證券代號,證券名稱,外陸資買進股數(不含外資自營商),外陸資賣出股數(不含外資自營商),外陸資買賣超股數(不含外資自營商),外資自營商買進股數,外資自營商賣出股數,外資自營商買賣超股數,投信買進股數,投信賣出股數,投信買賣超股數,自營商買賣超股數,自營商買進股數(自行買賣),自營商賣出股數(自行買賣),自營商買賣超股數(自行買賣),自營商買進股數(避險),自營商賣出股數(避險),自營商買賣超股數(避險),三大法人買賣超股數
00677U,富邦VIX         ,263652000,56773000,206879000,0,0,0,0,0,0,60819000,1190000,700000,490000,94596000,34267000,60329000,267698000
00632R,元大台灣50反1   ,78151000,1400000,76751000,0,0,0,0,0,0,20502000,1770000,10246000,-8476000,60877000,31899000,28978000,97253000
2834,臺企銀          ,19756000,5381292,14374708,0,0,0,7000,0,7000,66000,86000,28000,58000,10000,2000,8000,14447708
00669R,國泰美國道瓊反1 ,0,619000,-619000,0,0,0,0,0,0,10907000,0,0,0,13288000,2381000,10907000,10288000
2368,金像電          ,9457000,13466000,-4009000,0,0,0,11096000,3000000,8096000,3544000,5225000,1681000,3544000,0,0,0,7631000
00637L,元大滬深300正2  ,21693000,15121000,6572000,0,0,0,0,0,0,818000,0,0,0,50842000,50024000,818000,7390000
00633L,富邦上証正2     ,7430000,1194000,6236000,0,0,0,0,0,0,1130000,0,38000,-38000,9401000,8233000,1168000,7366000
03033P,微星國票03售01  ,0,0,0,0,0,0,0,0,0,7292000,0,0,0,7400000,108000,7292000,7292000
03555P,聯電元大02售24  ,0,0,0,0,0,0,0,0,0,6993000,0,0,0,6993000,0,6993000,6993000
2884,玉山金          ,20244000,14292581,5951419,0,0,0,11000,0,11000,919000,579000,44000,535000,394000,10000,384000,6881419
00708L,元大S&P黃金正2  ,1625000,0,1625000,0,0,0,0,0,0,4737000,0,0,0,7822000,3085000,4737000,6362000
2344,華邦電          ,11242000,5485000,5757000,0,0,0,4000,968000,-964000,907000,439000,272000,167000,874000,134000,740000,5700000
3017,奇鋐            ,4952000,1073000,3879000,0,0,0,545000,0,545000,990000,2000,0,2000,1044000,56000,988000,5414000
2353,宏碁            ,8531000,3829905,4701095,0,0,0,0,0,0,231000,84000,10000,74000,157000,0,157000,4932095
6116,彩晶            ,5105000,2103000,3002000,0,0,0,0,0,0,1655000,203000,56000,147000,1524000,16000,1508000,4657000
00648R,元大S&P500反1   ,0,3000,-3000,0,0,0,0,0,0,3765000,0,0,0,4579000,814000,3765000,3762000
00634R,富邦上証反1     ,885000,893000,-8000,0,0,0,0,0,0,3720000,0,800000,-800000,6000000,1480000,4520000,3712000
2027,大成鋼          ,2018000,950000,1068000,0,0,0,0,0,0,2255000,58000,35000,23000,2325000,93000,2232000,3323000
2890,永豐金          ,13530000,10292000,3238000,0,0,0,12000,0,12000,30000,79000,29000,50000,0,20000,-20000,3280000
00676R,富邦臺灣加權反1 ,0,0,0,0,0,0,0,0,0,3075000,0,0,0,3555000,480000,3075000,3075000
06924P,台積電群益98售07,0,0,0,0,0,0,0,0,0,3002000,0,0,0,4275000,1273000,3002000,3002000
00673R,元大S&P原油反1  ,11247000,610000,10637000,0,0,0,0,0,0,-7737000,0,222000,-222000,14014000,21529000,-7515000,2900000
5880,合庫金          ,11304000,8509480,2794520,0,0,0,14000,0,14000,52000,88000,31000,57000,1000,6000,-5000,2860520
3661,世芯-KY         ,3556000,960000,2596000,0,0,0,0,0,0,256000,144000,89000,55000,274000,73000,201000,2852000
04294P,台積電元大95售01,0,0,0,0,0,0,0,0,0,2813000,0,0,0,2958000,145000,2813000,2813000
00655L,國泰中國A50正2  ,4095000,544000,3551000,0,0,0,0,0,0,-821000,0,12000,-12000,4990000,5799000,-809000,2730000
4142,國光生          ,5126000,2536000,2590000,0,0,0,0,0,0,-30000,22000,12000,10000,0,40000,-40000,2560000
2478,大毅            ,3118000,909000,2209000,0,0,0,0,0,0,276000,4000,0,4000,283000,11000,272000,2485000
1909,榮成            ,5837584,3514000,2323584,0,0,0,254000,0,254000,-128000,189000,317000,-128000,0,0,0,2449584
06572P,台積電永昌99售01,0,0,0,0,0,0,0,0,0,2379000,0,0,0,4214000,1835000,2379000,2379000
2323,中環            ,3708842,1215000,2493842,0,0,0,0,0,0,-118000,42000,13000,29000,119000,266000,-147000,2375842
00672L,元大S&P原油正2  ,2938000,629000,2309000,0,0,0,0,0,0,47000,0,1000000,-1000000,9884000,8837000,1047000,2356000
044864,道瓊反國票96購01,0,0,0,0,0,0,0,0,0,2356000,0,0,0,3917000,1561000,2356000,2356000
2610,華航            ,9889000,7707792,2181208,0,0,0,5000,0,5000,53000,42000,9000,33000,20000,0,20000,2239208
2887,台新金          ,14156371,12049399,2106972,0,0,0,11000,0,11000,57000,69000,22000,47000,59000,49000,10000,2174972
9958,世紀鋼          ,1927000,584000,1343000,0,0,0,224000,0,224000,596000,147000,139000,8000,902000,314000,588000,2163000
03840P,台積電統一99售02,0,0,0,0,0,0,0,0,0,2135000,0,0,0,2979000,844000,2135000,2135000
3049,和鑫            ,2865000,738000,2127000,0,0,0,0,0,0,-3000,0,0,0,8000,11000,-3000,2124000
054400,健策永豐96購02  ,0,0,0,0,0,0,0,0,0,2057000,0,0,0,2082000,25000,2057000,2057000
08998P,玉晶光群益02售15,0,0,0,0,0,0,0,0,0,1981000,0,0,0,1981000,0,1981000,1981000
04930P,國巨統一94售08  ,0,0,0,0,0,0,0,0,0,1874000,0,0,0,2049000,175000,1874000,1874000
2892,第一金          ,14480080,12741623,1738457,0,0,0,80000,0,80000,33000,85000,30000,55000,0,22000,-22000,1851457
04787P,台積電永昌96售04,5000,0,5000,0,0,0,0,0,0,1844000,0,0,0,2590000,746000,1844000,1849000
5876,上海商銀        ,6994000,5478541,1515459,0,0,0,0,0,0,331000,328000,23000,305000,70000,44000,26000,1846459
2618,長榮航          ,10926208,8706672,2219536,0,0,0,5000,0,5000,-417000,49000,175000,-126000,9000,300000,-291000,1807536
04049P,大立光元大95售02,0,0,0,0,0,0,0,0,0,1777000,0,0,0,2188000,411000,1777000,1777000
2504,國產            ,2932000,772000,2160000,0,0,0,0,450000,-450000,41000,18000,4000,14000,50000,23000,27000,1751000
00638R,元大滬深300反1  ,763000,200000,563000,0,0,0,0,0,0,1169000,162000,500000,-338000,2914000,1407000,1507000,1732000
3231,緯創            ,4603000,4515000,88000,0,0,0,331000,0,331000,1311000,30000,127000,-97000,1494000,86000,1408000,1730000
056593,台積電元富98購02,0,0,0,0,0,0,0,0,0,1720000,0,0,0,2351000,631000,1720000,1720000
3338,泰碩            ,994000,876000,118000,0,0,0,1154000,0,1154000,443000,125000,50000,75000,422000,54000,368000,1715000
8046,南電            ,7568000,5324000,2244000,0,0,0,533000,1585000,-1052000,513000,190000,103000,87000,488000,62000,426000,1705000
2383,台光電          ,2098000,1193884,904116,0,0,0,424000,0,424000,301000,157000,113000,44000,260000,3000,257000,1629116
2349,錸德            ,2095000,478000,1617000,0,0,0,0,0,0,0,0,0,0,0,0,0,1617000
3016,嘉晶            ,1754000,1574000,180000,0,0,0,0,0,0,1404000,22000,16000,6000,1421000,23000,1398000,1584000
4927,泰鼎-KY         ,3064000,1086000,1978000,0,0,0,0,281000,-281000,-114000,67000,198000,-131000,198000,181000,17000,1583000
06573P,台積電永昌99售02,0,0,0,0,0,0,0,0,0,1568000,0,0,0,3178000,1610000,1568000,1568000
3034,聯詠            ,3062000,1662848,1399152,0,0,0,4000,0,4000,163000,55000,78000,-23000,225000,39000,186000,1566152
00671R,富邦NASDAQ反1   ,0,0,0,0,0,0,0,0,0,1562000,0,0,0,2121000,559000,1562000,1562000
2812,台中銀          ,3404000,1892000,1512000,0,0,0,0,0,0,38000,51000,13000,38000,0,0,0,1550000
2456,奇力新          ,3658000,1547000,2111000,0,0,0,0,480000,-480000,-148000,74000,222000,-148000,39000,39000,0,1483000
2327,國巨            ,3936000,2707672,1228328,0,0,0,0,605000,-605000,857000,761000,418000,343000,607000,93000,514000,1480328
08637P,台灣50中信96售03,0,0,0,0,0,0,0,0,0,1471000,0,0,0,3295000,1824000,1471000,1471000
043538,元石油國票97購01,0,0,0,0,0,0,0,0,0,1462000,0,0,0,1462000,0,1462000,1462000
6269,台郡            ,1409000,954000,455000,0,0,0,889000,15000,874000,118000,84000,129000,-45000,173000,10000,163000,1447000
044514,亞光凱基93購02  ,0,0,0,0,0,0,0,0,0,1409000,0,0,0,1409000,0,1409000,1409000
2867,三商壽          ,2185000,812000,1373000,0,0,0,0,0,0,8000,25000,17000,8000,0,0,0,1381000
049871,T50反1台新9A購02,0,0,0,0,0,0,0,0,0,1349000,0,0,0,1472000,123000,1349000,1349000
05174P,元金2X富邦9B售01,0,0,0,0,0,0,0,0,0,1342000,0,0,0,1799000,457000,1342000,1342000
2492,華新科          ,2924000,2679852,244148,0,0,0,6000,26000,-20000,1115000,686000,208000,478000,722000,85000,637000,1339148
054640,健策中信9B購01  ,0,0,0,0,0,0,0,0,0,1329000,0,0,0,1359000,30000,1329000,1329000
2014,中鴻            ,1710000,407000,1303000,0,0,0,0,0,0,21000,26000,5000,21000,0,0,0,1324000
058341,T50反1群益99購01,0,0,0,0,0,0,0,0,0,1321000,0,0,0,1680000,359000,1321000,1321000
00641R,富邦日本反1     ,62000,0,62000,0,0,0,0,0,0,1257000,0,0,0,1653000,396000,1257000,1319000
2367,燿華            ,2998000,1687000,1311000,0,0,0,0,25000,-25000,10000,4000,1000,3000,57000,50000,7000,1296000
3702,大聯大          ,2338000,2516000,-178000,0,0,0,18000,0,18000,1423000,12000,110000,-98000,1522000,1000,1521000,1263000
03418P,大毅群益02售03  ,0,0,0,0,0,0,0,0,0,1252000,0,0,0,1252000,0,1252000,1252000
043040,永冠元富94購01  ,0,0,0,0,0,0,0,0,0,1247000,0,0,0,1247000,0,1247000,1247000
05901P,臺股指凱基9C售01,0,0,0,0,0,0,0,0,0,1239000,0,0,0,1626000,387000,1239000,1239000
056698,T50反1國泰9A購01,0,0,0,0,0,0,0,0,0,1233000,0,0,0,1303000,70000,1233000,1233000
048628,T50反1元大96購03,0,0,0,0,0,0,0,0,0,1226000,0,0,0,1227000,1000,1226000,1226000
05196P,台積電永豐95售03,0,0,0,0,0,0,0,0,0,1213000,0,0,0,1239000,26000,1213000,1213000
00639,富邦深100       ,1391000,14000,1377000,0,0,0,0,0,0,-165000,25000,10000,15000,1078000,1258000,-180000,1212000
2897,王道銀行        ,1325000,151000,1174000,0,0,0,2000,0,2000,21000,30000,9000,21000,0,0,0,1197000
03832P,臺股指中信95售03,0,0,0,0,0,0,0,0,0,1175000,0,0,0,1231000,56000,1175000,1175000
058103,台積電永豐98購06,0,0,0,0,0,0,0,0,0,1167000,0,0,0,1434000,267000,1167000,1167000
04690P,國巨群益94售06  ,0,0,0,0,0,0,0,0,0,1162000,0,0,0,1162000,0,1162000,1162000
057197,立積台新98購01  ,0,0,0,0,0,0,0,0,0,1122000,0,0,0,1335000,213000,1122000,1122000
2883,開發金          ,16990000,15257000,1733000,0,0,0,16000,700000,-684000,73000,127000,34000,93000,0,20000,-20000,1122000
05170P,世芯元大95售01  ,0,0,0,0,0,0,0,0,0,1113000,0,0,0,1666000,553000,1113000,1113000
06513P,鴻海凱基98售10  ,0,0,0,0,0,0,0,0,0,1113000,0,0,0,1121000,8000,1113000,1113000
05966P,矽力凱基96售03  ,0,0,0,0,0,0,0,0,0,1097000,0,0,0,1107000,10000,1097000,1097000
2480,敦陽科          ,756000,154000,602000,0,0,0,0,0,0,488000,552000,64000,488000,0,0,0,1090000
04289P,臺股指中信95售07,0,0,0,0,0,0,0,0,0,1088000,0,0,0,1168000,80000,1088000,1088000
050104,元石油元大97購02,0,0,0,0,0,0,0,0,0,1080000,0,0,0,1080000,0,1080000,1080000
1718,中纖            ,1477000,425000,1052000,0,0,0,0,0,0,0,0,0,0,0,0,0,1052000
052687,國泰金元大96購03,0,0,0,0,0,0,0,0,0,1040000,0,0,0,1225000,185000,1040000,1040000
006205,富邦上証        ,1680000,22000,1658000,0,0,0,0,250000,-250000,-381000,100000,210000,-110000,1322000,1593000,-271000,1027000
0061,元大寶滬深      ,99000,0,99000,0,0,0,0,0,0,919000,170000,10000,160000,774000,15000,759000,1018000
05980P,台積電永昌96售09,0,0,0,0,0,0,0,0,0,1017000,0,0,0,4255000,3238000,1017000,1017000
054556,世芯凱基99購01  ,0,0,0,0,0,0,0,0,0,1013000,0,0,0,1348000,335000,1013000,1013000
4934,太極            ,1673000,667000,1006000,0,0,0,0,0,0,0,0,0,0,0,0,0,1006000
2439,美律            ,1058000,515000,543000,0,0,0,1000,0,1000,457000,92000,35000,57000,413000,13000,400000,1001000
06105P,國巨國票98售02  ,0,0,0,0,0,0,0,0,0,1000000,0,0,0,1075000,75000,1000000,1000000
052103,台積電兆豐95購06,0,0,0,0,0,0,0,0,0,990000,0,0,0,1323000,333000,990000,990000
057563,旭富國泰9A購01  ,0,0,0,0,0,0,0,0,0,984000,0,0,0,1188000,204000,984000,984000
08674P,嘉晶元富07售02  ,0,0,0,0,0,0,0,0,0,984000,0,0,0,1604000,620000,984000,984000
054868,國泰金群益9A購01,0,0,0,0,0,0,0,0,0,980000,0,0,0,1192000,212000,980000,980000
2449,京元電子        ,2361000,2876000,-515000,0,0,0,241000,0,241000,1250000,69000,60000,9000,1278000,37000,1241000,976000
051316,T50反1國票95購02,0,0,0,0,0,0,0,0,0,960000,0,0,0,960000,0,960000,960000
052036,臺股指群益95購09,0,0,0,0,0,0,0,0,0,956000,0,0,0,956000,0,956000,956000
052928,美律元大98購01  ,0,0,0,0,0,0,0,0,0,943000,0,0,0,943000,0,943000,943000
055370,旺宏元大97購05  ,0,0,0,0,0,0,0,0,0,943000,0,0,0,943000,0,943000,943000
055192,世芯元富97購01  ,0,0,0,0,0,0,0,0,0,922000,0,0,0,1140000,218000,922000,922000
052838,新唐國泰98購01  ,0,0,0,0,0,0,0,0,0,912000,0,0,0,925000,13000,912000,912000
3019,亞光            ,1307000,387000,920000,0,0,0,0,63000,-63000,52000,136000,141000,-5000,76000,19000,57000,909000
06189P,華新科永豐97售03,0,0,0,0,0,0,0,0,0,891000,0,0,0,1053000,162000,891000,891000
04874P,高股息中信97售01,0,0,0,0,0,0,0,0,0,889000,0,0,0,899000,10000,889000,889000
3035,智原            ,1554000,793000,761000,0,0,0,0,0,0,120000,122000,1000,121000,9000,10000,-1000,881000
050055,道瓊反凱基95購01,0,0,0,0,0,0,0,0,0,871000,0,0,0,887000,16000,871000,871000
1707,葡萄王          ,878000,60000,818000,0,0,0,50000,0,50000,0,46000,43000,3000,0,3000,-3000,868000
2845,遠東銀          ,1852000,983000,869000,0,0,0,4000,0,4000,-20000,42000,68000,-26000,6000,0,6000,853000
056797,台積電麥證98購01,0,0,0,850000,0,850000,0,0,0,850000,0,0,0,850000,0,850000,850000
046155,道瓊反群益94購01,0,0,0,0,0,0,0,0,0,849000,0,0,0,854000,5000,849000,849000
2809,京城銀          ,1095000,643000,452000,0,0,0,355000,0,355000,42000,59000,17000,42000,0,0,0,849000
044974,鴻海國票94購01  ,0,0,0,0,0,0,0,0,0,844000,0,0,0,844000,0,844000,844000
044805,旭富凱基93購01  ,0,0,0,0,0,0,0,0,0,833000,0,0,0,875000,42000,833000,833000
05262P,台積電元大95售19,0,0,0,0,0,0,0,0,0,821000,0,0,0,841000,20000,821000,821000
2601,益航            ,1053000,233000,820000,0,0,0,0,0,0,0,0,0,0,0,0,0,820000
00643,群益深証中小    ,944000,43000,901000,0,0,0,0,0,0,-82000,0,0,0,513000,595000,-82000,819000
9919,康那香          ,1422000,620000,802000,0,0,0,0,0,0,15000,17000,2000,15000,0,0,0,817000
00636,國泰中國A50     ,802000,4000,798000,0,0,0,0,0,0,18000,70000,70000,0,345000,327000,18000,816000
044249,T50反1中信94購01,0,0,0,0,0,0,0,0,0,808000,0,0,0,1458000,650000,808000,808000
6278,台表科          ,1912000,1109109,802891,0,0,0,40000,199000,-159000,156000,28000,61000,-33000,192000,3000,189000,799891
3026,禾伸堂          ,1091000,300000,791000,0,0,0,0,0,0,-7000,2000,0,2000,21000,30000,-9000,784000
04595P,臺股指元大94售13,0,0,0,0,0,0,0,0,0,780000,0,0,0,800000,20000,780000,780000
052456,滬深2X元富9B購03,0,0,0,0,0,0,0,0,0,775000,0,0,0,970000,195000,775000,775000
6176,瑞儀            ,2397000,1824000,573000,0,0,0,0,308000,-308000,506000,42000,16000,26000,493000,13000,480000,771000
050754,元金2X元富9B購01,0,0,0,0,0,0,0,0,0,767000,0,0,0,804000,37000,767000,767000
04014P,聯發科元大93售18,0,0,0,0,0,0,0,0,0,766000,0,0,0,950000,184000,766000,766000
05089P,亞德客元大95售01,0,0,0,0,0,0,0,0,0,765000,0,0,0,925000,160000,765000,765000
054578,世芯元大99購01  ,0,0,0,0,0,0,0,0,0,765000,0,0,0,817000,52000,765000,765000
05381P,聯詠群益95售02  ,0,0,0,0,0,0,0,0,0,750000,0,0,0,750000,0,750000,750000
3682,亞太電          ,980000,234000,746000,0,0,0,0,0,0,0,0,0,0,0,0,0,746000
04434P,玉晶光國票96售02,0,0,0,0,0,0,0,0,0,744000,0,0,0,880000,136000,744000,744000
1326,台化            ,3737000,3512968,224032,0,0,0,30000,0,30000,489000,100000,80000,20000,471000,2000,469000,743032
05403P,台積電富邦95售08,0,0,0,0,0,0,0,0,0,742000,0,0,0,828000,86000,742000,742000
2375,凱美            ,1024000,288000,736000,0,0,0,0,0,0,-6000,1000,0,1000,3000,10000,-7000,730000
055225,華邦電國票99購01,0,0,0,0,0,0,0,0,0,723000,0,0,0,723000,0,723000,723000
05491P,茂林元大95售04  ,0,10000,-10000,0,0,0,0,0,0,729000,0,0,0,952000,223000,729000,719000
06676P,華新科國票98售03,0,0,0,0,0,0,0,0,0,718000,0,0,0,718000,0,718000,718000
06310P,精元元富97售02  ,0,0,0,0,0,0,0,0,0,715000,0,0,0,759000,44000,715000,715000
057298,旭富永豐98購01  ,0,0,0,0,0,0,0,0,0,713000,0,0,0,753000,40000,713000,713000
2489,瑞軒            ,982000,235000,747000,0,0,0,0,0,0,-36000,8000,44000,-36000,0,0,0,711000
8112,至上            ,1306100,742000,564100,0,0,0,2000,0,2000,142000,149000,7000,142000,0,0,0,708100
050914,健鼎中信95購01  ,0,0,0,0,0,0,0,0,0,706000,0,0,0,791000,85000,706000,706000
4915,致伸            ,1276000,586000,690000,0,0,0,2000,0,2000,14000,3000,1000,2000,12000,0,12000,706000
058465,元石油中信01購01,0,0,0,0,0,0,0,0,0,705000,0,0,0,879000,174000,705000,705000
054843,中環兆豐97購01  ,0,0,0,0,0,0,0,0,0,701000,0,0,0,792000,91000,701000,701000
053863,聯發科元大96購18,0,0,0,0,0,0,0,0,0,701000,0,0,0,701000,0,701000,701000
06496P,台灣50日盛98售01,0,0,0,0,0,0,0,0,0,701000,0,0,0,749000,48000,701000,701000
055945,上証2X元大97購04,0,0,0,0,0,0,0,0,0,699000,0,0,0,699000,0,699000,699000
06303P,臺股指元大97售09,0,0,0,0,0,0,0,0,0,698000,0,0,0,698000,0,698000,698000
2201,裕隆            ,1519000,772000,747000,0,0,0,0,0,0,-63000,15000,5000,10000,74000,147000,-73000,684000
057782,台積電國票99購07,0,0,0,0,0,0,0,0,0,675000,0,0,0,933000,258000,675000,675000
06822P,上銀富邦99售03  ,0,0,0,0,0,0,0,0,0,675000,0,0,0,837000,162000,675000,675000
2417,圓剛            ,893000,221000,672000,0,0,0,0,0,0,-2000,0,2000,-2000,0,0,0,670000
06500P,臺股指元大9A售05,0,0,0,0,0,0,0,0,0,669000,0,0,0,675000,6000,669000,669000
4967,十銓            ,1261100,585000,676100,0,0,0,0,0,0,-10000,4000,14000,-10000,0,0,0,666100
00681R,元大美債20反1   ,0,0,0,0,0,0,0,0,0,663000,0,0,0,814000,151000,663000,663000
051614,元金2X凱基97購01,0,0,0,0,0,0,0,0,0,657000,0,0,0,1209000,552000,657000,657000
00635U,元大S&P黃金     ,166000,0,166000,0,0,0,0,0,0,489000,5000,611000,-606000,1525000,430000,1095000,655000
2637,慧洋-KY         ,473000,309000,164000,0,0,0,1000,0,1000,488000,495000,7000,488000,0,0,0,653000
053902,S&P反1凱基97購01,0,0,0,0,0,0,0,0,0,640000,0,0,0,657000,17000,640000,640000
052956,聯發科日盛96購01,0,0,0,0,0,0,0,0,0,634000,0,0,0,634000,0,634000,634000
06633P,國巨國票99售01  ,0,0,0,0,0,0,0,0,0,631000,0,0,0,637000,6000,631000,631000
03418B,臺股指元大95熊20,0,0,0,0,0,0,0,0,0,629000,0,0,0,711000,82000,629000,629000
06821P,臺股指元富98售10,0,0,0,0,0,0,0,0,0,629000,0,0,0,714000,85000,629000,629000
2312,金寶            ,1713000,1129000,584000,0,0,0,0,0,0,42000,12000,2000,10000,46000,14000,32000,626000
06229P,欣興凱基97售07  ,0,0,0,0,0,0,0,0,0,626000,0,0,0,851000,225000,626000,626000
052371,元金2X元大95購01,0,0,0,0,0,0,0,0,0,620000,0,0,0,620000,0,620000,620000
047885,元金2X富邦99購01,0,0,0,0,0,0,0,0,0,617000,0,0,0,805000,188000,617000,617000
058547,世紀鋼富邦9A購01,0,0,0,0,0,0,0,0,0,616000,0,0,0,918000,302000,616000,616000
05176P,台積電凱基95售11,0,0,0,0,0,0,0,0,0,615000,0,0,0,638000,23000,615000,615000
00739,元大MSCI A股    ,2000,0,2000,0,0,0,0,0,0,612000,27000,0,27000,619000,34000,585000,614000
03197P,台積電統一01售14,0,0,0,0,0,0,0,0,0,613000,0,0,0,613000,0,613000,613000
8039,台虹            ,1065000,730000,335000,0,0,0,0,0,0,270000,134000,30000,104000,189000,23000,166000,605000
051368,國泰金富邦97購01,0,0,0,0,0,0,0,0,0,602000,0,0,0,655000,53000,602000,602000
03181P,台灣50元大01售40,0,0,0,0,0,0,0,0,0,596000,0,0,0,720000,124000,596000,596000
05934P,國巨凱基96售13  ,0,0,0,0,0,0,0,0,0,595000,0,0,0,672000,77000,595000,595000
2006,東和鋼鐵        ,1148000,629000,519000,0,0,0,1000,0,1000,75000,99000,24000,75000,0,0,0,595000
054204,元金2X國票9B購02,0,0,0,0,0,0,0,0,0,593000,0,0,0,825000,232000,593000,593000
06757P,台灣50元大9B售01,0,0,0,0,0,0,0,0,0,593000,0,0,0,608000,15000,593000,593000
052427,上証2X永豐96購01,0,0,0,0,0,0,0,0,0,589000,0,0,0,589000,0,589000,589000
1709,和益            ,711000,128000,583000,0,0,0,0,0,0,1000,1000,0,1000,0,0,0,584000
056188,晶相光統一99購01,0,0,0,0,0,0,0,0,0,577000,0,0,0,667000,90000,577000,577000
2342,茂矽            ,1511000,1011000,500000,0,0,0,0,0,0,76000,77000,1000,76000,0,0,0,576000
1736,喬山            ,865000,315000,550000,0,0,0,0,0,0,25000,11000,2000,9000,29000,13000,16000,575000
05698P,群創凱基96售01  ,0,0,0,0,0,0,0,0,0,572000,0,0,0,605000,33000,572000,572000
052450,嘉澤元大95購03  ,0,0,0,0,0,0,0,0,0,571000,0,0,0,571000,0,571000,571000
051613,S&P反1凱基96購01,0,0,0,0,0,0,0,0,0,570000,0,0,0,570000,0,570000,570000
048460,盛群凱基94購01  ,0,0,0,0,0,0,0,0,0,566000,0,0,0,990000,424000,566000,566000
043961,道瓊反國泰94購01,0,0,0,0,0,0,0,0,0,564000,0,0,0,564000,0,564000,564000
9946,三發地產        ,752000,190000,562000,0,0,0,0,0,0,0,0,0,0,0,0,0,562000
08795P,聯發科凱基01售11,0,0,0,0,0,0,0,0,0,559000,0,0,0,619000,60000,559000,559000
2633,台灣高鐵        ,3612000,3051722,560278,0,0,0,3000,0,3000,-5000,43000,38000,5000,1000,11000,-10000,558278
050853,南電國票96購01  ,0,0,0,0,0,0,0,0,0,558000,0,0,0,1255000,697000,558000,558000
051990,泰碩元大95購01  ,0,0,0,0,0,0,0,0,0,558000,0,0,0,558000,0,558000,558000
058587,台積電中信9C購03,0,0,0,0,0,0,0,0,0,557000,0,0,0,980000,423000,557000,557000
06376P,上銀統一99售01  ,0,0,0,0,0,0,0,0,0,553000,0,0,0,573000,20000,553000,553000
058344,旺宏群益99購05  ,0,0,0,0,0,0,0,0,0,545000,0,0,0,605000,60000,545000,545000
2340,光磊            ,927000,391000,536000,0,0,0,0,0,0,7000,28000,16000,12000,12000,17000,-5000,543000
2481,強茂            ,834000,337000,497000,0,0,0,0,0,0,46000,10000,0,10000,37000,1000,36000,543000
06860P,台灣50兆豐98售01,0,0,0,0,0,0,0,0,0,539000,0,0,0,600000,61000,539000,539000
4943,康控-KY         ,644000,147000,497000,0,0,0,0,0,0,41000,1000,0,1000,61000,21000,40000,538000
6153,嘉聯益          ,1450000,1079000,371000,0,0,0,0,0,0,166000,136000,51000,85000,95000,14000,81000,537000
044694,道瓊反元大94購02,0,0,0,0,0,0,0,0,0,535000,0,0,0,535000,0,535000,535000
2915,潤泰全          ,676000,943000,-267000,0,0,0,0,0,0,796000,9000,5000,4000,803000,11000,792000,529000
04979P,臺股指凱基96售07,0,0,0,0,0,0,0,0,0,525000,0,0,0,960000,435000,525000,525000
5521,工信            ,614000,89000,525000,0,0,0,0,0,0,0,0,0,0,0,0,0,525000
04692P,大立光群益94售06,0,0,0,0,0,0,0,0,0,523000,0,0,0,523000,0,523000,523000
055843,美律元大97購02  ,0,0,0,0,0,0,0,0,0,521000,0,0,0,833000,312000,521000,521000
04708P,國巨元大94售11  ,0,0,0,0,0,0,0,0,0,519000,0,0,0,519000,0,519000,519000
051971,元金2X凱基97購02,0,0,0,0,0,0,0,0,0,515000,0,0,0,712000,197000,515000,515000
053747,滬深2X永豐96購05,0,0,0,0,0,0,0,0,0,514000,0,0,0,517000,3000,514000,514000
6706,惠特            ,545000,44000,501000,0,0,0,10000,0,10000,0,0,0,0,0,0,0,511000
06081P,深中小元大97售02,0,0,0,0,0,0,0,0,0,510000,0,0,0,850000,340000,510000,510000
05292P,台積電凱基95售16,0,0,0,0,0,0,0,0,0,507000,0,0,0,507000,0,507000,507000
052815,滬深2X永豐97購01,0,0,0,0,0,0,0,0,0,506000,0,0,0,506000,0,506000,506000
05655P,南亞科統一96售01,0,0,0,0,0,0,0,0,0,504000,0,0,0,515000,11000,504000,504000
8926,台汽電          ,864000,804000,60000,0,0,0,11000,0,11000,433000,635000,202000,433000,0,0,0,504000
3596,智易            ,658000,161000,497000,0,0,0,0,0,0,6000,37000,35000,2000,51000,47000,4000,503000
056413,上証反中信9A購01,0,0,0,0,0,0,0,0,0,500000,0,0,0,500000,0,500000,500000
052785,滬深2X中信99購03,0,0,0,0,0,0,0,0,0,499000,0,0,0,637000,138000,499000,499000
04116P,京元電元大94售02,0,0,0,0,0,0,0,0,0,499000,0,0,0,499000,0,499000,499000
08599P,台表科元大9C售11,0,0,0,0,0,0,0,0,0,499000,0,0,0,549000,50000,499000,499000
8105,凌巨            ,734000,239000,495000,0,0,0,0,0,0,2000,3000,1000,2000,0,0,0,497000
05045P,台積電永豐95售01,0,0,0,0,0,0,0,0,0,495000,0,0,0,495000,0,495000,495000
05657P,樺漢統一97售01  ,0,0,0,0,0,0,0,0,0,494000,0,0,0,494000,0,494000,494000
2838,聯邦銀          ,869000,402000,467000,0,0,0,0,0,0,21000,37000,16000,21000,0,0,0,488000
06118P,上証2X凱基98售03,0,0,0,0,0,0,0,0,0,485000,0,0,0,526000,41000,485000,485000
6120,達運            ,782000,298000,484000,0,0,0,0,0,0,0,15000,14000,1000,0,1000,-1000,484000
06614P,祥碩永豐98售03  ,0,0,0,0,0,0,0,0,0,483000,0,0,0,483000,0,483000,483000
055193,世芯元富97購02  ,0,0,0,0,0,0,0,0,0,482000,0,0,0,1143000,661000,482000,482000
2889,國票金          ,1451000,1031000,420000,0,0,0,29000,0,29000,33000,53000,20000,33000,0,0,0,482000
006207,FH滬深          ,454000,32000,422000,0,0,0,0,0,0,59000,0,0,0,120000,61000,59000,481000
2371,大同            ,3187000,2823000,364000,0,0,0,0,0,0,117000,216000,99000,117000,0,0,0,481000
04755P,大立光元富94售07,0,0,0,0,0,0,0,0,0,480000,0,0,0,480000,0,480000,480000
053181,滬深2X元富99購02,0,0,0,0,0,0,0,0,0,480000,0,0,0,608000,128000,480000,480000
051277,聯發科中信9A購01,0,0,0,0,0,0,0,0,0,479000,0,0,0,579000,100000,479000,479000
06760P,台積電元大98售18,0,0,0,0,0,0,0,0,0,479000,0,0,0,901000,422000,479000,479000
06538P,國巨凱基98售11  ,0,0,0,0,0,0,0,0,0,478000,0,0,0,582000,104000,478000,478000
053791,同欣電元大96購05,0,0,0,0,0,0,0,0,0,477000,0,0,0,587000,110000,477000,477000
05487P,台表科凱基95售02,0,0,0,0,0,0,0,0,0,476000,0,0,0,478000,2000,476000,476000
06587P,國巨元大98售13  ,0,0,0,0,0,0,0,0,0,473000,0,0,0,530000,57000,473000,473000
6196,帆宣            ,844000,275000,569000,0,0,0,0,0,0,-96000,0,100000,-100000,10000,6000,4000,473000
048193,旺宏元大94購05  ,0,0,0,0,0,0,0,0,0,471000,0,0,0,626000,155000,471000,471000
049766,滬深2X元富94購02,0,0,0,0,0,0,0,0,0,469000,0,0,0,550000,81000,469000,469000
052193,國巨元富95購06  ,0,0,0,0,0,0,0,0,0,463000,0,0,0,534000,71000,463000,463000
051158,嘉晶富邦96購01  ,0,0,0,0,0,0,0,0,0,463000,0,0,0,540000,77000,463000,463000
058035,旭富永豐98購02  ,0,0,0,0,0,0,0,0,0,461000,0,0,0,523000,62000,461000,461000
06109P,華新科群益97售05,0,0,0,0,0,0,0,0,0,461000,0,0,0,471000,10000,461000,461000
3665,貿聯-KY         ,847000,461160,385840,0,0,0,0,12000,-12000,87000,82000,26000,56000,39000,8000,31000,460840
053411,深中小國票9B購01,0,0,0,0,0,0,0,0,0,460000,0,0,0,470000,10000,460000,460000
06767P,台積電永昌99售03,0,0,0,0,0,0,0,0,0,460000,0,0,0,660000,200000,460000,460000
05091P,台積電元大95售11,0,0,0,0,0,0,0,0,0,456000,0,0,0,2093000,1637000,456000,456000
053470,華邦電元大96購02,0,0,0,0,0,0,0,0,0,454000,0,0,0,755000,301000,454000,454000
3532,台勝科          ,483000,683000,-200000,0,0,0,0,0,0,652000,81000,42000,39000,614000,1000,613000,452000
055602,康控元大97購03  ,0,0,0,0,0,0,0,0,0,449000,0,0,0,605000,156000,449000,449000
2401,凌陽            ,609000,157697,451303,0,0,0,0,0,0,-3000,5000,8000,-3000,0,0,0,448303
04672P,台積電統一94售09,0,0,0,0,0,0,0,0,0,446000,0,0,0,493000,47000,446000,446000
2442,新美齊          ,660000,214000,446000,0,0,0,0,0,0,0,1000,1000,0,0,0,0,446000
06640P,國巨兆豐99售02  ,0,0,0,0,0,0,0,0,0,445000,0,0,0,465000,20000,445000,445000
051735,台積電國票96購06,0,0,0,0,0,0,0,0,0,444000,0,0,0,1000000,556000,444000,444000
055709,深中小元大97購03,0,0,0,0,0,0,0,0,0,443000,0,0,0,453000,10000,443000,443000
049441,T50反1統一94購05,0,0,0,0,0,0,0,0,0,442000,0,0,0,442000,0,442000,442000
051718,上証2X永豐95購01,0,0,0,0,0,0,0,0,0,441000,0,0,0,480000,39000,441000,441000
05688P,臺股指元大96售13,0,0,0,0,0,0,0,0,0,440000,0,0,0,465000,25000,440000,440000
03427P,聯電元大02售11  ,0,0,0,0,0,0,0,0,0,440000,0,0,0,500000,60000,440000,440000
049212,T50反1國票94購04,0,0,0,0,0,0,0,0,0,438000,0,0,0,556000,118000,438000,438000
05551P,電子類元大96售01,0,0,0,0,0,0,0,0,0,438000,0,0,0,458000,20000,438000,438000
06382P,大毅元富97售02  ,0,0,0,0,0,0,0,0,0,437000,0,0,0,632000,195000,437000,437000
04730P,臺股指中信96售02,0,0,0,0,0,0,0,0,0,436000,0,0,0,456000,20000,436000,436000
050540,台積電凱基94購38,0,0,0,0,0,0,0,0,0,434000,0,0,0,1018000,584000,434000,434000
2105,正新            ,2417000,2009000,408000,0,0,0,0,0,0,25000,30000,6000,24000,1000,0,1000,433000
2393,億光            ,571000,315000,256000,0,0,0,120000,0,120000,54000,32000,32000,0,71000,17000,54000,430000
06984P,上銀富邦9B售01  ,0,0,0,0,0,0,0,0,0,430000,0,0,0,435000,5000,430000,430000
1701,中化            ,899000,500000,399000,0,0,0,0,0,0,27000,27000,0,27000,0,0,0,426000
048442,友訊凱基94購01  ,0,0,0,0,0,0,0,0,0,421000,0,0,0,501000,80000,421000,421000
051117,臺指反群益95購02,0,0,0,0,0,0,0,0,0,420000,0,0,0,420000,0,420000,420000
06162P,大立光群益97售02,0,0,0,0,0,0,0,0,0,419000,0,0,0,491000,72000,419000,419000
044457,滬深2X國票97購01,0,0,0,0,0,0,0,0,0,416000,0,0,0,1628000,1212000,416000,416000
06715P,台積電元大99售04,0,0,0,0,0,0,0,0,0,416000,0,0,0,997000,581000,416000,416000
050363,臺指反元大98購04,0,0,0,0,0,0,0,0,0,414000,0,0,0,414000,0,414000,414000
044280,T50反1凱基94購02,0,0,0,0,0,0,0,0,0,413000,0,0,0,1521000,1108000,413000,413000
057182,禾伸堂元大99購02,0,0,0,0,0,0,0,0,0,412000,0,0,0,585000,173000,412000,412000
05011P,南電國泰96售01  ,0,0,0,0,0,0,0,0,0,412000,0,0,0,549000,137000,412000,412000
044247,道瓊反元富97購01,0,0,0,0,0,0,0,0,0,410000,0,0,0,411000,1000,410000,410000
055102,上銀凱基98購01  ,0,0,0,0,0,0,0,0,0,410000,0,0,0,807000,397000,410000,410000
2537,聯上發          ,965000,555000,410000,0,0,0,0,0,0,0,0,0,0,0,0,0,410000
05103P,臺股指凱基96售10,0,0,0,0,0,0,0,0,0,408000,0,0,0,458000,50000,408000,408000
056341,宏達電凱基9A購01,0,0,0,0,0,0,0,0,0,408000,0,0,0,435000,27000,408000,408000
05995P,T50正2中信9C售01,0,0,0,0,0,0,0,0,0,406000,0,0,0,442000,36000,406000,406000
052061,樺漢國票96購01  ,0,0,0,0,0,0,0,0,0,406000,0,0,0,515000,109000,406000,406000
05620P,大立光富邦9B售01,0,0,0,0,0,0,0,0,0,405000,0,0,0,961000,556000,405000,405000
046717,世紀鋼國泰94購01,0,0,0,0,0,0,0,0,0,403000,0,0,0,415000,12000,403000,403000
051405,世芯永豐95購01  ,0,0,0,0,0,0,0,0,0,403000,0,0,0,1398000,995000,403000,403000
3056,總太            ,802000,402000,400000,0,0,0,0,0,0,3000,4000,1000,3000,0,0,0,403000
05235P,健鼎康和95售02  ,0,0,0,0,0,0,0,0,0,401000,0,0,0,495000,94000,401000,401000
04636P,臺股指群益94售11,0,0,0,0,0,0,0,0,0,400000,0,0,0,400000,0,400000,400000
047529,嘉晶元大94購02  ,0,0,0,0,0,0,0,0,0,400000,0,0,0,450000,50000,400000,400000
045657,T50反1國泰94購01,0,0,0,0,0,0,0,0,0,399000,0,0,0,399000,0,399000,399000
05452P,亞德客群益95售02,0,0,0,0,0,0,0,0,0,399000,0,0,0,399000,0,399000,399000
04506P,旺宏元大94售06  ,0,0,0,0,0,0,0,0,0,398000,0,0,0,400000,2000,398000,398000
056952,元油2X國泰99購01,0,0,0,0,0,0,0,0,0,395000,0,0,0,395000,0,395000,395000
053967,華邦電元大96購03,0,0,0,0,0,0,0,0,0,395000,0,0,0,498000,103000,395000,395000
2609,陽明            ,580000,185000,395000,0,0,0,0,0,0,0,0,0,0,0,0,0,395000
2499,東貝            ,711000,333000,378000,0,0,0,0,0,0,17000,17000,0,17000,0,0,0,395000
06721P,臺股指中信9A售03,0,0,0,0,0,0,0,0,0,395000,0,0,0,585000,190000,395000,395000
04703P,樺漢統一95售01  ,0,0,0,0,0,0,0,0,0,394000,0,0,0,394000,0,394000,394000
03428P,台積電元大02售28,0,0,0,0,0,0,0,0,0,394000,0,0,0,421000,27000,394000,394000
2104,國際中橡        ,1279000,884000,395000,0,0,0,0,0,0,-1000,10000,4000,6000,0,7000,-7000,394000
051938,旭富群益95購01  ,0,0,0,0,0,0,0,0,0,393000,0,0,0,438000,45000,393000,393000
1802,台玻            ,947000,590000,357000,0,0,0,0,0,0,36000,44000,8000,36000,0,0,0,393000
2369,菱生            ,763000,373000,390000,0,0,0,0,0,0,3000,4000,1000,3000,0,0,0,393000
08506P,台灣50中信96售02,0,0,0,0,0,0,0,0,0,392000,0,0,0,392000,0,392000,392000
04875P,台積電中信94售04,0,0,0,0,0,0,0,0,0,390000,0,0,0,423000,33000,390000,390000
052272,T50反1群益95購03,0,0,0,0,0,0,0,0,0,390000,0,0,0,390000,0,390000,390000
054050,創意元大96購06  ,0,0,0,0,0,0,0,0,0,390000,0,0,0,390000,0,390000,390000
053090,新唐元大96購01  ,0,0,0,0,0,0,0,0,0,389000,0,0,0,449000,60000,389000,389000
2405,浩鑫            ,426000,35000,391000,0,0,0,0,0,0,-2000,0,2000,-2000,0,0,0,389000
050714,深中小群益98購01,0,0,0,0,0,0,0,0,0,388000,0,0,0,528000,140000,388000,388000
03656C,臺股指凱基99牛12,0,0,0,0,0,0,0,0,0,386000,0,0,0,427000,41000,386000,386000
06136P,華新科國泰99售02,0,0,0,0,0,0,0,0,0,385000,0,0,0,987000,602000,385000,385000
046999,康控富邦99購01  ,0,0,0,0,0,0,0,0,0,383000,0,0,0,680000,297000,383000,383000
048381,T50反1國票94購03,0,0,0,0,0,0,0,0,0,383000,0,0,0,383000,0,383000,383000
04455P,台積電統一94售07,0,0,0,0,0,0,0,0,0,381000,0,0,0,381000,0,381000,381000
049244,亞光元富94購01  ,0,0,0,0,0,0,0,0,0,380000,0,0,0,380000,0,380000,380000
052228,聯發科凱基96購06,0,0,0,0,0,0,0,0,0,379000,0,0,0,479000,100000,379000,379000
049135,台達電元大94購03,0,0,0,0,0,0,0,0,0,378000,0,0,0,398000,20000,378000,378000
05041P,大立光凱基95售09,0,0,0,0,0,0,0,0,0,378000,0,0,0,1240000,862000,378000,378000
05549P,臺股指元大96售03,0,0,0,0,0,0,0,0,0,377000,0,0,0,608000,231000,377000,377000
053966,旺宏元大96購08  ,0,0,0,0,0,0,0,0,0,376000,0,0,0,712000,336000,376000,376000
1455,集盛            ,410000,36000,374000,0,0,0,0,0,0,0,0,0,0,0,0,0,374000
2849,安泰銀          ,377000,13000,364000,0,0,0,0,0,0,10000,15000,5000,10000,0,0,0,374000
3006,晶豪科          ,628000,290000,338000,0,0,0,0,0,0,36000,21000,17000,4000,90000,58000,32000,374000
00651R,FH香港反1       ,20000,1000,19000,0,0,0,0,0,0,354000,340000,0,340000,668000,654000,14000,373000
2605,新興            ,923000,183000,740000,0,0,0,0,351000,-351000,-17000,0,17000,-17000,0,0,0,372000
05090P,國巨元大95售05  ,0,0,0,0,0,0,0,0,0,370000,0,0,0,470000,100000,370000,370000
050752,美律統一94購05  ,0,0,0,0,0,0,0,0,0,370000,0,0,0,370000,0,370000,370000
051749,矽力國泰97購01  ,0,0,0,0,0,0,0,0,0,369000,0,0,0,595000,226000,369000,369000
05180P,玉晶光凱基95售04,0,0,0,0,0,0,0,0,0,366000,0,0,0,461000,95000,366000,366000
06077P,GIS凱基97售02   ,0,0,0,0,0,0,0,0,0,366000,0,0,0,387000,21000,366000,366000
05748P,臺股指群益99售02,0,0,0,0,0,0,0,0,0,365000,0,0,0,573000,208000,365000,365000
05444P,大立光元大95售10,0,0,0,0,0,0,0,0,0,365000,0,0,0,390000,25000,365000,365000
3576,聯合再生        ,1004000,260000,744000,0,0,0,0,0,0,-380000,0,380000,-380000,0,0,0,364000
05729P,臺股指凱基97售02,0,0,0,0,0,0,0,0,0,362000,0,0,0,374000,12000,362000,362000
06371P,茂林國票98售04  ,0,0,0,0,0,0,0,0,0,362000,0,0,0,469000,107000,362000,362000
06778P,台積電元大99售06,0,0,0,0,0,0,0,0,0,362000,0,0,0,838000,476000,362000,362000
057112,立積群益99購01  ,0,0,0,0,0,0,0,0,0,361000,0,0,0,526000,165000,361000,361000
048677,智伸科國泰94購01,0,0,0,0,0,0,0,0,0,360000,0,0,0,360000,0,360000,360000
053122,美律凱基98購01  ,0,0,0,0,0,0,0,0,0,360000,0,0,0,397000,37000,360000,360000
2332,友訊            ,1434000,402000,1032000,0,0,0,0,0,0,-672000,5000,648000,-643000,93000,122000,-29000,360000
055263,華新科富邦9A購01,0,0,0,0,0,0,0,0,0,359000,0,0,0,799000,440000,359000,359000
2363,矽統            ,673000,316000,357000,0,0,0,0,0,0,2000,2000,0,2000,0,0,0,359000
053025,燿華富邦98購02  ,0,0,0,0,0,0,0,0,0,358000,0,0,0,368000,10000,358000,358000
2614,東森            ,1014000,652000,362000,0,0,0,0,0,0,-4000,0,4000,-4000,0,0,0,358000
052882,南電凱基96購02  ,0,0,0,0,0,0,0,0,0,356000,0,0,0,1173000,817000,356000,356000
2402,毅嘉            ,535000,199000,336000,0,0,0,0,0,0,20000,20000,0,20000,0,0,0,356000
05660P,玉晶光第一96售01,0,0,0,0,0,0,0,0,0,355000,0,0,0,370000,15000,355000,355000
06666P,台積電日盛9A售02,0,0,0,0,0,0,0,0,0,354000,0,0,0,372000,18000,354000,354000
6592,和潤企業        ,389000,35000,354000,0,0,0,0,0,0,0,0,0,0,0,0,0,354000
04760P,旺宏凱基94售02  ,0,0,0,0,0,0,0,0,0,353000,0,0,0,378000,25000,353000,353000
048079,燿華日盛93購01  ,0,0,0,0,0,0,0,0,0,350000,0,0,0,350000,0,350000,350000
04544P,欣興富邦96售02  ,0,0,0,0,0,0,0,0,0,350000,0,0,0,350000,0,350000,350000
053150,聯發科元大96購11,0,0,0,0,0,0,0,0,0,350000,0,0,0,650000,300000,350000,350000
054372,南亞科中信96購01,0,0,0,0,0,0,0,0,0,350000,0,0,0,350000,0,350000,350000
054275,華通群益97購03  ,0,0,0,0,0,0,0,0,0,350000,0,0,0,350000,0,350000,350000
052668,聯發科群益97購01,0,0,0,0,0,0,0,0,0,349000,0,0,0,349000,0,349000,349000
054811,裕隆元大9A購01  ,0,0,0,0,0,0,0,0,0,349000,0,0,0,1026000,677000,349000,349000
6202,盛群            ,1642000,1233000,409000,0,0,0,0,0,0,-62000,31000,51000,-20000,0,42000,-42000,347000
1218,泰山            ,630000,284000,346000,0,0,0,0,0,0,0,0,0,0,0,0,0,346000
1305,華夏            ,633000,292000,341000,0,0,0,0,0,0,5000,6000,1000,5000,0,0,0,346000
037536,道瓊反元富93購01,0,0,0,0,0,0,0,0,0,345000,0,0,0,345000,0,345000,345000
6288,聯嘉            ,485000,139000,346000,0,0,0,0,0,0,-1000,11000,12000,-1000,0,0,0,345000
4137,麗豐-KY         ,384000,68000,316000,0,0,0,1000,0,1000,28000,1000,1000,0,28000,0,28000,345000
6558,興能高          ,448000,105000,343000,0,0,0,0,0,0,0,0,0,0,0,0,0,343000
2498,宏達電          ,1532000,1399000,133000,0,0,0,0,0,0,210000,131000,52000,79000,219000,88000,131000,343000
8996,高力            ,1274000,485000,789000,0,0,0,191000,537000,-346000,-101000,1000,102000,-101000,0,0,0,342000
2801,彰銀            ,7683000,7393240,289760,0,0,0,10000,0,10000,40000,101000,35000,66000,2000,28000,-26000,339760
04957P,上証2X凱基96售02,0,0,0,0,0,0,0,0,0,338000,0,0,0,478000,140000,338000,338000
04729P,臺股指中信96售01,0,0,0,0,0,0,0,0,0,337000,0,0,0,357000,20000,337000,337000
04966P,台表科元大94售04,0,0,0,0,0,0,0,0,0,336000,0,0,0,336000,0,336000,336000
057415,和碩日盛98購01  ,0,0,0,0,0,0,0,0,0,335000,0,0,0,593000,258000,335000,335000
04888P,臺股指凱基95售03,0,0,0,0,0,0,0,0,0,335000,0,0,0,365000,30000,335000,335000
055008,隆達元富97購01  ,0,0,0,0,0,0,0,0,0,335000,0,0,0,375000,40000,335000,335000
056055,國巨元大97購15  ,0,0,0,0,0,0,0,0,0,335000,0,0,0,438000,103000,335000,335000
1590,亞德客-KY       ,1278000,1018800,259200,0,0,0,97000,78000,19000,56000,3000,1000,2000,63000,9000,54000,334200
03638C,T50反1元大94牛03,0,0,0,0,0,0,0,0,0,334000,0,0,0,435000,101000,334000,334000
054888,泰碩統一97購01  ,0,0,0,0,0,0,0,0,0,334000,0,0,0,930000,596000,334000,334000
06370P,貿聯凱基97售03  ,0,0,0,0,0,0,0,0,0,334000,0,0,0,334000,0,334000,334000
050521,聯發科元大94購15,0,0,0,0,0,0,0,0,0,333000,0,0,0,594000,261000,333000,333000
04682P,臺股指統一96售01,0,0,0,0,0,0,0,0,0,331000,0,0,0,331000,0,331000,331000
06855P,聯發科富邦9A售01,0,0,0,0,0,0,0,0,0,331000,0,0,0,365000,34000,331000,331000
057224,和碩日盛9A購01  ,0,0,0,0,0,0,0,0,0,330000,0,0,0,391000,61000,330000,330000
041527,T50反1中信96購01,0,0,0,0,0,0,0,0,0,330000,0,0,0,525000,195000,330000,330000
049926,智易元大95購02  ,0,0,0,0,0,0,0,0,0,330000,0,0,0,330000,0,330000,330000
054943,群光元大97購01  ,0,0,0,0,0,0,0,0,0,330000,0,0,0,407000,77000,330000,330000
06211P,鴻海元大98售04  ,0,0,0,0,0,0,0,0,0,328000,0,0,0,359000,31000,328000,328000
6668,中揚光          ,408000,74000,334000,0,0,0,0,0,0,-6000,8000,14000,-6000,0,0,0,328000
047504,滬深2X國票9A購01,0,0,0,0,0,0,0,0,0,326000,0,0,0,867000,541000,326000,326000
051983,道瓊反元大95購01,0,0,0,0,0,0,0,0,0,326000,0,0,0,365000,39000,326000,326000
050098,嘉聯益國泰95購02,0,0,0,0,0,0,0,0,0,325000,0,0,0,445000,120000,325000,325000
3515,華擎            ,701000,438000,263000,0,0,0,0,0,0,61000,50000,60000,-10000,78000,7000,71000,324000
6213,聯茂            ,987000,590000,397000,0,0,0,0,543000,-543000,467000,422000,212000,210000,290000,33000,257000,321000
06148P,台積電元大97售17,0,0,0,0,0,0,0,0,0,321000,0,0,0,380000,59000,321000,321000
06411P,晶相光永豐97售03,0,0,0,0,0,0,0,0,0,321000,0,0,0,557000,236000,321000,321000
056972,祥碩永豐98購02  ,0,0,0,0,0,0,0,0,0,320000,0,0,0,425000,105000,320000,320000
04898P,瑞儀中信95售01  ,0,0,0,0,0,0,0,0,0,320000,0,0,0,331000,11000,320000,320000
054348,康控國票97購03  ,0,0,0,0,0,0,0,0,0,320000,0,0,0,331000,11000,320000,320000
06405P,億光元富97售02  ,0,0,0,0,0,0,0,0,0,320000,0,0,0,340000,20000,320000,320000
8081,致新            ,408000,200000,208000,0,0,0,0,0,0,112000,0,0,0,116000,4000,112000,320000
055260,晶相光統一98購01,0,0,0,0,0,0,0,0,0,319000,0,0,0,358000,39000,319000,319000
03399P,欣興中信02售03  ,0,0,0,0,0,0,0,0,0,318000,0,0,0,495000,177000,318000,318000
06724P,台灣50國票98售01,0,0,0,0,0,0,0,0,0,318000,0,0,0,320000,2000,318000,318000
08653P,台灣50凱基96售07,0,0,0,0,0,0,0,0,0,317000,0,0,0,1670000,1353000,317000,317000
020008,元大特股高息N   ,0,0,0,0,0,0,0,0,0,316000,0,0,0,345000,29000,316000,316000
4414,如興            ,592000,277000,315000,0,0,0,0,0,0,0,0,0,0,0,0,0,315000
6669,緯穎            ,649000,409000,240000,0,0,0,94000,109000,-15000,87000,46000,7000,39000,54000,6000,48000,312000
056725,鴻海國票99購03  ,0,0,0,0,0,0,0,0,0,310000,0,0,0,330000,20000,310000,310000
04890P,台積電元大95售05,0,0,0,0,0,0,0,0,0,310000,0,0,0,420000,110000,310000,310000
049950,南亞科群益94購02,0,0,0,0,0,0,0,0,0,310000,0,0,0,310000,0,310000,310000
00678,群益NBI生技     ,77000,11000,66000,0,0,0,0,0,0,243000,0,0,0,243000,0,243000,309000
3518,柏騰            ,373000,65000,308000,0,0,0,0,0,0,0,8000,8000,0,0,0,0,308000
3413,京鼎            ,842000,292000,550000,0,0,0,0,213000,-213000,-29000,6000,15000,-9000,8000,28000,-20000,308000
06555P,臺股指元大99售07,0,0,0,0,0,0,0,0,0,307000,0,0,0,307000,0,307000,307000
049906,光寶科元大94購03,0,0,0,0,0,0,0,0,0,306000,0,0,0,398000,92000,306000,306000
047689,瑞昱富邦97購01  ,0,0,0,0,0,0,0,0,0,305000,0,0,0,340000,35000,305000,305000
051597,T50反1中信99購02,0,0,0,0,0,0,0,0,0,305000,0,0,0,340000,35000,305000,305000
2851,中再保          ,347000,45000,302000,0,0,0,0,0,0,1000,1000,0,1000,0,0,0,303000
6451,訊芯-KY         ,1057000,342000,715000,0,0,0,0,437000,-437000,25000,14000,16000,-2000,44000,17000,27000,303000
05214P,台積電國票97售02,0,0,0,0,0,0,0,0,0,302000,0,0,0,302000,0,302000,302000
05331P,上証2X國票96售01,0,0,0,0,0,0,0,0,0,301000,0,0,0,301000,0,301000,301000
06508P,台灣50統一98售01,0,0,0,0,0,0,0,0,0,301000,0,0,0,1025000,724000,301000,301000
048335,和大元大93購03  ,0,0,0,0,0,0,0,0,0,300000,0,0,0,300000,0,300000,300000
054038,T50反1元大98購04,0,0,0,0,0,0,0,0,0,300000,0,0,0,300000,0,300000,300000
055159,玉晶光元大98購05,0,0,0,0,0,0,0,0,0,300000,0,0,0,410000,110000,300000,300000
06359P,上銀群益97售03  ,0,0,0,0,0,0,0,0,0,300000,0,0,0,308000,8000,300000,300000
03546P,欣興群益02售12  ,0,0,0,0,0,0,0,0,0,299000,0,0,0,299000,0,299000,299000
049213,滬深2X國票94購02,0,0,0,0,0,0,0,0,0,298000,0,0,0,301000,3000,298000,298000
049966,旺宏國票95購02  ,0,0,0,0,0,0,0,0,0,296000,0,0,0,499000,203000,296000,296000
053474,聯發科元大97購06,0,0,0,0,0,0,0,0,0,296000,0,0,0,307000,11000,296000,296000
052451,旭富元大95購02  ,0,2000,-2000,0,0,0,0,0,0,297000,0,0,0,686000,389000,297000,295000
05632P,大立光群益96售02,0,0,0,0,0,0,0,0,0,295000,0,0,0,298000,3000,295000,295000
06237P,台積電元大97售26,0,0,0,0,0,0,0,0,0,295000,0,0,0,696000,401000,295000,295000
9933,中鼎            ,637000,347000,290000,0,0,0,0,0,0,5000,7000,2000,5000,0,0,0,295000
054627,義隆凱基98購01  ,0,0,0,0,0,0,0,0,0,294000,0,0,0,294000,0,294000,294000
2390,云辰            ,532000,238000,294000,0,0,0,0,0,0,0,12000,12000,0,0,0,0,294000
053537,玉晶光永豐98購02,0,0,0,0,0,0,0,0,0,293000,0,0,0,989000,696000,293000,293000
054981,國巨元富97購02  ,0,0,0,0,0,0,0,0,0,291000,0,0,0,302000,11000,291000,291000
06326P,鴻海中信01售01  ,0,0,0,0,0,0,0,0,0,291000,0,0,0,359000,68000,291000,291000
053430,樺漢永豐96購01  ,0,0,0,0,0,0,0,0,0,290000,0,0,0,300000,10000,290000,290000
06196P,元上證元大97售01,0,0,0,0,0,0,0,0,0,290000,0,0,0,290000,0,290000,290000
6533,晶心科          ,385000,95000,290000,0,0,0,0,0,0,0,3000,3000,0,0,0,0,290000
06996P,臺股指凱基99售17,0,0,0,0,0,0,0,0,0,289000,0,0,0,475000,186000,289000,289000
05062P,大立光富邦98售03,0,0,0,0,0,0,0,0,0,287000,0,0,0,295000,8000,287000,287000
1464,得力            ,331000,44000,287000,0,0,0,0,0,0,0,0,0,0,0,0,0,287000
06058P,玉晶光凱基97售04,0,0,0,0,0,0,0,0,0,285000,0,0,0,319000,34000,285000,285000
6531,愛普            ,664000,413000,251000,0,0,0,0,0,0,34000,70000,36000,34000,0,0,0,285000
2836,高雄銀          ,624000,350000,274000,0,0,0,0,0,0,10000,10000,0,10000,0,0,0,284000
06597P,國巨富邦9A售05  ,0,0,0,0,0,0,0,0,0,284000,0,0,0,291000,7000,284000,284000
06858P,道瓊指中信9B售01,0,0,0,0,0,0,0,0,0,282000,0,0,0,294000,12000,282000,282000
2905,三商            ,423000,148000,275000,0,0,0,0,0,0,6000,6000,0,6000,0,0,0,281000
056710,漢唐永豐98購01  ,0,0,0,0,0,0,0,0,0,280000,0,0,0,280000,0,280000,280000
054708,華通統一97購02  ,0,0,0,0,0,0,0,0,0,280000,0,0,0,280000,0,280000,280000
05580P,美律凱基96售03  ,0,0,0,0,0,0,0,0,0,280000,0,0,0,326000,46000,280000,280000
08388P,台灣50中信03售09,0,0,0,0,0,0,0,0,0,280000,0,0,0,310000,30000,280000,280000
06308P,國巨元富97售06  ,0,0,0,0,0,0,0,0,0,280000,0,0,0,749000,469000,280000,280000
4904,遠傳            ,3633000,3355000,278000,0,0,0,4000,0,4000,-3000,23000,26000,-3000,0,0,0,279000
04028P,燿華凱基94售02  ,0,0,0,0,0,0,0,0,0,278000,0,0,0,390000,112000,278000,278000
052420,道瓊反國票9B購01,0,0,0,0,0,0,0,0,0,277000,0,0,0,304000,27000,277000,277000
03648C,T50反1元大96牛07,0,0,0,0,0,0,0,0,0,276000,0,0,0,321000,45000,276000,276000
04159P,滬深2X中信95售08,0,0,0,0,0,0,0,0,0,275000,0,0,0,330000,55000,275000,275000
049413,台達電凱基94購06,0,0,0,0,0,0,0,0,0,275000,0,0,0,275000,0,275000,275000
049636,上証反凱基9A購01,0,0,0,0,0,0,0,0,0,274000,0,0,0,289000,15000,274000,274000
052594,友訊群益98購01  ,0,0,0,0,0,0,0,0,0,274000,0,0,0,489000,215000,274000,274000
06375P,矽力元大97售06  ,0,0,0,0,0,0,0,0,0,274000,0,0,0,378000,104000,274000,274000
055237,晶豪科台新97購01,0,0,0,0,0,0,0,0,0,273000,0,0,0,273000,0,273000,273000
4977,眾達-KY         ,617000,529000,88000,0,0,0,172000,0,172000,13000,106000,96000,10000,4000,1000,3000,273000
054232,台積電群益96購12,0,0,0,0,0,0,0,0,0,270000,0,0,0,310000,40000,270000,270000
06247P,同欣電元富97售02,0,0,0,0,0,0,0,0,0,269000,0,0,0,308000,39000,269000,269000
06455P,上銀統一99售03  ,0,0,0,0,0,0,0,0,0,269000,0,0,0,269000,0,269000,269000
2049,上銀            ,2167660,1957718,209942,0,0,0,65000,55000,10000,49000,98000,92000,6000,67000,24000,43000,268942
06307P,聚陽元富97售02  ,0,0,0,0,0,0,0,0,0,268000,0,0,0,378000,110000,268000,268000
045869,滬深2X元富95購01,0,0,0,0,0,0,0,0,0,267000,0,0,0,495000,228000,267000,267000
050797,聯發科中信99購01,0,0,0,0,0,0,0,0,0,267000,0,0,0,412000,145000,267000,267000
06622P,牧德元大98售01  ,0,0,0,0,0,0,0,0,0,267000,0,0,0,287000,20000,267000,267000
2002,中鋼            ,8661000,8465000,196000,0,0,0,16000,0,16000,54000,106000,82000,24000,30000,0,30000,266000
057722,臺股指元富98購01,0,0,0,0,0,0,0,0,0,265000,0,0,0,265000,0,265000,265000
1460,宏遠            ,287000,23000,264000,0,0,0,0,0,0,0,0,0,0,0,0,0,264000
04784P,超眾元富94售01  ,0,0,0,0,0,0,0,0,0,263000,0,0,0,603000,340000,263000,263000
3557,嘉威            ,303000,41000,262000,0,0,0,0,0,0,1000,1000,0,1000,0,0,0,263000
053969,瑞昱元大97購01  ,0,0,0,0,0,0,0,0,0,262000,0,0,0,362000,100000,262000,262000
044643,滬深2X群益96購01,0,0,0,0,0,0,0,0,0,261000,0,0,0,352000,91000,261000,261000
00706L,元大S&P日圓正2  ,0,0,0,0,0,0,0,0,0,261000,0,0,0,384000,123000,261000,261000
2316,楠梓電          ,858000,692000,166000,0,0,0,0,0,0,94800,1000,2200,-1200,98000,2000,96000,260800
052591,康友永豐97購01  ,0,0,0,0,0,0,0,0,0,260000,0,0,0,270000,10000,260000,260000
053612,T50反1群益96購01,0,0,0,0,0,0,0,0,0,260000,0,0,0,493000,233000,260000,260000
06835P,台灣50國票9A售01,0,0,0,0,0,0,0,0,0,260000,0,0,0,260000,0,260000,260000
06613P,華新科富邦9A售03,0,0,0,0,0,0,0,0,0,259000,0,0,0,528000,269000,259000,259000
056592,台積電元富98購01,0,0,0,0,0,0,0,0,0,258000,0,0,0,1880000,1622000,258000,258000
05906P,國巨元富96售05  ,0,0,0,0,0,0,0,0,0,257000,0,0,0,257000,0,257000,257000
050919,台積電凱基95購03,0,0,0,0,0,0,0,0,0,257000,0,0,0,529000,272000,257000,257000
5203,訊連            ,432000,116000,316000,0,0,0,0,0,0,-59000,23000,35000,-12000,11000,58000,-47000,257000
058261,大立光富邦03購01,0,0,0,0,0,0,0,0,0,256000,0,0,0,300000,44000,256000,256000
057300,訊連永豐98購01  ,0,0,0,0,0,0,0,0,0,256000,0,0,0,322000,66000,256000,256000
06783P,亞光元大98售03  ,0,0,0,0,0,0,0,0,0,256000,0,0,0,318000,62000,256000,256000
053348,彩晶國票97購02  ,0,0,0,0,0,0,0,0,0,254000,0,0,0,254000,0,254000,254000
4739,康普            ,306000,52000,254000,0,0,0,0,0,0,0,0,0,0,0,0,0,254000
046771,聯發科國泰94購02,0,0,0,0,0,0,0,0,0,253000,0,0,0,271000,18000,253000,253000
049378,聯詠元大94購02  ,0,0,0,0,0,0,0,0,0,253000,0,0,0,313000,60000,253000,253000
3530,晶相光          ,631000,358000,273000,0,0,0,0,0,0,-20000,21000,0,21000,116000,157000,-41000,253000
06753P,智邦富邦98售03  ,0,0,0,0,0,0,0,0,0,253000,0,0,0,269000,16000,253000,253000
06283P,祥碩永豐97售01  ,0,0,0,0,0,0,0,0,0,253000,0,0,0,300000,47000,253000,253000
06123P,玉晶光元大97售04,0,0,0,0,0,0,0,0,0,253000,0,0,0,448000,195000,253000,253000
06766P,玉晶光元大99售10,0,0,0,0,0,0,0,0,0,252000,0,0,0,266000,14000,252000,252000
057213,華邦電群益98購01,0,0,0,0,0,0,0,0,0,251000,0,0,0,297000,46000,251000,251000
050602,訊芯國泰96購01  ,0,0,0,0,0,0,0,0,0,250000,0,0,0,250000,0,250000,250000
07018P,台灣50統一9B售01,0,0,0,0,0,0,0,0,0,250000,0,0,0,250000,0,250000,250000
06617P,智邦元大98售03  ,0,0,0,0,0,0,0,0,0,250000,0,0,0,306000,56000,250000,250000
053080,力山元大96購02  ,0,0,0,0,0,0,0,0,0,249000,0,0,0,250000,1000,249000,249000
054120,奇力新永豐96購01,0,0,0,0,0,0,0,0,0,249000,0,0,0,250000,1000,249000,249000
06837P,上銀統一9A售02  ,0,0,0,0,0,0,0,0,0,248000,0,0,0,249000,1000,248000,248000
050778,瑞儀元大96購01  ,0,0,0,0,0,0,0,0,0,247000,0,0,0,247000,0,247000,247000
051978,泰碩凱基96購01  ,0,0,0,0,0,0,0,0,0,247000,0,0,0,301000,54000,247000,247000
06394P,台積電元大97售28,0,0,0,0,0,0,0,0,0,247000,0,0,0,491000,244000,247000,247000
05925P,晶技永豐96售03  ,0,0,0,0,0,0,0,0,0,246000,0,0,0,295000,49000,246000,246000
055289,泰碩元大98購01  ,0,0,0,0,0,0,0,0,0,246000,0,0,0,275000,29000,246000,246000
03420B,臺股指元大95熊31,0,0,0,0,0,0,0,0,0,245000,0,0,0,380000,135000,245000,245000
053996,晶相光群益97購01,0,0,0,0,0,0,0,0,0,244000,0,0,0,612000,368000,244000,244000
1201,味全            ,494000,245000,249000,0,0,0,0,0,0,-5000,3000,0,3000,5000,13000,-8000,244000
054665,華通元富97購02  ,0,0,0,0,0,0,0,0,0,243000,0,0,0,391000,148000,243000,243000
5225,東科-KY         ,365000,120000,245000,0,0,0,0,0,0,-2000,0,2000,-2000,0,0,0,243000
05977P,旺宏永豐96售06  ,0,0,0,0,0,0,0,0,0,242000,0,0,0,539000,297000,242000,242000
05040P,聯發科凱基95售05,0,0,0,0,0,0,0,0,0,242000,0,0,0,242000,0,242000,242000
2485,兆赫            ,394000,203000,191000,0,0,0,0,0,0,50000,25000,2000,23000,27000,0,27000,241000
05772P,景碩凱基96售02  ,0,0,0,0,0,0,0,0,0,240000,0,0,0,320000,80000,240000,240000
049808,聯詠元大94購03  ,0,0,0,0,0,0,0,0,0,240000,0,0,0,250000,10000,240000,240000
049870,南電兆豐94購01  ,0,0,0,0,0,0,0,0,0,240000,0,0,0,450000,210000,240000,240000
047629,深中小元大96購01,0,0,0,0,0,0,0,0,0,240000,0,0,0,430000,190000,240000,240000
1308,亞聚            ,430000,191000,239000,0,0,0,0,0,0,1000,1000,0,1000,0,0,0,240000
06185P,台表科元大97售05,0,0,0,0,0,0,0,0,0,240000,0,0,0,285000,45000,240000,240000
057916,國巨凱基98購13  ,0,0,0,0,0,0,0,0,0,239000,0,0,0,240000,1000,239000,239000
04978P,台表科凱基94售02,0,0,0,0,0,0,0,0,0,237000,0,0,0,237000,0,237000,237000
05984P,台積電統一98售01,0,0,0,0,0,0,0,0,0,236000,0,0,0,249000,13000,236000,236000
04961P,貿聯凱基94售03  ,0,0,0,0,0,0,0,0,0,236000,0,0,0,236000,0,236000,236000
06645P,上銀元大98售05  ,0,0,0,0,0,0,0,0,0,235000,0,0,0,287000,52000,235000,235000
048627,T50反1元大96購02,0,0,0,0,0,0,0,0,0,234000,0,0,0,234000,0,234000,234000
08679P,台灣50元大01售15,0,0,0,0,0,0,0,0,0,234000,0,0,0,234000,0,234000,234000
051155,聯發科國泰96購01,0,0,0,0,0,0,0,0,0,233000,0,0,0,517000,284000,233000,233000
05867P,友達兆豐97售02  ,0,0,0,0,0,0,0,0,0,231000,0,0,0,325000,94000,231000,231000
052826,嘉聯益永豐96購01,0,0,0,0,0,0,0,0,0,231000,0,0,0,231000,0,231000,231000
2103,台橡            ,406000,180000,226000,0,0,0,0,0,0,5000,7000,2000,5000,0,0,0,231000
054656,深中小元大97購01,0,0,0,0,0,0,0,0,0,230000,0,0,0,240000,10000,230000,230000
05450P,臺股指元大95售27,0,0,0,0,0,0,0,0,0,230000,0,0,0,230000,0,230000,230000
05763P,致新永豐96售01  ,0,0,0,0,0,0,0,0,0,229000,0,0,0,229000,0,229000,229000
056811,健策統一9B購01  ,0,0,0,0,0,0,0,0,0,229000,0,0,0,250000,21000,229000,229000
056193,聯發科富邦99購08,0,0,0,0,0,0,0,0,0,229000,0,0,0,471000,242000,229000,229000
06031P,新光金兆豐96售02,0,0,0,0,0,0,0,0,0,228000,0,0,0,228000,0,228000,228000
054122,康友永豐96購01  ,0,0,0,0,0,0,0,0,0,228000,0,0,0,426000,198000,228000,228000
9941,裕融            ,303000,78000,225000,0,0,0,1000,0,1000,1000,2000,1000,1000,0,0,0,227000
06504P,麗豐國票99售02  ,0,0,0,0,0,0,0,0,0,226000,0,0,0,286000,60000,226000,226000
053039,聯發科凱基96購11,0,0,0,0,0,0,0,0,0,225000,0,0,0,225000,0,225000,225000
06752P,訊芯凱基98售05  ,0,0,0,0,0,0,0,0,0,225000,0,0,0,299000,74000,225000,225000
06016P,京元電凱基96售03,0,0,0,0,0,0,0,0,0,224000,0,0,0,379000,155000,224000,224000
04747P,臺股指元大94售22,0,0,0,0,0,0,0,0,0,224000,0,0,0,227000,3000,224000,224000
049685,T50反1元大94購01,0,0,0,0,0,0,0,0,0,223000,0,0,0,250000,27000,223000,223000
05231P,GIS群益95售03   ,0,0,0,0,0,0,0,0,0,223000,0,0,0,238000,15000,223000,223000
05649P,矽創國票97售03  ,0,0,0,0,0,0,0,0,0,222000,0,0,0,222000,0,222000,222000
055522,道瓊反群益01購01,0,0,0,0,0,0,0,0,0,222000,0,0,0,222000,0,222000,222000
05509P,智邦元富96售02  ,0,0,0,0,0,0,0,0,0,221000,0,0,0,239000,18000,221000,221000
06651P,華新科元大99售09,0,0,0,0,0,0,0,0,0,221000,0,0,0,362000,141000,221000,221000
04655P,臺股指凱基94售14,0,0,0,0,0,0,0,0,0,220000,0,0,0,230000,10000,220000,220000
051248,華固元大95購01  ,0,0,0,0,0,0,0,0,0,220000,0,0,0,220000,0,220000,220000
05589P,大立光中信9A售01,0,0,0,0,0,0,0,0,0,220000,0,0,0,320000,100000,220000,220000
08897P,國巨群益01售10  ,0,0,0,0,0,0,0,0,0,220000,0,0,0,220000,0,220000,220000
050431,聯發科凱基94購18,0,0,0,0,0,0,0,0,0,219000,0,0,0,449000,230000,219000,219000
06832P,玉晶光凱基98售03,0,0,0,0,0,0,0,0,0,219000,0,0,0,249000,30000,219000,219000
03765P,大立光元富96售01,0,0,0,0,0,0,0,0,0,218000,0,0,0,463000,245000,218000,218000
056013,T50反1群益97購01,0,0,0,0,0,0,0,0,0,218000,0,0,0,396000,178000,218000,218000
048499,達運元大96購01  ,0,0,0,0,0,0,0,0,0,217000,0,0,0,319000,102000,217000,217000
3443,創意            ,325241,98000,227241,0,0,0,0,0,0,-11000,1000,20000,-19000,19000,11000,8000,216241
05979P,華新科中信96售02,0,0,0,0,0,0,0,0,0,215000,0,0,0,215000,0,215000,215000
054591,GIS國泰98購01   ,0,0,0,0,0,0,0,0,0,215000,0,0,0,215000,0,215000,215000
051962,晶相光永豐95購02,0,0,0,0,0,0,0,0,0,214000,0,0,0,352000,138000,214000,214000
053371,滬深2X元大99購01,0,0,0,0,0,0,0,0,0,213000,0,0,0,233000,20000,213000,213000
05807P,泰鼎永豐96售03  ,0,0,0,0,0,0,0,0,0,212000,0,0,0,304000,92000,212000,212000
051506,台積電元富95購06,0,0,0,0,0,0,0,0,0,212000,0,0,0,212000,0,212000,212000
053813,友達群益9A購03  ,0,0,0,0,0,0,0,0,0,212000,0,0,0,325000,113000,212000,212000
05924P,超眾元富96售04  ,0,0,0,0,0,0,0,0,0,211000,0,0,0,272000,61000,211000,211000
06355P,聯茂永豐97售02  ,0,0,0,0,0,0,0,0,0,211000,0,0,0,311000,100000,211000,211000
051048,臺指反群益96購01,0,0,0,0,0,0,0,0,0,210000,0,0,0,350000,140000,210000,210000
056052,T50反1元大97購06,0,0,0,0,0,0,0,0,0,210000,0,0,0,210000,0,210000,210000
06742P,可成富邦99售02  ,0,0,0,0,0,0,0,0,0,210000,0,0,0,210000,0,210000,210000
6591,動力-KY         ,255000,45000,210000,0,0,0,0,0,0,0,4000,4000,0,0,0,0,210000
06653P,美食元大98售02  ,0,0,0,0,0,0,0,0,0,209000,0,0,0,424000,215000,209000,209000
06492P,上銀永豐98售01  ,0,0,0,0,0,0,0,0,0,209000,0,0,0,239000,30000,209000,209000
05837P,臺股指富邦96售04,0,0,0,0,0,0,0,0,0,208000,0,0,0,208000,0,208000,208000
05767P,國巨凱基96售11  ,0,0,0,0,0,0,0,0,0,208000,0,0,0,268000,60000,208000,208000
6456,GIS-KY          ,633000,436000,197000,0,0,0,0,0,0,11000,3000,5000,-2000,24000,11000,13000,208000
03643C,臺股指元富99牛04,0,0,0,0,0,0,0,0,0,207000,0,0,0,210000,3000,207000,207000
06227P,大立光群益97售04,0,0,0,0,0,0,0,0,0,207000,0,0,0,218000,11000,207000,207000
06140P,華新科群益97售06,0,0,0,0,0,0,0,0,0,207000,0,0,0,247000,40000,207000,207000
049785,華新科兆豐95購01,0,0,0,0,0,0,0,0,0,206000,0,0,0,682000,476000,206000,206000
06490P,鴻海富邦99售02  ,0,0,0,0,0,0,0,0,0,206000,0,0,0,216000,10000,206000,206000
3029,零壹            ,411000,205000,206000,0,0,0,0,0,0,0,0,0,0,0,0,0,206000
4961,天鈺            ,279000,74000,205000,0,0,0,0,0,0,0,0,0,0,0,0,0,205000
06312P,樺漢元富97售02  ,0,0,0,0,0,0,0,0,0,205000,0,0,0,827000,622000,205000,205000
05766P,A50正2凱基99售01,0,0,0,0,0,0,0,0,0,204000,0,0,0,255000,51000,204000,204000
05844P,旺宏元大96售07  ,0,0,0,0,0,0,0,0,0,204000,0,0,0,444000,240000,204000,204000
00654R,富邦印度反1     ,95000,0,95000,0,0,0,0,0,0,109000,0,0,0,122000,13000,109000,204000
050702,崇越凱基94購01  ,0,0,0,0,0,0,0,0,0,204000,0,0,0,210000,6000,204000,204000
053459,康控國泰97購01  ,0,0,0,0,0,0,0,0,0,204000,0,0,0,243000,39000,204000,204000
058278,FBVIX中信03購02 ,0,0,0,0,0,0,0,0,0,203000,0,0,0,469000,266000,203000,203000
052730,華新科國泰98購01,0,0,0,0,0,0,0,0,0,203000,0,0,0,203000,0,203000,203000
1513,中興電          ,1047000,851000,196000,0,0,0,0,0,0,7000,23000,16000,7000,0,0,0,203000
4919,新唐            ,432000,128000,304000,0,0,0,0,0,0,-101000,3000,1000,2000,17000,120000,-103000,203000
057527,億光元大98購01  ,0,0,0,0,0,0,0,0,0,202000,0,0,0,231000,29000,202000,202000
047769,大立光元大96購01,0,0,0,0,0,0,0,0,0,202000,0,0,0,202000,0,202000,202000
050254,大立光富邦96購02,0,0,0,0,0,0,0,0,0,202000,0,0,0,307000,105000,202000,202000
2486,一詮            ,234000,28000,206000,0,0,0,0,0,0,-4000,0,4000,-4000,0,0,0,202000
056812,泰鼎統一98購01  ,0,0,0,0,0,0,0,0,0,201000,0,0,0,349000,148000,201000,201000
052524,新光金元大9B購01,0,0,0,0,0,0,0,0,0,201000,0,0,0,201000,0,201000,201000
051429,智邦元富95購01  ,0,0,0,0,0,0,0,0,0,201000,0,0,0,285000,84000,201000,201000
06330P,南亞科群益97售03,0,0,0,0,0,0,0,0,0,201000,0,0,0,212000,11000,201000,201000
048865,世紀鋼群益94購01,0,0,0,0,0,0,0,0,0,200000,0,0,0,200000,0,200000,200000
046680,上証反群益95購01,0,0,0,0,0,0,0,0,0,200000,0,0,0,520000,320000,200000,200000
04546P,台積電元大94售09,0,0,0,0,0,0,0,0,0,200000,0,0,0,200000,0,200000,200000
04383P,泰鼎國泰95售01  ,0,0,0,0,0,0,0,0,0,200000,0,0,0,385000,185000,200000,200000
05095P,景碩元大95售01  ,0,0,0,0,0,0,0,0,0,200000,0,0,0,200000,0,200000,200000
050081,聯發科統一94購07,0,0,0,0,0,0,0,0,0,200000,0,0,0,200000,0,200000,200000
053124,聯發科凱基96購12,0,0,0,0,0,0,0,0,0,200000,0,0,0,200000,0,200000,200000
052285,康控凱基95購02  ,0,0,0,0,0,0,0,0,0,200000,0,0,0,200000,0,200000,200000
05209P,鴻海凱基96售09  ,0,0,0,0,0,0,0,0,0,200000,0,0,0,220000,20000,200000,200000
05374P,台積電國票96售07,0,0,0,0,0,0,0,0,0,200000,0,0,0,204000,4000,200000,200000
054853,TPK國票98購02   ,0,0,0,0,0,0,0,0,0,200000,0,0,0,200000,0,200000,200000
06819P,臺股指元富98售08,0,0,0,0,0,0,0,0,0,200000,0,0,0,200000,0,200000,200000
05077P,智易群益95售02  ,0,0,0,0,0,0,0,0,0,199000,0,0,0,209000,10000,199000,199000
054552,聯發科凱基98購03,0,0,0,0,0,0,0,0,0,199000,0,0,0,200000,1000,199000,199000
1905,華紙            ,619000,420000,199000,0,0,0,0,0,0,0,0,0,0,0,0,0,199000
00738U,元大道瓊白銀    ,32000,0,32000,0,0,0,0,0,0,166000,0,0,0,580000,414000,166000,198000
054495,滬深2X永豐97購02,0,0,0,0,0,0,0,0,0,198000,0,0,0,198000,0,198000,198000
058274,世紀鋼永豐99購01,0,0,0,0,0,0,0,0,0,197000,0,0,0,197000,0,197000,197000
04824P,亞泥中信94售02  ,0,0,0,0,0,0,0,0,0,197000,0,0,0,252000,55000,197000,197000
052713,智邦凱基96購01  ,0,0,0,0,0,0,0,0,0,197000,0,0,0,230000,33000,197000,197000
2355,敬鵬            ,351000,143000,208000,0,0,0,0,0,0,-11000,5000,15000,-10000,0,1000,-1000,197000
2832,台產            ,210000,13000,197000,0,0,0,0,0,0,0,0,0,0,0,0,0,197000
052101,滬深2X兆豐96購01,0,0,0,0,0,0,0,0,0,196000,0,0,0,196000,0,196000,196000
06238P,台積電元大98售07,0,0,0,0,0,0,0,0,0,196000,0,0,0,511000,315000,196000,196000
06735P,奇力新凱基98售07,0,0,0,0,0,0,0,0,0,196000,0,0,0,209000,13000,196000,196000
04912P,可成元富94售06  ,0,0,0,0,0,0,0,0,0,195000,0,0,0,214000,19000,195000,195000
056361,美律元大99購02  ,0,0,0,0,0,0,0,0,0,195000,0,0,0,280000,85000,195000,195000
055530,聯發科群益98購01,0,0,0,0,0,0,0,0,0,195000,0,0,0,304000,109000,195000,195000
06417P,台積電兆豐97售03,0,0,0,0,0,0,0,0,0,195000,0,0,0,323000,128000,195000,195000
06131P,京鼎元富97售02  ,0,0,0,0,0,0,0,0,0,195000,0,0,0,242000,47000,195000,195000
06957P,FBVIX凱基01售01 ,0,0,0,0,0,0,0,0,0,195000,0,0,0,209000,14000,195000,195000
2425,承啟            ,305000,110000,195000,0,0,0,0,0,0,0,8000,8000,0,0,0,0,195000
6141,柏承            ,292000,115000,177000,0,0,0,0,0,0,18000,19000,1000,18000,0,0,0,195000
9802,鈺齊-KY         ,1077000,1210000,-133000,0,0,0,196000,0,196000,132000,1000,1000,0,181000,49000,132000,195000
04553P,S&P正2中信95售01,0,0,0,0,0,0,0,0,0,194000,0,0,0,354000,160000,194000,194000
053523,T50反1中信9A購01,0,0,0,0,0,0,0,0,0,194000,0,0,0,234000,40000,194000,194000
050624,鈺齊元大94購01  ,0,0,0,0,0,0,0,0,0,194000,0,0,0,208000,14000,194000,194000
055144,T50反1元大97購03,0,0,0,0,0,0,0,0,0,194000,0,0,0,305000,111000,194000,194000
6414,樺漢            ,161000,77000,84000,0,0,0,91000,0,91000,19000,22000,29000,-7000,45000,19000,26000,194000
049708,滬深2X凱基94購02,0,0,0,0,0,0,0,0,0,193000,0,0,0,203000,10000,193000,193000
051305,訊連凱基96購01  ,0,0,0,0,0,0,0,0,0,193000,0,0,0,404000,211000,193000,193000
050172,臺指反元大98購02,0,0,0,0,0,0,0,0,0,192000,0,0,0,192000,0,192000,192000
9938,百和            ,677000,472000,205000,0,0,0,0,0,0,-13000,2000,1000,1000,5000,19000,-14000,192000
051957,旺宏台新95購02  ,0,0,0,0,0,0,0,0,0,191000,0,0,0,239000,48000,191000,191000
056924,亞光兆豐98購01  ,0,0,0,0,0,0,0,0,0,190000,0,0,0,190000,0,190000,190000
044402,景碩凱基93購01  ,0,0,0,0,0,0,0,0,0,190000,0,0,0,250000,60000,190000,190000
05295P,緯創凱基95售01  ,0,0,0,0,0,0,0,0,0,190000,0,0,0,200000,10000,190000,190000
06552P,茂林元大99售02  ,0,0,0,0,0,0,0,0,0,190000,0,0,0,435000,245000,190000,190000
05747P,漢唐群益96售03  ,0,0,0,0,0,0,0,0,0,189000,0,0,0,211000,22000,189000,189000
050455,貿聯元大94購02  ,0,0,0,0,0,0,0,0,0,188000,0,0,0,188000,0,188000,188000
053561,玉晶光國泰98購01,0,0,0,0,0,0,0,0,0,188000,0,0,0,478000,290000,188000,188000
051430,瑞昱元富95購02  ,0,0,0,0,0,0,0,0,0,188000,0,0,0,258000,70000,188000,188000
06602P,國巨統一99售02  ,0,0,0,0,0,0,0,0,0,188000,0,0,0,223000,35000,188000,188000
05930P,景碩康和96售01  ,0,0,0,0,0,0,0,0,0,187000,0,0,0,257000,70000,187000,187000
053525,台積電中信96購04,0,0,0,0,0,0,0,0,0,187000,0,0,0,281000,94000,187000,187000
054668,傳奇元富97購03  ,0,0,0,0,0,0,0,0,0,187000,0,0,0,252000,65000,187000,187000
05397P,大立光凱基96售08,0,0,0,0,0,0,0,0,0,187000,0,0,0,397000,210000,187000,187000
2351,順德            ,226000,40000,186000,0,0,0,0,0,0,1000,1000,0,1000,0,0,0,187000
3673,TPK-KY          ,1158000,1019000,139000,0,0,0,0,0,0,48000,66000,57000,9000,42000,3000,39000,187000
058323,泰鼎永豐9A購01  ,0,0,0,0,0,0,0,0,0,186000,0,0,0,186000,0,186000,186000
05590P,臺股指中信96售05,0,0,0,0,0,0,0,0,0,186000,0,0,0,346000,160000,186000,186000
055805,矽力永豐97購01  ,0,0,0,0,0,0,0,0,0,186000,0,0,0,208000,22000,186000,186000
06891P,緯穎富邦99售03  ,0,0,0,0,0,0,0,0,0,186000,0,0,0,228000,42000,186000,186000
055953,上銀元大97購09  ,0,0,0,0,0,0,0,0,0,185000,0,0,0,198000,13000,185000,185000
054005,旺宏統一97購04  ,0,0,0,0,0,0,0,0,0,185000,0,0,0,400000,215000,185000,185000
06904P,TPK凱基98售03   ,0,0,0,0,0,0,0,0,0,185000,0,0,0,185000,0,185000,185000
05072P,聯電元富95售02  ,0,0,0,0,0,0,0,0,0,184000,0,0,0,200000,16000,184000,184000
4725,信昌化          ,287000,102000,185000,0,0,0,0,0,0,-1000,0,1000,-1000,0,0,0,184000
05420P,大立光國泰97售03,0,0,0,0,0,0,0,0,0,183000,0,0,0,198000,15000,183000,183000
6239,力成            ,1935000,1745000,190000,0,0,0,13000,0,13000,-20000,6000,47000,-41000,55000,34000,21000,183000
052680,T50反1元大96購04,0,0,0,0,0,0,0,0,0,182000,0,0,0,182000,0,182000,182000
05402P,台郡永豐95售02  ,0,0,0,0,0,0,0,0,0,182000,0,0,0,182000,0,182000,182000
4560,強信-KY         ,274000,92000,182000,0,0,0,0,0,0,0,0,0,0,0,0,0,182000
05258P,臺股指凱基96售11,0,0,0,0,0,0,0,0,0,181000,0,0,0,201000,20000,181000,181000
053766,友達富邦97購01  ,0,0,0,0,0,0,0,0,0,181000,0,0,0,1000000,819000,181000,181000
3712,永崴投控        ,198000,17000,181000,0,0,0,0,0,0,0,0,0,0,0,0,0,181000
058545,義隆富邦9C購01  ,0,0,0,0,0,0,0,0,0,180000,0,0,0,200000,20000,180000,180000
05815P,台積電凱基97售06,0,0,0,0,0,0,0,0,0,180000,0,0,0,802000,622000,180000,180000
04913P,聯詠元富94售02  ,0,0,0,0,0,0,0,0,0,180000,0,0,0,190000,10000,180000,180000
043944,欣興兆豐93購02  ,0,0,0,0,0,0,0,0,0,180000,0,0,0,180000,0,180000,180000
04575P,新日興統一94售02,0,0,0,0,0,0,0,0,0,180000,0,0,0,286000,106000,180000,180000
051848,元金2X中信98購02,0,0,0,0,0,0,0,0,0,180000,0,0,0,200000,20000,180000,180000
050806,華新科日盛95購01,0,0,0,0,0,0,0,0,0,180000,0,0,0,180000,0,180000,180000
06488P,台積電元富98售05,0,0,0,0,0,0,0,0,0,180000,0,0,0,550000,370000,180000,180000
06701P,臺股指統一99售06,0,0,0,0,0,0,0,0,0,180000,0,0,0,180000,0,180000,180000
056580,泰鼎元大9A購01  ,0,0,0,0,0,0,0,0,0,178000,0,0,0,684000,506000,178000,178000
006206,元大上證50      ,287000,4000,283000,0,0,0,0,0,0,-105000,0,0,0,38000,143000,-105000,178000
04828P,聯發科凱基94售15,0,0,0,0,0,0,0,0,0,178000,0,0,0,181000,3000,178000,178000
050807,群臺反凱基95購01,0,0,0,0,0,0,0,0,0,178000,0,0,0,228000,50000,178000,178000
052644,聯發科永豐96購01,0,0,0,0,0,0,0,0,0,178000,0,0,0,178000,0,178000,178000
055716,致茂元大97購01  ,0,0,0,0,0,0,0,0,0,178000,0,0,0,183000,5000,178000,178000
06703P,新日興元富98售02,0,0,0,0,0,0,0,0,0,178000,0,0,0,188000,10000,178000,178000
06042P,華新科永豐96售04,0,0,0,0,0,0,0,0,0,176000,0,0,0,338000,162000,176000,176000
04223P,友達統一93售05  ,0,0,0,0,0,0,0,0,0,176000,0,0,0,176000,0,176000,176000
05618P,聯發科元富96售02,0,0,0,0,0,0,0,0,0,176000,0,0,0,176000,0,176000,176000
1795,美時            ,424000,263000,161000,0,0,0,14000,0,14000,1000,1000,0,1000,0,0,0,176000
3005,神基            ,938000,1927000,-989000,0,0,0,5000,0,5000,1160000,21000,15000,6000,1180000,26000,1154000,176000
055515,聚陽中信9A購01  ,0,0,0,0,0,0,0,0,0,175000,0,0,0,175000,0,175000,175000
8404,百和興業-KY     ,274000,98000,176000,0,0,0,0,0,0,-1000,0,1000,-1000,0,0,0,175000
06529P,貿聯富邦99售03  ,0,0,0,0,0,0,0,0,0,175000,0,0,0,236000,61000,175000,175000
06092P,嘉聯益統一97售01,0,0,0,0,0,0,0,0,0,175000,0,0,0,224000,49000,175000,175000
06378P,國巨統一97售08  ,0,0,0,0,0,0,0,0,0,175000,0,0,0,235000,60000,175000,175000
047780,友達中信96購01  ,0,0,0,0,0,0,0,0,0,174000,0,0,0,184000,10000,174000,174000
055190,華新科元富97購01,0,0,0,0,0,0,0,0,0,174000,0,0,0,329000,155000,174000,174000
06072P,牧德永豐97售01  ,0,0,0,0,0,0,0,0,0,174000,0,0,0,201000,27000,174000,174000
06149P,台積電元大97售18,0,0,0,0,0,0,0,0,0,174000,0,0,0,959000,785000,174000,174000
2484,希華            ,333000,159000,174000,0,0,0,0,0,0,0,0,0,0,0,0,0,174000
2388,威盛            ,296000,120000,176000,0,0,0,0,0,0,-3000,0,3000,-3000,0,0,0,173000
056933,國巨元富98購03  ,0,0,0,0,0,0,0,0,0,172000,0,0,0,322000,150000,172000,172000
06395P,台積電元大97售29,0,0,0,0,0,0,0,0,0,172000,0,0,0,202000,30000,172000,172000
6452,康友-KY         ,312000,129000,183000,0,0,0,0,0,0,-11000,1000,21000,-20000,53000,44000,9000,172000
03557P,欣興元大02售17  ,0,0,0,0,0,0,0,0,0,171000,0,0,0,171000,0,171000,171000
05260P,和碩元富95售02  ,0,0,0,0,0,0,0,0,0,171000,0,0,0,419000,248000,171000,171000
9105,泰金寶-DR       ,467000,296000,171000,0,0,0,0,0,0,0,0,0,0,0,0,0,171000
06434P,超眾群益98售02  ,0,0,0,0,0,0,0,0,0,171000,0,0,0,171000,0,171000,171000
056670,樺漢國票99購01  ,0,0,0,0,0,0,0,0,0,170000,0,0,0,288000,118000,170000,170000
03298P,台積電統一03售15,0,0,0,0,0,0,0,0,0,170000,0,0,0,170000,0,170000,170000
052046,漢唐凱基96購01  ,0,0,0,0,0,0,0,0,0,170000,0,0,0,170000,0,170000,170000
06164P,臺股指凱基97售04,0,0,0,0,0,0,0,0,0,170000,0,0,0,170000,0,170000,170000
04402P,TPK兆豐95售01   ,0,0,0,0,0,0,0,0,0,169000,0,0,0,179000,10000,169000,169000
05323P,瑞昱凱基96售02  ,0,0,0,0,0,0,0,0,0,169000,0,0,0,294000,125000,169000,169000
06732P,台灣50日盛9A售01,0,0,0,0,0,0,0,0,0,169000,0,0,0,169000,0,169000,169000
057212,台積電群益98購03,0,0,0,0,0,0,0,0,0,168000,0,0,0,299000,131000,168000,168000
040215,上証反凱基95購01,0,0,0,0,0,0,0,0,0,168000,0,0,0,198000,30000,168000,168000
05545P,台表科國泰98售01,0,0,0,0,0,0,0,0,0,168000,0,0,0,173000,5000,168000,168000
05229P,台積電群益95售05,0,0,0,0,0,0,0,0,0,167000,0,0,0,167000,0,167000,167000
06093P,華通元富97售03  ,0,0,0,0,0,0,0,0,0,167000,0,0,0,243000,76000,167000,167000
3605,宏致            ,253000,91000,162000,0,0,0,0,0,0,5000,5000,0,5000,0,0,0,167000
057110,立積群益98購01  ,0,0,0,0,0,0,0,0,0,166000,0,0,0,847000,681000,166000,166000
03651C,臺股指凱基97牛17,0,0,0,0,0,0,0,0,0,166000,0,0,0,166000,0,166000,166000
00686R,群益臺灣加權反1 ,0,0,0,0,0,0,0,0,0,166000,0,0,0,285000,119000,166000,166000
05449P,臺股指元大95售26,0,0,0,0,0,0,0,0,0,166000,0,0,0,166000,0,166000,166000
048595,儒鴻國票96購01  ,0,0,0,0,0,0,0,0,0,165000,0,0,0,250000,85000,165000,165000
051355,聯發科元大96購01,0,0,0,0,0,0,0,0,0,165000,0,0,0,165000,0,165000,165000
050368,國巨元大94購14  ,0,0,0,0,0,0,0,0,0,165000,0,0,0,351000,186000,165000,165000
050899,旭富元大95購01  ,0,0,0,0,0,0,0,0,0,165000,0,0,0,228000,63000,165000,165000
055412,旺宏富邦99購01  ,0,0,0,0,0,0,0,0,0,165000,0,0,0,166000,1000,165000,165000
2331,精英            ,345000,176000,169000,0,0,0,0,0,0,-4000,15000,19000,-4000,0,0,0,165000
047692,T50反1國票94購01,0,0,0,0,0,0,0,0,0,164000,0,0,0,184000,20000,164000,164000
04946P,華通元大94售04  ,0,0,0,0,0,0,0,0,0,164000,0,0,0,164000,0,164000,164000
051948,滬深2X元富9B購01,0,0,0,0,0,0,0,0,0,164000,0,0,0,545000,381000,164000,164000
05928P,華邦電康和96售01,0,0,0,0,0,0,0,0,0,163000,0,0,0,173000,10000,163000,163000
052804,淘帝元大96購01  ,0,0,0,0,0,0,0,0,0,163000,0,0,0,264000,101000,163000,163000
04215P,鴻海國票93售02  ,0,0,0,0,0,0,0,0,0,163000,0,0,0,163000,0,163000,163000
050451,嘉晶元大95購01  ,0,0,0,0,0,0,0,0,0,163000,0,0,0,354000,191000,163000,163000
06194P,台積電元富97售05,0,0,0,0,0,0,0,0,0,163000,0,0,0,270000,107000,163000,163000
05801P,正崴兆豐96售01  ,0,0,0,0,0,0,0,0,0,162000,0,0,0,163000,1000,162000,162000
05065P,燿華元大96售03  ,0,0,0,0,0,0,0,0,0,162000,0,0,0,217000,55000,162000,162000
057825,和碩元大98購02  ,0,0,0,0,0,0,0,0,0,161000,0,0,0,541000,380000,161000,161000
05110P,上銀統一95售01  ,0,0,0,0,0,0,0,0,0,161000,0,0,0,161000,0,161000,161000
053034,上海銀兆豐96購01,0,0,0,0,0,0,0,0,0,161000,0,0,0,161000,0,161000,161000
055688,力成凱基98購02  ,0,0,0,0,0,0,0,0,0,160000,0,0,0,160000,0,160000,160000
055011,元翎元富97購01  ,0,0,0,0,0,0,0,0,0,160000,0,0,0,186000,26000,160000,160000
054113,奇力新台新97購01,0,0,0,0,0,0,0,0,0,160000,0,0,0,190000,30000,160000,160000
06130P,玉晶光元富97售07,0,0,0,0,0,0,0,0,0,160000,0,0,0,183000,23000,160000,160000
050192,康控元大97購01  ,0,0,0,0,0,0,0,0,0,159000,0,0,0,239000,80000,159000,159000
06824P,台灣50國票99售02,0,0,0,0,0,0,0,0,0,159000,0,0,0,176000,17000,159000,159000
06995P,臺股指凱基99售16,0,0,0,0,0,0,0,0,0,159000,0,0,0,193000,34000,159000,159000
1315,達新            ,236000,77000,159000,0,0,0,0,0,0,0,0,0,0,0,0,0,159000
3018,同開            ,210000,51934,158066,0,0,0,0,0,0,0,0,0,0,0,0,0,158066
055401,亞光元富9A購01  ,0,0,0,0,0,0,0,0,0,158000,0,0,0,173000,15000,158000,158000
2723,美食-KY         ,688000,530000,158000,0,0,0,0,0,0,0,3000,1000,2000,4000,6000,-2000,158000
2606,裕民            ,675000,562000,113000,0,0,0,6000,0,6000,39000,41000,2000,39000,0,0,0,158000
6283,淳安            ,203000,46000,157000,0,0,0,0,0,0,1000,11000,10000,1000,0,0,0,158000
05682P,大立光元大98售03,0,0,0,0,0,0,0,0,0,157000,0,0,0,168000,11000,157000,157000
052923,台積電永豐96購02,0,0,0,0,0,0,0,0,0,157000,0,0,0,324000,167000,157000,157000
05248P,矽創群益96售01  ,0,0,0,0,0,0,0,0,0,157000,0,0,0,157000,0,157000,157000
053432,世紀鋼永豐96購02,0,0,0,0,0,0,0,0,0,157000,0,0,0,169000,12000,157000,157000
05885P,牧德統一96售01  ,0,0,0,0,0,0,0,0,0,156000,0,0,0,424000,268000,156000,156000
056051,T50反1元大97購05,0,0,0,0,0,0,0,0,0,156000,0,0,0,156000,0,156000,156000
05774P,臺股指凱基99售04,0,0,0,0,0,0,0,0,0,155000,0,0,0,244000,89000,155000,155000
057105,致茂群益9A購01  ,0,0,0,0,0,0,0,0,0,155000,0,0,0,353000,198000,155000,155000
05730P,臺股指凱基97售03,0,0,0,0,0,0,0,0,0,155000,0,0,0,155000,0,155000,155000
052747,京鼎元大97購01  ,0,0,0,0,0,0,0,0,0,155000,0,0,0,185000,30000,155000,155000
05283P,健鼎元大95售04  ,0,0,0,0,0,0,0,0,0,154000,0,0,0,154000,0,154000,154000
06809P,電子類群益98售03,0,0,0,0,0,0,0,0,0,154000,0,0,0,155000,1000,154000,154000
06419P,國巨統一97售09  ,0,0,0,0,0,0,0,0,0,154000,0,0,0,154000,0,154000,154000
055409,元黃金富邦01購01,0,0,0,0,0,0,0,0,0,153000,0,0,0,186000,33000,153000,153000
2392,正崴            ,685000,333000,352000,0,0,0,0,294000,-294000,95000,35000,16000,19000,77000,1000,76000,153000
05722P,玉晶光國票97售03,0,0,0,0,0,0,0,0,0,152000,0,0,0,300000,148000,152000,152000
04422P,玉晶光永豐94售03,0,0,0,0,0,0,0,0,0,152000,0,0,0,162000,10000,152000,152000
053889,致茂群益97購01  ,0,0,0,0,0,0,0,0,0,152000,0,0,0,423000,271000,152000,152000
06172P,台虹永豐97售02  ,0,0,0,0,0,0,0,0,0,151000,0,0,0,217000,66000,151000,151000
4976,佳凌            ,219000,68000,151000,0,0,0,0,0,0,0,1000,1000,0,0,0,0,151000
05790P,臺股指永昌96售07,0,0,0,0,0,0,0,0,0,150000,0,0,0,150000,0,150000,150000
04603P,訊芯凱基94售03  ,0,0,0,0,0,0,0,0,0,150000,0,0,0,200000,50000,150000,150000
047454,滬深2X群益96購03,0,0,0,0,0,0,0,0,0,150000,0,0,0,400000,250000,150000,150000
04891P,友達元大94售01  ,0,0,0,0,0,0,0,0,0,150000,0,0,0,150000,0,150000,150000
049440,T50反1統一94購04,0,0,0,0,0,0,0,0,0,150000,0,0,0,150000,0,150000,150000
049986,嘉澤凱基94購02  ,0,0,0,0,0,0,0,0,0,150000,0,0,0,210000,60000,150000,150000
049930,上海銀元大94購02,0,0,0,0,0,0,0,0,0,150000,0,0,0,236000,86000,150000,150000
050447,廣達元大94購01  ,0,0,0,0,0,0,0,0,0,150000,0,0,0,150000,0,150000,150000
05047P,強茂永豐95售02  ,0,0,0,0,0,0,0,0,0,150000,0,0,0,150000,0,150000,150000
051544,T50反1康和98購01,0,0,0,0,0,0,0,0,0,150000,0,0,0,150000,0,150000,150000
05028P,康控永豐95售02  ,0,0,0,0,0,0,0,0,0,150000,0,0,0,150000,0,150000,150000
055890,鴻海統一99購01  ,0,0,0,0,0,0,0,0,0,150000,0,0,0,185000,35000,150000,150000
06205P,台積電群益97售03,0,0,0,0,0,0,0,0,0,150000,0,0,0,150000,0,150000,150000
06465P,國巨統一98售04  ,0,0,0,0,0,0,0,0,0,150000,0,0,0,150000,0,150000,150000
058189,嘉澤永豐99購01  ,0,0,0,0,0,0,0,0,0,149000,0,0,0,149000,0,149000,149000
05721P,全新群益98售02  ,0,0,0,0,0,0,0,0,0,149000,0,0,0,169000,20000,149000,149000
057066,緯穎富邦99購01  ,0,0,0,0,0,0,0,0,0,149000,0,0,0,231000,82000,149000,149000
04676P,彩晶統一94售03  ,0,0,0,0,0,0,0,0,0,149000,0,0,0,149000,0,149000,149000
4532,瑞智            ,210000,61000,149000,0,0,0,0,0,0,0,0,0,0,0,0,0,149000
2454,聯發科          ,5567544,5889807,-322263,0,0,0,184000,0,184000,287000,182000,53000,129000,205000,47000,158000,148737
05758P,光罩永豐96售02  ,0,0,0,0,0,0,0,0,0,148000,0,0,0,212000,64000,148000,148000
048471,旭富永豐93購01  ,0,0,0,0,0,0,0,0,0,148000,0,0,0,288000,140000,148000,148000
047616,鴻海凱基94購10  ,0,0,0,0,0,0,0,0,0,148000,0,0,0,288000,140000,148000,148000
052745,欣興元大96購04  ,0,0,0,0,0,0,0,0,0,148000,0,0,0,150000,2000,148000,148000
054755,世紀鋼凱基98購01,0,0,0,0,0,0,0,0,0,148000,0,0,0,683000,535000,148000,148000
4190,佐登-KY         ,199000,45000,154000,0,0,0,0,0,0,-6000,3000,10000,-7000,3000,2000,1000,148000
05912P,和大元大96售01  ,0,0,0,0,0,0,0,0,0,147000,0,0,0,150000,3000,147000,147000
048629,滬深2X元大96購04,0,0,0,0,0,0,0,0,0,147000,0,0,0,157000,10000,147000,147000
051969,世紀鋼永豐95購01,0,0,0,0,0,0,0,0,0,147000,0,0,0,237000,90000,147000,147000
05426P,聯發科凱基95售12,0,0,0,0,0,0,0,0,0,147000,0,0,0,167000,20000,147000,147000
046793,聯發科元富99購01,0,0,0,0,0,0,0,0,0,146000,0,0,0,176000,30000,146000,146000
03821P,上海銀統一95售01,0,0,0,0,0,0,0,0,0,146000,0,0,0,234000,88000,146000,146000
04051P,友達中信94售02  ,0,0,0,0,0,0,0,0,0,146000,0,0,0,200000,54000,146000,146000
05555P,健策群益98售01  ,0,0,0,0,0,0,0,0,0,146000,0,0,0,146000,0,146000,146000
3653,健策            ,461000,285000,176000,0,0,0,51000,209000,-158000,128000,64000,26000,38000,183000,93000,90000,146000
1592,英瑞-KY         ,158000,12000,146000,0,0,0,0,0,0,0,1000,1000,0,0,0,0,146000
03180P,台灣50元大01售39,0,0,0,0,0,0,0,0,0,145000,0,0,0,145000,0,145000,145000
053009,大成鋼統一96購02,0,0,0,0,0,0,0,0,0,145000,0,0,0,145000,0,145000,145000
050397,力成元富94購01  ,0,0,0,0,0,0,0,0,0,145000,0,0,0,380000,235000,145000,145000
05863P,滬深2X元大96售09,0,0,0,0,0,0,0,0,0,144000,0,0,0,153000,9000,144000,144000
05762P,昇陽半永豐96售04,0,0,0,0,0,0,0,0,0,144000,0,0,0,149000,5000,144000,144000
05329P,臺股指凱基95售13,0,0,0,0,0,0,0,0,0,144000,0,0,0,144000,0,144000,144000
05921P,同欣電元大96售06,0,0,0,0,0,0,0,0,0,143000,0,0,0,336000,193000,143000,143000
052518,道瓊反元大95購02,0,0,0,0,0,0,0,0,0,143000,0,0,0,257000,114000,143000,143000
055048,台積電永豐97購04,0,0,0,0,0,0,0,0,0,143000,0,0,0,154000,11000,143000,143000
06589P,台積電元大98售12,0,0,0,0,0,0,0,0,0,143000,0,0,0,158000,15000,143000,143000
06018P,康控凱基96售03  ,0,0,0,0,0,0,0,0,0,142000,0,0,0,142000,0,142000,142000
057886,聯詠群益98購01  ,0,0,0,0,0,0,0,0,0,142000,0,0,0,152000,10000,142000,142000
047406,香港反統一94購01,0,0,0,0,0,0,0,0,0,142000,0,0,0,180000,38000,142000,142000
06039P,亞光台新96售03  ,0,0,0,0,0,0,0,0,0,141000,0,0,0,141000,0,141000,141000
05685P,臺股指元大96售10,0,0,0,0,0,0,0,0,0,141000,0,0,0,141000,0,141000,141000
04086P,臺股指元富93售04,0,0,0,0,0,0,0,0,0,141000,0,0,0,141000,0,141000,141000
04023P,臺股指元富99售02,0,0,0,0,0,0,0,0,0,141000,0,0,0,1714000,1573000,141000,141000
051455,樺漢元大96購01  ,0,0,0,0,0,0,0,0,0,141000,0,0,0,161000,20000,141000,141000
2010,春源            ,153000,12000,141000,0,0,0,0,0,0,0,0,0,0,0,0,0,141000
058080,台積電群益98購06,0,0,0,0,0,0,0,0,0,140000,0,0,0,428000,288000,140000,140000
04194P,欣興永豐93售05  ,0,0,0,0,0,0,0,0,0,140000,0,0,0,140000,0,140000,140000
03371P,聯電元大02售07  ,0,0,0,0,0,0,0,0,0,140000,0,0,0,140000,0,140000,140000
048889,牧德元富94購03  ,0,0,0,0,0,0,0,0,0,140000,0,0,0,140000,0,140000,140000
052912,日月光統一96購01,0,0,0,0,0,0,0,0,0,140000,0,0,0,140000,0,140000,140000
052666,瑞昱群益96購01  ,0,0,0,0,0,0,0,0,0,140000,0,0,0,140000,0,140000,140000
047975,緯創兆豐93購01  ,0,0,0,0,0,0,0,0,0,140000,0,0,0,140000,0,140000,140000
050009,昇陽半永豐94購02,0,0,0,0,0,0,0,0,0,140000,0,0,0,140000,0,140000,140000
050680,上銀元富94購01  ,0,0,0,0,0,0,0,0,0,140000,0,0,0,190000,50000,140000,140000
054653,聯發科麥證97購02,0,0,0,140000,0,140000,0,0,0,140000,0,0,0,140000,0,140000,140000
2328,廣宇            ,440000,325000,115000,0,0,0,0,0,0,25000,19000,10000,9000,16000,0,16000,140000
06895P,台灣50統一9A售01,0,0,0,0,0,0,0,0,0,140000,0,0,0,175000,35000,140000,140000
05994P,奇鋐元大96售02  ,0,0,0,0,0,0,0,0,0,139000,0,0,0,282000,143000,139000,139000
05621P,聯電中信96售01  ,0,0,0,0,0,0,0,0,0,139000,0,0,0,245000,106000,139000,139000
06270P,致伸凱基97售03  ,0,0,0,0,0,0,0,0,0,139000,0,0,0,170000,31000,139000,139000
057816,欣興元大98購13  ,0,0,0,0,0,0,0,0,0,138000,0,0,0,153000,15000,138000,138000
047556,群創凱基95購01  ,0,0,0,0,0,0,0,0,0,138000,0,0,0,400000,262000,138000,138000
049435,S&P反1國泰96購01,0,0,0,0,0,0,0,0,0,138000,0,0,0,138000,0,138000,138000
03647P,京元電元富95售02,0,0,0,0,0,0,0,0,0,138000,0,0,0,153000,15000,138000,138000
046703,瑞昱元富95購01  ,0,0,0,0,0,0,0,0,0,138000,0,0,0,232000,94000,138000,138000
054939,台積電元大97購15,0,0,0,0,0,0,0,0,0,138000,0,0,0,246000,108000,138000,138000
06339P,上銀統一97售06  ,0,0,0,0,0,0,0,0,0,138000,0,0,0,138000,0,138000,138000
057208,上海銀元富98購01,0,0,0,0,0,0,0,0,0,137000,0,0,0,282000,145000,137000,137000
055862,矽力元大97購04  ,0,0,0,0,0,0,0,0,0,137000,0,0,0,197000,60000,137000,137000
058585,S&P正2中信9B購02,0,0,0,0,0,0,0,0,0,136000,0,0,0,136000,0,136000,136000
00783,富邦中証500     ,562000,213000,349000,0,0,0,0,0,0,-213000,0,0,0,1284000,1497000,-213000,136000
050854,世紀鋼國票97購01,0,0,0,0,0,0,0,0,0,136000,0,0,0,256000,120000,136000,136000
053283,同欣電元大96購03,0,0,0,0,0,0,0,0,0,136000,0,0,0,334000,198000,136000,136000
06844P,智邦元大98售13  ,0,0,0,0,0,0,0,0,0,136000,0,0,0,136000,0,136000,136000
057054,立積元大98購03  ,0,0,0,0,0,0,0,0,0,135000,0,0,0,262000,127000,135000,135000
06883P,聯茂群益98售03  ,0,0,0,0,0,0,0,0,0,135000,0,0,0,155000,20000,135000,135000
1720,生達            ,215000,80000,135000,0,0,0,0,0,0,0,0,0,0,0,0,0,135000
8101,華冠            ,163000,28000,135000,0,0,0,0,0,0,0,0,0,0,0,0,0,135000
053708,道瓊反凱基98購01,0,0,0,0,0,0,0,0,0,134000,0,0,0,143000,9000,134000,134000
05638P,國巨統一96售04  ,0,0,0,0,0,0,0,0,0,134000,0,0,0,517000,383000,134000,134000
055502,群創元大9C購03  ,0,0,0,0,0,0,0,0,0,134000,0,0,0,137000,3000,134000,134000
1730,花仙子          ,247000,96000,151000,0,0,0,0,0,0,-17000,1000,18000,-17000,0,0,0,134000
06979P,台灣50永豐9A售02,0,0,0,0,0,0,0,0,0,134000,0,0,0,140000,6000,134000,134000
056660,臺股指元大9A購07,0,0,0,0,0,0,0,0,0,133000,0,0,0,133000,0,133000,133000
06087P,國巨永豐97售01  ,0,0,0,0,0,0,0,0,0,133000,0,0,0,163000,30000,133000,133000
06731P,聯茂元大98售05  ,0,0,0,0,0,0,0,0,0,133000,0,0,0,143000,10000,133000,133000
06749P,技嘉元富98售03  ,0,0,0,0,0,0,0,0,0,133000,0,0,0,179000,46000,133000,133000
4994,傳奇            ,159200,35000,124200,0,0,0,0,0,0,8000,9000,0,9000,0,1000,-1000,132200
058322,玉晶光永豐99購02,0,0,0,0,0,0,0,0,0,132000,0,0,0,199000,67000,132000,132000
03162P,泰碩元大01售02  ,0,0,0,0,0,0,0,0,0,132000,0,0,0,203000,71000,132000,132000
052682,上銀元大97購01  ,0,0,0,0,0,0,0,0,0,132000,0,0,0,291000,159000,132000,132000
053734,友達中信98購02  ,0,0,0,0,0,0,0,0,0,132000,0,0,0,213000,81000,132000,132000
050578,聯發科國票95購03,0,0,0,0,0,0,0,0,0,132000,0,0,0,232000,100000,132000,132000
05626P,景碩國票97售03  ,0,0,0,0,0,0,0,0,0,132000,0,0,0,153000,21000,132000,132000
3708,上緯投控        ,182000,46000,136000,0,0,0,0,0,0,-4000,0,0,0,0,4000,-4000,132000
3504,揚明光          ,211000,81000,130000,0,0,0,0,0,0,2000,0,0,0,2000,0,2000,132000
05803P,臺股指兆豐96售03,0,0,0,0,0,0,0,0,0,131000,0,0,0,131000,0,131000,131000
052152,創意富邦98購01  ,0,0,0,0,0,0,0,0,0,131000,0,0,0,131000,0,131000,131000
3535,晶彩科          ,215000,84000,131000,0,0,0,0,0,0,0,0,0,0,0,0,0,131000
1503,士電            ,129000,7000,122000,0,0,0,0,0,0,9000,13000,4000,9000,0,0,0,131000
2329,華泰            ,808000,707000,101000,0,0,0,0,0,0,30000,4000,1000,3000,52000,25000,27000,131000
05744P,台表科元大96售04,0,0,0,0,0,0,0,0,0,130000,0,0,0,190000,60000,130000,130000
04856P,光磊元富94售01  ,0,0,0,0,0,0,0,0,0,130000,0,0,0,150000,20000,130000,130000
047875,南電永豐93購02  ,0,0,0,0,0,0,0,0,0,130000,0,0,0,130000,0,130000,130000
03645C,臺股指凱基96牛27,0,0,0,0,0,0,0,0,0,130000,0,0,0,219000,89000,130000,130000
04440P,訊芯群益94售01  ,0,0,0,0,0,0,0,0,0,130000,0,0,0,130000,0,130000,130000
048240,嘉聯益國票94購03,0,0,0,0,0,0,0,0,0,130000,0,0,0,130000,0,130000,130000
055155,奇力新元大99購01,0,0,0,0,0,0,0,0,0,130000,0,0,0,210000,80000,130000,130000
054667,神基元富97購01  ,0,0,0,0,0,0,0,0,0,130000,0,0,0,153000,23000,130000,130000
06084P,宏達電元富97售02,0,0,0,0,0,0,0,0,0,130000,0,0,0,243000,113000,130000,130000
2527,宏璟            ,148000,32000,116000,0,0,0,0,0,0,14000,15000,1000,14000,0,0,0,130000
3705,永信            ,281000,151000,130000,0,0,0,0,0,0,0,0,0,0,0,0,0,130000
057575,世紀鋼永豐98購02,0,0,0,0,0,0,0,0,0,129000,0,0,0,177000,48000,129000,129000
00703,台新MSCI中國    ,1000,0,1000,0,0,0,0,0,0,128000,0,0,0,478000,350000,128000,129000
052601,大成鋼元大96購01,0,0,0,0,0,0,0,0,0,129000,0,0,0,546000,417000,129000,129000
056428,台達電凱基99購01,0,0,0,0,0,0,0,0,0,129000,0,0,0,132000,3000,129000,129000
06761P,台積電元大99售05,0,0,0,0,0,0,0,0,0,129000,0,0,0,343000,214000,129000,129000
056720,世紀鋼永豐98購01,0,0,0,0,0,0,0,0,0,128000,0,0,0,218000,90000,128000,128000
05880P,創意康和96售01  ,0,0,0,0,0,0,0,0,0,128000,0,0,0,249000,121000,128000,128000
03416B,臺股指凱基95熊05,0,0,0,0,0,0,0,0,0,128000,0,0,0,135000,7000,128000,128000
06665P,欣興兆豐99售01  ,0,0,0,0,0,0,0,0,0,128000,0,0,0,190000,62000,128000,128000
1442,名軒            ,161000,52000,109000,0,0,0,0,0,0,19000,19000,0,19000,0,0,0,128000
06938P,南電元大98售03  ,0,0,0,0,0,0,0,0,0,128000,0,0,0,128000,0,128000,128000
05836P,臺股指元富96售08,0,0,0,0,0,0,0,0,0,127000,0,0,0,127000,0,127000,127000
04454P,大立光富邦98售02,0,0,0,0,0,0,0,0,0,127000,0,0,0,148000,21000,127000,127000
05015P,臺股指元大95售06,0,0,0,0,0,0,0,0,0,127000,0,0,0,127000,0,127000,127000
054963,牧德元大97購02  ,0,0,0,0,0,0,0,0,0,127000,0,0,0,143000,16000,127000,127000
05857P,旺宏中信98售02  ,0,0,0,0,0,0,0,0,0,126000,0,0,0,156000,30000,126000,126000
05013P,台積電元大96售05,0,0,0,0,0,0,0,0,0,126000,0,0,0,200000,74000,126000,126000
05050P,華通群益96售02  ,0,0,0,0,0,0,0,0,0,126000,0,0,0,141000,15000,126000,126000
055863,緯穎元大97購05  ,0,0,0,0,0,0,0,0,0,126000,0,0,0,286000,160000,126000,126000
06811P,聯發科統一98售06,0,0,0,0,0,0,0,0,0,126000,0,0,0,126000,0,126000,126000
2009,第一銅          ,134000,9000,125000,0,0,0,0,0,0,1000,1000,0,1000,0,0,0,126000
2852,第一保          ,125000,0,125000,0,0,0,0,0,0,1000,1000,0,1000,0,0,0,126000
058418,台積電麥證99購01,0,0,0,125000,0,125000,0,0,0,125000,0,0,0,125000,0,125000,125000
057766,矽力凱基98購03  ,0,0,0,0,0,0,0,0,0,125000,0,0,0,156000,31000,125000,125000
04512P,臺股指元大94售07,0,0,0,0,0,0,0,0,0,125000,0,0,0,125000,0,125000,125000
04345P,景碩國泰94售02  ,0,0,0,0,0,0,0,0,0,125000,0,0,0,125000,0,125000,125000
03576P,台灣50元富06售01,0,0,0,0,0,0,0,0,0,125000,0,0,0,330000,205000,125000,125000
050236,旺宏凱基94購06  ,0,0,0,0,0,0,0,0,0,125000,0,0,0,173000,48000,125000,125000
055286,晶技元大98購03  ,0,0,0,0,0,0,0,0,0,125000,0,0,0,206000,81000,125000,125000
06421P,嘉澤統一97售02  ,0,0,0,0,0,0,0,0,0,125000,0,0,0,125000,0,125000,125000
3406,玉晶光          ,1224000,1401000,-177000,0,0,0,87000,39000,48000,253208,668000,519792,148208,142000,37000,105000,124208
053079,世紀鋼永豐96購01,0,0,0,0,0,0,0,0,0,124000,0,0,0,214000,90000,124000,124000
054036,T50反1元大96購08,0,0,0,0,0,0,0,0,0,124000,0,0,0,124000,0,124000,124000
2461,光群雷          ,348000,223000,125000,0,0,0,0,0,0,-1000,0,1000,-1000,0,0,0,124000
06696P,台灣50國票99售01,0,0,0,0,0,0,0,0,0,124000,0,0,0,128000,4000,124000,124000
1316,上曜            ,160000,36000,124000,0,0,0,0,0,0,0,0,0,0,0,0,0,124000
057781,國巨國票99購04  ,0,0,0,0,0,0,0,0,0,123000,0,0,0,285000,162000,123000,123000
058117,元石油群益9B購02,0,0,0,0,0,0,0,0,0,123000,0,0,0,585000,462000,123000,123000
05922P,京元電兆豐96售01,0,0,0,0,0,0,0,0,0,123000,0,0,0,199000,76000,123000,123000
049800,瑞昱元大94購05  ,0,0,0,0,0,0,0,0,0,123000,0,0,0,123000,0,123000,123000
053279,景碩元大97購01  ,0,0,0,0,0,0,0,0,0,123000,0,0,0,334000,211000,123000,123000
2034,允強            ,224000,101000,123000,0,0,0,0,0,0,0,0,0,0,0,0,0,123000
1449,佳和            ,218000,95000,123000,0,0,0,0,0,0,0,0,0,0,0,0,0,123000
06179P,國巨群益97售04  ,0,0,0,0,0,0,0,0,0,123000,0,0,0,123000,0,123000,123000
056542,緯創凱基98購01  ,0,0,0,0,0,0,0,0,0,122000,0,0,0,140000,18000,122000,122000
04808P,訊芯永豐94售02  ,0,0,0,0,0,0,0,0,0,122000,0,0,0,248000,126000,122000,122000
050306,聯發科中信97購01,0,0,0,0,0,0,0,0,0,122000,0,0,0,672000,550000,122000,122000
05596P,可成統一96售01  ,0,0,0,0,0,0,0,0,0,122000,0,0,0,122000,0,122000,122000
056127,致新國票98購02  ,0,0,0,0,0,0,0,0,0,122000,0,0,0,122000,0,122000,122000
06261P,上銀凱基97售03  ,0,0,0,0,0,0,0,0,0,122000,0,0,0,135000,13000,122000,122000
3437,榮創            ,334000,212000,122000,0,0,0,0,0,0,0,0,0,0,0,0,0,122000
9940,信義            ,221000,106000,115000,0,0,0,0,0,0,7000,9000,2000,7000,0,0,0,122000
05749P,臺股指群益99售03,0,0,0,0,0,0,0,0,0,121000,0,0,0,121000,0,121000,121000
04974P,聯發科凱基96售02,0,0,0,0,0,0,0,0,0,121000,0,0,0,121000,0,121000,121000
04629P,康控元大94售05  ,0,0,0,0,0,0,0,0,0,121000,0,0,0,121000,0,121000,121000
056306,晶相光元大98購01,0,0,0,0,0,0,0,0,0,121000,0,0,0,556000,435000,121000,121000
8463,潤泰材          ,176000,76000,100000,0,0,0,0,0,0,21000,21000,0,21000,0,0,0,121000
06212P,華新科元大97售11,0,0,0,0,0,0,0,0,0,121000,0,0,0,375000,254000,121000,121000
04861P,中磊群益94售02  ,0,0,0,0,0,0,0,0,0,120000,0,0,0,120000,0,120000,120000
051822,和碩元富95購01  ,0,0,0,0,0,0,0,0,0,120000,0,0,0,150000,30000,120000,120000
056128,和大中信99購01  ,0,0,0,0,0,0,0,0,0,120000,0,0,0,120000,0,120000,120000
055371,正崴元大97購02  ,0,0,0,0,0,0,0,0,0,120000,0,0,0,168000,48000,120000,120000
053979,健策元大98購01  ,0,0,0,0,0,0,0,0,0,120000,0,0,0,336000,216000,120000,120000
05388P,南亞科元大95售04,0,0,0,0,0,0,0,0,0,120000,0,0,0,183000,63000,120000,120000
054390,智邦元富96購03  ,0,0,0,0,0,0,0,0,0,120000,0,0,0,217000,97000,120000,120000
06576P,台光電群益98售03,0,0,0,0,0,0,0,0,0,120000,0,0,0,180000,60000,120000,120000
1522,堤維西          ,215000,95000,120000,0,0,0,0,0,0,0,0,0,0,0,0,0,120000
08163P,T50正2中信95售01,0,0,0,0,0,0,0,0,0,120000,0,0,0,170000,50000,120000,120000
06834P,訊芯群益99售02  ,0,0,0,0,0,0,0,0,0,120000,0,0,0,183000,63000,120000,120000
3003,健和興          ,177000,66000,111000,0,0,0,0,0,0,9000,9000,0,9000,0,0,0,120000
1227,佳格            ,907000,682976,224024,0,0,0,0,0,0,-105000,11000,116000,-105000,0,0,0,119024
052796,和碩兆豐96購01  ,0,0,0,0,0,0,0,0,0,119000,0,0,0,221000,102000,119000,119000
04496P,國巨國泰96售02  ,0,0,0,0,0,0,0,0,0,119000,0,0,0,828000,709000,119000,119000
050665,南電台新94購01  ,0,0,0,0,0,0,0,0,0,119000,0,0,0,165000,46000,119000,119000
056125,旺宏國票98購02  ,0,0,0,0,0,0,0,0,0,119000,0,0,0,169000,50000,119000,119000
5907,大洋-KY         ,213000,94000,119000,0,0,0,0,0,0,0,0,0,0,0,0,0,119000
049091,訊連凱基94購01  ,0,0,0,0,0,0,0,0,0,118000,0,0,0,138000,20000,118000,118000
055579,健策統一9A購01  ,0,0,0,0,0,0,0,0,0,118000,0,0,0,178000,60000,118000,118000
055598,欣興元大97購03  ,0,0,0,0,0,0,0,0,0,118000,0,0,0,157000,39000,118000,118000
3047,訊舟            ,202000,85000,117000,0,0,0,0,0,0,1000,16000,15000,1000,0,0,0,118000
05153P,台表科群益96售01,0,0,0,0,0,0,0,0,0,117000,0,0,0,441000,324000,117000,117000
05234P,美食康和95售01  ,0,0,0,0,0,0,0,0,0,117000,0,0,0,119000,2000,117000,117000
054608,致茂永豐97購01  ,0,0,0,0,0,0,0,0,0,117000,0,0,0,127000,10000,117000,117000
1457,宜進            ,202000,85000,117000,0,0,0,0,0,0,0,0,0,0,0,0,0,117000
06686P,麗豐永豐98售02  ,0,0,0,0,0,0,0,0,0,117000,0,0,0,117000,0,117000,117000
06305P,臺股指元大97售11,0,0,0,0,0,0,0,0,0,117000,0,0,0,117000,0,117000,117000
06351P,臺股指台新99售03,0,0,0,0,0,0,0,0,0,117000,0,0,0,130000,13000,117000,117000
056709,華通永豐98購01  ,0,0,0,0,0,0,0,0,0,116000,0,0,0,195000,79000,116000,116000
056848,泰鼎元富98購01  ,0,0,0,0,0,0,0,0,0,116000,0,0,0,180000,64000,116000,116000
048584,欣興富邦95購01  ,0,0,0,0,0,0,0,0,0,116000,0,0,0,121000,5000,116000,116000
04768P,大立光國泰96售03,0,0,0,0,0,0,0,0,0,116000,0,0,0,172000,56000,116000,116000
052746,泰碩元大97購01  ,0,0,0,0,0,0,0,0,0,116000,0,0,0,126000,10000,116000,116000
05049P,矽創永豐95售01  ,0,0,0,0,0,0,0,0,0,116000,0,0,0,116000,0,116000,116000
056080,世紀鋼元大97購03,0,0,0,0,0,0,0,0,0,116000,0,0,0,176000,60000,116000,116000
06214P,國巨國票98售04  ,0,0,0,0,0,0,0,0,0,116000,0,0,0,149000,33000,116000,116000
06736P,新日興凱基98售03,0,0,0,0,0,0,0,0,0,116000,0,0,0,139000,23000,116000,116000
1808,潤隆            ,153000,39000,114000,0,0,0,0,0,0,2000,4000,2000,2000,0,0,0,116000
05974P,國巨富邦97售03  ,0,0,0,0,0,0,0,0,0,115000,0,0,0,306000,191000,115000,115000
05975P,國巨日盛99售02  ,0,0,0,0,0,0,0,0,0,115000,0,0,0,186000,71000,115000,115000
03945P,欣興群益94售01  ,0,0,0,0,0,0,0,0,0,115000,0,0,0,115000,0,115000,115000
05540P,亞德客凱基96售01,0,0,0,0,0,0,0,0,0,115000,0,0,0,252000,137000,115000,115000
054960,新日興元大97購02,0,0,0,0,0,0,0,0,0,115000,0,0,0,121000,6000,115000,115000
055007,晶相光元富9A購02,0,0,0,0,0,0,0,0,0,115000,0,0,0,271000,156000,115000,115000
05413P,台郡國票96售02  ,0,0,0,0,0,0,0,0,0,115000,0,0,0,150000,35000,115000,115000
2059,川湖            ,222000,117000,105000,0,0,0,10000,0,10000,0,0,0,0,0,0,0,115000
08852P,台灣50台新01售01,0,0,0,0,0,0,0,0,0,115000,0,0,0,115000,0,115000,115000
06944P,健鼎元富98售02  ,0,0,0,0,0,0,0,0,0,115000,0,0,0,137000,22000,115000,115000
06884P,台郡群益98售03  ,0,0,0,0,0,0,0,0,0,115000,0,0,0,116000,1000,115000,115000
06097P,茂林永豐97售01  ,0,0,0,0,0,0,0,0,0,115000,0,0,0,115000,0,115000,115000
04311P,奇力新統一95售01,0,0,0,0,0,0,0,0,0,114000,0,0,0,124000,10000,114000,114000
03415B,臺股指元大93熊49,0,0,0,0,0,0,0,0,0,114000,0,0,0,115000,1000,114000,114000
045516,聯茂統一94購01  ,0,0,0,0,0,0,0,0,0,114000,0,0,0,190000,76000,114000,114000
049299,矽創群益94購01  ,0,0,0,0,0,0,0,0,0,114000,0,0,0,114000,0,114000,114000
06642P,可成兆豐98售01  ,0,0,0,0,0,0,0,0,0,114000,0,0,0,114000,0,114000,114000
06463P,大立光富邦9A售01,0,0,0,0,0,0,0,0,0,114000,0,0,0,114000,0,114000,114000
06450P,聯發科元大98售03,0,0,0,0,0,0,0,0,0,114000,0,0,0,547000,433000,114000,114000
3645,達邁            ,207000,94000,113000,0,0,0,0,0,0,1000,10000,9000,1000,0,0,0,114000
05104P,智邦台新95售02  ,0,0,0,0,0,0,0,0,0,113000,0,0,0,113000,0,113000,113000
05035P,聯發科元大95售06,0,0,0,0,0,0,0,0,0,113000,0,0,0,759000,646000,113000,113000
054129,技嘉元大96購02  ,0,0,0,0,0,0,0,0,0,113000,0,0,0,378000,265000,113000,113000
054652,裕隆麥證97購01  ,0,0,0,113000,0,113000,0,0,0,113000,0,0,0,113000,0,113000,113000
06169P,華新科元富97售02,0,0,0,0,0,0,0,0,0,113000,0,0,0,148000,35000,113000,113000
051536,玉晶光國票97購01,0,0,0,0,0,0,0,0,0,112000,0,0,0,140000,28000,112000,112000
051522,玉晶光凱基95購05,0,0,0,0,0,0,0,0,0,112000,0,0,0,146000,34000,112000,112000
05193P,台郡台新95售01  ,0,0,0,0,0,0,0,0,0,112000,0,0,0,112000,0,112000,112000
051855,道瓊反凱基97購01,0,0,0,0,0,0,0,0,0,112000,0,0,0,333000,221000,112000,112000
054231,國巨群益98購03  ,0,0,0,0,0,0,0,0,0,112000,0,0,0,266000,154000,112000,112000
06144P,台光電永豐97售01,0,0,0,0,0,0,0,0,0,112000,0,0,0,124000,12000,112000,112000
07022P,嘉晶永豐99售02  ,0,0,0,0,0,0,0,0,0,112000,0,0,0,122000,10000,112000,112000
044533,S&P反1中信94購02,0,0,0,0,0,0,0,0,0,111000,0,0,0,206000,95000,111000,111000
05005P,台表科統一95售01,0,0,0,0,0,0,0,0,0,111000,0,0,0,112000,1000,111000,111000
051578,智邦元大96購01  ,0,0,0,0,0,0,0,0,0,111000,0,0,0,193000,82000,111000,111000
052437,聯發科富邦99購02,0,0,0,0,0,0,0,0,0,111000,0,0,0,206000,95000,111000,111000
06111P,上銀兆豐98售01  ,0,0,0,0,0,0,0,0,0,111000,0,0,0,111000,0,111000,111000
4540,全球傳動        ,185000,74000,111000,0,0,0,0,0,0,0,0,0,0,0,0,0,111000
05942P,奇力新凱基96售04,0,0,0,0,0,0,0,0,0,110000,0,0,0,207000,97000,110000,110000
056453,禾伸堂凱基99購02,0,0,0,0,0,0,0,0,0,110000,0,0,0,110000,0,110000,110000
04542P,致伸永豐94售01  ,0,0,0,0,0,0,0,0,0,110000,0,0,0,110000,0,110000,110000
045101,玉晶光中信94購01,0,0,0,0,0,0,0,0,0,110000,0,0,0,110000,0,110000,110000
047219,美律麥證94購01  ,0,0,0,120000,10000,110000,0,0,0,110000,0,0,0,120000,10000,110000,110000
03960P,新日興元富96售02,0,0,0,0,0,0,0,0,0,110000,0,0,0,220000,110000,110000,110000
03103P,聯發科元富01售02,0,0,0,0,0,0,0,0,0,110000,0,0,0,110000,0,110000,110000
047566,華新科國票94購02,0,0,0,0,0,0,0,0,0,110000,0,0,0,110000,0,110000,110000
050019,T50反1元大94購04,0,0,0,0,0,0,0,0,0,110000,0,0,0,110000,0,110000,110000
049375,大立光元大94購13,0,0,0,0,0,0,0,0,0,110000,0,0,0,110000,0,110000,110000
04877P,聯發科麥證94售04,0,0,0,150000,40000,110000,0,0,0,110000,0,0,0,150000,40000,110000,110000
04880P,GIS永豐94售02   ,0,0,0,0,0,0,0,0,0,110000,0,0,0,110000,0,110000,110000
052209,深中小元大95購02,0,0,0,0,0,0,0,0,0,110000,0,0,0,270000,160000,110000,110000
052741,聯發科元大96購08,0,0,0,0,0,0,0,0,0,110000,0,0,0,121000,11000,110000,110000
05046P,台光電永豐95售02,0,0,0,0,0,0,0,0,0,110000,0,0,0,132000,22000,110000,110000
050170,臺指反元大97購02,0,0,0,0,0,0,0,0,0,110000,0,0,0,110000,0,110000,110000
053970,聯發科元大97購08,0,0,0,0,0,0,0,0,0,110000,0,0,0,110000,0,110000,110000
05543P,鴻海元富96售04  ,0,0,0,0,0,0,0,0,0,110000,0,0,0,136000,26000,110000,110000
055241,T50反1統一99購01,0,0,0,0,0,0,0,0,0,110000,0,0,0,110000,0,110000,110000
4746,台耀            ,647000,762000,-115000,0,0,0,78000,0,78000,147000,169000,22000,147000,0,0,0,110000
06410P,祥碩統一97售01  ,0,0,0,0,0,0,0,0,0,110000,0,0,0,156000,46000,110000,110000
06458P,玉晶光統一9A售02,0,0,0,0,0,0,0,0,0,110000,0,0,0,265000,155000,110000,110000
1612,宏泰            ,175000,39000,136000,0,0,0,0,0,0,-26000,0,26000,-26000,0,0,0,110000
06047P,聯發科富邦99售04,0,0,0,0,0,0,0,0,0,109000,0,0,0,130000,21000,109000,109000
049789,世紀鋼兆豐94購01,0,0,0,0,0,0,0,0,0,109000,0,0,0,251000,142000,109000,109000
03314P,台積電元大02售16,0,0,0,0,0,0,0,0,0,109000,0,0,0,109000,0,109000,109000
047105,和大元大94購01  ,0,0,0,0,0,0,0,0,0,109000,0,0,0,109000,0,109000,109000
05092P,全新元大95售03  ,0,0,0,0,0,0,0,0,0,109000,0,0,0,109000,0,109000,109000
056118,聯詠群益97購03  ,0,0,0,0,0,0,0,0,0,109000,0,0,0,109000,0,109000,109000
05410P,聯發科元富95售04,0,0,0,0,0,0,0,0,0,109000,0,0,0,109000,0,109000,109000
06936P,瑞儀元大98售01  ,0,0,0,0,0,0,0,0,0,109000,0,0,0,112000,3000,109000,109000
057929,上銀群益98購02  ,0,0,0,0,0,0,0,0,0,108000,0,0,0,112000,4000,108000,108000
048145,大立光統一93購10,0,0,0,0,0,0,0,0,0,108000,0,0,0,108000,0,108000,108000
04804P,聯發科凱基94售12,0,0,0,0,0,0,0,0,0,108000,0,0,0,108000,0,108000,108000
051061,中磊群益95購01  ,0,0,0,0,0,0,0,0,0,108000,0,0,0,108000,0,108000,108000
05163P,聯發科統一96售02,0,0,0,0,0,0,0,0,0,108000,0,0,0,112000,4000,108000,108000
054074,健策富邦98購01  ,0,0,0,0,0,0,0,0,0,108000,0,0,0,110000,2000,108000,108000
04916P,大立光永昌96售02,0,0,0,0,0,0,0,0,0,107000,0,0,0,906000,799000,107000,107000
04923P,GIS凱基94售06   ,0,0,0,0,0,0,0,0,0,107000,0,0,0,107000,0,107000,107000
046998,同欣電國泰94購01,0,0,0,0,0,0,0,0,0,107000,0,0,0,152000,45000,107000,107000
055046,上銀永豐97購01  ,0,0,0,0,0,0,0,0,0,107000,0,0,0,107000,0,107000,107000
2338,光罩            ,1462000,1586000,-124000,0,0,0,0,0,0,231000,1000,168000,-167000,458000,60000,398000,107000
6191,精成科          ,602000,458000,144000,0,0,0,0,0,0,-37000,5000,41000,-36000,8000,9000,-1000,107000
048935,玉晶光永豐94購04,0,0,0,0,0,0,0,0,0,106000,0,0,0,116000,10000,106000,106000
053926,晶相光國票97購01,0,0,0,0,0,0,0,0,0,106000,0,0,0,212000,106000,106000,106000
8110,華東            ,317000,245000,72000,0,0,0,0,0,0,34000,61000,27000,34000,0,0,0,106000
1337,再生-KY         ,136000,30000,106000,0,0,0,0,0,0,0,0,0,0,0,0,0,106000
06021P,世紀鋼元富96售03,0,0,0,0,0,0,0,0,0,105000,0,0,0,220000,115000,105000,105000
05702P,矽創凱基96售02  ,0,0,0,0,0,0,0,0,0,105000,0,0,0,105000,0,105000,105000
04876P,台光電中信94售02,0,0,0,0,0,0,0,0,0,105000,0,0,0,105000,0,105000,105000
049612,香港反中信96購01,0,0,0,0,0,0,0,0,0,105000,0,0,0,105000,0,105000,105000
03253P,台灣50國泰03售02,0,0,0,0,0,0,0,0,0,105000,0,0,0,137000,32000,105000,105000
03824P,燿華元大94售01  ,0,0,0,0,0,0,0,0,0,105000,0,0,0,105000,0,105000,105000
05346P,臺股指統一95售06,0,0,0,0,0,0,0,0,0,105000,0,0,0,115000,10000,105000,105000
056261,台積電統一97購07,0,0,0,0,0,0,0,0,0,105000,0,0,0,125000,20000,105000,105000
056239,宏達電群益98購01,0,0,0,0,0,0,0,0,0,105000,0,0,0,110000,5000,105000,105000
06849P,欣興元大98售12  ,0,0,0,0,0,0,0,0,0,105000,0,0,0,115000,10000,105000,105000
6165,捷泰            ,140000,35000,105000,0,0,0,0,0,0,0,0,0,0,0,0,0,105000
056462,訊芯凱基98購03  ,0,0,0,0,0,0,0,0,0,104000,0,0,0,269000,165000,104000,104000
05669P,嘉晶永豐96售03  ,0,0,0,0,0,0,0,0,0,104000,0,0,0,124000,20000,104000,104000
05953P,台積電國票98售02,0,0,0,0,0,0,0,0,0,104000,0,0,0,108000,4000,104000,104000
047250,日月光群益94購01,0,0,0,0,0,0,0,0,0,104000,0,0,0,196000,92000,104000,104000
055569,聚陽統一98購01  ,0,0,0,0,0,0,0,0,0,104000,0,0,0,141000,37000,104000,104000
054349,同欣電國票97購02,0,0,0,0,0,0,0,0,0,104000,0,0,0,169000,65000,104000,104000
1313,聯成            ,680000,576000,104000,0,0,0,0,0,0,0,0,0,0,0,0,0,104000
04520P,欣興群益94售02  ,0,0,0,0,0,0,0,0,0,103000,0,0,0,138000,35000,103000,103000
05369P,可成元富95售04  ,0,0,0,0,0,0,0,0,0,103000,0,0,0,103000,0,103000,103000
05037P,華新科元大95售09,0,0,0,0,0,0,0,0,0,103000,0,0,0,133000,30000,103000,103000
050988,廣達富邦95購01  ,0,0,0,0,0,0,0,0,0,103000,0,0,0,105000,2000,103000,103000
054284,和大元大96購03  ,0,0,0,0,0,0,0,0,0,103000,0,0,0,103000,0,103000,103000
06091P,華新科統一97售01,0,0,0,0,0,0,0,0,0,103000,0,0,0,121000,18000,103000,103000
2457,飛宏            ,124000,20000,104000,0,0,0,0,0,0,-1000,21000,22000,-1000,0,0,0,103000
056557,世紀鋼凱基98購02,0,0,0,0,0,0,0,0,0,102000,0,0,0,214000,112000,102000,102000
057001,華邦電國票99購02,0,0,0,0,0,0,0,0,0,102000,0,0,0,138000,36000,102000,102000
04427P,滬深2X元大97售02,0,0,0,0,0,0,0,0,0,102000,0,0,0,102000,0,102000,102000
048979,晶相光元大94購03,0,0,0,0,0,0,0,0,0,102000,0,0,0,127000,25000,102000,102000
053098,國巨元富96購04  ,0,0,0,0,0,0,0,0,0,102000,0,0,0,332000,230000,102000,102000
057382,聯發科國泰9A購01,0,0,0,0,0,0,0,0,0,101000,0,0,0,216000,115000,101000,101000
05764P,世紀鋼永豐96售03,0,0,0,0,0,0,0,0,0,101000,0,0,0,101000,0,101000,101000
05769P,台積電凱基96售16,0,0,0,0,0,0,0,0,0,101000,0,0,0,101000,0,101000,101000
048781,臺股指凱基96購01,0,0,0,0,0,0,0,0,0,101000,0,0,0,101000,0,101000,101000
04811P,上銀元大94售02  ,0,0,0,0,0,0,0,0,0,101000,0,0,0,101000,0,101000,101000
04940P,台積電國票95售02,0,0,0,0,0,0,0,0,0,101000,0,0,0,127000,26000,101000,101000
00766L,台新MSCI中國正2 ,0,0,0,0,0,0,0,0,0,101000,0,0,0,364000,263000,101000,101000
056113,新日興兆豐98購01,0,0,0,0,0,0,0,0,0,101000,0,0,0,119000,18000,101000,101000
055956,瑞昱元大97購05  ,0,0,0,0,0,0,0,0,0,101000,0,0,0,134000,33000,101000,101000
057711,台積電統一9A購03,0,0,0,0,0,0,0,0,0,100000,0,0,0,200000,100000,100000,100000
05813P,臺股指國票96售06,0,0,0,0,0,0,0,0,0,100000,0,0,0,100000,0,100000,100000
06033P,可成凱基96售09  ,0,0,0,0,0,0,0,0,0,100000,0,0,0,110000,10000,100000,100000
057416,T50反1凱基9C購01,0,0,0,0,0,0,0,0,0,100000,0,0,0,100000,0,100000,100000
056584,鴻海統一9B購01  ,0,0,0,0,0,0,0,0,0,100000,0,0,0,144000,44000,100000,100000
05665P,台積電凱基96售08,0,0,0,0,0,0,0,0,0,100000,0,0,0,154000,54000,100000,100000
04050P,創意元大93售05  ,0,0,0,0,0,0,0,0,0,100000,0,0,0,100000,0,100000,100000
03387P,台積電凱基03售11,0,0,0,0,0,0,0,0,0,100000,0,0,0,100000,0,100000,100000
04204P,臺股指元大93售44,0,0,0,0,0,0,0,0,0,100000,0,0,0,100000,0,100000,100000
046345,世紀鋼國票93購01,0,0,0,0,0,0,0,0,0,100000,0,0,0,100000,0,100000,100000
046149,宏達電國票93購01,0,0,0,0,0,0,0,0,0,100000,0,0,0,100000,0,100000,100000
03969P,華新科國票94售01,0,0,0,0,0,0,0,0,0,100000,0,0,0,100000,0,100000,100000
04476P,玉晶光元大94售05,0,0,0,0,0,0,0,0,0,100000,0,0,0,100000,0,100000,100000
04604P,華新科國票95售01,0,0,0,0,0,0,0,0,0,100000,0,0,0,100000,0,100000,100000
043832,SP黃豆國票95購01,0,0,0,0,0,0,0,0,0,100000,0,0,0,100000,0,100000,100000
047263,揚明光國票94購01,0,0,0,0,0,0,0,0,0,100000,0,0,0,100000,0,100000,100000
047248,奇鋐群益95購01  ,0,0,0,0,0,0,0,0,0,100000,0,0,0,100000,0,100000,100000
047141,宏達電兆豐94購01,0,0,0,0,0,0,0,0,0,100000,0,0,0,100000,0,100000,100000
048197,義隆元大93購04  ,0,0,0,0,0,0,0,0,0,100000,0,0,0,100000,0,100000,100000
049271,百和元大94購01  ,0,0,0,0,0,0,0,0,0,100000,0,0,0,100000,0,100000,100000
049997,聯發科永豐94購04,0,0,0,0,0,0,0,0,0,100000,0,0,0,200000,100000,100000,100000
048345,緯創元大94購01  ,0,0,0,0,0,0,0,0,0,100000,0,0,0,300000,200000,100000,100000
048334,A50正2元大96購01,0,0,0,0,0,0,0,0,0,100000,0,0,0,101000,1000,100000,100000
04773P,金融類元大94售01,0,0,0,0,0,0,0,0,0,100000,0,0,0,100000,0,100000,100000
047829,旺宏元大93購06  ,0,0,0,0,0,0,0,0,0,100000,0,0,0,100000,0,100000,100000
049459,全新元富95購02  ,0,0,0,0,0,0,0,0,0,100000,0,0,0,100000,0,100000,100000
047524,瑞昱元大93購10  ,0,0,0,0,0,0,0,0,0,100000,0,0,0,100000,0,100000,100000
048980,嘉澤元大94購02  ,0,0,0,0,0,0,0,0,0,100000,0,0,0,100000,0,100000,100000
04886P,臺股指凱基94售20,0,0,0,0,0,0,0,0,0,100000,0,0,0,100000,0,100000,100000
052969,建準群益97購01  ,0,0,0,0,0,0,0,0,0,100000,0,0,0,126000,26000,100000,100000
050655,中磊凱基96購01  ,0,0,0,0,0,0,0,0,0,100000,0,0,0,100000,0,100000,100000
050282,T50反1凱基97購01,0,0,0,0,0,0,0,0,0,100000,0,0,0,100000,0,100000,100000
05322P,台積電凱基95售17,0,0,0,0,0,0,0,0,0,100000,0,0,0,100000,0,100000,100000
051991,泰碩元大95購02  ,0,0,0,0,0,0,0,0,0,100000,0,0,0,121000,21000,100000,100000
052116,T50反1國票97購01,0,0,0,0,0,0,0,0,0,100000,0,0,0,100000,0,100000,100000
051409,美律國票96購01  ,0,0,0,0,0,0,0,0,0,100000,0,0,0,120000,20000,100000,100000
05246P,南電元大95售04  ,0,0,0,0,0,0,0,0,0,100000,0,0,0,151000,51000,100000,100000
05595P,友達統一96售02  ,0,0,0,0,0,0,0,0,0,100000,0,0,0,100000,0,100000,100000
05531P,臺股指群益96售04,0,0,0,0,0,0,0,0,0,100000,0,0,0,243000,143000,100000,100000
054354,技嘉富邦97購01  ,0,0,0,0,0,0,0,0,0,100000,0,0,0,100000,0,100000,100000
05432P,國巨元富95售07  ,0,0,0,0,0,0,0,0,0,100000,0,0,0,100000,0,100000,100000
054916,聯發科凱基98購04,0,0,0,0,0,0,0,0,0,100000,0,0,0,100000,0,100000,100000
054626,建準凱基98購01  ,0,0,0,0,0,0,0,0,0,100000,0,0,0,100000,0,100000,100000
054510,S&P反1元大98購01,0,0,0,0,0,0,0,0,0,100000,0,0,0,154000,54000,100000,100000
05474P,智邦亞東95售01  ,0,0,0,0,0,0,0,0,0,100000,0,0,0,100000,0,100000,100000
6525,捷敏-KY         ,138000,34000,104000,0,0,0,0,0,0,-4000,0,4000,-4000,0,0,0,100000
06748P,智邦台新98售02  ,0,0,0,0,0,0,0,0,0,100000,0,0,0,109000,9000,100000,100000
07866P,上証2X國票97售01,0,0,0,0,0,0,0,0,0,100000,0,0,0,100000,0,100000,100000
2406,國碩            ,395000,295000,100000,0,0,0,0,0,0,0,0,0,0,0,0,0,100000
048271,可成富邦95購02  ,0,0,0,0,0,0,0,0,0,99000,0,0,0,100000,1000,99000,99000
048177,臺指反富邦99購01,0,0,0,0,0,0,0,0,0,99000,0,0,0,100000,1000,99000,99000
04715P,聯茂元大94售06  ,0,0,0,0,0,0,0,0,0,99000,0,0,0,99000,0,99000,99000
052957,T50反1凱基99購01,0,0,0,0,0,0,0,0,0,99000,0,0,0,99000,0,99000,99000
051450,世芯元大95購02  ,0,0,0,0,0,0,0,0,0,99000,0,0,0,185000,86000,99000,99000
051071,聯發科國票96購01,0,0,0,0,0,0,0,0,0,99000,0,0,0,100000,1000,99000,99000
06853P,華擎元富98售03  ,0,0,0,0,0,0,0,0,0,99000,0,0,0,102000,3000,99000,99000
06493P,聯發科永豐98售02,0,0,0,0,0,0,0,0,0,99000,0,0,0,99000,0,99000,99000
06163P,聯詠群益97售01  ,0,0,0,0,0,0,0,0,0,99000,0,0,0,104000,5000,99000,99000
057108,潤泰全群益98購01,0,0,0,0,0,0,0,0,0,98000,0,0,0,98000,0,98000,98000
057140,宏達電兆豐98購01,0,0,0,0,0,0,0,0,0,98000,0,0,0,129000,31000,98000,98000
04293P,滬深2X元大96售02,0,0,0,0,0,0,0,0,0,98000,0,0,0,170000,72000,98000,98000
047673,瑞昱元富96購01  ,0,0,0,0,0,0,0,0,0,98000,0,0,0,98000,0,98000,98000
051890,智邦元富95購03  ,0,0,0,0,0,0,0,0,0,98000,0,0,0,98000,0,98000,98000
051891,智邦元富95購04  ,0,0,0,0,0,0,0,0,0,98000,0,0,0,98000,0,98000,98000
050945,致茂群益95購01  ,0,0,0,0,0,0,0,0,0,98000,0,0,0,98000,0,98000,98000
050116,嘉澤元大94購03  ,0,0,0,0,0,0,0,0,0,98000,0,0,0,100000,2000,98000,98000
055017,緯穎元富97購01  ,0,0,0,0,0,0,0,0,0,98000,0,0,0,122000,24000,98000,98000
054384,瀚宇博群益96購02,0,0,0,0,0,0,0,0,0,98000,0,0,0,98000,0,98000,98000
053845,和大元富96購01  ,0,0,0,0,0,0,0,0,0,98000,0,0,0,98000,0,98000,98000
055600,致伸元大97購02  ,0,0,0,0,0,0,0,0,0,98000,0,0,0,130000,32000,98000,98000
055533,大立光群益97購03,0,0,0,0,0,0,0,0,0,98000,0,0,0,108000,10000,98000,98000
5285,界霖            ,118000,20000,98000,0,0,0,0,0,0,0,0,0,0,0,0,0,98000
3052,夆典            ,213000,116000,97000,0,0,0,0,0,0,1000,2000,1000,1000,0,0,0,98000
057648,和碩元大98購01  ,0,0,0,0,0,0,0,0,0,97000,0,0,0,185000,88000,97000,97000
05910P,力山永豐96售02  ,0,0,0,0,0,0,0,0,0,97000,0,0,0,97000,0,97000,97000
05162P,玉晶光國票96售03,0,0,0,0,0,0,0,0,0,97000,0,0,0,886000,789000,97000,97000
052299,T50反1台新05購03,0,0,0,0,0,0,0,0,0,97000,0,0,0,100000,3000,97000,97000
5519,隆大            ,180000,83000,97000,0,0,0,0,0,0,0,0,0,0,0,0,0,97000
06235P,國巨元大97售12  ,0,0,0,0,0,0,0,0,0,97000,0,0,0,225000,128000,97000,97000
048747,華通元富97購01  ,0,0,0,0,0,0,0,0,0,96000,0,0,0,110000,14000,96000,96000
052297,旭富國票96購01  ,0,0,0,0,0,0,0,0,0,96000,0,0,0,124000,28000,96000,96000
051643,瑞昱康和95購01  ,0,0,0,0,0,0,0,0,0,96000,0,0,0,96000,0,96000,96000
06414P,矽力凱基97售03  ,0,0,0,0,0,0,0,0,0,96000,0,0,0,113000,17000,96000,96000
05900P,臺股指凱基99售05,0,0,0,0,0,0,0,0,0,95000,0,0,0,105000,10000,95000,95000
05740P,宏達電元富96售01,0,0,0,0,0,0,0,0,0,95000,0,0,0,145000,50000,95000,95000
05675P,美律群益97售01  ,0,0,0,0,0,0,0,0,0,95000,0,0,0,100000,5000,95000,95000
05282P,可成元大95售09  ,0,0,0,0,0,0,0,0,0,95000,0,0,0,130000,35000,95000,95000
052821,晶技永豐96購01  ,0,0,0,0,0,0,0,0,0,95000,0,0,0,95000,0,95000,95000
04997P,燿華台新95售02  ,0,0,0,0,0,0,0,0,0,95000,0,0,0,95000,0,95000,95000
04395P,台積電群益94售06,0,0,0,0,0,0,0,0,0,95000,0,0,0,105000,10000,95000,95000
049599,樺漢元大95購01  ,0,0,0,0,0,0,0,0,0,95000,0,0,0,134000,39000,95000,95000
050441,和碩凱基94購01  ,0,0,0,0,0,0,0,0,0,95000,0,0,0,148000,53000,95000,95000
05360P,健策元大95售03  ,0,0,0,0,0,0,0,0,0,95000,0,0,0,620000,525000,95000,95000
050881,大立光元富95購04,0,0,0,0,0,0,0,0,0,95000,0,0,0,108000,13000,95000,95000
05108P,欣興中信95售02  ,0,0,0,0,0,0,0,0,0,95000,0,0,0,110000,15000,95000,95000
055495,長榮航元大97購01,0,0,0,0,0,0,0,0,0,95000,0,0,0,498000,403000,95000,95000
054156,聯電亞東98購01  ,0,0,0,0,0,0,0,0,0,95000,0,0,0,115000,20000,95000,95000
054169,上緯控凱基98購01,0,0,0,0,0,0,0,0,0,95000,0,0,0,101000,6000,95000,95000
054581,訊芯元大97購02  ,0,0,0,0,0,0,0,0,0,95000,0,0,0,163000,68000,95000,95000
06386P,欣興永豐97售03  ,0,0,0,0,0,0,0,0,0,95000,0,0,0,135000,40000,95000,95000
06475P,牧德永豐98售03  ,0,0,0,0,0,0,0,0,0,95000,0,0,0,95000,0,95000,95000
06773P,台灣50兆豐9A售01,0,0,0,0,0,0,0,0,0,95000,2000,0,2000,105000,12000,93000,95000
06759P,台積電元大98售17,0,0,0,0,0,0,0,0,0,95000,0,0,0,302000,207000,95000,95000
06722P,臺股指中信9A售04,0,0,0,0,0,0,0,0,0,95000,0,0,0,95000,0,95000,95000
2233,宇隆            ,108000,13000,95000,0,0,0,0,0,0,0,0,0,0,0,0,0,95000
04953P,台積電群益94售13,0,0,0,0,0,0,0,0,0,94000,0,0,0,220000,126000,94000,94000
052757,華邦電群益96購01,0,0,0,0,0,0,0,0,0,94000,0,0,0,100000,6000,94000,94000
056238,聯發科群益98購02,0,0,0,0,0,0,0,0,0,94000,0,0,0,104000,10000,94000,94000
2208,台船            ,256000,163000,93000,0,0,0,0,0,0,1000,1000,0,1000,0,0,0,94000
06737P,台郡凱基98售07  ,0,0,0,0,0,0,0,0,0,94000,0,0,0,174000,80000,94000,94000
06661P,玉晶光永豐98售05,0,0,0,0,0,0,0,0,0,94000,0,0,0,163000,69000,94000,94000
6477,安集            ,113000,19000,94000,0,0,0,0,0,0,0,0,0,0,0,0,0,94000
057029,緯穎凱基98購04  ,0,0,0,0,0,0,0,0,0,93000,0,0,0,103000,10000,93000,93000
057535,泰鼎元大99購01  ,0,0,0,0,0,0,0,0,0,93000,0,0,0,445000,352000,93000,93000
04900P,矽格中信94售02  ,0,0,0,0,0,0,0,0,0,93000,0,0,0,93000,0,93000,93000
052975,嘉聯益群益96購01,0,0,0,0,0,0,0,0,0,93000,0,0,0,100000,7000,93000,93000
05569P,漢唐統一97售01  ,0,0,0,0,0,0,0,0,0,93000,0,0,0,412000,319000,93000,93000
055097,福懋科群益97購01,0,0,0,0,0,0,0,0,0,93000,0,0,0,134000,41000,93000,93000
2929,淘帝-KY         ,152000,61000,91000,0,0,0,0,0,0,2000,0,0,0,2000,0,2000,93000
06702P,智邦元富98售01  ,0,0,0,0,0,0,0,0,0,93000,0,0,0,119000,26000,93000,93000
06368P,台積電凱基97售15,0,0,0,0,0,0,0,0,0,93000,0,0,0,313000,220000,93000,93000
06839P,玉晶光統一9A售05,0,0,0,0,0,0,0,0,0,93000,0,0,0,138000,45000,93000,93000
056861,美律群益99購01  ,0,0,0,0,0,0,0,0,0,92000,0,0,0,92000,0,92000,92000
05650P,台積電富邦96售01,0,0,0,0,0,0,0,0,0,92000,0,0,0,172000,80000,92000,92000
05861P,瀚宇博永豐96售02,0,0,0,0,0,0,0,0,0,92000,0,0,0,92000,0,92000,92000
057821,晶相光元大98購03,0,0,0,0,0,0,0,0,0,92000,0,0,0,142000,50000,92000,92000
03635C,滬深2X元富99牛01,0,0,0,0,0,0,0,0,0,92000,0,0,0,112000,20000,92000,92000
055118,嘉聯益凱基98購02,0,0,0,0,0,0,0,0,0,92000,0,0,0,100000,8000,92000,92000
054694,聯鈞永豐97購01  ,0,0,0,0,0,0,0,0,0,92000,0,0,0,131000,39000,92000,92000
054037,T50反1元大96購09,0,0,0,0,0,0,0,0,0,92000,0,0,0,92000,0,92000,92000
055590,聯發科元大98購02,0,0,0,0,0,0,0,0,0,92000,0,0,0,188000,96000,92000,92000
056145,緯穎元大98購03  ,0,0,0,0,0,0,0,0,0,92000,0,0,0,207000,115000,92000,92000
06090P,旺宏統一97售06  ,0,0,0,0,0,0,0,0,0,92000,0,0,0,121000,29000,92000,92000
3607,谷崧            ,122000,31000,91000,0,0,0,0,0,0,1000,14000,13000,1000,0,0,0,92000
2816,旺旺保          ,119000,27000,92000,0,0,0,0,0,0,0,0,0,0,0,0,0,92000
2538,基泰            ,174000,82000,92000,0,0,0,0,0,0,0,0,0,0,0,0,0,92000
6209,今國光          ,296000,204000,92000,0,0,0,0,0,0,0,1000,1000,0,0,0,0,92000
8215,明基材          ,498000,404000,94000,0,0,0,0,0,0,-2000,1000,3000,-2000,0,0,0,92000
057451,大立光元富9B購01,0,0,0,0,0,0,0,0,0,91000,0,0,0,105000,14000,91000,91000
05712P,友達統一97售03  ,0,0,0,0,0,0,0,0,0,91000,0,0,0,195000,104000,91000,91000
04785P,鴻海永豐94售03  ,0,0,0,0,0,0,0,0,0,91000,0,0,0,132000,41000,91000,91000
052736,T50反1元大96購05,0,0,0,0,0,0,0,0,0,91000,0,0,0,100000,9000,91000,91000
056106,晶相光永豐97購02,0,0,0,0,0,0,0,0,0,91000,0,0,0,93000,2000,91000,91000
055993,致茂國泰99購01  ,0,0,0,0,0,0,0,0,0,91000,0,0,0,431000,340000,91000,91000
06428P,國巨元大97售17  ,0,0,0,0,0,0,0,0,0,91000,0,0,0,194000,103000,91000,91000
06426P,T50正2元大9B售01,0,0,0,0,0,0,0,0,0,91000,0,0,0,91000,0,91000,91000
1733,五鼎            ,104000,20000,84000,0,0,0,0,0,0,7000,12000,5000,7000,0,0,0,91000
2385,群光            ,1686000,2142508,-456508,0,0,0,9000,0,9000,538000,10000,2000,8000,536000,6000,530000,90492
05957P,友達國票97售04  ,0,0,0,0,0,0,0,0,0,90000,0,0,0,100000,10000,90000,90000
047765,瑞昱元大93購12  ,0,0,0,0,0,0,0,0,0,90000,0,0,0,200000,110000,90000,90000
04914P,國巨國泰95售06  ,0,0,0,0,0,0,0,0,0,90000,0,0,0,90000,0,90000,90000
03751P,旺宏富邦95售01  ,0,0,0,0,0,0,0,0,0,90000,0,0,0,260000,170000,90000,90000
04241P,欣興國泰95售02  ,0,0,0,0,0,0,0,0,0,90000,0,0,0,135000,45000,90000,90000
048233,南電凱基93購05  ,0,0,0,0,0,0,0,0,0,90000,0,0,0,90000,0,90000,90000
044673,上銀凱基93購04  ,0,0,0,0,0,0,0,0,0,90000,0,0,0,100000,10000,90000,90000
051494,中環兆豐95購01  ,0,0,0,0,0,0,0,0,0,90000,0,0,0,90000,0,90000,90000
053306,晶技凱基97購01  ,0,0,0,0,0,0,0,0,0,90000,0,0,0,100000,10000,90000,90000
053370,上証2X元大97購03,0,0,0,0,0,0,0,0,0,90000,0,0,0,213000,123000,90000,90000
050107,鴻海元大94購12  ,0,0,0,0,0,0,0,0,0,90000,0,0,0,100000,10000,90000,90000
052629,訊芯中信99購01  ,0,0,0,0,0,0,0,0,0,90000,0,0,0,250000,160000,90000,90000
050876,復盛永豐95購01  ,0,0,0,0,0,0,0,0,0,90000,0,0,0,90000,0,90000,90000
055929,聯發科群益97購05,0,0,0,0,0,0,0,0,0,90000,0,0,0,91000,1000,90000,90000
055518,華新科中信99購01,0,0,0,0,0,0,0,0,0,90000,0,0,0,980000,890000,90000,90000
055242,道瓊銀統一98購01,0,0,0,0,0,0,0,0,0,90000,0,0,0,90000,0,90000,90000
055179,大立光統一97購04,0,0,0,0,0,0,0,0,0,90000,0,0,0,90000,0,90000,90000
054344,景碩國票97購04  ,0,0,0,0,0,0,0,0,0,90000,0,0,0,90000,0,90000,90000
2374,佳能            ,99000,12000,87000,0,0,0,0,0,0,3000,17000,14000,3000,0,0,0,90000
2414,精技            ,97000,7000,90000,0,0,0,0,0,0,0,0,0,0,0,0,0,90000
08484P,台灣50中信96售01,0,0,0,0,0,0,0,0,0,90000,0,0,0,90000,0,90000,90000
06398P,禾伸堂凱基97售02,0,0,0,0,0,0,0,0,0,90000,0,0,0,110000,20000,90000,90000
06369P,台積電凱基97售16,0,0,0,0,0,0,0,0,0,90000,0,0,0,160000,70000,90000,90000
06219P,國巨元富97售05  ,0,0,0,0,0,0,0,0,0,90000,0,0,0,196000,106000,90000,90000
06203P,奇力新中信98售02,0,0,0,0,0,0,0,0,0,90000,0,0,0,90000,0,90000,90000
056477,欣興元大98購02  ,0,0,0,0,0,0,0,0,0,89000,0,0,0,105000,16000,89000,89000
056822,佐登永豐98購01  ,0,0,0,0,0,0,0,0,0,89000,0,0,0,89000,0,89000,89000
035277,景碩台新97購01  ,0,0,0,0,0,0,0,0,0,89000,0,0,0,90000,1000,89000,89000
052269,T50反1日盛9B購01,0,0,0,0,0,0,0,0,0,89000,0,0,0,489000,400000,89000,89000
055211,A50反1凱基9A購01,0,4000,-4000,0,0,0,0,0,0,93000,0,0,0,101000,8000,93000,89000
06682P,玉晶光元大99售08,0,0,0,0,0,0,0,0,0,89000,0,0,0,89000,0,89000,89000
06683P,訊芯元大98售07  ,0,0,0,0,0,0,0,0,0,89000,0,0,0,147000,58000,89000,89000
06636P,可成凱基98售08  ,0,0,0,0,0,0,0,0,0,89000,0,0,0,89000,0,89000,89000
1906,寶隆            ,179000,90000,89000,0,0,0,0,0,0,0,0,0,0,0,0,0,89000
2017,官田鋼          ,86000,7000,79000,0,0,0,0,0,0,10000,10000,0,10000,0,0,0,89000
9934,成霖            ,280000,198000,82000,0,0,0,0,0,0,7000,9000,2000,7000,0,0,0,89000
056756,T50反1元大98購06,0,0,0,0,0,0,0,0,0,88000,0,0,0,88000,0,88000,88000
047004,台積電統一99購01,0,0,0,0,0,0,0,0,0,88000,0,0,0,176000,88000,88000,88000
048652,巨大元大96購01  ,0,0,0,0,0,0,0,0,0,88000,0,0,0,215000,127000,88000,88000
052270,力成日盛95購01  ,0,0,0,0,0,0,0,0,0,88000,0,0,0,90000,2000,88000,88000
053409,和碩兆豐96購02  ,0,0,0,0,0,0,0,0,0,88000,0,0,0,200000,112000,88000,88000
050243,華新科凱基94購10,0,0,0,0,0,0,0,0,0,88000,0,0,0,177000,89000,88000,88000
055300,緯穎元大98購01  ,0,0,0,0,0,0,0,0,0,88000,0,0,0,339000,251000,88000,88000
05567P,致伸群益96售01  ,0,0,0,0,0,0,0,0,0,88000,0,0,0,89000,1000,88000,88000
055737,開發金元富97購01,0,0,0,0,0,0,0,0,0,88000,0,0,0,108000,20000,88000,88000
05500P,臺股指中信96售04,0,0,0,0,0,0,0,0,0,88000,0,0,0,128000,40000,88000,88000
2431,聯昌            ,120000,41000,79000,0,0,0,0,0,0,9000,9000,0,9000,0,0,0,88000
2007,燁興            ,87000,0,87000,0,0,0,0,0,0,1000,1000,0,1000,0,0,0,88000
05653P,華邦電統一96售02,0,0,0,0,0,0,0,0,0,87000,0,0,0,117000,30000,87000,87000
00650L,FH香港正2       ,15000,15000,0,0,0,0,0,0,0,87000,0,0,0,299000,212000,87000,87000
046645,技嘉國泰94購01  ,0,0,0,0,0,0,0,0,0,87000,0,0,0,100000,13000,87000,87000
054987,凱美元富97購01  ,0,0,0,0,0,0,0,0,0,87000,0,0,0,95000,8000,87000,87000
054000,訊芯群益96購02  ,0,0,0,0,0,0,0,0,0,87000,0,0,0,109000,22000,87000,87000
055937,康舒群益97購01  ,0,0,0,0,0,0,0,0,0,87000,0,0,0,98000,11000,87000,87000
1309,台達化          ,273000,186000,87000,0,0,0,0,0,0,0,0,0,0,0,0,0,87000
5243,乙盛-KY         ,258000,169000,89000,0,0,0,0,0,0,-2000,0,2000,-2000,0,0,0,87000
058364,奇力新凱基99購04,0,0,0,0,0,0,0,0,0,86000,0,0,0,98000,12000,86000,86000
057935,晶技群益98購02  ,0,0,0,0,0,0,0,0,0,86000,0,0,0,102000,16000,86000,86000
04323P,強茂元大93售02  ,0,0,0,0,0,0,0,0,0,86000,0,0,0,86000,0,86000,86000
049726,道瓊反中信96購01,0,0,0,0,0,0,0,0,0,86000,0,0,0,130000,44000,86000,86000
050896,華新科元大96購02,0,0,0,0,0,0,0,0,0,86000,0,0,0,215000,129000,86000,86000
050123,群臺反凱基96購01,0,0,0,0,0,0,0,0,0,86000,0,0,0,86000,0,86000,86000
05316P,台積電永昌96售06,0,0,0,0,0,0,0,0,0,86000,0,0,0,599000,513000,86000,86000
053293,聯發科中信9B購01,0,0,0,0,0,0,0,0,0,86000,0,0,0,92000,6000,86000,86000
052060,旺宏國票96購02  ,0,0,0,0,0,0,0,0,0,86000,0,0,0,119000,33000,86000,86000
055588,瑞昱元大97購03  ,0,0,0,0,0,0,0,0,0,86000,0,0,0,326000,240000,86000,86000
055093,京鼎群益98購01  ,0,0,0,0,0,0,0,0,0,86000,0,0,0,98000,12000,86000,86000
4526,東台            ,86000,1000,85000,0,0,0,0,0,0,1000,1000,0,1000,0,0,0,86000
3004,豐達科          ,238000,23000,215000,0,0,0,0,129000,-129000,0,0,0,0,0,0,0,86000
1435,中福            ,106000,21000,85000,0,0,0,0,0,0,1000,1000,0,1000,0,0,0,86000
06499P,臺股指元大9A售04,0,0,0,0,0,0,0,0,0,86000,0,0,0,93000,7000,86000,86000
06223P,漢唐元富97售02  ,0,0,0,0,0,0,0,0,0,86000,0,0,0,206000,120000,86000,86000
057855,晶技國票99購01  ,0,0,0,0,0,0,0,0,0,85000,0,0,0,140000,55000,85000,85000
05865P,大立光元大96售09,0,0,0,0,0,0,0,0,0,85000,0,0,0,250000,165000,85000,85000
057167,台積電元大99購03,0,0,0,0,0,0,0,0,0,85000,0,0,0,237000,152000,85000,85000
04420P,奇鋐永豐94售01  ,0,0,0,0,0,0,0,0,0,85000,0,0,0,85000,0,85000,85000
051961,泰碩永豐95購01  ,0,0,0,0,0,0,0,0,0,85000,0,0,0,90000,5000,85000,85000
055964,正文元大97購02  ,0,0,0,0,0,0,0,0,0,85000,0,0,0,105000,20000,85000,85000
06173P,華通元大97售02  ,0,0,0,0,0,0,0,0,0,85000,0,0,0,105000,20000,85000,85000
06286P,世芯國票97售02  ,0,0,0,0,0,0,0,0,0,85000,0,0,0,175000,90000,85000,85000
06533P,上証2X中信9B售01,0,0,0,0,0,0,0,0,0,85000,0,0,0,100000,15000,85000,85000
06541P,元油2X國票9A售02,0,0,0,0,0,0,0,0,0,85000,0,0,0,85000,0,85000,85000
1608,華榮            ,144000,65000,79000,0,0,0,0,0,0,6000,6000,0,6000,0,0,0,85000
06946P,T50正2元大9C售01,0,0,0,0,0,0,0,0,0,85000,0,0,0,85000,0,85000,85000
4968,立積            ,834000,828000,6000,0,0,0,0,0,0,79000,10000,6000,4000,146000,71000,75000,85000
057034,道瓊反元大9B購01,0,0,0,0,0,0,0,0,0,84000,0,0,0,143000,59000,84000,84000
04437P,滬深2X群益98售03,0,0,0,0,0,0,0,0,0,84000,0,0,0,84000,0,84000,84000
048203,矽力元大93購02  ,0,0,0,0,0,0,0,0,0,84000,0,0,0,84000,0,84000,84000
05268P,玉晶光元大98售01,0,0,0,0,0,0,0,0,0,84000,0,0,0,258000,174000,84000,84000
052952,矽創國票97購02  ,0,0,0,0,0,0,0,0,0,84000,0,0,0,172000,88000,84000,84000
053229,南電台新97購01  ,0,0,0,0,0,0,0,0,0,84000,0,0,0,313000,229000,84000,84000
050213,華新科台新94購03,0,0,0,0,0,0,0,0,0,84000,0,0,0,94000,10000,84000,84000
05301P,矽力元大95售02  ,0,0,0,0,0,0,0,0,0,84000,0,0,0,140000,56000,84000,84000
05151P,台光電群益95售02,0,0,0,0,0,0,0,0,0,84000,0,0,0,104000,20000,84000,84000
050454,嘉澤元大94購04  ,0,0,0,0,0,0,0,0,0,84000,0,0,0,94000,10000,84000,84000
055821,勤誠國票98購01  ,0,0,0,0,0,0,0,0,0,84000,0,0,0,190000,106000,84000,84000
2472,立隆電          ,183000,93000,90000,0,0,0,0,0,0,-6000,309000,315000,-6000,0,0,0,84000
1110,東泥            ,96000,9000,87000,0,0,0,0,0,0,-3000,0,3000,-3000,0,0,0,84000
06991P,矽創群益99售01  ,0,0,0,0,0,0,0,0,0,84000,0,0,0,90000,6000,84000,84000
1605,華新            ,3302000,8129000,-4827000,0,0,0,3000,0,3000,4908000,105000,71000,34000,4900000,26000,4874000,84000
049618,美律群益94購03  ,0,0,0,0,0,0,0,0,0,83000,0,0,0,120000,37000,83000,83000
05378P,台積電凱基96售02,0,0,0,0,0,0,0,0,0,83000,0,0,0,83000,0,83000,83000
2031,新光鋼          ,319000,237000,82000,0,0,0,0,0,0,1000,11000,10000,1000,0,0,0,83000
06990P,康友元富99售03  ,0,0,0,0,0,0,0,0,0,83000,0,0,0,131000,48000,83000,83000
06551P,貿聯元大98售05  ,0,0,0,0,0,0,0,0,0,83000,0,0,0,88000,5000,83000,83000
057289,力成元大98購03  ,0,0,0,0,0,0,0,0,0,82000,0,0,0,103000,21000,82000,82000
06038P,國泰金台新96售01,0,0,0,0,0,0,0,0,0,82000,0,0,0,88000,6000,82000,82000
058544,FBVIX富邦9B購01 ,0,0,0,0,0,0,0,0,0,82000,0,0,0,95000,13000,82000,82000
048762,寶齡凱基94購01  ,0,0,0,0,0,0,0,0,0,82000,0,0,0,272000,190000,82000,82000
051758,瑞昱元大95購01  ,0,0,0,0,0,0,0,0,0,82000,0,0,0,112000,30000,82000,82000
06734P,智邦凱基98售05  ,0,0,0,0,0,0,0,0,0,82000,0,0,0,158000,76000,82000,82000
06323P,台郡統一97售01  ,0,0,0,0,0,0,0,0,0,82000,0,0,0,140000,58000,82000,82000
06215P,康控永豐97售02  ,0,0,0,0,0,0,0,0,0,82000,0,0,0,82000,0,82000,82000
06908P,健策國泰99售02  ,0,0,0,0,0,0,0,0,0,82000,0,0,0,810000,728000,82000,82000
06011P,貿聯元富96售04  ,0,0,0,0,0,0,0,0,0,81000,0,0,0,91000,10000,81000,81000
057872,旺宏元大99購06  ,0,0,0,0,0,0,0,0,0,81000,0,0,0,108000,27000,81000,81000
05695P,台積電凱基96售10,0,0,0,0,0,0,0,0,0,81000,0,0,0,92000,11000,81000,81000
04283P,麗豐永豐93售03  ,0,0,0,0,0,0,0,0,0,81000,0,0,0,81000,0,81000,81000
053273,國巨元大96購08  ,0,0,0,0,0,0,0,0,0,81000,0,0,0,214000,133000,81000,81000
055957,瑞昱元大97購06  ,0,0,0,0,0,0,0,0,0,81000,0,0,0,126000,45000,81000,81000
055275,台積電元大97購19,0,0,0,0,0,0,0,0,0,81000,0,0,0,150000,69000,81000,81000
5522,遠雄            ,429000,395000,34000,0,0,0,8000,0,8000,39000,58000,19000,39000,0,0,0,81000
06014P,聯發科富邦97售02,0,0,0,0,0,0,0,0,0,80000,0,0,0,160000,80000,80000,80000
04652P,臺股指凱基94售11,0,0,0,0,0,0,0,0,0,80000,0,0,0,330000,250000,80000,80000
03016P,滬深2X群益01售09,0,0,0,0,0,0,0,0,0,80000,0,0,0,100000,20000,80000,80000
049294,南亞科群益94購01,0,0,0,0,0,0,0,0,0,80000,0,0,0,80000,0,80000,80000
04605P,台積電兆豐94售03,0,0,0,0,0,0,0,0,0,80000,0,0,0,80000,0,80000,80000
044637,滬深2X元富94購01,0,0,0,0,0,0,0,0,0,80000,0,0,0,200000,120000,80000,80000
048348,矽力元大93購03  ,0,0,0,0,0,0,0,0,0,80000,0,0,0,80000,0,80000,80000
051100,同欣電元大95購01,0,0,0,0,0,0,0,0,0,80000,0,0,0,110000,30000,80000,80000
051799,台積電永豐96購01,0,0,0,0,0,0,0,0,0,80000,0,0,0,82000,2000,80000,80000
050322,世紀鋼國票95購01,0,0,0,0,0,0,0,0,0,80000,0,0,0,119000,39000,80000,80000
053597,牧德元大99購01  ,0,0,0,0,0,0,0,0,0,80000,0,0,0,80000,0,80000,80000
053444,奇力新凱基96購03,0,0,0,0,0,0,0,0,0,80000,0,0,0,1141000,1061000,80000,80000
053691,聯發科元大96購16,0,0,0,0,0,0,0,0,0,80000,0,0,0,130000,50000,80000,80000
053588,聯發科元大97購07,0,0,0,0,0,0,0,0,0,80000,0,0,0,100000,20000,80000,80000
05350P,可成元富98售04  ,0,0,0,0,0,0,0,0,0,80000,0,0,0,80000,0,80000,80000
056194,聯發科富邦9B購01,0,0,0,0,0,0,0,0,0,80000,0,0,0,100000,20000,80000,80000
054167,揚明光凱基98購01,0,0,0,0,0,0,0,0,0,80000,0,0,0,80000,0,80000,80000
6582,申豐            ,182000,108000,74000,0,0,0,0,0,0,6000,6000,0,6000,0,0,0,80000
2539,櫻花建          ,86000,6000,80000,0,0,0,0,0,0,0,0,0,0,0,0,0,80000
06982P,義隆凱基99售02  ,0,0,0,0,0,0,0,0,0,80000,0,0,0,106000,26000,80000,80000
05775P,台積電國泰98售02,0,0,0,0,0,0,0,0,0,79000,0,0,0,133000,54000,79000,79000
058130,瑞昱元大99購01  ,0,0,0,0,0,0,0,0,0,79000,0,0,0,79000,0,79000,79000
056982,華新科群益98購05,0,0,0,0,0,0,0,0,0,79000,0,0,0,105000,26000,79000,79000
056743,貿聯凱基98購04  ,0,0,0,0,0,0,0,0,0,79000,0,0,0,79000,0,79000,79000
057161,亞德客元大98購02,0,0,0,0,0,0,0,0,0,79000,0,0,0,126000,47000,79000,79000
05745P,富邦金兆豐96售02,0,0,0,0,0,0,0,0,0,79000,0,0,0,207000,128000,79000,79000
049108,玉晶光富邦96購02,0,0,0,0,0,0,0,0,0,79000,0,0,0,101000,22000,79000,79000
044693,滬深2X元大94購01,0,0,0,0,0,0,0,0,0,79000,0,0,0,181000,102000,79000,79000
04230P,臺股指中信95售06,0,0,0,0,0,0,0,0,0,79000,0,0,0,121000,42000,79000,79000
05320P,華通凱基96售03  ,0,0,0,0,0,0,0,0,0,79000,0,0,0,84000,5000,79000,79000
05443P,宏達電元大95售05,0,0,0,0,0,0,0,0,0,79000,0,0,0,79000,0,79000,79000
05399P,GIS國票95售03   ,0,0,0,0,0,0,0,0,0,79000,0,0,0,89000,10000,79000,79000
05396P,台郡元大95售05  ,0,0,0,0,0,0,0,0,0,79000,0,0,0,112000,33000,79000,79000
054975,福懋科元大97購01,0,0,0,0,0,0,0,0,0,79000,0,0,0,169000,90000,79000,79000
054921,文曄凱基97購01  ,0,0,0,0,0,0,0,0,0,79000,0,0,0,238000,159000,79000,79000
054737,京元電凱基99購01,0,0,0,0,0,0,0,0,0,79000,0,0,0,90000,11000,79000,79000
06927P,台灣50元大9B售03,0,0,0,0,0,0,0,0,0,79000,0,0,0,90000,11000,79000,79000
06145P,華新科永豐97售02,0,0,0,0,0,0,0,0,0,79000,0,0,0,148000,69000,79000,79000
06630P,國巨群益98售08  ,0,0,0,0,0,0,0,0,0,79000,0,0,0,83000,4000,79000,79000
05678P,群創群益97售01  ,0,0,0,0,0,0,0,0,0,78000,0,0,0,89000,11000,78000,78000
05811P,臺股指國票96售04,0,0,0,0,0,0,0,0,0,78000,0,0,0,78000,0,78000,78000
058007,南電群益98購02  ,0,0,0,0,0,0,0,0,0,78000,0,0,0,201000,123000,78000,78000
03497P,金像電凱基02售06,0,0,0,0,0,0,0,0,0,78000,0,0,0,90000,12000,78000,78000
042993,葡萄王元大94購01,0,0,0,0,0,0,0,0,0,78000,0,0,0,312000,234000,78000,78000
047206,元金2X國泰94購01,0,0,0,0,0,0,0,0,0,78000,0,0,0,78000,0,78000,78000
048793,超眾元大95購02  ,0,0,0,0,0,0,0,0,0,78000,0,0,0,78000,0,78000,78000
053568,智伸科富邦98購01,0,0,0,0,0,0,0,0,0,78000,0,0,0,113000,35000,78000,78000
051666,旺宏元大96購05  ,0,0,0,0,0,0,0,0,0,78000,0,0,0,108000,30000,78000,78000
054851,樺漢兆豐97購01  ,0,0,0,0,0,0,0,0,0,78000,0,0,0,84000,6000,78000,78000
055076,福懋科永豐97購01,0,0,0,0,0,0,0,0,0,78000,0,0,0,78000,0,78000,78000
056011,矽力中信99購01  ,0,0,0,0,0,0,0,0,0,78000,0,0,0,161000,83000,78000,78000
07023P,南電永豐99售02  ,0,0,0,0,0,0,0,0,0,78000,0,0,0,78000,0,78000,78000
2477,美隆電          ,96000,14000,82000,0,0,0,0,0,0,-4000,3000,7000,-4000,0,0,0,78000
057888,貿聯群益98購02  ,0,0,0,0,0,0,0,0,0,77000,0,0,0,108000,31000,77000,77000
056494,緯創國泰99購01  ,0,0,0,0,0,0,0,0,0,77000,0,0,0,97000,20000,77000,77000
057111,立積群益98購02  ,0,0,0,0,0,0,0,0,0,77000,0,0,0,402000,325000,77000,77000
042315,T50反1台新96購01,0,0,0,0,0,0,0,0,0,77000,0,0,0,100000,23000,77000,77000
053369,T50反1元大96購06,0,0,0,0,0,0,0,0,0,77000,0,0,0,77000,0,77000,77000
053022,欣興國泰98購01  ,0,0,0,0,0,0,0,0,0,77000,0,0,0,98000,21000,77000,77000
050072,京鼎凱基94購02  ,0,0,0,0,0,0,0,0,0,77000,0,0,0,110000,33000,77000,77000
054118,國巨永豐96購04  ,0,0,0,0,0,0,0,0,0,77000,0,0,0,112000,35000,77000,77000
6235,華孚            ,80000,3000,77000,0,0,0,0,0,0,0,0,0,0,0,0,0,77000
6415,矽力-KY         ,289000,220000,69000,0,0,0,9000,6000,3000,5000,0,0,0,11000,6000,5000,77000
2204,中華            ,356000,282000,74000,0,0,0,0,0,0,3000,5000,2000,3000,0,0,0,77000
1532,勤美            ,120000,43000,77000,0,0,0,0,0,0,0,0,0,0,0,0,0,77000
06727P,台光電元大98售05,0,0,0,0,0,0,0,0,0,77000,0,0,0,177000,100000,77000,77000
06208P,台郡凱基97售03  ,0,0,0,0,0,0,0,0,0,77000,0,0,0,120000,43000,77000,77000
057660,訊芯兆豐98購02  ,0,0,0,0,0,0,0,0,0,76000,0,0,0,86000,10000,76000,76000
05996P,華新科群益96售03,0,0,0,0,0,0,0,0,0,76000,0,0,0,132000,56000,76000,76000
04176P,台達電元大94售01,0,0,0,0,0,0,0,0,0,76000,0,0,0,83000,7000,76000,76000
040760,T50反1凱基95購01,0,0,0,0,0,0,0,0,0,76000,0,0,0,80000,4000,76000,76000
048189,臺指反元大96購06,0,0,0,0,0,0,0,0,0,76000,0,0,0,76000,0,76000,76000
049915,瑞昱元大94購07  ,0,0,0,0,0,0,0,0,0,76000,0,0,0,96000,20000,76000,76000
052980,上銀元大96購03  ,0,0,0,0,0,0,0,0,0,76000,0,0,0,365000,289000,76000,76000
050813,旺宏凱基96購01  ,0,0,0,0,0,0,0,0,0,76000,0,0,0,206000,130000,76000,76000
06167P,欣興國票97售05  ,0,0,0,0,0,0,0,0,0,76000,0,0,0,100000,24000,76000,76000
06106P,國巨群益97售02  ,0,0,0,0,0,0,0,0,0,76000,0,0,0,101000,25000,76000,76000
06966P,健策台新9A售02  ,0,0,0,0,0,0,0,0,0,76000,0,0,0,76000,0,76000,76000
06959P,鴻海凱基9A售02  ,0,0,0,0,0,0,0,0,0,76000,0,0,0,86000,10000,76000,76000
06850P,聯茂元大98售06  ,0,0,0,0,0,0,0,0,0,76000,0,0,0,76000,0,76000,76000
04566P,GIS凱基94售04   ,0,0,0,0,0,0,0,0,0,75000,0,0,0,75000,0,75000,75000
051101,台表科元大96購02,0,0,0,0,0,0,0,0,0,75000,0,0,0,75000,0,75000,75000
053577,上証2X元大96購02,0,0,0,0,0,0,0,0,0,75000,0,0,0,387000,312000,75000,75000
05244P,台積電元大95售17,0,0,0,0,0,0,0,0,0,75000,0,0,0,1070000,995000,75000,75000
050366,鴻海元大94購19  ,0,0,0,0,0,0,0,0,0,75000,0,0,0,125000,50000,75000,75000
050444,卜蜂元大94購03  ,0,0,0,0,0,0,0,0,0,75000,0,0,0,80000,5000,75000,75000
05501P,健策國票97售01  ,0,0,0,0,0,0,0,0,0,75000,0,0,0,75000,0,75000,75000
054544,統一中信97購01  ,0,0,0,0,0,0,0,0,0,75000,0,0,0,80000,5000,75000,75000
056320,京鼎群益99購01  ,0,0,0,0,0,0,0,0,0,75000,0,0,0,98000,23000,75000,75000
055303,鈺齊元大97購01  ,0,0,0,0,0,0,0,0,0,75000,0,0,0,105000,30000,75000,75000
055341,台達電凱基97購02,0,0,0,0,0,0,0,0,0,75000,0,0,0,80000,5000,75000,75000
06625P,華新科統一98售03,0,0,0,0,0,0,0,0,0,75000,0,0,0,75000,0,75000,75000
06660P,大立光富邦9B售03,0,0,0,0,0,0,0,0,0,75000,0,0,0,75000,0,75000,75000
06601P,臺股指永豐98售04,0,0,0,0,0,0,0,0,0,75000,0,0,0,75000,0,75000,75000
6112,聚碩            ,150000,76000,74000,0,0,0,0,0,0,1000,1000,0,1000,0,0,0,75000
05741P,聯發科元大96售14,0,0,0,0,0,0,0,0,0,74000,0,0,0,473000,399000,74000,74000
056565,欣興群益98購03  ,0,0,0,0,0,0,0,0,0,74000,0,0,0,268000,194000,74000,74000
04177P,富邦金元大94售01,0,0,0,0,0,0,0,0,0,74000,0,0,0,110000,36000,74000,74000
050477,矽力永豐94購01  ,0,0,0,0,0,0,0,0,0,74000,0,0,0,90000,16000,74000,74000
056281,深中小永豐97購01,0,0,0,0,0,0,0,0,0,74000,0,0,0,92000,18000,74000,74000
05470P,康控元大95售05  ,0,0,0,0,0,0,0,0,0,74000,0,0,0,74000,0,74000,74000
06137P,玉晶光永豐97售04,0,0,0,0,0,0,0,0,0,74000,0,0,0,88000,14000,74000,74000
056774,和鑫元大98購01  ,0,0,0,0,0,0,0,0,0,73000,0,0,0,73000,0,73000,73000
057986,華新科元富99購05,0,0,0,0,0,0,0,0,0,73000,0,0,0,168000,95000,73000,73000
04432P,昇陽半元大94售04,0,0,0,0,0,0,0,0,0,73000,0,0,0,83000,10000,73000,73000
051126,訊連群益95購01  ,0,0,0,0,0,0,0,0,0,73000,0,0,0,83000,10000,73000,73000
056282,S&P反1永豐97購01,0,0,0,0,0,0,0,0,0,73000,0,0,0,73000,0,73000,73000
056060,宏達電元大99購01,0,0,0,0,0,0,0,0,0,73000,0,0,0,249000,176000,73000,73000
06449P,台積電元大98售09,0,0,0,0,0,0,0,0,0,73000,0,0,0,148000,75000,73000,73000
1231,聯華食          ,107000,35000,72000,0,0,0,0,0,0,1000,1000,0,1000,0,0,0,73000
1526,日馳            ,106000,33000,73000,0,0,0,0,0,0,0,0,0,0,0,0,0,73000
3533,嘉澤            ,228000,177000,51000,0,0,0,35000,37000,-2000,24000,50000,18000,32000,2000,10000,-8000,73000
3356,奇偶            ,115000,42000,73000,0,0,0,0,0,0,0,4000,4000,0,0,0,0,73000
1340,勝悅-KY         ,81110,7000,74110,0,0,0,0,0,0,-2000,0,2000,-2000,0,0,0,72110
06063P,玉晶光元富97售01,0,0,0,0,0,0,0,0,0,72000,0,0,0,257000,185000,72000,72000
06049P,創意亞東97售01  ,0,0,0,0,0,0,0,0,0,72000,0,0,0,77000,5000,72000,72000
057493,聯詠元大98購02  ,0,0,0,0,0,0,0,0,0,72000,0,0,0,108000,36000,72000,72000
050035,聯茂元大94購07  ,0,0,0,0,0,0,0,0,0,72000,0,0,0,137000,65000,72000,72000
04834P,鴻海元大94售17  ,0,0,0,0,0,0,0,0,0,72000,0,0,0,72000,0,72000,72000
05100P,智邦凱基95售02  ,0,0,0,0,0,0,0,0,0,72000,0,0,0,101000,29000,72000,72000
052719,致新凱基96購01  ,0,0,0,0,0,0,0,0,0,72000,0,0,0,88000,16000,72000,72000
051487,健策凱基96購03  ,0,0,0,0,0,0,0,0,0,72000,0,0,0,100000,28000,72000,72000
053381,友達元大9A購02  ,0,0,0,0,0,0,0,0,0,72000,0,0,0,93000,21000,72000,72000
056293,上銀元大97購10  ,0,0,0,0,0,0,0,0,0,72000,0,0,0,82000,10000,72000,72000
055222,臺股指凱基97購05,0,0,0,0,0,0,0,0,0,72000,0,0,0,171000,99000,72000,72000
055712,金寶元大97購02  ,0,0,0,0,0,0,0,0,0,72000,0,0,0,140000,68000,72000,72000
05469P,台積電元大95售24,0,0,0,0,0,0,0,0,0,72000,0,0,0,875000,803000,72000,72000
055142,健策永豐98購01  ,0,0,0,0,0,0,0,0,0,72000,0,0,0,137000,65000,72000,72000
06396P,新日興康和97售01,0,0,0,0,0,0,0,0,0,72000,0,0,0,72000,0,72000,72000
06044P,同欣電永豐96售03,0,0,0,0,0,0,0,0,0,71000,0,0,0,129000,58000,71000,71000
057932,美律群益98購04  ,0,0,0,0,0,0,0,0,0,71000,0,0,0,156000,85000,71000,71000
047618,義隆凱基94購02  ,0,0,0,0,0,0,0,0,0,71000,0,0,0,71000,0,71000,71000
05276P,GIS永豐95售02   ,0,0,0,0,0,0,0,0,0,71000,0,0,0,71000,0,71000,71000
03421B,臺股指元大99熊01,0,0,0,0,0,0,0,0,0,71000,0,0,0,71000,0,71000,71000
053670,台積電統一96購09,0,0,0,0,0,0,0,0,0,71000,0,0,0,274000,203000,71000,71000
052477,美律群益98購01  ,0,0,0,0,0,0,0,0,0,71000,0,0,0,131000,60000,71000,71000
053656,可成凱基96購06  ,0,0,0,0,0,0,0,0,0,71000,0,0,0,109000,38000,71000,71000
05019P,喬山中信95售01  ,0,0,0,0,0,0,0,0,0,71000,0,0,0,122000,51000,71000,71000
051834,南電元大96購02  ,0,0,0,0,0,0,0,0,0,71000,0,0,0,71000,0,71000,71000
05495P,大立光統一95售07,0,0,0,0,0,0,0,0,0,71000,0,0,0,85000,14000,71000,71000
054701,宏全永豐97購01  ,0,0,0,0,0,0,0,0,0,71000,0,0,0,81000,10000,71000,71000
054788,華新科群益98購02,0,0,0,0,0,0,0,0,0,71000,0,0,0,71000,0,71000,71000
055989,矽力元富9A購01  ,0,0,0,0,0,0,0,0,0,71000,0,0,0,136000,65000,71000,71000
055952,上銀元大97購08  ,0,0,0,0,0,0,0,0,0,71000,0,0,0,191000,120000,71000,71000
055971,矽力元大97購05  ,0,0,0,0,0,0,0,0,0,71000,0,0,0,71000,0,71000,71000
06407P,創意元富97售02  ,0,0,0,0,0,0,0,0,0,71000,0,0,0,81000,10000,71000,71000
06276P,臺股指凱基97售08,0,0,0,0,0,0,0,0,0,71000,0,0,0,71000,0,71000,71000
06195P,台積電元富97售06,0,0,0,0,0,0,0,0,0,71000,0,0,0,1076000,1005000,71000,71000
2022,聚亨            ,78000,7000,71000,0,0,0,0,0,0,0,0,0,0,0,0,0,71000
3266,昇陽            ,75000,4000,71000,0,0,0,0,0,0,0,0,0,0,0,0,0,71000
06020P,燿華元富96售04  ,0,0,0,0,0,0,0,0,0,70000,0,0,0,70000,0,70000,70000
057443,臺股指統一99購04,0,0,0,0,0,0,0,0,0,70000,0,0,0,90000,20000,70000,70000
056604,鴻海富邦9A購01  ,0,0,0,0,0,0,0,0,0,70000,0,0,0,150000,80000,70000,70000
03064X,元展59          ,0,0,0,0,0,0,0,0,0,70000,0,0,0,70000,0,70000,70000
048135,瀚宇博國票94購01,0,0,0,0,0,0,0,0,0,70000,0,0,0,80000,10000,70000,70000
045479,T50反1中信95購01,0,0,0,0,0,0,0,0,0,70000,0,0,0,70000,0,70000,70000
043726,T50反1國泰93購01,0,0,0,0,0,0,0,0,0,70000,0,0,0,70000,0,70000,70000
04921P,TPK凱基94售05   ,0,0,0,0,0,0,0,0,0,70000,0,0,0,70000,0,70000,70000
04872P,高股息中信94售01,0,0,0,0,0,0,0,0,0,70000,0,0,0,80000,10000,70000,70000
049178,宏達電凱基94購02,0,0,0,0,0,0,0,0,0,70000,0,0,0,70000,0,70000,70000
04751P,智邦兆豐95售02  ,0,0,0,0,0,0,0,0,0,70000,0,0,0,111000,41000,70000,70000
050137,臺指反國票96購01,0,0,0,0,0,0,0,0,0,70000,0,0,0,70000,0,70000,70000
053595,創意元大96購02  ,0,0,0,0,0,0,0,0,0,70000,0,0,0,100000,30000,70000,70000
05237P,為升永豐95售01  ,0,0,0,0,0,0,0,0,0,70000,0,0,0,470000,400000,70000,70000
05207P,高股息中信97售03,0,0,0,0,0,0,0,0,0,70000,0,0,0,70000,0,70000,70000
05274P,嘉聯益亞東95售01,0,0,0,0,0,0,0,0,0,70000,0,0,0,70000,0,70000,70000
05126P,牧德群益95售01  ,0,0,0,0,0,0,0,0,0,70000,0,0,0,70000,0,70000,70000
05598P,國巨元富96售03  ,0,0,0,0,0,0,0,0,0,70000,0,0,0,85000,15000,70000,70000
05524P,瀚宇博國票97售02,0,0,0,0,0,0,0,0,0,70000,0,0,0,100000,30000,70000,70000
054969,亞翔元大97購01  ,0,0,0,0,0,0,0,0,0,70000,0,0,0,70000,0,70000,70000
055129,鈺齊兆豐97購01  ,0,0,0,0,0,0,0,0,0,70000,0,0,0,80000,10000,70000,70000
054023,和大康和96購01  ,0,0,0,0,0,0,0,0,0,70000,0,0,0,70000,0,70000,70000
1773,勝一            ,160000,90000,70000,0,0,0,0,0,0,0,0,0,0,0,0,0,70000
06870P,台灣50群益9A售03,0,0,0,0,0,0,0,0,0,70000,0,0,0,70000,0,70000,70000
06085P,義隆台新97售01  ,0,0,0,0,0,0,0,0,0,70000,0,0,0,79000,9000,70000,70000
06674P,祥碩群益98售02  ,0,0,0,0,0,0,0,0,0,70000,0,0,0,373000,303000,70000,70000
2207,和泰車          ,397000,329020,67980,0,0,0,0,0,0,2000,3000,1000,2000,0,0,0,69980
05659P,A50正2中信97售01,0,0,0,0,0,0,0,0,0,69000,0,0,0,71000,2000,69000,69000
05853P,欣興群益96售05  ,0,0,0,0,0,0,0,0,0,69000,0,0,0,110000,41000,69000,69000
04848P,康控凱基94售02  ,0,0,0,0,0,0,0,0,0,69000,0,0,0,69000,0,69000,69000
04939P,國巨國票95售03  ,0,0,0,0,0,0,0,0,0,69000,0,0,0,114000,45000,69000,69000
052939,富邦金兆豐96購01,0,0,0,0,0,0,0,0,0,69000,0,0,0,221000,152000,69000,69000
044475,國巨元富95購02  ,0,0,0,0,0,0,0,0,0,69000,0,0,0,69000,0,69000,69000
05368P,可成元富95售03  ,0,0,0,0,0,0,0,0,0,69000,0,0,0,69000,0,69000,69000
051138,訊連永豐95購01  ,0,0,0,0,0,0,0,0,0,69000,0,0,0,69000,0,69000,69000
051985,智邦元大95購05  ,0,0,0,0,0,0,0,0,0,69000,0,0,0,157000,88000,69000,69000
053994,微星群益96購01  ,0,0,0,0,0,0,0,0,0,69000,0,0,0,69000,0,69000,69000
2013,中鋼構          ,124000,55000,69000,0,0,0,0,0,0,0,0,0,0,0,0,0,69000
06669P,緯穎凱基98售05  ,0,0,0,0,0,0,0,0,0,69000,0,0,0,214000,145000,69000,69000
06631P,玉晶光群益9A售03,0,0,0,0,0,0,0,0,0,69000,0,0,0,69000,0,69000,69000
06507P,台表科國票99售01,0,0,0,0,0,0,0,0,0,69000,0,0,0,69000,0,69000,69000
3149,正達            ,70000,1000,69000,0,0,0,0,0,0,0,0,0,0,0,0,0,69000
2838A,聯邦銀甲特      ,0,0,0,0,0,0,0,0,0,69000,94000,25000,69000,0,0,0,69000
058640,台灣50麥證9A購01,0,0,0,131000,63000,68000,0,0,0,68000,0,0,0,131000,63000,68000,68000
057817,景碩元大98購01  ,0,0,0,0,0,0,0,0,0,68000,0,0,0,68000,0,68000,68000
057803,上銀元大98購08  ,0,0,0,0,0,0,0,0,0,68000,0,0,0,68000,0,68000,68000
058072,大立光凱基98購20,0,0,0,0,0,0,0,0,0,68000,0,0,0,68000,0,68000,68000
056567,瀚宇博群益98購02,0,0,0,0,0,0,0,0,0,68000,0,0,0,133000,65000,68000,68000
056532,技嘉凱基98購01  ,0,0,0,0,0,0,0,0,0,68000,0,0,0,130000,62000,68000,68000
056841,友達元富98購03  ,0,0,0,0,0,0,0,0,0,68000,0,0,0,68000,0,68000,68000
056963,建準永豐98購01  ,0,0,0,0,0,0,0,0,0,68000,0,0,0,68000,0,68000,68000
056919,英業達兆豐98購01,0,0,0,0,0,0,0,0,0,68000,0,0,0,68000,0,68000,68000
057573,京鼎永豐98購02  ,0,0,0,0,0,0,0,0,0,68000,0,0,0,68000,0,68000,68000
057060,緯穎元大98購05  ,0,0,0,0,0,0,0,0,0,68000,0,0,0,88000,20000,68000,68000
057076,緯穎永豐98購01  ,0,0,0,0,0,0,0,0,0,68000,0,0,0,88000,20000,68000,68000
057176,全新元大99購02  ,0,0,0,0,0,0,0,0,0,68000,0,0,0,148000,80000,68000,68000
043748,漢唐元大93購01  ,0,0,0,0,0,0,0,0,0,68000,0,0,0,68000,0,68000,68000
049256,瑞昱元大94購04  ,0,0,0,0,0,0,0,0,0,68000,0,0,0,68000,0,68000,68000
049489,美律元大94購05  ,0,0,0,0,0,0,0,0,0,68000,0,0,0,68000,0,68000,68000
051474,智邦凱基95購04  ,0,0,0,0,0,0,0,0,0,68000,0,0,0,68000,0,68000,68000
050825,嘉澤凱基95購01  ,0,0,0,0,0,0,0,0,0,68000,0,0,0,68000,0,68000,68000
053271,喬山元大97購01  ,0,0,0,0,0,0,0,0,0,68000,0,0,0,130000,62000,68000,68000
050181,富邦金元大94購02,0,0,0,0,0,0,0,0,0,68000,0,0,0,68000,0,68000,68000
053041,可成凱基96購02  ,0,0,0,0,0,0,0,0,0,68000,0,0,0,68000,0,68000,68000
051945,智邦統一95購03  ,0,0,0,0,0,0,0,0,0,68000,0,0,0,68000,0,68000,68000
053688,燿華元大96購05  ,0,0,0,0,0,0,0,0,0,68000,0,0,0,68000,0,68000,68000
053375,鴻海元大96購18  ,0,0,0,0,0,0,0,0,0,68000,0,0,0,68000,0,68000,68000
053376,鴻海元大96購19  ,0,0,0,0,0,0,0,0,0,68000,0,0,0,78000,10000,68000,68000
053284,樺漢元大97購01  ,0,0,0,0,0,0,0,0,0,68000,0,0,0,78000,10000,68000,68000
053594,京鼎元大96購02  ,0,0,0,0,0,0,0,0,0,68000,0,0,0,68000,0,68000,68000
051342,光寶科元大95購01,0,0,0,0,0,0,0,0,0,68000,0,0,0,68000,0,68000,68000
050448,義隆元大94購04  ,0,0,0,0,0,0,0,0,0,68000,0,0,0,68000,0,68000,68000
052045,瑞昱凱基96購01  ,0,0,0,0,0,0,0,0,0,68000,0,0,0,68000,0,68000,68000
05204P,TPK元大95售03   ,0,0,0,0,0,0,0,0,0,68000,0,0,0,68000,0,68000,68000
051671,和鑫元大96購02  ,0,0,0,0,0,0,0,0,0,68000,0,0,0,68000,0,68000,68000
053783,聯發科元大96購17,0,0,0,0,0,0,0,0,0,68000,0,0,0,68000,0,68000,68000
053746,彰銀康和96購01  ,0,0,0,0,0,0,0,0,0,68000,0,0,0,68000,0,68000,68000
053875,GIS元大97購01   ,0,0,0,0,0,0,0,0,0,68000,0,0,0,68000,0,68000,68000
053866,景碩元大97購02  ,0,0,0,0,0,0,0,0,0,68000,0,0,0,68000,0,68000,68000
054161,友訊凱基98購01  ,0,0,0,0,0,0,0,0,0,68000,0,0,0,98000,30000,68000,68000
054265,GIS元大96購03   ,0,0,0,0,0,0,0,0,0,68000,0,0,0,68000,0,68000,68000
054466,欣興凱基97購03  ,0,0,0,0,0,0,0,0,0,68000,0,0,0,68000,0,68000,68000
054922,文曄凱基98購01  ,0,0,0,0,0,0,0,0,0,68000,0,0,0,68000,0,68000,68000
055375,京鼎元大97購03  ,0,0,0,0,0,0,0,0,0,68000,0,0,0,121000,53000,68000,68000
055459,建準永豐97購03  ,0,0,0,0,0,0,0,0,0,68000,0,0,0,68000,0,68000,68000
055581,和大元大97購04  ,0,0,0,0,0,0,0,0,0,68000,0,0,0,68000,0,68000,68000
055988,矽力元富97購01  ,0,0,0,0,0,0,0,0,0,68000,0,0,0,106000,38000,68000,68000
055809,T50反1國票98購02,0,0,0,0,0,0,0,0,0,68000,0,0,0,158000,90000,68000,68000
056298,億光元大97購02  ,0,0,0,0,0,0,0,0,0,68000,0,0,0,68000,0,68000,68000
056230,可成凱基98購03  ,0,0,0,0,0,0,0,0,0,68000,0,0,0,68000,0,68000,68000
056372,訊芯元大98購04  ,0,0,0,0,0,0,0,0,0,68000,0,0,0,68000,0,68000,68000
056392,玉晶光富邦9C購01,0,0,0,0,0,0,0,0,0,68000,0,0,0,420000,352000,68000,68000
2911,麗嬰房          ,72000,4000,68000,0,0,0,0,0,0,0,0,0,0,0,0,0,68000
06364P,鴻海凱基97售08  ,0,0,0,0,0,0,0,0,0,68000,0,0,0,125000,57000,68000,68000
1319,東陽            ,644028,631000,13028,0,0,0,0,0,0,54000,58000,4000,54000,0,0,0,67028
057613,瑞昱元富02購02  ,0,0,0,0,0,0,0,0,0,67000,0,0,0,133000,66000,67000,67000
056905,欣興元大98購03  ,0,0,0,0,0,0,0,0,0,67000,0,0,0,92000,25000,67000,67000
04854P,鴻海國泰96售04  ,0,0,0,0,0,0,0,0,0,67000,0,0,0,179000,112000,67000,67000
044950,玉晶光群益94購01,0,0,0,0,0,0,0,0,0,67000,0,0,0,68000,1000,67000,67000
052078,大立光元富95購10,0,0,0,0,0,0,0,0,0,67000,0,0,0,200000,133000,67000,67000
052094,瀚宇博元大96購02,0,0,0,0,0,0,0,0,0,67000,0,0,0,67000,0,67000,67000
055938,矽力群益97購01  ,0,0,0,0,0,0,0,0,0,67000,0,0,0,221000,154000,67000,67000
05575P,玉晶光元富96售01,0,0,0,0,0,0,0,0,0,67000,0,0,0,88000,21000,67000,67000
055690,矽力凱基97購02  ,0,0,0,0,0,0,0,0,0,67000,0,0,0,88000,21000,67000,67000
06810P,國巨統一99售03  ,0,0,0,0,0,0,0,0,0,67000,0,0,0,77000,10000,67000,67000
057636,上銀元大98購06  ,0,0,0,0,0,0,0,0,0,66000,0,0,0,86000,20000,66000,66000
05862P,大立光國泰98售01,0,0,0,0,0,0,0,0,0,66000,0,0,0,399000,333000,66000,66000
04198P,滬深2X群益95售04,0,0,0,0,0,0,0,0,0,66000,0,0,0,90000,24000,66000,66000
047576,技嘉群益94購01  ,0,0,0,0,0,0,0,0,0,66000,0,0,0,66000,0,66000,66000
05365P,臺股指富邦95售05,0,0,0,0,0,0,0,0,0,66000,0,0,0,66000,0,66000,66000
052508,矽力日盛95購02  ,0,0,0,0,0,0,0,0,0,66000,0,0,0,66000,0,66000,66000
05608P,聯發科凱基96售10,0,0,0,0,0,0,0,0,0,66000,0,0,0,77000,11000,66000,66000
06917P,聯電亞東99售01  ,0,0,0,0,0,0,0,0,0,66000,0,0,0,66000,0,66000,66000
06476P,臺股指永豐98售01,0,0,0,0,0,0,0,0,0,66000,0,0,0,66000,0,66000,66000
2702,華園            ,70000,15000,55000,0,0,0,0,0,0,11000,11000,0,11000,0,0,0,66000
058499,滬深2X元大9C購01,0,0,0,0,0,0,0,0,0,65000,0,0,0,100000,35000,65000,65000
058153,景碩統一9B購01  ,0,0,0,0,0,0,0,0,0,65000,0,0,0,91000,26000,65000,65000
057366,智邦元大98購08  ,0,0,0,0,0,0,0,0,0,65000,0,0,0,72000,7000,65000,65000
057106,美律群益98購03  ,0,0,0,0,0,0,0,0,0,65000,0,0,0,75000,10000,65000,65000
04250P,嘉晶統一95售02  ,0,0,0,0,0,0,0,0,0,65000,0,0,0,183000,118000,65000,65000
053662,矽力凱基97購01  ,0,0,0,0,0,0,0,0,0,65000,0,0,0,68000,3000,65000,65000
052071,臺股指兆豐95購01,0,0,0,0,0,0,0,0,0,65000,0,0,0,65000,0,65000,65000
051347,國巨元大95購06  ,0,0,0,0,0,0,0,0,0,65000,0,0,0,179000,114000,65000,65000
05182P,嘉晶統一95售03  ,0,0,0,0,0,0,0,0,0,65000,0,0,0,65000,0,65000,65000
051431,群創元富99購02  ,0,0,0,0,0,0,0,0,0,65000,0,0,0,65000,0,65000,65000
05414P,台表科國票96售02,0,0,0,0,0,0,0,0,0,65000,0,0,0,65000,0,65000,65000
2704,國賓            ,109000,44000,65000,0,0,0,0,0,0,0,0,0,0,0,0,0,65000
2020,美亞            ,70000,5000,65000,0,0,0,0,0,0,0,0,0,0,0,0,0,65000
057391,樺漢永豐98購01  ,0,0,0,0,0,0,0,0,0,64000,0,0,0,64000,0,64000,64000
057435,旺宏國票99購04  ,0,0,0,0,0,0,0,0,0,64000,0,0,0,64000,0,64000,64000
057472,T50正2元大9B購03,0,0,0,0,0,0,0,0,0,64000,0,0,0,64000,0,64000,64000
057634,道瓊反元大99購01,0,0,0,0,0,0,0,0,0,64000,0,0,0,128000,64000,64000,64000
056449,義隆凱基98購03  ,0,0,0,0,0,0,0,0,0,64000,0,0,0,244000,180000,64000,64000
056739,美律凱基98購04  ,0,0,0,0,0,0,0,0,0,64000,0,0,0,97000,33000,64000,64000
05186P,鈺齊中信95售02  ,0,0,0,0,0,0,0,0,0,64000,0,0,0,76000,12000,64000,64000
050142,聯發科元富9A購01,0,0,0,0,0,0,0,0,0,64000,0,0,0,237000,173000,64000,64000
052457,日月光元富95購01,0,0,0,0,0,0,0,0,0,64000,0,0,0,114000,50000,64000,64000
056077,矽力元大97購07  ,0,0,0,0,0,0,0,0,0,64000,0,0,0,177000,113000,64000,64000
06937P,GIS元大98售03   ,0,0,0,0,0,0,0,0,0,64000,0,0,0,83000,19000,64000,64000
3419,譁裕            ,107000,43000,64000,0,0,0,0,0,0,0,0,0,0,0,0,0,64000
9908,大台北          ,72000,11000,61000,0,0,0,0,0,0,3000,3000,0,3000,0,0,0,64000
050887,台積電富邦95購05,0,0,0,0,0,0,0,0,0,63000,0,0,0,135000,72000,63000,63000
053888,和大群益97購01  ,0,0,0,0,0,0,0,0,0,63000,0,0,0,223000,160000,63000,63000
053749,揚明光永豐97購01,0,0,0,0,0,0,0,0,0,63000,0,0,0,68000,5000,63000,63000
6504,南六            ,219000,171000,48000,0,0,0,0,0,0,15000,20000,5000,15000,0,0,0,63000
06560P,台積電統一98售07,0,0,0,0,0,0,0,0,0,63000,0,0,0,63000,0,63000,63000
06391P,上銀中信97售03  ,0,0,0,0,0,0,0,0,0,63000,0,0,0,68000,5000,63000,63000
06431P,新日興元大97售05,0,0,0,0,0,0,0,0,0,63000,0,0,0,63000,0,63000,63000
05673P,台積電群益96售05,0,0,0,0,0,0,0,0,0,62000,0,0,0,62000,0,62000,62000
057325,可成群益9A購01  ,0,0,0,0,0,0,0,0,0,62000,0,0,0,62000,0,62000,62000
03896P,長榮航凱基95售01,0,0,0,0,0,0,0,0,0,62000,0,0,0,88000,26000,62000,62000
047797,臺股指群益93購08,0,0,0,0,0,0,0,0,0,62000,0,0,0,62000,0,62000,62000
052090,聯發科元大97購03,0,0,0,0,0,0,0,0,0,62000,0,0,0,65000,3000,62000,62000
054579,聯茂元大97購01  ,0,0,0,0,0,0,0,0,0,62000,0,0,0,123000,61000,62000,62000
06239P,奇力新元大97售08,0,0,0,0,0,0,0,0,0,62000,0,0,0,77000,15000,62000,62000
06978P,聯發科富邦9B售02,0,0,0,0,0,0,0,0,0,62000,0,0,0,62000,0,62000,62000
3622,洋華            ,102000,40000,62000,0,0,0,0,0,0,0,0,0,0,0,0,0,62000
3312,弘憶股          ,181000,119000,62000,0,0,0,0,0,0,0,0,0,0,0,0,0,62000
05795P,華邦電群益96售05,0,0,0,0,0,0,0,0,0,61000,0,0,0,61000,0,61000,61000
06023P,超眾國票96售03  ,0,0,0,0,0,0,0,0,0,61000,0,0,0,61000,0,61000,61000
04805P,創意元富94售01  ,0,0,0,0,0,0,0,0,0,61000,0,0,0,93000,32000,61000,61000
050614,聯發科元大95購04,0,0,0,0,0,0,0,0,0,61000,0,0,0,81000,20000,61000,61000
053898,康友群益97購01  ,0,0,0,0,0,0,0,0,0,61000,0,0,0,65000,4000,61000,61000
054177,牧德台新97購01  ,0,0,0,0,0,0,0,0,0,61000,0,0,0,94000,33000,61000,61000
054192,國巨中信98購01  ,0,0,0,0,0,0,0,0,0,61000,0,0,0,129000,68000,61000,61000
056044,同欣電凱基97購03,0,0,0,0,0,0,0,0,0,61000,0,0,0,118000,57000,61000,61000
055711,上銀元大97購04  ,0,0,0,0,0,0,0,0,0,61000,0,0,0,104000,43000,61000,61000
055474,欣興凱基97購05  ,0,0,0,0,0,0,0,0,0,61000,0,0,0,309000,248000,61000,61000
055177,宏達電統一99購01,0,0,0,0,0,0,0,0,0,61000,0,0,0,61000,0,61000,61000
2467,志聖            ,354000,292000,62000,0,0,0,0,0,0,-1000,1000,2000,-1000,0,0,0,61000
06656P,GIS元大98售02   ,0,0,0,0,0,0,0,0,0,61000,0,0,0,61000,0,61000,61000
05990P,台積電群益96售13,0,0,0,0,0,0,0,0,0,60000,0,0,0,140000,80000,60000,60000
057805,華通元大98購06  ,0,0,0,0,0,0,0,0,0,60000,0,0,0,176000,116000,60000,60000
058029,台灣50永豐9A購01,0,0,0,0,0,0,0,0,0,60000,0,0,0,60000,0,60000,60000
056624,景碩永豐98購01  ,0,0,0,0,0,0,0,0,0,60000,0,0,0,60000,0,60000,60000
056879,旺宏國票99購02  ,0,0,0,0,0,0,0,0,0,60000,0,0,0,60000,0,60000,60000
047969,台達電富邦97購01,0,0,0,0,0,0,0,0,0,60000,0,0,0,170000,110000,60000,60000
047722,南電凱基94購02  ,0,0,0,0,0,0,0,0,0,60000,0,0,0,60000,0,60000,60000
04976P,中磊凱基94售01  ,0,0,0,0,0,0,0,0,0,60000,0,0,0,60000,0,60000,60000
052899,和大國票97購01  ,0,0,0,0,0,0,0,0,0,60000,0,0,0,90000,30000,60000,60000
049022,聯詠群益94購01  ,0,0,0,0,0,0,0,0,0,60000,0,0,0,60000,0,60000,60000
048977,晶相光元大94購01,0,0,0,0,0,0,0,0,0,60000,0,0,0,80000,20000,60000,60000
044016,義隆凱基93購01  ,0,0,0,0,0,0,0,0,0,60000,0,0,0,88000,28000,60000,60000
04630P,嘉聯益元大95售02,0,0,0,0,0,0,0,0,0,60000,0,0,0,60000,0,60000,60000
04558P,瑞昱日盛94售01  ,0,0,0,0,0,0,0,0,0,60000,0,0,0,60000,0,60000,60000
04337P,台積電元大93售25,0,0,0,0,0,0,0,0,0,60000,0,0,0,140000,80000,60000,60000
050688,大立光日盛94購03,0,0,0,0,0,0,0,0,0,60000,0,0,0,60000,0,60000,60000
050499,台達電凱基94購11,0,0,0,0,0,0,0,0,0,60000,0,0,0,60000,0,60000,60000
051118,台塑群益95購01  ,0,0,0,0,0,0,0,0,0,60000,0,0,0,60000,0,60000,60000
052724,力成統一97購01  ,0,0,0,0,0,0,0,0,0,60000,0,0,0,100000,40000,60000,60000
053139,滬深2X永豐98購01,0,0,0,0,0,0,0,0,0,60000,0,0,0,60000,0,60000,60000
050378,上証2X群益98購02,0,0,0,0,0,0,0,0,0,60000,0,0,0,155000,95000,60000,60000
052243,致茂康和95購01  ,0,0,0,0,0,0,0,0,0,60000,0,0,0,60000,0,60000,60000
053698,中磊元大96購02  ,0,0,0,0,0,0,0,0,0,60000,0,0,0,60000,0,60000,60000
055742,健策元富97購02  ,0,0,0,0,0,0,0,0,0,60000,0,0,0,60000,0,60000,60000
055641,鴻海元富97購04  ,0,0,0,0,0,0,0,0,0,60000,0,0,0,75000,15000,60000,60000
055931,冠德群益97購02  ,0,0,0,0,0,0,0,0,0,60000,0,0,0,60000,0,60000,60000
056208,崇越永豐97購01  ,0,0,0,0,0,0,0,0,0,60000,0,0,0,60000,0,60000,60000
054230,上銀群益96購03  ,0,0,0,0,0,0,0,0,0,60000,0,0,0,124000,64000,60000,60000
05393P,鴻海統一95售14  ,0,0,0,0,0,0,0,0,0,60000,0,0,0,60000,0,60000,60000
054718,可成永豐97購01  ,0,0,0,0,0,0,0,0,0,60000,0,0,0,60000,0,60000,60000
054990,凌陽元富97購01  ,0,0,0,0,0,0,0,0,0,60000,0,0,0,60000,0,60000,60000
06480P,上銀凱基98售04  ,0,0,0,0,0,0,0,0,0,60000,0,0,0,60000,0,60000,60000
1234,黑松            ,70000,10000,60000,0,0,0,0,0,0,0,0,0,0,0,0,0,60000
08703P,華碩凱基01售02  ,0,0,0,0,0,0,0,0,0,60000,0,0,0,60000,0,60000,60000
3059,華晶科          ,255000,195000,60000,0,0,0,0,0,0,0,0,0,0,0,0,0,60000
2913,農林            ,293000,245000,48000,0,0,0,0,0,0,12000,13000,1000,12000,0,0,0,60000
05658P,日月光元富96售02,0,0,0,0,0,0,0,0,0,59000,0,0,0,95000,36000,59000,59000
057304,為升兆豐99購02  ,0,0,0,0,0,0,0,0,0,59000,0,0,0,210000,151000,59000,59000
057163,上銀元大98購04  ,0,0,0,0,0,0,0,0,0,59000,0,0,0,69000,10000,59000,59000
052776,力山國票97購01  ,0,0,0,0,0,0,0,0,0,59000,0,0,0,60000,1000,59000,59000
052468,超眾統一96購02  ,0,0,0,0,0,0,0,0,0,59000,0,0,0,59000,0,59000,59000
052744,聯詠元大97購01  ,0,0,0,0,0,0,0,0,0,59000,0,0,0,248000,189000,59000,59000
053899,矽創群益96購02  ,0,0,0,0,0,0,0,0,0,59000,0,0,0,111000,52000,59000,59000
054450,聯茂第一96購01  ,0,0,0,0,0,0,0,0,0,59000,0,0,0,180000,121000,59000,59000
06969P,上銀元大99售02  ,0,0,0,0,0,0,0,0,0,59000,0,0,0,79000,20000,59000,59000
056742,玉晶光凱基9A購01,0,0,0,0,0,0,0,0,0,58000,0,0,0,78000,20000,58000,58000
056444,南亞科凱基99購01,0,0,0,0,0,0,0,0,0,58000,0,0,0,68000,10000,58000,58000
058223,世芯統一9B購01  ,0,0,0,0,0,0,0,0,0,58000,0,0,0,58000,0,58000,58000
048592,漢唐群益93購04  ,0,0,0,0,0,0,0,0,0,58000,0,0,0,58000,0,58000,58000
051307,康舒凱基95購01  ,0,0,0,0,0,0,0,0,0,58000,0,0,0,68000,10000,58000,58000
053426,創意永豐96購04  ,0,0,0,0,0,0,0,0,0,58000,0,0,0,58000,0,58000,58000
05263P,台積電元大96售09,0,0,0,0,0,0,0,0,0,58000,0,0,0,970000,912000,58000,58000
050608,台達電元大94購12,0,0,0,0,0,0,0,0,0,58000,0,0,0,68000,10000,58000,58000
05026P,貿聯群益95售01  ,0,0,0,0,0,0,0,0,0,58000,0,0,0,58000,0,58000,58000
053865,欣興元大97購02  ,0,0,0,0,0,0,0,0,0,58000,0,0,0,120000,62000,58000,58000
053869,嘉澤元大96購02  ,0,0,0,0,0,0,0,0,0,58000,0,0,0,68000,10000,58000,58000
055951,大成鋼元大97購02,0,0,0,0,0,0,0,0,0,58000,0,0,0,68000,10000,58000,58000
055510,GIS元大97購03   ,0,0,0,0,0,0,0,0,0,58000,0,0,0,68000,10000,58000,58000
07039P,南電台新99售01  ,0,0,0,0,0,0,0,0,0,58000,0,0,0,62000,4000,58000,58000
06578P,華新科國票98售02,0,0,0,0,0,0,0,0,0,58000,0,0,0,63000,5000,58000,58000
06242P,大立光元富9A售02,0,0,0,0,0,0,0,0,0,58000,0,0,0,59000,1000,58000,58000
06190P,玉晶光永豐97售05,0,0,0,0,0,0,0,0,0,58000,0,0,0,93000,35000,58000,58000
056737,國巨凱基9A購01  ,0,0,0,0,0,0,0,0,0,57000,0,0,0,68000,11000,57000,57000
052829,上銀群益96購01  ,0,0,0,0,0,0,0,0,0,57000,0,0,0,122000,65000,57000,57000
052942,聯發科中信97購04,0,0,0,0,0,0,0,0,0,57000,0,0,0,418000,361000,57000,57000
04424P,台郡永豐94售01  ,0,0,0,0,0,0,0,0,0,57000,0,0,0,57000,0,57000,57000
051843,聯發科富邦99購01,0,0,0,0,0,0,0,0,0,57000,0,0,0,391000,334000,57000,57000
055970,聯茂元大97購04  ,0,0,0,0,0,0,0,0,0,57000,0,0,0,57000,0,57000,57000
05604P,聯發科元大96售10,0,0,0,0,0,0,0,0,0,57000,0,0,0,271000,214000,57000,57000
05400P,台積電永豐95售05,0,0,0,0,0,0,0,0,0,57000,0,0,0,61000,4000,57000,57000
054318,台虹凱基98購01  ,0,0,0,0,0,0,0,0,0,57000,0,0,0,76000,19000,57000,57000
06741P,台積電富邦98售04,0,0,0,0,0,0,0,0,0,57000,0,0,0,419000,362000,57000,57000
06893P,致新元富98售02  ,0,0,0,0,0,0,0,0,0,57000,0,0,0,62000,5000,57000,57000
4306,炎洲            ,214000,167000,47000,0,0,0,0,0,0,10000,14000,4000,10000,0,0,0,57000
057333,智邦國票99購01  ,0,0,0,0,0,0,0,0,0,56000,0,0,0,76000,20000,56000,56000
057947,和碩國票99購01  ,0,0,0,0,0,0,0,0,0,56000,0,0,0,94000,38000,56000,56000
05955P,台光電國票97售02,0,0,0,0,0,0,0,0,0,56000,0,0,0,76000,20000,56000,56000
05897P,國巨凱基96售12  ,0,0,0,0,0,0,0,0,0,56000,0,0,0,147000,91000,56000,56000
052902,鴻海國票97購04  ,0,0,0,0,0,0,0,0,0,56000,0,0,0,100000,44000,56000,56000
049485,台積電元大96購03,0,0,0,0,0,0,0,0,0,56000,0,0,0,629000,573000,56000,56000
053268,日月光群益96購01,0,0,0,0,0,0,0,0,0,56000,0,0,0,107000,51000,56000,56000
052159,瑞昱永豐95購01  ,0,0,0,0,0,0,0,0,0,56000,0,0,0,56000,0,56000,56000
05171P,臺股指元大95售15,0,0,0,0,0,0,0,0,0,56000,0,0,0,56000,0,56000,56000
054203,滬深2X國票96購03,0,0,0,0,0,0,0,0,0,56000,0,0,0,66000,10000,56000,56000
05515P,台積電群益96售03,0,0,0,0,0,0,0,0,0,56000,0,0,0,56000,0,56000,56000
05447P,臺股指元大95售24,0,0,0,0,0,0,0,0,0,56000,0,0,0,68000,12000,56000,56000
056143,訊芯元大97購04  ,0,0,0,0,0,0,0,0,0,56000,0,0,0,112000,56000,56000,56000
8033,雷虎            ,59000,3000,56000,0,0,0,0,0,0,0,0,0,0,0,0,0,56000
06892P,聯鈞元富98售01  ,0,0,0,0,0,0,0,0,0,56000,0,0,0,76000,20000,56000,56000
06241P,大立光元富9A售01,0,0,0,0,0,0,0,0,0,56000,0,0,0,66000,10000,56000,56000
1476,儒鴻            ,523000,529869,-6869,0,0,0,33000,0,33000,29000,42000,11000,31000,0,2000,-2000,55131
05947P,大成鋼元大96售03,0,0,0,0,0,0,0,0,0,55000,0,0,0,60000,5000,55000,55000
057890,滬深反統一98購01,0,0,0,0,0,0,0,0,0,55000,0,0,0,190000,135000,55000,55000
058157,華通台新99購01  ,0,0,0,0,0,0,0,0,0,55000,0,0,0,55000,0,55000,55000
049486,旺宏元大94購08  ,0,0,0,0,0,0,0,0,0,55000,0,0,0,65000,10000,55000,55000
048698,宏達電國票95購01,0,0,0,0,0,0,0,0,0,55000,0,0,0,130000,75000,55000,55000
049129,S&P反1元大97購01,0,0,0,0,0,0,0,0,0,55000,0,0,0,55000,0,55000,55000
03662C,FBVIX凱基03牛01 ,0,15000,-15000,0,0,0,0,0,0,70000,0,0,0,217000,147000,70000,55000
04581P,楠梓電康和94售03,0,0,0,0,0,0,0,0,0,55000,0,0,0,55000,0,55000,55000
051737,瑞昱國票96購01  ,0,0,0,0,0,0,0,0,0,55000,0,0,0,55000,0,55000,55000
052115,T50反1國票95購03,0,0,0,0,0,0,0,0,0,55000,0,0,0,105000,50000,55000,55000
053387,緯創元大97購01  ,0,0,0,0,0,0,0,0,0,55000,0,0,0,573000,518000,55000,55000
053693,欣興元大96購05  ,0,0,0,0,0,0,0,0,0,55000,0,0,0,110000,55000,55000,55000
055501,創意元大97購01  ,0,0,0,0,0,0,0,0,0,55000,0,0,0,100000,45000,55000,55000
055552,瑞昱凱基97購02  ,0,0,0,0,0,0,0,0,0,55000,0,0,0,55000,0,55000,55000
055307,瑞昱群益97購02  ,0,0,0,0,0,0,0,0,0,55000,0,0,0,116000,61000,55000,55000
055382,台郡元大99購01  ,0,0,0,0,0,0,0,0,0,55000,0,0,0,55000,0,55000,55000
055343,國巨凱基97購03  ,0,0,0,0,0,0,0,0,0,55000,0,0,0,55000,0,55000,55000
054955,宏達電元大98購01,0,0,0,0,0,0,0,0,0,55000,0,0,0,149000,94000,55000,55000
053901,T50反1凱基99購03,0,0,0,0,0,0,0,0,0,55000,0,0,0,55000,0,55000,55000
2305,全友            ,39000,0,39000,0,0,0,0,0,0,16000,16000,0,16000,0,0,0,55000
06271P,彩晶凱基97售01  ,0,0,0,0,0,0,0,0,0,55000,0,0,0,65000,10000,55000,55000
06374P,台表科元大97售06,0,1000,-1000,0,0,0,0,0,0,56000,0,0,0,61000,5000,56000,55000
06509P,鴻海群益98售03  ,0,0,0,0,0,0,0,0,0,55000,0,0,0,55000,0,55000,55000
6491,晶碩            ,55000,0,55000,0,0,0,0,0,0,0,0,0,0,0,0,0,55000
4106,雃博            ,122000,68000,54000,0,0,0,0,0,0,1000,1000,0,1000,0,0,0,55000
2453,凌群            ,120000,71000,49000,0,0,0,0,0,0,6000,7000,1000,6000,0,0,0,55000
04710P,台積電元大94售16,0,0,0,0,0,0,0,0,0,54000,0,0,0,181000,127000,54000,54000
047160,台郡國票94購01  ,0,0,0,0,0,0,0,0,0,54000,0,0,0,60000,6000,54000,54000
04889P,華通元大94售03  ,0,0,0,0,0,0,0,0,0,54000,0,0,0,162000,108000,54000,54000
053641,正文永豐96購01  ,0,0,0,0,0,0,0,0,0,54000,0,0,0,108000,54000,54000,54000
051338,揚明光永豐95購02,0,0,0,0,0,0,0,0,0,54000,0,0,0,54000,0,54000,54000
052738,聯電元大98購02  ,0,0,0,0,0,0,0,0,0,54000,0,0,0,226000,172000,54000,54000
051696,新日興中信96購01,0,0,0,0,0,0,0,0,0,54000,0,0,0,61000,7000,54000,54000
052731,宏達電國泰98購01,0,0,0,0,0,0,0,0,0,54000,0,0,0,116000,62000,54000,54000
054865,可成群益97購01  ,0,0,0,0,0,0,0,0,0,54000,0,0,0,64000,10000,54000,54000
055627,亞德客永豐97購02,0,0,0,0,0,0,0,0,0,54000,0,0,0,54000,0,54000,54000
055483,和大元大97購03  ,0,0,0,0,0,0,0,0,0,54000,0,0,0,144000,90000,54000,54000
06668P,祥碩凱基98售02  ,0,0,0,0,0,0,0,0,0,54000,0,0,0,169000,115000,54000,54000
06075P,智邦凱基97售02  ,0,0,0,0,0,0,0,0,0,54000,0,0,0,164000,110000,54000,54000
06935P,神達元大98售02  ,0,0,0,0,0,0,0,0,0,54000,0,0,0,61000,7000,54000,54000
057878,台郡元大99購04  ,0,0,0,0,0,0,0,0,0,53000,0,0,0,68000,15000,53000,53000
06036P,台表科凱基96售04,0,0,0,0,0,0,0,0,0,53000,0,0,0,53000,0,53000,53000
05895P,奇力新群益96售03,0,0,0,0,0,0,0,0,0,53000,0,0,0,53000,0,53000,53000
057539,南茂元大98購02  ,0,0,0,0,0,0,0,0,0,53000,0,0,0,700000,647000,53000,53000
057448,致茂元富98購01  ,0,0,0,0,0,0,0,0,0,53000,0,0,0,73000,20000,53000,53000
049372,華新科元大95購04,0,0,0,0,0,0,0,0,0,53000,0,0,0,66000,13000,53000,53000
053005,微星永豐96購01  ,0,0,0,0,0,0,0,0,0,53000,0,0,0,53000,0,53000,53000
050693,鴻海凱基96購05  ,0,0,0,0,0,0,0,0,0,53000,0,0,0,68000,15000,53000,53000
051728,道瓊反國票97購01,0,0,0,0,0,0,0,0,0,53000,0,0,0,73000,20000,53000,53000
052089,聯發科元大96購02,0,0,0,0,0,0,0,0,0,53000,0,0,0,53000,0,53000,53000
051250,大立光元大98購01,0,0,0,0,0,0,0,0,0,53000,0,0,0,88000,35000,53000,53000
052386,鴻海群益96購02  ,0,0,0,0,0,0,0,0,0,53000,0,0,0,103000,50000,53000,53000
056241,緯創群益97購01  ,0,0,0,0,0,0,0,0,0,53000,0,0,0,53000,0,53000,53000
056315,同欣電元大97購05,0,0,0,0,0,0,0,0,0,53000,0,0,0,208000,155000,53000,53000
05411P,台積電國票96售08,0,0,0,0,0,0,0,0,0,53000,0,0,0,55000,2000,53000,53000
054417,牧德元大96購01  ,0,0,0,0,0,0,0,0,0,53000,0,0,0,66000,13000,53000,53000
06220P,廣宇元富97售02  ,0,1000,-1000,0,0,0,0,0,0,54000,0,0,0,64000,10000,54000,53000
06314P,GIS元富97售02   ,0,0,0,0,0,0,0,0,0,53000,0,0,0,59000,6000,53000,53000
06643P,大立光兆豐98售01,0,0,0,0,0,0,0,0,0,53000,0,0,0,53000,0,53000,53000
2413,環科            ,63000,10000,53000,0,0,0,0,0,0,0,7000,7000,0,0,0,0,53000
2516,新建            ,54000,1000,53000,0,0,0,0,0,0,0,0,0,0,0,0,0,53000
057269,鈺齊兆豐98購01  ,0,0,0,0,0,0,0,0,0,52000,0,0,0,62000,10000,52000,52000
056526,力山凱基98購01  ,0,0,0,0,0,0,0,0,0,52000,0,0,0,72000,20000,52000,52000
06028P,智邦台新97售01  ,0,0,0,0,0,0,0,0,0,52000,0,0,0,110000,58000,52000,52000
057874,可成元大99購02  ,0,0,0,0,0,0,0,0,0,52000,0,0,0,68000,16000,52000,52000
049026,晶相光群益94購01,0,0,0,0,0,0,0,0,0,52000,0,0,0,63000,11000,52000,52000
053421,南亞科永豐96購01,0,0,0,0,0,0,0,0,0,52000,0,0,0,62000,10000,52000,52000
05173P,臺股指元大95售17,0,0,0,0,0,0,0,0,0,52000,0,0,0,53000,1000,52000,52000
053251,世紀鋼國票97購02,0,0,0,0,0,0,0,0,0,52000,0,0,0,52000,0,52000,52000
05201P,玉晶光國泰97售02,0,0,0,0,0,0,0,0,0,52000,0,0,0,292000,240000,52000,52000
053003,國巨永豐96購02  ,0,0,0,0,0,0,0,0,0,52000,0,0,0,55000,3000,52000,52000
050204,華新科群益94購05,0,0,0,0,0,0,0,0,0,52000,0,0,0,102000,50000,52000,52000
055164,矽創元大98購01  ,0,0,0,0,0,0,0,0,0,52000,0,0,0,164000,112000,52000,52000
056365,欣興元大98購01  ,0,0,0,0,0,0,0,0,0,52000,0,0,0,120000,68000,52000,52000
055508,矽力元大97購01  ,0,0,0,0,0,0,0,0,0,52000,0,0,0,123000,71000,52000,52000
055185,晶相光統一97購01,0,0,0,0,0,0,0,0,0,52000,0,0,0,63000,11000,52000,52000
055215,智邦凱基98購02  ,0,0,0,0,0,0,0,0,0,52000,0,0,0,68000,16000,52000,52000
2611,志信            ,56000,4000,52000,0,0,0,0,0,0,0,0,0,0,0,0,0,52000
2514,龍邦            ,135000,83000,52000,0,0,0,0,0,0,0,0,0,0,0,0,0,52000
06187P,國巨統一97售05  ,0,0,0,0,0,0,0,0,0,52000,0,0,0,52000,0,52000,52000
1598,岱宇            ,82000,30000,52000,0,0,0,0,0,0,0,0,0,0,0,0,0,52000
06009P,宏達電元富96售03,0,0,0,0,0,0,0,0,0,51000,0,0,0,51000,0,51000,51000
04813P,智邦元大94售07  ,0,0,0,0,0,0,0,0,0,51000,0,0,0,51000,0,51000,51000
05222P,致伸凱基95售02  ,0,0,0,0,0,0,0,0,0,51000,0,0,0,62000,11000,51000,51000
05532P,臺股指群益96售05,0,0,0,0,0,0,0,0,0,51000,0,0,0,51000,0,51000,51000
055357,欣興凱基97購04  ,0,0,0,0,0,0,0,0,0,51000,0,0,0,51000,0,51000,51000
05556P,全新國票96售04  ,0,0,0,0,0,0,0,0,0,51000,0,0,0,60000,9000,51000,51000
05634P,玉晶光台新97售01,0,0,0,0,0,0,0,0,0,51000,0,0,0,56000,5000,51000,51000
056394,晶豪科永豐98購01,0,0,0,0,0,0,0,0,0,51000,0,0,0,51000,0,51000,51000
056271,嘉澤統一97購01  ,0,0,0,0,0,0,0,0,0,51000,0,0,0,51000,0,51000,51000
055104,台達電凱基98購01,0,0,0,0,0,0,0,0,0,51000,0,0,0,51000,0,51000,51000
054220,國巨統一97購02  ,0,0,0,0,0,0,0,0,0,51000,0,0,0,94000,43000,51000,51000
1108,幸福            ,61000,7000,54000,0,0,0,0,0,0,-3000,0,3000,-3000,0,0,0,51000
06216P,上銀元富97售03  ,0,0,0,0,0,0,0,0,0,51000,0,0,0,51000,0,51000,51000
6152,百一            ,65000,14000,51000,0,0,0,0,0,0,0,0,0,0,0,0,0,51000
6698,旭暉應材        ,68000,18000,50000,0,0,0,0,0,0,1000,1000,0,1000,0,0,0,51000
9943,好樂迪          ,108000,57000,51000,0,0,0,0,0,0,0,0,0,0,0,0,0,51000
05918P,大立光元大96售11,0,0,0,0,0,0,0,0,0,50000,0,0,0,50000,0,50000,50000
058136,景碩元大99購02  ,0,0,0,0,0,0,0,0,0,50000,0,0,0,60000,10000,50000,50000
058033,景碩永豐98購02  ,0,0,0,0,0,0,0,0,0,50000,0,0,0,50000,0,50000,50000
056541,智原凱基98購03  ,0,0,0,0,0,0,0,0,0,50000,0,0,0,50000,0,50000,50000
056727,滬深反凱基9B購01,0,0,0,0,0,0,0,0,0,50000,0,0,0,50000,0,50000,50000
056640,元油2X凱基9A購01,0,0,0,0,0,0,0,0,0,50000,0,0,0,80000,30000,50000,50000
057178,可成元大98購03  ,0,0,0,0,0,0,0,0,0,50000,0,0,0,100000,50000,50000,50000
057436,義隆國票99購02  ,0,0,0,0,0,0,0,0,0,50000,0,0,0,68000,18000,50000,50000
057375,欣興元大98購09  ,0,0,0,0,0,0,0,0,0,50000,0,0,0,55000,5000,50000,50000
047184,漢唐元大94購02  ,0,0,0,0,0,0,0,0,0,50000,0,0,0,100000,50000,50000,50000
03650C,T50反1元大98牛05,0,0,0,0,0,0,0,0,0,50000,0,0,0,300000,250000,50000,50000
03074X,元展69          ,0,0,0,0,0,0,0,0,0,50000,0,0,0,50000,0,50000,50000
04619P,華新統一94售02  ,0,0,0,0,0,0,0,0,0,50000,0,0,0,50000,0,50000,50000
046290,儒鴻統一93購01  ,0,0,0,0,0,0,0,0,0,50000,0,0,0,50000,0,50000,50000
046340,滬深2X國票96購01,0,0,0,0,0,0,0,0,0,50000,0,0,0,50000,0,50000,50000
046491,滬深2X富邦95購02,0,0,0,0,0,0,0,0,0,50000,0,0,0,60000,10000,50000,50000
04654P,臺股指凱基94售13,0,0,0,0,0,0,0,0,0,50000,0,0,0,50000,0,50000,50000
04235P,鴻海群益93售08  ,0,0,0,0,0,0,0,0,0,50000,0,0,0,50000,0,50000,50000
04189P,台積電兆豐94售02,0,0,0,0,0,0,0,0,0,50000,0,0,0,50000,0,50000,50000
04172P,大立光凱基93售34,0,0,0,0,0,0,0,0,0,50000,0,0,0,50000,0,50000,50000
04161P,全新國泰94售01  ,0,0,0,0,0,0,0,0,0,50000,0,0,0,65000,15000,50000,50000
042719,臺指反群益93購01,0,0,0,0,0,0,0,0,0,50000,0,0,0,50000,0,50000,50000
049055,聯詠永豐94購01  ,0,0,0,0,0,0,0,0,0,50000,0,0,0,50000,0,50000,50000
049065,T50反1凱基96購04,0,0,0,0,0,0,0,0,0,50000,0,0,0,50000,0,50000,50000
049130,臺指反元大98購01,0,0,0,0,0,0,0,0,0,50000,0,0,0,50000,0,50000,50000
04869P,鴻海元富95售02  ,0,0,0,0,0,0,0,0,0,50000,0,0,0,50000,0,50000,50000
05288P,寶成元富95售02  ,0,0,0,0,0,0,0,0,0,50000,0,0,0,56000,6000,50000,50000
05277P,深中小統一95售02,0,0,0,0,0,0,0,0,0,50000,0,0,0,50000,0,50000,50000
052794,群創兆豐97購01  ,0,0,0,0,0,0,0,0,0,50000,0,0,0,100000,50000,50000,50000
049373,大立光元大94購11,0,0,0,0,0,0,0,0,0,50000,0,0,0,50000,0,50000,50000
049417,奇力新凱基94購02,0,0,0,0,0,0,0,0,0,50000,0,0,0,50000,0,50000,50000
048374,味全元富94購01  ,0,0,0,0,0,0,0,0,0,50000,0,0,0,50000,0,50000,50000
04833P,鴻海元大94售16  ,0,0,0,0,0,0,0,0,0,50000,0,0,0,91000,41000,50000,50000
04972P,緯穎元富94售03  ,0,0,0,0,0,0,0,0,0,50000,0,0,0,50000,0,50000,50000
049797,台積電元大94購17,0,0,0,0,0,0,0,0,0,50000,0,0,0,150000,100000,50000,50000
047546,瑞昱凱基93購06  ,0,0,0,0,0,0,0,0,0,50000,0,0,0,50000,0,50000,50000
047678,景碩台新93購01  ,0,0,0,0,0,0,0,0,0,50000,0,0,0,50000,0,50000,50000
047939,亞德客國票93購02,0,0,0,0,0,0,0,0,0,50000,0,0,0,50000,0,50000,50000
047956,麗豐永豐93購02  ,0,0,0,0,0,0,0,0,0,50000,0,0,0,50000,0,50000,50000
053654,聯發科凱基98購01,0,0,0,0,0,0,0,0,0,50000,0,0,0,50000,0,50000,50000
052520,南亞科元大95購06,0,0,0,0,0,0,0,0,0,50000,0,0,0,59000,9000,50000,50000
053482,矽力元大96購03  ,0,0,0,0,0,0,0,0,0,50000,0,0,0,50000,0,50000,50000
052043,瑞昱日盛95購01  ,0,0,0,0,0,0,0,0,0,50000,0,0,0,120000,70000,50000,50000
05166P,中磊元富95售03  ,0,0,0,0,0,0,0,0,0,50000,0,0,0,50000,0,50000,50000
051593,和碩元大95購01  ,0,0,0,0,0,0,0,0,0,50000,0,0,0,128000,78000,50000,50000
05152P,玉晶光群益96售05,0,0,0,0,0,0,0,0,0,50000,0,0,0,50000,0,50000,50000
050318,景碩國票94購02  ,0,0,0,0,0,0,0,0,0,50000,0,0,0,50000,0,50000,50000
052194,旺宏元富95購04  ,0,0,0,0,0,0,0,0,0,50000,0,0,0,50000,0,50000,50000
050489,聯詠元富94購01  ,0,0,0,0,0,0,0,0,0,50000,0,0,0,50000,0,50000,50000
050134,世紀鋼凱基94購04,0,0,0,0,0,0,0,0,0,50000,0,0,0,50000,0,50000,50000
050130,華新科凱基94購09,0,0,0,0,0,0,0,0,0,50000,0,0,0,270000,220000,50000,50000
051839,和鑫國泰96購01  ,0,0,0,0,0,0,0,0,0,50000,0,0,0,50000,0,50000,50000
052604,建準元大97購01  ,0,0,0,0,0,0,0,0,0,50000,0,0,0,50000,0,50000,50000
05300P,健策元大95售02  ,0,0,0,0,0,0,0,0,0,50000,0,0,0,80000,30000,50000,50000
051987,廣達元大95購01  ,0,0,0,0,0,0,0,0,0,50000,0,0,0,50000,0,50000,50000
05117P,瑞昱群益95售02  ,0,0,0,0,0,0,0,0,0,50000,0,0,0,50000,0,50000,50000
051242,台積電元大96購06,0,0,0,0,0,0,0,0,0,50000,0,0,0,50000,0,50000,50000
050757,聯發科元富94購03,0,0,0,0,0,0,0,0,0,50000,0,0,0,50000,0,50000,50000
051149,可成凱基95購04  ,0,0,0,0,0,0,0,0,0,50000,0,0,0,50000,0,50000,50000
054289,聯發科元大97購11,0,0,0,0,0,0,0,0,0,50000,0,0,0,50000,0,50000,50000
053946,全新富邦97購02  ,0,0,0,0,0,0,0,0,0,50000,0,0,0,50000,0,50000,50000
053950,緯穎富邦97購02  ,0,0,0,0,0,0,0,0,0,50000,0,0,0,50000,0,50000,50000
053964,上銀元大96購05  ,0,0,0,0,0,0,0,0,0,50000,0,0,0,50000,0,50000,50000
054481,鎧勝中信96購01  ,0,0,0,0,0,0,0,0,0,50000,0,0,0,200000,150000,50000,50000
054553,宏達電凱基99購01,0,0,0,0,0,0,0,0,0,50000,0,0,0,200000,150000,50000,50000
05467P,聯電元大95售02  ,0,0,0,0,0,0,0,0,0,50000,0,0,0,50000,0,50000,50000
054792,揚明光群益97購01,0,0,0,0,0,0,0,0,0,50000,0,0,0,50000,0,50000,50000
054820,新日興元大97購01,0,0,0,0,0,0,0,0,0,50000,0,0,0,78000,28000,50000,50000
056215,華新科國票97購03,0,0,0,0,0,0,0,0,0,50000,0,0,0,60000,10000,50000,50000
055943,瑞昱麥證97購01  ,0,0,0,80000,30000,50000,0,0,0,50000,0,0,0,80000,30000,50000,50000
05584P,臺股指凱基96售13,0,0,0,0,0,0,0,0,0,50000,0,0,0,50000,0,50000,50000
055571,鴻海統一97購03  ,0,0,0,0,0,0,0,0,0,50000,0,0,0,64000,14000,50000,50000
055577,晶技統一97購02  ,0,0,0,0,0,0,0,0,0,50000,0,0,0,135000,85000,50000,50000
055656,新唐元富97購01  ,0,0,0,0,0,0,0,0,0,50000,0,0,0,50000,0,50000,50000
055680,美律凱基99購01  ,0,0,0,0,0,0,0,0,0,50000,0,0,0,50000,0,50000,50000
055296,康舒元大97購02  ,0,0,0,0,0,0,0,0,0,50000,0,0,0,108000,58000,50000,50000
4956,光鋐            ,65000,14000,51000,0,0,0,0,0,0,-1000,6000,7000,-1000,0,0,0,50000
06245P,健策元富97售03  ,0,0,0,0,0,0,0,0,0,50000,0,0,0,60000,10000,50000,50000
06406P,可成元富97售04  ,0,0,0,0,0,0,0,0,0,50000,0,0,0,57000,7000,50000,50000
06881P,國巨群益98售10  ,0,0,0,0,0,0,0,0,0,50000,0,0,0,50000,0,50000,50000
056860,正崴群益98購01  ,0,0,0,0,0,0,0,0,0,49000,0,0,0,108000,59000,49000,49000
057924,健策凱基98購02  ,0,0,0,0,0,0,0,0,0,49000,0,0,0,65000,16000,49000,49000
049691,可成元大94購06  ,0,0,0,0,0,0,0,0,0,49000,0,0,0,69000,20000,49000,49000
05267P,欣興元大95售08  ,0,0,0,0,0,0,0,0,0,49000,0,0,0,60000,11000,49000,49000
00865B,國泰US短期公債  ,0,0,0,0,0,0,0,0,0,49000,0,0,0,49000,0,49000,49000
046298,聯發科富邦94購01,0,0,0,0,0,0,0,0,0,49000,0,0,0,82000,33000,49000,49000
050742,新日興永豐94購01,0,0,0,0,0,0,0,0,0,49000,0,0,0,49000,0,49000,49000
051234,南電群益95購02  ,0,0,0,0,0,0,0,0,0,49000,0,0,0,175000,126000,49000,49000
05270P,台表科元大95售05,0,0,0,0,0,0,0,0,0,49000,0,0,0,53000,4000,49000,49000
053358,晶技統一98購01  ,0,0,0,0,0,0,0,0,0,49000,0,0,0,84000,35000,49000,49000
053519,力成群益96購02  ,0,0,0,0,0,0,0,0,0,49000,0,0,0,82000,33000,49000,49000
055760,新日興群益98購02,0,0,0,0,0,0,0,0,0,49000,0,0,0,65000,16000,49000,49000
05550P,臺股指元大96售07,0,0,0,0,0,0,0,0,0,49000,0,0,0,49000,0,49000,49000
053980,泰鼎元大97購02  ,0,0,0,0,0,0,0,0,0,49000,0,0,0,91000,42000,49000,49000
06198P,台積電元大98售06,0,0,0,0,0,0,0,0,0,49000,0,0,0,986000,937000,49000,49000
06141P,大立光日盛97售01,0,0,0,0,0,0,0,0,0,49000,0,0,0,61000,12000,49000,49000
06641P,智邦兆豐99售01  ,0,0,0,0,0,0,0,0,0,49000,0,0,0,88000,39000,49000,49000
8114,振樺電          ,55000,7000,48000,0,0,0,0,0,0,1000,1000,0,1000,0,0,0,49000
8261,富鼎            ,110000,61000,49000,0,0,0,0,0,0,0,0,0,0,0,0,0,49000
057963,緯穎元大98購08  ,0,0,0,0,0,0,0,0,0,48000,0,0,0,68000,20000,48000,48000
057771,鴻海群益99購01  ,0,0,0,0,0,0,0,0,0,48000,0,0,0,161000,113000,48000,48000
05902P,華通國票96售02  ,0,0,0,0,0,0,0,0,0,48000,0,0,0,88000,40000,48000,48000
056996,矽力日盛99購01  ,0,0,0,0,0,0,0,0,0,48000,0,0,0,50000,2000,48000,48000
056540,聯詠凱基98購02  ,0,0,0,0,0,0,0,0,0,48000,0,0,0,68000,20000,48000,48000
05743P,創意元大96售01  ,0,0,0,0,0,0,0,0,0,48000,0,0,0,98000,50000,48000,48000
057096,緯穎元富98購01  ,0,0,0,0,0,0,0,0,0,48000,0,0,0,98000,50000,48000,48000
057351,奇力新統一98購02,0,0,0,0,0,0,0,0,0,48000,0,0,0,48000,0,48000,48000
04826P,華新科麥證95售01,0,0,0,68000,20000,48000,0,0,0,48000,0,0,0,68000,20000,48000,48000
045298,旺宏元大94購01  ,0,0,0,0,0,0,0,0,0,48000,0,0,0,60000,12000,48000,48000
04474P,聯發科元大94售03,0,0,0,0,0,0,0,0,0,48000,0,0,0,48000,0,48000,48000
052847,漢唐統一99購01  ,0,0,0,0,0,0,0,0,0,48000,0,0,0,48000,0,48000,48000
049721,晶技凱基94購02  ,0,0,0,0,0,0,0,0,0,48000,0,0,0,48000,0,48000,48000
049914,瑞昱元大94購06  ,0,0,0,0,0,0,0,0,0,48000,0,0,0,68000,20000,48000,48000
04786P,鴻海永昌96售01  ,0,0,0,0,0,0,0,0,0,48000,0,0,0,48000,0,48000,48000
053399,創意中信96購01  ,0,0,0,0,0,0,0,0,0,48000,0,0,0,48000,0,48000,48000
05330P,臺股指凱基95售14,0,0,0,0,0,0,0,0,0,48000,0,0,0,48000,0,48000,48000
052327,聯詠中信95購03  ,0,0,0,0,0,0,0,0,0,48000,0,0,0,48000,0,48000,48000
050083,旺宏元富94購01  ,0,0,0,0,0,0,0,0,0,48000,0,0,0,98000,50000,48000,48000
051941,樺漢群益95購02  ,0,0,0,0,0,0,0,0,0,48000,0,0,0,48000,0,48000,48000
050560,聯詠統一94購02  ,0,0,0,0,0,0,0,0,0,48000,0,0,0,48000,0,48000,48000
050569,英業達中信94購01,0,0,0,0,0,0,0,0,0,48000,0,0,0,48000,0,48000,48000
053227,晶技台新96購01  ,0,0,0,0,0,0,0,0,0,48000,0,0,0,48000,0,48000,48000
05023P,和碩凱基95售01  ,0,0,0,0,0,0,0,0,0,48000,0,0,0,73000,25000,48000,48000
05029P,鴻海元富95售04  ,0,0,0,0,0,0,0,0,0,48000,0,0,0,61000,13000,48000,48000
054870,新日興群益98購01,0,0,0,0,0,0,0,0,0,48000,0,0,0,72000,24000,48000,48000
056214,義隆國票99購01  ,0,0,0,0,0,0,0,0,0,48000,0,0,0,56000,8000,48000,48000
4720,德淵            ,29000,18000,11000,0,0,0,0,0,0,37000,51000,14000,37000,0,0,0,48000
2428,興勤            ,195000,154000,41000,0,0,0,0,0,0,7000,1000,0,1000,8000,2000,6000,48000
06739P,聯詠兆豐98售02  ,0,0,0,0,0,0,0,0,0,48000,0,0,0,64000,16000,48000,48000
06068P,玉晶光康和97售01,0,0,0,0,0,0,0,0,0,48000,0,0,0,74000,26000,48000,48000
06905P,上証2X國泰99售02,0,0,0,0,0,0,0,0,0,48000,0,0,0,48000,0,48000,48000
1708,東鹼            ,72000,24000,48000,0,0,0,0,0,0,0,0,0,0,0,0,0,48000
057241,超眾凱基99購02  ,0,0,0,0,0,0,0,0,0,47000,0,0,0,60000,13000,47000,47000
05725P,嘉聯益永豐96售02,0,0,0,0,0,0,0,0,0,47000,0,0,0,87000,40000,47000,47000
057349,聯發科統一98購04,0,0,0,0,0,0,0,0,0,47000,0,0,0,60000,13000,47000,47000
056777,矽力元大98購02  ,0,0,0,0,0,0,0,0,0,47000,0,0,0,50000,3000,47000,47000
05908P,大立光元富96售05,0,0,0,0,0,0,0,0,0,47000,0,0,0,47000,0,47000,47000
057773,技嘉群益9A購02  ,0,0,0,0,0,0,0,0,0,47000,0,0,0,51000,4000,47000,47000
05817P,可成凱基96售07  ,0,0,0,0,0,0,0,0,0,47000,0,0,0,47000,0,47000,47000
04714P,上海銀元大94售01,0,0,0,0,0,0,0,0,0,47000,0,0,0,47000,0,47000,47000
04664P,臺股指國票94售03,0,0,0,0,0,0,0,0,0,47000,0,0,0,50000,3000,47000,47000
050864,亞光永豐95購01  ,0,0,0,0,0,0,0,0,0,47000,0,0,0,47000,0,47000,47000
051534,景碩國票97購01  ,0,0,0,0,0,0,0,0,0,47000,0,0,0,47000,0,47000,47000
055861,矽力元大97購03  ,0,0,0,0,0,0,0,0,0,47000,0,0,0,107000,60000,47000,47000
055727,矽力元大97購02  ,0,0,0,0,0,0,0,0,0,47000,0,0,0,50000,3000,47000,47000
053841,美律統一96購01  ,0,0,0,0,0,0,0,0,0,47000,0,0,0,48000,1000,47000,47000
1786,科妍            ,64000,26000,38000,0,0,0,0,0,0,9000,19000,10000,9000,0,0,0,47000
2109,華豐            ,47000,0,47000,0,0,0,0,0,0,0,0,0,0,0,0,0,47000
06066P,群創台新98售01  ,0,0,0,0,0,0,0,0,0,47000,0,0,0,47000,0,47000,47000
06102P,智邦凱基97售03  ,0,0,0,0,0,0,0,0,0,47000,0,0,0,87000,40000,47000,47000
06432P,上銀群益98售01  ,0,0,0,0,0,0,0,0,0,47000,0,0,0,51000,4000,47000,47000
06546P,聯發科元大98售05,0,0,0,0,0,0,0,0,0,47000,0,0,0,58000,11000,47000,47000
4952,凌通            ,124000,89000,35000,0,0,0,0,0,0,12000,22000,10000,12000,0,0,0,47000
6183,關貿            ,69000,9000,60000,0,0,0,0,0,0,-13000,0,13000,-13000,0,0,0,47000
6168,宏齊            ,132000,86000,46000,0,0,0,0,0,0,1000,2000,1000,1000,0,0,0,47000
9907,統一實          ,452000,418000,34000,0,0,0,0,0,0,13000,13000,0,13000,0,0,0,47000
058020,大立光凱基99購03,0,0,0,0,0,0,0,0,0,46000,0,0,0,68000,22000,46000,46000
058432,台積電統一9B購03,0,0,0,0,0,0,0,0,0,46000,0,0,0,125000,79000,46000,46000
05705P,上証2X永豐96售03,0,0,0,0,0,0,0,0,0,46000,0,0,0,46000,0,46000,46000
051594,和碩元大96購01  ,0,0,0,0,0,0,0,0,0,46000,0,0,0,132000,86000,46000,46000
050708,臺股指凱基96購06,0,0,0,0,0,0,0,0,0,46000,0,0,0,46000,0,46000,46000
052010,兆豐金中信95購01,0,0,0,0,0,0,0,0,0,46000,0,0,0,139000,93000,46000,46000
05067P,欣興兆豐96售02  ,0,0,0,0,0,0,0,0,0,46000,0,0,0,46000,0,46000,46000
053947,義隆富邦97購01  ,0,0,0,0,0,0,0,0,0,46000,0,0,0,102000,56000,46000,46000
055797,華通富邦98購01  ,0,0,0,0,0,0,0,0,0,46000,0,0,0,51000,5000,46000,46000
5531,鄉林            ,304000,258000,46000,0,0,0,0,0,0,0,0,0,0,0,0,0,46000
06354P,大立光永豐97售04,0,0,0,0,0,0,0,0,0,46000,0,0,0,100000,54000,46000,46000
06263P,燿華凱基97售04  ,0,0,0,0,0,0,0,0,0,46000,0,0,0,46000,0,46000,46000
1618,合機            ,50000,3000,47000,0,0,0,0,0,0,-1000,3000,4000,-1000,0,0,0,46000
06842P,臺股指統一9A售03,0,0,0,0,0,0,0,0,0,46000,0,0,0,136000,90000,46000,46000
057211,鴻海群益98購05  ,0,0,0,0,0,0,0,0,0,45000,0,0,0,148000,103000,45000,45000
057523,大成鋼元大99購01,0,0,0,0,0,0,0,0,0,45000,0,0,0,153000,108000,45000,45000
057637,上銀元大98購07  ,0,0,0,0,0,0,0,0,0,45000,0,0,0,45000,0,45000,45000
057008,華新科中信99購02,0,0,0,0,0,0,0,0,0,45000,0,0,0,45000,0,45000,45000
06046P,健策統一96售03  ,0,0,0,0,0,0,0,0,0,45000,0,0,0,127000,82000,45000,45000
058192,訊芯永豐99購01  ,0,0,0,0,0,0,0,0,0,45000,0,0,0,109000,64000,45000,45000
058172,國巨凱基9B購02  ,0,0,0,0,0,0,0,0,0,45000,0,0,0,45000,0,45000,45000
057693,臺股指凱基98購11,0,0,0,0,0,0,0,0,0,45000,0,0,0,95000,50000,45000,45000
04928P,大立光凱基95售07,0,0,0,0,0,0,0,0,0,45000,0,0,0,45000,0,45000,45000
049563,華新統一95購01  ,0,0,0,0,0,0,0,0,0,45000,0,0,0,129000,84000,45000,45000
04533P,臺股指凱基94售05,0,0,0,0,0,0,0,0,0,45000,0,0,0,45000,0,45000,45000
048484,大立光國泰95購02,0,0,0,0,0,0,0,0,0,45000,0,0,0,100000,55000,45000,45000
049761,亞德客國泰95購03,0,0,0,0,0,0,0,0,0,45000,0,0,0,99000,54000,45000,45000
048651,美利達元大96購05,0,0,0,0,0,0,0,0,0,45000,0,0,0,68000,23000,45000,45000
05111P,台積電統一95售04,0,0,0,0,0,0,0,0,0,45000,0,0,0,456000,411000,45000,45000
053264,南亞科群益96購01,0,0,0,0,0,0,0,0,0,45000,0,0,0,55000,10000,45000,45000
050749,道瓊銀統一96購03,0,0,0,0,0,0,0,0,0,45000,0,0,0,45000,0,45000,45000
050842,旺宏國票97購01  ,0,0,0,0,0,0,0,0,0,45000,0,0,0,72000,27000,45000,45000
05312P,臺股指群益95售11,0,0,0,0,0,0,0,0,0,45000,0,0,0,45000,0,45000,45000
052739,國巨元大96購04  ,0,0,0,0,0,0,0,0,0,45000,0,0,0,155000,110000,45000,45000
052163,康舒永豐95購02  ,0,0,0,0,0,0,0,0,0,45000,0,0,0,125000,80000,45000,45000
054258,牧德元大97購01  ,0,0,0,0,0,0,0,0,0,45000,0,0,0,45000,0,45000,45000
054991,南亞科元富97購01,0,0,0,0,0,0,0,0,0,45000,0,0,0,45000,0,45000,45000
06873P,嘉晶元富98售02  ,0,0,0,0,0,0,0,0,0,45000,0,0,0,65000,20000,45000,45000
06926P,可成群益9A售04  ,0,0,0,0,0,0,0,0,0,45000,0,0,0,69000,24000,45000,45000
06373P,聯發科元大97售22,0,0,0,0,0,0,0,0,0,45000,0,0,0,438000,393000,45000,45000
06498P,臺股指元大9A售03,0,0,0,0,0,0,0,0,0,45000,0,0,0,90000,45000,45000,45000
8482,商億-KY         ,249000,204000,45000,0,0,0,0,0,0,0,0,0,0,0,0,0,45000
2616,山隆            ,47000,2000,45000,0,0,0,0,0,0,0,0,0,0,0,0,0,45000
057559,可成兆豐99購02  ,0,0,0,0,0,0,0,0,0,44000,0,0,0,44000,0,44000,44000
048645,創意元大94購02  ,0,0,0,0,0,0,0,0,0,44000,0,0,0,68000,24000,44000,44000
049128,滬深2X元大97購03,0,0,0,0,0,0,0,0,0,44000,0,0,0,47000,3000,44000,44000
049004,聯發科中信96購01,0,0,0,0,0,0,0,0,0,44000,0,0,0,80000,36000,44000,44000
04841P,群創元大94售04  ,0,0,0,0,0,0,0,0,0,44000,0,0,0,44000,0,44000,44000
04403P,景碩國票95售01  ,0,0,0,0,0,0,0,0,0,44000,0,0,0,44000,0,44000,44000
050744,健策永豐94購04  ,0,0,0,0,0,0,0,0,0,44000,0,0,0,118000,74000,44000,44000
054971,帆宣元大97購02  ,0,0,0,0,0,0,0,0,0,44000,0,0,0,44000,0,44000,44000
05453P,智邦群益95售03  ,0,0,0,0,0,0,0,0,0,44000,0,0,0,44000,0,44000,44000
055909,大成鋼凱基98購02,0,0,0,0,0,0,0,0,0,44000,0,0,0,44000,0,44000,44000
2488,漢平            ,67000,26000,41000,0,0,0,0,0,0,3000,3000,0,3000,0,0,0,44000
3057,喬鼎            ,54000,10000,44000,0,0,0,0,0,0,0,0,0,0,0,0,0,44000
06453P,群創元大9B售02  ,0,0,0,0,0,0,0,0,0,44000,0,0,0,144000,100000,44000,44000
06320P,上銀統一97售04  ,0,0,0,0,0,0,0,0,0,44000,0,0,0,45000,1000,44000,44000
06124P,超眾元大97售03  ,0,0,0,0,0,0,0,0,0,44000,0,0,0,44000,0,44000,44000
06213P,大立光元大98售07,0,0,0,0,0,0,0,0,0,44000,0,0,0,411000,367000,44000,44000
08602P,台灣50凱基96售04,0,0,0,0,0,0,0,0,0,44000,0,0,0,44000,0,44000,44000
07005P,台積電統一9B售05,0,0,0,0,0,0,0,0,0,44000,0,0,0,114000,70000,44000,44000
1459,聯發            ,44000,0,44000,0,0,0,0,0,0,0,0,0,0,0,0,0,44000
057226,上銀凱基98購06  ,0,0,0,0,0,0,0,0,0,43000,0,0,0,43000,0,43000,43000
057903,聯鈞永豐99購01  ,0,0,0,0,0,0,0,0,0,43000,0,0,0,73000,30000,43000,43000
058069,美律凱基99購05  ,0,0,0,0,0,0,0,0,0,43000,0,0,0,50000,7000,43000,43000
05917P,宏達電元大96售02,0,0,0,0,0,0,0,0,0,43000,0,0,0,46000,3000,43000,43000
04993P,上銀兆豐96售01  ,0,0,0,0,0,0,0,0,0,43000,0,0,0,83000,40000,43000,43000
04756P,大立光元富94售08,0,0,0,0,0,0,0,0,0,43000,0,0,0,85000,42000,43000,43000
049103,易華電國泰96購01,0,0,0,0,0,0,0,0,0,43000,0,0,0,43000,0,43000,43000
052808,矽力元大96購02  ,0,0,0,0,0,0,0,0,0,43000,0,0,0,50000,7000,43000,43000
053270,台塑元大96購01  ,0,0,0,0,0,0,0,0,0,43000,0,0,0,305000,262000,43000,43000
05224P,華通統一95售03  ,0,0,0,0,0,0,0,0,0,43000,0,0,0,43000,0,43000,43000
052501,茂林永豐95購04  ,0,0,0,0,0,0,0,0,0,43000,0,0,0,68000,25000,43000,43000
05627P,致伸國票97售01  ,0,0,0,0,0,0,0,0,0,43000,0,0,0,43000,0,43000,43000
054580,樺漢元大98購01  ,0,0,0,0,0,0,0,0,0,43000,0,0,0,206000,163000,43000,43000
055021,亞德客國泰98購01,0,0,0,0,0,0,0,0,0,43000,0,0,0,112000,69000,43000,43000
054380,世芯群益97購02  ,0,0,0,0,0,0,0,0,0,43000,0,0,0,264000,221000,43000,43000
054032,上銀中信96購01  ,0,0,0,0,0,0,0,0,0,43000,0,0,0,48000,5000,43000,43000
1410,南染            ,50000,7000,43000,0,0,0,0,0,0,0,0,0,0,0,0,0,43000
6142,友勁            ,16000,62000,-46000,0,0,0,0,0,0,89000,89000,0,89000,0,0,0,43000
6226,光鼎            ,69000,26000,43000,0,0,0,0,0,0,0,0,0,0,0,0,0,43000
4989,榮科            ,64000,21000,43000,0,0,0,0,0,0,0,0,0,0,0,0,0,43000
057240,茂林凱基9A購01  ,0,0,0,0,0,0,0,0,0,42000,0,0,0,130000,88000,42000,42000
057596,聯茂兆豐99購01  ,0,0,0,0,0,0,0,0,0,42000,0,0,0,219000,177000,42000,42000
05746P,台積電群益96售07,0,0,0,0,0,0,0,0,0,42000,0,0,0,42000,0,42000,42000
04949P,致新元大94售04  ,0,0,0,0,0,0,0,0,0,42000,0,0,0,42000,0,42000,42000
04807P,聯茂元富94售01  ,0,0,0,0,0,0,0,0,0,42000,0,0,0,76000,34000,42000,42000
03826P,瀚宇博元大95售01,0,0,0,0,0,0,0,0,0,42000,0,0,0,203000,161000,42000,42000
04451P,可成凱基94售04  ,0,0,0,0,0,0,0,0,0,42000,0,0,0,50000,8000,42000,42000
049266,和碩元大94購01  ,0,0,0,0,0,0,0,0,0,42000,0,0,0,302000,260000,42000,42000
047196,上銀統一97購01  ,0,0,0,0,0,0,0,0,0,42000,0,0,0,55000,13000,42000,42000
04737P,正崴永豐94售02  ,0,0,0,0,0,0,0,0,0,42000,0,0,0,42000,0,42000,42000
05230P,京元電群益95售01,0,0,0,0,0,0,0,0,0,42000,0,0,0,42000,0,42000,42000
051069,智邦國票96購01  ,0,0,0,0,0,0,0,0,0,42000,0,0,0,100000,58000,42000,42000
053951,T50反1台新06購02,0,0,0,0,0,0,0,0,0,42000,0,0,0,192000,150000,42000,42000
054504,聯鈞永豐96購01  ,0,0,0,0,0,0,0,0,0,42000,0,0,0,44000,2000,42000,42000
055925,上銀群益97購01  ,0,0,0,0,0,0,0,0,0,42000,0,0,0,65000,23000,42000,42000
055763,鎧勝群益97購01  ,0,0,0,0,0,0,0,0,0,42000,0,0,0,100000,58000,42000,42000
055526,台積電群益97購02,0,0,0,0,0,0,0,0,0,42000,0,0,0,52000,10000,42000,42000
8011,台通            ,100000,58000,42000,0,0,0,0,0,0,0,1000,1000,0,0,0,0,42000
2443,億麗            ,44000,2000,42000,0,0,0,0,0,0,0,0,0,0,0,0,0,42000
06916P,聯鈞元富98售02  ,0,0,0,0,0,0,0,0,0,42000,0,0,0,64000,22000,42000,42000
06802P,緯穎群益98售03  ,0,0,0,0,0,0,0,0,0,42000,0,0,0,58000,16000,42000,42000
06160P,台達電群益97售01,0,0,0,0,0,0,0,0,0,42000,0,0,0,42000,0,42000,42000
06399P,台表科凱基97售05,0,0,0,0,0,0,0,0,0,42000,0,0,0,42000,0,42000,42000
06738P,瑞昱兆豐98售02  ,0,0,0,0,0,0,0,0,0,42000,0,0,0,124000,82000,42000,42000
057082,玉晶光統一9A購04,0,0,0,0,0,0,0,0,0,41000,0,0,0,51000,10000,41000,41000
06032P,健策群益97售03  ,0,0,0,0,0,0,0,0,0,41000,0,0,0,41000,0,41000,41000
05878P,創意群益98售01  ,0,0,0,0,0,0,0,0,0,41000,0,0,0,50000,9000,41000,41000
05871P,全新凱基96售04  ,0,0,0,0,0,0,0,0,0,41000,0,0,0,41000,0,41000,41000
058405,訊連元大99購02  ,0,0,0,0,0,0,0,0,0,41000,0,0,0,60000,19000,41000,41000
045054,聯發科元富98購02,0,0,0,0,0,0,0,0,0,41000,0,0,0,177000,136000,41000,41000
04433P,上証2X國票95售01,0,0,0,0,0,0,0,0,0,41000,0,0,0,41000,0,41000,41000
046493,緯創富邦93購01  ,0,0,0,0,0,0,0,0,0,41000,0,0,0,41000,0,41000,41000
042705,台積電亞東93購01,0,0,0,0,0,0,0,0,0,41000,0,0,0,41000,0,41000,41000
042927,道瓊反中信94購01,0,0,0,0,0,0,0,0,0,41000,0,0,0,51000,10000,41000,41000
03595P,聯發科凱基02售11,0,0,0,0,0,0,0,0,0,41000,0,0,0,41000,0,41000,41000
047598,深中小統一94購01,0,0,0,0,0,0,0,0,0,41000,0,0,0,41000,0,41000,41000
04932P,香港2X中信96售01,0,0,0,0,0,0,0,0,0,41000,0,0,0,101000,60000,41000,41000
053719,可成凱基96購08  ,0,0,0,0,0,0,0,0,0,41000,0,0,0,68000,27000,41000,41000
055621,國巨國泰98購03  ,0,0,0,0,0,0,0,0,0,41000,0,0,0,51000,10000,41000,41000
055369,友訊元大97購01  ,0,0,0,0,0,0,0,0,0,41000,0,0,0,192000,151000,41000,41000
056342,中工凱基98購01  ,0,0,0,0,0,0,0,0,0,41000,0,0,0,50000,9000,41000,41000
05424P,台達電亞東96售02,0,0,0,0,0,0,0,0,0,41000,0,0,0,41000,0,41000,41000
1423,利華            ,41000,0,41000,0,0,0,0,0,0,0,0,0,0,0,0,0,41000
3593,力銘            ,40000,0,40000,0,0,0,0,0,0,1000,1000,0,1000,0,0,0,41000
058436,聯發科統一9B購03,0,0,0,0,0,0,0,0,0,40000,0,0,0,68000,28000,40000,40000
05835P,臺股指元富96售07,0,0,0,0,0,0,0,0,0,40000,0,0,0,40000,0,40000,40000
06037P,超眾國票98售02  ,0,0,0,0,0,0,0,0,0,40000,0,0,0,50000,10000,40000,40000
058149,百和元大99購02  ,0,0,0,0,0,0,0,0,0,40000,0,0,0,54000,14000,40000,40000
058236,大立光元大99購09,0,0,0,0,0,0,0,0,0,40000,0,0,0,40000,0,40000,40000
057959,欣興元大98購14  ,0,0,0,0,0,0,0,0,0,40000,0,0,0,56000,16000,40000,40000
057688,國巨凱基99購07  ,0,0,0,0,0,0,0,0,0,40000,0,0,0,147000,107000,40000,40000
057647,欣興元大98購10  ,0,0,0,0,0,0,0,0,0,40000,0,0,0,55000,15000,40000,40000
05710P,禾伸堂國票97售02,0,0,0,0,0,0,0,0,0,40000,0,0,0,40000,0,40000,40000
057198,智伸科統一9B購01,0,0,0,0,0,0,0,0,0,40000,0,0,0,48000,8000,40000,40000
057556,智易凱基99購01  ,0,0,0,0,0,0,0,0,0,40000,0,0,0,40000,0,40000,40000
057533,晶相光元大98購02,0,0,0,0,0,0,0,0,0,40000,0,0,0,165000,125000,40000,40000
056873,友達凱基98購07  ,0,0,0,0,0,0,0,0,0,40000,0,0,0,40000,0,40000,40000
056644,宏達電凱基98購04,0,0,0,0,0,0,0,0,0,40000,0,0,0,139000,99000,40000,40000
049424,中石化兆豐94購01,0,0,0,0,0,0,0,0,0,40000,0,0,0,100000,60000,40000,40000
049410,統一凱基94購02  ,0,0,0,0,0,0,0,0,0,40000,0,0,0,60000,20000,40000,40000
04832P,為升元大94售09  ,0,0,0,0,0,0,0,0,0,40000,0,0,0,80000,40000,40000,40000
050011,S&P反1國泰95購01,0,0,0,0,0,0,0,0,0,40000,0,0,0,40000,0,40000,40000
049686,T50反1元大94購02,0,0,0,0,0,0,0,0,0,40000,0,0,0,40000,0,40000,40000
048480,FB上証中信94購01,0,0,0,0,0,0,0,0,0,40000,0,0,0,160000,120000,40000,40000
047809,瑞昱凱基93購08  ,0,0,0,0,0,0,0,0,0,40000,0,0,0,60000,20000,40000,40000
047761,亞德客元大93購02,0,0,0,0,0,0,0,0,0,40000,0,0,0,50000,10000,40000,40000
052845,旺宏統一97購01  ,0,0,0,0,0,0,0,0,0,40000,0,0,0,40000,0,40000,40000
052543,聯詠元富95購01  ,0,0,0,0,0,0,0,0,0,40000,0,0,0,40000,0,40000,40000
052558,新唐國票97購01  ,0,0,0,0,0,0,0,0,0,40000,0,0,0,40000,0,40000,40000
048897,日電貿國泰95購01,0,0,0,0,0,0,0,0,0,40000,0,0,0,40000,0,40000,40000
04859P,台達電群益94售04,0,0,0,0,0,0,0,0,0,40000,0,0,0,40000,0,40000,40000
048794,易華電元大97購01,0,0,0,0,0,0,0,0,0,40000,0,0,0,40000,0,40000,40000
042712,元石油國票95購01,0,0,0,0,0,0,0,0,0,40000,0,0,0,50000,10000,40000,40000
04196P,東陽中信93售02  ,0,0,0,0,0,0,0,0,0,40000,0,0,0,40000,0,40000,40000
04435P,台積電中信95售07,0,0,0,0,0,0,0,0,0,40000,0,0,0,60000,20000,40000,40000
043924,世紀鋼凱基93購01,0,0,0,0,0,0,0,0,0,40000,0,0,0,40000,0,40000,40000
03149P,鴻海群益01售12  ,0,0,0,0,0,0,0,0,0,40000,0,0,0,40000,0,40000,40000
03996P,旺宏國泰95售01  ,0,0,0,0,0,0,0,0,0,40000,0,0,0,85000,45000,40000,40000
04508P,臺股指元大94售03,0,0,0,0,0,0,0,0,0,40000,0,0,0,40000,0,40000,40000
045500,聯發科凱基93購04,0,0,0,0,0,0,0,0,0,40000,0,0,0,40000,0,40000,40000
04348P,燿華國票94售01  ,0,0,0,0,0,0,0,0,0,40000,0,0,0,40000,0,40000,40000
04384P,上証2X中信96售01,0,0,0,0,0,0,0,0,0,40000,0,0,0,45000,5000,40000,40000
04959P,可成凱基94售14  ,0,0,0,0,0,0,0,0,0,40000,0,0,0,240000,200000,40000,40000
053331,玉晶光永豐97購02,0,0,0,0,0,0,0,0,0,40000,0,0,0,50000,10000,40000,40000
053458,聯詠國泰97購01  ,0,0,0,0,0,0,0,0,0,40000,0,0,0,40000,0,40000,40000
052210,華夏元大95購01  ,0,0,0,0,0,0,0,0,0,40000,0,0,0,40000,0,40000,40000
052208,力成麥證95購01  ,0,0,0,50000,10000,40000,0,0,0,40000,0,0,0,50000,10000,40000,40000
052444,友訊元大95購01  ,0,0,0,0,0,0,0,0,0,40000,0,0,0,78000,38000,40000,40000
053642,瀚宇博永豐96購01,0,0,0,0,0,0,0,0,0,40000,0,0,0,42000,2000,40000,40000
053626,台積電兆豐96購03,0,0,0,0,0,0,0,0,0,40000,0,0,0,40000,0,40000,40000
053614,台積電群益96購08,0,20000,-20000,0,0,0,0,0,0,60000,0,0,0,110000,50000,60000,40000
05131P,聯詠統一97售01  ,0,0,0,0,0,0,0,0,0,40000,0,0,0,40000,0,40000,40000
051271,華新科群益95購04,0,0,0,0,0,0,0,0,0,40000,0,0,0,50000,10000,40000,40000
05124P,華新科富邦97售02,0,0,0,0,0,0,0,0,0,40000,0,0,0,40000,0,40000,40000
050480,健策國票95購04  ,0,0,0,0,0,0,0,0,0,40000,0,0,0,40000,0,40000,40000
05218P,大立光永昌96售04,0,0,0,0,0,0,0,0,0,40000,0,0,0,265000,225000,40000,40000
050415,力成永豐94購01  ,0,0,0,0,0,0,0,0,0,40000,0,0,0,40000,0,40000,40000
051633,可成國票96購03  ,0,0,0,0,0,0,0,0,0,40000,0,0,0,60000,20000,40000,40000
050101,台積電永昌96購03,173000,5000,168000,0,0,0,0,0,0,-128000,0,0,0,878000,1006000,-128000,40000
052606,聯發科元大97購04,0,0,0,0,0,0,0,0,0,40000,0,0,0,141000,101000,40000,40000
050073,傳奇凱基94購02  ,0,0,0,0,0,0,0,0,0,40000,0,0,0,40000,0,40000,40000
050189,旭富元大94購01  ,0,0,0,0,0,0,0,0,0,40000,0,0,0,41000,1000,40000,40000
052708,楠梓電永豐97購01,0,0,0,0,0,0,0,0,0,40000,0,0,0,40000,0,40000,40000
053224,矽力凱基96購02  ,0,0,0,0,0,0,0,0,0,40000,0,0,0,250000,210000,40000,40000
051104,鈺齊元大96購01  ,0,0,0,0,0,0,0,0,0,40000,0,0,0,161000,121000,40000,40000
050514,聯電元大94購01  ,0,0,0,0,0,0,0,0,0,40000,0,0,0,50000,10000,40000,40000
050743,京鼎永豐94購02  ,0,0,0,0,0,0,0,0,0,40000,0,0,0,40000,0,40000,40000
051434,中磊元富95購02  ,0,0,0,0,0,0,0,0,0,40000,0,0,0,44000,4000,40000,40000
054264,超眾元大97購02  ,0,0,0,0,0,0,0,0,0,40000,0,0,0,43000,3000,40000,40000
054109,南亞科凱基96購05,0,0,0,0,0,0,0,0,0,40000,0,0,0,40000,0,40000,40000
054671,國巨國泰98購01  ,0,0,0,0,0,0,0,0,0,40000,0,0,0,50000,10000,40000,40000
054836,勤誠中信97購01  ,0,0,0,0,0,0,0,0,0,40000,0,0,0,40000,0,40000,40000
056399,上証2X群益9C購01,0,0,0,0,0,0,0,0,0,40000,0,0,0,425000,385000,40000,40000
055934,景碩群益98購03  ,0,0,0,0,0,0,0,0,0,40000,0,0,0,168000,128000,40000,40000
055396,瑞儀統一97購01  ,0,0,0,0,0,0,0,0,0,40000,0,0,0,40000,0,40000,40000
6641,基士德-KY       ,40000,0,40000,0,0,0,0,0,0,0,0,0,0,0,0,0,40000
6449,鈺邦            ,78000,42000,36000,0,0,0,0,0,0,4000,8000,4000,4000,0,0,0,40000
2476,鉅祥            ,62000,23000,39000,0,0,0,0,0,0,1000,1000,0,1000,0,0,0,40000
3002,歐格            ,47000,5000,42000,0,0,0,0,0,0,-2000,0,2000,-2000,0,0,0,40000
2380,虹光            ,40000,0,40000,0,0,0,0,0,0,0,0,0,0,0,0,0,40000
06608P,立積群益99售02  ,0,0,0,0,0,0,0,0,0,40000,0,0,0,40000,0,40000,40000
06424P,大成鋼永豐97售01,0,0,0,0,0,0,0,0,0,40000,0,0,0,40000,0,40000,40000
06409P,康友元富97售03  ,0,0,0,0,0,0,0,0,0,40000,0,0,0,90000,50000,40000,40000
06336P,鴻海元大98售05  ,0,0,0,0,0,0,0,0,0,40000,0,0,0,40000,0,40000,40000
06294P,臺股指國票97售08,0,0,0,0,0,0,0,0,0,40000,0,0,0,40000,0,40000,40000
06285P,台積電國票98售04,0,0,0,0,0,0,0,0,0,40000,0,0,0,56000,16000,40000,40000
06207P,聯發科凱基97售07,0,0,0,0,0,0,0,0,0,40000,0,0,0,61000,21000,40000,40000
06108P,奇力新群益97售05,0,0,0,0,0,0,0,0,0,40000,0,0,0,40000,0,40000,40000
056909,嘉聯益元大99購03,0,0,0,0,0,0,0,0,0,39000,0,0,0,54000,15000,39000,39000
057088,上銀元富98購01  ,0,0,0,0,0,0,0,0,0,39000,0,0,0,50000,11000,39000,39000
05889P,群創元大98售02  ,0,0,0,0,0,0,0,0,0,39000,0,0,0,140000,101000,39000,39000
03422B,臺股指凱基96熊28,0,0,0,0,0,0,0,0,0,39000,0,0,0,44000,5000,39000,39000
05310P,智原永豐95售04  ,0,0,0,0,0,0,0,0,0,39000,0,0,0,39000,0,39000,39000
052392,台表科群益96購02,0,0,0,0,0,0,0,0,0,39000,0,0,0,150000,111000,39000,39000
05485P,旺宏凱基95售08  ,0,0,0,0,0,0,0,0,0,39000,0,0,0,64000,25000,39000,39000
054408,義隆國票98購01  ,0,0,0,0,0,0,0,0,0,39000,0,0,0,39000,0,39000,39000
053798,台積電中信98購02,0,0,0,0,0,0,0,0,0,39000,0,0,0,47000,8000,39000,39000
06321P,台積電統一98售03,0,0,0,0,0,0,0,0,0,39000,0,0,0,45000,6000,39000,39000
06403P,鴻海元富97售15  ,0,0,0,0,0,0,0,0,0,39000,0,0,0,39000,0,39000,39000
06438P,玉晶光國票99售02,0,0,0,0,0,0,0,0,0,39000,0,0,0,39000,0,39000,39000
06447P,上銀元大98售01  ,0,0,0,0,0,0,0,0,0,39000,0,0,0,70000,31000,39000,39000
06542P,台光電國票98售05,0,0,0,0,0,0,0,0,0,39000,0,0,0,49000,10000,39000,39000
1528,恩德            ,49000,10000,39000,0,0,0,0,0,0,0,0,0,0,0,0,0,39000
06956P,國巨日盛99售04  ,0,0,0,0,0,0,0,0,0,39000,0,0,0,39000,0,39000,39000
3033,威健            ,99000,60000,39000,0,0,0,0,0,0,0,0,0,0,0,0,0,39000
2636,台驊投控        ,42000,3000,39000,0,0,0,0,0,0,0,0,0,0,0,0,0,39000
05978P,麗豐永豐96售02  ,0,0,0,0,0,0,0,0,0,38000,0,0,0,38000,0,38000,38000
05839P,臺股指富邦96售06,0,0,0,0,0,0,0,0,0,38000,0,0,0,38000,0,38000,38000
057790,台積電統一99購04,0,0,0,0,0,0,0,0,0,38000,0,0,0,38000,0,38000,38000
058043,鴻海元大98購13  ,0,0,0,0,0,0,0,0,0,38000,0,0,0,107000,69000,38000,38000
057149,京鼎國票99購02  ,0,0,0,0,0,0,0,0,0,38000,0,0,0,38000,0,38000,38000
056828,國巨富邦9A購03  ,0,0,0,0,0,0,0,0,0,38000,0,0,0,90000,52000,38000,38000
056558,台達電群益98購01,0,0,0,0,0,0,0,0,0,38000,0,0,0,69000,31000,38000,38000
05656P,台表科統一96售01,0,0,0,0,0,0,0,0,0,38000,0,0,0,38000,0,38000,38000
04322P,可成元大94售01  ,0,0,0,0,0,0,0,0,0,38000,0,0,0,38000,0,38000,38000
049567,鴻海統一94購05  ,0,0,0,0,0,0,0,0,0,38000,0,0,0,38000,0,38000,38000
049217,智邦國票95購01  ,0,0,0,0,0,0,0,0,0,38000,0,0,0,38000,0,38000,38000
04781P,欣興凱基94售06  ,0,0,0,0,0,0,0,0,0,38000,0,0,0,48000,10000,38000,38000
050407,聯詠台新94購02  ,0,0,0,0,0,0,0,0,0,38000,0,0,0,38000,0,38000,38000
051074,矽力國票96購01  ,0,0,0,0,0,0,0,0,0,38000,0,0,0,48000,10000,38000,38000
050843,富邦金國票96購01,0,0,0,0,0,0,0,0,0,38000,0,0,0,38000,0,38000,38000
053248,智伸科國票97購01,0,0,0,0,0,0,0,0,0,38000,0,0,0,38000,0,38000,38000
054214,京鼎國票97購02  ,0,0,0,0,0,0,0,0,0,38000,0,0,0,48000,10000,38000,38000
055090,國巨群益97購03  ,0,0,0,0,0,0,0,0,0,38000,0,0,0,38000,0,38000,38000
054489,牧德台新97購02  ,0,0,0,0,0,0,0,0,0,38000,0,0,0,38000,0,38000,38000
05454P,奇鋐群益95售04  ,0,0,0,0,0,0,0,0,0,38000,0,0,0,40000,2000,38000,38000
055817,京鼎國票99購01  ,0,0,0,0,0,0,0,0,0,38000,0,0,0,38000,0,38000,38000
3321,同泰            ,79000,41000,38000,0,0,0,0,0,0,0,0,0,0,0,0,0,38000
6442,光聖            ,43000,5000,38000,0,0,0,0,0,0,0,0,0,0,0,0,0,38000
6243,迅杰            ,38000,0,38000,0,0,0,0,0,0,0,0,0,0,0,0,0,38000
5608,四維航          ,56000,18000,38000,0,0,0,0,0,0,0,0,0,0,0,0,0,38000
06918P,嘉聯益亞東99售01,0,0,0,0,0,0,0,0,0,38000,0,0,0,58000,20000,38000,38000
1413,宏洲            ,45000,7000,38000,0,0,0,0,0,0,0,0,0,0,0,0,0,38000
06457P,玉晶光統一98售02,0,0,0,0,0,0,0,0,0,38000,0,0,0,191000,153000,38000,38000
06505P,康控國票99售02  ,0,0,0,0,0,0,0,0,0,38000,0,0,0,48000,10000,38000,38000
06521P,矽力元大98售01  ,0,0,0,0,0,0,0,0,0,38000,0,0,0,131000,93000,38000,38000
06491P,台積電富邦99售02,0,0,0,0,0,0,0,0,0,38000,0,0,0,100000,62000,38000,38000
06648P,華邦電元大98售03,0,0,0,0,0,0,0,0,0,38000,0,0,0,56000,18000,38000,38000
06649P,聯發科元大98售08,0,0,0,0,0,0,0,0,0,38000,0,0,0,242000,204000,38000,38000
057006,國巨中信98購03  ,0,0,0,0,0,0,0,0,0,37000,0,0,0,37000,0,37000,37000
04995P,台達電凱基96售03,0,0,0,0,0,0,0,0,0,37000,0,0,0,106000,69000,37000,37000
04907P,超眾國票95售01  ,0,0,0,0,0,0,0,0,0,37000,0,0,0,146000,109000,37000,37000
04713P,創意元大95售01  ,0,0,0,0,0,0,0,0,0,37000,0,0,0,37000,0,37000,37000
050559,聯發科統一94購10,0,0,0,0,0,0,0,0,0,37000,0,0,0,226000,189000,37000,37000
051954,矽力元富95購04  ,0,0,0,0,0,0,0,0,0,37000,0,0,0,44000,7000,37000,37000
05120P,聯發科國泰97售01,0,0,0,0,0,0,0,0,0,37000,0,0,0,37000,0,37000,37000
052147,上緯控群益95購01,0,0,0,0,0,0,0,0,0,37000,0,0,0,37000,0,37000,37000
053352,義隆兆豐96購01  ,0,0,0,0,0,0,0,0,0,37000,0,0,0,53000,16000,37000,37000
053581,台積電元大96購14,0,0,0,0,0,0,0,0,0,37000,0,0,0,37000,0,37000,37000
055364,矽創凱基97購03  ,0,0,0,0,0,0,0,0,0,37000,0,0,0,145000,108000,37000,37000
054514,道瓊銀元大98購01,0,0,0,0,0,0,0,0,0,37000,0,0,0,85000,48000,37000,37000
054699,復盛永豐97購01  ,0,0,0,0,0,0,0,0,0,37000,0,0,0,42000,5000,37000,37000
06725P,聯電元富98售01  ,0,0,0,0,0,0,0,0,0,37000,0,0,0,87000,50000,37000,37000
06423P,亞光台新97售01  ,0,0,0,0,0,0,0,0,0,37000,0,0,0,43000,6000,37000,37000
06201P,可成元大97售01  ,0,0,0,0,0,0,0,0,0,37000,0,0,0,620000,583000,37000,37000
1441,大東            ,58000,21000,37000,0,0,0,0,0,0,0,0,0,0,0,0,0,37000
1452,宏益            ,42000,5000,37000,0,0,0,0,0,0,0,0,0,0,0,0,0,37000
06912P,台光電元大99售02,0,0,0,0,0,0,0,0,0,37000,0,0,0,57000,20000,37000,37000
06872P,亞德客元富98售04,0,0,0,0,0,0,0,0,0,37000,0,0,0,52000,15000,37000,37000
4572,駐龍            ,41000,4000,37000,0,0,0,0,0,0,0,0,0,0,0,0,0,37000
3011,今皓            ,37000,0,37000,0,0,0,0,0,0,0,0,0,0,0,0,0,37000
2493,揚博            ,66000,24000,42000,0,0,0,0,0,0,-5000,0,5000,-5000,0,0,0,37000
056851,瑞儀元富98購01  ,0,0,0,0,0,0,0,0,0,36000,0,0,0,155000,119000,36000,36000
057774,台光電群益99購02,0,0,0,0,0,0,0,0,0,36000,0,0,0,67000,31000,36000,36000
057964,緯穎元大99購03  ,0,0,0,0,0,0,0,0,0,36000,0,0,0,68000,32000,36000,36000
06005P,晶豪科永豐96售04,0,0,0,0,0,0,0,0,0,36000,0,0,0,46000,10000,36000,36000
048945,訊連永豐94購01  ,0,0,0,0,0,0,0,0,0,36000,0,0,0,46000,10000,36000,36000
048773,貿聯凱基94購01  ,0,0,0,0,0,0,0,0,0,36000,0,0,0,36000,0,36000,36000
04941P,台達電台新94售02,0,0,0,0,0,0,0,0,0,36000,0,0,0,41000,5000,36000,36000
051650,矽力永豐95購01  ,0,0,0,0,0,0,0,0,0,36000,0,0,0,36000,0,36000,36000
052596,群創群益98購05  ,0,0,0,0,0,0,0,0,0,36000,0,0,0,36000,0,36000,36000
054807,台化元大9A購02  ,0,0,0,0,0,0,0,0,0,36000,0,0,0,78000,42000,36000,36000
4141,龍燈-KY         ,38000,2000,36000,0,0,0,0,0,0,0,0,0,0,0,0,0,36000
1603,華電            ,54000,13000,41000,0,0,0,0,0,0,-5000,0,5000,-5000,0,0,0,36000
2029,盛餘            ,53000,17000,36000,0,0,0,0,0,0,0,0,0,0,0,0,0,36000
06713P,臺股指富邦99售04,0,0,0,0,0,0,0,0,0,36000,0,0,0,36000,0,36000,36000
06664P,聯發科兆豐98售02,0,0,0,0,0,0,0,0,0,36000,0,0,0,39000,3000,36000,36000
06439P,上銀凱基98售02  ,0,0,0,0,0,0,0,0,0,36000,0,0,0,46000,10000,36000,36000
058386,A50正2國票9B購01,0,0,0,0,0,0,0,0,0,35000,0,0,0,35000,0,35000,35000
057823,神達元大98購01  ,0,0,0,0,0,0,0,0,0,35000,0,0,0,181000,146000,35000,35000
056990,聯發科兆豐98購01,0,0,0,0,0,0,0,0,0,35000,0,0,0,35000,0,35000,35000
05701P,彩晶凱基96售01  ,0,0,0,0,0,0,0,0,0,35000,0,0,0,435000,400000,35000,35000
049360,台達電元大94購07,0,0,0,0,0,0,0,0,0,35000,0,0,0,35000,0,35000,35000
04838P,宏達電元大95售02,0,0,0,0,0,0,0,0,0,35000,0,0,0,35000,0,35000,35000
052839,上海銀國泰97購01,0,0,0,0,0,0,0,0,0,35000,0,0,0,135000,100000,35000,35000
03425B,臺股指元大9A熊01,0,0,0,0,0,0,0,0,0,35000,0,0,0,203000,168000,35000,35000
00728,第一金工業30    ,0,0,0,0,0,0,0,0,0,35000,0,0,0,775000,740000,35000,35000
052732,新唐國泰97購01  ,0,0,0,0,0,0,0,0,0,35000,0,0,0,35000,0,35000,35000
052345,矽力凱基95購01  ,0,0,0,0,0,0,0,0,0,35000,0,0,0,45000,10000,35000,35000
054693,神基永豐97購01  ,0,0,0,0,0,0,0,0,0,35000,0,0,0,50000,15000,35000,35000
05418P,瑞昱永豐95售02  ,0,0,0,0,0,0,0,0,0,35000,0,0,0,35000,0,35000,35000
05441P,華通元大95售09  ,0,0,0,0,0,0,0,0,0,35000,0,0,0,40000,5000,35000,35000
053824,樺漢群益96購02  ,0,0,0,0,0,0,0,0,0,35000,0,0,0,36000,1000,35000,35000
054053,聯茂元大96購01  ,0,0,0,0,0,0,0,0,0,35000,0,0,0,58000,23000,35000,35000
055270,上銀元大97購03  ,0,0,0,0,0,0,0,0,0,35000,0,0,0,100000,65000,35000,35000
056020,義隆群益97購01  ,0,0,0,0,0,0,0,0,0,35000,0,0,0,133000,98000,35000,35000
056308,TPK元大97購02   ,0,0,0,0,0,0,0,0,0,35000,0,0,0,68000,33000,35000,35000
056255,華新科元富97購05,0,0,0,0,0,0,0,0,0,35000,0,0,0,122000,87000,35000,35000
06687P,A50正2中信9A售01,0,0,0,0,0,0,0,0,0,35000,0,0,0,35000,0,35000,35000
06743P,創意永豐98售03  ,0,0,0,0,0,0,0,0,0,35000,0,0,0,35000,0,35000,35000
06064P,台積電台新98售01,0,0,0,0,0,0,0,0,0,35000,0,0,0,35000,0,35000,35000
1721,三晃            ,44000,9000,35000,0,0,0,0,0,0,0,0,0,0,0,0,0,35000
06970P,旺宏元大99售08  ,0,0,0,0,0,0,0,0,0,35000,0,0,0,75000,40000,35000,35000
07006P,旺宏統一9B售03  ,0,0,0,0,0,0,0,0,0,35000,0,0,0,62000,27000,35000,35000
07010P,T50正2凱基9C售01,0,0,0,0,0,0,0,0,0,35000,0,0,0,35000,0,35000,35000
1307,三芳            ,78000,43000,35000,0,0,0,0,0,0,0,0,0,0,0,0,0,35000
2444,兆勁            ,52000,16000,36000,0,0,0,0,0,0,-1000,0,1000,-1000,0,0,0,35000
2423,固緯            ,106000,71000,35000,0,0,0,0,0,0,0,0,0,0,0,0,0,35000
05697P,友達凱基96售01  ,0,0,0,0,0,0,0,0,0,34000,0,0,0,104000,70000,34000,34000
056553,啟碁凱基98購02  ,0,0,0,0,0,0,0,0,0,34000,0,0,0,64000,30000,34000,34000
05715P,創意元富96售05  ,0,0,0,0,0,0,0,0,0,34000,0,0,0,116000,82000,34000,34000
058411,技嘉兆豐99購01  ,0,0,0,0,0,0,0,0,0,34000,0,0,0,34000,0,34000,34000
06017P,亞光凱基96售04  ,0,0,0,0,0,0,0,0,0,34000,0,0,0,74000,40000,34000,34000
04324P,新光金元大94售01,0,0,0,0,0,0,0,0,0,34000,0,0,0,34000,0,34000,34000
03999P,鴻海凱基94售11  ,0,0,0,0,0,0,0,0,0,34000,0,0,0,45000,11000,34000,34000
049608,旺宏兆豐94購02  ,0,0,0,0,0,0,0,0,0,34000,0,0,0,44000,10000,34000,34000
047298,聯茂元富96購01  ,0,0,0,0,0,0,0,0,0,34000,0,0,0,60000,26000,34000,34000
04922P,日月光凱基94售02,0,0,0,0,0,0,0,0,0,34000,0,0,0,70000,36000,34000,34000
04999P,南電永豐95售01  ,0,0,0,0,0,0,0,0,0,34000,0,0,0,71000,37000,34000,34000
04783P,貿聯元富94售01  ,0,0,0,0,0,0,0,0,0,34000,0,0,0,34000,0,34000,34000
04754P,宏達電元富94售02,0,0,0,0,0,0,0,0,0,34000,0,0,0,34000,0,34000,34000
052375,奇力新元大96購02,0,0,0,0,0,0,0,0,0,34000,0,0,0,39000,5000,34000,34000
052515,矽力凱基95購02  ,0,0,0,0,0,0,0,0,0,34000,0,0,0,34000,0,34000,34000
05610P,國巨群益98售01  ,0,0,0,0,0,0,0,0,0,34000,0,0,0,34000,0,34000,34000
055285,華新科元大99購03,0,0,0,0,0,0,0,0,0,34000,0,0,0,141000,107000,34000,34000
054891,聯鈞統一99購02  ,0,0,0,0,0,0,0,0,0,34000,0,0,0,490000,456000,34000,34000
2705,六福            ,53000,20000,33000,0,0,0,0,0,0,1000,1000,0,1000,0,0,0,34000
3022,威強電          ,65000,32000,33000,0,0,0,0,0,0,1000,1000,0,1000,0,0,0,34000
3679,新至陞          ,46000,18000,28000,0,0,0,0,0,0,6000,6000,0,6000,0,0,0,34000
08613P,同欣電凱基9C售04,0,0,0,0,0,0,0,0,0,34000,0,0,0,34000,0,34000,34000
06056P,台積電凱基98售02,0,0,0,0,0,0,0,0,0,33000,0,0,0,74000,41000,33000,33000
058326,祥碩台新99購01  ,0,0,0,0,0,0,0,0,0,33000,0,0,0,33000,0,33000,33000
057842,緯穎富邦99購02  ,0,0,0,0,0,0,0,0,0,33000,0,0,0,34000,1000,33000,33000
057792,群創統一99購01  ,0,0,0,0,0,0,0,0,0,33000,0,0,0,48000,15000,33000,33000
05806P,宏達電永豐96售03,0,0,0,0,0,0,0,0,0,33000,0,0,0,33000,0,33000,33000
057401,晶豪科群益99購01,0,0,0,0,0,0,0,0,0,33000,0,0,0,99000,66000,33000,33000
05663P,創意元富96售04  ,0,0,0,0,0,0,0,0,0,33000,0,0,0,53000,20000,33000,33000
04696P,亞德客國泰95售02,0,0,0,0,0,0,0,0,0,33000,0,0,0,153000,120000,33000,33000
04517P,宏達電群益95售01,0,0,0,0,0,0,0,0,0,33000,0,0,0,33000,0,33000,33000
00693U,街口S&P黃豆     ,77000,0,77000,0,0,0,0,0,0,-44000,0,0,0,281000,325000,-44000,33000
00771,元大US高息特別股,0,0,0,0,0,0,0,0,0,33000,0,0,0,60000,27000,33000,33000
052391,瑞儀群益95購01  ,0,0,0,0,0,0,0,0,0,33000,0,0,0,33000,0,33000,33000
050456,聯茂元大94購09  ,0,0,0,0,0,0,0,0,0,33000,0,0,0,68000,35000,33000,33000
052630,滬深2X日盛96購01,0,0,0,0,0,0,0,0,0,33000,0,0,0,133000,100000,33000,33000
05119P,聯發科國泰96售02,0,0,0,0,0,0,0,0,0,33000,0,0,0,58000,25000,33000,33000
051970,元黃金凱基98購01,0,0,0,0,0,0,0,0,0,33000,0,0,0,123000,90000,33000,33000
054617,超眾永豐97購01  ,0,0,0,0,0,0,0,0,0,33000,0,0,0,33000,0,33000,33000
053971,聯發科元大97購09,0,0,0,0,0,0,0,0,0,33000,0,0,0,33000,0,33000,33000
055850,聯詠元大97購06  ,0,0,0,0,0,0,0,0,0,33000,0,0,0,206000,173000,33000,33000
05619P,創意元富96售02  ,0,0,0,0,0,0,0,0,0,33000,0,0,0,53000,20000,33000,33000
05640P,旺宏元富96售03  ,0,0,0,0,0,0,0,0,0,33000,0,0,0,59000,26000,33000,33000
06928P,鴻海元大99售10  ,0,0,0,0,0,0,0,0,0,33000,0,0,0,55000,22000,33000,33000
1615,大山            ,34000,1000,33000,0,0,0,0,0,0,0,0,0,0,0,0,0,33000
06099P,鴻海日盛97售03  ,0,0,0,0,0,0,0,0,0,33000,0,0,0,38000,5000,33000,33000
06128P,玉晶光元富97售05,0,0,0,0,0,0,0,0,0,33000,0,0,0,47000,14000,33000,33000
06361P,聯發科群益97售06,0,0,0,0,0,0,0,0,0,33000,0,0,0,52000,19000,33000,33000
06680P,智邦元大98售06  ,0,0,0,0,0,0,0,0,0,33000,0,0,0,76000,43000,33000,33000
06627P,華新科元富99售01,0,0,0,0,0,0,0,0,0,33000,0,0,0,48000,15000,33000,33000
056611,國巨永豐98購03  ,0,0,0,0,0,0,0,0,0,32000,0,0,0,52000,20000,32000,32000
056484,聯茂元大98購02  ,0,0,0,0,0,0,0,0,0,32000,0,0,0,42000,10000,32000,32000
05674P,瑞昱群益96售02  ,0,0,0,0,0,0,0,0,0,32000,0,0,0,54000,22000,32000,32000
05719P,可成元大96售03  ,0,0,0,0,0,0,0,0,0,32000,0,0,0,33000,1000,32000,32000
057328,京鼎群益99購02  ,0,0,0,0,0,0,0,0,0,32000,0,0,0,98000,66000,32000,32000
05794P,華邦電群益96售04,0,0,0,0,0,0,0,0,0,32000,0,0,0,32000,0,32000,32000
05909P,康友元富96售02  ,0,0,0,0,0,0,0,0,0,32000,0,0,0,85000,53000,32000,32000
048483,可成國泰95購01  ,0,0,0,0,0,0,0,0,0,32000,0,0,0,102000,70000,32000,32000
049759,元黃金富邦9A購01,0,0,0,0,0,0,0,0,0,32000,0,0,0,35000,3000,32000,32000
048795,復盛元大94購01  ,0,0,0,0,0,0,0,0,0,32000,0,0,0,132000,100000,32000,32000
050124,元金2X凱基95購01,0,0,0,0,0,0,0,0,0,32000,0,0,0,42000,10000,32000,32000
05154P,台積電兆豐95售05,0,0,0,0,0,0,0,0,0,32000,0,0,0,32000,0,32000,32000
053587,京元電元大98購01,0,0,0,0,0,0,0,0,0,32000,0,0,0,363000,331000,32000,32000
053405,台達電兆豐96購01,0,0,0,0,0,0,0,0,0,32000,0,0,0,49000,17000,32000,32000
05600P,玉晶光台新96售04,0,0,0,0,0,0,0,0,0,32000,0,0,0,32000,0,32000,32000
05496P,聯詠統一95售04  ,0,0,0,0,0,0,0,0,0,32000,0,0,0,32000,0,32000,32000
06747P,大立光群益99售04,0,0,0,0,0,0,0,0,0,32000,0,0,0,35000,3000,32000,32000
06267P,大立光凱基97售12,0,0,0,0,0,0,0,0,0,32000,0,0,0,32000,0,32000,32000
06067P,華新科康和97售01,0,0,0,0,0,0,0,0,0,32000,0,0,0,212000,180000,32000,32000
2302,麗正            ,32000,0,32000,0,0,0,0,0,0,0,0,0,0,0,0,0,32000
2358,廷鑫            ,43000,10000,33000,0,0,0,0,0,0,-1000,0,1000,-1000,0,0,0,32000
6230,超眾            ,302000,286000,16000,0,0,0,57000,0,57000,-41000,3000,70000,-67000,46000,20000,26000,32000
2509,全坤建          ,32000,0,32000,0,0,0,0,0,0,0,0,0,0,0,0,0,32000
910322,康師傅-DR       ,32000,0,32000,0,0,0,0,0,0,0,0,0,0,0,0,0,32000
06008P,燿華統一96售04  ,0,0,0,0,0,0,0,0,0,31000,0,0,0,31000,0,31000,31000
058388,健策國票9A購01  ,0,0,0,0,0,0,0,0,0,31000,0,0,0,78000,47000,31000,31000
05825P,臺股指凱基96售22,0,0,0,0,0,0,0,0,0,31000,0,0,0,31000,0,31000,31000
057599,技嘉群益9A購01  ,0,0,0,0,0,0,0,0,0,31000,0,0,0,31000,0,31000,31000
05684P,臺股指元大96售09,0,0,0,0,0,0,0,0,0,31000,0,0,0,31000,0,31000,31000
04893P,創意元大94售03  ,0,0,0,0,0,0,0,0,0,31000,0,0,0,81000,50000,31000,31000
049155,同欣電元大94購01,0,0,0,0,0,0,0,0,0,31000,0,0,0,99000,68000,31000,31000
049700,瀚宇博元大97購01,0,0,0,0,0,0,0,0,0,31000,0,0,0,45000,14000,31000,31000
047993,鑽全元大96購01  ,0,0,0,0,0,0,0,0,0,31000,0,0,0,31000,0,31000,31000
03518P,臺股指國票02售07,0,0,0,0,0,0,0,0,0,31000,0,0,0,31000,0,31000,31000
051375,道瓊反群益9A購01,0,0,0,0,0,0,0,0,0,31000,0,0,0,31000,0,31000,31000
05083P,麗豐永豐95售02  ,0,0,0,0,0,0,0,0,0,31000,0,0,0,31000,0,31000,31000
050561,上証2X元富97購01,0,0,0,0,0,0,0,0,0,31000,0,0,0,41000,10000,31000,31000
051139,康友永豐95購01  ,0,0,0,0,0,0,0,0,0,31000,0,0,0,31000,0,31000,31000
051113,聯電元富95購01  ,0,0,0,0,0,0,0,0,0,31000,0,0,0,201000,170000,31000,31000
054058,晶豪科國票98購01,0,0,0,0,0,0,0,0,0,31000,0,0,0,41000,10000,31000,31000
05527P,聯茂群益96售01  ,0,0,0,0,0,0,0,0,0,31000,0,0,0,36000,5000,31000,31000
055217,緯創凱基97購02  ,0,0,0,0,0,0,0,0,0,31000,0,0,0,145000,114000,31000,31000
055478,訊芯凱基97購01  ,0,0,0,0,0,0,0,0,0,31000,0,0,0,31000,0,31000,31000
5525,順天            ,41000,10000,31000,0,0,0,0,0,0,0,0,0,0,0,0,0,31000
1338,廣華-KY         ,74000,40000,34000,0,0,0,0,0,0,-3000,0,3000,-3000,0,0,0,31000
06856P,台灣50永豐99售03,0,0,0,0,0,0,0,0,0,31000,0,0,0,31000,0,31000,31000
056840,友達元富98購02  ,0,0,0,0,0,0,0,0,0,30000,0,0,0,30000,0,30000,30000
056794,上銀麥證98購01  ,0,0,0,50000,20000,30000,0,0,0,30000,0,0,0,50000,20000,30000,30000
057027,祥碩凱基98購01  ,0,0,0,0,0,0,0,0,0,30000,0,0,0,95000,65000,30000,30000
056439,華邦電凱基98購02,0,0,0,0,0,0,0,0,0,30000,0,0,0,111000,81000,30000,30000
056508,揚明光永豐98購01,0,0,0,0,0,0,0,0,0,30000,0,0,0,45000,15000,30000,30000
056728,元油2X凱基9A購02,0,0,0,0,0,0,0,0,0,30000,0,0,0,80000,50000,30000,30000
057611,技嘉元富98購02  ,0,0,0,0,0,0,0,0,0,30000,0,0,0,40000,10000,30000,30000
057538,緯穎元大98購07  ,0,0,0,0,0,0,0,0,0,30000,0,0,0,50000,20000,30000,30000
05732P,臺股指統一96售02,0,0,0,0,0,0,0,0,0,30000,0,0,0,31000,1000,30000,30000
057123,上銀凱基98購05  ,0,0,0,0,0,0,0,0,0,30000,0,0,0,30000,0,30000,30000
058091,欣興元大99購03  ,0,0,0,0,0,0,0,0,0,30000,0,0,0,55000,25000,30000,30000
057971,華新科富邦9B購02,0,0,0,0,0,0,0,0,0,30000,0,0,0,30000,0,30000,30000
05783P,嘉澤元富96售01  ,0,0,0,0,0,0,0,0,0,30000,0,0,0,30000,0,30000,30000
057685,台灣50凱基9C購01,0,0,0,0,0,0,0,0,0,30000,0,0,0,30000,0,30000,30000
058434,旺宏統一9B購01  ,0,0,0,0,0,0,0,0,0,30000,0,0,0,43000,13000,30000,30000
058373,晶技凱基99購02  ,0,0,0,0,0,0,0,0,0,30000,0,0,0,73000,43000,30000,30000
06022P,緯穎永豐96售03  ,0,0,0,0,0,0,0,0,0,30000,0,0,0,40000,10000,30000,30000
03417B,臺股指凱基95熊19,0,0,0,0,0,0,0,0,0,30000,0,0,0,30000,0,30000,30000
041990,A50正2國票97購01,0,0,0,0,0,0,0,0,0,30000,0,0,0,30000,0,30000,30000
04200P,奇力新群益93售07,0,0,0,0,0,0,0,0,0,30000,0,0,0,30000,0,30000,30000
04615P,華新科群益94售03,0,0,0,0,0,0,0,0,0,30000,0,0,0,30000,0,30000,30000
03830P,緯創中信95售01  ,0,0,0,0,0,0,0,0,0,30000,0,0,0,30000,0,30000,30000
044049,元金2X元大94購03,0,0,0,0,0,0,0,0,0,30000,0,0,0,30000,0,30000,30000
04419P,奇力新永豐94售01,0,0,0,0,0,0,0,0,0,30000,0,0,0,30000,0,30000,30000
044282,上銀凱基93購03  ,0,0,0,0,0,0,0,0,0,30000,0,0,0,60000,30000,30000,30000
04665P,臺股指國票94售04,0,0,0,0,0,0,0,0,0,30000,0,0,0,100000,70000,30000,30000
04670P,臺股指國票94售09,0,0,0,0,0,0,0,0,0,30000,0,0,0,30000,0,30000,30000
04661P,臺股指富邦94售04,0,0,0,0,0,0,0,0,0,30000,0,0,0,30000,0,30000,30000
04510P,臺股指元大94售05,0,0,0,0,0,0,0,0,0,30000,0,0,0,30000,0,30000,30000
045446,鴻海國泰94購01  ,0,0,0,0,0,0,0,0,0,30000,0,0,0,30000,0,30000,30000
044526,訊芯凱基93購02  ,0,0,0,0,0,0,0,0,0,30000,0,0,0,30000,0,30000,30000
043912,華新科凱基93購01,0,0,0,0,0,0,0,0,0,30000,0,0,0,30000,0,30000,30000
047402,T50反1統一94購03,0,0,0,0,0,0,0,0,0,30000,0,0,0,30000,0,30000,30000
047405,香港2X統一96購01,0,0,0,0,0,0,0,0,0,30000,0,0,0,30000,0,30000,30000
04815P,致伸元大94售04  ,0,0,0,0,0,0,0,0,0,30000,0,0,0,30000,0,30000,30000
049579,鴻海元大94購06  ,0,0,0,0,0,0,0,0,0,30000,0,0,0,30000,0,30000,30000
048003,旭富元大93購01  ,0,0,0,0,0,0,0,0,0,30000,0,0,0,40000,10000,30000,30000
047782,燿華國泰95購01  ,0,0,0,0,0,0,0,0,0,30000,0,0,0,30000,0,30000,30000
047650,矽力元大93購01  ,0,0,0,0,0,0,0,0,0,30000,0,0,0,40000,10000,30000,30000
04849P,GIS中信94售01   ,0,0,0,0,0,0,0,0,0,30000,0,0,0,30000,0,30000,30000
047547,友達凱基99購02  ,0,0,0,0,0,0,0,0,0,30000,0,0,0,50000,20000,30000,30000
047625,友達國票94購01  ,0,0,0,0,0,0,0,0,0,30000,0,0,0,30000,0,30000,30000
049499,康控元大96購01  ,0,0,0,0,0,0,0,0,0,30000,0,0,0,30000,0,30000,30000
049874,全新康和94購01  ,0,0,0,0,0,0,0,0,0,30000,0,0,0,30000,0,30000,30000
050021,鴻海元大94購10  ,0,0,0,0,0,0,0,0,0,30000,0,0,0,30000,0,30000,30000
04879P,康控永豐94售02  ,0,0,0,0,0,0,0,0,0,30000,0,0,0,30000,0,30000,30000
049200,元黃金群益98購01,0,0,0,0,0,0,0,0,0,30000,0,0,0,30000,0,30000,30000
052697,滬深2X國票98購01,0,0,0,0,0,0,0,0,0,30000,0,0,0,30000,0,30000,30000
05266P,華新科元大95售11,0,0,0,0,0,0,0,0,0,30000,0,0,0,130000,100000,30000,30000
052775,滬深2X國票99購02,0,0,0,0,0,0,0,0,0,30000,0,0,0,30000,0,30000,30000
052855,群創日盛99購01  ,0,0,0,0,0,0,0,0,0,30000,0,0,0,30000,0,30000,30000
052907,嘉澤國票97購01  ,0,0,0,0,0,0,0,0,0,30000,0,0,0,30000,0,30000,30000
05257P,欣興凱基95售04  ,0,0,0,0,0,0,0,0,0,30000,0,0,0,76000,46000,30000,30000
052929,可成元大96購02  ,0,0,0,0,0,0,0,0,0,30000,0,0,0,30000,0,30000,30000
050308,矽創中信97購01  ,0,0,0,0,0,0,0,0,0,30000,0,0,0,60000,30000,30000,30000
050233,香港2X凱基96購01,0,0,0,0,0,0,0,0,0,30000,0,0,0,30000,0,30000,30000
053220,瀚宇博凱基98購01,0,0,0,0,0,0,0,0,0,30000,0,0,0,130000,100000,30000,30000
05056P,訊芯群益95售01  ,0,0,0,0,0,0,0,0,0,30000,0,0,0,30000,0,30000,30000
050524,宏達電元大95購04,0,0,0,0,0,0,0,0,0,30000,0,0,0,30000,0,30000,30000
052943,奇力新國票96購02,0,0,0,0,0,0,0,0,0,30000,0,0,0,30000,0,30000,30000
050766,燿華元大96購02  ,0,0,0,0,0,0,0,0,0,30000,0,0,0,60000,30000,30000,30000
051203,微星麥證95購01  ,0,0,0,30000,0,30000,0,0,0,30000,0,0,0,30000,0,30000,30000
050462,寶成元大94購01  ,0,0,0,0,0,0,0,0,0,30000,0,0,0,30000,0,30000,30000
052200,台光電統一95購02,0,0,0,0,0,0,0,0,0,30000,0,0,0,30000,0,30000,30000
050371,台積電元大94購25,0,0,0,0,0,0,0,0,0,30000,0,0,0,30000,0,30000,30000
05030P,台積電元富95售04,0,0,0,0,0,0,0,0,0,30000,0,0,0,59000,29000,30000,30000
051658,深中小國泰97購01,0,0,0,0,0,0,0,0,0,30000,0,0,0,30000,0,30000,30000
053724,聯詠凱基96購04  ,0,0,0,0,0,0,0,0,0,30000,0,0,0,128000,98000,30000,30000
055653,聯詠元富01購02  ,0,0,0,0,0,0,0,0,0,30000,0,0,0,60000,30000,30000,30000
055367,台積電元大97購23,0,0,0,0,0,0,0,0,0,30000,0,0,0,105000,75000,30000,30000
055402,正文元富97購02  ,0,0,0,0,0,0,0,0,0,30000,0,0,0,40000,10000,30000,30000
056049,奇力新國票98購01,0,0,0,0,0,0,0,0,0,30000,0,0,0,30000,0,30000,30000
056040,亞光凱基98購01  ,0,0,0,0,0,0,0,0,0,30000,0,0,0,50000,20000,30000,30000
055791,臺股指凱基97購14,0,0,0,0,0,0,0,0,0,30000,0,0,0,30000,0,30000,30000
055829,上銀元大97購06  ,0,0,0,0,0,0,0,0,0,30000,0,0,0,30000,0,30000,30000
05592P,可成群益96售03  ,0,0,0,0,0,0,0,0,0,30000,0,0,0,30000,0,30000,30000
05395P,旺宏元大96售06  ,0,0,0,0,0,0,0,0,0,30000,0,0,0,30000,0,30000,30000
053825,南電群益96購02  ,0,0,0,0,0,0,0,0,0,30000,0,0,0,57000,27000,30000,30000
054430,上銀台新96購02  ,0,0,0,0,0,0,0,0,0,30000,0,0,0,94000,64000,30000,30000
054174,宏達電台新97購01,0,0,0,0,0,0,0,0,0,30000,0,0,0,30000,0,30000,30000
054170,泰鼎凱基98購01  ,0,0,0,0,0,0,0,0,0,30000,0,0,0,52000,22000,30000,30000
054207,國巨國票98購01  ,0,0,0,0,0,0,0,0,0,30000,0,0,0,30000,0,30000,30000
054954,華新科元大97購06,0,0,0,0,0,0,0,0,0,30000,0,0,0,30000,0,30000,30000
054923,晶技凱基98購01  ,0,0,0,0,0,0,0,0,0,30000,0,0,0,60000,30000,30000,30000
055152,旺宏元大98購04  ,0,0,0,0,0,0,0,0,0,30000,0,0,0,140000,110000,30000,30000
054821,貿聯元大9A購01  ,0,0,0,0,0,0,0,0,0,30000,0,0,0,143000,113000,30000,30000
054762,奇力新國票99購01,0,0,0,0,0,0,0,0,0,30000,0,0,0,30000,0,30000,30000
05476P,聯發科群益95售06,0,0,0,0,0,0,0,0,0,30000,0,0,0,30000,0,30000,30000
1215,卜蜂            ,253000,206000,47000,0,0,0,0,0,0,-17000,0,0,0,0,17000,-17000,30000
06115P,台積電統一97售04,0,0,0,0,0,0,0,0,0,30000,0,0,0,30000,0,30000,30000
06341P,大立光統一97售08,0,0,0,0,0,0,0,0,0,30000,0,0,0,30000,0,30000,30000
06385P,聯發科永豐97售02,0,0,0,0,0,0,0,0,0,30000,0,0,0,30000,0,30000,30000
06706P,智原台新98售02  ,0,0,0,0,0,0,0,0,0,30000,0,0,0,30000,0,30000,30000
06474P,鴻海富邦98售03  ,0,0,0,0,0,0,0,0,0,30000,0,0,0,132000,102000,30000,30000
3027,盛達            ,32000,3000,29000,0,0,0,0,0,0,1000,3000,2000,1000,0,0,0,30000
6128,上福            ,32616,3000,29616,0,0,0,0,0,0,0,0,0,0,0,0,0,29616
058158,台積電台新99購01,0,0,0,0,0,0,0,0,0,29000,0,0,0,268000,239000,29000,29000
057118,欣興日盛9A購01  ,0,0,0,0,0,0,0,0,0,29000,0,0,0,47000,18000,29000,29000
047656,聯詠兆豐93購02  ,0,0,0,0,0,0,0,0,0,29000,0,0,0,60000,31000,29000,29000
04764P,台光電台新94售01,0,0,0,0,0,0,0,0,0,29000,0,0,0,49000,20000,29000,29000
03874P,臺股指群益95售01,0,0,0,0,0,0,0,0,0,29000,0,0,0,29000,0,29000,29000
04165P,南亞科元富95售03,0,0,0,0,0,0,0,0,0,29000,0,0,0,35000,6000,29000,29000
05349P,可成元富98售03  ,0,0,0,0,0,0,0,0,0,29000,0,0,0,29000,0,29000,29000
052239,泰鼎國票97購01  ,0,0,0,0,0,0,0,0,0,29000,0,0,0,39000,10000,29000,29000
05228P,大立光元富95售09,0,0,0,0,0,0,0,0,0,29000,0,0,0,29000,0,29000,29000
051703,台積電群益95購04,0,0,0,0,0,0,0,0,0,29000,0,0,0,340000,311000,29000,29000
050117,麗豐元大96購02  ,0,0,0,0,0,0,0,0,0,29000,0,0,0,29000,0,29000,29000
051927,國巨中信96購01  ,0,0,0,0,0,0,0,0,0,29000,0,0,0,91000,62000,29000,29000
054253,宏達電元大97購03,0,0,0,0,0,0,0,0,0,29000,0,0,0,212000,183000,29000,29000
054460,和大凱基97購01  ,0,0,0,0,0,0,0,0,0,29000,0,0,0,39000,10000,29000,29000
053861,台光電元大98購01,0,0,0,0,0,0,0,0,0,29000,0,0,0,122000,93000,29000,29000
055801,景碩永豐97購02  ,0,0,0,0,0,0,0,0,0,29000,0,0,0,33000,4000,29000,29000
055881,康控元富97購01  ,0,0,0,0,0,0,0,0,0,29000,0,0,0,451000,422000,29000,29000
055703,緯穎富邦98購01  ,0,0,0,0,0,0,0,0,0,29000,0,0,0,84000,55000,29000,29000
5234,達興材料        ,115000,88000,27000,0,0,0,0,0,0,2000,3000,1000,2000,0,0,0,29000
8497,格威傳媒        ,31000,2000,29000,0,0,0,0,0,0,0,0,0,0,0,0,0,29000
8499,鼎炫-KY         ,82000,23000,59000,0,0,0,0,0,0,-30000,0,30000,-30000,0,0,0,29000
2460,建通            ,30000,0,30000,0,0,0,0,0,0,-1000,13000,14000,-1000,0,0,0,29000
2748,雲品            ,36000,7000,29000,0,0,0,0,0,0,0,0,0,0,0,0,0,29000
2855,統一證          ,712000,694000,18000,0,0,0,11000,0,11000,0,0,0,0,0,0,0,29000
06698P,玉晶光國票99售05,0,0,0,0,0,0,0,0,0,29000,0,0,0,49000,20000,29000,29000
06673P,大立光群益98售01,0,0,0,0,0,0,0,0,0,29000,0,0,0,29000,0,29000,29000
06083P,華通統一98售02  ,0,0,0,0,0,0,0,0,0,29000,0,0,0,39000,10000,29000,29000
06994P,台光電凱基99售02,0,0,0,0,0,0,0,0,0,29000,0,0,0,49000,20000,29000,29000
06801P,技嘉群益99售02  ,0,0,0,0,0,0,0,0,0,29000,0,0,0,29000,0,29000,29000
06823P,台灣50永豐98售02,0,0,0,0,0,0,0,0,0,29000,0,0,0,29000,0,29000,29000
1474,弘裕            ,30000,3000,27000,0,0,0,0,0,0,2000,2000,0,2000,0,0,0,29000
2062,橋椿            ,55000,25000,30000,0,0,0,0,0,0,-1000,0,1000,-1000,0,0,0,29000
1903,士紙            ,27000,0,27000,0,0,0,0,0,0,2000,2000,0,2000,0,0,0,29000
057545,國巨凱基99購05  ,0,0,0,0,0,0,0,0,0,28000,0,0,0,31000,3000,28000,28000
056714,晶相光永豐98購02,0,0,0,0,0,0,0,0,0,28000,0,0,0,209000,181000,28000,28000
058259,訊連國泰9B購01  ,0,0,0,0,0,0,0,0,0,28000,0,0,0,40000,12000,28000,28000
05976P,國巨凱基96售14  ,0,0,0,0,0,0,0,0,0,28000,0,0,0,28000,0,28000,28000
05851P,力山群益97售01  ,0,0,0,0,0,0,0,0,0,28000,0,0,0,28000,0,28000,28000
042556,台灣50中信96購04,0,0,0,0,0,0,0,0,0,28000,0,0,0,65000,37000,28000,28000
04618P,電子類群益94售02,0,0,0,0,0,0,0,0,0,28000,0,0,0,62000,34000,28000,28000
048054,鴻海國泰95購01  ,0,0,0,0,0,0,0,0,0,28000,0,0,0,128000,100000,28000,28000
052843,鴻海統一96購09  ,0,0,0,0,0,0,0,0,0,28000,0,0,0,48000,20000,28000,28000
04857P,美律元富94售01  ,0,0,0,0,0,0,0,0,0,28000,0,0,0,28000,0,28000,28000
049046,同欣電兆豐94購01,0,0,0,0,0,0,0,0,0,28000,0,0,0,28000,0,28000,28000
05296P,牧德凱基96售01  ,0,0,0,0,0,0,0,0,0,28000,0,0,0,33000,5000,28000,28000
052241,台郡國票96購01  ,0,0,0,0,0,0,0,0,0,28000,0,0,0,38000,10000,28000,28000
052446,聯發科元大96購03,0,0,0,0,0,0,0,0,0,28000,0,0,0,50000,22000,28000,28000
055575,華新科統一98購01,0,0,0,0,0,0,0,0,0,28000,0,0,0,46000,18000,28000,28000
055336,茂林兆豐98購01  ,0,0,0,0,0,0,0,0,0,28000,0,0,0,101000,73000,28000,28000
056327,樺漢兆豐98購01  ,0,0,0,0,0,0,0,0,0,28000,0,0,0,45000,17000,28000,28000
05409P,京元電元富95售05,0,0,0,0,0,0,0,0,0,28000,0,0,0,38000,10000,28000,28000
054775,復盛國票98購01  ,0,0,0,0,0,0,0,0,0,28000,0,0,0,145000,117000,28000,28000
05465P,台表科永豐95售03,0,0,0,0,0,0,0,0,0,28000,0,0,0,30000,2000,28000,28000
054607,台積電永豐97購03,0,0,0,0,0,0,0,0,0,28000,0,0,0,108000,80000,28000,28000
06566P,華通永豐98售03  ,0,0,0,0,0,0,0,0,0,28000,0,0,0,43000,15000,28000,28000
06582P,可成凱基98售06  ,0,0,0,0,0,0,0,0,0,28000,0,0,0,231000,203000,28000,28000
2850,新產            ,197000,169000,28000,0,0,0,0,0,0,0,0,0,0,0,0,0,28000
2881A,富邦特          ,0,25000,-25000,0,0,0,0,0,0,53000,83000,30000,53000,0,0,0,28000
4912,聯德控股-KY     ,32000,6000,26000,0,0,0,0,0,0,2000,3000,1000,2000,0,0,0,28000
4566,時碩工業        ,58000,30000,28000,0,0,0,0,0,0,0,0,0,0,0,0,0,28000
058449,台積電永豐99購01,0,0,0,0,0,0,0,0,0,27000,0,0,0,27000,0,27000,27000
058290,南電國票9A購01  ,20000,0,20000,0,0,0,0,0,0,7000,0,0,0,50000,43000,7000,27000
057811,南亞科元大98購08,0,0,0,0,0,0,0,0,0,27000,0,0,0,37000,10000,27000,27000
057462,光磊永豐98購02  ,0,0,0,0,0,0,0,0,0,27000,0,0,0,27000,0,27000,27000
050005,京鼎永豐94購01  ,0,0,0,0,0,0,0,0,0,27000,0,0,0,37000,10000,27000,27000
049738,神基群益94購01  ,0,0,0,0,0,0,0,0,0,27000,0,0,0,100000,73000,27000,27000
053431,志超永豐96購01  ,0,0,0,0,0,0,0,0,0,27000,0,0,0,27000,0,27000,27000
051623,和碩凱基96購02  ,0,0,0,0,0,0,0,0,0,27000,0,0,0,198000,171000,27000,27000
051017,聯發科凱基95購04,0,0,0,0,0,0,0,0,0,27000,0,0,0,27000,0,27000,27000
053146,滬深2X元大96購08,0,0,0,0,0,0,0,0,0,27000,0,0,0,27000,0,27000,27000
052581,訊芯元富98購01  ,0,0,0,0,0,0,0,0,0,27000,0,0,0,57000,30000,27000,27000
051207,聯茂麥證95購01  ,0,0,0,76000,49000,27000,0,0,0,27000,0,0,0,76000,49000,27000,27000
051479,兆豐金凱基95購01,0,0,0,0,0,0,0,0,0,27000,0,0,0,76000,49000,27000,27000
054103,T50反1凱基99購04,0,0,0,0,0,0,0,0,0,27000,0,0,0,30000,3000,27000,27000
053900,T50反1日盛99購01,0,0,0,0,0,0,0,0,0,27000,0,0,0,1400000,1373000,27000,27000
056170,鴻海元富97購09  ,0,0,0,0,0,0,0,0,0,27000,0,0,0,46000,19000,27000,27000
055387,世紀鋼元大97購01,0,0,0,0,0,0,0,0,0,27000,0,0,0,60000,33000,27000,27000
3032,偉訓            ,48000,21000,27000,0,0,0,0,0,0,0,0,0,0,0,0,0,27000
3021,鴻名            ,24000,3000,21000,0,0,0,0,0,0,6000,7000,1000,6000,0,0,0,27000
3013,晟銘電          ,52000,27000,25000,0,0,0,0,0,0,2000,5000,3000,2000,0,0,0,27000
2506,太設            ,28000,0,28000,0,0,0,0,0,0,-1000,0,1000,-1000,0,0,0,27000
9930,中聯資源        ,63000,36000,27000,0,0,0,0,0,0,0,0,0,0,0,0,0,27000
06558P,旺宏元富98售02  ,0,0,0,0,0,0,0,0,0,27000,0,0,0,32000,5000,27000,27000
06618P,智邦元大98售04  ,0,0,0,0,0,0,0,0,0,27000,0,0,0,134000,107000,27000,27000
06071P,大立光永豐97售01,0,0,0,0,0,0,0,0,0,27000,0,0,0,27000,0,27000,27000
06151P,華新科元大97售07,0,0,0,0,0,0,0,0,0,27000,0,0,0,303000,276000,27000,27000
2069,運錩            ,27000,0,27000,0,0,0,0,0,0,0,0,0,0,0,0,0,27000
2228,劍麟            ,186000,159000,27000,0,0,0,0,0,0,0,0,0,0,0,0,0,27000
1506,正道            ,27000,0,27000,0,0,0,0,0,0,0,1000,1000,0,0,0,0,27000
1524,耿鼎            ,28000,1000,27000,0,0,0,0,0,0,0,0,0,0,0,0,0,27000
1533,車王電          ,33000,6000,27000,0,0,0,0,0,0,0,0,0,0,0,0,0,27000
057543,華通凱基99購02  ,0,0,0,0,0,0,0,0,0,26000,0,0,0,102000,76000,26000,26000
057353,玉晶光統一99購01,0,0,0,0,0,0,0,0,0,26000,0,0,0,75000,49000,26000,26000
056772,欣興元大99購01  ,0,0,0,0,0,0,0,0,0,26000,0,0,0,151000,125000,26000,26000
06010P,國泰金元富96售01,0,0,0,0,0,0,0,0,0,26000,0,0,0,79000,53000,26000,26000
06060P,玉晶光元大97售03,0,0,0,0,0,0,0,0,0,26000,0,0,0,190000,164000,26000,26000
05873P,華通群益97售02  ,0,0,0,0,0,0,0,0,0,26000,0,0,0,41000,15000,26000,26000
049484,台積電元大95購02,0,0,0,0,0,0,0,0,0,26000,0,0,0,551000,525000,26000,26000
048804,和碩富邦94購01  ,0,0,0,0,0,0,0,0,0,26000,0,0,0,26000,0,26000,26000
048757,美利達元富96購01,0,0,0,0,0,0,0,0,0,26000,0,0,0,40000,14000,26000,26000
05281P,南亞科元大95售03,0,0,0,0,0,0,0,0,0,26000,0,0,0,31000,5000,26000,26000
03025P,國巨元大01售12  ,0,0,0,0,0,0,0,0,0,26000,0,0,0,26000,0,26000,26000
00680L,元大美債20正2   ,0,0,0,0,0,0,0,0,0,26000,0,0,0,1045000,1019000,26000,26000
04461P,燿華元富94售01  ,0,0,0,0,0,0,0,0,0,26000,0,0,0,26000,0,26000,26000
050990,T50反1元大95購01,0,0,0,0,0,0,0,0,0,26000,0,0,0,26000,0,26000,26000
051564,和碩國泰96購01  ,0,0,0,0,0,0,0,0,0,26000,0,0,0,133000,107000,26000,26000
051299,致茂凱基95購01  ,0,0,0,0,0,0,0,0,0,26000,0,0,0,26000,0,26000,26000
05341P,臺股指兆豐95售02,0,0,0,0,0,0,0,0,0,26000,0,0,0,26000,0,26000,26000
053424,欣興永豐96購02  ,0,0,0,0,0,0,0,0,0,26000,0,0,0,110000,84000,26000,26000
05630P,大立光永昌96售06,0,0,0,0,0,0,0,0,0,26000,0,0,0,347000,321000,26000,26000
054385,矽創群益98購01  ,0,0,0,0,0,0,0,0,0,26000,0,0,0,142000,116000,26000,26000
05472P,國巨統一96售02  ,0,0,0,0,0,0,0,0,0,26000,0,0,0,60000,34000,26000,26000
1454,台富            ,27000,1000,26000,0,0,0,0,0,0,0,0,0,0,0,0,0,26000
06800P,台灣50群益9A售02,0,0,0,0,0,0,0,0,0,26000,0,0,0,230000,204000,26000,26000
1203,味王            ,33000,8000,25000,0,0,0,0,0,0,1000,1000,0,1000,0,0,0,26000
3376,新日興          ,957000,212000,745000,0,0,0,0,40000,-40000,-679000,37000,763000,-726000,59000,12000,47000,26000
4576,大銀微系統      ,27000,1000,26000,0,0,0,0,0,0,0,0,0,0,0,0,0,26000
6281,全國電          ,27000,1000,26000,0,0,0,0,0,0,0,0,0,0,0,0,0,26000
058409,鴻海兆豐99購05  ,0,0,0,0,0,0,0,0,0,25000,0,0,0,61000,36000,25000,25000
056726,友達日盛9A購01  ,0,0,0,0,0,0,0,0,0,25000,0,0,0,25000,0,25000,25000
056457,嘉澤凱基98購01  ,0,0,0,0,0,0,0,0,0,25000,0,0,0,46000,21000,25000,25000
056459,茂林凱基99購01  ,0,0,0,0,0,0,0,0,0,25000,0,0,0,25000,0,25000,25000
057335,技嘉國票99購01  ,0,0,0,0,0,0,0,0,0,25000,0,0,0,46000,21000,25000,25000
057368,微星元大98購02  ,0,0,0,0,0,0,0,0,0,25000,0,0,0,105000,80000,25000,25000
046981,智伸科兆豐94購01,0,0,0,0,0,0,0,0,0,25000,0,0,0,25000,0,25000,25000
049261,大立光元大94購08,0,0,0,0,0,0,0,0,0,25000,0,0,0,25000,0,25000,25000
049292,鴻海群益94購04  ,0,0,0,0,0,0,0,0,0,25000,0,0,0,45000,20000,25000,25000
03267P,台灣50元大02售06,0,0,0,0,0,0,0,0,0,25000,0,0,0,65000,40000,25000,25000
04639P,臺股指群益94售14,0,0,0,0,0,0,0,0,0,25000,10000,0,10000,15000,0,15000,25000
04408P,台積電統一94售06,0,0,0,0,0,0,0,0,0,25000,0,0,0,30000,5000,25000,25000
05286P,矽力統一95售02  ,0,0,0,0,0,0,0,0,0,25000,0,0,0,30000,5000,25000,25000
04881P,高股息凱基96售01,0,0,0,0,0,0,0,0,0,25000,0,0,0,25000,0,25000,25000
047994,亞德客元大93購03,0,0,0,0,0,0,0,0,0,25000,0,0,0,50000,25000,25000,25000
048000,義隆元大93購03  ,0,0,0,0,0,0,0,0,0,25000,0,0,0,45000,20000,25000,25000
04792P,智邦元大94售06  ,0,0,0,0,0,0,0,0,0,25000,0,0,0,50000,25000,25000,25000
047748,漢唐元富93購02  ,0,0,0,0,0,0,0,0,0,25000,0,0,0,25000,0,25000,25000
049889,欣興國泰96購01  ,0,0,0,0,0,0,0,0,0,25000,0,0,0,35000,10000,25000,25000
048286,滬深2X兆豐94購04,0,0,0,0,0,0,0,0,0,25000,0,0,0,87000,62000,25000,25000
049386,嘉聯益元大95購01,0,0,0,0,0,0,0,0,0,25000,0,0,0,30000,5000,25000,25000
05366P,鴻海元富95售12  ,0,0,0,0,0,0,0,0,0,25000,0,0,0,75000,50000,25000,25000
052463,聯電統一96購01  ,0,0,0,0,0,0,0,0,0,25000,0,0,0,48000,23000,25000,25000
052197,台郡元富95購03  ,0,0,0,0,0,0,0,0,0,25000,0,0,0,25000,0,25000,25000
051667,光磊元大96購02  ,0,0,0,0,0,0,0,0,0,25000,0,0,0,93000,68000,25000,25000
051886,道瓊反統一95購03,0,0,0,0,0,0,0,0,0,25000,0,0,0,25000,0,25000,25000
05189P,新光金凱基97售02,0,0,0,0,0,0,0,0,0,25000,0,0,0,25000,0,25000,25000
05088P,大立光富邦99售01,0,0,0,0,0,0,0,0,0,25000,0,0,0,30000,5000,25000,25000
050841,國巨國票96購02  ,0,0,0,0,0,0,0,0,0,25000,0,0,0,165000,140000,25000,25000
05080P,亞光永豐95售02  ,0,0,0,0,0,0,0,0,0,25000,0,0,0,25000,0,25000,25000
054815,台積電元大97購14,0,0,0,0,0,0,0,0,0,25000,0,0,0,25000,0,25000,25000
054226,燿華元富96購02  ,0,0,0,0,0,0,0,0,0,25000,0,0,0,25000,0,25000,25000
05415P,台積電台新95售04,0,0,0,0,0,0,0,0,0,25000,0,0,0,25000,0,25000,25000
054166,日電貿凱基98購01,0,0,0,0,0,0,0,0,0,25000,0,0,0,65000,40000,25000,25000
05386P,臺股指永豐95售05,0,0,0,0,0,0,0,0,0,25000,0,0,0,25000,0,25000,25000
053940,康友元富96購01  ,0,0,0,0,0,0,0,0,0,25000,0,0,0,108000,83000,25000,25000
055431,和鑫群益98購01  ,0,0,0,0,0,0,0,0,0,25000,0,0,0,50000,25000,25000,25000
055551,致茂凱基98購01  ,0,0,0,0,0,0,0,0,0,25000,0,0,0,26000,1000,25000,25000
3591,艾笛森          ,31000,7000,24000,0,0,0,0,0,0,1000,1000,0,1000,0,0,0,25000
5007,三星            ,42000,16000,26000,0,0,0,0,0,0,-1000,0,1000,-1000,0,0,0,25000
3015,全漢            ,47000,22000,25000,0,0,0,0,0,0,0,0,0,0,0,0,0,25000
2908,特力            ,79000,54000,25000,0,0,0,0,0,0,0,0,0,0,0,0,0,25000
9927,泰銘            ,38000,14000,24000,0,0,0,0,0,0,1000,1000,0,1000,0,0,0,25000
2028,威致            ,28000,0,28000,0,0,0,0,0,0,-3000,0,3000,-3000,0,0,0,25000
06089P,矽創永豐97售01  ,0,0,0,0,0,0,0,0,0,25000,0,0,0,35000,10000,25000,25000
06353P,電子類富邦99售02,0,0,0,0,0,0,0,0,0,25000,0,0,0,25000,0,25000,25000
06646P,國巨元大98售16  ,0,0,0,0,0,0,0,0,0,25000,0,0,0,113000,88000,25000,25000
06657P,寶成元大98售01  ,0,0,0,0,0,0,0,0,0,25000,0,0,0,25000,0,25000,25000
06604P,聯發科元富02售02,0,0,0,0,0,0,0,0,0,25000,0,0,0,45000,20000,25000,25000
8454,富邦媒          ,142000,121756,20244,0,0,0,0,0,0,4000,6000,2000,4000,0,0,0,24244
057504,技嘉麥證98購01  ,0,0,0,24000,0,24000,0,0,0,24000,0,0,0,24000,0,24000,24000
057610,致茂元富98購02  ,0,0,0,0,0,0,0,0,0,24000,0,0,0,44000,20000,24000,24000
057205,元翎元富98購01  ,0,0,0,0,0,0,0,0,0,24000,0,0,0,125000,101000,24000,24000
057063,立積國泰9A購01  ,0,0,0,0,0,0,0,0,0,24000,0,0,0,342000,318000,24000,24000
056846,晶相光元富98購01,0,0,0,0,0,0,0,0,0,24000,0,0,0,42000,18000,24000,24000
05877P,大立光群益96售06,0,0,0,0,0,0,0,0,0,24000,0,0,0,29000,5000,24000,24000
057706,臺股指群益98購06,0,0,0,0,0,0,0,0,0,24000,0,0,0,24000,0,24000,24000
057946,晶相光國票99購01,0,0,0,0,0,0,0,0,0,24000,0,0,0,24000,0,24000,24000
04812P,國巨元大95售03  ,0,0,0,0,0,0,0,0,0,24000,0,0,0,24000,0,24000,24000
00691R,兆豐藍籌30反1   ,0,0,0,0,0,0,0,0,0,24000,0,0,0,25000,1000,24000,24000
053152,大立光元大99購01,0,0,0,0,0,0,0,0,0,24000,0,0,0,244000,220000,24000,24000
055422,康控永豐97購01  ,0,0,0,0,0,0,0,0,0,24000,0,0,0,124000,100000,24000,24000
055889,鴻海統一97購05  ,0,0,0,0,0,0,0,0,0,24000,0,0,0,44000,20000,24000,24000
05442P,鴻海元大96售13  ,0,0,0,0,0,0,0,0,0,24000,0,0,0,195000,171000,24000,24000
054890,聯鈞統一99購01  ,0,0,0,0,0,0,0,0,0,24000,0,0,0,34000,10000,24000,24000
6666,羅麗芬-KY       ,28000,4000,24000,0,0,0,0,0,0,0,0,0,0,0,0,0,24000
8104,錸寶            ,71000,47000,24000,0,0,0,0,0,0,0,0,0,0,0,0,0,24000
6184,大豐電          ,30000,6000,24000,0,0,0,0,0,0,0,0,0,0,0,0,0,24000
5388,中磊            ,404000,370000,34000,0,0,0,3000,41000,-38000,28000,4000,1000,3000,27000,2000,25000,24000
4108,懷特            ,59000,35000,24000,0,0,0,0,0,0,0,0,0,0,0,0,0,24000
3058,立德            ,30000,6000,24000,0,0,0,0,0,0,0,0,0,0,0,0,0,24000
2483,百容            ,24000,0,24000,0,0,0,0,0,0,0,0,0,0,0,0,0,24000
2450,神腦            ,44000,21000,23000,0,0,0,0,0,0,1000,2000,1000,1000,0,0,0,24000
06595P,祥碩元大98售03  ,0,0,0,0,0,0,0,0,0,24000,0,0,0,133000,109000,24000,24000
06655P,TPK元大98售02   ,0,0,0,0,0,0,0,0,0,24000,0,0,0,24000,0,24000,24000
06662P,玉晶光中信9A售01,0,0,0,0,0,0,0,0,0,24000,0,0,0,24000,0,24000,24000
06393P,台積電元大97售27,0,0,0,0,0,0,0,0,0,24000,0,0,0,85000,61000,24000,24000
06139P,台積電中信99售02,0,0,0,0,0,0,0,0,0,24000,0,0,0,57000,33000,24000,24000
2239,英利-KY         ,37000,12000,25000,0,0,0,0,0,0,-1000,0,1000,-1000,0,0,0,24000
2038,海光            ,30000,6000,24000,0,0,0,0,0,0,0,0,0,0,0,0,0,24000
1517,利奇            ,24000,0,24000,0,0,0,0,0,0,0,0,0,0,0,0,0,24000
1727,中華化          ,24000,1000,23000,0,0,0,0,0,0,1000,1000,0,1000,0,0,0,24000
06791P,聯發科凱基98售16,0,0,0,0,0,0,0,0,0,24000,0,0,0,42000,18000,24000,24000
06848P,聯詠元大98售04  ,0,0,0,0,0,0,0,0,0,24000,0,0,0,30000,6000,24000,24000
05961P,鴻海群益97售01  ,0,0,0,0,0,0,0,0,0,23000,0,0,0,23000,0,23000,23000
05963P,貿聯國票97售02  ,0,0,0,0,0,0,0,0,0,23000,0,0,0,53000,30000,23000,23000
05945P,聯詠中信96售01  ,0,0,0,0,0,0,0,0,0,23000,0,0,0,54000,31000,23000,23000
04954P,健策國票96售01  ,0,0,0,0,0,0,0,0,0,23000,0,0,0,23000,0,23000,23000
047417,台塑富邦97購01  ,0,0,0,0,0,0,0,0,0,23000,0,0,0,100000,77000,23000,23000
050616,潤泰全元大94購01,0,0,0,0,0,0,0,0,0,23000,0,0,0,68000,45000,23000,23000
051406,泰鼎永豐96購01  ,0,0,0,0,0,0,0,0,0,23000,0,0,0,33000,10000,23000,23000
052149,電子類群益95購01,0,0,0,0,0,0,0,0,0,23000,0,0,0,23000,0,23000,23000
053619,和碩群益96購01  ,0,0,0,0,0,0,0,0,0,23000,0,0,0,23000,0,23000,23000
053351,A50正2兆豐97購01,0,0,0,0,0,0,0,0,0,23000,0,0,0,46000,23000,23000,23000
054759,台化國票98購01  ,0,0,0,0,0,0,0,0,0,23000,0,0,0,66000,43000,23000,23000
05463P,創意國票96售04  ,0,0,0,0,0,0,0,0,0,23000,0,0,0,63000,40000,23000,23000
056070,新日興元大97購04,0,0,0,0,0,0,0,0,0,23000,0,0,0,73000,50000,23000,23000
056179,康友元富97購02  ,0,0,0,0,0,0,0,0,0,23000,0,0,0,118000,95000,23000,23000
055392,凱美統一97購03  ,0,0,0,0,0,0,0,0,0,23000,0,0,0,28000,5000,23000,23000
055667,致茂群益98購01  ,0,0,0,0,0,0,0,0,0,23000,0,0,0,24000,1000,23000,23000
06920P,台灣50凱基9A售01,0,0,0,0,0,0,0,0,0,23000,0,0,0,673000,650000,23000,23000
1467,南緯            ,23000,0,23000,0,0,0,0,0,0,0,0,0,0,0,0,0,23000
2373,震旦行          ,22000,4000,18000,0,0,0,0,0,0,5000,6000,1000,5000,0,0,0,23000
06147P,國巨元大97售05  ,0,0,0,0,0,0,0,0,0,23000,0,0,0,248000,225000,23000,23000
06182P,群創兆豐97售03  ,0,0,0,0,0,0,0,0,0,23000,0,0,0,50000,27000,23000,23000
06246P,茂林元富97售03  ,0,0,0,0,0,0,0,0,0,23000,0,0,0,382000,359000,23000,23000
06599P,宏達電永豐98售02,0,0,0,0,0,0,0,0,0,23000,0,0,0,27000,4000,23000,23000
2939,凱羿-KY         ,25000,2000,23000,0,0,0,0,0,0,0,0,0,0,0,0,0,23000
6672,騰輝電子-KY     ,153000,91000,62000,0,0,0,0,0,0,-39000,4000,43000,-39000,0,0,0,23000
05888P,友達元大97售01  ,0,0,0,0,0,0,0,0,0,22000,0,0,0,67000,45000,22000,22000
056970,TPK永豐98購01   ,0,0,0,0,0,0,0,0,0,22000,0,0,0,41000,19000,22000,22000
057597,華通群益9A購02  ,0,0,0,0,0,0,0,0,0,22000,0,0,0,22000,0,22000,22000
04363P,儒鴻元富94售01  ,0,0,0,0,0,0,0,0,0,22000,0,0,0,22000,0,22000,22000
04386P,大立光日盛94售01,0,0,0,0,0,0,0,0,0,22000,0,0,0,40000,18000,22000,22000
046937,聯電元大99購01  ,0,0,0,0,0,0,0,0,0,22000,0,0,0,105000,83000,22000,22000
00656R,國泰中國A50反1  ,0,11000,-11000,0,0,0,0,0,0,33000,0,0,0,1145000,1112000,33000,22000
049947,S&P反1中信97購01,0,0,0,0,0,0,0,0,0,22000,0,0,0,82000,60000,22000,22000
053485,矽創國票97購04  ,0,0,0,0,0,0,0,0,0,22000,0,0,0,22000,0,22000,22000
052294,創意國票96購03  ,0,0,0,0,0,0,0,0,0,22000,0,0,0,38000,16000,22000,22000
05136P,台積電凱基95售08,0,0,0,0,0,0,0,0,0,22000,0,0,0,732000,710000,22000,22000
051665,台積電元大96購07,0,0,0,0,0,0,0,0,0,22000,0,0,0,32000,10000,22000,22000
05025P,聯發科群益95售02,0,0,0,0,0,0,0,0,0,22000,0,0,0,22000,0,22000,22000
051112,台郡統一95購01  ,0,0,0,0,0,0,0,0,0,22000,0,0,0,32000,10000,22000,22000
05078P,義隆永豐95售01  ,0,0,0,0,0,0,0,0,0,22000,0,0,0,22000,0,22000,22000
051940,康舒群益95購01  ,0,0,0,0,0,0,0,0,0,22000,0,0,0,22000,0,22000,22000
051846,S&P反1中信96購02,0,0,0,0,0,0,0,0,0,22000,0,0,0,53000,31000,22000,22000
05259P,臺股指凱基96售12,0,0,0,0,0,0,0,0,0,22000,0,0,0,27000,5000,22000,22000
05557P,S&P500中信96售02,0,0,0,0,0,0,0,0,0,22000,0,0,0,42000,20000,22000,22000
056359,旺宏元大9A購01  ,0,0,0,0,0,0,0,0,0,22000,0,0,0,204000,182000,22000,22000
05582P,群創凱基98售06  ,0,0,0,0,0,0,0,0,0,22000,0,0,0,50000,28000,22000,22000
054810,中橡元大9A購01  ,0,0,0,0,0,0,0,0,0,22000,0,0,0,72000,50000,22000,22000
055053,瑞昱永豐97購01  ,0,0,0,0,0,0,0,0,0,22000,0,0,0,22000,0,22000,22000
05439P,聯發科國票95售06,0,0,0,0,0,0,0,0,0,22000,0,0,0,22000,0,22000,22000
054299,南電元大96購03  ,0,0,0,0,0,0,0,0,0,22000,0,0,0,51000,29000,22000,22000
6164,華興            ,22000,0,22000,0,0,0,0,0,0,0,0,0,0,0,0,0,22000
4438,廣越            ,46000,23000,23000,0,0,0,0,0,0,-1000,0,1000,-1000,0,0,0,22000
5515,建國            ,23000,0,23000,0,0,0,0,0,0,-1000,0,1000,-1000,0,0,0,22000
6024,群益期          ,125000,103000,22000,0,0,0,0,0,0,0,0,0,0,0,0,0,22000
3164,景岳            ,29000,8000,21000,0,0,0,0,0,0,1000,1000,0,1000,0,0,0,22000
2701,萬企            ,22000,0,22000,0,0,0,0,0,0,0,0,0,0,0,0,0,22000
2528,皇普            ,36000,14000,22000,0,0,0,0,0,0,0,2000,2000,0,0,0,0,22000
06467P,旺宏統一98售01  ,0,0,0,0,0,0,0,0,0,22000,0,0,0,39000,17000,22000,22000
06728P,全新元大98售03  ,0,0,0,0,0,0,0,0,0,22000,0,0,0,22000,0,22000,22000
06372P,聯發科元大97售21,0,0,0,0,0,0,0,0,0,22000,0,0,0,35000,13000,22000,22000
057153,祥碩國泰99購01  ,0,0,0,0,0,0,0,0,0,21000,0,0,0,21000,0,21000,21000
05686P,臺股指元大96售11,0,0,0,0,0,0,0,0,0,21000,0,0,0,31000,10000,21000,21000
056612,台積電永豐98購01,0,0,0,0,0,0,0,0,0,21000,0,0,0,33000,12000,21000,21000
05890P,彩晶元大99售01  ,0,0,0,0,0,0,0,0,0,21000,0,0,0,21000,0,21000,21000
05881P,彩晶康和96售01  ,0,0,0,0,0,0,0,0,0,21000,0,0,0,21000,0,21000,21000
06001P,樺漢台新96售01  ,0,0,0,0,0,0,0,0,0,21000,0,0,0,46000,25000,21000,21000
05848P,臺股指元大96售24,0,0,0,0,0,0,0,0,0,21000,0,0,0,21000,0,21000,21000
058142,瑞儀元大99購01  ,0,0,0,0,0,0,0,0,0,21000,0,0,0,21000,0,21000,21000
058180,華新科國泰9A購01,0,0,0,0,0,0,0,0,0,21000,0,0,0,21000,0,21000,21000
058085,景碩群益9A購01  ,0,0,0,0,0,0,0,0,0,21000,0,0,0,21000,0,21000,21000
049811,聯鈞元大94購01  ,0,0,0,0,0,0,0,0,0,21000,0,0,0,39000,18000,21000,21000
047741,鴻海統一93購06  ,0,0,0,0,0,0,0,0,0,21000,0,0,0,21000,0,21000,21000
048657,大成鋼統一93購04,0,0,0,0,0,0,0,0,0,21000,0,0,0,21000,0,21000,21000
049143,智邦元大94購02  ,0,0,0,0,0,0,0,0,0,21000,0,0,0,74000,53000,21000,21000
048892,台郡元富97購01  ,0,0,0,0,0,0,0,0,0,21000,0,0,0,31000,10000,21000,21000
052920,景碩台新96購02  ,0,0,0,0,0,0,0,0,0,21000,0,0,0,22000,1000,21000,21000
0052,富邦科技        ,1000,3000,-2000,0,0,0,0,0,0,23000,0,0,0,132000,109000,23000,21000
00709,富邦歐洲        ,0,0,0,0,0,0,0,0,0,21000,0,0,0,132000,111000,21000,21000
044645,元金2X群益93購01,0,0,0,0,0,0,0,0,0,21000,0,0,0,21000,0,21000,21000
049536,T50反1群益94購02,0,0,0,0,0,0,0,0,0,21000,0,0,0,61000,40000,21000,21000
05261P,鴻海元大95售20  ,0,0,0,0,0,0,0,0,0,21000,0,0,0,680000,659000,21000,21000
05027P,南電群益95售01  ,0,0,0,0,0,0,0,0,0,21000,0,0,0,31000,10000,21000,21000
051119,光寶科群益95購01,0,0,0,0,0,0,0,0,0,21000,0,0,0,149000,128000,21000,21000
052742,可成元大96購01  ,0,0,0,0,0,0,0,0,0,21000,0,0,0,111000,90000,21000,21000
05516P,台積電元大96售12,0,0,0,0,0,0,0,0,0,21000,0,0,0,21000,0,21000,21000
054564,玉晶光群益99購01,0,0,0,0,0,0,0,0,0,21000,0,0,0,135000,114000,21000,21000
05591P,義隆群益96售03  ,0,0,0,0,0,0,0,0,0,21000,0,0,0,21000,0,21000,21000
056405,聯茂群益98購01  ,0,0,0,0,0,0,0,0,0,21000,0,0,0,48000,27000,21000,21000
055704,亞德客永豐97購04,0,0,0,0,0,0,0,0,0,21000,0,0,0,21000,0,21000,21000
055707,聯鈞永豐98購01  ,0,0,0,0,0,0,0,0,0,21000,0,0,0,43000,22000,21000,21000
055290,玉晶光元大98購08,0,0,0,0,0,0,0,0,0,21000,0,0,0,31000,10000,21000,21000
055320,建準國票98購01  ,0,0,0,0,0,0,0,0,0,21000,0,0,0,21000,0,21000,21000
06079P,燿華群益98售02  ,0,0,0,0,0,0,0,0,0,21000,0,0,0,31000,10000,21000,21000
06448P,華通元大99售01  ,0,0,0,0,0,0,0,0,0,21000,0,0,0,27000,6000,21000,21000
06549P,大立光元大98售11,0,0,0,0,0,0,0,0,0,21000,0,0,0,21000,0,21000,21000
06518P,奇力新兆豐99售01,0,0,0,0,0,0,0,0,0,21000,0,0,0,91000,70000,21000,21000
1465,偉全            ,21000,0,21000,0,0,0,0,0,0,0,0,0,0,0,0,0,21000
1713,國化            ,25000,3000,22000,0,0,0,0,0,0,-1000,0,1000,-1000,0,0,0,21000
06915P,晶技元富98售02  ,0,0,0,0,0,0,0,0,0,21000,0,0,0,41000,20000,21000,21000
06813P,友訊元富98售03  ,0,0,0,0,0,0,0,0,0,21000,0,0,0,21000,0,21000,21000
2707,晶華            ,52000,39000,13000,0,0,0,0,0,0,8000,2000,1000,1000,7000,0,7000,21000
2468,華經            ,68000,14000,54000,0,0,0,0,0,0,-33000,0,33000,-33000,0,0,0,21000
3346,麗清            ,44000,24000,20000,0,0,0,0,0,0,1000,1000,0,1000,0,0,0,21000
5288,豐祥-KY         ,70000,48000,22000,0,0,0,0,0,0,-1000,0,1000,-1000,0,0,0,21000
9906,欣巴巴          ,21000,0,21000,0,0,0,0,0,0,0,0,0,0,0,0,0,21000
058442,玉晶光台新99購01,0,0,0,0,0,0,0,0,0,20000,0,0,0,21000,1000,20000,20000
058455,玉晶光永豐99購03,0,0,0,0,0,0,0,0,0,20000,0,0,0,33000,13000,20000,20000
058413,義隆兆豐99購01  ,0,0,0,0,0,0,0,0,0,20000,0,0,0,20000,0,20000,20000
058378,南電凱基99購01  ,0,0,0,0,0,0,0,0,0,20000,0,0,0,97000,77000,20000,20000
06040P,亞光康和96售03  ,8000,0,8000,0,0,0,0,0,0,12000,0,0,0,20000,8000,12000,20000
05905P,晶技統一97售01  ,0,0,0,0,0,0,0,0,0,20000,0,0,0,30000,10000,20000,20000
056577,玉晶光元大99購06,0,0,0,0,0,0,0,0,0,20000,0,0,0,51000,31000,20000,20000
056866,矽創群益98購03  ,0,0,0,0,0,0,0,0,0,20000,0,0,0,22000,2000,20000,20000
056821,日電貿永豐98購01,0,0,0,0,0,0,0,0,0,20000,0,0,0,20000,0,20000,20000
056808,台積電統一98購06,0,0,0,0,0,0,0,0,0,20000,0,0,0,88000,68000,20000,20000
057033,A50反1元大9B購02,0,0,0,0,0,0,0,0,0,20000,0,0,0,20000,0,20000,20000
057017,和大凱基98購01  ,0,0,0,0,0,0,0,0,0,20000,0,0,0,20000,0,20000,20000
057152,緯穎國票99購03  ,0,0,0,0,0,0,0,0,0,20000,0,0,0,30000,10000,20000,20000
05713P,大立光統一96售05,0,0,0,0,0,0,0,0,0,20000,0,0,0,21000,1000,20000,20000
057089,奇力新元富98購01,0,0,0,0,0,0,0,0,0,20000,0,0,0,30000,10000,20000,20000
057225,華新凱基98購01  ,0,0,0,0,0,0,0,0,0,20000,0,0,0,20000,0,20000,20000
057604,鴻海統一9C購01  ,0,0,0,0,0,0,0,0,0,20000,0,0,0,20000,0,20000,20000
057621,崇越凱基98購01  ,0,0,0,0,0,0,0,0,0,20000,0,0,0,60000,40000,20000,20000
057474,T50反1元大98購09,0,0,0,0,0,0,0,0,0,20000,0,0,0,20000,0,20000,20000
057411,臺股指群益99購05,0,0,0,0,0,0,0,0,0,20000,0,0,0,20000,0,20000,20000
04720P,台積電凱基94售25,0,0,0,0,0,0,0,0,0,20000,0,0,0,20000,0,20000,20000
048143,聯發科統一94購03,0,0,0,0,0,0,0,0,0,20000,0,0,0,20000,0,20000,20000
04745P,祥碩元大94售04  ,0,0,0,0,0,0,0,0,0,20000,0,0,0,20000,0,20000,20000
04817P,創意國票95售02  ,0,0,0,0,0,0,0,0,0,20000,0,0,0,70000,50000,20000,20000
048256,鴻海統一93購08  ,0,0,0,0,0,0,0,0,0,20000,0,0,0,40000,20000,20000,20000
04462P,全新元富96售01  ,0,0,0,0,0,0,0,0,0,20000,0,0,0,20000,0,20000,20000
044507,燿華凱基93購03  ,0,0,0,0,0,0,0,0,0,20000,0,0,0,20000,0,20000,20000
04504P,台積電元富94售04,0,0,0,0,0,0,0,0,0,20000,0,0,0,20000,0,20000,20000
045679,欣興元大94購01  ,0,0,0,0,0,0,0,0,0,20000,0,0,0,20000,0,20000,20000
045660,欣興富邦93購03  ,0,0,0,0,0,0,0,0,0,20000,0,0,0,20000,0,20000,20000
04507P,台光電元大94售03,0,0,0,0,0,0,0,0,0,20000,0,0,0,20000,0,20000,20000
043909,台光電凱基93購01,0,0,0,0,0,0,0,0,0,20000,0,0,0,20000,0,20000,20000
042903,金寶元大94購01  ,0,0,0,0,0,0,0,0,0,20000,0,0,0,106000,86000,20000,20000
03520P,臺股指國票02售09,0,0,0,0,0,0,0,0,0,20000,0,0,0,40000,20000,20000,20000
04228P,貿聯永豐93售03  ,0,0,0,0,0,0,0,0,0,20000,0,0,0,50000,30000,20000,20000
04208P,臺股指元大93售48,0,0,0,0,0,0,0,0,0,20000,0,0,0,120000,100000,20000,20000
04391P,玉晶光凱基95售03,0,0,0,0,0,0,0,0,0,20000,0,0,0,20000,0,20000,20000
044302,智邦兆豐93購02  ,0,0,0,0,0,0,0,0,0,20000,0,0,0,20000,0,20000,20000
046685,世紀鋼群益93購02,0,0,0,0,0,0,0,0,0,20000,0,0,0,20000,0,20000,20000
046185,正崴凱基93購02  ,0,0,0,0,0,0,0,0,0,20000,0,0,0,50000,30000,20000,20000
04003P,麗豐凱基94售03  ,0,0,0,0,0,0,0,0,0,20000,0,0,0,22000,2000,20000,20000
05290P,國巨永豐95售04  ,0,0,0,0,0,0,0,0,0,20000,0,0,0,20000,0,20000,20000
052552,智邦國票97購01  ,0,0,0,0,0,0,0,0,0,20000,0,0,0,20000,0,20000,20000
052535,日月光國泰96購01,0,0,0,0,0,0,0,0,0,20000,0,0,0,30000,10000,20000,20000
052816,上銀永豐96購01  ,0,0,0,0,0,0,0,0,0,20000,0,0,0,20000,0,20000,20000
04920P,智易凱基94售05  ,0,0,0,0,0,0,0,0,0,20000,0,0,0,20000,0,20000,20000
052660,京元電國票97購01,0,0,0,0,0,0,0,0,0,20000,0,0,0,96000,76000,20000,20000
048866,滬深2X兆豐95購01,0,0,0,0,0,0,0,0,0,20000,0,0,0,20000,0,20000,20000
048978,晶相光元大94購02,0,0,0,0,0,0,0,0,0,20000,0,0,0,30000,10000,20000,20000
049049,玉晶光康和94購02,0,0,0,0,0,0,0,0,0,20000,0,0,0,20000,0,20000,20000
049036,燿華兆豐95購01  ,0,0,0,0,0,0,0,0,0,20000,0,0,0,20000,0,20000,20000
04860P,鴻海群益94售07  ,0,0,0,0,0,0,0,0,0,20000,0,0,0,20000,0,20000,20000
048787,義隆元大94購02  ,0,0,0,0,0,0,0,0,0,20000,0,0,0,20000,0,20000,20000
04769P,高股息元大94售01,0,0,0,0,0,0,0,0,0,20000,0,0,0,20000,0,20000,20000
047880,聯發科國泰94購03,0,0,0,0,0,0,0,0,0,20000,0,0,0,20000,0,20000,20000
048453,嘉澤凱基93購05  ,0,0,0,0,0,0,0,0,0,20000,0,0,0,30000,10000,20000,20000
049445,遠東新統一94購01,0,0,0,0,0,0,0,0,0,20000,0,0,0,30000,10000,20000,20000
048569,台虹元大93購03  ,0,0,0,0,0,0,0,0,0,20000,0,0,0,20000,0,20000,20000
049814,超眾元大95購04  ,0,0,0,0,0,0,0,0,0,20000,0,0,0,20000,0,20000,20000
049833,正文凱基94購05  ,0,0,0,0,0,0,0,0,0,20000,0,0,0,220000,200000,20000,20000
049890,嘉澤國泰95購01  ,0,0,0,0,0,0,0,0,0,20000,0,0,0,30000,10000,20000,20000
049406,T50反1日盛97購01,0,0,0,0,0,0,0,0,0,20000,0,0,0,500000,480000,20000,20000
049352,泰鼎永豐95購01  ,0,0,0,0,0,0,0,0,0,20000,0,0,0,20000,0,20000,20000
048274,矽力台新93購01  ,0,0,0,0,0,0,0,0,0,20000,0,0,0,20000,0,20000,20000
050014,國巨富邦98購01  ,0,0,0,0,0,0,0,0,0,20000,0,0,0,20000,0,20000,20000
050343,鴻海元富94購01  ,0,0,0,0,0,0,0,0,0,20000,0,0,0,20000,0,20000,20000
050358,致新群益94購01  ,0,0,0,0,0,0,0,0,0,20000,0,0,0,20000,0,20000,20000
051249,潤泰全元大95購01,0,0,0,0,0,0,0,0,0,20000,0,0,0,20000,0,20000,20000
051334,宏達電永豐95購01,0,0,0,0,0,0,0,0,0,20000,0,0,0,41000,21000,20000,20000
051311,瑞昱麥證95購01  ,0,0,0,220000,200000,20000,0,0,0,20000,0,0,0,220000,200000,20000,20000
051284,上銀統一95購02  ,0,0,0,0,0,0,0,0,0,20000,0,0,0,40000,20000,20000,20000
051683,A50正2凱基97購01,0,0,0,0,0,0,0,0,0,20000,0,0,0,20000,0,20000,20000
051485,玉晶光凱基97購02,0,0,0,0,0,0,0,0,0,20000,0,0,0,73000,53000,20000,20000
05150P,玉晶光第一95售01,0,0,0,0,0,0,0,0,0,20000,0,0,0,30000,10000,20000,20000
051782,昇陽半群益95購01,0,0,0,0,0,0,0,0,0,20000,0,0,0,40000,20000,20000,20000
052083,S&P反1元大97購02,0,0,0,0,0,0,0,0,0,20000,0,0,0,20000,0,20000,20000
052300,力成台新95購01  ,0,0,0,0,0,0,0,0,0,20000,0,0,0,20000,0,20000,20000
052280,聯發科凱基95購11,0,0,0,0,0,0,0,0,0,20000,0,0,0,30000,10000,20000,20000
052237,嘉澤國票96購02  ,0,0,0,0,0,0,0,0,0,20000,0,0,0,20000,0,20000,20000
052276,力成群益96購01  ,0,0,0,0,0,0,0,0,0,20000,0,0,0,75000,55000,20000,20000
052252,大立光永豐95購03,0,0,0,0,0,0,0,0,0,20000,0,0,0,20000,0,20000,20000
05220P,台積電元大95售16,0,0,0,0,0,0,0,0,0,20000,0,0,0,419000,399000,20000,20000
05240P,玉晶光永豐96售01,0,0,0,0,0,0,0,0,0,20000,0,0,0,20000,0,20000,20000
05362P,可成富邦97售02  ,0,0,0,0,0,0,0,0,0,20000,0,0,0,20000,0,20000,20000
053640,上緯控永豐96購01,0,0,0,0,0,0,0,0,0,20000,0,0,0,20000,0,20000,20000
052449,創意元大95購04  ,0,0,0,0,0,0,0,0,0,20000,0,0,0,20000,0,20000,20000
05243P,鴻海元大95售19  ,0,0,0,0,0,0,0,0,0,20000,0,0,0,95000,75000,20000,20000
053286,臺股指元大96購14,0,0,0,0,0,0,0,0,0,20000,0,0,0,20000,0,20000,20000
053400,緯穎中信9A購01  ,0,0,0,0,0,0,0,0,0,20000,0,0,0,80000,60000,20000,20000
053378,台積電元大98購02,0,0,0,0,0,0,0,0,0,20000,0,0,0,32000,12000,20000,20000
053739,A50正2國票9A購01,0,0,0,0,0,0,0,0,0,20000,0,0,0,35000,15000,20000,20000
05353P,臺股指元富95售07,0,0,0,0,0,0,0,0,0,20000,0,0,0,20000,0,20000,20000
050649,華新科凱基96購01,0,0,0,0,0,0,0,0,0,20000,0,0,0,195000,175000,20000,20000
050281,台積電日盛94購03,0,0,0,0,0,0,0,0,0,20000,0,0,0,216000,196000,20000,20000
053275,燿華元大97購01  ,0,0,0,0,0,0,0,0,0,20000,0,0,0,40000,20000,20000,20000
050767,京元電元大96購01,0,0,0,0,0,0,0,0,0,20000,0,0,0,20000,0,20000,20000
050759,貿聯元富94購02  ,0,0,0,0,0,0,0,0,0,20000,0,0,0,20000,0,20000,20000
050720,上証2X國票94購02,0,0,0,0,0,0,0,0,0,20000,0,0,0,20000,0,20000,20000
050832,力成凱基95購01  ,0,0,0,0,0,0,0,0,0,20000,0,0,0,20000,0,20000,20000
050873,新唐永豐95購01  ,0,0,0,0,0,0,0,0,0,20000,0,0,0,20000,0,20000,20000
05087P,GIS國泰96售01   ,0,0,0,0,0,0,0,0,0,20000,0,0,0,20000,0,20000,20000
052013,台積電永豐95購04,0,0,0,0,0,0,0,0,0,20000,0,0,0,20000,0,20000,20000
051200,國巨麥證95購01  ,0,0,0,20000,0,20000,0,0,0,20000,0,0,0,20000,0,20000,20000
05123P,鴻海永昌96售07  ,0,0,0,0,0,0,0,0,0,20000,0,0,0,283000,263000,20000,20000
05179P,大立光凱基96售06,0,0,0,0,0,0,0,0,0,20000,0,0,0,20000,0,20000,20000
05097P,聯發科日盛95售01,0,0,0,0,0,0,0,0,0,20000,0,0,0,20000,0,20000,20000
051905,道瓊銀元大95購01,0,0,0,0,0,0,0,0,0,20000,0,0,0,98000,78000,20000,20000
051882,潤泰全永豐95購01,0,0,0,0,0,0,0,0,0,20000,0,0,0,20000,0,20000,20000
051909,潤泰全元大95購02,0,0,0,0,0,0,0,0,0,20000,0,0,0,20000,0,20000,20000
051002,華邦電亞東96購01,0,0,0,0,0,0,0,0,0,20000,0,0,0,20000,0,20000,20000
051004,台新金中信95購02,0,0,0,0,0,0,0,0,0,20000,0,0,0,20000,0,20000,20000
050996,隆達元大95購01  ,0,0,0,0,0,0,0,0,0,20000,0,0,0,20000,0,20000,20000
05302P,華通國泰96售01  ,0,0,0,0,0,0,0,0,0,20000,0,0,0,20000,0,20000,20000
055310,聯詠群益97購02  ,0,0,0,0,0,0,0,0,0,20000,0,0,0,50000,30000,20000,20000
05529P,臺股指群益96售02,0,0,0,0,0,0,0,0,0,20000,0,0,0,20000,0,20000,20000
055171,凱美統一97購01  ,0,0,0,0,0,0,0,0,0,20000,0,0,0,20000,0,20000,20000
055437,禾伸堂中信99購01,0,0,0,0,0,0,0,0,0,20000,0,0,0,20000,0,20000,20000
05544P,台表科元富96售01,0,0,0,0,0,0,0,0,0,20000,0,0,0,20000,0,20000,20000
055642,廣宇元富97購01  ,0,0,0,0,0,0,0,0,0,20000,0,0,0,55000,35000,20000,20000
05553P,智原群益96售01  ,0,0,0,0,0,0,0,0,0,20000,0,0,0,20000,0,20000,20000
056373,上銀統一99購02  ,0,0,0,0,0,0,0,0,0,20000,0,0,0,77000,57000,20000,20000
055838,致茂元大97購03  ,0,0,0,0,0,0,0,0,0,20000,0,0,0,151000,131000,20000,20000
056071,創意元大97購02  ,0,0,0,0,0,0,0,0,0,20000,0,0,0,91000,71000,20000,20000
054650,南亞麥證97購01  ,0,0,0,20000,0,20000,0,0,0,20000,0,0,0,20000,0,20000,20000
054779,台塑群益98購01  ,0,0,0,0,0,0,0,0,0,20000,0,0,0,20000,0,20000,20000
055140,晶相光永豐97購01,0,0,0,0,0,0,0,0,0,20000,0,0,0,64000,44000,20000,20000
055091,微星群益97購01  ,0,0,0,0,0,0,0,0,0,20000,0,0,0,20000,0,20000,20000
055002,群創元富99購04  ,0,0,0,0,0,0,0,0,0,20000,0,0,0,60000,40000,20000,20000
054901,群光康和97購01  ,0,0,0,0,0,0,0,0,0,20000,0,0,0,20000,0,20000,20000
054948,聯發科元大97購14,0,0,0,0,0,0,0,0,0,20000,0,0,0,50000,30000,20000,20000
054950,奇力新元大98購02,0,0,0,0,0,0,0,0,0,20000,0,0,0,20000,0,20000,20000
054934,金寶元大97購01  ,0,0,0,0,0,0,0,0,0,20000,0,0,0,108000,88000,20000,20000
054961,玉晶光元大99購01,0,0,0,0,0,0,0,0,0,20000,0,0,0,150000,130000,20000,20000
05497P,聯詠統一96售01  ,0,0,0,0,0,0,0,0,0,20000,0,0,0,20000,0,20000,20000
054233,聯發科群益96購04,0,0,0,0,0,0,0,0,0,20000,0,0,0,40000,20000,20000,20000
054205,華新國票97購02  ,0,0,0,0,0,0,0,0,0,20000,0,0,0,20000,0,20000,20000
053847,美律元富96購02  ,0,0,0,0,0,0,0,0,0,20000,0,0,0,40000,20000,20000,20000
8367,建新國際        ,25000,5000,20000,0,0,0,0,0,0,0,3000,3000,0,0,0,0,20000
2471,資通            ,34000,11000,23000,0,0,0,0,0,0,-3000,0,3000,-3000,0,0,0,20000
06789P,鴻海凱基98售12  ,0,0,0,0,0,0,0,0,0,20000,0,0,0,30000,10000,20000,20000
06922P,元上證群益9C售01,0,0,0,0,0,0,0,0,0,20000,0,0,0,20000,0,20000,20000
07026P,超眾凱基99售03  ,0,0,0,0,0,0,0,0,0,20000,0,0,0,50000,30000,20000,20000
06967P,台郡台新99售02  ,0,0,0,0,0,0,0,0,0,20000,0,0,0,20000,0,20000,20000
06544P,鴻海元大98售09  ,0,0,0,0,0,0,0,0,0,20000,0,0,0,71000,51000,20000,20000
06466P,台積電統一9B售01,0,0,0,0,0,0,0,0,0,20000,0,0,0,30000,10000,20000,20000
06473P,鴻海元大99售03  ,0,0,0,0,0,0,0,0,0,20000,0,0,0,20000,0,20000,20000
06762P,智邦元大98售11  ,0,0,0,0,0,0,0,0,0,20000,0,0,0,28000,8000,20000,20000
06678P,大立光統一99售01,0,0,0,0,0,0,0,0,0,20000,0,0,0,20000,0,20000,20000
06135P,志超元富97售01  ,0,0,0,0,0,0,0,0,0,20000,0,0,0,20000,0,20000,20000
06415P,台積電群益97售07,0,0,0,0,0,0,0,0,0,20000,0,0,0,20000,0,20000,20000
06233P,訊芯永豐97售03  ,0,0,0,0,0,0,0,0,0,20000,0,0,0,30000,10000,20000,20000
057560,華新科兆豐99購01,0,0,0,0,0,0,0,0,0,19000,0,0,0,19000,0,19000,19000
056454,欣興凱基98購02  ,0,0,0,0,0,0,0,0,0,19000,0,0,0,29000,10000,19000,19000
05672P,鴻海群益96售03  ,0,0,0,0,0,0,0,0,0,19000,0,0,0,19000,0,19000,19000
056700,華新科國泰99購03,0,0,0,0,0,0,0,0,0,19000,0,0,0,19000,0,19000,19000
05997P,嘉聯益群益96售02,0,0,0,0,0,0,0,0,0,19000,0,0,0,36000,17000,19000,19000
05988P,光磊元富96售02  ,0,0,0,0,0,0,0,0,0,19000,0,0,0,50000,31000,19000,19000
05903P,聯發科統一96售09,0,0,0,0,0,0,0,0,0,19000,0,0,0,20000,1000,19000,19000
041534,T50反1凱基96購01,0,0,0,0,0,0,0,0,0,19000,0,0,0,20000,1000,19000,19000
047098,大毅國泰94購01  ,0,0,0,0,0,0,0,0,0,19000,0,0,0,19000,0,19000,19000
04584P,楠梓電永豐94售01,0,0,0,0,0,0,0,0,0,19000,0,0,0,29000,10000,19000,19000
047292,台光電元富96購01,0,0,0,0,0,0,0,0,0,19000,0,0,0,19000,0,19000,19000
050885,T50反1富邦95購01,0,0,0,0,0,0,0,0,0,19000,0,0,0,19000,0,19000,19000
05022P,智易凱基95售01  ,0,0,0,0,0,0,0,0,0,19000,0,0,0,19000,0,19000,19000
053672,嘉澤元富96購02  ,0,0,0,0,0,0,0,0,0,19000,0,0,0,19000,0,19000,19000
052249,大成鋼永豐95購01,0,0,0,0,0,0,0,0,0,19000,0,0,0,80000,61000,19000,19000
051296,鴻海凱基97購01  ,0,0,0,0,0,0,0,0,0,19000,0,0,0,20000,1000,19000,19000
053915,光罩國票96購02  ,0,0,0,0,0,0,0,0,0,19000,0,0,0,19000,0,19000,19000
053769,香港反元大99購01,0,0,0,0,0,0,0,0,0,19000,0,0,0,19000,0,19000,19000
05548P,臺股指元大96售02,0,0,0,0,0,0,0,0,0,19000,0,0,0,19000,0,19000,19000
055462,華邦電日盛97購01,0,0,0,0,0,0,0,0,0,19000,0,0,0,20000,1000,19000,19000
055429,華新科群益99購01,0,0,0,0,0,0,0,0,0,19000,0,0,0,258000,239000,19000,19000
06714P,台積電元大98售15,0,0,0,0,0,0,0,0,0,19000,0,0,0,64000,45000,19000,19000
06980P,緯穎永豐99售02  ,0,0,0,0,0,0,0,0,0,19000,0,0,0,20000,1000,19000,19000
1220,台榮            ,19000,0,19000,0,0,0,0,0,0,0,0,0,0,0,0,0,19000
08714P,華碩元富01售03  ,0,0,0,0,0,0,0,0,0,19000,0,0,0,19000,0,19000,19000
1414,東和            ,24000,5000,19000,0,0,0,0,0,0,0,0,0,0,0,0,0,19000
2397,友通            ,28000,9000,19000,0,0,0,0,0,0,0,0,0,0,0,0,0,19000
2462,良得電          ,28000,9000,19000,0,0,0,0,0,0,0,0,0,0,0,0,0,19000
6216,居易            ,20000,3000,17000,0,0,0,0,0,0,2000,2000,0,2000,0,0,0,19000
4148,全宇生技-KY     ,38000,19000,19000,0,0,0,0,0,0,0,0,0,0,0,0,0,19000
056474,華新科元大99購05,0,0,0,0,0,0,0,0,0,18000,0,0,0,38000,20000,18000,18000
057427,華通兆豐99購01  ,0,0,0,0,0,0,0,0,0,18000,0,0,0,48000,30000,18000,18000
057370,可成元大98購07  ,0,0,0,0,0,0,0,0,0,18000,0,0,0,68000,50000,18000,18000
043580,大立光元富94購01,0,0,0,0,0,0,0,0,0,18000,0,0,0,18000,0,18000,18000
04164P,滬深2X元富93售03,0,0,0,0,0,0,0,0,0,18000,0,0,0,18000,0,18000,18000
00665L,富邦恒生國企正2 ,21000,37000,-16000,0,0,0,0,0,0,34000,0,0,0,120000,86000,34000,18000
03637C,臺股指凱基94牛18,0,0,0,0,0,0,0,0,0,18000,0,0,0,34000,16000,18000,18000
050031,嘉澤元大95購01  ,0,0,0,0,0,0,0,0,0,18000,0,0,0,149000,131000,18000,18000
048810,玉晶光第一94購01,0,0,0,0,0,0,0,0,0,18000,0,0,0,18000,0,18000,18000
051397,聯茂兆豐95購03  ,0,0,0,0,0,0,0,0,0,18000,0,0,0,18000,0,18000,18000
053126,健策凱基97購02  ,0,0,0,0,0,0,0,0,0,18000,0,0,0,107000,89000,18000,18000
053211,漢唐凱基96購03  ,0,0,0,0,0,0,0,0,0,18000,0,0,0,18000,0,18000,18000
051888,國巨元富95購05  ,0,0,0,0,0,0,0,0,0,18000,0,0,0,583000,565000,18000,18000
055521,S&P反1群益01購01,0,0,0,0,0,0,0,0,0,18000,0,0,0,18000,0,18000,18000
056177,嘉澤元富97購01  ,0,0,0,0,0,0,0,0,0,18000,0,0,0,18000,0,18000,18000
054137,聯詠元大97購02  ,0,0,0,0,0,0,0,0,0,18000,0,0,0,267000,249000,18000,18000
055112,晶豪科凱基98購01,0,0,0,0,0,0,0,0,0,18000,0,0,0,18000,0,18000,18000
054673,京鼎國泰98購01  ,0,0,0,0,0,0,0,0,0,18000,0,0,0,40000,22000,18000,18000
5533,皇鼎            ,44000,26000,18000,0,0,0,0,0,0,0,0,0,0,0,0,0,18000
5706,鳳凰            ,33000,15000,18000,0,0,0,0,0,0,0,0,0,0,0,0,0,18000
2546,根基            ,48000,30000,18000,0,0,0,0,0,0,0,0,0,0,0,0,0,18000
3311,閎暉            ,40000,22000,18000,0,0,0,0,0,0,0,0,0,0,0,0,0,18000
2002A,中鋼特          ,0,0,0,0,0,0,0,0,0,18000,21000,3000,18000,0,0,0,18000
06933P,禾伸堂元大98售03,0,0,0,0,0,0,0,0,0,18000,0,0,0,23000,5000,18000,18000
06580P,元油2X凱基9A售06,0,9000,-9000,0,0,0,0,0,0,27000,0,0,0,27000,0,27000,18000
06155P,智邦統一97售02  ,0,0,0,0,0,0,0,0,0,18000,0,0,0,28000,10000,18000,18000
8429,金麗-KY         ,69000,51543,17457,0,0,0,0,0,0,0,0,0,0,0,0,0,17457
057216,聯發科群益99購01,0,0,0,0,0,0,0,0,0,17000,0,0,0,20000,3000,17000,17000
05681P,大立光元大96售05,0,0,0,0,0,0,0,0,0,17000,0,0,0,17000,0,17000,17000
056880,緯穎國票98購02  ,0,0,0,0,0,0,0,0,0,17000,0,0,0,97000,80000,17000,17000
056854,友達中信9A購01  ,0,0,0,0,0,0,0,0,0,17000,0,0,0,70000,53000,17000,17000
048755,志超元富96購01  ,0,0,0,0,0,0,0,0,0,17000,0,0,0,17000,0,17000,17000
049114,玉晶光統一94購02,0,0,0,0,0,0,0,0,0,17000,0,0,0,20000,3000,17000,17000
048021,滬深反凱基93購02,0,0,0,0,0,0,0,0,0,17000,0,0,0,17000,0,17000,17000
044377,南茂兆豐93購01  ,0,0,0,0,0,0,0,0,0,17000,0,0,0,17000,0,17000,17000
05006P,華通元富95售01  ,0,0,0,0,0,0,0,0,0,17000,0,0,0,187000,170000,17000,17000
051225,台積電群益95購02,0,0,0,0,0,0,0,0,0,17000,0,0,0,118000,101000,17000,17000
051449,玉晶光元大96購01,0,0,0,0,0,0,0,0,0,17000,0,0,0,67000,50000,17000,17000
050393,樺漢統一94購01  ,0,0,0,0,0,0,0,0,0,17000,0,0,0,131000,114000,17000,17000
055082,台郡中信97購01  ,0,0,0,0,0,0,0,0,0,17000,0,0,0,72000,55000,17000,17000
05629P,聯發科永昌99售02,0,0,0,0,0,0,0,0,0,17000,0,0,0,38000,21000,17000,17000
056302,大立光元大97購17,0,0,0,0,0,0,0,0,0,17000,0,0,0,17000,0,17000,17000
055506,台郡元大99購02  ,0,0,0,0,0,0,0,0,0,17000,0,0,0,17000,0,17000,17000
8411,福貞-KY         ,20000,2000,18000,0,0,0,0,0,0,-1000,1000,2000,-1000,0,0,0,17000
8940,新天地          ,17000,0,17000,0,0,0,0,0,0,0,0,0,0,0,0,0,17000
6224,聚鼎            ,79000,59000,20000,0,0,0,0,0,0,-3000,2000,5000,-3000,0,0,0,17000
6172,互億            ,21000,4000,17000,0,0,0,0,0,0,0,0,0,0,0,0,0,17000
4104,佳醫            ,119000,102000,17000,0,0,0,0,0,0,0,0,0,0,0,0,0,17000
2530,華建            ,17000,0,17000,0,0,0,0,0,0,0,0,0,0,0,0,0,17000
2706,第一店          ,18000,1000,17000,0,0,0,0,0,0,0,0,0,0,0,0,0,17000
2459,敦吉            ,55000,38000,17000,0,0,0,0,0,0,0,0,0,0,0,0,0,17000
9942,茂順            ,62000,45000,17000,0,0,0,0,0,0,0,0,0,0,0,0,0,17000
06690P,玉晶光群益9A售05,0,0,0,0,0,0,0,0,0,17000,0,0,0,105000,88000,17000,17000
06624P,訊芯元大98售06  ,0,0,0,0,0,0,0,0,0,17000,0,0,0,28000,11000,17000,17000
06923P,鴻海群益98售09  ,0,0,0,0,0,0,0,0,0,17000,0,0,0,20000,3000,17000,17000
1225,福懋油          ,56000,39000,17000,0,0,0,0,0,0,0,0,0,0,0,0,0,17000
1726,永記            ,22000,5000,17000,0,0,0,0,0,0,0,0,0,0,0,0,0,17000
1409,新纖            ,665000,773035,-108035,0,0,0,13000,0,13000,112000,117000,5000,112000,0,0,0,16965
05676P,欣興群益96售04  ,0,0,0,0,0,0,0,0,0,16000,0,0,0,41000,25000,16000,16000
05720P,可成中信98售01  ,0,0,0,0,0,0,0,0,0,16000,0,0,0,17000,1000,16000,16000
057257,台泥兆豐99購01  ,0,0,0,0,0,0,0,0,0,16000,0,0,0,180000,164000,16000,16000
057352,大立光統一9A購02,0,0,0,0,0,0,0,0,0,16000,0,0,0,48000,32000,16000,16000
057602,聯茂群益98購02  ,0,0,0,0,0,0,0,0,0,16000,0,0,0,26000,10000,16000,16000
057980,聯詠永豐98購01  ,0,0,0,0,0,0,0,0,0,16000,0,0,0,88000,72000,16000,16000
057869,大立光凱基99購01,0,0,0,0,0,0,0,0,0,16000,0,0,0,17000,1000,16000,16000
057679,臺股指元大98購09,0,0,0,0,0,0,0,0,0,16000,0,0,0,26000,10000,16000,16000
047383,鴻海元大95購01  ,0,0,0,0,0,0,0,0,0,16000,0,0,0,138000,122000,16000,16000
048069,南亞科元富95購02,0,0,0,0,0,0,0,0,0,16000,0,0,0,18000,2000,16000,16000
049701,聯茂元大94購05  ,0,0,0,0,0,0,0,0,0,16000,0,0,0,76000,60000,16000,16000
052542,友達元富98購01  ,0,0,0,0,0,0,0,0,0,16000,0,0,0,30000,14000,16000,16000
052213,富邦金元大95購01,0,0,0,0,0,0,0,0,0,16000,0,0,0,76000,60000,16000,16000
053349,台郡國票97購02  ,0,0,0,0,0,0,0,0,0,16000,0,0,0,17000,1000,16000,16000
052026,漢唐群益95購01  ,0,0,0,0,0,0,0,0,0,16000,0,0,0,45000,29000,16000,16000
053230,達方台新97購01  ,0,0,0,0,0,0,0,0,0,16000,0,0,0,51000,35000,16000,16000
051926,聯電中信97購01  ,0,0,0,0,0,0,0,0,0,16000,0,0,0,98000,82000,16000,16000
055378,晶相光元大97購02,0,0,0,0,0,0,0,0,0,16000,0,0,0,180000,164000,16000,16000
05633P,台表科群益96售04,0,0,0,0,0,0,0,0,0,16000,0,0,0,16000,0,16000,16000
054945,正崴元大97購01  ,0,0,0,0,0,0,0,0,0,16000,0,0,0,100000,84000,16000,16000
054641,祥碩中信98購01  ,0,0,0,0,0,0,0,0,0,16000,0,0,0,16000,0,16000,16000
054577,世芯元大98購01  ,0,0,0,0,0,0,0,0,0,16000,0,0,0,171000,155000,16000,16000
054252,奇力新元大96購04,0,0,0,0,0,0,0,0,0,16000,0,0,0,16000,0,16000,16000
054391,宏達電元富96購04,0,0,0,0,0,0,0,0,0,16000,0,0,0,16000,0,16000,16000
1817,凱撒衛          ,28000,12000,16000,0,0,0,0,0,0,0,0,0,0,0,0,0,16000
1219,福壽            ,27000,11000,16000,0,0,0,0,0,0,0,0,0,0,0,0,0,16000
06795P,臺股指凱基98售05,0,0,0,0,0,0,0,0,0,16000,0,0,0,16000,0,16000,16000
06746P,聯發科群益99售02,0,0,0,0,0,0,0,0,0,16000,0,0,0,16000,0,16000,16000
06483P,聯發科凱基98售10,0,0,0,0,0,0,0,0,0,16000,0,0,0,27000,11000,16000,16000
06412P,南亞科日盛97售01,0,0,0,0,0,0,0,0,0,16000,0,0,0,31000,15000,16000,16000
2545,皇翔            ,100000,86000,14000,0,0,0,0,0,0,2000,2000,0,2000,0,0,0,16000
6277,宏正            ,41000,25000,16000,0,0,0,0,0,0,0,0,0,0,0,0,0,16000
05782P,聯詠元富96售02  ,0,0,0,0,0,0,0,0,0,15000,0,0,0,15000,0,15000,15000
057975,台積電永豐98購05,0,0,0,0,0,0,0,0,0,15000,0,0,0,68000,53000,15000,15000
05789P,臺股指永昌96售06,0,0,0,0,0,0,0,0,0,15000,10000,0,10000,5000,0,5000,15000
05828P,台積電統一97售02,0,0,0,0,0,0,0,0,0,15000,0,0,0,35000,20000,15000,15000
057455,景碩國泰99購01  ,0,0,0,0,0,0,0,0,0,15000,0,0,0,61000,46000,15000,15000
057343,道瓊反統一9A購01,0,0,0,0,0,0,0,0,0,15000,0,0,0,15000,0,15000,15000
056570,旺宏元大98購07  ,0,0,0,0,0,0,0,0,0,15000,0,0,0,30000,15000,15000,15000
056669,貿聯國票99購01  ,0,0,0,0,0,0,0,0,0,15000,0,0,0,15000,0,15000,15000
056661,臺股指元大9A購08,0,0,0,0,0,0,0,0,0,15000,0,0,0,17000,2000,15000,15000
052575,茂林凱基96購04  ,0,0,0,0,0,0,0,0,0,15000,0,0,0,15000,0,15000,15000
052926,旺宏元大98購02  ,0,0,0,0,0,0,0,0,0,15000,0,0,0,70000,55000,15000,15000
052903,致茂國票97購01  ,0,0,0,0,0,0,0,0,0,15000,0,0,0,20000,5000,15000,15000
048923,國巨永豐94購02  ,0,0,0,0,0,0,0,0,0,15000,0,0,0,118000,103000,15000,15000
048653,巨大元大96購02  ,0,0,0,0,0,0,0,0,0,15000,0,0,0,35000,20000,15000,15000
04797P,華新科元大94售04,0,0,0,0,0,0,0,0,0,15000,0,0,0,15000,0,15000,15000
047687,元金2X富邦96購01,0,0,0,0,0,0,0,0,0,15000,0,0,0,20000,5000,15000,15000
045882,滬深2X元大95購01,0,0,0,0,0,0,0,0,0,15000,0,0,0,15000,0,15000,15000
04548P,大立光元大94售14,0,0,0,0,0,0,0,0,0,15000,0,0,0,15000,0,15000,15000
040160,SP黃豆元富95購01,0,0,0,0,0,0,0,0,0,15000,0,0,0,15000,0,15000,15000
04210P,鴻海凱基93售36  ,0,0,0,0,0,0,0,0,0,15000,0,0,0,15000,0,15000,15000
04259P,滬深2X群益93售03,0,0,0,0,0,0,0,0,0,15000,0,0,0,15000,0,15000,15000
051841,南茂國泰96購01  ,0,0,0,0,0,0,0,0,0,15000,0,0,0,162000,147000,15000,15000
050127,台積電凱基94購31,0,0,0,0,0,0,0,0,0,15000,0,0,0,15000,0,15000,15000
051232,貿聯群益95購02  ,0,0,0,0,0,0,0,0,0,15000,0,0,0,32000,17000,15000,15000
051968,勤誠永豐95購01  ,0,0,0,0,0,0,0,0,0,15000,0,0,0,15000,0,15000,15000
05194P,玉晶光康和95售01,0,0,0,0,0,0,0,0,0,15000,0,0,0,15000,0,15000,15000
050831,超眾凱基95購01  ,0,0,0,0,0,0,0,0,0,15000,0,0,0,56000,41000,15000,15000
050784,美律國泰96購01  ,0,0,0,0,0,0,0,0,0,15000,0,0,0,45000,30000,15000,15000
053336,元油反國票9B購02,0,0,0,0,0,0,0,0,0,15000,0,0,0,15000,0,15000,15000
053393,元油反中信98購01,0,0,0,0,0,0,0,0,0,15000,0,0,0,15000,0,15000,15000
05358P,大立光元大95售09,0,0,0,0,0,0,0,0,0,15000,0,0,0,15000,0,15000,15000
053742,創意國票97購01  ,0,0,0,0,0,0,0,0,0,15000,0,0,0,27000,12000,15000,15000
053631,欣興兆豐97購01  ,0,0,0,0,0,0,0,0,0,15000,0,0,0,15000,0,15000,15000
05132P,鴻海元富95售07  ,0,0,0,0,0,0,0,0,0,15000,0,0,0,15000,0,15000,15000
051558,元金2X國泰97購01,0,0,0,0,0,0,0,0,0,15000,0,0,0,15000,0,15000,15000
051551,新日興永豐95購01,0,0,0,0,0,0,0,0,0,15000,0,0,0,15000,0,15000,15000
05383P,鴻海富邦95售06  ,0,0,0,0,0,0,0,0,0,15000,0,0,0,15000,0,15000,15000
053961,揚明光永豐96購04,0,0,0,0,0,0,0,0,0,15000,0,0,0,68000,53000,15000,15000
05473P,聯詠統一97售02  ,0,0,0,0,0,0,0,0,0,15000,0,0,0,15000,0,15000,15000
054809,大成鋼元大97購01,0,0,0,0,0,0,0,0,0,15000,0,0,0,156000,141000,15000,15000
05490P,鴻海元大95售23  ,0,0,0,0,0,0,0,0,0,15000,0,0,0,15000,0,15000,15000
05502P,台表科國票97售01,0,0,0,0,0,0,0,0,0,15000,0,0,0,15000,0,15000,15000
055116,康控凱基98購01  ,0,0,0,0,0,0,0,0,0,15000,0,0,0,15000,0,15000,15000
056250,瑞昱兆豐97購02  ,0,0,0,0,0,0,0,0,0,15000,0,0,0,15000,0,15000,15000
056231,嘉聯益凱基97購02,0,0,0,0,0,0,0,0,0,15000,0,0,0,60000,45000,15000,15000
05581P,華新科凱基96售07,0,0,0,0,0,0,0,0,0,15000,0,0,0,15000,0,15000,15000
055363,緯穎凱基98購03  ,0,0,0,0,0,0,0,0,0,15000,0,0,0,82000,67000,15000,15000
6189,豐藝            ,108000,96000,12000,0,0,0,0,0,0,3000,3000,0,3000,0,0,0,15000
2597,潤弘            ,32000,17000,15000,0,0,0,0,0,0,0,1000,1000,0,0,0,0,15000
2451,創見            ,330000,963000,-633000,0,0,0,0,0,0,648000,4000,1000,3000,645000,0,645000,15000
2433,互盛電          ,52000,39000,13000,0,0,0,0,0,0,2000,2000,0,2000,0,0,0,15000
3550,聯穎            ,17000,4000,13000,0,0,0,0,0,0,2000,2000,0,2000,0,0,0,15000
2923,鼎固-KY         ,39000,24000,15000,0,0,0,0,0,0,0,0,0,0,0,0,0,15000
2904,匯僑            ,15000,0,15000,0,0,0,0,0,0,0,0,0,0,0,0,0,15000
3010,華立            ,83000,70000,13000,0,0,0,0,0,0,2000,2000,0,2000,0,0,0,15000
06607P,友達台新98售02  ,0,0,0,0,0,0,0,0,0,15000,0,0,0,15000,0,15000,15000
06744P,嘉聯益永豐98售03,0,0,0,0,0,0,0,0,0,15000,0,0,0,55000,40000,15000,15000
06763P,技嘉元大98售05  ,0,0,0,0,0,0,0,0,0,15000,0,0,0,15000,0,15000,15000
06764P,聯發科元大98售11,0,0,0,0,0,0,0,0,0,15000,0,0,0,15000,0,15000,15000
1432,大魯閣          ,17000,2000,15000,0,0,0,0,0,0,0,0,0,0,0,0,0,15000
1446,宏和            ,28000,14000,14000,0,0,0,0,0,0,1000,1000,0,1000,0,0,0,15000
1507,永大            ,75000,62000,13000,0,0,0,0,0,0,2000,3000,1000,2000,0,0,0,15000
05904P,大立光統一96售07,0,0,0,0,0,0,0,0,0,14000,0,0,0,15000,1000,14000,14000
06059P,泰碩元大97售02  ,0,0,0,0,0,0,0,0,0,14000,0,0,0,128000,114000,14000,14000
06062P,宏達電元富97售01,0,0,0,0,0,0,0,0,0,14000,0,0,0,50000,36000,14000,14000
058286,道瓊指國票9B購01,0,0,0,0,0,0,0,0,0,14000,0,0,0,46000,32000,14000,14000
04626P,聯發科元大94售07,0,0,0,0,0,0,0,0,0,14000,0,0,0,26000,12000,14000,14000
04646P,TPK凱基94售03   ,0,0,0,0,0,0,0,0,0,14000,0,0,0,20000,6000,14000,14000
049632,臺股指群益94購05,0,0,0,0,0,0,0,0,0,14000,0,0,0,14000,0,14000,14000
047726,友達群益94購02  ,0,0,0,0,0,0,0,0,0,14000,0,0,0,14000,0,14000,14000
04868P,可成統一94售03  ,0,0,0,0,0,0,0,0,0,14000,0,0,0,14000,0,14000,14000
04892P,聯發科元大94售14,0,0,0,0,0,0,0,0,0,14000,0,0,0,15000,1000,14000,14000
049086,晶相光凱基94購01,0,0,0,0,0,0,0,0,0,14000,0,0,0,66000,52000,14000,14000
051762,國泰金元大95購01,0,0,0,0,0,0,0,0,0,14000,0,0,0,14000,0,14000,14000
051766,泰鼎元大95購02  ,0,0,0,0,0,0,0,0,0,14000,0,0,0,14000,0,14000,14000
050360,T50反1元大94購06,0,0,0,0,0,0,0,0,0,14000,0,0,0,14000,0,14000,14000
051383,京鼎群益96購02  ,0,0,0,0,0,0,0,0,0,14000,0,0,0,20000,6000,14000,14000
052177,京鼎元大95購02  ,0,0,0,0,0,0,0,0,0,14000,0,0,0,124000,110000,14000,14000
053601,台表科元大98購01,0,0,0,0,0,0,0,0,0,14000,0,0,0,14000,0,14000,14000
052316,台積電元大96購10,0,0,0,0,0,0,0,0,0,14000,0,0,0,24000,10000,14000,14000
053541,泰鼎永豐96購02  ,0,0,0,0,0,0,0,0,0,14000,0,0,0,24000,10000,14000,14000
052722,群創統一97購02  ,0,0,0,0,0,0,0,0,0,14000,0,0,0,14000,0,14000,14000
051801,牧德永豐95購04  ,0,0,0,0,0,0,0,0,0,14000,0,0,0,14000,0,14000,14000
050965,揚明光永豐96購01,0,0,0,0,0,0,0,0,0,14000,0,0,0,14000,0,14000,14000
055639,上銀元富97購02  ,0,0,0,0,0,0,0,0,0,14000,0,0,0,17000,3000,14000,14000
055905,可成兆豐97購03  ,0,0,0,0,0,0,0,0,0,14000,0,0,0,114000,100000,14000,14000
05594P,旺宏國票96售04  ,0,0,0,0,0,0,0,0,0,14000,0,0,0,34000,20000,14000,14000
054069,亞光國泰98購01  ,0,0,0,0,0,0,0,0,0,14000,0,0,0,92000,78000,14000,14000
1725,元禎            ,15000,1000,14000,0,0,0,0,0,0,0,0,0,0,0,0,0,14000
2033,佳大            ,15000,1000,14000,0,0,0,0,0,0,0,0,0,0,0,0,0,14000
06833P,矽力群益99售01  ,0,0,0,0,0,0,0,0,0,14000,0,0,0,15000,1000,14000,14000
06726P,欣興元富98售04  ,0,0,0,0,0,0,0,0,0,14000,0,0,0,198000,184000,14000,14000
06616P,國巨元大98售15  ,0,0,0,0,0,0,0,0,0,14000,0,0,0,64000,50000,14000,14000
06539P,聯發科凱基98售12,0,0,0,0,0,0,0,0,0,14000,0,0,0,220000,206000,14000,14000
06559P,玉晶光元富98售02,0,0,0,0,0,0,0,0,0,14000,0,0,0,28000,14000,14000,14000
06420P,大立光統一98售06,0,0,0,0,0,0,0,0,0,14000,0,0,0,14000,0,14000,14000
06100P,台積電日盛97售03,0,0,0,0,0,0,0,0,0,14000,0,0,0,1018000,1004000,14000,14000
2841,台開            ,491000,477000,14000,0,0,0,0,0,0,0,0,0,0,0,0,0,14000
6405,悅城            ,12000,1000,11000,0,0,0,0,0,0,3000,3000,0,3000,0,0,0,14000
6108,競國            ,130000,117000,13000,0,0,0,0,0,0,1000,4000,3000,1000,0,0,0,14000
5258,虹堡            ,74000,60000,14000,0,0,0,0,0,0,0,0,0,0,0,0,0,14000
057292,國巨國泰9B購01  ,0,0,0,0,0,0,0,0,0,13000,0,0,0,43000,30000,13000,13000
057201,華擎元富98購01  ,0,0,0,0,0,0,0,0,0,13000,0,0,0,20000,7000,13000,13000
048270,T50反1富邦99購01,0,0,0,0,0,0,0,0,0,13000,0,0,0,14000,1000,13000,13000
045088,康控元大94購02  ,0,0,0,0,0,0,0,0,0,13000,0,0,0,13000,0,13000,13000
03020X,元展20          ,0,0,0,0,0,0,0,0,0,13000,0,0,0,13000,0,13000,13000
03567P,可成凱基02售06  ,0,0,0,0,0,0,0,0,0,13000,0,0,0,13000,0,13000,13000
053194,緯穎統一99購01  ,0,0,0,0,0,0,0,0,0,13000,0,0,0,15000,2000,13000,13000
053502,智伸科兆豐97購01,0,0,0,0,0,0,0,0,0,13000,0,0,0,13000,0,13000,13000
053357,可成統一96購02  ,0,0,0,0,0,0,0,0,0,13000,0,0,0,439000,426000,13000,13000
053309,泰鼎凱基96購03  ,0,0,0,0,0,0,0,0,0,13000,0,0,0,13000,0,13000,13000
053302,國巨凱基96購10  ,0,0,0,0,0,0,0,0,0,13000,0,0,0,13000,0,13000,13000
050395,大立光元富94購10,0,0,0,0,0,0,0,0,0,13000,0,0,0,13000,0,13000,13000
051601,群創兆豐95購02  ,0,0,0,0,0,0,0,0,0,13000,0,0,0,15000,2000,13000,13000
054256,創意元大96購07  ,0,0,0,0,0,0,0,0,0,13000,0,0,0,91000,78000,13000,13000
055733,奇力新元富97購01,0,0,0,0,0,0,0,0,0,13000,0,0,0,13000,0,13000,13000
055272,國巨元大98購04  ,0,0,0,0,0,0,0,0,0,13000,0,0,0,106000,93000,13000,13000
4722,國精化          ,18000,6000,12000,0,0,0,0,0,0,1000,1000,0,1000,0,0,0,13000
8462,柏文            ,68000,55000,13000,0,0,0,0,0,0,0,0,0,0,0,0,0,13000
6655,科定            ,15000,0,15000,0,0,0,0,0,0,-2000,0,2000,-2000,0,0,0,13000
9941A,裕融甲特        ,0,0,0,0,0,0,0,0,0,13000,18000,5000,13000,0,0,0,13000
9905,大華            ,40000,27000,13000,0,0,0,0,0,0,0,0,0,0,0,0,0,13000
06138P,台積電中信99售01,0,0,0,0,0,0,0,0,0,13000,0,0,0,13000,0,13000,13000
06433P,大立光群益99售01,0,0,0,0,0,0,0,0,0,13000,0,0,0,16000,3000,13000,13000
06596P,元油2X富邦02售03,0,0,0,0,0,0,0,0,0,13000,0,0,0,13000,0,13000,13000
1235,興泰            ,14000,1000,13000,0,0,0,0,0,0,0,0,0,0,0,0,0,13000
2032,新鋼            ,17000,4000,13000,0,0,0,0,0,0,0,0,0,0,0,0,0,13000
057468,台郡永豐98購01  ,0,0,0,0,0,0,0,0,0,12000,0,0,0,68000,56000,12000,12000
056686,可成統一98購01  ,0,0,0,0,0,0,0,0,0,12000,0,0,0,48000,36000,12000,12000
056560,旺宏群益98購03  ,0,0,0,0,0,0,0,0,0,12000,0,0,0,90000,78000,12000,12000
05768P,台積電凱基96售15,0,0,0,0,0,0,0,0,0,12000,0,0,0,1266000,1254000,12000,12000
057695,S&P反1群益9B購01,0,0,0,0,0,0,0,0,0,12000,0,0,0,12000,0,12000,12000
06061P,訊芯統一97售01  ,0,0,0,0,0,0,0,0,0,12000,0,0,0,12000,0,12000,12000
06000P,GIS元大96售04   ,0,0,0,0,0,0,0,0,0,12000,0,0,0,27000,15000,12000,12000
06029P,聯發科台新96售02,0,0,0,0,0,0,0,0,0,12000,0,0,0,12000,0,12000,12000
043156,大立光統一94購01,0,0,0,0,0,0,0,0,0,12000,0,0,0,12000,0,12000,12000
047296,日月光元富96購01,0,0,0,0,0,0,0,0,0,12000,0,0,0,12000,0,12000,12000
049875,台積電永豐94購04,5000,0,5000,0,0,0,0,0,0,7000,0,0,0,13000,6000,7000,12000
047671,T50反1統一93購04,0,0,0,0,0,0,0,0,0,12000,0,0,0,12000,0,12000,12000
04771P,友達元大96售02  ,0,0,0,0,0,0,0,0,0,12000,0,0,0,312000,300000,12000,12000
052698,深中小國票99購01,0,0,0,0,0,0,0,0,0,12000,0,0,0,12000,0,12000,12000
05363P,臺股指富邦95售03,0,0,0,0,0,0,0,0,0,12000,0,0,0,12000,0,12000,12000
05245P,台積電元大95售18,0,0,0,0,0,0,0,0,0,12000,0,0,0,1398000,1386000,12000,12000
052378,矽力元大96購01  ,0,0,0,0,0,0,0,0,0,12000,0,0,0,57000,45000,12000,12000
052376,聯詠元大95購04  ,0,0,0,0,0,0,0,0,0,12000,0,0,0,12000,0,12000,12000
053527,創意中信97購01  ,0,0,0,0,0,0,0,0,0,12000,0,0,0,48000,36000,12000,12000
053735,矽力中信97購01  ,0,0,0,0,0,0,0,0,0,12000,0,0,0,30000,18000,12000,12000
053705,滬深2X凱基99購01,0,0,0,0,0,0,0,0,0,12000,0,0,0,167000,155000,12000,12000
051918,聯茂元大95購01  ,0,0,0,0,0,0,0,0,0,12000,0,0,0,188000,176000,12000,12000
050769,聯發科元大94購17,0,0,0,0,0,0,0,0,0,12000,0,0,0,12000,0,12000,12000
05118P,超眾元大96售04  ,0,0,0,0,0,0,0,0,0,12000,0,0,0,51000,39000,12000,12000
050496,鴻海富邦96購01  ,0,0,0,0,0,0,0,0,0,12000,0,0,0,12000,0,12000,12000
055330,上銀兆豐98購02  ,0,0,0,0,0,0,0,0,0,12000,0,0,0,50000,38000,12000,12000
056097,訊芯元富97購02  ,0,0,0,0,0,0,0,0,0,12000,0,0,0,12000,0,12000,12000
055056,億光永豐97購01  ,0,0,0,0,0,0,0,0,0,12000,0,0,0,18000,6000,12000,12000
054622,漢唐第一97購01  ,0,0,0,0,0,0,0,0,0,12000,0,0,0,12000,0,12000,12000
2227,裕日車          ,47000,34000,13000,0,0,0,2000,0,2000,-3000,2000,5000,-3000,0,0,0,12000
2365,昆盈            ,68000,25000,43000,0,0,0,0,0,0,-31000,0,31000,-31000,0,0,0,12000
1529,樂士            ,4000,0,4000,0,0,0,0,0,0,8000,8000,0,8000,0,0,0,12000
1541,錩泰            ,14000,1000,13000,0,0,0,0,0,0,-1000,1000,2000,-1000,0,0,0,12000
1444,力麗            ,373000,353000,20000,0,0,0,0,0,0,-8000,0,8000,-8000,0,0,0,12000
1419,新紡            ,14000,1000,13000,0,0,0,0,0,0,-1000,0,1000,-1000,0,0,0,12000
1321,大洋            ,101000,89000,12000,0,0,0,0,0,0,0,2000,2000,0,0,0,0,12000
06998P,S&P正2中信9B售01,0,0,0,0,0,0,0,0,0,12000,0,0,0,12000,0,12000,12000
06857P,超眾永豐98售02  ,0,0,0,0,0,0,0,0,0,12000,0,0,0,40000,28000,12000,12000
06903P,技嘉凱基98售04  ,0,0,0,0,0,0,0,0,0,12000,0,0,0,12000,0,12000,12000
06940P,旺宏永豐98售05  ,0,0,0,0,0,0,0,0,0,12000,0,0,0,62000,50000,12000,12000
4557,永新-KY         ,15000,3000,12000,0,0,0,0,0,0,0,0,0,0,0,0,0,12000
05919P,京鼎元大96售03  ,0,0,0,0,0,0,0,0,0,11000,0,0,0,100000,89000,11000,11000
05935P,台積電凱基96售19,0,0,0,0,0,0,0,0,0,11000,0,0,0,145000,134000,11000,11000
05849P,臺股指元大96售25,0,0,0,0,0,0,0,0,0,11000,0,0,0,11000,0,11000,11000
057931,正崴群益98購02  ,0,0,0,0,0,0,0,0,0,11000,0,0,0,11000,0,11000,11000
058005,茂林群益98購04  ,0,0,0,0,0,0,0,0,0,11000,0,0,0,11000,0,11000,11000
058092,牧德元大98購02  ,0,0,0,0,0,0,0,0,0,11000,0,0,0,83000,72000,11000,11000
058081,技嘉群益9A購03  ,0,0,0,0,0,0,0,0,0,11000,0,0,0,63000,52000,11000,11000
056442,瑞昱凱基98購02  ,0,0,0,0,0,0,0,0,0,11000,0,0,0,94000,83000,11000,11000
057434,國巨國票99購03  ,0,0,0,0,0,0,0,0,0,11000,0,0,0,29000,18000,11000,11000
057614,華新科元富99購04,0,0,0,0,0,0,0,0,0,11000,0,0,0,11000,0,11000,11000
057070,美律永豐98購02  ,0,0,0,0,0,0,0,0,0,11000,0,0,0,79000,68000,11000,11000
057341,技嘉台新98購01  ,0,0,0,0,0,0,0,0,0,11000,0,0,0,18000,7000,11000,11000
057223,富邦金日盛99購01,0,0,0,0,0,0,0,0,0,11000,0,0,0,105000,94000,11000,11000
05285P,同欣電群益95售02,0,0,0,0,0,0,0,0,0,11000,0,0,0,52000,41000,11000,11000
049044,和碩兆豐94購01  ,0,0,0,0,0,0,0,0,0,11000,0,0,0,71000,60000,11000,11000
04945P,鴻海永豐94售06  ,0,0,0,0,0,0,0,0,0,11000,0,0,0,11000,0,11000,11000
049842,道瓊反中信98購01,0,0,0,0,0,0,0,0,0,11000,0,0,0,40000,29000,11000,11000
047144,華通群益94購01  ,0,0,0,0,0,0,0,0,0,11000,0,0,0,11000,0,11000,11000
045115,玉晶光永豐94購01,0,0,0,0,0,0,0,0,0,11000,0,0,0,11000,0,11000,11000
047114,全新元大94購01  ,0,0,0,0,0,0,0,0,0,11000,0,0,0,11000,0,11000,11000
047014,元油反元大99購01,0,0,0,0,0,0,0,0,0,11000,0,0,0,21000,10000,11000,11000
04644P,全新凱基94售01  ,0,0,0,0,0,0,0,0,0,11000,0,0,0,11000,0,11000,11000
00684R,元大美元指數反1 ,0,0,0,0,0,0,0,0,0,11000,0,0,0,15000,4000,11000,11000
050656,瑞儀凱基96購01  ,0,0,0,0,0,0,0,0,0,11000,0,0,0,11000,0,11000,11000
050115,群創元大96購01  ,0,0,0,0,0,0,0,0,0,11000,0,0,0,29000,18000,11000,11000
05183P,台積電元富95售07,0,0,0,0,0,0,0,0,0,11000,0,0,0,11000,0,11000,11000
053513,義隆群益96購05  ,0,0,0,0,0,0,0,0,0,11000,0,0,0,111000,100000,11000,11000
050353,華擎群益95購01  ,0,0,0,0,0,0,0,0,0,11000,0,0,0,11000,0,11000,11000
051399,玉晶光台新96購01,0,0,0,0,0,0,0,0,0,11000,0,0,0,12000,1000,11000,11000
052202,矽力統一96購01  ,0,0,0,0,0,0,0,0,0,11000,0,0,0,11000,0,11000,11000
054576,健策元大98購03  ,0,0,0,0,0,0,0,0,0,11000,0,0,0,159000,148000,11000,11000
054862,群光群益97購01  ,0,0,0,0,0,0,0,0,0,11000,0,0,0,98000,87000,11000,11000
054968,佐登元大97購01  ,0,0,0,0,0,0,0,0,0,11000,0,0,0,18000,7000,11000,11000
053810,台達電群益96購01,0,0,0,0,0,0,0,0,0,11000,0,0,0,21000,10000,11000,11000
053778,旺宏元大97購03  ,0,0,0,0,0,0,0,0,0,11000,0,0,0,229000,218000,11000,11000
056059,美律元大98購02  ,0,0,0,0,0,0,0,0,0,11000,0,0,0,41000,30000,11000,11000
055486,國巨元大98購06  ,0,0,0,0,0,0,0,0,0,11000,0,0,0,76000,65000,11000,11000
4755,三福化          ,12000,1000,11000,0,0,0,0,0,0,0,0,0,0,0,0,0,11000
5283,禾聯碩          ,54000,44000,10000,0,0,0,0,0,0,1000,0,0,0,1000,0,1000,11000
6605,帝寶            ,51000,40000,11000,0,0,0,0,0,0,0,0,0,0,0,0,0,11000
6579,研揚            ,13000,2000,11000,0,0,0,0,0,0,0,0,0,0,0,0,0,11000
6431,光麗-KY         ,11000,0,11000,0,0,0,0,0,0,0,0,0,0,0,0,0,11000
2430,燦坤            ,10000,2000,8000,0,0,0,0,0,0,3000,3000,0,3000,0,0,0,11000
3528,安馳            ,15000,4000,11000,0,0,0,0,0,0,0,0,0,0,0,0,0,11000
3167,大量            ,29000,17000,12000,0,0,0,0,0,0,-1000,0,1000,-1000,0,0,0,11000
06925P,致茂群益9A售02  ,0,0,0,0,0,0,0,0,0,11000,0,0,0,20000,9000,11000,11000
06906P,國巨國泰99售01  ,0,0,0,0,0,0,0,0,0,11000,0,0,0,11000,0,11000,11000
06794P,臺股指凱基98售04,0,0,0,0,0,0,0,0,0,11000,0,0,0,11000,0,11000,11000
06779P,智邦元大98售12  ,0,0,0,0,0,0,0,0,0,11000,0,0,0,11000,0,11000,11000
1233,天仁            ,13000,2000,11000,0,0,0,0,0,0,0,0,0,0,0,0,0,11000
1109,信大            ,144000,136000,8000,0,0,0,0,0,0,3000,3000,0,3000,0,0,0,11000
1616,億泰            ,11000,0,11000,0,0,0,0,0,0,0,0,0,0,0,0,0,11000
1614,三洋電          ,28000,17000,11000,0,0,0,0,0,0,0,0,0,0,0,0,0,11000
06574P,大立光永昌99售01,0,0,0,0,0,0,0,0,0,11000,0,0,0,11000,0,11000,11000
06704P,玉晶光元富98售05,0,0,0,0,0,0,0,0,0,11000,0,0,0,21000,10000,11000,11000
06349P,臺股指台新99售01,0,0,0,0,0,0,0,0,0,11000,0,0,0,18000,7000,11000,11000
06265P,美律凱基97售01  ,0,0,0,0,0,0,0,0,0,11000,0,0,0,11000,0,11000,11000
06175P,台積電元大97售21,0,0,0,0,0,0,0,0,0,11000,0,0,0,86000,75000,11000,11000
057195,南茂元大98購01  ,0,0,0,0,0,0,0,0,0,10000,0,0,0,984000,974000,10000,10000
05726P,易華電永豐96售02,0,0,0,0,0,0,0,0,0,10000,0,0,0,10000,0,10000,10000
057261,瑞昱兆豐98購01  ,0,0,0,0,0,0,0,0,0,10000,0,0,0,30000,20000,10000,10000
05733P,臺股指統一96售03,0,0,0,0,0,0,0,0,0,10000,0,0,0,10000,0,10000,10000
05717P,鴻海元大97售07  ,0,0,0,0,0,0,0,0,0,10000,0,0,0,10000,0,10000,10000
057147,新日興國票99購01,0,0,0,0,0,0,0,0,0,10000,0,0,0,10000,0,10000,10000
057587,微星國票99購01  ,0,0,0,0,0,0,0,0,0,10000,0,0,0,10000,0,10000,10000
057555,玉晶光凱基9A購02,0,0,0,0,0,0,0,0,0,10000,0,0,0,25000,15000,10000,10000
057464,大立光永豐98購02,0,0,0,0,0,0,0,0,0,10000,0,0,0,10000,0,10000,10000
057471,昇陽半永豐98購02,0,0,0,0,0,0,0,0,0,10000,0,0,0,10000,0,10000,10000
05742P,可成元大96售04  ,0,0,0,0,0,0,0,0,0,10000,0,0,0,74000,64000,10000,10000
057433,上銀國票98購04  ,0,0,0,0,0,0,0,0,0,10000,0,0,0,20000,10000,10000,10000
056495,泰鼎國泰99購01  ,0,0,0,0,0,0,0,0,0,10000,0,0,0,30000,20000,10000,10000
056473,奇力新元大99購02,0,0,0,0,0,0,0,0,0,10000,0,0,0,10000,0,10000,10000
056563,華新科群益98購04,0,0,0,0,0,0,0,0,0,10000,0,0,0,30000,20000,10000,10000
056511,超眾永豐98購01  ,0,0,0,0,0,0,0,0,0,10000,0,0,0,10000,0,10000,10000
056734,國巨凱基99購01  ,0,0,0,0,0,0,0,0,0,10000,0,0,0,30000,20000,10000,10000
056736,國巨凱基99購03  ,0,0,0,0,0,0,0,0,0,10000,0,0,0,10000,0,10000,10000
056798,華新科麥證98購01,0,0,0,50000,40000,10000,0,0,0,10000,0,0,0,50000,40000,10000,10000
05679P,台表科群益96售05,0,0,0,0,0,0,0,0,0,10000,0,0,0,10000,0,10000,10000
056890,國巨元大98購11  ,0,0,0,0,0,0,0,0,0,10000,0,0,0,10000,0,10000,10000
056988,聚陽兆豐98購01  ,0,0,0,0,0,0,0,0,0,10000,0,0,0,30000,20000,10000,10000
05691P,聯發科中信98售01,0,0,0,0,0,0,0,0,0,10000,0,0,0,10000,0,10000,10000
056922,全新兆豐99購01  ,0,0,0,0,0,0,0,0,0,10000,0,0,0,10000,0,10000,10000
056917,國巨兆豐98購03  ,0,0,0,0,0,0,0,0,0,10000,0,0,0,15000,5000,10000,10000
057995,華新科中信98購02,0,0,0,0,0,0,0,0,0,10000,0,0,0,10000,0,10000,10000
058041,FBVIX元大98購02 ,0,0,0,0,0,0,0,0,0,10000,0,0,0,10000,0,10000,10000
058181,華新科國泰9B購01,0,0,0,0,0,0,0,0,0,10000,0,0,0,10000,0,10000,10000
05814P,臺股指國票96售07,0,0,0,0,0,0,0,0,0,10000,0,0,0,10000,0,10000,10000
057958,禾伸堂元大99購05,0,0,0,0,0,0,0,0,0,10000,0,0,0,16000,6000,10000,10000
057810,技嘉元大98購06  ,0,0,0,0,0,0,0,0,0,10000,0,0,0,10000,0,10000,10000
057881,SP黃豆群益9A購01,0,0,0,0,0,0,0,0,0,10000,0,0,0,10000,0,10000,10000
05845P,大立光元大96售06,0,0,0,0,0,0,0,0,0,10000,0,0,0,220000,210000,10000,10000
058592,聯發科統一9C購01,0,0,0,0,0,0,0,0,0,10000,0,0,0,40000,30000,10000,10000
058313,台積電富邦9B購04,0,0,0,0,0,0,0,0,0,10000,0,0,0,358000,348000,10000,10000
058303,華通元大99購03  ,0,0,0,0,0,0,0,0,0,10000,0,0,0,87000,77000,10000,10000
05843P,台積電元大96售16,0,0,0,0,0,0,0,0,0,10000,0,0,0,11000,1000,10000,10000
05915P,聯發科元大96售19,0,0,0,0,0,0,0,0,0,10000,0,0,0,10000,0,10000,10000
05943P,欣興凱基96售03  ,0,0,0,0,0,0,0,0,0,10000,0,0,0,56000,46000,10000,10000
05960P,欣興統一96售01  ,0,0,0,0,0,0,0,0,0,10000,0,0,0,10000,0,10000,10000
06051P,嘉聯益國票97售04,0,0,0,0,0,0,0,0,0,10000,0,0,0,50000,40000,10000,10000
04070P,臺股指凱基93售06,0,0,0,0,0,0,0,0,0,10000,0,0,0,60000,50000,10000,10000
04032P,聯茂凱基94售02  ,0,0,0,0,0,0,0,0,0,10000,0,0,0,10000,0,10000,10000
04272P,元上證凱基94售01,0,0,0,0,0,0,0,0,0,10000,0,0,0,20000,10000,10000,10000
03202P,聯電凱基01售03  ,0,0,0,0,0,0,0,0,0,10000,0,0,0,10000,0,10000,10000
04263P,南電群益93售03  ,0,0,0,0,0,0,0,0,0,10000,0,0,0,10000,0,10000,10000
04264P,宏碁統一93售01  ,0,0,0,0,0,0,0,0,0,10000,0,0,0,10000,0,10000,10000
04213P,台光電凱基93售11,0,0,0,0,0,0,0,0,0,10000,0,0,0,10000,0,10000,10000
04104P,臺股指國票93售11,0,0,0,0,0,0,0,0,0,10000,0,0,0,10000,0,10000,10000
046450,鴻海凱基93購12  ,0,0,0,0,0,0,0,0,0,10000,0,0,0,20000,10000,10000,10000
046486,樺漢國泰94購01  ,0,0,0,0,0,0,0,0,0,10000,0,0,0,89000,79000,10000,10000
046348,嘉澤兆豐93購01  ,0,0,0,0,0,0,0,0,0,10000,0,0,0,10000,0,10000,10000
04439P,聯發科群益94售04,0,0,0,0,0,0,0,0,0,10000,0,0,0,10000,0,10000,10000
04397P,玉晶光群益95售03,0,0,0,0,0,0,0,0,0,10000,0,0,0,70000,60000,10000,10000
044039,康控群益93購01  ,0,0,0,0,0,0,0,0,0,10000,0,0,0,10000,0,10000,10000
04411P,智易統一96售01  ,0,0,0,0,0,0,0,0,0,10000,0,0,0,10000,0,10000,10000
04004P,智伸科凱基93售06,0,0,0,0,0,0,0,0,0,10000,0,0,0,10000,0,10000,10000
03953P,易華電凱基94售01,0,0,0,0,0,0,0,0,0,10000,0,0,0,10000,0,10000,10000
03026X,元展23          ,0,0,0,0,0,0,0,0,0,10000,0,0,0,10000,0,10000,10000
04625P,燿華元大94售03  ,0,0,0,0,0,0,0,0,0,10000,0,0,0,10000,0,10000,10000
045897,泰鼎元大93購04  ,0,0,0,0,0,0,0,0,0,10000,0,0,0,10000,0,10000,10000
045817,滬深2X凱基95購02,0,0,0,0,0,0,0,0,0,10000,0,0,0,10000,0,10000,10000
04360P,易華電永豐94售01,0,0,0,0,0,0,0,0,0,10000,0,0,0,10000,0,10000,10000
04350P,欣興國票94售01  ,0,0,0,0,0,0,0,0,0,10000,0,0,0,60000,50000,10000,10000
043730,旭富國泰93購01  ,0,0,0,0,0,0,0,0,0,10000,0,0,0,10000,0,10000,10000
04691P,智邦群益94售02  ,0,0,0,0,0,0,0,0,0,10000,0,0,0,10000,0,10000,10000
04505P,佳世達元富96售03,0,0,0,0,0,0,0,0,0,10000,0,0,0,55000,45000,10000,10000
045331,旺宏群益94購01  ,0,0,0,0,0,0,0,0,0,10000,0,0,0,21000,11000,10000,10000
045627,聯電凱基93購03  ,0,0,0,0,0,0,0,0,0,10000,0,0,0,10000,0,10000,10000
045630,技嘉凱基93購02  ,0,0,0,0,0,0,0,0,0,10000,0,0,0,20000,10000,10000,10000
04480P,微星兆豐94售01  ,0,0,0,0,0,0,0,0,0,10000,0,0,0,10000,0,10000,10000
04470P,為升元大94售01  ,0,0,0,0,0,0,0,0,0,10000,0,0,0,10000,0,10000,10000
044735,光磊國泰93購01  ,0,0,0,0,0,0,0,0,0,10000,0,0,0,10000,0,10000,10000
04716P,中石化凱基94售01,0,0,0,0,0,0,0,0,0,10000,0,0,0,10000,0,10000,10000
04721P,正崴凱基94售02  ,0,0,0,0,0,0,0,0,0,10000,0,0,0,10000,0,10000,10000
04726P,TPK凱基94售04   ,0,0,0,0,0,0,0,0,0,10000,0,0,0,10000,0,10000,10000
04732P,聯茂群益94售01  ,0,0,0,0,0,0,0,0,0,10000,0,0,0,10000,0,10000,10000
04734P,上海銀兆豐94售02,0,0,0,0,0,0,0,0,0,10000,0,0,0,10000,0,10000,10000
048194,華邦電元大94購04,0,0,0,0,0,0,0,0,0,10000,0,0,0,10000,0,10000,10000
048227,亞光凱基93購05  ,0,0,0,0,0,0,0,0,0,10000,0,0,0,10000,0,10000,10000
048214,滬深2X凱基96購03,0,0,0,0,0,0,0,0,0,10000,0,0,0,20000,10000,10000,10000
048144,華固統一93購01  ,0,0,0,0,0,0,0,0,0,10000,0,0,0,10000,0,10000,10000
048162,矽力麥證93購01  ,0,0,0,21000,11000,10000,0,0,0,10000,0,0,0,21000,11000,10000,10000
048165,嘉澤康和93購01  ,0,0,0,0,0,0,0,0,0,10000,0,0,0,10000,0,10000,10000
048175,矽力國泰95購01  ,0,0,0,0,0,0,0,0,0,10000,0,0,0,10000,0,10000,10000
049610,奇力新兆豐95購01,0,0,0,0,0,0,0,0,0,10000,0,0,0,10000,0,10000,10000
049601,矽創元大95購02  ,0,0,0,0,0,0,0,0,0,10000,0,0,0,10000,0,10000,10000
049561,道瓊銀統一96購01,0,0,0,0,0,0,0,0,0,10000,0,0,0,10000,0,10000,10000
049569,光磊統一94購02  ,0,0,0,0,0,0,0,0,0,10000,0,0,0,20000,10000,10000,10000
049311,漢唐凱基94購03  ,0,0,0,0,0,0,0,0,0,10000,0,0,0,10000,0,10000,10000
050046,矽力兆豐94購01  ,0,0,0,0,0,0,0,0,0,10000,0,0,0,10000,0,10000,10000
05004P,健策統一95售01  ,0,0,0,0,0,0,0,0,0,10000,0,0,0,10000,0,10000,10000
049259,聯發科元大94購04,0,0,0,0,0,0,0,0,0,10000,0,0,0,10000,0,10000,10000
049835,緯穎凱基94購05  ,0,0,0,0,0,0,0,0,0,10000,0,0,0,15000,5000,10000,10000
049898,緯穎統一95購01  ,0,0,0,0,0,0,0,0,0,10000,0,0,0,10000,0,10000,10000
049705,緯穎元大94購05  ,0,0,0,0,0,0,0,0,0,10000,0,0,0,10000,0,10000,10000
049751,牧德永豐95購01  ,0,0,0,0,0,0,0,0,0,10000,0,0,0,20000,10000,10000,10000
048288,T50反1群益93購05,0,0,0,0,0,0,0,0,0,10000,0,0,0,10000,0,10000,10000
048373,A50正2元富95購01,0,0,0,0,0,0,0,0,0,10000,0,0,0,10000,0,10000,10000
049374,大立光元大94購12,0,0,0,0,0,0,0,0,0,10000,0,0,0,10000,0,10000,10000
049477,泰鼎永豐94購01  ,0,0,0,0,0,0,0,0,0,10000,0,0,0,30000,20000,10000,10000
047588,大立光永豐94購01,0,0,0,0,0,0,0,0,0,10000,0,0,0,10000,0,10000,10000
04855P,上証2X元富94售02,0,0,0,0,0,0,0,0,0,10000,0,0,0,20000,10000,10000,10000
048568,緯穎元大93購06  ,0,0,0,0,0,0,0,0,0,10000,0,0,0,10000,0,10000,10000
049436,義隆國泰96購02  ,0,0,0,0,0,0,0,0,0,10000,0,0,0,31000,21000,10000,10000
048519,緯穎凱基93購02  ,0,0,0,0,0,0,0,0,0,10000,0,0,0,10000,0,10000,10000
048548,緯穎永豐93購02  ,0,0,0,0,0,0,0,0,0,10000,0,0,0,10000,0,10000,10000
047735,華邦電台新94購01,0,0,0,0,0,0,0,0,0,10000,0,0,0,10000,0,10000,10000
047670,矽力永豐93購01  ,0,0,0,0,0,0,0,0,0,10000,0,0,0,10000,0,10000,10000
047643,新光金元大95購02,0,0,0,0,0,0,0,0,0,10000,0,0,0,10000,0,10000,10000
047987,力成群益93購01  ,0,0,0,0,0,0,0,0,0,10000,0,0,0,10000,0,10000,10000
047967,南亞科國泰95購01,0,0,0,0,0,0,0,0,0,10000,0,0,0,10000,0,10000,10000
047973,華通兆豐94購01  ,0,0,0,0,0,0,0,0,0,10000,0,0,0,25000,15000,10000,10000
047930,嘉澤凱基93購03  ,0,0,0,0,0,0,0,0,0,10000,0,0,0,20000,10000,10000,10000
047911,晶技麥證94購01  ,0,0,0,10000,0,10000,0,0,0,10000,0,0,0,10000,0,10000,10000
047887,智原富邦97購01  ,0,0,0,0,0,0,0,0,0,10000,0,0,0,10000,0,10000,10000
048070,聯發科元富99購03,0,0,0,0,0,0,0,0,0,10000,0,0,0,26000,16000,10000,10000
048097,聯詠凱基93購07  ,0,0,0,0,0,0,0,0,0,10000,0,0,0,80000,70000,10000,10000
04906P,欣興國票95售01  ,0,0,0,0,0,0,0,0,0,10000,0,0,0,10000,0,10000,10000
04905P,國巨國票94售04  ,0,0,0,0,0,0,0,0,0,10000,0,0,0,10000,0,10000,10000
049102,智伸科國泰96購01,0,0,0,0,0,0,0,0,0,10000,0,0,0,10000,0,10000,10000
049172,鴻海凱基94購14  ,0,0,0,0,0,0,0,0,0,10000,0,0,0,20000,10000,10000,10000
048910,和鑫富邦98購01  ,0,0,0,0,0,0,0,0,0,10000,0,0,0,10000,0,10000,10000
048876,牧德國票95購02  ,0,0,0,0,0,0,0,0,0,10000,0,0,0,10000,0,10000,10000
049014,台達電群益94購02,0,0,0,0,0,0,0,0,0,10000,0,0,0,22000,12000,10000,10000
048678,統一富邦93購01  ,0,0,0,0,0,0,0,0,0,10000,0,0,0,10000,0,10000,10000
048706,緯穎國票94購01  ,0,0,0,0,0,0,0,0,0,10000,0,0,0,10000,0,10000,10000
048616,智伸科凱基93購07,0,0,0,0,0,0,0,0,0,10000,0,0,0,10000,0,10000,10000
048128,超眾元大95購01  ,0,0,0,0,0,0,0,0,0,10000,0,0,0,10000,0,10000,10000
048576,義隆國泰95購01  ,0,0,0,0,0,0,0,0,0,10000,0,0,0,50000,40000,10000,10000
048600,嘉澤國票94購01  ,0,0,0,0,0,0,0,0,0,10000,0,0,0,20000,10000,10000,10000
048751,京鼎元富96購01  ,0,0,0,0,0,0,0,0,0,10000,0,0,0,10000,0,10000,10000
048735,美利達麥證95購01,0,0,0,10000,0,10000,0,0,0,10000,0,0,0,10000,0,10000,10000
048789,大立光元大95購04,0,0,0,0,0,0,0,0,0,10000,0,0,0,10000,0,10000,10000
052859,國巨凱基96購07  ,0,0,0,0,0,0,0,0,0,10000,0,0,0,10000,0,10000,10000
052566,國巨凱基96購04  ,0,0,0,0,0,0,0,0,0,10000,0,0,0,23000,13000,10000,10000
052662,華新科國票97購01,0,0,0,0,0,0,0,0,0,10000,0,0,0,24000,14000,10000,10000
049234,可成統一94購02  ,0,0,0,0,0,0,0,0,0,10000,0,0,0,10000,0,10000,10000
052765,新日興群益97購01,0,0,0,0,0,0,0,0,0,10000,0,0,0,10000,0,10000,10000
05138P,嘉聯益凱基96售02,0,0,0,0,0,0,0,0,0,10000,0,0,0,57000,47000,10000,10000
050464,華通國泰95購01  ,0,0,0,0,0,0,0,0,0,10000,0,0,0,10000,0,10000,10000
050482,台郡國票94購04  ,0,0,0,0,0,0,0,0,0,10000,0,0,0,10000,0,10000,10000
050485,國巨統一96購01  ,0,0,0,0,0,0,0,0,0,10000,0,0,0,10000,0,10000,10000
052174,聯發科元大95購13,0,0,0,0,0,0,0,0,0,10000,0,0,0,10000,0,10000,10000
052181,南茂元大95購05  ,0,0,0,0,0,0,0,0,0,10000,0,0,0,58000,48000,10000,10000
050446,鴻海元大94購22  ,0,0,0,0,0,0,0,0,0,10000,0,0,0,15000,5000,10000,10000
050414,泰鼎永豐94購04  ,0,0,0,0,0,0,0,0,0,10000,0,0,0,10000,0,10000,10000
050420,鴻海凱基95購03  ,0,0,0,0,0,0,0,0,0,10000,0,0,0,10000,0,10000,10000
05273P,國巨群益95售02  ,0,0,0,0,0,0,0,0,0,10000,0,0,0,10000,0,10000,10000
052737,滬深2X元大96購06,0,0,0,0,0,0,0,0,0,10000,0,0,0,20000,10000,10000,10000
051257,光寶科國泰96購01,0,0,0,0,0,0,0,0,0,10000,0,0,0,10000,0,10000,10000
050384,嘉澤國票94購02  ,0,0,0,0,0,0,0,0,0,10000,0,0,0,20000,10000,10000,10000
051313,緯創麥證95購02  ,0,0,0,10000,0,10000,0,0,0,10000,0,0,0,10000,0,10000,10000
051550,日電貿永豐95購01,0,0,0,0,0,0,0,0,0,10000,0,0,0,10000,0,10000,10000
051526,超眾凱基95購02  ,0,0,0,0,0,0,0,0,0,10000,0,0,0,59000,49000,10000,10000
051743,揚明光國票96購02,0,0,0,0,0,0,0,0,0,10000,0,0,0,10000,0,10000,10000
052077,可成元富98購02  ,0,0,0,0,0,0,0,0,0,10000,0,0,0,10000,0,10000,10000
052073,矽力統一95購03  ,0,0,0,0,0,0,0,0,0,10000,0,0,0,10000,0,10000,10000
052104,英業達兆豐96購01,0,0,0,0,0,0,0,0,0,10000,0,0,0,110000,100000,10000,10000
051791,智伸科國票96購01,0,0,0,0,0,0,0,0,0,10000,0,0,0,10000,0,10000,10000
051795,T50反1台新05購02,0,0,0,0,0,0,0,0,0,10000,0,0,0,10000,0,10000,10000
051796,和碩康和95購01  ,0,0,0,0,0,0,0,0,0,10000,0,0,0,10000,0,10000,10000
053542,超眾永豐96購01  ,0,0,0,0,0,0,0,0,0,10000,0,0,0,10000,0,10000,10000
053574,奇力新元富99購01,0,0,0,0,0,0,0,0,0,10000,0,0,0,30000,20000,10000,10000
053359,矽力統一96購02  ,0,0,0,0,0,0,0,0,0,10000,0,0,0,10000,0,10000,10000
053442,光罩凱基96購01  ,0,0,0,0,0,0,0,0,0,10000,0,0,0,10000,0,10000,10000
052406,力成凱基95購03  ,0,0,0,0,0,0,0,0,0,10000,0,0,0,10000,0,10000,10000
05226P,智邦統一95售01  ,0,0,0,0,0,0,0,0,0,10000,0,0,0,10000,0,10000,10000
052459,道瓊反統一95購04,0,0,0,0,0,0,0,0,0,10000,0,0,0,10000,0,10000,10000
052430,泰碩永豐95購02  ,0,0,0,0,0,0,0,0,0,10000,0,0,0,10000,0,10000,10000
05328P,臺股指凱基95售12,0,0,0,0,0,0,0,0,0,10000,0,0,0,10000,0,10000,10000
052485,深中小國票96購01,0,0,0,0,0,0,0,0,0,10000,0,0,0,10000,0,10000,10000
053650,華邦電凱基98購01,0,0,0,0,0,0,0,0,0,10000,0,0,0,10000,0,10000,10000
050986,上証2X永昌97購01,0,0,0,0,0,0,0,0,0,10000,0,0,0,509000,499000,10000,10000
05012P,台積電元大95售07,0,0,0,0,0,0,0,0,0,10000,0,0,0,10000,0,10000,10000
050191,和碩元大94購02  ,0,0,0,0,0,0,0,0,0,10000,0,0,0,110000,100000,10000,10000
050171,臺指反元大97購03,0,0,0,0,0,0,0,0,0,10000,0,0,0,10000,0,10000,10000
050141,國巨統一94購07  ,0,0,0,0,0,0,0,0,0,10000,0,0,0,10000,0,10000,10000
050176,正崴元大94購03  ,0,0,0,0,0,0,0,0,0,10000,0,0,0,10000,0,10000,10000
050179,全新元大96購02  ,0,0,0,0,0,0,0,0,0,10000,0,0,0,20000,10000,10000,10000
050122,臺指反凱基96購01,0,0,0,0,0,0,0,0,0,10000,0,0,0,10000,0,10000,10000
050113,欣興元大95購05  ,0,0,0,0,0,0,0,0,0,10000,0,0,0,30000,20000,10000,10000
050094,T50反1國泰95購01,0,0,0,0,0,0,0,0,0,10000,0,0,0,10000,0,10000,10000
050941,T50反1群益95購01,0,0,0,0,0,0,0,0,0,10000,0,0,0,190000,180000,10000,10000
050927,聯詠凱基95購01  ,0,0,0,0,0,0,0,0,0,10000,0,0,0,10000,0,10000,10000
052590,祥碩永豐96購01  ,0,0,0,0,0,0,0,0,0,10000,0,0,0,10000,0,10000,10000
052633,國巨凱基96購05  ,0,0,0,0,0,0,0,0,0,10000,0,0,0,13000,3000,10000,10000
052636,大立光凱基96購10,0,0,0,0,0,0,0,0,0,10000,0,0,0,410000,400000,10000,10000
053048,同欣電麥證96購01,0,0,0,20000,10000,10000,0,0,0,10000,0,0,0,20000,10000,10000,10000
051935,味全群益95購01  ,0,0,0,0,0,0,0,0,0,10000,0,0,0,10000,0,10000,10000
05299P,旺宏元大95售04  ,0,0,0,0,0,0,0,0,0,10000,0,0,0,10000,0,10000,10000
051887,上証2X元富98購01,0,0,0,0,0,0,0,0,0,10000,0,0,0,10000,0,10000,10000
050211,貿聯國票95購01  ,0,0,0,0,0,0,0,0,0,10000,0,0,0,10000,0,10000,10000
051001,緯穎元大96購02  ,0,0,0,0,0,0,0,0,0,10000,0,0,0,94000,84000,10000,10000
05318P,臺股指永昌95售03,0,0,0,0,0,0,0,0,0,10000,10000,0,10000,0,0,0,10000
053199,旺宏日盛96購01  ,0,0,0,0,0,0,0,0,0,10000,0,0,0,10000,0,10000,10000
053158,茂林元大96購01  ,0,0,0,0,0,0,0,0,0,10000,0,0,0,75000,65000,10000,10000
053142,緯穎永豐96購01  ,0,0,0,0,0,0,0,0,0,10000,0,0,0,50000,40000,10000,10000
053127,貿聯凱基97購01  ,0,0,0,0,0,0,0,0,0,10000,0,0,0,10000,0,10000,10000
050642,和大凱基94購03  ,0,0,0,0,0,0,0,0,0,10000,0,0,0,10000,0,10000,10000
050671,超眾永豐94購04  ,0,0,0,0,0,0,0,0,0,10000,0,0,0,10000,0,10000,10000
050672,上証2X富邦97購01,0,0,0,0,0,0,0,0,0,10000,0,0,0,10000,0,10000,10000
05060P,台達電富邦97售02,0,0,0,0,0,0,0,0,0,10000,0,0,0,10000,0,10000,10000
050610,鴻海元大94購24  ,0,0,0,0,0,0,0,0,0,10000,0,0,0,78000,68000,10000,10000
050218,世紀鋼統一94購02,0,0,0,0,0,0,0,0,0,10000,0,0,0,318000,308000,10000,10000
050262,台積電元大94購21,0,0,0,0,0,0,0,0,0,10000,0,0,0,68000,58000,10000,10000
050307,欣興中信95購01  ,0,0,0,0,0,0,0,0,0,10000,0,0,0,110000,100000,10000,10000
051206,大立光麥證95購02,0,0,0,10000,0,10000,0,0,0,10000,0,0,0,10000,0,10000,10000
052016,神基永豐95購01  ,0,0,0,0,0,0,0,0,0,10000,0,0,0,10000,0,10000,10000
050730,復盛國票94購01  ,0,0,0,0,0,0,0,0,0,10000,0,0,0,10000,0,10000,10000
050792,可成富邦96購01  ,0,0,0,0,0,0,0,0,0,10000,0,0,0,220000,210000,10000,10000
05552P,聯詠群益96售01  ,0,0,0,0,0,0,0,0,0,10000,0,0,0,10000,0,10000,10000
055628,旺宏永豐97購01  ,0,0,0,0,0,0,0,0,0,10000,0,0,0,10000,0,10000,10000
055613,全新國票98購01  ,0,0,0,0,0,0,0,0,0,10000,0,0,0,10000,0,10000,10000
055772,致茂凱基97購01  ,0,0,0,0,0,0,0,0,0,10000,0,0,0,10000,0,10000,10000
055798,聯茂富邦98購01  ,0,0,0,0,0,0,0,0,0,10000,0,0,0,50000,40000,10000,10000
05566P,景碩永豐96售01  ,0,0,0,0,0,0,0,0,0,10000,0,0,0,20000,10000,10000,10000
055339,緯穎兆豐98購01  ,0,0,0,0,0,0,0,0,0,10000,0,0,0,10000,0,10000,10000
05539P,鎧勝永豐96售01  ,0,0,0,0,0,0,0,0,0,10000,0,0,0,10000,0,10000,10000
055400,緯穎統一97購01  ,0,0,0,0,0,0,0,0,0,10000,0,0,0,10000,0,10000,10000
055411,國巨富邦9A購02  ,0,0,0,0,0,0,0,0,0,10000,0,0,0,10000,0,10000,10000
055419,國巨永豐97購03  ,0,0,0,0,0,0,0,0,0,10000,0,0,0,10000,0,10000,10000
055246,美律統一98購01  ,0,0,0,0,0,0,0,0,0,10000,0,0,0,10000,0,10000,10000
05606P,TPK國票97售02   ,0,0,0,0,0,0,0,0,0,10000,0,0,0,10000,0,10000,10000
056124,華通國票98購02  ,0,0,0,0,0,0,0,0,0,10000,0,0,0,10000,0,10000,10000
05611P,康控群益96售02  ,0,0,0,0,0,0,0,0,0,10000,0,0,0,10000,0,10000,10000
056129,義隆麥證97購01  ,0,0,0,10000,0,10000,0,0,0,10000,0,0,0,10000,0,10000,10000
055849,聯詠元大97購05  ,0,0,0,0,0,0,0,0,0,10000,0,0,0,10000,0,10000,10000
055858,聯茂元大97購03  ,0,0,0,0,0,0,0,0,0,10000,0,0,0,457000,447000,10000,10000
056164,聯茂凱基98購03  ,0,0,0,0,0,0,0,0,0,10000,0,0,0,10000,0,10000,10000
056142,超眾元大97購06  ,0,0,0,0,0,0,0,0,0,10000,0,0,0,10000,0,10000,10000
056160,智易凱基97購03  ,0,0,0,0,0,0,0,0,0,10000,0,0,0,10000,0,10000,10000
056272,嘉澤統一99購01  ,0,0,0,0,0,0,0,0,0,10000,0,0,0,20000,10000,10000,10000
056325,群創兆豐9A購01  ,0,0,0,0,0,0,0,0,0,10000,0,0,0,10000,0,10000,10000
056400,道瓊反群益9C購01,0,0,0,0,0,0,0,0,0,10000,0,0,0,10000,0,10000,10000
056433,鴻海凱基98購09  ,0,0,0,0,0,0,0,0,0,10000,0,0,0,100000,90000,10000,10000
056427,上銀凱基98購03  ,0,0,0,0,0,0,0,0,0,10000,0,0,0,20000,10000,10000,10000
053752,超眾永豐96購02  ,0,0,0,0,0,0,0,0,0,10000,0,0,0,10000,0,10000,10000
053790,嘉聯益元大99購02,0,0,0,0,0,0,0,0,0,10000,0,0,0,10000,0,10000,10000
053924,京鼎國票97購01  ,0,0,0,0,0,0,0,0,0,10000,0,0,0,10000,0,10000,10000
054083,智伸科元富96購01,0,0,0,0,0,0,0,0,0,10000,0,0,0,10000,0,10000,10000
054060,晶技國票97購02  ,0,0,0,0,0,0,0,0,0,10000,0,0,0,10000,0,10000,10000
053938,彩晶元富96購01  ,0,0,0,0,0,0,0,0,0,10000,0,0,0,10000,0,10000,10000
053952,南亞科台新96購01,0,0,0,0,0,0,0,0,0,10000,0,0,0,10000,0,10000,10000
05398P,康控國票96售03  ,0,0,0,0,0,0,0,0,0,10000,0,0,0,10000,0,10000,10000
053998,泰鼎群益98購01  ,0,0,0,0,0,0,0,0,0,10000,0,0,0,50000,40000,10000,10000
054240,訊芯群益96購03  ,0,0,0,0,0,0,0,0,0,10000,0,0,0,10000,0,10000,10000
054189,貿聯永豐96購03  ,0,0,0,0,0,0,0,0,0,10000,0,0,0,10000,0,10000,10000
05417P,燿華永豐95售07  ,0,0,0,0,0,0,0,0,0,10000,0,0,0,20000,10000,10000,10000
054183,亞光康和96購01  ,0,0,0,0,0,0,0,0,0,10000,0,0,0,10000,0,10000,10000
054406,旺宏國票98購01  ,0,0,0,0,0,0,0,0,0,10000,0,0,0,10000,0,10000,10000
054428,禾伸堂富邦98購01,0,0,0,0,0,0,0,0,0,10000,0,0,0,22000,12000,10000,10000
054292,欣興元大96購06  ,0,0,0,0,0,0,0,0,0,10000,0,0,0,143000,133000,10000,10000
054346,世芯國票97購01  ,0,0,0,0,0,0,0,0,0,10000,0,0,0,10000,0,10000,10000
054347,上緯控國票96購02,0,0,0,0,0,0,0,0,0,10000,0,0,0,30000,20000,10000,10000
054359,南亞科日盛96購02,0,0,0,0,0,0,0,0,0,10000,0,0,0,10000,0,10000,10000
054949,奇力新元大98購01,0,0,0,0,0,0,0,0,0,10000,0,0,0,10000,0,10000,10000
054959,禾伸堂元大98購01,0,0,0,0,0,0,0,0,0,10000,0,0,0,20000,10000,10000,10000
05483P,國巨凱基95售07  ,0,0,0,0,0,0,0,0,0,10000,0,0,0,10000,0,10000,10000
054828,正崴國泰99購01  ,0,0,0,0,0,0,0,0,0,10000,0,0,0,20000,10000,10000,10000
054913,億光凱基97購01  ,0,0,0,0,0,0,0,0,0,10000,0,0,0,11000,1000,10000,10000
05503P,智邦日盛96售01  ,0,0,0,0,0,0,0,0,0,10000,0,0,0,10000,0,10000,10000
055072,康友永豐97購02  ,0,0,0,0,0,0,0,0,0,10000,0,0,0,10000,0,10000,10000
055019,福懋科元富97購01,0,0,0,0,0,0,0,0,0,10000,0,0,0,45000,35000,10000,10000
054625,旺宏凱基98購03  ,0,0,0,0,0,0,0,0,0,10000,0,0,0,10000,0,10000,10000
05462P,美律亞東97售01  ,0,0,0,0,0,0,0,0,0,10000,0,0,0,10000,0,10000,10000
054805,台苯元大9A購01  ,0,0,0,0,0,0,0,0,0,10000,0,0,0,78000,68000,10000,10000
054748,正文凱基98購01  ,0,0,0,0,0,0,0,0,0,10000,0,0,0,10000,0,10000,10000
054749,聯茂凱基98購01  ,0,0,0,0,0,0,0,0,0,10000,0,0,0,10000,0,10000,10000
054740,強茂凱基99購01  ,0,0,0,0,0,0,0,0,0,10000,0,0,0,10000,0,10000,10000
05471P,聯電統一95售01  ,0,0,0,0,0,0,0,0,0,10000,0,0,0,60000,50000,10000,10000
054670,康友元富97購01  ,0,0,0,0,0,0,0,0,0,10000,0,0,0,75000,65000,10000,10000
054655,貿聯麥證98購01  ,0,0,0,10000,0,10000,0,0,0,10000,0,0,0,10000,0,10000,10000
06180P,禾伸堂群益97售01,0,0,0,0,0,0,0,0,0,10000,0,0,0,10000,0,10000,10000
06156P,大立光統一97售05,0,0,0,0,0,0,0,0,0,10000,0,0,0,14000,4000,10000,10000
06107P,美律群益98售02  ,0,0,0,0,0,0,0,0,0,10000,0,0,0,10000,0,10000,10000
06278P,臺股指凱基97售10,0,0,0,0,0,0,0,0,0,10000,0,0,0,10000,0,10000,10000
06234P,亞德客元大97售02,0,0,0,0,0,0,0,0,0,10000,0,0,0,10000,0,10000,10000
06422P,勤誠統一98售01  ,0,0,0,0,0,0,0,0,0,10000,0,0,0,20000,10000,10000,10000
06387P,緯穎永豐97售02  ,0,0,0,0,0,0,0,0,0,10000,0,0,0,20000,10000,10000,10000
06609P,元油2X凱基9B售06,0,0,0,0,0,0,0,0,0,10000,0,0,0,10000,0,10000,10000
06634P,欣興國票98售02  ,0,0,0,0,0,0,0,0,0,10000,0,0,0,20000,10000,10000,10000
06685P,鴻海國泰9A售01  ,0,0,0,0,0,0,0,0,0,10000,0,0,0,10000,0,10000,10000
06562P,台積電國泰99售02,0,0,0,0,0,0,0,0,0,10000,0,0,0,10000,0,10000,10000
06517P,國巨凱基98售09  ,0,0,0,0,0,0,0,0,0,10000,0,0,0,10000,0,10000,10000
06436P,台光電國票98售04,0,0,0,0,0,0,0,0,0,10000,0,0,0,10000,0,10000,10000
2024,志聯            ,12000,2000,10000,0,0,0,0,0,0,0,0,0,0,0,0,0,10000
08525P,台灣50凱基96售02,0,0,0,0,0,0,0,0,0,10000,0,0,0,10000,0,10000,10000
07033P,大立光統一9B售03,10000,0,10000,0,0,0,0,0,0,0,0,0,0,30000,30000,0,10000
06973P,臺股指元大9A售11,0,0,0,0,0,0,0,0,0,10000,0,0,0,10000,0,10000,10000
06992P,玉晶光日盛9B售01,0,0,0,0,0,0,0,0,0,10000,0,0,0,38000,28000,10000,10000
06793P,臺股指凱基98售03,0,0,0,0,0,0,0,0,0,10000,0,0,0,10000,0,10000,10000
06830P,臺股指國票98售06,0,0,0,0,0,0,0,0,0,10000,0,0,0,10000,0,10000,10000
06862P,大立光凱基98售16,0,0,0,0,0,0,0,0,0,10000,0,0,0,10000,0,10000,10000
06914P,南茂元大98售03  ,0,0,0,0,0,0,0,0,0,10000,0,0,0,19000,9000,10000,10000
3094,聯傑            ,88000,81000,7000,0,0,0,0,0,0,3000,5000,2000,3000,0,0,0,10000
3046,建碁            ,11000,2000,9000,0,0,0,0,0,0,1000,7000,6000,1000,0,0,0,10000
3416,融程電          ,18000,8000,10000,0,0,0,0,0,0,0,0,0,0,0,0,0,10000
2427,三商電          ,10000,0,10000,0,0,0,0,0,0,0,0,0,0,0,0,0,10000
2482,連宇            ,23000,13000,10000,0,0,0,0,0,0,0,0,0,0,0,0,0,10000
6573,虹揚-KY         ,14000,4000,10000,0,0,0,0,0,0,0,3000,3000,0,0,0,0,10000
8442,威宏-KY         ,16000,6000,10000,0,0,0,0,0,0,0,0,0,0,0,0,0,10000
4930,燦星網          ,13000,3000,10000,0,0,0,0,0,0,0,0,0,0,0,0,0,10000
05785P,臺股指元大96售19,0,0,0,0,0,0,0,0,0,9000,0,0,0,9000,0,9000,9000
057977,台光電永豐98購02,0,0,0,0,0,0,0,0,0,9000,0,0,0,69000,60000,9000,9000
05800P,台積電兆豐96售04,0,0,0,0,0,0,0,0,0,9000,0,0,0,137000,128000,9000,9000
056978,技嘉群益99購01  ,0,0,0,0,0,0,0,0,0,9000,0,0,0,18000,9000,9000,9000
056517,茂林兆豐99購01  ,0,0,0,0,0,0,0,0,0,9000,0,0,0,10000,1000,9000,9000
056572,義隆元大99購01  ,0,0,0,0,0,0,0,0,0,9000,0,0,0,129000,120000,9000,9000
057383,玉晶光富邦9A購01,0,0,0,0,0,0,0,0,0,9000,0,0,0,9000,0,9000,9000
057574,中磊永豐98購01  ,0,0,0,0,0,0,0,0,0,9000,0,0,0,12000,3000,9000,9000
052800,國巨元大96購05  ,0,0,0,0,0,0,0,0,0,9000,0,0,0,19000,10000,9000,9000
052754,上証2X群益9A購01,0,0,0,0,0,0,0,0,0,9000,0,0,0,12000,3000,9000,9000
04782P,智伸科統一96售01,0,0,0,0,0,0,0,0,0,9000,0,0,0,63000,54000,9000,9000
049418,大立光凱基94購05,0,0,0,0,0,0,0,0,0,9000,0,0,0,10000,1000,9000,9000
049560,香港反統一95購01,0,0,0,0,0,0,0,0,0,9000,0,0,0,9000,0,9000,9000
04453P,聯發科富邦94售04,0,0,0,0,0,0,0,0,0,9000,0,0,0,19000,10000,9000,9000
04693P,超眾群益95售01  ,0,0,0,0,0,0,0,0,0,9000,0,0,0,17000,8000,9000,9000
04366P,全新元富95售01  ,0,0,0,0,0,0,0,0,0,9000,0,0,0,21000,12000,9000,9000
043513,台灣50元大96購05,0,0,0,0,0,0,0,0,0,9000,0,0,0,10000,1000,9000,9000
00689R,國泰20年美債反1 ,0,0,0,0,0,0,0,0,0,9000,0,0,0,117000,108000,9000,9000
05115P,T50反1群益95售02,0,0,0,0,0,0,0,0,0,9000,0,0,0,9000,0,9000,9000
053175,矽力群益96購01  ,0,0,0,0,0,0,0,0,0,9000,0,0,0,9000,0,9000,9000
05099P,台積電凱基95售06,0,0,0,0,0,0,0,0,0,9000,0,0,0,9000,0,9000,9000
051898,富邦金國泰97購01,0,0,0,0,0,0,0,0,0,9000,0,0,0,70000,61000,9000,9000
052369,矽力國票96購02  ,0,0,0,0,0,0,0,0,0,9000,0,0,0,22000,13000,9000,9000
052961,國巨凱基97購02  ,0,0,0,0,0,0,0,0,0,9000,0,0,0,10000,1000,9000,9000
051500,聯茂群益95購01  ,0,0,0,0,0,0,0,0,0,9000,0,0,0,107000,98000,9000,9000
050370,台積電元大94購24,0,0,0,0,0,0,0,0,0,9000,0,0,0,121000,112000,9000,9000
054725,國巨日盛97購01  ,0,0,0,0,0,0,0,0,0,9000,0,0,0,9000,0,9000,9000
05459P,聯詠凱基95售03  ,0,0,0,0,0,0,0,0,0,9000,0,0,0,39000,30000,9000,9000
054532,強茂國泰98購01  ,0,0,0,0,0,0,0,0,0,9000,0,0,0,35000,26000,9000,9000
055075,南電永豐97購01  ,0,0,0,0,0,0,0,0,0,9000,0,0,0,59000,50000,9000,9000
054228,貿聯元富96購03  ,0,0,0,0,0,0,0,0,0,9000,0,0,0,20000,11000,9000,9000
056085,聯發科統一97購01,0,0,0,0,0,0,0,0,0,9000,0,0,0,48000,39000,9000,9000
056096,超眾元富9A購01  ,0,0,0,0,0,0,0,0,0,9000,0,0,0,107000,98000,9000,9000
5906,台南-KY         ,11000,2000,9000,0,0,0,0,0,0,0,0,0,0,0,0,0,9000
4571,鈞興-KY         ,9000,0,9000,0,0,0,0,0,0,0,0,0,0,0,0,0,9000
8374,羅昇            ,12000,3000,9000,0,0,0,0,0,0,0,0,0,0,0,0,0,9000
8478,東哥遊艇        ,13000,3000,10000,0,0,0,0,0,0,-1000,0,1000,-1000,0,0,0,9000
6201,亞弘電          ,9000,0,9000,0,0,0,0,0,0,0,0,0,0,0,0,0,9000
3040,遠見            ,9000,0,9000,0,0,0,0,0,0,0,0,0,0,0,0,0,9000
06934P,聯鈞元大98售03  ,0,0,0,0,0,0,0,0,0,9000,0,0,0,91000,82000,9000,9000
06845P,億光元大98售02  ,0,0,0,0,0,0,0,0,0,9000,0,0,0,9000,0,9000,9000
08539P,元油2X國票99售01,0,0,0,0,0,0,0,0,0,9000,0,0,0,9000,0,9000,9000
08671P,友訊國票01售01  ,0,0,0,0,0,0,0,0,0,9000,0,0,0,29000,20000,9000,9000
1236,宏亞            ,10000,1000,9000,0,0,0,0,0,0,0,0,0,0,0,0,0,9000
1530,亞崴            ,9000,0,9000,0,0,0,0,0,0,0,0,0,0,0,0,0,9000
1776,展宇            ,9000,0,9000,0,0,0,0,0,0,0,1000,1000,0,0,0,0,9000
1443,立益            ,11000,2000,9000,0,0,0,0,0,0,0,0,0,0,0,0,0,9000
06554P,臺股指元大99售06,0,0,0,0,0,0,0,0,0,9000,0,0,0,64000,55000,9000,9000
06591P,大立光元大98售14,0,0,0,0,0,0,0,0,0,9000,0,0,0,9000,0,9000,9000
06269P,群創凱基98售10  ,0,0,0,0,0,0,0,0,0,9000,0,0,0,9000,0,9000,9000
06311P,嘉聯益元富97售02,0,0,0,0,0,0,0,0,0,9000,0,0,0,69000,60000,9000,9000
057179,可成元大98購04  ,0,0,0,0,0,0,0,0,0,8000,0,0,0,93000,85000,8000,8000
05728P,滬深2X凱基98售03,0,0,0,0,0,0,0,0,0,8000,0,0,0,8000,0,8000,8000
056582,易華電元大98購01,0,0,0,0,0,0,0,0,0,8000,0,0,0,9000,1000,8000,8000
058127,FBVIX元大9C購01 ,0,0,0,0,0,0,0,0,0,8000,0,0,0,8000,0,8000,8000
057877,神達元大99購01  ,0,0,0,0,0,0,0,0,0,8000,0,0,0,148000,140000,8000,8000
057853,旺宏國票99購05  ,0,0,0,0,0,0,0,0,0,8000,0,0,0,8000,0,8000,8000
05793P,臺股指中信99售08,0,0,0,0,0,0,0,0,0,8000,0,0,0,8000,0,8000,8000
06054P,臺股指中信9A售01,0,0,0,0,0,0,0,0,0,8000,0,0,0,14000,6000,8000,8000
06025P,臺股指元大99售02,0,0,0,0,0,0,0,0,0,8000,0,0,0,8000,0,8000,8000
05962P,大立光群益96售07,0,0,0,0,0,0,0,0,0,8000,0,0,0,9000,1000,8000,8000
05883P,致伸永豐96售03  ,0,0,0,0,0,0,0,0,0,8000,0,0,0,8000,0,8000,8000
058452,義隆永豐99購02  ,0,0,0,0,0,0,0,0,0,8000,0,0,0,38000,30000,8000,8000
006203,元大MSCI台灣    ,1000,1000,0,0,0,0,0,0,0,8000,0,0,0,8000,0,8000,8000
04083P,欣興統一94售01  ,0,0,0,0,0,0,0,0,0,8000,0,0,0,8000,0,8000,8000
03438P,群創群益98售03  ,0,0,0,0,0,0,0,0,0,8000,0,0,0,8000,0,8000,8000
03111P,元油2X富邦97售01,0,0,0,0,0,0,0,0,0,8000,0,0,0,8000,0,8000,8000
03177P,國巨群益01售12  ,0,0,0,0,0,0,0,0,0,8000,0,0,0,8000,0,8000,8000
049291,華通群益94購04  ,0,0,0,0,0,0,0,0,0,8000,0,0,0,28000,20000,8000,8000
048331,臺指反富邦97購01,0,0,0,0,0,0,0,0,0,8000,0,0,0,18000,10000,8000,8000
048121,亞德客元大93購05,0,0,0,0,0,0,0,0,0,8000,0,0,0,75000,67000,8000,8000
052915,創意元富96購01  ,0,0,0,0,0,0,0,0,0,8000,0,0,0,10000,2000,8000,8000
052064,臺股指國票95購11,0,0,0,0,0,0,0,0,0,8000,0,0,0,8000,0,8000,8000
052088,漢唐元大95購02  ,0,0,0,0,0,0,0,0,0,8000,0,0,0,8000,0,8000,8000
051736,旺宏國票96購01  ,0,0,0,0,0,0,0,0,0,8000,0,0,0,8000,0,8000,8000
052417,聯發科兆豐9B購01,0,0,0,0,0,0,0,0,0,8000,0,0,0,28000,20000,8000,8000
051847,香港反中信99購01,0,0,0,0,0,0,0,0,0,8000,0,0,0,8000,0,8000,8000
050692,鴻海凱基96購04  ,0,0,0,0,0,0,0,0,0,8000,0,0,0,10000,2000,8000,8000
050553,緯穎凱基94購06  ,0,0,0,0,0,0,0,0,0,8000,0,0,0,52000,44000,8000,8000
050585,矽格國票94購01  ,0,0,0,0,0,0,0,0,0,8000,0,0,0,8000,0,8000,8000
056130,新日興麥證97購01,0,0,0,20000,22000,-2000,0,0,0,8000,0,0,0,30000,22000,8000,8000
055832,台達電元大97購02,0,0,0,0,0,0,0,0,0,8000,0,0,0,68000,60000,8000,8000
05521P,創意永豐96售01  ,0,0,0,0,0,0,0,0,0,8000,0,0,0,8000,0,8000,8000
055220,緯穎凱基98購02  ,0,0,0,0,0,0,0,0,0,8000,0,0,0,108000,100000,8000,8000
05573P,仁寶元富96售02  ,0,0,0,0,0,0,0,0,0,8000,0,0,0,22000,14000,8000,8000
054059,欣興國票97購03  ,0,0,0,0,0,0,0,0,0,8000,0,0,0,8000,0,8000,8000
055105,鴻海凱基98購05  ,0,0,0,0,0,0,0,0,0,8000,0,0,0,75000,67000,8000,8000
06299P,可成元大97售04  ,0,0,0,0,0,0,0,0,0,8000,0,0,0,183000,175000,8000,8000
06590P,大立光元大98售13,0,0,0,0,0,0,0,0,0,8000,0,0,0,8000,0,8000,8000
06535P,可成群益99售02  ,0,0,0,0,0,0,0,0,0,8000,0,0,0,66000,58000,8000,8000
06510P,燿華永豐98售03  ,0,0,0,0,0,0,0,0,0,8000,0,0,0,34000,26000,8000,8000
06716P,台積電元大9A售02,0,0,0,0,0,0,0,0,0,8000,0,0,0,42000,34000,8000,8000
1535,中宇            ,13000,5000,8000,0,0,0,0,0,0,0,0,0,0,0,0,0,8000
1604,聲寶            ,162000,164000,-2000,0,0,0,0,0,0,10000,15000,5000,10000,0,0,0,8000
06939P,國巨永豐98售09  ,0,0,0,0,0,0,0,0,0,8000,0,0,0,18000,10000,8000,8000
2882A,國泰特          ,0,17000,-17000,0,0,0,0,0,0,25000,25000,0,25000,0,0,0,8000
2465,麗臺            ,8000,0,8000,0,0,0,0,0,0,0,0,0,0,0,0,0,8000
4807,日成-KY         ,14000,6000,8000,0,0,0,0,0,0,0,0,0,0,0,0,0,8000
5264,鎧勝-KY         ,466000,460000,6000,0,0,0,0,0,0,2000,13000,11000,2000,0,0,0,8000
4999,鑫禾            ,12000,2000,10000,0,0,0,0,0,0,-2000,0,2000,-2000,0,0,0,8000
9103,美德醫療-DR     ,4000,0,4000,0,0,0,0,0,0,4000,4000,0,4000,0,0,0,8000
9917,中保科          ,107000,102000,5000,0,0,0,0,0,0,3000,4000,1000,3000,0,0,0,8000
05874P,台積電群益96售10,0,0,0,0,0,0,0,0,0,7000,0,0,0,10000,3000,7000,7000
057847,聯茂永豐98購01  ,0,0,0,0,0,0,0,0,0,7000,0,0,0,93000,86000,7000,7000
057843,晶技永豐98購02  ,0,0,0,0,0,0,0,0,0,7000,0,0,0,53000,46000,7000,7000
057748,華通國票98購04  ,0,0,0,0,0,0,0,0,0,7000,0,0,0,48000,41000,7000,7000
05823P,臺股指凱基96售20,0,0,0,0,0,0,0,0,0,7000,0,0,0,10000,3000,7000,7000
056647,晶技凱基98購02  ,0,0,0,0,0,0,0,0,0,7000,0,0,0,77000,70000,7000,7000
056845,揚明光元富98購01,0,0,0,0,0,0,0,0,0,7000,0,0,0,7000,0,7000,7000
057166,國巨元大99購06  ,0,0,0,0,0,0,0,0,0,7000,0,0,0,56000,49000,7000,7000
057550,聯發科凱基02購01,0,0,0,0,0,0,0,0,0,7000,0,0,0,7000,0,7000,7000
052681,T50反1元大98購02,0,0,0,0,0,0,0,0,0,7000,0,0,0,7000,0,7000,7000
048687,旺宏群益96購01  ,0,0,0,0,0,0,0,0,0,7000,0,0,0,7000,0,7000,7000
04909P,鴻海統一94售10  ,0,0,0,0,0,0,0,0,0,7000,0,0,0,18000,11000,7000,7000
047972,康控富邦95購01  ,0,0,0,0,0,0,0,0,0,7000,0,0,0,9000,2000,7000,7000
048495,南亞科元大93購04,0,0,0,0,0,0,0,0,0,7000,0,0,0,7000,0,7000,7000
049635,臺股指群益94購08,0,0,0,0,0,0,0,0,0,7000,0,0,0,7000,0,7000,7000
045749,智邦富邦93購01  ,0,0,0,0,0,0,0,0,0,7000,0,0,0,7000,0,7000,7000
045522,滬深2X永豐94購01,0,0,0,0,0,0,0,0,0,7000,0,0,0,7000,0,7000,7000
044003,聯發科兆豐93購01,0,0,0,0,0,0,0,0,0,7000,0,0,0,307000,300000,7000,7000
03252P,台積電台新02售01,0,0,0,0,0,0,0,0,0,7000,0,0,0,43000,36000,7000,7000
00657,國泰日經225     ,0,0,0,0,0,0,0,0,0,7000,0,0,0,111000,104000,7000,7000
00743,國泰中國A150    ,86000,6000,80000,0,0,0,0,0,0,-73000,0,0,0,16000,89000,-73000,7000
050533,致新元大94購03  ,0,0,0,0,0,0,0,0,0,7000,0,0,0,7000,0,7000,7000
051982,深中小元大95購01,0,0,0,0,0,0,0,0,0,7000,0,0,0,7000,0,7000,7000
051458,臺股指元大95購18,0,0,0,0,0,0,0,0,0,7000,0,0,0,7000,0,7000,7000
05122P,鴻海永昌96售06  ,0,0,0,0,0,0,0,0,0,7000,0,0,0,216000,209000,7000,7000
052610,貿聯元大97購01  ,0,0,0,0,0,0,0,0,0,7000,0,0,0,20000,13000,7000,7000
050936,國巨國票95購04  ,0,0,0,0,0,0,0,0,0,7000,0,0,0,7000,0,7000,7000
052402,健策凱基97購01  ,0,0,0,0,0,0,0,0,0,7000,0,0,0,40000,33000,7000,7000
052322,力成元大96購01  ,0,0,0,0,0,0,0,0,0,7000,0,0,0,9000,2000,7000,7000
05348P,美律元富98售01  ,0,0,0,0,0,0,0,0,0,7000,0,0,0,46000,39000,7000,7000
053467,鴻海元大96購20  ,0,0,0,0,0,0,0,0,0,7000,0,0,0,88000,81000,7000,7000
051453,智伸科元大95購02,0,0,0,0,0,0,0,0,0,7000,0,0,0,7000,0,7000,7000
050362,深中小元大94購04,0,0,0,0,0,0,0,0,0,7000,0,0,0,7000,0,7000,7000
051358,台新金元大95購01,0,0,0,0,0,0,0,0,0,7000,0,0,0,140000,133000,7000,7000
054996,聯陽元富97購01  ,0,0,0,0,0,0,0,0,0,7000,0,0,0,50000,43000,7000,7000
054061,晶技國票97購03  ,0,0,0,0,0,0,0,0,0,7000,0,0,0,97000,90000,7000,7000
054128,台積電元大97購10,0,0,0,0,0,0,0,0,0,7000,0,0,0,10000,3000,7000,7000
055664,和大群益98購02  ,0,0,0,0,0,0,0,0,0,7000,0,0,0,105000,98000,7000,7000
05565P,鎧勝元大96售01  ,0,0,0,0,0,0,0,0,0,7000,0,0,0,7000,0,7000,7000
055911,可成凱基98購02  ,0,0,0,0,0,0,0,0,0,7000,0,0,0,68000,61000,7000,7000
056076,超眾元大97購05  ,0,0,0,0,0,0,0,0,0,7000,0,0,0,25000,18000,7000,7000
056355,台積電元大98購08,0,0,0,0,0,0,0,0,0,7000,0,0,0,194000,187000,7000,7000
056169,鴻海元富97購08  ,0,0,0,0,0,0,0,0,0,7000,0,0,0,38000,31000,7000,7000
6133,金橋            ,8000,0,8000,0,0,0,0,0,0,-1000,0,1000,-1000,0,0,0,7000
6581,鋼聯            ,10000,2000,8000,0,0,0,0,0,0,-1000,0,1000,-1000,0,0,0,7000
2906,高林            ,8000,1000,7000,0,0,0,0,0,0,0,0,0,0,0,0,0,7000
3432,台端            ,6000,0,6000,0,0,0,0,0,0,1000,1000,0,1000,0,0,0,7000
06854P,鴻海富邦99售05  ,0,0,0,0,0,0,0,0,0,7000,0,0,0,7000,0,7000,7000
06814P,臺股指元富98售03,0,0,0,0,0,0,0,0,0,7000,0,0,0,7000,0,7000,7000
1521,大億            ,11000,4000,7000,0,0,0,0,0,0,0,0,0,0,0,0,0,7000
1453,大將            ,8000,1000,7000,0,0,0,0,0,0,0,0,0,0,0,0,0,7000
1806,冠軍            ,103000,96000,7000,0,0,0,0,0,0,0,0,0,0,0,0,0,7000
06751P,旺宏凱基98售10  ,0,0,0,0,0,0,0,0,0,7000,0,0,0,10000,3000,7000,7000
06605P,玉晶光元富98售03,0,0,0,0,0,0,0,0,0,7000,0,0,0,37000,30000,7000,7000
06243P,亞光元富97售01  ,0,0,0,0,0,0,0,0,0,7000,0,0,0,7000,0,7000,7000
06346P,聯鈞元富97售02  ,0,0,0,0,0,0,0,0,0,7000,0,0,0,92000,85000,7000,7000
06150P,奇力新元大97售06,0,0,0,0,0,0,0,0,0,7000,0,0,0,227000,220000,7000,7000
057170,瑞昱元大98購01  ,0,0,0,0,0,0,0,0,0,6000,0,0,0,106000,100000,6000,6000
05714P,群創統一97售03  ,0,0,0,0,0,0,0,0,0,6000,0,0,0,157000,151000,6000,6000
057204,利勤元富98購01  ,0,0,0,0,0,0,0,0,0,6000,0,0,0,7000,1000,6000,6000
056857,國巨群益99購02  ,0,0,0,0,0,0,0,0,0,6000,0,0,0,116000,110000,6000,6000
056903,大立光元大99購04,0,0,0,0,0,0,0,0,0,6000,0,0,0,6000,0,6000,6000
056825,深中小富邦9B購01,0,0,0,0,0,0,0,0,0,6000,0,0,0,6000,0,6000,6000
056976,喬山群益98購01  ,0,0,0,0,0,0,0,0,0,6000,0,0,0,70000,64000,6000,6000
056602,嘉澤國泰99購01  ,0,0,0,0,0,0,0,0,0,6000,0,0,0,50000,44000,6000,6000
058217,新唐群益99購01  ,0,0,0,0,0,0,0,0,0,6000,0,0,0,17000,11000,6000,6000
058146,勤誠元大99購01  ,0,0,0,0,0,0,0,0,0,6000,0,0,0,20000,14000,6000,6000
05911P,南亞科永豐96售03,0,0,0,0,0,0,0,0,0,6000,0,0,0,10000,4000,6000,6000
05972P,瑞昱元大96售01  ,0,0,0,0,0,0,0,0,0,6000,0,0,0,145000,139000,6000,6000
06057P,大立光凱基98售01,0,0,0,0,0,0,0,0,0,6000,0,0,0,10000,4000,6000,6000
058506,台積電元大99購09,0,0,0,0,0,0,0,0,0,6000,0,0,0,160000,154000,6000,6000
04146P,可成凱基93售14  ,0,0,0,0,0,0,0,0,0,6000,0,0,0,6000,0,6000,6000
04315P,台光電國票93售04,0,0,0,0,0,0,0,0,0,6000,0,0,0,6000,0,6000,6000
04456P,日月光統一94售01,0,0,0,0,0,0,0,0,0,6000,0,0,0,6000,0,6000,6000
04489P,大立光凱基94售03,0,0,0,0,0,0,0,0,0,6000,0,0,0,12000,6000,6000,6000
044972,元金2X國票96購01,0,0,0,0,0,0,0,0,0,6000,0,0,0,6000,0,6000,6000
047493,旺宏元富96購01  ,0,0,0,0,0,0,0,0,0,6000,0,0,0,6000,0,6000,6000
048514,嘉澤凱基93購06  ,0,0,0,0,0,0,0,0,0,6000,0,0,0,6000,0,6000,6000
048102,矽力凱基94購01  ,0,0,0,0,0,0,0,0,0,6000,0,0,0,10000,4000,6000,6000
049398,微星群益94購02  ,0,0,0,0,0,0,0,0,0,6000,0,0,0,59000,53000,6000,6000
049820,世紀鋼元大96購03,0,0,0,0,0,0,0,0,0,6000,0,0,0,199000,193000,6000,6000
049087,晶相光凱基94購02,0,0,0,0,0,0,0,0,0,6000,0,0,0,48000,42000,6000,6000
04911P,美律元富94售02  ,0,0,0,0,0,0,0,0,0,6000,0,0,0,28000,22000,6000,6000
049016,國巨群益94購02  ,4000,0,4000,0,0,0,0,0,0,2000,0,0,0,27000,25000,2000,6000
048127,麗豐元大94購01  ,0,0,0,0,0,0,0,0,0,6000,0,0,0,6000,0,6000,6000
05265P,正崴元大95售03  ,0,0,0,0,0,0,0,0,0,6000,0,0,0,33000,27000,6000,6000
052661,奇力新國票97購03,0,0,0,0,0,0,0,0,0,6000,0,0,0,12000,6000,6000,6000
05141P,華通台新96售01  ,0,0,0,0,0,0,0,0,0,6000,0,0,0,25000,19000,6000,6000
052055,緯穎凱基95購03  ,0,0,0,0,0,0,0,0,0,6000,0,0,0,38000,32000,6000,6000
053438,玉晶光麥證97購02,0,0,0,50000,44000,6000,0,0,0,6000,0,0,0,50000,44000,6000,6000
052396,台積電凱基97購01,0,0,0,0,0,0,0,0,0,6000,0,0,0,20000,14000,6000,6000
05221P,玉晶光元大95售04,0,0,0,0,0,0,0,0,0,6000,0,0,0,16000,10000,6000,6000
053616,奇力新群益97購01,0,0,0,0,0,0,0,0,0,6000,0,0,0,6000,0,6000,6000
050983,新光金國泰97購01,0,0,0,0,0,0,0,0,0,6000,0,0,0,6000,0,6000,6000
051220,大立光元富95購08,0,0,0,0,0,0,0,0,0,6000,0,0,0,6000,0,6000,6000
055728,緯穎元大97購03  ,0,0,0,0,0,0,0,0,0,6000,0,0,0,87000,81000,6000,6000
055317,金寶國票98購01  ,0,0,0,0,0,0,0,0,0,6000,0,0,0,180000,174000,6000,6000
054224,亞光統一98購01  ,0,0,0,0,0,0,0,0,0,6000,0,0,0,6000,0,6000,6000
054215,創意國票97購02  ,0,0,0,0,0,0,0,0,0,6000,0,0,0,16000,10000,6000,6000
053782,京元電元大98購02,0,0,0,0,0,0,0,0,0,6000,0,0,0,68000,62000,6000,6000
053751,康控永豐96購02  ,0,0,0,0,0,0,0,0,0,6000,0,0,0,7000,1000,6000,6000
06206P,台積電凱基97售11,0,0,0,0,0,0,0,0,0,6000,0,0,0,1520000,1514000,6000,6000
06553P,訊芯元大98售05  ,0,0,0,0,0,0,0,0,0,6000,0,0,0,36000,30000,6000,6000
06506P,台郡國票99售02  ,0,0,0,0,0,0,0,0,0,6000,0,0,0,6000,0,6000,6000
06717P,可成元大98售09  ,0,0,0,0,0,0,0,0,0,6000,0,0,0,6000,0,6000,6000
06708P,臺股指台新99售05,0,0,0,0,0,0,0,0,0,6000,0,0,0,515000,509000,6000,6000
2399,映泰            ,363000,357000,6000,0,0,0,0,0,0,0,3000,3000,0,0,0,0,6000
1456,怡華            ,6000,0,6000,0,0,0,0,0,0,0,0,0,0,0,0,0,6000
1617,榮星            ,11000,5000,6000,0,0,0,0,0,0,0,0,0,0,0,0,0,6000
06812P,台灣50元富9C售01,0,0,0,0,0,0,0,0,0,6000,0,0,0,171000,165000,6000,6000
06888P,日月光元大98售02,0,0,0,0,0,0,0,0,0,6000,0,0,0,10000,4000,6000,6000
3054,立萬利          ,18000,14000,4000,0,0,0,0,0,0,2000,8000,6000,2000,0,0,0,6000
5484,慧友            ,7000,0,7000,0,0,0,0,0,0,-1000,0,1000,-1000,0,0,0,6000
4439,冠星-KY         ,6000,0,6000,0,0,0,0,0,0,0,0,0,0,0,0,0,6000
9944,新麗            ,120000,113000,7000,0,0,0,0,0,0,-1000,0,1000,-1000,0,0,0,6000
05929P,宏達電康和96售01,0,0,0,0,0,0,0,0,0,5000,0,0,0,5000,0,5000,5000
05892P,大立光中信98售03,0,0,0,0,0,0,0,0,0,5000,0,0,0,14000,9000,5000,5000
058163,道瓊反凱基9B購01,0,0,0,0,0,0,0,0,0,5000,0,0,0,10000,5000,5000,5000
058183,國巨富邦9A購06  ,0,0,0,0,0,0,0,0,0,5000,0,0,0,5000,0,5000,5000
058231,技嘉元大99購02  ,0,0,0,0,0,0,0,0,0,5000,0,0,0,35000,30000,5000,5000
057997,旺宏第一9C購01  ,0,0,0,0,0,0,0,0,0,5000,0,0,0,5000,0,5000,5000
05773P,臺股指凱基99售03,0,0,0,0,0,0,0,0,0,5000,0,0,0,27000,22000,5000,5000
057744,健策永豐98購02  ,0,0,0,0,0,0,0,0,0,5000,0,0,0,5000,0,5000,5000
057830,T50反1台新02購02,0,0,0,0,0,0,0,0,0,5000,0,0,0,5000,0,5000,5000
05796P,臺股指群益96售10,0,0,0,0,0,0,0,0,0,5000,0,0,0,5000,0,5000,5000
057892,上証2X元富02購01,0,0,0,0,0,0,0,0,0,5000,0,0,0,5000,0,5000,5000
056620,華新科永豐98購02,0,0,0,0,0,0,0,0,0,5000,0,0,0,73000,68000,5000,5000
05662P,景碩元富96售01  ,0,0,0,0,0,0,0,0,0,5000,0,0,0,5000,0,5000,5000
05643P,大立光中信98售01,0,0,0,0,0,0,0,0,0,5000,0,0,0,5000,0,5000,5000
056464,臺股指凱基99購06,0,0,0,0,0,0,0,0,0,5000,0,0,0,45000,40000,5000,5000
05692P,聯發科中信9A售02,0,0,0,0,0,0,0,0,0,5000,0,0,0,5000,0,5000,5000
057031,滬深反元大9B購02,0,0,0,0,0,0,0,0,0,5000,0,0,0,5000,0,5000,5000
056755,聯茂兆豐98購01  ,0,0,0,0,0,0,0,0,0,5000,0,0,0,5000,0,5000,5000
056902,大立光元大98購12,0,0,0,0,0,0,0,0,0,5000,0,0,0,5000,0,5000,5000
05687P,臺股指元大96售12,0,0,0,0,0,0,0,0,0,5000,0,0,0,5000,0,5000,5000
05683P,矽創元大96售01  ,0,0,0,0,0,0,0,0,0,5000,0,0,0,87000,82000,5000,5000
057327,玉晶光群益9A購04,0,0,0,0,0,0,0,0,0,5000,0,0,0,14000,9000,5000,5000
057144,南電兆豐98購01  ,0,0,0,0,0,0,0,0,0,5000,0,0,0,37000,32000,5000,5000
057389,玉晶光永豐98購06,0,0,0,0,0,0,0,0,0,5000,0,0,0,98000,93000,5000,5000
052567,台積電凱基96購05,0,0,0,0,0,0,0,0,0,5000,0,0,0,5000,0,5000,5000
04867P,美律統一94售03  ,0,0,0,0,0,0,0,0,0,5000,0,0,0,5000,0,5000,5000
048968,可成元大94購02  ,0,0,0,0,0,0,0,0,0,5000,0,0,0,5000,0,5000,5000
049770,康控元富95購01  ,0,0,0,0,0,0,0,0,0,5000,0,0,0,5000,0,5000,5000
049679,臺股指國票94購12,0,0,0,0,0,0,0,0,0,5000,5000,0,5000,0,0,0,5000
049381,欣興元大94購05  ,0,0,0,0,0,0,0,0,0,5000,0,0,0,5000,0,5000,5000
047544,台積電凱基93購17,0,0,0,0,0,0,0,0,0,5000,0,0,0,5000,0,5000,5000
04947P,聯詠元大94售05  ,0,0,0,0,0,0,0,0,0,5000,0,0,0,5000,0,5000,5000
049469,元金2X永豐94購01,0,0,0,0,0,0,0,0,0,5000,0,0,0,5000,0,5000,5000
04948P,瑞儀元大94售03  ,0,0,0,0,0,0,0,0,0,5000,0,0,0,5000,0,5000,5000
049500,聯茂元大94購04  ,0,0,0,0,0,0,0,0,0,5000,0,0,0,30000,25000,5000,5000
04746P,臺股指元大94售17,0,0,0,0,0,0,0,0,0,5000,0,0,0,5000,0,5000,5000
048186,元黃金元大96購01,0,0,0,0,0,0,0,0,0,5000,0,0,0,5000,0,5000,5000
047419,聯發科富邦95購01,0,0,0,0,0,0,0,0,0,5000,0,0,0,5000,0,5000,5000
047420,全新富邦97購01  ,0,0,0,0,0,0,0,0,0,5000,0,0,0,15000,10000,5000,5000
049316,茂林凱基94購02  ,0,0,0,0,0,0,0,0,0,5000,0,0,0,10000,5000,5000,5000
049286,美律兆豐94購01  ,0,0,0,0,0,0,0,0,0,5000,0,0,0,5000,0,5000,5000
044883,玉晶光群益93購01,0,0,0,0,0,0,0,0,0,5000,0,0,0,5000,0,5000,5000
04571P,華新科國泰95售03,0,0,0,0,0,0,0,0,0,5000,0,0,0,111000,106000,5000,5000
04695P,正崴康和94售01  ,0,0,0,0,0,0,0,0,0,5000,0,0,0,5000,0,5000,5000
046980,智邦兆豐94購01  ,0,0,0,0,0,0,0,0,0,5000,0,0,0,5000,0,5000,5000
03995P,滬深2X國泰95售01,0,0,0,0,0,0,0,0,0,5000,0,0,0,5000,0,5000,5000
03658C,T50反1元大9A牛02,0,0,0,0,0,0,0,0,0,5000,0,0,0,5000,0,5000,5000
04674P,全新統一95售01  ,0,0,0,0,0,0,0,0,0,5000,0,0,0,5000,0,5000,5000
04155P,全新永豐93售01  ,0,0,0,0,0,0,0,0,0,5000,0,0,0,5000,0,5000,5000
04251P,欣興統一93售06  ,0,0,0,0,0,0,0,0,0,5000,0,0,0,5000,0,5000,5000
042754,元黃金元大93購01,0,0,0,0,0,0,0,0,0,5000,0,0,0,5000,0,5000,5000
03560P,台積電兆豐03售10,0,0,0,0,0,0,0,0,0,5000,0,0,0,11000,6000,5000,5000
051984,台塑元大95購01  ,0,0,0,0,0,0,0,0,0,5000,0,0,0,5000,0,5000,5000
05070P,鴻海統一96售04  ,0,0,0,0,0,0,0,0,0,5000,0,0,0,6000,1000,5000,5000
05071P,鴻海統一96售05  ,0,0,0,0,0,0,0,0,0,5000,0,0,0,5000,0,5000,5000
050641,上証反凱基96購01,0,0,0,0,0,0,0,0,0,5000,0,0,0,30000,25000,5000,5000
051088,台積電元大95購09,0,0,0,0,0,0,0,0,0,5000,0,0,0,46000,41000,5000,5000
05326P,臺股指凱基95售10,0,0,0,0,0,0,0,0,0,5000,0,0,0,85000,80000,5000,5000
051865,聯發科凱基96購04,0,0,0,0,0,0,0,0,0,5000,0,0,0,5000,0,5000,5000
05093P,可成元大95售03  ,0,0,0,0,0,0,0,0,0,5000,0,0,0,5000,0,5000,5000
051930,國泰金兆豐97購01,0,0,0,0,0,0,0,0,0,5000,0,0,0,5000,0,5000,5000
053129,緯穎凱基96購01  ,0,0,0,0,0,0,0,0,0,5000,0,0,0,10000,5000,5000,5000
053031,華新科第一96購01,0,0,0,0,0,0,0,0,0,5000,0,0,0,5000,0,5000,5000
053073,技嘉康和96購01  ,0,0,0,0,0,0,0,0,0,5000,0,0,0,10000,5000,5000,5000
05359P,嘉澤元大95售02  ,0,0,0,0,0,0,0,0,0,5000,0,0,0,5000,0,5000,5000
052447,聯發科元大96購04,0,0,0,0,0,0,0,0,0,5000,0,0,0,36000,31000,5000,5000
052255,T50反1國泰96購01,0,0,0,0,0,0,0,0,0,5000,0,0,0,5000,0,5000,5000
052382,臺股指元大95購23,0,0,0,0,0,0,0,0,0,5000,0,0,0,5000,0,5000,5000
053333,新唐永豐96購01  ,0,0,0,0,0,0,0,0,0,5000,0,0,0,5000,0,5000,5000
053704,國巨群益96購06  ,0,0,0,0,0,0,0,0,0,5000,0,0,0,34000,29000,5000,5000
052958,T50反1凱基99購02,0,0,0,0,0,0,0,0,0,5000,0,0,0,5000,0,5000,5000
051716,康控康和95購01  ,0,0,0,0,0,0,0,0,0,5000,0,0,0,5000,0,5000,5000
051679,百和元大95購02  ,0,0,0,0,0,0,0,0,0,5000,0,0,0,5000,0,5000,5000
051693,華新科統一95購02,0,0,0,0,0,0,0,0,0,5000,0,0,0,15000,10000,5000,5000
051582,聯發科元大97購02,0,0,0,0,0,0,0,0,0,5000,0,0,0,120000,115000,5000,5000
051428,玉晶光統一96購01,0,0,0,0,0,0,0,0,0,5000,0,0,0,22000,17000,5000,5000
05038P,牧德元大95售03  ,0,0,0,0,0,0,0,0,0,5000,0,0,0,5000,0,5000,5000
051268,創意富邦97購01  ,0,0,0,0,0,0,0,0,0,5000,0,0,0,15000,10000,5000,5000
054025,鴻海凱基96購17  ,0,0,0,0,0,0,0,0,0,5000,0,0,0,50000,45000,5000,5000
054095,同欣電群益98購03,0,0,0,0,0,0,0,0,0,5000,0,0,0,114000,109000,5000,5000
054164,強茂凱基98購01  ,0,0,0,0,0,0,0,0,0,5000,0,0,0,20000,15000,5000,5000
054312,TPK凱基98購01   ,0,0,0,0,0,0,0,0,0,5000,0,0,0,15000,10000,5000,5000
054972,聯茂元大97購02  ,0,0,0,0,0,0,0,0,0,5000,0,0,0,5000,0,5000,5000
05493P,華新科富邦99售02,0,0,0,0,0,0,0,0,0,5000,0,0,0,5000,0,5000,5000
055130,京鼎康和97購01  ,0,0,0,0,0,0,0,0,0,5000,0,0,0,68000,63000,5000,5000
055154,聯發科元大98購01,0,0,0,0,0,0,0,0,0,5000,0,0,0,45000,40000,5000,5000
05528P,臺股指群益96售01,0,0,0,0,0,0,0,0,0,5000,0,0,0,5000,0,5000,5000
055439,台表科國票98購02,0,0,0,0,0,0,0,0,0,5000,0,0,0,15000,10000,5000,5000
055354,宏達電凱基98購01,0,0,0,0,0,0,0,0,0,5000,0,0,0,95000,90000,5000,5000
055705,微星永豐97購01  ,0,0,0,0,0,0,0,0,0,5000,0,0,0,5000,0,5000,5000
055692,緯穎凱基97購03  ,0,0,0,0,0,0,0,0,0,5000,0,0,0,35000,30000,5000,5000
05641P,貿聯元富96售02  ,0,0,0,0,0,0,0,0,0,5000,0,0,0,110000,105000,5000,5000
05607P,華通日盛96售01  ,0,0,0,0,0,0,0,0,0,5000,0,0,0,49000,44000,5000,5000
056109,彩晶永豐98購01  ,0,0,0,0,0,0,0,0,0,5000,0,0,0,42000,37000,5000,5000
055926,國巨群益98購06  ,0,0,0,0,0,0,0,0,0,5000,0,0,0,5000,0,5000,5000
05593P,鴻海國票97售03  ,0,0,0,0,0,0,0,0,0,5000,0,0,0,5000,0,5000,5000
055867,臺股指元大97購05,0,0,0,0,0,0,0,0,0,5000,0,0,0,5000,0,5000,5000
055840,南亞科元大97購03,0,0,0,0,0,0,0,0,0,5000,0,0,0,5000,0,5000,5000
9929,秋雨            ,5000,0,5000,0,0,0,0,0,0,0,0,0,0,0,0,0,5000
3694,海華            ,9000,4000,5000,0,0,0,0,0,0,0,18000,18000,0,0,0,0,5000
5284,jpp-KY          ,5000,0,5000,0,0,0,0,0,0,0,0,0,0,0,0,0,5000
8467,波力-KY         ,6000,1000,5000,0,0,0,0,0,0,0,0,0,0,0,0,0,5000
8473,山林水          ,19000,14000,5000,0,0,0,0,0,0,0,1000,1000,0,0,0,0,5000
2630,亞航            ,5000,0,5000,0,0,0,0,0,0,0,0,0,0,0,0,0,5000
2540,愛山林          ,5000,0,5000,0,0,0,0,0,0,0,0,0,0,0,0,0,5000
06907P,華新科國泰99售05,0,0,0,0,0,0,0,0,0,5000,0,0,0,50000,45000,5000,5000
06817P,臺股指元富98售06,0,0,0,0,0,0,0,0,0,5000,0,0,0,5000,0,5000,5000
06840P,臺股指統一98售04,0,0,0,0,0,0,0,0,0,5000,0,0,0,5000,0,5000,5000
07029P,緯穎群益99售02  ,0,0,0,0,0,0,0,0,0,5000,0,0,0,5000,0,5000,5000
2114,鑫永銓          ,9000,4000,5000,0,0,0,0,0,0,0,0,0,0,0,0,0,5000
06709P,臺股指台新99售06,0,0,0,0,0,0,0,0,0,5000,0,0,0,505000,500000,5000,5000
06699P,台積電統一98售11,0,0,0,0,0,0,0,0,0,5000,0,0,0,5000,0,5000,5000
06776P,鴻海元大99售05  ,0,0,0,0,0,0,0,0,0,5000,0,0,0,61000,56000,5000,5000
06679P,旺宏元大98售09  ,0,0,0,0,0,0,0,0,0,5000,0,0,0,11000,6000,5000,5000
06659P,T50正2富邦9A售01,0,0,0,0,0,0,0,0,0,5000,0,0,0,5000,0,5000,5000
06610P,台積電凱基9A售03,0,0,0,0,0,0,0,0,0,5000,0,0,0,94000,89000,5000,5000
06620P,聯發科元大98售07,0,0,0,0,0,0,0,0,0,5000,0,0,0,41000,36000,5000,5000
06523P,台積電麥證98售02,0,0,0,5000,0,5000,0,0,0,5000,0,0,0,5000,0,5000,5000
06482P,台積電凱基98售13,0,0,0,0,0,0,0,0,0,5000,0,0,0,11000,6000,5000,5000
06547P,大立光元大98售09,0,0,0,0,0,0,0,0,0,5000,0,0,0,5000,0,5000,5000
06183P,大立光元大97售05,0,0,0,0,0,0,0,0,0,5000,0,0,0,5000,0,5000,5000
06134P,緯穎元富97售03  ,0,0,0,0,0,0,0,0,0,5000,0,0,0,5000,0,5000,5000
06345P,臺股指統一9A售01,0,0,0,0,0,0,0,0,0,5000,0,0,0,5000,0,5000,5000
06232P,智易永豐97售01  ,0,0,0,0,0,0,0,0,0,5000,0,0,0,5000,0,5000,5000
057393,台積電中信02購01,0,0,0,0,0,0,0,0,0,4000,0,0,0,888000,884000,4000,4000
057171,台光電元大9B購01,0,0,0,0,0,0,0,0,0,4000,0,0,0,105000,101000,4000,4000
057130,全新凱基98購03  ,0,0,0,0,0,0,0,0,0,4000,0,0,0,4000,0,4000,4000
057291,國巨國泰9A購01  ,0,0,0,0,0,0,0,0,0,4000,0,0,0,4000,0,4000,4000
056863,義隆群益98購01  ,0,0,0,0,0,0,0,0,0,4000,0,0,0,157000,153000,4000,4000
05820P,臺股指凱基96售17,0,0,0,0,0,0,0,0,0,4000,0,0,0,4000,0,4000,4000
058648,聯陽永豐99購01  ,0,0,0,0,0,0,0,0,0,4000,0,0,0,4000,0,4000,4000
05914P,友達元大96售04  ,0,0,0,0,0,0,0,0,0,4000,0,0,0,19000,15000,4000,4000
03607P,滬深2X富邦95售01,0,0,0,0,0,0,0,0,0,4000,0,0,0,4000,0,4000,4000
01002T,土銀國泰R1      ,12000,8000,4000,0,0,0,0,0,0,0,0,0,0,0,0,0,4000
04647P,上海銀凱基94售04,0,0,0,0,0,0,0,0,0,4000,0,0,0,20000,16000,4000,4000
046602,新日興群益94購01,0,0,0,0,0,0,0,0,0,4000,0,0,0,10000,6000,4000,4000
04325P,創意元大93售06  ,0,0,0,0,0,0,0,0,0,4000,0,0,0,4000,0,4000,4000
03102P,臺股指凱基03售08,0,0,0,0,0,0,0,0,0,4000,0,0,0,4000,0,4000,4000
045861,智邦統一93購02  ,0,0,0,0,0,0,0,0,0,4000,0,0,0,4000,0,4000,4000
046002,美律統一93購01  ,0,0,0,0,0,0,0,0,0,4000,0,0,0,4000,0,4000,4000
047049,聯發科國票94購01,0,0,0,0,0,0,0,0,0,4000,0,0,0,4000,0,4000,4000
044846,旺宏統一93購01  ,0,0,0,0,0,0,0,0,0,4000,0,0,0,4000,0,4000,4000
044768,深中小元大94購02,0,0,0,0,0,0,0,0,0,4000,0,0,0,4000,0,4000,4000
045640,嘉晶凱基93購01  ,0,0,0,0,0,0,0,0,0,4000,0,0,0,4000,0,4000,4000
04929P,同欣電凱基95售01,0,0,0,0,0,0,0,0,0,4000,0,0,0,252000,248000,4000,4000
049382,牧德元大94購04  ,0,0,0,0,0,0,0,0,0,4000,0,0,0,4000,0,4000,4000
049931,矽力元大94購01  ,0,0,0,0,0,0,0,0,0,4000,0,0,0,4000,0,4000,4000
04991P,台表科元大94售05,0,0,0,0,0,0,0,0,0,4000,0,0,0,4000,0,4000,4000
048888,牧德元富94購02  ,0,0,0,0,0,0,0,0,0,4000,0,0,0,4000,0,4000,4000
052885,高鐵兆豐98購01  ,0,0,0,0,0,0,0,0,0,4000,0,0,0,5000,1000,4000,4000
053361,友達元富99購01  ,0,0,0,0,0,0,0,0,0,4000,0,0,0,17000,13000,4000,4000
05345P,臺股指統一95售05,0,0,0,0,0,0,0,0,0,4000,0,0,0,4000,0,4000,4000
052384,臺股指元大95購30,0,0,0,0,0,0,0,0,0,4000,0,0,0,4000,0,4000,4000
05251P,喬山台新95售02  ,0,0,0,0,0,0,0,0,0,4000,0,0,0,30000,26000,4000,4000
053615,光罩群益96購01  ,0,0,0,0,0,0,0,0,0,4000,0,0,0,90000,86000,4000,4000
05094P,大立光元大95售07,0,0,0,0,0,0,0,0,0,4000,0,0,0,4000,0,4000,4000
052598,滬深2X元大96購05,0,0,0,0,0,0,0,0,0,4000,0,0,0,47000,43000,4000,4000
051146,旺宏凱基95購04  ,0,0,0,0,0,0,0,0,0,4000,0,0,0,10000,6000,4000,4000
05199P,訊芯永豐95售02  ,0,0,0,0,0,0,0,0,0,4000,0,0,0,56000,52000,4000,4000
051435,聯茂元富95購01  ,0,0,0,0,0,0,0,0,0,4000,0,0,0,39000,35000,4000,4000
056279,新日興富邦99購01,0,0,0,0,0,0,0,0,0,4000,0,0,0,20000,16000,4000,4000
055658,南電元富97購01  ,0,0,0,0,0,0,0,0,0,4000,0,0,0,20000,16000,4000,4000
055753,貿聯第一98購01  ,0,0,0,0,0,0,0,0,0,4000,0,0,0,5000,1000,4000,4000
055315,晶技麥證97購01  ,0,0,0,67000,39000,28000,0,0,0,4000,0,0,0,67000,63000,4000,4000
054872,瀚宇博群益98購01,0,0,0,0,0,0,0,0,0,4000,0,0,0,4000,0,4000,4000
054742,京鼎凱基99購01  ,0,0,0,0,0,0,0,0,0,4000,0,0,0,13000,9000,4000,4000
054800,訊芯群益99購01  ,0,0,0,0,0,0,0,0,0,4000,0,0,0,113000,109000,4000,4000
054319,世紀鋼凱基96購02,0,0,0,0,0,0,0,0,0,4000,0,0,0,205000,201000,4000,4000
054357,可成兆豐97購02  ,0,0,0,0,0,0,0,0,0,4000,0,0,0,10000,6000,4000,4000
054168,貿聯凱基97購02  ,0,0,0,0,0,0,0,0,0,4000,0,0,0,10000,6000,4000,4000
054179,上海銀台新97購01,0,0,0,0,0,0,0,0,0,4000,0,0,0,40000,36000,4000,4000
06528P,台積電富邦99售03,0,0,0,0,0,0,0,0,0,4000,0,0,0,253000,249000,4000,4000
06600P,貿聯永豐98售01  ,0,0,0,0,0,0,0,0,0,4000,0,0,0,39000,35000,4000,4000
06635P,聯發科凱基98售15,0,0,0,0,0,0,0,0,0,4000,0,0,0,59000,55000,4000,4000
2115,六暉-KY         ,4000,0,4000,0,0,0,0,0,0,0,0,0,0,0,0,0,4000
2243,宏旭-KY         ,5000,1000,4000,0,0,0,0,0,0,0,0,0,0,0,0,0,4000
1463,強盛            ,42000,38000,4000,0,0,0,0,0,0,0,0,0,0,0,0,0,4000
1466,聚隆            ,6000,2000,4000,0,0,0,0,0,0,0,0,0,0,0,0,0,4000
06999P,玉晶光國票9B售01,0,0,0,0,0,0,0,0,0,4000,0,0,0,28000,24000,4000,4000
07008P,台郡中信99售02  ,0,0,0,0,0,0,0,0,0,4000,0,0,0,24000,20000,4000,4000
06931P,大立光元大98售20,0,0,0,0,0,0,0,0,0,4000,0,0,0,5000,1000,4000,4000
2739,寒舍            ,4000,0,4000,0,0,0,0,0,0,0,1000,1000,0,0,0,0,4000
2440,太空梭          ,5000,0,5000,0,0,0,0,0,0,-1000,0,1000,-1000,0,0,0,4000
3229,晟鈦            ,4000,0,4000,0,0,0,0,0,0,0,0,0,0,0,0,0,4000
2882B,國泰金乙特      ,0,2000,-2000,0,0,0,0,0,0,6000,19000,13000,6000,0,0,0,4000
3031,佰鴻            ,162000,159000,3000,0,0,0,0,0,0,1000,1000,0,1000,0,0,0,4000
6671,三能-KY         ,7000,3000,4000,0,0,0,0,0,0,0,0,0,0,0,0,0,4000
05899P,臺股指凱基96售30,0,0,0,0,0,0,0,0,0,3000,0,0,0,3000,0,3000,3000
058087,鴻海元大98購15  ,0,0,0,0,0,0,0,0,0,3000,0,0,0,98000,95000,3000,3000
057915,台泥凱基98購01  ,0,0,0,0,0,0,0,0,0,3000,0,0,0,23000,20000,3000,3000
057927,勤誠凱基98購01  ,0,0,0,0,0,0,0,0,0,3000,0,0,0,10000,7000,3000,3000
056874,友達凱基98購08  ,0,0,0,0,0,0,0,0,0,3000,0,0,0,3000,0,3000,3000
056915,上銀兆豐99購01  ,0,0,0,0,0,0,0,0,0,3000,0,0,0,8000,5000,3000,3000
056969,智易永豐98購01  ,0,0,0,0,0,0,0,0,0,3000,0,0,0,62000,59000,3000,3000
056633,鴻海永昌98購02  ,0,0,0,0,0,0,0,0,0,3000,0,0,0,29000,26000,3000,3000
057271,國巨元大98購17  ,0,0,0,0,0,0,0,0,0,3000,0,0,0,144000,141000,3000,3000
057481,技嘉元大98購04  ,0,0,0,0,0,0,0,0,0,3000,0,0,0,31000,28000,3000,3000
057632,傳奇永豐98購01  ,0,0,0,0,0,0,0,0,0,3000,0,0,0,4000,1000,3000,3000
052905,潤泰全國票97購01,0,0,0,0,0,0,0,0,0,3000,0,0,0,13000,10000,3000,3000
04915P,鴻海永昌96售02  ,0,0,0,0,0,0,0,0,0,3000,0,0,0,14000,11000,3000,3000
05278P,台郡元富95售02  ,0,0,0,0,0,0,0,0,0,3000,0,0,0,40000,37000,3000,3000
048655,A50正2元富96購01,0,0,0,0,0,0,0,0,0,3000,0,0,0,3000,0,3000,3000
048534,貿聯國票94購01  ,0,0,0,0,0,0,0,0,0,3000,0,0,0,3000,0,3000,3000
048566,上海銀元大93購04,0,0,0,0,0,0,0,0,0,3000,0,0,0,3000,0,3000,3000
04800P,聯茂元大94售08  ,0,0,0,0,0,0,0,0,0,3000,0,0,0,3000,0,3000,3000
050056,國巨凱基94購04  ,0,0,0,0,0,0,0,0,0,3000,0,0,0,23000,20000,3000,3000
04526P,美律凱基94售03  ,0,0,0,0,0,0,0,0,0,3000,0,0,0,3000,0,3000,3000
04599P,南亞科凱基94售03,0,0,0,0,0,0,0,0,0,3000,0,0,0,113000,110000,3000,3000
046962,群創中信95購03  ,0,0,0,0,0,0,0,0,0,3000,0,0,0,3000,0,3000,3000
04651P,臺股指凱基94售10,0,0,0,0,0,0,0,0,0,3000,0,0,0,13000,10000,3000,3000
046300,嘉聯益富邦94購01,0,0,0,0,0,0,0,0,0,3000,0,0,0,3000,0,3000,3000
00742,新光內需收益    ,0,0,0,0,0,0,0,0,0,3000,0,0,0,4000,1000,3000,3000
03429B,臺股指元富97熊07,0,0,0,0,0,0,0,0,0,3000,0,0,0,3000,0,3000,3000
04076P,臺股指凱基93售12,0,0,0,0,0,0,0,0,0,3000,0,0,0,3000,0,3000,3000
04103P,臺股指國票93售10,0,0,0,0,0,0,0,0,0,3000,0,0,0,3000,0,3000,3000
050636,上証2X國票94購01,0,0,0,0,0,0,0,0,0,3000,0,0,0,5000,2000,3000,3000
053055,聯詠國票97購01  ,0,0,0,0,0,0,0,0,0,3000,0,0,0,32000,29000,3000,3000
050219,台積電元富95購03,0,0,0,0,0,0,0,0,0,3000,0,0,0,3000,0,3000,3000
050269,欣興元大94購09  ,0,0,0,0,0,0,0,0,0,3000,0,0,0,3000,0,3000,3000
050964,晶技永豐95購02  ,0,0,0,0,0,0,0,0,0,3000,0,0,0,28000,25000,3000,3000
05009P,大立光元富95售06,0,0,0,0,0,0,0,0,0,3000,0,0,0,8000,5000,3000,3000
05315P,鴻海永昌96售08  ,0,0,0,0,0,0,0,0,0,3000,0,0,0,59000,56000,3000,3000
053632,新唐兆豐96購01  ,0,0,0,0,0,0,0,0,0,3000,0,0,0,103000,100000,3000,3000
052308,大立光國泰97購02,0,0,0,0,0,0,0,0,0,3000,0,0,0,167000,164000,3000,3000
05371P,臺股指中信95售10,0,0,0,0,0,0,0,0,0,3000,0,0,0,4000,1000,3000,3000
053530,聯發科康和96購01,0,0,0,0,0,0,0,0,0,3000,0,0,0,3000,0,3000,3000
051388,大立光麥證95購03,0,0,0,3000,0,3000,0,0,0,3000,0,0,0,3000,0,3000,3000
05161P,華新科國票96售01,0,0,0,0,0,0,0,0,0,3000,0,0,0,3000,0,3000,3000
051756,台積電元大97購04,0,0,0,0,0,0,0,0,0,3000,0,0,0,7000,4000,3000,3000
05421P,鴻海元大96售12  ,0,0,0,0,0,0,0,0,0,3000,0,0,0,158000,155000,3000,3000
054334,超眾永豐96購04  ,0,0,0,0,0,0,0,0,0,3000,0,0,0,3000,0,3000,3000
054307,高鐵凱基98購01  ,0,0,0,0,0,0,0,0,0,3000,0,0,0,3000,0,3000,3000
054448,矽力兆豐96購01  ,0,0,0,0,0,0,0,0,0,3000,0,0,0,3000,0,3000,3000
053809,上銀群益96購02  ,0,0,0,0,0,0,0,0,0,3000,0,0,0,72000,69000,3000,3000
054478,可成中信97購01  ,0,0,0,0,0,0,0,0,0,3000,0,0,0,8000,5000,3000,3000
054472,道瓊反中信9A購01,0,0,0,0,0,0,0,0,0,3000,0,0,0,3000,0,3000,3000
054877,百和群益98購01  ,0,0,0,0,0,0,0,0,0,3000,0,0,0,3000,0,3000,3000
055253,大立光統一97購06,0,0,0,0,0,0,0,0,0,3000,0,0,0,13000,10000,3000,3000
055381,茂林元大97購02  ,0,0,0,0,0,0,0,0,0,3000,0,0,0,28000,25000,3000,3000
055426,旺宏群益99購02  ,0,0,0,0,0,0,0,0,0,3000,0,0,0,31000,28000,3000,3000
055649,華新科元富97購03,0,0,0,0,0,0,0,0,0,3000,0,0,0,20000,17000,3000,3000
055687,瀚宇博凱基97購01,0,0,0,0,0,0,0,0,0,3000,0,0,0,9000,6000,3000,3000
055619,同欣電國票98購02,0,0,0,0,0,0,0,0,0,3000,0,0,0,13000,10000,3000,3000
056353,鴻海元大99購02  ,0,0,0,0,0,0,0,0,0,3000,0,0,0,6000,3000,3000,3000
055831,台達電元大97購01,0,0,0,0,0,0,0,0,0,3000,0,0,0,62000,59000,3000,3000
055923,矽力凱基98購01  ,0,0,0,0,0,0,0,0,0,3000,0,0,0,6000,3000,3000,3000
8201,無敵            ,5000,2000,3000,0,0,0,0,0,0,0,0,0,0,0,0,0,3000
3701,大眾控          ,3000,0,3000,0,0,0,0,0,0,0,0,0,0,0,0,0,3000
2613,中櫃            ,5000,2000,3000,0,0,0,0,0,0,0,0,0,0,0,0,0,3000
9912,偉聯            ,4000,1000,3000,0,0,0,0,0,0,0,0,0,0,0,0,0,3000
06869P,金融類元大99售01,0,0,0,0,0,0,0,0,0,3000,0,0,0,10000,7000,3000,3000
06976P,臺股指元大9A售14,0,0,0,0,0,0,0,0,0,3000,0,0,0,3000,0,3000,3000
1468,昶和            ,5000,2000,3000,0,0,0,0,0,0,0,0,0,0,0,0,0,3000
1437,勤益控          ,19000,16000,3000,0,0,0,0,0,0,0,0,0,0,0,0,0,3000
1583,程泰            ,17000,14000,3000,0,0,0,0,0,0,0,0,0,0,0,0,0,3000
1540,喬福            ,30000,27000,3000,0,0,0,0,0,0,0,0,0,0,0,0,0,3000
1724,台硝            ,3000,0,3000,0,0,0,0,0,0,0,0,0,0,0,0,0,3000
1732,毛寶            ,3000,0,3000,0,0,0,0,0,0,0,0,0,0,0,0,0,3000
2415,錩新            ,5000,0,5000,0,0,0,0,0,0,-2000,0,2000,-2000,0,0,0,3000
06598P,奇力新永豐98售02,0,0,0,0,0,0,0,0,0,3000,0,0,0,25000,22000,3000,3000
06333P,臺股指群益9C售02,0,0,0,0,0,0,0,0,0,3000,0,0,0,3000,0,3000,3000
06200P,聯發科元大97售18,0,0,0,0,0,0,0,0,0,3000,0,0,0,33000,30000,3000,3000
3008,大立光          ,330000,365168,-35168,0,0,0,35000,7300,27700,10000,14000,15000,-1000,12000,1000,11000,2532
057616,聯電凱基99購01  ,0,0,0,0,0,0,0,0,0,2000,0,0,0,2000,0,2000,2000
05750P,臺股指群益99售04,0,0,0,0,0,0,0,0,0,2000,0,0,0,2000,0,2000,2000
057083,立積統一98購01  ,0,0,0,0,0,0,0,0,0,2000,0,0,0,64000,62000,2000,2000
056688,聯詠統一98購01  ,0,0,0,0,0,0,0,0,0,2000,0,0,0,12000,10000,2000,2000
057921,可成凱基98購09  ,0,0,0,0,0,0,0,0,0,2000,0,0,0,70000,68000,2000,2000
05787P,臺股指永昌96售04,0,0,0,0,0,0,0,0,0,2000,0,0,0,2000,0,2000,2000
05770P,聯發科凱基96售16,0,0,0,0,0,0,0,0,0,2000,0,0,0,2000,0,2000,2000
05812P,臺股指國票96售05,0,0,0,0,0,0,0,0,0,2000,0,0,0,2000,0,2000,2000
058241,景碩元大99購05  ,0,0,0,0,0,0,0,0,0,2000,0,0,0,2000,0,2000,2000
05931P,鴻海凱基96售15  ,0,0,0,0,0,0,0,0,0,2000,0,0,0,2000,0,2000,2000
058429,欣興元富99購01  ,0,0,0,0,0,0,0,0,0,2000,0,0,0,2000,0,2000,2000
04207P,臺股指元大93售47,0,0,0,0,0,0,0,0,0,2000,0,0,0,2000,0,2000,2000
03454P,台積電凱基03售14,0,0,0,0,0,0,0,0,0,2000,0,0,0,2000,0,2000,2000
03517P,臺股指國票02售06,0,0,0,0,0,0,0,0,0,2000,0,0,0,2000,0,2000,2000
00700,富邦恒生國企    ,0,0,0,0,0,0,0,0,0,2000,0,0,0,6000,4000,2000,2000
04678P,臺股指統一94售03,0,0,0,0,0,0,0,0,0,2000,0,0,0,2000,0,2000,2000
04412P,欣興元富94售01  ,0,0,0,0,0,0,0,0,0,2000,0,0,0,3000,1000,2000,2000
04610P,世紀鋼永豐94售03,0,0,0,0,0,0,0,0,0,2000,0,0,0,102000,100000,2000,2000
046191,新光金凱基98購01,0,0,0,0,0,0,0,0,0,2000,0,0,0,4000,2000,2000,2000
046241,聯發科中信94購02,0,0,0,0,0,0,0,0,0,2000,0,0,0,2000,0,2000,2000
04308P,京元電凱基93售06,0,0,0,0,0,0,0,0,0,2000,0,0,0,21000,19000,2000,2000
04372P,臺股指凱基94售02,0,0,0,0,0,0,0,0,0,2000,0,0,0,2000,0,2000,2000
04706P,力山元大95售01  ,0,0,0,0,0,0,0,0,0,2000,0,0,0,2000,0,2000,2000
04516P,台積電群益94售07,0,0,0,0,0,0,0,0,0,2000,0,0,0,2000,0,2000,2000
045001,旺宏富邦94購01  ,0,0,0,0,0,0,0,0,0,2000,0,0,0,2000,0,2000,2000
04515P,元油2X群益97售02,0,0,0,0,0,0,0,0,0,2000,0,0,0,2000,0,2000,2000
045685,康控元大95購01  ,0,0,0,0,0,0,0,0,0,2000,0,0,0,12000,10000,2000,2000
04958P,和大凱基94售04  ,0,0,0,0,0,0,0,0,0,2000,0,0,0,9000,7000,2000,2000
048158,大立光兆豐95購01,0,0,0,0,0,0,0,0,0,2000,0,0,0,2000,0,2000,2000
047991,元油反元大96購05,0,0,0,0,0,0,0,0,0,2000,0,0,0,2000,0,2000,2000
047704,智邦凱基93購06  ,0,0,0,0,0,0,0,0,0,2000,0,0,0,42000,40000,2000,2000
048509,上証反凱基99購02,0,0,0,0,0,0,0,0,0,2000,0,0,0,2000,0,2000,2000
049903,大立光元富94購06,0,0,0,0,0,0,0,0,0,2000,0,0,0,2000,0,2000,2000
04992P,元油2X富邦97售04,0,0,0,0,0,0,0,0,0,2000,0,0,0,2000,0,2000,2000
04994P,大成鋼凱基95售01,0,0,0,0,0,0,0,0,0,2000,0,0,0,2000,0,2000,2000
049408,旺宏日盛94購01  ,0,0,0,0,0,0,0,0,0,2000,0,0,0,2000,0,2000,2000
048712,樺漢台新94購01  ,0,0,0,0,0,0,0,0,0,2000,0,0,0,2000,0,2000,2000
048784,台積電元大94購04,0,0,0,0,0,0,0,0,0,2000,0,0,0,7000,5000,2000,2000
04885P,大立光凱基94售19,0,0,0,0,0,0,0,0,0,2000,0,0,0,2000,0,2000,2000
048871,晶豪科國票94購01,0,0,0,0,0,0,0,0,0,2000,0,0,0,2000,0,2000,2000
049170,亞德客凱基94購01,0,0,0,0,0,0,0,0,0,2000,0,0,0,12000,10000,2000,2000
049151,大立光元大94購07,0,0,0,0,0,0,0,0,0,2000,0,0,0,2000,0,2000,2000
049198,聯鈞永豐94購01  ,0,0,0,0,0,0,0,0,0,2000,0,0,0,2000,0,2000,2000
051752,緯穎富邦96購01  ,0,0,0,0,0,0,0,0,0,2000,0,0,0,5000,3000,2000,2000
053703,緯穎兆豐96購01  ,0,0,0,0,0,0,0,0,0,2000,0,0,0,30000,28000,2000,2000
053412,台達電國票97購02,0,0,0,0,0,0,0,0,0,2000,0,0,0,56000,54000,2000,2000
05239P,欣興永豐95售03  ,0,0,0,0,0,0,0,0,0,2000,0,0,0,20000,18000,2000,2000
052370,滬深2X元大95購04,0,0,0,0,0,0,0,0,0,2000,0,0,0,2000,0,2000,2000
052354,健策群益96購02  ,0,0,0,0,0,0,0,0,0,2000,0,0,0,83000,81000,2000,2000
052439,寶成富邦97購01  ,0,0,0,0,0,0,0,0,0,2000,0,0,0,2000,0,2000,2000
053081,上銀元大97購02  ,0,0,0,0,0,0,0,0,0,2000,0,0,0,2000,0,2000,2000
053108,南亞科兆豐96購01,0,0,0,0,0,0,0,0,0,2000,0,0,0,5000,3000,2000,2000
05192P,玉晶光台新96售02,0,0,0,0,0,0,0,0,0,2000,0,0,0,2000,0,2000,2000
052709,光寶科日盛96購01,0,0,0,0,0,0,0,0,0,2000,0,0,0,88000,86000,2000,2000
050220,台積電元富96購01,0,0,0,0,0,0,0,0,0,2000,0,0,0,12000,10000,2000,2000
053246,聯詠國票97購02  ,0,0,0,0,0,0,0,0,0,2000,0,0,0,2000,0,2000,2000
050620,和碩元大94購04  ,0,0,0,0,0,0,0,0,0,2000,0,0,0,80000,78000,2000,2000
05146P,鴻海元大95售10  ,0,0,0,0,0,0,0,0,0,2000,0,0,0,79000,77000,2000,2000
055919,景碩凱基98購02  ,0,0,0,0,0,0,0,0,0,2000,0,0,0,2000,0,2000,2000
056028,GIS群益97購02   ,0,0,0,0,0,0,0,0,0,2000,0,0,0,22000,20000,2000,2000
056370,台郡元大98購03  ,0,0,0,0,0,0,0,0,0,2000,0,0,0,88000,86000,2000,2000
056385,創意國泰99購01  ,0,0,0,0,0,0,0,0,0,2000,0,0,0,16000,14000,2000,2000
05559P,臺股指麥證96售01,0,0,0,2000,0,2000,0,0,0,2000,0,0,0,2000,0,2000,2000
055537,康友群益97購03  ,0,0,0,0,0,0,0,0,0,2000,0,0,0,2000,0,2000,2000
05535P,台積電元大97售06,0,0,0,0,0,0,0,0,0,2000,0,0,0,936000,934000,2000,2000
055257,景碩統一97購01  ,0,0,0,0,0,0,0,0,0,2000,0,0,0,2000,0,2000,2000
054908,群電康和97購01  ,0,0,0,0,0,0,0,0,0,2000,0,0,0,2000,0,2000,2000
055141,牧德永豐98購02  ,0,0,0,0,0,0,0,0,0,2000,0,0,0,3000,1000,2000,2000
055101,台肥凱基97購01  ,0,0,0,0,0,0,0,0,0,2000,0,0,0,2000,0,2000,2000
054543,元金2X中信01購01,0,0,0,0,0,0,0,0,0,2000,0,0,0,2000,0,2000,2000
053754,英業達元富96購02,0,0,0,0,0,0,0,0,0,2000,0,0,0,100000,98000,2000,2000
053764,A50正2富邦99購01,0,0,0,0,0,0,0,0,0,2000,0,0,0,2000,0,2000,2000
053773,上銀元大96購04  ,0,0,0,0,0,0,0,0,0,2000,0,0,0,2000,0,2000,2000
05391P,鴻海統一95售12  ,0,0,0,0,0,0,0,0,0,2000,0,0,0,2000,0,2000,2000
053912,T50反1國票97購02,0,0,0,0,0,0,0,0,0,2000,0,0,0,12000,10000,2000,2000
054106,元油反凱基9C購01,0,0,0,0,0,0,0,0,0,2000,0,0,0,2000,0,2000,2000
05429P,鴻海統一95售16  ,0,0,0,0,0,0,0,0,0,2000,0,0,0,2000,0,2000,2000
05416P,喬山永豐95售04  ,0,0,0,0,0,0,0,0,0,2000,0,0,0,8000,6000,2000,2000
2910,統領            ,2000,0,2000,0,0,0,0,0,0,0,0,0,0,0,0,0,2000
2891B,中信金乙特      ,0,0,0,0,0,0,0,0,0,2000,8000,6000,2000,0,0,0,2000
3296,勝德            ,3000,1000,2000,0,0,0,0,0,0,0,0,0,0,0,0,0,2000
2491,吉祥全          ,2000,0,2000,0,0,0,0,0,0,0,0,0,0,0,0,0,2000
2497,怡利電          ,5000,3000,2000,0,0,0,0,0,0,0,0,0,0,0,0,0,2000
4555,氣立            ,14000,12000,2000,0,0,0,0,0,0,0,0,0,0,0,0,0,2000
8443,阿瘦            ,3000,1000,2000,0,0,0,0,0,0,0,0,0,0,0,0,0,2000
8466,美吉吉-KY       ,4000,2000,2000,0,0,0,0,0,0,0,0,0,0,0,0,0,2000
6674,鋐寶科技        ,1000,0,1000,0,0,0,0,0,0,1000,2000,1000,1000,0,0,0,2000
8072,陞泰            ,2000,0,2000,0,0,0,0,0,0,0,0,0,0,0,0,0,2000
6205,詮欣            ,3000,1000,2000,0,0,0,0,0,0,0,0,0,0,0,0,0,2000
9918,欣天然          ,3000,1000,2000,0,0,0,0,0,0,0,0,0,0,0,0,0,2000
06197P,國巨元大97售08  ,0,0,0,0,0,0,0,0,0,2000,0,0,0,157000,155000,2000,2000
06177P,玉晶光元大98售07,0,0,0,0,0,0,0,0,0,2000,0,0,0,56000,54000,2000,2000
06340P,鴻海統一98售06  ,0,0,0,0,0,0,0,0,0,2000,0,0,0,2000,0,2000,2000
06313P,訊芯元富97售01  ,0,0,0,0,0,0,0,0,0,2000,0,0,0,50000,48000,2000,2000
06446P,大立光凱基98售10,0,0,0,0,0,0,0,0,0,2000,0,0,0,2000,0,2000,2000
06621P,欣興元大98售06  ,0,0,0,0,0,0,0,0,0,2000,0,0,0,12000,10000,2000,2000
06730P,祥碩元大98售07  ,0,0,0,0,0,0,0,0,0,2000,0,0,0,109000,107000,2000,2000
2008,高興昌          ,2000,0,2000,0,0,0,0,0,0,0,0,0,0,0,0,0,2000
1445,大宇            ,2000,0,2000,0,0,0,0,0,0,0,0,0,0,0,0,0,2000
1324,地球            ,2000,0,2000,0,0,0,0,0,0,0,0,0,0,0,0,0,2000
06871P,元油2X群益98售04,0,0,0,0,0,0,0,0,0,2000,0,0,0,2000,0,2000,2000
05941P,聯發科凱基96售22,0,0,0,0,0,0,0,0,0,1000,0,0,0,1000,0,1000,1000
05973P,聯詠元大96售06  ,0,0,0,0,0,0,0,0,0,1000,0,0,0,51000,50000,1000,1000
05913P,國巨元大96售11  ,0,0,0,0,0,0,0,0,0,1000,0,0,0,71000,70000,1000,1000
05869P,旺宏凱基96售05  ,0,0,0,0,0,0,0,0,0,1000,0,0,0,19000,18000,1000,1000
058255,臺股指元大9A購19,0,0,0,0,0,0,0,0,0,1000,0,0,0,1000,0,1000,1000
058271,訊連永豐99購01  ,0,0,0,0,0,0,0,0,0,1000,0,0,0,1000,0,1000,1000
058143,瑞儀元大99購02  ,0,0,0,0,0,0,0,0,0,1000,0,0,0,1000,0,1000,1000
05808P,臺股指國票96售01,0,0,0,0,0,0,0,0,0,1000,0,0,0,1000,0,1000,1000
058014,上銀凱基99購02  ,0,0,0,0,0,0,0,0,0,1000,0,0,0,1000,0,1000,1000
05776P,鴻海統一98售02  ,0,0,0,0,0,0,0,0,0,1000,0,0,0,1000,0,1000,1000
057873,義隆元大98購03  ,0,0,0,0,0,0,0,0,0,1000,0,0,0,77000,76000,1000,1000
056493,晶技國泰99購01  ,0,0,0,0,0,0,0,0,0,1000,0,0,0,5000,4000,1000,1000
057044,旺宏元大98購08  ,0,0,0,0,0,0,0,0,0,1000,0,0,0,69000,68000,1000,1000
057077,國巨統一98購06  ,0,0,0,0,0,0,0,0,0,1000,0,0,0,1000,0,1000,1000
057488,聯發科元大99購02,0,0,0,0,0,0,0,0,0,1000,0,0,0,258000,257000,1000,1000
052684,旺宏元大98購01  ,0,0,0,0,0,0,0,0,0,1000,0,0,0,270000,269000,1000,1000
052671,祥碩群益96購01  ,0,0,0,0,0,0,0,0,0,1000,0,0,0,1000,0,1000,1000
05275P,國巨凱基95售05  ,0,0,0,0,0,0,0,0,0,1000,0,0,0,264000,263000,1000,1000
052818,智邦永豐96購01  ,0,0,0,0,0,0,0,0,0,1000,0,0,0,69000,68000,1000,1000
052873,新唐凱基96購02  ,0,0,0,0,0,0,0,0,0,1000,0,0,0,1000,0,1000,1000
052879,滬深2X凱基97購02,0,0,0,0,0,0,0,0,0,1000,0,0,0,1000,0,1000,1000
049185,南電凱基94購03  ,0,0,0,0,0,0,0,0,0,1000,0,0,0,20000,19000,1000,1000
048852,旺宏群益96購02  ,0,0,0,0,0,0,0,0,0,1000,0,0,0,73000,72000,1000,1000
048689,台光電群益94購01,0,0,0,0,0,0,0,0,0,1000,0,0,0,1000,0,1000,1000
047725,廣達群益93購01  ,0,0,0,0,0,0,0,0,0,1000,0,0,0,1000,0,1000,1000
047925,可成凱基94購01  ,0,0,0,0,0,0,0,0,0,1000,0,0,0,1000,0,1000,1000
048052,力成中信93購01  ,0,0,0,0,0,0,0,0,0,1000,0,0,0,1000,0,1000,1000
04823P,台積電元富94售09,0,0,0,0,0,0,0,0,0,1000,0,0,0,1000,0,1000,1000
048245,台積電兆豐93購07,0,0,0,0,0,0,0,0,0,1000,0,0,0,1000,0,1000,1000
047342,T50反1中信99購01,0,0,0,0,0,0,0,0,0,1000,0,0,0,20000,19000,1000,1000
04723P,美律凱基94售06  ,0,0,0,0,0,0,0,0,0,1000,0,0,0,1000,0,1000,1000
049559,香港反統一94購02,0,0,0,0,0,0,0,0,0,1000,0,0,0,2000,1000,1000,1000
04924P,元油2X元大94售12,0,0,0,0,0,0,0,0,0,1000,0,0,0,1000,0,1000,1000
04557P,茂林群益94售03  ,0,0,0,0,0,0,0,0,0,1000,0,0,0,1000,0,1000,1000
04547P,高鐵元大94售01  ,0,0,0,0,0,0,0,0,0,1000,0,0,0,1000,0,1000,1000
04704P,臺股指統一95售01,0,0,0,0,0,0,0,0,0,1000,0,0,0,1000,0,1000,1000
04593P,台積電元大94售11,0,0,0,0,0,0,0,0,0,1000,0,0,0,1000,0,1000,1000
045754,大立光國泰94購03,0,0,0,0,0,0,0,0,0,1000,0,0,0,1000,0,1000,1000
04573P,聯電統一94售02  ,0,0,0,0,0,0,0,0,0,1000,0,0,0,1000,0,1000,1000
046866,台積電統一94購03,0,0,0,0,0,0,0,0,0,1000,0,0,0,1000,0,1000,1000
04309P,滬深2X統一93售05,0,0,0,0,0,0,0,0,0,1000,0,0,0,1000,0,1000,1000
04021P,寶滬深元富93售01,0,0,0,0,0,0,0,0,0,1000,0,0,0,1000,0,1000,1000
03632C,臺股指元大95牛03,0,0,0,0,0,0,0,0,0,1000,0,0,0,1000,0,1000,1000
046492,旺宏富邦94購02  ,0,0,0,0,0,0,0,0,0,1000,0,0,0,1000,0,1000,1000
04650P,臺股指凱基94售09,0,0,0,0,0,0,0,0,0,1000,100000,0,100000,101000,200000,-99000,1000
04666P,臺股指國票94售05,0,0,0,0,0,0,0,0,0,1000,0,0,0,11000,10000,1000,1000
00732,國泰RMB短期報酬 ,0,0,0,0,0,0,0,0,0,1000,0,0,0,99000,98000,1000,1000
01003T,兆豐新光R1      ,2000,1000,1000,0,0,0,0,0,0,0,0,0,0,0,0,0,1000
020007,凱基臺灣500N    ,0,0,0,0,0,0,0,0,0,1000,0,0,0,1000,0,1000,1000
04061P,臺股指群益93售15,0,0,0,0,0,0,0,0,0,1000,0,0,0,1000,0,1000,1000
0054,元大台商50      ,0,0,0,0,0,0,0,0,0,1000,0,0,0,11000,10000,1000,1000
03307P,臺股指中信05售02,0,0,0,0,0,0,0,0,0,1000,0,0,0,1000,0,1000,1000
042093,台灣50群益94購02,0,0,0,0,0,0,0,0,0,1000,0,0,0,1000,0,1000,1000
04239P,上銀凱基93售08  ,0,0,0,0,0,0,0,0,0,1000,0,0,0,1000,0,1000,1000
051194,大立光中信96購02,0,0,0,0,0,0,0,0,0,1000,0,0,0,21000,20000,1000,1000
050747,道瓊銀統一94購03,0,0,0,0,0,0,0,0,0,1000,0,0,0,1000,0,1000,1000
05109P,臺股指麥證95售01,0,0,0,1000,0,1000,0,0,0,1000,0,0,0,1000,0,1000,1000
05114P,臺股指元富95售02,0,0,0,0,0,0,0,0,0,1000,0,0,0,1000,0,1000,1000
050304,台光電中信94購01,0,0,0,0,0,0,0,0,0,1000,0,0,0,1000,0,1000,1000
050188,貿聯元大96購01  ,0,0,0,0,0,0,0,0,0,1000,0,0,0,1000,0,1000,1000
050973,S&P反1統一95購01,0,0,0,0,0,0,0,0,0,1000,0,0,0,1000,0,1000,1000
053180,同欣電統一96購01,0,0,0,0,0,0,0,0,0,1000,0,0,0,1000,0,1000,1000
053290,元油反中信97購01,0,0,0,0,0,0,0,0,0,1000,0,0,0,1000,0,1000,1000
052230,大立光凱基96購09,0,0,0,0,0,0,0,0,0,1000,0,0,0,2000,1000,1000,1000
053533,光罩永豐96購03  ,0,0,0,0,0,0,0,0,0,1000,0,0,0,1000,0,1000,1000
053524,聯電中信97購02  ,0,0,0,0,0,0,0,0,0,1000,0,0,0,2000,1000,1000,1000
051721,玉晶光永豐96購02,0,0,0,0,0,0,0,0,0,1000,0,0,0,1000,0,1000,1000
051424,緯穎國票97購01  ,0,0,0,0,0,0,0,0,0,1000,0,0,0,10000,9000,1000,1000
05137P,華新科凱基96售03,0,0,0,0,0,0,0,0,0,1000,0,0,0,1000,0,1000,1000
05212P,台積電國票96售04,0,0,0,0,0,0,0,0,0,1000,0,0,0,1000,0,1000,1000
05032P,台積電國泰96售05,0,0,0,0,0,0,0,0,0,1000,0,0,0,21000,20000,1000,1000
050334,鴻海國泰96購07  ,0,0,0,0,0,0,0,0,0,1000,0,0,0,51000,50000,1000,1000
050341,光寶科元富94購01,0,0,0,0,0,0,0,0,0,1000,0,0,0,51000,50000,1000,1000
054184,A50正2永豐96購01,0,0,0,0,0,0,0,0,0,1000,0,0,0,1000,0,1000,1000
05422P,大立光中信97售02,0,0,0,0,0,0,0,0,0,1000,0,0,0,1000,0,1000,1000
054287,台積電元大97購11,0,0,0,0,0,0,0,0,0,1000,0,0,0,1000,0,1000,1000
054102,百和國票97購04  ,0,0,0,0,0,0,0,0,0,1000,0,0,0,1000,0,1000,1000
053811,國巨群益98購02  ,0,0,0,0,0,0,0,0,0,1000,0,0,0,1000,0,1000,1000
053833,彩晶台新97購02  ,0,0,0,0,0,0,0,0,0,1000,0,0,0,5000,4000,1000,1000
054669,凌華元富97購01  ,0,0,0,0,0,0,0,0,0,1000,0,0,0,1000,0,1000,1000
055037,宏盛富邦99購01  ,0,0,0,0,0,0,0,0,0,1000,0,0,0,1000,0,1000,1000
054864,聯發科群益97購02,0,0,0,0,0,0,0,0,0,1000,0,0,0,2000,1000,1000,1000
055654,景碩元富97購01  ,0,0,0,0,0,0,0,0,0,1000,0,0,0,1000,0,1000,1000
056012,勤誠中信99購01  ,0,0,0,0,0,0,0,0,0,1000,0,0,0,1000,0,1000,1000
05586P,臺股指凱基96售15,0,0,0,0,0,0,0,0,0,1000,0,0,0,1000,0,1000,1000
06846P,美律元大98售05  ,0,0,0,0,0,0,0,0,0,1000,0,0,0,5000,4000,1000,1000
06785P,臺股指元大98售02,0,0,0,0,0,0,0,0,0,1000,0,0,0,1000,0,1000,1000
06910P,元油2X元大98售23,0,0,0,0,0,0,0,0,0,1000,0,0,0,1000,0,1000,1000
06882P,聯發科群益98售07,0,0,0,0,0,0,0,0,0,1000,0,0,0,20000,19000,1000,1000
06876P,台灣50兆豐9B售01,0,0,0,0,0,0,0,0,0,1000,1000,0,1000,1000,1000,0,1000
06971P,台光電元大99售03,0,0,0,0,0,0,0,0,0,1000,0,0,0,310000,309000,1000,1000
1438,裕豐            ,1000,0,1000,0,0,0,0,0,0,0,0,0,0,0,0,0,1000
1472,三洋紡          ,6000,5000,1000,0,0,0,0,0,0,0,0,0,0,0,0,0,1000
2012,春雨            ,15000,14000,1000,0,0,0,0,0,0,0,0,0,0,0,0,0,1000
1805,寶徠            ,2000,1000,1000,0,0,0,0,0,0,0,0,0,0,0,0,0,1000
06697P,台積電國票99售05,0,0,0,0,0,0,0,0,0,1000,0,0,0,6000,5000,1000,1000
06331P,南亞科群益97售04,0,0,0,0,0,0,0,0,0,1000,0,0,0,11000,10000,1000,1000
06344P,臺股指統一99售03,0,0,0,0,0,0,0,0,0,1000,0,0,0,1000,0,1000,1000
06192P,高股息中信98售01,0,0,0,0,0,0,0,0,0,1000,0,0,0,1000,0,1000,1000
06070P,漢唐永豐97售01  ,0,0,0,0,0,0,0,0,0,1000,0,0,0,220000,219000,1000,1000
9928,中視            ,0,0,0,0,0,0,0,0,0,1000,1000,0,1000,0,0,0,1000
6215,和椿            ,11000,10000,1000,0,0,0,0,0,0,0,4000,4000,0,0,0,0,1000
4581,光隆精密-KY     ,1000,0,1000,0,0,0,0,0,0,0,0,0,0,0,0,0,1000
6117,迎廣            ,2000,1000,1000,0,0,0,0,0,0,0,0,0,0,0,0,0,1000
2438,翔耀            ,1000,0,1000,0,0,0,0,0,0,0,0,0,0,0,0,0,1000
2936,客思達-KY       ,6000,5000,1000,0,0,0,0,0,0,0,0,0,0,0,0,0,1000
6289,華上            ,1,0,1,0,0,0,0,0,0,0,0,0,0,0,0,0,1
057483,微星元大98購04  ,0,0,0,0,0,0,0,0,0,0,0,0,0,68000,68000,0,0
057484,南亞科元大98購06,0,0,0,0,0,0,0,0,0,0,0,0,0,10000,10000,0,0
057480,技嘉元大98購03  ,0,0,0,0,0,0,0,0,0,0,0,0,0,21000,21000,0,0
057509,聯發科統一9A購03,0,0,0,0,0,0,0,0,0,0,0,0,0,48000,48000,0,0
057465,智易永豐98購02  ,0,0,0,0,0,0,0,0,0,0,0,0,0,27000,27000,0,0
057460,楠梓電永豐98購03,0,0,0,0,0,0,0,0,0,0,0,0,0,10000,10000,0,0
05739P,臺股指統一97售02,0,0,0,0,0,0,0,0,0,0,0,0,0,10000,10000,0,0
057386,聯發科永豐98購04,0,0,0,0,0,0,0,0,0,0,0,0,0,50000,50000,0,0
057371,可成元大98購08  ,0,0,0,0,0,0,0,0,0,0,0,0,0,91000,91000,0,0
057369,奇力新元大99購05,0,0,0,0,0,0,0,0,0,0,0,0,0,50000,50000,0,0
057525,光磊元大99購01  ,0,0,0,0,0,0,0,0,0,0,0,0,0,68000,68000,0,0
057585,鴻海國票99購05  ,0,0,0,0,0,0,0,0,0,0,0,0,0,100000,100000,0,0
057609,友訊元富98購01  ,0,0,0,0,0,0,0,0,0,0,0,0,0,60000,60000,0,0
057639,國巨元大99購07  ,0,0,0,0,0,0,0,0,0,0,0,0,0,4000,4000,0,0
057650,力成元大98購04  ,0,0,0,0,0,0,0,0,0,0,0,0,0,5000,5000,0,0
05707P,中磊永豐96售01  ,0,0,0,0,0,0,0,0,0,0,0,0,0,10000,10000,0,0
057165,國巨元大99購05  ,0,0,0,0,0,0,0,0,0,0,0,0,0,35000,35000,0,0
057169,微星元大98購01  ,0,0,0,0,0,0,0,0,0,0,0,0,0,68000,68000,0,0
057276,全新元大99購03  ,0,0,0,0,0,0,0,0,0,0,0,0,0,45000,45000,0,0
057277,可成元大98購05  ,0,0,0,0,0,0,0,0,0,0,0,0,0,25000,25000,0,0
057245,福懋科台新98購01,0,0,0,0,0,0,0,0,0,0,0,0,0,4000,4000,0,0
05723P,華通永豐96售03  ,0,0,0,0,0,0,0,0,0,0,0,0,0,33000,33000,0,0
057222,鴻海國票99購04  ,0,0,0,0,0,0,0,0,0,0,0,0,0,69000,69000,0,0
057040,國巨元大98購12  ,0,0,0,0,0,0,0,0,0,0,0,0,0,111000,111000,0,0
057051,群創元大9B購03  ,0,0,0,0,0,0,0,0,0,0,0,0,0,4000,4000,0,0
056964,聯發科永豐98購03,0,0,0,0,0,0,0,0,0,0,0,0,0,68000,68000,0,0
056907,群創元大9C購04  ,0,0,0,0,0,0,0,0,0,0,0,0,0,13000,13000,0,0
056900,可成元大98購02  ,0,0,0,0,0,0,0,0,0,0,0,0,0,25000,25000,0,0
056763,國巨元大99購02  ,0,0,0,0,0,0,0,0,0,0,0,0,0,139000,139000,0,0
056796,國巨麥證98購02  ,0,0,0,30000,30000,0,0,0,0,0,0,0,0,30000,30000,0,0
056817,國巨永豐98購04  ,0,0,0,0,0,0,0,0,0,0,0,0,0,2000,2000,0,0
056792,訊芯群益98購01  ,0,0,0,0,0,0,0,0,0,0,0,0,0,41000,41000,0,0
056482,貿聯元大99購01  ,0,0,0,0,0,0,0,0,0,0,0,0,0,10000,10000,0,0
056458,日月光凱基98購02,0,0,0,0,0,0,0,0,0,0,0,0,0,18000,18000,0,0
05645P,聯發科凱基96售13,0,0,0,0,0,0,0,0,0,0,0,0,0,20000,20000,0,0
056701,國產國泰9A購01  ,0,0,0,0,0,0,0,0,0,0,0,0,0,102000,102000,0,0
056668,光磊國票99購01  ,0,0,0,0,0,0,0,0,0,0,0,0,0,8000,8000,0,0
056678,力成元富98購01  ,0,0,0,0,0,0,0,0,0,0,0,0,0,30000,30000,0,0
056738,國巨凱基9A購02  ,0,0,0,0,0,0,0,0,0,0,0,0,0,11000,11000,0,0
056626,同欣電永豐98購01,0,0,0,0,0,0,0,0,0,0,0,0,0,71000,71000,0,0
056627,訊芯永豐98購01  ,0,0,0,0,0,0,0,0,0,0,0,0,0,68000,68000,0,0
056623,禾伸堂永豐98購01,0,0,0,0,0,0,0,0,0,0,0,0,0,8000,8000,0,0
056643,奇力新凱基99購01,0,0,0,0,0,0,0,0,0,0,0,0,0,20000,20000,0,0
056610,鴻海永豐98購01  ,0,0,0,0,0,0,0,0,0,0,0,0,0,68000,68000,0,0
05786P,臺股指永昌96售03,0,0,0,0,0,0,0,0,0,0,0,0,0,300000,300000,0,0
057933,聯發科群益98購06,0,0,0,0,0,0,0,0,0,0,0,0,0,20000,20000,0,0
057976,旺宏永豐98購03  ,0,0,0,0,0,0,0,0,0,0,0,0,0,68000,68000,0,0
057955,技嘉元大98購07  ,0,0,0,0,0,0,0,0,0,0,0,0,0,7000,7000,0,0
057755,鴻海日盛98購01  ,0,0,0,0,0,0,0,0,0,0,0,0,0,15000,15000,0,0
057795,鴻海兆豐99購02  ,0,0,0,0,0,0,0,0,0,0,0,0,0,5000,5000,0,0
057779,禾伸堂群益98購02,0,0,0,0,0,0,0,0,0,0,0,0,0,6000,6000,0,0
057677,臺股指元大98購07,0,0,0,0,0,0,0,0,0,0,0,0,0,20000,20000,0,0
057671,群創元大9B購06  ,0,0,0,0,0,0,0,0,0,0,0,0,0,34000,34000,0,0
057665,技嘉元大99購01  ,0,0,0,0,0,0,0,0,0,0,0,0,0,25000,25000,0,0
057974,上銀永豐98購02  ,0,0,0,0,0,0,0,0,0,0,0,0,0,68000,68000,0,0
058042,鴻海元大98購12  ,0,0,0,0,0,0,0,0,0,0,0,0,0,61000,61000,0,0
058024,台積電國泰9A購01,0,0,0,0,0,0,0,0,0,0,0,0,0,100000,100000,0,0
058048,群創元大9B購07  ,0,0,0,0,0,0,0,0,0,0,0,0,0,29000,29000,0,0
058086,鴻海元大98購14  ,0,0,0,0,0,0,0,0,0,0,0,0,0,52000,52000,0,0
058068,旺宏凱基98購11  ,0,0,0,0,0,0,0,0,0,0,0,0,0,7000,7000,0,0
058129,國巨元大99購10  ,0,0,0,0,0,0,0,0,0,0,0,0,0,20000,20000,0,0
058124,玉晶光國票9A購01,0,0,0,0,0,0,0,0,0,0,0,0,0,1000,1000,0,0
058098,T50反1國泰9A購02,0,0,0,0,0,0,0,0,0,0,0,0,0,10000,10000,0,0
058167,鴻海凱基9A購03  ,0,0,0,0,0,0,0,0,0,0,0,0,0,35000,35000,0,0
058201,華通凱基9A購01  ,0,0,0,0,0,0,0,0,0,0,0,0,0,8000,8000,0,0
058240,景碩元大99購04  ,0,0,0,0,0,0,0,0,0,0,0,0,0,10000,10000,0,0
058234,華新科元大99購12,0,0,0,0,0,0,0,0,0,0,0,0,0,20000,20000,0,0
058700,鴻海元大99購15  ,0,0,0,0,0,0,0,0,0,0,0,0,0,28000,28000,0,0
058701,鴻海元大99購16  ,0,0,0,0,0,0,0,0,0,0,0,0,0,12000,12000,0,0
058694,鈺齊國票9A購02  ,0,0,0,0,0,0,0,0,0,0,0,0,0,200000,200000,0,0
058697,亞德客元大99購01,0,0,0,0,0,0,0,0,0,0,0,0,0,50000,50000,0,0
058707,泰鼎元大99購02  ,0,0,0,0,0,0,0,0,0,0,0,0,0,9000,9000,0,0
058730,玉晶光永豐9A購01,0,0,0,0,0,0,0,0,0,0,0,0,0,1000,1000,0,0
058731,貿聯永豐99購02  ,0,0,0,0,0,0,0,0,0,0,0,0,0,29000,29000,0,0
058653,光寶科中信9A購01,0,0,0,0,0,0,0,0,0,0,0,0,0,31000,31000,0,0
058654,鴻海中信03購01  ,0,0,0,0,0,0,0,0,0,0,0,0,0,12000,12000,0,0
058655,鴻海中信03購02  ,0,0,0,0,0,0,0,0,0,0,0,0,0,11000,11000,0,0
058673,華新科群益9A購02,0,0,0,0,0,0,0,0,0,0,0,0,0,20000,20000,0,0
058674,宏達電群益99購01,0,0,0,0,0,0,0,0,0,0,0,0,0,17000,17000,0,0
058675,康控群益9B購01  ,0,0,0,0,0,0,0,0,0,0,0,0,0,44000,44000,0,0
058677,矽格群益99購01  ,0,0,0,0,0,0,0,0,0,0,0,0,0,23000,23000,0,0
058679,可成日盛99購01  ,0,0,0,0,0,0,0,0,0,0,0,0,0,53000,53000,0,0
058682,聯發科凱基99購07,0,0,0,0,0,0,0,0,0,0,0,0,0,2000,2000,0,0
058670,鴻海群益9A購03  ,0,0,0,0,0,0,0,0,0,0,0,0,0,13000,13000,0,0
058687,聯茂凱基9A購01  ,0,0,0,0,0,0,0,0,0,0,0,0,0,1000,1000,0,0
05868P,台積電凱基96售17,0,0,0,0,0,0,0,0,0,0,0,0,0,39000,39000,0,0
058607,聯發科元大99購14,0,0,0,0,0,0,0,0,0,0,0,0,0,213000,213000,0,0
05985P,燿華統一96售03  ,0,0,0,0,0,0,0,0,0,0,0,0,0,20000,20000,0,0
05933P,鴻海凱基97售03  ,0,0,0,0,0,0,0,0,0,0,0,0,0,1000,1000,0,0
05936P,台積電凱基96售20,0,0,0,0,0,0,0,0,0,0,0,0,0,50000,50000,0,0
058374,玉晶光凱基9A購03,0,0,0,0,0,0,0,0,0,0,0,0,0,73000,73000,0,0
058358,技嘉凱基9A購01  ,0,0,0,0,0,0,0,0,0,0,0,0,0,45000,45000,0,0
058342,鴻海群益9A購01  ,0,0,0,0,0,0,0,0,0,0,0,0,0,97000,97000,0,0
058355,旺宏凱基99購04  ,0,0,0,0,0,0,0,0,0,0,0,0,0,7000,7000,0,0
058502,鴻海元大99購13  ,0,0,0,0,0,0,0,0,0,0,0,0,0,55000,55000,0,0
058503,鴻海元大99購14  ,0,0,0,0,0,0,0,0,0,0,0,0,0,48000,48000,0,0
058504,台積電元大99購07,0,0,0,0,0,0,0,0,0,0,0,0,0,189000,189000,0,0
058512,宏達電元大99購04,0,0,0,0,0,0,0,0,0,0,0,0,0,6000,6000,0,0
058487,晶技國票9A購01  ,0,0,0,0,0,0,0,0,0,0,0,0,0,20000,20000,0,0
058476,旺宏凱基9A購01  ,0,0,0,0,0,0,0,0,0,0,0,0,0,1000,1000,0,0
058481,玉晶光凱基9A購04,0,0,0,0,0,0,0,0,0,0,0,0,0,31000,31000,0,0
058582,禾伸堂群益99購02,0,0,0,0,0,0,0,0,0,0,0,0,0,10000,10000,0,0
058578,聯發科群益99購03,0,0,0,0,0,0,0,0,0,0,0,0,0,13000,13000,0,0
058565,鴻海凱基9A購07  ,0,0,0,0,0,0,0,0,0,0,0,0,0,25000,25000,0,0
058539,聯發科台新99購01,0,0,0,0,0,0,0,0,0,0,0,0,0,10000,10000,0,0
058558,鴻海日盛9A購02  ,0,0,0,0,0,0,0,0,0,0,0,0,0,55000,55000,0,0
04265P,滬深2X元富93售04,0,0,0,0,0,0,0,0,0,0,0,0,0,350000,350000,0,0
04267P,康控元富93售04  ,0,0,0,0,0,0,0,0,0,0,0,0,0,10000,10000,0,0
042692,台灣50凱基96購09,0,0,0,0,0,0,0,0,0,0,0,0,0,2000,2000,0,0
04078P,臺股指凱基93售14,0,0,0,0,0,0,0,0,0,0,0,0,0,330000,330000,0,0
042502,上銀凱基93購01  ,0,0,0,0,0,0,0,0,0,0,0,0,0,10000,10000,0,0
00636K,國泰中國A50+U   ,0,0,0,0,0,0,0,0,0,0,0,0,0,100,100,0,0
00625K,富邦上証+R      ,0,0,0,0,0,0,0,0,0,0,0,0,0,50000,50000,0,0
00657K,國泰日經225+U   ,0,0,0,0,0,0,0,0,0,0,0,0,0,100,100,0,0
00668K,國泰美國道瓊+U  ,0,0,0,0,0,0,0,0,0,0,0,0,0,100,100,0,0
00682U,元大美元指數    ,0,0,0,0,0,0,0,0,0,0,0,0,0,40000,40000,0,0
04071P,臺股指凱基93售07,0,0,0,0,0,0,0,0,0,0,0,0,0,100000,100000,0,0
04072P,臺股指凱基93售08,0,0,0,0,0,0,0,0,0,0,0,0,0,330000,330000,0,0
04025P,宏達電國泰94售01,0,0,0,0,0,0,0,0,0,0,0,0,0,47000,47000,0,0
00774B,新光中國政金綠債,0,0,0,0,0,0,0,0,0,0,0,0,0,2000,2000,0,0
04653P,臺股指凱基94售12,0,0,0,0,0,0,0,0,0,0,0,0,0,30000,30000,0,0
04648P,臺股指凱基94售07,0,0,0,0,0,0,0,0,0,0,10000,0,10000,0,10000,-10000,0
044201,群創國票95購01  ,0,0,0,0,0,0,0,0,0,0,0,0,0,369000,369000,0,0
04436P,聯發科中信96售02,0,0,0,0,0,0,0,0,0,0,0,0,0,30000,30000,0,0
044374,燿華兆豐93購01  ,0,0,0,0,0,0,0,0,0,0,0,0,0,10000,10000,0,0
044408,聯茂凱基93購02  ,0,0,0,0,0,0,0,0,0,0,0,0,0,40000,40000,0,0
04326P,泰鼎元大93售06  ,0,240000,-240000,0,0,0,0,0,0,240000,0,0,0,240000,0,240000,0
046877,燿華國泰94購01  ,0,0,0,0,0,0,0,0,0,0,0,0,0,40000,40000,0,0
046939,燿華元大96購01  ,0,0,0,0,0,0,0,0,0,0,0,0,0,68000,68000,0,0
04344P,台達電國泰94售01,0,0,0,0,0,0,0,0,0,0,0,0,0,22000,22000,0,0
045797,健策中信93購01  ,0,0,0,0,0,0,0,0,0,0,0,0,0,20000,20000,0,0
045907,鴻海中信94購02  ,0,0,0,0,0,0,0,0,0,0,0,0,0,420000,420000,0,0
046064,中工凱基94購01  ,0,0,0,0,0,0,0,0,0,0,0,0,0,12000,12000,0,0
04559P,華通凱基94售03  ,0,0,0,0,0,0,0,0,0,0,0,0,0,20000,20000,0,0
045537,華新群益94購01  ,0,0,0,0,0,0,0,0,0,0,0,0,0,30000,30000,0,0
04450P,京元電凱基94售01,0,0,0,0,0,0,0,0,0,0,0,0,0,26000,26000,0,0
044516,景碩凱基93購02  ,0,0,0,0,0,0,0,0,0,0,0,0,0,10000,10000,0,0
050057,國巨凱基94購05  ,0,0,0,0,0,0,0,0,0,0,0,0,0,35000,35000,0,0
049522,華通兆豐94購02  ,0,0,0,0,0,0,0,0,0,0,0,0,0,5000,5000,0,0
050044,聯詠兆豐94購02  ,0,0,0,0,0,0,0,0,0,0,0,0,0,94000,94000,0,0
049571,華固統一94購02  ,0,0,0,0,0,0,0,0,0,0,0,0,0,10000,10000,0,0
047213,新日興富邦97購01,0,0,0,0,0,0,0,0,0,0,0,0,0,62000,62000,0,0
047369,漢唐國票94購01  ,0,0,0,0,0,0,0,0,0,0,0,0,0,10000,10000,0,0
048251,T50反1統一93購06,0,0,0,0,0,0,0,0,0,0,0,0,0,1000,1000,0,0
048253,T50反1統一93購08,0,0,0,0,0,0,0,0,0,0,0,0,0,1000,1000,0,0
04820P,聯茂永豐94售02  ,0,0,0,0,0,0,0,0,0,0,0,0,0,10000,10000,0,0
048181,A50正2群益95購01,0,0,0,0,0,0,0,0,0,0,0,0,0,62000,62000,0,0
048190,道瓊反元大96購02,0,0,0,0,0,0,0,0,0,0,0,0,0,7000,7000,0,0
048150,矽力元富93購01  ,0,0,0,0,0,0,0,0,0,0,0,0,0,30000,30000,0,0
048033,大立光凱基93購28,0,0,0,0,0,0,0,0,0,0,0,0,0,50000,50000,0,0
04793P,台光電元大94售07,0,0,0,0,0,0,0,0,0,0,0,0,0,100000,100000,0,0
047882,超眾國泰94購01  ,0,0,0,0,0,0,0,0,0,0,0,0,0,15000,15000,0,0
047826,台泥元大93購01  ,0,0,0,0,0,0,0,0,0,0,0,0,0,100000,100000,0,0
04772P,欣興元大94售08  ,0,0,0,0,0,0,0,0,0,0,0,0,0,22000,22000,0,0
047734,欣興兆豐94購02  ,0,0,0,0,0,0,0,0,0,0,0,0,0,100000,100000,0,0
047835,華新科元大93購09,0,0,0,0,0,0,0,0,0,0,0,0,0,4000,4000,0,0
047801,臺股指兆豐93購01,0,0,0,0,0,0,0,0,0,0,0,0,0,9000,9000,0,0
047840,新日興元大93購03,0,0,0,0,0,0,0,0,0,0,0,0,0,3000,3000,0,0
048488,大立光富邦93購05,0,0,0,0,0,0,0,0,0,0,0,0,0,10000,10000,0,0
048533,景碩國票94購01  ,0,0,0,0,0,0,0,0,0,0,0,0,0,10000,10000,0,0
049442,滬深2X統一99購01,0,0,0,0,0,0,0,0,0,0,0,0,0,4000,4000,0,0
049511,奇力新凱基94購03,0,0,0,0,0,0,0,0,0,0,0,0,0,2000,2000,0,0
047642,宏達電元大93購08,0,0,0,0,0,0,0,0,0,0,0,0,0,10000,10000,0,0
047635,華新元大93購01  ,0,0,0,0,0,0,0,0,0,0,0,0,0,69000,69000,0,0
049409,滬深2X凱基96購04,0,0,0,0,0,0,0,0,0,0,0,0,0,100000,100000,0,0
049369,義隆元大95購01  ,0,0,0,0,0,0,0,0,0,0,0,0,0,10000,10000,0,0
049345,富邦金統一94購02,0,0,0,0,0,0,0,0,0,0,0,0,0,50000,50000,0,0
049353,茂林永豐94購03  ,0,0,0,0,0,0,0,0,0,0,0,0,0,10000,10000,0,0
048329,台積電永昌93購07,0,0,0,0,0,0,0,0,0,0,0,0,0,10000,10000,0,0
048349,美利達元大96購02,0,0,0,0,0,0,0,0,0,0,0,0,0,10000,10000,0,0
050022,鴻海元大94購11  ,0,0,0,0,0,0,0,0,0,0,0,0,0,2000,2000,0,0
049913,微星元大94購01  ,0,0,0,0,0,0,0,0,0,0,0,0,0,96000,96000,0,0
049917,華新科元大94購02,0,0,0,0,0,0,0,0,0,0,0,0,0,68000,68000,0,0
049846,台泥群益94購01  ,0,0,0,0,0,0,0,0,0,0,0,0,0,10000,10000,0,0
04988P,楠梓電元大94售01,0,0,0,0,0,0,0,0,0,0,0,0,0,25000,25000,0,0
04971P,矽力元富94售02  ,0,0,0,0,0,0,0,0,0,0,0,0,0,50000,50000,0,0
049697,群創元大98購01  ,0,0,0,0,0,0,0,0,0,0,0,0,0,4000,4000,0,0
049775,旺宏統一95購02  ,0,0,0,0,0,0,0,0,0,0,0,0,0,108000,108000,0,0
049796,國巨元大94購10  ,0,0,0,0,0,0,0,0,0,0,0,0,0,30000,30000,0,0
048685,T50反1第一94購01,0,0,0,0,0,0,0,0,0,0,0,0,0,100000,100000,0,0
04864P,欣興元大94售10  ,0,0,0,0,0,0,0,0,0,0,0,0,0,10000,10000,0,0
048582,國泰金富邦93購01,0,0,0,0,0,0,0,0,0,0,0,0,0,10000,10000,0,0
048611,宏達電凱基93購04,0,0,0,0,0,0,0,0,0,0,0,0,0,10000,10000,0,0
048636,鴻海元大94購05  ,0,0,0,0,0,0,0,0,0,0,0,0,0,24000,24000,0,0
049156,緯穎元大96購01  ,0,0,0,0,0,0,0,0,0,0,0,0,0,2000,2000,0,0
048908,慧洋富邦95購01  ,0,0,0,0,0,0,0,0,0,0,0,0,0,22000,22000,0,0
048974,日電貿元大94購01,0,0,0,0,0,0,0,0,0,0,0,0,0,100000,100000,0,0
048975,玉晶光元大94購03,0,0,0,0,0,0,0,0,0,0,0,0,0,2000,2000,0,0
048938,玉晶光永豐95購02,0,0,0,0,0,0,0,0,0,0,0,0,0,1000,1000,0,0
048957,玉晶光康和94購01,0,0,0,0,0,0,0,0,0,0,0,0,0,1000,1000,0,0
052893,聯電群益98購01  ,0,0,0,0,0,0,0,0,0,0,0,0,0,11000,11000,0,0
052555,漢唐國票97購01  ,0,0,0,0,0,0,0,0,0,0,0,0,0,11000,11000,0,0
052529,力成元大95購03  ,0,0,0,0,0,0,0,0,0,0,0,0,0,6000,6000,0,0
052811,玉晶光台新96購03,0,0,0,0,0,0,0,0,0,0,0,0,0,1000,1000,0,0
052686,華新科元大96購03,0,0,0,0,0,0,0,0,0,0,0,0,0,120000,120000,0,0
052688,新日興元大96購01,0,0,0,0,0,0,0,0,0,0,0,0,0,10000,10000,0,0
04919P,聯詠凱基94售05  ,0,0,0,0,0,0,0,0,0,0,0,0,0,30000,30000,0,0
050330,南電永豐94購01  ,0,0,0,0,0,0,0,0,0,0,0,0,0,55000,55000,0,0
050333,鴻海國泰96購06  ,0,0,0,0,0,0,0,0,0,0,0,0,0,27000,27000,0,0
051348,國巨元大95購07  ,0,0,0,0,0,0,0,0,0,0,0,0,0,3000,3000,0,0
051346,仁寶元大95購01  ,0,0,0,0,0,0,0,0,0,0,0,0,0,68000,68000,0,0
05134P,鴻海凱基96售06  ,0,0,0,0,0,0,0,0,0,0,0,0,0,100000,100000,0,0
05127P,鴻海亞東96售01  ,0,0,0,0,0,0,0,0,0,0,0,0,0,100000,100000,0,0
05128P,聯發科中信97售03,0,0,0,0,0,0,0,0,0,0,0,0,0,10000,10000,0,0
05135P,鴻海凱基96售07  ,0,0,0,0,0,0,0,0,0,0,0,0,0,1000,1000,0,0
051404,牧德永豐96購01  ,0,0,0,0,0,0,0,0,0,0,0,0,0,37000,37000,0,0
05219P,鴻海元大95售17  ,0,0,0,0,0,0,0,0,0,0,0,0,0,134000,134000,0,0
051760,奇力新元大95購04,0,0,0,0,0,0,0,0,0,0,0,0,0,25000,25000,0,0
051742,欣興國票96購01  ,0,0,0,0,0,0,0,0,0,0,0,0,0,40000,40000,0,0
05177P,台積電凱基95售12,0,0,0,0,0,0,0,0,0,0,0,0,0,1000,1000,0,0
05160P,國巨國票96售03  ,0,0,0,0,0,0,0,0,0,0,0,0,0,50000,50000,0,0
051588,聯詠元大95購03  ,0,0,0,0,0,0,0,0,0,0,0,0,0,68000,68000,0,0
051684,瑞昱凱基95購02  ,0,0,0,0,0,0,0,0,0,0,0,0,0,26000,26000,0,0
051519,國泰金凱基95購02,10000,0,10000,0,0,0,0,0,0,-10000,0,0,0,14000,24000,-10000,0
051514,智邦凱基95購05  ,0,0,0,0,0,0,0,0,0,0,0,0,0,499000,499000,0,0
051542,南茂國票96購01  ,0,55000,-55000,0,0,0,0,0,0,55000,0,0,0,55000,0,55000,0
051572,上銀元大95購01  ,0,0,0,0,0,0,0,0,0,0,0,0,0,3000,3000,0,0
053529,國巨麥證96購01  ,0,0,0,0,20000,-20000,0,0,0,0,0,0,0,20000,20000,0,0
05356P,臺股指元富95售10,0,0,0,0,0,0,0,0,0,0,0,0,0,10000,10000,0,0
053562,玉晶光國泰98購02,0,0,0,0,0,0,0,0,0,0,0,0,0,264000,264000,0,0
053713,漢唐凱基96購04  ,0,0,0,0,0,0,0,0,0,0,0,0,0,30000,30000,0,0
053741,漢唐國票97購03  ,0,0,0,0,0,0,0,0,0,0,0,0,0,38000,38000,0,0
053676,新光金國泰98購02,0,0,0,0,0,0,0,0,0,0,0,0,0,76000,76000,0,0
053692,聯詠元大96購04  ,0,0,0,0,0,0,0,0,0,0,0,0,0,68000,68000,0,0
053449,超眾凱基98購01  ,0,0,0,0,0,0,0,0,0,0,0,0,0,5000,5000,0,0
053483,嘉澤第一96購01  ,0,0,0,0,0,0,0,0,0,0,0,0,0,10000,10000,0,0
05335P,臺股指國票95售04,0,0,0,0,0,0,0,0,0,0,0,0,0,3000,3000,0,0
053386,聯詠元大96購03  ,0,0,0,0,0,0,0,0,0,0,0,0,0,68000,68000,0,0
053374,台達電元大96購03,0,0,0,0,0,0,0,0,0,0,0,0,0,68000,68000,0,0
052312,美律富邦96購02  ,0,0,0,0,0,0,0,0,0,0,0,0,0,10000,10000,0,0
052368,力成國票96購01  ,0,0,0,0,0,0,0,0,0,0,0,0,0,150000,150000,0,0
052352,力成元富95購01  ,0,0,0,0,0,0,0,0,0,0,0,0,0,30000,30000,0,0
052326,滬深反中信99購01,0,0,0,0,0,0,0,0,0,0,0,0,0,150000,150000,0,0
052374,瑞昱元大95購02  ,0,0,0,0,0,0,0,0,0,0,0,0,0,4000,4000,0,0
053593,晶技元大98購01  ,0,0,0,0,0,0,0,0,0,0,0,0,0,20000,20000,0,0
052440,上証2X元大95購02,0,0,0,0,0,0,0,0,0,0,0,0,0,499000,499000,0,0
053643,漢唐國票97購02  ,0,0,0,0,0,0,0,0,0,0,0,0,0,16000,16000,0,0
053304,可成凱基96購03  ,0,0,0,0,0,0,0,0,0,0,0,0,0,68000,68000,0,0
053318,全新群益99購01  ,0,0,0,0,0,0,0,0,0,0,0,0,0,111000,111000,0,0
052998,拓凱康和96購01  ,0,0,0,0,0,0,0,0,0,0,0,0,0,5000,5000,0,0
051932,康控國票96購02  ,0,0,0,0,0,0,0,0,0,0,0,0,0,100000,100000,0,0
051939,同欣電群益97購01,0,0,0,0,0,0,0,0,0,0,0,0,0,113000,113000,0,0
051057,信邦群益95購01  ,0,0,0,0,0,0,0,0,0,0,0,0,0,10000,10000,0,0
051032,南電元富95購01  ,0,0,0,0,0,0,0,0,0,0,0,0,0,1000,1000,0,0
051040,漢唐永豐95購01  ,0,0,0,0,0,0,0,0,0,0,0,0,0,68000,68000,0,0
053077,同欣電永豐96購01,0,0,0,0,0,0,0,0,0,0,0,0,0,68000,68000,0,0
053089,貿聯元大97購02  ,0,0,0,0,0,0,0,0,0,0,0,0,0,2000,2000,0,0
053116,華新科中信96購01,0,0,0,0,0,0,0,0,0,0,0,0,0,80000,80000,0,0
053012,國巨統一96購03  ,0,0,0,0,0,0,0,0,0,0,0,0,0,260000,260000,0,0
053134,南亞科國票97購01,0,0,0,0,0,0,0,0,0,0,0,0,0,4000,4000,0,0
053171,中磊群益96購01  ,0,0,0,0,0,0,0,0,0,0,0,0,0,10000,10000,0,0
053188,旺宏統一97購03  ,0,0,0,0,0,0,0,0,0,0,0,0,0,28000,28000,0,0
050971,緯穎永豐95購01  ,0,0,0,0,0,0,0,0,0,0,0,0,0,211000,211000,0,0
050911,光磊中信98購01  ,0,0,0,0,0,0,0,0,0,0,0,0,0,20000,20000,0,0
052611,力成元大96購02  ,0,0,0,0,0,0,0,0,0,0,0,0,0,7000,7000,0,0
052612,康舒元大97購01  ,0,0,0,0,0,0,0,0,0,0,0,0,0,68000,68000,0,0
052614,聯電國泰97購01  ,0,0,0,0,0,0,0,0,0,0,0,0,0,102000,102000,0,0
053042,大立光凱基97購03,0,0,0,0,0,0,0,0,0,0,0,0,0,30000,30000,0,0
050198,緯穎元大94購09  ,0,0,0,0,0,0,0,0,0,0,0,0,0,2000,2000,0,0
051878,鴻海台新96購01  ,0,0,0,0,0,0,0,0,0,0,0,0,0,50000,50000,0,0
051820,道瓊反元富95購01,0,0,0,0,0,0,0,0,0,0,0,0,0,13000,13000,0,0
051081,聯茂富邦96購01  ,0,0,0,0,0,0,0,0,0,0,0,0,0,4000,4000,0,0
051092,禾伸堂元大95購02,0,0,0,0,0,0,0,0,0,0,0,0,0,12000,12000,0,0
051093,聯詠元大95購01  ,0,0,0,0,0,0,0,0,0,0,0,0,0,68000,68000,0,0
053258,上証2X群益9A購03,0,0,0,0,0,0,0,0,0,0,0,0,0,285000,285000,0,0
053059,聯發科永昌99購01,0,0,0,0,0,0,0,0,0,0,0,0,0,15000,15000,0,0
053277,大立光元大96購04,0,0,0,0,0,0,0,0,0,0,0,0,0,70000,70000,0,0
050494,可成永昌96購01  ,0,0,0,0,0,0,0,0,0,0,0,0,0,33000,33000,0,0
050726,可成國票96購01  ,0,0,0,0,0,0,0,0,0,0,0,0,0,20000,20000,0,0
050753,百和統一94購01  ,0,0,0,0,0,0,0,0,0,0,0,0,0,6000,6000,0,0
050905,臺股指元大95購12,0,0,0,0,0,0,0,0,0,0,0,0,0,2000,2000,0,0
050811,國巨凱基95購02  ,0,0,0,0,0,0,0,0,0,0,0,0,0,19000,19000,0,0
05084P,嘉聯益永豐95售02,0,0,0,0,0,0,0,0,0,0,0,0,0,39000,39000,0,0
05121P,創意國泰96售01  ,0,0,0,0,0,0,0,0,0,0,0,0,0,40000,40000,0,0
051233,力成群益97購01  ,0,0,0,0,0,0,0,0,0,0,0,0,0,44000,44000,0,0
051243,微星元大95購01  ,0,0,0,0,0,0,0,0,0,0,0,0,0,68000,68000,0,0
051245,南亞科元大95購01,0,0,0,0,0,0,0,0,0,0,0,0,0,19000,19000,0,0
05147P,鴻海元大95售11  ,0,0,0,0,0,0,0,0,0,0,0,0,0,40000,40000,0,0
051439,川湖元大95購01  ,0,0,0,0,0,0,0,0,0,0,0,0,0,1000,1000,0,0
055837,致茂元大97購02  ,0,0,0,0,0,0,0,0,0,0,0,0,0,68000,68000,0,0
055915,大立光凱基98購07,0,0,0,0,0,0,0,0,0,0,0,0,0,1000,1000,0,0
055916,奇鋐凱基99購01  ,0,0,0,0,0,0,0,0,0,0,0,0,0,5000,5000,0,0
055912,宏達電凱基98購03,0,0,0,0,0,0,0,0,0,0,0,0,0,10000,10000,0,0
056021,興富發群益97購01,0,0,0,0,0,0,0,0,0,0,0,0,0,10000,10000,0,0
056018,旺宏群益97購02  ,0,0,0,0,0,0,0,0,0,0,0,0,0,22000,22000,0,0
056068,欣興元大97購05  ,0,0,0,0,0,0,0,0,0,0,0,0,0,93000,93000,0,0
056032,勤誠康和97購03  ,0,0,0,0,0,0,0,0,0,0,0,0,0,20000,20000,0,0
056035,鴻海凱基97購06  ,0,0,0,0,0,0,0,0,0,0,0,0,0,32000,32000,0,0
056100,楠梓電永豐97購02,0,0,0,0,0,0,0,0,0,0,0,0,0,10000,10000,0,0
056351,鴻海元大98購06  ,0,0,0,0,0,0,0,0,0,0,0,0,0,80000,80000,0,0
056352,鴻海元大99購01  ,0,0,0,0,0,0,0,0,0,0,0,0,0,91000,91000,0,0
056314,力成元大97購01  ,0,0,0,0,0,0,0,0,0,0,0,0,0,6000,6000,0,0
056285,可成永豐97購02  ,0,0,0,0,0,0,0,0,0,0,0,0,0,10000,10000,0,0
056307,貿聯元大97購05  ,0,0,0,0,0,0,0,0,0,0,0,0,0,68000,68000,0,0
05623P,台積電中信96售03,0,0,0,0,0,0,0,0,0,0,0,0,0,60000,60000,0,0
056219,T50反1日盛02購01,0,0,0,0,0,0,0,0,0,0,0,0,0,1030000,1030000,0,0
055697,牧德國票98購01  ,0,0,0,0,0,0,0,0,0,0,0,0,0,11000,11000,0,0
05568P,台積電統一96售03,0,0,0,0,0,0,0,0,0,0,0,0,0,10000,10000,0,0
055677,喬山凱基97購01  ,0,0,0,0,0,0,0,0,0,0,0,0,0,1000,1000,0,0
055757,大成鋼群益99購01,0,0,0,0,0,0,0,0,0,0,0,0,0,30000,30000,0,0
055776,宏達電凱基98購02,0,0,0,0,0,0,0,0,0,0,0,0,0,19000,19000,0,0
05578P,鴻海凱基96售11  ,0,0,0,0,0,0,0,0,0,0,0,0,0,105000,105000,0,0
055713,國巨元大98購09  ,0,0,0,0,0,0,0,0,0,0,0,0,0,10000,10000,0,0
055723,康控元大97購04  ,0,0,0,0,0,0,0,0,0,0,0,0,0,68000,68000,0,0
055542,亞德客凱基97購01,0,0,0,0,0,0,0,0,0,0,0,0,0,50000,50000,0,0
055511,大立光兆豐97購02,0,0,0,0,0,0,0,0,0,0,0,0,0,10000,10000,0,0
055604,訊芯元大98購02  ,0,0,0,0,0,0,0,0,0,0,0,0,0,68000,68000,0,0
05525P,奇力新群益96售02,0,0,0,0,0,0,0,0,0,0,0,0,0,1000,1000,0,0
055236,建準台新98購01  ,0,0,0,0,0,0,0,0,0,0,0,0,0,38000,38000,0,0
055172,凱美統一97購02  ,0,0,0,0,0,0,0,0,0,0,0,0,0,10000,10000,0,0
055353,華新科凱基98購03,0,0,0,0,0,0,0,0,0,0,0,0,0,25000,25000,0,0
055372,宏達電元大97購04,0,0,0,0,0,0,0,0,0,0,0,0,0,180000,180000,0,0
055427,技嘉群益98購01  ,0,0,0,0,0,0,0,0,0,0,0,0,0,88000,88000,0,0
055430,宏達電群益97購01,0,0,0,0,0,0,0,0,0,0,0,0,0,50000,50000,0,0
055433,嘉聯益群益99購01,0,0,0,0,0,0,0,0,0,0,0,0,0,6000,6000,0,0
05541P,鴻海統一96售08  ,0,0,0,0,0,0,0,0,0,0,0,0,0,52000,52000,0,0
054878,和大統一97購02  ,0,0,0,0,0,0,0,0,0,0,0,0,0,48000,48000,0,0
05492P,聯茂元大95售02  ,0,0,0,0,0,0,0,0,0,0,0,0,0,435000,435000,0,0
054957,興富發元大97購01,0,0,0,0,0,0,0,0,0,0,0,0,0,50000,50000,0,0
054964,智易元大99購01  ,0,0,0,0,0,0,0,0,0,0,0,0,0,68000,68000,0,0
055038,華航富邦99購01  ,0,0,0,0,0,0,0,0,0,0,0,0,0,40000,40000,0,0
055049,智邦永豐97購01  ,0,0,0,0,0,0,0,0,0,0,0,0,0,68000,68000,0,0
055060,聯陽永豐97購01  ,0,0,0,0,0,0,0,0,0,0,0,0,0,180000,180000,0,0
055084,國巨第一97購01  ,0,0,0,0,0,0,0,0,0,0,0,0,0,10000,10000,0,0
055094,智易群益98購01  ,0,0,0,0,0,0,0,0,0,0,0,0,0,300000,300000,0,0
055115,日月光凱基98購01,0,0,0,0,0,0,0,0,0,0,0,0,0,10000,10000,0,0
055167,友訊統一97購01  ,0,0,0,0,0,0,0,0,0,0,0,0,0,73000,73000,0,0
054662,同欣電元大97購02,0,0,0,0,0,0,0,0,0,0,0,0,0,68000,68000,0,0
054684,裕隆永豐97購01  ,0,0,0,0,0,0,0,0,0,0,0,0,0,260000,260000,0,0
054678,麗豐台新98購02  ,0,0,0,0,0,0,0,0,0,0,0,0,0,25000,25000,0,0
054825,康友元大97購01  ,0,0,0,0,0,0,0,0,0,0,0,0,0,11000,11000,0,0
054535,旺宏富邦97購02  ,0,0,0,0,0,0,0,0,0,0,0,0,0,18000,18000,0,0
054589,聯鈞國泰99購01  ,0,0,0,0,0,0,0,0,0,0,0,0,0,35000,35000,0,0
05457P,鴻海凱基95售20  ,0,0,0,0,0,0,0,0,0,0,0,0,0,64000,64000,0,0
054642,訊芯中信9A購01  ,0,0,0,0,0,0,0,0,0,0,0,0,0,60000,60000,0,0
054648,智原群益98購01  ,0,0,0,0,0,0,0,0,0,0,0,0,0,50000,50000,0,0
054658,道瓊銀元大9A購01,0,0,0,0,0,0,0,0,0,0,0,0,0,75000,75000,0,0
053820,大立光群益96購05,0,0,0,0,0,0,0,0,0,0,0,0,0,100000,100000,0,0
053814,美律群益97購02  ,0,0,0,0,0,0,0,0,0,0,0,0,0,15000,15000,0,0
053818,富邦金群益98購01,0,0,0,0,0,0,0,0,0,0,0,0,0,40000,40000,0,0
05379P,可成凱基95售11  ,0,0,0,0,0,0,0,0,0,0,0,0,0,21000,21000,0,0
053775,鴻海元大96購21  ,0,0,0,0,0,0,0,0,0,0,0,0,0,1000,1000,0,0
053913,華新國票97購01  ,0,0,0,0,0,0,0,0,0,0,0,0,0,10000,10000,0,0
053870,正文元大96購01  ,0,0,0,0,0,0,0,0,0,0,0,0,0,68000,68000,0,0
053883,大立光中信98購02,0,0,0,0,0,0,0,0,0,0,0,0,0,100000,100000,0,0
05387P,鴻海元大95售21  ,0,0,0,0,0,0,0,0,0,0,0,0,0,30000,30000,0,0
054093,智原群益97購01  ,0,0,0,0,0,0,0,0,0,0,0,0,0,100000,100000,0,0
054081,聯電元富96購01  ,0,0,0,0,0,0,0,0,0,0,0,0,0,42000,42000,0,0
054078,鴻海中信98購01  ,0,0,0,0,0,0,0,0,0,0,0,0,0,2000,2000,0,0
054041,鴻海元大96購22  ,0,0,0,0,0,0,0,0,0,0,0,0,0,68000,68000,0,0
054014,宏達電永豐96購04,0,0,0,0,0,0,0,0,0,0,0,0,0,300000,300000,0,0
054018,華新台新96購01  ,0,0,0,0,0,0,0,0,0,0,0,0,0,38000,38000,0,0
053944,亞泥富邦97購01  ,0,0,0,0,0,0,0,0,0,0,0,0,0,10000,10000,0,0
054335,緯穎永豐96購02  ,0,0,0,0,0,0,0,0,0,0,0,0,0,115000,115000,0,0
05436P,台積電群益95售07,0,0,0,0,0,0,0,0,0,0,0,0,0,60000,60000,0,0
054250,漢唐元大96購04  ,0,0,0,0,0,0,0,0,0,0,0,0,0,68000,68000,0,0
054276,國巨群益96購07  ,0,0,0,0,0,0,0,0,0,0,0,0,0,100000,100000,0,0
054147,GIS元大96購02   ,0,0,0,0,0,0,0,0,0,0,0,0,0,2000,2000,0,0
8222,寶一            ,7000,7000,0,0,0,0,0,0,0,0,0,0,0,0,0,0,0
4764,雙鍵            ,9000,9000,0,0,0,0,0,0,0,0,0,0,0,0,0,0,0
2901,欣欣            ,1000,1000,0,0,0,0,0,0,0,0,0,0,0,0,0,0,0
3308,聯德            ,1000,1000,0,0,0,0,0,0,0,0,0,0,0,0,0,0,0
06082P,華通統一98售01  ,0,1000,-1000,0,0,0,0,0,0,1000,0,0,0,1000,0,1000,0
06188P,大立光元富97售01,0,0,0,0,0,0,0,0,0,0,0,0,0,10000,10000,0,0
06218P,鴻海元富97售06  ,0,0,0,0,0,0,0,0,0,0,0,0,0,10000,10000,0,0
06176P,台積電元大97售22,0,0,0,0,0,0,0,0,0,0,0,0,0,19000,19000,0,0
06184P,大立光元大97售06,0,0,0,0,0,0,0,0,0,0,0,0,0,275000,275000,0,0
06356P,啟碁永豐97售01  ,0,1000,-1000,0,0,0,0,0,0,1000,0,0,0,21000,20000,1000,0
06366P,鴻海凱基97售10  ,0,0,0,0,0,0,0,0,0,0,0,0,0,99000,99000,0,0
06304P,臺股指元大97售10,0,0,0,0,0,0,0,0,0,0,0,0,0,2000,2000,0,0
06284P,台積電國票98售03,0,0,0,0,0,0,0,0,0,0,0,0,0,5000,5000,0,0
06777P,鴻海元大99售06  ,0,0,0,0,0,0,0,0,0,0,0,0,0,15000,15000,0,0
06638P,鴻海統一99售02  ,0,0,0,0,0,0,0,0,0,0,0,0,0,1000,1000,0,0
06650P,聯發科元大98售09,0,0,0,0,0,0,0,0,0,0,0,0,0,11000,11000,0,0
06672P,聯發科群益98售05,0,0,0,0,0,0,0,0,0,0,0,0,0,11000,11000,0,0
06677P,牧德國票98售02  ,0,0,0,0,0,0,0,0,0,0,0,0,0,10000,10000,0,0
06484P,聯發科凱基98售11,0,0,0,0,0,0,0,0,0,0,0,0,0,11000,11000,0,0
06497P,大立光凱基98售11,0,0,0,0,0,0,0,0,0,0,0,0,0,13000,13000,0,0
06534P,聯發科群益98售04,0,0,0,0,0,0,0,0,0,0,0,0,0,11000,11000,0,0
1539,巨庭            ,2000,2000,0,0,0,0,0,0,0,0,0,0,0,0,0,0,0
06972P,聯發科元大99售04,0,0,0,0,0,0,0,0,0,0,0,0,0,11000,11000,0,0
06954P,大立光元富99售01,0,0,0,0,0,0,0,0,0,0,0,0,0,3000,3000,0,0
06960P,國巨凱基99售08  ,0,0,0,0,0,0,0,0,0,0,0,0,0,2000,2000,0,0
06985P,華新科富邦9C售02,0,0,0,0,0,0,0,0,0,0,0,0,0,20000,20000,0,0
07016P,聯發科元大99售10,0,0,0,0,0,0,0,0,0,0,0,0,0,11000,11000,0,0
08663P,台灣50元大96售01,0,0,0,0,0,0,0,0,0,0,0,0,0,30000,30000,0,0
07062P,台積電元大99售15,0,0,0,0,0,0,0,0,0,0,0,0,0,50000,50000,0,0
06899P,嘉澤群益98售01  ,0,0,0,0,0,0,0,0,0,0,0,0,0,40000,40000,0,0
06836P,玉晶光國票99售06,0,0,0,0,0,0,0,0,0,0,0,0,0,47000,47000,0,0
058448,滬深2X永豐9A購01,0,0,0,0,0,0,0,0,0,-1000,0,0,0,0,1000,-1000,-1000
058492,華通群益9B購01  ,0,0,0,0,0,0,0,0,0,-1000,0,0,0,16000,17000,-1000,-1000
05842P,台積電元大96售15,0,0,0,0,0,0,0,0,0,-1000,0,0,0,518000,519000,-1000,-1000
05959P,聯發科國票98售01,0,0,0,0,0,0,0,0,0,-1000,0,0,0,0,1000,-1000,-1000
058606,聯發科元大99購13,0,0,0,0,0,0,0,0,0,-1000,0,0,0,194000,195000,-1000,-1000
058688,矽創凱基9A購01  ,0,0,0,0,0,0,0,0,0,-1000,0,0,0,0,1000,-1000,-1000
058252,臺股指元大9A購16,0,0,0,0,0,0,0,0,0,-1000,0,0,0,0,1000,-1000,-1000
058178,國巨國泰9A購02  ,0,0,0,0,0,0,0,0,0,-1000,0,0,0,0,1000,-1000,-1000
058162,上銀日盛9B購01  ,0,0,0,0,0,0,0,0,0,-1000,0,0,0,0,1000,-1000,-1000
058165,FBVIX凱基9C購01 ,0,0,0,0,0,0,0,0,0,-1000,0,0,0,14000,15000,-1000,-1000
058084,大立光群益98購04,0,0,0,0,0,0,0,0,0,-1000,0,0,0,1000,2000,-1000,-1000
057871,國巨元大99購09  ,0,0,0,0,0,0,0,0,0,-1000,0,0,0,0,1000,-1000,-1000
057880,金融類元大99購02,0,0,0,0,0,0,0,0,0,-1000,0,0,0,100000,101000,-1000,-1000
057850,上銀兆豐99購02  ,0,0,0,0,0,0,0,0,0,-1000,0,0,0,0,1000,-1000,-1000
056625,致伸永豐98購01  ,0,0,0,0,0,0,0,0,0,-1000,0,0,0,0,1000,-1000,-1000
05661P,聯發科統一96售06,0,0,0,0,0,0,0,0,0,-1000,0,0,0,5000,6000,-1000,-1000
056718,GIS永豐98購01   ,0,0,0,0,0,0,0,0,0,-1000,0,0,0,13000,14000,-1000,-1000
056711,亞光永豐98購01  ,0,0,0,0,0,0,0,0,0,-1000,0,0,0,0,1000,-1000,-1000
056682,鴻海統一98購10  ,0,0,0,0,0,0,0,0,0,-1000,0,0,0,0,1000,-1000,-1000
056664,上証反中信9B購01,0,0,0,0,0,0,0,0,0,-1000,0,0,0,0,1000,-1000,-1000
056891,國巨元大99購03  ,0,0,0,0,0,0,0,0,0,-1000,0,0,0,0,1000,-1000,-1000
057262,友達兆豐98購03  ,0,0,0,0,0,0,0,0,0,-1000,0,0,0,0,1000,-1000,-1000
057469,康友永豐98購02  ,0,0,0,0,0,0,0,0,0,-1000,0,0,0,20000,21000,-1000,-1000
049219,聯發科國票95購01,0,0,0,0,0,0,0,0,0,-1000,0,0,0,0,1000,-1000,-1000
048932,美食永豐94購01  ,0,0,0,0,0,0,0,0,0,-1000,0,0,0,0,1000,-1000,-1000
048664,華新科統一94購01,0,0,0,0,0,0,0,0,0,-1000,0,0,0,0,1000,-1000,-1000
048742,瀚宇博統一94購01,0,0,0,0,0,0,0,0,0,-1000,0,0,0,0,1000,-1000,-1000
048732,台勝科麥證95購01,0,0,0,0,1000,-1000,0,0,0,-1000,0,0,0,0,1000,-1000,-1000
049716,台積電凱基94購24,0,0,0,0,0,0,0,0,0,-1000,0,0,0,0,1000,-1000,-1000
049676,美食國票94購01  ,0,0,0,0,0,0,0,0,0,-1000,0,0,0,0,1000,-1000,-1000
048298,華通麥證94購01  ,0,0,0,50000,51000,-1000,0,0,0,-1000,0,0,0,50000,51000,-1000,-1000
048279,聯鈞永豐93購01  ,0,0,0,0,0,0,0,0,0,-1000,0,0,0,2000,3000,-1000,-1000
049361,華通元大94購02  ,0,0,0,0,0,0,0,0,0,-1000,0,0,0,43000,44000,-1000,-1000
049488,智邦元大95購01  ,0,0,0,0,0,0,0,0,0,-1000,0,0,0,68000,69000,-1000,-1000
049432,聯詠國票95購01  ,0,0,0,0,0,0,0,0,0,-1000,0,0,0,48000,49000,-1000,-1000
04767P,台積電國泰95售04,0,0,0,0,0,0,0,0,0,-1000,0,0,0,1000,2000,-1000,-1000
048108,鴻海群益93購07  ,0,0,0,0,0,0,0,0,0,-1000,0,0,0,0,1000,-1000,-1000
048221,鴻海凱基95購01  ,0,0,0,0,0,0,0,0,0,-1000,0,0,0,55000,56000,-1000,-1000
049554,禾伸堂富邦96購01,0,0,0,0,0,0,0,0,0,-1000,0,0,0,0,1000,-1000,-1000
049254,台積電元大96購02,0,0,0,0,0,0,0,0,0,-1000,0,0,0,11000,12000,-1000,-1000
049274,臺股指元大94購09,0,0,0,0,0,0,0,0,0,-1000,0,0,0,0,1000,-1000,-1000
049276,臺股指元大94購11,0,0,0,0,0,0,0,0,0,-1000,0,0,0,0,1000,-1000,-1000
04499P,滬深2X統一94售03,0,0,0,0,0,0,0,0,0,-1000,0,0,0,22000,23000,-1000,-1000
04554P,可成中信94售01  ,0,0,0,0,0,0,0,0,0,-1000,0,0,0,5000,6000,-1000,-1000
047109,華邦電元大94購01,0,0,0,0,0,0,0,0,0,-1000,0,0,0,150000,151000,-1000,-1000
045992,鴻海富邦94購01  ,0,0,0,0,0,0,0,0,0,-1000,0,0,0,0,1000,-1000,-1000
043642,元金2X國票97購01,0,0,0,0,0,0,0,0,0,-1000,0,0,0,0,1000,-1000,-1000
046268,嘉晶凱基93購02  ,0,0,0,0,0,0,0,0,0,-1000,0,0,0,0,1000,-1000,-1000
03039X,元展36          ,0,0,0,0,0,0,0,0,0,-1000,0,0,0,0,1000,-1000,-1000
03078X,元展73          ,0,0,0,0,0,0,0,0,0,-1000,0,0,0,0,1000,-1000,-1000
046662,大立光元大93購14,0,0,0,0,0,0,0,0,0,-1000,0,0,0,0,1000,-1000,-1000
020011,統一微波高息20N ,0,0,0,0,0,0,0,0,0,-1000,0,0,0,0,1000,-1000,-1000
03010X,元展10          ,0,0,0,0,0,0,0,0,0,-1000,0,0,0,0,1000,-1000,-1000
020004,兆豐電菁英30N   ,0,0,0,0,0,0,0,0,0,-1000,0,0,0,0,1000,-1000,-1000
00666R,富邦恒生國企反1 ,0,0,0,0,0,0,0,0,0,-1000,0,0,0,7000,8000,-1000,-1000
00661,元大日經225     ,0,0,0,0,0,0,0,0,0,-1000,0,0,0,2000,3000,-1000,-1000
006204,永豐臺灣加權    ,0,0,0,0,0,0,0,0,0,-1000,0,0,0,1000,2000,-1000,-1000
03430B,臺股指元大9B熊01,0,0,0,0,0,0,0,0,0,-1000,0,0,0,79000,80000,-1000,-1000
03427B,臺股指元大9A熊02,0,0,0,0,0,0,0,0,0,-1000,0,0,0,0,1000,-1000,-1000
04142P,元油反凱基99售01,0,0,0,0,0,0,0,0,0,-1000,0,0,0,0,1000,-1000,-1000
042089,台灣50中信94購03,0,0,0,0,0,0,0,0,0,-1000,0,0,0,740000,741000,-1000,-1000
04225P,台積電元富94售02,0,0,0,0,0,0,0,0,0,-1000,0,0,0,0,1000,-1000,-1000
042281,元油2X富邦96購02,0,0,0,0,0,0,0,0,0,-1000,0,0,0,0,1000,-1000,-1000
042173,台灣50永豐93購01,0,0,0,0,0,0,0,0,0,-1000,0,0,0,0,1000,-1000,-1000
052955,國巨日盛96購01  ,0,0,0,0,0,0,0,0,0,-1000,0,0,0,0,1000,-1000,-1000
051167,京鼎元大95購01  ,0,0,0,0,0,0,0,0,0,-1000,0,0,0,0,1000,-1000,-1000
050903,臺股指元大95購10,0,0,0,0,0,0,0,0,0,-1000,0,0,0,0,1000,-1000,-1000
050570,聯發科中信97購02,0,0,0,0,0,0,0,0,0,-1000,0,0,0,0,1000,-1000,-1000
050666,道瓊銀永豐94購01,0,0,0,0,0,0,0,0,0,-1000,0,0,0,0,1000,-1000,-1000
050669,嘉晶永豐96購01  ,0,0,0,0,0,0,0,0,0,-1000,0,0,0,5000,6000,-1000,-1000
050280,國巨日盛94購01  ,0,0,0,0,0,0,0,0,0,-1000,0,0,0,218000,219000,-1000,-1000
050245,大立光凱基94購12,0,0,0,0,0,0,0,0,0,-1000,0,0,0,0,1000,-1000,-1000
050992,台積電元大97購01,0,0,0,0,0,0,0,0,0,-1000,0,0,0,86000,87000,-1000,-1000
050132,日電貿凱基94購02,0,0,0,0,0,0,0,0,0,-1000,0,0,0,0,1000,-1000,-1000
052642,滬深2X永豐96購03,0,0,0,0,0,0,0,0,0,-1000,0,0,0,30000,31000,-1000,-1000
052608,欣興元大97購01  ,0,0,0,0,0,0,0,0,0,-1000,0,0,0,10000,11000,-1000,-1000
050954,樺漢群益95購01  ,0,0,0,0,0,0,0,0,0,-1000,0,0,0,0,1000,-1000,-1000
053195,玉晶光元富96購02,0,0,0,0,0,0,0,0,0,-1000,0,0,0,0,1000,-1000,-1000
052989,麗豐元大98購01  ,0,0,0,0,0,0,0,0,0,-1000,0,0,0,0,1000,-1000,-1000
052974,瀚宇博群益96購01,0,0,0,0,0,0,0,0,0,-1000,0,0,0,1000,2000,-1000,-1000
053647,臺股指國票96購10,0,0,0,0,0,0,0,0,0,-1000,0,0,0,0,1000,-1000,-1000
05337P,臺股指國票95售06,0,0,0,0,0,0,0,0,0,-1000,0,0,0,0,1000,-1000,-1000
052426,國巨台新96購01  ,0,0,0,0,0,0,0,0,0,-1000,0,0,0,0,1000,-1000,-1000
053466,華通元大98購01  ,0,0,0,0,0,0,0,0,0,-1000,0,0,0,0,1000,-1000,-1000
053731,矽創凱基96購03  ,0,0,0,0,0,0,0,0,0,-1000,0,0,0,0,1000,-1000,-1000
053579,華通元大97購01  ,0,0,0,0,0,0,0,0,0,-1000,0,0,0,0,1000,-1000,-1000
051523,牧德凱基95購02  ,0,0,0,0,0,0,0,0,0,-1000,0,0,0,9000,10000,-1000,-1000
051631,國巨國票96購06  ,0,0,0,0,0,0,0,0,0,-1000,0,0,0,1000,2000,-1000,-1000
051385,矽創群益95購01  ,0,0,0,0,0,0,0,0,0,-1000,0,0,0,0,1000,-1000,-1000
054278,晶技群益97購02  ,0,0,0,0,0,0,0,0,0,-1000,0,0,0,26000,27000,-1000,-1000
053933,大立光統一96購06,0,0,0,0,0,0,0,0,0,-1000,0,0,0,0,1000,-1000,-1000
053988,友達亞東96購01  ,0,0,0,0,0,0,0,0,0,-1000,0,0,0,0,1000,-1000,-1000
054092,大立光群益97購01,0,0,0,0,0,0,0,0,0,-1000,0,0,0,0,1000,-1000,-1000
054111,緯穎凱基97購01  ,0,0,0,0,0,0,0,0,0,-1000,0,0,0,49000,50000,-1000,-1000
05382P,電子類群益95售02,0,0,0,0,0,0,0,0,0,-1000,0,0,0,15000,16000,-1000,-1000
054651,台化麥證97購01  ,0,0,0,0,1000,-1000,0,0,0,-1000,0,0,0,0,1000,-1000,-1000
054636,華通中信97購01  ,0,0,0,0,0,0,0,0,0,-1000,0,0,0,0,1000,-1000,-1000
054639,台新金中信99購01,0,0,0,0,0,0,0,0,0,-1000,0,0,0,48000,49000,-1000,-1000
054621,華新科兆豐98購01,0,0,0,0,0,0,0,0,0,-1000,0,0,0,60000,61000,-1000,-1000
054601,奇鋐台新98購01  ,0,0,0,0,0,0,0,0,0,-1000,0,0,0,0,1000,-1000,-1000
054547,鴻海凱基98購02  ,0,0,0,0,0,0,0,0,0,-1000,0,0,0,0,1000,-1000,-1000
054511,香港反元大98購01,0,0,0,0,0,0,0,0,0,-1000,0,0,0,0,1000,-1000,-1000
055169,光罩統一99購01  ,0,0,0,0,0,0,0,0,0,-1000,0,0,0,0,1000,-1000,-1000
054837,欣興第一97購01  ,10000,40000,-30000,0,0,0,0,0,0,29000,0,0,0,40000,11000,29000,-1000
055288,日電貿元大97購02,0,0,0,0,0,0,0,0,0,-1000,0,0,0,0,1000,-1000,-1000
055609,旺宏國票99購01  ,0,0,0,0,0,0,0,0,0,-1000,0,0,0,0,1000,-1000,-1000
055746,同欣電元富97購01,0,0,0,0,0,0,0,0,0,-1000,0,0,0,128000,129000,-1000,-1000
056225,聯發科凱基97購09,0,0,0,0,0,0,0,0,0,-1000,0,0,0,0,1000,-1000,-1000
056178,嘉澤元富97購02  ,0,0,0,0,0,0,0,0,0,-1000,0,0,0,9000,10000,-1000,-1000
056243,創意群益97購03  ,0,0,0,0,0,0,0,0,0,-1000,0,0,0,0,1000,-1000,-1000
056324,南亞科兆豐98購01,0,0,0,0,0,0,0,0,0,-1000,0,0,0,0,1000,-1000,-1000
056349,道瓊銀元大9B購01,0,0,0,0,0,0,0,0,0,-1000,0,0,0,0,1000,-1000,-1000
056417,欣興中信98購01  ,0,0,0,0,0,0,0,0,0,-1000,0,0,0,0,1000,-1000,-1000
056066,奇鋐元大98購02  ,0,0,0,0,0,0,0,0,0,-1000,0,0,0,222000,223000,-1000,-1000
055904,貿聯亞東99購01  ,0,0,0,0,0,0,0,0,0,-1000,0,0,0,0,1000,-1000,-1000
06863P,欣興凱基98售05  ,0,0,0,0,0,0,0,0,0,-1000,0,0,0,57000,58000,-1000,-1000
07050P,宏達電中信9B售01,0,0,0,0,0,0,0,0,0,-1000,0,0,0,0,1000,-1000,-1000
06989P,鴻海元富99售10  ,0,0,0,0,0,0,0,0,0,-1000,0,0,0,1000,2000,-1000,-1000
06977P,臺股指元大9A售15,0,0,0,0,0,0,0,0,0,-1000,0,0,0,0,1000,-1000,-1000
06975P,臺股指元大9A售13,0,0,0,0,0,0,0,0,0,-1000,0,0,0,0,1000,-1000,-1000
1568,倉佑            ,21000,22000,-1000,0,0,0,0,0,0,0,0,0,0,0,0,0,-1000
1587,吉茂            ,1000,2000,-1000,0,0,0,0,0,0,0,0,0,0,0,0,0,-1000
1470,大統新創        ,0,1000,-1000,0,0,0,0,0,0,0,0,0,0,0,0,0,-1000
1525,江申            ,0,1000,-1000,0,0,0,0,0,0,0,0,0,0,0,0,0,-1000
1451,年興            ,28000,30000,-2000,0,0,0,0,0,0,1000,1000,0,1000,0,0,0,-1000
1312A,國喬特          ,0,0,0,0,0,0,0,0,0,-1000,1000,2000,-1000,0,0,0,-1000
06663P,鴻海兆豐98售03  ,0,0,0,0,0,0,0,0,0,-1000,0,0,0,10000,11000,-1000,-1000
06619P,聯發科元大98售06,0,0,0,0,0,0,0,0,0,-1000,0,0,0,38000,39000,-1000,-1000
06352P,臺股指富邦99售02,0,0,0,0,0,0,0,0,0,-1000,0,0,0,0,1000,-1000,-1000
06122P,亞光元大98售01  ,0,0,0,0,0,0,0,0,0,-1000,0,0,0,1000,2000,-1000,-1000
06112P,台積電兆豐97售01,0,0,0,0,0,0,0,0,0,-1000,0,0,0,0,1000,-1000,-1000
2712,遠雄來          ,0,1000,-1000,0,0,0,0,0,0,0,0,0,0,0,0,0,-1000
4552,力達-KY         ,36000,37000,-1000,0,0,0,0,0,0,0,0,0,0,0,0,0,-1000
4562,穎漢            ,0,1000,-1000,0,0,0,0,0,0,0,0,0,0,0,0,0,-1000
6136,富爾特          ,14000,15000,-1000,0,0,0,0,0,0,0,0,0,0,0,0,0,-1000
8427,基勝-KY         ,0,1000,-1000,0,0,0,0,0,0,0,0,0,0,0,0,0,-1000
8488,吉源-KY         ,0,1000,-1000,0,0,0,0,0,0,0,0,0,0,0,0,0,-1000
8103,瀚荃            ,8000,12000,-4000,0,0,0,0,0,0,3000,4000,1000,3000,0,0,0,-1000
6464,台數科          ,1000,2000,-1000,0,0,0,0,0,0,0,0,0,0,0,0,0,-1000
057425,臺股指凱基9C購02,0,0,0,0,0,0,0,0,0,-2000,0,0,0,5000,7000,-2000,-2000
05756P,臺股指中信99售05,0,0,0,0,0,0,0,0,0,-2000,0,0,0,0,2000,-2000,-2000
056856,華通群益9A購01  ,0,0,0,0,0,0,0,0,0,-2000,0,0,0,36000,38000,-2000,-2000
05694P,台積電凱基96售09,0,0,0,0,0,0,0,0,0,-2000,0,0,0,17000,19000,-2000,-2000
056646,奇鋐凱基99購02  ,0,0,0,0,0,0,0,0,0,-2000,0,0,0,395000,397000,-2000,-2000
056512,易華電永豐98購01,0,0,0,0,0,0,0,0,0,-2000,0,0,0,0,2000,-2000,-2000
057930,旺宏群益99購04  ,0,0,0,0,0,0,0,0,0,-2000,0,0,0,72000,74000,-2000,-2000
057710,金融類群益98購01,0,0,0,0,0,0,0,0,0,-2000,0,0,0,0,2000,-2000,-2000
057791,可成統一99購01  ,0,0,0,0,0,0,0,0,0,-2000,0,0,0,10000,12000,-2000,-2000
058047,可成元大98購11  ,0,0,0,0,0,0,0,0,0,-2000,0,0,0,68000,70000,-2000,-2000
058032,大立光永豐98購05,0,0,0,0,0,0,0,0,0,-2000,0,0,0,1000,3000,-2000,-2000
058144,聯茂元大99購02  ,0,0,0,0,0,0,0,0,0,-2000,0,0,0,69000,71000,-2000,-2000
058185,國巨永豐99購01  ,0,0,0,0,0,0,0,0,0,-2000,0,0,0,0,2000,-2000,-2000
058644,元黃金富邦03購01,0,0,0,0,0,0,0,0,0,-2000,0,0,0,0,2000,-2000,-2000
058715,鴻海台新99購02  ,0,0,0,0,0,0,0,0,0,-2000,0,0,0,34000,36000,-2000,-2000
058698,華通元大99購05  ,0,0,0,0,0,0,0,0,0,-2000,0,0,0,0,2000,-2000,-2000
05896P,宏達電群益96售03,0,0,0,0,0,0,0,0,0,-2000,0,0,0,16000,18000,-2000,-2000
06006P,欣興永豐96售04  ,0,0,0,0,0,0,0,0,0,-2000,0,0,0,18000,20000,-2000,-2000
058369,亞光凱基99購02  ,0,0,0,0,0,0,0,0,0,-2000,0,0,0,1000,3000,-2000,-2000
058531,華通元富99購01  ,0,0,0,0,0,0,0,0,0,-2000,0,0,0,3000,5000,-2000,-2000
058568,宏達電凱基9A購02,0,0,0,0,0,0,0,0,0,-2000,0,0,0,9000,11000,-2000,-2000
04275P,南亞科凱基93售08,0,0,0,0,0,0,0,0,0,-2000,0,0,0,10000,12000,-2000,-2000
04276P,聯發科凱基93售33,0,0,0,0,0,0,0,0,0,-2000,0,0,0,6000,8000,-2000,-2000
00735,國泰臺韓科技    ,0,24000,-24000,0,0,0,0,0,0,22000,0,0,0,129000,107000,22000,-2000
04669P,臺股指國票94售08,0,0,0,0,0,0,0,0,0,-2000,0,0,0,0,2000,-2000,-2000
046465,GIS凱基95購01   ,0,0,0,0,0,0,0,0,0,-2000,0,0,0,0,2000,-2000,-2000
044468,台積電群益93購01,0,0,0,0,0,0,0,0,0,-2000,0,0,0,0,2000,-2000,-2000
03035X,元展32          ,0,0,0,0,0,0,0,0,0,-2000,0,0,0,0,2000,-2000,-2000
03038X,元展35          ,0,0,0,0,0,0,0,0,0,-2000,0,0,0,0,2000,-2000,-2000
046148,友達中信94購01  ,0,0,0,0,0,0,0,0,0,-2000,0,0,0,20000,22000,-2000,-2000
036084,台灣50台新98購01,0,0,0,0,0,0,0,0,0,-2000,0,0,0,0,2000,-2000,-2000
04687P,全新凱基94售02  ,0,0,0,0,0,0,0,0,0,-2000,0,0,0,100000,102000,-2000,-2000
04574P,台達電統一94售05,0,0,0,0,0,0,0,0,0,-2000,0,0,0,10000,12000,-2000,-2000
049252,國巨元大96購01  ,0,0,0,0,0,0,0,0,0,-2000,0,0,0,1000,3000,-2000,-2000
048263,台積電元富95購01,0,0,0,0,0,0,0,0,0,-2000,0,0,0,0,2000,-2000,-2000
04742P,瑞昱統一94售01  ,0,0,0,0,0,0,0,0,0,-2000,0,0,0,0,2000,-2000,-2000
049476,美食永豐94購02  ,0,0,0,0,0,0,0,0,0,-2000,0,0,0,0,2000,-2000,-2000
049388,南電元大94購05  ,0,0,0,0,0,0,0,0,0,-2000,0,0,0,53000,55000,-2000,-2000
049653,緯穎凱基94購03  ,0,0,0,0,0,0,0,0,0,-2000,0,0,0,34000,36000,-2000,-2000
048124,大立光元大95購03,0,0,0,0,0,0,0,0,0,-2000,0,0,0,0,2000,-2000,-2000
049000,元油2X中信95購02,0,0,0,0,0,0,0,0,0,-2000,0,0,0,0,2000,-2000,-2000
052814,上証2X永豐96購02,0,0,0,0,0,0,0,0,0,-2000,0,0,0,883000,885000,-2000,-2000
05252P,華通凱基95售01  ,0,0,0,0,0,0,0,0,0,-2000,0,0,0,73000,75000,-2000,-2000
052871,群創凱基98購07  ,0,0,0,0,0,0,0,0,0,-2000,0,0,0,0,2000,-2000,-2000
051408,台積電國票95購03,0,0,0,0,0,0,0,0,0,-2000,0,0,0,0,2000,-2000,-2000
050391,大立光統一94購07,0,0,0,0,0,0,0,0,0,-2000,0,0,0,20000,22000,-2000,-2000
051598,瑞昱兆豐95購01  ,0,0,0,0,0,0,0,0,0,-2000,0,0,0,8000,10000,-2000,-2000
051664,鴻海元大96購07  ,0,0,0,0,0,0,0,0,0,-2000,0,0,0,0,2000,-2000,-2000
051568,智邦富邦95購01  ,0,0,0,0,0,0,0,0,0,-2000,0,0,0,0,2000,-2000,-2000
051552,牧德永豐95購03  ,0,0,0,0,0,0,0,0,0,-2000,0,0,0,20000,22000,-2000,-2000
051761,富邦金元大96購01,0,0,0,0,0,0,0,0,0,-2000,0,0,0,68000,70000,-2000,-2000
052484,矽創群益95購02  ,0,0,0,0,0,0,0,0,0,-2000,0,0,0,0,2000,-2000,-2000
051980,樺漢凱基96購01  ,0,0,0,0,0,0,0,0,0,-2000,0,0,0,10000,12000,-2000,-2000
055820,矽力國票98購02  ,0,0,0,0,0,0,0,0,0,-2000,0,0,0,28000,30000,-2000,-2000
056082,旺宏統一99購02  ,0,0,0,0,0,0,0,0,0,-2000,0,0,0,5000,7000,-2000,-2000
056131,鴻海元大97購12  ,0,0,0,0,0,0,0,0,0,-2000,0,0,0,86000,88000,-2000,-2000
056419,欣興元富98購02  ,0,0,0,0,0,0,0,0,0,-2000,0,0,0,15000,17000,-2000,-2000
056343,高鐵凱基98購02  ,0,0,0,0,0,0,0,0,0,-2000,0,0,0,0,2000,-2000,-2000
05576P,群創日盛99售02  ,0,0,0,0,0,0,0,0,0,-2000,0,0,0,0,2000,-2000,-2000
055532,中工群益98購01  ,0,0,0,0,0,0,0,0,0,-2000,0,0,0,98000,100000,-2000,-2000
055458,燿華永豐98購01  ,0,0,0,0,0,0,0,0,0,-2000,0,0,0,3000,5000,-2000,-2000
054965,健策元大98購04  ,0,0,0,0,0,0,0,0,0,-2000,0,0,0,60000,62000,-2000,-2000
054777,昇陽半國票98購01,0,0,0,0,0,0,0,0,0,-2000,0,0,0,0,2000,-2000,-2000
6625,必應            ,0,2000,-2000,0,0,0,0,0,0,0,0,0,0,0,0,0,-2000
4763,材料-KY         ,47000,50000,-3000,0,0,0,0,0,0,1000,1000,0,1000,0,0,0,-2000
2722,夏都            ,0,2000,-2000,0,0,0,0,0,0,0,0,0,0,0,0,0,-2000
2496,卓越            ,3000,5000,-2000,0,0,0,0,0,0,0,0,0,0,0,0,0,-2000
3494,誠研            ,3000,5000,-2000,0,0,0,0,0,0,0,0,0,0,0,0,0,-2000
3028,增你強          ,142000,121000,21000,0,0,0,0,0,0,-23000,0,23000,-23000,0,0,0,-2000
911616,杜康-DR         ,1000,3000,-2000,0,0,0,0,0,0,0,0,0,0,0,0,0,-2000
06143P,鴻海永豐97售02  ,0,0,0,0,0,0,0,0,0,-2000,0,0,0,0,2000,-2000,-2000
06719P,台灣50群益9A售01,0,0,0,0,0,0,0,0,0,-2000,0,0,0,127000,129000,-2000,-2000
07032P,聯發科統一9C售02,0,0,0,0,0,0,0,0,0,-2000,0,0,0,0,2000,-2000,-2000
06886P,旺宏元大99售07  ,0,0,0,0,0,0,0,0,0,-2000,0,0,0,6000,8000,-2000,-2000
058573,鴻海群益9A購02  ,0,0,0,0,0,0,0,0,0,-3000,0,0,0,105000,108000,-3000,-3000
058526,鈺齊元大99購02  ,0,0,0,0,0,0,0,0,0,-3000,0,0,0,42000,45000,-3000,-3000
058474,鴻海凱基9A購06  ,0,0,0,0,0,0,0,0,0,-3000,0,0,0,30000,33000,-3000,-3000
05958P,聯發科國票97售04,0,0,0,0,0,0,0,0,0,-3000,0,0,0,0,3000,-3000,-3000
058733,同欣電永豐99購02,0,0,0,0,0,0,0,0,0,-3000,0,0,0,0,3000,-3000,-3000
058646,聯茂富邦9A購01  ,0,0,0,0,0,0,0,0,0,-3000,0,0,0,0,3000,-3000,-3000
058647,華新科永豐99購03,0,0,0,0,0,0,0,0,0,-3000,0,0,0,22000,25000,-3000,-3000
058040,FBVIX元大98購01 ,0,0,0,0,0,0,0,0,0,-3000,0,0,0,0,3000,-3000,-3000
057767,緯穎凱基98購06  ,0,0,0,0,0,0,0,0,0,-3000,0,0,0,39000,42000,-3000,-3000
057666,奇力新元大9A購01,0,0,0,0,0,0,0,0,0,-3000,0,0,0,0,3000,-3000,-3000
057836,南亞科國泰9A購01,0,0,0,0,0,0,0,0,0,-3000,0,0,0,10000,13000,-3000,-3000
056516,晶豪科兆豐98購01,0,0,0,0,0,0,0,0,0,-3000,0,0,0,305000,308000,-3000,-3000
05654P,台光電統一96售01,0,0,0,0,0,0,0,0,0,-3000,0,0,0,28000,31000,-3000,-3000
056556,南電凱基98購01  ,0,0,0,0,0,0,0,0,0,-3000,0,0,0,0,3000,-3000,-3000
056965,全新永豐98購01  ,0,0,0,0,0,0,0,0,0,-3000,0,0,0,0,3000,-3000,-3000
056908,牧德元大99購03  ,0,0,0,0,0,0,0,0,0,-3000,0,0,0,34000,37000,-3000,-3000
056993,GIS兆豐99購01   ,0,0,0,0,0,0,0,0,0,-3000,0,0,0,0,3000,-3000,-3000
056892,旺宏元大9A購02  ,0,0,0,0,0,0,0,0,0,-3000,0,0,0,25000,28000,-3000,-3000
056899,可成元大98購01  ,0,0,0,0,0,0,0,0,0,-3000,0,0,0,149000,152000,-3000,-3000
057422,欣興凱基98購04  ,0,0,0,0,0,0,0,0,0,-3000,0,0,0,23000,26000,-3000,-3000
057221,華通國票98購03  ,0,0,0,0,0,0,0,0,0,-3000,0,0,0,7000,10000,-3000,-3000
052836,旺宏國泰98購01  ,0,0,0,0,0,0,0,0,0,-3000,0,0,0,189000,192000,-3000,-3000
05254P,瑞昱凱基95售04  ,0,0,0,0,0,0,0,0,0,-3000,0,0,0,0,3000,-3000,-3000
049175,台積電凱基94購12,0,0,0,0,0,0,0,0,0,-3000,0,0,0,0,3000,-3000,-3000
049052,台積電永豐94購02,0,0,0,0,0,0,0,0,0,-3000,0,0,0,0,3000,-3000,-3000
04896P,上証2X中信95售01,0,0,0,0,0,0,0,0,0,-3000,0,0,0,10000,13000,-3000,-3000
049891,T50反1富邦94購02,0,0,0,0,0,0,0,0,0,-3000,0,0,0,0,3000,-3000,-3000
049857,緯穎群益94購03  ,0,0,0,0,0,0,0,0,0,-3000,0,0,0,10000,13000,-3000,-3000
049904,矽力元富94購01  ,0,0,0,0,0,0,0,0,0,-3000,0,0,0,6000,9000,-3000,-3000
048396,奇力新國票94購02,0,0,0,0,0,0,0,0,0,-3000,0,0,0,27000,30000,-3000,-3000
047627,華新科國票94購03,0,0,0,0,0,0,0,0,0,-3000,0,0,0,0,3000,-3000,-3000
048427,百和元富95購01  ,0,0,0,0,0,0,0,0,0,-3000,0,0,0,47000,50000,-3000,-3000
049253,台積電元大94購08,0,0,0,0,0,0,0,0,0,-3000,0,0,0,10000,13000,-3000,-3000
050058,國巨凱基94購06  ,0,0,0,0,0,0,0,0,0,-3000,0,0,0,5000,8000,-3000,-3000
04563P,可成凱基94售05  ,0,0,0,0,0,0,0,0,0,-3000,0,0,0,0,3000,-3000,-3000
04458P,世紀鋼統一96售01,0,0,0,0,0,0,0,0,0,-3000,0,0,0,0,3000,-3000,-3000
03094X,大立光元大68展08,0,0,0,0,0,0,0,0,0,-3000,0,0,0,0,3000,-3000,-3000
03885P,華新科統一96售01,0,0,0,0,0,0,0,0,0,-3000,0,0,0,0,3000,-3000,-3000
046629,群創統一98購01  ,0,0,0,0,0,0,0,0,0,-3000,0,0,0,97000,100000,-3000,-3000
00733,富邦臺灣中小    ,0,0,0,0,0,0,0,0,0,-3000,0,0,0,210000,213000,-3000,-3000
00866,新光Shiller CAPE,0,0,0,0,0,0,0,0,0,-3000,0,0,0,9000,12000,-3000,-3000
00767,FH美國金融股    ,0,0,0,0,0,0,0,0,0,-3000,0,0,0,0,3000,-3000,-3000
0057,富邦摩台        ,0,0,0,0,0,0,0,0,0,-3000,0,0,0,20000,23000,-3000,-3000
051981,南茂凱基96購01  ,0,0,0,0,0,0,0,0,0,-3000,0,0,0,0,3000,-3000,-3000
053259,卜蜂群益97購01  ,0,0,0,0,0,0,0,0,0,-3000,0,0,0,0,3000,-3000,-3000
050650,大立光凱基96購01,0,0,0,0,0,0,0,0,0,-3000,0,0,0,0,3000,-3000,-3000
050535,台表科群益94購02,0,0,0,0,0,0,0,0,0,-3000,0,0,0,0,3000,-3000,-3000
050491,旺宏國泰96購01  ,0,0,0,0,0,0,0,0,0,-3000,0,0,0,91000,94000,-3000,-3000
053137,旺宏富邦98購01  ,0,0,0,0,0,0,0,0,0,-3000,0,0,0,0,3000,-3000,-3000
053159,同欣電元大96購02,0,0,0,0,0,0,0,0,0,-3000,0,0,0,68000,71000,-3000,-3000
053128,瀚宇博凱基96購01,0,0,0,0,0,0,0,0,0,-3000,0,0,0,0,3000,-3000,-3000
050917,瀚宇博兆豐96購01,0,0,0,0,0,0,0,0,0,-3000,0,0,0,0,3000,-3000,-3000
050993,聯發科元大95購05,0,0,0,0,0,0,0,0,0,-3000,0,0,0,10000,13000,-3000,-3000
052431,茂林永豐95購03  ,0,0,0,0,0,0,0,0,0,-3000,0,0,0,2000,5000,-3000,-3000
052372,台泥元大95購02  ,0,0,0,0,0,0,0,0,0,-3000,0,0,0,68000,71000,-3000,-3000
051672,玉晶光元大96購03,0,0,0,0,0,0,0,0,0,-3000,0,0,0,0,3000,-3000,-3000
050356,緯穎群益94購05  ,0,0,0,0,0,0,0,0,0,-3000,0,0,0,17000,20000,-3000,-3000
051339,智易永豐95購02  ,0,0,0,0,0,0,0,0,0,-3000,0,0,0,0,3000,-3000,-3000
054715,中橡康和97購01  ,0,0,0,0,0,0,0,0,0,-3000,0,0,0,0,3000,-3000,-3000
054545,奇力新中信98購01,0,0,0,0,0,0,0,0,0,-3000,0,0,0,2000,5000,-3000,-3000
054942,凱美元大97購02  ,0,0,0,0,0,0,0,0,0,-3000,0,0,0,0,3000,-3000,-3000
054929,群電凱基97購01  ,0,0,0,0,0,0,0,0,0,-3000,0,0,0,7000,10000,-3000,-3000
055052,凱美永豐97購01  ,0,0,0,0,0,0,0,0,0,-3000,0,0,0,0,3000,-3000,-3000
053986,矽創第一96購01  ,0,0,0,0,0,0,0,0,0,-3000,0,0,0,0,3000,-3000,-3000
054267,上銀第一96購01  ,0,0,0,0,0,0,0,0,0,-3000,0,0,0,0,3000,-3000,-3000
055325,佐登國票98購01  ,0,0,0,0,0,0,0,0,0,-3000,0,0,0,0,3000,-3000,-3000
055489,瑞昱元大97購02  ,0,0,0,0,0,0,0,0,0,-3000,0,0,0,23000,26000,-3000,-3000
056384,玉晶光國泰9A購02,0,0,0,0,0,0,0,0,0,-3000,0,0,0,10000,13000,-3000,-3000
05612P,台積電元大96售13,0,0,0,0,0,0,0,0,0,-3000,0,0,0,47000,50000,-3000,-3000
055830,上銀元大97購07  ,0,0,0,0,0,0,0,0,0,-3000,0,0,0,50000,53000,-3000,-3000
07021P,台積電富邦9C售02,0,0,0,0,0,0,0,0,0,-3000,0,0,0,0,3000,-3000,-3000
06076P,大立光凱基98售03,0,0,0,0,0,0,0,0,0,-3000,0,0,0,0,3000,-3000,-3000
06178P,大立光第一99售01,0,0,0,0,0,0,0,0,0,-3000,0,0,0,7000,10000,-3000,-3000
3025,星通            ,7000,10000,-3000,0,0,0,0,0,0,0,0,0,0,0,0,0,-3000
5538,東明-KY         ,0,3000,-3000,0,0,0,0,0,0,0,0,0,0,0,0,0,-3000
057232,京元電凱基98購02,0,0,0,0,0,0,0,0,0,-4000,0,0,0,0,4000,-4000,-4000
057254,友達麥證98購01  ,0,0,0,11000,15000,-4000,0,0,0,-4000,0,0,0,11000,15000,-4000,-4000
056751,和大兆豐98購01  ,0,0,0,0,0,0,0,0,0,-4000,0,0,0,64000,68000,-4000,-4000
056771,嘉晶元大99購01  ,0,0,0,0,0,0,0,0,0,-4000,0,0,0,25000,29000,-4000,-4000
056645,大立光凱基98購12,0,0,0,0,0,0,0,0,0,-4000,0,0,0,3000,7000,-4000,-4000
057956,全新元大99購04  ,0,0,0,0,0,0,0,0,0,-4000,0,0,0,0,4000,-4000,-4000
057987,大立光元富98購02,0,0,0,0,0,0,0,0,0,-4000,0,0,0,6000,10000,-4000,-4000
058284,滬深反群益01購01,0,0,0,0,0,0,0,0,0,-4000,0,0,0,0,4000,-4000,-4000
058709,臺股指元大9A購22,0,0,0,0,0,0,0,0,0,-4000,0,0,0,0,4000,-4000,-4000
05898P,旺宏凱基96售06  ,0,0,0,0,0,0,0,0,0,-4000,0,0,0,35000,39000,-4000,-4000
058548,元石油永豐99購01,0,0,0,0,0,0,0,0,0,-4000,0,0,0,0,4000,-4000,-4000
00775B,新光投等債15+   ,0,0,0,0,0,0,0,0,0,-4000,0,0,0,2000,6000,-4000,-4000
046384,群創凱基98購02  ,0,0,0,0,0,0,0,0,0,-4000,0,0,0,66000,70000,-4000,-4000
04452P,超眾國泰95售01  ,0,0,0,0,0,0,0,0,0,-4000,0,0,0,0,4000,-4000,-4000
04494P,台積電國票94售04,0,0,0,0,0,0,0,0,0,-4000,0,0,0,0,4000,-4000,-4000
046944,奇力新元大96購01,0,0,0,0,0,0,0,0,0,-4000,0,0,0,0,4000,-4000,-4000
048425,聯茂元富96購02  ,0,0,0,0,0,0,0,0,0,-4000,0,0,0,0,4000,-4000,-4000
049430,國巨國票95購02  ,0,0,0,0,0,0,0,0,0,-4000,0,0,0,35000,39000,-4000,-4000
048983,牧德元大95購01  ,0,0,0,0,0,0,0,0,0,-4000,0,0,0,2000,6000,-4000,-4000
051269,康友富邦97購01  ,0,0,0,0,0,0,0,0,0,-4000,0,0,0,0,4000,-4000,-4000
051591,玉晶光元大97購01,0,0,0,0,0,0,0,0,0,-4000,0,0,0,68000,72000,-4000,-4000
051780,矽力群益95購01  ,0,0,0,0,0,0,0,0,0,-4000,0,0,0,78000,82000,-4000,-4000
051719,鴻海永豐95購04  ,0,0,0,0,0,0,0,0,0,-4000,0,0,0,0,4000,-4000,-4000
053585,友達元大9C購03  ,0,0,0,0,0,0,0,0,0,-4000,0,0,0,16000,20000,-4000,-4000
053441,旺宏凱基98購01  ,0,0,0,0,0,0,0,0,0,-4000,0,0,0,10000,14000,-4000,-4000
053179,大立光統一96購04,0,0,0,0,0,0,0,0,0,-4000,0,0,0,100000,104000,-4000,-4000
051873,緯穎凱基95購02  ,0,0,0,0,0,0,0,0,0,-4000,0,0,0,31000,35000,-4000,-4000
052583,友達台新96購02  ,0,0,0,0,0,0,0,0,0,-4000,0,0,0,52000,56000,-4000,-4000
053166,聯詠群益96購02  ,0,0,0,0,0,0,0,0,0,-4000,0,0,0,11000,15000,-4000,-4000
053132,國巨國票97購02  ,0,0,0,0,0,0,0,0,0,-4000,0,0,0,2000,6000,-4000,-4000
053187,國巨統一96購05  ,0,0,0,0,0,0,0,0,0,-4000,0,0,0,23000,27000,-4000,-4000
050652,大立光凱基96購03,0,0,0,0,0,0,0,0,0,-4000,0,0,0,0,4000,-4000,-4000
050604,上証2X永昌94購01,0,0,0,0,0,0,0,0,0,-4000,0,0,0,4000,8000,-4000,-4000
050227,大立光中信96購01,0,0,0,0,0,0,0,0,0,-4000,0,0,0,36000,40000,-4000,-4000
051224,華通群益96購03  ,0,0,0,0,0,0,0,0,0,-4000,0,0,0,0,4000,-4000,-4000
050895,聯發科元大97購01,0,0,0,0,0,0,0,0,0,-4000,0,0,0,62000,66000,-4000,-4000
050817,可成凱基95購01  ,0,0,0,0,0,0,0,0,0,-4000,0,0,0,0,4000,-4000,-4000
056252,聯發科兆豐97購03,0,0,0,0,0,0,0,0,0,-4000,0,0,0,0,4000,-4000,-4000
056157,聯詠凱基97購03  ,0,0,0,0,0,0,0,0,0,-4000,0,0,0,12000,16000,-4000,-4000
055284,全新元大99購01  ,0,0,0,0,0,0,0,0,0,-4000,0,0,0,0,4000,-4000,-4000
055441,緯穎國票98購01  ,0,0,0,0,0,0,0,0,0,-4000,0,0,0,0,4000,-4000,-4000
054241,深中小元大98購01,0,0,0,0,0,0,0,0,0,-4000,0,0,0,0,4000,-4000,-4000
054193,鴻海麥證96購02  ,0,0,0,0,4000,-4000,0,0,0,-4000,0,0,0,0,4000,-4000,-4000
05466P,旺宏富邦97售01  ,0,0,0,0,0,0,0,0,0,-4000,0,0,0,200000,204000,-4000,-4000
4164,承業醫          ,72000,76000,-4000,0,0,0,0,0,0,0,3000,3000,0,0,0,0,-4000
4144,康聯-KY         ,9000,13000,-4000,0,0,0,0,0,0,0,0,0,0,0,0,0,-4000
3024,憶聲            ,57000,60000,-3000,0,0,0,0,0,0,-1000,0,1000,-1000,0,0,0,-4000
3454,晶睿            ,86000,90000,-4000,0,0,0,0,0,0,0,0,0,0,0,0,0,-4000
911622,泰聚亨-DR       ,0,0,0,0,0,0,0,0,0,-4000,0,4000,-4000,0,0,0,-4000
06161P,聯發科群益97售03,0,0,0,0,0,0,0,0,0,-4000,0,0,0,0,4000,-4000,-4000
06133P,帆宣元富97售02  ,0,1000,-1000,0,0,0,0,0,0,-3000,0,0,0,8000,11000,-3000,-4000
06564P,國巨富邦9A售04  ,0,0,0,0,0,0,0,0,0,-4000,0,0,0,33000,37000,-4000,-4000
06593P,欣興元大98售05  ,0,0,0,0,0,0,0,0,0,-4000,0,0,0,177000,181000,-4000,-4000
06472P,道瓊銀元大98售03,0,0,0,0,0,0,0,0,0,-4000,0,0,0,200000,204000,-4000,-4000
07019P,鴻海台新99售01  ,0,0,0,0,0,0,0,0,0,-4000,0,0,0,0,4000,-4000,-4000
06885P,國巨國票99售06  ,0,0,0,0,0,0,0,0,0,-4000,0,0,0,1000,5000,-4000,-4000
06792P,臺股指凱基98售02,0,0,0,0,0,0,0,0,0,-4000,0,0,0,1000,5000,-4000,-4000
06803P,臺股指群益98售09,0,0,0,0,0,0,0,0,0,-4000,0,0,0,2000,6000,-4000,-4000
1339,昭輝            ,36000,41000,-5000,0,0,0,0,0,0,1000,2000,1000,1000,0,0,0,-4000
058534,友達統一9B購01  ,0,0,0,0,0,0,0,0,0,-5000,0,0,0,0,5000,-5000,-5000
058477,億光凱基9A購01  ,0,0,0,0,0,0,0,0,0,-5000,0,0,0,0,5000,-5000,-5000
058362,聯發科凱基99購06,0,0,0,0,0,0,0,0,0,-5000,0,0,0,35000,40000,-5000,-5000
058310,大立光元大99購10,0,0,0,0,0,0,0,0,0,-5000,0,0,0,0,5000,-5000,-5000
05894P,友達群益98售02  ,0,0,0,0,0,0,0,0,0,-5000,0,0,0,69000,74000,-5000,-5000
058699,楠梓電元大99購02,0,0,0,0,0,0,0,0,0,-5000,0,0,0,0,5000,-5000,-5000
058727,嘉晶富邦9A購01  ,0,0,0,0,0,0,0,0,0,-5000,0,0,0,0,5000,-5000,-5000
05860P,旺宏康和96售01  ,0,0,0,0,0,0,0,0,0,-5000,0,0,0,10000,15000,-5000,-5000
058620,滬深2X國票9A購02,0,0,0,0,0,0,0,0,0,-5000,0,0,0,0,5000,-5000,-5000
05937P,台積電凱基96售21,0,0,0,0,0,0,0,0,0,-5000,0,0,0,5000,10000,-5000,-5000
058003,FBVIX群益9C購02 ,0,0,0,0,0,0,0,0,0,-5000,0,0,0,0,5000,-5000,-5000
057922,華新科凱基99購01,0,0,0,0,0,0,0,0,0,-5000,0,0,0,0,5000,-5000,-5000
057851,鴻海國票99購06  ,0,0,0,0,0,0,0,0,0,-5000,0,0,0,20000,25000,-5000,-5000
05780P,台積電統一96售07,0,0,0,0,0,0,0,0,0,-5000,0,0,0,15000,20000,-5000,-5000
056689,玉晶光統一9A購03,0,0,0,0,0,0,0,0,0,-5000,0,0,0,1000,6000,-5000,-5000
056746,超眾凱基99購01  ,0,0,0,0,0,0,0,0,0,-5000,0,0,0,1000,6000,-5000,-5000
057407,超眾群益99購01  ,0,0,0,0,0,0,0,0,0,-5000,0,0,0,3000,8000,-5000,-5000
057379,寶成元大98購02  ,0,0,0,0,0,0,0,0,0,-5000,0,0,0,0,5000,-5000,-5000
05738P,臺股指統一97售01,0,0,0,0,0,0,0,0,0,-5000,0,0,0,0,5000,-5000,-5000
057461,國巨永豐98購07  ,0,0,0,0,0,0,0,0,0,-5000,0,0,0,25000,30000,-5000,-5000
048992,昇陽半元大94購02,0,0,0,0,0,0,0,0,0,-5000,0,0,0,0,5000,-5000,-5000
04901P,臺股指麥證94售02,0,0,0,10000,15000,-5000,0,0,0,-5000,0,0,0,10000,15000,-5000,-5000
048832,玉晶光凱基95購02,0,0,0,0,0,0,0,0,0,-5000,0,0,0,6000,11000,-5000,-5000
04837P,華新科元大94售05,0,0,0,0,0,0,0,0,0,-5000,0,0,0,72000,77000,-5000,-5000
049318,樺漢凱基94購01  ,0,0,0,0,0,0,0,0,0,-5000,0,0,0,5000,10000,-5000,-5000
049985,華擎凱基94購01  ,0,0,0,0,0,0,0,0,0,-5000,0,0,0,20000,25000,-5000,-5000
049859,味全兆豐95購01  ,0,0,0,0,0,0,0,0,0,-5000,0,0,0,0,5000,-5000,-5000
048532,大立光國票93購06,0,0,0,0,0,0,0,0,0,-5000,0,0,0,0,5000,-5000,-5000
047630,元油反元大96購02,0,0,0,0,0,0,0,0,0,-5000,0,0,0,5000,10000,-5000,-5000
047897,可成群益94購01  ,0,0,0,0,0,0,0,0,0,-5000,0,0,0,270000,275000,-5000,-5000
047860,臺股指國票93購15,0,0,0,0,0,0,0,0,0,-5000,0,0,0,5000,10000,-5000,-5000
047784,元油反富邦94購03,0,0,0,0,0,0,0,0,0,-5000,0,0,0,82000,87000,-5000,-5000
046934,智邦元富96購01  ,0,0,0,0,0,0,0,0,0,-5000,0,0,0,50000,55000,-5000,-5000
046884,元油反群益95購01,0,0,0,0,0,0,0,0,0,-5000,0,0,0,0,5000,-5000,-5000
04712P,國泰金元大94售01,0,0,0,0,0,0,0,0,0,-5000,0,0,0,0,5000,-5000,-5000
03615C,臺股指元大94牛01,0,0,0,0,0,0,0,0,0,-5000,0,0,0,0,5000,-5000,-5000
03012X,元展12          ,0,0,0,0,0,0,0,0,0,-5000,0,0,0,0,5000,-5000,-5000
04252P,台達電元富93售02,0,0,0,0,0,0,0,0,0,-5000,0,0,0,5000,10000,-5000,-5000
050823,信邦凱基95購01  ,0,0,0,0,0,0,0,0,0,-5000,0,0,0,5000,10000,-5000,-5000
050768,聯發科元大94購16,0,0,0,0,0,0,0,0,0,-5000,0,0,0,0,5000,-5000,-5000
051241,台積電元大95購13,0,0,0,0,0,0,0,0,0,-5000,0,0,0,0,5000,-5000,-5000
051440,鴻海元大95購12  ,0,0,0,0,0,0,0,0,0,-5000,0,0,0,0,5000,-5000,-5000
051471,國巨凱基97購01  ,0,0,0,0,0,0,0,0,0,-5000,0,0,0,5000,10000,-5000,-5000
053278,禾伸堂元大96購01,0,0,0,0,0,0,0,0,0,-5000,0,0,0,71000,76000,-5000,-5000
053233,大立光永豐96購01,0,0,0,0,0,0,0,0,0,-5000,0,0,0,0,5000,-5000,-5000
051082,上証2X元大98購01,0,0,0,0,0,0,0,0,0,-5000,0,0,0,5000,10000,-5000,-5000
050662,智易元大96購01  ,0,0,0,0,0,0,0,0,0,-5000,0,0,0,0,5000,-5000,-5000
050544,聯發科凱基95購02,0,0,0,0,0,0,0,0,0,-5000,0,0,0,5000,10000,-5000,-5000
051010,美律日盛95購01  ,0,0,0,0,0,0,0,0,0,-5000,0,0,0,0,5000,-5000,-5000
050105,力山元大95購02  ,0,0,0,0,0,0,0,0,0,-5000,0,0,0,0,5000,-5000,-5000
051876,宏達電國票96購01,0,0,0,0,0,0,0,0,0,-5000,0,0,0,0,5000,-5000,-5000
051862,旺宏凱基95購05  ,0,0,0,0,0,0,0,0,0,-5000,0,0,0,148000,153000,-5000,-5000
050131,新光金凱基94購01,0,0,0,0,0,0,0,0,0,-5000,0,0,0,15000,20000,-5000,-5000
053339,友達國票97購02  ,0,0,0,0,0,0,0,0,0,-5000,0,0,0,0,5000,-5000,-5000
053665,臺股指凱基96購26,0,0,0,0,0,0,0,0,0,-5000,0,0,0,0,5000,-5000,-5000
053556,康控凱基97購02  ,0,0,0,0,0,0,0,0,0,-5000,0,0,0,0,5000,-5000,-5000
052212,可成元大95購11  ,0,0,0,0,0,0,0,0,0,-5000,0,0,0,0,5000,-5000,-5000
052505,友達日盛9B購02  ,0,0,0,0,0,0,0,0,0,-5000,0,0,0,57000,62000,-5000,-5000
051775,旺宏亞東95購01  ,0,0,0,0,0,0,0,0,0,-5000,0,0,0,0,5000,-5000,-5000
052063,臺股指國票95購10,0,0,0,0,0,0,0,0,0,-5000,0,0,0,0,5000,-5000,-5000
051545,裕隆康和95購01  ,0,0,0,0,0,0,0,0,0,-5000,0,0,0,0,5000,-5000,-5000
05149P,緯穎國泰96售01  ,0,0,0,0,0,0,0,0,0,-5000,0,0,0,0,5000,-5000,-5000
051289,大立光統一96購01,0,0,0,0,0,0,0,0,0,-5000,0,0,0,35000,40000,-5000,-5000
052123,泰碩國票95購01  ,0,0,0,0,0,0,0,0,0,-5000,0,0,0,111000,116000,-5000,-5000
050311,上銀兆豐95購01  ,0,0,0,0,0,0,0,0,0,-5000,0,0,0,0,5000,-5000,-5000
050313,大立光兆豐94購05,0,0,0,0,0,0,0,0,0,-5000,0,0,0,0,5000,-5000,-5000
051392,玉山金兆豐95購01,0,0,0,0,0,0,0,0,0,-5000,0,0,0,5000,10000,-5000,-5000
050402,緯穎中信96購01  ,0,0,0,0,0,0,0,0,0,-5000,0,0,0,92000,97000,-5000,-5000
054518,亞光元大97購01  ,0,0,0,0,0,0,0,0,0,-5000,0,0,0,80000,85000,-5000,-5000
055068,亞翔永豐97購01  ,0,0,0,0,0,0,0,0,0,-5000,0,0,0,0,5000,-5000,-5000
054941,凱美元大97購01  ,0,0,0,0,0,0,0,0,0,-5000,0,0,0,50000,55000,-5000,-5000
054907,帆宣康和97購01  ,0,0,0,0,0,0,0,0,0,-5000,0,0,0,0,5000,-5000,-5000
054194,國巨麥證96購02  ,0,0,0,90000,95000,-5000,0,0,0,-5000,0,0,0,90000,95000,-5000,-5000
054396,日電貿永豐96購02,0,0,0,0,0,0,0,0,0,-5000,0,0,0,0,5000,-5000,-5000
054382,康控群益96購03  ,0,0,0,0,0,0,0,0,0,-5000,0,0,0,111000,116000,-5000,-5000
053948,大立光富邦99購04,0,0,0,0,0,0,0,0,0,-5000,0,0,0,20000,25000,-5000,-5000
053848,聯發科元富96購03,0,0,0,0,0,0,0,0,0,-5000,0,0,0,0,5000,-5000,-5000
053908,貿聯凱基98購01  ,0,0,0,0,0,0,0,0,0,-5000,0,0,0,0,5000,-5000,-5000
053911,臺股指凱基96購31,0,0,0,0,0,0,0,0,0,-5000,0,0,0,0,5000,-5000,-5000
055376,群創元大01購01  ,0,0,0,0,0,0,0,0,0,-5000,0,0,0,54000,59000,-5000,-5000
055309,冠德群益97購01  ,0,0,0,0,0,0,0,0,0,-5000,0,0,0,0,5000,-5000,-5000
055304,瑞昱第一98購01  ,0,0,0,0,0,0,0,0,0,-5000,0,0,0,0,5000,-5000,-5000
055243,國巨統一97購04  ,0,0,0,0,0,0,0,0,0,-5000,0,0,0,0,5000,-5000,-5000
055480,元上證元大97購02,0,0,0,0,0,0,0,0,0,-5000,0,0,0,7000,12000,-5000,-5000
055481,聚陽元大97購01  ,0,0,0,0,0,0,0,0,0,-5000,0,0,0,0,5000,-5000,-5000
055585,國巨元大98購08  ,0,0,0,0,0,0,0,0,0,-5000,0,0,0,70000,75000,-5000,-5000
055747,康舒元富97購01  ,0,0,0,0,0,0,0,0,0,-5000,0,0,0,50000,55000,-5000,-5000
055754,和大兆豐97購01  ,0,0,0,0,0,0,0,0,0,-5000,0,0,0,0,5000,-5000,-5000
055761,創意群益97購01  ,0,0,0,0,0,0,0,0,0,-5000,0,0,0,0,5000,-5000,-5000
05577P,上銀凱基96售02  ,0,0,0,0,0,0,0,0,0,-5000,0,0,0,0,5000,-5000,-5000
055678,上銀凱基97購02  ,0,0,0,0,0,0,0,0,0,-5000,0,0,0,68000,73000,-5000,-5000
056401,國巨群益98購07  ,0,0,0,0,0,0,0,0,0,-5000,0,0,0,10000,15000,-5000,-5000
055864,臺股指元大97購01,0,0,0,0,0,0,0,0,0,-5000,0,0,0,0,5000,-5000,-5000
056090,康舒統一97購01  ,0,0,0,0,0,0,0,0,0,-5000,0,0,0,0,5000,-5000,-5000
05601P,鴻海元大97售04  ,0,0,0,0,0,0,0,0,0,-5000,0,0,0,33000,38000,-5000,-5000
056024,大立光群益97購05,0,0,0,0,0,0,0,0,0,-5000,0,0,0,0,5000,-5000,-5000
056008,全新中信9B購01  ,0,0,0,0,0,0,0,0,0,-5000,0,0,0,0,5000,-5000,-5000
1783,和康生          ,25000,30000,-5000,0,0,0,0,0,0,0,0,0,0,0,0,0,-5000
06784P,臺股指元大98售01,0,0,0,0,0,0,0,0,0,-5000,0,0,0,0,5000,-5000,-5000
06838P,台積電統一99售05,0,0,0,0,0,0,0,0,0,-5000,0,0,0,5000,10000,-5000,-5000
07025P,玉晶光凱基99售01,0,0,0,0,0,0,0,0,0,-5000,0,0,0,0,5000,-5000,-5000
07068P,欣興台新99售01  ,0,0,0,0,0,0,0,0,0,-5000,0,0,0,0,5000,-5000,-5000
06441P,台積電凱基98售08,0,0,0,0,0,0,0,0,0,-5000,0,0,0,76000,81000,-5000,-5000
06729P,聯詠元大98售03  ,0,0,0,0,0,0,0,0,0,-5000,0,0,0,0,5000,-5000,-5000
06350P,臺股指台新99售02,0,0,0,0,0,0,0,0,0,-5000,0,0,0,0,5000,-5000,-5000
06413P,聯發科凱基97售11,0,0,0,0,0,0,0,0,0,-5000,0,0,0,0,5000,-5000,-5000
9902,台火            ,23000,28000,-5000,0,0,0,0,0,0,0,0,0,0,0,0,0,-5000
2426,鼎元            ,227000,233000,-6000,0,0,0,0,0,0,1000,2000,1000,1000,0,0,0,-5000
2820,華票            ,629000,646000,-17000,0,0,0,0,0,0,12000,17000,5000,12000,0,0,0,-5000
057423,台郡凱基98購06  ,0,0,0,0,0,0,0,0,0,-6000,0,0,0,20000,26000,-6000,-6000
05761P,嘉澤永豐96售01  ,0,0,0,0,0,0,0,0,0,-6000,0,0,0,24000,30000,-6000,-6000
05724P,致茂永豐96售01  ,0,0,0,0,0,0,0,0,0,-6000,0,0,0,14000,20000,-6000,-6000
057310,聯發科日盛99購01,0,0,0,0,0,0,0,0,0,-6000,0,0,0,0,6000,-6000,-6000
057129,聯發科凱基99購03,0,0,0,0,0,0,0,0,0,-6000,0,0,0,0,6000,-6000,-6000
056549,嘉聯益凱基98購04,0,0,0,0,0,0,0,0,0,-6000,0,0,0,10000,16000,-6000,-6000
056904,大立光元大99購05,0,0,0,0,0,0,0,0,0,-6000,0,0,0,0,6000,-6000,-6000
05777P,台積電統一96售04,0,0,0,0,0,0,0,0,0,-6000,0,0,0,139000,145000,-6000,-6000
057777,可成群益9A購03  ,0,0,0,0,0,0,0,0,0,-6000,0,0,0,46000,52000,-6000,-6000
057778,大立光群益98購02,0,0,0,0,0,0,0,0,0,-6000,0,0,0,0,6000,-6000,-6000
057822,牧德元大9A購01  ,0,0,0,0,0,0,0,0,0,-6000,0,0,0,0,6000,-6000,-6000
058004,大立光群益98購03,0,0,0,0,0,0,0,0,0,-6000,0,0,0,2000,8000,-6000,-6000
058227,台灣50元大9C購01,0,0,0,0,0,0,0,0,0,-6000,0,0,0,4000,10000,-6000,-6000
05983P,聯詠國票96售02  ,0,0,0,0,0,0,0,0,0,-6000,0,0,0,20000,26000,-6000,-6000
05993P,國巨元大96售13  ,0,0,0,0,0,0,0,0,0,-6000,0,0,0,31000,37000,-6000,-6000
058410,國巨兆豐99購03  ,0,0,0,0,0,0,0,0,0,-6000,0,0,0,10000,16000,-6000,-6000
05852P,嘉晶群益96售01  ,0,0,0,0,0,0,0,0,0,-6000,0,0,0,0,6000,-6000,-6000
042501,台灣50凱基96購06,0,0,0,0,0,0,0,0,0,-6000,0,0,0,4000,10000,-6000,-6000
00688L,國泰20年美債正2 ,0,0,0,0,0,0,0,0,0,-6000,0,0,0,166000,172000,-6000,-6000
03022X,富展01          ,0,0,0,0,0,0,0,0,0,-6000,0,0,0,0,6000,-6000,-6000
046477,台積電統一94購02,0,0,0,0,0,0,0,0,0,-6000,0,0,0,0,6000,-6000,-6000
04385P,可成日盛94售01  ,0,0,0,0,0,0,0,0,0,-6000,0,0,0,0,6000,-6000,-6000
045293,鴻海元大94購01  ,0,0,0,0,0,0,0,0,0,-6000,0,0,0,80000,86000,-6000,-6000
047557,麗豐凱基94購02  ,0,0,0,0,0,0,0,0,0,-6000,0,0,0,0,6000,-6000,-6000
047542,華通凱基94購02  ,0,0,0,0,0,0,0,0,0,-6000,0,0,0,0,6000,-6000,-6000
049880,健策永豐94購02  ,0,0,0,0,0,0,0,0,0,-6000,0,0,0,34000,40000,-6000,-6000
04863P,技嘉元大94售02  ,0,0,0,0,0,0,0,0,0,-6000,0,0,0,0,6000,-6000,-6000
048719,亞光永豐94購01  ,0,0,0,0,0,0,0,0,0,-6000,0,0,0,0,6000,-6000,-6000
050425,國巨凱基94購12  ,0,0,0,0,0,0,0,0,0,-6000,0,0,0,18000,24000,-6000,-6000
051372,樺漢富邦96購01  ,0,0,0,0,0,0,0,0,0,-6000,0,0,0,20000,26000,-6000,-6000
051722,玉晶光永豐97購01,0,0,0,0,0,0,0,0,0,-6000,0,0,0,2000,8000,-6000,-6000
053462,元油反富邦97購02,0,0,0,0,0,0,0,0,0,-6000,0,0,0,7000,13000,-6000,-6000
053044,南茂凱基96購02  ,0,0,0,0,0,0,0,0,0,-6000,0,0,0,99000,105000,-6000,-6000
050210,華新科國票94購08,0,0,0,0,0,0,0,0,0,-6000,0,0,0,0,6000,-6000,-6000
051023,S&P反1統一95購02,0,0,0,0,0,0,0,0,0,-6000,0,0,0,0,6000,-6000,-6000
051899,欣興國泰97購01  ,0,0,0,0,0,0,0,0,0,-6000,0,0,0,10000,16000,-6000,-6000
053169,貿聯群益97購01  ,0,0,0,0,0,0,0,0,0,-6000,0,0,0,21000,27000,-6000,-6000
050572,大立光中信97購01,0,0,0,0,0,0,0,0,0,-6000,0,0,0,10000,16000,-6000,-6000
053274,旺宏元大98購03  ,0,0,0,0,0,0,0,0,0,-6000,0,0,0,97000,103000,-6000,-6000
051996,康友元大95購01  ,0,0,0,0,0,0,0,0,0,-6000,0,0,0,0,6000,-6000,-6000
056004,南電永豐97購02  ,0,0,0,0,0,0,0,0,0,-6000,0,0,0,62000,68000,-6000,-6000
055872,亞泥元富97購01  ,0,0,0,0,0,0,0,0,0,-6000,0,0,0,10000,16000,-6000,-6000
056348,S&P反1元大9A購01,0,0,0,0,0,0,0,0,0,-6000,0,0,0,8000,14000,-6000,-6000
056176,創意元富97購01  ,0,0,0,0,0,0,0,0,0,-6000,0,0,0,0,6000,-6000,-6000
055567,訊芯凱基98購02  ,0,0,0,0,0,0,0,0,0,-6000,0,0,0,0,6000,-6000,-6000
055527,旺宏群益99購03  ,0,0,0,0,0,0,0,0,0,-6000,0,0,0,22000,28000,-6000,-6000
055418,華通永豐97購01  ,0,0,0,0,0,0,0,0,0,-6000,0,0,0,0,6000,-6000,-6000
054107,上銀凱基97購01  ,0,0,0,0,0,0,0,0,0,-6000,0,0,0,10000,16000,-6000,-6000
054338,全新統一96購01  ,0,0,0,0,0,0,0,0,0,-6000,0,0,0,0,6000,-6000,-6000
054314,嘉聯益凱基97購01,0,0,0,0,0,0,0,0,0,-6000,0,0,0,0,6000,-6000,-6000
054884,友達統一99購01  ,0,0,0,0,0,0,0,0,0,-6000,0,0,0,100000,106000,-6000,-6000
05455P,聯詠日盛95售01  ,0,0,0,0,0,0,0,0,0,-6000,0,0,0,0,6000,-6000,-6000
054752,易華電凱基97購02,0,0,0,0,0,0,0,0,0,-6000,0,0,0,99000,105000,-6000,-6000
3050,鈺德            ,52000,58000,-6000,0,0,0,0,0,0,0,0,0,0,0,0,0,-6000
3030,德律            ,311000,317000,-6000,0,0,0,0,0,0,0,2000,2000,0,0,0,0,-6000
9937,全國            ,10000,16000,-6000,0,0,0,0,0,0,0,0,0,0,0,0,0,-6000
06389P,聯發科兆豐97售01,0,0,0,0,0,0,0,0,0,-6000,0,0,0,29000,35000,-6000,-6000
06113P,台積電群益97售01,0,0,0,0,0,0,0,0,0,-6000,0,0,0,26000,32000,-6000,-6000
06098P,T50反1日盛97售02,0,0,0,0,0,0,0,0,0,-6000,0,0,0,15000,21000,-6000,-6000
06623P,立積元大98售04  ,0,0,0,0,0,0,0,0,0,-6000,0,0,0,223000,229000,-6000,-6000
06537P,華通凱基98售04  ,0,0,0,0,0,0,0,0,0,-6000,0,0,0,9000,15000,-6000,-6000
058430,滬深2X統一99購02,0,0,0,0,0,0,0,0,0,-7000,0,0,0,11000,18000,-7000,-7000
058288,南亞科國票9A購01,0,0,0,0,0,0,0,0,0,-7000,0,0,0,3000,10000,-7000,-7000
058123,亞光國票9A購01  ,0,0,0,0,0,0,0,0,0,-7000,0,0,0,18000,25000,-7000,-7000
056911,緯穎元大99購01  ,0,0,0,0,0,0,0,0,0,-7000,0,0,0,68000,75000,-7000,-7000
056665,上証2X國票99購02,0,0,0,0,0,0,0,0,0,-7000,0,0,0,19000,26000,-7000,-7000
05708P,奇力新國票97售04,0,0,0,0,0,0,0,0,0,-7000,0,0,0,73000,80000,-7000,-7000
057548,微星凱基99購01  ,0,0,0,0,0,0,0,0,0,-7000,0,0,0,0,7000,-7000,-7000
05753P,臺股指中信99售02,0,0,0,0,0,0,0,0,0,-7000,0,0,0,34000,41000,-7000,-7000
048068,南亞科元富95購01,0,0,0,0,0,0,0,0,0,-7000,0,0,0,0,7000,-7000,-7000
046903,友達凱基99購01  ,0,0,0,0,0,0,0,0,0,-7000,0,0,0,33000,40000,-7000,-7000
047410,上銀元富96購01  ,0,0,0,0,0,0,0,0,0,-7000,0,0,0,20000,27000,-7000,-7000
04825P,元大金中信94售01,0,0,0,0,0,0,0,0,0,-7000,0,0,0,28000,35000,-7000,-7000
046066,長榮航凱基94購01,0,0,0,0,0,0,0,0,0,-7000,0,0,0,0,7000,-7000,-7000
00736,國泰新興市場    ,0,0,0,0,0,0,0,0,0,-7000,0,0,0,102000,109000,-7000,-7000
051086,鴻海元大96購04  ,0,0,0,0,0,0,0,0,0,-7000,0,0,0,178000,185000,-7000,-7000
050629,廣宇亞東96購01  ,0,0,0,0,0,0,0,0,0,-7000,0,0,0,0,7000,-7000,-7000
051068,台積電國票97購01,0,0,0,0,0,0,0,0,0,-7000,0,0,0,3000,10000,-7000,-7000
051906,國巨元大95購09  ,0,0,0,0,0,0,0,0,0,-7000,0,0,0,145000,152000,-7000,-7000
050173,旺宏元大96購02  ,0,0,0,0,0,0,0,0,0,-7000,0,0,0,68000,75000,-7000,-7000
051861,鴻海凱基98購01  ,0,0,0,0,0,0,0,0,0,-7000,0,0,0,6000,13000,-7000,-7000
053322,京鼎群益97購01  ,0,0,0,0,0,0,0,0,0,-7000,0,0,0,31000,38000,-7000,-7000
052344,台表科凱基98購01,0,0,0,0,0,0,0,0,0,-7000,0,0,0,26000,33000,-7000,-7000
051694,A50正2中信96購03,0,0,0,0,0,0,0,0,0,-7000,0,0,0,88000,95000,-7000,-7000
05178P,大立光凱基96售05,0,0,0,0,0,0,0,0,0,-7000,0,0,0,5000,12000,-7000,-7000
051784,國巨兆豐95購01  ,0,0,0,0,0,0,0,0,0,-7000,0,0,0,230000,237000,-7000,-7000
052076,可成元富98購01  ,0,0,0,0,0,0,0,0,0,-7000,0,0,0,20000,27000,-7000,-7000
051503,玉晶光統一97購01,0,0,0,0,0,0,0,0,0,-7000,0,0,0,0,7000,-7000,-7000
050340,鴻海統一94購07  ,0,0,0,0,0,0,0,0,0,-7000,0,0,0,30000,37000,-7000,-7000
054296,世芯元大97購01  ,0,0,0,0,0,0,0,0,0,-7000,0,0,0,57000,64000,-7000,-7000
054427,潤泰全富邦97購01,0,0,0,0,0,0,0,0,0,-7000,0,0,0,215000,222000,-7000,-7000
053942,超眾國泰96購02  ,0,0,0,0,0,0,0,0,0,-7000,0,0,0,98000,105000,-7000,-7000
053972,華新科元大96購06,0,0,0,0,0,0,0,0,0,-7000,0,0,0,20000,27000,-7000,-7000
055498,大立光元大97購07,0,0,0,0,0,0,0,0,0,-7000,0,0,0,50000,57000,-7000,-7000
055583,國巨元大97購10  ,0,0,0,0,0,0,0,0,0,-7000,0,0,0,0,7000,-7000,-7000
055734,奇力新元富97購02,0,0,0,0,0,0,0,0,0,-7000,0,0,0,0,7000,-7000,-7000
06451P,聯發科元大98售04,0,0,0,0,0,0,0,0,0,-7000,0,0,0,24000,31000,-7000,-7000
06695P,群創兆豐98售04  ,0,0,0,0,0,0,0,0,0,-7000,0,0,0,93000,100000,-7000,-7000
1101B,台泥乙特        ,0,0,0,0,0,0,0,0,0,-7000,14000,21000,-7000,0,0,0,-7000
06780P,義隆元大98售02  ,0,0,0,0,0,0,0,0,0,-7000,0,0,0,20000,27000,-7000,-7000
2495,普安            ,43000,51000,-8000,0,0,0,0,0,0,1000,1000,0,1000,0,0,0,-7000
6206,飛捷            ,62000,60000,2000,0,0,0,0,0,0,-9000,1000,10000,-9000,0,0,0,-7000
057080,華新科統一99購02,0,0,0,0,0,0,0,0,0,-8000,0,0,0,75000,83000,-8000,-8000
057086,立積統一9C購01  ,0,0,0,0,0,0,0,0,0,-8000,0,0,0,0,8000,-8000,-8000
057107,華新科群益98購06,0,0,0,0,0,0,0,0,0,-8000,0,0,0,3000,11000,-8000,-8000
057146,技嘉國票98購01  ,0,0,0,0,0,0,0,0,0,-8000,0,0,0,53000,61000,-8000,-8000
057294,台灣50永豐99購01,0,0,0,0,0,0,0,0,0,-8000,0,0,0,0,8000,-8000,-8000
05731P,創意統一96售03  ,0,0,0,0,0,0,0,0,0,-8000,0,0,0,0,8000,-8000,-8000
056609,楠梓電永豐98購02,0,0,0,0,0,0,0,0,0,-8000,0,0,0,2000,10000,-8000,-8000
056621,宏達電永豐98購01,0,0,0,0,0,0,0,0,0,-8000,0,0,0,36000,44000,-8000,-8000
056503,楠梓電永豐98購01,0,0,0,0,0,0,0,0,0,-8000,0,0,0,2000,10000,-8000,-8000
056789,和碩群益98購01  ,0,0,0,0,0,0,0,0,0,-8000,0,0,0,43000,51000,-8000,-8000
057991,健策統一9C購01  ,0,0,0,0,0,0,0,0,0,-8000,0,0,0,10000,18000,-8000,-8000
058508,聯發科元大99購11,0,0,0,0,0,0,0,0,0,-8000,0,0,0,239000,247000,-8000,-8000
06050P,玉晶光國票98售01,0,0,0,0,0,0,0,0,0,-8000,0,0,0,29000,37000,-8000,-8000
058602,台積電元大99購11,0,0,0,0,0,0,0,0,0,-8000,0,0,0,147000,155000,-8000,-8000
00714,群益道瓊美國地產,0,169000,-169000,0,0,0,0,0,0,161000,0,0,0,201000,40000,161000,-8000
049605,旺宏第一94購01  ,0,0,0,0,0,0,0,0,0,-8000,0,0,0,3000,11000,-8000,-8000
044784,華邦電中信96購01,0,0,0,0,0,0,0,0,0,-8000,0,0,0,2000,10000,-8000,-8000
047659,大立光麥證93購01,0,0,0,2000,10000,-8000,0,0,0,-8000,0,0,0,2000,10000,-8000,-8000
047634,亞德客元大93購01,0,0,0,0,0,0,0,0,0,-8000,0,0,0,0,8000,-8000,-8000
050023,國巨元大94購12  ,0,0,0,0,0,0,0,0,0,-8000,0,0,0,2000,10000,-8000,-8000
048700,和鑫國票95購01  ,0,0,0,0,0,0,0,0,0,-8000,0,0,0,0,8000,-8000,-8000
048909,聯詠富邦94購01  ,0,0,0,0,0,0,0,0,0,-8000,0,0,0,12000,20000,-8000,-8000
052557,群創國票97購02  ,0,0,0,0,0,0,0,0,0,-8000,0,0,0,8000,16000,-8000,-8000
051570,和碩富邦97購01  ,0,0,0,0,0,0,0,0,0,-8000,0,0,0,12000,20000,-8000,-8000
05165P,欣興元富95售03  ,0,0,0,0,0,0,0,0,0,-8000,0,0,0,104000,112000,-8000,-8000
051699,世紀鋼麥證95購01,0,0,0,1000,9000,-8000,0,0,0,-8000,0,0,0,1000,9000,-8000,-8000
052319,可成元大95購12  ,0,0,0,0,0,0,0,0,0,-8000,0,0,0,27000,35000,-8000,-8000
052290,鴻海元富97購01  ,0,0,0,0,0,0,0,0,0,-8000,0,0,0,20000,28000,-8000,-8000
053492,華邦電兆豐97購01,0,0,0,0,0,0,0,0,0,-8000,0,0,0,40000,48000,-8000,-8000
053102,祥碩元富96購01  ,0,0,0,0,0,0,0,0,0,-8000,0,0,0,0,8000,-8000,-8000
050516,華通元大95購05  ,0,0,0,0,0,0,0,0,0,-8000,0,0,0,12000,20000,-8000,-8000
055740,智易元富97購01  ,0,0,0,0,0,0,0,0,0,-8000,0,0,0,0,8000,-8000,-8000
055788,緯穎凱基97購04  ,0,0,0,0,0,0,0,0,0,-8000,0,0,0,19000,27000,-8000,-8000
056207,茂林永豐97購03  ,0,0,0,0,0,0,0,0,0,-8000,0,0,0,0,8000,-8000,-8000
055814,晶豪科國票97購02,0,0,0,0,0,0,0,0,0,-8000,0,0,0,23000,31000,-8000,-8000
055892,國巨統一99購01  ,0,0,0,0,0,0,0,0,0,-8000,0,0,0,146000,154000,-8000,-8000
05401P,聯茂永豐95售03  ,0,0,0,0,0,0,0,0,0,-8000,0,0,0,0,8000,-8000,-8000
054082,楠梓電元富96購01,0,0,0,0,0,0,0,0,0,-8000,0,0,0,12000,20000,-8000,-8000
054066,緯穎國票97購03  ,0,0,0,0,0,0,0,0,0,-8000,0,0,0,0,8000,-8000,-8000
054375,貿聯中信99購01  ,0,0,0,0,0,0,0,0,0,-8000,0,0,0,0,8000,-8000,-8000
054143,茂林元大96購04  ,0,0,0,0,0,0,0,0,0,-8000,0,0,0,51000,59000,-8000,-8000
054133,奇力新元大97購04,0,0,0,0,0,0,0,0,0,-8000,0,0,0,0,8000,-8000,-8000
054776,矽創國票98購01  ,0,0,0,0,0,0,0,0,0,-8000,0,0,0,40000,48000,-8000,-8000
054630,聯鈞凱基98購01  ,0,0,0,0,0,0,0,0,0,-8000,0,0,0,34000,42000,-8000,-8000
054973,台郡元大98購02  ,0,0,0,0,0,0,0,0,0,-8000,0,0,0,32000,40000,-8000,-8000
4916,事欣科          ,101900,108900,-7000,0,0,0,0,0,0,-1000,0,1000,-1000,0,0,0,-8000
3305,昇貿            ,29000,37000,-8000,0,0,0,0,0,0,0,1000,1000,0,0,0,0,-8000
06880P,鈺齊凱基98售03  ,0,0,0,0,0,0,0,0,0,-8000,0,0,0,131000,139000,-8000,-8000
1232,大統益          ,19000,28000,-9000,0,0,0,0,0,0,1000,1000,0,1000,0,0,0,-8000
06309P,光罩元富97售03  ,0,0,0,0,0,0,0,0,0,-8000,0,0,0,56000,64000,-8000,-8000
058520,智易元大99購03  ,0,0,0,0,0,0,0,0,0,-9000,0,0,0,7000,16000,-9000,-9000
058402,欣興元大99購04  ,0,0,0,0,0,0,0,0,0,-9000,0,0,0,94000,103000,-9000,-9000
058306,聯發科元大99購07,0,0,0,0,0,0,0,0,0,-9000,0,0,0,209000,218000,-9000,-9000
056766,義隆元大98購01  ,0,0,0,0,0,0,0,0,0,-9000,0,0,0,72000,81000,-9000,-9000
056837,國巨元富98購02  ,0,0,0,0,0,0,0,0,0,-9000,0,0,0,11000,20000,-9000,-9000
052864,奇力新凱基96購02,0,0,0,0,0,0,0,0,0,-9000,0,0,0,1000,10000,-9000,-9000
050007,貿聯永豐94購01  ,0,0,0,0,0,0,0,0,0,-9000,0,0,0,0,9000,-9000,-9000
04933P,中石化中信96售01,0,0,0,0,0,0,0,0,0,-9000,0,0,0,10000,19000,-9000,-9000
048351,旺宏台新94購02  ,0,0,0,0,0,0,0,0,0,-9000,0,0,0,21000,30000,-9000,-9000
047521,台積電元大94購03,0,0,0,0,0,0,0,0,0,-9000,0,0,0,13000,22000,-9000,-9000
048058,大立光國泰95購01,0,0,0,0,0,0,0,0,0,-9000,0,0,0,0,9000,-9000,-9000
044764,聯茂凱基93購03  ,0,0,0,0,0,0,0,0,0,-9000,0,0,0,1000,10000,-9000,-9000
049633,臺股指群益94購06,0,0,0,0,0,0,0,0,0,-9000,0,0,0,0,9000,-9000,-9000
050039,鴻海中信94購03  ,0,0,0,0,0,0,0,0,0,-9000,0,0,0,97000,106000,-9000,-9000
050049,華通群益96購01  ,0,0,0,0,0,0,0,0,0,-9000,0,0,0,28000,37000,-9000,-9000
04749P,臺股指元大94售25,0,0,0,0,0,0,0,0,0,-9000,0,0,0,10000,19000,-9000,-9000
04738P,揚明光永豐94售03,0,0,0,0,0,0,0,0,0,-9000,0,0,0,3000,12000,-9000,-9000
04221P,大立光兆豐93售05,0,0,0,0,0,0,0,0,0,-9000,0,0,0,1000,10000,-9000,-9000
03831P,臺股指中信95售02,0,0,0,0,0,0,0,0,0,-9000,0,0,0,32000,41000,-9000,-9000
050612,台積電元大95購06,0,0,0,0,0,0,0,0,0,-9000,0,0,0,0,9000,-9000,-9000
052025,國巨群益96購01  ,0,0,0,0,0,0,0,0,0,-9000,0,0,0,10000,19000,-9000,-9000
051979,群創凱基97購01  ,0,0,0,0,0,0,0,0,0,-9000,0,0,0,69000,78000,-9000,-9000
050866,景碩永豐95購01  ,0,0,0,0,0,0,0,0,0,-9000,0,0,0,0,9000,-9000,-9000
053104,台表科元富96購02,0,0,0,0,0,0,0,0,0,-9000,0,0,0,0,9000,-9000,-9000
053173,矽格群益97購01  ,0,0,0,0,0,0,0,0,0,-9000,0,0,0,23000,32000,-9000,-9000
052292,緯穎元富95購02  ,0,0,0,0,0,0,0,0,0,-9000,0,0,0,0,9000,-9000,-9000
051769,矽力元大95購01  ,0,0,0,0,0,0,0,0,0,-9000,0,0,0,2000,11000,-9000,-9000
051254,健策元大96購04  ,0,0,0,0,0,0,0,0,0,-9000,0,0,0,142000,151000,-9000,-9000
052180,緯穎元大96購05  ,0,0,0,0,0,0,0,0,0,-9000,0,0,0,38000,47000,-9000,-9000
055095,啟碁群益98購01  ,0,0,0,0,0,0,0,0,0,-9000,0,0,0,0,9000,-9000,-9000
054546,玉晶光中信9B購01,0,0,0,0,0,0,0,0,0,-9000,0,0,0,447000,456000,-9000,-9000
054257,揚明光元大96購02,0,0,0,0,0,0,0,0,0,-9000,0,0,0,1000,10000,-9000,-9000
053892,景碩群益96購02  ,0,0,0,0,0,0,0,0,0,-9000,0,0,0,1000,10000,-9000,-9000
055922,台郡凱基98購03  ,0,0,0,0,0,0,0,0,0,-9000,0,0,0,0,9000,-9000,-9000
056318,鴻海群益98購02  ,0,0,0,0,0,0,0,0,0,-9000,0,0,0,0,9000,-9000,-9000
056425,聯發科日盛9A購01,0,0,0,0,0,0,0,0,0,-9000,0,0,0,2000,11000,-9000,-9000
055638,上銀元富97購01  ,0,0,0,0,0,0,0,0,0,-9000,0,0,0,20000,29000,-9000,-9000
055346,國巨凱基98購02  ,0,0,0,0,0,0,0,0,0,-9000,0,0,0,16000,25000,-9000,-9000
06199P,聯發科元大97售17,0,0,0,0,0,0,0,0,0,-9000,0,0,0,19000,28000,-9000,-9000
1436,華友聯          ,10000,19000,-9000,0,0,0,0,0,0,0,0,0,0,0,0,0,-9000
05680P,聯發科元大96售12,0,0,0,0,0,0,0,0,0,-10000,0,0,0,0,10000,-10000,-10000
056940,嘉聯益元富98購01,0,0,0,0,0,0,0,0,0,-10000,0,0,0,0,10000,-10000,-10000
056946,國巨統一98購05  ,0,0,0,0,0,0,0,0,0,-10000,0,0,0,10000,20000,-10000,-10000
056997,台灣50康和9A購02,0,0,0,0,0,0,0,0,0,-10000,0,0,0,5000,15000,-10000,-10000
056452,亞光凱基98購02  ,0,0,0,0,0,0,0,0,0,-10000,0,0,0,0,10000,-10000,-10000
056568,台表科群益98購01,0,0,0,0,0,0,0,0,0,-10000,0,0,0,0,10000,-10000,-10000
056545,TPK凱基98購02   ,0,0,0,0,0,0,0,0,0,-10000,0,0,0,13000,23000,-10000,-10000
056603,嘉聯益國泰9A購01,0,0,0,0,0,0,0,0,0,-10000,0,0,0,0,10000,-10000,-10000
056703,群創國泰9A購01  ,0,0,0,0,0,0,0,0,0,-10000,0,0,0,0,10000,-10000,-10000
057320,玉晶光凱基98購01,0,0,0,0,0,0,0,0,0,-10000,0,0,0,2000,12000,-10000,-10000
057337,聯發科國票99購02,0,0,0,0,0,0,0,0,0,-10000,0,0,0,0,10000,-10000,-10000
057347,國巨統一9A購03  ,0,0,0,0,0,0,0,0,0,-10000,0,0,0,50000,60000,-10000,-10000
057314,全新麥證98購01  ,0,0,0,0,10000,-10000,0,0,0,-10000,0,0,0,0,10000,-10000,-10000
057301,嘉聯益永豐98購02,0,0,0,0,0,0,0,0,0,-10000,0,0,0,0,10000,-10000,-10000
057252,牧德元富98購01  ,0,0,0,0,0,0,0,0,0,-10000,0,0,0,0,10000,-10000,-10000
057278,可成元大98購06  ,0,0,0,0,0,0,0,0,0,-10000,0,0,0,68000,78000,-10000,-10000
057154,易華電國泰99購01,0,0,0,0,0,0,0,0,0,-10000,0,0,0,20000,30000,-10000,-10000
057100,國巨中信9A購02  ,0,0,0,0,0,0,0,0,0,-10000,0,0,0,0,10000,-10000,-10000
057131,奇力新凱基98購05,0,0,0,0,0,0,0,0,0,-10000,0,0,0,0,10000,-10000,-10000
057090,奇力新元富98購02,0,0,0,0,0,0,0,0,0,-10000,0,0,0,0,10000,-10000,-10000
057544,鴻海凱基02購01  ,0,0,0,0,0,0,0,0,0,-10000,0,0,0,68000,78000,-10000,-10000
05754P,臺股指中信99售03,0,0,0,0,0,0,0,0,0,-10000,0,0,0,9000,19000,-10000,-10000
05757P,旺宏永豐96售03  ,0,0,0,0,0,0,0,0,0,-10000,0,0,0,13000,23000,-10000,-10000
057381,微星國泰9A購01  ,0,0,0,0,0,0,0,0,0,-10000,0,0,0,30000,40000,-10000,-10000
057445,華通元富02購01  ,0,0,0,0,0,0,0,0,0,-10000,0,0,0,0,10000,-10000,-10000
058353,國巨凱基99購09  ,0,0,0,0,0,0,0,0,0,-10000,0,0,0,10000,20000,-10000,-10000
058438,大立光統一9B購01,0,0,0,0,0,0,0,0,0,-10000,0,0,0,0,10000,-10000,-10000
058414,大立光兆豐99購02,0,0,0,0,0,0,0,0,0,-10000,0,0,0,0,10000,-10000,-10000
058473,上銀凱基9A購03  ,0,0,0,0,0,0,0,0,0,-10000,0,0,0,0,10000,-10000,-10000
05846P,大立光元大96售07,0,0,0,0,0,0,0,0,0,-10000,0,0,0,400000,410000,-10000,-10000
058560,T50反1凱基9A購04,0,0,0,0,0,0,0,0,0,-10000,0,0,0,0,10000,-10000,-10000
058590,南電中信9A購02  ,0,0,0,0,0,0,0,0,0,-10000,0,0,0,0,10000,-10000,-10000
058625,旺宏國票9A購01  ,0,0,0,0,0,0,0,0,0,-10000,0,0,0,0,10000,-10000,-10000
058630,日月光國票9A購01,0,0,0,0,0,0,0,0,0,-10000,0,0,0,0,10000,-10000,-10000
058641,鴻海麥證99購02  ,0,0,0,18000,44000,-26000,0,0,0,-10000,0,0,0,52000,62000,-10000,-10000
058671,旺宏群益9A購01  ,0,0,0,0,0,0,0,0,0,-10000,0,0,0,23000,33000,-10000,-10000
05870P,聯發科凱基96售19,0,0,0,0,0,0,0,0,0,-10000,0,0,0,0,10000,-10000,-10000
05952P,台積電國票97售06,0,0,0,0,0,0,0,0,0,-10000,0,0,0,0,10000,-10000,-10000
05965P,健策凱基96售05  ,0,0,0,0,0,0,0,0,0,-10000,0,0,0,10000,20000,-10000,-10000
05938P,旺宏凱基96售07  ,0,0,0,0,0,0,0,0,0,-10000,0,0,0,0,10000,-10000,-10000
058018,南亞科凱基99購03,0,0,0,0,0,0,0,0,0,-10000,0,0,0,0,10000,-10000,-10000
058113,百和元富98購01  ,0,0,0,0,0,0,0,0,0,-10000,0,0,0,0,10000,-10000,-10000
058077,超眾凱基98購02  ,0,0,0,0,0,0,0,0,0,-10000,0,0,0,0,10000,-10000,-10000
057841,茂林富邦9A購02  ,0,0,0,0,0,0,0,0,0,-10000,0,0,0,0,10000,-10000,-10000
057864,奇力新凱基99購03,0,0,0,0,0,0,0,0,0,-10000,0,0,0,30000,40000,-10000,-10000
057866,玉山金凱基98購01,0,0,0,0,0,0,0,0,0,-10000,0,0,0,73000,83000,-10000,-10000
057839,台積電富邦9A購02,0,0,0,0,0,0,0,0,0,-10000,0,0,0,10000,20000,-10000,-10000
057899,台積電永豐98購04,0,0,0,0,0,0,0,0,0,-10000,0,0,0,5000,15000,-10000,-10000
057696,聯電群益9A購01  ,0,0,0,0,0,0,0,0,0,-10000,0,0,0,12000,22000,-10000,-10000
057689,南亞科凱基99購02,0,0,0,0,0,0,0,0,0,-10000,0,0,0,0,10000,-10000,-10000
057701,嘉聯益群益98購02,0,0,0,0,0,0,0,0,0,-10000,0,0,0,0,10000,-10000,-10000
057719,欣興元富02購01  ,0,0,0,0,0,0,0,0,0,-10000,0,0,0,0,10000,-10000,-10000
057726,華通國泰9A購01  ,0,0,0,0,0,0,0,0,0,-10000,0,0,0,38000,48000,-10000,-10000
057728,瑞昱國泰99購01  ,0,0,0,0,0,0,0,0,0,-10000,0,0,0,0,10000,-10000,-10000
046202,台表科凱基93購04,0,0,0,0,0,0,0,0,0,-10000,0,0,0,0,10000,-10000,-10000
046379,奇力新凱基93購03,0,0,0,0,0,0,0,0,0,-10000,0,0,0,20000,30000,-10000,-10000
046528,聯詠中信94購01  ,0,0,0,0,0,0,0,0,0,-10000,0,0,0,58000,68000,-10000,-10000
046648,和鑫國泰94購01  ,0,0,0,0,0,0,0,0,0,-10000,0,0,0,0,10000,-10000,-10000
044407,聯茂凱基93購01  ,0,0,0,0,0,0,0,0,0,-10000,0,0,0,0,10000,-10000,-10000
044105,聯詠中信95購01  ,0,0,0,0,0,0,0,0,0,-10000,0,0,0,68000,78000,-10000,-10000
044265,滬深2X中信95購05,0,0,0,0,0,0,0,0,0,-10000,0,0,0,0,10000,-10000,-10000
044216,華新科凱基93購02,0,0,0,0,0,0,0,0,0,-10000,0,0,0,0,10000,-10000,-10000
042088,台灣50中信93購04,0,0,0,0,0,0,0,0,0,-10000,0,0,0,10000,20000,-10000,-10000
042516,健策凱基93購01  ,0,0,0,0,0,0,0,0,0,-10000,0,0,0,0,10000,-10000,-10000
042527,台灣50永豐94購01,0,0,0,0,0,0,0,0,0,-10000,0,0,0,0,10000,-10000,-10000
041528,國泰金中信93購01,0,0,0,0,0,0,0,0,0,-10000,0,0,0,10000,20000,-10000,-10000
04193P,智原永豐93售01  ,0,0,0,0,0,0,0,0,0,-10000,0,0,0,0,10000,-10000,-10000
042904,金寶元大94購02  ,0,0,0,0,0,0,0,0,0,-10000,0,0,0,0,10000,-10000,-10000
03492P,創意元大02售03  ,0,0,0,0,0,0,0,0,0,-10000,0,0,0,0,10000,-10000,-10000
03564P,為升群益02售02  ,0,0,0,0,0,0,0,0,0,-10000,0,0,0,0,10000,-10000,-10000
00776,新光ICE美國權值 ,0,0,0,0,0,0,0,0,0,-10000,0,0,0,0,10000,-10000,-10000
00753L,中信中國50正2   ,0,0,0,0,0,0,0,0,0,-10000,0,0,0,81000,91000,-10000,-10000
04731P,臺股指中信96售03,0,0,0,0,0,0,0,0,0,-10000,0,0,0,40000,50000,-10000,-10000
047211,華新科富邦99購01,0,0,0,0,0,0,0,0,0,-10000,0,0,0,10000,20000,-10000,-10000
048222,台積電凱基93購26,0,0,0,0,0,0,0,0,0,-10000,0,0,0,10000,20000,-10000,-10000
049293,友訊群益95購01  ,0,0,0,0,0,0,0,0,0,-10000,0,0,0,28000,38000,-10000,-10000
049242,佳世達元富96購01,0,0,0,0,0,0,0,0,0,-10000,0,0,0,0,10000,-10000,-10000
04927P,大立光凱基95售06,0,0,0,0,0,0,0,0,0,-10000,0,0,0,31000,41000,-10000,-10000
049281,嘉聯益國票95購01,0,0,0,0,0,0,0,0,0,-10000,0,0,0,0,10000,-10000,-10000
049268,聯茂元大94購03  ,0,0,0,0,0,0,0,0,0,-10000,0,0,0,0,10000,-10000,-10000
049597,泰鼎元大96購01  ,0,0,0,0,0,0,0,0,0,-10000,0,0,0,1000,11000,-10000,-10000
049641,台達電凱基94購08,0,0,0,0,0,0,0,0,0,-10000,0,0,0,0,10000,-10000,-10000
049587,美律元大95購01  ,0,0,0,0,0,0,0,0,0,-10000,0,0,0,10000,20000,-10000,-10000
049525,華新科兆豐94購01,0,0,0,0,0,0,0,0,0,-10000,0,0,0,0,10000,-10000,-10000
044964,旺宏中信94購01  ,0,0,0,0,0,0,0,0,0,-10000,0,0,0,0,10000,-10000,-10000
044567,華通凱基93購03  ,0,0,0,0,0,0,0,0,0,-10000,0,0,0,0,10000,-10000,-10000
044705,群創元大93購03  ,0,0,0,0,0,0,0,0,0,-10000,0,0,0,0,10000,-10000,-10000
04529P,正文凱基94售04  ,0,0,0,0,0,0,0,0,0,-10000,0,0,0,0,10000,-10000,-10000
045250,華通凱基94購01  ,0,0,0,0,0,0,0,0,0,-10000,0,0,0,0,10000,-10000,-10000
045437,大立光統一94購02,0,0,0,0,0,0,0,0,0,-10000,0,0,0,0,10000,-10000,-10000
046927,上銀富邦95購01  ,0,0,0,0,0,0,0,0,0,-10000,0,0,0,0,10000,-10000,-10000
046893,華新科群益94購01,0,0,0,0,0,0,0,0,0,-10000,0,0,0,0,10000,-10000,-10000
046797,T50反1元大96購01,0,0,0,0,0,0,0,0,0,-10000,0,0,0,60000,70000,-10000,-10000
045996,南電富邦94購01  ,0,0,0,0,0,0,0,0,0,-10000,0,0,0,0,10000,-10000,-10000
045818,鴻海凱基93購10  ,0,0,0,0,0,0,0,0,0,-10000,0,0,0,10000,20000,-10000,-10000
048051,大立光中信94購03,0,0,0,0,0,0,0,0,0,-10000,0,0,0,3000,13000,-10000,-10000
047942,華新科國票94購04,0,0,0,0,0,0,0,0,0,-10000,0,0,0,0,10000,-10000,-10000
047716,晶技凱基93購03  ,0,0,0,0,0,0,0,0,0,-10000,0,0,0,10000,20000,-10000,-10000
047675,群創元富96購03  ,0,0,0,0,0,0,0,0,0,-10000,0,0,0,6000,16000,-10000,-10000
047699,亞德客凱基93購04,0,0,0,0,0,0,0,0,0,-10000,0,0,0,0,10000,-10000,-10000
047742,友達統一93購04  ,0,0,0,0,0,0,0,0,0,-10000,0,0,0,0,10000,-10000,-10000
049508,上銀凱基94購04  ,0,0,0,0,0,0,0,0,0,-10000,0,0,0,10000,20000,-10000,-10000
047609,奇力新第一93購01,0,0,0,0,0,0,0,0,0,-10000,0,0,0,0,10000,-10000,-10000
047553,大立光凱基93購21,0,0,0,0,0,0,0,0,0,-10000,0,0,0,0,10000,-10000,-10000
048546,廣越永豐93購01  ,0,0,0,0,0,0,0,0,0,-10000,0,0,0,0,10000,-10000,-10000
048441,台積電凱基93購29,0,0,0,0,0,0,0,0,0,-10000,0,0,0,100000,110000,-10000,-10000
048462,南電凱基93購06  ,0,0,0,0,0,0,0,0,0,-10000,0,0,0,20000,30000,-10000,-10000
04846P,旺宏凱基94售07  ,0,0,0,0,0,0,0,0,0,-10000,0,0,0,0,10000,-10000,-10000
048389,國巨國票94購01  ,0,0,0,0,0,0,0,0,0,-10000,0,0,0,0,10000,-10000,-10000
049363,旺宏元大94購07  ,0,0,0,0,0,0,0,0,0,-10000,0,0,0,0,10000,-10000,-10000
049359,台達電元大94購06,0,0,0,0,0,0,0,0,0,-10000,0,0,0,0,10000,-10000,-10000
049377,聯詠元大94購01  ,0,0,0,0,0,0,0,0,0,-10000,0,0,0,14000,24000,-10000,-10000
048299,聯詠麥證93購02  ,0,0,0,0,10000,-10000,0,0,0,-10000,0,0,0,0,10000,-10000,-10000
048305,深100凱基96購01 ,0,0,0,0,0,0,0,0,0,-10000,0,0,0,0,10000,-10000,-10000
048320,聯詠凱基93購08  ,0,0,0,0,0,0,0,0,0,-10000,0,0,0,60000,70000,-10000,-10000
049872,聯發科台新94購03,0,0,0,0,0,0,0,0,0,-10000,0,0,0,0,10000,-10000,-10000
049866,景碩兆豐94購01  ,0,0,0,0,0,0,0,0,0,-10000,0,0,0,0,10000,-10000,-10000
049828,華新科凱基94購06,0,0,0,0,0,0,0,0,0,-10000,0,0,0,20000,30000,-10000,-10000
04989P,國巨元大94售15  ,0,0,0,0,0,0,0,0,0,-10000,0,0,0,0,10000,-10000,-10000
049908,鴻海元大94購08  ,0,0,0,0,0,0,0,0,0,-10000,0,0,0,0,10000,-10000,-10000
049946,智邦兆豐95購01  ,0,0,0,0,0,0,0,0,0,-10000,0,0,0,10000,20000,-10000,-10000
049638,A50反1凱基94購01,0,0,0,0,0,0,0,0,0,-10000,0,0,0,0,10000,-10000,-10000
04965P,日月光元大94售02,0,0,0,0,0,0,0,0,0,-10000,0,0,0,50000,60000,-10000,-10000
049723,緯穎凱基94購04  ,0,0,0,0,0,0,0,0,0,-10000,0,0,0,0,10000,-10000,-10000
052568,漢唐凱基96購02  ,0,0,0,0,0,0,0,0,0,-10000,0,0,0,10000,20000,-10000,-10000
049229,台化富邦94購01  ,0,0,0,0,0,0,0,0,0,-10000,0,0,0,0,10000,-10000,-10000
052658,友達元富9C購01  ,0,0,0,0,0,0,0,0,0,-10000,0,0,0,215000,225000,-10000,-10000
051797,卜蜂永豐95購01  ,0,0,0,0,0,0,0,0,0,-10000,0,0,0,0,10000,-10000,-10000
052652,台虹永豐96購01  ,0,0,0,0,0,0,0,0,0,-10000,0,0,0,5000,15000,-10000,-10000
052670,茂林群益96購02  ,0,0,0,0,0,0,0,0,0,-10000,0,0,0,33000,43000,-10000,-10000
052683,鴻海元大97購03  ,0,0,0,0,0,0,0,0,0,-10000,0,0,0,0,10000,-10000,-10000
052817,楠梓電永豐96購02,0,0,0,0,0,0,0,0,0,-10000,0,0,0,0,10000,-10000,-10000
052824,揚明光永豐96購02,0,0,0,0,0,0,0,0,0,-10000,0,0,0,0,10000,-10000,-10000
052803,冠德元大96購01  ,0,0,0,0,0,0,0,0,0,-10000,0,0,0,0,10000,-10000,-10000
052797,樺漢兆豐96購01  ,0,0,0,0,0,0,0,0,0,-10000,0,0,0,0,10000,-10000,-10000
052784,緯穎國票97購02  ,0,0,0,0,0,0,0,0,0,-10000,0,0,0,13000,23000,-10000,-10000
048986,訊連元大94購01  ,0,0,0,0,0,0,0,0,0,-10000,0,0,0,0,10000,-10000,-10000
048944,茂林永豐94購01  ,0,0,0,0,0,0,0,0,0,-10000,0,0,0,0,10000,-10000,-10000
04908P,南電國票95售03  ,0,0,0,0,0,0,0,0,0,-10000,0,0,0,40000,50000,-10000,-10000
049189,訊芯康和94購01  ,0,0,0,0,0,0,0,0,0,-10000,0,0,0,0,10000,-10000,-10000
049196,奇力新永豐94購02,0,0,0,0,0,0,0,0,0,-10000,0,0,0,0,10000,-10000,-10000
049174,台積電凱基94購11,0,0,0,0,0,0,0,0,0,-10000,0,0,0,0,10000,-10000,-10000
049149,華新科元大95購03,0,0,0,0,0,0,0,0,0,-10000,0,0,0,0,10000,-10000,-10000
048716,力山永豐94購01  ,0,0,0,0,0,0,0,0,0,-10000,0,0,0,0,10000,-10000,-10000
048723,世紀鋼永豐94購02,0,0,0,0,0,0,0,0,0,-10000,0,0,0,0,10000,-10000,-10000
048574,台積電國泰95購02,0,0,0,0,0,0,0,0,0,-10000,0,0,0,0,10000,-10000,-10000
04882P,鴻海凱基94售19  ,0,0,0,0,0,0,0,0,0,-10000,0,0,0,1000,11000,-10000,-10000
048841,聯茂凱基94購06  ,0,0,0,0,0,0,0,0,0,-10000,0,0,0,10000,20000,-10000,-10000
048790,大立光元大95購05,0,0,0,0,0,0,0,0,0,-10000,0,0,0,0,10000,-10000,-10000
048797,美律國泰95購02  ,0,0,0,0,0,0,0,0,0,-10000,0,0,0,0,10000,-10000,-10000
048811,鴻海日盛94購01  ,0,0,0,0,0,0,0,0,0,-10000,0,0,0,30000,40000,-10000,-10000
048752,廣越元富95購01  ,0,0,0,0,0,0,0,0,0,-10000,0,0,0,0,10000,-10000,-10000
048783,國巨元大94購01  ,0,0,0,0,0,0,0,0,0,-10000,0,0,0,0,10000,-10000,-10000
048768,景碩凱基94購02  ,0,0,0,0,0,0,0,0,0,-10000,0,0,0,0,10000,-10000,-10000
048763,台積電凱基94購03,0,0,0,0,0,0,0,0,0,-10000,0,0,0,0,10000,-10000,-10000
052169,鴻海元大97購02  ,0,0,0,0,0,0,0,0,0,-10000,0,0,0,0,10000,-10000,-10000
050422,鴻海凱基96購01  ,0,0,0,0,0,0,0,0,0,-10000,0,0,0,0,10000,-10000,-10000
051403,玉晶光永豐95購05,0,0,0,0,0,0,0,0,0,-10000,0,0,0,3000,13000,-10000,-10000
050468,矽格中信94購01  ,0,0,0,0,0,0,0,0,0,-10000,0,0,0,0,10000,-10000,-10000
050388,鴻海統一94購09  ,0,0,0,0,0,0,0,0,0,-10000,0,0,0,0,10000,-10000,-10000
050351,華新科群益95購02,0,0,0,0,0,0,0,0,0,-10000,0,0,0,50000,60000,-10000,-10000
050348,鴻海群益94購06  ,0,0,0,0,0,0,0,0,0,-10000,0,0,0,41000,51000,-10000,-10000
052164,啟碁永豐95購01  ,0,0,0,0,0,0,0,0,0,-10000,0,0,0,0,10000,-10000,-10000
052132,旺宏凱基9B購01  ,0,0,0,0,0,0,0,0,0,-10000,0,0,0,3000,13000,-10000,-10000
051786,A50正2國票95購02,0,0,0,0,0,0,0,0,0,-10000,0,0,0,5000,15000,-10000,-10000
051777,聯發科群益95購04,0,0,0,0,0,0,0,0,0,-10000,0,0,0,10000,20000,-10000,-10000
051690,超眾凱基95購03  ,0,0,0,0,0,0,0,0,0,-10000,0,0,0,0,10000,-10000,-10000
051682,元黃金凱基97購01,0,0,0,0,0,0,0,0,0,-10000,0,0,0,0,10000,-10000,-10000
051725,緯穎永豐95購02  ,0,0,0,0,0,0,0,0,0,-10000,0,0,0,12000,22000,-10000,-10000
052070,GIS兆豐95購03   ,0,0,0,0,0,0,0,0,0,-10000,0,0,0,0,10000,-10000,-10000
053065,大立光群益96購01,0,0,0,0,0,0,0,0,0,-10000,0,0,0,0,10000,-10000,-10000
052056,緯穎凱基95購04  ,0,0,0,0,0,0,0,0,0,-10000,0,0,0,0,10000,-10000,-10000
051653,南電永豐95購02  ,0,0,0,0,0,0,0,0,0,-10000,0,0,0,0,10000,-10000,-10000
05158P,華通永豐95售01  ,0,0,0,0,0,0,0,0,0,-10000,0,0,0,0,10000,-10000,-10000
051512,超眾麥證95購01  ,0,0,0,20000,30000,-10000,0,0,0,-10000,0,0,0,20000,30000,-10000,-10000
051508,元黃金中信97購01,0,0,0,0,0,0,0,0,0,-10000,0,0,0,0,10000,-10000,-10000
051497,中磊亞東96購01  ,0,0,0,0,0,0,0,0,0,-10000,0,0,0,0,10000,-10000,-10000
051486,玉晶光凱基97購03,0,0,0,0,0,0,0,0,0,-10000,0,0,0,2000,12000,-10000,-10000
051540,力成國票95購01  ,0,0,0,0,0,0,0,0,0,-10000,0,0,0,0,10000,-10000,-10000
051555,聯茂永豐95購01  ,0,0,0,0,0,0,0,0,0,-10000,0,0,0,10000,20000,-10000,-10000
052279,旺宏凱基95購07  ,0,0,0,0,0,0,0,0,0,-10000,0,0,0,0,10000,-10000,-10000
052363,廣達國票96購01  ,0,0,0,0,0,0,0,0,0,-10000,0,0,0,0,10000,-10000,-10000
052373,鴻海元大95購22  ,0,0,0,0,0,0,0,0,0,-10000,0,0,0,100000,110000,-10000,-10000
05241P,鴻海國泰97售04  ,0,0,0,0,0,0,0,0,0,-10000,0,0,0,110000,120000,-10000,-10000
052405,聯茂凱基95購01  ,0,0,0,0,0,0,0,0,0,-10000,0,0,0,0,10000,-10000,-10000
052487,國巨國票96購07  ,0,0,0,0,0,0,0,0,0,-10000,0,0,0,0,10000,-10000,-10000
052499,合勤控永豐95購01,0,0,0,0,0,0,0,0,0,-10000,0,0,0,0,10000,-10000,-10000
053618,新唐群益96購01  ,0,0,0,0,0,0,0,0,0,-10000,0,0,0,0,10000,-10000,-10000
053494,南亞科兆豐96購02,0,0,0,0,0,0,0,0,0,-10000,0,0,0,3000,13000,-10000,-10000
053498,大立光兆豐96購03,0,0,0,0,0,0,0,0,0,-10000,0,0,0,0,10000,-10000,-10000
053557,聯茂凱基96購04  ,0,0,0,0,0,0,0,0,0,-10000,0,0,0,0,10000,-10000,-10000
053540,健策永豐96購01  ,0,0,0,0,0,0,0,0,0,-10000,0,0,0,68000,78000,-10000,-10000
053584,友達元大9B購02  ,0,0,0,0,0,0,0,0,0,-10000,0,0,0,0,10000,-10000,-10000
053714,南亞科凱基96購03,0,0,0,0,0,0,0,0,0,-10000,0,0,0,0,10000,-10000,-10000
053730,樺漢凱基98購01  ,0,0,0,0,0,0,0,0,0,-10000,0,0,0,0,10000,-10000,-10000
053353,玉晶光兆豐97購03,0,0,0,0,0,0,0,0,0,-10000,0,0,0,3000,13000,-10000,-10000
05334P,臺股指國票95售03,0,0,0,0,0,0,0,0,0,-10000,0,0,0,0,10000,-10000,-10000
05338P,臺股指國票95售07,0,0,0,0,0,0,0,0,0,-10000,10000,0,10000,20000,40000,-20000,-10000
053397,國泰金中信96購01,0,0,0,0,0,0,0,0,0,-10000,0,0,0,0,10000,-10000,-10000
053484,國巨國票97購03  ,0,0,0,0,0,0,0,0,0,-10000,0,0,0,0,10000,-10000,-10000
053423,亞光永豐96購01  ,0,0,0,0,0,0,0,0,0,-10000,0,0,0,15000,25000,-10000,-10000
053165,大立光群益96購03,0,0,0,0,0,0,0,0,0,-10000,0,0,0,30000,40000,-10000,-10000
053143,昇陽半永豐96購03,0,0,0,0,0,0,0,0,0,-10000,0,0,0,0,10000,-10000,-10000
053094,聯電統一97購02  ,0,0,0,0,0,0,0,0,0,-10000,0,0,0,40000,50000,-10000,-10000
051912,健鼎元大96購01  ,0,0,0,0,0,0,0,0,0,-10000,0,0,0,0,10000,-10000,-10000
051921,南茂元大95購04  ,0,0,0,0,0,0,0,0,0,-10000,0,0,0,0,10000,-10000,-10000
052978,貿聯麥證97購01  ,0,0,0,0,10000,-10000,0,0,0,-10000,0,0,0,0,10000,-10000,-10000
051011,國巨凱基95購03  ,0,0,0,0,0,0,0,0,0,-10000,0,0,0,0,10000,-10000,-10000
051003,中環中信97購01  ,0,0,0,0,0,0,0,0,0,-10000,0,0,0,0,10000,-10000,-10000
051868,貿聯凱基96購01  ,0,0,0,0,0,0,0,0,0,-10000,0,0,0,0,10000,-10000,-10000
05187P,力山凱基95售01  ,0,0,0,0,0,0,0,0,0,-10000,0,0,0,0,10000,-10000,-10000
052706,台虹國票97購01  ,0,0,0,0,0,0,0,0,0,-10000,0,0,0,80000,90000,-10000,-10000
050180,華新科元大95購08,0,0,0,0,0,0,0,0,0,-10000,0,0,0,125000,135000,-10000,-10000
050202,建準群益95購01  ,0,0,0,0,0,0,0,0,0,-10000,0,0,0,0,10000,-10000,-10000
052726,鴻海元富96購03  ,0,0,0,0,0,0,0,0,0,-10000,0,0,0,0,10000,-10000,-10000
052615,鴻海國泰98購01  ,0,0,0,0,0,0,0,0,0,-10000,0,0,0,0,10000,-10000,-10000
050093,國巨永豐94購05  ,0,0,0,0,0,0,0,0,0,-10000,0,0,0,32000,42000,-10000,-10000
050948,華固群益95購01  ,0,0,0,0,0,0,0,0,0,-10000,0,0,0,10000,20000,-10000,-10000
050951,緯創群益96購01  ,0,0,0,0,0,0,0,0,0,-10000,0,0,0,0,10000,-10000,-10000
050975,楠梓電統一95購01,0,0,0,0,0,0,0,0,0,-10000,0,0,0,0,10000,-10000,-10000
050925,可成凱基95購02  ,0,0,0,0,0,0,0,0,0,-10000,0,0,0,0,10000,-10000,-10000
050818,華新科凱基95購02,0,0,0,0,0,0,0,0,0,-10000,0,0,0,25000,35000,-10000,-10000
050822,亞光凱基95購01  ,0,0,0,0,0,0,0,0,0,-10000,0,0,0,0,10000,-10000,-10000
050882,華泰國泰96購01  ,0,0,0,0,0,0,0,0,0,-10000,0,0,0,0,10000,-10000,-10000
050771,華新科元大94購06,0,0,0,0,0,0,0,0,0,-10000,0,0,0,0,10000,-10000,-10000
050787,致伸國泰96購01  ,0,0,0,0,0,0,0,0,0,-10000,0,0,0,0,10000,-10000,-10000
052000,鈺齊元大95購03  ,0,0,0,0,0,0,0,0,0,-10000,0,0,0,0,10000,-10000,-10000
051466,玉晶光富邦97購01,0,0,0,0,0,0,0,0,0,-10000,0,0,0,3000,13000,-10000,-10000
051478,宏達電凱基95購03,0,0,0,0,0,0,0,0,0,-10000,0,0,0,0,10000,-10000,-10000
05145P,道瓊反元大98售01,0,0,0,0,0,0,0,0,0,-10000,0,0,0,0,10000,-10000,-10000
051433,中磊元富95購01  ,0,0,0,0,0,0,0,0,0,-10000,0,0,0,10000,20000,-10000,-10000
050637,欣興國票94購02  ,0,0,0,0,0,0,0,0,0,-10000,0,0,0,0,10000,-10000,-10000
050590,晶技永豐95購01  ,0,0,0,0,0,0,0,0,0,-10000,0,0,0,65000,75000,-10000,-10000
050644,國巨凱基96購01  ,0,0,0,0,0,0,0,0,0,-10000,0,0,0,0,10000,-10000,-10000
050646,美律凱基96購01  ,0,0,0,0,0,0,0,0,0,-10000,0,0,0,0,10000,-10000,-10000
050690,台達電凱基96購01,0,0,0,0,0,0,0,0,0,-10000,0,0,0,0,10000,-10000,-10000
050682,南亞科元富94購02,0,0,0,0,0,0,0,0,0,-10000,0,0,0,0,10000,-10000,-10000
050536,亞泥凱基95購01  ,0,0,0,0,0,0,0,0,0,-10000,0,0,0,10000,20000,-10000,-10000
050575,南亞科國票94購01,0,0,0,0,0,0,0,0,0,-10000,0,0,0,0,10000,-10000,-10000
050550,大立光凱基95購04,0,0,0,0,0,0,0,0,0,-10000,0,0,0,0,10000,-10000,-10000
050552,禾伸堂凱基94購05,0,0,0,0,0,0,0,0,0,-10000,0,0,0,0,10000,-10000,-10000
051157,華新科富邦98購01,0,0,0,0,0,0,0,0,0,-10000,0,0,0,50000,60000,-10000,-10000
051124,創意群益95購01  ,0,0,0,0,0,0,0,0,0,-10000,0,0,0,0,10000,-10000,-10000
050230,聯發科麥證94購02,0,0,0,20000,52000,-32000,0,0,0,-10000,0,0,0,42000,52000,-10000,-10000
050235,國巨凱基94購11  ,0,0,0,0,0,0,0,0,0,-10000,0,0,0,45000,55000,-10000,-10000
050266,兆豐金元大94購01,0,0,0,0,0,0,0,0,0,-10000,0,0,0,0,10000,-10000,-10000
053257,華通富邦97購01  ,0,0,0,0,0,0,0,0,0,-10000,0,0,0,0,10000,-10000,-10000
055329,百和國票98購01  ,0,0,0,0,0,0,0,0,0,-10000,0,0,0,200000,210000,-10000,-10000
055356,大立光凱基97購06,0,0,0,0,0,0,0,0,0,-10000,0,0,0,0,10000,-10000,-10000
055323,貿聯國票98購01  ,0,0,0,0,0,0,0,0,0,-10000,0,0,0,0,10000,-10000,-10000
05533P,滬深2X富邦97售01,0,0,0,0,0,0,0,0,0,-10000,0,0,0,0,10000,-10000,-10000
055373,聯詠元大97購03  ,0,0,0,0,0,0,0,0,0,-10000,0,0,0,15000,25000,-10000,-10000
055436,晶豪科中信99購01,0,0,0,0,0,0,0,0,0,-10000,0,0,0,0,10000,-10000,-10000
055456,上銀富邦99購01  ,0,0,0,0,0,0,0,0,0,-10000,0,0,0,0,10000,-10000,-10000
055467,國巨凱基97購05  ,0,0,0,0,0,0,0,0,0,-10000,0,0,0,19000,29000,-10000,-10000
055191,牧德元富97購01  ,0,0,0,0,0,0,0,0,0,-10000,0,0,0,0,10000,-10000,-10000
05518P,T50反1凱基98售03,0,0,0,0,0,0,0,0,0,-10000,0,0,0,0,10000,-10000,-10000
055204,宏達電中信99購01,0,0,0,0,0,0,0,0,0,-10000,0,0,0,0,10000,-10000,-10000
055550,華邦電凱基97購03,0,0,0,0,0,0,0,0,0,-10000,0,0,0,10000,20000,-10000,-10000
055505,新唐元大97購02  ,0,0,0,0,0,0,0,0,0,-10000,0,0,0,0,10000,-10000,-10000
055519,茂林中信99購01  ,0,0,0,0,0,0,0,0,0,-10000,0,0,0,10000,20000,-10000,-10000
055544,鴻海凱基97購05  ,0,0,0,0,0,0,0,0,0,-10000,0,0,0,0,10000,-10000,-10000
056336,南亞科凱基98購02,0,0,0,0,0,0,0,0,0,-10000,0,0,0,0,10000,-10000,-10000
05636P,國巨永豐96售03  ,0,0,0,0,0,0,0,0,0,-10000,0,0,0,0,10000,-10000,-10000
056196,聯茂富邦98購02  ,0,0,0,0,0,0,0,0,0,-10000,0,0,0,20000,30000,-10000,-10000
056154,宏達電凱基97購03,0,0,0,0,0,0,0,0,0,-10000,0,0,0,10000,20000,-10000,-10000
056273,祥碩統一97購02  ,0,0,0,0,0,0,0,0,0,-10000,0,0,0,0,10000,-10000,-10000
055961,國泰金元大97購01,0,0,0,0,0,0,0,0,0,-10000,0,0,0,68000,78000,-10000,-10000
055794,聯發科國泰99購01,0,0,0,0,0,0,0,0,0,-10000,0,0,0,60000,70000,-10000,-10000
055839,瑞昱元大97購04  ,0,0,0,0,0,0,0,0,0,-10000,0,0,0,0,10000,-10000,-10000
05583P,訊芯凱基96售01  ,0,0,0,0,0,0,0,0,0,-10000,0,0,0,100000,110000,-10000,-10000
055833,華通元大98購05  ,0,0,0,0,0,0,0,0,0,-10000,0,0,0,0,10000,-10000,-10000
055854,群創元大98購04  ,0,0,0,0,0,0,0,0,0,-10000,0,0,0,0,10000,-10000,-10000
056029,國巨麥證98購01  ,0,0,0,0,10000,-10000,0,0,0,-10000,0,0,0,0,10000,-10000,-10000
05605P,嘉聯益元大97售02,0,0,0,0,0,0,0,0,0,-10000,0,0,0,10000,20000,-10000,-10000
056038,可成凱基97購01  ,0,0,0,0,0,0,0,0,0,-10000,0,0,0,0,10000,-10000,-10000
056132,台光電元大97購03,0,0,0,0,0,0,0,0,0,-10000,0,0,0,0,10000,-10000,-10000
053932,華新科統一96購03,0,0,0,0,0,0,0,0,0,-10000,0,0,0,0,10000,-10000,-10000
053829,力成麥證96購01  ,0,0,0,0,10000,-10000,0,0,0,-10000,0,0,0,0,10000,-10000,-10000
053812,台積電群益96購09,0,0,0,0,0,0,0,0,0,-10000,0,0,0,0,10000,-10000,-10000
053792,百和元大96購01  ,0,0,0,0,0,0,0,0,0,-10000,0,0,0,0,10000,-10000,-10000
053987,宏碁亞東96購01  ,0,0,0,0,0,0,0,0,0,-10000,0,0,0,0,10000,-10000,-10000
053989,奇力新兆豐97購01,0,0,0,0,0,0,0,0,0,-10000,0,0,0,48000,58000,-10000,-10000
054145,嘉聯益元大98購01,0,0,0,0,0,0,0,0,0,-10000,0,0,0,0,10000,-10000,-10000
054142,致伸元大97購01  ,0,0,0,0,0,0,0,0,0,-10000,0,0,0,0,10000,-10000,-10000
054373,富邦金中信97購01,0,0,0,0,0,0,0,0,0,-10000,0,0,0,0,10000,-10000,-10000
054310,牧德凱基98購01  ,0,0,0,0,0,0,0,0,0,-10000,0,0,0,20000,30000,-10000,-10000
054550,旺宏凱基98購02  ,0,0,0,0,0,0,0,0,0,-10000,0,0,0,0,10000,-10000,-10000
054519,禾伸堂元大97購02,0,0,0,0,0,0,0,0,0,-10000,0,0,0,13000,23000,-10000,-10000
054480,和碩中信98購01  ,0,0,0,0,0,0,0,0,0,-10000,0,0,0,0,10000,-10000,-10000
054631,台郡凱基98購02  ,0,0,0,0,0,0,0,0,0,-10000,0,0,0,0,10000,-10000,-10000
054654,全新麥證99購01  ,0,0,0,0,10000,-10000,0,0,0,-10000,0,0,0,0,10000,-10000,-10000
054592,美律永昌9A購01  ,0,0,0,0,0,0,0,0,0,-10000,0,0,0,0,10000,-10000,-10000
054782,國巨群益97購01  ,0,0,0,0,0,0,0,0,0,-10000,0,0,0,160000,170000,-10000,-10000
054750,聯茂凱基98購02  ,0,0,0,0,0,0,0,0,0,-10000,0,0,0,0,10000,-10000,-10000
054727,台積電日盛97購02,0,0,0,0,0,0,0,0,0,-10000,0,0,0,80000,90000,-10000,-10000
054735,漢唐凱基98購01  ,0,0,0,0,0,0,0,0,0,-10000,0,0,0,0,10000,-10000,-10000
054736,南亞科凱基98購01,0,0,0,0,0,0,0,0,0,-10000,0,0,0,0,10000,-10000,-10000
055111,宏盛凱基97購01  ,0,0,0,0,0,0,0,0,0,-10000,0,0,0,0,10000,-10000,-10000
05514P,康舒永豐96售01  ,0,0,0,0,0,0,0,0,0,-10000,0,0,0,0,10000,-10000,-10000
055078,亞泥中信98購01  ,0,0,0,0,0,0,0,0,0,-10000,0,0,0,0,10000,-10000,-10000
055015,帆宣元富97購01  ,0,0,0,0,0,0,0,0,0,-10000,0,0,0,0,10000,-10000,-10000
054998,玉晶光元富97購02,0,0,0,0,0,0,0,0,0,-10000,0,0,0,10000,20000,-10000,-10000
054986,藍天元富97購01  ,0,0,0,0,0,0,0,0,0,-10000,0,0,0,0,10000,-10000,-10000
054977,SP黃豆元富9B購01,0,0,0,0,0,0,0,0,0,-10000,0,0,0,0,10000,-10000,-10000
054936,鴻海元大97購10  ,0,0,0,0,0,0,0,0,0,-10000,0,0,0,68000,78000,-10000,-10000
054927,帆宣凱基97購01  ,0,0,0,0,0,0,0,0,0,-10000,0,0,0,0,10000,-10000,-10000
054920,智原凱基98購01  ,0,0,0,0,0,0,0,0,0,-10000,0,0,0,0,10000,-10000,-10000
054879,大成鋼統一97購01,0,0,0,0,0,0,0,0,0,-10000,0,0,0,0,10000,-10000,-10000
054910,信錦凱基97購01  ,0,0,0,0,0,0,0,0,0,-10000,0,0,0,0,10000,-10000,-10000
054898,台肥康和97購01  ,0,0,0,0,0,0,0,0,0,-10000,0,0,0,0,10000,-10000,-10000
054917,聯發科凱基98購05,0,0,0,0,0,0,0,0,0,-10000,0,0,0,0,10000,-10000,-10000
05481P,鴻海凱基95售21  ,0,0,0,0,0,0,0,0,0,-10000,0,0,0,54000,64000,-10000,-10000
054852,奇鋐國票98購01  ,0,0,0,0,0,0,0,0,0,-10000,0,0,0,0,10000,-10000,-10000
07067P,旺宏台新99售02  ,0,0,0,0,0,0,0,0,0,-10000,0,0,0,0,10000,-10000,-10000
07051P,大立光中信99售02,0,0,0,0,0,0,0,0,0,-10000,0,0,0,0,10000,-10000,-10000
07002P,鴻海兆豐99售04  ,0,0,0,0,0,0,0,0,0,-10000,0,0,0,0,10000,-10000,-10000
06913P,聯發科元大98售14,0,0,0,0,0,0,0,0,0,-10000,0,0,0,10000,20000,-10000,-10000
06929P,鴻海元大99售11  ,0,0,0,0,0,0,0,0,0,-10000,0,0,0,5000,15000,-10000,-10000
06101P,聯發科日盛97售03,0,0,0,0,0,0,0,0,0,-10000,0,0,0,0,10000,-10000,-10000
06103P,漢唐凱基97售02  ,0,0,0,0,0,0,0,0,0,-10000,0,0,0,0,10000,-10000,-10000
06088P,建準永豐97售01  ,0,0,0,0,0,0,0,0,0,-10000,0,0,0,70000,80000,-10000,-10000
06095P,燿華永豐97售01  ,0,0,0,0,0,0,0,0,0,-10000,0,0,0,0,10000,-10000,-10000
06230P,亞德客永豐97售03,0,0,0,0,0,0,0,0,0,-10000,0,0,0,0,10000,-10000,-10000
06240P,奇力新元富97售03,0,0,0,0,0,0,0,0,0,-10000,0,0,0,70000,80000,-10000,-10000
06348P,鈺齊元富97售02  ,0,0,0,0,0,0,0,0,0,-10000,0,0,0,0,10000,-10000,-10000
06688P,鴻海中信02售01  ,0,0,0,0,0,0,0,0,0,-10000,0,0,0,0,10000,-10000,-10000
06456P,聯發科統一98售03,0,0,0,0,0,0,0,0,0,-10000,0,0,0,30000,40000,-10000,-10000
06477P,緯穎國票99售02  ,0,0,0,0,0,0,0,0,0,-10000,0,0,0,10000,20000,-10000,-10000
3055,蔚華科          ,53000,63000,-10000,0,0,0,0,0,0,0,0,0,0,0,0,0,-10000
3617,碩天            ,81000,89000,-8000,0,0,0,0,0,0,-2000,3000,5000,-2000,0,0,0,-10000
2466,冠西電          ,13000,22000,-9000,0,0,0,0,0,0,-1000,0,1000,-1000,0,0,0,-10000
4737,華廣            ,20000,30000,-10000,0,0,0,0,0,0,0,0,0,0,0,0,0,-10000
6155,鈞寶            ,183000,193000,-10000,0,0,0,0,0,0,0,6000,6000,0,0,0,0,-10000
057739,新日興富邦9B購01,0,0,0,0,0,0,0,0,0,-11000,0,0,0,10000,21000,-11000,-11000
057775,南亞科群益98購02,0,0,0,0,0,0,0,0,0,-11000,0,0,0,0,11000,-11000,-11000
057887,智原群益98購04  ,0,0,0,0,0,0,0,0,0,-11000,0,0,0,0,11000,-11000,-11000
058283,世紀鋼中信99購01,0,0,0,0,0,0,0,0,0,-11000,0,0,0,239000,250000,-11000,-11000
058600,國巨元大99購15  ,0,0,0,0,0,0,0,0,0,-11000,0,0,0,0,11000,-11000,-11000
058347,玉晶光群益9B購01,0,0,0,0,0,0,0,0,0,-11000,0,0,0,8000,19000,-11000,-11000
058304,鴻海元大99購12  ,0,0,0,0,0,0,0,0,0,-11000,0,0,0,57000,68000,-11000,-11000
057326,景碩群益99購02  ,0,0,0,0,0,0,0,0,0,-11000,0,0,0,0,11000,-11000,-11000
056707,鴻海富邦99購03  ,0,0,0,0,0,0,0,0,0,-11000,0,0,0,16000,27000,-11000,-11000
056524,欣興中信98購02  ,0,0,0,0,0,0,0,0,0,-11000,0,0,0,90000,101000,-11000,-11000
056564,亞光群益98購02  ,0,0,0,0,0,0,0,0,0,-11000,0,0,0,0,11000,-11000,-11000
056968,揚明光永豐98購02,0,0,0,0,0,0,0,0,0,-11000,0,0,0,68000,79000,-11000,-11000
056981,全新群益99購03  ,0,0,0,0,0,0,0,0,0,-11000,0,0,0,0,11000,-11000,-11000
056833,和大元富9B購01  ,0,0,0,0,0,0,0,0,0,-11000,0,0,0,120000,131000,-11000,-11000
048939,華擎永豐94購01  ,0,0,0,0,0,0,0,0,0,-11000,0,0,0,0,11000,-11000,-11000
052677,景碩富邦97購01  ,0,0,0,0,0,0,0,0,0,-11000,0,0,0,30000,41000,-11000,-11000
052667,漢唐群益96購01  ,0,0,0,0,0,0,0,0,0,-11000,0,0,0,0,11000,-11000,-11000
052891,台泥群益96購01  ,0,0,0,0,0,0,0,0,0,-11000,0,0,0,0,11000,-11000,-11000
04963P,鴻海元大94售25  ,0,0,0,0,0,0,0,0,0,-11000,0,0,0,153000,164000,-11000,-11000
049426,為升兆豐95購01  ,0,0,0,0,0,0,0,0,0,-11000,0,0,0,0,11000,-11000,-11000
049478,祥碩永豐94購02  ,0,0,0,0,0,0,0,0,0,-11000,0,0,0,0,11000,-11000,-11000
04598P,光罩凱基94售03  ,0,0,0,0,0,0,0,0,0,-11000,0,0,0,0,11000,-11000,-11000
04685P,訊芯元大94售02  ,0,0,0,0,0,0,0,0,0,-11000,0,0,0,17000,28000,-11000,-11000
045449,嘉聯益國泰94購01,0,0,0,0,0,0,0,0,0,-11000,0,0,0,0,11000,-11000,-11000
04479P,同欣電中信96售02,0,0,0,0,0,0,0,0,0,-11000,0,0,0,0,11000,-11000,-11000
048262,台積電元富94購01,0,0,0,0,0,0,0,0,0,-11000,0,0,0,0,11000,-11000,-11000
053256,上銀富邦98購01  ,0,0,0,0,0,0,0,0,0,-11000,0,0,0,5000,16000,-11000,-11000
051095,貿聯元大95購03  ,0,0,0,0,0,0,0,0,0,-11000,0,0,0,12000,23000,-11000,-11000
05107P,鴻海兆豐96售02  ,0,0,0,0,0,0,0,0,0,-11000,0,0,0,0,11000,-11000,-11000
052029,矽力群益95購02  ,0,0,0,0,0,0,0,0,0,-11000,0,0,0,0,11000,-11000,-11000
050946,瑞昱群益95購01  ,0,0,0,0,0,0,0,0,0,-11000,0,0,0,0,11000,-11000,-11000
051858,上銀凱基95購01  ,0,0,0,0,0,0,0,0,0,-11000,0,0,0,80000,91000,-11000,-11000
051943,台積電麥證95購03,0,0,0,10000,21000,-11000,0,0,0,-11000,0,0,0,10000,21000,-11000,-11000
053580,國巨元大96購10  ,0,0,0,0,0,0,0,0,0,-11000,0,0,0,97000,108000,-11000,-11000
052483,超眾群益95購03  ,0,0,0,0,0,0,0,0,0,-11000,0,0,0,0,11000,-11000,-11000
051587,大立光元大95購08,0,0,0,0,0,0,0,0,0,-11000,0,0,0,0,11000,-11000,-11000
051705,富邦金群益97購01,0,0,0,0,0,0,0,0,0,-11000,0,0,0,0,11000,-11000,-11000
054896,聯茂日盛97購01  ,0,0,0,0,0,0,0,0,0,-11000,0,0,0,0,11000,-11000,-11000
055139,欣興永豐97購01  ,0,0,0,0,0,0,0,0,0,-11000,0,0,0,0,11000,-11000,-11000
054817,聯發科元大97購13,0,0,0,0,0,0,0,0,0,-11000,0,0,0,5000,16000,-11000,-11000
054795,合勤控群益98購01,0,0,0,0,0,0,0,0,0,-11000,0,0,0,0,11000,-11000,-11000
054786,全新群益99購02  ,0,0,0,0,0,0,0,0,0,-11000,0,0,0,0,11000,-11000,-11000
054468,台郡凱基98購01  ,0,0,0,0,0,0,0,0,0,-11000,0,0,0,0,11000,-11000,-11000
054136,亞光元大96購04  ,0,0,0,0,0,0,0,0,0,-11000,0,0,0,44000,55000,-11000,-11000
054263,聯茂元大96購02  ,0,0,0,0,0,0,0,0,0,-11000,0,0,0,0,11000,-11000,-11000
053974,大立光元大96購10,0,0,0,0,0,0,0,0,0,-11000,0,0,0,50000,61000,-11000,-11000
053960,晶技永豐96購02  ,0,0,0,0,0,0,0,0,0,-11000,0,0,0,0,11000,-11000,-11000
056299,友達元大9B購04  ,0,0,0,0,0,0,0,0,0,-11000,0,0,0,1000,12000,-11000,-11000
055536,嘉聯益群益99購02,0,0,0,0,0,0,0,0,0,-11000,0,0,0,6000,17000,-11000,-11000
055512,聯詠兆豐97購01  ,0,0,0,0,0,0,0,0,0,-11000,0,0,0,38000,49000,-11000,-11000
4545,銘鈺            ,62000,73000,-11000,0,0,0,0,0,0,0,9000,9000,0,0,0,0,-11000
06637P,大立光凱基98售15,0,0,0,0,0,0,0,0,0,-11000,0,0,0,3000,14000,-11000,-11000
1723,中碳            ,61000,73000,-12000,0,0,0,0,0,0,1000,2000,1000,1000,0,0,0,-11000
1626,艾美特-KY       ,34000,45000,-11000,0,0,0,0,0,0,0,0,0,0,0,0,0,-11000
057003,立積國票98購01  ,0,0,0,0,0,0,0,0,0,-12000,0,0,0,24000,36000,-12000,-12000
057348,台積電統一98購09,0,0,0,0,0,0,0,0,0,-12000,0,0,0,1000,13000,-12000,-12000
057282,大立光元大99購06,0,0,0,0,0,0,0,0,0,-12000,0,0,0,0,12000,-12000,-12000
057571,泰碩永豐98購01  ,0,0,0,0,0,0,0,0,0,-12000,0,0,0,10000,22000,-12000,-12000
057600,大立光群益99購03,0,0,0,0,0,0,0,0,0,-12000,0,0,0,2000,14000,-12000,-12000
057662,上銀元大9A購01  ,0,0,0,0,0,0,0,0,0,-12000,0,0,0,0,12000,-12000,-12000
058601,台積電元大99購10,0,0,0,0,0,0,0,0,0,-12000,0,0,0,82000,94000,-12000,-12000
058710,臺股指元大9A購23,0,0,0,0,0,0,0,0,0,-12000,0,0,0,0,12000,-12000,-12000
058627,聯發科國票99購04,0,0,0,0,0,0,0,0,0,-12000,0,0,0,0,12000,-12000,-12000
058070,華新科凱基98購07,0,0,0,0,0,0,0,0,0,-12000,0,0,0,40000,52000,-12000,-12000
057908,國泰金亞東99購01,0,0,0,0,0,0,0,0,0,-12000,0,0,0,48000,60000,-12000,-12000
057970,國巨富邦99購03  ,0,0,0,0,0,0,0,0,0,-12000,0,0,0,0,12000,-12000,-12000
04518P,高鐵群益95售01  ,0,0,0,0,0,0,0,0,0,-12000,0,0,0,8000,20000,-12000,-12000
045750,鈺齊富邦94購01  ,0,0,0,0,0,0,0,0,0,-12000,0,0,0,0,12000,-12000,-12000
04596P,臺股指元大94售14,0,0,0,0,0,0,0,0,0,-12000,0,0,0,0,12000,-12000,-12000
048450,聯詠凱基93購09  ,0,0,0,0,0,0,0,0,0,-12000,0,0,0,46000,58000,-12000,-12000
048438,台表科麥證94購01,0,0,0,0,12000,-12000,0,0,0,-12000,0,0,0,0,12000,-12000,-12000
048571,美利達元大96購03,0,0,0,0,0,0,0,0,0,-12000,0,0,0,0,12000,-12000,-12000
047683,亞德客國泰95購01,0,0,0,0,0,0,0,0,0,-12000,0,0,0,0,12000,-12000,-12000
047895,台積電群益94購04,0,0,0,0,0,0,0,0,0,-12000,0,0,0,20000,32000,-12000,-12000
049725,台郡國票94購03  ,0,0,0,0,0,0,0,0,0,-12000,0,0,0,0,12000,-12000,-12000
052578,大立光統一97購01,0,0,0,0,0,0,0,0,0,-12000,0,0,0,51000,63000,-12000,-12000
052541,大立光統一95購06,0,0,0,0,0,0,0,0,0,-12000,0,0,0,108000,120000,-12000,-12000
049222,和碩國票94購01  ,0,0,0,0,0,0,0,0,0,-12000,0,0,0,38000,50000,-12000,-12000
048635,鴻海元大94購04  ,0,0,0,0,0,0,0,0,0,-12000,0,0,0,30000,42000,-12000,-12000
05157P,全新台新96售01  ,0,0,0,0,0,0,0,0,0,-12000,0,0,0,16000,28000,-12000,-12000
051484,玉晶光凱基97購01,0,0,0,0,0,0,0,0,0,-12000,0,0,0,3000,15000,-12000,-12000
050344,鴻海元富96購01  ,0,0,0,0,0,0,0,0,0,-12000,0,0,0,30000,42000,-12000,-12000
052517,滬深2X元大95購05,0,0,0,0,0,0,0,0,0,-12000,0,0,0,0,12000,-12000,-12000
053320,華新科群益97購01,0,0,0,0,0,0,0,0,0,-12000,0,0,0,0,12000,-12000,-12000
052313,聯電元大98購01  ,0,0,0,0,0,0,0,0,0,-12000,0,0,0,98000,110000,-12000,-12000
052226,旺宏凱基95購06  ,0,0,0,0,0,0,0,0,0,-12000,0,0,0,69000,81000,-12000,-12000
053024,國巨富邦97購02  ,0,0,0,0,0,0,0,0,0,-12000,0,0,0,21000,33000,-12000,-12000
052723,新唐統一97購01  ,0,0,0,0,0,0,0,0,0,-12000,0,0,0,38000,50000,-12000,-12000
050186,京鼎元大94購01  ,0,0,0,0,0,0,0,0,0,-12000,0,0,0,0,12000,-12000,-12000
052634,華邦電凱基96購01,0,0,0,0,0,0,0,0,0,-12000,0,0,0,0,12000,-12000,-12000
052635,奇力新凱基98購01,0,0,0,0,0,0,0,0,0,-12000,0,0,0,10000,22000,-12000,-12000
050728,新日興國票94購01,0,0,0,0,0,0,0,0,0,-12000,0,0,0,20000,32000,-12000,-12000
050699,京鼎凱基96購01  ,0,0,0,0,0,0,0,0,0,-12000,0,0,0,0,12000,-12000,-12000
053222,聯茂凱基96購03  ,0,0,0,0,0,0,0,0,0,-12000,0,0,0,18000,30000,-12000,-12000
056062,大立光元大97購12,0,0,0,0,0,0,0,0,0,-12000,0,0,0,103000,115000,-12000,-12000
054094,創意群益96購02  ,0,0,0,0,0,0,0,0,0,-12000,0,0,0,28000,40000,-12000,-12000
053881,南亞科中信97購01,0,0,0,0,0,0,0,0,0,-12000,0,0,0,0,12000,-12000,-12000
054355,上海銀富邦98購01,0,0,0,0,0,0,0,0,0,-12000,0,0,0,9000,21000,-12000,-12000
05480P,滬深2X凱基96售05,0,0,0,0,0,0,0,0,0,-12000,0,0,0,103000,115000,-12000,-12000
055013,訊連元富97購01  ,0,0,0,0,0,0,0,0,0,-12000,0,0,0,235000,247000,-12000,-12000
2511,太子            ,263000,270000,-7000,0,0,0,0,0,0,-5000,0,5000,-5000,0,0,0,-12000
057743,華擎永豐98購03  ,0,0,0,0,0,0,0,0,0,-13000,0,0,0,40000,53000,-13000,-13000
057738,旺宏富邦9A購01  ,0,0,0,0,0,0,0,0,0,-13000,0,0,0,0,13000,-13000,-13000
058045,鴻海元大99購08  ,0,0,0,0,0,0,0,0,0,-13000,0,0,0,96000,109000,-13000,-13000
058559,華新科日盛99購02,0,0,0,0,0,0,0,0,0,-13000,0,0,0,0,13000,-13000,-13000
058321,大立光永豐99購01,0,0,0,0,0,0,0,0,0,-13000,0,0,0,0,13000,-13000,-13000
058417,國巨麥證99購01  ,0,0,0,0,13000,-13000,0,0,0,-13000,0,0,0,0,13000,-13000,-13000
057192,力成元大98購01  ,0,0,0,0,0,0,0,0,0,-13000,0,0,0,2000,15000,-13000,-13000
057047,華新科元大99購07,0,0,0,0,0,0,0,0,0,-13000,0,0,0,74000,87000,-13000,-13000
056466,臺股指凱基99購08,0,0,0,0,0,0,0,0,0,-13000,0,0,0,0,13000,-13000,-13000
056483,TPK元大98購01   ,0,0,0,0,0,0,0,0,0,-13000,0,0,0,6000,19000,-13000,-13000
048696,台達電國票96購01,0,0,0,0,0,0,0,0,0,-13000,0,0,0,30000,43000,-13000,-13000
048130,美利達元大96購01,0,0,0,0,0,0,0,0,0,-13000,0,0,0,0,13000,-13000,-13000
045736,台積電群益94購01,0,0,0,0,0,0,0,0,0,-13000,0,0,0,0,13000,-13000,-13000
04058P,臺股指群益93售12,0,0,0,0,0,0,0,0,0,-13000,0,0,0,0,13000,-13000,-13000
03033X,元展30          ,0,0,0,0,0,0,0,0,0,-13000,0,0,0,1000,14000,-13000,-13000
053250,百和國票97購02  ,0,0,0,0,0,0,0,0,0,-13000,0,0,0,34000,47000,-13000,-13000
050700,健策凱基96購01  ,0,0,0,0,0,0,0,0,0,-13000,0,0,0,52000,65000,-13000,-13000
051825,中環元大95購01  ,0,0,0,0,0,0,0,0,0,-13000,0,0,0,97000,110000,-13000,-13000
052242,台達電台新96購01,0,0,0,0,0,0,0,0,0,-13000,0,0,0,118000,131000,-13000,-13000
052321,華擎元大95購01  ,0,0,0,0,0,0,0,0,0,-13000,0,0,0,3000,16000,-13000,-13000
053427,鎧勝永豐96購02  ,0,0,0,0,0,0,0,0,0,-13000,0,0,0,25000,38000,-13000,-13000
053468,鴻海元大98購01  ,0,0,0,0,0,0,0,0,0,-13000,0,0,0,40000,53000,-13000,-13000
051493,台郡凱基95購02  ,0,0,0,0,0,0,0,0,0,-13000,0,0,0,30000,43000,-13000,-13000
051543,鈺齊國票96購01  ,0,0,0,0,0,0,0,0,0,-13000,0,0,0,1000,14000,-13000,-13000
055131,茂林康和97購01  ,0,0,0,0,0,0,0,0,0,-13000,0,0,0,0,13000,-13000,-13000
05433P,智原元富95售02  ,0,0,0,0,0,0,0,0,0,-13000,0,0,0,10000,23000,-13000,-13000
054297,台郡元大98購01  ,0,0,0,0,0,0,0,0,0,-13000,0,0,0,48000,61000,-13000,-13000
053753,啟碁永豐96購01  ,0,0,0,0,0,0,0,0,0,-13000,0,0,0,24000,37000,-13000,-13000
054026,台積電凱基97購08,0,0,0,0,0,0,0,0,0,-13000,0,0,0,40000,53000,-13000,-13000
056064,大立光元大97購14,0,0,0,0,0,0,0,0,0,-13000,0,0,0,0,13000,-13000,-13000
056057,華邦電元大97購05,0,0,0,0,0,0,0,0,0,-13000,0,0,0,68000,81000,-13000,-13000
056101,光磊永豐98購01  ,0,0,0,0,0,0,0,0,0,-13000,0,0,0,13000,26000,-13000,-13000
056235,鴻海群益97購07  ,0,0,0,0,0,0,0,0,0,-13000,0,0,0,0,13000,-13000,-13000
05554P,群創群益96售02  ,0,0,0,0,0,0,0,0,0,-13000,0,0,0,0,13000,-13000,-13000
8480,泰昇-KY         ,20000,31000,-11000,0,0,0,0,0,0,-2000,0,2000,-2000,0,0,0,-13000
2348,海悅            ,85000,104000,-19000,0,0,0,0,0,0,6000,7000,1000,6000,0,0,0,-13000
06383P,聯茂元富97售01  ,0,0,0,0,0,0,0,0,0,-13000,0,0,0,30000,43000,-13000,-13000
06217P,鴻海元富97售05  ,0,0,0,0,0,0,0,0,0,-13000,0,0,0,7000,20000,-13000,-13000
056578,智易元大99購02  ,0,0,0,0,0,0,0,0,0,-14000,0,0,0,4000,18000,-14000,-14000
056581,超眾元大99購01  ,0,0,0,0,0,0,0,0,0,-14000,0,0,0,30000,44000,-14000,-14000
056519,創意國票99購01  ,0,0,0,0,0,0,0,0,0,-14000,0,0,0,20000,34000,-14000,-14000
057012,康控中信98購01  ,0,0,0,0,0,0,0,0,0,-14000,0,0,0,6000,20000,-14000,-14000
057495,牧德元大99購04  ,0,0,0,0,0,0,0,0,0,-14000,0,0,0,6000,20000,-14000,-14000
05847P,大立光元大96售08,0,0,0,0,0,0,0,0,0,-14000,0,0,0,17000,31000,-14000,-14000
058642,旺宏麥證9A購01  ,0,0,0,0,14000,-14000,0,0,0,-14000,0,0,0,0,14000,-14000,-14000
05875P,旺宏群益98售01  ,0,0,0,0,0,0,0,0,0,-14000,0,0,0,28000,42000,-14000,-14000
05920P,力成元大96售04  ,0,0,0,0,0,0,0,0,0,-14000,0,0,0,0,14000,-14000,-14000
00660,元大歐洲50      ,0,0,0,0,0,0,0,0,0,-14000,0,0,0,30000,44000,-14000,-14000
03433B,臺股指元大9C熊01,0,0,0,0,0,0,0,0,0,-14000,0,0,0,0,14000,-14000,-14000
046942,友達元大99購01  ,0,0,0,0,0,0,0,0,0,-14000,0,0,0,249000,263000,-14000,-14000
047457,旺宏群益95購01  ,0,0,0,0,0,0,0,0,0,-14000,0,0,0,81000,95000,-14000,-14000
049273,臺股指元大94購08,0,0,0,0,0,0,0,0,0,-14000,0,0,0,2000,16000,-14000,-14000
048593,華新科群益93購04,0,0,0,0,0,0,0,0,0,-14000,0,0,0,20000,34000,-14000,-14000
048623,世紀鋼凱基94購03,0,0,0,0,0,0,0,0,0,-14000,0,0,0,25000,39000,-14000,-14000
052779,欣興國票97購01  ,0,0,0,0,0,0,0,0,0,-14000,0,0,0,150000,164000,-14000,-14000
052559,茂林國票97購01  ,0,0,0,0,0,0,0,0,0,-14000,0,0,0,0,14000,-14000,-14000
051332,奇力新永豐95購01,0,0,0,0,0,0,0,0,0,-14000,0,0,0,73000,87000,-14000,-14000
053669,台積電統一96購08,0,0,0,0,0,0,0,0,0,-14000,0,0,0,292000,306000,-14000,-14000
052325,高股息中信99購01,0,0,0,0,0,0,0,0,0,-14000,0,0,0,49000,63000,-14000,-14000
053651,台光電凱基98購01,0,0,0,0,0,0,0,0,0,-14000,0,0,0,15000,29000,-14000,-14000
05264P,微星元大95售02  ,0,0,0,0,0,0,0,0,0,-14000,0,0,0,0,14000,-14000,-14000
053095,台光電統一98購01,0,0,0,0,0,0,0,0,0,-14000,0,0,0,0,14000,-14000,-14000
053167,欣興群益96購03  ,0,0,0,0,0,0,0,0,0,-14000,0,0,0,234000,248000,-14000,-14000
050718,茂林群益94購04  ,0,0,0,0,0,0,0,0,0,-14000,0,0,0,6000,20000,-14000,-14000
050869,健策永豐95購01  ,0,0,0,0,0,0,0,0,0,-14000,0,0,0,81000,95000,-14000,-14000
051187,晶相光永豐95購01,0,0,0,0,0,0,0,0,0,-14000,0,0,0,304000,318000,-14000,-14000
050229,鴻海麥證94購02  ,0,0,0,53000,67000,-14000,0,0,0,-14000,0,0,0,53000,67000,-14000,-14000
05024P,華通國票96售01  ,0,0,0,0,0,0,0,0,0,-14000,0,0,0,16000,30000,-14000,-14000
055553,聯發科凱基97購05,0,0,0,0,0,0,0,0,0,-14000,0,0,0,2000,16000,-14000,-14000
055736,宏達電元富99購01,0,0,0,0,0,0,0,0,0,-14000,0,0,0,8000,22000,-14000,-14000
055183,聯鈞統一97購01  ,0,0,0,0,0,0,0,0,0,-14000,0,0,0,46000,60000,-14000,-14000
055434,樺漢群益97購01  ,0,0,0,0,0,0,0,0,0,-14000,0,0,0,81000,95000,-14000,-14000
05609P,國泰金凱基96售01,0,0,0,0,0,0,0,0,0,-14000,0,0,0,131000,145000,-14000,-14000
055997,矽創國泰99購01  ,0,0,0,0,0,0,0,0,0,-14000,0,0,0,10000,24000,-14000,-14000
055930,可成群益98購01  ,0,0,0,0,0,0,0,0,0,-14000,0,0,0,0,14000,-14000,-14000
06647P,台積電元大98售13,0,0,0,0,0,0,0,0,0,-14000,0,0,0,185000,199000,-14000,-14000
1531,高林股          ,25000,39000,-14000,0,0,0,0,0,0,0,0,0,0,0,0,0,-14000
06986P,台積電台新9A售01,0,0,0,0,0,0,0,0,0,-14000,0,0,0,0,14000,-14000,-14000
4133,亞諾法          ,75000,78000,-3000,0,0,0,0,0,0,-11000,1000,0,1000,0,12000,-12000,-14000
3209,全科            ,136000,148000,-12000,0,0,0,0,0,0,-2000,1000,3000,-2000,0,0,0,-14000
058725,美律富邦9A購01  ,0,0,0,0,0,0,0,0,0,-15000,0,0,0,0,15000,-15000,-15000
05907P,聯發科元富96售05,0,0,0,0,0,0,0,0,0,-15000,0,0,0,20000,35000,-15000,-15000
058554,瀚宇博永豐99購01,0,0,0,0,0,0,0,0,0,-15000,0,0,0,13000,28000,-15000,-15000
058540,嘉聯益國泰9A購02,0,0,0,0,0,0,0,0,0,-15000,0,0,0,0,15000,-15000,-15000
058564,元金2X凱基9C購01,0,0,0,0,0,0,0,0,0,-15000,0,0,0,0,15000,-15000,-15000
058431,國巨統一9B購01  ,0,0,0,0,0,0,0,0,0,-15000,0,0,0,5000,20000,-15000,-15000
058324,嘉聯益永豐9A購01,0,0,0,0,0,0,0,0,0,-15000,0,0,0,15000,30000,-15000,-15000
058053,上銀統一9B購01  ,0,0,0,0,0,0,0,0,0,-15000,0,0,0,0,15000,-15000,-15000
057768,華新科中信9A購01,0,0,0,0,0,0,0,0,0,-15000,0,0,0,10000,25000,-15000,-15000
057764,台表科凱基9A購01,0,0,0,0,0,0,0,0,0,-15000,0,0,0,20000,35000,-15000,-15000
057911,國巨日盛98購01  ,0,0,0,0,0,0,0,0,0,-15000,0,0,0,10000,25000,-15000,-15000
057598,鴻海群益98購07  ,0,0,0,0,0,0,0,0,0,-15000,0,0,0,12000,27000,-15000,-15000
057607,旺宏台新98購02  ,0,0,0,0,0,0,0,0,0,-15000,0,0,0,0,15000,-15000,-15000
057580,玉山金中信9A購01,0,0,0,0,0,0,0,0,0,-15000,0,0,0,0,15000,-15000,-15000
057151,易華電國票99購01,0,0,0,0,0,0,0,0,0,-15000,0,0,0,19000,34000,-15000,-15000
057139,華新科兆豐98購02,0,0,0,0,0,0,0,0,0,-15000,0,0,0,35000,50000,-15000,-15000
057233,聯發科凱基98購14,0,0,0,0,0,0,0,0,0,-15000,0,0,0,25000,40000,-15000,-15000
057030,滬深反元大9B購01,0,0,0,0,0,0,0,0,0,-15000,0,0,0,0,15000,-15000,-15000
056925,群創兆豐98購03  ,0,0,0,0,0,0,0,0,0,-15000,0,0,0,0,15000,-15000,-15000
056853,元油2X中信9B購02,0,0,0,0,0,0,0,0,0,-15000,0,0,0,0,15000,-15000,-15000
052579,亞泥元富96購01  ,0,0,0,0,0,0,0,0,0,-15000,0,0,0,40000,55000,-15000,-15000
048315,聯發科凱基93購32,0,0,0,0,0,0,0,0,0,-15000,0,0,0,0,15000,-15000,-15000
048555,技嘉元大93購02  ,0,0,0,0,0,0,0,0,0,-15000,0,0,0,0,15000,-15000,-15000
049498,茂林元大95購01  ,0,0,0,0,0,0,0,0,0,-15000,0,0,0,0,15000,-15000,-15000
049592,欣興元大96購01  ,0,0,0,0,0,0,0,0,0,-15000,0,0,0,0,15000,-15000,-15000
045753,大立光國泰94購02,0,0,0,0,0,0,0,0,0,-15000,0,0,0,0,15000,-15000,-15000
047097,旺宏國泰94購03  ,0,0,0,0,0,0,0,0,0,-15000,0,0,0,15000,30000,-15000,-15000
04543P,鴻海富邦95售03  ,0,0,0,0,0,0,0,0,0,-15000,0,0,0,0,15000,-15000,-15000
044809,道瓊反國票93購01,0,0,0,0,0,0,0,0,0,-15000,0,0,0,45000,60000,-15000,-15000
03019X,元展19          ,0,0,0,0,0,0,0,0,0,-15000,0,0,0,0,15000,-15000,-15000
04607P,A50中信94售01   ,0,0,0,0,0,0,0,0,0,-15000,0,0,0,0,15000,-15000,-15000
03777P,華通中信95售01  ,0,0,0,0,0,0,0,0,0,-15000,0,0,0,100000,115000,-15000,-15000
044346,力山富邦95購01  ,0,0,0,0,0,0,0,0,0,-15000,0,0,0,0,15000,-15000,-15000
046480,群創元富96購01  ,0,0,0,0,0,0,0,0,0,-15000,0,0,0,125000,140000,-15000,-15000
053064,國巨群益96購04  ,0,0,0,0,0,0,0,0,0,-15000,0,0,0,10000,25000,-15000,-15000
050657,宏達電麥證94購01,0,0,0,155000,170000,-15000,0,0,0,-15000,0,0,0,155000,170000,-15000,-15000
050633,義隆群益96購02  ,0,0,0,0,0,0,0,0,0,-15000,0,0,0,11000,26000,-15000,-15000
051163,鴻海元大95購04  ,0,0,0,0,0,0,0,0,0,-15000,0,0,0,5000,20000,-15000,-15000
052944,宏達電國票97購01,0,0,0,0,0,0,0,0,0,-15000,0,0,0,90000,105000,-15000,-15000
051008,大立光麥證95購01,0,0,0,10000,25000,-15000,0,0,0,-15000,0,0,0,10000,25000,-15000,-15000
052607,大立光元大96購03,0,0,0,0,0,0,0,0,0,-15000,0,0,0,10000,25000,-15000,-15000
050972,台虹永豐95購01  ,0,0,0,0,0,0,0,0,0,-15000,0,0,0,91000,106000,-15000,-15000
050108,鴻海元大94購13  ,0,0,0,0,0,0,0,0,0,-15000,0,0,0,10000,25000,-15000,-15000
053292,美律中信98購01  ,0,0,0,0,0,0,0,0,0,-15000,0,0,0,53000,68000,-15000,-15000
05361P,聯發科富邦97售01,0,0,0,0,0,0,0,0,0,-15000,0,0,0,105000,120000,-15000,-15000
053554,欣興凱基97購02  ,0,0,0,0,0,0,0,0,0,-15000,0,0,0,0,15000,-15000,-15000
053356,聯發科統一96購07,0,0,0,0,0,0,0,0,0,-15000,0,0,0,118000,133000,-15000,-15000
051380,禾伸堂群益95購01,0,0,0,0,0,0,0,0,0,-15000,0,0,0,10000,25000,-15000,-15000
050460,GIS元大95購03   ,0,0,0,0,0,0,0,0,0,-15000,0,0,0,0,15000,-15000,-15000
051575,國巨元大96購03  ,0,0,0,0,0,0,0,0,0,-15000,0,0,0,154000,169000,-15000,-15000
051734,台積電國票95購04,0,0,0,0,0,0,0,0,0,-15000,0,0,0,75000,90000,-15000,-15000
055963,欣興元大97購04  ,0,0,0,0,0,0,0,0,0,-15000,0,0,0,5000,20000,-15000,-15000
056073,智伸科元大97購01,0,0,0,0,0,0,0,0,0,-15000,0,0,0,0,15000,-15000,-15000
056228,可成凱基97購03  ,0,0,0,0,0,0,0,0,0,-15000,0,0,0,10000,25000,-15000,-15000
056362,聯發科元大99購01,0,0,0,0,0,0,0,0,0,-15000,0,0,0,97000,112000,-15000,-15000
055280,智邦元大97購01  ,0,0,0,0,0,0,0,0,0,-15000,0,0,0,25000,40000,-15000,-15000
055700,緯穎國泰98購02  ,0,0,0,0,0,0,0,0,0,-15000,0,0,0,25000,40000,-15000,-15000
054101,茂林國票97購04  ,0,0,0,0,0,0,0,0,0,-15000,0,0,0,30000,45000,-15000,-15000
053805,奇鋐凱基98購02  ,0,0,0,0,0,0,0,0,0,-15000,0,0,0,0,15000,-15000,-15000
053823,茂林群益96購06  ,0,0,0,0,0,0,0,0,0,-15000,0,0,0,27000,42000,-15000,-15000
054364,智伸科凱基96購01,0,0,0,0,0,0,0,0,0,-15000,0,0,0,0,15000,-15000,-15000
054437,欣興台新97購02  ,0,0,0,0,0,0,0,0,0,-15000,0,0,0,0,15000,-15000,-15000
054132,聯發科元大97購10,0,0,0,0,0,0,0,0,0,-15000,0,0,0,40000,55000,-15000,-15000
055012,茂林元富97購01  ,0,0,0,0,0,0,0,0,0,-15000,0,0,0,229000,244000,-15000,-15000
054979,南港元富97購01  ,0,0,0,0,0,0,0,0,0,-15000,0,0,0,0,15000,-15000,-15000
054822,祥碩元大97購01  ,0,0,0,0,0,0,0,0,0,-15000,0,0,0,15000,30000,-15000,-15000
054574,美律元大99購01  ,0,0,0,0,0,0,0,0,0,-15000,0,0,0,10000,25000,-15000,-15000
06964P,臺股指凱基9B售01,0,0,0,0,0,0,0,0,0,-15000,0,0,0,3000,18000,-15000,-15000
06997P,台灣50中信03售01,0,0,0,0,0,0,0,0,0,-15000,0,0,0,1000,16000,-15000,-15000
07011P,宏達電凱基99售02,0,0,0,0,0,0,0,0,0,-15000,0,0,0,45000,60000,-15000,-15000
06911P,鴻海元大99售09  ,0,0,0,0,0,0,0,0,0,-15000,0,0,0,0,15000,-15000,-15000
1416,廣豐            ,0,15000,-15000,0,0,0,0,0,0,0,0,0,0,0,0,0,-15000
1810,和成            ,107000,122000,-15000,0,0,0,0,0,0,0,0,0,0,0,0,0,-15000
06711P,臺股指台新99售08,0,0,0,0,0,0,0,0,0,-15000,50000,0,50000,752000,817000,-65000,-15000
06485P,玉晶光群益9A售02,0,0,0,0,0,0,0,0,0,-15000,0,0,0,35000,50000,-15000,-15000
06298P,聯發科元大97售20,0,0,0,0,0,0,0,0,0,-15000,0,0,0,0,15000,-15000,-15000
05704P,矽力群益96售04  ,0,0,0,0,0,0,0,0,0,-16000,0,0,0,0,16000,-16000,-16000
057576,南亞科第一9C購01,0,0,0,0,0,0,0,0,0,-16000,0,0,0,0,16000,-16000,-16000
057429,華新科兆豐98購03,0,0,0,0,0,0,0,0,0,-16000,0,0,0,55000,71000,-16000,-16000
057925,貿聯凱基99購01  ,0,0,0,0,0,0,0,0,0,-16000,0,0,0,0,16000,-16000,-16000
05792P,臺股指中信99售07,0,0,0,0,0,0,0,0,0,-16000,0,0,0,9000,25000,-16000,-16000
057691,健策凱基99購01  ,0,0,0,0,0,0,0,0,0,-16000,0,0,0,0,16000,-16000,-16000
057670,欣興元大99購02  ,0,0,0,0,0,0,0,0,0,-16000,0,0,0,11000,27000,-16000,-16000
058357,智邦凱基99購02  ,0,0,0,0,0,0,0,0,0,-16000,0,0,0,38000,54000,-16000,-16000
00707R,元大S&P日圓反1  ,0,0,0,0,0,0,0,0,0,-16000,0,0,0,170000,186000,-16000,-16000
043442,大立光台新01購01,0,0,0,0,0,0,0,0,0,-16000,0,0,0,5000,21000,-16000,-16000
049614,聯茂中信94購01  ,0,0,0,0,0,0,0,0,0,-16000,0,0,0,0,16000,-16000,-16000
049470,楠梓電永豐94購03,0,0,0,0,0,0,0,0,0,-16000,0,0,0,0,16000,-16000,-16000
048283,亞德客中信94購01,0,0,0,0,0,0,0,0,0,-16000,0,0,0,11000,27000,-16000,-16000
049393,世紀鋼第一94購01,0,0,0,0,0,0,0,0,0,-16000,0,0,0,130000,146000,-16000,-16000
048412,台勝科亞東93購01,0,0,0,0,0,0,0,0,0,-16000,0,0,0,0,16000,-16000,-16000
049677,臺股指國票94購10,0,0,0,0,0,0,0,0,0,-16000,0,0,0,0,16000,-16000,-16000
05291P,鴻海凱基95售16  ,0,0,0,0,0,0,0,0,0,-16000,0,0,0,13000,29000,-16000,-16000
052909,上銀統一96購01  ,0,0,0,0,0,0,0,0,0,-16000,0,0,0,56000,72000,-16000,-16000
052799,上銀元大96購01  ,0,0,0,0,0,0,0,0,0,-16000,0,0,0,63000,79000,-16000,-16000
04871P,力成元富94售02  ,0,0,0,0,0,0,0,0,0,-16000,0,0,0,76000,92000,-16000,-16000
048878,康控國票95購02  ,0,0,0,0,0,0,0,0,0,-16000,0,0,0,0,16000,-16000,-16000
051701,華通群益97購01  ,0,0,0,0,0,0,0,0,0,-16000,0,0,0,0,16000,-16000,-16000
051637,嘉聯益國票96購01,0,0,0,0,0,0,0,0,0,-16000,0,0,0,0,16000,-16000,-16000
053443,智邦凱基97購01  ,0,0,0,0,0,0,0,0,0,-16000,0,0,0,94000,110000,-16000,-16000
052342,茂林凱基96購01  ,0,0,0,0,0,0,0,0,0,-16000,0,0,0,11000,27000,-16000,-16000
051934,緯穎國票96購01  ,0,0,0,0,0,0,0,0,0,-16000,0,0,0,15000,31000,-16000,-16000
053085,華新科元大97購04,0,0,0,0,0,0,0,0,0,-16000,0,0,0,22000,38000,-16000,-16000
050223,聯茂元富94購02  ,0,0,0,0,0,0,0,0,0,-16000,0,0,0,0,16000,-16000,-16000
055001,京鼎元富97購01  ,0,0,0,0,0,0,0,0,0,-16000,0,0,0,42000,58000,-16000,-16000
05513P,玉山金台新96售01,0,0,0,0,0,0,0,0,0,-16000,0,0,0,81000,97000,-16000,-16000
055161,貿聯元大98購03  ,0,0,0,0,0,0,0,0,0,-16000,0,0,0,5000,21000,-16000,-16000
053836,亞光永豐96購02  ,0,0,0,0,0,0,0,0,0,-16000,0,0,0,7000,23000,-16000,-16000
053893,京鼎群益97購02  ,0,0,0,0,0,0,0,0,0,-16000,0,0,0,11000,27000,-16000,-16000
054008,大立光元富96購06,0,0,0,0,0,0,0,0,0,-16000,0,0,0,4000,20000,-16000,-16000
055503,健策元大98購05  ,0,0,0,0,0,0,0,0,0,-16000,0,0,0,70000,86000,-16000,-16000
056388,勤誠國泰99購01  ,0,0,0,0,0,0,0,0,0,-16000,0,0,0,10000,26000,-16000,-16000
056181,百和元富97購02  ,0,0,0,0,0,0,0,0,0,-16000,0,0,0,284000,300000,-16000,-16000
056117,宏達電群益97購02,0,0,0,0,0,0,0,0,0,-16000,0,0,0,0,16000,-16000,-16000
055928,南亞科群益97購02,0,0,0,0,0,0,0,0,0,-16000,0,0,0,1000,17000,-16000,-16000
055855,牧德元大99購02  ,0,0,0,0,0,0,0,0,0,-16000,0,0,0,0,16000,-16000,-16000
06273P,台表科凱基97售04,0,0,0,0,0,0,0,0,0,-16000,0,0,0,44000,60000,-16000,-16000
06268P,聯詠凱基97售02  ,0,0,0,0,0,0,0,0,0,-16000,0,0,0,10000,26000,-16000,-16000
2881B,富邦金乙特      ,0,0,0,0,0,0,0,0,0,-16000,17000,33000,-16000,0,0,0,-16000
2429,銘旺科          ,67000,83000,-16000,0,0,0,0,0,0,0,0,0,0,0,0,0,-16000
058593,大立光統一9B購02,0,0,0,0,0,0,0,0,0,-17000,0,0,0,0,17000,-17000,-17000
058513,宏達電元大99購05,0,0,0,0,0,0,0,0,0,-17000,0,0,0,9000,26000,-17000,-17000
05992P,華通元大96售05  ,0,0,0,0,0,0,0,0,0,-17000,0,0,0,35000,52000,-17000,-17000
057745,泰鼎永豐99購01  ,0,0,0,0,0,0,0,0,0,-17000,0,0,0,152000,169000,-17000,-17000
057943,可成國票99購03  ,0,0,0,0,0,0,0,0,0,-17000,0,0,0,0,17000,-17000,-17000
057478,智邦元大99購01  ,0,0,0,0,0,0,0,0,0,-17000,0,0,0,254000,271000,-17000,-17000
057354,聯鈞統一99購03  ,0,0,0,0,0,0,0,0,0,-17000,0,0,0,21000,38000,-17000,-17000
049017,旺宏群益96購03  ,0,0,0,0,0,0,0,0,0,-17000,0,0,0,48000,65000,-17000,-17000
04938P,亞德客國票95售01,0,0,0,0,0,0,0,0,0,-17000,0,0,0,3000,20000,-17000,-17000
047917,台積電凱基94購01,0,0,0,0,0,0,0,0,0,-17000,0,0,0,28000,45000,-17000,-17000
047674,群創元富96購02  ,0,0,0,0,0,0,0,0,0,-17000,0,0,0,3000,20000,-17000,-17000
0051,元大中型100     ,1000,1000,0,0,0,0,0,0,0,-17000,0,0,0,9000,26000,-17000,-17000
03959P,義隆元富96售01  ,0,0,0,0,0,0,0,0,0,-17000,0,0,0,61000,78000,-17000,-17000
050579,聯發科國票95購04,0,0,0,0,0,0,0,0,0,-17000,0,0,0,33000,50000,-17000,-17000
05085P,鴻海日盛95售01  ,0,0,0,0,0,0,0,0,0,-17000,0,0,0,26000,43000,-17000,-17000
050765,鴻海元大96購02  ,0,0,0,0,0,0,0,0,0,-17000,0,0,0,162000,179000,-17000,-17000
051229,亞光群益95購01  ,0,0,0,0,0,0,0,0,0,-17000,0,0,0,0,17000,-17000,-17000
051731,聯電國票96購02  ,0,0,0,0,0,0,0,0,0,-17000,0,0,0,0,17000,-17000,-17000
056434,國巨凱基98購03  ,0,0,0,0,0,0,0,0,0,-17000,0,0,0,0,17000,-17000,-17000
055298,啟碁元大97購02  ,0,0,0,0,0,0,0,0,0,-17000,0,0,0,72000,89000,-17000,-17000
055443,台虹國票98購01  ,0,0,0,0,0,0,0,0,0,-17000,0,0,0,11000,28000,-17000,-17000
053850,嘉澤元富96購03  ,0,0,0,0,0,0,0,0,0,-17000,0,0,0,65000,82000,-17000,-17000
2524,京城            ,79000,95000,-16000,0,0,0,0,0,0,-1000,0,1000,-1000,0,0,0,-17000
057321,台泥群益98購01  ,0,0,0,0,0,0,0,0,0,-18000,0,0,0,22000,40000,-18000,-18000
057299,立積永豐98購02  ,0,0,0,0,0,0,0,0,0,-18000,0,0,0,258000,276000,-18000,-18000
057164,國巨元大98購14  ,0,0,0,0,0,0,0,0,0,-18000,0,0,0,50000,68000,-18000,-18000
057506,聯鈞國票99購02  ,0,0,0,0,0,0,0,0,0,-18000,0,0,0,34000,52000,-18000,-18000
057444,台泥元富98購01  ,0,0,0,0,0,0,0,0,0,-18000,0,0,0,80000,98000,-18000,-18000
057641,旺宏元大98購10  ,0,0,0,0,0,0,0,0,0,-18000,0,0,0,255000,273000,-18000,-18000
056509,晶相光永豐98購01,0,0,0,0,0,0,0,0,0,-18000,0,0,0,146000,164000,-18000,-18000
058571,緯穎凱基9A購02  ,0,0,0,0,0,0,0,0,0,-18000,0,0,0,0,18000,-18000,-18000
058371,智原凱基9A購01  ,0,0,0,0,0,0,0,0,0,-18000,0,0,0,17000,35000,-18000,-18000
058336,鴻海元富99購07  ,0,0,0,0,0,0,0,0,0,-18000,0,0,0,0,18000,-18000,-18000
05841P,華通元大96售04  ,0,0,0,0,0,0,0,0,0,-18000,0,0,0,20000,38000,-18000,-18000
058425,S&P正2元富01購02,0,0,0,0,0,0,0,0,0,-18000,0,0,0,2000,20000,-18000,-18000
0053,元大電子        ,0,0,0,0,0,0,0,0,0,-18000,0,0,0,1000,19000,-18000,-18000
04578P,微星富邦96售01  ,0,0,0,0,0,0,0,0,0,-18000,0,0,0,47000,65000,-18000,-18000
044763,瀚宇博凱基93購01,0,0,0,0,0,0,0,0,0,-18000,0,0,0,15000,33000,-18000,-18000
047989,深中小元大96購02,0,0,0,0,0,0,0,0,0,-18000,0,0,0,222000,240000,-18000,-18000
047995,台達電元大96購01,0,0,0,0,0,0,0,0,0,-18000,0,0,0,50000,68000,-18000,-18000
048417,國巨統一94購01  ,0,0,0,0,0,0,0,0,0,-18000,0,0,0,4000,22000,-18000,-18000
049794,台達電元大94購10,0,0,0,0,0,0,0,0,0,-18000,0,0,0,50000,68000,-18000,-18000
052096,力成元大95購01  ,0,0,0,0,0,0,0,0,0,-18000,0,0,0,58000,76000,-18000,-18000
051501,康友群益95購02  ,0,0,0,0,0,0,0,0,0,-18000,0,0,0,53000,71000,-18000,-18000
050419,鴻海凱基95購02  ,0,0,0,0,0,0,0,0,0,-18000,0,0,0,0,18000,-18000,-18000
051340,健策永豐95購03  ,0,0,0,0,0,0,0,0,0,-18000,0,0,0,2000,20000,-18000,-18000
050357,南電群益94購02  ,0,0,0,0,0,0,0,0,0,-18000,0,0,0,2000,20000,-18000,-18000
053265,南亞科群益96購02,0,0,0,0,0,0,0,0,0,-18000,0,0,0,2000,20000,-18000,-18000
053130,聯發科麥證96購01,0,0,0,49000,67000,-18000,0,0,0,-18000,0,0,0,49000,67000,-18000,-18000
051012,台積電凱基95購04,0,0,0,0,0,0,0,0,0,-18000,0,0,0,0,18000,-18000,-18000
050069,禾伸堂凱基94購04,0,0,0,0,0,0,0,0,0,-18000,0,0,0,20000,38000,-18000,-18000
053784,奇力新元大97購02,0,0,0,0,0,0,0,0,0,-18000,0,0,0,65000,83000,-18000,-18000
055340,華新科日盛97購01,0,0,0,0,0,0,0,0,0,-18000,0,0,0,2000,20000,-18000,-18000
055487,國巨元大98購07  ,0,0,0,0,0,0,0,0,0,-18000,0,0,0,102000,120000,-18000,-18000
056429,華通凱基98購02  ,0,0,0,0,0,0,0,0,0,-18000,0,0,0,158000,176000,-18000,-18000
056242,緯創群益9A購01  ,0,0,0,0,0,0,0,0,0,-18000,0,0,0,42000,60000,-18000,-18000
06707P,臺股指台新99售04,0,0,0,0,0,0,0,0,0,-18000,0,0,0,1009000,1027000,-18000,-18000
1216,統一            ,10256000,10367281,-111281,0,0,0,64000,0,64000,29000,38000,11000,27000,3000,1000,2000,-18281
058589,群創中信01購01  ,0,0,0,0,0,0,0,0,0,-19000,0,0,0,0,19000,-19000,-19000
058631,鈺齊國票9A購01  ,0,0,0,0,0,0,0,0,0,-19000,0,0,0,200000,219000,-19000,-19000
058213,欣興群益99購01  ,0,0,0,0,0,0,0,0,0,-19000,0,0,0,16000,35000,-19000,-19000
056471,台光電元大99購01,0,0,0,0,0,0,0,0,0,-19000,0,0,0,0,19000,-19000,-19000
056506,晶豪科永豐98購02,0,0,0,0,0,0,0,0,0,-19000,0,0,0,1000,20000,-19000,-19000
056675,聯發科元富02購01,0,0,0,0,0,0,0,0,0,-19000,0,0,0,1000,20000,-19000,-19000
056697,緯穎群益98購01  ,0,0,0,0,0,0,0,0,0,-19000,0,0,0,39000,58000,-19000,-19000
057084,立積統一9B購01  ,0,0,0,0,0,0,0,0,0,-19000,0,0,0,24000,43000,-19000,-19000
057296,智原永豐98購01  ,0,0,0,0,0,0,0,0,0,-19000,0,0,0,21000,40000,-19000,-19000
049713,鴻海凱基94購17  ,0,0,0,0,0,0,0,0,0,-19000,0,0,0,10000,29000,-19000,-19000
048088,台積電凱基93購23,0,0,0,0,0,0,0,0,0,-19000,0,0,0,0,19000,-19000,-19000
047737,義隆麥證94購01  ,0,0,0,21000,40000,-19000,0,0,0,-19000,0,0,0,21000,40000,-19000,-19000
049298,矽格群益95購01  ,0,0,0,0,0,0,0,0,0,-19000,0,0,0,28000,47000,-19000,-19000
047395,聯茂元大94購01  ,0,0,0,0,0,0,0,0,0,-19000,0,0,0,6000,25000,-19000,-19000
04638P,臺股指群益94售13,0,0,0,0,0,0,0,0,0,-19000,0,0,0,0,19000,-19000,-19000
050061,聯發科凱基94購07,0,0,0,0,0,0,0,0,0,-19000,0,0,0,31000,50000,-19000,-19000
053185,友達中信99購01  ,0,0,0,0,0,0,0,0,0,-19000,0,0,0,0,19000,-19000,-19000
053026,奇力新富邦98購01,0,0,0,0,0,0,0,0,0,-19000,0,0,0,1000,20000,-19000,-19000
05034P,台積電元大95售08,0,0,0,0,0,0,0,0,0,-19000,0,0,0,551000,570000,-19000,-19000
053379,南亞科元大96購01,0,0,0,0,0,0,0,0,0,-19000,0,0,0,2000,21000,-19000,-19000
053450,同欣電凱基96購02,0,0,0,0,0,0,0,0,0,-19000,0,0,0,21000,40000,-19000,-19000
055629,華新科永豐97購04,0,0,0,0,0,0,0,0,0,-19000,0,0,0,1000,20000,-19000,-19000
055297,啟碁元大97購01  ,0,0,0,0,0,0,0,0,0,-19000,0,0,0,0,19000,-19000,-19000
055181,日電貿統一97購01,0,0,0,0,0,0,0,0,0,-19000,0,0,0,1000,20000,-19000,-19000
055214,聯電凱基97購02  ,0,0,0,0,0,0,0,0,0,-19000,0,0,0,114000,133000,-19000,-19000
053884,緯穎第一96購01  ,0,0,0,0,0,0,0,0,0,-19000,0,0,0,16000,35000,-19000,-19000
053927,牧德國票97購01  ,0,0,0,0,0,0,0,0,0,-19000,0,0,0,10000,29000,-19000,-19000
054067,百和國票97購03  ,0,0,0,0,0,0,0,0,0,-19000,0,0,0,1680000,1699000,-19000,-19000
054039,元油反元大96購08,0,0,0,0,0,0,0,0,0,-19000,0,0,0,8000,27000,-19000,-19000
054376,聯茂中信97購01  ,0,0,0,0,0,0,0,0,0,-19000,0,0,0,150000,169000,-19000,-19000
054415,奇力新元大96購06,0,0,0,0,0,0,0,0,0,-19000,0,0,0,1000,20000,-19000,-19000
055005,晶相光元富97購01,0,0,0,0,0,0,0,0,0,-19000,0,0,0,218000,237000,-19000,-19000
054676,牧德台新98購01  ,0,0,0,0,0,0,0,0,0,-19000,0,0,0,1000,20000,-19000,-19000
07014P,華通元大99售04  ,0,0,0,0,0,0,0,0,0,-19000,0,0,0,0,19000,-19000,-19000
06125P,楠梓電元富99售01,0,0,0,0,0,0,0,0,0,-19000,0,0,0,14000,33000,-19000,-19000
4942,嘉彰            ,79000,98000,-19000,0,0,0,0,0,0,0,0,0,0,0,0,0,-19000
057313,聯發科麥證99購01,0,0,0,30000,50000,-20000,0,0,0,-20000,0,0,0,30000,50000,-20000,-20000
057279,國揚元大98購01  ,0,0,0,0,0,0,0,0,0,-20000,0,0,0,0,20000,-20000,-20000
057273,智邦元大98購05  ,0,0,0,0,0,0,0,0,0,-20000,0,0,0,75000,95000,-20000,-20000
057246,元油2X統一99購01,0,0,0,0,0,0,0,0,0,-20000,0,0,0,0,20000,-20000,-20000
057117,開發金日盛9B購01,0,0,0,0,0,0,0,0,0,-20000,0,0,0,0,20000,-20000,-20000
057542,上銀凱基99購01  ,0,0,0,0,0,0,0,0,0,-20000,0,0,0,10000,30000,-20000,-20000
05752P,台積電中信96售06,0,0,0,0,0,0,0,0,0,-20000,0,0,0,0,20000,-20000,-20000
057520,元油2X元大98購15,0,0,0,0,0,0,0,0,0,-20000,0,0,0,0,20000,-20000,-20000
057400,全新群益9A購01  ,0,0,0,0,0,0,0,0,0,-20000,0,0,0,0,20000,-20000,-20000
056715,瀚宇博永豐98購01,0,0,0,0,0,0,0,0,0,-20000,0,0,0,0,20000,-20000,-20000
056641,華通凱基98購03  ,0,0,0,0,0,0,0,0,0,-20000,0,0,0,8000,28000,-20000,-20000
056440,智邦凱基98購03  ,0,0,0,0,0,0,0,0,0,-20000,0,0,0,8000,28000,-20000,-20000
056977,國巨群益9A購01  ,0,0,0,0,0,0,0,0,0,-20000,0,0,0,0,20000,-20000,-20000
056895,技嘉元大98購01  ,0,0,0,0,0,0,0,0,0,-20000,0,0,0,34000,54000,-20000,-20000
056723,國巨中信9A購01  ,0,0,0,0,0,0,0,0,0,-20000,0,0,0,10000,30000,-20000,-20000
058264,瑞昱永豐99購01  ,0,0,0,0,0,0,0,0,0,-20000,0,0,0,0,20000,-20000,-20000
058194,勤誠永豐99購01  ,0,0,0,0,0,0,0,0,0,-20000,0,0,0,0,20000,-20000,-20000
057754,臺股指國票98購10,0,0,0,0,0,0,0,0,0,-20000,0,0,0,0,20000,-20000,-20000
057686,中50凱基99購01  ,0,0,0,0,0,0,0,0,0,-20000,0,0,0,0,20000,-20000,-20000
057727,華邦電國泰9A購01,0,0,0,0,0,0,0,0,0,-20000,0,0,0,30000,50000,-20000,-20000
057717,友訊元富98購02  ,0,0,0,0,0,0,0,0,0,-20000,0,0,0,50000,70000,-20000,-20000
058693,旭富國票9A購01  ,0,0,0,0,0,0,0,0,0,-20000,0,0,0,0,20000,-20000,-20000
05981P,可成永昌98售02  ,0,0,0,0,0,0,0,0,0,-20000,0,0,0,85000,105000,-20000,-20000
05856P,A50正2中信99售01,0,0,0,0,0,0,0,0,0,-20000,0,0,0,35000,55000,-20000,-20000
058538,智邦台新99購02  ,0,0,0,0,0,0,0,0,0,-20000,0,0,0,0,20000,-20000,-20000
058518,玉晶光元大99購13,0,0,0,0,0,0,0,0,0,-20000,0,0,0,0,20000,-20000,-20000
058459,南電永豐99購01  ,0,0,0,0,0,0,0,0,0,-20000,0,0,0,0,20000,-20000,-20000
058428,大立光元富99購02,0,0,0,0,0,0,0,0,0,-20000,0,0,0,14000,34000,-20000,-20000
058292,上銀凱基9A購01  ,0,0,0,0,0,0,0,0,0,-20000,0,0,0,0,20000,-20000,-20000
046438,群創群益95購01  ,0,0,0,0,0,0,0,0,0,-20000,0,0,0,0,20000,-20000,-20000
046479,群創元富94購01  ,0,0,0,0,0,0,0,0,0,-20000,0,0,0,20000,40000,-20000,-20000
044255,群創元大93購01  ,0,0,0,0,0,0,0,0,0,-20000,0,0,0,0,20000,-20000,-20000
04417P,光罩國泰95售02  ,0,0,0,0,0,0,0,0,0,-20000,0,0,0,0,20000,-20000,-20000
044011,鴻海凱基93購03  ,0,0,0,0,0,0,0,0,0,-20000,0,0,0,1000,21000,-20000,-20000
03646C,臺股指元大95牛32,0,0,0,0,0,0,0,0,0,-20000,0,0,0,23000,43000,-20000,-20000
046242,大立光中信93購02,0,0,0,0,0,0,0,0,0,-20000,0,0,0,0,20000,-20000,-20000
01010T,京城樂富R1      ,0,0,0,0,0,0,0,0,0,-20000,0,20000,-20000,0,0,0,-20000
03591P,台積電國票03售10,0,0,0,0,0,0,0,0,0,-20000,0,0,0,0,20000,-20000,-20000
04740P,台積電富邦95售02,0,0,0,0,0,0,0,0,0,-20000,0,0,0,0,20000,-20000,-20000
047227,華新科凱基94購01,0,0,0,0,0,0,0,0,0,-20000,0,0,0,0,20000,-20000,-20000
047289,啟碁統一97購01  ,0,0,0,0,0,0,0,0,0,-20000,0,0,0,0,20000,-20000,-20000
047495,新日興元富96購01,0,0,0,0,0,0,0,0,0,-20000,0,0,0,50000,70000,-20000,-20000
049308,台達電凱基94購04,0,0,0,0,0,0,0,0,0,-20000,0,0,0,0,20000,-20000,-20000
049313,晶技凱基94購01  ,0,0,0,0,0,0,0,0,0,-20000,0,0,0,0,20000,-20000,-20000
04926P,聯發科凱基95售03,0,0,0,0,0,0,0,0,0,-20000,0,0,0,200000,220000,-20000,-20000
049247,光寶科元大94購02,0,0,0,0,0,0,0,0,0,-20000,0,0,0,0,20000,-20000,-20000
049613,華通中信94購01  ,0,0,0,0,0,0,0,0,0,-20000,0,0,0,0,20000,-20000,-20000
049544,台積電群益94購08,0,0,0,0,0,0,0,0,0,-20000,0,0,0,15000,35000,-20000,-20000
044987,宏達電統一94購01,0,0,0,0,0,0,0,0,0,-20000,0,0,0,40000,60000,-20000,-20000
045535,A50正2群益94購01,0,0,0,0,0,0,0,0,0,-20000,0,0,0,0,20000,-20000,-20000
045213,A50正2元大95購01,0,0,0,0,0,0,0,0,0,-20000,0,0,0,180000,200000,-20000,-20000
045231,南電元大94購01  ,0,0,0,0,0,0,0,0,0,-20000,0,0,0,0,20000,-20000,-20000
045071,奇力新元大94購01,0,0,0,0,0,0,0,0,0,-20000,0,0,0,0,20000,-20000,-20000
045760,鴻海統一93購02  ,0,0,0,0,0,0,0,0,0,-20000,0,0,0,0,20000,-20000,-20000
047013,超眾元富96購01  ,0,0,0,0,0,0,0,0,0,-20000,0,0,0,30000,50000,-20000,-20000
04346P,大立光兆豐95售02,0,0,0,0,0,0,0,0,0,-20000,0,0,0,0,20000,-20000,-20000
04379P,大立光元大94售06,0,0,0,0,0,0,0,0,0,-20000,0,0,0,0,20000,-20000,-20000
046869,聯發科統一95購01,0,0,0,0,0,0,0,0,0,-20000,0,0,0,43000,63000,-20000,-20000
048001,中工元大96購01  ,0,0,0,0,0,0,0,0,0,-20000,0,0,0,0,20000,-20000,-20000
04788P,台積電永昌96售05,0,0,0,0,0,0,0,0,0,-20000,0,0,0,0,20000,-20000,-20000
049472,楠梓電永豐95購01,0,0,0,0,0,0,0,0,0,-20000,0,0,0,20000,40000,-20000,-20000
049454,群創統一94購01  ,0,0,0,0,0,0,0,0,0,-20000,0,0,0,0,20000,-20000,-20000
048560,聯發科元大94購01,0,0,0,0,0,0,0,0,0,-20000,0,0,0,0,20000,-20000,-20000
048564,智易元大94購01  ,0,0,0,0,0,0,0,0,0,-20000,0,0,0,0,20000,-20000,-20000
049702,台表科元大95購03,0,0,0,0,0,0,0,0,0,-20000,0,0,0,0,20000,-20000,-20000
049687,國巨元大94購09  ,0,0,0,0,0,0,0,0,0,-20000,0,0,0,0,20000,-20000,-20000
049688,台光電元大94購04,0,0,0,0,0,0,0,0,0,-20000,0,0,0,27000,47000,-20000,-20000
049899,台積電元富94購05,0,0,0,0,0,0,0,0,0,-20000,0,0,0,3000,23000,-20000,-20000
049335,聯電統一97購01  ,0,0,0,0,0,0,0,0,0,-20000,0,0,0,0,20000,-20000,-20000
049340,鴻海統一94購03  ,0,0,0,0,0,0,0,0,0,-20000,0,0,0,0,20000,-20000,-20000
049344,華固統一94購01  ,0,0,0,0,0,0,0,0,0,-20000,0,0,0,10000,30000,-20000,-20000
048311,台積電凱基93購28,0,0,0,0,0,0,0,0,0,-20000,0,0,0,0,20000,-20000,-20000
050003,景碩永豐94購01  ,0,0,0,0,0,0,0,0,0,-20000,0,0,0,0,20000,-20000,-20000
05001P,華通統一95售01  ,0,0,0,0,0,0,0,0,0,-20000,0,0,0,0,20000,-20000,-20000
049018,光罩群益94購01  ,0,0,0,0,0,0,0,0,0,-20000,0,0,0,0,20000,-20000,-20000
049056,玉晶光永豐95購03,0,0,0,0,0,0,0,0,0,-20000,0,0,0,10000,30000,-20000,-20000
048588,世紀鋼中信94購01,0,0,0,0,0,0,0,0,0,-20000,0,0,0,0,20000,-20000,-20000
048765,奇力新凱基94購01,0,0,0,0,0,0,0,0,0,-20000,0,0,0,0,20000,-20000,-20000
048835,牧德凱基94購02  ,0,0,0,0,0,0,0,0,0,-20000,0,0,0,10000,30000,-20000,-20000
052778,智原國票97購01  ,0,0,0,0,0,0,0,0,0,-20000,0,0,0,30000,50000,-20000,-20000
052790,智邦兆豐97購01  ,0,0,0,0,0,0,0,0,0,-20000,0,0,0,12000,32000,-20000,-20000
049176,漢唐凱基94購02  ,0,0,0,0,0,0,0,0,0,-20000,0,0,0,0,20000,-20000,-20000
052908,大成鋼統一96購01,0,0,0,0,0,0,0,0,0,-20000,0,0,0,0,20000,-20000,-20000
052925,日電貿永豐96購01,0,0,0,0,0,0,0,0,0,-20000,0,0,0,0,20000,-20000,-20000
052548,旺宏亞東96購01  ,0,0,0,0,0,0,0,0,0,-20000,0,0,0,0,20000,-20000,-20000
053491,鴻海兆豐97購02  ,0,0,0,0,0,0,0,0,0,-20000,0,0,0,53000,73000,-20000,-20000
053363,旺宏國泰98購02  ,0,0,0,0,0,0,0,0,0,-20000,0,0,0,40000,60000,-20000,-20000
053280,群創元大9C購01  ,0,0,0,0,0,0,0,0,0,-20000,0,0,0,67000,87000,-20000,-20000
053553,聯詠凱基96購03  ,0,0,0,0,0,0,0,0,0,-20000,0,0,0,0,20000,-20000,-20000
05357P,臺股指元富95售11,0,0,0,0,0,0,0,0,0,-20000,460000,0,460000,0,480000,-480000,-20000
053582,英業達元大97購01,0,0,0,0,0,0,0,0,0,-20000,0,0,0,0,20000,-20000,-20000
053500,新日興兆豐97購01,0,0,0,0,0,0,0,0,0,-20000,0,0,0,0,20000,-20000,-20000
053510,聯電群益97購01  ,0,0,0,0,0,0,0,0,0,-20000,0,0,0,37000,57000,-20000,-20000
05367P,鴻海元富95售13  ,0,0,0,0,0,0,0,0,0,-20000,0,0,0,10000,30000,-20000,-20000
052367,聯茂國票96購02  ,0,0,0,0,0,0,0,0,0,-20000,0,0,0,0,20000,-20000,-20000
052380,臺股指元大95購21,0,0,0,0,0,0,0,0,0,-20000,0,0,0,5000,25000,-20000,-20000
052383,臺股指元大95購29,0,0,0,0,0,0,0,0,0,-20000,0,0,0,0,20000,-20000,-20000
052393,康友群益95購05  ,0,0,0,0,0,0,0,0,0,-20000,0,0,0,53000,73000,-20000,-20000
052229,奇力新凱基96購01,0,0,0,0,0,0,0,0,0,-20000,0,0,0,0,20000,-20000,-20000
052214,智伸科元大96購01,0,0,0,0,0,0,0,0,0,-20000,0,0,0,0,20000,-20000,-20000
051537,牧德國票96購01  ,0,0,0,0,0,0,0,0,0,-20000,0,0,0,15000,35000,-20000,-20000
051584,可成元大95購08  ,0,0,0,0,0,0,0,0,0,-20000,0,0,0,30000,50000,-20000,-20000
052091,緯創元大95購04  ,0,0,0,0,0,0,0,0,0,-20000,0,0,0,0,20000,-20000,-20000
052067,中磊兆豐96購01  ,0,0,0,0,0,0,0,0,0,-20000,0,0,0,0,20000,-20000,-20000
052068,瑞儀兆豐96購01  ,0,0,0,0,0,0,0,0,0,-20000,0,0,0,0,20000,-20000,-20000
051781,緯穎群益96購01  ,0,0,0,0,0,0,0,0,0,-20000,0,0,0,0,20000,-20000,-20000
053106,鴻海兆豐98購01  ,0,0,0,0,0,0,0,0,0,-20000,0,0,0,0,20000,-20000,-20000
053177,華邦電統一96購01,0,0,0,0,0,0,0,0,0,-20000,0,0,0,0,20000,-20000,-20000
053206,聯發科麥證96購02,0,0,0,10000,30000,-20000,0,0,0,-20000,0,0,0,10000,30000,-20000,-20000
050994,欣興元大96購03  ,0,0,0,0,0,0,0,0,0,-20000,0,0,0,0,20000,-20000,-20000
053002,鴻海永豐96購01  ,0,0,0,0,0,0,0,0,0,-20000,0,0,0,0,20000,-20000,-20000
050063,聯發科凱基94購09,0,0,0,0,0,0,0,0,0,-20000,0,0,0,0,20000,-20000,-20000
052640,台表科凱基97購01,0,0,0,0,0,0,0,0,0,-20000,0,0,0,0,20000,-20000,-20000
050921,旺宏凱基95購02  ,0,0,0,0,0,0,0,0,0,-20000,0,0,0,3000,23000,-20000,-20000
05016P,臺股指元大95售07,0,0,0,0,0,0,0,0,0,-20000,0,0,0,0,20000,-20000,-20000
053266,全新群益98購01  ,0,0,0,0,0,0,0,0,0,-20000,0,0,0,0,20000,-20000,-20000
053226,國巨台新97購02  ,0,0,0,0,0,0,0,0,0,-20000,0,0,0,0,20000,-20000,-20000
053209,台積電凱基96購07,0,0,0,0,0,0,0,0,0,-20000,0,0,0,0,20000,-20000,-20000
050216,奇力新永豐94購04,0,0,0,0,0,0,0,0,0,-20000,0,0,0,10000,30000,-20000,-20000
053056,同欣電國票97購01,0,0,0,0,0,0,0,0,0,-20000,0,0,0,15000,35000,-20000,-20000
050231,聯發科麥證94購03,0,0,0,40000,60000,-20000,0,0,0,-20000,0,0,0,40000,60000,-20000,-20000
050587,緯穎國票94購02  ,0,0,0,0,0,0,0,0,0,-20000,0,0,0,10000,30000,-20000,-20000
050634,華新科群益96購01,0,0,0,0,0,0,0,0,0,-20000,0,0,0,24000,44000,-20000,-20000
051150,宏達電凱基95購02,0,0,0,0,0,0,0,0,0,-20000,0,0,0,280000,300000,-20000,-20000
050538,鴻海凱基95購06  ,0,0,0,0,0,0,0,0,0,-20000,0,0,0,0,20000,-20000,-20000
051230,聯詠群益95購01  ,0,0,0,0,0,0,0,0,0,-20000,0,0,0,0,20000,-20000,-20000
051178,大立光凱基95購10,0,0,0,0,0,0,0,0,0,-20000,0,0,0,0,20000,-20000,-20000
051448,聯詠元大95購02  ,0,0,0,0,0,0,0,0,0,-20000,0,0,0,0,20000,-20000,-20000
051995,矽力元大95購03  ,0,0,0,0,0,0,0,0,0,-20000,0,0,0,21000,41000,-20000,-20000
050788,台郡國泰96購01  ,0,0,0,0,0,0,0,0,0,-20000,0,0,0,0,20000,-20000,-20000
050791,聯發科富邦96購01,0,0,0,0,0,0,0,0,0,-20000,0,0,0,7000,27000,-20000,-20000
050713,矽格麥證94購01  ,0,0,0,0,20000,-20000,0,0,0,-20000,0,0,0,0,20000,-20000,-20000
050751,聯電統一94購05  ,0,0,0,0,0,0,0,0,0,-20000,0,0,0,199000,219000,-20000,-20000
052949,智易國票97購02  ,0,0,0,0,0,0,0,0,0,-20000,0,0,0,0,20000,-20000,-20000
05294P,亞光凱基95售02  ,0,0,0,0,0,0,0,0,0,-20000,0,0,0,0,20000,-20000,-20000
054732,台化凱基98購01  ,0,0,0,0,0,0,0,0,0,-20000,0,0,0,0,20000,-20000,-20000
054823,祥碩元大97購02  ,0,0,0,0,0,0,0,0,0,-20000,0,0,0,0,20000,-20000,-20000
054757,南亞國票98購01  ,0,0,0,0,0,0,0,0,0,-20000,0,0,0,0,20000,-20000,-20000
055030,帆宣國泰99購02  ,0,0,0,0,0,0,0,0,0,-20000,0,0,0,0,20000,-20000,-20000
055031,南港富邦99購01  ,0,0,0,0,0,0,0,0,0,-20000,0,0,0,10000,30000,-20000,-20000
055029,帆宣國泰99購01  ,0,0,0,0,0,0,0,0,0,-20000,0,0,0,0,20000,-20000,-20000
05507P,聯茂凱基96售02  ,0,0,0,0,0,0,0,0,0,-20000,0,0,0,0,20000,-20000,-20000
055163,訊芯元大98購01  ,0,0,0,0,0,0,0,0,0,-20000,0,0,0,10000,30000,-20000,-20000
055138,大毅永豐97購02  ,0,0,0,0,0,0,0,0,0,-20000,0,0,0,0,20000,-20000,-20000
054958,亞光元大97購03  ,0,0,0,0,0,0,0,0,0,-20000,0,0,0,0,20000,-20000,-20000
054407,美律國票97購02  ,0,0,0,0,0,0,0,0,0,-20000,0,0,0,0,20000,-20000,-20000
054401,康普永豐96購01  ,0,0,0,0,0,0,0,0,0,-20000,0,0,0,0,20000,-20000,-20000
054434,友達台新96購03  ,0,0,0,0,0,0,0,0,0,-20000,0,0,0,0,20000,-20000,-20000
054454,滬深2X群益96購04,0,0,0,0,0,0,0,0,0,-20000,0,0,0,60000,80000,-20000,-20000
054320,國喬台新96購01  ,0,0,0,0,0,0,0,0,0,-20000,0,0,0,0,20000,-20000,-20000
054172,易華電凱基98購01,0,0,0,0,0,0,0,0,0,-20000,0,0,0,0,20000,-20000,-20000
054238,聯茂群益96購04  ,0,0,0,0,0,0,0,0,0,-20000,0,0,0,0,20000,-20000,-20000
054222,大立光統一98購03,0,0,0,0,0,0,0,0,0,-20000,0,0,0,0,20000,-20000,-20000
054085,華新科統一96購04,0,0,0,0,0,0,0,0,0,-20000,0,0,0,43000,63000,-20000,-20000
054100,致伸國票97購03  ,0,0,0,0,0,0,0,0,0,-20000,0,0,0,0,20000,-20000,-20000
053905,華新科凱基96購10,0,0,0,0,0,0,0,0,0,-20000,0,0,0,10000,30000,-20000,-20000
053745,康友國票97購01  ,0,0,0,0,0,0,0,0,0,-20000,0,0,0,41000,61000,-20000,-20000
053819,大立光群益96購04,0,0,0,0,0,0,0,0,0,-20000,0,0,0,0,20000,-20000,-20000
055174,精元統一97購01  ,0,0,0,0,0,0,0,0,0,-20000,0,0,0,20000,40000,-20000,-20000
05519P,上証2X凱基98售01,0,0,0,0,0,0,0,0,0,-20000,0,0,0,0,20000,-20000,-20000
055326,緯穎國票97購06  ,0,0,0,0,0,0,0,0,0,-20000,0,0,0,14000,34000,-20000,-20000
055620,樺漢國票98購01  ,0,0,0,0,0,0,0,0,0,-20000,0,0,0,30000,50000,-20000,-20000
055691,訊芯凱基97購02  ,0,0,0,0,0,0,0,0,0,-20000,0,0,0,0,20000,-20000,-20000
055650,華新科元富98購01,0,0,0,0,0,0,0,0,0,-20000,0,0,0,21000,41000,-20000,-20000
055721,聯詠元大97購04  ,0,0,0,0,0,0,0,0,0,-20000,0,0,0,68000,88000,-20000,-20000
056275,國巨國泰98購04  ,0,0,0,0,0,0,0,0,0,-20000,0,0,0,0,20000,-20000,-20000
056276,同欣電國泰98購01,0,0,0,0,0,0,0,0,0,-20000,0,0,0,98000,118000,-20000,-20000
056191,世紀鋼統一97購01,0,0,0,0,0,0,0,0,0,-20000,0,0,0,40000,60000,-20000,-20000
056204,嘉澤永豐97購01  ,0,0,0,0,0,0,0,0,0,-20000,0,0,0,0,20000,-20000,-20000
055906,大立光兆豐97購03,0,0,0,0,0,0,0,0,0,-20000,0,0,0,0,20000,-20000,-20000
056043,力成凱基97購01  ,0,0,0,0,0,0,0,0,0,-20000,0,0,0,0,20000,-20000,-20000
3588,通嘉            ,74000,94000,-20000,0,0,0,0,0,0,0,4000,4000,0,0,0,0,-20000
06078P,臺股指凱基9A售01,0,0,0,0,0,0,0,0,0,-20000,0,0,0,38000,58000,-20000,-20000
06166P,大立光國票98售01,0,0,0,0,0,0,0,0,0,-20000,0,0,0,0,20000,-20000,-20000
06244P,智易元富97售02  ,0,0,0,0,0,0,0,0,0,-20000,0,0,0,0,20000,-20000,-20000
06335P,台積電麥證97售02,0,0,0,50000,70000,-20000,0,0,0,-20000,0,0,0,50000,70000,-20000,-20000
06771P,台灣50中信02售01,0,0,0,0,0,0,0,0,0,-20000,0,0,0,24000,44000,-20000,-20000
06639P,訊芯元富98售04  ,0,0,0,0,0,0,0,0,0,-20000,0,0,0,0,20000,-20000,-20000
06469P,臺股指凱基99售09,0,0,0,0,0,0,0,0,0,-20000,0,0,0,334000,354000,-20000,-20000
06570P,大立光永豐98售01,0,0,0,0,0,0,0,0,0,-20000,0,0,0,0,20000,-20000,-20000
07013P,玉晶光群益9A售06,0,0,0,0,0,0,0,0,0,-20000,0,0,0,0,20000,-20000,-20000
06953P,景碩統一9A售01  ,0,0,0,0,0,0,0,0,0,-20000,0,0,0,55000,75000,-20000,-20000
08164P,滬深2X中信95售04,0,0,0,0,0,0,0,0,0,-20000,0,0,0,0,20000,-20000,-20000
06896P,信邦中信98售01  ,0,0,0,0,0,0,0,0,0,-20000,0,0,0,0,20000,-20000,-20000
1516,川飛            ,11000,31000,-20000,0,0,0,0,0,0,0,0,0,0,0,0,0,-20000
058440,玉晶光統一99購02,0,0,0,0,0,0,0,0,0,-21000,0,0,0,1000,22000,-21000,-21000
058461,滬深2X永昌9C購01,0,0,0,0,0,0,0,0,0,-21000,0,0,0,0,21000,-21000,-21000
058708,臺股指元大9A購21,0,0,0,0,0,0,0,0,0,-21000,0,0,0,0,21000,-21000,-21000
057944,新日興國票99購02,0,0,0,0,0,0,0,0,0,-21000,0,0,0,115000,136000,-21000,-21000
058164,FBVIX凱基03購02 ,0,0,0,0,0,0,0,0,0,-21000,0,0,0,14000,35000,-21000,-21000
058118,瑞昱群益99購01  ,0,0,0,0,0,0,0,0,0,-21000,0,0,0,107000,128000,-21000,-21000
056788,日月光群益98購01,0,0,0,0,0,0,0,0,0,-21000,0,0,0,102000,123000,-21000,-21000
056443,南亞科凱基98購03,0,0,0,0,0,0,0,0,0,-21000,0,0,0,0,21000,-21000,-21000
056659,泰碩元大99購01  ,0,0,0,0,0,0,0,0,0,-21000,0,0,0,110000,131000,-21000,-21000
048729,鴻海麥證94購01  ,0,0,0,0,22000,-22000,0,0,0,-21000,0,0,0,1000,22000,-21000,-21000
04897P,喬山中信94售01  ,0,0,0,0,0,0,0,0,0,-21000,0,0,0,0,21000,-21000,-21000
048874,玉晶光國票96購01,0,0,0,0,0,0,0,0,0,-21000,0,0,0,29000,50000,-21000,-21000
045106,玉晶光群益95購01,0,0,0,0,0,0,0,0,0,-21000,0,0,0,2000,23000,-21000,-21000
04426P,佳世達康和94售02,0,0,0,0,0,0,0,0,0,-21000,0,0,0,79000,100000,-21000,-21000
051974,華新科凱基96購05,0,0,0,0,0,0,0,0,0,-21000,0,0,0,20000,41000,-21000,-21000
050675,奇鋐富邦96購01  ,0,0,0,0,0,0,0,0,0,-21000,0,0,0,0,21000,-21000,-21000
051805,元黃金凱基97購02,0,0,0,0,0,0,0,0,0,-21000,0,0,0,10000,31000,-21000,-21000
050955,達方群益97購01  ,0,0,0,0,0,0,0,0,0,-21000,0,0,0,21000,42000,-21000,-21000
051931,美律國票96購02  ,0,0,0,0,0,0,0,0,0,-21000,0,0,0,163000,184000,-21000,-21000
053170,茂林群益96購04  ,0,0,0,0,0,0,0,0,0,-21000,0,0,0,32000,53000,-21000,-21000
052105,南亞科兆豐95購01,0,0,0,0,0,0,0,0,0,-21000,0,0,0,0,21000,-21000,-21000
050350,全新群益94購04  ,0,0,0,0,0,0,0,0,0,-21000,0,0,0,141000,162000,-21000,-21000
052429,禾伸堂永豐95購02,0,0,0,0,0,0,0,0,0,-21000,0,0,0,0,21000,-21000,-21000
053658,亞光凱基96購01  ,0,0,0,0,0,0,0,0,0,-21000,0,0,0,10000,31000,-21000,-21000
053299,台泥凱基96購01  ,0,0,0,0,0,0,0,0,0,-21000,0,0,0,0,21000,-21000,-21000
055882,嘉聯益元富97購01,0,0,0,0,0,0,0,0,0,-21000,0,0,0,0,21000,-21000,-21000
056430,鴻海凱基98購06  ,0,0,0,0,0,0,0,0,0,-21000,0,0,0,120000,141000,-21000,-21000
055774,台光電凱基97購02,0,0,0,0,0,0,0,0,0,-21000,0,0,0,45000,66000,-21000,-21000
055344,國巨凱基97購04  ,0,0,0,0,0,0,0,0,0,-21000,0,0,0,0,21000,-21000,-21000
053880,智邦中信96購01  ,0,0,0,0,0,0,0,0,0,-21000,0,0,0,1000,22000,-21000,-21000
054876,群電群益97購02  ,0,0,0,0,0,0,0,0,0,-21000,0,0,0,0,21000,-21000,-21000
054590,嘉聯益國泰98購01,0,0,0,0,0,0,0,0,0,-21000,0,0,0,0,21000,-21000,-21000
054570,易華電群益98購01,0,0,0,0,0,0,0,0,0,-21000,0,0,0,100000,121000,-21000,-21000
06615P,鴻海元大9C售02  ,0,0,0,0,0,0,0,0,0,-21000,0,0,0,0,21000,-21000,-21000
06094P,台達電中信97售01,0,0,0,0,0,0,0,0,0,-21000,0,0,0,14000,35000,-21000,-21000
056523,光寶科中信98購01,0,0,0,0,0,0,0,0,0,-22000,0,0,0,77000,99000,-22000,-22000
056823,智伸科永豐98購01,0,0,0,0,0,0,0,0,0,-22000,0,0,0,0,22000,-22000,-22000
056871,新日興日盛99購01,0,0,0,0,0,0,0,0,0,-22000,0,0,0,87000,109000,-22000,-22000
056849,瀚宇博元富98購01,0,0,0,0,0,0,0,0,0,-22000,0,0,0,24000,46000,-22000,-22000
056944,鴻海統一98購11  ,0,0,0,0,0,0,0,0,0,-22000,0,0,0,22000,44000,-22000,-22000
057322,旺宏群益98購04  ,0,0,0,0,0,0,0,0,0,-22000,0,0,0,0,22000,-22000,-22000
058110,光寶科元富98購01,0,0,0,0,0,0,0,0,0,-22000,0,0,0,90000,112000,-22000,-22000
058133,華新科元大9A購02,0,0,0,0,0,0,0,0,0,-22000,0,0,0,0,22000,-22000,-22000
058025,聯茂國泰99購01  ,0,0,0,0,0,0,0,0,0,-22000,0,0,0,0,22000,-22000,-22000
058212,華新科群益9A購01,0,0,0,0,0,0,0,0,0,-22000,0,0,0,20000,42000,-22000,-22000
058268,泰碩永豐9A購01  ,0,0,0,0,0,0,0,0,0,-22000,0,0,0,4000,26000,-22000,-22000
057934,華新科群益98購07,0,0,0,0,0,0,0,0,0,-22000,0,0,0,118000,140000,-22000,-22000
057789,上銀統一9A購01  ,0,0,0,0,0,0,0,0,0,-22000,0,0,0,77000,99000,-22000,-22000
058567,華新科凱基9A購02,0,0,0,0,0,0,0,0,0,-22000,0,0,0,20000,42000,-22000,-22000
04126P,滬深2X國票95售02,0,0,0,0,0,0,0,0,0,-22000,0,0,0,0,22000,-22000,-22000
045662,華邦電統一94購02,0,0,0,0,0,0,0,0,0,-22000,0,0,0,0,22000,-22000,-22000
047295,欣興元富96購02  ,0,0,0,0,0,0,0,0,0,-22000,0,0,0,100000,122000,-22000,-22000
048843,台郡凱基94購01  ,0,0,0,0,0,0,0,0,0,-22000,0,0,0,0,22000,-22000,-22000
048402,聯茂兆豐95購01  ,0,0,0,0,0,0,0,0,0,-22000,0,0,0,0,22000,-22000,-22000
049885,緯穎永豐94購01  ,0,0,0,0,0,0,0,0,0,-22000,0,0,0,21000,43000,-22000,-22000
053069,同欣電群益98購01,0,0,0,0,0,0,0,0,0,-22000,0,0,0,128000,150000,-22000,-22000
050406,台積電台新95購02,0,0,0,0,0,0,0,0,0,-22000,0,0,0,12000,34000,-22000,-22000
052965,廣宇群益97購01  ,0,0,0,0,0,0,0,0,0,-22000,0,0,0,0,22000,-22000,-22000
051739,奇力新國票97購01,0,0,0,0,0,0,0,0,0,-22000,0,0,0,6000,28000,-22000,-22000
051539,瀚宇博國票97購01,0,0,0,0,0,0,0,0,0,-22000,0,0,0,0,22000,-22000,-22000
050952,健策群益96購01  ,0,0,0,0,0,0,0,0,0,-22000,0,0,0,42000,64000,-22000,-22000
050673,旺宏富邦96購02  ,0,0,0,0,0,0,0,0,0,-22000,0,0,0,15000,37000,-22000,-22000
050515,聯電元大96購01  ,0,0,0,0,0,0,0,0,0,-22000,0,0,0,68000,90000,-22000,-22000
051168,訊連元大95購02  ,0,0,0,0,0,0,0,0,0,-22000,0,0,0,65000,87000,-22000,-22000
050704,復盛凱基94購03  ,0,0,0,0,0,0,0,0,0,-22000,0,0,0,3000,25000,-22000,-22000
054716,緯穎康和97購01  ,0,0,0,0,0,0,0,0,0,-22000,0,0,0,6000,28000,-22000,-22000
055065,神達永豐97購01  ,0,0,0,0,0,0,0,0,0,-22000,0,0,0,57000,79000,-22000,-22000
054266,緯穎元大96購07  ,0,0,0,0,0,0,0,0,0,-22000,0,0,0,92000,114000,-22000,-22000
054282,泰鼎群益98購02  ,0,0,0,0,0,0,0,0,0,-22000,0,0,0,208000,230000,-22000,-22000
054178,中磊台新97購01  ,0,0,0,0,0,0,0,0,0,-22000,0,0,0,38000,60000,-22000,-22000
054444,緯穎台新97購01  ,0,0,0,0,0,0,0,0,0,-22000,0,0,0,94000,116000,-22000,-22000
055302,達方元大97購01  ,0,0,0,0,0,0,0,0,0,-22000,0,0,0,112000,134000,-22000,-22000
055593,華新科元大97購10,0,0,0,0,0,0,0,0,0,-22000,0,0,0,88000,110000,-22000,-22000
056432,鴻海凱基98購08  ,0,0,0,0,0,0,0,0,0,-22000,0,0,0,117000,139000,-22000,-22000
055887,上銀統一97購03  ,0,0,0,0,0,0,0,0,0,-22000,0,0,0,10000,32000,-22000,-22000
056054,亞德客元大97購05,0,0,0,0,0,0,0,0,0,-22000,0,0,0,141000,163000,-22000,-22000
06525P,上証2X國泰99售01,0,0,0,0,0,0,0,0,0,-22000,0,0,0,361000,383000,-22000,-22000
07046P,大立光富邦9C售03,0,0,0,0,0,0,0,0,0,-22000,0,0,0,0,22000,-22000,-22000
1256,鮮活果汁-KY     ,13000,35000,-22000,0,0,0,0,0,0,0,0,0,0,0,0,0,-22000
3501,維熹            ,29000,51000,-22000,0,0,0,0,0,0,0,0,0,0,0,0,0,-22000
058494,可成群益9B購01  ,0,0,0,0,0,0,0,0,0,-23000,0,0,0,0,23000,-23000,-23000
058376,貿聯凱基9A購01  ,0,0,0,0,0,0,0,0,0,-23000,0,0,0,0,23000,-23000,-23000
057765,康舒凱基98購01  ,0,0,0,0,0,0,0,0,0,-23000,0,0,0,0,23000,-23000,-23000
057746,同欣電永豐98購02,0,0,0,0,0,0,0,0,0,-23000,0,0,0,0,23000,-23000,-23000
057751,神達國票99購02  ,0,0,0,0,0,0,0,0,0,-23000,0,0,0,12000,35000,-23000,-23000
057969,緯穎國泰99購01  ,0,0,0,0,0,0,0,0,0,-23000,0,0,0,41000,64000,-23000,-23000
058174,台積電凱基9A購05,0,0,0,0,0,0,0,0,0,-23000,0,0,0,50000,73000,-23000,-23000
057159,晶技永豐98購01  ,0,0,0,0,0,0,0,0,0,-23000,0,0,0,35000,58000,-23000,-23000
057454,上銀國泰99購02  ,0,0,0,0,0,0,0,0,0,-23000,0,0,0,20000,43000,-23000,-23000
057566,欣興富邦99購01  ,0,0,0,0,0,0,0,0,0,-23000,0,0,0,100000,123000,-23000,-23000
057569,光磊永豐98購03  ,0,0,0,0,0,0,0,0,0,-23000,0,0,0,13000,36000,-23000,-23000
056941,台郡元富9B購01  ,0,0,0,0,0,0,0,0,0,-23000,0,0,0,8000,31000,-23000,-23000
056569,T50正2元大9B購02,0,0,0,0,0,0,0,0,0,-23000,0,0,0,0,23000,-23000,-23000
049873,華新科台新94購02,0,0,0,0,0,0,0,0,0,-23000,0,0,0,142000,165000,-23000,-23000
048109,旺宏群益94購02  ,0,0,0,0,0,0,0,0,0,-23000,0,0,0,0,23000,-23000,-23000
048834,牧德凱基94購01  ,0,0,0,0,0,0,0,0,0,-23000,0,0,0,7000,30000,-23000,-23000
048637,鴻海元大96購01  ,0,0,0,0,0,0,0,0,0,-23000,0,0,0,59000,82000,-23000,-23000
046011,欣興元富95購01  ,0,0,0,0,0,0,0,0,0,-23000,0,0,0,8000,31000,-23000,-23000
01007T,兆豐國泰R2      ,1000,24000,-23000,0,0,0,0,0,0,0,0,0,0,0,0,0,-23000
00731,FH富時高息低波  ,1000,0,1000,0,0,0,0,0,0,-24000,0,0,0,148000,172000,-24000,-23000
052948,景碩國票97購02  ,0,0,0,0,0,0,0,0,0,-23000,0,0,0,10000,33000,-23000,-23000
051218,聯發科元富9B購02,0,0,0,0,0,0,0,0,0,-23000,0,0,0,3000,26000,-23000,-23000
051895,聯茂元富95購02  ,0,0,0,0,0,0,0,0,0,-23000,0,0,0,30000,53000,-23000,-23000
051553,牧德永豐96購02  ,0,0,0,0,0,0,0,0,0,-23000,0,0,0,28000,51000,-23000,-23000
050315,和碩兆豐95購01  ,0,0,0,0,0,0,0,0,0,-23000,0,0,0,26000,49000,-23000,-23000
052134,智邦凱基95購09  ,0,0,0,0,0,0,0,0,0,-23000,0,0,0,150000,173000,-23000,-23000
051349,國巨元大95購08  ,0,0,0,0,0,0,0,0,0,-23000,0,0,0,0,23000,-23000,-23000
053635,技嘉永豐96購01  ,0,0,0,0,0,0,0,0,0,-23000,0,0,0,17000,40000,-23000,-23000
056366,玉晶光元大99購04,0,0,0,0,0,0,0,0,0,-23000,0,0,0,2000,25000,-23000,-23000
055327,致新國票98購01  ,0,0,0,0,0,0,0,0,0,-23000,0,0,0,30000,53000,-23000,-23000
054280,牧德群益98購01  ,0,0,0,0,0,0,0,0,0,-23000,0,0,0,6000,29000,-23000,-23000
053990,晶技兆豐96購01  ,0,0,0,0,0,0,0,0,0,-23000,0,0,0,45000,68000,-23000,-23000
055092,開發金群益9B購01,0,0,0,0,0,0,0,0,0,-23000,0,0,0,150000,173000,-23000,-23000
06606P,訊芯元富98售02  ,0,0,0,0,0,0,0,0,0,-23000,0,0,0,67000,90000,-23000,-23000
057398,台郡中信99購01  ,0,0,0,0,0,0,0,0,0,-24000,0,0,0,0,24000,-24000,-24000
058145,聯茂元大99購03  ,0,0,0,0,0,0,0,0,0,-24000,0,0,0,117000,141000,-24000,-24000
058017,漢唐凱基99購01  ,0,0,0,0,0,0,0,0,0,-24000,0,0,0,30000,54000,-24000,-24000
057895,全新元富9B購01  ,0,0,0,0,0,0,0,0,0,-24000,0,0,0,0,24000,-24000,-24000
058389,聯茂國票9A購01  ,0,0,0,0,0,0,0,0,0,-24000,0,0,0,64000,88000,-24000,-24000
058491,滬深2X群益01購01,0,0,0,0,0,0,0,0,0,-24000,0,0,0,36000,60000,-24000,-24000
058579,聯發科群益99購04,0,0,0,0,0,0,0,0,0,-24000,0,0,0,0,24000,-24000,-24000
058596,旺宏台新99購01  ,0,0,0,0,0,0,0,0,0,-24000,0,0,0,0,24000,-24000,-24000
058635,華新科兆豐99購03,0,0,0,0,0,0,0,0,0,-24000,0,0,0,14000,38000,-24000,-24000
045842,T50反1台新98購01,0,0,0,0,0,0,0,0,0,-24000,0,0,0,0,24000,-24000,-24000
046804,群創元大94購01  ,0,0,0,0,0,0,0,0,0,-24000,0,0,0,15000,39000,-24000,-24000
048769,聯鈞凱基94購01  ,0,0,0,0,0,0,0,0,0,-24000,0,0,0,10000,34000,-24000,-24000
047877,滬深2X中信95購07,0,0,0,0,0,0,0,0,0,-24000,0,0,0,48000,72000,-24000,-24000
049456,上海銀統一94購03,0,0,0,0,0,0,0,0,0,-24000,0,0,0,0,24000,-24000,-24000
049762,華邦電國泰95購01,0,0,0,0,0,0,0,0,0,-24000,0,0,0,135000,159000,-24000,-24000
053407,台積電兆豐96購02,0,0,0,0,0,0,0,0,0,-24000,0,0,0,0,24000,-24000,-24000
050175,台光電元大94購08,0,0,0,0,0,0,0,0,0,-24000,0,0,0,86000,110000,-24000,-24000
051438,喬山元大95購03  ,0,0,0,0,0,0,0,0,0,-24000,0,0,0,0,24000,-24000,-24000
052950,超眾國票98購01  ,0,0,0,0,0,0,0,0,0,-24000,0,0,0,35000,59000,-24000,-24000
050867,聯鈞永豐95購01  ,0,0,0,0,0,0,0,0,0,-24000,0,0,0,73000,97000,-24000,-24000
055096,緯穎群益97購01  ,0,0,0,0,0,0,0,0,0,-24000,0,0,0,46000,70000,-24000,-24000
054525,奇鋐元富96購01  ,0,0,0,0,0,0,0,0,0,-24000,0,0,0,0,24000,-24000,-24000
054506,矽格永豐96購01  ,0,0,0,0,0,0,0,0,0,-24000,0,0,0,72000,96000,-24000,-24000
054216,聯茂國票97購03  ,0,0,0,0,0,0,0,0,0,-24000,0,0,0,105000,129000,-24000,-24000
055233,康友國票98購01  ,0,0,0,0,0,0,0,0,0,-24000,0,0,0,41000,65000,-24000,-24000
055955,微星元大97購01  ,0,0,0,0,0,0,0,0,0,-24000,0,0,0,80000,104000,-24000,-24000
06427P,鴻海元大97售13  ,0,0,0,0,0,0,0,0,0,-24000,0,0,0,1000,25000,-24000,-24000
05887P,友達元富99售03  ,0,0,0,0,0,0,0,0,0,-25000,0,0,0,59000,84000,-25000,-25000
05954P,旺宏國票97售03  ,0,0,0,0,0,0,0,0,0,-25000,0,0,0,40000,65000,-25000,-25000
058294,華新科凱基9A購01,0,0,0,0,0,0,0,0,0,-25000,0,0,0,20000,45000,-25000,-25000
057849,南茂永豐98購02  ,0,0,0,0,0,0,0,0,0,-25000,0,0,0,199000,224000,-25000,-25000
057723,臺股指元富98購02,0,0,0,0,0,0,0,0,0,-25000,0,0,0,0,25000,-25000,-25000
058074,欣興凱基99購01  ,0,0,0,0,0,0,0,0,0,-25000,0,0,0,63000,88000,-25000,-25000
057377,康控元大99購02  ,0,0,0,0,0,0,0,0,0,-25000,0,0,0,308000,333000,-25000,-25000
057470,易華電永豐98購02,0,0,0,0,0,0,0,0,0,-25000,0,0,0,0,25000,-25000,-25000
057062,立積國泰99購01  ,0,0,0,0,0,0,0,0,0,-25000,0,0,0,242000,267000,-25000,-25000
05703P,矽力群益96售03  ,0,0,0,0,0,0,0,0,0,-25000,0,0,0,5000,30000,-25000,-25000
057004,滬深反中信9A購01,0,0,0,0,0,0,0,0,0,-25000,0,0,0,15000,40000,-25000,-25000
056989,鴻海兆豐98購02  ,0,0,0,0,0,0,0,0,0,-25000,0,0,0,10000,35000,-25000,-25000
048387,台達電國票94購01,0,0,0,0,0,0,0,0,0,-25000,0,0,0,0,25000,-25000,-25000
048552,鴻海元大94購03  ,0,0,0,0,0,0,0,0,0,-25000,0,0,0,6000,31000,-25000,-25000
048429,旺宏國票94購02  ,0,0,0,0,0,0,0,0,0,-25000,0,0,0,12000,37000,-25000,-25000
047711,華新科凱基94購03,0,0,0,0,0,0,0,0,0,-25000,0,0,0,10000,35000,-25000,-25000
052892,大成鋼群益96購01,0,0,0,0,0,0,0,0,0,-25000,0,0,0,43000,68000,-25000,-25000
052763,晶技群益97購01  ,0,0,0,0,0,0,0,0,0,-25000,0,0,0,44000,69000,-25000,-25000
052802,華新科元大97購02,0,0,0,0,0,0,0,0,0,-25000,0,0,0,0,25000,-25000,-25000
047051,可成國票94購01  ,0,0,0,0,0,0,0,0,0,-25000,0,0,0,23000,48000,-25000,-25000
045547,滬深2X國票95購01,0,0,0,0,0,0,0,0,0,-25000,0,0,0,0,25000,-25000,-25000
049591,開發金元大98購01,0,0,0,0,0,0,0,0,0,-25000,0,0,0,0,25000,-25000,-25000
0055,元大MSCI金融    ,1000,1000,0,0,0,0,0,0,0,-25000,0,0,0,0,25000,-25000,-25000
03860P,群創元富97售01  ,0,0,0,0,0,0,0,0,0,-25000,0,0,0,30000,55000,-25000,-25000
050732,台虹國票94購01  ,0,0,0,0,0,0,0,0,0,-25000,0,0,0,5000,30000,-25000,-25000
052727,仁寶元富96購01  ,0,0,0,0,0,0,0,0,0,-25000,0,0,0,60000,85000,-25000,-25000
052647,晶技永豐97購01  ,0,0,0,0,0,0,0,0,0,-25000,0,0,0,84000,109000,-25000,-25000
053687,智邦元大96購02  ,0,0,0,0,0,0,0,0,0,-25000,0,0,0,150000,175000,-25000,-25000
053312,緯穎凱基96購02  ,0,0,0,0,0,0,0,0,0,-25000,0,0,0,36000,61000,-25000,-25000
052498,台積電永豐95購06,0,0,0,0,0,0,0,0,0,-25000,0,0,0,161000,186000,-25000,-25000
052135,聯發科凱基9B購01,0,0,0,0,0,0,0,0,0,-25000,0,0,0,57000,82000,-25000,-25000
052743,華新科元大97購01,0,0,0,0,0,0,0,0,0,-25000,0,0,0,57000,82000,-25000,-25000
051527,台郡凱基95購03  ,0,0,0,0,0,0,0,0,0,-25000,0,0,0,50000,75000,-25000,-25000
056000,佳世達永豐97購01,0,0,0,0,0,0,0,0,0,-25000,0,0,0,0,25000,-25000,-25000
056133,可成元大97購05  ,0,0,0,0,0,0,0,0,0,-25000,0,0,0,104000,129000,-25000,-25000
056358,友訊元大99購01  ,0,0,0,0,0,0,0,0,0,-25000,0,0,0,68000,93000,-25000,-25000
055316,上銀國票98購01  ,0,0,0,0,0,0,0,0,0,-25000,0,0,0,0,25000,-25000,-25000
055282,聯發科元大97購15,0,0,0,0,0,0,0,0,0,-25000,0,0,0,281000,306000,-25000,-25000
055390,國巨統一98購03  ,0,0,0,0,0,0,0,0,0,-25000,0,0,0,5000,30000,-25000,-25000
055725,嘉聯益元大98購03,0,0,0,0,0,0,0,0,0,-25000,0,0,0,0,25000,-25000,-25000
055645,技嘉元富97購01  ,0,0,0,0,0,0,0,0,0,-25000,0,0,0,5000,30000,-25000,-25000
055635,緯穎永豐97購01  ,0,0,0,0,0,0,0,0,0,-25000,0,0,0,78000,103000,-25000,-25000
053959,晶豪科永豐96購02,0,0,0,0,0,0,0,0,0,-25000,0,0,0,0,25000,-25000,-25000
054045,奇力新元大97購03,0,0,0,0,0,0,0,0,0,-25000,0,0,0,0,25000,-25000,-25000
054051,貿聯元大97購03  ,0,0,0,0,0,0,0,0,0,-25000,0,0,0,10000,35000,-25000,-25000
053853,康控國泰97購02  ,0,0,0,0,0,0,0,0,0,-25000,0,0,0,3000,28000,-25000,-25000
05458P,台積電凱基97售02,0,0,0,0,0,0,0,0,0,-25000,0,0,0,427000,452000,-25000,-25000
054614,玉晶光永豐97購03,0,0,0,0,0,0,0,0,0,-25000,0,0,0,30000,55000,-25000,-25000
054880,華泰統一97購01  ,0,0,0,0,0,0,0,0,0,-25000,0,0,0,15000,40000,-25000,-25000
054900,金寶康和97購01  ,0,0,0,0,0,0,0,0,0,-25000,0,0,0,0,25000,-25000,-25000
06129P,玉晶光元富97售06,0,0,0,0,0,0,0,0,0,-25000,0,0,0,41000,66000,-25000,-25000
06165P,臺股指凱基9A售03,0,0,0,0,0,0,0,0,0,-25000,0,0,0,11000,36000,-25000,-25000
06159P,牧德元富97售02  ,0,0,0,0,0,0,0,0,0,-25000,0,0,0,0,25000,-25000,-25000
06204P,鴻海群益97售04  ,0,0,0,0,0,0,0,0,0,-25000,0,0,0,20000,45000,-25000,-25000
08749P,鴻海台新01售02  ,0,0,0,0,0,0,0,0,0,-25000,0,0,0,0,25000,-25000,-25000
06897P,FBVIX群益01售01 ,0,0,0,0,0,0,0,0,0,-25000,0,0,0,2000,27000,-25000,-25000
06878P,台灣50日盛9B售01,0,0,0,0,0,0,0,0,0,-25000,0,0,0,40000,65000,-25000,-25000
06847P,奇力新元大98售05,0,0,0,0,0,0,0,0,0,-25000,0,0,0,22000,47000,-25000,-25000
1558,伸興            ,31000,55000,-24000,0,0,0,0,0,0,-1000,0,1000,-1000,0,0,0,-25000
5305,敦南            ,167000,192000,-25000,0,0,0,0,0,0,0,1000,1000,0,0,0,0,-25000
056460,同欣電凱基99購01,0,0,0,0,0,0,0,0,0,-26000,0,0,0,34000,60000,-26000,-26000
057115,元油2X日盛9A購01,0,0,0,0,0,0,0,0,0,-26000,0,0,0,0,26000,-26000,-26000
057109,信邦群益98購01  ,0,0,0,0,0,0,0,0,0,-26000,0,0,0,4000,30000,-26000,-26000
057508,康控國票99購03  ,0,0,0,0,0,0,0,0,0,-26000,0,0,0,0,26000,-26000,-26000
058012,鈺齊國票99購01  ,0,0,0,0,0,0,0,0,0,-26000,0,0,0,0,26000,-26000,-26000
058031,旺宏永豐98購04  ,0,0,0,0,0,0,0,0,0,-26000,0,0,0,50000,76000,-26000,-26000
057813,京元電元大98購03,0,0,0,0,0,0,0,0,0,-26000,0,0,0,118000,144000,-26000,-26000
057900,南亞科永豐98購01,0,0,0,0,0,0,0,0,0,-26000,0,0,0,4000,30000,-26000,-26000
058637,晶技兆豐99購01  ,0,0,0,0,0,0,0,0,0,-26000,0,0,0,9000,35000,-26000,-26000
058619,台灣50國票99購04,0,0,0,0,0,0,0,0,0,-26000,0,0,0,10000,36000,-26000,-26000
042953,鴻海台新01購01  ,0,0,0,0,0,0,0,0,0,-26000,0,0,0,94000,120000,-26000,-26000
03006X,元展06          ,0,0,0,0,0,0,0,0,0,-26000,0,0,0,0,26000,-26000,-26000
04022P,群創元富96售04  ,0,0,0,0,0,0,0,0,0,-26000,0,0,0,100000,126000,-26000,-26000
04286P,滬深2X中信96售01,0,0,0,0,0,0,0,0,0,-26000,0,0,0,0,26000,-26000,-26000
047151,台積電國票94購02,0,0,0,0,0,0,0,0,0,-26000,0,0,0,16000,42000,-26000,-26000
048149,泰鼎元富95購01  ,0,0,0,0,0,0,0,0,0,-26000,0,0,0,24000,50000,-26000,-26000
045866,南茂統一94購01  ,0,0,0,0,0,0,0,0,0,-26000,0,0,0,172000,198000,-26000,-26000
052870,玉晶光凱基96購03,0,0,0,0,0,0,0,0,0,-26000,0,0,0,109000,135000,-26000,-26000
049714,國巨凱基94購02  ,0,0,0,0,0,0,0,0,0,-26000,0,0,0,10000,36000,-26000,-26000
052124,京鼎國票95購01  ,0,0,0,0,0,0,0,0,0,-26000,0,0,0,30000,56000,-26000,-26000
051361,泰鼎元大95購01  ,0,0,0,0,0,0,0,0,0,-26000,0,0,0,14000,40000,-26000,-26000
053507,百和兆豐96購01  ,0,0,0,0,0,0,0,0,0,-26000,0,0,0,42000,68000,-26000,-26000
05098P,鴻海凱基95售15  ,0,0,0,0,0,0,0,0,0,-26000,0,0,0,0,26000,-26000,-26000
053216,京鼎凱基96購02  ,0,0,0,0,0,0,0,0,0,-26000,0,0,0,0,26000,-26000,-26000
050894,旺宏元大96購03  ,0,0,0,0,0,0,0,0,0,-26000,0,0,0,38000,64000,-26000,-26000
051215,大立光統一95購03,0,0,0,0,0,0,0,0,0,-26000,0,0,0,0,26000,-26000,-26000
054772,康控國票98購02  ,0,0,0,0,0,0,0,0,0,-26000,0,0,0,0,26000,-26000,-26000
053891,欣興群益98購01  ,0,0,0,0,0,0,0,0,0,-26000,0,0,0,0,26000,-26000,-26000
055708,茂林永豐97購02  ,0,0,0,0,0,0,0,0,0,-26000,0,0,0,68000,94000,-26000,-26000
2891C,中信金丙特      ,0,0,0,0,0,0,0,0,0,-26000,0,26000,-26000,0,0,0,-26000
06377P,華通統一97售04  ,0,0,0,0,0,0,0,0,0,-26000,0,0,0,90000,116000,-26000,-26000
058334,鴻海元富99購05  ,0,0,0,0,0,0,0,0,0,-27000,0,0,0,79000,106000,-27000,-27000
058363,全新凱基9A購02  ,0,0,0,0,0,0,0,0,0,-27000,0,0,0,0,27000,-27000,-27000
058387,國巨國票9A購03  ,0,0,0,0,0,0,0,0,0,-27000,0,0,0,10000,37000,-27000,-27000
058287,國巨國票9A購02  ,0,0,0,0,0,0,0,0,0,-27000,0,0,0,10000,37000,-27000,-27000
056536,義隆凱基98購04  ,0,0,0,0,0,0,0,0,0,-27000,0,0,0,10000,37000,-27000,-27000
056844,欣興元富98購03  ,0,0,0,0,0,0,0,0,0,-27000,0,0,0,3000,30000,-27000,-27000
056820,欣興永豐98購02  ,0,0,0,0,0,0,0,0,0,-27000,0,0,0,86000,113000,-27000,-27000
05002P,台積電統一95售03,0,0,0,0,0,0,0,0,0,-27000,0,0,0,5000,32000,-27000,-27000
047768,大立光元大95購01,0,0,0,0,0,0,0,0,0,-27000,0,0,0,0,27000,-27000,-27000
04910P,台積電統一94售12,0,0,0,0,0,0,0,0,0,-27000,0,0,0,18000,45000,-27000,-27000
045053,聯發科元富98購01,0,0,0,0,0,0,0,0,0,-27000,0,0,0,644000,671000,-27000,-27000
00711B,FH彭博新興債    ,0,20000,-20000,0,0,0,0,0,0,-7000,0,0,0,147000,154000,-7000,-27000
03899P,滬深2X群益95售03,0,0,0,0,0,0,0,0,0,-27000,0,0,0,13000,40000,-27000,-27000
051237,鴻海元大97購01  ,0,0,0,0,0,0,0,0,0,-27000,0,0,0,0,27000,-27000,-27000
050901,樺漢元大95購02  ,0,0,0,0,0,0,0,0,0,-27000,0,0,0,10000,37000,-27000,-27000
050653,聯鈞凱基96購01  ,0,0,0,0,0,0,0,0,0,-27000,0,0,0,66000,93000,-27000,-27000
053228,康友台新97購01  ,0,0,0,0,0,0,0,0,0,-27000,0,0,0,63000,90000,-27000,-27000
051067,台積電國票96購03,0,0,0,0,0,0,0,0,0,-27000,0,0,0,9000,36000,-27000,-27000
050922,南亞科凱基95購02,0,0,0,0,0,0,0,0,0,-27000,0,0,0,0,27000,-27000,-27000
050121,南電元大95購02  ,0,0,0,0,0,0,0,0,0,-27000,0,0,0,113000,140000,-27000,-27000
053373,台泥元大96購01  ,0,0,0,0,0,0,0,0,0,-27000,0,0,0,179000,206000,-27000,-27000
052317,台積電元大96購11,0,0,0,0,0,0,0,0,0,-27000,0,0,0,20000,47000,-27000,-27000
052126,群創國票97購01  ,0,0,0,0,0,0,0,0,0,-27000,0,0,0,0,27000,-27000,-27000
05206P,南茂元大95售01  ,0,0,0,0,0,0,0,0,0,-27000,0,0,0,9000,36000,-27000,-27000
053067,牧德群益96購01  ,0,0,0,0,0,0,0,0,0,-27000,0,0,0,31000,58000,-27000,-27000
055722,聯鈞元大97購03  ,0,0,0,0,0,0,0,0,0,-27000,0,0,0,190000,217000,-27000,-27000
055312,台虹群益99購01  ,0,0,0,0,0,0,0,0,0,-27000,0,0,0,10000,37000,-27000,-27000
055234,昇陽半國票98購02,0,0,0,0,0,0,0,0,0,-27000,0,0,0,0,27000,-27000,-27000
056354,國巨元大98購10  ,0,0,0,0,0,0,0,0,0,-27000,0,0,0,115000,142000,-27000,-27000
056199,美律永豐97購01  ,0,0,0,0,0,0,0,0,0,-27000,0,0,0,0,27000,-27000,-27000
054130,漢唐元大97購02  ,0,0,0,0,0,0,0,0,0,-27000,0,0,0,144000,171000,-27000,-27000
054826,復盛元大9A購01  ,0,0,0,0,0,0,0,0,0,-27000,0,0,0,23000,50000,-27000,-27000
054739,義隆凱基98購02  ,0,0,0,0,0,0,0,0,0,-27000,0,0,0,115000,142000,-27000,-27000
054470,緯穎國票97購04  ,0,0,0,0,0,0,0,0,0,-27000,0,0,0,14000,41000,-27000,-27000
056486,樺漢元大98購04  ,0,0,0,0,0,0,0,0,0,-28000,0,0,0,21000,49000,-28000,-28000
057657,國巨兆豐98購04  ,0,0,0,0,0,0,0,0,0,-28000,0,0,0,36000,64000,-28000,-28000
057061,華擎國泰9A購01  ,0,0,0,0,0,0,0,0,0,-28000,0,0,0,176000,204000,-28000,-28000
057336,聯發科國票99購01,0,0,0,0,0,0,0,0,0,-28000,0,0,0,3000,31000,-28000,-28000
057346,鴻海統一98購13  ,0,0,0,0,0,0,0,0,0,-28000,0,0,0,75000,103000,-28000,-28000
057342,玉晶光台新98購01,0,0,0,0,0,0,0,0,0,-28000,0,0,0,21000,49000,-28000,-28000
057243,樺漢凱基99購01  ,0,0,0,0,0,0,0,0,0,-28000,0,0,0,0,28000,-28000,-28000
058095,昇陽半元大98購03,0,0,0,0,0,0,0,0,0,-28000,0,0,0,72000,100000,-28000,-28000
058105,旺宏統一9A購02  ,0,0,0,0,0,0,0,0,0,-28000,0,0,0,55000,83000,-28000,-28000
057859,神達康和98購01  ,0,0,0,0,0,0,0,0,0,-28000,0,0,0,11000,39000,-28000,-28000
058400,聯發科元大99購09,0,0,0,0,0,0,0,0,0,-28000,0,0,0,236000,264000,-28000,-28000
058551,義隆永豐99購03  ,0,0,0,0,0,0,0,0,0,-28000,0,0,0,39000,67000,-28000,-28000
03951P,新光金凱基95售01,0,0,0,0,0,0,0,0,0,-28000,0,0,0,52000,80000,-28000,-28000
04662P,臺股指國票94售01,0,0,0,0,0,0,0,0,0,-28000,0,0,0,0,28000,-28000,-28000
046630,京元電元富95購03,0,0,0,0,0,0,0,0,0,-28000,0,0,0,7000,35000,-28000,-28000
047491,旺宏統一94購03  ,0,0,0,0,0,0,0,0,0,-28000,0,0,0,0,28000,-28000,-28000
048905,旺宏富邦96購01  ,0,0,0,0,0,0,0,0,0,-28000,0,0,0,60000,88000,-28000,-28000
04774P,金融類元大94售02,0,0,0,0,0,0,0,0,0,-28000,0,0,0,0,28000,-28000,-28000
050337,南電國泰95購01  ,0,0,0,0,0,0,0,0,0,-28000,0,0,0,30000,58000,-28000,-28000
052191,超眾群益96購01  ,0,0,0,0,0,0,0,0,0,-28000,0,0,0,20000,48000,-28000,-28000
053395,致茂中信96購01  ,0,0,0,0,0,0,0,0,0,-28000,0,0,0,20000,48000,-28000,-28000
051826,智邦元大95購03  ,0,0,0,0,0,0,0,0,0,-28000,0,0,0,146000,174000,-28000,-28000
050155,華新科群益95購01,0,0,0,0,0,0,0,0,0,-28000,0,0,0,58000,86000,-28000,-28000
051024,南亞科統一95購01,0,0,0,0,0,0,0,0,0,-28000,0,0,0,0,28000,-28000,-28000
054683,川湖永豐97購01  ,0,0,0,0,0,0,0,0,0,-28000,0,0,0,0,28000,-28000,-28000
054866,宏盛群益98購01  ,0,0,0,0,0,0,0,0,0,-28000,0,0,0,0,28000,-28000,-28000
054387,台積電統一98購02,0,0,0,0,0,0,0,0,0,-28000,0,0,0,0,28000,-28000,-28000
054343,世紀鋼元富96購02,0,0,0,0,0,0,0,0,0,-28000,0,0,0,470000,498000,-28000,-28000
056269,新日興統一98購01,0,0,0,0,0,0,0,0,0,-28000,0,0,0,0,28000,-28000,-28000
056379,玉晶光元富98購01,0,0,0,0,0,0,0,0,0,-28000,0,0,0,8000,36000,-28000,-28000
05637P,聯電元大96售04  ,0,0,0,0,0,0,0,0,0,-28000,0,0,0,0,28000,-28000,-28000
056350,上銀元大98購02  ,0,0,0,0,0,0,0,0,0,-28000,0,0,0,51000,79000,-28000,-28000
055983,全新元富9A購02  ,0,0,0,0,0,0,0,0,0,-28000,0,0,0,0,28000,-28000,-28000
055321,大立光國票98購02,0,0,0,0,0,0,0,0,0,-28000,0,0,0,0,28000,-28000,-28000
05536P,奇力新元大96售03,0,0,0,0,0,0,0,0,0,-28000,0,0,0,102000,130000,-28000,-28000
055724,祥碩元大97購03  ,0,0,0,0,0,0,0,0,0,-28000,0,0,0,15000,43000,-28000,-28000
2030,彰源            ,80000,108000,-28000,0,0,0,0,0,0,0,0,0,0,0,0,0,-28000
2455,全新            ,810000,864000,-54000,0,0,0,36000,0,36000,-10000,50000,62000,-12000,29000,27000,2000,-28000
9136,巨騰-DR         ,1000,29000,-28000,0,0,0,0,0,0,0,0,0,0,0,0,0,-28000
058566,聯發科凱基9A購02,0,0,0,0,0,0,0,0,0,-29000,0,0,0,0,29000,-29000,-29000
058101,台積電富邦9C購01,0,0,0,0,0,0,0,0,0,-29000,0,0,0,105000,134000,-29000,-29000
058097,台灣50國泰99購01,0,0,0,0,0,0,0,0,0,-29000,0,0,0,215000,244000,-29000,-29000
05804P,美律永豐96售01  ,0,0,0,0,0,0,0,0,0,-29000,0,0,0,4000,33000,-29000,-29000
057603,樺漢群益98購02  ,0,0,0,0,0,0,0,0,0,-29000,0,0,0,25000,54000,-29000,-29000
057532,智原元大98購03  ,0,0,0,0,0,0,0,0,0,-29000,0,0,0,3000,32000,-29000,-29000
056596,光磊元富98購01  ,0,0,0,0,0,0,0,0,0,-29000,0,0,0,21000,50000,-29000,-29000
056597,宏碁元富98購01  ,0,0,0,0,0,0,0,0,0,-29000,0,0,0,125000,154000,-29000,-29000
056862,聯發科群益98購03,0,0,0,0,0,0,0,0,0,-29000,0,0,0,1088000,1117000,-29000,-29000
047701,鴻海凱基94購12  ,0,0,0,0,0,0,0,0,0,-29000,0,0,0,24000,53000,-29000,-29000
048506,華通群益94購03  ,0,0,0,0,0,0,0,0,0,-29000,0,0,0,29000,58000,-29000,-29000
049892,國巨富邦96購01  ,0,0,0,0,0,0,0,0,0,-29000,0,0,0,10000,39000,-29000,-29000
048733,台勝科麥證95購02,0,0,0,36000,65000,-29000,0,0,0,-29000,0,0,0,36000,65000,-29000,-29000
047350,華新科凱基94購02,0,0,0,0,0,0,0,0,0,-29000,0,0,0,50000,79000,-29000,-29000
049553,鴻海國泰96購02  ,0,0,0,0,0,0,0,0,0,-29000,0,0,0,43000,72000,-29000,-29000
046293,聯發科統一94購01,0,0,0,0,0,0,0,0,0,-29000,0,0,0,0,29000,-29000,-29000
053083,中環元大99購01  ,0,0,0,0,0,0,0,0,0,-29000,0,0,0,80000,109000,-29000,-29000
051452,貿聯元大95購04  ,0,0,0,0,0,0,0,0,0,-29000,0,0,0,129000,158000,-29000,-29000
052385,滬深2X群益99購05,0,0,0,0,0,0,0,0,0,-29000,0,0,0,78000,107000,-29000,-29000
053644,台表科國票97購03,0,0,0,0,0,0,0,0,0,-29000,0,0,0,10000,39000,-29000,-29000
050404,元大金麥證94購01,0,0,0,11000,40000,-29000,0,0,0,-29000,0,0,0,11000,40000,-29000,-29000
051416,創意國票96購02  ,0,0,0,0,0,0,0,0,0,-29000,0,0,0,10000,39000,-29000,-29000
051529,東元國票96購01  ,0,0,0,0,0,0,0,0,0,-29000,0,0,0,11000,40000,-29000,-29000
056050,晶技國票98購01  ,0,0,0,0,0,0,0,0,0,-29000,0,0,0,68000,97000,-29000,-29000
055932,玉山金群益99購01,0,0,0,0,0,0,0,0,0,-29000,0,0,0,44000,73000,-29000,-29000
054895,南電統一97購01  ,0,0,0,0,0,0,0,0,0,-29000,0,0,0,1000,30000,-29000,-29000
054637,智邦中信98購01  ,0,0,0,0,0,0,0,0,0,-29000,0,0,0,48000,77000,-29000,-29000
5269,祥碩            ,251000,470000,-219000,0,0,0,90000,10000,80000,110000,21000,7000,14000,102000,6000,96000,-29000
6541,泰福-KY         ,147000,176000,-29000,0,0,0,0,0,0,0,0,0,0,0,0,0,-29000
06114P,台積電統一97售03,0,0,0,0,0,0,0,0,0,-29000,0,0,0,5000,34000,-29000,-29000
06628P,訊芯元富98售03  ,0,0,0,0,0,0,0,0,0,-29000,0,0,0,2000,31000,-29000,-29000
056943,華通統一99購01  ,0,0,0,0,0,0,0,0,0,-30000,0,0,0,0,30000,-30000,-30000
056679,元油2X統一98購01,0,0,0,0,0,0,0,0,0,-30000,0,0,0,0,30000,-30000,-30000
056468,鴻海元大98購07  ,0,0,0,0,0,0,0,0,0,-30000,0,0,0,30000,60000,-30000,-30000
056544,貿聯凱基98購03  ,0,0,0,0,0,0,0,0,0,-30000,0,0,0,10000,40000,-30000,-30000
056548,瀚宇博凱基98購02,0,0,0,0,0,0,0,0,0,-30000,0,0,0,19000,49000,-30000,-30000
056576,晶技元大99購02  ,0,0,0,0,0,0,0,0,0,-30000,0,0,0,52000,82000,-30000,-30000
057570,技嘉永豐98購02  ,0,0,0,0,0,0,0,0,0,-30000,0,0,0,0,30000,-30000,-30000
057654,A50正2中信98購01,0,0,0,0,0,0,0,0,0,-30000,0,0,0,10000,40000,-30000,-30000
057399,滬深反群益9C購01,0,0,0,0,0,0,0,0,0,-30000,0,0,0,70000,100000,-30000,-30000
057247,元油2X統一9A購01,0,0,0,0,0,0,0,0,0,-30000,0,0,0,0,30000,-30000,-30000
057235,亞光凱基98購04  ,0,0,0,0,0,0,0,0,0,-30000,0,0,0,1000,31000,-30000,-30000
057329,緯穎群益98購02  ,0,0,0,0,0,0,0,0,0,-30000,0,0,0,18000,48000,-30000,-30000
057101,新光金中信9A購01,0,0,0,0,0,0,0,0,0,-30000,0,0,0,0,30000,-30000,-30000
057157,群創富邦98購02  ,0,0,0,0,0,0,0,0,0,-30000,0,0,0,0,30000,-30000,-30000
057188,佐登元大98購01  ,0,0,0,0,0,0,0,0,0,-30000,0,0,0,0,30000,-30000,-30000
058059,晶技元富98購01  ,0,0,0,0,0,0,0,0,0,-30000,0,0,0,83000,113000,-30000,-30000
058009,智易國票99購01  ,0,0,0,0,0,0,0,0,0,-30000,0,0,0,38000,68000,-30000,-30000
057994,技嘉中信98購01  ,0,0,0,0,0,0,0,0,0,-30000,0,0,0,86000,116000,-30000,-30000
058205,神達凱基9B購01  ,0,0,0,0,0,0,0,0,0,-30000,0,0,0,33000,63000,-30000,-30000
058188,華擎永豐99購01  ,0,0,0,0,0,0,0,0,0,-30000,0,0,0,0,30000,-30000,-30000
057876,隆達元大98購01  ,0,0,0,0,0,0,0,0,0,-30000,0,0,0,0,30000,-30000,-30000
057854,聯發科國票99購03,0,0,0,0,0,0,0,0,0,-30000,0,0,0,20000,50000,-30000,-30000
057845,晶相光永豐98購03,0,0,0,0,0,0,0,0,0,-30000,0,0,0,70000,100000,-30000,-30000
057831,聯發科元富02購04,0,0,0,0,0,0,0,0,0,-30000,0,0,0,0,30000,-30000,-30000
058367,大立光凱基9A購01,0,0,0,0,0,0,0,0,0,-30000,0,0,0,0,30000,-30000,-30000
058351,上銀凱基9A購02  ,0,0,0,0,0,0,0,0,0,-30000,0,0,0,0,30000,-30000,-30000
058626,瑞昱國票9A購01  ,0,0,0,0,0,0,0,0,0,-30000,0,0,0,0,30000,-30000,-30000
058650,台虹永豐9A購01  ,0,0,0,0,0,0,0,0,0,-30000,0,0,0,0,30000,-30000,-30000
058719,智邦元富99購01  ,0,0,0,0,0,0,0,0,0,-30000,0,0,0,0,30000,-30000,-30000
05971P,世紀鋼永豐96售04,0,0,0,0,0,0,0,0,0,-30000,0,0,0,0,30000,-30000,-30000
03810P,大立光富邦98售01,0,0,0,0,0,0,0,0,0,-30000,0,0,0,20000,50000,-30000,-30000
046740,大立光群益95購01,0,0,0,0,0,0,0,0,0,-30000,0,0,0,0,30000,-30000,-30000
046460,聯鈞凱基93購02  ,0,0,0,0,0,0,0,0,0,-30000,0,0,0,0,30000,-30000,-30000
046432,宏達電中信94購01,0,0,0,0,0,0,0,0,0,-30000,0,0,0,0,30000,-30000,-30000
044217,華新科凱基93購03,0,0,0,0,0,0,0,0,0,-30000,0,0,0,71000,101000,-30000,-30000
00645,富邦日本        ,0,0,0,0,0,0,0,0,0,-30000,0,0,0,71000,101000,-30000,-30000
042037,台灣50群益93購03,0,0,0,0,0,0,0,0,0,-30000,0,0,0,0,30000,-30000,-30000
049547,新光金群益94購01,0,0,0,0,0,0,0,0,0,-30000,0,0,0,0,30000,-30000,-30000
049589,奇力新元大95購02,0,0,0,0,0,0,0,0,0,-30000,0,0,0,0,30000,-30000,-30000
049645,台積電凱基94購22,0,0,0,0,0,0,0,0,0,-30000,0,0,0,0,30000,-30000,-30000
049649,信邦凱基94購01  ,0,0,0,0,0,0,0,0,0,-30000,0,0,0,0,30000,-30000,-30000
050040,鴻海中信94購04  ,0,0,0,0,0,0,0,0,0,-30000,0,0,0,0,30000,-30000,-30000
047376,南電國票94購01  ,0,0,0,0,0,0,0,0,0,-30000,0,0,0,10000,40000,-30000,-30000
045443,群創元富98購01  ,0,0,0,0,0,0,0,0,0,-30000,0,0,0,0,30000,-30000,-30000
045856,南亞科國泰94購01,0,0,0,0,0,0,0,0,0,-30000,0,0,0,0,30000,-30000,-30000
046864,和大統一97購01  ,0,0,0,0,0,0,0,0,0,-30000,0,0,0,33000,63000,-30000,-30000
046865,鴻海統一95購01  ,0,0,0,0,0,0,0,0,0,-30000,0,0,0,10000,40000,-30000,-30000
046925,華新科國泰94購03,0,0,0,0,0,0,0,0,0,-30000,0,0,0,0,30000,-30000,-30000
04382P,美律國泰95售01  ,0,0,0,0,0,0,0,0,0,-30000,0,0,0,0,30000,-30000,-30000
048590,貿聯兆豐94購02  ,0,0,0,0,0,0,0,0,0,-30000,0,0,0,0,30000,-30000,-30000
048988,聯茂元大94購02  ,0,0,0,0,0,0,0,0,0,-30000,0,0,0,0,30000,-30000,-30000
048916,華新科台新94購01,0,0,0,0,0,0,0,0,0,-30000,0,0,0,10000,40000,-30000,-30000
049141,旺宏元大95購01  ,0,0,0,0,0,0,0,0,0,-30000,0,0,0,42000,72000,-30000,-30000
052760,盟立群益96購01  ,0,0,0,0,0,0,0,0,0,-30000,0,0,0,0,30000,-30000,-30000
052769,達興群益96購01  ,0,0,0,0,0,0,0,0,0,-30000,0,0,0,0,30000,-30000,-30000
052781,瀚宇博國票97購03,0,0,0,0,0,0,0,0,0,-30000,0,0,0,0,30000,-30000,-30000
049893,日月光富邦98購01,0,0,0,0,0,0,0,0,0,-30000,0,0,0,30000,60000,-30000,-30000
049909,國巨元大95購01  ,0,0,0,0,0,0,0,0,0,-30000,0,0,0,86000,116000,-30000,-30000
049337,台達電統一94購03,0,0,0,0,0,0,0,0,0,-30000,0,0,0,0,30000,-30000,-30000
049394,T50反1群益94購01,0,0,0,0,0,0,0,0,0,-30000,0,0,0,10000,40000,-30000,-30000
049349,國巨康和94購01  ,0,0,0,0,0,0,0,0,0,-30000,0,0,0,0,30000,-30000,-30000
048521,華通統一93購05  ,0,0,0,0,0,0,0,0,0,-30000,0,0,0,0,30000,-30000,-30000
048567,台郡元大93購03  ,0,0,0,0,0,0,0,0,0,-30000,0,0,0,20000,50000,-30000,-30000
047685,嘉聯益國泰95購01,0,0,0,0,0,0,0,0,0,-30000,0,0,0,0,30000,-30000,-30000
048105,滬深2X群益99購02,0,0,0,0,0,0,0,0,0,-30000,0,0,0,0,30000,-30000,-30000
048037,台表科凱基93購05,0,0,0,0,0,0,0,0,0,-30000,0,0,0,0,30000,-30000,-30000
051563,泰鼎國泰96購01  ,0,0,0,0,0,0,0,0,0,-30000,0,0,0,10000,40000,-30000,-30000
051639,康友國票96購02  ,0,0,0,0,0,0,0,0,0,-30000,0,0,0,7000,37000,-30000,-30000
051663,鴻海元大95購18  ,0,0,0,0,0,0,0,0,0,-30000,0,0,0,0,30000,-30000,-30000
052053,泰鼎凱基96購01  ,0,0,0,0,0,0,0,0,0,-30000,0,0,0,56000,86000,-30000,-30000
052185,奇力新群益95購03,0,0,0,0,0,0,0,0,0,-30000,0,0,0,0,30000,-30000,-30000
052178,台郡元大96購03  ,0,0,0,0,0,0,0,0,0,-30000,0,0,0,59000,89000,-30000,-30000
050427,台積電凱基94購34,0,0,0,0,0,0,0,0,0,-30000,0,0,0,0,30000,-30000,-30000
050383,超眾兆豐95購01  ,0,0,0,0,0,0,0,0,0,-30000,0,0,0,0,30000,-30000,-30000
052119,漢唐國票96購01  ,0,0,0,0,0,0,0,0,0,-30000,0,0,0,0,30000,-30000,-30000
051353,聯發科元大95購08,0,0,0,0,0,0,0,0,0,-30000,0,0,0,0,30000,-30000,-30000
052133,華邦電凱基9B購01,0,0,0,0,0,0,0,0,0,-30000,0,0,0,26000,56000,-30000,-30000
053311,同欣電凱基96購01,0,0,0,0,0,0,0,0,0,-30000,0,0,0,0,30000,-30000,-30000
052362,瑞昱國票96購02  ,0,0,0,0,0,0,0,0,0,-30000,0,0,0,0,30000,-30000,-30000
052274,大立光群益95購03,0,0,0,0,0,0,0,0,0,-30000,0,0,0,3000,33000,-30000,-30000
052206,燿華中信95購02  ,0,0,0,0,0,0,0,0,0,-30000,0,0,0,0,30000,-30000,-30000
053428,中磊永豐96購02  ,0,0,0,0,0,0,0,0,0,-30000,0,0,0,10000,40000,-30000,-30000
053486,T50反1兆豐96購01,0,0,0,0,0,0,0,0,0,-30000,0,0,0,0,30000,-30000,-30000
053480,祥碩元大96購02  ,0,0,0,0,0,0,0,0,0,-30000,0,0,0,0,30000,-30000,-30000
053565,台光電富邦98購01,0,0,0,0,0,0,0,0,0,-30000,0,0,0,0,30000,-30000,-30000
053547,台積電凱基96購14,0,0,0,0,0,0,0,0,0,-30000,0,0,0,0,30000,-30000,-30000
05116P,台積電群益95售03,0,0,0,0,0,0,0,0,0,-30000,0,0,0,0,30000,-30000,-30000
050773,京鼎元大94購02  ,0,0,0,0,0,0,0,0,0,-30000,0,0,0,51000,81000,-30000,-30000
053276,友達元大9C購01  ,0,0,0,0,0,0,0,0,0,-30000,0,0,0,197000,227000,-30000,-30000
050548,華固凱基95購01  ,0,0,0,0,0,0,0,0,0,-30000,0,0,0,0,30000,-30000,-30000
051137,聯詠永豐95購01  ,0,0,0,0,0,0,0,0,0,-30000,0,0,0,0,30000,-30000,-30000
053023,泰鼎國泰97購01  ,0,0,0,0,0,0,0,0,0,-30000,0,0,0,0,30000,-30000,-30000
053207,SP黃豆凱基96購01,0,0,0,0,0,0,0,0,0,-30000,0,0,0,0,30000,-30000,-30000
051073,同欣電國票96購01,0,0,0,0,0,0,0,0,0,-30000,0,0,0,63000,93000,-30000,-30000
050138,台表科國票95購02,0,0,0,0,0,0,0,0,0,-30000,0,0,0,0,30000,-30000,-30000
050982,台積電國泰96購04,0,0,0,0,0,0,0,0,0,-30000,0,0,0,35000,65000,-30000,-30000
051870,台郡凱基95購04  ,0,0,0,0,0,0,0,0,0,-30000,0,0,0,0,30000,-30000,-30000
05010P,台郡元富95售01  ,0,0,0,0,0,0,0,0,0,-30000,0,0,0,0,30000,-30000,-30000
052639,康控凱基96購02  ,0,0,0,0,0,0,0,0,0,-30000,0,0,0,0,30000,-30000,-30000
054634,FB上証中信99購01,0,0,0,0,0,0,0,0,0,-30000,0,0,0,0,30000,-30000,-30000
054572,國巨元大98購03  ,0,0,0,0,0,0,0,0,0,-30000,0,0,0,251000,281000,-30000,-30000
054588,玉晶光國泰99購02,0,0,0,0,0,0,0,0,0,-30000,0,0,0,12000,42000,-30000,-30000
054508,臺股指永豐96購04,0,0,0,0,0,0,0,0,0,-30000,0,0,0,0,30000,-30000,-30000
05468P,鴻海元大96售14  ,0,0,0,0,0,0,0,0,0,-30000,0,0,0,350000,380000,-30000,-30000
054661,嘉聯益元大97購03,0,0,0,0,0,0,0,0,0,-30000,0,0,0,50000,80000,-30000,-30000
054726,台積電日盛97購01,0,0,0,0,0,0,0,0,0,-30000,0,0,0,239000,269000,-30000,-30000
054827,宏全元大9A購01  ,0,0,0,0,0,0,0,0,0,-30000,0,0,0,0,30000,-30000,-30000
054801,康友群益97購02  ,0,0,0,0,0,0,0,0,0,-30000,0,0,0,44000,74000,-30000,-30000
054861,智邦群益97購01  ,0,0,0,0,0,0,0,0,0,-30000,0,0,0,179000,209000,-30000,-30000
055036,中工富邦9B購01  ,0,0,0,0,0,0,0,0,0,-30000,0,0,0,0,30000,-30000,-30000
055023,億光國泰98購01  ,0,0,0,0,0,0,0,0,0,-30000,0,0,0,155000,185000,-30000,-30000
054290,奇力新元大96購05,0,0,0,0,0,0,0,0,0,-30000,0,0,0,0,30000,-30000,-30000
054149,達方元大96購01  ,0,0,0,0,0,0,0,0,0,-30000,0,0,0,5000,35000,-30000,-30000
054273,宏達電中信98購01,0,0,0,0,0,0,0,0,0,-30000,0,0,0,0,30000,-30000,-30000
053916,漢唐國票97購04  ,0,0,0,0,0,0,0,0,0,-30000,0,0,0,18000,48000,-30000,-30000
053890,華新科群益98購01,0,0,0,0,0,0,0,0,0,-30000,0,0,0,0,30000,-30000,-30000
053781,友達元大9B購03  ,0,0,0,0,0,0,0,0,0,-30000,0,0,0,0,30000,-30000,-30000
054021,義隆台新96購01  ,0,0,0,0,0,0,0,0,0,-30000,0,0,0,0,30000,-30000,-30000
055948,道瓊銀元大98購02,0,0,0,0,0,0,0,0,0,-30000,0,0,0,0,30000,-30000,-30000
055871,群創台新97購02  ,0,0,0,0,0,0,0,0,0,-30000,0,0,0,0,30000,-30000,-30000
055842,建準元大98購01  ,0,0,0,0,0,0,0,0,0,-30000,0,0,0,20000,50000,-30000,-30000
055810,T50反1國票99購01,0,0,0,0,0,0,0,0,0,-30000,0,0,0,0,30000,-30000,-30000
055991,鈺齊元富97購01  ,0,0,0,0,0,0,0,0,0,-30000,0,0,0,0,30000,-30000,-30000
05602P,國巨元大96售06  ,0,0,0,0,0,0,0,0,0,-30000,0,0,0,311000,341000,-30000,-30000
056116,義隆群益97購02  ,0,0,0,0,0,0,0,0,0,-30000,0,0,0,0,30000,-30000,-30000
056152,可成凱基97購02  ,0,0,0,0,0,0,0,0,0,-30000,0,0,0,0,30000,-30000,-30000
056102,億光永豐97購02  ,0,0,0,0,0,0,0,0,0,-30000,0,0,0,0,30000,-30000,-30000
05642P,玉晶光兆豐97售02,0,0,0,0,0,0,0,0,0,-30000,0,0,0,60000,90000,-30000,-30000
056386,TPK國泰99購01   ,0,0,0,0,0,0,0,0,0,-30000,0,0,0,10000,40000,-30000,-30000
056414,國巨中信98購02  ,0,0,0,0,0,0,0,0,0,-30000,0,0,0,5000,35000,-30000,-30000
055775,友達凱基9A購01  ,0,0,0,0,0,0,0,0,0,-30000,0,0,0,0,30000,-30000,-30000
05579P,友達凱基98售03  ,0,0,0,0,0,0,0,0,0,-30000,0,0,0,321000,351000,-30000,-30000
055562,欣興凱基97購06  ,0,0,0,0,0,0,0,0,0,-30000,0,0,0,0,30000,-30000,-30000
055423,亞光亞東99購01  ,0,0,0,0,0,0,0,0,0,-30000,0,0,0,0,30000,-30000,-30000
055188,亞翔統一97購01  ,0,0,0,0,0,0,0,0,0,-30000,0,0,0,10000,40000,-30000,-30000
06718P,聯詠元大98售01  ,0,0,0,0,0,0,0,0,0,-30000,0,0,0,0,30000,-30000,-30000
06461P,玉晶光國泰9A售01,0,0,0,0,0,0,0,0,0,-30000,0,0,0,14000,44000,-30000,-30000
06527P,T50正2富邦9C售01,0,0,0,0,0,0,0,0,0,-30000,0,0,0,0,30000,-30000,-30000
06532P,友達元富98售04  ,0,0,0,0,0,0,0,0,0,-30000,0,0,0,20000,50000,-30000,-30000
06120P,大立光凱基98售05,0,0,0,0,0,0,0,0,0,-30000,0,0,0,9000,39000,-30000,-30000
06228P,亞德客凱基97售04,0,0,0,0,0,0,0,0,0,-30000,0,0,0,0,30000,-30000,-30000
1447,力鵬            ,212000,242000,-30000,0,0,0,0,0,0,0,0,0,0,0,0,0,-30000
07043P,國巨元大99售14  ,0,0,0,0,0,0,0,0,0,-30000,0,0,0,28000,58000,-30000,-30000
058529,S&P正2元富9B購01,0,0,0,0,0,0,0,0,0,-31000,0,0,0,10000,41000,-31000,-31000
058202,鴻海凱基9A購04  ,0,0,0,0,0,0,0,0,0,-31000,0,0,0,72000,103000,-31000,-31000
056504,國巨永豐98購02  ,0,0,0,0,0,0,0,0,0,-31000,0,0,0,39000,70000,-31000,-31000
049494,華新科元大95購05,0,0,0,0,0,0,0,0,0,-31000,0,0,0,124000,155000,-31000,-31000
044530,台積電富邦94購01,0,0,0,0,0,0,0,0,0,-31000,0,0,0,2000,33000,-31000,-31000
047303,寶滬深元大96購01,0,0,0,0,0,0,0,0,0,-31000,0,0,0,0,31000,-31000,-31000
00690,兆豐藍籌30      ,0,0,0,0,0,0,0,0,0,-31000,0,0,0,170000,201000,-31000,-31000
050082,聯發科統一94購08,0,0,0,0,0,0,0,0,0,-31000,0,0,0,61000,92000,-31000,-31000
053151,華新科元大96購04,0,0,0,0,0,0,0,0,0,-31000,0,0,0,90000,121000,-31000,-31000
050890,南電富邦99購01  ,0,0,0,0,0,0,0,0,0,-31000,0,0,0,20000,51000,-31000,-31000
050875,訊芯永豐95購01  ,0,0,0,0,0,0,0,0,0,-31000,0,0,0,0,31000,-31000,-31000
053417,上銀永豐96購02  ,0,0,0,0,0,0,0,0,0,-31000,0,0,0,69000,100000,-31000,-31000
052478,大立光群益95購05,0,0,0,0,0,0,0,0,0,-31000,0,0,0,32000,63000,-31000,-31000
055178,晶豪科統一97購01,0,0,0,0,0,0,0,0,0,-31000,0,0,0,0,31000,-31000,-31000
055605,緯穎元大97購02  ,0,0,0,0,0,0,0,0,0,-31000,0,0,0,352000,383000,-31000,-31000
055509,訊芯元大97購03  ,0,0,0,0,0,0,0,0,0,-31000,0,0,0,42000,73000,-31000,-31000
054065,樺漢國票97購01  ,0,0,0,0,0,0,0,0,0,-31000,0,0,0,0,31000,-31000,-31000
06272P,台郡凱基97售04  ,0,0,0,0,0,0,0,0,0,-31000,0,0,0,0,31000,-31000,-31000
06675P,國巨國票99售02  ,0,0,0,0,0,0,0,0,0,-31000,0,0,0,0,31000,-31000,-31000
056492,全新國泰9A購01  ,0,0,0,0,0,0,0,0,0,-32000,0,0,0,0,32000,-32000,-32000
056554,GIS凱基99購01   ,0,0,0,0,0,0,0,0,0,-32000,0,0,0,102000,134000,-32000,-32000
056527,大成鋼凱基98購03,0,0,0,0,0,0,0,0,0,-32000,0,0,0,75000,107000,-32000,-32000
057048,新日興元大98購01,0,0,0,0,0,0,0,0,0,-32000,0,0,0,0,32000,-32000,-32000
057372,華新科元大99購10,0,0,0,0,0,0,0,0,0,-32000,0,0,0,20000,52000,-32000,-32000
057456,道瓊銀富邦9C購01,0,0,0,0,0,0,0,0,0,-32000,0,0,0,25000,57000,-32000,-32000
058453,可成永豐99購01  ,0,0,0,0,0,0,0,0,0,-32000,0,0,0,0,32000,-32000,-32000
058397,大成鋼元大99購02,0,0,0,0,0,0,0,0,0,-32000,0,0,0,193000,225000,-32000,-32000
06026P,華通台新97售01  ,0,0,0,0,0,0,0,0,0,-32000,0,0,0,23000,55000,-32000,-32000
03619C,臺股指元大95牛02,0,0,0,0,0,0,0,0,0,-32000,0,0,0,6000,38000,-32000,-32000
046949,群創元大99購01  ,0,0,0,0,0,0,0,0,0,-32000,0,0,0,38000,70000,-32000,-32000
052516,臺股指凱基95購20,0,0,0,0,0,0,0,0,0,-32000,0,0,0,0,32000,-32000,-32000
052309,健策國泰97購01  ,0,0,0,0,0,0,0,0,0,-32000,0,0,0,54000,86000,-32000,-32000
053684,台積電元大96購17,0,0,0,0,0,0,0,0,0,-32000,0,0,0,68000,100000,-32000,-32000
050369,台積電元大94購23,0,0,0,0,0,0,0,0,0,-32000,0,0,0,134000,166000,-32000,-32000
050698,明泰凱基96購01  ,0,0,0,0,0,0,0,0,0,-32000,0,0,0,0,32000,-32000,-32000
051227,技嘉群益97購01  ,0,0,0,0,0,0,0,0,0,-32000,0,0,0,99000,131000,-32000,-32000
05063P,聯電元大96售03  ,0,0,0,0,0,0,0,0,0,-32000,0,0,0,0,32000,-32000,-32000
051823,矽力元富95購02  ,0,0,0,0,0,0,0,0,0,-32000,0,0,0,10000,42000,-32000,-32000
05271P,國巨富邦97售01  ,0,0,0,0,0,0,0,0,0,-32000,0,0,0,0,32000,-32000,-32000
054070,創意國泰96購02  ,0,0,0,0,0,0,0,0,0,-32000,0,0,0,10000,42000,-32000,-32000
053788,泰鼎元大97購01  ,0,0,0,0,0,0,0,0,0,-32000,0,0,0,19000,51000,-32000,-32000
054366,和大中信98購01  ,0,0,0,0,0,0,0,0,0,-32000,0,0,0,108000,140000,-32000,-32000
054803,味全元大9A購01  ,0,0,0,0,0,0,0,0,0,-32000,0,0,0,68000,100000,-32000,-32000
054784,順德群益9A購01  ,0,0,0,0,0,0,0,0,0,-32000,0,0,0,0,32000,-32000,-32000
054731,S&P反1凱基98購01,0,0,0,0,0,0,0,0,0,-32000,0,0,0,18000,50000,-32000,-32000
056311,泰鼎元大98購01  ,0,0,0,0,0,0,0,0,0,-32000,0,0,0,260000,292000,-32000,-32000
055873,聚陽元富97購01  ,0,0,0,0,0,0,0,0,0,-32000,0,0,0,43000,75000,-32000,-32000
06225P,華新科元富97售04,0,0,0,0,0,0,0,0,0,-32000,0,0,0,246000,278000,-32000,-32000
1737,臺鹽            ,58000,90000,-32000,0,0,0,0,0,0,0,0,0,0,0,0,0,-32000
912000,晨訊科-DR       ,3000,35000,-32000,0,0,0,0,0,0,0,0,0,0,0,0,0,-32000
057690,美律凱基99購03  ,0,0,0,0,0,0,0,0,0,-33000,0,0,0,0,33000,-33000,-33000
057378,康友元大98購02  ,0,0,0,0,0,0,0,0,0,-33000,0,0,0,20000,53000,-33000,-33000
057582,亞光中信9A購02  ,0,0,0,0,0,0,0,0,0,-33000,0,0,0,5000,38000,-33000,-33000
057557,聯茂凱基99購04  ,0,0,0,0,0,0,0,0,0,-33000,0,0,0,50000,83000,-33000,-33000
056935,華新科元富98購02,0,0,0,0,0,0,0,0,0,-33000,0,0,0,20000,53000,-33000,-33000
020000,富邦特選蘋果N   ,0,0,0,0,0,0,0,0,0,-33000,0,0,0,109000,142000,-33000,-33000
042929,台積電中信95購02,0,0,0,0,0,0,0,0,0,-33000,0,0,0,38000,71000,-33000,-33000
048414,滬深2X統一98購01,0,0,0,0,0,0,0,0,0,-33000,0,0,0,0,33000,-33000,-33000
052933,祥碩元大96購01  ,0,0,0,0,0,0,0,0,0,-33000,0,0,0,5000,38000,-33000,-33000
049104,元油2X富邦97購02,0,0,0,0,0,0,0,0,0,-33000,0,0,0,0,33000,-33000,-33000
048847,A50群益98購01   ,0,0,0,0,0,0,0,0,0,-33000,0,0,0,4000,37000,-33000,-33000
053084,國巨元大98購01  ,0,0,0,0,0,0,0,0,0,-33000,0,0,0,80000,113000,-33000,-33000
050681,南亞科元富94購01,0,0,0,0,0,0,0,0,0,-33000,0,0,0,0,33000,-33000,-33000
050525,嘉晶元大95購02  ,0,0,0,0,0,0,0,0,0,-33000,0,0,0,172000,205000,-33000,-33000
051214,大立光統一95購02,0,0,0,0,0,0,0,0,0,-33000,0,0,0,0,33000,-33000,-33000
052125,群創國票95購02  ,0,0,0,0,0,0,0,0,0,-33000,0,0,0,80000,113000,-33000,-33000
052521,友達元大9B購01  ,0,0,0,0,0,0,0,0,0,-33000,0,0,0,220000,253000,-33000,-33000
052461,和大統一95購01  ,0,0,0,0,0,0,0,0,0,-33000,0,0,0,50000,83000,-33000,-33000
055755,禾伸堂兆豐97購02,0,0,0,0,0,0,0,0,0,-33000,0,0,0,0,33000,-33000,-33000
055306,燿華群益97購01  ,0,0,0,0,0,0,0,0,0,-33000,0,0,0,0,33000,-33000,-33000
055425,聚陽群益99購01  ,0,0,0,0,0,0,0,0,0,-33000,0,0,0,21000,54000,-33000,-33000
055449,超眾統一9A購01  ,0,0,0,0,0,0,0,0,0,-33000,0,0,0,50000,83000,-33000,-33000
054743,聯鈞凱基99購01  ,0,0,0,0,0,0,0,0,0,-33000,0,0,0,753000,786000,-33000,-33000
054527,國巨統一97購03  ,0,0,0,0,0,0,0,0,0,-33000,0,0,0,62000,95000,-33000,-33000
054624,台積電凱基98購03,0,0,0,0,0,0,0,0,0,-33000,0,0,0,10000,43000,-33000,-33000
054829,亞光國泰99購01  ,0,0,0,0,0,0,0,0,0,-33000,0,0,0,0,33000,-33000,-33000
053858,台達電元大96購05,0,0,0,0,0,0,0,0,0,-33000,0,0,0,20000,53000,-33000,-33000
054097,淘帝國票97購01  ,0,0,0,0,0,0,0,0,0,-33000,0,0,0,11000,44000,-33000,-33000
054020,技嘉台新97購01  ,0,0,0,0,0,0,0,0,0,-33000,0,0,0,43000,76000,-33000,-33000
2441,超豐            ,367000,363000,4000,0,0,0,3000,0,3000,-40000,5000,45000,-40000,0,0,0,-33000
1809,中釉            ,139000,171000,-32000,0,0,0,0,0,0,-1000,0,1000,-1000,0,0,0,-33000
06887P,華新科元大98售04,0,0,0,0,0,0,0,0,0,-33000,0,0,0,0,33000,-33000,-33000
06127P,泰碩元富97售01  ,0,0,0,0,0,0,0,0,0,-33000,0,0,0,116000,149000,-33000,-33000
06132P,正文元富97售01  ,0,0,0,0,0,0,0,0,0,-33000,0,0,0,7000,40000,-33000,-33000
06581P,南亞科凱基98售04,0,0,0,0,0,0,0,0,0,-33000,0,0,0,20000,53000,-33000,-33000
057534,旭富元大98購01  ,0,0,0,0,0,0,0,0,0,-34000,0,0,0,208000,242000,-34000,-34000
058044,鴻海元大99購07  ,0,0,0,0,0,0,0,0,0,-34000,0,0,0,55000,89000,-34000,-34000
058028,國巨富邦99購04  ,0,0,0,0,0,0,0,0,0,-34000,0,0,0,16000,50000,-34000,-34000
058335,鴻海元富99購06  ,0,0,0,0,0,0,0,0,0,-34000,0,0,0,14000,48000,-34000,-34000
049425,喬山兆豐95購01  ,0,0,0,0,0,0,0,0,0,-34000,0,0,0,16000,50000,-34000,-34000
053545,上銀凱基96購03  ,0,0,0,0,0,0,0,0,0,-34000,0,0,0,9000,43000,-34000,-34000
053433,友達日盛99購06  ,0,0,0,0,0,0,0,0,0,-34000,0,0,0,0,34000,-34000,-34000
051281,健策兆豐96購01  ,0,0,0,0,0,0,0,0,0,-34000,0,0,0,10000,44000,-34000,-34000
051412,奇力新國票96購01,0,0,0,0,0,0,0,0,0,-34000,0,0,0,14000,48000,-34000,-34000
052075,旺宏元富95購03  ,0,0,0,0,0,0,0,0,0,-34000,0,0,0,0,34000,-34000,-34000
051495,玉晶光第一95購02,0,0,0,0,0,0,0,0,0,-34000,0,0,0,30000,64000,-34000,-34000
052984,漢唐元大96購01  ,0,0,0,0,0,0,0,0,0,-34000,0,0,0,11000,45000,-34000,-34000
051871,同欣電凱基95購02,0,0,0,0,0,0,0,0,0,-34000,0,0,0,1000,35000,-34000,-34000
052626,上証2X中信9A購01,0,0,0,0,0,0,0,0,0,-34000,0,0,0,6000,40000,-34000,-34000
053984,康友元大96購05  ,0,0,0,0,0,0,0,0,0,-34000,0,0,0,28000,62000,-34000,-34000
054079,鴻海中信98購02  ,0,0,0,0,0,0,0,0,0,-34000,0,0,0,0,34000,-34000,-34000
053758,華新科國泰97購02,0,0,0,0,0,0,0,0,0,-34000,0,0,0,1000,35000,-34000,-34000
055089,金寶群益98購01  ,0,0,0,0,0,0,0,0,0,-34000,0,0,0,93000,127000,-34000,-34000
055408,力成國泰98購01  ,0,0,0,0,0,0,0,0,0,-34000,0,0,0,10000,44000,-34000,-34000
055715,智邦元大97購04  ,0,0,0,0,0,0,0,0,0,-34000,0,0,0,25000,59000,-34000,-34000
056223,華邦電凱基97購04,0,0,0,0,0,0,0,0,0,-34000,0,0,0,0,34000,-34000,-34000
06479P,聯發科中信99售02,0,0,0,0,0,0,0,0,0,-34000,0,0,0,6000,40000,-34000,-34000
058359,瑞昱凱基99購01  ,0,0,0,0,0,0,0,0,0,-35000,0,0,0,0,35000,-35000,-35000
058399,美律元大99購05  ,0,0,0,0,0,0,0,0,0,-35000,0,0,0,10000,45000,-35000,-35000
058384,大成鋼中信99購01,0,0,0,0,0,0,0,0,0,-35000,0,0,0,0,35000,-35000,-35000
058218,緯穎群益99購01  ,0,0,0,0,0,0,0,0,0,-35000,0,0,0,37000,72000,-35000,-35000
057526,智邦元大98購10  ,0,0,0,0,0,0,0,0,0,-35000,0,0,0,5000,40000,-35000,-35000
057482,微星元大98購03  ,0,0,0,0,0,0,0,0,0,-35000,0,0,0,50000,85000,-35000,-35000
057302,福懋科中信98購01,0,0,0,0,0,0,0,0,0,-35000,0,0,0,20000,55000,-35000,-35000
057010,景碩中信98購01  ,0,0,0,0,0,0,0,0,0,-35000,0,0,0,0,35000,-35000,-35000
056748,T50反1兆豐99購01,0,0,0,0,0,0,0,0,0,-35000,0,0,0,0,35000,-35000,-35000
049956,國巨統一94購05  ,0,0,0,0,0,0,0,0,0,-35000,0,0,0,77000,112000,-35000,-35000
04753P,台積電統一94售11,0,0,0,0,0,0,0,0,0,-35000,0,0,0,0,35000,-35000,-35000
052770,聯茂群益96購02  ,0,0,0,0,0,0,0,0,0,-35000,0,0,0,54000,89000,-35000,-35000
049588,聯發科元大94購06,0,0,0,0,0,0,0,0,0,-35000,0,0,0,10000,45000,-35000,-35000
052593,台積電群益96購02,0,0,0,0,0,0,0,0,0,-35000,0,0,0,10000,45000,-35000,-35000
050979,鴻海元富96購02  ,0,0,0,0,0,0,0,0,0,-35000,0,0,0,11000,46000,-35000,-35000
052977,奇力新麥證97購01,0,0,0,10000,45000,-35000,0,0,0,-35000,0,0,0,10000,45000,-35000,-35000
051937,廣達群益95購01  ,0,0,0,0,0,0,0,0,0,-35000,0,0,0,85000,120000,-35000,-35000
05144P,美律永豐95售02  ,0,0,0,0,0,0,0,0,0,-35000,0,0,0,15000,50000,-35000,-35000
051513,台積電凱基95購13,0,0,0,0,0,0,0,0,0,-35000,0,0,0,70000,105000,-35000,-35000
051567,台積電富邦95購06,0,0,0,0,0,0,0,0,0,-35000,0,0,0,0,35000,-35000,-35000
052062,臺股指國票95購09,0,0,0,0,0,0,0,0,0,-35000,0,0,0,81000,116000,-35000,-35000
053454,創意統一96購02  ,0,0,0,0,0,0,0,0,0,-35000,0,0,0,20000,55000,-35000,-35000
053521,緯穎群益96購02  ,0,0,0,0,0,0,0,0,0,-35000,0,0,0,32000,67000,-35000,-35000
053319,可成群益96購04  ,0,0,0,0,0,0,0,0,0,-35000,0,0,0,0,35000,-35000,-35000
056403,茂林群益98購01  ,0,0,0,0,0,0,0,0,0,-35000,0,0,0,16000,51000,-35000,-35000
055783,群創凱基99購03  ,0,0,0,0,0,0,0,0,0,-35000,0,0,0,0,35000,-35000,-35000
055507,樺漢元大98購02  ,0,0,0,0,0,0,0,0,0,-35000,0,0,0,239000,274000,-35000,-35000
054513,元金2X元大96購01,0,0,0,0,0,0,0,0,0,-35000,0,0,0,0,35000,-35000,-35000
054730,上証2X凱基98購02,0,0,0,0,0,0,0,0,0,-35000,0,0,0,55000,90000,-35000,-35000
054682,東元永豐97購01  ,0,0,0,0,0,0,0,0,0,-35000,0,0,0,69000,104000,-35000,-35000
06501P,臺股指元大9A售06,0,0,0,0,0,0,0,0,0,-35000,0,0,0,0,35000,-35000,-35000
06342P,世芯統一98售01  ,0,0,0,0,0,0,0,0,0,-35000,0,0,0,0,35000,-35000,-35000
06384P,訊芯元富97售03  ,0,0,0,0,0,0,0,0,0,-35000,0,0,0,37000,72000,-35000,-35000
057684,聯茂日盛99購01  ,0,0,0,0,0,0,0,0,0,-36000,0,0,0,35000,71000,-36000,-36000
057862,智邦凱基99購01  ,0,0,0,0,0,0,0,0,0,-36000,0,0,0,142000,178000,-36000,-36000
049573,長榮航統一95購01,0,0,0,0,0,0,0,0,0,-36000,0,0,0,20000,56000,-36000,-36000
046961,大立光中信95購02,0,0,0,0,0,0,0,0,0,-36000,0,0,0,34000,70000,-36000,-36000
047058,聯茂國票94購01  ,0,0,0,0,0,0,0,0,0,-36000,0,0,0,0,36000,-36000,-36000
03412P,滬深2X群益98售01,0,0,0,0,0,0,0,0,0,-36000,0,0,0,40000,76000,-36000,-36000
052689,玉晶光元大98購03,0,0,0,0,0,0,0,0,0,-36000,0,0,0,1000,37000,-36000,-36000
052696,玉晶光麥證97購01,0,0,0,18000,55000,-37000,0,0,0,-36000,0,0,0,23000,59000,-36000,-36000
049927,健策元大94購02  ,0,0,0,0,0,0,0,0,0,-36000,0,0,0,13000,49000,-36000,-36000
052421,元油反國票9B購01,0,0,0,0,0,0,0,0,0,-36000,0,0,0,4000,40000,-36000,-36000
053744,台郡國票97購03  ,0,0,0,0,0,0,0,0,0,-36000,0,0,0,30000,66000,-36000,-36000
051729,華新國票96購01  ,0,0,0,0,0,0,0,0,0,-36000,0,0,0,51000,87000,-36000,-36000
053223,台郡凱基96購02  ,0,0,0,0,0,0,0,0,0,-36000,0,0,0,0,36000,-36000,-36000
054769,創意國票98購01  ,0,0,0,0,0,0,0,0,0,-36000,0,0,0,0,36000,-36000,-36000
055004,群創元富99購06  ,0,0,0,0,0,0,0,0,0,-36000,0,0,0,17000,53000,-36000,-36000
055160,玉晶光元大99購03,0,0,0,0,0,0,0,0,0,-36000,0,0,0,284000,320000,-36000,-36000
054838,京鼎第一97購01  ,0,0,0,0,0,0,0,0,0,-36000,0,0,0,20000,56000,-36000,-36000
054420,緯穎元大96購08  ,0,0,0,0,0,0,0,0,0,-36000,0,0,0,130000,166000,-36000,-36000
055652,聯詠元富01購01  ,0,0,0,0,0,0,0,0,0,-36000,0,0,0,91000,127000,-36000,-36000
055403,泰鼎元富97購01  ,0,0,0,0,0,0,0,0,0,-36000,0,0,0,62000,98000,-36000,-36000
055415,禾伸堂富邦9B購01,0,0,0,0,0,0,0,0,0,-36000,0,0,0,27000,63000,-36000,-36000
056347,GIS凱基9A購01   ,0,0,0,0,0,0,0,0,0,-36000,0,0,0,22000,58000,-36000,-36000
06319P,臺股指元富97售06,0,0,0,0,0,0,0,0,0,-36000,0,0,0,6000,42000,-36000,-36000
06126P,凌陽元富97售02  ,0,0,0,0,0,0,0,0,0,-36000,0,0,0,0,36000,-36000,-36000
06750P,聯發科元富02售03,0,0,0,0,0,0,0,0,0,-36000,0,0,0,20000,56000,-36000,-36000
2731,雄獅            ,49000,85000,-36000,0,0,0,0,0,0,0,0,0,0,0,0,0,-36000
3042,晶技            ,2031000,2847000,-816000,0,0,0,440000,0,440000,340000,293000,57000,236000,143000,39000,104000,-36000
058089,聯發科元大98購15,0,0,0,0,0,0,0,0,0,-37000,0,0,0,151000,188000,-37000,-37000
058721,立積元富9C購01  ,0,0,0,0,0,0,0,0,0,-37000,0,0,0,0,37000,-37000,-37000
056451,可成凱基99購01  ,0,0,0,0,0,0,0,0,0,-37000,0,0,0,0,37000,-37000,-37000
048527,鴻海國票94購02  ,0,0,0,0,0,0,0,0,0,-37000,0,0,0,152000,189000,-37000,-37000
052917,大立光富邦99購02,0,0,0,0,0,0,0,0,0,-37000,0,0,0,154000,191000,-37000,-37000
03618C,高股息凱基95牛01,0,0,0,0,0,0,0,0,0,-37000,0,0,0,0,37000,-37000,-37000
03663C,臺股指元大04牛01,0,0,0,0,0,0,0,0,0,-37000,0,0,0,0,37000,-37000,-37000
04597P,為升凱基94售02  ,0,0,0,0,0,0,0,0,0,-37000,0,0,0,13000,50000,-37000,-37000
04951P,緯創中信94售01  ,0,0,0,0,0,0,0,0,0,-37000,0,0,0,5000,42000,-37000,-37000
051015,南亞科凱基95購04,0,0,0,0,0,0,0,0,0,-37000,0,0,0,0,37000,-37000,-37000
052085,聯電元大95購01  ,0,0,0,0,0,0,0,0,0,-37000,0,0,0,110000,147000,-37000,-37000
051577,台積電元大97購03,0,0,0,0,0,0,0,0,0,-37000,0,0,0,12000,49000,-37000,-37000
050390,聯發科統一94購09,0,0,0,0,0,0,0,0,0,-37000,0,0,0,0,37000,-37000,-37000
056110,嘉聯益永豐97購02,0,0,0,0,0,0,0,0,0,-37000,0,0,0,10000,47000,-37000,-37000
056088,台郡統一97購02  ,0,0,0,0,0,0,0,0,0,-37000,0,0,0,1000,38000,-37000,-37000
055440,矽力國票98購01  ,0,0,0,0,0,0,0,0,0,-37000,0,0,0,45000,82000,-37000,-37000
055786,彩晶凱基99購02  ,0,0,0,0,0,0,0,0,0,-37000,0,0,0,1000,38000,-37000,-37000
054071,泰鼎國泰97購02  ,0,0,0,0,0,0,0,0,0,-37000,0,0,0,30000,67000,-37000,-37000
06654P,欣興元大98售08  ,0,0,0,0,0,0,0,0,0,-37000,0,0,0,12000,49000,-37000,-37000
1702,南僑            ,123000,162000,-39000,0,0,0,0,0,0,2000,2000,0,2000,0,0,0,-37000
1537,廣隆            ,23000,56000,-33000,0,0,0,0,0,0,-4000,1000,5000,-4000,0,0,0,-37000
056518,美律國票99購01  ,0,0,0,0,0,0,0,0,0,-38000,0,0,0,70000,108000,-38000,-38000
056585,台積電統一9A購01,0,0,0,0,0,0,0,0,0,-38000,0,0,0,0,38000,-38000,-38000
056629,昇陽半永豐98購01,0,0,0,0,0,0,0,0,0,-38000,0,0,0,50000,88000,-38000,-38000
057288,聯茂元大98購03  ,0,0,0,0,0,0,0,0,0,-38000,0,0,0,39000,77000,-38000,-38000
057490,可成元大98購10  ,0,0,0,0,0,0,0,0,0,-38000,0,0,0,129000,167000,-38000,-38000
057618,台光電凱基99購01,0,0,0,0,0,0,0,0,0,-38000,0,0,0,5000,43000,-38000,-38000
058555,矽創永豐9A購01  ,0,0,0,0,0,0,0,0,0,-38000,0,0,0,150000,188000,-38000,-38000
058206,祥碩凱基99購01  ,0,0,0,0,0,0,0,0,0,-38000,0,0,0,15000,53000,-38000,-38000
048139,南電國票94購02  ,0,0,0,0,0,0,0,0,0,-38000,0,0,0,0,38000,-38000,-38000
044509,台光電凱基93購03,0,0,0,0,0,0,0,0,0,-38000,0,0,0,0,38000,-38000,-38000
044382,嘉聯益群益94購01,0,0,0,0,0,0,0,0,0,-38000,0,0,0,0,38000,-38000,-38000
048707,南電國票95購01  ,0,0,0,0,0,0,0,0,0,-38000,0,0,0,0,38000,-38000,-38000
048379,台郡元富96購01  ,0,0,0,0,0,0,0,0,0,-38000,0,0,0,8000,46000,-38000,-38000
050327,泰鼎永豐94購03  ,0,0,0,0,0,0,0,0,0,-38000,0,0,0,56000,94000,-38000,-38000
050309,亞泥兆豐94購01  ,0,0,0,0,0,0,0,0,0,-38000,0,0,0,8000,46000,-38000,-38000
05370P,矽創元富95售01  ,0,0,0,0,0,0,0,0,0,-38000,0,0,0,26000,64000,-38000,-38000
053478,京鼎元大96購01  ,0,0,0,0,0,0,0,0,0,-38000,0,0,0,111000,149000,-38000,-38000
053490,為升兆豐97購01  ,0,0,0,0,0,0,0,0,0,-38000,0,0,0,15000,53000,-38000,-38000
051127,同欣電群益95購01,0,0,0,0,0,0,0,0,0,-38000,0,0,0,57000,95000,-38000,-38000
050618,緯創元大95購01  ,0,0,0,0,0,0,0,0,0,-38000,0,0,0,96000,134000,-38000,-38000
050736,台積電康和94購01,0,0,0,0,0,0,0,0,0,-38000,0,0,0,80000,118000,-38000,-38000
054469,同欣電凱基97購01,0,0,0,0,0,0,0,0,0,-38000,0,0,0,2000,40000,-38000,-38000
054783,國巨群益98購04  ,0,0,0,0,0,0,0,0,0,-38000,0,0,0,111000,149000,-38000,-38000
054674,台光電台新97購01,0,0,0,0,0,0,0,0,0,-38000,0,0,0,0,38000,-38000,-38000
054483,聯電台新96購01  ,0,0,0,0,0,0,0,0,0,-38000,0,0,0,0,38000,-38000,-38000
054484,仁寶台新96購01  ,0,0,0,0,0,0,0,0,0,-38000,0,0,0,0,38000,-38000,-38000
055985,聯鈞元富97購01  ,0,0,0,0,0,0,0,0,0,-38000,0,0,0,11000,49000,-38000,-38000
056406,建準國票99購01  ,0,0,0,0,0,0,0,0,0,-38000,0,0,0,0,38000,-38000,-38000
07015P,國巨元大99售13  ,0,0,0,0,0,0,0,0,0,-38000,0,0,0,132000,170000,-38000,-38000
06248P,國巨統一97售07  ,0,0,0,0,0,0,0,0,0,-38000,0,0,0,26000,64000,-38000,-38000
057998,玉晶光麥證9A購01,0,0,0,16000,55000,-39000,0,0,0,-39000,0,0,0,16000,55000,-39000,-39000
058311,緯穎元大99購05  ,0,0,0,0,0,0,0,0,0,-39000,0,0,0,31000,70000,-39000,-39000
05668P,滬深2X永豐96售04,0,0,0,0,0,0,0,0,0,-39000,0,0,0,11000,50000,-39000,-39000
049490,京元電元大95購02,0,0,0,0,0,0,0,0,0,-39000,0,0,0,98000,137000,-39000,-39000
050659,宏達電元大96購01,0,0,0,0,0,0,0,0,0,-39000,0,0,0,0,39000,-39000,-39000
053267,華新科群益96購02,0,0,0,0,0,0,0,0,0,-39000,0,0,0,2000,41000,-39000,-39000
050279,彩晶第一94購01  ,0,0,0,0,0,0,0,0,0,-39000,0,0,0,0,39000,-39000,-39000
052962,台積電凱基97購03,0,0,0,0,0,0,0,0,0,-39000,0,0,0,2000,41000,-39000,-39000
051788,奇力新國票97購02,0,0,0,0,0,0,0,0,0,-39000,0,0,0,25000,64000,-39000,-39000
051740,可成國票96購04  ,0,0,0,0,0,0,0,0,0,-39000,0,0,0,1000,40000,-39000,-39000
056412,上証2X中信9A購02,0,0,0,0,0,0,0,0,0,-39000,0,0,0,11000,50000,-39000,-39000
056093,大毅元富97購01  ,0,0,0,0,0,0,0,0,0,-39000,0,0,0,0,39000,-39000,-39000
055860,啟碁元大97購04  ,0,0,0,0,0,0,0,0,0,-39000,0,0,0,68000,107000,-39000,-39000
055657,超眾元富97購02  ,0,0,0,0,0,0,0,0,0,-39000,0,0,0,6000,45000,-39000,-39000
055229,大毅國票97購02  ,0,0,0,0,0,0,0,0,0,-39000,0,0,0,54000,93000,-39000,-39000
054773,台郡國票98購01  ,0,0,0,0,0,0,0,0,0,-39000,0,0,0,0,39000,-39000,-39000
054254,晶豪科元大96購02,0,0,0,0,0,0,0,0,0,-39000,0,0,0,91000,130000,-39000,-39000
053928,智易國票97購03  ,0,0,0,0,0,0,0,0,0,-39000,0,0,0,0,39000,-39000,-39000
06758P,鴻海元大98售10  ,0,0,0,0,0,0,0,0,0,-39000,0,0,0,81000,120000,-39000,-39000
06981P,台灣50麥證99售02,0,0,0,0,39000,-39000,0,0,0,-39000,0,0,0,0,39000,-39000,-39000
1323,永裕            ,12000,50000,-38000,0,0,0,0,0,0,-1000,0,1000,-1000,0,0,0,-39000
2345,智邦            ,1688000,2040200,-352200,0,0,0,90000,0,90000,223000,131000,70000,61000,175000,13000,162000,-39200
056575,禾伸堂元大99購01,0,0,0,0,0,0,0,0,0,-40000,0,0,0,113000,153000,-40000,-40000
056543,京鼎凱基98購01  ,0,0,0,0,0,0,0,0,0,-40000,0,0,0,0,40000,-40000,-40000
056491,南亞科國泰99購01,0,0,0,0,0,0,0,0,0,-40000,0,0,0,0,40000,-40000,-40000
056934,國巨元富98購04  ,0,0,0,0,0,0,0,0,0,-40000,0,0,0,0,40000,-40000,-40000
058421,國泰金麥證01購01,0,0,0,0,40000,-40000,0,0,0,-40000,0,0,0,0,40000,-40000,-40000
058511,華新科元大9B購01,0,0,0,0,0,0,0,0,0,-40000,0,0,0,10000,50000,-40000,-40000
058613,茂林元大99購03  ,0,0,0,0,0,0,0,0,0,-40000,0,0,0,4000,44000,-40000,-40000
057984,聯發科台新98購01,0,0,0,0,0,0,0,0,0,-40000,0,0,0,0,40000,-40000,-40000
05805P,義隆永豐96售02  ,0,0,0,0,0,0,0,0,0,-40000,0,0,0,13000,53000,-40000,-40000
058119,華新亞東99購01  ,0,0,0,0,0,0,0,0,0,-40000,0,0,0,58000,98000,-40000,-40000
058281,奇力新中信99購01,0,0,0,0,0,0,0,0,0,-40000,0,0,0,0,40000,-40000,-40000
058275,S&P500中信9B購01,0,0,0,0,0,0,0,0,0,-40000,0,0,0,0,40000,-40000,-40000
057818,泰碩元大9A購01  ,0,0,0,0,0,0,0,0,0,-40000,0,0,0,66000,106000,-40000,-40000
057828,緯穎元大99購02  ,0,0,0,0,0,0,0,0,0,-40000,0,0,0,0,40000,-40000,-40000
057948,嘉聯益國票99購02,0,0,0,0,0,0,0,0,0,-40000,0,0,0,10000,50000,-40000,-40000
057692,臺股指凱基98購10,0,0,0,0,0,0,0,0,0,-40000,0,0,0,0,40000,-40000,-40000
057780,台郡群益98購02  ,0,0,0,0,0,0,0,0,0,-40000,0,0,0,10000,50000,-40000,-40000
048435,致新國票93購01  ,0,0,0,0,0,0,0,0,0,-40000,0,0,0,0,40000,-40000,-40000
049453,新日興統一94購01,0,0,0,0,0,0,0,0,0,-40000,0,0,0,0,40000,-40000,-40000
048676,和鑫國泰94購02  ,0,0,0,0,0,0,0,0,0,-40000,0,0,0,0,40000,-40000,-40000
048792,瑞儀元大94購01  ,0,0,0,0,0,0,0,0,0,-40000,0,0,0,0,40000,-40000,-40000
04878P,國巨康和94售02  ,0,0,0,0,0,0,0,0,0,-40000,0,0,0,0,40000,-40000,-40000
048766,禾伸堂凱基94購01,0,0,0,0,0,0,0,0,0,-40000,0,0,0,0,40000,-40000,-40000
049090,茂林凱基94購01  ,0,0,0,0,0,0,0,0,0,-40000,0,0,0,0,40000,-40000,-40000
052901,台達電國票97購01,0,0,0,0,0,0,0,0,0,-40000,0,0,0,30000,70000,-40000,-40000
052840,友達富邦96購01  ,0,0,0,0,0,0,0,0,0,-40000,0,0,0,0,40000,-40000,-40000
044129,群創凱基93購02  ,0,0,0,0,0,0,0,0,0,-40000,0,0,0,0,40000,-40000,-40000
046707,友達康和93購01  ,0,0,0,0,0,0,0,0,0,-40000,0,0,0,0,40000,-40000,-40000
046187,友達凱基93購03  ,0,0,0,0,0,0,0,0,0,-40000,0,0,0,0,40000,-40000,-40000
03935P,可成富邦95售01  ,0,0,0,0,0,0,0,0,0,-40000,0,0,0,0,40000,-40000,-40000
047435,台積電元大94購01,0,0,0,0,0,0,0,0,0,-40000,0,0,0,0,40000,-40000,-40000
049250,華通元大95購04  ,0,0,0,0,0,0,0,0,0,-40000,0,0,0,10000,50000,-40000,-40000
04964P,鴻海元大94售26  ,0,0,0,0,0,0,0,0,0,-40000,0,0,0,4000,44000,-40000,-40000
049622,聯詠群益94購02  ,0,0,0,0,0,0,0,0,0,-40000,0,0,0,10000,50000,-40000,-40000
051741,可成國票97購01  ,0,0,0,0,0,0,0,0,0,-40000,0,0,0,0,40000,-40000,-40000
052959,聯電凱基97購01  ,0,0,0,0,0,0,0,0,0,-40000,0,0,0,10000,50000,-40000,-40000
051579,宏碁元大95購01  ,0,0,0,0,0,0,0,0,0,-40000,0,0,0,0,40000,-40000,-40000
051559,宏達電國泰96購01,0,0,0,0,0,0,0,0,0,-40000,0,0,0,8000,48000,-40000,-40000
052137,台表科凱基96購02,0,0,0,0,0,0,0,0,0,-40000,0,0,0,0,40000,-40000,-40000
051364,鴻海國泰97購03  ,0,0,0,0,0,0,0,0,0,-40000,0,0,0,0,40000,-40000,-40000
053463,可成富邦98購01  ,0,0,0,0,0,0,0,0,0,-40000,0,0,0,5000,45000,-40000,-40000
052399,台光電凱基95購03,0,0,0,0,0,0,0,0,0,-40000,0,0,0,0,40000,-40000,-40000
052366,聯詠國票96購01  ,0,0,0,0,0,0,0,0,0,-40000,0,0,0,0,40000,-40000,-40000
052296,TPK國票96購01   ,0,0,0,0,0,0,0,0,0,-40000,0,0,0,1497000,1537000,-40000,-40000
053610,矽力中信98購01  ,0,0,0,0,0,0,0,0,0,-40000,0,0,0,50000,90000,-40000,-40000
053592,亞光元大96購01  ,0,0,0,0,0,0,0,0,0,-40000,0,0,0,55000,95000,-40000,-40000
051087,國巨元大97購01  ,0,0,0,0,0,0,0,0,0,-40000,0,0,0,0,40000,-40000,-40000
050904,臺股指元大95購11,0,0,0,0,0,0,0,0,0,-40000,0,0,0,0,40000,-40000,-40000
051994,瀚宇博元大96購01,0,0,0,0,0,0,0,0,0,-40000,0,0,0,0,40000,-40000,-40000
051226,英業達群益95購01,0,0,0,0,0,0,0,0,0,-40000,0,0,0,43000,83000,-40000,-40000
051973,華新科凱基96購04,0,0,0,0,0,0,0,0,0,-40000,0,0,0,257000,297000,-40000,-40000
05102P,臺股指凱基96售09,0,0,0,0,0,0,0,0,0,-40000,0,0,0,0,40000,-40000,-40000
051910,大立光元大97購01,0,0,0,0,0,0,0,0,0,-40000,0,0,0,0,40000,-40000,-40000
053212,友達凱基99購04  ,0,0,0,0,0,0,0,0,0,-40000,0,0,0,30000,70000,-40000,-40000
051877,嘉聯益國票97購02,0,0,0,0,0,0,0,0,0,-40000,0,0,0,20000,60000,-40000,-40000
050205,牧德群益94購02  ,0,0,0,0,0,0,0,0,0,-40000,0,0,0,60000,100000,-40000,-40000
050913,全新中信97購01  ,0,0,0,0,0,0,0,0,0,-40000,0,0,0,0,40000,-40000,-40000
053851,鴻海國泰98購03  ,0,0,0,0,0,0,0,0,0,-40000,0,0,0,0,40000,-40000,-40000
054131,南亞科元大96購04,0,0,0,0,0,0,0,0,0,-40000,0,0,0,55000,95000,-40000,-40000
054146,康友元大96購06  ,0,0,0,0,0,0,0,0,0,-40000,0,0,0,14000,54000,-40000,-40000
054767,日電貿國票98購01,0,0,0,0,0,0,0,0,0,-40000,0,0,0,40000,80000,-40000,-40000
054804,南亞元大9A購01  ,0,0,0,0,0,0,0,0,0,-40000,0,0,0,0,40000,-40000,-40000
054704,玉晶光第一97購01,0,0,0,0,0,0,0,0,0,-40000,0,0,0,101000,141000,-40000,-40000
054846,瑞昱兆豐97購01  ,0,0,0,0,0,0,0,0,0,-40000,0,0,0,0,40000,-40000,-40000
05494P,華邦電統一95售02,0,0,0,0,0,0,0,0,0,-40000,0,0,0,0,40000,-40000,-40000
054976,上証2X元富9A購01,0,0,0,0,0,0,0,0,0,-40000,0,0,0,10000,50000,-40000,-40000
055146,華通元大98購04  ,0,0,0,0,0,0,0,0,0,-40000,0,0,0,0,40000,-40000,-40000
055127,台虹兆豐97購01  ,0,0,0,0,0,0,0,0,0,-40000,0,0,0,16000,56000,-40000,-40000
055040,台虹富邦99購01  ,0,0,0,0,0,0,0,0,0,-40000,0,0,0,98000,138000,-40000,-40000
055209,勤誠康和97購01  ,0,0,0,0,0,0,0,0,0,-40000,0,0,0,60000,100000,-40000,-40000
055224,鴻海國票99購02  ,0,0,0,0,0,0,0,0,0,-40000,0,0,0,10000,50000,-40000,-40000
055366,國巨元大98購05  ,0,0,0,0,0,0,0,0,0,-40000,0,0,0,0,40000,-40000,-40000
055695,大毅國票98購03  ,0,0,0,0,0,0,0,0,0,-40000,0,0,0,10000,50000,-40000,-40000
055743,TPK元富98購01   ,0,0,0,0,0,0,0,0,0,-40000,0,0,0,10000,50000,-40000,-40000
055699,康控國票97購04  ,0,0,0,0,0,0,0,0,0,-40000,0,0,0,20000,60000,-40000,-40000
055466,台達電凱基97購03,0,0,0,0,0,0,0,0,0,-40000,0,0,0,0,40000,-40000,-40000
055568,緯穎凱基97購02  ,0,0,0,0,0,0,0,0,0,-40000,0,0,0,0,40000,-40000,-40000
056395,玉晶光永豐9B購01,0,0,0,0,0,0,0,0,0,-40000,0,0,0,0,40000,-40000,-40000
056376,玉晶光統一98購01,0,0,0,0,0,0,0,0,0,-40000,0,0,0,20000,60000,-40000,-40000
056234,GIS麥證97購01   ,0,0,0,10000,50000,-40000,0,0,0,-40000,0,0,0,10000,50000,-40000,-40000
056309,合勤控元大97購01,0,0,0,0,0,0,0,0,0,-40000,0,0,0,0,40000,-40000,-40000
06898P,FBVIX群益9C售03 ,0,0,0,0,0,0,0,0,0,-40000,0,0,0,0,40000,-40000,-40000
06790P,台積電凱基9A售04,0,0,0,0,0,0,0,0,0,-40000,0,0,0,235000,275000,-40000,-40000
06667P,鴻海凱基98售11  ,0,0,0,0,0,0,0,0,0,-40000,0,0,0,91000,131000,-40000,-40000
06452P,大立光元大98售08,0,0,0,0,0,0,0,0,0,-40000,0,0,0,5000,45000,-40000,-40000
06579P,臺股指麥證98售03,0,0,0,0,40000,-40000,0,0,0,-40000,0,0,0,0,40000,-40000,-40000
06379P,群創統一97售05  ,0,0,0,0,0,0,0,0,0,-40000,0,0,0,50000,90000,-40000,-40000
06069P,台積電永豐97售01,0,0,0,0,0,0,0,0,0,-40000,0,0,0,27000,67000,-40000,-40000
057882,華通群益9A購03  ,0,0,0,0,0,0,0,0,0,-41000,0,0,0,23000,64000,-41000,-41000
056472,美律元大99購03  ,0,0,0,0,0,0,0,0,0,-41000,0,0,0,0,41000,-41000,-41000
056562,奇力新群益98購01,0,0,0,0,0,0,0,0,0,-41000,0,0,0,100000,141000,-41000,-41000
057102,亞光中信9A購01  ,0,0,0,0,0,0,0,0,0,-41000,0,0,0,0,41000,-41000,-41000
045414,康控群益94購02  ,0,0,0,0,0,0,0,0,0,-41000,0,0,0,5000,46000,-41000,-41000
047137,健策凱基94購01  ,0,0,0,0,0,0,0,0,0,-41000,0,0,0,30000,71000,-41000,-41000
052878,台虹凱基96購01  ,0,0,0,0,0,0,0,0,0,-41000,0,0,0,85000,126000,-41000,-41000
052653,臺股指永豐97購01,0,0,0,0,0,0,0,0,0,-41000,0,0,0,0,41000,-41000,-41000
051817,元金2X統一95購01,0,0,0,0,0,0,0,0,0,-41000,0,0,0,40000,81000,-41000,-41000
053123,京元電凱基96購01,0,0,0,0,0,0,0,0,0,-41000,0,0,0,20000,61000,-41000,-41000
050774,健策元大96購02  ,0,0,0,0,0,0,0,0,0,-41000,0,0,0,95000,136000,-41000,-41000
051131,玉山金台新95購01,0,0,0,0,0,0,0,0,0,-41000,0,0,0,20000,61000,-41000,-41000
053291,旺宏中信9A購01  ,0,0,0,0,0,0,0,0,0,-41000,0,0,0,3000,44000,-41000,-41000
051422,超眾國票96購01  ,0,0,0,0,0,0,0,0,0,-41000,0,0,0,0,41000,-41000,-41000
051603,深中小群益99購03,0,0,0,0,0,0,0,0,0,-41000,0,0,0,12000,53000,-41000,-41000
056393,精元永豐98購01  ,0,0,0,0,0,0,0,0,0,-41000,0,0,0,0,41000,-41000,-41000
055497,開發金元大97購01,0,0,0,0,0,0,0,0,0,-41000,0,0,0,0,41000,-41000,-41000
055238,茂林台新97購01  ,0,0,0,0,0,0,0,0,0,-41000,0,0,0,0,41000,-41000,-41000
054778,世紀鋼國票99購01,0,0,0,0,0,0,0,0,0,-41000,0,0,0,40000,81000,-41000,-41000
053962,聯茂永豐96購01  ,0,0,0,0,0,0,0,0,0,-41000,0,0,0,87000,128000,-41000,-41000
06158P,玉晶光元富97售08,0,0,0,0,0,0,0,0,0,-41000,0,0,0,3000,44000,-41000,-41000
06864P,健策凱基98售01  ,0,0,0,0,0,0,0,0,0,-41000,0,0,0,348000,389000,-41000,-41000
1417,嘉裕            ,0,41000,-41000,0,0,0,0,0,0,0,0,0,0,0,0,0,-41000
057217,奇力新群益99購01,0,0,0,0,0,0,0,0,0,-42000,0,0,0,30000,72000,-42000,-42000
057005,元油2X中信9C購01,0,0,0,0,0,0,0,0,0,-42000,0,0,0,0,42000,-42000,-42000
058575,智邦群益99購01  ,0,0,0,0,0,0,0,0,0,-42000,0,0,0,44000,86000,-42000,-42000
048281,矽力永豐93購02  ,0,0,0,0,0,0,0,0,0,-42000,0,0,0,11000,53000,-42000,-42000
03543P,台泥中信02售01  ,0,0,0,0,0,0,0,0,0,-42000,0,0,0,20000,62000,-42000,-42000
00702,國泰標普低波高息,2000,0,2000,0,0,0,0,0,0,-44000,0,0,0,63000,107000,-44000,-42000
05306P,泰碩國泰97售01  ,0,0,0,0,0,0,0,0,0,-42000,0,0,0,396000,438000,-42000,-42000
052488,旺宏國票96購03  ,0,0,0,0,0,0,0,0,0,-42000,0,0,0,0,42000,-42000,-42000
053354,康控兆豐97購02  ,0,0,0,0,0,0,0,0,0,-42000,0,0,0,18000,60000,-42000,-42000
052020,聯茂永豐95購02  ,0,0,0,0,0,0,0,0,0,-42000,0,0,0,97000,139000,-42000,-42000
050114,群創元大95購01  ,0,0,0,0,0,0,0,0,0,-42000,0,0,0,11000,53000,-42000,-42000
054234,可成群益96購05  ,0,0,0,0,0,0,0,0,0,-42000,0,0,0,56000,98000,-42000,-42000
05479P,華新科台新96售01,0,0,0,0,0,0,0,0,0,-42000,0,0,0,61000,103000,-42000,-42000
054538,台光電國票98購01,0,0,0,0,0,0,0,0,0,-42000,0,0,0,30000,72000,-42000,-42000
054619,昇陽半永豐97購03,0,0,0,0,0,0,0,0,0,-42000,0,0,0,0,42000,-42000,-42000
054871,明泰群益98購01  ,0,0,0,0,0,0,0,0,0,-42000,0,0,0,2000,44000,-42000,-42000
054883,億光統一97購01  ,0,0,0,0,0,0,0,0,0,-42000,0,0,0,30000,72000,-42000,-42000
056210,矽創永豐97購02  ,0,0,0,0,0,0,0,0,0,-42000,0,0,0,0,42000,-42000,-42000
056168,鴻海元富97購07  ,0,0,0,0,0,0,0,0,0,-42000,0,0,0,34000,76000,-42000,-42000
06561P,台灣50國泰9A售01,0,0,0,0,0,0,0,0,0,-42000,0,0,0,10000,52000,-42000,-42000
058295,欣興凱基99購02  ,0,0,0,0,0,0,0,0,0,-43000,0,0,0,0,43000,-43000,-43000
058689,元油2X國票99購03,0,0,0,0,0,0,0,0,0,-43000,0,0,0,0,43000,-43000,-43000
06030P,友達兆豐96售02  ,0,0,0,0,0,0,0,0,0,-43000,0,0,0,72000,115000,-43000,-43000
05927P,正文永豐96售03  ,0,0,0,0,0,0,0,0,0,-43000,0,0,0,20000,63000,-43000,-43000
057025,華新科凱基98購04,0,0,0,0,0,0,0,0,0,-43000,0,0,0,77000,120000,-43000,-43000
056776,聯茂元大99購01  ,0,0,0,0,0,0,0,0,0,-43000,0,0,0,38000,81000,-43000,-43000
056847,佐登元富98購01  ,0,0,0,0,0,0,0,0,0,-43000,0,0,0,7000,50000,-43000,-43000
056867,華通麥證98購01  ,0,0,0,30000,73000,-43000,0,0,0,-43000,0,0,0,30000,73000,-43000,-43000
056692,燿華群益98購03  ,0,0,0,0,0,0,0,0,0,-43000,0,0,0,0,43000,-43000,-43000
057189,康控元大98購02  ,0,0,0,0,0,0,0,0,0,-43000,0,0,0,110000,153000,-43000,-43000
057479,致茂元大98購03  ,0,0,0,0,0,0,0,0,0,-43000,0,0,0,25000,68000,-43000,-43000
057437,可成國票99購01  ,0,0,0,0,0,0,0,0,0,-43000,0,0,0,215000,258000,-43000,-43000
048273,南電富邦97購01  ,0,0,0,0,0,0,0,0,0,-43000,0,0,0,80000,123000,-43000,-43000
052806,玉晶光元大98購04,0,0,0,0,0,0,0,0,0,-43000,0,0,0,108000,151000,-43000,-43000
048839,牧德凱基95購01  ,0,0,0,0,0,0,0,0,0,-43000,0,0,0,0,43000,-43000,-43000
052627,中壽中信98購01  ,0,0,0,0,0,0,0,0,0,-43000,0,0,0,0,43000,-43000,-43000
053145,元黃金元大96購02,0,0,0,0,0,0,0,0,0,-43000,0,0,0,2000,45000,-43000,-43000
053668,鴻海統一97購01  ,0,0,0,0,0,0,0,0,0,-43000,0,0,0,66000,109000,-43000,-43000
052328,台表科中信99購01,0,0,0,0,0,0,0,0,0,-43000,0,0,0,0,43000,-43000,-43000
052753,電子類元大96購02,0,0,0,0,0,0,0,0,0,-43000,0,0,0,75000,118000,-43000,-43000
052069,聯茂兆豐96購01  ,0,0,0,0,0,0,0,0,0,-43000,0,0,0,0,43000,-43000,-43000
056340,可成凱基98購04  ,0,0,0,0,0,0,0,0,0,-43000,0,0,0,0,43000,-43000,-43000
056007,上銀中信97購02  ,0,0,0,0,0,0,0,0,0,-43000,0,0,0,48000,91000,-43000,-43000
054978,堤維西元富97購01,0,0,0,0,0,0,0,0,0,-43000,0,0,0,7000,50000,-43000,-43000
054173,奇力新台新97購02,0,0,0,0,0,0,0,0,0,-43000,0,0,0,0,43000,-43000,-43000
054046,義隆元大96購02  ,0,0,0,0,0,0,0,0,0,-43000,0,0,0,316000,359000,-43000,-43000
053786,新日興元大96購02,0,0,0,0,0,0,0,0,0,-43000,0,0,0,13000,56000,-43000,-43000
06868P,電子類元大99售01,0,0,0,0,0,0,0,0,0,-43000,0,0,0,143000,186000,-43000,-43000
06902P,聯電凱基98售02  ,0,0,0,0,0,0,0,0,0,-43000,0,0,0,35000,78000,-43000,-43000
6139,亞翔            ,98000,152000,-54000,0,0,0,0,0,0,11000,12000,1000,11000,0,0,0,-43000
057181,亞光元大98購02  ,0,0,0,0,0,0,0,0,0,-44000,0,0,0,55000,99000,-44000,-44000
056615,燿華永豐98購02  ,0,0,0,0,0,0,0,0,0,-44000,0,0,0,24000,68000,-44000,-44000
05987P,健策統一96售02  ,0,0,0,0,0,0,0,0,0,-44000,0,0,0,40000,84000,-44000,-44000
058404,貿聯元大99購02  ,0,0,0,0,0,0,0,0,0,-44000,0,0,0,49000,93000,-44000,-44000
058196,台塑中信99購01  ,0,0,0,0,0,0,0,0,0,-44000,0,0,0,0,44000,-44000,-44000
058083,聯發科群益98購08,0,0,0,0,0,0,0,0,0,-44000,0,0,0,1005000,1049000,-44000,-44000
052782,超眾國票96購02  ,0,0,0,0,0,0,0,0,0,-44000,0,0,0,22000,66000,-44000,-44000
048276,旺宏永豐94購01  ,0,0,0,0,0,0,0,0,0,-44000,0,0,0,0,44000,-44000,-44000
046600,鴻海群益94購01  ,0,0,0,0,0,0,0,0,0,-44000,0,0,0,60000,104000,-44000,-44000
053677,同欣電國泰97購01,0,0,0,0,0,0,0,0,0,-44000,0,0,0,130000,174000,-44000,-44000
05307P,光寶科中信95售01,0,0,0,0,0,0,0,0,0,-44000,0,0,0,141000,185000,-44000,-44000
052987,華新科元大99購01,0,0,0,0,0,0,0,0,0,-44000,0,0,0,76000,120000,-44000,-44000
052616,鴻海國泰98購02  ,0,0,0,0,0,0,0,0,0,-44000,0,0,0,4000,48000,-44000,-44000
056114,台達電群益97購02,0,0,0,0,0,0,0,0,0,-44000,0,0,0,0,44000,-44000,-44000
056387,智伸科國泰99購01,0,0,0,0,0,0,0,0,0,-44000,0,0,0,30000,74000,-44000,-44000
056246,祥碩群益97購01  ,0,0,0,0,0,0,0,0,0,-44000,0,0,0,136000,180000,-44000,-44000
055269,和大元大97購02  ,0,0,0,0,0,0,0,0,0,-44000,0,0,0,75000,119000,-44000,-44000
05546P,全新元大97售01  ,0,0,0,0,0,0,0,0,0,-44000,0,0,0,224000,268000,-44000,-44000
055499,大立光元大98購05,0,0,0,0,0,0,0,0,0,-44000,0,0,0,10000,54000,-44000,-44000
4536,拓凱            ,28000,56000,-28000,0,0,0,0,0,0,-16000,0,16000,-16000,0,0,0,-44000
06594P,立積元大98售01  ,0,0,0,0,0,0,0,0,0,-44000,0,0,0,246000,290000,-44000,-44000
06454P,緯穎元大98售04  ,0,0,0,0,0,0,0,0,0,-44000,0,0,0,239000,283000,-44000,-44000
06486P,麗豐元大98售02  ,0,0,0,0,0,0,0,0,0,-44000,0,0,0,5000,49000,-44000,-44000
06264P,友達凱基98售06  ,0,0,0,0,0,0,0,0,0,-44000,0,0,0,16000,60000,-44000,-44000
058285,牧德群益9A購02  ,0,0,0,0,0,0,0,0,0,-45000,0,0,0,0,45000,-45000,-45000
057949,南電國票99購01  ,0,0,0,0,0,0,0,0,0,-45000,0,0,0,23000,68000,-45000,-45000
057967,聯發科國泰9A購02,0,0,0,0,0,0,0,0,0,-45000,0,0,0,90000,135000,-45000,-45000
057733,嘉聯益國泰99購01,0,0,0,0,0,0,0,0,0,-45000,0,0,0,0,45000,-45000,-45000
058609,玉山金元大99購01,0,0,0,0,0,0,0,0,0,-45000,0,0,0,24000,69000,-45000,-45000
056782,鴻海群益98購04  ,0,0,0,0,0,0,0,0,0,-45000,0,0,0,42000,87000,-45000,-45000
057041,國巨元大99購04  ,0,0,0,0,0,0,0,0,0,-45000,0,0,0,245000,290000,-45000,-45000
057007,奇力新中信98購04,0,0,0,0,0,0,0,0,0,-45000,0,0,0,0,45000,-45000,-45000
057457,華邦電富邦98購01,0,0,0,0,0,0,0,0,0,-45000,0,0,0,0,45000,-45000,-45000
057594,宏達電兆豐99購01,0,0,0,0,0,0,0,0,0,-45000,0,0,0,0,45000,-45000,-45000
04253P,聯發科元富93售01,0,0,0,0,0,0,0,0,0,-45000,0,0,0,0,45000,-45000,-45000
04373P,滬深2X元大97售01,0,0,0,0,0,0,0,0,0,-45000,0,0,0,379000,424000,-45000,-45000
043784,鴻海凱基94購01  ,0,0,0,0,0,0,0,0,0,-45000,0,0,0,0,45000,-45000,-45000
044683,聯鈞凱基93購01  ,0,0,0,0,0,0,0,0,0,-45000,0,0,0,3000,48000,-45000,-45000
052648,茂林永豐96購01  ,0,0,0,0,0,0,0,0,0,-45000,0,0,0,0,45000,-45000,-45000
050062,聯發科凱基94購08,0,0,0,0,0,0,0,0,0,-45000,0,0,0,15000,60000,-45000,-45000
051802,同欣電永豐95購02,0,0,0,0,0,0,0,0,0,-45000,0,0,0,58000,103000,-45000,-45000
050783,旺宏國泰96購02  ,0,0,0,0,0,0,0,0,0,-45000,0,0,0,270000,315000,-45000,-45000
051083,A50正2元大98購01,0,0,0,0,0,0,0,0,0,-45000,0,0,0,15000,60000,-45000,-45000
052333,嘉聯益兆豐96購01,0,0,0,0,0,0,0,0,0,-45000,0,0,0,5000,50000,-45000,-45000
053294,聯發科中信9C購01,0,0,0,0,0,0,0,0,0,-45000,0,0,0,0,45000,-45000,-45000
05169P,玉晶光元大95售03,0,0,0,0,0,0,0,0,0,-45000,0,0,0,7000,52000,-45000,-45000
050449,宏達電元大95購03,0,0,0,0,0,0,0,0,0,-45000,0,0,0,0,45000,-45000,-45000
051357,可成元大95購05  ,0,0,0,0,0,0,0,0,0,-45000,0,0,0,0,45000,-45000,-45000
05031P,台光電元富95售01,0,0,0,0,0,0,0,0,0,-45000,0,0,0,0,45000,-45000,-45000
05558P,鴻海麥證96售01  ,0,0,0,135000,194000,-59000,0,0,0,-45000,0,0,0,234000,279000,-45000,-45000
055333,晶豪科兆豐97購01,0,0,0,0,0,0,0,0,0,-45000,0,0,0,0,45000,-45000,-45000
055213,大成鋼凱基98購01,0,0,0,0,0,0,0,0,0,-45000,0,0,0,30000,75000,-45000,-45000
055175,建準統一97購01  ,0,0,0,0,0,0,0,0,0,-45000,0,0,0,3000,48000,-45000,-45000
05614P,臺股指康和96售03,0,0,0,0,0,0,0,0,0,-45000,0,0,0,5000,50000,-45000,-45000
056141,聯茂元大97購05  ,0,0,0,0,0,0,0,0,0,-45000,0,0,0,50000,95000,-45000,-45000
056034,華通凱基98購01  ,0,0,0,0,0,0,0,0,0,-45000,0,0,0,6000,51000,-45000,-45000
054236,貿聯群益96購01  ,0,0,0,0,0,0,0,0,0,-45000,0,0,0,15000,60000,-45000,-45000
054442,啟碁台新96購01  ,0,0,0,0,0,0,0,0,0,-45000,0,0,0,0,45000,-45000,-45000
054386,鴻海統一98購03  ,0,0,0,0,0,0,0,0,0,-45000,0,0,0,0,45000,-45000,-45000
05434P,世紀鋼元富95售02,0,0,0,0,0,0,0,0,0,-45000,0,0,0,20000,65000,-45000,-45000
054300,華通凱基96購07  ,0,0,0,0,0,0,0,0,0,-45000,0,0,0,8000,53000,-45000,-45000
054984,華泰元富97購01  ,0,0,0,0,0,0,0,0,0,-45000,0,0,0,55000,100000,-45000,-45000
06588P,台積電元大98售11,0,0,0,0,0,0,0,0,0,-45000,0,0,0,30000,75000,-45000,-45000
06681P,致茂元大98售02  ,0,0,0,0,0,0,0,0,0,-45000,0,0,0,0,45000,-45000,-45000
06772P,國巨中信99售01  ,0,0,0,0,0,0,0,0,0,-45000,0,0,0,560000,605000,-45000,-45000
06689P,鴻海中信9C售02  ,0,0,0,0,0,0,0,0,0,-45000,0,0,0,0,45000,-45000,-45000
06692P,瑞昱凱基98售03  ,0,0,0,0,0,0,0,0,0,-45000,0,0,0,15000,60000,-45000,-45000
06875P,台灣50永昌9A售02,0,0,0,0,0,0,0,0,0,-45000,0,0,0,120000,165000,-45000,-45000
9935,慶豐富          ,358000,453000,-95000,0,0,0,0,0,0,50000,50000,0,50000,0,0,0,-45000
057620,康控凱基99購01  ,0,0,0,0,0,0,0,0,0,-46000,0,0,0,32000,78000,-46000,-46000
057499,奇鋐群益98購01  ,0,0,0,0,0,0,0,0,0,-46000,0,0,0,50000,96000,-46000,-46000
057318,台光電凱基9A購01,0,0,0,0,0,0,0,0,0,-46000,0,0,0,23000,69000,-46000,-46000
056959,鴻海永豐98購03  ,0,0,0,0,0,0,0,0,0,-46000,0,0,0,22000,68000,-46000,-46000
056677,智伸科元富98購01,0,0,0,0,0,0,0,0,0,-46000,0,0,0,0,46000,-46000,-46000
056684,旺宏統一98購02  ,0,0,0,0,0,0,0,0,0,-46000,0,0,0,48000,94000,-46000,-46000
056479,玉晶光元大99購05,0,0,0,0,0,0,0,0,0,-46000,0,0,0,16000,62000,-46000,-46000
058403,玉晶光元大99購12,0,0,0,0,0,0,0,0,0,-46000,0,0,0,49000,95000,-46000,-46000
057788,嘉聯益國票99購01,0,0,0,0,0,0,0,0,0,-46000,0,0,0,0,46000,-46000,-46000
049585,旺宏元大95購02  ,0,0,0,0,0,0,0,0,0,-46000,0,0,0,9000,55000,-46000,-46000
049507,和大凱基94購01  ,0,0,0,0,0,0,0,0,0,-46000,0,0,0,4000,50000,-46000,-46000
047781,上銀國泰94購02  ,0,0,0,0,0,0,0,0,0,-46000,0,0,0,15000,61000,-46000,-46000
052860,旺宏凱基96購03  ,0,0,0,0,0,0,0,0,0,-46000,0,0,0,0,46000,-46000,-46000
048825,華新科凱基94購05,0,0,0,0,0,0,0,0,0,-46000,0,0,0,10000,56000,-46000,-46000
053456,大立光元富96購04,0,0,0,0,0,0,0,0,0,-46000,0,0,0,78000,124000,-46000,-46000
051128,台表科群益95購02,0,0,0,0,0,0,0,0,0,-46000,0,0,0,4000,50000,-46000,-46000
054587,玉晶光國泰99購01,0,0,0,0,0,0,0,0,0,-46000,0,0,0,46000,92000,-46000,-46000
054771,茂林國票98購02  ,0,0,0,0,0,0,0,0,0,-46000,0,0,0,16000,62000,-46000,-46000
054412,智邦元大96購03  ,0,0,0,0,0,0,0,0,0,-46000,0,0,0,43000,89000,-46000,-46000
054159,T50正2凱基99購01,0,0,0,0,0,0,0,0,0,-46000,0,0,0,145000,191000,-46000,-46000
053941,國巨國泰96購05  ,0,0,0,0,0,0,0,0,0,-46000,0,0,0,10000,56000,-46000,-46000
056229,可成凱基97購04  ,0,0,0,0,0,0,0,0,0,-46000,0,0,0,24000,70000,-46000,-46000
056396,祥碩永豐98購01  ,0,0,0,0,0,0,0,0,0,-46000,0,0,0,42000,88000,-46000,-46000
056374,聯發科統一9B購01,0,0,0,0,0,0,0,0,0,-46000,0,0,0,63000,109000,-46000,-46000
06765P,欣興元大98售11  ,0,0,0,0,0,0,0,0,0,-46000,0,0,0,14000,60000,-46000,-46000
06577P,聯發科日盛9A售02,0,0,0,0,0,0,0,0,0,-46000,0,0,0,34000,80000,-46000,-46000
058147,鈺齊元大99購01  ,0,0,0,0,0,0,0,0,0,-47000,0,0,0,154000,201000,-47000,-47000
058067,台積電第一9C購01,0,0,0,0,0,0,0,0,0,-47000,0,0,0,0,47000,-47000,-47000
058330,鴻海元富99購01  ,0,0,0,0,0,0,0,0,0,-47000,0,0,0,10000,57000,-47000,-47000
056510,正文永豐98購02  ,0,0,0,0,0,0,0,0,0,-47000,0,0,0,68000,115000,-47000,-47000
057009,信邦中信99購01  ,0,0,0,0,0,0,0,0,0,-47000,0,0,0,10000,57000,-47000,-47000
048985,茂林元大94購01  ,0,0,0,0,0,0,0,0,0,-47000,0,0,0,0,47000,-47000,-47000
00713,元大台灣高息低波,7000,7000,0,0,0,0,0,0,0,-47000,0,0,0,27000,74000,-47000,-47000
050495,大立光永昌96購01,0,0,0,0,0,0,0,0,0,-47000,0,0,0,100000,147000,-47000,-47000
053516,茂林群益96購05  ,0,0,0,0,0,0,0,0,0,-47000,0,0,0,27000,74000,-47000,-47000
053549,南亞科凱基96購02,0,0,0,0,0,0,0,0,0,-47000,0,0,0,0,47000,-47000,-47000
052201,超眾統一96購01  ,0,0,0,0,0,0,0,0,0,-47000,0,0,0,20000,67000,-47000,-47000
056083,億光統一97購03  ,0,0,0,0,0,0,0,0,0,-47000,0,0,0,37000,84000,-47000,-47000
054126,和大元大96購02  ,0,0,0,0,0,0,0,0,0,-47000,0,0,0,21000,68000,-47000,-47000
054606,台積電永豐97購02,0,0,0,0,0,0,0,0,0,-47000,0,0,0,0,47000,-47000,-47000
06332P,世紀鋼群益98售01,0,0,0,0,0,0,0,0,0,-47000,0,0,0,21000,68000,-47000,-47000
06901P,亞德客凱基98售02,0,0,0,0,0,0,0,0,0,-47000,0,0,0,529000,576000,-47000,-47000
057024,義隆凱基99購01  ,0,0,0,0,0,0,0,0,0,-48000,0,0,0,0,48000,-48000,-48000
057494,玉晶光元大99購09,0,0,0,0,0,0,0,0,0,-48000,0,0,0,4000,52000,-48000,-48000
057397,茂林中信9A購01  ,0,0,0,0,0,0,0,0,0,-48000,0,0,0,0,48000,-48000,-48000
058298,聯茂凱基99購05  ,0,0,0,0,0,0,0,0,0,-48000,0,0,0,57000,105000,-48000,-48000
058509,聯發科元大99購12,0,0,0,0,0,0,0,0,0,-48000,0,0,0,188000,236000,-48000,-48000
058249,緯穎元大99購04  ,0,0,0,0,0,0,0,0,0,-48000,0,0,0,0,48000,-48000,-48000
047494,華邦電元富96購01,0,0,0,0,0,0,0,0,0,-48000,0,0,0,0,48000,-48000,-48000
049137,華通元大95購02  ,0,0,0,0,0,0,0,0,0,-48000,0,0,0,20000,68000,-48000,-48000
052772,台虹群益96購01  ,0,0,0,0,0,0,0,0,0,-48000,0,0,0,36000,84000,-48000,-48000
049505,臺股指元大94購16,0,0,0,0,0,0,0,0,0,-48000,0,0,0,0,48000,-48000,-48000
050457,力成元大94購01  ,0,0,0,0,0,0,0,0,0,-48000,0,0,0,57000,105000,-48000,-48000
053535,宏達電永豐96購02,0,0,0,0,0,0,0,0,0,-48000,0,0,0,26000,74000,-48000,-48000
050092,鴻海永豐94購04  ,0,0,0,0,0,0,0,0,0,-48000,0,0,0,0,48000,-48000,-48000
053010,鴻海統一96購11  ,0,0,0,0,0,0,0,0,0,-48000,0,0,0,0,48000,-48000,-48000
053189,聯發科統一96購05,0,0,0,0,0,0,0,0,0,-48000,0,0,0,0,48000,-48000,-48000
055088,聯詠亞東97購01  ,0,0,0,0,0,0,0,0,0,-48000,0,0,0,0,48000,-48000,-48000
054221,華新科統一96購05,0,0,0,0,0,0,0,0,0,-48000,0,0,0,0,48000,-48000,-48000
054064,台郡國票97購04  ,0,0,0,0,0,0,0,0,0,-48000,0,0,0,13000,61000,-48000,-48000
054096,佳世達國票97購01,0,0,0,0,0,0,0,0,0,-48000,0,0,0,50000,98000,-48000,-48000
053774,台達電元大96購04,0,0,0,0,0,0,0,0,0,-48000,0,0,0,2000,50000,-48000,-48000
053904,漢唐凱基97購01  ,0,0,0,0,0,0,0,0,0,-48000,0,0,0,0,48000,-48000,-48000
055974,上銀統一97購05  ,0,0,0,0,0,0,0,0,0,-48000,0,0,0,0,48000,-48000,-48000
056023,晶豪科群益97購01,0,0,0,0,0,0,0,0,0,-48000,0,0,0,7000,55000,-48000,-48000
056363,華新科元大99購04,0,0,0,0,0,0,0,0,0,-48000,0,0,0,70000,118000,-48000,-48000
056421,鴻海統一98購08  ,0,0,0,0,0,0,0,0,0,-48000,0,0,0,25000,73000,-48000,-48000
056247,台郡群益97購01  ,0,0,0,0,0,0,0,0,0,-48000,0,0,0,24000,72000,-48000,-48000
056263,友訊統一99購01  ,0,0,0,0,0,0,0,0,0,-48000,0,0,0,0,48000,-48000,-48000
055531,華新科群益98購03,0,0,0,0,0,0,0,0,0,-48000,0,0,0,20000,68000,-48000,-48000
055781,聯詠凱基98購01  ,0,0,0,0,0,0,0,0,0,-48000,0,0,0,20000,68000,-48000,-48000
06894P,鈺齊元富98售03  ,0,0,0,0,0,0,0,0,0,-48000,0,0,0,10000,58000,-48000,-48000
06416P,大立光群益97售06,0,0,0,0,0,0,0,0,0,-48000,0,0,0,2000,50000,-48000,-48000
057785,智邦國票99購02  ,0,0,0,0,0,0,0,0,0,-49000,0,0,0,13000,62000,-49000,-49000
057968,可成國泰9A購01  ,0,0,0,0,0,0,0,0,0,-49000,0,0,0,224000,273000,-49000,-49000
058515,健鼎元大99購01  ,0,0,0,0,0,0,0,0,0,-49000,0,0,0,0,49000,-49000,-49000
058533,玉晶光元富99購01,0,0,0,0,0,0,0,0,0,-49000,0,0,0,0,49000,-49000,-49000
058412,聯發科兆豐99購01,0,0,0,0,0,0,0,0,0,-49000,0,0,0,0,49000,-49000,-49000
057374,禾伸堂元大99購03,0,0,0,0,0,0,0,0,0,-49000,0,0,0,13000,62000,-49000,-49000
049667,大立光國泰96購01,0,0,0,0,0,0,0,0,0,-49000,0,0,0,3000,52000,-49000,-49000
049159,同欣電中信96購01,0,0,0,0,0,0,0,0,0,-49000,0,0,0,48000,97000,-49000,-49000
00685L,群益臺灣加權正2 ,30000,0,30000,0,0,0,0,0,0,-79000,0,0,0,439000,518000,-79000,-49000
053001,力山永豐96購01  ,0,0,0,0,0,0,0,0,0,-49000,0,0,0,1000,50000,-49000,-49000
050617,神基元大94購01  ,0,0,0,0,0,0,0,0,0,-49000,0,0,0,92000,141000,-49000,-49000
053732,S&P反1中信9C購01,0,0,0,0,0,0,0,0,0,-49000,0,0,0,10000,59000,-49000,-49000
053627,宏碁兆豐97購01  ,0,0,0,0,0,0,0,0,0,-49000,0,0,0,0,49000,-49000,-49000
052120,友達國票96購01  ,0,0,0,0,0,0,0,0,0,-49000,0,0,0,0,49000,-49000,-49000
056251,聯發科兆豐97購02,0,0,0,0,0,0,0,0,0,-49000,0,0,0,0,49000,-49000,-49000
056407,嘉晶國票99購01  ,0,0,0,0,0,0,0,0,0,-49000,0,0,0,170000,219000,-49000,-49000
053855,康友國泰98購01  ,0,0,0,0,0,0,0,0,0,-49000,0,0,0,100000,149000,-49000,-49000
054281,世芯群益97購01  ,0,0,0,0,0,0,0,0,0,-49000,0,0,0,68000,117000,-49000,-49000
054416,禾伸堂元大97購01,0,0,0,0,0,0,0,0,0,-49000,0,0,0,24000,73000,-49000,-49000
2505,國揚            ,298000,343000,-45000,0,0,0,0,0,0,-4000,9000,0,9000,0,13000,-13000,-49000
6409,旭隼            ,45000,108950,-63950,0,0,0,14000,0,14000,0,0,0,0,0,0,0,-49950
057446,旺宏元富02購01  ,0,0,0,0,0,0,0,0,0,-50000,0,0,0,0,50000,-50000,-50000
057284,新日興元大98購03,0,0,0,0,0,0,0,0,0,-50000,0,0,0,0,50000,-50000,-50000
057236,聯詠凱基98購03  ,0,0,0,0,0,0,0,0,0,-50000,0,0,0,25000,75000,-50000,-50000
057251,泰鼎統一98購02  ,0,0,0,0,0,0,0,0,0,-50000,0,0,0,3000,53000,-50000,-50000
057194,南電元大98購01  ,0,0,0,0,0,0,0,0,0,-50000,0,0,0,0,50000,-50000,-50000
05699P,茂林凱基96售05  ,0,0,0,0,0,0,0,0,0,-50000,0,0,0,304000,354000,-50000,-50000
056991,牧德兆豐98購01  ,0,0,0,0,0,0,0,0,0,-50000,0,0,0,0,50000,-50000,-50000
056950,亞光統一99購01  ,0,0,0,0,0,0,0,0,0,-50000,0,0,0,0,50000,-50000,-50000
056795,鴻海麥證98購01  ,0,0,0,44000,80000,-36000,0,0,0,-50000,0,0,0,44000,94000,-50000,-50000
056865,樺漢群益98購01  ,0,0,0,0,0,0,0,0,0,-50000,0,0,0,20000,70000,-50000,-50000
056830,友達富邦99購01  ,0,0,0,0,0,0,0,0,0,-50000,0,0,0,30000,80000,-50000,-50000
056617,美律永豐98購01  ,0,0,0,0,0,0,0,0,0,-50000,0,0,0,0,50000,-50000,-50000
058416,鴻海麥證99購01  ,0,0,0,15000,84000,-69000,0,0,0,-50000,0,0,0,49000,99000,-50000,-50000
058420,聯發科麥證99購03,0,0,0,0,50000,-50000,0,0,0,-50000,0,0,0,0,50000,-50000,-50000
05855P,滬深2X中信9C售01,0,0,0,0,0,0,0,0,0,-50000,0,0,0,0,50000,-50000,-50000
058546,玉晶光富邦9B購01,0,0,0,0,0,0,0,0,0,-50000,0,0,0,0,50000,-50000,-50000
058563,元油2X凱基9B購07,0,0,0,0,0,0,0,0,0,-50000,0,0,0,0,50000,-50000,-50000
058588,致茂中信9B購01  ,0,0,0,0,0,0,0,0,0,-50000,0,0,0,112000,162000,-50000,-50000
058484,元金2X國票04購01,0,0,0,0,0,0,0,0,0,-50000,0,0,0,0,50000,-50000,-50000
058639,南電兆豐99購01  ,0,0,0,0,0,0,0,0,0,-50000,0,0,0,0,50000,-50000,-50000
057942,可成國票99購02  ,0,0,0,0,0,0,0,0,0,-50000,0,0,0,0,50000,-50000,-50000
057732,牧德國泰9A購01  ,0,0,0,0,0,0,0,0,0,-50000,0,0,0,10000,60000,-50000,-50000
057694,臺股指凱基98購12,0,0,0,0,0,0,0,0,0,-50000,0,0,0,0,50000,-50000,-50000
058159,健策台新9A購01  ,0,0,0,0,0,0,0,0,0,-50000,0,0,0,38000,88000,-50000,-50000
058208,百和凱基99購01  ,0,0,0,0,0,0,0,0,0,-50000,0,0,0,0,50000,-50000,-50000
058102,楠梓電永豐98購04,0,0,0,0,0,0,0,0,0,-50000,0,0,0,0,50000,-50000,-50000
041870,A50正2凱基96購01,0,0,0,0,0,0,0,0,0,-50000,0,0,0,20000,70000,-50000,-50000
035275,台積電台新97購01,0,0,0,0,0,0,0,0,0,-50000,0,0,0,0,50000,-50000,-50000
03296P,台積電統一02售13,0,0,0,0,0,0,0,0,0,-50000,0,0,0,0,50000,-50000,-50000
04649P,臺股指凱基94售08,0,0,0,0,0,0,0,0,0,-50000,0,0,0,0,50000,-50000,-50000
04614P,光罩群益94售02  ,0,0,0,0,0,0,0,0,0,-50000,0,0,0,0,50000,-50000,-50000
03612C,臺股指元大95牛01,0,0,0,0,0,0,0,0,0,-50000,0,0,0,0,50000,-50000,-50000
048266,臺指反中信95購01,0,0,0,0,0,0,0,0,0,-50000,0,0,0,200000,250000,-50000,-50000
049534,華擎永豐94購02  ,0,0,0,0,0,0,0,0,0,-50000,0,0,0,0,50000,-50000,-50000
049249,台達電元大94購05,0,0,0,0,0,0,0,0,0,-50000,0,0,0,50000,100000,-50000,-50000
049066,元石油凱基97購01,0,0,0,0,0,0,0,0,0,-50000,0,0,0,0,50000,-50000,-50000
049029,茂林群益94購01  ,0,0,0,0,0,0,0,0,0,-50000,0,0,0,0,50000,-50000,-50000
048786,瑞昱元大94購02  ,0,0,0,0,0,0,0,0,0,-50000,0,0,0,60000,110000,-50000,-50000
048754,瀚宇博元富97購01,0,0,0,0,0,0,0,0,0,-50000,0,0,0,19000,69000,-50000,-50000
048650,台表科元大93購05,0,0,0,0,0,0,0,0,0,-50000,0,0,0,0,50000,-50000,-50000
048633,台達電元大94購02,0,0,0,0,0,0,0,0,0,-50000,0,0,0,50000,100000,-50000,-50000
052780,玉晶光國票96購04,0,0,0,0,0,0,0,0,0,-50000,0,0,0,0,50000,-50000,-50000
052788,開發金中信98購02,0,0,0,0,0,0,0,0,0,-50000,0,0,0,0,50000,-50000,-50000
052938,華新科兆豐96購01,0,0,0,0,0,0,0,0,0,-50000,0,0,0,41000,91000,-50000,-50000
049916,台光電元大94購06,0,0,0,0,0,0,0,0,0,-50000,0,0,0,20000,70000,-50000,-50000
049900,台積電元富94購06,0,0,0,0,0,0,0,0,0,-50000,0,0,0,1162000,1212000,-50000,-50000
048383,元金2X國票99購01,0,0,0,0,0,0,0,0,0,-50000,0,0,0,0,50000,-50000,-50000
049336,台達電統一94購02,0,0,0,0,0,0,0,0,0,-50000,0,0,0,10000,60000,-50000,-50000
049487,智邦元大94購03  ,0,0,0,0,0,0,0,0,0,-50000,0,0,0,0,50000,-50000,-50000
047548,友達凱基99購03  ,0,0,0,0,0,0,0,0,0,-50000,0,0,0,80000,130000,-50000,-50000
047825,道瓊反元大96購01,0,0,0,0,0,0,0,0,0,-50000,0,0,0,23000,73000,-50000,-50000
048099,健策凱基93購06  ,0,0,0,0,0,0,0,0,0,-50000,0,0,0,0,50000,-50000,-50000
04810P,亞德客元大94售01,0,0,0,0,0,0,0,0,0,-50000,0,0,0,0,50000,-50000,-50000
047937,元金2X國票97購02,0,0,0,0,0,0,0,0,0,-50000,0,0,0,0,50000,-50000,-50000
047966,華通國泰94購01  ,0,0,0,0,0,0,0,0,0,-50000,0,0,0,0,50000,-50000,-50000
051286,國巨統一97購01  ,0,0,0,0,0,0,0,0,0,-50000,0,0,0,13000,63000,-50000,-50000
052131,台積電凱基96購01,0,0,0,0,0,0,0,0,0,-50000,0,0,0,0,50000,-50000,-50000
052092,貿聯元大96購02  ,0,0,0,0,0,0,0,0,0,-50000,0,0,0,56000,106000,-50000,-50000
051541,GIS國票96購02   ,0,0,0,0,0,0,0,0,0,-50000,0,0,0,0,50000,-50000,-50000
052445,南亞科元大95購05,0,0,0,0,0,0,0,0,0,-50000,0,0,0,0,50000,-50000,-50000
053343,宏達電國票97購02,0,0,0,0,0,0,0,0,0,-50000,0,0,0,0,50000,-50000,-50000
053344,嘉晶國票97購02  ,0,0,0,0,0,0,0,0,0,-50000,0,0,0,120000,170000,-50000,-50000
051121,裕民群益97購01  ,0,0,0,0,0,0,0,0,0,-50000,0,0,0,0,50000,-50000,-50000
050530,台表科元大95購04,0,0,0,0,0,0,0,0,0,-50000,0,0,0,0,50000,-50000,-50000
050268,智原元大95購03  ,0,0,0,0,0,0,0,0,0,-50000,0,0,0,0,50000,-50000,-50000
050270,景碩元大94購01  ,0,0,0,0,0,0,0,0,0,-50000,0,0,0,0,50000,-50000,-50000
053261,國巨群益96購05  ,0,0,0,0,0,0,0,0,0,-50000,0,0,0,0,50000,-50000,-50000
05076P,深中小群益99售02,0,0,0,0,0,0,0,0,0,-50000,0,0,0,0,50000,-50000,-50000
050900,台郡元大95購02  ,0,0,0,0,0,0,0,0,0,-50000,0,0,0,0,50000,-50000,-50000
050810,鴻海凱基95購09  ,0,0,0,0,0,0,0,0,0,-50000,0,0,0,150000,200000,-50000,-50000
051456,鈺齊元大95購01  ,0,0,0,0,0,0,0,0,0,-50000,0,0,0,0,50000,-50000,-50000
051951,聯發科元富95購02,0,0,0,0,0,0,0,0,0,-50000,0,0,0,260000,310000,-50000,-50000
051202,智邦麥證95購01  ,0,0,0,0,50000,-50000,0,0,0,-50000,0,0,0,0,50000,-50000,-50000
051908,國泰金元大96購02,0,0,0,0,0,0,0,0,0,-50000,0,0,0,40000,90000,-50000,-50000
051070,正崴國票96購01  ,0,0,0,0,0,0,0,0,0,-50000,0,0,0,0,50000,-50000,-50000
053087,冠德元大96購02  ,0,0,0,0,0,0,0,0,0,-50000,0,0,0,0,50000,-50000,-50000
053020,貿聯元富96購01  ,0,0,0,0,0,0,0,0,0,-50000,0,0,0,0,50000,-50000,-50000
050183,奇鋐元大96購01  ,0,0,0,0,0,0,0,0,0,-50000,0,0,0,0,50000,-50000,-50000
053862,南亞科元大97購02,0,0,0,0,0,0,0,0,0,-50000,0,0,0,0,50000,-50000,-50000
053804,富邦金凱基96購01,0,0,0,0,0,0,0,0,0,-50000,0,0,0,0,50000,-50000,-50000
053934,A50正2元富96購02,0,0,0,0,0,0,0,0,0,-50000,0,0,0,0,50000,-50000,-50000
055170,光磊統一97購01  ,0,0,0,0,0,0,0,0,0,-50000,0,0,0,0,50000,-50000,-50000
054967,神達元大97購01  ,0,0,0,0,0,0,0,0,0,-50000,0,0,0,52000,102000,-50000,-50000
056171,鴻海元富97購10  ,0,0,0,0,0,0,0,0,0,-50000,0,0,0,100000,150000,-50000,-50000
056159,牧德凱基99購01  ,0,0,0,0,0,0,0,0,0,-50000,0,0,0,0,50000,-50000,-50000
055883,樺漢元富97購01  ,0,0,0,0,0,0,0,0,0,-50000,0,0,0,0,50000,-50000,-50000
055836,華邦電元大97購04,0,0,0,0,0,0,0,0,0,-50000,0,0,0,68000,118000,-50000,-50000
055914,大立光凱基97購13,0,0,0,0,0,0,0,0,0,-50000,0,0,0,0,50000,-50000,-50000
055730,建準元富97購02  ,0,0,0,0,0,0,0,0,0,-50000,0,0,0,0,50000,-50000,-50000
055698,茂林國票98購03  ,0,0,0,0,0,0,0,0,0,-50000,0,0,0,21000,71000,-50000,-50000
055648,可成元富97購01  ,0,0,0,0,0,0,0,0,0,-50000,0,0,0,20000,70000,-50000,-50000
055584,國巨元大97購11  ,0,0,0,0,0,0,0,0,0,-50000,0,0,0,80000,130000,-50000,-50000
055244,國巨統一98購01  ,0,0,0,0,0,0,0,0,0,-50000,0,0,0,0,50000,-50000,-50000
055291,京鼎元大97購02  ,0,0,0,0,0,0,0,0,0,-50000,0,0,0,0,50000,-50000,-50000
055414,奇力新富邦9B購01,0,0,0,0,0,0,0,0,0,-50000,0,0,0,0,50000,-50000,-50000
06104P,大立光凱基97售04,0,0,0,0,0,0,0,0,0,-50000,0,0,0,10000,60000,-50000,-50000
06592P,欣興元大98售04  ,0,0,0,0,0,0,0,0,0,-50000,0,0,0,10000,60000,-50000,-50000
06545P,致茂元大98售01  ,0,0,0,0,0,0,0,0,0,-50000,0,0,0,0,50000,-50000,-50000
06460P,亞德客元富98售02,0,0,0,0,0,0,0,0,0,-50000,0,0,0,0,50000,-50000,-50000
07003P,聯發科兆豐99售02,0,0,0,0,0,0,0,0,0,-50000,0,0,0,0,50000,-50000,-50000
058131,義隆元大99購02  ,0,0,0,0,0,0,0,0,0,-51000,0,0,0,17000,68000,-51000,-51000
057904,矽力永豐98購01  ,0,0,0,0,0,0,0,0,0,-51000,0,0,0,0,51000,-51000,-51000
056574,亞光元大99購03  ,0,0,0,0,0,0,0,0,0,-51000,0,0,0,55000,106000,-51000,-51000
056906,玉晶光元大9B購01,0,0,0,0,0,0,0,0,0,-51000,0,0,0,1000,52000,-51000,-51000
057092,健策元富98購01  ,0,0,0,0,0,0,0,0,0,-51000,0,0,0,25000,76000,-51000,-51000
057255,聯發科麥證98購02,0,0,0,10000,61000,-51000,0,0,0,-51000,0,0,0,10000,61000,-51000,-51000
057466,泰鼎永豐98購01  ,0,0,0,0,0,0,0,0,0,-51000,0,0,0,163000,214000,-51000,-51000
057510,泰碩統一98購02  ,0,0,0,0,0,0,0,0,0,-51000,0,0,0,2000,53000,-51000,-51000
049845,台積電麥證94購01,0,0,0,40000,91000,-51000,0,0,0,-51000,0,0,0,40000,91000,-51000,-51000
048900,精成科國泰95購01,0,0,0,0,0,0,0,0,0,-51000,0,0,0,20000,71000,-51000,-51000
049245,和鑫元富95購01  ,0,0,0,0,0,0,0,0,0,-51000,0,0,0,0,51000,-51000,-51000
049314,京鼎凱基94購01  ,0,0,0,0,0,0,0,0,0,-51000,0,0,0,20000,71000,-51000,-51000
046813,聯電凱基96購01  ,0,0,0,0,0,0,0,0,0,-51000,0,0,0,20000,71000,-51000,-51000
053014,旺宏統一97購02  ,0,0,0,0,0,0,0,0,0,-51000,0,0,0,2000,53000,-51000,-51000
05309P,康友中信95售03  ,0,0,0,0,0,0,0,0,0,-51000,0,0,0,0,51000,-51000,-51000
051897,台光電國泰97購01,0,0,0,0,0,0,0,0,0,-51000,0,0,0,10000,61000,-51000,-51000
051923,聯發科日盛95購02,0,0,0,0,0,0,0,0,0,-51000,0,0,0,0,51000,-51000,-51000
053341,聯發科國票97購03,0,0,0,0,0,0,0,0,0,-51000,0,0,0,90000,141000,-51000,-51000
053445,可成凱基96購04  ,0,0,0,0,0,0,0,0,0,-51000,0,0,0,68000,119000,-51000,-51000
053534,微星永豐96購02  ,0,0,0,0,0,0,0,0,0,-51000,0,0,0,40000,91000,-51000,-51000
050316,上証2X國票98購01,0,0,0,0,0,0,0,0,0,-51000,0,0,0,0,51000,-51000,-51000
05464P,華通康和95售02  ,0,0,0,0,0,0,0,0,0,-51000,0,0,0,0,51000,-51000,-51000
054477,聯發科中信9C購02,0,0,0,0,0,0,0,0,0,-51000,0,0,0,91000,142000,-51000,-51000
06584P,欣興凱基98售03  ,0,0,0,0,0,0,0,0,0,-51000,0,0,0,54000,105000,-51000,-51000
2501,國建            ,340000,405000,-65000,0,0,0,0,0,0,14000,19000,5000,14000,0,0,0,-51000
057624,新日興國泰99購01,0,0,0,0,0,0,0,0,0,-52000,0,0,0,104000,156000,-52000,-52000
057879,電子類元大99購02,0,0,0,0,0,0,0,0,0,-52000,0,0,0,0,52000,-52000,-52000
057856,聯鈞國票99購03  ,0,0,0,0,0,0,0,0,0,-52000,0,0,0,108000,160000,-52000,-52000
057752,臺股指國票98購08,0,0,0,0,0,0,0,0,0,-52000,0,0,0,0,52000,-52000,-52000
05964P,華通凱基96售06  ,0,0,0,0,0,0,0,0,0,-52000,0,0,0,93000,145000,-52000,-52000
042387,台積電永昌93購02,0,0,0,0,0,0,0,0,0,-52000,0,0,0,10000,62000,-52000,-52000
052577,台積電統一96購01,0,0,0,0,0,0,0,0,0,-52000,0,0,0,1000,53000,-52000,-52000
048346,智易元大95購01  ,0,0,0,0,0,0,0,0,0,-52000,0,0,0,200000,252000,-52000,-52000
05213P,台積電國票96售05,0,0,0,0,0,0,0,0,0,-52000,0,0,0,0,52000,-52000,-52000
052192,SP黃豆元富95購04,0,0,0,0,0,0,0,0,0,-52000,0,0,0,0,52000,-52000,-52000
053103,瀚宇博元富96購01,0,0,0,0,0,0,0,0,0,-52000,0,0,0,152000,204000,-52000,-52000
050252,聯發科國泰95購01,0,0,0,0,0,0,0,0,0,-52000,0,0,0,63000,115000,-52000,-52000
051094,健策元大96購03  ,0,0,0,0,0,0,0,0,0,-52000,0,0,0,42000,94000,-52000,-52000
055074,台虹永豐97購01  ,0,0,0,0,0,0,0,0,0,-52000,0,0,0,0,52000,-52000,-52000
055424,聚陽群益98購01  ,0,0,0,0,0,0,0,0,0,-52000,0,0,0,10000,62000,-52000,-52000
055261,帆宣統一98購01  ,0,0,0,0,0,0,0,0,0,-52000,0,0,0,0,52000,-52000,-52000
05956P,漢唐國票96售02  ,0,0,0,0,0,0,0,0,0,-53000,0,0,0,50000,103000,-53000,-53000
06004P,奇力新永豐96售02,0,0,0,0,0,0,0,0,0,-53000,0,0,0,60000,113000,-53000,-53000
057988,鈺齊元富98購02  ,0,0,0,0,0,0,0,0,0,-53000,0,0,0,0,53000,-53000,-53000
057515,智原元富98購02  ,0,0,0,0,0,0,0,0,0,-53000,0,0,0,0,53000,-53000,-53000
057380,技嘉國泰9A購01  ,0,0,0,0,0,0,0,0,0,-53000,0,0,0,431000,484000,-53000,-53000
057418,台光電凱基98購04,0,0,0,0,0,0,0,0,0,-53000,0,0,0,18000,71000,-53000,-53000
05727P,新光金日盛96售02,0,0,0,0,0,0,0,0,0,-53000,0,0,0,80000,133000,-53000,-53000
057239,貿聯凱基98購05  ,0,0,0,0,0,0,0,0,0,-53000,0,0,0,0,53000,-53000,-53000
056657,華邦電元大99購01,0,0,0,0,0,0,0,0,0,-53000,0,0,0,10000,63000,-53000,-53000
048475,台郡永豐93購02  ,0,0,0,0,0,0,0,0,0,-53000,0,0,0,0,53000,-53000,-53000
052866,大立光凱基96購12,0,0,0,0,0,0,0,0,0,-53000,0,0,0,0,53000,-53000,-53000
048610,華新科凱基94購04,0,0,0,0,0,0,0,0,0,-53000,0,0,0,7000,60000,-53000,-53000
047389,義隆元大94購01  ,0,0,0,0,0,0,0,0,0,-53000,0,0,0,0,53000,-53000,-53000
053245,全新國票97購01  ,0,0,0,0,0,0,0,0,0,-53000,0,0,0,5000,58000,-53000,-53000
053518,聯茂群益96購03  ,0,0,0,0,0,0,0,0,0,-53000,0,0,0,22000,75000,-53000,-53000
053673,超眾元富96購03  ,0,0,0,0,0,0,0,0,0,-53000,0,0,0,41000,94000,-53000,-53000
055986,祥碩元富97購01  ,0,0,0,0,0,0,0,0,0,-53000,0,0,0,47000,100000,-53000,-53000
056360,智邦元大98購01  ,0,0,0,0,0,0,0,0,0,-53000,0,0,0,0,53000,-53000,-53000
054974,台表科元大98購02,0,0,0,0,0,0,0,0,0,-53000,0,0,0,2000,55000,-53000,-53000
054802,高股息元大97購01,0,0,0,0,0,0,0,0,0,-53000,0,0,0,0,53000,-53000,-53000
054812,鴻海元大97購08  ,0,0,0,0,0,0,0,0,0,-53000,0,0,0,147000,200000,-53000,-53000
053787,健策元大97購02  ,0,0,0,0,0,0,0,0,0,-53000,0,0,0,113000,166000,-53000,-53000
056507,創意永豐98購02  ,0,0,0,0,0,0,0,0,0,-54000,0,0,0,30000,84000,-54000,-54000
057406,茂林群益98購03  ,0,0,0,0,0,0,0,0,0,-54000,0,0,0,10000,64000,-54000,-54000
057567,嘉聯益富邦9A購01,0,0,0,0,0,0,0,0,0,-54000,0,0,0,8000,62000,-54000,-54000
058445,旺宏富邦9C購01  ,0,0,0,0,0,0,0,0,0,-54000,0,0,0,0,54000,-54000,-54000
05830P,滬深2X元富99售03,0,0,0,0,0,0,0,0,0,-54000,0,0,0,182000,236000,-54000,-54000
058338,康友元富99購01  ,0,0,0,0,0,0,0,0,0,-54000,0,0,0,27000,81000,-54000,-54000
049264,奇鋐元大95購01  ,0,0,0,0,0,0,0,0,0,-54000,0,0,0,52000,106000,-54000,-54000
049528,台積電中信94購01,0,0,0,0,0,0,0,0,0,-54000,0,0,0,20000,74000,-54000,-54000
044429,元金2X元大94購04,0,0,0,0,0,0,0,0,0,-54000,0,0,0,141000,195000,-54000,-54000
053496,義隆兆豐96購02  ,0,0,0,0,0,0,0,0,0,-54000,0,0,0,10000,64000,-54000,-54000
050261,國巨元大95購04  ,0,0,0,0,0,0,0,0,0,-54000,0,0,0,247000,301000,-54000,-54000
050547,華新科凱基95購01,0,0,0,0,0,0,0,0,0,-54000,0,0,0,20000,74000,-54000,-54000
050595,緯穎永豐94購03  ,0,0,0,0,0,0,0,0,0,-54000,0,0,0,0,54000,-54000,-54000
053027,玉晶光富邦98購01,0,0,0,0,0,0,0,0,0,-54000,0,0,0,2000,56000,-54000,-54000
053162,緯穎元大97購01  ,0,0,0,0,0,0,0,0,0,-54000,0,0,0,239000,293000,-54000,-54000
051919,台郡元大96購02  ,0,0,0,0,0,0,0,0,0,-54000,0,0,0,20000,74000,-54000,-54000
051075,智邦國泰97購01  ,0,0,0,0,0,0,0,0,0,-54000,0,0,0,27000,81000,-54000,-54000
054794,貿聯群益98購01  ,0,0,0,0,0,0,0,0,0,-54000,0,0,0,0,54000,-54000,-54000
054854,台積電麥證97購01,0,0,0,178000,232000,-54000,0,0,0,-54000,0,0,0,178000,232000,-54000,-54000
056174,億光元富97購01  ,0,0,0,0,0,0,0,0,0,-54000,0,0,0,0,54000,-54000,-54000
056039,宏達電凱基97購02,0,0,0,0,0,0,0,0,0,-54000,0,0,0,10000,64000,-54000,-54000
055299,康友元大97購02  ,0,0,0,0,0,0,0,0,0,-54000,0,0,0,9000,63000,-54000,-54000
055198,奇力新第一97購01,0,0,0,0,0,0,0,0,0,-54000,0,0,0,200000,254000,-54000,-54000
055597,禾伸堂元大98購02,0,0,0,0,0,0,0,0,0,-54000,0,0,0,7000,61000,-54000,-54000
06930P,台積電元大98售19,0,0,0,0,0,0,0,0,0,-54000,0,0,0,15000,69000,-54000,-54000
1731,美吾華          ,137000,193000,-56000,0,0,0,0,0,0,2000,2000,0,2000,0,0,0,-54000
058524,超眾元大99購04  ,0,0,0,0,0,0,0,0,0,-55000,0,0,0,13000,68000,-55000,-55000
057577,廣宇中信9A購01  ,0,0,0,0,0,0,0,0,0,-55000,0,0,0,51000,106000,-55000,-55000
057513,智邦台新98購01  ,0,0,0,0,0,0,0,0,0,-55000,0,0,0,0,55000,-55000,-55000
049593,群創元大9A購01  ,0,0,0,0,0,0,0,0,0,-55000,0,0,0,32000,87000,-55000,-55000
046983,南茂兆豐94購01  ,0,0,0,0,0,0,0,0,0,-55000,0,0,0,20000,75000,-55000,-55000
048788,華新科元大95購02,0,0,0,0,0,0,0,0,0,-55000,0,0,0,16000,71000,-55000,-55000
050144,宏達電台新95購01,0,0,0,0,0,0,0,0,0,-55000,0,0,0,0,55000,-55000,-55000
052631,T50反1凱基98購02,0,0,0,0,0,0,0,0,0,-55000,0,0,0,200000,255000,-55000,-55000
050686,欣興兆豐96購01  ,0,0,0,0,0,0,0,0,0,-55000,0,0,0,61000,116000,-55000,-55000
052179,康友元大95購03  ,0,0,0,0,0,0,0,0,0,-55000,0,0,0,0,55000,-55000,-55000
051688,大立光凱基97購02,0,0,0,0,0,0,0,0,0,-55000,0,0,0,7000,62000,-55000,-55000
055541,聚陽凱基98購01  ,0,0,0,0,0,0,0,0,0,-55000,0,0,0,0,55000,-55000,-55000
055494,華新科元大98購01,0,0,0,0,0,0,0,0,0,-55000,0,0,0,219000,274000,-55000,-55000
055714,智邦元大97購03  ,0,0,0,0,0,0,0,0,0,-55000,0,0,0,60000,115000,-55000,-55000
055780,禾伸堂凱基99購01,0,0,0,0,0,0,0,0,0,-55000,0,0,0,0,55000,-55000,-55000
055345,國巨凱基98購01  ,0,0,0,0,0,0,0,0,0,-55000,0,0,0,135000,190000,-55000,-55000
055389,國巨統一98購02  ,0,0,0,0,0,0,0,0,0,-55000,0,0,0,68000,123000,-55000,-55000
056089,同欣電統一98購01,0,0,0,0,0,0,0,0,0,-55000,0,0,0,33000,88000,-55000,-55000
056305,群創元大9A購03  ,0,0,0,0,0,0,0,0,0,-55000,0,0,0,42000,97000,-55000,-55000
054938,國巨元大97購04  ,0,0,0,0,0,0,0,0,0,-55000,0,0,0,178000,233000,-55000,-55000
055064,碩天永豐97購01  ,0,0,0,0,0,0,0,0,0,-55000,0,0,0,5000,60000,-55000,-55000
054711,禾伸堂元富97購01,0,0,0,0,0,0,0,0,0,-55000,0,0,0,3000,58000,-55000,-55000
053756,亞光元富96購02  ,0,0,0,0,0,0,0,0,0,-55000,0,0,0,0,55000,-55000,-55000
053973,晶豪科元大96購01,0,0,0,0,0,0,0,0,0,-55000,0,0,0,48000,103000,-55000,-55000
06222P,致茂元富97售02  ,0,0,0,0,0,0,0,0,0,-55000,0,0,0,45000,100000,-55000,-55000
8249,菱光            ,70000,125000,-55000,0,0,0,0,0,0,0,0,0,0,0,0,0,-55000
8070,長華*           ,28000,64000,-36000,0,0,0,0,0,0,-19000,1000,20000,-19000,0,0,0,-55000
3698,隆達            ,480000,387000,93000,0,0,0,0,0,0,-148000,4000,120000,-116000,0,32000,-32000,-55000
057475,聯電元大9A購01  ,0,0,0,0,0,0,0,0,0,-56000,0,0,0,50000,106000,-56000,-56000
057505,健策麥證98購01  ,0,0,0,0,56000,-56000,0,0,0,-56000,0,0,0,0,56000,-56000,-56000
057191,祥碩元大98購05  ,0,0,0,0,0,0,0,0,0,-56000,0,0,0,247000,303000,-56000,-56000
056652,上証反元大9B購01,0,0,0,0,0,0,0,0,0,-56000,0,0,0,0,56000,-56000,-56000
056702,欣興國泰9A購01  ,0,0,0,0,0,0,0,0,0,-56000,0,0,0,35000,91000,-56000,-56000
05884P,旺宏統一96售01  ,0,0,0,0,0,0,0,0,0,-56000,0,0,0,28000,84000,-56000,-56000
048873,玉晶光國票95購02,0,0,0,0,0,0,0,0,0,-56000,0,0,0,7000,63000,-56000,-56000
044879,上証2X群益93購01,0,0,0,0,0,0,0,0,0,-56000,0,0,0,24000,80000,-56000,-56000
045428,彩晶凱基94購01  ,0,0,0,0,0,0,0,0,0,-56000,0,0,0,0,56000,-56000,-56000
047355,世紀鋼凱基94購01,0,0,0,0,0,0,0,0,0,-56000,0,0,0,40000,96000,-56000,-56000
04206P,臺股指元大93售46,0,0,0,0,0,0,0,0,0,-56000,0,0,0,0,56000,-56000,-56000
051624,智邦麥證95購02  ,0,0,0,20000,125000,-105000,0,0,0,-56000,0,0,0,69000,125000,-56000,-56000
051266,國巨富邦99購01  ,0,0,0,0,0,0,0,0,0,-56000,0,0,0,24000,80000,-56000,-56000
051193,新日興兆豐96購01,0,0,0,0,0,0,0,0,0,-56000,0,0,0,14000,70000,-56000,-56000
051175,國巨凱基95購04  ,0,0,0,0,0,0,0,0,0,-56000,0,0,0,0,56000,-56000,-56000
050080,國巨統一94購06  ,0,0,0,0,0,0,0,0,0,-56000,0,0,0,0,56000,-56000,-56000
051020,健策凱基96購02  ,0,0,0,0,0,0,0,0,0,-56000,0,0,0,18000,74000,-56000,-56000
050995,貿聯元大95購02  ,0,0,0,0,0,0,0,0,0,-56000,0,0,0,12000,68000,-56000,-56000
053148,華邦電元大96購01,0,0,0,0,0,0,0,0,0,-56000,0,0,0,468000,524000,-56000,-56000
053110,大立光兆豐97購01,0,0,0,0,0,0,0,0,0,-56000,0,0,0,10000,66000,-56000,-56000
053917,友達國票97購03  ,0,0,0,0,0,0,0,0,0,-56000,0,0,0,313000,369000,-56000,-56000
056300,聯發科元大97購23,0,0,0,0,0,0,0,0,0,-56000,0,0,0,192000,248000,-56000,-56000
056259,T50反1統一9A購01,0,0,0,0,0,0,0,0,0,-56000,0,0,0,0,56000,-56000,-56000
056189,樺漢統一97購02  ,0,0,0,0,0,0,0,0,0,-56000,0,0,0,48000,104000,-56000,-56000
056212,台光電國票98購03,0,0,0,0,0,0,0,0,0,-56000,0,0,0,10000,66000,-56000,-56000
055347,台積電凱基97購10,0,0,0,0,0,0,0,0,0,-56000,0,0,0,20000,76000,-56000,-56000
055250,華新科統一97購02,0,0,0,0,0,0,0,0,0,-56000,0,0,0,0,56000,-56000,-56000
6214,精誠            ,191000,300000,-109000,0,0,0,0,0,0,53000,54000,1000,53000,0,0,0,-56000
058337,日月光元富99購01,0,0,0,0,0,0,0,0,0,-57000,0,0,0,14000,71000,-57000,-57000
058419,聯發科麥證99購02,0,0,0,0,92000,-92000,0,0,0,-57000,0,0,0,35000,92000,-57000,-57000
058408,華通兆豐99購02  ,0,0,0,0,0,0,0,0,0,-57000,0,0,0,98000,155000,-57000,-57000
058166,鴻海凱基9A購01  ,0,0,0,0,0,0,0,0,0,-57000,0,0,0,86000,143000,-57000,-57000
057883,中環群益98購01  ,0,0,0,0,0,0,0,0,0,-57000,0,0,0,0,57000,-57000,-57000
048990,台表科元大94購01,0,0,0,0,0,0,0,0,0,-57000,0,0,0,0,57000,-57000,-57000
053178,南亞科統一98購01,0,0,0,0,0,0,0,0,0,-57000,0,0,0,3000,60000,-57000,-57000
052079,康友元富98購01  ,0,0,0,0,0,0,0,0,0,-57000,0,0,0,10000,67000,-57000,-57000
052057,臺股指凱基95購15,0,0,0,0,0,0,0,0,0,-57000,0,0,0,0,57000,-57000,-57000
053493,智邦兆豐97購02  ,0,0,0,0,0,0,0,0,0,-57000,0,0,0,0,57000,-57000,-57000
056310,神達元大97購02  ,0,0,0,0,0,0,0,0,0,-57000,0,0,0,103000,160000,-57000,-57000
056332,台郡國票99購01  ,0,0,0,0,0,0,0,0,0,-57000,0,0,0,0,57000,-57000,-57000
6115,鎰勝            ,75000,133000,-58000,0,0,0,0,0,0,1000,1000,0,1000,0,0,0,-57000
06209P,旺宏統一97售07  ,0,0,0,0,0,0,0,0,0,-57000,0,0,0,10000,67000,-57000,-57000
06942P,台灣50台新02售01,0,0,0,0,0,0,0,0,0,-57000,1000,0,1000,17000,75000,-58000,-57000
057742,喬山永豐98購02  ,0,0,0,0,0,0,0,0,0,-58000,0,0,0,0,58000,-58000,-58000
057758,鴻海凱基99購03  ,0,0,0,0,0,0,0,0,0,-58000,0,0,0,10000,68000,-58000,-58000
058015,旺宏凱基99購02  ,0,0,0,0,0,0,0,0,0,-58000,0,0,0,11000,69000,-58000,-58000
058079,鴻海群益98購08  ,0,0,0,0,0,0,0,0,0,-58000,0,0,0,117000,175000,-58000,-58000
058377,茂林凱基9A購03  ,0,0,0,0,0,0,0,0,0,-58000,0,0,0,2000,60000,-58000,-58000
058591,台灣50統一9B購02,0,0,0,0,0,0,0,0,0,-58000,0,0,0,0,58000,-58000,-58000
058486,大立光國票9A購01,0,0,0,0,0,0,0,0,0,-58000,0,0,0,20000,78000,-58000,-58000
056694,欣興群益98購04  ,0,0,0,0,0,0,0,0,0,-58000,0,0,0,67000,125000,-58000,-58000
056642,旺宏凱基98購07  ,0,0,0,0,0,0,0,0,0,-58000,0,0,0,26000,84000,-58000,-58000
056571,燿華元大98購02  ,0,0,0,0,0,0,0,0,0,-58000,0,0,0,111000,169000,-58000,-58000
056550,瑞儀凱基99購01  ,0,0,0,0,0,0,0,0,0,-58000,0,0,0,50000,108000,-58000,-58000
057272,台積電元大98購14,0,0,0,0,0,0,0,0,0,-58000,0,0,0,208000,266000,-58000,-58000
052819,義隆永豐96購01  ,0,0,0,0,0,0,0,0,0,-58000,0,0,0,101000,159000,-58000,-58000
049473,光罩永豐94購03  ,0,0,0,0,0,0,0,0,0,-58000,0,0,0,0,58000,-58000,-58000
047772,泰鼎元大93購05  ,0,0,0,0,0,0,0,0,0,-58000,0,0,0,1000,59000,-58000,-58000
046375,友達凱基98購01  ,0,0,0,0,0,0,0,0,0,-58000,0,0,0,158000,216000,-58000,-58000
045189,大立光元富98購01,0,0,0,0,0,0,0,0,0,-58000,0,0,0,76000,134000,-58000,-58000
045906,鴻海中信94購01  ,0,0,0,0,0,0,0,0,0,-58000,0,0,0,31000,89000,-58000,-58000
053332,創意永豐96購03  ,0,0,0,0,0,0,0,0,0,-58000,0,0,0,0,58000,-58000,-58000
053300,大成鋼凱基96購02,0,0,0,0,0,0,0,0,0,-58000,0,0,0,20000,78000,-58000,-58000
052207,台郡中信95購02  ,0,0,0,0,0,0,0,0,0,-58000,0,0,0,186000,244000,-58000,-58000
052215,樺漢元大96購02  ,0,0,0,0,0,0,0,0,0,-58000,0,0,0,5000,63000,-58000,-58000
051654,致新永豐95購01  ,0,0,0,0,0,0,0,0,0,-58000,0,0,0,0,58000,-58000,-58000
051212,國巨統一95購01  ,0,0,0,0,0,0,0,0,0,-58000,0,0,0,0,58000,-58000,-58000
05631P,國巨富邦9A售01  ,0,0,0,0,0,0,0,0,0,-58000,0,0,0,90000,148000,-58000,-58000
055331,國巨兆豐99購01  ,0,0,0,0,0,0,0,0,0,-58000,0,0,0,0,58000,-58000,-58000
055380,智易元大98購02  ,0,0,0,0,0,0,0,0,0,-58000,0,0,0,10000,68000,-58000,-58000
055587,智邦元大97購02  ,0,0,0,0,0,0,0,0,0,-58000,0,0,0,48000,106000,-58000,-58000
054270,寶滬深中信98購01,0,0,0,0,0,0,0,0,0,-58000,0,0,0,0,58000,-58000,-58000
054700,致新永豐97購01  ,0,0,0,0,0,0,0,0,0,-58000,0,0,0,0,58000,-58000,-58000
054761,台光電國票98購02,0,0,0,0,0,0,0,0,0,-58000,0,0,0,26000,84000,-58000,-58000
054482,大成鋼台新96購01,0,0,0,0,0,0,0,0,0,-58000,0,0,0,0,58000,-58000,-58000
055083,康友中信97購01  ,0,0,0,0,0,0,0,0,0,-58000,0,0,0,2000,60000,-58000,-58000
055148,鴻海元大98購02  ,0,0,0,0,0,0,0,0,0,-58000,0,0,0,86000,144000,-58000,-58000
054831,緯穎國泰98購01  ,0,0,0,0,0,0,0,0,0,-58000,0,0,0,57000,115000,-58000,-58000
06073P,健策永豐97售01  ,0,0,0,0,0,0,0,0,0,-58000,0,0,0,73000,131000,-58000,-58000
056954,聯詠富邦9A購01  ,0,0,0,0,0,0,0,0,0,-59000,0,0,0,217000,276000,-59000,-59000
057042,台積電元大98購10,5000,10000,-5000,0,0,0,0,0,0,-54000,0,0,0,213000,267000,-54000,-59000
058556,百和永豐99購01  ,0,0,0,0,0,0,0,0,0,-59000,0,0,0,0,59000,-59000,-59000
058177,華新科凱基99購02,0,0,0,0,0,0,0,0,0,-59000,0,0,0,20000,79000,-59000,-59000
057907,台達電亞東99購01,0,0,0,0,0,0,0,0,0,-59000,0,0,0,0,59000,-59000,-59000
049368,奇力新元大94購02,0,0,0,0,0,0,0,0,0,-59000,0,0,0,0,59000,-59000,-59000
049955,崇越群益95購01  ,0,0,0,0,0,0,0,0,0,-59000,0,0,0,0,59000,-59000,-59000
05280P,華通元大95售08  ,0,0,0,0,0,0,0,0,0,-59000,0,0,0,5000,64000,-59000,-59000
051997,康友元大95購02  ,0,0,0,0,0,0,0,0,0,-59000,0,0,0,25000,84000,-59000,-59000
050892,聯電元大96購02  ,0,0,0,0,0,0,0,0,0,-59000,0,0,0,50000,109000,-59000,-59000
050545,奇力新凱基95購01,0,0,0,0,0,0,0,0,0,-59000,0,0,0,77000,136000,-59000,-59000
051856,亞德客凱基95購01,0,0,0,0,0,0,0,0,0,-59000,0,0,0,5000,64000,-59000,-59000
05156P,群創兆豐95售01  ,0,0,0,0,0,0,0,0,0,-59000,0,0,0,1000,60000,-59000,-59000
052968,燿華群益98購01  ,0,0,0,0,0,0,0,0,0,-59000,0,0,0,0,59000,-59000,-59000
051345,鴻海元大95購09  ,0,0,0,0,0,0,0,0,0,-59000,0,0,0,11000,70000,-59000,-59000
052360,FB上証國票96購01,0,0,0,0,0,0,0,0,0,-59000,0,0,0,0,59000,-59000,-59000
053338,台光電國票97購01,0,0,0,0,0,0,0,0,0,-59000,0,0,0,16000,75000,-59000,-59000
054841,亞德客兆豐97購01,0,0,0,0,0,0,0,0,0,-59000,0,0,0,20000,79000,-59000,-59000
055107,旺宏凱基98購04  ,0,0,0,0,0,0,0,0,0,-59000,0,0,0,37000,96000,-59000,-59000
055612,台光電國票97購04,0,0,0,0,0,0,0,0,0,-59000,0,0,0,14000,73000,-59000,-59000
056227,奇力新凱基98購04,0,0,0,0,0,0,0,0,0,-59000,0,0,0,1000,60000,-59000,-59000
07053P,台灣50兆豐01售01,0,0,0,0,0,0,0,0,0,-59000,0,0,0,0,59000,-59000,-59000
4766,南寶            ,112000,175000,-63000,0,0,0,0,0,0,4000,5000,1000,4000,0,0,0,-59000
2642,宅配通          ,41000,100000,-59000,0,0,0,0,0,0,0,0,0,0,0,0,0,-59000
3563,牧德            ,105000,153000,-48000,0,0,0,2000,32000,-30000,19000,0,0,0,34000,15000,19000,-59000
057928,鈺齊凱基98購02  ,0,0,0,0,0,0,0,0,0,-60000,0,0,0,20000,80000,-60000,-60000
057807,友訊元大98購02  ,0,0,0,0,0,0,0,0,0,-60000,0,0,0,0,60000,-60000,-60000
058280,SGBR2X中信99購01,0,0,0,0,0,0,0,0,0,-60000,0,0,0,0,60000,-60000,-60000
058282,聯茂中信99購01  ,0,0,0,0,0,0,0,0,0,-60000,0,0,0,10000,70000,-60000,-60000
058122,美律國票9A購01  ,0,0,0,0,0,0,0,0,0,-60000,0,0,0,74000,134000,-60000,-60000
058038,滬深反元大98購01,0,0,0,0,0,0,0,0,0,-60000,0,0,0,0,60000,-60000,-60000
058390,樺漢國票9A購01  ,0,0,0,0,0,0,0,0,0,-60000,0,0,0,217000,277000,-60000,-60000
058385,創意中信99購01  ,0,0,0,0,0,0,0,0,0,-60000,0,0,0,0,60000,-60000,-60000
058422,百和麥證99購01  ,0,0,0,10000,70000,-60000,0,0,0,-60000,0,0,0,10000,70000,-60000,-60000
058370,聯詠凱基99購01  ,0,0,0,0,0,0,0,0,0,-60000,0,0,0,0,60000,-60000,-60000
05991P,聯茂群益96售05  ,0,0,0,0,0,0,0,0,0,-60000,0,0,0,0,60000,-60000,-60000
056910,超眾元大99購02  ,0,0,0,0,0,0,0,0,0,-60000,0,0,0,3000,63000,-60000,-60000
056441,燿華凱基98購01  ,0,0,0,0,0,0,0,0,0,-60000,0,0,0,10000,70000,-60000,-60000
056590,樺漢統一9A購01  ,0,0,0,0,0,0,0,0,0,-60000,0,0,0,98000,158000,-60000,-60000
057476,國巨元大98購19  ,0,0,0,0,0,0,0,0,0,-60000,0,0,0,50000,110000,-60000,-60000
057367,技嘉元大98購02  ,0,0,0,0,0,0,0,0,0,-60000,0,0,0,25000,85000,-60000,-60000
052783,台郡國票97購01  ,0,0,0,0,0,0,0,0,0,-60000,0,0,0,26000,86000,-60000,-60000
052695,台表科中信98購01,0,0,0,0,0,0,0,0,0,-60000,0,0,0,0,60000,-60000,-60000
052705,超眾國票97購01  ,0,0,0,0,0,0,0,0,0,-60000,0,0,0,14000,74000,-60000,-60000
052527,泰鼎元大96購02  ,0,0,0,0,0,0,0,0,0,-60000,0,0,0,13000,73000,-60000,-60000
052930,華新科元大97購03,0,0,0,0,0,0,0,0,0,-60000,0,0,0,130000,190000,-60000,-60000
049117,矽格統一96購01  ,0,0,0,0,0,0,0,0,0,-60000,0,0,0,1000,61000,-60000,-60000
048831,玉晶光凱基95購01,0,0,0,0,0,0,0,0,0,-60000,0,0,0,0,60000,-60000,-60000
048842,矽格凱基94購01  ,0,0,0,0,0,0,0,0,0,-60000,0,0,0,10000,70000,-60000,-60000
048818,台達電凱基94購01,0,0,0,0,0,0,0,0,0,-60000,0,0,0,0,60000,-60000,-60000
048575,旺宏國泰94購04  ,0,0,0,0,0,0,0,0,0,-60000,0,0,0,66000,126000,-60000,-60000
048704,台表科國票95購01,0,0,0,0,0,0,0,0,0,-60000,0,0,0,20000,80000,-60000,-60000
048289,臺指反群益95購01,0,0,0,0,0,0,0,0,0,-60000,0,0,0,399000,459000,-60000,-60000
044680,華新科凱基93購06,0,0,0,0,0,0,0,0,0,-60000,0,0,0,0,60000,-60000,-60000
047156,群創國票94購01  ,0,0,0,0,0,0,0,0,0,-60000,0,0,0,3000,63000,-60000,-60000
049634,臺股指群益94購07,0,0,0,0,0,0,0,0,0,-60000,0,0,0,0,60000,-60000,-60000
049577,台達電元大94購08,0,0,0,0,0,0,0,0,0,-60000,0,0,0,0,60000,-60000,-60000
049300,南電群益94購01  ,0,0,0,0,0,0,0,0,0,-60000,0,0,0,52000,112000,-60000,-60000
04633P,旺宏群益96售04  ,0,0,0,0,0,0,0,0,0,-60000,0,0,0,0,60000,-60000,-60000
046570,旺宏國泰94購01  ,0,0,0,0,0,0,0,0,0,-60000,0,0,0,0,60000,-60000,-60000
053355,超眾兆豐97購01  ,0,0,0,0,0,0,0,0,0,-60000,0,0,0,0,60000,-60000,-60000
053738,群創麥證96購01  ,0,0,0,20000,80000,-60000,0,0,0,-60000,0,0,0,20000,80000,-60000,-60000
053743,康控國票97購02  ,0,0,0,0,0,0,0,0,0,-60000,0,0,0,0,60000,-60000,-60000
052343,同欣電凱基95購03,0,0,0,0,0,0,0,0,0,-60000,0,0,0,51000,111000,-60000,-60000
052490,禾伸堂國票95購01,0,0,0,0,0,0,0,0,0,-60000,0,0,0,0,60000,-60000,-60000
05211P,國巨國票96售05  ,0,0,0,0,0,0,0,0,0,-60000,0,0,0,40000,100000,-60000,-60000
051419,麗豐國票96購01  ,0,0,0,0,0,0,0,0,0,-60000,0,0,0,0,60000,-60000,-60000
050467,力成中信94購01  ,0,0,0,0,0,0,0,0,0,-60000,0,0,0,0,60000,-60000,-60000
051384,康友群益95購01  ,0,0,0,0,0,0,0,0,0,-60000,0,0,0,29000,89000,-60000,-60000
051518,富邦金凱基95購01,0,0,0,0,0,0,0,0,0,-60000,0,0,0,0,60000,-60000,-60000
050174,技嘉元大94購01  ,0,0,0,0,0,0,0,0,0,-60000,0,0,0,25000,85000,-60000,-60000
053047,寶成中信97購01  ,0,0,0,0,0,0,0,0,0,-60000,0,0,0,0,60000,-60000,-60000
053196,康控元富96購01  ,0,0,0,0,0,0,0,0,0,-60000,0,0,0,0,60000,-60000,-60000
051055,友達群益98購01  ,0,0,0,0,0,0,0,0,0,-60000,0,0,0,0,60000,-60000,-60000
050508,上証2X元大97購01,0,0,0,0,0,0,0,0,0,-60000,0,0,0,0,60000,-60000,-60000
050598,友達麥證94購01  ,0,0,0,10000,70000,-60000,0,0,0,-60000,0,0,0,10000,70000,-60000,-60000
050291,聯發科凱基94購16,0,0,0,0,0,0,0,0,0,-60000,0,0,0,0,60000,-60000,-60000
051105,台光電國票96購01,0,0,0,0,0,0,0,0,0,-60000,0,0,0,0,60000,-60000,-60000
053054,禾伸堂國票97購01,0,0,0,0,0,0,0,0,0,-60000,0,0,0,0,60000,-60000,-60000
051472,台積電凱基95購09,0,0,0,0,0,0,0,0,0,-60000,0,0,0,0,60000,-60000,-60000
056316,訊芯元大98購03  ,0,0,0,0,0,0,0,0,0,-60000,0,0,0,150000,210000,-60000,-60000
056422,全新統一98購02  ,0,0,0,0,0,0,0,0,0,-60000,0,0,0,0,60000,-60000,-60000
055823,臺股指國票97購10,0,0,0,0,0,0,0,0,0,-60000,0,0,0,0,60000,-60000,-60000
055618,麗豐國票98購01  ,0,0,0,0,0,0,0,0,0,-60000,0,0,0,0,60000,-60000,-60000
055694,光罩國票98購01  ,0,0,0,0,0,0,0,0,0,-60000,0,0,0,271000,331000,-60000,-60000
055461,TPK永豐97購01   ,0,0,0,0,0,0,0,0,0,-60000,0,0,0,0,60000,-60000,-60000
055199,國喬群益97購01  ,0,0,0,0,0,0,0,0,0,-60000,0,0,0,0,60000,-60000,-60000
055058,大毅永豐97購01  ,0,0,0,0,0,0,0,0,0,-60000,0,0,0,0,60000,-60000,-60000
054893,帆宣統一99購01  ,0,0,0,0,0,0,0,0,0,-60000,0,0,0,40000,100000,-60000,-60000
054211,奇鋐國票97購03  ,0,0,0,0,0,0,0,0,0,-60000,0,0,0,0,60000,-60000,-60000
054219,楠梓電統一97購01,0,0,0,0,0,0,0,0,0,-60000,0,0,0,0,60000,-60000,-60000
053857,宏達電富邦97購02,0,0,0,0,0,0,0,0,0,-60000,0,0,0,16000,76000,-60000,-60000
2903,遠百            ,437000,505000,-68000,0,0,0,0,0,0,8000,13000,5000,8000,0,0,0,-60000
2436,偉詮電          ,295000,357000,-62000,0,0,0,0,0,0,2000,2000,0,2000,0,0,0,-60000
08218P,滬深2X凱基96售01,0,0,0,0,0,0,0,0,0,-60000,0,0,0,70000,130000,-60000,-60000
06437P,玉晶光國票99售01,0,0,0,0,0,0,0,0,0,-60000,0,0,0,0,60000,-60000,-60000
06670P,鴻海群益98售06  ,0,0,0,0,0,0,0,0,0,-60000,0,0,0,0,60000,-60000,-60000
057185,群創元大98購06  ,0,0,0,0,0,0,0,0,0,-61000,0,0,0,0,61000,-61000,-61000
057148,玉晶光國票99購04,0,0,0,0,0,0,0,0,0,-61000,0,0,0,60000,121000,-61000,-61000
056538,國泰金凱基98購01,0,0,0,0,0,0,0,0,0,-61000,0,0,0,16000,77000,-61000,-61000
057046,奇力新元大99購03,0,0,0,0,0,0,0,0,0,-61000,0,0,0,34000,95000,-61000,-61000
058253,臺股指元大9A購17,0,0,0,0,0,0,0,0,0,-61000,0,0,0,0,61000,-61000,-61000
057698,奇力新群益98購02,0,0,0,0,0,0,0,0,0,-61000,0,0,0,12000,73000,-61000,-61000
057730,聯鈞國泰9A購01  ,0,0,0,0,0,0,0,0,0,-61000,0,0,0,31000,92000,-61000,-61000
057962,超眾元大99購03  ,0,0,0,0,0,0,0,0,0,-61000,0,0,0,10000,71000,-61000,-61000
046291,友達統一94購01  ,0,0,0,0,0,0,0,0,0,-61000,0,0,0,20000,81000,-61000,-61000
048007,明基材元大96購01,0,0,0,0,0,0,0,0,0,-61000,0,0,0,5000,66000,-61000,-61000
047628,新光金國票95購02,0,0,0,0,0,0,0,0,0,-61000,0,0,0,0,61000,-61000,-61000
052792,大立光兆豐96購01,0,0,0,0,0,0,0,0,0,-61000,0,0,0,0,61000,-61000,-61000
053070,訊芯群益96購01  ,0,0,0,0,0,0,0,0,0,-61000,0,0,0,11000,72000,-61000,-61000
051636,嘉晶國票95購02  ,0,0,0,0,0,0,0,0,0,-61000,0,0,0,15000,76000,-61000,-61000
053725,晶相光凱基96購01,0,0,0,0,0,0,0,0,0,-61000,0,0,0,109000,170000,-61000,-61000
053418,旺宏永豐96購02  ,0,0,0,0,0,0,0,0,0,-61000,0,0,0,150000,211000,-61000,-61000
054930,群電凱基98購01  ,0,0,0,0,0,0,0,0,0,-61000,0,0,0,7000,68000,-61000,-61000
054517,高鐵元大96購01  ,0,0,0,0,0,0,0,0,0,-61000,0,0,0,52000,113000,-61000,-61000
054567,拓凱群益98購01  ,0,0,0,0,0,0,0,0,0,-61000,0,0,0,0,61000,-61000,-61000
055216,友達凱基98購05  ,0,0,0,0,0,0,0,0,0,-61000,0,0,0,0,61000,-61000,-61000
055492,華新科元大97購08,0,0,0,0,0,0,0,0,0,-61000,0,0,0,48000,109000,-61000,-61000
06694P,臺股指凱基99售13,0,0,0,0,0,0,0,0,0,-61000,0,0,0,0,61000,-61000,-61000
06782P,大立光元大99售07,0,0,0,0,0,0,0,0,0,-61000,0,0,0,0,61000,-61000,-61000
2727,王品            ,62000,123000,-61000,0,0,0,0,0,0,0,0,0,0,0,0,0,-61000
2612,中航            ,128000,162000,-34000,0,0,0,0,0,0,-27000,0,27000,-27000,0,0,0,-61000
058233,聯發科元大99購06,0,0,0,0,0,0,0,0,0,-62000,0,0,0,147000,209000,-62000,-62000
056696,茂林群益98購02  ,0,0,0,0,0,0,0,0,0,-62000,0,0,0,14000,76000,-62000,-62000
049517,台光電國票94購02,0,0,0,0,0,0,0,0,0,-62000,0,0,0,10000,72000,-62000,-62000
047992,東陽元大96購01  ,0,0,0,0,0,0,0,0,0,-62000,0,0,0,0,62000,-62000,-62000
047763,旺宏元大94購04  ,0,0,0,0,0,0,0,0,0,-62000,0,0,0,10000,72000,-62000,-62000
053586,建準元大96購01  ,0,0,0,0,0,0,0,0,0,-62000,0,0,0,6000,68000,-62000,-62000
053018,旺宏元富96購02  ,0,0,0,0,0,0,0,0,0,-62000,0,0,0,98000,160000,-62000,-62000
051947,矽力統一95購01  ,0,0,0,0,0,0,0,0,0,-62000,0,0,0,13000,75000,-62000,-62000
051959,台郡台新95購03  ,0,0,0,0,0,0,0,0,0,-62000,0,0,0,164000,226000,-62000,-62000
05086P,鴻海凱基95售13  ,0,0,0,0,0,0,0,0,0,-62000,0,0,0,7000,69000,-62000,-62000
050786,健策國泰96購01  ,0,0,0,0,0,0,0,0,0,-62000,0,0,0,30000,92000,-62000,-62000
055240,京元電元富97購01,0,0,0,0,0,0,0,0,0,-62000,0,0,0,17000,79000,-62000,-62000
056033,T50正2凱基99購02,0,0,0,0,0,0,0,0,0,-62000,0,0,0,0,62000,-62000,-62000
054824,同欣電元大97購04,0,0,0,0,0,0,0,0,0,-62000,0,0,0,68000,130000,-62000,-62000
054940,台積電元大97購16,0,0,0,0,0,0,0,0,0,-62000,0,0,0,168000,230000,-62000,-62000
053859,台積電元大97購09,0,0,0,0,0,0,0,0,0,-62000,0,0,0,126000,188000,-62000,-62000
054272,華通中信98購01  ,0,0,0,0,0,0,0,0,0,-62000,0,0,0,0,62000,-62000,-62000
6177,達麗            ,88000,150000,-62000,0,0,0,0,0,0,0,0,0,0,0,0,0,-62000
06949P,台表科元大99售01,0,0,0,0,0,0,0,0,0,-62000,0,0,0,28000,90000,-62000,-62000
06296P,燿華元大98售01  ,0,0,0,0,0,0,0,0,0,-62000,0,0,0,95000,157000,-62000,-62000
056942,昇陽半元富98購01,0,0,0,0,0,0,0,0,0,-63000,0,0,0,156000,219000,-63000,-63000
056843,冠德元富98購01  ,0,0,0,0,0,0,0,0,0,-63000,0,0,0,60000,123000,-63000,-63000
057253,高股息中信99購02,0,0,0,0,0,0,0,0,0,-63000,0,0,0,70000,133000,-63000,-63000
057323,智邦群益98購01  ,0,0,0,0,0,0,0,0,0,-63000,0,0,0,114000,177000,-63000,-63000
057364,國巨元大98購18  ,0,0,0,0,0,0,0,0,0,-63000,0,0,0,107000,170000,-63000,-63000
057536,康控元大99購03  ,0,0,0,0,0,0,0,0,0,-63000,0,0,0,59000,122000,-63000,-63000
058360,台光電凱基9A購02,0,0,0,0,0,0,0,0,0,-63000,0,0,0,6000,69000,-63000,-63000
058331,鴻海元富99購02  ,0,0,0,0,0,0,0,0,0,-63000,0,0,0,511000,574000,-63000,-63000
045435,鴻海統一94購01  ,0,0,0,0,0,0,0,0,0,-63000,0,0,0,11000,74000,-63000,-63000
050512,台泥元大94購01  ,0,0,0,0,0,0,0,0,0,-63000,0,0,0,87000,150000,-63000,-63000
051052,台積電群益95購01,0,0,0,0,0,0,0,0,0,-63000,0,0,0,159000,222000,-63000,-63000
053661,嘉澤凱基97購01  ,0,0,0,0,0,0,0,0,0,-63000,0,0,0,0,63000,-63000,-63000
051483,玉晶光凱基96購02,0,0,0,0,0,0,0,0,0,-63000,0,0,0,107000,170000,-63000,-63000
05431P,台光電統一97售01,0,0,0,0,0,0,0,0,0,-63000,0,0,0,0,63000,-63000,-63000
056140,康控元大98購01  ,0,0,0,0,0,0,0,0,0,-63000,0,0,0,292000,355000,-63000,-63000
056126,台郡國票98購02  ,0,0,0,0,0,0,0,0,0,-63000,0,0,0,9000,72000,-63000,-63000
055816,新日興國票98購01,0,0,0,0,0,0,0,0,0,-63000,0,0,0,14000,77000,-63000,-63000
055262,台虹國泰98購01  ,0,0,0,0,0,0,0,0,0,-63000,0,0,0,20000,83000,-63000,-63000
055535,緯創群益98購01  ,0,0,0,0,0,0,0,0,0,-63000,0,0,0,55000,118000,-63000,-63000
2314,台揚            ,272000,333000,-61000,0,0,0,0,0,0,-2000,0,15000,-15000,13000,0,13000,-63000
058307,聯發科元大99購08,0,0,0,0,0,0,0,0,0,-64000,0,0,0,254000,318000,-64000,-64000
056836,國巨元富98購01  ,0,0,0,0,0,0,0,0,0,-64000,0,0,0,47000,111000,-64000,-64000
056914,臺股指元大99購09,0,0,0,0,0,0,0,0,0,-64000,0,0,0,22000,86000,-64000,-64000
057053,立積元大98購02  ,0,0,0,0,0,0,0,0,0,-64000,0,0,0,59000,123000,-64000,-64000
056674,華邦電元富98購01,0,0,0,0,0,0,0,0,0,-64000,0,0,0,95000,159000,-64000,-64000
050050,國泰金群益94購02,0,0,0,0,0,0,0,0,0,-64000,0,0,0,3000,67000,-64000,-64000
047476,鴻海凱基94購08  ,0,0,0,0,0,0,0,0,0,-64000,0,0,0,17000,81000,-64000,-64000
03993P,滬深2X中信94售03,0,0,0,0,0,0,0,0,0,-64000,0,0,0,23000,87000,-64000,-64000
042793,台積電台新9C購01,0,0,0,0,0,0,0,0,0,-64000,0,0,0,0,64000,-64000,-64000
04982P,臺股指中信94售03,0,0,0,0,0,0,0,0,0,-64000,0,0,0,15000,79000,-64000,-64000
049727,台積電中信94購02,0,0,0,0,0,0,0,0,0,-64000,0,0,0,30000,94000,-64000,-64000
051378,奇力新群益95購01,0,0,0,0,0,0,0,0,0,-64000,0,0,0,0,64000,-64000,-64000
052028,健策群益95購02  ,0,0,0,0,0,0,0,0,0,-64000,0,0,0,52000,116000,-64000,-64000
055460,華擎永豐97購01  ,0,0,0,0,0,0,0,0,0,-64000,0,0,0,1000,65000,-64000,-64000
056119,欣興群益97購02  ,0,0,0,0,0,0,0,0,0,-64000,0,0,0,0,64000,-64000,-64000
054398,牧德永豐96購03  ,0,0,0,0,0,0,0,0,0,-64000,0,0,0,6000,70000,-64000,-64000
054237,茂林群益97購01  ,0,0,0,0,0,0,0,0,0,-64000,0,0,0,17000,81000,-64000,-64000
055106,台積電凱基98購05,0,0,0,0,0,0,0,0,0,-64000,0,0,0,0,64000,-64000,-64000
054571,楠梓電元大99購01,0,0,0,0,0,0,0,0,0,-64000,0,0,0,4000,68000,-64000,-64000
06550P,健策元大99售01  ,0,0,0,0,0,0,0,0,0,-64000,0,0,0,529000,593000,-64000,-64000
057477,智邦元大98購09  ,0,0,0,0,0,0,0,0,0,-65000,0,0,0,1000,66000,-65000,-65000
057500,神達群益98購01  ,0,0,0,0,0,0,0,0,0,-65000,0,0,0,11000,76000,-65000,-65000
058703,台積電元大99購16,0,0,0,0,0,0,0,0,0,-65000,0,0,0,0,65000,-65000,-65000
057940,和大國票99購01  ,0,0,0,0,0,0,0,0,0,-65000,0,0,0,0,65000,-65000,-65000
049690,義隆元大95購02  ,0,0,0,0,0,0,0,0,0,-65000,0,0,0,0,65000,-65000,-65000
050010,鈺齊永豐94購01  ,0,0,0,0,0,0,0,0,0,-65000,0,0,0,0,65000,-65000,-65000
048061,鴻海統一95購03  ,0,0,0,0,0,0,0,0,0,-65000,0,0,0,15000,80000,-65000,-65000
047572,深中小群益95購01,0,0,0,0,0,0,0,0,0,-65000,0,0,0,0,65000,-65000,-65000
00851,台新全球AI      ,0,0,0,0,0,0,0,0,0,-65000,0,0,0,74000,139000,-65000,-65000
047437,旺宏元大94購02  ,0,0,0,0,0,0,0,0,0,-65000,0,0,0,6000,71000,-65000,-65000
045480,滬深2X中信94購01,0,0,0,0,0,0,0,0,0,-65000,0,0,0,0,65000,-65000,-65000
050263,旺宏元大94購10  ,0,0,0,0,0,0,0,0,0,-65000,0,0,0,112000,177000,-65000,-65000
053112,中磊兆豐97購01  ,0,0,0,0,0,0,0,0,0,-65000,0,0,0,0,65000,-65000,-65000
051828,微星元大95購03  ,0,0,0,0,0,0,0,0,0,-65000,0,0,0,16000,81000,-65000,-65000
050484,世紀鋼國票95購02,0,0,0,0,0,0,0,0,0,-65000,0,0,0,62000,127000,-65000,-65000
051318,上銀國票96購01  ,0,0,0,0,0,0,0,0,0,-65000,0,0,0,4000,69000,-65000,-65000
050385,貿聯國票95購02  ,0,0,0,0,0,0,0,0,0,-65000,0,0,0,10000,75000,-65000,-65000
051677,達方元大95購01  ,0,0,0,0,0,0,0,0,0,-65000,0,0,0,80000,145000,-65000,-65000
052452,茂林元大95購03  ,0,0,0,0,0,0,0,0,0,-65000,0,0,0,31000,96000,-65000,-65000
05477P,華新科群益95售06,0,0,0,0,0,0,0,0,0,-65000,0,0,0,145000,210000,-65000,-65000
054452,華通亞東96購01  ,0,0,0,0,0,0,0,0,0,-65000,0,0,0,0,65000,-65000,-65000
054367,鴻海中信98購03  ,0,0,0,0,0,0,0,0,0,-65000,0,0,0,0,65000,-65000,-65000
053977,新日興元大96購03,0,0,0,0,0,0,0,0,0,-65000,0,0,0,188000,253000,-65000,-65000
056158,新日興凱基98購02,0,0,0,0,0,0,0,0,0,-65000,0,0,0,0,65000,-65000,-65000
055334,禾伸堂兆豐97購01,0,0,0,0,0,0,0,0,0,-65000,0,0,0,0,65000,-65000,-65000
055245,凱美統一99購01  ,0,0,0,0,0,0,0,0,0,-65000,0,0,0,0,65000,-65000,-65000
055710,亞德客元大97購03,0,0,0,0,0,0,0,0,0,-65000,0,0,0,168000,233000,-65000,-65000
055735,宏達電元富98購01,0,0,0,0,0,0,0,0,0,-65000,0,0,0,361000,426000,-65000,-65000
06889P,臺股指元大98售13,0,0,0,0,0,0,0,0,0,-65000,0,0,0,0,65000,-65000,-65000
05946P,和碩中信96售01  ,0,0,0,0,0,0,0,0,0,-66000,0,0,0,71000,137000,-66000,-66000
058536,群創統一9B購01  ,0,0,0,0,0,0,0,0,0,-66000,0,0,0,0,66000,-66000,-66000
057203,麗豐元富98購02  ,0,0,0,0,0,0,0,0,0,-66000,0,0,0,35000,101000,-66000,-66000
057174,南亞科元大98購05,0,0,0,0,0,0,0,0,0,-66000,0,0,0,2000,68000,-66000,-66000
049341,旺宏統一95購01  ,0,0,0,0,0,0,0,0,0,-66000,0,0,0,59000,125000,-66000,-66000
049732,國巨群益94購05  ,0,0,0,0,0,0,0,0,0,-66000,0,0,0,0,66000,-66000,-66000
05039P,鴻海凱基95售10  ,0,0,0,0,0,0,0,0,0,-66000,0,0,0,6000,72000,-66000,-66000
056014,上銀群益97購02  ,0,0,0,0,0,0,0,0,0,-66000,0,0,0,14000,80000,-66000,-66000
054615,牧德永豐98購01  ,0,0,0,0,0,0,0,0,0,-66000,0,0,0,0,66000,-66000,-66000
06300P,緯穎元大97售04  ,0,0,0,0,0,0,0,0,0,-66000,0,0,0,24000,90000,-66000,-66000
9925,新保            ,56000,122000,-66000,0,0,0,0,0,0,0,0,0,0,0,0,0,-66000
056926,日月光兆豐98購01,0,0,0,0,0,0,0,0,0,-67000,0,0,0,36000,103000,-67000,-67000
056958,喬山永豐98購01  ,0,0,0,0,0,0,0,0,0,-67000,0,0,0,4000,71000,-67000,-67000
056773,晶技元大99購03  ,0,0,0,0,0,0,0,0,0,-67000,0,0,0,61000,128000,-67000,-67000
052536,聯茂國泰97購01  ,0,0,0,0,0,0,0,0,0,-67000,0,0,0,10000,77000,-67000,-67000
052832,益航群益96購01  ,0,0,0,0,0,0,0,0,0,-67000,0,0,0,195000,262000,-67000,-67000
051647,華新科永豐95購02,0,0,0,0,0,0,0,0,0,-67000,0,0,0,20000,87000,-67000,-67000
052109,可成元富95購01  ,0,0,0,0,0,0,0,0,0,-67000,0,0,0,0,67000,-67000,-67000
051772,玉山金中信95購01,0,0,0,0,0,0,0,0,0,-67000,0,0,0,94000,161000,-67000,-67000
051195,台郡中信95購01  ,0,0,0,0,0,0,0,0,0,-67000,0,0,0,0,67000,-67000,-67000
055554,聯發科凱基97購06,0,0,0,0,0,0,0,0,0,-67000,0,0,0,1000,68000,-67000,-67000
055384,緯穎元大98購02  ,0,0,0,0,0,0,0,0,0,-67000,0,0,0,32000,99000,-67000,-67000
06471P,臺股指凱基99售11,0,0,0,0,0,0,0,0,0,-67000,0,0,0,173000,240000,-67000,-67000
06644P,亞德客元大98售03,0,0,0,0,0,0,0,0,0,-67000,0,0,0,2000,69000,-67000,-67000
056966,嘉晶永豐98購01  ,0,0,0,0,0,0,0,0,0,-68000,0,0,0,0,68000,-68000,-68000
056676,國產元富98購01  ,0,0,0,0,0,0,0,0,0,-68000,0,0,0,30000,98000,-68000,-68000
056573,華新科元大99購06,0,0,0,0,0,0,0,0,0,-68000,0,0,0,20000,88000,-68000,-68000
056438,旺宏凱基98購05  ,0,0,0,0,0,0,0,0,0,-68000,0,0,0,1000,69000,-68000,-68000
057162,上銀元大98購03  ,0,0,0,0,0,0,0,0,0,-68000,0,0,0,0,68000,-68000,-68000
057630,茂林永豐98購01  ,0,0,0,0,0,0,0,0,0,-68000,0,0,0,0,68000,-68000,-68000
057642,南亞科元大98購07,0,0,0,0,0,0,0,0,0,-68000,0,0,0,0,68000,-68000,-68000
057861,台積電凱基98購16,0,0,0,0,0,0,0,0,0,-68000,0,0,0,12000,80000,-68000,-68000
058251,百和元大99購03  ,0,0,0,0,0,0,0,0,0,-68000,0,0,0,0,68000,-68000,-68000
058138,晶相光元大9C購01,0,0,0,0,0,0,0,0,0,-68000,0,0,0,400000,468000,-68000,-68000
058026,上銀富邦9A購01  ,0,0,0,0,0,0,0,0,0,-68000,0,0,0,10000,78000,-68000,-68000
058051,同欣電元大98購03,0,0,0,0,0,0,0,0,0,-68000,0,0,0,0,68000,-68000,-68000
058116,正崴中信99購02  ,0,0,0,0,0,0,0,0,0,-68000,0,0,0,60000,128000,-68000,-68000
052934,中磊元大96購01  ,0,0,0,0,0,0,0,0,0,-68000,0,0,0,0,68000,-68000,-68000
052672,世紀鋼群益96購02,0,0,0,0,0,0,0,0,0,-68000,0,0,0,327000,395000,-68000,-68000
048642,聯發科元大94購02,0,0,0,0,0,0,0,0,0,-68000,0,0,0,0,68000,-68000,-68000
049138,台積電元大94購05,0,0,0,0,0,0,0,0,0,-68000,0,0,0,150000,218000,-68000,-68000
050529,矽格元大94購05  ,0,0,0,0,0,0,0,0,0,-68000,0,0,0,0,68000,-68000,-68000
051832,復盛元大95購01  ,0,0,0,0,0,0,0,0,0,-68000,0,0,0,0,68000,-68000,-68000
050199,南電元大94購09  ,0,0,0,0,0,0,0,0,0,-68000,0,0,0,115000,183000,-68000,-68000
051669,建準元大95購01  ,0,0,0,0,0,0,0,0,0,-68000,0,0,0,0,68000,-68000,-68000
051362,台郡元大95購04  ,0,0,0,0,0,0,0,0,0,-68000,0,0,0,0,68000,-68000,-68000
053596,嘉澤元大96購01  ,0,0,0,0,0,0,0,0,0,-68000,0,0,0,0,68000,-68000,-68000
053546,台積電凱基96購13,0,0,0,0,0,0,0,0,0,-68000,0,0,0,0,68000,-68000,-68000
053583,漢唐元大96購03  ,0,0,0,0,0,0,0,0,0,-68000,0,0,0,0,68000,-68000,-68000
055182,京鼎統一98購01  ,0,0,0,0,0,0,0,0,0,-68000,0,0,0,48000,116000,-68000,-68000
055615,宏達電國票99購02,0,0,0,0,0,0,0,0,0,-68000,0,0,0,2000,70000,-68000,-68000
055684,京鼎凱基97購01  ,0,0,0,0,0,0,0,0,0,-68000,0,0,0,0,68000,-68000,-68000
056139,貿聯元大97購04  ,0,0,0,0,0,0,0,0,0,-68000,0,0,0,0,68000,-68000,-68000
055802,新日興永豐97購01,0,0,0,0,0,0,0,0,0,-68000,0,0,0,0,68000,-68000,-68000
055828,上銀元大97購05  ,0,0,0,0,0,0,0,0,0,-68000,0,0,0,5000,73000,-68000,-68000
055844,大毅元大98購01  ,0,0,0,0,0,0,0,0,0,-68000,0,0,0,430000,498000,-68000,-68000
056224,聯發科凱基97購08,0,0,0,0,0,0,0,0,0,-68000,0,0,0,0,68000,-68000,-68000
056294,上銀元大97購11  ,0,0,0,0,0,0,0,0,0,-68000,0,0,0,0,68000,-68000,-68000
055147,鴻海元大97購11  ,0,0,0,0,0,0,0,0,0,-68000,0,0,0,0,68000,-68000,-68000
054042,華泰元大96購01  ,0,0,0,0,0,0,0,0,0,-68000,0,0,0,0,68000,-68000,-68000
054326,宏達電台新97購02,0,0,0,0,0,0,0,0,0,-68000,0,0,0,0,68000,-68000,-68000
054244,華新元大96購01  ,0,0,0,0,0,0,0,0,0,-68000,0,0,0,0,68000,-68000,-68000
054153,宏達電國泰97購01,0,0,0,0,0,0,0,0,0,-68000,0,0,0,125000,193000,-68000,-68000
054138,晶技元大98購02  ,0,0,0,0,0,0,0,0,0,-68000,0,0,0,146000,214000,-68000,-68000
058623,國巨國票99購08  ,0,0,0,0,0,0,0,0,0,-69000,0,0,0,0,69000,-69000,-69000
057528,南亞科元大99購01,0,0,0,0,0,0,0,0,0,-69000,0,0,0,0,69000,-69000,-69000
057363,華通元大99購02  ,0,0,0,0,0,0,0,0,0,-69000,0,0,0,23000,92000,-69000,-69000
057193,力成元大98購02  ,0,0,0,0,0,0,0,0,0,-69000,0,0,0,50000,119000,-69000,-69000
057079,台積電統一9A購02,0,0,0,0,0,0,0,0,0,-69000,0,0,0,356000,425000,-69000,-69000
056929,華新科台新98購01,0,0,0,0,0,0,0,0,0,-69000,0,0,0,0,69000,-69000,-69000
056881,台灣50康和9A購01,0,0,0,0,0,0,0,0,0,-69000,0,0,0,60000,129000,-69000,-69000
049101,聯詠國泰95購01  ,0,0,0,0,0,0,0,0,0,-69000,0,0,0,51000,120000,-69000,-69000
048894,光罩國泰94購01  ,0,0,0,0,0,0,0,0,0,-69000,0,0,0,15000,84000,-69000,-69000
049297,日電貿群益95購01,0,0,0,0,0,0,0,0,0,-69000,0,0,0,0,69000,-69000,-69000
053578,華新元大98購01  ,0,0,0,0,0,0,0,0,0,-69000,0,0,0,73000,142000,-69000,-69000
050102,鴻海富邦95購04  ,0,0,0,0,0,0,0,0,0,-69000,0,0,0,1000,70000,-69000,-69000
050998,訊連元大95購01  ,0,0,0,0,0,0,0,0,0,-69000,0,0,0,0,69000,-69000,-69000
053053,京元電國票97購02,0,0,0,0,0,0,0,0,0,-69000,0,0,0,0,69000,-69000,-69000
054946,億光元大97購01  ,0,0,0,0,0,0,0,0,0,-69000,0,0,0,0,69000,-69000,-69000
055643,宏碁元富97購01  ,0,0,0,0,0,0,0,0,0,-69000,0,0,0,0,69000,-69000,-69000
055239,帆宣台新97購01  ,0,0,0,0,0,0,0,0,0,-69000,0,0,0,40000,109000,-69000,-69000
055383,GIS元大97購02   ,0,0,0,0,0,0,0,0,0,-69000,0,0,0,100000,169000,-69000,-69000
3583,辛耘            ,231000,170000,61000,0,0,0,0,130000,-130000,0,0,0,0,0,0,0,-69000
056445,聯發科凱基98購07,0,0,0,0,0,0,0,0,0,-70000,0,0,0,20000,90000,-70000,-70000
057120,茂林康和98購01  ,0,0,0,0,0,0,0,0,0,-70000,0,0,0,0,70000,-70000,-70000
057283,欣興元大98購07  ,0,0,0,0,0,0,0,0,0,-70000,0,0,0,75000,145000,-70000,-70000
057307,瀚宇博兆豐99購01,0,0,0,0,0,0,0,0,0,-70000,0,0,0,30000,100000,-70000,-70000
057260,微星兆豐98購01  ,0,0,0,0,0,0,0,0,0,-70000,0,0,0,19000,89000,-70000,-70000
057458,TPK富邦9A購01   ,0,0,0,0,0,0,0,0,0,-70000,0,0,0,25000,95000,-70000,-70000
05760P,京鼎永豐96售02  ,0,0,0,0,0,0,0,0,0,-70000,0,0,0,30000,100000,-70000,-70000
058495,元大金群益9B購01,0,0,0,0,0,0,0,0,0,-70000,0,0,0,0,70000,-70000,-70000
058446,新光金富邦9C購01,0,0,0,0,0,0,0,0,0,-70000,0,0,0,0,70000,-70000,-70000
058451,智邦永豐9A購01  ,0,0,0,0,0,0,0,0,0,-70000,0,0,0,34000,104000,-70000,-70000
058457,創意永豐99購01  ,0,0,0,0,0,0,0,0,0,-70000,0,0,0,167000,237000,-70000,-70000
058266,宏達電永豐99購01,0,0,0,0,0,0,0,0,0,-70000,0,0,0,6000,76000,-70000,-70000
04925P,和碩元大94售03  ,0,0,0,0,0,0,0,0,0,-70000,0,0,0,180000,250000,-70000,-70000
045208,力成國泰94購01  ,0,0,0,0,0,0,0,0,0,-70000,0,0,0,65000,135000,-70000,-70000
04288P,台積電中信95售06,0,0,0,0,0,0,0,0,0,-70000,0,0,0,30000,100000,-70000,-70000
044299,南電凱基93購02  ,0,0,0,0,0,0,0,0,0,-70000,0,0,0,0,70000,-70000,-70000
052828,滬深2X群益9A購02,0,0,0,0,0,0,0,0,0,-70000,0,0,0,50000,120000,-70000,-70000
048443,旺宏凱基93購08  ,0,0,0,0,0,0,0,0,0,-70000,0,0,0,0,70000,-70000,-70000
053176,矽力群益96購02  ,0,0,0,0,0,0,0,0,0,-70000,0,0,0,11000,81000,-70000,-70000
052580,高鐵元富96購01  ,0,0,0,0,0,0,0,0,0,-70000,0,0,0,20000,90000,-70000,-70000
051833,昇陽半元大96購01,0,0,0,0,0,0,0,0,0,-70000,0,0,0,0,70000,-70000,-70000
052707,景碩台新96購01  ,0,0,0,0,0,0,0,0,0,-70000,0,0,0,30000,100000,-70000,-70000
050609,鴻海元大94購23  ,0,0,0,0,0,0,0,0,0,-70000,0,0,0,0,70000,-70000,-70000
053506,南茂兆豐97購01  ,0,0,0,0,0,0,0,0,0,-70000,0,0,0,75000,145000,-70000,-70000
053536,明泰永豐96購01  ,0,0,0,0,0,0,0,0,0,-70000,0,0,0,0,70000,-70000,-70000
053729,聯茂凱基96購05  ,0,0,0,0,0,0,0,0,0,-70000,0,0,0,0,70000,-70000,-70000
053624,A50正2兆豐97購02,0,0,0,0,0,0,0,0,0,-70000,0,0,0,60000,130000,-70000,-70000
052413,上証反中信97購01,0,0,0,0,0,0,0,0,0,-70000,0,0,0,0,70000,-70000,-70000
052211,台積電元大95購22,0,0,0,0,0,0,0,0,0,-70000,0,0,0,0,70000,-70000,-70000
051366,康友國泰97購01  ,0,0,0,0,0,0,0,0,0,-70000,0,0,0,15000,85000,-70000,-70000
050437,聯詠凱基94購04  ,0,0,0,0,0,0,0,0,0,-70000,0,0,0,0,70000,-70000,-70000
051779,大立光群益95購02,0,0,0,0,0,0,0,0,0,-70000,0,0,0,0,70000,-70000,-70000
055800,欣興永豐97購02  ,0,0,0,0,0,0,0,0,0,-70000,0,0,0,20000,90000,-70000,-70000
055557,華新科凱基97購01,0,0,0,0,0,0,0,0,0,-70000,0,0,0,15000,85000,-70000,-70000
055573,國巨統一97購06  ,0,0,0,0,0,0,0,0,0,-70000,0,0,0,150000,220000,-70000,-70000
056404,嘉聯益群益9A購01,0,0,0,0,0,0,0,0,0,-70000,0,0,0,111000,181000,-70000,-70000
054575,聯鈞元大97購01  ,0,0,0,0,0,0,0,0,0,-70000,0,0,0,28000,98000,-70000,-70000
054542,台表科國票98購01,0,0,0,0,0,0,0,0,0,-70000,0,0,0,70000,140000,-70000,-70000
054473,鴻海中信96購02  ,0,0,0,0,0,0,0,0,0,-70000,0,0,0,130000,200000,-70000,-70000
053854,聯茂國泰97購02  ,0,0,0,0,0,0,0,0,0,-70000,0,0,0,10000,80000,-70000,-70000
06295P,國巨元大97售14  ,0,0,0,0,0,0,0,0,0,-70000,0,0,0,70000,140000,-70000,-70000
058595,T50正2元富99購01,0,0,0,0,0,0,0,0,0,-71000,0,0,0,0,71000,-71000,-71000
058618,南電元大99購02  ,0,0,0,0,0,0,0,0,0,-71000,0,0,0,15000,86000,-71000,-71000
058633,台灣50兆豐99購01,0,0,0,0,0,0,0,0,0,-71000,0,0,0,5000,76000,-71000,-71000
06002P,華通康和96售01  ,0,0,0,0,0,0,0,0,0,-71000,0,0,0,0,71000,-71000,-71000
057113,祥碩群益98購01  ,0,0,0,0,0,0,0,0,0,-71000,0,0,0,52000,123000,-71000,-71000
056475,宏達電元大99購02,0,0,0,0,0,0,0,0,0,-71000,0,0,0,65000,136000,-71000,-71000
056631,臺股指永豐98購03,0,0,0,0,0,0,0,0,0,-71000,0,0,0,0,71000,-71000,-71000
05696P,南亞科凱基96售01,0,0,0,0,0,0,0,0,0,-71000,0,0,0,29000,100000,-71000,-71000
051641,矽創國票96購01  ,0,0,0,0,0,0,0,0,0,-71000,0,0,0,59000,130000,-71000,-71000
053487,台泥兆豐97購01  ,0,0,0,0,0,0,0,0,0,-71000,0,0,0,0,71000,-71000,-71000
050200,致新元大94購01  ,0,0,0,0,0,0,0,0,0,-71000,0,0,0,1000,72000,-71000,-71000
05390P,康友群益95售04  ,0,0,0,0,0,0,0,0,0,-71000,0,0,0,0,71000,-71000,-71000
054048,國泰金元大96購04,0,0,0,0,0,0,0,0,0,-71000,0,0,0,100000,171000,-71000,-71000
054208,台積電國票97購07,0,0,0,0,0,0,0,0,0,-71000,0,0,0,33000,104000,-71000,-71000
054268,健策第一96購01  ,0,0,0,0,0,0,0,0,0,-71000,0,0,0,80000,151000,-71000,-71000
055482,聚陽元大97購02  ,0,0,0,0,0,0,0,0,0,-71000,0,0,0,11000,82000,-71000,-71000
055675,亞德客凱基97購02,0,0,0,0,0,0,0,0,0,-71000,0,0,0,2000,73000,-71000,-71000
055448,健策統一97購02  ,0,0,0,0,0,0,0,0,0,-71000,0,0,0,0,71000,-71000,-71000
06338P,亞德客統一97售02,0,0,0,0,0,0,0,0,0,-71000,0,0,0,15000,86000,-71000,-71000
06943P,致茂元富98售03  ,0,0,0,0,0,0,0,0,0,-71000,0,0,0,36000,107000,-71000,-71000
2888A,新光金甲特      ,0,18000,-18000,0,0,0,0,0,0,-53000,0,53000,-53000,0,0,0,-71000
058468,聯茂中信99購02  ,0,0,0,0,0,0,0,0,0,-72000,0,0,0,55000,127000,-72000,-72000
058244,神達元大99購02  ,0,0,0,0,0,0,0,0,0,-72000,0,0,0,32000,104000,-72000,-72000
052771,GIS群益96購01   ,0,0,0,0,0,0,0,0,0,-72000,0,0,0,0,72000,-72000,-72000
049024,玉晶光群益97購01,0,0,0,0,0,0,0,0,0,-72000,0,0,0,26000,98000,-72000,-72000
049139,台積電元大94購06,0,0,0,0,0,0,0,0,0,-72000,0,0,0,185000,257000,-72000,-72000
045837,群創群益98購02  ,0,0,0,0,0,0,0,0,0,-72000,0,0,0,18000,90000,-72000,-72000
050722,聯電國票96購01  ,0,0,0,0,0,0,0,0,0,-72000,0,0,0,37000,109000,-72000,-72000
052435,滬深2X富邦96購05,0,0,0,0,0,0,0,0,0,-72000,0,0,0,0,72000,-72000,-72000
051401,華新科永豐95購01,0,0,0,0,0,0,0,0,0,-72000,0,0,0,20000,92000,-72000,-72000
055351,聯發科凱基97購03,0,0,0,0,0,0,0,0,0,-72000,0,0,0,0,72000,-72000,-72000
055294,智易元大98購01  ,0,0,0,0,0,0,0,0,0,-72000,0,0,0,118000,190000,-72000,-72000
056268,新日興統一97購01,0,0,0,0,0,0,0,0,0,-72000,0,0,0,0,72000,-72000,-72000
055950,華新元大97購02  ,0,0,0,0,0,0,0,0,0,-72000,0,0,0,4000,76000,-72000,-72000
056053,和大元大97購05  ,0,0,0,0,0,0,0,0,0,-72000,0,0,0,0,72000,-72000,-72000
056061,國泰金元大97購02,0,0,0,0,0,0,0,0,0,-72000,0,0,0,68000,140000,-72000,-72000
054260,貿聯元大96購03  ,0,0,0,0,0,0,0,0,0,-72000,0,0,0,0,72000,-72000,-72000
054017,茂林永豐96購02  ,0,0,0,0,0,0,0,0,0,-72000,0,0,0,5000,77000,-72000,-72000
055014,達興元富97購01  ,0,0,0,0,0,0,0,0,0,-72000,0,0,0,2000,74000,-72000,-72000
058200,世芯康和99購01  ,0,0,0,0,0,0,0,0,0,-73000,0,0,0,30000,103000,-73000,-73000
057776,京元電群益98購02,0,0,0,0,0,0,0,0,0,-73000,0,0,0,23000,96000,-73000,-73000
058299,同欣電凱基9A購01,0,0,0,0,0,0,0,0,0,-73000,0,0,0,0,73000,-73000,-73000
056869,國巨日盛99購03  ,0,0,0,0,0,0,0,0,0,-73000,0,0,0,50000,123000,-73000,-73000
056752,國巨兆豐98購02  ,0,0,0,0,0,0,0,0,0,-73000,0,0,0,7000,80000,-73000,-73000
05670P,台積電國票98售01,0,0,0,0,0,0,0,0,0,-73000,0,0,0,77000,150000,-73000,-73000
056502,A50正2永豐98購01,0,0,0,0,0,0,0,0,0,-73000,0,0,0,27000,100000,-73000,-73000
044010,華通凱基93購01  ,0,0,0,0,0,0,0,0,0,-73000,0,0,0,0,73000,-73000,-73000
04628P,欣興元大95售01  ,0,0,0,0,0,0,0,0,0,-73000,0,0,0,17000,90000,-73000,-73000
048433,聯詠國票94購01  ,0,0,0,0,0,0,0,0,0,-73000,0,0,0,61000,134000,-73000,-73000
050320,台表科國票94購01,0,0,0,0,0,0,0,0,0,-73000,0,0,0,0,73000,-73000,-73000
051755,台積電元大96購08,0,0,0,0,0,0,0,0,0,-73000,0,0,0,74000,147000,-73000,-73000
053707,A50正2凱基99購02,0,0,0,0,0,0,0,0,0,-73000,0,0,0,10000,83000,-73000,-73000
054262,瀚宇博元大96購03,0,0,0,0,0,0,0,0,0,-73000,0,0,0,65000,138000,-73000,-73000
055313,南電群益97購01  ,0,0,0,0,0,0,0,0,0,-73000,0,0,0,142000,215000,-73000,-73000
055259,玉晶光統一9A購01,0,0,0,0,0,0,0,0,0,-73000,0,0,0,0,73000,-73000,-73000
3703,欣陸            ,202000,275000,-73000,0,0,0,0,0,0,0,0,0,0,0,0,0,-73000
07001P,國巨元大99售12  ,0,0,0,0,0,0,0,0,0,-73000,0,0,0,133000,206000,-73000,-73000
2534,宏盛            ,352200,417000,-64800,0,0,0,0,0,0,-9000,0,6000,-6000,0,3000,-3000,-73800
056608,力山永豐98購01  ,0,0,0,0,0,0,0,0,0,-74000,0,0,0,6000,80000,-74000,-74000
056818,正崴永豐98購01  ,0,0,0,0,0,0,0,0,0,-74000,0,0,0,10000,84000,-74000,-74000
057496,佐登元大98購02  ,0,0,0,0,0,0,0,0,0,-74000,0,0,0,0,74000,-74000,-74000
057796,鴻海兆豐99購03  ,0,0,0,0,0,0,0,0,0,-74000,0,0,0,0,74000,-74000,-74000
047145,鴻海群益95購01  ,0,0,0,0,0,0,0,0,0,-74000,0,0,0,45000,119000,-74000,-74000
053520,康友群益96購01  ,0,0,0,0,0,0,0,0,0,-74000,0,0,0,31000,105000,-74000,-74000
053591,大立光元大99購03,0,0,0,0,0,0,0,0,0,-74000,0,0,0,8000,82000,-74000,-74000
053639,禾伸堂永豐96購01,0,0,0,0,0,0,0,0,0,-74000,0,0,0,7000,81000,-74000,-74000
050288,台積電凱基94購32,0,0,0,0,0,0,0,0,0,-74000,0,0,0,0,74000,-74000,-74000
05542P,滬深2X元富96售01,0,0,0,0,0,0,0,0,0,-74000,0,0,0,0,74000,-74000,-74000
055496,高鐵元大97購02  ,0,0,0,0,0,0,0,0,0,-74000,0,0,0,0,74000,-74000,-74000
056410,康控國票99購01  ,0,0,0,0,0,0,0,0,0,-74000,0,0,0,22000,96000,-74000,-74000
054209,台積電國票97購08,0,0,0,0,0,0,0,0,0,-74000,0,0,0,0,74000,-74000,-74000
07017P,台灣50元富9B售02,0,0,0,0,0,0,0,0,0,-74000,0,0,0,0,74000,-74000,-74000
058088,鴻海元大9A購01  ,0,0,0,0,0,0,0,0,0,-75000,0,0,0,26000,101000,-75000,-75000
058728,SP黃豆永豐99購01,0,0,0,0,0,0,0,0,0,-75000,0,0,0,0,75000,-75000,-75000
057631,康控永豐98購02  ,0,0,0,0,0,0,0,0,0,-75000,0,0,0,93000,168000,-75000,-75000
057155,元油2X富邦9B購02,0,0,0,0,0,0,0,0,0,-75000,0,0,0,0,75000,-75000,-75000
057308,同欣電兆豐99購01,0,0,0,0,0,0,0,0,0,-75000,0,0,0,180000,255000,-75000,-75000
047063,漢唐凱基95購01  ,0,0,0,0,0,0,0,0,0,-75000,0,0,0,25000,100000,-75000,-75000
046791,台郡統一96購01  ,0,0,0,0,0,0,0,0,0,-75000,0,0,0,0,75000,-75000,-75000
04894P,世紀鋼元大94售02,0,0,0,0,0,0,0,0,0,-75000,0,0,0,0,75000,-75000,-75000
050234,國巨凱基94購10  ,0,0,0,0,0,0,0,0,0,-75000,0,0,0,26000,101000,-75000,-75000
051798,國巨永豐95購03  ,0,0,0,0,0,0,0,0,0,-75000,0,0,0,10000,85000,-75000,-75000
052983,國巨元大96購07  ,0,0,0,0,0,0,0,0,0,-75000,0,0,0,118000,193000,-75000,-75000
051590,玉晶光元大96購02,0,0,0,0,0,0,0,0,0,-75000,0,0,0,118000,193000,-75000,-75000
055067,禾聯碩永豐97購01,0,0,0,0,0,0,0,0,0,-75000,0,0,0,0,75000,-75000,-75000
056283,鴻海永豐97購03  ,0,0,0,0,0,0,0,0,0,-75000,0,0,0,0,75000,-75000,-75000
055834,國巨元大97購13  ,0,0,0,0,0,0,0,0,0,-75000,0,0,0,115000,190000,-75000,-75000
055787,聯茂凱基99購01  ,0,0,0,0,0,0,0,0,0,-75000,0,0,0,66000,141000,-75000,-75000
057206,立積元富98購01  ,0,0,0,0,0,0,0,0,0,-76000,0,0,0,104000,180000,-76000,-76000
057583,啟碁中信9A購01  ,0,0,0,0,0,0,0,0,0,-76000,0,0,0,0,76000,-76000,-76000
057586,台積電國票99購06,0,0,0,0,0,0,0,0,0,-76000,0,0,0,54000,130000,-76000,-76000
058706,聯鈞元大9C購01  ,0,0,0,0,0,0,0,0,0,-76000,0,0,0,0,76000,-76000,-76000
058617,南電元大99購01  ,0,0,0,0,0,0,0,0,0,-76000,0,0,0,24000,100000,-76000,-76000
058333,鴻海元富99購04  ,0,0,0,0,0,0,0,0,0,-76000,0,0,0,0,76000,-76000,-76000
057724,亞德客國泰99購01,0,0,0,0,0,0,0,0,0,-76000,0,0,0,66000,142000,-76000,-76000
049694,華新科元大95購06,0,0,0,0,0,0,0,0,0,-76000,0,0,0,201000,277000,-76000,-76000
051505,台積電元富95購05,0,0,0,0,0,0,0,0,0,-76000,0,0,0,172000,248000,-76000,-76000
052994,群創台新99購01  ,0,0,0,0,0,0,0,0,0,-76000,0,0,0,15000,91000,-76000,-76000
050779,超眾元大96購03  ,0,0,0,0,0,0,0,0,0,-76000,0,0,0,141000,217000,-76000,-76000
050893,鴻海元大96購03  ,0,0,0,0,0,0,0,0,0,-76000,0,0,0,202000,278000,-76000,-76000
056295,國巨元大97購16  ,0,0,0,0,0,0,0,0,0,-76000,0,0,0,2000,78000,-76000,-76000
056161,康控凱基98購02  ,0,0,0,0,0,0,0,0,0,-76000,0,0,0,116000,192000,-76000,-76000
054926,神達凱基98購01  ,0,0,0,0,0,0,0,0,0,-76000,0,0,0,43000,119000,-76000,-76000
054555,欣興凱基98購01  ,0,0,0,0,0,0,0,0,0,-76000,0,0,0,48000,124000,-76000,-76000
1710,東聯            ,375000,459000,-84000,0,0,0,0,0,0,8000,11000,3000,8000,0,0,0,-76000
06327P,台積電中信01售01,0,0,0,0,0,0,0,0,0,-76000,0,0,0,94000,170000,-76000,-76000
058063,旺宏中信98購04  ,0,0,0,0,0,0,0,0,0,-77000,0,0,0,20000,97000,-77000,-77000
058325,昇陽半永豐99購01,0,0,0,0,0,0,0,0,0,-77000,0,0,0,20000,97000,-77000,-77000
057064,華新科富邦9B購01,0,0,0,0,0,0,0,0,0,-77000,0,0,0,143000,220000,-77000,-77000
056469,國巨元大99購01  ,0,0,0,0,0,0,0,0,0,-77000,0,0,0,20000,97000,-77000,-77000
056534,京元電凱基98購01,0,0,0,0,0,0,0,0,0,-77000,0,0,0,34000,111000,-77000,-77000
04977P,力成凱基96售01  ,0,0,0,0,0,0,0,0,0,-77000,0,0,0,0,77000,-77000,-77000
048902,昇陽半國泰96購01,0,0,0,0,0,0,0,0,0,-77000,0,0,0,30000,107000,-77000,-77000
03413B,臺股指凱基94熊19,100000,200000,-100000,0,0,0,0,0,0,23000,0,0,0,756000,733000,23000,-77000
044965,大立光中信95購01,0,0,0,0,0,0,0,0,0,-77000,0,0,0,36000,113000,-77000,-77000
050250,台郡凱基94購03  ,0,0,0,0,0,0,0,0,0,-77000,0,0,0,20000,97000,-77000,-77000
053019,禾伸堂元富96購01,0,0,0,0,0,0,0,0,0,-77000,0,0,0,33000,110000,-77000,-77000
052712,旺宏凱基96購02  ,0,0,0,0,0,0,0,0,0,-77000,0,0,0,3000,80000,-77000,-77000
050433,華新科凱基94購11,0,0,0,0,0,0,0,0,0,-77000,0,0,0,1000,78000,-77000,-77000
054925,神達凱基97購01  ,0,0,0,0,0,0,0,0,0,-77000,0,0,0,75000,152000,-77000,-77000
054886,大毅統一97購01  ,0,0,0,0,0,0,0,0,0,-77000,0,0,0,13000,90000,-77000,-77000
054333,茂林永豐96購03  ,0,0,0,0,0,0,0,0,0,-77000,0,0,0,68000,145000,-77000,-77000
055186,正文統一97購01  ,0,0,0,0,0,0,0,0,0,-77000,0,0,0,48000,125000,-77000,-77000
056531,佳世達凱基98購01,0,0,0,0,0,0,0,0,0,-78000,0,0,0,11000,89000,-78000,-78000
056717,康友永豐98購01  ,0,0,0,0,0,0,0,0,0,-78000,0,0,0,10000,88000,-78000,-78000
056754,智易兆豐99購01  ,0,0,0,0,0,0,0,0,0,-78000,0,0,0,70000,148000,-78000,-78000
057132,華新科凱基98購05,0,0,0,0,0,0,0,0,0,-78000,0,0,0,15000,93000,-78000,-78000
057640,台積電元大98購16,0,0,0,0,0,0,0,0,0,-78000,0,0,0,32000,110000,-78000,-78000
057712,南亞科統一9A購01,0,0,0,0,0,0,0,0,0,-78000,0,0,0,0,78000,-78000,-78000
048758,美利達元富96購02,0,0,0,0,0,0,0,0,0,-78000,0,0,0,20000,98000,-78000,-78000
052823,創意永豐96購02  ,0,0,0,0,0,0,0,0,0,-78000,0,0,0,0,78000,-78000,-78000
049656,臺股指凱基94購17,0,0,0,0,0,0,0,0,0,-78000,0,0,0,0,78000,-78000,-78000
052172,致茂元大95購01  ,0,0,0,0,0,0,0,0,0,-78000,0,0,0,100000,178000,-78000,-78000
050367,鴻海元大94購20  ,0,0,0,0,0,0,0,0,0,-78000,0,0,0,37000,115000,-78000,-78000
051300,台光電凱基96購02,0,0,0,0,0,0,0,0,0,-78000,0,0,0,0,78000,-78000,-78000
053611,聯茂麥證96購01  ,0,0,0,53000,202000,-149000,0,0,0,-78000,0,0,0,125000,203000,-78000,-78000
055435,佳世達中信99購01,0,0,0,0,0,0,0,0,0,-78000,0,0,0,50000,128000,-78000,-78000
055470,南亞科凱基97購01,0,0,0,0,0,0,0,0,0,-78000,0,0,0,0,78000,-78000,-78000
055731,美律元富97購01  ,0,0,0,0,0,0,0,0,0,-78000,0,0,0,20000,98000,-78000,-78000
055647,義隆元富97購01  ,0,0,0,0,0,0,0,0,0,-78000,0,0,0,20000,98000,-78000,-78000
056321,創意群益98購02  ,0,0,0,0,0,0,0,0,0,-78000,0,0,0,20000,98000,-78000,-78000
053785,聯詠元大96購05  ,0,0,0,0,0,0,0,0,0,-78000,0,0,0,0,78000,-78000,-78000
054937,國巨元大97購03  ,0,0,0,0,0,0,0,0,0,-78000,0,0,0,69000,147000,-78000,-78000
055039,神達富邦99購01  ,0,0,0,0,0,0,0,0,0,-78000,0,0,0,3000,81000,-78000,-78000
054649,聯茂群益97購01  ,0,0,0,0,0,0,0,0,0,-78000,0,0,0,23000,101000,-78000,-78000
06347P,祥碩元富97售02  ,0,0,0,0,0,0,0,0,0,-78000,0,0,0,155000,233000,-78000,-78000
057941,聯電國票99購01  ,0,0,0,0,0,0,0,0,0,-79000,0,0,0,0,79000,-79000,-79000
057658,玉晶光兆豐99購02,0,0,0,0,0,0,0,0,0,-79000,0,0,0,6000,85000,-79000,-79000
057501,超眾群益98購04  ,0,0,0,0,0,0,0,0,0,-79000,0,0,0,28000,107000,-79000,-79000
057306,玉晶光兆豐99購01,0,0,0,0,0,0,0,0,0,-79000,0,0,0,5000,84000,-79000,-79000
057312,美律麥證98購01  ,0,0,0,20000,99000,-79000,0,0,0,-79000,0,0,0,20000,99000,-79000,-79000
057295,可成永豐98購02  ,0,0,0,0,0,0,0,0,0,-79000,0,0,0,88000,167000,-79000,-79000
049504,臺股指元大94購15,0,0,0,0,0,0,0,0,0,-79000,0,0,0,22000,101000,-79000,-79000
052674,智邦國泰98購01  ,0,0,0,0,0,0,0,0,0,-79000,0,0,0,40000,119000,-79000,-79000
049136,華通元大95購01  ,0,0,0,0,0,0,0,0,0,-79000,0,0,0,116000,195000,-79000,-79000
00710B,FH彭博高收益債  ,0,0,0,0,0,0,0,0,0,-79000,0,0,0,16000,95000,-79000,-79000
00662,富邦NASDAQ      ,2000,2000,0,0,0,0,0,0,0,-79000,0,0,0,122000,201000,-79000,-79000
052170,台積電元大95購20,0,0,0,0,0,0,0,0,0,-79000,0,0,0,0,79000,-79000,-79000
051402,玉晶光永豐95購04,0,0,0,0,0,0,0,0,0,-79000,0,0,0,2000,81000,-79000,-79000
053091,同欣電元大96購01,0,0,0,0,0,0,0,0,0,-79000,0,0,0,92000,171000,-79000,-79000
05298P,上銀元大95售03  ,0,0,0,0,0,0,0,0,0,-79000,0,0,0,111000,190000,-79000,-79000
053242,聯電國票96購04  ,0,0,0,0,0,0,0,0,0,-79000,0,0,0,10000,89000,-79000,-79000
050812,台積電凱基95購01,0,0,0,0,0,0,0,0,0,-79000,0,0,0,21000,100000,-79000,-79000
050724,國巨國票96購01  ,0,0,0,0,0,0,0,0,0,-79000,0,0,0,24000,103000,-79000,-79000
053923,亞光國票97購01  ,0,0,0,0,0,0,0,0,0,-79000,0,0,0,20000,99000,-79000,-79000
054001,康友群益96購02  ,0,0,0,0,0,0,0,0,0,-79000,0,0,0,41000,120000,-79000,-79000
056220,上証2X凱基99購01,0,0,0,0,0,0,0,0,0,-79000,0,0,0,20000,99000,-79000,-79000
056069,新日興元大97購03,0,0,0,0,0,0,0,0,0,-79000,0,0,0,51000,130000,-79000,-79000
055265,玉晶光永豐98購03,300000,0,300000,0,0,0,0,0,0,-379000,0,0,0,440000,819000,-379000,-79000
2419,仲琦            ,120000,199000,-79000,0,0,0,0,0,0,0,1000,1000,0,0,0,0,-79000
057815,信邦元大98購01  ,0,0,0,0,0,0,0,0,0,-80000,0,0,0,0,80000,-80000,-80000
058052,南電元大98購02  ,0,0,0,0,0,0,0,0,0,-80000,0,0,0,35000,115000,-80000,-80000
058232,聯發科元大99購05,0,0,0,0,0,0,0,0,0,-80000,0,0,0,177000,257000,-80000,-80000
044909,玉晶光凱基93購02,0,0,0,0,0,0,0,0,0,-80000,0,0,0,12000,92000,-80000,-80000
045994,康控富邦94購01  ,0,0,0,0,0,0,0,0,0,-80000,0,0,0,30000,110000,-80000,-80000
04733P,康控兆豐95售01  ,0,0,0,0,0,0,0,0,0,-80000,0,0,0,0,80000,-80000,-80000
049584,台積電元大96購04,0,0,0,0,0,0,0,0,0,-80000,0,0,0,176000,256000,-80000,-80000
048760,S&P反1凱基94購01,0,0,0,0,0,0,0,0,0,-80000,0,0,0,0,80000,-80000,-80000
048697,華新科國票94購06,0,0,0,0,0,0,0,0,0,-80000,0,0,0,157000,237000,-80000,-80000
049228,台塑富邦94購01  ,0,0,0,0,0,0,0,0,0,-80000,0,0,0,0,80000,-80000,-80000
049451,富邦金統一94購03,0,0,0,0,0,0,0,0,0,-80000,0,0,0,20000,100000,-80000,-80000
049795,華通元大96購02  ,0,0,0,0,0,0,0,0,0,-80000,0,0,0,40000,120000,-80000,-80000
049894,嘉聯益富邦98購01,0,0,0,0,0,0,0,0,0,-80000,0,0,0,0,80000,-80000,-80000
051461,聯詠國泰96購01  ,0,0,0,0,0,0,0,0,0,-80000,0,0,0,40000,120000,-80000,-80000
050097,可成國泰96購02  ,0,0,0,0,0,0,0,0,0,-80000,0,0,0,41000,121000,-80000,-80000
050458,台郡元大94購03  ,0,0,0,0,0,0,0,0,0,-80000,0,0,0,0,80000,-80000,-80000
052471,華固亞東95購01  ,0,0,0,0,0,0,0,0,0,-80000,0,0,0,0,80000,-80000,-80000
056153,華新科凱基97購02,0,0,0,0,0,0,0,0,0,-80000,0,0,0,20000,100000,-80000,-80000
056086,奇力新統一98購01,0,0,0,0,0,0,0,0,0,-80000,0,0,0,0,80000,-80000,-80000
056254,為升元富97購01  ,0,0,0,0,0,0,0,0,0,-80000,0,0,0,0,80000,-80000,-80000
054090,瑞昱群益97購01  ,0,0,0,0,0,0,0,0,0,-80000,0,0,0,0,80000,-80000,-80000
054154,智易國泰97購01  ,0,0,0,0,0,0,0,0,0,-80000,0,0,0,0,80000,-80000,-80000
054690,新興永豐97購01  ,0,0,0,0,0,0,0,0,0,-80000,0,0,0,0,80000,-80000,-80000
057979,華新科永豐98購03,0,0,0,0,0,0,0,0,0,-81000,0,0,0,2000,83000,-81000,-81000
06019P,緯穎凱基96售03  ,0,0,0,0,0,0,0,0,0,-81000,0,0,0,0,81000,-81000,-81000
057293,力成國泰99購01  ,0,0,0,0,0,0,0,0,0,-81000,0,0,0,50000,131000,-81000,-81000
057020,台積電凱基99購02,0,0,0,0,0,0,0,0,0,-81000,0,0,0,0,81000,-81000,-81000
056683,台積電統一98購05,0,0,0,0,0,0,0,0,0,-81000,0,0,0,0,81000,-81000,-81000
050006,華擎永豐94購03  ,0,0,0,0,0,0,0,0,0,-81000,0,0,0,1000,82000,-81000,-81000
048505,滬深2X群益99購03,0,0,0,0,0,0,0,0,0,-81000,0,0,0,0,81000,-81000,-81000
048872,玉晶光國票94購02,0,0,0,0,0,0,0,0,0,-81000,0,0,0,49000,130000,-81000,-81000
044439,南電元大93購01  ,0,0,0,0,0,0,0,0,0,-81000,0,0,0,10000,91000,-81000,-81000
053465,聯電元大96購05  ,0,0,0,0,0,0,0,0,0,-81000,0,0,0,20000,101000,-81000,-81000
053472,漢唐元大96購02  ,0,0,0,0,0,0,0,0,0,-81000,0,0,0,185000,266000,-81000,-81000
050150,國巨群益95購01  ,0,0,0,0,0,0,0,0,0,-81000,0,0,0,199000,280000,-81000,-81000
053154,聯詠元大96購01  ,0,0,0,0,0,0,0,0,0,-81000,0,0,0,95000,176000,-81000,-81000
051160,亞德客元大95購02,0,0,0,0,0,0,0,0,0,-81000,0,0,0,123000,204000,-81000,-81000
054666,強茂元富97購01  ,0,0,0,0,0,0,0,0,0,-81000,0,0,0,50000,131000,-81000,-81000
054999,玉晶光元富97購03,0,0,0,0,0,0,0,0,0,-81000,0,0,0,259000,340000,-81000,-81000
054210,台光電國票97購03,0,0,0,0,0,0,0,0,0,-81000,0,0,0,10000,91000,-81000,-81000
05405P,大立光群益95售04,0,0,0,0,0,0,0,0,0,-81000,0,0,0,19000,100000,-81000,-81000
056456,群創凱基9B購01  ,0,0,0,0,0,0,0,0,0,-82000,0,0,0,0,82000,-82000,-82000
057055,立積元大99購01  ,0,0,0,0,0,0,0,0,0,-82000,0,0,0,246000,328000,-82000,-82000
057537,聯茂元大98購04  ,0,0,0,0,0,0,0,0,0,-82000,0,0,0,0,82000,-82000,-82000
058720,旭富元富99購01  ,0,0,0,0,0,0,0,0,0,-82000,0,0,0,0,82000,-82000,-82000
058314,欣興富邦9B購01  ,0,0,0,0,0,0,0,0,0,-82000,0,0,0,10000,92000,-82000,-82000
057709,電子類群益98購01,0,0,0,0,0,0,0,0,0,-82000,0,0,0,144000,226000,-82000,-82000
050522,聯發科元大95購03,0,0,0,0,0,0,0,0,0,-82000,0,0,0,253000,335000,-82000,-82000
053149,京元電元大96購02,0,0,0,0,0,0,0,0,0,-82000,0,0,0,68000,150000,-82000,-82000
051911,大立光元大98購02,0,0,0,0,0,0,0,0,0,-82000,0,0,0,116000,198000,-82000,-82000
052377,景碩元大96購02  ,0,0,0,0,0,0,0,0,0,-82000,0,0,0,128000,210000,-82000,-82000
055886,上銀統一97購02  ,0,0,0,0,0,0,0,0,0,-82000,0,0,0,0,82000,-82000,-82000
2420,新巨            ,86000,168000,-82000,0,0,0,0,0,0,0,1000,1000,0,0,0,0,-82000
056485,同欣電元大98購01,0,0,0,0,0,0,0,0,0,-83000,0,0,0,170000,253000,-83000,-83000
057022,智邦凱基98購04  ,0,0,0,0,0,0,0,0,0,-83000,0,0,0,207000,290000,-83000,-83000
048850,聯電群益96購01  ,0,0,0,0,0,0,0,0,0,-83000,0,0,0,104000,187000,-83000,-83000
052795,健策兆豐97購01  ,0,0,0,0,0,0,0,0,0,-83000,0,0,0,9000,92000,-83000,-83000
052355,為升永豐95購02  ,0,0,0,0,0,0,0,0,0,-83000,0,0,0,0,83000,-83000,-83000
053326,瀚宇博台新96購01,0,0,0,0,0,0,0,0,0,-83000,0,0,0,0,83000,-83000,-83000
051704,智邦群益95購02  ,0,0,0,0,0,0,0,0,0,-83000,0,0,0,13000,96000,-83000,-83000
054304,台積電凱基96購23,0,0,0,0,0,0,0,0,0,-83000,0,0,0,0,83000,-83000,-83000
055153,台光電元大98購02,0,0,0,0,0,0,0,0,0,-83000,0,0,0,212000,295000,-83000,-83000
6715,嘉基            ,85000,38000,47000,0,0,0,0,109000,-109000,-21000,0,21000,-21000,0,0,0,-83000
06489P,台積電元富98售06,0,0,0,0,0,0,0,0,0,-83000,0,0,0,60000,143000,-83000,-83000
057617,國巨凱基99購06  ,0,0,0,0,0,0,0,0,0,-84000,0,0,0,6000,90000,-84000,-84000
057757,鴻海凱基98購13  ,0,0,0,0,0,0,0,0,0,-84000,0,0,0,271000,355000,-84000,-84000
057760,聯發科凱基98購18,0,0,0,0,0,0,0,0,0,-84000,0,0,0,17000,101000,-84000,-84000
057827,康友元大98購03  ,0,0,0,0,0,0,0,0,0,-84000,0,0,0,21000,105000,-84000,-84000
058134,信邦元大99購01  ,0,0,0,0,0,0,0,0,0,-84000,0,0,0,0,84000,-84000,-84000
049527,國巨中信95購01  ,0,0,0,0,0,0,0,0,0,-84000,0,0,0,40000,124000,-84000,-84000
052424,泰碩國票97購01  ,0,0,0,0,0,0,0,0,0,-84000,0,0,0,309000,393000,-84000,-84000
053600,同欣電元大96購04,0,0,0,0,0,0,0,0,0,-84000,0,0,0,318000,402000,-84000,-84000
053637,強茂永豐96購01  ,0,0,0,0,0,0,0,0,0,-84000,0,0,0,10000,94000,-84000,-84000
054956,宏盛元大97購01  ,0,0,0,0,0,0,0,0,0,-84000,0,0,0,0,84000,-84000,-84000
054520,健鼎元大96購02  ,0,0,0,0,0,0,0,0,0,-84000,0,0,0,7000,91000,-84000,-84000
053837,貿聯永豐96購02  ,0,0,0,0,0,0,0,0,0,-84000,0,0,0,13000,97000,-84000,-84000
055287,日電貿元大97購01,0,0,0,0,0,0,0,0,0,-84000,0,0,0,0,84000,-84000,-84000
055293,晶相光元大97購01,0,0,0,0,0,0,0,0,0,-84000,0,0,0,141000,225000,-84000,-84000
057846,神達永豐98購01  ,0,0,0,0,0,0,0,0,0,-85000,0,0,0,44000,129000,-85000,-85000
058485,智邦國票9A購01  ,0,0,0,0,0,0,0,0,0,-85000,0,0,0,10000,95000,-85000,-85000
057340,玉晶光元富98購04,0,0,0,0,0,0,0,0,0,-85000,0,0,0,0,85000,-85000,-85000
056463,台虹凱基98購02  ,0,0,0,0,0,0,0,0,0,-85000,0,0,0,54000,139000,-85000,-85000
045868,臺股指統一93購04,0,0,0,0,0,0,0,0,0,-85000,0,0,0,10000,95000,-85000,-85000
04287P,A50正2中信96售01,0,0,0,0,0,0,0,0,0,-85000,0,0,0,10000,95000,-85000,-85000
049437,可成國泰96購01  ,0,0,0,0,0,0,0,0,0,-85000,0,0,0,30000,115000,-85000,-85000
052205,台積電中信95購09,0,0,0,0,0,0,0,0,0,-85000,0,0,0,0,85000,-85000,-85000
051576,台積電元大97購02,0,0,0,0,0,0,0,0,0,-85000,0,0,0,1000,86000,-85000,-85000
051562,玉晶光國泰97購05,0,0,0,0,0,0,0,0,0,-85000,0,0,0,109000,194000,-85000,-85000
051053,台光電群益95購01,0,0,0,0,0,0,0,0,0,-85000,0,0,0,125000,210000,-85000,-85000
051064,鴻海國票95購01  ,0,0,0,0,0,0,0,0,0,-85000,0,0,0,220000,305000,-85000,-85000
055471,聯發科凱基97購04,0,0,0,0,0,0,0,0,0,-85000,0,0,0,15000,100000,-85000,-85000
055417,健策富邦98購02  ,0,0,0,0,0,0,0,0,0,-85000,0,0,0,52000,137000,-85000,-85000
054360,智邦凱基96購03  ,0,0,0,0,0,0,0,0,0,-85000,0,0,0,31000,116000,-85000,-85000
054540,泰鼎國票99購01  ,0,0,0,0,0,0,0,0,0,-85000,0,0,0,11000,96000,-85000,-85000
05506P,茂林凱基96售03  ,0,0,0,0,0,0,0,0,0,-85000,0,0,0,0,85000,-85000,-85000
06961P,台積電凱基99售05,0,0,0,0,0,0,0,0,0,-85000,0,0,0,25000,110000,-85000,-85000
057303,喬山兆豐99購01  ,0,0,0,0,0,0,0,0,0,-86000,0,0,0,123000,209000,-86000,-86000
052663,奇鋐國票97購01  ,0,0,0,0,0,0,0,0,0,-86000,0,0,0,20000,106000,-86000,-86000
051463,世芯國泰97購02  ,0,0,0,0,0,0,0,0,0,-86000,0,0,0,112000,198000,-86000,-86000
052523,奇力新元大97購01,0,0,0,0,0,0,0,0,0,-86000,0,0,0,5000,91000,-86000,-86000
054932,台肥元大97購01  ,0,0,0,0,0,0,0,0,0,-86000,0,0,0,82000,168000,-86000,-86000
054522,康友元大96購07  ,0,0,0,0,0,0,0,0,0,-86000,0,0,0,27000,113000,-86000,-86000
054443,樺漢台新96購02  ,0,0,0,0,0,0,0,0,0,-86000,0,0,0,117000,203000,-86000,-86000
055669,緯穎群益97購02  ,0,0,0,0,0,0,0,0,0,-86000,0,0,0,84000,170000,-86000,-86000
056072,群創元大97購01  ,0,0,0,0,0,0,0,0,0,-86000,0,0,0,105000,191000,-86000,-86000
056383,上銀國泰99購01  ,0,0,0,0,0,0,0,0,0,-86000,0,0,0,0,86000,-86000,-86000
06153P,健策元大97售04  ,0,0,0,0,0,0,0,0,0,-86000,0,0,0,466000,552000,-86000,-86000
4426,利勤            ,80000,166000,-86000,0,0,0,0,0,0,0,0,0,0,0,0,0,-86000
058022,樺漢凱基99購02  ,0,0,0,0,0,0,0,0,0,-87000,0,0,0,0,87000,-87000,-87000
058179,國巨國泰9B購02  ,0,0,0,0,0,0,0,0,0,-87000,0,0,0,55000,142000,-87000,-87000
047047,旺宏國票95購01  ,0,0,0,0,0,0,0,0,0,-87000,0,0,0,55000,142000,-87000,-87000
044927,聯詠國泰94購01  ,0,0,0,0,0,0,0,0,0,-87000,0,0,0,40000,127000,-87000,-87000
052519,旺宏元大95購05  ,0,0,0,0,0,0,0,0,0,-87000,0,0,0,298000,385000,-87000,-87000
052223,聯電凱基96購02  ,0,0,0,0,0,0,0,0,0,-87000,0,0,0,80000,167000,-87000,-87000
051363,矽創元大95購03  ,0,0,0,0,0,0,0,0,0,-87000,0,0,0,0,87000,-87000,-87000
050957,T50反1台新05購01,0,0,0,0,0,0,0,0,0,-87000,0,0,0,10000,97000,-87000,-87000
056382,道瓊反國泰9A購01,0,0,0,0,0,0,0,0,0,-87000,0,0,0,159000,246000,-87000,-87000
056248,康友群益97購04  ,0,0,0,0,0,0,0,0,0,-87000,0,0,0,18000,105000,-87000,-87000
05603P,聯發科元大96售09,0,0,0,0,0,0,0,0,0,-87000,0,0,0,22000,109000,-87000,-87000
055255,欣興統一97購02  ,0,0,0,0,0,0,0,0,0,-87000,0,0,0,26000,113000,-87000,-87000
054855,得力群益98購01  ,0,0,0,0,0,0,0,0,0,-87000,0,0,0,11000,98000,-87000,-87000
8210,勤誠            ,210000,285000,-75000,0,0,0,3000,0,3000,-15000,0,33000,-33000,25000,7000,18000,-87000
058058,大立光元富9B購02,0,0,0,0,0,0,0,0,0,-88000,0,0,0,0,88000,-88000,-88000
058456,京鼎永豐99購01  ,0,0,0,0,0,0,0,0,0,-88000,0,0,0,0,88000,-88000,-88000
058634,可成兆豐99購03  ,0,0,0,0,0,0,0,0,0,-88000,0,0,0,38000,126000,-88000,-88000
057091,華新科元富9A購01,0,0,0,0,0,0,0,0,0,-88000,0,0,0,106000,194000,-88000,-88000
057644,奇力新元大98購04,0,0,0,0,0,0,0,0,0,-88000,0,0,0,0,88000,-88000,-88000
057629,泰碩永豐98購02  ,0,0,0,0,0,0,0,0,0,-88000,0,0,0,46000,134000,-88000,-88000
057467,祥碩永豐98購04  ,0,0,0,0,0,0,0,0,0,-88000,0,0,0,114000,202000,-88000,-88000
057404,貿聯群益99購01  ,0,0,0,0,0,0,0,0,0,-88000,0,0,0,11000,99000,-88000,-88000
056497,GIS國泰99購01   ,0,0,0,0,0,0,0,0,0,-88000,0,0,0,10000,98000,-88000,-88000
056768,宏達電元大99購03,0,0,0,0,0,0,0,0,0,-88000,0,0,0,28000,116000,-88000,-88000
048192,華通元大96購01  ,0,0,0,0,0,0,0,0,0,-88000,0,0,0,201000,289000,-88000,-88000
052654,友達統一97購01  ,0,0,0,0,0,0,0,0,0,-88000,0,0,0,114000,202000,-88000,-88000
052657,友達元富96購01  ,0,0,0,0,0,0,0,0,0,-88000,0,0,0,20000,108000,-88000,-88000
052561,矽創國票97購01  ,0,0,0,0,0,0,0,0,0,-88000,0,0,0,20000,108000,-88000,-88000
049439,牧德國泰96購01  ,0,0,0,0,0,0,0,0,0,-88000,0,0,0,0,88000,-88000,-88000
049888,智邦國泰96購01  ,0,0,0,0,0,0,0,0,0,-88000,0,0,0,123000,211000,-88000,-88000
05020P,廣達中信95售01  ,0,0,0,0,0,0,0,0,0,-88000,0,0,0,113000,201000,-88000,-88000
052990,超眾元大97購01  ,0,0,0,0,0,0,0,0,0,-88000,0,0,0,38000,126000,-88000,-88000
053028,康控富邦98購01  ,0,0,0,0,0,0,0,0,0,-88000,0,0,0,0,88000,-88000,-88000
050879,樺漢統一95購02  ,0,0,0,0,0,0,0,0,0,-88000,0,0,0,33000,121000,-88000,-88000
055063,玉晶光永豐99購01,0,0,0,0,0,0,0,0,0,-88000,0,0,0,609000,697000,-88000,-88000
054677,智易台新98購02  ,0,0,0,0,0,0,0,0,0,-88000,0,0,0,0,88000,-88000,-88000
054819,裕民元大9A購01  ,0,0,0,0,0,0,0,0,0,-88000,0,0,0,4000,92000,-88000,-88000
06174P,國巨元大97售07  ,0,0,0,0,0,0,0,0,0,-88000,0,0,0,84000,172000,-88000,-88000
057013,聯發科麥證98購01,0,0,0,55000,144000,-89000,0,0,0,-89000,0,0,0,55000,144000,-89000,-89000
058023,南電凱基98購02  ,0,0,0,0,0,0,0,0,0,-89000,0,0,0,128000,217000,-89000,-89000
050024,旺宏元大94購09  ,0,0,0,0,0,0,0,0,0,-89000,0,0,0,16000,105000,-89000,-89000
00674R,元大S&P黃金反1  ,0,0,0,0,0,0,0,0,0,-89000,0,0,0,136000,225000,-89000,-89000
051109,美律統一95購02  ,0,0,0,0,0,0,0,0,0,-89000,0,0,0,1000,90000,-89000,-89000
053164,台光電群益96購02,0,0,0,0,0,0,0,0,0,-89000,0,0,0,4000,93000,-89000,-89000
052971,京元電群益98購01,0,0,0,0,0,0,0,0,0,-89000,0,0,0,0,89000,-89000,-89000
053324,康舒群益96購01  ,0,0,0,0,0,0,0,0,0,-89000,0,0,0,11000,100000,-89000,-89000
053392,致新元大96購01  ,0,0,0,0,0,0,0,0,0,-89000,0,0,0,137000,226000,-89000,-89000
053457,旺宏國泰98購03  ,0,0,0,0,0,0,0,0,0,-89000,0,0,0,25000,114000,-89000,-89000
054867,華航群益99購01  ,0,0,0,0,0,0,0,0,0,-89000,0,0,0,44000,133000,-89000,-89000
055603,超眾元大97購04  ,0,0,0,0,0,0,0,0,0,-89000,0,0,0,24000,113000,-89000,-89000
3048,益登            ,167000,256000,-89000,0,0,0,0,0,0,0,0,0,0,0,0,0,-89000
058037,台灣50元大9B購02,0,0,0,0,0,0,0,0,0,-90000,0,0,0,2000,92000,-90000,-90000
05944P,富邦金中信96售01,0,0,0,0,0,0,0,0,0,-90000,0,0,0,57000,147000,-90000,-90000
058463,宏達電兆豐99購02,0,0,0,0,0,0,0,0,0,-90000,0,0,0,0,90000,-90000,-90000
058339,康友元富99購02  ,0,0,0,0,0,0,0,0,0,-90000,0,0,0,65000,155000,-90000,-90000
047460,富邦金群益95購01,0,0,0,0,0,0,0,0,0,-90000,0,0,0,0,90000,-90000,-90000
049243,佳世達元富96購02,0,0,0,0,0,0,0,0,0,-90000,0,0,0,0,90000,-90000,-90000
049675,台光電國票95購01,0,0,0,0,0,0,0,0,0,-90000,0,0,0,0,90000,-90000,-90000
052570,華新科凱基96購06,0,0,0,0,0,0,0,0,0,-90000,0,0,0,25000,115000,-90000,-90000
052768,泰鼎群益96購01  ,0,0,0,0,0,0,0,0,0,-90000,0,0,0,61000,151000,-90000,-90000
048805,瀚宇博富邦95購01,0,0,0,0,0,0,0,0,0,-90000,0,0,0,10000,100000,-90000,-90000
053452,臺股指凱基97購01,0,0,0,0,0,0,0,0,0,-90000,0,0,0,0,90000,-90000,-90000
053589,宏達電元大97購02,0,0,0,0,0,0,0,0,0,-90000,0,0,0,10000,100000,-90000,-90000
052324,康友元大96購02  ,0,0,0,0,0,0,0,0,0,-90000,0,0,0,24000,114000,-90000,-90000
051596,超眾元大95購05  ,0,0,0,0,0,0,0,0,0,-90000,0,0,0,21000,111000,-90000,-90000
051072,強茂國票95購02  ,0,0,0,0,0,0,0,0,0,-90000,0,0,0,10000,100000,-90000,-90000
050947,聯發科群益95購01,0,0,0,0,0,0,0,0,0,-90000,0,0,0,0,90000,-90000,-90000
053221,彩晶凱基98購01  ,0,0,0,0,0,0,0,0,0,-90000,0,0,0,0,90000,-90000,-90000
050217,健策永豐94購03  ,0,0,0,0,0,0,0,0,0,-90000,0,0,0,0,90000,-90000,-90000
050647,聯發科凱基96購01,0,0,0,0,0,0,0,0,0,-90000,0,0,0,0,90000,-90000,-90000
050877,美律統一95購01  ,0,0,0,0,0,0,0,0,0,-90000,0,0,0,0,90000,-90000,-90000
055388,華通統一97購03  ,0,0,0,0,0,0,0,0,0,-90000,0,0,0,0,90000,-90000,-90000
055398,超眾統一97購03  ,0,0,0,0,0,0,0,0,0,-90000,0,0,0,46000,136000,-90000,-90000
055978,大立光統一98購05,0,0,0,0,0,0,0,0,0,-90000,0,0,0,148000,238000,-90000,-90000
055081,健鼎中信97購01  ,0,0,0,0,0,0,0,0,0,-90000,0,0,0,0,90000,-90000,-90000
054770,健策國票98購01  ,0,0,0,0,0,0,0,0,0,-90000,0,0,0,565000,655000,-90000,-90000
054558,劍麟群益99購01  ,0,0,0,0,0,0,0,0,0,-90000,0,0,0,0,90000,-90000,-90000
054293,健策元大98購02  ,0,0,0,0,0,0,0,0,0,-90000,0,0,0,231000,321000,-90000,-90000
07044P,台積電元大99售13,0,0,0,0,0,0,0,0,0,-90000,0,0,0,0,90000,-90000,-90000
058497,新日興群益9B購01,0,0,0,0,0,0,0,0,0,-91000,0,0,0,4000,95000,-91000,-91000
058265,奇力新永豐9A購01,0,0,0,0,0,0,0,0,0,-91000,0,0,0,0,91000,-91000,-91000
048972,晶豪科元大94購01,0,0,0,0,0,0,0,0,0,-91000,0,0,0,0,91000,-91000,-91000
052834,彩晶群益96購01  ,0,0,0,0,0,0,0,0,0,-91000,0,0,0,0,91000,-91000,-91000
049695,新光金元大9A購01,0,0,0,0,0,0,0,0,0,-91000,0,0,0,50000,141000,-91000,-91000
00683L,元大美元指數正2 ,0,0,0,0,0,0,0,0,0,-91000,0,0,0,12000,103000,-91000,-91000
00663L,國泰臺灣加權正2 ,0,0,0,0,0,0,0,0,0,-91000,0,0,0,33000,124000,-91000,-91000
046770,聯發科國泰94購01,0,0,0,0,0,0,0,0,0,-91000,0,0,0,17000,108000,-91000,-91000
050789,矽創國泰96購01  ,0,0,0,0,0,0,0,0,0,-91000,0,0,0,30000,121000,-91000,-91000
052963,智邦凱基96購02  ,0,0,0,0,0,0,0,0,0,-91000,0,0,0,86000,177000,-91000,-91000
051423,GIS國票97購01   ,0,0,0,0,0,0,0,0,0,-91000,0,0,0,0,91000,-91000,-91000
053686,台積電元大97購08,0,0,0,0,0,0,0,0,0,-91000,0,0,0,0,91000,-91000,-91000
055927,南亞科群益97購01,0,0,0,0,0,0,0,0,0,-91000,0,0,0,0,91000,-91000,-91000
056166,微星台新97購01  ,0,0,0,0,0,0,0,0,0,-91000,0,0,0,0,91000,-91000,-91000
06603P,立積統一99售01  ,0,0,0,0,0,0,0,0,0,-91000,0,0,0,96000,187000,-91000,-91000
056476,智原元大98購02  ,0,0,0,0,0,0,0,0,0,-92000,0,0,0,0,92000,-92000,-92000
056713,華擎永豐98購01  ,0,0,0,0,0,0,0,0,0,-92000,0,0,0,0,92000,-92000,-92000
057449,華新科元富99購02,0,0,0,0,0,0,0,0,0,-92000,0,0,0,20000,112000,-92000,-92000
057095,祥碩元富98購02  ,0,0,0,0,0,0,0,0,0,-92000,0,0,0,207000,299000,-92000,-92000
049780,智易統一94購02  ,0,0,0,0,0,0,0,0,0,-92000,0,0,0,8000,100000,-92000,-92000
048699,嘉晶國票95購01  ,0,0,0,0,0,0,0,0,0,-92000,0,0,0,10000,102000,-92000,-92000
053737,華新科麥證96購01,0,0,0,33000,125000,-92000,0,0,0,-92000,0,0,0,33000,125000,-92000,-92000
052173,廣達元大95購02  ,0,0,0,0,0,0,0,0,0,-92000,0,0,0,93000,185000,-92000,-92000
051830,健策元大97購01  ,0,0,0,0,0,0,0,0,0,-92000,0,0,0,62000,154000,-92000,-92000
053174,同欣電群益98購02,0,0,0,0,0,0,0,0,0,-92000,0,0,0,98000,190000,-92000,-92000
056435,台積電凱基98購09,0,0,0,0,0,0,0,0,0,-92000,0,0,0,230000,322000,-92000,-92000
054798,超眾群益97購01  ,0,0,0,0,0,0,0,0,0,-92000,0,0,0,8000,100000,-92000,-92000
057403,亞光群益98購04  ,0,0,0,0,0,0,0,0,0,-93000,0,0,0,27000,120000,-93000,-93000
049152,大立光元大95購06,0,0,0,0,0,0,0,0,0,-93000,0,0,0,2000,95000,-93000,-93000
047584,元金2X永豐95購01,0,0,0,0,0,0,0,0,0,-93000,0,0,0,0,93000,-93000,-93000
047623,世紀鋼凱基94購02,0,0,0,0,0,0,0,0,0,-93000,0,0,0,75000,168000,-93000,-93000
046878,康友國泰94購01  ,0,0,0,0,0,0,0,0,0,-93000,0,0,0,1000,94000,-93000,-93000
051451,世芯元大95購03  ,0,0,0,0,0,0,0,0,0,-93000,0,0,0,152000,245000,-93000,-93000
053451,致新凱基96購02  ,0,0,0,0,0,0,0,0,0,-93000,0,0,0,0,93000,-93000,-93000
5215,科嘉-KY         ,85000,81000,4000,0,0,0,0,97000,-97000,0,0,0,0,0,0,0,-93000
9924,福興            ,76000,169000,-93000,0,0,0,0,0,0,0,3000,3000,0,0,0,0,-93000
053410,啟碁兆豐96購01  ,0,0,0,0,0,0,0,0,0,-94000,0,0,0,0,94000,-94000,-94000
050809,鴻海凱基95購08  ,0,0,0,0,0,0,0,0,0,-94000,0,0,0,68000,162000,-94000,-94000
054629,華新科凱基98購01,0,0,0,0,0,0,0,0,0,-94000,0,0,0,96000,190000,-94000,-94000
054246,國巨元大96購12  ,0,0,0,0,0,0,0,0,0,-94000,0,0,0,234000,328000,-94000,-94000
054235,欣興群益96購06  ,0,0,0,0,0,0,0,0,0,-94000,0,0,0,15000,109000,-94000,-94000
9914,美利達          ,138000,211000,-73000,0,0,0,0,0,0,-21000,8000,33000,-25000,4000,0,4000,-94000
2608,嘉里大榮        ,161000,215000,-54000,0,0,0,8000,0,8000,-48000,6000,54000,-48000,0,0,0,-94000
06951P,台積電統一9B售02,0,0,0,0,0,0,0,0,0,-94000,0,0,0,4000,98000,-94000,-94000
1711,永光            ,268000,379000,-111000,0,0,0,0,0,0,17000,46000,29000,17000,0,0,0,-94000
057572,明泰永豐98購01  ,0,0,0,0,0,0,0,0,0,-95000,0,0,0,0,95000,-95000,-95000
057297,新日興永豐98購01,0,0,0,0,0,0,0,0,0,-95000,0,0,0,41000,136000,-95000,-95000
056932,T50反1元富98購01,0,0,0,0,0,0,0,0,0,-95000,0,0,0,100000,195000,-95000,-95000
058011,台虹國票99購01  ,0,0,0,0,0,0,0,0,0,-95000,0,0,0,15000,110000,-95000,-95000
058082,美律群益98購05  ,0,0,0,0,0,0,0,0,0,-95000,0,0,0,16000,111000,-95000,-95000
058439,玉晶光統一01購02,0,0,0,0,0,0,0,0,0,-95000,0,0,0,1000,96000,-95000,-95000
050018,高股息元大94購02,0,0,0,0,0,0,0,0,0,-95000,0,0,0,0,95000,-95000,-95000
052979,上銀元大96購02  ,0,0,0,0,0,0,0,0,0,-95000,0,0,0,30000,125000,-95000,-95000
051324,康友國票96購01  ,0,0,0,0,0,0,0,0,0,-95000,0,0,0,56000,151000,-95000,-95000
051315,同欣電麥證95購01,0,0,0,55000,150000,-95000,0,0,0,-95000,0,0,0,55000,150000,-95000,-95000
051608,新日興群益96購01,0,0,0,0,0,0,0,0,0,-95000,0,0,0,49000,144000,-95000,-95000
055308,聯發科群益97購04,0,0,0,0,0,0,0,0,0,-95000,0,0,0,55000,150000,-95000,-95000
055586,旺宏元大98購06  ,0,0,0,0,0,0,0,0,0,-95000,0,0,0,68000,163000,-95000,-95000
055477,同欣電凱基98購01,0,0,0,0,0,0,0,0,0,-95000,0,0,0,102000,197000,-95000,-95000
06181P,國巨中信97售02  ,0,0,0,0,0,0,0,0,0,-95000,0,0,0,90000,185000,-95000,-95000
3380,明泰            ,644000,624000,20000,0,0,0,0,0,0,-115000,239000,402000,-163000,65000,17000,48000,-95000
6005,群益證          ,1432000,1578000,-146000,0,0,0,51000,0,51000,0,0,0,0,0,0,0,-95000
056791,嘉聯益群益98購01,0,0,0,0,0,0,0,0,0,-96000,0,0,0,31000,127000,-96000,-96000
049860,亞德客兆豐94購01,0,0,0,0,0,0,0,0,0,-96000,0,0,0,0,96000,-96000,-96000
052935,康友元大96購03  ,0,0,0,0,0,0,0,0,0,-96000,0,0,0,80000,176000,-96000,-96000
056198,台光電永豐97購02,0,0,0,0,0,0,0,0,0,-96000,0,0,0,12000,108000,-96000,-96000
1303,南亞            ,5067000,5204000,-137000,0,0,0,36000,0,36000,5000,61000,57000,4000,1000,0,1000,-96000
057558,致新凱基98購01  ,0,0,0,0,0,0,0,0,0,-97000,0,0,0,75000,172000,-97000,-97000
058450,旺宏永豐99購01  ,0,0,0,0,0,0,0,0,0,-97000,0,0,0,25000,122000,-97000,-97000
058569,健策凱基9A購01  ,0,0,0,0,0,0,0,0,0,-97000,0,0,0,0,97000,-97000,-97000
06055P,華通凱基97售04  ,0,0,0,0,0,0,0,0,0,-97000,0,0,0,5000,102000,-97000,-97000
058604,華邦電元大99購03,0,0,0,0,0,0,0,0,0,-97000,0,0,0,0,97000,-97000,-97000
058036,南電永豐98購01  ,0,0,0,0,0,0,0,0,0,-97000,0,0,0,2000,99000,-97000,-97000
057837,康控國泰99購02  ,0,0,0,0,0,0,0,0,0,-97000,0,0,0,63000,160000,-97000,-97000
049434,茂林國票95購01  ,0,0,0,0,0,0,0,0,0,-97000,0,0,0,1000,98000,-97000,-97000
043641,深中小國票94購01,0,0,0,0,0,0,0,0,0,-97000,0,0,0,53000,150000,-97000,-97000
045087,玉晶光元大95購01,0,0,0,0,0,0,0,0,0,-97000,0,0,0,21000,118000,-97000,-97000
049270,台表科元大95購02,0,0,0,0,0,0,0,0,0,-97000,0,0,0,10000,107000,-97000,-97000
00757,統一FANG+       ,0,0,0,0,0,0,0,0,0,-97000,0,0,0,234000,331000,-97000,-97000
053013,台積電統一97購01,0,0,0,0,0,0,0,0,0,-97000,0,0,0,0,97000,-97000,-97000
2464,盟立            ,278000,400000,-122000,0,0,0,0,0,0,25000,30000,0,30000,0,5000,-5000,-97000
057832,聯發科元富02購05,0,0,0,0,0,0,0,0,0,-98000,0,0,0,0,98000,-98000,-98000
057729,華新科國泰99購04,0,0,0,0,0,0,0,0,0,-98000,0,0,0,0,98000,-98000,-98000
058272,超眾永豐9A購01  ,0,0,0,0,0,0,0,0,0,-98000,0,0,0,4000,102000,-98000,-98000
058250,台虹元大99購01  ,0,0,0,0,0,0,0,0,0,-98000,0,0,0,0,98000,-98000,-98000
058632,世紀鋼國票9A購01,0,0,0,0,0,0,0,0,0,-98000,0,0,0,0,98000,-98000,-98000
057311,玉晶光日盛9A購01,0,0,0,0,0,0,0,0,0,-98000,0,0,0,54000,152000,-98000,-98000
056784,南亞科群益98購01,0,0,0,0,0,0,0,0,0,-98000,0,0,0,0,98000,-98000,-98000
057000,亞德客國票99購01,0,0,0,0,0,0,0,0,0,-98000,0,0,0,1000,99000,-98000,-98000
056693,國產群益98購01  ,0,0,0,0,0,0,0,0,0,-98000,0,0,0,11000,109000,-98000,-98000
056478,晶技元大99購01  ,0,0,0,0,0,0,0,0,0,-98000,0,0,0,78000,176000,-98000,-98000
049257,南亞科元大94購03,0,0,0,0,0,0,0,0,0,-98000,0,0,0,0,98000,-98000,-98000
052896,宏達電群益96購01,0,0,0,0,0,0,0,0,0,-98000,0,0,0,83000,181000,-98000,-98000
052827,昇陽半永豐97購01,0,0,0,0,0,0,0,0,0,-98000,0,0,0,0,98000,-98000,-98000
048987,崇越元大94購01  ,0,0,0,0,0,0,0,0,0,-98000,0,0,0,0,98000,-98000,-98000
048638,台光電元大94購01,0,0,0,0,0,0,0,0,0,-98000,0,0,0,0,98000,-98000,-98000
048622,南電凱基93購07  ,0,0,0,0,0,0,0,0,0,-98000,0,0,0,30000,128000,-98000,-98000
048782,亞泥元大94購01  ,0,0,0,0,0,0,0,0,0,-98000,0,0,0,0,98000,-98000,-98000
053093,緯穎元大96購06  ,0,0,0,0,0,0,0,0,0,-98000,0,0,0,82000,180000,-98000,-98000
051000,台郡元大96購01  ,0,0,0,0,0,0,0,0,0,-98000,0,0,0,197000,295000,-98000,-98000
051560,玉晶光國泰97購03,0,0,0,0,0,0,0,0,0,-98000,0,0,0,116000,214000,-98000,-98000
051381,玉晶光群益98購01,0,0,0,0,0,0,0,0,0,-98000,0,0,0,38000,136000,-98000,-98000
052341,泰鼎凱基96購02  ,0,0,0,0,0,0,0,0,0,-98000,0,0,0,12000,110000,-98000,-98000
055804,祥碩永豐97購02  ,0,0,0,0,0,0,0,0,0,-98000,0,0,0,0,98000,-98000,-98000
055485,國巨元大97購09  ,0,0,0,0,0,0,0,0,0,-98000,0,0,0,102000,200000,-98000,-98000
055596,新光金元大9B購02,0,0,0,0,0,0,0,0,0,-98000,0,0,0,104000,202000,-98000,-98000
055281,台光電元大98購03,0,0,0,0,0,0,0,0,0,-98000,0,0,0,0,98000,-98000,-98000
05522P,友達元富96售02  ,0,0,0,0,0,0,0,0,0,-98000,0,0,0,7000,105000,-98000,-98000
054785,建準群益98購01  ,0,0,0,0,0,0,0,0,0,-98000,0,0,0,0,98000,-98000,-98000
055032,億光富邦99購01  ,0,0,0,0,0,0,0,0,0,-98000,0,0,0,10000,108000,-98000,-98000
055151,台積電元大98購05,0,0,0,0,0,0,0,0,0,-98000,0,0,0,66000,164000,-98000,-98000
054994,建準元富97購01  ,0,0,0,0,0,0,0,0,0,-98000,0,0,0,0,98000,-98000,-98000
056744,麗豐凱基9A購01  ,0,0,0,0,0,0,0,0,0,-99000,0,0,0,5000,104000,-99000,-99000
057331,台積電國票99購04,0,0,0,0,0,0,0,0,0,-99000,0,0,0,39000,138000,-99000,-99000
057409,台虹群益98購02  ,0,0,0,0,0,0,0,0,0,-99000,0,0,0,30000,129000,-99000,-99000
058064,華邦電亞東99購01,0,0,0,0,0,0,0,0,0,-99000,0,0,0,3000,102000,-99000,-99000
049074,光罩凱基94購02  ,0,0,0,0,0,0,0,0,0,-99000,0,0,0,0,99000,-99000,-99000
049669,訊芯國泰95購01  ,0,0,0,0,0,0,0,0,0,-99000,0,0,0,164000,263000,-99000,-99000
049529,華新科中信95購01,0,0,0,0,0,0,0,0,0,-99000,0,0,0,445000,544000,-99000,-99000
048248,聯發科兆豐95購01,0,0,0,0,0,0,0,0,0,-99000,0,0,0,202000,301000,-99000,-99000
05347P,滬深2X元富9B售02,0,0,0,0,0,0,0,0,0,-99000,0,0,0,221000,320000,-99000,-99000
055125,智原兆豐97購01  ,0,0,0,0,0,0,0,0,0,-99000,0,0,0,0,99000,-99000,-99000
054188,欣興永豐96購03  ,0,0,0,0,0,0,0,0,0,-99000,0,0,0,47000,146000,-99000,-99000
054317,昇陽半凱基98購01,0,0,0,0,0,0,0,0,0,-99000,0,0,0,22000,121000,-99000,-99000
054462,旺宏凱基96購08  ,0,0,0,0,0,0,0,0,0,-99000,0,0,0,87000,186000,-99000,-99000
054405,樺漢康和96購01  ,0,0,0,0,0,0,0,0,0,-99000,0,0,0,0,99000,-99000,-99000
1439,中和            ,33000,132000,-99000,0,0,0,0,0,0,0,0,0,0,0,0,0,-99000
057725,台達電國泰9A購01,0,0,0,0,0,0,0,0,0,-100000,0,0,0,0,100000,-100000,-100000
057667,可成元大99購01  ,0,0,0,0,0,0,0,0,0,-100000,0,0,0,68000,168000,-100000,-100000
058611,欣興元大99購06  ,0,0,0,0,0,0,0,0,0,-100000,0,0,0,9000,109000,-100000,-100000
058312,大毅國泰9B購01  ,0,0,0,0,0,0,0,0,0,-100000,0,0,0,20000,120000,-100000,-100000
057487,聯發科元大98購10,0,0,0,0,0,0,0,0,0,-100000,0,0,0,334000,434000,-100000,-100000
057485,友達元大9C購04  ,0,0,0,0,0,0,0,0,0,-100000,0,0,0,0,100000,-100000,-100000
057578,可成中信99購01  ,0,0,0,0,0,0,0,0,0,-100000,0,0,0,0,100000,-100000,-100000
057519,元油2X元大98購14,0,0,0,0,0,0,0,0,0,-100000,0,0,0,0,100000,-100000,-100000
057627,和大永豐98購01  ,0,0,0,0,0,0,0,0,0,-100000,0,0,0,58000,158000,-100000,-100000
057237,群創凱基9B購02  ,0,0,0,0,0,0,0,0,0,-100000,0,0,0,100000,200000,-100000,-100000
057125,國巨凱基98購12  ,0,0,0,0,0,0,0,0,0,-100000,0,0,0,0,100000,-100000,-100000
056745,聯茂凱基99購03  ,0,0,0,0,0,0,0,0,0,-100000,0,0,0,2000,102000,-100000,-100000
056764,友達元大9A購03  ,0,0,0,0,0,0,0,0,0,-100000,0,0,0,8000,108000,-100000,-100000
048246,京元電兆豐93購02,0,0,0,0,0,0,0,0,0,-100000,0,0,0,0,100000,-100000,-100000
047483,新光金凱基99購04,0,0,0,0,0,0,0,0,0,-100000,0,0,0,0,100000,-100000,-100000
047360,鴻海群益95購02  ,0,0,0,0,0,0,0,0,0,-100000,0,0,0,0,100000,-100000,-100000
044639,京元電元富94購01,0,0,0,0,0,0,0,0,0,-100000,0,0,0,180000,280000,-100000,-100000
04376P,漢唐元大94售04  ,0,0,0,0,0,0,0,0,0,-100000,0,0,0,0,100000,-100000,-100000
044340,TPK統一93購01   ,0,0,0,0,0,0,0,0,0,-100000,0,0,0,0,100000,-100000,-100000
049817,南電元大94購07  ,0,0,0,0,0,0,0,0,0,-100000,0,0,0,0,100000,-100000,-100000
049936,柏文元大94購02  ,0,0,0,0,0,0,0,0,0,-100000,0,0,0,0,100000,-100000,-100000
049963,聯發科元富94購02,0,0,0,0,0,0,0,0,0,-100000,0,0,0,0,100000,-100000,-100000
04839P,大立光元大94售17,0,0,0,0,0,0,0,0,0,-100000,0,0,0,0,100000,-100000,-100000
049407,台積電日盛94購02,0,0,0,0,0,0,0,0,0,-100000,0,0,0,10000,110000,-100000,-100000
048558,漢唐元大93購06  ,0,0,0,0,0,0,0,0,0,-100000,0,0,0,0,100000,-100000,-100000
049497,茂林元大94購04  ,0,0,0,0,0,0,0,0,0,-100000,0,0,0,0,100000,-100000,-100000
047839,景碩元大93購03  ,0,0,0,0,0,0,0,0,0,-100000,0,0,0,0,100000,-100000,-100000
048756,志超元富96購02  ,0,0,0,0,0,0,0,0,0,-100000,0,0,0,0,100000,-100000,-100000
049207,茂林群益94購02  ,0,0,0,0,0,0,0,0,0,-100000,0,0,0,0,100000,-100000,-100000
052906,緯創國票97購01  ,0,0,0,0,0,0,0,0,0,-100000,0,0,0,15000,115000,-100000,-100000
052922,國巨永豐96購01  ,0,0,0,0,0,0,0,0,0,-100000,0,0,0,50000,150000,-100000,-100000
052569,聯發科凱基96購08,0,0,0,0,0,0,0,0,0,-100000,0,0,0,0,100000,-100000,-100000
053477,大立光元大97購03,0,0,0,0,0,0,0,0,0,-100000,0,0,0,0,100000,-100000,-100000
052394,滬深2X日盛95購01,0,0,0,0,0,0,0,0,0,-100000,0,0,0,100000,200000,-100000,-100000
052218,大立光日盛95購01,0,0,0,0,0,0,0,0,0,-100000,0,0,0,0,100000,-100000,-100000
052260,為升富邦97購02  ,0,0,0,0,0,0,0,0,0,-100000,0,0,0,60000,160000,-100000,-100000
052298,易華電國票96購01,0,0,0,0,0,0,0,0,0,-100000,0,0,0,0,100000,-100000,-100000
052454,力成元大95購02  ,0,0,0,0,0,0,0,0,0,-100000,0,0,0,17000,117000,-100000,-100000
053629,玉山金兆豐96購01,0,0,0,0,0,0,0,0,0,-100000,0,0,0,0,100000,-100000,-100000
051400,國巨永豐95購01  ,0,0,0,0,0,0,0,0,0,-100000,0,0,0,58000,158000,-100000,-100000
050432,聯發科凱基94購19,0,0,0,0,0,0,0,0,0,-100000,0,0,0,0,100000,-100000,-100000
050421,鴻海凱基95購04  ,0,0,0,0,0,0,0,0,0,-100000,0,0,0,400000,500000,-100000,-100000
052145,京元電群益95購02,0,0,0,0,0,0,0,0,0,-100000,0,0,0,0,100000,-100000,-100000
050364,卜蜂元大94購02  ,0,0,0,0,0,0,0,0,0,-100000,0,0,0,0,100000,-100000,-100000
051509,鴻海中信97購01  ,0,0,0,0,0,0,0,0,0,-100000,0,0,0,0,100000,-100000,-100000
051676,康舒元大95購01  ,0,0,0,0,0,0,0,0,0,-100000,0,0,0,128000,228000,-100000,-100000
052106,明泰兆豐95購01  ,0,0,0,0,0,0,0,0,0,-100000,0,0,0,0,100000,-100000,-100000
051691,台表科凱基95購01,0,0,0,0,0,0,0,0,0,-100000,0,0,0,0,100000,-100000,-100000
052985,美律元大96購02  ,0,0,0,0,0,0,0,0,0,-100000,0,0,0,0,100000,-100000,-100000
053006,玉晶光永豐96購03,0,0,0,0,0,0,0,0,0,-100000,0,0,0,40000,140000,-100000,-100000
053111,緯創兆豐97購01  ,0,0,0,0,0,0,0,0,0,-100000,0,0,0,0,100000,-100000,-100000
053161,康友元大96購04  ,0,0,0,0,0,0,0,0,0,-100000,0,0,0,0,100000,-100000,-100000
053138,華邦電富邦96購01,0,0,0,0,0,0,0,0,0,-100000,0,0,0,0,100000,-100000,-100000
051866,聯發科凱基96購05,0,0,0,0,0,0,0,0,0,-100000,0,0,0,88000,188000,-100000,-100000
050158,上海銀群益96購01,0,0,0,0,0,0,0,0,0,-100000,0,0,0,2000,102000,-100000,-100000
052715,可成凱基96購01  ,0,0,0,0,0,0,0,0,0,-100000,0,0,0,0,100000,-100000,-100000
050755,和大元富94購01  ,0,0,0,0,0,0,0,0,0,-100000,0,0,0,0,100000,-100000,-100000
050716,可成群益96購01  ,0,0,0,0,0,0,0,0,0,-100000,0,0,0,40000,140000,-100000,-100000
050537,鴻海凱基95購05  ,0,0,0,0,0,0,0,0,0,-100000,0,0,0,8000,108000,-100000,-100000
05430P,台積電統一95售07,0,0,0,0,0,0,0,0,0,-100000,0,0,0,25000,125000,-100000,-100000
054339,聯詠統一96購02  ,0,0,0,0,0,0,0,0,0,-100000,0,0,0,48000,148000,-100000,-100000
054341,燿華元富96購03  ,0,0,0,0,0,0,0,0,0,-100000,0,0,0,0,100000,-100000,-100000
054062,TPK國票96購02   ,0,0,0,0,0,0,0,0,0,-100000,0,0,0,0,100000,-100000,-100000
053968,華邦電元大97購01,0,0,0,0,0,0,0,0,0,-100000,0,0,0,0,100000,-100000,-100000
055086,華邦電亞東98購01,0,0,0,0,0,0,0,0,0,-100000,0,0,0,0,100000,-100000,-100000
054849,日月光兆豐97購01,0,0,0,0,0,0,0,0,0,-100000,0,0,0,0,100000,-100000,-100000
054889,京鼎統一99購01  ,0,0,0,0,0,0,0,0,0,-100000,0,0,0,0,100000,-100000,-100000
054814,台積電元大97購13,0,0,0,0,0,0,0,0,0,-100000,0,0,0,73000,173000,-100000,-100000
054638,國泰金中信99購01,0,0,0,0,0,0,0,0,0,-100000,0,0,0,98000,198000,-100000,-100000
055406,大毅國泰99購01  ,0,0,0,0,0,0,0,0,0,-100000,0,0,0,158000,258000,-100000,-100000
055421,玉晶光永豐98購04,0,0,0,0,0,0,0,0,0,-100000,0,0,0,10000,110000,-100000,-100000
055464,聚陽凱基97購01  ,0,0,0,0,0,0,0,0,0,-100000,0,0,0,0,100000,-100000,-100000
055566,台表科凱基97購03,0,0,0,0,0,0,0,0,0,-100000,0,0,0,0,100000,-100000,-100000
056144,GIS元大98購01   ,0,0,0,0,0,0,0,0,0,-100000,0,0,0,49000,149000,-100000,-100000
056146,台虹元大98購01  ,0,0,0,0,0,0,0,0,0,-100000,0,0,0,60000,160000,-100000,-100000
056232,瑞儀凱基98購01  ,0,0,0,0,0,0,0,0,0,-100000,0,0,0,0,100000,-100000,-100000
056163,嘉聯益凱基98購03,0,0,0,0,0,0,0,0,0,-100000,0,0,0,0,100000,-100000,-100000
056408,奇鋐國票99購01  ,0,0,0,0,0,0,0,0,0,-100000,0,0,0,0,100000,-100000,-100000
056345,嘉聯益凱基99購01,0,0,0,0,0,0,0,0,0,-100000,0,0,0,100000,200000,-100000,-100000
056335,微星凱基98購01  ,0,0,0,0,0,0,0,0,0,-100000,0,0,0,30000,130000,-100000,-100000
8341,日友            ,608000,711000,-103000,0,0,0,0,0,0,3000,3000,0,3000,0,0,0,-100000
056898,全新元大98購02  ,0,0,0,0,0,0,0,0,0,-101000,0,0,0,2000,103000,-101000,-101000
056658,美食元大98購01  ,0,0,0,0,0,0,0,0,0,-101000,0,0,0,104000,205000,-101000,-101000
056496,康控國泰99購01  ,0,0,0,0,0,0,0,0,0,-101000,0,0,0,105000,206000,-101000,-101000
057514,華新科元富99購03,0,0,0,0,0,0,0,0,0,-101000,0,0,0,14000,115000,-101000,-101000
05755P,臺股指中信99售04,0,0,0,0,0,0,0,0,0,-101000,0,0,0,42000,143000,-101000,-101000
058293,光寶科凱基9A購01,0,0,0,0,0,0,0,0,0,-101000,0,0,0,63000,164000,-101000,-101000
058665,台灣50群益9B購02,0,0,0,0,0,0,0,0,0,-101000,0,0,0,0,101000,-101000,-101000
052525,聯詠元大95購06  ,0,0,0,0,0,0,0,0,0,-101000,0,0,0,68000,169000,-101000,-101000
042994,葡萄王元大94購02,0,0,0,0,0,0,0,0,0,-101000,0,0,0,52000,153000,-101000,-101000
047439,漢唐元大95購01  ,0,0,0,0,0,0,0,0,0,-101000,0,0,0,0,101000,-101000,-101000
051950,旺宏元富95購02  ,0,0,0,0,0,0,0,0,0,-101000,0,0,0,2000,103000,-101000,-101000
053204,旺宏麥證96購01  ,0,0,0,20000,121000,-101000,0,0,0,-101000,0,0,0,20000,121000,-101000,-101000
051889,智邦元富95購02  ,0,0,0,0,0,0,0,0,0,-101000,0,0,0,180000,281000,-101000,-101000
053282,彩晶元大9C購01  ,0,0,0,0,0,0,0,0,0,-101000,0,0,0,3000,104000,-101000,-101000
056165,矽力凱基98購02  ,0,0,0,0,0,0,0,0,0,-101000,0,0,0,28000,129000,-101000,-101000
056015,華通群益99購01  ,0,0,0,0,0,0,0,0,0,-101000,0,0,0,30000,131000,-101000,-101000
055273,華泰元大97購01  ,0,0,0,0,0,0,0,0,0,-101000,0,0,0,0,101000,-101000,-101000
053886,亞光兆豐96購01  ,0,0,0,0,0,0,0,0,0,-101000,0,0,0,10000,111000,-101000,-101000
05982P,漢唐國票96售03  ,0,0,0,0,0,0,0,0,0,-102000,0,0,0,40000,142000,-102000,-102000
058581,大立光群益99購05,0,0,0,0,0,0,0,0,0,-102000,0,0,0,0,102000,-102000,-102000
058186,聯發科永豐99購01,0,0,0,0,0,0,0,0,0,-102000,0,0,0,168000,270000,-102000,-102000
057497,祥碩元大98購06  ,0,0,0,0,0,0,0,0,0,-102000,0,0,0,70000,172000,-102000,-102000
056498,A50正2富邦9B購01,0,0,0,0,0,0,0,0,0,-102000,0,0,0,5000,107000,-102000,-102000
053281,茂林元大96購02  ,0,0,0,0,0,0,0,0,0,-102000,0,0,0,129000,231000,-102000,-102000
053571,奇鋐統一96購02  ,0,0,0,0,0,0,0,0,0,-102000,0,0,0,0,102000,-102000,-102000
051751,聯茂富邦95購01  ,0,0,0,0,0,0,0,0,0,-102000,0,0,0,0,102000,-102000,-102000
050119,瀚宇博元大95購03,0,0,0,0,0,0,0,0,0,-102000,0,0,0,0,102000,-102000,-102000
051162,楠梓電元大95購01,0,0,0,0,0,0,0,0,0,-102000,0,0,0,0,102000,-102000,-102000
055365,華通元大97購03  ,0,0,0,0,0,0,0,0,0,-102000,0,0,0,32000,134000,-102000,-102000
06358P,力成中信97售02  ,0,0,0,0,0,0,0,0,0,-102000,0,0,0,118000,220000,-102000,-102000
06282P,聯鈞永豐97售02  ,0,0,0,0,0,0,0,0,0,-102000,0,0,0,23000,125000,-102000,-102000
056634,為升兆豐99購01  ,0,0,0,0,0,0,0,0,0,-103000,0,0,0,23000,126000,-103000,-103000
056775,康控元大99購01  ,0,0,0,0,0,0,0,0,0,-103000,0,0,0,40000,143000,-103000,-103000
057554,新日興凱基99購02,0,0,0,0,0,0,0,0,0,-103000,0,0,0,72000,175000,-103000,-103000
058171,國巨凱基9A購07  ,0,0,0,0,0,0,0,0,0,-103000,0,0,0,0,103000,-103000,-103000
047844,台虹元大93購02  ,0,0,0,0,0,0,0,0,0,-103000,0,0,0,0,103000,-103000,-103000
048422,瑞昱元富96購02  ,0,0,0,0,0,0,0,0,0,-103000,0,0,0,0,103000,-103000,-103000
050815,南亞科凱基95購01,0,0,0,0,0,0,0,0,0,-103000,0,0,0,0,103000,-103000,-103000
051618,智邦凱基95購06  ,0,0,0,0,0,0,0,0,0,-103000,0,0,0,0,103000,-103000,-103000
050442,復盛凱基94購01  ,0,0,0,0,0,0,0,0,0,-103000,0,0,0,177000,280000,-103000,-103000
053342,全新國票99購01  ,0,0,0,0,0,0,0,0,0,-103000,0,0,0,100000,203000,-103000,-103000
052224,楠梓電凱基97購01,0,0,0,0,0,0,0,0,0,-103000,0,0,0,2000,105000,-103000,-103000
057713,美律統一99購01  ,0,0,0,0,0,0,0,0,0,-104000,0,0,0,30000,134000,-104000,-104000
057802,卜蜂元大98購01  ,0,0,0,0,0,0,0,0,0,-104000,0,0,0,0,104000,-104000,-104000
057763,康控凱基99購02  ,0,0,0,0,0,0,0,0,0,-104000,0,0,0,0,104000,-104000,-104000
058309,大毅元大99購02  ,0,0,0,0,0,0,0,0,0,-104000,0,0,0,10000,114000,-104000,-104000
052467,嘉聯益統一96購01,0,0,0,0,0,0,0,0,0,-104000,0,0,0,75000,179000,-104000,-104000
053501,明泰兆豐96購01  ,0,0,0,0,0,0,0,0,0,-104000,0,0,0,0,104000,-104000,-104000
055176,大毅統一98購02  ,0,0,0,0,0,0,0,0,0,-104000,0,0,0,21000,125000,-104000,-104000
055202,神達群益97購01  ,0,0,0,0,0,0,0,0,0,-104000,0,0,0,71000,175000,-104000,-104000
05574P,英業達元富96售01,0,0,0,0,0,0,0,0,0,-104000,0,0,0,12000,116000,-104000,-104000
056162,祥碩凱基97購03  ,0,0,0,0,0,0,0,0,0,-104000,0,0,0,23000,127000,-104000,-104000
1734,杏輝            ,125000,230000,-105000,0,0,0,0,0,0,1000,1000,0,1000,0,0,0,-104000
058532,禾伸堂元富99購01,0,0,0,0,0,0,0,0,0,-105000,0,0,0,0,105000,-105000,-105000
057863,美律凱基9A購01  ,0,0,0,0,0,0,0,0,0,-105000,0,0,0,0,105000,-105000,-105000
058152,聯發科統一9B購02,0,0,0,0,0,0,0,0,0,-105000,0,0,0,0,105000,-105000,-105000
058006,台郡群益98購04  ,0,0,0,0,0,0,0,0,0,-105000,0,0,0,0,105000,-105000,-105000
057265,聯詠兆豐98購01  ,0,0,0,0,0,0,0,0,0,-105000,0,0,0,0,105000,-105000,-105000
056806,元油2X統一98購02,0,0,0,0,0,0,0,0,0,-105000,0,0,0,0,105000,-105000,-105000
057052,華擎元大98購01  ,0,0,0,0,0,0,0,0,0,-105000,0,0,0,59000,164000,-105000,-105000
049431,光罩國票96購01  ,0,0,0,0,0,0,0,0,0,-105000,0,0,0,10000,115000,-105000,-105000
052700,奇鋐國票97購02  ,0,0,0,0,0,0,0,0,0,-105000,0,0,0,0,105000,-105000,-105000
049570,華新科統一94購04,0,0,0,0,0,0,0,0,0,-105000,0,0,0,0,105000,-105000,-105000
044875,玉晶光統一93購01,0,0,0,0,0,0,0,0,0,-105000,0,0,0,0,105000,-105000,-105000
051640,GIS國票96購03   ,0,0,0,0,0,0,0,0,0,-105000,0,0,0,0,105000,-105000,-105000
050880,大立光元富95購03,0,0,0,0,0,0,0,0,0,-105000,0,0,0,16000,121000,-105000,-105000
051916,和碩元大95購02  ,0,0,0,0,0,0,0,0,0,-105000,0,0,0,15000,120000,-105000,-105000
056265,國泰金統一97購01,0,0,0,0,0,0,0,0,0,-105000,0,0,0,49000,154000,-105000,-105000
055960,義隆元大97購01  ,0,0,0,0,0,0,0,0,0,-105000,0,0,0,15000,120000,-105000,-105000
055230,大毅國票98購01  ,0,0,0,0,0,0,0,0,0,-105000,0,0,0,14000,119000,-105000,-105000
054356,可成兆豐97購01  ,0,0,0,0,0,0,0,0,0,-105000,0,0,0,0,105000,-105000,-105000
054559,台光電群益99購01,0,0,0,0,0,0,0,0,0,-105000,0,0,0,42000,147000,-105000,-105000
3702A,大聯大甲特      ,0,3000,-3000,0,0,0,0,0,0,-102000,8000,110000,-102000,0,0,0,-105000
2474,可成            ,1181000,1174000,7000,0,0,0,6000,122000,-116000,4000,85000,170000,-85000,110000,21000,89000,-105000
057568,友訊永豐99購01  ,0,0,0,0,0,0,0,0,0,-106000,0,0,0,10000,116000,-106000,-106000
046159,群創群益98購04  ,0,0,0,0,0,0,0,0,0,-106000,0,0,0,39000,145000,-106000,-106000
05253P,智邦凱基95售08  ,0,0,0,0,0,0,0,0,0,-106000,0,0,0,0,106000,-106000,-106000
049005,可成中信95購01  ,0,0,0,0,0,0,0,0,0,-106000,0,0,0,0,106000,-106000,-106000
049492,聯發科元大95購02,0,0,0,0,0,0,0,0,0,-106000,0,0,0,21000,127000,-106000,-106000
051045,南茂永豐95購01  ,0,0,0,0,0,0,0,0,0,-106000,0,0,0,25000,131000,-106000,-106000
053062,緯穎富邦97購01  ,0,0,0,0,0,0,0,0,0,-106000,0,0,0,118000,224000,-106000,-106000
053345,欣興國票97購02  ,0,0,0,0,0,0,0,0,0,-106000,0,0,0,4000,110000,-106000,-106000
054600,中壽台新97購01  ,0,0,0,0,0,0,0,0,0,-106000,0,0,0,170000,276000,-106000,-106000
055454,華邦電元富97購02,0,0,0,0,0,0,0,0,0,-106000,0,0,0,19000,125000,-106000,-106000
2107,厚生            ,211000,319450,-108450,0,0,0,0,0,0,2000,2000,0,2000,0,0,0,-106450
056501,貿聯富邦99購01  ,0,0,0,0,0,0,0,0,0,-107000,0,0,0,118000,225000,-107000,-107000
053365,彩晶國泰98購01  ,0,0,0,0,0,0,0,0,0,-107000,0,0,0,0,107000,-107000,-107000
050760,矽力元富94購03  ,0,0,0,0,0,0,0,0,0,-107000,0,0,0,10000,117000,-107000,-107000
054303,國巨凱基96購15  ,0,0,0,0,0,0,0,0,0,-107000,0,0,0,63000,170000,-107000,-107000
057606,健策統一98購03  ,0,0,0,0,0,0,0,0,0,-108000,0,0,0,0,108000,-108000,-108000
057699,可成群益9A購02  ,0,0,0,0,0,0,0,0,0,-108000,0,0,0,0,108000,-108000,-108000
058514,潤泰全元大99購01,0,0,0,0,0,0,0,0,0,-108000,0,0,0,65000,173000,-108000,-108000
048562,宏達電元大95購01,0,0,0,0,0,0,0,0,0,-108000,0,0,0,100000,208000,-108000,-108000
048572,美利達元大96購04,0,0,0,0,0,0,0,0,0,-108000,0,0,0,0,108000,-108000,-108000
048829,欣興凱基94購02  ,0,0,0,0,0,0,0,0,0,-108000,0,0,0,0,108000,-108000,-108000
052572,群創凱基99購01  ,0,0,0,0,0,0,0,0,0,-108000,0,0,0,10000,118000,-108000,-108000
051076,緯創國泰96購01  ,0,0,0,0,0,0,0,0,0,-108000,0,0,0,98000,206000,-108000,-108000
053394,鴻海中信9A購01  ,0,0,0,0,0,0,0,0,0,-108000,0,0,0,0,108000,-108000,-108000
053638,信邦永豐96購01  ,0,0,0,0,0,0,0,0,0,-108000,0,0,0,10000,118000,-108000,-108000
054439,健策台新96購03  ,0,0,0,0,0,0,0,0,0,-108000,0,0,0,101000,209000,-108000,-108000
054196,台光電國泰97購02,0,0,0,0,0,0,0,0,0,-108000,0,0,0,10000,118000,-108000,-108000
054274,智易中信96購02  ,0,0,0,0,0,0,0,0,0,-108000,0,0,0,0,108000,-108000,-108000
055405,華泰國泰98購01  ,0,0,0,0,0,0,0,0,0,-108000,0,0,0,0,108000,-108000,-108000
055524,鴻海群益98購01  ,0,0,0,0,0,0,0,0,0,-108000,0,0,0,297000,405000,-108000,-108000
057852,國巨國票99購05  ,0,0,0,0,0,0,0,0,0,-109000,0,0,0,11000,120000,-109000,-109000
057549,台光電凱基98購05,0,0,0,0,0,0,0,0,0,-109000,0,0,0,0,109000,-109000,-109000
057104,康友中信99購01  ,0,0,0,0,0,0,0,0,0,-109000,0,0,0,0,109000,-109000,-109000
056461,樺漢凱基98購02  ,0,0,0,0,0,0,0,0,0,-109000,0,0,0,15000,124000,-109000,-109000
049537,元石油群益97購01,0,0,0,0,0,0,0,0,0,-109000,0,0,0,590000,699000,-109000,-109000
052195,健策元富95購01  ,0,0,0,0,0,0,0,0,0,-109000,0,0,0,40000,149000,-109000,-109000
050493,聯發科永昌96購01,0,0,0,0,0,0,0,0,0,-109000,0,0,0,40000,149000,-109000,-109000
055683,晶技凱基99購01  ,0,0,0,0,0,0,0,0,0,-109000,0,0,0,14000,123000,-109000,-109000
056026,智易群益97購01  ,0,0,0,0,0,0,0,0,0,-109000,0,0,0,11000,120000,-109000,-109000
056056,旺宏元大97購06  ,0,0,0,0,0,0,0,0,0,-109000,0,0,0,71000,180000,-109000,-109000
053771,華新元大97購01  ,0,0,0,0,0,0,0,0,0,-109000,0,0,0,28000,137000,-109000,-109000
1473,台南            ,170000,280000,-110000,0,0,0,0,0,0,1000,1000,0,1000,0,0,0,-109000
8464,億豐            ,309000,427000,-118000,0,0,0,1000,0,1000,8000,12000,4000,8000,0,0,0,-109000
056951,牧德統一99購01  ,0,0,0,0,0,0,0,0,0,-110000,0,0,0,0,110000,-110000,-110000
058263,大成鋼永豐99購01,0,0,0,0,0,0,0,0,0,-110000,0,0,0,10000,120000,-110000,-110000
058525,台虹元大99購02  ,0,0,0,0,0,0,0,0,0,-110000,0,0,0,0,110000,-110000,-110000
058713,國巨統一9B購02  ,0,0,0,0,0,0,0,0,0,-110000,0,0,0,0,110000,-110000,-110000
052807,貿聯元大98購01  ,0,0,0,0,0,0,0,0,0,-110000,0,0,0,0,110000,-110000,-110000
051153,鴻海國泰97購02  ,0,0,0,0,0,0,0,0,0,-110000,0,0,0,0,110000,-110000,-110000
050513,亞泥元大94購02  ,0,0,0,0,0,0,0,0,0,-110000,0,0,0,33000,143000,-110000,-110000
053243,楠梓電國票97購02,0,0,0,0,0,0,0,0,0,-110000,0,0,0,0,110000,-110000,-110000
053092,台表科元大97購02,0,0,0,0,0,0,0,0,0,-110000,0,0,0,0,110000,-110000,-110000
053033,智易兆豐97購01  ,0,0,0,0,0,0,0,0,0,-110000,0,0,0,0,110000,-110000,-110000
050372,全新元大96購03  ,0,0,0,0,0,0,0,0,0,-110000,0,0,0,10000,120000,-110000,-110000
051687,大立光凱基95購12,0,0,0,0,0,0,0,0,0,-110000,0,0,0,80000,190000,-110000,-110000
055975,鴻海統一98購05  ,0,0,0,0,0,0,0,0,0,-110000,0,0,0,40000,150000,-110000,-110000
056206,泰鼎永豐97購01  ,0,0,0,0,0,0,0,0,0,-110000,0,0,0,29000,139000,-110000,-110000
055758,旺宏群益97購01  ,0,0,0,0,0,0,0,0,0,-110000,0,0,0,1285000,1395000,-110000,-110000
055529,華邦電群益97購02,0,0,0,0,0,0,0,0,0,-110000,0,0,0,0,110000,-110000,-110000
055399,超眾統一99購01  ,0,0,0,0,0,0,0,0,0,-110000,0,0,0,0,110000,-110000,-110000
055205,京鼎中信99購01  ,0,0,0,0,0,0,0,0,0,-110000,0,0,0,20000,130000,-110000,-110000
057897,華通富邦99購01  ,0,0,0,0,0,0,0,0,0,-111000,0,0,0,0,111000,-111000,-111000
056979,微星群益98購01  ,0,0,0,0,0,0,0,0,0,-111000,0,0,0,0,111000,-111000,-111000
057056,立積元大99購02  ,0,0,0,0,0,0,0,0,0,-111000,0,0,0,112000,223000,-111000,-111000
057524,旺宏元大99購04  ,0,0,0,0,0,0,0,0,0,-111000,0,0,0,29000,140000,-111000,-111000
050012,台積電國泰95購03,0,0,0,0,0,0,0,0,0,-111000,0,0,0,10000,121000,-111000,-111000
042317,台灣50永豐96購01,0,0,0,0,0,0,0,0,0,-111000,0,0,0,0,111000,-111000,-111000
051771,上銀中信95購01  ,0,0,0,0,0,0,0,0,0,-111000,0,0,0,172000,283000,-111000,-111000
051561,玉晶光國泰97購04,0,0,0,0,0,0,0,0,0,-111000,0,0,0,26000,137000,-111000,-111000
051425,昇陽半國票97購01,0,0,0,0,0,0,0,0,0,-111000,0,0,0,0,111000,-111000,-111000
053439,台積電凱基96購11,0,0,0,0,0,0,0,0,0,-111000,0,0,0,54000,165000,-111000,-111000
053575,聯詠元富96購01  ,0,0,0,0,0,0,0,0,0,-111000,0,0,0,130000,241000,-111000,-111000
052637,欣興凱基97購01  ,0,0,0,0,0,0,0,0,0,-111000,0,0,0,470000,581000,-111000,-111000
050750,上銀統一94購02  ,0,0,0,0,0,0,0,0,0,-111000,0,0,0,210000,321000,-111000,-111000
051231,健策群益97購01  ,0,0,0,0,0,0,0,0,0,-111000,0,0,0,103000,214000,-111000,-111000
055314,華邦電中信99購01,0,0,0,0,0,0,0,0,0,-111000,0,0,0,38000,149000,-111000,-111000
055355,大立光凱基97購05,0,0,0,0,0,0,0,0,0,-111000,0,0,0,0,111000,-111000,-111000
055520,矽力中信97購02  ,0,0,0,0,0,0,0,0,0,-111000,0,0,0,106000,217000,-111000,-111000
054098,嘉晶國票97購04  ,0,0,0,0,0,0,0,0,0,-111000,0,0,0,16000,127000,-111000,-111000
054781,台化群益99購01  ,0,0,0,0,0,0,0,0,0,-111000,0,0,0,11000,122000,-111000,-111000
056813,聯茂統一99購01  ,0,0,0,0,0,0,0,0,0,-112000,0,0,0,0,112000,-112000,-112000
058603,台積電元大99購12,0,0,0,0,0,0,0,0,0,-112000,0,0,0,264000,376000,-112000,-112000
058482,祥碩凱基99購02  ,0,0,0,0,0,0,0,0,0,-112000,0,0,0,35000,147000,-112000,-112000
058401,華航元大9A購01  ,0,0,0,0,0,0,0,0,0,-112000,0,0,0,0,112000,-112000,-112000
050684,台郡元富94購02  ,0,0,0,0,0,0,0,0,0,-112000,0,0,0,20000,132000,-112000,-112000
053008,達方永豐96購01  ,0,0,0,0,0,0,0,0,0,-112000,0,0,0,0,112000,-112000,-112000
050429,漢唐凱基94購04  ,0,0,0,0,0,0,0,0,0,-112000,0,0,0,23000,135000,-112000,-112000
051745,玉晶光國泰97購06,0,0,0,0,0,0,0,0,0,-112000,0,0,0,30000,142000,-112000,-112000
055379,牧德元大97購03  ,0,0,0,0,0,0,0,0,0,-112000,0,0,0,88000,200000,-112000,-112000
056120,聯茂群益97購02  ,0,0,0,0,0,0,0,0,0,-112000,0,0,0,33000,145000,-112000,-112000
057972,群創富邦9C購01  ,0,0,0,0,0,0,0,0,0,-113000,0,0,0,21000,134000,-113000,-113000
057663,國巨元大99購08  ,0,0,0,0,0,0,0,0,0,-113000,0,0,0,0,113000,-113000,-113000
057430,富邦金兆豐98購01,0,0,0,0,0,0,0,0,0,-113000,0,0,0,48000,161000,-113000,-113000
052006,康友富邦98購01  ,0,0,0,0,0,0,0,0,0,-113000,0,0,0,13000,126000,-113000,-113000
050782,台積電國泰96購03,0,0,0,0,0,0,0,0,0,-113000,0,0,0,56000,169000,-113000,-113000
056150,台光電凱基98購02,0,0,0,0,0,0,0,0,0,-113000,0,0,0,0,113000,-113000,-113000
056135,緯創元大98購01  ,0,0,0,0,0,0,0,0,0,-113000,0,0,0,2000,115000,-113000,-113000
055896,南電統一97購02  ,0,0,0,0,0,0,0,0,0,-113000,0,0,0,13000,126000,-113000,-113000
055516,上銀中信97購01  ,0,0,0,0,0,0,0,0,0,-113000,0,0,0,59000,172000,-113000,-113000
054027,欣興凱基96購04  ,0,0,0,0,0,0,0,0,0,-113000,0,0,0,0,113000,-113000,-113000
057885,台光電群益98購04,0,0,0,0,0,0,0,0,0,-114000,0,0,0,35000,149000,-114000,-114000
049157,矽創元大95購01  ,0,0,0,0,0,0,0,0,0,-114000,0,0,0,19000,133000,-114000,-114000
051928,大立光中信96購03,0,0,0,0,0,0,0,0,0,-114000,0,0,0,20000,134000,-114000,-114000
053168,晶技群益98購01  ,0,0,0,0,0,0,0,0,0,-114000,0,0,0,201000,315000,-114000,-114000
050991,元油2X元大96購04,0,0,0,0,0,0,0,0,0,-114000,0,0,0,0,114000,-114000,-114000
053985,矽創元大96購02  ,0,0,0,0,0,0,0,0,0,-114000,0,0,0,229000,343000,-114000,-114000
054337,智邦統一96購01  ,0,0,0,0,0,0,0,0,0,-114000,0,0,0,0,114000,-114000,-114000
054502,泰碩永豐96購01  ,0,0,0,0,0,0,0,0,0,-114000,0,0,0,36000,150000,-114000,-114000
055665,亞德客群益97購01,0,0,0,0,0,0,0,0,0,-114000,0,0,0,41000,155000,-114000,-114000
058190,貿聯永豐99購01  ,0,0,0,0,0,0,0,0,0,-115000,0,0,0,20000,135000,-115000,-115000
057394,台積電中信9C購02,0,0,0,0,0,0,0,0,0,-115000,0,0,0,130000,245000,-115000,-115000
057638,上銀元大99購01  ,0,0,0,0,0,0,0,0,0,-115000,0,0,0,90000,205000,-115000,-115000
057128,台光電凱基98購03,0,0,0,0,0,0,0,0,0,-115000,0,0,0,2000,117000,-115000,-115000
049040,亞光兆豐95購01  ,0,0,0,0,0,0,0,0,0,-115000,0,0,0,0,115000,-115000,-115000
048814,上銀凱基94購01  ,0,0,0,0,0,0,0,0,0,-115000,0,0,0,5000,120000,-115000,-115000
049803,華新科元大95購07,0,0,0,0,0,0,0,0,0,-115000,0,0,0,183000,298000,-115000,-115000
049255,旺宏元大97購02  ,0,0,0,0,0,0,0,0,0,-115000,0,0,0,73000,188000,-115000,-115000
044817,可成兆豐93購01  ,0,0,0,0,0,0,0,0,0,-115000,0,0,0,0,115000,-115000,-115000
046870,大立光統一95購01,0,0,0,0,0,0,0,0,0,-115000,0,0,0,28000,143000,-115000,-115000
050705,南電凱基96購01  ,0,0,0,0,0,0,0,0,0,-115000,0,0,0,40000,155000,-115000,-115000
050497,臺指反凱基96購02,0,0,0,0,0,0,0,0,0,-115000,0,0,0,30000,145000,-115000,-115000
051748,超眾國泰96購01  ,0,0,0,0,0,0,0,0,0,-115000,0,0,0,3000,118000,-115000,-115000
051592,健策元大96購05  ,0,0,0,0,0,0,0,0,0,-115000,0,0,0,50000,165000,-115000,-115000
052441,亞泥元大95購01  ,0,0,0,0,0,0,0,0,0,-115000,0,0,0,503000,618000,-115000,-115000
052422,聯電國票96購03  ,0,0,0,0,0,0,0,0,0,-115000,0,0,0,45000,160000,-115000,-115000
055888,鴻海統一97購04  ,0,0,0,0,0,0,0,0,0,-115000,0,0,0,0,115000,-115000,-115000
054368,鴻海中信9A購02  ,0,0,0,0,0,0,0,0,0,-115000,0,0,0,0,115000,-115000,-115000
1760,寶齡富錦        ,106000,224000,-118000,0,0,0,0,0,0,3000,3000,0,3000,0,0,0,-115000
057075,嘉聯益永豐98購01,0,0,0,0,0,0,0,0,0,-116000,0,0,0,0,116000,-116000,-116000
057116,鴻海日盛9A購01  ,0,0,0,0,0,0,0,0,0,-116000,0,0,0,54000,170000,-116000,-116000
057893,亞德客元富98購03,0,0,0,0,0,0,0,0,0,-116000,0,0,0,16000,132000,-116000,-116000
042168,台灣50凱基96購01,0,0,0,0,0,0,0,0,0,-116000,0,0,0,1000,117000,-116000,-116000
052455,樺漢元大96購03  ,0,0,0,0,0,0,0,0,0,-116000,0,0,0,0,116000,-116000,-116000
051685,台光電凱基95購01,0,0,0,0,0,0,0,0,0,-116000,0,0,0,0,116000,-116000,-116000
051524,貿聯凱基95購02  ,0,0,0,0,0,0,0,0,0,-116000,0,0,0,0,116000,-116000,-116000
051502,南茂群益95購01  ,0,0,0,0,0,0,0,0,0,-116000,0,0,0,0,116000,-116000,-116000
051031,康友元富95購02  ,0,0,0,0,0,0,0,0,0,-116000,0,0,0,58000,174000,-116000,-116000
051049,亞德客群益95購01,0,0,0,0,0,0,0,0,0,-116000,0,0,0,44000,160000,-116000,-116000
055157,晶豪科元大97購01,0,0,0,0,0,0,0,0,0,-116000,0,0,0,106000,222000,-116000,-116000
055132,台虹康和97購01  ,0,0,0,0,0,0,0,0,0,-116000,0,0,0,68000,184000,-116000,-116000
2023,燁輝            ,948000,1064000,-116000,0,0,0,0,0,0,0,0,0,0,0,0,0,-116000
06950P,鴻海統一9B售02  ,0,0,0,0,0,0,0,0,0,-116000,0,0,0,1000,117000,-116000,-116000
8016,矽創            ,392000,637000,-245000,0,0,0,20000,0,20000,109000,0,1000,-1000,131000,21000,110000,-116000
057978,聯發科永豐98購05,0,0,0,0,0,0,0,0,0,-117000,0,0,0,114000,231000,-117000,-117000
058636,亞光兆豐9A購01  ,0,0,0,0,0,0,0,0,0,-117000,0,0,0,0,117000,-117000,-117000
057114,台虹群益98購01  ,0,0,0,0,0,0,0,0,0,-117000,0,0,0,36000,153000,-117000,-117000
048798,華新科國泰95購01,0,0,0,0,0,0,0,0,0,-117000,0,0,0,39000,156000,-117000,-117000
051804,新光金日盛95購01,0,0,0,0,0,0,0,0,0,-117000,0,0,0,0,117000,-117000,-117000
051849,旺宏中信98購01  ,0,0,0,0,0,0,0,0,0,-117000,0,0,0,45000,162000,-117000,-117000
054989,精元元富97購01  ,0,0,0,0,0,0,0,0,0,-117000,0,0,0,0,117000,-117000,-117000
054285,國巨元大98購02  ,0,0,0,0,0,0,0,0,0,-117000,0,0,0,13000,130000,-117000,-117000
055968,祥碩元大97購04  ,0,0,0,0,0,0,0,0,0,-117000,0,0,0,15000,132000,-117000,-117000
055672,國巨日盛97購02  ,0,0,0,0,0,0,0,0,0,-117000,0,0,0,78000,195000,-117000,-117000
055591,全新元大98購01  ,0,0,0,0,0,0,0,0,0,-117000,0,0,0,0,117000,-117000,-117000
055235,金寶台新98購01  ,0,0,0,0,0,0,0,0,0,-117000,0,0,0,38000,155000,-117000,-117000
057357,超眾統一98購01  ,0,0,0,0,0,0,0,0,0,-118000,0,0,0,0,118000,-118000,-118000
056897,南亞科元大98購02,0,0,0,0,0,0,0,0,0,-118000,0,0,0,0,118000,-118000,-118000
057819,新日興元大99購01,0,0,0,0,0,0,0,0,0,-118000,0,0,0,6000,124000,-118000,-118000
052766,玉晶光群益9A購01,0,0,0,0,0,0,0,0,0,-118000,0,0,0,26000,144000,-118000,-118000
049272,世紀鋼元大96購02,0,0,0,0,0,0,0,0,0,-118000,0,0,0,360000,478000,-118000,-118000
048217,亞德客凱基93購06,0,0,0,0,0,0,0,0,0,-118000,0,0,0,10000,128000,-118000,-118000
050253,百和國泰96購01  ,0,0,0,0,0,0,0,0,0,-118000,0,0,0,0,118000,-118000,-118000
052186,宏達電群益95購04,0,0,0,0,0,0,0,0,0,-118000,0,0,0,6000,124000,-118000,-118000
052130,國巨凱基9B購01  ,0,0,0,0,0,0,0,0,0,-118000,0,0,0,119000,237000,-118000,-118000
052282,宏達電凱基95購05,0,0,0,0,0,0,0,0,0,-118000,0,0,0,112000,230000,-118000,-118000
055295,瀚宇博元大97購02,0,0,0,0,0,0,0,0,0,-118000,0,0,0,2000,120000,-118000,-118000
054457,強茂群益96購01  ,0,0,0,0,0,0,0,0,0,-118000,0,0,0,19000,137000,-118000,-118000
053780,南亞科元大96購03,0,0,0,0,0,0,0,0,0,-118000,0,0,0,0,118000,-118000,-118000
055119,力成凱基98購01  ,0,0,0,0,0,0,0,0,0,-118000,0,0,0,20000,138000,-118000,-118000
057218,可成群益99購03  ,0,0,0,0,0,0,0,0,0,-119000,0,0,0,11000,130000,-119000,-119000
046208,滬深2X元富95購03,0,0,0,0,0,0,0,0,0,-119000,0,0,0,11000,130000,-119000,-119000
046383,群創凱基98購01  ,0,0,0,0,0,0,0,0,0,-119000,0,0,0,7000,126000,-119000,-119000
052830,台光電群益96購01,0,0,0,0,0,0,0,0,0,-119000,0,0,0,81000,200000,-119000,-119000
048302,上証反凱基93購01,0,0,0,0,0,0,0,0,0,-119000,0,0,0,21000,140000,-119000,-119000
047962,T50反1中信96購02,0,10000,-10000,0,0,0,0,0,0,-109000,0,0,0,50000,159000,-109000,-119000
051776,上証2X群益99購01,0,0,0,0,0,0,0,0,0,-119000,0,0,0,0,119000,-119000,-119000
050939,健鼎國票96購01  ,0,0,0,0,0,0,0,0,0,-119000,0,0,0,30000,149000,-119000,-119000
051914,健策元大96購06  ,0,0,0,0,0,0,0,0,0,-119000,0,0,0,34000,153000,-119000,-119000
054330,世芯永豐96購02  ,0,0,0,0,0,0,0,0,0,-119000,0,0,0,90000,209000,-119000,-119000
054127,台積電元大96購21,0,0,0,0,0,0,0,0,0,-119000,0,0,0,354000,473000,-119000,-119000
4935,茂林-KY         ,1255000,734000,521000,0,0,0,0,347000,-347000,-293000,14000,413000,-399000,165000,59000,106000,-119000
05759P,智邦永豐96售02  ,0,0,0,0,0,0,0,0,0,-120000,0,0,0,10000,130000,-120000,-120000
056870,全新日盛9A購01  ,0,0,0,0,0,0,0,0,0,-120000,0,0,0,12000,132000,-120000,-120000
056834,華新元富99購01  ,0,0,0,0,0,0,0,0,0,-120000,0,0,0,70000,190000,-120000,-120000
056539,新光金凱基9A購01,0,0,0,0,0,0,0,0,0,-120000,0,0,0,10000,130000,-120000,-120000
056680,華通統一98購04  ,0,0,0,0,0,0,0,0,0,-120000,0,0,0,10000,130000,-120000,-120000
057860,金寶凱基98購01  ,0,0,0,0,0,0,0,0,0,-120000,0,0,0,0,120000,-120000,-120000
057786,聯發科國票98購05,0,0,0,0,0,0,0,0,0,-120000,0,0,0,98000,218000,-120000,-120000
058605,華邦電元大99購04,0,0,0,0,0,0,0,0,0,-120000,0,0,0,0,120000,-120000,-120000
06007P,世芯永豐96售01  ,0,0,0,0,0,0,0,0,0,-120000,0,0,0,50000,170000,-120000,-120000
049310,台積電凱基94購15,0,0,0,0,0,0,0,0,0,-120000,0,0,0,0,120000,-120000,-120000
045162,玉晶光國泰94購04,0,0,0,0,0,0,0,0,0,-120000,0,0,0,0,120000,-120000,-120000
051115,華通麥證96購01  ,0,0,0,0,120000,-120000,0,0,0,-120000,0,0,0,0,120000,-120000,-120000
051152,鴻海國泰97購01  ,0,0,0,0,0,0,0,0,0,-120000,0,0,0,60000,180000,-120000,-120000
050517,台積電元大94購27,0,0,0,0,0,0,0,0,0,-120000,0,0,0,0,120000,-120000,-120000
052481,利勤群益95購01  ,0,0,0,0,0,0,0,0,0,-120000,0,0,0,0,120000,-120000,-120000
053298,SP黃豆凱基99購01,0,0,0,0,0,0,0,0,0,-120000,0,0,0,0,120000,-120000,-120000
05336P,臺股指國票95售05,0,0,0,0,0,0,0,0,0,-120000,0,0,0,10000,130000,-120000,-120000
053350,台表科國票97購02,0,0,0,0,0,0,0,0,0,-120000,0,0,0,0,120000,-120000,-120000
054155,美律第一96購01  ,0,0,0,0,0,0,0,0,0,-120000,0,0,0,0,120000,-120000,-120000
054647,禾伸堂群益99購01,0,0,0,0,0,0,0,0,0,-120000,0,0,0,0,120000,-120000,-120000
054733,鴻海凱基98購04  ,0,0,0,0,0,0,0,0,0,-120000,0,0,0,0,120000,-120000,-120000
055231,大毅國票98購02  ,0,0,0,0,0,0,0,0,0,-120000,0,0,0,10000,130000,-120000,-120000
05562P,鴻海元大96售16  ,0,0,0,0,0,0,0,0,0,-120000,0,0,0,3000,123000,-120000,-120000
056292,統一元大97購01  ,0,0,0,0,0,0,0,0,0,-120000,0,0,0,24000,144000,-120000,-120000
057923,晶豪科凱基98購02,0,0,0,0,0,0,0,0,0,-121000,0,0,0,14000,135000,-121000,-121000
056628,矽創永豐98購01  ,0,0,0,0,0,0,0,0,0,-121000,0,0,0,130000,251000,-121000,-121000
052849,可成統一97購01  ,0,0,0,0,0,0,0,0,0,-121000,0,0,0,0,121000,-121000,-121000
053327,彩晶台新97購01  ,0,0,0,0,0,0,0,0,0,-121000,0,0,0,20000,141000,-121000,-121000
050445,鴻海元大94購21  ,0,0,0,0,0,0,0,0,0,-121000,0,0,0,349000,470000,-121000,-121000
056371,樺漢元大98購03  ,0,0,0,0,0,0,0,0,0,-121000,0,0,0,69000,190000,-121000,-121000
055305,旺宏群益99購01  ,0,0,0,0,0,0,0,0,0,-121000,0,0,0,0,121000,-121000,-121000
054863,億光群益97購01  ,0,0,0,0,0,0,0,0,0,-121000,0,0,0,11000,132000,-121000,-121000
4564,元翎            ,241000,312000,-71000,0,0,0,0,0,0,-50000,0,0,0,0,50000,-50000,-121000
057541,台灣50康和9A購04,0,0,0,0,0,0,0,0,0,-122000,0,0,0,75000,197000,-122000,-122000
058093,神達元大9A購01  ,0,0,0,0,0,0,0,0,0,-122000,0,0,0,100000,222000,-122000,-122000
049150,新光金元大96購01,0,0,0,0,0,0,0,0,0,-122000,0,0,0,0,122000,-122000,-122000
049855,台表科群益94購01,0,0,0,0,0,0,0,0,0,-122000,0,0,0,0,122000,-122000,-122000
051251,信邦元大95購01  ,0,0,0,0,0,0,0,0,0,-122000,0,0,0,0,122000,-122000,-122000
053573,臺股指統一99購01,0,0,0,0,0,0,0,0,0,-122000,0,0,0,4000,126000,-122000,-122000
05305P,華新科國泰97售01,0,0,0,0,0,0,0,0,0,-122000,0,0,0,328000,450000,-122000,-122000
051482,玉晶光凱基96購01,0,0,0,0,0,0,0,0,0,-122000,0,0,0,46000,168000,-122000,-122000
054277,亞光群益97購01  ,0,0,0,0,0,0,0,0,0,-122000,0,0,0,11000,133000,-122000,-122000
054419,嘉聯益元大98購02,0,0,0,0,0,0,0,0,0,-122000,0,0,0,0,122000,-122000,-122000
054031,中鋼中信98購01  ,0,0,0,0,0,0,0,0,0,-122000,0,0,0,10000,132000,-122000,-122000
055457,聚陽永豐97購01  ,0,0,0,0,0,0,0,0,0,-122000,0,0,0,0,122000,-122000,-122000
056391,大立光富邦9C購01,0,0,0,0,0,0,0,0,0,-122000,0,0,0,187000,309000,-122000,-122000
056426,上証2X凱基9A購01,0,0,0,0,0,0,0,0,0,-122000,0,0,0,9000,131000,-122000,-122000
057838,台郡國泰99購01  ,0,0,0,0,0,0,0,0,0,-123000,0,0,0,49000,172000,-123000,-123000
057258,中環兆豐98購01  ,0,0,0,0,0,0,0,0,0,-123000,0,0,0,0,123000,-123000,-123000
048989,矽格元大94購02  ,0,0,0,0,0,0,0,0,0,-123000,0,0,0,0,123000,-123000,-123000
045161,玉晶光國泰94購03,0,0,0,0,0,0,0,0,0,-123000,0,0,0,0,123000,-123000,-123000
049582,台積電元大95購03,0,0,0,0,0,0,0,0,0,-123000,0,0,0,258000,381000,-123000,-123000
1104,環泥            ,77000,200000,-123000,0,0,0,0,0,0,0,0,0,0,0,0,0,-123000
05751P,台積電中信96售05,0,0,0,0,0,0,0,0,0,-124000,0,0,0,14000,138000,-124000,-124000
057643,聯發科元大99購03,0,0,0,0,0,0,0,0,0,-124000,0,0,0,133000,257000,-124000,-124000
056655,旺宏元大99購02  ,0,0,0,0,0,0,0,0,0,-124000,0,0,0,29000,153000,-124000,-124000
056618,京元電永豐98購01,0,0,0,0,0,0,0,0,0,-124000,0,0,0,103000,227000,-124000,-124000
056546,致伸凱基98購01  ,0,0,0,0,0,0,0,0,0,-124000,0,0,0,33000,157000,-124000,-124000
057756,瑞昱日盛99購01  ,0,0,0,0,0,0,0,0,0,-124000,0,0,0,0,124000,-124000,-124000
058182,日電貿國泰9A購01,0,0,0,0,0,0,0,0,0,-124000,0,0,0,0,124000,-124000,-124000
047123,中石化中信95購01,0,0,0,0,0,0,0,0,0,-124000,0,0,0,10000,134000,-124000,-124000
051686,宏達電凱基95購04,0,0,0,0,0,0,0,0,0,-124000,0,0,0,0,124000,-124000,-124000
055965,泰鼎元大97購03  ,0,0,0,0,0,0,0,0,0,-124000,0,0,0,58000,182000,-124000,-124000
056134,可成元大97購06  ,0,0,0,0,0,0,0,0,0,-124000,0,0,0,117000,241000,-124000,-124000
055644,致茂元富97購01  ,0,0,0,0,0,0,0,0,0,-124000,0,0,0,16000,140000,-124000,-124000
06611P,祥碩國票98售01  ,0,0,0,0,0,0,0,0,0,-124000,0,0,0,183000,307000,-124000,-124000
058471,台積電日盛9C購01,0,0,0,0,0,0,0,0,0,-125000,0,0,0,0,125000,-125000,-125000
056636,台積電日盛9A購01,0,0,0,0,0,0,0,0,0,-125000,0,0,0,61000,186000,-125000,-125000
056923,奇力新兆豐99購02,0,0,0,0,0,0,0,0,0,-125000,0,0,0,0,125000,-125000,-125000
046905,新光金凱基99購01,0,0,0,0,0,0,0,0,0,-125000,0,0,0,0,125000,-125000,-125000
052560,康舒國票97購01  ,0,0,0,0,0,0,0,0,0,-125000,0,0,0,48000,173000,-125000,-125000
052142,滬深2X群益99購04,0,0,0,0,0,0,0,0,0,-125000,0,0,0,75000,200000,-125000,-125000
051382,玉晶光群益98購02,0,0,0,0,0,0,0,0,0,-125000,0,0,0,46000,171000,-125000,-125000
050836,緯穎凱基95購01  ,0,0,0,0,0,0,0,0,0,-125000,0,0,0,23000,148000,-125000,-125000
050214,嘉晶台新94購01  ,0,0,0,0,0,0,0,0,0,-125000,0,0,0,0,125000,-125000,-125000
053232,友達永豐97購02  ,0,0,0,0,0,0,0,0,0,-125000,0,0,0,0,125000,-125000,-125000
055546,台積電凱基97購12,0,0,0,0,0,0,0,0,0,-125000,0,0,0,0,125000,-125000,-125000
055322,欣興國票97購06  ,0,0,0,0,0,0,0,0,0,-125000,0,0,0,37000,162000,-125000,-125000
055200,和大群益98購01  ,0,0,0,0,0,0,0,0,0,-125000,0,0,0,16000,141000,-125000,-125000
054830,世芯國泰99購01  ,0,0,0,0,0,0,0,0,0,-125000,0,0,0,121000,246000,-125000,-125000
055113,大立光凱基98購06,0,0,0,0,0,0,0,0,0,-125000,0,0,0,115000,240000,-125000,-125000
056852,矽格元富98購01  ,0,0,0,0,0,0,0,0,0,-126000,0,0,0,43000,169000,-126000,-126000
057141,嘉聯益兆豐99購01,0,0,0,0,0,0,0,0,0,-126000,0,0,0,43000,169000,-126000,-126000
05718P,國巨元大96售09  ,0,0,0,0,0,0,0,0,0,-126000,0,0,0,141000,267000,-126000,-126000
054541,康控國票98購01  ,0,0,0,0,0,0,0,0,0,-126000,0,0,0,0,126000,-126000,-126000
055208,京鼎康和97購02  ,0,0,0,0,0,0,0,0,0,-126000,0,0,0,68000,194000,-126000,-126000
055332,奇力新兆豐98購01,0,0,0,0,0,0,0,0,0,-126000,0,0,0,0,126000,-126000,-126000
2362,藍天            ,139000,262000,-123000,0,0,0,0,0,0,-3000,7000,10000,-3000,0,0,0,-126000
057183,玉晶光元大99購07,0,0,0,0,0,0,0,0,0,-127000,0,0,0,64000,191000,-127000,-127000
053121,上証2X凱基9C購01,0,0,0,0,0,0,0,0,0,-127000,0,0,0,13000,140000,-127000,-127000
051488,健策凱基96購04  ,0,0,0,0,0,0,0,0,0,-127000,0,0,0,363000,490000,-127000,-127000
055570,華通統一98購03  ,0,0,0,0,0,0,0,0,0,-127000,0,0,0,165000,292000,-127000,-127000
056431,鴻海凱基98購07  ,0,0,0,0,0,0,0,0,0,-127000,0,0,0,107000,234000,-127000,-127000
05427P,聯發科凱基96售07,0,0,0,0,0,0,0,0,0,-127000,0,0,0,81000,208000,-127000,-127000
056893,智邦元大98購02  ,0,0,0,0,0,0,0,0,0,-128000,0,0,0,114000,242000,-128000,-128000
056939,康控元富98購01  ,0,0,0,0,0,0,0,0,0,-128000,0,0,0,47000,175000,-128000,-128000
05644P,大立光中信9A售03,0,0,0,0,0,0,0,0,0,-128000,0,0,0,40000,168000,-128000,-128000
05858P,矽力中信96售01  ,0,0,0,0,0,0,0,0,0,-128000,0,0,0,256000,384000,-128000,-128000
053706,S&P反1凱基99購01,0,0,0,0,0,0,0,0,0,-128000,0,0,0,20000,148000,-128000,-128000
056262,台積電統一98購04,0,0,0,0,0,0,0,0,0,-128000,0,0,0,103000,231000,-128000,-128000
05624P,同欣電中信98售01,0,0,0,0,0,0,0,0,0,-128000,0,0,0,94000,222000,-128000,-128000
055913,中信金凱基97購01,0,0,0,0,0,0,0,0,0,-128000,0,0,0,22000,150000,-128000,-128000
055484,華通元大97購04  ,0,0,0,0,0,0,0,0,0,-128000,0,0,0,55000,183000,-128000,-128000
055420,欣興永豐98購01  ,0,0,0,0,0,0,0,0,0,-128000,0,0,0,49000,177000,-128000,-128000
058472,亞德客凱基9A購01,0,0,0,0,0,0,0,0,0,-129000,0,0,0,26000,155000,-129000,-129000
058612,健策元大99購02  ,0,0,0,0,0,0,0,0,0,-129000,0,0,0,35000,164000,-129000,-129000
058184,鴻海永豐99購01  ,0,0,0,0,0,0,0,0,0,-129000,0,0,0,0,129000,-129000,-129000
043585,道瓊反元大94購01,0,0,0,0,0,0,0,0,0,-129000,0,0,0,0,129000,-129000,-129000
04327P,台積電國泰95售01,0,0,0,0,0,0,0,0,0,-129000,0,0,0,410000,539000,-129000,-129000
00652,富邦印度        ,1000,79000,-78000,0,0,0,0,0,0,-51000,0,0,0,2000,53000,-51000,-129000
055455,健策國泰98購02  ,0,0,0,0,0,0,0,0,0,-129000,0,0,0,10000,139000,-129000,-129000
058150,中502X統一9B購01,0,0,0,0,0,0,0,0,0,-130000,0,0,0,0,130000,-130000,-130000
058247,聯茂元大99購04  ,0,0,0,0,0,0,0,0,0,-130000,0,0,0,27000,157000,-130000,-130000
057678,臺股指元大98購08,0,0,0,0,0,0,0,0,0,-130000,0,0,0,0,130000,-130000,-130000
058661,臺股指中信9C購01,0,0,0,0,0,0,0,0,0,-130000,0,0,0,0,130000,-130000,-130000
058424,滬深2X元富99購04,0,0,0,0,0,0,0,0,0,-130000,0,0,0,40000,170000,-130000,-130000
056651,聯茂凱基98購04  ,0,0,0,0,0,0,0,0,0,-130000,0,0,0,15000,145000,-130000,-130000
056901,華新科元大98購03,0,0,0,0,0,0,0,0,0,-130000,0,0,0,5000,135000,-130000,-130000
057344,元油2X統一98購03,0,0,0,0,0,0,0,0,0,-130000,0,0,0,0,130000,-130000,-130000
057486,美律元大98購04  ,0,0,0,0,0,0,0,0,0,-130000,0,0,0,0,130000,-130000,-130000
047102,潤泰全富邦95購01,0,0,0,0,0,0,0,0,0,-130000,0,0,0,150000,280000,-130000,-130000
045444,群創元富98購02  ,0,0,0,0,0,0,0,0,0,-130000,0,0,0,0,130000,-130000,-130000
049283,滬深2X中信95購10,0,0,0,0,0,0,0,0,0,-130000,0,0,0,0,130000,-130000,-130000
047287,貿聯統一95購01  ,0,0,0,0,0,0,0,0,0,-130000,0,0,0,0,130000,-130000,-130000
052702,群創國票97購03  ,0,0,0,0,0,0,0,0,0,-130000,0,0,0,0,130000,-130000,-130000
052320,緯創元大95購05  ,0,0,0,0,0,0,0,0,0,-130000,0,0,0,70000,200000,-130000,-130000
052203,T50反1中信99購03,0,0,0,0,0,0,0,0,0,-130000,0,0,0,0,130000,-130000,-130000
053120,復盛中信9A購01  ,0,0,0,0,0,0,0,0,0,-130000,0,0,0,10000,140000,-130000,-130000
052595,奇力新群益96購01,0,0,0,0,0,0,0,0,0,-130000,0,0,0,0,130000,-130000,-130000
050984,大立光國泰97購01,0,0,0,0,0,0,0,0,0,-130000,0,0,0,52000,182000,-130000,-130000
052005,矽力國泰97購02  ,0,0,0,0,0,0,0,0,0,-130000,0,0,0,80000,210000,-130000,-130000
055385,昇陽半元大98購01,0,0,0,0,0,0,0,0,0,-130000,0,0,0,29000,159000,-130000,-130000
056326,TPK兆豐98購01   ,0,0,0,0,0,0,0,0,0,-130000,0,0,0,0,130000,-130000,-130000
054201,聯詠富邦97購02  ,0,0,0,0,0,0,0,0,0,-130000,0,0,0,0,130000,-130000,-130000
054185,喬山永豐96購02  ,0,0,0,0,0,0,0,0,0,-130000,0,0,0,22000,152000,-130000,-130000
054055,全新國票99購02  ,0,0,0,0,0,0,0,0,0,-130000,0,0,0,0,130000,-130000,-130000
2617,台航            ,148000,278000,-130000,0,0,0,0,0,0,0,0,0,0,0,0,0,-130000
057447,智邦元富02購01  ,0,0,0,0,0,0,0,0,0,-131000,0,0,0,5000,136000,-131000,-131000
056721,台灣50永昌9A購01,0,0,0,0,0,0,0,0,0,-131000,0,0,0,333000,464000,-131000,-131000
057734,訊芯國泰9A購01  ,0,0,0,0,0,0,0,0,0,-131000,0,0,0,5000,136000,-131000,-131000
049655,臺股指凱基94購16,0,0,0,0,0,0,0,0,0,-131000,0,0,0,0,131000,-131000,-131000
050459,台表科元大94購03,0,0,0,0,0,0,0,0,0,-131000,0,0,0,0,131000,-131000,-131000
054361,技嘉凱基96購01  ,0,0,0,0,0,0,0,0,0,-131000,0,0,0,72000,203000,-131000,-131000
055028,佐登國泰98購01  ,0,0,0,0,0,0,0,0,0,-131000,0,0,0,0,131000,-131000,-131000
056357,台積電元大9A購01,0,0,0,0,0,0,0,0,0,-131000,0,0,0,106000,237000,-131000,-131000
055206,台虹中信97購01  ,0,0,0,0,0,0,0,0,0,-131000,0,0,0,120000,251000,-131000,-131000
055595,宏達電元大98購02,0,0,0,0,0,0,0,0,0,-131000,0,0,0,25000,156000,-131000,-131000
057798,貿聯兆豐99購01  ,0,0,0,0,0,0,0,0,0,-132000,0,0,0,0,132000,-132000,-132000
058608,華新科元大99購13,0,0,0,0,0,0,0,0,0,-132000,0,0,0,15000,147000,-132000,-132000
056586,光罩統一98購02  ,0,0,0,0,0,0,0,0,0,-132000,0,0,0,10000,142000,-132000,-132000
057592,美律兆豐99購01  ,0,0,0,0,0,0,0,0,0,-132000,0,0,0,72000,204000,-132000,-132000
048583,智原富邦98購01  ,0,0,0,0,0,0,0,0,0,-132000,0,0,0,0,132000,-132000,-132000
045768,大立光元富95購02,0,0,0,0,0,0,0,0,0,-132000,0,0,0,58000,190000,-132000,-132000
052293,泰碩國票95購03  ,0,0,0,0,0,0,0,0,0,-132000,0,0,0,8000,140000,-132000,-132000
053509,華新群益98購01  ,0,0,0,0,0,0,0,0,0,-132000,0,0,0,118000,250000,-132000,-132000
050833,台郡凱基95購01  ,0,0,0,0,0,0,0,0,0,-132000,0,0,0,0,132000,-132000,-132000
051077,台郡國泰96購02  ,0,0,0,0,0,0,0,0,0,-132000,0,0,0,20000,152000,-132000,-132000
051063,台郡群益95購01  ,0,0,0,0,0,0,0,0,0,-132000,0,0,0,30000,162000,-132000,-132000
055729,金寶元富99購01  ,0,0,0,0,0,0,0,0,0,-132000,0,0,0,80000,212000,-132000,-132000
054924,景碩凱基98購01  ,0,0,0,0,0,0,0,0,0,-132000,0,0,0,18000,150000,-132000,-132000
054336,台積電統一96購11,0,0,0,0,0,0,0,0,0,-132000,0,0,0,192000,324000,-132000,-132000
9955,佳龍            ,84000,217000,-133000,0,0,0,0,0,0,1000,2000,1000,1000,0,0,0,-132000
06337P,祥碩元大97售05  ,0,0,0,0,0,0,0,0,0,-132000,0,0,0,91000,223000,-132000,-132000
056945,鴻海統一98購12  ,0,0,0,0,0,0,0,0,0,-133000,0,0,0,65000,198000,-133000,-133000
058427,大毅元富99購01  ,0,0,0,0,0,0,0,0,0,-133000,0,0,0,7000,140000,-133000,-133000
052184,台光電群益95購03,0,0,0,0,0,0,0,0,0,-133000,0,0,0,17000,150000,-133000,-133000
051774,聯茂中信96購01  ,0,0,0,0,0,0,0,0,0,-133000,0,0,0,52000,185000,-133000,-133000
053817,華新科群益97購02,0,0,0,0,0,0,0,0,0,-133000,0,0,0,16000,149000,-133000,-133000
05520P,聯詠凱基96售01  ,1000,0,1000,0,0,0,0,0,0,-134000,0,0,0,16000,150000,-134000,-133000
055397,超眾統一97購02  ,0,0,0,0,0,0,0,0,0,-133000,0,0,0,0,133000,-133000,-133000
056290,正文永豐98購01  ,0,0,0,0,0,0,0,0,0,-133000,0,0,0,37000,170000,-133000,-133000
05891P,聯發科中信98售03,0,0,0,0,0,0,0,0,0,-134000,0,0,0,20000,154000,-134000,-134000
057675,同欣電元大98購02,0,0,0,0,0,0,0,0,0,-134000,0,0,0,68000,202000,-134000,-134000
052080,康友元富98購02  ,0,0,0,0,0,0,0,0,0,-134000,0,0,0,0,134000,-134000,-134000
053347,茂林國票98購01  ,0,0,0,0,0,0,0,0,0,-134000,0,0,0,0,134000,-134000,-134000
053135,信邦國票96購01  ,0,0,0,0,0,0,0,0,0,-134000,0,0,0,3000,137000,-134000,-134000
050687,上銀日盛94購01  ,0,0,0,0,0,0,0,0,0,-134000,0,0,0,50000,184000,-134000,-134000
056329,上銀國票98購02  ,0,0,0,0,0,0,0,0,0,-134000,0,0,0,0,134000,-134000,-134000
055582,亞德客元大97購01,0,0,0,0,0,0,0,0,0,-134000,0,0,0,137000,271000,-134000,-134000
055123,億光兆豐97購01  ,0,0,0,0,0,0,0,0,0,-134000,0,0,0,0,134000,-134000,-134000
058649,健策永豐99購01  ,0,0,0,0,0,0,0,0,0,-135000,0,0,0,0,135000,-135000,-135000
057045,美律元大99購04  ,0,0,0,0,0,0,0,0,0,-135000,0,0,0,4000,139000,-135000,-135000
056447,聯發科凱基98購09,0,0,0,0,0,0,0,0,0,-135000,0,0,0,0,135000,-135000,-135000
056635,亞德客日盛99購01,0,0,0,0,0,0,0,0,0,-135000,0,0,0,22000,157000,-135000,-135000
057581,元大金中信9A購01,0,0,0,0,0,0,0,0,0,-135000,0,0,0,0,135000,-135000,-135000
047202,欣興元富96購01  ,0,0,0,0,0,0,0,0,0,-135000,0,0,0,5000,140000,-135000,-135000
048247,聯發科兆豐93購03,0,0,0,0,0,0,0,0,0,-135000,0,0,0,10000,145000,-135000,-135000
051085,鴻海元大95購03  ,0,0,0,0,0,0,0,0,0,-135000,0,0,0,10000,145000,-135000,-135000
053383,京元電元大97購01,0,0,0,0,0,0,0,0,0,-135000,0,0,0,8000,143000,-135000,-135000
052216,康友元大96購01  ,0,0,0,0,0,0,0,0,0,-135000,0,0,0,34000,169000,-135000,-135000
052482,茂林群益95購01  ,0,0,0,0,0,0,0,0,0,-135000,0,0,0,0,135000,-135000,-135000
05203P,華新科元大95售10,0,0,0,0,0,0,0,0,0,-135000,0,0,0,5000,140000,-135000,-135000
053993,旺宏群益98購02  ,0,0,0,0,0,0,0,0,0,-135000,0,0,0,118000,253000,-135000,-135000
05572P,群創統一96售02  ,0,0,0,0,0,0,0,0,0,-135000,0,0,0,7000,142000,-135000,-135000
2882,國泰金          ,12483987,13475884,-991897,0,0,0,14000,0,14000,842000,205000,28000,177000,735000,70000,665000,-135897
057410,南電群益98購01  ,0,0,0,0,0,0,0,0,0,-136000,0,0,0,114000,250000,-136000,-136000
057137,鈺齊凱基98購01  ,0,0,0,0,0,0,0,0,0,-136000,0,0,0,0,136000,-136000,-136000
05850P,台積電兆豐96售06,0,0,0,0,0,0,0,0,0,-136000,0,0,0,4000,140000,-136000,-136000
057740,茂林富邦9A購01  ,0,0,0,0,0,0,0,0,0,-136000,0,0,0,20000,156000,-136000,-136000
057910,華新科兆豐99購02,0,0,0,0,0,0,0,0,0,-136000,0,0,0,319000,455000,-136000,-136000
058214,世芯群益9A購01  ,0,0,0,0,0,0,0,0,0,-136000,0,0,0,17000,153000,-136000,-136000
058273,同欣電永豐99購01,0,0,0,0,0,0,0,0,0,-136000,0,0,0,0,136000,-136000,-136000
046855,嘉晶元大94購01  ,0,0,0,0,0,0,0,0,0,-136000,0,0,0,3000,139000,-136000,-136000
052777,燿華國票98購01  ,0,0,0,0,0,0,0,0,0,-136000,0,0,0,0,136000,-136000,-136000
051645,光寶科永豐95購01,0,0,0,0,0,0,0,0,0,-136000,0,0,0,44000,180000,-136000,-136000
051977,泰碩凱基95購01  ,0,0,0,0,0,0,0,0,0,-136000,0,0,0,80000,216000,-136000,-136000
053115,滬深2X中信97購01,0,0,0,0,0,0,0,0,0,-136000,0,0,0,45000,181000,-136000,-136000
054644,A50正2群益9B購01,0,0,0,0,0,0,0,0,0,-136000,0,0,0,120000,256000,-136000,-136000
054710,東元元富97購01  ,0,0,0,0,0,0,0,0,0,-136000,0,0,0,90000,226000,-136000,-136000
06053P,緯穎國票97售05  ,0,0,0,0,0,0,0,0,0,-137000,0,0,0,300000,437000,-137000,-137000
057450,國泰金元富98購01,0,0,0,0,0,0,0,0,0,-137000,0,0,0,85000,222000,-137000,-137000
057645,華新科元大99購11,0,0,0,0,0,0,0,0,0,-137000,0,0,0,73000,210000,-137000,-137000
053191,奇鋐統一96購01  ,0,0,0,0,0,0,0,0,0,-137000,0,0,0,0,137000,-137000,-137000
053408,友達兆豐98購01  ,0,0,0,0,0,0,0,0,0,-137000,0,0,0,0,137000,-137000,-137000
054404,新日興康和96購01,0,0,0,0,0,0,0,0,0,-137000,0,0,0,118000,255000,-137000,-137000
057625,泰鼎國泰9A購01  ,0,0,0,0,0,0,0,0,0,-138000,0,0,0,173000,311000,-138000,-138000
058391,T50反1元大99購02,0,0,0,0,0,0,0,0,0,-138000,0,0,0,0,138000,-138000,-138000
058361,美律凱基99購06  ,0,0,0,0,0,0,0,0,0,-138000,0,0,0,0,138000,-138000,-138000
1325,恆大            ,261000,399000,-138000,0,0,0,0,0,0,0,0,0,0,0,0,0,-138000
058155,牧德統一9A購01  ,0,0,0,0,0,0,0,0,0,-139000,0,0,0,18000,157000,-139000,-139000
057503,世紀鋼群益98購02,0,0,0,0,0,0,0,0,0,-139000,0,0,0,97000,236000,-139000,-139000
056614,智邦永豐98購01  ,0,0,0,0,0,0,0,0,0,-139000,0,0,0,0,139000,-139000,-139000
051999,勤誠元大95購01  ,0,0,0,0,0,0,0,0,0,-139000,0,0,0,165000,304000,-139000,-139000
1536,和大            ,1296000,849000,447000,0,0,0,0,582000,-582000,-4000,2000,5000,-3000,17000,18000,-1000,-139000
056448,全新凱基99購01  ,0,0,0,0,0,0,0,0,0,-140000,0,0,0,0,140000,-140000,-140000
058352,鴻海凱基9A購05  ,0,0,0,0,0,0,0,0,0,-140000,0,0,0,29000,169000,-140000,-140000
052528,茂林元大95購05  ,0,0,0,0,0,0,0,0,0,-140000,0,0,0,18000,158000,-140000,-140000
048705,GIS國票95購01   ,0,0,0,0,0,0,0,0,0,-140000,0,0,0,0,140000,-140000,-140000
052338,道瓊反凱基97購02,0,0,0,0,0,0,0,0,0,-140000,0,0,0,67000,207000,-140000,-140000
054024,中鋼康和96購01  ,0,0,0,0,0,0,0,0,0,-140000,0,0,0,0,140000,-140000,-140000
055394,健策統一97購01  ,0,0,0,0,0,0,0,0,0,-140000,0,0,0,0,140000,-140000,-140000
056377,智伸科統一9A購01,0,0,0,0,0,0,0,0,0,-140000,0,0,0,0,140000,-140000,-140000
055908,GIS日盛97購01   ,0,0,0,0,0,0,0,0,0,-140000,0,0,0,200000,340000,-140000,-140000
055994,聯發科國泰99購02,0,0,0,0,0,0,0,0,0,-140000,0,0,0,14000,154000,-140000,-140000
06418P,T50反1統一9A售02,0,0,0,0,0,0,0,0,0,-140000,0,0,0,110000,250000,-140000,-140000
057150,貿聯國票99購02  ,0,0,0,0,0,0,0,0,0,-141000,0,0,0,38000,179000,-141000,-141000
050558,台積電統一94購14,0,0,0,0,0,0,0,0,0,-141000,0,0,0,207000,348000,-141000,-141000
053153,大立光元大99購02,0,0,0,0,0,0,0,0,0,-141000,0,0,0,100000,241000,-141000,-141000
052602,聯電元大97購01  ,0,0,0,0,0,0,0,0,0,-141000,0,0,0,68000,209000,-141000,-141000
054539,欣興國票98購01  ,0,0,0,0,0,0,0,0,0,-141000,0,0,0,0,141000,-141000,-141000
054549,台積電凱基98購01,0,0,0,0,0,0,0,0,0,-141000,0,0,0,50000,191000,-141000,-141000
07004P,大立光兆豐9A售01,0,0,0,0,0,0,0,0,0,-141000,0,0,0,0,141000,-141000,-141000
057452,新日興元富98購01,0,0,0,0,0,0,0,0,0,-142000,0,0,0,67000,209000,-142000,-142000
057016,中石化凱基9B購01,0,0,0,0,0,0,0,0,0,-142000,0,0,0,0,142000,-142000,-142000
049954,健策群益95購01  ,0,0,0,0,0,0,0,0,0,-142000,0,0,0,0,142000,-142000,-142000
054717,亞德客永豐97購01,0,0,0,0,0,0,0,0,0,-142000,0,0,0,51000,193000,-142000,-142000
056098,矽創元富97購02  ,0,0,0,0,0,0,0,0,0,-142000,0,0,0,51000,193000,-142000,-142000
056107,智易永豐97購02  ,0,0,0,0,0,0,0,0,0,-142000,0,0,0,6000,148000,-142000,-142000
055447,華新科統一97購04,0,0,0,0,0,0,0,0,0,-142000,0,0,0,9000,151000,-142000,-142000
056916,台達電兆豐98購02,0,0,0,0,0,0,0,0,0,-143000,0,0,0,116000,259000,-143000,-143000
056487,康友元大98購01  ,0,0,0,0,0,0,0,0,0,-143000,0,0,0,29000,172000,-143000,-143000
056555,矽創凱基98購01  ,0,0,0,0,0,0,0,0,0,-143000,0,0,0,119000,262000,-143000,-143000
049346,新光金統一95購01,0,0,0,0,0,0,0,0,0,-143000,0,0,0,50000,193000,-143000,-143000
052464,大立光統一95購05,0,0,0,0,0,0,0,0,0,-143000,0,0,0,50000,193000,-143000,-143000
053488,中石化兆豐97購01,0,0,0,0,0,0,0,0,0,-143000,0,0,0,20000,163000,-143000,-143000
054882,台光電統一97購02,0,0,0,0,0,0,0,0,0,-143000,0,0,0,0,143000,-143000,-143000
058096,南電元大98購04  ,0,0,0,0,0,0,0,0,0,-144000,0,0,0,20000,164000,-144000,-144000
052911,友達統一97購02  ,0,0,0,0,0,0,0,0,0,-144000,0,0,0,151000,295000,-144000,-144000
052801,友達元大9A購01  ,0,0,0,0,0,0,0,0,0,-144000,0,0,0,220000,364000,-144000,-144000
053625,國巨兆豐96購03  ,0,0,0,0,0,0,0,0,0,-144000,0,0,0,307000,451000,-144000,-144000
051657,台郡元富98購01  ,0,0,0,0,0,0,0,0,0,-144000,0,0,0,50000,194000,-144000,-144000
056339,聯發科凱基99購02,0,0,0,0,0,0,0,0,0,-144000,0,0,0,0,144000,-144000,-144000
05886P,華通元富96售01  ,0,0,0,0,0,0,0,0,0,-145000,0,0,0,229000,374000,-145000,-145000
05289P,鴻海永豐95售05  ,0,0,0,0,0,0,0,0,0,-145000,0,0,0,13000,158000,-145000,-145000
039212,台達電台新9A購01,0,0,0,0,0,0,0,0,0,-145000,0,0,0,8000,153000,-145000,-145000
052348,台光電富邦95購01,0,0,0,0,0,0,0,0,0,-145000,0,0,0,0,145000,-145000,-145000
052307,潤泰全國泰96購01,0,0,0,0,0,0,0,0,0,-145000,0,0,0,40000,185000,-145000,-145000
053198,亞德客日盛96購01,0,0,0,0,0,0,0,0,0,-145000,0,0,0,0,145000,-145000,-145000
054724,鴻海日盛97購02  ,0,0,0,0,0,0,0,0,0,-145000,0,0,0,0,145000,-145000,-145000
054311,世芯凱基96購02  ,0,0,0,0,0,0,0,0,0,-145000,0,0,0,21000,166000,-145000,-145000
058019,美律凱基99購04  ,0,0,0,0,0,0,0,0,0,-146000,0,0,0,0,146000,-146000,-146000
05693P,滬深2X凱基98售02,0,0,0,0,0,0,0,0,0,-146000,0,0,0,0,146000,-146000,-146000
056937,智原元富98購01  ,0,0,0,0,0,0,0,0,0,-146000,0,0,0,0,146000,-146000,-146000
057049,新日興元大98購02,0,0,0,0,0,0,0,0,0,-146000,0,0,0,100000,246000,-146000,-146000
045504,群創凱基94購01  ,0,0,0,0,0,0,0,0,0,-146000,0,0,0,58000,204000,-146000,-146000
048178,上銀富邦95購02  ,0,0,0,0,0,0,0,0,0,-146000,0,0,0,0,146000,-146000,-146000
049267,瀚宇博元大95購02,0,0,0,0,0,0,0,0,0,-146000,0,0,0,206000,352000,-146000,-146000
047543,鴻海凱基94購09  ,0,0,0,0,0,0,0,0,0,-146000,0,0,0,10000,156000,-146000,-146000
050717,京鼎群益96購01  ,0,0,0,0,0,0,0,0,0,-146000,0,0,0,31000,177000,-146000,-146000
051662,大立光永昌96購03,0,0,0,0,0,0,0,0,0,-146000,0,0,0,48000,194000,-146000,-146000
054573,漢唐元大98購01  ,0,0,0,0,0,0,0,0,0,-146000,0,0,0,190000,336000,-146000,-146000
056183,南亞科統一97購02,0,0,0,0,0,0,0,0,0,-146000,0,0,0,0,146000,-146000,-146000
056123,鈺齊群益97購01  ,0,0,0,0,0,0,0,0,0,-146000,0,0,0,0,146000,-146000,-146000
2547,日勝生          ,418000,564000,-146000,0,0,0,0,0,0,0,0,0,0,0,0,0,-146000
056875,亞光凱基98購03  ,0,0,0,0,0,0,0,0,0,-147000,0,0,0,0,147000,-147000,-147000
058108,台郡台新99購01  ,0,0,0,0,0,0,0,0,0,-147000,0,0,0,38000,185000,-147000,-147000
051840,康友國泰97購02  ,0,0,0,0,0,0,0,0,0,-147000,0,0,0,74000,221000,-147000,-147000
5434,崇越            ,212000,402000,-190000,0,0,0,2000,0,2000,41000,2000,0,2000,41000,2000,39000,-147000
052623,台郡兆豐96購01  ,0,0,0,0,0,0,0,0,0,-148000,0,0,0,0,148000,-148000,-148000
053052,旺宏國票97購02  ,0,0,0,0,0,0,0,0,0,-148000,0,0,0,20000,168000,-148000,-148000
053096,康控統一96購01  ,0,0,0,0,0,0,0,0,0,-148000,0,0,0,0,148000,-148000,-148000
051988,台光電元大95購01,0,0,0,0,0,0,0,0,0,-148000,0,0,0,50000,198000,-148000,-148000
05628P,茂林國票97售02  ,0,0,0,0,0,0,0,0,0,-148000,0,0,0,103000,251000,-148000,-148000
054458,復盛群益96購01  ,0,0,0,0,0,0,0,0,0,-148000,0,0,0,32000,180000,-148000,-148000
057700,新日興群益9A購01,0,0,0,0,0,0,0,0,0,-149000,0,0,0,0,149000,-149000,-149000
057619,玉晶光凱基98購02,0,0,0,0,0,0,0,0,0,-149000,0,0,0,1000,150000,-149000,-149000
049783,元油2X兆豐95購01,0,0,0,0,0,0,0,0,0,-149000,0,0,0,0,149000,-149000,-149000
052787,國巨中信96購02  ,0,0,0,0,0,0,0,0,0,-149000,0,0,0,10000,159000,-149000,-149000
048634,華通元大94購01  ,0,0,0,0,0,0,0,0,0,-149000,0,0,0,87000,236000,-149000,-149000
050500,台積電凱基94購36,0,0,0,0,0,0,0,0,0,-149000,0,0,0,5000,154000,-149000,-149000
051668,智邦元大95購02  ,0,0,0,0,0,0,0,0,0,-149000,0,0,0,201000,350000,-149000,-149000
053602,台虹元大96購01  ,0,0,0,0,0,0,0,0,0,-149000,0,0,0,139000,288000,-149000,-149000
053983,樺漢元大97購02  ,0,0,0,0,0,0,0,0,0,-149000,0,0,0,218000,367000,-149000,-149000
055232,泰碩國票98購01  ,0,0,0,0,0,0,0,0,0,-149000,0,0,0,79000,228000,-149000,-149000
057649,嘉聯益元大99購04,0,0,0,0,0,0,0,0,0,-150000,0,0,0,68000,218000,-150000,-150000
057274,友達元大98購03  ,0,0,0,0,0,0,0,0,0,-150000,0,0,0,20000,170000,-150000,-150000
056750,元油2X兆豐9A購01,0,0,0,0,0,0,0,0,0,-150000,0,0,0,0,150000,-150000,-150000
058686,祥碩凱基99購03  ,0,0,0,0,0,0,0,0,0,-150000,0,0,0,15000,165000,-150000,-150000
058610,欣興元大99購05  ,0,0,0,0,0,0,0,0,0,-150000,0,0,0,5000,155000,-150000,-150000
058584,百和群益9A購01  ,0,0,0,0,0,0,0,0,0,-150000,0,0,0,0,150000,-150000,-150000
058586,鴻海中信01購02  ,0,0,0,0,0,0,0,0,0,-150000,0,0,0,0,150000,-150000,-150000
052676,聯發科永昌98購01,0,0,0,0,0,0,0,0,0,-150000,0,0,0,336000,486000,-150000,-150000
052941,康控兆豐97購01  ,0,0,0,0,0,0,0,0,0,-150000,0,0,0,0,150000,-150000,-150000
049974,聯發科日盛94購02,0,0,0,0,0,0,0,0,0,-150000,0,0,0,0,150000,-150000,-150000
047736,聯發科台新94購01,0,0,0,0,0,0,0,0,0,-150000,0,0,0,0,150000,-150000,-150000
049578,台達電元大94購09,0,0,0,0,0,0,0,0,0,-150000,0,0,0,0,150000,-150000,-150000
049590,華新科元大94購01,0,0,0,0,0,0,0,0,0,-150000,0,0,0,0,150000,-150000,-150000
053476,冠德元大96購03  ,0,0,0,0,0,0,0,0,0,-150000,0,0,0,0,150000,-150000,-150000
053736,友達麥證96購01  ,0,0,0,270000,420000,-150000,0,0,0,-150000,0,0,0,270000,420000,-150000,-150000
052981,鴻海元大97購05  ,0,0,0,0,0,0,0,0,0,-150000,0,0,0,16000,166000,-150000,-150000
055187,彩晶統一98購01  ,0,0,0,0,0,0,0,0,0,-150000,0,0,0,90000,240000,-150000,-150000
055759,技嘉群益98購02  ,0,0,0,0,0,0,0,0,0,-150000,0,0,0,47000,197000,-150000,-150000
055646,漢唐元富97購01  ,0,0,0,0,0,0,0,0,0,-150000,0,0,0,70000,220000,-150000,-150000
056303,亞光元大97購04  ,0,0,0,0,0,0,0,0,0,-150000,0,0,0,0,150000,-150000,-150000
056108,麗豐永豐97購01  ,0,0,0,0,0,0,0,0,0,-150000,0,0,0,0,150000,-150000,-150000
056111,力成永豐97購01  ,0,0,0,0,0,0,0,0,0,-150000,0,0,0,0,150000,-150000,-150000
055996,矽力國泰99購01  ,0,0,0,0,0,0,0,0,0,-150000,0,0,0,117000,267000,-150000,-150000
056041,禾伸堂凱基98購03,0,0,0,0,0,0,0,0,0,-150000,0,0,0,0,150000,-150000,-150000
055962,晶豪科元大97購02,0,0,0,0,0,0,0,0,0,-150000,0,0,0,2000,152000,-150000,-150000
055979,聯鈞統一97購03  ,0,0,0,0,0,0,0,0,0,-150000,0,0,0,134000,284000,-150000,-150000
054049,亞光元大96購03  ,0,0,0,0,0,0,0,0,0,-150000,0,0,0,4000,154000,-150000,-150000
054397,創意永豐96購05  ,0,0,0,0,0,0,0,0,0,-150000,0,0,0,0,150000,-150000,-150000
054487,京元電台新97購01,0,0,0,0,0,0,0,0,0,-150000,0,0,0,0,150000,-150000,-150000
054723,鴻海日盛97購01  ,0,0,0,0,0,0,0,0,0,-150000,0,0,0,0,150000,-150000,-150000
3060,銘異            ,140000,290000,-150000,0,0,0,0,0,0,0,7000,7000,0,0,0,0,-150000
06808P,電子類群益98售02,0,0,0,0,0,0,0,0,0,-150000,0,0,0,0,150000,-150000,-150000
058522,聯茂元大99購07  ,0,0,0,0,0,0,0,0,0,-151000,0,0,0,101000,252000,-151000,-151000
057385,光罩永豐99購01  ,0,0,0,0,0,0,0,0,0,-151000,0,0,0,1000,152000,-151000,-151000
049799,旺宏元大96購01  ,0,0,0,0,0,0,0,0,0,-151000,0,0,0,35000,186000,-151000,-151000
052553,技嘉國票96購01  ,0,0,0,0,0,0,0,0,0,-151000,0,0,0,13000,164000,-151000,-151000
052913,鴻海元富96購05  ,0,0,0,0,0,0,0,0,0,-151000,0,0,0,0,151000,-151000,-151000
052764,景碩群益98購01  ,0,0,0,0,0,0,0,0,0,-151000,0,0,0,14000,165000,-151000,-151000
048859,玉晶光群益96購02,0,0,0,0,0,0,0,0,0,-151000,0,0,0,32000,183000,-151000,-151000
050645,台積電凱基94購39,0,0,0,0,0,0,0,0,0,-151000,0,0,0,0,151000,-151000,-151000
054687,建準永豐97購02  ,0,0,0,0,0,0,0,0,0,-151000,0,0,0,0,151000,-151000,-151000
054906,神達康和97購01  ,0,0,0,0,0,0,0,0,0,-151000,0,0,0,46000,197000,-151000,-151000
053894,創意群益96購01  ,0,0,0,0,0,0,0,0,0,-151000,0,0,0,20000,171000,-151000,-151000
056291,聯茂永豐97購03  ,0,0,0,0,0,0,0,0,0,-151000,0,0,0,153000,304000,-151000,-151000
1582,信錦            ,151000,246000,-95000,0,0,0,0,0,0,-56000,5000,61000,-56000,0,0,0,-151000
8163,達方            ,334000,477000,-143000,0,0,0,1000,0,1000,-9000,6000,12000,-6000,2000,5000,-3000,-151000
058216,TPK群益99購01   ,0,0,0,0,0,0,0,0,0,-152000,0,0,0,0,152000,-152000,-152000
052669,群創群益98購06  ,0,0,0,0,0,0,0,0,0,-152000,0,0,0,0,152000,-152000,-152000
048122,台達電元大96購02,0,0,0,0,0,0,0,0,0,-152000,0,0,0,0,152000,-152000,-152000
051089,旺宏元大96購04  ,0,0,0,0,0,0,0,0,0,-152000,0,0,0,5000,157000,-152000,-152000
056137,聯鈞元大9A購01  ,0,0,0,0,0,0,0,0,0,-152000,0,0,0,79000,231000,-152000,-152000
055311,健策群益98購02  ,0,0,0,0,0,0,0,0,0,-152000,0,0,0,10000,162000,-152000,-152000
054689,華新科永豐97購01,0,0,0,0,0,0,0,0,0,-152000,0,0,0,300000,452000,-152000,-152000
058276,道瓊指中信9C購01,0,0,0,0,0,0,0,0,0,-153000,0,0,0,0,153000,-153000,-153000
05791P,臺股指中信99售06,0,0,0,0,0,0,0,0,0,-153000,0,0,0,2000,155000,-153000,-153000
056616,台光電永豐98購01,0,0,0,0,0,0,0,0,0,-153000,0,0,0,25000,178000,-153000,-153000
050259,鴻海元大94購14  ,0,0,0,0,0,0,0,0,0,-153000,0,0,0,0,153000,-153000,-153000
050758,聯發科元富9B購01,0,0,0,0,0,0,0,0,0,-153000,0,0,0,0,153000,-153000,-153000
054931,緯穎凱基98購01  ,0,0,0,0,0,0,0,0,0,-153000,0,0,0,44000,197000,-153000,-153000
055018,緯穎元富97購02  ,0,0,0,0,0,0,0,0,0,-153000,0,0,0,109000,262000,-153000,-153000
2206,三陽工業        ,234000,387000,-153000,0,0,0,0,0,0,0,0,0,0,0,0,0,-153000
06328P,台積電中信01售02,0,0,0,0,0,0,0,0,0,-153000,0,0,0,10000,163000,-153000,-153000
06740P,台灣50國泰9A售02,0,0,0,0,0,0,0,0,0,-153000,0,0,0,109000,262000,-153000,-153000
057037,元油2X元大9B購05,0,0,0,0,0,0,0,0,0,-154000,0,0,0,297000,451000,-154000,-154000
058215,貿聯群益99購02  ,0,0,0,0,0,0,0,0,0,-154000,0,0,0,10000,164000,-154000,-154000
054351,華新科國泰97購03,0,0,0,0,0,0,0,0,0,-154000,0,0,0,68000,222000,-154000,-154000
055679,華通凱基99購01  ,0,0,0,0,0,0,0,0,0,-154000,0,0,0,28000,182000,-154000,-154000
056515,燿華兆豐99購01  ,0,0,0,0,0,0,0,0,0,-155000,0,0,0,18000,173000,-155000,-155000
046792,京元電元富96購01,0,0,0,0,0,0,0,0,0,-155000,0,0,0,0,155000,-155000,-155000
050099,台積電永昌96購01,0,0,0,0,0,0,0,0,0,-155000,0,0,0,821000,976000,-155000,-155000
054875,群電群益97購01  ,0,0,0,0,0,0,0,0,0,-155000,0,0,0,0,155000,-155000,-155000
06470P,臺股指凱基99售10,0,0,0,0,0,0,0,0,0,-155000,0,0,0,133000,288000,-155000,-155000
056936,禾伸堂元富98購01,0,0,0,0,0,0,0,0,0,-156000,0,0,0,0,156000,-156000,-156000
057420,美食凱基98購01  ,0,0,0,0,0,0,0,0,0,-156000,0,0,0,0,156000,-156000,-156000
057463,華邦電永豐98購01,0,0,0,0,0,0,0,0,0,-156000,0,0,0,4000,160000,-156000,-156000
057057,立積元大9A購01  ,0,0,0,0,0,0,0,0,0,-156000,0,0,0,157000,313000,-156000,-156000
058643,T50正2富邦03購01,0,0,0,0,0,0,0,0,0,-156000,0,0,0,0,156000,-156000,-156000
041900,元油2X富邦96購01,0,0,0,0,0,0,0,0,0,-156000,0,0,0,0,156000,-156000,-156000
054383,傳奇群益97購01  ,0,0,0,0,0,0,0,0,0,-156000,0,0,0,60000,216000,-156000,-156000
054353,世紀鋼國泰98購01,0,0,0,0,0,0,0,0,0,-156000,0,0,0,187000,343000,-156000,-156000
054006,智易統一97購01  ,0,0,0,0,0,0,0,0,0,-156000,0,0,0,0,156000,-156000,-156000
056762,亞德客元大98購01,0,0,0,0,0,0,0,0,0,-157000,0,0,0,198000,355000,-157000,-157000
046626,台光電統一94購01,0,0,0,0,0,0,0,0,0,-157000,0,0,0,0,157000,-157000,-157000
052721,友達統一96購01  ,0,0,0,0,0,0,0,0,0,-157000,0,0,0,154000,311000,-157000,-157000
052254,康友永豐95購03  ,0,0,0,0,0,0,0,0,0,-157000,0,0,0,22000,179000,-157000,-157000
053945,國巨富邦98購02  ,0,0,0,0,0,0,0,0,0,-157000,0,0,0,343000,500000,-157000,-157000
055976,台積電統一99購03,0,0,0,0,0,0,0,0,0,-157000,0,0,0,0,157000,-157000,-157000
056424,泰碩統一98購01  ,0,0,0,0,0,0,0,0,0,-157000,0,0,0,67000,224000,-157000,-157000
057731,華擎國泰9A購02  ,0,0,0,0,0,0,0,0,0,-158000,0,0,0,112000,270000,-158000,-158000
053464,喬山元大96購01  ,0,0,0,0,0,0,0,0,0,-158000,0,0,0,48000,206000,-158000,-158000
051535,新日興國票96購01,0,0,0,0,0,0,0,0,0,-158000,0,0,0,20000,178000,-158000,-158000
052022,南電永豐95購03  ,0,0,0,0,0,0,0,0,0,-158000,0,0,0,10000,168000,-158000,-158000
056184,南亞科統一97購03,0,0,0,0,0,0,0,0,0,-158000,0,0,0,20000,178000,-158000,-158000
054565,玉晶光群益99購02,0,0,0,0,0,0,0,0,0,-158000,0,0,0,37000,195000,-158000,-158000
2337,旺宏            ,15423000,16836378,-1413378,0,0,0,390000,0,390000,865000,234000,245000,-11000,1381000,505000,876000,-158378
056716,康舒永豐98購01  ,0,0,0,0,0,0,0,0,0,-159000,0,0,0,0,159000,-159000,-159000
054881,光罩統一97購01  ,0,0,0,0,0,0,0,0,0,-159000,0,0,0,63000,222000,-159000,-159000
053887,聯茂兆豐97購02  ,0,0,0,0,0,0,0,0,0,-159000,0,0,0,45000,204000,-159000,-159000
054410,國巨元大96購14  ,0,0,0,0,0,0,0,0,0,-159000,0,0,0,120000,279000,-159000,-159000
056712,京鼎永豐98購01  ,0,0,0,0,0,0,0,0,0,-160000,0,0,0,0,160000,-160000,-160000
056663,臺股指元大9A購10,0,0,0,0,0,0,0,0,0,-160000,0,0,0,33000,193000,-160000,-160000
056765,友達元大9B購05  ,0,0,0,0,0,0,0,0,0,-160000,0,0,0,180000,340000,-160000,-160000
056810,群創統一9A購01  ,0,0,0,0,0,0,0,0,0,-160000,0,0,0,0,160000,-160000,-160000
058100,聯茂國泰99購02  ,0,0,0,0,0,0,0,0,0,-160000,0,0,0,130000,290000,-160000,-160000
058505,台積電元大99購08,0,0,0,0,0,0,0,0,0,-160000,0,0,0,187000,347000,-160000,-160000
058552,欣興永豐99購01  ,0,0,0,0,0,0,0,0,0,-160000,0,0,0,0,160000,-160000,-160000
044270,群創中信95購02  ,0,0,0,0,0,0,0,0,0,-160000,0,0,0,0,160000,-160000,-160000
04975P,華新科凱基96售02,0,0,0,0,0,0,0,0,0,-160000,0,0,0,170000,330000,-160000,-160000
048328,滬深2X永昌94購01,0,0,0,0,0,0,0,0,0,-160000,0,0,0,42000,202000,-160000,-160000
052650,台郡永豐96購01  ,0,0,0,0,0,0,0,0,0,-160000,0,0,0,20000,180000,-160000,-160000
053086,宏達電元大97購01,0,0,0,0,0,0,0,0,0,-160000,0,0,0,168000,328000,-160000,-160000
051600,新日興兆豐96購02,0,0,0,0,0,0,0,0,0,-160000,0,0,0,12000,172000,-160000,-160000
052227,瑞昱凱基95購05  ,0,0,0,0,0,0,0,0,0,-160000,0,0,0,57000,217000,-160000,-160000
054413,台光電元大96購03,0,0,0,0,0,0,0,0,0,-160000,0,0,0,0,160000,-160000,-160000
054418,茂林元大97購01  ,0,0,0,0,0,0,0,0,0,-160000,0,0,0,19000,179000,-160000,-160000
056409,麗豐國票99購01  ,0,0,0,0,0,0,0,0,0,-160000,0,0,0,0,160000,-160000,-160000
055944,日月光麥證97購01,0,0,0,5000,165000,-160000,0,0,0,-160000,0,0,0,5000,165000,-160000,-160000
055335,健策兆豐98購01  ,0,0,0,0,0,0,0,0,0,-160000,0,0,0,0,160000,-160000,-160000
06866P,聯發科元大98售13,0,0,0,0,0,0,0,0,0,-160000,0,0,0,16000,176000,-160000,-160000
3257,虹冠電          ,133000,28000,105000,0,0,0,0,0,0,-265000,1000,266000,-265000,0,0,0,-160000
056589,康控統一98購01  ,0,0,0,0,0,0,0,0,0,-161000,0,0,0,54000,215000,-161000,-161000
049706,世紀鋼元大95購02,0,0,0,0,0,0,0,0,0,-161000,0,0,0,202000,363000,-161000,-161000
049935,南電元大94購08  ,0,0,0,0,0,0,0,0,0,-161000,0,0,0,47000,208000,-161000,-161000
056200,大毅永豐98購01  ,0,0,0,0,0,0,0,0,0,-161000,0,0,0,30000,191000,-161000,-161000
053965,聯電元大98購04  ,0,0,0,0,0,0,0,0,0,-161000,0,0,0,0,161000,-161000,-161000
055006,晶相光元富9A購01,0,0,0,0,0,0,0,0,0,-161000,0,0,0,188000,349000,-161000,-161000
055120,南港兆豐97購01  ,0,0,0,0,0,0,0,0,0,-161000,0,0,0,18000,179000,-161000,-161000
1527,鑽全            ,168000,329000,-161000,0,0,0,0,0,0,0,0,0,0,0,0,0,-161000
056598,京元電元富98購01,0,0,0,0,0,0,0,0,0,-162000,0,0,0,158000,320000,-162000,-162000
056662,臺股指元大9A購09,0,0,0,0,0,0,0,0,0,-162000,0,0,0,0,162000,-162000,-162000
057588,南亞科國票99購01,0,0,0,0,0,0,0,0,0,-162000,0,0,0,38000,200000,-162000,-162000
057518,世紀鋼元富98購01,0,0,0,0,0,0,0,0,0,-162000,0,0,0,827000,989000,-162000,-162000
057759,聯發科凱基98購17,0,0,0,0,0,0,0,0,0,-162000,0,0,0,117000,279000,-162000,-162000
044872,旺宏統一93購02  ,0,0,0,0,0,0,0,0,0,-162000,0,0,0,0,162000,-162000,-162000
055254,聯詠統一97購03  ,0,0,0,0,0,0,0,0,0,-162000,0,0,0,0,162000,-162000,-162000
06157P,聯鈞統一97售02  ,0,0,0,0,0,0,0,0,0,-162000,0,0,0,25000,187000,-162000,-162000
3038,全台            ,228000,388000,-160000,0,0,0,0,0,0,-2000,0,2000,-2000,0,0,0,-162000
057682,台積電日盛9A購03,0,0,0,0,0,0,0,0,0,-163000,0,0,0,0,163000,-163000,-163000
058016,智邦凱基98購06  ,0,0,0,0,0,0,0,0,0,-163000,0,0,0,20000,183000,-163000,-163000
057990,美律統一99購02  ,0,0,0,0,0,0,0,0,0,-163000,0,0,0,108000,271000,-163000,-163000
053262,華邦電群益96購02,0,0,0,0,0,0,0,0,0,-163000,0,0,0,9000,172000,-163000,-163000
053247,麗豐國票97購01  ,0,0,0,0,0,0,0,0,0,-163000,0,0,0,0,163000,-163000,-163000
055818,晶相光國票97購02,0,0,0,0,0,0,0,0,0,-163000,0,0,0,145000,308000,-163000,-163000
058488,華擎國票9A購01  ,0,0,0,0,0,0,0,0,0,-164000,0,0,0,0,164000,-164000,-164000
049617,光罩群益94購03  ,0,0,0,0,0,0,0,0,0,-164000,0,0,0,0,164000,-164000,-164000
00737,國泰AI+Robo     ,1000,143000,-142000,0,0,0,0,0,0,-22000,0,0,0,81000,103000,-22000,-164000
055741,健策元富97購01  ,0,0,0,0,0,0,0,0,0,-164000,0,0,0,36000,200000,-164000,-164000
054709,宏達電統一97購01,0,0,0,0,0,0,0,0,0,-164000,0,0,0,0,164000,-164000,-164000
05893P,國巨兆豐96售04  ,0,0,0,0,0,0,0,0,0,-165000,0,0,0,20000,185000,-165000,-165000
057442,玉晶光統一98購03,0,0,0,0,0,0,0,0,0,-165000,0,0,0,5000,170000,-165000,-165000
056470,旺宏元大99購01  ,0,0,0,0,0,0,0,0,0,-165000,0,0,0,116000,281000,-165000,-165000
03641C,臺股指凱基95牛18,0,0,0,0,0,0,0,0,0,-165000,0,0,0,0,165000,-165000,-165000
04471P,華通元大95售03  ,0,0,0,0,0,0,0,0,0,-165000,0,0,0,27000,192000,-165000,-165000
049463,華新科富邦97購01,0,0,0,0,0,0,0,0,0,-165000,0,0,0,2000,167000,-165000,-165000
052869,新日興凱基96購01,0,0,0,0,0,0,0,0,0,-165000,0,0,0,83000,248000,-165000,-165000
051325,台光電台新96購01,0,0,0,0,0,0,0,0,0,-165000,0,0,0,0,165000,-165000,-165000
054340,大成鋼元富96購01,0,0,0,0,0,0,0,0,0,-165000,0,0,0,75000,240000,-165000,-165000
2359,所羅門          ,243000,408000,-165000,0,0,0,0,0,0,0,0,0,0,0,0,0,-165000
07009P,臺股指中信9B售01,0,0,0,0,0,0,0,0,0,-165000,0,0,0,0,165000,-165000,-165000
056960,光罩永豐98購01  ,0,0,0,0,0,0,0,0,0,-166000,0,0,0,68000,234000,-166000,-166000
057334,技嘉國票98購02  ,0,0,0,0,0,0,0,0,0,-166000,0,0,0,60000,226000,-166000,-166000
058320,華新科永豐99購02,0,0,0,0,0,0,0,0,0,-166000,0,0,0,20000,186000,-166000,-166000
058256,臺股指元大9A購20,0,0,0,0,0,0,0,0,0,-166000,0,0,0,10000,176000,-166000,-166000
048895,光罩國泰95購01  ,0,0,0,0,0,0,0,0,0,-166000,0,0,0,187000,353000,-166000,-166000
052453,崇越元大95購01  ,0,0,0,0,0,0,0,0,0,-166000,0,0,0,0,166000,-166000,-166000
055027,牧德國泰99購01  ,0,0,0,0,0,0,0,0,0,-166000,0,0,0,132000,298000,-166000,-166000
058553,合勤控永豐99購01,0,0,0,0,0,0,0,0,0,-167000,0,0,0,0,167000,-167000,-167000
056588,聯發科統一9A購02,0,0,0,0,0,0,0,0,0,-167000,0,0,0,120000,287000,-167000,-167000
049847,旺宏群益94購04  ,0,0,0,0,0,0,0,0,0,-167000,0,0,0,9000,176000,-167000,-167000
03644C,臺股指元大94牛28,499000,0,499000,0,0,0,0,0,0,-666000,0,0,0,495000,1161000,-666000,-167000
051114,鈺齊中信95購01  ,0,0,0,0,0,0,0,0,0,-167000,0,0,0,274000,441000,-167000,-167000
053043,嘉晶凱基96購01  ,0,0,0,0,0,0,0,0,0,-167000,0,0,0,62000,229000,-167000,-167000
055149,國巨元大97購06  ,0,0,0,0,0,0,0,0,0,-167000,0,0,0,8000,175000,-167000,-167000
054381,世芯群益98購01  ,0,0,0,0,0,0,0,0,0,-167000,0,0,0,60000,227000,-167000,-167000
056769,國產元大98購01  ,0,0,0,0,0,0,0,0,0,-168000,0,0,0,0,168000,-168000,-168000
056896,南亞科元大98購01,0,0,0,0,0,0,0,0,0,-168000,0,0,0,0,168000,-168000,-168000
058651,FBVIX中信9C購01 ,0,0,0,0,0,0,0,0,0,-168000,0,0,0,0,168000,-168000,-168000
058050,台郡元大99購05  ,0,0,0,0,0,0,0,0,0,-168000,0,0,0,0,168000,-168000,-168000
058099,鴻海國泰9A購02  ,0,0,0,0,0,0,0,0,0,-168000,0,0,0,0,168000,-168000,-168000
038489,T50反1台新9A購01,0,0,0,0,0,0,0,0,0,-168000,0,0,0,11300000,11468000,-168000,-168000
050133,鈺齊凱基94購01  ,0,0,0,0,0,0,0,0,0,-168000,0,0,0,0,168000,-168000,-168000
053192,創意統一96購01  ,0,0,0,0,0,0,0,0,0,-168000,0,0,0,50000,218000,-168000,-168000
054016,嘉晶永豐96購04  ,0,0,0,0,0,0,0,0,0,-168000,0,0,0,5000,173000,-168000,-168000
055806,致新永豐97購02  ,0,0,0,0,0,0,0,0,0,-168000,0,0,0,0,168000,-168000,-168000
056786,亞光群益98購03  ,0,0,0,0,0,0,0,0,0,-169000,0,0,0,0,169000,-169000,-169000
056530,旺宏凱基98購06  ,0,0,0,0,0,0,0,0,0,-169000,0,0,0,2000,171000,-169000,-169000
057180,華新科元大99購08,0,0,0,0,0,0,0,0,0,-169000,0,0,0,21000,190000,-169000,-169000
1611,中電            ,207000,376000,-169000,0,0,0,0,0,0,0,0,0,0,0,0,0,-169000
057215,友達群益98購03  ,0,0,0,0,0,0,0,0,0,-170000,0,0,0,25000,195000,-170000,-170000
057674,台郡元大99購03  ,0,0,0,0,0,0,0,0,0,-170000,0,0,0,141000,311000,-170000,-170000
03657C,T50反1元大99牛01,0,0,0,0,0,0,0,0,0,-170000,0,0,0,30000,200000,-170000,-170000
04950P,上証2X中信96售02,0,0,0,0,0,0,0,0,0,-170000,0,0,0,30000,200000,-170000,-170000
052679,致伸富邦98購01  ,0,0,0,0,0,0,0,0,0,-170000,0,0,0,50000,220000,-170000,-170000
053155,晶技元大97購02  ,0,0,0,0,0,0,0,0,0,-170000,0,0,0,208000,378000,-170000,-170000
050632,國巨群益94購07  ,0,0,0,0,0,0,0,0,0,-170000,0,0,0,190000,360000,-170000,-170000
055949,亞德客元大97購04,0,0,0,0,0,0,0,0,0,-170000,0,0,0,155000,325000,-170000,-170000
053799,矽創中信9A購01  ,0,0,0,0,0,0,0,0,0,-170000,0,0,0,0,170000,-170000,-170000
058220,世芯國票9A購01  ,0,0,0,0,0,0,0,0,0,-171000,0,0,0,0,171000,-171000,-171000
05999P,世芯元大96售01  ,0,0,0,0,0,0,0,0,0,-171000,0,0,0,330000,501000,-171000,-171000
05854P,華新科凱基96售09,0,0,0,0,0,0,0,0,0,-171000,0,0,0,288000,459000,-171000,-171000
046574,泰鼎國泰94購01  ,0,0,0,0,0,0,0,0,0,-171000,0,0,0,68000,239000,-171000,-171000
053186,健策中信9C購01  ,0,0,0,0,0,0,0,0,0,-171000,0,0,0,83000,254000,-171000,-171000
053075,欣興永豐96購01  ,0,0,0,0,0,0,0,0,0,-171000,0,0,0,0,171000,-171000,-171000
052432,康友永豐95購04  ,0,0,0,0,0,0,0,0,0,-171000,0,0,0,3000,174000,-171000,-171000
053846,友達元富99購02  ,0,0,0,0,0,0,0,0,0,-171000,0,0,0,83000,254000,-171000,-171000
053922,亞光國票96購01  ,0,0,0,0,0,0,0,0,0,-171000,0,0,0,0,171000,-171000,-171000
054952,大毅元大97購02  ,0,0,0,0,0,0,0,0,0,-171000,0,0,0,28000,199000,-171000,-171000
058258,世芯國泰9A購01  ,0,0,0,0,0,0,0,0,0,-172000,0,0,0,223000,395000,-172000,-172000
058034,神達永豐98購02  ,0,0,0,0,0,0,0,0,0,-172000,0,0,0,88000,260000,-172000,-172000
057190,立積元大9A購02  ,0,0,0,0,0,0,0,0,0,-172000,0,0,0,96000,268000,-172000,-172000
056480,京鼎元大98購02  ,0,0,0,0,0,0,0,0,0,-172000,0,0,0,100000,272000,-172000,-172000
056402,智易群益98購02  ,0,0,0,0,0,0,0,0,0,-172000,0,0,0,18000,190000,-172000,-172000
3062,建漢            ,364000,538000,-174000,0,0,0,0,0,0,2000,2000,0,2000,0,0,0,-172000
056606,華新科富邦9A購02,0,0,0,0,0,0,0,0,0,-173000,0,0,0,1000,174000,-173000,-173000
057957,嘉晶元大98購01  ,0,0,0,0,0,0,0,0,0,-173000,0,0,0,14000,187000,-173000,-173000
046275,台表科凱基94購01,0,0,0,0,0,0,0,0,0,-173000,0,0,0,0,173000,-173000,-173000
052538,和大統一95購02  ,0,0,0,0,0,0,0,0,0,-173000,0,0,0,208000,381000,-173000,-173000
052531,台積電國泰96購06,0,0,0,0,0,0,0,0,0,-173000,0,0,0,2000,175000,-173000,-173000
048860,玉晶光群益96購03,0,0,0,0,0,0,0,0,0,-173000,0,0,0,72000,245000,-173000,-173000
052740,聯發科元大96購07,0,0,0,0,0,0,0,0,0,-173000,0,0,0,125000,298000,-173000,-173000
053136,彩晶國票97購01  ,0,0,0,0,0,0,0,0,0,-173000,0,0,0,63000,236000,-173000,-173000
055880,神達元富97購02  ,0,0,0,0,0,0,0,0,0,-173000,0,0,0,75000,248000,-173000,-173000
056002,嘉晶永豐97購01  ,0,0,0,0,0,0,0,0,0,-173000,0,0,0,68000,241000,-173000,-173000
054516,國巨元大97購02  ,0,0,0,0,0,0,0,0,0,-173000,0,0,0,25000,198000,-173000,-173000
3669,圓展            ,246000,252000,-6000,0,0,0,0,80000,-80000,-87000,11000,98000,-87000,0,0,0,-173000
06867P,訊芯元大98售08  ,0,0,0,0,0,0,0,0,0,-173000,0,0,0,39000,212000,-173000,-173000
057824,日月光元大98購01,0,0,0,0,0,0,0,0,0,-174000,0,0,0,98000,272000,-174000,-174000
057138,亞德客兆豐98購01,0,0,0,0,0,0,0,0,0,-174000,0,0,0,0,174000,-174000,-174000
052919,鈺齊富邦98購01  ,0,0,0,0,0,0,0,0,0,-174000,0,0,0,10000,184000,-174000,-174000
05081P,京鼎永豐95售01  ,0,0,0,0,0,0,0,0,0,-174000,0,0,0,0,174000,-174000,-174000
057502,訊芯群益98購02  ,0,0,0,0,0,0,0,0,0,-175000,0,0,0,33000,208000,-175000,-175000
057612,瑞昱元富02購01  ,0,0,0,0,0,0,0,0,0,-175000,0,0,0,0,175000,-175000,-175000
056488,致新元大99購01  ,0,0,0,0,0,0,0,0,0,-175000,0,0,0,1000,176000,-175000,-175000
058111,健鼎元富98購01  ,0,0,0,0,0,0,0,0,0,-175000,0,0,0,10000,185000,-175000,-175000
052880,台積電凱基96購06,0,0,0,0,0,0,0,0,0,-175000,0,0,0,15000,190000,-175000,-175000
048675,台達電國泰94購02,0,0,0,0,0,0,0,0,0,-175000,0,0,0,0,175000,-175000,-175000
046220,滬深2X元大95購03,0,0,0,0,0,0,0,0,0,-175000,0,0,0,30000,205000,-175000,-175000
054628,可成凱基98購01  ,0,0,0,0,0,0,0,0,0,-175000,0,0,0,40000,215000,-175000,-175000
054951,大毅元大97購01  ,0,0,0,0,0,0,0,0,0,-175000,0,0,0,27000,202000,-175000,-175000
053876,可成永昌98購01  ,0,0,0,0,0,0,0,0,0,-175000,0,0,0,161000,336000,-175000,-175000
054047,富邦金元大97購01,0,0,0,0,0,0,0,0,0,-175000,0,0,0,130000,305000,-175000,-175000
054255,亞光元大96購05  ,0,0,0,0,0,0,0,0,0,-175000,0,0,0,0,175000,-175000,-175000
05538P,玉晶光國票97售02,0,0,0,0,0,0,0,0,0,-175000,0,0,0,46000,221000,-175000,-175000
9910,豐泰            ,684000,869843,-185843,0,0,0,0,0,0,10000,11000,2000,9000,1000,0,1000,-175843
056656,華邦電元大98購02,0,0,0,0,0,0,0,0,0,-176000,0,0,0,11000,187000,-176000,-176000
00770,國泰北美科技    ,0,7000,-7000,0,0,0,0,0,0,-169000,0,0,0,1000,170000,-169000,-176000
048161,旺宏麥證94購01  ,0,0,0,20000,196000,-176000,0,0,0,-176000,0,0,0,20000,196000,-176000,-176000
049804,華固元大94購01  ,0,0,0,0,0,0,0,0,0,-176000,0,0,0,49000,225000,-176000,-176000
055349,京元電凱基97購02,0,0,0,0,0,0,0,0,0,-176000,0,0,0,45000,221000,-176000,-176000
057703,矽力群益98購01  ,0,0,0,0,0,0,0,0,0,-177000,0,0,0,103000,280000,-177000,-177000
048891,傳奇元富97購02  ,0,0,0,0,0,0,0,0,0,-177000,0,0,0,0,177000,-177000,-177000
053184,世紀鋼元富96購01,0,0,0,0,0,0,0,0,0,-177000,0,0,0,1131000,1308000,-177000,-177000
06962P,華新科永豐99售01,0,0,0,0,0,0,0,0,0,-177000,0,0,0,303000,480000,-177000,-177000
057912,美律日盛99購01  ,0,0,0,0,0,0,0,0,0,-178000,0,0,0,60000,238000,-178000,-178000
058193,緯穎永豐99購01  ,0,0,0,0,0,0,0,0,0,-178000,0,0,0,68000,246000,-178000,-178000
050695,台積電凱基94購40,0,0,0,0,0,0,0,0,0,-178000,0,0,0,1000,179000,-178000,-178000
053481,同欣電元大97購01,0,0,0,0,0,0,0,0,0,-178000,0,0,0,100000,278000,-178000,-178000
058106,神達統一98購02  ,0,0,0,0,0,0,0,0,0,-179000,0,0,0,36000,215000,-179000,-179000
058060,貿聯元富98購01  ,0,0,0,0,0,0,0,0,0,-179000,0,0,0,140000,319000,-179000,-179000
057945,京鼎國票99購03  ,0,0,0,0,0,0,0,0,0,-179000,0,0,0,30000,209000,-179000,-179000
056619,強茂永豐98購01  ,0,0,0,0,0,0,0,0,0,-179000,0,0,0,10000,189000,-179000,-179000
057431,京鼎兆豐98購02  ,0,0,0,0,0,0,0,0,0,-179000,0,0,0,38000,217000,-179000,-179000
050902,南電元大96購01  ,0,0,0,0,0,0,0,0,0,-179000,0,0,0,98000,277000,-179000,-179000
053097,超眾統一96購03  ,0,0,0,0,0,0,0,0,0,-179000,0,0,0,29000,208000,-179000,-179000
054741,亞光凱基99購01  ,0,0,0,0,0,0,0,0,0,-179000,0,0,0,31000,210000,-179000,-179000
054756,世紀鋼凱基99購01,0,0,0,0,0,0,0,0,0,-179000,0,0,0,618000,797000,-179000,-179000
057244,鈺齊凱基99購01  ,0,0,0,0,0,0,0,0,0,-180000,0,0,0,7000,187000,-180000,-180000
056706,元油2X富邦9B購01,0,0,0,0,0,0,0,0,0,-180000,0,0,0,0,180000,-180000,-180000
056962,技嘉永豐98購01  ,0,0,0,0,0,0,0,0,0,-180000,0,0,0,0,180000,-180000,-180000
052685,技嘉元大96購01  ,0,0,0,0,0,0,0,0,0,-180000,0,0,0,25000,205000,-180000,-180000
04637P,臺股指群益94售12,0,0,0,0,0,0,0,0,0,-180000,0,0,0,0,180000,-180000,-180000
053113,瀚宇博兆豐97購01,0,0,0,0,0,0,0,0,0,-180000,0,0,0,16000,196000,-180000,-180000
053125,宏達電凱基96購01,0,0,0,0,0,0,0,0,0,-180000,0,0,0,0,180000,-180000,-180000
051638,聯茂國票96購01  ,0,0,0,0,0,0,0,0,0,-180000,0,0,0,10000,190000,-180000,-180000
054847,創意兆豐97購01  ,0,0,0,0,0,0,0,0,0,-180000,0,0,0,2000,182000,-180000,-180000
053921,嘉晶國票97購03  ,0,0,0,0,0,0,0,0,0,-180000,0,0,0,62000,242000,-180000,-180000
055624,聯發科富邦99購07,0,0,0,0,0,0,0,0,0,-180000,0,0,0,0,180000,-180000,-180000
055841,南亞科元大97購04,0,0,0,0,0,0,0,0,0,-180000,0,0,0,10000,190000,-180000,-180000
056913,臺股指元大99購05,0,0,0,0,0,0,0,0,0,-181000,0,0,0,10000,191000,-181000,-181000
056995,華新科日盛99購01,0,0,0,0,0,0,0,0,0,-181000,0,0,0,5000,186000,-181000,-181000
057702,同欣電群益99購01,0,0,0,0,0,0,0,0,0,-181000,0,0,0,138000,319000,-181000,-181000
057668,華新科元大9A購01,0,0,0,0,0,0,0,0,0,-181000,0,0,0,130000,311000,-181000,-181000
052530,台郡元大96購04  ,0,0,0,0,0,0,0,0,0,-181000,0,0,0,2000,183000,-181000,-181000
054584,貿聯元富97購01  ,0,0,0,0,0,0,0,0,0,-181000,0,0,0,40000,221000,-181000,-181000
054548,鴻海凱基98購03  ,0,0,0,0,0,0,0,0,0,-181000,0,0,0,40000,221000,-181000,-181000
06152P,玉晶光元大98售06,0,0,0,0,0,0,0,0,0,-181000,0,0,0,28000,209000,-181000,-181000
06110P,國巨國泰98售02  ,0,0,0,0,0,0,0,0,0,-181000,0,0,0,207000,388000,-181000,-181000
058348,台表科群益99購01,0,0,0,0,0,0,0,0,0,-182000,0,0,0,0,182000,-182000,-182000
049042,玉晶光兆豐95購01,0,0,0,0,0,0,0,0,0,-182000,0,0,0,83000,265000,-182000,-182000
053385,聯詠元大96購02  ,0,0,0,0,0,0,0,0,0,-182000,0,0,0,78000,260000,-182000,-182000
055958,台光電元大97購02,0,0,0,0,0,0,0,0,0,-182000,0,0,0,58000,240000,-182000,-182000
06684P,緯穎元大98售06  ,0,0,0,0,0,0,0,0,0,-182000,0,0,0,48000,230000,-182000,-182000
2377,微星            ,1066000,1874000,-808000,0,0,0,7000,0,7000,619000,304000,248000,56000,589000,26000,563000,-182000
057669,嘉晶元大99購03  ,0,0,0,0,0,0,0,0,0,-184000,0,0,0,198000,382000,-184000,-184000
056864,新日興群益99購01,0,0,0,0,0,0,0,0,0,-184000,0,0,0,119000,303000,-184000,-184000
057175,美律元大98購03  ,0,0,0,0,0,0,0,0,0,-184000,0,0,0,135000,319000,-184000,-184000
052895,台積電群益96購04,0,0,0,0,0,0,0,0,0,-184000,0,0,0,729000,913000,-184000,-184000
052970,美律群益96購01  ,0,0,0,0,0,0,0,0,0,-184000,0,0,0,0,184000,-184000,-184000
053770,元金2X元大98購01,0,0,0,0,0,0,0,0,0,-184000,0,0,0,55000,239000,-184000,-184000
054363,世芯凱基97購01  ,0,0,0,0,0,0,0,0,0,-184000,0,0,0,18000,202000,-184000,-184000
8028,昇陽半導體      ,536000,400000,136000,0,0,0,0,372000,-372000,52000,7000,10000,-3000,66000,11000,55000,-184000
053252,華邦電國泰98購01,0,0,0,0,0,0,0,0,0,-185000,0,0,0,150000,335000,-185000,-185000
055114,新日興凱基98購01,0,0,0,0,0,0,0,0,0,-185000,0,0,0,90000,275000,-185000,-185000
048142,聯電統一93購01  ,0,0,0,0,0,0,0,0,0,-186000,0,0,0,0,186000,-186000,-186000
050870,旭富永豐95購01  ,0,0,0,0,0,0,0,0,0,-186000,0,0,0,146000,332000,-186000,-186000
051904,深100元大95購01 ,0,0,0,0,0,0,0,0,0,-187000,0,0,0,0,187000,-187000,-187000
053599,崇越元大96購01  ,0,0,0,0,0,0,0,0,0,-187000,0,0,0,0,187000,-187000,-187000
056092,亞德客元富97購02,0,0,0,0,0,0,0,0,0,-187000,0,0,0,61000,248000,-187000,-187000
056155,嘉晶凱基97購01  ,0,0,0,0,0,0,0,0,0,-187000,0,0,0,3000,190000,-187000,-187000
1434,福懋            ,780000,983000,-203000,0,0,0,2000,0,2000,14000,21000,7000,14000,0,0,0,-187000
057516,和鑫元富98購01  ,0,0,0,0,0,0,0,0,0,-188000,0,0,0,30000,218000,-188000,-188000
057939,鈺齊群益98購02  ,0,0,0,0,0,0,0,0,0,-188000,0,0,0,22000,210000,-188000,-188000
058187,泰碩永豐99購01  ,0,0,0,0,0,0,0,0,0,-188000,0,0,0,61000,249000,-188000,-188000
05923P,旺宏元富96售05  ,0,0,0,0,0,0,0,0,0,-188000,0,0,0,72000,260000,-188000,-188000
051892,台光電元富95購03,0,0,0,0,0,0,0,0,0,-188000,0,0,0,0,188000,-188000,-188000
052729,國巨國泰97購03  ,0,0,0,0,0,0,0,0,0,-188000,0,0,0,6000,194000,-188000,-188000
054195,亞泥國泰98購01  ,0,0,0,0,0,0,0,0,0,-188000,0,0,0,50000,238000,-188000,-188000
6416,瑞祺電通        ,532000,1288000,-756000,0,0,0,449000,0,449000,119000,171000,52000,119000,0,0,0,-188000
053197,超眾元富96購02  ,0,0,0,0,0,0,0,0,0,-189000,0,0,0,10000,199000,-189000,-189000
051216,為升元富95購01  ,0,0,0,0,0,0,0,0,0,-189000,0,0,0,10000,199000,-189000,-189000
051365,瀚宇博國泰97購01,0,0,0,0,0,0,0,0,0,-189000,0,0,0,10000,199000,-189000,-189000
1515,力山            ,165000,363000,-198000,0,0,0,0,0,0,9000,0,0,0,9000,0,9000,-189000
058296,明泰凱基99購01  ,0,0,0,0,0,0,0,0,0,-190000,0,0,0,0,190000,-190000,-190000
052550,鴻海國票97購02  ,0,0,0,0,0,0,0,0,0,-190000,0,0,0,0,190000,-190000,-190000
053552,華新科凱基96購08,0,0,0,0,0,0,0,0,0,-190000,0,0,0,35000,225000,-190000,-190000
054056,華新科國票96購02,0,0,0,0,0,0,0,0,0,-190000,0,0,0,0,190000,-190000,-190000
055024,興勤國泰98購01  ,0,0,0,0,0,0,0,0,0,-190000,0,0,0,0,190000,-190000,-190000
058061,貿聯元富9B購01  ,0,0,0,0,0,0,0,0,0,-191000,0,0,0,50000,241000,-191000,-191000
056455,群創凱基9A購01  ,0,0,0,0,0,0,0,0,0,-191000,0,0,0,0,191000,-191000,-191000
051317,亞德客國票96購01,0,0,0,0,0,0,0,0,0,-191000,0,0,0,47000,238000,-191000,-191000
051007,台光電麥證95購01,0,0,0,20000,211000,-191000,0,0,0,-191000,0,0,0,20000,211000,-191000,-191000
055108,智邦凱基98購01  ,0,0,0,0,0,0,0,0,0,-191000,0,0,0,38000,229000,-191000,-191000
054594,國巨麥證97購01  ,0,0,0,44000,235000,-191000,0,0,0,-191000,0,0,0,44000,235000,-191000,-191000
054148,矽創元大96購03  ,0,0,0,0,0,0,0,0,0,-191000,0,0,0,240000,431000,-191000,-191000
055251,華新科統一99購01,0,0,0,0,0,0,0,0,0,-191000,0,0,0,0,191000,-191000,-191000
6285,啟碁            ,316000,511000,-195000,0,0,0,3000,0,3000,1000,8000,3000,5000,17000,21000,-4000,-191000
057136,立積凱基98購02  ,0,0,0,0,0,0,0,0,0,-192000,0,0,0,47000,239000,-192000,-192000
058248,聯茂元大99購05  ,0,0,0,0,0,0,0,0,0,-192000,0,0,0,42000,234000,-192000,-192000
057835,華擎元富9B購01  ,0,0,0,0,0,0,0,0,0,-192000,0,0,0,10000,202000,-192000,-192000
052565,上銀凱基96購01  ,0,0,0,0,0,0,0,0,0,-192000,0,0,0,20000,212000,-192000,-192000
048898,晶相光國泰96購01,0,0,0,0,0,0,0,0,0,-192000,0,0,0,297000,489000,-192000,-192000
050628,美律中信94購02  ,0,0,0,0,0,0,0,0,0,-192000,0,0,0,10000,202000,-192000,-192000
051634,大立光國票96購03,0,0,0,0,0,0,0,0,0,-192000,0,0,0,30000,222000,-192000,-192000
056286,奇鋐永豐97購01  ,0,0,0,0,0,0,0,0,0,-192000,0,0,0,0,192000,-192000,-192000
056364,亞光元大99購02  ,0,0,0,0,0,0,0,0,0,-192000,0,0,0,8000,200000,-192000,-192000
06516P,國巨凱基98售08  ,0,0,0,0,0,0,0,0,0,-192000,0,0,0,14000,206000,-192000,-192000
056749,滬深2X兆豐99購01,0,0,0,0,0,0,0,0,0,-193000,0,0,0,188000,381000,-193000,-193000
049798,台積電元大94購18,0,0,0,0,0,0,0,0,0,-193000,0,0,0,301000,494000,-193000,-193000
051673,玉晶光元大96購04,0,0,0,0,0,0,0,0,0,-193000,0,0,0,79000,272000,-193000,-193000
053032,國巨兆豐97購02  ,0,0,0,0,0,0,0,0,0,-193000,0,0,0,37000,230000,-193000,-193000
055874,中環元富9A購01  ,0,0,0,0,0,0,0,0,0,-193000,0,0,0,30000,223000,-193000,-193000
057453,矽創元富98購01  ,0,0,0,0,0,0,0,0,0,-194000,0,0,0,72000,266000,-194000,-194000
051050,鴻海群益95購03  ,0,0,0,0,0,0,0,0,0,-194000,0,0,0,5000,199000,-194000,-194000
054134,強茂元大96購01  ,0,0,0,0,0,0,0,0,0,-194000,0,0,0,292000,486000,-194000,-194000
057267,康控兆豐99購01  ,0,0,0,0,0,0,0,0,0,-195000,0,0,0,10000,205000,-195000,-195000
052822,泰碩永豐97購01  ,0,0,0,0,0,0,0,0,0,-195000,0,0,0,116000,311000,-195000,-195000
054374,信邦中信96購01  ,0,0,0,0,0,0,0,0,0,-195000,0,0,0,15000,210000,-195000,-195000
054432,台積電台新96購05,0,0,0,0,0,0,0,0,0,-195000,0,0,0,0,195000,-195000,-195000
053808,大成鋼群益97購01,0,0,0,0,0,0,0,0,0,-195000,0,0,0,33000,228000,-195000,-195000
054528,台光電統一96購02,0,0,0,0,0,0,0,0,0,-195000,0,0,0,20000,215000,-195000,-195000
055661,亞德客中信98購01,0,0,0,0,0,0,0,0,0,-195000,0,0,0,5000,200000,-195000,-195000
055681,奇鋐凱基98購03  ,0,0,0,0,0,0,0,0,0,-195000,0,0,0,40000,235000,-195000,-195000
057697,國巨群益98購09  ,0,0,0,0,0,0,0,0,0,-196000,0,0,0,0,196000,-196000,-196000
058332,鴻海元富99購03  ,0,0,0,0,0,0,0,0,0,-196000,0,0,0,15000,211000,-196000,-196000
052574,茂林凱基96購02  ,0,0,0,0,0,0,0,0,0,-196000,0,0,0,0,196000,-196000,-196000
048153,台積電兆豐94購01,0,0,0,0,0,0,0,0,0,-196000,0,0,0,24000,220000,-196000,-196000
052102,台泥兆豐96購01  ,0,0,0,0,0,0,0,0,0,-196000,0,0,0,0,196000,-196000,-196000
054997,文曄元富97購01  ,0,0,0,0,0,0,0,0,0,-196000,0,0,0,0,196000,-196000,-196000
054088,華新群益98購02  ,0,0,0,0,0,0,0,0,0,-196000,0,0,0,0,196000,-196000,-196000
054455,楠梓電群益98購02,0,0,0,0,0,0,0,0,0,-196000,0,0,0,20000,216000,-196000,-196000
054371,台積電中信9C購01,0,0,0,0,0,0,0,0,0,-196000,0,0,0,193000,389000,-196000,-196000
057087,台郡統一99購01  ,0,0,0,0,0,0,0,0,0,-197000,0,0,0,3000,200000,-197000,-197000
050075,南電凱基94購04  ,0,0,0,0,0,0,0,0,0,-197000,0,0,0,94000,291000,-197000,-197000
053897,台郡群益96購01  ,0,0,0,0,0,0,0,0,0,-197000,0,0,0,0,197000,-197000,-197000
8131,福懋科          ,291000,386000,-95000,0,0,0,10000,0,10000,-112000,6000,95000,-89000,0,23000,-23000,-197000
052532,台積電國泰96購07,0,0,0,0,0,0,0,0,0,-198000,0,0,0,107000,305000,-198000,-198000
055580,南茂統一97購01  ,0,0,0,0,0,0,0,0,0,-198000,0,0,0,48000,246000,-198000,-198000
055599,TPK元大97購01   ,0,0,0,0,0,0,0,0,0,-198000,0,0,0,0,198000,-198000,-198000
4155,訊映            ,161000,359000,-198000,0,0,0,0,0,0,0,0,0,0,0,0,0,-198000
056824,元石油富邦9B購01,0,0,0,0,0,0,0,0,0,-199000,0,0,0,0,199000,-199000,-199000
058305,華邦電元大99購02,0,0,0,0,0,0,0,0,0,-199000,0,0,0,0,199000,-199000,-199000
03763P,聯發科元富96售01,0,0,0,0,0,0,0,0,0,-199000,0,0,0,240000,439000,-199000,-199000
050597,聯電麥證94購01  ,0,0,0,0,199000,-199000,0,0,0,-199000,0,0,0,0,199000,-199000,-199000
051528,亞泥國票96購01  ,0,0,0,0,0,0,0,0,0,-199000,0,0,0,100000,299000,-199000,-199000
051359,中信金元大95購01,0,0,0,0,0,0,0,0,0,-199000,0,0,0,355000,554000,-199000,-199000
051354,聯發科元大95購09,0,0,0,0,0,0,0,0,0,-199000,0,0,0,261000,460000,-199000,-199000
053380,南亞科元大97購01,0,0,0,0,0,0,0,0,0,-199000,0,0,0,115000,314000,-199000,-199000
053307,泰碩凱基97購01  ,0,0,0,0,0,0,0,0,0,-199000,0,0,0,160000,359000,-199000,-199000
052387,台積電群益95購08,0,0,0,0,0,0,0,0,0,-199000,0,0,0,697000,896000,-199000,-199000
054551,聯發科凱基98購02,0,0,0,0,0,0,0,0,0,-199000,0,0,0,1000,200000,-199000,-199000
054774,同欣電國票98購01,0,0,0,0,0,0,0,0,0,-199000,0,0,0,222000,421000,-199000,-199000
058406,聯茂元大99購06  ,0,0,0,0,0,0,0,0,0,-200000,0,0,0,53000,253000,-200000,-200000
058498,世紀鋼群益99購01,0,0,0,0,0,0,0,0,0,-200000,0,0,0,106000,306000,-200000,-200000
057762,全新凱基99購03  ,0,0,0,0,0,0,0,0,0,-200000,0,0,0,0,200000,-200000,-200000
058230,國巨元大99購11  ,0,0,0,0,0,0,0,0,0,-200000,0,0,0,0,200000,-200000,-200000
056973,T50反1永昌9C購01,0,0,0,0,0,0,0,0,0,-200000,0,0,0,0,200000,-200000,-200000
057234,宏達電凱基98購05,0,0,0,0,0,0,0,0,0,-200000,0,0,0,110000,310000,-200000,-200000
03664C,臺股指元大05牛01,0,0,0,0,0,0,0,0,0,-200000,0,0,0,10000,210000,-200000,-200000
049551,電子類群益94購01,0,0,0,0,0,0,0,0,0,-200000,0,0,0,0,200000,-200000,-200000
048994,南電元大94購03  ,0,0,0,0,0,0,0,0,0,-200000,0,0,0,0,200000,-200000,-200000
049148,全新元大95購01  ,0,0,0,0,0,0,0,0,0,-200000,0,0,0,0,200000,-200000,-200000
048744,儒鴻元富97購01  ,0,0,0,0,0,0,0,0,0,-200000,0,0,0,40000,240000,-200000,-200000
049937,臺股指元大94購18,0,0,0,0,0,0,0,0,0,-200000,0,0,0,0,200000,-200000,-200000
049949,燿華群益96購01  ,0,0,0,0,0,0,0,0,0,-200000,0,0,0,0,200000,-200000,-200000
050562,瑞昱元富94購02  ,0,0,0,0,0,0,0,0,0,-200000,0,0,0,0,200000,-200000,-200000
050301,矽創凱基94購03  ,0,0,0,0,0,0,0,0,0,-200000,0,0,0,0,200000,-200000,-200000
050240,聯發科凱基94購13,0,0,0,0,0,0,0,0,0,-200000,0,0,0,0,200000,-200000,-200000
050738,臺股指康和94購01,0,0,0,0,0,0,0,0,0,-200000,0,0,0,0,200000,-200000,-200000
053088,奇鋐元大98購01  ,0,0,0,0,0,0,0,0,0,-200000,0,0,0,0,200000,-200000,-200000
054664,台表科元大97購04,0,0,0,0,0,0,0,0,0,-200000,0,0,0,0,200000,-200000,-200000
055109,正崴凱基98購01  ,0,0,0,0,0,0,0,0,0,-200000,0,0,0,0,200000,-200000,-200000
054040,中石化元大9C購01,0,0,0,0,0,0,0,0,0,-200000,0,0,0,0,200000,-200000,-200000
054447,國泰金兆豐96購01,0,0,0,0,0,0,0,0,0,-200000,0,0,0,0,200000,-200000,-200000
055277,旺宏元大97購04  ,0,0,0,0,0,0,0,0,0,-200000,0,0,0,0,200000,-200000,-200000
055348,旺宏凱基97購01  ,0,0,0,0,0,0,0,0,0,-200000,0,0,0,0,200000,-200000,-200000
055935,創意群益97購02  ,0,0,0,0,0,0,0,0,0,-200000,0,0,0,0,200000,-200000,-200000
056337,聯發科凱基98購06,0,0,0,0,0,0,0,0,0,-200000,0,0,0,0,200000,-200000,-200000
6552,易華電          ,150000,349070,-199070,0,0,0,0,0,0,-1000,4000,0,4000,4000,9000,-5000,-200070
057884,華邦電群益98購02,0,0,0,0,0,0,0,0,0,-201000,0,0,0,52000,253000,-201000,-201000
048875,晶相光國票94購01,0,0,0,0,0,0,0,0,0,-201000,0,0,0,10000,211000,-201000,-201000
052576,聯茂凱基96購01  ,0,0,0,0,0,0,0,0,0,-201000,0,0,0,49000,250000,-201000,-201000
050196,嘉聯益元大97購01,0,0,0,0,0,0,0,0,0,-201000,0,0,0,0,201000,-201000,-201000
052167,亞泥元大96購01  ,0,0,0,0,0,0,0,0,0,-201000,0,0,0,254000,455000,-201000,-201000
057704,台虹群益98購03  ,0,0,0,0,0,0,0,0,0,-202000,0,0,0,138000,340000,-202000,-202000
056552,台表科凱基99購01,0,0,0,0,0,0,0,0,0,-202000,0,0,0,189000,391000,-202000,-202000
053860,台積電元大98購03,0,0,0,0,0,0,0,0,0,-202000,0,0,0,0,202000,-202000,-202000
054845,智邦兆豐98購01  ,0,0,0,0,0,0,0,0,0,-202000,0,0,0,20000,222000,-202000,-202000
056994,緯穎兆豐98購02  ,0,0,0,0,0,0,0,0,0,-203000,0,0,0,221000,424000,-203000,-203000
056855,祥碩中信98購02  ,0,0,0,0,0,0,0,0,0,-203000,0,0,0,40000,243000,-203000,-203000
057716,神達統一98購01  ,0,0,0,0,0,0,0,0,0,-203000,0,0,0,64000,267000,-203000,-203000
052491,泰碩國票99購01  ,0,0,0,0,0,0,0,0,0,-203000,0,0,0,242000,445000,-203000,-203000
053779,台光電元大96購02,0,0,0,0,0,0,0,0,0,-203000,0,0,0,42000,245000,-203000,-203000
055337,超眾兆豐98購01  ,0,0,0,0,0,0,0,0,0,-203000,0,0,0,0,203000,-203000,-203000
055490,台光電元大97購01,0,0,0,0,0,0,0,0,0,-203000,0,0,0,0,203000,-203000,-203000
8213,志超            ,204000,407000,-203000,0,0,0,0,0,0,0,0,0,0,0,0,0,-203000
048010,嘉聯益富邦97購01,0,0,0,0,0,0,0,0,0,-204000,0,0,0,10000,214000,-204000,-204000
046476,鴻海統一96購01  ,0,0,0,0,0,0,0,0,0,-204000,0,0,0,121000,325000,-204000,-204000
046650,台表科國泰94購01,0,0,0,0,0,0,0,0,0,-204000,0,0,0,0,204000,-204000,-204000
051489,世芯凱基95購01  ,0,0,0,0,0,0,0,0,0,-204000,0,0,0,126000,330000,-204000,-204000
053057,聯電國泰97購02  ,0,0,0,0,0,0,0,0,0,-204000,0,0,0,111000,315000,-204000,-204000
051863,技嘉凱基95購01  ,0,0,0,0,0,0,0,0,0,-205000,0,0,0,5000,210000,-205000,-205000
055826,中石化元大97購01,0,0,0,0,0,0,0,0,0,-205000,0,0,0,100000,305000,-205000,-205000
053761,健策國泰98購01  ,0,0,0,0,0,0,0,0,0,-205000,0,0,0,947000,1152000,-205000,-205000
054530,台光電國泰97購03,0,0,0,0,0,0,0,0,0,-205000,0,0,0,10000,215000,-205000,-205000
054583,玉晶光統一97購02,0,0,0,0,0,0,0,0,0,-205000,0,0,0,10000,215000,-205000,-205000
6670,復盛應用        ,272000,455000,-183000,0,0,0,0,0,0,-22000,1000,10000,-9000,0,13000,-13000,-205000
057074,立積永豐98購01  ,0,0,0,0,0,0,0,0,0,-206000,0,0,0,234000,440000,-206000,-206000
051670,欣興元大95購06  ,0,0,0,0,0,0,0,0,0,-206000,0,0,0,0,206000,-206000,-206000
05505P,聯發科凱基96售09,0,0,0,0,0,0,0,0,0,-206000,0,0,0,38000,244000,-206000,-206000
055885,大成鋼統一97購02,0,0,0,0,0,0,0,0,0,-206000,0,0,0,89000,295000,-206000,-206000
052833,康控群益96購01  ,0,0,0,0,0,0,0,0,0,-207000,0,0,0,190000,397000,-207000,-207000
052084,台泥元大95購01  ,0,0,0,0,0,0,0,0,0,-207000,0,0,0,97000,304000,-207000,-207000
051205,華新科麥證95購02,0,0,0,0,207000,-207000,0,0,0,-207000,0,0,0,0,207000,-207000,-207000
051170,南電元大95購03  ,0,0,0,0,0,0,0,0,0,-207000,0,0,0,27000,234000,-207000,-207000
057158,義隆永豐99購01  ,0,0,0,0,0,0,0,0,0,-208000,0,0,0,119000,327000,-208000,-208000
058203,信邦凱基99購01  ,0,0,0,0,0,0,0,0,0,-208000,0,0,0,0,208000,-208000,-208000
058109,台灣50元富9B購01,0,0,0,0,0,0,0,0,0,-208000,0,0,0,160000,368000,-208000,-208000
056381,台虹元富98購01  ,0,0,0,0,0,0,0,0,0,-208000,0,0,0,64000,272000,-208000,-208000
056699,光罩國泰99購01  ,0,0,0,0,0,0,0,0,0,-209000,0,0,0,10000,219000,-209000,-209000
048284,臺股指中信95購04,0,0,0,0,0,0,0,0,0,-209000,0,0,0,0,209000,-209000,-209000
053415,聯茂國票97購01  ,0,0,0,0,0,0,0,0,0,-209000,0,0,0,101000,310000,-209000,-209000
055631,創意永豐98購01  ,0,0,0,0,0,0,0,0,0,-209000,0,0,0,30000,239000,-209000,-209000
053976,亞光元大96購02  ,0,0,0,0,0,0,0,0,0,-209000,0,0,0,0,209000,-209000,-209000
2102,泰豐            ,142000,351000,-209000,0,0,0,0,0,0,0,0,0,0,0,0,0,-209000
057035,元油2X元大9B購03,0,0,0,0,0,0,0,0,0,-210000,0,0,0,0,210000,-210000,-210000
057126,台積電凱基99購03,0,0,0,0,0,0,0,0,0,-210000,0,0,0,0,210000,-210000,-210000
057635,中鋼元大98購01  ,0,0,0,0,0,0,0,0,0,-210000,0,0,0,21000,231000,-210000,-210000
049896,聯發科統一94購06,0,0,0,0,0,0,0,0,0,-210000,0,0,0,0,210000,-210000,-210000
048012,嘉晶國票94購01  ,0,0,0,0,0,0,0,0,0,-210000,0,0,0,0,210000,-210000,-210000
046061,中石化凱基98購01,0,0,0,0,0,0,0,0,0,-210000,0,0,0,15000,225000,-210000,-210000
050719,世紀鋼群益96購01,0,0,0,0,0,0,0,0,0,-210000,0,0,0,18000,228000,-210000,-210000
051907,台積電元大97購05,0,0,0,0,0,0,0,0,0,-210000,0,0,0,30000,240000,-210000,-210000
055606,矽創元大97購01  ,0,0,0,0,0,0,0,0,0,-210000,0,0,0,185000,395000,-210000,-210000
057601,中磊群益98購01  ,0,0,0,0,0,0,0,0,0,-211000,0,0,0,98000,309000,-211000,-211000
051025,晶華統一95購01  ,0,0,0,0,0,0,0,0,0,-211000,0,0,0,47000,258000,-211000,-211000
051490,世芯凱基96購01  ,0,0,0,0,0,0,0,0,0,-211000,0,0,0,64000,275000,-211000,-211000
056344,嘉晶凱基98購02  ,0,0,0,0,0,0,0,0,0,-211000,0,0,0,55000,266000,-211000,-211000
05456P,鴻海凱基95售19  ,0,0,0,0,0,0,0,0,0,-211000,0,0,0,27000,238000,-211000,-211000
056986,超眾群益98購03  ,0,0,0,0,0,0,0,0,0,-212000,0,0,0,36000,248000,-212000,-212000
050038,金融類元大94購04,0,0,0,0,0,0,0,0,0,-212000,0,0,0,0,212000,-212000,-212000
04831P,聯詠富邦96售01  ,0,0,0,0,0,0,0,0,0,-212000,0,0,0,30000,242000,-212000,-212000
052900,大成鋼國票97購01,0,0,0,0,0,0,0,0,0,-212000,0,0,0,30000,242000,-212000,-212000
051611,鈺齊群益95購02  ,0,0,0,0,0,0,0,0,0,-212000,0,0,0,0,212000,-212000,-212000
054474,鴻海中信96購03  ,0,0,0,0,0,0,0,0,0,-212000,0,0,0,0,212000,-212000,-212000
053807,T50反1群益96購02,0,0,0,0,0,0,0,0,0,-212000,0,0,0,414000,626000,-212000,-212000
05588P,群創兆豐97售02  ,0,0,0,0,0,0,0,0,0,-212000,0,0,0,40000,252000,-212000,-212000
3014,聯陽            ,1064000,1382000,-318000,0,0,0,0,0,0,106000,7000,12000,-5000,130000,19000,111000,-212000
057579,長榮航中信9A購01,0,0,0,0,0,0,0,0,0,-213000,0,0,0,22000,235000,-213000,-213000
056190,昇陽半統一97購01,0,0,0,0,0,0,0,0,0,-213000,0,0,0,56000,269000,-213000,-213000
055472,大立光凱基97購07,0,0,0,0,0,0,0,0,0,-213000,0,0,0,0,213000,-213000,-213000
054818,奇力新元大97購05,0,0,0,0,0,0,0,0,0,-213000,0,0,0,30000,243000,-213000,-213000
057227,台積電凱基98購15,0,0,0,0,0,0,0,0,0,-214000,0,0,0,2000,216000,-214000,-214000
055875,光罩元富97購02  ,0,0,0,0,0,0,0,0,0,-214000,0,0,0,0,214000,-214000,-214000
1589,永冠-KY         ,161000,327000,-166000,0,0,0,0,0,0,-48000,5000,40000,-35000,0,13000,-13000,-214000
048998,玉晶光國票95購03,0,0,0,0,0,0,0,0,0,-215000,0,0,0,93000,308000,-215000,-215000
00762,元大全球AI      ,2000,2000,0,0,0,0,0,0,0,-215000,0,30000,-30000,315000,500000,-185000,-215000
056297,台光電元大97購04,0,0,0,0,0,0,0,0,0,-215000,0,0,0,69000,284000,-215000,-215000
04763P,臺股指凱基96售05,0,0,0,0,0,0,0,0,0,-216000,0,0,0,326000,542000,-216000,-216000
053931,楠梓電統一96購01,0,0,0,0,0,0,0,0,0,-216000,0,0,0,0,216000,-216000,-216000
053690,南亞科元大96購02,0,0,0,0,0,0,0,0,0,-217000,0,0,0,0,217000,-217000,-217000
055054,群光永豐97購01  ,0,0,0,0,0,0,0,0,0,-217000,0,0,0,0,217000,-217000,-217000
056087,世芯統一97購01  ,0,0,0,0,0,0,0,0,0,-217000,0,0,0,466000,683000,-217000,-217000
055342,鴻海凱基97購04  ,0,0,0,0,0,0,0,0,0,-217000,0,0,0,68000,285000,-217000,-217000
056685,光罩統一98購03  ,0,0,0,0,0,0,0,0,0,-218000,0,0,0,166000,384000,-218000,-218000
049154,玉晶光元大95購02,0,0,0,0,0,0,0,0,0,-218000,0,0,0,2000,220000,-218000,-218000
053118,大立光中信9C購01,0,0,0,0,0,0,0,0,0,-218000,0,0,0,0,218000,-218000,-218000
056115,奇力新群益97購06,0,0,0,0,0,0,0,0,0,-218000,0,0,0,0,218000,-218000,-218000
054043,漢唐元大97購01  ,0,0,0,0,0,0,0,0,0,-218000,0,0,0,50000,268000,-218000,-218000
057623,友訊國泰99購01  ,0,0,0,0,0,0,0,0,0,-219000,0,0,0,10000,229000,-219000,-219000
058219,台灣50國票9A購02,0,0,0,0,0,0,0,0,0,-219000,0,0,0,0,219000,-219000,-219000
058735,南茂永豐99購01  ,35000,0,35000,0,0,0,0,0,0,-254000,0,0,0,77000,331000,-254000,-219000
049023,玉晶光群益96購04,0,0,0,0,0,0,0,0,0,-219000,0,0,0,271000,490000,-219000,-219000
053406,國巨兆豐96購02  ,0,0,0,0,0,0,0,0,0,-219000,0,0,0,25000,244000,-219000,-219000
052462,上銀統一95購03  ,0,0,0,0,0,0,0,0,0,-219000,0,0,0,0,219000,-219000,-219000
055301,台虹元大97購01  ,0,0,0,0,0,0,0,0,0,-219000,0,0,0,63000,282000,-219000,-219000
058319,大毅永豐9A購01  ,0,0,0,0,0,0,0,0,0,-220000,0,0,0,40000,260000,-220000,-220000
052690,台表科元大97購01,0,0,0,0,0,0,0,0,0,-220000,0,0,0,0,220000,-220000,-220000
052863,友達凱基98購02  ,0,0,0,0,0,0,0,0,0,-221000,0,0,0,0,221000,-221000,-221000
053701,台積電兆豐96購05,0,0,0,0,0,0,0,0,0,-221000,0,0,0,566000,787000,-221000,-221000
051507,彩晶元富95購01  ,0,0,0,0,0,0,0,0,0,-221000,0,0,0,30000,251000,-221000,-221000
050251,樺漢凱基94購02  ,0,0,0,0,0,0,0,0,0,-221000,0,0,0,0,221000,-221000,-221000
055446,奇力新統一9A購01,0,0,0,0,0,0,0,0,0,-221000,0,0,0,50000,271000,-221000,-221000
056173,廣達元富97購01  ,0,0,0,0,0,0,0,0,0,-221000,0,0,0,90000,311000,-221000,-221000
053896,麗豐群益97購01  ,0,0,0,0,0,0,0,0,0,-221000,0,0,0,4000,225000,-221000,-221000
054288,華邦電元大96購05,0,0,0,0,0,0,0,0,0,-221000,0,0,0,242000,463000,-221000,-221000
058382,S&P500中信99購01,0,0,0,0,0,0,0,0,0,-222000,0,0,0,0,222000,-222000,-222000
051344,鴻海元大95購08  ,0,0,0,0,0,0,0,0,0,-222000,0,0,0,0,222000,-222000,-222000
052287,臺股指中信95購12,0,0,0,0,0,0,0,0,0,-222000,0,0,0,1568000,1790000,-222000,-222000
055726,台表科元大98購03,0,0,0,0,0,0,0,0,0,-222000,0,0,0,0,222000,-222000,-222000
9945,潤泰新          ,863000,1135723,-272723,0,0,0,3000,0,3000,47000,20000,5000,15000,32000,0,32000,-222723
057489,奇力新元大99購06,0,0,0,0,0,0,0,0,0,-223000,0,0,0,0,223000,-223000,-223000
054301,楠梓電凱基98購01,0,0,0,0,0,0,0,0,0,-223000,0,0,0,5000,228000,-223000,-223000
053548,旺宏凱基96購04  ,0,0,0,0,0,0,0,0,0,-224000,0,0,0,20000,244000,-224000,-224000
054593,滬深2X永昌9A購01,0,0,0,0,0,0,0,0,0,-224000,0,0,0,175000,399000,-224000,-224000
06408P,聯茂元富97售02  ,0,0,0,0,0,0,0,0,0,-224000,0,0,0,85000,309000,-224000,-224000
056446,聯發科凱基98購08,0,0,0,0,0,0,0,0,0,-225000,0,0,0,2000,227000,-225000,-225000
053323,群創群益98購07  ,0,0,0,0,0,0,0,0,0,-225000,0,0,0,0,225000,-225000,-225000
051989,華固元大95購02  ,0,0,0,0,0,0,0,0,0,-225000,0,0,0,1000,226000,-225000,-225000
051047,深中小群益99購01,0,0,0,0,0,0,0,0,0,-225000,0,0,0,0,225000,-225000,-225000
051879,健策台新96購01  ,0,0,0,0,0,0,0,0,0,-225000,0,0,0,25000,250000,-225000,-225000
054918,華新科凱基98購02,0,0,0,0,0,0,0,0,0,-225000,0,0,0,10000,235000,-225000,-225000
057517,矽創元富98購02  ,0,0,0,0,0,0,0,0,0,-226000,0,0,0,57000,283000,-226000,-226000
057135,立積凱基98購01  ,0,0,0,0,0,0,0,0,0,-226000,0,0,0,91000,317000,-226000,-226000
049524,可成兆豐95購02  ,0,0,0,0,0,0,0,0,0,-226000,0,0,0,0,226000,-226000,-226000
053316,友達群益9A購01  ,0,0,0,0,0,0,0,0,0,-226000,0,0,0,71000,297000,-226000,-226000
054672,華新科國泰99購01,0,0,0,0,0,0,0,0,0,-226000,0,0,0,63000,289000,-226000,-226000
054358,矽創兆豐96購01  ,0,0,0,0,0,0,0,0,0,-226000,0,0,0,38000,264000,-226000,-226000
057953,聚陽元大98購01  ,0,0,0,0,0,0,0,0,0,-227000,0,0,0,226000,453000,-227000,-227000
048049,滬深反中信96購01,0,0,0,0,0,0,0,0,0,-227000,0,0,0,28000,255000,-227000,-227000
055025,華新科國泰98購02,0,0,0,0,0,0,0,0,0,-227000,0,0,0,25000,252000,-227000,-227000
058437,可成統一9B購01  ,0,0,0,0,0,0,0,0,0,-228000,0,0,0,0,228000,-228000,-228000
056719,台虹永豐98購01  ,0,0,0,0,0,0,0,0,0,-228000,0,0,0,68000,296000,-228000,-228000
053337,聯電國票97購01  ,0,0,0,0,0,0,0,0,0,-228000,0,0,0,30000,258000,-228000,-228000
056330,玉晶光國票99購03,0,0,0,0,0,0,0,0,0,-228000,0,0,0,32000,260000,-228000,-228000
057266,TPK兆豐98購02   ,0,0,0,0,0,0,0,0,0,-229000,0,0,0,0,229000,-229000,-229000
057529,嘉晶元大99購02  ,0,0,0,0,0,0,0,0,0,-229000,0,0,0,333000,562000,-229000,-229000
048813,元黃金凱基94購01,0,0,0,0,0,0,0,0,0,-229000,0,0,0,2000,231000,-229000,-229000
051099,台郡元大95購03  ,0,0,0,0,0,0,0,0,0,-229000,0,0,0,16000,245000,-229000,-229000
055428,友達群益9C購01  ,0,0,0,0,0,0,0,0,0,-229000,0,0,0,21000,250000,-229000,-229000
054345,世芯國票96購02  ,0,0,0,0,0,0,0,0,0,-229000,0,0,0,0,229000,-229000,-229000
054461,台積電凱基97購09,0,0,0,0,0,0,0,0,0,-229000,0,0,0,71000,300000,-229000,-229000
06557P,台積電兆豐98售02,0,0,0,0,0,0,0,0,0,-229000,0,0,0,136000,365000,-229000,-229000
056525,T50反1凱基99購06,0,0,0,0,0,0,0,0,0,-230000,0,0,0,110000,340000,-230000,-230000
057936,健策群益99購01  ,0,0,0,0,0,0,0,0,0,-230000,0,0,0,52000,282000,-230000,-230000
058260,華新科富邦9C購01,0,0,0,0,0,0,0,0,0,-230000,0,0,0,0,230000,-230000,-230000
049668,大立光國泰96購02,0,0,0,0,0,0,0,0,0,-230000,0,0,0,164000,394000,-230000,-230000
046207,群創國泰94購02  ,0,0,0,0,0,0,0,0,0,-230000,0,0,0,0,230000,-230000,-230000
051467,GIS富邦96購01   ,0,0,0,0,0,0,0,0,0,-230000,0,0,0,0,230000,-230000,-230000
053029,國巨第一96購01  ,0,0,0,0,0,0,0,0,0,-230000,0,0,0,92000,322000,-230000,-230000
051753,華通元大96購03  ,0,0,0,0,0,0,0,0,0,-230000,0,0,0,0,230000,-230000,-230000
06859P,元金2X中信9C售01,0,0,0,0,0,0,0,0,0,-230000,0,0,0,64000,294000,-230000,-230000
057937,神達群益98購02  ,0,0,0,0,0,0,0,0,0,-231000,0,0,0,114000,345000,-231000,-231000
057909,台光電兆豐98購01,0,0,0,0,0,0,0,0,0,-231000,0,0,0,22000,253000,-231000,-231000
057018,亞德客凱基98購01,0,0,0,0,0,0,0,0,0,-231000,0,0,0,20000,251000,-231000,-231000
053695,智易元大97購02  ,0,0,0,0,0,0,0,0,0,-231000,0,0,0,0,231000,-231000,-231000
050790,昇陽半國泰96購02,0,0,0,0,0,0,0,0,0,-231000,0,0,0,0,231000,-231000,-231000
6197,佳必琪          ,48000,279000,-231000,0,0,0,0,0,0,0,0,0,0,0,0,0,-231000
051097,嘉聯益元大96購02,0,0,0,0,0,0,0,0,0,-232000,0,0,0,105000,337000,-232000,-232000
051946,健策統一98購01  ,0,0,0,0,0,0,0,0,0,-232000,0,0,0,125000,357000,-232000,-232000
053827,漢唐麥證9A購01  ,0,0,0,0,232000,-232000,0,0,0,-232000,0,0,0,0,232000,-232000,-232000
058267,奇鋐永豐99購01  ,0,0,0,0,0,0,0,0,0,-233000,0,0,0,0,233000,-233000,-233000
058718,台灣50元富03購01,0,0,0,0,0,0,0,0,0,-233000,0,0,0,0,233000,-233000,-233000
048259,新日興統一93購01,0,0,0,0,0,0,0,0,0,-233000,0,0,0,0,233000,-233000,-233000
048937,玉晶光永豐95購01,0,0,0,0,0,0,0,0,0,-233000,0,0,0,136000,369000,-233000,-233000
049233,聯發科統一94購04,0,0,0,0,0,0,0,0,0,-233000,0,0,0,56000,289000,-233000,-233000
053074,嘉晶永豐96購02  ,0,0,0,0,0,0,0,0,0,-233000,0,0,0,42000,275000,-233000,-233000
050197,矽格元大94購04  ,0,0,0,0,0,0,0,0,0,-233000,0,0,0,25000,258000,-233000,-233000
052217,台光電日盛95購01,0,0,0,0,0,0,0,0,0,-233000,0,0,0,0,233000,-233000,-233000
058245,訊連元大99購01  ,0,0,0,0,0,0,0,0,0,-234000,0,0,0,20000,254000,-234000,-234000
047046,台積電國票94購01,0,0,0,0,0,0,0,0,0,-234000,0,0,0,40000,274000,-234000,-234000
04168P,元金2X凱基99售01,0,0,0,0,0,0,0,0,0,-234000,0,0,0,466000,700000,-234000,-234000
053689,台光電元大96購01,0,0,0,0,0,0,0,0,0,-234000,0,0,0,36000,270000,-234000,-234000
056356,台積電元大99購01,0,0,0,0,0,0,0,0,0,-234000,0,0,0,182000,416000,-234000,-234000
1519,華城            ,301000,438000,-137000,0,0,0,0,100000,-100000,3000,3000,0,3000,0,0,0,-234000
058090,聯發科元大98購16,0,0,0,0,0,0,0,0,0,-235000,0,0,0,204000,439000,-235000,-235000
058629,嘉晶國票9A購01  ,0,0,0,0,0,0,0,0,0,-235000,0,0,0,12000,247000,-235000,-235000
03857P,聯發科元富99售02,0,0,0,0,0,0,0,0,0,-235000,0,0,0,1000,236000,-235000,-235000
047571,滬深2X群益99購01,0,0,0,0,0,0,0,0,0,-235000,0,0,0,542000,777000,-235000,-235000
051700,深中小群益99購04,0,0,0,0,0,0,0,0,0,-235000,0,0,0,0,235000,-235000,-235000
052621,台郡富邦97購01  ,0,0,0,0,0,0,0,0,0,-235000,0,0,0,0,235000,-235000,-235000
050264,聯發科元大94購13,0,0,0,0,0,0,0,0,0,-235000,0,0,0,101000,336000,-235000,-235000
053852,南亞科國泰98購01,0,0,0,0,0,0,0,0,0,-235000,0,0,0,0,235000,-235000,-235000
057200,技嘉元富98購01  ,0,0,0,0,0,0,0,0,0,-236000,0,0,0,60000,296000,-236000,-236000
055517,國巨中信97購03  ,0,0,0,0,0,0,0,0,0,-237000,0,0,0,105000,342000,-237000,-237000
06459P,亞德客元富98售01,0,0,0,0,0,0,0,0,0,-237000,0,0,0,17000,254000,-237000,-237000
049562,和大統一94購01  ,0,0,0,0,0,0,0,0,0,-238000,0,0,0,0,238000,-238000,-238000
055789,台虹凱基97購01  ,55000,0,55000,0,0,0,0,0,0,-293000,0,0,0,13000,306000,-293000,-238000
054768,泰碩國票99購02  ,0,0,0,0,0,0,0,0,0,-238000,0,0,0,229000,467000,-238000,-238000
056650,彩晶凱基9A購01  ,0,0,0,0,0,0,0,0,0,-239000,0,0,0,0,239000,-239000,-239000
051390,京元電兆豐95購01,0,0,0,0,0,0,0,0,0,-239000,0,0,0,0,239000,-239000,-239000
053755,亞光元富96購01  ,0,0,0,0,0,0,0,0,0,-239000,0,0,0,0,239000,-239000,-239000
3041,揚智            ,697000,936000,-239000,0,0,0,0,0,0,0,0,0,0,0,0,0,-239000
057865,富邦金凱基98購01,0,0,0,0,0,0,0,0,0,-240000,0,0,0,30000,270000,-240000,-240000
045600,道瓊指國票95購01,0,0,0,0,0,0,0,0,0,-240000,0,0,0,0,240000,-240000,-240000
052809,訊芯元大97購01  ,0,0,0,0,0,0,0,0,0,-240000,0,0,0,441000,681000,-240000,-240000
052857,大成鋼凱基96購01,0,0,0,0,0,0,0,0,0,-240000,0,0,0,10000,250000,-240000,-240000
053389,彩晶元大98購01  ,0,0,0,0,0,0,0,0,0,-240000,0,0,0,170000,410000,-240000,-240000
051953,矽力元富95購03  ,0,0,0,0,0,0,0,0,0,-240000,0,0,0,83000,323000,-240000,-240000
050956,鈺齊群益95購01  ,0,0,0,0,0,0,0,0,0,-240000,0,0,0,0,240000,-240000,-240000
054034,景碩中信96購01  ,0,0,0,0,0,0,0,0,0,-240000,0,0,0,0,240000,-240000,-240000
054117,宏全康和96購01  ,0,0,0,0,0,0,0,0,0,-240000,0,0,0,0,240000,-240000,-240000
054688,兆赫永豐97購01  ,0,0,0,0,0,0,0,0,0,-240000,0,0,0,0,240000,-240000,-240000
055003,群創元富99購05  ,0,0,0,0,0,0,0,0,0,-240000,0,0,0,0,240000,-240000,-240000
055738,玉山金元富97購01,0,0,0,0,0,0,0,0,0,-240000,0,0,0,20000,260000,-240000,-240000
055548,旺宏凱基97購02  ,0,0,0,0,0,0,0,0,0,-240000,0,0,0,1000,241000,-240000,-240000
057784,台積電國票9B購01,0,0,0,0,0,0,0,0,0,-241000,0,0,0,79000,320000,-241000,-241000
049782,世紀鋼統一94購01,0,0,0,0,0,0,0,0,0,-241000,0,0,0,47000,288000,-241000,-241000
052171,台積電元大95購21,0,0,0,0,0,0,0,0,0,-241000,0,0,0,64000,305000,-241000,-241000
055670,矽創群益98購02  ,0,0,0,0,0,0,0,0,0,-241000,0,0,0,164000,405000,-241000,-241000
054308,嘉晶凱基98購01  ,0,0,0,0,0,0,0,0,0,-241000,0,0,0,105000,346000,-241000,-241000
054332,世芯永豐97購01  ,0,0,0,0,0,0,0,0,0,-241000,0,0,0,164000,405000,-241000,-241000
058350,T50正2凱基9B購01,0,0,0,0,0,0,0,0,0,-242000,0,0,0,10000,252000,-242000,-242000
057309,南茂兆豐99購01  ,0,0,0,0,0,0,0,0,0,-242000,0,0,0,131000,373000,-242000,-242000
049625,智易群益95購01  ,0,0,0,0,0,0,0,0,0,-242000,0,0,0,78000,320000,-242000,-242000
051191,可成兆豐96購01  ,0,0,0,0,0,0,0,0,0,-242000,0,0,0,0,242000,-242000,-242000
06193P,台積電元富97售04,0,0,0,0,0,0,0,0,0,-242000,0,0,0,78000,320000,-242000,-242000
058132,義隆元大99購03  ,0,0,0,0,0,0,0,0,0,-243000,0,0,0,71000,314000,-243000,-243000
058126,元油2X元大9C購02,0,0,0,0,0,0,0,0,0,-243000,0,0,0,297000,540000,-243000,-243000
051446,中壽元大96購01  ,0,0,0,0,0,0,0,0,0,-243000,0,0,0,100000,343000,-243000,-243000
056338,聯發科凱基99購01,0,0,0,0,0,0,0,0,0,-243000,0,0,0,45000,288000,-243000,-243000
057783,台積電國票9A購01,0,0,0,0,0,0,0,0,0,-244000,0,0,0,21000,265000,-244000,-244000
058507,美律元大9A購01  ,0,0,0,0,0,0,0,0,0,-244000,0,0,0,100000,344000,-244000,-244000
058470,台灣50日盛9B購02,0,0,0,0,0,0,0,0,0,-244000,0,0,0,0,244000,-244000,-244000
057249,華邦電統一9A購01,0,0,0,0,0,0,0,0,0,-244000,0,0,0,45000,289000,-244000,-244000
052884,台積電兆豐96購01,0,0,0,0,0,0,0,0,0,-244000,0,0,0,155000,399000,-244000,-244000
049100,華新科國泰96購01,0,0,0,0,0,0,0,0,0,-244000,0,0,0,10000,254000,-244000,-244000
057317,技嘉凱基98購02  ,0,0,0,0,0,0,0,0,0,-245000,0,0,0,0,245000,-245000,-245000
047886,京元電富邦95購01,0,0,0,0,0,0,0,0,0,-245000,0,0,0,10000,255000,-245000,-245000
052095,彩晶元大97購01  ,0,0,0,0,0,0,0,0,0,-245000,0,0,0,1000,246000,-245000,-245000
054370,台積電中信9A購01,0,0,0,0,0,0,0,0,0,-245000,0,0,0,21000,266000,-245000,-245000
057806,國巨元大98購20  ,0,0,0,0,0,0,0,0,0,-246000,0,0,0,137000,383000,-246000,-246000
049735,台光電群益94購03,0,0,0,0,0,0,0,0,0,-246000,0,0,0,0,246000,-246000,-246000
053269,同欣電群益96購01,0,0,0,0,0,0,0,0,0,-246000,0,0,0,78000,324000,-246000,-246000
056313,聯茂元大98購01  ,0,0,0,0,0,0,0,0,0,-246000,0,0,0,23000,269000,-246000,-246000
055525,國巨群益98購05  ,0,0,0,0,0,0,0,0,0,-247000,0,0,0,104000,351000,-247000,-247000
057889,致新群益99購01  ,0,0,0,0,0,0,0,0,0,-248000,0,0,0,0,248000,-248000,-248000
057156,元油2X富邦9C購01,0,0,0,0,0,0,0,0,0,-248000,0,0,0,0,248000,-248000,-248000
056790,彩晶群益98購03  ,0,0,0,0,0,0,0,0,0,-248000,0,0,0,0,248000,-248000,-248000
046628,大立光統一98購01,0,0,0,0,0,0,0,0,0,-248000,0,0,0,71000,319000,-248000,-248000
05564P,玉晶光元大97售02,0,0,0,0,0,0,0,0,0,-248000,0,0,0,55000,303000,-248000,-248000
055292,聯鈞元大97購02  ,0,0,0,0,0,0,0,0,0,-248000,0,0,0,24000,272000,-248000,-248000
054229,超眾元富96購05  ,0,0,0,0,0,0,0,0,0,-248000,0,0,0,17000,265000,-248000,-248000
056632,鴻海永昌98購01  ,0,0,0,0,0,0,0,0,0,-249000,0,0,0,76000,325000,-249000,-249000
057414,華新科日盛9A購01,0,0,0,0,0,0,0,0,0,-249000,0,0,0,12000,261000,-249000,-249000
058523,聯茂元大99購08  ,0,0,0,0,0,0,0,0,0,-249000,0,0,0,10000,259000,-249000,-249000
048269,瀚宇博國泰95購01,0,0,0,0,0,0,0,0,0,-249000,0,0,0,1000,250000,-249000,-249000
050519,旺宏元大95購03  ,0,0,0,0,0,0,0,0,0,-249000,0,0,0,383000,632000,-249000,-249000
055180,文曄統一97購01  ,0,0,0,0,0,0,0,0,0,-249000,0,0,0,0,249000,-249000,-249000
048154,旺宏兆豐94購01  ,0,0,0,0,0,0,0,0,0,-250000,0,0,0,0,250000,-250000,-250000
048726,儒鴻麥證95購01  ,0,0,0,60000,310000,-250000,0,0,0,-250000,0,0,0,60000,310000,-250000,-250000
052004,泰碩國泰97購03  ,0,0,0,0,0,0,0,0,0,-250000,0,0,0,39000,289000,-250000,-250000
050838,為升國票96購01  ,0,0,0,0,0,0,0,0,0,-250000,0,0,0,0,250000,-250000,-250000
050915,健策中信98購01  ,0,0,0,0,0,0,0,0,0,-250000,0,0,0,213000,463000,-250000,-250000
053131,華通國票97購03  ,0,0,0,0,0,0,0,0,0,-250000,0,0,0,0,250000,-250000,-250000
051913,緯創元大96購01  ,0,0,0,0,0,0,0,0,0,-250000,0,0,0,0,250000,-250000,-250000
051066,台積電國票96購02,0,0,0,0,0,0,0,0,0,-250000,0,0,0,0,250000,-250000,-250000
055189,台虹統一97購01  ,0,0,0,0,0,0,0,0,0,-250000,0,0,0,0,250000,-250000,-250000
1514,亞力            ,290000,540000,-250000,0,0,0,0,0,0,0,0,0,0,0,0,0,-250000
057687,中502X凱基98購01,0,0,0,0,0,0,0,0,0,-251000,0,0,0,0,251000,-251000,-251000
057214,瑞昱群益98購01  ,0,0,0,0,0,0,0,0,0,-251000,0,0,0,245000,496000,-251000,-251000
05664P,國巨凱基96售09  ,0,0,0,0,0,0,0,0,0,-251000,0,0,0,56000,307000,-251000,-251000
055184,群創統一98購02  ,0,0,0,0,0,0,0,0,0,-251000,0,0,0,0,251000,-251000,-251000
06154P,超眾元大98售01  ,0,0,0,0,0,0,0,0,0,-251000,0,0,0,271000,522000,-251000,-251000
050976,台光電統一95購01,0,0,0,0,0,0,0,0,0,-252000,0,0,0,0,252000,-252000,-252000
055283,聯發科元大97購16,0,0,0,0,0,0,0,0,0,-252000,0,0,0,66000,318000,-252000,-252000
054294,世芯元大96購02  ,0,0,0,0,0,0,0,0,0,-252000,0,0,0,8000,260000,-252000,-252000
048848,滬深2X群益98購02,0,0,0,0,0,0,0,0,0,-253000,0,0,0,281000,534000,-253000,-253000
03050X,元展47          ,0,0,0,0,0,0,0,0,0,-253000,0,0,0,3000,256000,-253000,-253000
050974,大成鋼統一95購01,0,0,0,0,0,0,0,0,0,-253000,0,0,0,100000,353000,-253000,-253000
053995,奇力新群益97購02,0,0,0,0,0,0,0,0,0,-253000,0,0,0,20000,273000,-253000,-253000
4551,智伸科          ,160000,111000,49000,0,0,0,0,302000,-302000,0,17000,13000,4000,2000,6000,-4000,-253000
058289,奇鋐國票9A購01  ,0,0,0,0,0,0,0,0,0,-254000,0,0,0,10000,264000,-254000,-254000
04313P,國巨元富95售03  ,0,0,0,0,0,0,0,0,0,-254000,0,0,0,0,254000,-254000,-254000
053436,聯茂日盛96購01  ,0,0,0,0,0,0,0,0,0,-254000,0,0,0,0,254000,-254000,-254000
057287,彩晶元大9C購03  ,0,0,0,0,0,0,0,0,0,-255000,0,0,0,0,255000,-255000,-255000
049260,華新科元大96購01,0,0,0,0,0,0,0,0,0,-255000,0,0,0,144000,399000,-255000,-255000
052894,國巨群益96購03  ,0,0,0,0,0,0,0,0,0,-255000,0,0,0,300000,555000,-255000,-255000
051829,玉晶光元大98購02,0,0,0,0,0,0,0,0,0,-255000,0,0,0,102000,357000,-255000,-255000
054763,宏達電國票99購01,0,0,0,0,0,0,0,0,0,-255000,0,0,0,91000,346000,-255000,-255000
052927,友達元大98購02  ,0,0,0,0,0,0,0,0,0,-256000,0,0,0,410000,666000,-256000,-256000
04600P,可成凱基94售07  ,0,0,0,0,0,0,0,0,0,-256000,0,0,0,0,256000,-256000,-256000
1717,長興            ,221000,356000,-135000,0,0,0,0,0,0,-121000,14000,135000,-121000,0,0,0,-256000
052534,貿聯國泰96購02  ,0,0,0,0,0,0,0,0,0,-257000,0,0,0,10000,267000,-257000,-257000
055442,矽創國票98購02  ,0,0,0,0,0,0,0,0,0,-257000,0,0,0,40000,297000,-257000,-257000
1440,南紡            ,388000,648000,-260000,0,0,0,0,0,0,3000,3000,0,3000,0,0,0,-257000
044988,玉晶光統一95購01,0,0,0,0,0,0,0,0,0,-258000,0,0,0,26000,284000,-258000,-258000
056673,中石化元富9B購01,0,0,0,0,0,0,0,0,0,-259000,0,0,0,10000,269000,-259000,-259000
046624,彩晶凱基94購02  ,0,0,0,0,0,0,0,0,0,-259000,0,0,0,0,259000,-259000,-259000
3189,景碩            ,918000,1181000,-263000,0,0,0,0,0,0,4000,178000,150000,28000,21000,45000,-24000,-259000
057264,新光金兆豐98購01,0,0,0,0,0,0,0,0,0,-260000,0,0,0,50000,310000,-260000,-260000
058614,台郡元大9A購01  ,0,0,0,0,0,0,0,0,0,-260000,0,0,0,152000,412000,-260000,-260000
00664R,國泰臺灣加權反1 ,0,10000,-10000,0,0,0,0,0,0,-250000,0,0,0,2122000,2372000,-250000,-260000
050566,高股息中信97購02,0,0,0,0,0,0,0,0,0,-260000,0,0,0,10000,270000,-260000,-260000
055796,南電國泰98購01  ,0,0,0,0,0,0,0,0,0,-260000,0,0,0,0,260000,-260000,-260000
054121,奇鋐永豐96購02  ,0,0,0,0,0,0,0,0,0,-260000,0,0,0,0,260000,-260000,-260000
06367P,台積電凱基97售14,0,0,0,0,0,0,0,0,0,-260000,0,0,0,1150000,1410000,-260000,-260000
057207,立積元富98購02  ,0,0,0,0,0,0,0,0,0,-261000,0,0,0,94000,355000,-261000,-261000
047850,彩晶統一94購01  ,0,0,0,0,0,0,0,0,0,-261000,0,0,0,0,261000,-261000,-261000
055085,大毅國票97購01  ,0,0,0,0,0,0,0,0,0,-261000,0,0,0,17000,278000,-261000,-261000
055168,光罩統一98購01  ,0,0,0,0,0,0,0,0,0,-261000,0,0,0,0,261000,-261000,-261000
056277,上銀富邦99購02  ,0,0,0,0,0,0,0,0,0,-261000,0,0,0,0,261000,-261000,-261000
055660,台光電兆豐97購01,0,0,0,0,0,0,0,0,0,-261000,0,0,0,10000,271000,-261000,-261000
057220,鈺齊群益98購01  ,0,0,0,0,0,0,0,0,0,-262000,0,0,0,22000,284000,-262000,-262000
055651,富邦金元富97購01,0,0,0,0,0,0,0,0,0,-262000,0,0,0,235000,497000,-262000,-262000
055547,台積電凱基97購13,0,0,0,0,0,0,0,0,0,-262000,0,0,0,0,262000,-262000,-262000
03414B,臺股指凱基99熊01,2000,0,2000,0,0,0,0,0,0,-265000,0,0,0,192000,457000,-265000,-263000
054352,世芯國泰98購01  ,0,0,0,0,0,0,0,0,0,-263000,0,0,0,97000,360000,-263000,-263000
056747,致新凱基99購01  ,0,0,0,0,0,0,0,0,0,-264000,0,0,0,67000,331000,-264000,-264000
00675L,富邦臺灣加權正2 ,0,58000,-58000,0,0,0,0,0,0,-206000,0,0,0,157000,363000,-206000,-264000
055469,台光電凱基97購01,0,0,0,0,0,0,0,0,0,-264000,0,0,0,15000,279000,-264000,-264000
057097,致新元富98購01  ,0,0,0,0,0,0,0,0,0,-265000,0,0,0,38000,303000,-265000,-265000
05327P,臺股指凱基95售11,0,0,0,0,0,0,0,0,0,-265000,0,0,0,5000,270000,-265000,-265000
055594,華新科元大98購02,0,0,0,0,0,0,0,0,0,-265000,0,0,0,15000,280000,-265000,-265000
055271,鴻海元大98購03  ,0,0,0,0,0,0,0,0,0,-265000,0,0,0,68000,333000,-265000,-265000
054202,樺漢富邦97購01  ,0,0,0,0,0,0,0,0,0,-265000,0,0,0,0,265000,-265000,-265000
054850,上海銀兆豐97購01,0,0,0,0,0,0,0,0,0,-265000,0,0,0,12000,277000,-265000,-265000
049607,台積電兆豐94購04,0,0,0,0,0,0,0,0,0,-266000,0,0,0,20000,286000,-266000,-266000
049897,華新科統一94購07,0,0,0,0,0,0,0,0,0,-266000,0,0,0,64000,330000,-266000,-266000
054985,光罩元富97購01  ,0,0,0,0,0,0,0,0,0,-267000,0,0,0,0,267000,-267000,-267000
050897,嘉晶元大95購03  ,0,0,0,0,0,0,0,0,0,-268000,0,0,0,54000,322000,-268000,-268000
042752,台灣50元大96購03,0,0,0,0,0,0,0,0,0,-269000,0,0,0,36000,305000,-269000,-269000
050523,義隆元大94購05  ,0,0,0,0,0,0,0,0,0,-269000,0,0,0,0,269000,-269000,-269000
04549P,茂林元大94售02  ,0,0,0,0,0,0,0,0,0,-270000,0,0,0,0,270000,-270000,-270000
052388,旺宏群益96購05  ,0,0,0,0,0,0,0,0,0,-270000,0,0,0,164000,434000,-270000,-270000
055000,玉晶光元富97購04,0,0,0,0,0,0,0,0,0,-270000,0,0,0,0,270000,-270000,-270000
054620,南茂永豐97購01  ,0,0,0,0,0,0,0,0,0,-270000,0,0,0,20000,290000,-270000,-270000
05547P,群創元大96售03  ,0,0,0,0,0,0,0,0,0,-270000,0,0,0,115000,385000,-270000,-270000
056099,上銀永豐97購02  ,0,0,0,0,0,0,0,0,0,-270000,0,0,0,500000,770000,-270000,-270000
058398,中環元大99購02  ,0,0,0,0,0,0,0,0,0,-271000,0,0,0,0,271000,-271000,-271000
049982,嘉晶凱基94購01  ,0,0,0,0,0,0,0,0,0,-271000,0,0,0,1000,272000,-271000,-271000
055879,神達元富97購01  ,0,0,0,0,0,0,0,0,0,-271000,0,0,0,65000,336000,-271000,-271000
6192,巨路            ,60000,332000,-272000,0,0,0,0,0,0,1000,2000,1000,1000,0,0,0,-271000
049302,聯茂日盛94購01  ,0,0,0,0,0,0,0,0,0,-272000,0,0,0,0,272000,-272000,-272000
050685,緯穎元富94購02  ,0,0,0,0,0,0,0,0,0,-273000,0,0,0,79000,352000,-273000,-273000
052231,景碩凱基96購01  ,0,0,0,0,0,0,0,0,0,-274000,0,0,0,281000,555000,-274000,-274000
052072,健策統一95購02  ,0,0,0,0,0,0,0,0,0,-274000,0,0,0,3000,277000,-274000,-274000
055744,茂林元富97購02  ,0,0,0,0,0,0,0,0,0,-274000,0,0,0,432000,706000,-274000,-274000
2354,鴻準            ,988000,1299563,-311563,0,0,0,2000,0,2000,35000,40000,5000,35000,0,0,0,-274563
057402,嘉晶群益98購02  ,0,0,0,0,0,0,0,0,0,-275000,0,0,0,130000,405000,-275000,-275000
051464,彩晶國泰96購01  ,0,0,0,0,0,0,0,0,0,-275000,0,0,0,0,275000,-275000,-275000
056850,彩晶元富99購01  ,0,0,0,0,0,0,0,0,0,-276000,0,0,0,0,276000,-276000,-276000
044963,台積電中信96購01,0,5000,-5000,0,0,0,0,0,0,-271000,0,0,0,36000,307000,-271000,-276000
054493,同欣電台新96購01,0,0,0,0,0,0,0,0,0,-276000,0,0,0,43000,319000,-276000,-276000
057804,為升元大98購01  ,0,0,0,0,0,0,0,0,0,-277000,0,0,0,85000,362000,-277000,-277000
049153,大立光元大96購02,0,0,0,0,0,0,0,0,0,-277000,0,0,0,118000,395000,-277000,-277000
050543,聯發科凱基95購01,0,0,0,0,0,0,0,0,0,-277000,0,0,0,5000,282000,-277000,-277000
055876,美食元富9A購01  ,0,0,0,0,0,0,0,0,0,-277000,0,0,0,220000,497000,-277000,-277000
056025,嘉晶群益97購01  ,0,0,0,0,0,0,0,0,0,-277000,0,0,0,0,277000,-277000,-277000
057659,台表科兆豐98購01,0,0,0,0,0,0,0,0,0,-278000,0,0,0,52000,330000,-278000,-278000
057315,台灣50康和9A購03,0,0,0,0,0,0,0,0,0,-278000,0,0,0,50000,328000,-278000,-278000
051915,日月光元大96購01,0,0,0,0,0,0,0,0,0,-278000,0,0,0,0,278000,-278000,-278000
050481,泰鼎國票96購01  ,0,0,0,0,0,0,0,0,0,-278000,0,0,0,10000,288000,-278000,-278000
053560,漢唐國泰98購01  ,0,0,0,0,0,0,0,0,0,-278000,0,0,0,20000,298000,-278000,-278000
055350,聯發科凱基97購02,0,0,0,0,0,0,0,0,0,-278000,0,0,0,0,278000,-278000,-278000
054944,精元元大97購01  ,0,0,0,0,0,0,0,0,0,-278000,0,0,0,0,278000,-278000,-278000
058480,新日興凱基9A購01,0,0,0,0,0,0,0,0,0,-279000,0,0,0,14000,293000,-279000,-279000
058315,TPK富邦9C購01   ,0,0,0,0,0,0,0,0,0,-280000,0,0,0,5000,285000,-280000,-280000
050950,健鼎群益96購01  ,0,0,0,0,0,0,0,0,0,-280000,0,0,0,82000,362000,-280000,-280000
057737,國巨富邦99購02  ,0,70000,-70000,0,0,0,0,0,0,-211000,0,0,0,160000,371000,-211000,-281000
058075,貿聯凱基99購02  ,0,0,0,0,0,0,0,0,0,-281000,0,0,0,1000,282000,-281000,-281000
055207,致新中信99購01  ,0,0,0,0,0,0,0,0,0,-281000,0,0,0,0,281000,-281000,-281000
056079,世紀鋼元大97購02,0,0,0,0,0,0,0,0,0,-281000,0,0,0,733000,1014000,-281000,-281000
057954,宏碁元大99購01  ,0,0,0,0,0,0,0,0,0,-282000,0,0,0,0,282000,-282000,-282000
055468,智邦凱基97購04  ,0,0,0,0,0,0,0,0,0,-282000,0,0,0,65000,347000,-282000,-282000
057656,大成鋼兆豐98購01,0,0,0,0,0,0,0,0,0,-283000,0,0,0,104000,387000,-283000,-283000
057388,奇鋐永豐98購02  ,0,0,0,0,0,0,0,0,0,-283000,0,0,0,3000,286000,-283000,-283000
06983P,台積電國泰9A售02,0,0,0,0,0,0,0,0,0,-283000,0,0,0,57000,340000,-283000,-283000
058327,大毅統一9B購01  ,0,0,0,0,0,0,0,0,0,-284000,0,0,0,0,284000,-284000,-284000
06013P,世芯國泰97售03  ,0,0,0,0,0,0,0,0,0,-284000,0,0,0,194000,478000,-284000,-284000
055980,祥碩統一98購01  ,0,0,0,0,0,0,0,0,0,-284000,0,0,0,88000,372000,-284000,-284000
053295,奇力新中信96購01,0,0,0,0,0,0,0,0,0,-285000,0,0,0,25000,310000,-285000,-285000
054291,高鐵元大97購01  ,0,0,0,0,0,0,0,0,0,-285000,0,0,0,0,285000,-285000,-285000
057019,台積電凱基98購14,0,0,0,0,0,0,0,0,0,-286000,0,0,0,125000,411000,-286000,-286000
053517,崇越群益97購01  ,0,0,0,0,0,0,0,0,0,-286000,0,0,0,10000,296000,-286000,-286000
9939,宏全            ,217000,517000,-300000,0,0,0,5000,0,5000,9000,14000,5000,9000,7000,7000,0,-286000
055777,冠德凱基97購01  ,0,0,0,0,0,0,0,0,0,-287000,0,0,0,32000,319000,-287000,-287000
058375,群創凱基9B購04  ,0,0,0,0,0,0,0,0,0,-288000,0,0,0,84000,372000,-288000,-288000
053712,台光電凱基96購04,0,0,0,0,0,0,0,0,0,-288000,0,0,0,0,288000,-288000,-288000
051252,健鼎元大95購01  ,0,0,0,0,0,0,0,0,0,-288000,0,0,0,0,288000,-288000,-288000
056182,台光電統一97購03,0,0,0,0,0,0,0,0,0,-288000,0,0,0,0,288000,-288000,-288000
049552,鴻海國泰96購01  ,0,0,0,0,0,0,0,0,0,-289000,0,0,0,331000,620000,-289000,-289000
047487,南電凱基94購01  ,0,0,0,0,0,0,0,0,0,-289000,0,0,0,20000,309000,-289000,-289000
056218,億光中信98購01  ,0,0,0,0,0,0,0,0,0,-289000,0,0,0,10000,299000,-289000,-289000
055374,明泰元大97購01  ,0,0,0,0,0,0,0,0,0,-289000,0,0,0,18000,307000,-289000,-289000
055150,台積電元大98購04,0,0,0,0,0,0,0,0,0,-290000,0,0,0,10000,300000,-290000,-290000
058328,世紀鋼統一9B購01,0,0,0,0,0,0,0,0,0,-291000,0,0,0,15000,306000,-291000,-291000
044966,台表科中信94購01,0,0,0,0,0,0,0,0,0,-292000,0,0,0,20000,312000,-292000,-292000
049720,欣興凱基94購05  ,0,0,0,0,0,0,0,0,0,-292000,0,0,0,1000,293000,-292000,-292000
053511,鴻海群益96購04  ,0,0,0,0,0,0,0,0,0,-292000,0,0,0,13000,305000,-292000,-292000
049681,旺宏統一94購04  ,0,0,0,0,0,0,0,0,0,-293000,0,0,0,108000,401000,-293000,-293000
051421,彩晶國票95購01  ,0,0,0,0,0,0,0,0,0,-293000,0,0,0,0,293000,-293000,-293000
8422,可寧衛          ,86000,388000,-302000,0,0,0,2000,0,2000,7000,7000,0,7000,0,0,0,-293000
057814,聯發科元大98購12,0,0,0,0,0,0,0,0,0,-294000,0,0,0,221000,515000,-294000,-294000
051098,矽格元大95購01  ,0,0,0,0,0,0,0,0,0,-294000,0,0,0,78000,372000,-294000,-294000
054515,華通元大98購02  ,0,0,0,0,0,0,0,0,0,-294000,0,0,0,27000,321000,-294000,-294000
055488,華邦電元大98購01,0,0,0,0,0,0,0,0,0,-294000,0,0,0,30000,324000,-294000,-294000
049396,元油2X群益97購03,0,0,0,0,0,0,0,0,0,-295000,0,0,0,0,295000,-295000,-295000
057747,致新永豐98購01  ,0,0,0,0,0,0,0,0,0,-297000,0,0,0,54000,351000,-297000,-297000
047569,世紀鋼國票94購02,0,0,0,0,0,0,0,0,0,-297000,0,0,0,0,297000,-297000,-297000
051944,智邦統一95購02  ,0,0,0,0,0,0,0,0,0,-297000,0,0,0,0,297000,-297000,-297000
051747,貿聯國泰96購01  ,0,0,0,0,0,0,0,0,0,-297000,0,0,0,10000,307000,-297000,-297000
053455,台光電元富96購02,0,0,0,0,0,0,0,0,0,-297000,0,0,0,200000,497000,-297000,-297000
055534,晶技群益97購03  ,0,0,0,0,0,0,0,0,0,-297000,0,0,0,96000,393000,-297000,-297000
054753,復盛凱基98購01  ,0,0,0,0,0,0,0,0,0,-297000,0,0,0,33000,330000,-297000,-297000
054198,台積電永昌96購08,0,0,0,0,0,0,0,0,0,-297000,0,0,0,232000,529000,-297000,-297000
055361,樺漢凱基97購01  ,0,0,0,0,0,0,0,0,0,-298000,0,0,0,56000,354000,-298000,-298000
056418,台光電元富98購01,0,0,0,0,0,0,0,0,0,-298000,0,0,0,138000,436000,-298000,-298000
049923,智原元大95購02  ,0,0,0,0,0,0,0,0,0,-299000,0,0,0,0,299000,-299000,-299000
051532,潤泰全國票96購01,0,0,0,0,0,0,0,0,0,-299000,0,0,0,0,299000,-299000,-299000
050399,潤泰全中信95購01,0,0,0,0,0,0,0,0,0,-299000,0,0,0,0,299000,-299000,-299000
051283,亞德客統一95購01,0,0,0,0,0,0,0,0,0,-299000,0,0,0,132000,431000,-299000,-299000
055682,智原凱基98購02  ,0,0,0,0,0,0,0,0,0,-299000,0,0,0,0,299000,-299000,-299000
054663,同欣電元大97購03,0,0,0,0,0,0,0,0,0,-299000,0,0,0,68000,367000,-299000,-299000
055137,GIS富邦98購01   ,0,0,0,0,0,0,0,0,0,-299000,0,0,0,0,299000,-299000,-299000
054844,華邦電兆豐98購01,0,0,0,0,0,0,0,0,0,-299000,0,0,0,1000,300000,-299000,-299000
057735,台灣50富邦9C購02,0,0,0,0,0,0,0,0,0,-300000,0,0,0,7000,307000,-300000,-300000
058225,旺宏元富99購01  ,0,0,0,0,0,0,0,0,0,-300000,0,0,0,0,300000,-300000,-300000
057014,元油2X凱基9A購05,0,0,0,0,0,0,0,0,0,-300000,0,0,0,0,300000,-300000,-300000
056490,台積電國泰99購01,0,0,0,0,0,0,0,0,0,-300000,0,0,0,70000,370000,-300000,-300000
049367,全新元大96購01  ,0,0,0,0,0,0,0,0,0,-300000,0,0,0,0,300000,-300000,-300000
047680,上証反中信96購01,0,0,0,0,0,0,0,0,0,-300000,0,0,0,0,300000,-300000,-300000
049583,台積電元大95購04,0,0,0,0,0,0,0,0,0,-300000,0,0,0,272000,572000,-300000,-300000
049619,宏達電群益95購02,0,0,0,0,0,0,0,0,0,-300000,0,0,0,0,300000,-300000,-300000
050398,上証2X中信97購01,0,0,0,0,0,0,0,0,0,-300000,0,0,0,0,300000,-300000,-300000
051573,鴻海元大95購15  ,0,0,0,0,0,0,0,0,0,-300000,0,0,0,0,300000,-300000,-300000
053390,彩晶元大9A購01  ,0,0,0,0,0,0,0,0,0,-300000,0,0,0,0,300000,-300000,-300000
053147,楠梓電元大98購01,0,0,0,0,0,0,0,0,0,-300000,0,0,0,0,300000,-300000,-300000
050187,群創元大94購03  ,0,0,0,0,0,0,0,0,0,-300000,0,0,0,143000,443000,-300000,-300000
050163,群創國泰95購01  ,0,0,0,0,0,0,0,0,0,-300000,0,0,0,0,300000,-300000,-300000
052011,欣興中信96購01  ,0,0,0,0,0,0,0,0,0,-300000,0,0,0,0,300000,-300000,-300000
054632,緯穎凱基9A購01  ,0,0,0,0,0,0,0,0,0,-300000,0,0,0,207000,507000,-300000,-300000
054414,全新元大97購02  ,0,0,0,0,0,0,0,0,0,-300000,0,0,0,0,300000,-300000,-300000
053885,全新兆豐96購01  ,0,0,0,0,0,0,0,0,0,-300000,0,0,0,0,300000,-300000,-300000
5607,遠雄港          ,119000,239000,-120000,0,0,0,0,0,0,-180000,0,180000,-180000,0,0,0,-300000
052813,T50正2永豐96購01,0,0,0,0,0,0,0,0,0,-302000,0,0,0,163000,465000,-302000,-302000
051013,旺宏凱基95購03  ,0,0,0,0,0,0,0,0,0,-302000,0,0,0,0,302000,-302000,-302000
053413,台積電國票99購01,0,0,0,0,0,0,0,0,0,-302000,0,0,0,747000,1049000,-302000,-302000
054108,台積電凱基96購22,0,0,0,0,0,0,0,0,0,-302000,0,0,0,30000,332000,-302000,-302000
054421,臺股指元大99購03,0,0,0,0,0,0,0,0,0,-302000,0,0,0,0,302000,-302000,-302000
055671,世紀鋼群益97購01,0,0,0,0,0,0,0,0,0,-302000,0,0,0,156000,458000,-302000,-302000
057664,台積電元大9A購03,0,0,0,0,0,0,0,0,0,-303000,0,0,0,261000,564000,-303000,-303000
057511,健策統一98購02  ,0,0,0,0,0,0,0,0,0,-303000,0,0,0,0,303000,-303000,-303000
06024P,台郡國票97售05  ,0,0,0,0,0,0,0,0,0,-303000,0,0,0,20000,323000,-303000,-303000
047194,世紀鋼元大96購01,1000,0,1000,0,0,0,0,0,0,-304000,0,0,0,189000,493000,-304000,-303000
050923,南亞科凱基95購03,0,0,0,0,0,0,0,0,0,-303000,0,0,0,1000,304000,-303000,-303000
057121,立積康和98購01  ,0,0,0,0,0,0,0,0,0,-304000,0,0,0,78000,382000,-304000,-304000
056221,鴻海凱基99購01  ,0,0,0,0,0,0,0,0,0,-304000,0,0,0,13000,317000,-304000,-304000
03875P,滬深2X國票05售01,0,0,0,0,0,0,0,0,0,-305000,0,0,0,5000,310000,-305000,-305000
050920,旺宏凱基95購01  ,0,0,0,0,0,0,0,0,0,-305000,0,0,0,73000,378000,-305000,-305000
054835,致新中信97購01  ,0,0,0,0,0,0,0,0,0,-305000,0,0,0,20000,325000,-305000,-305000
058055,華擎統一9A購01  ,0,0,0,0,0,0,0,0,0,-307000,0,0,0,17000,324000,-307000,-307000
052146,泰碩群益95購01  ,0,0,0,0,0,0,0,0,0,-308000,0,0,0,87000,395000,-308000,-308000
054509,上証反元大99購01,0,0,0,0,0,0,0,0,0,-308000,0,0,0,504000,812000,-308000,-308000
047696,聯發科國票94購02,0,0,0,0,0,0,0,0,0,-310000,0,0,0,0,310000,-310000,-310000
049503,矽創元大94購01  ,0,0,0,0,0,0,0,0,0,-310000,0,0,0,0,310000,-310000,-310000
055041,致新富邦97購01  ,0,0,0,0,0,0,0,0,0,-310000,0,0,0,0,310000,-310000,-310000
2542,興富發          ,1371000,1706000,-335000,0,0,0,0,0,0,25000,72000,47000,25000,0,0,0,-310000
057428,正崴兆豐98購01  ,0,0,0,0,0,0,0,0,0,-311000,0,0,0,0,311000,-311000,-311000
050780,台表科元大96購01,0,0,0,0,0,0,0,0,0,-311000,0,0,0,21000,332000,-311000,-311000
055973,亞德客統一97購01,0,0,0,0,0,0,0,0,0,-311000,0,0,0,0,311000,-311000,-311000
055790,南電凱基97購01  ,0,0,0,0,0,0,0,0,0,-311000,0,0,0,32000,343000,-311000,-311000
2515,中工            ,492000,798000,-306000,0,0,0,0,0,0,-5000,3000,0,3000,2000,10000,-8000,-311000
07031P,台灣50中信03售02,0,0,0,0,0,0,0,0,0,-311000,0,0,0,0,311000,-311000,-311000
057073,康控永豐98購01  ,0,0,0,0,0,0,0,0,0,-312000,0,0,0,110000,422000,-312000,-312000
055907,台虹兆豐98購01  ,0,0,0,0,0,0,0,0,0,-312000,0,0,0,38000,350000,-312000,-312000
053978,創意元大96購05  ,0,0,0,0,0,0,0,0,0,-312000,0,0,0,136000,448000,-312000,-312000
056882,華邦電康和98購01,0,0,0,0,0,0,0,0,0,-314000,0,0,0,0,314000,-314000,-314000
058115,台光電中信99購01,0,0,0,0,0,0,0,0,0,-314000,0,0,0,10000,324000,-314000,-314000
058530,為升元富99購01  ,0,0,0,0,0,0,0,0,0,-314000,0,0,0,0,314000,-314000,-314000
053528,南電中信9A購01  ,0,0,0,0,0,0,0,0,0,-314000,0,0,0,30000,344000,-314000,-314000
056380,麗豐元富98購01  ,0,0,0,0,0,0,0,0,0,-314000,0,0,0,0,314000,-314000,-314000
048059,欣興國泰95購01  ,0,0,0,0,0,0,0,0,0,-315000,0,0,0,200000,515000,-315000,-315000
048350,世紀鋼元大95購01,0,0,0,0,0,0,0,0,0,-316000,0,0,0,142000,458000,-316000,-316000
044996,嘉晶國泰95購01  ,0,0,0,0,0,0,0,0,0,-316000,0,0,0,0,316000,-316000,-316000
056047,台積電兆豐97購02,0,0,0,0,0,0,0,0,0,-317000,0,0,0,35000,352000,-317000,-317000
058237,嘉晶元大99購04  ,0,0,0,0,0,0,0,0,0,-318000,0,0,0,63000,381000,-318000,-318000
053720,宏達電凱基97購01,0,0,0,0,0,0,0,0,0,-318000,0,0,0,47000,365000,-318000,-318000
04229P,臺股指中信95售05,0,0,0,0,0,0,0,0,0,-320000,0,0,0,50000,370000,-320000,-320000
053657,元大金凱基96購01,0,0,0,0,0,0,0,0,0,-320000,0,0,0,35000,355000,-320000,-320000
054585,禾伸堂國泰99購01,0,0,0,0,0,0,0,0,0,-320000,0,0,0,0,320000,-320000,-320000
057026,長榮航凱基98購01,0,0,0,0,0,0,0,0,0,-321000,0,0,0,1000,322000,-321000,-321000
053255,貿聯國泰97購01  ,0,0,0,0,0,0,0,0,0,-321000,0,0,0,74000,395000,-321000,-321000
053071,南電群益96購01  ,0,0,0,0,0,0,0,0,0,-321000,0,0,0,101000,422000,-321000,-321000
056767,大毅元大99購01  ,0,0,0,0,0,0,0,0,0,-322000,0,0,0,53000,375000,-322000,-322000
057330,台積電國票99購03,0,0,0,0,0,0,0,0,0,-322000,0,0,0,88000,410000,-322000,-322000
057355,彩晶統一98購03  ,0,0,0,0,0,0,0,0,0,-322000,0,0,0,0,322000,-322000,-322000
049518,宏達電國票95購02,0,0,0,0,0,0,0,0,0,-322000,0,0,0,15000,337000,-322000,-322000
052793,健鼎兆豐96購01  ,0,0,0,0,0,0,0,0,0,-322000,0,0,0,0,322000,-322000,-322000
048745,儒鴻元富97購02  ,0,0,0,0,0,0,0,0,0,-322000,0,0,0,428000,750000,-322000,-322000
052733,台郡國泰97購01  ,0,0,0,0,0,0,0,0,0,-322000,0,0,0,33000,355000,-322000,-322000
050030,嘉晶元大94購03  ,0,0,0,0,0,0,0,0,0,-323000,0,0,0,96000,419000,-323000,-323000
049602,南電元大95購01  ,0,0,0,0,0,0,0,0,0,-324000,0,0,0,47000,371000,-324000,-324000
056783,國巨群益99購01  ,0,0,0,0,0,0,0,0,0,-325000,0,0,0,378000,703000,-325000,-325000
056912,臺股指元大99購04,0,0,0,0,0,0,0,0,0,-325000,0,0,0,50000,375000,-325000,-325000
056759,元油2X元大98購05,0,0,0,0,0,0,0,0,0,-326000,0,0,0,0,326000,-326000,-326000
057231,美律凱基98購05  ,0,0,0,0,0,0,0,0,0,-326000,0,0,0,57000,383000,-326000,-326000
053082,聯電元大98購03  ,0,0,0,0,0,0,0,0,0,-326000,0,0,0,192000,518000,-326000,-326000
058496,文曄群益99購01  ,0,0,0,0,0,0,0,0,0,-327000,0,0,0,119000,446000,-327000,-327000
055706,大立光永豐97購03,0,0,0,0,0,0,0,0,0,-327000,0,0,0,209000,536000,-327000,-327000
06035P,同欣電凱基96售03,0,0,0,0,0,0,0,0,0,-328000,0,0,0,0,328000,-328000,-328000
057772,台積電群益99購01,0,0,0,0,0,0,0,0,0,-328000,0,0,0,793000,1121000,-328000,-328000
054947,興勤元大97購01  ,0,0,0,0,0,0,0,0,0,-328000,0,0,0,7000,335000,-328000,-328000
058356,華邦電凱基99購01,0,0,0,0,0,0,0,0,0,-330000,0,0,0,26000,356000,-330000,-330000
049962,台光電元富94購01,0,0,0,0,0,0,0,0,0,-330000,0,0,0,0,330000,-330000,-330000
053460,緯穎國泰97購01  ,0,0,0,0,0,0,0,0,0,-330000,0,0,0,59000,389000,-330000,-330000
055576,嘉晶統一98購01  ,0,0,0,0,0,0,0,0,0,-330000,0,0,0,7000,337000,-330000,-330000
056237,智邦群益97購02  ,0,0,0,0,0,0,0,0,0,-330000,0,0,0,119000,449000,-330000,-330000
049236,元油2X元富96購06,0,0,0,0,0,0,0,0,0,-331000,0,0,0,0,331000,-331000,-331000
055770,欣興麥證97購01  ,0,0,0,0,331000,-331000,0,0,0,-331000,0,0,0,0,331000,-331000,-331000
05989P,健策元富96售01  ,0,0,0,0,0,0,0,0,0,-332000,0,0,0,56000,388000,-332000,-332000
056367,祥碩元大98購01  ,0,0,0,0,0,0,0,0,0,-332000,0,0,0,25000,357000,-332000,-332000
052867,晶技凱基96購01  ,0,0,0,0,0,0,0,0,0,-334000,0,0,0,145000,479000,-334000,-334000
053172,瑞儀群益97購01  ,0,0,0,0,0,0,0,0,0,-334000,0,0,0,0,334000,-334000,-334000
051816,臺股指凱基95購07,0,0,0,0,0,0,0,0,0,-334000,0,0,0,0,334000,-334000,-334000
051844,宏達電富邦96購01,0,0,0,0,0,0,0,0,0,-334000,0,0,0,2000,336000,-334000,-334000
050260,鴻海元大94購15  ,0,0,0,0,0,0,0,0,0,-334000,0,0,0,124000,458000,-334000,-334000
050611,鴻海元大95購02  ,0,0,0,0,0,0,0,0,0,-335000,0,0,0,25000,360000,-335000,-335000
053404,致新群益96購01  ,0,0,0,0,0,0,0,0,0,-335000,0,0,0,0,335000,-335000,-335000
2106,建大            ,340000,680000,-340000,0,0,0,0,0,0,5000,7000,2000,5000,0,0,0,-335000
2615,萬海            ,640000,590000,50000,0,0,0,2000,400000,-398000,12000,17000,5000,12000,0,0,0,-336000
055452,台積電元富97購03,0,0,0,0,0,0,0,0,0,-337000,0,0,0,5000,342000,-337000,-337000
057770,亞德客群益98購01,0,0,0,0,0,0,0,0,0,-338000,0,0,0,1000,339000,-338000,-338000
1229,聯華            ,843000,1052700,-209700,0,0,0,4000,0,4000,-133000,11000,144000,-133000,0,0,0,-338700
058368,奇鋐凱基9A購01  ,0,0,0,0,0,0,0,0,0,-339000,0,0,0,90000,429000,-339000,-339000
4906,正文            ,650000,962000,-312000,0,0,0,0,0,0,-27000,45000,44000,1000,30000,58000,-28000,-339000
053440,台積電凱基96購12,0,0,0,0,0,0,0,0,0,-340000,0,0,0,50000,390000,-340000,-340000
052506,日月光日盛95購01,0,0,0,0,0,0,0,0,0,-340000,0,0,0,0,340000,-340000,-340000
055676,亞德客凱基97購03,0,0,0,0,0,0,0,0,0,-340000,0,0,0,10000,350000,-340000,-340000
056288,健鼎永豐97購01  ,0,0,0,0,0,0,0,0,0,-340000,0,0,0,68000,408000,-340000,-340000
057256,元油2X兆豐98購01,0,0,0,0,0,0,0,0,0,-341000,0,0,0,245000,586000,-341000,-341000
056172,鴻海元富97購11  ,0,0,0,0,0,0,0,0,0,-341000,0,0,0,592000,933000,-341000,-341000
056390,台積電富邦9B購01,0,0,0,0,0,0,0,0,0,-341000,0,0,0,25000,366000,-341000,-341000
8021,尖點            ,252000,584000,-332000,0,0,0,0,0,0,-9000,15000,24000,-9000,0,0,0,-341000
054582,致新元大97購01  ,0,0,0,0,0,0,0,0,0,-342000,0,0,0,68000,410000,-342000,-342000
050036,矽格元大94購03  ,0,0,0,0,0,0,0,0,0,-343000,0,0,0,3000,346000,-343000,-343000
055819,晶相光國票98購01,0,0,0,0,0,0,0,0,0,-343000,0,0,0,10000,353000,-343000,-343000
055718,可成元大97購02  ,0,0,0,0,0,0,0,0,0,-343000,0,0,0,189000,532000,-343000,-343000
055719,可成元大97購03  ,0,0,0,0,0,0,0,0,0,-343000,0,0,0,400000,743000,-343000,-343000
055668,欣興群益97購01  ,0,0,0,0,0,0,0,0,0,-344000,0,0,0,16000,360000,-344000,-344000
056346,聯茂凱基99購02  ,0,0,0,0,0,0,0,0,0,-344000,0,0,0,124000,468000,-344000,-344000
054248,燿華元大97購02  ,0,0,0,0,0,0,0,0,0,-344000,0,0,0,0,344000,-344000,-344000
057913,健策日盛98購01  ,0,0,0,0,0,0,0,0,0,-346000,0,0,0,75000,421000,-346000,-346000
058046,國巨元大9A購01  ,0,0,0,0,0,0,0,0,0,-346000,0,0,0,27000,373000,-346000,-346000
052751,臺股指元大96購05,0,0,0,0,0,0,0,0,0,-346000,0,0,0,10000,356000,-346000,-346000
058574,台積電群益99購03,0,0,0,0,0,0,0,0,0,-347000,0,0,0,573000,920000,-347000,-347000
057177,奇力新元大99購04,0,0,0,0,0,0,0,0,0,-349000,0,0,0,0,349000,-349000,-349000
056601,鈺齊元富98購01  ,0,0,0,0,0,0,0,0,0,-349000,0,0,0,17000,366000,-349000,-349000
049736,宏達電群益95購03,0,0,0,0,0,0,0,0,0,-349000,0,0,0,0,349000,-349000,-349000
053590,新光金元大9A購02,0,0,0,0,0,0,0,0,0,-349000,0,0,0,101000,450000,-349000,-349000
056528,為升凱基98購01  ,0,0,0,0,0,0,0,0,0,-350000,0,0,0,169000,519000,-350000,-350000
056998,麗豐康和98購01  ,0,0,0,0,0,0,0,0,0,-350000,0,0,0,0,350000,-350000,-350000
04802P,國巨凱基94售07  ,0,0,0,0,0,0,0,0,0,-350000,0,0,0,0,350000,-350000,-350000
052176,景碩元大96購01  ,0,0,0,0,0,0,0,0,0,-350000,0,0,0,0,350000,-350000,-350000
055416,欣興富邦98購01  ,0,0,0,0,0,0,0,0,0,-350000,0,0,0,149000,499000,-350000,-350000
055852,聯鈞元大98購01  ,0,0,0,0,0,0,0,0,0,-351000,0,0,0,193000,544000,-351000,-351000
054848,群創兆豐98購01  ,0,0,0,0,0,0,0,0,0,-351000,0,0,0,12000,363000,-351000,-351000
06034P,世芯凱基96售03  ,0,0,0,0,0,0,0,0,0,-352000,0,0,0,148000,500000,-352000,-352000
054191,香港2X中信98購01,0,0,0,0,0,0,0,0,0,-352000,0,0,0,0,352000,-352000,-352000
051415,晶技國票96購01  ,0,0,0,0,0,0,0,0,0,-354000,0,0,0,101000,455000,-354000,-354000
052655,群創統一97購01  ,0,0,0,0,0,0,0,0,0,-355000,0,0,0,20000,375000,-355000,-355000
058076,神達凱基98購02  ,0,0,0,0,0,0,0,0,0,-356000,0,0,0,44000,400000,-356000,-356000
057094,祥碩元富98購01  ,0,0,0,0,0,0,0,0,0,-356000,0,0,0,30000,386000,-356000,-356000
057564,台積電富邦9B購03,0,0,0,0,0,0,0,0,0,-356000,0,0,0,5000,361000,-356000,-356000
055079,台光電中信97購01,0,0,0,0,0,0,0,0,0,-357000,0,0,0,190000,547000,-357000,-357000
055438,鴻海國票98購01  ,0,0,0,0,0,0,0,0,0,-357000,0,0,0,10000,367000,-357000,-357000
2535,達欣工          ,597000,953000,-356000,0,0,0,0,0,0,-1000,0,1000,-1000,0,0,0,-357000
056065,奇鋐元大97購01  ,0,0,0,0,0,0,0,0,0,-358000,0,0,0,165000,523000,-358000,-358000
056369,彩晶元大01購01  ,0,0,0,0,0,0,0,0,0,-358000,0,0,0,1000,359000,-358000,-358000
1304,台聚            ,398000,788000,-390000,0,0,0,0,0,0,32000,32000,0,32000,0,0,0,-358000
045795,瀚宇博兆豐94購01,0,0,0,0,0,0,0,0,0,-359000,0,0,0,44000,403000,-359000,-359000
058469,臺股指中信9A購05,0,0,0,0,0,0,0,0,0,-360000,0,0,0,0,360000,-360000,-360000
056075,瀚宇博元大97購03,0,0,0,0,0,0,0,0,0,-360000,0,0,0,173000,533000,-360000,-360000
058343,台積電群益99購02,0,0,0,0,0,0,0,0,0,-361000,0,0,0,207000,568000,-361000,-361000
057071,華擎永豐98購02  ,0,0,0,0,0,0,0,0,0,-361000,0,0,0,10000,371000,-361000,-361000
052861,台光電凱基96購03,0,0,0,0,0,0,0,0,0,-361000,0,0,0,35000,396000,-361000,-361000
052991,台積電台新96購01,0,0,0,0,0,0,0,0,0,-361000,0,0,0,0,361000,-361000,-361000
055538,鴻海日盛97購04  ,0,0,0,0,0,0,0,0,0,-361000,0,0,0,85000,446000,-361000,-361000
047774,台表科元大95購01,0,0,0,0,0,0,0,0,0,-362000,0,0,0,100000,462000,-362000,-362000
047681,滬深反中信95購01,0,0,0,0,0,0,0,0,0,-363000,0,0,0,366000,729000,-363000,-363000
055940,致新群益98購01  ,0,0,0,0,0,0,0,0,0,-363000,0,0,0,0,363000,-363000,-363000
054806,台化元大9A購01  ,0,0,0,0,0,0,0,0,0,-363000,0,0,0,0,363000,-363000,-363000
052749,日月光元大96購02,0,0,0,0,0,0,0,0,0,-365000,0,0,0,0,365000,-365000,-365000
058624,台積電國票99購09,0,0,0,0,0,0,0,0,0,-366000,0,0,0,0,366000,-366000,-366000
056594,台積電元富98購03,0,0,0,0,0,0,0,0,0,-367000,0,0,0,1055000,1422000,-367000,-367000
051396,健鼎兆豐95購01  ,0,0,0,0,0,0,0,0,0,-367000,0,0,0,8000,375000,-367000,-367000
056984,嘉晶群益98購01  ,0,0,0,0,0,0,0,0,0,-368000,0,0,0,104000,472000,-368000,-368000
057646,玉山金元大98購01,0,0,0,0,0,0,0,0,0,-368000,0,0,0,18000,386000,-368000,-368000
058204,世芯凱基9A購01  ,0,0,0,0,0,0,0,0,0,-368000,0,0,0,56000,424000,-368000,-368000
053760,牧德國泰98購01  ,0,0,0,0,0,0,0,0,0,-369000,0,0,0,58000,427000,-369000,-369000
055662,上銀中信99購01  ,0,0,0,0,0,0,0,0,0,-369000,0,0,0,374000,743000,-369000,-369000
055782,新日興凱基99購01,0,0,0,0,0,0,0,0,0,-369000,0,0,0,0,369000,-369000,-369000
055197,致新元富97購02  ,0,0,0,0,0,0,0,0,0,-369000,0,0,0,47000,416000,-369000,-369000
055386,致新元大97購02  ,0,0,0,0,0,0,0,0,0,-370000,0,0,0,10000,380000,-370000,-370000
054464,奇力新凱基98購02,0,0,0,0,0,0,0,0,0,-370000,0,0,0,100000,470000,-370000,-370000
055128,致新兆豐97購01  ,0,0,0,0,0,0,0,0,0,-372000,0,0,0,0,372000,-372000,-372000
055249,大毅統一99購01  ,0,0,0,0,0,0,0,0,0,-372000,0,0,0,401000,773000,-372000,-372000
056192,智邦富邦98購01  ,0,0,0,0,0,0,0,0,0,-372000,0,0,0,0,372000,-372000,-372000
2548,華固            ,191000,547000,-356000,0,0,0,0,0,0,-16000,11000,7000,4000,0,20000,-20000,-372000
051462,世芯國泰97購01  ,0,0,0,0,0,0,0,0,0,-374000,0,0,0,239000,613000,-374000,-374000
056331,聯鈞國票99購01  ,0,0,0,0,0,0,0,0,0,-374000,0,0,0,87000,461000,-374000,-374000
2536,宏普            ,196000,571000,-375000,0,0,0,0,0,0,1000,1000,0,1000,0,0,0,-374000
058616,台虹元大9A購01  ,0,0,0,0,0,0,0,0,0,-375000,0,0,0,0,375000,-375000,-375000
056583,昇陽半元大98購02,0,0,0,0,0,0,0,0,0,-375000,0,0,0,226000,601000,-375000,-375000
2231,為升            ,472000,398000,74000,0,0,0,2000,241000,-239000,-211000,72000,303000,-231000,31000,11000,20000,-376000
047421,聯茂富邦97購01  ,0,0,0,0,0,0,0,0,0,-377000,0,0,0,52000,429000,-377000,-377000
053997,健策群益97購02  ,0,0,0,0,0,0,0,0,0,-378000,0,0,0,10000,388000,-378000,-378000
058191,祥碩永豐99購01  ,0,0,0,0,0,0,0,0,0,-379000,0,0,0,265000,644000,-379000,-379000
055451,台積電元富97購02,0,0,0,0,0,0,0,0,0,-379000,0,0,0,22000,401000,-379000,-379000
055463,國喬凱基97購01  ,0,0,0,0,0,0,0,0,0,-379000,0,0,0,0,379000,-379000,-379000
3044,健鼎            ,695000,1170000,-475000,0,0,0,1000,0,1000,95000,36000,1000,35000,71000,11000,60000,-379000
058226,世芯元富99購01  ,0,0,0,0,0,0,0,0,0,-381000,0,0,0,17000,398000,-381000,-381000
055561,奇鋐凱基97購01  ,0,0,0,0,0,0,0,0,0,-383000,0,0,0,55000,438000,-383000,-383000
052428,嘉晶永豐95購01  ,0,0,0,0,0,0,0,0,0,-384000,0,0,0,56000,440000,-384000,-384000
053882,聯發科中信98購02,0,0,0,0,0,0,0,0,0,-384000,0,0,0,2000,386000,-384000,-384000
052759,京元電群益96購01,0,0,0,0,0,0,0,0,0,-385000,0,0,0,11000,396000,-385000,-385000
053512,台積電群益96購06,0,0,0,0,0,0,0,0,0,-385000,0,0,0,50000,435000,-385000,-385000
2015,豐興            ,308000,633000,-325000,0,0,0,6000,0,6000,-67000,7000,74000,-67000,0,0,0,-386000
050439,新日興凱基94購01,0,0,0,0,0,0,0,0,0,-387000,0,0,0,21000,408000,-387000,-387000
058454,嘉晶永豐99購01  ,0,0,0,0,0,0,0,0,0,-388000,0,0,0,11000,399000,-388000,-388000
056561,台光電群益98購02,0,0,0,0,0,0,0,0,0,-388000,0,0,0,40000,428000,-388000,-388000
057209,元油2X第一98購01,0,0,0,0,0,0,0,0,0,-388000,0,0,0,0,388000,-388000,-388000
2101,南港            ,553000,994000,-441000,0,0,0,0,0,0,53000,6000,2000,4000,61000,12000,49000,-388000
1609,大亞            ,354000,746000,-392000,0,0,0,0,0,0,4000,6000,2000,4000,0,0,0,-388000
055720,宏達電元大97購05,0,0,0,0,0,0,0,0,0,-389000,0,0,0,24000,413000,-389000,-389000
6443,元晶            ,256000,95000,161000,0,0,0,0,0,0,-550000,0,550000,-550000,0,0,0,-389000
045055,聯發科元富98購03,0,0,0,0,0,0,0,0,0,-390000,0,0,0,78000,468000,-390000,-390000
056992,祥碩兆豐98購01  ,0,0,0,0,0,0,0,0,0,-392000,0,0,0,35000,427000,-392000,-392000
053759,晶相光國泰98購01,0,0,0,0,0,0,0,0,0,-392000,0,0,0,563000,955000,-392000,-392000
2607,榮運            ,291000,683000,-392000,0,0,0,0,0,0,0,0,0,0,0,0,0,-392000
057546,台積電凱基02購01,0,0,0,0,0,0,0,0,0,-393000,0,0,0,355000,748000,-393000,-393000
052798,滬深2X元大96購07,0,0,0,0,0,0,0,0,0,-393000,0,0,0,128000,521000,-393000,-393000
055902,同欣電中信99購01,0,0,0,0,0,0,0,0,0,-393000,0,0,0,181000,574000,-393000,-393000
2448,晶電            ,7537000,7796000,-259000,0,0,0,58000,290000,-232000,97000,535000,312000,223000,40000,166000,-126000,-394000
054425,聯發科富邦99購03,0,0,0,0,0,0,0,0,0,-395000,0,0,0,163000,558000,-395000,-395000
6166,凌華            ,287000,680000,-393000,0,0,0,0,0,0,-2000,0,0,0,0,2000,-2000,-395000
06900P,FBVIX國票12售01 ,0,0,0,0,0,0,0,0,0,-395000,0,0,0,7000,402000,-395000,-395000
053366,樺漢國泰98購01  ,0,0,0,0,0,0,0,0,0,-396000,0,0,0,312000,708000,-396000,-396000
054680,華新科康和97購02,0,0,0,0,0,0,0,0,0,-396000,0,0,0,15000,411000,-396000,-396000
057749,華新科國票99購01,0,0,0,0,0,0,0,0,0,-398000,0,0,0,71000,469000,-398000,-398000
03828P,致茂中信95售01  ,0,0,0,0,0,0,0,0,0,-398000,0,0,0,120000,518000,-398000,-398000
053313,世紀鋼凱基96購01,0,0,0,0,0,0,0,0,0,-398000,0,0,0,180000,578000,-398000,-398000
9911,櫻花            ,247000,587000,-340000,0,0,0,0,0,0,-58000,1000,59000,-58000,0,0,0,-398000
052389,聯發科群益95購05,0,0,0,0,0,0,0,0,0,-399000,0,0,0,100000,499000,-399000,-399000
5534,長虹            ,143000,509000,-366000,0,0,0,2000,28000,-26000,-7000,5000,12000,-7000,0,0,0,-399000
056753,群創兆豐98購02  ,0,0,0,0,0,0,0,0,0,-400000,0,0,0,0,400000,-400000,-400000
046108,A50正2元大95購02,0,0,0,0,0,0,0,0,0,-400000,0,0,0,0,400000,-400000,-400000
052597,茂林群益96購01  ,0,0,0,0,0,0,0,0,0,-400000,0,0,0,7000,407000,-400000,-400000
054152,漢唐國泰98購02  ,0,0,0,0,0,0,0,0,0,-400000,0,0,0,50000,450000,-400000,-400000
055268,和大元大97購01  ,0,180000,-180000,0,0,0,0,0,0,-220000,0,0,0,180000,400000,-220000,-400000
056886,元油2X元大99購04,0,0,0,0,0,0,0,0,0,-401000,0,0,0,0,401000,-401000,-401000
047719,聯茂凱基94購01  ,0,0,0,0,0,0,0,0,0,-401000,0,0,0,60000,461000,-401000,-401000
053559,台積電國泰98購01,0,0,0,0,0,0,0,0,0,-401000,0,0,0,264000,665000,-401000,-401000
056333,台積電日盛9B購01,0,0,0,0,0,0,0,0,0,-401000,0,0,0,329000,730000,-401000,-401000
056938,泰碩元富98購01  ,0,0,0,0,0,0,0,0,0,-402000,0,0,0,37000,439000,-402000,-402000
057078,國巨統一9A購02  ,0,0,0,0,0,0,0,0,0,-402000,0,0,0,231000,633000,-402000,-402000
054695,世芯永豐98購01  ,0,0,0,0,0,0,0,0,0,-402000,0,0,0,35000,437000,-402000,-402000
052914,奇力新元富96購01,0,0,0,0,0,0,0,0,0,-403000,0,0,0,17000,420000,-403000,-403000
056921,京元電兆豐98購01,0,0,0,0,0,0,0,0,0,-405000,0,0,0,0,405000,-405000,-405000
056947,國巨統一9A購01  ,0,0,0,0,0,0,0,0,0,-406000,0,0,0,0,406000,-406000,-406000
054426,國泰金富邦97購02,0,0,0,0,0,0,0,0,0,-406000,0,0,0,150000,556000,-406000,-406000
06958P,FBVIX凱基9C售02 ,0,0,0,0,0,0,0,0,0,-406000,0,0,0,4000,410000,-406000,-406000
2308,台達電          ,4134958,4728939,-593981,0,0,0,3000,0,3000,182000,207000,28000,179000,37000,34000,3000,-408981
5471,松翰            ,1565000,1985000,-420000,0,0,0,0,0,0,11000,13000,2000,11000,0,0,0,-409000
056858,國巨群益99購03  ,0,0,0,0,0,0,0,0,0,-410000,0,0,0,98000,508000,-410000,-410000
052805,晶技元大97購01  ,0,0,0,0,0,0,0,0,0,-410000,0,0,0,157000,567000,-410000,-410000
051028,台光電元富95購02,0,0,0,0,0,0,0,0,0,-411000,0,0,0,15000,426000,-411000,-411000
055166,台積電統一97購05,0,0,0,0,0,0,0,0,0,-413000,0,0,0,146000,559000,-413000,-413000
057361,元油2X元大98購11,0,0,0,0,0,0,0,0,0,-414000,0,0,0,0,414000,-414000,-414000
049745,國巨永豐94購04  ,0,0,0,0,0,0,0,0,0,-415000,0,0,0,142000,557000,-415000,-415000
054563,泰碩群益99購01  ,0,0,0,0,0,0,0,0,0,-415000,0,0,0,220000,635000,-415000,-415000
3704,合勤控          ,979000,1410000,-431000,0,0,0,0,0,0,16000,1000,1000,0,16000,0,16000,-415000
056398,南茂永豐98購01  ,0,0,0,0,0,0,0,0,0,-416000,0,0,0,496000,912000,-416000,-416000
07007P,台灣50台新01售02,0,0,0,0,0,0,0,0,0,-417000,0,0,0,2000,419000,-417000,-417000
052888,台表科中信9A購01,0,0,0,0,0,0,0,0,0,-418000,0,0,0,0,418000,-418000,-418000
054459,鈺齊群益96購01  ,0,0,0,0,0,0,0,0,0,-418000,0,0,0,0,418000,-418000,-418000
055877,奇鋐元富97購01  ,0,0,0,0,0,0,0,0,0,-419000,0,0,0,2000,421000,-419000,-419000
056967,奇鋐永豐98購01  ,0,0,0,0,0,0,0,0,0,-420000,0,0,0,235000,655000,-420000,-420000
057595,健鼎兆豐98購01  ,0,0,0,0,0,0,0,0,0,-421000,0,0,0,0,421000,-421000,-421000
053045,國巨中信97購01  ,0,0,0,0,0,0,0,0,0,-422000,0,0,0,48000,470000,-422000,-422000
057562,奇鋐兆豐98購01  ,0,0,0,0,0,0,0,0,0,-423000,0,0,0,7000,430000,-423000,-423000
056787,健鼎群益98購01  ,0,0,0,0,0,0,0,0,0,-423000,0,0,0,10000,433000,-423000,-423000
054679,台積電康和99購01,0,0,0,0,0,0,0,0,0,-424000,0,0,0,2000,426000,-424000,-424000
043231,鴻海中信95購01  ,0,0,0,0,0,0,0,0,0,-425000,0,0,0,0,425000,-425000,-425000
055122,國巨兆豐98購01  ,0,0,0,0,0,0,0,0,0,-425000,0,0,0,246000,671000,-425000,-425000
054162,光罩凱基98購01  ,0,0,0,0,0,0,0,0,0,-425000,0,0,0,255000,680000,-425000,-425000
055739,健鼎元富97購01  ,0,0,0,0,0,0,0,0,0,-425000,0,0,0,10000,435000,-425000,-425000
052851,滬深2X元富96購02,0,0,0,0,0,0,0,0,0,-427000,0,0,0,188000,615000,-427000,-427000
055009,合勤控元富97購01,0,0,0,0,0,0,0,0,0,-427000,0,0,0,50000,477000,-427000,-427000
050848,日月光國票95購01,0,0,0,0,0,0,0,0,0,-428000,0,0,0,2000,430000,-428000,-428000
053935,華通元富96購02  ,0,0,0,0,0,0,0,0,0,-428000,0,0,0,0,428000,-428000,-428000
049843,康友中信95購01  ,0,0,0,0,0,0,0,0,0,-429000,0,0,0,94000,523000,-429000,-429000
058690,元油2X國票9A購03,0,0,0,0,0,0,0,0,0,-430000,0,0,0,0,430000,-430000,-430000
057902,嘉晶永豐98購02  ,0,0,0,0,0,0,0,0,0,-431000,0,0,0,29000,460000,-431000,-431000
057826,祥碩元大98購08  ,0,0,0,0,0,0,0,0,0,-431000,0,0,0,65000,496000,-431000,-431000
056579,麗豐元大99購01  ,0,0,0,0,0,0,0,0,0,-431000,0,0,0,166000,597000,-431000,-431000
057356,彩晶統一98購04  ,0,0,0,0,0,0,0,0,0,-432000,0,0,0,0,432000,-432000,-432000
048287,嘉晶兆豐94購01  ,0,0,0,0,0,0,0,0,0,-432000,0,0,0,6000,438000,-432000,-432000
050177,聯發科元大94購11,0,0,0,0,0,0,0,0,0,-433000,0,0,0,200000,633000,-433000,-433000
051410,京元電國票96購01,0,0,0,0,0,0,0,0,0,-433000,0,0,0,365000,798000,-433000,-433000
056436,台積電凱基98購10,0,0,0,0,0,0,0,0,0,-434000,0,0,0,0,434000,-434000,-434000
054378,楠梓電群益98購01,0,0,0,0,0,0,0,0,0,-434000,0,0,0,0,434000,-434000,-434000
055210,S&P正2凱基97購01,0,0,0,0,0,0,0,0,0,-434000,0,0,0,0,434000,-434000,-434000
06503P,臺股指中信9A售02,0,0,0,0,0,0,0,0,0,-434000,0,0,0,366000,800000,-434000,-434000
058638,矽力兆豐99購01  ,0,0,0,0,0,0,0,0,0,-436000,0,0,0,0,436000,-436000,-436000
058433,台積電統一9B購04,0,0,0,0,0,0,0,0,0,-436000,0,0,0,0,436000,-436000,-436000
057122,元油2X凱基9B購05,0,0,0,0,0,0,0,0,0,-438000,0,0,0,80000,518000,-438000,-438000
04727P,臺股指凱基96售03,0,0,0,0,0,0,0,0,0,-438000,0,0,0,10000,448000,-438000,-438000
058365,奇力新凱基9A購01,0,0,0,0,0,0,0,0,0,-440000,0,0,0,150000,590000,-440000,-440000
057960,聯鈞元大98購02  ,0,0,0,0,0,0,0,0,0,-440000,0,0,0,204000,644000,-440000,-440000
055795,茂林國泰98購01  ,0,0,0,0,0,0,0,0,0,-440000,0,0,0,10000,450000,-440000,-440000
054744,晶相光凱基99購01,0,0,0,0,0,0,0,0,0,-440000,0,0,0,89000,529000,-440000,-440000
056930,晶豪科台新98購01,0,0,0,0,0,0,0,0,0,-442000,0,0,0,48000,490000,-442000,-442000
055258,玉晶光統一97購03,0,0,0,0,0,0,0,0,0,-443000,0,0,0,0,443000,-443000,-443000
056500,大立光富邦9B購02,0,0,0,0,0,0,0,0,0,-444000,0,0,0,60000,504000,-444000,-444000
055156,華新科元大99購02,0,0,0,0,0,0,0,0,0,-444000,0,0,0,10000,454000,-444000,-444000
05948P,茂林元大96售03  ,0,0,0,0,0,0,0,0,0,-446000,0,0,0,340000,786000,-446000,-446000
054316,矽創凱基97購01  ,0,0,0,0,0,0,0,0,0,-446000,0,0,0,108000,554000,-446000,-446000
3090,日電貿          ,395000,847000,-452000,0,0,0,0,0,0,6000,1000,0,1000,15000,10000,5000,-446000
047688,亞德客富邦95購01,0,0,0,0,0,0,0,0,0,-447000,0,0,0,15000,462000,-447000,-447000
053051,楠梓電國票97購01,0,0,0,0,0,0,0,0,0,-449000,0,0,0,0,449000,-449000,-449000
1310,台苯            ,388000,843000,-455000,0,0,0,0,0,0,5000,7000,2000,5000,0,0,0,-450000
054623,華新科第一97購01,0,0,0,0,0,0,0,0,0,-451000,0,0,0,0,451000,-451000,-451000
051240,台積電元大95購12,0,0,0,0,0,0,0,0,0,-454000,0,0,0,1000,455000,-454000,-454000
057396,健鼎中信99購01  ,0,0,0,0,0,0,0,0,0,-455000,0,0,0,10000,465000,-455000,-455000
051145,台積電凱基95購05,0,0,0,0,0,0,0,0,0,-455000,0,0,0,50000,505000,-455000,-455000
053925,群創國票98購01  ,0,0,0,0,0,0,0,0,0,-457000,0,0,0,51000,508000,-457000,-457000
056467,上証2X元大98購02,0,0,0,0,0,0,0,0,0,-458000,0,0,0,49000,507000,-458000,-458000
058112,神達元富98購01  ,0,0,0,0,0,0,0,0,0,-458000,0,0,0,104000,562000,-458000,-458000
054259,健策元大97購03  ,0,0,0,0,0,0,0,0,0,-458000,0,0,0,89000,547000,-458000,-458000
053532,台積電永豐96購03,0,0,0,0,0,0,0,0,0,-459000,0,0,0,310000,769000,-459000,-459000
050064,華新科凱基94購08,0,0,0,0,0,0,0,0,0,-461000,0,0,0,0,461000,-461000,-461000
057540,緯穎日盛99購01  ,0,0,0,0,0,0,0,0,0,-464000,0,0,0,48000,512000,-464000,-464000
054533,泰碩國泰98購01  ,0,0,0,0,0,0,0,0,0,-464000,0,0,0,53000,517000,-464000,-464000
058229,為升元大99購02  ,30000,0,30000,0,0,0,0,0,0,-495000,0,0,0,56000,551000,-495000,-465000
057896,嘉晶元富98購01  ,0,0,0,0,0,0,0,0,0,-468000,0,0,0,7000,475000,-468000,-468000
052986,聯發科元大97購05,0,0,0,0,0,0,0,0,0,-468000,0,0,0,363000,831000,-468000,-468000
053797,台積電中信98購01,0,0,0,0,0,0,0,0,0,-468000,0,0,0,30000,498000,-468000,-468000
057590,元油2X兆豐98購02,0,0,0,0,0,0,0,0,0,-470000,0,0,0,0,470000,-470000,-470000
055022,精元國泰99購01  ,0,0,0,0,0,0,0,0,0,-470000,0,0,0,0,470000,-470000,-470000
056222,台積電凱基9A購01,0,0,0,0,0,0,0,0,0,-471000,0,0,0,211000,682000,-471000,-471000
057721,華擎元富98購02  ,0,0,0,0,0,0,0,0,0,-472000,0,0,0,146000,618000,-472000,-472000
058345,台光電群益99購03,0,0,0,0,0,0,0,0,0,-473000,0,0,0,65000,538000,-473000,-473000
051924,聯茂日盛95購01  ,0,0,0,0,0,0,0,0,0,-473000,0,0,0,99000,572000,-473000,-473000
055924,深中小群益9B購01,0,0,0,0,0,0,0,0,0,-474000,0,0,0,511000,985000,-474000,-474000
056270,群創統一98購04  ,0,0,0,0,0,0,0,0,0,-475000,0,0,0,200000,675000,-475000,-475000
058125,元油2X元大9C購01,0,0,0,0,0,0,0,0,0,-476000,0,0,0,297000,773000,-476000,-476000
051201,台積電麥證95購02,0,0,0,136000,613000,-477000,0,0,0,-477000,0,0,0,136000,613000,-477000,-477000
053683,上証2X元大96購03,0,0,0,0,0,0,0,0,0,-477000,0,0,0,0,477000,-477000,-477000
057058,祥碩元大98購04  ,0,0,0,0,0,0,0,0,0,-478000,0,0,0,92000,570000,-478000,-478000
058160,奇鋐元富99購01  ,0,0,0,0,0,0,0,0,0,-479000,0,0,0,54000,533000,-479000,-479000
051222,世紀鋼元富95購01,0,0,0,0,0,0,0,0,0,-479000,0,0,0,259000,738000,-479000,-479000
049967,華新科國票94購07,0,0,0,0,0,0,0,0,0,-481000,0,0,0,378000,859000,-481000,-481000
054249,技嘉元大96購03  ,0,0,0,0,0,0,0,0,0,-481000,0,0,0,137000,618000,-481000,-481000
058493,台積電群益9A購01,20000,0,20000,0,0,0,0,0,0,-502000,0,0,0,60000,562000,-502000,-482000
04380P,欣興元大94售02  ,0,0,0,0,0,0,0,0,0,-482000,0,0,0,0,482000,-482000,-482000
055493,華新科元大97購09,0,0,0,0,0,0,0,0,0,-482000,0,0,0,174000,656000,-482000,-482000
055693,南茂凱基97購01  ,0,0,0,0,0,0,0,0,0,-483000,0,0,0,174000,657000,-483000,-483000
1312,國喬            ,855000,1357000,-502000,0,0,0,0,0,0,19000,26000,9000,17000,2000,0,2000,-483000
053864,義隆元大96購01  ,0,0,0,0,0,0,0,0,0,-484000,0,0,0,45000,529000,-484000,-484000
052945,嘉晶國票97購01  ,0,0,0,0,0,0,0,0,0,-487000,0,0,0,19000,506000,-487000,-487000
055811,國巨國票98購05  ,0,0,0,0,0,0,0,0,0,-487000,0,0,0,40000,527000,-487000,-487000
056505,聯發科永豐98購01,0,0,0,0,0,0,0,0,0,-488000,0,0,0,277000,765000,-488000,-488000
055812,台積電國票99購02,0,0,0,0,0,0,0,0,0,-488000,0,0,0,467000,955000,-488000,-488000
054089,台積電群益96購11,0,0,0,0,0,0,0,0,0,-489000,0,0,0,2000,491000,-489000,-489000
048261,鴻海元富95購01  ,0,0,0,0,0,0,0,0,0,-490000,0,0,0,190000,680000,-490000,-490000
048746,台達電元富94購01,0,0,0,0,0,0,0,0,0,-490000,0,0,0,30000,520000,-490000,-490000
052434,茂林國泰97購01  ,0,0,0,0,0,0,0,0,0,-490000,0,0,0,10000,500000,-490000,-490000
057750,神達國票99購01  ,0,0,0,0,0,0,0,0,0,-491000,0,0,0,306000,797000,-491000,-491000
1477,聚陽            ,871000,1328000,-457000,0,0,0,0,0,0,-35000,28000,61000,-33000,1000,3000,-2000,-492000
04935P,鴻海中信96售01  ,0,0,0,0,0,0,0,0,0,-493000,0,0,0,34000,527000,-493000,-493000
055221,矽創凱基97購02  ,0,0,0,0,0,0,0,0,0,-493000,0,0,0,33000,526000,-493000,-493000
051602,南茂兆豐96購01  ,0,0,0,0,0,0,0,0,0,-495000,0,0,0,32000,527000,-495000,-495000
054072,台積電富邦98購02,0,0,0,0,0,0,0,0,0,-495000,0,0,0,1129000,1624000,-495000,-495000
056637,台光電日盛9A購01,0,0,0,0,0,0,0,0,0,-498000,0,0,0,191000,689000,-498000,-498000
047285,鴻海統一95購02  ,0,0,0,0,0,0,0,0,0,-498000,0,0,0,0,498000,-498000,-498000
047418,智邦富邦97購01  ,0,0,0,0,0,0,0,0,0,-498000,0,0,0,50000,548000,-498000,-498000
052852,國巨元富96購02  ,0,0,0,0,0,0,0,0,0,-499000,0,0,0,0,499000,-499000,-499000
054325,奇力新台新97購03,0,0,0,0,0,0,0,0,0,-499000,0,0,0,0,499000,-499000,-499000
05711P,茂林國票97售03  ,0,0,0,0,0,0,0,0,0,-500000,0,0,0,159000,659000,-500000,-500000
058211,國巨群益9A購02  ,0,0,0,0,0,0,0,0,0,-500000,0,0,0,0,500000,-500000,-500000
047212,宏達電富邦97購01,0,0,0,0,0,0,0,0,0,-500000,0,0,0,50000,550000,-500000,-500000
055201,興勤群益98購01  ,0,0,0,0,0,0,0,0,0,-500000,0,0,0,0,500000,-500000,-500000
051272,嘉晶群益95購01  ,0,0,0,0,0,0,0,0,0,-503000,0,0,0,60000,563000,-503000,-503000
055601,茂林元大97購03  ,0,0,0,0,0,0,0,0,0,-503000,0,0,0,0,503000,-503000,-503000
053765,智邦富邦96購01  ,0,0,0,0,0,0,0,0,0,-503000,0,0,0,163000,666000,-503000,-503000
1712,興農            ,366000,889000,-523000,0,0,0,0,0,0,20000,20000,0,20000,0,0,0,-503000
055319,國巨國票98購03  ,0,0,0,0,0,0,0,0,0,-504000,0,0,0,11000,515000,-504000,-504000
057891,華新科統一9A購01,0,0,0,0,0,0,0,0,0,-505000,0,0,0,190000,695000,-505000,-505000
042792,T50反1台新9C購01,0,0,0,0,0,0,0,0,0,-507000,0,0,0,37000,544000,-507000,-507000
1904,正隆            ,2663000,2509000,154000,0,0,0,100000,722000,-622000,-40000,20000,60000,-40000,0,0,0,-508000
052233,台郡凱基96購01  ,0,0,0,0,0,0,0,0,0,-511000,0,0,0,0,511000,-511000,-511000
053219,祥碩凱基96購01  ,0,0,0,0,0,0,0,0,0,-512000,0,0,0,64000,576000,-512000,-512000
054796,康普群益98購01  ,0,0,0,0,0,0,0,0,0,-514000,0,0,0,0,514000,-514000,-514000
058154,泰碩統一9A購01  ,0,0,0,0,0,0,0,0,0,-518000,0,0,0,114000,632000,-518000,-518000
3023,信邦            ,485000,1007494,-522494,0,0,0,3000,0,3000,1000,54000,59000,-5000,9000,3000,6000,-518494
055696,華新科國票98購01,0,0,0,0,0,0,0,0,0,-519000,0,0,0,273000,792000,-519000,-519000
058175,旺宏凱基99購03  ,0,0,0,0,0,0,0,0,0,-520000,0,0,0,604000,1124000,-520000,-520000
045829,滬深2X群益95購02,0,0,0,0,0,0,0,0,0,-520000,0,0,0,0,520000,-520000,-520000
051432,群創元富99購03  ,0,0,0,0,0,0,0,0,0,-520000,0,0,0,5000,525000,-520000,-520000
057799,世紀鋼兆豐98購01,0,0,0,0,0,0,0,0,0,-522000,0,0,0,269000,791000,-522000,-522000
054395,華新科永豐96購03,0,0,0,0,0,0,0,0,0,-523000,0,0,0,119000,642000,-523000,-523000
050601,台表科國泰96購01,0,0,0,0,0,0,0,0,0,-524000,0,0,0,112000,636000,-524000,-524000
054962,玉晶光元大99購02,0,0,0,0,0,0,0,0,0,-524000,0,0,0,105000,629000,-524000,-524000
058291,元油2X日盛99購01,0,0,0,0,0,0,0,0,0,-525000,0,0,0,300000,825000,-525000,-525000
052854,聯詠日盛96購01  ,0,0,0,0,0,0,0,0,0,-525000,0,0,0,0,525000,-525000,-525000
054808,東元元大9A購01  ,0,0,0,0,0,0,0,0,0,-527000,0,0,0,85000,612000,-527000,-527000
058426,旺宏元富99購02  ,0,0,0,0,0,0,0,0,0,-528000,0,0,0,8000,536000,-528000,-528000
053919,可成國票97購02  ,0,0,0,0,0,0,0,0,0,-528000,0,0,0,0,528000,-528000,-528000
055556,奇力新凱基98購03,0,0,0,0,0,0,0,0,0,-530000,0,0,0,0,530000,-530000,-530000
055328,鈺齊國票98購01  ,0,0,0,0,0,0,0,0,0,-530000,0,0,0,216000,746000,-530000,-530000
058269,世芯永豐9A購01  ,0,0,0,0,0,0,0,0,0,-531000,0,0,0,30000,561000,-531000,-531000
052619,茂林國泰99購01  ,0,0,0,0,0,0,0,0,0,-531000,0,0,0,49000,580000,-531000,-531000
056839,台光電元富98購02,0,0,0,0,0,0,0,0,0,-533000,0,0,0,0,533000,-533000,-533000
052936,華通兆豐98購01  ,0,0,0,0,0,0,0,0,0,-535000,0,0,0,20000,555000,-535000,-535000
056832,元油2X元富98購12,0,0,0,0,0,0,0,0,0,-537000,0,0,0,0,537000,-537000,-537000
057405,麗豐群益98購01  ,0,0,0,0,0,0,0,0,0,-537000,0,0,0,41000,578000,-537000,-537000
06921P,台光電凱基98售06,0,0,0,0,0,0,0,0,0,-537000,0,0,0,109000,646000,-537000,-537000
052678,群創富邦96購01  ,0,0,0,0,0,0,0,0,0,-538000,0,0,0,12000,550000,-538000,-538000
047408,嘉晶統一95購01  ,0,0,0,0,0,0,0,0,0,-538000,0,0,0,81000,619000,-538000,-538000
055822,臺股指國票97購09,0,0,0,0,0,0,0,0,0,-538000,0,0,0,0,538000,-538000,-538000
056437,台積電凱基98購11,0,0,0,0,0,0,0,0,0,-543000,0,0,0,432000,975000,-543000,-543000
058464,矽創兆豐9A購01  ,0,0,0,0,0,0,0,0,0,-543000,0,0,0,60000,603000,-543000,-543000
055808,世紀鋼永豐97購01,0,0,0,0,0,0,0,0,0,-543000,0,0,0,220000,763000,-543000,-543000
049864,聯發科兆豐94購01,0,0,0,0,0,0,0,0,0,-547000,0,0,0,35000,582000,-547000,-547000
2387,精元            ,1324000,823000,501000,0,0,0,0,1100000,-1100000,52000,1000,0,1000,57000,6000,51000,-547000
052967,智邦群益96購01  ,0,0,0,0,0,0,0,0,0,-548000,0,0,0,97000,645000,-548000,-548000
054369,鴻海中信9C購01  ,0,0,0,0,0,0,0,0,0,-551000,0,0,0,347000,898000,-551000,-551000
056240,嘉晶群益97購02  ,0,0,0,0,0,0,0,0,0,-553000,0,0,0,4000,557000,-553000,-553000
057021,台積電凱基9A購02,0,0,0,0,0,0,0,0,0,-555000,0,0,0,10000,565000,-555000,-555000
056368,祥碩元大98購02  ,0,0,0,0,0,0,0,0,0,-558000,0,0,0,19000,577000,-558000,-558000
053133,華邦電國票97購01,0,0,0,0,0,0,0,0,0,-559000,0,0,0,0,559000,-559000,-559000
052877,矽創凱基96購01  ,0,0,0,0,0,0,0,0,0,-560000,0,0,0,0,560000,-560000,-560000
051322,國泰金國票96購01,0,0,0,0,0,0,0,0,0,-560000,0,0,0,0,560000,-560000,-560000
055565,祥碩凱基97購01  ,0,0,0,0,0,0,0,0,0,-560000,0,0,0,100000,660000,-560000,-560000
054389,為升元富96購02  ,0,0,0,0,0,0,0,0,0,-560000,0,0,0,0,560000,-560000,-560000
058121,國巨國票9A購01  ,0,0,0,0,0,0,0,0,0,-563000,0,0,0,143000,706000,-563000,-563000
050603,致新國泰96購01  ,0,0,0,0,0,0,0,0,0,-563000,0,0,0,150000,713000,-563000,-563000
057259,台積電兆豐98購03,0,0,0,0,0,0,0,0,0,-564000,0,0,0,262000,826000,-564000,-564000
057142,力成兆豐98購01  ,0,0,0,0,0,0,0,0,0,-565000,0,0,0,200000,765000,-565000,-565000
056257,聯茂元富97購04  ,0,0,0,0,0,0,0,0,0,-565000,0,0,0,82000,647000,-565000,-565000
04041P,大立光統一94售03,0,0,0,0,0,0,0,0,0,-571000,0,0,0,0,571000,-571000,-571000
054295,世芯元大96購03  ,0,0,0,0,0,0,0,0,0,-573000,0,0,0,210000,783000,-573000,-573000
051842,大成鋼富邦97購01,0,0,0,0,0,0,0,0,0,-574000,0,0,0,230000,804000,-574000,-574000
00668,國泰美國道瓊    ,91000,0,91000,0,0,0,0,0,0,-666000,0,0,0,106000,772000,-666000,-575000
055368,台積電元大97購24,0,10000,-10000,0,0,0,0,0,0,-565000,0,0,0,190000,755000,-565000,-575000
050613,台光電元大94購09,0,0,0,0,0,0,0,0,0,-576000,0,0,0,5000,581000,-576000,-576000
053718,全新凱基97購02  ,0,0,0,0,0,0,0,0,0,-576000,0,0,0,100000,676000,-576000,-576000
056284,台積電永豐97購06,0,0,0,0,0,0,0,0,0,-576000,0,0,0,35000,611000,-576000,-576000
05412P,泰碩國票95售02  ,0,0,0,0,0,0,0,0,0,-577000,0,0,0,300000,877000,-577000,-577000
058346,嘉晶群益99購01  ,0,0,0,0,0,0,0,0,0,-580000,0,0,0,64000,644000,-580000,-580000
055623,貿聯國泰99購01  ,0,0,0,0,0,0,0,0,0,-580000,0,0,0,123000,703000,-580000,-580000
048844,訊芯凱基94購02  ,0,0,0,0,0,0,0,0,0,-582000,0,0,0,20000,602000,-582000,-582000
052443,台積電元大95購23,0,0,0,0,0,0,0,0,0,-582000,0,0,0,85000,667000,-582000,-582000
050151,台積電群益94購12,0,0,0,0,0,0,0,0,0,-582000,0,0,0,5000,587000,-582000,-582000
058228,為升元大99購01  ,0,0,0,0,0,0,0,0,0,-584000,0,0,0,39000,623000,-584000,-584000
05677P,玉晶光群益98售03,0,0,0,0,0,0,0,0,0,-584000,0,0,0,107000,691000,-584000,-584000
056529,中環凱基98購01  ,0,0,0,0,0,0,0,0,0,-585000,0,0,0,0,585000,-585000,-585000
058054,台積電統一9C購01,0,0,0,0,0,0,0,0,0,-585000,0,0,0,23000,608000,-585000,-585000
058528,世紀鋼元大99購02,0,0,0,0,0,0,0,0,0,-585000,0,0,0,126000,711000,-585000,-585000
052476,台光電群益98購01,0,0,0,0,0,0,0,0,0,-585000,0,0,0,130000,715000,-585000,-585000
055982,T50反1元富97購01,0,0,0,0,0,0,0,0,0,-586000,0,0,0,10000,596000,-586000,-586000
06012P,世芯國票96售01  ,0,0,0,0,0,0,0,0,0,-592000,0,0,0,118000,710000,-592000,-592000
052546,友達中信98購01  ,0,0,0,0,0,0,0,0,0,-593000,0,0,0,23000,616000,-593000,-593000
054112,台積電麥證96購02,0,0,0,30000,624000,-594000,0,0,0,-594000,0,0,0,30000,624000,-594000,-594000
058652,SGBR2X中信01購01,0,0,0,0,0,0,0,0,0,-595000,0,0,0,0,595000,-595000,-595000
055990,矽創元富97購01  ,0,0,0,0,0,0,0,0,0,-595000,0,0,0,116000,711000,-595000,-595000
058423,臺股指麥證99購01,0,0,0,0,596000,-596000,0,0,0,-596000,0,0,0,0,596000,-596000,-596000
044464,滬深2X群益95購01,0,0,0,0,0,0,0,0,0,-597000,0,0,0,0,597000,-597000,-597000
049073,光罩凱基94購01  ,0,0,0,0,0,0,0,0,0,-599000,0,0,0,0,599000,-599000,-599000
058381,元石油中信9C購01,0,0,0,0,0,0,0,0,0,-600000,0,0,0,350000,950000,-600000,-600000
057275,友達元大9A購04  ,0,0,0,0,0,0,0,0,0,-600000,0,0,0,0,600000,-600000,-600000
046385,群創凱基98購03  ,0,0,0,0,0,0,0,0,0,-603000,0,0,0,80000,683000,-603000,-603000
058120,台灣50國票99購03,0,0,0,0,0,0,0,0,0,-606000,0,0,0,381000,987000,-606000,-606000
05599P,欣興台新96售01  ,0,0,0,0,0,0,0,0,0,-606000,0,0,0,0,606000,-606000,-606000
056971,麗豐永豐98購01  ,0,0,0,0,0,0,0,0,0,-609000,0,0,0,68000,677000,-609000,-609000
1560,中砂            ,153000,552000,-399000,0,0,0,0,0,0,-210000,0,210000,-210000,0,0,0,-609000
057820,華擎元大98購02  ,0,0,0,0,0,0,0,0,0,-612000,0,0,0,90000,702000,-612000,-612000
055701,亞德客富邦99購01,0,0,0,0,0,0,0,0,0,-613000,0,0,0,39000,652000,-613000,-613000
052972,義隆群益96購04  ,0,0,0,0,0,0,0,0,0,-617000,0,0,0,82000,699000,-617000,-617000
04980P,臺股指凱基96售08,0,0,0,0,0,0,0,0,0,-618000,0,0,0,3389000,4007000,-618000,-618000
052289,為升元富95購02  ,0,0,0,0,0,0,0,0,0,-619000,0,0,0,1000,620000,-619000,-619000
052400,聯詠凱基97購01  ,0,0,0,0,0,0,0,0,0,-619000,0,0,0,11000,630000,-619000,-619000
057085,立積統一9B購02  ,0,0,0,0,0,0,0,0,0,-620000,0,0,0,87000,707000,-620000,-620000
058354,台積電凱基9A購06,0,0,0,0,0,0,0,0,0,-621000,0,0,0,240000,861000,-621000,-621000
1722,台肥            ,679000,1307000,-628000,0,0,0,0,0,0,7000,10000,4000,6000,1000,0,1000,-621000
048573,世紀鋼元大93購05,0,0,0,0,0,0,0,0,0,-624000,0,0,0,0,624000,-624000,-624000
055391,光罩統一97購02  ,0,0,0,0,0,0,0,0,0,-626000,0,0,0,125000,751000,-626000,-626000
3450,聯鈞            ,721000,1394000,-673000,0,0,0,0,0,0,47000,14000,31000,-17000,125000,61000,64000,-626000
055771,台積電日盛97購04,0,0,0,0,0,0,0,0,0,-629000,0,0,0,30000,659000,-629000,-629000
051920,南茂元大95購03  ,0,0,0,0,0,0,0,0,0,-630000,0,0,0,120000,750000,-630000,-630000
056211,南港國票98購01  ,0,0,0,0,0,0,0,0,0,-630000,0,0,0,0,630000,-630000,-630000
053391,嘉聯益元大99購01,0,0,0,0,0,0,0,0,0,-633000,0,0,0,0,633000,-633000,-633000
050166,彩晶國泰95購01  ,0,0,0,0,0,0,0,0,0,-634000,0,0,0,90000,724000,-634000,-634000
057530,奇鋐元大99購01  ,0,0,0,0,0,0,0,0,0,-635000,0,0,0,50000,685000,-635000,-635000
1789,神隆            ,525000,1159000,-634000,0,0,0,0,0,0,-2000,18000,20000,-2000,0,0,0,-636000
2360,致茂            ,960000,1357000,-397000,0,0,0,140000,374000,-234000,-6000,47000,45000,2000,17000,25000,-8000,-637000
055099,可成日盛97購01  ,0,0,0,0,0,0,0,0,0,-639000,0,0,0,53000,692000,-639000,-639000
6412,群電            ,393000,1039766,-646766,0,0,0,1000,0,1000,6000,7000,1000,6000,0,0,0,-639766
048391,友訊國票94購01  ,0,0,0,0,0,0,0,0,0,-642000,0,0,0,85000,727000,-642000,-642000
2108,南帝            ,312000,984000,-672000,0,0,0,0,0,0,25000,25000,0,25000,0,0,0,-647000
055133,致新康和97購01  ,0,0,0,0,0,0,0,0,0,-651000,0,0,0,0,651000,-651000,-651000
055891,鴻海統一9A購01  ,0,0,0,0,0,0,0,0,0,-651000,0,0,0,575000,1226000,-651000,-651000
057440,台積電統一98購10,0,0,0,0,0,0,0,0,0,-652000,0,0,0,55000,707000,-652000,-652000
051259,鴻海永昌96購03  ,0,0,0,0,0,0,0,0,0,-659000,0,0,0,1450000,2109000,-659000,-659000
052042,台積電日盛95購02,0,0,0,0,0,0,0,0,0,-663000,0,0,0,447000,1110000,-663000,-663000
052066,華邦電兆豐96購01,0,0,0,0,0,0,0,0,0,-663000,0,0,0,482000,1145000,-663000,-663000
055966,茂林元大99購01  ,0,0,0,0,0,0,0,0,0,-664000,0,0,0,108000,772000,-664000,-664000
056918,台積電兆豐98購01,0,0,0,0,0,0,0,0,0,-669000,0,0,0,1169000,1838000,-669000,-669000
056859,台積電群益98購02,0,0,0,0,0,0,0,0,0,-669000,0,0,0,544000,1213000,-669000,-669000
055878,泰碩元富97購02  ,0,0,0,0,0,0,0,0,0,-670000,0,0,0,19000,689000,-670000,-670000
055196,致新元富97購01  ,0,0,0,0,0,0,0,0,0,-671000,0,0,0,42000,713000,-671000,-671000
06658P,台灣50富邦9C售01,0,0,0,0,0,0,0,0,0,-671000,0,0,0,41000,712000,-671000,-671000
057124,為升凱基98購02  ,0,0,0,0,0,0,0,0,0,-672000,0,0,0,120000,792000,-672000,-672000
052937,國巨兆豐97購01  ,0,0,0,0,0,0,0,0,0,-673000,0,0,0,163000,836000,-673000,-673000
2520,冠德            ,1002000,523000,479000,0,0,0,0,1139000,-1139000,-13000,8000,7000,1000,3000,17000,-14000,-673000
055450,台積電元富97購01,0,0,0,0,0,0,0,0,0,-679000,0,0,0,33000,712000,-679000,-679000
049848,聯發科群益94購06,0,0,0,0,0,0,0,0,0,-680000,0,0,0,140000,820000,-680000,-680000
054586,健鼎國泰99購01  ,0,0,0,0,0,0,0,0,0,-680000,0,0,0,80000,760000,-680000,-680000
058243,華擎元大99購01  ,0,0,0,0,0,0,0,0,0,-688000,0,0,0,60000,748000,-688000,-688000
056955,台灣50永豐98購01,31000,0,31000,0,0,0,0,0,0,-726000,0,0,0,0,726000,-726000,-695000
051827,智邦元大95購04  ,0,0,0,0,0,0,0,0,0,-695000,0,0,0,56000,751000,-695000,-695000
06170P,禾伸堂元富97售02,0,0,0,0,0,0,0,0,0,-695000,0,0,0,0,695000,-695000,-695000
054009,欣興元富96購03  ,0,0,0,0,0,0,0,0,0,-698000,0,0,0,15000,713000,-698000,-698000
056016,鴻海群益97購06  ,0,0,0,0,0,0,0,0,0,-701000,0,0,0,10000,711000,-701000,-701000
1217,愛之味          ,434000,1137000,-703000,0,0,0,0,0,0,0,0,0,0,0,0,0,-703000
057036,元油2X元大9B購04,0,0,0,0,0,0,0,0,0,-704000,0,0,0,297000,1001000,-704000,-704000
056730,元油2X凱基9A購04,0,0,0,0,0,0,0,0,0,-705000,0,0,0,0,705000,-705000,-705000
056807,元油2X統一9B購01,0,0,0,0,0,0,0,0,0,-712000,0,0,0,0,712000,-712000,-712000
058257,聯陽國泰9B購01  ,0,0,0,0,0,0,0,0,0,-712000,0,0,0,118000,830000,-712000,-712000
049491,聯發科元大95購01,0,0,0,0,0,0,0,0,0,-714000,0,0,0,1153000,1867000,-714000,-714000
056423,奇鋐統一98購01  ,0,0,0,0,0,0,0,0,0,-714000,0,0,0,12000,726000,-714000,-714000
058615,矽創元大99購01  ,0,0,0,0,0,0,0,0,0,-715000,0,0,0,50000,765000,-715000,-715000
049007,玉晶光中信96購01,0,0,0,0,0,0,0,0,0,-716000,0,0,0,391000,1107000,-716000,-716000
057043,台積電元大99購02,0,0,0,0,0,0,0,0,0,-725000,0,0,0,94000,819000,-725000,-725000
056704,健策國泰99購01  ,0,0,0,0,0,0,0,0,0,-728000,0,0,0,396000,1124000,-728000,-728000
058238,奇鋐元大99購02  ,0,0,0,0,0,0,0,0,0,-729000,0,0,0,214000,943000,-729000,-729000
06877P,台積電兆豐98售04,0,0,0,0,0,0,0,0,0,-733000,0,0,0,649000,1382000,-733000,-733000
052789,台積電麥證96購01,0,0,0,10000,744000,-734000,0,0,0,-734000,0,0,0,10000,744000,-734000,-734000
03661C,臺股指凱基9C牛03,0,0,0,0,0,0,0,0,0,-736000,0,0,0,22000,758000,-736000,-736000
058537,彩晶統一9B購01  ,0,0,0,0,0,0,0,0,0,-737000,0,0,0,0,737000,-737000,-737000
058329,S&P正2元富01購01,0,0,0,0,0,0,0,0,0,-739000,0,0,0,250000,989000,-739000,-739000
054982,國巨元富97購03  ,0,0,0,0,0,0,0,0,0,-742000,0,0,0,504000,1246000,-742000,-742000
00730,富邦臺灣優質高息,0,0,0,0,0,0,0,0,0,-746000,0,0,0,358000,1104000,-746000,-746000
052489,義隆國票96購02  ,0,0,0,0,0,0,0,0,0,-747000,0,0,0,10000,757000,-747000,-747000
056312,茂林元大98購01  ,0,0,0,0,0,0,0,0,0,-747000,0,0,0,79000,826000,-747000,-747000
2458,義隆            ,680000,1830000,-1150000,0,0,0,387000,0,387000,13000,30000,82000,-52000,89000,24000,65000,-750000
6271,同欣電          ,967000,927000,40000,0,0,0,0,671000,-671000,-122000,102000,189000,-87000,21000,56000,-35000,-753000
053630,奇鋐兆豐97購01  ,0,0,0,0,0,0,0,0,0,-755000,0,0,0,299000,1054000,-755000,-755000
054331,世芯永豐96購03  ,0,0,0,0,0,0,0,0,0,-756000,0,0,0,390000,1146000,-756000,-756000
050942,S&P正2群益95購01,0,0,0,0,0,0,0,0,0,-762000,0,0,0,62000,824000,-762000,-762000
053205,台光電麥證96購01,0,0,0,57000,864000,-807000,0,0,0,-767000,0,0,0,97000,864000,-767000,-767000
8271,宇瞻            ,947000,1920000,-973000,0,0,0,163000,0,163000,42000,56000,14000,42000,0,0,0,-768000
00653L,富邦印度正2     ,6000,1000,5000,0,0,0,0,0,0,-774000,0,0,0,94000,868000,-774000,-769000
9921,巨大            ,426000,1204613,-778613,0,0,0,1000,0,1000,0,6000,6000,0,0,0,0,-777613
056236,台積電群益97購06,0,0,0,0,0,0,0,0,0,-779000,0,0,0,751000,1530000,-779000,-779000
00640L,富邦日本正2     ,0,0,0,0,0,0,0,0,0,-781000,0,0,0,703000,1484000,-781000,-781000
054073,群創富邦96購03  ,0,0,0,0,0,0,0,0,0,-786000,0,0,0,5000,791000,-786000,-786000
6505,台塑化          ,2239000,2533000,-294000,0,0,0,22000,623000,-601000,103000,77000,20000,57000,46000,0,46000,-792000
2912,統一超          ,1048000,1851975,-803975,0,0,0,1000,0,1000,9000,11000,2000,9000,0,0,0,-793975
057263,可成兆豐99購01  ,0,0,0,0,0,0,0,0,0,-801000,0,0,0,135000,936000,-801000,-801000
055276,台積電元大97購20,0,0,0,0,0,0,0,0,0,-805000,0,0,0,96000,901000,-805000,-805000
051370,聯詠富邦97購01  ,0,0,0,0,0,0,0,0,0,-819000,0,0,0,200000,1019000,-819000,-819000
058527,世紀鋼元大99購01,0,0,0,0,0,0,0,0,0,-820000,0,0,0,393000,1213000,-820000,-820000
00647L,元大S&P500正2   ,3000,1000,2000,0,0,0,0,0,0,-828000,0,0,0,299000,1127000,-828000,-826000
054791,泰碩群益99購02  ,0,0,0,0,0,0,0,0,0,-830000,0,0,0,155000,985000,-830000,-830000
1762,中化生          ,260000,1095000,-835000,0,0,0,0,0,0,0,0,0,0,0,0,0,-835000
057973,神達富邦9A購01  ,0,0,0,0,0,0,0,0,0,-842000,0,0,0,26000,868000,-842000,-842000
5871,中租-KY         ,3922000,4820678,-898678,0,0,0,1000,0,1000,53000,71000,18000,53000,0,0,0,-844678
6257,矽格            ,544000,1523000,-979000,0,0,0,0,0,0,132000,76000,92000,-16000,160000,12000,148000,-847000
058224,世芯統一9B購02  ,0,0,0,0,0,0,0,0,0,-850000,0,0,0,54000,904000,-850000,-850000
053114,聯茂兆豐97購01  ,0,0,0,0,0,0,0,0,0,-861000,0,0,0,10000,871000,-861000,-861000
052032,臺股指群益95購05,0,0,0,0,0,0,0,0,0,-863000,0,0,0,426000,1289000,-863000,-863000
050100,台積電永昌96購02,0,0,0,0,0,0,0,0,0,-865000,0,0,0,759000,1624000,-865000,-865000
06440P,台積電凱基98售07,0,0,0,0,0,0,0,0,0,-866000,0,0,0,1384000,2250000,-866000,-866000
03660C,元油2X富邦02牛04,0,0,0,0,0,0,0,0,0,-875000,0,0,0,0,875000,-875000,-875000
00752,中信中國50      ,0,9000,-9000,0,0,0,0,0,0,-869000,0,0,0,913000,1782000,-869000,-878000
052107,台積電統一95購06,0,0,0,0,0,0,0,0,0,-884000,0,0,0,41000,925000,-884000,-884000
056256,聯茂元富97購03  ,0,0,0,0,0,0,0,0,0,-885000,0,0,0,80000,965000,-885000,-885000
056835,聯電元富99購01  ,0,0,0,0,0,0,0,0,0,-891000,0,0,0,508000,1399000,-891000,-891000
053036,聯電凱基98購01  ,0,0,0,0,0,0,0,0,0,-899000,0,0,0,10000,909000,-899000,-899000
1902,台紙            ,505000,1455000,-950000,0,0,0,0,0,0,50000,50000,0,50000,0,0,0,-900000
2347,聯強            ,2434000,4629000,-2195000,0,0,0,4000,0,4000,1288000,17000,58000,-41000,1330000,1000,1329000,-903000
2408,南亞科          ,2819000,4199000,-1380000,0,0,0,3000,253000,-250000,726000,157000,182000,-25000,766000,15000,751000,-904000
053563,台積電富邦97購01,20000,0,20000,0,0,0,0,0,0,-929000,0,0,0,0,929000,-929000,-909000
06540P,聯發科凱基98售13,0,0,0,0,0,0,0,0,0,-913000,0,0,0,11000,924000,-913000,-913000
006208,富邦台50        ,3000,3000,0,0,0,0,0,0,0,-919000,0,0,0,685000,1604000,-919000,-919000
056949,義隆統一98購01  ,0,0,0,0,0,0,0,0,0,-922000,0,0,0,50000,972000,-922000,-922000
050734,台積電台新94購02,0,0,0,0,0,0,0,0,0,-925000,0,0,0,10000,935000,-925000,-925000
2395,研華            ,1011500,1914075,-902575,0,0,0,3000,0,3000,-27000,9000,36000,-27000,0,0,0,-926575
057417,國巨凱基9A購03  ,0,0,0,0,0,0,0,0,0,-931000,0,0,0,203000,1134000,-931000,-931000
1907,永豐餘          ,1332000,2304000,-972000,0,0,0,24000,0,24000,12000,19000,7000,12000,0,0,0,-936000
052003,泰碩國泰97購02  ,0,0,0,0,0,0,0,0,0,-947000,0,0,0,433000,1380000,-947000,-947000
054980,國巨元富97購01  ,0,0,0,0,0,0,0,0,0,-947000,0,0,0,598000,1545000,-947000,-947000
057672,茂林元大98購02  ,0,0,0,0,0,0,0,0,0,-948000,0,0,0,18000,966000,-948000,-948000
043656,上証反元大94購01,0,0,0,0,0,0,0,0,0,-948000,0,0,0,9000,957000,-948000,-948000
06879P,長榮航凱基98售02,0,0,0,0,0,0,0,0,0,-950000,0,0,0,60000,1010000,-950000,-950000
1103,嘉泥            ,705000,1667000,-962000,0,0,0,0,0,0,12000,17000,5000,12000,0,0,0,-950000
057199,台達電元富02購01,0,0,0,0,0,0,0,0,0,-959000,0,0,0,30000,989000,-959000,-959000
054713,國巨中信9B購01  ,0,0,0,0,0,0,0,0,0,-959000,0,0,0,1061000,2020000,-959000,-959000
2634,漢翔            ,929000,1537706,-608706,0,0,0,1000,0,1000,-355000,7000,362000,-355000,0,0,0,-962706
054534,台積電富邦98購03,0,0,0,0,0,0,0,0,0,-966000,0,0,0,10000,976000,-966000,-966000
058562,元油2X凱基99購01,0,0,0,0,0,0,0,0,0,-967000,0,0,0,0,967000,-967000,-967000
2421,建準            ,786000,1748000,-962000,0,0,0,0,0,0,-5000,2000,1000,1000,17000,23000,-6000,-967000
058173,台積電凱基99購04,0,0,0,0,0,0,0,0,0,-971000,0,0,0,190000,1161000,-971000,-971000
6282,康舒            ,489000,1570000,-1081000,0,0,0,0,0,0,109000,120000,40000,80000,30000,1000,29000,-972000
056779,元油2X群益9A購02,0,0,0,0,0,0,0,0,0,-974000,0,0,0,5000,979000,-974000,-974000
054497,國巨永豐96購05  ,0,0,0,0,0,0,0,0,0,-978000,0,0,0,420000,1398000,-978000,-978000
052150,台積電富邦95購07,0,0,0,0,0,0,0,0,0,-983000,0,0,0,0,983000,-983000,-983000
3036,文曄            ,564000,1528198,-964198,0,0,0,12000,0,12000,-35000,25000,134000,-109000,84000,10000,74000,-987198
00712,FH富時不動產    ,0,0,0,0,0,0,0,0,0,-994000,0,0,0,2000,996000,-994000,-994000
052982,鴻海元大97購06  ,0,0,0,0,0,0,0,0,0,-1000000,0,0,0,0,1000000,-1000000,-1000000
047505,元金2X國票9B購01,0,0,0,0,0,0,0,0,0,-1004000,0,0,0,132000,1136000,-1004000,-1004000
055785,祥碩凱基97購02  ,0,12000,-12000,0,0,0,0,0,0,-1002000,0,0,0,37000,1039000,-1002000,-1014000
058462,台積電兆豐99購01,20000,0,20000,0,0,0,0,0,0,-1037000,0,0,0,224000,1261000,-1037000,-1017000
053949,康控富邦9A購01  ,0,0,0,0,0,0,0,0,0,-1021000,0,0,0,20000,1041000,-1021000,-1021000
058209,臺股指凱基01購01,0,0,0,0,0,0,0,0,0,-1029000,0,0,0,165000,1194000,-1029000,-1029000
058169,國巨凱基9A購05  ,0,0,0,0,0,0,0,0,0,-1041000,0,0,0,0,1041000,-1041000,-1041000
056074,茂林元大97購04  ,0,0,0,0,0,0,0,0,0,-1049000,0,0,0,37000,1086000,-1049000,-1049000
057248,台積電統一98購08,0,0,0,0,0,0,0,0,0,-1050000,0,0,0,60000,1110000,-1050000,-1050000
047231,大立光凱基95購03,0,0,0,0,0,0,0,0,0,-1053000,0,0,0,1000,1054000,-1053000,-1053000
044717,旺宏統一94購01  ,0,0,0,0,0,0,0,0,0,-1058000,0,0,0,516000,1574000,-1058000,-1058000
2885,元大金          ,10144000,11127036,-983036,0,0,0,20000,0,20000,-95000,15000,110000,-95000,2000,2000,0,-1058036
049438,嘉晶國泰96購01  ,0,0,0,0,0,0,0,0,0,-1060000,0,0,0,45000,1105000,-1060000,-1060000
2404,漢唐            ,306000,1587000,-1281000,0,0,0,1000,0,1000,213000,26000,102000,-76000,314000,25000,289000,-1067000
056827,元油2X富邦02購01,0,0,0,0,0,0,0,0,0,-1072000,0,0,0,6000,1078000,-1072000,-1072000
057769,T50反1群益98購02,0,0,0,0,0,0,0,0,0,-1088000,0,0,0,30000,1118000,-1088000,-1088000
3045,台灣大          ,3095296,4024764,-929468,0,0,0,31000,208000,-177000,17000,27000,11000,16000,1000,0,1000,-1089468
020012,富邦行動通訊N   ,0,0,0,0,0,0,0,0,0,-1092000,0,0,0,367000,1459000,-1092000,-1092000
058195,鈺齊永豐99購01  ,0,0,0,0,0,0,0,0,0,-1094000,0,0,0,2000,1096000,-1094000,-1094000
3545,敦泰            ,4169000,5348000,-1179000,0,0,0,0,0,0,79000,99000,20000,79000,0,0,0,-1100000
055614,華新科國票97購02,0,0,0,0,0,0,0,0,0,-1119000,0,0,0,332000,1451000,-1119000,-1119000
058489,台灣50群益9B購01,0,0,0,0,0,0,0,0,0,-1132000,0,0,0,190000,1322000,-1132000,-1132000
057015,元油2X凱基9B購04,0,0,0,0,0,0,0,0,0,-1132000,0,0,0,0,1132000,-1132000,-1132000
055663,崇越中信97購01  ,0,0,0,0,0,0,0,0,0,-1135000,0,0,0,80000,1215000,-1135000,-1135000
052844,台積電統一96購02,0,0,0,0,0,0,0,0,0,-1150000,0,0,0,52000,1202000,-1150000,-1150000
053401,臺股指中信99購01,0,0,0,0,0,0,0,0,0,-1169000,0,0,0,817000,1986000,-1169000,-1169000
00830,國泰費城半導體  ,95000,193000,-98000,0,0,0,0,0,0,-1072000,0,0,0,49000,1121000,-1072000,-1170000
057069,台積電永豐98購02,0,0,0,0,0,0,0,0,0,-1178000,0,0,0,106000,1284000,-1178000,-1178000
05511P,T50反1台新06售01,0,0,0,0,0,0,0,0,0,-1201000,0,0,0,0,1201000,-1201000,-1201000
056017,台積電群益97購04,0,0,0,0,0,0,0,0,0,-1211000,0,0,0,1410000,2621000,-1211000,-1211000
048728,台達電麥證94購01,0,0,0,20000,1240000,-1220000,0,0,0,-1220000,0,0,0,20000,1240000,-1220000,-1220000
053621,臺股指群益96購07,0,0,0,0,0,0,0,0,0,-1230000,0,0,0,0,1230000,-1230000,-1230000
044104,鴻海中信95購03  ,0,0,0,0,0,0,0,0,0,-1240000,0,0,0,0,1240000,-1240000,-1240000
054914,億光凱基98購01  ,0,0,0,0,0,0,0,0,0,-1252000,0,0,0,4000,1256000,-1252000,-1252000
2357,華碩            ,1388000,2838000,-1450000,0,0,0,0,0,0,195000,6000,4000,2000,194000,1000,193000,-1255000
049545,台積電群益94購09,0,0,0,0,0,0,0,0,0,-1268000,0,0,0,0,1268000,-1268000,-1268000
057426,元油2X兆豐9B購01,0,0,0,0,0,0,0,0,0,-1285000,0,0,0,0,1285000,-1285000,-1285000
051845,世紀鋼富邦96購01,0,0,0,0,0,0,0,0,0,-1302000,0,0,0,235000,1537000,-1302000,-1302000
07480P,FBVIX凱基94售01 ,0,0,0,0,0,0,0,0,0,-1302000,0,0,0,64000,1366000,-1302000,-1302000
053646,臺股指國票96購09,0,0,0,0,0,0,0,0,0,-1305000,0,0,0,90000,1395000,-1305000,-1305000
00701,國泰股利精選30  ,73000,36000,37000,0,0,0,0,0,0,-1345000,0,0,0,1340000,2685000,-1345000,-1308000
058151,台積電統一9A購04,0,0,0,0,0,0,0,0,0,-1316000,0,0,0,196000,1512000,-1316000,-1316000
058415,祥碩兆豐99購01  ,0,0,0,0,0,0,0,0,0,-1320000,0,0,0,1516000,2836000,-1320000,-1320000
056595,台積電元富98購04,0,0,0,0,0,0,0,0,0,-1326000,0,0,0,164000,1490000,-1326000,-1326000
056605,台積電富邦9B購02,0,0,0,0,0,0,0,0,0,-1326000,0,0,0,111000,1437000,-1326000,-1326000
4119,旭富            ,542000,1756000,-1214000,0,0,0,8000,0,8000,-138000,76000,32000,44000,10000,192000,-182000,-1344000
053777,台積電元大96購20,0,0,0,0,0,0,0,0,0,-1357000,0,0,0,425000,1782000,-1357000,-1357000
058580,華新科群益99購02,0,0,0,0,0,0,0,0,0,-1363000,0,0,0,15000,1378000,-1363000,-1363000
00850,元大臺灣ESG永續 ,3000,15000,-12000,0,0,0,0,0,0,-1353000,0,0,0,1267000,2620000,-1353000,-1365000
058483,道瓊指國票9A購01,0,0,0,0,0,0,0,0,0,-1366000,0,0,0,215000,1581000,-1366000,-1366000
054860,台積電群益98購01,0,0,0,0,0,0,0,0,0,-1366000,0,0,0,14000,1380000,-1366000,-1366000
055564,茂林凱基98購01  ,0,0,0,0,0,0,0,0,0,-1369000,0,0,0,0,1369000,-1369000,-1369000
056112,勤誠永豐97購02  ,0,0,0,0,0,0,0,0,0,-1375000,0,0,0,0,1375000,-1375000,-1375000
054933,南港元大97購01  ,0,0,0,0,0,0,0,0,0,-1391000,0,0,0,20000,1411000,-1391000,-1391000
057961,茂林元大9A購01  ,0,0,0,0,0,0,0,0,0,-1395000,0,0,0,2000,1397000,-1395000,-1395000
058695,元油2X元大9C購03,0,0,0,0,0,0,0,0,0,-1408000,0,0,0,0,1408000,-1408000,-1408000
057459,臺股指富邦99購03,0,0,0,0,0,0,0,0,0,-1419000,0,0,0,0,1419000,-1419000,-1419000
2412,中華電          ,4489494,5926728,-1437234,0,0,0,53000,0,53000,-85000,60000,149000,-89000,6000,2000,4000,-1469234
057143,台郡兆豐98購01  ,0,0,0,0,0,0,0,0,0,-1471000,0,0,0,30000,1501000,-1471000,-1471000
2352,佳世達          ,1364000,2948000,-1584000,0,0,0,14000,0,14000,84000,106000,33000,73000,11000,0,11000,-1486000
058210,臺股指凱基9C購04,0,0,0,0,0,0,0,0,0,-1497000,0,0,0,531000,2028000,-1497000,-1497000
051727,S&P反1國票97購01,0,0,0,0,0,0,0,0,0,-1500000,0,0,0,0,1500000,-1500000,-1500000
1210,大成            ,563000,1349000,-786000,0,0,0,16000,754000,-738000,17000,20000,3000,17000,0,0,0,-1507000
050934,喬山國票96購01  ,0,0,0,0,0,0,0,0,0,-1513000,0,0,0,4000,1517000,-1513000,-1513000
06652P,長榮航元大98售01,0,0,0,0,0,0,0,0,0,-1517000,0,0,0,63000,1580000,-1517000,-1517000
054011,旺宏永豐96購05  ,0,0,0,0,0,0,0,0,0,-1520000,0,0,0,0,1520000,-1520000,-1520000
057753,臺股指國票98購09,0,0,0,0,0,0,0,0,0,-1541000,0,0,0,82000,1623000,-1541000,-1541000
052114,華固中信95購01  ,0,0,0,0,0,0,0,0,0,-1550000,0,0,0,0,1550000,-1550000,-1550000
058094,祥碩元大98購09  ,0,0,0,0,0,0,0,0,0,-1556000,0,0,0,300000,1856000,-1556000,-1556000
3711,日月光投控      ,3705888,5411000,-1705112,0,0,0,67000,0,67000,70000,74000,11000,63000,40000,33000,7000,-1568112
03686P,大立光統一98售02,0,0,0,0,0,0,0,0,0,-1577000,0,0,0,619000,2196000,-1577000,-1577000
050416,高股息凱基96購02,0,0,0,0,0,0,0,0,0,-1592000,0,0,0,17000,1609000,-1592000,-1592000
054197,台積電永昌96購07,0,0,0,0,0,0,0,0,0,-1593000,0,0,0,1757000,3350000,-1593000,-1593000
057858,T50正2康和98購01,0,0,0,0,0,0,0,0,0,-1620000,0,0,0,0,1620000,-1620000,-1620000
6251,定穎            ,1478000,2661000,-1183000,0,0,0,0,0,0,-440000,320000,760000,-440000,0,0,0,-1623000
5469,瀚宇博          ,965000,2630898,-1665898,0,0,0,0,0,0,33000,3000,0,3000,90000,60000,30000,-1632898
03647C,T50反1元富99牛02,0,0,0,0,0,0,0,0,0,-1647000,0,0,0,0,1647000,-1647000,-1647000
1714,和桐            ,1104000,2866000,-1762000,0,0,0,0,0,0,107000,107000,0,107000,0,0,0,-1655000
00646,元大S&P500      ,398000,152000,246000,0,0,0,0,0,0,-1929000,0,0,0,64000,1993000,-1929000,-1683000
052752,臺股指元大96購06,0,0,0,0,0,0,0,0,0,-1683000,0,0,0,100000,1783000,-1683000,-1683000
2379,瑞昱            ,1146000,2870680,-1724680,0,0,0,0,0,0,41000,77000,1000,76000,2000,37000,-35000,-1683680
058207,南茂凱基99購01  ,0,0,0,0,0,0,0,0,0,-1699000,0,0,0,388000,2087000,-1699000,-1699000
056671,台灣50元富9A購01,430000,0,430000,0,0,0,0,0,0,-2139000,0,0,0,245000,2384000,-2139000,-1709000
2880,華南金          ,11444639,13239511,-1794872,0,0,0,12000,0,12000,27000,88000,35000,53000,0,26000,-26000,-1755872
058383,道瓊指中信9C購02,0,0,0,0,0,0,0,0,0,-1798000,0,0,0,27000,1825000,-1798000,-1798000
058501,S&P正2元大99購01,0,0,0,0,0,0,0,0,0,-1807000,0,0,0,318000,2125000,-1807000,-1807000
056758,元石油元大98購02,0,0,0,0,0,0,0,0,0,-1812000,0,0,0,0,1812000,-1812000,-1812000
2382,廣達            ,2482000,5138000,-2656000,0,0,0,4000,0,4000,820000,227000,147000,80000,758000,18000,740000,-1832000
050077,臺股指凱基99購02,0,0,0,0,0,0,0,0,0,-1871000,0,0,0,121000,1992000,-1871000,-1871000
03652C,臺股指元大03牛01,0,0,0,0,0,0,0,0,0,-1884000,0,0,0,203000,2087000,-1884000,-1884000
056975,元油2X群益98購03,0,0,0,0,0,0,0,0,0,-1906000,0,0,0,0,1906000,-1906000,-1906000
00692,富邦公司治理    ,5000,0,5000,0,0,0,0,0,0,-1955000,0,0,0,1777000,3732000,-1955000,-1950000
054377,臺股指中信99購09,0,0,0,0,0,0,0,0,0,-1977000,0,0,0,8000,1985000,-1977000,-1977000
058667,元油2X群益99購01,0,0,0,0,0,0,0,0,0,-1985000,0,0,0,0,1985000,-1985000,-1985000
054633,臺股指凱基9A購02,0,0,0,0,0,0,0,0,0,-1990000,0,0,0,0,1990000,-1990000,-1990000
8150,南茂            ,2546000,6873000,-4327000,0,0,0,224000,0,224000,2111000,106000,2000,104000,2356000,349000,2007000,-1992000
044269,群創中信95購01  ,0,0,0,0,0,0,0,0,0,-1994000,0,0,0,71000,2065000,-1994000,-1994000
052750,臺股指元大96購04,0,0,0,0,0,0,0,0,0,-2026000,0,0,0,878000,2904000,-2026000,-2026000
1301,台塑            ,3018000,4854022,-1836022,0,0,0,29000,0,29000,-239000,52000,81000,-29000,7000,217000,-210000,-2046022
050715,台積電群益96購01,0,0,0,0,0,0,0,0,0,-2119000,0,0,0,50000,2169000,-2119000,-2119000
058466,SGBR2X中信99購02,0,0,0,0,0,0,0,0,0,-2123000,0,0,0,0,2123000,-2123000,-2123000
054983,國巨元富97購04  ,0,0,0,0,0,0,0,0,0,-2156000,0,0,0,471000,2627000,-2156000,-2156000
00631L,元大台灣50正2   ,34000,257000,-223000,0,0,0,0,0,0,-1947000,0,0,0,2393000,4340000,-1947000,-2170000
052786,S&P500中信96購01,0,0,0,0,0,0,0,0,0,-2175000,0,0,0,0,2175000,-2175000,-2175000
056987,南茂群益98購01  ,0,0,0,0,0,0,0,0,0,-2200000,0,0,0,198000,2398000,-2200000,-2200000
056760,元油2X元大98購06,0,0,0,0,0,0,0,0,0,-2218000,0,0,0,70000,2288000,-2218000,-2218000
056666,元油2X國票9A購01,0,0,0,0,0,0,0,0,0,-2352000,0,0,0,0,2352000,-2352000,-2352000
053314,A50正2群益9A購01,0,0,0,0,0,0,0,0,0,-2360000,0,0,0,32000,2392000,-2360000,-2360000
2376,技嘉            ,2029000,5047502,-3018502,0,0,0,3000,0,3000,639000,86000,332000,-246000,972000,87000,885000,-2376502
1402,遠東新          ,3027000,5382000,-2355000,0,0,0,10000,122000,-112000,17000,59000,40000,19000,3000,5000,-2000,-2450000
3706,神達            ,1961000,5136000,-3175000,0,0,0,253000,0,253000,456000,225000,243000,-18000,513000,39000,474000,-2466000
057038,元油2X元大9B購06,0,0,0,0,0,0,0,0,0,-2467000,0,0,0,297000,2764000,-2467000,-2467000
056180,南茂元富97購01  ,0,0,0,0,0,0,0,0,0,-2554000,0,0,0,445000,2999000,-2554000,-2554000
1102,亞泥            ,4590000,8311000,-3721000,0,0,0,26000,300000,-274000,1395000,81000,8000,73000,1333000,11000,1322000,-2600000
056831,元油2X元富98購11,0,0,0,0,0,0,0,0,0,-2631000,0,0,0,0,2631000,-2631000,-2631000
2881,富邦金          ,10981000,13717000,-2736000,0,0,0,15000,34619,-19619,118000,266000,229000,37000,175000,94000,81000,-2637619
057362,元油2X元大98購12,0,0,0,0,0,0,0,0,0,-2685000,0,0,0,0,2685000,-2685000,-2685000
00717,富邦美國特別股  ,100,633000,-632900,0,0,0,0,0,0,-2172000,0,0,0,280000,2452000,-2172000,-2804900
058696,元油2X元大9C購04,0,0,0,0,0,0,0,0,0,-2835000,0,0,0,0,2835000,-2835000,-2835000
056999,元油2X國票98購02,0,0,0,0,0,0,0,0,0,-2891000,0,0,0,305000,3196000,-2891000,-2891000
054685,國巨永豐97購02  ,0,0,0,0,0,0,0,0,0,-3038000,0,0,0,909000,3947000,-3038000,-3038000
2603,長榮            ,8873000,13557818,-4684818,0,0,0,1486000,0,1486000,-8000,115000,44000,71000,0,79000,-79000,-3206818
053564,台積電富邦99購01,0,20000,-20000,0,0,0,0,0,0,-3208000,0,0,0,0,3208000,-3208000,-3228000
058380,臺股指凱基99購15,0,0,0,0,0,0,0,0,0,-3299000,0,0,0,30000,3329000,-3299000,-3299000
056829,台積電富邦9A購01,0,0,0,0,0,0,0,0,0,-3356000,0,0,0,579000,3935000,-3356000,-3356000
00670L,富邦NASDAQ正2   ,6000,1000,5000,0,0,0,0,0,0,-3391000,0,0,0,1526000,4917000,-3391000,-3386000
1101,台泥            ,4749000,9536143,-4787143,0,0,0,4000,0,4000,1363000,10000,148000,-138000,1517000,16000,1501000,-3420143
1314,中石化          ,4415700,7937100,-3521400,0,0,0,3000,0,3000,83000,132000,68000,64000,62000,43000,19000,-3435400
051133,台積電永豐95購02,0,0,0,0,0,0,0,0,0,-3452000,0,0,0,447000,3899000,-3452000,-3452000
055223,和大國票98購01  ,0,0,0,0,0,0,0,0,0,-3473000,0,0,0,40000,3513000,-3473000,-3473000
9904,寶成            ,2995000,6569870,-3574870,0,0,0,11000,0,11000,86000,89000,16000,73000,13000,0,13000,-3477870
2356,英業達          ,2984000,8511000,-5527000,0,0,0,4000,0,4000,1998000,29000,24000,5000,2159000,166000,1993000,-3525000
058392,元油2X元大99購12,0,0,0,0,0,0,0,0,0,-3547000,0,0,0,0,3547000,-3547000,-3547000
056691,元油2X群益9B購01,0,0,0,0,0,0,0,0,0,-3659000,0,0,0,227000,3886000,-3659000,-3659000
2324,仁寶            ,6719000,13081644,-6362644,0,0,0,32000,0,32000,2626000,33000,99000,-66000,2692000,0,2692000,-3704644
05635P,健策台新96售02  ,0,0,0,0,0,0,0,0,0,-3745000,0,0,0,0,3745000,-3745000,-3745000
056672,元油2X元富98購10,0,0,0,0,0,0,0,0,0,-3911000,0,0,0,50000,3961000,-3911000,-3911000
056889,元油2X元大99購07,0,0,0,0,0,0,0,0,0,-3912000,0,0,0,297000,4209000,-3912000,-3912000
058379,臺股指凱基99購14,0,0,0,0,0,0,0,0,0,-4011000,0,0,0,107000,4118000,-4011000,-4011000
058500,元石油元大9C購01,0,0,0,0,0,0,0,0,0,-4125000,0,0,0,379000,4504000,-4125000,-4125000
058668,元油2X群益9B購04,0,0,0,0,0,0,0,0,0,-4185000,0,0,0,0,4185000,-4185000,-4185000
058393,元油2X元大99購13,0,0,0,0,0,0,0,0,0,-4367000,0,0,0,21000,4388000,-4367000,-4367000
056780,元油2X群益9A購03,0,0,0,0,0,0,0,0,0,-4783000,0,0,0,0,4783000,-4783000,-4783000
057615,元油2X凱基98購02,90000,0,90000,0,0,0,0,0,0,-4878000,0,0,0,0,4878000,-4878000,-4788000
058394,元油2X元大99購14,0,0,0,0,0,0,0,0,0,-4790000,0,0,0,0,4790000,-4790000,-4790000
056781,元油2X群益9B購02,0,0,0,0,0,0,0,0,0,-4793000,0,0,0,0,4793000,-4793000,-4793000
056653,元石油元大98購01,0,0,0,0,0,0,0,0,0,-4834000,0,0,0,7000,4841000,-4834000,-4834000
2301,光寶科          ,2727000,8458213,-5731213,0,0,0,0,0,0,860000,99000,135000,-36000,944000,48000,896000,-4871213
058395,元油2X元大99購15,0,0,0,0,0,0,0,0,0,-4999000,0,0,0,0,4999000,-4999000,-4999000
4938,和碩            ,3819000,9823149,-6004149,0,0,0,15000,0,15000,462000,40000,53000,-13000,681000,206000,475000,-5527149
2886,兆豐金          ,16435136,25619136,-9184000,0,0,0,38000,0,38000,3124000,1689000,40000,1649000,1501000,26000,1475000,-6022000
057039,元油2X元大9B購07,0,0,0,0,0,0,0,0,0,-6402000,0,0,0,549000,6951000,-6402000,-6402000
2823,中壽            ,7554000,14269626,-6715626,0,0,0,4000,0,4000,150000,52000,20000,32000,146000,28000,118000,-6561626
2317,鴻海            ,14541000,22571446,-8030446,0,0,0,0,0,0,647000,735000,284000,451000,466000,270000,196000,-7383446
1504,東元            ,1677000,9196000,-7519000,0,0,0,2000,0,2000,29000,39000,10000,29000,0,0,0,-7488000
2888,新光金          ,21975753,29959087,-7983334,0,0,0,13000,0,13000,335000,159000,104000,55000,490000,210000,280000,-7635334
00861,元大全球未來通訊,1000,36000,-35000,0,0,0,0,0,0,-8203000,75000,0,75000,1564000,9842000,-8278000,-8238000
2313,華通            ,3125000,11310000,-8185000,0,0,0,7000,530000,-523000,95000,514000,405000,109000,362000,376000,-14000,-8613000
3481,群創            ,64888969,68764684,-3875715,0,0,0,59000,4420000,-4361000,-422000,849000,1148000,-299000,1482000,1605000,-123000,-8658715
3037,欣興            ,8194083,16411000,-8216917,0,0,0,22000,1090000,-1068000,574000,657000,205000,452000,362000,240000,122000,-8710917
056761,元油2X元大98購07,0,0,0,0,0,0,0,0,0,-9182000,0,0,0,0,9182000,-9182000,-9182000
00852L,國泰美國道瓊正2 ,0,0,0,0,0,0,0,0,0,-9777000,0,0,0,1138000,10915000,-9777000,-9777000
0050,元大台灣50      ,2062000,9107000,-7045000,0,0,0,45000,0,45000,-7386000,386000,953000,-567000,1074000,7893000,-6819000,-14386000
2891,中信金          ,36334000,55463000,-19129000,0,0,0,117000,95000,22000,2176000,2246000,45000,2201000,3000,28000,-25000,-16931000
2330,台積電          ,27545840,50912807,-23366967,0,0,0,419000,0,419000,1270000,1938000,971000,967000,739000,436000,303000,-21677967
049235,元油2X元富96購05,0,0,0,0,0,0,0,0,0,-22931000,0,0,0,1876000,24807000,-22931000,-22931000
2409,友達            ,19538000,36132590,-16594590,0,0,0,68000,8516000,-8448000,915000,1333000,653000,680000,1031000,796000,235000,-24127590
00715L,街口布蘭特油正2 ,0,2116000,-2116000,0,0,0,0,0,0,-22191000,0,0,0,10000,22201000,-22191000,-24307000
2303,聯電            ,31204000,61519589,-30315589,0,0,0,12000,0,12000,2223000,2214000,449000,1765000,728000,270000,458000,-28080589
00642U,元大S&P石油     ,151000,9517000,-9366000,0,0,0,0,0,0,-45452000,0,1610000,-1610000,2004000,45846000,-43842000,-54818000
0056,元大高股息      ,35000,49000,-14000,0,0,0,0,0,0,-56857000,58000,250000,-192000,30000,56695000,-56665000,-56871000
