證券代號,證券名稱,外陸資買進股數(不含外資自營商),外陸資賣出股數(不含外資自營商),外陸資買賣超股數(不含外資自營商),外資自營商買進股數,外資自營商賣出股數,外資自營商買賣超股數,投信買進股數,投信賣出股數,投信買賣超股數,自營商買賣超股數,自營商買進股數(自行買賣),自營商賣出股數(自行買賣),自營商買賣超股數(自行買賣),自營商買進股數(避險),自營商賣出股數(避險),自營商買賣超股數(避險),三大法人買賣超股數
2409,友達            ,42441000,28044000,14397000,0,0,0,8772000,0,8772000,1173000,1593000,1376000,217000,1276000,320000,956000,24342000
2303,聯電            ,39577664,30596000,8981664,0,0,0,4785000,0,4785000,-2653000,272000,647000,-375000,76000,2354000,-2278000,11113664
00637L,元大滬深300正2  ,2439000,6845000,-4406000,0,0,0,0,0,0,15321000,1186000,0,1186000,28286000,14151000,14135000,10915000
00673R,元大S&P原油反1  ,0,3069000,-3069000,0,0,0,0,0,0,13133000,0,0,0,13133000,0,13133000,10064000
00861,元大全球未來通訊,3931000,0,3931000,0,0,0,0,0,0,4890000,0,0,0,5333000,443000,4890000,8821000
2888,新光金          ,12531015,6580000,5951015,0,0,0,44000,0,44000,-519000,65000,12000,53000,2000,574000,-572000,5476015
3481,群創            ,43864640,41816000,2048640,0,0,0,1495000,0,1495000,667000,5043000,5285000,-242000,1351000,442000,909000,4210640
055144,T50反1元大97購03,0,0,0,0,0,0,0,0,0,4162000,0,0,0,5104000,942000,4162000,4162000
01003T,兆豐新光R1      ,3612000,0,3612000,0,0,0,0,0,0,0,0,0,0,0,0,0,3612000
3231,緯創            ,5778000,2483000,3295000,0,0,0,66000,0,66000,-33000,76000,81000,-5000,105000,133000,-28000,3328000
2356,英業達          ,7463000,4695000,2768000,0,0,0,4000,0,4000,69000,64000,102000,-38000,120000,13000,107000,2841000
2891,中信金          ,17998000,15120000,2878000,0,0,0,25000,49000,-24000,-134000,0,134000,-134000,0,0,0,2720000
00639,富邦深100       ,1753000,299000,1454000,0,0,0,0,0,0,788766,0,0,0,1917766,1129000,788766,2242766
00633L,富邦上証正2     ,56000,626000,-570000,0,0,0,0,0,0,2807000,0,10000,-10000,5512000,2695000,2817000,2237000
2885,元大金          ,6744000,4415000,2329000,0,0,0,16000,0,16000,-119000,0,100000,-100000,0,19000,-19000,2226000
052498,台積電永豐95購06,0,0,0,0,0,0,0,0,0,2087000,0,0,0,2087000,0,2087000,2087000
1907,永豐餘          ,2426000,361000,2065000,0,0,0,0,0,0,-2000,0,2000,-2000,0,0,0,2063000
044081,鴻海國票92購01  ,0,0,0,0,0,0,0,0,0,1996000,0,0,0,1996000,0,1996000,1996000
047646,貿聯元大94購01  ,0,0,0,0,0,0,0,0,0,1994000,0,0,0,2002000,8000,1994000,1994000
2324,仁寶            ,3564750,1687000,1877750,0,0,0,6000,0,6000,57000,6000,65000,-59000,152000,36000,116000,1940750
2317,鴻海            ,13754089,10085491,3668598,0,0,0,9000,48000,-39000,-1716000,62000,204000,-142000,329000,1903000,-1574000,1913598
2412,中華電          ,4140418,2306000,1834418,0,0,0,7000,0,7000,-11000,0,11000,-11000,0,0,0,1830418
6166,凌華            ,2286000,553000,1733000,0,0,0,0,0,0,24000,0,4000,-4000,28000,0,28000,1757000
049272,世紀鋼元大96購02,0,0,0,0,0,0,0,0,0,1700000,0,0,0,1700000,0,1700000,1700000
2345,智邦            ,3619000,1856000,1763000,0,0,0,9000,539000,-530000,291000,311000,92000,219000,150000,78000,72000,1524000
049900,台積電元富94購06,0,0,0,0,0,0,0,0,0,1523000,0,0,0,1942000,419000,1523000,1523000
054037,T50反1元大96購09,0,0,0,0,0,0,0,0,0,1519000,0,0,0,1519000,0,1519000,1519000
00655L,國泰中國A50正2  ,77000,84000,-7000,0,0,0,0,0,0,1524000,84000,0,84000,3041000,1601000,1440000,1517000
051228,聯發科群益95購03,0,0,0,0,0,0,0,0,0,1500000,0,0,0,1500000,0,1500000,1500000
4142,國光生          ,2054000,624000,1430000,0,0,0,0,0,0,51000,211000,160000,51000,0,0,0,1481000
6153,嘉聯益          ,2207840,827000,1380840,0,0,0,0,0,0,88000,82000,82000,0,184000,96000,88000,1468840
00664R,國泰臺灣加權反1 ,163000,2000000,-1837000,0,0,0,0,0,0,3212000,0,0,0,3478000,266000,3212000,1375000
03887P,大立光元富93售02,0,0,0,0,0,0,0,0,0,1367000,0,0,0,1369000,2000,1367000,1367000
053314,A50正2群益9A購01,0,0,0,0,0,0,0,0,0,1347000,0,0,0,1347000,0,1347000,1347000
054081,聯電元富96購01  ,0,0,0,0,0,0,0,0,0,1344000,0,0,0,1659000,315000,1344000,1344000
1904,正隆            ,1674000,386000,1288000,0,0,0,0,0,0,53000,263000,210000,53000,0,0,0,1341000
054197,台積電永昌96購07,0,0,0,0,0,0,0,0,0,1325000,0,0,0,3322000,1997000,1325000,1325000
051133,台積電永豐95購02,0,0,0,0,0,0,0,0,0,1290000,0,0,0,3989000,2699000,1290000,1290000
053825,南電群益96購02  ,0,0,0,0,0,0,0,0,0,1284000,0,0,0,1441000,157000,1284000,1284000
044998,玉晶光國泰94購01,0,0,0,0,0,0,0,0,0,1260000,0,0,0,1260000,0,1260000,1260000
2454,聯發科          ,6216834,3344694,2872140,0,0,0,2000,912000,-910000,-723000,0,598000,-598000,40000,165000,-125000,1239140
2323,中環            ,2699000,1122000,1577000,0,0,0,0,0,0,-345000,2000,19000,-17000,0,328000,-328000,1232000
2360,致茂            ,1631603,398000,1233603,0,0,0,22000,2000,20000,-60000,20000,64000,-44000,1000,17000,-16000,1193603
2867,三商壽          ,2069000,814000,1255000,0,0,0,0,0,0,-100000,0,100000,-100000,0,0,0,1155000
055038,華航富邦99購01  ,0,0,0,0,0,0,0,0,0,1142000,0,0,0,1144000,2000,1142000,1142000
6239,力成            ,2365000,1231000,1134000,0,0,0,21000,0,21000,-27000,0,16000,-16000,10000,21000,-11000,1128000
055606,矽創元大97購01  ,0,0,0,0,0,0,0,0,0,1123000,0,0,0,1504000,381000,1123000,1123000
03275P,台積電台新02售02,0,0,0,0,0,0,0,0,0,1122000,0,0,0,1122000,0,1122000,1122000
051259,鴻海永昌96購03  ,0,0,0,0,0,0,0,0,0,1113000,0,0,0,1833000,720000,1113000,1113000
056467,上証2X元大98購02,0,0,0,0,0,0,0,0,0,1064000,0,0,0,1146000,82000,1064000,1064000
05862P,大立光國泰98售01,0,0,0,0,0,0,0,0,0,1030000,0,0,0,1583000,553000,1030000,1030000
050100,台積電永昌96購02,0,0,0,0,0,0,0,0,0,1023000,0,0,0,1666000,643000,1023000,1023000
04377P,大立光元大94售04,0,0,0,0,0,0,0,0,0,1020000,0,0,0,1135000,115000,1020000,1020000
048618,超眾凱基93購08  ,0,0,0,0,0,0,0,0,0,998000,0,0,0,998000,0,998000,998000
054040,中石化元大9C購01,0,0,0,0,0,0,0,0,0,985000,0,0,0,1000000,15000,985000,985000
053593,晶技元大98購01  ,0,0,0,0,0,0,0,0,0,983000,0,0,0,983000,0,983000,983000
054867,華航群益99購01  ,0,0,0,0,0,0,0,0,0,959000,0,0,0,961000,2000,959000,959000
00636,國泰中國A50     ,436000,0,436000,0,0,0,0,0,0,512000,0,93000,-93000,685000,80000,605000,948000
054640,健策中信9B購01  ,0,0,0,0,0,0,0,0,0,945000,0,0,0,1030000,85000,945000,945000
053949,康控富邦9A購01  ,0,0,0,0,0,0,0,0,0,938000,0,0,0,1008000,70000,938000,938000
053197,超眾元富96購02  ,0,0,0,0,0,0,0,0,0,926000,0,0,0,1011000,85000,926000,926000
048569,台虹元大93購03  ,0,0,0,0,0,0,0,0,0,920000,0,0,0,980000,60000,920000,920000
052020,聯茂永豐95購02  ,0,0,0,0,0,0,0,0,0,918000,0,0,0,1095000,177000,918000,918000
052738,聯電元大98購02  ,0,0,0,0,0,0,0,0,0,915000,0,0,0,1168000,253000,915000,915000
053371,滬深2X元大99購01,0,0,0,0,0,0,0,0,0,888000,0,0,0,1144000,256000,888000,888000
049114,玉晶光統一94購02,0,0,0,0,0,0,0,0,0,854000,0,0,0,993000,139000,854000,854000
052810,易華電元大96購02,0,0,0,0,0,0,0,0,0,836000,0,0,0,836000,0,836000,836000
053965,聯電元大98購04  ,0,0,0,0,0,0,0,0,0,834000,0,0,0,1007000,173000,834000,834000
053638,信邦永豐96購01  ,0,0,0,0,0,0,0,0,0,832000,0,0,0,842000,10000,832000,832000
6202,盛群            ,1008000,196000,812000,0,0,0,0,0,0,20000,20000,0,20000,0,0,0,832000
047882,超眾國泰94購01  ,0,0,0,0,0,0,0,0,0,818000,0,0,0,897000,79000,818000,818000
055128,致新兆豐97購01  ,0,0,0,0,0,0,0,0,0,817000,0,0,0,827000,10000,817000,817000
2439,美律            ,1160000,398000,762000,0,0,0,0,0,0,48000,157000,116000,41000,43000,36000,7000,810000
051113,聯電元富95購01  ,0,0,0,0,0,0,0,0,0,809000,0,0,0,826000,17000,809000,809000
03769P,聯發科元大93售04,0,0,0,0,0,0,0,0,0,803000,0,0,0,1292000,489000,803000,803000
052833,康控群益96購01  ,0,0,0,0,0,0,0,0,0,801000,0,0,0,843000,42000,801000,801000
2892,第一金          ,2624281,1836000,788281,0,0,0,14000,0,14000,-2000,0,2000,-2000,0,0,0,800281
056362,聯發科元大99購01,0,0,0,0,0,0,0,0,0,796000,0,0,0,889000,93000,796000,796000
3005,神基            ,1206000,684000,522000,0,0,0,0,0,0,273000,220000,0,220000,88000,35000,53000,795000
4119,旭富            ,884400,103000,781400,0,0,0,15000,0,15000,-14000,30000,50000,-20000,12000,6000,6000,782400
00708L,元大S&P黃金正2  ,0,0,0,0,0,0,0,0,0,778000,0,23000,-23000,1946000,1145000,801000,778000
052613,易華電元大96購01,0,0,0,0,0,0,0,0,0,765000,0,0,0,765000,0,765000,765000
006205,富邦上証        ,357000,0,357000,0,0,0,0,0,0,407000,0,20000,-20000,1274000,847000,427000,764000
05901P,臺股指凱基9C售01,0,0,0,0,0,0,0,0,0,751000,0,0,0,886000,135000,751000,751000
06194P,台積電元富97售05,0,0,0,0,0,0,0,0,0,744000,0,0,0,1004000,260000,744000,744000
053256,上銀富邦98購01  ,0,0,0,0,0,0,0,0,0,732000,0,0,0,821000,89000,732000,732000
056004,南電永豐97購02  ,0,0,0,0,0,0,0,0,0,731000,0,0,0,731000,0,731000,731000
055763,鎧勝群益97購01  ,0,0,0,0,0,0,0,0,0,726000,0,0,0,818000,92000,726000,726000
050680,上銀元富94購01  ,0,0,0,0,0,0,0,0,0,720000,0,0,0,877000,157000,720000,720000
052677,景碩富邦97購01  ,0,0,0,0,0,0,0,0,0,715000,0,0,0,832000,117000,715000,715000
048149,泰鼎元富95購01  ,0,0,0,0,0,0,0,0,0,713000,0,0,0,753000,40000,713000,713000
055027,牧德國泰99購01  ,0,0,0,0,0,0,0,0,0,707000,0,0,0,971000,264000,707000,707000
056277,上銀富邦99購02  ,0,0,0,0,0,0,0,0,0,706000,0,0,0,968000,262000,706000,706000
054570,易華電群益98購01,0,0,0,0,0,0,0,0,0,700000,0,0,0,700000,0,700000,700000
046608,超眾兆豐93購02  ,0,0,0,0,0,0,0,0,0,700000,0,0,0,700000,0,700000,700000
051454,致伸元大95購01  ,0,0,0,0,0,0,0,0,0,700000,0,0,0,700000,0,700000,700000
049620,美食群益94購01  ,0,0,0,0,0,0,0,0,0,699000,0,0,0,699000,0,699000,699000
044493,京元電元大92購02,0,0,0,0,0,0,0,0,0,698000,0,0,0,798000,100000,698000,698000
050988,廣達富邦95購01  ,0,0,0,0,0,0,0,0,0,697000,0,0,0,946000,249000,697000,697000
6116,彩晶            ,2969000,1522000,1447000,0,0,0,0,0,0,-755000,2000,812000,-810000,290000,235000,55000,692000
052755,滬深2X群益9A購01,0,0,0,0,0,0,0,0,0,686000,0,0,0,686000,0,686000,686000
045873,元油2X元富98購04,0,0,0,0,0,0,0,0,0,685000,0,0,0,1207000,522000,685000,685000
2376,技嘉            ,1532000,741000,791000,0,0,0,0,0,0,-106000,8000,23000,-15000,161000,252000,-91000,685000
056171,鴻海元富97購10  ,0,0,0,0,0,0,0,0,0,681000,0,0,0,819000,138000,681000,681000
048812,上証2X凱基96購01,0,0,0,0,0,0,0,0,0,680000,0,0,0,680000,0,680000,680000
0061,元大寶滬深      ,620514,334000,286514,0,0,0,0,0,0,393000,0,0,0,407000,14000,393000,679514
050744,健策永豐94購04  ,0,0,0,0,0,0,0,0,0,678000,0,0,0,781000,103000,678000,678000
051370,聯詠富邦97購01  ,0,0,0,0,0,0,0,0,0,677000,0,0,0,852000,175000,677000,677000
047410,上銀元富96購01  ,0,0,0,0,0,0,0,0,0,674000,0,0,0,956000,282000,674000,674000
044960,京元電兆豐93購01,0,0,0,0,0,0,0,0,0,673000,0,0,0,673000,0,673000,673000
05501P,健策國票97售01  ,0,0,0,0,0,0,0,0,0,670000,0,0,0,1416000,746000,670000,670000
052527,泰鼎元大96購02  ,0,0,0,0,0,0,0,0,0,670000,0,0,0,803000,133000,670000,670000
4725,信昌化          ,971000,302000,669000,0,0,0,0,0,0,-1000,0,1000,-1000,0,0,0,668000
049279,元油2X國票94購02,0,0,0,0,0,0,0,0,0,663000,0,0,0,749000,86000,663000,663000
055001,京鼎元富97購01  ,0,0,0,0,0,0,0,0,0,657000,0,0,0,657000,0,657000,657000
05161P,華新科國票96售01,0,0,0,0,0,0,0,0,0,653000,0,0,0,659000,6000,653000,653000
053537,玉晶光永豐98購02,0,0,0,0,0,0,0,0,0,653000,0,0,0,661000,8000,653000,653000
053488,中石化兆豐97購01,0,0,0,0,0,0,0,0,0,652000,0,0,0,652000,0,652000,652000
045414,康控群益94購02  ,0,0,0,0,0,0,0,0,0,651000,0,0,0,661000,10000,651000,651000
054701,宏全永豐97購01  ,0,0,0,0,0,0,0,0,0,650000,0,0,0,749000,99000,650000,650000
056356,台積電元大99購01,0,0,0,0,0,0,0,0,0,647000,0,0,0,1048000,401000,647000,647000
049820,世紀鋼元大96購03,0,0,0,0,0,0,0,0,0,647000,0,0,0,647000,0,647000,647000
054123,易華電永豐96購03,0,0,0,0,0,0,0,0,0,643000,0,0,0,661000,18000,643000,643000
055131,茂林康和97購01  ,0,0,0,0,0,0,0,0,0,641000,0,0,0,799000,158000,641000,641000
052796,和碩兆豐96購01  ,0,0,0,0,0,0,0,0,0,632000,0,0,0,655000,23000,632000,632000
053404,致新群益96購01  ,0,0,0,0,0,0,0,0,0,631000,0,0,0,651000,20000,631000,631000
053229,南電台新97購01  ,0,0,0,0,0,0,0,0,0,628000,0,0,0,658000,30000,628000,628000
049367,全新元大96購01  ,0,0,0,0,0,0,0,0,0,622000,0,0,0,623000,1000,622000,622000
04465P,大立光元富94售03,0,0,0,0,0,0,0,0,0,619000,0,0,0,619000,0,619000,619000
053457,旺宏國泰98購03  ,0,0,0,0,0,0,0,0,0,613000,0,0,0,766000,153000,613000,613000
053887,聯茂兆豐97購02  ,0,0,0,0,0,0,0,0,0,613000,0,0,0,623000,10000,613000,613000
00643,群益深証中小    ,1366000,0,1366000,0,0,0,0,0,0,-754000,0,60000,-60000,256000,950000,-694000,612000
05885P,牧德統一96售01  ,0,0,0,0,0,0,0,0,0,607000,0,0,0,786000,179000,607000,607000
054686,順德永豐97購01  ,0,0,0,0,0,0,0,0,0,605000,0,0,0,705000,100000,605000,605000
055542,亞德客凱基97購01,0,0,0,0,0,0,0,0,0,604000,0,0,0,693000,89000,604000,604000
048894,光罩國泰94購01  ,0,0,0,0,0,0,0,0,0,603000,0,0,0,732000,129000,603000,603000
055100,得力凱基97購01  ,0,0,0,0,0,0,0,0,0,600000,0,0,0,600000,0,600000,600000
049706,世紀鋼元大95購02,0,0,0,0,0,0,0,0,0,600000,0,0,0,600000,0,600000,600000
05722P,玉晶光國票97售03,0,0,0,0,0,0,0,0,0,599000,0,0,0,664000,65000,599000,599000
055590,聯發科元大98購02,0,0,0,0,0,0,0,0,0,595000,0,0,0,741000,146000,595000,595000
2382,廣達            ,3021322,2300000,721322,0,0,0,5000,6000,-1000,-126000,17000,104000,-87000,82000,121000,-39000,594322
053465,聯電元大96購05  ,0,0,0,0,0,0,0,0,0,594000,0,0,0,961000,367000,594000,594000
045161,玉晶光國泰94購03,0,0,0,0,0,0,0,0,0,591000,0,0,0,593000,2000,591000,591000
2353,宏碁            ,3302550,2743000,559550,0,0,0,2000,0,2000,26000,64000,58000,6000,143000,123000,20000,587550
053363,旺宏國泰98購02  ,0,0,0,0,0,0,0,0,0,586000,0,0,0,659000,73000,586000,586000
042561,南電兆豐92購01  ,0,0,0,0,0,0,0,0,0,583000,0,0,0,583000,0,583000,583000
051579,宏碁元大95購01  ,0,0,0,0,0,0,0,0,0,581000,0,0,0,597000,16000,581000,581000
6452,康友-KY         ,512000,377256,134744,0,0,0,0,0,0,442000,6000,0,6000,456000,20000,436000,576744
050533,致新元大94購03  ,0,0,0,0,0,0,0,0,0,576000,0,0,0,644000,68000,576000,576000
06225P,華新科元富97售04,0,0,0,0,0,0,0,0,0,574000,0,0,0,574000,0,574000,574000
056300,聯發科元大97購23,0,0,0,0,0,0,0,0,0,567000,0,0,0,919000,352000,567000,567000
053568,智伸科富邦98購01,0,0,0,0,0,0,0,0,0,566000,0,0,0,717000,151000,566000,566000
055645,技嘉元富97購01  ,0,0,0,0,0,0,0,0,0,564000,0,0,0,1078000,514000,564000,564000
055827,中石化元大98購01,0,0,0,0,0,0,0,0,0,560000,0,0,0,560000,0,560000,560000
044224,超眾凱基93購01  ,0,0,0,0,0,0,0,0,0,559000,0,0,0,569000,10000,559000,559000
049994,聯茂台新94購02  ,0,0,0,0,0,0,0,0,0,556000,0,0,0,566000,10000,556000,556000
06069P,台積電永豐97售01,0,0,0,0,0,0,0,0,0,556000,0,0,0,598000,42000,556000,556000
056279,新日興富邦99購01,0,0,0,0,0,0,0,0,0,554000,0,0,0,565000,11000,554000,554000
049734,瑞昱群益94購02  ,0,0,0,0,0,0,0,0,0,554000,0,0,0,554000,0,554000,554000
043396,世紀鋼元大93購01,0,0,0,0,0,0,0,0,0,553000,0,0,0,553000,0,553000,553000
046999,康控富邦99購01  ,0,0,0,0,0,0,0,0,0,550000,0,0,0,600000,50000,550000,550000
048509,上証反凱基99購02,0,0,0,0,0,0,0,0,0,550000,0,0,0,671000,121000,550000,550000
054889,京鼎統一99購01  ,0,0,0,0,0,0,0,0,0,548000,0,0,0,580000,32000,548000,548000
053936,旺宏元富96購04  ,0,0,0,0,0,0,0,0,0,547000,0,0,0,552000,5000,547000,547000
05397P,大立光凱基96售08,0,0,0,0,0,0,0,0,0,547000,0,0,0,557000,10000,547000,547000
055973,亞德客統一97購01,0,0,0,0,0,0,0,0,0,546000,0,0,0,972000,426000,546000,546000
00739,元大MSCI A股    ,0,0,0,0,0,0,0,0,0,546000,0,0,0,869000,323000,546000,546000
050742,新日興永豐94購01,0,0,0,0,0,0,0,0,0,545000,0,0,0,565000,20000,545000,545000
048893,南電元富94購01  ,0,0,0,0,0,0,0,0,0,544000,0,0,0,544000,0,544000,544000
055676,亞德客凱基97購03,0,0,0,0,0,0,0,0,0,541000,0,0,0,769000,228000,541000,541000
052483,超眾群益95購03  ,0,0,0,0,0,0,0,0,0,541000,0,0,0,574000,33000,541000,541000
05319P,上銀凱基95售02  ,0,0,0,0,0,0,0,0,0,540000,0,0,0,600000,60000,540000,540000
054717,亞德客永豐97購01,0,0,0,0,0,0,0,0,0,539000,0,0,0,681000,142000,539000,539000
049243,佳世達元富96購02,0,0,0,0,0,0,0,0,0,539000,0,0,0,549000,10000,539000,539000
05712P,友達統一97售03  ,0,0,0,0,0,0,0,0,0,537000,0,0,0,608000,71000,537000,537000
04888P,臺股指凱基95售03,0,0,0,0,0,0,0,0,0,535000,0,0,0,1077000,542000,535000,535000
00783,富邦中証500     ,696000,14000,682000,0,0,0,0,0,0,-149516,0,0,0,1648484,1798000,-149516,532484
056059,美律元大98購02  ,0,0,0,0,0,0,0,0,0,531000,0,0,0,541000,10000,531000,531000
055995,華擎國泰99購01  ,0,0,0,0,0,0,0,0,0,530000,0,0,0,717000,187000,530000,530000
048073,南電元富93購02  ,0,0,0,0,0,0,0,0,0,530000,0,0,0,550000,20000,530000,530000
045663,元油2X元富94購01,0,0,0,0,0,0,0,0,0,529000,0,0,0,699000,170000,529000,529000
046795,瀚宇博元富93購01,0,0,0,0,0,0,0,0,0,529000,0,0,0,529000,0,529000,529000
051390,京元電兆豐95購01,0,0,0,0,0,0,0,0,0,528000,0,0,0,568000,40000,528000,528000
056172,鴻海元富97購11  ,0,0,0,0,0,0,0,0,0,524000,0,0,0,579000,55000,524000,524000
052898,樺漢群益96購01  ,0,0,0,0,0,0,0,0,0,523000,0,0,0,528000,5000,523000,523000
051946,健策統一98購01  ,0,0,0,0,0,0,0,0,0,520000,0,0,0,598000,78000,520000,520000
055802,新日興永豐97購01,0,0,0,0,0,0,0,0,0,517000,0,0,0,710000,193000,517000,517000
054694,聯鈞永豐97購01  ,0,0,0,0,0,0,0,0,0,517000,0,0,0,518000,1000,517000,517000
055336,茂林兆豐98購01  ,0,0,0,0,0,0,0,0,0,517000,0,0,0,556000,39000,517000,517000
056424,泰碩統一98購01  ,0,0,0,0,0,0,0,0,0,516000,0,0,0,516000,0,516000,516000
048988,聯茂元大94購02  ,0,0,0,0,0,0,0,0,0,515000,0,0,0,515000,0,515000,515000
050603,致新國泰96購01  ,0,0,0,0,0,0,0,0,0,515000,0,0,0,555000,40000,515000,515000
06229P,欣興凱基97售07  ,0,0,0,0,0,0,0,0,0,515000,0,0,0,745000,230000,515000,515000
055075,南電永豐97購01  ,0,0,0,0,0,0,0,0,0,512000,0,0,0,512000,0,512000,512000
053120,復盛中信9A購01  ,0,0,0,0,0,0,0,0,0,512000,0,0,0,522000,10000,512000,512000
056586,光罩統一98購02  ,0,0,0,0,0,0,0,0,0,510000,0,0,0,510000,0,510000,510000
2327,國巨            ,1913000,1654396,258604,0,0,0,194000,0,194000,57000,21000,34000,-13000,104000,34000,70000,509604
049076,佳世達凱基94購01,0,0,0,0,0,0,0,0,0,509000,0,0,0,509000,0,509000,509000
055335,健策兆豐98購01  ,0,0,0,0,0,0,0,0,0,508000,0,0,0,518000,10000,508000,508000
055438,鴻海國票98購01  ,0,0,0,0,0,0,0,0,0,507000,0,0,0,509000,2000,507000,507000
054780,中石化群益99購01,0,0,0,0,0,0,0,0,0,506000,0,0,0,537000,31000,506000,506000
051941,樺漢群益95購02  ,0,0,0,0,0,0,0,0,0,505000,0,0,0,505000,0,505000,505000
056149,亞光康和97購01  ,0,0,0,0,0,0,0,0,0,502000,0,0,0,502000,0,502000,502000
044351,台光電元大92購02,0,0,0,0,0,0,0,0,0,502000,0,0,0,502000,0,502000,502000
051283,亞德客統一95購01,0,0,0,0,0,0,0,0,0,501000,0,0,0,503000,2000,501000,501000
050110,京元電元大94購03,0,0,0,0,0,0,0,0,0,501000,0,0,0,574000,73000,501000,501000
050778,瑞儀元大96購01  ,0,0,0,0,0,0,0,0,0,501000,0,0,0,637000,136000,501000,501000
04749P,臺股指元大94售25,0,0,0,0,0,0,0,0,0,500000,0,0,0,500000,0,500000,500000
00712,FH富時不動產    ,228000,0,228000,0,0,0,0,0,0,272000,0,0,0,390000,118000,272000,500000
04874P,高股息中信97售01,0,0,0,0,0,0,0,0,0,500000,0,0,0,500000,0,500000,500000
048201,智易元大93購06  ,0,0,0,0,0,0,0,0,0,500000,0,0,0,500000,0,500000,500000
049295,全新群益94購02  ,0,0,0,0,0,0,0,0,0,500000,0,0,0,500000,0,500000,500000
051675,瑞儀元大96購02  ,0,0,0,0,0,0,0,0,0,500000,0,0,0,520000,20000,500000,500000
053436,聯茂日盛96購01  ,0,0,0,0,0,0,0,0,0,500000,0,0,0,582000,82000,500000,500000
04386P,大立光日盛94售01,0,0,0,0,0,0,0,0,0,499000,0,0,0,499000,0,499000,499000
050607,為升元大94購10  ,0,0,0,0,0,0,0,0,0,499000,0,0,0,499000,0,499000,499000
051757,佳世達元大95購02,0,0,0,0,0,0,0,0,0,499000,0,0,0,499000,0,499000,499000
050869,健策永豐95購01  ,0,0,0,0,0,0,0,0,0,497000,0,0,0,647000,150000,497000,497000
044487,元油2X元大94購01,0,0,0,0,0,0,0,0,0,495000,0,0,0,520000,25000,495000,495000
053893,京鼎群益97購02  ,0,0,0,0,0,0,0,0,0,495000,0,0,0,495000,0,495000,495000
052157,東元永豐95購01  ,0,0,0,0,0,0,0,0,0,494000,0,0,0,494000,0,494000,494000
048027,京元電凱基93購03,0,0,0,0,0,0,0,0,0,491000,0,0,0,551000,60000,491000,491000
1789,神隆            ,589000,290410,298590,0,0,0,200000,0,200000,-8000,0,8000,-8000,0,0,0,490590
048792,瑞儀元大94購01  ,0,0,0,0,0,0,0,0,0,490000,0,0,0,500000,10000,490000,490000
051917,瑞儀元大95購01  ,0,0,0,0,0,0,0,0,0,490000,0,0,0,500000,10000,490000,490000
053005,微星永豐96購01  ,0,0,0,0,0,0,0,0,0,490000,0,0,0,603000,113000,490000,490000
055444,致新台新97購01  ,0,0,0,0,0,0,0,0,0,487000,0,0,0,487000,0,487000,487000
052819,義隆永豐96購01  ,0,0,0,0,0,0,0,0,0,486000,0,0,0,518000,32000,486000,486000
051019,大立光凱基95購08,0,0,0,0,0,0,0,0,0,484000,0,0,0,499000,15000,484000,484000
055450,台積電元富97購01,0,0,0,0,0,0,0,0,0,483000,0,0,0,548000,65000,483000,483000
042909,順德元大94購01  ,0,0,0,0,0,0,0,0,0,480000,0,0,0,500000,20000,480000,480000
046573,上緯控國泰94購01,0,0,0,0,0,0,0,0,0,480000,0,0,0,480000,0,480000,480000
055626,力山永豐97購01  ,0,0,0,0,0,0,0,0,0,479000,0,0,0,479000,0,479000,479000
056187,京鼎統一97購01  ,0,0,0,0,0,0,0,0,0,478000,0,0,0,520000,42000,478000,478000
048791,智原元大94購02  ,0,0,0,0,0,0,0,0,0,474000,0,0,0,474000,0,474000,474000
054843,中環兆豐97購01  ,0,0,0,0,0,0,0,0,0,470000,0,0,0,497000,27000,470000,470000
04414P,牧德元富94售04  ,0,0,0,0,0,0,0,0,0,470000,0,0,0,490000,20000,470000,470000
8028,昇陽半導體      ,625000,149000,476000,0,0,0,0,0,0,-6000,1000,1000,0,4000,10000,-6000,470000
054382,康控群益96購03  ,0,0,0,0,0,0,0,0,0,467000,0,0,0,514000,47000,467000,467000
047690,美律富邦97購01  ,0,0,0,0,0,0,0,0,0,466000,0,0,0,506000,40000,466000,466000
048573,世紀鋼元大93購05,0,0,0,0,0,0,0,0,0,465000,0,0,0,465000,0,465000,465000
052013,台積電永豐95購04,0,0,0,0,0,0,0,0,0,464000,0,0,0,757000,293000,464000,464000
051948,滬深2X元富9B購01,0,0,0,0,0,0,0,0,0,462000,0,0,0,474000,12000,462000,462000
052506,日月光日盛95購01,0,0,0,0,0,0,0,0,0,462000,0,0,0,618000,156000,462000,462000
051879,健策台新96購01  ,0,0,0,0,0,0,0,0,0,461000,0,0,0,661000,200000,461000,461000
03650C,T50反1元大98牛05,0,0,0,0,0,0,0,0,0,460000,0,0,0,920000,460000,460000,460000
050743,京鼎永豐94購02  ,0,0,0,0,0,0,0,0,0,459000,0,0,0,506000,47000,459000,459000
051351,台積電元大95購15,0,0,0,0,0,0,0,0,0,456000,0,0,0,681000,225000,456000,456000
055168,光罩統一98購01  ,0,0,0,0,0,0,0,0,0,454000,0,0,0,464000,10000,454000,454000
045053,聯發科元富98購01,5000,0,5000,0,0,0,0,0,0,447000,0,0,0,640000,193000,447000,452000
052719,致新凱基96購01  ,0,0,0,0,0,0,0,0,0,450000,0,0,0,450000,0,450000,450000
08405P,聯發科元大9C售11,0,0,0,0,0,0,0,0,0,450000,0,0,0,450000,0,450000,450000
054890,聯鈞統一99購01  ,0,0,0,0,0,0,0,0,0,445000,0,0,0,455000,10000,445000,445000
1519,華城            ,645000,160000,485000,0,0,0,0,40000,-40000,0,0,0,0,0,0,0,445000
3189,景碩            ,2995000,1879000,1116000,0,0,0,37000,250000,-213000,-458000,154000,131000,23000,80000,561000,-481000,445000
055675,亞德客凱基97購02,0,0,0,0,0,0,0,0,0,443000,0,0,0,453000,10000,443000,443000
053018,旺宏元富96購02  ,0,0,0,0,0,0,0,0,0,441000,0,0,0,466000,25000,441000,441000
06335P,台積電麥證97售02,0,0,0,441000,0,441000,0,0,0,441000,0,0,0,441000,0,441000,441000
00766L,台新MSCI中國正2 ,0,0,0,0,0,0,0,0,0,439000,0,0,0,729000,290000,439000,439000
045829,滬深2X群益95購02,0,0,0,0,0,0,0,0,0,439000,0,0,0,500000,61000,439000,439000
056384,玉晶光國泰9A購02,0,0,0,0,0,0,0,0,0,438000,0,0,0,489000,51000,438000,438000
04747P,臺股指元大94售22,0,0,0,0,0,0,0,0,0,438000,0,0,0,864000,426000,438000,438000
051762,國泰金元大95購01,0,0,0,0,0,0,0,0,0,436000,0,0,0,436000,0,436000,436000
04337P,台積電元大93售25,0,0,0,0,0,0,0,0,0,435000,0,0,0,435000,0,435000,435000
055889,鴻海統一97購05  ,0,0,0,0,0,0,0,0,0,433000,0,0,0,433000,0,433000,433000
051397,聯茂兆豐95購03  ,0,0,0,0,0,0,0,0,0,432000,0,0,0,432000,0,432000,432000
054076,義隆第一96購01  ,0,0,0,0,0,0,0,0,0,432000,0,0,0,432000,0,432000,432000
047886,京元電富邦95購01,0,0,0,0,0,0,0,0,0,431000,0,0,0,431000,0,431000,431000
047022,聯發科元大93購07,0,0,0,0,0,0,0,0,0,430000,0,0,0,430000,0,430000,430000
045412,宏達電群益93購01,0,0,0,0,0,0,0,0,0,430000,0,0,0,430000,0,430000,430000
049067,元油2X凱基94購02,0,0,0,0,0,0,0,0,0,430000,0,0,0,430000,0,430000,430000
055940,致新群益98購01  ,0,0,0,0,0,0,0,0,0,429000,0,0,0,631000,202000,429000,429000
055638,上銀元富97購01  ,0,0,0,0,0,0,0,0,0,428000,0,0,0,909000,481000,428000,428000
055142,健策永豐98購01  ,0,0,0,0,0,0,0,0,0,428000,0,0,0,626000,198000,428000,428000
053851,鴻海國泰98購03  ,0,0,0,0,0,0,0,0,0,426000,0,0,0,426000,0,426000,426000
054896,聯茂日盛97購01  ,0,0,0,0,0,0,0,0,0,425000,0,0,0,542000,117000,425000,425000
051710,和碩群益95購01  ,0,0,0,0,0,0,0,0,0,425000,0,0,0,425000,0,425000,425000
052476,台光電群益98購01,0,0,0,0,0,0,0,0,0,425000,0,0,0,435000,10000,425000,425000
044853,亞光國泰93購01  ,0,0,0,0,0,0,0,0,0,424000,0,0,0,430000,6000,424000,424000
050614,聯發科元大95購04,0,0,0,0,0,0,0,0,0,422000,0,0,0,482000,60000,422000,422000
050309,亞泥兆豐94購01  ,0,0,0,0,0,0,0,0,0,422000,0,0,0,554000,132000,422000,422000
050528,瑞儀元大94購02  ,0,0,0,0,0,0,0,0,0,422000,0,0,0,500000,78000,422000,422000
052504,鴻海日盛95購03  ,0,0,0,0,0,0,0,0,0,420000,0,0,0,420000,0,420000,420000
050983,新光金國泰97購01,0,0,0,0,0,0,0,0,0,417000,0,0,0,422000,5000,417000,417000
036805,國巨元富93購02  ,0,0,0,0,0,0,0,0,0,415000,0,0,0,538000,123000,415000,415000
049236,元油2X元富96購06,0,0,0,0,0,0,0,0,0,415000,0,0,0,679000,264000,415000,415000
050751,聯電統一94購05  ,0,0,0,0,0,0,0,0,0,414000,0,0,0,694000,280000,414000,414000
053087,冠德元大96購02  ,0,0,0,0,0,0,0,0,0,414000,0,0,0,522000,108000,414000,414000
055886,上銀統一97購02  ,0,0,0,0,0,0,0,0,0,413000,0,0,0,413000,0,413000,413000
043697,聯茂兆豐92購01  ,0,0,0,0,0,0,0,0,0,412000,0,0,0,412000,0,412000,412000
051644,聯茂康和95購01  ,0,0,0,0,0,0,0,0,0,412000,0,0,0,422000,10000,412000,412000
053409,和碩兆豐96購02  ,0,0,0,0,0,0,0,0,0,412000,0,0,0,422000,10000,412000,412000
051230,聯詠群益95購01  ,0,0,0,0,0,0,0,0,0,411000,0,0,0,453000,42000,411000,411000
053824,樺漢群益96購02  ,0,0,0,0,0,0,0,0,0,411000,0,0,0,421000,10000,411000,411000
055649,華新科元富97購03,0,0,0,0,0,0,0,0,0,410000,0,0,0,430000,20000,410000,410000
04548P,大立光元大94售14,0,0,0,0,0,0,0,0,0,410000,0,0,0,425000,15000,410000,410000
050441,和碩凱基94購01  ,0,0,0,0,0,0,0,0,0,410000,0,0,0,430000,20000,410000,410000
051227,技嘉群益97購01  ,0,0,0,0,0,0,0,0,0,410000,0,0,0,494000,84000,410000,410000
056618,京元電永豐98購01,0,0,0,0,0,0,0,0,0,409000,0,0,0,533000,124000,409000,409000
053334,訊芯永豐96購01  ,0,0,0,0,0,0,0,0,0,409000,0,0,0,557000,148000,409000,409000
049814,超眾元大95購04  ,0,0,0,0,0,0,0,0,0,408000,0,0,0,408000,0,408000,408000
052986,聯發科元大97購05,0,0,0,0,0,0,0,0,0,408000,0,0,0,691000,283000,408000,408000
051430,瑞昱元富95購02  ,0,0,0,0,0,0,0,0,0,407000,0,0,0,507000,100000,407000,407000
048422,瑞昱元富96購02  ,0,0,0,0,0,0,0,0,0,406000,0,0,0,544000,138000,406000,406000
053673,超眾元富96購03  ,0,0,0,0,0,0,0,0,0,406000,0,0,0,471000,65000,406000,406000
05403P,台積電富邦95售08,0,0,0,0,0,0,0,0,0,406000,0,0,0,406000,0,406000,406000
056092,亞德客元富97購02,0,0,0,0,0,0,0,0,0,404000,0,0,0,569000,165000,404000,404000
055266,京鼎永豐97購01  ,0,0,0,0,0,0,0,0,0,403000,0,0,0,462000,59000,403000,403000
050719,世紀鋼群益96購01,0,0,0,0,0,0,0,0,0,401000,0,0,0,401000,0,401000,401000
05563P,台積電元大97售07,0,0,0,0,0,0,0,0,0,400000,0,0,0,430000,30000,400000,400000
050381,鴻海兆豐94購01  ,0,0,0,0,0,0,0,0,0,400000,0,0,0,410000,10000,400000,400000
047034,東陽群益93購01  ,0,0,0,0,0,0,0,0,0,400000,0,0,0,400000,0,400000,400000
044496,群創元大93購02  ,0,0,0,0,0,0,0,0,0,400000,0,0,0,485000,85000,400000,400000
053533,光罩永豐96購03  ,0,0,0,0,0,0,0,0,0,400000,0,0,0,400000,0,400000,400000
052795,健策兆豐97購01  ,0,0,0,0,0,0,0,0,0,400000,0,0,0,410000,10000,400000,400000
051924,聯茂日盛95購01  ,0,0,0,0,0,0,0,0,0,400000,0,0,0,441000,41000,400000,400000
053222,聯茂凱基96購03  ,0,0,0,0,0,0,0,0,0,399000,0,0,0,448000,49000,399000,399000
052289,為升元富95購02  ,0,0,0,0,0,0,0,0,0,398000,0,0,0,497000,99000,398000,398000
051340,健策永豐95購03  ,0,0,0,0,0,0,0,0,0,397000,0,0,0,397000,0,397000,397000
046061,中石化凱基98購01,0,0,0,0,0,0,0,0,0,396000,0,0,0,396000,0,396000,396000
048712,樺漢台新94購01  ,0,0,0,0,0,0,0,0,0,395000,0,0,0,395000,0,395000,395000
052913,鴻海元富96購05  ,0,0,0,0,0,0,0,0,0,395000,0,0,0,598000,203000,395000,395000
044602,大立光國泰93購01,0,0,0,0,0,0,0,0,0,394000,0,0,0,436000,42000,394000,394000
051081,聯茂富邦96購01  ,0,0,0,0,0,0,0,0,0,393000,0,0,0,393000,0,393000,393000
045887,台光電元大92購07,0,0,0,0,0,0,0,0,0,392000,0,0,0,392000,0,392000,392000
049854,超眾群益94購02  ,0,0,0,0,0,0,0,0,0,392000,0,0,0,403000,11000,392000,392000
052442,中環元大95購02  ,0,0,0,0,0,0,0,0,0,392000,0,0,0,392000,0,392000,392000
05489P,臺股指凱基95售22,0,0,0,0,0,0,0,0,0,391000,0,0,0,392000,1000,391000,391000
05103P,臺股指凱基96售10,0,0,0,0,0,0,0,0,0,391000,0,0,0,420000,29000,391000,391000
049197,信邦永豐94購01  ,0,0,0,0,0,0,0,0,0,391000,0,0,0,465000,74000,391000,391000
054129,技嘉元大96購02  ,0,0,0,0,0,0,0,0,0,391000,0,0,0,444000,53000,391000,391000
045235,致茂中信93購01  ,0,0,0,0,0,0,0,0,0,390000,0,0,0,400000,10000,390000,390000
054841,亞德客兆豐97購01,0,0,0,0,0,0,0,0,0,389000,0,0,0,389000,0,389000,389000
047678,景碩台新93購01  ,0,0,0,0,0,0,0,0,0,389000,0,0,0,607000,218000,389000,389000
054752,易華電凱基97購02,0,0,0,0,0,0,0,0,0,388000,0,0,0,428000,40000,388000,388000
050182,淘帝元大94購01  ,0,0,0,0,0,0,0,0,0,387000,0,0,0,387000,0,387000,387000
047212,宏達電富邦97購01,0,0,0,0,0,0,0,0,0,385000,0,0,0,385000,0,385000,385000
044615,聯茂兆豐93購01  ,0,0,0,0,0,0,0,0,0,385000,0,0,0,385000,0,385000,385000
051281,健策兆豐96購01  ,0,0,0,0,0,0,0,0,0,383000,0,0,0,393000,10000,383000,383000
051152,鴻海國泰97購01  ,0,0,0,0,0,0,0,0,0,381000,0,0,0,441000,60000,381000,381000
06319P,臺股指元富97售06,0,0,0,0,0,0,0,0,0,381000,0,0,0,401000,20000,381000,381000
04506P,旺宏元大94售06  ,0,0,0,0,0,0,0,0,0,380000,0,0,0,920000,540000,380000,380000
046486,樺漢國泰94購01  ,0,0,0,0,0,0,0,0,0,380000,0,0,0,400000,20000,380000,380000
055045,台肥永豐97購01  ,0,0,0,0,0,0,0,0,0,379000,0,0,0,379000,0,379000,379000
048246,京元電兆豐93購02,0,0,0,0,0,0,0,0,0,379000,0,0,0,399000,20000,379000,379000
051500,聯茂群益95購01  ,0,0,0,0,0,0,0,0,0,379000,0,0,0,409000,30000,379000,379000
056140,康控元大98購01  ,0,0,0,0,0,0,0,0,0,378000,0,0,0,695000,317000,378000,378000
050220,台積電元富96購01,0,0,0,0,0,0,0,0,0,377000,0,0,0,444000,67000,377000,377000
056512,易華電永豐98購01,0,0,0,0,0,0,0,0,0,376000,0,0,0,382000,6000,376000,376000
050363,臺指反元大98購04,0,0,0,0,0,0,0,0,0,375000,0,0,0,884000,509000,375000,375000
053198,亞德客日盛96購01,0,0,0,0,0,0,0,0,0,374000,0,0,0,515000,141000,374000,374000
049788,智伸科兆豐95購01,0,0,0,0,0,0,0,0,0,373000,0,0,0,383000,10000,373000,373000
055838,致茂元大97購03  ,0,0,0,0,0,0,0,0,0,370000,0,0,0,412000,42000,370000,370000
054608,致茂永豐97購01  ,0,0,0,0,0,0,0,0,0,370000,0,0,0,461000,91000,370000,370000
055721,聯詠元大97購04  ,0,0,0,0,0,0,0,0,0,370000,0,0,0,395000,25000,370000,370000
047872,貿聯永豐93購02  ,0,0,0,0,0,0,0,0,0,370000,0,0,0,400000,30000,370000,370000
03832P,臺股指中信95售03,0,0,0,0,0,0,0,0,0,370000,0,0,0,400000,30000,370000,370000
04972P,緯穎元富94售03  ,0,0,0,0,0,0,0,0,0,370000,0,0,0,550000,180000,370000,370000
055196,致新元富97購01  ,0,0,0,0,0,0,0,0,0,367000,0,0,0,410000,43000,367000,367000
03050X,元展47          ,0,0,0,0,0,0,0,0,0,367000,0,0,0,370000,3000,367000,367000
053496,義隆兆豐96購02  ,0,0,0,0,0,0,0,0,0,367000,0,0,0,454000,87000,367000,367000
052516,臺股指凱基95購20,0,0,0,0,0,0,0,0,0,367000,0,0,0,367000,0,367000,367000
047722,南電凱基94購02  ,0,0,0,0,0,0,0,0,0,366000,0,0,0,444000,78000,366000,366000
053538,京鼎永豐96購03  ,0,0,0,0,0,0,0,0,0,366000,0,0,0,373000,7000,366000,366000
044513,義隆凱基93購02  ,0,0,0,0,0,0,0,0,0,365000,0,0,0,373000,8000,365000,365000
05638P,國巨統一96售04  ,0,0,0,0,0,0,0,0,0,364000,0,0,0,607000,243000,364000,364000
054021,義隆台新96購01  ,0,0,0,0,0,0,0,0,0,364000,0,0,0,364000,0,364000,364000
051816,臺股指凱基95購07,0,0,0,0,0,0,0,0,0,362000,0,0,0,362000,0,362000,362000
052042,台積電日盛95購02,0,0,0,0,0,0,0,0,0,362000,0,0,0,588000,226000,362000,362000
054781,台化群益99購01  ,0,0,0,0,0,0,0,0,0,361000,0,0,0,401000,40000,361000,361000
055207,致新中信99購01  ,0,0,0,0,0,0,0,0,0,359000,0,0,0,359000,0,359000,359000
006206,元大上證50      ,214000,0,214000,0,0,0,0,0,0,145000,0,0,0,145000,0,145000,359000
048609,京元電凱基93購07,0,0,0,0,0,0,0,0,0,359000,0,0,0,359000,0,359000,359000
051943,台積電麥證95購03,0,0,0,384000,25000,359000,0,0,0,359000,0,0,0,384000,25000,359000,359000
055896,南電統一97購02  ,0,0,0,0,0,0,0,0,0,358000,0,0,0,358000,0,358000,358000
052979,上銀元大96購02  ,0,0,0,0,0,0,0,0,0,358000,0,0,0,470000,112000,358000,358000
05637P,聯電元大96售04  ,0,0,0,0,0,0,0,0,0,357000,0,0,0,531000,174000,357000,357000
054838,京鼎第一97購01  ,0,0,0,0,0,0,0,0,0,357000,0,0,0,462000,105000,357000,357000
050333,鴻海國泰96購06  ,0,0,0,0,0,0,0,0,0,356000,0,0,0,696000,340000,356000,356000
052886,世紀鋼兆豐96購01,0,0,0,0,0,0,0,0,0,355000,0,0,0,365000,10000,355000,355000
050456,聯茂元大94購09  ,0,0,0,0,0,0,0,0,0,354000,0,0,0,354000,0,354000,354000
048061,鴻海統一95購03  ,0,0,0,0,0,0,0,0,0,354000,0,0,0,406000,52000,354000,354000
054427,潤泰全富邦97購01,0,0,0,0,0,0,0,0,0,354000,0,0,0,374000,20000,354000,354000
053418,旺宏永豐96購02  ,0,0,0,0,0,0,0,0,0,353000,0,0,0,524000,171000,353000,353000
044995,大立光國泰94購01,0,0,0,0,0,0,0,0,0,352000,0,0,0,363000,11000,352000,352000
03240P,臺股指元大02售05,0,0,0,0,0,0,0,0,0,350000,0,0,0,350000,0,350000,350000
050268,智原元大95購03  ,0,0,0,0,0,0,0,0,0,350000,0,0,0,350000,0,350000,350000
053805,奇鋐凱基98購02  ,0,0,0,0,0,0,0,0,0,350000,0,0,0,350000,0,350000,350000
053079,世紀鋼永豐96購01,0,0,0,0,0,0,0,0,0,349000,0,0,0,379000,30000,349000,349000
047864,信邦康和93購01  ,0,0,0,0,0,0,0,0,0,347000,0,0,0,347000,0,347000,347000
049353,茂林永豐94購03  ,0,0,0,0,0,0,0,0,0,347000,0,0,0,357000,10000,347000,347000
2316,楠梓電          ,799000,372000,427000,0,0,0,0,0,0,-80000,0,2000,-2000,6000,84000,-78000,347000
05585P,臺股指凱基96售14,0,0,0,0,0,0,0,0,0,346000,0,0,0,401000,55000,346000,346000
055073,易華電永豐97購01,0,0,0,0,0,0,0,0,0,343000,0,0,0,343000,0,343000,343000
055261,帆宣統一98購01  ,0,0,0,0,0,0,0,0,0,342000,0,0,0,366000,24000,342000,342000
05729P,臺股指凱基97售02,0,0,0,0,0,0,0,0,0,342000,0,0,0,347000,5000,342000,342000
045797,健策中信93購01  ,0,0,0,0,0,0,0,0,0,342000,0,0,0,389000,47000,342000,342000
053510,聯電群益97購01  ,0,0,0,0,0,0,0,0,0,342000,0,0,0,363000,21000,342000,342000
056130,新日興麥證97購01,0,0,0,362000,21000,341000,0,0,0,341000,0,0,0,362000,21000,341000,341000
054299,南電元大96購03  ,0,0,0,0,0,0,0,0,0,341000,0,0,0,781000,440000,341000,341000
055519,茂林中信99購01  ,0,0,0,0,0,0,0,0,0,340000,0,0,0,388000,48000,340000,340000
054689,華新科永豐97購01,0,0,0,0,0,0,0,0,0,340000,0,0,0,625000,285000,340000,340000
047922,聯發科凱基94購01,0,0,0,0,0,0,0,0,0,340000,0,0,0,360000,20000,340000,340000
06441P,台積電凱基98售08,0,0,0,0,0,0,0,0,0,340000,0,0,0,340000,0,340000,340000
050315,和碩兆豐95購01  ,0,0,0,0,0,0,0,0,0,339000,0,0,0,399000,60000,339000,339000
03796P,宏碁元大93售01  ,0,0,0,0,0,0,0,0,0,338000,0,0,0,338000,0,338000,338000
05447P,臺股指元大95售24,0,0,0,0,0,0,0,0,0,338000,0,0,0,359000,21000,338000,338000
048848,滬深2X群益98購02,0,0,0,0,0,0,337000,0,0,0,611000,274000,337000,337000,,,
054434,友達台新96購03  ,0,0,0,0,0,0,0,0,0,337000,0,0,0,342000,5000,337000,337000
053352,義隆兆豐96購01  ,0,0,0,0,0,0,0,0,0,337000,0,0,0,377000,40000,337000,337000
053094,聯電統一97購02  ,0,0,0,0,0,0,0,0,0,336000,0,0,0,450000,114000,336000,336000
054700,致新永豐97購01  ,0,0,0,0,0,0,0,0,0,335000,0,0,0,403000,68000,335000,335000
056273,祥碩統一97購02  ,0,0,0,0,0,0,0,0,0,335000,0,0,0,379000,44000,335000,335000
055795,茂林國泰98購01  ,0,0,0,0,0,0,0,0,0,335000,0,0,0,589000,254000,335000,335000
051673,玉晶光元大96購04,0,0,0,0,0,0,0,0,0,335000,0,0,0,414000,79000,335000,335000
053149,京元電元大96購02,0,0,0,0,0,0,0,0,0,335000,0,0,0,353000,18000,335000,335000
056678,力成元富98購01  ,0,0,0,0,0,0,0,0,0,333000,0,0,0,336000,3000,333000,333000
054487,京元電台新97購01,0,0,0,0,0,0,0,0,0,333000,0,0,0,335000,2000,333000,333000
049863,京元電兆豐94購01,0,0,0,0,0,0,0,0,0,332000,0,0,0,334000,2000,332000,332000
053451,致新凱基96購02  ,0,0,0,0,0,0,0,0,0,332000,0,0,0,332000,0,332000,332000
053823,茂林群益96購06  ,0,0,0,0,0,0,0,0,0,332000,0,0,0,338000,6000,332000,332000
056589,康控統一98購01  ,0,0,0,0,0,0,0,0,0,331000,0,0,0,331000,0,331000,331000
054851,樺漢兆豐97購01  ,0,0,0,0,0,0,0,0,0,331000,0,0,0,331000,0,331000,331000
055041,致新富邦97購01  ,0,0,0,0,0,0,0,0,0,330000,0,0,0,330000,0,330000,330000
055403,泰鼎元富97購01  ,0,0,0,0,0,0,0,0,0,330000,0,0,0,421000,91000,330000,330000
049910,智邦元大94購04  ,0,0,0,0,0,0,0,0,0,330000,0,0,0,360000,30000,330000,330000
050061,聯發科凱基94購07,0,0,0,0,0,0,0,0,0,329000,0,0,0,366000,37000,329000,329000
00653L,富邦印度正2     ,173000,0,173000,0,0,0,0,0,0,155000,0,0,0,214000,59000,155000,328000
047571,滬深2X群益99購01,0,0,0,0,0,0,0,0,0,328000,0,0,0,408000,80000,328000,328000
056096,超眾元富9A購01  ,0,0,0,0,0,0,326000,0,0,0,481000,155000,326000,326000,,,
049905,為升元大94購05  ,0,0,0,0,0,0,0,0,0,326000,0,0,0,346000,20000,326000,326000
06077P,GIS凱基97售02   ,0,0,0,0,0,0,0,0,0,326000,0,0,0,326000,0,326000,326000
051049,亞德客群益95購01,0,0,0,0,0,0,0,0,0,325000,0,0,0,411000,86000,325000,325000
047576,技嘉群益94購01  ,0,0,0,0,0,0,0,0,0,324000,0,0,0,418000,94000,324000,324000
050558,台積電統一94購14,0,0,0,0,0,0,0,0,0,324000,0,0,0,324000,0,324000,324000
053425,京鼎永豐96購01  ,0,0,0,0,0,0,0,0,0,324000,0,0,0,327000,3000,324000,324000
054439,健策台新96購03  ,0,0,0,0,0,0,0,0,0,324000,0,0,0,349000,25000,324000,324000
047514,亞光國票94購01  ,0,0,0,0,0,0,0,0,0,322000,0,0,0,322000,0,322000,322000
8016,矽創            ,315000,287000,28000,0,0,0,215000,11000,204000,90000,18000,15000,3000,96000,9000,87000,322000
050469,聯電台新94購01  ,0,0,0,0,0,0,0,0,0,321000,0,0,0,321000,0,321000,321000
053411,深中小國票9B購01,0,0,0,0,0,0,0,0,0,321000,0,0,0,426000,105000,321000,321000
056234,GIS麥證97購01   ,0,0,0,320000,0,320000,0,0,0,320000,0,0,0,320000,0,320000,320000
056161,康控凱基98購02  ,0,0,0,0,0,0,0,0,0,320000,0,0,0,436000,116000,320000,320000
054874,帆宣群益99購02  ,0,0,0,0,0,0,0,0,0,320000,0,0,0,342000,22000,320000,320000
045457,光磊元大93購01  ,0,0,0,0,0,0,0,0,0,320000,0,0,0,371000,51000,320000,320000
047495,新日興元富96購01,0,0,0,0,0,0,0,0,0,320000,0,0,0,330000,10000,320000,320000
03642C,臺股指元大94牛27,0,0,0,0,0,0,0,0,0,320000,0,0,0,320000,0,320000,320000
053186,健策中信9C購01  ,0,0,0,0,0,0,0,0,0,320000,0,0,0,328000,8000,320000,320000
050257,為升元大94購07  ,0,0,0,0,0,0,0,0,0,319000,0,0,0,349000,30000,319000,319000
052424,泰碩國票97購01  ,0,0,0,0,0,0,0,0,0,319000,0,0,0,319000,0,319000,319000
04241P,欣興國泰95售02  ,0,0,0,0,0,0,0,0,0,318000,0,0,0,328000,10000,318000,318000
042801,達邁元大93購01  ,0,0,0,0,0,0,0,0,0,318000,0,0,0,411000,93000,318000,318000
054202,樺漢富邦97購01  ,0,0,0,0,0,0,0,0,0,318000,0,0,0,499000,181000,318000,318000
054582,致新元大97購01  ,0,0,0,0,0,0,0,0,0,317000,0,0,0,317000,0,317000,317000
056254,為升元富97購01  ,0,0,0,0,0,0,0,0,0,316000,0,0,0,316000,0,316000,316000
06286P,世芯國票97售02  ,0,0,0,0,0,0,0,0,0,316000,0,0,0,402000,86000,316000,316000
048976,華擎元大94購01  ,0,0,0,0,0,0,0,0,0,315000,0,0,0,315000,0,315000,315000
056207,茂林永豐97購03  ,0,0,0,0,0,0,0,0,0,314000,0,0,0,314000,0,314000,314000
056510,正文永豐98購02  ,0,0,0,0,0,0,0,0,0,314000,0,0,0,314000,0,314000,314000
055133,致新康和97購01  ,0,0,0,0,0,0,0,0,0,314000,0,0,0,349000,35000,314000,314000
055700,緯穎國泰98購02  ,0,0,0,0,0,0,0,0,0,314000,0,0,0,659000,345000,314000,314000
046066,長榮航凱基94購01,0,0,0,0,0,0,0,0,0,314000,0,0,0,314000,0,314000,314000
053846,友達元富99購02  ,0,0,0,0,0,0,0,0,0,312000,0,0,0,452000,140000,312000,312000
055705,微星永豐97購01  ,0,0,0,0,0,0,0,0,0,311000,0,0,0,362000,51000,311000,311000
055211,A50反1凱基9A購01,0,0,0,0,0,0,0,0,0,311000,0,0,0,426000,115000,311000,311000
054979,南港元富97購01  ,0,0,0,0,0,0,0,0,0,311000,0,0,0,328000,17000,311000,311000
046053,滬深2X群益94購01,0,0,0,0,0,0,0,0,0,310000,0,0,0,310000,0,310000,310000
04688P,大立光凱基94售09,0,0,0,0,0,0,0,0,0,310000,0,0,0,310000,0,310000,310000
06063P,玉晶光元富97售01,0,0,0,0,0,0,0,0,0,309000,0,0,0,644000,335000,309000,309000
06414P,矽力凱基97售03  ,0,0,0,0,0,0,0,0,0,309000,0,0,0,370000,61000,309000,309000
056118,聯詠群益97購03  ,0,0,0,0,0,0,0,0,0,308000,0,0,0,319000,11000,308000,308000
048178,上銀富邦95購02  ,0,0,0,0,0,0,0,0,0,308000,0,0,0,1573000,1265000,308000,308000
054833,京鼎中信97購01  ,0,0,0,0,0,0,0,0,0,307000,0,0,0,392000,85000,307000,307000
04682P,臺股指統一96售01,0,0,0,0,0,0,0,0,0,307000,0,0,0,307000,0,307000,307000
053750,致伸永豐96購02  ,0,0,0,0,0,0,0,0,0,307000,0,0,0,436000,129000,307000,307000
054400,健策永豐96購02  ,0,0,0,0,0,0,0,0,0,307000,0,0,0,1094000,787000,307000,307000
054850,上海銀兆豐97購01,0,0,0,0,0,0,0,0,0,306000,0,0,0,523000,217000,306000,306000
048662,京元電統一93購04,0,0,0,0,0,0,0,0,0,306000,0,0,0,306000,0,306000,306000
049983,智原凱基94購02  ,0,0,0,0,0,0,0,0,0,306000,0,0,0,337000,31000,306000,306000
052563,京元電日盛96購01,0,0,0,0,0,0,0,0,0,306000,0,0,0,316000,10000,306000,306000
055658,南電元富97購01  ,0,0,0,0,0,0,0,0,0,305000,0,0,0,315000,10000,305000,305000
053542,超眾永豐96購01  ,0,0,0,0,0,0,0,0,0,304000,0,0,0,348000,44000,304000,304000
053400,緯穎中信9A購01  ,0,0,0,0,0,0,0,0,0,304000,0,0,0,348000,44000,304000,304000
047781,上銀國泰94購02  ,0,0,0,0,0,0,0,0,0,303000,0,0,0,303000,0,303000,303000
04527P,大立光凱基94售04,0,0,0,0,0,0,0,0,0,302000,0,0,0,302000,0,302000,302000
053587,京元電元大98購01,0,0,0,0,0,0,0,0,0,302000,0,0,0,730000,428000,302000,302000
046806,瀚宇博元大93購03,0,0,0,0,0,0,0,0,0,301000,0,0,0,301000,0,301000,301000
047177,上銀元大93購05  ,0,0,0,0,0,0,0,0,0,301000,0,0,0,421000,120000,301000,301000
055764,臺股指群益97購02,0,0,0,0,0,0,0,0,0,300000,0,0,0,320000,20000,300000,300000
04601P,大立光凱基94售07,0,0,0,0,0,0,0,0,0,300000,0,0,0,300000,0,300000,300000
04466P,大立光元富94售04,0,0,0,0,0,0,0,0,0,300000,0,0,0,310000,10000,300000,300000
03883P,鴻海元大93售11  ,0,0,0,0,0,0,0,0,0,300000,0,0,0,300000,0,300000,300000
051368,國泰金富邦97購01,0,0,0,0,0,0,0,0,0,300000,0,0,0,300000,0,300000,300000
054389,為升元富96購02  ,0,0,0,0,0,0,0,0,0,300000,0,0,0,390000,90000,300000,300000
05405P,大立光群益95售04,0,0,0,0,0,0,0,0,0,300000,0,0,0,300000,0,300000,300000
055069,帆宣永豐97購01  ,0,0,0,0,0,0,0,0,0,299000,0,0,0,301000,2000,299000,299000
055824,臺股指國票97購11,0,0,0,0,0,0,0,0,0,299000,0,0,0,299000,0,299000,299000
05670P,台積電國票98售01,0,0,0,0,0,0,0,0,0,299000,0,0,0,382000,83000,299000,299000
044770,漢唐元大93購02  ,0,0,0,0,0,0,0,0,0,299000,0,0,0,299000,0,299000,299000
051132,喬山永豐95購02  ,0,0,0,0,0,0,0,0,0,299000,0,0,0,299000,0,299000,299000
053641,正文永豐96購01  ,0,0,0,0,0,0,0,0,0,299000,0,0,0,502000,203000,299000,299000
053335,易華電永豐96購01,0,0,0,0,0,0,0,0,0,299000,0,0,0,369000,70000,299000,299000
056632,鴻海永昌98購01  ,0,0,0,0,0,0,0,0,0,298000,0,0,0,893000,595000,298000,298000
045698,致伸兆豐93購01  ,0,0,0,0,0,0,0,0,0,298000,0,0,0,298000,0,298000,298000
050750,上銀統一94購02  ,0,0,0,0,0,0,0,0,0,298000,0,0,0,303000,5000,298000,298000
050005,京鼎永豐94購01  ,0,0,0,0,0,0,0,0,0,298000,0,0,0,419000,121000,298000,298000
049523,微星兆豐94購02  ,0,0,0,0,0,0,0,0,0,297000,0,0,0,332000,35000,297000,297000
046419,聯鈞元大92購01  ,0,0,0,0,0,0,0,0,0,297000,0,0,0,297000,0,297000,297000
043748,漢唐元大93購01  ,0,0,0,0,0,0,0,0,0,296000,0,0,0,296000,0,296000,296000
047049,聯發科國票94購01,0,0,0,0,0,0,0,0,0,296000,0,0,0,301000,5000,296000,296000
054032,上銀中信96購01  ,0,0,0,0,0,0,0,0,0,296000,0,0,0,356000,60000,296000,296000
054017,茂林永豐96購02  ,0,0,0,0,0,0,0,0,0,296000,0,0,0,296000,0,296000,296000
05660P,玉晶光第一96售01,0,0,0,0,0,0,0,0,0,295000,0,0,0,300000,5000,295000,295000
056101,光磊永豐98購01  ,0,0,0,0,0,0,0,0,0,295000,0,0,0,557000,262000,295000,295000
055456,上銀富邦99購01  ,0,0,0,0,0,0,0,0,0,294000,0,0,0,347000,53000,294000,294000
048516,麗豐凱基93購02  ,0,0,0,0,0,0,0,0,0,294000,0,0,0,294000,0,294000,294000
044457,滬深2X國票97購01,0,0,0,0,0,0,0,0,0,294000,0,0,0,499000,205000,294000,294000
052309,健策國泰97購01  ,0,0,0,0,0,0,0,0,0,294000,0,0,0,784000,490000,294000,294000
05005P,台表科統一95售01,0,0,0,0,0,0,0,0,0,293000,0,0,0,379000,86000,293000,293000
048429,旺宏國票94購02  ,0,0,0,0,0,0,0,0,0,293000,0,0,0,703000,410000,293000,293000
3533,嘉澤            ,564000,329000,235000,0,0,0,70000,0,70000,-12000,33000,52000,-19000,60000,53000,7000,293000
055046,上銀永豐97購01  ,0,0,0,0,0,0,0,0,0,292000,0,0,0,348000,56000,292000,292000
052670,茂林群益96購02  ,0,0,0,0,0,0,0,0,0,292000,0,0,0,293000,1000,292000,292000
055804,祥碩永豐97購02  ,0,0,0,0,0,0,0,0,0,291000,0,0,0,391000,100000,291000,291000
056074,茂林元大97購04  ,0,0,0,0,0,0,0,0,0,290000,0,0,0,291000,1000,290000,290000
042255,群創國票92購01  ,0,0,0,0,0,0,0,0,0,290000,0,0,0,290000,0,290000,290000
048702,正文國票95購01  ,0,0,0,0,0,0,0,0,0,290000,0,0,0,300000,10000,290000,290000
049134,為升元大95購01  ,0,0,0,0,0,0,0,0,0,290000,0,0,0,340000,50000,290000,290000
053870,正文元大96購01  ,0,0,0,0,0,0,0,0,0,290000,0,0,0,290000,0,290000,290000
048937,玉晶光永豐95購01,0,0,0,0,0,0,0,0,0,289000,0,0,0,329000,40000,289000,289000
053114,聯茂兆豐97購01  ,0,0,0,0,0,0,0,0,0,289000,0,0,0,387000,98000,289000,289000
055980,祥碩統一98購01  ,0,0,0,0,0,0,0,0,0,288000,0,0,0,426000,138000,288000,288000
053063,力山群益98購01  ,0,0,0,0,0,0,0,0,0,288000,0,0,0,310000,22000,288000,288000
049490,京元電元大95購02,0,0,0,0,0,0,0,0,0,287000,0,0,0,374000,87000,287000,287000
050954,樺漢群益95購01  ,0,0,0,0,0,0,0,0,0,287000,0,0,0,299000,12000,287000,287000
8271,宇瞻            ,494000,214000,280000,0,0,0,0,0,0,7000,7000,0,7000,0,0,0,287000
054775,復盛國票98購01  ,0,0,0,0,0,0,0,0,0,286000,0,0,0,364000,78000,286000,286000
05026P,貿聯群益95售01  ,0,0,0,0,0,0,0,0,0,286000,0,0,0,394000,108000,286000,286000
054644,A50正2群益9B購01,0,0,0,0,0,0,0,0,0,285000,0,0,0,300000,15000,285000,285000
055391,光罩統一97購02  ,0,0,0,0,0,0,0,0,0,285000,0,0,0,295000,10000,285000,285000
05301P,矽力元大95售02  ,0,0,0,0,0,0,0,0,0,285000,0,0,0,550000,265000,285000,285000
046843,上銀永豐93購01  ,0,0,0,0,0,0,0,0,0,284000,0,0,0,384000,100000,284000,284000
045517,元油2X元富98購01,0,0,0,0,0,0,0,0,0,284000,0,0,0,457000,173000,284000,284000
051106,華通統一95購02  ,0,0,0,0,0,0,0,0,0,284000,0,0,0,300000,16000,284000,284000
052446,聯發科元大96購03,0,0,0,0,0,0,0,0,0,284000,0,0,0,292000,8000,284000,284000
048314,京元電凱基93購04,0,0,0,0,0,0,0,0,0,283000,0,0,0,283000,0,283000,283000
053569,漢唐統一98購01  ,0,0,0,0,0,0,0,0,0,283000,0,0,0,303000,20000,283000,283000
053270,台塑元大96購01  ,0,0,0,0,0,0,0,0,0,282000,0,0,0,337000,55000,282000,282000
052075,旺宏元富95購03  ,0,0,0,0,0,0,0,0,0,282000,0,0,0,297000,15000,282000,282000
054503,京鼎永豐96購04  ,0,0,0,0,0,0,0,0,0,281000,0,0,0,283000,2000,281000,281000
055153,台光電元大98購02,0,0,0,0,0,0,0,0,0,281000,0,0,0,291000,10000,281000,281000
05171P,臺股指元大95售15,0,0,0,0,0,0,0,0,0,281000,0,0,0,321000,40000,281000,281000
051665,台積電元大96購07,0,0,0,0,0,0,0,0,0,280000,0,0,0,300000,20000,280000,280000
049306,元油2X凱基96購01,0,0,0,0,0,0,0,0,0,280000,0,0,0,490000,210000,280000,280000
049651,訊芯凱基94購04  ,0,0,0,0,0,0,0,0,0,280000,0,0,0,470000,190000,280000,280000
056327,樺漢兆豐98購01  ,0,0,0,0,0,0,0,0,0,279000,0,0,0,279000,0,279000,279000
049763,美食國泰96購01  ,0,0,0,0,0,0,0,0,0,279000,0,0,0,279000,0,279000,279000
049744,亞德客永豐94購01,0,0,0,0,0,0,0,0,0,279000,0,0,0,393000,114000,279000,279000
048499,達運元大96購01  ,0,0,0,0,0,0,0,0,0,279000,0,0,0,383000,104000,279000,279000
051570,和碩富邦97購01  ,0,0,0,0,0,0,0,0,0,279000,0,0,0,389000,110000,279000,279000
054746,貿聯凱基98購02  ,0,0,0,0,0,0,0,0,0,278000,0,0,0,300000,22000,278000,278000
055205,京鼎中信99購01  ,0,0,0,0,0,0,0,0,0,278000,0,0,0,288000,10000,278000,278000
055711,上銀元大97購04  ,0,0,0,0,0,0,0,0,0,278000,0,0,0,460000,182000,278000,278000
055742,健策元富97購02  ,0,0,0,0,0,0,0,0,0,278000,0,0,0,288000,10000,278000,278000
052434,茂林國泰97購01  ,0,0,0,0,0,0,0,0,0,278000,0,0,0,318000,40000,278000,278000
053540,健策永豐96購01  ,0,0,0,0,0,0,0,0,0,278000,0,0,0,328000,50000,278000,278000
053863,聯發科元大96購18,0,0,0,0,0,0,0,0,0,277000,0,0,0,342000,65000,277000,277000
050467,力成中信94購01  ,0,0,0,0,0,0,0,0,0,276000,0,0,0,412000,136000,276000,276000
050258,為升元大94購08  ,0,0,0,0,0,0,0,0,0,276000,0,0,0,392000,116000,276000,276000
04294P,台積電元大95售01,0,0,0,0,0,0,0,0,0,275000,0,0,0,538000,263000,275000,275000
049018,光罩群益94購01  ,0,0,0,0,0,0,0,0,0,275000,0,0,0,275000,0,275000,275000
053383,京元電元大97購01,0,0,0,0,0,0,0,0,0,275000,0,0,0,409000,134000,275000,275000
2354,鴻準            ,1120620,846000,274620,0,0,0,0,0,0,0,0,0,0,0,0,0,274620
055182,京鼎統一98購01  ,0,0,0,0,0,0,0,0,0,274000,0,0,0,274000,0,274000,274000
049793,為升元大94購04  ,0,0,0,0,0,0,0,0,0,274000,0,0,0,309000,35000,274000,274000
051216,為升元富95購01  ,0,0,0,0,0,0,0,0,0,274000,0,0,0,364000,90000,274000,274000
054350,美律國泰98購01  ,0,0,0,0,0,0,0,0,0,274000,0,0,0,431000,157000,274000,274000
051969,世紀鋼永豐95購01,0,0,0,0,0,0,0,0,0,274000,0,0,0,274000,0,274000,274000
051860,為升凱基95購01  ,0,0,0,0,0,0,0,0,0,274000,0,0,0,351000,77000,274000,274000
054873,帆宣群益99購01  ,0,0,0,0,0,0,0,0,0,273000,0,0,0,305000,32000,273000,273000
050716,可成群益96購01  ,0,0,0,0,0,0,0,0,0,273000,0,0,0,273000,0,273000,273000
049985,華擎凱基94購01  ,0,0,0,0,0,0,0,0,0,273000,0,0,0,404000,131000,273000,273000
053615,光罩群益96購01  ,0,0,0,0,0,0,0,0,0,273000,0,0,0,273000,0,273000,273000
053619,和碩群益96購01  ,0,0,0,0,0,0,0,0,0,273000,0,0,0,391000,118000,273000,273000
1909,榮成            ,665000,409000,256000,0,0,0,0,0,0,17000,20000,3000,17000,0,0,0,273000
055238,茂林台新97購01  ,0,0,0,0,0,0,0,0,0,272000,0,0,0,272000,0,272000,272000
055396,瑞儀統一97購01  ,0,0,0,0,0,0,0,0,0,272000,0,0,0,272000,0,272000,272000
051040,漢唐永豐95購01  ,0,0,0,0,0,0,0,0,0,272000,0,0,0,272000,0,272000,272000
053752,超眾永豐96購02  ,0,0,0,0,0,0,0,0,0,272000,0,0,0,292000,20000,272000,272000
054250,漢唐元大96購04  ,0,0,0,0,0,0,0,0,0,271000,0,0,0,275000,4000,271000,271000
052386,鴻海群益96購02  ,0,0,0,0,0,0,0,0,0,271000,0,0,0,271000,0,271000,271000
2408,南亞科          ,3350000,3692000,-342000,0,0,0,415000,0,415000,198000,199000,53000,146000,137000,85000,52000,271000
054811,裕隆元大9A購01  ,0,0,0,0,0,0,0,0,0,270000,0,0,0,463000,193000,270000,270000
056269,新日興統一98購01,0,0,0,0,0,0,0,0,0,270000,0,0,0,330000,60000,270000,270000
051982,深中小元大95購01,0,0,0,0,0,0,0,0,0,270000,0,0,0,390000,120000,270000,270000
053625,國巨兆豐96購03  ,0,0,0,0,0,0,0,0,0,270000,0,0,0,312000,42000,270000,270000
06382P,大毅元富97售02  ,0,0,0,0,0,0,0,0,0,270000,0,0,0,326000,56000,270000,270000
056286,奇鋐永豐97購01  ,0,0,0,0,0,0,0,0,0,269000,0,0,0,269000,0,269000,269000
054683,川湖永豐97購01  ,0,0,0,0,0,0,0,0,0,269000,0,0,0,472000,203000,269000,269000
053727,麗豐凱基97購01  ,0,0,0,0,0,0,0,0,0,269000,0,0,0,305000,36000,269000,269000
052816,上銀永豐96購01  ,0,0,0,0,0,0,0,0,0,269000,0,0,0,396000,127000,269000,269000
055600,致伸元大97購02  ,0,0,0,0,0,0,0,0,0,268000,0,0,0,368000,100000,268000,268000
055798,聯茂富邦98購01  ,0,0,0,0,0,0,0,0,0,268000,0,0,0,335000,67000,268000,268000
047354,訊芯凱基94購01  ,0,0,0,0,0,0,0,0,0,268000,0,0,0,278000,10000,268000,268000
049078,瑞昱凱基94購02  ,0,0,0,0,0,0,0,0,0,268000,0,0,0,300000,32000,268000,268000
054376,聯茂中信97購01  ,0,0,0,0,0,0,0,0,0,268000,0,0,0,316000,48000,268000,268000
055660,台光電兆豐97購01,0,0,0,0,0,0,0,0,0,267000,0,0,0,277000,10000,267000,267000
053941,國巨國泰96購05  ,0,0,0,0,0,0,0,0,0,267000,0,0,0,580000,313000,267000,267000
055769,智伸科中信97購01,0,0,0,0,0,0,0,0,0,266000,0,0,0,336000,70000,266000,266000
049492,聯發科元大95購02,0,0,0,0,0,0,0,0,0,266000,0,0,0,512000,246000,266000,266000
050121,南電元大95購02  ,0,0,0,0,0,0,0,0,0,266000,0,0,0,266000,0,266000,266000
055596,新光金元大9B購02,0,0,0,0,0,0,0,0,0,265000,0,0,0,265000,0,265000,265000
047684,景碩國泰94購01  ,0,0,0,0,0,0,0,0,0,265000,0,0,0,274000,9000,265000,265000
043231,鴻海中信95購01  ,0,0,0,0,0,0,0,0,0,265000,0,0,0,300000,35000,265000,265000
048810,玉晶光第一94購01,0,0,0,0,0,0,0,0,0,265000,0,0,0,375000,110000,265000,265000
053997,健策群益97購02  ,0,0,0,0,0,0,0,0,0,265000,0,0,0,329000,64000,265000,265000
053034,上海銀兆豐96購01,0,0,0,0,0,0,0,0,0,265000,0,0,0,452000,187000,265000,265000
055195,昇陽半元富97購02,0,0,0,0,0,0,0,0,0,264000,0,0,0,266000,2000,264000,264000
05867P,友達兆豐97售02  ,0,0,0,0,0,0,0,0,0,264000,0,0,0,264000,0,264000,264000
051027,楠梓電元富95購01,0,0,0,0,0,0,0,0,0,264000,0,0,0,264000,0,264000,264000
054895,南電統一97購01  ,0,0,0,0,0,0,0,0,0,263000,0,0,0,263000,0,263000,263000
047202,欣興元富96購01  ,0,0,0,0,0,0,0,0,0,263000,0,0,0,275000,12000,263000,263000
054384,瀚宇博群益96購02,0,0,0,0,0,0,0,0,0,263000,0,0,0,274000,11000,263000,263000
054835,致新中信97購01  ,0,0,0,0,0,0,0,0,0,262000,0,0,0,362000,100000,262000,262000
047077,日月光兆豐93購01,0,0,0,0,0,0,0,0,0,262000,0,0,0,292000,30000,262000,262000
050123,群臺反凱基96購01,0,0,0,0,0,0,0,0,0,262000,0,0,0,263000,1000,262000,262000
054446,美食兆豐97購01  ,0,0,0,0,0,0,0,0,0,262000,0,0,0,291000,29000,262000,262000
06212P,華新科元大97售11,0,0,0,0,0,0,0,0,0,262000,0,0,0,796000,534000,262000,262000
055640,鴻海元富97購03  ,0,0,0,0,0,0,0,0,0,261000,0,0,0,431000,170000,261000,261000
046770,聯發科國泰94購01,0,0,0,0,0,0,0,0,0,261000,0,0,0,585000,324000,261000,261000
047969,台達電富邦97購01,0,0,0,0,0,0,0,0,0,261000,0,0,0,274000,13000,261000,261000
050767,京元電元大96購01,0,0,0,0,0,0,0,0,0,261000,0,0,0,499000,238000,261000,261000
053687,智邦元大96購02  ,0,0,0,0,0,0,0,0,0,261000,0,0,0,446000,185000,261000,261000
053518,聯茂群益96購03  ,0,0,0,0,0,0,0,0,0,261000,0,0,0,281000,20000,261000,261000
05239P,欣興永豐95售03  ,0,0,0,0,0,0,0,0,0,261000,0,0,0,304000,43000,261000,261000
055321,大立光國票98購02,0,0,0,0,0,0,0,0,0,260000,0,0,0,270000,10000,260000,260000
05774P,臺股指凱基99售04,0,0,0,0,0,0,0,0,0,260000,0,0,0,563000,303000,260000,260000
049481,為升元大94購03  ,0,0,0,0,0,0,0,0,0,260000,0,0,0,260000,0,260000,260000
051990,泰碩元大95購01  ,0,0,0,0,0,0,0,0,0,260000,0,0,0,460000,200000,260000,260000
053017,世紀鋼統一96購02,0,0,0,0,0,0,0,0,0,260000,0,0,0,262000,2000,260000,260000
053432,世紀鋼永豐96購02,0,0,0,0,0,0,0,0,0,260000,0,0,0,260000,0,260000,260000
053757,聯發科國泰96購04,0,0,0,0,0,0,0,0,0,260000,0,0,0,330000,70000,260000,260000
050083,旺宏元富94購01  ,0,0,0,0,0,0,0,0,0,259000,0,0,0,260000,1000,259000,259000
052312,美律富邦96購02  ,0,0,0,0,0,0,0,0,0,259000,0,0,0,311000,52000,259000,259000
056476,智原元大98購02  ,0,0,0,0,0,0,0,0,0,258000,0,0,0,325000,67000,258000,258000
054673,京鼎國泰98購01  ,0,0,0,0,0,0,0,0,0,258000,0,0,0,268000,10000,258000,258000
050439,新日興凱基94購01,0,0,0,0,0,0,0,0,0,258000,0,0,0,288000,30000,258000,258000
047368,南電群益93購01  ,0,0,0,0,0,0,0,0,0,258000,0,0,0,308000,50000,258000,258000
044291,群創凱基93購06  ,0,0,0,0,0,0,0,0,0,258000,0,0,0,854000,596000,258000,258000
051654,致新永豐95購01  ,0,0,0,0,0,0,0,0,0,258000,0,0,0,268000,10000,258000,258000
052195,健策元富95購01  ,0,0,0,0,0,0,0,0,0,258000,0,0,0,339000,81000,258000,258000
053110,大立光兆豐97購01,0,0,0,0,0,0,0,0,0,258000,0,0,0,268000,10000,258000,258000
047522,微星元大93購02  ,0,0,0,0,0,0,0,0,0,257000,0,0,0,257000,0,257000,257000
03414B,臺股指凱基99熊01,0,0,0,0,0,0,0,0,0,257000,0,0,0,333000,76000,257000,257000
051156,鴻海富邦97購01  ,0,0,0,0,0,0,0,0,0,257000,0,0,0,257000,0,257000,257000
049766,滬深2X元富94購02,0,0,0,0,0,0,0,0,0,257000,0,0,0,1324000,1067000,257000,257000
055379,牧德元大97購03  ,0,0,0,0,0,0,0,0,0,256000,0,0,0,408000,152000,256000,256000
054243,國喬元大96購01  ,0,0,0,0,0,0,0,0,0,256000,0,0,0,256000,0,256000,256000
055120,南港兆豐97購01  ,0,0,0,0,0,0,0,0,0,255000,0,0,0,311000,56000,255000,255000
055796,南電國泰98購01  ,0,0,0,0,0,0,0,0,0,255000,0,0,0,265000,10000,255000,255000
056381,台虹元富98購01  ,0,0,0,0,0,0,0,0,0,255000,0,0,0,260000,5000,255000,255000
049789,世紀鋼兆豐94購01,0,0,0,0,0,0,0,0,0,255000,0,0,0,255000,0,255000,255000
048237,致茂國票94購01  ,0,0,0,0,0,0,0,0,0,255000,0,0,0,310000,55000,255000,255000
054563,泰碩群益99購01  ,0,0,0,0,0,0,0,0,0,254000,0,0,0,264000,10000,254000,254000
049516,光罩國票94購02  ,0,0,0,0,0,0,0,0,0,254000,0,0,0,254000,0,254000,254000
047965,景碩中信93購01  ,0,0,0,0,0,0,0,0,0,254000,0,0,0,254000,0,254000,254000
049899,台積電元富94購05,0,0,0,0,0,0,0,0,0,254000,0,0,0,586000,332000,254000,254000
047968,南電國泰94購01  ,0,0,0,0,0,0,0,0,0,253000,0,0,0,533000,280000,253000,253000
051560,玉晶光國泰97購03,0,0,0,0,0,0,0,0,0,253000,0,0,0,304000,51000,253000,253000
054229,超眾元富96購05  ,0,0,0,0,0,0,0,0,0,253000,0,0,0,254000,1000,253000,253000
054374,信邦中信96購01  ,0,0,0,0,0,0,0,0,0,253000,0,0,0,283000,30000,253000,253000
053331,玉晶光永豐97購02,0,0,0,0,0,0,0,0,0,253000,0,0,0,279000,26000,253000,253000
2375,凱美            ,449000,213000,236000,0,0,0,0,0,0,17000,0,0,0,30000,13000,17000,253000
055093,京鼎群益98購01  ,0,0,0,0,0,0,0,0,0,252000,0,0,0,252000,0,252000,252000
054881,光罩統一97購01  ,0,0,0,0,0,0,0,0,0,252000,0,0,0,252000,0,252000,252000
056100,楠梓電永豐97購02,0,0,0,0,0,0,0,0,0,252000,0,0,0,352000,100000,252000,252000
048128,超眾元大95購01  ,0,0,0,0,0,0,0,0,0,252000,0,0,0,367000,115000,252000,252000
054798,超眾群益97購01  ,0,0,0,0,0,0,0,0,0,251000,0,0,0,292000,41000,251000,251000
049369,義隆元大95購01  ,0,0,0,0,0,0,0,0,0,251000,0,0,0,252000,1000,251000,251000
053392,致新元大96購01  ,0,0,0,0,0,0,0,0,0,251000,0,0,0,501000,250000,251000,251000
053695,智易元大97購02  ,0,0,0,0,0,0,0,0,0,251000,0,0,0,251000,0,251000,251000
055394,健策統一97購01  ,0,0,0,0,0,0,0,0,0,250000,0,0,0,442000,192000,250000,250000
055257,景碩統一97購01  ,0,0,0,0,0,0,0,0,0,250000,0,0,0,312000,62000,250000,250000
056048,同欣電兆豐97購01,0,0,0,0,0,0,0,0,0,250000,0,0,0,334000,84000,250000,250000
056222,台積電凱基9A購01,0,0,0,0,0,0,0,0,0,250000,0,0,0,250000,0,250000,250000
053859,台積電元大97購09,0,0,0,0,0,0,0,0,0,250000,0,0,0,559000,309000,250000,250000
2887E,台新戊特        ,0,0,0,0,0,0,0,0,0,250000,250000,0,250000,0,0,0,250000
047845,美利達元大93購02,0,0,0,0,0,0,0,0,0,249000,0,0,0,249000,0,249000,249000
046116,京元電元大92購05,0,0,0,0,0,0,0,0,0,249000,0,0,0,249000,0,249000,249000
048725,京元電日盛94購01,0,0,0,0,0,0,0,0,0,249000,0,0,0,344000,95000,249000,249000
052420,道瓊反國票9B購01,0,0,0,0,0,0,0,0,0,249000,0,0,0,250000,1000,249000,249000
052774,京元電亞東96購01,0,0,0,0,0,0,0,0,0,248000,0,0,0,248000,0,248000,248000
054237,茂林群益97購01  ,0,0,0,0,0,0,0,0,0,247000,0,0,0,299000,52000,247000,247000
047871,健策永豐93購02  ,0,0,0,0,0,0,0,0,0,246000,0,0,0,276000,30000,246000,246000
047388,京元電元大95購01,0,0,0,0,0,0,0,0,0,246000,0,0,0,248000,2000,246000,246000
051238,中環元大96購01  ,0,0,0,0,0,0,0,0,0,246000,0,0,0,246000,0,246000,246000
049795,華通元大96購02  ,0,0,0,0,0,0,0,0,0,246000,0,0,0,276000,30000,246000,246000
053458,聯詠國泰97購01  ,0,0,0,0,0,0,0,0,0,245000,0,0,0,460000,215000,245000,245000
050430,京元電凱基94購03,0,0,0,0,0,0,0,0,0,244000,0,0,0,244000,0,244000,244000
051825,中環元大95購01  ,0,0,0,0,0,0,0,0,0,244000,0,0,0,246000,2000,244000,244000
056127,致新國票98購02  ,0,0,0,0,0,0,0,0,0,243000,0,0,0,243000,0,243000,243000
049538,元油2X群益98購01,0,0,0,0,0,0,0,0,0,243000,0,0,0,445000,202000,243000,243000
04974P,聯發科凱基96售02,0,0,0,0,0,0,0,0,0,243000,0,0,0,363000,120000,243000,243000
049240,華通元富94購01  ,0,0,0,0,0,0,0,0,0,243000,0,0,0,293000,50000,243000,243000
050968,超眾永豐95購01  ,0,0,0,0,0,0,0,0,0,243000,0,0,0,263000,20000,243000,243000
048871,晶豪科國票94購01,0,0,0,0,0,0,0,0,0,243000,0,0,0,243000,0,243000,243000
052586,晶豪科永豐96購01,0,0,0,0,0,0,0,0,0,243000,0,0,0,246000,3000,243000,243000
052836,旺宏國泰98購01  ,0,0,0,0,0,0,0,0,0,242000,0,0,0,264000,22000,242000,242000
052904,冠德國票97購01  ,0,0,0,0,0,0,0,0,0,242000,0,0,0,250000,8000,242000,242000
052507,日月光日盛95購02,0,0,0,0,0,0,0,0,0,242000,0,0,0,242000,0,242000,242000
046134,致新國泰93購02  ,0,0,0,0,0,0,0,0,0,241000,0,0,0,241000,0,241000,241000
045484,聯電亞東94購01  ,0,0,0,0,0,0,0,0,0,241000,0,0,0,261000,20000,241000,241000
050006,華擎永豐94購03  ,0,0,0,0,0,0,0,0,0,241000,0,0,0,484000,243000,241000,241000
049598,超眾元大95購03  ,0,0,0,0,0,0,0,0,0,241000,0,0,0,266000,25000,241000,241000
06217P,鴻海元富97售05  ,0,0,0,0,0,0,0,0,0,241000,0,0,0,513000,272000,241000,241000
055426,旺宏群益99購02  ,0,0,0,0,0,0,0,0,0,240000,0,0,0,243000,3000,240000,240000
055154,聯發科元大98購01,0,0,0,0,0,0,0,0,0,240000,0,0,0,313000,73000,240000,240000
04139P,大立光國票93售03,0,0,0,0,0,0,0,0,0,240000,0,0,0,240000,0,240000,240000
03021P,玉晶光群益02售25,0,0,0,0,0,0,0,0,0,240000,0,0,0,250000,10000,240000,240000
049381,欣興元大94購05  ,0,0,0,0,0,0,0,0,0,240000,0,0,0,245000,5000,240000,240000
051814,鈺齊凱基95購01  ,0,0,0,0,0,0,0,0,0,240000,0,0,0,400000,160000,240000,240000
052746,泰碩元大97購01  ,0,0,0,0,0,0,0,0,0,240000,0,0,0,240000,0,240000,240000
054044,京元電元大96購03,0,0,0,0,0,0,0,0,0,240000,0,0,0,260000,20000,240000,240000
048218,上銀凱基93購07  ,0,0,0,0,0,0,0,0,0,239000,0,0,0,393000,154000,239000,239000
048576,義隆國泰95購01  ,0,0,0,0,0,0,0,0,0,238000,0,0,0,544000,306000,238000,238000
048007,明基材元大96購01,0,0,0,0,0,0,0,0,0,238000,0,0,0,263000,25000,238000,238000
055808,世紀鋼永豐97購01,0,0,0,0,0,0,0,0,0,237000,0,0,0,237000,0,237000,237000
046204,致新凱基93購01  ,0,0,0,0,0,0,0,0,0,237000,0,0,0,237000,0,237000,237000
053992,中環群益96購01  ,0,0,0,0,0,0,0,0,0,237000,0,0,0,237000,0,237000,237000
051395,聯詠兆豐95購01  ,0,0,0,0,0,0,0,0,0,236000,0,0,0,236000,0,236000,236000
051707,欣興群益95購02  ,0,0,0,0,0,0,0,0,0,236000,0,0,0,236000,0,236000,236000
056423,奇鋐統一98購01  ,0,0,0,0,0,0,0,0,0,235000,0,0,0,235000,0,235000,235000
055657,超眾元富97購02  ,0,0,0,0,0,0,0,0,0,235000,0,0,0,235000,0,235000,235000
055627,亞德客永豐97購02,0,0,0,0,0,0,0,0,0,235000,0,0,0,333000,98000,235000,235000
047931,日月光凱基93購01,0,0,0,0,0,0,0,0,0,235000,0,0,0,388000,153000,235000,235000
048127,麗豐元大94購01  ,0,0,0,0,0,0,0,0,0,235000,0,0,0,355000,120000,235000,235000
054121,奇鋐永豐96購02  ,0,0,0,0,0,0,0,0,0,235000,0,0,0,235000,0,235000,235000
055198,奇力新第一97購01,0,0,0,0,0,0,0,0,0,233000,0,0,0,253000,20000,233000,233000
054856,得力群益99購01  ,0,0,0,0,0,0,0,0,0,233000,0,0,0,243000,10000,233000,233000
048624,美律台新93購01  ,0,0,0,0,0,0,0,0,0,233000,0,0,0,243000,10000,233000,233000
051470,玉晶光日盛95購01,0,0,0,0,0,0,0,0,0,233000,0,0,0,414000,181000,233000,233000
05998P,台積電元大97售12,0,0,0,0,0,0,0,0,0,233000,0,0,0,515000,282000,233000,233000
056166,微星台新97購01  ,0,0,0,0,0,0,0,0,0,232000,0,0,0,247000,15000,232000,232000
5876,上海商銀        ,1983000,1530000,453000,0,0,0,0,0,0,-221000,0,1000,-1000,21000,241000,-220000,232000
056625,致伸永豐98購01  ,0,0,0,0,0,0,0,0,0,231000,0,0,0,231000,0,231000,231000
055282,聯發科元大97購15,0,0,0,0,0,0,0,0,0,231000,0,0,0,317000,86000,231000,231000
048000,義隆元大93購03  ,0,0,0,0,0,0,0,0,0,231000,0,0,0,257000,26000,231000,231000
054747,麗豐凱基98購01  ,0,0,0,0,0,0,0,0,0,230000,0,0,0,230000,0,230000,230000
056051,T50反1元大97購05,0,0,0,0,0,0,0,0,0,230000,0,0,0,370000,140000,230000,230000
051094,健策元大96購03  ,0,0,0,0,0,0,0,0,0,230000,0,0,0,242000,12000,230000,230000
048428,滬深2X國票93購05,0,0,0,0,0,0,0,0,0,230000,0,0,0,230000,0,230000,230000
054361,技嘉凱基96購01  ,0,0,0,0,0,0,0,0,0,230000,0,0,0,290000,60000,230000,230000
052468,超眾統一96購02  ,0,0,0,0,0,0,0,0,0,230000,0,0,0,230000,0,230000,230000
056368,祥碩元大98購02  ,0,0,0,0,0,0,0,0,0,229000,0,0,0,387000,158000,229000,229000
047663,亞德客永豐93購03,0,0,0,0,0,0,0,0,0,229000,0,0,0,289000,60000,229000,229000
056191,世紀鋼統一97購01,0,0,0,0,0,0,0,0,0,228000,0,0,0,228000,0,228000,228000
056528,為升凱基98購01  ,0,0,0,0,0,0,0,0,0,228000,0,0,0,263000,35000,228000,228000
055604,訊芯元大98購02  ,0,0,0,0,0,0,0,0,0,228000,0,0,0,228000,0,228000,228000
047231,大立光凱基95購03,0,0,0,0,0,0,0,0,0,228000,0,0,0,263000,35000,228000,228000
051503,玉晶光統一97購01,0,0,0,0,0,0,0,0,0,228000,0,0,0,228000,0,228000,228000
051645,光寶科永豐95購01,0,0,0,0,0,0,0,0,0,228000,0,0,0,229000,1000,228000,228000
048869,光罩國票94購01  ,0,0,0,0,0,0,0,0,0,228000,0,0,0,228000,0,228000,228000
054188,欣興永豐96購03  ,0,0,0,0,0,0,0,0,0,228000,0,0,0,268000,40000,228000,228000
055191,牧德元富97購01  ,0,0,0,0,0,0,0,0,0,227000,0,0,0,384000,157000,227000,227000
055398,超眾統一97購03  ,0,0,0,0,0,0,0,0,0,227000,0,0,0,227000,0,227000,227000
054581,訊芯元大97購02  ,0,0,0,0,0,0,0,0,0,227000,0,0,0,299000,72000,227000,227000
048631,遠東新元大93購01,0,0,0,0,0,0,0,0,0,227000,0,0,0,300000,73000,227000,227000
049588,聯發科元大94購06,0,0,0,0,0,0,0,0,0,227000,0,0,0,257000,30000,227000,227000
052391,瑞儀群益95購01  ,0,0,0,0,0,0,0,0,0,227000,0,0,0,249000,22000,227000,227000
056383,上銀國泰99購01  ,0,0,0,0,0,0,0,0,0,226000,0,0,0,226000,0,226000,226000
050562,瑞昱元富94購02  ,0,0,0,0,0,0,0,0,0,226000,0,0,0,460000,234000,226000,226000
052385,滬深2X群益99購05,0,0,0,0,0,0,0,0,0,226000,0,0,0,361000,135000,226000,226000
054156,聯電亞東98購01  ,0,0,0,0,0,0,0,0,0,226000,0,0,0,226000,0,226000,226000
046642,南電永豐93購01  ,0,0,0,0,0,0,0,0,0,225000,0,0,0,225000,0,225000,225000
055876,美食元富9A購01  ,0,0,0,0,0,0,0,0,0,224000,0,0,0,310000,86000,224000,224000
055629,華新科永豐97購04,0,0,0,0,0,0,0,0,0,224000,0,0,0,242000,18000,224000,224000
046197,日月光凱基92購04,0,0,0,0,0,0,0,0,0,224000,0,0,0,244000,20000,224000,224000
048536,南電國票93購04  ,0,0,0,0,0,0,0,0,0,224000,0,0,0,224000,0,224000,224000
045086,玉晶光元大94購02,0,0,0,0,0,0,0,0,0,224000,0,0,0,243000,19000,224000,224000
05062P,大立光富邦98售03,0,0,0,0,0,0,0,0,0,224000,0,0,0,289000,65000,224000,224000
051774,聯茂中信96購01  ,0,0,0,0,0,0,0,0,0,224000,0,0,0,237000,13000,224000,224000
051748,超眾國泰96購01  ,0,0,0,0,0,0,0,0,0,224000,0,0,0,343000,119000,224000,224000
052809,訊芯元大97購01  ,0,0,0,0,0,0,0,0,0,224000,0,0,0,467000,243000,224000,224000
052688,新日興元大96購01,0,0,0,0,0,0,0,0,0,224000,0,0,0,309000,85000,224000,224000
054927,帆宣凱基97購01  ,0,0,0,0,0,0,0,0,0,223000,0,0,0,267000,44000,223000,223000
05684P,臺股指元大96售09,0,0,0,0,0,0,0,0,0,223000,0,0,0,260000,37000,223000,223000
044855,南電國泰93購01  ,0,0,0,0,0,0,0,0,0,223000,0,0,0,223000,0,223000,223000
054201,聯詠富邦97購02  ,0,0,0,0,0,0,0,0,0,223000,0,0,0,539000,316000,223000,223000
03422B,臺股指凱基96熊28,0,0,0,0,0,0,0,0,0,222000,0,0,0,222000,0,222000,222000
047741,鴻海統一93購06  ,0,0,0,0,0,0,0,0,0,222000,0,0,0,222000,0,222000,222000
051461,聯詠國泰96購01  ,0,0,0,0,0,0,0,0,0,222000,0,0,0,242000,20000,222000,222000
051213,華新科統一95購01,0,0,0,0,0,0,0,0,0,222000,0,0,0,222000,0,222000,222000
053147,楠梓電元大98購01,0,0,0,0,0,0,0,0,0,222000,0,0,0,222000,0,222000,222000
052072,健策統一95購02  ,0,0,0,0,0,0,0,0,0,222000,0,0,0,269000,47000,222000,222000
05804P,美律永豐96售01  ,0,0,0,0,0,0,0,0,0,221000,0,0,0,221000,0,221000,221000
05656P,台表科統一96售01,0,0,0,0,0,0,0,0,0,221000,0,0,0,245000,24000,221000,221000
056089,同欣電統一98購01,0,0,0,0,0,0,0,0,0,221000,0,0,0,269000,48000,221000,221000
054829,亞光國泰99購01  ,0,0,0,0,0,0,0,0,0,221000,0,0,0,373000,152000,221000,221000
055292,聯鈞元大97購02  ,0,0,0,0,0,0,0,0,0,221000,0,0,0,342000,121000,221000,221000
047072,義隆兆豐94購01  ,0,0,0,0,0,0,0,0,0,221000,0,0,0,232000,11000,221000,221000
006207,FH滬深          ,266000,32000,234000,0,0,0,0,0,0,-13000,0,0,0,439000,452000,-13000,221000
054483,聯電台新96購01  ,0,0,0,0,0,0,0,0,0,221000,0,0,0,311000,90000,221000,221000
054531,聯發科國泰97購02,0,0,0,0,0,0,0,0,0,220000,0,0,0,230000,10000,220000,220000
056290,正文永豐98購01  ,0,0,0,0,0,0,0,0,0,220000,0,0,0,290000,70000,220000,220000
04980P,臺股指凱基96售08,0,0,0,0,0,0,0,0,0,220000,0,0,0,846000,626000,220000,220000
048773,貿聯凱基94購01  ,0,0,0,0,0,0,0,0,0,220000,0,0,0,250000,30000,220000,220000
048607,上銀凱基93購11  ,0,0,0,0,0,0,0,0,0,220000,0,0,0,230000,10000,220000,220000
050286,為升凱基94購05  ,0,0,0,0,0,0,0,0,0,220000,0,0,0,260000,40000,220000,220000
052053,泰鼎凱基96購01  ,0,0,0,0,0,0,0,0,0,220000,0,0,0,258000,38000,220000,220000
052455,樺漢元大96購03  ,0,0,0,0,0,0,0,0,0,220000,0,0,0,232000,12000,220000,220000
052614,聯電國泰97購01  ,0,0,0,0,0,0,0,0,0,220000,0,0,0,350000,130000,220000,220000
06042P,華新科永豐96售04,0,0,0,0,0,0,0,0,0,220000,0,0,0,220000,0,220000,220000
056593,台積電元富98購02,0,0,0,0,0,0,0,0,0,219000,0,0,0,381000,162000,219000,219000
054965,健策元大98購04  ,0,0,0,0,0,0,0,0,0,219000,0,0,0,310000,91000,219000,219000
052595,奇力新群益96購01,0,0,0,0,0,0,0,0,0,219000,0,0,0,219000,0,219000,219000
053776,台積電元大96購19,0,0,0,0,0,0,0,0,0,219000,0,0,0,230000,11000,219000,219000
05811P,臺股指國票96售04,0,0,0,0,0,0,0,0,0,218000,0,0,0,218000,0,218000,218000
050597,聯電麥證94購01  ,0,0,0,228000,10000,218000,0,0,0,218000,0,0,0,228000,10000,218000,218000
052172,致茂元大95購01  ,0,0,0,0,0,0,0,0,0,218000,0,0,0,218000,0,218000,218000
055125,智原兆豐97購01  ,0,0,0,0,0,0,0,0,0,217000,0,0,0,217000,0,217000,217000
055540,京鼎台新97購01  ,0,0,0,0,0,0,0,0,0,217000,0,0,0,293000,76000,217000,217000
048794,易華電元大97購01,0,0,0,0,0,0,0,0,0,217000,0,0,0,217000,0,217000,217000
052759,京元電群益96購01,0,0,0,0,0,0,0,0,0,217000,0,0,0,217000,0,217000,217000
053822,正文群益97購01  ,0,0,0,0,0,0,0,0,0,217000,0,0,0,227000,10000,217000,217000
054000,訊芯群益96購02  ,0,0,0,0,0,0,0,0,0,217000,0,0,0,246000,29000,217000,217000
045103,上海銀亞東94購01,0,0,0,0,0,0,0,0,0,216000,0,0,0,216000,0,216000,216000
052920,景碩台新96購02  ,0,0,0,0,0,0,0,0,0,216000,0,0,0,379000,163000,216000,216000
052085,聯電元大95購01  ,0,0,0,0,0,0,0,0,0,216000,0,0,0,223000,7000,216000,216000
054944,精元元大97購01  ,0,0,0,0,0,0,0,0,0,215000,0,0,0,246000,31000,215000,215000
047146,智邦群益93購01  ,0,0,0,0,0,0,0,0,0,215000,0,0,0,276000,61000,215000,215000
049724,南電第一94購01  ,0,0,0,0,0,0,0,0,0,215000,0,0,0,215000,0,215000,215000
050685,緯穎元富94購02  ,0,0,0,0,0,0,0,0,0,214000,0,0,0,454000,240000,214000,214000
052909,上銀統一96購01  ,0,0,0,0,0,0,0,0,0,214000,0,0,0,224000,10000,214000,214000
054354,技嘉富邦97購01  ,0,0,0,0,0,0,0,0,0,213000,0,0,0,273000,60000,213000,213000
053483,嘉澤第一96購01  ,0,0,0,0,0,0,0,0,0,213000,0,0,0,409000,196000,213000,213000
055579,健策統一9A購01  ,0,0,0,0,0,0,0,0,0,212000,0,0,0,617000,405000,212000,212000
055830,上銀元大97購07  ,0,0,0,0,0,0,0,0,0,212000,0,0,0,617000,405000,212000,212000
051185,強茂永豐95購03  ,0,0,0,0,0,0,0,0,0,212000,0,0,0,212000,0,212000,212000
048259,新日興統一93購01,0,0,0,0,0,0,0,0,0,212000,0,0,0,222000,10000,212000,212000
049867,日月光兆豐94購01,0,0,0,0,0,0,0,0,0,212000,0,0,0,232000,20000,212000,212000
052431,茂林永豐95購03  ,0,0,0,0,0,0,0,0,0,212000,0,0,0,212000,0,212000,212000
050395,大立光元富94購10,0,0,0,0,0,0,0,0,0,211000,0,0,0,211000,0,211000,211000
051564,和碩國泰96購01  ,0,0,0,0,0,0,0,0,0,211000,0,0,0,263000,52000,211000,211000
056320,京鼎群益99購01  ,0,0,0,0,0,0,0,0,0,210000,0,0,0,210000,0,210000,210000
049465,美律台新94購01  ,0,0,0,0,0,0,0,0,0,210000,0,0,0,210000,0,210000,210000
046871,美律元富93購01  ,0,0,0,0,0,0,0,0,0,210000,0,0,0,230000,20000,210000,210000
048465,南電台新93購01  ,0,0,0,0,0,0,0,0,0,210000,0,0,0,210000,0,210000,210000
052371,元金2X元大95購01,0,0,0,0,0,0,0,0,0,210000,0,0,0,220000,10000,210000,210000
052354,健策群益96購02  ,0,0,0,0,0,0,0,0,0,210000,0,0,0,359000,149000,210000,210000
05221P,玉晶光元大95售04,0,0,0,0,0,0,0,0,0,210000,0,0,0,230000,20000,210000,210000
052163,康舒永豐95購02  ,0,0,0,0,0,0,0,0,0,210000,0,0,0,278000,68000,210000,210000
053994,微星群益96購01  ,0,0,0,0,0,0,0,0,0,210000,0,0,0,240000,30000,210000,210000
053971,聯發科元大97購09,0,0,0,0,0,0,0,0,0,210000,0,0,0,210000,0,210000,210000
056394,晶豪科永豐98購01,0,0,0,0,0,0,0,0,0,209000,0,0,0,209000,0,209000,209000
056517,茂林兆豐99購01  ,0,0,0,0,0,0,0,0,0,209000,0,0,0,327000,118000,209000,209000
050585,矽格國票94購01  ,0,0,0,0,0,0,0,0,0,209000,0,0,0,219000,10000,209000,209000
051267,美律富邦96購01  ,0,0,0,0,0,0,0,0,0,209000,0,0,0,210000,1000,209000,209000
054355,上海銀富邦98購01,0,0,0,0,0,0,0,0,0,209000,0,0,0,210000,1000,209000,209000
052891,台泥群益96購01  ,0,0,0,0,0,0,0,0,0,209000,0,0,0,231000,22000,209000,209000
056376,玉晶光統一98購01,0,0,0,0,0,0,0,0,0,208000,0,0,0,528000,320000,208000,208000
055647,義隆元富97購01  ,0,0,0,0,0,0,0,0,0,208000,0,0,0,218000,10000,208000,208000
055741,健策元富97購01  ,0,0,0,0,0,0,0,0,0,208000,0,0,0,244000,36000,208000,208000
054593,滬深2X永昌9A購01,10000,0,10000,0,0,0,0,0,0,198000,0,0,0,200000,2000,198000,208000
053014,旺宏統一97購02  ,0,0,0,0,0,0,0,0,0,208000,0,0,0,268000,60000,208000,208000
052355,為升永豐95購02  ,0,0,0,0,0,0,0,0,0,208000,0,0,0,252000,44000,208000,208000
046028,微星元大92購01  ,0,0,0,0,0,0,0,0,0,207000,0,0,0,228000,21000,207000,207000
052088,漢唐元大95購02  ,0,0,0,0,0,0,0,0,0,207000,0,0,0,210000,3000,207000,207000
053045,國巨中信97購01  ,0,0,0,0,0,0,0,0,0,207000,0,0,0,317000,110000,207000,207000
05400P,台積電永豐95售05,0,0,0,0,0,0,0,0,0,207000,0,0,0,287000,80000,207000,207000
2456,奇力新          ,671000,485000,186000,0,0,0,40000,0,40000,-19000,46000,67000,-21000,49000,47000,2000,207000
9802,鈺齊-KY         ,479000,326000,153000,0,0,0,0,0,0,54000,2000,0,2000,64000,12000,52000,207000
05014P,臺股指元大95售05,0,0,0,0,0,0,0,0,0,206000,0,0,0,210000,4000,206000,206000
050879,樺漢統一95購02  ,0,0,0,0,0,0,0,0,0,206000,0,0,0,206000,0,206000,206000
048555,技嘉元大93購02  ,0,0,0,0,0,0,0,0,0,205000,0,0,0,209000,4000,205000,205000
050601,台表科國泰96購01,0,0,0,0,0,0,0,0,0,205000,0,0,0,297000,92000,205000,205000
054246,國巨元大96購12  ,0,0,0,0,0,0,0,0,0,205000,0,0,0,296000,91000,205000,205000
05703P,矽力群益96售03  ,0,0,0,0,0,0,0,0,0,204000,0,0,0,204000,0,204000,204000
045720,台光電凱基93購07,0,0,0,0,0,0,0,0,0,204000,0,0,0,204000,0,204000,204000
049866,景碩兆豐94購01  ,0,0,0,0,0,0,0,0,0,204000,0,0,0,237000,33000,204000,204000
051101,台表科元大96購02,0,0,0,0,0,0,0,0,0,204000,0,0,0,220000,16000,204000,204000
051243,微星元大95購01  ,0,0,0,0,0,0,0,0,0,204000,0,0,0,482000,278000,204000,204000
053513,義隆群益96購05  ,0,0,0,0,0,0,0,0,0,204000,0,0,0,450000,246000,204000,204000
055197,致新元富97購02  ,0,0,0,0,0,0,0,0,0,203000,0,0,0,213000,10000,203000,203000
047416,台泥富邦94購01  ,0,0,0,0,0,0,0,0,0,203000,0,0,0,399000,196000,203000,203000
053447,京鼎凱基96購03  ,0,0,0,0,0,0,0,0,0,203000,0,0,0,203000,0,203000,203000
055349,京元電凱基97購02,0,0,0,0,0,0,0,0,0,202000,0,0,0,242000,40000,202000,202000
047896,京元電群益93購01,0,0,0,0,0,0,0,0,0,202000,0,0,0,202000,0,202000,202000
048442,友訊凱基94購01  ,0,0,0,0,0,0,0,0,0,202000,0,0,0,205000,3000,202000,202000
050759,貿聯元富94購02  ,0,0,0,0,0,0,0,0,0,202000,0,0,0,393000,191000,202000,202000
048895,光罩國泰95購01  ,0,0,0,0,0,0,0,0,0,202000,0,0,0,252000,50000,202000,202000
053812,台積電群益96購09,0,0,0,0,0,0,0,0,0,202000,0,0,0,757000,555000,202000,202000
055717,聯發科元大97購19,0,0,0,0,0,0,0,0,0,201000,0,0,0,281000,80000,201000,201000
047839,景碩元大93購03  ,0,0,0,0,0,0,0,0,0,201000,0,0,0,255000,54000,201000,201000
050314,晶技兆豐94購01  ,0,0,0,0,0,0,0,0,0,201000,0,0,0,201000,0,201000,201000
050020,為升元大94購06  ,0,0,0,0,0,0,0,0,0,201000,0,0,0,201000,0,201000,201000
055146,華通元大98購04  ,0,0,0,0,0,0,0,0,0,200000,0,0,0,200000,0,200000,200000
055117,臻鼎凱基98購02  ,0,0,0,0,0,0,0,0,0,200000,0,0,0,200000,0,200000,200000
055025,華新科國泰98購02,0,0,0,0,0,0,0,0,0,200000,0,0,0,216000,16000,200000,200000
055030,帆宣國泰99購02  ,0,0,0,0,0,0,0,0,0,200000,0,0,0,295000,95000,200000,200000
056372,訊芯元大98購04  ,0,0,0,0,0,0,0,0,0,200000,0,0,0,200000,0,200000,200000
055833,華通元大98購05  ,0,0,0,0,0,0,0,0,0,200000,0,0,0,200000,0,200000,200000
047856,GIS國票94購01   ,0,0,0,0,0,0,0,0,0,200000,0,0,0,200000,0,200000,200000
050452,智原元大95購04  ,0,0,0,0,0,0,0,0,0,200000,0,0,0,200000,0,200000,200000
045790,瀚宇博元大92購01,0,0,0,0,0,0,0,0,0,200000,0,0,0,200000,0,200000,200000
047777,寶成元大93購01  ,0,0,0,0,0,0,0,0,0,200000,0,0,0,200000,0,200000,200000
043856,GIS富邦92購01   ,0,0,0,0,0,0,0,0,0,200000,0,0,0,200000,0,200000,200000
03267P,台灣50元大02售06,0,0,0,0,0,0,0,0,0,200000,0,0,0,300000,100000,200000,200000
050113,欣興元大95購05  ,0,0,0,0,0,0,0,0,0,200000,0,0,0,200000,0,200000,200000
050605,上証2X元大97購02,0,0,0,0,0,0,0,0,0,200000,0,0,0,200000,0,200000,200000
050574,微星國票94購01  ,0,0,0,0,0,0,0,0,0,200000,0,0,0,200000,0,200000,200000
050902,南電元大96購01  ,0,0,0,0,0,0,0,0,0,200000,0,0,0,200000,0,200000,200000
050945,致茂群益95購01  ,0,0,0,0,0,0,0,0,0,200000,0,0,0,200000,0,200000,200000
048614,欣興凱基93購05  ,0,0,0,0,0,0,0,0,0,200000,0,0,0,200000,0,200000,200000
050949,亞光群益96購01  ,0,0,0,0,0,0,0,0,0,200000,0,0,0,400000,200000,200000,200000
051162,楠梓電元大95購01,0,0,0,0,0,0,0,0,0,200000,0,0,0,200000,0,200000,200000
048691,智伸科群益94購01,0,0,0,0,0,0,0,0,0,200000,0,0,0,210000,10000,200000,200000
048779,美利達凱基94購01,0,0,0,0,0,0,0,0,0,200000,0,0,0,200000,0,200000,200000
049419,欣興凱基94購04  ,0,0,0,0,0,0,0,0,0,200000,0,0,0,200000,0,200000,200000
048234,美利達凱基93購03,0,0,0,0,0,0,0,0,0,200000,0,0,0,200000,0,200000,200000
053912,T50反1國票97購02,0,0,0,0,0,0,0,0,0,200000,0,0,0,300000,100000,200000,200000
05305P,華新科國泰97售01,0,0,0,0,0,0,0,0,0,200000,0,0,0,200000,0,200000,200000
052600,力山元大97購01  ,0,0,0,0,0,0,0,0,0,200000,0,0,0,200000,0,200000,200000
052524,新光金元大9B購01,0,0,0,0,0,0,0,0,0,200000,0,0,0,200000,0,200000,200000
051824,華通元大95購07  ,0,0,0,0,0,0,0,0,0,200000,0,0,0,200000,0,200000,200000
052360,FB上証國票96購01,0,0,0,0,0,0,0,0,0,200000,0,0,0,200000,0,200000,200000
05688P,臺股指元大96售13,0,0,0,0,0,0,0,0,0,199000,0,0,0,296000,97000,199000,199000
054559,台光電群益99購01,0,0,0,0,0,0,0,0,0,199000,0,0,0,210000,11000,199000,199000
046294,台勝科統一92購01,0,0,0,0,0,0,0,0,0,199000,0,0,0,199000,0,199000,199000
047083,大立光永豐93購01,0,0,0,0,0,0,0,0,0,199000,0,0,0,300000,101000,199000,199000
052341,泰鼎凱基96購02  ,0,0,0,0,0,0,0,0,0,199000,0,0,0,322000,123000,199000,199000
052619,茂林國泰99購01  ,0,0,0,0,0,0,0,0,0,199000,0,0,0,576000,377000,199000,199000
053057,聯電國泰97購02  ,0,0,0,0,0,0,0,0,0,199000,0,0,0,672000,473000,199000,199000
053095,台光電統一98購01,0,0,0,0,0,0,0,0,0,199000,0,0,0,199000,0,199000,199000
053154,聯詠元大96購01  ,0,0,0,0,0,0,0,0,0,199000,0,0,0,513000,314000,199000,199000
053637,強茂永豐96購01  ,0,0,0,0,0,0,0,0,0,199000,0,0,0,278000,79000,199000,199000
053373,台泥元大96購01  ,0,0,0,0,0,0,0,0,0,199000,0,0,0,299000,100000,199000,199000
05573P,仁寶元富96售02  ,0,0,0,0,0,0,0,0,0,198000,0,0,0,205000,7000,198000,198000
055574,美律統一97購01  ,0,0,0,0,0,0,0,0,0,198000,0,0,0,198000,0,198000,198000
045516,聯茂統一94購01  ,0,0,0,0,0,0,0,0,0,198000,0,0,0,198000,0,198000,198000
045626,上銀凱基93購05  ,0,0,0,0,0,0,0,0,0,198000,0,0,0,208000,10000,198000,198000
04796P,聯發科元大94售10,0,0,0,0,0,0,0,0,0,198000,0,0,0,254000,56000,198000,198000
049034,台達電兆豐94購01,0,0,0,0,0,0,0,0,0,198000,0,0,0,208000,10000,198000,198000
049045,上海銀兆豐94購01,0,0,0,0,0,0,0,0,0,198000,0,0,0,198000,0,198000,198000
049880,健策永豐94購02  ,0,0,0,0,0,0,0,0,0,198000,0,0,0,315000,117000,198000,198000
051916,和碩元大95購02  ,0,0,0,0,0,0,0,0,0,198000,0,0,0,374000,176000,198000,198000
055338,GIS兆豐97購01   ,0,0,0,0,0,0,0,0,0,197000,0,0,0,197000,0,197000,197000
04373P,滬深2X元大97售01,0,0,0,0,0,0,0,0,0,197000,0,0,0,727000,530000,197000,197000
044408,聯茂凱基93購02  ,0,0,0,0,0,0,0,0,0,197000,0,0,0,442000,245000,197000,197000
051562,玉晶光國泰97購05,0,0,0,0,0,0,0,0,0,197000,0,0,0,206000,9000,197000,197000
053668,鴻海統一97購01  ,0,0,0,0,0,0,0,0,0,197000,0,0,0,274000,77000,197000,197000
054970,帆宣元大97購01  ,0,0,0,0,0,0,0,0,0,196000,0,0,0,278000,82000,196000,196000
055925,上銀群益97購01  ,0,0,0,0,0,0,0,0,0,196000,0,0,0,416000,220000,196000,196000
052184,台光電群益95購03,0,0,0,0,0,0,0,0,0,196000,0,0,0,207000,11000,196000,196000
052672,世紀鋼群益96購02,0,0,0,0,0,0,0,0,0,196000,0,0,0,196000,0,196000,196000
054985,光罩元富97購01  ,0,0,0,0,0,0,0,0,0,195000,0,0,0,195000,0,195000,195000
04571P,華新科國泰95售03,0,0,0,0,0,0,0,0,0,195000,0,0,0,205000,10000,195000,195000
04717P,和大凱基94售02  ,0,0,0,0,0,0,0,0,0,195000,0,0,0,200000,5000,195000,195000
052142,滬深2X群益99購04,0,0,0,0,0,0,0,0,0,195000,0,0,0,197000,2000,195000,195000
052392,台表科群益96購02,0,0,0,0,0,0,0,0,0,195000,0,0,0,200000,5000,195000,195000
05197P,智原永豐95售02  ,0,0,0,0,0,0,0,0,0,195000,0,0,0,285000,90000,195000,195000
053562,玉晶光國泰98購02,0,0,0,0,0,0,0,0,0,195000,0,0,0,231000,36000,195000,195000
053821,群創群益98購08  ,0,0,0,0,0,0,0,0,0,195000,0,0,0,195000,0,195000,195000
056688,聯詠統一98購01  ,0,0,0,0,0,0,0,0,0,194000,0,0,0,200000,6000,194000,194000
05163P,聯發科統一96售02,1000,0,1000,0,0,0,0,0,0,193000,0,0,0,228000,35000,193000,194000
053456,大立光元富96購04,0,0,0,0,0,0,0,0,0,194000,0,0,0,205000,11000,194000,194000
056515,燿華兆豐99購01  ,0,0,0,0,0,0,0,0,0,193000,0,0,0,203000,10000,193000,193000
055952,上銀元大97購08  ,0,0,0,0,0,0,0,0,0,193000,0,0,0,442000,249000,193000,193000
056396,祥碩永豐98購01  ,0,0,0,0,0,0,0,0,0,193000,0,0,0,219000,26000,193000,193000
054649,聯茂群益97購01  ,0,0,0,0,0,0,0,0,0,193000,0,0,0,193000,0,193000,193000
048942,上緯控永豐94購01,0,0,0,0,0,0,0,0,0,193000,0,0,0,193000,0,193000,193000
053322,京鼎群益97購01  ,0,0,0,0,0,0,0,0,0,193000,0,0,0,235000,42000,193000,193000
052162,智伸科永豐95購01,0,0,0,0,0,0,0,0,0,193000,0,0,0,193000,0,193000,193000
055432,臻鼎群益97購02  ,0,0,0,0,0,0,0,0,0,192000,0,0,0,202000,10000,192000,192000
055837,致茂元大97購02  ,0,0,0,0,0,0,0,0,0,192000,0,0,0,192000,0,192000,192000
04760P,旺宏凱基94售02  ,0,0,0,0,0,0,0,0,0,192000,0,0,0,259000,67000,192000,192000
050756,京元電元富94購03,0,0,0,0,0,0,0,0,0,192000,0,0,0,192000,0,192000,192000
05267P,欣興元大95售08  ,0,0,0,0,0,0,0,0,0,192000,0,0,0,210000,18000,192000,192000
052708,楠梓電永豐97購01,0,0,0,0,0,0,0,0,0,192000,0,0,0,192000,0,192000,192000
053785,聯詠元大96購05  ,0,0,0,0,0,0,0,0,0,192000,0,0,0,271000,79000,192000,192000
056291,聯茂永豐97購03  ,0,0,0,0,0,0,0,0,0,191000,0,0,0,259000,68000,191000,191000
051128,台表科群益95購02,0,0,0,0,0,0,0,0,0,191000,0,0,0,395000,204000,191000,191000
049733,旺宏群益94購03  ,0,0,0,0,0,0,0,0,0,191000,0,0,0,277000,86000,191000,191000
049761,亞德客國泰95購03,0,0,0,0,0,0,0,0,0,191000,0,0,0,256000,65000,191000,191000
051700,深中小群益99購04,0,0,0,0,0,0,0,0,0,191000,0,0,0,493000,302000,191000,191000
056107,智易永豐97購02  ,0,0,0,0,0,0,0,0,0,190000,0,0,0,190000,0,190000,190000
056457,嘉澤凱基98購01  ,0,0,0,0,0,0,0,0,0,190000,0,0,0,316000,126000,190000,190000
047504,滬深2X國票9A購01,0,0,0,0,0,0,0,0,0,190000,0,0,0,210000,20000,190000,190000
04991P,台表科元大94售05,0,0,0,0,0,0,0,0,0,190000,0,0,0,190000,0,190000,190000
04875P,台積電中信94售04,0,0,0,0,0,0,0,0,0,190000,0,0,0,190000,0,190000,190000
049427,瑞昱兆豐94購01  ,0,0,0,0,0,0,0,0,0,190000,0,0,0,191000,1000,190000,190000
053258,上証2X群益9A購03,0,0,0,0,0,0,0,0,0,190000,0,0,0,190000,0,190000,190000
053862,南亞科元大97購02,0,0,0,0,0,0,0,0,0,190000,0,0,0,450000,260000,190000,190000
054288,華邦電元大96購05,0,0,0,0,0,0,0,0,0,190000,0,0,0,198000,8000,190000,190000
054377,臺股指中信99購09,0,0,0,0,0,0,0,0,0,190000,0,0,0,324000,134000,190000,190000
052509,鴻海凱基96購10  ,0,0,0,0,0,0,0,0,0,190000,0,0,0,190000,0,190000,190000
06030P,友達兆豐96售02  ,0,0,0,0,0,0,0,0,0,190000,0,0,0,220000,30000,190000,190000
055055,精元永豐97購01  ,0,0,0,0,0,0,0,0,0,189000,0,0,0,192000,3000,189000,189000
047219,美律麥證94購01  ,0,0,0,615000,261000,354000,0,0,0,189000,0,0,0,706000,517000,189000,189000
049655,臺股指凱基94購16,0,0,0,0,0,0,0,0,0,189000,0,0,0,189000,0,189000,189000
049020,可成群益94購02  ,0,0,0,0,0,0,0,0,0,189000,0,0,0,199000,10000,189000,189000
053068,智伸科群益96購01,0,0,0,0,0,0,0,0,0,189000,0,0,0,202000,13000,189000,189000
053472,漢唐元大96購02  ,0,0,0,0,0,0,0,0,0,189000,0,0,0,277000,88000,189000,189000
053570,京元電統一96購01,0,0,0,0,0,0,0,0,0,189000,0,0,0,189000,0,189000,189000
8131,福懋科          ,265000,111000,154000,0,0,0,1000,0,1000,34000,0,0,0,38000,4000,34000,189000
055372,宏達電元大97購04,0,0,0,0,0,0,0,0,0,188000,0,0,0,198000,10000,188000,188000
054262,瀚宇博元大96購03,0,0,0,0,0,0,0,0,0,188000,0,0,0,213000,25000,188000,188000
052482,茂林群益95購01  ,0,0,0,0,0,0,0,0,0,188000,0,0,0,192000,4000,188000,188000
052059,臺股指凱基95購17,0,0,0,0,0,0,0,0,0,188000,0,0,0,188000,0,188000,188000
054667,神基元富97購01  ,0,0,0,0,0,0,0,0,0,187000,0,0,0,214000,27000,187000,187000
046356,智伸科群益93購01,0,0,0,0,0,0,0,0,0,187000,0,0,0,197000,10000,187000,187000
05170P,世芯元大95售01  ,0,0,0,0,0,0,0,0,0,187000,0,0,0,751000,564000,187000,187000
049991,臺股指凱基96購04,0,0,0,0,0,0,0,0,0,187000,0,0,0,188000,1000,187000,187000
055009,合勤控元富97購01,0,0,0,0,0,0,0,0,0,186000,0,0,0,196000,10000,186000,186000
051058,景碩群益96購01  ,0,0,0,0,0,0,0,0,0,186000,0,0,0,211000,25000,186000,186000
050915,健策中信98購01  ,0,0,0,0,0,0,0,0,0,186000,0,0,0,202000,16000,186000,186000
053773,上銀元大96購04  ,0,0,0,0,0,0,0,0,0,186000,0,0,0,254000,68000,186000,186000
6504,南六            ,315000,261000,54000,0,0,0,0,0,0,132000,154000,0,154000,0,22000,-22000,186000
055722,聯鈞元大97購03  ,0,0,0,0,0,0,0,0,0,185000,0,0,0,225000,40000,185000,185000
050383,超眾兆豐95購01  ,0,0,0,0,0,0,0,0,0,185000,0,0,0,185000,0,185000,185000
050970,康舒永豐95購01  ,0,0,0,0,0,0,0,0,0,185000,0,0,0,253000,68000,185000,185000
049695,新光金元大9A購01,0,0,0,0,0,0,0,0,0,185000,0,0,0,300000,115000,185000,185000
049404,訊芯群益94購02  ,0,0,0,0,0,0,0,0,0,185000,0,0,0,195000,10000,185000,185000
048373,A50正2元富95購01,0,0,0,0,0,0,0,0,0,185000,0,0,0,186000,1000,185000,185000
049913,微星元大94購01  ,0,0,0,0,0,0,0,0,0,185000,0,0,0,344000,159000,185000,185000
054267,上銀第一96購01  ,0,0,0,0,0,0,0,0,0,185000,0,0,0,185000,0,185000,185000
05825P,臺股指凱基96售22,0,0,0,0,0,0,0,0,0,184000,0,0,0,189000,5000,184000,184000
051420,康控國票95購05  ,0,0,0,0,0,0,0,0,0,184000,0,0,0,184000,0,184000,184000
051240,台積電元大95購12,0,0,0,0,0,0,0,0,0,184000,0,0,0,514000,330000,184000,184000
052130,國巨凱基9B購01  ,0,0,0,0,0,0,0,0,0,184000,0,0,0,213000,29000,184000,184000
047010,聯詠統一93購05  ,0,0,0,0,0,0,0,0,0,183000,0,0,0,235000,52000,183000,183000
048864,昇陽半群益94購01,0,0,0,0,0,0,0,0,0,183000,0,0,0,183000,0,183000,183000
052145,京元電群益95購02,0,0,0,0,0,0,0,0,0,183000,0,0,0,183000,0,183000,183000
052177,京鼎元大95購02  ,0,0,0,0,0,0,0,0,0,183000,0,0,0,495000,312000,183000,183000
053806,鎧勝凱基96購02  ,0,0,0,0,0,0,0,0,0,183000,0,0,0,260000,77000,183000,183000
1905,華紙            ,569000,385000,184000,0,0,0,0,0,0,-1000,0,1000,-1000,0,0,0,183000
052094,瀚宇博元大96購02,0,0,0,0,0,0,0,0,0,182000,0,0,0,182000,0,182000,182000
056331,聯鈞國票99購01  ,0,0,0,0,0,0,0,0,0,181000,0,0,0,191000,10000,181000,181000
052764,景碩群益98購01  ,0,0,0,0,0,0,0,0,0,181000,0,0,0,325000,144000,181000,181000
053534,微星永豐96購02  ,0,0,0,0,0,0,0,0,0,181000,0,0,0,310000,129000,181000,181000
3515,華擎            ,894000,486000,408000,0,0,0,10000,46000,-36000,-191000,10000,7000,3000,78000,272000,-194000,181000
055276,台積電元大97購20,0,0,0,0,0,0,0,0,0,180000,0,0,0,200000,20000,180000,180000
055249,大毅統一99購01  ,0,0,0,0,0,0,0,0,0,180000,0,0,0,568000,388000,180000,180000
054612,慧洋永豐97購01  ,0,0,0,0,0,0,0,0,0,180000,0,0,0,180000,0,180000,180000
054576,健策元大98購03  ,0,0,0,0,0,0,0,0,0,180000,0,0,0,330000,150000,180000,180000
049500,聯茂元大94購04  ,0,0,0,0,0,0,0,0,0,180000,0,0,0,180000,0,180000,180000
053894,創意群益96購01  ,0,0,0,0,0,0,0,0,0,180000,0,0,0,222000,42000,180000,180000
051907,台積電元大97購05,0,0,0,0,0,0,0,0,0,180000,0,0,0,297000,117000,180000,180000
06097P,茂林永豐97售01  ,0,0,0,0,0,0,0,0,0,180000,0,0,0,180000,0,180000,180000
055386,致新元大97購02  ,0,0,0,0,0,0,0,0,0,179000,0,0,0,347000,168000,179000,179000
056403,茂林群益98購01  ,0,0,0,0,0,0,0,0,0,179000,0,0,0,224000,45000,179000,179000
055799,致茂永豐97購02  ,0,0,0,0,0,0,0,0,0,179000,0,0,0,247000,68000,179000,179000
05823P,臺股指凱基96售20,0,0,0,0,0,0,0,0,0,179000,0,0,0,259000,80000,179000,179000
05858P,矽力中信96售01  ,0,0,0,0,0,0,0,0,0,179000,0,0,0,199000,20000,179000,179000
051223,台化群益95購01  ,0,0,0,0,0,0,0,0,0,179000,0,0,0,179000,0,179000,179000
052602,聯電元大97購01  ,0,0,0,0,0,0,0,0,0,179000,0,0,0,194000,15000,179000,179000
06301P,臺股指元大97售04,0,0,0,0,0,0,0,0,0,179000,0,0,0,267000,88000,179000,179000
054508,臺股指永豐96購04,0,0,0,0,0,0,0,0,0,178000,0,0,0,188000,10000,178000,178000
050729,聯鈞國票94購01  ,0,0,0,0,0,0,0,0,0,178000,0,0,0,211000,33000,178000,178000
052648,茂林永豐96購01  ,0,0,0,0,0,0,0,0,0,178000,0,0,0,202000,24000,178000,178000
054364,智伸科凱基96購01,0,0,0,0,0,0,0,0,0,178000,0,0,0,308000,130000,178000,178000
053368,京元電富邦98購01,0,0,0,0,0,0,0,0,0,178000,0,0,0,178000,0,178000,178000
054797,臻鼎群益97購01  ,0,0,0,0,0,0,0,0,0,177000,0,0,0,207000,30000,177000,177000
047782,燿華國泰95購01  ,0,0,0,0,0,0,0,0,0,177000,0,0,0,177000,0,177000,177000
055183,聯鈞統一97購01  ,0,0,0,0,0,0,0,0,0,176000,0,0,0,244000,68000,176000,176000
055653,聯詠元富01購02  ,0,0,0,0,0,0,0,0,0,176000,0,0,0,210000,34000,176000,176000
055661,亞德客中信98購01,0,0,0,0,0,0,0,0,0,176000,0,0,0,245000,69000,176000,176000
056079,世紀鋼元大97購02,0,0,0,0,0,0,0,0,0,176000,0,0,0,199000,23000,176000,176000
047767,聯發科元大93購20,0,0,0,0,0,0,0,0,0,176000,0,0,0,204000,28000,176000,176000
050522,聯發科元大95購03,0,0,0,0,0,0,0,0,0,176000,0,0,0,487000,311000,176000,176000
048031,全新凱基93購02  ,0,0,0,0,0,0,0,0,0,176000,0,0,0,176000,0,176000,176000
053583,漢唐元大96購03  ,0,0,0,0,0,0,0,0,0,176000,0,0,0,176000,0,176000,176000
056073,智伸科元大97購01,0,0,0,0,0,0,0,0,0,175000,0,0,0,225000,50000,175000,175000
056120,聯茂群益97購02  ,0,0,0,0,0,0,0,0,0,175000,0,0,0,175000,0,175000,175000
056018,旺宏群益97購02  ,0,0,0,0,0,0,0,0,0,175000,0,0,0,178000,3000,175000,175000
055554,聯發科凱基97購06,0,0,0,0,0,0,0,0,0,175000,0,0,0,192000,17000,175000,175000
054723,鴻海日盛97購01  ,0,0,0,0,0,0,0,0,0,175000,0,0,0,200000,25000,175000,175000
051623,和碩凱基96購02  ,0,0,0,0,0,0,0,0,0,175000,0,0,0,181000,6000,175000,175000
053377,台積電元大98購01,0,0,0,0,0,0,0,0,0,175000,0,0,0,659000,484000,175000,175000
052754,上証2X群益9A購01,0,0,0,0,0,0,0,0,0,175000,0,0,0,177000,2000,175000,175000
055704,亞德客永豐97購04,0,0,0,0,0,0,0,0,0,174000,0,0,0,235000,61000,174000,174000
050677,光寶科統一94購01,0,0,0,0,0,0,0,0,0,174000,0,0,0,174000,0,174000,174000
03421B,臺股指元大99熊01,0,0,0,0,0,0,0,0,0,174000,0,0,0,199000,25000,174000,174000
053163,上証2X群益9A購02,0,0,0,0,0,0,0,0,0,174000,0,0,0,199000,25000,174000,174000
054052,日月光元大96購06,0,0,0,0,0,0,0,0,0,174000,0,0,0,199000,25000,174000,174000
055654,景碩元富97購01  ,0,0,0,0,0,0,0,0,0,173000,0,0,0,270000,97000,173000,173000
055021,亞德客國泰98購01,0,0,0,0,0,0,0,0,0,173000,0,0,0,226000,53000,173000,173000
050175,台光電元大94購08,0,0,0,0,0,0,0,0,0,173000,0,0,0,173000,0,173000,173000
054214,京鼎國票97購02  ,0,0,0,0,0,0,0,0,0,173000,0,0,0,173000,0,173000,173000
2385,群光            ,809000,792000,17000,0,0,0,136000,0,136000,20000,3000,3000,0,28000,8000,20000,173000
056488,致新元大99購01  ,0,0,0,0,0,0,0,0,0,172000,0,0,0,202000,30000,172000,172000
049259,聯發科元大94購04,0,0,0,0,0,0,0,0,0,172000,0,0,0,532000,360000,172000,172000
055996,矽力國泰99購01  ,0,0,0,0,0,0,0,0,0,171000,0,0,0,302000,131000,171000,171000
054545,奇力新中信98購01,0,0,0,0,0,0,0,0,0,171000,0,0,0,258000,87000,171000,171000
055221,矽創凱基97購02  ,0,0,0,0,0,0,0,0,0,171000,0,0,0,260000,89000,171000,171000
055434,樺漢群益97購01  ,0,0,0,0,0,0,0,0,0,171000,0,0,0,213000,42000,171000,171000
047673,瑞昱元富96購01  ,0,0,0,0,0,0,0,0,0,171000,0,0,0,309000,138000,171000,171000
048936,玉晶光永豐94購05,0,0,0,0,0,0,0,0,0,171000,0,0,0,201000,30000,171000,171000
052817,楠梓電永豐96購02,0,0,0,0,0,0,0,0,0,171000,0,0,0,171000,0,171000,171000
052830,台光電群益96購01,0,0,0,0,0,0,0,0,0,171000,0,0,0,267000,96000,171000,171000
06316P,臺股指元富97售03,0,0,0,0,0,0,0,0,0,171000,0,0,0,171000,0,171000,171000
056405,聯茂群益98購01  ,0,0,0,0,0,0,0,0,0,170000,0,0,0,170000,0,170000,170000
050717,京鼎群益96購01  ,0,0,0,0,0,0,0,0,0,170000,0,0,0,172000,2000,170000,170000
051594,和碩元大96購01  ,0,0,0,0,0,0,0,0,0,170000,0,0,0,233000,63000,170000,170000
048189,臺指反元大96購06,0,0,0,0,0,0,0,0,0,170000,0,0,0,171000,1000,170000,170000
053942,超眾國泰96購02  ,0,0,0,0,0,0,0,0,0,170000,0,0,0,180000,10000,170000,170000
056462,訊芯凱基98購03  ,0,0,0,0,0,0,0,0,0,169000,0,0,0,209000,40000,169000,169000
049452,新光金統一94購02,0,0,0,0,0,0,0,0,0,169000,0,0,0,169000,0,169000,169000
050526,貿聯元大95購01  ,0,0,0,0,0,0,0,0,0,169000,0,0,0,449000,280000,169000,169000
052576,聯茂凱基96購01  ,0,0,0,0,0,0,0,0,0,169000,0,0,0,169000,0,169000,169000
052450,嘉澤元大95購03  ,0,0,0,0,0,0,0,0,0,169000,0,0,0,553000,384000,169000,169000
056137,聯鈞元大9A購01  ,0,0,0,0,0,0,0,0,0,168000,0,0,0,198000,30000,168000,168000
056042,京鼎凱基97購02  ,0,0,0,0,0,0,0,0,0,168000,0,0,0,200000,32000,168000,168000
055723,康控元大97購04  ,0,0,0,0,0,0,0,0,0,168000,0,0,0,171000,3000,168000,168000
054580,樺漢元大98購01  ,0,0,0,0,0,0,0,0,0,168000,0,0,0,218000,50000,168000,168000
047590,健策永豐93購01  ,0,0,0,0,0,0,0,0,0,168000,0,0,0,168000,0,168000,168000
053866,景碩元大97購02  ,0,0,0,0,0,0,0,0,0,168000,0,0,0,193000,25000,168000,168000
054120,奇力新永豐96購01,0,0,0,0,0,0,0,0,0,168000,0,0,0,168000,0,168000,168000
053843,訊芯統一96購01  ,0,0,0,0,0,0,0,0,0,168000,0,0,0,168000,0,168000,168000
054614,玉晶光永豐97購03,0,0,0,0,0,0,0,0,0,167000,0,0,0,269000,102000,167000,167000
03831P,臺股指中信95售02,0,0,0,0,0,0,0,0,0,167000,0,0,0,167000,0,167000,167000
046630,京元電元富95購03,0,0,0,0,0,0,0,0,0,167000,0,0,0,237000,70000,167000,167000
049596,智伸科元大95購01,0,0,0,0,0,0,0,0,0,167000,0,0,0,172000,5000,167000,167000
053399,創意中信96購01  ,0,0,0,0,0,0,0,0,0,167000,0,0,0,188000,21000,167000,167000
054034,景碩中信96購01  ,0,0,0,0,0,0,0,0,0,167000,0,0,0,194000,27000,167000,167000
054312,TPK凱基98購01   ,0,0,0,0,0,0,0,0,0,167000,0,0,0,167000,0,167000,167000
054641,祥碩中信98購01  ,0,0,0,0,0,0,0,0,0,166000,0,0,0,238000,72000,166000,166000
056007,上銀中信97購02  ,0,0,0,0,0,0,0,0,0,166000,0,0,0,323000,157000,166000,166000
048305,深100凱基96購01 ,0,0,0,0,0,0,0,0,0,166000,0,0,0,176000,10000,166000,166000
048045,上銀永豐93購02  ,0,0,0,0,0,0,0,0,0,166000,0,0,0,349000,183000,166000,166000
054347,上緯控國票96購02,0,0,0,0,0,0,0,0,0,166000,0,0,0,166000,0,166000,166000
055979,聯鈞統一97購03  ,0,0,0,0,0,0,0,0,0,165000,0,0,0,167000,2000,165000,165000
056582,易華電元大98購01,0,0,0,0,0,0,0,0,0,165000,0,0,0,395000,230000,165000,165000
048778,聯茂凱基94購04  ,0,0,0,0,0,0,0,0,0,165000,0,0,0,165000,0,165000,165000
050324,訊芯台新94購01  ,0,0,0,0,0,0,0,0,0,165000,0,0,0,165000,0,165000,165000
052492,易華電國票96購02,0,0,0,0,0,0,0,0,0,165000,0,0,0,165000,0,165000,165000
052028,健策群益95購02  ,0,0,0,0,0,0,0,0,0,165000,0,0,0,245000,80000,165000,165000
06129P,玉晶光元富97售06,0,0,0,0,0,0,0,0,0,165000,0,0,0,211000,46000,165000,165000
2903,遠百            ,697000,528000,169000,0,0,0,0,0,0,-4000,0,4000,-4000,0,0,0,165000
054960,新日興元大97購02,0,0,0,0,0,0,0,0,0,164000,0,0,0,304000,140000,164000,164000
054849,日月光兆豐97購01,0,0,0,0,0,0,0,0,0,164000,0,0,0,164000,0,164000,164000
054907,帆宣康和97購01  ,0,0,0,0,0,0,0,0,0,164000,0,0,0,164000,0,164000,164000
055367,台積電元大97購23,0,0,0,0,0,0,0,0,0,164000,0,0,0,219000,55000,164000,164000
045854,貿聯富邦93購01  ,0,0,0,0,0,0,0,0,0,164000,0,0,0,210000,46000,164000,164000
051596,超眾元大95購05  ,0,0,0,0,0,0,0,0,0,164000,0,0,0,307000,143000,164000,164000
048114,景碩群益93購02  ,0,0,0,0,0,0,0,0,0,164000,0,0,0,186000,22000,164000,164000
050494,可成永昌96購01  ,0,0,0,0,0,0,0,0,0,164000,0,0,0,226000,62000,164000,164000
052305,GIS永豐95購03   ,0,0,0,0,0,0,0,0,0,164000,0,0,0,168000,4000,164000,164000
052246,超眾康和95購01  ,0,0,0,0,0,0,0,0,0,164000,0,0,0,164000,0,164000,164000
055311,健策群益98購02  ,0,0,0,0,0,0,0,0,0,163000,0,0,0,310000,147000,163000,163000
055503,健策元大98購05  ,0,0,0,0,0,0,0,0,0,163000,0,0,0,520000,357000,163000,163000
054573,漢唐元大98購01  ,0,0,0,0,0,0,0,0,0,163000,0,0,0,304000,141000,163000,163000
05699P,茂林凱基96售05  ,0,0,0,0,0,0,0,0,0,163000,0,0,0,168000,5000,163000,163000
049426,為升兆豐95購01  ,0,0,0,0,0,0,0,0,0,163000,0,0,0,198000,35000,163000,163000
052457,日月光元富95購01,0,0,0,0,0,0,0,0,0,163000,0,0,0,220000,57000,163000,163000
052685,技嘉元大96購01  ,0,0,0,0,0,0,0,0,0,163000,0,0,0,225000,62000,163000,163000
054134,強茂元大96購01  ,0,0,0,0,0,0,0,0,0,163000,0,0,0,417000,254000,163000,163000
055966,茂林元大99購01  ,0,0,0,0,0,0,0,0,0,162000,0,0,0,210000,48000,162000,162000
055234,昇陽半國票98購02,0,0,0,0,0,0,0,0,0,162000,0,0,0,182000,20000,162000,162000
046020,滬深2X元大95購02,0,0,0,0,0,0,0,0,0,162000,0,0,0,162000,0,162000,162000
050671,超眾永豐94購04  ,0,0,0,0,0,0,0,0,0,162000,0,0,0,202000,40000,162000,162000
04189P,台積電兆豐94售02,0,0,0,0,0,0,0,0,0,162000,0,0,0,162000,0,162000,162000
048935,玉晶光永豐94購04,0,0,0,0,0,0,0,0,0,162000,0,0,0,212000,50000,162000,162000
051532,潤泰全國票96購01,0,0,0,0,0,0,0,0,0,162000,0,0,0,162000,0,162000,162000
052725,為升元富96購01  ,0,0,0,0,0,0,0,0,0,162000,0,0,0,162000,0,162000,162000
055524,鴻海群益98購01  ,0,0,0,0,0,0,0,0,0,161000,0,0,0,161000,0,161000,161000
056602,嘉澤國泰99購01  ,0,0,0,0,0,0,0,0,0,161000,0,0,0,270000,109000,161000,161000
046499,技嘉元大92購02  ,0,0,0,0,0,0,0,0,0,161000,0,0,0,171000,10000,161000,161000
048547,訊芯永豐93購03  ,0,0,0,0,0,0,0,0,0,161000,0,0,0,161000,0,161000,161000
045447,鴻海國泰94購02  ,0,0,0,0,0,0,0,0,0,161000,0,0,0,221000,60000,161000,161000
049972,南電國票95購02  ,0,0,0,0,0,0,0,0,0,161000,0,0,0,161000,0,161000,161000
048197,義隆元大93購04  ,0,0,0,0,0,0,0,0,0,161000,0,0,0,301000,140000,161000,161000
048786,瑞昱元大94購02  ,0,0,0,0,0,0,0,0,0,161000,0,0,0,223000,62000,161000,161000
053170,茂林群益96購04  ,0,0,0,0,0,0,0,0,0,161000,0,0,0,173000,12000,161000,161000
053070,訊芯群益96購01  ,0,0,0,0,0,0,0,0,0,161000,0,0,0,172000,11000,161000,161000
055806,致新永豐97購02  ,0,0,0,0,0,0,0,0,0,160000,0,0,0,211000,51000,160000,160000
056142,超眾元大97購06  ,0,0,0,0,0,0,0,0,0,160000,0,0,0,170000,10000,160000,160000
055601,茂林元大97購03  ,0,0,0,0,0,0,0,0,0,160000,0,0,0,163000,3000,160000,160000
054603,智易台新98購01  ,0,0,0,0,0,0,0,0,0,160000,0,0,0,160000,0,160000,160000
046602,新日興群益94購01,0,0,0,0,0,0,0,0,0,160000,0,0,0,184000,24000,160000,160000
04378P,大立光元大94售05,0,0,0,0,0,0,0,0,0,160000,0,0,0,175000,15000,160000,160000
044119,台郡兆豐92購01  ,0,0,0,0,0,0,0,0,0,160000,0,0,0,180000,20000,160000,160000
048878,康控國票95購02  ,0,0,0,0,0,0,0,0,0,160000,0,0,0,210000,50000,160000,160000
051369,新光金富邦9A購01,0,0,0,0,0,0,0,0,0,160000,0,0,0,160000,0,160000,160000
054333,茂林永豐96購03  ,0,0,0,0,0,0,0,0,0,160000,0,0,0,203000,43000,160000,160000
053701,台積電兆豐96購05,0,0,0,0,0,0,0,0,0,160000,0,0,0,176000,16000,160000,160000
053658,亞光凱基96購01  ,0,0,0,0,0,0,0,0,0,160000,0,0,0,174000,14000,160000,160000
056263,友訊統一99購01  ,0,0,0,0,0,0,0,0,0,159000,0,0,0,179000,20000,159000,159000
056000,佳世達永豐97購01,0,0,0,0,0,0,0,0,0,159000,0,0,0,159000,0,159000,159000
053561,玉晶光國泰98購01,0,0,0,0,0,0,0,0,0,159000,0,0,0,159000,0,159000,159000
052535,日月光國泰96購01,0,0,0,0,0,0,0,0,0,159000,0,0,0,195000,36000,159000,159000
054517,高鐵元大96購01  ,0,0,0,0,0,0,0,0,0,158000,0,0,0,166000,8000,158000,158000
055744,茂林元富97購02  ,0,0,0,0,0,0,0,0,0,158000,0,0,0,277000,119000,158000,158000
039212,台達電台新9A購01,0,0,0,0,0,0,0,0,0,158000,0,0,0,169000,11000,158000,158000
050678,美律統一94購04  ,0,0,0,0,0,0,0,0,0,158000,0,0,0,158000,0,158000,158000
051088,台積電元大95購09,0,0,0,0,0,0,0,0,0,158000,0,0,0,377000,219000,158000,158000
054323,旺宏台新96購02  ,0,0,0,0,0,0,0,0,0,158000,0,0,0,168000,10000,158000,158000
055857,嘉聯益元大97購04,0,0,0,0,0,0,0,0,0,157000,0,0,0,357000,200000,157000,157000
048556,技嘉元大93購03  ,0,0,0,0,0,0,0,0,0,157000,0,0,0,160000,3000,157000,157000
048506,華通群益94購03  ,0,0,0,0,0,0,0,0,0,157000,0,0,0,157000,0,157000,157000
046981,智伸科兆豐94購01,0,0,0,0,0,0,0,0,0,157000,0,0,0,167000,10000,157000,157000
046703,瑞昱元富95購01  ,0,0,0,0,0,0,0,0,0,157000,0,0,0,240000,83000,157000,157000
044764,聯茂凱基93購03  ,0,0,0,0,0,0,0,0,0,157000,0,0,0,157000,0,157000,157000
053746,彰銀康和96購01  ,0,0,0,0,0,0,0,0,0,157000,0,0,0,157000,0,157000,157000
052317,台積電元大96購11,0,0,0,0,0,0,0,0,0,157000,0,0,0,235000,78000,157000,157000
046626,台光電統一94購01,0,0,0,0,0,0,0,0,0,156000,0,0,0,156000,0,156000,156000
046672,聯茂元大93購01  ,0,0,0,0,0,0,0,0,0,156000,0,0,0,156000,0,156000,156000
047395,聯茂元大94購01  ,0,0,0,0,0,0,0,0,0,156000,0,0,0,175000,19000,156000,156000
050101,台積電永昌96購03,0,0,0,0,0,0,0,0,0,156000,0,0,0,251000,95000,156000,156000
052167,亞泥元大96購01  ,0,0,0,0,0,0,0,0,0,156000,0,0,0,224000,68000,156000,156000
053782,京元電元大98購02,0,0,0,0,0,0,0,0,0,156000,0,0,0,156000,0,156000,156000
055826,中石化元大97購01,0,0,0,0,0,0,0,0,0,155000,0,0,0,155000,0,155000,155000
055974,上銀統一97購05  ,0,0,0,0,0,0,0,0,0,155000,0,0,0,223000,68000,155000,155000
056070,新日興元大97購04,0,0,0,0,0,0,0,0,0,155000,0,0,0,204000,49000,155000,155000
055516,上銀中信97購01  ,0,0,0,0,0,0,0,0,0,155000,0,0,0,196000,41000,155000,155000
054827,宏全元大9A購01  ,0,0,0,0,0,0,0,0,0,155000,0,0,0,223000,68000,155000,155000
054943,群光元大97購01  ,0,0,0,0,0,0,0,0,0,155000,0,0,0,243000,88000,155000,155000
055012,茂林元富97購01  ,0,0,0,0,0,0,0,0,0,155000,0,0,0,494000,339000,155000,155000
03075X,元展70          ,0,0,0,0,0,0,0,0,0,155000,0,0,0,155000,0,155000,155000
049926,智易元大95購02  ,0,0,0,0,0,0,0,0,0,155000,0,0,0,155000,0,155000,155000
04940P,台積電國票95售02,0,0,0,0,0,0,0,0,0,155000,0,0,0,155000,0,155000,155000
050195,上海銀元大94購03,0,0,0,0,0,0,0,0,0,155000,0,0,0,170000,15000,155000,155000
054215,創意國票97購02  ,0,0,0,0,0,0,0,0,0,155000,0,0,0,155000,0,155000,155000
052165,訊芯永豐95購03  ,0,0,0,0,0,0,0,0,0,155000,0,0,0,155000,0,155000,155000
054504,聯鈞永豐96購01  ,0,0,0,0,0,0,0,0,0,154000,0,0,0,174000,20000,154000,154000
055337,超眾兆豐98購01  ,0,0,0,0,0,0,0,0,0,154000,0,0,0,154000,0,154000,154000
055791,臺股指凱基97購14,0,0,0,0,0,0,0,0,0,154000,0,0,0,179000,25000,154000,154000
048900,精成科國泰95購01,0,0,0,0,0,0,0,0,0,154000,0,0,0,157000,3000,154000,154000
050104,元石油元大97購02,10000,0,10000,0,0,0,0,0,0,144000,0,0,0,154000,10000,144000,154000
053081,上銀元大97購02  ,0,0,0,0,0,0,0,0,0,154000,0,0,0,252000,98000,154000,154000
056123,鈺齊群益97購01  ,0,0,0,0,0,0,0,0,0,153000,0,0,0,205000,52000,153000,153000
056115,奇力新群益97購06,0,0,0,0,0,0,0,0,0,153000,0,0,0,479000,326000,153000,153000
056328,訊芯兆豐98購01  ,0,0,0,0,0,0,0,0,0,153000,0,0,0,203000,50000,153000,153000
055471,聯發科凱基97購04,0,0,0,0,0,0,0,0,0,153000,0,0,0,169000,16000,153000,153000
055662,上銀中信99購01  ,0,0,0,0,0,0,0,0,0,153000,0,0,0,366000,213000,153000,153000
054538,台光電國票98購01,0,0,0,0,0,0,0,0,0,153000,0,0,0,163000,10000,153000,153000
046480,群創元富96購01  ,0,0,0,0,0,0,0,0,0,153000,0,0,0,163000,10000,153000,153000
050831,超眾凱基95購01  ,0,0,0,0,0,0,0,0,0,153000,0,0,0,233000,80000,153000,153000
051918,聯茂元大95購01  ,0,0,0,0,0,0,0,0,0,153000,0,0,0,221000,68000,153000,153000
051802,同欣電永豐95購02,0,0,0,0,0,0,0,0,0,153000,0,0,0,153000,0,153000,153000
053876,可成永昌98購01  ,0,0,0,0,0,0,0,0,0,153000,0,0,0,179000,26000,153000,153000
054791,泰碩群益99購02  ,0,0,0,0,0,0,0,0,0,152000,0,0,0,207000,55000,152000,152000
055018,緯穎元富97購02  ,0,0,0,0,0,0,0,0,0,152000,0,0,0,389000,237000,152000,152000
055047,南港永豐97購01  ,0,0,0,0,0,0,0,0,0,152000,0,0,0,152000,0,152000,152000
05551P,電子類元大96售01,0,0,0,0,0,0,0,0,0,152000,0,0,0,358000,206000,152000,152000
056615,燿華永豐98購02  ,0,0,0,0,0,0,0,0,0,152000,0,0,0,205000,53000,152000,152000
048324,訊芯凱基93購03  ,0,0,0,0,0,0,0,0,0,152000,0,0,0,164000,12000,152000,152000
049137,華通元大95購02  ,0,0,0,0,0,0,0,0,0,152000,0,0,0,173000,21000,152000,152000
054074,健策富邦98購01  ,0,0,0,0,0,0,0,0,0,152000,0,0,0,226000,74000,152000,152000
053201,美律日盛96購01  ,0,0,0,0,0,0,0,0,0,152000,0,0,0,200000,48000,152000,152000
056262,台積電統一98購04,0,0,0,0,0,0,0,0,0,151000,0,0,0,161000,10000,151000,151000
056197,友訊永豐97購01  ,0,0,0,0,0,0,0,0,0,151000,0,0,0,151000,0,151000,151000
046487,鴻海永昌92購01  ,0,0,0,0,0,0,0,0,0,151000,0,0,0,161000,10000,151000,151000
050420,鴻海凱基95購03  ,0,0,0,0,0,0,0,0,0,151000,0,0,0,191000,40000,151000,151000
05044P,亞德客永豐95售01,0,0,0,0,0,0,0,0,0,151000,0,0,0,156000,5000,151000,151000
051251,信邦元大95購01  ,0,0,0,0,0,0,0,0,0,151000,0,0,0,196000,45000,151000,151000
054131,南亞科元大96購04,0,0,0,0,0,0,0,0,0,151000,0,0,0,206000,55000,151000,151000
056032,勤誠康和97購03  ,0,0,0,0,0,0,0,0,0,150000,0,0,0,150000,0,150000,150000
056503,楠梓電永豐98購01,0,0,0,0,0,0,0,0,0,150000,0,0,0,170000,20000,150000,150000
055702,美律富邦98購01  ,0,0,0,0,0,0,0,0,0,150000,0,0,0,150000,0,150000,150000
055420,欣興永豐98購01  ,0,0,0,0,0,0,0,0,0,150000,0,0,0,224000,74000,150000,150000
054677,智易台新98購02  ,0,0,0,0,0,0,0,0,0,150000,0,0,0,150000,0,150000,150000
054501,強茂永豐96購02  ,0,0,0,0,0,0,0,0,0,150000,0,0,0,150000,0,150000,150000
050421,鴻海凱基95購04  ,0,0,0,0,0,0,0,0,0,150000,0,0,0,150000,0,150000,150000
046991,健策凱基93購04  ,0,0,0,0,0,0,0,0,0,150000,0,0,0,150000,0,150000,150000
047353,台郡凱基93購03  ,0,0,0,0,0,0,0,0,0,150000,0,0,0,150000,0,150000,150000
047248,奇鋐群益95購01  ,0,0,0,0,0,0,0,0,0,150000,0,0,0,150000,0,150000,150000
047057,瀚宇博國票93購01,0,0,0,0,0,0,0,0,0,150000,0,0,0,150000,0,150000,150000
046852,燿華元大93購02  ,0,0,0,0,0,0,0,0,0,150000,0,0,0,150000,0,150000,150000
04379P,大立光元大94售06,0,0,0,0,0,0,0,0,0,150000,0,0,0,165000,15000,150000,150000
044582,GIS凱基92購01   ,0,0,0,0,0,0,0,0,0,150000,0,0,0,150000,0,150000,150000
051222,世紀鋼元富95購01,0,0,0,0,0,0,0,0,0,150000,0,0,0,150000,0,150000,150000
050281,台積電日盛94購03,0,0,0,0,0,0,0,0,0,150000,0,0,0,220000,70000,150000,150000
051447,新光金元大97購01,0,0,0,0,0,0,0,0,0,150000,0,0,0,150000,0,150000,150000
053266,全新群益98購01  ,0,0,0,0,0,0,0,0,0,150000,0,0,0,241000,91000,150000,150000
053306,晶技凱基97購01  ,0,0,0,0,0,0,0,0,0,150000,0,0,0,150000,0,150000,150000
053688,燿華元大96購05  ,0,0,0,0,0,0,0,0,0,150000,0,0,0,197000,47000,150000,150000
052146,泰碩群益95購01  ,0,0,0,0,0,0,0,0,0,150000,0,0,0,150000,0,150000,150000
052497,楠梓電永豐96購01,0,0,0,0,0,0,0,0,0,150000,0,0,0,150000,0,150000,150000
03266P,寶成國票04售01  ,0,0,0,0,0,0,0,0,0,149000,0,0,0,349000,200000,149000,149000
049357,微星富邦94購01  ,0,0,0,0,0,0,0,0,0,149000,0,0,0,159000,10000,149000,149000
048346,智易元大95購01  ,0,0,0,0,0,0,0,0,0,149000,0,0,0,249000,100000,149000,149000
050521,聯發科元大94購15,0,0,0,0,0,0,0,0,0,149000,0,0,0,201000,52000,149000,149000
053749,揚明光永豐97購01,0,0,0,0,0,0,0,0,0,149000,0,0,0,149000,0,149000,149000
5471,松翰            ,336000,187000,149000,0,0,0,0,0,0,0,0,0,0,0,0,0,149000
055986,祥碩元富97購01  ,0,0,0,0,0,0,0,0,0,148000,0,0,0,253000,105000,148000,148000
055907,台虹兆豐98購01  ,0,0,0,0,0,0,0,0,0,148000,0,0,0,148000,0,148000,148000
044429,元金2X元大94購04,0,0,0,0,0,0,0,0,0,148000,0,0,0,148000,0,148000,148000
047109,華邦電元大94購01,0,0,0,0,0,0,0,0,0,148000,0,0,0,153000,5000,148000,148000
053297,鎧勝中信98購01  ,0,0,0,0,0,0,0,0,0,148000,0,0,0,148000,0,148000,148000
05418P,瑞昱永豐95售02  ,0,0,0,0,0,0,0,0,0,148000,0,0,0,150000,2000,148000,148000
05957P,友達國票97售04  ,0,0,0,0,0,0,0,0,0,147000,0,0,0,177000,30000,147000,147000
046813,聯電凱基96購01  ,0,0,0,0,0,0,0,0,0,147000,0,0,0,149000,2000,147000,147000
03242P,聯電統一02售04  ,0,0,0,0,0,0,0,0,0,147000,0,0,0,150000,3000,147000,147000
056111,力成永豐97購01  ,0,0,0,0,0,0,0,0,0,146000,0,0,0,234000,88000,146000,146000
055240,京元電元富97購01,0,0,0,0,0,0,0,0,0,146000,0,0,0,248000,102000,146000,146000
045376,友訊元大93購01  ,0,0,0,0,0,0,0,0,0,146000,0,0,0,146000,0,146000,146000
051525,日月光凱基95購02,0,0,0,0,0,0,0,0,0,146000,0,0,0,308000,162000,146000,146000
053947,義隆富邦97購01  ,0,0,0,0,0,0,0,0,0,146000,0,0,0,488000,342000,146000,146000
053166,聯詠群益96購02  ,0,0,0,0,0,0,0,0,0,146000,0,0,0,199000,53000,146000,146000
052710,玉晶光日盛96購01,0,0,0,0,0,0,0,0,0,146000,0,0,0,173000,27000,146000,146000
055310,聯詠群益97購02  ,0,0,0,0,0,0,0,0,0,145000,0,0,0,202000,57000,145000,145000
055762,智伸科群益97購01,0,0,0,0,0,0,0,0,0,145000,0,0,0,157000,12000,145000,145000
055993,致茂國泰99購01  ,0,0,0,0,0,0,0,0,0,145000,0,0,0,155000,10000,145000,145000
045993,美律富邦93購01  ,0,0,0,0,0,0,0,0,0,145000,0,0,0,145000,0,145000,145000
047221,日月光麥證93購01,0,0,0,167000,20000,147000,0,0,0,145000,0,0,0,167000,22000,145000,145000
044188,超眾國泰93購01  ,0,0,0,0,0,0,0,0,0,145000,0,0,0,230000,85000,145000,145000
048597,台達電國票93購02,0,0,0,0,0,0,0,0,0,145000,0,0,0,183000,38000,145000,145000
056090,康舒統一97購01  ,0,0,0,0,0,0,0,0,0,144000,0,0,0,192000,48000,144000,144000
056428,台達電凱基99購01,0,0,0,0,0,0,0,0,0,144000,0,0,0,149000,5000,144000,144000
055674,南港康和97購02  ,0,0,0,0,0,0,0,0,0,144000,0,0,0,212000,68000,144000,144000
04655P,臺股指凱基94售14,0,0,0,0,0,0,0,0,0,144000,0,0,0,694000,550000,144000,144000
046792,京元電元富96購01,0,0,0,0,0,0,0,0,0,144000,0,0,0,194000,50000,144000,144000
050867,聯鈞永豐95購01  ,0,0,0,0,0,0,0,0,0,144000,0,0,0,224000,80000,144000,144000
051212,國巨統一95購01  ,0,0,0,0,0,0,0,0,0,144000,0,0,0,155000,11000,144000,144000
05282P,可成元大95售09  ,0,0,0,0,0,0,0,0,0,144000,0,0,0,273000,129000,144000,144000
052243,致茂康和95購01  ,0,0,0,0,0,0,0,0,0,144000,0,0,0,304000,160000,144000,144000
054012,廣達永豐96購01  ,0,0,0,0,0,0,0,0,0,144000,0,0,0,144000,0,144000,144000
056363,華新科元大99購04,0,0,0,0,0,0,0,0,0,143000,0,0,0,211000,68000,143000,143000
05844P,旺宏元大96售07  ,0,0,0,0,0,0,0,0,0,143000,0,0,0,573000,430000,143000,143000
044013,友達凱基93購01  ,0,0,0,0,0,0,0,0,0,143000,0,0,0,222000,79000,143000,143000
00865B,國泰US短期公債  ,0,0,0,0,0,0,0,0,0,143000,0,0,0,143000,0,143000,143000
051406,泰鼎永豐96購01  ,0,0,0,0,0,0,0,0,0,143000,0,0,0,176000,33000,143000,143000
054164,強茂凱基98購01  ,0,0,0,0,0,0,0,0,0,143000,0,0,0,143000,0,143000,143000
06375P,矽力元大97售06  ,0,0,0,0,0,0,0,0,0,143000,0,0,0,353000,210000,143000,143000
056027,樺漢群益97購02  ,0,0,0,0,0,0,0,0,0,142000,0,0,0,142000,0,142000,142000
055002,群創元富99購04  ,0,0,0,0,0,0,0,0,0,142000,0,0,0,302000,160000,142000,142000
044510,台光電凱基93購04,0,0,0,0,0,0,0,0,0,142000,0,0,0,142000,0,142000,142000
050620,和碩元大94購04  ,0,0,0,0,0,0,0,0,0,142000,0,0,0,151000,9000,142000,142000
052275,日月光群益95購01,0,0,0,0,0,0,0,0,0,142000,0,0,0,253000,111000,142000,142000
052326,滬深反中信99購01,0,0,0,0,0,0,0,0,0,142000,0,0,0,309000,167000,142000,142000
052726,鴻海元富96購03  ,0,0,0,0,0,0,0,0,0,142000,0,0,0,303000,161000,142000,142000
054886,大毅統一97購01  ,0,0,0,0,0,0,0,0,0,141000,0,0,0,240000,99000,141000,141000
055333,晶豪科兆豐97購01,0,0,0,0,0,0,0,0,0,141000,0,0,0,141000,0,141000,141000
055208,京鼎康和97購02  ,0,0,0,0,0,0,0,0,0,141000,0,0,0,141000,0,141000,141000
056010,力成中信97購01  ,0,0,0,0,0,0,0,0,0,141000,0,0,0,496000,355000,141000,141000
046864,和大統一97購01  ,0,0,0,0,0,0,0,0,0,141000,0,0,0,531000,390000,141000,141000
053915,光罩國票96購02  ,0,0,0,0,0,0,0,0,0,141000,0,0,0,190000,49000,141000,141000
06045P,臺股指永豐96售03,0,0,0,0,0,0,0,0,0,141000,0,0,0,141000,0,141000,141000
056147,鴻海日盛97購05  ,0,0,0,0,0,0,0,0,0,140000,0,0,0,500000,360000,140000,140000
055422,康控永豐97購01  ,0,0,0,0,0,0,0,0,0,140000,0,0,0,160000,20000,140000,140000
055448,健策統一97購02  ,0,0,0,0,0,0,0,0,0,140000,0,0,0,210000,70000,140000,140000
050454,嘉澤元大94購04  ,0,0,0,0,0,0,0,0,0,140000,0,0,0,328000,188000,140000,140000
03621P,旺宏第一92售01  ,0,0,0,0,0,0,0,0,0,140000,0,0,0,140000,0,140000,140000
044801,微星凱基93購01  ,0,0,0,0,0,0,0,0,0,140000,0,0,0,160000,20000,140000,140000
048962,宏全康和94購01  ,0,0,0,0,0,0,0,0,0,140000,0,0,0,234000,94000,140000,140000
049210,昇陽半群益94購02,0,0,0,0,0,0,0,0,0,140000,0,0,0,140000,0,140000,140000
048498,嘉澤元大94購01  ,0,0,0,0,0,0,0,0,0,140000,0,0,0,282000,142000,140000,140000
049765,上証2X元富94購01,0,0,0,0,0,0,0,0,0,140000,0,0,0,140000,0,140000,140000
049624,嘉澤群益94購01  ,0,0,0,0,0,0,0,0,0,140000,0,0,0,234000,94000,140000,140000
054155,美律第一96購01  ,0,0,0,0,0,0,0,0,0,140000,0,0,0,150000,10000,140000,140000
053309,泰鼎凱基96購03  ,0,0,0,0,0,0,0,0,0,140000,0,0,0,160000,20000,140000,140000
053080,力山元大96購02  ,0,0,0,0,0,0,0,0,0,140000,0,0,0,333000,193000,140000,140000
055130,京鼎康和97購01  ,0,0,0,0,0,0,0,0,0,139000,0,0,0,139000,0,139000,139000
056236,台積電群益97購06,0,0,0,0,0,0,0,0,0,139000,0,0,0,326000,187000,139000,139000
05744P,台表科元大96售04,0,0,0,0,0,0,0,0,0,139000,0,0,0,234000,95000,139000,139000
050884,聯茂國泰96購01  ,0,0,0,0,0,0,0,0,0,139000,0,0,0,139000,0,139000,139000
049584,台積電元大96購04,0,0,0,0,0,0,0,0,0,139000,0,0,0,473000,334000,139000,139000
049403,欣興群益94購03  ,0,0,0,0,0,0,0,0,0,139000,0,0,0,139000,0,139000,139000
049154,玉晶光元大95購02,0,0,0,0,0,0,0,0,0,139000,0,0,0,157000,18000,139000,139000
052277,台達電凱基97購01,0,0,0,0,0,0,0,0,0,139000,0,0,0,169000,30000,139000,139000
053424,欣興永豐96購02  ,0,0,0,0,0,0,0,0,0,139000,0,0,0,141000,2000,139000,139000
054179,上海銀台新97購01,0,0,0,0,0,0,0,0,0,139000,0,0,0,139000,0,139000,139000
05440P,緯穎國票96售02  ,0,0,0,0,0,0,0,0,0,139000,0,0,0,139000,0,139000,139000
056570,旺宏元大98購07  ,0,0,0,0,0,0,0,0,0,138000,0,0,0,163000,25000,138000,138000
055964,正文元大97購02  ,0,0,0,0,0,0,0,0,0,138000,0,0,0,368000,230000,138000,138000
047002,鴻海統一93購04  ,0,0,0,0,0,0,0,0,0,138000,0,0,0,138000,0,138000,138000
051593,和碩元大95購01  ,0,0,0,0,0,0,0,0,0,138000,0,0,0,191000,53000,138000,138000
048775,智伸科凱基94購01,0,0,0,0,0,0,0,0,0,138000,0,0,0,138000,0,138000,138000
048351,旺宏台新94購02  ,0,0,0,0,0,0,0,0,0,138000,0,0,0,188000,50000,138000,138000
050144,宏達電台新95購01,0,0,0,0,0,0,0,0,0,138000,0,0,0,148000,10000,138000,138000
052224,楠梓電凱基97購01,0,0,0,0,0,0,0,0,0,138000,0,0,0,138000,0,138000,138000
051926,聯電中信97購01  ,0,0,0,0,0,0,0,0,0,138000,0,0,0,217000,79000,138000,138000
055954,南港元大97購02  ,0,0,0,0,0,0,0,0,0,137000,0,0,0,193000,56000,137000,137000
05914P,友達元大96售04  ,0,0,0,0,0,0,0,0,0,137000,0,0,0,178000,41000,137000,137000
050745,茂林永豐94購06  ,0,0,0,0,0,0,0,0,0,137000,0,0,0,137000,0,137000,137000
050773,京鼎元大94購02  ,0,0,0,0,0,0,0,0,0,137000,0,0,0,147000,10000,137000,137000
052463,聯電統一96購01  ,0,0,0,0,0,0,0,0,0,137000,0,0,0,298000,161000,137000,137000
052439,寶成富邦97購01  ,0,0,0,0,0,0,0,0,0,137000,0,0,0,148000,11000,137000,137000
052949,智易國票97購02  ,0,0,0,0,0,0,0,0,0,137000,0,0,0,167000,30000,137000,137000
052847,漢唐統一99購01  ,0,0,0,0,0,0,0,0,0,137000,0,0,0,137000,0,137000,137000
054963,牧德元大97購02  ,0,0,0,0,0,0,0,0,0,136000,0,0,0,366000,230000,136000,136000
054698,同欣電永豐97購01,0,0,0,0,0,0,0,0,0,136000,0,0,0,136000,0,136000,136000
055290,玉晶光元大98購08,0,0,0,0,0,0,0,0,0,136000,0,0,0,136000,0,136000,136000
046668,嘉澤元大93購01  ,0,0,0,0,0,0,0,0,0,136000,0,0,0,138000,2000,136000,136000
044961,聯電中信94購01  ,0,0,0,0,0,0,0,0,0,136000,0,0,0,276000,140000,136000,136000
047554,聯詠凱基93購04  ,0,0,0,0,0,0,0,0,0,136000,0,0,0,136000,0,136000,136000
050628,美律中信94購02  ,0,0,0,0,0,0,0,0,0,136000,0,0,0,437000,301000,136000,136000
052466,聯詠統一95購03  ,0,0,0,0,0,0,0,0,0,136000,0,0,0,136000,0,136000,136000
052147,上緯控群益95購01,0,0,0,0,0,0,0,0,0,136000,0,0,0,136000,0,136000,136000
054313,麗豐凱基96購02  ,0,0,0,0,0,0,0,0,0,136000,0,0,0,204000,68000,136000,136000
055707,聯鈞永豐98購01  ,0,0,0,0,0,0,0,0,0,135000,0,0,0,135000,0,135000,135000
046652,上銀元大93購02  ,0,0,0,0,0,0,0,0,0,135000,0,0,0,135000,0,135000,135000
050711,TPK中信94購01   ,0,0,0,0,0,0,0,0,0,135000,0,0,0,135000,0,135000,135000
050662,智易元大96購01  ,0,0,0,0,0,0,0,0,0,135000,0,0,0,135000,0,135000,135000
048157,美律兆豐93購01  ,0,0,0,0,0,0,0,0,0,135000,0,0,0,255000,120000,135000,135000
049204,京元電群益94購02,0,0,0,0,0,0,0,0,0,135000,0,0,0,165000,30000,135000,135000
053180,同欣電統一96購01,0,0,0,0,0,0,0,0,0,135000,0,0,0,135000,0,135000,135000
055265,玉晶光永豐98購03,0,0,0,0,0,0,0,0,0,134000,0,0,0,144000,10000,134000,134000
054893,帆宣統一99購01  ,0,0,0,0,0,0,0,0,0,134000,0,0,0,175000,41000,134000,134000
055801,景碩永豐97購02  ,0,0,0,0,0,0,0,0,0,134000,0,0,0,217000,83000,134000,134000
056020,義隆群益97購01  ,0,11000,-11000,0,0,0,0,0,0,145000,0,0,0,274000,129000,145000,134000
043177,致新國泰93購01  ,0,0,0,0,0,0,0,0,0,134000,0,0,0,134000,0,134000,134000
047971,南亞科富邦95購01,0,0,0,0,0,0,0,0,0,134000,0,0,0,134000,0,134000,134000
051551,新日興永豐95購01,0,0,0,0,0,0,0,0,0,134000,0,0,0,149000,15000,134000,134000
048957,玉晶光康和94購01,0,0,0,0,0,0,0,0,0,134000,0,0,0,134000,0,134000,134000
052046,漢唐凱基96購01  ,0,0,0,0,0,0,0,0,0,134000,0,0,0,174000,40000,134000,134000
052113,漢唐中信98購01  ,0,0,0,0,0,0,0,0,0,134000,0,0,0,234000,100000,134000,134000
054339,聯詠統一96購02  ,0,0,0,0,0,0,0,0,0,134000,0,0,0,134000,0,134000,134000
053444,奇力新凱基96購03,0,0,0,0,0,0,0,0,0,134000,0,0,0,263000,129000,134000,134000
054509,上証反元大99購01,0,0,0,0,0,0,0,0,0,133000,0,0,0,206000,73000,133000,133000
055429,華新科群益99購01,0,0,0,0,0,0,0,0,0,133000,0,0,0,204000,71000,133000,133000
045694,智邦兆豐93購05  ,0,0,0,0,0,0,0,0,0,133000,0,0,0,485000,352000,133000,133000
053387,緯創元大97購01  ,0,0,0,0,0,0,0,0,0,133000,0,0,0,133000,0,133000,133000
053699,臺股指元大96購22,0,0,0,0,0,0,0,0,0,133000,0,0,0,403000,270000,133000,133000
052191,超眾群益96購01  ,0,0,0,0,0,0,0,0,0,133000,0,0,0,203000,70000,133000,133000
052676,聯發科永昌98購01,0,0,0,0,0,0,0,0,0,133000,0,0,0,740000,607000,133000,133000
055509,訊芯元大97購03  ,0,0,0,0,0,0,0,0,0,132000,0,0,0,212000,80000,132000,132000
048966,佳世達元大95購01,0,0,0,0,0,0,0,0,0,132000,0,0,0,132000,0,132000,132000
049447,聯電統一94購01  ,0,0,0,0,0,0,0,0,0,132000,0,0,0,132000,0,132000,132000
052826,嘉聯益永豐96購01,0,0,0,0,0,0,0,0,0,132000,0,0,0,142000,10000,132000,132000
052814,上証2X永豐96購02,0,0,0,0,0,0,0,0,0,132000,0,0,0,337000,205000,132000,132000
052893,聯電群益98購01  ,0,0,0,0,0,0,0,0,0,132000,0,0,0,225000,93000,132000,132000
046931,聯詠統一93購01  ,0,0,0,0,0,0,0,0,0,131000,0,0,0,135000,4000,131000,131000
03576P,台灣50元富06售01,0,0,0,0,0,0,0,0,0,131000,0,0,0,143000,12000,131000,131000
050516,華通元大95購05  ,0,0,0,0,0,0,0,0,0,131000,0,0,0,131000,0,131000,131000
054153,宏達電國泰97購01,0,0,0,0,0,0,0,0,0,131000,0,0,0,246000,115000,131000,131000
055754,和大兆豐97購01  ,0,0,0,0,0,0,0,0,0,130000,0,0,0,130000,0,130000,130000
056417,欣興中信98購01  ,0,0,0,0,0,0,0,0,0,130000,0,0,0,132000,2000,130000,130000
046385,群創凱基98購03  ,0,0,0,0,0,0,0,0,0,130000,0,0,0,130000,0,130000,130000
04644P,全新凱基94售01  ,0,0,0,0,0,0,0,0,0,130000,0,0,0,152000,22000,130000,130000
04557P,茂林群益94售03  ,0,0,0,0,0,0,0,0,0,130000,0,0,0,130000,0,130000,130000
049712,為升凱基94購03  ,0,0,0,0,0,0,0,0,0,130000,0,0,0,130000,0,130000,130000
049235,元油2X元富96購05,0,0,0,0,0,0,0,0,0,130000,0,0,0,133000,3000,130000,130000
054484,仁寶台新96購01  ,0,0,0,0,0,0,0,0,0,130000,0,0,0,191000,61000,130000,130000
052606,聯發科元大97購04,0,0,0,0,0,0,0,0,0,130000,0,0,0,164000,34000,130000,130000
052018,京鼎永豐95購02  ,0,0,0,0,0,0,0,0,0,130000,0,0,0,130000,0,130000,130000
06073P,健策永豐97售01  ,0,0,0,0,0,0,0,0,0,130000,0,0,0,170000,40000,130000,130000
056626,同欣電永豐98購01,0,0,0,0,0,0,0,0,0,129000,0,0,0,129000,0,129000,129000
055667,致茂群益98購01  ,0,0,0,0,0,0,0,0,0,129000,0,0,0,140000,11000,129000,129000
047783,聯茂國泰94購02  ,0,0,0,0,0,0,0,0,0,129000,0,0,0,149000,20000,129000,129000
050472,和大永豐94購01  ,0,0,0,0,0,0,0,0,0,129000,0,0,0,200000,71000,129000,129000
048550,中鴻元大96購01  ,0,0,0,0,0,0,0,0,0,129000,0,0,0,275000,146000,129000,129000
046403,技嘉元大92購01  ,0,0,0,0,0,0,0,0,0,129000,0,0,0,139000,10000,129000,129000
044163,台光電元大92購01,0,0,0,0,0,0,0,0,0,129000,0,0,0,129000,0,129000,129000
050523,義隆元大94購05  ,0,0,0,0,0,0,0,0,0,129000,0,0,0,205000,76000,129000,129000
048965,佳世達元大94購01,0,0,0,0,0,0,0,0,0,129000,0,0,0,139000,10000,129000,129000
048914,川湖台新94購01  ,0,0,0,0,0,0,0,0,0,129000,0,0,0,129000,0,129000,129000
051392,玉山金兆豐95購01,0,0,0,0,0,0,0,0,0,129000,0,0,0,156000,27000,129000,129000
053783,聯發科元大96購17,0,0,0,0,0,0,0,0,0,129000,0,0,0,174000,45000,129000,129000
053454,創意統一96購02  ,0,0,0,0,0,0,0,0,0,129000,0,0,0,189000,60000,129000,129000
053524,聯電中信97購02  ,0,0,0,0,0,0,0,0,0,129000,0,0,0,315000,186000,129000,129000
045102,京元電亞東93購01,0,0,0,0,0,0,0,0,0,128000,0,0,0,128000,0,128000,128000
048884,川湖元富94購01  ,0,0,0,0,0,0,0,0,0,128000,0,0,0,138000,10000,128000,128000
048867,台積電兆豐95購01,0,0,0,0,0,0,0,0,0,128000,0,0,0,148000,20000,128000,128000
049667,大立光國泰96購01,0,0,0,0,0,0,0,0,0,128000,0,0,0,130000,2000,128000,128000
052966,光磊群益96購01  ,0,0,0,0,0,0,0,0,0,128000,0,0,0,226000,98000,128000,128000
053183,大立光元富96購03,0,0,0,0,0,0,0,0,0,128000,0,0,0,128000,0,128000,128000
055829,上銀元大97購06  ,0,0,0,0,0,0,0,0,0,127000,0,0,0,312000,185000,127000,127000
00650L,FH香港正2       ,0,5000,-5000,0,0,0,0,0,0,132000,0,0,0,286000,154000,132000,127000
048484,大立光國泰95購02,0,0,0,0,0,0,0,0,0,127000,0,0,0,143000,16000,127000,127000
048814,上銀凱基94購01  ,0,0,0,0,0,0,0,0,0,127000,0,0,0,181000,54000,127000,127000
049022,聯詠群益94購01  ,0,0,0,0,0,0,0,0,0,127000,0,0,0,162000,35000,127000,127000
052465,聯詠統一95購02  ,0,0,0,0,0,0,0,0,0,127000,0,0,0,127000,0,127000,127000
052346,訊芯凱基95購01  ,0,0,0,0,0,0,0,0,0,127000,0,0,0,149000,22000,127000,127000
054324,美律台新97購01  ,0,0,0,0,0,0,0,0,0,127000,0,0,0,235000,108000,127000,127000
054117,宏全康和96購01  ,0,0,0,0,0,0,0,0,0,127000,0,0,0,247000,120000,127000,127000
056071,創意元大97購02  ,0,0,0,0,0,0,0,0,0,126000,0,0,0,178000,52000,126000,126000
055708,茂林永豐97購02  ,0,0,0,0,0,0,0,0,0,126000,0,0,0,166000,40000,126000,126000
055734,奇力新元富97購02,0,0,0,0,0,0,0,0,0,126000,0,0,0,699000,573000,126000,126000
044134,訊芯凱基93購01  ,0,0,0,0,0,0,0,0,0,126000,0,0,0,248000,122000,126000,126000
046431,中環第一92購01  ,0,0,0,0,0,0,0,0,0,126000,0,0,0,126000,0,126000,126000
050093,國巨永豐94購05  ,0,0,0,0,0,0,0,0,0,126000,0,0,0,157000,31000,126000,126000
049318,樺漢凱基94購01  ,0,0,0,0,0,0,0,0,0,126000,0,0,0,135000,9000,126000,126000
049416,美律凱基94購04  ,0,0,0,0,0,0,0,0,0,126000,0,0,0,126000,0,126000,126000
049622,聯詠群益94購02  ,0,0,0,0,0,0,0,0,0,126000,0,0,0,136000,10000,126000,126000
054249,技嘉元大96購03  ,0,0,0,0,0,0,0,0,0,126000,0,0,0,152000,26000,126000,126000
052057,臺股指凱基95購15,0,0,0,0,0,0,0,0,0,126000,0,0,0,379000,253000,126000,126000
055427,技嘉群益98購01  ,0,0,0,0,0,0,0,0,0,125000,0,0,0,207000,82000,125000,125000
056067,智原元大97購01  ,0,0,0,0,0,0,0,0,0,125000,0,0,0,173000,48000,125000,125000
056068,欣興元大97購05  ,0,0,0,0,0,0,0,0,0,125000,0,0,0,125000,0,125000,125000
056033,T50正2凱基99購02,0,0,0,0,0,0,0,0,0,125000,0,0,0,149000,24000,125000,125000
056491,南亞科國泰99購01,0,0,0,0,0,0,0,0,0,125000,0,0,0,130000,5000,125000,125000
045206,創意國泰93購02  ,0,0,0,0,0,0,0,0,0,125000,0,0,0,165000,40000,125000,125000
050370,台積電元大94購24,0,0,0,0,0,0,0,0,0,125000,0,0,0,262000,137000,125000,125000
046796,南電元富93購01  ,0,0,0,0,0,0,0,0,0,125000,0,0,0,155000,30000,125000,125000
050512,台泥元大94購01  ,0,0,0,0,0,0,0,0,0,125000,0,0,0,244000,119000,125000,125000
049127,上海銀元富94購01,0,0,0,0,0,0,0,0,0,125000,0,0,0,147000,22000,125000,125000
049030,凌華群益94購01  ,0,0,0,0,0,0,0,0,0,125000,0,0,0,204000,79000,125000,125000
051715,和碩台新95購01  ,0,0,0,0,0,0,0,0,0,125000,0,0,0,183000,58000,125000,125000
052152,創意富邦98購01  ,0,0,0,0,0,0,0,0,0,125000,0,0,0,125000,0,125000,125000
053124,聯發科凱基96購12,0,0,0,0,0,0,0,0,0,125000,0,0,0,335000,210000,125000,125000
052767,智伸科群益98購01,0,0,0,0,0,0,0,0,0,125000,0,0,0,135000,10000,125000,125000
054080,微星中信98購01  ,0,0,0,0,0,0,0,0,0,125000,0,0,0,232000,107000,125000,125000
055828,上銀元大97購05  ,0,0,0,0,0,0,0,0,0,124000,0,0,0,494000,370000,124000,124000
04687P,全新凱基94售02  ,0,0,0,0,0,0,0,0,0,124000,0,0,0,148000,24000,124000,124000
046240,中鋼中信94購01  ,0,0,0,0,0,0,0,0,0,124000,0,0,0,254000,130000,124000,124000
050474,鴻海永豐94購05  ,0,0,0,0,0,0,0,0,0,124000,0,0,0,124000,0,124000,124000
044190,聯詠富邦93購01  ,0,0,0,0,0,0,0,0,0,124000,0,0,0,234000,110000,124000,124000
051582,聯發科元大97購02,0,0,0,0,0,0,0,0,0,124000,0,0,0,341000,217000,124000,124000
050515,聯電元大96購01  ,0,0,0,0,0,0,0,0,0,124000,0,0,0,128000,4000,124000,124000
050866,景碩永豐95購01  ,0,0,0,0,0,0,0,0,0,124000,0,0,0,192000,68000,124000,124000
053558,訊芯凱基96購02  ,0,0,0,0,0,0,0,0,0,124000,0,0,0,202000,78000,124000,124000
05270P,台表科元大95售05,0,0,0,0,0,0,0,0,0,124000,0,0,0,324000,200000,124000,124000
052707,景碩台新96購01  ,0,0,0,0,0,0,0,0,0,124000,0,0,0,278000,154000,124000,124000
053123,京元電凱基96購01,0,0,0,0,0,0,0,0,0,124000,0,0,0,128000,4000,124000,124000
056358,友訊元大99購01  ,0,0,0,0,0,0,0,0,0,123000,0,0,0,156000,33000,123000,123000
055252,新光金統一98購02,0,0,0,0,0,0,0,0,0,123000,0,0,0,123000,0,123000,123000
047591,訊芯永豐93購02  ,0,0,0,0,0,0,0,0,0,123000,0,0,0,123000,0,123000,123000
048753,智伸科元富94購01,0,0,0,0,0,0,0,0,0,123000,0,0,0,133000,10000,123000,123000
051203,微星麥證95購01  ,0,0,0,181000,58000,123000,0,0,0,123000,0,0,0,181000,58000,123000,123000
049119,元油2X元富94購04,0,0,0,0,0,0,0,0,0,123000,0,0,0,180000,57000,123000,123000
053135,信邦國票96購01  ,0,0,0,0,0,0,0,0,0,123000,0,0,0,161000,38000,123000,123000
052526,智伸科元大96購02,0,0,0,0,0,0,0,0,0,123000,0,0,0,133000,10000,123000,123000
052514,嘉澤凱基96購01  ,0,0,0,0,0,0,0,0,0,123000,0,0,0,267000,144000,123000,123000
053284,樺漢元大97購01  ,0,0,0,0,0,0,0,0,0,123000,0,0,0,213000,90000,123000,123000
055678,上銀凱基97購02  ,0,0,0,0,0,0,0,0,0,122000,0,0,0,183000,61000,122000,122000
056211,南港國票98購01  ,0,0,0,0,0,0,0,0,0,122000,0,0,0,122000,0,122000,122000
05651P,大立光元大97售02,0,0,0,0,0,0,0,0,0,122000,0,0,0,174000,52000,122000,122000
047074,大立光兆豐94購02,0,0,0,0,0,0,0,0,0,122000,0,0,0,122000,0,122000,122000
050035,聯茂元大94購07  ,0,0,0,0,0,0,0,0,0,122000,0,0,0,236000,114000,122000,122000
048733,台勝科麥證95購02,0,0,0,162000,40000,122000,0,0,0,122000,0,0,0,162000,40000,122000,122000
050786,健策國泰96購01  ,0,0,0,0,0,0,0,0,0,122000,0,0,0,122000,0,122000,122000
054292,欣興元大96購06  ,0,0,0,0,0,0,0,0,0,122000,0,0,0,297000,175000,122000,122000
06056P,台積電凱基98售02,0,0,0,0,0,0,0,0,0,122000,0,0,0,123000,1000,122000,122000
056511,超眾永豐98購01  ,0,0,0,0,0,0,0,0,0,121000,0,0,0,143000,22000,121000,121000
046628,大立光統一98購01,0,0,0,0,0,0,0,0,0,121000,0,0,0,158000,37000,121000,121000
044693,滬深2X元大94購01,0,0,0,0,0,0,0,0,0,121000,0,0,0,121000,0,121000,121000
050179,全新元大96購02  ,0,0,0,0,0,0,0,0,0,121000,0,0,0,121000,0,121000,121000
051568,智邦富邦95購01  ,0,0,0,0,0,0,0,0,0,121000,0,0,0,131000,10000,121000,121000
054268,健策第一96購01  ,0,0,0,0,0,0,0,0,0,121000,0,0,0,346000,225000,121000,121000
05312P,臺股指群益95售11,0,0,0,0,0,0,0,0,0,121000,0,0,0,151000,30000,121000,121000
051822,和碩元富95購01  ,0,0,0,0,0,0,0,0,0,121000,0,0,0,151000,30000,121000,121000
056617,美律永豐98購01  ,0,0,0,0,0,0,0,0,0,120000,0,0,0,458000,338000,120000,120000
055693,南茂凱基97購01  ,0,0,0,0,0,0,0,0,0,120000,0,0,0,120000,0,120000,120000
054646,華新科群益97購03,0,0,0,0,0,0,0,0,0,120000,0,0,0,120000,0,120000,120000
054859,鴻海群益97購02  ,0,0,0,0,0,0,0,0,0,120000,0,0,0,120000,0,120000,120000
03458P,玉晶光凱基03售08,0,0,0,0,0,0,0,0,0,120000,0,0,0,170000,50000,120000,120000
044396,燿華凱基93購02  ,0,0,0,0,0,0,0,0,0,120000,0,0,0,120000,0,120000,120000
044299,南電凱基93購02  ,0,0,0,0,0,0,0,0,0,120000,0,0,0,120000,0,120000,120000
045162,玉晶光國泰94購04,0,0,0,0,0,0,0,0,0,120000,0,0,0,121000,1000,120000,120000
046205,明基材凱基93購01,0,0,0,0,0,0,0,0,0,120000,0,0,0,120000,0,120000,120000
047325,材料元大93購01  ,0,0,0,0,0,0,0,0,0,120000,0,0,0,120000,0,120000,120000
051439,川湖元大95購01  ,0,0,0,0,0,0,0,0,0,120000,0,0,0,145000,25000,120000,120000
048992,昇陽半元大94購02,0,0,0,0,0,0,0,0,0,120000,0,0,0,120000,0,120000,120000
04886P,臺股指凱基94售20,0,0,0,0,0,0,0,0,0,120000,0,0,0,130000,10000,120000,120000
049361,華通元大94購02  ,0,0,0,0,0,0,0,0,0,120000,0,0,0,120000,0,120000,120000
050196,嘉聯益元大97購01,0,0,0,0,0,0,0,0,0,120000,0,0,0,120000,0,120000,120000
049587,美律元大95購01  ,0,0,0,0,0,0,0,0,0,120000,0,0,0,139000,19000,120000,120000
051160,亞德客元大95購02,0,0,0,0,0,0,0,0,0,120000,0,0,0,248000,128000,120000,120000
051096,日月光元大95購01,0,0,0,0,0,0,0,0,0,120000,0,0,0,148000,28000,120000,120000
051826,智邦元大95購03  ,0,0,0,0,0,0,0,0,0,120000,0,0,0,236000,116000,120000,120000
054070,創意國泰96購02  ,0,0,0,0,0,0,0,0,0,120000,0,0,0,120000,0,120000,120000
053501,明泰兆豐96購01  ,0,0,0,0,0,0,0,0,0,120000,0,0,0,120000,0,120000,120000
053502,智伸科兆豐97購01,0,0,0,0,0,0,0,0,0,120000,0,0,0,140000,20000,120000,120000
053647,臺股指國票96購10,0,0,0,0,0,0,0,0,0,120000,0,0,0,120000,0,120000,120000
054800,訊芯群益99購01  ,0,0,0,0,0,0,0,0,0,119000,0,0,0,141000,22000,119000,119000
055500,京鼎元大97購04  ,0,0,0,0,0,0,0,0,0,119000,0,0,0,142000,23000,119000,119000
050483,樺漢國票94購01  ,0,0,0,0,0,0,0,0,0,119000,0,0,0,119000,0,119000,119000
044934,玉晶光元大93購01,0,0,0,0,0,0,0,0,0,119000,0,0,0,169000,50000,119000,119000
050201,光磊群益94購01  ,0,0,0,0,0,0,0,0,0,119000,0,0,0,178000,59000,119000,119000
051383,京鼎群益96購02  ,0,0,0,0,0,0,0,0,0,119000,0,0,0,119000,0,119000,119000
053978,創意元大96購05  ,0,0,0,0,0,0,0,0,0,119000,0,0,0,139000,20000,119000,119000
05224P,華通統一95售03  ,0,0,0,0,0,0,0,0,0,119000,0,0,0,145000,26000,119000,119000
054799,超眾群益98購01  ,0,0,0,0,0,0,0,0,0,118000,0,0,0,190000,72000,118000,118000
054616,智伸科永豐97購01,0,0,0,0,0,0,0,0,0,118000,0,0,0,118000,0,118000,118000
044600,上銀國泰93購01  ,0,0,0,0,0,0,0,0,0,118000,0,0,0,123000,5000,118000,118000
046937,聯電元大99購01  ,0,0,0,0,0,0,0,0,0,118000,0,0,0,121000,3000,118000,118000
051372,樺漢富邦96購01  ,0,0,0,0,0,0,0,0,0,118000,0,0,0,120000,2000,118000,118000
050049,華通群益96購01  ,0,0,0,0,0,0,0,0,0,118000,0,0,0,168000,50000,118000,118000
048099,健策凱基93購06  ,0,0,0,0,0,0,0,0,0,118000,0,0,0,118000,0,118000,118000
049256,瑞昱元大94購04  ,0,0,0,0,0,0,0,0,0,118000,0,0,0,134000,16000,118000,118000
048480,FB上証中信94購01,0,0,0,0,0,0,0,0,0,118000,0,0,0,170000,52000,118000,118000
053033,智易兆豐97購01  ,0,0,0,0,0,0,0,0,0,118000,0,0,0,118000,0,118000,118000
053599,崇越元大96購01  ,0,0,0,0,0,0,0,0,0,118000,0,0,0,121000,3000,118000,118000
053844,GIS統一96購01   ,0,0,0,0,0,0,0,0,0,118000,0,0,0,120000,2000,118000,118000
056371,樺漢元大98購03  ,0,0,0,0,0,0,0,0,0,117000,0,0,0,161000,44000,117000,117000
055959,美律元大97購03  ,0,0,0,0,0,0,0,0,0,117000,0,0,0,137000,20000,117000,117000
047653,上銀兆豐94購01  ,0,0,0,0,0,0,0,0,0,117000,0,0,0,133000,16000,117000,117000
045022,聯電亞東93購01  ,0,0,0,0,0,0,0,0,0,117000,0,0,0,117000,0,117000,117000
049649,信邦凱基94購01  ,0,0,0,0,0,0,0,0,0,117000,0,0,0,117000,0,117000,117000
049717,微星凱基94購01  ,0,0,0,0,0,0,0,0,0,117000,0,0,0,132000,15000,117000,117000
050928,日月光凱基95購01,0,0,0,0,0,0,0,0,0,117000,0,0,0,353000,236000,117000,117000
056003,智伸科永豐97購02,0,0,0,0,0,0,0,0,0,116000,0,0,0,116000,0,116000,116000
056200,大毅永豐98購01  ,0,0,0,0,0,0,0,0,0,116000,0,0,0,243000,127000,116000,116000
047647,麗豐元大93購03  ,0,0,0,0,0,0,0,0,0,116000,0,0,0,146000,30000,116000,116000
049625,智易群益95購01  ,0,0,0,0,0,0,0,0,0,116000,0,0,0,121000,5000,116000,116000
051020,健策凱基96購02  ,0,0,0,0,0,0,0,0,0,116000,0,0,0,166000,50000,116000,116000
049742,日月光群益94購02,0,0,0,0,0,0,0,0,0,116000,0,0,0,126000,10000,116000,116000
049247,光寶科元大94購02,0,0,0,0,0,0,0,0,0,116000,0,0,0,116000,0,116000,116000
048859,玉晶光群益96購02,0,0,0,0,0,0,0,0,0,116000,0,0,0,116000,0,116000,116000
054088,華新群益98購02  ,0,0,0,0,0,0,0,0,0,116000,0,0,0,117000,1000,116000,116000
054480,和碩中信98購01  ,0,0,0,0,0,0,0,0,0,116000,0,0,0,120000,4000,116000,116000
056196,聯茂富邦98購02  ,0,0,0,0,0,0,0,0,0,115000,0,0,0,212000,97000,115000,115000
055875,光罩元富97購02  ,0,0,0,0,0,0,0,0,0,115000,0,0,0,115000,0,115000,115000
04254P,亞德客國票93售03,0,0,0,0,0,0,0,0,0,115000,0,0,0,125000,10000,115000,115000
050272,訊芯元大94購03  ,0,0,0,0,0,0,0,0,0,115000,0,0,0,115000,0,115000,115000
048179,臻鼎富邦97購01  ,0,0,0,0,0,0,0,0,0,115000,0,0,0,131000,16000,115000,115000
053481,同欣電元大97購01,0,0,0,0,0,0,0,0,0,115000,0,0,0,117000,2000,115000,115000
052214,智伸科元大96購01,0,0,0,0,0,0,0,0,0,115000,0,0,0,115000,0,115000,115000
052376,聯詠元大95購04  ,0,0,0,0,0,0,0,0,0,115000,0,0,0,173000,58000,115000,115000
055913,中信金凱基97購01,0,0,0,0,0,0,0,0,0,114000,0,0,0,114000,0,114000,114000
055844,大毅元大98購01  ,0,0,0,0,0,0,0,0,0,114000,0,0,0,396000,282000,114000,114000
054602,聯詠台新97購01  ,0,0,0,0,0,0,0,0,0,114000,0,0,0,139000,25000,114000,114000
055007,晶相光元富9A購02,0,0,0,0,0,0,0,0,0,114000,0,0,0,222000,108000,114000,114000
053817,華新科群益97購02,0,0,0,0,0,0,0,0,0,114000,0,0,0,114000,0,114000,114000
054248,燿華元大97購02  ,0,0,0,0,0,0,0,0,0,114000,0,0,0,174000,60000,114000,114000
054006,智易統一97購01  ,0,0,0,0,0,0,0,0,0,114000,0,0,0,119000,5000,114000,114000
055603,超眾元大97購04  ,0,0,0,0,0,0,0,0,0,113000,0,0,0,123000,10000,113000,113000
055313,南電群益97購01  ,0,0,0,0,0,0,0,0,0,113000,0,0,0,161000,48000,113000,113000
056447,聯發科凱基98購09,0,0,0,0,0,0,0,0,0,113000,0,0,0,129000,16000,113000,113000
047759,復盛元富93購01  ,0,0,0,0,0,0,0,0,0,113000,0,0,0,123000,10000,113000,113000
047123,中石化中信95購01,0,0,0,0,0,0,0,0,0,113000,0,0,0,193000,80000,113000,113000
048350,世紀鋼元大95購01,0,0,0,0,0,0,0,0,0,113000,0,0,0,113000,0,113000,113000
049408,旺宏日盛94購01  ,0,0,0,0,0,0,0,0,0,113000,0,0,0,116000,3000,113000,113000
049623,創意群益94購01  ,0,0,0,0,0,0,0,0,0,113000,0,0,0,139000,26000,113000,113000
050142,聯發科元富9A購01,0,0,0,0,0,0,0,0,0,113000,0,0,0,395000,282000,113000,113000
048844,訊芯凱基94購02  ,0,0,0,0,0,0,0,0,0,113000,0,0,0,113000,0,113000,113000
049073,光罩凱基94購01  ,0,0,0,0,0,0,0,0,0,113000,0,0,0,113000,0,113000,113000
051559,宏達電國泰96購01,0,0,0,0,0,0,0,0,0,113000,0,0,0,117000,4000,113000,113000
053395,致茂中信96購01  ,0,0,0,0,0,0,0,0,0,113000,0,0,0,161000,48000,113000,113000
051959,台郡台新95購03  ,0,0,0,0,0,0,0,0,0,113000,0,0,0,121000,8000,113000,113000
055684,京鼎凱基97購01  ,0,0,0,0,0,0,0,0,0,112000,0,0,0,112000,0,112000,112000
054903,億光康和97購02  ,0,0,0,0,0,0,0,0,0,112000,0,0,0,122000,10000,112000,112000
045963,新光金凱基93購01,0,0,0,0,0,0,0,0,0,112000,0,0,0,122000,10000,112000,112000
051438,喬山元大95購03  ,0,0,0,0,0,0,0,0,0,112000,0,0,0,136000,24000,112000,112000
050946,瑞昱群益95購01  ,0,0,0,0,0,0,0,0,0,112000,0,0,0,119000,7000,112000,112000
049268,聯茂元大94購03  ,0,0,0,0,0,0,0,0,0,112000,0,0,0,180000,68000,112000,112000
054353,世紀鋼國泰98購01,0,0,0,0,0,0,0,0,0,112000,0,0,0,123000,11000,112000,112000
054407,美律國票97購02  ,0,0,0,0,0,0,0,0,0,112000,0,0,0,122000,10000,112000,112000
055091,微星群益97購01  ,0,0,0,0,0,0,0,0,0,111000,0,0,0,111000,0,111000,111000
055663,崇越中信97購01  ,0,0,0,0,0,0,0,0,0,111000,0,0,0,193000,82000,111000,111000
056526,力山凱基98購01  ,0,0,0,0,0,0,0,0,0,111000,0,0,0,111000,0,111000,111000
044016,義隆凱基93購01  ,0,0,0,0,0,0,0,0,0,111000,0,0,0,208000,97000,111000,111000
047552,潤泰全凱基94購02,0,0,0,0,0,0,0,0,0,111000,0,0,0,111000,0,111000,111000
048268,長榮航中信95購01,0,0,0,0,0,0,0,0,0,111000,0,0,0,143000,32000,111000,111000
04953P,台積電群益94售13,0,0,0,0,0,0,0,0,0,111000,0,0,0,171000,60000,111000,111000
051708,創意群益95購02  ,0,0,0,0,0,0,0,0,0,111000,0,0,0,111000,0,111000,111000
051935,味全群益95購01  ,0,0,0,0,0,0,0,0,0,111000,0,0,0,121000,10000,111000,111000
052937,國巨兆豐97購01  ,0,0,0,0,0,0,0,0,0,111000,0,0,0,210000,99000,111000,111000
05286P,矽力統一95售02  ,0,0,0,0,0,0,0,0,0,111000,0,0,0,138000,27000,111000,111000
2340,光磊            ,699050,560850,138200,0,0,0,0,0,0,-28000,8000,5000,3000,120000,151000,-31000,110200
05685P,臺股指元大96售10,0,0,0,0,0,0,0,0,0,110000,0,0,0,200000,90000,110000,110000
056377,智伸科統一9A購01,0,0,0,0,0,0,0,0,0,110000,0,0,0,110000,0,110000,110000
05564P,玉晶光元大97售02,0,0,0,0,0,0,0,0,0,110000,0,0,0,125000,15000,110000,110000
047466,新光金國泰95購01,0,0,0,0,0,0,0,0,0,110000,0,0,0,190000,80000,110000,110000
042895,鴻海永昌93購03  ,0,0,0,0,0,0,0,0,0,110000,0,0,0,160000,50000,110000,110000
041473,滬深2X群益93購01,0,0,0,0,0,0,0,0,0,110000,0,0,0,110000,0,110000,110000
044673,上銀凱基93購04  ,0,0,0,0,0,0,0,0,0,110000,0,0,0,177000,67000,110000,110000
045537,華新群益94購01  ,0,0,0,0,0,0,0,0,0,110000,0,0,0,110000,0,110000,110000
046620,智伸科凱基93購01,0,0,0,0,0,0,0,0,0,110000,0,0,0,140000,30000,110000,110000
047330,康舒元大93購01  ,0,0,0,0,0,0,0,0,0,110000,0,0,0,310000,200000,110000,110000
047033,日月光中信95購01,0,0,0,0,0,0,0,0,0,110000,0,0,0,188000,78000,110000,110000
049120,元油2X元富94購05,0,0,0,0,0,0,0,0,0,110000,0,0,0,156000,46000,110000,110000
050174,技嘉元大94購01  ,0,0,0,0,0,0,0,0,0,110000,0,0,0,136000,26000,110000,110000
051124,創意群益95購01  ,0,0,0,0,0,0,0,0,0,110000,0,0,0,140000,30000,110000,110000
051149,可成凱基95購04  ,0,0,0,0,0,0,0,0,0,110000,0,0,0,186000,76000,110000,110000
049798,台積電元大94購18,0,0,0,0,0,0,0,0,0,110000,0,0,0,335000,225000,110000,110000
052831,華固群益96購01  ,0,0,0,0,0,0,0,0,0,110000,0,0,0,110000,0,110000,110000
052004,泰碩國泰97購03  ,0,0,0,0,0,0,0,0,0,110000,0,0,0,110000,0,110000,110000
054128,台積電元大97購10,0,0,0,0,0,0,0,0,0,110000,0,0,0,207000,97000,110000,110000
06136P,華新科國泰99售02,0,0,0,0,0,0,0,0,0,110000,0,0,0,313000,203000,110000,110000
054972,聯茂元大97購02  ,0,0,0,0,0,0,0,0,0,109000,0,0,0,241000,132000,109000,109000
054761,台光電國票98購02,0,0,0,0,0,0,0,0,0,109000,0,0,0,179000,70000,109000,109000
048560,聯發科元大94購01,0,0,0,0,0,0,0,0,0,109000,0,0,0,119000,10000,109000,109000
047118,欣興元大93購06  ,0,0,0,0,0,0,0,0,0,109000,0,0,0,109000,0,109000,109000
050823,信邦凱基95購01  ,0,0,0,0,0,0,0,0,0,109000,0,0,0,174000,65000,109000,109000
049148,全新元大95購01  ,0,0,0,0,0,0,0,0,0,109000,0,0,0,110000,1000,109000,109000
049021,慧洋群益94購01  ,0,0,0,0,0,0,0,0,0,109000,0,0,0,109000,0,109000,109000
050633,義隆群益96購02  ,0,0,0,0,0,0,0,0,0,109000,0,0,0,192000,83000,109000,109000
054079,鴻海中信98購02  ,0,0,0,0,0,0,0,0,0,109000,0,0,0,112000,3000,109000,109000
053385,聯詠元大96購02  ,0,0,0,0,0,0,0,0,0,109000,0,0,0,230000,121000,109000,109000
053330,燿華永豐96購03  ,0,0,0,0,0,0,0,0,0,109000,0,0,0,109000,0,109000,109000
052173,廣達元大95購02  ,0,0,0,0,0,0,0,0,0,109000,0,0,0,152000,43000,109000,109000
053051,楠梓電國票97購01,0,0,0,0,0,0,0,0,0,109000,0,0,0,109000,0,109000,109000
055580,南茂統一97購01  ,0,0,0,0,0,0,0,0,0,108000,0,0,0,108000,0,108000,108000
050437,聯詠凱基94購04  ,0,0,0,0,0,0,0,0,0,108000,0,0,0,130000,22000,108000,108000
04568P,瑞昱兆豐94售02  ,0,0,0,0,0,0,0,0,0,108000,0,0,0,110000,2000,108000,108000
046432,宏達電中信94購01,0,0,0,0,0,0,0,0,0,108000,0,0,0,108000,0,108000,108000
050337,南電國泰95購01  ,0,0,0,0,0,0,0,0,0,108000,0,0,0,145000,37000,108000,108000
050301,矽創凱基94購03  ,0,0,0,0,0,0,0,0,0,108000,0,0,0,114000,6000,108000,108000
052744,聯詠元大97購01  ,0,0,0,0,0,0,0,0,0,108000,0,0,0,395000,287000,108000,108000
052681,T50反1元大98購02,0,0,0,0,0,0,0,0,0,108000,0,0,0,110000,2000,108000,108000
051751,聯茂富邦95購01  ,0,0,0,0,0,0,0,0,0,108000,0,0,0,108000,0,108000,108000
055639,上銀元富97購02  ,0,0,0,0,0,0,0,0,0,107000,0,0,0,559000,452000,107000,107000
055785,祥碩凱基97購02  ,0,0,0,0,0,0,0,0,0,107000,0,0,0,160000,53000,107000,107000
051543,鈺齊國票96購01  ,0,0,0,0,0,0,0,0,0,107000,0,0,0,113000,6000,107000,107000
052598,滬深2X元大96購05,0,0,0,0,0,0,0,0,0,107000,0,0,0,110000,3000,107000,107000
053184,世紀鋼元富96購01,0,0,0,0,0,0,0,0,0,107000,0,0,0,107000,0,107000,107000
054380,世芯群益97購02  ,0,0,0,0,0,0,0,0,0,107000,0,0,0,159000,52000,107000,107000
054932,台肥元大97購01  ,0,0,0,0,0,0,0,0,0,106000,0,0,0,212000,106000,106000,106000
055054,群光永豐97購01  ,0,0,0,0,0,0,0,0,0,106000,0,0,0,106000,0,106000,106000
055898,訊芯第一97購01  ,0,0,0,0,0,0,0,0,0,106000,0,0,0,106000,0,106000,106000
056076,超眾元大97購05  ,0,0,0,0,0,0,0,0,0,106000,0,0,0,122000,16000,106000,106000
056648,牧德凱基99購02  ,0,0,0,0,0,0,0,0,0,106000,0,0,0,115000,9000,106000,106000
050353,華擎群益95購01  ,0,0,0,0,0,0,0,0,0,106000,0,0,0,108000,2000,106000,106000
049495,欣興元大94購06  ,0,0,0,0,0,0,0,0,0,106000,0,0,0,106000,0,106000,106000
047292,台光電元富96購01,0,0,0,0,0,0,0,0,0,106000,0,0,0,111000,5000,106000,106000
049032,百和群益94購04  ,0,0,0,0,0,0,0,0,0,106000,0,0,0,106000,0,106000,106000
051072,強茂國票95購02  ,0,0,0,0,0,0,0,0,0,106000,0,0,0,106000,0,106000,106000
049335,聯電統一97購01  ,0,0,0,0,0,0,0,0,0,106000,0,0,0,116000,10000,106000,106000
049285,宏碁兆豐94購01  ,0,0,0,0,0,0,0,0,0,106000,0,0,0,266000,160000,106000,106000
054095,同欣電群益98購03,0,0,0,0,0,0,0,0,0,106000,0,0,0,149000,43000,106000,106000
053801,台積電凱基96購18,0,0,0,0,0,0,0,0,0,106000,0,0,0,108000,2000,106000,106000
052806,玉晶光元大98購04,0,0,0,0,0,0,0,0,0,106000,0,0,0,188000,82000,106000,106000
06254P,臺股指群益97售07,0,0,0,0,0,0,0,0,0,106000,0,0,0,106000,0,106000,106000
05837P,臺股指富邦96售04,0,0,0,0,0,0,0,0,0,105000,0,0,0,155000,50000,105000,105000
055956,瑞昱元大97購05  ,0,0,0,0,0,0,0,0,0,105000,0,0,0,140000,35000,105000,105000
056231,嘉聯益凱基97購02,0,0,0,0,0,0,0,0,0,105000,0,0,0,145000,40000,105000,105000
055327,致新國票98購01  ,0,0,0,0,0,0,0,0,0,105000,0,0,0,105000,0,105000,105000
055169,光罩統一99購01  ,0,0,0,0,0,0,0,0,0,105000,0,0,0,105000,0,105000,105000
047271,華通永豐93購01  ,0,0,0,0,0,0,0,0,0,105000,0,0,0,105000,0,105000,105000
049198,聯鈞永豐94購01  ,0,0,0,0,0,0,0,0,0,105000,0,0,0,125000,20000,105000,105000
048926,燿華永豐95購01  ,0,0,0,0,0,0,0,0,0,105000,0,0,0,115000,10000,105000,105000
051602,南茂兆豐96購01  ,0,0,0,0,0,0,0,0,0,105000,0,0,0,105000,0,105000,105000
052351,中環元富95購01  ,0,0,0,0,0,0,0,0,0,105000,0,0,0,105000,0,105000,105000
052456,滬深2X元富9B購03,0,0,0,0,0,0,0,0,0,105000,0,0,0,150000,45000,105000,105000
6715,嘉基            ,53000,117000,-64000,0,0,0,170000,0,170000,-1000,13000,14000,-1000,0,0,0,105000
054742,京鼎凱基99購01  ,0,0,0,0,0,0,0,0,0,104000,0,0,0,104000,0,104000,104000
056395,玉晶光永豐9B購01,0,0,0,0,0,0,0,0,0,104000,0,0,0,104000,0,104000,104000
03020X,元展20          ,0,0,0,0,0,0,0,0,0,104000,0,0,0,104000,0,104000,104000
048426,超眾元富93購01  ,0,0,0,0,0,0,0,0,0,104000,0,0,0,150000,46000,104000,104000
053394,鴻海中信9A購01  ,0,0,0,0,0,0,0,0,0,104000,0,0,0,118000,14000,104000,104000
054071,泰鼎國泰97購02  ,0,0,0,0,0,0,0,0,0,104000,0,0,0,171000,67000,104000,104000
054053,聯茂元大96購01  ,0,0,0,0,0,0,0,0,0,104000,0,0,0,133000,29000,104000,104000
053969,瑞昱元大97購01  ,0,0,0,0,0,0,0,0,0,104000,0,0,0,315000,211000,104000,104000
054459,鈺齊群益96購01  ,0,0,0,0,0,0,0,0,0,104000,0,0,0,187000,83000,104000,104000
056426,上証2X凱基9A購01,0,0,0,0,0,0,0,0,0,103000,0,0,0,103000,0,103000,103000
056312,茂林元大98購01  ,0,0,0,0,0,0,0,0,0,103000,0,0,0,104000,1000,103000,103000
055840,南亞科元大97購03,0,0,0,0,0,0,0,0,0,103000,0,0,0,310000,207000,103000,103000
045031,上銀群益93購02  ,0,0,0,0,0,0,0,0,0,103000,0,0,0,116000,13000,103000,103000
043580,大立光元富94購01,0,0,0,0,0,0,0,0,0,103000,0,0,0,111000,8000,103000,103000
047229,大立光凱基93購18,0,0,0,0,0,0,0,0,0,103000,0,0,0,103000,0,103000,103000
047194,世紀鋼元大96購01,0,0,0,0,0,0,0,0,0,103000,0,0,0,103000,0,103000,103000
049519,新光金國票95購03,0,0,0,0,0,0,0,0,0,103000,0,0,0,103000,0,103000,103000
050687,上銀日盛94購01  ,0,0,0,0,0,0,0,0,0,103000,0,0,0,157000,54000,103000,103000
051108,鴻海統一96購02  ,0,0,0,0,0,0,0,0,0,103000,0,0,0,108000,5000,103000,103000
050189,旭富元大94購01  ,0,0,0,0,0,0,0,0,0,103000,0,0,0,103000,0,103000,103000
048688,瑞昱群益94購01  ,0,0,0,0,0,0,0,0,0,103000,0,0,0,113000,10000,103000,103000
048713,美利達康和94購01,0,0,0,0,0,0,0,0,0,103000,0,0,0,103000,0,103000,103000
053403,彩晶群益98購01  ,0,0,0,0,0,0,0,0,0,103000,0,0,0,103000,0,103000,103000
05356P,臺股指元富95售10,0,0,0,0,0,0,0,0,0,103000,0,0,0,328000,225000,103000,103000
052313,聯電元大98購01  ,0,0,0,0,0,0,0,0,0,103000,0,0,0,107000,4000,103000,103000
053040,全新凱基98購01  ,0,0,0,0,0,0,0,0,0,103000,0,0,0,103000,0,103000,103000
054539,欣興國票98購01  ,0,0,0,0,0,0,0,0,0,102000,0,0,0,117000,15000,102000,102000
050433,華新科凱基94購11,0,0,0,0,0,0,0,0,0,102000,0,0,0,110000,8000,102000,102000
04763P,臺股指凱基96售05,0,0,0,0,0,0,0,0,0,102000,0,0,0,102000,0,102000,102000
048431,瑞昱國票94購01  ,0,0,0,0,0,0,0,0,0,102000,0,0,0,159000,57000,102000,102000
049307,上銀凱基94購03  ,0,0,0,0,0,0,0,0,0,102000,0,0,0,151000,49000,102000,102000
05266P,華新科元大95售11,0,0,0,0,0,0,0,0,0,102000,0,0,0,202000,100000,102000,102000
052405,聯茂凱基95購01  ,0,0,0,0,0,0,0,0,0,102000,0,0,0,103000,1000,102000,102000
05186P,鈺齊中信95售02  ,0,0,0,0,0,0,0,0,0,102000,0,0,0,102000,0,102000,102000
053743,康控國票97購02  ,0,0,0,0,0,0,0,0,0,102000,0,0,0,132000,30000,102000,102000
054240,訊芯群益96購03  ,0,0,0,0,0,0,0,0,0,102000,0,0,0,124000,22000,102000,102000
06347P,祥碩元富97售02  ,0,0,0,0,0,0,0,0,0,102000,0,0,0,1197000,1095000,102000,102000
055286,晶技元大98購03  ,0,0,0,0,0,0,0,0,0,101000,0,0,0,101000,0,101000,101000
056075,瀚宇博元大97購03,0,0,0,0,0,0,0,0,0,101000,0,0,0,106000,5000,101000,101000
05980P,台積電永昌96售09,0,0,0,0,0,0,0,0,0,101000,0,0,0,1794000,1693000,101000,101000
056707,鴻海富邦99購03  ,0,0,0,0,0,0,0,0,0,101000,0,0,0,101000,0,101000,101000
047773,超眾元大96購01  ,0,0,0,0,0,0,0,0,0,101000,0,0,0,121000,20000,101000,101000
044167,大立光元大93購03,0,0,0,0,0,0,0,0,0,101000,0,0,0,101000,0,101000,101000
03645C,臺股指凱基96牛27,0,0,0,0,0,0,0,0,0,101000,0,0,0,101000,0,101000,101000
048732,台勝科麥證95購01,0,0,0,101000,0,101000,0,0,0,101000,0,0,0,101000,0,101000,101000
050168,緯創富邦95購01  ,0,0,0,0,0,0,0,0,0,101000,0,0,0,101000,0,101000,101000
050987,台泥富邦95購01  ,0,0,0,0,0,0,0,0,0,101000,0,0,0,101000,0,101000,101000
051396,健鼎兆豐95購01  ,0,0,0,0,0,0,0,0,0,101000,0,0,0,101000,0,101000,101000
054140,智易元大97購03  ,0,0,0,0,0,0,0,0,0,101000,0,0,0,101000,0,101000,101000
052797,樺漢兆豐96購01  ,0,0,0,0,0,0,0,0,0,101000,0,0,0,101000,0,101000,101000
053093,緯穎元大96購06  ,0,0,0,0,0,0,0,0,0,101000,0,0,0,205000,104000,101000,101000
06081P,深中小元大97售02,0,0,0,0,0,0,0,0,0,101000,0,0,0,780000,679000,101000,101000
06017P,亞光凱基96售04  ,0,0,0,0,0,0,0,0,0,101000,0,0,0,101000,0,101000,101000
2395,研華            ,616500,529149,87351,0,0,0,0,0,0,13000,15000,2000,13000,0,0,0,100351
056543,京鼎凱基98購01  ,0,0,0,0,0,0,0,0,0,100000,0,0,0,100000,0,100000,100000
05912P,和大元大96售01  ,0,0,0,0,0,0,0,0,0,100000,0,0,0,200000,100000,100000,100000
05701P,彩晶凱基96售01  ,0,0,0,0,0,0,0,0,0,100000,0,0,0,100000,0,100000,100000
05740P,宏達電元富96售01,0,0,0,0,0,0,0,0,0,100000,0,0,0,111000,11000,100000,100000
056054,亞德客元大97購05,0,0,0,0,0,0,0,0,0,100000,0,0,0,186000,86000,100000,100000
056055,國巨元大97購15  ,0,0,0,0,0,0,0,0,0,100000,0,0,0,100000,0,100000,100000
056024,大立光群益97購05,0,0,0,0,0,0,0,0,0,100000,0,0,0,100000,0,100000,100000
055856,新唐元大97購03  ,0,0,0,0,0,0,0,0,0,100000,0,0,0,100000,0,100000,100000
056304,創意元大97購03  ,0,0,0,0,0,0,0,0,0,100000,0,0,0,100000,0,100000,100000
056343,高鐵凱基98購02  ,0,0,0,0,0,0,0,0,0,100000,0,0,0,100000,0,100000,100000
055358,臻鼎凱基97購01  ,0,0,0,0,0,0,0,0,0,100000,0,0,0,100000,0,100000,100000
055404,超眾元富97購01  ,0,0,0,0,0,0,0,0,0,100000,0,0,0,100000,0,100000,100000
055582,亞德客元大97購01,0,0,0,0,0,0,0,0,0,100000,0,0,0,264000,164000,100000,100000
055564,茂林凱基98購01  ,0,0,0,0,0,0,0,0,0,100000,0,0,0,113000,13000,100000,100000
054776,矽創國票98購01  ,0,0,0,0,0,0,0,0,0,100000,0,0,0,100000,0,100000,100000
054806,台化元大9A購01  ,0,0,0,0,0,0,0,0,0,100000,0,0,0,100000,0,100000,100000
055078,亞泥中信98購01  ,0,0,0,0,0,0,0,0,0,100000,0,0,0,190000,90000,100000,100000
055106,台積電凱基98購05,0,0,0,0,0,0,0,0,0,100000,0,0,0,125000,25000,100000,100000
054900,金寶康和97購01  ,0,0,0,0,0,0,0,0,0,100000,0,0,0,331000,231000,100000,100000
03810P,大立光富邦98售01,0,0,0,0,0,0,0,0,0,100000,0,0,0,100000,0,100000,100000
044637,滬深2X元富94購01,0,0,0,0,0,0,0,0,0,100000,0,0,0,100000,0,100000,100000
03969P,華新科國票94售01,0,0,0,0,0,0,0,0,0,100000,0,0,0,100000,0,100000,100000
04005P,樺漢凱基93售02  ,0,0,0,0,0,0,0,0,0,100000,0,0,0,100000,0,100000,100000
044022,健策凱基93購02  ,0,0,0,0,0,0,0,0,0,100000,0,0,0,110000,10000,100000,100000
046416,聯詠元大92購05  ,0,0,0,0,0,0,0,0,0,100000,0,0,0,100000,0,100000,100000
042902,光寶科元大94購01,0,0,0,0,0,0,0,0,0,100000,0,0,0,101000,1000,100000,100000
045355,聯鈞凱基92購01  ,0,0,0,0,0,0,0,0,0,100000,0,0,0,110000,10000,100000,100000
04750P,臺股指元大94售26,0,0,0,0,0,0,0,0,0,100000,0,0,0,100000,0,100000,100000
047555,欣興凱基93購01  ,0,0,0,0,0,0,0,0,0,100000,0,0,0,100000,0,100000,100000
047623,世紀鋼凱基94購02,0,0,0,0,0,0,0,0,0,100000,0,0,0,100000,0,100000,100000
047686,元油反富邦94購02,0,0,0,0,0,0,0,0,0,100000,0,0,0,100000,0,100000,100000
047838,亞光元大93購03  ,0,0,0,0,0,0,0,0,0,100000,0,0,0,100000,0,100000,100000
046335,矽創元大92購04  ,0,0,0,0,0,0,0,0,0,100000,0,0,0,100000,0,100000,100000
04589P,祥碩永豐94售01  ,0,0,0,0,0,0,0,0,0,100000,0,0,0,100000,0,100000,100000
050699,京鼎凱基96購01  ,0,0,0,0,0,0,0,0,0,100000,0,0,0,142000,42000,100000,100000
047042,佐登群益93購01  ,0,0,0,0,0,0,0,0,0,100000,0,0,0,100000,0,100000,100000
047276,中工永豐93購01  ,0,0,0,0,0,0,0,0,0,100000,0,0,0,100000,0,100000,100000
04695P,正崴康和94售01  ,0,0,0,0,0,0,0,0,0,100000,0,0,0,100000,0,100000,100000
047075,群創兆豐93購01  ,0,0,0,0,0,0,0,0,0,100000,0,0,0,100000,0,100000,100000
047091,南茂元富93購01  ,0,0,0,0,0,0,0,0,0,100000,0,0,0,100000,0,100000,100000
051414,新光金國票95購04,0,0,0,0,0,0,0,0,0,100000,0,0,0,100000,0,100000,100000
05154P,台積電兆豐95售05,0,0,0,0,0,0,0,0,0,100000,0,0,0,104000,4000,100000,100000
051512,超眾麥證95購01  ,0,0,0,100000,0,100000,0,0,0,100000,0,0,0,100000,0,100000,100000
051728,道瓊反國票97購01,0,0,0,0,0,0,0,0,0,100000,0,0,0,100000,0,100000,100000
047974,新光金兆豐93購01,0,0,0,0,0,0,0,0,0,100000,0,0,0,100000,0,100000,100000
047999,聯發科元大93購22,0,0,0,0,0,0,0,0,0,100000,0,0,0,100000,0,100000,100000
049982,嘉晶凱基94購01  ,0,0,0,0,0,0,0,0,0,100000,0,0,0,110000,10000,100000,100000
048952,川湖康和94購01  ,0,0,0,0,0,0,0,0,0,100000,0,0,0,110000,10000,100000,100000
048908,慧洋富邦95購01  ,0,0,0,0,0,0,0,0,0,100000,0,0,0,100000,0,100000,100000
051098,矽格元大95購01  ,0,0,0,0,0,0,0,0,0,100000,0,0,0,100000,0,100000,100000
051146,旺宏凱基95購04  ,0,0,0,0,0,0,0,0,0,100000,0,0,0,144000,44000,100000,100000
04966P,台表科元大94售04,0,0,0,0,0,0,0,0,0,100000,0,0,0,100000,0,100000,100000
049762,華邦電國泰95購01,0,0,0,0,0,0,0,0,0,100000,0,0,0,100000,0,100000,100000
048230,瀚宇博凱基93購03,0,0,0,0,0,0,0,0,0,100000,0,0,0,100000,0,100000,100000
051195,台郡中信95購01  ,0,0,0,0,0,0,0,0,0,100000,0,0,0,100000,0,100000,100000
052996,聯電康和96購01  ,0,0,0,0,0,0,0,0,0,100000,0,0,0,100000,0,100000,100000
052835,滬深2X國泰98購01,0,0,0,0,0,0,0,0,0,100000,0,0,0,100000,0,100000,100000
052848,聯發科統一96購03,0,0,0,0,0,0,0,0,0,100000,0,0,0,100000,0,100000,100000
052849,可成統一97購01  ,0,0,0,0,0,0,0,0,0,100000,0,0,0,100000,0,100000,100000
052741,聯發科元大96購08,0,0,0,0,0,0,0,0,0,100000,0,0,0,127000,27000,100000,100000
052531,台積電國泰96購06,0,0,0,0,0,0,0,0,0,100000,0,0,0,101000,1000,100000,100000
05181P,健策凱基95售01  ,0,0,0,0,0,0,0,0,0,100000,0,0,0,120000,20000,100000,100000
051804,新光金日盛95購01,0,0,0,0,0,0,0,0,0,100000,0,0,0,100000,0,100000,100000
052014,光罩永豐95購01  ,0,0,0,0,0,0,0,0,0,100000,0,0,0,106000,6000,100000,100000
051981,南茂凱基96購01  ,0,0,0,0,0,0,0,0,0,100000,0,0,0,100000,0,100000,100000
052069,聯茂兆豐96購01  ,0,0,0,0,0,0,0,0,0,100000,0,0,0,100000,0,100000,100000
052027,智原群益95購01  ,0,0,0,0,0,0,0,0,0,100000,0,0,0,150000,50000,100000,100000
052103,台積電兆豐95購06,0,0,0,0,0,0,0,0,0,100000,0,0,0,354000,254000,100000,100000
052451,旭富元大95購02  ,0,0,0,0,0,0,0,0,0,100000,0,0,0,100000,0,100000,100000
052443,台積電元大95購23,0,0,0,0,0,0,0,0,0,100000,0,0,0,329000,229000,100000,100000
052153,GIS富邦96購02   ,0,0,0,0,0,0,0,0,0,100000,0,0,0,100000,0,100000,100000
054144,康控元大97購02  ,0,0,0,0,0,0,0,0,0,100000,0,0,0,100000,0,100000,100000
053983,樺漢元大97購02  ,0,0,0,0,0,0,0,0,0,100000,0,0,0,382000,282000,100000,100000
053935,華通元富96購02  ,0,0,0,0,0,0,0,0,0,100000,0,0,0,100000,0,100000,100000
054271,中石化中信99購01,0,0,0,0,0,0,0,0,0,100000,0,0,0,100000,0,100000,100000
054294,世芯元大96購02  ,0,0,0,0,0,0,0,0,0,100000,0,0,0,118000,18000,100000,100000
054492,嘉聯益台新96購01,0,0,0,0,0,0,0,0,0,100000,0,0,0,100000,0,100000,100000
053618,新唐群益96購01  ,0,0,0,0,0,0,0,0,0,100000,0,0,0,100000,0,100000,100000
053497,新光金兆豐97購01,0,0,0,0,0,0,0,0,0,100000,0,0,0,100000,0,100000,100000
053355,超眾兆豐97購01  ,0,0,0,0,0,0,0,0,0,100000,0,0,0,119000,19000,100000,100000
06321P,台積電統一98售03,0,0,0,0,0,0,0,0,0,100000,0,0,0,100000,0,100000,100000
06479P,聯發科中信99售02,0,0,0,0,0,0,0,0,0,100000,0,0,0,100000,0,100000,100000
050735,亞光台新94購01  ,0,0,0,0,0,0,0,0,0,99000,0,0,0,99000,0,99000,99000
046108,A50正2元大95購02,0,0,0,0,0,0,0,0,0,99000,0,0,0,99000,0,99000,99000
046369,同欣電日盛92購01,0,0,0,0,0,0,0,0,0,99000,0,0,0,99000,0,99000,99000
046592,南電元大92購03  ,0,0,0,0,0,0,0,0,0,99000,0,0,0,99000,0,99000,99000
044254,深中小元大94購01,0,0,0,0,0,0,0,0,0,99000,0,0,0,400000,301000,99000,99000
051130,百和群益96購01  ,0,0,0,0,0,0,0,0,0,99000,0,0,0,110000,11000,99000,99000
048656,大立光元富93購05,0,0,0,0,0,0,0,0,0,99000,0,0,0,119000,20000,99000,99000
049350,麗豐康和94購01  ,0,0,0,0,0,0,0,0,0,99000,0,0,0,99000,0,99000,99000
051033,台積電兆豐95購03,0,0,0,0,0,0,0,0,0,99000,0,0,0,111000,12000,99000,99000
051638,聯茂國票96購01  ,0,0,0,0,0,0,0,0,0,99000,0,0,0,194000,95000,99000,99000
054172,易華電凱基98購01,0,0,0,0,0,0,0,0,0,99000,0,0,0,99000,0,99000,99000
052210,華夏元大95購01  ,0,0,0,0,0,0,0,0,0,99000,0,0,0,168000,69000,99000,99000
054875,群電群益97購01  ,0,0,0,0,0,0,0,0,0,98000,0,0,0,98000,0,98000,98000
055577,晶技統一97購02  ,0,0,0,0,0,0,0,0,0,98000,0,0,0,108000,10000,98000,98000
055535,緯創群益98購01  ,0,0,0,0,0,0,0,0,0,98000,0,0,0,98000,0,98000,98000
056399,上証2X群益9C購01,0,0,0,0,0,0,0,0,0,98000,0,0,0,190000,92000,98000,98000
056385,創意國泰99購01  ,0,0,0,0,0,0,0,0,0,98000,0,0,0,98000,0,98000,98000
056558,台達電群益98購01,0,0,0,0,0,0,0,0,0,98000,0,0,0,108000,10000,98000,98000
04410P,大立光統一94售05,0,0,0,0,0,0,0,0,0,98000,0,0,0,108000,10000,98000,98000
050674,瑞昱富邦94購02  ,0,0,0,0,0,0,0,0,0,98000,0,0,0,98000,0,98000,98000
047058,聯茂國票94購01  ,0,0,0,0,0,0,0,0,0,98000,0,0,0,98000,0,98000,98000
050958,日月光台新95購01,0,0,0,0,0,0,0,0,0,98000,0,0,0,98000,0,98000,98000
050880,大立光元富95購03,0,0,0,0,0,0,0,0,0,98000,0,0,0,98000,0,98000,98000
048184,達運群益93購01  ,0,0,0,0,0,0,0,0,0,98000,0,0,0,98000,0,98000,98000
048117,南電群益93購02  ,0,0,0,0,0,0,0,0,0,98000,0,0,0,98000,0,98000,98000
049741,創意群益94購02  ,0,0,0,0,0,0,0,0,0,98000,0,0,0,98000,0,98000,98000
052414,聯電麥證95購01  ,0,0,0,150000,52000,98000,0,0,0,98000,0,0,0,150000,52000,98000,98000
052102,台泥兆豐96購01  ,0,0,0,0,0,0,0,0,0,98000,0,0,0,108000,10000,98000,98000
052091,緯創元大95購04  ,0,0,0,0,0,0,0,0,0,98000,0,0,0,118000,20000,98000,98000
051892,台光電元富95購03,0,0,0,0,0,0,0,0,0,98000,0,0,0,98000,0,98000,98000
052594,友訊群益98購01  ,0,0,0,0,0,0,0,0,0,98000,0,0,0,348000,250000,98000,98000
052714,義隆凱基96購02  ,0,0,0,0,0,0,0,0,0,98000,0,0,0,312000,214000,98000,98000
052974,瀚宇博群益96購01,0,0,0,0,0,0,0,0,0,98000,0,0,0,120000,22000,98000,98000
054456,華泰群益99購01  ,0,0,0,0,0,0,0,0,0,98000,0,0,0,110000,12000,98000,98000
053235,智原永豐96購01  ,0,0,0,0,0,0,0,0,0,98000,0,0,0,98000,0,98000,98000
053515,致伸群益96購02  ,0,0,0,0,0,0,0,0,0,98000,0,0,0,98000,0,98000,98000
053384,聯發科元大96購13,0,0,0,0,0,0,0,0,0,98000,0,0,0,778000,680000,98000,98000
053455,台光電元富96購02,0,0,0,0,0,0,0,0,0,98000,0,0,0,98000,0,98000,98000
056266,開發金統一9A購01,0,0,0,0,0,0,0,0,0,97000,0,0,0,97000,0,97000,97000
056162,祥碩凱基97購03  ,0,0,0,0,0,0,0,0,0,97000,0,0,0,100000,3000,97000,97000
055466,台達電凱基97購03,0,0,0,0,0,0,0,0,0,97000,0,0,0,164000,67000,97000,97000
055092,開發金群益9B購01,0,0,0,0,0,0,0,0,0,97000,0,0,0,171000,74000,97000,97000
047242,上銀群益93購04  ,0,0,0,0,0,0,0,0,0,97000,0,0,0,129000,32000,97000,97000
049398,微星群益94購02  ,0,0,0,0,0,0,0,0,0,97000,0,0,0,115000,18000,97000,97000
048592,漢唐群益93購04  ,0,0,0,0,0,0,0,0,0,97000,0,0,0,100000,3000,97000,97000
048705,GIS國票95購01   ,0,0,0,0,0,0,0,0,0,97000,0,0,0,100000,3000,97000,97000
05289P,鴻海永豐95售05  ,0,0,0,0,0,0,0,0,0,97000,0,0,0,773000,676000,97000,97000
053052,旺宏國票97購02  ,0,0,0,0,0,0,0,0,0,97000,0,0,0,122000,25000,97000,97000
052372,台泥元大95購02  ,0,0,0,0,0,0,0,0,0,97000,0,0,0,165000,68000,97000,97000
054921,文曄凱基97購01  ,0,0,0,0,0,0,0,0,0,96000,0,0,0,96000,0,96000,96000
054544,統一中信97購01  ,0,0,0,0,0,0,0,0,0,96000,0,0,0,96000,0,96000,96000
055598,欣興元大97購03  ,0,0,0,0,0,0,0,0,0,96000,0,0,0,103000,7000,96000,96000
056313,聯茂元大98購01  ,0,0,0,0,0,0,0,0,0,96000,0,0,0,316000,220000,96000,96000
045627,聯電凱基93購03  ,0,0,0,0,0,0,0,0,0,96000,0,0,0,120000,24000,96000,96000
049669,訊芯國泰95購01  ,0,0,0,0,0,0,0,0,0,96000,0,0,0,96000,0,96000,96000
049286,美律兆豐94購01  ,0,0,0,0,0,0,0,0,0,96000,0,0,0,116000,20000,96000,96000
048271,可成富邦95購02  ,0,0,0,0,0,0,0,0,0,96000,0,0,0,200000,104000,96000,96000
048291,台積電群益93購09,0,0,0,0,0,0,0,0,0,96000,0,0,0,320000,224000,96000,96000
049159,同欣電中信96購01,0,0,0,0,0,0,0,0,0,96000,0,0,0,134000,38000,96000,96000
052342,茂林凱基96購01  ,0,0,0,0,0,0,0,0,0,96000,0,0,0,225000,129000,96000,96000
052084,台泥元大95購01  ,0,0,0,0,0,0,0,0,0,96000,0,0,0,229000,133000,96000,96000
052874,超眾凱基96購01  ,0,0,0,0,0,0,0,0,0,96000,0,0,0,96000,0,96000,96000
3605,宏致            ,342000,246000,96000,0,0,0,0,0,0,0,0,0,0,0,0,0,96000
056565,欣興群益98購03  ,0,0,0,0,0,0,0,0,0,95000,0,0,0,163000,68000,95000,95000
05765P,臺股指永豐96售01,0,0,0,0,0,0,0,0,0,95000,0,0,0,98000,3000,95000,95000
054615,牧德永豐98購01  ,0,0,0,0,0,0,0,0,0,95000,0,0,0,172000,77000,95000,95000
054587,玉晶光國泰99購01,0,0,0,0,0,0,0,0,0,95000,0,0,0,115000,20000,95000,95000
046583,聯發科元大92購24,0,0,0,0,0,0,0,0,0,95000,0,0,0,100000,5000,95000,95000
045386,新光金元大93購02,0,0,0,0,0,0,0,0,0,95000,0,0,0,95000,0,95000,95000
049534,華擎永豐94購02  ,0,0,0,0,0,0,0,0,0,95000,0,0,0,102000,7000,95000,95000
045165,台虹國泰93購01  ,0,0,0,0,0,0,0,0,0,95000,0,0,0,195000,100000,95000,95000
047445,創意元大93購04  ,0,0,0,0,0,0,0,0,0,95000,0,0,0,95000,0,95000,95000
050226,華新科中信94購01,0,0,0,0,0,0,0,0,0,95000,0,0,0,125000,30000,95000,95000
048132,冠德國票94購01  ,0,0,0,0,0,0,0,0,0,95000,0,0,0,100000,5000,95000,95000
050849,智伸科國票95購01,0,0,0,0,0,0,0,0,0,95000,0,0,0,98000,3000,95000,95000
049564,聯電統一94購03  ,0,0,0,0,0,0,0,0,0,95000,0,0,0,95000,0,95000,95000
052637,欣興凱基97購01  ,0,0,0,0,0,0,0,0,0,95000,0,0,0,100000,5000,95000,95000
051771,上銀中信95購01  ,0,0,0,0,0,0,0,0,0,95000,0,0,0,116000,21000,95000,95000
052259,深100富邦95購01 ,0,0,0,0,0,0,0,0,0,95000,0,0,0,100000,5000,95000,95000
054432,台積電台新96購05,0,0,0,0,0,0,0,0,0,95000,0,0,0,200000,105000,95000,95000
6670,復盛應用        ,213000,108000,105000,0,0,0,0,0,0,-10000,0,0,0,0,10000,-10000,95000
054697,凌華永豐97購01  ,0,0,0,0,0,0,0,0,0,94000,0,0,0,130000,36000,94000,94000
056141,聯茂元大97購05  ,0,0,0,0,0,0,0,0,0,94000,0,0,0,97000,3000,94000,94000
05584P,臺股指凱基96售13,0,0,0,0,0,0,0,0,0,94000,0,0,0,180000,86000,94000,94000
055992,智原台新97購02  ,0,0,0,0,0,0,0,0,0,94000,0,0,0,104000,10000,94000,94000
046443,超眾兆豐93購01  ,0,0,0,0,0,0,0,0,0,94000,0,0,0,100000,6000,94000,94000
049529,華新科中信95購01,0,0,0,0,0,0,0,0,0,94000,0,0,0,215000,121000,94000,94000
047166,台達電康和93購01,0,0,0,0,0,0,0,0,0,94000,0,0,0,94000,0,94000,94000
046717,世紀鋼國泰94購01,0,0,0,0,0,0,0,0,0,94000,0,0,0,94000,0,94000,94000
051566,鴻海富邦95購05  ,0,0,0,0,0,0,0,0,0,94000,0,0,0,94000,0,94000,94000
053928,智易國票97購03  ,0,0,0,0,0,0,0,0,0,94000,0,0,0,94000,0,94000,94000
053507,百和兆豐96購01  ,0,0,0,0,0,0,0,0,0,94000,0,0,0,114000,20000,94000,94000
051988,台光電元大95購01,0,0,0,0,0,0,0,0,0,94000,0,0,0,115000,21000,94000,94000
052851,滬深2X元富96購02,0,0,0,0,0,0,0,0,0,94000,0,0,0,105000,11000,94000,94000
06338P,亞德客統一97售02,0,0,0,0,0,0,0,0,0,94000,0,0,0,210000,116000,94000,94000
055958,台光電元大97購02,0,0,0,0,0,0,0,0,0,93000,0,0,0,93000,0,93000,93000
054589,聯鈞國泰99購01  ,0,0,0,0,0,0,0,0,0,93000,0,0,0,138000,45000,93000,93000
054951,大毅元大97購01  ,0,0,0,0,0,0,0,0,0,93000,0,0,0,110000,17000,93000,93000
055306,燿華群益97購01  ,0,0,0,0,0,0,0,0,0,93000,0,0,0,93000,0,93000,93000
047137,健策凱基94購01  ,0,0,0,0,0,0,0,0,0,93000,0,0,0,96000,3000,93000,93000
00652,富邦印度        ,43000,0,43000,0,0,0,0,0,0,50000,0,0,0,83000,33000,50000,93000
051567,台積電富邦95購06,0,0,0,0,0,0,0,0,0,93000,0,0,0,93000,0,93000,93000
050072,京鼎凱基94購02  ,0,0,0,0,0,0,0,0,0,93000,0,0,0,104000,11000,93000,93000
049635,臺股指群益94購08,0,0,0,0,0,0,0,0,0,93000,0,0,0,100000,7000,93000,93000
048337,致茂元大93購04  ,0,0,0,0,0,0,0,0,0,93000,0,0,0,98000,5000,93000,93000
052104,英業達兆豐96購01,0,0,0,0,0,0,0,0,0,93000,0,0,0,95000,2000,93000,93000
054437,欣興台新97購02  ,0,0,0,0,0,0,0,0,0,93000,0,0,0,93000,0,93000,93000
054315,訊芯凱基98購01  ,0,0,0,0,0,0,0,0,0,93000,0,0,0,182000,89000,93000,93000
055782,新日興凱基99購01,0,0,0,0,0,0,0,0,0,92000,0,0,0,92000,0,92000,92000
055716,致茂元大97購01  ,0,0,0,0,0,0,0,0,0,92000,0,0,0,95000,3000,92000,92000
054533,泰碩國泰98購01  ,0,0,0,0,0,0,0,0,0,92000,0,0,0,92000,0,92000,92000
055935,創意群益97購02  ,0,0,0,0,0,0,0,0,0,92000,0,0,0,164000,72000,92000,92000
05821P,臺股指凱基96售18,0,0,0,0,0,0,0,0,0,92000,0,0,0,131000,39000,92000,92000
056590,樺漢統一9A購01  ,0,0,0,0,0,0,0,0,0,92000,0,0,0,92000,0,92000,92000
00737,國泰AI+Robo     ,101000,0,101000,0,0,0,0,0,0,-9000,0,0,0,174000,183000,-9000,92000
044376,日月光兆豐92購01,0,0,0,0,0,0,0,0,0,92000,0,0,0,119000,27000,92000,92000
043511,上銀富邦93購01  ,0,0,0,0,0,0,0,0,0,92000,0,0,0,92000,0,92000,92000
047351,聯詠凱基93購02  ,0,0,0,0,0,0,0,0,0,92000,0,0,0,92000,0,92000,92000
050686,欣興兆豐96購01  ,0,0,0,0,0,0,0,0,0,92000,0,0,0,102000,10000,92000,92000
05004P,健策統一95售01  ,0,0,0,0,0,0,0,0,0,92000,0,0,0,724000,632000,92000,92000
051572,上銀元大95購01  ,0,0,0,0,0,0,0,0,0,92000,0,0,0,257000,165000,92000,92000
051419,麗豐國票96購01  ,0,0,0,0,0,0,0,0,0,92000,0,0,0,102000,10000,92000,92000
054481,鎧勝中信96購01  ,0,0,0,0,0,0,0,0,0,92000,0,0,0,92000,0,92000,92000
053889,致茂群益97購01  ,0,0,0,0,0,0,0,0,0,92000,0,0,0,148000,56000,92000,92000
053437,啟碁日盛96購01  ,0,0,0,0,0,0,0,0,0,92000,0,0,0,92000,0,92000,92000
052768,泰鼎群益96購01  ,0,0,0,0,0,0,0,0,0,92000,0,0,0,205000,113000,92000,92000
052593,台積電群益96購02,0,0,0,0,0,0,0,0,0,92000,0,0,0,194000,102000,92000,92000
052884,台積電兆豐96購01,0,0,0,0,0,0,0,0,0,92000,0,0,0,155000,63000,92000,92000
053082,聯電元大98購03  ,0,0,0,0,0,0,0,0,0,92000,0,0,0,148000,56000,92000,92000
06159P,牧德元富97售02  ,0,0,0,0,0,0,0,0,0,92000,0,0,0,130000,38000,92000,92000
056598,京元電元富98購01,0,0,0,0,0,0,0,0,0,91000,0,0,0,197000,106000,91000,91000
054767,日電貿國票98購01,0,0,0,0,0,0,0,0,0,91000,0,0,0,91000,0,91000,91000
055177,宏達電統一99購01,0,0,0,0,0,0,0,0,0,91000,0,0,0,91000,0,91000,91000
055452,台積電元富97購03,0,0,0,0,0,0,0,0,0,91000,0,0,0,98000,7000,91000,91000
048572,美利達元大96購04,0,0,0,0,0,0,0,0,0,91000,0,0,0,96000,5000,91000,91000
04654P,臺股指凱基94售13,0,0,0,0,0,0,0,0,0,91000,0,0,0,641000,550000,91000,91000
050932,台塑國票96購01  ,0,0,0,0,0,0,0,0,0,91000,0,0,0,115000,24000,91000,91000
050832,力成凱基95購01  ,0,0,0,0,0,0,0,0,0,91000,0,0,0,120000,29000,91000,91000
052244,廣達康和95購01  ,0,0,0,0,0,0,0,0,0,91000,0,0,0,176000,85000,91000,91000
06078P,臺股指凱基9A售01,0,0,0,0,0,0,0,0,0,91000,0,0,0,187000,96000,91000,91000
055375,京鼎元大97購03  ,0,0,0,0,0,0,0,0,0,90000,0,0,0,496000,406000,90000,90000
054817,聯發科元大97購13,0,0,0,0,0,0,0,0,0,90000,0,0,0,100000,10000,90000,90000
055127,台虹兆豐97購01  ,0,0,0,0,0,0,0,0,0,90000,0,0,0,90000,0,90000,90000
05814P,臺股指國票96售07,0,0,0,0,0,0,0,0,0,90000,0,0,0,90000,0,90000,90000
056223,華邦電凱基97購04,0,0,0,0,0,0,0,0,0,90000,0,0,0,90000,0,90000,90000
045308,泰鼎元大93購02  ,0,0,0,0,0,0,0,0,0,90000,0,0,0,100000,10000,90000,90000
046436,新光金群益92購02,0,0,0,0,0,0,0,0,0,90000,0,0,0,90000,0,90000,90000
03189P,玉晶光元大03售05,0,0,0,0,0,0,0,0,0,90000,0,0,0,110000,20000,90000,90000
04488P,聯發科凱基94售05,0,0,0,0,0,0,0,0,0,90000,0,0,0,100000,10000,90000,90000
050417,喬山凱基94購01  ,0,0,0,0,0,0,0,0,0,90000,0,0,0,100000,10000,90000,90000
04680P,臺股指統一94售05,0,0,0,0,0,0,0,0,0,90000,0,0,0,100000,10000,90000,90000
050957,T50反1台新05購01,0,0,0,0,0,0,0,0,0,90000,0,0,0,90000,0,90000,90000
048435,致新國票93購01  ,0,0,0,0,0,0,0,0,0,90000,0,0,0,100000,10000,90000,90000
048196,聯發科元大93購24,0,0,0,0,0,0,0,0,0,90000,0,0,0,101000,11000,90000,90000
051207,聯茂麥證95購01  ,0,0,0,110000,20000,90000,0,0,0,90000,0,0,0,110000,20000,90000,90000
051021,啟碁凱基95購02  ,0,0,0,0,0,0,0,0,0,90000,0,0,0,100000,10000,90000,90000
051690,超眾凱基95購03  ,0,0,0,0,0,0,0,0,0,90000,0,0,0,100000,10000,90000,90000
050332,鴻海國泰96購05  ,0,0,0,0,0,0,0,0,0,90000,0,0,0,140000,50000,90000,90000
050231,聯發科麥證94購03,0,0,0,120000,30000,90000,0,0,0,90000,0,0,0,120000,30000,90000,90000
05223P,臻鼎凱基95售02  ,0,0,0,0,0,0,0,0,0,90000,0,0,0,90000,0,90000,90000
052256,台泥國泰96購01  ,0,0,0,0,0,0,0,0,0,90000,0,0,0,100000,10000,90000,90000
052470,華新科亞東97購01,0,0,0,0,0,0,0,0,0,90000,0,0,0,90000,0,90000,90000
051855,道瓊反凱基97購01,0,0,0,0,0,0,0,0,0,90000,0,0,0,90000,0,90000,90000
052869,新日興凱基96購01,0,0,0,0,0,0,0,0,0,90000,0,0,0,93000,3000,90000,90000
053206,聯發科麥證96購02,0,0,0,110000,20000,90000,0,0,0,90000,0,0,0,110000,20000,90000,90000
053539,智易永豐96購01  ,0,0,0,0,0,0,0,0,0,90000,0,0,0,90000,0,90000,90000
053929,正文國票97購01  ,0,0,0,0,0,0,0,0,0,90000,0,0,0,90000,0,90000,90000
054264,超眾元大97購02  ,0,0,0,0,0,0,0,0,0,90000,0,0,0,629000,539000,90000,90000
054259,健策元大97購03  ,0,0,0,0,0,0,0,0,0,90000,0,0,0,106000,16000,90000,90000
06368P,台積電凱基97售15,0,0,0,0,0,0,0,0,0,90000,0,0,0,90000,0,90000,90000
055167,友訊統一97購01  ,0,0,0,0,0,0,0,0,0,89000,0,0,0,92000,3000,89000,89000
055295,瀚宇博元大97購02,0,0,0,0,0,0,0,0,0,89000,0,0,0,93000,4000,89000,89000
050431,聯發科凱基94購18,0,0,0,0,0,0,0,0,0,89000,0,0,0,170000,81000,89000,89000
00703,台新MSCI中國    ,0,0,0,0,0,0,0,0,0,89000,0,0,0,129000,40000,89000,89000
046547,大立光永豐92購05,0,0,0,0,0,0,0,0,0,89000,0,0,0,89000,0,89000,89000
044284,聯電凱基92購01  ,0,0,0,0,0,0,0,0,0,89000,0,0,0,134000,45000,89000,89000
048386,華新國票94購01  ,0,0,0,0,0,0,0,0,0,89000,0,0,0,89000,0,89000,89000
049617,光罩群益94購03  ,0,0,0,0,0,0,0,0,0,89000,0,0,0,97000,8000,89000,89000
054365,遠東新中信96購01,0,0,0,0,0,0,0,0,0,89000,0,0,0,105000,16000,89000,89000
053219,祥碩凱基96購01  ,0,0,0,0,0,0,0,0,0,89000,0,0,0,98000,9000,89000,89000
055273,華泰元大97購01  ,0,0,0,0,0,0,0,0,0,88000,0,0,0,100000,12000,88000,88000
055103,南港凱基97購01  ,0,0,0,0,0,0,0,0,0,88000,0,0,0,130000,42000,88000,88000
055114,新日興凱基98購01,0,0,0,0,0,0,0,0,0,88000,0,0,0,93000,5000,88000,88000
054699,復盛永豐97購01  ,0,0,0,0,0,0,0,0,0,88000,0,0,0,103000,15000,88000,88000
054753,復盛凱基98購01  ,0,0,0,0,0,0,0,0,0,88000,0,0,0,88000,0,88000,88000
054654,全新麥證99購01  ,0,0,0,98000,10000,88000,0,0,0,88000,0,0,0,98000,10000,88000,88000
056267,文曄統一97購02  ,0,0,0,0,0,0,0,0,0,88000,0,0,0,136000,48000,88000,88000
05681P,大立光元大96售05,0,0,0,0,0,0,0,0,0,88000,0,0,0,132000,44000,88000,88000
050394,大立光元富94購09,0,0,0,0,0,0,0,0,0,88000,0,0,0,98000,10000,88000,88000
047766,聯發科元大93購19,0,0,0,0,0,0,0,0,0,88000,0,0,0,98000,10000,88000,88000
045579,全新元大93購03  ,0,0,0,0,0,0,0,0,0,88000,0,0,0,88000,0,88000,88000
049293,友訊群益95購01  ,0,0,0,0,0,0,0,0,0,88000,0,0,0,123000,35000,88000,88000
049019,美律群益94購02  ,0,0,0,0,0,0,0,0,0,88000,0,0,0,129000,41000,88000,88000
052948,景碩國票97購02  ,0,0,0,0,0,0,0,0,0,88000,0,0,0,88000,0,88000,88000
06170P,禾伸堂元富97售02,0,0,0,0,0,0,0,0,0,88000,0,0,0,113000,25000,88000,88000
055800,欣興永豐97購02  ,0,0,0,0,0,0,0,0,0,87000,0,0,0,87000,0,87000,87000
054975,福懋科元大97購01,0,0,0,0,0,0,0,0,0,87000,0,0,0,197000,110000,87000,87000
055539,億光台新97購01  ,0,0,0,0,0,0,0,0,0,87000,0,0,0,89000,2000,87000,87000
04768P,大立光國泰96售03,0,0,0,0,0,0,0,0,0,87000,0,0,0,327000,240000,87000,87000
047557,麗豐凱基94購02  ,0,0,0,0,0,0,0,0,0,87000,0,0,0,109000,22000,87000,87000
047618,義隆凱基94購02  ,0,0,0,0,0,0,0,0,0,87000,0,0,0,88000,1000,87000,87000
046448,亞德客凱基92購03,0,0,0,0,0,0,0,0,0,87000,0,0,0,87000,0,87000,87000
048850,聯電群益96購01  ,0,0,0,0,0,0,0,0,0,87000,0,0,0,178000,91000,87000,87000
049917,華新科元大94購02,0,0,0,0,0,0,0,0,0,87000,0,0,0,109000,22000,87000,87000
04958P,和大凱基94售04  ,0,0,0,0,0,0,0,0,0,87000,0,0,0,117000,30000,87000,87000
051914,健策元大96購06  ,0,0,0,0,0,0,0,0,0,87000,0,0,0,114000,27000,87000,87000
3530,晶相光          ,300000,224000,76000,0,0,0,0,0,0,11000,0,0,0,45000,34000,11000,87000
054899,南港康和97購01  ,0,0,0,0,0,0,0,0,0,86000,0,0,0,154000,68000,86000,86000
055070,聯茂永豐97購01  ,0,0,0,0,0,0,0,0,0,86000,0,0,0,86000,0,86000,86000
055805,矽力永豐97購01  ,0,0,0,0,0,0,0,0,0,86000,0,0,0,125000,39000,86000,86000
055887,上銀統一97購03  ,0,0,0,0,0,0,0,0,0,86000,0,0,0,108000,22000,86000,86000
056418,台光電元富98購01,0,0,0,0,0,0,0,0,0,86000,0,0,0,146000,60000,86000,86000
05894P,友達群益98售02  ,0,0,0,0,0,0,0,0,0,86000,0,0,0,87000,1000,86000,86000
056658,美食元大98購01  ,0,0,0,0,0,0,0,0,0,86000,0,0,0,148000,62000,86000,86000
042752,台灣50元大96購03,0,0,0,0,0,0,0,0,0,86000,0,0,0,103000,17000,86000,86000
047626,全新國票94購01  ,0,0,0,0,0,0,0,0,0,86000,0,0,0,86000,0,86000,86000
046829,義隆群益93購01  ,0,0,0,0,0,0,0,0,0,86000,0,0,0,98000,12000,86000,86000
050442,復盛凱基94購01  ,0,0,0,0,0,0,0,0,0,86000,0,0,0,86000,0,86000,86000
049479,矽格永豐94購01  ,0,0,0,0,0,0,0,0,0,86000,0,0,0,86000,0,86000,86000
047144,華通群益94購01  ,0,0,0,0,0,0,0,0,0,86000,0,0,0,86000,0,86000,86000
050197,矽格元大94購04  ,0,0,0,0,0,0,0,0,0,86000,0,0,0,86000,0,86000,86000
048653,巨大元大96購02  ,0,0,0,0,0,0,0,0,0,86000,0,0,0,86000,0,86000,86000
048500,樺漢元大93購03  ,0,0,0,0,0,0,0,0,0,86000,0,0,0,174000,88000,86000,86000
048349,美利達元大96購02,0,0,0,0,0,0,0,0,0,86000,0,0,0,100000,14000,86000,86000
048130,美利達元大96購01,0,0,0,0,0,0,0,0,0,86000,0,0,0,112000,26000,86000,86000
050040,鴻海中信94購04  ,0,0,0,0,0,0,0,0,0,86000,0,0,0,116000,30000,86000,86000
051339,智易永豐95購02  ,0,0,0,0,0,0,0,0,0,86000,0,0,0,92000,6000,86000,86000
053247,麗豐國票97購01  ,0,0,0,0,0,0,0,0,0,86000,0,0,0,119000,33000,86000,86000
053427,鎧勝永豐96購02  ,0,0,0,0,0,0,0,0,0,86000,0,0,0,172000,86000,86000,86000
054450,聯茂第一96購01  ,0,0,0,0,0,0,0,0,0,86000,0,0,0,91000,5000,86000,86000
054274,智易中信96購02  ,0,0,0,0,0,0,0,0,0,86000,0,0,0,86000,0,86000,86000
054328,台化康和96購01  ,0,0,0,0,0,0,0,0,0,86000,0,0,0,86000,0,86000,86000
053950,緯穎富邦97購02  ,0,0,0,0,0,0,0,0,0,86000,0,0,0,116000,30000,86000,86000
056288,健鼎永豐97購01  ,0,0,0,0,0,0,0,0,0,85000,0,0,0,95000,10000,85000,85000
056129,義隆麥證97購01  ,0,0,0,86000,1000,85000,0,0,0,85000,0,0,0,86000,1000,85000,85000
056009,奇力新中信98購03,0,0,0,0,0,0,0,0,0,85000,0,0,0,186000,101000,85000,85000
055710,亞德客元大97購03,0,0,0,0,0,0,0,0,0,85000,0,0,0,209000,124000,85000,85000
055210,S&P正2凱基97購01,0,0,0,0,0,0,0,0,0,85000,0,0,0,85000,0,85000,85000
042387,台積電永昌93購02,0,0,0,0,0,0,0,0,0,85000,0,0,0,189000,104000,85000,85000
051658,深中小國泰97購01,0,0,0,0,0,0,0,0,0,85000,0,0,0,85000,0,85000,85000
049860,亞德客兆豐94購01,0,0,0,0,0,0,0,0,0,85000,0,0,0,85000,0,85000,85000
04826P,華新科麥證95售01,0,0,0,230000,145000,85000,0,0,0,85000,0,0,0,230000,145000,85000,85000
050996,隆達元大95購01  ,0,0,0,0,0,0,0,0,0,85000,0,0,0,88000,3000,85000,85000
054359,南亞科日盛96購02,0,0,0,0,0,0,0,0,0,85000,0,0,0,119000,34000,85000,85000
053438,玉晶光麥證97購02,0,0,0,163000,74000,89000,0,0,0,85000,0,0,0,165000,80000,85000,85000
053216,京鼎凱基96購02  ,0,0,0,0,0,0,0,0,0,85000,0,0,0,106000,21000,85000,85000
06162P,大立光群益97售02,0,0,0,0,0,0,0,0,0,85000,0,0,0,90000,5000,85000,85000
055186,正文統一97購01  ,0,0,0,0,0,0,0,0,0,84000,0,0,0,84000,0,84000,84000
055576,嘉晶統一98購01  ,0,0,0,0,0,0,0,0,0,84000,0,0,0,84000,0,84000,84000
054784,順德群益9A購01  ,0,0,0,0,0,0,0,0,0,84000,0,0,0,134000,50000,84000,84000
056072,群創元大97購01  ,0,0,0,0,0,0,0,0,0,84000,0,0,0,121000,37000,84000,84000
056091,百和統一97購01  ,0,0,0,0,0,0,0,0,0,84000,0,0,0,132000,48000,84000,84000
056112,勤誠永豐97購02  ,0,0,0,0,0,0,0,0,0,84000,0,0,0,204000,120000,84000,84000
056208,崇越永豐97購01  ,0,0,0,0,0,0,0,0,0,84000,0,0,0,84000,0,84000,84000
05628P,茂林國票97售02  ,0,0,0,0,0,0,0,0,0,84000,0,0,0,136000,52000,84000,84000
05895P,奇力新群益96售03,0,0,0,0,0,0,0,0,0,84000,0,0,0,84000,0,84000,84000
047826,台泥元大93購01  ,0,0,0,0,0,0,0,0,0,84000,0,0,0,164000,80000,84000,84000
045908,矽創中信92購01  ,0,0,0,0,0,0,0,0,0,84000,0,0,0,94000,10000,84000,84000
050877,美律統一95購01  ,0,0,0,0,0,0,0,0,0,84000,0,0,0,112000,28000,84000,84000
049144,瑞昱元大94購03  ,0,0,0,0,0,0,0,0,0,84000,0,0,0,92000,8000,84000,84000
049925,創意元大95購02  ,0,0,0,0,0,0,0,0,0,84000,0,0,0,84000,0,84000,84000
053227,晶技台新96購01  ,0,0,0,0,0,0,0,0,0,84000,0,0,0,84000,0,84000,84000
053964,上銀元大96購05  ,0,0,0,0,0,0,0,0,0,84000,0,0,0,247000,163000,84000,84000
052030,GIS群益95購04   ,0,0,0,0,0,0,0,0,0,84000,0,0,0,84000,0,84000,84000
052043,瑞昱日盛95購01  ,0,0,0,0,0,0,0,0,0,84000,0,0,0,292000,208000,84000,84000
051984,台塑元大95購01  ,0,0,0,0,0,0,0,0,0,84000,0,0,0,142000,58000,84000,84000
052501,茂林永豐95購04  ,0,0,0,0,0,0,0,0,0,84000,0,0,0,84000,0,84000,84000
052903,致茂國票97購01  ,0,0,0,0,0,0,0,0,0,84000,0,0,0,84000,0,84000,84000
2614,東森            ,168000,83000,85000,0,0,0,0,0,0,-1000,0,1000,-1000,0,0,0,84000
054737,京元電凱基99購01,0,0,0,0,0,0,0,0,0,83000,0,0,0,91000,8000,83000,83000
054627,義隆凱基98購01  ,0,0,0,0,0,0,0,0,0,83000,0,0,0,94000,11000,83000,83000
055048,台積電永豐97購04,0,0,0,0,0,0,0,0,0,83000,0,0,0,86000,3000,83000,83000
055283,聯發科元大97購16,0,0,0,0,0,0,0,0,0,83000,0,0,0,166000,83000,83000,83000
055447,華新科統一97購04,0,0,0,0,0,0,0,0,0,83000,0,0,0,205000,122000,83000,83000
05545P,台表科國泰98售01,0,0,0,0,0,0,0,0,0,83000,0,0,0,83000,0,83000,83000
055402,正文元富97購02  ,0,0,0,0,0,0,0,0,0,83000,0,0,0,103000,20000,83000,83000
044950,玉晶光群益94購01,0,0,0,0,0,0,0,0,0,83000,0,0,0,104000,21000,83000,83000
051290,大立光統一96購02,0,0,0,0,0,0,0,0,0,83000,0,0,0,83000,0,83000,83000
050199,南電元大94購09  ,0,0,0,0,0,0,0,0,0,83000,0,0,0,85000,2000,83000,83000
052547,光磊兆豐96購01  ,0,0,0,0,0,0,0,0,0,83000,0,0,0,190000,107000,83000,83000
053596,嘉澤元大96購01  ,0,0,0,0,0,0,0,0,0,83000,0,0,0,298000,215000,83000,83000
053640,上緯控永豐96購01,0,0,0,0,0,0,0,0,0,83000,0,0,0,103000,20000,83000,83000
1590,亞德客-KY       ,932000,852150,79850,0,0,0,82000,3000,79000,-76000,21000,1000,20000,6000,102000,-96000,82850
055296,康舒元大97購02  ,0,0,0,0,0,0,0,0,0,82000,0,0,0,350000,268000,82000,82000
054618,訊芯永豐97購01  ,0,0,0,0,0,0,0,0,0,82000,0,0,0,142000,60000,82000,82000
036804,國巨元富93購01  ,0,0,0,0,0,0,0,0,0,82000,0,0,0,139000,57000,82000,82000
048703,康控國票95購01  ,0,0,0,0,0,0,0,0,0,82000,0,0,0,82000,0,82000,82000
050892,聯電元大96購02  ,0,0,0,0,0,0,0,0,0,82000,0,0,0,109000,27000,82000,82000
048293,聯詠群益93購04  ,0,0,0,0,0,0,0,0,0,82000,0,0,0,97000,15000,82000,82000
051591,玉晶光元大97購01,0,0,0,0,0,0,0,0,0,82000,0,0,0,96000,14000,82000,82000
053651,台光電凱基98購01,0,0,0,0,0,0,0,0,0,82000,0,0,0,82000,0,82000,82000
053924,京鼎國票97購01  ,0,0,0,0,0,0,0,0,0,82000,0,0,0,103000,21000,82000,82000
054408,義隆國票98購01  ,0,0,0,0,0,0,0,0,0,82000,0,0,0,135000,53000,82000,82000
053121,上証2X凱基9C購01,0,0,0,0,0,0,0,0,0,82000,0,0,0,83000,1000,82000,82000
053137,旺宏富邦98購01  ,0,0,0,0,0,0,0,0,0,82000,0,0,0,122000,40000,82000,82000
055085,大毅國票97購01  ,0,0,0,0,0,0,0,0,0,81000,0,0,0,175000,94000,81000,81000
055232,泰碩國票98購01  ,0,0,0,0,0,0,0,0,0,81000,0,0,0,81000,0,81000,81000
05960P,欣興統一96售01  ,0,0,0,0,0,0,0,0,0,81000,0,0,0,81000,0,81000,81000
056233,超眾凱基97購02  ,0,0,0,0,0,0,0,0,0,81000,0,0,0,81000,0,81000,81000
047295,欣興元富96購02  ,0,0,0,0,0,0,0,0,0,81000,0,0,0,81000,0,81000,81000
048645,創意元大94購02  ,0,0,0,0,0,0,0,0,0,81000,0,0,0,81000,0,81000,81000
054107,上銀凱基97購01  ,0,0,0,0,0,0,0,0,0,81000,0,0,0,321000,240000,81000,81000
06410P,祥碩統一97售01  ,0,0,0,0,0,0,0,0,0,81000,0,0,0,450000,369000,81000,81000
056294,上銀元大97購11  ,0,0,0,0,0,0,0,0,0,80000,0,0,0,227000,147000,80000,80000
05877P,大立光群益96售06,0,0,0,0,0,0,0,0,0,80000,0,0,0,111000,31000,80000,80000
055270,上銀元大97購03  ,0,0,0,0,0,0,0,0,0,80000,0,0,0,141000,61000,80000,80000
047421,聯茂富邦97購01  ,0,0,0,0,0,0,0,0,0,80000,0,0,0,588000,508000,80000,80000
045690,啟碁元大92購01  ,0,0,0,0,0,0,0,0,0,80000,0,0,0,80000,0,80000,80000
04010P,上銀元大93售07  ,0,0,0,0,0,0,0,0,0,80000,0,0,0,80000,0,80000,80000
046476,鴻海統一96購01  ,0,0,0,0,0,0,0,0,0,80000,0,0,0,205000,125000,80000,80000
050754,元金2X元富9B購01,0,0,0,0,0,0,0,0,0,80000,0,0,0,100000,20000,80000,80000
051109,美律統一95購02  ,0,0,0,0,0,0,0,0,0,80000,0,0,0,80000,0,80000,80000
049316,茂林凱基94購02  ,0,0,0,0,0,0,0,0,0,80000,0,0,0,80000,0,80000,80000
049432,聯詠國票95購01  ,0,0,0,0,0,0,0,0,0,80000,0,0,0,80000,0,80000,80000
051455,樺漢元大96購01  ,0,0,0,0,0,0,0,0,0,80000,0,0,0,94000,14000,80000,80000
051316,T50反1國票95購02,0,0,0,0,0,0,0,0,0,80000,0,0,0,80000,0,80000,80000
048028,聯發科凱基93購25,0,0,0,0,0,0,0,0,0,80000,0,0,0,80000,0,80000,80000
050305,正崴中信95購01  ,0,0,0,0,0,0,0,0,0,80000,0,0,0,80000,0,80000,80000
054317,昇陽半凱基98購01,0,0,0,0,0,0,0,0,0,80000,0,0,0,100000,20000,80000,80000
053119,日月光中信97購01,0,0,0,0,0,0,0,0,0,80000,0,0,0,80000,0,80000,80000
05316P,台積電永昌96售06,0,0,0,0,0,0,0,0,0,80000,0,0,0,80000,0,80000,80000
052687,國泰金元大96購03,0,0,0,0,0,0,0,0,0,80000,0,0,0,80000,0,80000,80000
05225P,鴻海統一95售09  ,0,0,0,0,0,0,0,0,0,80000,0,0,0,110000,30000,80000,80000
052265,聯發科亞東95購01,0,0,0,0,0,0,0,0,0,80000,0,0,0,80000,0,80000,80000
052140,鈺齊凱基95購02  ,0,0,0,0,0,0,0,0,0,80000,0,0,0,100000,20000,80000,80000
051786,A50正2國票95購02,0,0,0,0,0,0,0,0,0,80000,0,0,0,650000,570000,80000,80000
5880,合庫金          ,4750000,4682000,68000,0,0,0,14000,0,14000,-2000,0,0,0,0,2000,-2000,80000
054552,聯發科凱基98購03,0,0,0,0,0,0,0,0,0,79000,0,0,0,90000,11000,79000,79000
054769,創意國票98購01  ,0,0,0,0,0,0,0,0,0,79000,0,0,0,127000,48000,79000,79000
055858,聯茂元大97購03  ,0,0,0,0,0,0,0,0,0,79000,0,0,0,199000,120000,79000,79000
044922,玉晶光永豐93購01,0,0,0,0,0,0,0,0,0,79000,0,0,0,79000,0,79000,79000
048557,瑞昱元大94購01  ,0,0,0,0,0,0,0,0,0,79000,0,0,0,123000,44000,79000,79000
048511,美律凱基93購07  ,0,0,0,0,0,0,0,0,0,79000,0,0,0,172000,93000,79000,79000
051479,兆豐金凱基95購01,0,0,0,0,0,0,0,0,0,79000,0,0,0,250000,171000,79000,79000
051231,健策群益97購01  ,0,0,0,0,0,0,0,0,0,79000,0,0,0,191000,112000,79000,79000
050184,信邦元大94購01  ,0,0,0,0,0,0,0,0,0,79000,0,0,0,79000,0,79000,79000
049672,臺股指富邦94購01,0,0,0,0,0,0,0,0,0,79000,0,0,0,80000,1000,79000,79000
052666,瑞昱群益96購01  ,0,0,0,0,0,0,0,0,0,79000,0,0,0,115000,36000,79000,79000
053696,日月光元大96購05,0,0,0,0,0,0,0,0,0,79000,0,0,0,91000,12000,79000,79000
053864,義隆元大96購01  ,0,0,0,0,0,0,0,0,0,79000,0,0,0,371000,292000,79000,79000
053474,聯發科元大97購06,0,0,0,0,0,0,0,0,0,79000,0,0,0,200000,121000,79000,79000
055819,晶相光國票98購01,0,0,0,0,0,0,0,0,0,78000,0,0,0,87000,9000,78000,78000
056556,南電凱基98購01  ,0,0,0,0,0,0,0,0,0,78000,0,0,0,101000,23000,78000,78000
054777,昇陽半國票98購01,0,0,0,0,0,0,0,0,0,78000,0,0,0,78000,0,78000,78000
054816,聯發科元大97購12,0,0,0,0,0,0,0,0,0,78000,0,0,0,118000,40000,78000,78000
055061,聯詠永豐97購01  ,0,0,0,0,0,0,0,0,0,78000,0,0,0,80000,2000,78000,78000
046572,貿聯國泰94購01  ,0,0,0,0,0,0,0,0,0,78000,0,0,0,182000,104000,78000,78000
053778,旺宏元大97購03  ,0,0,0,0,0,0,0,0,0,78000,0,0,0,238000,160000,78000,78000
054575,聯鈞元大97購01  ,0,0,0,0,0,0,0,0,0,77000,0,0,0,87000,10000,77000,77000
055399,超眾統一99購01  ,0,0,0,0,0,0,0,0,0,77000,0,0,0,208000,131000,77000,77000
03429B,臺股指元富97熊07,0,0,0,0,0,0,0,0,0,77000,0,0,0,77000,0,77000,77000
046647,高鐵國泰93購01  ,0,0,0,0,0,0,0,0,0,77000,0,0,0,77000,0,77000,77000
04668P,臺股指國票94售07,0,0,0,0,0,0,0,0,0,77000,0,0,0,77000,0,77000,77000
050752,美律統一94購05  ,0,0,0,0,0,0,0,0,0,77000,0,0,0,300000,223000,77000,77000
049296,義隆群益96購01  ,0,0,0,0,0,0,0,0,0,77000,0,0,0,119000,42000,77000,77000
051068,台積電國票97購01,0,0,0,0,0,0,0,0,0,77000,0,0,0,77000,0,77000,77000
053557,聯茂凱基96購04  ,0,0,0,0,0,0,0,0,0,77000,0,0,0,77000,0,77000,77000
052617,景碩國泰98購01  ,0,0,0,0,0,0,0,0,0,77000,0,0,0,77000,0,77000,77000
055239,帆宣台新97購01  ,0,0,0,0,0,0,0,0,0,76000,0,0,0,171000,95000,76000,76000
055115,日月光凱基98購01,0,0,0,0,0,0,0,0,0,76000,0,0,0,99000,23000,76000,76000
056293,上銀元大97購10  ,0,0,0,0,0,0,0,0,0,76000,0,0,0,121000,45000,76000,76000
04592P,台積電元大94售10,0,0,0,0,0,0,0,0,0,76000,0,0,0,80000,4000,76000,76000
05041P,大立光凱基95售09,0,0,0,0,0,0,0,0,0,76000,0,0,0,236000,160000,76000,76000
03639C,元油2X元大9B牛01,0,0,0,0,0,0,0,0,0,76000,0,0,0,199000,123000,76000,76000
044201,群創國票95購01  ,0,0,0,0,0,0,0,0,0,76000,0,0,0,395000,319000,76000,76000
051590,玉晶光元大96購02,0,0,0,0,0,0,0,0,0,76000,0,0,0,88000,12000,76000,76000
049056,玉晶光永豐95購03,0,0,0,0,0,0,0,0,0,76000,0,0,0,81000,5000,76000,76000
048121,亞德客元大93購05,0,0,0,0,0,0,0,0,0,76000,0,0,0,116000,40000,76000,76000
048616,智伸科凱基93購07,0,0,0,0,0,0,0,0,0,76000,0,0,0,131000,55000,76000,76000
049583,台積電元大95購04,0,0,0,0,0,0,0,0,0,76000,0,0,0,428000,352000,76000,76000
052698,深中小國票99購01,0,0,0,0,0,0,0,0,0,76000,0,0,0,274000,198000,76000,76000
053006,玉晶光永豐96購03,0,0,0,0,0,0,0,0,0,76000,0,0,0,96000,20000,76000,76000
051866,聯發科凱基96購05,0,0,0,0,0,0,0,0,0,76000,0,0,0,178000,102000,76000,76000
053315,漢唐群益96購02  ,0,0,0,0,0,0,0,0,0,76000,0,0,0,100000,24000,76000,76000
05411P,台積電國票96售08,0,0,0,0,0,0,0,0,0,76000,0,0,0,96000,20000,76000,76000
2441,超豐            ,311000,235000,76000,0,0,0,0,0,0,0,0,0,0,0,0,0,76000
056333,台積電日盛9B購01,0,0,0,0,0,0,0,0,0,75000,0,0,0,225000,150000,75000,75000
056627,訊芯永豐98購01  ,0,0,0,0,0,0,0,0,0,75000,0,0,0,75000,0,75000,75000
055015,帆宣元富97購01  ,0,0,0,0,0,0,0,0,0,75000,0,0,0,75000,0,75000,75000
054785,建準群益98購01  ,0,0,0,0,0,0,0,0,0,75000,0,0,0,86000,11000,75000,75000
055400,緯穎統一97購01  ,0,0,0,0,0,0,0,0,0,75000,0,0,0,90000,15000,75000,75000
055322,欣興國票97購06  ,0,0,0,0,0,0,0,0,0,75000,0,0,0,85000,10000,75000,75000
042516,健策凱基93購01  ,0,0,0,0,0,0,0,0,0,75000,0,0,0,75000,0,75000,75000
044997,信邦國泰93購01  ,0,0,0,0,0,0,0,0,0,75000,0,0,0,75000,0,75000,75000
04132P,瑞昱群益93售04  ,0,0,0,0,0,0,0,0,0,75000,0,0,0,77000,2000,75000,75000
03109P,台積電元大01售41,0,0,0,0,0,0,0,0,0,75000,0,0,0,105000,30000,75000,75000
05042P,GIS凱基95售03   ,0,0,0,0,0,0,0,0,0,75000,0,0,0,75000,0,75000,75000
050177,聯發科元大94購11,0,0,0,0,0,0,0,0,0,75000,0,0,0,291000,216000,75000,75000
048594,泰鼎群益93購02  ,0,0,0,0,0,0,0,0,0,75000,0,0,0,138000,63000,75000,75000
050640,致新國票94購01  ,0,0,0,0,0,0,0,0,0,75000,0,0,0,75000,0,75000,75000
05144P,美律永豐95售02  ,0,0,0,0,0,0,0,0,0,75000,0,0,0,75000,0,75000,75000
054065,樺漢國票97購01  ,0,0,0,0,0,0,0,0,0,75000,0,0,0,75000,0,75000,75000
053977,新日興元大96購03,0,0,0,0,0,0,0,0,0,75000,0,0,0,78000,3000,75000,75000
053338,台光電國票97購01,0,0,0,0,0,0,0,0,0,75000,0,0,0,101000,26000,75000,75000
052253,康控永豐95購04  ,0,0,0,0,0,0,0,0,0,75000,0,0,0,85000,10000,75000,75000
052875,樺漢凱基96購02  ,0,0,0,0,0,0,0,0,0,75000,0,0,0,75000,0,75000,75000
2357,華碩            ,416000,353000,63000,0,0,0,0,0,0,12000,0,0,0,13000,1000,12000,75000
05532P,臺股指群益96售05,0,0,0,0,0,0,0,0,0,74000,0,0,0,238000,164000,74000,74000
055745,臻鼎元富97購01  ,0,0,0,0,0,0,0,0,0,74000,0,0,0,80000,6000,74000,74000
054952,大毅元大97購02  ,0,0,0,0,0,0,0,0,0,74000,0,0,0,114000,40000,74000,74000
05674P,瑞昱群益96售02  ,0,0,0,0,0,0,0,0,0,74000,0,0,0,77000,3000,74000,74000
047389,義隆元大94購01  ,0,0,0,0,0,0,0,0,0,74000,0,0,0,207000,133000,74000,74000
047201,鴻海元富93購05  ,0,0,0,0,0,0,0,0,0,74000,0,0,0,148000,74000,74000,74000
046002,美律統一93購01  ,0,0,0,0,0,0,0,0,0,74000,0,0,0,84000,10000,74000,74000
046200,上海銀凱基93購01,0,0,0,0,0,0,0,0,0,74000,0,0,0,74000,0,74000,74000
046660,宏達電元大93購07,0,0,0,0,0,0,0,0,0,74000,0,0,0,114000,40000,74000,74000
045534,深中小群益94購01,0,0,0,0,0,0,0,0,0,74000,0,0,0,74000,0,74000,74000
043784,鴻海凱基94購01  ,0,0,0,0,0,0,0,0,0,74000,0,0,0,85000,11000,74000,74000
047930,嘉澤凱基93購03  ,0,0,0,0,0,0,0,0,0,74000,0,0,0,101000,27000,74000,74000
049331,元石油統一94購01,0,0,0,0,0,0,0,0,0,74000,0,0,0,100000,26000,74000,74000
052132,旺宏凱基9B購01  ,0,0,0,0,0,0,0,0,0,74000,0,0,0,106000,32000,74000,74000
052316,台積電元大96購10,0,0,0,0,0,0,0,0,0,74000,0,0,0,210000,136000,74000,74000
053535,宏達電永豐96購02,0,0,0,0,0,0,0,0,0,74000,0,0,0,74000,0,74000,74000
056086,奇力新統一98購01,0,0,0,0,0,0,0,0,0,73000,0,0,0,289000,216000,73000,73000
055759,技嘉群益98購02  ,0,0,0,0,0,0,0,0,0,73000,0,0,0,263000,190000,73000,73000
055572,鴻海統一98購04  ,0,0,0,0,0,0,0,0,0,73000,0,0,0,83000,10000,73000,73000
046540,創意群益92購04  ,0,0,0,0,0,0,0,0,0,73000,0,0,0,73000,0,73000,73000
045015,玉晶光元大94購01,0,0,0,0,0,0,0,0,0,73000,0,0,0,118000,45000,73000,73000
04164P,滬深2X元富93售03,0,0,0,0,0,0,0,0,0,73000,0,0,0,75000,2000,73000,73000
044578,緯創凱基93購02  ,0,0,0,0,0,0,0,0,0,73000,0,0,0,73000,0,73000,73000
045374,鴻海元大92購07  ,0,0,0,0,0,0,0,0,0,73000,0,0,0,73000,0,73000,73000
049915,瑞昱元大94購07  ,0,0,0,0,0,0,0,0,0,73000,0,0,0,73000,0,73000,73000
051600,新日興兆豐96購02,0,0,0,0,0,0,0,0,0,73000,0,0,0,113000,40000,73000,73000
05165P,欣興元富95售03  ,0,0,0,0,0,0,0,0,0,73000,0,0,0,82000,9000,73000,73000
048002,景碩元大93購04  ,0,0,0,0,0,0,0,0,0,73000,0,0,0,127000,54000,73000,73000
048139,南電國票94購02  ,0,0,0,0,0,0,0,0,0,73000,0,0,0,73000,0,73000,73000
049187,義隆台新94購01  ,0,0,0,0,0,0,0,0,0,73000,0,0,0,221000,148000,73000,73000
048823,漢唐凱基94購01  ,0,0,0,0,0,0,0,0,0,73000,0,0,0,73000,0,73000,73000
053478,京鼎元大96購01  ,0,0,0,0,0,0,0,0,0,73000,0,0,0,140000,67000,73000,73000
054403,同欣電永豐96購02,0,0,0,0,0,0,0,0,0,73000,0,0,0,141000,68000,73000,73000
053021,國巨國泰97購04  ,0,0,0,0,0,0,0,0,0,73000,0,0,0,73000,0,73000,73000
052985,美律元大96購02  ,0,0,0,0,0,0,0,0,0,73000,0,0,0,200000,127000,73000,73000
052612,康舒元大97購01  ,0,0,0,0,0,0,0,0,0,73000,0,0,0,241000,168000,73000,73000
06190P,玉晶光永豐97售05,0,0,0,0,0,0,0,0,0,73000,0,0,0,92000,19000,73000,73000
8110,華東            ,145000,89000,56000,0,0,0,0,0,0,17000,31000,14000,17000,0,0,0,73000
055570,華通統一98購03  ,0,0,0,0,0,0,0,0,0,72000,0,0,0,88000,16000,72000,72000
054870,新日興群益98購01,0,0,0,0,0,0,0,0,0,72000,0,0,0,72000,0,72000,72000
054583,玉晶光統一97購02,0,0,0,0,0,0,0,0,0,72000,0,0,0,72000,0,72000,72000
055852,聯鈞元大98購01  ,0,0,0,0,0,0,0,0,0,72000,0,0,0,123000,51000,72000,72000
055905,可成兆豐97購03  ,0,0,0,0,0,0,0,0,0,72000,0,0,0,72000,0,72000,72000
056480,京鼎元大98購02  ,0,0,0,0,0,0,0,0,0,72000,0,0,0,137000,65000,72000,72000
045665,聯電元富92購01  ,0,0,0,0,0,0,0,0,0,72000,0,0,0,101000,29000,72000,72000
047089,聯詠元富93購03  ,0,0,0,0,0,0,0,0,0,72000,0,0,0,112000,40000,72000,72000
044518,京鼎凱基92購01  ,0,0,0,0,0,0,0,0,0,72000,0,0,0,96000,24000,72000,72000
050833,台郡凱基95購01  ,0,0,0,0,0,0,0,0,0,72000,0,0,0,72000,0,72000,72000
050847,創意國票96購01  ,0,0,0,0,0,0,0,0,0,72000,0,0,0,72000,0,72000,72000
053071,南電群益96購01  ,0,0,0,0,0,0,0,0,0,72000,0,0,0,72000,0,72000,72000
052051,京鼎凱基95購01  ,0,0,0,0,0,0,0,0,0,72000,0,0,0,72000,0,72000,72000
054103,T50反1凱基99購04,0,0,0,0,0,0,0,0,0,72000,0,0,0,72000,0,72000,72000
054083,智伸科元富96購01,0,0,0,0,0,0,0,0,0,72000,0,0,0,95000,23000,72000,72000
054160,華泰凱基98購01  ,0,0,0,0,0,0,0,0,0,72000,0,0,0,72000,0,72000,72000
053839,華通統一96購01  ,0,0,0,0,0,0,0,0,0,72000,0,0,0,72000,0,72000,72000
1103,嘉泥            ,857000,806000,51000,0,0,0,0,0,0,21000,0,20000,-20000,41000,0,41000,72000
3706,神達            ,81000,603000,-522000,0,0,0,600000,0,600000,-6000,40000,0,40000,4000,50000,-46000,72000
054826,復盛元大9A購01  ,0,0,0,0,0,0,0,0,0,71000,0,0,0,71000,0,71000,71000
054884,友達統一99購01  ,0,0,0,0,0,0,0,0,0,71000,0,0,0,355000,284000,71000,71000
055150,台積電元大98購04,0,0,0,0,0,0,0,0,0,71000,0,0,0,326000,255000,71000,71000
055388,華通統一97購03  ,0,0,0,0,0,0,0,0,0,71000,0,0,0,71000,0,71000,71000
055460,華擎永豐97購01  ,0,0,0,0,0,0,0,0,0,71000,0,0,0,81000,10000,71000,71000
055462,華邦電日盛97購01,0,0,0,0,0,0,0,0,0,71000,0,0,0,181000,110000,71000,71000
046858,群創元大94購02  ,0,0,0,0,0,0,0,0,0,71000,0,0,0,411000,340000,71000,71000
051141,鈺齊永豐95購01  ,0,0,0,0,0,0,0,0,0,71000,0,0,0,76000,5000,71000,71000
048310,台達電凱基93購05,0,0,0,0,0,0,0,0,0,71000,0,0,0,71000,0,71000,71000
053495,聯發科兆豐96購02,0,0,0,0,0,0,0,0,0,71000,0,0,0,86000,15000,71000,71000
053981,康控元大96購05  ,0,0,0,0,0,0,0,0,0,71000,0,0,0,71000,0,71000,71000
054467,隆達凱基97購01  ,0,0,0,0,0,0,0,0,0,71000,0,0,0,71000,0,71000,71000
052310,聯電富邦95購01  ,0,0,0,0,0,0,0,0,0,71000,0,0,0,71000,0,71000,71000
2850,新產            ,110000,39000,71000,0,0,0,0,0,0,0,0,0,0,0,0,0,71000
055291,京鼎元大97購02  ,0,0,0,0,0,0,0,0,0,70000,0,0,0,152000,82000,70000,70000
055544,鴻海凱基97購05  ,0,0,0,0,0,0,0,0,0,70000,0,0,0,70000,0,70000,70000
055489,瑞昱元大97購02  ,0,0,0,0,0,0,0,0,0,70000,0,0,0,180000,110000,70000,70000
055731,美律元富97購01  ,0,0,0,0,0,0,0,0,0,70000,0,0,0,70000,0,70000,70000
055095,啟碁群益98購01  ,0,0,0,0,0,0,0,0,0,70000,0,0,0,81000,11000,70000,70000
054877,百和群益98購01  ,0,0,0,0,0,0,0,0,0,70000,0,0,0,75000,5000,70000,70000
056160,智易凱基97購03  ,0,0,0,0,0,0,0,0,0,70000,0,0,0,70000,0,70000,70000
046089,南亞科兆豐92購01,0,0,0,0,0,0,0,0,0,70000,0,0,0,70000,0,70000,70000
047870,嘉澤永豐93購02  ,0,0,0,0,0,0,0,0,0,70000,0,0,0,233000,163000,70000,70000
048518,聯茂凱基93購10  ,0,0,0,0,0,0,0,0,0,70000,0,0,0,70000,0,70000,70000
049477,泰鼎永豐94購01  ,0,0,0,0,0,0,0,0,0,70000,0,0,0,70000,0,70000,70000
044405,材料凱基93購01  ,0,0,0,0,0,0,0,0,0,70000,0,0,0,70000,0,70000,70000
043940,京元電兆豐92購01,0,0,0,0,0,0,0,0,0,70000,0,0,0,100000,30000,70000,70000
04512P,臺股指元大94售07,0,0,0,0,0,0,0,0,0,70000,0,0,0,70000,0,70000,70000
04276P,聯發科凱基93售33,0,0,0,0,0,0,0,0,0,70000,0,0,0,166000,96000,70000,70000
044362,元油2X中信94購01,0,0,0,0,0,0,0,0,0,70000,0,0,0,110000,40000,70000,70000
044265,滬深2X中信95購05,0,0,0,0,0,0,0,0,0,70000,0,0,0,70000,0,70000,70000
048311,台積電凱基93購28,0,0,0,0,0,0,0,0,0,70000,0,0,0,70000,0,70000,70000
048329,台積電永昌93購07,0,0,0,0,0,0,0,0,0,70000,0,0,0,173000,103000,70000,70000
048315,聯發科凱基93購32,0,0,0,0,0,0,0,0,0,70000,0,0,0,81000,11000,70000,70000
048155,瑞昱兆豐93購01  ,0,0,0,0,0,0,0,0,0,70000,0,0,0,90000,20000,70000,70000
048194,華邦電元大94購04,0,0,0,0,0,0,0,0,0,70000,0,0,0,100000,30000,70000,70000
050191,和碩元大94購02  ,0,0,0,0,0,0,0,0,0,70000,0,0,0,80000,10000,70000,70000
048742,瀚宇博統一94購01,0,0,0,0,0,0,0,0,0,70000,0,0,0,70000,0,70000,70000
050543,聯發科凱基95購01,0,0,0,0,0,0,0,0,0,70000,0,0,0,87000,17000,70000,70000
051597,T50反1中信99購02,0,0,0,0,0,0,0,0,0,70000,0,0,0,70000,0,70000,70000
051402,玉晶光永豐95購04,0,0,0,0,0,0,0,0,0,70000,0,0,0,70000,0,70000,70000
051509,鴻海中信97購01  ,0,0,0,0,0,0,0,0,0,70000,0,0,0,70000,0,70000,70000
050003,景碩永豐94購01  ,0,0,0,0,0,0,0,0,0,70000,0,0,0,247000,177000,70000,70000
050087,美食台新94購01  ,0,0,0,0,0,0,0,0,0,70000,0,0,0,70000,0,70000,70000
050092,鴻海永豐94購04  ,0,0,0,0,0,0,0,0,0,70000,0,0,0,433000,363000,70000,70000
052159,瑞昱永豐95購01  ,0,0,0,0,0,0,0,0,0,70000,0,0,0,146000,76000,70000,70000
052334,大成鋼日盛95購01,0,0,0,0,0,0,0,0,0,70000,0,0,0,70000,0,70000,70000
052359,百和永豐95購01  ,0,0,0,0,0,0,0,0,0,70000,0,0,0,70000,0,70000,70000
052365,聯詠國票95購02  ,0,0,0,0,0,0,0,0,0,70000,0,0,0,70000,0,70000,70000
051978,泰碩凱基96購01  ,0,0,0,0,0,0,0,0,0,70000,0,0,0,70000,0,70000,70000
052881,康控凱基97購01  ,0,0,0,0,0,0,0,0,0,70000,0,0,0,120000,50000,70000,70000
052944,宏達電國票97購01,0,0,0,0,0,0,0,0,0,70000,0,0,0,70000,0,70000,70000
052624,微星亞東97購01  ,0,0,0,0,0,0,0,0,0,70000,0,0,0,70000,0,70000,70000
052679,致伸富邦98購01  ,0,0,0,0,0,0,0,0,0,70000,0,0,0,100000,30000,70000,70000
054269,台光電亞東98購01,0,0,0,0,0,0,0,0,0,70000,0,0,0,70000,0,70000,70000
053555,日月光凱基97購01,0,0,0,0,0,0,0,0,0,70000,0,0,0,70000,0,70000,70000
2201,裕隆            ,1049000,1286000,-237000,0,0,0,0,0,0,307000,13000,1000,12000,351000,56000,295000,70000
056016,鴻海群益97購06  ,0,0,0,0,0,0,0,0,0,69000,0,0,0,69000,0,69000,69000
056486,樺漢元大98購04  ,0,0,0,0,0,0,0,0,0,69000,0,0,0,176000,107000,69000,69000
05677P,玉晶光群益98售03,0,0,0,0,0,0,0,0,0,69000,0,0,0,106000,37000,69000,69000
05849P,臺股指元大96售25,0,0,0,0,0,0,0,0,0,69000,0,0,0,175000,106000,69000,69000
055569,聚陽統一98購01  ,0,0,0,0,0,0,0,0,0,69000,0,0,0,69000,0,69000,69000
055565,祥碩凱基97購01  ,0,0,0,0,0,0,0,0,0,69000,0,0,0,86000,17000,69000,69000
047536,正崴日盛93購01  ,0,0,0,0,0,0,0,0,0,69000,0,0,0,69000,0,69000,69000
04103P,臺股指國票93售10,0,0,0,0,0,0,0,0,0,69000,0,0,0,80000,11000,69000,69000
04854P,鴻海國泰96售04  ,0,0,0,0,0,0,0,0,0,69000,0,0,0,77000,8000,69000,69000
051362,台郡元大95購04  ,0,0,0,0,0,0,0,0,0,69000,0,0,0,69000,0,69000,69000
049261,大立光元大94購08,0,0,0,0,0,0,0,0,0,69000,0,0,0,72000,3000,69000,69000
053742,創意國票97購01  ,0,0,0,0,0,0,0,0,0,69000,0,0,0,69000,0,69000,69000
054445,技嘉兆豐96購01  ,0,0,0,0,0,0,0,0,0,69000,0,0,0,122000,53000,69000,69000
052882,南電凱基96購02  ,0,0,0,0,0,0,0,0,0,69000,0,0,0,69000,0,69000,69000
051787,燿華國票96購02  ,0,0,0,0,0,0,0,0,0,69000,0,0,0,69000,0,69000,69000
055720,宏達電元大97購05,0,0,0,0,0,0,0,0,0,68000,0,0,0,68000,0,68000,68000
055673,旺宏日盛97購01  ,0,0,0,0,0,0,0,0,0,68000,0,0,0,86000,18000,68000,68000
055464,聚陽凱基97購01  ,0,0,0,0,0,0,0,0,0,68000,0,0,0,68000,0,68000,68000
054807,台化元大9A購02  ,0,0,0,0,0,0,0,0,0,68000,0,0,0,68000,0,68000,68000
054721,揚明光永豐97購03,0,0,0,0,0,0,0,0,0,68000,0,0,0,68000,0,68000,68000
054679,台積電康和99購01,0,0,0,0,0,0,0,0,0,68000,0,0,0,68000,0,68000,68000
054549,台積電凱基98購01,0,0,0,0,0,0,0,0,0,68000,0,0,0,102000,34000,68000,68000
055970,聯茂元大97購04  ,0,0,0,0,0,0,0,0,0,68000,0,0,0,71000,3000,68000,68000
055934,景碩群益98購03  ,0,0,0,0,0,0,0,0,0,68000,0,0,0,120000,52000,68000,68000
048559,京元電元大93購03,0,0,0,0,0,0,0,0,0,68000,0,0,0,68000,0,68000,68000
047023,聯發科元大93購08,0,0,0,0,0,0,0,0,0,68000,0,0,0,68000,0,68000,68000
047920,南亞科凱基93購04,0,0,0,0,0,0,0,0,0,68000,0,0,0,68000,0,68000,68000
047390,富邦金元大93購01,0,0,0,0,0,0,0,0,0,68000,0,0,0,68000,0,68000,68000
046188,京元電凱基92購06,0,0,0,0,0,0,0,0,0,68000,0,0,0,68000,0,68000,68000
047818,台郡凱基93購04  ,0,0,0,0,0,0,0,0,0,68000,0,0,0,68000,0,68000,68000
047533,瑞儀元大93購02  ,0,0,0,0,0,0,0,0,0,68000,0,0,0,68000,0,68000,68000
049263,大立光元大94購10,0,0,0,0,0,0,0,0,0,68000,0,0,0,68000,0,68000,68000
049309,台達電凱基94購05,0,0,0,0,0,0,0,0,0,68000,0,0,0,68000,0,68000,68000
048476,同欣電永豐93購01,0,0,0,0,0,0,0,0,0,68000,0,0,0,105000,37000,68000,68000
048770,揚明光凱基94購01,0,0,0,0,0,0,0,0,0,68000,0,0,0,68000,0,68000,68000
048320,聯詠凱基93購08  ,0,0,0,0,0,0,0,0,0,68000,0,0,0,76000,8000,68000,68000
049602,南電元大95購01  ,0,0,0,0,0,0,0,0,0,68000,0,0,0,68000,0,68000,68000
049563,華新統一95購01  ,0,0,0,0,0,0,0,0,0,68000,0,0,0,68000,0,68000,68000
051300,台光電凱基96購02,0,0,0,0,0,0,0,0,0,68000,0,0,0,68000,0,68000,68000
049075,光磊凱基94購01  ,0,0,0,0,0,0,0,0,0,68000,0,0,0,68000,0,68000,68000
047961,百和永豐93購03  ,0,0,0,0,0,0,0,0,0,68000,0,0,0,68000,0,68000,68000
051495,玉晶光第一95購02,0,0,0,0,0,0,0,0,0,68000,0,0,0,78000,10000,68000,68000
051669,建準元大95購01  ,0,0,0,0,0,0,0,0,0,68000,0,0,0,83000,15000,68000,68000
050118,臻鼎元大94購01  ,0,0,0,0,0,0,0,0,0,68000,0,0,0,68000,0,68000,68000
050273,GIS元大94購04   ,0,0,0,0,0,0,0,0,0,68000,0,0,0,68000,0,68000,68000
050287,台達電凱基94購10,0,0,0,0,0,0,0,0,0,68000,0,0,0,68000,0,68000,68000
050254,大立光富邦96購02,0,0,0,0,0,0,0,0,0,68000,0,0,0,78000,10000,68000,68000
051041,大立光永豐95購01,0,0,0,0,0,0,0,0,0,68000,0,0,0,68000,0,68000,68000
049914,瑞昱元大94購06  ,0,0,0,0,0,0,0,0,0,68000,0,0,0,110000,42000,68000,68000
049984,揚明光凱基94購04,0,0,0,0,0,0,0,0,0,68000,0,0,0,68000,0,68000,68000
051888,國巨元富95購05  ,0,0,0,0,0,0,0,0,0,68000,0,0,0,108000,40000,68000,68000
052489,義隆國票96購02  ,0,0,0,0,0,0,0,0,0,68000,0,0,0,70000,2000,68000,68000
052453,崇越元大95購01  ,0,0,0,0,0,0,0,0,0,68000,0,0,0,122000,54000,68000,68000
052160,美律永豐95購03  ,0,0,0,0,0,0,0,0,0,68000,0,0,0,68000,0,68000,68000
052285,康控凱基95購02  ,0,0,0,0,0,0,0,0,0,68000,0,0,0,68000,0,68000,68000
052251,台光電永豐95購03,0,0,0,0,0,0,0,0,0,68000,0,0,0,68000,0,68000,68000
052650,台郡永豐96購01  ,0,0,0,0,0,0,0,0,0,68000,0,0,0,68000,0,68000,68000
052568,漢唐凱基96購02  ,0,0,0,0,0,0,0,0,0,68000,0,0,0,68000,0,68000,68000
052820,宏達電永豐96購01,0,0,0,0,0,0,0,0,0,68000,0,0,0,68000,0,68000,68000
054443,樺漢台新96購02  ,0,0,0,0,0,0,0,0,0,68000,0,0,0,68000,0,68000,68000
054394,奇力新永豐96購03,0,0,0,0,0,0,0,0,0,68000,0,0,0,68000,0,68000,68000
054251,聯發科元大96購21,0,0,0,0,0,0,0,0,0,68000,0,0,0,68000,0,68000,68000
054182,台積電康和96購01,0,0,0,0,0,0,0,0,0,68000,0,0,0,68000,0,68000,68000
053731,矽創凱基96購03  ,0,0,0,0,0,0,0,0,0,68000,0,0,0,68000,0,68000,68000
053544,華新凱基96購01  ,0,0,0,0,0,0,0,0,0,68000,0,0,0,68000,0,68000,68000
053277,大立光元大96購04,0,0,0,0,0,0,0,0,0,68000,0,0,0,98000,30000,68000,68000
055937,康舒群益97購01  ,0,0,0,0,0,0,0,0,0,67000,0,0,0,119000,52000,67000,67000
056329,上銀國票98購02  ,0,15000,-15000,0,0,0,0,0,0,82000,0,0,0,98000,16000,82000,67000
05826P,臺股指凱基96售23,0,0,0,0,0,0,0,0,0,67000,0,0,0,123000,56000,67000,67000
056445,聯發科凱基98購07,0,0,0,0,0,0,0,0,0,67000,0,0,0,85000,18000,67000,67000
055655,群創元富99購07  ,0,0,0,0,0,0,0,0,0,67000,0,0,0,185000,118000,67000,67000
042502,上銀凱基93購01  ,0,0,0,0,0,0,0,0,0,67000,0,0,0,67000,0,67000,67000
03416B,臺股指凱基95熊05,0,0,0,0,0,0,0,0,0,67000,0,0,0,80000,13000,67000,67000
047789,景碩群益93購01  ,0,0,0,0,0,0,0,0,0,67000,0,0,0,119000,52000,67000,67000
046877,燿華國泰94購01  ,0,0,0,0,0,0,0,0,0,67000,0,0,0,115000,48000,67000,67000
046729,智伸科元大93購01,0,0,0,0,0,0,0,0,0,67000,0,0,0,67000,0,67000,67000
04542P,致伸永豐94售01  ,0,0,0,0,0,0,0,0,0,67000,0,0,0,157000,90000,67000,67000
051062,超眾群益95購02  ,0,0,0,0,0,0,0,0,0,67000,0,0,0,147000,80000,67000,67000
050782,台積電國泰96購03,0,0,0,0,0,0,0,0,0,67000,0,0,0,70000,3000,67000,67000
051028,台光電元富95購02,0,0,0,0,0,0,0,0,0,67000,0,0,0,222000,155000,67000,67000
053708,道瓊反凱基98購01,0,0,0,0,0,0,0,0,0,67000,0,0,0,107000,40000,67000,67000
054180,亞泥康和96購01  ,0,0,0,0,0,0,0,0,0,67000,0,0,0,67000,0,67000,67000
054161,友訊凱基98購01  ,0,0,0,0,0,0,0,0,0,67000,0,0,0,67000,0,67000,67000
054293,健策元大98購02  ,0,0,0,0,0,0,0,0,0,67000,0,0,0,86000,19000,67000,67000
052896,宏達電群益96購01,0,0,0,0,0,0,0,0,0,67000,0,0,0,77000,10000,67000,67000
055686,致伸凱基97購02  ,0,0,0,0,0,0,0,0,0,66000,0,0,0,86000,20000,66000,66000
055682,智原凱基98購02  ,0,0,0,0,0,0,0,0,0,66000,0,0,0,176000,110000,66000,66000
054505,揚明光永豐97購02,0,0,0,0,0,0,0,0,0,66000,0,0,0,68000,2000,66000,66000
054588,玉晶光國泰99購02,0,0,0,0,0,0,0,0,0,66000,0,0,0,84000,18000,66000,66000
054778,世紀鋼國票99購01,0,0,0,0,0,0,0,0,0,66000,0,0,0,66000,0,66000,66000
05893P,國巨兆豐96售04  ,0,0,0,0,0,0,0,0,0,66000,0,0,0,66000,0,66000,66000
046621,智伸科凱基93購02,0,0,0,0,0,0,0,0,0,66000,0,0,0,66000,0,66000,66000
046894,日月光群益93購01,0,0,0,0,0,0,0,0,0,66000,0,0,0,116000,50000,66000,66000
044588,元金2X統一93購01,0,0,0,0,0,0,0,0,0,66000,0,0,0,120000,54000,66000,66000
04121P,宏碁凱基93售02  ,0,0,0,0,0,0,0,0,0,66000,0,0,0,100000,34000,66000,66000
044124,燿華凱基93購01  ,0,0,0,0,0,0,0,0,0,66000,0,0,0,66000,0,66000,66000
050940,嘉澤國票95購01  ,0,0,0,0,0,0,0,0,0,66000,0,0,0,104000,38000,66000,66000
05032P,台積電國泰96售05,0,0,0,0,0,0,0,0,0,66000,0,0,0,66000,0,66000,66000
048963,川湖元大94購01  ,0,0,0,0,0,0,0,0,0,66000,0,0,0,76000,10000,66000,66000
049113,大立光統一94購06,0,0,0,0,0,0,0,0,0,66000,0,0,0,66000,0,66000,66000
048036,隆達凱基93購01  ,0,0,0,0,0,0,0,0,0,66000,0,0,0,66000,0,66000,66000
049031,矽格群益94購01  ,0,0,0,0,0,0,0,0,0,66000,0,0,0,76000,10000,66000,66000
052993,欣興台新97購01  ,0,0,0,0,0,0,0,0,0,66000,0,0,0,66000,0,66000,66000
053083,中環元大99購01  ,0,0,0,0,0,0,0,0,0,66000,0,0,0,76000,10000,66000,66000
054108,台積電凱基96購22,0,0,0,0,0,0,0,0,0,66000,0,0,0,68000,2000,66000,66000
053918,美律國票97購01  ,0,0,0,0,0,0,0,0,0,66000,0,0,0,134000,68000,66000,66000
053249,致伸國票97購02  ,0,0,0,0,0,0,0,0,0,66000,0,0,0,104000,38000,66000,66000
053417,上銀永豐96購02  ,0,0,0,0,0,0,0,0,0,66000,0,0,0,181000,115000,66000,66000
053396,漢唐中信9A購01  ,0,0,0,0,0,0,0,0,0,66000,0,0,0,66000,0,66000,66000
056409,麗豐國票99購01  ,0,0,0,0,0,0,0,0,0,65000,0,0,0,65000,0,65000,65000
055960,義隆元大97購01  ,0,0,0,0,0,0,0,0,0,65000,0,0,0,86000,21000,65000,65000
054680,華新科康和97購02,0,0,0,0,0,0,0,0,0,65000,0,0,0,87000,22000,65000,65000
054901,群光康和97購01  ,0,0,0,0,0,0,0,0,0,65000,0,0,0,65000,0,65000,65000
055449,超眾統一9A購01  ,0,0,0,0,0,0,0,0,0,65000,0,0,0,70000,5000,65000,65000
055425,聚陽群益99購01  ,0,0,0,0,0,0,0,0,0,65000,0,0,0,75000,10000,65000,65000
055417,健策富邦98購02  ,0,0,0,0,0,0,0,0,0,65000,0,0,0,80000,15000,65000,65000
055359,超眾凱基97購01  ,0,0,0,0,0,0,0,0,0,65000,0,0,0,65000,0,65000,65000
055189,台虹統一97購01  ,0,0,0,0,0,0,0,0,0,65000,0,0,0,65000,0,65000,65000
044605,超眾國泰93購02  ,0,0,0,0,0,0,0,0,0,65000,0,0,0,115000,50000,65000,65000
047867,旺宏永豐93購02  ,0,0,0,0,0,0,0,0,0,65000,0,0,0,427000,362000,65000,65000
050702,崇越凱基94購01  ,0,0,0,0,0,0,0,0,0,65000,0,0,0,65000,0,65000,65000
050453,創意元大95購03  ,0,0,0,0,0,0,0,0,0,65000,0,0,0,68000,3000,65000,65000
047751,玉山金元富93購01,0,0,0,0,0,0,0,0,0,65000,0,0,0,75000,10000,65000,65000
051286,國巨統一97購01  ,0,0,0,0,0,0,0,0,0,65000,0,0,0,67000,2000,65000,65000
051385,矽創群益95購01  ,0,0,0,0,0,0,0,0,0,65000,0,0,0,88000,23000,65000,65000
051428,玉晶光統一96購01,0,0,0,0,0,0,0,0,0,65000,0,0,0,65000,0,65000,65000
048602,上緯控國票96購01,0,0,0,0,0,0,0,0,0,65000,0,0,0,65000,0,65000,65000
048455,上緯控凱基94購01,0,0,0,0,0,0,0,0,0,65000,0,0,0,65000,0,65000,65000
053410,啟碁兆豐96購01  ,0,0,0,0,0,0,0,0,0,65000,0,0,0,65000,0,65000,65000
053671,可成統一96購03  ,0,0,0,0,0,0,0,0,0,65000,0,0,0,65000,0,65000,65000
053973,晶豪科元大96購01,0,0,0,0,0,0,0,0,0,65000,0,0,0,65000,0,65000,65000
05420P,大立光國泰97售03,0,0,0,0,0,0,0,0,0,65000,0,0,0,95000,30000,65000,65000
054453,上海銀亞東96購01,0,0,0,0,0,0,0,0,0,65000,0,0,0,65000,0,65000,65000
3532,台勝科          ,299000,278000,21000,0,0,0,1000,0,1000,43000,23000,3000,20000,34000,11000,23000,65000
06208P,台郡凱基97售03  ,0,0,0,0,0,0,0,0,0,65000,0,0,0,85000,20000,65000,65000
055738,玉山金元富97購01,0,0,0,0,0,0,0,0,0,64000,0,0,0,101000,37000,64000,64000
055618,麗豐國票98購01  ,0,0,0,0,0,0,0,0,0,64000,0,0,0,104000,40000,64000,64000
055501,創意元大97購01  ,0,0,0,0,0,0,0,0,0,64000,0,0,0,84000,20000,64000,64000
054772,康控國票98購02  ,0,0,0,0,0,0,0,0,0,64000,0,0,0,64000,0,64000,64000
054604,麗豐台新98購01  ,0,0,0,0,0,0,0,0,0,64000,0,0,0,87000,23000,64000,64000
05884P,旺宏統一96售01  ,0,0,0,0,0,0,0,0,0,64000,0,0,0,79000,15000,64000,64000
047007,大立光統一93購05,0,0,0,0,0,0,0,0,0,64000,0,0,0,64000,0,64000,64000
047134,聯發科凱基93購10,0,0,0,0,0,0,0,0,0,64000,0,0,0,64000,0,64000,64000
048841,聯茂凱基94購06  ,0,0,0,0,0,0,0,0,0,64000,0,0,0,64000,0,64000,64000
05117P,瑞昱群益95售02  ,0,0,0,0,0,0,0,0,0,64000,0,0,0,77000,13000,64000,64000
050158,上海銀群益96購01,0,0,0,0,0,0,0,0,0,64000,0,0,0,159000,95000,64000,64000
051425,昇陽半國票97購01,0,0,0,0,0,0,0,0,0,64000,0,0,0,123000,59000,64000,64000
051603,深中小群益99購03,0,0,0,0,0,0,0,0,0,64000,0,0,0,74000,10000,64000,64000
051089,旺宏元大96購04  ,0,0,0,0,0,0,0,0,0,64000,0,0,0,160000,96000,64000,64000
053653,京元電凱基96購02,0,0,0,0,0,0,0,0,0,64000,0,0,0,69000,5000,64000,64000
053845,和大元富96購01  ,0,0,0,0,0,0,0,0,0,64000,0,0,0,70000,6000,64000,64000
053407,台積電兆豐96購02,0,0,0,0,0,0,0,0,0,64000,0,0,0,78000,14000,64000,64000
053333,新唐永豐96購01  ,0,0,0,0,0,0,0,0,0,64000,0,0,0,64000,0,64000,64000
052861,台光電凱基96購03,0,0,0,0,0,0,0,0,0,64000,0,0,0,94000,30000,64000,64000
052209,深中小元大95購02,0,0,0,0,0,0,0,0,0,64000,0,0,0,64000,0,64000,64000
06105P,國巨國票98售02  ,0,0,0,0,0,0,0,0,0,64000,0,0,0,94000,30000,64000,64000
056255,華新科元富97購05,0,0,0,0,0,0,0,0,0,63000,0,0,0,96000,33000,63000,63000
055783,群創凱基99購03  ,0,0,0,0,0,0,0,0,0,63000,0,0,0,123000,60000,63000,63000
048545,嘉澤永豐93購03  ,0,0,0,0,0,0,0,0,0,63000,0,0,0,317000,254000,63000,63000
050712,和碩中信94購01  ,0,0,0,0,0,0,0,0,0,63000,0,0,0,133000,70000,63000,63000
04547P,高鐵元大94售01  ,0,0,0,0,0,0,0,0,0,63000,0,0,0,64000,1000,63000,63000
049944,日月光第一94購01,0,0,0,0,0,0,0,0,0,63000,0,0,0,63000,0,63000,63000
049352,泰鼎永豐95購01  ,0,0,0,0,0,0,0,0,0,63000,0,0,0,127000,64000,63000,63000
049668,大立光國泰96購02,0,0,0,0,0,0,0,0,0,63000,0,0,0,264000,201000,63000,63000
050984,大立光國泰97購01,0,0,0,0,0,0,0,0,0,63000,0,0,0,74000,11000,63000,63000
048313,南亞科凱基93購06,0,0,0,0,0,0,0,0,0,63000,0,0,0,73000,10000,63000,63000
051832,復盛元大95購01  ,0,0,0,0,0,0,0,0,0,63000,0,0,0,63000,0,63000,63000
052915,創意元富96購01  ,0,0,0,0,0,0,0,0,0,63000,0,0,0,63000,0,63000,63000
053349,台郡國票97購02  ,0,0,0,0,0,0,0,0,0,63000,0,0,0,94000,31000,63000,63000
3443,創意            ,322000,205000,117000,0,0,0,0,0,0,-54000,14000,52000,-38000,11000,27000,-16000,63000
4564,元翎            ,228000,164000,64000,0,0,0,0,0,0,-1000,0,1000,-1000,0,0,0,63000
055614,華新科國票97購02,0,0,0,0,0,0,0,0,0,62000,0,0,0,87000,25000,62000,62000
054779,台塑群益98購01  ,0,0,0,0,0,0,0,0,0,62000,0,0,0,73000,11000,62000,62000
054818,奇力新元大97購05,0,0,0,0,0,0,0,0,0,62000,0,0,0,67000,5000,62000,62000
055156,華新科元大99購02,0,0,0,0,0,0,0,0,0,62000,0,0,0,62000,0,62000,62000
055157,晶豪科元大97購01,0,0,0,0,0,0,0,0,0,62000,0,0,0,75000,13000,62000,62000
056209,超眾永豐97購02  ,0,0,0,0,0,0,0,0,0,62000,0,0,0,108000,46000,62000,62000
056335,微星凱基98購01  ,0,0,0,0,0,0,0,0,0,62000,0,0,0,233000,171000,62000,62000
056023,晶豪科群益97購01,0,0,0,0,0,0,0,0,0,62000,0,0,0,62000,0,62000,62000
05911P,南亞科永豐96售03,0,0,0,0,0,0,0,0,0,62000,0,0,0,78000,16000,62000,62000
056516,晶豪科兆豐98購01,0,0,0,0,0,0,0,0,0,62000,0,0,0,118000,56000,62000,62000
047713,大立光凱基93購24,0,0,0,0,0,0,0,0,0,62000,0,0,0,62000,0,62000,62000
045851,健策永豐92購01  ,0,0,0,0,0,0,0,0,0,62000,0,0,0,62000,0,62000,62000
045958,技嘉凱基93購04  ,0,0,0,0,0,0,0,0,0,62000,0,0,0,62000,0,62000,62000
047909,超眾元大93購03  ,0,0,0,0,0,0,0,0,0,62000,0,0,0,62000,0,62000,62000
047901,復盛群益93購01  ,0,0,0,0,0,0,0,0,0,62000,0,0,0,75000,13000,62000,62000
049434,茂林國票95購01  ,0,0,0,0,0,0,0,0,0,62000,0,0,0,62000,0,62000,62000
050864,亞光永豐95購01  ,0,0,0,0,0,0,0,0,0,62000,0,0,0,62000,0,62000,62000
051102,訊芯元大96購01  ,0,0,0,0,0,0,0,0,0,62000,0,0,0,62000,0,62000,62000
048889,牧德元富94購03  ,0,0,0,0,0,0,0,0,0,62000,0,0,0,117000,55000,62000,62000
051494,中環兆豐95購01  ,0,0,0,0,0,0,0,0,0,62000,0,0,0,92000,30000,62000,62000
053408,友達兆豐98購01  ,0,0,0,0,0,0,0,0,0,62000,0,0,0,62000,0,62000,62000
053595,創意元大96購02  ,0,0,0,0,0,0,0,0,0,62000,0,0,0,62000,0,62000,62000
054090,瑞昱群益97購01  ,0,0,0,0,0,0,0,0,0,62000,0,0,0,73000,11000,62000,62000
054082,楠梓電元富96購01,0,0,0,0,0,0,0,0,0,62000,0,0,0,82000,20000,62000,62000
052215,樺漢元大96購02  ,0,0,0,0,0,0,0,0,0,62000,0,0,0,80000,18000,62000,62000
052390,聯詠群益95購03  ,0,0,0,0,0,0,0,0,0,62000,0,0,0,185000,123000,62000,62000
05790P,臺股指永昌96售07,0,0,0,0,0,0,0,0,0,61000,310000,0,310000,186000,435000,-249000,61000
047107,上銀元大93購04  ,0,0,0,0,0,0,0,0,0,61000,0,0,0,61000,0,61000,61000
050384,嘉澤國票94購02  ,0,0,0,0,0,0,0,0,0,61000,0,0,0,75000,14000,61000,61000
046222,上銀元大92購08  ,0,0,0,0,0,0,0,0,0,61000,0,0,0,61000,0,61000,61000
04036P,臻鼎群益93售03  ,0,0,0,0,0,0,0,0,0,61000,0,0,0,81000,20000,61000,61000
051622,和碩凱基96購01  ,0,0,0,0,0,0,0,0,0,61000,0,0,0,91000,30000,61000,61000
051667,光磊元大96購02  ,0,0,0,0,0,0,0,0,0,61000,0,0,0,161000,100000,61000,61000
048980,嘉澤元大94購02  ,0,0,0,0,0,0,0,0,0,61000,0,0,0,239000,178000,61000,61000
050291,聯發科凱基94購16,0,0,0,0,0,0,0,0,0,61000,0,0,0,77000,16000,61000,61000
049826,光磊凱基94購02  ,0,0,0,0,0,0,0,0,0,61000,0,0,0,127000,66000,61000,61000
048707,南電國票95購01  ,0,0,0,0,0,0,0,0,0,61000,0,0,0,61000,0,61000,61000
048642,聯發科元大94購02,0,0,0,0,0,0,0,0,0,61000,0,0,0,270000,209000,61000,61000
049800,瑞昱元大94購05  ,0,0,0,0,0,0,0,0,0,61000,0,0,0,104000,43000,61000,61000
052444,友訊元大95購01  ,0,0,0,0,0,0,0,0,0,61000,0,0,0,71000,10000,61000,61000
051936,力山群益95購02  ,0,0,0,0,0,0,0,0,0,61000,0,0,0,61000,0,61000,61000
052003,泰碩國泰97購02  ,0,0,0,0,0,0,0,0,0,61000,0,0,0,161000,100000,61000,61000
052959,聯電凱基97購01  ,0,0,0,0,0,0,0,0,0,61000,0,0,0,95000,34000,61000,61000
053132,國巨國票97購02  ,0,0,0,0,0,0,0,0,0,61000,0,0,0,81000,20000,61000,61000
052529,力成元大95購03  ,0,0,0,0,0,0,0,0,0,61000,0,0,0,108000,47000,61000,61000
053990,晶技兆豐96購01  ,0,0,0,0,0,0,0,0,0,61000,0,0,0,61000,0,61000,61000
054410,國巨元大96購14  ,0,0,0,0,0,0,0,0,0,61000,0,0,0,111000,50000,61000,61000
053469,光磊元大97購01  ,0,0,0,0,0,0,0,0,0,61000,0,0,0,61000,0,61000,61000
053299,台泥凱基96購01  ,0,0,0,0,0,0,0,0,0,61000,0,0,0,61000,0,61000,61000
056477,欣興元大98購02  ,0,0,0,0,0,0,0,0,0,60000,0,0,0,155000,95000,60000,60000
056599,臻鼎元富98購01  ,0,0,0,0,0,0,0,0,0,60000,0,0,0,60000,0,60000,60000
056580,泰鼎元大9A購01  ,0,0,0,0,0,0,0,0,0,60000,0,0,0,145000,85000,60000,60000
055878,泰碩元富97購02  ,0,0,0,0,0,0,0,0,0,60000,0,0,0,60000,0,60000,60000
056427,上銀凱基98購03  ,0,0,0,0,0,0,0,0,0,60000,0,0,0,60000,0,60000,60000
055101,台肥凱基97購01  ,0,0,0,0,0,0,0,0,0,60000,0,0,0,100000,40000,60000,60000
054771,茂林國票98購02  ,0,0,0,0,0,0,0,0,0,60000,0,0,0,60000,0,60000,60000
054754,昇陽半凱基98購02,0,0,0,0,0,0,0,0,0,60000,0,0,0,100000,40000,60000,60000
055563,智易凱基97購02  ,0,0,0,0,0,0,0,0,0,60000,0,0,0,61000,1000,60000,60000
055691,訊芯凱基97購02  ,0,0,0,0,0,0,0,0,0,60000,0,0,0,60000,0,60000,60000
055253,大立光統一97購06,0,0,0,0,0,0,0,0,0,60000,0,0,0,60000,0,60000,60000
055369,友訊元大97購01  ,0,0,0,0,0,0,0,0,0,60000,0,0,0,163000,103000,60000,60000
04025P,宏達電國泰94售01,0,0,0,0,0,0,0,0,0,60000,0,0,0,60000,0,60000,60000
04001P,聯發科凱基93售15,0,0,0,0,0,0,0,0,0,60000,0,0,0,60000,0,60000,60000
03947P,新光金國泰94售01,0,0,0,0,0,0,0,0,0,60000,0,0,0,60000,0,60000,60000
044671,台積電兆豐93購01,0,0,0,0,0,0,0,0,0,60000,0,0,0,82000,22000,60000,60000
045001,旺宏富邦94購01  ,0,0,0,0,0,0,0,0,0,60000,0,0,0,70000,10000,60000,60000
03544P,鴻海群益02售07  ,0,0,0,0,0,0,0,0,0,60000,0,0,0,288000,228000,60000,60000
044094,南亞科統一92購01,0,0,0,0,0,0,0,0,0,60000,0,0,0,60000,0,60000,60000
045055,聯發科元富98購03,0,0,0,0,0,0,0,0,0,60000,0,0,0,70000,10000,60000,60000
04344P,台達電國泰94售01,0,0,0,0,0,0,0,0,0,60000,0,0,0,80000,20000,60000,60000
047601,上海銀中信93購01,0,0,0,0,0,0,0,0,0,60000,0,0,0,80000,20000,60000,60000
047565,美律國票93購02  ,0,0,0,0,0,0,0,0,0,60000,0,0,0,60000,0,60000,60000
046231,創意元大92購07  ,0,0,0,0,0,0,0,0,0,60000,0,0,0,60000,0,60000,60000
046045,聯茂元大92購07  ,0,0,0,0,0,0,0,0,0,60000,0,0,0,60000,0,60000,60000
045448,宏達電國泰93購02,0,0,0,0,0,0,0,0,0,60000,0,0,0,60000,0,60000,60000
050388,鴻海統一94購09  ,0,0,0,0,0,0,0,0,0,60000,0,0,0,70000,10000,60000,60000
046911,達方凱基93購01  ,0,0,0,0,0,0,0,0,0,60000,0,0,0,60000,0,60000,60000
047199,鴻海元富93購03  ,0,0,0,0,0,0,0,0,0,60000,0,0,0,60000,0,60000,60000
04941P,台達電台新94售02,0,0,0,0,0,0,0,0,0,60000,0,0,0,60000,0,60000,60000
048401,南電國票93購03  ,0,0,0,0,0,0,0,0,0,60000,0,0,0,60000,0,60000,60000
048430,瑞昱國票93購02  ,0,0,0,0,0,0,0,0,0,60000,0,0,0,62000,2000,60000,60000
051250,大立光元大98購01,0,0,0,0,0,0,0,0,0,60000,0,0,0,61000,1000,60000,60000
048657,大成鋼統一93購04,0,0,0,0,0,0,0,0,0,60000,0,0,0,60000,0,60000,60000
050971,緯穎永豐95購01  ,0,0,0,0,0,0,0,0,0,60000,0,0,0,235000,175000,60000,60000
051005,緯創中信95購02  ,0,0,0,0,0,0,0,0,0,60000,0,0,0,108000,48000,60000,60000
050839,楠梓電國票96購01,0,0,0,0,0,0,0,0,0,60000,0,0,0,60000,0,60000,60000
050853,南電國票96購01  ,0,0,0,0,0,0,0,0,0,60000,0,0,0,60000,0,60000,60000
050779,超眾元大96購03  ,0,0,0,0,0,0,0,0,0,60000,0,0,0,272000,212000,60000,60000
050549,慧洋凱基95購01  ,0,0,0,0,0,0,0,0,0,60000,0,0,0,100000,40000,60000,60000
050496,鴻海富邦96購01  ,0,0,0,0,0,0,0,0,0,60000,0,0,0,60000,0,60000,60000
049833,正文凱基94購05  ,0,0,0,0,0,0,0,0,0,60000,0,0,0,60000,0,60000,60000
051304,緯創凱基96購01  ,0,0,0,0,0,0,0,0,0,60000,0,0,0,60000,0,60000,60000
051338,揚明光永豐95購02,0,0,0,0,0,0,0,0,0,60000,0,0,0,60000,0,60000,60000
053345,欣興國票97購02  ,0,0,0,0,0,0,0,0,0,60000,0,0,0,60000,0,60000,60000
054457,強茂群益96購01  ,0,0,0,0,0,0,0,0,0,60000,0,0,0,104000,44000,60000,60000
053931,楠梓電統一96購01,0,0,0,0,0,0,0,0,0,60000,0,0,0,60000,0,60000,60000
053141,景碩永豐96購02  ,0,0,0,0,0,0,0,0,0,60000,0,0,0,60000,0,60000,60000
053099,正崴元富96購01  ,0,0,0,0,0,0,0,0,0,60000,0,0,0,60000,0,60000,60000
052366,聯詠國票96購01  ,0,0,0,0,0,0,0,0,0,60000,0,0,0,60000,0,60000,60000
052298,易華電國票96購01,0,0,0,0,0,0,0,0,0,60000,0,0,0,60000,0,60000,60000
6269,台郡            ,795000,643000,152000,0,0,0,13000,73000,-60000,-32000,45000,73000,-28000,30000,34000,-4000,60000
055642,廣宇元富97購01  ,0,0,0,0,0,0,0,0,0,59000,0,0,0,61000,2000,59000,59000
054565,玉晶光群益99購02,0,0,0,0,0,0,0,0,0,59000,0,0,0,95000,36000,59000,59000
055097,福懋科群益97購01,0,0,0,0,0,0,0,0,0,59000,0,0,0,167000,108000,59000,59000
054966,貿聯元大98購02  ,0,0,0,0,0,0,0,0,0,59000,0,0,0,70000,11000,59000,59000
056056,旺宏元大97購06  ,0,0,0,0,0,0,0,0,0,59000,0,0,0,348000,289000,59000,59000
047298,聯茂元富96購01  ,0,0,0,0,0,0,0,0,0,59000,0,0,0,64000,5000,59000,59000
047255,訊芯群益93購01  ,0,0,0,0,0,0,0,0,0,59000,0,0,0,59000,0,59000,59000
050723,楠梓電國票94購01,0,0,0,0,0,0,0,0,0,59000,0,0,0,59000,0,59000,59000
046715,美律國泰94購01  ,0,0,0,0,0,0,0,0,0,59000,0,0,0,79000,20000,59000,59000
047996,華邦電元大93購04,0,0,0,0,0,0,0,0,0,59000,0,0,0,59000,0,59000,59000
049334,上銀統一94購01  ,0,0,0,0,0,0,0,0,0,59000,0,0,0,59000,0,59000,59000
049126,玉晶光元富94購02,0,0,0,0,0,0,0,0,0,59000,0,0,0,116000,57000,59000,59000
051118,台塑群益95購01  ,0,0,0,0,0,0,0,0,0,59000,0,0,0,69000,10000,59000,59000
051784,國巨兆豐95購01  ,0,0,0,0,0,0,0,0,0,59000,0,0,0,59000,0,59000,59000
052574,茂林凱基96購02  ,0,0,0,0,0,0,0,0,0,59000,0,0,0,115000,56000,59000,59000
054247,華邦電元大96購04,0,0,0,0,0,0,0,0,0,59000,0,0,0,68000,9000,59000,59000
053243,楠梓電國票97購02,0,0,0,0,0,0,0,0,0,59000,0,0,0,89000,30000,59000,59000
06458P,玉晶光統一9A售02,0,0,0,0,0,0,0,0,0,59000,0,0,0,81000,22000,59000,59000
056566,臻鼎群益98購01  ,0,0,0,0,0,0,0,0,0,58000,0,0,0,93000,35000,58000,58000
056509,晶相光永豐98購01,0,0,0,0,0,0,0,0,0,58000,0,0,0,58000,0,58000,58000
055148,鴻海元大98購02  ,0,0,0,0,0,0,0,0,0,58000,0,0,0,94000,36000,58000,58000
054613,大立光永豐97購02,0,0,0,0,0,0,0,0,0,58000,0,0,0,68000,10000,58000,58000
05531P,臺股指群益96售04,0,0,0,0,0,0,0,0,0,58000,0,0,0,58000,0,58000,58000
055230,大毅國票98購01  ,0,0,0,0,0,0,0,0,0,58000,0,0,0,126000,68000,58000,58000
055231,大毅國票98購02  ,0,0,0,0,0,0,0,0,0,58000,0,0,0,58000,0,58000,58000
046308,廣達元大92購02  ,0,0,0,0,0,0,0,0,0,58000,0,0,0,58000,0,58000,58000
050733,寶成國票94購01  ,0,0,0,0,0,0,0,0,0,58000,0,0,0,58000,0,58000,58000
048533,景碩國票94購01  ,0,0,0,0,0,0,0,0,0,58000,0,0,0,71000,13000,58000,58000
047349,可成凱基93購06  ,0,0,0,0,0,0,0,0,0,58000,0,0,0,68000,10000,58000,58000
051119,光寶科群益95購01,0,0,0,0,0,0,0,0,0,58000,0,0,0,58000,0,58000,58000
050505,可成凱基94購12  ,0,0,0,0,0,0,0,0,0,58000,0,0,0,68000,10000,58000,58000
048721,正文永豐94購01  ,0,0,0,0,0,0,0,0,0,58000,0,0,0,58000,0,58000,58000
050548,華固凱基95購01  ,0,0,0,0,0,0,0,0,0,58000,0,0,0,68000,10000,58000,58000
050513,亞泥元大94購02  ,0,0,0,0,0,0,0,0,0,58000,0,0,0,84000,26000,58000,58000
050768,聯發科元大94購16,0,0,0,0,0,0,0,0,0,58000,0,0,0,68000,10000,58000,58000
051038,健策台新95購01  ,0,0,0,0,0,0,0,0,0,58000,0,0,0,58000,0,58000,58000
050065,冠德凱基94購01  ,0,0,0,0,0,0,0,0,0,58000,0,0,0,68000,10000,58000,58000
049927,健策元大94購02  ,0,0,0,0,0,0,0,0,0,58000,0,0,0,64000,6000,58000,58000
053304,可成凱基96購03  ,0,0,0,0,0,0,0,0,0,58000,0,0,0,68000,10000,58000,58000
053838,正文永豐96購02  ,0,0,0,0,0,0,0,0,0,58000,0,0,0,58000,0,58000,58000
054005,旺宏統一97購04  ,0,0,0,0,0,0,0,0,0,58000,0,0,0,58000,0,58000,58000
054097,淘帝國票97購01  ,0,0,0,0,0,0,0,0,0,58000,0,0,0,58000,0,58000,58000
052989,麗豐元大98購01  ,0,0,0,0,0,0,0,0,0,58000,0,0,0,144000,86000,58000,58000
051830,健策元大97購01  ,0,0,0,0,0,0,0,0,0,58000,0,0,0,157000,99000,58000,58000
052090,聯發科元大97購03,0,0,0,0,0,0,0,0,0,58000,0,0,0,132000,74000,58000,58000
052239,泰鼎國票97購01  ,0,0,0,0,0,0,0,0,0,58000,0,0,0,58000,0,58000,58000
055180,文曄統一97購01  ,0,0,0,0,0,0,0,0,0,57000,0,0,0,177000,120000,57000,57000
047015,上銀元大93購03  ,0,0,0,0,0,0,0,0,0,57000,0,0,0,61000,4000,57000,57000
048897,日電貿國泰95購01,0,0,0,0,0,0,0,0,0,57000,0,0,0,77000,20000,57000,57000
050271,上緯控元大96購01,0,0,0,0,0,0,0,0,0,57000,0,0,0,57000,0,57000,57000
050264,聯發科元大94購13,0,0,0,0,0,0,0,0,0,57000,0,0,0,451000,394000,57000,57000
050119,瀚宇博元大95購03,0,0,0,0,0,0,0,0,0,57000,0,0,0,57000,0,57000,57000
050075,南電凱基94購04  ,0,0,0,0,0,0,0,0,0,57000,0,0,0,61000,4000,57000,57000
047953,台積電永豐93購04,0,0,0,0,0,0,0,0,0,57000,0,0,0,57000,0,57000,57000
051538,和碩國票96購01  ,0,0,0,0,0,0,0,0,0,57000,0,0,0,60000,3000,57000,57000
051401,華新科永豐95購01,0,0,0,0,0,0,0,0,0,57000,0,0,0,151000,94000,57000,57000
052957,T50反1凱基99購01,0,0,0,0,0,0,0,0,0,57000,0,0,0,57000,0,57000,57000
052823,創意永豐96購02  ,0,0,0,0,0,0,0,0,0,57000,0,0,0,74000,17000,57000,57000
06089P,矽創永豐97售01  ,0,0,0,0,0,0,0,0,0,57000,0,0,0,57000,0,57000,57000
055307,瑞昱群益97購02  ,0,0,0,0,0,0,0,0,0,56000,0,0,0,63000,7000,56000,56000
055490,台光電元大97購01,0,0,0,0,0,0,0,0,0,56000,0,0,0,56000,0,56000,56000
054803,味全元大9A購01  ,0,0,0,0,0,0,0,0,0,56000,0,0,0,56000,0,56000,56000
054957,興富發元大97購01,0,0,0,0,0,0,0,0,0,56000,0,0,0,61000,5000,56000,56000
050404,元大金麥證94購01,0,0,0,57000,1000,56000,0,0,0,56000,0,0,0,57000,1000,56000,56000
046919,大毅永豐93購01  ,0,0,0,0,0,0,0,0,0,56000,0,0,0,59000,3000,56000,56000
046164,健策兆豐93購03  ,0,0,0,0,0,0,0,0,0,56000,0,0,0,56000,0,56000,56000
04233P,儒鴻兆豐93售01  ,0,0,0,0,0,0,0,0,0,56000,0,0,0,168000,112000,56000,56000
035277,景碩台新97購01  ,0,0,0,0,0,0,0,0,0,56000,0,0,0,74000,18000,56000,56000
04102P,臺股指國票93售09,0,0,0,0,0,0,0,0,0,56000,0,0,0,56000,0,56000,56000
051563,泰鼎國泰96購01  ,0,0,0,0,0,0,0,0,0,56000,0,0,0,67000,11000,56000,56000
05169P,玉晶光元大95售03,0,0,0,0,0,0,0,0,0,56000,0,0,0,56000,0,56000,56000
050036,矽格元大94購03  ,0,0,0,0,0,0,0,0,0,56000,0,0,0,56000,0,56000,56000
050318,景碩國票94購02  ,0,0,0,0,0,0,0,0,0,56000,0,0,0,56000,0,56000,56000
049569,光磊統一94購02  ,0,0,0,0,0,0,0,0,0,56000,0,0,0,56000,0,56000,56000
048107,華通群益93購02  ,0,0,0,0,0,0,0,0,0,56000,0,0,0,56000,0,56000,56000
049291,華通群益94購04  ,0,0,0,0,0,0,0,0,0,56000,0,0,0,56000,0,56000,56000
052621,台郡富邦97購01  ,0,0,0,0,0,0,0,0,0,56000,0,0,0,60000,4000,56000,56000
052995,上銀康和96購01  ,0,0,0,0,0,0,0,0,0,56000,0,0,0,66000,10000,56000,56000
052124,京鼎國票95購01  ,0,0,0,0,0,0,0,0,0,56000,0,0,0,66000,10000,56000,56000
052428,嘉晶永豐95購01  ,0,0,0,0,0,0,0,0,0,56000,0,0,0,100000,44000,56000,56000
052484,矽創群益95購02  ,0,0,0,0,0,0,0,0,0,56000,0,0,0,90000,34000,56000,56000
054254,晶豪科元大96購02,0,0,0,0,0,0,0,0,0,56000,0,0,0,66000,10000,56000,56000
054216,聯茂國票97購03  ,0,0,0,0,0,0,0,0,0,56000,0,0,0,56000,0,56000,56000
053274,旺宏元大98購03  ,0,0,0,0,0,0,0,0,0,56000,0,0,0,78000,22000,56000,56000
3607,谷崧            ,82000,27000,55000,0,0,0,0,0,0,1000,1000,0,1000,0,0,0,56000
054933,南港元大97購01  ,0,0,0,0,0,0,0,0,0,55000,0,0,0,95000,40000,55000,55000
055499,大立光元大98購05,0,0,0,0,0,0,0,0,0,55000,0,0,0,68000,13000,55000,55000
055373,聯詠元大97購03  ,0,0,0,0,0,0,0,0,0,55000,0,0,0,113000,58000,55000,55000
055364,矽創凱基97購03  ,0,0,0,0,0,0,0,0,0,55000,0,0,0,153000,98000,55000,55000
05770P,聯發科凱基96售16,0,0,0,0,0,0,0,0,0,55000,0,0,0,55000,0,55000,55000
05850P,台積電兆豐96售06,0,0,0,0,0,0,0,0,0,55000,0,0,0,82000,27000,55000,55000
055877,奇鋐元富97購01  ,0,0,0,0,0,0,0,0,0,55000,0,0,0,55000,0,55000,55000
055962,晶豪科元大97購02,0,0,0,0,0,0,0,0,0,55000,0,0,0,55000,0,55000,55000
055787,聯茂凱基99購01  ,0,0,0,0,0,0,0,0,0,55000,0,0,0,95000,40000,55000,55000
03543P,台泥中信02售01  ,0,0,0,0,0,0,0,0,0,55000,0,0,0,55000,0,55000,55000
04638P,臺股指群益94售13,0,0,0,0,0,0,0,0,0,55000,0,0,0,65000,10000,55000,55000
046011,欣興元富95購01  ,0,0,0,0,0,0,0,0,0,55000,0,0,0,208000,153000,55000,55000
047391,潤泰全元大93購02,0,0,0,0,0,0,0,0,0,55000,0,0,0,55000,0,55000,55000
050411,聯發科永豐94購05,0,0,0,0,0,0,0,0,0,55000,0,0,0,385000,330000,55000,55000
050732,台虹國票94購01  ,0,0,0,0,0,0,0,0,0,55000,0,0,0,55000,0,55000,55000
049456,上海銀統一94購03,0,0,0,0,0,0,0,0,0,55000,0,0,0,95000,40000,55000,55000
049708,滬深2X凱基94購02,0,0,0,0,0,0,0,0,0,55000,0,0,0,55000,0,55000,55000
049967,華新科國票94購07,0,0,0,0,0,0,0,0,0,55000,0,0,0,112000,57000,55000,55000
05023P,和碩凱基95售01  ,0,0,0,0,0,0,0,0,0,55000,0,0,0,55000,0,55000,55000
053292,美律中信98購01  ,0,0,0,0,0,0,0,0,0,55000,0,0,0,249000,194000,55000,55000
053429,彩晶永豐96購01  ,0,0,0,0,0,0,0,0,0,55000,0,0,0,55000,0,55000,55000
053702,智易兆豐97購02  ,0,0,0,0,0,0,0,0,0,55000,0,0,0,55000,0,55000,55000
053588,聯發科元大97購07,0,0,0,0,0,0,0,0,0,55000,0,0,0,150000,95000,55000,55000
054289,聯發科元大97購11,0,0,0,0,0,0,0,0,0,55000,0,0,0,85000,30000,55000,55000
054043,漢唐元大97購01  ,0,0,0,0,0,0,0,0,0,55000,0,0,0,65000,10000,55000,55000
053979,健策元大98購01  ,0,0,0,0,0,0,0,0,0,55000,0,0,0,513000,458000,55000,55000
052290,鴻海元富97購01  ,0,0,0,0,0,0,0,0,0,55000,0,0,0,75000,20000,55000,55000
051841,南茂國泰96購01  ,0,0,0,0,0,0,0,0,0,55000,0,0,0,55000,0,55000,55000
052980,上銀元大96購03  ,0,0,0,0,0,0,0,0,0,55000,0,0,0,72000,17000,55000,55000
05307P,光寶科中信95售01,0,0,0,0,0,0,0,0,0,55000,0,0,0,55000,0,55000,55000
052646,淘帝永豐96購01  ,0,0,0,0,0,0,0,0,0,55000,0,0,0,55000,0,55000,55000
052799,上銀元大96購01  ,0,0,0,0,0,0,0,0,0,55000,0,0,0,196000,141000,55000,55000
06014P,聯發科富邦97售02,0,0,0,0,0,0,0,0,0,55000,0,0,0,73000,18000,55000,55000
06219P,國巨元富97售05  ,0,0,0,0,0,0,0,0,0,55000,0,0,0,60000,5000,55000,55000
055908,GIS日盛97購01   ,0,0,0,0,0,0,0,0,0,54000,0,0,0,64000,10000,54000,54000
055918,和鑫凱基97購01  ,0,0,0,0,0,0,0,0,0,54000,0,0,0,122000,68000,54000,54000
056026,智易群益97購01  ,0,0,0,0,0,0,0,0,0,54000,0,0,0,54000,0,54000,54000
056339,聯發科凱基99購02,0,0,0,0,0,0,0,0,0,54000,0,0,0,55000,1000,54000,54000
05655P,南亞科統一96售01,0,0,0,0,0,0,0,0,0,54000,0,0,0,54000,0,54000,54000
056619,強茂永豐98購01  ,0,0,0,0,0,0,0,0,0,54000,0,0,0,54000,0,54000,54000
055199,國喬群益97購01  ,0,0,0,0,0,0,0,0,0,54000,0,0,0,54000,0,54000,54000
055687,瀚宇博凱基97購01,0,0,0,0,0,0,0,0,0,54000,0,0,0,58000,4000,54000,54000
054656,深中小元大97購01,0,0,0,0,0,0,0,0,0,54000,0,0,0,54000,0,54000,54000
046933,台泥元富93購01  ,0,0,0,0,0,0,0,0,0,54000,0,0,0,74000,20000,54000,54000
046794,智伸科元富93購01,0,0,0,0,0,0,0,0,0,54000,0,0,0,54000,0,54000,54000
044683,聯鈞凱基93購01  ,0,0,0,0,0,0,0,0,0,54000,0,0,0,54000,0,54000,54000
051671,和鑫元大96購02  ,0,0,0,0,0,0,0,0,0,54000,0,0,0,54000,0,54000,54000
051544,T50反1康和98購01,0,0,0,0,0,0,0,0,0,54000,0,0,0,54000,0,54000,54000
049557,南電元富94購02  ,0,0,0,0,0,0,0,0,0,54000,0,0,0,74000,20000,54000,54000
05085P,鴻海日盛95售01  ,0,0,0,0,0,0,0,0,0,54000,0,0,0,54000,0,54000,54000
051025,晶華統一95購01  ,0,0,0,0,0,0,0,0,0,54000,0,0,0,54000,0,54000,54000
05123P,鴻海永昌96售07  ,0,0,0,0,0,0,0,0,0,54000,0,0,0,334000,280000,54000,54000
051214,大立光統一95購02,0,0,0,0,0,0,0,0,0,54000,0,0,0,54000,0,54000,54000
053107,旺宏兆豐97購01  ,0,0,0,0,0,0,0,0,0,54000,0,0,0,54000,0,54000,54000
053062,緯穎富邦97購01  ,0,0,0,0,0,0,0,0,0,54000,0,0,0,84000,30000,54000,54000
053138,華邦電富邦96購01,0,0,0,0,0,0,0,0,0,54000,0,0,0,185000,131000,54000,54000
051856,亞德客凱基95購01,0,0,0,0,0,0,0,0,0,54000,0,0,0,76000,22000,54000,54000
052182,鴻海群益96購01  ,0,0,0,0,0,0,0,0,0,54000,0,0,0,58000,4000,54000,54000
054203,滬深2X國票96購03,0,0,0,0,0,0,0,0,0,54000,0,0,0,54000,0,54000,54000
053777,台積電元大96購20,0,0,0,0,0,0,0,0,0,54000,0,0,0,113000,59000,54000,54000
053814,美律群益97購02  ,0,0,0,0,0,0,0,0,0,54000,0,0,0,74000,20000,54000,54000
053366,樺漢國泰98購01  ,0,0,0,0,0,0,0,0,0,54000,0,0,0,334000,280000,54000,54000
06169P,華新科元富97售02,0,0,0,0,0,0,0,0,0,54000,0,0,0,113000,59000,54000,54000
2059,川湖            ,206000,162000,44000,0,0,0,0,0,0,10000,17000,0,17000,1000,8000,-7000,54000
055064,碩天永豐97購01  ,0,0,0,0,0,0,0,0,0,53000,0,0,0,68000,15000,53000,53000
055609,旺宏國票99購01  ,0,0,0,0,0,0,0,0,0,53000,0,0,0,53000,0,53000,53000
055217,緯創凱基97購02  ,0,0,0,0,0,0,0,0,0,53000,0,0,0,53000,0,53000,53000
055279,華邦電元大97購02,0,0,0,0,0,0,0,0,0,53000,0,0,0,68000,15000,53000,53000
055842,建準元大98購01  ,0,0,0,0,0,0,0,0,0,53000,0,0,0,110000,57000,53000,53000
046528,聯詠中信94購01  ,0,0,0,0,0,0,0,0,0,53000,0,0,0,64000,11000,53000,53000
046474,創意永豐92購03  ,0,0,0,0,0,0,0,0,0,53000,0,0,0,53000,0,53000,53000
04672P,台積電統一94售09,0,0,0,0,0,0,0,0,0,53000,0,0,0,343000,290000,53000,53000
047343,台達電中信95購01,0,0,0,0,0,0,0,0,0,53000,0,0,0,110000,57000,53000,53000
04979P,臺股指凱基96售07,0,0,0,0,0,0,0,0,0,53000,0,0,0,53000,0,53000,53000
050554,百和凱基95購01  ,0,0,0,0,0,0,0,0,0,53000,0,0,0,53000,0,53000,53000
053813,友達群益9A購03  ,0,0,0,0,0,0,0,0,0,53000,0,0,0,976000,923000,53000,53000
053974,大立光元大96購10,0,0,0,0,0,0,0,0,0,53000,0,0,0,68000,15000,53000,53000
053156,緯創元大96購02  ,0,0,0,0,0,0,0,0,0,53000,0,0,0,53000,0,53000,53000
052682,上銀元大97購01  ,0,0,0,0,0,0,0,0,0,53000,0,0,0,66000,13000,53000,53000
056315,同欣電元大97購05,0,0,0,0,0,0,0,0,0,52000,0,0,0,119000,67000,52000,52000
056437,台積電凱基98購11,0,0,0,0,0,0,0,0,0,52000,0,0,0,60000,8000,52000,52000
056143,訊芯元大97購04  ,0,0,0,0,0,0,0,0,0,52000,0,0,0,52000,0,52000,52000
056592,台積電元富98購01,0,0,0,0,0,0,0,0,0,52000,0,0,0,488000,436000,52000,52000
055287,日電貿元大97購01,0,0,0,0,0,0,0,0,0,52000,0,0,0,142000,90000,52000,52000
054748,正文凱基98購01  ,0,0,0,0,0,0,0,0,0,52000,0,0,0,52000,0,52000,52000
046938,致茂元大93購02  ,0,0,0,0,0,0,0,0,0,52000,0,0,0,52000,0,52000,52000
049498,茂林元大95購01  ,0,0,0,0,0,0,0,0,0,52000,0,0,0,68000,16000,52000,52000
050703,矽格凱基94購02  ,0,0,0,0,0,0,0,0,0,52000,0,0,0,120000,68000,52000,52000
045470,康控元大94購03  ,0,0,0,0,0,0,0,0,0,52000,0,0,0,120000,68000,52000,52000
045454,上銀元大93購01  ,0,0,0,0,0,0,0,0,0,52000,0,0,0,52000,0,52000,52000
00743,國泰中國A150    ,139000,0,139000,0,0,0,0,0,0,-87000,0,0,0,23000,110000,-87000,52000
050111,全新元大95購02  ,0,0,0,0,0,0,0,0,0,52000,0,0,0,52000,0,52000,52000
049775,旺宏統一95購02  ,0,0,0,0,0,0,0,0,0,52000,0,0,0,52000,0,52000,52000
050804,和大日盛95購01  ,0,0,0,0,0,0,0,0,0,52000,0,0,0,52000,0,52000,52000
051167,京鼎元大95購01  ,0,0,0,0,0,0,0,0,0,52000,0,0,0,128000,76000,52000,52000
052616,鴻海國泰98購02  ,0,0,0,0,0,0,0,0,0,52000,0,0,0,532000,480000,52000,52000
05174P,元金2X富邦9B售01,0,0,0,0,0,0,0,0,0,52000,0,0,0,52000,0,52000,52000
054019,燿華台新96購01  ,0,0,0,0,0,0,0,0,0,52000,0,0,0,90000,38000,52000,52000
054303,國巨凱基96購15  ,0,0,0,0,0,0,0,0,0,52000,0,0,0,60000,8000,52000,52000
054257,揚明光元大96購02,0,0,0,0,0,0,0,0,0,52000,0,0,0,62000,10000,52000,52000
054261,智伸科元大96購03,0,0,0,0,0,0,0,0,0,52000,0,0,0,235000,183000,52000,52000
053741,漢唐國票97購03  ,0,0,0,0,0,0,0,0,0,52000,0,0,0,52000,0,52000,52000
053628,微星兆豐96購01  ,0,0,0,0,0,0,0,0,0,52000,0,0,0,75000,23000,52000,52000
054792,揚明光群益97購01,0,0,0,0,0,0,0,0,0,51000,0,0,0,51000,0,51000,51000
054567,拓凱群益98購01  ,0,0,0,0,0,0,0,0,0,51000,0,0,0,54000,3000,51000,51000
055176,大毅統一98購02  ,0,0,0,0,0,0,0,0,0,51000,0,0,0,56000,5000,51000,51000
056318,鴻海群益98購02  ,0,0,0,0,0,0,0,0,0,51000,0,0,0,57000,6000,51000,51000
03956P,欣興統一93售02  ,0,0,0,0,0,0,0,0,0,51000,0,0,0,71000,20000,51000,51000
039900,上証2X國泰92購01,0,0,0,0,0,0,0,0,0,51000,0,0,0,51000,0,51000,51000
045575,智邦元大92購06  ,0,0,0,0,0,0,0,0,0,51000,0,0,0,51000,0,51000,51000
046107,勤誠永豐92購01  ,0,0,0,0,0,0,0,0,0,51000,0,0,0,61000,10000,51000,51000
046124,健策元大92購04  ,0,0,0,0,0,0,0,0,0,51000,0,0,0,84000,33000,51000,51000
04731P,臺股指中信96售03,0,0,0,0,0,0,0,0,0,51000,0,0,0,94000,43000,51000,51000
050753,百和統一94購01  ,0,0,0,0,0,0,0,0,0,51000,0,0,0,51000,0,51000,51000
049585,旺宏元大95購02  ,0,0,0,0,0,0,0,0,0,51000,0,0,0,177000,126000,51000,51000
04860P,鴻海群益94售07  ,0,0,0,0,0,0,0,0,0,51000,0,0,0,51000,0,51000,51000
048167,旺宏永豐93購04  ,0,0,0,0,0,0,0,0,0,51000,0,0,0,174000,123000,51000,51000
050091,喬山永豐94購02  ,0,0,0,0,0,0,0,0,0,51000,0,0,0,51000,0,51000,51000
049150,新光金元大96購01,0,0,0,0,0,0,0,0,0,51000,0,0,0,51000,0,51000,51000
049341,旺宏統一95購01  ,0,0,0,0,0,0,0,0,0,51000,0,0,0,99000,48000,51000,51000
048994,南電元大94購03  ,0,0,0,0,0,0,0,0,0,51000,0,0,0,51000,0,51000,51000
05133P,臺股指日盛95售01,0,0,0,0,0,0,0,0,0,51000,0,0,0,51000,0,51000,51000
053753,啟碁永豐96購01  ,0,0,0,0,0,0,0,0,0,51000,0,0,0,91000,40000,51000,51000
053412,台達電國票97購02,0,0,0,0,0,0,0,0,0,51000,0,0,0,75000,24000,51000,51000
051752,緯穎富邦96購01  ,0,0,0,0,0,0,0,0,0,51000,0,0,0,77000,26000,51000,51000
052732,新唐國泰97購01  ,0,0,0,0,0,0,0,0,0,51000,0,0,0,101000,50000,51000,51000
052984,漢唐元大96購01  ,0,0,0,0,0,0,0,0,0,51000,0,0,0,51000,0,51000,51000
052988,智易元大96購02  ,0,0,0,0,0,0,0,0,0,51000,0,0,0,51000,0,51000,51000
06036P,台表科凱基96售04,0,0,0,0,0,0,0,0,0,51000,0,0,0,66000,15000,51000,51000
056338,聯發科凱基99購01,0,0,0,0,0,0,0,0,0,50000,0,0,0,84000,34000,50000,50000
056438,旺宏凱基98購05  ,0,0,0,0,0,0,0,0,0,50000,0,0,0,55000,5000,50000,50000
056369,彩晶元大01購01  ,0,0,0,0,0,0,0,0,0,50000,0,0,0,50000,0,50000,50000
056224,聯發科凱基97購08,0,0,0,0,0,0,0,0,0,50000,0,0,0,70000,20000,50000,50000
056541,智原凱基98購03  ,0,0,0,0,0,0,0,0,0,50000,0,0,0,50000,0,50000,50000
056684,旺宏統一98購02  ,0,0,0,0,0,0,0,0,0,50000,0,0,0,50000,0,50000,50000
05948P,茂林元大96售03  ,0,0,0,0,0,0,0,0,0,50000,0,0,0,50000,0,50000,50000
055362,GIS凱基97購03   ,0,0,0,0,0,0,0,0,0,50000,0,0,0,50000,0,50000,50000
055355,大立光凱基97購05,0,0,0,0,0,0,0,0,0,50000,0,0,0,81000,31000,50000,50000
055443,台虹國票98購01  ,0,0,0,0,0,0,0,0,0,50000,0,0,0,50000,0,50000,50000
055484,華通元大97購04  ,0,0,0,0,0,0,0,0,0,50000,0,0,0,50000,0,50000,50000
05477P,華新科群益95售06,0,0,0,0,0,0,0,0,0,50000,0,0,0,50000,0,50000,50000
055111,宏盛凱基97購01  ,0,0,0,0,0,0,0,0,0,50000,0,0,0,50000,0,50000,50000
054858,台肥群益97購01  ,0,0,0,0,0,0,0,0,0,50000,0,0,0,61000,11000,50000,50000
047102,潤泰全富邦95購01,0,0,0,0,0,0,0,0,0,50000,0,0,0,50000,0,50000,50000
050405,新光金麥證94購01,0,0,0,50000,0,50000,0,0,0,50000,0,0,0,50000,0,50000,50000
050386,智伸科國票94購01,0,0,0,0,0,0,0,0,0,50000,0,0,0,86000,36000,50000,50000
046976,國巨永豐93購02  ,0,0,0,0,0,0,0,0,0,50000,0,0,0,50000,0,50000,50000
047030,日月光元大93購02,0,0,0,0,0,0,0,0,0,50000,0,0,0,50000,0,50000,50000
048558,漢唐元大93購06  ,0,0,0,0,0,0,0,0,0,50000,0,0,0,58000,8000,50000,50000
045866,南茂統一94購01  ,0,0,0,0,0,0,0,0,0,50000,0,0,0,60000,10000,50000,50000
045782,欣興元大93購04  ,0,0,0,0,0,0,0,0,0,50000,0,0,0,130000,80000,50000,50000
045760,鴻海統一93購02  ,0,0,0,0,0,0,0,0,0,50000,0,0,0,50000,0,50000,50000
045480,滬深2X中信94購01,0,0,0,0,0,0,0,0,0,50000,0,0,0,50000,0,50000,50000
04551P,台表科元大94售02,0,0,0,0,0,0,0,0,0,50000,0,0,0,50000,0,50000,50000
046756,廣達凱基93購01  ,0,0,0,0,0,0,0,0,0,50000,0,0,0,50000,0,50000,50000
046793,聯發科元富99購01,0,0,0,0,0,0,0,0,0,50000,0,0,0,70000,20000,50000,50000
047770,聯詠元大93購10  ,0,0,0,0,0,0,0,0,0,50000,0,0,0,50000,0,50000,50000
047771,緯創元大93購01  ,0,0,0,0,0,0,0,0,0,50000,0,0,0,50000,0,50000,50000
047640,聯發科元大93購17,0,0,0,0,0,0,0,0,0,50000,0,0,0,60000,10000,50000,50000
03942P,電子類元大93售02,0,0,0,0,0,0,0,0,0,50000,0,0,0,50000,0,50000,50000
03908P,致茂元大93售03  ,0,0,0,0,0,0,0,0,0,50000,0,0,0,150000,100000,50000,50000
044643,滬深2X群益96購01,0,0,0,0,0,0,0,0,0,50000,0,0,0,50000,0,50000,50000
044908,玉晶光凱基93購01,0,0,0,0,0,0,0,0,0,50000,0,0,0,50000,0,50000,50000
04174P,上銀群益93售06  ,0,0,0,0,0,0,0,0,0,50000,0,0,0,50000,0,50000,50000
03359P,金像電群益02售04,0,0,0,0,0,0,0,0,0,50000,0,0,0,50000,0,50000,50000
03826P,瀚宇博元大95售01,0,0,0,0,0,0,0,0,0,50000,0,0,0,50000,0,50000,50000
04758P,國巨凱基94售03  ,0,0,0,0,0,0,0,0,0,50000,0,0,0,50000,0,50000,50000
047525,漢唐元大93購04  ,0,0,0,0,0,0,0,0,0,50000,0,0,0,50000,0,50000,50000
04640P,上銀凱基94售05  ,0,0,0,0,0,0,0,0,0,50000,0,0,0,50000,0,50000,50000
051317,亞德客國票96購01,0,0,0,0,0,0,0,0,0,50000,0,0,0,195000,145000,50000,50000
051315,同欣電麥證95購01,0,0,0,94000,20000,74000,0,0,0,50000,0,0,0,94000,44000,50000,50000
051279,喬山兆豐96購01  ,0,0,0,0,0,0,0,0,0,50000,0,0,0,50000,0,50000,50000
049082,晶豪科凱基94購01,0,0,0,0,0,0,0,0,0,50000,0,0,0,50000,0,50000,50000
050580,強茂國票95購01  ,0,0,0,0,0,0,0,0,0,50000,0,0,0,50000,0,50000,50000
051437,百和元富95購02  ,0,0,0,0,0,0,0,0,0,50000,0,0,0,50000,0,50000,50000
051630,力山國票96購01  ,0,0,0,0,0,0,0,0,0,50000,0,0,0,50000,0,50000,50000
051047,深中小群益99購01,0,0,0,0,0,0,0,0,0,50000,0,0,0,61000,11000,50000,50000
049101,聯詠國泰95購01  ,0,0,0,0,0,0,0,0,0,50000,0,0,0,50000,0,50000,50000
05013P,台積電元大96售05,0,0,0,0,0,0,0,0,0,50000,0,0,0,50000,0,50000,50000
051253,緯創元大95購02  ,0,0,0,0,0,0,0,0,0,50000,0,0,0,77000,27000,50000,50000
049164,滬深2X日盛94購01,0,0,0,0,0,0,0,0,0,50000,0,0,0,50000,0,50000,50000
049213,滬深2X國票94購02,0,0,0,0,0,0,0,0,0,50000,0,0,0,50000,0,50000,50000
049269,超眾元大96購02  ,0,0,0,0,0,0,0,0,0,50000,0,0,0,80000,30000,50000,50000
050955,達方群益97購01  ,0,0,0,0,0,0,0,0,0,50000,0,0,0,50000,0,50000,50000
048639,漢唐元大93購07  ,0,0,0,0,0,0,0,0,0,50000,0,0,0,52000,2000,50000,50000
050927,聯詠凱基95購01  ,0,0,0,0,0,0,0,0,0,50000,0,0,0,80000,30000,50000,50000
050194,臻鼎元大94購03  ,0,0,0,0,0,0,0,0,0,50000,0,0,0,50000,0,50000,50000
05016P,臺股指元大95售07,0,0,0,0,0,0,0,0,0,50000,0,0,0,50000,0,50000,50000
05017P,臺股指元大95售08,0,0,0,0,0,0,0,0,0,50000,0,0,0,100000,50000,50000,50000
053048,同欣電麥證96購01,0,0,0,84000,10000,74000,0,0,0,50000,0,0,0,84000,34000,50000,50000
052748,群創元大9A購02  ,0,0,0,0,0,0,0,0,0,50000,0,0,0,50000,0,50000,50000
052870,玉晶光凱基96購03,0,0,0,0,0,0,0,0,0,50000,0,0,0,50000,0,50000,50000
052674,智邦國泰98購01  ,0,0,0,0,0,0,0,0,0,50000,0,0,0,90000,40000,50000,50000
052522,聯發科元大96購05,0,0,0,0,0,0,0,0,0,50000,0,0,0,50000,0,50000,50000
051955,寶成元富95購01  ,0,0,0,0,0,0,0,0,0,50000,0,0,0,50000,0,50000,50000
052283,TPK凱基97購01   ,0,0,0,0,0,0,0,0,0,50000,0,0,0,50000,0,50000,50000
052229,奇力新凱基96購01,0,0,0,0,0,0,0,0,0,50000,0,0,0,56000,6000,50000,50000
052363,廣達國票96購01  ,0,0,0,0,0,0,0,0,0,50000,0,0,0,50000,0,50000,50000
052402,健策凱基97購01  ,0,0,0,0,0,0,0,0,0,50000,0,0,0,158000,108000,50000,50000
053406,國巨兆豐96購02  ,0,0,0,0,0,0,0,0,0,50000,0,0,0,50000,0,50000,50000
053337,聯電國票97購01  ,0,0,0,0,0,0,0,0,0,50000,0,0,0,50000,0,50000,50000
053204,旺宏麥證96購01  ,0,0,0,55000,0,55000,0,0,0,50000,0,0,0,55000,5000,50000,50000
053807,T50反1群益96購02,0,0,0,0,0,0,0,0,0,50000,0,0,0,50000,0,50000,50000
053794,燿華亞東96購01  ,0,0,0,0,0,0,0,0,0,50000,0,0,0,50000,0,50000,50000
053694,創意元大96購03  ,0,0,0,0,0,0,0,0,0,50000,0,0,0,50000,0,50000,50000
053700,臺股指元大96購23,0,0,0,0,0,0,0,0,0,50000,0,0,0,50000,0,50000,50000
054296,世芯元大97購01  ,0,0,0,0,0,0,0,0,0,50000,0,0,0,60000,10000,50000,50000
054322,國巨台新96購02  ,0,0,0,0,0,0,0,0,0,50000,0,0,0,50000,0,50000,50000
054447,國泰金兆豐96購01,0,0,0,0,0,0,0,0,0,50000,0,0,0,50000,0,50000,50000
054185,喬山永豐96購02  ,0,0,0,0,0,0,0,0,0,50000,0,0,0,50000,0,50000,50000
06294P,臺股指國票97售08,0,0,0,0,0,0,0,0,0,50000,0,0,0,56000,6000,50000,50000
06361P,聯發科群益97售06,0,0,0,0,0,0,0,0,0,50000,0,0,0,80000,30000,50000,50000
8341,日友            ,92000,41000,51000,0,0,0,0,0,0,-1000,0,1000,-1000,0,0,0,50000
054862,群光群益97購01  ,0,0,0,0,0,0,0,0,0,49000,0,0,0,49000,0,49000,49000
054898,台肥康和97購01  ,0,0,0,0,0,0,0,0,0,49000,0,0,0,59000,10000,49000,49000
056470,旺宏元大99購01  ,0,0,0,0,0,0,0,0,0,49000,0,0,0,78000,29000,49000,49000
041210,群創元富93購01  ,0,0,0,0,0,0,0,0,0,49000,0,0,0,74000,25000,49000,49000
03026X,元展23          ,0,0,0,0,0,0,0,0,0,49000,0,0,0,49000,0,49000,49000
047749,富邦金元富93購01,0,0,0,0,0,0,0,0,0,49000,0,0,0,49000,0,49000,49000
047848,可成統一93購01  ,0,0,0,0,0,0,0,0,0,49000,0,0,0,59000,10000,49000,49000
049703,訊芯元大95購01  ,0,0,0,0,0,0,0,0,0,49000,0,0,0,49000,0,49000,49000
04938P,亞德客國票95售01,0,0,0,0,0,0,0,0,0,49000,0,0,0,73000,24000,49000,49000
054270,寶滬深中信98購01,0,0,0,0,0,0,0,0,0,49000,0,0,0,49000,0,49000,49000
053772,大成鋼元大96購02,0,0,0,0,0,0,0,0,0,49000,0,0,0,50000,1000,49000,49000
053246,聯詠國票97購02  ,0,0,0,0,0,0,0,0,0,49000,0,0,0,141000,92000,49000,49000
053489,上銀兆豐97購01  ,0,0,0,0,0,0,0,0,0,49000,0,0,0,59000,10000,49000,49000
052322,力成元大96購01  ,0,0,0,0,0,0,0,0,0,49000,0,0,0,87000,38000,49000,49000
052552,智邦國票97購01  ,0,0,0,0,0,0,0,0,0,49000,0,0,0,49000,0,49000,49000
052660,京元電國票97購01,0,0,0,0,0,0,0,0,0,49000,0,0,0,62000,13000,49000,49000
053168,晶技群益98購01  ,0,0,0,0,0,0,0,0,0,49000,0,0,0,55000,6000,49000,49000
052907,嘉澤國票97購01  ,0,0,0,0,0,0,0,0,0,49000,0,0,0,109000,60000,49000,49000
2501,國建            ,205000,156000,49000,0,0,0,0,0,0,0,0,0,0,0,0,0,49000
05742P,可成元大96售04  ,0,0,0,0,0,0,0,0,0,48000,0,0,0,166000,118000,48000,48000
056030,華通日盛97購01  ,0,0,0,0,0,0,0,0,0,48000,0,0,0,48000,0,48000,48000
054750,聯茂凱基98購02  ,0,0,0,0,0,0,0,0,0,48000,0,0,0,73000,25000,48000,48000
055246,美律統一98購01  ,0,0,0,0,0,0,0,0,0,48000,0,0,0,48000,0,48000,48000
050407,聯詠台新94購02  ,0,0,0,0,0,0,0,0,0,48000,0,0,0,133000,85000,48000,48000
045895,智伸科元大92購02,0,0,0,0,0,0,0,0,0,48000,0,0,0,50000,2000,48000,48000
046427,樺漢元大92購02  ,0,0,0,0,0,0,0,0,0,48000,0,0,0,48000,0,48000,48000
049366,聯發科元大94購05,0,0,0,0,0,0,0,0,0,48000,0,0,0,68000,20000,48000,48000
050253,百和國泰96購01  ,0,0,0,0,0,0,0,0,0,48000,0,0,0,166000,118000,48000,48000
050557,台積電統一94購13,0,0,0,0,0,0,0,0,0,48000,0,0,0,48000,0,48000,48000
049997,聯發科永豐94購04,0,0,0,0,0,0,0,0,0,48000,0,0,0,78000,30000,48000,48000
050034,智伸科元大94購01,0,0,0,0,0,0,0,0,0,48000,0,0,0,48000,0,48000,48000
048874,玉晶光國票96購01,0,0,0,0,0,0,0,0,0,48000,0,0,0,80000,32000,48000,48000
048905,旺宏富邦96購01  ,0,0,0,0,0,0,0,0,0,48000,0,0,0,79000,31000,48000,48000
051581,聯發科元大95購12,0,0,0,0,0,0,0,0,0,48000,0,0,0,68000,20000,48000,48000
049042,玉晶光兆豐95購01,0,0,0,0,0,0,0,0,0,48000,0,0,0,48000,0,48000,48000
051373,華新亞東95購01  ,0,0,0,0,0,0,0,0,0,48000,0,0,0,48000,0,48000,48000
050502,聯發科凱基94購21,0,0,0,0,0,0,0,0,0,48000,0,0,0,68000,20000,48000,48000
051225,台積電群益95購02,0,0,0,0,0,0,0,0,0,48000,0,0,0,288000,240000,48000,48000
050901,樺漢元大95購02  ,0,0,0,0,0,0,0,0,0,48000,0,0,0,239000,191000,48000,48000
04954P,健策國票96售01  ,0,0,0,0,0,0,0,0,0,48000,0,0,0,48000,0,48000,48000
049266,和碩元大94購01  ,0,0,0,0,0,0,0,0,0,48000,0,0,0,48000,0,48000,48000
048066,樺漢統一93購01  ,0,0,0,0,0,0,0,0,0,48000,0,0,0,48000,0,48000,48000
048053,美利達中信93購01,0,0,0,0,0,0,0,0,0,48000,0,0,0,48000,0,48000,48000
053275,燿華元大97購01  ,0,0,0,0,0,0,0,0,0,48000,0,0,0,53000,5000,48000,48000
053200,華邦電日盛96購01,0,0,0,0,0,0,0,0,0,48000,0,0,0,48000,0,48000,48000
053836,亞光永豐96購02  ,0,0,0,0,0,0,0,0,0,48000,0,0,0,68000,20000,48000,48000
053842,聯發科統一96購08,0,0,0,0,0,0,0,0,0,48000,0,0,0,48000,0,48000,48000
054073,群創富邦96購03  ,0,0,0,0,0,0,0,0,0,48000,0,0,0,73000,25000,48000,48000
053933,大立光統一96購06,0,0,0,0,0,0,0,0,0,48000,0,0,0,48000,0,48000,48000
053957,瑞昱永豐96購01  ,0,0,0,0,0,0,0,0,0,48000,0,0,0,88000,40000,48000,48000
06137P,玉晶光永豐97售04,0,0,0,0,0,0,0,0,0,48000,0,0,0,62000,14000,48000,48000
05516P,台積電元大96售12,0,0,0,0,0,0,0,0,0,47000,0,0,0,86000,39000,47000,47000
055746,同欣電元富97購01,0,0,0,0,0,0,0,0,0,47000,0,0,0,47000,0,47000,47000
054630,聯鈞凱基98購01  ,0,0,0,0,0,0,0,0,0,47000,0,0,0,60000,13000,47000,47000
055112,晶豪科凱基98購01,0,0,0,0,0,0,0,0,0,47000,0,0,0,50000,3000,47000,47000
056105,智原永豐97購01  ,0,0,0,0,0,0,0,0,0,47000,0,0,0,54000,7000,47000,47000
055836,華邦電元大97購04,0,0,0,0,0,0,0,0,0,47000,0,0,0,57000,10000,47000,47000
05853P,欣興群益96售05  ,0,0,0,0,0,0,0,0,0,47000,0,0,0,50000,3000,47000,47000
05784P,臺股指元大96售18,0,0,0,0,0,0,0,0,0,47000,0,0,0,53000,6000,47000,47000
047469,華通中信93購01  ,0,0,0,0,0,0,0,0,0,47000,0,0,0,47000,0,47000,47000
043611,台積電群益92購03,0,0,0,0,0,0,0,0,0,47000,0,0,0,47000,0,47000,47000
044875,玉晶光統一93購01,0,0,0,0,0,0,0,0,0,47000,0,0,0,68000,21000,47000,47000
050402,緯穎中信96購01  ,0,0,0,0,0,0,0,0,0,47000,0,0,0,64000,17000,47000,47000
049222,和碩國票94購01  ,0,0,0,0,0,0,0,0,0,47000,0,0,0,47000,0,47000,47000
048793,超眾元大95購02  ,0,0,0,0,0,0,0,0,0,47000,0,0,0,87000,40000,47000,47000
050616,潤泰全元大94購01,0,0,0,0,0,0,0,0,0,47000,0,0,0,47000,0,47000,47000
050277,上銀亞東94購01  ,0,0,0,0,0,0,0,0,0,47000,0,0,0,47000,0,47000,47000
049102,智伸科國泰96購01,0,0,0,0,0,0,0,0,0,47000,0,0,0,47000,0,47000,47000
054099,TPK國票98購01   ,0,0,0,0,0,0,0,0,0,47000,0,0,0,85000,38000,47000,47000
052170,台積電元大95購20,0,0,0,0,0,0,0,0,0,47000,0,0,0,149000,102000,47000,47000
05172P,臺股指元大95售16,0,0,0,0,0,0,0,0,0,47000,0,0,0,61000,14000,47000,47000
05778P,台積電統一96售05,0,0,0,0,0,0,0,0,0,46000,0,0,0,48000,2000,46000,46000
05664P,國巨凱基96售09  ,0,0,0,0,0,0,0,0,0,46000,0,0,0,60000,14000,46000,46000
056150,台光電凱基98購02,0,0,0,0,0,0,0,0,0,46000,0,0,0,50000,4000,46000,46000
054872,瀚宇博群益98購01,0,0,0,0,0,0,0,0,0,46000,0,0,0,46000,0,46000,46000
054962,玉晶光元大99購02,0,0,0,0,0,0,0,0,0,46000,0,0,0,206000,160000,46000,46000
05452P,亞德客群益95售02,0,0,0,0,0,0,0,0,0,46000,0,0,0,73000,27000,46000,46000
054666,強茂元富97購01  ,0,0,0,0,0,0,0,0,0,46000,0,0,0,46000,0,46000,46000
055543,為升凱基97購01  ,0,0,0,0,0,0,0,0,0,46000,0,0,0,116000,70000,46000,46000
055289,泰碩元大98購01  ,0,0,0,0,0,0,0,0,0,46000,0,0,0,46000,0,46000,46000
047141,宏達電兆豐94購01,0,0,0,0,0,0,0,0,0,46000,0,0,0,236000,190000,46000,46000
046072,台勝科凱基92購03,0,0,0,0,0,0,0,0,0,46000,0,0,0,46000,0,46000,46000
047688,亞德客富邦95購01,0,0,0,0,0,0,0,0,0,46000,0,0,0,72000,26000,46000,46000
046557,亞泥凱基93購02  ,0,0,0,0,0,0,0,0,0,46000,0,0,0,167000,121000,46000,46000
050602,訊芯國泰96購01  ,0,0,0,0,0,0,0,0,0,46000,0,0,0,51000,5000,46000,46000
047946,南亞科統一93購04,0,0,0,0,0,0,0,0,0,46000,0,0,0,46000,0,46000,46000
052441,亞泥元大95購01  ,0,0,0,0,0,0,0,0,0,46000,0,0,0,111000,65000,46000,46000
053142,緯穎永豐96購01  ,0,0,0,0,0,0,0,0,0,46000,0,0,0,63000,17000,46000,46000
053611,聯茂麥證96購01  ,0,0,0,100000,0,100000,0,0,0,46000,0,0,0,100000,54000,46000,46000
053354,康控兆豐97購02  ,0,0,0,0,0,0,0,0,0,46000,0,0,0,46000,0,46000,46000
053415,聯茂國票97購01  ,0,0,0,0,0,0,0,0,0,46000,0,0,0,188000,142000,46000,46000
1312,國喬            ,613000,559000,54000,0,0,0,0,0,0,-8000,0,1000,-1000,16000,23000,-7000,46000
055250,華新科統一97購02,0,0,0,0,0,0,0,0,0,45000,0,0,0,45000,0,45000,45000
055548,旺宏凱基97購02  ,0,0,0,0,0,0,0,0,0,45000,0,0,0,85000,40000,45000,45000
054925,神達凱基97購01  ,0,0,0,0,0,0,0,0,0,45000,0,0,0,100000,55000,45000,45000
056616,台光電永豐98購01,0,0,0,0,0,0,0,0,0,45000,0,0,0,108000,63000,45000,45000
056463,台虹凱基98購02  ,0,0,0,0,0,0,0,0,0,45000,0,0,0,95000,50000,45000,45000
05717P,鴻海元大97售07  ,0,0,0,0,0,0,0,0,0,45000,0,0,0,50000,5000,45000,45000
05966P,矽力凱基96售03  ,0,0,0,0,0,0,0,0,0,45000,0,0,0,86000,41000,45000,45000
04032P,聯茂凱基94售02  ,0,0,0,0,0,0,0,0,0,45000,0,0,0,45000,0,45000,45000
049445,遠東新統一94購01,0,0,0,0,0,0,0,0,0,45000,0,0,0,45000,0,45000,45000
049878,宏達電永豐94購01,0,0,0,0,0,0,0,0,0,45000,0,0,0,101000,56000,45000,45000
048797,美律國泰95購02  ,0,0,0,0,0,0,0,0,0,45000,0,0,0,152000,107000,45000,45000
049769,和鑫元富96購01  ,0,0,0,0,0,0,0,0,0,45000,0,0,0,55000,10000,45000,45000
049255,旺宏元大97購02  ,0,0,0,0,0,0,0,0,0,45000,0,0,0,86000,41000,45000,45000
049562,和大統一94購01  ,0,0,0,0,0,0,0,0,0,45000,0,0,0,45000,0,45000,45000
053487,台泥兆豐97購01  ,0,0,0,0,0,0,0,0,0,45000,0,0,0,109000,64000,45000,45000
053473,聯發科元大96購15,0,0,0,0,0,0,0,0,0,45000,0,0,0,96000,51000,45000,45000
053657,元大金凱基96購01,0,0,0,0,0,0,0,0,0,45000,0,0,0,53000,8000,45000,45000
054193,鴻海麥證96購02  ,0,0,0,45000,0,45000,0,0,0,45000,0,0,0,45000,0,45000,45000
053922,亞光國票96購01  ,0,0,0,0,0,0,0,0,0,45000,0,0,0,46000,1000,45000,45000
054209,台積電國票97購08,0,0,0,0,0,0,0,0,0,45000,0,0,0,91000,46000,45000,45000
054397,創意永豐96購05  ,0,0,0,0,0,0,0,0,0,45000,0,0,0,113000,68000,45000,45000
054367,鴻海中信98購03  ,0,0,0,0,0,0,0,0,0,45000,0,0,0,48000,3000,45000,45000
052628,樺漢中信96購01  ,0,0,0,0,0,0,0,0,0,45000,0,0,0,45000,0,45000,45000
052859,國巨凱基96購07  ,0,0,0,0,0,0,0,0,0,45000,0,0,0,63000,18000,45000,45000
05227P,大立光統一95售04,0,0,0,0,0,0,0,0,0,45000,0,0,0,45000,0,45000,45000
05184P,緯穎元富95售01  ,0,0,0,0,0,0,0,0,0,45000,0,0,0,45000,0,45000,45000
051937,廣達群益95購01  ,0,0,0,0,0,0,0,0,0,45000,0,0,0,56000,11000,45000,45000
06306P,臺股指元大97售12,0,0,0,0,0,0,0,0,0,45000,0,0,0,45000,0,45000,45000
054796,康普群益98購01  ,0,0,0,0,0,0,0,0,0,44000,0,0,0,64000,20000,44000,44000
055302,達方元大97購01  ,0,0,0,0,0,0,0,0,0,44000,0,0,0,44000,0,44000,44000
04137P,元油反國票97售01,0,0,0,0,0,0,0,0,0,44000,0,0,0,50000,6000,44000,44000
045645,祥碩凱基93購03  ,0,0,0,0,0,0,0,0,0,44000,0,0,0,44000,0,44000,44000
04618P,電子類群益94售02,0,0,0,0,0,0,0,0,0,44000,0,0,0,84000,40000,44000,44000
047157,智伸科國票93購01,0,0,0,0,0,0,0,0,0,44000,0,0,0,44000,0,44000,44000
047296,日月光元富96購01,0,0,0,0,0,0,0,0,0,44000,0,0,0,279000,235000,44000,44000
050897,嘉晶元大95購03  ,0,0,0,0,0,0,0,0,0,44000,0,0,0,44000,0,44000,44000
049139,台積電元大94購06,0,0,0,0,0,0,0,0,0,44000,0,0,0,334000,290000,44000,44000
050661,景碩元大94購02  ,0,0,0,0,0,0,0,0,0,44000,0,0,0,187000,143000,44000,44000
048989,矽格元大94購02  ,0,0,0,0,0,0,0,0,0,44000,0,0,0,44000,0,44000,44000
052026,漢唐群益95購01  ,0,0,0,0,0,0,0,0,0,44000,0,0,0,50000,6000,44000,44000
05213P,台積電國票96售05,0,0,0,0,0,0,0,0,0,44000,0,0,0,44000,0,44000,44000
052558,新唐國票97購01  ,0,0,0,0,0,0,0,0,0,44000,0,0,0,44000,0,44000,44000
053103,瀚宇博元富96購01,0,0,0,0,0,0,0,0,0,44000,0,0,0,44000,0,44000,44000
053511,鴻海群益96購04  ,0,0,0,0,0,0,0,0,0,44000,0,0,0,44000,0,44000,44000
055179,大立光統一97購04,0,0,0,0,0,0,0,0,0,43000,0,0,0,125000,82000,43000,43000
05767P,國巨凱基96售11  ,0,0,0,0,0,0,0,0,0,43000,0,0,0,83000,40000,43000,43000
056459,茂林凱基99購01  ,0,0,0,0,0,0,0,0,0,43000,0,0,0,81000,38000,43000,43000
055870,智原台新97購01  ,0,0,0,0,0,0,0,0,0,43000,0,0,0,43000,0,43000,43000
056126,台郡國票98購02  ,0,0,0,0,0,0,0,0,0,43000,0,0,0,48000,5000,43000,43000
050730,復盛國票94購01  ,0,0,0,0,0,0,0,0,0,43000,0,0,0,68000,25000,43000,43000
045871,元油2X元富96購03,0,0,0,0,0,0,0,0,0,43000,0,0,0,131000,88000,43000,43000
049048,玉晶光台新94購01,0,0,0,0,0,0,0,0,0,43000,0,0,0,43000,0,43000,43000
049145,南亞科元大94購01,0,0,0,0,0,0,0,0,0,43000,0,0,0,47000,4000,43000,43000
049451,富邦金統一94購03,0,0,0,0,0,0,0,0,0,43000,0,0,0,43000,0,43000,43000
050233,香港2X凱基96購01,0,0,0,0,0,0,0,0,0,43000,0,0,0,45000,2000,43000,43000
049214,台達電國票95購01,0,0,0,0,0,0,0,0,0,43000,0,0,0,66000,23000,43000,43000
053729,聯茂凱基96購05  ,0,0,0,0,0,0,0,0,0,43000,0,0,0,43000,0,43000,43000
052769,達興群益96購01  ,0,0,0,0,0,0,0,0,0,43000,0,0,0,43000,0,43000,43000
052765,新日興群益97購01,0,0,0,0,0,0,0,0,0,43000,0,0,0,145000,102000,43000,43000
06141P,大立光日盛97售01,0,0,0,0,0,0,0,0,0,43000,0,0,0,43000,0,43000,43000
06065P,大立光台新97售01,0,0,0,0,0,0,0,0,0,43000,0,0,0,53000,10000,43000,43000
06371P,茂林國票98售04  ,0,0,0,0,0,0,0,0,0,43000,0,0,0,195000,152000,43000,43000
055850,聯詠元大97購06  ,0,0,0,0,0,0,0,0,0,42000,0,0,0,148000,106000,42000,42000
055817,京鼎國票99購01  ,0,0,0,0,0,0,0,0,0,42000,0,0,0,177000,135000,42000,42000
056374,聯發科統一9B購01,0,0,0,0,0,0,0,0,0,42000,0,0,0,70000,28000,42000,42000
056496,康控國泰99購01  ,0,0,0,0,0,0,0,0,0,42000,0,0,0,78000,36000,42000,42000
056542,緯創凱基98購01  ,0,0,0,0,0,0,0,0,0,42000,0,0,0,42000,0,42000,42000
056609,楠梓電永豐98購02,0,0,0,0,0,0,0,0,0,42000,0,0,0,72000,30000,42000,42000
056699,光罩國泰99購01  ,0,0,0,0,0,0,0,0,0,42000,0,0,0,122000,80000,42000,42000
055747,康舒元富97購01  ,0,0,0,0,0,0,0,0,0,42000,0,0,0,72000,30000,42000,42000
055724,祥碩元大97購03  ,0,0,0,0,0,0,0,0,0,42000,0,0,0,70000,28000,42000,42000
054675,美律台新98購01  ,0,0,0,0,0,0,0,0,0,42000,0,0,0,260000,218000,42000,42000
054707,聯茂亞東97購01  ,0,0,0,0,0,0,0,0,0,42000,0,0,0,52000,10000,42000,42000
054665,華通元富97購02  ,0,0,0,0,0,0,0,0,0,42000,0,0,0,42000,0,42000,42000
055071,群電永豐97購01  ,0,0,0,0,0,0,0,0,0,42000,0,0,0,42000,0,42000,42000
05068P,鴻海統一95售06  ,0,0,0,0,0,0,0,0,0,42000,0,0,0,112000,70000,42000,42000
049502,訊芯元大94購01  ,0,0,0,0,0,0,0,0,0,42000,0,0,0,42000,0,42000,42000
049491,聯發科元大95購01,0,0,0,0,0,0,0,0,0,42000,0,0,0,314000,272000,42000,42000
046950,隆達元大93購01  ,0,0,0,0,0,0,0,0,0,42000,0,0,0,42000,0,42000,42000
044759,新日興凱基93購01,0,0,0,0,0,0,0,0,0,42000,0,0,0,52000,10000,42000,42000
044403,新日興凱基92購01,0,0,0,0,0,0,0,0,0,42000,0,0,0,62000,20000,42000,42000
049436,義隆國泰96購02  ,0,0,0,0,0,0,0,0,0,42000,0,0,0,446000,404000,42000,42000
050200,致新元大94購01  ,0,0,0,0,0,0,0,0,0,42000,0,0,0,134000,92000,42000,42000
05061P,鴻海富邦96售03  ,0,0,0,0,0,0,0,0,0,42000,0,0,0,52000,10000,42000,42000
047994,亞德客元大93購03,0,0,0,0,0,0,0,0,0,42000,0,0,0,76000,34000,42000,42000
051608,新日興群益96購01,0,0,0,0,0,0,0,0,0,42000,0,0,0,42000,0,42000,42000
052491,泰碩國票99購01  ,0,0,0,0,0,0,0,0,0,42000,0,0,0,42000,0,42000,42000
052321,華擎元大95購01  ,0,0,0,0,0,0,0,0,0,42000,0,0,0,53000,11000,42000,42000
052070,GIS兆豐95購03   ,0,0,0,0,0,0,0,0,0,42000,0,0,0,42000,0,42000,42000
051895,聯茂元富95購02  ,0,0,0,0,0,0,0,0,0,42000,0,0,0,92000,50000,42000,42000
054386,鴻海統一98購03  ,0,0,0,0,0,0,0,0,0,42000,0,0,0,64000,22000,42000,42000
053944,亞泥富邦97購01  ,0,0,0,0,0,0,0,0,0,42000,0,0,0,142000,100000,42000,42000
053886,亞光兆豐96購01  ,0,0,0,0,0,0,0,0,0,42000,0,0,0,42000,0,42000,42000
4927,泰鼎-KY         ,611000,613000,-2000,0,0,0,200000,0,200000,-156000,35000,1000,34000,109000,299000,-190000,42000
055089,金寶群益98購01  ,0,0,0,0,0,0,0,0,0,41000,0,0,0,65000,24000,41000,41000
054705,欣興亞東97購01  ,0,0,0,0,0,0,0,0,0,41000,0,0,0,41000,0,41000,41000
055527,旺宏群益99購03  ,0,0,0,0,0,0,0,0,0,41000,0,0,0,41000,0,41000,41000
056584,鴻海統一9B購01  ,0,0,0,0,0,0,0,0,0,41000,0,0,0,45000,4000,41000,41000
05963P,貿聯國票97售02  ,0,0,0,0,0,0,0,0,0,41000,0,0,0,62000,21000,41000,41000
04450P,京元電凱基94售01,0,0,0,0,0,0,0,0,0,41000,0,0,0,42000,1000,41000,41000
046422,健策元大92購06  ,0,0,0,0,0,0,0,0,0,41000,0,0,0,41000,0,41000,41000
047450,南茂元大93購05  ,0,0,0,0,0,0,0,0,0,41000,0,0,0,215000,174000,41000,41000
047459,全新群益93購02  ,0,0,0,0,0,0,0,0,0,41000,0,0,0,41000,0,41000,41000
047612,瑞昱群益93購03  ,0,0,0,0,0,0,0,0,0,41000,0,0,0,41000,0,41000,41000
043601,亞光元大93購01  ,0,0,0,0,0,0,0,0,0,41000,0,0,0,41000,0,41000,41000
044735,光磊國泰93購01  ,0,0,0,0,0,0,0,0,0,41000,0,0,0,41000,0,41000,41000
047186,大立光元大93購20,0,0,0,0,0,0,0,0,0,41000,0,0,0,41000,0,41000,41000
047027,新光金元大95購01,0,0,0,0,0,0,0,0,0,41000,0,0,0,51000,10000,41000,41000
04703P,樺漢統一95售01  ,0,0,0,0,0,0,0,0,0,41000,0,0,0,50000,9000,41000,41000
046326,智伸科元大92購03,0,0,0,0,0,0,0,0,0,41000,0,0,0,50000,9000,41000,41000
047755,麗豐元富93購01  ,0,0,0,0,0,0,0,0,0,41000,0,0,0,51000,10000,41000,41000
047689,瑞昱富邦97購01  ,0,0,0,0,0,0,0,0,0,41000,0,0,0,125000,84000,41000,41000
051458,臺股指元大95購18,0,0,0,0,0,0,0,0,0,41000,0,0,0,45000,4000,41000,41000
051291,聯詠統一95購01  ,0,0,0,0,0,0,0,0,0,41000,0,0,0,111000,70000,41000,41000
049950,南亞科群益94購02,0,0,0,0,0,0,0,0,0,41000,0,0,0,72000,31000,41000,41000
047939,亞德客國票93購02,0,0,0,0,0,0,0,0,0,41000,0,0,0,79000,38000,41000,41000
051057,信邦群益95購01  ,0,0,0,0,0,0,0,0,0,41000,0,0,0,51000,10000,41000,41000
048731,創意麥證94購01  ,0,0,0,41000,0,41000,0,0,0,41000,0,0,0,41000,0,41000,41000
052961,國巨凱基97購02  ,0,0,0,0,0,0,0,0,0,41000,0,0,0,41000,0,41000,41000
06383P,聯茂元富97售01  ,0,0,0,0,0,0,0,0,0,41000,0,0,0,60000,19000,41000,41000
06265P,美律凱基97售01  ,0,0,0,0,0,0,0,0,0,41000,0,0,0,44000,3000,41000,41000
05879P,台積電台新96售03,0,0,0,0,0,0,0,0,0,40000,0,0,0,40000,0,40000,40000
05791P,臺股指中信99售06,0,0,0,0,0,0,0,0,0,40000,0,0,0,40000,0,40000,40000
056446,聯發科凱基98購08,0,0,0,0,0,0,0,0,0,40000,0,0,0,85000,45000,40000,40000
056379,玉晶光元富98購01,0,0,0,0,0,0,0,0,0,40000,0,0,0,43000,3000,40000,40000
056228,可成凱基97購03  ,0,0,0,0,0,0,0,0,0,40000,0,0,0,54000,14000,40000,40000
056001,美食永豐97購01  ,0,0,0,0,0,0,0,0,0,40000,0,0,0,40000,0,40000,40000
05550P,臺股指元大96售07,0,0,0,0,0,0,0,0,0,40000,0,0,0,40000,0,40000,40000
055254,聯詠統一97購03  ,0,0,0,0,0,0,0,0,0,40000,0,0,0,40000,0,40000,40000
055408,力成國泰98購01  ,0,0,0,0,0,0,0,0,0,40000,0,0,0,40000,0,40000,40000
055350,聯發科凱基97購02,0,0,0,0,0,0,0,0,0,40000,0,0,0,70000,30000,40000,40000
054736,南亞科凱基98購01,0,0,0,0,0,0,0,0,0,40000,0,0,0,40000,0,40000,40000
055022,精元國泰99購01  ,0,0,0,0,0,0,0,0,0,40000,0,0,0,40000,0,40000,40000
046597,可成亞東93購01  ,0,0,0,0,0,0,0,0,0,40000,0,0,0,40000,0,40000,40000
046319,新日興元大92購03,0,0,0,0,0,0,0,0,0,40000,0,0,0,60000,20000,40000,40000
045814,可成麥證93購01  ,0,0,0,40000,0,40000,0,0,0,40000,0,0,0,40000,0,40000,40000
047804,鴻海凱基93購26  ,0,0,0,0,0,0,0,0,0,40000,0,0,0,70000,30000,40000,40000
046185,正崴凱基93購02  ,0,0,0,0,0,0,0,0,0,40000,0,0,0,40000,0,40000,40000
046109,遠東新元大92購01,0,0,0,0,0,0,0,0,0,40000,0,0,0,140000,100000,40000,40000
047005,南亞科統一93購03,0,0,0,0,0,0,0,0,0,40000,0,0,0,40000,0,40000,40000
050377,華通第一94購01  ,0,0,0,0,0,0,0,0,0,40000,0,0,0,40000,0,40000,40000
04718P,亞德客凱基94售03,0,0,0,0,0,0,0,0,0,40000,0,0,0,40000,0,40000,40000
047272,技嘉永豐93購01  ,0,0,0,0,0,0,0,0,0,40000,0,0,0,40000,0,40000,40000
046881,智原富邦99購01  ,0,0,0,0,0,0,0,0,0,40000,0,0,0,40000,0,40000,40000
03564P,為升群益02售02  ,0,0,0,0,0,0,0,0,0,40000,0,0,0,250000,210000,40000,40000
03118P,台積電國票01售07,0,0,0,0,0,0,0,0,0,40000,0,0,0,40000,0,40000,40000
00686R,群益臺灣加權反1 ,0,0,0,0,0,0,0,0,0,40000,0,0,0,42000,2000,40000,40000
043936,和大兆豐92購01  ,0,0,0,0,0,0,0,0,0,40000,0,0,0,40000,0,40000,40000
043907,鴻海凱基93購01  ,0,10000,-10000,0,0,0,0,0,0,50000,0,0,0,50000,0,50000,40000
047620,貿聯凱基93購01  ,0,0,0,0,0,0,0,0,0,40000,0,0,0,150000,110000,40000,40000
04753P,台積電統一94售11,0,0,0,0,0,0,0,0,0,40000,0,0,0,40000,0,40000,40000
047508,旺宏國票94購01  ,0,0,0,0,0,0,0,0,0,40000,0,0,0,40000,0,40000,40000
04313P,國巨元富95售03  ,0,0,0,0,0,0,0,0,0,40000,0,0,0,80000,40000,40000,40000
049644,台積電凱基94購21,0,0,0,0,0,0,0,0,0,40000,0,0,0,40000,0,40000,40000
05051P,鴻海群益95售05  ,0,0,0,0,0,0,0,0,0,40000,0,0,0,40000,0,40000,40000
050538,鴻海凱基95購06  ,0,0,0,0,0,0,0,0,0,40000,0,0,0,40000,0,40000,40000
05090P,國巨元大95售05  ,0,0,0,0,0,0,0,0,0,40000,0,0,0,150000,110000,40000,40000
050774,健策元大96購02  ,0,0,0,0,0,0,0,0,0,40000,0,0,0,113000,73000,40000,40000
04862P,台積電元大94售26,0,0,0,0,0,0,0,0,0,40000,0,0,0,200000,160000,40000,40000
049229,台化富邦94購01  ,0,0,0,0,0,0,0,0,0,40000,0,0,0,50000,10000,40000,40000
049175,台積電凱基94購12,0,0,0,0,0,0,0,0,0,40000,0,0,0,40000,0,40000,40000
04880P,GIS永豐94售02   ,0,0,0,0,0,0,0,0,0,40000,0,0,0,92000,52000,40000,40000
048260,鴻海元富93購06  ,0,0,0,0,0,0,0,0,0,40000,0,0,0,50000,10000,40000,40000
051196,喬山麥證95購01  ,0,0,0,50000,10000,40000,0,0,0,40000,0,0,0,50000,10000,40000,40000
049986,嘉澤凱基94購02  ,0,0,0,0,0,0,0,0,0,40000,0,0,0,146000,106000,40000,40000
051084,華通元大95購06  ,0,0,0,0,0,0,0,0,0,40000,0,0,0,50000,10000,40000,40000
048909,聯詠富邦94購01  ,0,0,0,0,0,0,0,0,0,40000,0,0,0,40000,0,40000,40000
050229,鴻海麥證94購02  ,0,0,0,43000,0,43000,0,0,0,40000,0,0,0,43000,3000,40000,40000
049121,元油2X元富94購06,0,0,0,0,0,0,0,0,0,40000,0,0,0,40000,0,40000,40000
051387,新光金麥證96購01,0,0,0,40000,0,40000,0,0,0,40000,0,0,0,40000,0,40000,40000
051453,智伸科元大95購02,0,0,0,0,0,0,0,0,0,40000,0,0,0,108000,68000,40000,40000
051410,京元電國票96購01,0,0,0,0,0,0,0,0,0,40000,0,0,0,60000,20000,40000,40000
051528,亞泥國票96購01  ,0,0,0,0,0,0,0,0,0,40000,0,0,0,100000,60000,40000,40000
052958,T50反1凱基99購02,0,0,0,0,0,0,0,0,0,40000,0,0,0,40000,0,40000,40000
052977,奇力新麥證97購01,0,0,0,60000,19000,41000,0,0,0,40000,0,0,0,60000,20000,40000,40000
052912,日月光統一96購01,0,0,0,0,0,0,0,0,0,40000,0,0,0,108000,68000,40000,40000
052932,正文元大97購01  ,0,0,0,0,0,0,0,0,0,40000,0,0,0,40000,0,40000,40000
053130,聯發科麥證96購01,0,0,0,130000,90000,40000,0,0,0,40000,0,0,0,130000,90000,40000,40000
052740,聯發科元大96購07,0,0,0,0,0,0,0,0,0,40000,0,0,0,82000,42000,40000,40000
052839,上海銀國泰97購01,0,0,0,0,0,0,0,0,0,40000,0,0,0,40000,0,40000,40000
051792,泰鼎國票96購02  ,0,0,0,0,0,0,0,0,0,40000,0,0,0,40000,0,40000,40000
052218,大立光日盛95購01,0,0,0,0,0,0,0,0,0,40000,0,0,0,40000,0,40000,40000
053892,景碩群益96購02  ,0,0,0,0,0,0,0,0,0,40000,0,0,0,133000,93000,40000,40000
053923,亞光國票97購01  ,0,0,0,0,0,0,0,0,0,40000,0,0,0,40000,0,40000,40000
054207,國巨國票98購01  ,0,0,0,0,0,0,0,0,0,40000,0,0,0,40000,0,40000,40000
054213,欣興國票97購04  ,0,0,0,0,0,0,0,0,0,40000,0,0,0,40000,0,40000,40000
054343,世紀鋼元富96購02,0,0,0,0,0,0,0,0,0,40000,0,0,0,40000,0,40000,40000
053423,亞光永豐96購01  ,0,0,0,0,0,0,0,0,0,40000,0,0,0,65000,25000,40000,40000
053378,台積電元大98購02,0,0,0,0,0,0,0,0,0,40000,0,0,0,475000,435000,40000,40000
053248,智伸科國票97購01,0,0,0,0,0,0,0,0,0,40000,0,0,0,78000,38000,40000,40000
06213P,大立光元大98售07,0,0,0,0,0,0,0,0,0,40000,0,0,0,122000,82000,40000,40000
6155,鈞寶            ,106000,63000,43000,0,0,0,0,0,0,-3000,0,3000,-3000,0,0,0,40000
054938,國巨元大97購04  ,0,0,0,0,0,0,0,0,0,39000,0,0,0,118000,79000,39000,39000
055256,日電貿統一99購01,0,0,0,0,0,0,0,0,0,39000,0,0,0,75000,36000,39000,39000
05571P,大立光統一96售03,0,0,0,0,0,0,0,0,0,39000,0,0,0,39000,0,39000,39000
055786,彩晶凱基99購02  ,0,0,0,0,0,0,0,0,0,39000,0,0,0,57000,18000,39000,39000
05583P,訊芯凱基96售01  ,0,0,0,0,0,0,0,0,0,39000,0,0,0,697000,658000,39000,39000
055967,臻鼎元大97購01  ,0,0,0,0,0,0,0,0,0,39000,0,0,0,118000,79000,39000,39000
056402,智易群益98購02  ,0,0,0,0,0,0,0,0,0,39000,0,0,0,128000,89000,39000,39000
056547,臻鼎凱基99購01  ,0,0,0,0,0,0,0,0,0,39000,0,0,0,39000,0,39000,39000
05727P,新光金日盛96售02,0,0,0,0,0,0,0,0,0,39000,0,0,0,60000,21000,39000,39000
05934P,國巨凱基96售13  ,0,0,0,0,0,0,0,0,0,39000,0,0,0,63000,24000,39000,39000
046167,樺漢兆豐92購01  ,0,0,0,0,0,0,0,0,0,39000,0,0,0,39000,0,39000,39000
045695,英業達兆豐93購01,0,0,0,0,0,0,0,0,0,39000,0,0,0,40000,1000,39000,39000
046656,華邦電元大93購02,0,0,0,0,0,0,0,0,0,39000,0,0,0,60000,21000,39000,39000
045383,大毅元大92購01  ,0,0,0,0,0,0,0,0,0,39000,0,0,0,39000,0,39000,39000
046782,建準永豐93購01  ,0,0,0,0,0,0,0,0,0,39000,0,0,0,42000,3000,39000,39000
048832,玉晶光凱基95購02,0,0,0,0,0,0,0,0,0,39000,0,0,0,39000,0,39000,39000
050965,揚明光永豐96購01,0,0,0,0,0,0,0,0,0,39000,0,0,0,71000,32000,39000,39000
050992,台積電元大97購01,0,0,0,0,0,0,0,0,0,39000,0,0,0,58000,19000,39000,39000
050765,鴻海元大96購02  ,0,0,0,0,0,0,0,0,0,39000,0,0,0,262000,223000,39000,39000
05332P,臺股指國票95售01,0,0,0,0,0,0,0,0,0,39000,0,0,0,39000,0,39000,39000
053952,南亞科台新96購01,0,0,0,0,0,0,0,0,0,39000,0,0,0,53000,14000,39000,39000
053904,漢唐凱基97購01  ,0,0,0,0,0,0,0,0,0,39000,0,0,0,39000,0,39000,39000
053962,聯茂永豐96購01  ,0,0,0,0,0,0,0,0,0,39000,0,0,0,49000,10000,39000,39000
054143,茂林元大96購04  ,0,0,0,0,0,0,0,0,0,39000,0,0,0,58000,19000,39000,39000
051744,嘉聯益國票97購01,0,0,0,0,0,0,0,0,0,39000,0,0,0,115000,76000,39000,39000
053086,宏達電元大97購01,0,0,0,0,0,0,0,0,0,39000,0,0,0,85000,46000,39000,39000
3016,嘉晶            ,290000,222000,68000,0,0,0,0,0,0,-29000,0,0,0,2000,31000,-29000,39000
05746P,台積電群益96售07,0,0,0,0,0,0,0,0,0,38000,0,0,0,74000,36000,38000,38000
05580P,美律凱基96售03  ,0,0,0,0,0,0,0,0,0,38000,0,0,0,44000,6000,38000,38000
055620,樺漢國票98購01  ,0,0,0,0,0,0,0,0,0,38000,0,0,0,38000,0,38000,38000
055556,奇力新凱基98購03,0,0,0,0,0,0,0,0,0,38000,0,0,0,38000,0,38000,38000
055387,世紀鋼元大97購01,0,0,0,0,0,0,0,0,0,38000,0,0,0,38000,0,38000,38000
054894,GIS統一97購01   ,0,0,0,0,0,0,0,0,0,38000,0,0,0,48000,10000,38000,38000
054507,鈺齊永豐96購01  ,0,0,0,0,0,0,0,0,0,38000,0,0,0,40000,2000,38000,38000
047725,廣達群益93購01  ,0,0,0,0,0,0,0,0,0,38000,0,0,0,48000,10000,38000,38000
048542,美利達台新93購01,0,0,0,0,0,0,0,0,0,38000,0,0,0,38000,0,38000,38000
04430P,晶相光元大94售04,0,0,0,0,0,0,0,0,0,38000,0,0,0,120000,82000,38000,38000
044736,聯發科國泰93購01,0,0,0,0,0,0,0,0,0,38000,0,0,0,73000,35000,38000,38000
050769,聯發科元大94購17,0,0,0,0,0,0,0,0,0,38000,0,0,0,68000,30000,38000,38000
050854,世紀鋼國票97購01,0,0,0,0,0,0,0,0,0,38000,0,0,0,38000,0,38000,38000
048699,嘉晶國票95購01  ,0,0,0,0,0,0,0,0,0,38000,0,0,0,38000,0,38000,38000
048153,台積電兆豐94購01,0,0,0,0,0,0,0,0,0,38000,0,0,0,38000,0,38000,38000
048286,滬深2X兆豐94購04,0,0,0,0,0,0,0,0,0,38000,0,0,0,288000,250000,38000,38000
051539,瀚宇博國票97購01,0,0,0,0,0,0,0,0,0,38000,0,0,0,38000,0,38000,38000
051534,景碩國票97購01  ,0,0,0,0,0,0,0,0,0,38000,0,0,0,80000,42000,38000,38000
051035,百和兆豐95購01  ,0,0,0,0,0,0,0,0,0,38000,0,0,0,38000,0,38000,38000
051036,喬山台新95購01  ,0,0,0,0,0,0,0,0,0,38000,0,0,0,38000,0,38000,38000
049339,鴻海統一94購02  ,0,0,0,0,0,0,0,0,0,38000,0,0,0,38000,0,38000,38000
049956,國巨統一94購05  ,0,0,0,0,0,0,0,0,0,38000,0,0,0,109000,71000,38000,38000
049995,GIS台新94購01   ,0,0,0,0,0,0,0,0,0,38000,0,0,0,38000,0,38000,38000
050010,鈺齊永豐94購01  ,0,0,0,0,0,0,0,0,0,38000,0,0,0,60000,22000,38000,38000
052717,正文凱基96購01  ,0,0,0,0,0,0,0,0,0,38000,0,0,0,38000,0,38000,38000
052579,亞泥元富96購01  ,0,0,0,0,0,0,0,0,0,38000,0,0,0,68000,30000,38000,38000
052565,上銀凱基96購01  ,0,0,0,0,0,0,0,0,0,38000,0,0,0,251000,213000,38000,38000
051958,貿聯台新95購01  ,0,0,0,0,0,0,0,0,0,38000,0,0,0,38000,0,38000,38000
053630,奇鋐兆豐97購01  ,0,0,0,0,0,0,0,0,0,38000,0,0,0,38000,0,38000,38000
053669,台積電統一96購08,0,0,0,0,0,0,0,0,0,38000,0,0,0,51000,13000,38000,38000
06270P,致伸凱基97售03  ,0,0,0,0,0,0,0,0,0,38000,0,0,0,38000,0,38000,38000
06446P,大立光凱基98售10,0,0,0,0,0,0,0,0,0,38000,0,0,0,38000,0,38000,38000
054498,燿華永豐96購06  ,0,0,0,0,0,0,0,0,0,37000,0,0,0,37000,0,37000,37000
055122,國巨兆豐98購01  ,0,0,0,0,0,0,0,0,0,37000,0,0,0,237000,200000,37000,37000
055646,漢唐元富97購01  ,0,0,0,0,0,0,0,0,0,37000,0,0,0,62000,25000,37000,37000
056053,和大元大97購05  ,0,0,0,0,0,0,0,0,0,37000,0,0,0,37000,0,37000,37000
056066,奇鋐元大98購02  ,0,0,0,0,0,0,0,0,0,37000,0,0,0,40000,3000,37000,37000
056373,上銀統一99購02  ,0,0,0,0,0,0,0,0,0,37000,0,0,0,47000,10000,37000,37000
04190P,大立光兆豐94售03,0,0,0,0,0,0,0,0,0,37000,0,0,0,37000,0,37000,37000
03629C,元油2X元富98牛06,0,0,0,0,0,0,0,0,0,37000,0,0,0,256000,219000,37000,37000
044270,群創中信95購02  ,0,0,0,0,0,0,0,0,0,37000,0,0,0,57000,20000,37000,37000
047855,美律國票94購01  ,0,0,0,0,0,0,0,0,0,37000,0,0,0,85000,48000,37000,37000
047319,晶技元大93購02  ,0,0,0,0,0,0,0,0,0,37000,0,0,0,37000,0,37000,37000
046649,致伸國泰94購01  ,0,0,0,0,0,0,0,0,0,37000,0,0,0,135000,98000,37000,37000
047761,亞德客元大93購02,0,0,0,0,0,0,0,0,0,37000,0,0,0,37000,0,37000,37000
04684P,欣興元大94售07  ,0,0,0,0,0,0,0,0,0,37000,0,0,0,37000,0,37000,37000
046365,禾伸堂永豐92購02,0,0,0,0,0,0,0,0,0,37000,0,0,0,40000,3000,37000,37000
048875,晶相光國票94購01,0,0,0,0,0,0,0,0,0,37000,0,0,0,47000,10000,37000,37000
048340,聯發科元大93購25,0,0,0,0,0,0,0,0,0,37000,0,0,0,98000,61000,37000,37000
051026,健策統一96購01  ,0,0,0,0,0,0,0,0,0,37000,0,0,0,37000,0,37000,37000
053831,台積電台新97購02,0,0,0,0,0,0,0,0,0,37000,0,0,0,37000,0,37000,37000
054094,創意群益96購02  ,0,0,0,0,0,0,0,0,0,37000,0,0,0,115000,78000,37000,37000
054238,聯茂群益96購04  ,0,0,0,0,0,0,0,0,0,37000,0,0,0,37000,0,37000,37000
051991,泰碩元大95購02  ,0,0,0,0,0,0,0,0,0,37000,0,0,0,37000,0,37000,37000
052747,京鼎元大97購01  ,0,0,0,0,0,0,0,0,0,37000,0,0,0,137000,100000,37000,37000
06068P,玉晶光康和97售01,0,0,0,0,0,0,0,0,0,37000,0,0,0,125000,88000,37000,37000
8464,億豐            ,540000,508000,32000,0,0,0,5000,0,5000,0,0,0,0,0,0,0,37000
056297,台光電元大97購04,0,0,0,0,0,0,0,0,0,36000,0,0,0,54000,18000,36000,36000
054971,帆宣元大97購02  ,0,0,0,0,0,0,0,0,0,36000,0,0,0,296000,260000,36000,36000
047068,南電凱基93購04  ,0,0,0,0,0,0,0,0,0,36000,0,0,0,36000,0,36000,36000
048514,嘉澤凱基93購06  ,0,0,0,0,0,0,0,0,0,36000,0,0,0,170000,134000,36000,36000
050484,世紀鋼國票95購02,0,0,0,0,0,0,0,0,0,36000,0,0,0,36000,0,36000,36000
047481,可成凱基93購08  ,0,0,0,0,0,0,0,0,0,36000,0,0,0,126000,90000,36000,36000
046513,景碩元大92購02  ,0,0,0,0,0,0,0,0,0,36000,0,0,0,46000,10000,36000,36000
03909P,奇鋐元大93售04  ,0,0,0,0,0,0,0,0,0,36000,0,0,0,36000,0,36000,36000
048394,正崴國票94購01  ,0,0,0,0,0,0,0,0,0,36000,0,0,0,36000,0,36000,36000
050541,智邦凱基94購04  ,0,0,0,0,0,0,0,0,0,36000,0,0,0,256000,220000,36000,36000
050185,和鑫元大95購02  ,0,0,0,0,0,0,0,0,0,36000,0,0,0,36000,0,36000,36000
050322,世紀鋼國票95購01,0,0,0,0,0,0,0,0,0,36000,0,0,0,36000,0,36000,36000
050230,聯發科麥證94購02,0,0,0,76000,40000,36000,0,0,0,36000,0,0,0,76000,40000,36000,36000
051476,聯發科凱基95購09,0,0,0,0,0,0,0,0,0,36000,0,0,0,45000,9000,36000,36000
051609,貿聯群益95購03  ,0,0,0,0,0,0,0,0,0,36000,0,0,0,120000,84000,36000,36000
050627,華通中信94購02  ,0,0,0,0,0,0,0,0,0,36000,0,0,0,36000,0,36000,36000
053101,創意元富96購03  ,0,0,0,0,0,0,0,0,0,36000,0,0,0,46000,10000,36000,36000
052939,富邦金兆豐96購01,0,0,0,0,0,0,0,0,0,36000,0,0,0,36000,0,36000,36000
052970,美律群益96購01  ,0,0,0,0,0,0,0,0,0,36000,0,0,0,63000,27000,36000,36000
052274,大立光群益95購03,0,0,0,0,0,0,0,0,0,36000,0,0,0,36000,0,36000,36000
053865,欣興元大97購02  ,0,0,0,0,0,0,0,0,0,36000,0,0,0,47000,11000,36000,36000
053238,麗豐永豐96購01  ,0,0,0,0,0,0,0,0,0,36000,0,0,0,36000,0,36000,36000
053506,南茂兆豐97購01  ,0,0,0,0,0,0,0,0,0,36000,0,0,0,36000,0,36000,36000
054888,泰碩統一97購01  ,0,0,0,0,0,0,0,0,0,35000,0,0,0,35000,0,35000,35000
055087,瑞昱亞東97購01  ,0,0,0,0,0,0,0,0,0,35000,0,0,0,35000,0,35000,35000
055008,隆達元富97購01  ,0,0,0,0,0,0,0,0,0,35000,0,0,0,41000,6000,35000,35000
055637,亞德客元富97購01,0,0,0,0,0,0,0,0,0,35000,0,0,0,52000,17000,35000,35000
055671,世紀鋼群益97購01,0,0,0,0,0,0,0,0,0,35000,0,0,0,35000,0,35000,35000
055575,華新科統一98購01,0,0,0,0,0,0,0,0,0,35000,0,0,0,98000,63000,35000,35000
055385,昇陽半元大98購01,0,0,0,0,0,0,0,0,0,35000,0,0,0,50000,15000,35000,35000
05630P,大立光永昌96售06,0,0,0,0,0,0,0,0,0,35000,0,0,0,65000,30000,35000,35000
055839,瑞昱元大97購04  ,0,0,0,0,0,0,0,0,0,35000,0,0,0,77000,42000,35000,35000
05762P,昇陽半永豐96售04,0,0,0,0,0,0,0,0,0,35000,0,0,0,65000,30000,35000,35000
056568,台表科群益98購01,0,0,0,0,0,0,0,0,0,35000,0,0,0,40000,5000,35000,35000
04289P,臺股指中信95售07,0,0,0,0,0,0,0,0,0,35000,0,0,0,105000,70000,35000,35000
048538,美利達國票94購01,0,0,0,0,0,0,0,0,0,35000,0,0,0,35000,0,35000,35000
047080,仁寶康和93購01  ,0,0,0,0,0,0,0,0,0,35000,0,0,0,35000,0,35000,35000
047289,啟碁統一97購01  ,0,0,0,0,0,0,0,0,0,35000,0,0,0,35000,0,35000,35000
046362,華通永豐92購02  ,0,0,0,0,0,0,0,0,0,35000,0,0,0,38000,3000,35000,35000
046862,台郡元大94購01  ,0,0,0,0,0,0,0,0,0,35000,0,0,0,35000,0,35000,35000
046706,智邦台新93購01  ,0,0,0,0,0,0,0,0,0,35000,0,0,0,35000,0,35000,35000
050647,聯發科凱基96購01,0,0,0,0,0,0,0,0,0,35000,0,0,0,46000,11000,35000,35000
051440,鴻海元大95購12  ,0,0,0,0,0,0,0,0,0,35000,0,0,0,45000,10000,35000,35000
050219,台積電元富95購03,0,0,0,0,0,0,0,0,0,35000,0,0,0,35000,0,35000,35000
049152,大立光元大95購06,0,0,0,0,0,0,0,0,0,35000,0,0,0,75000,40000,35000,35000
049619,宏達電群益95購02,0,0,0,0,0,0,0,0,0,35000,0,0,0,50000,15000,35000,35000
050836,緯穎凱基95購01  ,0,0,0,0,0,0,0,0,0,35000,0,0,0,122000,87000,35000,35000
050857,義隆台新95購01  ,0,0,0,0,0,0,0,0,0,35000,0,0,0,60000,25000,35000,35000
049582,台積電元大95購03,0,0,0,0,0,0,0,0,0,35000,0,0,0,64000,29000,35000,35000
048279,聯鈞永豐93購01  ,0,0,0,0,0,0,0,0,0,35000,0,0,0,35000,0,35000,35000
048439,上銀凱基93購09  ,0,0,0,0,0,0,0,0,0,35000,0,0,0,114000,79000,35000,35000
048502,百和元大93購01  ,0,0,0,0,0,0,0,0,0,35000,0,0,0,70000,35000,35000,35000
049297,日電貿群益95購01,0,0,0,0,0,0,0,0,0,35000,0,0,0,55000,20000,35000,35000
053631,欣興兆豐97購01  ,0,0,0,0,0,0,0,0,0,35000,0,0,0,35000,0,35000,35000
053551,可成凱基96購05  ,0,0,0,0,0,0,0,0,0,35000,0,0,0,35000,0,35000,35000
05217P,鴻海統一95售08  ,0,0,0,0,0,0,0,0,0,35000,0,0,0,35000,0,35000,35000
052357,揚明光永豐95購03,0,0,0,0,0,0,0,0,0,35000,0,0,0,41000,6000,35000,35000
053053,京元電國票97購02,0,0,0,0,0,0,0,0,0,35000,0,0,0,60000,25000,35000,35000
052709,光寶科日盛96購01,0,0,0,0,0,0,0,0,0,35000,0,0,0,36000,1000,35000,35000
06406P,可成元富97售04  ,0,0,0,0,0,0,0,0,0,35000,0,0,0,50000,15000,35000,35000
056579,麗豐元大99購01  ,0,0,0,0,0,0,0,0,0,34000,0,0,0,55000,21000,34000,34000
056608,力山永豐98購01  ,0,0,0,0,0,0,0,0,0,34000,0,0,0,34000,0,34000,34000
055955,微星元大97購01  ,0,0,0,0,0,0,0,0,0,34000,0,0,0,559000,525000,34000,34000
056093,大毅元富97購01  ,0,0,0,0,0,0,0,0,0,34000,0,0,0,113000,79000,34000,34000
056037,美律凱基98購03  ,0,0,0,0,0,0,0,0,0,34000,0,0,0,39000,5000,34000,34000
056199,美律永豐97購01  ,0,0,0,0,0,0,0,0,0,34000,0,0,0,167000,133000,34000,34000
05526P,茂林群益96售03  ,0,0,0,0,0,0,0,0,0,34000,0,0,0,35000,1000,34000,34000
055181,日電貿統一97購01,0,0,0,0,0,0,0,0,0,34000,0,0,0,35000,1000,34000,34000
055775,友達凱基9A購01  ,0,0,0,0,0,0,0,0,0,34000,0,0,0,34000,0,34000,34000
054863,億光群益97購01  ,0,0,0,0,0,0,0,0,0,34000,0,0,0,87000,53000,34000,34000
05458P,台積電凱基97售02,0,0,0,0,0,0,0,0,0,34000,0,0,0,34000,0,34000,34000
045749,智邦富邦93購01  ,0,0,0,0,0,0,0,0,0,34000,0,0,0,45000,11000,34000,34000
04590P,元石油元大97售01,0,0,0,0,0,0,0,0,0,34000,0,0,0,35000,1000,34000,34000
050351,華新科群益95購02,0,0,0,0,0,0,0,0,0,34000,0,0,0,71000,37000,34000,34000
044614,聯茂兆豐92購02  ,0,0,0,0,0,0,0,0,0,34000,0,0,0,34000,0,34000,34000
049570,華新科統一94購04,0,0,0,0,0,0,0,0,0,34000,0,0,0,60000,26000,34000,34000
048622,南電凱基93購07  ,0,0,0,0,0,0,0,0,0,34000,0,0,0,34000,0,34000,34000
052702,群創國票97購03  ,0,0,0,0,0,0,0,0,0,34000,0,0,0,34000,0,34000,34000
052749,日月光元大96購02,0,0,0,0,0,0,0,0,0,34000,0,0,0,101000,67000,34000,34000
052462,上銀統一95購03  ,0,0,0,0,0,0,0,0,0,34000,0,0,0,34000,0,34000,34000
05218P,大立光永昌96售04,0,0,0,0,0,0,0,0,0,34000,0,0,0,372000,338000,34000,34000
052015,漢唐永豐95購02  ,0,0,0,0,0,0,0,0,0,34000,0,0,0,34000,0,34000,34000
054010,致伸元富96購01  ,0,0,0,0,0,0,0,0,0,34000,0,0,0,44000,10000,34000,34000
055081,健鼎中信97購01  ,0,0,0,0,0,0,0,0,0,33000,0,0,0,43000,10000,33000,33000
055666,鴻海群益97購05  ,0,0,0,0,0,0,0,0,0,33000,0,0,0,33000,0,33000,33000
055650,華新科元富98購01,0,0,0,0,0,0,0,0,0,33000,0,0,0,555000,522000,33000,33000
055694,光罩國票98購01  ,0,0,0,0,0,0,0,0,0,33000,0,0,0,108000,75000,33000,33000
055697,牧德國票98購01  ,0,0,0,0,0,0,0,0,0,33000,0,0,0,118000,85000,33000,33000
056114,台達電群益97購02,0,0,0,0,0,0,0,0,0,33000,0,0,0,44000,11000,33000,33000
055949,亞德客元大97購04,0,0,0,0,0,0,0,0,0,33000,0,0,0,200000,167000,33000,33000
056461,樺漢凱基98購02  ,0,0,0,0,0,0,0,0,0,33000,0,0,0,33000,0,33000,33000
04104P,臺股指國票93售11,0,0,0,0,0,0,0,0,0,33000,0,0,0,70000,37000,33000,33000
044507,燿華凱基93購03  ,0,0,0,0,0,0,0,0,0,33000,0,0,0,33000,0,33000,33000
044468,台積電群益93購01,0,0,0,0,0,0,0,0,0,33000,0,0,0,33000,0,33000,33000
045163,瀚宇博國泰93購01,0,0,0,0,0,0,0,0,0,33000,0,0,0,43000,10000,33000,33000
050391,大立光統一94購07,0,0,0,0,0,0,0,0,0,33000,0,0,0,54000,21000,33000,33000
046303,台積電元大92購25,0,0,0,0,0,0,0,0,0,33000,0,0,0,33000,0,33000,33000
045632,正崴凱基93購01  ,0,0,0,0,0,0,0,0,0,33000,0,0,0,33000,0,33000,33000
050952,健策群益96購01  ,0,0,0,0,0,0,0,0,0,33000,0,0,0,80000,47000,33000,33000
049250,華通元大95購04  ,0,0,0,0,0,0,0,0,0,33000,0,0,0,46000,13000,33000,33000
049122,元油2X元富94購07,0,0,0,0,0,0,0,0,0,33000,0,0,0,33000,0,33000,33000
050251,樺漢凱基94購02  ,0,0,0,0,0,0,0,0,0,33000,0,0,0,33000,0,33000,33000
050327,泰鼎永豐94購03  ,0,0,0,0,0,0,0,0,0,33000,0,0,0,104000,71000,33000,33000
051577,台積電元大97購03,0,0,0,0,0,0,0,0,0,33000,0,0,0,242000,209000,33000,33000
054020,技嘉台新97購01  ,0,0,0,0,0,0,0,0,0,33000,0,0,0,33000,0,33000,33000
053896,麗豐群益97購01  ,0,0,0,0,0,0,0,0,0,33000,0,0,0,33000,0,33000,33000
054263,聯茂元大96購02  ,0,0,0,0,0,0,0,0,0,33000,0,0,0,35000,2000,33000,33000
054373,富邦金中信97購01,0,0,0,0,0,0,0,0,0,33000,0,0,0,38000,5000,33000,33000
053656,可成凱基96購06  ,0,0,0,0,0,0,0,0,0,33000,0,0,0,41000,8000,33000,33000
053205,台光電麥證96購01,0,0,0,158000,125000,33000,0,0,0,33000,0,0,0,158000,125000,33000,33000
053353,玉晶光兆豐97購03,0,0,0,0,0,0,0,0,0,33000,0,0,0,43000,10000,33000,33000
052190,創意群益95購03  ,0,0,0,0,0,0,0,0,0,33000,0,0,0,33000,0,33000,33000
052771,GIS群益96購01   ,0,0,0,0,0,0,0,0,0,33000,0,0,0,58000,25000,33000,33000
052627,中壽中信98購01  ,0,0,0,0,0,0,0,0,0,33000,0,0,0,33000,0,33000,33000
052667,漢唐群益96購01  ,0,0,0,0,0,0,0,0,0,33000,0,0,0,33000,0,33000,33000
053069,同欣電群益98購01,0,0,0,0,0,0,0,0,0,33000,0,0,0,64000,31000,33000,33000
053002,鴻海永豐96購01  ,0,0,0,0,0,0,0,0,0,33000,0,0,0,43000,10000,33000,33000
06181P,國巨中信97售02  ,0,0,0,0,0,0,0,0,0,33000,0,0,0,80000,47000,33000,33000
05953P,台積電國票98售02,0,0,0,0,0,0,0,0,0,32000,0,0,0,39000,7000,32000,32000
055478,訊芯凱基97購01  ,0,0,0,0,0,0,0,0,0,32000,0,0,0,180000,148000,32000,32000
055330,上銀兆豐98購02  ,0,0,0,0,0,0,0,0,0,32000,0,0,0,34000,2000,32000,32000
055430,宏達電群益97購01,0,0,0,0,0,0,0,0,0,32000,0,0,0,43000,11000,32000,32000
054955,宏達電元大98購01,0,0,0,0,0,0,0,0,0,32000,0,0,0,100000,68000,32000,32000
054569,GIS群益98購01   ,0,0,0,0,0,0,0,0,0,32000,0,0,0,32000,0,32000,32000
04767P,台積電國泰95售04,0,0,0,0,0,0,0,0,0,32000,0,0,0,48000,16000,32000,32000
046339,訊芯中信92購01  ,0,0,0,0,0,0,0,0,0,32000,0,0,0,32000,0,32000,32000
047833,全新元大94購02  ,0,0,0,0,0,0,0,0,0,32000,0,0,0,32000,0,32000,32000
049508,上銀凱基94購04  ,0,0,0,0,0,0,0,0,0,32000,0,0,0,53000,21000,32000,32000
047138,智伸科凱基93購04,0,0,0,0,0,0,0,0,0,32000,0,0,0,42000,10000,32000,32000
046521,台郡元大92購06  ,0,0,0,0,0,0,0,0,0,32000,0,0,0,32000,0,32000,32000
049233,聯發科統一94購04,0,0,0,0,0,0,0,0,0,32000,0,0,0,149000,117000,32000,32000
051090,光磊元大96購01  ,0,0,0,0,0,0,0,0,0,32000,0,0,0,100000,68000,32000,32000
050787,致伸國泰96購01  ,0,0,0,0,0,0,0,0,0,32000,0,0,0,72000,40000,32000,32000
050790,昇陽半國泰96購02,0,0,0,0,0,0,0,0,0,32000,0,0,0,62000,30000,32000,32000
049595,麗豐元大95購01  ,0,0,0,0,0,0,0,0,0,32000,0,0,0,333000,301000,32000,32000
052590,祥碩永豐96購01  ,0,0,0,0,0,0,0,0,0,32000,0,0,0,32000,0,32000,32000
051734,台積電國票95購04,0,0,0,0,0,0,0,0,0,32000,0,0,0,195000,163000,32000,32000
051927,國巨中信96購01  ,0,0,0,0,0,0,0,0,0,32000,0,0,0,32000,0,32000,32000
051829,玉晶光元大98購02,0,0,0,0,0,0,0,0,0,32000,0,0,0,32000,0,32000,32000
053690,南亞科元大96購02,0,0,0,0,0,0,0,0,0,32000,0,0,0,43000,11000,32000,32000
054415,奇力新元大96購06,0,0,0,0,0,0,0,0,0,32000,0,0,0,32000,0,32000,32000
054468,台郡凱基98購01  ,0,0,0,0,0,0,0,0,0,32000,0,0,0,60000,28000,32000,32000
054478,可成中信97購01  ,0,0,0,0,0,0,0,0,0,32000,0,0,0,32000,0,32000,32000
054002,GIS群益96購03   ,0,0,0,0,0,0,0,0,0,32000,0,0,0,32000,0,32000,32000
054116,順德康和96購01  ,0,0,0,0,0,0,0,0,0,32000,0,0,0,32000,0,32000,32000
054058,晶豪科國票98購01,0,0,0,0,0,0,0,0,0,32000,0,0,0,32000,0,32000,32000
054170,泰鼎凱基98購01  ,0,0,0,0,0,0,0,0,0,32000,0,0,0,39000,7000,32000,32000
056471,台光電元大99購01,0,0,0,0,0,0,0,0,0,31000,0,0,0,31000,0,31000,31000
056581,超眾元大99購01  ,0,0,0,0,0,0,0,0,0,31000,0,0,0,54000,23000,31000,31000
055888,鴻海統一97購04  ,0,0,0,0,0,0,0,0,0,31000,0,0,0,81000,50000,31000,31000
05604P,聯發科元大96售10,0,0,0,0,0,0,0,0,0,31000,0,0,0,91000,60000,31000,31000
04645P,禾伸堂凱基94售03,0,0,0,0,0,0,0,0,0,31000,0,0,0,33000,2000,31000,31000
047523,瑞昱元大93購09  ,0,0,0,0,0,0,0,0,0,31000,0,0,0,42000,11000,31000,31000
046562,大立光凱基95購01,0,0,0,0,0,0,0,0,0,31000,0,0,0,31000,0,31000,31000
045213,A50正2元大95購01,0,0,0,0,0,0,0,0,0,31000,0,0,0,36000,5000,31000,31000
04256P,美律國票93售03  ,0,0,0,0,0,0,0,0,0,31000,0,0,0,31000,0,31000,31000
047048,華邦電國票93購02,0,0,0,0,0,0,0,0,0,31000,0,0,0,31000,0,31000,31000
047078,上海銀兆豐93購01,0,0,0,0,0,0,0,0,0,31000,0,0,0,35000,4000,31000,31000
047274,華新科永豐93購02,0,0,0,0,0,0,0,0,0,31000,0,0,0,31000,0,31000,31000
050713,矽格麥證94購01  ,0,0,0,41000,10000,31000,0,0,0,31000,0,0,0,41000,10000,31000,31000
048855,華新科群益94購02,0,0,0,0,0,0,0,0,0,31000,0,0,0,91000,60000,31000,31000
050039,鴻海中信94購03  ,0,0,0,0,0,0,0,0,0,31000,0,0,0,56000,25000,31000,31000
053574,奇力新元富99購01,0,0,0,0,0,0,0,0,0,31000,0,0,0,136000,105000,31000,31000
053283,同欣電元大96購03,0,0,0,0,0,0,0,0,0,31000,0,0,0,37000,6000,31000,31000
051993,和碩元大95購03  ,0,0,0,0,0,0,0,0,0,31000,0,0,0,497000,466000,31000,31000
05222P,致伸凱基95售02  ,0,0,0,0,0,0,0,0,0,31000,0,0,0,51000,20000,31000,31000
052575,茂林凱基96購04  ,0,0,0,0,0,0,0,0,0,31000,0,0,0,31000,0,31000,31000
052787,國巨中信96購02  ,0,0,0,0,0,0,0,0,0,31000,0,0,0,54000,23000,31000,31000
06475P,牧德永豐98售03  ,0,0,0,0,0,0,0,0,0,31000,0,0,0,51000,20000,31000,31000
2419,仲琦            ,351000,320000,31000,0,0,0,0,0,0,0,0,0,0,0,0,0,31000
8926,台汽電          ,374000,397000,-23000,0,0,0,0,0,0,54000,55000,1000,54000,0,0,0,31000
05579P,友達凱基98售03  ,0,0,0,0,0,0,0,0,0,30000,0,0,0,30000,0,30000,30000
056170,鴻海元富97購09  ,0,0,0,0,0,0,0,0,0,30000,0,0,0,30000,0,30000,30000
056167,力成台新97購01  ,0,0,0,0,0,0,0,0,0,30000,0,0,0,30000,0,30000,30000
056173,廣達元富97購01  ,0,0,0,0,0,0,0,0,0,30000,0,0,0,30000,0,30000,30000
056380,麗豐元富98購01  ,0,0,0,0,0,0,0,0,0,30000,0,0,0,30000,0,30000,30000
056397,彩晶永豐99購01  ,0,0,0,0,0,0,0,0,0,30000,0,0,0,80000,50000,30000,30000
056588,聯發科統一9A購02,0,0,0,0,0,0,0,0,0,30000,0,0,0,60000,30000,30000,30000
056490,台積電國泰99購01,0,0,0,0,0,0,0,0,0,30000,0,0,0,35000,5000,30000,30000
05673P,台積電群益96售05,0,0,0,0,0,0,0,0,0,30000,0,0,0,40000,10000,30000,30000
05949P,台積電國票96售09,0,0,0,0,0,0,0,0,0,30000,0,0,0,90000,60000,30000,30000
054547,鴻海凱基98購02  ,0,0,0,0,0,0,0,0,0,30000,0,0,0,50000,20000,30000,30000
054597,南亞台新97購01  ,0,0,0,0,0,0,0,0,0,30000,0,0,0,40000,10000,30000,30000
054639,台新金中信99購01,0,0,0,0,0,0,0,0,0,30000,0,0,0,30000,0,30000,30000
054989,精元元富97購01  ,0,0,0,0,0,0,0,0,0,30000,0,0,0,30000,0,30000,30000
054928,帆宣凱基98購01  ,0,0,0,0,0,0,0,0,0,30000,0,0,0,30000,0,30000,30000
054836,勤誠中信97購01  ,0,0,0,0,0,0,0,0,0,30000,0,0,0,71000,41000,30000,30000
055495,長榮航元大97購01,0,0,0,0,0,0,0,0,0,30000,0,0,0,100000,70000,30000,30000
055512,聯詠兆豐97購01  ,0,0,0,0,0,0,0,0,0,30000,0,0,0,60000,30000,30000,30000
055538,鴻海日盛97購04  ,0,0,0,0,0,0,0,0,0,30000,0,0,0,40000,10000,30000,30000
05576P,群創日盛99售02  ,0,0,0,0,0,0,0,0,0,30000,0,0,0,30000,0,30000,30000
048553,光磊元大93購03  ,0,0,0,0,0,0,0,0,0,30000,0,0,0,30000,0,30000,30000
047261,聯詠國票93購02  ,0,0,0,0,0,0,0,0,0,30000,0,0,0,30000,0,30000,30000
047321,日月光元大93購03,0,0,0,0,0,0,0,0,0,30000,0,0,0,30000,0,30000,30000
046960,台新金中信95購01,0,0,0,0,0,0,0,0,0,30000,0,0,0,30000,0,30000,30000
047131,鴻海凱基94購03  ,0,0,0,0,0,0,0,0,0,30000,0,0,0,30000,0,30000,30000
046895,智伸科群益93購02,0,0,0,0,0,0,0,0,0,30000,0,0,0,30000,0,30000,30000
045934,燿華群益93購01  ,0,0,0,0,0,0,0,0,0,30000,0,0,0,30000,0,30000,30000
046126,致伸元大92購05  ,0,0,0,0,0,0,0,0,0,30000,0,0,0,30000,0,30000,30000
046067,富邦金凱基92購02,0,0,0,0,0,0,0,0,0,30000,0,0,0,40000,10000,30000,30000
046346,旺宏兆豐92購02  ,0,0,0,0,0,0,0,0,0,30000,0,0,0,30000,0,30000,30000
046300,嘉聯益富邦94購01,0,0,0,0,0,0,0,0,0,30000,0,0,0,40000,10000,30000,30000
046209,全新元富92購01  ,0,0,0,0,0,0,0,0,0,30000,0,0,0,30000,0,30000,30000
046273,和碩凱基92購02  ,0,0,0,0,0,0,0,0,0,30000,0,0,0,30000,0,30000,30000
04628P,欣興元大95售01  ,0,0,0,0,0,0,0,0,0,30000,0,0,0,30000,0,30000,30000
045855,緯穎富邦93購01  ,0,0,0,0,0,0,0,0,0,30000,0,0,0,30000,0,30000,30000
046653,鴻海元大93購05  ,0,0,0,0,0,0,0,0,0,30000,0,0,0,30000,0,30000,30000
047733,友達兆豐95購01  ,0,0,0,0,0,0,0,0,0,30000,0,0,0,30000,0,30000,30000
047760,元油反元大96購03,0,0,0,0,0,0,0,0,0,30000,0,0,0,30000,0,30000,30000
043970,為升富邦94購01  ,0,0,0,0,0,0,0,0,0,30000,0,0,0,30000,0,30000,30000
045090,瀚宇博元大93購01,0,0,0,0,0,0,0,0,0,30000,0,0,0,30000,0,30000,30000
045060,世紀鋼富邦93購01,0,0,0,0,0,0,0,0,0,30000,0,0,0,30000,0,30000,30000
04353P,全新永豐94售01  ,0,0,0,0,0,0,0,0,0,30000,0,0,0,30000,0,30000,30000
04653P,臺股指凱基94售12,0,0,0,0,0,0,0,0,0,30000,0,0,0,30000,0,30000,30000
047540,技嘉麥證93購01  ,0,0,0,60000,30000,30000,0,0,0,30000,0,0,0,60000,30000,30000,30000
047584,元金2X永豐95購01,0,0,0,0,0,0,0,0,0,30000,0,0,0,30000,0,30000,30000
046504,聯發科元大92購19,0,0,0,0,0,0,0,0,0,30000,0,0,0,30000,0,30000,30000
046536,聯發科群益92購08,0,0,0,0,0,0,0,0,0,30000,0,0,0,30000,0,30000,30000
045327,智伸科永豐92購01,0,0,0,0,0,0,0,0,0,30000,0,0,0,30000,0,30000,30000
045295,台積電元大93購02,0,0,0,0,0,0,0,0,0,30000,0,0,0,30000,0,30000,30000
03208P,國巨中信02售02  ,0,0,0,0,0,0,0,0,0,30000,0,0,0,30000,0,30000,30000
040215,上証反凱基95購01,0,0,0,0,0,0,0,0,0,30000,0,0,0,32000,2000,30000,30000
044861,玉晶光兆豐93購01,0,0,0,0,0,0,0,0,0,30000,0,0,0,35000,5000,30000,30000
04172P,大立光凱基93售34,0,0,0,0,0,0,0,0,0,30000,0,0,0,70000,40000,30000,30000
04490P,聯發科台新94售02,0,0,0,0,0,0,0,0,0,30000,0,0,0,30000,0,30000,30000
050334,鴻海國泰96購07  ,0,0,0,0,0,0,0,0,0,30000,0,0,0,30000,0,30000,30000
050556,道瓊銀統一95購01,0,0,0,0,0,0,0,0,0,30000,0,0,0,30000,0,30000,30000
049919,美食元大94購03  ,0,0,0,0,0,0,0,0,0,30000,0,0,0,30000,0,30000,30000
047937,元金2X國票97購02,0,0,0,0,0,0,0,0,0,30000,0,0,0,30000,0,30000,30000
048950,達方永豐94購01  ,0,0,0,0,0,0,0,0,0,30000,0,0,0,30000,0,30000,30000
050240,聯發科凱基94購13,0,0,0,0,0,0,0,0,0,30000,0,0,0,70000,40000,30000,30000
050263,旺宏元大94購10  ,0,0,0,0,0,0,0,0,0,30000,0,0,0,74000,44000,30000,30000
050212,瀚宇博國票95購02,0,0,0,0,0,0,0,0,0,30000,0,0,0,30000,0,30000,30000
049868,傳奇兆豐94購01  ,0,0,0,0,0,0,0,0,0,30000,0,0,0,30000,0,30000,30000
049117,矽格統一96購01  ,0,0,0,0,0,0,0,0,0,30000,0,0,0,76000,46000,30000,30000
049142,智邦元大94購01  ,0,0,0,0,0,0,0,0,0,30000,0,0,0,68000,38000,30000,30000
051053,台光電群益95購01,0,0,0,0,0,0,0,0,0,30000,0,0,0,30000,0,30000,30000
051422,超眾國票96購01  ,0,0,0,0,0,0,0,0,0,30000,0,0,0,30000,0,30000,30000
051399,玉晶光台新96購01,0,0,0,0,0,0,0,0,0,30000,0,0,0,30000,0,30000,30000
051516,全新凱基96購02  ,0,0,0,0,0,0,0,0,0,30000,0,0,0,30000,0,30000,30000
050615,奇力新元大95購03,0,0,0,0,0,0,0,0,0,30000,0,0,0,81000,51000,30000,30000
048019,GIS麥證94購01   ,0,0,0,30000,0,30000,0,0,0,30000,0,0,0,30000,0,30000,30000
051353,聯發科元大95購08,0,0,0,0,0,0,0,0,0,30000,0,0,0,40000,10000,30000,30000
051295,國巨元富95購04  ,0,0,0,0,0,0,0,0,0,30000,0,0,0,30000,0,30000,30000
050183,奇鋐元大96購01  ,0,0,0,0,0,0,0,0,0,30000,0,0,0,30000,0,30000,30000
050544,聯發科凱基95購02,0,0,0,0,0,0,0,0,0,30000,0,0,0,40000,10000,30000,30000
050520,凌陽元大94購02  ,0,0,0,0,0,0,0,0,0,30000,0,0,0,30000,0,30000,30000
048693,GIS群益94購02   ,0,0,0,0,0,0,0,0,0,30000,0,0,0,30000,0,30000,30000
050993,聯發科元大95購05,0,0,0,0,0,0,0,0,0,30000,0,0,0,30000,0,30000,30000
051007,台光電麥證95購01,0,0,0,40000,10000,30000,0,0,0,30000,0,0,0,40000,10000,30000,30000
051004,台新金中信95購02,0,0,0,0,0,0,0,0,0,30000,0,0,0,30000,0,30000,30000
050979,鴻海元富96購02  ,0,0,0,0,0,0,0,0,0,30000,0,0,0,30000,0,30000,30000
049228,台塑富邦94購01  ,0,0,0,0,0,0,0,0,0,30000,0,0,0,50000,20000,30000,30000
049177,美律凱基94購02  ,0,0,0,0,0,0,0,0,0,30000,0,0,0,30000,0,30000,30000
049301,致新群益95購01  ,0,0,0,0,0,0,0,0,0,30000,0,0,0,30000,0,30000,30000
052843,鴻海統一96購09  ,0,0,0,0,0,0,0,0,0,30000,0,0,0,30000,0,30000,30000
052559,茂林國票97購01  ,0,0,0,0,0,0,0,0,0,30000,0,0,0,60000,30000,30000,30000
05287P,鴻海元富95售09  ,0,0,0,0,0,0,0,0,0,30000,0,0,0,45000,15000,30000,30000
053056,同欣電國票97購01,0,0,0,0,0,0,0,0,0,30000,0,0,0,30000,0,30000,30000
053115,滬深2X中信97購01,0,0,0,0,0,0,0,0,0,30000,0,0,0,60000,30000,30000,30000
052278,國巨凱基95購06  ,0,0,0,0,0,0,0,0,0,30000,0,0,0,30000,0,30000,30000
052447,聯發科元大96購04,0,0,0,0,0,0,0,0,0,30000,0,0,0,70000,40000,30000,30000
051987,廣達元大95購01  ,0,0,0,0,0,0,0,0,0,30000,0,0,0,76000,46000,30000,30000
051976,淘帝凱基95購01  ,0,0,0,0,0,0,0,0,0,30000,0,0,0,30000,0,30000,30000
052078,大立光元富95購10,0,0,0,0,0,0,0,0,0,30000,0,0,0,30000,0,30000,30000
05179P,大立光凱基96售06,0,0,0,0,0,0,0,0,0,30000,0,0,0,136000,106000,30000,30000
051818,國巨統一95購02  ,0,0,0,0,0,0,0,0,0,30000,0,0,0,30000,0,30000,30000
053517,崇越群益97購01  ,0,0,0,0,0,0,0,0,0,30000,0,0,0,38000,8000,30000,30000
053459,康控國泰97購01  ,0,0,0,0,0,0,0,0,0,30000,0,0,0,80000,50000,30000,30000
053795,群創亞東96購01  ,0,0,0,0,0,0,0,0,0,30000,0,0,0,30000,0,30000,30000
054112,台積電麥證96購02,0,0,0,30000,0,30000,0,0,0,30000,0,0,0,30000,0,30000,30000
054239,台郡群益96購02  ,0,0,0,0,0,0,0,0,0,30000,0,0,0,30000,0,30000,30000
054208,台積電國票97購07,0,0,0,0,0,0,0,0,0,30000,0,0,0,44000,14000,30000,30000
06059P,泰碩元大97售02  ,0,0,0,0,0,0,0,0,0,30000,0,0,0,40000,10000,30000,30000
055331,國巨兆豐99購01  ,0,0,0,0,0,0,0,0,0,29000,0,0,0,29000,0,29000,29000
055138,大毅永豐97購02  ,0,0,0,0,0,0,0,0,0,29000,0,0,0,133000,104000,29000,29000
054732,台化凱基98購01  ,0,0,0,0,0,0,0,0,0,29000,0,0,0,29000,0,29000,29000
05848P,臺股指元大96售24,0,0,0,0,0,0,0,0,0,29000,0,0,0,83000,54000,29000,29000
056524,欣興中信98購02  ,0,0,0,0,0,0,0,0,0,29000,0,0,0,39000,10000,29000,29000
056408,奇鋐國票99購01  ,0,0,0,0,0,0,0,0,0,29000,0,0,0,29000,0,29000,29000
056317,華通群益99購02  ,0,0,0,0,0,0,0,0,0,29000,0,0,0,60000,31000,29000,29000
056190,昇陽半統一97購01,0,0,0,0,0,0,0,0,0,29000,0,0,0,85000,56000,29000,29000
056243,創意群益97購03  ,0,0,0,0,0,0,0,0,0,29000,0,0,0,49000,20000,29000,29000
00678,群益NBI生技     ,0,0,0,0,0,0,0,0,0,29000,0,0,0,31000,2000,29000,29000
047637,旺宏元大94購03  ,0,0,0,0,0,0,0,0,0,29000,0,0,0,261000,232000,29000,29000
046861,和碩元大93購01  ,0,0,0,0,0,0,0,0,0,29000,0,0,0,29000,0,29000,29000
045907,鴻海中信94購02  ,0,0,0,0,0,0,0,0,0,29000,0,0,0,41000,12000,29000,29000
047293,全新元富93購03  ,0,0,0,0,0,0,0,0,0,29000,0,0,0,30000,1000,29000,29000
048494,瑞昱元大93購13  ,0,0,0,0,0,0,0,0,0,29000,0,0,0,121000,92000,29000,29000
048336,光磊元大93購02  ,0,0,0,0,0,0,0,0,0,29000,0,0,0,87000,58000,29000,29000
048892,台郡元富97購01  ,0,0,0,0,0,0,0,0,0,29000,0,0,0,29000,0,29000,29000
054357,可成兆豐97購02  ,0,0,0,0,0,0,0,0,0,29000,0,0,0,32000,3000,29000,29000
053982,臻鼎元大96購05  ,0,0,0,0,0,0,0,0,0,29000,0,0,0,101000,72000,29000,29000
053492,華邦電兆豐97購01,0,0,0,0,0,0,0,0,0,29000,0,0,0,49000,20000,29000,29000
053237,揚明光永豐96購03,0,0,0,0,0,0,0,0,0,29000,0,0,0,41000,12000,29000,29000
05323P,瑞昱凱基96售02  ,0,0,0,0,0,0,0,0,0,29000,0,0,0,50000,21000,29000,29000
052700,奇鋐國票97購02  ,0,0,0,0,0,0,0,0,0,29000,0,0,0,34000,5000,29000,29000
06067P,華新科康和97售01,0,0,0,0,0,0,0,0,0,29000,0,0,0,39000,10000,29000,29000
06104P,大立光凱基97售04,0,0,0,0,0,0,0,0,0,29000,0,0,0,30000,1000,29000,29000
2390,云辰            ,251000,222000,29000,0,0,0,0,0,0,0,0,0,0,0,0,0,29000
056430,鴻海凱基98購06  ,0,0,0,0,0,0,0,0,0,28000,0,0,0,100000,72000,28000,28000
055988,矽力元富97購01  ,0,0,0,0,0,0,0,0,0,28000,0,0,0,34000,6000,28000,28000
056449,義隆凱基98購03  ,0,0,0,0,0,0,0,0,0,28000,0,0,0,150000,122000,28000,28000
05906P,國巨元富96售05  ,0,0,0,0,0,0,0,0,0,28000,0,0,0,80000,52000,28000,28000
054714,和鑫台新98購01  ,0,0,0,0,0,0,0,0,0,28000,0,0,0,66000,38000,28000,28000
054651,台化麥證97購01  ,0,0,0,33000,5000,28000,0,0,0,28000,0,0,0,33000,5000,28000,28000
055178,晶豪科統一97購01,0,0,0,0,0,0,0,0,0,28000,0,0,0,28000,0,28000,28000
055214,聯電凱基97購02  ,0,0,0,0,0,0,0,0,0,28000,0,0,0,83000,55000,28000,28000
047182,智邦元大93購07  ,0,0,0,0,0,0,0,0,0,28000,0,0,0,40000,12000,28000,28000
048540,百和國票93購01  ,0,0,0,0,0,0,0,0,0,28000,0,0,0,38000,10000,28000,28000
04597P,為升凱基94售02  ,0,0,0,0,0,0,0,0,0,28000,0,0,0,60000,32000,28000,28000
046802,聯電元大93購01  ,0,0,0,0,0,0,0,0,0,28000,0,0,0,38000,10000,28000,28000
045586,創意元大93購03  ,0,0,0,0,0,0,0,0,0,28000,0,0,0,128000,100000,28000,28000
00688L,國泰20年美債正2 ,0,0,0,0,0,0,0,0,0,28000,0,0,0,168000,140000,28000,28000
047568,創意國票93購03  ,0,0,0,0,0,0,0,0,0,28000,0,0,0,38000,10000,28000,28000
049003,智邦中信95購01  ,0,0,0,0,0,0,0,0,0,28000,0,0,0,46000,18000,28000,28000
048784,台積電元大94購04,0,0,0,0,0,0,0,0,0,28000,0,0,0,212000,184000,28000,28000
050800,百和中信95購01  ,0,0,0,0,0,0,0,0,0,28000,0,0,0,28000,0,28000,28000
050838,為升國票96購01  ,0,0,0,0,0,0,0,0,0,28000,0,0,0,65000,37000,28000,28000
051127,同欣電群益95購01,0,0,0,0,0,0,0,0,0,28000,0,0,0,66000,38000,28000,28000
05116P,台積電群益95售03,0,0,0,0,0,0,0,0,0,28000,0,0,0,68000,40000,28000,28000
05268P,玉晶光元大98售01,0,0,0,0,0,0,0,0,0,28000,0,0,0,128000,100000,28000,28000
053012,國巨統一96購03  ,0,0,0,0,0,0,0,0,0,28000,0,0,0,28000,0,28000,28000
052016,神基永豐95購01  ,0,0,0,0,0,0,0,0,0,28000,0,0,0,36000,8000,28000,28000
053380,南亞科元大97購01,0,0,0,0,0,0,0,0,0,28000,0,0,0,87000,59000,28000,28000
053789,彩晶元大9C購02  ,0,0,0,0,0,0,0,0,0,28000,0,0,0,31000,3000,28000,28000
053755,亞光元富96購01  ,0,0,0,0,0,0,0,0,0,28000,0,0,0,38000,10000,28000,28000
054111,緯穎凱基97購01  ,0,0,0,0,0,0,0,0,0,28000,0,0,0,35000,7000,28000,28000
055361,樺漢凱基97購01  ,0,0,0,0,0,0,0,0,0,27000,0,0,0,27000,0,27000,27000
054770,健策國票98購01  ,0,0,0,0,0,0,0,0,0,27000,0,0,0,169000,142000,27000,27000
056508,揚明光永豐98購01,0,0,0,0,0,0,0,0,0,27000,0,0,0,27000,0,27000,27000
056340,可成凱基98購04  ,0,0,0,0,0,0,0,0,0,27000,0,0,0,27000,0,27000,27000
056347,GIS凱基9A購01   ,0,0,0,0,0,0,0,0,0,27000,0,0,0,47000,20000,27000,27000
056189,樺漢統一97購02  ,0,0,0,0,0,0,0,0,0,27000,0,0,0,127000,100000,27000,27000
046578,聯電元大92購01  ,0,0,0,0,0,0,0,0,0,27000,0,0,0,37000,10000,27000,27000
044526,訊芯凱基93購02  ,0,0,0,0,0,0,0,0,0,27000,0,0,0,27000,0,27000,27000
040760,T50反1凱基95購01,0,0,0,0,0,0,0,0,0,27000,0,0,0,70000,43000,27000,27000
047788,欣興群益93購05  ,0,0,0,0,0,0,0,0,0,27000,0,0,0,969000,942000,27000,27000
045906,鴻海中信94購01  ,0,0,0,0,0,0,0,0,0,27000,0,0,0,27000,0,27000,27000
046330,祥碩元大92購02  ,0,0,0,0,0,0,0,0,0,27000,0,0,0,27000,0,27000,27000
048754,瀚宇博元富97購01,0,0,0,0,0,0,0,0,0,27000,0,0,0,27000,0,27000,27000
050784,美律國泰96購01  ,0,0,0,0,0,0,0,0,0,27000,0,0,0,170000,143000,27000,27000
048450,聯詠凱基93購09  ,0,0,0,0,0,0,0,0,0,27000,0,0,0,104000,77000,27000,27000
049777,華新科統一94購06,0,0,0,0,0,0,0,0,0,27000,0,0,0,27000,0,27000,27000
048270,T50反1富邦99購01,0,0,0,0,0,0,0,0,0,27000,0,0,0,27000,0,27000,27000
048221,鴻海凱基95購01  ,0,0,0,0,0,0,0,0,0,27000,0,0,0,57000,30000,27000,27000
051257,光寶科國泰96購01,0,0,0,0,0,0,0,0,0,27000,0,0,0,27000,0,27000,27000
051365,瀚宇博國泰97購01,0,0,0,0,0,0,0,0,0,27000,0,0,0,27000,0,27000,27000
050340,鴻海統一94購07  ,0,0,0,0,0,0,0,0,0,27000,0,0,0,27000,0,27000,27000
051985,智邦元大95購05  ,0,0,0,0,0,0,0,0,0,27000,0,0,0,205000,178000,27000,27000
051761,富邦金元大96購01,0,0,0,0,0,0,0,0,0,27000,0,0,0,27000,0,27000,27000
052772,台虹群益96購01  ,0,0,0,0,0,0,0,0,0,27000,0,0,0,27000,0,27000,27000
06218P,鴻海元富97售06  ,0,0,0,0,0,0,0,0,0,27000,0,0,0,29000,2000,27000,27000
06242P,大立光元富9A售02,0,0,0,0,0,0,0,0,0,27000,0,0,0,29000,2000,27000,27000
06417P,台積電兆豐97售03,0,0,0,0,0,0,0,0,0,27000,0,0,0,41000,14000,27000,27000
056387,智伸科國泰99購01,0,0,0,0,0,0,0,0,0,26000,0,0,0,26000,0,26000,26000
05675P,美律群益97售01  ,0,0,0,0,0,0,0,0,0,26000,0,0,0,61000,35000,26000,26000
054759,台化國票98購01  ,0,0,0,0,0,0,0,0,0,26000,0,0,0,26000,0,26000,26000
054804,南亞元大9A購01  ,0,0,0,0,0,0,0,0,0,26000,0,0,0,26000,0,26000,26000
055143,臻鼎永豐97購01  ,0,0,0,0,0,0,0,0,0,26000,0,0,0,94000,68000,26000,26000
055140,晶相光永豐97購01,0,0,0,0,0,0,0,0,0,26000,0,0,0,26000,0,26000,26000
055104,台達電凱基98購01,0,0,0,0,0,0,0,0,0,26000,0,0,0,76000,50000,26000,26000
054986,藍天元富97購01  ,0,0,0,0,0,0,0,0,0,26000,0,0,0,50000,24000,26000,26000
055407,祥碩國泰98購01  ,0,0,0,0,0,0,0,0,0,26000,0,0,0,26000,0,26000,26000
055255,欣興統一97購02  ,0,0,0,0,0,0,0,0,0,26000,0,0,0,55000,29000,26000,26000
055761,創意群益97購01  ,0,0,0,0,0,0,0,0,0,26000,0,0,0,104000,78000,26000,26000
055592,奇力新元大97購07,0,0,0,0,0,0,0,0,0,26000,0,0,0,156000,130000,26000,26000
047322,日月光元大93購04,0,0,0,0,0,0,0,0,0,26000,0,0,0,36000,10000,26000,26000
046955,康舒國票93購01  ,0,0,0,0,0,0,0,0,0,26000,0,0,0,26000,0,26000,26000
046889,燿華群益93購02  ,0,0,0,0,0,0,0,0,0,26000,0,0,0,26000,0,26000,26000
00674R,元大S&P黃金反1  ,0,8000,-8000,0,0,0,0,0,0,34000,0,0,0,34000,0,34000,26000
046569,同欣電元富92購02,0,0,0,0,0,0,0,0,0,26000,0,0,0,26000,0,26000,26000
04746P,臺股指元大94售17,0,0,0,0,0,0,0,0,0,26000,0,0,0,26000,0,26000,26000
049901,瑞昱元富94購01  ,0,0,0,0,0,0,0,0,0,26000,0,0,0,26000,0,26000,26000
051415,晶技國票96購01  ,0,0,0,0,0,0,0,0,0,26000,0,0,0,37000,11000,26000,26000
051413,富邦金國票96購02,0,0,0,0,0,0,0,0,0,26000,0,0,0,38000,12000,26000,26000
051662,大立光永昌96購03,0,0,0,0,0,0,0,0,0,26000,0,0,0,27000,1000,26000,26000
04821P,臺股指永豐94售01,0,0,0,0,0,0,0,0,0,26000,0,0,0,40000,14000,26000,26000
048055,燿華國泰95購02  ,0,0,0,0,0,0,0,0,0,26000,0,0,0,26000,0,26000,26000
048828,禾伸堂凱基94購02,0,0,0,0,0,0,0,0,0,26000,0,0,0,27000,1000,26000,26000
048837,牧德凱基94購04  ,0,0,0,0,0,0,0,0,0,26000,0,0,0,26000,0,26000,26000
050529,矽格元大94購05  ,0,0,0,0,0,0,0,0,0,26000,0,0,0,26000,0,26000,26000
052776,力山國票97購01  ,0,0,0,0,0,0,0,0,0,26000,0,0,0,36000,10000,26000,26000
052693,微星中信96購01  ,0,0,0,0,0,0,0,0,0,26000,0,0,0,36000,10000,26000,26000
052778,智原國票97購01  ,0,0,0,0,0,0,0,0,0,26000,0,0,0,46000,20000,26000,26000
052663,奇鋐國票97購01  ,0,0,0,0,0,0,0,0,0,26000,0,0,0,76000,50000,26000,26000
053158,茂林元大96購01  ,0,0,0,0,0,0,0,0,0,26000,0,0,0,78000,52000,26000,26000
052099,臺股指富邦95購02,0,0,0,0,0,0,0,0,0,26000,0,0,0,51000,25000,26000,26000
052237,嘉澤國票96購02  ,0,0,0,0,0,0,0,0,0,26000,0,0,0,26000,0,26000,26000
05448P,臺股指元大95售25,0,0,0,0,0,0,0,0,0,26000,0,0,0,26000,0,26000,26000
053689,台光電元大96購01,0,0,0,0,0,0,0,0,0,26000,0,0,0,26000,0,26000,26000
053271,喬山元大97購01  ,0,0,0,0,0,0,0,0,0,26000,0,0,0,32000,6000,26000,26000
055173,瑞昱統一97購01  ,0,0,0,0,0,0,0,0,0,25000,0,0,0,35000,10000,25000,25000
054668,傳奇元富97購03  ,0,0,0,0,0,0,0,0,0,25000,0,0,0,25000,0,25000,25000
05753P,臺股指中信99售02,0,0,0,0,0,0,0,0,0,25000,0,0,0,30000,5000,25000,25000
047490,元油反統一93購01,0,0,0,0,0,0,0,0,0,25000,0,0,0,25000,0,25000,25000
04327P,台積電國泰95售01,0,0,0,0,0,0,0,0,0,25000,0,0,0,491000,466000,25000,25000
03945P,欣興群益94售01  ,0,0,0,0,0,0,0,0,0,25000,0,0,0,25000,0,25000,25000
044563,亞德客凱基92購01,0,0,0,0,0,0,0,0,0,25000,0,0,0,45000,20000,25000,25000
047376,南電國票94購01  ,0,0,0,0,0,0,0,0,0,25000,0,0,0,90000,65000,25000,25000
046831,大立光群益94購01,0,0,0,0,0,0,0,0,0,25000,0,0,0,25000,0,25000,25000
04669P,臺股指國票94售08,0,0,0,0,0,0,0,0,0,25000,0,0,0,25000,0,25000,25000
045393,寶齡國泰93購01  ,0,0,0,0,0,0,0,0,0,25000,0,0,0,25000,0,25000,25000
049688,台光電元大94購04,0,0,0,0,0,0,0,0,0,25000,0,0,0,25000,0,25000,25000
051150,宏達電凱基95購02,0,0,0,0,0,0,0,0,0,25000,0,0,0,25000,0,25000,25000
050814,微星凱基95購01  ,0,0,0,0,0,0,0,0,0,25000,0,0,0,40000,15000,25000,25000
050848,日月光國票95購01,0,0,0,0,0,0,0,0,0,25000,0,0,0,346000,321000,25000,25000
048169,瑞昱永豐93購02  ,0,0,0,0,0,0,0,0,0,25000,0,0,0,25000,0,25000,25000
051480,大立光凱基97購01,0,0,0,0,0,0,0,0,0,25000,0,0,0,30000,5000,25000,25000
050670,牧德永豐94購03  ,0,0,0,0,0,0,0,0,0,25000,0,0,0,45000,20000,25000,25000
05020P,廣達中信95售01  ,0,0,0,0,0,0,0,0,0,25000,0,0,0,40000,15000,25000,25000
050218,世紀鋼統一94購02,0,0,0,0,0,0,0,0,0,25000,0,0,0,30000,5000,25000,25000
050255,GIS富邦95購01   ,0,0,0,0,0,0,0,0,0,25000,0,0,0,40000,15000,25000,25000
049948,聯發科麥證94購01,0,0,0,30000,5000,25000,0,0,0,25000,0,0,0,30000,5000,25000,25000
053748,燿華永豐96購04  ,0,0,0,0,0,0,0,0,0,25000,0,0,0,37000,12000,25000,25000
054470,緯穎國票97購04  ,0,0,0,0,0,0,0,0,0,25000,0,0,0,35000,10000,25000,25000
05441P,華通元大95售09  ,0,0,0,0,0,0,0,0,0,25000,0,0,0,25000,0,25000,25000
05407P,超眾凱基95售04  ,0,0,0,0,0,0,0,0,0,25000,0,0,0,25000,0,25000,25000
052164,啟碁永豐95購01  ,0,0,0,0,0,0,0,0,0,25000,0,0,0,50000,25000,25000,25000
051776,上証2X群益99購01,0,0,0,0,0,0,0,0,0,25000,0,0,0,25000,0,25000,25000
052887,華通中信96購01  ,0,0,0,0,0,0,0,0,0,25000,0,0,0,55000,30000,25000,25000
06448P,華通元大99售01  ,0,0,0,0,0,0,0,0,0,25000,0,0,0,70000,45000,25000,25000
06177P,玉晶光元大98售07,0,0,0,0,0,0,0,0,0,25000,0,0,0,39000,14000,25000,25000
06209P,旺宏統一97售07  ,0,0,0,0,0,0,0,0,0,25000,0,0,0,35000,10000,25000,25000
06333P,臺股指群益9C售02,0,0,0,0,0,0,0,0,0,25000,0,0,0,25000,0,25000,25000
05824P,臺股指凱基96售21,0,0,0,0,0,0,0,0,0,24000,0,0,0,26000,2000,24000,24000
055943,瑞昱麥證97購01  ,0,0,0,100000,76000,24000,0,0,0,24000,0,0,0,100000,76000,24000,24000
054749,聯茂凱基98購01  ,0,0,0,0,0,0,0,0,0,24000,0,0,0,24000,0,24000,24000
046302,亞德客元大92購02,0,0,0,0,0,0,0,0,0,24000,0,0,0,24000,0,24000,24000
046241,聯發科中信94購02,0,0,0,0,0,0,0,0,0,24000,0,0,0,264000,240000,24000,24000
045717,微星凱基92購03  ,0,0,0,0,0,0,0,0,0,24000,0,0,0,24000,0,24000,24000
047385,華邦電元大94購02,0,0,0,0,0,0,0,0,0,24000,0,0,0,44000,20000,24000,24000
046896,臻鼎群益94購01  ,0,0,0,0,0,0,0,0,0,24000,0,0,0,85000,61000,24000,24000
046974,上銀台新93購01  ,0,0,0,0,0,0,0,0,0,24000,0,0,0,24000,0,24000,24000
047019,台積電元大93購14,0,0,0,0,0,0,0,0,0,24000,0,0,0,24000,0,24000,24000
049453,新日興統一94購01,0,0,0,0,0,0,0,0,0,24000,0,0,0,34000,10000,24000,24000
049494,華新科元大95購05,0,0,0,0,0,0,0,0,0,24000,0,0,0,26000,2000,24000,24000
041206,樺漢統一92購01  ,0,0,0,0,0,0,0,0,0,24000,0,0,0,24000,0,24000,24000
049978,瑞昱凱基94購04  ,0,0,0,0,0,0,0,0,0,24000,0,0,0,24000,0,24000,24000
049999,義隆永豐94購01  ,0,0,0,0,0,0,0,0,0,24000,0,0,0,70000,46000,24000,24000
050033,日月光元大94購01,0,0,0,0,0,0,0,0,0,24000,0,0,0,48000,24000,24000,24000
049028,麗豐群益94購01  ,0,0,0,0,0,0,0,0,0,24000,0,0,0,24000,0,24000,24000
051642,鈺齊台新95購01  ,0,0,0,0,0,0,0,0,0,24000,0,0,0,24000,0,24000,24000
048052,力成中信93購01  ,0,0,0,0,0,0,0,0,0,24000,0,0,0,84000,60000,24000,24000
048040,百和凱基93購07  ,0,0,0,0,0,0,0,0,0,24000,0,0,0,24000,0,24000,24000
049735,台光電群益94購03,0,0,0,0,0,0,0,0,0,24000,0,0,0,74000,50000,24000,24000
049804,華固元大94購01  ,0,0,0,0,0,0,0,0,0,24000,0,0,0,92000,68000,24000,24000
050974,大成鋼統一95購01,0,0,0,0,0,0,0,0,0,24000,0,0,0,24000,0,24000,24000
049690,義隆元大95購02  ,0,0,0,0,0,0,0,0,0,24000,0,0,0,26000,2000,24000,24000
048684,上海銀富邦93購02,0,0,0,0,0,0,0,0,0,24000,0,0,0,24000,0,24000,24000
052525,聯詠元大95購06  ,0,0,0,0,0,0,0,0,0,24000,0,0,0,181000,157000,24000,24000
051791,智伸科國票96購01,0,0,0,0,0,0,0,0,0,24000,0,0,0,62000,38000,24000,24000
052208,力成麥證95購01  ,0,0,0,74000,50000,24000,0,0,0,24000,0,0,0,74000,50000,24000,24000
053989,奇力新兆豐97購01,0,0,0,0,0,0,0,0,0,24000,0,0,0,80000,56000,24000,24000
053635,技嘉永豐96購01  ,0,0,0,0,0,0,0,0,0,24000,0,0,0,80000,56000,24000,24000
053545,上銀凱基96購03  ,0,0,0,0,0,0,0,0,0,24000,0,0,0,69000,45000,24000,24000
053541,泰鼎永豐96購02  ,0,0,0,0,0,0,0,0,0,24000,0,0,0,84000,60000,24000,24000
06227P,大立光群益97售04,0,0,0,0,0,0,0,0,0,24000,0,0,0,51000,27000,24000,24000
1731,美吾華          ,100000,75000,25000,0,0,0,0,0,0,-1000,0,1000,-1000,0,0,0,24000
054795,合勤控群益98購01,0,0,0,0,0,0,0,0,0,23000,0,0,0,121000,98000,23000,23000
054745,智易凱基97購01  ,0,0,0,0,0,0,0,0,0,23000,0,0,0,23000,0,23000,23000
054594,國巨麥證97購01  ,0,0,0,30000,7000,23000,0,0,0,23000,0,0,0,30000,7000,23000,23000
055595,宏達電元大98購02,0,0,0,0,0,0,0,0,0,23000,0,0,0,23000,0,23000,23000
056367,祥碩元大98購01  ,0,0,0,0,0,0,0,0,0,23000,0,0,0,92000,69000,23000,23000
056483,TPK元大98購01   ,0,0,0,0,0,0,0,0,0,23000,0,0,0,33000,10000,23000,23000
044407,聯茂凱基93購01  ,0,0,0,0,0,0,0,0,0,23000,0,0,0,23000,0,23000,23000
050451,嘉晶元大95購01  ,0,0,0,0,0,0,0,0,0,23000,0,0,0,53000,30000,23000,23000
045684,和碩元大92購02  ,0,0,0,0,0,0,0,0,0,23000,0,0,0,23000,0,23000,23000
045830,亞德客群益92購02,0,0,0,0,0,0,0,0,0,23000,0,0,0,33000,10000,23000,23000
046039,新日興元大92購02,0,0,0,0,0,0,0,0,0,23000,0,0,0,33000,10000,23000,23000
04971P,矽力元富94售02  ,0,0,0,0,0,0,0,0,0,23000,0,0,0,173000,150000,23000,23000
049607,台積電兆豐94購04,0,0,0,0,0,0,0,0,0,23000,0,0,0,50000,27000,23000,23000
048123,大立光元大93購27,0,0,0,0,0,0,0,0,0,23000,0,0,0,23000,0,23000,23000
048849,光寶科群益94購01,0,0,0,0,0,0,0,0,0,23000,0,0,0,23000,0,23000,23000
048901,矽格國泰95購01  ,0,0,0,0,0,0,0,0,0,23000,0,0,0,73000,50000,23000,23000
053636,全新永豐96購02  ,0,0,0,0,0,0,0,0,0,23000,0,0,0,68000,45000,23000,23000
053895,智易群益96購02  ,0,0,0,0,0,0,0,0,0,23000,0,0,0,23000,0,23000,23000
054085,華新科統一96購04,0,0,0,0,0,0,0,0,0,23000,0,0,0,43000,20000,23000,23000
054181,華新康和96購01  ,0,0,0,0,0,0,0,0,0,23000,0,0,0,23000,0,23000,23000
054176,亞光台新96購01  ,0,0,0,0,0,0,0,0,0,23000,0,0,0,23000,0,23000,23000
054245,鴻海元大96購23  ,0,0,0,0,0,0,0,0,0,23000,0,0,0,63000,40000,23000,23000
052370,滬深2X元大95購04,0,0,0,0,0,0,0,0,0,23000,0,0,0,23000,0,23000,23000
052640,台表科凱基97購01,0,0,0,0,0,0,0,0,0,23000,0,0,0,23000,0,23000,23000
052623,台郡兆豐96購01  ,0,0,0,0,0,0,0,0,0,23000,0,0,0,38000,15000,23000,23000
052694,開發金中信98購01,0,0,0,0,0,0,0,0,0,23000,0,0,0,23000,0,23000,23000
053044,南茂凱基96購02  ,0,0,0,0,0,0,0,0,0,23000,0,0,0,23000,0,23000,23000
06291P,臺股指國票97售05,0,0,0,0,0,0,0,0,0,23000,0,0,0,23000,0,23000,23000
06120P,大立光凱基98售05,0,0,0,0,0,0,0,0,0,23000,0,0,0,65000,42000,23000,23000
2481,強茂            ,370800,323000,47800,0,0,0,0,0,0,-25000,0,0,0,38000,63000,-25000,22800
056577,玉晶光元大99購06,0,0,0,0,0,0,0,0,0,22000,0,0,0,74000,52000,22000,22000
056610,鴻海永豐98購01  ,0,0,0,0,0,0,0,0,0,22000,0,0,0,522000,500000,22000,22000
05682P,大立光元大98售03,0,0,0,0,0,0,0,0,0,22000,0,0,0,144000,122000,22000,22000
056145,緯穎元大98購03  ,0,0,0,0,0,0,0,0,0,22000,0,0,0,66000,44000,22000,22000
056128,和大中信99購01  ,0,0,0,0,0,0,0,0,0,22000,0,0,0,102000,80000,22000,22000
055899,群創中信99購01  ,0,0,0,0,0,0,0,0,0,22000,0,0,0,22000,0,22000,22000
055174,精元統一97購01  ,0,0,0,0,0,0,0,0,0,22000,0,0,0,22000,0,22000,22000
054650,南亞麥證97購01  ,0,0,0,52000,30000,22000,0,0,0,22000,0,0,0,52000,30000,22000,22000
055000,玉晶光元富97購04,0,0,0,0,0,0,0,0,0,22000,0,0,0,22000,0,22000,22000
054842,台達電兆豐98購01,0,0,0,0,0,0,0,0,0,22000,0,0,0,32000,10000,22000,22000
046828,聯發科群益94購01,0,0,0,0,0,0,0,0,0,22000,0,0,0,22000,0,22000,22000
047753,景碩元富93購01  ,0,0,0,0,0,0,0,0,0,22000,0,0,0,22000,0,22000,22000
046921,日電貿永豐93購01,0,0,0,0,0,0,0,0,0,22000,0,0,0,22000,0,22000,22000
047910,全新麥證94購01  ,0,0,0,22000,0,22000,0,0,0,22000,0,0,0,22000,0,22000,22000
044966,台表科中信94購01,0,0,0,0,0,0,0,0,0,22000,0,0,0,32000,10000,22000,22000
048902,昇陽半國泰96購01,0,0,0,0,0,0,0,0,0,22000,0,0,0,92000,70000,22000,22000
049998,奇力新永豐94購03,0,0,0,0,0,0,0,0,0,22000,0,0,0,33000,11000,22000,22000
050560,聯詠統一94購02  ,0,0,0,0,0,0,0,0,0,22000,0,0,0,187000,165000,22000,22000
051377,鴻海群益95購07  ,0,0,0,0,0,0,0,0,0,22000,0,0,0,22000,0,22000,22000
051313,緯創麥證95購02  ,0,0,0,42000,20000,22000,0,0,0,22000,0,0,0,42000,20000,22000,22000
048427,百和元富95購01  ,0,0,0,0,0,0,0,0,0,22000,0,0,0,22000,0,22000,22000
051236,鴻海元大96購05  ,0,0,0,0,0,0,0,0,0,22000,0,0,0,22000,0,22000,22000
048842,矽格凱基94購01  ,0,0,0,0,0,0,0,0,0,22000,0,0,0,22000,0,22000,22000
050500,台積電凱基94購36,0,0,0,0,0,0,0,0,0,22000,0,0,0,22000,0,22000,22000
050797,聯發科中信99購01,0,0,0,0,0,0,0,0,0,22000,0,0,0,88000,66000,22000,22000
049539,元油2X群益9A購01,5000,0,5000,0,0,0,0,0,0,17000,0,0,0,269000,252000,17000,22000
052910,鴻海統一96購10  ,0,0,0,0,0,0,0,0,0,22000,0,0,0,22000,0,22000,22000
052761,可成群益96購02  ,0,0,0,0,0,0,0,0,0,22000,0,0,0,22000,0,22000,22000
052270,力成日盛95購01  ,0,0,0,0,0,0,0,0,0,22000,0,0,0,22000,0,22000,22000
05229P,台積電群益95售05,0,0,0,0,0,0,0,0,0,22000,0,0,0,97000,75000,22000,22000
054275,華通群益97購03  ,0,0,0,0,0,0,0,0,0,22000,0,0,0,22000,0,22000,22000
054277,亞光群益97購01  ,0,0,0,0,0,0,0,0,0,22000,0,0,0,22000,0,22000,22000
054458,復盛群益96購01  ,0,0,0,0,0,0,0,0,0,22000,0,0,0,37000,15000,22000,22000
053697,臻鼎元大96購02  ,0,0,0,0,0,0,0,0,0,22000,0,0,0,91000,69000,22000,22000
053600,同欣電元大96購04,0,0,0,0,0,0,0,0,0,22000,0,0,0,52000,30000,22000,22000
053325,GIS群益96購02   ,0,0,0,0,0,0,0,0,0,22000,0,0,0,22000,0,22000,22000
2109,華豐            ,56000,36000,20000,0,0,0,0,0,0,2000,2000,0,2000,0,0,0,22000
06107P,美律群益98售02  ,0,0,0,0,0,0,0,0,0,22000,0,0,0,32000,10000,22000,22000
06135P,志超元富97售01  ,0,0,0,0,0,0,0,0,0,22000,0,0,0,22000,0,22000,22000
06131P,京鼎元富97售02  ,0,0,0,0,0,0,0,0,0,22000,0,0,0,30000,8000,22000,22000
06331P,南亞科群益97售04,0,0,0,0,0,0,0,0,0,22000,0,0,0,25000,3000,22000,22000
054571,楠梓電元大99購01,0,0,0,0,0,0,0,0,0,21000,0,0,0,300000,279000,21000,21000
054812,鴻海元大97購08  ,0,0,0,0,0,0,0,0,0,21000,0,0,0,422000,401000,21000,21000
055526,台積電群益97購02,0,0,0,0,0,0,0,0,0,21000,0,0,0,21000,0,21000,21000
055920,智伸科凱基97購02,0,0,0,0,0,0,0,0,0,21000,0,0,0,21000,0,21000,21000
055985,聯鈞元富97購01  ,0,0,0,0,0,0,0,0,0,21000,0,0,0,54000,33000,21000,21000
056272,嘉澤統一99購01  ,0,0,0,0,0,0,0,0,0,21000,0,0,0,250000,229000,21000,21000
056621,宏達電永豐98購01,0,0,0,0,0,0,0,0,0,21000,0,0,0,26000,5000,21000,21000
04235P,鴻海群益93售08  ,0,0,0,0,0,0,0,0,0,21000,0,0,0,41000,20000,21000,21000
047840,新日興元大93購03,0,0,0,0,0,0,0,0,0,21000,0,0,0,81000,60000,21000,21000
047246,華新科群益93購01,0,0,0,0,0,0,0,0,0,21000,0,0,0,22000,1000,21000,21000
048571,美利達元大96購03,0,0,0,0,0,0,0,0,0,21000,0,0,0,96000,75000,21000,21000
046979,台泥兆豐93購01  ,0,0,0,0,0,0,0,0,0,21000,0,0,0,21000,0,21000,21000
051097,嘉聯益元大96購02,0,0,0,0,0,0,0,0,0,21000,0,0,0,21000,0,21000,21000
048630,南亞元大93購01  ,0,0,0,0,0,0,0,0,0,21000,0,0,0,21000,0,21000,21000
048634,華通元大94購01  ,0,0,0,0,0,0,0,0,0,21000,0,0,0,82000,61000,21000,21000
050205,牧德群益94購02  ,0,0,0,0,0,0,0,0,0,21000,0,0,0,81000,60000,21000,21000
048769,聯鈞凱基94購01  ,0,0,0,0,0,0,0,0,0,21000,0,0,0,69000,48000,21000,21000
048191,亞德客元大93購06,0,0,0,0,0,0,0,0,0,21000,0,0,0,21000,0,21000,21000
048109,旺宏群益94購02  ,0,0,0,0,0,0,0,0,0,21000,0,0,0,21000,0,21000,21000
051348,國巨元大95購07  ,0,0,0,0,0,0,0,0,0,21000,0,0,0,21000,0,21000,21000
047973,華通兆豐94購01  ,0,0,0,0,0,0,0,0,0,21000,0,0,0,21000,0,21000,21000
051670,欣興元大95購06  ,0,0,0,0,0,0,0,0,0,21000,0,0,0,25000,4000,21000,21000
050341,光寶科元富94購01,0,0,0,0,0,0,0,0,0,21000,0,0,0,21000,0,21000,21000
048876,牧德國票95購02  ,0,0,0,0,0,0,0,0,0,21000,0,0,0,59000,38000,21000,21000
048974,日電貿元大94購01,0,0,0,0,0,0,0,0,0,21000,0,0,0,52000,31000,21000,21000
053490,為升兆豐97購01  ,0,0,0,0,0,0,0,0,0,21000,0,0,0,26000,5000,21000,21000
053712,台光電凱基96購04,0,0,0,0,0,0,0,0,0,21000,0,0,0,21000,0,21000,21000
05379P,可成凱基95售11  ,0,0,0,0,0,0,0,0,0,21000,0,0,0,31000,10000,21000,21000
054411,光磊元大97購02  ,0,0,0,0,0,0,0,0,0,21000,0,0,0,71000,50000,21000,21000
053937,光磊元富96購01  ,0,0,0,0,0,0,0,0,0,21000,0,0,0,21000,0,21000,21000
052220,T50反1凱基98購01,0,0,0,0,0,0,0,0,0,21000,0,0,0,21000,0,21000,21000
052943,奇力新國票96購02,0,0,0,0,0,0,0,0,0,21000,0,0,0,21000,0,21000,21000
06255P,臺股指群益97售08,0,0,0,0,0,0,0,0,0,21000,0,0,0,21000,0,21000,21000
06158P,玉晶光元富97售08,0,0,0,0,0,0,0,0,0,21000,0,0,0,49000,28000,21000,21000
06016P,京元電凱基96售03,0,0,0,0,0,0,0,0,0,21000,0,0,0,31000,10000,21000,21000
056709,華通永豐98購01  ,0,0,0,0,0,0,0,0,0,20000,0,0,0,63000,43000,20000,20000
05747P,漢唐群益96售03  ,0,0,0,0,0,0,0,0,0,20000,0,0,0,20000,0,20000,20000
05854P,華新科凱基96售09,0,0,0,0,0,0,0,0,0,20000,0,0,0,20000,0,20000,20000
05886P,華通元富96售01  ,0,0,0,0,0,0,0,0,0,20000,0,0,0,84000,64000,20000,20000
05930P,景碩康和96售01  ,0,0,0,0,0,0,0,0,0,20000,0,0,0,115000,95000,20000,20000
056330,玉晶光國票99購03,0,0,0,0,0,0,0,0,0,20000,0,0,0,20000,0,20000,20000
056441,燿華凱基98購01  ,0,0,0,0,0,0,0,0,0,20000,0,0,0,20000,0,20000,20000
056406,建準國票99購01  ,0,0,0,0,0,0,0,0,0,20000,0,0,0,25000,5000,20000,20000
056168,鴻海元富97購07  ,0,0,0,0,0,0,0,0,0,20000,0,0,0,20000,0,20000,20000
05589P,大立光中信9A售01,0,0,0,0,0,0,0,0,0,20000,0,0,0,20000,0,20000,20000
055624,聯發科富邦99購07,0,0,0,0,0,0,0,0,0,20000,0,0,0,130000,110000,20000,20000
055651,富邦金元富97購01,0,0,0,0,0,0,0,0,0,20000,0,0,0,40000,20000,20000,20000
05520P,聯詠凱基96售01  ,0,0,0,0,0,0,0,0,0,20000,0,0,0,20000,0,20000,20000
054762,奇力新國票99購01,0,0,0,0,0,0,0,0,0,20000,0,0,0,43000,23000,20000,20000
054740,強茂凱基99購01  ,0,0,0,0,0,0,0,0,0,20000,0,0,0,70000,50000,20000,20000
054661,嘉聯益元大97購03,0,0,0,0,0,0,0,0,0,20000,0,0,0,285000,265000,20000,20000
054936,鴻海元大97購10  ,0,0,0,0,0,0,0,0,0,20000,0,0,0,20000,0,20000,20000
055014,達興元富97購01  ,0,0,0,0,0,0,0,0,0,20000,0,0,0,20000,0,20000,20000
055032,億光富邦99購01  ,0,0,0,0,0,0,0,0,0,20000,0,0,0,83000,63000,20000,20000
055077,臺股指永豐97購02,0,0,0,0,0,0,0,0,0,20000,0,0,0,20000,0,20000,20000
050489,聯詠元富94購01  ,0,0,0,0,0,0,0,0,0,20000,0,0,0,30000,10000,20000,20000
050432,聯發科凱基94購19,0,0,0,0,0,0,0,0,0,20000,0,0,0,30000,10000,20000,20000
050737,聯詠康和94購01  ,0,0,0,0,0,0,0,0,0,20000,0,0,0,70000,50000,20000,20000
050672,上証2X富邦97購01,0,0,0,0,0,0,0,0,0,20000,0,0,0,20000,0,20000,20000
047299,樺漢元富93購01  ,0,0,0,0,0,0,0,0,0,20000,0,0,0,20000,0,20000,20000
047301,啟碁國泰94購01  ,0,0,0,0,0,0,0,0,0,20000,0,0,0,20000,0,20000,20000
047200,鴻海元富93購04  ,0,0,0,0,0,0,0,0,0,20000,0,0,0,159000,139000,20000,20000
047207,晶技國泰94購01  ,0,0,0,0,0,0,0,0,0,20000,0,0,0,30000,10000,20000,20000
047342,T50反1中信99購01,0,0,0,0,0,0,0,0,0,20000,0,0,0,20000,0,20000,20000
046731,嘉聯益元大93購03,0,0,0,0,0,0,0,0,0,20000,0,0,0,20000,0,20000,20000
046707,友達康和93購01  ,0,0,0,0,0,0,0,0,0,20000,0,0,0,30000,10000,20000,20000
045588,健策元大93購01  ,0,0,0,0,0,0,0,0,0,20000,0,0,0,20000,0,20000,20000
045520,嘉聯益元富92購01,0,0,0,0,0,0,0,0,0,20000,0,0,0,20000,0,20000,20000
047711,華新科凱基94購03,0,0,0,0,0,0,0,0,0,20000,0,0,0,20000,0,20000,20000
045369,康控兆豐93購01  ,0,0,0,0,0,0,0,0,0,20000,0,0,0,40000,20000,20000,20000
046673,樺漢元大93購01  ,0,0,0,0,0,0,0,0,0,20000,0,0,0,22000,2000,20000,20000
046582,聯發科元大92購23,0,0,0,0,0,0,0,0,0,20000,0,0,0,20000,0,20000,20000
046043,日月光元大92購02,0,0,0,0,0,0,0,0,0,20000,0,0,0,20000,0,20000,20000
046029,微星元大92購02  ,0,0,0,0,0,0,0,0,0,20000,0,0,0,20000,0,20000,20000
046060,台塑凱基92購01  ,0,0,0,0,0,0,0,0,0,20000,0,0,0,20000,0,20000,20000
046073,日月光凱基92購03,0,0,0,0,0,0,0,0,0,20000,0,0,0,20000,0,20000,20000
046872,全新元富93購02  ,0,0,0,0,0,0,0,0,0,20000,0,0,0,30000,10000,20000,20000
046251,宏達電群益92購03,0,0,0,0,0,0,0,0,0,20000,0,0,0,20000,0,20000,20000
046299,大立光富邦93購04,0,0,0,0,0,0,0,0,0,20000,0,0,0,20000,0,20000,20000
046344,超眾國票94購01  ,0,0,0,0,0,0,0,0,0,20000,0,0,0,20000,0,20000,20000
04228P,貿聯永豐93售03  ,0,0,0,0,0,0,0,0,0,20000,0,0,0,382000,362000,20000,20000
044354,奇鋐元大93購02  ,0,0,0,0,0,0,0,0,0,20000,0,0,0,20000,0,20000,20000
04397P,玉晶光群益95售03,0,0,0,0,0,0,0,0,0,20000,0,0,0,20000,0,20000,20000
044187,泰鼎國泰93購01  ,0,0,0,0,0,0,0,0,0,20000,0,0,0,20000,0,20000,20000
043909,台光電凱基93購01,0,0,0,0,0,0,0,0,0,20000,0,0,0,20000,0,20000,20000
043774,瑞昱兆豐92購01  ,0,0,0,0,0,0,0,0,0,20000,0,0,0,20000,0,20000,20000
04505P,佳世達元富96售03,0,0,0,0,0,0,0,0,0,20000,0,0,0,20000,0,20000,20000
045149,聯發科凱基93購02,0,0,0,0,0,0,0,0,0,20000,0,0,0,40000,20000,20000,20000
044511,全新凱基92購01  ,0,0,0,0,0,0,0,0,0,20000,0,0,0,20000,0,20000,20000
046538,大立光群益93購06,0,0,0,0,0,0,0,0,0,20000,0,0,0,21000,1000,20000,20000
044988,玉晶光統一95購01,0,0,0,0,0,0,0,0,0,20000,0,0,0,56000,36000,20000,20000
03103P,聯發科元富01售02,0,0,0,0,0,0,0,0,0,20000,0,0,0,20000,0,20000,20000
03950P,聯發科中信93售03,0,0,0,0,0,0,0,0,0,20000,0,0,0,22000,2000,20000,20000
00640L,富邦日本正2     ,21000,33000,-12000,0,0,0,0,0,0,32000,0,0,0,630000,598000,32000,20000
03025P,國巨元大01售12  ,0,0,0,0,0,0,0,0,0,20000,0,0,0,20000,0,20000,20000
048941,牧德永豐94購02  ,0,0,0,0,0,0,0,0,0,20000,0,0,0,115000,95000,20000,20000
048880,昇陽半國票94購01,0,0,0,0,0,0,0,0,0,20000,0,0,0,20000,0,20000,20000
050009,昇陽半永豐94購02,0,0,0,0,0,0,0,0,0,20000,0,0,0,20000,0,20000,20000
050217,健策永豐94購03  ,0,0,0,0,0,0,0,0,0,20000,0,0,0,20000,0,20000,20000
050224,台泥中信94購01  ,0,0,0,0,0,0,0,0,0,20000,0,0,0,90000,70000,20000,20000
049846,台泥群益94購01  ,0,0,0,0,0,0,0,0,0,20000,0,0,0,45000,25000,20000,20000
049088,上緯控凱基94購02,0,0,0,0,0,0,0,0,0,20000,0,0,0,20000,0,20000,20000
049446,為升統一94購01  ,0,0,0,0,0,0,0,0,0,20000,0,0,0,30000,10000,20000,20000
049128,滬深2X元大97購03,0,0,0,0,0,0,0,0,0,20000,0,0,0,20000,0,20000,20000
049338,台達電統一94購04,0,0,0,0,0,0,0,0,0,20000,0,0,0,40000,20000,20000,20000
049842,道瓊反中信98購01,0,0,0,0,0,0,0,0,0,20000,0,0,0,20000,0,20000,20000
051663,鴻海元大95購18  ,0,0,0,0,0,0,0,0,0,20000,0,0,0,20000,0,20000,20000
051651,易華電永豐95購01,0,0,0,0,0,0,0,0,0,20000,0,0,0,20000,0,20000,20000
051625,聯發科麥證95購01,0,0,0,30000,10000,20000,0,0,0,20000,0,0,0,30000,10000,20000,20000
048037,台表科凱基93購05,0,0,0,0,0,0,0,0,0,20000,0,0,0,25000,5000,20000,20000
049004,聯發科中信96購01,0,0,0,0,0,0,0,0,0,20000,0,0,0,60000,40000,20000,20000
051318,上銀國票96購01  ,0,0,0,0,0,0,0,0,0,20000,0,0,0,20000,0,20000,20000
051364,鴻海國泰97購03  ,0,0,0,0,0,0,0,0,0,20000,0,0,0,20000,0,20000,20000
048295,泰鼎群益93購01  ,0,0,0,0,0,0,0,0,0,20000,0,0,0,100000,80000,20000,20000
048146,大立光統一93購11,0,0,0,0,0,0,0,0,0,20000,0,0,0,20000,0,20000,20000
048226,大立光凱基93購35,0,0,0,0,0,0,0,0,0,20000,0,0,0,20000,0,20000,20000
048248,聯發科兆豐95購01,0,0,0,0,0,0,0,0,0,20000,0,0,0,45000,25000,20000,20000
051199,鴻海麥證95購03  ,0,0,0,20000,0,20000,0,0,0,20000,0,0,0,20000,0,20000,20000
051246,美律元大96購01  ,0,0,0,0,0,0,0,0,0,20000,0,0,0,20000,0,20000,20000
04849P,GIS中信94售01   ,0,0,0,0,0,0,0,0,0,20000,0,0,0,20000,0,20000,20000
049278,南亞科亞東94購01,0,0,0,0,0,0,0,0,0,20000,0,0,0,20000,0,20000,20000
049409,滬深2X凱基96購04,0,0,0,0,0,0,0,0,0,20000,0,0,0,20000,0,20000,20000
049397,台達電群益94購03,0,0,0,0,0,0,0,0,0,20000,0,0,0,20000,0,20000,20000
05110P,上銀統一95售01  ,0,0,0,0,0,0,0,0,0,20000,0,0,0,25000,5000,20000,20000
051120,南亞科群益95購01,0,0,0,0,0,0,0,0,0,20000,0,0,0,31000,11000,20000,20000
048735,美利達麥證95購01,0,0,0,20000,0,20000,0,0,0,20000,0,0,0,20000,0,20000,20000
048759,巨大元富96購01  ,0,0,0,0,0,0,0,0,0,20000,0,0,0,30000,10000,20000,20000
048647,正文元大93購01  ,0,0,0,0,0,0,0,0,0,20000,0,0,0,30000,10000,20000,20000
048652,巨大元大96購01  ,0,0,0,0,0,0,0,0,0,20000,0,0,0,20000,0,20000,20000
049578,台達電元大94購09,0,0,0,0,0,0,0,0,0,20000,0,0,0,20000,0,20000,20000
050922,南亞科凱基95購02,0,0,0,0,0,0,0,0,0,20000,0,0,0,20000,0,20000,20000
052942,聯發科中信97購04,0,0,0,0,0,0,0,0,0,20000,0,0,0,46000,26000,20000,20000
052981,鴻海元大97購05  ,0,0,0,0,0,0,0,0,0,20000,0,0,0,20000,0,20000,20000
053097,超眾統一96購03  ,0,0,0,0,0,0,0,0,0,20000,0,0,0,20000,0,20000,20000
053144,上証2X元大96購01,0,0,0,0,0,0,0,0,0,20000,0,0,0,20000,0,20000,20000
05280P,華通元大95售08  ,0,0,0,0,0,0,0,0,0,20000,0,0,0,20000,0,20000,20000
052675,新光金國泰98購01,0,0,0,0,0,0,0,0,0,20000,0,0,0,20000,0,20000,20000
052540,華新科統一95購03,0,0,0,0,0,0,0,0,0,20000,0,0,0,30000,10000,20000,20000
052183,華邦電群益95購01,0,0,0,0,0,0,0,0,0,20000,0,0,0,20000,0,20000,20000
052260,為升富邦97購02  ,0,0,0,0,0,0,0,0,0,20000,0,0,0,76000,56000,20000,20000
052454,力成元大95購02  ,0,0,0,0,0,0,0,0,0,20000,0,0,0,20000,0,20000,20000
051850,臻鼎中信96購01  ,0,0,0,0,0,0,0,0,0,20000,0,0,0,50000,30000,20000,20000
051915,日月光元大96購01,0,0,0,0,0,0,0,0,0,20000,0,0,0,99000,79000,20000,20000
051885,易華電永豐95購02,0,0,0,0,0,0,0,0,0,20000,0,0,0,20000,0,20000,20000
053916,漢唐國票97購04  ,0,0,0,0,0,0,0,0,0,20000,0,0,0,20000,0,20000,20000
053900,T50反1日盛99購01,0,0,0,0,0,0,0,0,0,20000,0,0,0,20000,0,20000,20000
054425,聯發科富邦99購03,0,0,0,0,0,0,0,0,0,20000,0,0,0,40000,20000,20000,20000
054477,聯發科中信9C購02,0,0,0,0,0,0,0,0,0,20000,0,0,0,40000,20000,20000,20000
054211,奇鋐國票97購03  ,0,0,0,0,0,0,0,0,0,20000,0,0,0,20000,0,20000,20000
054342,亞光元富99購01  ,0,0,0,0,0,0,0,0,0,20000,0,0,0,20000,0,20000,20000
054348,康控國票97購03  ,0,0,0,0,0,0,0,0,0,20000,0,0,0,30000,10000,20000,20000
054349,同欣電國票97購02,0,0,0,0,0,0,0,0,0,20000,0,0,0,24000,4000,20000,20000
05429P,鴻海統一95售16  ,0,0,0,0,0,0,0,0,0,20000,0,0,0,20000,0,20000,20000
053740,元油反國票99購01,0,0,0,0,0,0,0,0,0,20000,0,0,0,20000,0,20000,20000
05366P,鴻海元富95售12  ,0,0,0,0,0,0,0,0,0,20000,0,0,0,70000,50000,20000,20000
053655,全新凱基98購02  ,0,0,0,0,0,0,0,0,0,20000,0,0,0,20000,0,20000,20000
053643,漢唐國票97購02  ,0,0,0,0,0,0,0,0,0,20000,0,0,0,30000,10000,20000,20000
053468,鴻海元大98購01  ,0,0,0,0,0,0,0,0,0,20000,0,0,0,20000,0,20000,20000
053419,光罩永豐96購01  ,0,0,0,0,0,0,0,0,0,20000,0,0,0,20000,0,20000,20000
053327,彩晶台新97購01  ,0,0,0,0,0,0,0,0,0,20000,0,0,0,20000,0,20000,20000
06060P,玉晶光元大97售03,0,0,0,0,0,0,0,0,0,20000,0,0,0,20000,0,20000,20000
06412P,南亞科日盛97售01,0,0,0,0,0,0,0,0,0,20000,0,0,0,20000,0,20000,20000
06430P,大立光元大97售16,0,0,0,0,0,0,0,0,0,20000,0,0,0,50000,30000,20000,20000
06367P,台積電凱基97售14,0,0,0,0,0,0,0,0,0,20000,0,0,0,121000,101000,20000,20000
4155,訊映            ,119000,99000,20000,0,0,0,0,0,0,0,0,0,0,0,0,0,20000
055268,和大元大97購01  ,170000,0,170000,0,0,0,0,0,0,-151000,0,0,0,20000,171000,-151000,19000
055284,全新元大99購01  ,0,0,0,0,0,0,0,0,0,19000,0,0,0,21000,2000,19000,19000
055421,玉晶光永豐98購04,0,0,0,0,0,0,0,0,0,19000,0,0,0,89000,70000,19000,19000
05592P,可成群益96售03  ,0,0,0,0,0,0,0,0,0,19000,0,0,0,39000,20000,19000,19000
055930,可成群益98購01  ,0,0,0,0,0,0,0,0,0,19000,0,0,0,43000,24000,19000,19000
055968,祥碩元大97購04  ,0,0,0,0,0,0,0,0,0,19000,0,0,0,57000,38000,19000,19000
055841,南亞科元大97購04,0,0,0,0,0,0,0,0,0,19000,0,0,0,89000,70000,19000,19000
05687P,臺股指元大96售12,0,0,0,0,0,0,0,0,0,19000,0,0,0,30000,11000,19000,19000
056523,光寶科中信98購01,0,0,0,0,0,0,0,0,0,19000,0,0,0,19000,0,19000,19000
056497,GIS國泰99購01   ,0,0,0,0,0,0,0,0,0,19000,0,0,0,20000,1000,19000,19000
00670L,富邦NASDAQ正2   ,0,0,0,0,0,0,0,0,0,19000,0,0,0,61000,42000,19000,19000
042062,台灣50兆豐92購01,0,0,0,0,0,0,0,0,0,19000,0,0,0,30000,11000,19000,19000
044944,技嘉群益93購01  ,0,0,0,0,0,0,0,0,0,19000,0,0,0,20000,1000,19000,19000
03332P,台積電元大02售17,0,0,0,0,0,0,0,0,0,19000,0,0,0,19000,0,19000,19000
04438P,微星群益94售01  ,0,0,0,0,0,0,0,0,0,19000,0,0,0,30000,11000,19000,19000
042527,台灣50永豐94購01,0,0,0,0,0,0,0,0,0,19000,0,0,0,20000,1000,19000,19000
047648,智伸科元大93購05,0,0,0,0,0,0,0,0,0,19000,0,0,0,19000,0,19000,19000
045456,鴻海元大93購04  ,0,0,0,0,0,0,0,0,0,19000,0,0,0,19000,0,19000,19000
047047,旺宏國票95購01  ,0,0,0,0,0,0,0,0,0,19000,0,0,0,71000,52000,19000,19000
048530,大立光國票93購04,0,0,0,0,0,0,0,0,0,19000,0,0,0,19000,0,19000,19000
050900,台郡元大95購02  ,0,0,0,0,0,0,0,0,0,19000,0,0,0,102000,83000,19000,19000
050821,國泰金凱基95購01,0,0,0,0,0,0,0,0,0,19000,0,0,0,20000,1000,19000,19000
051001,緯穎元大96購02  ,0,0,0,0,0,0,0,0,0,19000,0,0,0,113000,94000,19000,19000
04959P,可成凱基94售14  ,0,0,0,0,0,0,0,0,0,19000,0,0,0,95000,76000,19000,19000
049420,日電貿凱基94購01,0,0,0,0,0,0,0,0,0,19000,0,0,0,19000,0,19000,19000
049290,元油2X群益94購02,0,0,0,0,0,0,0,0,0,19000,0,0,0,20000,1000,19000,19000
051274,華新科亞東96購01,0,0,0,0,0,0,0,0,0,19000,0,0,0,19000,0,19000,19000
049024,玉晶光群益97購01,0,0,0,0,0,0,0,0,0,19000,0,0,0,54000,35000,19000,19000
047998,美律元大93購06  ,0,0,0,0,0,0,0,0,0,19000,0,0,0,77000,58000,19000,19000
047954,漢唐永豐93購02  ,0,0,0,0,0,0,0,0,0,19000,0,0,0,76000,57000,19000,19000
05155P,聯發科兆豐95售03,0,0,0,0,0,0,0,0,0,19000,0,0,0,54000,35000,19000,19000
04986P,茂林永豐94售05  ,0,0,0,0,0,0,0,0,0,19000,0,0,0,29000,10000,19000,19000
053332,創意永豐96購03  ,0,0,0,0,0,0,0,0,0,19000,0,0,0,78000,59000,19000,19000
053439,台積電凱基96購11,0,0,0,0,0,0,0,0,0,19000,0,0,0,90000,71000,19000,19000
053626,台積電兆豐96購03,0,0,0,0,0,0,0,0,0,19000,0,0,0,49000,30000,19000,19000
053775,鴻海元大96購21  ,0,0,0,0,0,0,0,0,0,19000,0,0,0,19000,0,19000,19000
053847,美律元富96購02  ,0,0,0,0,0,0,0,0,0,19000,0,0,0,79000,60000,19000,19000
054327,亞光台新96購02  ,0,0,0,0,0,0,0,0,0,19000,0,0,0,19000,0,19000,19000
054370,台積電中信9A購01,0,0,0,0,0,0,0,0,0,19000,0,0,0,38000,19000,19000,19000
054378,楠梓電群益98購01,0,0,0,0,0,0,0,0,0,19000,0,0,0,31000,12000,19000,19000
05395P,旺宏元大96售06  ,0,0,0,0,0,0,0,0,0,19000,0,0,0,20000,1000,19000,19000
051876,宏達電國票96購01,0,0,0,0,0,0,0,0,0,19000,0,0,0,178000,159000,19000,19000
051785,臻鼎兆豐96購01  ,0,0,0,0,0,0,0,0,0,19000,0,0,0,34000,15000,19000,19000
052528,茂林元大95購05  ,0,0,0,0,0,0,0,0,0,19000,0,0,0,251000,232000,19000,19000
052523,奇力新元大97購01,0,0,0,0,0,0,0,0,0,19000,0,0,0,224000,205000,19000,19000
052647,晶技永豐97購01  ,0,0,0,0,0,0,0,0,0,19000,0,0,0,19000,0,19000,19000
053164,台光電群益96購02,0,0,0,0,0,0,0,0,0,19000,0,0,0,30000,11000,19000,19000
053162,緯穎元大97購01  ,0,0,0,0,0,0,0,0,0,19000,0,0,0,108000,89000,19000,19000
053032,國巨兆豐97購02  ,0,0,0,0,0,0,0,0,0,19000,0,0,0,34000,15000,19000,19000
2881A,富邦特          ,56000,0,56000,0,0,0,0,0,0,-37000,0,37000,-37000,0,0,0,19000
06109P,華新科群益97售05,0,0,0,0,0,0,0,0,0,19000,0,0,0,51000,32000,19000,19000
06127P,泰碩元富97售01  ,0,0,0,0,0,0,0,0,0,19000,0,0,0,24000,5000,19000,19000
05713P,大立光統一96售05,0,0,0,0,0,0,0,0,0,18000,0,0,0,20000,2000,18000,18000
05792P,臺股指中信99售07,0,0,0,0,0,0,0,0,0,18000,0,0,0,20000,2000,18000,18000
05954P,旺宏國票97售03  ,0,0,0,0,0,0,0,0,0,18000,0,0,0,25000,7000,18000,18000
056180,南茂元富97購01  ,0,0,0,0,0,0,0,0,0,18000,0,0,0,18000,0,18000,18000
056370,台郡元大98購03  ,0,0,0,0,0,0,0,0,0,18000,0,0,0,18000,0,18000,18000
055680,美律凱基99購01  ,0,0,0,0,0,0,0,0,0,18000,0,0,0,32000,14000,18000,18000
055770,欣興麥證97購01  ,0,0,0,20000,2000,18000,0,0,0,18000,0,0,0,20000,2000,18000,18000
055551,致茂凱基98購01  ,0,0,0,0,0,0,0,0,0,18000,0,0,0,20000,2000,18000,18000
055497,開發金元大97購01,0,0,0,0,0,0,0,0,0,18000,0,0,0,18000,0,18000,18000
055029,帆宣國泰99購01  ,0,0,0,0,0,0,0,0,0,18000,0,0,0,246000,228000,18000,18000
050480,健策國票95購04  ,0,0,0,0,0,0,0,0,0,18000,0,0,0,18000,0,18000,18000
046242,大立光中信93購02,0,0,0,0,0,0,0,0,0,18000,0,0,0,18000,0,18000,18000
045766,上証2X元富92購01,0,0,0,0,0,0,0,0,0,18000,0,0,0,20000,2000,18000,18000
043236,台灣50兆豐93購02,0,0,0,0,0,0,0,0,0,18000,0,0,0,46000,28000,18000,18000
046455,瑞昱凱基92購03  ,0,0,0,0,0,0,0,0,0,18000,0,0,0,38000,20000,18000,18000
046579,台積電元大92購32,0,0,0,0,0,0,0,0,0,18000,0,0,0,18000,0,18000,18000
00757,統一FANG+       ,0,0,0,0,0,0,0,0,0,18000,0,0,0,218000,200000,18000,18000
03926P,麗豐元大93售02  ,0,0,0,0,0,0,0,0,0,18000,0,0,0,131000,113000,18000,18000
049324,臺股指凱基94購06,0,0,0,0,0,0,0,0,0,18000,0,0,0,20000,2000,18000,18000
049911,智邦元大94購05  ,0,0,0,0,0,0,0,0,0,18000,0,0,0,68000,50000,18000,18000
048944,茂林永豐94購01  ,0,0,0,0,0,0,0,0,0,18000,0,0,0,18000,0,18000,18000
051400,國巨永豐95購01  ,0,0,0,0,0,0,0,0,0,18000,0,0,0,59000,41000,18000,18000
04802P,國巨凱基94售07  ,0,0,0,0,0,0,0,0,0,18000,0,0,0,68000,50000,18000,18000
050577,美律國票94購03  ,0,0,0,0,0,0,0,0,0,18000,0,0,0,48000,30000,18000,18000
049025,華擎群益94購01  ,0,0,0,0,0,0,0,0,0,18000,0,0,0,39000,21000,18000,18000
049074,光罩凱基94購02  ,0,0,0,0,0,0,0,0,0,18000,0,0,0,68000,50000,18000,18000
051347,國巨元大95購06  ,0,0,0,0,0,0,0,0,0,18000,0,0,0,20000,2000,18000,18000
049294,南亞科群益94購01,0,0,0,0,0,0,0,0,0,18000,0,0,0,30000,12000,18000,18000
051248,華固元大95購01  ,0,0,0,0,0,0,0,0,0,18000,0,0,0,18000,0,18000,18000
051164,鴻海元大95購05  ,0,0,0,0,0,0,0,0,0,18000,0,0,0,18000,0,18000,18000
048670,華新科永豐93購03,0,0,0,0,0,0,0,0,0,18000,0,0,0,126000,108000,18000,18000
052766,玉晶光群益9A購01,0,0,0,0,0,0,0,0,0,18000,0,0,0,30000,12000,18000,18000
051798,國巨永豐95購03  ,0,0,0,0,0,0,0,0,0,18000,0,0,0,30000,12000,18000,18000
05187P,力山凱基95售01  ,0,0,0,0,0,0,0,0,0,18000,0,0,0,36000,18000,18000,18000
052212,可成元大95購11  ,0,0,0,0,0,0,0,0,0,18000,0,0,0,18000,0,18000,18000
053967,華邦電元大96購03,0,0,0,0,0,0,0,0,0,18000,0,0,0,68000,50000,18000,18000
053728,茂林凱基97購01  ,0,0,0,0,0,0,0,0,0,18000,0,0,0,20000,2000,18000,18000
053602,台虹元大96購01  ,0,0,0,0,0,0,0,0,0,18000,0,0,0,63000,45000,18000,18000
053514,麗豐群益96購01  ,0,0,0,0,0,0,0,0,0,18000,0,0,0,18000,0,18000,18000
053340,建準國票97購01  ,0,0,0,0,0,0,0,0,0,18000,0,0,0,28000,10000,18000,18000
06241P,大立光元富9A售01,0,0,0,0,0,0,0,0,0,18000,0,0,0,20000,2000,18000,18000
06295P,國巨元大97售14  ,0,0,0,0,0,0,0,0,0,18000,0,0,0,18000,0,18000,18000
06450P,聯發科元大98售03,0,0,0,0,0,0,0,0,0,18000,0,0,0,218000,200000,18000,18000
056410,康控國票99購01  ,0,0,0,0,0,0,0,0,0,17000,0,0,0,27000,10000,17000,17000
055821,勤誠國票98購01  ,0,0,0,0,0,0,0,0,0,17000,0,0,0,110000,93000,17000,17000
03932P,欣興統一93售01  ,0,0,0,0,0,0,0,0,0,17000,0,0,0,17000,0,17000,17000
044024,祥碩凱基93購01  ,0,0,0,0,0,0,0,0,0,17000,0,0,0,17000,0,17000,17000
046288,創意兆豐92購03  ,0,0,0,0,0,0,0,0,0,17000,0,0,0,27000,10000,17000,17000
047830,智邦元大93購08  ,0,0,0,0,0,0,0,0,0,17000,0,0,0,168000,151000,17000,17000
047105,和大元大94購01  ,0,0,0,0,0,0,0,0,0,17000,0,0,0,17000,0,17000,17000
050495,大立光永昌96購01,0,0,0,0,0,0,0,0,0,17000,0,0,0,67000,50000,17000,17000
049589,奇力新元大95購02,0,0,0,0,0,0,0,0,0,17000,0,0,0,25000,8000,17000,17000
048176,美利達國泰94購01,0,0,0,0,0,0,0,0,0,17000,0,0,0,30000,13000,17000,17000
048821,光磊凱基95購01  ,0,0,0,0,0,0,0,0,0,17000,0,0,0,185000,168000,17000,17000
050590,晶技永豐95購01  ,0,0,0,0,0,0,0,0,0,17000,0,0,0,29000,12000,17000,17000
048898,晶相光國泰96購01,0,0,0,0,0,0,0,0,0,17000,0,0,0,160000,143000,17000,17000
049906,光寶科元大94購03,0,0,0,0,0,0,0,0,0,17000,0,0,0,37000,20000,17000,17000
054320,國喬台新96購01  ,0,0,0,0,0,0,0,0,0,17000,0,0,0,93000,76000,17000,17000
052271,力成日盛95購02  ,0,0,0,0,0,0,0,0,0,17000,0,0,0,20000,3000,17000,17000
051807,瑞昱凱基95購03  ,0,0,0,0,0,0,0,0,0,17000,0,0,0,32000,15000,17000,17000
051980,樺漢凱基96購01  ,0,0,0,0,0,0,0,0,0,17000,0,0,0,26000,9000,17000,17000
06180P,禾伸堂群益97售01,0,0,0,0,0,0,0,0,0,17000,0,0,0,67000,50000,17000,17000
6409,旭隼            ,50000,33000,17000,0,0,0,0,0,0,0,0,0,0,0,0,0,17000
056270,群創統一98購04  ,0,0,0,0,0,0,0,0,0,16000,0,0,0,76000,60000,16000,16000
056202,國揚永豐97購01  ,0,0,0,0,0,0,0,0,0,16000,0,0,0,116000,100000,16000,16000
05755P,臺股指中信99售04,0,0,0,0,0,0,0,0,0,16000,0,0,0,16000,0,16000,16000
056539,新光金凱基9A購01,0,0,0,0,0,0,0,0,0,16000,0,0,0,16000,0,16000,16000
054998,玉晶光元富97購02,0,0,0,0,0,0,0,0,0,16000,0,0,0,17000,1000,16000,16000
055050,敬鵬永豐97購01  ,0,0,0,0,0,0,0,0,0,16000,0,0,0,16000,0,16000,16000
054725,國巨日盛97購01  ,0,0,0,0,0,0,0,0,0,16000,0,0,0,33000,17000,16000,16000
054676,牧德台新98購01  ,0,0,0,0,0,0,0,0,0,16000,0,0,0,16000,0,16000,16000
055773,瑞昱凱基97購03  ,0,0,0,0,0,0,0,0,0,16000,0,0,0,20000,4000,16000,16000
055365,華通元大97購03  ,0,0,0,0,0,0,0,0,0,16000,0,0,0,62000,46000,16000,16000
046940,瑞昱元大93購07  ,0,0,0,0,0,0,0,0,0,16000,0,0,0,16000,0,16000,16000
046970,聯詠群益93購01  ,0,0,0,0,0,0,0,0,0,16000,0,0,0,56000,40000,16000,16000
047236,智伸科凱基93購05,0,0,0,0,0,0,0,0,0,16000,0,0,0,16000,0,16000,16000
049478,祥碩永豐94購02  ,0,0,0,0,0,0,0,0,0,16000,0,0,0,16000,0,16000,16000
045960,聯發科凱基92購01,0,0,0,0,0,0,0,0,0,16000,0,0,0,16000,0,16000,16000
04652P,臺股指凱基94售11,0,0,0,0,0,0,0,0,0,16000,0,0,0,16000,0,16000,16000
044433,華新科元大92購06,0,0,0,0,0,0,0,0,0,16000,0,0,0,16000,0,16000,16000
049001,川湖中信94購01  ,0,0,0,0,0,0,0,0,0,16000,0,0,0,16000,0,16000,16000
049437,可成國泰96購01  ,0,0,0,0,0,0,0,0,0,16000,0,0,0,90000,74000,16000,16000
049401,可成群益94購04  ,0,0,0,0,0,0,0,0,0,16000,0,0,0,18000,2000,16000,16000
049257,南亞科元大94購03,0,0,0,0,0,0,0,0,0,16000,0,0,0,19000,3000,16000,16000
051209,百和麥證95購01  ,0,0,0,26000,10000,16000,0,0,0,16000,0,0,0,26000,10000,16000,16000
051218,聯發科元富9B購02,0,0,0,0,0,0,0,0,0,16000,0,0,0,20000,4000,16000,16000
050934,喬山國票96購01  ,0,0,0,0,0,0,0,0,0,16000,0,0,0,36000,20000,16000,16000
052154,緯創台新95購01  ,0,0,0,0,0,0,0,0,0,16000,0,0,0,16000,0,16000,16000
052854,聯詠日盛96購01  ,0,0,0,0,0,0,0,0,0,16000,0,0,0,16000,0,16000,16000
053047,寶成中信97購01  ,0,0,0,0,0,0,0,0,0,16000,0,0,0,73000,57000,16000,16000
054217,台表科國票97購05,0,0,0,0,0,0,0,0,0,16000,0,0,0,16000,0,16000,16000
053614,台積電群益96購08,0,0,0,0,0,0,0,0,0,16000,0,0,0,26000,10000,16000,16000
053770,元金2X元大98購01,0,0,0,0,0,0,0,0,0,16000,0,0,0,38000,22000,16000,16000
053811,國巨群益98購02  ,0,0,0,0,0,0,0,0,0,16000,0,0,0,16000,0,16000,16000
06407P,創意元富97售02  ,0,0,0,0,0,0,0,0,0,16000,0,0,0,16000,0,16000,16000
3004,豐達科          ,48000,53000,-5000,0,0,0,21000,0,21000,0,0,0,0,0,0,0,16000
2425,承啟            ,73000,57000,16000,0,0,0,0,0,0,0,0,0,0,0,0,0,16000
055428,友達群益9C購01  ,0,0,0,0,0,0,0,0,0,15000,0,0,0,15000,0,15000,15000
055451,台積電元富97購02,0,0,0,0,0,0,0,0,0,15000,0,0,0,101000,86000,15000,15000
054555,欣興凱基98購01  ,0,0,0,0,0,0,0,0,0,15000,0,0,0,27000,12000,15000,15000
054535,旺宏富邦97購02  ,0,0,0,0,0,0,0,0,0,15000,0,0,0,20000,5000,15000,15000
05499P,聯詠元富95售02  ,0,0,0,0,0,0,0,0,0,15000,0,0,0,15000,0,15000,15000
056622,高鐵永豐98購01  ,0,0,0,0,0,0,0,0,0,15000,0,0,0,15000,0,15000,15000
056613,旺宏永豐98購01  ,0,0,0,0,0,0,0,0,0,15000,0,0,0,24000,9000,15000,15000
056624,景碩永豐98購01  ,0,0,0,0,0,0,0,0,0,15000,0,0,0,130000,115000,15000,15000
05665P,台積電凱基96售08,0,0,0,0,0,0,0,0,0,15000,0,0,0,75000,60000,15000,15000
05869P,旺宏凱基96售05  ,0,0,0,0,0,0,0,0,0,15000,0,0,0,68000,53000,15000,15000
056295,國巨元大97購16  ,0,0,0,0,0,0,0,0,0,15000,0,0,0,55000,40000,15000,15000
044466,和大群益93購01  ,0,0,0,0,0,0,0,0,0,15000,0,0,0,15000,0,15000,15000
043170,喬山國泰93購01  ,0,0,0,0,0,0,0,0,0,15000,0,0,0,15000,0,15000,15000
043050,欣興國泰93購01  ,0,0,0,0,0,0,0,0,0,15000,0,0,0,15000,0,15000,15000
046460,聯鈞凱基93購02  ,0,0,0,0,0,0,0,0,0,15000,0,0,0,25000,10000,15000,15000
047550,聯發科凱基93購13,0,0,0,0,0,0,0,0,0,15000,0,0,0,25000,10000,15000,15000
044105,聯詠中信95購01  ,0,0,0,0,0,0,0,0,0,15000,0,0,0,63000,48000,15000,15000
04421P,玉晶光永豐94售02,0,0,0,0,0,0,0,0,0,15000,0,0,0,45000,30000,15000,15000
044264,大立光富邦93購03,0,0,0,0,0,0,0,0,0,15000,0,0,0,25000,10000,15000,15000
044296,嘉聯益凱基93購01,0,0,0,0,0,0,0,0,0,15000,0,0,0,15000,0,15000,15000
00762,元大全球AI      ,0,0,0,0,0,0,0,0,0,15000,0,0,0,15000,0,15000,15000
044537,上銀群益92購01  ,0,0,0,0,0,0,0,0,0,15000,0,0,0,15000,0,15000,15000
047763,旺宏元大94購04  ,60000,65000,-5000,0,0,0,0,0,0,20000,0,0,0,128000,108000,20000,15000
04775P,台積電凱基94售29,0,0,0,0,0,0,0,0,0,15000,0,0,0,15000,0,15000,15000
050701,上緯控凱基94購04,0,0,0,0,0,0,0,0,0,15000,0,0,0,30000,15000,15000,15000
047232,禾伸堂凱基93購02,0,0,0,0,0,0,0,0,0,15000,0,0,0,15000,0,15000,15000
047408,嘉晶統一95購01  ,0,0,0,0,0,0,0,0,0,15000,0,0,0,15000,0,15000,15000
047106,喬山元大93購01  ,0,0,0,0,0,0,0,0,0,15000,0,0,0,15000,0,15000,15000
047149,聯鈞群益93購01  ,0,0,0,0,0,0,0,0,0,15000,0,0,0,26000,11000,15000,15000
050842,旺宏國票97購01  ,0,0,0,0,0,0,0,0,0,15000,0,0,0,15000,0,15000,15000
048649,瀚宇博元大93購05,0,0,0,0,0,0,0,0,0,15000,0,0,0,25000,10000,15000,15000
050982,台積電國泰96購04,0,0,0,0,0,0,0,0,0,15000,0,0,0,15000,0,15000,15000
049613,華通中信94購01  ,0,0,0,0,0,0,0,0,0,15000,0,0,0,15000,0,15000,15000
051183,建準永豐95購02  ,0,0,0,0,0,0,0,0,0,15000,0,0,0,20000,5000,15000,15000
051229,亞光群益95購01  ,0,0,0,0,0,0,0,0,0,15000,0,0,0,15000,0,15000,15000
049298,矽格群益95購01  ,0,0,0,0,0,0,0,0,0,15000,0,0,0,35000,20000,15000,15000
049302,聯茂日盛94購01  ,0,0,0,0,0,0,0,0,0,15000,0,0,0,15000,0,15000,15000
050621,易華電元大95購01,0,0,0,0,0,0,0,0,0,15000,0,0,0,15000,0,15000,15000
048008,聯發科富邦95購02,0,0,0,0,0,0,0,0,0,15000,0,0,0,20000,5000,15000,15000
04800P,聯茂元大94售08  ,0,0,0,0,0,0,0,0,0,15000,0,0,0,17000,2000,15000,15000
048857,晶豪科群益94購01,0,0,0,0,0,0,0,0,0,15000,0,0,0,15000,0,15000,15000
050023,國巨元大94購12  ,0,0,0,0,0,0,0,0,0,15000,0,0,0,29000,14000,15000,15000
048920,川湖永豐94購01  ,0,0,0,0,0,0,0,0,0,15000,0,0,0,15000,0,15000,15000
053756,亞光元富96購02  ,0,0,0,0,0,0,0,0,0,15000,0,0,0,15000,0,15000,15000
053199,旺宏日盛96購01  ,0,0,0,0,0,0,0,0,0,15000,0,0,0,75000,60000,15000,15000
054210,台光電國票97購03,0,0,0,0,0,0,0,0,0,15000,0,0,0,15000,0,15000,15000
054436,高鐵台新97購02  ,0,0,0,0,0,0,0,0,0,15000,0,0,0,15000,0,15000,15000
053956,旺宏永豐96購04  ,0,0,0,0,0,0,0,0,0,15000,0,0,0,22000,7000,15000,15000
054177,牧德台新97購01  ,0,0,0,0,0,0,0,0,0,15000,0,0,0,28000,13000,15000,15000
053074,嘉晶永豐96購02  ,0,0,0,0,0,0,0,0,0,15000,0,0,0,40000,25000,15000,15000
053127,貿聯凱基97購01  ,0,0,0,0,0,0,0,0,0,15000,0,0,0,15000,0,15000,15000
052931,麗豐元大97購01  ,0,0,0,0,0,0,0,0,0,15000,0,0,0,115000,100000,15000,15000
052213,富邦金元大95購01,0,0,0,0,0,0,0,0,0,15000,0,0,0,15000,0,15000,15000
052374,瑞昱元大95購02  ,0,0,0,0,0,0,0,0,0,15000,0,0,0,94000,79000,15000,15000
05208P,TPK中信95售01   ,0,0,0,0,0,0,0,0,0,15000,0,0,0,15000,0,15000,15000
051812,臻鼎凱基95購03  ,0,0,0,0,0,0,0,0,0,15000,0,0,0,15000,0,15000,15000
051873,緯穎凱基95購02  ,0,0,0,0,0,0,0,0,0,15000,0,0,0,131000,116000,15000,15000
3018,同開            ,78000,63000,15000,0,0,0,0,0,0,0,0,0,0,0,0,0,15000
1454,台富            ,38000,23000,15000,0,0,0,0,0,0,0,0,0,0,0,0,0,15000
06308P,國巨元富97售06  ,0,0,0,0,0,0,0,0,0,15000,0,0,0,30000,15000,15000,15000
06112P,台積電兆豐97售01,0,0,0,0,0,0,0,0,0,15000,0,0,0,25000,10000,15000,15000
6277,宏正            ,35000,20000,15000,0,0,0,0,0,0,0,0,0,0,0,0,0,15000
05883P,致伸永豐96售03  ,0,0,0,0,0,0,0,0,0,14000,0,0,0,104000,90000,14000,14000
05859P,台表科國票97售04,0,0,0,0,0,0,0,0,0,14000,0,0,0,14000,0,14000,14000
054506,矽格永豐96購01  ,0,0,0,0,0,0,0,0,0,14000,0,0,0,72000,58000,14000,14000
055381,茂林元大97購02  ,0,0,0,0,0,0,0,0,0,14000,0,0,0,66000,52000,14000,14000
055739,健鼎元富97購01  ,0,0,0,0,0,0,0,0,0,14000,0,0,0,25000,11000,14000,14000
047417,台塑富邦97購01  ,0,0,0,0,0,0,0,0,0,14000,0,0,0,25000,11000,14000,14000
04726P,TPK凱基94售04   ,0,0,0,0,0,0,0,0,0,14000,0,0,0,15000,1000,14000,14000
050457,力成元大94購01  ,0,0,0,0,0,0,0,0,0,14000,0,0,0,14000,0,14000,14000
04855P,上証2X元富94售02,0,0,0,0,0,0,0,0,0,14000,0,0,0,14000,0,14000,14000
04599P,南亞科凱基94售03,0,0,0,0,0,0,0,0,0,14000,0,0,0,139000,125000,14000,14000
04179P,滬深2X國票93售03,0,0,0,0,0,0,0,0,0,14000,0,0,0,14000,0,14000,14000
041528,國泰金中信93購01,0,0,0,0,0,0,0,0,0,14000,0,0,0,15000,1000,14000,14000
044639,京元電元富94購01,0,0,0,0,0,0,0,0,0,14000,0,0,0,246000,232000,14000,14000
047617,瑞昱凱基93購07  ,0,0,0,0,0,0,0,0,0,14000,0,0,0,18000,4000,14000,14000
051085,鴻海元大95購03  ,0,0,0,0,0,0,0,0,0,14000,0,0,0,335000,321000,14000,14000
050613,台光電元大94購09,0,0,0,0,0,0,0,0,0,14000,0,0,0,24000,10000,14000,14000
051647,華新科永豐95購02,0,0,0,0,0,0,0,0,0,14000,0,0,0,28000,14000,14000,14000
049170,亞德客凱基94購01,0,0,0,0,0,0,0,0,0,14000,0,0,0,55000,41000,14000,14000
049199,茂林永豐95購01  ,0,0,0,0,0,0,0,0,0,14000,0,0,0,14000,0,14000,14000
048445,瑞昱凱基93購11  ,0,0,0,0,0,0,0,0,0,14000,0,0,0,14000,0,14000,14000
051254,健策元大96購04  ,0,0,0,0,0,0,0,0,0,14000,0,0,0,65000,51000,14000,14000
04805P,創意元富94售01  ,0,0,0,0,0,0,0,0,0,14000,0,0,0,30000,16000,14000,14000
049721,晶技凱基94購02  ,0,0,0,0,0,0,0,0,0,14000,0,0,0,14000,0,14000,14000
050855,華通台新95購01  ,0,0,0,0,0,0,0,0,0,14000,0,0,0,92000,78000,14000,14000
052403,麗豐凱基96購01  ,0,0,0,0,0,0,0,0,0,14000,0,0,0,34000,20000,14000,14000
052991,台積電台新96購01,0,0,0,0,0,0,0,0,0,14000,0,0,0,14000,0,14000,14000
054301,楠梓電凱基98購01,0,0,0,0,0,0,0,0,0,14000,0,0,0,54000,40000,14000,14000
6226,光鼎            ,63000,49000,14000,0,0,0,0,0,0,0,0,0,0,0,0,0,14000
06329P,大立光兆豐97售04,0,0,0,0,0,0,0,0,0,14000,0,0,0,14000,0,14000,14000
06444P,大立光凱基98售08,0,0,0,0,0,0,0,0,0,14000,0,0,0,14000,0,14000,14000
06463P,大立光富邦9A售01,0,0,0,0,0,0,0,0,0,14000,0,0,0,60000,46000,14000,14000
055586,旺宏元大98購06  ,0,0,0,0,0,0,0,0,0,13000,0,0,0,36000,23000,13000,13000
054515,華通元大98購02  ,0,0,0,0,0,0,0,0,0,13000,0,0,0,26000,13000,13000,13000
054678,麗豐台新98購02  ,0,0,0,0,0,0,0,0,0,13000,0,0,0,40000,27000,13000,13000
054912,群光凱基97購01  ,0,0,0,0,0,0,0,0,0,13000,0,0,0,18000,5000,13000,13000
047493,旺宏元富96購01  ,0,0,0,0,0,0,0,0,0,13000,0,0,0,138000,125000,13000,13000
045231,南電元大94購01  ,0,0,0,0,0,0,0,0,0,13000,0,0,0,52000,39000,13000,13000
04152P,喬山永豐93售02  ,0,0,0,0,0,0,0,0,0,13000,0,0,0,25000,12000,13000,13000
045975,祥碩凱基93購04  ,0,0,0,0,0,0,0,0,0,13000,0,0,0,13000,0,13000,13000
050700,健策凱基96購01  ,0,0,0,0,0,0,0,0,0,13000,0,0,0,101000,88000,13000,13000
047898,嘉澤群益93購02  ,0,0,0,0,0,0,0,0,0,13000,0,0,0,23000,10000,13000,13000
048600,嘉澤國票94購01  ,0,0,0,0,0,0,0,0,0,13000,0,0,0,43000,30000,13000,13000
049671,上証2X富邦95購01,0,0,0,0,0,0,0,0,0,13000,0,0,0,13000,0,13000,13000
051104,鈺齊元大96購01  ,0,0,0,0,0,0,0,0,0,13000,0,0,0,13000,0,13000,13000
048276,旺宏永豐94購01  ,0,0,0,0,0,0,0,0,0,13000,0,0,0,122000,109000,13000,13000
048341,全新元大94購03  ,0,0,0,0,0,0,0,0,0,13000,0,0,0,13000,0,13000,13000
051206,大立光麥證95購02,0,0,0,23000,10000,13000,0,0,0,13000,0,0,0,23000,10000,13000,13000
051241,台積電元大95購13,0,0,0,0,0,0,0,0,0,13000,0,0,0,258000,245000,13000,13000
04815P,致伸元大94售04  ,0,0,0,0,0,0,0,0,0,13000,0,0,0,13000,0,13000,13000
051681,日月光兆豐95購01,0,0,0,0,0,0,0,0,0,13000,0,0,0,23000,10000,13000,13000
051722,玉晶光永豐97購01,0,0,0,0,0,0,0,0,0,13000,0,0,0,13000,0,13000,13000
050632,國巨群益94購07  ,0,0,0,0,0,0,0,0,0,13000,0,0,0,13000,0,13000,13000
048998,玉晶光國票95購03,0,0,0,0,0,0,0,0,0,13000,0,0,0,64000,51000,13000,13000
049058,茂林永豐94購02  ,0,0,0,0,0,0,0,0,0,13000,0,0,0,13000,0,13000,13000
048873,玉晶光國票95購02,0,0,0,0,0,0,0,0,0,13000,0,0,0,13000,0,13000,13000
050302,百和凱基94購03  ,0,0,0,0,0,0,0,0,0,13000,0,0,0,13000,0,13000,13000
054151,瑞昱國泰97購01  ,0,0,0,0,0,0,0,0,0,13000,0,0,0,27000,14000,13000,13000
053195,玉晶光元富96購02,0,0,0,0,0,0,0,0,0,13000,0,0,0,17000,4000,13000,13000
053505,瑞儀兆豐97購01  ,0,0,0,0,0,0,0,0,0,13000,0,0,0,33000,20000,13000,13000
05341P,臺股指兆豐95售02,0,0,0,0,0,0,0,0,0,13000,0,0,0,13000,0,13000,13000
053786,新日興元大96購02,0,0,0,0,0,0,0,0,0,13000,0,0,0,13000,0,13000,13000
053601,台表科元大98購01,0,0,0,0,0,0,0,0,0,13000,0,0,0,34000,21000,13000,13000
052668,聯發科群益97購01,0,0,0,0,0,0,0,0,0,13000,0,0,0,28000,15000,13000,13000
052025,國巨群益96購01  ,0,0,0,0,0,0,0,0,0,13000,0,0,0,13000,0,13000,13000
06403P,鴻海元富97售15  ,0,0,0,0,0,0,0,0,0,13000,0,0,0,45000,32000,13000,13000
06050P,玉晶光國票98售01,0,0,0,0,0,0,0,0,0,13000,0,0,0,23000,10000,13000,13000
054822,祥碩元大97購01  ,0,0,0,0,0,0,0,0,0,12000,0,0,0,12000,0,12000,12000
054519,禾伸堂元大97購02,0,0,0,0,0,0,0,0,0,12000,0,0,0,12000,0,12000,12000
054564,玉晶光群益99購01,0,0,0,0,0,0,0,0,0,12000,0,0,0,32000,20000,12000,12000
055591,全新元大98購01  ,0,0,0,0,0,0,0,0,0,12000,0,0,0,28000,16000,12000,12000
055280,智邦元大97購01  ,0,0,0,0,0,0,0,0,0,12000,0,0,0,24000,12000,12000,12000
056506,晶豪科永豐98購02,0,0,0,0,0,0,0,0,0,12000,0,0,0,53000,41000,12000,12000
056404,嘉聯益群益9A購01,0,0,0,0,0,0,0,0,0,12000,0,0,0,86000,74000,12000,12000
056366,玉晶光元大99購04,0,0,0,0,0,0,0,0,0,12000,0,0,0,12000,0,12000,12000
056135,緯創元大98購01  ,0,0,0,0,0,0,0,0,0,12000,0,0,0,12000,0,12000,12000
056015,華通群益99購01  ,0,0,0,0,0,0,0,0,0,12000,0,0,0,12000,0,12000,12000
056097,訊芯元富97購02  ,0,0,0,0,0,0,0,0,0,12000,0,0,0,12000,0,12000,12000
047052,大毅國票93購01  ,0,0,0,0,0,0,0,0,0,12000,0,0,0,14000,2000,12000,12000
047251,麗豐群益93購01  ,0,0,0,0,0,0,0,0,0,12000,0,0,0,12000,0,12000,12000
047383,鴻海元大95購01  ,0,0,0,0,0,0,0,0,0,12000,0,0,0,15000,3000,12000,12000
048548,緯穎永豐93購02  ,0,0,0,0,0,0,0,0,0,12000,0,0,0,14000,2000,12000,12000
046332,同欣電元大92購01,0,0,0,0,0,0,0,0,0,12000,0,0,0,12000,0,12000,12000
046767,南茂凱基93購03  ,0,0,0,0,0,0,0,0,0,12000,0,0,0,12000,0,12000,12000
046685,世紀鋼群益93購02,0,0,0,0,0,0,0,0,0,12000,0,0,0,12000,0,12000,12000
046658,微星元大93購01  ,0,0,0,0,0,0,0,0,0,12000,0,0,0,12000,0,12000,12000
04165P,南亞科元富95售03,0,0,0,0,0,0,0,0,0,12000,0,0,0,12000,0,12000,12000
03861P,群創元富99售01  ,0,0,0,0,0,0,0,0,0,12000,0,0,0,12000,0,12000,12000
044217,華新科凱基93購03,0,0,0,0,0,0,0,0,0,12000,0,0,0,12000,0,12000,12000
04754P,宏達電元富94售02,0,0,0,0,0,0,0,0,0,12000,0,0,0,12000,0,12000,12000
050007,貿聯永豐94購01  ,0,0,0,0,0,0,0,0,0,12000,0,0,0,88000,76000,12000,12000
050064,華新科凱基94購08,0,0,0,0,0,0,0,0,0,12000,0,0,0,27000,15000,12000,12000
047941,義隆國票94購02  ,0,0,0,0,0,0,0,0,0,12000,0,0,0,60000,48000,12000,12000
049323,百和凱基94購01  ,0,0,0,0,0,0,0,0,0,12000,0,0,0,12000,0,12000,12000
049885,緯穎永豐94購01  ,0,0,0,0,0,0,0,0,0,12000,0,0,0,24000,12000,12000,12000
051375,道瓊反群益9A購01,0,0,0,0,0,0,0,0,0,12000,0,0,0,12000,0,12000,12000
051307,康舒凱基95購01  ,0,0,0,0,0,0,0,0,0,12000,0,0,0,66000,54000,12000,12000
048982,牧德元大94購02  ,0,0,0,0,0,0,0,0,0,12000,0,0,0,12000,0,12000,12000
051382,玉晶光群益98購02,0,0,0,0,0,0,0,0,0,12000,0,0,0,12000,0,12000,12000
051550,日電貿永豐95購01,0,0,0,0,0,0,0,0,0,12000,0,0,0,86000,74000,12000,12000
051536,玉晶光國票97購01,0,0,0,0,0,0,0,0,0,12000,0,0,0,12000,0,12000,12000
051234,南電群益95購02  ,0,0,0,0,0,0,0,0,0,12000,0,0,0,12000,0,12000,12000
048443,旺宏凱基93購08  ,0,0,0,0,0,0,0,0,0,12000,0,0,0,18000,6000,12000,12000
049811,聯鈞元大94購01  ,0,0,0,0,0,0,0,0,0,12000,0,0,0,32000,20000,12000,12000
049300,南電群益94購01  ,0,0,0,0,0,0,0,0,0,12000,0,0,0,12000,0,12000,12000
049310,台積電凱基94購15,0,0,0,0,0,0,0,0,0,12000,0,0,0,16000,4000,12000,12000
049407,台積電日盛94購02,0,0,0,0,0,0,0,0,0,12000,0,0,0,135000,123000,12000,12000
05096P,台積電日盛95售01,0,0,0,0,0,0,0,0,0,12000,0,0,0,12000,0,12000,12000
051939,同欣電群益97購01,0,0,0,0,0,0,0,0,0,12000,0,0,0,26000,14000,12000,12000
051854,鴻海麥證95購04  ,0,0,0,12000,0,12000,0,0,0,12000,0,0,0,12000,0,12000,12000
05173P,臺股指元大95售17,0,0,0,0,0,0,0,0,0,12000,0,0,0,55000,43000,12000,12000
052325,高股息中信99購01,0,0,0,0,0,0,0,0,0,12000,0,0,0,12000,0,12000,12000
052480,麗豐群益95購01  ,0,0,0,0,0,0,0,0,0,12000,0,0,0,12000,0,12000,12000
052249,大成鋼永豐95購01,0,0,0,0,0,0,0,0,0,12000,0,0,0,12000,0,12000,12000
053118,大立光中信9C購01,0,0,0,0,0,0,0,0,0,12000,0,0,0,42000,30000,12000,12000
053136,彩晶國票97購01  ,0,0,0,0,0,0,0,0,0,12000,0,0,0,12000,0,12000,12000
053706,S&P反1凱基99購01,0,0,0,0,0,0,0,0,0,12000,0,0,0,12000,0,12000,12000
05327P,臺股指凱基95售11,0,0,0,0,0,0,0,0,0,12000,0,0,0,12000,0,12000,12000
053927,牧德國票97購01  ,0,0,0,0,0,0,0,0,0,12000,0,0,0,50000,38000,12000,12000
054311,世芯凱基96購02  ,0,0,0,0,0,0,0,0,0,12000,0,0,0,17000,5000,12000,12000
054335,緯穎永豐96購02  ,0,0,0,0,0,0,0,0,0,12000,0,0,0,22000,10000,12000,12000
054340,大成鋼元富96購01,0,0,0,0,0,0,0,0,0,12000,0,0,0,12000,0,12000,12000
054471,T50反1中信9C購01,0,0,0,0,0,0,0,0,0,12000,0,0,0,12000,0,12000,12000
054479,緯創中信98購01  ,0,0,0,0,0,0,0,0,0,12000,0,0,0,12000,0,12000,12000
054428,禾伸堂富邦98購01,0,0,0,0,0,0,0,0,0,12000,0,0,0,25000,13000,12000,12000
056019,燿華群益97購02  ,0,0,0,0,0,0,0,0,0,11000,0,0,0,11000,0,11000,11000
056238,聯發科群益98購02,0,0,0,0,0,0,0,0,0,11000,0,0,0,11000,0,11000,11000
056241,緯創群益97購01  ,0,0,0,0,0,0,0,0,0,11000,0,0,0,11000,0,11000,11000
056242,緯創群益9A購01  ,0,0,0,0,0,0,0,0,0,11000,0,0,0,11000,0,11000,11000
056481,創意元大98購01  ,0,0,0,0,0,0,0,0,0,11000,0,0,0,11000,0,11000,11000
056563,華新科群益98購04,0,0,0,0,0,0,0,0,0,11000,0,0,0,17000,6000,11000,11000
056564,亞光群益98購02  ,0,0,0,0,0,0,0,0,0,11000,0,0,0,11000,0,11000,11000
05721P,全新群益98售02  ,0,0,0,0,0,0,0,0,0,11000,0,0,0,11000,0,11000,11000
05739P,臺股指統一97售02,0,0,0,0,0,0,0,0,0,11000,0,0,0,16000,5000,11000,11000
05900P,臺股指凱基99售05,0,0,0,0,0,0,0,0,0,11000,0,0,0,11000,0,11000,11000
055309,冠德群益97購01  ,0,0,0,0,0,0,0,0,0,11000,0,0,0,22000,11000,11000,11000
055366,國巨元大98購05  ,0,0,0,0,0,0,0,0,0,11000,0,0,0,18000,7000,11000,11000
055312,台虹群益99購01  ,0,0,0,0,0,0,0,0,0,11000,0,0,0,36000,25000,11000,11000
055633,牧德永豐97購02  ,0,0,0,0,0,0,0,0,0,11000,0,0,0,245000,234000,11000,11000
05567P,致伸群益96售01  ,0,0,0,0,0,0,0,0,0,11000,0,0,0,22000,11000,11000,11000
054562,亞光群益98購01  ,0,0,0,0,0,0,0,0,0,11000,0,0,0,11000,0,11000,11000
054693,神基永豐97購01  ,0,0,0,0,0,0,0,0,0,11000,0,0,0,134000,123000,11000,11000
05495P,大立光統一95售07,0,0,0,0,0,0,0,0,0,11000,0,0,0,39000,28000,11000,11000
054831,緯穎國泰98購01  ,0,0,0,0,0,0,0,0,0,11000,0,0,0,21000,10000,11000,11000
054871,明泰群益98購01  ,0,0,0,0,0,0,0,0,0,11000,0,0,0,11000,0,11000,11000
046551,聯發科麥證92購02,0,0,0,11000,0,11000,0,0,0,11000,0,0,0,11000,0,11000,11000
046510,大立光元大92購25,0,0,0,0,0,0,0,0,0,11000,0,0,0,11000,0,11000,11000
04308P,京元電凱基93售06,0,0,0,0,0,0,0,0,0,11000,0,0,0,12000,1000,11000,11000
046391,上海銀統一94購01,0,0,0,0,0,0,0,0,0,11000,0,0,0,31000,20000,11000,11000
044198,友達國票92購01  ,0,0,0,0,0,0,0,0,0,11000,0,0,0,11000,0,11000,11000
043381,大立光元大93購02,0,0,0,0,0,0,0,0,0,11000,0,0,0,11000,0,11000,11000
04336P,台達電元大93售04,0,0,0,0,0,0,0,0,0,11000,0,0,0,11000,0,11000,11000
045220,漢唐元大94購01  ,0,0,0,0,0,0,0,0,0,11000,0,0,0,11000,0,11000,11000
04518P,高鐵群益95售01  ,0,0,0,0,0,0,0,0,0,11000,0,0,0,21000,10000,11000,11000
045115,玉晶光永豐94購01,0,0,0,0,0,0,0,0,0,11000,0,0,0,19000,8000,11000,11000
03678P,欣興元大92售09  ,0,0,0,0,0,0,0,0,0,11000,0,0,0,12000,1000,11000,11000
044741,玉山金富邦93購01,0,0,0,0,0,0,0,0,0,11000,0,0,0,11000,0,11000,11000
04018P,亞光永豐93售01  ,0,0,0,0,0,0,0,0,0,11000,0,0,0,11000,0,11000,11000
0055,元大MSCI金融    ,0,0,0,0,0,0,0,0,0,11000,0,0,0,14000,3000,11000,11000
03064X,元展59          ,0,0,0,0,0,0,0,0,0,11000,0,0,0,11000,0,11000,11000
046755,瑞昱凱基93購05  ,0,0,0,0,0,0,0,0,0,11000,0,0,0,11000,0,11000,11000
045512,訊芯凱基92購01  ,0,0,0,0,0,0,0,0,0,11000,0,0,0,11000,0,11000,11000
046248,技嘉群益93購02  ,0,0,0,0,0,0,0,0,0,11000,0,0,0,41000,30000,11000,11000
046021,台泥元大92購01  ,0,0,0,0,0,0,0,0,0,11000,0,0,0,21000,10000,11000,11000
049489,美律元大94購05  ,0,0,0,0,0,0,0,0,0,11000,0,0,0,41000,30000,11000,11000
048564,智易元大94購01  ,0,0,0,0,0,0,0,0,0,11000,0,0,0,11000,0,11000,11000
047245,聯發科群益94購03,0,0,0,0,0,0,0,0,0,11000,0,0,0,21000,10000,11000,11000
04723P,美律凱基94售06  ,0,0,0,0,0,0,0,0,0,11000,0,0,0,14000,3000,11000,11000
047180,台積電元大93購18,0,0,0,0,0,0,0,0,0,11000,0,0,0,11000,0,11000,11000
050972,台虹永豐95購01  ,0,0,0,0,0,0,0,0,0,11000,0,0,0,11000,0,11000,11000
050943,楠梓電群益96購01,0,0,0,0,0,0,0,0,0,11000,0,0,0,11000,0,11000,11000
050207,百和群益95購01  ,0,0,0,0,0,0,0,0,0,11000,0,0,0,22000,11000,11000,11000
048689,台光電群益94購01,0,0,0,0,0,0,0,0,0,11000,0,0,0,11000,0,11000,11000
049396,元油2X群益97購03,0,0,0,0,0,0,0,0,0,11000,0,0,0,20000,9000,11000,11000
049189,訊芯康和94購01  ,0,0,0,0,0,0,0,0,0,11000,0,0,0,26000,15000,11000,11000
049206,大立光群益94購04,0,0,0,0,0,0,0,0,0,11000,0,0,0,11000,0,11000,11000
049785,華新科兆豐95購01,0,0,0,0,0,0,0,0,0,11000,0,0,0,32000,21000,11000,11000
048404,大立光群益93購11,0,0,0,0,0,0,0,0,0,11000,0,0,0,11000,0,11000,11000
051685,台光電凱基95購01,0,0,0,0,0,0,0,0,0,11000,0,0,0,11000,0,11000,11000
051702,鴻海群益95購08  ,0,0,0,0,0,0,0,0,0,11000,0,0,0,11000,0,11000,11000
048986,訊連元大94購01  ,0,0,0,0,0,0,0,0,0,11000,0,0,0,17000,6000,11000,11000
048993,昇陽半元大94購03,0,0,0,0,0,0,0,0,0,11000,0,0,0,11000,0,11000,11000
051319,光磊國票96購02  ,0,0,0,0,0,0,0,0,0,11000,0,0,0,498000,487000,11000,11000
049858,百和群益94購05  ,0,0,0,0,0,0,0,0,0,11000,0,0,0,21000,10000,11000,11000
050234,國巨凱基94購10  ,0,0,0,0,0,0,0,0,0,11000,0,0,0,29000,18000,11000,11000
049337,台達電統一94購03,0,0,0,0,0,0,0,0,0,11000,0,0,0,31000,20000,11000,11000
049105,亞泥富邦94購01  ,0,0,0,0,0,0,0,0,0,11000,0,0,0,15000,4000,11000,11000
047940,台光電國票93購01,0,0,0,0,0,0,0,0,0,11000,0,0,0,11000,0,11000,11000
051082,上証2X元大98購01,0,0,0,0,0,0,0,0,0,11000,0,0,0,11000,0,11000,11000
054379,光磊群益98購01  ,0,0,0,0,0,0,0,0,0,11000,0,0,0,109000,98000,11000,11000
054285,國巨元大98購02  ,0,0,0,0,0,0,0,0,0,11000,0,0,0,59000,48000,11000,11000
054234,可成群益96購05  ,0,0,0,0,0,0,0,0,0,11000,0,0,0,11000,0,11000,11000
054266,緯穎元大96購07  ,0,0,0,0,0,0,0,0,0,11000,0,0,0,84000,73000,11000,11000
053321,智原群益96購02  ,0,0,0,0,0,0,0,0,0,11000,0,0,0,11000,0,11000,11000
053242,聯電國票96購04  ,0,0,0,0,0,0,0,0,0,11000,0,0,0,11000,0,11000,11000
053239,崇越永豐96購01  ,0,0,0,0,0,0,0,0,0,11000,0,0,0,79000,68000,11000,11000
053250,百和國票97購02  ,0,0,0,0,0,0,0,0,0,11000,0,0,0,35000,24000,11000,11000
053509,華新群益98購01  ,0,0,0,0,0,0,0,0,0,11000,0,0,0,16000,5000,11000,11000
053159,同欣電元大96購02,0,0,0,0,0,0,0,0,0,11000,0,0,0,14000,3000,11000,11000
052782,超眾國票96購02  ,0,0,0,0,0,0,0,0,0,11000,0,0,0,20000,9000,11000,11000
052763,晶技群益97購01  ,0,0,0,0,0,0,0,0,0,11000,0,0,0,11000,0,11000,11000
06064P,台積電台新98售01,0,0,0,0,0,0,0,0,0,11000,0,0,0,330000,319000,11000,11000
06108P,奇力新群益97售05,0,0,0,0,0,0,0,0,0,11000,0,0,0,21000,10000,11000,11000
06157P,聯鈞統一97售02  ,0,0,0,0,0,0,0,0,0,11000,0,0,0,15000,4000,11000,11000
054954,華新科元大97購06,0,0,0,0,0,0,0,0,0,10000,0,0,0,10000,0,10000,10000
055003,群創元富99購05  ,0,0,0,0,0,0,0,0,0,10000,0,0,0,10000,0,10000,10000
055147,鴻海元大97購11  ,0,0,0,0,0,0,0,0,0,10000,0,0,0,10000,0,10000,10000
05467P,聯電元大95售02  ,0,0,0,0,0,0,0,0,0,10000,0,0,0,155000,145000,10000,10000
054537,南亞科亞東97購01,0,0,0,0,0,0,0,0,0,10000,0,0,0,10000,0,10000,10000
054591,GIS國泰98購01   ,0,0,0,0,0,0,0,0,0,10000,0,0,0,10000,0,10000,10000
054605,鴻海永豐97購01  ,0,0,0,0,0,0,0,0,0,10000,0,0,0,10000,0,10000,10000
055659,百和元富97購01  ,0,0,0,0,0,0,0,0,0,10000,0,0,0,10000,0,10000,10000
055641,鴻海元富97購04  ,0,0,0,0,0,0,0,0,0,10000,0,0,0,10000,0,10000,10000
055737,開發金元富97購01,0,0,0,0,0,0,0,0,0,10000,0,0,0,10000,0,10000,10000
055772,致茂凱基97購01  ,0,0,0,0,0,0,0,0,0,10000,0,0,0,10000,0,10000,10000
055748,GIS元富97購01   ,0,0,0,0,0,0,0,0,0,10000,0,0,0,10000,0,10000,10000
055632,群創永豐98購01  ,0,0,0,0,0,0,0,0,0,10000,0,0,0,39000,29000,10000,10000
055619,同欣電國票98購02,0,0,0,0,0,0,0,0,0,10000,0,0,0,10000,0,10000,10000
055514,亞光麥證97購01  ,0,0,0,10000,0,10000,0,0,0,10000,0,0,0,10000,0,10000,10000
055549,旺宏凱基97購03  ,0,0,0,0,0,0,0,0,0,10000,0,0,0,14000,4000,10000,10000
055332,奇力新兆豐98購01,0,0,0,0,0,0,0,0,0,10000,0,0,0,20000,10000,10000,10000
05535P,台積電元大97售06,0,0,0,0,0,0,0,0,0,10000,0,0,0,360000,350000,10000,10000
055393,華新科統一97購03,0,0,0,0,0,0,0,0,0,10000,0,0,0,10000,0,10000,10000
055303,鈺齊元大97購01  ,0,0,0,0,0,0,0,0,0,10000,0,0,0,10000,0,10000,10000
05897P,國巨凱基96售12  ,0,0,0,0,0,0,0,0,0,10000,0,0,0,10000,0,10000,10000
05899P,臺股指凱基96售30,0,0,0,0,0,0,0,0,0,10000,0,0,0,32000,22000,10000,10000
05962P,大立光群益96售07,0,0,0,0,0,0,0,0,0,10000,0,0,0,10000,0,10000,10000
05756P,臺股指中信99售05,0,0,0,0,0,0,0,0,0,10000,0,0,0,11000,1000,10000,10000
05715P,創意元富96售05  ,0,0,0,0,0,0,0,0,0,10000,0,0,0,10000,0,10000,10000
05793P,臺股指中信99售08,0,0,0,0,0,0,0,0,0,10000,0,0,0,12000,2000,10000,10000
05787P,臺股指永昌96售04,0,0,0,0,0,0,0,0,0,10000,130000,0,130000,390000,510000,-120000,10000
056529,中環凱基98購01  ,0,0,0,0,0,0,0,0,0,10000,0,0,0,10000,0,10000,10000
056591,S&P正2元富9A購01,0,0,0,0,0,0,0,0,0,10000,0,0,0,10000,0,10000,10000
056493,晶技國泰99購01  ,0,0,0,0,0,0,0,0,0,10000,0,0,0,30000,20000,10000,10000
056494,緯創國泰99購01  ,0,0,0,0,0,0,0,0,0,10000,0,0,0,10000,0,10000,10000
056495,泰鼎國泰99購01  ,0,0,0,0,0,0,0,0,0,10000,0,0,0,10000,0,10000,10000
056630,臺股指永豐98購02,0,0,0,0,0,0,0,0,0,10000,0,0,0,10000,0,10000,10000
05663P,創意元富96售04  ,0,0,0,0,0,0,0,0,0,10000,0,0,0,10000,0,10000,10000
056281,深中小永豐97購01,0,0,0,0,0,0,0,0,0,10000,0,0,0,10000,0,10000,10000
056257,聯茂元富97購04  ,0,0,0,0,0,0,0,0,0,10000,0,0,0,109000,99000,10000,10000
056258,訊芯元富97購04  ,0,0,0,0,0,0,0,0,0,10000,0,0,0,10000,0,10000,10000
056148,臺股指日盛97購03,0,0,0,0,0,0,0,0,0,10000,0,0,0,10000,0,10000,10000
05617P,大立光統一97售02,0,0,0,0,0,0,0,0,0,10000,0,0,0,10000,0,10000,10000
05619P,創意元富96售02  ,0,0,0,0,0,0,0,0,0,10000,0,0,0,10000,0,10000,10000
056386,TPK國泰99購01   ,0,0,0,0,0,0,0,0,0,10000,0,0,0,10000,0,10000,10000
056061,國泰金元大97購02,0,0,0,0,0,0,0,0,0,10000,0,0,0,10000,0,10000,10000
055831,台達電元大97購01,0,0,0,0,0,0,0,0,0,10000,0,0,0,77000,67000,10000,10000
05586P,臺股指凱基96售15,0,0,0,0,0,0,0,0,0,10000,0,0,0,12000,2000,10000,10000
055882,嘉聯益元富97購01,0,0,0,0,0,0,0,0,0,10000,0,0,0,10000,0,10000,10000
047124,華新中信93購01  ,0,0,0,0,0,0,0,0,0,10000,0,0,0,10000,0,10000,10000
047918,智邦凱基93購08  ,0,0,0,0,0,0,0,0,0,10000,0,0,0,10000,0,10000,10000
047108,華邦電元大93購03,0,0,0,0,0,0,0,0,0,10000,0,0,0,10000,0,10000,10000
047897,可成群益94購01  ,0,0,0,0,0,0,0,0,0,10000,0,0,0,150000,140000,10000,10000
046943,聯發科元大93購06,0,0,0,0,0,0,0,0,0,10000,0,0,0,10000,0,10000,10000
046944,奇力新元大96購01,0,0,0,0,0,0,0,0,0,10000,0,0,0,71000,61000,10000,10000
046888,鴻海群益93購05  ,0,0,0,0,0,0,0,0,0,10000,0,0,0,10000,0,10000,10000
046906,新光金凱基99購02,0,0,0,0,0,0,0,0,0,10000,0,0,0,10000,0,10000,10000
047240,樺漢凱基93購01  ,0,0,0,0,0,0,0,0,0,10000,0,0,0,10000,0,10000,10000
047188,聯詠元大93購04  ,0,0,0,0,0,0,0,0,0,10000,0,0,0,10000,0,10000,10000
047184,漢唐元大94購02  ,0,0,0,0,0,0,0,0,0,10000,0,0,0,10000,0,10000,10000
047185,益航元大94購02  ,0,0,0,0,0,0,0,0,0,10000,0,0,0,10000,0,10000,10000
047284,華通統一93購03  ,0,0,0,0,0,0,0,0,0,10000,0,0,0,10000,0,10000,10000
047290,台積電元富93購04,0,0,0,0,0,0,0,0,0,10000,0,0,0,20000,10000,10000,10000
047317,聯詠元大93購06  ,0,0,0,0,0,0,0,0,0,10000,0,0,0,10000,0,10000,10000
047312,聯發科元大93購13,0,0,0,0,0,0,0,0,0,10000,0,0,0,10000,0,10000,10000
047365,隆達群益93購01  ,0,0,0,0,0,0,0,0,0,10000,0,0,0,10000,0,10000,10000
047345,鴻海凱基94購06  ,0,0,0,0,0,0,0,0,0,10000,0,0,0,10000,0,10000,10000
046962,群創中信95購03  ,0,0,0,0,0,0,0,0,0,10000,0,0,0,10000,0,10000,10000
046958,鴻海中信93購01  ,0,0,0,0,0,0,0,0,0,10000,0,0,0,10000,0,10000,10000
048577,GIS國泰94購01   ,0,0,0,0,0,0,0,0,0,10000,0,0,0,12000,2000,10000,10000
048591,台郡兆豐94購01  ,0,0,0,0,0,0,0,0,0,10000,0,0,0,40000,30000,10000,10000
049480,同欣電永豐94購01,0,0,0,0,0,0,0,0,0,10000,0,0,0,15000,5000,10000,10000
048562,宏達電元大95購01,0,0,0,0,0,0,0,0,0,10000,0,0,0,30000,20000,10000,10000
048512,全新凱基93購04  ,0,0,0,0,0,0,0,0,0,10000,0,0,0,10000,0,10000,10000
046987,智邦凱基93購04  ,0,0,0,0,0,0,0,0,0,10000,0,0,0,20000,10000,10000,10000
048503,百和元大93購02  ,0,0,0,0,0,0,0,0,0,10000,0,0,0,10000,0,10000,10000
047029,日月光元大93購01,0,0,0,0,0,0,0,0,0,10000,0,0,0,10000,0,10000,10000
050356,緯穎群益94購05  ,0,0,0,0,0,0,0,0,0,10000,0,0,0,33000,23000,10000,10000
050361,T50反1元大94購07,0,0,0,0,0,0,0,0,0,10000,0,0,0,10000,0,10000,10000
046030,南亞科元大92購04,0,0,0,0,0,0,0,0,0,10000,0,0,0,10000,0,10000,10000
046042,台勝科元大92購03,0,0,0,0,0,0,0,0,0,10000,0,0,0,10000,0,10000,10000
046074,佐登凱基92購01  ,0,0,0,0,0,0,0,0,0,10000,0,0,0,30000,20000,10000,10000
046142,康舒統一93購01  ,0,0,0,0,0,0,0,0,0,10000,0,0,0,30000,20000,10000,10000
046186,南亞科凱基92購03,0,0,0,0,0,0,0,0,0,10000,0,0,0,20000,10000,10000,10000
046191,新光金凱基98購01,0,0,0,0,0,0,0,0,0,10000,0,0,0,10000,0,10000,10000
046193,大立光凱基92購06,0,0,0,0,0,0,0,0,0,10000,0,0,0,10000,0,10000,10000
045971,智伸科凱基92購01,0,0,0,0,0,0,0,0,0,10000,0,0,0,10000,0,10000,10000
045984,亞光麥證93購02  ,0,0,0,10000,0,10000,0,0,0,10000,0,0,0,10000,0,10000,10000
046003,欣興統一92購02  ,0,0,0,0,0,0,0,0,0,10000,0,0,0,10000,0,10000,10000
046005,健策統一92購02  ,0,0,0,0,0,0,0,0,0,10000,0,0,0,10000,0,10000,10000
045898,康控元大93購04  ,0,0,0,0,0,0,0,0,0,10000,0,0,0,108000,98000,10000,10000
047832,漢唐元大94購03  ,0,0,0,0,0,0,0,0,0,10000,0,0,0,10000,0,10000,10000
045890,欣興元大92購06  ,0,0,0,0,0,0,0,0,0,10000,0,0,0,10000,0,10000,10000
046266,兆豐金凱基92購01,0,0,0,0,0,0,0,0,0,10000,0,0,0,10000,0,10000,10000
046325,日月光元大92購03,0,0,0,0,0,0,0,0,0,10000,0,0,0,10000,0,10000,10000
046366,上緯控永豐92購02,0,0,0,0,0,0,0,0,0,10000,0,0,0,10000,0,10000,10000
045799,微星亞東93購01  ,0,0,0,0,0,0,0,0,0,10000,0,0,0,10000,0,10000,10000
046376,建準凱基92購01  ,0,0,0,0,0,0,0,0,0,10000,0,0,0,10000,0,10000,10000
045710,儒鴻凱基92購02  ,0,0,0,0,0,0,0,0,0,10000,0,0,0,10000,0,10000,10000
046859,智伸科元大93購03,0,0,0,0,0,0,0,0,0,10000,0,0,0,10000,0,10000,10000
046855,嘉晶元大94購01  ,0,0,0,0,0,0,0,0,0,10000,0,0,0,10000,0,10000,10000
045826,樺漢凱基92購02  ,0,0,0,0,0,0,0,0,0,10000,0,0,0,10000,0,10000,10000
045489,晶技台新92購01  ,0,0,0,0,0,0,0,0,0,10000,0,0,0,10000,0,10000,10000
046757,漢唐凱基93購02  ,0,0,0,0,0,0,0,0,0,10000,0,0,0,21000,11000,10000,10000
045608,鴻海群益93購02  ,0,0,0,0,0,0,0,0,0,10000,0,0,0,10000,0,10000,10000
045668,奇力新元富92購01,0,0,0,0,0,0,0,0,0,10000,0,0,0,10000,0,10000,10000
046769,百和凱基93購06  ,0,0,0,0,0,0,0,0,0,10000,0,0,0,10000,0,10000,10000
046814,鴻海凱基93購20  ,0,0,0,0,0,0,0,0,0,10000,0,0,0,10000,0,10000,10000
047764,燿華元大93購03  ,0,0,0,0,0,0,0,0,0,10000,0,0,0,10000,0,10000,10000
046627,高鐵統一95購01  ,0,0,0,0,0,0,0,0,0,10000,0,0,0,10000,0,10000,10000
046619,可成凱基93購01  ,0,0,0,0,0,0,0,0,0,10000,0,0,0,20000,10000,10000,10000
046600,鴻海群益94購01  ,0,0,0,0,0,0,0,0,0,10000,0,0,0,10000,0,10000,10000
046580,正崴元大92購01  ,0,0,0,0,0,0,0,0,0,10000,0,0,0,10000,0,10000,10000
046696,可成凱基93購02  ,0,0,0,0,0,0,0,0,0,10000,0,0,0,20000,10000,10000,10000
04667P,臺股指國票94售06,0,0,0,0,0,0,0,0,0,10000,0,0,0,20000,10000,10000,10000
047641,可成元大93購09  ,0,0,0,0,0,0,0,0,0,10000,0,0,0,10000,0,10000,10000
047636,台達電元大93購03,0,0,0,0,0,0,0,0,0,10000,0,0,0,10000,0,10000,10000
047658,全新麥證93購02  ,0,0,0,50000,40000,10000,0,0,0,10000,0,0,0,50000,40000,10000,10000
04765P,宏達電永豐94售02,0,0,0,0,0,0,0,0,0,10000,0,0,0,10000,0,10000,10000
045435,鴻海統一94購01  ,0,0,0,0,0,0,0,0,0,10000,0,0,0,10000,0,10000,10000
045380,漢唐元大93購03  ,0,0,0,0,0,0,0,0,0,10000,0,0,0,10000,0,10000,10000
047696,聯發科國票94購02,0,0,0,0,0,0,0,0,0,10000,0,0,0,110000,100000,10000,10000
047702,鴻海凱基94購13  ,0,0,0,0,0,0,0,0,0,10000,0,0,0,10000,0,10000,10000
03146P,台灣50群益03售01,0,0,0,0,0,0,0,0,0,10000,0,0,0,10000,0,10000,10000
03177P,國巨群益01售12  ,0,0,0,0,0,0,0,0,0,10000,0,0,0,10000,0,10000,10000
03181P,台灣50元大01售40,0,0,0,0,0,0,0,0,0,10000,0,0,0,10000,0,10000,10000
03252P,台積電台新02售01,0,0,0,0,0,0,0,0,0,10000,0,0,0,10000,0,10000,10000
00742,新光內需收益    ,0,0,0,0,0,0,0,0,0,10000,0,0,0,10000,0,10000,10000
044698,奇力新元大93購01,0,0,0,0,0,0,0,0,0,10000,0,0,0,10000,0,10000,10000
044611,正崴兆豐92購01  ,0,0,0,0,0,0,0,0,0,10000,0,0,0,10000,0,10000,10000
044622,旺宏元大92購06  ,0,0,0,0,0,0,0,0,0,10000,0,0,0,10000,0,10000,10000
044872,旺宏統一93購02  ,0,0,0,0,0,0,0,0,0,10000,0,0,0,14000,4000,10000,10000
044887,亞光麥證93購01  ,0,0,0,10000,0,10000,0,0,0,10000,0,0,0,10000,0,10000,10000
044816,漢唐兆豐93購02  ,0,0,0,0,0,0,0,0,0,10000,0,0,0,10000,0,10000,10000
04186P,創意元富93售04  ,0,0,0,0,0,0,0,0,0,10000,0,0,0,100000,90000,10000,10000
042088,台灣50中信93購04,0,0,0,0,0,0,0,0,0,10000,0,0,0,10000,0,10000,10000
042089,台灣50中信94購03,0,0,0,0,0,0,0,0,0,10000,0,0,0,30000,20000,10000,10000
044900,建準凱基93購01  ,0,0,0,0,0,0,0,0,0,10000,0,0,0,10000,0,10000,10000
03765P,大立光元富96售01,0,0,0,0,0,0,0,0,0,10000,0,0,0,10000,0,10000,10000
03637C,臺股指凱基94牛18,0,0,0,0,0,0,0,0,0,10000,0,0,0,10000,0,10000,10000
045108,康友群益93購02  ,0,0,0,0,0,0,0,0,0,10000,0,0,0,10000,0,10000,10000
043391,康控元大94購01  ,0,0,0,0,0,0,0,0,0,10000,0,0,0,60000,50000,10000,10000
045088,康控元大94購02  ,0,0,0,0,0,0,0,0,0,10000,0,0,0,10000,0,10000,10000
043719,國巨統一93購02  ,0,0,0,0,0,0,0,0,0,10000,0,0,0,10000,0,10000,10000
043728,美律國泰93購01  ,0,0,0,0,0,0,0,0,0,10000,0,0,0,60000,50000,10000,10000
044298,南電凱基93購01  ,0,0,0,0,0,0,0,0,0,10000,0,0,0,10000,0,10000,10000
044258,超眾元大92購02  ,0,0,0,0,0,0,0,0,0,10000,0,0,0,10000,0,10000,10000
043964,台肥國泰92購01  ,0,0,0,0,0,0,0,0,0,10000,0,0,0,10000,0,10000,10000
044010,華通凱基93購01  ,0,0,0,0,0,0,0,0,0,10000,0,0,0,10000,0,10000,10000
043980,旺宏元大92購05  ,0,0,0,0,0,0,0,0,0,10000,0,0,0,10000,0,10000,10000
04398P,致伸群益94售02  ,0,0,0,0,0,0,0,0,0,10000,0,0,0,21000,11000,10000,10000
042470,元油2X元大93購04,0,0,0,0,0,0,0,0,0,10000,0,0,0,70000,60000,10000,10000
042754,元黃金元大93購01,0,0,0,0,0,0,0,0,0,10000,0,0,0,10000,0,10000,10000
04261P,大立光群益93售12,0,0,0,0,0,0,0,0,0,10000,0,0,0,10000,0,10000,10000
046379,奇力新凱基93購03,0,0,0,0,0,0,0,0,0,10000,0,0,0,10000,0,10000,10000
044400,大立光凱基92購01,0,0,0,0,0,0,0,0,0,10000,0,0,0,10000,0,10000,10000
045346,潤泰全凱基92購02,0,0,0,0,0,0,0,0,0,10000,0,0,0,10000,0,10000,10000
044512,奇力新凱基93購02,0,0,0,0,0,0,0,0,0,10000,0,0,0,10000,0,10000,10000
04452P,超眾國泰95售01  ,0,0,0,0,0,0,0,0,0,10000,0,0,0,10000,0,10000,10000
04285P,超眾永豐93售04  ,0,0,0,0,0,0,0,0,0,10000,0,0,0,10000,0,10000,10000
046522,樺漢元大92購03  ,0,0,0,0,0,0,0,0,0,10000,0,0,0,10000,0,10000,10000
046457,可成凱基92購09  ,0,0,0,0,0,0,0,0,0,10000,0,0,0,20000,10000,10000,10000
046458,大立光凱基92購11,0,0,0,0,0,0,0,0,0,10000,0,0,0,10000,0,10000,10000
047462,和鑫群益93購02  ,0,0,0,0,0,0,0,0,0,10000,0,0,0,10000,0,10000,10000
046561,可成凱基92購11  ,0,0,0,0,0,0,0,0,0,10000,0,0,0,20000,10000,10000,10000
047583,深中小永豐94購01,0,0,0,0,0,0,0,0,0,10000,0,0,0,10000,0,10000,10000
051032,南電元富95購01  ,0,0,0,0,0,0,0,0,0,10000,0,0,0,13000,3000,10000,10000
048955,慧洋康和94購01  ,0,0,0,0,0,0,0,0,0,10000,0,0,0,20000,10000,10000,10000
048939,華擎永豐94購01  ,0,0,0,0,0,0,0,0,0,10000,0,0,0,26000,16000,10000,10000
04889P,華通元大94售03  ,0,0,0,0,0,0,0,0,0,10000,0,0,0,10000,0,10000,10000
049934,緯穎元大94購08  ,0,0,0,0,0,0,0,0,0,10000,0,0,0,80000,70000,10000,10000
049931,矽力元大94購01  ,0,0,0,0,0,0,0,0,0,10000,0,0,0,10000,0,10000,10000
051056,華新科群益95購03,0,0,0,0,0,0,0,0,0,10000,0,0,0,10000,0,10000,10000
051064,鴻海國票95購01  ,0,0,0,0,0,0,0,0,0,10000,0,0,0,10000,0,10000,10000
051076,緯創國泰96購01  ,0,0,0,0,0,0,0,0,0,10000,0,0,0,10000,0,10000,10000
050572,大立光中信97購01,0,0,0,0,0,0,0,0,0,10000,0,0,0,10000,0,10000,10000
050295,大立光凱基94購16,0,0,0,0,0,0,0,0,0,10000,0,0,0,10000,0,10000,10000
050296,亞光凱基94購03  ,0,0,0,0,0,0,0,0,0,10000,0,0,0,21000,11000,10000,10000
049106,大立光富邦94購01,0,0,0,0,0,0,0,0,0,10000,0,0,0,10000,0,10000,10000
049132,大成鋼元大94購01,0,0,0,0,0,0,0,0,0,10000,0,0,0,10000,0,10000,10000
049340,鴻海統一94購03  ,0,0,0,0,0,0,0,0,0,10000,0,0,0,10000,0,10000,10000
049327,台郡元富94購01  ,0,0,0,0,0,0,0,0,0,10000,0,0,0,10000,0,10000,10000
049351,揚明光永豐94購01,0,0,0,0,0,0,0,0,0,10000,0,0,0,10000,0,10000,10000
049344,華固統一94購01  ,0,0,0,0,0,0,0,0,0,10000,0,0,0,20000,10000,10000,10000
049830,智易凱基94購02  ,0,0,0,0,0,0,0,0,0,10000,0,0,0,10000,0,10000,10000
049385,茂林元大94購03  ,0,0,0,0,0,0,0,0,0,10000,0,0,0,10000,0,10000,10000
050130,華新科凱基94購09,0,0,0,0,0,0,0,0,0,10000,0,0,0,16000,6000,10000,10000
050245,大立光凱基94購12,0,0,0,0,0,0,0,0,0,10000,0,0,0,10000,0,10000,10000
049845,台積電麥證94購01,0,0,0,40000,30000,10000,0,0,0,10000,0,0,0,40000,30000,10000,10000
04984P,臺股指康和94售04,0,0,0,0,0,0,0,0,0,10000,0,0,0,10000,0,10000,10000
049897,華新科統一94購07,0,0,0,0,0,0,0,0,0,10000,0,0,0,10000,0,10000,10000
049898,緯穎統一95購01  ,0,0,0,0,0,0,0,0,0,10000,0,0,0,10000,0,10000,10000
051312,國泰金麥證95購01,0,0,0,10000,0,10000,0,0,0,10000,0,0,0,10000,0,10000,10000
051323,康控國票96購01  ,0,0,0,0,0,0,0,0,0,10000,0,0,0,40000,30000,10000,10000
049059,超眾永豐94購01  ,0,0,0,0,0,0,0,0,0,10000,0,0,0,10000,0,10000,10000
04901P,臺股指麥證94售02,0,0,0,10000,0,10000,0,0,0,10000,0,0,0,10000,0,10000,10000
049072,台積電凱基94購08,0,0,0,0,0,0,0,0,0,10000,0,0,0,10000,0,10000,10000
048987,崇越元大94購01  ,0,0,0,0,0,0,0,0,0,10000,0,0,0,40000,30000,10000,10000
047991,元油反元大96購05,0,0,0,0,0,0,0,0,0,10000,0,0,0,10000,0,10000,10000
048018,南亞科麥證93購01,0,0,0,20000,10000,10000,0,0,0,10000,0,0,0,20000,10000,10000,10000
050657,宏達電麥證94購01,0,0,0,310000,300000,10000,0,0,0,10000,0,0,0,310000,300000,10000,10000
050658,台郡麥證96購01  ,0,0,0,10000,0,10000,0,0,0,10000,0,0,0,10000,0,10000,10000
051679,百和元大95購02  ,0,0,0,0,0,0,0,0,0,10000,0,0,0,10000,0,10000,10000
051640,GIS國票96購03   ,0,0,0,0,0,0,0,0,0,10000,0,0,0,10000,0,10000,10000
051659,力山國泰97購01  ,0,0,0,0,0,0,0,0,0,10000,0,0,0,10000,0,10000,10000
051583,可成元大95購07  ,0,0,0,0,0,0,0,0,0,10000,0,0,0,10000,0,10000,10000
051585,美食元大95購01  ,0,0,0,0,0,0,0,0,0,10000,0,0,0,10000,0,10000,10000
05160P,國巨國票96售03  ,0,0,0,0,0,0,0,0,0,10000,0,0,0,20000,10000,10000,10000
051542,南茂國票96購01  ,0,0,0,0,0,0,0,0,0,10000,0,0,0,10000,0,10000,10000
051555,聯茂永豐95購01  ,0,0,0,0,0,0,0,0,0,10000,0,0,0,10000,0,10000,10000
051556,台表科永豐96購01,0,0,0,0,0,0,0,0,0,10000,0,0,0,10000,0,10000,10000
05153P,台表科群益96售01,0,0,0,0,0,0,0,0,0,10000,0,0,0,10000,0,10000,10000
051473,台積電凱基95購10,0,0,0,0,0,0,0,0,0,10000,0,0,0,10000,0,10000,10000
051436,訊芯元富95購01  ,0,0,0,0,0,0,0,0,0,10000,0,0,0,10000,0,10000,10000
051464,彩晶國泰96購01  ,0,0,0,0,0,0,0,0,0,10000,0,0,0,10000,0,10000,10000
048405,嘉晶群益93購03  ,0,0,0,0,0,0,0,0,0,10000,0,0,0,10000,0,10000,10000
048380,T50反1國票94購02,0,0,0,0,0,0,0,0,0,10000,0,0,0,30000,20000,10000,10000
048307,道瓊指凱基93購01,0,0,0,0,0,0,0,0,0,10000,0,0,0,10000,0,10000,10000
048298,華通麥證94購01  ,0,0,0,10000,0,10000,0,0,0,10000,0,0,0,10000,0,10000,10000
048272,新光金富邦98購01,0,0,0,0,0,0,0,0,0,10000,0,0,0,10000,0,10000,10000
048054,鴻海國泰95購01  ,0,0,0,0,0,0,0,0,0,10000,0,0,0,10000,0,10000,10000
048416,台達電統一93購02,0,0,0,0,0,0,0,0,0,10000,0,0,0,30000,20000,10000,10000
048124,大立光元大95購03,0,0,0,0,0,0,0,0,0,10000,0,0,0,10000,0,10000,10000
048120,台泥元大93購02  ,0,0,0,0,0,0,0,0,0,10000,0,0,0,20000,10000,10000,10000
048135,瀚宇博國票94購01,0,0,0,0,0,0,0,0,0,10000,0,0,0,10000,0,10000,10000
051015,南亞科凱基95購04,0,0,0,0,0,0,0,0,0,10000,0,0,0,10000,0,10000,10000
051192,緯創兆豐96購01  ,0,0,0,0,0,0,0,0,0,10000,0,0,0,10000,0,10000,10000
051211,道瓊反統一95購01,0,0,0,0,0,0,0,0,0,10000,0,0,0,50000,40000,10000,10000
051249,潤泰全元大95購01,0,0,0,0,0,0,0,0,0,10000,0,0,0,68000,58000,10000,10000
048161,旺宏麥證94購01  ,0,0,0,12000,0,12000,0,0,0,10000,0,0,0,12000,2000,10000,10000
048144,華固統一93購01  ,0,0,0,0,0,0,0,0,0,10000,0,0,0,10000,0,10000,10000
048825,華新科凱基94購05,0,0,0,0,0,0,0,0,0,10000,0,0,0,17000,7000,10000,10000
048818,台達電凱基94購01,0,0,0,0,0,0,0,0,0,10000,0,0,0,10000,0,10000,10000
048820,台積電凱基94購06,0,0,0,0,0,0,0,0,0,10000,0,0,0,10000,0,10000,10000
049730,滬深2X群益94購02,0,0,0,0,0,0,0,0,0,10000,0,0,0,10000,0,10000,10000
048471,旭富永豐93購01  ,0,0,0,0,0,0,0,0,0,10000,0,0,0,10000,0,10000,10000
048496,南亞科元大93購05,0,0,0,0,0,0,0,0,0,10000,0,0,0,10000,0,10000,10000
048765,奇力新凱基94購01,0,0,0,0,0,0,0,0,0,10000,0,0,0,10000,0,10000,10000
049802,可成元大94購10  ,0,0,0,0,0,0,0,0,0,10000,0,0,0,10000,0,10000,10000
049224,致新國票95購01  ,0,0,0,0,0,0,0,0,0,10000,0,0,0,60000,50000,10000,10000
049314,京鼎凱基94購01  ,0,0,0,0,0,0,0,0,0,10000,0,0,0,10000,0,10000,10000
049315,上緯控凱基94購03,0,0,0,0,0,0,0,0,0,10000,0,0,0,10000,0,10000,10000
049415,智邦凱基94購02  ,0,0,0,0,0,0,0,0,0,10000,0,0,0,10000,0,10000,10000
049417,奇力新凱基94購02,0,0,0,0,0,0,0,0,0,10000,0,0,0,19000,9000,10000,10000
048698,宏達電國票95購01,0,0,0,0,0,0,0,0,0,10000,0,0,0,10000,0,10000,10000
04871P,力成元富94售02  ,0,0,0,0,0,0,0,0,0,10000,0,0,0,22000,12000,10000,10000
049713,鴻海凱基94購17  ,0,0,0,0,0,0,0,0,0,10000,0,0,0,30000,20000,10000,10000
049648,大立光凱基94購08,0,0,0,0,0,0,0,0,0,10000,0,0,0,10000,0,10000,10000
04965P,日月光元大94售02,0,0,0,0,0,0,0,0,0,10000,0,0,0,10000,0,10000,10000
048734,美利達麥證94購01,0,0,0,10000,0,10000,0,0,0,10000,0,0,0,10000,0,10000,10000
05018P,臺股指元大95售09,0,0,0,0,0,0,0,0,0,10000,0,0,0,15000,5000,10000,10000
05089P,亞德客元大95售01,0,0,0,0,0,0,0,0,0,10000,0,0,0,10000,0,10000,10000
050846,緯創國票96購01  ,0,0,0,0,0,0,0,0,0,10000,0,0,0,10000,0,10000,10000
04957P,上証2X凱基96售02,0,0,0,0,0,0,0,0,0,10000,0,0,0,30000,20000,10000,10000
049586,正崴元大94購01  ,0,0,0,0,0,0,0,0,0,10000,0,0,0,10000,0,10000,10000
051011,國巨凱基95購03  ,0,0,0,0,0,0,0,0,0,10000,0,0,0,10000,0,10000,10000
051014,智邦凱基95購01  ,0,0,0,0,0,0,0,0,0,10000,0,0,0,110000,100000,10000,10000
048593,華新科群益93購04,0,0,0,0,0,0,0,0,0,10000,0,0,0,27000,17000,10000,10000
050950,健鼎群益96購01  ,0,0,0,0,0,0,0,0,0,10000,0,0,0,21000,11000,10000,10000
052762,欣興群益96購01  ,0,0,0,0,0,0,0,0,0,10000,0,0,0,10000,0,10000,10000
052752,臺股指元大96購06,0,0,0,0,0,0,0,0,0,10000,0,0,0,10000,0,10000,10000
052673,T50反1國泰97購01,0,0,0,0,0,0,0,0,0,10000,0,0,0,10000,0,10000,10000
052607,大立光元大96購03,0,0,0,0,0,0,0,0,0,10000,0,0,0,12000,2000,10000,10000
052538,和大統一95購02  ,0,0,0,0,0,0,0,0,0,10000,0,0,0,40000,30000,10000,10000
052555,漢唐國票97購01  ,0,0,0,0,0,0,0,0,0,10000,0,0,0,10000,0,10000,10000
052580,高鐵元富96購01  ,0,0,0,0,0,0,0,0,0,10000,0,0,0,10000,0,10000,10000
053134,南亞科國票97購01,0,0,0,0,0,0,0,0,0,10000,0,0,0,10000,0,10000,10000
053084,國巨元大98購01  ,0,0,0,0,0,0,0,0,0,10000,0,0,0,110000,100000,10000,10000
053091,同欣電元大96購01,0,0,0,0,0,0,0,0,0,10000,0,0,0,45000,35000,10000,10000
053037,國巨凱基96購08  ,0,0,0,0,0,0,0,0,0,10000,0,0,0,10000,0,10000,10000
053030,南亞科第一96購01,0,0,0,0,0,0,0,0,0,10000,0,0,0,10000,0,10000,10000
05299P,旺宏元大95售04  ,0,0,0,0,0,0,0,0,0,10000,0,0,0,10000,0,10000,10000
052889,致伸麥證97購01  ,0,0,0,10000,0,10000,0,0,0,10000,0,0,0,10000,0,10000,10000
052880,台積電凱基96購06,0,0,0,0,0,0,0,0,0,10000,0,0,0,10000,0,10000,10000
052247,深中小永豐95購01,0,0,0,0,0,0,0,0,0,10000,0,0,0,10000,0,10000,10000
052307,潤泰全國泰96購01,0,0,0,0,0,0,0,0,0,10000,0,0,0,10000,0,10000,10000
052207,台郡中信95購02  ,0,0,0,0,0,0,0,0,0,10000,0,0,0,62000,52000,10000,10000
052445,南亞科元大95購05,0,0,0,0,0,0,0,0,0,10000,0,0,0,15000,5000,10000,10000
052426,國巨台新96購01  ,0,0,0,0,0,0,0,0,0,10000,0,0,0,10000,0,10000,10000
052437,聯發科富邦99購02,0,0,0,0,0,0,0,0,0,10000,0,0,0,20000,10000,10000,10000
052368,力成國票96購01  ,0,0,0,0,0,0,0,0,0,10000,0,0,0,10000,0,10000,10000
052399,台光電凱基95購03,0,0,0,0,0,0,0,0,0,10000,0,0,0,10000,0,10000,10000
051730,為升國票96購02  ,0,0,0,0,0,0,0,0,0,10000,0,0,0,68000,58000,10000,10000
051760,奇力新元大95購04,0,0,0,0,0,0,0,0,0,10000,0,0,0,10000,0,10000,10000
051781,緯穎群益96購01  ,0,0,0,0,0,0,0,0,0,10000,0,0,0,10000,0,10000,10000
051848,元金2X中信98購02,0,0,0,0,0,0,0,0,0,10000,0,0,0,10000,0,10000,10000
053527,創意中信97購01  ,0,0,0,0,0,0,0,0,0,10000,0,0,0,10000,0,10000,10000
05351P,臺股指元富95售05,0,0,0,0,0,0,0,0,0,10000,0,0,0,19000,9000,10000,10000
053471,正崴元大96購01  ,0,0,0,0,0,0,0,0,0,10000,0,0,0,10000,0,10000,10000
053453,新光金統一98購01,0,0,0,0,0,0,0,0,0,10000,0,0,0,10000,0,10000,10000
053479,達興元大96購01  ,0,0,0,0,0,0,0,0,0,10000,0,0,0,10000,0,10000,10000
053449,超眾凱基98購01  ,0,0,0,0,0,0,0,0,0,10000,0,0,0,30000,20000,10000,10000
053210,華邦電凱基97購02,0,0,0,0,0,0,0,0,0,10000,0,0,0,10000,0,10000,10000
053313,世紀鋼凱基96購01,0,0,0,0,0,0,0,0,0,10000,0,0,0,10000,0,10000,10000
053369,T50反1元大96購06,0,0,0,0,0,0,0,0,0,10000,0,0,0,10000,0,10000,10000
053290,元油反中信97購01,0,0,0,0,0,0,0,0,0,10000,0,0,0,10000,0,10000,10000
053853,康控國泰97購02  ,0,0,0,0,0,0,0,0,0,10000,0,0,0,40000,30000,10000,10000
053827,漢唐麥證9A購01  ,0,0,0,25000,15000,10000,0,0,0,10000,0,0,0,25000,15000,10000,10000
053609,華新中信9A購01  ,0,0,0,0,0,0,0,0,0,10000,0,0,0,10000,0,10000,10000
053591,大立光元大99購03,0,0,0,0,0,0,0,0,0,10000,0,0,0,95000,85000,10000,10000
053685,台積電元大96購18,0,0,0,0,0,0,0,0,0,10000,0,0,0,109000,99000,10000,10000
05423P,聯電亞東95售02  ,0,0,0,0,0,0,0,0,0,10000,0,0,0,10000,0,10000,10000
054230,上銀群益96購03  ,0,0,0,0,0,0,0,0,0,10000,0,0,0,11000,1000,10000,10000
054309,禾伸堂凱基98購01,0,0,0,0,0,0,0,0,0,10000,0,0,0,11000,1000,10000,10000
054304,台積電凱基96購23,0,0,0,0,0,0,0,0,0,10000,0,0,0,10000,0,10000,10000
054319,世紀鋼凱基96購02,0,0,0,0,0,0,0,0,0,10000,0,0,0,10000,0,10000,10000
05431P,台光電統一97售01,0,0,0,0,0,0,0,0,0,10000,0,0,0,11000,1000,10000,10000
054341,燿華元富96購03  ,0,0,0,0,0,0,0,0,0,10000,0,0,0,10000,0,10000,10000
054418,茂林元大97購01  ,0,0,0,0,0,0,0,0,0,10000,0,0,0,21000,11000,10000,10000
054430,上銀台新96購02  ,0,0,0,0,0,0,0,0,0,10000,0,0,0,10000,0,10000,10000
053903,燿華凱基97購01  ,0,0,0,0,0,0,0,0,0,10000,0,0,0,10000,0,10000,10000
053877,奇力新亞東96購01,0,0,0,0,0,0,0,0,0,10000,0,0,0,10000,0,10000,10000
05387P,鴻海元大95售21  ,0,0,0,0,0,0,0,0,0,10000,0,0,0,194000,184000,10000,10000
053970,聯發科元大97購08,0,0,0,0,0,0,0,0,0,10000,0,0,0,10000,0,10000,10000
054011,旺宏永豐96購05  ,0,0,0,0,0,0,0,0,0,10000,0,0,0,27000,17000,10000,10000
054091,晶豪科群益96購01,0,0,0,0,0,0,0,0,0,10000,0,0,0,16000,6000,10000,10000
054050,創意元大96購06  ,0,0,0,0,0,0,0,0,0,10000,0,0,0,45000,35000,10000,10000
054049,亞光元大96購03  ,0,0,0,0,0,0,0,0,0,10000,0,0,0,29000,19000,10000,10000
06084P,宏達電元富97售02,0,0,0,0,0,0,0,0,0,10000,0,0,0,20000,10000,10000,10000
06096P,全新永豐97售02  ,0,0,0,0,0,0,0,0,0,10000,0,0,0,18000,8000,10000,10000
06330P,南亞科群益97售03,0,0,0,0,0,0,0,0,0,10000,0,0,0,10000,0,10000,10000
06346P,聯鈞元富97售02  ,0,0,0,0,0,0,0,0,0,10000,0,0,0,10000,0,10000,10000
06415P,台積電群益97售07,0,0,0,0,0,0,0,0,0,10000,0,0,0,20000,10000,10000,10000
06485P,玉晶光群益9A售02,0,0,0,0,0,0,0,0,0,10000,0,0,0,10000,0,10000,10000
06487P,聯發科統一99售02,0,0,0,0,0,0,0,0,0,10000,0,0,0,10000,0,10000,10000
08859P,奇鋐國票03售01  ,0,0,0,0,0,0,0,0,0,10000,0,0,0,10000,0,10000,10000
2881B,富邦金乙特      ,0,0,0,0,0,0,0,0,0,10000,10000,0,10000,0,0,0,10000
2516,新建            ,24000,14000,10000,0,0,0,0,0,0,0,0,0,0,0,0,0,10000
055874,中環元富9A購01  ,0,0,0,0,0,0,0,0,0,9000,0,0,0,25000,16000,9000,9000
055989,矽力元富9A購01  ,0,0,0,0,0,0,0,0,0,9000,0,0,0,10000,1000,9000,9000
05860P,旺宏康和96售01  ,0,0,0,0,0,0,0,0,0,9000,0,0,0,9000,0,9000,9000
05750P,臺股指群益99售04,0,0,0,0,0,0,0,0,0,9000,0,0,0,9000,0,9000,9000
055215,智邦凱基98購02  ,0,0,0,0,0,0,0,0,0,9000,0,0,0,77000,68000,9000,9000
055380,智易元大98購02  ,0,0,0,0,0,0,0,0,0,9000,0,0,0,9000,0,9000,9000
055529,華邦電群益97購02,0,0,0,0,0,0,0,0,0,9000,0,0,0,9000,0,9000,9000
05577P,上銀凱基96售02  ,0,0,0,0,0,0,0,0,0,9000,0,0,0,10000,1000,9000,9000
054510,S&P反1元大98購01,0,0,0,0,0,0,0,0,0,9000,0,0,0,54000,45000,9000,9000
054568,訊芯群益97購01  ,0,0,0,0,0,0,0,0,0,9000,0,0,0,69000,60000,9000,9000
054823,祥碩元大97購02  ,0,0,0,0,0,0,0,0,0,9000,0,0,0,29000,20000,9000,9000
055099,可成日盛97購01  ,0,0,0,0,0,0,0,0,0,9000,0,0,0,9000,0,9000,9000
047547,友達凱基99購02  ,0,0,0,0,0,0,0,0,0,9000,0,0,0,10000,1000,9000,9000
046506,全新元大92購05  ,0,0,0,0,0,0,0,0,0,9000,0,0,0,10000,1000,9000,9000
047434,台積電元大93購21,0,0,0,0,0,0,0,0,0,9000,0,0,0,17000,8000,9000,9000
043344,可成富邦93購01  ,0,0,0,0,0,0,0,0,0,9000,0,0,0,9000,0,9000,9000
044963,台積電中信96購01,0,0,0,0,0,0,0,0,0,9000,0,0,0,41000,32000,9000,9000
047634,亞德客元大93購01,0,0,0,0,0,0,0,0,0,9000,0,0,0,19000,10000,9000,9000
045499,技嘉凱基92購02  ,0,0,0,0,0,0,0,0,0,9000,0,0,0,11000,2000,9000,9000
045752,全新國泰93購01  ,0,0,0,0,0,0,0,0,0,9000,0,0,0,39000,30000,9000,9000
045936,富邦金群益94購01,0,0,0,0,0,0,0,0,0,9000,0,0,0,10000,1000,9000,9000
045957,技嘉凱基93購03  ,0,0,0,0,0,0,0,0,0,9000,0,0,0,10000,1000,9000,9000
049503,矽創元大94購01  ,0,0,0,0,0,0,0,0,0,9000,0,0,0,9000,0,9000,9000
04741P,台積電統一94售10,0,0,0,0,0,0,0,0,0,9000,0,0,0,9000,0,9000,9000
050180,華新科元大95購08,0,0,0,0,0,0,0,0,0,9000,0,0,0,9000,0,9000,9000
048767,欣興凱基94購01  ,0,0,0,0,0,0,0,0,0,9000,0,0,0,30000,21000,9000,9000
049783,元油2X兆豐95購01,0,0,0,0,0,0,0,0,0,9000,0,0,0,317000,308000,9000,9000
05121P,創意國泰96售01  ,0,0,0,0,0,0,0,0,0,9000,0,0,0,31000,22000,9000,9000
051537,牧德國票96購01  ,0,0,0,0,0,0,0,0,0,9000,0,0,0,14000,5000,9000,9000
050587,緯穎國票94購02  ,0,0,0,0,0,0,0,0,0,9000,0,0,0,20000,11000,9000,9000
049373,大立光元大94購11,0,0,0,0,0,0,0,0,0,9000,0,0,0,9000,0,9000,9000
049958,華新科統一94購08,0,0,0,0,0,0,0,0,0,9000,0,0,0,14000,5000,9000,9000
049955,崇越群益95購01  ,0,0,0,0,0,0,0,0,0,9000,0,0,0,11000,2000,9000,9000
048943,智伸科永豐94購01,0,0,0,0,0,0,0,0,0,9000,0,0,0,9000,0,9000,9000
054162,光罩凱基98購01  ,0,0,0,0,0,0,0,0,0,9000,0,0,0,69000,60000,9000,9000
054133,奇力新元大97購04,0,0,0,0,0,0,0,0,0,9000,0,0,0,69000,60000,9000,9000
054369,鴻海中信9C購01  ,0,0,0,0,0,0,0,0,0,9000,0,0,0,199000,190000,9000,9000
05422P,大立光中信97售02,0,0,0,0,0,0,0,0,0,9000,0,0,0,9000,0,9000,9000
053467,鴻海元大96購20  ,0,0,0,0,0,0,0,0,0,9000,0,0,0,9000,0,9000,9000
051897,台光電國泰97購01,0,0,0,0,0,0,0,0,0,9000,0,0,0,91000,82000,9000,9000
05196P,台積電永豐95售03,0,0,0,0,0,0,0,0,0,9000,0,0,0,9000,0,9000,9000
052452,茂林元大95購03  ,0,0,0,0,0,0,0,0,0,9000,0,0,0,39000,30000,9000,9000
052601,大成鋼元大96購01,0,0,0,0,0,0,0,0,0,9000,0,0,0,9000,0,9000,9000
052829,上銀群益96購01  ,0,0,0,0,0,0,0,0,0,9000,0,0,0,9000,0,9000,9000
06481P,台積電凱基98售12,0,0,0,0,0,0,0,0,0,9000,0,0,0,9000,0,9000,9000
06354P,大立光永豐97售04,0,0,0,0,0,0,0,0,0,9000,0,0,0,45000,36000,9000,9000
06048P,大立光富邦96售05,0,0,0,0,0,0,0,0,0,9000,0,0,0,91000,82000,9000,9000
05505P,聯發科凱基96售09,0,0,0,0,0,0,0,0,0,8000,0,0,0,15000,7000,8000,8000
054847,創意兆豐97購01  ,0,0,0,0,0,0,0,0,0,8000,0,0,0,386000,378000,8000,8000
05570P,聯發科統一96售04,0,0,0,0,0,0,0,0,0,8000,0,0,0,8000,0,8000,8000
055445,旺宏統一99購01  ,0,0,0,0,0,0,0,0,0,8000,0,0,0,56000,48000,8000,8000
05924P,超眾元富96售04  ,0,0,0,0,0,0,0,0,0,8000,0,0,0,100000,92000,8000,8000
05641P,貿聯元富96售02  ,0,0,0,0,0,0,0,0,0,8000,0,0,0,39000,31000,8000,8000
056164,聯茂凱基98購03  ,0,0,0,0,0,0,0,0,0,8000,0,0,0,12000,4000,8000,8000
056117,宏達電群益97購02,0,0,0,0,0,0,0,0,0,8000,0,0,0,8000,0,8000,8000
04783P,貿聯元富94售01  ,0,0,0,0,0,0,0,0,0,8000,0,0,0,20000,12000,8000,8000
047908,南亞科元大93購02,0,0,0,0,0,0,0,0,0,8000,0,0,0,100000,92000,8000,8000
047860,臺股指國票93購15,0,0,0,0,0,0,0,0,0,8000,0,0,0,13000,5000,8000,8000
049497,茂林元大94購04  ,0,0,0,0,0,0,0,0,0,8000,0,0,0,11000,3000,8000,8000
046025,台積電元大92購18,0,0,0,0,0,0,0,0,0,8000,0,0,0,8000,0,8000,8000
046753,台積電凱基93購04,0,0,0,0,0,0,0,0,0,8000,0,0,0,34000,26000,8000,8000
046819,台中銀凱基93購01,0,0,0,0,0,0,0,0,0,8000,0,0,0,8000,0,8000,8000
00736,國泰新興市場    ,0,0,0,0,0,0,0,0,0,8000,0,0,0,147000,139000,8000,8000
04517P,宏達電群益95售01,0,0,0,0,0,0,0,0,0,8000,0,0,0,10000,2000,8000,8000
047511,義隆國票93購02  ,0,0,0,0,0,0,0,0,0,8000,0,0,0,28000,20000,8000,8000
048972,晶豪科元大94購01,0,0,0,0,0,0,0,0,0,8000,0,0,0,45000,37000,8000,8000
048912,牧德富邦94購01  ,0,0,0,0,0,0,0,0,0,8000,0,0,0,8000,0,8000,8000
049156,緯穎元大96購01  ,0,0,0,0,0,0,0,0,0,8000,0,0,0,9000,1000,8000,8000
04801P,矽力元大94售02  ,0,0,0,0,0,0,0,0,0,8000,0,0,0,8000,0,8000,8000
051352,南亞科元大95購02,0,0,0,0,0,0,0,0,0,8000,0,0,0,48000,40000,8000,8000
051484,玉晶光凱基97購01,0,0,0,0,0,0,0,0,0,8000,0,0,0,10000,2000,8000,8000
051466,玉晶光富邦97購01,0,0,0,0,0,0,0,0,0,8000,0,0,0,8000,0,8000,8000
048162,矽力麥證93購01  ,0,0,0,10000,2000,8000,0,0,0,8000,0,0,0,10000,2000,8000,8000
048789,大立光元大95購04,0,0,0,0,0,0,0,0,0,8000,0,0,0,8000,0,8000,8000
049238,元油2X元富96購08,0,0,0,0,0,0,0,0,0,8000,0,0,0,75000,67000,8000,8000
048757,美利達元富96購01,0,0,0,0,0,0,0,0,0,8000,0,0,0,28000,20000,8000,8000
050514,聯電元大94購01  ,0,0,0,0,0,0,0,0,0,8000,0,0,0,37000,29000,8000,8000
048644,華固元大93購01  ,0,0,0,0,0,0,0,0,0,8000,0,0,0,8000,0,8000,8000
052742,可成元大96購01  ,0,0,0,0,0,0,0,0,0,8000,0,0,0,95000,87000,8000,8000
052706,台虹國票97購01  ,0,0,0,0,0,0,0,0,0,8000,0,0,0,28000,20000,8000,8000
052532,台積電國泰96購07,0,0,0,0,0,0,0,0,0,8000,0,0,0,8000,0,8000,8000
052876,GIS凱基96購03   ,0,0,0,0,0,0,0,0,0,8000,0,0,0,10000,2000,8000,8000
053031,華新科第一96購01,0,0,0,0,0,0,0,0,0,8000,0,0,0,8000,0,8000,8000
05313P,臺股指群益95售12,0,0,0,0,0,0,0,0,0,8000,0,0,0,58000,50000,8000,8000
052375,奇力新元大96購02,0,0,0,0,0,0,0,0,0,8000,0,0,0,347000,339000,8000,8000
052318,友達元大98購01  ,0,0,0,0,0,0,0,0,0,8000,0,0,0,8000,0,8000,8000
052228,聯發科凱基96購06,0,0,0,0,0,0,0,0,0,8000,0,0,0,83000,75000,8000,8000
052061,樺漢國票96購01  ,0,0,0,0,0,0,0,0,0,8000,0,0,0,28000,20000,8000,8000
053187,國巨統一96購05  ,0,0,0,0,0,0,0,0,0,8000,0,0,0,55000,47000,8000,8000
053565,台光電富邦98購01,0,0,0,0,0,0,0,0,0,8000,0,0,0,8000,0,8000,8000
053703,緯穎兆豐96購01  ,0,0,0,0,0,0,0,0,0,8000,0,0,0,8000,0,8000,8000
06185P,台表科元大97售05,0,0,0,0,0,0,0,0,0,8000,0,0,0,9000,1000,8000,8000
056365,欣興元大98購01  ,0,0,0,0,0,0,0,0,0,7000,0,0,0,91000,84000,7000,7000
05786P,臺股指永昌96售03,0,0,0,0,0,0,0,0,0,7000,167000,0,167000,430000,590000,-160000,7000
056479,玉晶光元大99購05,0,0,0,0,0,0,0,0,0,7000,0,0,0,7000,0,7000,7000
056475,宏達電元大99購02,0,0,0,0,0,0,0,0,0,7000,0,0,0,54000,47000,7000,7000
056600,聯茂元富98購01  ,0,0,0,0,0,0,0,0,0,7000,0,0,0,10000,3000,7000,7000
056536,義隆凱基98購04  ,0,0,0,0,0,0,0,0,0,7000,0,0,0,20000,13000,7000,7000
056559,華通群益98購02  ,0,0,0,0,0,0,0,0,0,7000,0,0,0,11000,4000,7000,7000
055345,國巨凱基98購01  ,0,0,0,0,0,0,0,0,0,7000,0,0,0,7000,0,7000,7000
055209,勤誠康和97購01  ,0,0,0,0,0,0,0,0,0,7000,0,0,0,7000,0,7000,7000
055758,旺宏群益97購01  ,0,0,0,0,0,0,0,0,0,7000,0,0,0,37000,30000,7000,7000
055728,緯穎元大97購03  ,0,0,0,0,0,0,0,0,0,7000,0,0,0,20000,13000,7000,7000
054846,瑞昱兆豐97購01  ,0,0,0,0,0,0,0,0,0,7000,0,0,0,45000,38000,7000,7000
054724,鴻海日盛97購02  ,0,0,0,0,0,0,0,0,0,7000,0,0,0,53000,46000,7000,7000
044705,群創元大93購03  ,0,0,0,0,0,0,0,0,0,7000,0,0,0,32000,25000,7000,7000
044750,鴻海凱基93購07  ,0,0,0,0,0,0,0,0,0,7000,0,0,0,25000,18000,7000,7000
047737,義隆麥證94購01  ,0,0,0,97000,90000,7000,0,0,0,7000,0,0,0,97000,90000,7000,7000
047748,漢唐元富93購02  ,0,0,0,0,0,0,0,0,0,7000,0,0,0,17000,10000,7000,7000
045630,技嘉凱基93購02  ,0,0,0,0,0,0,0,0,0,7000,0,0,0,10000,3000,7000,7000
046588,大立光元大93購13,0,0,0,0,0,0,0,0,0,7000,0,0,0,7000,0,7000,7000
04769P,高股息元大94售01,0,0,0,0,0,0,0,0,0,7000,0,0,0,12000,5000,7000,7000
045400,康友富邦93購01  ,0,0,0,0,0,0,0,0,0,7000,0,0,0,7000,0,7000,7000
04950P,上証2X中信96售02,0,0,0,0,0,0,0,0,0,7000,0,0,0,60000,53000,7000,7000
050446,鴻海元大94購22  ,0,0,0,0,0,0,0,0,0,7000,0,0,0,7000,0,7000,7000
04709P,台積電元大94售15,0,0,0,0,0,0,0,0,0,7000,0,0,0,7000,0,7000,7000
047396,力成元大93購01  ,0,0,0,0,0,0,0,0,0,7000,0,0,0,7000,0,7000,7000
050881,大立光元富95購04,0,0,0,0,0,0,0,0,0,7000,0,0,0,7000,0,7000,7000
048697,華新科國票94購06,0,0,0,0,0,0,0,0,0,7000,0,0,0,13000,6000,7000,7000
049611,緯穎兆豐95購02  ,0,0,0,0,0,0,0,0,0,7000,0,0,0,7000,0,7000,7000
048799,台積電富邦94購03,0,0,0,0,0,0,0,0,0,7000,0,0,0,7000,0,7000,7000
048177,臺指反富邦99購01,0,0,0,0,0,0,0,0,0,7000,0,0,0,10000,3000,7000,7000
048407,貿聯群益93購04  ,0,0,0,0,0,0,0,0,0,7000,0,0,0,7000,0,7000,7000
051435,聯茂元富95購01  ,0,0,0,0,0,0,0,0,0,7000,0,0,0,47000,40000,7000,7000
051403,玉晶光永豐95購05,0,0,0,0,0,0,0,0,0,7000,0,0,0,7000,0,7000,7000
051610,GIS群益95購02   ,0,0,0,0,0,0,0,0,0,7000,0,0,0,7000,0,7000,7000
04907P,超眾國票95售01  ,0,0,0,0,0,0,0,0,0,7000,0,0,0,7000,0,7000,7000
049853,上海銀群益94購02,0,0,0,0,0,0,0,0,0,7000,0,0,0,29000,22000,7000,7000
050311,上銀兆豐95購01  ,0,0,0,0,0,0,0,0,0,7000,0,0,0,20000,13000,7000,7000
050016,緯穎富邦95購01  ,0,0,0,0,0,0,0,0,0,7000,0,0,0,16000,9000,7000,7000
053652,友達凱基98購04  ,0,0,0,0,0,0,0,0,0,7000,0,0,0,36000,29000,7000,7000
053212,友達凱基99購04  ,0,0,0,0,0,0,0,0,0,7000,0,0,0,79000,72000,7000,7000
053521,緯穎群益96購02  ,0,0,0,0,0,0,0,0,0,7000,0,0,0,56000,49000,7000,7000
054310,牧德凱基98購01  ,0,0,0,0,0,0,0,0,0,7000,0,0,0,20000,13000,7000,7000
054195,亞泥國泰98購01  ,0,0,0,0,0,0,0,0,0,7000,0,0,0,120000,113000,7000,7000
052054,台表科凱基96購01,0,0,0,0,0,0,0,0,0,7000,0,0,0,7000,0,7000,7000
051815,百和凱基96購01  ,0,0,0,0,0,0,0,0,0,7000,0,0,0,7000,0,7000,7000
052987,華新科元大99購01,0,0,0,0,0,0,0,0,0,7000,0,0,0,7000,0,7000,7000
052965,廣宇群益97購01  ,0,0,0,0,0,0,0,0,0,7000,0,0,0,17000,10000,7000,7000
052519,旺宏元大95購05  ,0,0,0,0,0,0,0,0,0,7000,0,0,0,23000,16000,7000,7000
052597,茂林群益96購01  ,0,0,0,0,0,0,0,0,0,7000,0,0,0,126000,119000,7000,7000
052731,宏達電國泰98購01,0,0,0,0,0,0,0,0,0,7000,0,0,0,33000,26000,7000,7000
06235P,國巨元大97售12  ,0,0,0,0,0,0,0,0,0,7000,0,0,0,10000,3000,7000,7000
06011P,貿聯元富96售04  ,0,0,0,0,0,0,0,0,0,7000,0,0,0,154000,147000,7000,7000
06357P,臺股指永豐97售03,0,0,0,0,0,0,0,0,0,7000,0,0,0,7000,0,7000,7000
06453P,群創元大9B售02  ,0,0,0,0,0,0,0,0,0,7000,0,0,0,20000,13000,7000,7000
2472,立隆電          ,79000,96000,-17000,0,0,0,0,0,0,24000,28000,4000,24000,0,0,0,7000
1617,榮星            ,11000,4000,7000,0,0,0,0,0,0,0,0,0,0,0,0,0,7000
054961,玉晶光元大99購01,0,0,0,0,0,0,0,0,0,6000,0,0,0,145000,139000,6000,6000
05506P,茂林凱基96售03  ,0,0,0,0,0,0,0,0,0,6000,0,0,0,6000,0,6000,6000
055110,美律凱基98購02  ,0,0,0,0,0,0,0,0,0,6000,0,0,0,16000,10000,6000,6000
055477,同欣電凱基98購01,0,0,0,0,0,0,0,0,0,6000,0,0,0,26000,20000,6000,6000
055281,台光電元大98購03,0,0,0,0,0,0,0,0,0,6000,0,0,0,6000,0,6000,6000
055314,華邦電中信99購01,0,0,0,0,0,0,0,0,0,6000,0,0,0,61000,55000,6000,6000
055329,百和國票98購01  ,0,0,0,0,0,0,0,0,0,6000,0,0,0,48000,42000,6000,6000
056450,可成凱基98購05  ,0,0,0,0,0,0,0,0,0,6000,0,0,0,6000,0,6000,6000
056649,智易凱基98購01  ,0,0,0,0,0,0,0,0,0,6000,0,0,0,12000,6000,6000,6000
056705,超眾國泰99購01  ,0,0,0,0,0,0,0,0,0,6000,0,0,0,67000,61000,6000,6000
056694,欣興群益98購04  ,0,0,0,0,0,0,0,0,0,6000,0,0,0,6000,0,6000,6000
05785P,臺股指元大96售19,0,0,0,0,0,0,0,0,0,6000,0,0,0,6000,0,6000,6000
05878P,創意群益98售01  ,0,0,0,0,0,0,0,0,0,6000,0,0,0,11000,5000,6000,6000
05967P,臺股指麥證96售02,0,0,0,6000,0,6000,0,0,0,6000,0,0,0,6000,0,6000,6000
056412,上証2X中信9A購02,0,0,0,0,0,0,0,0,0,6000,0,0,0,6000,0,6000,6000
056407,嘉晶國票99購01  ,0,0,0,0,0,0,0,0,0,6000,0,0,0,13000,7000,6000,6000
047332,訊芯元大93購04  ,0,0,0,0,0,0,0,0,0,6000,0,0,0,6000,0,6000,6000
046941,瑞昱元大93購08  ,0,0,0,0,0,0,0,0,0,6000,0,0,0,6000,0,6000,6000
050704,復盛凱基94購03  ,0,0,0,0,0,0,0,0,0,6000,0,0,0,11000,5000,6000,6000
047699,亞德客凱基93購04,0,0,0,0,0,0,0,0,0,6000,0,0,0,26000,20000,6000,6000
047651,復盛元大93購01  ,0,0,0,0,0,0,0,0,0,6000,0,0,0,6000,0,6000,6000
045500,聯發科凱基93購04,0,0,0,0,0,0,0,0,0,6000,0,0,0,12000,6000,6000,6000
046172,美律永豐92購01  ,0,0,0,0,0,0,0,0,0,6000,0,0,0,6000,0,6000,6000
045774,義隆元大92購02  ,0,0,0,0,0,0,0,0,0,6000,0,0,0,96000,90000,6000,6000
046350,上銀群益92購02  ,0,0,0,0,0,0,0,0,0,6000,0,0,0,6000,0,6000,6000
046345,世紀鋼國票93購01,0,0,0,0,0,0,0,0,0,6000,0,0,0,6000,0,6000,6000
046268,嘉晶凱基93購02  ,0,0,0,0,0,0,0,0,0,6000,0,0,0,6000,0,6000,6000
03351P,台積電麥證02售07,0,0,0,0,0,0,0,0,0,6000,0,0,0,6000,0,6000,6000
03673P,康控元富92售02  ,0,0,0,0,0,0,0,0,0,6000,0,0,0,6000,0,6000,6000
00732,國泰RMB短期報酬 ,0,0,0,0,0,0,0,0,0,6000,0,0,0,107000,101000,6000,6000
00852L,國泰美國道瓊正2 ,0,0,0,0,0,0,0,0,0,6000,0,0,0,205000,199000,6000,6000
0054,元大台商50      ,0,0,0,0,0,0,0,0,0,6000,0,0,0,6000,0,6000,6000
03155P,玉晶光群益01售08,0,0,0,0,0,0,0,0,0,6000,0,0,0,6000,0,6000,6000
04023P,臺股指元富99售02,0,0,0,0,0,0,0,0,0,6000,0,0,0,26000,20000,6000,6000
04267P,康控元富93售04  ,0,0,0,0,0,0,0,0,0,6000,0,0,0,6000,0,6000,6000
044126,奇力新凱基93購01,0,0,0,0,0,0,0,0,0,6000,0,0,0,12000,6000,6000,6000
051083,A50正2元大98購01,0,0,0,0,0,0,0,0,0,6000,0,0,0,11000,5000,6000,6000
049138,台積電元大94購05,0,0,0,0,0,0,0,0,0,6000,0,0,0,263000,257000,6000,6000
049103,易華電國泰96購01,0,0,0,0,0,0,0,0,0,6000,0,0,0,6000,0,6000,6000
049013,川湖群益94購01  ,0,0,0,0,0,0,0,0,0,6000,0,0,0,25000,19000,6000,6000
05130P,聯發科統一95售03,0,0,0,0,0,0,0,0,0,6000,0,0,0,6000,0,6000,6000
050642,和大凱基94購03  ,0,0,0,0,0,0,0,0,0,6000,0,0,0,67000,61000,6000,6000
051725,緯穎永豐95購02  ,0,0,0,0,0,0,0,0,0,6000,0,0,0,28000,22000,6000,6000
048683,日月光富邦93購01,0,0,0,0,0,0,0,0,0,6000,0,0,0,6000,0,6000,6000
048719,亞光永豐94購01  ,0,0,0,0,0,0,0,0,0,6000,0,0,0,23000,17000,6000,6000
048668,奇力新永豐93購04,0,0,0,0,0,0,0,0,0,6000,0,0,0,20000,14000,6000,6000
052536,聯茂國泰97購01  ,0,0,0,0,0,0,0,0,0,6000,0,0,0,6000,0,6000,6000
052543,聯詠元富95購01  ,0,0,0,0,0,0,0,0,0,6000,0,0,0,30000,24000,6000,6000
052929,可成元大96購02  ,0,0,0,0,0,0,0,0,0,6000,0,0,0,166000,160000,6000,6000
053054,禾伸堂國票97購01,0,0,0,0,0,0,0,0,0,6000,0,0,0,10000,4000,6000,6000
053065,大立光群益96購01,0,0,0,0,0,0,0,0,0,6000,0,0,0,26000,20000,6000,6000
053089,貿聯元大97購02  ,0,0,0,0,0,0,0,0,0,6000,0,0,0,109000,103000,6000,6000
051808,美律凱基96購02  ,0,0,0,0,0,0,0,0,0,6000,0,0,0,6000,0,6000,6000
051911,大立光元大98購02,0,0,0,0,0,0,0,0,0,6000,0,0,0,53000,47000,6000,6000
051864,聯發科凱基96購03,0,0,0,0,0,0,0,0,0,6000,0,0,0,6000,0,6000,6000
052257,燿華國泰96購01  ,0,0,0,0,0,0,0,0,0,6000,0,0,0,6000,0,6000,6000
054451,上銀亞東98購01  ,0,0,0,0,0,0,0,0,0,6000,0,0,0,11000,5000,6000,6000
053594,京鼎元大96購02  ,0,0,0,0,0,0,0,0,0,6000,0,0,0,102000,96000,6000,6000
053715,美律凱基96購04  ,0,0,0,0,0,0,0,0,0,6000,0,0,0,6000,0,6000,6000
053754,英業達元富96購02,0,0,0,0,0,0,0,0,0,6000,0,0,0,13000,7000,6000,6000
3669,圓展            ,3000,22000,-19000,0,0,0,25000,0,25000,0,0,0,0,0,0,0,6000
1474,弘裕            ,32000,25000,7000,0,0,0,0,0,0,-1000,0,1000,-1000,0,0,0,6000
06035P,同欣電凱基96售03,0,0,0,0,0,0,0,0,0,6000,0,0,0,6000,0,6000,6000
06090P,旺宏統一97售06  ,0,0,0,0,0,0,0,0,0,6000,0,0,0,46000,40000,6000,6000
056325,群創兆豐9A購01  ,0,0,0,0,0,0,0,0,0,5000,0,0,0,85000,80000,5000,5000
056309,合勤控元大97購01,0,0,0,0,0,0,0,0,0,5000,0,0,0,5000,0,5000,5000
056134,可成元大97購06  ,0,0,0,0,0,0,0,0,0,5000,0,0,0,19000,14000,5000,5000
05621P,聯電中信96售01  ,0,0,0,0,0,0,0,0,0,5000,0,0,0,23000,18000,5000,5000
05773P,臺股指凱基99售03,0,0,0,0,0,0,0,0,0,5000,0,0,0,5000,0,5000,5000
05801P,正崴兆豐96售01  ,0,0,0,0,0,0,0,0,0,5000,0,0,0,10000,5000,5000,5000
05830P,滬深2X元富99售03,0,0,0,0,0,0,0,0,0,5000,0,0,0,5000,0,5000,5000
05833P,臺股指元富96售05,0,0,0,0,0,0,0,0,0,5000,0,0,0,5000,0,5000,5000
05842P,台積電元大96售15,0,0,0,0,0,0,0,0,0,5000,0,0,0,34000,29000,5000,5000
056472,美律元大99購03  ,0,0,0,0,0,0,0,0,0,5000,0,0,0,5000,0,5000,5000
056514,訊芯亞東99購01  ,0,0,0,0,0,0,0,0,0,5000,0,0,0,5000,0,5000,5000
056567,瀚宇博群益98購02,0,0,0,0,0,0,0,0,0,5000,0,0,0,5000,0,5000,5000
055384,緯穎元大98購02  ,0,0,0,0,0,0,0,0,0,5000,0,0,0,129000,124000,5000,5000
055305,旺宏群益99購01  ,0,0,0,0,0,0,0,0,0,5000,0,0,0,18000,13000,5000,5000
055271,鴻海元大98購03  ,0,0,0,0,0,0,0,0,0,5000,0,0,0,5000,0,5000,5000
05572P,群創統一96售02  ,0,0,0,0,0,0,0,0,0,5000,0,0,0,5000,0,5000,5000
055643,宏碁元富97購01  ,0,0,0,0,0,0,0,0,0,5000,0,0,0,10000,5000,5000,5000
054941,凱美元大97購01  ,0,0,0,0,0,0,0,0,0,5000,0,0,0,5000,0,5000,5000
054728,聯發科日盛97購01,0,0,0,0,0,0,0,0,0,5000,0,0,0,5000,0,5000,5000
05479P,華新科台新96售01,0,0,0,0,0,0,0,0,0,5000,0,0,0,15000,10000,5000,5000
054518,亞光元大97購01  ,0,0,0,0,0,0,0,0,0,5000,0,0,0,8000,3000,5000,5000
05466P,旺宏富邦97售01  ,0,0,0,0,0,0,0,0,0,5000,0,0,0,5000,0,5000,5000
046509,中壽元大92購01  ,0,0,0,0,0,0,0,0,0,5000,0,0,0,5000,0,5000,5000
047616,鴻海凱基94購10  ,0,0,0,0,0,0,0,0,0,5000,0,0,0,5000,0,5000,5000
043051,天鈺國泰93購01  ,0,0,0,0,0,0,0,0,0,5000,0,0,0,5000,0,5000,5000
044430,上銀元大92購03  ,0,0,0,0,0,0,0,0,0,5000,0,0,0,5000,0,5000,5000
044439,南電元大93購01  ,0,0,0,0,0,0,0,0,0,5000,0,0,0,5000,0,5000,5000
040381,元金2X元富95購01,0,0,0,0,0,0,0,0,0,5000,0,0,0,5000,0,5000,5000
03981P,嘉澤凱基93售02  ,0,0,0,0,0,0,0,0,0,5000,0,0,0,5000,0,5000,5000
03946P,麗豐群益93售02  ,0,0,0,0,0,0,0,0,0,5000,0,0,0,7000,2000,5000,5000
03039X,元展36          ,0,0,0,0,0,0,0,0,0,5000,0,0,0,5000,0,5000,5000
03199P,台積電統一01售16,0,0,0,0,0,0,0,0,0,5000,0,0,0,80000,75000,5000,5000
04116P,京元電元大94售02,0,0,0,0,0,0,0,0,0,5000,0,0,0,6000,1000,5000,5000
00683L,元大美元指數正2 ,0,60000,-60000,0,0,0,0,0,0,65000,0,0,0,65000,0,65000,5000
00866,新光Shiller CAPE,0,0,0,0,0,0,0,0,0,5000,0,0,0,34000,29000,5000,5000
00753L,中信中國50正2   ,0,0,0,0,0,0,0,0,0,5000,0,0,0,84000,79000,5000,5000
04455P,台積電統一94售07,0,0,0,0,0,0,0,0,0,5000,0,0,0,5000,0,5000,5000
03419P,玉晶光群益03售04,0,0,0,0,0,0,0,0,0,5000,0,0,0,5000,0,5000,5000
03350P,台積電麥證02售06,0,0,0,0,0,0,0,0,0,5000,0,0,0,5000,0,5000,5000
03304P,欣興元富02售02  ,0,0,0,0,0,0,0,0,0,5000,0,0,0,5000,0,5000,5000
03591P,台積電國票03售10,0,0,0,0,0,0,0,0,0,5000,0,0,0,5000,0,5000,5000
045786,台勝科元大92購02,0,0,0,0,0,0,0,0,0,5000,0,0,0,5000,0,5000,5000
045721,中信金凱基92購01,0,0,0,0,0,0,0,0,0,5000,0,0,0,15000,10000,5000,5000
046103,麗豐永豐92購01  ,0,0,0,0,0,0,0,0,0,5000,0,0,0,5000,0,5000,5000
046104,智伸科永豐92購02,0,0,0,0,0,0,0,0,0,5000,0,0,0,5000,0,5000,5000
046069,禾伸堂凱基92購01,0,0,0,0,0,0,0,0,0,5000,0,0,0,33000,28000,5000,5000
04595P,臺股指元大94售13,0,0,0,0,0,0,0,0,0,5000,0,0,0,21000,16000,5000,5000
046007,緯穎統一92購02  ,0,0,0,0,0,0,0,0,0,5000,0,0,0,5000,0,5000,5000
04555P,元油2X群益95售01,0,0,0,0,0,0,0,0,0,5000,0,0,0,5000,0,5000,5000
047774,台表科元大95購01,0,0,0,0,0,0,0,0,0,5000,0,0,0,5000,0,5000,5000
050425,國巨凱基94購12  ,0,0,0,0,0,0,0,0,0,5000,0,0,0,5000,0,5000,5000
050359,T50反1元大94購05,0,0,0,0,0,0,0,0,0,5000,0,0,0,5000,0,5000,5000
047026,大毅元大93購02  ,0,0,0,0,0,0,0,0,0,5000,0,0,0,5000,0,5000,5000
047020,智邦元大93購04  ,0,0,0,0,0,0,0,0,0,5000,0,0,0,101000,96000,5000,5000
047842,聯茂元大93購06  ,0,0,0,0,0,0,0,0,0,5000,0,0,0,5000,0,5000,5000
047086,群創統一93購03  ,0,0,0,0,0,0,0,0,0,5000,0,0,0,5000,0,5000,5000
047339,臺股指元大93購34,0,0,0,0,0,0,0,0,0,5000,0,0,0,5000,0,5000,5000
047380,統一元大93購01  ,0,0,0,0,0,0,0,0,0,5000,0,0,0,90000,85000,5000,5000
047280,泰鼎永豐93購01  ,0,0,0,0,0,0,0,0,0,5000,0,0,0,10000,5000,5000,5000
048629,滬深2X元大96購04,0,0,0,0,0,0,0,0,0,5000,0,0,0,10000,5000,5000,5000
050785,全新國泰96購01  ,0,0,0,0,0,0,0,0,0,5000,0,0,0,30000,25000,5000,5000
050540,台積電凱基94購38,0,0,0,0,0,0,0,0,0,5000,0,0,0,5000,0,5000,5000
050181,富邦金元大94購02,0,0,0,0,0,0,0,0,0,5000,0,0,0,5000,0,5000,5000
048334,A50正2元大96購01,0,0,0,0,0,0,0,0,0,5000,0,0,0,5000,0,5000,5000
048118,百和群益94購03  ,0,0,0,0,0,0,0,0,0,5000,0,0,0,15000,10000,5000,5000
048192,華通元大96購01  ,0,0,0,0,0,0,0,0,0,5000,0,0,0,41000,36000,5000,5000
048766,禾伸堂凱基94購01,0,0,0,0,0,0,0,0,0,5000,0,0,0,23000,18000,5000,5000
049803,華新科元大95購07,0,0,0,0,0,0,0,0,0,5000,0,0,0,10000,5000,5000,5000
051519,國泰金凱基95購02,0,0,0,0,0,0,0,0,0,5000,0,0,0,5000,0,5000,5000
050618,緯創元大95購01  ,0,0,0,0,0,0,0,0,0,5000,0,0,0,5000,0,5000,5000
048985,茂林元大94購01  ,0,0,0,0,0,0,0,0,0,5000,0,0,0,17000,12000,5000,5000
04988P,楠梓電元大94售01,0,0,0,0,0,0,0,0,0,5000,0,0,0,10000,5000,5000,5000
050069,禾伸堂凱基94購04,0,0,0,0,0,0,0,0,0,5000,0,0,0,6000,1000,5000,5000
05024P,華通國票96售01  ,0,0,0,0,0,0,0,0,0,5000,0,0,0,5000,0,5000,5000
050282,T50反1凱基97購01,0,0,0,0,0,0,0,0,0,5000,0,0,0,10000,5000,5000,5000
050125,中環凱基94購01  ,0,0,0,0,0,0,0,0,0,5000,0,0,0,5000,0,5000,5000
050210,華新科國票94購08,0,0,0,0,0,0,0,0,0,5000,0,0,0,10000,5000,5000,5000
051080,全新富邦96購01  ,0,0,0,0,0,0,0,0,0,5000,0,0,0,5000,0,5000,5000
048888,牧德元富94購02  ,0,0,0,0,0,0,0,0,0,5000,0,0,0,19000,14000,5000,5000
051075,智邦國泰97購01  ,0,0,0,0,0,0,0,0,0,5000,0,0,0,47000,42000,5000,5000
048862,中磊群益94購01  ,0,0,0,0,0,0,0,0,0,5000,0,0,0,5000,0,5000,5000
051059,康普群益95購01  ,0,0,0,0,0,0,0,0,0,5000,0,0,0,5000,0,5000,5000
050048,百和國票94購01  ,0,0,0,0,0,0,0,0,0,5000,0,0,0,25000,20000,5000,5000
053784,奇力新元大97購02,0,0,0,0,0,0,0,0,0,5000,0,0,0,12000,7000,5000,5000
053607,大立光第一96購01,0,0,0,0,0,0,0,0,0,5000,0,0,0,5000,0,5000,5000
053504,祥碩兆豐96購01  ,0,0,0,0,0,0,0,0,0,5000,0,0,0,5000,0,5000,5000
053498,大立光兆豐96購03,0,0,0,0,0,0,0,0,0,5000,0,0,0,5000,0,5000,5000
053193,超眾統一97購01  ,0,0,0,0,0,0,0,0,0,5000,0,0,0,5000,0,5000,5000
054069,亞光國泰98購01  ,0,0,0,0,0,0,0,0,0,5000,0,0,0,49000,44000,5000,5000
054106,元油反凱基9C購01,0,0,0,0,0,0,0,0,0,5000,0,0,0,5000,0,5000,5000
054026,台積電凱基97購08,0,0,0,0,0,0,0,0,0,5000,0,0,0,10000,5000,5000,5000
052141,百和凱基95購02  ,0,0,0,0,0,0,0,0,0,5000,0,0,0,5000,0,5000,5000
052065,臺股指國票95購12,0,0,0,0,0,0,0,0,0,5000,0,0,0,5000,0,5000,5000
053035,台表科兆豐97購01,0,0,0,0,0,0,0,0,0,5000,0,0,0,5000,0,5000,5000
053129,緯穎凱基96購01  ,0,0,0,0,0,0,0,0,0,5000,0,0,0,19000,14000,5000,5000
06310P,精元元富97售02  ,0,0,0,0,0,0,0,0,0,5000,0,0,0,5000,0,5000,5000
06251P,臺股指永昌97售03,0,0,0,0,0,0,0,0,0,5000,0,0,0,5000,0,5000,5000
06277P,臺股指凱基97售09,0,0,0,0,0,0,0,0,0,5000,0,0,0,191000,186000,5000,5000
08465P,玉晶光兆豐01售02,0,0,0,0,0,0,0,0,0,5000,0,0,0,5000,0,5000,5000
08469P,富邦金凱基9C售01,0,0,0,0,0,0,0,0,0,5000,0,0,0,5000,0,5000,5000
4133,亞諾法          ,49000,44000,5000,0,0,0,0,0,0,0,0,0,0,0,0,0,5000
054528,台光電統一96購02,0,0,0,0,0,0,0,0,0,4000,0,0,0,52000,48000,4000,4000
054496,為升永豐96購01  ,0,0,0,0,0,0,0,0,0,4000,0,0,0,4000,0,4000,4000
054786,全新群益99購02  ,0,0,0,0,0,0,0,0,0,4000,0,0,0,53000,49000,4000,4000
054866,宏盛群益98購01  ,0,0,0,0,0,0,0,0,0,4000,0,0,0,4000,0,4000,4000
05484P,台積電凱基95售18,0,0,0,0,0,0,0,0,0,4000,0,0,0,58000,54000,4000,4000
056571,燿華元大98購02  ,0,0,0,0,0,0,0,0,0,4000,0,0,0,72000,68000,4000,4000
05661P,聯發科統一96售06,0,0,0,0,0,0,0,0,0,4000,0,0,0,4000,0,4000,4000
05863P,滬深2X元大96售09,0,0,0,0,0,0,0,0,0,4000,0,0,0,4000,0,4000,4000
05779P,台積電統一96售06,0,0,0,0,0,0,0,0,0,4000,0,0,0,4000,0,4000,4000
056351,鴻海元大98購06  ,0,0,0,0,0,0,0,0,0,4000,0,0,0,4000,0,4000,4000
056419,欣興元富98購02  ,0,0,0,0,0,0,0,0,0,4000,0,0,0,9000,5000,4000,4000
056046,百和凱基97購01  ,0,0,0,0,0,0,0,0,0,4000,0,0,0,5000,1000,4000,4000
047213,新日興富邦97購01,0,0,0,0,0,0,0,0,0,4000,0,0,0,113000,109000,4000,4000
047372,創意國票94購01  ,0,0,0,0,0,0,0,0,0,4000,0,0,0,4000,0,4000,4000
047360,鴻海群益95購02  ,0,0,0,0,0,0,0,0,0,4000,0,0,0,4000,0,4000,4000
049505,臺股指元大94購16,0,0,0,0,0,0,0,0,0,4000,0,0,0,4000,0,4000,4000
050463,百和元大94購04  ,0,0,0,0,0,0,0,0,0,4000,0,0,0,4000,0,4000,4000
046758,聯發科凱基93購05,0,0,0,0,0,0,0,0,0,4000,0,0,0,34000,30000,4000,4000
046659,瑞昱元大93購02  ,0,0,0,0,0,0,0,0,0,4000,0,0,0,4000,0,4000,4000
046215,大立光統一92購03,0,0,0,0,0,0,0,0,0,4000,0,0,0,4000,0,4000,4000
00691R,兆豐藍籌30反1   ,0,0,0,0,0,0,0,0,0,4000,0,0,0,5000,1000,4000,4000
00685L,群益臺灣加權正2 ,0,0,0,0,0,0,0,0,0,4000,0,0,0,20000,16000,4000,4000
0053,元大電子        ,0,0,0,0,0,0,0,0,0,4000,0,0,0,16000,12000,4000,4000
04061P,臺股指群益93售15,0,0,0,0,0,0,0,0,0,4000,0,0,0,4000,0,4000,4000
03243P,台積電統一02售08,0,0,0,0,0,0,0,0,0,4000,0,0,0,5000,1000,4000,4000
03148P,聯電群益03售04  ,0,0,0,0,0,0,0,0,0,4000,0,0,0,4000,0,4000,4000
04003P,麗豐凱基94售03  ,0,0,0,0,0,0,0,0,0,4000,0,0,0,6000,2000,4000,4000
046404,友達元大93購02  ,0,0,0,0,0,0,0,0,0,4000,0,0,0,4000,0,4000,4000
04643P,京元電凱基94售02,0,0,0,0,0,0,0,0,0,4000,0,0,0,5000,1000,4000,4000
044061,聯發科元大92購03,0,0,0,0,0,0,0,0,0,4000,0,0,0,4000,0,4000,4000
049977,瑞昱凱基94購03  ,0,0,0,0,0,0,0,0,0,4000,0,0,0,4000,0,4000,4000
050141,國巨統一94購07  ,0,0,0,0,0,0,0,0,0,4000,0,0,0,4000,0,4000,4000
050076,百和凱基94購02  ,0,0,0,0,0,0,0,0,0,4000,0,0,0,4000,0,4000,4000
050595,緯穎永豐94購03  ,0,0,0,0,0,0,0,0,0,4000,0,0,0,27000,23000,4000,4000
050606,劍麟元大94購02  ,0,0,0,0,0,0,0,0,0,4000,0,0,0,4000,0,4000,4000
049044,和碩兆豐94購01  ,0,0,0,0,0,0,0,0,0,4000,0,0,0,4000,0,4000,4000
05141P,華通台新96售01  ,0,0,0,0,0,0,0,0,0,4000,0,0,0,22000,18000,4000,4000
050550,大立光凱基95購04,0,0,0,0,0,0,0,0,0,4000,0,0,0,4000,0,4000,4000
048199,大立光元大94購03,0,0,0,0,0,0,0,0,0,4000,0,0,0,4000,0,4000,4000
049629,臺股指群益94購02,0,0,0,0,0,0,0,0,0,4000,0,0,0,4000,0,4000,4000
049725,台郡國票94購03  ,0,0,0,0,0,0,0,0,0,4000,0,0,0,4000,0,4000,4000
049680,臺股指國票94購13,0,0,0,0,0,0,0,0,0,4000,0,0,0,6000,2000,4000,4000
053175,矽力群益96購01  ,0,0,0,0,0,0,0,0,0,4000,0,0,0,5000,1000,4000,4000
053076,貿聯永豐96購01  ,0,0,0,0,0,0,0,0,0,4000,0,0,0,14000,10000,4000,4000
051833,昇陽半元大96購01,0,0,0,0,0,0,0,0,0,4000,0,0,0,104000,100000,4000,4000
052176,景碩元大96購01  ,0,0,0,0,0,0,0,0,0,4000,0,0,0,98000,94000,4000,4000
05230P,京元電群益95售01,0,0,0,0,0,0,0,0,0,4000,0,0,0,15000,11000,4000,4000
054102,百和國票97購04  ,0,0,0,0,0,0,0,0,0,4000,0,0,0,26000,22000,4000,4000
054104,T50反1凱基9A購02,0,0,0,0,0,0,0,0,0,4000,0,0,0,179000,175000,4000,4000
054385,矽創群益98購01  ,0,0,0,0,0,0,0,0,0,4000,0,0,0,261000,257000,4000,4000
054413,台光電元大96購03,0,0,0,0,0,0,0,0,0,4000,0,0,0,4000,0,4000,4000
054318,台虹凱基98購01  ,0,0,0,0,0,0,0,0,0,4000,0,0,0,69000,65000,4000,4000
054241,深中小元大98購01,0,0,0,0,0,0,0,0,0,4000,0,0,0,554000,550000,4000,4000
05382P,電子類群益95售02,0,0,0,0,0,0,0,0,0,4000,0,0,0,4000,0,4000,4000
06369P,台積電凱基97售16,0,0,0,0,0,0,0,0,0,4000,0,0,0,4000,0,4000,4000
06260P,臺股指群益97售13,0,0,0,0,0,0,0,0,0,4000,0,0,0,10000,6000,4000,4000
06305P,臺股指元大97售11,0,0,0,0,0,0,0,0,0,4000,0,0,0,23000,19000,4000,4000
06340P,鴻海統一98售06  ,0,0,0,0,0,0,0,0,0,4000,0,0,0,4000,0,4000,4000
06165P,臺股指凱基9A售03,0,0,0,0,0,0,0,0,0,4000,0,0,0,4000,0,4000,4000
5484,慧友            ,20000,16000,4000,0,0,0,0,0,0,0,0,0,0,0,0,0,4000
056080,世紀鋼元大97購03,0,0,0,0,0,0,0,0,0,3000,0,0,0,3000,0,3000,3000
055790,南電凱基97購01  ,0,0,0,0,0,0,0,0,0,3000,0,0,0,224000,221000,3000,3000
056442,瑞昱凱基98購02  ,0,0,0,0,0,0,0,0,0,3000,0,0,0,57000,54000,3000,3000
056352,鴻海元大99購01  ,0,0,0,0,0,0,0,0,0,3000,0,0,0,11000,8000,3000,3000
056132,台光電元大97購03,0,0,0,0,0,0,0,0,0,3000,0,0,0,3000,0,3000,3000
056655,旺宏元大99購02  ,0,0,0,0,0,0,0,0,0,3000,0,0,0,66000,63000,3000,3000
056685,光罩統一98購03  ,0,0,0,0,0,0,0,0,0,3000,0,0,0,71000,68000,3000,3000
055149,國巨元大97購06  ,0,0,0,0,0,0,0,0,0,3000,0,0,0,3000,0,3000,3000
054710,東元元富97購01  ,0,0,0,0,0,0,0,0,0,3000,0,0,0,100000,97000,3000,3000
043660,華新科元大93購01,0,0,0,0,0,0,0,0,0,3000,0,0,0,3000,0,3000,3000
046567,正崴元富92購01  ,0,0,0,0,0,0,0,0,0,3000,0,0,0,3000,0,3000,3000
00654R,富邦印度反1     ,0,9000,-9000,0,0,0,0,0,0,12000,0,0,0,17000,5000,12000,3000
00700,富邦恒生國企    ,0,0,0,0,0,0,0,0,0,3000,0,0,0,103000,100000,3000,3000
00735,國泰臺韓科技    ,0,0,0,0,0,0,0,0,0,3000,0,0,0,329000,326000,3000,3000
00711B,FH彭博新興債    ,0,0,0,0,0,0,0,0,0,3000,0,0,0,103000,100000,3000,3000
03369P,景碩中信02售01  ,0,0,0,0,0,0,0,0,0,3000,0,0,0,3000,0,3000,3000
036628,統一台新99購01  ,0,0,0,0,0,0,0,0,0,3000,0,0,0,3000,0,3000,3000
03740P,奇鋐群益94售01  ,0,0,0,0,0,0,0,0,0,3000,0,0,0,3000,0,3000,3000
046351,智邦群益92購01  ,0,0,0,0,0,0,0,0,0,3000,0,0,0,3000,0,3000,3000
04583P,滬深2X永豐94售06,0,0,0,0,0,0,0,0,0,3000,0,0,0,3000,0,3000,3000
046880,瑞昱永昌93購01  ,0,0,0,0,0,0,0,0,0,3000,0,0,0,3000,0,3000,3000
046625,勤誠凱基93購01  ,0,0,0,0,0,0,0,0,0,3000,0,0,0,44000,41000,3000,3000
046695,瑞昱凱基93購03  ,0,0,0,0,0,0,0,0,0,3000,0,0,0,33000,30000,3000,3000
045436,友達統一93購02  ,0,0,0,0,0,0,0,0,0,3000,0,0,0,3000,0,3000,3000
047765,瑞昱元大93購12  ,0,0,0,0,0,0,0,0,0,3000,0,0,0,3000,0,3000,3000
050697,冠德凱基96購01  ,0,0,0,0,0,0,0,0,0,3000,0,0,0,3000,0,3000,3000
047040,台勝科群益93購01,0,0,0,0,0,0,0,0,0,3000,0,0,0,3000,0,3000,3000
047374,麗豐國票93購01  ,0,0,0,0,0,0,0,0,0,3000,0,0,0,15000,12000,3000,3000
047239,瀚宇博凱基94購01,0,0,0,0,0,0,0,0,0,3000,0,0,0,7000,4000,3000,3000
046901,英業達凱基93購02,0,0,0,0,0,0,0,0,0,3000,0,0,0,3000,0,3000,3000
050525,嘉晶元大95購02  ,0,0,0,0,0,0,0,0,0,3000,0,0,0,5000,2000,3000,3000
05054P,臻鼎群益95售02  ,0,0,0,0,0,0,0,0,0,3000,0,0,0,13000,10000,3000,3000
050799,嘉聯益中信98購01,0,0,0,0,0,0,0,0,0,3000,0,0,0,3000,0,3000,3000
048605,百和國票93購02  ,0,0,0,0,0,0,0,0,0,3000,0,0,0,3000,0,3000,3000
048084,華通凱基93購05  ,0,0,0,0,0,0,0,0,0,3000,0,0,0,19000,16000,3000,3000
048495,南亞科元大93購04,0,0,0,0,0,0,0,0,0,3000,0,0,0,3000,0,3000,3000
048491,A50元大93購01   ,0,0,0,0,0,0,0,0,0,3000,0,0,0,3000,0,3000,3000
04977P,力成凱基96售01  ,0,0,0,0,0,0,0,0,0,3000,0,0,0,3000,0,3000,3000
049166,元油2X凱基97購02,0,0,0,0,0,0,0,0,0,3000,0,0,0,3000,0,3000,3000
049312,亞光凱基94購02  ,0,0,0,0,0,0,0,0,0,3000,0,0,0,13000,10000,3000,3000
051416,創意國票96購02  ,0,0,0,0,0,0,0,0,0,3000,0,0,0,53000,50000,3000,3000
051471,國巨凱基97購01  ,0,0,0,0,0,0,0,0,0,3000,0,0,0,4000,1000,3000,3000
05025P,聯發科群益95售02,0,0,0,0,0,0,0,0,0,3000,0,0,0,23000,20000,3000,3000
049158,元油2X中信94購03,0,0,0,0,0,0,0,0,0,3000,0,0,0,58000,55000,3000,3000
048852,旺宏群益96購02  ,0,0,0,0,0,0,0,0,0,3000,0,0,0,3000,0,3000,3000
051065,台積電國票96購01,0,0,0,0,0,0,0,0,0,3000,0,0,0,43000,40000,3000,3000
053861,台光電元大98購01,0,0,0,0,0,0,0,0,0,3000,0,0,0,32000,29000,3000,3000
053730,樺漢凱基98購01  ,0,0,0,0,0,0,0,0,0,3000,0,0,0,8000,5000,3000,3000
053639,禾伸堂永豐96購01,0,0,0,0,0,0,0,0,0,3000,0,0,0,59000,56000,3000,3000
054375,貿聯中信99購01  ,0,0,0,0,0,0,0,0,0,3000,0,0,0,3000,0,3000,3000
054059,欣興國票97購03  ,0,0,0,0,0,0,0,0,0,3000,0,0,0,3000,0,3000,3000
052292,緯穎元富95購02  ,0,0,0,0,0,0,0,0,0,3000,0,0,0,3000,0,3000,3000
051758,瑞昱元大95購01  ,0,0,0,0,0,0,0,0,0,3000,0,0,0,132000,129000,3000,3000
052019,創意永豐95購02  ,0,0,0,0,0,0,0,0,0,3000,0,0,0,3000,0,3000,3000
052652,台虹永豐96購01  ,0,0,0,0,0,0,0,0,0,3000,0,0,0,3000,0,3000,3000
052696,玉晶光麥證97購01,0,0,0,5000,2000,3000,0,0,0,3000,0,0,0,7000,4000,3000,3000
052844,台積電統一96購02,0,0,0,0,0,0,0,0,0,3000,0,0,0,3000,0,3000,3000
06124P,超眾元大97售03  ,0,0,0,0,0,0,0,0,0,3000,0,0,0,28000,25000,3000,3000
06029P,聯發科台新96售02,0,0,0,0,0,0,0,0,0,3000,0,0,0,3000,0,3000,3000
06419P,國巨統一97售09  ,0,0,0,0,0,0,0,0,0,3000,0,0,0,40000,37000,3000,3000
06437P,玉晶光國票99售01,0,0,0,0,0,0,0,0,0,3000,0,0,0,5000,2000,3000,3000
06473P,鴻海元大99售03  ,0,0,0,0,0,0,0,0,0,3000,0,0,0,5000,2000,3000,3000
1203,味王            ,24000,21000,3000,0,0,0,0,0,0,0,0,0,0,0,0,0,3000
1233,天仁            ,8000,5000,3000,0,0,0,0,0,0,0,0,0,0,0,0,0,3000
3504,揚明光          ,123000,108000,15000,0,0,0,0,0,0,-12000,0,0,0,0,12000,-12000,3000
2882A,國泰特          ,0,0,0,0,0,0,0,0,0,3000,3000,0,3000,0,0,0,3000
2936,客思達-KY       ,7000,4000,3000,0,0,0,0,0,0,0,0,0,0,0,0,0,3000
1726,永記            ,11000,8000,3000,0,0,0,0,0,0,0,0,0,0,0,0,0,3000
054662,同欣電元大97購02,0,0,0,0,0,0,0,0,0,2000,0,0,0,2000,0,2000,2000
055094,智易群益98購01  ,0,0,0,0,0,0,0,0,0,2000,0,0,0,2000,0,2000,2000
055062,文曄永豐97購01  ,0,0,0,0,0,0,0,0,0,2000,0,0,0,2000,0,2000,2000
054964,智易元大99購01  ,0,0,0,0,0,0,0,0,0,2000,0,0,0,2000,0,2000,2000
055780,禾伸堂凱基99購01,0,0,0,0,0,0,0,0,0,2000,0,0,0,3000,1000,2000,2000
055771,台積電日盛97購04,0,0,0,0,0,0,0,0,0,2000,0,0,0,2000,0,2000,2000
055630,聯詠永豐97購02  ,0,0,0,0,0,0,0,0,0,2000,0,0,0,70000,68000,2000,2000
055589,台光電元大98購04,0,0,0,0,0,0,0,0,0,2000,0,0,0,2000,0,2000,2000
055288,日電貿元大97購02,0,0,0,0,0,0,0,0,0,2000,0,0,0,101000,99000,2000,2000
055163,訊芯元大98購01  ,0,0,0,0,0,0,0,0,0,2000,0,0,0,380000,378000,2000,2000
055317,金寶國票98購01  ,0,0,0,0,0,0,0,0,0,2000,0,0,0,59000,57000,2000,2000
056557,世紀鋼凱基98購02,0,0,0,0,0,0,0,0,0,2000,0,0,0,2000,0,2000,2000
05788P,臺股指永昌96售05,0,0,0,0,0,0,0,0,0,2000,170000,0,170000,322000,490000,-168000,2000
05732P,臺股指統一96售02,0,0,0,0,0,0,0,0,0,2000,0,0,0,2000,0,2000,2000
056244,群創群益98購09  ,0,0,0,0,0,0,0,0,0,2000,0,0,0,6000,4000,2000,2000
056435,台積電凱基98購09,0,0,0,0,0,0,0,0,0,2000,0,0,0,2000,0,2000,2000
056028,GIS群益97購02   ,0,0,0,0,0,0,0,0,0,2000,0,0,0,32000,30000,2000,2000
047121,訊芯元大93購03  ,0,0,0,0,0,0,0,0,0,2000,0,0,0,31000,29000,2000,2000
04728P,美律亞東94售02  ,0,0,0,0,0,0,0,0,0,2000,0,0,0,2000,0,2000,2000
047336,臺股指元大93購31,0,0,0,0,0,0,0,0,0,2000,0,0,0,2000,0,2000,2000
047403,香港2X統一93購01,0,0,0,0,0,0,0,0,0,2000,0,0,0,2000,0,2000,2000
04857P,美律元富94售01  ,0,0,0,0,0,0,0,0,0,2000,0,0,0,8000,6000,2000,2000
05043P,佳世達元富95售01,0,0,0,0,0,0,0,0,0,2000,0,0,0,12000,10000,2000,2000
045385,華新科元大93購04,0,0,0,0,0,0,0,0,0,2000,0,0,0,2000,0,2000,2000
046674,訊芯元大93購01  ,0,0,0,0,0,0,0,0,0,2000,0,0,0,2000,0,2000,2000
047633,力山元大94購01  ,0,0,0,0,0,0,0,0,0,2000,0,0,0,2000,0,2000,2000
046080,同欣電凱基92購03,0,0,0,0,0,0,0,0,0,2000,0,0,0,2000,0,2000,2000
044604,嘉聯益國泰93購01,0,0,0,0,0,0,0,0,0,2000,0,0,0,2000,0,2000,2000
03425B,臺股指元大9A熊01,0,0,0,0,0,0,0,0,0,2000,0,0,0,13000,11000,2000,2000
03583P,微星元大02售03  ,0,0,0,0,0,0,0,0,0,2000,0,0,0,2000,0,2000,2000
04471P,華通元大95售03  ,0,0,0,0,0,0,0,0,0,2000,0,0,0,2000,0,2000,2000
00763U,街口道瓊銅      ,0,0,0,0,0,0,0,0,0,2000,0,0,0,3000,1000,2000,2000
00668,國泰美國道瓊    ,0,0,0,0,0,0,0,0,0,2000,0,0,0,37000,35000,2000,2000
00684R,元大美元指數反1 ,0,0,0,0,0,0,0,0,0,2000,0,0,0,42000,40000,2000,2000
00689R,國泰20年美債反1 ,0,0,0,0,0,0,0,0,0,2000,0,0,0,230000,228000,2000,2000
03912P,臺股指元大93售36,0,0,0,0,0,0,0,0,0,2000,0,0,0,2000,0,2000,2000
03048P,南電國票03售01  ,0,0,0,0,0,0,0,0,0,2000,0,0,0,2000,0,2000,2000
040721,大立光富邦92購01,0,0,0,0,0,0,0,0,0,2000,0,0,0,2000,0,2000,2000
04117P,聯發科元大93售21,0,0,0,0,0,0,0,0,0,2000,0,0,0,62000,60000,2000,2000
04756P,大立光元富94售08,0,0,0,0,0,0,0,0,0,2000,0,0,0,17000,15000,2000,2000
047491,旺宏統一94購03  ,0,0,0,0,0,0,0,0,0,2000,0,0,0,3000,1000,2000,2000
043175,傳奇國泰93購01  ,0,0,0,0,0,0,0,0,0,2000,0,0,0,2000,0,2000,2000
044465,元油2X群益97購01,0,0,0,0,0,0,0,0,0,2000,0,0,0,126000,124000,2000,2000
04357P,智易永豐94售01  ,0,0,0,0,0,0,0,0,0,2000,0,0,0,2000,0,2000,2000
04341P,美律永豐93售03  ,0,0,0,0,0,0,0,0,0,2000,0,0,0,32000,30000,2000,2000
04382P,美律國泰95售01  ,0,0,0,0,0,0,0,0,0,2000,0,0,0,2000,0,2000,2000
045074,華新科元大93購03,0,0,0,0,0,0,0,0,0,2000,0,0,0,2000,0,2000,2000
044039,康控群益93購01  ,0,0,0,0,0,0,0,0,0,2000,0,0,0,2000,0,2000,2000
04274P,滬深2X凱基94售01,0,0,0,0,0,0,0,0,0,2000,0,0,0,5000,3000,2000,2000
04526P,美律凱基94售03  ,0,0,0,0,0,0,0,0,0,2000,0,0,0,2000,0,2000,2000
04223P,友達統一93售05  ,0,0,0,0,0,0,0,0,0,2000,0,0,0,2000,0,2000,2000
044305,瀚宇博兆豐93購01,0,0,0,0,0,0,0,0,0,2000,0,0,0,2000,0,2000,2000
049987,智易凱基94購03  ,0,0,0,0,0,0,0,0,0,2000,0,0,0,2000,0,2000,2000
049916,台光電元大94購06,0,0,0,0,0,0,0,0,0,2000,0,0,0,2000,0,2000,2000
049388,南電元大94購05  ,0,0,0,0,0,0,0,0,0,2000,0,0,0,2000,0,2000,2000
049380,欣興元大94購04  ,0,0,0,0,0,0,0,0,0,2000,0,0,0,2000,0,2000,2000
049093,昇陽半凱基94購01,0,0,0,0,0,0,0,0,0,2000,0,0,0,2000,0,2000,2000
049149,華新科元大95購03,0,0,0,0,0,0,0,0,0,2000,0,0,0,29000,27000,2000,2000
04911P,美律元富94售02  ,0,0,0,0,0,0,0,0,0,2000,0,0,0,2000,0,2000,2000
050288,台積電凱基94購32,0,0,0,0,0,0,0,0,0,2000,0,0,0,2000,0,2000,2000
050074,訊芯凱基94購05  ,0,0,0,0,0,0,0,0,0,2000,0,0,0,2000,0,2000,2000
051450,世芯元大95購02  ,0,0,0,0,0,0,0,0,0,2000,0,0,0,13000,11000,2000,2000
051636,嘉晶國票95購02  ,0,0,0,0,0,0,0,0,0,2000,0,0,0,2000,0,2000,2000
051619,智邦凱基95購07  ,0,0,0,0,0,0,0,0,0,2000,0,0,0,75000,73000,2000,2000
04900P,矽格中信94售02  ,0,0,0,0,0,0,0,0,0,2000,0,0,0,2000,0,2000,2000
049079,聯發科凱基94購04,0,0,0,0,0,0,0,0,0,2000,0,0,0,12000,10000,2000,2000
04928P,大立光凱基95售07,0,0,0,0,0,0,0,0,0,2000,0,0,0,2000,0,2000,2000
048385,亞德客國票94購01,0,0,0,0,0,0,0,0,0,2000,0,0,0,2000,0,2000,2000
048204,訊芯元大93購06  ,0,0,0,0,0,0,0,0,0,2000,0,0,0,2000,0,2000,2000
048159,聯詠兆豐93購03  ,0,0,0,0,0,0,0,0,0,2000,0,0,0,74000,72000,2000,2000
048638,台光電元大94購01,0,0,0,0,0,0,0,0,0,2000,0,0,0,2000,0,2000,2000
049545,台積電群益94購09,0,0,0,0,0,0,0,0,0,2000,0,0,0,159000,157000,2000,2000
050771,華新科元大94購06,0,0,0,0,0,0,0,0,0,2000,0,0,0,10000,8000,2000,2000
050841,國巨國票96購02  ,0,0,0,0,0,0,0,0,0,2000,0,0,0,2000,0,2000,2000
050896,華新科元大96購02,0,0,0,0,0,0,0,0,0,2000,0,0,0,2000,0,2000,2000
048711,台郡台新94購01  ,0,0,0,0,0,0,0,0,0,2000,0,0,0,2000,0,2000,2000
049694,華新科元大95購06,0,0,0,0,0,0,0,0,0,2000,0,0,0,2000,0,2000,2000
052635,奇力新凱基98購01,0,0,0,0,0,0,0,0,0,2000,0,0,0,15000,13000,2000,2000
052686,華新科元大96購03,0,0,0,0,0,0,0,0,0,2000,0,0,0,2000,0,2000,2000
052542,友達元富98購01  ,0,0,0,0,0,0,0,0,0,2000,0,0,0,2000,0,2000,2000
052566,國巨凱基96購04  ,0,0,0,0,0,0,0,0,0,2000,0,0,0,12000,10000,2000,2000
053112,中磊兆豐97購01  ,0,0,0,0,0,0,0,0,0,2000,0,0,0,2000,0,2000,2000
052872,智易凱基96購01  ,0,0,0,0,0,0,0,0,0,2000,0,0,0,2000,0,2000,2000
051871,同欣電凱基95購02,0,0,0,0,0,0,0,0,0,2000,0,0,0,7000,5000,2000,2000
052343,同欣電凱基95購03,0,0,0,0,0,0,0,0,0,2000,0,0,0,12000,10000,2000,2000
054113,奇力新台新97購01,0,0,0,0,0,0,0,0,0,2000,0,0,0,10000,8000,2000,2000
054135,大立光元大97購04,0,0,0,0,0,0,0,0,0,2000,0,0,0,10000,8000,2000,2000
054383,傳奇群益97購01  ,0,0,0,0,0,0,0,0,0,2000,0,0,0,20000,18000,2000,2000
054421,臺股指元大99購03,0,0,0,0,0,0,0,0,0,2000,0,0,0,6000,4000,2000,2000
054212,聯詠國票97購03  ,0,0,0,0,0,0,0,0,0,2000,0,0,0,2000,0,2000,2000
054338,全新統一96購01  ,0,0,0,0,0,0,0,0,0,2000,0,0,0,102000,100000,2000,2000
054351,華新科國泰97購03,0,0,0,0,0,0,0,0,0,2000,0,0,0,62000,60000,2000,2000
054334,超眾永豐96購04  ,0,0,0,0,0,0,0,0,0,2000,0,0,0,20000,18000,2000,2000
053592,亞光元大96購01  ,0,0,0,0,0,0,0,0,0,2000,0,0,0,17000,15000,2000,2000
053739,A50正2國票9A購01,0,0,0,0,0,0,0,0,0,2000,0,0,0,2000,0,2000,2000
05375P,健策國票96售02  ,0,0,0,0,0,0,0,0,0,2000,0,0,0,105000,103000,2000,2000
053308,智易凱基96購02  ,0,0,0,0,0,0,0,0,0,2000,0,0,0,2000,0,2000,2000
05348P,美律元富98售01  ,0,0,0,0,0,0,0,0,0,2000,0,0,0,2000,0,2000,2000
053480,祥碩元大96購02  ,0,0,0,0,0,0,0,0,0,2000,0,0,0,12000,10000,2000,2000
053475,華新科元大96購05,0,0,0,0,0,0,0,0,0,2000,0,0,0,3000,1000,2000,2000
053516,茂林群益96購05  ,0,0,0,0,0,0,0,0,0,2000,0,0,0,2000,0,2000,2000
053530,聯發科康和96購01,0,0,0,0,0,0,0,0,0,2000,0,0,0,2000,0,2000,2000
053388,群創元大9C購02  ,0,0,0,0,0,0,0,0,0,2000,0,0,0,3000,1000,2000,2000
2429,銘旺科          ,2000,0,2000,0,0,0,0,0,0,0,0,0,0,0,0,0,2000
2882B,國泰金乙特      ,0,0,0,0,0,0,0,0,0,2000,2000,0,2000,0,0,0,2000
2701,萬企            ,29000,26000,3000,0,0,0,0,0,0,-1000,0,1000,-1000,0,0,0,2000
3702A,大聯大甲特      ,0,0,0,0,0,0,0,0,0,2000,2000,0,2000,0,0,0,2000
1236,宏亞            ,10000,8000,2000,0,0,0,0,0,0,0,0,0,0,0,0,0,2000
1468,昶和            ,7000,5000,2000,0,0,0,0,0,0,0,0,0,0,0,0,0,2000
1453,大將            ,14000,12000,2000,0,0,0,0,0,0,0,0,0,0,0,0,0,2000
08638P,泰碩國票9C售01  ,0,0,0,0,0,0,0,0,0,2000,0,0,0,2000,0,2000,2000
05994P,奇鋐元大96售02  ,0,0,0,0,0,0,0,0,0,2000,0,0,0,49000,47000,2000,2000
06261P,上銀凱基97售03  ,0,0,0,0,0,0,0,0,0,2000,0,0,0,5000,3000,2000,2000
8104,錸寶            ,35000,33000,2000,0,0,0,0,0,0,0,0,0,0,0,0,0,2000
8454,富邦媒          ,58000,57000,1000,0,0,0,0,0,0,1000,1000,0,1000,0,0,0,2000
00771,元大US高息特別股,0,0,0,0,0,0,0,0,0,1701,0,0,0,7000,5299,1701,1701
056022,新光金群益97購02,0,0,0,0,0,0,0,0,0,1000,0,0,0,1000,0,1000,1000
056014,上銀群益97購02  ,0,0,0,0,0,0,0,0,0,1000,0,0,0,1000,0,1000,1000
055900,瀚宇博中信97購01,0,0,0,0,0,0,0,0,0,1000,0,0,0,1000,0,1000,1000
055946,元油反元大97購02,0,0,0,0,0,0,0,0,0,1000,0,0,0,1000,0,1000,1000
056214,義隆國票99購01  ,0,0,0,0,0,0,0,0,0,1000,0,0,0,202000,201000,1000,1000
056136,京鼎元大98購01  ,0,0,0,0,0,0,0,0,0,1000,0,0,0,152000,151000,1000,1000
05781P,臺股指統一99售02,0,0,0,0,0,0,0,0,0,1000,0,0,0,1000,0,1000,1000
05917P,宏達電元大96售02,0,0,0,0,0,0,0,0,0,1000,0,0,0,421000,420000,1000,1000
056560,旺宏群益98購03  ,0,0,0,0,0,0,0,0,0,1000,0,0,0,1000,0,1000,1000
056555,矽創凱基98購01  ,0,0,0,0,0,0,0,0,0,1000,0,0,0,39000,38000,1000,1000
056452,亞光凱基98購02  ,0,0,0,0,0,0,0,0,0,1000,0,0,0,15000,14000,1000,1000
056629,昇陽半永豐98購01,0,0,0,0,0,0,0,0,0,1000,0,0,0,17000,16000,1000,1000
056612,台積電永豐98購01,0,0,0,0,0,0,0,0,0,1000,0,0,0,128000,127000,1000,1000
055161,貿聯元大98購03  ,0,0,0,0,0,0,0,0,0,1000,0,0,0,114000,113000,1000,1000
055740,智易元富97購01  ,0,0,0,0,0,0,0,0,0,1000,0,0,0,1000,0,1000,1000
055670,矽創群益98購02  ,0,0,0,0,0,0,0,0,0,1000,0,0,0,306000,305000,1000,1000
055665,亞德客群益97購01,0,0,0,0,0,0,0,0,0,1000,0,0,0,1000,0,1000,1000
055016,群電元富97購01  ,0,0,0,0,0,0,0,0,0,1000,0,0,0,1000,0,1000,1000
055155,奇力新元大99購01,0,0,0,0,0,0,0,0,0,1000,0,0,0,1000,0,1000,1000
054560,全新群益98購03  ,0,0,0,0,0,0,0,0,0,1000,0,0,0,34000,33000,1000,1000
054764,亞光國票98購01  ,0,0,0,0,0,0,0,0,0,1000,0,0,0,1000,0,1000,1000
00775B,新光投等債15+   ,0,0,0,0,0,0,0,0,0,1000,0,0,0,3000,2000,1000,1000
00662,富邦NASDAQ      ,0,0,0,0,0,0,0,0,0,1000,0,0,0,127000,126000,1000,1000
00657,國泰日經225     ,0,0,0,0,0,0,0,0,0,1000,0,0,0,102000,101000,1000,1000
04101P,臺股指國票93售08,0,0,0,0,0,0,0,0,0,1000,0,0,0,440000,439000,1000,1000
03035X,元展32          ,0,0,0,0,0,0,0,0,0,1000,0,0,0,1000,0,1000,1000
03052X,元展49          ,0,0,0,0,0,0,0,0,0,1000,0,0,0,1000,0,1000,1000
03257P,聯電永豐02售01  ,0,0,0,0,0,0,0,0,0,1000,0,0,0,1000,0,1000,1000
03903P,美律永豐93售01  ,0,0,0,0,0,0,0,0,0,1000,0,0,0,1000,0,1000,1000
04034P,技嘉群益93售03  ,0,0,0,0,0,0,0,0,0,1000,0,0,0,2000,1000,1000,1000
044834,旺宏元大93購02  ,0,0,0,0,0,0,0,0,0,1000,0,0,0,127000,126000,1000,1000
042093,台灣50群益94購02,0,0,0,0,0,0,0,0,0,1000,0,0,0,1000,0,1000,1000
03619C,臺股指元大95牛02,0,0,0,0,0,0,0,0,0,1000,0,0,0,2000,1000,1000,1000
03860P,群創元富97售01  ,0,0,0,0,0,0,0,0,0,1000,0,0,0,1000,0,1000,1000
044290,群創凱基93購05  ,0,0,0,0,0,0,0,0,0,1000,0,0,0,185000,184000,1000,1000
045079,大立光元大93購05,0,0,0,0,0,0,0,0,0,1000,0,0,0,1000,0,1000,1000
045080,大立光元大93購06,0,0,0,0,0,0,0,0,0,1000,0,0,0,1000,0,1000,1000
045140,玉晶光兆豐93購02,0,0,0,0,0,0,0,0,0,1000,0,0,0,1000,0,1000,1000
043832,SP黃豆國票95購01,0,0,0,0,0,0,0,0,0,1000,0,0,0,1000,0,1000,1000
043467,全新元大93購01  ,0,0,0,0,0,0,0,0,0,1000,0,0,0,1000,0,1000,1000
043647,台積電國票92購01,0,0,0,0,0,0,0,0,0,1000,0,0,0,1000,0,1000,1000
04279P,超眾凱基93售07  ,0,0,0,0,0,0,0,0,0,1000,0,0,0,1000,0,1000,1000
042903,金寶元大94購01  ,0,0,0,0,0,0,0,0,0,1000,0,0,0,1000,0,1000,1000
042928,台積電中信95購01,0,0,0,0,0,0,0,0,0,1000,0,0,0,1000,0,1000,1000
043273,緯穎國泰93購01  ,0,0,0,0,0,0,0,0,0,1000,0,0,0,1000,0,1000,1000
046414,大立光元大92購23,0,0,0,0,0,0,0,0,0,1000,0,0,0,1000,0,1000,1000
04639P,臺股指群益94售14,0,0,0,0,0,0,0,0,0,1000,0,0,0,1000,0,1000,1000
047488,臺股指凱基93購04,0,0,0,0,0,0,0,0,0,1000,0,0,0,1000,0,1000,1000
046525,臺股指元大92購24,0,0,0,0,0,0,0,0,0,1000,0,0,0,1000,0,1000,1000
046537,聯發科群益93購02,0,0,0,0,0,0,0,0,0,1000,0,0,0,15000,14000,1000,1000
047572,深中小群益95購01,0,0,0,0,0,0,0,0,0,1000,0,0,0,54000,53000,1000,1000
047559,彩晶凱基94購03  ,0,0,0,0,0,0,0,0,0,1000,0,0,0,1000,0,1000,1000
046026,友訊元大92購01  ,0,0,0,0,0,0,0,0,0,1000,0,0,0,1000,0,1000,1000
046036,大立光元大92購15,0,0,0,0,0,0,0,0,0,1000,0,0,0,1000,0,1000,1000
046037,大立光元大92購16,0,0,0,0,0,0,0,0,0,1000,0,0,0,1000,0,1000,1000
046182,燿華凱基93購04  ,0,0,0,0,0,0,0,0,0,1000,0,0,0,1000,0,1000,1000
046183,瑞昱凱基92購02  ,0,0,0,0,0,0,0,0,0,1000,0,0,0,1000,0,1000,1000
046121,大立光元大92購18,0,0,0,0,0,0,0,0,0,1000,0,0,0,1000,0,1000,1000
046841,智伸科台新93購01,0,0,0,0,0,0,0,0,0,1000,0,0,0,1000,0,1000,1000
045778,大立光元大93購10,0,0,0,0,0,0,0,0,0,1000,0,0,0,1000,0,1000,1000
045779,大立光元大93購11,0,0,0,0,0,0,0,0,0,1000,0,0,0,1000,0,1000,1000
045674,友達元大92購03  ,0,0,0,0,0,0,0,0,0,1000,0,0,0,1000,0,1000,1000
046317,亞光元大92購04  ,0,0,0,0,0,0,0,0,0,1000,0,0,0,1000,0,1000,1000
046307,瑞昱元大92購03  ,0,0,0,0,0,0,0,0,0,1000,0,0,0,1000,0,1000,1000
046217,康友富邦94購01  ,0,0,0,0,0,0,0,0,0,1000,0,0,0,1000,0,1000,1000
046229,大立光元大92購19,0,0,0,0,0,0,0,0,0,1000,0,0,0,1000,0,1000,1000
046293,聯發科統一94購01,0,0,0,0,0,0,0,0,0,1000,0,0,0,4000,3000,1000,1000
046662,大立光元大93購14,0,0,0,0,0,0,0,0,0,1000,0,0,0,1000,0,1000,1000
046586,大立光元大92購26,0,0,0,0,0,0,0,0,0,1000,0,0,0,1000,0,1000,1000
046610,義隆國票93購01  ,0,0,0,0,0,0,0,0,0,1000,0,0,0,1000,0,1000,1000
050718,茂林群益94購04  ,0,0,0,0,0,0,0,0,0,1000,0,0,0,1000,0,1000,1000
05071P,鴻海統一96售05  ,0,0,0,0,0,0,0,0,0,1000,0,0,0,1000,0,1000,1000
050721,台泥國票94購01  ,0,0,0,0,0,0,0,0,0,1000,0,0,0,71000,70000,1000,1000
050725,光磊國票96購01  ,0,0,0,0,0,0,0,0,0,1000,0,0,0,989000,988000,1000,1000
049511,奇力新凱基94購03,0,0,0,0,0,0,0,0,0,1000,0,0,0,10000,9000,1000,1000
047116,大立光元大93購19,0,0,0,0,0,0,0,0,0,1000,0,0,0,1000,0,1000,1000
04867P,美律統一94售03  ,0,0,0,0,0,0,0,0,0,1000,0,0,0,1000,0,1000,1000
050536,亞泥凱基95購01  ,0,0,0,0,0,0,0,0,0,1000,0,0,0,1000,0,1000,1000
050204,華新科群益94購05,0,0,0,0,0,0,0,0,0,1000,0,0,0,20000,19000,1000,1000
050760,矽力元富94購03  ,0,0,0,0,0,0,0,0,0,1000,0,0,0,4000,3000,1000,1000
049574,新日興統一94購03,0,0,0,0,0,0,0,0,0,1000,0,0,0,11000,10000,1000,1000
049549,瀚宇博群益94購01,0,0,0,0,0,0,0,0,0,1000,0,0,0,1000,0,1000,1000
04864P,欣興元大94售10  ,0,0,0,0,0,0,0,0,0,1000,0,0,0,1000,0,1000,1000
048168,致茂永豐93購02  ,0,0,0,0,0,0,0,0,0,1000,0,0,0,1000,0,1000,1000
048344,大立光元大93購30,0,0,0,0,0,0,0,0,0,1000,0,0,0,1000,0,1000,1000
048267,元金反中信93購01,0,0,0,0,0,0,0,0,0,1000,0,0,0,4000,3000,1000,1000
049273,臺股指元大94購08,0,0,0,0,0,0,0,0,0,1000,0,0,0,4000,3000,1000,1000
049274,臺股指元大94購09,0,0,0,0,0,0,0,0,0,1000,0,0,0,2000,1000,1000,1000
049209,GIS群益94購03   ,0,0,0,0,0,0,0,0,0,1000,0,0,0,11000,10000,1000,1000
049738,神基群益94購01  ,0,0,0,0,0,0,0,0,0,1000,0,0,0,12000,11000,1000,1000
048815,川湖凱基94購01  ,0,0,0,0,0,0,0,0,0,1000,0,0,0,11000,10000,1000,1000
051349,國巨元大95購08  ,0,0,0,0,0,0,0,0,0,1000,0,0,0,1000,0,1000,1000
051434,中磊元富95購02  ,0,0,0,0,0,0,0,0,0,1000,0,0,0,21000,20000,1000,1000
051346,仁寶元大95購01  ,0,0,0,0,0,0,0,0,0,1000,0,0,0,1000,0,1000,1000
051342,光寶科元大95購01,0,0,0,0,0,0,0,0,0,1000,0,0,0,20000,19000,1000,1000
05135P,鴻海凱基96售07  ,0,0,0,0,0,0,0,0,0,1000,0,0,0,19000,18000,1000,1000
050630,大立光亞東96購01,0,0,0,0,0,0,0,0,0,1000,0,0,0,1000,0,1000,1000
050575,南亞科國票94購01,0,0,0,0,0,0,0,0,0,1000,0,0,0,1000,0,1000,1000
048026,瑞昱凱基94購01  ,0,0,0,0,0,0,0,0,0,1000,0,0,0,1000,0,1000,1000
047955,南亞科永豐93購01,0,0,0,0,0,0,0,0,0,1000,0,0,0,1000,0,1000,1000
051607,緯創群益96購02  ,0,0,0,0,0,0,0,0,0,1000,0,0,0,1000,0,1000,1000
051589,健鼎元大95購02  ,0,0,0,0,0,0,0,0,0,1000,0,0,0,1000,0,1000,1000
051587,大立光元大95購08,0,0,0,0,0,0,0,0,0,1000,0,0,0,70000,69000,1000,1000
051705,富邦金群益97購01,0,0,0,0,0,0,0,0,0,1000,0,0,0,11000,10000,1000,1000
051688,大立光凱基97購02,0,0,0,0,0,0,0,0,0,1000,0,0,0,10000,9000,1000,1000
051443,聯發科元大95購10,0,0,0,0,0,0,0,0,0,1000,0,0,0,1000,0,1000,1000
050284,台泥凱基94購01  ,0,0,0,0,0,0,0,0,0,1000,0,0,0,1000,0,1000,1000
050132,日電貿凱基94購02,0,0,0,0,0,0,0,0,0,1000,0,0,0,1000,0,1000,1000
049155,同欣電元大94購01,0,0,0,0,0,0,0,0,0,1000,0,0,0,1000,0,1000,1000
049382,牧德元大94購04  ,0,0,0,0,0,0,0,0,0,1000,0,0,0,1000,0,1000,1000
048969,兆赫元大94購01  ,0,0,0,0,0,0,0,0,0,1000,0,0,0,1000,0,1000,1000
050015,友達富邦95購01  ,0,0,0,0,0,0,0,0,0,1000,0,0,0,1000,0,1000,1000
050056,國巨凱基94購04  ,0,0,0,0,0,0,0,0,0,1000,0,0,0,11000,10000,1000,1000
050050,國泰金群益94購02,0,0,0,0,0,0,0,0,0,1000,0,0,0,5000,4000,1000,1000
053448,智易凱基96購03  ,0,0,0,0,0,0,0,0,0,1000,0,0,0,1000,0,1000,1000
053426,創意永豐96購04  ,0,0,0,0,0,0,0,0,0,1000,0,0,0,78000,77000,1000,1000
053295,奇力新中信96購01,0,0,0,0,0,0,0,0,0,1000,0,0,0,21000,20000,1000,1000
053713,漢唐凱基96購04  ,0,0,0,0,0,0,0,0,0,1000,0,0,0,11000,10000,1000,1000
053718,全新凱基97購02  ,0,0,0,0,0,0,0,0,0,1000,0,0,0,1000,0,1000,1000
05355P,臺股指元富95售09,0,0,0,0,0,0,0,0,0,1000,0,0,0,1000,0,1000,1000
054297,台郡元大98購01  ,0,0,0,0,0,0,0,0,0,1000,0,0,0,1000,0,1000,1000
054223,大立光統一98購04,0,0,0,0,0,0,0,0,0,1000,0,0,0,1000,0,1000,1000
054420,緯穎元大96購08  ,0,0,0,0,0,0,0,0,0,1000,0,0,0,119000,118000,1000,1000
054414,全新元大97購02  ,0,0,0,0,0,0,0,0,0,1000,0,0,0,1000,0,1000,1000
054463,瑞昱凱基97購01  ,0,0,0,0,0,0,0,0,0,1000,0,0,0,35000,34000,1000,1000
054169,上緯控凱基98購01,0,0,0,0,0,0,0,0,0,1000,0,0,0,1000,0,1000,1000
054029,瀚宇博凱基96購02,0,0,0,0,0,0,0,0,0,1000,0,0,0,1000,0,1000,1000
053966,旺宏元大96購08  ,0,0,0,0,0,0,0,0,0,1000,0,0,0,222000,221000,1000,1000
05228P,大立光元富95售09,0,0,0,0,0,0,0,0,0,1000,0,0,0,1000,0,1000,1000
052223,聯電凱基96購02  ,0,0,0,0,0,0,0,0,0,1000,0,0,0,25000,24000,1000,1000
052230,大立光凱基96購09,0,0,0,0,0,0,0,0,0,1000,0,0,0,2000,1000,1000,1000
051925,瀚宇博第一95購01,0,0,0,0,0,0,0,0,0,1000,0,0,0,1000,0,1000,1000
051903,T50反1元大97購02,0,0,0,0,0,0,0,0,0,1000,0,0,0,1000,0,1000,1000
052055,緯穎凱基95購03  ,0,0,0,0,0,0,0,0,0,1000,0,0,0,18000,17000,1000,1000
052037,全新國泰96購02  ,0,0,0,0,0,0,0,0,0,1000,0,0,0,11000,10000,1000,1000
05314P,臺股指群益95售13,0,0,0,0,0,0,0,0,0,1000,0,0,0,1000,0,1000,1000
053172,瑞儀群益97購01  ,0,0,0,0,0,0,0,0,0,1000,0,0,0,121000,120000,1000,1000
053174,同欣電群益98購02,0,0,0,0,0,0,0,0,0,1000,0,0,0,31000,30000,1000,1000
053064,國巨群益96購04  ,0,0,0,0,0,0,0,0,0,1000,0,0,0,30000,29000,1000,1000
052727,仁寶元富96購01  ,0,0,0,0,0,0,0,0,0,1000,0,0,0,84000,83000,1000,1000
052758,友達群益99購01  ,0,0,0,0,0,0,0,0,0,1000,0,0,0,1000,0,1000,1000
8488,吉源-KY         ,4000,3000,1000,0,0,0,0,0,0,0,0,0,0,0,0,0,1000
06334P,臺股指群益9C售03,0,0,0,0,0,0,0,0,0,1000,0,0,0,52000,51000,1000,1000
06240P,奇力新元富97售03,0,0,0,0,0,0,0,0,0,1000,0,0,0,1000,0,1000,1000
06207P,聯發科凱基97售07,0,0,0,0,0,0,0,0,0,1000,0,0,0,1000,0,1000,1000
06179P,國巨群益97售04  ,0,0,0,0,0,0,0,0,0,1000,0,0,0,1000,0,1000,1000
06057P,大立光凱基98售01,0,0,0,0,0,0,0,0,0,1000,0,0,0,4000,3000,1000,1000
06155P,智邦統一97售02  ,0,0,0,0,0,0,0,0,0,1000,0,0,0,99000,98000,1000,1000
06133P,帆宣元富97售02  ,0,0,0,0,0,0,0,0,0,1000,0,0,0,1000,0,1000,1000
06471P,臺股指凱基99售11,0,0,0,0,0,0,0,0,0,1000,0,0,0,1000,0,1000,1000
06390P,美律國票97售03  ,0,0,0,0,0,0,0,0,0,1000,0,0,0,10000,9000,1000,1000
2838A,聯邦銀甲特      ,0,0,0,0,0,0,0,0,0,1000,1000,0,1000,0,0,0,1000
2540,愛山林          ,5000,5000,0,0,0,0,0,0,0,1000,1000,0,1000,0,0,0,1000
008201,BP上證50        ,0,0,0,0,0,0,0,0,0,300,0,0,0,300,0,300,300
05481P,鴻海凱基95售21  ,0,0,0,0,0,0,0,0,0,0,0,0,0,20000,20000,0,0
054814,台積電元大97購13,0,0,0,0,0,0,0,0,0,0,0,0,0,229000,229000,0,0
054551,聯發科凱基98購02,0,0,0,0,0,0,0,0,0,0,0,0,0,1000,1000,0,0
054566,貿聯群益97購02  ,0,0,0,0,0,0,0,0,0,0,0,0,0,11000,11000,0,0
054514,道瓊銀元大98購01,0,0,0,0,0,0,0,0,0,0,0,0,0,13000,13000,0,0
054636,華通中信97購01  ,0,0,0,0,0,0,0,0,0,0,0,0,0,2000,2000,0,0
054625,旺宏凱基98購03  ,0,0,0,0,0,0,0,0,0,0,0,0,0,5000,5000,0,0
055096,緯穎群益97購01  ,0,0,0,0,0,0,0,0,0,0,0,0,0,97000,97000,0,0
055105,鴻海凱基98購05  ,0,0,0,0,0,0,0,0,0,0,0,0,0,50000,50000,0,0
055118,嘉聯益凱基98購02,0,0,0,0,0,0,0,0,0,0,0,0,0,24000,24000,0,0
054990,凌陽元富97購01  ,0,0,0,0,0,0,0,0,0,0,0,0,0,20000,20000,0,0
054942,凱美元大97購02  ,0,0,0,0,0,0,0,0,0,0,0,0,0,60000,60000,0,0
054939,台積電元大97購15,0,0,0,0,0,0,0,0,0,0,0,0,0,249000,249000,0,0
054940,台積電元大97購16,0,0,0,0,0,0,0,0,0,0,0,0,0,249000,249000,0,0
054946,億光元大97購01  ,0,0,0,0,0,0,0,0,0,0,0,0,0,18000,18000,0,0
054918,華新科凱基98購02,0,0,0,0,0,0,0,0,0,0,0,0,0,6000,6000,0,0
054910,信錦凱基97購01  ,0,0,0,0,0,0,0,0,0,0,0,0,0,5000,5000,0,0
055774,台光電凱基97購02,0,0,0,0,0,0,0,0,0,0,0,0,0,50000,50000,0,0
055593,華新科元大97購10,0,0,0,0,0,0,0,0,0,0,0,0,0,6000,6000,0,0
055552,瑞昱凱基97購02  ,0,0,0,0,0,0,0,0,0,0,0,0,0,38000,38000,0,0
055562,欣興凱基97購06  ,0,0,0,0,0,0,0,0,0,0,0,0,0,8000,8000,0,0
055498,大立光元大97購07,0,0,0,0,0,0,0,0,0,0,0,0,0,77000,77000,0,0
055487,國巨元大98購07  ,0,0,0,0,0,0,0,0,0,0,0,0,0,20000,20000,0,0
055485,國巨元大97購09  ,0,0,0,0,0,0,0,0,0,0,0,0,0,45000,45000,0,0
055491,奇力新元大98購03,0,0,0,0,0,0,0,0,0,0,0,0,0,10000,10000,0,0
055547,台積電凱基97購13,0,0,0,0,0,0,0,0,0,0,0,0,0,42000,42000,0,0
055536,嘉聯益群益99購02,0,0,0,0,0,0,0,0,0,0,0,0,0,22000,22000,0,0
055301,台虹元大97購01  ,0,0,0,0,0,0,0,0,0,0,0,0,0,25000,25000,0,0
055346,國巨凱基98購02  ,0,0,0,0,0,0,0,0,0,0,0,0,0,70000,70000,0,0
055348,旺宏凱基97購01  ,0,0,0,0,0,0,0,0,0,0,0,0,0,5000,5000,0,0
055351,聯發科凱基97購03,0,0,0,0,0,0,0,0,0,0,0,0,0,16000,16000,0,0
055353,華新科凱基98購03,0,0,0,0,0,0,0,0,0,0,0,0,0,6000,6000,0,0
055357,欣興凱基97購04  ,0,0,0,0,0,0,0,0,0,0,0,0,0,5000,5000,0,0
055395,泰鼎統一97購01  ,0,0,0,0,0,0,0,0,0,0,0,0,0,10000,10000,0,0
056596,光磊元富98購01  ,0,0,0,0,0,0,0,0,0,0,0,0,0,201000,201000,0,0
056641,華通凱基98購03  ,0,0,0,0,0,0,0,0,0,0,0,0,0,32000,32000,0,0
056644,宏達電凱基98購04,0,0,0,0,0,0,0,0,0,0,0,0,0,5000,5000,0,0
056657,華邦電元大99購01,0,0,0,0,0,0,0,0,0,0,0,0,0,35000,35000,0,0
056711,亞光永豐98購01  ,0,0,0,0,0,0,0,0,0,0,0,0,0,7000,7000,0,0
056715,瀚宇博永豐98購01,0,0,0,0,0,0,0,0,0,0,0,0,0,4000,4000,0,0
056719,台虹永豐98購01  ,0,0,0,0,0,0,0,0,0,0,0,0,0,24000,24000,0,0
056768,宏達電元大99購03,0,0,0,0,0,0,0,0,0,0,0,0,0,5000,5000,0,0
056763,國巨元大99購02  ,0,0,0,0,0,0,0,0,0,0,0,0,0,38000,38000,0,0
056764,友達元大9A購03  ,0,0,0,0,0,0,0,0,0,0,0,0,0,46000,46000,0,0
056784,南亞科群益98購01,0,0,0,0,0,0,0,0,0,0,0,0,0,1000,1000,0,0
056771,嘉晶元大99購01  ,0,0,0,0,0,0,0,0,0,0,0,0,0,1000,1000,0,0
056772,欣興元大99購01  ,0,0,0,0,0,0,0,0,0,0,0,0,0,41000,41000,0,0
05679P,台表科群益96售05,0,0,0,0,0,0,0,0,0,0,0,0,0,41000,41000,0,0
056454,欣興凱基98購02  ,0,0,0,0,0,0,0,0,0,0,0,0,0,16000,16000,0,0
05645P,聯發科凱基96售13,0,0,0,0,0,0,0,0,0,0,0,0,0,6000,6000,0,0
056583,昇陽半元大98購02,0,0,0,0,0,0,0,0,0,0,0,0,0,80000,80000,0,0
056573,華新科元大99購06,0,0,0,0,0,0,0,0,0,0,0,0,0,6000,6000,0,0
056574,亞光元大99購03  ,0,0,0,0,0,0,0,0,0,0,0,0,0,20000,20000,0,0
056540,聯詠凱基98購02  ,0,0,0,0,0,0,0,0,0,0,0,0,0,20000,20000,0,0
05652P,臻鼎群益96售01  ,0,0,0,0,0,0,0,0,0,0,0,0,0,20000,20000,0,0
056530,旺宏凱基98購06  ,0,0,0,0,0,0,0,0,0,0,0,0,0,5000,5000,0,0
056548,瀚宇博凱基98購02,0,0,0,0,0,0,0,0,0,0,0,0,0,5000,5000,0,0
05931P,鴻海凱基96售15  ,0,0,0,0,0,0,0,0,0,0,0,0,0,20000,20000,0,0
05932P,鴻海凱基96售16  ,0,0,0,0,0,0,0,0,0,0,0,0,0,20000,20000,0,0
05933P,鴻海凱基97售03  ,0,0,0,0,0,0,0,0,0,0,0,0,0,20000,20000,0,0
05939P,聯發科凱基96售20,0,0,0,0,0,0,0,0,0,0,0,0,0,9000,9000,0,0
05872P,大立光凱基96售15,0,0,0,0,0,0,0,0,0,0,0,0,0,2000,2000,0,0
05908P,大立光元富96售05,0,0,0,0,0,0,0,0,0,0,0,0,0,2000,2000,0,0
05974P,國巨富邦97售03  ,0,0,0,0,0,0,0,0,0,0,0,0,0,2000,2000,0,0
05977P,旺宏永豐96售06  ,0,0,0,0,0,0,0,0,0,0,0,0,0,17000,17000,0,0
05789P,臺股指永昌96售06,0,0,0,0,0,0,0,0,0,0,540000,0,540000,0,540000,-540000,0
05768P,台積電凱基96售15,0,0,0,0,0,0,0,0,0,0,0,0,0,400000,400000,0,0
05769P,台積電凱基96售16,0,0,0,0,0,0,0,0,0,0,0,0,0,200000,200000,0,0
05813P,臺股指國票96售06,0,0,0,0,0,0,0,0,0,0,0,0,0,1000,1000,0,0
05865P,大立光元大96售09,0,0,0,0,0,0,0,0,0,0,0,0,0,80000,80000,0,0
05866P,致伸元大96售01  ,0,0,0,0,0,0,0,0,0,0,0,0,0,100000,100000,0,0
05845P,大立光元大96售06,0,0,0,0,0,0,0,0,0,0,0,0,0,65000,65000,0,0
05741P,聯發科元大96售14,0,0,0,0,0,0,0,0,0,0,0,0,0,31000,31000,0,0
05719P,可成元大96售03  ,0,0,0,0,0,0,0,0,0,0,0,0,0,35000,35000,0,0
05761P,嘉澤永豐96售01  ,0,0,0,0,0,0,0,0,0,0,0,0,0,30000,30000,0,0
05757P,旺宏永豐96售03  ,0,0,0,0,0,0,0,0,0,0,0,0,0,16000,16000,0,0
056820,欣興永豐98購02  ,0,0,0,0,0,0,0,0,0,0,0,0,0,1000,1000,0,0
056133,可成元大97購05  ,0,0,0,0,0,0,0,0,0,0,0,0,0,6000,6000,0,0
056153,華新科凱基97購02,0,0,0,0,0,0,0,0,0,0,0,0,0,6000,6000,0,0
056146,台虹元大98購01  ,0,0,0,0,0,0,0,0,0,0,0,0,0,25000,25000,0,0
056195,群創富邦98購01  ,0,0,0,0,0,0,0,0,0,0,0,0,0,11000,11000,0,0
056175,可成元富97購03  ,0,0,0,0,0,0,0,0,0,0,0,0,0,10000,10000,0,0
056212,台光電國票98購03,0,0,0,0,0,0,0,0,0,0,0,0,0,10000,10000,0,0
056225,聯發科凱基97購09,0,0,0,0,0,0,0,0,0,0,0,0,0,2000,2000,0,0
056261,台積電統一97購07,0,0,0,0,0,0,0,0,0,0,0,0,0,50000,50000,0,0
056287,亞光永豐97購02  ,0,0,0,0,0,0,0,0,0,0,0,0,0,12000,12000,0,0
056432,鴻海凱基98購08  ,0,0,0,0,0,0,0,0,0,0,0,0,0,60000,60000,0,0
056429,華通凱基98購02  ,0,0,0,0,0,0,0,0,0,0,0,0,0,32000,32000,0,0
056364,亞光元大99購02  ,0,0,0,0,0,0,0,0,0,0,0,0,0,1000,1000,0,0
05639P,欣興統一97售01  ,0,0,0,0,0,0,0,0,0,0,0,0,0,15000,15000,0,0
056345,嘉聯益凱基99購01,0,0,0,0,0,0,0,0,0,0,0,0,0,30000,30000,0,0
056336,南亞科凱基98購02,0,0,0,0,0,0,0,0,0,0,0,0,0,53000,53000,0,0
056292,統一元大97購01  ,0,0,0,0,0,0,0,0,0,0,0,0,0,26000,26000,0,0
05578P,鴻海凱基96售11  ,0,0,0,0,0,0,0,0,0,0,0,0,0,20000,20000,0,0
055848,大立光元大97購11,0,0,0,0,0,0,0,0,0,0,0,0,0,2000,2000,0,0
05601P,鴻海元大97售04  ,0,0,0,0,0,0,0,0,0,0,0,0,0,307000,307000,0,0
056034,華通凱基98購01  ,0,0,0,0,0,0,0,0,0,0,0,0,0,23000,23000,0,0
056035,鴻海凱基97購06  ,0,0,0,0,0,0,0,0,0,0,0,0,0,10000,10000,0,0
05606P,TPK國票97售02   ,0,0,0,0,0,0,0,0,0,0,0,0,0,60000,60000,0,0
056062,大立光元大97購12,0,0,0,0,0,0,0,0,0,0,0,0,0,2000,2000,0,0
056063,大立光元大97購13,0,0,0,0,0,0,0,0,0,0,0,0,0,12000,12000,0,0
056064,大立光元大97購14,0,0,0,0,0,0,0,0,0,0,0,0,0,13000,13000,0,0
00776,新光ICE美國權值 ,0,0,0,0,0,0,0,0,0,0,0,0,0,1000,1000,0,0
00774B,新光中國政金綠債,0,0,0,0,0,0,0,0,0,0,0,0,0,2000,2000,0,0
00767,FH美國金融股    ,0,0,0,0,0,0,0,0,0,0,0,0,0,9000,9000,0,0
020011,統一微波高息20N ,0,0,0,0,0,0,0,0,0,0,0,0,0,2000,2000,0,0
00714,群益道瓊美國地產,0,0,0,0,0,0,0,0,0,0,0,0,0,100000,100000,0,0
00707R,元大S&P日圓反1  ,0,0,0,0,0,0,0,0,0,0,0,0,0,1000,1000,0,0
00657K,國泰日經225+U   ,0,0,0,0,0,0,0,0,0,0,0,0,0,100,100,0,0
00668K,國泰美國道瓊+U  ,0,0,0,0,0,0,0,0,0,0,0,0,0,100,100,0,0
00682U,元大美元指數    ,0,0,0,0,0,0,0,0,0,0,0,0,0,40000,40000,0,0
00625K,富邦上証+R      ,0,0,0,0,0,0,0,0,0,0,0,0,0,50000,50000,0,0
00645,富邦日本        ,0,0,0,0,0,0,0,0,0,0,0,0,0,122000,122000,0,0
00636K,國泰中國A50+U   ,0,0,0,0,0,0,0,0,0,0,0,0,0,100,100,0,0
03955P,華通統一93售04  ,0,0,0,0,0,0,0,0,0,0,0,0,0,200000,200000,0,0
04075P,臺股指凱基93售11,0,0,0,0,0,0,0,0,0,0,0,0,0,110000,110000,0,0
04085P,欣興元富93售01  ,0,0,0,0,0,0,0,0,0,0,0,0,0,70000,70000,0,0
04087P,臺股指元富93售05,0,0,0,0,0,0,0,0,0,0,0,0,0,60000,60000,0,0
04088P,臺股指元富93售06,0,0,0,0,0,0,0,0,0,0,0,0,0,30000,30000,0,0
04064P,臺股指兆豐93售03,0,0,0,0,0,0,0,0,0,0,0,0,0,40000,40000,0,0
044567,華通凱基93購03  ,0,0,0,0,0,0,0,0,0,0,0,0,0,4000,4000,0,0
03602C,臺股指元大93牛01,0,0,0,0,0,0,0,0,0,0,0,0,0,18000,18000,0,0
03430B,臺股指元大9B熊01,0,0,0,0,0,0,0,0,0,0,0,0,0,20000,20000,0,0
04178P,聯茂元大93售07  ,0,0,0,0,0,0,0,0,0,0,0,0,0,3000,3000,0,0
044901,聯發科凱基93購01,0,0,0,0,0,0,0,0,0,0,0,0,0,10000,10000,0,0
045013,大立光元大93購04,0,0,0,0,0,0,0,0,0,0,0,0,0,10000,10000,0,0
044820,臻鼎兆豐93購02  ,0,0,0,0,0,0,0,0,0,0,0,0,0,10000,10000,0,0
044763,瀚宇博凱基93購01,0,0,0,0,0,0,0,0,0,0,0,0,0,4000,4000,0,0
04470P,為升元大94售01  ,0,0,0,0,0,0,0,0,0,0,0,0,0,50000,50000,0,0
044646,旺宏群益93購01  ,0,0,0,0,0,0,0,0,0,0,0,0,0,11000,11000,0,0
047543,鴻海凱基94購09  ,0,0,0,0,0,0,0,0,0,0,0,0,0,82000,82000,0,0
046515,嘉澤元大92購04  ,0,0,0,0,0,0,0,0,0,0,0,0,0,10000,10000,0,0
047476,鴻海凱基94購08  ,0,0,0,0,0,0,0,0,0,0,0,0,0,70000,70000,0,0
047478,旺宏凱基93購04  ,0,0,0,0,0,0,0,0,0,0,0,0,0,13000,13000,0,0
047519,台達電元大93購02,0,0,0,0,0,0,0,0,0,0,0,0,0,96000,96000,0,0
046450,鴻海凱基93購12  ,0,0,0,0,0,0,0,0,0,0,0,0,0,50000,50000,0,0
047457,旺宏群益95購01  ,0,0,0,0,0,0,0,0,0,0,0,0,0,10000,10000,0,0
047458,聯發科群益93購08,0,0,0,0,0,0,0,0,0,0,0,0,0,10000,10000,0,0
046378,聯發科凱基92購04,0,0,0,0,0,0,0,0,0,0,0,0,0,20000,20000,0,0
04329P,TPK群益93售04   ,0,0,0,0,0,0,0,0,0,0,0,0,0,10000,10000,0,0
04325P,創意元大93售06  ,0,0,0,0,0,0,0,0,0,0,0,0,0,68000,68000,0,0
04446P,元油2X凱基94售03,0,0,0,0,0,0,0,0,0,0,0,0,0,87000,87000,0,0
04528P,智原凱基94售01  ,0,0,0,0,0,0,0,0,0,0,0,0,0,40000,40000,0,0
045341,華邦電凱基93購04,0,0,0,0,0,0,0,0,0,0,0,0,0,79000,79000,0,0
044462,漢唐兆豐93購01  ,0,0,0,0,0,0,0,0,0,0,0,0,0,36000,36000,0,0
04348P,燿華國票94售01  ,0,0,0,0,0,0,0,0,0,0,0,0,0,37000,37000,0,0
045121,康控元大93購03  ,0,0,0,0,0,0,0,0,0,0,0,0,0,39000,39000,0,0
045150,聯發科凱基93購03,0,0,0,0,0,0,0,0,0,0,0,0,0,12000,12000,0,0
045223,潤泰全元大93購01,0,0,0,0,0,0,0,0,0,0,0,0,0,17000,17000,0,0
045038,臻鼎群益93購01  ,0,0,0,0,0,0,0,0,0,0,0,0,0,20000,20000,0,0
04214P,美利達凱基93售04,0,0,0,0,0,0,0,0,0,0,0,0,0,100000,100000,0,0
042388,大立光永昌93購02,0,0,0,0,0,0,0,0,0,0,0,0,0,40000,40000,0,0
04243P,大立光永昌93售08,0,0,0,0,0,0,0,0,0,0,0,0,0,15000,15000,0,0
04244P,可成元大93售12  ,0,0,0,0,0,0,0,0,0,0,0,0,0,18000,18000,0,0
04252P,台達電元富93售02,0,0,0,0,0,0,0,0,0,0,0,0,0,6000,6000,0,0
047115,可成元大93購06  ,0,0,0,0,0,0,0,0,0,0,0,0,0,89000,89000,0,0
04715P,聯茂元大94售06  ,0,0,0,0,0,0,0,0,0,0,0,0,0,2000,2000,0,0
047073,大立光兆豐94購01,0,0,0,0,0,0,0,0,0,0,0,0,0,9000,9000,0,0
047879,台積電中信93購04,0,0,0,0,0,0,0,0,0,0,0,0,0,20000,20000,0,0
047412,鴻海永昌93購05  ,0,0,0,0,0,0,0,0,0,0,0,0,0,600000,600000,0,0
046952,南茂元大93購02  ,0,0,0,0,0,0,0,0,0,0,0,0,0,46000,46000,0,0
046965,復盛中信93購01  ,0,0,0,0,0,0,0,0,0,0,0,0,0,20000,20000,0,0
046961,大立光中信95購02,0,0,0,0,0,0,0,0,0,0,0,0,0,21000,21000,0,0
04724P,可成凱基94售08  ,0,0,0,0,0,0,0,0,0,0,0,0,0,35000,35000,0,0
04729P,臺股指中信96售01,0,0,0,0,0,0,0,0,0,0,0,0,0,20000,20000,0,0
047227,華新科凱基94購01,0,0,0,0,0,0,0,0,0,0,0,0,0,1000,1000,0,0
049528,台積電中信94購01,0,0,0,0,0,0,0,0,0,0,0,0,0,20000,20000,0,0
048568,緯穎元大93購06  ,0,0,0,0,0,0,0,0,0,0,0,0,0,9000,9000,0,0
048586,美利達富邦93購01,0,0,0,0,0,0,0,0,0,0,0,0,0,20000,20000,0,0
049459,全新元富95購02  ,0,0,0,0,0,0,0,0,0,0,0,0,0,20000,20000,0,0
048534,貿聯國票94購01  ,0,0,0,0,0,0,0,0,0,0,0,0,0,20000,20000,0,0
050445,鴻海元大94購21  ,0,0,0,0,0,0,0,0,0,0,0,0,0,101000,101000,0,0
04658P,臺股指永昌94售02,0,0,0,0,0,0,0,0,0,0,0,0,0,40000,40000,0,0
046591,康舒元大92購01  ,0,0,0,0,0,0,0,0,0,0,0,0,0,99000,99000,0,0
046643,臺股指永豐93購01,0,0,0,0,0,0,0,0,0,0,0,0,0,1654000,1654000,0,0
046693,台積電凱基93購03,0,0,0,0,0,0,0,0,0,0,0,0,0,25000,25000,0,0
045377,華邦電元大93購01,0,0,0,0,0,0,0,0,0,0,0,0,0,55000,55000,0,0
045433,康友永豐92購01  ,0,0,0,0,0,0,0,0,0,0,0,0,0,14000,14000,0,0
047701,鴻海凱基94購12  ,0,0,0,0,0,0,0,0,0,0,0,0,0,20000,20000,0,0
047708,聯發科凱基93購17,0,0,0,0,0,0,0,0,0,0,0,0,0,35000,35000,0,0
046827,漢唐群益93購02  ,0,0,0,0,0,0,0,0,0,0,0,0,0,10000,10000,0,0
046815,台積電凱基93購07,0,0,0,0,0,0,0,0,0,0,0,0,0,10000,10000,0,0
04559P,華通凱基94售03  ,0,0,0,0,0,0,0,0,0,0,0,0,0,50000,50000,0,0
045629,智邦凱基92購01  ,0,0,0,0,0,0,0,0,0,0,0,0,0,10000,10000,0,0
045639,冠德凱基93購01  ,0,0,0,0,0,0,0,0,0,0,0,0,0,68000,68000,0,0
045583,嘉晶元大92購02  ,0,0,0,0,0,0,0,0,0,0,0,0,0,11000,11000,0,0
045462,美律元大93購04  ,0,0,0,0,0,0,0,0,0,0,0,0,0,95000,95000,0,0
046291,友達統一94購01  ,0,0,0,0,0,0,0,0,0,0,0,0,0,20000,20000,0,0
046370,全新麥證93購01  ,0,0,0,10000,10000,0,0,0,0,0,0,0,0,10000,10000,0,0
046377,聯發科凱基92購03,0,0,0,0,0,0,0,0,0,0,0,0,0,10000,10000,0,0
045842,T50反1台新98購01,0,0,0,0,0,0,0,0,0,0,0,0,0,200000,200000,0,0
045818,鴻海凱基93購10  ,0,0,0,0,0,0,0,0,0,0,0,0,0,34000,34000,0,0
046068,國泰金凱基92購02,0,0,0,0,0,0,0,0,0,0,0,0,0,10000,10000,0,0
045904,勤誠元大92購01  ,0,0,0,0,0,0,0,0,0,0,0,0,0,12000,12000,0,0
045874,東元元富92購01  ,0,0,0,0,0,0,0,0,0,0,0,0,0,20000,20000,0,0
047829,旺宏元大93購06  ,0,0,0,0,0,0,0,0,0,0,0,0,0,10000,10000,0,0
047822,臺股指凱基93購16,0,0,0,0,0,0,0,0,0,0,0,0,0,570000,570000,0,0
050024,旺宏元大94購09  ,0,0,0,0,0,0,0,0,0,0,0,0,0,22000,22000,0,0
050028,華新科元大94購03,0,0,0,0,0,0,0,0,0,0,0,0,0,6000,6000,0,0
050059,旺宏凱基94購03  ,0,0,0,0,0,0,0,0,0,0,0,0,0,8000,8000,0,0
050062,聯發科凱基94購08,0,0,0,0,0,0,0,0,0,0,0,0,0,4000,4000,0,0
048860,玉晶光群益96購03,0,0,0,0,0,0,0,0,0,0,0,0,0,73000,73000,0,0
050343,鴻海元富94購01  ,0,0,0,0,0,0,0,0,0,0,0,0,0,6000,6000,0,0
048973,禾伸堂元大94購01,0,0,0,0,0,0,0,0,0,0,0,0,0,16000,16000,0,0
048938,玉晶光永豐95購02,0,0,0,0,0,0,0,0,0,0,0,0,0,12000,12000,0,0
049973,T50反1日盛9A購01,0,0,0,0,0,0,0,0,0,0,0,0,0,150000,150000,0,0
049933,GIS元大95購01   ,0,0,0,0,0,0,0,0,0,0,0,0,0,2000,2000,0,0
049935,南電元大94購08  ,0,0,0,0,0,0,0,0,0,0,0,0,0,30000,30000,0,0
049387,緯穎元大94購03  ,0,0,0,0,0,0,0,0,0,0,0,0,0,9000,9000,0,0
049815,緯穎元大94購06  ,0,0,0,0,0,0,0,0,0,0,0,0,0,3000,3000,0,0
049112,可成統一94購01  ,0,0,0,0,0,0,0,0,0,0,0,0,0,3000,3000,0,0
049440,T50反1統一94購04,0,0,0,0,0,0,0,0,0,0,0,0,0,20000,20000,0,0
050082,聯發科統一94購08,0,0,0,0,0,0,0,0,0,0,0,0,0,12000,12000,0,0
050102,鴻海富邦95購04  ,0,0,0,0,0,0,0,0,0,0,0,0,0,1000,1000,0,0
050107,鴻海元大94購12  ,0,0,0,0,0,0,0,0,0,0,0,0,0,1000,1000,0,0
050114,群創元大95購01  ,0,0,0,0,0,0,0,0,0,0,0,0,0,37000,37000,0,0
049896,聯發科統一94購06,0,0,0,0,0,0,0,0,0,0,0,0,0,48000,48000,0,0
049857,緯穎群益94購03  ,0,0,0,0,0,0,0,0,0,0,0,0,0,8000,8000,0,0
051431,群創元富99購02  ,0,0,0,0,0,0,0,0,0,0,0,0,0,30000,30000,0,0
05146P,鴻海元大95售10  ,0,0,0,0,0,0,0,0,0,0,0,0,0,271000,271000,0,0
051472,台積電凱基95購09,0,0,0,0,0,0,0,0,0,0,0,0,0,89000,89000,0,0
051485,玉晶光凱基97購02,0,0,0,0,0,0,0,0,0,0,0,0,0,75000,75000,0,0
051482,玉晶光凱基96購01,0,0,0,0,0,0,0,0,0,0,0,0,0,5000,5000,0,0
051712,嘉聯益群益95購01,0,0,0,0,0,0,0,0,0,0,0,0,0,11000,11000,0,0
051575,國巨元大96購03  ,0,0,0,0,0,0,0,0,0,0,0,0,0,110000,110000,0,0
051635,大立光國票96購04,0,0,0,0,0,0,0,0,0,0,0,0,0,11000,11000,0,0
050664,全新台新94購02  ,0,0,0,0,0,0,0,0,0,0,0,0,0,38000,38000,0,0
050656,瑞儀凱基96購01  ,0,0,0,0,0,0,0,0,0,0,0,0,0,10000,10000,0,0
048033,大立光凱基93購28,0,0,0,0,0,0,0,0,0,0,0,0,0,11000,11000,0,0
050583,瑞儀國票94購01  ,0,0,0,0,0,0,0,0,0,0,0,0,0,38000,38000,0,0
05058P,燿華國票97售01  ,0,0,0,0,0,0,0,0,0,0,0,0,0,37000,37000,0,0
050649,華新科凱基96購01,0,0,0,0,0,0,0,0,0,0,0,0,0,6000,6000,0,0
051360,緯創元大95購03  ,0,0,0,0,0,0,0,0,0,0,0,0,0,12000,12000,0,0
05134P,鴻海凱基96售06  ,0,0,0,0,0,0,0,0,0,0,0,0,0,10000,10000,0,0
051378,奇力新群益95購01,0,0,0,0,0,0,0,0,0,0,0,0,0,20000,20000,0,0
05136P,台積電凱基95售08,0,0,0,0,0,0,0,0,0,0,0,0,0,34000,34000,0,0
05132P,鴻海元富95售07  ,0,0,0,0,0,0,0,0,0,0,0,0,0,20000,20000,0,0
051336,智原永豐95購01  ,0,0,0,0,0,0,0,0,0,0,0,0,0,75000,75000,0,0
051334,宏達電永豐95購01,0,0,0,0,0,0,0,0,0,0,0,0,0,4000,4000,0,0
051433,中磊元富95購01  ,0,0,0,0,0,0,0,0,0,0,0,0,0,10000,10000,0,0
049016,國巨群益94購02  ,0,0,0,0,0,0,0,0,0,0,0,0,0,24000,24000,0,0
049017,旺宏群益96購03  ,0,0,0,0,0,0,0,0,0,0,0,0,0,64000,64000,0,0
04882P,鴻海凱基94售19  ,0,0,0,0,0,0,0,0,0,0,0,0,0,30000,30000,0,0
049796,國巨元大94購10  ,0,0,0,0,0,0,0,0,0,0,0,0,0,17000,17000,0,0
048483,可成國泰95購01  ,0,0,0,0,0,0,0,0,0,0,0,0,0,48000,48000,0,0
048790,大立光元大95購05,0,0,0,0,0,0,0,0,0,0,0,0,0,38000,38000,0,0
049178,宏達電凱基94購02,0,0,0,0,0,0,0,0,0,0,0,0,0,100000,100000,0,0
049172,鴻海凱基94購14  ,0,0,0,0,0,0,0,0,0,0,0,0,0,60000,60000,0,0
049242,佳世達元富96購01,0,0,0,0,0,0,0,0,0,0,0,0,0,20000,20000,0,0
049245,和鑫元富95購01  ,0,0,0,0,0,0,0,0,0,0,0,0,0,10000,10000,0,0
049267,瀚宇博元大95購02,0,0,0,0,0,0,0,0,0,0,0,0,0,4000,4000,0,0
049812,致伸元大94購03  ,0,0,0,0,0,0,0,0,0,0,0,0,0,78000,78000,0,0
048372,美利達統一93購01,0,0,0,0,0,0,0,0,0,0,0,0,0,44000,44000,0,0
04840P,大立光元大94售18,0,0,0,0,0,0,0,0,0,0,0,0,0,15000,15000,0,0
048086,鴻海凱基93購33  ,0,0,0,0,0,0,0,0,0,0,0,0,0,10000,10000,0,0
048098,嘉澤凱基93購04  ,0,0,0,0,0,0,0,0,0,0,0,0,0,94000,94000,0,0
048069,南亞科元富95購02,0,0,0,0,0,0,0,0,0,0,0,0,0,10000,10000,0,0
04811P,上銀元大94售02  ,0,0,0,0,0,0,0,0,0,0,0,0,0,1000,1000,0,0
04809P,台光電群益94售04,0,0,0,0,0,0,0,0,0,0,0,0,0,12000,12000,0,0
048112,宏達電群益93購05,0,0,0,0,0,0,0,0,0,0,0,0,0,120000,120000,0,0
048441,台積電凱基93購29,0,0,0,0,0,0,0,0,0,0,0,0,0,100000,100000,0,0
048210,鴻海日盛93購01  ,0,0,0,0,0,0,0,0,0,0,0,0,0,50000,50000,0,0
048220,鴻海凱基93購35  ,0,0,0,0,0,0,0,0,0,0,0,0,0,30000,30000,0,0
048219,為升凱基93購06  ,0,0,0,0,0,0,0,0,0,0,0,0,0,68000,68000,0,0
048256,鴻海統一93購08  ,0,0,0,0,0,0,0,0,0,0,0,0,0,1000,1000,0,0
048247,聯發科兆豐93購03,0,0,0,0,0,0,0,0,0,0,0,0,0,30000,30000,0,0
048245,台積電兆豐93購07,0,0,0,0,0,0,0,0,0,0,0,0,0,10000,10000,0,0
048227,亞光凱基93購05  ,0,0,0,0,0,0,0,0,0,0,0,0,0,14000,14000,0,0
051239,國巨元大96購02  ,0,0,0,0,0,0,0,0,0,0,0,0,0,1000,1000,0,0
05122P,鴻海永昌96售06  ,0,0,0,0,0,0,0,0,0,0,0,0,0,297000,297000,0,0
050964,晶技永豐95購02  ,0,0,0,0,0,0,0,0,0,0,0,0,0,10000,10000,0,0
05098P,鴻海凱基95售15  ,0,0,0,0,0,0,0,0,0,0,0,0,0,20000,20000,0,0
050761,華通元大94購05  ,0,0,0,0,0,0,0,0,0,0,0,0,0,50000,50000,0,0
050766,燿華元大96購02  ,0,0,0,0,0,0,0,0,0,0,0,0,0,10000,10000,0,0
050783,旺宏國泰96購02  ,0,0,0,0,0,0,0,0,0,0,0,0,0,12000,12000,0,0
050818,華新科凱基95購02,0,0,0,0,0,0,0,0,0,0,0,0,0,4000,4000,0,0
050810,鴻海凱基95購09  ,0,0,0,0,0,0,0,0,0,0,0,0,0,20000,20000,0,0
050813,旺宏凱基96購01  ,0,0,0,0,0,0,0,0,0,0,0,0,0,18000,18000,0,0
051103,緯穎元大96購03  ,0,0,0,0,0,0,0,0,0,0,0,0,0,5000,5000,0,0
050187,群創元大94購03  ,0,0,0,0,0,0,0,0,0,0,0,0,0,18000,18000,0,0
049600,緯穎元大95購02  ,0,0,0,0,0,0,0,0,0,0,0,0,0,18000,18000,0,0
050537,鴻海凱基95購05  ,0,0,0,0,0,0,0,0,0,0,0,0,0,11000,11000,0,0
050547,華新科凱基95購01,0,0,0,0,0,0,0,0,0,0,0,0,0,6000,6000,0,0
050542,宏碁凱基95購01  ,0,0,0,0,0,0,0,0,0,0,0,0,0,31000,31000,0,0
04870P,大立光元富94售11,0,0,0,0,0,0,0,0,0,0,0,0,0,10000,10000,0,0
049705,緯穎元大94購05  ,0,0,0,0,0,0,0,0,0,0,0,0,0,18000,18000,0,0
049646,旺宏凱基94購01  ,0,0,0,0,0,0,0,0,0,0,0,0,0,4000,4000,0,0
05256P,義隆凱基95售02  ,0,0,0,0,0,0,0,0,0,0,0,0,0,270000,270000,0,0
052596,群創群益98購05  ,0,0,0,0,0,0,0,0,0,0,0,0,0,13000,13000,0,0
052578,大立光統一97購01,0,0,0,0,0,0,0,0,0,0,0,0,0,10000,10000,0,0
052520,南亞科元大95購06,0,0,0,0,0,0,0,0,0,0,0,0,0,2000,2000,0,0
052633,國巨凱基96購05  ,0,0,0,0,0,0,0,0,0,0,0,0,0,30000,30000,0,0
053043,嘉晶凱基96購01  ,0,0,0,0,0,0,0,0,0,0,0,0,0,100000,100000,0,0
053077,同欣電永豐96購01,0,0,0,0,0,0,0,0,0,0,0,0,0,68000,68000,0,0
053090,新唐元大96購01  ,0,0,0,0,0,0,0,0,0,0,0,0,0,10000,10000,0,0
053155,晶技元大97購02  ,0,0,0,0,0,0,0,0,0,0,0,0,0,42000,42000,0,0
053116,華新科中信96購01,0,0,0,0,0,0,0,0,0,0,0,0,0,20000,20000,0,0
052885,高鐵兆豐98購01  ,0,0,0,0,0,0,0,0,0,0,0,0,0,35000,35000,0,0
052897,緯創群益96購03  ,0,0,0,0,0,0,0,0,0,0,0,0,0,17000,17000,0,0
053004,燿華永豐96購01  ,0,0,0,0,0,0,0,0,0,0,0,0,0,5000,5000,0,0
05205P,緯穎元大95售03  ,0,0,0,0,0,0,0,0,0,0,0,0,0,10000,10000,0,0
052045,瑞昱凱基96購01  ,0,0,0,0,0,0,0,0,0,0,0,0,0,17000,17000,0,0
052093,麗豐元大96購04  ,0,0,0,0,0,0,0,0,0,0,0,0,0,100000,100000,0,0
051975,美食凱基95購02  ,0,0,0,0,0,0,0,0,0,0,0,0,0,36000,36000,0,0
051906,國巨元大95購09  ,0,0,0,0,0,0,0,0,0,0,0,0,0,67000,67000,0,0
051831,緯穎元大96購04  ,0,0,0,0,0,0,0,0,0,0,0,0,0,5000,5000,0,0
052226,旺宏凱基95購06  ,0,0,0,0,0,0,0,0,0,0,0,0,0,6000,6000,0,0
052178,台郡元大96購03  ,0,0,0,0,0,0,0,0,0,0,0,0,0,55000,55000,0,0
052180,緯穎元大96購05  ,0,0,0,0,0,0,0,0,0,0,0,0,0,106000,106000,0,0
052201,超眾統一96購01  ,0,0,0,0,0,0,0,0,0,0,0,0,0,34000,34000,0,0
052144,鴻海群益95購10  ,0,0,0,0,0,0,0,0,0,0,0,0,0,100000,100000,0,0
052171,台積電元大95購21,0,0,0,0,0,0,0,0,0,0,0,0,0,246000,246000,0,0
05244P,台積電元大95售17,0,0,0,0,0,0,0,0,0,0,0,0,0,306000,306000,0,0
05241P,鴻海國泰97售04  ,0,0,0,0,0,0,0,0,0,0,0,0,0,420000,420000,0,0
052478,大立光群益95購05,0,0,0,0,0,0,0,0,0,0,0,0,0,21000,21000,0,0
053975,大立光元大98購04,0,0,0,0,0,0,0,0,0,0,0,0,0,50000,50000,0,0
054025,鴻海凱基96購17  ,0,0,0,0,0,0,0,0,0,0,0,0,0,60000,60000,0,0
053867,創意元大96購04  ,0,0,0,0,0,0,0,0,0,0,0,0,0,27000,27000,0,0
05388P,南亞科元大95售04,0,0,0,0,0,0,0,0,0,0,0,0,0,100000,100000,0,0
053905,華新科凱基96購10,0,0,0,0,0,0,0,0,0,0,0,0,0,8000,8000,0,0
053913,華新國票97購01  ,0,0,0,0,0,0,0,0,0,0,0,0,0,10000,10000,0,0
053902,S&P反1凱基97購01,0,0,0,0,0,0,0,0,0,0,0,0,0,450000,450000,0,0
053919,可成國票97購02  ,0,0,0,0,0,0,0,0,0,0,0,0,0,10000,10000,0,0
054127,台積電元大96購21,0,0,0,0,0,0,0,0,0,0,0,0,0,249000,249000,0,0
054147,GIS元大96購02   ,0,0,0,0,0,0,0,0,0,0,0,0,0,27000,27000,0,0
054042,華泰元大96購01  ,0,0,0,0,0,0,0,0,0,0,0,0,0,80000,80000,0,0
054466,欣興凱基97購03  ,0,0,0,0,0,0,0,0,0,0,0,0,0,5000,5000,0,0
054486,漢唐台新96購01  ,0,0,0,0,0,0,0,0,0,0,0,0,0,15000,15000,0,0
054219,楠梓電統一97購01,0,0,0,0,0,0,0,0,0,0,0,0,0,30000,30000,0,0
054255,亞光元大96購05  ,0,0,0,0,0,0,0,0,0,0,0,0,0,16000,16000,0,0
054286,台積電元大96購22,0,0,0,0,0,0,0,0,0,0,0,0,0,99000,99000,0,0
054287,台積電元大97購11,0,0,0,0,0,0,0,0,0,0,0,0,0,79000,79000,0,0
054314,嘉聯益凱基97購01,0,0,0,0,0,0,0,0,0,0,0,0,0,1000,1000,0,0
054300,華通凱基96購07  ,0,0,0,0,0,0,0,0,0,0,0,0,0,28000,28000,0,0
053552,華新科凱基96購08,0,0,0,0,0,0,0,0,0,0,0,0,0,16000,16000,0,0
05358P,大立光元大95售09,0,0,0,0,0,0,0,0,0,0,0,0,0,39000,39000,0,0
053598,日月光元大96購04,0,0,0,0,0,0,0,0,0,0,0,0,0,10000,10000,0,0
053642,瀚宇博永豐96購01,0,0,0,0,0,0,0,0,0,0,0,0,0,12000,12000,0,0
05369P,可成元富95售04  ,0,0,0,0,0,0,0,0,0,0,0,0,0,10000,10000,0,0
053676,新光金國泰98購02,0,0,0,0,0,0,0,0,0,0,0,0,0,60000,60000,0,0
053684,台積電元大96購17,0,0,0,0,0,0,0,0,0,0,0,0,0,424000,424000,0,0
053735,矽力中信97購01  ,0,0,0,0,0,0,0,0,0,0,0,0,0,20000,20000,0,0
053774,台達電元大96購04,0,0,0,0,0,0,0,0,0,0,0,0,0,68000,68000,0,0
05384P,大立光永豐95售02,0,0,0,0,0,0,0,0,0,0,0,0,0,30000,30000,0,0
05377P,鴻海凱基95售18  ,0,0,0,0,0,0,0,0,0,0,0,0,0,60000,60000,0,0
053809,上銀群益96購02  ,0,0,0,0,0,0,0,0,0,0,0,0,0,34000,34000,0,0
05380P,鴻海群益95售11  ,0,0,0,0,0,0,0,0,0,0,0,0,0,10000,10000,0,0
053280,群創元大9C購01  ,0,0,0,0,0,0,0,0,0,0,0,0,0,10000,10000,0,0
053300,大成鋼凱基96購02,0,0,0,0,0,0,0,0,0,0,0,0,0,5000,5000,0,0
053356,聯發科統一96購07,0,0,0,0,0,0,0,0,0,0,0,0,0,48000,48000,0,0
053323,群創群益98購07  ,0,0,0,0,0,0,0,0,0,0,0,0,0,13000,13000,0,0
05318P,臺股指永昌95售03,0,0,0,0,0,0,0,0,0,0,0,0,0,90000,90000,0,0
053273,國巨元大96購08  ,0,0,0,0,0,0,0,0,0,0,0,0,0,80000,80000,0,0
053390,彩晶元大9A購01  ,0,0,0,0,0,0,0,0,0,0,0,0,0,100000,100000,0,0
053398,和鑫中信99購01  ,0,0,0,0,0,0,0,0,0,0,0,0,0,20000,20000,0,0
053494,南亞科兆豐96購02,0,0,0,0,0,0,0,0,0,0,0,0,0,3000,3000,0,0
053477,大立光元大97購03,0,0,0,0,0,0,0,0,0,0,0,0,0,45000,45000,0,0
1725,元禎            ,11000,11000,0,0,0,0,0,0,0,0,0,0,0,0,0,0,0
2012,春雨            ,7000,9000,-2000,0,0,0,0,0,0,2000,2000,0,2000,0,0,0,0
06365P,鴻海凱基97售09  ,0,0,0,0,0,0,0,0,0,0,0,0,0,70000,70000,0,0
06362P,臺股指麥證97售01,0,0,0,10000,10000,0,0,0,0,0,0,0,0,10000,10000,0,0
06438P,玉晶光國票99售02,0,0,0,0,0,0,0,0,0,0,0,0,0,8000,8000,0,0
06445P,大立光凱基98售09,0,0,0,0,0,0,0,0,0,0,0,0,0,1000,1000,0,0
06429P,大立光元大97售15,0,0,0,0,0,0,0,0,0,0,0,0,0,30000,30000,0,0
06420P,大立光統一98售06,0,0,0,0,0,0,0,0,0,0,0,0,0,10000,10000,0,0
06399P,台表科凱基97售05,0,0,0,0,0,0,0,0,0,0,0,0,0,12000,12000,0,0
06470P,臺股指凱基99售10,0,0,0,0,0,0,0,0,0,0,0,0,0,10000,10000,0,0
06449P,台積電元大98售09,0,0,0,0,0,0,0,0,0,0,0,0,0,90000,90000,0,0
06494P,鴻海永昌98售03  ,0,0,0,0,0,0,0,0,0,0,0,0,0,100000,100000,0,0
06143P,鴻海永豐97售02  ,0,0,0,0,0,0,0,0,0,0,0,0,0,499000,499000,0,0
06113P,台積電群益97售01,0,0,0,0,0,0,0,0,0,0,0,0,0,10000,10000,0,0
06047P,聯發科富邦99售04,0,0,0,0,0,0,0,0,0,0,0,0,0,20000,20000,0,0
06054P,臺股指中信9A售01,0,0,0,0,0,0,0,0,0,0,0,0,0,3000,3000,0,0
05997P,嘉聯益群益96售02,0,0,0,0,0,0,0,0,0,0,0,0,0,10000,10000,0,0
05990P,台積電群益96售13,0,0,0,0,0,0,0,0,0,0,0,0,0,20000,20000,0,0
06183P,大立光元大97售05,0,0,0,0,0,0,0,0,0,0,0,0,0,30000,30000,0,0
06200P,聯發科元大97售18,0,0,0,0,0,0,0,0,0,0,0,0,0,21000,21000,0,0
06197P,國巨元大97售08  ,0,0,0,0,0,0,0,0,0,0,0,0,0,15000,15000,0,0
06224P,可成元富97售02  ,0,0,0,0,0,0,0,0,0,0,0,0,0,10000,10000,0,0
06206P,台積電凱基97售11,0,0,0,0,0,0,0,0,0,0,0,0,0,60000,60000,0,0
06236P,台積電元大97售25,0,0,0,0,0,0,0,0,0,0,0,0,0,30000,30000,0,0
06311P,嘉聯益元富97售02,0,0,0,0,0,0,0,0,0,0,0,0,0,30000,30000,0,0
06312P,樺漢元富97售02  ,0,0,0,0,0,0,0,0,0,0,0,0,0,26000,26000,0,0
06281P,臺股指凱基97售13,0,0,0,0,0,0,0,0,0,0,0,0,0,5000,5000,0,0
9944,新麗            ,16000,16000,0,0,0,0,0,0,0,0,1000,1000,0,0,0,0,0
055822,臺股指國票97購09,0,0,0,0,0,0,0,0,0,-1000,0,0,0,0,1000,-1000,-1000
055932,玉山金群益99購01,0,0,0,0,0,0,0,0,0,-1000,0,0,0,62000,63000,-1000,-1000
056169,鴻海元富97購08  ,0,0,0,0,0,0,0,0,0,-1000,0,0,0,0,1000,-1000,-1000
05707P,中磊永豐96售01  ,0,0,0,0,0,0,0,0,0,-1000,0,0,0,0,1000,-1000,-1000
05857P,旺宏中信98售02  ,0,0,0,0,0,0,0,0,0,-1000,0,0,0,20000,21000,-1000,-1000
05943P,欣興凱基96售03  ,0,0,0,0,0,0,0,0,0,-1000,0,0,0,0,1000,-1000,-1000
056545,TPK凱基98購02   ,0,0,0,0,0,0,0,0,0,-1000,0,0,0,0,1000,-1000,-1000
056534,京元電凱基98購01,0,0,0,0,0,0,0,0,0,-1000,0,0,0,4000,5000,-1000,-1000
056513,臻鼎亞東99購01  ,0,0,0,0,0,0,0,0,0,-1000,0,0,0,0,1000,-1000,-1000
056755,聯茂兆豐98購01  ,0,0,0,0,0,0,0,0,0,-1000,0,0,0,0,1000,-1000,-1000
056766,義隆元大98購01  ,0,0,0,0,0,0,0,0,0,-1000,0,0,0,0,1000,-1000,-1000
056724,臻鼎中信9A購01  ,0,0,0,0,0,0,0,0,0,-1000,0,0,0,0,1000,-1000,-1000
056749,滬深2X兆豐99購01,0,0,0,0,0,0,0,0,0,-1000,0,0,0,0,1000,-1000,-1000
056716,康舒永豐98購01  ,0,0,0,0,0,0,0,0,0,-1000,0,0,0,20000,21000,-1000,-1000
056695,景碩群益99購01  ,0,0,0,0,0,0,0,0,0,-1000,0,0,0,9000,10000,-1000,-1000
056667,上銀國票99購01  ,0,0,0,0,0,0,0,0,0,-1000,0,0,0,4000,5000,-1000,-1000
056611,國巨永豐98購03  ,0,0,0,0,0,0,0,0,0,-1000,0,0,0,3000,4000,-1000,-1000
056620,華新科永豐98購02,0,0,0,0,0,0,0,0,0,-1000,0,0,0,16000,17000,-1000,-1000
05539P,鎧勝永豐96售01  ,0,0,0,0,0,0,0,0,0,-1000,0,0,0,0,1000,-1000,-1000
055433,嘉聯益群益99購01,0,0,0,0,0,0,0,0,0,-1000,0,0,0,11000,12000,-1000,-1000
055461,TPK永豐97購01   ,0,0,0,0,0,0,0,0,0,-1000,0,0,0,5000,6000,-1000,-1000
055308,聯發科群益97購04,0,0,0,0,0,0,0,0,0,-1000,0,0,0,0,1000,-1000,-1000
055545,國巨凱基97購06  ,0,0,0,0,0,0,0,0,0,-1000,0,0,0,0,1000,-1000,-1000
055469,台光電凱基97購01,0,0,0,0,0,0,0,0,0,-1000,0,0,0,0,1000,-1000,-1000
055664,和大群益98購02  ,0,0,0,0,0,0,0,0,0,-1000,0,0,0,194000,195000,-1000,-1000
054854,台積電麥證97購01,0,0,0,80000,81000,-1000,0,0,0,-1000,0,0,0,80000,81000,-1000,-1000
054837,欣興第一97購01  ,0,0,0,0,0,0,0,0,0,-1000,0,0,0,0,1000,-1000,-1000
05483P,國巨凱基95售07  ,0,0,0,0,0,0,0,0,0,-1000,0,0,0,0,1000,-1000,-1000
054664,台表科元大97購04,0,0,0,0,0,0,0,0,0,-1000,0,0,0,0,1000,-1000,-1000
054658,道瓊銀元大9A購01,0,0,0,0,0,0,0,0,0,-1000,0,0,0,0,1000,-1000,-1000
054715,中橡康和97購01  ,0,0,0,0,0,0,0,0,0,-1000,0,0,0,0,1000,-1000,-1000
054743,聯鈞凱基99購01  ,0,0,0,0,0,0,0,0,0,-1000,0,0,0,0,1000,-1000,-1000
047806,旺宏凱基93購05  ,0,0,0,0,0,0,0,0,0,-1000,0,0,0,33000,34000,-1000,-1000
045986,南亞科永昌93購01,0,0,0,0,0,0,0,0,0,-1000,0,0,0,0,1000,-1000,-1000
04591P,上銀元大94售01  ,0,0,0,0,0,0,0,0,0,-1000,0,0,0,0,1000,-1000,-1000
045736,台積電群益94購01,0,0,0,0,0,0,0,0,0,-1000,0,0,0,0,1000,-1000,-1000
046375,友達凱基98購01  ,0,0,0,0,0,0,0,0,0,-1000,0,0,0,10000,11000,-1000,-1000
04563P,可成凱基94售05  ,0,0,0,0,0,0,0,0,0,-1000,0,0,0,47000,48000,-1000,-1000
04679P,臺股指統一94售04,0,0,0,0,0,0,0,0,0,-1000,0,0,0,0,1000,-1000,-1000
050724,國巨國票96購01  ,0,0,0,0,0,0,0,0,0,-1000,0,0,0,0,1000,-1000,-1000
05046P,台光電永豐95售02,0,0,0,0,0,0,0,0,0,-1000,0,0,0,6000,7000,-1000,-1000
050458,台郡元大94購03  ,0,0,0,0,0,0,0,0,0,-1000,0,0,0,5000,6000,-1000,-1000
048504,A50正2中信95購01,0,0,0,0,0,0,0,0,0,-1000,0,0,0,0,1000,-1000,-1000
047003,鴻海統一93購05  ,0,0,0,0,0,0,0,0,0,-1000,0,0,0,0,1000,-1000,-1000
049536,T50反1群益94購02,0,0,0,0,0,0,0,0,0,-1000,0,0,0,0,1000,-1000,-1000
047406,香港反統一94購01,0,0,0,0,0,0,0,0,0,-1000,0,0,0,0,1000,-1000,-1000
04705P,臺股指統一95售02,0,0,0,0,0,0,0,0,0,-1000,0,0,0,0,1000,-1000,-1000
047114,全新元大94購01  ,0,0,0,0,0,0,0,0,0,-1000,0,0,0,1000,2000,-1000,-1000
042315,T50反1台新96購01,0,0,0,0,0,0,0,0,0,-1000,0,0,0,0,1000,-1000,-1000
042116,元油2X國票97購01,0,0,0,0,0,0,0,0,0,-1000,0,0,0,0,1000,-1000,-1000
045152,大立光凱基93購03,0,0,0,0,0,0,0,0,0,-1000,0,0,0,0,1000,-1000,-1000
045122,臺股指元大93購08,0,0,0,0,0,0,0,0,0,-1000,0,0,0,0,1000,-1000,-1000
04359P,中磊永豐94售01  ,0,0,0,0,0,0,0,0,0,-1000,0,0,0,0,1000,-1000,-1000
044374,燿華兆豐93購01  ,0,0,0,0,0,0,0,0,0,-1000,0,0,0,0,1000,-1000,-1000
045296,台積電元大93購03,0,0,0,0,0,0,0,0,0,-1000,0,0,0,0,1000,-1000,-1000
046465,GIS凱基95購01   ,0,0,0,0,0,0,0,0,0,-1000,0,0,0,0,1000,-1000,-1000
047542,華通凱基94購02  ,0,0,0,0,0,0,0,0,0,-1000,0,0,0,2000,3000,-1000,-1000
046556,道瓊指凱基92購01,0,0,0,0,0,0,0,0,0,-1000,0,0,0,0,1000,-1000,-1000
047579,大立光群益94購02,0,0,0,0,0,0,0,0,0,-1000,0,0,0,0,1000,-1000,-1000
04131P,裕隆群益93售01  ,0,0,0,0,0,0,0,0,0,-1000,0,0,0,0,1000,-1000,-1000
04176P,台達電元大94售01,0,0,0,0,0,0,0,0,0,-1000,0,0,0,0,1000,-1000,-1000
03570P,台積電元大03售09,0,0,0,0,0,0,0,0,0,-1000,0,0,0,0,1000,-1000,-1000
03639P,祥碩凱基93售05  ,0,0,0,0,0,0,0,0,0,-1000,0,0,0,0,1000,-1000,-1000
03833P,台光電群益93售01,0,0,0,0,0,0,0,0,0,-1000,0,0,0,0,1000,-1000,-1000
03702P,中磊元大93售02  ,0,0,0,0,0,0,0,0,0,-1000,0,0,0,0,1000,-1000,-1000
03689P,TPK元富93售01   ,0,0,0,0,0,0,0,0,0,-1000,0,0,0,0,1000,-1000,-1000
03771P,中磊元大93售03  ,0,0,0,0,0,0,0,0,0,-1000,0,0,0,0,1000,-1000,-1000
03772P,聯茂元大93售02  ,0,0,0,0,0,0,0,0,0,-1000,0,0,0,0,1000,-1000,-1000
03647P,京元電元富95售02,0,0,0,0,0,0,0,0,0,-1000,0,0,0,0,1000,-1000,-1000
04066P,京元電凱基93售02,0,0,0,0,0,0,0,0,0,-1000,0,0,0,0,1000,-1000,-1000
03098P,大立光凱基01售10,0,0,0,0,0,0,0,0,0,-1000,0,0,0,0,1000,-1000,-1000
03922P,中磊凱基93售01  ,0,0,0,0,0,0,0,0,0,-1000,0,0,0,0,1000,-1000,-1000
03987P,亞光群益93售02  ,0,0,0,0,0,0,0,0,0,-1000,0,0,0,10000,11000,-1000,-1000
03971P,智邦亞東93售01  ,0,0,0,0,0,0,0,0,0,-1000,0,0,0,0,1000,-1000,-1000
006204,永豐臺灣加權    ,0,0,0,0,0,0,0,0,0,-1000,0,0,0,0,1000,-1000,-1000
00666R,富邦恒生國企反1 ,0,0,0,0,0,0,0,0,0,-1000,0,0,0,82000,83000,-1000,-1000
03022X,富展01          ,0,0,0,0,0,0,0,0,0,-1000,0,0,0,0,1000,-1000,-1000
051147,南亞科凱基95購05,0,0,0,0,0,0,0,0,0,-1000,0,0,0,0,1000,-1000,-1000
050780,台表科元大96購01,0,0,0,0,0,0,0,0,0,-1000,0,0,0,100000,101000,-1000,-1000
050887,台積電富邦95購05,0,0,0,0,0,0,0,0,0,-1000,0,0,0,0,1000,-1000,-1000
04861P,中磊群益94售02  ,0,0,0,0,0,0,0,0,0,-1000,0,0,0,0,1000,-1000,-1000
05119P,聯發科國泰96售02,0,0,0,0,0,0,0,0,0,-1000,0,0,0,0,1000,-1000,-1000
051261,鴻海永昌96購05  ,0,0,0,0,0,0,0,0,0,-1000,0,0,0,0,1000,-1000,-1000
048068,南亞科元富95購01,0,0,0,0,0,0,0,0,0,-1000,0,0,0,20000,21000,-1000,-1000
04837P,華新科元大94售05,0,0,0,0,0,0,0,0,0,-1000,0,0,0,0,1000,-1000,-1000
048332,台積電富邦94購02,0,0,0,0,0,0,0,0,0,-1000,0,0,0,0,1000,-1000,-1000
048302,上証反凱基93購01,0,0,0,0,0,0,0,0,0,-1000,0,0,0,0,1000,-1000,-1000
049277,臺股指元大94購12,0,0,0,0,0,0,0,0,0,-1000,0,0,0,0,1000,-1000,-1000
04921P,TPK凱基94售05   ,0,0,0,0,0,0,0,0,0,-1000,0,0,0,0,1000,-1000,-1000
04915P,鴻海永昌96售02  ,0,0,0,0,0,0,0,0,0,-1000,0,0,0,298000,299000,-1000,-1000
048475,台郡永豐93購02  ,0,0,0,0,0,0,0,0,0,-1000,0,0,0,68000,69000,-1000,-1000
04844P,京元電亞東94售01,0,0,0,0,0,0,0,0,0,-1000,0,0,0,0,1000,-1000,-1000
04976P,中磊凱基94售01  ,0,0,0,0,0,0,0,0,0,-1000,0,0,0,0,1000,-1000,-1000
049062,華新科日盛94購01,0,0,0,0,0,0,0,0,0,-1000,0,0,0,3000,4000,-1000,-1000
051332,奇力新永豐95購01,0,0,0,0,0,0,0,0,0,-1000,0,0,0,20000,21000,-1000,-1000
051299,致茂凱基95購01  ,0,0,0,0,0,0,0,0,0,-1000,0,0,0,21000,22000,-1000,-1000
050593,台表科永豐94購03,0,0,0,0,0,0,0,0,0,-1000,0,0,0,0,1000,-1000,-1000
050578,聯發科國票95購03,0,0,0,0,0,0,0,0,0,-1000,0,0,0,0,1000,-1000,-1000
047988,志超群益93購02  ,0,0,0,0,0,0,0,0,0,-1000,0,0,0,1000,2000,-1000,-1000
051611,鈺齊群益95購02  ,0,0,0,0,0,0,0,0,0,-1000,0,0,0,10000,11000,-1000,-1000
05166P,中磊元富95售03  ,0,0,0,0,0,0,0,0,0,-1000,0,0,0,0,1000,-1000,-1000
05151P,台光電群益95售02,0,0,0,0,0,0,0,0,0,-1000,0,0,0,35000,36000,-1000,-1000
051511,鈺齊中信97購01  ,0,0,0,0,0,0,0,0,0,-1000,0,0,0,47000,48000,-1000,-1000
051463,世芯國泰97購02  ,0,0,0,0,0,0,0,0,0,-1000,0,0,0,100000,101000,-1000,-1000
051441,鴻海元大95購13  ,0,0,0,0,0,0,0,0,0,-1000,0,0,0,10000,11000,-1000,-1000
051408,台積電國票95購03,0,0,0,0,0,0,0,0,0,-1000,0,0,0,444000,445000,-1000,-1000
04944P,元油2X永豐94售06,0,0,0,0,0,0,0,0,0,-1000,0,0,0,0,1000,-1000,-1000
049386,嘉聯益元大95購01,0,0,0,0,0,0,0,0,0,-1000,0,0,0,19000,20000,-1000,-1000
05033P,T50反1元大98售01,0,0,0,0,0,0,0,0,0,-1000,0,0,0,0,1000,-1000,-1000
050308,矽創中信97購01  ,0,0,0,0,0,0,0,0,0,-1000,0,0,0,0,1000,-1000,-1000
053463,可成富邦98購01  ,0,0,0,0,0,0,0,0,0,-1000,0,0,0,15000,16000,-1000,-1000
053382,友達元大9C購02  ,0,0,0,0,0,0,0,0,0,-1000,0,0,0,42000,43000,-1000,-1000
053391,嘉聯益元大99購01,0,0,0,0,0,0,0,0,0,-1000,0,0,0,0,1000,-1000,-1000
053218,TPK凱基96購01   ,0,0,0,0,0,0,0,0,0,-1000,0,0,0,0,1000,-1000,-1000
053579,華通元大97購01  ,0,0,0,0,0,0,0,0,0,-1000,0,0,0,0,1000,-1000,-1000
053612,T50反1群益96購01,0,0,0,0,0,0,0,0,0,-1000,0,0,0,0,1000,-1000,-1000
054416,禾伸堂元大97購01,0,0,0,0,0,0,0,0,0,-1000,0,0,0,0,1000,-1000,-1000
054036,T50反1元大96購08,0,0,0,0,0,0,0,0,0,-1000,0,0,0,0,1000,-1000,-1000
054023,和大康和96購01  ,0,0,0,0,0,0,0,0,0,-1000,0,0,0,0,1000,-1000,-1000
052336,矽力日盛95購01  ,0,0,0,0,0,0,0,0,0,-1000,0,0,0,0,1000,-1000,-1000
052328,台表科中信99購01,0,0,0,0,0,0,0,0,0,-1000,0,0,0,0,1000,-1000,-1000
052131,台積電凱基96購01,0,0,0,0,0,0,0,0,0,-1000,0,0,0,0,1000,-1000,-1000
05183P,台積電元富95售07,0,0,0,0,0,0,0,0,0,-1000,0,0,0,1000,2000,-1000,-1000
05185P,鴻海中信95售04  ,0,0,0,0,0,0,0,0,0,-1000,0,0,0,0,1000,-1000,-1000
051979,群創凱基97購01  ,0,0,0,0,0,0,0,0,0,-1000,0,0,0,0,1000,-1000,-1000
052095,彩晶元大97購01  ,0,0,0,0,0,0,0,0,0,-1000,0,0,0,0,1000,-1000,-1000
053003,國巨永豐96購02  ,0,0,0,0,0,0,0,0,0,-1000,0,0,0,50000,51000,-1000,-1000
052895,台積電群益96購04,0,0,0,0,0,0,0,0,0,-1000,0,0,0,81000,82000,-1000,-1000
052877,矽創凱基96購01  ,0,0,0,0,0,0,0,0,0,-1000,0,0,0,0,1000,-1000,-1000
052934,中磊元大96購01  ,0,0,0,0,0,0,0,0,0,-1000,0,0,0,27000,28000,-1000,-1000
053145,元黃金元大96購02,0,0,0,0,0,0,0,0,0,-1000,0,0,0,0,1000,-1000,-1000
053151,華新科元大96購04,0,0,0,0,0,0,0,0,0,-1000,0,0,0,6000,7000,-1000,-1000
052608,欣興元大97購01  ,0,0,0,0,0,0,0,0,0,-1000,0,0,0,0,1000,-1000,-1000
05257P,欣興凱基95售04  ,0,0,0,0,0,0,0,0,0,-1000,0,0,0,0,1000,-1000,-1000
052841,群創富邦96購02  ,0,0,0,0,0,0,0,0,0,-1000,0,0,0,0,1000,-1000,-1000
6201,亞弘電          ,11000,12000,-1000,0,0,0,0,0,0,0,0,0,0,0,0,0,-1000
06263P,燿華凱基97售04  ,0,0,0,0,0,0,0,0,0,-1000,0,0,0,0,1000,-1000,-1000
06318P,臺股指元富97售05,0,0,0,0,0,0,0,0,0,-1000,0,0,0,0,1000,-1000,-1000
05993P,國巨元大96售13  ,0,0,0,0,0,0,0,0,0,-1000,0,0,0,0,1000,-1000,-1000
06138P,台積電中信99售01,0,0,0,0,0,0,0,0,0,-1000,0,0,0,5000,6000,-1000,-1000
06512P,元油2X凱基9B售01,0,0,0,0,0,0,0,0,0,-1000,0,0,0,0,1000,-1000,-1000
1219,福壽            ,6000,7000,-1000,0,0,0,0,0,0,0,0,0,0,0,0,0,-1000
1438,裕豐            ,0,2000,-2000,0,0,0,0,0,0,1000,1000,0,1000,0,0,0,-1000
2722,夏都            ,2000,3000,-1000,0,0,0,0,0,0,0,0,0,0,0,0,0,-1000
054973,台郡元大98購02  ,0,0,0,0,0,0,0,0,0,-2000,0,0,0,68000,70000,-2000,-2000
055017,緯穎元富97購01  ,0,0,0,0,0,0,0,0,0,-2000,0,0,0,143000,145000,-2000,-2000
055019,福懋科元富97購01,0,0,0,0,0,0,0,0,0,-2000,0,0,0,25000,27000,-2000,-2000
055040,台虹富邦99購01  ,0,0,0,0,0,0,0,0,0,-2000,0,0,0,0,2000,-2000,-2000
055776,宏達電凱基98購02,0,0,0,0,0,0,0,0,0,-2000,0,0,0,5000,7000,-2000,-2000
055718,可成元大97購02  ,0,0,0,0,0,0,0,0,0,-2000,0,0,0,14000,16000,-2000,-2000
055719,可成元大97購03  ,0,0,0,0,0,0,0,0,0,-2000,0,0,0,0,2000,-2000,-2000
055459,建準永豐97購03  ,0,0,0,0,0,0,0,0,0,-2000,0,0,0,68000,70000,-2000,-2000
055528,華邦電群益97購01,0,0,0,0,0,0,0,0,0,-2000,0,0,0,20000,22000,-2000,-2000
055634,訊芯永豐97購02  ,0,0,0,0,0,0,0,0,0,-2000,0,0,0,126000,128000,-2000,-2000
055175,建準統一97購01  ,0,0,0,0,0,0,0,0,0,-2000,0,0,0,18000,20000,-2000,-2000
056451,可成凱基99購01  ,0,0,0,0,0,0,0,0,0,-2000,0,0,0,2000,4000,-2000,-2000
056550,瑞儀凱基99購01  ,0,0,0,0,0,0,0,0,0,-2000,0,0,0,0,2000,-2000,-2000
056595,台積電元富98購04,0,0,0,0,0,0,0,0,0,-2000,0,0,0,125000,127000,-2000,-2000
05941P,聯發科凱基96售22,0,0,0,0,0,0,0,0,0,-2000,0,0,0,0,2000,-2000,-2000
056846,晶相光元富98購01,0,0,0,0,0,0,0,0,0,-2000,0,0,0,0,2000,-2000,-2000
056215,華新科國票97購03,0,0,0,0,0,0,0,0,0,-2000,0,0,0,4000,6000,-2000,-2000
055892,國巨統一99購01  ,0,0,0,0,0,0,0,0,0,-2000,0,0,0,6000,8000,-2000,-2000
055797,華通富邦98購01  ,0,0,0,0,0,0,0,0,0,-2000,0,0,0,0,2000,-2000,-2000
055868,臺股指元大97購07,0,0,0,0,0,0,0,0,0,-2000,0,0,0,0,2000,-2000,-2000
020007,凱基臺灣500N    ,0,0,0,0,0,0,0,0,0,-2000,0,0,0,0,2000,-2000,-2000
04019P,聯茂永豐93售01  ,0,0,0,0,0,0,0,0,0,-2000,0,0,0,0,2000,-2000,-2000
00709,富邦歐洲        ,0,0,0,0,0,0,0,0,0,-2000,0,0,0,100000,102000,-2000,-2000
00706L,元大S&P日圓正2  ,0,0,0,0,0,0,0,0,0,-2000,0,0,0,0,2000,-2000,-2000
0057,富邦摩台        ,0,0,0,0,0,0,0,0,0,-2000,0,0,0,20000,22000,-2000,-2000
04083P,欣興統一94售01  ,0,0,0,0,0,0,0,0,0,-2000,0,0,0,0,2000,-2000,-2000
03648C,T50反1元大96牛07,0,0,0,0,0,0,0,0,0,-2000,0,0,0,3000,5000,-2000,-2000
03856P,易華電永豐93售01,0,0,0,0,0,0,0,0,0,-2000,0,0,0,0,2000,-2000,-2000
03481P,欣興群益02售08  ,0,0,0,0,0,0,0,0,0,-2000,0,0,0,0,2000,-2000,-2000
04126P,滬深2X國票95售02,0,0,0,0,0,0,0,0,0,-2000,0,0,0,0,2000,-2000,-2000
044805,旭富凱基93購01  ,0,0,0,0,0,0,0,0,0,-2000,0,0,0,0,2000,-2000,-2000
044879,上証2X群益93購01,0,0,0,0,0,0,0,0,0,-2000,0,0,0,0,2000,-2000,-2000
04650P,臺股指凱基94售09,0,0,0,0,0,0,0,0,0,-2000,0,0,0,6000,8000,-2000,-2000
043652,微星國泰93購01  ,0,0,0,0,0,0,0,0,0,-2000,0,0,0,171000,173000,-2000,-2000
042280,元石油富邦96購01,0,0,0,0,0,0,0,0,0,-2000,0,0,0,0,2000,-2000,-2000
042793,台積電台新9C購01,0,0,0,0,0,0,0,0,0,-2000,0,0,0,0,2000,-2000,-2000
047181,智邦元大93購06  ,0,0,0,0,0,0,0,0,0,-2000,0,0,0,68000,70000,-2000,-2000
050350,全新群益94購04  ,0,0,0,0,0,0,0,0,0,-2000,0,0,0,107000,109000,-2000,-2000
049504,臺股指元大94購15,0,0,0,0,0,0,0,0,0,-2000,0,0,0,0,2000,-2000,-2000
050684,台郡元富94購02  ,0,0,0,0,0,0,0,0,0,-2000,0,0,0,0,2000,-2000,-2000
050681,南亞科元富94購01,0,0,0,0,0,0,0,0,0,-2000,0,0,0,20000,22000,-2000,-2000
05040P,聯發科凱基95售05,0,0,0,0,0,0,0,0,0,-2000,0,0,0,70000,72000,-2000,-2000
045558,冠德國票92購01  ,0,0,0,0,0,0,0,0,0,-2000,0,0,0,0,2000,-2000,-2000
045420,台積電凱基92購07,0,0,0,0,0,0,0,0,0,-2000,0,0,0,0,2000,-2000,-2000
046694,智邦凱基93購01  ,0,0,0,0,0,0,0,0,0,-2000,0,0,0,40000,42000,-2000,-2000
046866,台積電統一94購03,0,0,0,0,0,0,0,0,0,-2000,0,0,0,0,2000,-2000,-2000
048870,義隆國票96購01  ,0,0,0,0,0,0,0,0,0,-2000,0,0,0,76000,78000,-2000,-2000
049921,大立光元大94購16,0,0,0,0,0,0,0,0,0,-2000,0,0,0,0,2000,-2000,-2000
051052,台積電群益95購01,0,0,0,0,0,0,0,0,0,-2000,0,0,0,10000,12000,-2000,-2000
050108,鴻海元大94購13  ,0,0,0,0,0,0,0,0,0,-2000,0,0,0,0,2000,-2000,-2000
050131,新光金凱基94購01,0,0,0,0,0,0,0,0,0,-2000,0,0,0,0,2000,-2000,-2000
050239,廣達凱基94購01  ,0,0,0,0,0,0,0,0,0,-2000,0,0,0,6000,8000,-2000,-2000
050283,T50反1凱基9A購01,0,0,0,0,0,0,0,0,0,-2000,0,0,0,23000,25000,-2000,-2000
050270,景碩元大94購01  ,0,0,0,0,0,0,0,0,0,-2000,0,0,0,36000,38000,-2000,-2000
050252,聯發科國泰95購01,0,0,0,0,0,0,0,0,0,-2000,0,0,0,147000,149000,-2000,-2000
051442,正崴元大95購02  ,0,0,0,0,0,0,0,0,0,-2000,0,0,0,38000,40000,-2000,-2000
051661,華新科永昌96購01,0,0,0,0,0,0,0,0,0,-2000,0,0,0,0,2000,-2000,-2000
051683,A50正2凱基97購01,0,0,0,0,0,0,0,0,0,-2000,0,0,0,0,2000,-2000,-2000
047960,鈺齊永豐93購01  ,0,0,0,0,0,0,0,0,0,-2000,0,0,0,0,2000,-2000,-2000
051355,聯發科元大96購01,0,0,0,0,0,0,0,0,0,-2000,0,0,0,0,2000,-2000,-2000
049083,大立光凱基94購02,0,0,0,0,0,0,0,0,0,-2000,0,0,0,0,2000,-2000,-2000
049406,T50反1日盛97購01,0,0,0,0,0,0,0,0,0,-2000,0,0,0,0,2000,-2000,-2000
048417,國巨統一94購01  ,0,0,0,0,0,0,0,0,0,-2000,0,0,0,0,2000,-2000,-2000
048125,和鑫元大96購01  ,0,0,0,0,0,0,0,0,0,-2000,0,0,0,0,2000,-2000,-2000
049580,國巨元大94購07  ,0,0,0,0,0,0,0,0,0,-2000,0,0,0,0,2000,-2000,-2000
050491,旺宏國泰96購01  ,0,0,0,0,0,0,0,0,0,-2000,0,0,0,5000,7000,-2000,-2000
051115,華通麥證96購01  ,0,0,0,10000,12000,-2000,0,0,0,-2000,0,0,0,10000,12000,-2000,-2000
04869P,鴻海元富95售02  ,0,0,0,0,0,0,0,0,0,-2000,0,0,0,6000,8000,-2000,-2000
048729,鴻海麥證94購01  ,0,0,0,0,2000,-2000,0,0,0,-2000,0,0,0,0,2000,-2000,-2000
052871,群創凱基98購07  ,0,0,0,0,0,0,0,0,0,-2000,0,0,0,39000,41000,-2000,-2000
05276P,GIS永豐95售02   ,0,0,0,0,0,0,0,0,0,-2000,0,0,0,70000,72000,-2000,-2000
052690,台表科元大97購01,0,0,0,0,0,0,0,0,0,-2000,0,0,0,0,2000,-2000,-2000
052705,超眾國票97購01  ,0,0,0,0,0,0,0,0,0,-2000,0,0,0,10000,12000,-2000,-2000
052581,訊芯元富98購01  ,0,0,0,0,0,0,0,0,0,-2000,0,0,0,0,2000,-2000,-2000
053171,中磊群益96購01  ,0,0,0,0,0,0,0,0,0,-2000,0,0,0,25000,27000,-2000,-2000
053039,聯發科凱基96購11,0,0,0,0,0,0,0,0,0,-2000,0,0,0,141000,143000,-2000,-2000
052952,矽創國票97購02  ,0,0,0,0,0,0,0,0,0,-2000,0,0,0,113000,115000,-2000,-2000
052983,國巨元大96購07  ,0,0,0,0,0,0,0,0,0,-2000,0,0,0,36000,38000,-2000,-2000
051949,鴻海元富95購08  ,0,0,0,0,0,0,0,0,0,-2000,0,0,0,0,2000,-2000,-2000
05182P,嘉晶統一95售03  ,0,0,0,0,0,0,0,0,0,-2000,0,0,0,0,2000,-2000,-2000
051828,微星元大95購03  ,0,0,0,0,0,0,0,0,0,-2000,0,0,0,5000,7000,-2000,-2000
052281,全新凱基97購01  ,0,0,0,0,0,0,0,0,0,-2000,0,0,0,3000,5000,-2000,-2000
053869,嘉澤元大96購02  ,0,0,0,0,0,0,0,0,0,-2000,0,0,0,115000,117000,-2000,-2000
054089,台積電群益96購11,0,0,0,0,0,0,0,0,0,-2000,0,0,0,32000,34000,-2000,-2000
054178,中磊台新97購01  ,0,0,0,0,0,0,0,0,0,-2000,0,0,0,0,2000,-2000,-2000
054184,A50正2永豐96購01,0,0,0,0,0,0,0,0,0,-2000,0,0,0,0,2000,-2000,-2000
054460,和大凱基97購01  ,0,0,0,0,0,0,0,0,0,-2000,0,0,0,54000,56000,-2000,-2000
054280,牧德群益98購01  ,0,0,0,0,0,0,0,0,0,-2000,0,0,0,20000,22000,-2000,-2000
05424P,台達電亞東96售02,0,0,0,0,0,0,0,0,0,-2000,0,0,0,0,2000,-2000,-2000
054220,國巨統一97購02  ,0,0,0,0,0,0,0,0,0,-2000,0,0,0,0,2000,-2000,-2000
054221,華新科統一96購05,0,0,0,0,0,0,0,0,0,-2000,0,0,0,0,2000,-2000,-2000
053547,台積電凱基96購14,0,0,0,0,0,0,0,0,0,-2000,0,0,0,10000,12000,-2000,-2000
053698,中磊元大96購02  ,0,0,0,0,0,0,0,0,0,-2000,0,0,0,26000,28000,-2000,-2000
053705,滬深2X凱基99購01,0,0,0,0,0,0,0,0,0,-2000,0,0,0,0,2000,-2000,-2000
05317P,臺股指永昌95售02,0,0,0,0,0,0,0,0,0,-2000,0,0,0,0,2000,-2000,-2000
2809,京城銀          ,229000,231000,-2000,0,0,0,0,0,0,0,0,0,0,0,0,0,-2000
2712,遠雄來          ,0,3000,-3000,0,0,0,0,0,0,1000,1000,0,1000,0,0,0,-2000
2910,統領            ,1000,3000,-2000,0,0,0,0,0,0,0,0,0,0,0,0,0,-2000
3701,大眾控          ,0,2000,-2000,0,0,0,0,0,0,0,0,0,0,0,0,0,-2000
3557,嘉威            ,5000,7000,-2000,0,0,0,0,0,0,0,0,0,0,0,0,0,-2000
3308,聯德            ,0,2000,-2000,0,0,0,0,0,0,0,0,0,0,0,0,0,-2000
4562,穎漢            ,1000,3000,-2000,0,0,0,0,0,0,0,0,0,0,0,0,0,-2000
4571,鈞興-KY         ,0,2000,-2000,0,0,0,0,0,0,0,1000,1000,0,0,0,0,-2000
4807,日成-KY         ,2000,4000,-2000,0,0,0,0,0,0,0,0,0,0,0,0,0,-2000
2482,連宇            ,2000,11000,-9000,0,0,0,0,0,0,7000,8000,1000,7000,0,0,0,-2000
2424,隴華            ,1000,3000,-2000,0,0,0,0,0,0,0,0,0,0,0,0,0,-2000
1341,富林-KY         ,0,2000,-2000,0,0,0,0,0,0,0,0,0,0,0,0,0,-2000
1470,大統新創        ,0,2000,-2000,0,0,0,0,0,0,0,0,0,0,0,0,0,-2000
06484P,聯發科凱基98售11,0,0,0,0,0,0,0,0,0,-2000,0,0,0,0,2000,-2000,-2000
06447P,上銀元大98售01  ,0,0,0,0,0,0,0,0,0,-2000,0,0,0,0,2000,-2000,-2000
06408P,聯茂元富97售02  ,0,0,0,0,0,0,0,0,0,-2000,0,0,0,0,2000,-2000,-2000
06348P,鈺齊元富97售02  ,0,0,0,0,0,0,0,0,0,-2000,0,0,0,36000,38000,-2000,-2000
06381P,臺股指統一98售03,0,0,0,0,0,0,0,0,0,-2000,0,0,0,0,2000,-2000,-2000
06372P,聯發科元大97售21,0,0,0,0,0,0,0,0,0,-2000,0,0,0,10000,12000,-2000,-2000
06115P,台積電統一97售04,0,0,0,0,0,0,0,0,0,-2000,0,0,0,3000,5000,-2000,-2000
06118P,上証2X凱基98售03,0,0,0,0,0,0,0,0,0,-2000,0,0,0,60000,62000,-2000,-2000
06098P,T50反1日盛97售02,0,0,0,0,0,0,0,0,0,-2000,0,0,0,0,2000,-2000,-2000
06314P,GIS元富97售02   ,0,0,0,0,0,0,0,0,0,-2000,0,0,0,0,2000,-2000,-2000
6205,詮欣            ,0,2000,-2000,0,0,0,0,0,0,0,0,0,0,0,0,0,-2000
9929,秋雨            ,0,2000,-2000,0,0,0,0,0,0,0,0,0,0,0,0,0,-2000
055963,欣興元大97購04  ,0,0,0,0,0,0,0,0,0,-3000,0,0,0,3000,6000,-3000,-3000
055957,瑞昱元大97購06  ,0,0,0,0,0,0,0,0,0,-3000,0,0,0,96000,99000,-3000,-3000
056057,華邦電元大97購05,0,0,0,0,0,0,0,0,0,-3000,0,0,0,7000,10000,-3000,-3000
05691P,聯發科中信98售01,0,0,0,0,0,0,0,0,0,-3000,0,0,0,0,3000,-3000,-3000
05771P,大立光凱基96售13,0,0,0,0,0,0,0,0,0,-3000,0,0,0,1000,4000,-3000,-3000
056474,華新科元大99購05,0,0,0,0,0,0,0,0,0,-3000,0,0,0,11000,14000,-3000,-3000
05676P,欣興群益96售04  ,0,0,0,0,0,0,0,0,0,-3000,0,0,0,0,3000,-3000,-3000
055409,元黃金富邦01購01,0,0,0,0,0,0,0,0,0,-3000,0,0,0,0,3000,-3000,-3000
055599,TPK元大97購01   ,0,0,0,0,0,0,0,0,0,-3000,0,0,0,11000,14000,-3000,-3000
055568,緯穎凱基97購02  ,0,0,0,0,0,0,0,0,0,-3000,0,0,0,21000,24000,-3000,-3000
055511,大立光兆豐97購02,0,0,0,0,0,0,0,0,0,-3000,0,0,0,12000,15000,-3000,-3000
054978,堤維西元富97購01,0,0,0,0,0,0,0,0,0,-3000,0,0,0,0,3000,-3000,-3000
054755,世紀鋼凱基98購01,0,0,0,0,0,0,0,0,0,-3000,0,0,0,0,3000,-3000,-3000
054758,南亞國票9A購01  ,0,0,0,0,0,0,0,0,0,-3000,0,0,0,33000,36000,-3000,-3000
054663,同欣電元大97購03,0,0,0,0,0,0,0,0,0,-3000,0,0,0,1000,4000,-3000,-3000
054632,緯穎凱基9A購01  ,0,0,0,0,0,0,0,0,0,-3000,0,0,0,332000,335000,-3000,-3000
054600,中壽台新97購01  ,0,0,0,0,0,0,0,0,0,-3000,0,0,0,17000,20000,-3000,-3000
04584P,楠梓電永豐94售01,0,0,0,0,0,0,0,0,0,-3000,0,0,0,10000,13000,-3000,-3000
045837,群創群益98購02  ,0,0,0,0,0,0,0,0,0,-3000,0,0,0,0,3000,-3000,-3000
046353,聯發科群益92購04,0,0,0,0,0,0,0,0,0,-3000,0,0,0,0,3000,-3000,-3000
046024,鴻海元大92購11  ,0,0,0,0,0,0,0,0,0,-3000,0,0,0,0,3000,-3000,-3000
046180,裕隆凱基93購01  ,0,0,0,0,0,0,0,0,0,-3000,0,0,0,0,3000,-3000,-3000
045366,富邦金兆豐92購01,0,0,0,0,0,0,0,0,0,-3000,0,0,0,0,3000,-3000,-3000
050416,高股息凱基96購02,0,0,0,0,0,0,0,0,0,-3000,0,0,0,200000,203000,-3000,-3000
046942,友達元大99購01  ,0,0,0,0,0,0,0,0,0,-3000,0,0,0,0,3000,-3000,-3000
046949,群創元大99購01  ,0,0,0,0,0,0,0,0,0,-3000,0,0,0,91000,94000,-3000,-3000
042501,台灣50凱基96購06,0,0,0,0,0,0,0,0,0,-3000,0,0,0,0,3000,-3000,-3000
04346P,大立光兆豐95售02,0,0,0,0,0,0,0,0,0,-3000,0,0,0,0,3000,-3000,-3000
04340P,易華電元大94售02,0,0,0,0,0,0,0,0,0,-3000,0,0,0,0,3000,-3000,-3000
043889,台表科元大93購01,0,0,0,0,0,0,0,0,0,-3000,0,0,0,0,3000,-3000,-3000
04394P,臻鼎凱基94售01  ,0,0,0,0,0,0,0,0,0,-3000,0,0,0,0,3000,-3000,-3000
04306P,上銀凱基93售10  ,0,0,0,0,0,0,0,0,0,-3000,0,0,0,0,3000,-3000,-3000
03535P,臺股指凱基02售14,0,0,0,0,0,0,0,0,0,-3000,0,0,0,0,3000,-3000,-3000
03993P,滬深2X中信94售03,0,0,0,0,0,0,0,0,0,-3000,0,0,0,0,3000,-3000,-3000
03953P,易華電凱基94售01,0,0,0,0,0,0,0,0,0,-3000,0,0,0,0,3000,-3000,-3000
00702,國泰標普低波高息,0,0,0,0,0,0,0,0,0,-3000,0,0,0,0,3000,-3000,-3000
00770,國泰北美科技    ,49000,0,49000,0,0,0,0,0,0,-52000,0,0,0,0,52000,-52000,-3000
04962P,易華電凱基96售01,0,0,0,0,0,0,0,0,0,-3000,0,0,0,0,3000,-3000,-3000
049631,臺股指群益94購04,0,0,0,0,0,0,0,0,0,-3000,0,0,0,0,3000,-3000,-3000
051112,台郡統一95購01  ,0,0,0,0,0,0,0,0,0,-3000,0,0,0,53000,56000,-3000,-3000
050873,新唐永豐95購01  ,0,0,0,0,0,0,0,0,0,-3000,0,0,0,0,3000,-3000,-3000
050850,訊連國票96購01  ,0,0,0,0,0,0,0,0,0,-3000,0,0,0,10000,13000,-3000,-3000
048803,大立光富邦96購01,0,0,0,0,0,0,0,0,0,-3000,0,0,0,0,3000,-3000,-3000
04877P,聯發科麥證94售04,0,0,0,17000,20000,-3000,0,0,0,-3000,0,0,0,17000,20000,-3000,-3000
050584,瑞儀國票95購01  ,0,0,0,0,0,0,0,0,0,-3000,0,0,0,38000,41000,-3000,-3000
051467,GIS富邦96購01   ,0,0,0,0,0,0,0,0,0,-3000,0,0,0,147000,150000,-3000,-3000
051552,牧德永豐95購03  ,0,0,0,0,0,0,0,0,0,-3000,0,0,0,0,3000,-3000,-3000
049855,台表科群益94購01,0,0,0,0,0,0,0,0,0,-3000,0,0,0,10000,13000,-3000,-3000
049918,宏達電元大94購01,0,0,0,0,0,0,0,0,0,-3000,0,0,0,0,3000,-3000,-3000
048977,晶相光元大94購01,0,0,0,0,0,0,0,0,0,-3000,0,0,0,37000,40000,-3000,-3000
050063,聯發科凱基94購09,0,0,0,0,0,0,0,0,0,-3000,0,0,0,17000,20000,-3000,-3000
050313,大立光兆豐94購05,0,0,0,0,0,0,0,0,0,-3000,0,0,0,12000,15000,-3000,-3000
053289,臺股指元大96購17,0,0,0,0,0,0,0,0,0,-3000,0,0,0,0,3000,-3000,-3000
053294,聯發科中信9C購01,0,0,0,0,0,0,0,0,0,-3000,0,0,0,0,3000,-3000,-3000
053405,台達電兆豐96購01,0,0,0,0,0,0,0,0,0,-3000,0,0,0,20000,23000,-3000,-3000
05340P,臺股指國票95售08,0,0,0,0,0,0,0,0,0,-3000,0,0,0,40000,43000,-3000,-3000
052242,台達電台新96購01,0,0,0,0,0,0,0,0,0,-3000,0,0,0,84000,87000,-3000,-3000
052347,GIS凱基95購05   ,0,0,0,0,0,0,0,0,0,-3000,0,0,0,0,3000,-3000,-3000
051765,健鼎元大95購03  ,0,0,0,0,0,0,0,0,0,-3000,0,0,0,1000,4000,-3000,-3000
051741,可成國票97購01  ,0,0,0,0,0,0,0,0,0,-3000,0,0,0,0,3000,-3000,-3000
052047,建準凱基96購01  ,0,0,0,0,0,0,0,0,0,-3000,0,0,0,0,3000,-3000,-3000
053024,國巨富邦97購02  ,0,0,0,0,0,0,0,0,0,-3000,0,0,0,79000,82000,-3000,-3000
053109,聯發科兆豐96購01,0,0,0,0,0,0,0,0,0,-3000,0,0,0,0,3000,-3000,-3000
053072,國巨台新97購01  ,0,0,0,0,0,0,0,0,0,-3000,0,0,0,0,3000,-3000,-3000
052863,友達凱基98購02  ,0,0,0,0,0,0,0,0,0,-3000,0,0,0,11000,14000,-3000,-3000
9926,新海            ,2000,5000,-3000,0,0,0,0,0,0,0,0,0,0,0,0,0,-3000
8443,阿瘦            ,5000,8000,-3000,0,0,0,0,0,0,0,0,0,0,0,0,0,-3000
5538,東明-KY         ,0,3000,-3000,0,0,0,0,0,0,0,0,0,0,0,0,0,-3000
6464,台數科          ,1000,4000,-3000,0,0,0,0,0,0,0,0,0,0,0,0,0,-3000
06434P,超眾群益98售02  ,0,0,0,0,0,0,0,0,0,-3000,0,0,0,2000,5000,-3000,-3000
2543,皇昌            ,0,3000,-3000,0,0,0,0,0,0,0,0,0,0,0,0,0,-3000
2008,高興昌          ,0,3000,-3000,0,0,0,0,0,0,0,0,0,0,0,0,0,-3000
1732,毛寶            ,0,3000,-3000,0,0,0,0,0,0,0,0,0,0,0,0,0,-3000
2832,台產            ,54000,57000,-3000,0,0,0,0,0,0,0,0,0,0,0,0,0,-3000
055613,全新國票98購01  ,0,0,0,0,0,0,0,0,0,-4000,0,0,0,56000,60000,-4000,-4000
055698,茂林國票98購03  ,0,0,0,0,0,0,0,0,0,-4000,0,0,0,1000,5000,-4000,-4000
055363,緯穎凱基98購03  ,0,0,0,0,0,0,0,0,0,-4000,0,0,0,1000,5000,-4000,-4000
055371,正崴元大97購02  ,0,0,0,0,0,0,0,0,0,-4000,0,0,0,10000,14000,-4000,-4000
055225,華邦電國票99購01,0,0,0,0,0,0,0,0,0,-4000,0,0,0,0,4000,-4000,-4000
055294,智易元大98購01  ,0,0,0,0,0,0,0,0,0,-4000,0,0,0,3000,7000,-4000,-4000
056633,鴻海永昌98購02  ,0,0,0,0,0,0,0,0,0,-4000,0,0,0,580000,584000,-4000,-4000
056631,臺股指永豐98購03,0,0,0,0,0,0,0,0,0,-4000,0,0,0,0,4000,-4000,-4000
056656,華邦電元大98購02,0,0,0,0,0,0,0,0,0,-4000,0,0,0,0,4000,-4000,-4000
05839P,臺股指富邦96售06,0,0,0,0,0,0,0,0,0,-4000,0,0,0,48000,52000,-4000,-4000
05815P,台積電凱基97售06,0,0,0,0,0,0,0,0,0,-4000,0,0,0,225000,229000,-4000,-4000
05726P,易華電永豐96售02,0,0,0,0,0,0,0,0,0,-4000,0,0,0,11000,15000,-4000,-4000
055941,百和群益98購02  ,0,0,0,0,0,0,0,0,0,-4000,0,0,0,11000,15000,-4000,-4000
05618P,聯發科元富96售02,0,0,0,0,0,0,0,0,0,-4000,0,0,0,70000,74000,-4000,-4000
035275,台積電台新97購01,0,0,0,0,0,0,0,0,0,-4000,0,0,0,0,4000,-4000,-4000
03563P,台灣50群益02售14,0,0,0,0,0,0,0,0,0,-4000,0,0,0,0,4000,-4000,-4000
03417P,瑞昱群益04售01  ,0,0,0,0,0,0,0,0,0,-4000,0,0,0,0,4000,-4000,-4000
045332,康友群益92購01  ,0,0,0,0,0,0,0,0,0,-4000,0,0,0,0,4000,-4000,-4000
047510,奇力新國票94購01,0,0,0,0,0,0,0,0,0,-4000,0,0,0,0,4000,-4000,-4000
047518,儒鴻元大93購07  ,0,0,0,0,0,0,0,0,0,-4000,0,0,0,1000,5000,-4000,-4000
043513,台灣50元大96購05,0,0,0,0,0,0,0,0,0,-4000,0,0,0,0,4000,-4000,-4000
046927,上銀富邦95購01  ,0,0,0,0,0,0,0,0,0,-4000,0,0,0,0,4000,-4000,-4000
04692P,大立光群益94售06,0,0,0,0,0,0,0,0,0,-4000,0,0,0,26000,30000,-4000,-4000
046836,聯茂群益93購01  ,0,0,0,0,0,0,0,0,0,-4000,0,0,0,6000,10000,-4000,-4000
047746,宏碁元富93購01  ,0,0,0,0,0,0,0,0,0,-4000,0,0,0,21000,25000,-4000,-4000
046195,聯詠凱基92購08  ,0,0,0,0,0,0,0,0,0,-4000,0,0,0,46000,50000,-4000,-4000
045669,華通元大93購02  ,0,0,0,0,0,0,0,0,0,-4000,0,0,0,0,4000,-4000,-4000
047928,禾伸堂凱基93購04,0,0,0,0,0,0,0,0,0,-4000,0,0,0,3000,7000,-4000,-4000
050117,麗豐元大96購02  ,0,0,0,0,0,0,0,0,0,-4000,0,0,0,4000,8000,-4000,-4000
050260,鴻海元大94購15  ,0,0,0,0,0,0,0,0,0,-4000,0,0,0,1000,5000,-4000,-4000
049109,嘉澤富邦95購01  ,0,0,0,0,0,0,0,0,0,-4000,0,0,0,13000,17000,-4000,-4000
051287,台積電統一95購05,0,0,0,0,0,0,0,0,0,-4000,0,0,0,2000,6000,-4000,-4000
051388,大立光麥證95購03,0,0,0,10000,14000,-4000,0,0,0,-4000,0,0,0,10000,14000,-4000,-4000
048762,寶齡凱基94購01  ,0,0,0,0,0,0,0,0,0,-4000,0,0,0,0,4000,-4000,-4000
049203,智邦群益94購01  ,0,0,0,0,0,0,0,0,0,-4000,0,0,0,15000,19000,-4000,-4000
048131,全新國票94購02  ,0,0,0,0,0,0,0,0,0,-4000,0,0,0,0,4000,-4000,-4000
04812P,國巨元大95售03  ,0,0,0,0,0,0,0,0,0,-4000,0,0,0,0,4000,-4000,-4000
048080,元石油凱基96購01,0,0,0,0,0,0,0,0,0,-4000,0,0,0,0,4000,-4000,-4000
048379,台郡元富96購01  ,0,0,0,0,0,0,0,0,0,-4000,0,0,0,0,4000,-4000,-4000
050493,聯發科永昌96購01,0,0,0,0,0,0,0,0,0,-4000,0,0,0,322000,326000,-4000,-4000
052724,力成統一97購01  ,0,0,0,0,0,0,0,0,0,-4000,0,0,0,6000,10000,-4000,-4000
052625,南電亞東97購01  ,0,0,0,0,0,0,0,0,0,-4000,0,0,0,55000,59000,-4000,-4000
053073,技嘉康和96購01  ,0,0,0,0,0,0,0,0,0,-4000,0,0,0,258000,262000,-4000,-4000
052962,台積電凱基97購03,0,0,0,0,0,0,0,0,0,-4000,0,0,0,0,4000,-4000,-4000
052032,臺股指群益95購05,0,0,0,0,0,0,0,0,0,-4000,0,0,0,2000,6000,-4000,-4000
051737,瑞昱國票96購01  ,0,0,0,0,0,0,0,0,0,-4000,0,0,0,19000,23000,-4000,-4000
053296,貿聯中信98購01  ,0,0,0,0,0,0,0,0,0,-4000,0,0,0,0,4000,-4000,-4000
053245,全新國票97購01  ,0,0,0,0,0,0,0,0,0,-4000,0,0,0,19000,23000,-4000,-4000
053737,華新科麥證96購01,0,0,0,36000,40000,-4000,0,0,0,-4000,0,0,0,36000,40000,-4000,-4000
053725,晶相光凱基96購01,0,0,0,0,0,0,0,0,0,-4000,0,0,0,5000,9000,-4000,-4000
053573,臺股指統一99購01,0,0,0,0,0,0,0,0,0,-4000,0,0,0,0,4000,-4000,-4000
053580,國巨元大96購10  ,0,0,0,0,0,0,0,0,0,-4000,0,0,0,39000,43000,-4000,-4000
054218,S&P反1統一98購02,0,0,0,0,0,0,0,0,0,-4000,0,0,0,0,4000,-4000,-4000
054252,奇力新元大96購04,0,0,0,0,0,0,0,0,0,-4000,0,0,0,0,4000,-4000,-4000
054390,智邦元富96購03  ,0,0,0,0,0,0,0,0,0,-4000,0,0,0,45000,49000,-4000,-4000
4536,拓凱            ,20000,49000,-29000,0,0,0,23000,0,23000,2000,2000,0,2000,0,0,0,-4000
4439,冠星-KY         ,0,4000,-4000,0,0,0,0,0,0,0,0,0,0,0,0,0,-4000
3705,永信            ,63000,67000,-4000,0,0,0,0,0,0,0,0,0,0,0,0,0,-4000
1724,台硝            ,8000,12000,-4000,0,0,0,0,0,0,0,0,0,0,0,0,0,-4000
2033,佳大            ,0,4000,-4000,0,0,0,0,0,0,0,0,0,0,0,0,0,-4000
06411P,晶相光永豐97售03,0,0,0,0,0,0,0,0,0,-4000,0,0,0,0,4000,-4000,-4000
06462P,鴻海富邦98售01  ,0,0,0,0,0,0,0,0,0,-4000,0,0,0,0,4000,-4000,-4000
06483P,聯發科凱基98售10,0,0,0,0,0,0,0,0,0,-4000,0,0,0,0,4000,-4000,-4000
08966P,臺指反元大04售07,0,0,0,0,0,0,0,0,0,-4000,0,0,0,0,4000,-4000,-4000
06345P,臺股指統一9A售01,0,0,0,0,0,0,0,0,0,-4000,0,0,0,6000,10000,-4000,-4000
06161P,聯發科群益97售03,0,0,0,0,0,0,0,0,0,-4000,0,0,0,10000,14000,-4000,-4000
06083P,華通統一98售02  ,0,0,0,0,0,0,0,0,0,-4000,0,0,0,0,4000,-4000,-4000
05991P,聯茂群益96售05  ,0,0,0,0,0,0,0,0,0,-4000,0,0,0,0,4000,-4000,-4000
06032P,健策群益97售03  ,0,0,0,0,0,0,0,0,0,-4000,0,0,0,47000,51000,-4000,-4000
8070,長華*           ,5000,19000,-14000,0,0,0,0,0,0,10000,10000,0,10000,0,0,0,-4000
8480,泰昇-KY         ,9000,13000,-4000,0,0,0,0,0,0,0,0,0,0,0,0,0,-4000
8481,政伸            ,1000,5000,-4000,0,0,0,0,0,0,0,0,0,0,0,0,0,-4000
8482,商億-KY         ,84000,88000,-4000,0,0,0,0,0,0,0,0,0,0,0,0,0,-4000
9912,偉聯            ,1000,5000,-4000,0,0,0,0,0,0,0,0,0,0,0,0,0,-4000
056303,亞光元大97購04  ,0,0,0,0,0,0,0,0,0,-5000,0,0,0,52000,57000,-5000,-5000
056307,貿聯元大97購05  ,0,0,0,0,0,0,0,0,0,-5000,0,0,0,0,5000,-5000,-5000
056346,聯茂凱基99購02  ,0,0,0,0,0,0,0,0,0,-5000,0,0,0,54000,59000,-5000,-5000
055893,大立光統一97購07,0,0,0,0,0,0,0,0,0,-5000,0,0,0,0,5000,-5000,-5000
05730P,臺股指凱基97售03,0,0,0,0,0,0,0,0,0,-5000,0,0,0,0,5000,-5000,-5000
05959P,聯發科國票98售01,0,0,0,0,0,0,0,0,0,-5000,0,0,0,0,5000,-5000,-5000
056775,康控元大99購01  ,0,0,0,0,0,0,0,0,0,-5000,0,0,0,63000,68000,-5000,-5000
056468,鴻海元大98購07  ,0,0,0,0,0,0,0,0,0,-5000,0,0,0,4000,9000,-5000,-5000
05649P,矽創國票97售03  ,0,0,0,0,0,0,0,0,0,-5000,0,0,0,0,5000,-5000,-5000
055188,亞翔統一97購01  ,0,0,0,0,0,0,0,0,0,-5000,0,0,0,48000,53000,-5000,-5000
055615,宏達電國票99購02,0,0,0,0,0,0,0,0,0,-5000,0,0,0,0,5000,-5000,-5000
055476,台郡凱基97購02  ,0,0,0,0,0,0,0,0,0,-5000,0,0,0,0,5000,-5000,-5000
054620,南茂永豐97購01  ,0,0,0,0,0,0,0,0,0,-5000,0,0,0,10000,15000,-5000,-5000
054631,台郡凱基98購02  ,0,0,0,0,0,0,0,0,0,-5000,0,0,0,0,5000,-5000,-5000
054991,南亞科元富97購01,0,0,0,0,0,0,0,0,0,-5000,0,0,0,15000,20000,-5000,-5000
054924,景碩凱基98購01  ,0,0,0,0,0,0,0,0,0,-5000,0,0,0,0,5000,-5000,-5000
045996,南電富邦94購01  ,0,0,0,0,0,0,0,0,0,-5000,0,0,0,19000,24000,-5000,-5000
047828,華新元大93購03  ,0,0,0,0,0,0,0,0,0,-5000,0,0,0,0,5000,-5000,-5000
045591,彩晶元大93購01  ,0,0,0,0,0,0,0,0,0,-5000,0,0,0,0,5000,-5000,-5000
047704,智邦凱基93購06  ,0,0,0,0,0,0,0,0,0,-5000,0,0,0,0,5000,-5000,-5000
047628,新光金國票95購02,0,0,0,0,0,0,0,0,0,-5000,0,0,0,0,5000,-5000,-5000
046946,益航元大94購01  ,0,0,0,0,0,0,0,0,0,-5000,0,0,0,0,5000,-5000,-5000
047154,新光金國票95購01,0,0,0,0,0,0,0,0,0,-5000,0,0,0,55000,60000,-5000,-5000
04710P,台積電元大94售16,0,0,0,0,0,0,0,0,0,-5000,0,0,0,0,5000,-5000,-5000
050368,國巨元大94購14  ,0,0,0,0,0,0,0,0,0,-5000,0,0,0,14000,19000,-5000,-5000
049522,華通兆豐94購02  ,0,0,0,0,0,0,0,0,0,-5000,0,0,0,1000,6000,-5000,-5000
049527,國巨中信95購01  ,0,0,0,0,0,0,0,0,0,-5000,0,0,0,15000,20000,-5000,-5000
043775,友達兆豐92購01  ,0,0,0,0,0,0,0,0,0,-5000,0,0,0,0,5000,-5000,-5000
043757,欣興元大93購01  ,0,0,0,0,0,0,0,0,0,-5000,0,0,0,3000,8000,-5000,-5000
04232P,可成亞東93售02  ,0,0,0,0,0,0,0,0,0,-5000,0,0,0,0,5000,-5000,-5000
04417P,光罩國泰95售02  ,0,0,0,0,0,0,0,0,0,-5000,0,0,0,6000,11000,-5000,-5000
03428B,臺股指凱基97熊18,0,0,0,0,0,0,0,0,0,-5000,0,0,0,0,5000,-5000,-5000
03647C,T50反1元富99牛02,0,0,0,0,0,0,0,0,0,-5000,0,0,0,0,5000,-5000,-5000
044717,旺宏統一94購01  ,0,0,0,0,0,0,0,0,0,-5000,0,0,0,15000,20000,-5000,-5000
006203,元大MSCI台灣    ,0,2000,-2000,0,0,0,0,0,0,-3000,0,0,0,0,3000,-3000,-5000
050822,亞光凱基95購01  ,0,0,0,0,0,0,0,0,0,-5000,0,0,0,6000,11000,-5000,-5000
050876,復盛永豐95購01  ,0,0,0,0,0,0,0,0,0,-5000,0,0,0,16000,21000,-5000,-5000
050926,禾伸堂凱基95購01,0,0,0,0,0,0,0,0,0,-5000,0,0,0,0,5000,-5000,-5000
051176,聯發科凱基95購07,0,0,0,0,0,0,0,0,0,-5000,0,0,0,0,5000,-5000,-5000
049618,美律群益94購03  ,0,0,0,0,0,0,0,0,0,-5000,0,0,0,62000,67000,-5000,-5000
049593,群創元大9A購01  ,0,0,0,0,0,0,0,0,0,-5000,0,0,0,86000,91000,-5000,-5000
051354,聯發科元大95購09,0,0,0,0,0,0,0,0,0,-5000,0,0,0,0,5000,-5000,-5000
049086,晶相光凱基94購01,0,0,0,0,0,0,0,0,0,-5000,0,0,0,119000,124000,-5000,-5000
049000,元油2X中信95購02,0,0,0,0,0,0,0,0,0,-5000,0,0,0,0,5000,-5000,-5000
048983,牧德元大95購01  ,0,0,0,0,0,0,0,0,0,-5000,0,0,0,0,5000,-5000,-5000
050604,上証2X永昌94購01,0,0,0,0,0,0,0,0,0,-5000,0,0,0,0,5000,-5000,-5000
051427,聯發科統一95購04,0,0,0,0,0,0,0,0,0,-5000,0,0,0,55000,60000,-5000,-5000
051718,上証2X永豐95購01,0,0,0,0,0,0,0,0,0,-5000,0,0,0,75000,80000,-5000,-5000
050280,國巨日盛94購01  ,0,0,0,0,0,0,0,0,0,-5000,0,0,0,5000,10000,-5000,-5000
050127,台積電凱基94購31,0,0,0,0,0,0,0,0,0,-5000,0,0,0,0,5000,-5000,-5000
049889,欣興國泰96購01  ,0,0,0,0,0,0,0,0,0,-5000,0,0,0,0,5000,-5000,-5000
049976,台積電凱基94購28,0,0,0,0,0,0,0,0,0,-5000,0,0,0,0,5000,-5000,-5000
05001P,華通統一95售01  ,0,0,0,0,0,0,0,0,0,-5000,0,0,0,0,5000,-5000,-5000
054406,旺宏國票98購01  ,0,0,0,0,0,0,0,0,0,-5000,0,0,0,0,5000,-5000,-5000
054401,康普永豐96購01  ,0,0,0,0,0,0,0,0,0,-5000,0,0,0,0,5000,-5000,-5000
05443P,宏達電元大95售05,0,0,0,0,0,0,0,0,0,-5000,0,0,0,0,5000,-5000,-5000
054284,和大元大96購03  ,0,0,0,0,0,0,0,0,0,-5000,0,0,0,50000,55000,-5000,-5000
054352,世芯國泰98購01  ,0,0,0,0,0,0,0,0,0,-5000,0,0,0,76000,81000,-5000,-5000
054200,美律富邦97購02  ,0,0,0,0,0,0,0,0,0,-5000,0,0,0,0,5000,-5000,-5000
054132,聯發科元大97購10,0,0,0,0,0,0,0,0,0,-5000,0,0,0,0,5000,-5000,-5000
054035,聯詠麥證96購01  ,0,0,0,40000,45000,-5000,0,0,0,-5000,0,0,0,40000,45000,-5000,-5000
053968,華邦電元大97購01,0,0,0,0,0,0,0,0,0,-5000,0,0,0,0,5000,-5000,-5000
053566,大立光富邦99購03,0,0,0,0,0,0,0,0,0,-5000,0,0,0,0,5000,-5000,-5000
05367P,鴻海元富95售13  ,0,0,0,0,0,0,0,0,0,-5000,0,0,0,0,5000,-5000,-5000
053744,台郡國票97購03  ,0,50000,-50000,0,0,0,0,0,0,45000,0,0,0,95000,50000,45000,-5000
053720,宏達電凱基97購01,0,0,0,0,0,0,0,0,0,-5000,0,0,0,0,5000,-5000,-5000
053722,新光金凱基9C購01,0,0,0,0,0,0,0,0,0,-5000,0,0,0,0,5000,-5000,-5000
053714,南亞科凱基96購03,0,0,0,0,0,0,0,0,0,-5000,0,0,0,0,5000,-5000,-5000
053765,智邦富邦96購01  ,0,0,0,0,0,0,0,0,0,-5000,0,0,0,0,5000,-5000,-5000
053857,宏達電富邦97購02,0,0,0,0,0,0,0,0,0,-5000,0,0,0,0,5000,-5000,-5000
053215,禾伸堂凱基96購01,0,0,0,0,0,0,0,0,0,-5000,0,0,0,1000,6000,-5000,-5000
051849,旺宏中信98購01  ,0,0,0,0,0,0,0,0,0,-5000,0,0,0,15000,20000,-5000,-5000
051869,康控凱基96購01  ,0,0,0,0,0,0,0,0,0,-5000,0,0,0,0,5000,-5000,-5000
051898,富邦金國泰97購01,0,0,0,0,0,0,0,0,0,-5000,0,0,0,5000,10000,-5000,-5000
052086,鴻海元大96購08  ,0,0,0,0,0,0,0,0,0,-5000,0,0,0,0,5000,-5000,-5000
051931,美律國票96購02  ,0,0,0,0,0,0,0,0,0,-5000,0,0,0,50000,55000,-5000,-5000
051970,元黃金凱基98購01,0,0,0,0,0,0,0,0,0,-5000,0,0,0,21000,26000,-5000,-5000
052963,智邦凱基96購02  ,0,0,0,0,0,0,0,0,0,-5000,0,0,0,7000,12000,-5000,-5000
052950,超眾國票98購01  ,0,0,0,0,0,0,0,0,0,-5000,0,0,0,110000,115000,-5000,-5000
052922,國巨永豐96購01  ,0,0,0,0,0,0,0,0,0,-5000,0,0,0,0,5000,-5000,-5000
052662,華新科國票97購01,0,0,0,0,0,0,0,0,0,-5000,0,0,0,6000,11000,-5000,-5000
052577,台積電統一96購01,0,0,0,0,0,0,0,0,0,-5000,0,0,0,0,5000,-5000,-5000
052713,智邦凱基96購01  ,0,0,0,0,0,0,0,0,0,-5000,0,0,0,0,5000,-5000,-5000
9918,欣天然          ,0,5000,-5000,0,0,0,0,0,0,0,0,0,0,0,0,0,-5000
8427,基勝-KY         ,1000,6000,-5000,0,0,0,0,0,0,0,0,0,0,0,0,0,-5000
6165,捷泰            ,39000,60000,-21000,0,0,0,0,0,0,16000,16000,0,16000,0,0,0,-5000
06156P,大立光統一97售05,0,0,0,0,0,0,0,0,0,-5000,0,0,0,0,5000,-5000,-5000
06247P,同欣電元富97售02,0,0,0,0,0,0,0,0,0,-5000,0,0,0,26000,31000,-5000,-5000
06196P,元上證元大97售01,0,0,0,0,0,0,0,0,0,-5000,0,0,0,10000,15000,-5000,-5000
1472,三洋紡          ,5000,10000,-5000,0,0,0,0,0,0,0,0,0,0,0,0,0,-5000
1456,怡華            ,0,5000,-5000,0,0,0,0,0,0,0,0,0,0,0,0,0,-5000
1583,程泰            ,0,5000,-5000,0,0,0,0,0,0,0,0,0,0,0,0,0,-5000
06491P,台積電富邦99售02,0,0,0,0,0,0,0,0,0,-5000,0,0,0,0,5000,-5000,-5000
06467P,旺宏統一98售01  ,0,0,0,0,0,0,0,0,0,-5000,0,0,0,0,5000,-5000,-5000
2236,百達-KY         ,0,6000,-6000,0,0,0,0,0,0,1000,1000,0,1000,0,0,0,-5000
2420,新巨            ,61000,66000,-5000,0,0,0,0,0,0,0,0,0,0,0,0,0,-5000
3432,台端            ,1000,6000,-5000,0,0,0,0,0,0,0,0,0,0,0,0,0,-5000
4764,雙鍵            ,8000,13000,-5000,0,0,0,0,0,0,0,0,0,0,0,0,0,-5000
054988,凱美元富97購02  ,0,0,0,0,0,0,0,0,0,-6000,0,0,0,0,6000,-6000,-6000
05469P,台積電元大95售24,0,0,0,0,0,0,0,0,0,-6000,0,0,0,323000,329000,-6000,-6000
055515,聚陽中信9A購01  ,0,0,0,0,0,0,0,0,0,-6000,0,0,0,10000,16000,-6000,-6000
055560,大立光凱基97購10,0,0,0,0,0,0,0,0,0,-6000,0,0,0,0,6000,-6000,-6000
05575P,玉晶光元富96售01,0,0,0,0,0,0,0,0,0,-6000,0,0,0,9000,15000,-6000,-6000
055765,臺股指群益97購03,0,0,0,0,0,0,0,0,0,-6000,0,0,0,0,6000,-6000,-6000
056504,國巨永豐98購02  ,0,0,0,0,0,0,0,0,0,-6000,0,0,0,0,6000,-6000,-6000
056783,國巨群益99購01  ,0,0,0,0,0,0,0,0,0,-6000,0,0,0,0,6000,-6000,-6000
056680,華通統一98購04  ,0,0,0,0,0,0,0,0,0,-6000,0,0,0,17000,23000,-6000,-6000
05972P,瑞昱元大96售01  ,0,0,0,0,0,0,0,0,0,-6000,0,0,0,0,6000,-6000,-6000
055917,禾伸堂凱基98購02,0,0,0,0,0,0,0,0,0,-6000,0,0,0,0,6000,-6000,-6000
055919,景碩凱基98購02  ,0,0,0,0,0,0,0,0,0,-6000,0,0,0,0,6000,-6000,-6000
055873,聚陽元富97購01  ,0,0,0,0,0,0,0,0,0,-6000,0,0,0,0,6000,-6000,-6000
055931,冠德群益97購02  ,0,0,0,0,0,0,0,0,0,-6000,0,0,0,362000,368000,-6000,-6000
055823,臺股指國票97購10,0,0,0,0,0,0,0,0,0,-6000,0,0,0,4000,10000,-6000,-6000
056213,建準國票98購02  ,0,0,0,0,0,0,0,0,0,-6000,0,0,0,8000,14000,-6000,-6000
04067P,聯發科凱基93售24,0,0,0,0,0,0,0,0,0,-6000,0,0,0,0,6000,-6000,-6000
03111P,元油2X富邦97售01,0,0,0,0,0,0,0,0,0,-6000,0,0,0,0,6000,-6000,-6000
044645,元金2X群益93購01,0,0,0,0,0,0,0,0,0,-6000,0,0,0,0,6000,-6000,-6000
044817,可成兆豐93購01  ,0,0,0,0,0,0,0,0,0,-6000,0,0,0,114000,120000,-6000,-6000
03644C,臺股指元大94牛28,0,0,0,0,0,0,0,0,0,-6000,0,0,0,2000,8000,-6000,-6000
03597P,玉晶光凱基03售12,0,0,0,0,0,0,0,0,0,-6000,0,0,0,0,6000,-6000,-6000
04262P,景碩群益93售03  ,0,0,0,0,0,0,0,0,0,-6000,0,0,0,0,6000,-6000,-6000
04338P,亞光元大93售04  ,0,0,0,0,0,0,0,0,0,-6000,0,0,0,5000,11000,-6000,-6000
04188P,康控元富93售03  ,0,0,0,0,0,0,0,0,0,-6000,0,0,0,0,6000,-6000,-6000
05070P,鴻海統一96售04  ,0,0,0,0,0,0,0,0,0,-6000,0,0,0,30000,36000,-6000,-6000
047167,農林康和93購01  ,0,0,0,0,0,0,0,0,0,-6000,0,0,0,0,6000,-6000,-6000
04663P,臺股指國票94售02,0,0,0,0,0,0,0,0,0,-6000,0,0,0,0,6000,-6000,-6000
047703,台積電凱基93購19,0,0,0,0,0,0,0,0,0,-6000,0,0,0,0,6000,-6000,-6000
045825,力成凱基93購02  ,0,0,0,0,0,0,0,0,0,-6000,0,0,0,0,6000,-6000,-6000
050044,聯詠兆豐94購02  ,0,0,0,0,0,0,0,0,0,-6000,0,0,0,66000,72000,-6000,-6000
049937,臺股指元大94購18,0,0,0,0,0,0,0,0,0,-6000,0,0,0,0,6000,-6000,-6000
048911,玉晶光富邦96購01,0,0,0,0,0,0,0,0,0,-6000,0,0,0,1000,7000,-6000,-6000
049893,日月光富邦98購01,0,0,0,0,0,0,0,0,0,-6000,0,0,0,50000,56000,-6000,-6000
051335,華固永豐95購01  ,0,0,0,0,0,0,0,0,0,-6000,0,0,0,0,6000,-6000,-6000
051116,可成麥證95購01  ,0,0,0,8000,14000,-6000,0,0,0,-6000,0,0,0,8000,14000,-6000,-6000
050535,台表科群益94購02,0,0,0,0,0,0,0,0,0,-6000,0,0,0,0,6000,-6000,-6000
050948,華固群益95購01  ,0,0,0,0,0,0,0,0,0,-6000,0,0,0,14000,20000,-6000,-6000
051224,華通群益96購03  ,0,0,0,0,0,0,0,0,0,-6000,0,0,0,0,6000,-6000,-6000
049200,元黃金群益98購01,0,0,0,0,0,0,0,0,0,-6000,0,0,0,0,6000,-6000,-6000
048453,嘉澤凱基93購05  ,0,0,0,0,0,0,0,0,0,-6000,0,0,0,175000,181000,-6000,-6000
048838,牧德凱基94購07  ,0,0,0,0,0,0,0,0,0,-6000,0,0,0,2000,8000,-6000,-6000
049754,豐祥永豐94購01  ,0,0,0,0,0,0,0,0,0,-6000,0,0,0,3000,9000,-6000,-6000
052722,群創統一97購02  ,0,0,0,0,0,0,0,0,0,-6000,0,0,0,30000,36000,-6000,-6000
052040,臺股指永昌95購01,0,0,0,0,0,0,0,0,0,-6000,0,0,0,0,6000,-6000,-6000
051928,大立光中信96購03,0,0,0,0,0,0,0,0,0,-6000,0,0,0,10000,16000,-6000,-6000
052362,瑞昱國票96購02  ,0,0,0,0,0,0,0,0,0,-6000,0,0,0,19000,25000,-6000,-6000
052396,台積電凱基97購01,0,0,0,0,0,0,0,0,0,-6000,0,0,0,0,6000,-6000,-6000
052138,易華電凱基97購01,0,0,0,0,0,0,0,0,0,-6000,0,0,0,100000,106000,-6000,-6000
053780,南亞科元大96購03,0,0,0,0,0,0,0,0,0,-6000,0,0,0,10000,16000,-6000,-6000
05370P,矽創元富95售01  ,0,0,0,0,0,0,0,0,0,-6000,0,0,0,0,6000,-6000,-6000
053610,矽力中信98購01  ,0,0,0,0,0,0,0,0,0,-6000,0,0,0,40000,46000,-6000,-6000
054258,牧德元大97購01  ,0,0,0,0,0,0,0,0,0,-6000,0,0,0,8000,14000,-6000,-6000
4566,時碩工業        ,18000,24000,-6000,0,0,0,0,0,0,0,0,0,0,0,0,0,-6000
3528,安馳            ,1000,7000,-6000,0,0,0,0,0,0,0,0,0,0,0,0,0,-6000
3046,建碁            ,0,9000,-9000,0,0,0,0,0,0,3000,4000,1000,3000,0,0,0,-6000
2608,嘉里大榮        ,77000,83000,-6000,0,0,0,0,0,0,0,0,0,0,0,0,0,-6000
2243,宏旭-KY         ,1000,7000,-6000,0,0,0,0,0,0,0,0,0,0,0,0,0,-6000
2114,鑫永銓          ,2000,8000,-6000,0,0,0,0,0,0,0,0,0,0,0,0,0,-6000
1805,寶徠            ,0,6000,-6000,0,0,0,0,0,0,0,0,0,0,0,0,0,-6000
1735,日勝化          ,4000,10000,-6000,0,0,0,0,0,0,0,0,0,0,0,0,0,-6000
1786,科妍            ,19000,25000,-6000,0,0,0,0,0,0,0,0,0,0,0,0,0,-6000
1517,利奇            ,7000,13000,-6000,0,0,0,0,0,0,0,0,0,0,0,0,0,-6000
1325,恆大            ,0,6000,-6000,0,0,0,0,0,0,0,0,0,0,0,0,0,-6000
06174P,國巨元大97售07  ,0,0,0,0,0,0,0,0,0,-6000,0,0,0,101000,107000,-6000,-6000
06166P,大立光國票98售01,0,0,0,0,0,0,0,0,0,-6000,0,0,0,0,6000,-6000,-6000
06167P,欣興國票97售05  ,0,0,0,0,0,0,0,0,0,-6000,0,0,0,0,6000,-6000,-6000
8114,振樺電          ,16000,21000,-5000,0,0,0,0,0,0,-1000,0,1000,-1000,0,0,0,-6000
6625,必應            ,0,6000,-6000,0,0,0,0,0,0,0,0,0,0,0,0,0,-6000
910322,康師傅-DR       ,0,6000,-6000,0,0,0,0,0,0,0,0,0,0,0,0,0,-6000
056246,祥碩群益97購01  ,0,0,0,0,0,0,0,0,0,-7000,0,0,0,3000,10000,-7000,-7000
055864,臺股指元大97購01,0,0,0,0,0,0,0,0,0,-7000,0,0,0,0,7000,-7000,-7000
056078,勤誠元大97購01  ,0,0,0,0,0,0,0,0,0,-7000,0,0,0,274000,281000,-7000,-7000
055976,台積電統一99購03,0,0,0,0,0,0,0,0,0,-7000,0,0,0,40000,47000,-7000,-7000
056672,元油2X元富98購10,0,0,0,0,0,0,0,0,0,-7000,0,0,0,0,7000,-7000,-7000
056482,貿聯元大99購01  ,0,0,0,0,0,0,0,0,0,-7000,0,0,0,20000,27000,-7000,-7000
055669,緯穎群益97購02  ,0,0,0,0,0,0,0,0,0,-7000,0,0,0,87000,94000,-7000,-7000
055616,智原國票97購03  ,0,0,0,0,0,0,0,0,0,-7000,0,0,0,0,7000,-7000,-7000
05559P,臺股指麥證96售01,0,0,0,10000,17000,-7000,0,0,0,-7000,0,0,0,10000,17000,-7000,-7000
055550,華邦電凱基97購03,0,0,0,0,0,0,0,0,0,-7000,0,0,0,75000,82000,-7000,-7000
055467,國巨凱基97購05  ,0,0,0,0,0,0,0,0,0,-7000,0,0,0,18000,25000,-7000,-7000
054540,泰鼎國票99購01  ,0,40000,-40000,0,0,0,0,0,0,33000,0,0,0,54000,21000,33000,-7000
054981,國巨元富97購02  ,0,0,0,0,0,0,0,0,0,-7000,0,0,0,8000,15000,-7000,-7000
046070,景碩凱基92購03  ,0,0,0,0,0,0,0,0,0,-7000,0,0,0,2000,9000,-7000,-7000
047393,景碩元大93購02  ,0,0,0,0,0,0,0,0,0,-7000,0,0,0,2000,9000,-7000,-7000
049488,智邦元大95購01  ,0,0,0,0,0,0,0,0,0,-7000,0,0,0,68000,75000,-7000,-7000
04350P,欣興國票94售01  ,0,0,0,0,0,0,0,0,0,-7000,0,0,0,4000,11000,-7000,-7000
04283P,麗豐永豐93售03  ,0,0,0,0,0,0,0,0,0,-7000,0,0,0,5000,12000,-7000,-7000
0051,元大中型100     ,1000,1000,0,0,0,0,0,0,0,-7000,0,0,0,0,7000,-7000,-7000
00647L,元大S&P500正2   ,2000,0,2000,0,0,0,0,0,0,-9000,0,0,0,1000,10000,-9000,-7000
00663L,國泰臺灣加權正2 ,0,0,0,0,0,0,0,0,0,-7000,0,0,0,4000,11000,-7000,-7000
00681R,元大美債20反1   ,0,0,0,0,0,0,0,0,0,-7000,0,0,0,8000,15000,-7000,-7000
048835,牧德凱基94購02  ,0,0,0,0,0,0,0,0,0,-7000,0,0,0,6000,13000,-7000,-7000
048283,亞德客中信94購01,0,0,0,0,0,0,0,0,0,-7000,0,0,0,13000,20000,-7000,-7000
050921,旺宏凱基95購02  ,0,0,0,0,0,0,0,0,0,-7000,0,0,0,43000,50000,-7000,-7000
049679,臺股指國票94購12,0,0,0,0,0,0,0,0,0,-7000,0,0,0,0,7000,-7000,-7000
049026,晶相光群益94購01,0,0,0,0,0,0,0,0,0,-7000,0,0,0,195000,202000,-7000,-7000
051404,牧德永豐96購01  ,0,0,0,0,0,0,0,0,0,-7000,0,0,0,13000,20000,-7000,-7000
05421P,鴻海元大96售12  ,0,0,0,0,0,0,0,0,0,-7000,0,0,0,304000,311000,-7000,-7000
054126,和大元大96購02  ,0,0,0,0,0,0,0,0,0,-7000,0,0,0,65000,72000,-7000,-7000
053604,臺股指元大96購21,0,0,0,0,0,0,0,0,0,-7000,0,0,0,0,7000,-7000,-7000
053560,漢唐國泰98購01  ,0,0,0,0,0,0,0,0,0,-7000,0,0,0,3000,10000,-7000,-7000
053543,臺股指永豐96購02,0,0,0,0,0,0,0,0,0,-7000,0,0,0,0,7000,-7000,-7000
051772,玉山金中信95購01,0,0,0,0,0,0,0,0,0,-7000,0,0,0,0,7000,-7000,-7000
051801,牧德永豐95購04  ,0,0,0,0,0,0,0,0,0,-7000,0,0,0,13000,20000,-7000,-7000
052801,友達元大9A購01  ,0,0,0,0,0,0,0,0,0,-7000,0,0,0,17000,24000,-7000,-7000
8222,寶一            ,1000,8000,-7000,0,0,0,0,0,0,0,0,0,0,0,0,0,-7000
8497,格威傳媒        ,3000,10000,-7000,0,0,0,0,0,0,0,0,0,0,0,0,0,-7000
8467,波力-KY         ,2000,9000,-7000,0,0,0,0,0,0,0,0,0,0,0,0,0,-7000
6582,申豐            ,15000,21000,-6000,0,0,0,0,0,0,-1000,0,1000,-1000,0,0,0,-7000
06125P,楠梓電元富99售01,0,0,0,0,0,0,0,0,0,-7000,0,0,0,3000,10000,-7000,-7000
06173P,華通元大97售02  ,0,0,0,0,0,0,0,0,0,-7000,0,0,0,0,7000,-7000,-7000
06188P,大立光元富97售01,0,0,0,0,0,0,0,0,0,-7000,0,0,0,15000,22000,-7000,-7000
06259P,臺股指群益97售12,0,0,0,0,0,0,0,0,0,-7000,0,0,0,0,7000,-7000,-7000
1324,地球            ,2000,9000,-7000,0,0,0,0,0,0,0,0,0,0,0,0,0,-7000
06452P,大立光元大98售08,0,0,0,0,0,0,0,0,0,-7000,0,0,0,44000,51000,-7000,-7000
06521P,矽力元大98售01  ,0,0,0,0,0,0,0,0,0,-7000,0,0,0,0,7000,-7000,-7000
06352P,臺股指富邦99售02,0,0,0,0,0,0,0,0,0,-7000,0,0,0,2000,9000,-7000,-7000
1776,展宇            ,4000,11000,-7000,0,0,0,0,0,0,0,0,0,0,0,0,0,-7000
1906,寶隆            ,37000,45000,-8000,0,0,0,0,0,0,1000,1000,0,1000,0,0,0,-7000
2002A,中鋼特          ,0,0,0,0,0,0,0,0,0,-7000,1000,8000,-7000,0,0,0,-7000
1727,中華化          ,5000,12000,-7000,0,0,0,0,0,0,0,0,0,0,0,0,0,-7000
2440,太空梭          ,2000,9000,-7000,0,0,0,0,0,0,0,0,0,0,0,0,0,-7000
3054,立萬利          ,2000,8000,-6000,0,0,0,0,0,0,-1000,0,1000,-1000,0,0,0,-7000
2904,匯僑            ,9000,16000,-7000,0,0,0,0,0,0,0,0,0,0,0,0,0,-7000
4960,誠美材          ,0,7000,-7000,0,0,0,0,0,0,0,0,0,0,0,0,0,-7000
2912,統一超          ,263600,271000,-7400,0,0,0,1000,0,1000,-1000,2000,3000,-1000,0,0,0,-7400
054830,世芯國泰99購01  ,0,0,0,0,0,0,0,0,0,-8000,0,0,0,25000,33000,-8000,-8000
05511P,T50反1台新06售01,0,0,0,0,0,0,0,0,0,-8000,0,0,0,0,8000,-8000,-8000
054642,訊芯中信9A購01  ,0,0,0,0,0,0,0,0,0,-8000,0,0,0,212000,220000,-8000,-8000
054579,聯茂元大97購01  ,0,0,0,0,0,0,0,0,0,-8000,0,0,0,62000,70000,-8000,-8000
05474P,智邦亞東95售01  ,0,0,0,0,0,0,0,0,0,-8000,0,0,0,0,8000,-8000,-8000
055696,華新科國票98購01,0,0,0,0,0,0,0,0,0,-8000,0,0,0,69000,77000,-8000,-8000
056473,奇力新元大99購02,0,0,0,0,0,0,0,0,0,-8000,0,0,0,343000,351000,-8000,-8000
05828P,台積電統一97售02,0,0,0,0,0,0,0,0,0,-8000,0,0,0,2000,10000,-8000,-8000
056176,創意元富97購01  ,0,0,0,0,0,0,0,0,0,-8000,0,0,0,12000,20000,-8000,-8000
056425,聯發科日盛9A購01,0,0,0,0,0,0,0,0,0,-8000,0,0,0,21000,29000,-8000,-8000
03960P,新日興元富96售02,0,0,0,0,0,0,0,0,0,-8000,0,0,0,14000,22000,-8000,-8000
044364,超眾中信94購01  ,0,0,0,0,0,0,0,0,0,-8000,0,0,0,7000,15000,-8000,-8000
048582,國泰金富邦93購01,0,0,0,0,0,0,0,0,0,-8000,0,0,0,0,8000,-8000,-8000
046875,康友元富93購01  ,0,0,0,0,0,0,0,0,0,-8000,0,0,0,0,8000,-8000,-8000
047632,儒鴻元大93購08  ,0,0,0,0,0,0,0,0,0,-8000,0,0,0,0,8000,-8000,-8000
045576,智邦元大92購07  ,0,0,0,0,0,0,0,0,0,-8000,0,0,0,0,8000,-8000,-8000
051426,道瓊反統一95購02,0,0,0,0,0,0,0,0,0,-8000,0,0,0,0,8000,-8000,-8000
051324,康友國票96購01  ,0,0,0,0,0,0,0,0,0,-8000,0,0,0,42000,50000,-8000,-8000
048981,牧德元大94購01  ,0,0,0,0,0,0,0,0,0,-8000,0,0,0,1000,9000,-8000,-8000
05107P,鴻海兆豐96售02  ,0,0,0,0,0,0,0,0,0,-8000,0,0,0,0,8000,-8000,-8000
049641,台達電凱基94購08,0,0,0,0,0,0,0,0,0,-8000,0,0,0,0,8000,-8000,-8000
050509,元油2X元大94購09,0,0,0,0,0,0,0,0,0,-8000,0,0,0,0,8000,-8000,-8000
051175,國巨凱基95購04  ,0,0,0,0,0,0,0,0,0,-8000,0,0,0,63000,71000,-8000,-8000
048111,奇力新群益93購06,0,0,0,0,0,0,0,0,0,-8000,0,0,0,8000,16000,-8000,-8000
051215,大立光統一95購03,0,0,0,0,0,0,0,0,0,-8000,0,0,0,10000,18000,-8000,-8000
048834,牧德凱基94購01  ,0,0,0,0,0,0,0,0,0,-8000,0,0,0,1000,9000,-8000,-8000
049797,台積電元大94購17,0,0,0,0,0,0,0,0,0,-8000,0,0,0,11000,19000,-8000,-8000
04916P,大立光永昌96售02,0,0,0,0,0,0,0,0,0,-8000,0,0,0,30000,38000,-8000,-8000
052105,南亞科兆豐95購01,0,0,0,0,0,0,0,0,0,-8000,0,0,0,2000,10000,-8000,-8000
052467,嘉聯益統一96購01,0,0,0,0,0,0,0,0,0,-8000,0,0,0,156000,164000,-8000,-8000
054194,國巨麥證96購02  ,0,0,0,42000,50000,-8000,0,0,0,-8000,0,0,0,42000,50000,-8000,-8000
054308,嘉晶凱基98購01  ,0,0,0,0,0,0,0,0,0,-8000,0,0,0,0,8000,-8000,-8000
05442P,鴻海元大96售13  ,0,0,0,0,0,0,0,0,0,-8000,0,0,0,216000,224000,-8000,-8000
2939,凱羿-KY         ,3000,13000,-10000,0,0,0,0,0,0,2000,2000,0,2000,0,0,0,-8000
4919,新唐            ,187000,181000,6000,0,0,0,0,0,0,-14000,0,0,0,9000,23000,-14000,-8000
4720,德淵            ,0,8000,-8000,0,0,0,0,0,0,0,1000,1000,0,0,0,0,-8000
1435,中福            ,17000,25000,-8000,0,0,0,0,0,0,0,0,0,0,0,0,0,-8000
1235,興泰            ,0,8000,-8000,0,0,0,0,0,0,0,0,0,0,0,0,0,-8000
1465,偉全            ,0,8000,-8000,0,0,0,0,0,0,0,0,0,0,0,0,0,-8000
06296P,燿華元大98售01  ,0,0,0,0,0,0,0,0,0,-8000,0,0,0,0,8000,-8000,-8000
06248P,國巨統一97售07  ,0,0,0,0,0,0,0,0,0,-8000,0,0,0,8000,16000,-8000,-8000
06245P,健策元富97售03  ,0,0,0,0,0,0,0,0,0,-8000,0,0,0,2000,10000,-8000,-8000
06071P,大立光永豐97售01,0,0,0,0,0,0,0,0,0,-8000,0,0,0,25000,33000,-8000,-8000
06026P,華通台新97售01  ,0,0,0,0,0,0,0,0,0,-8000,0,0,0,0,8000,-8000,-8000
5906,台南-KY         ,3000,11000,-8000,0,0,0,0,0,0,0,0,0,0,0,0,0,-8000
6117,迎廣            ,1000,10000,-9000,0,0,0,0,0,0,1000,1000,0,1000,0,0,0,-8000
8940,新天地          ,0,8000,-8000,0,0,0,0,0,0,0,0,0,0,0,0,0,-8000
9941A,裕融甲特        ,0,0,0,0,0,0,0,0,0,-8000,1000,9000,-8000,0,0,0,-8000
3008,大立光          ,317335,312000,5335,0,0,0,2000,7000,-5000,-9000,3000,4000,-1000,1000,9000,-8000,-8665
05633P,台表科群益96售04,0,0,0,0,0,0,0,0,0,-9000,0,0,0,31000,40000,-9000,-9000
056278,全新富邦98購02  ,0,0,0,0,0,0,0,0,0,-9000,0,0,0,0,9000,-9000,-9000
056045,勤誠凱基97購01  ,0,0,0,0,0,0,0,0,0,-9000,0,0,0,1000,10000,-9000,-9000
055872,亞泥元富97購01  ,0,0,0,0,0,0,0,0,0,-9000,0,0,0,31000,40000,-9000,-9000
055849,聯詠元大97購05  ,0,0,0,0,0,0,0,0,0,-9000,0,0,0,106000,115000,-9000,-9000
05720P,可成中信98售01  ,0,0,0,0,0,0,0,0,0,-9000,0,0,0,5000,14000,-9000,-9000
05874P,台積電群益96售10,0,0,0,0,0,0,0,0,0,-9000,0,0,0,11000,20000,-9000,-9000
056670,樺漢國票99購01  ,0,0,0,0,0,0,0,0,0,-9000,0,0,0,0,9000,-9000,-9000
055729,金寶元富99購01  ,0,0,0,0,0,0,0,0,0,-9000,0,0,0,5000,14000,-9000,-9000
055732,全新元富9A購01  ,0,0,0,0,0,0,0,0,0,-9000,0,0,0,21000,30000,-9000,-9000
055455,健策國泰98購02  ,0,0,0,0,0,0,0,0,0,-9000,0,0,0,249000,258000,-9000,-9000
054760,台化國票9A購01  ,0,0,0,0,0,0,0,0,0,-9000,0,0,0,29000,38000,-9000,-9000
054773,台郡國票98購01  ,0,0,0,0,0,0,0,0,0,-9000,0,0,0,2000,11000,-9000,-9000
047758,康舒元富93購01  ,0,0,0,0,0,0,0,0,0,-9000,0,0,0,16000,25000,-9000,-9000
046324,健策元大92購05  ,0,0,0,0,0,0,0,0,0,-9000,0,0,0,19000,28000,-9000,-9000
04735P,聯茂兆豐94售01  ,0,0,0,0,0,0,0,0,0,-9000,0,0,0,0,9000,-9000,-9000
046890,瑞昱群益93購02  ,0,0,0,0,0,0,0,0,0,-9000,0,0,0,1000,10000,-9000,-9000
044184,南亞科國泰93購01,0,0,0,0,0,0,0,0,0,-9000,0,0,0,0,9000,-9000,-9000
044516,景碩凱基93購02  ,0,0,0,0,0,0,0,0,0,-9000,0,0,0,0,9000,-9000,-9000
00660,元大歐洲50      ,0,0,0,0,0,0,0,0,0,-9000,0,0,0,0,9000,-9000,-9000
03784P,致伸凱基93售02  ,0,0,0,0,0,0,0,0,0,-9000,0,0,0,1000,10000,-9000,-9000
048263,台積電元富95購01,0,0,0,0,0,0,0,0,0,-9000,0,0,0,1000,10000,-9000,-9000
050911,光磊中信98購01  ,0,0,0,0,0,0,0,0,0,-9000,0,0,0,0,9000,-9000,-9000
051066,台積電國票96購02,0,0,0,0,0,0,0,0,0,-9000,0,0,0,0,9000,-9000,-9000
049909,國巨元大95購01  ,0,0,0,0,0,0,0,0,0,-9000,0,0,0,1000,10000,-9000,-9000
049892,國巨富邦96購01  ,0,0,0,0,0,0,0,0,0,-9000,0,0,0,2000,11000,-9000,-9000
049143,智邦元大94購02  ,0,0,0,0,0,0,0,0,0,-9000,0,0,0,98000,107000,-9000,-9000
054281,世芯群益97購01  ,0,0,0,0,0,0,0,0,0,-9000,0,0,0,23000,32000,-9000,-9000
053826,光磊麥證97購01  ,0,0,0,1000,10000,-9000,0,0,0,-9000,0,0,0,1000,10000,-9000,-9000
052413,上証反中信97購01,0,0,0,0,0,0,0,0,0,-9000,0,0,0,0,9000,-9000,-9000
052573,智伸科凱基97購01,0,0,0,0,0,0,0,0,0,-9000,0,0,0,10000,19000,-9000,-9000
053126,健策凱基97購02  ,0,0,0,0,0,0,0,0,0,-9000,0,0,0,84000,93000,-9000,-9000
2611,志信            ,7000,16000,-9000,0,0,0,0,0,0,0,0,0,0,0,0,0,-9000
3296,勝德            ,1000,10000,-9000,0,0,0,0,0,0,0,0,0,0,0,0,0,-9000
1626,艾美特-KY       ,66000,75000,-9000,0,0,0,0,0,0,0,0,0,0,0,0,0,-9000
06003P,亞光康和96售02  ,0,0,0,0,0,0,0,0,0,-9000,0,0,0,0,9000,-9000,-9000
06282P,聯鈞永豐97售02  ,0,0,0,0,0,0,0,0,0,-9000,0,0,0,10000,19000,-9000,-9000
1521,大億            ,4000,13000,-9000,0,0,0,0,0,0,0,0,0,0,0,0,0,-9000
1516,川飛            ,5000,14000,-9000,0,0,0,0,0,0,0,0,0,0,0,0,0,-9000
1539,巨庭            ,1000,10000,-9000,0,0,0,0,0,0,0,0,0,0,0,0,0,-9000
1410,南染            ,1000,10000,-9000,0,0,0,0,0,0,0,0,0,0,0,0,0,-9000
9136,巨騰-DR         ,2000,11000,-9000,0,0,0,0,0,0,0,0,0,0,0,0,0,-9000
6579,研揚            ,1000,10000,-9000,0,0,0,0,0,0,0,0,0,0,0,0,0,-9000
6674,鋐寶科技        ,0,9000,-9000,0,0,0,0,0,0,0,0,0,0,0,0,0,-9000
054766,智原國票98購01  ,0,0,0,0,0,0,0,0,0,-10000,0,0,0,0,10000,-10000,-10000
054704,玉晶光第一97購01,0,0,0,0,0,0,0,0,0,-10000,0,0,0,50000,60000,-10000,-10000
054617,超眾永豐97購01  ,0,0,0,0,0,0,0,0,0,-10000,0,0,0,0,10000,-10000,-10000
054541,康控國票98購01  ,0,0,0,0,0,0,0,0,0,-10000,0,0,0,50000,60000,-10000,-10000
054511,香港反元大98購01,0,0,0,0,0,0,0,0,0,-10000,0,0,0,0,10000,-10000,-10000
054513,元金2X元大96購01,0,0,0,0,0,0,0,0,0,-10000,0,0,0,0,10000,-10000,-10000
054526,道瓊反統一98購01,0,0,0,0,0,0,0,0,0,-10000,0,0,0,0,10000,-10000,-10000
055135,聯發科富邦99購05,0,0,0,0,0,0,0,0,0,-10000,0,0,0,0,10000,-10000,-10000
055024,興勤國泰98購01  ,0,0,0,0,0,0,0,0,0,-10000,0,0,0,25000,35000,-10000,-10000
055042,得力永豐97購01  ,0,0,0,0,0,0,0,0,0,-10000,0,0,0,0,10000,-10000,-10000
054845,智邦兆豐98購01  ,0,0,0,0,0,0,0,0,0,-10000,0,0,0,40000,50000,-10000,-10000
054852,奇鋐國票98購01  ,0,0,0,0,0,0,0,0,0,-10000,0,0,0,100000,110000,-10000,-10000
054993,南亞科元富97購03,0,0,0,0,0,0,0,0,0,-10000,0,0,0,0,10000,-10000,-10000
054995,宏盛元富97購01  ,0,0,0,0,0,0,0,0,0,-10000,0,0,0,0,10000,-10000,-10000
054997,文曄元富97購01  ,0,0,0,0,0,0,0,0,0,-10000,0,0,0,0,10000,-10000,-10000
054969,亞翔元大97購01  ,0,0,0,0,0,0,0,0,0,-10000,0,0,0,60000,70000,-10000,-10000
054967,神達元大97購01  ,0,0,0,0,0,0,0,0,0,-10000,0,0,0,0,10000,-10000,-10000
054959,禾伸堂元大98購01,0,0,0,0,0,0,0,0,0,-10000,0,0,0,0,10000,-10000,-10000
055453,華邦電元富97購01,0,0,0,0,0,0,0,0,0,-10000,0,0,0,0,10000,-10000,-10000
055435,佳世達中信99購01,0,0,0,0,0,0,0,0,0,-10000,0,0,0,40000,50000,-10000,-10000
05533P,滬深2X富邦97售01,0,0,0,0,0,0,0,0,0,-10000,0,0,0,0,10000,-10000,-10000
055323,貿聯國票98購01  ,0,0,0,0,0,0,0,0,0,-10000,0,0,0,30000,40000,-10000,-10000
055219,啟碁凱基98購01  ,0,0,0,0,0,0,0,0,0,-10000,0,0,0,0,10000,-10000,-10000
055204,宏達電中信99購01,0,0,0,0,0,0,0,0,0,-10000,0,0,0,0,10000,-10000,-10000
05527P,聯茂群益96售01  ,0,0,0,0,0,0,0,0,0,-10000,0,0,0,0,10000,-10000,-10000
055474,欣興凱基97購05  ,0,0,0,0,0,0,0,0,0,-10000,0,0,0,15000,25000,-10000,-10000
05552P,聯詠群益96售01  ,0,0,0,0,0,0,0,0,0,-10000,0,0,0,0,10000,-10000,-10000
055588,瑞昱元大97購03  ,0,0,0,0,0,0,0,0,0,-10000,0,0,0,218000,228000,-10000,-10000
055623,貿聯國泰99購01  ,0,0,0,0,0,0,0,0,0,-10000,0,0,0,0,10000,-10000,-10000
055585,國巨元大98購08  ,0,0,0,0,0,0,0,0,0,-10000,0,0,0,10000,20000,-10000,-10000
055583,國巨元大97購10  ,0,0,0,0,0,0,0,0,0,-10000,0,0,0,0,10000,-10000,-10000
056676,國產元富98購01  ,0,0,0,0,0,0,0,0,0,-10000,0,0,0,0,10000,-10000,-10000
056706,元油2X富邦9B購01,0,0,0,0,0,0,0,0,0,-10000,0,0,0,0,10000,-10000,-10000
056697,緯穎群益98購01  ,0,0,0,0,0,0,0,0,0,-10000,0,0,0,48000,58000,-10000,-10000
056791,嘉聯益群益98購01,0,0,0,0,0,0,0,0,0,-10000,0,0,0,0,10000,-10000,-10000
056773,晶技元大99購03  ,0,0,0,0,0,0,0,0,0,-10000,0,0,0,0,10000,-10000,-10000
056761,元油2X元大98購07,0,0,0,0,0,0,0,0,0,-10000,0,0,0,0,10000,-10000,-10000
056726,友達日盛9A購01  ,0,0,0,0,0,0,0,0,0,-10000,0,0,0,0,10000,-10000,-10000
056546,致伸凱基98購01  ,0,0,0,0,0,0,0,0,0,-10000,0,0,0,0,10000,-10000,-10000
05873P,華通群益97售02  ,0,0,0,0,0,0,0,0,0,-10000,0,0,0,0,10000,-10000,-10000
05909P,康友元富96售02  ,0,0,0,0,0,0,0,0,0,-10000,0,0,0,0,10000,-10000,-10000
05907P,聯發科元富96售05,0,0,0,0,0,0,0,0,0,-10000,0,0,0,0,10000,-10000,-10000
05983P,聯詠國票96售02  ,0,0,0,0,0,0,0,0,0,-10000,0,0,0,0,10000,-10000,-10000
05694P,台積電凱基96售09,0,0,0,0,0,0,0,0,0,-10000,0,0,0,200000,210000,-10000,-10000
05718P,國巨元大96售09  ,0,0,0,0,0,0,0,0,0,-10000,0,0,0,10000,20000,-10000,-10000
05838P,臺股指富邦96售05,0,0,0,0,0,0,0,0,0,-10000,0,0,0,10000,20000,-10000,-10000
05797P,臺股指群益96售11,0,0,0,0,0,0,0,0,0,-10000,0,0,0,4000,14000,-10000,-10000
055977,南亞科統一97購01,0,0,0,0,0,0,0,0,0,-10000,0,0,0,0,10000,-10000,-10000
056251,聯發科兆豐97購02,0,0,0,0,0,0,0,0,0,-10000,0,0,0,0,10000,-10000,-10000
056256,聯茂元富97購03  ,0,0,0,0,0,0,0,0,0,-10000,0,0,0,99000,109000,-10000,-10000
056174,億光元富97購01  ,0,0,0,0,0,0,0,0,0,-10000,0,0,0,0,10000,-10000,-10000
056183,南亞科統一97購02,0,0,0,0,0,0,0,0,0,-10000,0,0,0,0,10000,-10000,-10000
056151,建準凱基97購01  ,0,0,0,0,0,0,0,0,0,-10000,0,0,0,0,10000,-10000,-10000
056360,智邦元大98購01  ,0,0,0,0,0,0,0,0,0,-10000,0,0,0,0,10000,-10000,-10000
03788P,聯發科群益94售02,0,0,0,0,0,0,0,0,0,-10000,0,0,0,0,10000,-10000,-10000
03641C,臺股指凱基95牛18,0,0,0,0,0,0,0,0,0,-10000,0,0,0,0,10000,-10000,-10000
03444P,道瓊銀群益02售04,0,0,0,0,0,0,0,0,0,-10000,0,0,0,0,10000,-10000,-10000
03492P,創意元大02售03  ,0,0,0,0,0,0,0,0,0,-10000,0,0,0,0,10000,-10000,-10000
03375P,玉晶光元大02售07,0,0,0,0,0,0,0,0,0,-10000,0,0,0,0,10000,-10000,-10000
044666,創意國泰93購01  ,0,0,0,0,0,0,0,0,0,-10000,0,0,0,0,10000,-10000,-10000
04462P,全新元富96售01  ,0,0,0,0,0,0,0,0,0,-10000,0,0,0,0,10000,-10000,-10000
04461P,燿華元富94售01  ,0,0,0,0,0,0,0,0,0,-10000,0,0,0,0,10000,-10000,-10000
044610,A50正2兆豐93購01,0,0,0,0,0,0,0,0,0,-10000,0,0,0,0,10000,-10000,-10000
04474P,聯發科元大94售03,0,0,0,0,0,0,0,0,0,-10000,0,0,0,110000,120000,-10000,-10000
041534,T50反1凱基96購01,0,0,0,0,0,0,0,0,0,-10000,0,0,0,0,10000,-10000,-10000
04210P,鴻海凱基93售36  ,0,0,0,0,0,0,0,0,0,-10000,0,0,0,0,10000,-10000,-10000
04194P,欣興永豐93售05  ,0,0,0,0,0,0,0,0,0,-10000,0,0,0,0,10000,-10000,-10000
04148P,GIS凱基93售05   ,0,0,0,0,0,0,0,0,0,-10000,0,0,0,23000,33000,-10000,-10000
044930,元黃金富邦93購01,0,0,0,0,0,0,0,0,0,-10000,0,0,0,25000,35000,-10000,-10000
03959P,義隆元富96售01  ,0,0,0,0,0,0,0,0,0,-10000,0,0,0,0,10000,-10000,-10000
03885P,華新科統一96售01,0,0,0,0,0,0,0,0,0,-10000,0,0,0,0,10000,-10000,-10000
03889P,國巨國泰94售04  ,0,0,0,0,0,0,0,0,0,-10000,0,0,0,0,10000,-10000,-10000
03892P,元油2X中信95售01,0,0,0,0,0,0,0,0,0,-10000,0,0,0,0,10000,-10000,-10000
03893P,為升凱基93售03  ,0,0,0,0,0,0,0,0,0,-10000,0,0,0,0,10000,-10000,-10000
04014P,聯發科元大93售18,0,0,0,0,0,0,0,0,0,-10000,0,0,0,0,10000,-10000,-10000
04033P,啟碁凱基93售04  ,0,0,0,0,0,0,0,0,0,-10000,0,0,0,0,10000,-10000,-10000
04044P,鴻海元大93售18  ,0,0,0,0,0,0,0,0,0,-10000,0,0,0,0,10000,-10000,-10000
03237P,大立光元大02售04,0,0,0,0,0,0,0,0,0,-10000,0,0,0,0,10000,-10000,-10000
04109P,臺股指永昌93售04,0,0,0,0,0,0,0,0,0,-10000,0,0,0,500000,510000,-10000,-10000
04449P,智邦凱基94售01  ,0,0,0,0,0,0,0,0,0,-10000,0,0,0,0,10000,-10000,-10000
04291P,鴻海富邦93售04  ,0,0,0,0,0,0,0,0,0,-10000,0,0,0,0,10000,-10000,-10000
046453,台積電凱基92購21,0,0,0,0,0,0,0,0,0,-10000,0,0,0,0,10000,-10000,-10000
047441,聯發科元大93購15,0,0,0,0,0,0,0,0,0,-10000,0,0,0,0,10000,-10000,-10000
046440,義隆亞東93購01  ,0,0,0,0,0,0,0,0,0,-10000,0,0,0,0,10000,-10000,-10000
046428,矽力元大92購02  ,0,0,0,0,0,0,0,0,0,-10000,0,0,0,0,10000,-10000,-10000
047485,景碩凱基94購01  ,0,0,0,0,0,0,0,0,0,-10000,0,0,0,0,10000,-10000,-10000
047480,全新凱基93購01  ,0,0,0,0,0,0,0,0,0,-10000,0,0,0,1000,11000,-10000,-10000
047578,新光金群益93購01,0,0,0,0,0,0,0,0,0,-10000,0,0,0,0,10000,-10000,-10000
047599,大立光統一93購08,0,0,0,0,0,0,0,0,0,-10000,0,0,0,0,10000,-10000,-10000
046555,A50反1凱基92購01,0,0,0,0,0,0,0,0,0,-10000,0,0,0,0,10000,-10000,-10000
04399P,樺漢群益94售01  ,0,0,0,0,0,0,0,0,0,-10000,0,0,0,0,10000,-10000,-10000
044129,群創凱基93購02  ,0,0,0,0,0,0,0,0,0,-10000,0,0,0,0,10000,-10000,-10000
044302,智邦兆豐93購02  ,0,0,0,0,0,0,0,0,0,-10000,0,0,0,0,10000,-10000,-10000
044304,臻鼎兆豐93購01  ,0,0,0,0,0,0,0,0,0,-10000,0,0,0,10000,20000,-10000,-10000
042445,上証2X凱基92購04,0,0,0,0,0,0,0,0,0,-10000,0,0,0,0,10000,-10000,-10000
042542,台灣50元大93購14,0,0,0,0,0,0,0,0,0,-10000,0,0,0,0,10000,-10000,-10000
04249P,大立光統一94售04,0,0,0,0,0,0,0,0,0,-10000,0,0,0,0,10000,-10000,-10000
043642,元金2X國票97購01,0,0,0,0,0,0,0,0,0,-10000,0,0,0,0,10000,-10000,-10000
04391P,玉晶光凱基95售03,0,0,0,0,0,0,0,0,0,-10000,0,0,0,0,10000,-10000,-10000
043921,台表科凱基93購01,0,0,0,0,0,0,0,0,0,-10000,0,0,0,0,10000,-10000,-10000
043892,矽創元大92購01  ,0,0,0,0,0,0,0,0,0,-10000,0,0,0,10000,20000,-10000,-10000
04203P,超眾元大93售04  ,0,0,0,0,0,0,0,0,0,-10000,0,0,0,0,10000,-10000,-10000
047911,晶技麥證94購01  ,0,0,0,0,10000,-10000,0,0,0,-10000,0,0,0,0,10000,-10000,-10000
047119,臻鼎元大93購01  ,0,0,0,0,0,0,0,0,0,-10000,0,0,0,0,10000,-10000,-10000
047127,臻鼎中信95購01  ,0,0,0,0,0,0,0,0,0,-10000,0,0,0,20000,30000,-10000,-10000
047128,新日興日盛93購01,0,0,0,0,0,0,0,0,0,-10000,0,0,0,0,10000,-10000,-10000
047087,亞泥元富93購01  ,0,0,0,0,0,0,0,0,0,-10000,0,0,0,20000,30000,-10000,-10000
04951P,緯創中信94售01  ,0,0,0,0,0,0,0,0,0,-10000,0,0,0,20000,30000,-10000,-10000
049493,可成元大94購05  ,0,0,0,0,0,0,0,0,0,-10000,0,0,0,0,10000,-10000,-10000
047039,晶技群益93購02  ,0,0,0,0,0,0,0,0,0,-10000,0,0,0,0,10000,-10000,-10000
048532,大立光國票93購06,0,0,0,0,0,0,0,0,0,-10000,0,0,0,0,10000,-10000,-10000
048552,鴻海元大94購03  ,0,0,0,0,0,0,0,0,0,-10000,0,0,0,1000,11000,-10000,-10000
050728,新日興國票94購01,0,0,0,0,0,0,0,0,0,-10000,0,0,0,0,10000,-10000,-10000
050481,泰鼎國票96購01  ,0,0,0,0,0,0,0,0,0,-10000,0,0,0,0,10000,-10000,-10000
050698,明泰凱基96購01  ,0,0,0,0,0,0,0,0,0,-10000,0,0,0,40000,50000,-10000,-10000
050688,大立光日盛94購03,0,0,0,0,0,0,0,0,0,-10000,0,0,0,0,10000,-10000,-10000
046349,康控兆豐93購02  ,0,0,0,0,0,0,0,0,0,-10000,0,0,0,0,10000,-10000,-10000
046220,滬深2X元大95購03,0,0,0,0,0,0,0,0,0,-10000,0,0,0,0,10000,-10000,-10000
046259,和大凱基92購02  ,0,0,0,0,0,0,0,0,0,-10000,0,0,0,0,10000,-10000,-10000
046867,瑞昱統一93購01  ,0,0,0,0,0,0,0,0,0,-10000,0,0,0,0,10000,-10000,-10000
045796,廣達中信93購01  ,0,0,0,0,0,0,0,0,0,-10000,0,0,0,254000,264000,-10000,-10000
04578P,微星富邦96售01  ,0,0,0,0,0,0,0,0,0,-10000,0,0,0,0,10000,-10000,-10000
045791,台表科元大93購04,0,0,0,0,0,0,0,0,0,-10000,0,0,0,0,10000,-10000,-10000
046178,聯發科日盛92購01,0,0,0,0,0,0,0,0,0,-10000,0,0,0,28000,38000,-10000,-10000
046082,矽力凱基92購01  ,0,0,0,0,0,0,0,0,0,-10000,0,0,0,0,10000,-10000,-10000
046159,群創群益98購04  ,0,0,0,0,0,0,0,0,0,-10000,0,0,0,0,10000,-10000,-10000
047813,華新科凱基93購07,0,0,0,0,0,0,0,0,0,-10000,0,0,0,0,10000,-10000,-10000
047803,卜蜂凱基93購03  ,0,0,0,0,0,0,0,0,0,-10000,0,0,0,0,10000,-10000,-10000
045968,貿聯凱基92購03  ,0,0,0,0,0,0,0,0,0,-10000,0,0,0,0,10000,-10000,-10000
04596P,臺股指元大94售14,0,0,0,0,0,0,0,0,0,-10000,0,0,0,0,10000,-10000,-10000
045966,聯詠凱基92購07  ,0,0,0,0,0,0,0,0,0,-10000,0,0,0,30000,40000,-10000,-10000
046818,奇力新凱基93購04,0,0,0,0,0,0,0,0,0,-10000,0,0,0,10000,20000,-10000,-10000
046788,貿聯永豐93購01  ,0,0,0,0,0,0,0,0,0,-10000,0,0,0,0,10000,-10000,-10000
046790,康友永豐93購01  ,0,0,0,0,0,0,0,0,0,-10000,0,0,0,177000,187000,-10000,-10000
04556P,大成鋼群益94售02,0,0,0,0,0,0,0,0,0,-10000,0,0,0,0,10000,-10000,-10000
045503,群創凱基93購09  ,0,0,0,0,0,0,0,0,0,-10000,0,0,0,0,10000,-10000,-10000
045651,力成凱基93購01  ,0,0,0,0,0,0,0,0,0,-10000,0,0,0,0,10000,-10000,-10000
047649,啟碁元大93購07  ,0,0,0,0,0,0,0,0,0,-10000,0,0,0,0,10000,-10000,-10000
04766P,緯穎永豐94售02  ,0,0,0,0,0,0,0,0,0,-10000,0,0,0,0,10000,-10000,-10000
046623,臻鼎凱基93購02  ,0,0,0,0,0,0,0,0,0,-10000,0,0,0,0,10000,-10000,-10000
047723,廣宇群益94購01  ,0,0,0,0,0,0,0,0,0,-10000,0,0,0,0,10000,-10000,-10000
047692,T50反1國票94購01,0,0,0,0,0,0,0,0,0,-10000,0,0,0,0,10000,-10000,-10000
04912P,可成元富94售06  ,0,0,0,0,0,0,0,0,0,-10000,0,0,0,0,10000,-10000,-10000
049364,燿華元大94購02  ,0,0,0,0,0,0,0,0,0,-10000,0,0,0,0,10000,-10000,-10000
049365,美律元大94購04  ,0,0,0,0,0,0,0,0,0,-10000,0,0,0,18000,28000,-10000,-10000
049346,新光金統一95購01,0,0,0,0,0,0,0,0,0,-10000,0,0,0,0,10000,-10000,-10000
049895,國巨統一94購04  ,0,0,0,0,0,0,0,0,0,-10000,0,0,0,0,10000,-10000,-10000
050079,元油2X統一94購06,0,0,0,0,0,0,0,0,0,-10000,0,0,0,0,10000,-10000,-10000
050134,世紀鋼凱基94購04,0,0,0,0,0,0,0,0,0,-10000,0,0,0,0,10000,-10000,-10000
050243,華新科凱基94購10,0,0,0,0,0,0,0,0,0,-10000,0,0,0,26000,36000,-10000,-10000
049971,台郡國票95購01  ,0,0,0,0,0,0,0,0,0,-10000,0,0,0,10000,20000,-10000,-10000
049980,奇力新凱基94購04,0,0,0,0,0,0,0,0,0,-10000,0,0,0,12000,22000,-10000,-10000
048961,矽創康和94購01  ,0,0,0,0,0,0,0,0,0,-10000,0,0,0,0,10000,-10000,-10000
048968,可成元大94購02  ,0,0,0,0,0,0,0,0,0,-10000,0,0,0,20000,30000,-10000,-10000
04893P,創意元大94售03  ,0,0,0,0,0,0,0,0,0,-10000,0,0,0,67000,77000,-10000,-10000
048851,台達電群益94購01,0,0,0,0,0,0,0,0,0,-10000,0,0,0,10000,20000,-10000,-10000
050292,可成凱基94購11  ,0,0,0,0,0,0,0,0,0,-10000,0,0,0,0,10000,-10000,-10000
050018,高股息元大94購02,0,0,0,0,0,0,0,0,0,-10000,0,0,0,0,10000,-10000,-10000
050570,聯發科中信97購02,0,0,0,0,0,0,0,0,0,-10000,0,0,0,0,10000,-10000,-10000
050565,矽格元富94購01  ,0,0,0,0,0,0,0,0,0,-10000,0,0,0,0,10000,-10000,-10000
047975,緯創兆豐93購01  ,0,0,0,0,0,0,0,0,0,-10000,0,0,0,10000,20000,-10000,-10000
048038,樺漢凱基93購03  ,0,0,0,0,0,0,0,0,0,-10000,0,0,0,10000,20000,-10000,-10000
051310,台達電麥證95購01,0,0,0,40000,50000,-10000,0,0,0,-10000,0,0,0,40000,50000,-10000,-10000
051309,卜蜂麥證95購01  ,0,0,0,0,10000,-10000,0,0,0,-10000,0,0,0,0,10000,-10000,-10000
051357,可成元大95購05  ,0,0,0,0,0,0,0,0,0,-10000,0,0,0,0,10000,-10000,-10000
051389,台達電兆豐95購01,0,0,0,0,0,0,0,0,0,-10000,0,0,0,0,10000,-10000,-10000
049014,台達電群益94購02,0,0,0,0,0,0,0,0,0,-10000,0,0,0,20000,30000,-10000,-10000
049040,亞光兆豐95購01  ,0,0,0,0,0,0,0,0,0,-10000,0,0,0,0,10000,-10000,-10000
051269,康友富邦97購01  ,0,0,0,0,0,0,0,0,0,-10000,0,0,0,0,10000,-10000,-10000
051412,奇力新國票96購01,0,0,0,0,0,0,0,0,0,-10000,0,0,0,0,10000,-10000,-10000
051535,新日興國票96購01,0,0,0,0,0,0,0,0,0,-10000,0,0,0,0,10000,-10000,-10000
051481,聯詠凱基95購02  ,0,0,0,0,0,0,0,0,0,-10000,0,0,0,0,10000,-10000,-10000
051714,健鼎台新95購01  ,0,0,0,0,0,0,0,0,0,-10000,0,0,0,10000,20000,-10000,-10000
051643,瑞昱康和95購01  ,0,0,0,0,0,0,0,0,0,-10000,0,0,0,58000,68000,-10000,-10000
050917,瀚宇博兆豐96購01,0,0,0,0,0,0,0,0,0,-10000,0,0,0,0,10000,-10000,-10000
05088P,大立光富邦99售01,0,0,0,0,0,0,0,0,0,-10000,0,0,0,30000,40000,-10000,-10000
050788,台郡國泰96購01  ,0,0,0,0,0,0,0,0,0,-10000,0,0,0,0,10000,-10000,-10000
050740,旺宏永豐94購03  ,0,0,0,0,0,0,0,0,0,-10000,0,0,0,15000,25000,-10000,-10000
050749,道瓊銀統一96購03,0,0,0,0,0,0,0,0,0,-10000,0,0,0,0,10000,-10000,-10000
050960,台光電永豐95購01,0,0,0,0,0,0,0,0,0,-10000,0,0,0,10000,20000,-10000,-10000
048606,聯發科日盛93購02,0,0,0,0,0,0,0,0,0,-10000,0,0,0,0,10000,-10000,-10000
048672,日電貿永豐93購02,0,0,0,0,0,0,0,0,0,-10000,0,0,0,0,10000,-10000,-10000
048641,美律元大94購01  ,0,0,0,0,0,0,0,0,0,-10000,0,0,0,68000,78000,-10000,-10000
048661,瑞昱統一93購05  ,0,0,0,0,0,0,0,0,0,-10000,0,0,0,0,10000,-10000,-10000
049571,華固統一94購02  ,0,0,0,0,0,0,0,0,0,-10000,0,0,0,10000,20000,-10000,-10000
050508,上証2X元大97購01,0,0,0,0,0,0,0,0,0,-10000,0,0,0,0,10000,-10000,-10000
05111P,台積電統一95售04,0,0,0,0,0,0,0,0,0,-10000,0,0,0,36000,46000,-10000,-10000
050151,台積電群益94購12,0,0,0,0,0,0,0,0,0,-10000,0,0,0,47000,57000,-10000,-10000
050167,T50反1富邦96購01,0,0,0,0,0,0,0,0,0,-10000,0,0,0,0,10000,-10000,-10000
050169,臺指反元大97購01,0,0,0,0,0,0,0,0,0,-10000,0,0,0,0,10000,-10000,-10000
048728,台達電麥證94購01,0,0,0,30000,40000,-10000,0,0,0,-10000,0,0,0,30000,40000,-10000,-10000
048758,美利達元富96購02,0,0,0,0,0,0,0,0,0,-10000,0,0,0,10000,20000,-10000,-10000
048746,台達電元富94購01,0,0,0,0,0,0,0,0,0,-10000,0,0,0,0,10000,-10000,-10000
049714,國巨凱基94購02  ,0,0,0,0,0,0,0,0,0,-10000,0,0,0,0,10000,-10000,-10000
04827P,國巨凱基94售09  ,0,0,0,0,0,0,0,0,0,-10000,0,0,0,0,10000,-10000,-10000
048376,台達電元富93購01,0,0,0,0,0,0,0,0,0,-10000,0,0,0,0,10000,-10000,-10000
048075,美利達元富93購02,0,0,0,0,0,0,0,0,0,-10000,0,0,0,10000,20000,-10000,-10000
05118P,超眾元大96售04  ,0,0,0,0,0,0,0,0,0,-10000,0,0,0,10000,20000,-10000,-10000
048240,嘉聯益國票94購03,0,0,0,0,0,0,0,0,0,-10000,0,0,0,0,10000,-10000,-10000
048203,矽力元大93購02  ,0,0,0,0,0,0,0,0,0,-10000,0,0,0,0,10000,-10000,-10000
048186,元黃金元大96購01,0,0,0,0,0,0,0,0,0,-10000,0,0,0,0,10000,-10000,-10000
048165,嘉澤康和93購01  ,0,0,0,0,0,0,0,0,0,-10000,0,0,0,0,10000,-10000,-10000
048170,智原永豐93購02  ,0,0,0,0,0,0,0,0,0,-10000,0,0,0,0,10000,-10000,-10000
049226,元石油富邦95購01,0,0,0,0,0,0,0,0,0,-10000,0,0,0,0,10000,-10000,-10000
04939P,國巨國票95售03  ,0,0,0,0,0,0,0,0,0,-10000,0,0,0,0,10000,-10000,-10000
049728,正崴中信94購01  ,0,0,0,0,0,0,0,0,0,-10000,0,0,0,0,10000,-10000,-10000
051023,S&P反1統一95購02,0,0,0,0,0,0,0,0,0,-10000,0,0,0,0,10000,-10000,-10000
051017,聯發科凱基95購04,0,0,0,0,0,0,0,0,0,-10000,0,0,0,6000,16000,-10000,-10000
053038,華邦電凱基97購01,0,0,0,0,0,0,0,0,0,-10000,0,0,0,10000,20000,-10000,-10000
05296P,牧德凱基96售01  ,0,0,0,0,0,0,0,0,0,-10000,0,0,0,0,10000,-10000,-10000
05300P,健策元大95售02  ,0,0,0,0,0,0,0,0,0,-10000,0,0,0,0,10000,-10000,-10000
052998,拓凱康和96購01  ,0,0,0,0,0,0,0,0,0,-10000,0,0,0,10000,20000,-10000,-10000
052569,聯發科凱基96購08,0,0,0,0,0,0,0,0,0,-10000,0,0,0,60000,70000,-10000,-10000
052560,康舒國票97購01  ,0,0,0,0,0,0,0,0,0,-10000,0,0,0,46000,56000,-10000,-10000
052546,友達中信98購01  ,0,0,0,0,0,0,0,0,0,-10000,0,0,0,20000,30000,-10000,-10000
052654,友達統一97購01  ,0,0,0,0,0,0,0,0,0,-10000,0,0,0,0,10000,-10000,-10000
052626,上証2X中信9A購01,0,0,0,0,0,0,0,0,0,-10000,0,0,0,0,10000,-10000,-10000
052808,矽力元大96購02  ,0,0,0,0,0,0,0,0,0,-10000,0,0,0,0,10000,-10000,-10000
05277P,深中小統一95售02,0,0,0,0,0,0,0,0,0,-10000,0,0,0,0,10000,-10000,-10000
05278P,台郡元富95售02  ,0,0,0,0,0,0,0,0,0,-10000,0,0,0,0,10000,-10000,-10000
052721,友達統一96購01  ,0,0,0,0,0,0,0,0,0,-10000,0,0,0,0,10000,-10000,-10000
052712,旺宏凱基96購02  ,0,0,0,0,0,0,0,0,0,-10000,0,0,0,0,10000,-10000,-10000
052415,台表科麥證95購02,0,0,0,0,10000,-10000,0,0,0,-10000,0,0,0,0,10000,-10000,-10000
05240P,玉晶光永豐96售01,0,0,0,0,0,0,0,0,0,-10000,0,0,0,0,10000,-10000,-10000
05243P,鴻海元大95售19  ,0,0,0,0,0,0,0,0,0,-10000,0,0,0,181000,191000,-10000,-10000
052448,新光金元大96購03,0,0,0,0,0,0,0,0,0,-10000,0,0,0,0,10000,-10000,-10000
052155,百和台新95購01  ,0,0,0,0,0,0,0,0,0,-10000,0,0,0,38000,48000,-10000,-10000
052185,奇力新群益95購03,0,0,0,0,0,0,0,0,0,-10000,0,0,0,10000,20000,-10000,-10000
052299,T50反1台新05購03,0,0,0,0,0,0,0,0,0,-10000,0,0,0,90000,100000,-10000,-10000
052300,力成台新95購01  ,0,0,0,0,0,0,0,0,0,-10000,0,0,0,0,10000,-10000,-10000
052096,力成元大95購01  ,0,0,0,0,0,0,0,0,0,-10000,0,0,0,2000,12000,-10000,-10000
052116,T50反1國票97購01,0,0,0,0,0,0,0,0,0,-10000,0,0,0,0,10000,-10000,-10000
052119,漢唐國票96購01  ,0,0,0,0,0,0,0,0,0,-10000,0,0,0,0,10000,-10000,-10000
052073,矽力統一95購03  ,0,0,0,0,0,0,0,0,0,-10000,0,0,0,0,10000,-10000,-10000
052031,臺股指群益95購04,0,0,0,0,0,0,0,0,0,-10000,0,0,0,0,10000,-10000,-10000
051932,康控國票96購02  ,0,0,0,0,0,0,0,0,0,-10000,0,0,0,0,10000,-10000,-10000
051945,智邦統一95購03  ,0,0,0,0,0,0,0,0,0,-10000,0,0,0,0,10000,-10000,-10000
051810,欣興凱基95購03  ,0,0,0,0,0,0,0,0,0,-10000,0,0,0,0,10000,-10000,-10000
051835,百和元大95購03  ,0,0,0,0,0,0,0,0,0,-10000,0,0,0,30000,40000,-10000,-10000
053835,南亞科永豐96購02,0,0,0,0,0,0,0,0,0,-10000,0,0,0,0,10000,-10000,-10000
053797,台積電中信98購01,5000,0,5000,0,0,0,0,0,0,-15000,0,0,0,20000,35000,-15000,-10000
053721,國泰金凱基97購01,0,0,0,0,0,0,0,0,0,-10000,0,0,0,0,10000,-10000,-10000
053567,群創富邦97購01  ,0,0,0,0,0,0,0,0,0,-10000,0,0,0,10000,20000,-10000,-10000
053571,奇鋐統一96購02  ,0,0,0,0,0,0,0,0,0,-10000,0,0,0,0,10000,-10000,-10000
053681,臺股指富邦96購02,0,0,0,0,0,0,0,0,0,-10000,0,0,0,20000,30000,-10000,-10000
053691,聯發科元大96購16,0,0,0,0,0,0,0,0,0,-10000,0,0,0,17000,27000,-10000,-10000
053623,臺股指群益96購09,0,0,0,0,0,0,0,0,0,-10000,0,0,0,0,10000,-10000,-10000
053214,冠德凱基96購02  ,0,0,0,0,0,0,0,0,0,-10000,0,0,0,0,10000,-10000,-10000
05325P,臺股指凱基95售09,0,0,0,0,0,0,0,0,0,-10000,0,0,0,0,10000,-10000,-10000
053312,緯穎凱基96購02  ,0,0,0,0,0,0,0,0,0,-10000,0,0,0,0,10000,-10000,-10000
053364,友達國泰98購01  ,0,0,0,0,0,0,0,0,0,-10000,0,0,0,0,10000,-10000,-10000
05349P,可成元富98售03  ,0,0,0,0,0,0,0,0,0,-10000,0,0,0,0,10000,-10000,-10000
053500,新日興兆豐97購01,0,0,0,0,0,0,0,0,0,-10000,0,0,0,0,10000,-10000,-10000
05350P,可成元富98售04  ,0,0,0,0,0,0,0,0,0,-10000,0,0,0,0,10000,-10000,-10000
053529,國巨麥證96購01  ,0,0,0,13000,22000,-9000,0,0,0,-10000,0,0,0,25000,35000,-10000,-10000
053525,台積電中信96購04,0,0,0,0,0,0,0,0,0,-10000,0,0,0,0,10000,-10000,-10000
054224,亞光統一98購01  ,0,0,0,0,0,0,0,0,0,-10000,0,0,0,0,10000,-10000,-10000
05426P,聯發科凱基95售12,0,0,0,0,0,0,0,0,0,-10000,0,0,0,10000,20000,-10000,-10000
054391,宏達電元富96購04,0,0,0,0,0,0,0,0,0,-10000,0,0,0,0,10000,-10000,-10000
054387,台積電統一98購02,0,0,0,0,0,0,0,0,0,-10000,0,0,0,0,10000,-10000,-10000
054469,同欣電凱基97購01,0,0,0,0,0,0,0,0,0,-10000,0,0,0,0,10000,-10000,-10000
054168,貿聯凱基97購02  ,0,0,0,0,0,0,0,0,0,-10000,0,0,0,0,10000,-10000,-10000
054173,奇力新台新97購02,0,0,0,0,0,0,0,0,0,-10000,0,0,0,10000,20000,-10000,-10000
054149,達方元大96購01  ,0,0,0,0,0,0,0,0,0,-10000,0,0,0,0,10000,-10000,-10000
054096,佳世達國票97購01,0,0,0,0,0,0,0,0,0,-10000,0,0,0,57000,67000,-10000,-10000
054018,華新台新96購01  ,0,0,0,0,0,0,0,0,0,-10000,0,0,0,0,10000,-10000,-10000
053885,全新兆豐96購01  ,0,0,0,0,0,0,0,0,0,-10000,0,0,0,10000,20000,-10000,-10000
053882,聯發科中信98購02,0,0,0,0,0,0,0,0,0,-10000,0,0,0,0,10000,-10000,-10000
6281,全國電          ,16000,26000,-10000,0,0,0,0,0,0,0,0,0,0,0,0,0,-10000
6405,悅城            ,0,10000,-10000,0,0,0,0,0,0,0,0,0,0,0,0,0,-10000
6024,群益期          ,7000,17000,-10000,0,0,0,0,0,0,0,0,0,0,0,0,0,-10000
9919,康那香          ,25000,35000,-10000,0,0,0,0,0,0,0,0,0,0,0,0,0,-10000
9911,櫻花            ,111000,121000,-10000,0,0,0,0,0,0,0,0,0,0,0,0,0,-10000
9943,好樂迪          ,21000,31000,-10000,0,0,0,0,0,0,0,0,0,0,0,0,0,-10000
1423,利華            ,0,10000,-10000,0,0,0,0,0,0,0,0,0,0,0,0,0,-10000
1587,吉茂            ,2000,12000,-10000,0,0,0,0,0,0,0,0,0,0,0,0,0,-10000
1524,耿鼎            ,4000,14000,-10000,0,0,0,0,0,0,0,0,0,0,0,0,0,-10000
1530,亞崴            ,4000,14000,-10000,0,0,0,0,0,0,0,0,0,0,0,0,0,-10000
1531,高林股          ,7000,17000,-10000,0,0,0,0,0,0,0,0,0,0,0,0,0,-10000
1466,聚隆            ,0,10000,-10000,0,0,0,0,0,0,0,0,0,0,0,0,0,-10000
06388P,鴻海兆豐97售04  ,0,0,0,0,0,0,0,0,0,-10000,0,0,0,5000,15000,-10000,-10000
06398P,禾伸堂凱基97售02,0,0,0,0,0,0,0,0,0,-10000,0,0,0,0,10000,-10000,-10000
08422P,玉晶光群益02售03,0,0,0,0,0,0,0,0,0,-10000,0,0,0,0,10000,-10000,-10000
07480P,FBVIX凱基94售01 ,0,0,0,0,0,0,0,0,0,-10000,0,0,0,0,10000,-10000,-10000
06231P,台積電永豐97售05,0,0,0,0,0,0,0,0,0,-10000,0,0,0,10000,20000,-10000,-10000
06214P,國巨國票98售04  ,0,0,0,0,0,0,0,0,0,-10000,0,0,0,30000,40000,-10000,-10000
06204P,鴻海群益97售04  ,0,0,0,0,0,0,0,0,0,-10000,0,0,0,40000,50000,-10000,-10000
05996P,華新科群益96售03,0,0,0,0,0,0,0,0,0,-10000,0,0,0,0,10000,-10000,-10000
06051P,嘉聯益國票97售04,0,0,0,0,0,0,0,0,0,-10000,0,0,0,0,10000,-10000,-10000
06122P,亞光元大98售01  ,0,0,0,0,0,0,0,0,0,-10000,0,0,0,40000,50000,-10000,-10000
06082P,華通統一98售01  ,0,0,0,0,0,0,0,0,0,-10000,0,0,0,0,10000,-10000,-10000
06075P,智邦凱基97售02  ,0,0,0,0,0,0,0,0,0,-10000,0,0,0,0,10000,-10000,-10000
06163P,聯詠群益97售01  ,0,0,0,0,0,0,0,0,0,-10000,0,0,0,0,10000,-10000,-10000
06132P,正文元富97售01  ,0,0,0,0,0,0,0,0,0,-10000,0,0,0,0,10000,-10000,-10000
06130P,玉晶光元富97售07,0,0,0,0,0,0,0,0,0,-10000,0,0,0,0,10000,-10000,-10000
1713,國化            ,13000,23000,-10000,0,0,0,0,0,0,0,0,0,0,0,0,0,-10000
2491,吉祥全          ,2000,15000,-13000,0,0,0,0,0,0,3000,3000,0,3000,0,0,0,-10000
4190,佐登-KY         ,118000,408000,-290000,0,0,0,0,0,0,280000,56000,17000,39000,252000,11000,241000,-10000
4555,氣立            ,2000,12000,-10000,0,0,0,0,0,0,0,0,0,0,0,0,0,-10000
3229,晟鈦            ,0,10000,-10000,0,0,0,0,0,0,0,0,0,0,0,0,0,-10000
056321,創意群益98購02  ,0,0,0,0,0,0,0,0,0,-11000,0,0,0,10000,21000,-11000,-11000
056433,鴻海凱基98購09  ,0,0,0,0,0,0,0,0,0,-11000,0,0,0,62000,73000,-11000,-11000
056391,大立光富邦9C購01,0,0,0,0,0,0,0,0,0,-11000,0,0,0,0,11000,-11000,-11000
056178,嘉澤元富97購02  ,0,0,0,0,0,0,0,0,0,-11000,0,0,0,72000,83000,-11000,-11000
056239,宏達電群益98購01,0,0,0,0,0,0,0,0,0,-11000,0,0,0,0,11000,-11000,-11000
056006,義隆亞東97購01  ,0,0,0,0,0,0,0,0,0,-11000,0,0,0,60000,71000,-11000,-11000
055915,大立光凱基98購07,0,0,0,0,0,0,0,0,0,-11000,0,0,0,0,11000,-11000,-11000
056696,茂林群益98購02  ,0,0,0,0,0,0,0,0,0,-11000,0,0,0,9000,20000,-11000,-11000
055621,國巨國泰98購03  ,0,0,0,0,0,0,0,0,0,-11000,0,0,0,0,11000,-11000,-11000
055727,矽力元大97購02  ,0,0,0,0,0,0,0,0,0,-11000,0,0,0,2000,13000,-11000,-11000
055757,大成鋼群益99購01,0,0,0,0,0,0,0,0,0,-11000,0,0,0,0,11000,-11000,-11000
055293,晶相光元大97購01,0,0,0,0,0,0,0,0,0,-11000,0,0,0,71000,82000,-11000,-11000
055229,大毅國票97購02  ,0,0,0,0,0,0,0,0,0,-11000,0,0,0,60000,71000,-11000,-11000
054868,國泰金群益9A購01,0,0,0,0,0,0,0,0,0,-11000,0,0,0,0,11000,-11000,-11000
046722,智邦元大93購02  ,0,0,0,0,0,0,0,0,0,-11000,0,0,0,140000,151000,-11000,-11000
045863,健策統一92購01  ,0,0,0,0,0,0,0,0,0,-11000,0,0,0,0,11000,-11000,-11000
04586P,光罩永豐94售02  ,0,0,0,0,0,0,0,0,0,-11000,0,0,0,0,11000,-11000,-11000
046184,台光電凱基93購08,0,0,0,0,0,0,0,0,0,-11000,0,0,0,88000,99000,-11000,-11000
049507,和大凱基94購01  ,0,0,0,0,0,0,0,0,0,-11000,0,0,0,0,11000,-11000,-11000
047112,聯發科元大93購11,0,0,0,0,0,0,0,0,0,-11000,0,0,0,39000,50000,-11000,-11000
046915,禾伸堂台新93購01,0,0,0,0,0,0,0,0,0,-11000,0,0,0,0,11000,-11000,-11000
045228,泰鼎元大93購01  ,0,0,0,0,0,0,0,0,0,-11000,0,0,0,0,11000,-11000,-11000
043695,臻鼎兆豐92購01  ,0,0,0,0,0,0,0,0,0,-11000,0,0,0,10000,21000,-11000,-11000
04345P,景碩國泰94售02  ,0,0,0,0,0,0,0,0,0,-11000,0,0,0,5000,16000,-11000,-11000
03957P,創意統一94售02  ,0,0,0,0,0,0,0,0,0,-11000,0,0,0,0,11000,-11000,-11000
0052,富邦科技        ,4000,4000,0,0,0,0,0,0,0,-11000,0,0,0,100000,111000,-11000,-11000
01010T,京城樂富R1      ,0,0,0,0,0,0,0,0,0,-11000,0,11000,-11000,0,0,0,-11000
00733,富邦臺灣中小    ,0,0,0,0,0,0,0,0,0,-11000,0,0,0,200000,211000,-11000,-11000
041990,A50正2國票97購01,0,0,0,0,0,0,0,0,0,-11000,0,0,0,39000,50000,-11000,-11000
03799P,京元電元大94售01,0,0,0,0,0,0,0,0,0,-11000,0,0,0,80000,91000,-11000,-11000
04454P,大立光富邦98售02,0,0,0,0,0,0,0,0,0,-11000,0,0,0,28000,39000,-11000,-11000
048185,台郡群益93購04  ,0,0,0,0,0,0,0,0,0,-11000,0,0,0,46000,57000,-11000,-11000
048292,微星群益93購01  ,0,0,0,0,0,0,0,0,0,-11000,0,0,0,5000,16000,-11000,-11000
050150,國巨群益95購01  ,0,0,0,0,0,0,0,0,0,-11000,0,0,0,36000,47000,-11000,-11000
051137,聯詠永豐95購01  ,0,0,0,0,0,0,0,0,0,-11000,0,0,0,30000,41000,-11000,-11000
04859P,台達電群益94售04,0,0,0,0,0,0,0,0,0,-11000,0,0,0,0,11000,-11000,-11000
051507,彩晶元富95購01  ,0,0,0,0,0,0,0,0,0,-11000,0,0,0,14000,25000,-11000,-11000
051409,美律國票96購01  ,0,0,0,0,0,0,0,0,0,-11000,0,0,0,52000,63000,-11000,-11000
05063P,聯電元大96售03  ,0,0,0,0,0,0,0,0,0,-11000,0,0,0,0,11000,-11000,-11000
050046,矽力兆豐94購01  ,0,0,0,0,0,0,0,0,0,-11000,0,0,0,0,11000,-11000,-11000
051061,中磊群益95購01  ,0,0,0,0,0,0,0,0,0,-11000,0,0,0,5000,16000,-11000,-11000
049108,玉晶光富邦96購02,0,0,0,0,0,0,0,0,0,-11000,0,0,0,19000,30000,-11000,-11000
054137,聯詠元大97購02  ,0,0,0,0,0,0,0,0,0,-11000,0,0,0,228000,239000,-11000,-11000
054278,晶技群益97購02  ,0,0,0,0,0,0,0,0,0,-11000,0,0,0,0,11000,-11000,-11000
05333P,臺股指國票95售02,0,0,0,0,0,0,0,0,0,-11000,0,0,0,0,11000,-11000,-11000
051803,矽創永豐95購03  ,0,0,0,0,0,0,0,0,0,-11000,0,0,0,68000,79000,-11000,-11000
052029,矽力群益95購02  ,0,0,0,0,0,0,0,0,0,-11000,0,0,0,24000,35000,-11000,-11000
052280,聯發科凱基95購11,0,0,0,0,0,0,0,0,0,-11000,0,0,0,31000,42000,-11000,-11000
052378,矽力元大96購01  ,0,0,0,0,0,0,0,0,0,-11000,0,0,0,5000,16000,-11000,-11000
052734,台表科國泰98購02,0,0,0,0,0,0,0,0,0,-11000,0,0,0,1000,12000,-11000,-11000
05288P,寶成元富95售02  ,0,0,0,0,0,0,0,0,0,-11000,0,0,0,0,11000,-11000,-11000
3040,遠見            ,0,11000,-11000,0,0,0,0,0,0,0,0,0,0,0,0,0,-11000
2739,寒舍            ,0,11000,-11000,0,0,0,0,0,0,0,0,0,0,0,0,0,-11000
2852,第一保          ,18000,29000,-11000,0,0,0,0,0,0,0,0,0,0,0,0,0,-11000
4148,全宇生技-KY     ,2000,13000,-11000,0,0,0,0,0,0,0,0,0,0,0,0,0,-11000
2438,翔耀            ,0,11000,-11000,0,0,0,0,0,0,0,0,0,0,0,0,0,-11000
06079P,燿華群益98售02  ,0,0,0,0,0,0,0,0,0,-11000,0,0,0,36000,47000,-11000,-11000
06010P,國泰金元富96售01,0,0,0,0,0,0,0,0,0,-11000,0,0,0,9000,20000,-11000,-11000
06332P,世紀鋼群益98售01,0,0,0,0,0,0,0,0,0,-11000,0,0,0,0,11000,-11000,-11000
1443,立益            ,0,7000,-7000,0,0,0,0,0,0,-4000,1000,5000,-4000,0,0,0,-11000
6671,三能-KY         ,2000,13000,-11000,0,0,0,0,0,0,0,0,0,0,0,0,0,-11000
054628,可成凱基98購01  ,0,0,0,0,0,0,0,0,0,-12000,0,0,0,15000,27000,-12000,-12000
055390,國巨統一98購03  ,0,0,0,0,0,0,0,0,0,-12000,0,0,0,48000,60000,-12000,-12000
055692,緯穎凱基97購03  ,0,0,0,0,0,0,0,0,0,-12000,0,0,0,0,12000,-12000,-12000
055625,亞光富邦98購01  ,0,0,0,0,0,0,0,0,0,-12000,0,0,0,0,12000,-12000,-12000
055473,禾伸堂凱基97購01,0,0,0,0,0,0,0,0,0,-12000,0,0,0,4000,16000,-12000,-12000
056788,日月光群益98購01,0,0,0,0,0,0,0,0,0,-12000,0,0,0,0,12000,-12000,-12000
05796P,臺股指群益96售10,0,0,0,0,0,0,0,0,0,-12000,0,0,0,6000,18000,-12000,-12000
05731P,創意統一96售03  ,0,0,0,0,0,0,0,0,0,-12000,0,0,0,0,12000,-12000,-12000
056041,禾伸堂凱基98購03,0,0,0,0,0,0,0,0,0,-12000,0,0,0,0,12000,-12000,-12000
056110,嘉聯益永豐97購02,0,0,0,0,0,0,0,0,0,-12000,0,0,0,102000,114000,-12000,-12000
056193,聯發科富邦99購08,0,0,0,0,0,0,0,0,0,-12000,0,0,0,158000,170000,-12000,-12000
056411,緯穎國票99購01  ,0,0,0,0,0,0,0,0,0,-12000,0,0,0,3000,15000,-12000,-12000
044784,華邦電中信96購01,0,0,0,0,0,0,0,0,0,-12000,0,0,0,20000,32000,-12000,-12000
04343P,啟碁永豐93售02  ,0,0,0,0,0,0,0,0,0,-12000,0,0,0,0,12000,-12000,-12000
04418P,燿華永豐94售01  ,0,0,0,0,0,0,0,0,0,-12000,0,0,0,0,12000,-12000,-12000
047614,台郡群益93購02  ,0,0,0,0,0,0,0,0,0,-12000,0,0,0,48000,60000,-12000,-12000
047484,聯詠凱基93購03  ,0,0,0,0,0,0,0,0,0,-12000,0,0,0,0,12000,-12000,-12000
042929,台積電中信95購02,0,0,0,0,0,0,0,0,0,-12000,0,0,0,10000,22000,-12000,-12000
042805,智邦統一93購01  ,0,0,0,0,0,0,0,0,0,-12000,0,0,0,0,12000,-12000,-12000
047250,日月光群益94購01,0,0,0,0,0,0,0,0,0,-12000,0,0,0,101000,113000,-12000,-12000
048566,上海銀元大93購04,0,0,0,0,0,0,0,0,0,-12000,0,0,0,93000,105000,-12000,-12000
047004,台積電統一99購01,0,0,0,0,0,0,0,0,0,-12000,0,0,0,42000,54000,-12000,-12000
05065P,燿華元大96售03  ,0,0,0,0,0,0,0,0,0,-12000,0,0,0,0,12000,-12000,-12000
051684,瑞昱凱基95購02  ,0,0,0,0,0,0,0,0,0,-12000,0,0,0,59000,71000,-12000,-12000
050998,訊連元大95購01  ,0,0,0,0,0,0,0,0,0,-12000,0,0,0,41000,53000,-12000,-12000
049590,華新科元大94購01,0,0,0,0,0,0,0,0,0,-12000,0,0,0,9000,21000,-12000,-12000
048206,臺股指元大93購40,0,0,0,0,0,0,0,0,0,-12000,0,0,0,0,12000,-12000,-12000
05124P,華新科富邦97售02,0,0,0,0,0,0,0,0,0,-12000,0,0,0,0,12000,-12000,-12000
049780,智易統一94購02  ,0,0,0,0,0,0,0,0,0,-12000,0,0,0,127000,139000,-12000,-12000
049299,矽創群益94購01  ,0,0,0,0,0,0,0,0,0,-12000,0,0,0,0,12000,-12000,-12000
052276,力成群益96購01  ,0,0,0,0,0,0,0,0,0,-12000,0,0,0,41000,53000,-12000,-12000
052060,旺宏國票96購02  ,0,0,0,0,0,0,0,0,0,-12000,0,0,0,0,12000,-12000,-12000
053808,大成鋼群益97購01,0,0,0,0,0,0,0,0,0,-12000,0,0,0,0,12000,-12000,-12000
054189,貿聯永豐96購03  ,0,0,0,0,0,0,0,0,0,-12000,0,0,0,0,12000,-12000,-12000
8072,陞泰            ,0,12000,-12000,0,0,0,0,0,0,0,0,0,0,0,0,0,-12000
5515,建國            ,11000,23000,-12000,0,0,0,0,0,0,0,0,0,0,0,0,0,-12000
5284,jpp-KY          ,3000,15000,-12000,0,0,0,0,0,0,0,0,0,0,0,0,0,-12000
6216,居易            ,6000,18000,-12000,0,0,0,0,0,0,0,0,0,0,0,0,0,-12000
9931,欣高            ,2000,14000,-12000,0,0,0,0,0,0,0,0,0,0,0,0,0,-12000
8466,美吉吉-KY       ,2000,14000,-12000,0,0,0,0,0,0,0,0,0,0,0,0,0,-12000
1441,大東            ,8000,20000,-12000,0,0,0,0,0,0,0,0,0,0,0,0,0,-12000
1525,江申            ,0,11000,-11000,0,0,0,0,1000,-1000,0,0,0,0,0,0,0,-12000
1110,東泥            ,0,12000,-12000,0,0,0,0,0,0,0,0,0,0,0,0,0,-12000
06031P,新光金兆豐96售02,0,0,0,0,0,0,0,0,0,-12000,0,0,0,0,12000,-12000,-12000
2017,官田鋼          ,23000,35000,-12000,0,0,0,0,0,0,0,0,0,0,0,0,0,-12000
4956,光鋐            ,31000,42000,-11000,0,0,0,0,0,0,-1000,0,1000,-1000,0,0,0,-12000
3356,奇偶            ,13000,25000,-12000,0,0,0,0,0,0,0,0,0,0,0,0,0,-12000
2838,聯邦銀          ,409000,421000,-12000,0,0,0,0,0,0,0,0,0,0,0,0,0,-12000
056354,國巨元大98購10  ,0,0,0,0,0,0,0,0,0,-13000,0,0,0,89000,102000,-13000,-13000
05599P,欣興台新96售01  ,0,0,0,0,0,0,0,0,0,-13000,0,0,0,0,13000,-13000,-13000
055820,矽力國票98購02  ,0,0,0,0,0,0,0,0,0,-13000,0,0,0,13000,26000,-13000,-13000
056669,貿聯國票99購01  ,0,0,0,0,0,0,0,0,0,-13000,0,0,0,53000,66000,-13000,-13000
056532,技嘉凱基98購01  ,0,0,0,0,0,0,0,0,0,-13000,0,0,0,0,13000,-13000,-13000
055465,和大凱基97購03  ,0,0,0,0,0,0,0,0,0,-13000,0,0,0,30000,43000,-13000,-13000
055320,建準國票98購01  ,0,0,0,0,0,0,0,0,0,-13000,0,0,0,0,13000,-13000,-13000
055285,華新科元大99購03,0,0,0,0,0,0,0,0,0,-13000,0,0,0,44000,57000,-13000,-13000
054574,美律元大99購01  ,0,0,0,0,0,0,0,0,0,-13000,0,0,0,186000,199000,-13000,-13000
054744,晶相光凱基99購01,0,0,0,0,0,0,0,0,0,-13000,0,0,0,15000,28000,-13000,-13000
050447,廣達元大94購01  ,0,0,0,0,0,0,0,0,0,-13000,0,0,0,37000,50000,-13000,-13000
045955,宏碁凱基93購01  ,0,0,0,0,0,0,0,0,0,-13000,0,0,0,0,13000,-13000,-13000
045658,儒鴻國泰93購01  ,0,0,0,0,0,0,0,0,0,-13000,0,0,0,2000,15000,-13000,-13000
047524,瑞昱元大93購10  ,0,0,0,0,0,0,0,0,0,-13000,0,0,0,57000,70000,-13000,-13000
04177P,富邦金元大94售01,0,0,0,0,0,0,0,0,0,-13000,0,0,0,0,13000,-13000,-13000
04052P,上銀國泰94售01  ,0,0,0,0,0,0,0,0,0,-13000,0,0,0,0,13000,-13000,-13000
048768,景碩凱基94購02  ,0,0,0,0,0,0,0,0,0,-13000,0,0,0,7000,20000,-13000,-13000
051245,南亞科元大95購01,0,0,0,0,0,0,0,0,0,-13000,0,0,0,5000,18000,-13000,-13000
048217,亞德客凱基93購06,0,0,0,0,0,0,0,0,0,-13000,0,0,0,17000,30000,-13000,-13000
049719,義隆凱基94購03  ,0,0,0,0,0,0,0,0,0,-13000,0,0,0,105000,118000,-13000,-13000
049654,臺股指凱基94購15,0,0,0,0,0,0,0,0,0,-13000,0,0,0,3000,16000,-13000,-13000
050919,台積電凱基95購03,0,0,0,0,0,0,0,0,0,-13000,0,0,0,0,13000,-13000,-13000
05145P,道瓊反元大98售01,0,0,0,0,0,0,0,0,0,-13000,0,0,0,0,13000,-13000,-13000
048001,中工元大96購01  ,0,0,0,0,0,0,0,0,0,-13000,0,0,0,16000,29000,-13000,-13000
048995,宏全元大94購01  ,0,0,0,0,0,0,0,0,0,-13000,0,0,0,85000,98000,-13000,-13000
054233,聯發科群益96購04,0,0,0,0,0,0,0,0,0,-13000,0,0,0,10000,23000,-13000,-13000
054441,力成台新96購01  ,0,0,0,0,0,0,0,0,0,-13000,0,0,0,28000,41000,-13000,-13000
05445P,聯詠元大95售05  ,0,0,0,0,0,0,0,0,0,-13000,0,0,0,0,13000,-13000,-13000
054360,智邦凱基96購03  ,0,0,0,0,0,0,0,0,0,-13000,0,0,0,7000,20000,-13000,-13000
053810,台達電群益96購01,0,0,0,0,0,0,0,0,0,-13000,0,0,0,10000,23000,-13000,-13000
053276,友達元大9C購01  ,0,0,0,0,0,0,0,0,0,-13000,0,0,0,22000,35000,-13000,-13000
053484,國巨國票97購03  ,0,0,0,0,0,0,0,0,0,-13000,0,0,0,9000,22000,-13000,-13000
053421,南亞科永豐96購01,0,0,0,0,0,0,0,0,0,-13000,0,0,0,20000,33000,-13000,-13000
051858,上銀凱基95購01  ,0,0,0,0,0,0,0,0,0,-13000,0,0,0,109000,122000,-13000,-13000
052241,台郡國票96購01  ,0,0,0,0,0,0,0,0,0,-13000,0,0,0,40000,53000,-13000,-13000
2888A,新光金甲特      ,0,13000,-13000,0,0,0,0,0,0,0,0,0,0,0,0,0,-13000
2616,山隆            ,17000,30000,-13000,0,0,0,0,0,0,0,0,0,0,0,0,0,-13000
3346,麗清            ,32000,45000,-13000,0,0,0,0,0,0,0,0,0,0,0,0,0,-13000
06024P,台郡國票97售05  ,0,0,0,0,0,0,0,0,0,-13000,0,0,0,0,13000,-13000,-13000
1436,華友聯          ,14000,27000,-13000,0,0,0,0,0,0,0,0,0,0,0,0,0,-13000
8422,可寧衛          ,11000,32000,-21000,0,0,0,8000,0,8000,0,0,0,0,0,0,0,-13000
6172,互億            ,0,13000,-13000,0,0,0,0,0,0,0,0,0,0,0,0,0,-13000
05517P,臻鼎元大96售01  ,0,0,0,0,0,0,0,0,0,-14000,0,0,0,6000,20000,-14000,-14000
055339,緯穎兆豐98購01  ,0,0,0,0,0,0,0,0,0,-14000,0,0,0,12000,26000,-14000,-14000
055468,智邦凱基97購04  ,0,0,0,0,0,0,0,0,0,-14000,0,0,0,5000,19000,-14000,-14000
055486,國巨元大98購06  ,0,0,0,0,0,0,0,0,0,-14000,0,0,0,75000,89000,-14000,-14000
055493,華新科元大97購09,0,0,0,0,0,0,0,0,0,-14000,0,0,0,13000,27000,-14000,-14000
056502,A50正2永豐98購01,0,0,0,0,0,0,0,0,0,-14000,0,0,0,40000,54000,-14000,-14000
056781,元油2X群益9B購02,0,0,0,0,0,0,0,0,0,-14000,0,0,0,0,14000,-14000,-14000
05668P,滬深2X永豐96售04,0,0,0,0,0,0,0,0,0,-14000,0,0,0,10000,24000,-14000,-14000
05961P,鴻海群益97售01  ,0,0,0,0,0,0,0,0,0,-14000,0,0,0,0,14000,-14000,-14000
055832,台達電元大97購02,0,0,0,0,0,0,0,0,0,-14000,0,0,0,81000,95000,-14000,-14000
056392,玉晶光富邦9C購01,0,0,0,0,0,0,0,0,0,-14000,0,0,0,0,14000,-14000,-14000
056401,國巨群益98購07  ,0,0,0,0,0,0,0,0,0,-14000,0,0,0,0,14000,-14000,-14000
04120P,智邦凱基93售09  ,0,0,0,0,0,0,0,0,0,-14000,0,0,0,6000,20000,-14000,-14000
046501,友達元大92購05  ,0,0,0,0,0,0,0,0,0,-14000,0,0,0,0,14000,-14000,-14000
042953,鴻海台新01購01  ,0,0,0,0,0,0,0,0,0,-14000,0,0,0,0,14000,-14000,-14000
04322P,可成元大94售01  ,0,0,0,0,0,0,0,0,0,-14000,0,0,0,1000,15000,-14000,-14000
043442,大立光台新01購01,0,0,0,0,0,0,0,0,0,-14000,0,0,0,0,14000,-14000,-14000
045850,嘉澤永豐92購01  ,0,0,0,0,0,0,0,0,0,-14000,0,0,0,36000,50000,-14000,-14000
046947,禾伸堂元大93購01,0,0,0,0,0,0,0,0,0,-14000,0,0,0,3000,17000,-14000,-14000
051381,玉晶光群益98購01,0,0,0,0,0,0,0,0,0,-14000,0,0,0,33000,47000,-14000,-14000
049591,開發金元大98購01,0,0,0,0,0,0,0,0,0,-14000,0,0,0,1000,15000,-14000,-14000
050188,貿聯元大96購01  ,0,0,0,0,0,0,0,0,0,-14000,0,0,0,5000,19000,-14000,-14000
048223,微星凱基93購02  ,0,0,0,0,0,0,0,0,0,-14000,0,0,0,0,14000,-14000,-14000
049260,華新科元大96購01,0,0,0,0,0,0,0,0,0,-14000,0,0,0,12000,26000,-14000,-14000
052250,光磊永豐95購01  ,0,0,0,0,0,0,0,0,0,-14000,0,0,0,100000,114000,-14000,-14000
052319,可成元大95購12  ,0,0,0,0,0,0,0,0,0,-14000,0,0,0,196000,210000,-14000,-14000
052464,大立光統一95購05,0,0,0,0,0,0,0,0,0,-14000,0,0,0,0,14000,-14000,-14000
051823,矽力元富95購02  ,0,0,0,0,0,0,0,0,0,-14000,0,0,0,10000,24000,-14000,-14000
053693,欣興元大96購05  ,0,0,0,0,0,0,0,0,0,-14000,0,0,0,5000,19000,-14000,-14000
6641,基士德-KY       ,0,14000,-14000,0,0,0,0,0,0,0,0,0,0,0,0,0,-14000
6442,光聖            ,0,14000,-14000,0,0,0,0,0,0,0,0,0,0,0,0,0,-14000
1439,中和            ,9000,23000,-14000,0,0,0,0,0,0,0,0,0,0,0,0,0,-14000
1413,宏洲            ,0,14000,-14000,0,0,0,0,0,0,0,0,0,0,0,0,0,-14000
06425P,TPK永豐97售02   ,0,0,0,0,0,0,0,0,0,-14000,0,0,0,0,14000,-14000,-14000
06389P,聯發科兆豐97售01,0,0,0,0,0,0,0,0,0,-14000,0,0,0,0,14000,-14000,-14000
06052P,台郡國票97售06  ,0,0,0,0,0,0,0,0,0,-14000,0,0,0,0,14000,-14000,-14000
06280P,臺股指凱基97售12,0,0,0,0,0,0,0,0,0,-14000,0,0,0,85000,99000,-14000,-14000
4912,聯德控股-KY     ,3000,16000,-13000,0,0,0,0,0,0,-1000,0,1000,-1000,0,0,0,-14000
3058,立德            ,2000,16000,-14000,0,0,0,0,0,0,0,0,0,0,0,0,0,-14000
3130,一零四          ,2000,16000,-14000,0,0,0,0,0,0,0,0,0,0,0,0,0,-14000
1720,生達            ,22000,36000,-14000,0,0,0,0,0,0,0,0,0,0,0,0,0,-14000
1733,五鼎            ,24000,41000,-17000,0,0,0,0,0,0,3000,3000,0,3000,0,0,0,-14000
2430,燦坤            ,7000,21000,-14000,0,0,0,0,0,0,0,0,0,0,0,0,0,-14000
4934,太極            ,162001,177000,-14999,0,0,0,0,0,0,0,0,0,0,0,0,0,-14999
056443,南亞科凱基98購03,0,0,0,0,0,0,0,0,0,-15000,0,0,0,0,15000,-15000,-15000
056326,TPK兆豐98購01   ,0,0,0,0,0,0,0,0,0,-15000,0,0,0,0,15000,-15000,-15000
056226,聯發科凱基97購10,0,0,0,0,0,0,0,0,0,-15000,0,0,0,0,15000,-15000,-15000
055969,彩晶元大99購02  ,0,0,0,0,0,0,0,0,0,-15000,0,0,0,0,15000,-15000,-15000
056094,大立光元富97購03,0,0,0,0,0,0,0,0,0,-15000,0,0,0,5000,20000,-15000,-15000
056829,台積電富邦9A購01,0,0,0,0,0,0,0,0,0,-15000,0,0,0,0,15000,-15000,-15000
05686P,臺股指元大96售11,0,0,0,0,0,0,0,0,0,-15000,0,0,0,20000,35000,-15000,-15000
05783P,嘉澤元富96售01  ,0,0,0,0,0,0,0,0,0,-15000,0,0,0,0,15000,-15000,-15000
056654,元油2X元大98購02,0,0,0,0,0,0,0,0,0,-15000,0,0,0,5000,20000,-15000,-15000
055610,光磊國票98購01  ,0,0,0,0,0,0,0,0,0,-15000,0,0,0,30000,45000,-15000,-15000
05556P,全新國票96售04  ,0,0,0,0,0,0,0,0,0,-15000,0,0,0,0,15000,-15000,-15000
055743,TPK元富98購01   ,0,0,0,0,0,0,0,0,0,-15000,0,0,0,0,15000,-15000,-15000
055368,台積電元大97購24,0,0,0,0,0,0,0,0,0,-15000,0,0,0,393000,408000,-15000,-15000
055223,和大國票98購01  ,0,0,0,0,0,0,0,0,0,-15000,0,0,0,0,15000,-15000,-15000
054681,味全永豐97購01  ,0,0,0,0,0,0,0,0,0,-15000,0,0,0,0,15000,-15000,-15000
055063,玉晶光永豐99購01,0,0,0,0,0,0,0,0,0,-15000,0,0,0,5000,20000,-15000,-15000
047427,貿聯亞東93購01  ,0,0,0,0,0,0,0,0,0,-15000,0,0,0,0,15000,-15000,-15000
047358,儒鴻群益93購02  ,0,0,0,0,0,0,0,0,0,-15000,0,0,0,0,15000,-15000,-15000
04785P,鴻海永豐94售03  ,0,0,0,0,0,0,0,0,0,-15000,0,0,0,105000,120000,-15000,-15000
047066,力成凱基93購04  ,0,0,0,0,0,0,0,0,0,-15000,0,0,0,5000,20000,-15000,-15000
04630P,嘉聯益元大95售02,0,0,0,0,0,0,0,0,0,-15000,0,0,0,100000,115000,-15000,-15000
04549P,茂林元大94售02  ,0,0,0,0,0,0,0,0,0,-15000,0,0,0,0,15000,-15000,-15000
04387P,玉晶光日盛94售01,0,0,0,0,0,0,0,0,0,-15000,0,0,0,0,15000,-15000,-15000
04408P,台積電統一94售06,0,0,0,0,0,0,0,0,0,-15000,0,0,0,0,15000,-15000,-15000
00690,兆豐藍籌30      ,0,0,0,0,0,0,0,0,0,-15000,0,0,0,156000,171000,-15000,-15000
04162P,南亞科統一94售02,0,0,0,0,0,0,0,0,0,-15000,0,0,0,21000,36000,-15000,-15000
044688,傳奇凱基93購01  ,0,0,0,0,0,0,0,0,0,-15000,0,0,0,0,15000,-15000,-15000
03298P,台積電統一03售15,0,0,0,0,0,0,0,0,0,-15000,0,0,0,0,15000,-15000,-15000
049438,嘉晶國泰96購01  ,0,0,0,0,0,0,0,0,0,-15000,0,0,0,0,15000,-15000,-15000
048788,華新科元大95購02,0,0,0,0,0,0,0,0,0,-15000,0,0,0,24000,39000,-15000,-15000
051226,英業達群益95購01,0,0,0,0,0,0,0,0,0,-15000,0,0,0,85000,100000,-15000,-15000
048287,嘉晶兆豐94購01  ,0,0,0,0,0,0,0,0,0,-15000,0,0,0,10000,25000,-15000,-15000
048339,友達元大95購01  ,0,0,0,0,0,0,0,0,0,-15000,0,0,0,5000,20000,-15000,-15000
048122,台達電元大96購02,0,0,0,0,0,0,0,0,0,-15000,0,0,0,0,15000,-15000,-15000
048436,聯茂日盛93購01  ,0,0,0,0,0,0,0,0,0,-15000,0,0,0,185000,200000,-15000,-15000
049038,高鐵兆豐94購01  ,0,0,0,0,0,0,0,0,0,-15000,0,0,0,0,15000,-15000,-15000
051459,臺股指元大95購19,0,0,0,0,0,0,0,0,0,-15000,0,0,0,0,15000,-15000,-15000
05147P,鴻海元大95售11  ,0,0,0,0,0,0,0,0,0,-15000,0,0,0,60000,75000,-15000,-15000
051618,智邦凱基95購06  ,0,0,0,0,0,0,0,0,0,-15000,0,0,0,7000,22000,-15000,-15000
051598,瑞昱兆豐95購01  ,0,0,0,0,0,0,0,0,0,-15000,0,0,0,0,15000,-15000,-15000
049140,台積電元大94購07,0,0,0,0,0,0,0,0,0,-15000,0,0,0,139000,154000,-15000,-15000
050211,貿聯國票95購01  ,0,0,0,0,0,0,0,0,0,-15000,0,0,0,0,15000,-15000,-15000
050116,嘉澤元大94購03  ,0,0,0,0,0,0,0,0,0,-15000,0,0,0,15000,30000,-15000,-15000
05106P,鴻海永豐95售02  ,0,0,0,0,0,0,0,0,0,-15000,0,0,0,18000,33000,-15000,-15000
051078,力山富邦97購01  ,0,0,0,0,0,0,0,0,0,-15000,0,0,0,0,15000,-15000,-15000
051087,國巨元大97購01  ,0,0,0,0,0,0,0,0,0,-15000,0,0,0,0,15000,-15000,-15000
049943,聯詠第一94購01  ,0,0,0,0,0,0,0,0,0,-15000,0,0,0,0,15000,-15000,-15000
049923,智原元大95購02  ,0,0,0,0,0,0,0,0,0,-15000,0,0,0,0,15000,-15000,-15000
053767,臻鼎富邦97購02  ,0,0,0,0,0,0,0,0,0,-15000,0,0,0,0,15000,-15000,-15000
053341,聯發科國票97購03,0,0,0,0,0,0,0,0,0,-15000,0,0,0,60000,75000,-15000,-15000
05444P,大立光元大95售10,0,0,0,0,0,0,0,0,0,-15000,0,0,0,5000,20000,-15000,-15000
054165,亞光凱基96購02  ,0,0,0,0,0,0,0,0,0,-15000,0,0,0,20000,35000,-15000,-15000
054046,義隆元大96購02  ,0,0,0,0,0,0,0,0,0,-15000,0,0,0,410000,425000,-15000,-15000
051780,矽力群益95購01  ,0,0,0,0,0,0,0,0,0,-15000,0,0,0,13000,28000,-15000,-15000
052383,臺股指元大95購29,7000,0,7000,0,0,0,0,0,0,-22000,0,0,0,0,22000,-22000,-15000
052905,潤泰全國票97購01,0,0,0,0,0,0,0,0,0,-15000,0,0,0,0,15000,-15000,-15000
052969,建準群益97購01  ,0,0,0,0,0,0,0,0,0,-15000,0,0,0,11000,26000,-15000,-15000
053036,聯電凱基98購01  ,0,0,0,0,0,0,0,0,0,-15000,0,0,0,80000,95000,-15000,-15000
053176,矽力群益96購02  ,0,0,0,0,0,0,0,0,0,-15000,0,0,0,13000,28000,-15000,-15000
053153,大立光元大99購02,0,0,0,0,0,0,0,0,0,-15000,0,0,0,57000,72000,-15000,-15000
05258P,臺股指凱基96售11,0,0,0,0,0,0,0,0,0,-15000,0,0,0,5000,20000,-15000,-15000
4545,銘鈺            ,6000,21000,-15000,0,0,0,0,0,0,0,0,0,0,0,0,0,-15000
4766,南寶            ,17000,32000,-15000,0,0,0,0,0,0,0,0,0,0,0,0,0,-15000
3416,融程電          ,7000,22000,-15000,0,0,0,0,0,0,0,0,0,0,0,0,0,-15000
3550,聯穎            ,0,15000,-15000,0,0,0,0,0,0,0,0,0,0,0,0,0,-15000
3055,蔚華科          ,24000,49000,-25000,0,0,0,0,0,0,10000,10000,0,10000,0,0,0,-15000
2630,亞航            ,0,16000,-16000,0,0,0,0,0,0,1000,1000,0,1000,0,0,0,-15000
2468,華經            ,3000,18000,-15000,0,0,0,0,0,0,0,0,0,0,0,0,0,-15000
06201P,可成元大97售01  ,0,0,0,0,0,0,0,0,0,-15000,0,0,0,0,15000,-15000,-15000
06160P,台達電群益97售01,0,0,0,0,0,0,0,0,0,-15000,0,0,0,43000,58000,-15000,-15000
06149P,台積電元大97售18,0,0,0,0,0,0,0,0,0,-15000,0,0,0,151000,166000,-15000,-15000
06101P,聯發科日盛97售03,0,0,0,0,0,0,0,0,0,-15000,0,0,0,10000,25000,-15000,-15000
06123P,玉晶光元大97售04,0,0,0,0,0,0,0,0,0,-15000,0,0,0,320000,335000,-15000,-15000
06523P,台積電麥證98售02,0,0,0,0,15000,-15000,0,0,0,-15000,0,0,0,0,15000,-15000,-15000
1414,東和            ,2000,17000,-15000,0,0,0,0,0,0,0,0,0,0,0,0,0,-15000
1445,大宇            ,0,15000,-15000,0,0,0,0,0,0,0,0,0,0,0,0,0,-15000
6206,飛捷            ,61000,76000,-15000,0,0,0,0,0,0,0,0,0,0,0,0,0,-15000
6197,佳必琪          ,22000,37000,-15000,0,0,0,0,0,0,0,0,0,0,0,0,0,-15000
054546,玉晶光中信9B購01,0,0,0,0,0,0,0,0,0,-16000,0,0,0,237000,253000,-16000,-16000
056519,創意國票99購01  ,0,0,0,0,0,0,0,0,0,-16000,0,0,0,4000,20000,-16000,-16000
05946P,和碩中信96售01  ,0,0,0,0,0,0,0,0,0,-16000,0,0,0,0,16000,-16000,-16000
05978P,麗豐永豐96售02  ,0,0,0,0,0,0,0,0,0,-16000,0,0,0,75000,91000,-16000,-16000
056083,億光統一97購03  ,0,0,0,0,0,0,0,0,0,-16000,0,0,0,65000,81000,-16000,-16000
056047,台積電兆豐97購02,0,0,0,0,0,0,0,0,0,-16000,0,0,0,0,16000,-16000,-16000
05626P,景碩國票97售03  ,0,0,0,0,0,0,0,0,0,-16000,0,0,0,0,16000,-16000,-16000
00710B,FH彭博高收益債  ,0,0,0,0,0,0,0,0,0,-16000,0,0,0,85000,101000,-16000,-16000
00851,台新全球AI      ,0,0,0,0,0,0,0,0,0,-16000,0,0,0,13000,29000,-16000,-16000
046286,高鐵兆豐93購01  ,0,0,0,0,0,0,0,0,0,-16000,0,0,0,4000,20000,-16000,-16000
045716,智邦凱基92購02  ,0,0,0,0,0,0,0,0,0,-16000,0,0,0,10000,26000,-16000,-16000
04853P,易華電永豐94售03,0,0,0,0,0,0,0,0,0,-16000,0,0,0,0,16000,-16000,-16000
050012,台積電國泰95購03,0,0,0,0,0,0,0,0,0,-16000,0,0,0,16000,32000,-16000,-16000
049828,華新科凱基94購06,0,0,0,0,0,0,0,0,0,-16000,0,0,0,6000,22000,-16000,-16000
051576,台積電元大97購02,0,0,0,0,0,0,0,0,0,-16000,0,0,0,60000,76000,-16000,-16000
05168P,鴻海元大95售14  ,0,0,0,0,0,0,0,0,0,-16000,0,0,0,60000,76000,-16000,-16000
051483,玉晶光凱基96購02,0,0,0,0,0,0,0,0,0,-16000,0,0,0,4000,20000,-16000,-16000
048839,牧德凱基95購01  ,0,0,0,0,0,0,0,0,0,-16000,0,0,0,0,16000,-16000,-16000
048677,智伸科國泰94購01,0,0,0,0,0,0,0,0,0,-16000,0,0,0,74000,90000,-16000,-16000
05108P,欣興中信95售02  ,0,0,0,0,0,0,0,0,0,-16000,0,0,0,20000,36000,-16000,-16000
052794,群創兆豐97購01  ,0,0,0,0,0,0,0,0,0,-16000,0,0,0,8000,24000,-16000,-16000
052947,晶技國票97購01  ,0,0,0,0,0,0,0,0,0,-16000,0,0,0,0,16000,-16000,-16000
05192P,玉晶光台新96售02,0,0,0,0,0,0,0,0,0,-16000,0,0,0,0,16000,-16000,-16000
053939,台表科元富96購03,0,0,0,0,0,0,0,0,0,-16000,0,0,0,0,16000,-16000,-16000
053194,緯穎統一99購01  ,0,0,0,0,0,0,0,0,0,-16000,0,0,0,24000,40000,-16000,-16000
053428,中磊永豐96購02  ,0,0,0,0,0,0,0,0,0,-16000,0,0,0,0,16000,-16000,-16000
1459,聯發            ,0,16000,-16000,0,0,0,0,0,0,0,0,0,0,0,0,0,-16000
1541,錩泰            ,0,16000,-16000,0,0,0,0,0,0,0,0,0,0,0,0,0,-16000
06309P,光罩元富97售03  ,0,0,0,0,0,0,0,0,0,-16000,0,0,0,0,16000,-16000,-16000
2535,達欣工          ,71000,87000,-16000,0,0,0,0,0,0,0,0,0,0,0,0,0,-16000
1616,億泰            ,0,16000,-16000,0,0,0,0,0,0,0,0,0,0,0,0,0,-16000
2901,欣欣            ,3000,19000,-16000,0,0,0,0,0,0,0,0,0,0,0,0,0,-16000
3593,力銘            ,0,16000,-16000,0,0,0,0,0,0,0,1000,1000,0,0,0,0,-16000
056414,國巨中信98購02  ,0,0,0,0,0,0,0,0,0,-17000,0,0,0,13000,30000,-17000,-17000
05603P,聯發科元大96售09,0,0,0,0,0,0,0,0,0,-17000,0,0,0,33000,50000,-17000,-17000
05605P,嘉聯益元大97售02,0,0,0,0,0,0,0,0,0,-17000,0,0,0,0,17000,-17000,-17000
055356,大立光凱基97購06,0,0,0,0,0,0,0,0,0,-17000,0,0,0,0,17000,-17000,-17000
055494,華新科元大98購01,0,0,0,0,0,0,0,0,0,-17000,0,0,0,19000,36000,-17000,-17000
050682,南亞科元富94購02,0,0,0,0,0,0,0,0,0,-17000,0,0,0,10000,27000,-17000,-17000
046804,群創元大94購01  ,0,0,0,0,0,0,0,0,0,-17000,0,0,0,119000,136000,-17000,-17000
04514P,元石油中信97售01,0,0,0,0,0,0,0,0,0,-17000,0,0,0,0,17000,-17000,-17000
045087,玉晶光元大95購01,0,0,0,0,0,0,0,0,0,-17000,0,0,0,10000,27000,-17000,-17000
050898,智原元大96購01  ,0,0,0,0,0,0,0,0,0,-17000,0,0,0,0,17000,-17000,-17000
050918,南亞科日盛95購01,0,0,0,0,0,0,0,0,0,-17000,0,0,0,13000,30000,-17000,-17000
048391,友訊國票94購01  ,0,0,0,0,0,0,0,0,0,-17000,0,0,0,0,17000,-17000,-17000
051242,台積電元大96購06,0,0,0,0,0,0,0,0,0,-17000,0,0,0,312000,329000,-17000,-17000
050236,旺宏凱基94購06  ,0,0,0,0,0,0,0,0,0,-17000,0,0,0,7000,24000,-17000,-17000
052011,欣興中信96購01  ,0,0,0,0,0,0,0,0,0,-17000,0,0,0,0,17000,-17000,-17000
052367,聯茂國票96購02  ,0,0,0,0,0,0,0,0,0,-17000,0,0,0,57000,74000,-17000,-17000
052490,禾伸堂國票95購01,0,0,0,0,0,0,0,0,0,-17000,0,0,0,37000,54000,-17000,-17000
05219P,鴻海元大95售17  ,0,0,0,0,0,0,0,0,0,-17000,0,0,0,317000,334000,-17000,-17000
052777,燿華國票98購01  ,0,0,0,0,0,0,0,0,0,-17000,0,0,0,25000,42000,-17000,-17000
3694,海華            ,7000,25000,-18000,0,0,0,0,0,0,1000,1000,0,1000,0,0,0,-17000
2032,新鋼            ,0,16000,-16000,0,0,0,0,0,0,-1000,0,1000,-1000,0,0,0,-17000
2239,英利-KY         ,7000,24000,-17000,0,0,0,0,0,0,0,0,0,0,0,0,0,-17000
06233P,訊芯永豐97售03  ,0,0,0,0,0,0,0,0,0,-17000,0,0,0,50000,67000,-17000,-17000
06038P,國泰金台新96售01,0,0,0,0,0,0,0,0,0,-17000,0,0,0,0,17000,-17000,-17000
06391P,上銀中信97售03  ,0,0,0,0,0,0,0,0,0,-17000,0,0,0,50000,67000,-17000,-17000
06433P,大立光群益99售01,0,0,0,0,0,0,0,0,0,-17000,0,0,0,25000,42000,-17000,-17000
6136,富爾特          ,2000,20000,-18000,0,0,0,0,0,0,1000,1000,0,1000,0,0,0,-17000
5533,皇鼎            ,6000,23000,-17000,0,0,0,0,0,0,0,0,0,0,0,0,0,-17000
6431,光麗-KY         ,0,17000,-17000,0,0,0,0,0,0,0,0,0,0,0,0,0,-17000
6655,科定            ,0,16000,-16000,0,0,0,0,0,0,-1000,0,1000,-1000,0,0,0,-17000
8201,無敵            ,6000,23000,-17000,0,0,0,0,0,0,0,0,0,0,0,0,0,-17000
8478,東哥遊艇        ,0,17000,-17000,0,0,0,0,0,0,0,1000,1000,0,0,0,0,-17000
9905,大華            ,14000,31000,-17000,0,0,0,0,0,0,0,0,0,0,0,0,0,-17000
055278,旺宏元大98購05  ,0,0,0,0,0,0,0,0,0,-18000,0,0,0,472000,490000,-18000,-18000
054635,台達電中信98購01,0,0,0,0,0,0,0,0,0,-18000,0,0,0,219000,237000,-18000,-18000
054722,傳奇永豐97購01  ,0,0,0,0,0,0,0,0,0,-18000,0,0,0,0,18000,-18000,-18000
056049,奇力新國票98購01,0,0,0,0,0,0,0,0,0,-18000,0,0,0,0,18000,-18000,-18000
05600P,玉晶光台新96售04,0,0,0,0,0,0,0,0,0,-18000,0,0,0,0,18000,-18000,-18000
05775P,台積電國泰98售02,0,0,0,0,0,0,0,0,0,-18000,0,0,0,22000,40000,-18000,-18000
056677,智伸科元富98購01,0,0,0,0,0,0,0,0,0,-18000,0,0,0,2000,20000,-18000,-18000
04310P,京元電統一93售03,0,0,0,0,0,0,0,0,0,-18000,0,0,0,0,18000,-18000,-18000
03904P,啟碁統一93售01  ,0,0,0,0,0,0,0,0,0,-18000,0,0,0,0,18000,-18000,-18000
04187P,麗豐元富93售02  ,0,0,0,0,0,0,0,0,0,-18000,0,0,0,1000,19000,-18000,-18000
04670P,臺股指國票94售09,0,0,0,0,0,0,0,0,0,-18000,0,0,0,462000,480000,-18000,-18000
04536P,長榮航統一94售01,0,0,0,0,0,0,0,0,0,-18000,0,0,0,5000,23000,-18000,-18000
04619P,華新統一94售02  ,0,0,0,0,0,0,0,0,0,-18000,0,0,0,0,18000,-18000,-18000
046081,康舒凱基92購01  ,0,0,0,0,0,0,0,0,0,-18000,0,0,0,82000,100000,-18000,-18000
050673,旺宏富邦96購02  ,0,0,0,0,0,0,0,0,0,-18000,0,0,0,24000,42000,-18000,-18000
050414,泰鼎永豐94購04  ,0,0,0,0,0,0,0,0,0,-18000,0,0,0,22000,40000,-18000,-18000
050378,上証2X群益98購02,0,0,0,0,0,0,0,0,0,-18000,0,0,0,0,18000,-18000,-18000
047151,台積電國票94購02,0,0,0,0,0,0,0,0,0,-18000,0,0,0,2000,20000,-18000,-18000
047046,台積電國票94購01,0,0,0,0,0,0,0,0,0,-18000,0,0,0,199000,217000,-18000,-18000
049449,宏碁統一94購01  ,0,0,0,0,0,0,0,0,0,-18000,0,0,0,32000,50000,-18000,-18000
051664,鴻海元大96購07  ,0,0,0,0,0,0,0,0,0,-18000,0,0,0,50000,68000,-18000,-18000
051179,臺股指凱基95購04,0,0,0,0,0,0,0,0,0,-18000,0,0,0,8000,26000,-18000,-18000
050997,麗豐元大95購03  ,0,0,0,0,0,0,0,0,0,-18000,0,0,0,150000,168000,-18000,-18000
048651,美利達元大96購05,0,0,0,0,0,0,0,0,0,-18000,0,0,0,50000,68000,-18000,-18000
048755,志超元富96購01  ,0,0,0,0,0,0,0,0,0,-18000,0,0,0,0,18000,-18000,-18000
052658,友達元富9C購01  ,0,0,0,0,0,0,0,0,0,-18000,0,0,0,2000,20000,-18000,-18000
052892,大成鋼群益96購01,0,0,0,0,0,0,0,0,0,-18000,0,0,0,0,18000,-18000,-18000
05248P,矽創群益96售01  ,0,0,0,0,0,0,0,0,0,-18000,0,0,0,0,18000,-18000,-18000
052459,道瓊反統一95購04,0,0,0,0,0,0,0,0,0,-18000,0,0,0,0,18000,-18000,-18000
052387,台積電群益95購08,0,0,0,0,0,0,0,0,0,-18000,0,0,0,220000,238000,-18000,-18000
052035,臺股指群益95購08,0,0,0,0,0,0,0,0,0,-18000,0,0,0,0,18000,-18000,-18000
051788,奇力新國票97購02,0,0,0,0,0,0,0,0,0,-18000,0,0,0,0,18000,-18000,-18000
053961,揚明光永豐96購04,0,0,0,0,0,0,0,0,0,-18000,0,0,0,54000,72000,-18000,-18000
054051,貿聯元大97購03  ,0,0,0,0,0,0,0,0,0,-18000,0,0,0,0,18000,-18000,-18000
054061,晶技國票97購03  ,0,0,0,0,0,0,0,0,0,-18000,0,0,0,0,18000,-18000,-18000
054171,台郡凱基97購01  ,0,0,0,0,0,0,0,0,0,-18000,0,0,0,5000,23000,-18000,-18000
054307,高鐵凱基98購01  ,0,0,0,0,0,0,0,0,0,-18000,0,0,0,2000,20000,-18000,-18000
9906,欣巴巴          ,0,18000,-18000,0,0,0,0,0,0,0,0,0,0,0,0,0,-18000
6224,聚鼎            ,42000,60000,-18000,0,0,0,0,0,0,0,0,0,0,0,0,0,-18000
06436P,台光電國票98售04,0,0,0,0,0,0,0,0,0,-18000,0,0,0,22000,40000,-18000,-18000
1529,樂士            ,0,28000,-28000,0,0,0,0,0,0,10000,10000,0,10000,0,0,0,-18000
06000P,GIS元大96售04   ,0,0,0,0,0,0,0,0,0,-18000,0,0,0,73000,91000,-18000,-18000
06234P,亞德客元大97售02,0,0,0,0,0,0,0,0,0,-18000,0,0,0,321000,339000,-18000,-18000
2115,六暉-KY         ,0,18000,-18000,0,0,0,0,0,0,0,1000,1000,0,0,0,0,-18000
1611,中電            ,10000,28000,-18000,0,0,0,0,0,0,0,0,0,0,0,0,0,-18000
05723P,華通永豐96售03  ,0,0,0,0,0,0,0,0,0,-19000,0,0,0,0,19000,-19000,-19000
05632P,大立光群益96售02,0,0,0,0,0,0,0,0,0,-19000,0,0,0,36000,55000,-19000,-19000
05470P,康控元大95售05  ,0,0,0,0,0,0,0,0,0,-19000,0,0,0,0,19000,-19000,-19000
054623,華新科第一97購01,0,0,0,0,0,0,0,0,0,-19000,0,0,0,171000,190000,-19000,-19000
054558,劍麟群益99購01  ,0,0,0,0,0,0,0,0,0,-19000,0,0,0,0,19000,-19000,-19000
05525P,奇力新群益96售02,0,0,0,0,0,0,0,0,0,-19000,0,0,0,1000,20000,-19000,-19000
047916,台積電凱基93購22,0,0,0,0,0,0,0,0,0,-19000,0,0,0,1000,20000,-19000,-19000
047117,禾伸堂元大93購02,0,0,0,0,0,0,0,0,0,-19000,0,0,0,3000,22000,-19000,-19000
04544P,欣興富邦96售02  ,0,0,0,0,0,0,0,0,0,-19000,0,0,0,20000,39000,-19000,-19000
046604,康控群益93購02  ,0,0,0,0,0,0,0,0,0,-19000,0,0,0,21000,40000,-19000,-19000
03415B,臺股指元大93熊49,0,0,0,0,0,0,0,0,0,-19000,0,0,0,91000,110000,-19000,-19000
047546,瑞昱凱基93購06  ,0,0,0,0,0,0,0,0,0,-19000,0,0,0,4000,23000,-19000,-19000
04420P,奇鋐永豐94售01  ,0,0,0,0,0,0,0,0,0,-19000,0,0,0,8000,27000,-19000,-19000
042558,瑞昱中信94購01  ,0,0,0,0,0,0,0,0,0,-19000,0,0,0,11000,30000,-19000,-19000
048771,嘉澤凱基94購01  ,0,0,0,0,0,0,0,0,0,-19000,0,0,0,174000,193000,-19000,-19000
05157P,全新台新96售01  ,0,0,0,0,0,0,0,0,0,-19000,0,0,0,0,19000,-19000,-19000
050600,瑞儀國泰95購01  ,0,0,0,0,0,0,0,0,0,-19000,0,0,0,41000,60000,-19000,-19000
050250,台郡凱基94購03  ,0,0,0,0,0,0,0,0,0,-19000,0,0,0,0,19000,-19000,-19000
054256,創意元大96購07  ,0,0,0,0,0,0,0,0,0,-19000,0,0,0,2000,21000,-19000,-19000
054381,世芯群益98購01  ,0,0,0,0,0,0,0,0,0,-19000,0,0,0,63000,82000,-19000,-19000
054109,南亞科凱基96購05,0,0,0,0,0,0,0,0,0,-19000,0,0,0,21000,40000,-19000,-19000
053883,大立光中信98購02,0,0,0,0,0,0,0,0,0,-19000,0,0,0,3000,22000,-19000,-19000
053464,喬山元大96購01  ,0,0,0,0,0,0,0,0,0,-19000,0,0,0,0,19000,-19000,-19000
053298,SP黃豆凱基99購01,0,0,0,0,0,0,0,0,0,-19000,0,0,0,0,19000,-19000,-19000
053559,台積電國泰98購01,0,0,0,0,0,0,0,0,0,-19000,0,0,0,111000,130000,-19000,-19000
051844,宏達電富邦96購01,0,0,0,0,0,0,0,0,0,-19000,0,0,0,114000,133000,-19000,-19000
05233P,台郡台新95售02  ,0,0,0,0,0,0,0,0,0,-19000,0,0,0,0,19000,-19000,-19000
052423,宏達電國票96購02,0,0,0,0,0,0,0,0,0,-19000,0,0,0,21000,40000,-19000,-19000
052232,貿聯凱基96購02  ,0,0,0,0,0,0,0,0,0,-19000,0,0,0,0,19000,-19000,-19000
053023,泰鼎國泰97購01  ,0,0,0,0,0,0,0,0,0,-19000,0,0,0,1000,20000,-19000,-19000
053173,矽格群益97購01  ,0,0,0,0,0,0,0,0,0,-19000,0,0,0,41000,60000,-19000,-19000
052813,T50正2永豐96購01,0,0,0,0,0,0,0,0,0,-19000,0,0,0,10000,29000,-19000,-19000
2024,志聯            ,2000,21000,-19000,0,0,0,0,0,0,0,0,0,0,0,0,0,-19000
2038,海光            ,3000,22000,-19000,0,0,0,0,0,0,0,0,0,0,0,0,0,-19000
4557,永新-KY         ,1000,20000,-19000,0,0,0,0,0,0,0,0,0,0,0,0,0,-19000
4952,凌通            ,23000,42000,-19000,0,0,0,0,0,0,0,0,0,0,0,0,0,-19000
3021,鴻名            ,4000,23000,-19000,0,0,0,0,0,0,0,0,0,0,0,0,0,-19000
06220P,廣宇元富97售02  ,0,0,0,0,0,0,0,0,0,-19000,0,0,0,0,19000,-19000,-19000
06303P,臺股指元大97售09,0,0,0,0,0,0,0,0,0,-19000,0,0,0,0,19000,-19000,-19000
1463,強盛            ,0,19000,-19000,0,0,0,0,0,0,0,0,0,0,0,0,0,-19000
1232,大統益          ,2000,20000,-18000,0,0,0,0,0,0,-1000,0,1000,-1000,0,0,0,-19000
1227,佳格            ,376000,397000,-21000,0,0,0,0,0,0,2000,3000,1000,2000,0,0,0,-19000
6164,華興            ,0,19000,-19000,0,0,0,0,0,0,0,0,0,0,0,0,0,-19000
05536P,奇力新元大96售03,0,0,0,0,0,0,0,0,0,-20000,0,0,0,1000,21000,-20000,-20000
055319,國巨國票98購03  ,0,0,0,0,0,0,0,0,0,-20000,0,0,0,0,20000,-20000,-20000
055597,禾伸堂元大98購02,0,0,0,0,0,0,0,0,0,-20000,0,0,0,0,20000,-20000,-20000
055781,聯詠凱基98購01  ,0,0,0,0,0,0,0,0,0,-20000,0,0,0,20000,40000,-20000,-20000
055778,美食凱基97購01  ,0,0,0,0,0,0,0,0,0,-20000,0,0,0,0,20000,-20000,-20000
055677,喬山凱基97購01  ,0,0,0,0,0,0,0,0,0,-20000,0,0,0,0,20000,-20000,-20000
054655,貿聯麥證98購01  ,0,0,0,0,20000,-20000,0,0,0,-20000,0,0,0,0,20000,-20000,-20000
054741,亞光凱基99購01  ,0,0,0,0,0,0,0,0,0,-20000,0,0,0,0,20000,-20000,-20000
05476P,聯發科群益95售06,0,0,0,0,0,0,0,0,0,-20000,0,0,0,0,20000,-20000,-20000
054828,正崴國泰99購01  ,0,0,0,0,0,0,0,0,0,-20000,0,0,0,0,20000,-20000,-20000
055098,臺股指群益97購01,0,0,0,0,0,0,0,0,0,-20000,0,0,0,0,20000,-20000,-20000
054864,聯發科群益97購02,0,0,0,0,0,0,0,0,0,-20000,0,0,0,0,20000,-20000,-20000
05494P,華邦電統一95售02,0,0,0,0,0,0,0,0,0,-20000,0,0,0,0,20000,-20000,-20000
054919,興富發凱基97購01,0,0,0,0,0,0,0,0,0,-20000,0,0,0,0,20000,-20000,-20000
05634P,玉晶光台新97售01,0,0,0,0,0,0,0,0,0,-20000,0,0,0,0,20000,-20000,-20000
056375,玉晶光統一01購01,0,0,0,0,0,0,0,0,0,-20000,0,0,0,0,20000,-20000,-20000
056232,瑞儀凱基98購01  ,0,0,0,0,0,0,0,0,0,-20000,0,0,0,0,20000,-20000,-20000
056029,國巨麥證98購01  ,0,0,0,10000,30000,-20000,0,0,0,-20000,0,0,0,10000,30000,-20000,-20000
056060,宏達電元大99購01,0,0,0,0,0,0,0,0,0,-20000,0,0,0,0,20000,-20000,-20000
055871,群創台新97購02  ,0,0,0,0,0,0,0,0,0,-20000,0,0,0,0,20000,-20000,-20000
05984P,台積電統一98售01,0,0,0,0,0,0,0,0,0,-20000,0,0,0,20000,40000,-20000,-20000
05918P,大立光元大96售11,0,0,0,0,0,0,0,0,0,-20000,0,0,0,32000,52000,-20000,-20000
05910P,力山永豐96售02  ,0,0,0,0,0,0,0,0,0,-20000,0,0,0,0,20000,-20000,-20000
056687,元大金統一98購01,0,0,0,0,0,0,0,0,0,-20000,0,0,0,0,20000,-20000,-20000
056808,台積電統一98購06,0,0,0,0,0,0,0,0,0,-20000,0,0,0,0,20000,-20000,-20000
05680P,聯發科元大96售12,0,0,0,0,0,0,0,0,0,-20000,0,0,0,25000,45000,-20000,-20000
056762,亞德客元大98購01,0,0,0,0,0,0,0,0,0,-20000,0,0,0,30000,50000,-20000,-20000
04275P,南亞科凱基93售08,0,0,0,0,0,0,0,0,0,-20000,0,0,0,0,20000,-20000,-20000
042281,元油2X富邦96購02,0,0,0,0,0,0,0,0,0,-20000,0,0,0,0,20000,-20000,-20000
045255,華邦電凱基93購03,0,0,0,0,0,0,0,0,0,-20000,0,0,0,0,20000,-20000,-20000
04384P,上証2X中信96售01,0,0,0,0,0,0,0,0,0,-20000,0,0,0,15000,35000,-20000,-20000
043735,元金2X元大94購01,0,0,0,0,0,0,0,0,0,-20000,0,0,0,100000,120000,-20000,-20000
04374P,深中小元大94售03,0,0,0,0,0,0,0,0,0,-20000,0,0,0,0,20000,-20000,-20000
046560,南亞科凱基92購04,0,0,0,0,0,0,0,0,0,-20000,0,0,0,0,20000,-20000,-20000
047494,華邦電元富96購01,0,0,0,0,0,0,0,0,0,-20000,0,0,0,0,20000,-20000,-20000
04320P,亞德客元大93售07,0,0,0,0,0,0,0,0,0,-20000,0,0,0,0,20000,-20000,-20000
046383,群創凱基98購01  ,0,0,0,0,0,0,0,0,0,-20000,0,0,0,8000,28000,-20000,-20000
045361,鈺齊凱基93購01  ,0,0,0,0,0,0,0,0,0,-20000,0,0,0,0,20000,-20000,-20000
03420B,臺股指元大95熊31,0,0,0,0,0,0,0,0,0,-20000,0,0,0,0,20000,-20000,-20000
03585P,欣興元大02售22  ,0,0,0,0,0,0,0,0,0,-20000,0,0,0,0,20000,-20000,-20000
03996P,旺宏國泰95售01  ,0,0,0,0,0,0,0,0,0,-20000,0,0,0,0,20000,-20000,-20000
045365,智邦兆豐93購04  ,0,0,0,0,0,0,0,0,0,-20000,0,0,0,10000,30000,-20000,-20000
04772P,欣興元大94售08  ,0,0,0,0,0,0,0,0,0,-20000,0,0,0,0,20000,-20000,-20000
046797,T50反1元大96購01,0,0,0,0,0,0,0,0,0,-20000,0,0,0,0,20000,-20000,-20000
04607P,A50中信94售01   ,0,0,0,0,0,0,0,0,0,-20000,0,0,0,0,20000,-20000,-20000
04594P,緯穎元大94售04  ,0,0,0,0,0,0,0,0,0,-20000,0,0,0,0,20000,-20000,-20000
045897,泰鼎元大93購04  ,0,0,0,0,0,0,0,0,0,-20000,0,0,0,0,20000,-20000,-20000
045820,京元電凱基92購04,0,0,0,0,0,0,0,0,0,-20000,0,0,0,110000,130000,-20000,-20000
046310,聯發科元大92購15,0,0,0,0,0,0,0,0,0,-20000,0,0,0,0,20000,-20000,-20000
04634P,臺股指群益94售09,0,0,0,0,0,0,0,0,0,-20000,0,0,0,0,20000,-20000,-20000
047122,康友元大93購02  ,0,0,0,0,0,0,0,0,0,-20000,0,0,0,0,20000,-20000,-20000
047095,聯詠麥證93購01  ,0,0,0,40000,60000,-20000,0,0,0,-20000,0,0,0,40000,60000,-20000,-20000
046959,技嘉中信93購01  ,0,0,0,0,0,0,0,0,0,-20000,0,0,0,10000,30000,-20000,-20000
046969,聯發科群益93購05,0,0,0,0,0,0,0,0,0,-20000,0,0,0,0,20000,-20000,-20000
047222,鴻海凱基94購04  ,0,0,0,0,0,0,0,0,0,-20000,0,0,0,0,20000,-20000,-20000
05072P,聯電元富95售02  ,0,0,0,0,0,0,0,0,0,-20000,0,0,0,0,20000,-20000,-20000
050710,元黃金中信96購01,0,0,0,0,0,0,0,0,0,-20000,0,0,0,40000,60000,-20000,-20000
050241,聯發科凱基94購14,0,0,0,0,0,0,0,0,0,-20000,0,0,0,0,20000,-20000,-20000
050143,臻鼎元富94購05  ,0,0,0,0,0,0,0,0,0,-20000,0,0,0,0,20000,-20000,-20000
04936P,大立光中信95售03,0,0,0,0,0,0,0,0,0,-20000,0,0,0,0,20000,-20000,-20000
050317,和鑫國票95購02  ,0,0,0,0,0,0,0,0,0,-20000,0,0,0,0,20000,-20000,-20000
051071,聯發科國票96購01,0,0,0,0,0,0,0,0,0,-20000,0,0,0,40000,60000,-20000,-20000
048861,牧德群益94購01  ,0,0,0,0,0,0,0,0,0,-20000,0,0,0,14000,34000,-20000,-20000
050055,道瓊反凱基95購01,0,0,0,0,0,0,0,0,0,-20000,0,0,0,0,20000,-20000,-20000
049941,臺股指元大94購24,0,0,0,0,0,0,0,0,0,-20000,0,0,0,0,20000,-20000,-20000
047924,可成凱基93購10  ,0,0,0,0,0,0,0,0,0,-20000,0,0,0,0,20000,-20000,-20000
047944,中石化元富96購01,0,0,0,0,0,0,0,0,0,-20000,0,0,0,0,20000,-20000,-20000
050655,中磊凱基96購01  ,0,0,0,0,0,0,0,0,0,-20000,0,0,0,0,20000,-20000,-20000
047990,臺指反元大96購02,0,0,0,0,0,0,0,0,0,-20000,0,0,0,0,20000,-20000,-20000
047964,元油反中信95購01,0,0,0,0,0,0,0,0,0,-20000,0,0,0,0,20000,-20000,-20000
051278,臻鼎中信97購02  ,0,0,0,0,0,0,0,0,0,-20000,0,0,0,0,20000,-20000,-20000
051588,聯詠元大95購03  ,0,0,0,0,0,0,0,0,0,-20000,0,0,0,0,20000,-20000,-20000
051595,康控元大95購04  ,0,0,0,0,0,0,0,0,0,-20000,0,0,0,0,20000,-20000,-20000
051615,華通凱基96購01  ,0,0,0,0,0,0,0,0,0,-20000,0,0,0,0,20000,-20000,-20000
051524,貿聯凱基95購02  ,0,0,0,0,0,0,0,0,0,-20000,0,0,0,20000,40000,-20000,-20000
048446,南亞科凱基93購07,0,0,0,0,0,0,0,0,0,-20000,0,0,0,0,20000,-20000,-20000
048474,嘉聯益永豐93購03,0,0,0,0,0,0,0,0,0,-20000,0,0,0,0,20000,-20000,-20000
049770,康控元富95購01  ,0,0,0,0,0,0,0,0,0,-20000,0,0,0,0,20000,-20000,-20000
049743,全新台新94購01  ,0,0,0,0,0,0,0,0,0,-20000,0,0,0,0,20000,-20000,-20000
049271,百和元大94購01  ,0,0,0,0,0,0,0,0,0,-20000,0,0,0,0,20000,-20000,-20000
049230,台達電富邦96購01,0,0,0,0,0,0,0,0,0,-20000,0,0,0,0,20000,-20000,-20000
051197,光寶科麥證95購01,0,0,0,30000,50000,-20000,0,0,0,-20000,0,0,0,30000,50000,-20000,-20000
048195,聯發科元大93購23,0,0,0,0,0,0,0,0,0,-20000,0,0,0,0,20000,-20000,-20000
048158,大立光兆豐95購01,0,0,0,0,0,0,0,0,0,-20000,0,0,0,0,20000,-20000,-20000
048438,台表科麥證94購01,0,0,0,0,20000,-20000,0,0,0,-20000,0,0,0,0,20000,-20000,-20000
048105,滬深2X群益99購02,0,0,0,0,0,0,0,0,0,-20000,0,0,0,0,20000,-20000,-20000
048116,矽創群益93購02  ,0,0,0,0,0,0,0,0,0,-20000,0,0,0,0,20000,-20000,-20000
048371,華固統一93購02  ,0,0,0,0,0,0,0,0,0,-20000,0,0,0,0,20000,-20000,-20000
048378,貿聯元富93購01  ,0,0,0,0,0,0,0,0,0,-20000,0,0,0,10000,30000,-20000,-20000
048736,台達電統一94購01,0,0,0,0,0,0,0,0,0,-20000,0,0,0,0,20000,-20000,-20000
049691,可成元大94購06  ,0,0,0,0,0,0,0,0,0,-20000,0,0,0,33000,53000,-20000,-20000
048687,旺宏群益96購01  ,0,0,0,0,0,0,0,0,0,-20000,0,0,0,20000,40000,-20000,-20000
050531,訊芯元大95購02  ,0,0,0,0,0,0,0,0,0,-20000,0,0,0,0,20000,-20000,-20000
051178,大立光凱基95購10,0,0,0,0,0,0,0,0,0,-20000,0,0,0,40000,60000,-20000,-20000
048640,南亞科元大93購06,0,0,0,0,0,0,0,0,0,-20000,0,0,0,0,20000,-20000,-20000
048603,中磊國票94購02  ,0,0,0,0,0,0,0,0,0,-20000,0,0,0,20000,40000,-20000,-20000
050956,鈺齊群益95購01  ,0,0,0,0,0,0,0,0,0,-20000,0,0,0,3000,23000,-20000,-20000
05097P,聯發科日盛95售01,0,0,0,0,0,0,0,0,0,-20000,0,0,0,0,20000,-20000,-20000
049547,新光金群益94購01,0,0,0,0,0,0,0,0,0,-20000,0,0,0,30000,50000,-20000,-20000
049560,香港反統一95購01,0,0,0,0,0,0,0,0,0,-20000,0,0,0,0,20000,-20000,-20000
050861,鴻海永豐95購01  ,0,0,0,0,0,0,0,0,0,-20000,0,0,0,0,20000,-20000,-20000
050806,華新科日盛95購01,0,0,0,0,0,0,0,0,0,-20000,0,0,0,153000,173000,-20000,-20000
052864,奇力新凱基96購02,0,0,0,0,0,0,0,0,0,-20000,0,0,0,0,20000,-20000,-20000
052736,T50反1元大96購05,0,0,0,0,0,0,0,0,0,-20000,0,0,0,0,20000,-20000,-20000
05273P,國巨群益95售02  ,0,0,0,0,0,0,0,0,0,-20000,0,0,0,0,20000,-20000,-20000
052567,台積電凱基96購05,0,0,0,0,0,0,0,0,0,-20000,0,0,0,0,20000,-20000,-20000
052553,技嘉國票96購01  ,0,0,0,0,0,0,0,0,0,-20000,0,0,0,35000,55000,-20000,-20000
052530,台郡元大96購04  ,0,0,0,0,0,0,0,0,0,-20000,0,0,0,62000,82000,-20000,-20000
053185,友達中信99購01  ,0,0,0,0,0,0,0,0,0,-20000,0,0,0,10000,30000,-20000,-20000
053148,華邦電元大96購01,0,0,0,0,0,0,0,0,0,-20000,0,0,0,59000,79000,-20000,-20000
052899,和大國票97購01  ,0,0,0,0,0,0,0,0,0,-20000,0,0,0,0,20000,-20000,-20000
052303,聯發科永豐95購05,0,0,0,0,0,0,0,0,0,-20000,0,0,0,0,20000,-20000,-20000
052421,元油反國票9B購01,0,0,0,0,0,0,0,0,0,-20000,0,0,0,10000,30000,-20000,-20000
052499,合勤控永豐95購01,0,0,0,0,0,0,0,0,0,-20000,0,0,0,0,20000,-20000,-20000
05249P,臻鼎國票95售01  ,0,0,0,0,0,0,0,0,0,-20000,0,0,0,0,20000,-20000,-20000
05250P,臻鼎國票96售01  ,0,0,0,0,0,0,0,0,0,-20000,0,0,0,0,20000,-20000,-20000
052406,力成凱基95購03  ,0,0,0,0,0,0,0,0,0,-20000,0,0,0,7000,27000,-20000,-20000
051902,T50反1元大97購01,0,0,0,0,0,0,0,0,0,-20000,0,0,0,160000,180000,-20000,-20000
052024,臺股指永豐95購04,0,0,0,0,0,0,0,0,0,-20000,0,0,0,0,20000,-20000,-20000
05193P,台郡台新95售01  ,0,0,0,0,0,0,0,0,0,-20000,0,0,0,0,20000,-20000,-20000
053554,欣興凱基97購02  ,0,0,0,0,0,0,0,0,0,-20000,0,0,0,0,20000,-20000,-20000
05359P,嘉澤元大95售02  ,0,0,0,0,0,0,0,0,0,-20000,0,0,0,25000,45000,-20000,-20000
053575,聯詠元富96購01  ,0,0,0,0,0,0,0,0,0,-20000,0,0,0,0,20000,-20000,-20000
05368P,可成元富95售03  ,0,0,0,0,0,0,0,0,0,-20000,0,0,0,0,20000,-20000,-20000
053764,A50正2富邦99購01,0,0,0,0,0,0,0,0,0,-20000,0,0,0,0,20000,-20000,-20000
053779,台光電元大96購02,0,0,0,0,0,0,0,0,0,-20000,0,0,0,5000,25000,-20000,-20000
053828,貿聯麥證96購01  ,0,0,0,10000,30000,-20000,0,0,0,-20000,0,0,0,10000,30000,-20000,-20000
053319,可成群益96購04  ,0,0,0,0,0,0,0,0,0,-20000,0,0,0,0,20000,-20000,-20000
053360,上証2X元富96購01,0,0,0,0,0,0,0,0,0,-20000,0,0,0,0,20000,-20000,-20000
053350,台表科國票97購02,0,0,0,0,0,0,0,0,0,-20000,0,0,0,0,20000,-20000,-20000
053257,華通富邦97購01  ,0,0,0,0,0,0,0,0,0,-20000,0,0,0,0,20000,-20000,-20000
053948,大立光富邦99購04,0,0,0,0,0,0,0,0,0,-20000,0,0,0,58000,78000,-20000,-20000
054110,群創凱基98購09  ,0,0,0,0,0,0,0,0,0,-20000,0,0,0,0,20000,-20000,-20000
054424,大成鋼富邦97購02,0,0,0,0,0,0,0,0,0,-20000,0,0,0,0,20000,-20000,-20000
6581,鋼聯            ,0,19000,-19000,0,0,0,0,0,0,-1000,0,1000,-1000,0,0,0,-20000
08897P,國巨群益01售10  ,0,0,0,0,0,0,0,0,0,-20000,0,0,0,101000,121000,-20000,-20000
1467,南緯            ,0,20000,-20000,0,0,0,0,0,0,0,0,0,0,0,0,0,-20000
06356P,啟碁永豐97售01  ,0,0,0,0,0,0,0,0,0,-20000,0,0,0,0,20000,-20000,-20000
06528P,台積電富邦99售03,0,0,0,0,0,0,0,0,0,-20000,0,0,0,0,20000,-20000,-20000
08484P,台灣50中信96售01,0,0,0,0,0,0,0,0,0,-20000,0,0,0,0,20000,-20000,-20000
06232P,智易永豐97售01  ,0,0,0,0,0,0,0,0,0,-20000,0,0,0,0,20000,-20000,-20000
06027P,鴻海台新96售04  ,0,0,0,0,0,0,0,0,0,-20000,0,0,0,0,20000,-20000,-20000
3027,盛達            ,3000,23000,-20000,0,0,0,0,0,0,0,0,0,0,0,0,0,-20000
3164,景岳            ,3000,23000,-20000,0,0,0,0,0,0,0,0,0,0,0,0,0,-20000
2906,高林            ,1000,21000,-20000,0,0,0,0,0,0,0,0,0,0,0,0,0,-20000
4755,三福化          ,0,20000,-20000,0,0,0,0,0,0,0,0,0,0,0,0,0,-20000
4106,雃博            ,28000,48000,-20000,0,0,0,0,0,0,0,0,0,0,0,0,0,-20000
05956P,漢唐國票96售02  ,0,0,0,0,0,0,0,0,0,-21000,0,0,0,0,21000,-21000,-21000
05642P,玉晶光兆豐97售02,0,0,0,0,0,0,0,0,0,-21000,0,0,0,20000,41000,-21000,-21000
056299,友達元大9B購04  ,0,0,0,0,0,0,0,0,0,-21000,0,0,0,17000,38000,-21000,-21000
055102,上銀凱基98購01  ,0,0,0,0,0,0,0,0,0,-21000,0,0,0,352000,373000,-21000,-21000
05456P,鴻海凱基95售19  ,0,0,0,0,0,0,0,0,0,-21000,0,0,0,31000,52000,-21000,-21000
055679,華通凱基99購01  ,0,0,0,0,0,0,0,0,0,-21000,0,0,0,0,21000,-21000,-21000
055424,聚陽群益98購01  ,0,0,0,0,0,0,0,0,0,-21000,0,0,0,82000,103000,-21000,-21000
050477,矽力永豐94購01  ,0,0,0,0,0,0,0,0,0,-21000,0,0,0,10000,31000,-21000,-21000
04732P,聯茂群益94售01  ,0,0,0,0,0,0,0,0,0,-21000,0,0,0,0,21000,-21000,-21000
046269,禾伸堂凱基92購03,0,0,0,0,0,0,0,0,0,-21000,0,0,0,23000,44000,-21000,-21000
04038P,聯茂群益93售03  ,0,0,0,0,0,0,0,0,0,-21000,0,0,0,0,21000,-21000,-21000
00731,FH富時高息低波  ,0,0,0,0,0,0,0,0,0,-21000,0,0,0,65000,86000,-21000,-21000
03840P,台積電統一99售02,0,0,0,0,0,0,0,0,0,-21000,0,0,0,1463000,1484000,-21000,-21000
03757P,麗豐永豐93售01  ,0,0,0,0,0,0,0,0,0,-21000,0,0,0,0,21000,-21000,-21000
042168,台灣50凱基96購01,0,0,0,0,0,0,0,0,0,-21000,0,0,0,1000,22000,-21000,-21000
049597,泰鼎元大96購01  ,0,0,0,0,0,0,0,0,0,-21000,0,0,0,29000,50000,-21000,-21000
049284,瑞昱中信94購02  ,0,0,0,0,0,0,0,0,0,-21000,0,0,0,26000,47000,-21000,-21000
049052,台積電永豐94購02,0,0,0,0,0,0,0,0,0,-21000,0,0,0,0,21000,-21000,-21000
050027,義隆元大94購03  ,0,0,0,0,0,0,0,0,0,-21000,0,0,0,81000,102000,-21000,-21000
051074,矽力國票96購01  ,0,0,0,0,0,0,0,0,0,-21000,0,0,0,0,21000,-21000,-21000
050098,嘉聯益國泰95購02,0,0,0,0,0,0,0,0,0,-21000,0,0,0,6000,27000,-21000,-21000
054205,華新國票97購02  ,0,0,0,0,0,0,0,0,0,-21000,0,0,0,0,21000,-21000,-21000
053582,英業達元大97購01,0,0,0,0,0,0,0,0,0,-21000,0,0,0,182000,203000,-21000,-21000
053603,臺股指元大96購20,0,0,0,0,0,0,0,0,0,-21000,0,0,0,0,21000,-21000,-21000
052975,嘉聯益群益96購01,0,0,0,0,0,0,0,0,0,-21000,0,0,0,11000,32000,-21000,-21000
052515,矽力凱基95購02  ,0,0,0,0,0,0,0,0,0,-21000,0,0,0,0,21000,-21000,-21000
1783,和康生          ,3000,24000,-21000,0,0,0,0,0,0,0,0,0,0,0,0,0,-21000
1473,台南            ,24000,45000,-21000,0,0,0,0,0,0,0,0,0,0,0,0,0,-21000
1220,台榮            ,0,20000,-20000,0,0,0,0,0,0,-1000,0,1000,-1000,0,0,0,-21000
6215,和椿            ,4000,25000,-21000,0,0,0,0,0,0,0,0,0,0,0,0,0,-21000
6115,鎰勝            ,22000,43000,-21000,0,0,0,0,0,0,0,0,0,0,0,0,0,-21000
8374,羅昇            ,4000,25000,-21000,0,0,0,0,0,0,0,0,0,0,0,0,0,-21000
055534,晶技群益97購03  ,0,0,0,0,0,0,0,0,0,-22000,0,0,0,0,22000,-22000,-22000
056420,台表科元富98購01,0,0,0,0,0,0,0,0,0,-22000,0,0,0,10000,32000,-22000,-22000
056205,貿聯永豐97購01  ,0,0,0,0,0,0,0,0,0,-22000,0,0,0,4000,26000,-22000,-22000
055788,緯穎凱基97購04  ,0,0,0,0,0,0,0,0,0,-22000,0,0,0,1000,23000,-22000,-22000
056674,華邦電元富98購01,0,0,0,0,0,0,0,0,0,-22000,0,0,0,150000,172000,-22000,-22000
056692,燿華群益98購03  ,0,0,0,0,0,0,0,0,0,-22000,0,0,0,0,22000,-22000,-22000
056637,台光電日盛9A購01,0,0,0,0,0,0,0,0,0,-22000,0,0,0,0,22000,-22000,-22000
047726,友達群益94購02  ,0,0,0,0,0,0,0,0,0,-22000,0,0,0,1000,23000,-22000,-22000
047055,旭富國票93購01  ,0,0,0,0,0,0,0,0,0,-22000,0,0,0,38000,60000,-22000,-22000
050444,卜蜂元大94購03  ,0,0,0,0,0,0,0,0,0,-22000,0,0,0,0,22000,-22000,-22000
050400,臻鼎中信97購01  ,0,0,0,0,0,0,0,0,0,-22000,0,0,0,6000,28000,-22000,-22000
049515,同欣電凱基94購01,0,0,0,0,0,0,0,0,0,-22000,0,0,0,8000,30000,-22000,-22000
049930,上海銀元大94購02,0,0,0,0,0,0,0,0,0,-22000,0,0,0,111000,133000,-22000,-22000
04990P,臻鼎元大94售04  ,0,0,0,0,0,0,0,0,0,-22000,0,0,0,0,22000,-22000,-22000
051233,力成群益97購01  ,0,0,0,0,0,0,0,0,0,-22000,0,0,0,62000,84000,-22000,-22000
050517,台積電元大94購27,0,0,0,0,0,0,0,0,0,-22000,0,0,0,401000,423000,-22000,-22000
05081P,京鼎永豐95售01  ,0,0,0,0,0,0,0,0,0,-22000,0,0,0,0,22000,-22000,-22000
050775,TPK元大96購01   ,0,0,0,0,0,0,0,0,0,-22000,0,0,0,0,22000,-22000,-22000
052066,華邦電兆豐96購01,0,0,0,0,0,0,0,0,0,-22000,0,0,0,17000,39000,-22000,-22000
052294,創意國票96購03  ,0,0,0,0,0,0,0,0,0,-22000,0,0,0,38000,60000,-22000,-22000
052134,智邦凱基95購09  ,0,0,0,0,0,0,0,0,0,-22000,0,0,0,0,22000,-22000,-22000
053662,矽力凱基97購01  ,0,0,0,0,0,0,0,0,0,-22000,0,0,0,0,22000,-22000,-22000
054175,高鐵台新97購01  ,0,0,0,0,0,0,0,0,0,-22000,0,0,0,16000,38000,-22000,-22000
053976,亞光元大96購02  ,0,0,0,0,0,0,0,0,0,-22000,0,0,0,27000,49000,-22000,-22000
6666,羅麗芬-KY       ,3000,24000,-21000,0,0,0,0,0,0,-1000,0,0,0,0,1000,-1000,-22000
1432,大魯閣          ,1000,23000,-22000,0,0,0,0,0,0,0,0,0,0,0,0,0,-22000
06468P,華新科統一98售02,0,0,0,0,0,0,0,0,0,-22000,0,0,0,17000,39000,-22000,-22000
1737,臺鹽            ,17000,39000,-22000,0,0,0,0,0,0,0,0,0,0,0,0,0,-22000
1817,凱撒衛          ,0,22000,-22000,0,0,0,0,0,0,0,0,0,0,0,0,0,-22000
1721,三晃            ,20000,42000,-22000,0,0,0,0,0,0,0,0,0,0,0,0,0,-22000
2476,鉅祥            ,2000,24000,-22000,0,0,0,0,0,0,0,0,0,0,0,0,0,-22000
3591,艾笛森          ,6000,29000,-23000,0,0,0,0,0,0,1000,1000,0,1000,0,0,0,-22000
4572,駐龍            ,2000,24000,-22000,0,0,0,0,0,0,0,0,0,0,0,0,0,-22000
4164,承業醫          ,22000,45000,-23000,0,0,0,0,0,0,1000,1000,0,1000,0,0,0,-22000
05710P,禾伸堂國票97售02,0,0,0,0,0,0,0,0,0,-23000,0,0,0,0,23000,-23000,-23000
055594,華新科元大98購02,0,0,0,0,0,0,0,0,0,-23000,0,0,0,13000,36000,-23000,-23000
05544P,台表科元富96售01,0,0,0,0,0,0,0,0,0,-23000,0,0,0,0,23000,-23000,-23000
050397,力成元富94購01  ,0,0,0,0,0,0,0,0,0,-23000,0,0,0,70000,93000,-23000,-23000
047676,臺股指元富99購01,0,0,0,0,0,0,0,0,0,-23000,0,0,0,20000,43000,-23000,-23000
045634,友達凱基93購02  ,0,0,0,0,0,0,0,0,0,-23000,0,0,0,3000,26000,-23000,-23000
044530,台積電富邦94購01,0,0,0,0,0,0,0,0,0,-23000,0,0,0,1000,24000,-23000,-23000
044850,南亞科統一94購01,0,0,0,0,0,0,0,0,0,-23000,0,0,0,44000,67000,-23000,-23000
00830,國泰費城半導體  ,43000,0,43000,0,0,0,0,0,0,-66000,0,0,0,45000,111000,-66000,-23000
03085P,台積電元大01售34,0,0,0,0,0,0,0,0,0,-23000,0,0,0,2000,25000,-23000,-23000
050202,建準群益95購01  ,0,0,0,0,0,0,0,0,0,-23000,0,0,0,12000,35000,-23000,-23000
051182,旺宏永豐95購01  ,0,0,0,0,0,0,0,0,0,-23000,0,0,0,33000,56000,-23000,-23000
048273,南電富邦97購01  ,0,0,0,0,0,0,0,0,0,-23000,0,0,0,22000,45000,-23000,-23000
049375,大立光元大94購13,0,0,0,0,0,0,0,0,0,-23000,0,0,0,0,23000,-23000,-23000
049343,華新科統一94購03,0,0,0,0,0,0,0,0,0,-23000,0,0,0,32000,55000,-23000,-23000
051523,牧德凱基95購02  ,0,0,0,0,0,0,0,0,0,-23000,0,0,0,3000,26000,-23000,-23000
054022,南亞康和96購01  ,0,0,0,0,0,0,0,0,0,-23000,0,0,0,75000,98000,-23000,-23000
054363,世芯凱基97購01  ,0,0,0,0,0,0,0,0,0,-23000,0,0,0,16000,39000,-23000,-23000
053666,臺股指凱基96購29,0,0,0,0,0,0,0,0,0,-23000,0,0,0,0,23000,-23000,-23000
053265,南亞科群益96購02,0,0,0,0,0,0,0,0,0,-23000,0,0,0,51000,74000,-23000,-23000
052227,瑞昱凱基95購05  ,0,0,0,0,0,0,0,0,0,-23000,0,0,0,74000,97000,-23000,-23000
051940,康舒群益95購01  ,0,0,0,0,0,0,0,0,0,-23000,0,0,0,50000,73000,-23000,-23000
052928,美律元大98購01  ,0,0,0,0,0,0,0,0,0,-23000,0,0,0,150000,173000,-23000,-23000
053133,華邦電國票97購01,0,0,0,0,0,0,0,0,0,-23000,0,0,0,10000,33000,-23000,-23000
3028,增你強          ,8000,32000,-24000,0,0,0,0,0,0,1000,1000,0,1000,0,0,0,-23000
2462,良得電          ,0,23000,-23000,0,0,0,0,0,0,0,0,0,0,0,0,0,-23000
2427,三商電          ,7000,30000,-23000,0,0,0,0,0,0,0,0,0,0,0,0,0,-23000
1537,廣隆            ,22000,45000,-23000,0,0,0,0,0,0,0,0,0,0,0,0,0,-23000
2027,大成鋼          ,284000,336000,-52000,0,0,0,0,0,0,29000,0,1000,-1000,141000,111000,30000,-23000
2207,和泰車          ,234000,255000,-21000,0,0,0,0,0,0,-2000,0,2000,-2000,0,0,0,-23000
1323,永裕            ,6000,29000,-23000,0,0,0,0,0,0,0,0,0,0,0,0,0,-23000
1568,倉佑            ,1000,24000,-23000,0,0,0,0,0,0,0,0,0,0,0,0,0,-23000
1535,中宇            ,0,23000,-23000,0,0,0,0,0,0,0,0,0,0,0,0,0,-23000
06041P,全新永豐96售03  ,0,0,0,0,0,0,0,0,0,-23000,0,0,0,36000,59000,-23000,-23000
06230P,亞德客永豐97售03,0,0,0,0,0,0,0,0,0,-23000,0,0,0,15000,38000,-23000,-23000
6573,虹揚-KY         ,2000,25000,-23000,0,0,0,0,0,0,0,0,0,0,0,0,0,-23000
6412,群電            ,433000,437000,-4000,0,0,0,0,22000,-22000,3000,3000,0,3000,0,0,0,-23000
6183,關貿            ,0,23000,-23000,0,0,0,0,0,0,0,0,0,0,0,0,0,-23000
8249,菱光            ,7000,30000,-23000,0,0,0,0,0,0,0,0,0,0,0,0,0,-23000
05538P,玉晶光國票97售02,0,0,0,0,0,0,0,0,0,-24000,0,0,0,0,24000,-24000,-24000
056572,義隆元大99購01  ,0,0,0,0,0,0,0,0,0,-24000,0,0,0,371000,395000,-24000,-24000
04006P,滬深2X國票9B售01,0,0,0,0,0,0,0,0,0,-24000,0,0,0,6000,30000,-24000,-24000
03873P,智伸科群益93售03,0,0,0,0,0,0,0,0,0,-24000,0,0,0,0,24000,-24000,-24000
047724,智邦群益93購03  ,0,0,0,0,0,0,0,0,0,-24000,0,0,0,0,24000,-24000,-24000
047035,華邦電群益94購02,0,0,0,0,0,0,0,0,0,-24000,0,0,0,16000,40000,-24000,-24000
051553,牧德永豐96購02  ,0,0,0,0,0,0,0,0,0,-24000,0,0,0,3000,27000,-24000,-24000
051361,泰鼎元大95購01  ,0,0,0,0,0,0,0,0,0,-24000,0,0,0,50000,74000,-24000,-24000
050653,聯鈞凱基96購01  ,0,0,0,0,0,0,0,0,0,-24000,0,0,0,11000,35000,-24000,-24000
050586,康友國票94購01  ,0,0,0,0,0,0,0,0,0,-24000,0,0,0,4000,28000,-24000,-24000
050552,禾伸堂凱基94購05,0,0,0,0,0,0,0,0,0,-24000,0,0,0,13000,37000,-24000,-24000
053181,滬深2X元富99購02,0,0,0,0,0,0,0,0,0,-24000,0,0,0,10000,34000,-24000,-24000
051966,台表科永豐95購01,0,0,0,0,0,0,0,0,0,-24000,0,0,0,0,24000,-24000,-24000
053503,臻鼎兆豐97購01  ,0,0,0,0,0,0,0,0,0,-24000,0,0,0,30000,54000,-24000,-24000
05435P,鴻海群益95售12  ,0,0,0,0,0,0,0,0,0,-24000,0,0,0,0,24000,-24000,-24000
054236,貿聯群益96購01  ,0,0,0,0,0,0,0,0,0,-24000,0,0,0,0,24000,-24000,-24000
054038,T50反1元大98購04,0,0,0,0,0,0,0,0,0,-24000,0,0,0,36000,60000,-24000,-24000
05412P,泰碩國票95售02  ,1000,0,1000,0,0,0,0,0,0,-25000,0,0,0,11000,36000,-25000,-24000
054055,全新國票99購02  ,0,0,0,0,0,0,0,0,0,-24000,0,0,0,0,24000,-24000,-24000
2460,建通            ,6000,31000,-25000,0,0,0,0,0,0,1000,1000,0,1000,0,0,0,-24000
5283,禾聯碩          ,3000,29000,-26000,0,0,0,0,0,0,2000,0,0,0,2000,0,2000,-24000
05669P,嘉晶永豐96售03  ,0,0,0,0,0,0,0,0,0,-25000,0,0,0,0,25000,-25000,-25000
056806,元油2X統一98購02,0,0,0,0,0,0,0,0,0,-25000,0,0,0,0,25000,-25000,-25000
05843P,台積電元大96售16,0,0,0,0,0,0,0,0,0,-25000,0,0,0,130000,155000,-25000,-25000
05808P,臺股指國票96售01,0,0,0,0,0,0,0,0,0,-25000,0,0,0,25000,50000,-25000,-25000
055938,矽力群益97購01  ,0,0,0,0,0,0,0,0,0,-25000,0,0,0,49000,74000,-25000,-25000
055994,聯發科國泰99購02,0,0,0,0,0,0,0,0,0,-25000,0,0,0,40000,65000,-25000,-25000
055541,聚陽凱基98購01  ,0,0,0,0,0,0,0,0,0,-25000,0,0,0,0,25000,-25000,-25000
054931,緯穎凱基98購01  ,0,0,0,0,0,0,0,0,0,-25000,0,0,0,15000,40000,-25000,-25000
054891,聯鈞統一99購02  ,0,0,0,0,0,0,0,0,0,-25000,0,0,0,1000,26000,-25000,-25000
04694P,TPK台新94售02   ,0,0,0,0,0,0,0,0,0,-25000,0,0,0,0,25000,-25000,-25000
04543P,鴻海富邦95售03  ,0,0,0,0,0,0,0,0,0,-25000,0,0,0,0,25000,-25000,-25000
046234,彩晶元大92購01  ,0,0,0,0,0,0,0,0,0,-25000,0,0,0,0,25000,-25000,-25000
04484P,台積電凱基94售09,0,0,0,0,0,0,0,0,0,-25000,0,0,0,0,25000,-25000,-25000
045106,玉晶光群益95購01,0,0,0,0,0,0,0,0,0,-25000,0,0,0,55000,80000,-25000,-25000
04416P,牧德元富94售06  ,0,0,0,0,0,0,0,0,0,-25000,0,0,0,0,25000,-25000,-25000
047443,智原元大94購01  ,0,0,0,0,0,0,0,0,0,-25000,0,0,0,30000,55000,-25000,-25000
047967,南亞科國泰95購01,0,0,0,0,0,0,0,0,0,-25000,0,0,0,159000,184000,-25000,-25000
047981,南亞科群益93購02,0,0,0,0,0,0,0,0,0,-25000,0,0,0,50000,75000,-25000,-25000
047984,禾伸堂群益93購01,0,0,0,0,0,0,0,0,0,-25000,0,0,0,0,25000,-25000,-25000
049046,同欣電兆豐94購01,0,0,0,0,0,0,0,0,0,-25000,0,0,0,40000,65000,-25000,-25000
049751,牧德永豐95購01  ,0,0,0,0,0,0,0,0,0,-25000,0,0,0,0,25000,-25000,-25000
04848P,康控凱基94售02  ,0,0,0,0,0,0,0,0,0,-25000,0,0,0,0,25000,-25000,-25000
05404P,台積電群益95售06,0,0,0,0,0,0,0,0,0,-25000,0,0,0,10000,35000,-25000,-25000
05427P,聯發科凱基96售07,0,0,0,0,0,0,0,0,0,-25000,0,0,0,41000,66000,-25000,-25000
054362,亞光凱基96購03  ,0,0,0,0,0,0,0,0,0,-25000,0,0,0,0,25000,-25000,-25000
054417,牧德元大96購01  ,0,0,0,0,0,0,0,0,0,-25000,0,0,0,0,25000,-25000,-25000
053665,臺股指凱基96購26,0,0,0,0,0,0,0,0,0,-25000,0,0,0,35000,60000,-25000,-25000
053627,宏碁兆豐97購01  ,0,0,0,0,0,0,0,0,0,-25000,0,0,0,251000,276000,-25000,-25000
051974,華新科凱基96購05,0,0,0,0,0,0,0,0,0,-25000,0,0,0,6000,31000,-25000,-25000
052033,臺股指群益95購06,0,0,0,0,0,0,0,0,0,-25000,0,0,0,0,25000,-25000,-25000
052902,鴻海國票97購04  ,0,0,0,0,0,0,0,0,0,-25000,0,0,0,50000,75000,-25000,-25000
052955,國巨日盛96購01  ,0,0,0,0,0,0,0,0,0,-25000,0,0,0,0,25000,-25000,-25000
053020,貿聯元富96購01  ,0,0,0,0,0,0,0,0,0,-25000,0,0,0,3000,28000,-25000,-25000
052533,聯發科國泰96購03,0,0,0,0,0,0,0,0,0,-25000,0,0,0,2000,27000,-25000,-25000
05260P,和碩元富95售02  ,0,0,0,0,0,0,0,0,0,-25000,0,0,0,11000,36000,-25000,-25000
052818,智邦永豐96購01  ,0,0,0,0,0,0,0,0,0,-25000,0,0,0,140000,165000,-25000,-25000
4930,燦星網          ,0,26000,-26000,0,0,0,0,0,0,1000,1000,0,1000,0,0,0,-25000
3454,晶睿            ,26000,51000,-25000,0,0,0,0,0,0,0,0,0,0,0,0,0,-25000
3011,今皓            ,1000,26000,-25000,0,0,0,0,0,0,0,0,0,0,0,0,0,-25000
2706,第一店          ,10000,35000,-25000,0,0,0,0,0,0,0,0,0,0,0,0,0,-25000
2483,百容            ,2000,27000,-25000,0,0,0,0,0,0,0,0,0,0,0,0,0,-25000
2497,怡利電          ,1000,25000,-24000,0,0,0,0,0,0,-1000,0,1000,-1000,0,0,0,-25000
2443,億麗            ,4000,29000,-25000,0,0,0,0,0,0,0,0,0,0,0,0,0,-25000
2405,浩鑫            ,56000,81000,-25000,0,0,0,0,0,0,0,0,0,0,0,0,0,-25000
1533,車王電          ,1000,26000,-25000,0,0,0,0,0,0,0,0,0,0,0,0,0,-25000
1506,正道            ,2000,27000,-25000,0,0,0,0,0,0,0,0,0,0,0,0,0,-25000
054906,神達康和97購01  ,0,0,0,0,0,0,0,0,0,-26000,0,0,0,68000,94000,-26000,-26000
054983,國巨元富97購04  ,0,0,0,0,0,0,0,0,0,-26000,0,0,0,202000,228000,-26000,-26000
054493,同欣電台新96購01,0,0,0,0,0,0,0,0,0,-26000,0,0,0,58000,84000,-26000,-26000
055753,貿聯第一98購01  ,0,0,0,0,0,0,0,0,0,-26000,0,0,0,54000,80000,-26000,-26000
05846P,大立光元大96售07,0,0,0,0,0,0,0,0,0,-26000,0,0,0,110000,136000,-26000,-26000
05772P,景碩凱基96售02  ,0,0,0,0,0,0,0,0,0,-26000,0,0,0,0,26000,-26000,-26000
056448,全新凱基99購01  ,0,0,0,0,0,0,0,0,0,-26000,0,0,0,0,26000,-26000,-26000
04213P,台光電凱基93售11,0,0,0,0,0,0,0,0,0,-26000,0,0,0,0,26000,-26000,-26000
047768,大立光元大95購01,0,0,0,0,0,0,0,0,0,-26000,0,0,0,4000,30000,-26000,-26000
048281,矽力永豐93購02  ,0,0,0,0,0,0,0,0,0,-26000,0,0,0,16000,42000,-26000,-26000
051266,國巨富邦99購01  ,0,0,0,0,0,0,0,0,0,-26000,0,0,0,84000,110000,-26000,-26000
051452,貿聯元大95購04  ,0,0,0,0,0,0,0,0,0,-26000,0,0,0,2000,28000,-26000,-26000
049091,訊連凱基94購01  ,0,0,0,0,0,0,0,0,0,-26000,0,0,0,0,26000,-26000,-26000
052669,群創群益98購06  ,0,0,0,0,0,0,0,0,0,-26000,0,0,0,99000,125000,-26000,-26000
053013,台積電統一97購01,0,0,0,0,0,0,0,0,0,-26000,0,0,0,0,26000,-26000,-26000
051852,啟碁群益95購01  ,0,0,0,0,0,0,0,0,0,-26000,0,0,0,0,26000,-26000,-26000
053430,樺漢永豐96購01  ,0,0,0,0,0,0,0,0,0,-26000,0,0,0,0,26000,-26000,-26000
054473,鴻海中信96購02  ,0,0,0,0,0,0,0,0,0,-26000,0,0,0,74000,100000,-26000,-26000
054024,中鋼康和96購01  ,0,0,0,0,0,0,0,0,0,-26000,0,0,0,68000,94000,-26000,-26000
06432P,上銀群益98售01  ,0,0,0,0,0,0,0,0,0,-26000,0,0,0,0,26000,-26000,-26000
06336P,鴻海元大98售05  ,0,0,0,0,0,0,0,0,0,-26000,0,0,0,5000,31000,-26000,-26000
06034P,世芯凱基96售03  ,0,0,0,0,0,0,0,0,0,-26000,0,0,0,0,26000,-26000,-26000
2433,互盛電          ,7000,33000,-26000,0,0,0,0,0,0,0,0,0,0,0,0,0,-26000
2415,錩新            ,0,27000,-27000,0,0,0,0,0,0,1000,1000,0,1000,0,0,0,-26000
3002,歐格            ,7000,33000,-26000,0,0,0,0,0,0,0,0,0,0,0,0,0,-26000
4763,材料-KY         ,6000,34000,-28000,0,0,0,0,0,0,2000,2000,0,2000,0,0,0,-26000
056250,瑞昱兆豐97購02  ,0,0,0,0,0,0,0,0,0,-27000,0,0,0,83000,110000,-27000,-27000
055304,瑞昱第一98購01  ,0,0,0,0,0,0,0,0,0,-27000,0,0,0,1000,28000,-27000,-27000
054672,華新科國泰99購01,0,0,0,0,0,0,0,0,0,-27000,0,0,0,6000,33000,-27000,-27000
04541P,智易永豐94售03  ,0,0,0,0,0,0,0,0,0,-27000,0,0,0,0,27000,-27000,-27000
046187,友達凱基93購03  ,0,0,0,0,0,0,0,0,0,-27000,0,0,0,3000,30000,-27000,-27000
044758,玉山金凱基93購01,0,0,0,0,0,0,0,0,0,-27000,0,0,0,13000,40000,-27000,-27000
051541,GIS國票96購02   ,0,0,0,0,0,0,0,0,0,-27000,0,0,0,0,27000,-27000,-27000
051126,訊連群益95購01  ,0,0,0,0,0,0,0,0,0,-27000,0,0,0,0,27000,-27000,-27000
050933,南亞國票95購01  ,0,0,0,0,0,0,0,0,0,-27000,0,0,0,23000,50000,-27000,-27000
054158,國巨日盛99購01  ,0,0,0,0,0,0,0,0,0,-27000,0,0,0,100000,127000,-27000,-27000
054192,國巨中信98購01  ,0,0,0,0,0,0,0,0,0,-27000,0,0,0,17000,44000,-27000,-27000
053381,友達元大9A購02  ,0,0,0,0,0,0,0,0,0,-27000,0,0,0,25000,52000,-27000,-27000
053493,智邦兆豐97購02  ,0,0,0,0,0,0,0,0,0,-27000,0,0,0,27000,54000,-27000,-27000
053259,卜蜂群益97購01  ,0,0,0,0,0,0,0,0,0,-27000,0,0,0,2000,29000,-27000,-27000
052364,全新國票95購02  ,0,0,0,0,0,0,0,0,0,-27000,0,0,0,20000,47000,-27000,-27000
052978,貿聯麥證97購01  ,0,0,0,0,27000,-27000,0,0,0,-27000,0,0,0,0,27000,-27000,-27000
053165,大立光群益96購03,0,0,0,0,0,0,0,0,0,-27000,0,0,0,57000,84000,-27000,-27000
053150,聯發科元大96購11,0,0,0,0,0,0,0,0,0,-27000,0,0,0,93000,120000,-27000,-27000
4976,佳凌            ,24000,51000,-27000,0,0,0,0,0,0,0,0,0,0,0,0,0,-27000
4141,龍燈-KY         ,17000,44000,-27000,0,0,0,0,0,0,0,0,0,0,0,0,0,-27000
3167,大量            ,12000,39000,-27000,0,0,0,0,0,0,0,0,0,0,0,0,0,-27000
2397,友通            ,1000,28000,-27000,0,0,0,0,0,0,0,0,0,0,0,0,0,-27000
2528,皇普            ,5000,32000,-27000,0,0,0,0,0,0,0,0,0,0,0,0,0,-27000
2546,根基            ,5000,32000,-27000,0,0,0,0,0,0,0,0,0,0,0,0,0,-27000
06134P,緯穎元富97售03  ,0,0,0,0,0,0,0,0,0,-27000,0,0,0,0,27000,-27000,-27000
054739,義隆凱基98購02  ,0,0,0,0,0,0,0,0,0,-28000,0,0,0,128000,156000,-28000,-28000
054824,同欣電元大97購04,0,0,0,0,0,0,0,0,0,-28000,0,0,0,22000,50000,-28000,-28000
055119,力成凱基98購01  ,0,0,0,0,0,0,0,0,0,-28000,0,0,0,5000,33000,-28000,-28000
055274,華泰元大97購02  ,0,0,0,0,0,0,0,0,0,-28000,0,0,0,73000,101000,-28000,-28000
055631,創意永豐98購01  ,0,0,0,0,0,0,0,0,0,-28000,0,0,0,45000,73000,-28000,-28000
056316,訊芯元大98購03  ,0,0,0,0,0,0,0,0,0,-28000,0,0,0,72000,100000,-28000,-28000
05657P,樺漢統一97售01  ,0,0,0,0,0,0,0,0,0,-28000,0,0,0,30000,58000,-28000,-28000
05705P,上証2X永豐96售03,0,0,0,0,0,0,0,0,0,-28000,0,0,0,12000,40000,-28000,-28000
040160,SP黃豆元富95購01,0,0,0,0,0,0,0,0,0,-28000,0,0,0,5000,33000,-28000,-28000
04451P,可成凱基94售04  ,0,0,0,0,0,0,0,0,0,-28000,0,0,0,8000,36000,-28000,-28000
047714,禾伸堂凱基93購03,0,0,0,0,0,0,0,0,0,-28000,0,0,0,3000,31000,-28000,-28000
047387,美律元大93購05  ,0,0,0,0,0,0,0,0,0,-28000,0,0,0,89000,117000,-28000,-28000
048137,力成國票93購01  ,0,0,0,0,0,0,0,0,0,-28000,0,0,0,5000,33000,-28000,-28000
051305,訊連凱基96購01  ,0,0,0,0,0,0,0,0,0,-28000,0,0,0,3000,31000,-28000,-28000
052603,鴻海元大96購15  ,0,0,0,0,0,0,0,0,0,-28000,0,0,0,40000,68000,-28000,-28000
052369,矽力國票96購02  ,0,0,0,0,0,0,0,0,0,-28000,0,0,0,17000,45000,-28000,-28000
053745,康友國票97購01  ,0,0,0,0,0,0,0,0,0,-28000,0,0,0,1000,29000,-28000,-28000
1540,喬福            ,6000,34000,-28000,0,0,0,0,0,0,0,0,0,0,0,0,0,-28000
2495,普安            ,21000,50000,-29000,0,0,0,0,0,0,1000,1000,0,1000,0,0,0,-28000
2465,麗臺            ,4000,32000,-28000,0,0,0,0,0,0,0,0,0,0,0,0,0,-28000
1701,中化            ,130000,156000,-26000,0,0,0,0,0,0,-2000,0,2000,-2000,0,0,0,-28000
4108,懷特            ,9000,37000,-28000,0,0,0,0,0,0,0,0,0,0,0,0,0,-28000
4722,國精化          ,1000,29000,-28000,0,0,0,0,0,0,0,0,0,0,0,0,0,-28000
5706,鳳凰            ,6000,36000,-30000,0,0,0,0,0,0,2000,2000,0,2000,0,0,0,-28000
056505,聯發科永豐98購01,0,0,0,0,0,0,0,0,0,-29000,0,0,0,853000,882000,-29000,-29000
055910,瑞昱凱基98購01  ,0,0,0,0,0,0,0,0,0,-29000,0,0,0,43000,72000,-29000,-29000
05530P,臺股指群益96售03,0,0,0,0,0,0,0,0,0,-29000,0,0,0,219000,248000,-29000,-29000
05521P,創意永豐96售01  ,0,0,0,0,0,0,0,0,0,-29000,0,0,0,0,29000,-29000,-29000
055013,訊連元富97購01  ,0,0,0,0,0,0,0,0,0,-29000,0,0,0,22000,51000,-29000,-29000
05468P,鴻海元大96售14  ,0,0,0,0,0,0,0,0,0,-29000,0,0,0,955000,984000,-29000,-29000
047196,上銀統一97購01  ,0,0,0,0,0,0,0,0,0,-29000,0,0,0,598000,627000,-29000,-29000
047316,大立光元大94購01,0,0,0,0,0,0,0,0,0,-29000,0,0,0,1000,30000,-29000,-29000
047306,儒鴻元大93購03  ,0,0,0,0,0,0,0,0,0,-29000,0,0,0,1000,30000,-29000,-29000
047809,瑞昱凱基93購08  ,0,0,0,0,0,0,0,0,0,-29000,0,0,0,25000,54000,-29000,-29000
045967,日電貿凱基92購01,0,0,0,0,0,0,0,0,0,-29000,0,0,0,1000,30000,-29000,-29000
045718,瑞昱凱基92購01  ,0,0,0,0,0,0,0,0,0,-29000,0,0,0,11000,40000,-29000,-29000
020008,元大特股高息N   ,0,0,0,0,0,0,0,0,0,-29000,0,0,0,3000,32000,-29000,-29000
04150P,燿華康和93售01  ,0,0,0,0,0,0,0,0,0,-29000,0,0,0,0,29000,-29000,-29000
04499P,滬深2X統一94售03,0,0,0,0,0,0,0,0,0,-29000,0,0,0,0,29000,-29000,-29000
05140P,台表科國票96售01,0,0,0,0,0,0,0,0,0,-29000,0,0,0,50000,79000,-29000,-29000
051252,健鼎元大95購01  ,0,0,0,0,0,0,0,0,0,-29000,0,0,0,11000,40000,-29000,-29000
050155,華新科群益95購01,0,0,0,0,0,0,0,0,0,-29000,0,0,0,16000,45000,-29000,-29000
053818,富邦金群益98購01,0,0,0,0,0,0,0,0,0,-29000,0,0,0,81000,110000,-29000,-29000
05409P,京元電元富95售05,0,0,0,0,0,0,0,0,0,-29000,0,0,0,30000,59000,-29000,-29000
052135,聯發科凱基9B購01,0,0,0,0,0,0,0,0,0,-29000,0,0,0,88000,117000,-29000,-29000
6128,上福            ,3000,32000,-29000,0,0,0,0,0,0,0,0,0,0,0,0,0,-29000
6142,友勁            ,2000,55000,-53000,0,0,0,0,0,0,24000,25000,1000,24000,0,0,0,-29000
5007,三星            ,5000,34000,-29000,0,0,0,0,0,0,0,0,0,0,0,0,0,-29000
3305,昇貿            ,4000,33000,-29000,0,0,0,0,0,0,0,0,0,0,0,0,0,-29000
1615,大山            ,7000,50000,-43000,0,0,0,0,0,0,14000,14000,0,14000,0,0,0,-29000
2010,春源            ,39000,68000,-29000,0,0,0,0,0,0,0,0,0,0,0,0,0,-29000
2227,裕日車          ,14000,64000,-50000,0,0,0,0,0,0,21000,21000,0,21000,0,0,0,-29000
2471,資通            ,10000,39000,-29000,0,0,0,0,0,0,0,0,0,0,0,0,0,-29000
2493,揚博            ,7000,36000,-29000,0,0,0,0,0,0,0,0,0,0,0,0,0,-29000
06506P,台郡國票99售02  ,0,0,0,0,0,0,0,0,0,-29000,0,0,0,0,29000,-29000,-29000
054516,國巨元大97購02  ,0,0,0,0,0,0,0,0,0,-30000,0,0,0,20000,50000,-30000,-30000
05454P,奇鋐群益95售04  ,0,0,0,0,0,0,0,0,0,-30000,0,0,0,0,30000,-30000,-30000
054911,敬鵬凱基97購01  ,0,0,0,0,0,0,0,0,0,-30000,0,0,0,70000,100000,-30000,-30000
054947,興勤元大97購01  ,0,0,0,0,0,0,0,0,0,-30000,0,0,0,0,30000,-30000,-30000
054902,億光康和97購01  ,0,0,0,0,0,0,0,0,0,-30000,0,0,0,0,30000,-30000,-30000
055237,晶豪科台新97購01,0,0,0,0,0,0,0,0,0,-30000,0,0,0,70000,100000,-30000,-30000
05558P,鴻海麥證96售01  ,0,0,0,0,30000,-30000,0,0,0,-30000,0,0,0,0,30000,-30000,-30000
055508,矽力元大97購01  ,0,0,0,0,0,0,0,0,0,-30000,0,0,0,21000,51000,-30000,-30000
055506,台郡元大99購02  ,0,0,0,0,0,0,0,0,0,-30000,0,0,0,75000,105000,-30000,-30000
055777,冠德凱基97購01  ,0,0,0,0,0,0,0,0,0,-30000,0,0,0,0,30000,-30000,-30000
055834,國巨元大97購13  ,0,0,0,0,0,0,0,0,0,-30000,0,0,0,114000,144000,-30000,-30000
056322,臺股指群益98購01,0,0,0,0,0,0,0,0,0,-30000,0,0,0,0,30000,-30000,-30000
05624P,同欣電中信98售01,0,0,0,0,0,0,0,0,0,-30000,0,0,0,0,30000,-30000,-30000
056533,友達凱基9A購02  ,0,0,0,0,0,0,0,0,0,-30000,0,0,0,0,30000,-30000,-30000
05653P,華邦電統一96售02,2000,0,2000,0,0,0,0,0,0,-32000,0,0,0,27000,59000,-32000,-30000
056700,華新科國泰99購03,0,0,0,0,0,0,0,0,0,-30000,0,0,0,10000,40000,-30000,-30000
056703,群創國泰9A購01  ,0,0,0,0,0,0,0,0,0,-30000,0,0,0,0,30000,-30000,-30000
05689P,滬深2X中信97售02,0,0,0,0,0,0,0,0,0,-30000,0,0,0,0,30000,-30000,-30000
04464P,可成元富94售04  ,0,0,0,0,0,0,0,0,0,-30000,0,0,0,0,30000,-30000,-30000
04477P,南電元大94售04  ,0,0,0,0,0,0,0,0,0,-30000,0,0,0,0,30000,-30000,-30000
044768,深中小元大94購02,0,0,0,0,0,0,0,0,0,-30000,0,0,0,0,30000,-30000,-30000
04476P,玉晶光元大94售05,0,0,0,0,0,0,0,0,0,-30000,0,0,0,0,30000,-30000,-30000
03804P,聯發科統一93售01,0,0,0,0,0,0,0,0,0,-30000,0,0,0,0,30000,-30000,-30000
03427P,聯電元大02售11  ,0,0,0,0,0,0,0,0,0,-30000,0,0,0,200000,230000,-30000,-30000
04027P,亞德客凱基93售05,0,0,0,0,0,0,0,0,0,-30000,0,0,0,0,30000,-30000,-30000
03882P,鴻海元大93售10  ,0,0,0,0,0,0,0,0,0,-30000,0,0,0,0,30000,-30000,-30000
04439P,聯發科群益94售04,0,0,0,0,0,0,0,0,0,-30000,0,0,0,21000,51000,-30000,-30000
046387,臻鼎凱基92購04  ,0,0,0,0,0,0,0,0,0,-30000,0,0,0,10000,40000,-30000,-30000
043171,冠德國泰93購01  ,0,0,0,0,0,0,0,0,0,-30000,0,0,0,0,30000,-30000,-30000
04413P,玉晶光元富94售01,0,0,0,0,0,0,0,0,0,-30000,0,0,0,20000,50000,-30000,-30000
046699,臻鼎凱基93購03  ,0,0,0,0,0,0,0,0,0,-30000,0,0,0,20000,50000,-30000,-30000
046682,聯發科群益93購03,0,0,0,0,0,0,0,0,0,-30000,0,0,0,0,30000,-30000,-30000
046734,華通國票93購02  ,0,0,0,0,0,0,0,0,0,-30000,0,0,0,0,30000,-30000,-30000
046738,台積電群益93購05,0,0,0,0,0,0,0,0,0,-30000,0,0,0,0,30000,-30000,-30000
046882,智易富邦97購01  ,0,0,0,0,0,0,0,0,0,-30000,0,0,0,0,30000,-30000,-30000
04852P,臻鼎永豐94售02  ,0,0,0,0,0,0,0,0,0,-30000,0,0,0,0,30000,-30000,-30000
05037P,華新科元大95售09,0,0,0,0,0,0,0,0,0,-30000,0,0,0,20000,50000,-30000,-30000
050450,富邦金元大94購03,0,0,0,0,0,0,0,0,0,-30000,0,0,0,0,30000,-30000,-30000
050190,麗豐元大95購02  ,0,0,0,0,0,0,0,0,0,-30000,0,0,0,499000,529000,-30000,-30000
051158,嘉晶富邦96購01  ,0,0,0,0,0,0,0,0,0,-30000,0,0,0,0,30000,-30000,-30000
050518,台積電元大94購28,0,0,0,0,0,0,0,0,0,-30000,0,0,0,280000,310000,-30000,-30000
050534,臻鼎兆豐94購01  ,0,0,0,0,0,0,0,0,0,-30000,0,0,0,0,30000,-30000,-30000
04868P,可成統一94售03  ,0,0,0,0,0,0,0,0,0,-30000,0,0,0,0,30000,-30000,-30000
048678,統一富邦93購01  ,0,0,0,0,0,0,0,0,0,-30000,0,0,0,10000,40000,-30000,-30000
051009,緯創麥證95購01  ,0,0,0,0,30000,-30000,0,0,0,-30000,0,0,0,0,30000,-30000,-30000
048381,T50反1國票94購03,0,0,0,0,0,0,0,0,0,-30000,0,0,0,0,30000,-30000,-30000
048348,矽力元大93購03  ,0,0,0,0,0,0,0,0,0,-30000,0,0,0,0,30000,-30000,-30000
048133,臻鼎國票94購01  ,0,0,0,0,0,0,0,0,0,-30000,0,0,0,0,30000,-30000,-30000
04839P,大立光元大94售17,0,0,0,0,0,0,0,0,0,-30000,0,0,0,15000,45000,-30000,-30000
04803P,台積電凱基94售30,0,0,0,0,0,0,0,0,0,-30000,0,0,0,0,30000,-30000,-30000
049424,中石化兆豐94購01,0,0,0,0,0,0,0,0,0,-30000,0,0,0,0,30000,-30000,-30000
049431,光罩國票96購01  ,0,0,0,0,0,0,0,0,0,-30000,0,0,0,0,30000,-30000,-30000
049225,達方國票94購01  ,0,0,0,0,0,0,0,0,0,-30000,0,0,0,0,30000,-30000,-30000
051617,台積電凱基95購14,0,0,0,0,0,0,0,0,0,-30000,0,0,0,10000,40000,-30000,-30000
051692,深中小統一95購01,0,0,0,0,0,0,0,0,0,-30000,0,0,0,30000,60000,-30000,-30000
049049,玉晶光康和94購02,0,0,0,0,0,0,0,0,0,-30000,0,0,0,70000,100000,-30000,-30000
049448,光磊統一94購01  ,0,0,0,0,0,0,0,0,0,-30000,0,0,0,60000,90000,-30000,-30000
04932P,香港2X中信96售01,0,0,0,0,0,0,0,0,0,-30000,0,0,0,0,30000,-30000,-30000
049395,元油2X群益94購03,0,0,0,0,0,0,0,0,0,-30000,0,0,0,0,30000,-30000,-30000
050133,鈺齊凱基94購01  ,0,0,0,0,0,0,0,0,0,-30000,0,0,0,30000,60000,-30000,-30000
048865,世紀鋼群益94購01,0,0,0,0,0,0,0,0,0,-30000,0,0,0,0,30000,-30000,-30000
048951,宏全永豐94購01  ,0,0,0,0,0,0,0,0,0,-30000,0,0,0,0,30000,-30000,-30000
052133,華邦電凱基9B購01,0,0,0,0,0,0,0,0,0,-30000,0,0,0,35000,65000,-30000,-30000
052122,新光金國票96購01,0,0,0,0,0,0,0,0,0,-30000,0,0,0,0,30000,-30000,-30000
052380,臺股指元大95購21,0,0,0,0,0,0,0,0,0,-30000,0,0,0,0,30000,-30000,-30000
052471,華固亞東95購01  ,0,0,0,0,0,0,0,0,0,-30000,0,0,0,0,30000,-30000,-30000
051795,T50反1台新05購02,0,0,0,0,0,0,0,0,0,-30000,0,0,0,0,30000,-30000,-30000
051961,泰碩永豐95購01  ,0,0,0,0,0,0,0,0,0,-30000,0,0,0,0,30000,-30000,-30000
052604,建準元大97購01  ,0,0,0,0,0,0,0,0,0,-30000,0,0,0,8000,38000,-30000,-30000
052689,玉晶光元大98購03,0,0,0,0,0,0,0,0,0,-30000,0,0,0,0,30000,-30000,-30000
052822,泰碩永豐97購01  ,0,0,0,0,0,0,0,0,0,-30000,0,0,0,0,30000,-30000,-30000
053152,大立光元大99購01,0,0,0,0,0,0,0,0,0,-30000,0,0,0,22000,52000,-30000,-30000
052967,智邦群益96購01  ,0,0,0,0,0,0,0,0,0,-30000,0,0,0,79000,109000,-30000,-30000
052908,大成鋼統一96購01,0,0,0,0,0,0,0,0,0,-30000,0,0,0,0,30000,-30000,-30000
054063,聯茂國票97購02  ,0,0,0,0,0,0,0,0,0,-30000,0,0,0,30000,60000,-30000,-30000
054031,中鋼中信98購01  ,0,0,0,0,0,0,0,0,0,-30000,0,0,0,20000,50000,-30000,-30000
053926,晶相光國票97購01,0,0,0,0,0,0,0,0,0,-30000,0,0,0,76000,106000,-30000,-30000
053934,A50正2元富96購02,0,0,0,0,0,0,0,0,0,-30000,0,0,0,0,30000,-30000,-30000
053884,緯穎第一96購01  ,0,0,0,0,0,0,0,0,0,-30000,0,0,0,60000,90000,-30000,-30000
054474,鴻海中信96購03  ,0,0,0,0,0,0,0,0,0,-30000,0,0,0,0,30000,-30000,-30000
053762,T50反1富邦97購01,0,0,0,0,0,0,0,0,0,-30000,0,0,0,500000,530000,-30000,-30000
053252,華邦電國泰98購01,0,0,0,0,0,0,0,0,0,-30000,0,0,0,20000,50000,-30000,-30000
053236,群創永豐97購02  ,0,0,0,0,0,0,0,0,0,-30000,0,0,0,0,30000,-30000,-30000
053342,全新國票99購01  ,0,0,0,0,0,0,0,0,0,-30000,0,0,0,0,30000,-30000,-30000
053279,景碩元大97購01  ,0,0,0,0,0,0,0,0,0,-30000,0,0,0,749000,779000,-30000,-30000
053389,彩晶元大98購01  ,0,0,0,0,0,0,0,0,0,-30000,0,0,0,0,30000,-30000,-30000
1452,宏益            ,0,30000,-30000,0,0,0,0,0,0,0,0,0,0,0,0,0,-30000
1416,廣豐            ,7000,37000,-30000,0,0,0,0,0,0,0,0,0,0,0,0,0,-30000
06202P,大立光元大98售06,0,0,0,0,0,0,0,0,0,-30000,0,0,0,256000,286000,-30000,-30000
06176P,台積電元大97售22,0,0,0,0,0,0,0,0,0,-30000,0,0,0,0,30000,-30000,-30000
2530,華建            ,2000,32000,-30000,0,0,0,0,0,0,0,0,0,0,0,0,0,-30000
2506,太設            ,2000,32000,-30000,0,0,0,0,0,0,0,0,0,0,0,0,0,-30000
2509,全坤建          ,4000,34000,-30000,0,0,0,0,0,0,0,0,0,0,0,0,0,-30000
4144,康聯-KY         ,0,30000,-30000,0,0,0,0,0,0,0,0,0,0,0,0,0,-30000
3209,全科            ,22000,52000,-30000,0,0,0,0,0,0,0,0,0,0,0,0,0,-30000
6257,矽格            ,662000,734000,-72000,0,0,0,0,0,0,42000,79000,28000,51000,13000,22000,-9000,-30000
05800P,台積電兆豐96售04,0,0,0,0,0,0,0,0,0,-31000,0,0,0,19000,50000,-31000,-31000
056500,大立光富邦9B購02,0,0,0,0,0,0,0,0,0,-31000,0,0,0,10000,41000,-31000,-31000
055584,國巨元大97購11  ,0,0,0,0,0,0,0,0,0,-31000,0,0,0,64000,95000,-31000,-31000
05519P,上証2X凱基98售01,0,0,0,0,0,0,0,0,0,-31000,0,0,0,0,31000,-31000,-31000
05515P,台積電群益96售03,0,0,0,0,0,0,0,0,0,-31000,0,0,0,41000,72000,-31000,-31000
050715,台積電群益96購01,0,0,0,0,0,0,0,0,0,-31000,0,0,0,259000,290000,-31000,-31000
046671,彩晶元大93購03  ,0,0,0,0,0,0,0,0,0,-31000,0,0,0,0,31000,-31000,-31000
045401,大立光兆豐93購01,0,0,0,0,0,0,0,0,0,-31000,0,0,0,0,31000,-31000,-31000
047541,深中小凱基94購01,0,0,0,0,0,0,0,0,0,-31000,0,0,0,90000,121000,-31000,-31000
03016P,滬深2X群益01售09,0,0,0,0,0,0,0,0,0,-31000,0,0,0,0,31000,-31000,-31000
050663,麗豐元大96購03  ,0,0,0,0,0,0,0,0,0,-31000,0,0,0,100000,131000,-31000,-31000
050976,台光電統一95購01,0,0,0,0,0,0,0,0,0,-31000,0,0,0,69000,100000,-31000,-31000
053232,友達永豐97購02  ,0,0,0,0,0,0,0,0,0,-31000,0,0,0,50000,81000,-31000,-31000
053901,T50反1凱基99購03,0,0,0,0,0,0,0,0,0,-31000,0,0,0,172000,203000,-31000,-31000
052972,義隆群益96購04  ,0,0,0,0,0,0,0,0,0,-31000,0,0,0,274000,305000,-31000,-31000
053027,玉晶光富邦98購01,0,0,0,0,0,0,0,0,0,-31000,0,0,0,0,31000,-31000,-31000
051769,矽力元大95購01  ,0,0,0,0,0,0,0,0,0,-31000,0,0,0,5000,36000,-31000,-31000
052398,瑞昱凱基95購06  ,0,0,0,0,0,0,0,0,0,-31000,0,0,0,36000,67000,-31000,-31000
052404,臻鼎凱基95購05  ,0,0,0,0,0,0,0,0,0,-31000,0,0,0,65000,96000,-31000,-31000
052308,大立光國泰97購02,0,0,0,0,0,0,0,0,0,-31000,0,0,0,53000,84000,-31000,-31000
8103,瀚荃            ,5000,37000,-32000,0,0,0,0,0,0,1000,1000,0,1000,0,0,0,-31000
9942,茂順            ,3000,34000,-31000,0,0,0,0,0,0,0,0,0,0,0,0,0,-31000
06093P,華通元富97售03  ,0,0,0,0,0,0,0,0,0,-31000,0,0,0,4000,35000,-31000,-31000
1340,勝悅-KY         ,8000,40000,-32000,0,0,0,0,0,0,1000,1000,0,1000,0,0,0,-31000
1603,華電            ,1000,32000,-31000,0,0,0,0,0,0,0,0,0,0,0,0,0,-31000
055628,旺宏永豐97購01  ,0,0,0,0,0,0,0,0,0,-32000,0,0,0,28000,60000,-32000,-32000
055531,華新科群益98購03,0,0,0,0,0,0,0,0,0,-32000,0,0,0,16000,48000,-32000,-32000
056561,台光電群益98購02,0,0,0,0,0,0,0,0,0,-32000,0,0,0,10000,42000,-32000,-32000
056701,國產國泰9A購01  ,0,0,0,0,0,0,0,0,0,-32000,0,0,0,0,32000,-32000,-32000
05981P,可成永昌98售02  ,0,0,0,0,0,0,0,0,0,-32000,0,0,0,32000,64000,-32000,-32000
055983,全新元富9A購02  ,0,0,0,0,0,0,0,0,0,-32000,0,0,0,20000,52000,-32000,-32000
056008,全新中信9B購01  ,0,0,0,0,0,0,0,0,0,-32000,0,0,0,48000,80000,-32000,-32000
03417B,臺股指凱基95熊19,0,0,0,0,0,0,0,0,0,-32000,0,0,0,21000,53000,-32000,-32000
04314P,聯茂元富93售01  ,0,0,0,0,0,0,0,0,0,-32000,0,0,0,26000,58000,-32000,-32000
047437,旺宏元大94購02  ,0,0,0,0,0,0,0,0,0,-32000,0,0,0,48000,80000,-32000,-32000
045522,滬深2X永豐94購01,0,0,0,0,0,0,0,0,0,-32000,0,0,0,38000,70000,-32000,-32000
054419,嘉聯益元大98購02,0,0,0,0,0,0,0,0,0,-32000,0,0,0,143000,175000,-32000,-32000
053422,可成永豐96購01  ,0,0,0,0,0,0,0,0,0,-32000,0,0,0,68000,100000,-32000,-32000
1307,三芳            ,8000,39000,-31000,0,0,0,0,0,0,-1000,0,1000,-1000,0,0,0,-32000
06359P,上銀群益97售03  ,0,0,0,0,0,0,0,0,0,-32000,0,0,0,16000,48000,-32000,-32000
06384P,訊芯元富97售03  ,0,0,0,0,0,0,0,0,0,-32000,0,0,0,0,32000,-32000,-32000
4999,鑫禾            ,1000,33000,-32000,0,0,0,0,0,0,0,0,0,0,0,0,0,-32000
6133,金橋            ,1000,33000,-32000,0,0,0,0,0,0,0,0,0,0,0,0,0,-32000
5608,四維航          ,16000,48000,-32000,0,0,0,0,0,0,0,0,0,0,0,0,0,-32000
1256,鮮活果汁-KY     ,11000,43400,-32400,0,0,0,0,0,0,0,0,0,0,0,0,0,-32400
056121,勤誠群益97購01  ,0,0,0,0,0,0,0,0,0,-33000,0,0,0,0,33000,-33000,-33000
05587P,鴻海凱基96售12  ,0,0,0,0,0,0,0,0,0,-33000,0,0,0,90000,123000,-33000,-33000
056507,創意永豐98購02  ,0,0,0,0,0,0,0,0,0,-33000,0,0,0,109000,142000,-33000,-33000
05553P,智原群益96售01  ,0,0,0,0,0,0,0,0,0,-33000,0,0,0,0,33000,-33000,-33000
046287,禾伸堂兆豐92購01,0,0,0,0,0,0,0,0,0,-33000,0,0,0,20000,53000,-33000,-33000
04614P,光罩群益94售02  ,0,0,0,0,0,0,0,0,0,-33000,0,0,0,0,33000,-33000,-33000
046903,友達凱基99購01  ,0,0,0,0,0,0,0,0,0,-33000,0,0,0,10000,43000,-33000,-33000
04201P,智原群益93售01  ,0,0,0,0,0,0,0,0,0,-33000,0,0,0,0,33000,-33000,-33000
051099,台郡元大95購03  ,0,0,0,0,0,0,0,0,0,-33000,0,0,0,41000,74000,-33000,-33000
054064,台郡國票97購04  ,0,0,0,0,0,0,0,0,0,-33000,0,0,0,5000,38000,-33000,-33000
051904,深100元大95購01 ,0,0,0,0,0,0,0,0,0,-33000,0,0,0,0,33000,-33000,-33000
05200P,臺股指永豐95售03,0,0,0,0,0,0,0,0,0,-33000,0,0,0,3000,36000,-33000,-33000
052750,臺股指元大96購04,0,0,0,0,0,0,0,0,0,-33000,0,0,0,15000,48000,-33000,-33000
06477P,緯穎國票99售02  ,0,0,0,0,0,0,0,0,0,-33000,0,0,0,0,33000,-33000,-33000
06106P,國巨群益97售02  ,0,0,0,0,0,0,0,0,0,-33000,0,0,0,10000,43000,-33000,-33000
06148P,台積電元大97售17,0,0,0,0,0,0,0,0,0,-33000,0,0,0,4000,37000,-33000,-33000
06184P,大立光元大97售06,0,0,0,0,0,0,0,0,0,-33000,0,0,0,27000,60000,-33000,-33000
3032,偉訓            ,9000,42000,-33000,0,0,0,0,0,0,0,0,0,0,0,0,0,-33000
2613,中櫃            ,3000,36000,-33000,0,0,0,0,0,0,0,0,0,0,0,0,0,-33000
2636,台驊投控        ,7000,40000,-33000,0,0,0,0,0,0,0,0,0,0,0,0,0,-33000
2028,威致            ,0,30000,-30000,0,0,0,0,0,0,-3000,0,3000,-3000,0,0,0,-33000
5288,豐祥-KY         ,2000,35000,-33000,0,0,0,0,0,0,0,0,0,0,0,0,0,-33000
9937,全國            ,0,33000,-33000,0,0,0,0,0,0,0,0,0,0,0,0,0,-33000
9925,新保            ,11000,43000,-32000,0,0,0,0,0,0,-1000,0,1000,-1000,0,0,0,-33000
054860,台積電群益98購01,0,0,0,0,0,0,0,0,0,-34000,0,0,0,240000,274000,-34000,-34000
054757,南亞國票98購01  ,0,0,0,0,0,0,0,0,0,-34000,0,0,0,12000,46000,-34000,-34000
056634,為升兆豐99購01  ,0,0,0,0,0,0,0,0,0,-34000,0,0,0,86000,120000,-34000,-34000
05913P,國巨元大96售11  ,0,0,0,0,0,0,0,0,0,-34000,0,0,0,0,34000,-34000,-34000
05610P,國巨群益98售01  ,0,0,0,0,0,0,0,0,0,-34000,0,0,0,20000,54000,-34000,-34000
056065,奇鋐元大97購01  ,0,0,0,0,0,0,0,0,0,-34000,0,0,0,112000,146000,-34000,-34000
04230P,臺股指中信95售06,0,0,0,0,0,0,0,0,0,-34000,0,0,0,44000,78000,-34000,-34000
046650,台表科國泰94購01,0,0,0,0,0,0,0,0,0,-34000,0,0,0,75000,109000,-34000,-34000
049670,鈺齊國泰96購01  ,0,0,0,0,0,0,0,0,0,-34000,0,0,0,3000,37000,-34000,-34000
051220,大立光元富95購08,0,0,0,0,0,0,0,0,0,-34000,0,0,0,6000,40000,-34000,-34000
04819P,嘉澤永豐94售01  ,0,0,0,0,0,0,0,0,0,-34000,0,0,0,0,34000,-34000,-34000
051350,台積電元大95購14,0,0,0,0,0,0,0,0,0,-34000,0,0,0,343000,377000,-34000,-34000
051703,台積電群益95購04,0,0,0,0,0,0,0,0,0,-34000,0,0,0,5000,39000,-34000,-34000
05251P,喬山台新95售02  ,0,0,0,0,0,0,0,0,0,-34000,0,0,0,5000,39000,-34000,-34000
051861,鴻海凱基98購01  ,0,0,0,0,0,0,0,0,0,-34000,0,0,0,30000,64000,-34000,-34000
05416P,喬山永豐95售04  ,0,0,0,0,0,0,0,0,0,-34000,0,0,0,10000,44000,-34000,-34000
05374P,台積電國票96售07,0,0,0,0,0,0,0,0,0,-34000,0,0,0,0,34000,-34000,-34000
053781,友達元大9B購03  ,0,0,0,0,0,0,0,0,0,-34000,0,0,0,131000,165000,-34000,-34000
5305,敦南            ,44000,78000,-34000,0,0,0,0,0,0,0,0,0,0,0,0,0,-34000
6243,迅杰            ,4000,38000,-34000,0,0,0,0,0,0,0,0,0,0,0,0,0,-34000
2373,震旦行          ,9000,43000,-34000,0,0,0,0,0,0,0,0,0,0,0,0,0,-34000
4526,東台            ,1000,35000,-34000,0,0,0,0,0,0,0,0,0,0,0,0,0,-34000
06150P,奇力新元大97售06,0,0,0,0,0,0,0,0,0,-34000,0,0,0,1000,35000,-34000,-34000
1419,新紡            ,10000,44000,-34000,0,0,0,0,0,0,0,0,0,0,0,0,0,-34000
055942,臺股指群益9C購01,0,0,0,0,0,0,0,0,0,-35000,0,0,0,2000,37000,-35000,-35000
056400,道瓊反群益9C購01,0,0,0,0,0,0,0,0,0,-35000,0,0,0,5000,40000,-35000,-35000
05973P,聯詠元大96售06  ,0,0,0,0,0,0,0,0,0,-35000,0,0,0,0,35000,-35000,-35000
05841P,華通元大96售04  ,0,0,0,0,0,0,0,0,0,-35000,0,0,0,13000,48000,-35000,-35000
056597,宏碁元富98購01  ,0,0,0,0,0,0,0,0,0,-35000,0,0,0,21000,56000,-35000,-35000
056689,玉晶光統一9A購03,0,0,0,0,0,0,0,0,0,-35000,0,0,0,0,35000,-35000,-35000
05493P,華新科富邦99售02,0,0,0,0,0,0,0,0,0,-35000,0,0,0,20000,55000,-35000,-35000
055736,宏達電元富99購01,0,0,0,0,0,0,0,0,0,-35000,0,0,0,0,35000,-35000,-35000
055706,大立光永豐97購03,0,0,0,0,0,0,0,0,0,-35000,0,0,0,45000,80000,-35000,-35000
04664P,臺股指國票94售03,0,0,0,0,0,0,0,0,0,-35000,0,0,0,25000,60000,-35000,-35000
045479,T50反1中信95購01,0,0,0,0,0,0,0,0,0,-35000,0,0,0,0,35000,-35000,-35000
04598P,光罩凱基94售03  ,0,0,0,0,0,0,0,0,0,-35000,0,0,0,0,35000,-35000,-35000
04778P,可成凱基94售10  ,0,0,0,0,0,0,0,0,0,-35000,0,0,0,0,35000,-35000,-35000
045768,大立光元富95購02,0,0,0,0,0,0,0,0,0,-35000,0,0,0,0,35000,-35000,-35000
043730,旭富國泰93購01  ,0,0,0,0,0,0,0,0,0,-35000,0,0,0,0,35000,-35000,-35000
051522,玉晶光凱基95購05,0,0,0,0,0,0,0,0,0,-35000,0,0,0,10000,45000,-35000,-35000
048239,嘉澤國票93購01  ,0,0,0,0,0,0,0,0,0,-35000,0,0,0,22000,57000,-35000,-35000
04807P,聯茂元富94售01  ,0,0,0,0,0,0,0,0,0,-35000,0,0,0,49000,84000,-35000,-35000
049704,羅麗芬元大95購01,0,0,0,0,0,0,0,0,0,-35000,0,0,0,0,35000,-35000,-35000
053499,禾伸堂兆豐96購01,0,0,0,0,0,0,0,0,0,-35000,0,0,0,35000,70000,-35000,-35000
053302,國巨凱基96購10  ,0,0,0,0,0,0,0,0,0,-35000,0,0,0,0,35000,-35000,-35000
054198,台積電永昌96購08,0,0,0,0,0,0,0,0,0,-35000,0,0,0,201000,236000,-35000,-35000
053988,友達亞東96購01  ,0,0,0,0,0,0,0,0,0,-35000,0,0,0,60000,95000,-35000,-35000
054290,奇力新元大96購05,0,0,0,0,0,0,0,0,0,-35000,0,0,0,24000,59000,-35000,-35000
054331,世芯永豐96購03  ,0,0,0,0,0,0,0,0,0,-35000,0,0,0,7000,42000,-35000,-35000
051962,晶相光永豐95購02,0,0,0,0,0,0,0,0,0,-35000,0,0,0,54000,89000,-35000,-35000
05206P,南茂元大95售01  ,0,0,0,0,0,0,0,0,0,-35000,0,0,0,0,35000,-35000,-35000
052233,台郡凱基96購01  ,0,0,0,0,0,0,0,0,0,-35000,0,0,0,40000,75000,-35000,-35000
052240,臻鼎國票96購03  ,0,0,0,0,0,0,0,0,0,-35000,0,0,0,0,35000,-35000,-35000
052477,美律群益98購01  ,0,0,0,0,0,0,0,0,0,-35000,0,0,0,0,35000,-35000,-35000
052751,臺股指元大96購05,0,0,0,0,0,0,0,0,0,-35000,0,0,0,0,35000,-35000,-35000
1592,英瑞-KY         ,6000,41000,-35000,0,0,0,0,0,0,0,0,0,0,0,0,0,-35000
06501P,臺股指元大9A售06,0,0,0,0,0,0,0,0,0,-35000,0,0,0,0,35000,-35000,-35000
06353P,電子類富邦99售02,0,0,0,0,0,0,0,0,0,-35000,0,0,0,2000,37000,-35000,-35000
06205P,台積電群益97售03,0,0,0,0,0,0,0,0,0,-35000,0,0,0,10000,45000,-35000,-35000
4104,佳醫            ,19000,54000,-35000,0,0,0,0,0,0,0,0,0,0,0,0,0,-35000
3060,銘異            ,7000,42000,-35000,0,0,0,0,0,0,0,0,0,0,0,0,0,-35000
2358,廷鑫            ,13000,48000,-35000,0,0,0,0,0,0,0,0,0,0,0,0,0,-35000
2423,固緯            ,13000,48000,-35000,0,0,0,0,0,0,0,0,0,0,0,0,0,-35000
2466,冠西電          ,1000,36000,-35000,0,0,0,0,0,0,0,0,0,0,0,0,0,-35000
1903,士紙            ,0,35000,-35000,0,0,0,0,0,0,0,0,0,0,0,0,0,-35000
2007,燁興            ,0,35000,-35000,0,0,0,0,0,0,0,0,0,0,0,0,0,-35000
1760,寶齡富錦        ,18000,51000,-33000,0,0,0,0,0,0,-2000,0,0,0,0,2000,-2000,-35000
1773,勝一            ,7000,42000,-35000,0,0,0,0,0,0,0,0,0,0,0,0,0,-35000
1614,三洋電          ,5000,40000,-35000,0,0,0,0,0,0,0,0,0,0,0,0,0,-35000
1709,和益            ,46000,77000,-31000,0,0,0,0,0,0,-4000,0,4000,-4000,0,0,0,-35000
9930,中聯資源        ,8000,43000,-35000,0,0,0,0,0,0,0,0,0,0,0,0,0,-35000
8411,福貞-KY         ,3000,38000,-35000,0,0,0,0,0,0,0,0,0,0,0,0,0,-35000
056518,美律國票99購01  ,0,0,0,0,0,0,0,0,0,-36000,0,0,0,0,36000,-36000,-36000
05817P,可成凱基96售07  ,0,0,0,0,0,0,0,0,0,-36000,0,0,0,1000,37000,-36000,-36000
056308,TPK元大97購02   ,0,0,0,0,0,0,0,0,0,-36000,0,0,0,100000,136000,-36000,-36000
00680L,元大美債20正2   ,0,0,0,0,0,0,0,0,0,-36000,43000,0,43000,13000,92000,-79000,-36000
046194,禾伸堂凱基92購02,0,0,0,0,0,0,0,0,0,-36000,0,0,0,13000,49000,-36000,-36000
04734P,上海銀兆豐94售02,0,0,0,0,0,0,0,0,0,-36000,0,0,0,0,36000,-36000,-36000
05100P,智邦凱基95售02  ,0,0,0,0,0,0,0,0,0,-36000,0,0,0,18000,54000,-36000,-36000
050944,智邦群益95購01  ,0,0,0,0,0,0,0,0,0,-36000,0,0,0,0,36000,-36000,-36000
050936,國巨國票95購04  ,0,0,0,0,0,0,0,0,0,-36000,0,0,0,0,36000,-36000,-36000
05093P,可成元大95售03  ,0,0,0,0,0,0,0,0,0,-36000,0,0,0,4000,40000,-36000,-36000
048782,亞泥元大94購01  ,0,0,0,0,0,0,0,0,0,-36000,0,0,0,127000,163000,-36000,-36000
051489,世芯凱基95購01  ,0,0,0,0,0,0,0,0,0,-36000,0,0,0,54000,90000,-36000,-36000
04995P,台達電凱基96售03,0,0,0,0,0,0,0,0,0,-36000,0,0,0,0,36000,-36000,-36000
054222,大立光統一98購03,0,0,0,0,0,0,0,0,0,-36000,0,0,0,0,36000,-36000,-36000
2069,運錩            ,5000,41000,-36000,0,0,0,0,0,0,0,0,0,0,0,0,0,-36000
06172P,台虹永豐97售02  ,0,0,0,0,0,0,0,0,0,-36000,0,0,0,0,36000,-36000,-36000
056562,奇力新群益98購01,0,0,0,0,0,0,0,0,0,-37000,0,0,0,410000,447000,-37000,-37000
056569,T50正2元大9B購02,0,0,0,0,0,0,0,0,0,-37000,0,0,0,57000,94000,-37000,-37000
055123,億光兆豐97購01  ,0,0,0,0,0,0,0,0,0,-37000,0,0,0,3000,40000,-37000,-37000
047160,台郡國票94購01  ,0,0,0,0,0,0,0,0,0,-37000,0,0,0,1000,38000,-37000,-37000
050358,致新群益94購01  ,0,0,0,0,0,0,0,0,0,-37000,0,0,0,61000,98000,-37000,-37000
046646,冠德國泰94購01  ,0,0,0,0,0,0,0,0,0,-37000,0,0,0,143000,180000,-37000,-37000
041824,元油2X國票96購01,0,0,0,0,0,0,0,0,0,-37000,0,0,0,80000,117000,-37000,-37000
04360P,易華電永豐94售01,0,0,0,0,0,0,0,0,0,-37000,0,0,0,5000,42000,-37000,-37000
047574,和大群益93購03  ,0,0,0,0,0,0,0,0,0,-37000,0,0,0,3000,40000,-37000,-37000
051490,世芯凱基96購01  ,0,0,0,0,0,0,0,0,0,-37000,0,0,0,16000,53000,-37000,-37000
051268,創意富邦97購01  ,0,0,0,0,0,0,0,0,0,-37000,0,0,0,148000,185000,-37000,-37000
05060P,台達電富邦97售02,0,0,0,0,0,0,0,0,0,-37000,0,0,0,2000,39000,-37000,-37000
04813P,智邦元大94售07  ,0,0,0,0,0,0,0,0,0,-37000,0,0,0,18000,55000,-37000,-37000
054232,台積電群益96購12,0,0,0,0,0,0,0,0,0,-37000,0,0,0,61000,98000,-37000,-37000
05330P,臺股指凱基95售14,0,0,0,0,0,0,0,0,0,-37000,0,0,0,24000,61000,-37000,-37000
053278,禾伸堂元大96購01,0,0,0,0,0,0,0,0,0,-37000,0,0,0,176000,213000,-37000,-37000
052723,新唐統一97購01  ,0,0,0,0,0,0,0,0,0,-37000,0,0,0,81000,118000,-37000,-37000
05284P,鴻海兆豐95售04  ,0,0,0,0,0,0,0,0,0,-37000,0,0,0,23000,60000,-37000,-37000
053140,燿華永豐96購02  ,0,0,0,0,0,0,0,0,0,-37000,0,0,0,0,37000,-37000,-37000
052936,華通兆豐98購01  ,0,0,0,0,0,0,0,0,0,-37000,0,0,0,12000,49000,-37000,-37000
2496,卓越            ,4000,43000,-39000,0,0,0,0,0,0,2000,2000,0,2000,0,0,0,-37000
2414,精技            ,7000,44000,-37000,0,0,0,0,0,0,0,0,0,0,0,0,0,-37000
3679,新至陞          ,8000,45000,-37000,0,0,0,0,0,0,0,0,0,0,0,0,0,-37000
6477,安集            ,25000,62000,-37000,0,0,0,0,0,0,0,0,0,0,0,0,0,-37000
3022,威強電          ,32000,67480,-35480,0,0,0,0,0,0,-2000,0,2000,-2000,0,0,0,-37480
054905,國揚康和97購01  ,0,0,0,0,0,0,0,0,0,-38000,0,0,0,82000,120000,-38000,-38000
055699,康控國票97購04  ,0,0,0,0,0,0,0,0,0,-38000,0,0,0,0,38000,-38000,-38000
055953,上銀元大97購09  ,0,0,0,0,0,0,0,0,0,-38000,0,0,0,265000,303000,-38000,-38000
046574,泰鼎國泰94購01  ,0,0,0,0,0,0,0,0,0,-38000,0,0,0,88000,126000,-38000,-38000
04428P,台光電元大94售02,0,0,0,0,0,0,0,0,0,-38000,0,0,0,23000,61000,-38000,-38000
041452,滬深2X元富93購01,0,0,0,0,0,0,0,0,0,-38000,0,0,0,87000,125000,-38000,-38000
047780,友達中信96購01  ,0,0,0,0,0,0,0,0,0,-38000,0,0,0,0,38000,-38000,-38000
050408,臻鼎台新94購02  ,0,0,0,0,0,0,0,0,0,-38000,0,0,0,0,38000,-38000,-38000
04851P,創意永豐94售02  ,0,0,0,0,0,0,0,0,0,-38000,0,0,0,0,38000,-38000,-38000
049499,康控元大96購01  ,0,0,0,0,0,0,0,0,0,-38000,0,0,0,30000,68000,-38000,-38000
048598,瑞昱國票93購03  ,0,0,0,0,0,0,0,0,0,-38000,0,0,0,9000,47000,-38000,-38000
048014,貿聯國票93購03  ,0,0,0,0,0,0,0,0,0,-38000,0,0,0,0,38000,-38000,-38000
048978,晶相光元大94購02,0,0,0,0,0,0,0,0,0,-38000,0,0,0,12000,50000,-38000,-38000
049837,臺股指凱基96購02,0,0,0,0,0,0,0,0,0,-38000,0,0,0,0,38000,-38000,-38000
052058,臺股指凱基95購16,0,0,0,0,0,0,0,0,0,-38000,0,0,0,191000,229000,-38000,-38000
052005,矽力國泰97購02  ,0,0,0,0,0,0,0,0,0,-38000,0,0,0,2000,40000,-38000,-38000
051793,臻鼎國票95購02  ,0,0,0,0,0,0,0,0,0,-38000,0,0,0,0,38000,-38000,-38000
053485,矽創國票97購04  ,0,0,0,0,0,0,0,0,0,-38000,0,0,0,63000,101000,-38000,-38000
053829,力成麥證96購01  ,0,0,0,42000,80000,-38000,0,0,0,-38000,0,0,0,42000,80000,-38000,-38000
054008,大立光元富96購06,0,0,0,0,0,0,0,0,0,-38000,0,0,0,27000,65000,-38000,-38000
2459,敦吉            ,3000,41000,-38000,0,0,0,0,0,0,0,0,0,0,0,0,0,-38000
2013,中鋼構          ,7000,45000,-38000,0,0,0,0,0,0,0,0,0,0,0,0,0,-38000
8499,鼎炫-KY         ,11000,49000,-38000,0,0,0,0,0,0,0,0,0,0,0,0,0,-38000
056614,智邦永豐98購01  ,0,0,0,0,0,0,0,0,0,-39000,0,0,0,73000,112000,-39000,-39000
05758P,光罩永豐96售02  ,0,0,0,0,0,0,0,0,0,-39000,0,0,0,0,39000,-39000,-39000
05970P,超眾永豐96售03  ,0,0,0,0,0,0,0,0,0,-39000,0,0,0,0,39000,-39000,-39000
049486,旺宏元大94購08  ,0,0,0,0,0,0,0,0,0,-39000,0,0,0,64000,103000,-39000,-39000
046939,燿華元大96購01  ,0,0,0,0,0,0,0,0,0,-39000,0,0,0,1000,40000,-39000,-39000
046968,台積電群益94購03,0,0,0,0,0,0,0,0,0,-39000,0,0,0,12000,51000,-39000,-39000
04429P,和鑫元大94售01  ,0,0,0,0,0,0,0,0,0,-39000,0,0,0,0,39000,-39000,-39000
050099,台積電永昌96購01,0,0,0,0,0,0,0,0,0,-39000,0,0,0,66000,105000,-39000,-39000
048872,玉晶光國票94購02,0,0,0,0,0,0,0,0,0,-39000,0,0,0,34000,73000,-39000,-39000
05087P,GIS國泰96售01   ,0,0,0,0,0,0,0,0,0,-39000,0,0,0,21000,60000,-39000,-39000
048747,華通元富97購01  ,0,0,0,0,0,0,0,0,0,-39000,0,0,0,64000,103000,-39000,-39000
049599,樺漢元大95購01  ,0,0,0,0,0,0,0,0,0,-39000,0,0,0,57000,96000,-39000,-39000
05331P,上証2X國票96售01,0,0,0,0,0,0,0,0,0,-39000,0,0,0,31000,70000,-39000,-39000
051912,健鼎元大96購01  ,0,0,0,0,0,0,0,0,0,-39000,0,0,0,131000,170000,-39000,-39000
052990,超眾元大97購01  ,0,0,0,0,0,0,0,0,0,-39000,0,0,0,172000,211000,-39000,-39000
053182,大立光元富96購02,0,0,0,0,0,0,0,0,0,-39000,0,0,0,0,39000,-39000,-39000
8442,威宏-KY         ,2000,41000,-39000,0,0,0,0,0,0,0,0,0,0,0,0,0,-39000
2527,宏璟            ,13000,52000,-39000,0,0,0,0,0,0,0,0,0,0,0,0,0,-39000
2444,兆勁            ,23000,62000,-39000,0,0,0,0,0,0,0,0,0,0,0,0,0,-39000
06128P,玉晶光元富97售05,0,0,0,0,0,0,0,0,0,-39000,0,0,0,22000,61000,-39000,-39000
06094P,台達電中信97售01,0,0,0,0,0,0,0,0,0,-39000,0,0,0,81000,120000,-39000,-39000
056646,奇鋐凱基99購02  ,0,0,0,0,0,0,0,0,0,-40000,0,0,0,10000,50000,-40000,-40000
056751,和大兆豐98購01  ,0,0,0,0,0,0,0,0,0,-40000,0,0,0,0,40000,-40000,-40000
05658P,日月光元富96售02,0,0,0,0,0,0,0,0,0,-40000,0,0,0,30000,70000,-40000,-40000
055843,美律元大97購02  ,0,0,0,0,0,0,0,0,0,-40000,0,0,0,50000,90000,-40000,-40000
055816,新日興國票98購01,0,0,0,0,0,0,0,0,0,-40000,0,0,0,80000,120000,-40000,-40000
05611P,康控群益96售02  ,0,0,0,0,0,0,0,0,0,-40000,0,0,0,0,40000,-40000,-40000
056036,鴻海凱基97購07  ,0,0,0,0,0,0,0,0,0,-40000,0,0,0,0,40000,-40000,-40000
056342,中工凱基98購01  ,0,0,0,0,0,0,0,0,0,-40000,0,0,0,0,40000,-40000,-40000
056221,鴻海凱基99購01  ,0,0,0,0,0,0,0,0,0,-40000,0,0,0,0,40000,-40000,-40000
055244,國巨統一98購01  ,0,0,0,0,0,0,0,0,0,-40000,0,0,0,0,40000,-40000,-40000
055113,大立光凱基98購06,0,0,0,0,0,0,0,0,0,-40000,0,0,0,0,40000,-40000,-40000
055004,群創元富99購06  ,0,0,0,0,0,0,0,0,0,-40000,0,0,0,10000,50000,-40000,-40000
05503P,智邦日盛96售01  ,0,0,0,0,0,0,0,0,0,-40000,0,0,0,4000,44000,-40000,-40000
055034,建準富邦99購01  ,0,0,0,0,0,0,0,0,0,-40000,0,0,0,20000,60000,-40000,-40000
054621,華新科兆豐98購01,0,0,0,0,0,0,0,0,0,-40000,0,0,0,0,40000,-40000,-40000
044247,道瓊反元富97購01,0,0,0,0,0,0,0,0,0,-40000,0,0,0,2000,42000,-40000,-40000
042644,貿聯兆豐92購01  ,0,0,0,0,0,0,0,0,0,-40000,0,0,0,80000,120000,-40000,-40000
046564,聯詠凱基92購09  ,0,0,0,0,0,0,0,0,0,-40000,0,0,0,30000,70000,-40000,-40000
047460,富邦金群益95購01,0,0,0,0,0,0,0,0,0,-40000,0,0,0,0,40000,-40000,-40000
043156,大立光統一94購01,0,0,0,0,0,0,0,0,0,-40000,0,0,0,10000,50000,-40000,-40000
044461,滬深2X兆豐93購01,0,0,0,0,0,0,0,0,0,-40000,0,0,0,0,40000,-40000,-40000
044898,旺宏凱基93購01  ,0,0,0,0,0,0,0,0,0,-40000,0,0,0,44000,84000,-40000,-40000
03567P,可成凱基02售06  ,0,0,0,0,0,0,0,0,0,-40000,0,0,0,10000,50000,-40000,-40000
03751P,旺宏富邦95售01  ,0,0,0,0,0,0,0,0,0,-40000,0,0,0,0,40000,-40000,-40000
04730P,臺股指中信96售02,0,0,0,0,0,0,0,0,0,-40000,0,0,0,0,40000,-40000,-40000
046988,南亞科凱基93購02,0,0,0,0,0,0,0,0,0,-40000,0,0,0,0,40000,-40000,-40000
050390,聯發科統一94購09,0,0,0,0,0,0,0,0,0,-40000,0,0,0,0,40000,-40000,-40000
047808,智邦凱基93購07  ,0,0,0,0,0,0,0,0,0,-40000,0,0,0,0,40000,-40000,-40000
045567,滬深2X富邦93購01,0,0,0,0,0,0,0,0,0,-40000,0,0,0,0,40000,-40000,-40000
049636,上証反凱基9A購01,0,0,0,0,0,0,0,0,0,-40000,0,0,0,0,40000,-40000,-40000
048726,儒鴻麥證95購01  ,0,0,0,10000,50000,-40000,0,0,0,-40000,0,0,0,10000,50000,-40000,-40000
050852,矽創國票95購02  ,0,0,0,0,0,0,0,0,0,-40000,0,0,0,20000,60000,-40000,-40000
05073P,臺股指中信95售09,0,0,0,0,0,0,0,0,0,-40000,0,0,0,0,40000,-40000,-40000
050963,強茂永豐95購01  ,0,0,0,0,0,0,0,0,0,-40000,0,0,0,0,40000,-40000,-40000
048091,漢唐凱基93購03  ,0,0,0,0,0,0,0,0,0,-40000,0,0,0,10000,50000,-40000,-40000
048452,緯創凱基93購04  ,0,0,0,0,0,0,0,0,0,-40000,0,0,0,0,40000,-40000,-40000
050588,矽創國票95購01  ,0,0,0,0,0,0,0,0,0,-40000,0,0,0,20000,60000,-40000,-40000
049012,大成鋼群益94購01,0,0,0,0,0,0,0,0,0,-40000,0,0,0,0,40000,-40000,-40000
051687,大立光凱基95購12,0,0,0,0,0,0,0,0,0,-40000,0,0,0,0,40000,-40000,-40000
053179,大立光統一96購04,0,0,0,0,0,0,0,0,0,-40000,0,0,0,0,40000,-40000,-40000
052838,新唐國泰98購01  ,0,0,0,0,0,0,0,0,0,-40000,0,0,0,10000,50000,-40000,-40000
052718,新唐凱基96購01  ,0,0,0,0,0,0,0,0,0,-40000,0,0,0,0,40000,-40000,-40000
052691,GIS元大96購01   ,0,0,0,0,0,0,0,0,0,-40000,0,0,0,0,40000,-40000,-40000
052642,滬深2X永豐96購03,0,0,0,0,0,0,0,0,0,-40000,0,0,0,30000,70000,-40000,-40000
051729,華新國票96購01  ,0,0,0,0,0,0,0,0,0,-40000,0,0,0,10000,50000,-40000,-40000
052417,聯發科兆豐9B購01,0,0,0,0,0,0,0,0,0,-40000,0,0,0,0,40000,-40000,-40000
052382,臺股指元大95購23,0,0,0,0,0,0,0,0,0,-40000,0,0,0,0,40000,-40000,-40000
052361,大成鋼國票96購01,0,0,0,0,0,0,0,0,0,-40000,0,0,0,0,40000,-40000,-40000
052337,臺股指日盛95購02,0,0,0,0,0,0,0,0,0,-40000,0,0,0,0,40000,-40000,-40000
053293,聯發科中信9B購01,0,0,0,0,0,0,0,0,0,-40000,0,0,0,0,40000,-40000,-40000
053217,群創凱基99購02  ,0,0,0,0,0,0,0,0,0,-40000,0,0,0,0,40000,-40000,-40000
053519,力成群益96購02  ,0,0,0,0,0,0,0,0,0,-40000,0,0,0,0,40000,-40000,-40000
053374,台達電元大96購03,0,0,0,0,0,0,0,0,0,-40000,0,0,0,10000,50000,-40000,-40000
054027,欣興凱基96購04  ,0,0,0,0,0,0,0,0,0,-40000,0,0,0,0,40000,-40000,-40000
05413P,台郡國票96售02  ,0,0,0,0,0,0,0,0,0,-40000,0,0,0,0,40000,-40000,-40000
054321,上銀台新96購01  ,0,0,0,0,0,0,0,0,0,-40000,0,0,0,0,40000,-40000,-40000
06283P,祥碩永豐97售01  ,0,0,0,0,0,0,0,0,0,-40000,0,0,0,206000,246000,-40000,-40000
06498P,臺股指元大9A售03,0,0,0,0,0,0,0,0,0,-40000,0,0,0,0,40000,-40000,-40000
08852P,台灣50台新01售01,0,0,0,0,0,0,0,0,0,-40000,0,0,0,0,40000,-40000,-40000
2450,神腦            ,6000,48000,-42000,0,0,0,0,0,0,2000,2000,0,2000,0,0,0,-40000
2020,美亞            ,2000,42000,-40000,0,0,0,0,0,0,0,0,0,0,0,0,0,-40000
2302,麗正            ,1000,41000,-40000,0,0,0,0,0,0,0,0,0,0,0,0,0,-40000
2851,中再保          ,16000,56000,-40000,0,0,0,0,0,0,0,0,0,0,0,0,0,-40000
3494,誠研            ,0,40000,-40000,0,0,0,0,0,0,0,0,0,0,0,0,0,-40000
8473,山林水          ,1000,40000,-39000,0,0,0,0,0,0,-1000,1000,2000,-1000,0,0,0,-40000
6449,鈺邦            ,21213,64000,-42787,0,0,0,0,0,0,2000,2000,0,2000,0,0,0,-40787
05473P,聯詠統一97售02  ,0,0,0,0,0,0,0,0,0,-41000,0,0,0,39000,80000,-41000,-41000
056422,全新統一98購02  ,0,0,0,0,0,0,0,0,0,-41000,0,0,0,59000,100000,-41000,-41000
056416,華新科中信98購01,0,0,0,0,0,0,0,0,0,-41000,0,0,0,40000,81000,-41000,-41000
05964P,華通凱基96售06  ,0,0,0,0,0,0,0,0,0,-41000,0,0,0,0,41000,-41000,-41000
05920P,力成元大96售04  ,0,0,0,0,0,0,0,0,0,-41000,0,0,0,101000,142000,-41000,-41000
04691P,智邦群益94售02  ,0,0,0,0,0,0,0,0,0,-41000,0,0,0,0,41000,-41000,-41000
04021P,寶滬深元富93售01,0,0,0,0,0,0,0,0,0,-41000,0,0,0,0,41000,-41000,-41000
047545,智邦凱基93購05  ,0,0,0,0,0,0,0,0,0,-41000,0,0,0,0,41000,-41000,-41000
04422P,玉晶光永豐94售03,0,0,0,0,0,0,0,0,0,-41000,0,0,0,294000,335000,-41000,-41000
048154,旺宏兆豐94購01  ,0,0,0,0,0,0,0,0,0,-41000,0,0,0,36000,77000,-41000,-41000
054136,亞光元大96購04  ,0,0,0,0,0,0,0,0,0,-41000,0,0,0,17000,58000,-41000,-41000
052127,日月光國票96購01,0,0,0,0,0,0,0,0,0,-41000,0,0,0,60000,101000,-41000,-41000
052107,台積電統一95購06,0,0,0,0,0,0,0,0,0,-41000,0,0,0,160000,201000,-41000,-41000
053108,南亞科兆豐96購01,0,0,0,0,0,0,0,0,0,-41000,0,0,0,0,41000,-41000,-41000
2911,麗嬰房          ,4000,45000,-41000,0,0,0,0,0,0,0,0,0,0,0,0,0,-41000
2539,櫻花建          ,7000,47000,-40000,0,0,0,0,0,0,-1000,0,1000,-1000,0,0,0,-41000
05915P,聯發科元大96售19,0,0,0,0,0,0,0,0,0,-42000,0,0,0,15000,57000,-42000,-42000
05706P,TPK永豐96售02   ,0,0,0,0,0,0,0,0,0,-42000,0,0,0,0,42000,-42000,-42000
05708P,奇力新國票97售04,0,0,0,0,0,0,0,0,0,-42000,0,0,0,0,42000,-42000,-42000
054718,可成永豐97購01  ,0,0,0,0,0,0,0,0,0,-42000,0,0,0,16000,58000,-42000,-42000
047595,元石油元富97購01,0,0,0,0,0,0,0,0,0,-42000,0,0,0,0,42000,-42000,-42000
05039P,鴻海凱基95售10  ,0,0,0,0,0,0,0,0,0,-42000,0,0,0,30000,72000,-42000,-42000
04949P,致新元大94售04  ,0,0,0,0,0,0,0,0,0,-42000,0,0,0,0,42000,-42000,-42000
050947,聯發科群益95購01,0,0,0,0,0,0,0,0,0,-42000,0,0,0,40000,82000,-42000,-42000
051668,智邦元大95購02  ,0,0,0,0,0,0,0,0,0,-42000,0,0,0,266000,308000,-42000,-42000
053028,康控富邦98購01  ,0,0,0,0,0,0,0,0,0,-42000,0,0,0,10000,52000,-42000,-42000
2380,虹光            ,4000,46000,-42000,0,0,0,0,0,0,0,0,0,0,0,0,0,-42000
2062,橋椿            ,6000,48000,-42000,0,0,0,0,0,0,0,0,0,0,0,0,0,-42000
1702,南僑            ,21000,63000,-42000,0,0,0,0,0,0,0,0,0,0,0,0,0,-42000
06465P,國巨統一98售04  ,0,0,0,0,0,0,0,0,0,-42000,0,0,0,0,42000,-42000,-42000
05480P,滬深2X凱基96售05,0,0,0,0,0,0,0,0,0,-43000,0,0,0,690000,733000,-43000,-43000
055011,元翎元富97購01  ,0,0,0,0,0,0,0,0,0,-43000,0,0,0,167000,210000,-43000,-43000
047028,新日興元大93購02,0,0,0,0,0,0,0,0,0,-43000,0,0,0,16000,59000,-43000,-43000
050115,群創元大96購01  ,0,0,0,0,0,0,0,0,0,-43000,0,0,0,113000,156000,-43000,-43000
053143,昇陽半永豐96購03,0,0,0,0,0,0,0,0,0,-43000,0,0,0,54000,97000,-43000,-43000
051947,矽力統一95購01  ,0,0,0,0,0,0,0,0,0,-43000,0,0,0,5000,48000,-43000,-43000
054152,漢唐國泰98購02  ,0,0,0,0,0,0,0,0,0,-43000,0,0,0,15000,58000,-43000,-43000
054371,台積電中信9C購01,0,0,0,0,0,0,0,0,0,-43000,0,0,0,131000,174000,-43000,-43000
1526,日馳            ,12000,55000,-43000,0,0,0,0,0,0,0,0,0,0,0,0,0,-43000
06304P,臺股指元大97售10,0,0,0,0,0,0,0,0,0,-43000,0,0,0,0,43000,-43000,-43000
2305,全友            ,4000,47000,-43000,0,0,0,0,0,0,0,0,0,0,0,0,0,-43000
6541,泰福-KY         ,50000,93000,-43000,0,0,0,0,0,0,0,0,0,0,0,0,0,-43000
055023,億光國泰98購01  ,0,0,0,0,0,0,0,0,0,-44000,0,0,0,25000,69000,-44000,-44000
05711P,茂林國票97售03  ,0,0,0,0,0,0,0,0,0,-44000,0,0,0,0,44000,-44000,-44000
05942P,奇力新凱基96售04,0,0,0,0,0,0,0,0,0,-44000,0,0,0,6000,50000,-44000,-44000
051448,聯詠元大95購02  ,0,0,0,0,0,0,0,0,0,-44000,0,0,0,42000,86000,-44000,-44000
051363,矽創元大95購03  ,0,0,0,0,0,0,0,0,0,-44000,0,0,0,95000,139000,-44000,-44000
048595,儒鴻國票96購01  ,0,0,0,0,0,0,0,0,0,-44000,0,0,0,11000,55000,-44000,-44000
049739,大立光群益94購05,0,0,0,0,0,0,0,0,0,-44000,0,0,0,1000,45000,-44000,-44000
054206,鴻海國票99購01  ,0,0,0,0,0,0,0,0,0,-44000,0,0,0,163000,207000,-44000,-44000
053855,康友國泰98購01  ,0,0,0,0,0,0,0,0,0,-44000,0,0,0,122000,166000,-44000,-44000
6491,晶碩            ,24000,68000,-44000,0,0,0,0,0,0,0,0,0,0,0,0,0,-44000
6184,大豐電          ,0,44000,-44000,0,0,0,0,0,0,0,0,0,0,0,0,0,-44000
1708,東鹼            ,10000,54000,-44000,0,0,0,0,0,0,0,0,0,0,0,0,0,-44000
05995P,T50正2中信9C售01,0,0,0,0,0,0,0,0,0,-44000,0,0,0,80000,124000,-44000,-44000
6112,聚碩            ,81000,125020,-44020,0,0,0,0,0,0,0,0,0,0,0,0,0,-44020
05704P,矽力群益96售04  ,0,0,0,0,0,0,0,0,0,-45000,0,0,0,5000,50000,-45000,-45000
056585,台積電統一9A購01,0,0,0,0,0,0,0,0,0,-45000,0,0,0,0,45000,-45000,-45000
05666P,聯發科凱基96售14,0,0,0,0,0,0,0,0,0,-45000,0,0,0,55000,100000,-45000,-45000
056206,泰鼎永豐97購01  ,0,0,0,0,0,0,0,0,0,-45000,0,0,0,143000,188000,-45000,-45000
055881,康控元富97購01  ,0,0,0,0,0,0,0,0,0,-45000,0,0,0,25000,70000,-45000,-45000
055924,深中小群益9B購01,0,0,0,0,0,0,0,0,0,-45000,0,0,0,20000,65000,-45000,-45000
047235,嘉澤凱基93購01  ,0,0,0,0,0,0,0,0,0,-45000,0,0,0,49000,94000,-45000,-45000
046712,勤誠永豐93購01  ,0,0,0,0,0,0,0,0,0,-45000,0,0,0,33000,78000,-45000,-45000
042993,葡萄王元大94購01,0,0,0,0,0,0,0,0,0,-45000,0,0,0,10000,55000,-45000,-45000
048836,牧德凱基94購03  ,0,0,0,0,0,0,0,0,0,-45000,0,0,0,1000,46000,-45000,-45000
051499,康控群益95購02  ,0,0,0,0,0,0,0,0,0,-45000,0,0,0,11000,56000,-45000,-45000
053790,嘉聯益元大99購02,0,0,0,0,0,0,0,0,0,-45000,0,0,0,0,45000,-45000,-45000
053629,玉山金兆豐96購01,0,0,0,0,0,0,0,0,0,-45000,0,0,0,70000,115000,-45000,-45000
053269,同欣電群益96購01,0,0,0,0,0,0,0,0,0,-45000,0,0,0,55000,100000,-45000,-45000
053996,晶相光群益97購01,0,0,0,0,0,0,0,0,0,-45000,0,0,0,162000,207000,-45000,-45000
053908,貿聯凱基98購01  ,0,0,0,0,0,0,0,0,0,-45000,0,0,0,64000,109000,-45000,-45000
06043P,創意永豐96售06  ,0,0,0,0,0,0,0,0,0,-45000,0,0,0,7000,52000,-45000,-45000
06502P,A50中信98售01   ,0,0,0,0,0,0,0,0,0,-45000,0,0,0,0,45000,-45000,-45000
06440P,台積電凱基98售07,0,0,0,0,0,0,0,0,0,-45000,0,0,0,113000,158000,-45000,-45000
1612,宏泰            ,0,45000,-45000,0,0,0,0,0,0,0,0,0,0,0,0,0,-45000
4994,傳奇            ,99000,140000,-41000,0,0,0,0,0,0,-4000,0,5000,-5000,1000,0,1000,-45000
056306,晶相光元大98購01,0,0,0,0,0,0,0,0,0,-46000,0,0,0,44000,90000,-46000,-46000
056730,元油2X凱基9A購04,0,0,0,0,0,0,0,0,0,-46000,0,0,0,0,46000,-46000,-46000
05847P,大立光元大96售08,0,0,0,0,0,0,0,0,0,-46000,0,0,0,62000,108000,-46000,-46000
055151,台積電元大98購05,0,0,0,0,0,0,0,0,0,-46000,0,0,0,559000,605000,-46000,-46000
054578,世芯元大99購01  ,0,0,0,0,0,0,0,0,0,-46000,0,0,0,8000,54000,-46000,-46000
047685,嘉聯益國泰95購01,0,0,0,0,0,0,0,0,0,-46000,0,0,0,120000,166000,-46000,-46000
051486,玉晶光凱基97購03,0,0,0,0,0,0,0,0,0,-46000,0,0,0,1000,47000,-46000,-46000
051451,世芯元大95購03  ,0,0,0,0,0,0,0,0,0,-46000,0,0,0,13000,59000,-46000,-46000
051592,健策元大96購05  ,0,0,0,0,0,0,0,0,0,-46000,0,0,0,245000,291000,-46000,-46000
048050,元油反中信93購01,0,0,0,0,0,0,0,0,0,-46000,0,0,0,0,46000,-46000,-46000
04831P,聯詠富邦96售01  ,0,0,0,0,0,0,0,0,0,-46000,0,0,0,0,46000,-46000,-46000
05311P,臺股指群益95售10,0,0,0,0,0,0,0,0,0,-46000,0,0,0,23000,69000,-46000,-46000
053001,力山永豐96購01  ,0,0,0,0,0,0,0,0,0,-46000,0,0,0,29000,75000,-46000,-46000
4438,廣越            ,10000,56000,-46000,0,0,0,0,0,0,0,0,0,0,0,0,0,-46000
1712,興農            ,25000,71000,-46000,0,0,0,0,0,0,0,0,0,0,0,0,0,-46000
06018P,康控凱基96售03  ,0,0,0,0,0,0,0,0,0,-46000,0,0,0,1000,47000,-46000,-46000
6192,巨路            ,54000,100000,-46000,0,0,0,0,0,0,0,0,0,0,0,0,0,-46000
8261,富鼎            ,29000,75000,-46000,0,0,0,0,0,0,0,0,0,0,0,0,0,-46000
05453P,智邦群益95售03  ,0,0,0,0,0,0,0,0,0,-47000,0,0,0,20000,67000,-47000,-47000
055341,台達電凱基97購02,0,0,0,0,0,0,0,0,0,-47000,0,0,0,24000,71000,-47000,-47000
056721,台灣50永昌9A購01,0,0,0,0,0,0,0,0,0,-47000,0,0,0,0,47000,-47000,-47000
055861,矽力元大97購03  ,0,1000,-1000,0,0,0,0,0,0,-46000,0,0,0,61000,107000,-46000,-47000
047418,智邦富邦97購01  ,0,0,0,0,0,0,0,0,0,-47000,0,0,0,115000,162000,-47000,-47000
03857P,聯發科元富99售02,0,0,0,0,0,0,0,0,0,-47000,0,0,0,180000,227000,-47000,-47000
04838P,宏達電元大95售02,0,0,0,0,0,0,0,0,0,-47000,0,0,0,3000,50000,-47000,-47000
04967P,台表科永豐94售04,0,0,0,0,0,0,0,0,0,-47000,0,0,0,20000,67000,-47000,-47000
049136,華通元大95購01  ,0,0,0,0,0,0,0,0,0,-47000,0,0,0,43000,90000,-47000,-47000
049146,南亞科元大94購02,0,0,0,0,0,0,0,0,0,-47000,0,0,0,22000,69000,-47000,-47000
051789,嘉澤國票96購01  ,0,0,0,0,0,0,0,0,0,-47000,0,0,0,48000,95000,-47000,-47000
6189,豐藝            ,18000,65000,-47000,0,0,0,0,0,0,0,0,0,0,0,0,0,-47000
06102P,智邦凱基97售03  ,0,0,0,0,0,0,0,0,0,-47000,0,0,0,69000,116000,-47000,-47000
06505P,康控國票99售02  ,0,0,0,0,0,0,0,0,0,-47000,0,0,0,0,47000,-47000,-47000
1810,和成            ,9000,56000,-47000,0,0,0,0,0,0,0,0,0,0,0,0,0,-47000
4916,事欣科          ,11000,58000,-47000,0,0,0,0,0,0,0,0,0,0,0,0,0,-47000
055862,矽力元大97購04  ,0,0,0,0,0,0,0,0,0,-48000,0,0,0,0,48000,-48000,-48000
056265,國泰金統一97購01,0,0,0,0,0,0,0,0,0,-48000,0,0,0,0,48000,-48000,-48000
055695,大毅國票98購03  ,0,0,0,0,0,0,0,0,0,-48000,0,0,0,112000,160000,-48000,-48000
055688,力成凱基98購02  ,0,0,0,0,0,0,0,0,0,-48000,0,0,0,90000,138000,-48000,-48000
054774,同欣電國票98購01,0,0,0,0,0,0,0,0,0,-48000,0,0,0,96000,144000,-48000,-48000
03651C,臺股指凱基97牛17,0,0,0,0,0,0,0,0,0,-48000,0,0,0,150000,198000,-48000,-48000
04333P,儒鴻凱基93售06  ,0,0,0,0,0,0,0,0,0,-48000,0,0,0,3000,51000,-48000,-48000
04427P,滬深2X元大97售02,0,0,0,0,0,0,0,0,0,-48000,0,0,0,422000,470000,-48000,-48000
04782P,智伸科統一96售01,0,0,0,0,0,0,0,0,0,-48000,0,0,0,0,48000,-48000,-48000
049342,聯發科統一94購05,0,0,0,0,0,0,0,0,0,-48000,0,0,0,48000,96000,-48000,-48000
049890,嘉澤國泰95購01  ,0,0,0,0,0,0,0,0,0,-48000,0,0,0,25000,73000,-48000,-48000
051650,矽力永豐95購01  ,0,0,0,0,0,0,0,0,0,-48000,0,0,0,30000,78000,-48000,-48000
051166,可成元大95購02  ,0,0,0,0,0,0,0,0,0,-48000,0,0,0,20000,68000,-48000,-48000
050939,健鼎國票96購01  ,0,0,0,0,0,0,0,0,0,-48000,0,0,0,20000,68000,-48000,-48000
052279,旺宏凱基95購07  ,0,0,0,0,0,0,0,0,0,-48000,0,0,0,4000,52000,-48000,-48000
052410,智邦亞東96購01  ,0,0,0,0,0,0,0,0,0,-48000,0,0,0,0,48000,-48000,-48000
052473,臻鼎亞東95購01  ,0,0,0,0,0,0,0,0,0,-48000,0,0,0,0,48000,-48000,-48000
053015,緯創統一96購01  ,0,0,0,0,0,0,0,0,0,-48000,0,0,0,0,48000,-48000,-48000
053177,華邦電統一96購01,0,0,0,0,0,0,0,0,0,-48000,0,0,0,0,48000,-48000,-48000
05269P,臻鼎元大95售05  ,0,0,0,0,0,0,0,0,0,-48000,0,0,0,40000,88000,-48000,-48000
053987,宏碁亞東96購01  ,0,0,0,0,0,0,0,0,0,-48000,0,0,0,69000,117000,-48000,-48000
05396P,台郡元大95售05  ,0,0,0,0,0,0,0,0,0,-48000,0,0,0,0,48000,-48000,-48000
05434P,世紀鋼元富95售02,0,0,0,0,0,0,0,0,0,-48000,0,0,0,0,48000,-48000,-48000
053324,康舒群益96購01  ,0,0,0,0,0,0,0,0,0,-48000,0,0,0,72000,120000,-48000,-48000
053361,友達元富99購01  ,0,0,0,0,0,0,0,0,0,-48000,0,0,0,0,48000,-48000,-48000
053585,友達元大9C購03  ,0,0,0,0,0,0,0,0,0,-48000,0,0,0,12000,60000,-48000,-48000
053791,同欣電元大96購05,0,0,0,0,0,0,0,0,0,-48000,0,0,0,5000,53000,-48000,-48000
5203,訊連            ,68000,143000,-75000,0,0,0,10000,0,10000,17000,1000,1000,0,17000,0,17000,-48000
4746,台耀            ,47000,101000,-54000,0,0,0,0,0,0,6000,6000,0,6000,0,0,0,-48000
2748,雲品            ,0,33000,-33000,0,0,0,0,15000,-15000,0,0,0,0,0,0,0,-48000
2103,台橡            ,83000,130000,-47000,0,0,0,0,0,0,-1000,0,1000,-1000,0,0,0,-48000
2431,聯昌            ,16000,64000,-48000,0,0,0,0,0,0,0,0,0,0,0,0,0,-48000
08218P,滬深2X凱基96售01,0,0,0,0,0,0,0,0,0,-48000,0,0,0,100000,148000,-48000,-48000
054793,牧德群益9A購01  ,0,0,0,0,0,0,0,0,0,-49000,0,0,0,75000,124000,-49000,-49000
055202,神達群益97購01  ,0,0,0,0,0,0,0,0,0,-49000,0,0,0,1000,50000,-49000,-49000
047191,同欣電元大93購02,0,0,0,0,0,0,0,0,0,-49000,0,0,0,1000,50000,-49000,-49000
047548,友達凱基99購03  ,0,0,0,0,0,0,0,0,0,-49000,0,0,0,10000,59000,-49000,-49000
047505,元金2X國票9B購01,0,0,0,0,0,0,0,0,0,-49000,0,0,0,1000,50000,-49000,-49000
04456P,日月光統一94售01,0,0,0,0,0,0,0,0,0,-49000,0,0,0,32000,81000,-49000,-49000
04160P,儒鴻中信93售01  ,0,0,0,0,0,0,0,0,0,-49000,0,0,0,0,49000,-49000,-49000
050573,光寶科國票94購01,0,0,0,0,0,0,0,0,0,-49000,0,0,0,39000,88000,-49000,-49000
052846,智邦統一97購01  ,0,0,0,0,0,0,0,0,0,-49000,0,0,0,41000,90000,-49000,-49000
052193,國巨元富95購06  ,0,0,0,0,0,0,0,0,0,-49000,0,0,0,132000,181000,-49000,-49000
06302P,臺股指元大97售06,0,0,0,0,0,0,0,0,0,-49000,0,0,0,0,49000,-49000,-49000
06187P,國巨統一97售05  ,0,0,0,0,0,0,0,0,0,-49000,0,0,0,10000,59000,-49000,-49000
06239P,奇力新元大97售08,0,0,0,0,0,0,0,0,0,-49000,0,0,0,1000,50000,-49000,-49000
2477,美隆電          ,12000,76000,-64000,0,0,0,0,0,0,15000,15000,0,15000,0,0,0,-49000
8367,建新國際        ,6000,55000,-49000,0,0,0,0,0,0,0,0,0,0,0,0,0,-49000
9927,泰銘            ,3000,52000,-49000,0,0,0,0,0,0,0,0,0,0,0,0,0,-49000
055200,和大群益98購01  ,0,0,0,0,0,0,0,0,0,-50000,0,0,0,7000,57000,-50000,-50000
055194,昇陽半元富97購01,0,0,0,0,0,0,0,0,0,-50000,0,0,0,200000,250000,-50000,-50000
055298,啟碁元大97購02  ,0,0,0,0,0,0,0,0,0,-50000,0,0,0,0,50000,-50000,-50000
055726,台表科元大98購03,0,0,0,0,0,0,0,0,0,-50000,0,0,0,0,50000,-50000,-50000
055510,GIS元大97購03   ,0,0,0,0,0,0,0,0,0,-50000,0,0,0,0,50000,-50000,-50000
055492,華新科元大97購08,0,0,0,0,0,0,0,0,0,-50000,0,0,0,36000,86000,-50000,-50000
054653,聯發科麥證97購02,0,0,0,0,50000,-50000,0,0,0,-50000,0,0,0,0,50000,-50000,-50000
054878,和大統一97購02  ,0,0,0,0,0,0,0,0,0,-50000,0,0,0,0,50000,-50000,-50000
054879,大成鋼統一97購01,0,0,0,0,0,0,0,0,0,-50000,0,0,0,0,50000,-50000,-50000
054948,聯發科元大97購14,0,0,0,0,0,0,0,0,0,-50000,0,0,0,200000,250000,-50000,-50000
056182,台光電統一97購03,0,0,0,0,0,0,0,0,0,-50000,0,0,0,50000,100000,-50000,-50000
05615P,臺股指康和96售04,0,0,0,0,0,0,0,0,0,-50000,0,0,0,50000,100000,-50000,-50000
056139,貿聯元大97購04  ,0,0,0,0,0,0,0,0,0,-50000,0,0,0,0,50000,-50000,-50000
055809,T50反1國票98購02,0,0,0,0,0,0,0,0,0,-50000,0,0,0,0,50000,-50000,-50000
055922,台郡凱基98購03  ,0,0,0,0,0,0,0,0,0,-50000,0,0,0,0,50000,-50000,-50000
055912,宏達電凱基98購03,0,0,0,0,0,0,0,0,0,-50000,0,0,0,0,50000,-50000,-50000
055975,鴻海統一98購05  ,0,0,0,0,0,0,0,0,0,-50000,0,0,0,0,50000,-50000,-50000
056103,聯發科永豐97購03,0,0,0,0,0,0,0,0,0,-50000,0,0,0,119000,169000,-50000,-50000
05607P,華通日盛96售01  ,0,0,0,0,0,0,0,0,0,-50000,0,0,0,0,50000,-50000,-50000
056805,元石油統一9B購01,0,0,0,0,0,0,0,0,0,-50000,0,0,0,0,50000,-50000,-50000
056673,中石化元富9B購01,0,0,0,0,0,0,0,0,0,-50000,0,0,0,0,50000,-50000,-50000
05714P,群創統一97售03  ,0,0,0,0,0,0,0,0,0,-50000,0,0,0,0,50000,-50000,-50000
05891P,聯發科中信98售03,0,0,0,0,0,0,0,0,0,-50000,0,0,0,0,50000,-50000,-50000
04482P,臺股指日盛94售01,0,0,0,0,0,0,0,0,0,-50000,0,0,0,0,50000,-50000,-50000
04460P,元油2X元富96售04,0,0,0,0,0,0,0,0,0,-50000,0,0,0,0,50000,-50000,-50000
03671P,大立光凱基95售02,0,0,0,0,0,0,0,0,0,-50000,0,0,0,0,50000,-50000,-50000
03578P,創意元富08售04  ,0,0,0,0,0,0,0,0,0,-50000,0,0,0,0,50000,-50000,-50000
03581P,台積電群益03售04,0,0,0,0,0,0,0,0,0,-50000,0,0,0,0,50000,-50000,-50000
03921P,亞光凱基94售01  ,0,0,0,0,0,0,0,0,0,-50000,0,0,0,0,50000,-50000,-50000
03197P,台積電統一01售14,0,0,0,0,0,0,0,0,0,-50000,0,0,0,50000,100000,-50000,-50000
04316P,華新科國票94售05,0,0,0,0,0,0,0,0,0,-50000,0,0,0,50000,100000,-50000,-50000
042679,群創元大92購02  ,0,0,0,0,0,0,0,0,0,-50000,0,0,0,0,50000,-50000,-50000
047187,亞光元大94購01  ,0,0,0,0,0,0,0,0,0,-50000,0,0,0,17000,67000,-50000,-50000
047304,元油2X元大96購02,0,0,0,0,0,0,0,0,0,-50000,0,0,0,0,50000,-50000,-50000
046967,元油反群益93購01,0,0,0,0,0,0,0,0,0,-50000,0,0,0,0,50000,-50000,-50000
047883,臺股指永昌93購01,0,0,0,0,0,0,0,0,0,-50000,0,0,0,41000,91000,-50000,-50000
047050,可成國票93購02  ,0,0,0,0,0,0,0,0,0,-50000,0,0,0,0,50000,-50000,-50000
050352,欣興群益95購01  ,0,0,0,0,0,0,0,0,0,-50000,0,0,0,0,50000,-50000,-50000
046062,遠東新凱基92購02,0,0,0,0,0,0,0,0,0,-50000,0,0,0,70000,120000,-50000,-50000
04985P,景碩永豐94售02  ,0,0,0,0,0,0,0,0,0,-50000,0,0,0,0,50000,-50000,-50000
049394,T50反1群益94購01,0,0,0,0,0,0,0,0,0,-50000,0,0,0,0,50000,-50000,-50000
051601,群創兆豐95購02  ,0,0,0,0,0,0,0,0,0,-50000,0,0,0,0,50000,-50000,-50000
051704,智邦群益95購02  ,0,0,0,0,0,0,0,0,0,-50000,0,0,0,31000,81000,-50000,-50000
051493,台郡凱基95購02  ,0,0,0,0,0,0,0,0,0,-50000,0,0,0,0,50000,-50000,-50000
050660,欣興元大96購02  ,0,0,0,0,0,0,0,0,0,-50000,0,0,0,0,50000,-50000,-50000
05086P,鴻海凱基95售13  ,0,0,0,0,0,0,0,0,0,-50000,0,0,0,55000,105000,-50000,-50000
048650,台表科元大93購05,0,0,0,0,0,0,0,0,0,-50000,0,0,0,0,50000,-50000,-50000
051091,聯發科元大95購07,0,0,0,0,0,0,0,0,0,-50000,0,0,0,0,50000,-50000,-50000
049561,道瓊銀統一96購01,0,0,0,0,0,0,0,0,0,-50000,0,0,0,0,50000,-50000,-50000
050208,燿華兆豐95購02  ,0,0,0,0,0,0,0,0,0,-50000,0,0,0,0,50000,-50000,-50000
050152,聯發科群益94購07,0,0,0,0,0,0,0,0,0,-50000,0,0,0,0,50000,-50000,-50000
049697,群創元大98購01  ,0,0,0,0,0,0,0,0,0,-50000,0,0,0,82000,132000,-50000,-50000
048700,和鑫國票95購01  ,0,0,0,0,0,0,0,0,0,-50000,0,0,0,0,50000,-50000,-50000
048685,T50反1第一94購01,0,0,0,0,0,0,0,0,0,-50000,0,0,0,0,50000,-50000,-50000
048364,臺股指永豐93購04,0,0,0,0,0,0,0,0,0,-50000,0,0,0,0,50000,-50000,-50000
048370,可成統一93購04  ,0,0,0,0,0,0,0,0,0,-50000,0,0,0,100000,150000,-50000,-50000
048261,鴻海元富95購01  ,0,0,0,0,0,0,0,0,0,-50000,0,0,0,40000,90000,-50000,-50000
048142,聯電統一93購01  ,0,0,0,0,0,0,0,0,0,-50000,0,0,0,0,50000,-50000,-50000
048138,羅麗芬國票94購01,0,0,0,0,0,0,0,0,0,-50000,0,0,0,0,50000,-50000,-50000
048829,欣興凱基94購02  ,0,0,0,0,0,0,0,0,0,-50000,0,0,0,0,50000,-50000,-50000
051030,康友元富95購01  ,0,0,0,0,0,0,0,0,0,-50000,0,0,0,17000,67000,-50000,-50000
049237,元油2X元富96購07,0,0,0,0,0,0,0,0,0,-50000,0,0,0,62000,112000,-50000,-50000
049176,漢唐凱基94購02  ,0,0,0,0,0,0,0,0,0,-50000,0,0,0,0,50000,-50000,-50000
052204,台泥中信96購01  ,0,0,0,0,0,0,0,0,0,-50000,0,0,0,0,50000,-50000,-50000
05235P,健鼎康和95售02  ,0,0,0,0,0,0,0,0,0,-50000,0,0,0,83000,133000,-50000,-50000
05178P,大立光凱基96售05,0,0,0,0,0,0,0,0,0,-50000,0,0,0,0,50000,-50000,-50000
05191P,鴻海台新95售01  ,0,0,0,0,0,0,0,0,0,-50000,0,0,0,0,50000,-50000,-50000
051930,國泰金兆豐97購01,0,0,0,0,0,0,0,0,0,-50000,0,0,0,0,50000,-50000,-50000
051872,矽力凱基96購01  ,0,0,0,0,0,0,0,0,0,-50000,0,0,0,0,50000,-50000,-50000
052121,全新國票96購03  ,0,0,0,0,0,0,0,0,0,-50000,0,0,0,0,50000,-50000,-50000
05281P,南亞科元大95售03,0,0,0,0,0,0,0,0,0,-50000,0,0,0,100000,150000,-50000,-50000
05253P,智邦凱基95售08  ,0,0,0,0,0,0,0,0,0,-50000,0,0,0,120000,170000,-50000,-50000
053178,南亞科統一98購01,0,0,0,0,0,0,0,0,0,-50000,0,0,0,0,50000,-50000,-50000
053620,臺股指群益96購06,0,0,0,0,0,0,0,0,0,-50000,0,0,0,17000,67000,-50000,-50000
053305,聯詠凱基96購02  ,0,0,0,0,0,0,0,0,0,-50000,0,0,0,0,50000,-50000,-50000
05321P,鴻海凱基95售17  ,0,0,0,0,0,0,0,0,0,-50000,0,0,0,0,50000,-50000,-50000
053190,聯發科統一99購01,0,0,0,0,0,0,0,0,0,-50000,0,0,0,0,50000,-50000,-50000
054475,鴻海中信96購04  ,0,0,0,0,0,0,0,0,0,-50000,0,0,0,0,50000,-50000,-50000
054476,聯發科中信96購03,0,0,0,0,0,0,0,0,0,-50000,0,0,0,0,50000,-50000,-50000
054438,群創台新96購01  ,0,0,0,0,0,0,0,0,0,-50000,0,0,0,0,50000,-50000,-50000
054148,矽創元大96購03  ,0,0,0,0,0,0,0,0,0,-50000,0,0,0,191000,241000,-50000,-50000
6168,宏齊            ,29000,79000,-50000,0,0,0,0,0,0,0,0,0,0,0,0,0,-50000
3266,昇陽            ,2000,52000,-50000,0,0,0,0,0,0,0,0,0,0,0,0,0,-50000
5234,達興材料        ,50000,69000,-19000,0,0,0,0,31000,-31000,0,0,0,0,0,0,0,-50000
06516P,國巨凱基98售08  ,0,0,0,0,0,0,0,0,0,-50000,0,0,0,0,50000,-50000,-50000
05888P,友達元大97售01  ,0,0,0,0,0,0,0,0,0,-51000,0,0,0,20000,71000,-51000,-51000
05975P,國巨日盛99售02  ,0,0,0,0,0,0,0,0,0,-51000,0,0,0,10000,61000,-51000,-51000
056712,京鼎永豐98購01  ,0,0,0,0,0,0,0,0,0,-51000,0,0,0,20000,71000,-51000,-51000
056575,禾伸堂元大99購01,0,0,0,0,0,0,0,0,0,-51000,0,0,0,92000,143000,-51000,-51000
055053,瑞昱永豐97購01  ,0,0,0,0,0,0,0,0,0,-51000,0,0,0,24000,75000,-51000,-51000
054716,緯穎康和97購01  ,0,0,0,0,0,0,0,0,0,-51000,0,0,0,1000,52000,-51000,-51000
055247,聯發科統一98購01,0,0,0,0,0,0,0,0,0,-51000,0,0,0,4000,55000,-51000,-51000
055159,玉晶光元大98購05,0,0,0,0,0,0,0,0,0,-51000,0,0,0,131000,182000,-51000,-51000
046314,宏達電元大92購05,0,0,0,0,0,0,0,0,0,-51000,0,0,0,44000,95000,-51000,-51000
050376,百和元大95購01  ,0,0,0,0,0,0,0,0,0,-51000,0,0,0,0,51000,-51000,-51000
048331,臺指反富邦97購01,0,0,0,0,0,0,0,0,0,-51000,0,0,0,0,51000,-51000,-51000
05077P,智易群益95售02  ,0,0,0,0,0,0,0,0,0,-51000,0,0,0,0,51000,-51000,-51000
04898P,瑞儀中信95售01  ,0,0,0,0,0,0,0,0,0,-51000,0,0,0,50000,101000,-51000,-51000
051366,康友國泰97購01  ,0,0,0,0,0,0,0,0,0,-51000,0,0,0,815000,866000,-51000,-51000
051634,大立光國票96購03,0,0,0,0,0,0,0,0,0,-51000,0,0,0,0,51000,-51000,-51000
053899,矽創群益96購02  ,0,0,0,0,0,0,0,0,0,-51000,0,0,0,0,51000,-51000,-51000
06370P,貿聯凱基97售03  ,0,0,0,0,0,0,0,0,0,-51000,0,0,0,10000,61000,-51000,-51000
06264P,友達凱基98售06  ,0,0,0,0,0,0,0,0,0,-51000,0,0,0,16000,67000,-51000,-51000
5225,東科-KY         ,28000,79000,-51000,0,0,0,0,0,0,0,0,0,0,0,0,0,-51000
3025,星通            ,11000,62000,-51000,0,0,0,0,0,0,0,0,0,0,0,0,0,-51000
2488,漢平            ,6000,57000,-51000,0,0,0,0,0,0,0,0,0,0,0,0,0,-51000
2597,潤弘            ,3000,44000,-41000,0,0,0,0,0,0,-10000,0,10000,-10000,0,0,0,-51000
2365,昆盈            ,14000,65000,-51000,0,0,0,0,0,0,0,0,0,0,0,0,0,-51000
2009,第一銅          ,36000,87000,-51000,0,0,0,0,0,0,0,0,0,0,0,0,0,-51000
056679,元油2X統一98購01,0,0,0,0,0,0,0,0,0,-52000,0,0,0,20000,72000,-52000,-52000
056603,嘉聯益國泰9A購01,0,0,0,0,0,0,0,0,0,-52000,0,0,0,68000,120000,-52000,-52000
050448,義隆元大94購04  ,0,0,0,0,0,0,0,0,0,-52000,0,0,0,3000,55000,-52000,-52000
046333,康友元大92購05  ,0,0,0,0,0,0,0,0,0,-52000,0,0,0,98000,150000,-52000,-52000
04082P,智邦統一93售03  ,0,0,0,0,0,0,0,0,0,-52000,0,0,0,0,52000,-52000,-52000
03399P,欣興中信02售03  ,0,0,0,0,0,0,0,0,0,-52000,0,0,0,0,52000,-52000,-52000
051529,東元國票96購01  ,0,0,0,0,0,0,0,0,0,-52000,0,0,0,30000,82000,-52000,-52000
049087,晶相光凱基94購02,0,0,0,0,0,0,0,0,0,-52000,0,0,0,8000,60000,-52000,-52000
054433,南亞科台新96購02,0,0,0,0,0,0,0,0,0,-52000,0,0,0,0,52000,-52000,-52000
052010,兆豐金中信95購01,0,0,0,0,0,0,0,0,0,-52000,0,0,0,20000,72000,-52000,-52000
1762,中化生          ,93000,144000,-51000,0,0,0,0,0,0,-1000,0,1000,-1000,0,0,0,-52000
3257,虹冠電          ,2000,54000,-52000,0,0,0,0,0,0,0,0,0,0,0,0,0,-52000
06095P,燿華永豐97售01  ,0,0,0,0,0,0,0,0,0,-52000,0,0,0,0,52000,-52000,-52000
6283,淳安            ,18000,70000,-52000,0,0,0,0,0,0,0,0,0,0,0,0,0,-52000
04550P,超眾元大94售01  ,0,0,0,0,0,0,0,0,0,-53000,0,0,0,0,53000,-53000,-53000
049888,智邦國泰96購01  ,0,0,0,0,0,0,0,0,0,-53000,0,0,0,0,53000,-53000,-53000
051411,聯發科國票95購05,0,0,0,0,0,0,0,0,0,-53000,0,0,0,0,53000,-53000,-53000
049244,亞光元富94購01  ,0,0,0,0,0,0,0,0,0,-53000,0,0,0,87000,140000,-53000,-53000
05306P,泰碩國泰97售01  ,0,0,0,0,0,0,0,0,0,-53000,0,0,0,45000,98000,-53000,-53000
053026,奇力新富邦98購01,0,0,0,0,0,0,0,0,0,-53000,0,0,0,0,53000,-53000,-53000
06145P,華新科永豐97售02,0,0,0,0,0,0,0,0,0,-53000,0,0,0,57000,110000,-53000,-53000
4739,康普            ,42000,89000,-47000,0,0,0,0,0,0,-6000,1000,0,1000,0,7000,-7000,-53000
2413,環科            ,9000,61000,-52000,0,0,0,0,0,0,-1000,2000,3000,-1000,0,0,0,-53000
055928,南亞科群益97購02,0,0,0,0,0,0,0,0,0,-54000,0,0,0,72000,126000,-54000,-54000
047772,泰鼎元大93購05  ,0,0,0,0,0,0,0,0,0,-54000,0,0,0,0,54000,-54000,-54000
049487,智邦元大94購03  ,0,0,0,0,0,0,0,0,0,-54000,0,0,0,68000,122000,-54000,-54000
03652C,臺股指元大03牛01,0,0,0,0,0,0,0,0,0,-54000,0,0,0,0,54000,-54000,-54000
04141P,啟碁國票93售01  ,0,0,0,0,0,0,0,0,0,-54000,0,0,0,0,54000,-54000,-54000
04433P,上証2X國票95售01,0,0,0,0,0,0,0,0,0,-54000,0,0,0,1005000,1059000,-54000,-54000
04369P,台光電凱基94售04,0,0,0,0,0,0,0,0,0,-54000,0,0,0,0,54000,-54000,-54000
048410,和碩群益93購01  ,0,0,0,0,0,0,0,0,0,-54000,0,0,0,53000,107000,-54000,-54000
050757,聯發科元富94購03,0,0,0,0,0,0,0,0,0,-54000,0,0,0,74000,128000,-54000,-54000
051506,台積電元富95購06,0,0,0,0,0,0,0,0,0,-54000,0,0,0,453000,507000,-54000,-54000
050306,聯發科中信97購01,0,0,0,0,0,0,0,0,0,-54000,0,0,0,11000,65000,-54000,-54000
052561,矽創國票97購01  ,0,0,0,0,0,0,0,0,0,-54000,0,0,0,85000,139000,-54000,-54000
4737,華廣            ,1000,55000,-54000,0,0,0,0,0,0,0,0,0,0,0,0,0,-54000
3013,晟銘電          ,13000,67000,-54000,0,0,0,0,0,0,0,0,0,0,0,0,0,-54000
2908,特力            ,0,54000,-54000,0,0,0,0,0,0,0,0,0,0,0,0,0,-54000
06228P,亞德客凱基97售04,0,0,0,0,0,0,0,0,0,-54000,0,0,0,5000,59000,-54000,-54000
1558,伸興            ,4000,32000,-28000,0,0,0,0,0,0,-26000,0,26000,-26000,0,0,0,-54000
6235,華孚            ,4000,58000,-54000,0,0,0,0,0,0,0,0,0,0,0,0,0,-54000
9938,百和            ,343000,431000,-88000,0,0,0,0,0,0,34000,0,4000,-4000,78000,40000,38000,-54000
05903P,聯發科統一96售09,0,0,0,0,0,0,0,0,0,-55000,0,0,0,0,55000,-55000,-55000
05568P,台積電統一96售03,0,0,0,0,0,0,0,0,0,-55000,0,0,0,45000,100000,-55000,-55000
054815,台積電元大97購14,0,0,0,0,0,0,0,0,0,-55000,0,0,0,0,55000,-55000,-55000
055031,南港富邦99購01  ,0,0,0,0,0,0,0,0,0,-55000,0,0,0,0,55000,-55000,-55000
046466,台虹凱基92購01  ,0,0,0,0,0,0,0,0,0,-55000,0,0,0,0,55000,-55000,-55000
046552,晶技麥證92購01  ,0,0,0,0,55000,-55000,0,0,0,-55000,0,0,0,0,55000,-55000,-55000
044819,新日興兆豐93購02,0,0,0,0,0,0,0,0,0,-55000,0,0,0,25000,80000,-55000,-55000
04453P,聯發科富邦94售04,0,0,0,0,0,0,0,0,0,-55000,0,0,0,72000,127000,-55000,-55000
04105P,東陽康和93售03  ,0,0,0,0,0,0,0,0,0,-55000,0,0,0,0,55000,-55000,-55000
047638,瑞昱元大93購11  ,0,0,0,0,0,0,0,0,0,-55000,0,0,0,5000,60000,-55000,-55000
048923,國巨永豐94購02  ,0,0,0,0,0,0,0,0,0,-55000,0,0,0,35000,90000,-55000,-55000
05011P,南電國泰96售01  ,0,0,0,0,0,0,0,0,0,-55000,0,0,0,0,55000,-55000,-55000
051468,智邦日盛95購01  ,0,0,0,0,0,0,0,0,0,-55000,0,0,0,27000,82000,-55000,-55000
051280,台積電兆豐95購04,0,0,0,0,0,0,0,0,0,-55000,0,0,0,0,55000,-55000,-55000
051756,台積電元大97購04,0,0,0,0,0,0,0,0,0,-55000,0,0,0,344000,399000,-55000,-55000
052379,鈺齊元大95購04  ,0,0,0,0,0,0,0,0,0,-55000,0,0,0,21000,76000,-55000,-55000
054260,貿聯元大96購03  ,0,0,0,0,0,0,0,0,0,-55000,0,0,0,0,55000,-55000,-55000
053654,聯發科凱基98購01,0,0,0,0,0,0,0,0,0,-55000,0,0,0,85000,140000,-55000,-55000
053608,彩晶第一96購01  ,0,0,0,0,0,0,0,0,0,-55000,0,0,0,0,55000,-55000,-55000
3090,日電貿          ,193000,236000,-43000,0,0,0,0,0,0,-12000,1000,0,1000,12000,25000,-13000,-55000
4989,榮科            ,4000,59000,-55000,0,0,0,0,0,0,0,0,0,0,0,0,0,-55000
2029,盛餘            ,2000,57970,-55970,0,0,0,0,0,0,0,0,0,0,0,0,0,-55970
054633,臺股指凱基9A購02,0,0,0,0,0,0,0,0,0,-56000,0,0,0,0,56000,-56000,-56000
054629,華新科凱基98購01,0,0,0,0,0,0,0,0,0,-56000,0,0,0,23000,79000,-56000,-56000
055437,禾伸堂中信99購01,0,0,0,0,0,0,0,0,0,-56000,0,0,0,40000,96000,-56000,-56000
056623,禾伸堂永豐98購01,0,0,0,0,0,0,0,0,0,-56000,0,0,0,72000,128000,-56000,-56000
056668,光磊國票99購01  ,0,0,0,0,0,0,0,0,0,-56000,0,0,0,0,56000,-56000,-56000
055792,臺股指凱基97購15,0,0,0,0,0,0,0,0,0,-56000,0,0,0,10000,66000,-56000,-56000
056296,旺宏元大97購07  ,0,0,0,0,0,0,0,0,0,-56000,0,0,0,307000,363000,-56000,-56000
03314P,台積電元大02售16,0,0,0,0,0,0,0,0,0,-56000,0,0,0,25000,81000,-56000,-56000
051488,健策凱基96購04  ,0,0,0,0,0,0,0,0,0,-56000,0,0,0,155000,211000,-56000,-56000
050307,欣興中信95購01  ,0,0,0,0,0,0,0,0,0,-56000,0,0,0,0,56000,-56000,-56000
053281,茂林元大96購02  ,0,0,0,0,0,0,0,0,0,-56000,0,0,0,18000,74000,-56000,-56000
053522,臺股指群益99購01,0,0,0,0,0,0,0,0,0,-56000,0,0,0,13000,69000,-56000,-56000
054316,矽創凱基97購01  ,0,0,0,0,0,0,0,0,0,-56000,0,0,0,5000,61000,-56000,-56000
3501,維熹            ,1000,57000,-56000,0,0,0,0,0,0,0,0,0,0,0,0,0,-56000
3311,閎暉            ,1000,57000,-56000,0,0,0,0,0,0,0,0,0,0,0,0,0,-56000
3006,晶豪科          ,346000,275000,71000,0,0,0,0,0,0,-127000,0,0,0,0,127000,-127000,-56000
06355P,聯茂永豐97售02  ,0,0,0,0,0,0,0,0,0,-56000,0,0,0,210000,266000,-56000,-56000
9908,大台北          ,1000,56000,-55000,0,0,0,0,0,0,-1000,0,1000,-1000,0,0,0,-56000
056704,健策國泰99購01  ,0,0,0,0,0,0,0,0,0,-57000,0,0,0,4000,61000,-57000,-57000
056485,同欣電元大98購01,0,0,0,0,0,0,0,0,0,-57000,0,0,0,134000,191000,-57000,-57000
05798P,臺股指群益96售12,0,0,0,0,0,0,0,0,0,-57000,0,0,0,15000,72000,-57000,-57000
05510P,燿華元富96售01  ,0,0,0,0,0,0,0,0,0,-57000,0,0,0,38000,95000,-57000,-57000
044792,康友群益93購01  ,0,0,0,0,0,0,0,0,0,-57000,0,0,0,35000,92000,-57000,-57000
046878,康友國泰94購01  ,0,0,0,0,0,0,0,0,0,-57000,0,0,0,20000,77000,-57000,-57000
050298,智伸科凱基94購02,0,0,0,0,0,0,0,0,0,-57000,0,0,0,11000,68000,-57000,-57000
047993,鑽全元大96購01  ,0,0,0,0,0,0,0,0,0,-57000,0,0,0,0,57000,-57000,-57000
04922P,日月光凱基94售02,0,0,0,0,0,0,0,0,0,-57000,0,0,0,0,57000,-57000,-57000
049167,元油2X凱基97購03,10000,0,10000,0,0,0,0,0,0,-67000,0,0,0,11000,78000,-67000,-57000
05252P,華通凱基95售01  ,0,0,0,0,0,0,0,0,0,-57000,0,0,0,0,57000,-57000,-57000
053000,臺股指康和96購02,0,0,0,0,0,0,0,0,0,-57000,0,0,0,2000,59000,-57000,-57000
6209,今國光          ,28000,85000,-57000,0,0,0,0,0,0,0,0,0,0,0,0,0,-57000
06269P,群創凱基98售10  ,0,0,0,0,0,0,0,0,0,-57000,0,0,0,0,57000,-57000,-57000
2727,王品            ,16000,73000,-57000,0,0,0,0,0,0,0,0,0,0,0,0,0,-57000
2707,晶華            ,25000,81000,-56000,0,0,0,0,0,0,-1000,0,0,0,0,1000,-1000,-57000
1711,永光            ,26000,83000,-57000,0,0,0,0,0,0,0,0,0,0,0,0,0,-57000
03896P,長榮航凱基95售01,0,0,0,0,0,0,0,0,0,-58000,0,0,0,2000,60000,-58000,-58000
049727,台積電中信94購02,0,0,0,0,0,0,0,0,0,-58000,0,0,0,10000,68000,-58000,-58000
049700,瀚宇博元大97購01,0,0,0,0,0,0,0,0,0,-58000,0,0,0,16000,74000,-58000,-58000
04961P,貿聯凱基94售03  ,0,0,0,0,0,0,0,0,0,-58000,0,0,0,8000,66000,-58000,-58000
051526,超眾凱基95購02  ,0,0,0,0,0,0,0,0,0,-58000,0,0,0,124000,182000,-58000,-58000
049819,百和元大94購02  ,0,0,0,0,0,0,0,0,0,-58000,0,0,0,10000,68000,-58000,-58000
052629,訊芯中信99購01  ,0,0,0,0,0,0,0,0,0,-58000,0,0,0,100000,158000,-58000,-58000
051749,矽力國泰97購01  ,0,0,0,0,0,0,0,0,0,-58000,0,0,0,8000,66000,-58000,-58000
05363P,臺股指富邦95售03,0,0,0,0,0,0,0,0,0,-58000,0,0,0,62000,120000,-58000,-58000
1618,合機            ,0,60000,-60000,0,0,0,0,0,0,2000,2000,0,2000,0,0,0,-58000
06326P,鴻海中信01售01  ,0,0,0,0,0,0,0,0,0,-58000,0,0,0,0,58000,-58000,-58000
06087P,國巨永豐97售01  ,0,0,0,0,0,0,0,0,0,-58000,0,0,0,0,58000,-58000,-58000
06486P,麗豐元大98售02  ,0,0,0,0,0,0,0,0,0,-58000,0,0,0,0,58000,-58000,-58000
055076,福懋科永豐97購01,0,0,0,0,0,0,0,0,0,-59000,0,0,0,183000,242000,-59000,-59000
056440,智邦凱基98購03  ,0,0,0,0,0,0,0,0,0,-59000,0,0,0,123000,182000,-59000,-59000
056201,華新科永豐98購01,0,0,0,0,0,0,0,0,0,-59000,0,0,0,29000,88000,-59000,-59000
051123,和鑫群益95購01  ,0,0,0,0,0,0,0,0,0,-59000,0,0,0,0,59000,-59000,-59000
053401,臺股指中信99購01,0,0,0,0,0,0,0,0,0,-59000,0,0,0,3000,62000,-59000,-59000
053311,同欣電凱基96購01,0,0,0,0,0,0,0,0,0,-59000,0,0,0,11000,70000,-59000,-59000
051913,緯創元大96購01  ,0,0,0,0,0,0,0,0,0,-59000,0,0,0,69000,128000,-59000,-59000
1451,年興            ,16000,73000,-57000,0,0,0,0,0,0,-2000,0,2000,-2000,0,0,0,-59000
08795P,聯發科凱基01售11,0,0,0,0,0,0,0,0,0,-59000,0,0,0,26000,85000,-59000,-59000
1108,幸福            ,5000,64000,-59000,0,0,0,0,0,0,0,0,0,0,0,0,0,-59000
2702,華園            ,9000,68000,-59000,0,0,0,0,0,0,0,0,0,0,0,0,0,-59000
6605,帝寶            ,4000,63000,-59000,0,0,0,0,0,0,0,0,0,0,0,0,0,-59000
056131,鴻海元大97購12  ,0,0,0,0,0,0,0,0,0,-60000,0,0,0,0,60000,-60000,-60000
056357,台積電元大9A購01,0,0,0,0,0,0,0,0,0,-60000,0,0,0,93000,153000,-60000,-60000
055463,國喬凱基97購01  ,0,0,0,0,0,0,0,0,0,-60000,0,0,0,0,60000,-60000,-60000
055171,凱美統一97購01  ,0,0,0,0,0,0,0,0,0,-60000,0,0,0,0,60000,-60000,-60000
055488,華邦電元大98購01,0,0,0,0,0,0,0,0,0,-60000,0,0,0,197000,257000,-60000,-60000
05555P,健策群益98售01  ,0,0,0,0,0,0,0,0,0,-60000,0,0,0,0,60000,-60000,-60000
04043P,復盛元富93售02  ,0,0,0,0,0,0,0,0,0,-60000,0,0,0,6000,66000,-60000,-60000
03526P,欣興凱基02售13  ,0,0,0,0,0,0,0,0,0,-60000,0,0,0,0,60000,-60000,-60000
043144,台肥統一93購01  ,0,0,0,0,0,0,0,0,0,-60000,0,0,0,0,60000,-60000,-60000
04287P,A50正2中信96售01,0,0,0,0,0,0,0,0,0,-60000,0,0,0,0,60000,-60000,-60000
04383P,泰鼎國泰95售01  ,0,0,0,0,0,0,0,0,0,-60000,0,0,0,0,60000,-60000,-60000
044289,群創凱基93購04  ,0,0,0,0,0,0,0,0,0,-60000,0,0,0,1000,61000,-60000,-60000
049496,和鑫元大95購01  ,0,0,0,0,0,0,0,0,0,-60000,0,0,0,60000,120000,-60000,-60000
050393,樺漢統一94購01  ,0,0,0,0,0,0,0,0,0,-60000,0,0,0,25000,85000,-60000,-60000
04706P,力山元大95售01  ,0,0,0,0,0,0,0,0,0,-60000,0,0,0,0,60000,-60000,-60000
050145,矽創台新94購01  ,0,0,0,0,0,0,0,0,0,-60000,0,0,0,0,60000,-60000,-60000
049807,新光金元大96購02,0,0,0,0,0,0,0,0,0,-60000,0,0,0,0,60000,-60000,-60000
049217,智邦國票95購01  ,0,0,0,0,0,0,0,0,0,-60000,0,0,0,0,60000,-60000,-60000
049115,創意統一94購03  ,0,0,0,0,0,0,0,0,0,-60000,0,0,0,48000,108000,-60000,-60000
048910,和鑫富邦98購01  ,0,0,0,0,0,0,0,0,0,-60000,0,0,0,0,60000,-60000,-60000
049936,柏文元大94購02  ,0,0,0,0,0,0,0,0,0,-60000,0,0,0,0,60000,-60000,-60000
051755,台積電元大96購08,0,0,0,0,0,0,0,0,0,-60000,0,0,0,110000,170000,-60000,-60000
051953,矽力元富95購03  ,0,0,0,0,0,0,0,0,0,-60000,0,0,0,115000,175000,-60000,-60000
052211,台積電元大95購22,0,0,0,0,0,0,0,0,0,-60000,0,0,0,555000,615000,-60000,-60000
052964,台表科凱基96購03,0,0,0,0,0,0,0,0,0,-60000,0,0,0,40000,100000,-60000,-60000
052982,鴻海元大97購06  ,0,0,0,0,0,0,0,0,0,-60000,0,0,0,0,60000,-60000,-60000
052906,緯創國票97購01  ,0,0,0,0,0,0,0,0,0,-60000,0,0,0,230000,290000,-60000,-60000
054344,景碩國票97購04  ,0,0,0,0,0,0,0,0,0,-60000,0,0,0,48000,108000,-60000,-60000
054356,可成兆豐97購01  ,0,0,0,0,0,0,0,0,0,-60000,0,0,0,0,60000,-60000,-60000
054372,南亞科中信96購01,0,0,0,0,0,0,0,0,0,-60000,0,0,0,81000,141000,-60000,-60000
05436P,台積電群益95售07,0,0,0,0,0,0,0,0,0,-60000,0,0,0,30000,90000,-60000,-60000
5525,順天            ,1000,61000,-60000,0,0,0,0,0,0,0,0,0,0,0,0,0,-60000
3563,牧德            ,216000,280000,-64000,0,0,0,51000,38000,13000,-9000,33000,7000,26000,16000,51000,-35000,-60000
1806,冠軍            ,6000,66000,-60000,0,0,0,0,0,0,0,0,0,0,0,0,0,-60000
2342,茂矽            ,22000,82000,-60000,0,0,0,0,0,0,0,0,0,0,0,0,0,-60000
06518P,奇力新兆豐99售01,0,0,0,0,0,0,0,0,0,-60000,0,0,0,0,60000,-60000,-60000
06271P,彩晶凱基97售01  ,0,0,0,0,0,0,0,0,0,-60000,0,0,0,0,60000,-60000,-60000
06256P,臺股指群益97售09,0,0,0,0,0,0,0,0,0,-60000,0,0,0,45000,105000,-60000,-60000
06238P,台積電元大98售07,0,0,0,0,0,0,0,0,0,-60000,0,0,0,0,60000,-60000,-60000
055553,聯發科凱基97購05,0,0,0,0,0,0,0,0,0,-61000,0,0,0,0,61000,-61000,-61000
054861,智邦群益97購01  ,0,0,0,0,0,0,0,0,0,-61000,0,0,0,0,61000,-61000,-61000
056218,億光中信98購01  ,0,0,0,0,0,0,0,0,0,-61000,0,0,0,50000,111000,-61000,-61000
046791,台郡統一96購01  ,0,0,0,0,0,0,0,0,0,-61000,0,0,0,17000,78000,-61000,-61000
049968,麗豐國票95購01  ,0,0,0,0,0,0,0,0,0,-61000,0,0,0,0,61000,-61000,-61000
048070,聯發科元富99購03,0,0,0,0,0,0,0,0,0,-61000,0,0,0,0,61000,-61000,-61000
053917,友達國票97購03  ,0,0,0,0,0,0,0,0,0,-61000,0,0,0,1000,62000,-61000,-61000
054118,國巨永豐96購04  ,0,0,0,0,0,0,0,0,0,-61000,0,0,0,337000,398000,-61000,-61000
06195P,台積電元富97售06,0,0,0,0,0,0,0,0,0,-61000,0,0,0,1528000,1589000,-61000,-61000
06273P,台表科凱基97售04,0,0,0,0,0,0,0,0,0,-61000,0,0,0,0,61000,-61000,-61000
06307P,聚陽元富97售02  ,1000,0,1000,0,0,0,0,0,0,-62000,0,0,0,23000,85000,-62000,-61000
9188,精熙-DR         ,0,61000,-61000,0,0,0,0,0,0,0,0,0,0,0,0,0,-61000
056237,智邦群益97購02  ,0,0,0,0,0,0,0,0,0,-62000,0,0,0,12000,74000,-62000,-62000
056245,嘉澤群益97購01  ,0,0,0,0,0,0,0,0,0,-62000,0,0,0,100000,162000,-62000,-62000
055049,智邦永豐97購01  ,0,0,0,0,0,0,0,0,0,-62000,0,0,0,0,62000,-62000,-62000
05507P,聯茂凱基96售02  ,0,0,0,0,0,0,0,0,0,-62000,0,0,0,26000,88000,-62000,-62000
055701,亞德客富邦99購01,0,0,0,0,0,0,0,0,0,-62000,0,0,0,895000,957000,-62000,-62000
04144P,瑞昱凱基93售10  ,0,0,0,0,0,0,0,0,0,-62000,0,0,0,0,62000,-62000,-62000
04914P,國巨國泰95售06  ,0,0,0,0,0,0,0,0,0,-62000,0,0,0,0,62000,-62000,-62000
054412,智邦元大96購03  ,0,0,0,0,0,0,0,0,0,-62000,0,0,0,206000,268000,-62000,-62000
052860,旺宏凱基96購03  ,0,0,0,0,0,0,0,0,0,-62000,0,0,0,90000,152000,-62000,-62000
9902,台火            ,9000,71000,-62000,0,0,0,0,0,0,0,0,0,0,0,0,0,-62000
9917,中保科          ,193000,255000,-62000,0,0,0,0,0,0,0,0,0,0,0,0,0,-62000
1582,信錦            ,78000,140000,-62000,0,0,0,0,0,0,0,0,0,0,0,0,0,-62000
2348,海悅            ,13000,78000,-65000,0,0,0,0,0,0,3000,3000,0,3000,0,0,0,-62000
5258,虹堡            ,36000,98000,-62000,0,0,0,0,0,0,0,0,0,0,0,0,0,-62000
4576,大銀微系統      ,0,62000,-62000,0,0,0,0,0,0,0,0,0,0,0,0,0,-62000
2705,六福            ,1000,63000,-62000,0,0,0,0,0,0,0,0,0,0,0,0,0,-62000
3033,威健            ,20000,82000,-62000,0,0,0,0,0,0,0,0,0,0,0,0,0,-62000
6669,緯穎            ,372707,355000,17707,0,0,0,10000,63000,-53000,-27000,6000,12000,-6000,10000,31000,-21000,-62293
04412P,欣興元富94售01  ,0,0,0,0,0,0,0,0,0,-63000,0,0,0,66000,129000,-63000,-63000
050342,華通元富94購02  ,0,0,0,0,0,0,0,0,0,-63000,0,0,0,111000,174000,-63000,-63000
052924,旺宏永豐96購01  ,0,0,0,0,0,0,0,0,0,-63000,0,0,0,2000,65000,-63000,-63000
052320,緯創元大95購05  ,0,0,0,0,0,0,0,0,0,-63000,0,0,0,18000,81000,-63000,-63000
052076,可成元富98購01  ,0,0,0,0,0,0,0,0,0,-63000,0,0,0,10000,73000,-63000,-63000
054100,致伸國票97購03  ,0,0,0,0,0,0,0,0,0,-63000,0,0,0,174000,237000,-63000,-63000
053443,智邦凱基97購01  ,0,0,0,0,0,0,0,0,0,-63000,0,0,0,36000,99000,-63000,-63000
1528,恩德            ,3000,66000,-63000,0,0,0,0,0,0,0,0,0,0,0,0,0,-63000
06322P,超眾統一97售04  ,0,0,0,0,0,0,0,0,0,-63000,0,0,0,0,63000,-63000,-63000
05999P,世芯元大96售01  ,0,0,0,0,0,0,0,0,0,-63000,0,0,0,316000,379000,-63000,-63000
055480,元上證元大97購02,0,0,0,0,0,0,0,0,0,-64000,0,0,0,25000,89000,-64000,-64000
055269,和大元大97購02  ,0,0,0,0,0,0,0,0,0,-64000,0,0,0,4000,68000,-64000,-64000
055340,華新科日盛97購01,0,0,0,0,0,0,0,0,0,-64000,0,0,0,537000,601000,-64000,-64000
03636C,元油2X元富04牛01,0,0,0,0,0,0,0,0,0,-64000,0,0,0,0,64000,-64000,-64000
049675,台光電國票95購01,0,0,0,0,0,0,0,0,0,-64000,0,0,0,30000,94000,-64000,-64000
053858,台達電元大96購05,0,0,0,0,0,0,0,0,0,-64000,0,0,0,10000,74000,-64000,-64000
06313P,訊芯元富97售01  ,0,0,0,0,0,0,0,0,0,-64000,0,0,0,330000,394000,-64000,-64000
06426P,T50正2元大9B售01,0,0,0,0,0,0,0,0,0,-64000,0,0,0,1297000,1361000,-64000,-64000
054920,智原凱基98購01  ,0,0,0,0,0,0,0,0,0,-65000,0,0,0,0,65000,-65000,-65000
056413,上証反中信9A購01,0,0,0,0,0,0,0,0,0,-65000,0,0,0,0,65000,-65000,-65000
05887P,友達元富99售03  ,0,0,0,0,0,0,0,0,0,-65000,0,0,0,57000,122000,-65000,-65000
04463P,可成元富94售03  ,0,0,0,0,0,0,0,0,0,-65000,0,0,0,1000,66000,-65000,-65000
04041P,大立光統一94售03,0,0,0,0,0,0,0,0,0,-65000,0,0,0,5000,70000,-65000,-65000
050995,貿聯元大95購02  ,0,0,0,0,0,0,0,0,0,-65000,0,0,0,0,65000,-65000,-65000
05162P,玉晶光國票96售03,0,0,0,0,0,0,0,0,0,-65000,0,0,0,135000,200000,-65000,-65000
054253,宏達電元大97購03,0,0,0,0,0,0,0,0,0,-65000,0,0,0,3000,68000,-65000,-65000
05259P,臺股指凱基96售12,0,0,0,0,0,0,0,0,0,-65000,0,0,0,0,65000,-65000,-65000
1507,永大            ,32000,98000,-66000,0,0,0,0,0,0,1000,2000,1000,1000,0,0,0,-65000
06267P,大立光凱基97售12,0,0,0,0,0,0,0,0,0,-65000,0,0,0,2000,67000,-65000,-65000
3057,喬鼎            ,4000,69000,-65000,0,0,0,0,0,0,0,0,0,0,0,0,0,-65000
2417,圓剛            ,13000,78000,-65000,0,0,0,0,0,0,0,0,0,0,0,0,0,-65000
054844,華邦電兆豐98購01,0,0,0,0,0,0,0,0,0,-66000,0,0,0,38000,104000,-66000,-66000
051380,禾伸堂群益95購01,0,0,0,0,0,0,0,0,0,-66000,0,0,0,16000,82000,-66000,-66000
049745,國巨永豐94購04  ,0,0,0,0,0,0,0,0,0,-66000,0,0,0,115000,181000,-66000,-66000
05262P,台積電元大95售19,0,0,0,0,0,0,0,0,0,-66000,0,0,0,0,66000,-66000,-66000
05303P,華通國泰97售01  ,0,0,0,0,0,0,0,0,0,-66000,0,0,0,10000,76000,-66000,-66000
054007,貿聯統一96購01  ,0,0,0,0,0,0,0,0,0,-66000,0,0,0,2000,68000,-66000,-66000
053318,全新群益99購01  ,0,0,0,0,0,0,0,0,0,-66000,0,0,0,54000,120000,-66000,-66000
3015,全漢            ,5000,72000,-67000,0,0,0,0,0,0,1000,1000,0,1000,0,0,0,-66000
4306,炎洲            ,41000,107000,-66000,0,0,0,0,0,0,0,0,0,0,0,0,0,-66000
1598,岱宇            ,11000,76000,-65000,0,0,0,0,0,0,-1000,0,1000,-1000,0,0,0,-66000
06386P,欣興永豐97售03  ,0,0,0,0,0,0,0,0,0,-66000,0,0,0,34000,100000,-66000,-66000
055121,鴻海兆豐97購03  ,0,0,0,0,0,0,0,0,0,-67000,0,0,0,3000,70000,-67000,-67000
054624,台積電凱基98購03,0,0,0,0,0,0,0,0,0,-67000,0,0,0,80000,147000,-67000,-67000
050764,鴻海元大94購27  ,0,0,0,0,0,0,0,0,0,-67000,0,0,0,406000,473000,-67000,-67000
05401P,聯茂永豐95售03  ,0,0,0,0,0,0,0,0,0,-67000,0,0,0,0,67000,-67000,-67000
054115,台塑康和96購01  ,0,0,0,0,0,0,0,0,0,-67000,0,0,0,47000,114000,-67000,-67000
052680,T50反1元大96購04,0,0,0,0,0,0,0,0,0,-67000,0,0,0,0,67000,-67000,-67000
052790,智邦兆豐97購01  ,0,0,0,0,0,0,0,0,0,-67000,0,0,0,20000,87000,-67000,-67000
1902,台紙            ,117000,179000,-62000,0,0,0,0,0,0,-5000,0,5000,-5000,0,0,0,-67000
6415,矽力-KY         ,182000,206000,-24000,0,0,0,0,35000,-35000,-8000,0,7000,-7000,0,1000,-1000,-67000
2880,華南金          ,2944000,3025161,-81161,0,0,0,14000,0,14000,0,0,0,0,0,0,0,-67161
054974,台表科元大98購02,0,0,0,0,0,0,0,0,0,-68000,0,0,0,0,68000,-68000,-68000
055383,GIS元大97購02   ,0,0,0,0,0,0,0,0,0,-68000,0,0,0,0,68000,-68000,-68000
055419,國巨永豐97購03  ,0,0,0,0,0,0,0,0,0,-68000,0,0,0,0,68000,-68000,-68000
055412,旺宏富邦99購01  ,0,0,0,0,0,0,0,0,0,-68000,0,0,0,118000,186000,-68000,-68000
055713,國巨元大98購09  ,0,0,0,0,0,0,0,0,0,-68000,0,0,0,115000,183000,-68000,-68000
056156,禾伸堂凱基98購04,0,0,0,0,0,0,0,0,0,-68000,0,0,0,29000,97000,-68000,-68000
056198,台光電永豐97購02,0,0,0,0,0,0,0,0,0,-68000,0,0,0,0,68000,-68000,-68000
055860,啟碁元大97購04  ,0,0,0,0,0,0,0,0,0,-68000,0,0,0,10000,78000,-68000,-68000
056031,勤誠康和97購02  ,0,0,0,0,0,0,0,0,0,-68000,0,0,0,0,68000,-68000,-68000
050461,GIS元大95購04   ,0,0,0,0,0,0,0,0,0,-68000,0,0,0,0,68000,-68000,-68000
050776,康控元大96購03  ,0,0,0,0,0,0,0,0,0,-68000,0,0,0,0,68000,-68000,-68000
048493,微星元大93購04  ,0,0,0,0,0,0,0,0,0,-68000,0,0,0,78000,146000,-68000,-68000
049169,統一凱基94購01  ,0,0,0,0,0,0,0,0,0,-68000,0,0,0,0,68000,-68000,-68000
051356,全新元大96購04  ,0,0,0,0,0,0,0,0,0,-68000,0,0,0,0,68000,-68000,-68000
051345,鴻海元大95購09  ,0,0,0,0,0,0,0,0,0,-68000,0,0,0,0,68000,-68000,-68000
047995,台達電元大96購01,0,0,0,0,0,0,0,0,0,-68000,0,0,0,20000,88000,-68000,-68000
051474,智邦凱基95購04  ,0,0,0,0,0,0,0,0,0,-68000,0,0,0,0,68000,-68000,-68000
051086,鴻海元大96購04  ,0,0,0,0,0,0,0,0,0,-68000,0,0,0,101000,169000,-68000,-68000
048946,崇越永豐94購01  ,0,0,0,0,0,0,0,0,0,-68000,0,0,0,0,68000,-68000,-68000
050248,臻鼎凱基94購03  ,0,0,0,0,0,0,0,0,0,-68000,0,0,0,0,68000,-68000,-68000
052917,大立光富邦99購02,0,0,0,0,0,0,0,0,0,-68000,0,0,0,30000,98000,-68000,-68000
054291,高鐵元大97購01  ,0,0,0,0,0,0,0,0,0,-68000,0,0,0,0,68000,-68000,-68000
054404,新日興康和96購01,0,0,0,0,0,0,0,0,0,-68000,0,0,0,0,68000,-68000,-68000
054366,和大中信98購01  ,0,0,0,0,0,0,0,0,0,-68000,0,0,0,50000,118000,-68000,-68000
2816,旺旺保          ,2000,70000,-68000,0,0,0,0,0,0,0,0,0,0,0,0,0,-68000
1736,喬山            ,375000,434000,-59000,0,0,0,0,0,0,-9000,0,0,0,3000,12000,-9000,-68000
1437,勤益控          ,3000,70000,-67000,0,0,0,0,0,0,-1000,0,1000,-1000,0,0,0,-68000
6698,旭暉應材        ,18000,75000,-57000,0,0,0,0,0,0,-11000,9000,20000,-11000,0,0,0,-68000
055978,大立光統一98購05,0,0,0,0,0,0,0,0,0,-69000,0,0,0,41000,110000,-69000,-69000
047895,台積電群益94購04,0,0,0,0,0,0,0,0,0,-69000,0,0,0,35000,104000,-69000,-69000
046348,嘉澤兆豐93購01  ,0,0,0,0,0,0,0,0,0,-69000,0,0,0,0,69000,-69000,-69000
03821P,上海銀統一95售01,0,0,0,0,0,0,0,0,0,-69000,0,0,0,1000,70000,-69000,-69000
051003,中環中信97購01  ,0,0,0,0,0,0,0,0,0,-69000,0,0,0,0,69000,-69000,-69000
051092,禾伸堂元大95購02,0,0,0,0,0,0,0,0,0,-69000,0,0,0,13000,82000,-69000,-69000
053224,矽力凱基96購02  ,0,0,0,0,0,0,0,0,0,-69000,0,0,0,0,69000,-69000,-69000
052469,宏碁亞東95購01  ,0,0,0,0,0,0,0,0,0,-69000,0,0,0,48000,117000,-69000,-69000
4426,利勤            ,48000,117000,-69000,0,0,0,0,0,0,0,0,0,0,0,0,0,-69000
055885,大成鋼統一97購02,0,0,0,0,0,0,0,0,0,-70000,0,0,0,0,70000,-70000,-70000
056219,T50反1日盛02購01,0,0,0,0,0,0,0,0,0,-70000,0,0,0,0,70000,-70000,-70000
056464,臺股指凱基99購06,0,0,0,0,0,0,0,0,0,-70000,0,0,0,0,70000,-70000,-70000
055507,樺漢元大98購02  ,0,0,0,0,0,0,0,0,0,-70000,0,0,0,464000,534000,-70000,-70000
055170,光磊統一97購01  ,0,0,0,0,0,0,0,0,0,-70000,0,0,0,0,70000,-70000,-70000
054916,聯發科凱基98購04,0,0,0,0,0,0,0,0,0,-70000,0,0,0,110000,180000,-70000,-70000
054913,億光凱基97購01  ,0,0,0,0,0,0,0,0,0,-70000,0,0,0,150000,220000,-70000,-70000
054840,T50反1兆豐98購01,0,0,0,0,0,0,0,0,0,-70000,0,0,0,0,70000,-70000,-70000
055124,建準兆豐97購01  ,0,0,0,0,0,0,0,0,0,-70000,0,0,0,0,70000,-70000,-70000
055035,興勤富邦98購01  ,0,0,0,0,0,0,0,0,0,-70000,0,0,0,0,70000,-70000,-70000
055044,信錦永豐97購01  ,0,0,0,0,0,0,0,0,0,-70000,0,0,0,0,70000,-70000,-70000
055005,晶相光元富97購01,0,0,0,0,0,0,0,0,0,-70000,0,0,0,68000,138000,-70000,-70000
043764,康友元大92購03  ,0,0,0,0,0,0,0,0,0,-70000,0,0,0,0,70000,-70000,-70000
047680,上証反中信96購01,0,0,0,0,0,0,0,0,0,-70000,0,0,0,0,70000,-70000,-70000
050978,鴻海元富95購03  ,0,0,0,0,0,0,0,0,0,-70000,0,0,0,318000,388000,-70000,-70000
050990,T50反1元大95購01,0,0,0,0,0,0,0,0,0,-70000,0,0,0,0,70000,-70000,-70000
051136,可成永豐95購02  ,0,0,0,0,0,0,0,0,0,-70000,0,0,0,0,70000,-70000,-70000
051247,可成元大95購04  ,0,0,0,0,0,0,0,0,0,-70000,0,0,0,10000,80000,-70000,-70000
048143,聯發科統一94購03,0,0,0,0,0,0,0,0,0,-70000,0,0,0,106000,176000,-70000,-70000
049848,聯發科群益94購06,0,0,0,0,0,0,0,0,0,-70000,0,0,0,110000,180000,-70000,-70000
049966,旺宏國票95購02  ,0,0,0,0,0,0,0,0,0,-70000,0,0,0,0,70000,-70000,-70000
051886,道瓊反統一95購03,0,0,0,0,0,0,0,0,0,-70000,0,0,0,0,70000,-70000,-70000
053008,達方永豐96購01  ,0,0,0,0,0,0,0,0,0,-70000,0,0,0,0,70000,-70000,-70000
053146,滬深2X元大96購08,0,0,0,0,0,0,0,0,0,-70000,0,0,0,0,70000,-70000,-70000
052827,昇陽半永豐97購01,0,0,0,0,0,0,0,0,0,-70000,0,0,0,62000,132000,-70000,-70000
053761,健策國泰98購01  ,0,0,0,0,0,0,0,0,0,-70000,0,0,0,1853000,1923000,-70000,-70000
054124,達方永豐96購02  ,0,0,0,0,0,0,0,0,0,-70000,0,0,0,0,70000,-70000,-70000
5243,乙盛-KY         ,130000,180000,-50000,0,0,0,0,0,0,-20000,0,20000,-20000,0,0,0,-70000
2332,友訊            ,516000,277000,239000,0,0,0,0,0,0,-309000,0,112000,-112000,28000,225000,-197000,-70000
2480,敦陽科          ,45000,115000,-70000,0,0,0,0,0,0,0,0,0,0,0,0,0,-70000
1217,愛之味          ,28000,98000,-70000,0,0,0,0,0,0,0,0,0,0,0,0,0,-70000
05989P,健策元富96售01  ,0,0,0,0,0,0,0,0,0,-70000,0,0,0,6000,76000,-70000,-70000
9941,裕融            ,43000,113000,-70000,0,0,0,0,0,0,0,0,0,0,0,0,0,-70000
056177,嘉澤元富97購01  ,0,0,0,0,0,0,0,0,0,-71000,0,0,0,73000,144000,-71000,-71000
056088,台郡統一97購02  ,0,0,0,0,0,0,0,0,0,-71000,0,0,0,84000,155000,-71000,-71000
048527,鴻海國票94購02  ,0,0,0,0,0,0,0,0,0,-71000,0,0,0,0,71000,-71000,-71000
04293P,滬深2X元大96售02,0,0,0,0,0,0,0,0,0,-71000,0,0,0,0,71000,-71000,-71000
051042,中磊永豐95購01  ,0,0,0,0,0,0,0,0,0,-71000,0,0,0,0,71000,-71000,-71000
049410,統一凱基94購02  ,0,0,0,0,0,0,0,0,0,-71000,0,0,0,0,71000,-71000,-71000
050801,元金2X群益98購01,0,0,0,0,0,0,0,0,0,-71000,0,0,0,10000,81000,-71000,-71000
051754,廣宇元大95購01  ,0,0,0,0,0,0,0,0,0,-71000,0,0,0,0,71000,-71000,-71000
05231P,GIS群益95售03   ,0,0,0,0,0,0,0,0,0,-71000,0,0,0,20000,91000,-71000,-71000
06058P,玉晶光凱基97售04,0,0,0,0,0,0,0,0,0,-71000,0,0,0,3000,74000,-71000,-71000
06378P,國巨統一97售08  ,0,0,0,0,0,0,0,0,0,-71000,0,0,0,12000,83000,-71000,-71000
056691,元油2X群益9B購01,0,0,0,0,0,0,0,0,0,-72000,0,0,0,3000,75000,-72000,-72000
05925P,晶技永豐96售03  ,0,0,0,0,0,0,0,0,0,-72000,0,0,0,0,72000,-72000,-72000
054834,帆宣中信97購01  ,0,0,0,0,0,0,0,0,0,-72000,0,0,0,100000,172000,-72000,-72000
055259,玉晶光統一9A購01,0,0,0,0,0,0,0,0,0,-72000,0,0,0,135000,207000,-72000,-72000
055414,奇力新富邦9B購01,0,0,0,0,0,0,0,0,0,-72000,0,0,0,10000,82000,-72000,-72000
055415,禾伸堂富邦9B購01,0,0,0,0,0,0,0,0,0,-72000,0,0,0,177000,249000,-72000,-72000
055602,康控元大97購03  ,0,0,0,0,0,0,0,0,0,-72000,0,0,0,153000,225000,-72000,-72000
043958,臻鼎元富94購01  ,0,0,0,0,0,0,0,0,0,-72000,0,0,0,355000,427000,-72000,-72000
048781,臺股指凱基96購01,0,0,0,0,0,0,0,0,0,-72000,0,0,0,4000,76000,-72000,-72000
053661,嘉澤凱基97購01  ,0,0,0,0,0,0,0,0,0,-72000,0,0,0,20000,92000,-72000,-72000
06100P,台積電日盛97售03,0,0,0,0,0,0,0,0,0,-72000,0,0,0,455000,527000,-72000,-72000
06110P,國巨國泰98售02  ,0,0,0,0,0,0,0,0,0,-72000,0,0,0,132000,204000,-72000,-72000
2406,國碩            ,55000,127000,-72000,0,0,0,0,0,0,0,0,0,0,0,0,0,-72000
2030,彰源            ,8000,80000,-72000,0,0,0,0,0,0,0,0,0,0,0,0,0,-72000
8011,台通            ,3000,75000,-72000,0,0,0,0,0,0,0,0,0,0,0,0,0,-72000
6672,騰輝電子-KY     ,34000,106000,-72000,0,0,0,0,0,0,0,0,0,0,0,0,0,-72000
055635,緯穎永豐97購01  ,0,0,0,0,0,0,0,0,0,-73000,0,0,0,0,73000,-73000,-73000
055272,國巨元大98購04  ,0,0,0,0,0,0,0,0,0,-73000,0,0,0,15000,88000,-73000,-73000
054982,國巨元富97購03  ,0,0,0,0,0,0,0,0,0,-73000,0,0,0,117000,190000,-73000,-73000
045069,美律元大93購03  ,0,0,0,0,0,0,0,0,0,-73000,0,0,0,20000,93000,-73000,-73000
044255,群創元大93購01  ,0,0,0,0,0,0,0,0,0,-73000,0,0,0,83000,156000,-73000,-73000
042556,台灣50中信96購04,0,0,0,0,0,0,0,0,0,-73000,0,0,0,149000,222000,-73000,-73000
045293,鴻海元大94購01  ,0,0,0,0,0,0,0,0,0,-73000,0,0,0,1000,74000,-73000,-73000
044852,華邦電國泰93購02,0,0,0,0,0,0,0,0,0,-73000,0,0,0,120000,193000,-73000,-73000
04053P,聯茂國泰94售01  ,0,0,0,0,0,0,0,0,0,-73000,0,0,0,0,73000,-73000,-73000
048539,巨大國票94購01  ,0,0,0,0,0,0,0,0,0,-73000,0,0,0,10000,83000,-73000,-73000
050895,聯發科元大97購01,0,0,0,0,0,0,0,0,0,-73000,0,0,0,82000,155000,-73000,-73000
049681,旺宏統一94購04  ,0,0,0,0,0,0,0,0,0,-73000,0,0,0,77000,150000,-73000,-73000
048745,儒鴻元富97購02  ,0,0,0,0,0,0,0,0,0,-73000,0,0,0,50000,123000,-73000,-73000
052644,聯發科永豐96購01,0,0,0,0,0,0,0,0,0,-73000,0,0,0,99000,172000,-73000,-73000
2022,聚亨            ,5000,78000,-73000,0,0,0,0,0,0,0,0,0,0,0,0,0,-73000
1734,杏輝            ,86000,92000,-6000,0,0,0,0,0,0,-67000,0,7000,-7000,0,60000,-60000,-73000
2453,凌群            ,42000,115000,-73000,0,0,0,0,0,0,0,0,0,0,0,0,0,-73000
06246P,茂林元富97售03  ,0,0,0,0,0,0,0,0,0,-73000,0,0,0,91000,164000,-73000,-73000
1321,大洋            ,18000,91000,-73000,0,0,0,0,0,0,0,0,0,0,0,0,0,-73000
05478P,智伸科國票96售02,0,0,0,0,0,0,0,0,0,-74000,0,0,0,4000,78000,-74000,-74000
055328,鈺齊國票98購01  ,0,0,0,0,0,0,0,0,0,-74000,0,0,0,0,74000,-74000,-74000
056498,A50正2富邦9B購01,0,0,0,0,0,0,0,0,0,-74000,0,0,0,1000,75000,-74000,-74000
04947P,聯詠元大94售05  ,0,0,0,0,0,0,0,0,0,-74000,0,0,0,0,74000,-74000,-74000
00675L,富邦臺灣加權正2 ,0,32000,-32000,0,0,0,0,0,0,-42000,0,0,0,22000,64000,-42000,-74000
047470,聯發科中信94購03,0,0,0,0,0,0,0,0,0,-74000,0,0,0,134000,208000,-74000,-74000
043696,瑞儀兆豐93購01  ,0,0,0,0,0,0,0,0,0,-74000,0,0,0,30000,104000,-74000,-74000
05234P,美食康和95售01  ,0,0,0,0,0,0,0,0,0,-74000,0,0,0,10000,84000,-74000,-74000
054464,奇力新凱基98購02,0,0,0,0,0,0,0,0,0,-74000,0,0,0,60000,134000,-74000,-74000
06300P,緯穎元大97售04  ,0,0,0,0,0,0,0,0,0,-74000,0,0,0,31000,105000,-74000,-74000
8033,雷虎            ,3000,77000,-74000,0,0,0,0,0,0,0,0,0,0,0,0,0,-74000
056604,鴻海富邦9A購01  ,0,0,0,0,0,0,0,0,0,-75000,0,0,0,0,75000,-75000,-75000
056305,群創元大9A購03  ,0,0,0,0,0,0,0,0,0,-75000,0,0,0,31000,106000,-75000,-75000
056323,旺宏兆豐98購01  ,0,0,0,0,0,0,0,0,0,-75000,0,0,0,0,75000,-75000,-75000
05482P,鴻海凱基95售22  ,0,0,0,0,0,0,0,0,0,-75000,0,0,0,20000,95000,-75000,-75000
04138P,智邦國票93售02  ,0,0,0,0,0,0,0,0,0,-75000,0,0,0,0,75000,-75000,-75000
044965,大立光中信95購01,0,0,0,0,0,0,0,0,0,-75000,0,0,0,80000,155000,-75000,-75000
045362,A50正2兆豐93購02,0,0,0,0,0,0,0,0,0,-75000,0,0,0,0,75000,-75000,-75000
048780,臺股指凱基94購03,0,0,0,0,0,0,0,0,0,-75000,0,0,0,0,75000,-75000,-75000
049792,元油2X元大94購08,0,0,0,0,0,0,0,0,0,-75000,0,0,0,0,75000,-75000,-75000
050331,鈺齊永豐94購02  ,0,0,0,0,0,0,0,0,0,-75000,0,0,0,0,75000,-75000,-75000
053716,京元電凱基97購01,0,0,0,0,0,0,0,0,0,-75000,0,0,0,35000,110000,-75000,-75000
053787,健策元大97購02  ,0,0,0,0,0,0,0,0,0,-75000,0,0,0,498000,573000,-75000,-75000
052925,日電貿永豐96購01,0,0,0,0,0,0,0,0,0,-75000,0,0,0,6000,81000,-75000,-75000
6152,百一            ,4000,79000,-75000,0,0,0,0,0,0,0,0,0,0,0,0,0,-75000
06020P,燿華元富96售04  ,0,0,0,0,0,0,0,0,0,-75000,0,0,0,16000,91000,-75000,-75000
06510P,燿華永豐98售03  ,0,0,0,0,0,0,0,0,0,-75000,0,0,0,0,75000,-75000,-75000
2228,劍麟            ,19000,78000,-59000,0,0,0,0,0,0,-16000,0,0,0,0,16000,-16000,-75000
3031,佰鴻            ,34000,109000,-75000,0,0,0,0,0,0,0,0,0,0,0,0,0,-75000
054782,國巨群益97購01  ,0,0,0,0,0,0,0,0,0,-76000,0,0,0,28000,104000,-76000,-76000
05540P,亞德客凱基96售01,0,0,0,0,0,0,0,0,0,-76000,0,0,0,25000,101000,-76000,-76000
05635P,健策台新96售02  ,0,0,0,0,0,0,0,0,0,-76000,0,0,0,25000,101000,-76000,-76000
055965,泰鼎元大97購03  ,0,0,0,0,0,0,0,0,0,-76000,0,0,0,151000,227000,-76000,-76000
056742,玉晶光凱基9A購01,0,0,0,0,0,0,0,0,0,-76000,0,0,0,0,76000,-76000,-76000
05905P,晶技統一97售01  ,0,0,0,0,0,0,0,0,0,-76000,0,0,0,0,76000,-76000,-76000
047447,台郡元大94購02  ,0,0,0,0,0,0,0,0,0,-76000,0,0,0,0,76000,-76000,-76000
051641,矽創國票96購01  ,0,0,0,0,0,0,0,0,0,-76000,0,0,0,71000,147000,-76000,-76000
052389,聯發科群益95購05,0,0,0,0,0,0,0,0,0,-76000,0,0,0,22000,98000,-76000,-76000
053751,康控永豐96購02  ,0,0,0,0,0,0,0,0,0,-76000,0,0,0,20000,96000,-76000,-76000
053672,嘉澤元富96購02  ,0,0,0,0,0,0,0,0,0,-76000,0,0,0,239000,315000,-76000,-76000
1316,上曜            ,3000,79000,-76000,0,0,0,0,0,0,0,0,0,0,0,0,0,-76000
1503,士電            ,12000,88000,-76000,0,0,0,0,0,0,0,0,0,0,0,0,0,-76000
05919P,京鼎元大96售03  ,0,0,0,0,0,0,0,0,0,-77000,0,0,0,1000,78000,-77000,-77000
056605,台積電富邦9B購02,0,0,0,0,0,0,0,0,0,-77000,0,0,0,0,77000,-77000,-77000
047608,聯發科第一95購01,0,0,0,0,0,0,0,0,0,-77000,0,0,0,0,77000,-77000,-77000
049055,聯詠永豐94購01  ,0,0,0,0,0,0,0,0,0,-77000,0,0,0,94000,171000,-77000,-77000
049957,智邦統一94購01  ,0,0,0,0,0,0,0,0,0,-77000,0,0,0,0,77000,-77000,-77000
05084P,嘉聯益永豐95售02,0,0,0,0,0,0,0,0,0,-77000,0,0,0,0,77000,-77000,-77000
05083P,麗豐永豐95售02  ,0,0,0,0,0,0,0,0,0,-77000,0,0,0,10000,87000,-77000,-77000
052805,晶技元大97購01  ,0,0,0,0,0,0,0,0,0,-77000,0,0,0,68000,145000,-77000,-77000
055389,國巨統一98購02  ,0,0,0,0,0,0,0,0,0,-78000,0,0,0,24000,102000,-78000,-78000
055192,世芯元富97購01  ,0,0,0,0,0,0,0,0,0,-78000,0,0,0,50000,128000,-78000,-78000
055108,智邦凱基98購01  ,0,0,0,0,0,0,0,0,0,-78000,0,0,0,16000,94000,-78000,-78000
03372P,台積電元大02售25,0,0,0,0,0,0,0,0,0,-78000,0,0,0,12000,90000,-78000,-78000
048708,智邦亞東94購01  ,0,0,0,0,0,0,0,0,0,-78000,0,0,0,0,78000,-78000,-78000
06091P,華新科統一97售01,0,0,0,0,0,0,0,0,0,-78000,0,0,0,19000,97000,-78000,-78000
06154P,超眾元大98售01  ,0,0,0,0,0,0,0,0,0,-78000,0,0,0,15000,93000,-78000,-78000
055184,群創統一98購02  ,0,0,0,0,0,0,0,0,0,-79000,0,0,0,95000,174000,-79000,-79000
047881,和鑫國泰95購01  ,0,0,0,0,0,0,0,0,0,-79000,0,0,0,1000,80000,-79000,-79000
047104,和大元大93購02  ,0,0,0,0,0,0,0,0,0,-79000,0,0,0,0,79000,-79000,-79000
05304P,國巨國泰97售02  ,0,0,0,0,0,0,0,0,0,-79000,0,0,0,0,79000,-79000,-79000
051995,矽力元大95購03  ,0,0,0,0,0,0,0,0,0,-79000,0,0,0,0,79000,-79000,-79000
3094,聯傑            ,42000,121000,-79000,0,0,0,0,0,0,0,0,0,0,0,0,0,-79000
2536,宏普            ,35000,114000,-79000,0,0,0,0,0,0,0,0,0,0,0,0,0,-79000
5907,大洋-KY         ,57000,135000,-78000,0,0,0,0,0,0,-1000,0,1000,-1000,0,0,0,-79000
055172,凱美統一97購02  ,0,0,0,0,0,0,0,0,0,-80000,0,0,0,0,80000,-80000,-80000
05549P,臺股指元大96售03,0,0,0,0,0,0,0,0,0,-80000,0,0,0,60000,140000,-80000,-80000
054999,玉晶光元富97購03,0,0,0,0,0,0,0,0,0,-80000,0,0,0,60000,140000,-80000,-80000
054695,世芯永豐98購01  ,0,0,0,0,0,0,0,0,0,-80000,0,0,0,3000,83000,-80000,-80000
056661,臺股指元大9A購08,0,0,0,0,0,0,0,0,0,-80000,0,0,0,0,80000,-80000,-80000
056698,T50反1國泰9A購01,0,0,0,0,0,0,0,0,0,-80000,0,0,0,0,80000,-80000,-80000
056501,貿聯富邦99購01  ,0,0,0,0,0,0,0,0,0,-80000,0,0,0,0,80000,-80000,-80000
05595P,友達統一96售02  ,0,0,0,0,0,0,0,0,0,-80000,0,0,0,0,80000,-80000,-80000
056116,義隆群益97購02  ,0,0,0,0,0,0,0,0,0,-80000,0,0,0,210000,290000,-80000,-80000
05613P,臻鼎台新96售01  ,0,0,0,0,0,0,0,0,0,-80000,0,0,0,5000,85000,-80000,-80000
047356,貿聯兆豐94購01  ,0,0,0,0,0,0,0,0,0,-80000,0,0,0,10000,90000,-80000,-80000
04858P,健策元富94售01  ,0,0,0,0,0,0,0,0,0,-80000,0,0,0,0,80000,-80000,-80000
047750,開發金元富93購01,0,0,0,0,0,0,0,0,0,-80000,0,0,0,20000,100000,-80000,-80000
046838,勤誠群益93購01  ,0,0,0,0,0,0,0,0,0,-80000,0,0,0,10000,90000,-80000,-80000
046137,遠東新統一92購01,0,0,0,0,0,0,0,0,0,-80000,0,0,0,50000,130000,-80000,-80000
045883,元油2X元大95購07,0,0,0,0,0,0,0,0,0,-80000,0,0,0,5000,85000,-80000,-80000
03811P,鴻海群益93售06  ,0,0,0,0,0,0,0,0,0,-80000,0,0,0,0,80000,-80000,-80000
04136P,智邦元大93售09  ,0,0,0,0,0,0,0,0,0,-80000,0,0,0,5000,85000,-80000,-80000
04072P,臺股指凱基93售08,0,0,0,0,0,0,0,0,0,-80000,0,0,0,0,80000,-80000,-80000
04106P,滬深2X永豐93售02,0,0,0,0,0,0,0,0,0,-80000,0,0,0,50000,130000,-80000,-80000
046433,康友中信92購01  ,0,0,0,0,0,0,0,0,0,-80000,0,0,0,10000,90000,-80000,-80000
04513P,元石油中信94售01,0,0,0,0,0,0,0,0,0,-80000,0,0,0,20000,100000,-80000,-80000
049686,T50反1元大94購02,0,0,0,0,0,0,0,0,0,-80000,0,0,0,120000,200000,-80000,-80000
050162,中環國泰95購01  ,0,0,0,0,0,0,0,0,0,-80000,0,0,0,0,80000,-80000,-80000
04978P,台表科凱基94售02,0,0,0,0,0,0,0,0,0,-80000,0,0,0,0,80000,-80000,-80000
049283,滬深2X中信95購10,0,0,0,0,0,0,0,0,0,-80000,0,0,0,150000,230000,-80000,-80000
051657,台郡元富98購01  ,0,0,0,0,0,0,0,0,0,-80000,0,0,0,0,80000,-80000,-80000
051747,貿聯國泰96購01  ,0,0,0,0,0,0,0,0,0,-80000,0,0,0,0,80000,-80000,-80000
051797,卜蜂永豐95購01  ,0,0,0,0,0,0,0,0,0,-80000,0,0,0,0,80000,-80000,-80000
051862,旺宏凱基95購05  ,0,0,0,0,0,0,0,0,0,-80000,0,0,0,6000,86000,-80000,-80000
051842,大成鋼富邦97購01,0,0,0,0,0,0,0,0,0,-80000,0,0,0,0,80000,-80000,-80000
052137,台表科凱基96購02,0,0,0,0,0,0,0,0,0,-80000,0,0,0,0,80000,-80000,-80000
052798,滬深2X元大96購07,0,0,0,0,0,0,0,0,0,-80000,0,0,0,23000,103000,-80000,-80000
053188,旺宏統一97購03  ,0,0,0,0,0,0,0,0,0,-80000,0,0,0,30000,110000,-80000,-80000
05417P,燿華永豐95售07  ,0,0,0,0,0,0,0,0,0,-80000,0,0,0,0,80000,-80000,-80000
8429,金麗-KY         ,13000,93000,-80000,0,0,0,0,0,0,0,0,0,0,0,0,0,-80000
8404,百和興業-KY     ,57000,137000,-80000,0,0,0,0,0,0,0,3000,3000,0,0,0,0,-80000
1723,中碳            ,19000,99000,-80000,0,0,0,0,0,0,0,0,0,0,0,0,0,-80000
3312,弘憶股          ,37000,117000,-80000,0,0,0,0,0,0,0,0,0,0,0,0,0,-80000
06323P,台郡統一97售01  ,0,0,0,0,0,0,0,0,0,-80000,0,0,0,20000,100000,-80000,-80000
1338,廣華-KY         ,12000,92000,-80000,0,0,0,0,0,0,0,0,0,0,0,0,0,-80000
05764P,世紀鋼永豐96售03,0,0,0,0,0,0,0,0,0,-81000,0,0,0,0,81000,-81000,-81000
054788,華新科群益98購02,0,0,0,0,0,0,0,0,0,-81000,0,0,0,46000,127000,-81000,-81000
048945,訊連永豐94購01  ,0,0,0,0,0,0,0,0,0,-81000,0,0,0,10000,91000,-81000,-81000
050261,國巨元大95購04  ,0,0,0,0,0,0,0,0,0,-81000,0,0,0,64000,145000,-81000,-81000
04927P,大立光凱基95售06,0,0,0,0,0,0,0,0,0,-81000,0,0,0,40000,121000,-81000,-81000
054435,華新科台新97購02,0,0,0,0,0,0,0,0,0,-81000,0,0,0,9000,90000,-81000,-81000
053196,康控元富96購01  ,0,0,0,0,0,0,0,0,0,-81000,0,0,0,20000,101000,-81000,-81000
8462,柏文            ,8000,86000,-78000,0,0,0,0,3000,-3000,0,0,0,0,0,0,0,-81000
1231,聯華食          ,5000,86984,-81984,0,0,0,0,0,0,0,0,0,0,0,0,0,-81984
056714,晶相光永豐98購02,0,0,0,0,0,0,0,0,0,-82000,0,0,0,0,82000,-82000,-82000
056439,華邦電凱基98購02,0,0,0,0,0,0,0,0,0,-82000,0,0,0,51000,133000,-82000,-82000
04253P,聯發科元富93售01,0,0,0,0,0,0,0,0,0,-82000,0,0,0,0,82000,-82000,-82000
049740,禾伸堂群益94購01,0,0,0,0,0,0,0,0,0,-82000,0,0,0,143000,225000,-82000,-82000
04843P,致新元大94售02  ,0,0,0,0,0,0,0,0,0,-82000,0,0,0,0,82000,-82000,-82000
048744,儒鴻元富97購01  ,0,0,0,0,0,0,0,0,0,-82000,0,0,0,5000,87000,-82000,-82000
050789,矽創國泰96購01  ,0,0,0,0,0,0,0,0,0,-82000,0,0,0,10000,92000,-82000,-82000
051073,同欣電國票96購01,0,0,0,0,0,0,0,0,0,-82000,0,0,0,80000,162000,-82000,-82000
053291,旺宏中信9A購01  ,0,0,0,0,0,0,0,0,0,-82000,0,0,0,7000,89000,-82000,-82000
052894,國巨群益96購03  ,0,0,0,0,0,0,0,0,0,-82000,0,0,0,68000,150000,-82000,-82000
05195P,南茂康和95售01  ,0,0,0,0,0,0,0,0,0,-82000,0,0,0,0,82000,-82000,-82000
1225,福懋油          ,2000,85000,-83000,0,0,0,0,0,0,1000,1000,0,1000,0,0,0,-82000
06215P,康控永豐97售02  ,0,0,0,0,0,0,0,0,0,-82000,0,0,0,1000,83000,-82000,-82000
2374,佳能            ,14000,96000,-82000,0,0,0,0,0,0,0,0,0,0,0,0,0,-82000
6177,達麗            ,5000,87000,-82000,0,0,0,0,0,0,0,0,0,0,0,0,0,-82000
055141,牧德永豐98購02  ,0,0,0,0,0,0,0,0,0,-83000,0,0,0,107000,190000,-83000,-83000
03450P,元油2X元富98售05,0,0,0,0,0,0,0,0,0,-83000,0,0,0,17000,100000,-83000,-83000
050396,欣興元富94購02  ,0,0,0,0,0,0,0,0,0,-83000,0,0,0,0,83000,-83000,-83000
050344,鴻海元富96購01  ,0,0,0,0,0,0,0,0,0,-83000,0,0,0,147000,230000,-83000,-83000
050077,臺股指凱基99購02,0,0,0,0,0,0,0,0,0,-83000,0,0,0,0,83000,-83000,-83000
051000,台郡元大96購01  ,0,0,0,0,0,0,0,0,0,-83000,0,0,0,50000,133000,-83000,-83000
048258,國泰金統一93購01,0,0,0,0,0,0,0,0,0,-83000,0,0,0,0,83000,-83000,-83000
052926,旺宏元大98購02  ,0,0,0,0,0,0,0,0,0,-83000,0,0,0,225000,308000,-83000,-83000
053420,華邦電永豐96購01,0,0,0,0,0,0,0,0,0,-83000,0,0,0,0,83000,-83000,-83000
4137,麗豐-KY         ,46000,128000,-82000,0,0,0,0,0,0,-1000,1000,0,1000,0,2000,-2000,-83000
5215,科嘉-KY         ,19000,102000,-83000,0,0,0,0,0,0,0,0,0,0,0,0,0,-83000
05471P,聯電統一95售01  ,0,0,0,0,0,0,0,0,0,-84000,0,0,0,0,84000,-84000,-84000
03968P,聯發科國票93售05,0,0,0,0,0,0,0,0,0,-84000,0,0,0,40000,124000,-84000,-84000
00713,元大台灣高息低波,0,43000,-43000,0,0,0,0,0,0,-41000,0,0,0,0,41000,-41000,-84000
054472,道瓊反中信9A購01,0,0,0,0,0,0,0,0,0,-84000,0,0,0,10000,94000,-84000,-84000
4540,全球傳動        ,22000,106000,-84000,0,0,0,0,0,0,0,0,0,0,0,0,0,-84000
055212,和大凱基97購02  ,0,0,0,0,0,0,0,0,0,-85000,0,0,0,23000,108000,-85000,-85000
055235,金寶台新98購01  ,0,0,0,0,0,0,0,0,0,-85000,0,0,0,10000,95000,-85000,-85000
055441,緯穎國票98購01  ,0,0,0,0,0,0,0,0,0,-85000,0,0,0,18000,103000,-85000,-85000
056359,旺宏元大9A購01  ,0,0,0,0,0,0,0,0,0,-85000,0,0,0,73000,158000,-85000,-85000
03686P,大立光統一98售02,0,0,0,0,0,0,0,0,0,-85000,0,0,0,437000,522000,-85000,-85000
046208,滬深2X元富95購03,0,0,0,0,0,0,0,0,0,-85000,0,0,0,14000,99000,-85000,-85000
052956,聯發科日盛96購01,0,0,0,0,0,0,0,0,0,-85000,0,0,0,25000,110000,-85000,-85000
051923,聯發科日盛95購02,0,0,0,0,0,0,0,0,0,-85000,0,0,0,55000,140000,-85000,-85000
05226P,智邦統一95售01  ,0,0,0,0,0,0,0,0,0,-85000,0,0,0,10000,95000,-85000,-85000
2514,龍邦            ,1000,86000,-85000,0,0,0,0,0,0,0,0,0,0,0,0,0,-85000
056099,上銀永豐97購02  ,0,0,0,0,0,0,0,0,0,-86000,0,0,0,262000,348000,-86000,-86000
055442,矽創國票98購02  ,0,0,0,0,0,0,0,0,0,-86000,0,0,0,60000,146000,-86000,-86000
055520,矽力中信97購02  ,0,0,0,0,0,0,0,0,0,-86000,0,0,0,105000,191000,-86000,-86000
049501,台郡元大95購01  ,0,0,0,0,0,0,0,0,0,-86000,0,0,0,0,86000,-86000,-86000
053523,T50反1中信9A購01,0,0,0,0,0,0,0,0,0,-86000,0,0,0,150000,236000,-86000,-86000
3712,永崴投控        ,21000,107000,-86000,0,0,0,0,0,0,0,0,0,0,0,0,0,-86000
06459P,亞德客元富98售01,0,0,0,0,0,0,0,0,0,-86000,0,0,0,36000,122000,-86000,-86000
054622,漢唐第一97購01  ,0,0,0,0,0,0,0,0,0,-87000,0,0,0,0,87000,-87000,-87000
055971,矽力元大97購05  ,0,0,0,0,0,0,0,0,0,-87000,0,0,0,0,87000,-87000,-87000
044884,嘉澤群益93購01  ,0,0,0,0,0,0,0,0,0,-87000,0,0,0,39000,126000,-87000,-87000
04296P,技嘉元大93售01  ,0,0,0,0,0,0,0,0,0,-87000,0,0,0,2000,89000,-87000,-87000
050157,臻鼎群益94購02  ,0,0,0,0,0,0,0,0,0,-87000,0,0,0,11000,98000,-87000,-87000
051558,元金2X國泰97購01,0,0,0,0,0,0,0,0,0,-87000,0,0,0,11000,98000,-87000,-87000
054295,世芯元大96購03  ,0,0,0,0,0,0,0,0,0,-87000,0,0,0,7000,94000,-87000,-87000
3419,譁裕            ,12000,99000,-87000,0,0,0,0,0,0,0,0,0,0,0,0,0,-87000
3048,益登            ,72000,159000,-87000,0,0,0,0,0,0,0,0,0,0,0,0,0,-87000
055715,智邦元大97購04  ,0,0,0,0,0,0,0,0,0,-88000,0,0,0,46000,134000,-88000,-88000
055222,臺股指凱基97購05,0,0,0,0,0,0,0,0,0,-88000,0,0,0,20000,108000,-88000,-88000
045101,玉晶光中信94購01,0,0,0,0,0,0,0,0,0,-88000,0,0,0,181000,269000,-88000,-88000
051777,聯發科群益95購04,0,0,0,0,0,0,0,0,0,-88000,0,0,0,35000,123000,-88000,-88000
3062,建漢            ,88000,176000,-88000,0,0,0,0,0,0,0,0,0,0,0,0,0,-88000
06503P,臺股指中信9A售02,0,0,0,0,0,0,0,0,0,-88000,0,0,0,0,88000,-88000,-88000
8463,潤泰材          ,18000,106000,-88000,0,0,0,0,0,0,0,0,0,0,0,0,0,-88000
05543P,鴻海元富96售04  ,0,0,0,0,0,0,0,0,0,-89000,0,0,0,21000,110000,-89000,-89000
050415,力成永豐94購01  ,0,0,0,0,0,0,0,0,0,-89000,0,0,0,45000,134000,-89000,-89000
2731,雄獅            ,5000,94000,-89000,0,0,0,0,0,0,0,0,0,0,0,0,0,-89000
3321,同泰            ,24000,113000,-89000,0,0,0,0,0,0,0,0,0,0,0,0,0,-89000
055768,臺股指群益97購06,0,0,0,0,0,0,0,0,0,-90000,0,0,0,0,90000,-90000,-90000
054607,台積電永豐97購03,0,0,0,0,0,0,0,0,0,-90000,0,0,0,10000,100000,-90000,-90000
054669,凌華元富97購01  ,0,0,0,0,0,0,0,0,0,-90000,0,0,0,29000,119000,-90000,-90000
056469,國巨元大99購01  ,0,0,0,0,0,0,0,0,0,-90000,0,0,0,13000,103000,-90000,-90000
047433,鴻海元大93購16  ,0,0,0,0,0,0,0,0,0,-90000,0,0,0,0,90000,-90000,-90000
047419,聯發科富邦95購01,0,0,0,0,0,0,0,0,0,-90000,0,0,0,10000,100000,-90000,-90000
044340,TPK統一93購01   ,0,0,0,0,0,0,0,0,0,-90000,0,0,0,0,90000,-90000,-90000
047442,聯詠元大93購09  ,0,0,0,0,0,0,0,0,0,-90000,0,0,0,9000,99000,-90000,-90000
03777P,華通中信95售01  ,0,0,0,0,0,0,0,0,0,-90000,0,0,0,0,90000,-90000,-90000
04045P,鴻海元大93售19  ,0,0,0,0,0,0,0,0,0,-90000,0,0,0,0,90000,-90000,-90000
051584,可成元大95購08  ,0,0,0,0,0,0,0,0,0,-90000,0,0,0,80000,170000,-90000,-90000
051573,鴻海元大95購15  ,0,0,0,0,0,0,0,0,0,-90000,0,0,0,35000,125000,-90000,-90000
051677,達方元大95購01  ,0,0,0,0,0,0,0,0,0,-90000,0,0,0,0,90000,-90000,-90000
051322,國泰金國票96購01,0,0,0,0,0,0,0,0,0,-90000,0,0,0,10000,100000,-90000,-90000
050659,宏達電元大96購01,0,0,0,0,0,0,0,0,0,-90000,0,0,0,0,90000,-90000,-90000
049370,可成元大94購03  ,0,0,0,0,0,0,0,0,0,-90000,0,0,0,10000,100000,-90000,-90000
050985,易華電國泰96購02,0,0,0,0,0,0,0,0,0,-90000,0,0,0,504000,594000,-90000,-90000
048193,旺宏元大94購05  ,0,0,0,0,0,0,0,0,0,-90000,0,0,0,1000,91000,-90000,-90000
051965,傳奇永豐95購01  ,0,0,0,0,0,0,0,0,0,-90000,0,0,0,0,90000,-90000,-90000
051999,勤誠元大95購01  ,0,0,0,0,0,0,0,0,0,-90000,0,0,0,30000,120000,-90000,-90000
052968,燿華群益98購01  ,0,0,0,0,0,0,0,0,0,-90000,0,0,0,11000,101000,-90000,-90000
053092,台表科元大97購02,0,0,0,0,0,0,0,0,0,-90000,0,0,0,10000,100000,-90000,-90000
052757,華邦電群益96購01,0,0,0,0,0,0,0,0,0,-90000,0,0,0,10000,100000,-90000,-90000
05346P,臺股指統一95售06,0,0,0,0,0,0,0,0,0,-90000,0,0,0,35000,125000,-90000,-90000
3617,碩天            ,33000,123000,-90000,0,0,0,0,0,0,0,0,0,0,0,0,0,-90000
3003,健和興          ,69000,158000,-89000,0,0,0,0,0,0,-1000,0,0,0,0,1000,-1000,-90000
06466P,台積電統一9B售01,0,0,0,0,0,0,0,0,0,-90000,0,0,0,0,90000,-90000,-90000
6139,亞翔            ,54000,212000,-158000,0,0,0,0,0,0,68000,74000,5000,69000,7000,8000,-1000,-90000
6414,樺漢            ,56000,78000,-22000,0,0,0,0,0,0,-68000,14000,4000,10000,3000,81000,-78000,-90000
055457,聚陽永豐97購01  ,0,0,0,0,0,0,0,0,0,-91000,0,0,0,4000,95000,-91000,-91000
03881P,易華電永豐93售02,0,0,0,0,0,0,0,0,0,-91000,0,0,0,0,91000,-91000,-91000
04963P,鴻海元大94售25  ,0,0,0,0,0,0,0,0,0,-91000,0,0,0,501000,592000,-91000,-91000
053386,聯詠元大96購03  ,0,0,0,0,0,0,0,0,0,-91000,0,0,0,159000,250000,-91000,-91000
052919,鈺齊富邦98購01  ,0,0,0,0,0,0,0,0,0,-91000,0,0,0,1000,92000,-91000,-91000
052900,大成鋼國票97購01,0,0,0,0,0,0,0,0,0,-91000,0,0,0,20000,111000,-91000,-91000
06008P,燿華統一96售04  ,0,0,0,0,0,0,0,0,0,-91000,0,0,0,0,91000,-91000,-91000
2913,農林            ,45000,135000,-90000,0,0,0,0,0,0,-1000,0,1000,-1000,0,0,0,-91000
3030,德律            ,100000,191000,-91000,0,0,0,0,0,0,0,0,0,0,0,0,0,-91000
2537,聯上發          ,71000,162000,-91000,0,0,0,0,0,0,0,0,0,0,0,0,0,-91000
054805,台苯元大9A購01  ,0,0,0,0,0,0,0,0,0,-92000,0,0,0,86000,178000,-92000,-92000
056830,友達富邦99購01  ,0,0,0,0,0,0,0,0,0,-92000,0,0,0,0,92000,-92000,-92000
051095,貿聯元大95購03  ,0,0,0,0,0,0,0,0,0,-92000,0,0,0,0,92000,-92000,-92000
048947,凌華永豐94購01  ,0,0,0,0,0,0,0,0,0,-92000,0,0,0,3000,95000,-92000,-92000
050594,康友永豐94購01  ,0,0,0,0,0,0,0,0,0,-92000,0,0,0,21000,113000,-92000,-92000
053029,國巨第一96購01  ,0,0,0,0,0,0,0,0,0,-92000,0,0,0,396000,488000,-92000,-92000
055733,奇力新元富97購01,0,0,0,0,0,0,0,0,0,-93000,0,0,0,158000,251000,-93000,-93000
051868,貿聯凱基96購01  ,0,0,0,0,0,0,0,0,0,-93000,0,0,0,0,93000,-93000,-93000
055530,聯發科群益98購01,0,0,0,0,0,0,0,0,0,-94000,0,0,0,44000,138000,-94000,-94000
051697,康友中信95購02  ,0,0,0,0,0,0,0,0,0,-94000,0,0,0,86000,180000,-94000,-94000
051624,智邦麥證95購02  ,0,0,0,40000,134000,-94000,0,0,0,-94000,0,0,0,40000,134000,-94000,-94000
050053,訊芯群益94購03  ,0,0,0,0,0,0,0,0,0,-94000,0,0,0,6000,100000,-94000,-94000
051157,華新科富邦98購01,0,0,0,0,0,0,0,0,0,-94000,0,0,0,86000,180000,-94000,-94000
052508,矽力日盛95購02  ,0,0,0,0,0,0,0,0,0,-94000,0,0,0,0,94000,-94000,-94000
055681,奇鋐凱基98購03  ,0,0,0,0,0,0,0,0,0,-95000,0,0,0,0,95000,-95000,-95000
05650P,台積電富邦96售01,0,0,0,0,0,0,0,0,0,-95000,0,0,0,0,95000,-95000,-95000
056017,台積電群益97購04,0,0,0,0,0,0,0,0,0,-95000,0,0,0,237000,332000,-95000,-95000
04764P,台光電台新94售01,0,0,0,0,0,0,0,0,0,-95000,0,0,0,0,95000,-95000,-95000
050834,啟碁凱基95購01  ,0,0,0,0,0,0,0,0,0,-95000,0,0,0,5000,100000,-95000,-95000
048787,義隆元大94購02  ,0,0,0,0,0,0,0,0,0,-95000,0,0,0,32000,127000,-95000,-95000
05320P,華通凱基96售03  ,0,0,0,0,0,0,0,0,0,-95000,0,0,0,0,95000,-95000,-95000
054204,元金2X國票9B購02,0,0,0,0,0,0,0,0,0,-95000,0,0,0,0,95000,-95000,-95000
053911,臺股指凱基96購31,0,0,0,0,0,0,0,0,0,-95000,0,0,0,1000,96000,-95000,-95000
2457,飛宏            ,30000,125000,-95000,0,0,0,0,0,0,0,0,0,0,0,0,0,-95000
2484,希華            ,26000,121000,-95000,0,0,0,0,0,0,0,0,0,0,0,0,0,-95000
6591,動力-KY         ,85000,180000,-95000,0,0,0,0,0,0,0,0,0,0,0,0,0,-95000
055525,國巨群益98購05  ,0,0,0,0,0,0,0,0,0,-96000,0,0,0,127000,223000,-96000,-96000
055193,世芯元富97購02  ,0,0,0,0,0,0,0,0,0,-96000,0,0,0,866000,962000,-96000,-96000
046677,矽創元大93購03  ,0,0,0,0,0,0,0,0,0,-96000,0,0,0,0,96000,-96000,-96000
046785,禾伸堂永豐93購01,0,0,0,0,0,0,0,0,0,-96000,0,0,0,20000,116000,-96000,-96000
04742P,瑞昱統一94售01  ,0,0,0,0,0,0,0,0,0,-96000,0,0,0,25000,121000,-96000,-96000
050443,復盛凱基94購02  ,0,0,0,0,0,0,0,0,0,-96000,0,0,0,4000,100000,-96000,-96000
050825,嘉澤凱基95購01  ,0,0,0,0,0,0,0,0,0,-96000,0,0,0,108000,204000,-96000,-96000
050530,台表科元大95購04,0,0,0,0,0,0,0,0,0,-96000,0,0,0,4000,100000,-96000,-96000
049377,聯詠元大94購01  ,0,0,0,0,0,0,0,0,0,-96000,0,0,0,19000,115000,-96000,-96000
049363,旺宏元大94購07  ,0,0,0,0,0,0,0,0,0,-96000,0,0,0,115000,211000,-96000,-96000
049877,南亞科永豐94購01,0,0,0,0,0,0,0,0,0,-96000,0,0,0,0,96000,-96000,-96000
055458,燿華永豐98購01  ,0,0,0,0,0,0,0,0,0,-97000,0,0,0,0,97000,-97000,-97000
055923,矽力凱基98購01  ,0,0,0,0,0,0,0,0,0,-97000,0,0,0,2000,99000,-97000,-97000
046980,智邦兆豐94購01  ,0,0,0,0,0,0,0,0,0,-97000,0,0,0,20000,117000,-97000,-97000
053482,矽力元大96購03  ,0,0,0,0,0,0,0,0,0,-97000,0,0,0,56000,153000,-97000,-97000
4560,強信-KY         ,55000,152000,-97000,0,0,0,0,0,0,0,0,0,0,0,0,0,-97000
4961,天鈺            ,76000,166000,-90000,0,0,0,0,0,0,-7000,0,0,0,0,7000,-7000,-97000
06427P,鴻海元大97售13  ,0,0,0,0,0,0,0,0,0,-97000,0,0,0,3000,100000,-97000,-97000
06431P,新日興元大97售05,0,0,0,0,0,0,0,0,0,-97000,0,0,0,0,97000,-97000,-97000
055416,欣興富邦98購01  ,0,0,0,0,0,0,0,0,0,-98000,0,0,0,0,98000,-98000,-98000
00728,第一金工業30    ,0,0,0,0,0,0,0,0,0,-98000,0,0,0,608000,706000,-98000,-98000
04297P,微星元大93售03  ,0,0,0,0,0,0,0,0,0,-98000,0,0,0,0,98000,-98000,-98000
047573,儒鴻群益93購04  ,0,0,0,0,0,0,0,0,0,-98000,0,0,0,0,98000,-98000,-98000
050084,宏達電元富94購03,0,0,0,0,0,0,0,0,0,-98000,0,0,0,0,98000,-98000,-98000
05029P,鴻海元富95售04  ,0,0,0,0,0,0,0,0,0,-98000,0,0,0,17000,115000,-98000,-98000
04798P,牧德元大95售02  ,0,0,0,0,0,0,0,0,0,-98000,0,0,0,2000,100000,-98000,-98000
049601,矽創元大95購02  ,0,0,0,0,0,0,0,0,0,-98000,0,0,0,386000,484000,-98000,-98000
04863P,技嘉元大94售02  ,0,0,0,0,0,0,0,0,0,-98000,0,0,0,2000,100000,-98000,-98000
050951,緯創群益96購01  ,0,0,0,0,0,0,0,0,0,-98000,0,0,0,0,98000,-98000,-98000
054346,世芯國票97購01  ,0,0,0,0,0,0,0,0,0,-98000,0,0,0,78000,176000,-98000,-98000
051790,貿聯國票95購03  ,0,0,0,0,0,0,0,0,0,-98000,0,0,0,0,98000,-98000,-98000
052077,可成元富98購02  ,0,0,0,0,0,0,0,0,0,-98000,0,0,0,2000,100000,-98000,-98000
1440,南紡            ,101000,204000,-103000,0,0,0,0,0,0,5000,7000,2000,5000,0,0,0,-98000
054584,貿聯元富97購01  ,0,0,0,0,0,0,0,0,0,-99000,0,0,0,21000,120000,-99000,-99000
055066,佐登永豐97購01  ,0,0,0,0,0,0,0,0,0,-99000,0,0,0,0,99000,-99000,-99000
05596P,可成統一96售01  ,0,0,0,0,0,0,0,0,0,-99000,0,0,0,10000,109000,-99000,-99000
056095,臻鼎元富9A購01  ,0,0,0,0,0,0,0,0,0,-99000,0,0,0,0,99000,-99000,-99000
05971P,世紀鋼永豐96售04,0,0,0,0,0,0,0,0,0,-99000,0,0,0,0,99000,-99000,-99000
042918,矽格元大94購01  ,0,0,0,0,0,0,0,0,0,-99000,0,0,0,0,99000,-99000,-99000
04218P,正文國票93售03  ,0,0,0,0,0,0,0,0,0,-99000,0,0,0,0,99000,-99000,-99000
00676R,富邦臺灣加權反1 ,0,0,0,0,0,0,0,0,0,-99000,0,0,0,527000,626000,-99000,-99000
03534P,臺股指凱基02售13,0,0,0,0,0,0,0,0,0,-99000,0,0,0,0,99000,-99000,-99000
03635C,滬深2X元富99牛01,0,0,0,0,0,0,0,0,0,-99000,0,0,0,117000,216000,-99000,-99000
049576,元油2X元大94購06,0,0,0,0,0,0,0,0,0,-99000,0,0,0,115000,214000,-99000,-99000
051358,台新金元大95購01,0,0,0,0,0,0,0,0,0,-99000,0,0,0,1000,100000,-99000,-99000
049372,華新科元大95購04,0,0,0,0,0,0,0,0,0,-99000,0,0,0,98000,197000,-99000,-99000
053880,智邦中信96購01  ,0,0,0,0,0,0,0,0,0,-99000,0,0,0,70000,169000,-99000,-99000
053528,南電中信9A購01  ,0,0,0,0,0,0,0,0,0,-99000,0,0,0,1000,100000,-99000,-99000
05736P,臺股指統一96售06,0,0,0,0,0,0,0,0,0,-100000,0,0,0,0,100000,-100000,-100000
05780P,台積電統一96售07,0,0,0,0,0,0,0,0,0,-100000,0,0,0,0,100000,-100000,-100000
056767,大毅元大99購01  ,0,0,0,0,0,0,0,0,0,-100000,0,0,0,0,100000,-100000,-100000
056723,國巨中信9A購01  ,0,0,0,0,0,0,0,0,0,-100000,0,0,0,0,100000,-100000,-100000
056087,世芯統一97購01  ,0,0,0,0,0,0,0,0,0,-100000,0,0,0,40000,140000,-100000,-100000
05598P,國巨元富96售03  ,0,0,0,0,0,0,0,0,0,-100000,0,0,0,0,100000,-100000,-100000
05590P,臺股指中信96售05,0,0,0,0,0,0,0,0,0,-100000,0,0,0,0,100000,-100000,-100000
056355,台積電元大98購08,0,0,0,0,0,0,0,0,0,-100000,0,0,0,20000,120000,-100000,-100000
056341,宏達電凱基9A購01,0,0,0,0,0,0,0,0,0,-100000,0,0,0,0,100000,-100000,-100000
056314,力成元大97購01  ,0,0,0,0,0,0,0,0,0,-100000,0,0,0,0,100000,-100000,-100000
055145,T50反1元大97購04,0,0,0,0,0,0,0,0,0,-100000,0,0,0,0,100000,-100000,-100000
055158,亞光元大99購01  ,0,0,0,0,0,0,0,0,0,-100000,0,0,0,0,100000,-100000,-100000
054813,鴻海元大97購09  ,0,0,0,0,0,0,0,0,0,-100000,0,0,0,201000,301000,-100000,-100000
05534P,元油反元大96售06,0,0,0,0,0,0,0,0,0,-100000,0,0,0,0,100000,-100000,-100000
055672,國巨日盛97購02  ,0,0,0,0,0,0,0,0,0,-100000,0,0,0,31000,131000,-100000,-100000
055712,金寶元大97購02  ,0,0,0,0,0,0,0,0,0,-100000,0,0,0,0,100000,-100000,-100000
03640P,百和凱基93售05  ,0,0,0,0,0,0,0,0,0,-100000,0,0,0,0,100000,-100000,-100000
03778P,聯發科麥證93售01,0,0,0,0,100000,-100000,0,0,0,-100000,0,0,0,0,100000,-100000,-100000
03824P,燿華元大94售01  ,0,0,0,0,0,0,0,0,0,-100000,0,0,0,0,100000,-100000,-100000
04469P,元油2X元大94售05,0,0,0,0,0,0,0,0,0,-100000,0,0,0,0,100000,-100000,-100000
03039P,玉晶光國票02售04,0,0,0,0,0,0,0,0,0,-100000,0,0,0,0,100000,-100000,-100000
03102P,臺股指凱基03售08,0,0,0,0,0,0,0,0,0,-100000,0,0,0,0,100000,-100000,-100000
045216,鴻海元大93購02  ,0,0,0,0,0,0,0,0,0,-100000,0,0,0,0,100000,-100000,-100000
043884,臻鼎元大92購01  ,0,0,0,0,0,0,0,0,0,-100000,0,0,0,0,100000,-100000,-100000
045258,漢唐凱基93購01  ,0,0,0,0,0,0,0,0,0,-100000,0,0,0,7000,107000,-100000,-100000
04225P,台積電元富94售02,0,0,0,0,0,0,0,0,0,-100000,0,0,0,0,100000,-100000,-100000
04226P,宏達電元富93售01,0,0,0,0,0,0,0,0,0,-100000,0,0,0,0,100000,-100000,-100000
04227P,滬深2X永豐94售04,0,0,0,0,0,0,0,0,0,-100000,0,0,0,20000,120000,-100000,-100000
044055,智邦元大92購03  ,0,0,0,0,0,0,0,0,0,-100000,0,0,0,0,100000,-100000,-100000
044003,聯發科兆豐93購01,0,0,0,0,0,0,0,0,0,-100000,0,0,0,0,100000,-100000,-100000
046426,臻鼎元大92購13  ,0,0,0,0,0,0,0,0,0,-100000,0,0,0,0,100000,-100000,-100000
04447P,上銀凱基94售02  ,0,0,0,0,0,0,0,0,0,-100000,0,0,0,0,100000,-100000,-100000
046577,東元元大92購02  ,0,0,0,0,0,0,0,0,0,-100000,0,0,0,100000,200000,-100000,-100000
047526,可成元大93購08  ,0,0,0,0,0,0,0,0,0,-100000,0,0,0,0,100000,-100000,-100000
046541,超眾群益93購01  ,0,0,0,0,0,0,0,0,0,-100000,0,0,0,0,100000,-100000,-100000
047031,麗豐元大93購01  ,0,0,0,0,0,0,0,0,0,-100000,0,0,0,0,100000,-100000,-100000
050455,貿聯元大94購02  ,0,0,0,0,0,0,0,0,0,-100000,0,0,0,0,100000,-100000,-100000
050422,鴻海凱基96購01  ,0,0,0,0,0,0,0,0,0,-100000,0,0,0,0,100000,-100000,-100000
047153,聯發科國票93購02,0,0,0,0,0,0,0,0,0,-100000,0,0,0,0,100000,-100000,-100000
046798,元油2X元大96購01,0,0,0,0,0,0,0,0,0,-100000,0,0,0,0,100000,-100000,-100000
047778,美利達元大93購01,0,0,0,0,0,0,0,0,0,-100000,0,0,0,0,100000,-100000,-100000
045535,A50正2群益94購01,0,0,0,0,0,0,0,0,0,-100000,0,0,0,0,100000,-100000,-100000
046716,欣興國泰93購03  ,0,0,0,0,0,0,0,0,0,-100000,0,0,0,0,100000,-100000,-100000
045643,臻鼎凱基93購01  ,0,0,0,0,0,0,0,0,0,-100000,0,0,0,0,100000,-100000,-100000
04770P,鴻海元大94售09  ,0,0,0,0,0,0,0,0,0,-100000,0,0,0,40000,140000,-100000,-100000
045795,瀚宇博兆豐94購01,0,0,0,0,0,0,0,0,0,-100000,0,0,0,0,100000,-100000,-100000
04633P,旺宏群益96售04  ,0,0,0,0,0,0,0,0,0,-100000,0,0,0,0,100000,-100000,-100000
049390,元油2X中信96購01,0,0,0,0,0,0,0,0,0,-100000,0,0,0,0,100000,-100000,-100000
049946,智邦兆豐95購01  ,0,0,0,0,0,0,0,0,0,-100000,0,0,0,100000,200000,-100000,-100000
051696,新日興中信96購01,0,0,0,0,0,0,0,0,0,-100000,0,0,0,279000,379000,-100000,-100000
050966,日月光永豐95購01,0,0,0,0,0,0,0,0,0,-100000,0,0,0,0,100000,-100000,-100000
051155,聯發科國泰96購01,0,0,0,0,0,0,0,0,0,-100000,0,0,0,269000,369000,-100000,-100000
049219,聯發科國票95購01,0,0,0,0,0,0,0,0,0,-100000,0,0,0,0,100000,-100000,-100000
04842P,群創元大96售02  ,0,0,0,0,0,0,0,0,0,-100000,0,0,0,0,100000,-100000,-100000
048100,貿聯凱基93購02  ,0,0,0,0,0,0,0,0,0,-100000,0,0,0,0,100000,-100000,-100000
048423,聯發科元富93購02,0,0,0,0,0,0,0,0,0,-100000,0,0,0,0,100000,-100000,-100000
048306,A50反1凱基93購01,0,0,0,0,0,0,0,0,0,-100000,0,0,0,0,100000,-100000,-100000
053644,台表科國票97購03,0,0,0,0,0,0,0,0,0,-100000,0,0,0,0,100000,-100000,-100000
05360P,健策元大95售03  ,0,0,0,0,0,0,0,0,0,-100000,0,0,0,0,100000,-100000,-100000
053832,聯發科台新96購01,0,0,0,0,0,0,0,0,0,-100000,0,0,0,0,100000,-100000,-100000
054114,新光金台新97購01,0,0,0,0,0,0,0,0,0,-100000,0,0,0,0,100000,-100000,-100000
052411,嘉聯益亞東95購02,0,0,0,0,0,0,0,0,0,-100000,0,0,0,0,100000,-100000,-100000
05308P,台積電中信95售08,0,0,0,0,0,0,0,0,0,-100000,0,0,0,0,100000,-100000,-100000
052793,健鼎兆豐96購01  ,0,0,0,0,0,0,0,0,0,-100000,0,0,0,0,100000,-100000,-100000
1446,宏和            ,11000,111000,-100000,0,0,0,0,0,0,0,0,0,0,0,0,0,-100000
06474P,鴻海富邦98售03  ,0,0,0,0,0,0,0,0,0,-100000,0,0,0,500000,600000,-100000,-100000
06513P,鴻海凱基98售10  ,0,0,0,0,0,0,0,0,0,-100000,0,0,0,0,100000,-100000,-100000
06088P,建準永豐97售01  ,0,0,0,0,0,0,0,0,0,-100000,0,0,0,4000,104000,-100000,-100000
06210P,元油反元大97售01,0,0,0,0,0,0,0,0,0,-100000,0,0,0,0,100000,-100000,-100000
06182P,群創兆豐97售03  ,0,0,0,0,0,0,0,0,0,-100000,0,0,0,0,100000,-100000,-100000
9955,佳龍            ,22000,121000,-99000,0,0,0,0,0,0,-1000,0,1000,-1000,0,0,0,-100000
055190,華新科元富97購01,0,0,0,0,0,0,0,0,0,-101000,0,0,0,33000,134000,-101000,-101000
054855,得力群益98購01  ,0,0,0,0,0,0,0,0,0,-101000,0,0,0,111000,212000,-101000,-101000
056683,台積電統一98購05,0,0,0,0,0,0,0,0,0,-101000,0,0,0,0,101000,-101000,-101000
056635,亞德客日盛99購01,0,0,0,0,0,0,0,0,0,-101000,0,0,0,8000,109000,-101000,-101000
047110,智邦元大93購05  ,0,0,0,0,0,0,0,0,0,-101000,0,0,0,0,101000,-101000,-101000
04402P,TPK兆豐95售01   ,0,0,0,0,0,0,0,0,0,-101000,0,0,0,0,101000,-101000,-101000
042433,元油2X永豐96購01,0,0,0,0,0,0,0,0,0,-101000,0,0,0,0,101000,-101000,-101000
050617,神基元大94購01  ,0,0,0,0,0,0,0,0,0,-101000,0,0,0,0,101000,-101000,-101000
05265P,正崴元大95售03  ,0,0,0,0,0,0,0,0,0,-101000,0,0,0,0,101000,-101000,-101000
052587,景碩永豐97購01  ,0,0,0,0,0,0,0,0,0,-101000,0,0,0,0,101000,-101000,-101000
052429,禾伸堂永豐95購02,0,0,0,0,0,0,0,0,0,-101000,0,0,0,134000,235000,-101000,-101000
051796,和碩康和95購01  ,0,0,0,0,0,0,0,0,0,-101000,0,0,0,29000,130000,-101000,-101000
06226P,聯發科麥證97售03,0,0,0,49000,150000,-101000,0,0,0,-101000,0,0,0,49000,150000,-101000,-101000
5269,祥碩            ,244000,271000,-27000,0,0,0,0,70000,-70000,-4000,15000,11000,4000,12000,20000,-8000,-101000
056639,國產康和98購01  ,0,0,0,0,0,0,0,0,0,-102000,0,0,0,0,102000,-102000,-102000
055587,智邦元大97購02  ,0,0,0,0,0,0,0,0,0,-102000,0,0,0,9000,111000,-102000,-102000
049009,南亞科麥證94購01,0,0,0,0,102000,-102000,0,0,0,-102000,0,0,0,0,102000,-102000,-102000
05143P,臻鼎台新95售01  ,0,0,0,0,0,0,0,0,0,-102000,0,0,0,0,102000,-102000,-102000
04935P,鴻海中信96售01  ,0,0,0,0,0,0,0,0,0,-102000,0,0,0,24000,126000,-102000,-102000
052807,貿聯元大98購01  ,0,0,0,0,0,0,0,0,0,-102000,0,0,0,354000,456000,-102000,-102000
05298P,上銀元大95售03  ,0,0,0,0,0,0,0,0,0,-102000,0,0,0,0,102000,-102000,-102000
053192,創意統一96購01  ,0,0,0,0,0,0,0,0,0,-102000,0,0,0,268000,370000,-102000,-102000
3038,全台            ,32000,134000,-102000,0,0,0,0,0,0,0,0,0,0,0,0,0,-102000
3052,夆典            ,28000,130000,-102000,0,0,0,0,0,0,0,0,0,0,0,0,0,-102000
1234,黑松            ,0,103000,-103000,0,0,0,0,0,0,1000,1000,0,1000,0,0,0,-102000
6525,捷敏-KY         ,17000,119000,-102000,0,0,0,0,0,0,0,0,0,0,0,0,0,-102000
055185,晶相光統一97購01,0,0,0,0,0,0,0,0,0,-103000,0,0,0,80000,183000,-103000,-103000
048940,晶相光永豐94購01,0,0,0,0,0,0,0,0,0,-103000,0,0,0,5000,108000,-103000,-103000
048856,高鐵群益94購01  ,0,0,0,0,0,0,0,0,0,-103000,0,0,0,4000,107000,-103000,-103000
054462,旺宏凱基96購08  ,0,0,0,0,0,0,0,0,0,-103000,0,0,0,128000,231000,-103000,-103000
054794,貿聯群益98購01  ,0,0,0,0,0,0,0,0,0,-104000,0,0,0,1000,105000,-104000,-104000
05904P,大立光統一96售07,0,0,0,0,0,0,0,0,0,-104000,0,0,0,0,104000,-104000,-104000
5531,鄉林            ,24000,127000,-103000,0,0,0,0,0,0,-1000,0,1000,-1000,0,0,0,-104000
1434,福懋            ,1017000,1122000,-105000,0,0,0,2000,0,2000,-1000,0,1000,-1000,0,0,0,-104000
06004P,奇力新永豐96售02,0,0,0,0,0,0,0,0,0,-104000,0,0,0,1000,105000,-104000,-104000
3682,亞太電          ,31000,135000,-104000,0,0,0,0,0,0,0,0,0,0,0,0,0,-104000
2610,華航            ,5050000,4683000,367000,0,0,0,5000,0,5000,-476000,0,24000,-24000,0,452000,-452000,-104000
6552,易華電          ,252000,190050,61950,0,0,0,0,0,0,-166000,0,5000,-5000,13000,174000,-161000,-104050
054865,可成群益97購01  ,0,0,0,0,0,0,0,0,0,-105000,0,0,0,33000,138000,-105000,-105000
055573,國巨統一97購06  ,0,0,0,0,0,0,0,0,0,-105000,0,0,0,42000,147000,-105000,-105000
04358P,TPK永豐94售01   ,0,0,0,0,0,0,0,0,0,-105000,0,0,0,50000,155000,-105000,-105000
03219P,台積電康和02售01,0,0,0,0,0,0,0,0,0,-105000,0,0,0,0,105000,-105000,-105000
047880,聯發科國泰94購03,0,0,0,0,0,0,0,0,0,-105000,0,0,0,35000,140000,-105000,-105000
047234,晶技凱基93購01  ,0,0,0,0,0,0,0,0,0,-105000,0,0,0,0,105000,-105000,-105000
049392,臺股指麥證94購01,0,0,0,0,105000,-105000,0,0,0,-105000,0,0,0,0,105000,-105000,-105000
049825,台積電凱基94購26,0,0,0,0,0,0,0,0,0,-105000,0,0,0,96000,201000,-105000,-105000
049444,元石油統一94購03,0,0,0,0,0,0,0,0,0,-105000,0,0,0,0,105000,-105000,-105000
051723,嘉澤永豐95購01  ,0,0,0,0,0,0,0,0,0,-105000,0,0,0,194000,299000,-105000,-105000
051193,新日興兆豐96購01,0,0,0,0,0,0,0,0,0,-105000,0,0,0,60000,165000,-105000,-105000
053993,旺宏群益98購02  ,0,0,0,0,0,0,0,0,0,-105000,0,0,0,92000,197000,-105000,-105000
05293P,廣達凱基95售01  ,0,0,0,0,0,0,0,0,0,-105000,0,0,0,25000,130000,-105000,-105000
3622,洋華            ,10000,115000,-105000,0,0,0,0,0,0,0,0,0,0,0,0,0,-105000
00717,富邦美國特別股  ,0,0,0,0,0,0,0,0,0,-105831,0,0,0,511000,616831,-105831,-105831
054789,高鐵群益98購01  ,0,0,0,0,0,0,0,0,0,-106000,0,0,0,22000,128000,-106000,-106000
054808,東元元大9A購01  ,0,0,0,0,0,0,0,0,0,-106000,0,0,0,126000,232000,-106000,-106000
05985P,燿華統一96售03  ,0,0,0,0,0,0,0,0,0,-106000,0,0,0,30000,136000,-106000,-106000
03841P,聯發科統一93售02,0,0,0,0,0,0,0,0,0,-106000,0,0,0,0,106000,-106000,-106000
049872,聯發科台新94購03,0,0,0,0,0,0,0,0,0,-106000,0,0,0,0,106000,-106000,-106000
054332,世芯永豐97購01  ,0,0,0,0,0,0,0,0,0,-106000,0,0,0,17000,123000,-106000,-106000
1808,潤隆            ,45000,152000,-107000,0,0,0,0,0,0,1000,1000,0,1000,0,0,0,-106000
6531,愛普            ,139000,259000,-120000,0,0,0,0,0,0,14000,15000,1000,14000,0,0,0,-106000
05502P,台表科國票97售01,0,0,0,0,0,0,0,0,0,-107000,0,0,0,17000,124000,-107000,-107000
055714,智邦元大97購03  ,0,0,0,0,0,0,0,0,0,-107000,0,0,0,75000,182000,-107000,-107000
055374,明泰元大97購01  ,0,0,0,0,0,0,0,0,0,-107000,0,0,0,3000,110000,-107000,-107000
04575P,新日興統一94售02,0,0,0,0,0,0,0,0,0,-107000,0,0,0,0,107000,-107000,-107000
049891,T50反1富邦94購02,0,0,0,0,0,0,0,0,0,-107000,0,0,0,0,107000,-107000,-107000
051069,智邦國票96購01  ,0,0,0,0,0,0,0,0,0,-107000,0,0,0,2000,109000,-107000,-107000
054398,牧德永豐96購03  ,0,0,0,0,0,0,0,0,0,-107000,0,0,0,57000,164000,-107000,-107000
053837,貿聯永豐96購02  ,0,0,0,0,0,0,0,0,0,-107000,0,0,0,10000,117000,-107000,-107000
052655,群創統一97購01  ,0,0,0,0,0,0,0,0,0,-107000,0,0,0,191000,298000,-107000,-107000
05263P,台積電元大96售09,0,0,0,0,0,0,0,0,0,-107000,0,0,0,103000,210000,-107000,-107000
051847,香港反中信99購01,0,0,0,0,0,0,0,0,0,-107000,0,0,0,0,107000,-107000,-107000
2034,允強            ,22000,128000,-106000,0,0,0,0,0,0,-1000,0,1000,-1000,0,0,0,-107000
056285,可成永豐97購02  ,0,0,0,0,0,0,0,0,0,-108000,0,0,0,0,108000,-108000,-108000
03497P,金像電凱基02售06,0,0,0,0,0,0,0,0,0,-108000,0,0,0,330000,438000,-108000,-108000
050913,全新中信97購01  ,0,0,0,0,0,0,0,0,0,-108000,0,0,0,0,108000,-108000,-108000
052855,群創日盛99購01  ,0,0,0,0,0,0,0,0,0,-108000,0,0,0,38000,146000,-108000,-108000
05419P,矽力永豐95售02  ,0,0,0,0,0,0,0,0,0,-108000,0,0,0,0,108000,-108000,-108000
2314,台揚            ,129000,237000,-108000,0,0,0,0,0,0,0,0,0,0,0,0,0,-108000
06285P,台積電國票98售04,0,0,0,0,0,0,0,0,0,-108000,0,0,0,0,108000,-108000,-108000
04047P,華邦電元大94售03,0,0,0,0,0,0,0,0,0,-109000,0,0,0,10000,119000,-109000,-109000
051131,玉山金台新95購01,0,0,0,0,0,0,0,0,0,-109000,0,0,0,0,109000,-109000,-109000
048284,臺股指中信95購04,0,0,0,0,0,0,0,0,0,-109000,0,0,0,1000,110000,-109000,-109000
050026,友達元大96購01  ,0,0,0,0,0,0,0,0,0,-109000,0,0,0,35000,144000,-109000,-109000
050135,禾伸堂兆豐95購01,0,0,0,0,0,0,0,0,0,-109000,0,0,0,6000,115000,-109000,-109000
051827,智邦元大95購04  ,0,0,0,0,0,0,0,0,0,-109000,0,0,0,120000,229000,-109000,-109000
051773,元大金中信95購02,0,0,0,0,0,0,0,0,0,-109000,0,0,0,0,109000,-109000,-109000
1457,宜進            ,11000,75000,-64000,0,0,0,0,0,0,-45000,0,45000,-45000,0,0,0,-109000
4551,智伸科          ,157000,191000,-34000,0,0,0,106000,111000,-5000,-70000,6000,6000,0,1000,71000,-70000,-109000
2612,中航            ,16000,125000,-109000,0,0,0,0,0,0,0,0,0,0,0,0,0,-109000
9924,福興            ,10000,119000,-109000,0,0,0,0,0,0,0,0,0,0,0,0,0,-109000
056165,矽力凱基98購02  ,0,0,0,0,0,0,0,0,0,-110000,0,0,0,0,110000,-110000,-110000
056431,鴻海凱基98購07  ,0,0,0,0,0,0,0,0,0,-110000,0,0,0,70000,180000,-110000,-110000
05602P,國巨元大96售06  ,0,0,0,0,0,0,0,0,0,-110000,0,0,0,0,110000,-110000,-110000
05855P,滬深2X中信9C售01,0,0,0,0,0,0,0,0,0,-110000,0,0,0,0,110000,-110000,-110000
054987,凱美元富97購01  ,0,0,0,0,0,0,0,0,0,-110000,0,0,0,0,110000,-110000,-110000
05497P,聯詠統一96售01  ,0,0,0,0,0,0,0,0,0,-110000,0,0,0,12000,122000,-110000,-110000
054590,嘉聯益國泰98購01,0,0,0,0,0,0,0,0,0,-110000,0,0,0,20000,130000,-110000,-110000
03875P,滬深2X國票05售01,0,0,0,0,0,0,0,0,0,-110000,0,0,0,0,110000,-110000,-110000
043916,群創凱基93購01  ,0,0,0,0,0,0,0,0,0,-110000,0,0,0,74000,184000,-110000,-110000
042997,新光鋼元大94購01,0,0,0,0,0,0,0,0,0,-110000,0,0,0,70000,180000,-110000,-110000
050137,臺指反國票96購01,0,0,0,0,0,0,0,0,0,-110000,0,0,0,0,110000,-110000,-110000
051232,貿聯群益95購02  ,0,0,0,0,0,0,0,0,0,-110000,0,0,0,3000,113000,-110000,-110000
052048,景碩凱基95購01  ,0,0,0,0,0,0,0,0,0,-110000,0,0,0,0,110000,-110000,-110000
052878,台虹凱基96購01  ,0,0,0,0,0,0,0,0,0,-110000,0,0,0,24000,134000,-110000,-110000
05432P,國巨元富95售07  ,0,0,0,0,0,0,0,0,0,-110000,0,0,0,0,110000,-110000,-110000
05376P,聯發科日盛95售04,0,0,0,0,0,0,0,0,0,-110000,0,0,0,0,110000,-110000,-110000
053581,台積電元大96購14,0,0,0,0,0,0,0,0,0,-110000,0,0,0,266000,376000,-110000,-110000
6108,競國            ,15000,125000,-110000,0,0,0,0,0,0,0,0,0,0,0,0,0,-110000
1460,宏遠            ,2000,112000,-110000,0,0,0,0,0,0,0,0,0,0,0,0,0,-110000
055058,大毅永豐97購01  ,0,0,0,0,0,0,0,0,0,-111000,0,0,0,70000,181000,-111000,-111000
056192,智邦富邦98購01  ,0,0,0,0,0,0,0,0,0,-111000,0,0,0,20000,131000,-111000,-111000
04784P,超眾元富94售01  ,0,0,0,0,0,0,0,0,0,-111000,0,0,0,11000,122000,-111000,-111000
051201,台積電麥證95購02,0,0,0,70000,181000,-111000,0,0,0,-111000,0,0,0,70000,181000,-111000,-111000
05851P,力山群益97售01  ,0,0,0,0,0,0,0,0,0,-112000,0,0,0,0,112000,-112000,-112000
05692P,聯發科中信9A售02,0,0,0,0,0,0,0,0,0,-112000,0,0,0,60000,172000,-112000,-112000
042927,道瓊反中信94購01,0,0,0,0,0,0,0,0,0,-112000,0,0,0,3000,115000,-112000,-112000
045189,大立光元富98購01,0,0,0,0,0,0,0,0,0,-112000,0,0,0,68000,180000,-112000,-112000
04507P,台光電元大94售03,0,0,0,0,0,0,0,0,0,-112000,0,0,0,0,112000,-112000,-112000
05079P,可成永豐95售01  ,0,0,0,0,0,0,0,0,0,-112000,0,0,0,0,112000,-112000,-112000
051284,上銀統一95購02  ,0,0,0,0,0,0,0,0,0,-112000,0,0,0,163000,275000,-112000,-112000
053670,台積電統一96購09,0,0,0,0,0,0,0,0,0,-112000,0,0,0,1000,113000,-112000,-112000
053759,晶相光國泰98購01,0,0,0,0,0,0,0,0,0,-112000,0,0,0,11000,123000,-112000,-112000
06061P,訊芯統一97售01  ,0,0,0,0,0,0,0,0,0,-112000,0,0,0,32000,144000,-112000,-112000
3059,華晶科          ,50000,159000,-109000,0,0,0,0,0,0,-3000,0,0,0,0,3000,-3000,-112000
04876P,台光電中信94售02,0,0,0,0,0,0,0,0,0,-113000,0,0,0,0,113000,-113000,-113000
053009,大成鋼統一96購02,0,0,0,0,0,0,0,0,0,-113000,0,0,0,138000,251000,-113000,-113000
06044P,同欣電永豐96售03,0,0,0,0,0,0,0,0,0,-113000,0,0,0,0,113000,-113000,-113000
1447,力鵬            ,23000,136000,-113000,0,0,0,0,0,0,0,0,0,0,0,0,0,-113000
056113,新日興兆豐98購01,0,0,0,0,0,0,0,0,0,-114000,0,0,0,89000,203000,-114000,-114000
055139,欣興永豐97購01  ,0,0,0,0,0,0,0,0,0,-114000,0,0,0,0,114000,-114000,-114000
03828P,致茂中信95售01  ,0,0,0,0,0,0,0,0,0,-114000,0,0,0,60000,174000,-114000,-114000
049463,華新科富邦97購01,0,0,0,0,0,0,0,0,0,-114000,0,0,0,6000,120000,-114000,-114000
052194,旺宏元富95購04  ,0,0,0,0,0,0,0,0,0,-114000,0,0,0,212000,326000,-114000,-114000
3149,正達            ,6000,120000,-114000,0,0,0,0,0,0,0,0,0,0,0,0,0,-114000
3583,辛耘            ,46000,160000,-114000,0,0,0,0,0,0,0,0,0,0,0,0,0,-114000
6668,中揚光          ,70000,187000,-117000,0,0,0,0,0,0,3000,0,0,0,3000,0,3000,-114000
05922P,京元電兆豐96售01,0,0,0,0,0,0,0,0,0,-115000,0,0,0,0,115000,-115000,-115000
056594,台積電元富98購03,0,0,0,0,0,0,0,0,0,-115000,0,0,0,135000,250000,-115000,-115000
03665P,華邦電永豐92售01,0,0,0,0,0,0,0,0,0,-115000,0,0,0,0,115000,-115000,-115000
049554,禾伸堂富邦96購01,0,0,0,0,0,0,0,0,0,-115000,0,0,0,80000,195000,-115000,-115000
051343,鴻海元大95購07  ,0,0,0,0,0,0,0,0,0,-115000,0,0,0,0,115000,-115000,-115000
051327,元油2X永豐95購02,0,0,0,0,0,0,0,0,0,-115000,0,0,0,185000,300000,-115000,-115000
051514,智邦凱基95購05  ,0,0,0,0,0,0,0,0,0,-115000,0,0,0,0,115000,-115000,-115000
2015,豐興            ,53000,167000,-114000,0,0,0,0,0,0,-1000,0,1000,-1000,0,0,0,-115000
06492P,上銀永豐98售01  ,0,0,0,0,0,0,0,0,0,-115000,0,0,0,0,115000,-115000,-115000
06461P,玉晶光國泰9A售01,0,0,0,0,0,0,0,0,0,-115000,0,0,0,96000,211000,-115000,-115000
06421P,嘉澤統一97售02  ,0,0,0,0,0,0,0,0,0,-115000,0,0,0,0,115000,-115000,-115000
05944P,富邦金中信96售01,0,0,0,0,0,0,0,0,0,-116000,0,0,0,0,116000,-116000,-116000
054783,國巨群益98購04  ,0,0,0,0,0,0,0,0,0,-116000,0,0,0,32000,148000,-116000,-116000
03643C,臺股指元富99牛04,0,0,0,0,0,0,0,0,0,-116000,0,0,0,50000,166000,-116000,-116000
04434P,玉晶光國票96售02,0,0,0,0,0,0,0,0,0,-116000,0,0,0,270000,386000,-116000,-116000
04696P,亞德客國泰95售02,0,0,0,0,0,0,0,0,0,-116000,0,0,0,10000,126000,-116000,-116000
05393P,鴻海統一95售14  ,0,0,0,0,0,0,0,0,0,-116000,0,0,0,101000,217000,-116000,-116000
1444,力麗            ,12000,128000,-116000,0,0,0,0,0,0,0,0,0,0,0,0,0,-116000
04272P,元上證凱基94售01,0,0,0,0,0,0,0,0,0,-117000,0,0,0,10000,127000,-117000,-117000
039550,滬深反凱基94購01,0,0,0,0,0,0,0,0,0,-117000,0,0,0,269000,386000,-117000,-117000
049612,香港反中信96購01,0,0,0,0,0,0,0,0,0,-117000,0,0,0,0,117000,-117000,-117000
05310P,智原永豐95售04  ,0,0,0,0,0,0,0,0,0,-117000,0,0,0,5000,122000,-117000,-117000
053169,貿聯群益97購01  ,0,0,0,0,0,0,0,0,0,-117000,0,0,0,35000,152000,-117000,-117000
1109,信大            ,133000,250000,-117000,0,0,0,0,0,0,0,0,0,0,0,0,0,-117000
06144P,台光電永豐97售01,0,0,0,0,0,0,0,0,0,-117000,0,0,0,3000,120000,-117000,-117000
055067,禾聯碩永豐97購01,0,0,0,0,0,0,0,0,0,-118000,0,0,0,36000,154000,-118000,-118000
055496,高鐵元大97購02  ,0,0,0,0,0,0,0,0,0,-118000,0,0,0,0,118000,-118000,-118000
042196,元油2X元大93購02,0,0,0,0,0,0,0,0,0,-118000,0,0,0,2000,120000,-118000,-118000
042994,葡萄王元大94購02,0,0,0,0,0,0,0,0,0,-118000,0,0,0,55000,173000,-118000,-118000
046771,聯發科國泰94購02,0,0,0,0,0,0,0,0,0,-118000,0,0,0,57000,175000,-118000,-118000
051237,鴻海元大97購01  ,0,0,0,0,0,0,0,0,0,-118000,0,0,0,159000,277000,-118000,-118000
050088,禾伸堂台新94購01,0,0,0,0,0,0,0,0,0,-118000,0,0,0,120000,238000,-118000,-118000
2006,東和鋼鐵        ,74000,214000,-140000,0,0,0,1000,38000,-37000,59000,60000,1000,59000,0,0,0,-118000
6214,精誠            ,77000,195000,-118000,0,0,0,0,0,0,0,0,0,0,0,0,0,-118000
8163,達方            ,156000,300000,-144000,0,0,0,0,0,0,26000,26000,0,26000,0,0,0,-118000
055299,康友元大97購02  ,0,0,0,0,0,0,0,0,0,-119000,0,0,0,116000,235000,-119000,-119000
04690P,國巨群益94售06  ,0,0,0,0,0,0,0,0,0,-119000,0,0,0,11000,130000,-119000,-119000
052610,貿聯元大97購01  ,0,0,0,0,0,0,0,0,0,-119000,0,0,0,170000,289000,-119000,-119000
1455,集盛            ,45000,163000,-118000,0,0,0,0,0,0,-1000,0,1000,-1000,0,0,0,-119000
055342,鴻海凱基97購04  ,0,0,0,0,0,0,0,0,0,-120000,0,0,0,60000,180000,-120000,-120000
055578,群創統一98購03  ,0,0,0,0,0,0,0,0,0,-120000,0,0,0,0,120000,-120000,-120000
05725P,嘉聯益永豐96售02,0,0,0,0,0,0,0,0,0,-120000,0,0,0,0,120000,-120000,-120000
049050,崇越康和94購01  ,0,0,0,0,0,0,0,0,0,-120000,0,0,0,50000,170000,-120000,-120000
04833P,鴻海元大94售16  ,0,0,0,0,0,0,0,0,0,-120000,0,0,0,80000,200000,-120000,-120000
052785,滬深2X中信99購03,0,0,0,0,0,0,0,0,0,-120000,0,0,0,0,120000,-120000,-120000
053980,泰鼎元大97購02  ,0,0,0,0,0,0,0,0,0,-120000,0,0,0,322000,442000,-120000,-120000
054272,華通中信98購01  ,0,0,0,0,0,0,0,0,0,-120000,0,0,0,0,120000,-120000,-120000
1604,聲寶            ,44000,164000,-120000,0,0,0,0,0,0,0,0,0,0,0,0,0,-120000
1532,勤美            ,23000,143000,-120000,0,0,0,0,0,0,0,0,0,0,0,0,0,-120000
2206,三陽工業        ,0,119000,-119000,0,0,0,0,0,0,-1000,0,1000,-1000,0,0,0,-120000
2231,為升            ,67000,164000,-97000,0,0,0,9000,0,9000,-32000,0,14000,-14000,6000,24000,-18000,-120000
4414,如興            ,231000,357000,-126000,0,0,0,0,0,0,6000,6000,0,6000,0,0,0,-120000
055998,臺股指富邦99購01,0,0,0,0,0,0,0,0,0,-121000,0,0,0,0,121000,-121000,-121000
04574P,台達電統一94售05,0,0,0,0,0,0,0,0,0,-121000,0,0,0,0,121000,-121000,-121000
050874,康控永豐95購01  ,0,0,0,0,0,0,0,0,0,-121000,0,0,0,0,121000,-121000,-121000
050569,英業達中信94購01,0,0,0,0,0,0,0,0,0,-121000,0,0,0,129000,250000,-121000,-121000
054336,台積電統一96購11,0,0,0,0,0,0,0,0,0,-121000,0,0,0,125000,246000,-121000,-121000
054337,智邦統一96購01  ,0,0,0,0,0,0,0,0,0,-121000,0,0,0,25000,146000,-121000,-121000
1308,亞聚            ,28000,148000,-120000,0,0,0,0,0,0,-1000,0,1000,-1000,0,0,0,-121000
06409P,康友元富97售03  ,0,0,0,0,0,0,0,0,0,-121000,0,0,0,43000,164000,-121000,-121000
9946,三發地產        ,238000,361000,-123000,0,0,0,0,0,0,2000,2000,0,2000,0,0,0,-121000
046645,技嘉國泰94購01  ,0,0,0,0,0,0,0,0,0,-122000,0,0,0,1029000,1151000,-122000,-122000
04792P,智邦元大94售06  ,0,0,0,0,0,0,0,0,0,-122000,0,0,0,173000,295000,-122000,-122000
049843,康友中信95購01  ,0,0,0,0,0,0,0,0,0,-122000,0,0,0,121000,243000,-122000,-122000
050173,旺宏元大96購02  ,0,0,0,0,0,0,0,0,0,-122000,0,0,0,108000,230000,-122000,-122000
054282,泰鼎群益98購02  ,0,0,0,0,0,0,0,0,0,-122000,0,0,0,383000,505000,-122000,-122000
054395,華新科永豐96購03,0,0,0,0,0,0,0,0,0,-122000,0,0,0,295000,417000,-122000,-122000
053860,台積電元大98購03,0,0,0,0,0,0,0,0,0,-122000,0,0,0,87000,209000,-122000,-122000
05347P,滬深2X元富9B售02,0,0,0,0,0,0,0,0,0,-122000,0,0,0,71000,193000,-122000,-122000
06455P,上銀統一99售03  ,0,0,0,0,0,0,0,0,0,-122000,0,0,0,0,122000,-122000,-122000
2897,王道銀行        ,94000,217000,-123000,0,0,0,1000,0,1000,0,0,0,0,0,0,0,-122000
05840P,臺股指富邦96售07,0,0,0,0,0,0,0,0,0,-123000,0,0,0,2000,125000,-123000,-123000
05569P,漢唐統一97售01  ,0,0,0,0,0,0,0,0,0,-123000,0,0,0,1000,124000,-123000,-123000
049537,元石油群益97購01,0,0,0,0,0,0,0,0,0,-123000,0,0,0,0,123000,-123000,-123000
05000P,臺股指永豐95售01,0,0,0,0,0,0,0,0,0,-123000,0,0,0,117000,240000,-123000,-123000
049996,元油2X永豐94購05,0,0,0,0,0,0,0,0,0,-123000,0,0,0,105000,228000,-123000,-123000
051311,瑞昱麥證95購01  ,0,0,0,113000,235000,-122000,0,0,0,-123000,0,0,0,113000,236000,-123000,-123000
053841,美律統一96購01  ,0,0,0,0,0,0,0,0,0,-123000,0,0,0,125000,248000,-123000,-123000
053536,明泰永豐96購01  ,0,0,0,0,0,0,0,0,0,-123000,0,0,0,0,123000,-123000,-123000
055725,嘉聯益元大98購03,0,0,0,0,0,0,0,0,0,-124000,0,0,0,31000,155000,-124000,-124000
047997,南亞科元大93購03,0,0,0,0,0,0,0,0,0,-124000,0,0,0,10000,134000,-124000,-124000
053788,泰鼎元大97購01  ,0,0,0,0,0,0,0,0,0,-124000,0,0,0,8000,132000,-124000,-124000
1608,華榮            ,7000,130000,-123000,0,0,0,0,0,0,-1000,0,1000,-1000,0,0,0,-124000
054883,億光統一97購01  ,0,0,0,0,0,0,0,0,0,-125000,0,0,0,40000,165000,-125000,-125000
05950P,台積電國票97售04,0,0,0,0,0,0,0,0,0,-125000,0,0,0,0,125000,-125000,-125000
056636,台積電日盛9A購01,0,0,0,0,0,0,0,0,0,-125000,0,0,0,0,125000,-125000,-125000
052150,台積電富邦95購07,0,0,0,0,0,0,0,0,0,-125000,0,0,0,1130000,1255000,-125000,-125000
06013P,世芯國泰97售03  ,0,0,0,0,0,0,0,0,0,-125000,0,0,0,69000,194000,-125000,-125000
4532,瑞智            ,18000,143000,-125000,0,0,0,0,0,0,0,0,0,0,0,0,0,-125000
056253,京鼎兆豐98購01  ,0,0,0,0,0,0,0,0,0,-126000,0,0,0,14000,140000,-126000,-126000
056361,美律元大99購02  ,0,0,0,0,0,0,0,0,0,-126000,0,0,0,19000,145000,-126000,-126000
051186,創意永豐95購01  ,0,0,0,0,0,0,0,0,0,-126000,0,0,0,10000,136000,-126000,-126000
3698,隆達            ,122000,230000,-108000,0,0,0,0,0,0,-18000,8000,0,8000,0,26000,-26000,-126000
1707,葡萄王          ,22000,145400,-123400,0,0,0,0,0,0,-3000,0,3000,-3000,0,0,0,-126400
055807,勤誠永豐97購01  ,0,0,0,0,0,0,0,0,0,-127000,0,0,0,73000,200000,-127000,-127000
055166,台積電統一97購05,0,0,0,0,0,0,0,0,0,-127000,0,0,0,900000,1027000,-127000,-127000
049462,康友元富94購01  ,0,0,0,0,0,0,0,0,0,-127000,0,0,0,20000,147000,-127000,-127000
05437P,聯詠永豐95售02  ,0,0,0,0,0,0,0,0,0,-127000,0,0,0,0,127000,-127000,-127000
054358,矽創兆豐96購01  ,0,0,0,0,0,0,0,0,0,-127000,0,0,0,169000,296000,-127000,-127000
053940,康友元富96購01  ,0,0,0,0,0,0,0,0,0,-127000,0,0,0,50000,177000,-127000,-127000
06244P,智易元富97售02  ,0,0,0,0,0,0,0,0,0,-127000,0,0,0,0,127000,-127000,-127000
056098,矽創元富97購02  ,0,0,0,0,0,0,0,0,0,-128000,0,0,0,31000,159000,-128000,-128000
056298,億光元大97購02  ,0,0,0,0,0,0,0,0,0,-128000,0,0,0,37000,165000,-128000,-128000
05807P,泰鼎永豐96售03  ,0,0,0,0,0,0,0,0,0,-128000,0,0,0,0,128000,-128000,-128000
051297,台積電凱基95購07,0,0,0,0,0,0,0,0,0,-128000,0,0,0,124000,252000,-128000,-128000
051359,中信金元大95購01,0,0,0,0,0,0,0,0,0,-128000,0,0,0,407000,535000,-128000,-128000
05006P,華通元富95售01  ,0,0,0,0,0,0,0,0,0,-128000,0,0,0,71000,199000,-128000,-128000
2436,偉詮電          ,30000,158000,-128000,0,0,0,0,0,0,0,0,0,0,0,0,0,-128000
3437,榮創            ,67000,196000,-129000,0,0,0,0,0,0,0,0,0,0,0,0,0,-129000
047076,TPK兆豐94購01   ,0,0,0,0,0,0,0,0,0,-130000,0,0,0,0,130000,-130000,-130000
047266,嘉聯益國票94購02,0,0,0,0,0,0,0,0,0,-130000,0,0,0,0,130000,-130000,-130000
04626P,聯發科元大94售07,0,0,0,0,0,0,0,0,0,-130000,0,0,0,200000,330000,-130000,-130000
04260P,亞德客群益93售01,0,0,0,0,0,0,0,0,0,-130000,0,0,0,35000,165000,-130000,-130000
045288,元油2X元大95購02,0,0,0,0,0,0,0,0,0,-130000,0,0,0,0,130000,-130000,-130000
05149P,緯穎國泰96售01  ,0,0,0,0,0,0,0,0,0,-130000,0,0,0,0,130000,-130000,-130000
2233,宇隆            ,4000,130000,-126000,0,0,0,0,0,0,-4000,0,0,0,8000,12000,-4000,-130000
06070P,漢唐永豐97售01  ,0,0,0,0,0,0,0,0,0,-130000,0,0,0,73000,203000,-130000,-130000
06364P,鴻海凱基97售08  ,0,0,0,0,0,0,0,0,0,-130000,0,0,0,20000,150000,-130000,-130000
046264,美律凱基93購05  ,0,0,0,0,0,0,0,0,0,-131000,0,0,0,43000,174000,-131000,-131000
047386,南亞科元大93購01,0,0,0,0,0,0,0,0,0,-131000,0,0,0,50000,181000,-131000,-131000
055233,康友國票98購01  ,0,0,0,0,0,0,0,0,0,-132000,0,0,0,0,132000,-132000,-132000
052393,康友群益95購05  ,0,0,0,0,0,0,0,0,0,-132000,0,0,0,181000,313000,-132000,-132000
06328P,台積電中信01售02,0,0,0,0,0,0,0,0,0,-132000,0,0,0,43000,175000,-132000,-132000
1730,花仙子          ,176000,316000,-140000,0,0,0,0,0,0,8000,8000,0,8000,0,0,0,-132000
2723,美食-KY         ,288000,386000,-98000,0,0,0,0,0,0,-34000,0,7000,-7000,0,27000,-27000,-132000
055703,緯穎富邦98購01  ,0,0,0,0,0,0,0,0,0,-133000,0,0,0,175000,308000,-133000,-133000
05927P,正文永豐96售03  ,0,0,0,0,0,0,0,0,0,-133000,0,0,0,0,133000,-133000,-133000
056398,南茂永豐98購01  ,0,0,0,0,0,0,0,0,0,-133000,0,0,0,97000,230000,-133000,-133000
056289,合勤控永豐97購01,0,0,0,0,0,0,0,0,0,-133000,0,0,0,5000,138000,-133000,-133000
04998P,京元電永豐95售01,0,0,0,0,0,0,0,0,0,-133000,0,0,0,30000,163000,-133000,-133000
1218,泰山            ,7000,139000,-132000,0,0,0,0,0,0,-1000,0,1000,-1000,0,0,0,-133000
9940,信義            ,5000,138000,-133000,0,0,0,0,0,0,0,0,0,0,0,0,0,-133000
055378,晶相光元大97購02,0,0,0,0,0,0,0,0,0,-134000,0,0,0,63000,197000,-134000,-134000
050791,聯發科富邦96購01,0,0,0,0,0,0,0,0,0,-134000,0,0,0,100000,234000,-134000,-134000
2812,台中銀          ,649000,783000,-134000,0,0,0,0,0,0,0,0,0,0,0,0,0,-134000
055392,凱美統一97購03  ,0,0,0,0,0,0,0,0,0,-135000,0,0,0,4000,139000,-135000,-135000
054984,華泰元富97購01  ,0,0,0,0,0,0,0,0,0,-135000,0,0,0,10000,145000,-135000,-135000
05472P,國巨統一96售02  ,0,0,0,0,0,0,0,0,0,-135000,0,0,0,30000,165000,-135000,-135000
044711,台郡元大93購01  ,0,0,0,0,0,0,0,0,0,-135000,0,0,0,0,135000,-135000,-135000
04993P,上銀兆豐96售01  ,0,0,0,0,0,0,0,0,0,-135000,0,0,0,74000,209000,-135000,-135000
3050,鈺德            ,11000,146000,-135000,0,0,0,0,0,0,0,0,0,0,0,0,0,-135000
2607,榮運            ,45000,148000,-103000,0,0,0,0,0,0,-32000,0,32000,-32000,0,0,0,-135000
9934,成霖            ,25000,160000,-135000,0,0,0,0,0,0,0,0,0,0,0,0,0,-135000
052221,東元凱基95購01  ,0,0,0,0,0,0,0,0,0,-136000,0,0,0,0,136000,-136000,-136000
053413,台積電國票99購01,0,0,0,0,0,0,0,0,0,-136000,0,0,0,7000,143000,-136000,-136000
054520,健鼎元大96購02  ,0,0,0,0,0,0,0,0,0,-137000,0,0,0,1000,138000,-137000,-137000
055043,中砂永豐97購01  ,0,0,0,0,0,0,0,0,0,-137000,0,0,0,0,137000,-137000,-137000
049965,矽創元富94購01  ,0,0,0,0,0,0,0,0,0,-137000,0,0,0,0,137000,-137000,-137000
04890P,台積電元大95售05,0,0,0,0,0,0,0,0,0,-137000,0,0,0,99000,236000,-137000,-137000
052200,台光電統一95購02,0,0,0,0,0,0,0,0,0,-137000,0,0,0,19000,156000,-137000,-137000
06189P,華新科永豐97售03,0,0,0,0,0,0,0,0,0,-137000,0,0,0,20000,157000,-137000,-137000
06153P,健策元大97售04  ,0,0,0,0,0,0,0,0,0,-137000,0,0,0,2000,139000,-137000,-137000
055220,緯穎凱基98購02  ,0,0,0,0,0,0,0,0,0,-138000,0,0,0,2000,140000,-138000,-138000
056159,牧德凱基99購01  ,0,0,0,0,0,0,0,0,0,-138000,0,0,0,2000,140000,-138000,-138000
054488,禾伸堂台新96購01,0,0,0,0,0,0,0,0,0,-138000,0,0,0,84000,222000,-138000,-138000
06139P,台積電中信99售02,0,0,0,0,0,0,0,0,0,-138000,0,0,0,26000,164000,-138000,-138000
05015P,臺股指元大95售06,0,0,0,0,0,0,0,0,0,-139000,0,0,0,366000,505000,-139000,-139000
04820P,聯茂永豐94售02  ,0,0,0,0,0,0,0,0,0,-139000,0,0,0,10000,149000,-139000,-139000
052297,旭富國票96購01  ,0,0,0,0,0,0,0,0,0,-139000,0,0,0,19000,158000,-139000,-139000
1315,達新            ,18000,159000,-141000,0,0,0,0,0,0,2000,3000,1000,2000,0,0,0,-139000
03917P,鴻海凱基94售07  ,0,0,0,0,0,0,0,0,0,-140000,0,0,0,0,140000,-140000,-140000
04317P,樺漢國票93售03  ,0,0,0,0,0,0,0,0,0,-140000,0,0,0,0,140000,-140000,-140000
047892,康控兆豐94購01  ,0,0,0,0,0,0,0,0,0,-140000,0,0,0,0,140000,-140000,-140000
05035P,聯發科元大95售06,0,0,0,0,0,0,0,0,0,-140000,0,0,0,79000,219000,-140000,-140000
052101,滬深2X兆豐96購01,0,0,0,0,0,0,0,0,0,-140000,0,0,0,200000,340000,-140000,-140000
051896,柏文元富95購01  ,0,0,0,0,0,0,0,0,0,-140000,0,0,0,0,140000,-140000,-140000
053379,南亞科元大96購01,0,0,0,0,0,0,0,0,0,-140000,0,0,0,6000,146000,-140000,-140000
053563,台積電富邦97購01,0,0,0,0,0,0,0,0,0,-140000,0,0,0,302000,442000,-140000,-140000
1464,得力            ,51000,189000,-138000,0,0,0,0,0,0,-2000,0,0,0,0,2000,-2000,-140000
2352,佳世達          ,646000,767000,-121000,0,0,0,1000,0,1000,-20000,0,1000,-1000,0,19000,-19000,-140000
055605,緯穎元大97購02  ,0,0,0,0,0,0,0,0,0,-141000,0,0,0,35000,176000,-141000,-141000
054606,台積電永豐97購02,0,0,0,0,0,0,0,0,0,-141000,0,0,0,173000,314000,-141000,-141000
051202,智邦麥證95購01  ,0,0,0,0,141000,-141000,0,0,0,-141000,0,0,0,0,141000,-141000,-141000
049157,矽創元大95購01  ,0,0,0,0,0,0,0,0,0,-141000,0,0,0,22000,163000,-141000,-141000
053951,T50反1台新06購02,0,0,0,0,0,0,0,0,0,-141000,0,0,0,0,141000,-141000,-141000
052080,康友元富98購02  ,0,0,0,0,0,0,0,0,0,-141000,0,0,0,60000,201000,-141000,-141000
05616P,台光電永豐96售01,0,0,0,0,0,0,0,0,0,-142000,0,0,0,0,142000,-142000,-142000
054047,富邦金元大97購01,0,0,0,0,0,0,0,0,0,-142000,0,0,0,19000,161000,-142000,-142000
053709,台達電凱基96購04,0,0,0,0,0,0,0,0,0,-142000,0,0,0,68000,210000,-142000,-142000
6558,興能高          ,34000,176000,-142000,0,0,0,0,0,0,0,0,0,0,0,0,0,-142000
055891,鴻海統一9A購01  ,0,0,0,0,0,0,0,0,0,-144000,0,0,0,935000,1079000,-144000,-144000
050470,智邦台新94購01  ,0,0,0,0,0,0,0,0,0,-145000,0,0,0,0,145000,-145000,-145000
046290,儒鴻統一93購01  ,0,0,0,0,0,0,0,0,0,-145000,0,0,0,50000,195000,-145000,-145000
042481,嘉聯益統一92購01,0,0,0,0,0,0,0,0,0,-145000,0,0,0,50000,195000,-145000,-145000
042195,元石油元大93購01,0,0,0,0,0,0,0,0,0,-145000,0,0,0,0,145000,-145000,-145000
048924,光罩永豐94購01  ,0,0,0,0,0,0,0,0,0,-145000,0,0,0,5000,150000,-145000,-145000
048671,大立光永豐93購04,0,0,0,0,0,0,0,0,0,-145000,0,0,0,30000,175000,-145000,-145000
053264,南亞科群益96購01,0,0,0,0,0,0,0,0,0,-145000,0,0,0,14000,159000,-145000,-145000
054228,貿聯元富96購03  ,0,0,0,0,0,0,0,0,0,-145000,0,0,0,15000,160000,-145000,-145000
4552,力達-KY         ,17000,162000,-145000,0,0,0,0,0,0,0,0,0,0,0,0,0,-145000
06066P,群創台新98售01  ,0,0,0,0,0,0,0,0,0,-145000,0,0,0,0,145000,-145000,-145000
055006,晶相光元富9A購01,0,0,0,0,0,0,0,0,0,-146000,0,0,0,52000,198000,-146000,-146000
055245,凱美統一99購01  ,0,0,0,0,0,0,0,0,0,-146000,0,0,0,0,146000,-146000,-146000
052052,嘉澤凱基95購02  ,0,0,0,0,0,0,0,0,0,-146000,0,0,0,35000,181000,-146000,-146000
3010,華立            ,9000,155000,-146000,0,0,0,0,0,0,0,0,0,0,0,0,0,-146000
2467,志聖            ,7000,153000,-146000,0,0,0,0,0,0,0,0,0,0,0,0,0,-146000
2359,所羅門          ,62000,208000,-146000,0,0,0,0,0,0,0,0,0,0,0,0,0,-146000
05490P,鴻海元大95售23  ,0,0,0,0,0,0,0,0,0,-147000,0,0,0,112000,259000,-147000,-147000
054711,禾伸堂元富97購01,0,0,0,0,0,0,0,0,0,-147000,0,0,0,120000,267000,-147000,-147000
05202P,鴻海元大95售16  ,0,0,0,0,0,0,0,0,0,-147000,0,0,0,25000,172000,-147000,-147000
054159,T50正2凱基99購01,0,0,0,0,0,0,0,0,0,-147000,0,0,0,0,147000,-147000,-147000
050856,智邦台新95購01  ,0,0,0,0,0,0,0,0,0,-148000,0,0,0,0,148000,-148000,-148000
054637,智邦中信98購01  ,0,0,0,0,0,0,0,0,0,-149000,0,0,0,10000,159000,-149000,-149000
055518,華新科中信99購01,0,0,0,0,0,0,0,0,0,-149000,0,0,0,370000,519000,-149000,-149000
042941,永冠國票93購01  ,0,0,0,0,0,0,0,0,0,-149000,0,0,0,0,149000,-149000,-149000
053059,聯發科永昌99購01,0,0,0,0,0,0,0,0,0,-149000,0,0,0,64000,213000,-149000,-149000
2023,燁輝            ,59000,206000,-147000,0,0,0,0,0,0,-2000,0,2000,-2000,0,0,0,-149000
2923,鼎固-KY         ,55000,204000,-149000,0,0,0,0,0,0,0,0,0,0,0,0,0,-149000
046568,臻鼎元富95購01  ,0,0,0,0,0,0,0,0,0,-150000,0,0,0,0,150000,-150000,-150000
043650,喬山國泰93購02  ,0,0,0,0,0,0,0,0,0,-150000,0,0,0,0,150000,-150000,-150000
040578,SP黃豆元富95購03,0,0,0,0,0,0,0,0,0,-150000,0,0,0,0,150000,-150000,-150000
03608P,鴻海元大92售14  ,0,0,0,0,0,0,0,0,0,-150000,0,0,0,0,150000,-150000,-150000
050362,深中小元大94購04,0,0,0,0,0,0,0,0,0,-150000,0,0,0,0,150000,-150000,-150000
050346,康友元富94購03  ,0,0,0,0,0,0,0,0,0,-150000,0,0,0,14000,164000,-150000,-150000
047893,嘉聯益兆豐94購01,0,0,0,0,0,0,0,0,0,-150000,0,0,0,0,150000,-150000,-150000
049359,台達電元大94購06,0,0,0,0,0,0,0,0,0,-150000,0,0,0,0,150000,-150000,-150000
051533,健鼎國票96購02  ,0,0,0,0,0,0,0,0,0,-150000,0,0,0,10000,160000,-150000,-150000
052804,淘帝元大96購01  ,0,0,0,0,0,0,0,0,0,-150000,0,0,0,73000,223000,-150000,-150000
054329,華新科永豐96購02,0,0,0,0,0,0,0,0,0,-150000,0,0,0,16000,166000,-150000,-150000
053310,彩晶凱基98購02  ,0,0,0,0,0,0,0,0,0,-150000,0,0,0,0,150000,-150000,-150000
055216,友達凱基98購05  ,0,0,0,0,0,0,0,0,0,-151000,0,0,0,35000,186000,-151000,-151000
055187,彩晶統一98購01  ,0,0,0,0,0,0,0,0,0,-151000,0,0,0,166000,317000,-151000,-151000
04163P,可成統一93售03  ,0,0,0,0,0,0,0,0,0,-151000,0,0,0,0,151000,-151000,-151000
054330,世芯永豐96購02  ,0,0,0,0,0,0,0,0,0,-151000,0,0,0,39000,190000,-151000,-151000
06278P,臺股指凱基97售10,0,0,0,0,0,0,0,0,0,-151000,0,0,0,187000,338000,-151000,-151000
056227,奇力新凱基98購04,0,0,0,0,0,0,0,0,0,-152000,0,0,0,0,152000,-152000,-152000
045172,欣興兆豐94購01  ,0,0,0,0,0,0,0,0,0,-152000,0,0,0,88000,240000,-152000,-152000
05099P,台積電凱基95售06,0,0,0,0,0,0,0,0,0,-152000,0,0,0,0,152000,-152000,-152000
2704,國賓            ,7000,159000,-152000,0,0,0,0,0,0,0,0,0,0,0,0,0,-152000
05496P,聯詠統一95售04  ,0,0,0,0,0,0,0,0,0,-153000,0,0,0,5000,158000,-153000,-153000
054909,福懋科康和97購01,0,0,0,0,0,0,0,0,0,-153000,0,0,0,0,153000,-153000,-153000
047604,智原國泰95購01  ,0,0,0,0,0,0,0,0,0,-153000,0,0,0,0,153000,-153000,-153000
00715L,街口布蘭特油正2 ,0,0,0,0,0,0,0,0,0,-153000,0,0,0,0,153000,-153000,-153000
051487,健策凱基96購03  ,0,0,0,0,0,0,0,0,0,-153000,0,0,0,98000,251000,-153000,-153000
05167P,百和元富95售03  ,0,0,0,0,0,0,0,0,0,-153000,0,0,0,0,153000,-153000,-153000
051344,鴻海元大95購08  ,0,0,0,0,0,0,0,0,0,-153000,0,0,0,337000,490000,-153000,-153000
049869,訊芯兆豐94購01  ,0,0,0,0,0,0,0,0,0,-153000,0,0,0,209000,362000,-153000,-153000
053441,旺宏凱基98購01  ,0,0,0,0,0,0,0,0,0,-153000,0,0,0,30000,183000,-153000,-153000
06164P,臺股指凱基97售04,0,0,0,0,0,0,0,0,0,-153000,0,0,0,183000,336000,-153000,-153000
055126,嘉澤兆豐97購01  ,0,0,0,0,0,0,0,0,0,-154000,0,0,0,6000,160000,-154000,-154000
05514P,康舒永豐96售01  ,0,0,0,0,0,0,0,0,0,-154000,0,0,0,8000,162000,-154000,-154000
1337,再生-KY         ,3000,157461,-154461,0,0,0,0,0,0,0,0,0,0,0,0,0,-154461
056275,國巨國泰98購04  ,0,0,0,0,0,0,0,0,0,-155000,0,0,0,47000,202000,-155000,-155000
03557P,欣興元大02售17  ,0,0,0,0,0,0,0,0,0,-155000,0,0,0,410000,565000,-155000,-155000
03276P,聯發科台新02售01,0,0,0,0,0,0,0,0,0,-155000,0,0,0,0,155000,-155000,-155000
049118,元油2X元富94購03,0,0,0,0,0,0,0,0,0,-155000,0,0,0,11000,166000,-155000,-155000
05644P,大立光中信9A售03,0,0,0,0,0,0,0,0,0,-156000,0,0,0,4000,160000,-156000,-156000
04956P,臺股指日盛94售02,0,0,0,0,0,0,0,0,0,-156000,0,0,0,48000,204000,-156000,-156000
050959,元金2X永豐95購02,0,0,0,0,0,0,0,0,0,-156000,0,0,0,10000,166000,-156000,-156000
054190,矽創永豐96購01  ,0,0,0,0,0,0,0,0,0,-156000,0,0,0,68000,224000,-156000,-156000
9921,巨大            ,526000,677000,-151000,0,0,0,1000,6000,-5000,0,0,0,0,0,0,0,-156000
9907,統一實          ,83000,238000,-155000,0,0,0,0,0,0,-1000,0,1000,-1000,0,0,0,-156000
054577,世芯元大98購01  ,0,0,0,0,0,0,0,0,0,-157000,0,0,0,196000,353000,-157000,-157000
055370,旺宏元大97購05  ,0,0,0,0,0,0,0,0,0,-157000,0,0,0,16000,173000,-157000,-157000
04503P,元油2X元富98售09,0,0,0,0,0,0,0,0,0,-157000,0,0,0,13000,170000,-157000,-157000
051114,鈺齊中信95購01  ,0,0,0,0,0,0,0,0,0,-157000,0,0,0,85000,242000,-157000,-157000
3019,亞光            ,462000,520000,-58000,0,0,0,0,0,0,-99000,12000,58000,-46000,0,53000,-53000,-157000
053888,和大群益97購01  ,0,0,0,0,0,0,0,0,0,-158000,0,0,0,41000,199000,-158000,-158000
3029,零壹            ,15000,173000,-158000,0,0,0,0,0,0,0,0,0,0,0,0,0,-158000
06279P,臺股指凱基97售11,0,0,0,0,0,0,0,0,0,-158000,0,0,0,185000,343000,-158000,-158000
9914,美利達          ,383000,574000,-191000,0,0,0,0,0,0,33000,40000,1000,39000,1000,7000,-6000,-158000
054820,新日興元大97購01,0,0,0,0,0,0,0,0,0,-159000,0,0,0,74000,233000,-159000,-159000
051168,訊連元大95購02  ,0,0,0,0,0,0,0,0,0,-159000,0,0,0,46000,205000,-159000,-159000
05697P,友達凱基96售01  ,0,0,0,0,0,0,0,0,0,-160000,0,0,0,0,160000,-160000,-160000
041978,貿聯中信93購01  ,0,0,0,0,0,0,0,0,0,-160000,0,0,0,0,160000,-160000,-160000
045018,矽創元大93購01  ,0,0,0,0,0,0,0,0,0,-160000,0,0,0,30000,190000,-160000,-160000
046257,A50正2國票94購01,0,0,0,0,0,0,0,0,0,-160000,0,0,0,0,160000,-160000,-160000
051142,臺股指永豐95購02,0,0,0,0,0,0,0,0,0,-160000,0,0,0,120000,280000,-160000,-160000
049212,T50反1國票94購04,0,0,0,0,0,0,0,0,0,-160000,0,0,0,77000,237000,-160000,-160000
049111,元油2X統一94購03,0,0,0,0,0,0,0,0,0,-160000,0,0,0,0,160000,-160000,-160000
053873,力成元大96購03  ,0,0,0,0,0,0,0,0,0,-160000,0,0,0,0,160000,-160000,-160000
051846,S&P反1中信96購02,0,0,0,0,0,0,0,0,0,-160000,0,0,0,50000,210000,-160000,-160000
5434,崇越            ,102000,362000,-260000,0,0,0,0,0,0,100000,106000,0,106000,10000,16000,-6000,-160000
054687,建準永豐97購02  ,0,0,0,0,0,0,0,0,0,-161000,0,0,0,0,161000,-161000,-161000
055483,和大元大97購03  ,0,0,0,0,0,0,0,0,0,-161000,0,0,0,57000,218000,-161000,-161000
049023,玉晶光群益96購04,0,0,0,0,0,0,0,0,0,-161000,0,0,0,43000,204000,-161000,-161000
049313,晶技凱基94購01  ,0,0,0,0,0,0,0,0,0,-161000,0,0,0,0,161000,-161000,-161000
052591,康友永豐97購01  ,0,0,0,0,0,0,0,0,0,-161000,0,0,0,60000,221000,-161000,-161000
052941,康控兆豐97購01  ,0,0,0,0,0,0,0,0,0,-161000,0,0,0,150000,311000,-161000,-161000
053452,臺股指凱基97購01,0,0,0,0,0,0,0,0,0,-161000,0,0,0,29000,190000,-161000,-161000
056671,台灣50元富9A購01,1000,0,1000,0,0,0,0,0,0,-163000,0,0,0,55000,218000,-163000,-162000
04380P,欣興元大94售02  ,0,0,0,0,0,0,0,0,0,-162000,0,0,0,8000,170000,-162000,-162000
2428,興勤            ,24000,187000,-163000,0,0,0,0,0,0,1000,0,0,0,2000,1000,1000,-162000
2545,皇翔            ,31000,193000,-162000,0,0,0,0,0,0,0,0,0,0,0,0,0,-162000
054880,華泰統一97購01  ,0,0,0,0,0,0,0,0,0,-163000,0,0,0,84000,247000,-163000,-163000
045054,聯發科元富98購02,0,0,0,0,0,0,0,0,0,-163000,0,0,0,81000,244000,-163000,-163000
2362,藍天            ,26000,189000,-163000,0,0,0,0,0,0,0,0,0,0,0,0,0,-163000
5285,界霖            ,1000,164000,-163000,0,0,0,0,0,0,0,0,0,0,0,0,0,-163000
054720,禾伸堂永豐97購01,0,0,0,0,0,0,0,0,0,-164000,0,0,0,0,164000,-164000,-164000
054465,亞光凱基97購01  ,0,0,0,0,0,0,0,0,0,-164000,0,0,0,35000,199000,-164000,-164000
2499,東貝            ,57000,221000,-164000,0,0,0,0,0,0,0,0,0,0,0,0,0,-164000
1560,中砂            ,188000,359000,-171000,0,0,0,0,0,0,6000,0,0,0,6000,0,6000,-165000
8996,高力            ,495000,821000,-326000,0,0,0,134000,0,134000,27000,47000,20000,27000,0,0,0,-165000
056576,晶技元大99購02  ,0,0,0,0,0,0,0,0,0,-166000,0,0,0,14000,180000,-166000,-166000
05745P,富邦金兆豐96售02,0,0,0,0,0,0,0,0,0,-166000,0,0,0,0,166000,-166000,-166000
056011,矽力中信99購01  ,0,0,0,0,0,0,0,0,0,-166000,0,0,0,109000,275000,-166000,-166000
00693U,街口S&P黃豆     ,0,0,0,0,0,0,0,0,0,-166000,0,0,0,0,166000,-166000,-166000
03027P,玉晶光元大01售09,0,0,0,0,0,0,0,0,0,-166000,0,0,0,0,166000,-166000,-166000
05620P,大立光富邦9B售01,0,0,0,0,0,0,0,0,0,-167000,0,0,0,142000,309000,-167000,-167000
05654P,台光電統一96售01,0,0,0,0,0,0,0,0,0,-167000,0,0,0,34000,201000,-167000,-167000
053548,旺宏凱基96購04  ,0,0,0,0,0,0,0,0,0,-168000,0,0,0,115000,283000,-168000,-168000
05199P,訊芯永豐95售02  ,0,0,0,0,0,0,0,0,0,-168000,0,0,0,420000,588000,-168000,-168000
055793,臺股指凱基97購16,0,0,0,0,0,0,0,0,0,-169000,0,0,0,0,169000,-169000,-169000
05446P,緯穎元大95售04  ,0,0,0,0,0,0,0,0,0,-169000,0,0,0,10000,179000,-169000,-169000
055401,亞光元富9A購01  ,0,0,0,0,0,0,0,0,0,-170000,0,0,0,20000,190000,-170000,-170000
048590,貿聯兆豐94購02  ,0,0,0,0,0,0,0,0,0,-170000,0,0,0,30000,200000,-170000,-170000
050149,東元群益94購01  ,0,0,0,0,0,0,0,0,0,-170000,0,0,0,30000,200000,-170000,-170000
054130,漢唐元大97購02  ,0,0,0,0,0,0,0,0,0,-170000,0,0,0,210000,380000,-170000,-170000
03180P,台灣50元大01售39,0,0,0,0,0,0,0,0,0,-171000,0,0,0,52000,223000,-171000,-171000
2014,中鴻            ,298000,458000,-160000,0,0,0,0,0,0,-11000,0,11000,-11000,0,0,0,-171000
046298,聯發科富邦94購01,0,0,0,0,0,0,0,0,0,-172000,0,0,0,40000,212000,-172000,-172000
051578,智邦元大96購01  ,0,0,0,0,0,0,0,0,0,-172000,0,0,0,67000,239000,-172000,-172000
052461,和大統一95購01  ,0,0,0,0,0,0,0,0,0,-172000,0,0,0,38000,210000,-172000,-172000
06428P,國巨元大97售17  ,0,0,0,0,0,0,0,0,0,-172000,0,0,0,0,172000,-172000,-172000
05052P,友達群益97售01  ,0,0,0,0,0,0,0,0,0,-173000,0,0,0,32000,205000,-173000,-173000
055537,康友群益97購03  ,0,0,0,0,0,0,0,0,0,-174000,0,0,0,490000,664000,-174000,-174000
046549,康友永豐92購02  ,0,0,0,0,0,0,0,0,0,-174000,0,0,0,0,174000,-174000,-174000
048059,欣興國泰95購01  ,0,0,0,0,0,0,0,0,0,-174000,0,0,0,11000,185000,-174000,-174000
050581,美食國票94購02  ,0,0,0,0,0,0,0,0,0,-174000,0,0,0,30000,204000,-174000,-174000
052622,貿聯兆豐97購01  ,0,0,0,0,0,0,0,0,0,-174000,0,0,0,20000,194000,-174000,-174000
056311,泰鼎元大98購01  ,0,0,0,0,0,0,0,0,0,-175000,0,0,0,312000,487000,-175000,-175000
04352P,國巨永豐94售01  ,0,0,0,0,0,0,0,0,0,-175000,0,0,0,0,175000,-175000,-175000
049776,全新統一95購02  ,0,0,0,0,0,0,0,0,0,-175000,0,0,0,0,175000,-175000,-175000
1449,佳和            ,7000,182000,-175000,0,0,0,0,0,0,0,0,0,0,0,0,0,-175000
3014,聯陽            ,87000,262000,-175000,0,0,0,0,0,0,0,0,0,0,0,0,0,-175000
044402,景碩凱基93購01  ,0,0,0,0,0,0,0,0,0,-176000,0,0,0,0,176000,-176000,-176000
044964,旺宏中信94購01  ,0,0,0,0,0,0,0,0,0,-176000,0,0,0,351000,527000,-176000,-176000
04558P,瑞昱日盛94售01  ,0,0,0,0,0,0,0,0,0,-176000,0,0,0,100000,276000,-176000,-176000
052432,康友永豐95購04  ,0,0,0,0,0,0,0,0,0,-176000,0,0,0,134000,310000,-176000,-176000
2524,京城            ,19000,194000,-175000,0,0,0,0,0,0,-1000,0,1000,-1000,0,0,0,-176000
2534,宏盛            ,79200,216000,-136800,0,0,0,0,0,0,-40000,0,0,0,0,40000,-40000,-176800
052888,台表科中信9A購01,0,0,0,0,0,0,0,0,0,-177000,0,0,0,153000,330000,-177000,-177000
2617,台航            ,0,162000,-162000,0,0,0,0,0,0,-15000,0,15000,-15000,0,0,0,-177000
050203,美律群益94購04  ,0,0,0,0,0,0,0,0,0,-178000,0,0,0,43000,221000,-178000,-178000
048979,晶相光元大94購03,0,0,0,0,0,0,0,0,0,-178000,0,0,0,48000,226000,-178000,-178000
05237P,為升永豐95售01  ,0,0,0,0,0,0,0,0,0,-178000,0,0,0,2000,180000,-178000,-178000
053649,台積電凱基97購05,0,0,0,0,0,0,0,0,0,-179000,0,0,0,3000,182000,-179000,-179000
1339,昭輝            ,53000,232000,-179000,0,0,0,0,0,0,0,0,0,0,0,0,0,-179000
06457P,玉晶光統一98售02,0,0,0,0,0,0,0,0,0,-179000,0,0,0,28000,207000,-179000,-179000
8105,凌巨            ,209000,388000,-179000,0,0,0,0,0,0,0,0,0,0,0,0,0,-179000
056012,勤誠中信99購01  ,0,0,0,0,0,0,0,0,0,-180000,0,0,0,80000,260000,-180000,-180000
047687,元金2X富邦96購01,0,0,0,0,0,0,0,0,0,-180000,0,0,0,0,180000,-180000,-180000
047264,貿聯國票93購02  ,0,0,0,0,0,0,0,0,0,-180000,0,0,0,0,180000,-180000,-180000
047569,世紀鋼國票94購02,0,0,0,0,0,0,0,0,0,-180000,0,0,0,0,180000,-180000,-180000
050304,台光電中信94購01,0,0,0,0,0,0,0,0,0,-180000,0,0,0,400000,580000,-180000,-180000
051614,元金2X凱基97購01,0,0,0,0,0,0,0,0,0,-180000,0,0,0,93000,273000,-180000,-180000
08602P,台灣50凱基96售04,0,0,0,0,0,0,0,0,0,-180000,0,0,0,0,180000,-180000,-180000
04745P,祥碩元大94售04  ,0,0,0,0,0,0,0,0,0,-181000,0,0,0,101000,282000,-181000,-181000
051159,力山元大96購01  ,0,0,0,0,0,0,0,0,0,-181000,0,0,0,10000,191000,-181000,-181000
055683,晶技凱基99購01  ,0,0,0,0,0,0,0,0,0,-182000,0,0,0,18000,200000,-182000,-182000
055260,晶相光統一98購01,0,0,0,0,0,0,0,0,0,-182000,0,0,0,55000,237000,-182000,-182000
049473,光罩永豐94購03  ,0,0,0,0,0,0,0,0,0,-182000,0,0,0,0,182000,-182000,-182000
048163,南亞科台新93購01,0,0,0,0,0,0,0,0,0,-182000,0,0,0,109000,291000,-182000,-182000
2331,精英            ,25000,208000,-183000,0,0,0,0,0,0,1000,1000,0,1000,0,0,0,-182000
050792,可成富邦96購01  ,0,0,0,0,0,0,0,0,0,-183000,0,0,0,30000,213000,-183000,-183000
051580,宏碁元大95購02  ,0,0,0,0,0,0,0,0,0,-184000,0,0,0,72000,256000,-184000,-184000
053255,貿聯國泰97購01  ,0,0,0,0,0,0,0,0,0,-184000,0,0,0,111000,295000,-184000,-184000
06337P,祥碩元大97售05  ,0,0,0,0,0,0,0,0,0,-184000,0,0,0,865000,1049000,-184000,-184000
4942,嘉彰            ,38000,228000,-190000,0,0,0,0,0,0,5000,5000,0,5000,0,0,0,-185000
056102,億光永豐97購02  ,0,0,0,0,0,0,0,0,0,-186000,0,0,0,0,186000,-186000,-186000
05329P,臺股指凱基95售13,0,0,0,0,0,0,0,0,0,-186000,0,0,0,58000,244000,-186000,-186000
3535,晶彩科          ,48000,234000,-186000,0,0,0,0,0,0,0,0,0,0,0,0,0,-186000
3708,上緯投控        ,23000,188000,-165000,0,0,0,0,0,0,-21000,0,0,0,0,21000,-21000,-186000
05176P,台積電凱基95售11,0,0,0,0,0,0,0,0,0,-187000,0,0,0,0,187000,-187000,-187000
053025,燿華富邦98購02  ,0,0,0,0,0,0,0,0,0,-187000,0,0,0,462000,649000,-187000,-187000
052852,國巨元富96購02  ,0,0,0,0,0,0,0,0,0,-187000,0,0,0,1051000,1238000,-187000,-187000
06358P,力成中信97售02  ,0,0,0,0,0,0,0,0,0,-187000,0,0,0,78000,265000,-187000,-187000
6592,和潤企業        ,33000,220000,-187000,0,0,0,0,0,0,0,0,0,0,0,0,0,-187000
050708,臺股指凱基96購06,0,0,0,0,0,0,0,0,0,-188000,0,0,0,55000,243000,-188000,-188000
04511P,臺股指元大94售06,0,0,0,0,0,0,0,0,0,-188000,0,0,0,0,188000,-188000,-188000
051296,鴻海凱基97購01  ,0,0,0,0,0,0,0,0,0,-188000,0,0,0,0,188000,-188000,-188000
06006P,欣興永豐96售04  ,0,0,0,0,0,0,0,0,0,-188000,0,0,0,54000,242000,-188000,-188000
042942,永冠國票94購01  ,0,0,0,0,0,0,0,0,0,-189000,0,0,0,11000,200000,-189000,-189000
052653,臺股指永豐97購01,0,0,0,0,0,0,0,0,0,-189000,0,0,0,22000,211000,-189000,-189000
05291P,鴻海凱基95售16  ,0,0,0,0,0,0,0,0,0,-189000,0,0,0,13000,202000,-189000,-189000
1809,中釉            ,64000,252000,-188000,0,0,0,0,0,0,-1000,0,1000,-1000,0,0,0,-189000
056606,華新科富邦9A購02,0,0,0,0,0,0,0,0,0,-190000,0,0,0,3000,193000,-190000,-190000
04298P,祥碩元大93售02  ,0,0,0,0,0,0,0,0,0,-190000,0,0,0,0,190000,-190000,-190000
05031P,台光電元富95售01,0,0,0,0,0,0,0,0,0,-190000,0,0,0,37000,227000,-190000,-190000
05104P,智邦台新95售02  ,0,0,0,0,0,0,0,0,0,-190000,0,0,0,0,190000,-190000,-190000
049322,志超凱基94購02  ,0,0,0,0,0,0,0,0,0,-190000,0,0,0,10000,200000,-190000,-190000
049191,元油2X永豐95購01,0,0,0,0,0,0,0,0,0,-190000,0,0,0,0,190000,-190000,-190000
054461,台積電凱基97購09,0,0,0,0,0,0,0,0,0,-190000,0,0,0,70000,260000,-190000,-190000
2377,微星            ,1137000,1708000,-571000,0,0,0,395000,0,395000,-14000,156000,17000,139000,56000,209000,-153000,-190000
3450,聯鈞            ,501000,455000,46000,0,0,0,0,0,0,-236000,0,0,0,9000,245000,-236000,-190000
05492P,聯茂元大95售02  ,0,0,0,0,0,0,0,0,0,-191000,0,0,0,50000,241000,-191000,-191000
05036P,義隆元大95售03  ,0,0,0,0,0,0,0,0,0,-191000,0,0,0,0,191000,-191000,-191000
04610P,世紀鋼永豐94售03,0,0,0,0,0,0,0,0,0,-191000,0,0,0,0,191000,-191000,-191000
1718,中纖            ,459000,650000,-191000,0,0,0,0,0,0,0,0,0,0,0,0,0,-191000
04685P,訊芯元大94售02  ,0,0,0,0,0,0,0,0,0,-192000,0,0,0,200000,392000,-192000,-192000
04519P,國泰金群益94售01,0,0,0,0,0,0,0,0,0,-192000,0,0,0,0,192000,-192000,-192000
048690,美律群益94購01  ,0,0,0,0,0,0,0,0,0,-192000,0,0,0,8000,200000,-192000,-192000
048928,華新科永豐94購02,0,0,0,0,0,0,0,0,0,-192000,0,0,0,51000,243000,-192000,-192000
2486,一詮            ,9000,201000,-192000,0,0,0,0,0,0,0,0,0,0,0,0,0,-192000
3024,憶聲            ,24000,231000,-207000,0,0,0,0,0,0,15000,15000,0,15000,0,0,0,-192000
00730,富邦臺灣優質高息,0,0,0,0,0,0,0,0,0,-193000,0,0,0,84000,277000,-193000,-193000
053262,華邦電群益96購02,0,0,0,0,0,0,0,0,0,-193000,0,0,0,22000,215000,-193000,-193000
2642,宅配通          ,18000,211000,-193000,0,0,0,0,0,0,0,0,0,0,0,0,0,-193000
03418B,臺股指元大95熊20,0,0,0,0,0,0,0,0,0,-195000,0,0,0,36000,231000,-195000,-195000
043961,道瓊反國泰94購01,0,0,0,0,0,0,0,0,0,-195000,0,0,0,0,195000,-195000,-195000
04748P,臺股指元大94售23,0,0,0,0,0,0,0,0,0,-195000,0,0,0,195000,390000,-195000,-195000
049988,貿聯凱基94購02  ,0,0,0,0,0,0,0,0,0,-195000,0,0,0,50000,245000,-195000,-195000
053766,友達富邦97購01  ,0,0,0,0,0,0,0,0,0,-195000,0,0,0,155000,350000,-195000,-195000
055760,新日興群益98購02,0,0,0,0,0,0,0,0,0,-196000,0,0,0,137000,333000,-196000,-196000
056104,義隆永豐97購01  ,0,0,0,0,0,0,0,0,0,-196000,0,0,0,72000,268000,-196000,-196000
1104,環泥            ,17000,213000,-196000,0,0,0,0,0,0,0,0,0,0,0,0,0,-196000
00738U,元大道瓊白銀    ,0,72000,-72000,0,0,0,0,0,0,-125000,0,86000,-86000,421000,460000,-39000,-197000
04629P,康控元大94售05  ,0,0,0,0,0,0,0,0,0,-197000,0,0,0,0,197000,-197000,-197000
05159P,聯發科永豐95售04,0,0,0,0,0,0,0,0,0,-197000,0,0,0,8000,205000,-197000,-197000
052784,緯穎國票97購02  ,0,0,0,0,0,0,0,0,0,-197000,0,0,0,7000,204000,-197000,-197000
055334,禾伸堂兆豐97購01,0,0,0,0,0,0,0,0,0,-198000,0,0,0,96000,294000,-198000,-198000
050154,可成群益94購05  ,0,0,0,0,0,0,0,0,0,-198000,0,0,0,0,198000,-198000,-198000
052108,鴻海元富95購11  ,0,0,0,0,0,0,0,0,0,-198000,0,0,0,0,198000,-198000,-198000
053798,台積電中信98購02,0,0,0,0,0,0,0,0,0,-198000,0,0,0,64000,262000,-198000,-198000
053433,友達日盛99購06  ,0,0,0,0,0,0,0,0,0,-198000,0,0,0,30000,228000,-198000,-198000
06366P,鴻海凱基97售10  ,0,0,0,0,0,0,0,0,0,-198000,0,0,0,20000,218000,-198000,-198000
3026,禾伸堂          ,808000,1075000,-267000,0,0,0,40000,0,40000,29000,0,130000,-130000,207000,48000,159000,-198000
8101,華冠            ,47000,245000,-198000,0,0,0,0,0,0,0,0,0,0,0,0,0,-198000
04020P,南茂永豐93售02  ,0,0,0,0,0,0,0,0,0,-199000,0,0,0,0,199000,-199000,-199000
048418,瑞昱統一93購04  ,0,0,0,0,0,0,0,0,0,-199000,0,0,0,0,199000,-199000,-199000
052269,T50反1日盛9B購01,0,0,0,0,0,0,0,0,0,-199000,0,0,0,6000,205000,-199000,-199000
054937,國巨元大97購03  ,0,0,0,0,0,0,0,0,0,-200000,0,0,0,10000,210000,-200000,-200000
056456,群創凱基9B購01  ,0,0,0,0,0,0,0,0,0,-200000,0,0,0,0,200000,-200000,-200000
05889P,群創元大98售02  ,0,0,0,0,0,0,0,0,0,-200000,0,0,0,0,200000,-200000,-200000
04119P,旺宏凱基93售06  ,0,0,0,0,0,0,0,0,0,-200000,0,0,0,0,200000,-200000,-200000
03388P,元油2X元富98售02,0,0,0,0,0,0,0,0,0,-200000,0,0,0,0,200000,-200000,-200000
03694P,嘉聯益永豐93售01,0,0,0,0,0,0,0,0,0,-200000,0,0,0,0,200000,-200000,-200000
03813P,可成麥證93售02  ,0,0,0,0,200000,-200000,0,0,0,-200000,0,0,0,0,200000,-200000,-200000
046380,神基凱基93購01  ,0,0,0,0,0,0,0,0,0,-200000,0,0,0,0,200000,-200000,-200000
04257P,景碩國票93售01  ,0,0,0,0,0,0,0,0,0,-200000,0,0,0,0,200000,-200000,-200000
045058,華邦電國泰94購01,0,0,0,0,0,0,0,0,0,-200000,0,0,0,0,200000,-200000,-200000
043538,元石油國票97購01,0,0,0,0,0,0,0,0,0,-200000,0,0,0,0,200000,-200000,-200000
045891,健鼎元大92購01  ,0,0,0,0,0,0,0,0,0,-200000,0,0,0,0,200000,-200000,-200000
045894,智伸科元大92購01,0,0,0,0,0,0,0,0,0,-200000,0,0,0,0,200000,-200000,-200000
049205,聯發科群益94購05,0,0,0,0,0,0,0,0,0,-200000,0,0,0,0,200000,-200000,-200000
049258,美律元大94購03  ,0,0,0,0,0,0,0,0,0,-200000,0,0,0,0,200000,-200000,-200000
049305,元油2X凱基95購06,0,0,0,0,0,0,0,0,0,-200000,0,0,0,0,200000,-200000,-200000
050499,台達電凱基94購11,0,0,0,0,0,0,0,0,0,-200000,0,0,0,68000,268000,-200000,-200000
050511,元油2X元大94購11,0,0,0,0,0,0,0,0,0,-200000,0,0,0,0,200000,-200000,-200000
050875,訊芯永豐95購01  ,0,0,0,0,0,0,0,0,0,-200000,0,0,0,0,200000,-200000,-200000
04799P,健策元大94售03  ,0,0,0,0,0,0,0,0,0,-200000,0,0,0,100000,300000,-200000,-200000
049831,日月光凱基94購01,0,0,0,0,0,0,0,0,0,-200000,0,0,0,0,200000,-200000,-200000
052181,南茂元大95購05  ,0,0,0,0,0,0,0,0,0,-200000,0,0,0,10000,210000,-200000,-200000
052401,智原凱基95購01  ,0,0,0,0,0,0,0,0,0,-200000,0,0,0,0,200000,-200000,-200000
051733,中環國票96購02  ,0,0,0,0,0,0,0,0,0,-200000,0,0,0,0,200000,-200000,-200000
05272P,臻鼎中信97售03  ,0,0,0,0,0,0,0,0,0,-200000,0,0,0,0,200000,-200000,-200000
054429,中石化台新97購01,0,0,0,0,0,0,0,0,0,-200000,0,0,0,0,200000,-200000,-200000
053945,國巨富邦98購02  ,0,0,0,0,0,0,0,0,0,-200000,0,0,0,628000,828000,-200000,-200000
2849,安泰銀          ,2000,202000,-200000,0,0,0,0,0,0,0,0,0,0,0,0,0,-200000
06488P,台積電元富98售05,0,0,0,0,0,0,0,0,0,-200000,0,0,0,0,200000,-200000,-200000
05491P,茂林元大95售04  ,0,0,0,0,0,0,0,0,0,-201000,0,0,0,463000,664000,-201000,-201000
054550,旺宏凱基98購02  ,0,0,0,0,0,0,0,0,0,-201000,0,0,0,4000,205000,-201000,-201000
05094P,大立光元大95售07,0,0,0,0,0,0,0,0,0,-201000,0,0,0,25000,226000,-201000,-201000
048249,嘉澤兆豐94購01  ,0,0,0,0,0,0,0,0,0,-201000,0,0,0,40000,241000,-201000,-201000
053711,鴻海凱基96購14  ,0,0,0,0,0,0,0,0,0,-201000,0,0,0,0,201000,-201000,-201000
2548,華固            ,134000,361000,-227000,0,0,0,0,0,0,26000,38000,8000,30000,4000,8000,-4000,-201000
6533,晶心科          ,77000,273000,-196000,0,0,0,0,0,0,-5000,0,5000,-5000,0,0,0,-201000
2388,威盛            ,43000,245000,-202000,0,0,0,0,0,0,0,0,0,0,0,0,0,-202000
2442,新美齊          ,24000,226000,-202000,0,0,0,0,0,0,0,0,0,0,0,0,0,-202000
05120P,聯發科國泰97售01,0,0,0,0,0,0,0,0,0,-203000,0,0,0,0,203000,-203000,-203000
048269,瀚宇博國泰95購01,0,0,0,0,0,0,0,0,0,-203000,0,0,0,57000,260000,-203000,-203000
049389,元石油中信97購02,5000,0,5000,0,0,0,0,0,0,-208000,0,0,0,42000,250000,-208000,-203000
050129,聯發科凱基94購11,0,0,0,0,0,0,0,0,0,-203000,0,0,0,0,203000,-203000,-203000
049922,禾伸堂元大95購01,0,0,0,0,0,0,0,0,0,-203000,0,0,0,148000,351000,-203000,-203000
2634,漢翔            ,211000,424000,-213000,0,0,0,1000,0,1000,9000,10000,1000,9000,0,0,0,-203000
6456,GIS-KY          ,339000,459000,-120000,0,0,0,0,0,0,-83000,1000,18000,-17000,2000,68000,-66000,-203000
056043,力成凱基97購01  ,0,0,0,0,0,0,0,0,0,-204000,0,0,0,1000,205000,-204000,-204000
2836,高雄銀          ,35000,239000,-204000,0,0,0,0,0,0,0,0,0,0,0,0,0,-204000
2855,統一證          ,64000,268000,-204000,0,0,0,0,0,0,0,0,0,0,0,0,0,-204000
055997,矽創國泰99購01  ,0,0,0,0,0,0,0,0,0,-205000,0,0,0,15000,220000,-205000,-205000
054534,台積電富邦98購03,0,0,0,0,0,0,0,0,0,-205000,0,0,0,191000,396000,-205000,-205000
051107,鴻海統一95購05  ,0,0,0,0,0,0,0,0,0,-205000,0,0,0,0,205000,-205000,-205000
06529P,貿聯富邦99售03  ,0,0,0,0,0,0,0,0,0,-205000,0,0,0,0,205000,-205000,-205000
05795P,華邦電群益96售05,0,0,0,0,0,0,0,0,0,-206000,0,0,0,95000,301000,-206000,-206000
050611,鴻海元大95購02  ,0,0,0,0,0,0,0,0,0,-207000,0,0,0,24000,231000,-207000,-207000
2485,兆赫            ,27000,234000,-207000,0,0,0,0,0,0,0,0,0,0,0,0,0,-207000
6141,柏承            ,110000,317000,-207000,0,0,0,0,0,0,0,0,0,0,0,0,0,-207000
055107,旺宏凱基98購04  ,0,0,0,0,0,0,0,0,0,-208000,0,0,0,70000,278000,-208000,-208000
6120,達運            ,77000,282000,-205000,0,0,0,0,0,0,-3000,0,1000,-1000,0,2000,-2000,-208000
1201,味全            ,102000,310000,-208000,0,0,0,0,0,0,0,0,0,0,0,0,0,-208000
04712P,國泰金元大94售01,0,0,0,0,0,0,0,0,0,-209000,0,0,0,0,209000,-209000,-209000
050081,聯發科統一94購07,0,0,0,0,0,0,0,0,0,-209000,0,0,0,0,209000,-209000,-209000
053985,矽創元大96購02  ,0,0,0,0,0,0,0,0,0,-209000,0,0,0,214000,423000,-209000,-209000
052377,景碩元大96購02  ,0,0,0,0,0,0,0,0,0,-209000,0,0,0,193000,402000,-209000,-209000
1442,名軒            ,6000,215000,-209000,0,0,0,0,0,0,0,0,0,0,0,0,0,-209000
06341P,大立光統一97售08,0,0,0,0,0,0,0,0,0,-209000,0,0,0,0,209000,-209000,-209000
051288,可成統一95購03  ,0,0,0,0,0,0,0,0,0,-210000,0,0,0,0,210000,-210000,-210000
053736,友達麥證96購01  ,0,0,0,146000,357000,-211000,0,0,0,-211000,0,0,0,146000,357000,-211000,-211000
2399,映泰            ,168000,379000,-211000,0,0,0,0,0,0,0,0,0,0,0,0,0,-211000
053019,禾伸堂元富96購01,0,0,0,0,0,0,0,0,0,-212000,0,0,0,80000,292000,-212000,-212000
03296P,台積電統一02售13,0,0,0,0,0,0,0,0,0,-214000,0,0,0,1000,215000,-214000,-214000
055454,華邦電元富97購02,0,0,0,0,0,0,0,0,0,-215000,0,0,0,802000,1017000,-215000,-215000
050770,全新元大94購04  ,0,0,0,0,0,0,0,0,0,-215000,0,0,0,130000,345000,-215000,-215000
2929,淘帝-KY         ,120000,335000,-215000,0,0,0,0,0,0,0,0,0,0,0,0,0,-215000
052683,鴻海元大97購03  ,0,0,0,0,0,0,0,0,0,-216000,0,0,0,10000,226000,-216000,-216000
05921P,同欣電元大96售06,0,0,0,0,0,0,0,0,0,-217000,0,0,0,0,217000,-217000,-217000
054009,欣興元富96購03  ,0,0,0,0,0,0,0,0,0,-217000,0,0,0,1000,218000,-217000,-217000
3703,欣陸            ,0,216000,-216000,0,0,0,0,0,0,-1000,0,1000,-1000,0,0,0,-217000
2511,太子            ,18000,235000,-217000,0,0,0,0,0,0,0,0,0,0,0,0,0,-217000
1305,華夏            ,47000,263000,-216000,0,0,0,0,0,0,-1000,0,1000,-1000,0,0,0,-217000
054671,國巨國泰98購01  ,0,0,0,0,0,0,0,0,0,-218000,0,0,0,10000,228000,-218000,-218000
04193P,智原永豐93售01  ,0,0,0,0,0,0,0,0,0,-218000,0,0,0,0,218000,-218000,-218000
042735,TPK兆豐92購01   ,0,0,0,0,0,0,0,0,0,-218000,0,0,0,0,218000,-218000,-218000
047529,嘉晶元大94購02  ,0,0,0,0,0,0,0,0,0,-218000,0,0,0,45000,263000,-218000,-218000
051446,中壽元大96購01  ,0,0,0,0,0,0,0,0,0,-218000,0,0,0,2000,220000,-218000,-218000
2538,基泰            ,20000,237000,-217000,0,0,0,0,0,0,-1000,0,1000,-1000,0,0,0,-218000
05805P,義隆永豐96售02  ,0,0,0,0,0,0,0,0,0,-219000,0,0,0,10000,229000,-219000,-219000
06320P,上銀統一97售04  ,0,0,0,0,0,0,0,0,0,-219000,0,0,0,20000,239000,-219000,-219000
8215,明基材          ,128000,347000,-219000,0,0,0,0,0,0,0,0,0,0,0,0,0,-219000
054756,世紀鋼凱基99購01,0,0,0,0,0,0,0,0,0,-220000,0,0,0,10000,230000,-220000,-220000
049685,T50反1元大94購01,0,0,0,0,0,0,0,0,0,-220000,0,0,0,20000,240000,-220000,-220000
052745,欣興元大96購04  ,0,0,0,0,0,0,0,0,0,-220000,0,0,0,5000,225000,-220000,-220000
056802,友達台新98購01  ,0,0,0,0,0,0,0,0,0,-221000,0,0,0,0,221000,-221000,-221000
055990,矽創元富97購01  ,0,0,0,0,0,0,0,0,0,-222000,0,0,0,20000,242000,-222000,-222000
056194,聯發科富邦9B購01,0,0,0,0,0,0,0,0,0,-223000,0,0,0,101000,324000,-223000,-223000
047285,鴻海統一95購02  ,0,0,0,0,0,0,0,0,0,-223000,0,0,0,12000,235000,-223000,-223000
2401,凌陽            ,84000,316000,-232000,0,0,0,0,0,0,9000,12000,3000,9000,0,0,0,-223000
4943,康控-KY         ,249000,426000,-177000,0,0,0,0,3000,-3000,-43000,0,0,0,5000,48000,-43000,-223000
055812,台積電國票99購02,0,0,0,0,0,0,0,0,0,-224000,0,0,0,103000,327000,-224000,-224000
056628,矽創永豐98購01  ,0,0,0,0,0,0,0,0,0,-224000,0,0,0,279000,503000,-224000,-224000
03412P,滬深2X群益98售01,0,0,0,0,0,0,0,0,0,-224000,0,0,0,163000,387000,-224000,-224000
053584,友達元大9B購02  ,0,0,0,0,0,0,0,0,0,-224000,0,0,0,50000,274000,-224000,-224000
2329,華泰            ,233000,423000,-190000,0,0,0,0,0,0,-34000,0,0,0,54000,88000,-34000,-224000
5469,瀚宇博          ,1044000,1170000,-126000,0,0,0,0,0,0,-98000,0,3000,-3000,11000,106000,-95000,-224000
056653,元石油元大98購01,0,0,0,0,0,0,0,0,0,-225000,0,0,0,0,225000,-225000,-225000
05529P,臺股指群益96售02,0,0,0,0,0,0,0,0,0,-225000,0,0,0,15000,240000,-225000,-225000
052832,益航群益96購01  ,0,0,0,0,0,0,0,0,0,-225000,0,0,0,115000,340000,-225000,-225000
052684,旺宏元大98購01  ,0,0,0,0,0,0,0,0,0,-225000,0,0,0,114000,339000,-225000,-225000
5534,長虹            ,18000,230000,-212000,0,0,0,0,15000,-15000,2000,2000,0,2000,0,0,0,-225000
06395P,台積電元大97售29,0,0,0,0,0,0,0,0,0,-225000,0,0,0,25000,250000,-225000,-225000
055164,矽創元大98購01  ,0,0,0,0,0,0,0,0,0,-226000,0,0,0,258000,484000,-226000,-226000
05609P,國泰金凱基96售01,0,0,0,0,0,0,0,0,0,-226000,0,0,0,0,226000,-226000,-226000
050755,和大元富94購01  ,0,0,0,0,0,0,0,0,0,-226000,0,0,0,40000,266000,-226000,-226000
050031,嘉澤元大95購01  ,0,0,0,0,0,0,0,0,0,-226000,0,0,0,274000,500000,-226000,-226000
053228,康友台新97購01  ,0,0,0,0,0,0,0,0,0,-226000,0,0,0,0,226000,-226000,-226000
6282,康舒            ,399000,528000,-129000,0,0,0,0,0,0,-97000,3000,1000,2000,7000,106000,-99000,-226000
050579,聯發科國票95購04,0,0,0,0,0,0,0,0,0,-229000,0,0,0,39000,268000,-229000,-229000
6288,聯嘉            ,114000,344000,-230000,0,0,0,0,0,0,1000,2000,1000,1000,0,0,0,-229000
043938,華邦電兆豐93購01,0,0,0,0,0,0,0,0,0,-230000,0,0,0,0,230000,-230000,-230000
049894,嘉聯益富邦98購01,0,0,0,0,0,0,0,0,0,-230000,0,0,0,20000,250000,-230000,-230000
049799,旺宏元大96購01  ,0,0,0,0,0,0,0,0,0,-230000,0,0,0,1000,231000,-230000,-230000
05364P,臺股指富邦95售04,0,0,0,0,0,0,0,0,0,-230000,0,0,0,100000,330000,-230000,-230000
053769,香港反元大99購01,0,0,0,0,0,0,0,0,0,-230000,0,0,0,0,230000,-230000,-230000
056077,矽力元大97購07  ,0,0,0,0,0,0,0,0,0,-231000,0,0,0,76000,307000,-231000,-231000
048959,凌華康和94購01  ,0,0,0,0,0,0,0,0,0,-231000,0,0,0,7000,238000,-231000,-231000
050624,鈺齊元大94購01  ,0,0,0,0,0,0,0,0,0,-231000,0,0,0,10000,241000,-231000,-231000
08525P,台灣50凱基96售02,0,0,0,0,0,0,0,0,0,-231000,0,0,0,0,231000,-231000,-231000
06211P,鴻海元大98售04  ,0,0,0,0,0,0,0,0,0,-231000,0,0,0,35000,266000,-231000,-231000
049241,智邦元富94購01  ,0,0,0,0,0,0,0,0,0,-233000,0,0,0,0,233000,-233000,-233000
042317,台灣50永豐96購01,0,0,0,0,0,0,0,0,0,-234000,0,0,0,33000,267000,-234000,-234000
05028P,康控永豐95售02  ,0,0,0,0,0,0,0,0,0,-234000,0,0,0,0,234000,-234000,-234000
052521,友達元大9B購01  ,0,0,0,0,0,0,0,0,0,-234000,0,0,0,7000,241000,-234000,-234000
1215,卜蜂            ,34000,252000,-218000,0,0,0,0,0,0,-16000,0,0,0,0,16000,-16000,-234000
056179,康友元富97購02  ,0,0,0,0,0,0,0,0,0,-235000,0,0,0,40000,275000,-235000,-235000
06216P,上銀元富97售03  ,0,0,0,0,0,0,0,0,0,-235000,0,0,0,51000,286000,-235000,-235000
056106,晶相光永豐97購02,0,0,0,0,0,0,0,0,0,-236000,0,0,0,0,236000,-236000,-236000
05700P,臻鼎凱基96售02  ,0,0,0,0,0,0,0,0,0,-236000,0,0,0,0,236000,-236000,-236000
052068,瑞儀兆豐96購01  ,0,0,0,0,0,0,0,0,0,-236000,0,0,0,21000,257000,-236000,-236000
05095P,景碩元大95售01  ,0,0,0,0,0,0,0,0,0,-237000,0,0,0,14000,251000,-237000,-237000
048667,旺宏永豐94購02  ,0,0,0,0,0,0,0,0,0,-237000,0,0,0,580000,817000,-237000,-237000
054122,康友永豐96購01  ,0,0,0,0,0,0,0,0,0,-237000,0,0,0,118000,355000,-237000,-237000
06387P,緯穎永豐97售02  ,0,0,0,0,0,0,0,0,0,-237000,0,0,0,0,237000,-237000,-237000
05760P,京鼎永豐96售02  ,0,0,0,0,0,0,0,0,0,-238000,0,0,0,30000,268000,-238000,-238000
05835P,臺股指元富96售07,0,0,0,0,0,0,0,0,0,-238000,0,0,0,157000,395000,-238000,-238000
05763P,致新永豐96售01  ,0,0,0,0,0,0,0,0,0,-240000,0,0,0,10000,250000,-240000,-240000
044863,矽創兆豐93購01  ,0,0,0,0,0,0,0,0,0,-240000,0,0,0,0,240000,-240000,-240000
050532,矽創元大94購03  ,0,0,0,0,0,0,0,0,0,-240000,0,0,0,55000,295000,-240000,-240000
00635U,元大S&P黃金     ,0,364000,-364000,0,0,0,0,0,0,123000,170000,0,170000,21000,68000,-47000,-241000
053686,台積電元大97購08,0,0,0,0,0,0,0,0,0,-241000,0,0,0,3000,244000,-241000,-241000
2363,矽統            ,279000,520000,-241000,0,0,0,0,0,0,0,0,0,0,0,0,0,-241000
053898,康友群益97購01  ,0,0,0,0,0,0,0,0,0,-242000,0,0,0,81000,323000,-242000,-242000
3380,明泰            ,207000,470000,-263000,0,0,0,0,0,0,21000,143000,70000,73000,0,52000,-52000,-242000
06249P,億光統一97售02  ,0,0,0,0,0,0,0,0,0,-242000,0,0,0,18000,260000,-242000,-242000
1304,台聚            ,167000,309000,-142000,0,0,0,0,0,0,-101000,0,101000,-101000,0,0,0,-243000
9935,慶豐富          ,62000,315000,-253000,0,0,0,0,0,0,10000,0,0,0,10000,0,10000,-243000
06046P,健策統一96售03  ,0,0,0,0,0,0,0,0,0,-244000,0,0,0,26000,270000,-244000,-244000
3518,柏騰            ,56000,301302,-245302,0,0,0,0,0,0,1000,1000,0,1000,0,0,0,-244302
2328,廣宇            ,73000,295000,-222000,0,0,0,0,0,0,-23000,4000,2000,2000,0,25000,-25000,-245000
049153,大立光元大96購02,0,0,0,0,0,0,0,0,0,-246000,0,0,0,20000,266000,-246000,-246000
05204P,TPK元大95售03   ,0,0,0,0,0,0,0,0,0,-246000,0,0,0,6000,252000,-246000,-246000
053984,康友元大96購05  ,0,0,0,0,0,0,0,0,0,-247000,0,0,0,96000,343000,-247000,-247000
03253P,台灣50國泰03售02,0,0,0,0,0,0,0,0,0,-248000,0,0,0,100000,348000,-248000,-248000
03183P,鴻海元大01售28  ,0,0,0,0,0,0,0,0,0,-250000,0,0,0,0,250000,-250000,-250000
050986,上証2X永昌97購01,0,0,0,0,0,0,0,0,0,-250000,0,0,0,0,250000,-250000,-250000
6191,精成科          ,257000,474000,-217000,0,0,0,0,0,0,-33000,0,2000,-2000,3000,34000,-31000,-250000
055446,奇力新統一9A購01,0,0,0,0,0,0,0,0,0,-251000,0,0,0,306000,557000,-251000,-251000
049216,華邦電國票95購01,0,0,0,0,0,0,0,0,0,-251000,0,0,0,0,251000,-251000,-251000
00752,中信中國50      ,0,0,0,0,0,0,0,0,0,-252000,0,0,0,664000,916000,-252000,-252000
2461,光群雷          ,110000,365000,-255000,0,0,0,0,0,0,3000,3000,0,3000,0,0,0,-252000
055902,同欣電中信99購01,0,0,0,0,0,0,0,0,0,-253000,0,0,0,204000,457000,-253000,-253000
051031,康友元富95購02  ,0,0,0,0,0,0,0,0,0,-254000,0,0,0,162000,416000,-254000,-254000
06272P,台郡凱基97售04  ,0,0,0,0,0,0,0,0,0,-254000,0,0,0,74000,328000,-254000,-254000
6196,帆宣            ,489000,661000,-172000,0,0,0,0,0,0,-83000,0,0,0,3000,86000,-83000,-255000
056390,台積電富邦9B購01,0,0,0,0,0,0,0,0,0,-256000,0,0,0,0,256000,-256000,-256000
04166P,美利達元富93售03,0,0,0,0,0,0,0,0,0,-257000,0,0,0,0,257000,-257000,-257000
05402P,台郡永豐95售02  ,0,0,0,0,0,0,0,0,0,-257000,0,0,0,0,257000,-257000,-257000
052092,貿聯元大96購02  ,0,0,0,0,0,0,0,0,0,-257000,0,0,0,48000,305000,-257000,-257000
052407,樺漢凱基95購01  ,0,0,0,0,0,0,0,0,0,-257000,0,0,0,0,257000,-257000,-257000
6176,瑞儀            ,487000,705000,-218000,0,0,0,0,36000,-36000,-3000,18000,28000,-10000,30000,23000,7000,-257000
2312,金寶            ,327000,507000,-180000,0,0,0,0,0,0,-77000,0,51000,-51000,94000,120000,-26000,-257000
054825,康友元大97購01  ,0,0,0,0,0,0,0,0,0,-259000,0,0,0,91000,350000,-259000,-259000
2392,正崴            ,307000,505000,-198000,0,0,0,0,0,0,-61000,4000,4000,0,5000,66000,-61000,-259000
06476P,臺股指永豐98售01,0,0,0,0,0,0,0,0,0,-259000,0,0,0,61000,320000,-259000,-259000
056271,嘉澤統一97購01  ,0,0,0,0,0,0,0,0,0,-260000,0,0,0,3000,263000,-260000,-260000
050707,寶成凱基94購02  ,0,0,0,0,0,0,0,0,0,-260000,0,0,0,0,260000,-260000,-260000
054532,強茂國泰98購01  ,0,0,0,0,0,0,0,0,0,-263000,0,0,0,128000,391000,-263000,-263000
049423,臺股指凱基95購02,0,0,0,0,0,0,0,0,0,-263000,0,0,0,55000,318000,-263000,-263000
051967,康友永豐95購02  ,0,0,0,0,0,0,0,0,0,-263000,0,0,0,0,263000,-263000,-263000
1717,長興            ,25000,288000,-263000,0,0,0,1000,0,1000,-1000,0,1000,-1000,0,0,0,-263000
3645,達邁            ,40000,298000,-258000,0,0,0,0,0,0,-5000,0,5000,-5000,0,0,0,-263000
056348,S&P反1元大9A購01,0,0,0,0,0,0,0,0,0,-264000,0,0,0,0,264000,-264000,-264000
047197,美律統一94購01  ,0,0,0,0,0,0,0,0,0,-264000,0,0,0,10000,274000,-264000,-264000
2820,華票            ,109000,373000,-264000,0,0,0,0,0,0,0,0,0,0,0,0,0,-264000
06379P,群創統一97售05  ,0,0,0,0,0,0,0,0,0,-264000,0,0,0,0,264000,-264000,-264000
051891,智邦元富95購04  ,0,0,0,0,0,0,0,0,0,-265000,0,0,0,0,265000,-265000,-265000
2355,敬鵬            ,117000,382000,-265000,0,0,0,0,0,0,0,0,0,0,0,0,0,-265000
05794P,華邦電群益96售04,0,0,0,0,0,0,0,0,0,-266000,0,0,0,0,266000,-266000,-266000
054702,智邦第一97購01  ,0,0,0,0,0,0,0,0,0,-267000,0,0,0,0,267000,-267000,-267000
051545,裕隆康和95購01  ,0,0,0,0,0,0,0,0,0,-267000,0,0,0,80000,347000,-267000,-267000
051989,華固元大95購02  ,0,0,0,0,0,0,0,0,0,-268000,0,0,0,0,268000,-268000,-268000
2107,厚生            ,30000,298000,-268000,0,0,0,0,0,0,0,0,0,0,0,0,0,-268000
06111P,上銀兆豐98售01  ,0,0,0,0,0,0,0,0,0,-268000,0,0,0,4000,272000,-268000,-268000
056487,康友元大98購01  ,0,0,0,0,0,0,0,0,0,-269000,0,0,0,160000,429000,-269000,-269000
03891P,晶技國泰94售02  ,0,0,0,0,0,0,0,0,0,-269000,0,0,0,0,269000,-269000,-269000
053986,矽創第一96購01  ,0,0,0,0,0,0,0,0,0,-269000,0,0,0,0,269000,-269000,-269000
054848,群創兆豐98購01  ,0,0,0,0,0,0,0,0,0,-270000,0,0,0,10000,280000,-270000,-270000
05139P,臺股指凱基95售06,0,0,0,0,0,0,0,0,0,-270000,0,0,0,120000,390000,-270000,-270000
2204,中華            ,33000,303000,-270000,0,0,0,0,0,0,0,0,0,0,0,0,0,-270000
3047,訊舟            ,9000,279000,-270000,0,0,0,0,0,0,0,0,0,0,0,0,0,-270000
048847,A50群益98購01   ,0,0,0,0,0,0,0,0,0,-271000,0,0,0,0,271000,-271000,-271000
06374P,台表科元大97售06,0,0,0,0,0,0,0,0,0,-271000,0,0,0,29000,300000,-271000,-271000
03852P,華邦電凱基93售05,0,0,0,0,0,0,0,0,0,-272000,0,0,0,6000,278000,-272000,-272000
2455,全新            ,357400,502000,-144600,0,0,0,42000,0,42000,-170000,39000,200000,-161000,4000,13000,-9000,-272600
055755,禾伸堂兆豐97購02,0,0,0,0,0,0,0,0,0,-275000,0,0,0,207000,482000,-275000,-275000
045449,嘉聯益國泰94購01,0,0,0,0,0,0,0,0,0,-276000,0,0,0,189000,465000,-276000,-276000
06001P,樺漢台新96售01  ,0,0,0,0,0,0,0,0,0,-276000,0,0,0,60000,336000,-276000,-276000
052770,聯茂群益96購02  ,0,0,0,0,0,0,0,0,0,-277000,0,0,0,184000,461000,-277000,-277000
048460,盛群凱基94購01  ,0,0,0,0,0,0,0,0,0,-278000,0,0,0,60000,338000,-278000,-278000
051139,康友永豐95購01  ,0,0,0,0,0,0,0,0,0,-278000,0,0,0,22000,300000,-278000,-278000
1101B,台泥乙特        ,0,282000,-282000,0,0,0,0,0,0,4000,4000,0,4000,0,0,0,-278000
056717,康友永豐98購01  ,0,0,0,0,0,0,0,0,0,-279000,0,0,0,66000,345000,-279000,-279000
055160,玉晶光元大99購03,0,0,0,0,0,0,0,0,0,-280000,0,0,0,53000,333000,-280000,-280000
05465P,台表科永豐95售03,0,0,0,0,0,0,0,0,0,-280000,0,0,0,0,280000,-280000,-280000
2351,順德            ,13000,284000,-271000,0,0,0,7000,0,7000,-17000,0,0,0,0,17000,-17000,-281000
9105,泰金寶-DR       ,635000,917000,-282000,0,0,0,0,0,0,0,0,0,0,0,0,0,-282000
051676,康舒元大95購01  ,0,0,0,0,0,0,0,0,0,-283000,0,0,0,273000,556000,-283000,-283000
048010,嘉聯益富邦97購01,0,0,0,0,0,0,0,0,0,-283000,0,0,0,0,283000,-283000,-283000
051938,旭富群益95購01  ,0,0,0,0,0,0,0,0,0,-284000,0,0,0,10000,294000,-284000,-284000
047885,元金2X富邦99購01,0,0,0,0,0,0,0,0,0,-285000,0,0,0,0,285000,-285000,-285000
055300,緯穎元大98購01  ,0,0,0,0,0,0,0,0,0,-286000,0,0,0,167000,453000,-286000,-286000
05076P,深中小群益99售02,0,0,0,0,0,0,0,0,0,-286000,0,0,0,20000,306000,-286000,-286000
052216,康友元大96購01  ,0,0,0,0,0,0,0,0,0,-286000,0,0,0,106000,392000,-286000,-286000
054522,康友元大96購07  ,0,0,0,0,0,0,0,0,0,-287000,0,0,0,163000,450000,-287000,-287000
04534P,臻鼎元富94售03  ,0,0,0,0,0,0,0,0,0,-287000,0,0,0,0,287000,-287000,-287000
3588,通嘉            ,94000,381000,-287000,0,0,0,0,0,0,0,0,0,0,0,0,0,-287000
006208,富邦台50        ,1000,0,1000,0,0,0,0,0,0,-289000,0,0,0,503000,792000,-289000,-288000
043973,元金2X元大94購02,0,0,0,0,0,0,0,0,0,-290000,0,0,0,0,290000,-290000,-290000
2404,漢唐            ,60020,284000,-223980,0,0,0,0,0,0,-69000,1000,2000,-1000,18000,86000,-68000,-292980
2208,台船            ,30000,323000,-293000,0,0,0,0,0,0,-1000,0,1000,-1000,0,0,0,-294000
047904,臺指反元大96購01,0,0,0,0,0,0,0,0,0,-295000,0,0,0,0,295000,-295000,-295000
04616P,臺股指群益95售02,0,0,0,0,0,0,0,0,0,-295000,0,0,0,0,295000,-295000,-295000
051840,康友國泰97購02  ,0,0,0,0,0,0,0,0,0,-295000,0,0,0,555000,850000,-295000,-295000
05509P,智邦元富96售02  ,0,0,0,0,0,0,0,0,0,-296000,0,0,0,10000,306000,-296000,-296000
046396,矽創國泰93購01  ,0,0,0,0,0,0,0,0,0,-298000,0,0,0,101000,399000,-298000,-298000
048704,台表科國票95購01,0,0,0,0,0,0,0,0,0,-299000,0,0,0,15000,314000,-299000,-299000
4967,十銓            ,471000,760000,-289000,0,0,0,0,0,0,-10000,13000,23000,-10000,0,0,0,-299000
8150,南茂            ,985000,1235000,-250000,0,0,0,0,0,0,-49000,0,0,0,24000,73000,-49000,-299000
04404P,玉晶光國票94售01,0,0,0,0,0,0,0,0,0,-300000,0,0,0,0,300000,-300000,-300000
04395P,台積電群益94售06,0,0,0,0,0,0,0,0,0,-300000,0,0,0,0,300000,-300000,-300000
00646,元大S&P500      ,0,53000,-53000,0,0,0,0,0,0,-247000,0,0,0,3000,250000,-247000,-300000
04615P,華新科群益94售03,0,0,0,0,0,0,0,0,0,-300000,0,0,0,0,300000,-300000,-300000
047972,康控富邦95購01  ,0,0,0,0,0,0,0,0,0,-300000,0,0,0,0,300000,-300000,-300000
053946,全新富邦97購02  ,0,0,0,0,0,0,0,0,0,-300000,0,0,0,0,300000,-300000,-300000
055275,台積電元大97購19,0,0,0,0,0,0,0,0,0,-301000,0,0,0,284000,585000,-301000,-301000
2106,建大            ,9000,309000,-300000,0,0,0,0,0,0,-1000,0,1000,-1000,0,0,0,-301000
1527,鑽全            ,40000,341313,-301313,0,0,0,0,0,0,0,0,0,0,0,0,0,-301313
054146,康友元大96購06  ,0,0,0,0,0,0,0,0,0,-302000,0,0,0,68000,370000,-302000,-302000
06405P,億光元富97售02  ,0,0,0,0,0,0,0,0,0,-302000,0,0,0,119000,421000,-302000,-302000
2371,大同            ,1349000,1593000,-244000,0,0,0,0,0,0,-59000,22000,81000,-59000,0,0,0,-303000
06496P,台灣50日盛98售01,0,0,0,0,0,0,0,0,0,-305000,0,0,0,98000,403000,-305000,-305000
054801,康友群益97購02  ,0,0,0,0,0,0,0,0,0,-306000,0,0,0,190000,496000,-306000,-306000
04159P,滬深2X中信95售08,0,0,0,0,0,0,0,0,0,-306000,0,0,0,0,306000,-306000,-306000
05078P,義隆永豐95售01  ,0,0,0,0,0,0,0,0,0,-306000,0,0,0,0,306000,-306000,-306000
055072,康友永豐97購02  ,0,0,0,0,0,0,0,0,0,-307000,0,0,0,0,307000,-307000,-307000
051639,康友國票96購02  ,0,0,0,0,0,0,0,0,0,-307000,0,0,0,174000,481000,-307000,-307000
1589,永冠-KY         ,23000,299000,-276000,0,0,0,0,0,0,-33000,0,2000,-2000,0,31000,-31000,-309000
051391,聯發科兆豐95購02,0,0,0,0,0,0,0,0,0,-310000,0,0,0,0,310000,-310000,-310000
2464,盟立            ,12000,322000,-310000,0,0,0,0,0,0,0,0,0,0,0,0,0,-310000
051187,晶相光永豐95購01,0,0,0,0,0,0,0,0,0,-311000,0,0,0,10000,321000,-311000,-311000
052148,康友群益95購03  ,0,0,0,0,0,0,0,0,0,-312000,0,0,0,60000,372000,-312000,-312000
6443,元晶            ,14000,327000,-313000,0,0,0,0,0,0,0,0,0,0,0,0,0,-313000
051889,智邦元富95購02  ,0,0,0,0,0,0,0,0,0,-314000,0,0,0,213000,527000,-314000,-314000
3023,信邦            ,109000,476000,-367000,0,0,0,40000,0,40000,13000,53000,0,53000,0,40000,-40000,-314000
055413,全新富邦98購01  ,0,0,0,0,0,0,0,0,0,-315000,0,0,0,0,315000,-315000,-315000
050559,聯發科統一94購10,0,0,0,0,0,0,0,0,0,-315000,0,0,0,0,315000,-315000,-315000
052585,友達永豐97購01  ,0,0,0,0,0,0,0,0,0,-316000,0,0,0,12000,328000,-316000,-316000
055152,旺宏元大98購04  ,0,0,0,0,0,0,0,0,0,-317000,0,0,0,599000,916000,-317000,-317000
1802,台玻            ,62000,377000,-315000,0,0,0,0,0,0,-2000,0,2000,-2000,0,0,0,-317000
045572,元油2X元大98購01,0,0,0,0,0,0,0,0,0,-318000,0,0,0,0,318000,-318000,-318000
1795,美時            ,327000,129000,198000,0,0,0,0,516000,-516000,0,0,0,0,0,0,0,-318000
04051P,友達中信94售02  ,0,0,0,0,0,0,0,0,0,-320000,0,0,0,0,320000,-320000,-320000
051367,可成富邦97購01  ,0,0,0,0,0,0,0,0,0,-320000,0,0,0,10000,330000,-320000,-320000
048628,T50反1元大96購03,0,0,0,0,0,0,0,0,0,-320000,0,0,0,245000,565000,-320000,-320000
051983,道瓊反元大95購01,0,0,0,0,0,0,0,0,0,-320000,0,0,0,110000,430000,-320000,-320000
2637,慧洋-KY         ,321000,1033000,-712000,0,0,0,1000,0,1000,391000,450000,0,450000,0,59000,-59000,-320000
2402,毅嘉            ,60000,383000,-323000,0,0,0,0,0,0,0,0,0,0,0,0,0,-323000
055010,佐登元富97購01  ,0,0,0,0,0,0,0,0,0,-325000,0,0,0,165000,490000,-325000,-325000
055855,牧德元大99購02  ,0,0,0,0,0,0,0,0,0,-325000,0,0,0,82000,407000,-325000,-325000
04198P,滬深2X群益95售04,0,0,0,0,0,0,0,0,0,-325000,0,0,0,135000,460000,-325000,-325000
053724,聯詠凱基96購04  ,0,0,0,0,0,0,0,0,0,-326000,0,0,0,99000,425000,-326000,-326000
052254,康友永豐95購03  ,0,0,0,0,0,0,0,0,0,-327000,0,0,0,142000,469000,-327000,-327000
2451,創見            ,466000,827000,-361000,0,0,0,0,0,0,34000,1000,0,1000,36000,3000,33000,-327000
4968,立積            ,245000,572000,-327000,0,0,0,0,0,0,0,0,0,0,0,0,0,-327000
054914,億光凱基98購01  ,0,0,0,0,0,0,0,0,0,-330000,0,0,0,0,330000,-330000,-330000
054543,元金2X中信01購01,0,0,0,0,0,0,0,0,0,-330000,0,0,0,0,330000,-330000,-330000
052695,台表科中信98購01,0,0,0,0,0,0,0,0,0,-331000,0,0,0,0,331000,-331000,-331000
5264,鎧勝-KY         ,131000,436000,-305000,0,0,0,0,0,0,-26000,0,0,0,2000,28000,-26000,-331000
054980,國巨元富97購01  ,0,230000,-230000,0,0,0,0,0,0,-103000,0,0,0,363000,466000,-103000,-333000
05053P,新日興群益95售01,0,0,0,0,0,0,0,0,0,-333000,0,0,0,100000,433000,-333000,-333000
053925,群創國票98購01  ,0,0,0,0,0,0,0,0,0,-333000,0,0,0,303000,636000,-333000,-333000
048626,矽創台新93購01  ,0,0,0,0,0,0,0,0,0,-334000,0,0,0,38000,372000,-334000,-334000
05414P,台表科國票96售02,0,0,0,0,0,0,0,0,0,-339000,0,0,0,0,339000,-339000,-339000
2108,南帝            ,9000,348000,-339000,0,0,0,0,0,0,0,0,0,0,0,0,0,-339000
04603P,訊芯凱基94售03  ,0,0,0,0,0,0,0,0,0,-341000,0,0,0,514000,855000,-341000,-341000
05724P,致茂永豐96售01  ,0,0,0,0,0,0,0,0,0,-343000,0,0,0,0,343000,-343000,-343000
05987P,健策統一96售02  ,0,0,0,0,0,0,0,0,0,-344000,0,0,0,22000,366000,-344000,-344000
053122,美律凱基98購01  ,0,0,0,0,0,0,0,0,0,-345000,0,0,0,61000,406000,-345000,-345000
051944,智邦統一95購02  ,0,0,0,0,0,0,0,0,0,-345000,0,0,0,0,345000,-345000,-345000
056248,康友群益97購04  ,0,0,0,0,0,0,0,0,0,-346000,0,0,0,294000,640000,-346000,-346000
055277,旺宏元大97購04  ,0,0,0,0,0,0,0,0,0,-346000,0,0,0,332000,678000,-346000,-346000
2369,菱生            ,36000,383000,-347000,0,0,0,0,0,0,0,0,0,0,0,0,0,-347000
05766P,A50正2凱基99售01,0,0,0,0,0,0,0,0,0,-348000,0,0,0,47000,395000,-348000,-348000
00665L,富邦恒生國企正2 ,1000,271000,-270000,0,0,0,0,0,0,-78000,0,0,0,84000,162000,-78000,-348000
054853,TPK國票98購02   ,0,0,0,0,0,0,0,0,0,-350000,0,0,0,0,350000,-350000,-350000
04011P,台積電元大93售22,0,0,0,0,0,0,0,0,0,-350000,0,0,0,0,350000,-350000,-350000
049736,宏達電群益95購03,0,0,0,0,0,0,0,0,0,-350000,0,0,0,0,350000,-350000,-350000
052324,康友元大96購02  ,0,0,0,0,0,0,0,0,0,-350000,0,0,0,262000,612000,-350000,-350000
052545,康控元富95購02  ,0,0,0,0,0,0,0,0,0,-350000,0,0,0,0,350000,-350000,-350000
3704,合勤控          ,210000,563000,-353000,0,0,0,0,0,0,3000,3000,0,3000,0,0,0,-350000
056188,晶相光統一99購01,0,0,0,0,0,0,0,0,0,-351000,0,0,0,0,351000,-351000,-351000
055851,智原元大98購01  ,0,0,0,0,0,0,0,0,0,-351000,0,0,0,0,351000,-351000,-351000
1710,東聯            ,73000,425000,-352000,0,0,0,0,0,0,-1000,0,1000,-1000,0,0,0,-353000
051277,聯發科中信9A購01,0,0,0,0,0,0,0,0,0,-355000,0,0,0,0,355000,-355000,-355000
3596,智易            ,131000,438000,-307000,0,0,0,0,0,0,-49000,19000,7000,12000,5000,66000,-61000,-356000
6230,超眾            ,83000,288000,-205000,0,0,0,15000,0,15000,-166000,0,20000,-20000,0,146000,-146000,-356000
053799,矽創中信9A購01  ,0,0,0,0,0,0,0,0,0,-359000,0,0,0,0,359000,-359000,-359000
5519,隆大            ,34000,393000,-359000,0,0,0,0,0,0,0,0,0,0,0,0,0,-359000
1313,聯成            ,128000,486000,-358000,0,0,0,0,0,0,-1000,0,1000,-1000,0,0,0,-359000
052114,華固中信95購01  ,0,0,0,0,0,0,0,0,0,-360000,0,0,0,0,360000,-360000,-360000
052115,T50反1國票95購03,0,0,0,0,0,0,0,0,0,-360000,0,0,0,146000,506000,-360000,-360000
06508P,台灣50統一98售01,0,0,0,0,0,0,0,0,0,-360000,0,0,0,68000,428000,-360000,-360000
053998,泰鼎群益98購01  ,0,0,0,0,0,0,0,0,0,-361000,0,0,0,297000,658000,-361000,-361000
2609,陽明            ,78000,439000,-361000,0,0,0,0,0,0,0,0,0,0,0,0,0,-361000
055944,日月光麥證97購01,0,0,0,51000,400000,-349000,0,0,0,-364000,0,0,0,51000,415000,-364000,-364000
05749P,臺股指群益99售03,0,0,0,0,0,0,0,0,0,-364000,0,0,0,7000,371000,-364000,-364000
055685,日月光凱基97購02,0,0,0,0,0,0,0,0,0,-364000,0,0,0,166000,530000,-364000,-364000
1477,聚陽            ,139000,512195,-373195,0,0,0,0,0,0,8000,8000,0,8000,0,0,0,-365195
053157,日月光元大96購03,0,0,0,0,0,0,0,0,0,-367000,0,0,0,34000,401000,-367000,-367000
3702,大聯大          ,220000,961000,-741000,0,0,0,1000,0,1000,373000,316000,23000,293000,85000,5000,80000,-367000
041991,元油2X國票98購01,0,0,0,0,0,0,0,0,0,-369000,0,0,0,55000,424000,-369000,-369000
049325,智邦元富94購02  ,0,0,0,0,0,0,0,0,0,-369000,0,0,0,80000,449000,-369000,-369000
2915,潤泰全          ,221000,610000,-389000,0,0,0,0,0,0,20000,0,1000,-1000,43000,22000,21000,-369000
055224,鴻海國票99購02  ,0,0,0,0,0,0,0,0,0,-370000,0,0,0,20000,390000,-370000,-370000
047206,元金2X國泰94購01,0,0,0,0,0,0,0,0,0,-370000,0,0,0,20000,390000,-370000,-370000
1319,東陽            ,39000,376000,-337000,0,0,0,0,0,0,-33000,2000,1000,1000,0,34000,-34000,-370000
04363P,儒鴻元富94售01  ,0,0,0,0,0,0,0,0,0,-371000,0,0,0,108000,479000,-371000,-371000
8213,志超            ,79000,437000,-358000,0,0,0,0,0,0,-14000,0,13000,-13000,0,1000,-1000,-372000
045861,智邦統一93購02  ,0,0,0,0,0,0,0,0,0,-373000,0,0,0,231000,604000,-373000,-373000
8081,致新            ,112000,390000,-278000,0,0,0,33000,0,33000,-128000,5000,0,5000,1000,134000,-133000,-373000
04295P,智邦元大93售10  ,0,0,0,0,0,0,0,0,0,-374000,0,0,0,0,374000,-374000,-374000
03413B,臺股指凱基94熊19,0,0,0,0,0,0,0,0,0,-377000,0,0,0,1381000,1758000,-377000,-377000
1210,大成            ,94000,518000,-424000,0,0,0,0,0,0,47000,47000,0,47000,0,0,0,-377000
052914,奇力新元富96購01,0,0,0,0,0,0,0,0,0,-379000,0,0,0,260000,639000,-379000,-379000
045994,康控富邦94購01  ,0,0,0,0,0,0,0,0,0,-380000,0,0,0,60000,440000,-380000,-380000
053717,聯發科凱基96購17,0,0,0,0,0,0,0,0,0,-380000,0,0,0,0,380000,-380000,-380000
2031,新光鋼          ,246000,511000,-265000,0,0,0,0,100000,-100000,-15000,20000,35000,-15000,0,0,0,-380000
00641R,富邦日本反1     ,0,456000,-456000,0,0,0,0,0,0,75000,0,0,0,372000,297000,75000,-381000
3413,京鼎            ,54000,281000,-227000,0,0,0,0,0,0,-154000,3000,20000,-17000,2000,139000,-137000,-381000
05180P,玉晶光凱基95售04,0,0,0,0,0,0,0,0,0,-384000,0,0,0,150000,534000,-384000,-384000
4977,眾達-KY         ,109000,522000,-413000,0,0,0,0,0,0,28000,93000,65000,28000,0,0,0,-385000
06151P,華新科元大97售07,0,0,0,0,0,0,0,0,0,-385000,0,0,0,231000,616000,-385000,-385000
050462,寶成元大94購01  ,0,0,0,0,0,0,0,0,0,-389000,0,0,0,130000,519000,-389000,-389000
053263,華邦電群益96購03,0,0,0,0,0,0,0,0,0,-389000,0,0,0,0,389000,-389000,-389000
5388,中磊            ,397000,760000,-363000,0,0,0,0,2000,-2000,-24000,0,21000,-21000,0,3000,-3000,-389000
06019P,緯穎凱基96售03  ,0,0,0,0,0,0,0,0,0,-390000,0,0,0,0,390000,-390000,-390000
05566P,景碩永豐96售01  ,0,0,0,0,0,0,0,0,0,-391000,0,0,0,10000,401000,-391000,-391000
045472,嘉聯益元大93購02,0,0,0,0,0,0,0,0,0,-391000,0,0,0,0,391000,-391000,-391000
048627,T50反1元大96購02,0,0,0,0,0,0,0,0,0,-395000,0,0,0,460000,855000,-395000,-395000
05928P,華邦電康和96售01,0,0,0,0,0,0,0,0,0,-396000,0,0,0,0,396000,-396000,-396000
046863,康友元大93購01  ,0,0,0,0,0,0,0,0,0,-397000,0,0,0,0,397000,-397000,-397000
044814,華邦電兆豐93購02,0,0,0,0,0,0,0,0,0,-400000,0,0,0,20000,420000,-400000,-400000
047483,新光金凱基99購04,0,0,0,0,0,0,0,0,0,-400000,0,0,0,0,400000,-400000,-400000
050883,嘉聯益國泰96購01,0,0,0,0,0,0,0,0,0,-400000,0,0,0,0,400000,-400000,-400000
052425,華通台新95購02  ,0,0,0,0,0,0,0,0,0,-400000,0,0,0,0,400000,-400000,-400000
2498,宏達電          ,467000,685000,-218000,0,0,0,0,0,0,-182000,40000,43000,-3000,12000,191000,-179000,-400000
9939,宏全            ,54000,406000,-352000,0,0,0,0,0,0,-48000,6000,2000,4000,21000,73000,-52000,-400000
05201P,玉晶光國泰97售02,0,0,0,0,0,0,0,0,0,-401000,0,0,0,202000,603000,-401000,-401000
06422P,勤誠統一98售01  ,0,0,0,0,0,0,0,0,0,-403000,0,0,0,275000,678000,-403000,-403000
049282,易華電國票95購01,0,0,0,0,0,0,0,0,0,-405000,0,0,0,0,405000,-405000,-405000
052935,康友元大96購03  ,0,0,0,0,0,0,0,0,0,-406000,0,0,0,372000,778000,-406000,-406000
1522,堤維西          ,38000,438000,-400000,0,0,0,0,0,0,-6000,0,4000,-4000,0,2000,-2000,-406000
05662P,景碩元富96售01  ,0,0,0,0,0,0,0,0,0,-407000,0,0,0,88000,495000,-407000,-407000
053820,大立光群益96購05,0,0,0,0,0,0,0,0,0,-407000,0,0,0,30000,437000,-407000,-407000
051235,鴻海元大95購06  ,0,0,0,0,0,0,0,0,0,-408000,0,0,0,0,408000,-408000,-408000
051890,智邦元富95購03  ,0,0,0,0,0,0,0,0,0,-408000,0,0,0,0,408000,-408000,-408000
054497,國巨永豐96購05  ,0,0,0,0,0,0,0,0,0,-410000,0,0,0,0,410000,-410000,-410000
054802,高股息元大97購01,0,0,0,0,0,0,0,0,0,-410000,0,0,0,0,410000,-410000,-410000
047431,儒鴻元大93購06  ,0,0,0,0,0,0,0,0,0,-410000,0,0,0,0,410000,-410000,-410000
06152P,玉晶光元大98售06,0,0,0,0,0,0,0,0,0,-410000,0,0,0,68000,478000,-410000,-410000
6706,惠特            ,24000,363000,-339000,0,0,0,20000,147000,-127000,55000,55000,0,55000,0,0,0,-411000
05279P,上銀元大95售02  ,0,0,0,0,0,0,0,0,0,-413000,0,0,0,50000,463000,-413000,-413000
00648R,元大S&P500反1   ,0,0,0,0,0,0,0,0,0,-414000,0,0,0,26000,440000,-414000,-414000
051384,康友群益95購01  ,0,0,0,0,0,0,0,0,0,-416000,0,0,0,111000,527000,-416000,-416000
9103,美德醫療-DR     ,164000,581000,-417000,0,0,0,0,0,0,0,0,0,0,0,0,0,-417000
054685,國巨永豐97購02  ,0,0,0,0,0,0,0,0,0,-418000,0,0,0,26000,444000,-418000,-418000
053734,友達中信98購02  ,0,0,0,0,0,0,0,0,0,-419000,0,0,0,424000,843000,-419000,-419000
043457,鴻海元大93購01  ,0,0,0,0,0,0,0,0,0,-420000,0,0,0,30000,450000,-420000,-420000
047852,矽創元富93購01  ,0,0,0,0,0,0,0,0,0,-420000,0,0,0,0,420000,-420000,-420000
053357,可成統一96購02  ,0,0,0,0,0,0,0,0,0,-420000,0,0,0,50000,470000,-420000,-420000
051863,技嘉凱基95購01  ,0,0,0,0,0,0,0,0,0,-420000,0,0,0,14000,434000,-420000,-420000
06198P,台積電元大98售06,0,0,0,0,0,0,0,0,0,-421000,0,0,0,198000,619000,-421000,-421000
055316,上銀國票98購01  ,0,0,0,0,0,0,0,0,0,-423000,0,0,0,136000,559000,-423000,-423000
050899,旭富元大95購01  ,0,0,0,0,0,0,0,0,0,-423000,0,0,0,95000,518000,-423000,-423000
04146P,可成凱基93售14  ,0,0,0,0,0,0,0,0,0,-425000,0,0,0,27000,452000,-425000,-425000
06222P,致茂元富97售02  ,0,0,0,0,0,0,0,0,0,-425000,0,0,0,45000,470000,-425000,-425000
06080P,景碩群益98售02  ,0,0,0,0,0,0,0,0,0,-427000,0,0,0,31000,458000,-427000,-427000
06376P,上銀統一99售01  ,0,0,0,0,0,0,0,0,0,-427000,0,0,0,100000,527000,-427000,-427000
03438P,群創群益98售03  ,0,0,0,0,0,0,0,0,0,-429000,0,0,0,0,429000,-429000,-429000
045662,華邦電統一94購02,0,0,0,0,0,0,0,0,0,-431000,0,0,0,0,431000,-431000,-431000
05056P,訊芯群益95售01  ,0,0,0,0,0,0,0,0,0,-432000,0,0,0,409000,841000,-432000,-432000
2338,光罩            ,780000,743000,37000,0,0,0,0,0,0,-469000,0,3000,-3000,9000,475000,-466000,-432000
2905,三商            ,33000,466000,-433000,0,0,0,0,0,0,0,0,0,0,0,0,0,-433000
06339P,上銀統一97售06  ,0,0,0,0,0,0,0,0,0,-436000,0,0,0,32000,468000,-436000,-436000
050714,深中小群益98購01,0,0,0,0,0,0,0,0,0,-438000,0,0,0,122000,560000,-438000,-438000
052225,台積電凱基96購03,0,0,0,0,0,0,0,0,0,-439000,0,0,0,0,439000,-439000,-439000
6451,訊芯-KY         ,97000,297000,-200000,0,0,0,0,112000,-112000,-129000,6000,1000,5000,3000,137000,-134000,-441000
9958,世紀鋼          ,116000,181000,-65000,0,0,0,20000,200000,-180000,-198000,20000,0,20000,8000,226000,-218000,-443000
1515,力山            ,154000,573000,-419000,0,0,0,0,0,0,-26000,0,0,0,1000,27000,-26000,-445000
056210,矽創永豐97購02  ,0,0,0,0,0,0,0,0,0,-449000,0,0,0,123000,572000,-449000,-449000
048288,T50反1群益93購05,0,0,0,0,0,0,0,0,0,-450000,0,0,0,0,450000,-450000,-450000
05290P,國巨永豐95售04  ,0,0,0,0,0,0,0,0,0,-450000,0,0,0,0,450000,-450000,-450000
054001,康友群益96購02  ,0,0,0,0,0,0,0,0,0,-450000,0,0,0,41000,491000,-450000,-450000
06454P,緯穎元大98售04  ,0,0,0,0,0,0,0,0,0,-450000,0,0,0,0,450000,-450000,-450000
055263,華新科富邦9A購01,0,0,0,0,0,0,0,0,0,-452000,0,0,0,361000,813000,-452000,-452000
051457,寶成元大95購01  ,0,0,0,0,0,0,0,0,0,-453000,0,0,0,46000,499000,-453000,-453000
1229,聯華            ,304000,757100,-453100,0,0,0,0,0,0,0,0,0,0,0,0,0,-453100
054727,台積電日盛97購02,0,0,0,0,0,0,0,0,0,-454000,0,0,0,186000,640000,-454000,-454000
06012P,世芯國票96售01  ,0,0,0,0,0,0,0,0,0,-454000,0,0,0,146000,600000,-454000,-454000
2308,台達電          ,2480687,1906000,574687,0,0,0,2000,900000,-898000,-134000,34000,68000,-34000,8000,108000,-100000,-457313
055863,緯穎元大97購05  ,0,0,0,0,0,0,0,0,0,-461000,0,0,0,377000,838000,-461000,-461000
055056,億光永豐97購01  ,0,0,0,0,0,0,0,0,0,-462000,0,0,0,1000,463000,-462000,-462000
3036,文曄            ,136000,671000,-535000,0,0,0,0,0,0,72000,64000,0,64000,34000,26000,8000,-463000
051258,鈺齊國泰97購01  ,0,0,0,0,0,0,0,0,0,-467000,0,0,0,3000,470000,-467000,-467000
054670,康友元富97購01  ,0,0,0,0,0,0,0,0,0,-468000,0,0,0,67000,535000,-468000,-468000
049759,元黃金富邦9A購01,0,0,0,0,0,0,0,0,0,-470000,0,0,0,0,470000,-470000,-470000
3338,泰碩            ,140000,561000,-421000,0,0,0,10000,0,10000,-59000,58000,47000,11000,0,70000,-70000,-470000
052284,日月光凱基96購01,0,0,0,0,0,0,0,0,0,-472000,0,0,0,61000,533000,-472000,-472000
05450P,臺股指元大95售27,0,0,0,0,0,0,0,0,0,-473000,0,0,0,70000,543000,-473000,-473000
04049P,大立光元大95售02,0,0,0,0,0,0,0,0,0,-473000,0,0,0,151000,624000,-473000,-473000
052953,百和國票97購01  ,0,0,0,0,0,0,0,0,0,-475000,0,0,0,62000,537000,-475000,-475000
053650,華邦電凱基98購01,0,0,0,0,0,0,0,0,0,-478000,0,0,0,0,478000,-478000,-478000
3056,總太            ,104000,567000,-463000,0,0,0,0,0,0,-15000,0,15000,-15000,0,0,0,-478000
050172,臺指反元大98購02,0,0,0,0,0,0,0,0,0,-482000,0,0,0,516000,998000,-482000,-482000
053244,光磊國票97購01  ,0,0,0,0,0,0,0,0,0,-482000,0,0,0,1624000,2106000,-482000,-482000
049355,元油2X富邦96購04,0,0,0,0,0,0,0,0,0,-483000,0,0,0,5000,488000,-483000,-483000
054067,百和國票97購03  ,0,0,0,0,0,0,0,0,0,-483000,0,0,0,26000,509000,-483000,-483000
05247P,上銀群益95售01  ,0,0,0,0,0,0,0,0,0,-483000,0,0,0,0,483000,-483000,-483000
051501,康友群益95購02  ,0,0,0,0,0,0,0,0,0,-484000,0,0,0,122000,606000,-484000,-484000
2601,益航            ,284000,754000,-470000,0,0,0,0,0,0,-15000,0,0,0,0,15000,-15000,-485000
047681,滬深反中信95購01,0,0,0,0,0,0,0,0,0,-487000,0,0,0,226000,713000,-487000,-487000
051429,智邦元富95購01  ,0,0,0,0,0,0,0,0,0,-488000,0,0,0,72000,560000,-488000,-488000
054572,國巨元大98購03  ,0,0,0,0,0,0,0,0,0,-491000,0,0,0,97000,588000,-491000,-491000
04834P,鴻海元大94售17  ,0,0,0,0,0,0,0,0,0,-492000,0,0,0,14000,506000,-492000,-492000
056350,上銀元大98購02  ,0,0,0,0,0,0,0,0,0,-494000,0,0,0,59000,553000,-494000,-494000
1309,台達化          ,34000,528000,-494000,0,0,0,0,0,0,0,0,0,0,0,0,0,-494000
056660,臺股指元大9A購07,0,0,0,0,0,0,0,0,0,-495000,0,0,0,0,495000,-495000,-495000
054726,台積電日盛97購01,0,0,0,0,0,0,0,0,0,-495000,0,0,0,400000,895000,-495000,-495000
04496P,國巨國泰96售02  ,0,0,0,0,0,0,0,0,0,-496000,0,0,0,0,496000,-496000,-496000
051462,世芯國泰97購01  ,0,0,0,0,0,0,0,0,0,-496000,0,0,0,115000,611000,-496000,-496000
05487P,台表科凱基95售02,0,0,0,0,0,0,0,0,0,-497000,0,0,0,50000,547000,-497000,-497000
05612P,台積電元大96售13,0,0,0,0,0,0,0,0,0,-499000,0,0,0,0,499000,-499000,-499000
045410,華邦電群益94購01,0,0,0,0,0,0,0,0,0,-499000,0,0,0,0,499000,-499000,-499000
053572,彩晶統一96購01  ,0,0,0,0,0,0,0,0,0,-499000,0,0,0,0,499000,-499000,-499000
053747,滬深2X永豐96購05,0,0,0,0,0,0,0,0,0,-499000,0,0,0,0,499000,-499000,-499000
050914,健鼎中信95購01  ,0,0,0,0,0,0,0,0,0,-500000,0,0,0,0,500000,-500000,-500000
04808P,訊芯永豐94售02  ,0,0,0,0,0,0,0,0,0,-505000,0,0,0,95000,600000,-505000,-505000
054056,華新科國票96購02,0,0,0,0,0,0,0,0,0,-505000,0,0,0,0,505000,-505000,-505000
2515,中工            ,238000,688000,-450000,0,0,0,0,0,0,-55000,0,0,0,0,55000,-55000,-505000
050192,康控元大97購01  ,0,0,0,0,0,0,0,0,0,-507000,0,0,0,22000,529000,-507000,-507000
051732,華通國票97購01  ,0,0,0,0,0,0,0,0,0,-508000,0,0,0,0,508000,-508000,-508000
052001,寶成元大95購02  ,0,0,0,0,0,0,0,0,0,-508000,0,0,0,41000,549000,-508000,-508000
045618,元油2X永豐98購01,0,0,0,0,0,0,0,0,0,-510000,0,0,0,30000,540000,-510000,-510000
050568,為升中信97購01  ,0,0,0,0,0,0,0,0,0,-510000,0,0,0,100000,610000,-510000,-510000
053763,T50反1富邦98購01,0,0,0,0,0,0,0,0,0,-511000,0,0,0,533000,1044000,-511000,-511000
056713,華擎永豐98購01  ,0,0,0,0,0,0,0,0,0,-514000,0,0,0,300000,814000,-514000,-514000
048395,南亞科國票93購02,0,0,0,0,0,0,0,0,0,-514000,0,0,0,35000,549000,-514000,-514000
049007,玉晶光中信96購01,0,0,0,0,0,0,0,0,0,-516000,0,0,0,53000,569000,-516000,-516000
6416,瑞祺電通        ,82000,628000,-546000,0,0,0,0,35000,-35000,62000,64000,6000,58000,4000,0,4000,-519000
05261P,鴻海元大95售20  ,0,0,0,0,0,0,0,0,0,-520000,0,0,0,509000,1029000,-520000,-520000
5607,遠雄港          ,20000,542000,-522000,0,0,0,0,0,0,-1000,0,1000,-1000,0,0,0,-523000
1722,台肥            ,120000,634000,-514000,0,0,0,1000,0,1000,-10000,0,1000,-1000,12000,21000,-9000,-523000
9910,豐泰            ,917000,1316500,-399500,0,0,0,1000,128000,-127000,0,0,0,0,0,0,0,-526500
052733,台郡國泰97購01  ,0,0,0,0,0,0,0,0,0,-527000,0,0,0,52000,579000,-527000,-527000
056204,嘉澤永豐97購01  ,0,0,0,0,0,0,0,0,0,-530000,0,0,0,52000,582000,-530000,-530000
054821,貿聯元大9A購01  ,0,0,0,0,0,0,0,0,0,-530000,0,0,0,155000,685000,-530000,-530000
051843,聯發科富邦99購01,0,0,0,0,0,0,0,0,0,-531000,0,0,0,1118000,1649000,-531000,-531000
2492,華新科          ,1318000,1948000,-630000,0,0,0,0,0,0,97000,219000,132000,87000,103000,93000,10000,-533000
053850,嘉澤元富96購03  ,0,0,0,0,0,0,0,0,0,-534000,0,0,0,152000,686000,-534000,-534000
2426,鼎元            ,130000,663000,-533000,0,0,0,0,0,0,-1000,0,1000,-1000,0,0,0,-534000
04532P,臺股指凱基94售04,0,0,0,0,0,0,0,0,0,-535000,0,0,0,30000,565000,-535000,-535000
054682,東元永豐97購01  ,0,0,0,0,0,0,0,0,0,-540000,0,0,0,0,540000,-540000,-540000
8112,至上            ,197000,745000,-548000,0,0,0,0,0,0,8000,8000,0,8000,0,0,0,-540000
052314,鴻海元大96購11  ,0,0,0,0,0,0,0,0,0,-541000,0,0,0,69000,610000,-541000,-541000
052079,康友元富98購01  ,0,0,0,0,0,0,0,0,0,-542000,0,0,0,120000,662000,-542000,-542000
1514,亞力            ,186000,741000,-555000,0,0,0,0,0,0,0,0,0,0,0,0,0,-555000
6285,啟碁            ,86000,729209,-643209,0,0,0,0,2000,-2000,87000,120000,6000,114000,0,27000,-27000,-558209
05245P,台積電元大95售18,0,0,0,0,0,0,0,0,0,-559000,0,0,0,163000,722000,-559000,-559000
053470,華邦電元大96購02,0,0,0,0,0,0,0,0,0,-559000,0,0,0,0,559000,-559000,-559000
2421,建準            ,315000,730000,-415000,0,0,0,0,0,0,-150000,0,107000,-107000,14000,57000,-43000,-565000
051997,康友元大95購02  ,0,0,0,0,0,0,0,0,0,-567000,0,0,0,224000,791000,-567000,-567000
055129,鈺齊兆豐97購01  ,0,0,0,0,0,0,0,0,0,-568000,0,0,0,82000,650000,-568000,-568000
2349,錸德            ,91000,661245,-570245,0,0,0,0,0,0,0,0,0,0,0,0,0,-570245
054713,國巨中信9B購01  ,0,0,0,0,0,0,0,0,0,-574000,0,0,0,51000,625000,-574000,-574000
055825,臺股指國票97購12,0,0,0,0,0,0,0,0,0,-578000,0,0,0,0,578000,-578000,-578000
4935,茂林-KY         ,44000,845000,-801000,0,0,0,441000,0,441000,-221000,36000,94000,-58000,50000,213000,-163000,-581000
2889,國票金          ,207000,796000,-589000,0,0,0,0,0,0,0,0,0,0,0,0,0,-589000
03871P,智邦群益93售02  ,0,0,0,0,0,0,0,0,0,-591000,0,0,0,0,591000,-591000,-591000
9945,潤泰新          ,104000,690000,-586000,0,0,0,0,0,0,-5000,6000,1000,5000,0,10000,-10000,-591000
041527,T50反1中信96購01,0,0,0,0,0,0,0,0,0,-592000,0,0,0,228000,820000,-592000,-592000
050991,元油2X元大96購04,0,0,0,0,0,0,0,0,0,-593000,0,0,0,388000,981000,-593000,-593000
8046,南電            ,541000,541000,0,0,0,0,0,0,0,-594000,0,44000,-44000,8000,558000,-550000,-594000
05315P,鴻海永昌96售08  ,0,0,0,0,0,0,0,0,0,-596000,0,0,0,253000,849000,-596000,-596000
054345,世芯國票96購02  ,0,0,0,0,0,0,0,0,0,-598000,0,0,0,320000,918000,-598000,-598000
048049,滬深反中信96購01,0,0,0,0,0,0,0,0,0,-600000,0,0,0,25000,625000,-600000,-600000
08164P,滬深2X中信95售04,0,0,0,0,0,0,0,0,0,-600000,0,0,0,0,600000,-600000,-600000
2841,台開            ,250000,852000,-602000,0,0,0,0,0,0,-1000,0,1000,-1000,0,0,0,-603000
2102,泰豐            ,71000,675000,-604000,0,0,0,0,0,0,0,0,0,0,0,0,0,-604000
049185,南電凱基94購03  ,0,0,0,0,0,0,0,0,0,-605000,0,0,0,0,605000,-605000,-605000
04702P,臺股指元富94售08,5000,0,5000,0,0,0,0,0,0,-614000,0,0,0,0,614000,-614000,-609000
03162P,泰碩元大01售02  ,0,0,0,0,0,0,0,0,0,-610000,0,0,0,0,610000,-610000,-610000
053098,國巨元富96購04  ,0,0,0,0,0,0,0,0,0,-614000,0,0,0,66000,680000,-614000,-614000
053268,日月光群益96購01,0,0,0,0,0,0,0,0,0,-615000,0,0,0,148000,763000,-615000,-615000
2615,萬海            ,232000,446000,-214000,0,0,0,1000,400000,-399000,-2000,0,2000,-2000,0,0,0,-615000
6271,同欣電          ,275000,490000,-215000,0,0,0,5000,290000,-285000,-115000,77000,171000,-94000,3000,24000,-21000,-615000
054647,禾伸堂群益99購01,0,0,0,0,0,0,0,0,0,-616000,0,0,0,0,616000,-616000,-616000
045685,康控元大95購01  ,0,0,0,0,0,0,0,0,0,-616000,0,0,0,20000,636000,-616000,-616000
051968,勤誠永豐95購01  ,0,0,0,0,0,0,0,0,0,-617000,0,0,0,88000,705000,-617000,-617000
051996,康友元大95購01  ,0,0,0,0,0,0,0,0,0,-619000,0,0,0,62000,681000,-619000,-619000
049125,禾伸堂元富94購01,0,0,0,0,0,0,0,0,0,-621000,0,0,0,141000,762000,-621000,-621000
2606,裕民            ,398000,1015000,-617000,0,0,0,1000,0,1000,-6000,0,1000,-1000,0,5000,-5000,-622000
050375,矽創元大94購02  ,0,0,0,0,0,0,0,0,0,-629000,0,0,0,0,629000,-629000,-629000
049190,元油2X永豐94購04,0,0,0,0,0,0,0,0,0,-630000,0,0,0,90000,720000,-630000,-630000
052815,滬深2X永豐97購01,0,0,0,0,0,0,0,0,0,-630000,0,0,0,201000,831000,-630000,-630000
056052,T50反1元大97購06,0,0,0,0,0,0,0,0,0,-638000,0,0,0,340000,978000,-638000,-638000
06022P,緯穎永豐96售03  ,0,0,0,0,0,0,0,0,0,-638000,0,0,0,0,638000,-638000,-638000
06007P,世芯永豐96售01  ,0,0,0,0,0,0,0,0,0,-639000,0,0,0,304000,943000,-639000,-639000
2618,長榮航          ,1479609,2169000,-689391,0,0,0,4000,0,4000,46000,144000,56000,88000,0,42000,-42000,-639391
1476,儒鴻            ,213000,801000,-588000,0,0,0,0,68000,-68000,11000,10000,0,10000,3000,2000,1000,-645000
054556,世芯凱基99購01  ,0,0,0,0,0,0,0,0,0,-647000,0,0,0,543000,1190000,-647000,-647000
2474,可成            ,1623000,2246000,-623000,0,0,0,0,5000,-5000,-20000,26000,20000,6000,22000,48000,-26000,-648000
047586,聯發科永豐94購01,0,0,0,0,0,0,0,0,0,-650000,0,0,0,0,650000,-650000,-650000
2387,精元            ,193000,610000,-417000,0,0,0,0,229000,-229000,-5000,7000,0,7000,0,12000,-12000,-651000
8021,尖點            ,86000,744000,-658000,0,0,0,0,0,0,1000,2000,1000,1000,0,0,0,-657000
00631L,元大台灣50正2   ,0,328000,-328000,0,0,0,0,0,0,-334000,0,0,0,385000,719000,-334000,-662000
054652,裕隆麥證97購01  ,0,0,0,229000,892000,-663000,0,0,0,-663000,0,0,0,229000,892000,-663000,-663000
049054,禾伸堂永豐94購01,0,0,0,0,0,0,0,0,0,-667000,0,0,0,20000,687000,-667000,-667000
05211P,國巨國票96售05  ,0,0,0,0,0,0,0,0,0,-667000,0,0,0,0,667000,-667000,-667000
2505,國揚            ,11000,677000,-666000,0,0,0,0,0,0,-1000,3000,0,3000,34000,38000,-4000,-667000
03888P,大立光元富93售03,0,0,0,0,0,0,0,0,0,-670000,0,0,0,0,670000,-670000,-670000
1605,華新            ,431000,1301000,-870000,0,0,0,2000,0,2000,194000,8000,0,8000,280000,94000,186000,-674000
052000,鈺齊元大95購03  ,0,0,0,0,0,0,0,0,0,-675000,0,0,0,34000,709000,-675000,-675000
056458,日月光凱基98購02,0,0,0,0,0,0,0,0,0,-676000,0,0,0,6000,682000,-676000,-676000
3653,健策            ,225000,548000,-323000,0,0,0,8000,0,8000,-365000,5000,8000,-3000,27000,389000,-362000,-680000
08703P,華碩凱基01售02  ,0,0,0,0,0,0,0,0,0,-682000,0,0,0,83000,765000,-682000,-682000
050641,上証反凱基96購01,0,0,0,0,0,0,0,0,0,-684000,0,0,0,0,684000,-684000,-684000
2105,正新            ,226000,926000,-700000,0,0,0,2000,0,2000,0,0,0,0,0,0,0,-698000
05255P,義隆凱基95售01  ,0,0,0,0,0,0,0,0,0,-705000,0,0,0,0,705000,-705000,-705000
047983,宏達電群益93購04,0,0,0,0,0,0,0,0,0,-708000,0,0,0,90000,798000,-708000,-708000
056601,鈺齊元富98購01  ,0,0,0,0,0,0,0,0,0,-715000,0,0,0,0,715000,-715000,-715000
05748P,臺股指群益99售02,0,0,0,0,0,0,0,0,0,-723000,0,0,0,64000,787000,-723000,-723000
3041,揚智            ,153000,879000,-726000,0,0,0,0,0,0,0,0,0,0,0,0,0,-726000
052664,麗豐國票96購02  ,0,0,0,0,0,0,0,0,0,-730000,0,0,0,10000,740000,-730000,-730000
2520,冠德            ,344000,984000,-640000,0,0,0,0,80000,-80000,-10000,0,1000,-1000,19000,28000,-9000,-730000
050223,聯茂元富94購02  ,0,0,0,0,0,0,0,0,0,-731000,0,0,0,0,731000,-731000,-731000
2301,光寶科          ,1996000,2766000,-770000,0,0,0,2000,0,2000,35000,16000,1000,15000,51000,31000,20000,-733000
052179,康友元大95購03  ,0,0,0,0,0,0,0,0,0,-738000,0,0,0,260000,998000,-738000,-738000
03999P,鴻海凱基94售11  ,0,0,0,0,0,0,0,0,0,-740000,0,0,0,0,740000,-740000,-740000
06193P,台積電元富97售04,0,0,0,0,0,0,0,0,0,-756000,0,0,0,1395000,2151000,-756000,-756000
051173,元油2X凱基98購01,0,0,0,0,0,0,0,0,0,-767000,0,0,0,0,767000,-767000,-767000
1513,中興電          ,173000,938000,-765000,0,0,0,0,0,0,-3000,0,3000,-3000,0,0,0,-768000
3044,健鼎            ,514000,1244000,-730000,0,0,0,0,0,0,-42000,21000,24000,-3000,20000,59000,-39000,-772000
050171,臺指反元大97購03,0,0,0,0,0,0,0,0,0,-777000,0,0,0,124000,901000,-777000,-777000
2547,日勝生          ,156000,909920,-753920,0,0,0,0,0,0,-24000,0,24000,-24000,0,0,0,-777920
053161,康友元大96購04  ,0,0,0,0,0,0,0,0,0,-780000,0,0,0,41000,821000,-780000,-780000
2605,新興            ,110000,895000,-785000,0,0,0,0,0,0,-4000,0,0,0,0,4000,-4000,-789000
047379,元油2X元大96購03,0,0,0,0,0,0,0,0,0,-790000,0,0,0,20000,810000,-790000,-790000
05091P,台積電元大95售11,0,0,0,0,0,0,0,0,0,-790000,0,0,0,294000,1084000,-790000,-790000
00651R,FH香港反1       ,0,55000,-55000,0,0,0,0,0,0,-737000,0,0,0,191000,928000,-737000,-792000
047824,臺股指凱基93購18,0,0,0,0,0,0,0,0,0,-801000,0,0,0,50000,851000,-801000,-801000
04787P,台積電永昌96售04,0,0,0,0,0,0,0,0,0,-806000,0,0,0,1403000,2209000,-806000,-806000
1326,台化            ,1025858,1857000,-831142,0,0,0,6000,0,6000,19000,2000,5000,-3000,27000,5000,22000,-806142
043040,永冠元富94購01  ,0,0,0,0,0,0,0,0,0,-808000,0,0,0,0,808000,-808000,-808000
5522,遠雄            ,274000,1002000,-728000,0,0,0,0,0,0,-80000,20000,100000,-80000,0,0,0,-808000
053852,南亞科國泰98購01,0,0,0,0,0,0,0,0,0,-816000,0,0,0,111000,927000,-816000,-816000
9933,中鼎            ,271000,1087000,-816000,0,0,0,0,0,0,0,0,0,0,0,0,0,-816000
055927,南亞科群益97購01,0,0,0,0,0,0,0,0,0,-819000,0,0,0,833000,1652000,-819000,-819000
2845,遠東銀          ,554000,1376133,-822133,0,0,0,3000,0,3000,0,0,0,0,0,0,0,-819133
3545,敦泰            ,285000,1107750,-822750,0,0,0,0,0,0,3000,3000,0,3000,0,0,0,-819750
045870,元油2X元富96購02,0,0,0,0,0,0,0,0,0,-824000,0,0,0,25000,849000,-824000,-824000
4915,致伸            ,783000,1568000,-785000,0,0,0,0,0,0,-39000,0,0,0,9000,48000,-39000,-824000
4906,正文            ,147000,734000,-587000,0,0,0,0,0,0,-239000,27000,18000,9000,23000,271000,-248000,-826000
052296,TPK國票96購01   ,0,0,0,0,0,0,0,0,0,-829000,0,0,0,400000,1229000,-829000,-829000
8039,台虹            ,188000,985280,-797280,0,0,0,0,0,0,-48000,0,0,0,5000,53000,-48000,-845280
056822,佐登永豐98購01  ,0,0,0,0,0,0,0,0,0,-864000,0,0,0,1000000,1864000,-864000,-864000
2633,台灣高鐵        ,432000,1214000,-782000,0,0,0,3000,0,3000,-85000,0,0,0,11000,96000,-85000,-864000
2347,聯強            ,758000,1835000,-1077000,0,0,0,0,0,0,206000,138000,1000,137000,74000,5000,69000,-871000
6005,群益證          ,37000,910000,-873000,0,0,0,2000,0,2000,0,0,0,0,0,0,0,-871000
3017,奇鋐            ,1922000,2731000,-809000,0,0,0,0,0,0,-67000,0,0,0,1000,68000,-67000,-876000
3042,晶技            ,421000,1174000,-753000,0,0,0,0,0,0,-125000,0,45000,-45000,0,80000,-80000,-878000
038489,T50反1台新9A購01,0,0,0,0,0,0,0,0,0,-879000,0,0,0,0,879000,-879000,-879000
053675,臺股指元富96購02,0,0,0,0,0,0,0,0,0,-880000,0,0,0,0,880000,-880000,-880000
3376,新日興          ,354000,850000,-496000,0,0,0,41000,428000,-387000,-3000,65000,32000,33000,43000,79000,-36000,-886000
00671R,富邦NASDAQ反1   ,0,12000,-12000,0,0,0,0,0,0,-875000,0,0,0,23000,898000,-875000,-887000
054790,禾伸堂群益98購01,0,0,0,0,0,0,0,0,0,-898000,0,0,0,23000,921000,-898000,-898000
2101,南港            ,252000,1084000,-832000,0,0,0,0,0,0,-74000,0,15000,-15000,0,59000,-59000,-906000
055411,國巨富邦9A購02  ,0,0,0,0,0,0,0,0,0,-910000,0,0,0,240000,1150000,-910000,-910000
051505,台積電元富95購05,0,0,0,0,0,0,0,0,0,-927000,0,0,0,927000,1854000,-927000,-927000
03638C,T50反1元大94牛03,0,0,0,0,0,0,0,0,0,-929000,0,0,0,431000,1360000,-929000,-929000
052400,聯詠凱基97購01  ,0,0,0,0,0,0,0,0,0,-941000,0,0,0,0,941000,-941000,-941000
054101,茂林國票97購04  ,0,0,0,0,0,0,0,0,0,-946000,0,0,0,99000,1045000,-946000,-946000
3576,聯合再生        ,181000,1132000,-951000,0,0,0,0,0,0,0,0,0,0,0,0,0,-951000
4958,臻鼎-KY         ,1927000,2512000,-585000,0,0,0,0,255000,-255000,-116000,27000,144000,-117000,20000,19000,1000,-956000
4938,和碩            ,1783000,2312000,-529000,0,0,0,32000,0,32000,-465000,45000,29000,16000,37000,518000,-481000,-962000
2542,興富發          ,244400,1225000,-980600,0,0,0,0,0,0,11000,25000,14000,11000,0,0,0,-969600
050170,臺指反元大97購02,0,0,0,0,0,0,0,0,0,-978000,0,0,0,0,978000,-978000,-978000
044104,鴻海中信95購03  ,0,0,0,0,0,0,0,0,0,-983000,0,0,0,64000,1047000,-983000,-983000
6505,台塑化          ,636000,1756000,-1120000,0,0,0,7000,0,7000,129000,0,7000,-7000,136000,0,136000,-984000
05759P,智邦永豐96售02  ,0,0,0,0,0,0,0,0,0,-990000,0,0,0,98000,1088000,-990000,-990000
3673,TPK-KY          ,479000,1445000,-966000,0,0,0,0,0,0,-27000,10000,8000,2000,3000,32000,-29000,-993000
1409,新纖            ,327000,1309000,-982000,0,0,0,0,0,0,-14000,0,14000,-14000,0,0,0,-996000
048021,滬深反凱基93購02,0,0,0,0,0,0,0,0,0,-998000,0,0,0,0,998000,-998000,-998000
041973,台灣50中信94購01,0,0,0,0,0,0,0,0,0,-1009000,0,0,0,374000,1383000,-1009000,-1009000
04751P,智邦兆豐95售02  ,0,0,0,0,0,0,0,0,0,-1013000,0,0,0,95000,1108000,-1013000,-1013000
2383,台光電          ,260000,1142000,-882000,0,0,0,118000,147000,-29000,-102000,80000,133000,-53000,5000,54000,-49000,-1013000
05034P,台積電元大95售08,0,0,0,0,0,0,0,0,0,-1015000,0,0,0,219000,1234000,-1015000,-1015000
047912,台郡麥證94購01  ,0,0,0,40000,1060000,-1020000,0,0,0,-1020000,0,0,0,40000,1060000,-1020000,-1020000
05009P,大立光元富95售06,0,0,0,0,0,0,0,0,0,-1022000,0,0,0,0,1022000,-1022000,-1022000
054072,台積電富邦98購02,0,0,0,0,0,0,0,0,0,-1022000,0,0,0,747000,1769000,-1022000,-1022000
06028P,智邦台新97售01  ,0,0,0,0,0,0,0,0,0,-1024000,0,0,0,78000,1102000,-1024000,-1024000
2489,瑞軒            ,89000,1116000,-1027000,0,0,0,0,0,0,-2000,0,2000,-2000,0,0,0,-1029000
3035,智原            ,328000,1045000,-717000,0,0,0,0,200000,-200000,-113000,0,74000,-74000,2000,41000,-39000,-1030000
2890,永豐金          ,2785000,3827000,-1042000,0,0,0,14000,0,14000,-3000,0,3000,-3000,0,0,0,-1031000
8210,勤誠            ,133000,1016000,-883000,0,0,0,0,4000,-4000,-144000,40000,206000,-166000,63000,41000,22000,-1031000
3406,玉晶光          ,723000,1388000,-665000,0,0,0,0,75000,-75000,-299000,16000,252000,-236000,4000,67000,-63000,-1039000
2478,大毅            ,882000,1861000,-979000,0,0,0,0,0,0,-79000,85000,80000,5000,42000,126000,-84000,-1058000
1609,大亞            ,104000,1168000,-1064000,0,0,0,0,0,0,0,0,0,0,0,0,0,-1064000
053512,台積電群益96購06,0,0,0,0,0,0,0,0,0,-1066000,0,0,0,236000,1302000,-1066000,-1066000
2834,臺企銀          ,2027000,3106200,-1079200,0,0,0,7000,0,7000,0,0,0,0,0,0,0,-1072200
5521,工信            ,96000,1228000,-1132000,0,0,0,0,0,0,38000,38000,0,38000,0,0,0,-1094000
1303,南亞            ,2747500,3816000,-1068500,0,0,0,8000,0,8000,-34000,0,32000,-32000,0,2000,-2000,-1094500
3034,聯詠            ,1534000,2314200,-780200,0,0,0,2000,179000,-177000,-157000,0,76000,-76000,18000,99000,-81000,-1114200
05449P,臺股指元大95售26,0,0,0,0,0,0,0,0,0,-1118000,0,0,0,257000,1375000,-1118000,-1118000
053520,康友群益96購01  ,0,0,0,0,0,0,0,0,0,-1122000,0,0,0,10000,1132000,-1122000,-1122000
052044,華通凱基97購01  ,0,0,0,0,0,0,0,0,0,-1138000,0,0,0,110000,1248000,-1138000,-1138000
1301,台塑            ,1620000,2755000,-1135000,0,0,0,4000,0,4000,-18000,0,4000,-4000,0,14000,-14000,-1149000
055028,佐登國泰98購01  ,0,0,0,0,0,0,0,0,0,-1156000,0,0,0,501000,1657000,-1156000,-1156000
06490P,鴻海富邦99售02  ,0,0,0,0,0,0,0,0,0,-1177000,0,0,0,276000,1453000,-1177000,-1177000
044269,群創中信95購01  ,0,0,0,0,0,0,0,0,0,-1216000,0,0,0,319000,1535000,-1216000,-1216000
056005,臺股指永豐97購04,0,0,0,0,0,0,0,0,0,-1248000,0,0,0,20000,1268000,-1248000,-1248000
3665,貿聯-KY         ,568000,1058000,-490000,0,0,0,0,525000,-525000,-250000,18000,239000,-221000,9000,38000,-29000,-1265000
056847,佐登元富98購01  ,0,0,0,0,0,0,0,0,0,-1269000,0,0,0,0,1269000,-1269000,-1269000
053532,台積電永豐96購03,0,0,0,0,0,0,0,0,0,-1269000,0,0,0,495000,1764000,-1269000,-1269000
054684,裕隆永豐97購01  ,0,0,0,0,0,0,0,0,0,-1296000,0,0,0,666000,1962000,-1296000,-1296000
1102,亞泥            ,1810000,3069532,-1259532,0,0,0,4000,0,4000,-57000,0,0,0,91000,148000,-57000,-1312532
042916,佐登元大94購01  ,0,0,0,0,0,0,0,0,0,-1330000,0,0,0,0,1330000,-1330000,-1330000
2002,中鋼            ,3049000,4453000,-1404000,0,0,0,19000,0,19000,42000,42000,0,42000,0,0,0,-1343000
6213,聯茂            ,495000,643000,-148000,0,0,0,0,635000,-635000,-570000,44000,350000,-306000,1000,265000,-264000,-1353000
6278,台表科          ,558000,1335000,-777000,0,0,0,0,536000,-536000,-44000,7000,34000,-27000,31000,48000,-17000,-1357000
043656,上証反元大94購01,0,0,0,0,0,0,0,0,0,-1367000,0,0,0,40000,1407000,-1367000,-1367000
056069,新日興元大97購03,0,0,0,0,0,0,0,0,0,-1370000,0,0,0,123000,1493000,-1370000,-1370000
2104,國際中橡        ,425000,1818940,-1393940,0,0,0,0,0,0,-9000,0,1000,-1000,0,8000,-8000,-1402940
2393,億光            ,1290000,2359000,-1069000,0,0,0,0,0,0,-339000,137000,484000,-347000,71000,63000,8000,-1408000
07866P,上証2X國票97售01,0,0,0,0,0,0,0,0,0,-1423000,0,0,0,100000,1523000,-1423000,-1423000
00692,富邦公司治理    ,1000,0,1000,0,0,0,0,0,0,-1446000,0,0,0,1383000,2829000,-1446000,-1445000
00656R,國泰中國A50反1  ,0,16000,-16000,0,0,0,0,0,0,-1453000,280000,0,280000,48000,1781000,-1733000,-1469000
1310,台苯            ,82000,1592000,-1510000,0,0,0,0,0,0,-1000,0,1000,-1000,0,0,0,-1511000
3045,台灣大          ,406000,1977000,-1571000,0,0,0,3000,0,3000,48000,50000,2000,48000,0,0,0,-1520000
056158,新日興凱基98購02,0,0,0,0,0,0,0,0,0,-1534000,0,0,0,31000,1565000,-1534000,-1534000
2367,燿華            ,672000,1985000,-1313000,0,0,0,0,0,0,-231000,0,50000,-50000,39000,220000,-181000,-1544000
2458,義隆            ,791000,2431000,-1640000,0,0,0,243000,0,243000,-177000,25000,46000,-21000,29000,185000,-156000,-1574000
04755P,大立光元富94售07,0,0,0,0,0,0,0,0,0,-1592000,0,0,0,0,1592000,-1592000,-1592000
3049,和鑫            ,238000,1425000,-1187000,0,0,0,0,404000,-404000,-24000,0,0,0,6000,30000,-24000,-1615000
1536,和大            ,167000,1283000,-1116000,0,0,0,23000,492000,-469000,-31000,4000,50000,-46000,27000,12000,15000,-1616000
055644,致茂元富97購01  ,0,0,0,0,0,0,0,0,0,-1631000,0,0,0,101000,1732000,-1631000,-1631000
2049,上銀            ,957000,2389000,-1432000,0,0,0,165000,0,165000,-364000,37000,52000,-15000,82000,431000,-349000,-1631000
4904,遠傳            ,1266000,2933000,-1667000,0,0,0,3000,0,3000,4000,4000,0,4000,0,0,0,-1660000
1101,台泥            ,2726000,4388000,-1662000,0,0,0,3000,50000,-47000,17000,48000,3000,45000,115000,143000,-28000,-1692000
052006,康友富邦98購01  ,0,0,0,0,0,0,0,0,0,-1694000,0,0,0,220000,1914000,-1694000,-1694000
5871,中租-KY         ,1498000,3093310,-1595310,0,0,0,11000,0,11000,-126000,0,126000,-126000,0,0,0,-1710310
049875,台積電永豐94購04,0,0,0,0,0,0,0,0,0,-1741000,0,0,0,1039000,2780000,-1741000,-1741000
03033P,微星國票03售01  ,0,0,0,0,0,0,0,0,0,-1774000,0,0,0,0,1774000,-1774000,-1774000
00669R,國泰美國道瓊反1 ,0,0,0,0,0,0,0,0,0,-1821000,135000,0,135000,262000,2218000,-1956000,-1821000
2504,國產            ,324000,2330000,-2006000,0,0,0,0,0,0,163000,130000,1000,129000,34000,0,34000,-1843000
2881,富邦金          ,7113000,8918000,-1805000,0,0,0,12000,0,12000,-87000,0,0,0,12000,99000,-87000,-1880000
6251,定穎            ,1450000,823000,627000,0,0,0,0,2000000,-2000000,-573000,11000,584000,-573000,0,0,0,-1946000
051405,世芯永豐95購01  ,0,0,0,0,0,0,0,0,0,-1974000,0,0,0,171000,2145000,-1974000,-1974000
2379,瑞昱            ,597000,2395000,-1798000,0,0,0,0,165000,-165000,-38000,33000,20000,13000,9000,60000,-51000,-2001000
055325,佐登國票98購01  ,0,0,0,0,0,0,0,0,0,-2111000,0,0,0,289000,2400000,-2111000,-2111000
2823,中壽            ,1401000,3670557,-2269557,0,0,0,5000,0,5000,27000,0,1000,-1000,34000,6000,28000,-2237557
1504,東元            ,607000,2915000,-2308000,0,0,0,2000,0,2000,-3000,3000,15000,-12000,9000,0,9000,-2309000
08679P,台灣50元大01售15,0,0,0,0,0,0,0,0,0,-2429000,0,0,0,0,2429000,-2429000,-2429000
3661,世芯-KY         ,1668000,2404000,-736000,0,0,0,0,1353000,-1353000,-349000,1000,360000,-359000,45000,35000,10000,-2438000
2801,彰銀            ,1575000,4041000,-2466000,0,0,0,11000,0,11000,-68000,0,1000,-1000,27000,94000,-67000,-2523000
053564,台積電富邦99購01,0,0,0,0,0,0,0,0,0,-2648000,0,0,0,218000,2866000,-2648000,-2648000
054968,佐登元大97購01  ,0,0,0,0,0,0,0,0,0,-2730000,0,0,0,621000,3351000,-2730000,-2730000
2882,國泰金          ,4776047,7638383,-2862336,0,0,0,14000,0,14000,20000,0,0,0,24000,4000,20000,-2828336
020000,富邦特選蘋果N   ,0,0,0,0,0,0,0,0,0,-2852000,0,0,0,20000,2872000,-2852000,-2852000
9904,寶成            ,2168000,5076000,-2908000,0,0,0,3000,0,3000,6000,8000,1000,7000,0,1000,-1000,-2899000
1714,和桐            ,967000,3885000,-2918000,0,0,0,0,0,0,-6000,0,6000,-6000,0,0,0,-2924000
2313,華通            ,1001000,2827000,-1826000,0,0,0,0,545000,-545000,-555000,172000,441000,-269000,42000,328000,-286000,-2926000
1216,統一            ,1986000,5284478,-3298478,0,0,0,8000,0,8000,-9000,4000,9000,-5000,4000,8000,-4000,-3299478
00701,國泰股利精選30  ,1000,0,1000,0,0,0,0,0,0,-3531000,0,0,0,93000,3624000,-3531000,-3530000
04545P,國巨元大94售05  ,0,0,0,0,0,0,0,0,0,-3710000,0,0,0,0,3710000,-3710000,-3710000
2603,長榮            ,1730000,5565000,-3835000,0,0,0,5000,439,4561,-6000,18000,24000,-6000,0,0,0,-3836439
05283P,健鼎元大95售04  ,0,0,0,0,0,0,0,0,0,-4082000,0,0,0,100000,4182000,-4082000,-4082000
045872,元油2X元富98購03,0,0,0,0,0,0,0,0,0,-4323000,0,0,0,0,4323000,-4323000,-4323000
2368,金像電          ,1068000,4789491,-3721491,0,0,0,0,100000,-100000,-641000,209000,850000,-641000,0,0,0,-4462491
3711,日月光投控      ,2698000,7977000,-5279000,0,0,0,5000,73000,-68000,837000,843000,3000,840000,70000,73000,-3000,-4510000
0056,元大高股息      ,2000,0,2000,0,0,0,130000,0,130000,-4675000,0,0,0,130000,4805000,-4675000,-4543000
00850,元大臺灣ESG永續 ,0,928000,-928000,0,0,0,0,0,0,-3668000,0,0,0,295000,3963000,-3668000,-4596000
2330,台積電          ,15733278,20450383,-4717105,0,0,0,43000,188000,-145000,62000,797000,150000,647000,129000,714000,-585000,-4800105
2886,兆豐金          ,4642000,9877000,-5235000,0,0,0,16000,0,16000,34000,0,61000,-61000,101000,6000,95000,-5185000
1402,遠東新          ,2010000,7403000,-5393000,0,0,0,6000,0,6000,99000,95000,2000,93000,30000,24000,6000,-5288000
053856,台積電富邦98購01,0,0,0,0,0,0,0,0,0,-5628000,0,0,0,82000,5710000,-5628000,-5628000
3037,欣興            ,1965000,4896000,-2931000,0,0,0,1000,2661000,-2660000,-56000,182000,153000,29000,172000,257000,-85000,-5647000
00638R,元大滬深300反1  ,0,1196000,-1196000,0,0,0,0,0,0,-4706000,0,0,0,108000,4814000,-4706000,-5902000
2448,晶電            ,1641000,6445000,-4804000,0,0,0,0,1592000,-1592000,167000,415000,248000,167000,0,0,0,-6229000
2449,京元電子        ,1798000,6817000,-5019000,0,0,0,0,298000,-298000,-1169000,18000,78000,-60000,57000,1166000,-1109000,-6486000
1314,中石化          ,1283000,7523000,-6240000,0,0,0,1000,0,1000,-253000,16000,19000,-3000,51000,301000,-250000,-6492000
0050,元大台灣50      ,66600,5691000,-5624400,0,0,0,75000,0,75000,-1348000,159000,70000,89000,499000,1936000,-1437000,-6897400
2887,台新金          ,3678000,10636566,-6958566,0,0,0,14000,0,14000,-1000,0,1000,-1000,0,0,0,-6945566
00632R,元大台灣50反1   ,6325000,10987000,-4662000,0,0,0,3000000,0,3000000,-5575000,3900000,4530000,-630000,6898000,11843000,-4945000,-7237000
2883,開發金          ,2104000,9529000,-7425000,0,0,0,20000,0,20000,2000,2000,0,2000,0,0,0,-7403000
2884,玉山金          ,4575000,13779000,-9204000,0,0,0,15000,0,15000,30000,25000,0,25000,118000,113000,5000,-9159000
00634R,富邦上証反1     ,136000,2272000,-2136000,0,0,0,0,0,0,-9175000,1010000,0,1010000,54000,10239000,-10185000,-11311000
2344,華邦電          ,7771373,9115000,-1343627,0,0,0,2000,13738000,-13736000,-663000,152000,433000,-281000,368000,750000,-382000,-15742627
00642U,元大S&P石油     ,49000,2409000,-2360000,0,0,0,0,0,0,-15534000,145000,80000,65000,64000,15663000,-15599000,-17894000
2337,旺宏            ,2134000,15723000,-13589000,0,0,0,35000,11303000,-11268000,-521000,676000,735000,-59000,270000,732000,-462000,-25378000
00677U,富邦VIX         ,3834000,33597000,-29763000,0,0,0,0,0,0,-16754000,200000,4600000,-4400000,30000,12384000,-12354000,-46517000
00672L,元大S&P原油正2  ,32605000,5360000,27245000,0,0,0,0,0,0,-113971000,1300000,0,1300000,4025000,119296000,-115271000,-86726000
