證券代號,證券名稱,外陸資買進股數(不含外資自營商),外陸資賣出股數(不含外資自營商),外陸資買賣超股數(不含外資自營商),外資自營商買進股數,外資自營商賣出股數,外資自營商買賣超股數,投信買進股數,投信賣出股數,投信買賣超股數,自營商買賣超股數,自營商買進股數(自行買賣),自營商賣出股數(自行買賣),自營商買賣超股數(自行買賣),自營商買進股數(避險),自營商賣出股數(避險),自營商買賣超股數(避險),三大法人買賣超股數
00637L,元大滬深300正2  ,9422000,58000,9364000,0,0,0,0,0,0,22551000,500000,0,500000,38198000,16147000,22051000,31915000
2337,旺宏            ,30838000,5590000,25248000,0,0,0,684000,0,684000,4858000,3311000,1059000,2252000,3205000,599000,2606000,30790000
2303,聯電            ,29797500,7606952,22190548,0,0,0,60000,2798000,-2738000,-1496000,130000,1509000,-1379000,282000,399000,-117000,17956548
00632R,元大台灣50反1   ,39000,835000,-796000,0,0,0,0,0,0,11758000,3451000,770000,2681000,16127000,7050000,9077000,10962000
2368,金像電          ,11519000,2271000,9248000,0,0,0,507000,0,507000,-460000,290000,750000,-460000,0,0,0,9295000
049609,全新兆豐95購01  ,0,0,0,0,0,0,0,0,0,6992000,0,0,0,7584000,592000,6992000,6992000
00861,元大全球未來通訊,1000,5000,-4000,0,0,0,0,0,0,5896000,150000,0,150000,5746000,0,5746000,5892000
1909,榮成            ,4934000,1211000,3723000,0,0,0,533000,0,533000,117000,117000,0,117000,0,0,0,4373000
00708L,元大S&P黃金正2  ,605000,1000,604000,0,0,0,0,0,0,3583000,0,0,0,7304000,3721000,3583000,4187000
048341,全新元大94購03  ,0,0,0,0,0,0,0,0,0,3412000,0,0,0,3432000,20000,3412000,3412000
2409,友達            ,27724000,21464975,6259025,0,0,0,1554000,0,1554000,-4498000,501000,3841000,-3340000,187000,1345000,-1158000,3315025
044588,元金2X統一93購01,0,0,0,0,0,0,0,0,0,3195000,0,0,0,3579000,384000,3195000,3195000
3682,亞太電          ,4384000,1194000,3190000,0,0,0,0,29017,-29017,0,0,0,0,0,0,0,3160983
00655L,國泰中國A50正2  ,0,0,0,0,0,0,0,0,0,3126000,0,0,0,4543000,1417000,3126000,3126000
2312,金寶            ,4270000,1852000,2418000,0,0,0,0,0,0,392000,159000,25000,134000,345000,87000,258000,2810000
00633L,富邦上証正2     ,672000,302000,370000,0,0,0,0,0,0,2388000,90000,837000,-747000,5116000,1981000,3135000,2758000
6116,彩晶            ,7256000,4141000,3115000,0,0,0,0,0,0,-401000,122000,130000,-8000,67000,460000,-393000,2714000
05980P,台積電永昌96售09,0,0,0,0,0,0,0,0,0,2622000,0,0,0,4230000,1608000,2622000,2622000
05400P,台積電永豐95售05,0,0,0,0,0,0,0,0,0,2472000,0,0,0,3526000,1054000,2472000,2472000
00673R,元大S&P原油反1  ,3833000,269000,3564000,0,0,0,0,0,0,-1111000,0,0,0,8411000,9522000,-1111000,2453000
04787P,台積電永昌96售04,0,0,0,0,0,0,0,0,0,2311000,0,0,0,3340000,1029000,2311000,2311000
00643,群益深証中小    ,2094000,0,2094000,0,0,0,0,0,0,57000,0,0,0,997000,940000,57000,2151000
047505,元金2X國票9B購01,0,0,0,0,0,0,0,0,0,2027000,0,0,0,2140000,113000,2027000,2027000
040760,T50反1凱基95購01,0,0,0,0,0,0,0,0,0,1895000,0,0,0,3461000,1566000,1895000,1895000
052595,奇力新群益96購01,0,0,0,0,0,0,0,0,0,1892000,0,0,0,2614000,722000,1892000,1892000
006207,FH滬深          ,22000,0,22000,0,0,0,0,0,0,1835000,0,0,0,2145000,310000,1835000,1857000
04206P,臺股指元大93售46,0,0,0,0,0,0,0,0,0,1797000,0,0,0,1898000,101000,1797000,1797000
2889,國票金          ,1846000,67000,1779000,0,0,0,0,0,0,0,0,0,0,0,0,0,1779000
1301,台塑            ,3008000,1585327,1422673,0,0,0,354000,0,354000,-57000,156000,203000,-47000,7000,17000,-10000,1719673
00783,富邦中証500     ,1104000,0,1104000,0,0,0,0,0,0,582000,0,0,0,1554000,972000,582000,1686000
043040,永冠元富94購01  ,0,0,0,0,0,0,0,0,0,1672000,0,0,0,1772000,100000,1672000,1672000
04338P,亞光元大93售04  ,0,0,0,0,0,0,0,0,0,1621000,0,0,0,1892000,271000,1621000,1621000
9938,百和            ,1620000,240000,1380000,0,0,0,69000,0,69000,172000,55000,50000,5000,204000,37000,167000,1621000
051354,聯發科元大95購09,0,0,0,0,0,0,0,0,0,1587000,0,0,0,1920000,333000,1587000,1587000
5876,上海商銀        ,2574894,1136988,1437906,0,0,0,4000,0,4000,120000,10000,0,10000,141000,31000,110000,1561906
04185P,欣興統一93售05  ,0,0,0,0,0,0,0,0,0,1550000,0,0,0,1626000,76000,1550000,1550000
04049P,大立光元大95售02,0,0,0,0,0,0,0,0,0,1542000,0,0,0,1698000,156000,1542000,1542000
3231,緯創            ,4033446,2390811,1642635,0,0,0,12000,0,12000,-179000,0,6000,-6000,29000,202000,-173000,1475635
00639,富邦深100       ,1101000,0,1101000,0,0,0,0,0,0,370000,0,0,0,1431000,1061000,370000,1471000
1902,台紙            ,3094000,1631000,1463000,0,0,0,110000,0,110000,-120000,80000,200000,-120000,0,0,0,1453000
052778,智原國票97購01  ,0,0,0,0,0,0,0,0,0,1443000,0,0,0,1458000,15000,1443000,1443000
05103P,臺股指凱基96售10,0,0,0,0,0,0,0,0,0,1418000,0,0,0,1469000,51000,1418000,1418000
040166,FBVIX元大92購01 ,0,0,0,0,0,0,0,0,0,1398000,0,0,0,1398000,0,1398000,1398000
2474,可成            ,2184368,761281,1423087,0,0,0,5000,12000,-7000,-36000,0,36000,-36000,56000,56000,0,1380087
03921P,亞光凱基94售01  ,0,0,0,0,0,0,0,0,0,1335000,0,0,0,1395000,60000,1335000,1335000
053414,臻鼎國票97購01  ,0,0,0,0,0,0,0,0,0,1301000,0,0,0,1301000,0,1301000,1301000
05657P,樺漢統一97售01  ,0,0,0,0,0,0,0,0,0,1294000,0,0,0,1448000,154000,1294000,1294000
2027,大成鋼          ,1486000,166737,1319263,0,0,0,0,0,0,-26000,10000,0,10000,39000,75000,-36000,1293263
05518P,T50反1凱基98售03,0,0,0,0,0,0,0,0,0,1250000,0,0,0,1250000,0,1250000,1250000
006205,富邦上証        ,0,0,0,0,0,0,0,0,0,1240000,80000,30000,50000,2193000,1003000,1190000,1240000
05688P,臺股指元大96售13,0,0,0,0,0,0,0,0,0,1228000,0,0,0,1388000,160000,1228000,1228000
045127,鴻海統一92購01  ,0,0,0,0,0,0,0,0,0,1225000,0,0,0,1243000,18000,1225000,1225000
00636,國泰中國A50     ,702000,0,702000,0,0,0,0,0,0,511000,0,0,0,790000,279000,511000,1213000
05563P,台積電元大97售07,0,0,0,0,0,0,0,0,0,1208000,0,0,0,1691000,483000,1208000,1208000
051039,台表科康和95購01,0,0,0,0,0,0,0,0,0,1205000,0,0,0,1333000,128000,1205000,1205000
1536,和大            ,530255,655000,-124745,0,0,0,1119000,2000,1117000,198000,219000,30000,189000,162000,153000,9000,1190255
00646,元大S&P500      ,348000,0,348000,0,0,0,0,0,0,811000,111000,0,111000,936000,236000,700000,1159000
047096,元油反國泰96購01,0,0,0,0,0,0,0,0,0,1151000,0,0,0,1151000,0,1151000,1151000
00739,元大MSCI A股    ,214000,1000,213000,0,0,0,0,0,0,926000,0,0,0,1032000,106000,926000,1139000
046884,元油反群益95購01,0,0,0,0,0,0,0,0,0,1110000,0,0,0,1110000,0,1110000,1110000
047206,元金2X國泰94購01,0,0,0,0,0,0,0,0,0,1103000,0,0,0,1464000,361000,1103000,1103000
049148,全新元大95購01  ,0,0,0,0,0,0,0,0,0,1097000,0,0,0,1334000,237000,1097000,1097000
05508P,華通統一97售01  ,0,0,0,0,0,0,0,0,0,1095000,0,0,0,1260000,165000,1095000,1095000
04422P,玉晶光永豐94售03,0,10000,-10000,0,0,0,0,0,0,1102000,0,0,0,1310000,208000,1102000,1092000
05585P,臺股指凱基96售14,0,0,0,0,0,0,0,0,0,1063000,0,0,0,1073000,10000,1063000,1063000
05516P,台積電元大96售12,0,0,0,0,0,0,0,0,0,1038000,0,0,0,1070000,32000,1038000,1038000
053992,中環群益96購01  ,0,0,0,0,0,0,0,0,0,1034000,0,0,0,1132000,98000,1034000,1034000
048456,利勤凱基95購01  ,0,0,0,0,0,0,0,0,0,1010000,0,0,0,1010000,0,1010000,1010000
1605,華新            ,1671000,831397,839603,0,0,0,0,0,0,152000,70000,24000,46000,247000,141000,106000,991603
053285,臺股指元大96購08,0,0,0,0,0,0,0,0,0,989000,0,0,0,991000,2000,989000,989000
044464,滬深2X群益95購01,0,0,0,0,0,0,0,0,0,982000,0,0,0,1487000,505000,982000,982000
052381,臺股指元大95購22,0,0,0,0,0,0,0,0,0,981000,0,0,0,981000,0,981000,981000
044615,聯茂兆豐93購01  ,0,0,0,0,0,0,0,0,0,974000,0,0,0,1924000,950000,974000,974000
054345,世芯國票96購02  ,0,0,0,0,0,0,0,0,0,973000,0,0,0,987000,14000,973000,973000
050683,智原元富94購02  ,0,0,0,0,0,0,0,0,0,971000,0,0,0,1099000,128000,971000,971000
045070,全新元大93購02  ,0,0,0,0,0,0,0,0,0,970000,0,0,0,970000,0,970000,970000
049355,元油2X富邦96購04,0,0,0,0,0,0,0,0,0,963000,0,0,0,963000,0,963000,963000
3406,玉晶光          ,1381000,344550,1036450,0,0,0,70000,10000,60000,-142000,52000,176000,-124000,23000,41000,-18000,954450
04575P,新日興統一94售02,0,0,0,0,0,0,0,0,0,944000,0,0,0,1029000,85000,944000,944000
6288,聯嘉            ,1480000,542000,938000,0,0,0,0,0,0,-3000,6000,9000,-3000,0,0,0,935000
044364,超眾中信94購01  ,0,0,0,0,0,0,0,0,0,926000,0,0,0,1298000,372000,926000,926000
054608,致茂永豐97購01  ,0,0,0,0,0,0,0,0,0,910000,0,0,0,973000,63000,910000,910000
039951,鴻海群益91購01  ,0,0,0,0,0,0,0,0,0,900000,0,0,0,900000,0,900000,900000
044981,南亞科國票92購01,0,0,0,0,0,0,0,0,0,899000,0,0,0,998000,99000,899000,899000
052572,群創凱基99購01  ,0,0,0,0,0,0,0,0,0,895000,0,0,0,900000,5000,895000,895000
044931,華新元大91購01  ,0,0,0,0,0,0,0,0,0,894000,0,0,0,999000,105000,894000,894000
04747P,臺股指元大94售22,0,0,0,0,0,0,0,0,0,894000,0,0,0,1802000,908000,894000,894000
08637P,台灣50中信96售03,0,0,0,0,0,0,0,0,0,890000,0,0,0,1080000,190000,890000,890000
041912,上緯控元大92購01,0,0,0,0,0,0,0,0,0,889000,0,0,0,930000,41000,889000,889000
03769P,聯發科元大93售04,0,0,0,0,0,0,0,0,0,879000,0,0,0,880000,1000,879000,879000
2014,中鴻            ,1037000,120000,917000,0,0,0,0,0,0,-48000,13000,0,13000,0,61000,-61000,869000
04751P,智邦兆豐95售02  ,0,0,0,0,0,0,0,0,0,859000,0,0,0,887000,28000,859000,859000
047361,致茂群益93購01  ,0,0,0,0,0,0,0,0,0,856000,0,0,0,940000,84000,856000,856000
8163,達方            ,990000,303000,687000,0,0,0,250000,0,250000,-83000,8000,12000,-4000,2000,81000,-79000,854000
05002P,台積電統一95售03,0,0,0,0,0,0,0,0,0,851000,0,0,0,977000,126000,851000,851000
05998P,台積電元大97售12,0,0,0,0,0,0,0,0,0,847000,0,0,0,1312000,465000,847000,847000
050504,全新凱基94購03  ,0,0,0,0,0,0,0,0,0,843000,0,0,0,843000,0,843000,843000
050388,鴻海統一94購09  ,0,0,0,0,0,0,0,0,0,834000,0,0,0,1686000,852000,834000,834000
05447P,臺股指元大95售24,0,0,0,0,0,0,0,0,0,831000,0,0,0,1627000,796000,831000,831000
3042,晶技            ,1133000,308000,825000,0,0,0,0,0,0,2000,0,24000,-24000,39000,13000,26000,827000
046742,智原日盛93購01  ,0,0,0,0,0,0,0,0,0,824000,0,0,0,952000,128000,824000,824000
05964P,華通凱基96售06  ,0,0,0,0,0,0,0,0,0,824000,0,0,0,880000,56000,824000,824000
03777P,華通中信95售01  ,0,0,0,0,0,0,0,0,0,812000,0,0,0,874000,62000,812000,812000
040167,FBVIX元大92購02 ,0,0,0,0,0,0,0,0,0,810000,0,0,0,810000,0,810000,810000
05091P,台積電元大95售11,0,0,0,0,0,0,0,0,0,805000,0,0,0,1106000,301000,805000,805000
050755,和大元富94購01  ,0,0,0,0,0,0,0,0,0,794000,0,0,0,1967000,1173000,794000,794000
054329,華新科永豐96購02,0,0,0,0,0,0,0,0,0,791000,0,0,0,1030000,239000,791000,791000
051259,鴻海永昌96購03  ,0,0,0,0,0,0,0,0,0,787000,0,0,0,2270000,1483000,787000,787000
050972,台虹永豐95購01  ,0,0,0,0,0,0,0,0,0,786000,0,0,0,900000,114000,786000,786000
05080P,亞光永豐95售02  ,0,0,0,0,0,0,0,0,0,771000,0,0,0,923000,152000,771000,771000
2383,台光電          ,1483000,602659,880341,0,0,0,76000,246000,-170000,51000,105000,136000,-31000,127000,45000,82000,761341
04476P,玉晶光元大94售05,0,0,0,0,0,0,0,0,0,760000,0,0,0,770000,10000,760000,760000
1609,大亞            ,806000,59000,747000,0,0,0,0,0,0,7000,7000,0,7000,0,0,0,754000
2419,仲琦            ,726000,53000,673000,0,0,0,0,0,0,74000,74000,0,74000,0,0,0,747000
00693U,街口S&P黃豆     ,0,0,0,0,0,0,0,0,0,746000,0,0,0,799000,53000,746000,746000
3056,總太            ,827000,84000,743000,0,0,0,0,0,0,0,0,0,0,0,0,0,743000
2812,台中銀          ,876000,140000,736000,0,0,0,0,0,0,0,0,0,0,0,0,0,736000
05759P,智邦永豐96售02  ,0,0,0,0,0,0,0,0,0,735000,0,0,0,735000,0,735000,735000
045096,達方元大92購01  ,0,0,0,0,0,0,0,0,0,730000,0,0,0,730000,0,730000,730000
050546,可成凱基94購13  ,0,0,0,0,0,0,0,0,0,729000,0,0,0,810000,81000,729000,729000
05641P,貿聯元富96售02  ,0,0,0,0,0,0,0,0,0,725000,0,0,0,726000,1000,725000,725000
05991P,聯茂群益96售05  ,0,0,0,0,0,0,0,0,0,725000,0,0,0,834000,109000,725000,725000
06011P,貿聯元富96售04  ,0,0,0,0,0,0,0,0,0,722000,0,0,0,722000,0,722000,722000
051229,亞光群益95購01  ,0,0,0,0,0,0,0,0,0,717000,0,0,0,719000,2000,717000,717000
2838,聯邦銀          ,758000,46000,712000,0,0,0,0,0,0,0,0,0,0,0,0,0,712000
053317,友達群益9A購02  ,0,0,0,0,0,0,0,0,0,704000,0,0,0,714000,10000,704000,704000
04806P,臻鼎元富94售06  ,0,0,0,0,0,0,0,0,0,703000,0,0,0,855000,152000,703000,703000
052115,T50反1國票95購03,0,0,0,0,0,0,0,0,0,703000,0,0,0,1403000,700000,703000,703000
046451,中環凱基93購02  ,0,0,0,0,0,0,0,0,0,699000,0,0,0,699000,0,699000,699000
051877,嘉聯益國票97購02,0,0,0,0,0,0,0,0,0,697000,0,0,0,699000,2000,697000,697000
052652,台虹永豐96購01  ,0,0,0,0,0,0,0,0,0,696000,0,0,0,769000,73000,696000,696000
049728,正崴中信94購01  ,0,0,0,0,0,0,0,0,0,695000,0,0,0,820000,125000,695000,695000
054268,健策第一96購01  ,0,0,0,0,0,0,0,0,0,694000,0,0,0,985000,291000,694000,694000
04748P,臺股指元大94售23,0,0,0,0,0,0,0,0,0,687000,0,0,0,687000,0,687000,687000
051367,可成富邦97購01  ,0,0,0,0,0,0,0,0,0,681000,0,0,0,681000,0,681000,681000
05420P,大立光國泰97售03,0,0,0,0,0,0,0,0,0,677000,0,0,0,745000,68000,677000,677000
046286,高鐵兆豐93購01  ,0,0,0,0,0,0,0,0,0,671000,0,0,0,671000,0,671000,671000
05497P,聯詠統一96售01  ,0,0,0,0,0,0,0,0,0,669000,0,0,0,812000,143000,669000,669000
05266P,華新科元大95售11,0,0,0,0,0,0,0,0,0,668000,0,0,0,795000,127000,668000,668000
05286P,矽力統一95售02  ,0,0,0,0,0,0,0,0,0,667000,0,0,0,667000,0,667000,667000
044429,元金2X元大94購04,0,0,0,0,0,0,0,0,0,664000,0,0,0,1326000,662000,664000,664000
05850P,台積電兆豐96售06,0,0,0,0,0,0,0,0,0,661000,0,0,0,816000,155000,661000,661000
1103,嘉泥            ,668000,54000,614000,0,0,0,0,0,0,34000,0,0,0,41000,7000,34000,648000
040168,FBVIX元大92購03 ,0,0,0,0,0,0,0,0,0,644000,0,0,0,644000,0,644000,644000
04471P,華通元大95售03  ,0,0,0,0,0,0,0,0,0,641000,0,0,0,830000,189000,641000,641000
051364,鴻海國泰97購03  ,0,0,0,0,0,0,0,0,0,640000,0,0,0,715000,75000,640000,640000
04444P,玉晶光永豐94售06,0,0,0,0,0,0,0,0,0,638000,0,0,0,638000,0,638000,638000
05224P,華通統一95售03  ,0,0,0,0,0,0,0,0,0,637000,0,0,0,814000,177000,637000,637000
05278P,台郡元富95售02  ,0,0,0,0,0,0,0,0,0,634000,0,0,0,677000,43000,634000,634000
05507P,聯茂凱基96售02  ,0,0,0,0,0,0,0,0,0,630000,0,0,0,630000,0,630000,630000
04616P,臺股指群益95售02,0,0,0,0,0,0,0,0,0,630000,0,0,0,730000,100000,630000,630000
05181P,健策凱基95售01  ,0,0,0,0,0,0,0,0,0,620000,0,0,0,754000,134000,620000,620000
05704P,矽力群益96售04  ,0,0,0,0,0,0,0,0,0,620000,0,0,0,630000,10000,620000,620000
047412,鴻海永昌93購05  ,0,0,0,0,0,0,0,0,0,614000,0,0,0,620000,6000,614000,614000
047887,智原富邦97購01  ,0,0,0,0,0,0,0,0,0,613000,0,0,0,713000,100000,613000,613000
049054,禾伸堂永豐94購01,0,0,0,0,0,0,0,0,0,613000,0,0,0,664000,51000,613000,613000
048294,智原群益93購02  ,0,0,0,0,0,0,0,0,0,612000,0,0,0,733000,121000,612000,612000
05499P,聯詠元富95售02  ,0,0,0,0,0,0,0,0,0,611000,0,0,0,631000,20000,611000,611000
041452,滬深2X元富93購01,0,0,0,0,0,0,0,0,0,603000,0,0,0,1430000,827000,603000,603000
03063P,臺股指凱基04售03,0,0,0,0,0,0,0,0,0,601000,0,0,0,601000,0,601000,601000
05407P,超眾凱基95售04  ,0,0,0,0,0,0,0,0,0,600000,0,0,0,600000,0,600000,600000
051358,台新金元大95購01,0,0,0,0,0,0,0,0,0,600000,0,0,0,600000,0,600000,600000
05076P,深中小群益99售02,0,0,0,0,0,0,0,0,0,600000,0,0,0,600000,0,600000,600000
052623,台郡兆豐96購01  ,0,0,0,0,0,0,0,0,0,598000,0,0,0,643000,45000,598000,598000
04783P,貿聯元富94售01  ,0,0,0,0,0,0,0,0,0,597000,0,0,0,597000,0,597000,597000
3006,晶豪科          ,704000,302000,402000,0,0,0,200000,0,200000,-6000,20000,3000,17000,42000,65000,-23000,596000
048591,台郡兆豐94購01  ,0,0,0,0,0,0,0,0,0,595000,0,0,0,610000,15000,595000,595000
046053,滬深2X群益94購01,0,0,0,0,0,0,0,0,0,594000,0,0,0,594000,0,594000,594000
053363,旺宏國泰98購02  ,0,0,0,0,0,0,0,0,0,593000,0,0,0,847000,254000,593000,593000
046647,高鐵國泰93購01  ,0,0,0,0,0,0,0,0,0,592000,0,0,0,659000,67000,592000,592000
04931P,臻鼎元富94售09  ,0,0,0,0,0,0,0,0,0,581000,0,0,0,726000,145000,581000,581000
045580,冠德元大92購02  ,0,0,0,0,0,0,0,0,0,580000,0,0,0,590000,10000,580000,580000
051336,智原永豐95購01  ,0,0,0,0,0,0,0,0,0,575000,0,0,0,670000,95000,575000,575000
03874P,臺股指群益95售01,0,0,0,0,0,0,0,0,0,574000,0,0,0,605000,31000,574000,574000
03413B,臺股指凱基94熊19,0,0,0,0,0,0,0,0,0,574000,0,0,0,704000,130000,574000,574000
047762,華新元大93購02  ,0,0,0,0,0,0,0,0,0,567000,0,0,0,667000,100000,567000,567000
046166,嘉聯益兆豐93購01,0,0,0,0,0,0,0,0,0,567000,0,0,0,572000,5000,567000,567000
045722,揚明光凱基92購03,0,0,0,0,0,0,0,0,0,564000,0,0,0,564000,0,564000,564000
050372,全新元大96購03  ,0,0,0,0,0,0,0,0,0,562000,0,0,0,689000,127000,562000,562000
04621P,楠梓電統一94售02,0,0,0,0,0,0,0,0,0,560000,0,0,0,644000,84000,560000,560000
043998,達方元大91購01  ,0,0,0,0,0,0,0,0,0,560000,0,0,0,580000,20000,560000,560000
047630,元油反元大96購02,0,0,0,0,0,0,0,0,0,555000,0,0,0,555000,0,555000,555000
052621,台郡富邦97購01  ,0,0,0,0,0,0,0,0,0,554000,0,0,0,673000,119000,554000,554000
4968,立積            ,1044000,393000,651000,0,0,0,30000,48000,-18000,-81000,14000,95000,-81000,0,0,0,552000
6282,康舒            ,829000,249000,580000,0,0,0,0,0,0,-29000,0,4000,-4000,7000,32000,-25000,551000
1303,南亞            ,1622000,1312241,309759,0,0,0,261000,0,261000,-20000,0,20000,-20000,0,0,0,550759
6706,惠特            ,134000,63000,71000,0,0,0,472000,0,472000,7000,12000,5000,7000,0,0,0,550000
04013P,漢唐元大93售05  ,0,0,0,0,0,0,0,0,0,549000,0,0,0,549000,0,549000,549000
1210,大成            ,1202000,94188,1107812,0,0,0,0,568447,-568447,8000,10000,2000,8000,0,0,0,547365
03511P,臺股指群益02售16,0,0,0,0,0,0,0,0,0,546000,0,0,0,614000,68000,546000,546000
043936,和大兆豐92購01  ,0,0,0,0,0,0,0,0,0,546000,0,0,0,957000,411000,546000,546000
053457,旺宏國泰98購03  ,0,0,0,0,0,0,0,0,0,545000,0,0,0,841000,296000,545000,545000
051143,鴻海凱基95購11  ,0,0,0,0,0,0,0,0,0,545000,0,0,0,836000,291000,545000,545000
042916,佐登元大94購01  ,0,0,0,0,0,0,0,0,0,542000,0,0,0,988000,446000,542000,542000
054585,禾伸堂國泰99購01,0,0,0,0,0,0,0,0,0,539000,0,0,0,676000,137000,539000,539000
05469P,台積電元大95售24,0,0,0,0,0,0,0,0,0,532000,0,0,0,932000,400000,532000,532000
052461,和大統一95購01  ,1000,0,1000,0,0,0,0,0,0,531000,0,0,0,670000,139000,531000,532000
041973,台灣50中信94購01,0,0,0,0,0,0,0,0,0,531000,0,0,0,1205000,674000,531000,531000
05253P,智邦凱基95售08  ,0,0,0,0,0,0,0,0,0,530000,0,0,0,535000,5000,530000,530000
052758,友達群益99購01  ,0,0,0,0,0,0,0,0,0,527000,0,0,0,537000,10000,527000,527000
05158P,華通永豐95售01  ,0,0,0,0,0,0,0,0,0,526000,0,0,0,642000,116000,526000,526000
04347P,全新群益94售01  ,0,0,0,0,0,0,0,0,0,524000,0,0,0,524000,0,524000,524000
03152P,聯發科群益01售15,0,0,0,0,0,0,0,0,0,524000,0,0,0,524000,0,524000,524000
047978,元油反群益97購01,0,0,0,0,0,0,0,0,0,523000,0,0,0,528000,5000,523000,523000
04693P,超眾群益95售01  ,0,0,0,0,0,0,0,0,0,522000,0,0,0,542000,20000,522000,522000
2006,東和鋼鐵        ,589515,70000,519515,0,0,0,0,0,0,0,0,0,0,0,0,0,519515
03148P,聯電群益03售04  ,0,0,0,0,0,0,0,0,0,517000,0,0,0,593000,76000,517000,517000
05722P,玉晶光國票97售03,0,0,0,0,0,0,0,0,0,517000,0,0,0,1060000,543000,517000,517000
048882,智原統一96購01  ,0,0,0,0,0,0,0,0,0,516000,0,0,0,758000,242000,516000,516000
05268P,玉晶光元大98售01,0,0,0,0,0,0,0,0,0,514000,0,0,0,706000,192000,514000,514000
049038,高鐵兆豐94購01  ,0,0,0,0,0,0,0,0,0,512000,0,0,0,542000,30000,512000,512000
2809,京城銀          ,1239000,914694,324306,0,0,0,0,0,0,184000,184000,0,184000,0,0,0,508306
006206,元大上證50      ,221000,1000,220000,0,0,0,0,0,0,287597,90000,0,90000,377000,179403,197597,507597
03109P,台積電元大01售41,0,0,0,0,0,0,0,0,0,505000,0,0,0,541000,36000,505000,505000
043641,深中小國票94購01,0,0,0,0,0,0,0,0,0,505000,0,0,0,513000,8000,505000,505000
049948,聯發科麥證94購01,0,0,0,532000,30000,502000,0,0,0,502000,0,0,0,532000,30000,502000,502000
047886,京元電富邦95購01,0,0,0,0,0,0,0,0,0,502000,0,0,0,522000,20000,502000,502000
048876,牧德國票95購02  ,0,0,0,0,0,0,0,0,0,501000,0,0,0,503000,2000,501000,501000
04133P,友達群益93售01  ,0,0,0,0,0,0,0,0,0,500000,0,0,0,500000,0,500000,500000
05039P,鴻海凱基95售10  ,0,0,0,0,0,0,0,0,0,500000,0,0,0,500000,0,500000,500000
05406P,台光電凱基95售02,0,0,0,0,0,0,0,0,0,499000,0,0,0,499000,0,499000,499000
053846,友達元富99購02  ,0,0,0,0,0,0,0,0,0,499000,0,0,0,499000,0,499000,499000
042119,宏達電國票91購01,0,0,0,0,0,0,0,0,0,499000,0,0,0,499000,0,499000,499000
03786P,鴻海群益94售02  ,0,0,0,0,0,0,0,0,0,499000,0,0,0,499000,0,499000,499000
03669P,智邦凱基92售07  ,0,0,0,0,0,0,0,0,0,499000,0,0,0,499000,0,499000,499000
03702P,中磊元大93售02  ,0,0,0,0,0,0,0,0,0,499000,0,0,0,499000,0,499000,499000
04744P,臻鼎元富94售04  ,0,0,0,0,0,0,0,0,0,499000,0,0,0,499000,0,499000,499000
05072P,聯電元富95售02  ,0,0,0,0,0,0,0,0,0,499000,0,0,0,499000,0,499000,499000
053288,臺股指元大96購16,0,0,0,0,0,0,0,0,0,498000,0,0,0,498000,0,498000,498000
048934,日電貿永豐94購01,0,0,0,0,0,0,0,0,0,498000,0,0,0,532000,34000,498000,498000
051233,力成群益97購01  ,0,0,0,0,0,0,0,0,0,496000,0,0,0,591000,95000,496000,496000
052210,華夏元大95購01  ,0,0,0,0,0,0,0,0,0,495000,0,0,0,535000,40000,495000,495000
043010,友達元大92購01  ,0,0,0,0,0,0,0,0,0,494000,0,0,0,499000,5000,494000,494000
052293,泰碩國票95購03  ,0,0,0,0,0,0,0,0,0,491000,0,0,0,501000,10000,491000,491000
05374P,台積電國票96售07,0,0,0,0,0,0,0,0,0,491000,0,0,0,580000,89000,491000,491000
04487P,南亞科凱基94售01,0,0,0,0,0,0,0,0,0,491000,0,0,0,501000,10000,491000,491000
05332P,臺股指國票95售01,0,0,0,0,0,0,0,0,0,490000,0,0,0,490000,0,490000,490000
053062,緯穎富邦97購01  ,0,0,0,0,0,0,0,0,0,490000,0,0,0,490000,0,490000,490000
05348P,美律元富98售01  ,0,0,0,0,0,0,0,0,0,489000,0,0,0,499000,10000,489000,489000
052382,臺股指元大95購23,0,0,0,0,0,0,0,0,0,487000,0,0,0,487000,0,487000,487000
1514,亞力            ,495000,9000,486000,0,0,0,0,0,0,0,0,0,0,0,0,0,486000
04369P,台光電凱基94售04,0,0,0,0,0,0,0,0,0,484000,0,0,0,590000,106000,484000,484000
04888P,臺股指凱基95售03,0,0,0,0,0,0,0,0,0,482000,0,0,0,488000,6000,482000,482000
053603,臺股指元大96購20,0,0,0,0,0,0,0,0,0,480000,0,0,0,492000,12000,480000,480000
048897,日電貿國泰95購01,0,0,0,0,0,0,0,0,0,480000,0,0,0,517000,37000,480000,480000
6451,訊芯-KY         ,846000,392000,454000,0,0,0,0,0,0,26000,2000,12000,-10000,72000,36000,36000,480000
049104,元油2X富邦97購02,0,0,0,0,0,0,0,0,0,478000,0,0,0,494000,16000,478000,478000
049504,臺股指元大94購15,0,0,0,0,0,0,0,0,0,476000,0,0,0,484000,8000,476000,476000
03579P,玉晶光台新02售02,0,0,0,0,0,0,0,0,0,475000,0,0,0,523000,48000,475000,475000
05832P,臺股指元富96售04,0,0,0,0,0,0,0,0,0,475000,0,0,0,475000,0,475000,475000
047421,聯茂富邦97購01  ,0,0,0,0,0,0,0,0,0,474000,0,0,0,696000,222000,474000,474000
042191,元油2X富邦93購01,0,0,0,0,0,0,0,0,0,473000,0,0,0,473000,0,473000,473000
051825,中環元大95購01  ,0,0,0,0,0,0,0,0,0,473000,0,0,0,636000,163000,473000,473000
052273,新光金群益95購02,0,0,0,0,0,0,0,0,0,471000,0,0,0,1096000,625000,471000,471000
053885,全新兆豐96購01  ,0,0,0,0,0,0,0,0,0,470000,0,0,0,569000,99000,470000,470000
044800,華邦電凱基93購02,0,0,0,0,0,0,0,0,0,470000,0,0,0,509000,39000,470000,470000
048666,康控統一93購01  ,0,0,0,0,0,0,0,0,0,470000,0,0,0,494000,24000,470000,470000
053889,致茂群益97購01  ,0,0,0,0,0,0,0,0,0,468000,0,0,0,551000,83000,468000,468000
042363,復盛元大91購01  ,0,0,0,0,0,0,0,0,0,467000,0,0,0,507000,40000,467000,467000
051223,台化群益95購01  ,0,0,0,0,0,0,0,0,0,463000,0,0,0,504000,41000,463000,463000
041917,上証2X群益92購01,0,0,0,0,0,0,0,0,0,460000,0,0,0,460000,0,460000,460000
03969P,華新科國票94售01,0,0,0,0,0,0,0,0,0,460000,0,0,0,520000,60000,460000,460000
04735P,聯茂兆豐94售01  ,0,0,0,0,0,0,0,0,0,460000,0,0,0,460000,0,460000,460000
046171,中環永豐92購01  ,0,0,0,0,0,0,0,0,0,459000,0,0,0,459000,0,459000,459000
050051,智原群益94購01  ,0,0,0,0,0,0,0,0,0,459000,0,0,0,540000,81000,459000,459000
05397P,大立光凱基96售08,0,0,0,0,0,0,0,0,0,457000,0,0,0,469000,12000,457000,457000
03087P,聯發科元大01售24,0,0,0,0,0,0,0,0,0,456000,0,0,0,468000,12000,456000,456000
2104,國際中橡        ,573990,131000,442990,0,0,0,10000,0,10000,0,0,0,0,0,0,0,452990
049041,和鑫兆豐94購01  ,0,0,0,0,0,0,0,0,0,452000,0,0,0,490000,38000,452000,452000
048889,牧德元富94購03  ,0,0,0,0,0,0,0,0,0,452000,0,0,0,544000,92000,452000,452000
04617P,臺股指群益95售03,0,0,0,0,0,0,0,0,0,451000,0,0,0,566000,115000,451000,451000
1722,台肥            ,504000,50000,454000,0,0,0,3000,0,3000,-6000,0,0,0,1000,7000,-6000,451000
2537,聯上發          ,586000,135000,451000,0,0,0,0,0,0,0,0,0,0,0,0,0,451000
03075P,泰碩國泰03售01  ,0,0,0,0,0,0,0,0,0,450000,0,0,0,450000,0,450000,450000
04191P,儒鴻永豐93售02  ,0,0,0,0,0,0,0,0,0,450000,0,0,0,450000,0,450000,450000
05885P,牧德統一96售01  ,0,0,0,0,0,0,0,0,0,450000,0,0,0,630000,180000,450000,450000
054458,復盛群益96購01  ,0,0,0,0,0,0,0,0,0,447000,0,0,0,504000,57000,447000,447000
05038P,牧德元大95售03  ,0,0,0,0,0,0,0,0,0,443000,0,0,0,443000,0,443000,443000
03183P,鴻海元大01售28  ,0,0,0,0,0,0,0,0,0,442000,0,0,0,524000,82000,442000,442000
045371,元石油元大95購01,0,0,0,0,0,0,0,0,0,442000,0,0,0,452000,10000,442000,442000
054182,台積電康和96購01,0,0,0,0,0,0,0,0,0,441000,0,0,0,509000,68000,441000,441000
03882P,鴻海元大93售10  ,0,0,0,0,0,0,0,0,0,440000,0,0,0,440000,0,440000,440000
047624,台達電國票93購01,0,0,0,0,0,0,0,0,0,440000,0,0,0,940000,500000,440000,440000
049565,楠梓電統一94購01,0,0,0,0,0,0,0,0,0,440000,0,0,0,440000,0,440000,440000
051603,深中小群益99購03,0,0,0,0,0,0,0,0,0,438000,0,0,0,600000,162000,438000,438000
05779P,台積電統一96售06,0,0,0,0,0,0,0,0,0,437000,0,0,0,437000,0,437000,437000
03833P,台光電群益93售01,0,0,0,0,0,0,0,0,0,436000,0,0,0,457000,21000,436000,436000
05126P,牧德群益95售01  ,0,0,0,0,0,0,0,0,0,436000,0,0,0,458000,22000,436000,436000
053650,華邦電凱基98購01,0,0,0,0,0,0,0,0,0,435000,0,0,0,630000,195000,435000,435000
052243,致茂康和95購01  ,0,0,0,0,0,0,0,0,0,435000,0,0,0,435000,0,435000,435000
048372,美利達統一93購01,0,0,0,0,0,0,0,0,0,432000,0,0,0,432000,0,432000,432000
0061,元大寶滬深      ,309000,0,309000,0,0,0,0,0,0,121000,80000,0,80000,144000,103000,41000,430000
04592P,台積電元大94售10,0,0,0,0,0,0,0,0,0,430000,0,0,0,430000,0,430000,430000
053853,康控國泰97購02  ,0,0,0,0,0,0,0,0,0,429000,0,0,0,448000,19000,429000,429000
8112,至上            ,780000,374000,406000,0,0,0,0,0,0,23000,25000,0,25000,0,2000,-2000,429000
05841P,華通元大96售04  ,0,0,0,0,0,0,0,0,0,428000,0,0,0,496000,68000,428000,428000
04837P,華新科元大94售05,0,0,0,0,0,0,0,0,0,426000,0,0,0,682000,256000,426000,426000
05527P,聯茂群益96售01  ,0,0,0,0,0,0,0,0,0,424000,0,0,0,486000,62000,424000,424000
052430,泰碩永豐95購02  ,0,0,0,0,0,0,0,0,0,424000,0,0,0,444000,20000,424000,424000
043958,臻鼎元富94購01  ,0,0,0,0,0,0,0,0,0,424000,0,0,0,544000,120000,424000,424000
043665,和鑫元大93購01  ,0,0,0,0,0,0,0,0,0,424000,0,0,0,424000,0,424000,424000
05151P,台光電群益95售02,0,0,0,0,0,0,0,0,0,423000,0,0,0,464000,41000,423000,423000
05065P,燿華元大96售03  ,0,0,0,0,0,0,0,0,0,422000,0,0,0,531000,109000,422000,422000
046205,明基材凱基93購01,0,0,0,0,0,0,0,0,0,420000,0,0,0,420000,0,420000,420000
049297,日電貿群益95購01,0,0,0,0,0,0,0,0,0,420000,0,0,0,626000,206000,420000,420000
6196,帆宣            ,790000,166698,623302,0,0,0,0,0,0,-204000,0,204000,-204000,0,0,0,419302
045534,深中小群益94購01,0,0,0,0,0,0,0,0,0,415000,0,0,0,415000,0,415000,415000
047844,台虹元大93購02  ,0,0,0,0,0,0,0,0,0,415000,0,0,0,786000,371000,415000,415000
052351,中環元富95購01  ,0,0,0,0,0,0,0,0,0,414000,0,0,0,578000,164000,414000,414000
046151,矽創國票92購02  ,0,0,0,0,0,0,0,0,0,414000,0,0,0,414000,0,414000,414000
050730,復盛國票94購01  ,0,0,0,0,0,0,0,0,0,414000,0,0,0,422000,8000,414000,414000
050685,緯穎元富94購02  ,0,0,0,0,0,0,0,0,0,413000,0,0,0,511000,98000,413000,413000
049220,聯發科國票95購02,0,0,0,0,0,0,0,0,0,412000,0,0,0,412000,0,412000,412000
052707,景碩台新96購01  ,0,0,0,0,0,0,0,0,0,410000,0,0,0,410000,0,410000,410000
053478,京鼎元大96購01  ,0,0,0,0,0,0,0,0,0,410000,0,0,0,420000,10000,410000,410000
04035P,全新群益93售03  ,0,0,0,0,0,0,0,0,0,410000,0,0,0,432000,22000,410000,410000
05444P,大立光元大95售10,0,0,0,0,0,0,0,0,0,409000,0,0,0,511000,102000,409000,409000
03267P,台灣50元大02售06,0,0,0,0,0,0,0,0,0,409000,0,0,0,430000,21000,409000,409000
053019,禾伸堂元富96購01,0,0,0,0,0,0,0,0,0,407000,0,0,0,498000,91000,407000,407000
048672,日電貿永豐93購02,0,0,0,0,0,0,0,0,0,406000,0,0,0,580000,174000,406000,406000
053035,台表科兆豐97購01,0,0,0,0,0,0,0,0,0,405000,0,0,0,448000,43000,405000,405000
05491P,茂林元大95售04  ,0,0,0,0,0,0,0,0,0,405000,0,0,0,667000,262000,405000,405000
04234P,華通群益94售02  ,0,0,0,0,0,0,0,0,0,405000,0,0,0,540000,135000,405000,405000
04053P,聯茂國泰94售01  ,0,0,0,0,0,0,0,0,0,404000,0,0,0,424000,20000,404000,404000
051538,和碩國票96購01  ,0,0,0,0,0,0,0,0,0,403000,0,0,0,458000,55000,403000,403000
05909P,康友元富96售02  ,0,0,0,0,0,0,0,0,0,403000,0,0,0,465000,62000,403000,403000
03686P,大立光統一98售02,0,0,0,0,0,0,0,0,0,402000,0,0,0,432000,30000,402000,402000
3545,敦泰            ,577000,175000,402000,0,0,0,0,0,0,0,0,0,0,0,0,0,402000
05235P,健鼎康和95售02  ,0,0,0,0,0,0,0,0,0,401000,0,0,0,496000,95000,401000,401000
051077,台郡國泰96購02  ,0,0,0,0,0,0,0,0,0,401000,0,0,0,664000,263000,401000,401000
05488P,臺股指凱基95售21,0,0,0,0,0,0,0,0,0,400000,0,0,0,400000,0,400000,400000
00662,富邦NASDAQ      ,4000,0,4000,0,0,0,0,0,0,396000,0,0,0,489000,93000,396000,400000
04746P,臺股指元大94售17,0,0,0,0,0,0,0,0,0,400000,0,0,0,400000,0,400000,400000
049406,T50反1日盛97購01,0,0,0,0,0,0,0,0,0,400000,0,0,0,400000,0,400000,400000
048177,臺指反富邦99購01,0,0,0,0,0,0,0,0,0,400000,0,0,0,400000,0,400000,400000
046726,台新金元大93購01,0,0,0,0,0,0,0,0,0,400000,0,0,0,400000,0,400000,400000
049709,力山凱基94購04  ,0,0,0,0,0,0,0,0,0,400000,0,0,0,400000,0,400000,400000
048260,鴻海元富93購06  ,0,0,0,0,0,0,0,0,0,398000,0,0,0,398000,0,398000,398000
3023,信邦            ,274900,159000,115900,0,0,0,267000,0,267000,14000,0,22000,-22000,42000,6000,36000,396900
05031P,台光電元富95售01,0,0,0,0,0,0,0,0,0,395000,0,0,0,395000,0,395000,395000
052353,高鐵群益97購01  ,0,0,0,0,0,0,0,0,0,392000,0,0,0,496000,104000,392000,392000
051762,國泰金元大95購01,0,0,0,0,0,0,0,0,0,391000,0,0,0,391000,0,391000,391000
05509P,智邦元富96售02  ,0,0,0,0,0,0,0,0,0,390000,0,0,0,564000,174000,390000,390000
046321,群創元大92購07  ,0,0,0,0,0,0,0,0,0,390000,0,0,0,395000,5000,390000,390000
043835,宏達電國票92購01,0,0,0,0,0,0,0,0,0,390000,0,0,0,390000,0,390000,390000
04404P,玉晶光國票94售01,0,0,0,0,0,0,0,0,0,390000,0,0,0,440000,50000,390000,390000
04861P,中磊群益94售02  ,0,0,0,0,0,0,0,0,0,390000,0,0,0,465000,75000,390000,390000
04577P,康友元富94售02  ,0,0,0,0,0,0,0,0,0,389000,0,0,0,499000,110000,389000,389000
049894,嘉聯益富邦98購01,0,0,0,0,0,0,0,0,0,389000,0,0,0,389000,0,389000,389000
052464,大立光統一95購05,0,0,0,0,0,0,0,0,0,388000,0,0,0,416000,28000,388000,388000
04213P,台光電凱基93售11,0,0,0,0,0,0,0,0,0,388000,0,0,0,454000,66000,388000,388000
05077P,智易群益95售02  ,0,0,0,0,0,0,0,0,0,388000,0,0,0,398000,10000,388000,388000
047035,華邦電群益94購02,0,0,0,0,0,0,0,0,0,387000,0,0,0,956000,569000,387000,387000
053160,台表科元大96購03,0,0,0,0,0,0,0,0,0,386000,0,0,0,524000,138000,386000,386000
045235,致茂中信93購01  ,0,0,0,0,0,0,0,0,0,386000,0,0,0,406000,20000,386000,386000
03765P,大立光元富96售01,0,0,0,0,0,0,0,0,0,382000,0,0,0,382000,0,382000,382000
052793,健鼎兆豐96購01  ,0,0,0,0,0,0,0,0,0,380000,0,0,0,400000,20000,380000,380000
047759,復盛元富93購01  ,0,0,0,0,0,0,0,0,0,380000,0,0,0,431000,51000,380000,380000
04946P,華通元大94售04  ,0,0,0,0,0,0,0,0,0,380000,0,0,0,594000,214000,380000,380000
04670P,臺股指國票94售09,0,0,0,0,0,0,0,0,0,379000,0,0,0,490000,111000,379000,379000
051128,台表科群益95購02,0,0,0,0,0,0,0,0,0,379000,0,0,0,600000,221000,379000,379000
049738,神基群益94購01  ,0,0,0,0,0,0,0,0,0,378000,0,0,0,400000,22000,378000,378000
1710,東聯            ,479000,104277,374723,0,0,0,3000,0,3000,0,0,0,0,0,0,0,377723
043735,元金2X元大94購01,0,0,0,0,0,0,0,0,0,375000,0,0,0,655000,280000,375000,375000
047807,華邦電凱基93購06,0,0,0,0,0,0,0,0,0,375000,0,0,0,465000,90000,375000,375000
047460,富邦金群益95購01,0,0,0,0,0,0,0,0,0,375000,0,0,0,375000,0,375000,375000
04710P,台積電元大94售16,0,0,0,0,0,0,0,0,0,375000,0,0,0,525000,150000,375000,375000
03450P,元油2X元富98售05,0,0,0,0,0,0,0,0,0,374000,0,0,0,429000,55000,374000,374000
046704,智原元富93購01  ,0,0,0,0,0,0,0,0,0,372000,0,0,0,402000,30000,372000,372000
3030,德律            ,413000,41000,372000,0,0,0,0,0,0,0,0,0,0,0,0,0,372000
05669P,嘉晶永豐96售03  ,0,0,0,0,0,0,0,0,0,372000,0,0,0,383000,11000,372000,372000
042801,達邁元大93購01  ,0,0,0,0,0,0,0,0,0,371000,0,0,0,553000,182000,371000,371000
04862P,台積電元大94售26,0,0,0,0,0,0,0,0,0,371000,0,0,0,719000,348000,371000,371000
2855,統一證          ,673000,302000,371000,0,0,0,0,0,0,0,0,0,0,0,0,0,371000
03772P,聯茂元大93售02  ,0,0,0,0,0,0,0,0,0,370000,0,0,0,370000,0,370000,370000
03535P,臺股指凱基02售14,0,0,0,0,0,0,0,0,0,370000,0,0,0,370000,0,370000,370000
051235,鴻海元大95購06  ,0,0,0,0,0,0,0,0,0,370000,0,0,0,685000,315000,370000,370000
053026,奇力新富邦98購01,0,0,0,0,0,0,0,0,0,368000,0,0,0,884000,516000,368000,368000
049776,全新統一95購02  ,0,0,0,0,0,0,0,0,0,368000,0,0,0,588000,220000,368000,368000
6269,台郡            ,1731000,1021146,709854,0,0,0,0,0,0,-342000,152000,198000,-46000,35000,331000,-296000,367854
04080P,可成元大93售11  ,0,0,0,0,0,0,0,0,0,367000,0,0,0,540000,173000,367000,367000
04541P,智易永豐94售03  ,0,0,0,0,0,0,0,0,0,367000,0,0,0,367000,0,367000,367000
043642,元金2X國票97購01,0,0,0,0,0,0,0,0,0,366000,0,0,0,376000,10000,366000,366000
046118,高鐵元大92購01  ,0,0,0,0,0,0,0,0,0,366000,0,0,0,479000,113000,366000,366000
05081P,京鼎永豐95售01  ,0,0,0,0,0,0,0,0,0,364000,0,0,0,364000,0,364000,364000
03859P,聯詠元富93售04  ,0,0,0,0,0,0,0,0,0,362000,0,0,0,392000,30000,362000,362000
049951,全新群益94購03  ,0,0,0,0,0,0,0,0,0,362000,0,0,0,558000,196000,362000,362000
044463,全新兆豐93購01  ,0,0,0,0,0,0,0,0,0,361000,0,0,0,556000,195000,361000,361000
049740,禾伸堂群益94購01,0,0,0,0,0,0,0,0,0,361000,0,0,0,438000,77000,361000,361000
049792,元油2X元大94購08,0,0,0,0,0,0,0,0,0,360000,0,0,0,360000,0,360000,360000
051003,中環中信97購01  ,0,0,0,0,0,0,0,0,0,360000,0,0,0,397000,37000,360000,360000
052079,康友元富98購01  ,0,0,0,0,0,0,0,0,0,359000,0,0,0,379000,20000,359000,359000
05551P,電子類元大96售01,0,0,0,0,0,0,0,0,0,358000,0,0,0,519000,161000,358000,358000
3665,貿聯-KY         ,426000,331000,95000,0,0,0,183000,0,183000,80000,81000,82000,-1000,120000,39000,81000,358000
05248P,矽創群益96售01  ,0,0,0,0,0,0,0,0,0,357000,0,0,0,357000,0,357000,357000
049206,大立光群益94購04,0,0,0,0,0,0,0,0,0,357000,0,0,0,380000,23000,357000,357000
2481,強茂            ,559000,313000,246000,0,0,0,112000,0,112000,-1000,20000,0,20000,57000,78000,-21000,357000
050111,全新元大95購02  ,0,0,0,0,0,0,0,0,0,356000,0,0,0,537000,181000,356000,356000
053833,彩晶台新97購02  ,0,0,0,0,0,0,0,0,0,355000,0,0,0,355000,0,355000,355000
054023,和大康和96購01  ,0,0,0,0,0,0,0,0,0,355000,0,0,0,387000,32000,355000,355000
043173,合勤控國泰93購01,0,0,0,0,0,0,0,0,0,353000,0,0,0,355000,2000,353000,353000
045515,滬深2X統一92購01,0,0,0,0,0,0,0,0,0,353000,0,0,0,1032000,679000,353000,353000
047360,鴻海群益95購02  ,0,0,0,0,0,0,0,0,0,352000,0,0,0,497000,145000,352000,352000
045305,嘉晶元大92購01  ,0,0,0,0,0,0,0,0,0,350000,0,0,0,350000,0,350000,350000
03616P,大立光元大92售24,0,0,0,0,0,0,0,0,0,350000,0,0,0,350000,0,350000,350000
049226,元石油富邦95購01,0,0,0,0,0,0,0,0,0,350000,0,0,0,350000,0,350000,350000
048608,燿華凱基93購06  ,0,0,0,0,0,0,0,0,0,350000,0,0,0,385000,35000,350000,350000
05245P,台積電元大95售18,0,0,0,0,0,0,0,0,0,349000,0,0,0,1217000,868000,349000,349000
053813,友達群益9A購03  ,0,0,0,0,0,0,0,0,0,348000,0,0,0,358000,10000,348000,348000
1513,中興電          ,451000,103375,347625,0,0,0,0,0,0,0,0,0,0,0,0,0,347625
052942,聯發科中信97購04,0,0,0,0,0,0,0,0,0,343000,0,0,0,710000,367000,343000,343000
051543,鈺齊國票96購01  ,0,0,0,0,0,0,0,0,0,343000,0,0,0,608000,265000,343000,343000
04796P,聯發科元大94售10,0,0,0,0,0,0,0,0,0,342000,0,0,0,592000,250000,342000,342000
2338,光罩            ,965000,601000,364000,0,0,0,0,0,0,-24000,0,0,0,26000,50000,-24000,340000
05231P,GIS群益95售03   ,0,0,0,0,0,0,0,0,0,339000,0,0,0,427000,88000,339000,339000
04370P,聯茂凱基94售05  ,0,0,0,0,0,0,0,0,0,339000,0,0,0,340000,1000,339000,339000
050002,智原永豐94購02  ,0,0,0,0,0,0,0,0,0,339000,0,0,0,419000,80000,339000,339000
045410,華邦電群益94購01,0,0,0,0,0,0,0,0,0,338000,0,0,0,846000,508000,338000,338000
9802,鈺齊-KY         ,374000,159000,215000,0,0,0,40000,0,40000,83000,0,3000,-3000,129000,43000,86000,338000
051799,台積電永豐96購01,0,0,0,0,0,0,0,0,0,337000,0,0,0,512000,175000,337000,337000
053252,華邦電國泰98購01,0,0,0,0,0,0,0,0,0,336000,0,0,0,900000,564000,336000,336000
047901,復盛群益93購01  ,0,0,0,0,0,0,0,0,0,336000,0,0,0,347000,11000,336000,336000
047363,奇鋐群益93購02  ,0,0,0,0,0,0,0,0,0,335000,0,0,0,335000,0,335000,335000
04493P,漢唐永豐94售01  ,0,0,0,0,0,0,0,0,0,332000,0,0,0,332000,0,332000,332000
04809P,台光電群益94售04,0,0,0,0,0,0,0,0,0,332000,0,0,0,332000,0,332000,332000
2404,漢唐            ,415000,89000,326000,0,0,0,0,0,0,6000,1000,0,1000,15000,10000,5000,332000
050104,元石油元大97購02,0,0,0,0,0,0,0,0,0,331000,0,0,0,346000,15000,331000,331000
052772,台虹群益96購01  ,0,0,0,0,0,0,0,0,0,330000,0,0,0,409000,79000,330000,330000
037536,道瓊反元富93購01,0,0,0,0,0,0,0,0,0,330000,0,0,0,330000,0,330000,330000
043415,群創凱基91購02  ,0,0,0,0,0,0,0,0,0,330000,0,0,0,330000,0,330000,330000
046535,宏碁群益92購01  ,0,0,0,0,0,0,0,0,0,330000,0,0,0,330000,0,330000,330000
05401P,聯茂永豐95售03  ,0,0,0,0,0,0,0,0,0,328000,0,0,0,328000,0,328000,328000
044081,鴻海國票92購01  ,0,0,0,0,0,0,0,0,0,328000,0,0,0,478000,150000,328000,328000
04556P,大成鋼群益94售02,0,0,0,0,0,0,0,0,0,327000,0,0,0,413000,86000,327000,327000
050900,台郡元大95購02  ,0,0,0,0,0,0,0,0,0,327000,0,0,0,420000,93000,327000,327000
046290,儒鴻統一93購01  ,0,0,0,0,0,0,0,0,0,324000,0,0,0,374000,50000,324000,324000
048381,T50反1國票94購03,0,0,0,0,0,0,0,0,0,324000,0,0,0,1224000,900000,324000,324000
05032P,台積電國泰96售05,0,0,0,0,0,0,0,0,0,324000,0,0,0,395000,71000,324000,324000
05515P,台積電群益96售03,0,0,0,0,0,0,0,0,0,323000,0,0,0,1489000,1166000,323000,323000
054291,高鐵元大97購01  ,0,0,0,0,0,0,0,0,0,323000,0,0,0,339000,16000,323000,323000
048225,全新凱基93購03  ,0,0,0,0,0,0,0,0,0,322000,0,0,0,400000,78000,322000,322000
03101P,GIS凱基01售04   ,0,0,0,0,0,0,0,0,0,322000,0,0,0,322000,0,322000,322000
03955P,華通統一93售04  ,0,0,0,0,0,0,0,0,0,321000,0,0,0,421000,100000,321000,321000
052498,台積電永豐95購06,0,0,0,0,0,0,0,0,0,320000,0,0,0,1035000,715000,320000,320000
048081,元油反凱基96購01,0,0,0,0,0,0,0,0,0,320000,0,0,0,320000,0,320000,320000
047080,仁寶康和93購01  ,0,0,0,0,0,0,0,0,0,320000,0,0,0,320000,0,320000,320000
05033P,T50反1元大98售01,0,0,0,0,0,0,0,0,0,320000,0,0,0,320000,0,320000,320000
053717,聯發科凱基96購17,0,0,0,0,0,0,0,0,0,319000,0,0,0,846000,527000,319000,319000
045649,超眾凱基93購04  ,0,0,0,0,0,0,0,0,0,319000,0,0,0,319000,0,319000,319000
05525P,奇力新群益96售02,0,0,0,0,0,0,0,0,0,318000,0,0,0,366000,48000,318000,318000
053028,康控富邦98購01  ,0,0,0,0,0,0,0,0,0,318000,0,0,0,358000,40000,318000,318000
3653,健策            ,669000,266000,403000,0,0,0,0,0,0,-85000,17000,126000,-109000,60000,36000,24000,318000
040959,為升國票91購01  ,0,0,0,0,0,0,0,0,0,317000,0,0,0,317000,0,317000,317000
048512,全新凱基93購04  ,0,0,0,0,0,0,0,0,0,316000,0,0,0,335000,19000,316000,316000
051420,康控國票95購05  ,0,0,0,0,0,0,0,0,0,315000,0,0,0,315000,0,315000,315000
048287,嘉晶兆豐94購01  ,0,0,0,0,0,0,0,0,0,313000,0,0,0,318000,5000,313000,313000
051155,聯發科國泰96購01,0,0,0,0,0,0,0,0,0,312000,0,0,0,493000,181000,312000,312000
052634,華邦電凱基96購01,0,0,0,0,0,0,0,0,0,310000,0,0,0,490000,180000,310000,310000
044983,玉晶光國票93購01,0,0,0,0,0,0,0,0,0,310000,0,0,0,310000,0,310000,310000
041427,滬深2X國票93購01,0,0,0,0,0,0,0,0,0,310000,0,0,0,360000,50000,310000,310000
03413P,華擎元大02售02  ,0,0,0,0,0,0,0,0,0,310000,0,0,0,310000,0,310000,310000
03416P,聯電台新02售02  ,0,0,0,0,0,0,0,0,0,310000,0,0,0,450000,140000,310000,310000
04854P,鴻海國泰96售04  ,0,0,0,0,0,0,0,0,0,310000,0,0,0,331000,21000,310000,310000
04669P,臺股指國票94售08,0,0,0,0,0,0,0,0,0,310000,0,0,0,320000,10000,310000,310000
04698P,臺股指元富94售04,0,0,0,0,0,0,0,0,0,310000,0,0,0,400000,90000,310000,310000
048856,高鐵群益94購01  ,0,0,0,0,0,0,0,0,0,309000,0,0,0,414000,105000,309000,309000
048863,超眾群益94購01  ,0,0,0,0,0,0,0,0,0,309000,0,0,0,360000,51000,309000,309000
052655,群創統一97購01  ,0,0,0,0,0,0,0,0,0,308000,0,0,0,308000,0,308000,308000
05062P,大立光富邦98售03,0,0,0,0,0,0,0,0,0,308000,0,0,0,379000,71000,308000,308000
053708,道瓊反凱基98購01,0,0,0,0,0,0,0,0,0,306000,0,0,0,316000,10000,306000,306000
04391P,玉晶光凱基95售03,0,0,0,0,0,0,0,0,0,306000,0,0,0,306000,0,306000,306000
048962,宏全康和94購01  ,0,0,0,0,0,0,0,0,0,305000,0,0,0,305000,0,305000,305000
047654,鴻海兆豐93購01  ,0,0,0,0,0,0,0,0,0,305000,0,0,0,305000,0,305000,305000
2929,淘帝-KY         ,372000,55000,317000,0,0,0,0,0,0,-12000,0,0,0,0,12000,-12000,305000
047000,和大統一93購01  ,0,0,0,0,0,0,0,0,0,304000,0,0,0,506000,202000,304000,304000
053672,嘉澤元富96購02  ,0,0,0,0,0,0,0,0,0,303000,0,0,0,323000,20000,303000,303000
047604,智原國泰95購01  ,0,0,0,0,0,0,0,0,0,303000,0,0,0,481000,178000,303000,303000
051785,臻鼎兆豐96購01  ,0,0,0,0,0,0,0,0,0,303000,0,0,0,308000,5000,303000,303000
051997,康友元大95購02  ,0,0,0,0,0,0,0,0,0,303000,0,0,0,961000,658000,303000,303000
04603P,訊芯凱基94售03  ,0,0,0,0,0,0,0,0,0,302000,0,0,0,302000,0,302000,302000
046487,鴻海永昌92購01  ,0,0,0,0,0,0,0,0,0,302000,0,0,0,353000,51000,302000,302000
050397,力成元富94購01  ,0,0,0,0,0,0,0,0,0,302000,0,0,0,314000,12000,302000,302000
8271,宇瞻            ,456000,149000,307000,0,0,0,0,0,0,-5000,0,5000,-5000,0,0,0,302000
6415,矽力-KY         ,567000,363000,204000,0,0,0,121000,16000,105000,-8000,0,4000,-4000,3000,7000,-4000,301000
3413,京鼎            ,460000,107555,352445,0,0,0,0,0,0,-52000,12000,89000,-77000,39000,14000,25000,300445
053768,S&P反1元大99購01,0,0,0,0,0,0,0,0,0,300000,0,0,0,300000,0,300000,300000
05560P,友達兆豐96售01  ,0,0,0,0,0,0,0,0,0,300000,0,0,0,300000,0,300000,300000
052680,T50反1元大96購04,0,0,0,0,0,0,0,0,0,300000,0,0,0,300000,0,300000,300000
052415,台表科麥證95購02,0,0,0,675000,370000,305000,0,0,0,300000,0,0,0,675000,375000,300000,300000
03340P,瀚宇博國票04售01,0,0,0,0,0,0,0,0,0,300000,0,0,0,300000,0,300000,300000
04081P,聯詠元大93售11  ,0,0,0,0,0,0,0,0,0,300000,0,0,0,300000,0,300000,300000
047371,明泰國票93購01  ,0,0,0,0,0,0,0,0,0,300000,0,0,0,300000,0,300000,300000
047596,元油反元富97購01,0,0,0,0,0,0,0,0,0,300000,0,0,0,300000,0,300000,300000
049379,智原元大95購01  ,0,0,0,0,0,0,0,0,0,300000,0,0,0,316000,16000,300000,300000
047160,台郡國票94購01  ,0,0,0,0,0,0,0,0,0,300000,0,0,0,308000,8000,300000,300000
051238,中環元大96購01  ,0,0,0,0,0,0,0,0,0,300000,0,0,0,300000,0,300000,300000
052272,T50反1群益95購03,0,0,0,0,0,0,0,0,0,299000,0,0,0,299000,0,299000,299000
04037P,中磊群益93售02  ,0,0,0,0,0,0,0,0,0,299000,0,0,0,299000,0,299000,299000
03304P,欣興元富02售02  ,0,0,0,0,0,0,0,0,0,299000,0,0,0,320000,21000,299000,299000
051171,T50反1第一95購01,0,0,0,0,0,0,0,0,0,299000,0,0,0,299000,0,299000,299000
050941,T50反1群益95購01,0,0,0,0,0,0,0,0,0,299000,0,0,0,299000,0,299000,299000
050360,T50反1元大94購06,0,0,0,0,0,0,0,0,0,299000,0,0,0,299000,0,299000,299000
050361,T50反1元大94購07,0,0,0,0,0,0,0,0,0,299000,0,0,0,299000,0,299000,299000
049891,T50反1富邦94購02,0,0,0,0,0,0,0,0,0,299000,0,0,0,299000,0,299000,299000
049527,國巨中信95購01  ,0,0,0,0,0,0,0,0,0,299000,0,0,0,359000,60000,299000,299000
047466,新光金國泰95購01,0,0,0,0,0,0,0,0,0,297000,0,0,0,496000,199000,297000,297000
053946,全新富邦97購02  ,0,0,0,0,0,0,0,0,0,296000,0,0,0,332000,36000,296000,296000
03938P,聯鈞元大93售01  ,0,0,0,0,0,0,0,0,0,296000,0,0,0,657000,361000,296000,296000
052111,智原元富95購01  ,0,0,0,0,0,0,0,0,0,296000,0,0,0,330000,34000,296000,296000
3576,聯合再生        ,487000,141000,346000,0,0,0,0,0,0,-50000,0,50000,-50000,0,0,0,296000
05471P,聯電統一95售01  ,0,0,0,0,0,0,0,0,0,294000,0,0,0,296000,2000,294000,294000
044974,鴻海國票94購01  ,0,0,0,0,0,0,0,0,0,294000,0,0,0,1473000,1179000,294000,294000
05843P,台積電元大96售16,0,0,0,0,0,0,0,0,0,294000,0,0,0,695000,401000,294000,294000
6139,亞翔            ,417000,65000,352000,0,0,0,0,0,0,-58000,0,58000,-58000,0,0,0,294000
052684,旺宏元大98購01  ,0,0,0,0,0,0,0,0,0,292000,0,0,0,1066000,774000,292000,292000
050342,華通元富94購02  ,0,0,0,0,0,0,0,0,0,292000,0,0,0,416000,124000,292000,292000
2451,創見            ,303000,29304,273696,0,0,0,0,0,0,18000,6000,0,6000,12000,0,12000,291696
03912P,臺股指元大93售36,0,0,0,0,0,0,0,0,0,291000,0,0,0,291000,0,291000,291000
052027,智原群益95購01  ,0,0,0,0,0,0,0,0,0,291000,0,0,0,373000,82000,291000,291000
051752,緯穎富邦96購01  ,0,0,0,0,0,0,0,0,0,291000,0,0,0,367000,76000,291000,291000
044725,禾伸堂永豐91購01,0,0,0,0,0,0,0,0,0,290000,0,0,0,340000,50000,290000,290000
048583,智原富邦98購01  ,0,0,0,0,0,0,0,0,0,290000,0,0,0,295000,5000,290000,290000
051269,康友富邦97購01  ,0,0,0,0,0,0,0,0,0,290000,0,0,0,465000,175000,290000,290000
046020,滬深2X元大95購02,0,0,0,0,0,0,0,0,0,288000,0,0,0,373000,85000,288000,288000
047848,可成統一93購01  ,0,0,0,0,0,0,0,0,0,287000,0,0,0,387000,100000,287000,287000
051258,鈺齊國泰97購01  ,0,0,0,0,0,0,0,0,0,287000,0,0,0,310000,23000,287000,287000
04250P,嘉晶統一95售02  ,0,0,0,0,0,0,0,0,0,286000,0,0,0,475000,189000,286000,286000
05088P,大立光富邦99售01,0,0,0,0,0,0,0,0,0,286000,0,0,0,389000,103000,286000,286000
046538,大立光群益93購06,0,0,0,0,0,0,0,0,0,284000,0,0,0,302000,18000,284000,284000
053357,可成統一96購02  ,0,0,0,0,0,0,0,0,0,283000,0,0,0,617000,334000,283000,283000
04434P,玉晶光國票96售02,0,0,0,0,0,0,0,0,0,283000,0,0,0,433000,150000,283000,283000
050162,中環國泰95購01  ,0,0,0,0,0,0,0,0,0,283000,0,0,0,363000,80000,283000,283000
051108,鴻海統一96購02  ,0,0,0,0,0,0,0,0,0,283000,0,0,0,300000,17000,283000,283000
054546,玉晶光中信9B購01,0,0,0,0,0,0,0,0,0,282000,0,0,0,524000,242000,282000,282000
048125,和鑫元大96購01  ,0,0,0,0,0,0,0,0,0,282000,0,0,0,282000,0,282000,282000
053321,智原群益96購02  ,0,0,0,0,0,0,0,0,0,281000,0,0,0,563000,282000,281000,281000
053015,緯創統一96購01  ,0,0,0,0,0,0,0,0,0,281000,0,0,0,281000,0,281000,281000
051459,臺股指元大95購19,0,0,0,0,0,0,0,0,0,281000,0,0,0,488000,207000,281000,281000
049748,智原永豐94購01  ,0,0,0,0,0,0,0,0,0,281000,0,0,0,326000,45000,281000,281000
06061P,訊芯統一97售01  ,0,0,0,0,0,0,0,0,0,281000,0,0,0,281000,0,281000,281000
043524,亞光元大92購01  ,0,0,0,0,0,0,0,0,0,280000,0,0,0,301000,21000,280000,280000
039828,鴻海統一91購01  ,0,0,0,0,0,0,0,0,0,280000,0,0,0,330000,50000,280000,280000
1904,正隆            ,297000,122000,175000,0,0,0,0,0,0,105000,105000,0,105000,0,0,0,280000
053797,台積電中信98購01,0,0,0,0,0,0,0,0,0,279000,0,0,0,445000,166000,279000,279000
3515,華擎            ,219000,13000,206000,0,0,0,69000,0,69000,4000,0,2000,-2000,6000,0,6000,279000
048950,達方永豐94購01  ,0,0,0,0,0,0,0,0,0,276000,0,0,0,296000,20000,276000,276000
05437P,聯詠永豐95售02  ,0,0,0,0,0,0,0,0,0,275000,0,0,0,450000,175000,275000,275000
048010,嘉聯益富邦97購01,0,0,0,0,0,0,0,0,0,275000,0,0,0,342000,67000,275000,275000
052156,滬深2X永豐95購03,0,0,0,0,0,0,0,0,0,275000,0,0,0,390000,115000,275000,275000
05096P,台積電日盛95售01,0,0,0,0,0,0,0,0,0,274000,0,0,0,300000,26000,274000,274000
06048P,大立光富邦96售05,0,0,0,0,0,0,0,0,0,274000,0,0,0,274000,0,274000,274000
05316P,台積電永昌96售06,0,0,0,0,0,0,0,0,0,273000,0,0,0,873000,600000,273000,273000
048807,崇越中信94購01  ,0,0,0,0,0,0,0,0,0,273000,0,0,0,273000,0,273000,273000
051359,中信金元大95購01,0,0,0,0,0,0,0,0,0,273000,0,0,0,300000,27000,273000,273000
05053P,新日興群益95售01,0,0,0,0,0,0,0,0,0,272000,0,0,0,466000,194000,272000,272000
054488,禾伸堂台新96購01,0,0,0,0,0,0,0,0,0,271000,0,0,0,271000,0,271000,271000
03842P,鴻海元富93售02  ,0,0,0,0,0,0,0,0,0,271000,0,0,0,271000,0,271000,271000
05287P,鴻海元富95售09  ,0,0,0,0,0,0,0,0,0,270000,0,0,0,293000,23000,270000,270000
044930,元黃金富邦93購01,0,0,0,0,0,0,0,0,0,270000,0,0,0,317000,47000,270000,270000
046845,燿華永豐93購01  ,0,0,0,0,0,0,0,0,0,270000,0,0,0,330000,60000,270000,270000
046383,群創凱基98購01  ,0,0,0,0,0,0,0,0,0,270000,0,0,0,300000,30000,270000,270000
050567,道瓊銀中信96購01,0,0,0,0,0,0,0,0,0,270000,0,0,0,270000,0,270000,270000
04032P,聯茂凱基94售02  ,0,0,0,0,0,0,0,0,0,268000,0,0,0,318000,50000,268000,268000
049224,致新國票95購01  ,0,0,0,0,0,0,0,0,0,267000,0,0,0,413000,146000,267000,267000
046368,嘉聯益永豐92購04,0,0,0,0,0,0,0,0,0,266000,0,0,0,276000,10000,266000,266000
043270,康控國泰92購01  ,0,0,0,0,0,0,0,0,0,265000,0,0,0,265000,0,265000,265000
04793P,台光電元大94售07,0,0,0,0,0,0,0,0,0,265000,0,0,0,300000,35000,265000,265000
043026,康友元大92購01  ,0,0,0,0,0,0,0,0,0,264000,0,0,0,289000,25000,264000,264000
042317,台灣50永豐96購01,0,0,0,0,0,0,0,0,0,264000,0,0,0,281000,17000,264000,264000
04083P,欣興統一94售01  ,0,0,0,0,0,0,0,0,0,263000,0,0,0,323000,60000,263000,263000
044536,深中小群益92購01,0,0,0,0,0,0,0,0,0,262000,0,0,0,290000,28000,262000,262000
045511,同欣電凱基92購02,0,0,0,0,0,0,0,0,0,262000,0,0,0,337000,75000,262000,262000
04420P,奇鋐永豐94售01  ,0,0,0,0,0,0,0,0,0,261000,0,0,0,274000,13000,261000,261000
04674P,全新統一95售01  ,0,0,0,0,0,0,0,0,0,261000,0,0,0,862000,601000,261000,261000
052650,台郡永豐96購01  ,0,0,0,0,0,0,0,0,0,260000,0,0,0,260000,0,260000,260000
053884,緯穎第一96購01  ,0,0,0,0,0,0,0,0,0,260000,0,0,0,481000,221000,260000,260000
051692,深中小統一95購01,0,0,0,0,0,0,0,0,0,260000,0,0,0,295000,35000,260000,260000
05874P,台積電群益96售10,0,0,0,0,0,0,0,0,0,260000,0,0,0,560000,300000,260000,260000
05607P,華通日盛96售01  ,0,0,0,0,0,0,0,0,0,260000,0,0,0,437000,177000,260000,260000
053038,華邦電凱基97購01,0,0,0,0,0,0,0,0,0,259000,0,0,0,354000,95000,259000,259000
043969,美利達國泰92購01,0,0,0,0,0,0,0,0,0,259000,0,0,0,279000,20000,259000,259000
046791,台郡統一96購01  ,0,0,0,0,0,0,0,0,0,259000,0,0,0,273000,14000,259000,259000
05978P,麗豐永豐96售02  ,0,0,0,0,0,0,0,0,0,259000,0,0,0,259000,0,259000,259000
054426,國泰金富邦97購02,0,0,0,0,0,0,0,0,0,258000,0,0,0,263000,5000,258000,258000
047572,深中小群益95購01,0,0,0,0,0,0,0,0,0,258000,0,0,0,600000,342000,258000,258000
05683P,矽創元大96售01  ,0,0,0,0,0,0,0,0,0,258000,0,0,0,265000,7000,258000,258000
051494,中環兆豐95購01  ,0,0,0,0,0,0,0,0,0,257000,0,0,0,279000,22000,257000,257000
5871,中租-KY         ,1849586,1219240,630346,0,0,0,6000,390000,-384000,10000,18000,8000,10000,0,0,0,256346
8110,華東            ,422000,202717,219283,0,0,0,0,0,0,37000,37000,0,37000,0,0,0,256283
04019P,聯茂永豐93售01  ,0,0,0,0,0,0,0,0,0,256000,0,0,0,324000,68000,256000,256000
044056,致茂元大91購01  ,0,0,0,0,0,0,0,0,0,255000,0,0,0,255000,0,255000,255000
04788P,台積電永昌96售05,0,0,0,0,0,0,0,0,0,255000,0,0,0,255000,0,255000,255000
05760P,京鼎永豐96售02  ,0,0,0,0,0,0,0,0,0,254000,0,0,0,254000,0,254000,254000
05655P,南亞科統一96售01,0,0,0,0,0,0,0,0,0,254000,0,0,0,272000,18000,254000,254000
03523P,南電元大02售09  ,0,0,0,0,0,0,0,0,0,253000,0,0,0,289000,36000,253000,253000
044693,滬深2X元大94購01,0,0,0,0,0,0,0,0,0,253000,0,0,0,810000,557000,253000,253000
054449,中環第一96購01  ,0,0,0,0,0,0,0,0,0,251000,0,0,0,251000,0,251000,251000
04953P,台積電群益94售13,0,0,0,0,0,0,0,0,0,251000,0,0,0,301000,50000,251000,251000
043398,聯電亞東91購01  ,0,0,0,0,0,0,0,0,0,250000,0,0,0,250000,0,250000,250000
043049,奇鋐國泰93購01  ,0,0,0,0,0,0,0,0,0,250000,0,0,0,260000,10000,250000,250000
04820P,聯茂永豐94售02  ,0,0,0,0,0,0,0,0,0,250000,0,0,0,326000,76000,250000,250000
048216,元油反凱基93購01,0,0,0,0,0,0,0,0,0,250000,0,0,0,250000,0,250000,250000
04678P,臺股指統一94售03,0,0,0,0,0,0,0,0,0,250000,0,0,0,250000,0,250000,250000
047185,益航元大94購02  ,0,0,0,0,0,0,0,0,0,250000,0,0,0,318000,68000,250000,250000
049549,瀚宇博群益94購01,0,0,0,0,0,0,0,0,0,250000,0,0,0,250000,0,250000,250000
05046P,台光電永豐95售02,0,0,0,0,0,0,0,0,0,250000,0,0,0,292000,42000,250000,250000
051224,華通群益96購03  ,0,0,0,0,0,0,0,0,0,250000,0,0,0,288000,38000,250000,250000
053950,緯穎富邦97購02  ,0,0,0,0,0,0,0,0,0,249000,0,0,0,279000,30000,249000,249000
045892,和鑫元大93購03  ,0,0,0,0,0,0,0,0,0,249000,0,0,0,249000,0,249000,249000
047838,亞光元大93購03  ,0,0,0,0,0,0,0,0,0,249000,0,0,0,276000,27000,249000,249000
051149,可成凱基95購04  ,0,0,0,0,0,0,0,0,0,249000,0,0,0,250000,1000,249000,249000
049427,瑞昱兆豐94購01  ,0,0,0,0,0,0,0,0,0,249000,0,0,0,250000,1000,249000,249000
045459,致茂元大92購01  ,0,0,0,0,0,0,0,0,0,248000,0,0,0,270000,22000,248000,248000
047128,新日興日盛93購01,0,0,0,0,0,0,0,0,0,248000,0,0,0,268000,20000,248000,248000
04619P,華新統一94售02  ,0,0,0,0,0,0,0,0,0,246000,0,0,0,246000,0,246000,246000
05166P,中磊元富95售03  ,0,0,0,0,0,0,0,0,0,246000,0,0,0,263000,17000,246000,246000
044273,微星群益92購01  ,0,0,0,0,0,0,0,0,0,245000,0,0,0,298000,53000,245000,245000
3530,晶相光          ,504000,399000,105000,0,0,0,0,0,0,140000,6000,0,6000,220000,86000,134000,245000
045855,緯穎富邦93購01  ,0,0,0,0,0,0,0,0,0,244000,0,0,0,251000,7000,244000,244000
6209,今國光          ,373000,129000,244000,0,0,0,0,0,0,0,0,0,0,0,0,0,244000
047580,TPK群益94購01   ,0,0,0,0,0,0,0,0,0,243000,0,0,0,245000,2000,243000,243000
050728,新日興國票94購01,0,0,0,0,0,0,0,0,0,242000,0,0,0,367000,125000,242000,242000
04376P,漢唐元大94售04  ,0,0,0,0,0,0,0,0,0,241000,0,0,0,255000,14000,241000,241000
05474P,智邦亞東95售01  ,0,0,0,0,0,0,0,0,0,240000,0,0,0,240000,0,240000,240000
043359,和鑫國票92購02  ,0,0,0,0,0,0,0,0,0,240000,0,0,0,240000,0,240000,240000
05774P,臺股指凱基99售04,0,0,0,0,0,0,0,0,0,240000,0,0,0,242000,2000,240000,240000
041904,儒鴻元大92購01  ,0,0,0,0,0,0,0,0,0,239000,0,0,0,249000,10000,239000,239000
03557P,欣興元大02售17  ,0,0,0,0,0,0,0,0,0,238000,0,0,0,239000,1000,238000,238000
04784P,超眾元富94售01  ,0,0,0,0,0,0,0,0,0,238000,0,0,0,338000,100000,238000,238000
049523,微星兆豐94購02  ,0,0,0,0,0,0,0,0,0,238000,0,0,0,238000,0,238000,238000
051195,台郡中信95購01  ,0,0,0,0,0,0,0,0,0,238000,0,0,0,310000,72000,238000,238000
052770,聯茂群益96購02  ,0,0,0,0,0,0,0,0,0,237000,0,0,0,248000,11000,237000,237000
045785,揚明光元大93購04,0,0,0,0,0,0,0,0,0,237000,0,0,0,237000,0,237000,237000
05925P,晶技永豐96售03  ,0,0,0,0,0,0,0,0,0,237000,0,0,0,237000,0,237000,237000
05453P,智邦群益95售03  ,0,0,0,0,0,0,0,0,0,235000,0,0,0,235000,0,235000,235000
048275,A50正2永豐93購01,0,0,0,0,0,0,0,0,0,235000,0,0,0,255000,20000,235000,235000
049076,佳世達凱基94購01,0,0,0,0,0,0,0,0,0,235000,0,0,0,235000,0,235000,235000
051941,樺漢群益95購02  ,0,0,0,0,0,0,0,0,0,234000,0,0,0,254000,20000,234000,234000
06046P,健策統一96售03  ,0,0,0,0,0,0,0,0,0,234000,0,0,0,448000,214000,234000,234000
050539,鴻海凱基95購07  ,0,0,0,0,0,0,0,0,0,233000,0,0,0,239000,6000,233000,233000
05896P,宏達電群益96售03,0,0,0,0,0,0,0,0,0,233000,0,0,0,233000,0,233000,233000
1718,中纖            ,406000,173000,233000,0,0,0,0,0,0,0,0,0,0,0,0,0,233000
054432,台積電台新96購05,0,0,0,0,0,0,0,0,0,232000,0,0,0,257000,25000,232000,232000
047417,台塑富邦97購01  ,0,0,0,0,0,0,0,0,0,232000,0,0,0,252000,20000,232000,232000
04986P,茂林永豐94售05  ,0,0,0,0,0,0,0,0,0,232000,0,0,0,249000,17000,232000,232000
05948P,茂林元大96售03  ,0,0,0,0,0,0,0,0,0,232000,0,0,0,232000,0,232000,232000
044777,超眾元大93購01  ,0,0,0,0,0,0,0,0,0,231000,0,0,0,281000,50000,231000,231000
1304,台聚            ,414000,52000,362000,0,0,0,169000,0,169000,-300000,0,300000,-300000,0,0,0,231000
2331,精英            ,317000,73000,244000,0,0,0,0,0,0,-13000,2000,15000,-13000,0,0,0,231000
05552P,聯詠群益96售01  ,0,0,0,0,0,0,0,0,0,230000,0,0,0,327000,97000,230000,230000
053644,台表科國票97購03,0,0,0,0,0,0,0,0,0,230000,0,0,0,230000,0,230000,230000
043968,易華電國泰92購02,0,0,0,0,0,0,0,0,0,230000,0,0,0,230000,0,230000,230000
04449P,智邦凱基94售01  ,0,0,0,0,0,0,0,0,0,230000,0,0,0,230000,0,230000,230000
046811,和大凱基93購01  ,0,0,0,0,0,0,0,0,0,230000,0,0,0,235000,5000,230000,230000
051570,和碩富邦97購01  ,0,0,0,0,0,0,0,0,0,230000,0,0,0,261000,31000,230000,230000
05747P,漢唐群益96售03  ,0,0,0,0,0,0,0,0,0,230000,0,0,0,240000,10000,230000,230000
053194,緯穎統一99購01  ,0,0,0,0,0,0,0,0,0,229000,0,0,0,393000,164000,229000,229000
053438,玉晶光麥證97購02,0,0,0,268000,39000,229000,0,0,0,229000,0,0,0,268000,39000,229000,229000
054243,國喬元大96購01  ,0,0,0,0,0,0,0,0,0,228000,0,0,0,530000,302000,228000,228000
04410P,大立光統一94售05,0,0,0,0,0,0,0,0,0,227000,0,0,0,344000,117000,227000,227000
045984,亞光麥證93購02  ,0,0,0,247000,21000,226000,0,0,0,227000,0,0,0,248000,21000,227000,227000
046605,瀚宇博群益93購01,0,0,0,0,0,0,0,0,0,227000,0,0,0,227000,0,227000,227000
052178,台郡元大96購03  ,0,0,0,0,0,0,0,0,0,226000,0,0,0,251000,25000,226000,226000
051550,日電貿永豐95購01,0,0,0,0,0,0,0,0,0,226000,0,0,0,276000,50000,226000,226000
044792,康友群益93購01  ,0,0,0,0,0,0,0,0,0,224000,0,0,0,337000,113000,224000,224000
04187P,麗豐元富93售02  ,0,0,0,0,0,0,0,0,0,224000,0,0,0,224000,0,224000,224000
047248,奇鋐群益95購01  ,0,0,0,0,0,0,0,0,0,224000,0,0,0,334000,110000,224000,224000
00680L,元大美債20正2   ,12000,0,12000,0,0,0,0,0,0,211000,0,0,0,298000,87000,211000,223000
050978,鴻海元富95購03  ,0,0,0,0,0,0,0,0,0,223000,0,0,0,233000,10000,223000,223000
052629,訊芯中信99購01  ,0,0,0,0,0,0,0,0,0,222000,0,0,0,276000,54000,222000,222000
04886P,臺股指凱基94售20,0,0,0,0,0,0,0,0,0,222000,0,0,0,290000,68000,222000,222000
051883,智原永豐95購03  ,0,0,0,0,0,0,0,0,0,222000,0,0,0,332000,110000,222000,222000
052914,奇力新元富96購01,0,0,0,0,0,0,0,0,0,221000,0,0,0,223000,2000,221000,221000
053425,京鼎永豐96購01  ,0,0,0,0,0,0,0,0,0,221000,0,0,0,250000,29000,221000,221000
05304P,國巨國泰97售02  ,0,0,0,0,0,0,0,0,0,221000,0,0,0,253000,32000,221000,221000
053024,國巨富邦97購02  ,0,0,0,0,0,0,0,0,0,221000,0,0,0,465000,244000,221000,221000
054527,國巨統一97購03  ,0,0,0,0,0,0,0,0,0,221000,0,0,0,280000,59000,221000,221000
052182,鴻海群益96購01  ,0,0,0,0,0,0,0,0,0,221000,0,0,0,236000,15000,221000,221000
05381P,聯詠群益95售02  ,0,0,0,0,0,0,0,0,0,220000,0,0,0,339000,119000,220000,220000
053083,中環元大99購01  ,0,0,0,0,0,0,0,0,0,220000,0,0,0,260000,40000,220000,220000
05322P,台積電凱基95售17,0,0,0,0,0,0,0,0,0,220000,0,0,0,340000,120000,220000,220000
042181,易華電統一92購01,0,0,0,0,0,0,0,0,0,220000,0,0,0,220000,0,220000,220000
04295P,智邦元大93售10  ,0,0,0,0,0,0,0,0,0,220000,0,0,0,220000,0,220000,220000
048516,麗豐凱基93購02  ,0,0,0,0,0,0,0,0,0,220000,0,0,0,220000,0,220000,220000
052442,中環元大95購02  ,0,0,0,0,0,0,0,0,0,219000,0,0,0,220000,1000,219000,219000
05492P,聯茂元大95售02  ,0,0,0,0,0,0,0,0,0,219000,0,0,0,270000,51000,219000,219000
049762,華邦電國泰95購01,0,0,0,0,0,0,0,0,0,219000,0,0,0,439000,220000,219000,219000
050455,貿聯元大94購02  ,0,0,0,0,0,0,0,0,0,219000,0,0,0,219000,0,219000,219000
053029,國巨第一96購01  ,0,20000,-20000,0,0,0,0,0,0,238000,0,0,0,1795000,1557000,238000,218000
053453,新光金統一98購01,0,0,0,0,0,0,0,0,0,218000,0,0,0,238000,20000,218000,218000
048408,正文群益93購01  ,0,0,0,0,0,0,0,0,0,218000,0,0,0,220000,2000,218000,218000
049073,光罩凱基94購01  ,0,0,0,0,0,0,0,0,0,218000,0,0,0,221000,3000,218000,218000
2031,新光鋼          ,313000,66000,247000,0,0,0,0,0,0,-29000,11000,40000,-29000,0,0,0,218000
03253P,台灣50國泰03售02,0,0,0,0,0,0,0,0,0,217000,0,0,0,330000,113000,217000,217000
050112,高鐵元大94購02  ,0,0,0,0,0,0,0,0,0,217000,0,0,0,237000,20000,217000,217000
053371,滬深2X元大99購01,0,0,0,0,0,0,0,0,0,216000,0,0,0,238000,22000,216000,216000
054045,奇力新元大97購03,0,0,0,0,0,0,0,0,0,216000,0,0,0,327000,111000,216000,216000
046639,嘉晶永豐93購01  ,0,0,0,0,0,0,0,0,0,216000,0,0,0,228000,12000,216000,216000
050534,臻鼎兆豐94購01  ,0,0,0,0,0,0,0,0,0,216000,0,0,0,241000,25000,216000,216000
050876,復盛永豐95購01  ,0,0,0,0,0,0,0,0,0,216000,0,0,0,216000,0,216000,216000
051330,宏碁永豐95購01  ,0,0,0,0,0,0,0,0,0,216000,0,0,0,216000,0,216000,216000
05985P,燿華統一96售03  ,0,0,0,0,0,0,0,0,0,216000,0,0,0,292000,76000,216000,216000
044284,聯電凱基92購01  ,0,0,0,0,0,0,0,0,0,215000,0,0,0,215000,0,215000,215000
04765P,宏達電永豐94售02,0,0,0,0,0,0,0,0,0,215000,0,0,0,215000,0,215000,215000
05026P,貿聯群益95售01  ,0,0,0,0,0,0,0,0,0,215000,0,0,0,215000,0,215000,215000
050185,和鑫元大95購02  ,0,0,0,0,0,0,0,0,0,215000,0,0,0,215000,0,215000,215000
036805,國巨元富93購02  ,0,0,0,0,0,0,0,0,0,213000,0,0,0,241000,28000,213000,213000
050943,楠梓電群益96購01,0,0,0,0,0,0,0,0,0,213000,0,0,0,213000,0,213000,213000
051487,健策凱基96購03  ,0,0,0,0,0,0,0,0,0,212000,0,0,0,277000,65000,212000,212000
052690,台表科元大97購01,0,0,0,0,0,0,0,0,0,211000,0,0,0,248000,37000,211000,211000
00737,國泰AI+Robo     ,0,0,0,0,0,0,0,0,0,211000,0,0,0,211000,0,211000,211000
04162P,南亞科統一94售02,0,0,0,0,0,0,0,0,0,211000,0,0,0,242000,31000,211000,211000
04395P,台積電群益94售06,0,0,0,0,0,0,0,0,0,211000,0,0,0,233000,22000,211000,211000
052421,元油反國票9B購01,0,0,0,0,0,0,0,0,0,210000,0,0,0,210000,0,210000,210000
052333,嘉聯益兆豐96購01,0,0,0,0,0,0,0,0,0,210000,0,0,0,220000,10000,210000,210000
053529,國巨麥證96購01  ,0,0,0,210000,0,210000,0,0,0,210000,0,0,0,210000,0,210000,210000
045341,華邦電凱基93購04,0,0,0,0,0,0,0,0,0,210000,0,0,0,326000,116000,210000,210000
048176,美利達國泰94購01,0,0,0,0,0,0,0,0,0,210000,0,0,0,210000,0,210000,210000
052179,康友元大95購03  ,0,0,0,0,0,0,0,0,0,210000,0,0,0,562000,352000,210000,210000
051657,台郡元富98購01  ,0,0,0,0,0,0,0,0,0,210000,0,0,0,295000,85000,210000,210000
050442,復盛凱基94購01  ,0,0,0,0,0,0,0,0,0,210000,0,0,0,220000,10000,210000,210000
06008P,燿華統一96售04  ,0,0,0,0,0,0,0,0,0,210000,0,0,0,210000,0,210000,210000
053162,緯穎元大97購01  ,0,0,0,0,0,0,0,0,0,209000,0,0,0,397000,188000,209000,209000
04337P,台積電元大93售25,0,0,0,0,0,0,0,0,0,209000,0,0,0,259000,50000,209000,209000
047836,國泰金元大93購01,0,0,0,0,0,0,0,0,0,209000,0,0,0,209000,0,209000,209000
051099,台郡元大95購03  ,0,0,0,0,0,0,0,0,0,209000,0,0,0,509000,300000,209000,209000
8131,福懋科          ,255000,44405,210595,0,0,0,0,0,0,-2000,0,2000,-2000,0,0,0,208595
054517,高鐵元大96購01  ,0,0,0,0,0,0,0,0,0,208000,0,0,0,240000,32000,208000,208000
045137,鴻海兆豐92購02  ,0,0,0,0,0,0,0,0,0,208000,0,0,0,297000,89000,208000,208000
048246,京元電兆豐93購02,0,0,0,0,0,0,0,0,0,208000,0,0,0,208000,0,208000,208000
046864,和大統一97購01  ,0,0,0,0,0,0,0,0,0,208000,0,0,0,1135000,927000,208000,208000
049114,玉晶光統一94購02,0,0,0,0,0,0,0,0,0,208000,0,0,0,848000,640000,208000,208000
049225,達方國票94購01  ,0,0,0,0,0,0,0,0,0,208000,0,0,0,284000,76000,208000,208000
050564,臻鼎元富94購08  ,0,0,0,0,0,0,0,0,0,208000,0,0,0,328000,120000,208000,208000
053395,致茂中信96購01  ,0,0,0,0,0,0,0,0,0,207000,0,0,0,316000,109000,207000,207000
054457,強茂群益96購01  ,0,0,0,0,0,0,0,0,0,206000,0,0,0,258000,52000,206000,206000
05570P,聯發科統一96售04,0,0,0,0,0,0,0,0,0,206000,0,0,0,206000,0,206000,206000
044715,康友中信91購01  ,0,0,0,0,0,0,0,0,0,206000,0,0,0,255000,49000,206000,206000
051316,T50反1國票95購02,0,0,0,0,0,0,0,0,0,206000,0,0,0,216000,10000,206000,206000
051918,聯茂元大95購01  ,0,0,0,0,0,0,0,0,0,206000,0,0,0,325000,119000,206000,206000
053408,友達兆豐98購01  ,0,0,0,0,0,0,0,0,0,205000,0,0,0,210000,5000,205000,205000
04993P,上銀兆豐96售01  ,0,0,0,0,0,0,0,0,0,205000,0,0,0,242000,37000,205000,205000
048147,元油反元富95購01,0,0,0,0,0,0,0,0,0,205000,0,0,0,230000,25000,205000,205000
045848,光磊永豐92購01  ,0,0,0,0,0,0,0,0,0,205000,0,0,0,215000,10000,205000,205000
05621P,聯電中信96售01  ,0,0,0,0,0,0,0,0,0,205000,0,0,0,320000,115000,205000,205000
052534,貿聯國泰96購02  ,0,0,0,0,0,0,0,0,0,204000,0,0,0,297000,93000,204000,204000
03840P,台積電統一99售02,0,0,0,0,0,0,0,0,0,204000,0,0,0,572000,368000,204000,204000
054611,全新永豐97購01  ,0,0,0,0,0,0,0,0,0,203000,0,0,0,203000,0,203000,203000
04233P,儒鴻兆豐93售01  ,0,0,0,0,0,0,0,0,0,203000,0,0,0,203000,0,203000,203000
04801P,矽力元大94售02  ,0,0,0,0,0,0,0,0,0,203000,0,0,0,279000,76000,203000,203000
05927P,正文永豐96售03  ,0,0,0,0,0,0,0,0,0,203000,0,0,0,203000,0,203000,203000
05994P,奇鋐元大96售02  ,0,0,0,0,0,0,0,0,0,203000,0,0,0,325000,122000,203000,203000
052923,台積電永豐96購02,0,0,0,0,0,0,0,0,0,202000,0,0,0,363000,161000,202000,202000
051470,玉晶光日盛95購01,0,0,0,0,0,0,0,0,0,202000,0,0,0,308000,106000,202000,202000
049785,華新科兆豐95購01,0,0,0,0,0,0,0,0,0,202000,0,0,0,332000,130000,202000,202000
046949,群創元大99購01  ,0,0,0,0,0,0,0,0,0,201000,0,0,0,239000,38000,201000,201000
046960,台新金中信95購01,0,0,0,0,0,0,0,0,0,201000,0,0,0,201000,0,201000,201000
05924P,超眾元富96售04  ,0,0,0,0,0,0,0,0,0,201000,0,0,0,306000,105000,201000,201000
05652P,臻鼎群益96售01  ,0,0,0,0,0,0,0,0,0,201000,0,0,0,232000,31000,201000,201000
05244P,台積電元大95售17,0,0,0,0,0,0,0,0,0,200000,0,0,0,600000,400000,200000,200000
05354P,臺股指元富95售08,0,0,0,0,0,0,0,0,0,200000,0,0,0,200000,0,200000,200000
053218,TPK凱基96購01   ,0,0,0,0,0,0,0,0,0,200000,0,0,0,200000,0,200000,200000
04175P,台積電群益94售05,0,0,0,0,0,0,0,0,0,200000,0,0,0,200000,0,200000,200000
04298P,祥碩元大93售02  ,0,0,0,0,0,0,0,0,0,200000,0,0,0,200000,0,200000,200000
03810P,大立光富邦98售01,0,0,0,0,0,0,0,0,0,200000,0,0,0,200000,0,200000,200000
03976P,智原元大93售02  ,0,0,0,0,0,0,0,0,0,200000,0,0,0,647000,447000,200000,200000
03961P,GIS元富93售04   ,0,0,0,0,0,0,0,0,0,200000,0,0,0,200000,0,200000,200000
03781P,智邦凱基93售03  ,0,0,0,0,0,0,0,0,0,200000,0,0,0,200000,0,200000,200000
046206,為升國泰93購01  ,0,0,0,0,0,0,0,0,0,200000,0,0,0,300000,100000,200000,200000
045164,彩晶國泰92購01  ,0,0,0,0,0,0,0,0,0,200000,0,0,0,200000,0,200000,200000
044745,景碩群益91購02  ,0,0,0,0,0,0,0,0,0,200000,0,0,0,200000,0,200000,200000
044854,智易國泰93購01  ,0,0,0,0,0,0,0,0,0,200000,0,0,0,200000,0,200000,200000
04522P,卜蜂凱基94售02  ,0,0,0,0,0,0,0,0,0,200000,0,0,0,200000,0,200000,200000
045956,英業達凱基93購01,0,0,0,0,0,0,0,0,0,200000,0,0,0,200000,0,200000,200000
04604P,華新科國票95售01,0,0,0,0,0,0,0,0,0,200000,0,0,0,200000,0,200000,200000
04753P,台積電統一94售11,0,0,0,0,0,0,0,0,0,200000,0,0,0,200000,0,200000,200000
050110,京元電元大94購03,0,0,0,0,0,0,0,0,0,200000,0,0,0,200000,0,200000,200000
05063P,聯電元大96售03  ,0,0,0,0,0,0,0,0,0,200000,0,0,0,250000,50000,200000,200000
050452,智原元大95購04  ,0,0,0,0,0,0,0,0,0,200000,0,0,0,325000,125000,200000,200000
05024P,華通國票96售01  ,0,0,0,0,0,0,0,0,0,200000,0,0,0,270000,70000,200000,200000
051475,宏碁凱基95購02  ,0,0,0,0,0,0,0,0,0,200000,0,0,0,200000,0,200000,200000
05100P,智邦凱基95售02  ,0,0,0,0,0,0,0,0,0,200000,0,0,0,207000,7000,200000,200000
051965,傳奇永豐95購01  ,0,0,0,0,0,0,0,0,0,200000,0,0,0,200000,0,200000,200000
05587P,鴻海凱基96售12  ,0,0,0,0,0,0,0,0,0,200000,0,0,0,335000,135000,200000,200000
05702P,矽創凱基96售02  ,0,0,0,0,0,0,0,0,0,200000,0,0,0,200000,0,200000,200000
08419P,元金2X群益9C售01,0,0,0,0,0,0,0,0,0,200000,0,0,0,200000,0,200000,200000
053396,漢唐中信9A購01  ,0,0,0,0,0,0,0,0,0,199000,0,0,0,199000,0,199000,199000
052501,茂林永豐95購04  ,0,0,0,0,0,0,0,0,0,199000,0,0,0,199000,0,199000,199000
053994,微星群益96購01  ,0,0,0,0,0,0,0,0,0,199000,0,0,0,221000,22000,199000,199000
03453P,儒鴻康和02售01  ,0,0,0,0,0,0,0,0,0,199000,0,0,0,199000,0,199000,199000
047054,聯詠國票93購01  ,0,0,0,0,0,0,0,0,0,199000,0,0,0,199000,0,199000,199000
046712,勤誠永豐93購01  ,0,0,0,0,0,0,0,0,0,199000,0,0,0,219000,20000,199000,199000
05180P,玉晶光凱基95售04,0,0,0,0,0,0,0,0,0,199000,0,0,0,249000,50000,199000,199000
08996P,華通群益02售05  ,0,0,0,0,0,0,0,0,0,199000,0,0,0,199000,0,199000,199000
054428,禾伸堂富邦98購01,0,0,0,0,0,0,0,0,0,198000,0,0,0,486000,288000,198000,198000
052406,力成凱基95購03  ,0,0,0,0,0,0,0,0,0,198000,0,0,0,201000,3000,198000,198000
04082P,智邦統一93售03  ,0,0,0,0,0,0,0,0,0,198000,0,0,0,519000,321000,198000,198000
04831P,聯詠富邦96售01  ,0,0,0,0,0,0,0,0,0,198000,0,0,0,522000,324000,198000,198000
045400,康友富邦93購01  ,0,0,0,0,0,0,0,0,0,197000,0,0,0,198000,1000,197000,197000
049898,緯穎統一95購01  ,0,0,0,0,0,0,0,0,0,197000,0,0,0,287000,90000,197000,197000
051144,鴻海凱基95購12  ,0,0,0,0,0,0,0,0,0,197000,0,0,0,197000,0,197000,197000
052913,鴻海元富96購05  ,0,0,0,0,0,0,0,0,0,196000,0,0,0,198000,2000,196000,196000
046938,致茂元大93購02  ,0,0,0,0,0,0,0,0,0,196000,0,0,0,212000,16000,196000,196000
051112,台郡統一95購01  ,0,0,0,0,0,0,0,0,0,196000,0,0,0,231000,35000,196000,196000
052122,新光金國票96購01,0,0,0,0,0,0,0,0,0,196000,0,0,0,210000,14000,196000,196000
049973,T50反1日盛9A購01,0,0,0,0,0,0,0,0,0,196000,0,0,0,196000,0,196000,196000
052504,鴻海日盛95購03  ,0,0,0,0,0,0,0,0,0,195000,0,0,0,242000,47000,195000,195000
044254,深中小元大94購01,0,0,0,0,0,0,0,0,0,195000,0,0,0,195000,0,195000,195000
03800P,景碩元大93售01  ,0,0,0,0,0,0,0,0,0,195000,0,0,0,275000,80000,195000,195000
042445,上証2X凱基92購04,0,0,0,0,0,0,0,0,0,195000,0,0,0,200000,5000,195000,195000
047595,元石油元富97購01,0,0,0,0,0,0,0,0,0,195000,0,0,0,195000,0,195000,195000
050542,宏碁凱基95購01  ,0,0,0,0,0,0,0,0,0,195000,0,0,0,201000,6000,195000,195000
052133,華邦電凱基9B購01,0,0,0,0,0,0,0,0,0,195000,0,0,0,250000,55000,195000,195000
06081P,深中小元大97售02,0,0,0,0,0,0,0,0,0,195000,0,0,0,200000,5000,195000,195000
053096,康控統一96購01  ,0,0,0,0,0,0,0,0,0,194000,0,0,0,201000,7000,194000,194000
05302P,華通國泰96售01  ,0,0,0,0,0,0,0,0,0,194000,0,0,0,194000,0,194000,194000
052172,致茂元大95購01  ,0,0,0,0,0,0,0,0,0,194000,0,0,0,220000,26000,194000,194000
051705,富邦金群益97購01,0,0,0,0,0,0,0,0,0,193000,0,0,0,203000,10000,193000,193000
2408,南亞科          ,2476000,2411545,64455,0,0,0,286000,29000,257000,-129000,70000,302000,-232000,180000,77000,103000,192455
054072,台積電富邦98購02,0,0,0,0,0,0,0,0,0,192000,0,0,0,430000,238000,192000,192000
00688L,國泰20年美債正2 ,0,0,0,0,0,0,0,0,0,192000,0,0,0,302000,110000,192000,192000
048888,牧德元富94購02  ,0,0,0,0,0,0,0,0,0,192000,0,0,0,204000,12000,192000,192000
050996,隆達元大95購01  ,0,0,0,0,0,0,0,0,0,192000,0,0,0,200000,8000,192000,192000
054320,國喬台新96購01  ,0,0,0,0,0,0,0,0,0,191000,0,0,0,201000,10000,191000,191000
044614,聯茂兆豐92購02  ,0,0,0,0,0,0,0,0,0,191000,0,0,0,211000,20000,191000,191000
047651,復盛元大93購01  ,0,0,0,0,0,0,0,0,0,191000,0,0,0,191000,0,191000,191000
05040P,聯發科凱基95售05,0,0,0,0,0,0,0,0,0,191000,0,0,0,191000,0,191000,191000
05467P,聯電元大95售02  ,0,0,0,0,0,0,0,0,0,190000,0,0,0,190000,0,190000,190000
052505,友達日盛9B購02  ,0,0,0,0,0,0,0,0,0,190000,0,0,0,200000,10000,190000,190000
00659R,國泰日本反1     ,0,0,0,0,0,0,0,0,0,190000,0,0,0,191000,1000,190000,190000
03820P,聯詠統一93售04  ,0,0,0,0,0,0,0,0,0,190000,0,0,0,200000,10000,190000,190000
044062,可成元大92購02  ,0,0,0,0,0,0,0,0,0,190000,0,0,0,200000,10000,190000,190000
048337,致茂元大93購04  ,0,0,0,0,0,0,0,0,0,190000,0,0,0,220000,30000,190000,190000
046482,超眾元富92購03  ,0,0,0,0,0,0,0,0,0,190000,0,0,0,245000,55000,190000,190000
05086P,鴻海凱基95售13  ,0,0,0,0,0,0,0,0,0,190000,0,0,0,190000,0,190000,190000
05089P,亞德客元大95售01,0,0,0,0,0,0,0,0,0,190000,0,0,0,240000,50000,190000,190000
047746,宏碁元富93購01  ,0,0,0,0,0,0,0,0,0,189000,0,0,0,222000,33000,189000,189000
045614,瀚宇博群益92購01,0,0,0,0,0,0,0,0,0,189000,0,0,0,200000,11000,189000,189000
052428,嘉晶永豐95購01  ,0,0,0,0,0,0,0,0,0,188000,0,0,0,200000,12000,188000,188000
049399,台光電群益94購02,0,0,0,0,0,0,0,0,0,188000,0,0,0,270000,82000,188000,188000
2614,東森            ,197000,20000,177000,0,0,0,0,0,0,11000,11000,0,11000,0,0,0,188000
045914,超眾國票93購01  ,0,0,0,0,0,0,0,0,0,187000,0,0,0,227000,40000,187000,187000
050709,嘉聯益第一96購01,0,0,0,0,0,0,0,0,0,187000,0,0,0,187000,0,187000,187000
05070P,鴻海統一96售04  ,0,0,0,0,0,0,0,0,0,187000,0,0,0,187000,0,187000,187000
03481P,欣興群益02售08  ,0,0,0,0,0,0,0,0,0,186000,0,0,0,190000,4000,186000,186000
03659P,臺股指元大92售21,0,0,0,0,0,0,0,0,0,186000,0,0,0,200000,14000,186000,186000
053187,國巨統一96購05  ,0,0,0,0,0,0,0,0,0,185000,0,0,0,360000,175000,185000,185000
053491,鴻海兆豐97購02  ,0,0,0,0,0,0,0,0,0,185000,0,0,0,185000,0,185000,185000
04737P,正崴永豐94售02  ,0,0,0,0,0,0,0,0,0,185000,0,0,0,212000,27000,185000,185000
04672P,台積電統一94售09,0,0,0,0,0,0,0,0,0,185000,0,0,0,185000,0,185000,185000
046405,京元電元大92購07,0,0,0,0,0,0,0,0,0,185000,0,0,0,205000,20000,185000,185000
050979,鴻海元富96購02  ,0,0,0,0,0,0,0,0,0,185000,0,0,0,208000,23000,185000,185000
049059,超眾永豐94購01  ,0,0,0,0,0,0,0,0,0,184000,0,0,0,221000,37000,184000,184000
047688,亞德客富邦95購01,0,0,0,0,0,0,0,0,0,184000,0,0,0,418000,234000,184000,184000
048915,國巨台新94購01  ,0,0,0,0,0,0,0,0,0,184000,0,0,0,184000,0,184000,184000
050647,聯發科凱基96購01,0,0,0,0,0,0,0,0,0,184000,0,0,0,204000,20000,184000,184000
050625,康控第一94購01  ,0,0,0,0,0,0,0,0,0,184000,0,0,0,184000,0,184000,184000
050614,聯發科元大95購04,0,0,0,0,0,0,0,0,0,184000,0,0,0,373000,189000,184000,184000
4560,強信-KY         ,240000,56000,184000,0,0,0,0,0,0,0,0,0,0,0,0,0,184000
044161,台郡永豐91購02  ,0,0,0,0,0,0,0,0,0,183000,0,0,0,193000,10000,183000,183000
051226,英業達群益95購01,0,0,0,0,0,0,0,0,0,183000,0,0,0,193000,10000,183000,183000
05303P,華通國泰97售01  ,0,0,0,0,0,0,0,0,0,182000,0,0,0,212000,30000,182000,182000
052292,緯穎元富95購02  ,0,0,0,0,0,0,0,0,0,182000,0,0,0,222000,40000,182000,182000
04363P,儒鴻元富94售01  ,0,0,0,0,0,0,0,0,0,182000,0,0,0,182000,0,182000,182000
04270P,台光電國票93售03,0,0,0,0,0,0,0,0,0,182000,0,0,0,182000,0,182000,182000
042994,葡萄王元大94購02,0,0,0,0,0,0,0,0,0,182000,0,0,0,240000,58000,182000,182000
05090P,國巨元大95售05  ,0,0,0,0,0,0,0,0,0,182000,0,0,0,220000,38000,182000,182000
051599,健鼎兆豐95購02  ,0,0,0,0,0,0,0,0,0,182000,0,0,0,187000,5000,182000,182000
2393,億光            ,730000,555000,175000,0,0,0,0,0,0,7000,8000,1000,7000,0,0,0,182000
054220,國巨統一97購02  ,0,0,0,0,0,0,0,0,0,181000,0,0,0,182000,1000,181000,181000
054403,同欣電永豐96購02,0,0,0,0,0,0,0,0,0,181000,0,0,0,181000,0,181000,181000
00743,國泰中國A150    ,28000,0,28000,0,0,0,0,0,0,153000,0,0,0,161000,8000,153000,181000
03867P,樺漢元大93售02  ,0,0,0,0,0,0,0,0,0,181000,0,0,0,281000,100000,181000,181000
047443,智原元大94購01  ,0,0,0,0,0,0,0,0,0,181000,0,0,0,392000,211000,181000,181000
047828,華新元大93購03  ,0,0,0,0,0,0,0,0,0,181000,0,0,0,196000,15000,181000,181000
047408,嘉晶統一95購01  ,0,0,0,0,0,0,0,0,0,181000,0,0,0,203000,22000,181000,181000
048017,美利達國票93購01,0,0,0,0,0,0,0,0,0,181000,0,0,0,181000,0,181000,181000
051187,晶相光永豐95購01,0,0,0,0,0,0,0,0,0,181000,0,0,0,221000,40000,181000,181000
053998,泰鼎群益98購01  ,0,0,0,0,0,0,0,0,0,180000,0,0,0,185000,5000,180000,180000
052434,茂林國泰97購01  ,0,0,0,0,0,0,0,0,0,180000,0,0,0,250000,70000,180000,180000
052640,台表科凱基97購01,0,0,0,0,0,0,0,0,0,180000,0,0,0,369000,189000,180000,180000
053433,友達日盛99購06  ,0,0,0,0,0,0,0,0,0,180000,0,0,0,210000,30000,180000,180000
04767P,台積電國泰95售04,0,0,0,0,0,0,0,0,0,180000,0,0,0,205000,25000,180000,180000
050912,正崴中信95購02  ,0,0,0,0,0,0,0,0,0,180000,0,0,0,180000,0,180000,180000
050535,台表科群益94購02,0,0,0,0,0,0,0,0,0,180000,0,0,0,236000,56000,180000,180000
050062,聯發科凱基94購08,0,0,0,0,0,0,0,0,0,180000,0,0,0,274000,94000,180000,180000
06025P,臺股指元大99售02,0,0,0,0,0,0,0,0,0,180000,0,0,0,220000,40000,180000,180000
05951P,台積電國票97售05,0,0,0,0,0,0,0,0,0,180000,0,0,0,180000,0,180000,180000
052306,鴻海國泰97購05  ,0,0,0,0,0,0,0,0,0,179000,0,0,0,280000,101000,179000,179000
05116P,台積電群益95售03,0,0,0,0,0,0,0,0,0,179000,0,0,0,179000,0,179000,179000
2332,友訊            ,453000,646000,-193000,0,0,0,0,0,0,371000,209000,0,209000,162000,0,162000,178000
03784P,致伸凱基93售02  ,0,0,0,0,0,0,0,0,0,177000,0,0,0,199000,22000,177000,177000
053897,台郡群益96購01  ,0,0,0,0,0,0,0,0,0,176000,0,0,0,209000,33000,176000,176000
044215,可成凱基91購07  ,0,0,0,0,0,0,0,0,0,176000,0,0,0,176000,0,176000,176000
04692P,大立光群益94售06,0,0,0,0,0,0,0,0,0,176000,0,0,0,219000,43000,176000,176000
04782P,智伸科統一96售01,0,0,0,0,0,0,0,0,0,176000,0,0,0,176000,0,176000,176000
050898,智原元大96購01  ,0,0,0,0,0,0,0,0,0,176000,0,0,0,248000,72000,176000,176000
050834,啟碁凱基95購01  ,0,0,0,0,0,0,0,0,0,176000,0,0,0,238000,62000,176000,176000
04571P,華新科國泰95售03,0,0,0,0,0,0,0,0,0,175000,0,0,0,195000,20000,175000,175000
03904P,啟碁統一93售01  ,0,0,0,0,0,0,0,0,0,175000,0,0,0,302000,127000,175000,175000
04439P,聯發科群益94售04,0,0,0,0,0,0,0,0,0,175000,0,0,0,178000,3000,175000,175000
046143,京元電元富92購01,0,0,0,0,0,0,0,0,0,175000,0,0,0,175000,0,175000,175000
042604,國泰金富邦92購01,0,0,0,0,0,0,0,0,0,174000,0,0,0,192000,18000,174000,174000
049234,可成統一94購02  ,0,0,0,0,0,0,0,0,0,174000,0,0,0,294000,120000,174000,174000
052328,台表科中信99購01,0,0,0,0,0,0,0,0,0,173000,0,0,0,723000,550000,173000,173000
048562,宏達電元大95購01,0,0,0,0,0,0,0,0,0,173000,0,0,0,173000,0,173000,173000
05128P,聯發科中信97售03,0,0,0,0,0,0,0,0,0,173000,0,0,0,216000,43000,173000,173000
052213,富邦金元大95購01,0,0,0,0,0,0,0,0,0,173000,0,0,0,176000,3000,173000,173000
05723P,華通永豐96售03  ,0,0,0,0,0,0,0,0,0,173000,0,0,0,263000,90000,173000,173000
053176,矽力群益96購02  ,0,0,0,0,0,0,0,0,0,172000,0,0,0,196000,24000,172000,172000
046220,滬深2X元大95購03,0,0,0,0,0,0,0,0,0,172000,0,0,0,172000,0,172000,172000
050319,康控國票95購04  ,0,0,0,0,0,0,0,0,0,172000,0,0,0,197000,25000,172000,172000
050143,臻鼎元富94購05  ,0,0,0,0,0,0,0,0,0,172000,0,0,0,312000,140000,172000,172000
05301P,矽力元大95售02  ,0,0,0,0,0,0,0,0,0,171000,0,0,0,271000,100000,171000,171000
05512P,華新科台新97售01,0,0,0,0,0,0,0,0,0,171000,0,0,0,270000,99000,171000,171000
047328,瀚宇博元大93購04,0,0,0,0,0,0,0,0,0,171000,0,0,0,191000,20000,171000,171000
051188,鴻海兆豐95購01  ,0,0,0,0,0,0,0,0,0,171000,0,0,0,171000,0,171000,171000
053036,聯電凱基98購01  ,0,0,0,0,0,0,0,0,0,170000,0,0,0,275000,105000,170000,170000
052983,國巨元大96購07  ,0,0,0,0,0,0,0,0,0,170000,0,0,0,254000,84000,170000,170000
053124,聯發科凱基96購12,0,0,0,0,0,0,0,0,0,170000,0,0,0,245000,75000,170000,170000
052271,力成日盛95購02  ,0,0,0,0,0,0,0,0,0,170000,0,0,0,170000,0,170000,170000
04178P,聯茂元大93售07  ,0,0,0,0,0,0,0,0,0,170000,0,0,0,170000,0,170000,170000
03544P,鴻海群益02售07  ,0,0,0,0,0,0,0,0,0,170000,0,0,0,170000,0,170000,170000
048750,智原元富94購01  ,0,0,0,0,0,0,0,0,0,170000,0,0,0,220000,50000,170000,170000
049612,香港反中信96購01,0,0,0,0,0,0,0,0,0,170000,0,0,0,170000,0,170000,170000
050494,可成永昌96購01  ,0,0,0,0,0,0,0,0,0,170000,0,0,0,170000,0,170000,170000
052678,群創富邦96購01  ,0,0,0,0,0,0,0,0,0,169000,0,0,0,187000,18000,169000,169000
053695,智易元大97購02  ,0,0,0,0,0,0,0,0,0,169000,0,0,0,170000,1000,169000,169000
054181,華新康和96購01  ,0,0,0,0,0,0,0,0,0,168000,0,0,0,168000,0,168000,168000
05504P,台積電凱基96售04,0,0,0,0,0,0,0,0,0,168000,0,0,0,168000,0,168000,168000
044645,元金2X群益93購01,0,0,0,0,0,0,0,0,0,168000,0,0,0,170000,2000,168000,168000
04535P,華新統一94售01  ,0,0,0,0,0,0,0,0,0,168000,0,0,0,168000,0,168000,168000
044038,群創群益93購02  ,0,0,0,0,0,0,0,0,0,168000,0,0,0,244000,76000,168000,168000
04715P,聯茂元大94售06  ,0,0,0,0,0,0,0,0,0,168000,0,0,0,168000,0,168000,168000
046790,康友永豐93購01  ,0,0,0,0,0,0,0,0,0,168000,0,0,0,326000,158000,168000,168000
1504,東元            ,1206000,1097647,108353,0,0,0,8000,0,8000,51000,34000,0,34000,17000,0,17000,167353
04157P,鎧勝永豐93售02  ,0,0,0,0,0,0,0,0,0,167000,0,0,0,167000,0,167000,167000
03881P,易華電永豐93售02,0,0,0,0,0,0,0,0,0,167000,0,0,0,220000,53000,167000,167000
048900,精成科國泰95購01,0,0,0,0,0,0,0,0,0,167000,0,0,0,252000,85000,167000,167000
053441,旺宏凱基98購01  ,0,0,0,0,0,0,0,0,0,166000,0,0,0,302000,136000,166000,166000
03530P,臺股指凱基02售09,0,0,0,0,0,0,0,0,0,166000,0,0,0,166000,0,166000,166000
050274,GIS元大94購05   ,0,0,0,0,0,0,0,0,0,166000,0,0,0,273000,107000,166000,166000
05013P,台積電元大96售05,0,0,0,0,0,0,0,0,0,166000,0,0,0,206000,40000,166000,166000
051214,大立光統一95購02,0,0,0,0,0,0,0,0,0,166000,0,0,0,221000,55000,166000,166000
050945,致茂群益95購01  ,0,0,0,0,0,0,0,0,0,166000,0,0,0,468000,302000,166000,166000
052589,群創永豐97購01  ,0,0,0,0,0,0,0,0,0,165000,0,0,0,165000,0,165000,165000
042068,台灣50富邦93購02,0,0,0,0,0,0,0,0,0,165000,0,0,0,165000,0,165000,165000
04807P,聯茂元富94售01  ,0,0,0,0,0,0,0,0,0,165000,0,0,0,165000,0,165000,165000
051552,牧德永豐95購03  ,0,0,0,0,0,0,0,0,0,165000,0,0,0,221000,56000,165000,165000
05879P,台積電台新96售03,0,0,0,0,0,0,0,0,0,165000,0,0,0,178000,13000,165000,165000
047673,瑞昱元富96購01  ,0,0,0,0,0,0,0,0,0,164000,0,0,0,166000,2000,164000,164000
05120P,聯發科國泰97售01,0,0,0,0,0,0,0,0,0,164000,0,0,0,206000,42000,164000,164000
049525,華新科兆豐94購01,0,0,0,0,0,0,0,0,0,164000,0,0,0,168000,4000,164000,164000
050562,瑞昱元富94購02  ,0,0,0,0,0,0,0,0,0,164000,0,0,0,184000,20000,164000,164000
05496P,聯詠統一95售04  ,0,0,0,0,0,0,0,0,0,163000,0,0,0,228000,65000,163000,163000
045845,台塑康和92購01  ,0,0,0,0,0,0,0,0,0,163000,0,0,0,183000,20000,163000,163000
05680P,聯發科元大96售12,0,0,0,0,0,0,0,0,0,163000,0,0,0,423000,260000,163000,163000
05416P,喬山永豐95售04  ,0,0,0,0,0,0,0,0,0,162000,0,0,0,162000,0,162000,162000
05539P,鎧勝永豐96售01  ,0,0,0,0,0,0,0,0,0,161000,0,0,0,161000,0,161000,161000
052148,康友群益95購03  ,0,0,0,0,0,0,0,0,0,161000,0,0,0,181000,20000,161000,161000
052554,正崴國票97購01  ,0,0,0,0,0,0,0,0,0,160000,0,0,0,170000,10000,160000,160000
052670,茂林群益96購02  ,0,0,0,0,0,0,0,0,0,160000,0,0,0,460000,300000,160000,160000
044643,滬深2X群益96購01,0,0,0,0,0,0,0,0,0,160000,0,0,0,180000,20000,160000,160000
03890P,聯詠國泰94售02  ,0,0,0,0,0,0,0,0,0,160000,0,0,0,170000,10000,160000,160000
03811P,鴻海群益93售06  ,0,0,0,0,0,0,0,0,0,160000,0,0,0,160000,0,160000,160000
04529P,正文凱基94售04  ,0,0,0,0,0,0,0,0,0,160000,0,0,0,160000,0,160000,160000
044224,超眾凱基93購01  ,0,0,0,0,0,0,0,0,0,160000,0,0,0,160000,0,160000,160000
04800P,聯茂元大94售08  ,0,0,0,0,0,0,0,0,0,160000,0,0,0,160000,0,160000,160000
046103,麗豐永豐92購01  ,0,0,0,0,0,0,0,0,0,160000,0,0,0,175000,15000,160000,160000
048576,義隆國泰95購01  ,0,0,0,0,0,0,0,0,0,160000,0,0,0,190000,30000,160000,160000
046610,義隆國票93購01  ,0,0,0,0,0,0,0,0,0,160000,0,0,0,200000,40000,160000,160000
04932P,香港2X中信96售01,0,0,0,0,0,0,0,0,0,160000,0,0,0,160000,0,160000,160000
049396,元油2X群益97購03,0,0,0,0,0,0,0,0,0,160000,0,0,0,170000,10000,160000,160000
050525,嘉晶元大95購02  ,0,0,0,0,0,0,0,0,0,160000,0,0,0,160000,0,160000,160000
05769P,台積電凱基96售16,0,0,0,0,0,0,0,0,0,160000,0,0,0,318000,158000,160000,160000
05919P,京鼎元大96售03  ,0,0,0,0,0,0,0,0,0,160000,0,0,0,160000,0,160000,160000
049237,元油2X元富96購07,0,0,0,0,0,0,0,0,0,159000,0,0,0,159000,0,159000,159000
04655P,臺股指凱基94售14,0,0,0,0,0,0,0,0,0,159000,0,0,0,459000,300000,159000,159000
04685P,訊芯元大94售02  ,0,0,0,0,0,0,0,0,0,159000,0,0,0,180000,21000,159000,159000
05661P,聯發科統一96售06,0,0,0,0,0,0,0,0,0,159000,0,0,0,169000,10000,159000,159000
3661,世芯-KY         ,431000,83000,348000,0,0,0,0,190000,-190000,1000,22000,15000,7000,10000,16000,-6000,159000
03420P,牧德群益02售04  ,0,0,0,0,0,0,0,0,0,158000,0,0,0,158000,0,158000,158000
04172P,大立光凱基93售34,0,0,0,0,0,0,0,0,0,158000,0,0,0,317000,159000,158000,158000
049005,可成中信95購01  ,0,0,0,0,0,0,0,0,0,158000,0,0,0,208000,50000,158000,158000
047501,合勤控永豐93購01,0,0,0,0,0,0,0,0,0,158000,0,0,0,158000,0,158000,158000
050878,嘉聯益統一95購01,0,0,0,0,0,0,0,0,0,158000,0,0,0,158000,0,158000,158000
051961,泰碩永豐95購01  ,0,0,0,0,0,0,0,0,0,158000,0,0,0,180000,22000,158000,158000
051362,台郡元大95購04  ,0,0,0,0,0,0,0,0,0,158000,0,0,0,244000,86000,158000,158000
053962,聯茂永豐96購01  ,0,0,0,0,0,0,0,0,0,157000,0,0,0,157000,0,157000,157000
04542P,致伸永豐94售01  ,0,0,0,0,0,0,0,0,0,157000,0,0,0,262000,105000,157000,157000
046863,康友元大93購01  ,0,0,0,0,0,0,0,0,0,157000,0,0,0,282000,125000,157000,157000
049994,聯茂台新94購02  ,0,0,0,0,0,0,0,0,0,157000,0,0,0,157000,0,157000,157000
053456,大立光元富96購04,0,0,0,0,0,0,0,0,0,156000,0,0,0,167000,11000,156000,156000
048965,佳世達元大94購01,0,0,0,0,0,0,0,0,0,156000,0,0,0,219000,63000,156000,156000
049611,緯穎兆豐95購02  ,0,0,0,0,0,0,0,0,0,156000,0,0,0,217000,61000,156000,156000
050451,嘉晶元大95購01  ,0,0,0,0,0,0,0,0,0,156000,0,0,0,261000,105000,156000,156000
05162P,玉晶光國票96售03,0,0,0,0,0,0,0,0,0,156000,0,0,0,156000,0,156000,156000
052935,康友元大96購03  ,0,0,0,0,0,0,0,0,0,155000,0,0,0,276000,121000,155000,155000
04894P,世紀鋼元大94售02,0,0,0,0,0,0,0,0,0,155000,0,0,0,218000,63000,155000,155000
045870,元油2X元富96購02,0,0,0,0,0,0,0,0,0,155000,0,0,0,170000,15000,155000,155000
05184P,緯穎元富95售01  ,0,0,0,0,0,0,0,0,0,155000,0,0,0,155000,0,155000,155000
05197P,智原永豐95售02  ,0,0,0,0,0,0,0,0,0,155000,0,0,0,275000,120000,155000,155000
05220P,台積電元大95售16,0,0,0,0,0,0,0,0,0,155000,0,0,0,160000,5000,155000,155000
049546,正崴群益94購01  ,0,0,0,0,0,0,0,0,0,155000,0,0,0,165000,10000,155000,155000
08890P,為升元大01售04  ,0,0,0,0,0,0,0,0,0,155000,0,0,0,155000,0,155000,155000
05310P,智原永豐95售04  ,0,0,0,0,0,0,0,0,0,154000,0,0,0,240000,86000,154000,154000
051900,臻鼎富邦95購01  ,0,0,0,0,0,0,0,0,0,154000,0,0,0,233000,79000,154000,154000
05528P,臺股指群益96售01,0,0,0,0,0,0,0,0,0,153000,0,0,0,183000,30000,153000,153000
052207,台郡中信95購02  ,0,0,0,0,0,0,0,0,0,153000,0,0,0,235000,82000,153000,153000
052139,矽創凱基95購01  ,0,0,0,0,0,0,0,0,0,153000,0,0,0,153000,0,153000,153000
049443,元石油統一94購02,0,0,0,0,0,0,0,0,0,153000,0,0,0,153000,0,153000,153000
05926P,智易永豐96售02  ,0,0,0,0,0,0,0,0,0,153000,0,0,0,153000,0,153000,153000
03956P,欣興統一93售02  ,0,0,0,0,0,0,0,0,0,152000,0,0,0,401000,249000,152000,152000
04994P,大成鋼凱基95售01,0,0,0,0,0,0,0,0,0,152000,0,0,0,162000,10000,152000,152000
049293,友訊群益95購01  ,0,0,0,0,0,0,0,0,0,152000,0,0,0,157000,5000,152000,152000
05034P,台積電元大95售08,0,0,0,0,0,0,0,0,0,152000,0,0,0,620000,468000,152000,152000
05778P,台積電統一96售05,0,0,0,0,0,0,0,0,0,152000,0,0,0,153000,1000,152000,152000
053120,復盛中信9A購01  ,0,0,0,0,0,0,0,0,0,151000,0,0,0,151000,0,151000,151000
053092,台表科元大97購02,0,0,0,0,0,0,0,0,0,151000,0,0,0,171000,20000,151000,151000
053235,智原永豐96購01  ,0,0,0,0,0,0,0,0,0,151000,0,0,0,313000,162000,151000,151000
05267P,欣興元大95售08  ,0,0,0,0,0,0,0,0,0,151000,0,0,0,194000,43000,151000,151000
04387P,玉晶光日盛94售01,0,0,0,0,0,0,0,0,0,151000,0,0,0,151000,0,151000,151000
052449,創意元大95購04  ,0,0,0,0,0,0,0,0,0,150000,0,0,0,155000,5000,150000,150000
053180,同欣電統一96購01,0,0,0,0,0,0,0,0,0,150000,0,0,0,160000,10000,150000,150000
05334P,臺股指國票95售03,0,0,0,0,0,0,0,0,0,150000,0,0,0,150000,0,150000,150000
05413P,台郡國票96售02  ,0,0,0,0,0,0,0,0,0,150000,0,0,0,160000,10000,150000,150000
045439,A50正2元富92購01,0,0,0,0,0,0,0,0,0,150000,0,0,0,152000,2000,150000,150000
044737,奇鋐國泰93購02  ,0,0,0,0,0,0,0,0,0,150000,0,0,0,150000,0,150000,150000
045829,滬深2X群益95購02,0,0,0,0,0,0,0,0,0,150000,0,0,0,150000,0,150000,150000
039910,嘉聯益富邦91購01,0,0,0,0,0,0,0,0,0,150000,0,0,0,150000,0,150000,150000
04058P,臺股指群益93售12,0,0,0,0,0,0,0,0,0,150000,0,0,0,150000,0,150000,150000
04010P,上銀元大93售07  ,0,0,0,0,0,0,0,0,0,150000,0,0,0,150000,0,150000,150000
03795P,智邦元大93售03  ,0,0,0,0,0,0,0,0,0,150000,0,0,0,150000,0,150000,150000
03528P,日月光凱基02售02,0,0,0,0,0,0,0,0,0,150000,0,0,0,150000,0,150000,150000
042901,中纖元大94購01  ,0,0,0,0,0,0,0,0,0,150000,0,0,0,150000,0,150000,150000
047635,華新元大93購01  ,0,0,0,0,0,0,0,0,0,150000,0,0,0,150000,0,150000,150000
047276,中工永豐93購01  ,0,0,0,0,0,0,0,0,0,150000,0,0,0,150000,0,150000,150000
047079,GIS兆豐94購01   ,0,0,0,0,0,0,0,0,0,150000,0,0,0,230000,80000,150000,150000
046784,嘉晶永豐93購02  ,0,0,0,0,0,0,0,0,0,150000,0,0,0,150000,0,150000,150000
04667P,臺股指國票94售06,0,0,0,0,0,0,0,0,0,150000,0,0,0,170000,20000,150000,150000
048383,元金2X國票99購01,0,0,0,0,0,0,0,0,0,150000,0,0,0,150000,0,150000,150000
049451,富邦金統一94購03,0,0,0,0,0,0,0,0,0,150000,0,0,0,268000,118000,150000,150000
051671,和鑫元大96購02  ,0,0,0,0,0,0,0,0,0,150000,0,0,0,150000,0,150000,150000
054196,台光電國泰97購02,0,0,0,0,0,0,0,0,0,149000,0,0,0,237000,88000,149000,149000
048974,日電貿元大94購01,0,0,0,0,0,0,0,0,0,149000,0,0,0,231000,82000,149000,149000
049121,元油2X元富94購06,0,0,0,0,0,0,0,0,0,149000,0,0,0,149000,0,149000,149000
052051,京鼎凱基95購01  ,0,0,0,0,0,0,0,0,0,149000,0,0,0,149000,0,149000,149000
2405,浩鑫            ,175000,26000,149000,0,0,0,0,0,0,0,0,0,0,0,0,0,149000
052768,泰鼎群益96購01  ,0,0,0,0,0,0,0,0,0,148000,0,0,0,158000,10000,148000,148000
04411P,智易統一96售01  ,0,0,0,0,0,0,0,0,0,148000,0,0,0,148000,0,148000,148000
05149P,緯穎國泰96售01  ,0,0,0,0,0,0,0,0,0,148000,0,0,0,148000,0,148000,148000
5434,崇越            ,269000,130000,139000,0,0,0,0,0,0,9000,16000,0,16000,0,7000,-7000,148000
07383P,聯發科群益99售06,0,0,0,0,0,0,0,0,0,148000,0,0,0,148000,0,148000,148000
053488,中石化兆豐97購01,0,0,0,0,0,0,0,0,0,147000,0,0,0,182000,35000,147000,147000
054044,京元電元大96購03,0,0,0,0,0,0,0,0,0,147000,0,0,0,395000,248000,147000,147000
04243P,大立光永昌93售08,0,0,0,0,0,0,0,0,0,147000,0,0,0,158000,11000,147000,147000
049236,元油2X元富96購06,0,0,0,0,0,0,0,0,0,147000,0,0,0,147000,0,147000,147000
051864,聯發科凱基96購03,0,0,0,0,0,0,0,0,0,147000,0,0,0,289000,142000,147000,147000
053874,台表科元大96購05,0,0,0,0,0,0,0,0,0,146000,0,0,0,178000,32000,146000,146000
05430P,台積電統一95售07,0,0,0,0,0,0,0,0,0,146000,0,0,0,201000,55000,146000,146000
047726,友達群益94購02  ,0,0,0,0,0,0,0,0,0,146000,0,0,0,214000,68000,146000,146000
044876,同欣電統一91購01,0,0,0,0,0,0,0,0,0,146000,0,0,0,174000,28000,146000,146000
05170P,世芯元大95售01  ,0,0,0,0,0,0,0,0,0,146000,0,0,0,218000,72000,146000,146000
049751,牧德永豐95購01  ,0,0,0,0,0,0,0,0,0,146000,0,0,0,358000,212000,146000,146000
05962P,大立光群益96售07,0,0,0,0,0,0,0,0,0,146000,0,0,0,148000,2000,146000,146000
5225,東科-KY         ,167000,17000,150000,0,0,0,0,0,0,-4000,0,4000,-4000,0,0,0,146000
4725,信昌化          ,156000,11000,145000,0,0,0,0,0,0,0,0,0,0,0,0,0,145000
2609,陽明            ,218000,73000,145000,0,0,0,0,0,0,0,0,0,0,0,0,0,145000
054560,全新群益98購03  ,0,0,0,0,0,0,0,0,0,144000,0,0,0,144000,0,144000,144000
047117,禾伸堂元大93購02,0,0,0,0,0,0,0,0,0,144000,0,0,0,171000,27000,144000,144000
04954P,健策國票96售01  ,0,0,0,0,0,0,0,0,0,144000,0,0,0,267000,123000,144000,144000
05083P,麗豐永豐95售02  ,0,0,0,0,0,0,0,0,0,144000,0,0,0,200000,56000,144000,144000
050820,美食凱基95購01  ,0,0,0,0,0,0,0,0,0,144000,0,0,0,144000,0,144000,144000
051129,GIS群益95購01   ,0,0,0,0,0,0,0,0,0,144000,0,0,0,154000,10000,144000,144000
04889P,華通元大94售03  ,0,0,0,0,0,0,0,0,0,143000,0,0,0,203000,60000,143000,143000
051505,台積電元富95購05,0,0,0,0,0,0,0,0,0,143000,0,0,0,182000,39000,143000,143000
050464,華通國泰95購01  ,0,0,0,0,0,0,0,0,0,143000,0,0,0,145000,2000,143000,143000
053368,京元電富邦98購01,0,0,0,0,0,0,0,0,0,142000,0,0,0,147000,5000,142000,142000
053069,同欣電群益98購01,0,0,0,0,0,0,0,0,0,142000,0,0,0,209000,67000,142000,142000
05285P,同欣電群益95售02,0,0,0,0,0,0,0,0,0,142000,0,0,0,142000,0,142000,142000
051035,百和兆豐95購01  ,0,0,0,0,0,0,0,0,0,142000,0,0,0,202000,60000,142000,142000
051775,旺宏亞東95購01  ,0,0,0,0,0,0,0,0,0,141000,0,0,0,141000,0,141000,141000
4414,如興            ,233000,92000,141000,0,0,0,0,0,0,0,0,0,0,0,0,0,141000
054133,奇力新元大97購04,0,0,0,0,0,0,0,0,0,140000,0,0,0,259000,119000,140000,140000
04512P,臺股指元大94售07,0,0,0,0,0,0,0,0,0,140000,0,0,0,375000,235000,140000,140000
046294,台勝科統一92購01,0,0,0,0,0,0,0,0,0,140000,0,0,0,336000,196000,140000,140000
044198,友達國票92購01  ,0,0,0,0,0,0,0,0,0,140000,0,0,0,140000,0,140000,140000
04044P,鴻海元大93售18  ,0,0,0,0,0,0,0,0,0,140000,0,0,0,190000,50000,140000,140000
046054,冠德群益93購01  ,0,0,0,0,0,0,0,0,0,140000,0,0,0,140000,0,140000,140000
050955,達方群益97購01  ,0,0,0,0,0,0,0,0,0,140000,0,0,0,294000,154000,140000,140000
051507,彩晶元富95購01  ,0,0,0,0,0,0,0,0,0,140000,0,0,0,210000,70000,140000,140000
050172,臺指反元大98購02,0,0,0,0,0,0,0,0,0,140000,0,0,0,170000,30000,140000,140000
053744,台郡國票97購03  ,0,0,0,0,0,0,0,0,0,139000,0,0,0,139000,0,139000,139000
05419P,矽力永豐95售02  ,0,0,0,0,0,0,0,0,0,139000,0,0,0,191000,52000,139000,139000
052247,深中小永豐95購01,0,0,0,0,0,0,0,0,0,139000,0,0,0,177000,38000,139000,139000
04711P,台光電元大94售05,0,0,0,0,0,0,0,0,0,139000,0,0,0,150000,11000,139000,139000
050264,聯發科元大94購13,0,0,0,0,0,0,0,0,0,139000,0,0,0,158000,19000,139000,139000
051007,台光電麥證95購01,0,0,0,180000,67000,113000,0,0,0,139000,0,0,0,206000,67000,139000,139000
051139,康友永豐95購01  ,0,0,0,0,0,0,0,0,0,139000,0,0,0,332000,193000,139000,139000
051714,健鼎台新95購01  ,0,0,0,0,0,0,0,0,0,139000,0,0,0,139000,0,139000,139000
05990P,台積電群益96售13,0,0,0,0,0,0,0,0,0,139000,0,0,0,608000,469000,139000,139000
053074,嘉晶永豐96購02  ,0,0,0,0,0,0,0,0,0,138000,0,0,0,150000,12000,138000,138000
04343P,啟碁永豐93售02  ,0,0,0,0,0,0,0,0,0,138000,0,0,0,228000,90000,138000,138000
047394,合勤控元大93購02,0,0,0,0,0,0,0,0,0,138000,0,0,0,144000,6000,138000,138000
046531,臻鼎兆豐92購02  ,0,0,0,0,0,0,0,0,0,138000,0,0,0,248000,110000,138000,138000
051696,新日興中信96購01,0,0,0,0,0,0,0,0,0,138000,0,0,0,149000,11000,138000,138000
052615,鴻海國泰98購01  ,0,0,0,0,0,0,0,0,0,137000,0,0,0,243000,106000,137000,137000
053982,臻鼎元大96購05  ,0,0,0,0,0,0,0,0,0,137000,0,0,0,152000,15000,137000,137000
047457,旺宏群益95購01  ,0,0,0,0,0,0,0,0,0,137000,0,0,0,255000,118000,137000,137000
051747,貿聯國泰96購01  ,0,0,0,0,0,0,0,0,0,137000,0,0,0,317000,180000,137000,137000
051401,華新科永豐95購01,0,0,0,0,0,0,0,0,0,137000,0,0,0,178000,41000,137000,137000
05405P,大立光群益95售04,0,0,0,0,0,0,0,0,0,136000,0,0,0,227000,91000,136000,136000
04260P,亞德客群益93售01,0,0,0,0,0,0,0,0,0,136000,0,0,0,151000,15000,136000,136000
046467,台虹凱基92購02  ,0,0,0,0,0,0,0,0,0,136000,0,0,0,189000,53000,136000,136000
050214,嘉晶台新94購01  ,0,0,0,0,0,0,0,0,0,136000,0,0,0,166000,30000,136000,136000
05986P,大立光統一97售03,0,0,0,0,0,0,0,0,0,136000,0,0,0,148000,12000,136000,136000
05673P,台積電群益96售05,0,0,0,0,0,0,0,0,0,136000,0,0,0,551000,415000,136000,136000
053391,嘉聯益元大99購01,0,0,0,0,0,0,0,0,0,135000,0,0,0,277000,142000,135000,135000
03856P,易華電永豐93售01,0,0,0,0,0,0,0,0,0,135000,0,0,0,182000,47000,135000,135000
046615,大成鋼凱基93購01,0,0,0,0,0,0,0,0,0,135000,0,0,0,135000,0,135000,135000
051292,牧德統一97購01  ,0,0,0,0,0,0,0,0,0,135000,0,0,0,215000,80000,135000,135000
051761,富邦金元大96購01,0,0,0,0,0,0,0,0,0,135000,0,0,0,206000,71000,135000,135000
05169P,玉晶光元大95售03,0,0,0,0,0,0,0,0,0,135000,0,0,0,135000,0,135000,135000
052695,台表科中信98購01,0,0,0,0,0,0,0,0,0,134000,0,0,0,354000,220000,134000,134000
05921P,同欣電元大96售06,0,0,0,0,0,0,0,0,0,134000,0,0,0,139000,5000,134000,134000
05269P,臻鼎元大95售05  ,0,0,0,0,0,0,0,0,0,133000,0,0,0,147000,14000,133000,133000
048475,台郡永豐93購02  ,0,0,0,0,0,0,0,0,0,133000,0,0,0,166000,33000,133000,133000
051396,健鼎兆豐95購01  ,0,0,0,0,0,0,0,0,0,133000,0,0,0,133000,0,133000,133000
054333,茂林永豐96購03  ,0,0,0,0,0,0,0,0,0,132000,0,0,0,132000,0,132000,132000
03798P,台光電元大93售02,0,0,0,0,0,0,0,0,0,132000,0,0,0,200000,68000,132000,132000
047528,高鐵元大93購03  ,0,0,0,0,0,0,0,0,0,132000,0,0,0,201000,69000,132000,132000
051118,台塑群益95購01  ,0,0,0,0,0,0,0,0,0,132000,0,0,0,159000,27000,132000,132000
049570,華新科統一94購04,0,0,0,0,0,0,0,0,0,132000,0,0,0,293000,161000,132000,132000
052375,奇力新元大96購02,0,0,0,0,0,0,0,0,0,131000,0,0,0,216000,85000,131000,131000
048392,宏碁國票94購01  ,0,0,0,0,0,0,0,0,0,131000,0,0,0,153000,22000,131000,131000
05227P,大立光統一95售04,0,0,0,0,0,0,0,0,0,130000,0,0,0,130000,0,130000,130000
05262P,台積電元大95售19,0,0,0,0,0,0,0,0,0,130000,0,0,0,460000,330000,130000,130000
05569P,漢唐統一97售01  ,0,0,0,0,0,0,0,0,0,130000,0,0,0,373000,243000,130000,130000
03147P,台灣50群益03售02,0,0,0,0,0,0,0,0,0,130000,0,0,0,130000,0,130000,130000
044633,台郡元大92購03  ,0,0,0,0,0,0,0,0,0,130000,0,0,0,130000,0,130000,130000
044083,開發金國票91購01,0,0,0,0,0,0,0,0,0,130000,0,0,0,130000,0,130000,130000
044046,台達電麥證91購01,0,0,0,130000,0,130000,0,0,0,130000,0,0,0,130000,0,130000,130000
044049,元金2X元大94購03,0,0,0,0,0,0,0,0,0,130000,0,0,0,140000,10000,130000,130000
048991,昇陽半元大94購01,0,0,0,0,0,0,0,0,0,130000,0,0,0,142000,12000,130000,130000
049832,麗豐凱基94購05  ,0,0,0,0,0,0,0,0,0,130000,0,0,0,130000,0,130000,130000
050450,富邦金元大94購03,0,0,0,0,0,0,0,0,0,130000,0,0,0,130000,0,130000,130000
08795P,聯發科凱基01售11,0,0,0,0,0,0,0,0,0,130000,0,0,0,130000,0,130000,130000
045128,旺宏統一92購01  ,0,0,0,0,0,0,0,0,0,129000,0,0,0,455000,326000,129000,129000
04127P,聯茂國票93售02  ,0,0,0,0,0,0,0,0,0,129000,0,0,0,164000,35000,129000,129000
054607,台積電永豐97購03,0,0,0,0,0,0,0,0,0,128000,0,0,0,132000,4000,128000,128000
054017,茂林永豐96購02  ,0,0,0,0,0,0,0,0,0,128000,0,0,0,128000,0,128000,128000
044814,華邦電兆豐93購02,0,0,0,0,0,0,0,0,0,128000,0,0,0,514000,386000,128000,128000
046333,康友元大92購05  ,0,0,0,0,0,0,0,0,0,128000,0,0,0,187000,59000,128000,128000
047880,聯發科國泰94購03,0,0,0,0,0,0,0,0,0,128000,0,0,0,144000,16000,128000,128000
050517,台積電元大94購27,0,0,0,0,0,0,0,0,0,128000,0,0,0,372000,244000,128000,128000
049522,華通兆豐94購02  ,0,0,0,0,0,0,0,0,0,128000,0,0,0,128000,0,128000,128000
050991,元油2X元大96購04,0,0,0,0,0,0,0,0,0,128000,0,0,0,267000,139000,128000,128000
051288,可成統一95購03  ,0,0,0,0,0,0,0,0,0,128000,0,0,0,128000,0,128000,128000
05992P,華通元大96售05  ,0,0,0,0,0,0,0,0,0,128000,0,0,0,153000,25000,128000,128000
6669,緯穎            ,245000,46800,198200,0,0,0,44000,55000,-11000,-60000,6000,31000,-25000,45000,80000,-35000,127200
054175,高鐵台新97購01  ,0,0,0,0,0,0,0,0,0,127000,0,0,0,179000,52000,127000,127000
052888,台表科中信9A購01,0,0,0,0,0,0,0,0,0,127000,0,0,0,156000,29000,127000,127000
053181,滬深2X元富99購02,0,0,0,0,0,0,0,0,0,127000,0,0,0,339000,212000,127000,127000
04756P,大立光元富94售08,0,0,0,0,0,0,0,0,0,127000,0,0,0,127000,0,127000,127000
05396P,台郡元大95售05  ,0,0,0,0,0,0,0,0,0,126000,0,0,0,275000,149000,126000,126000
04900P,矽格中信94售02  ,0,0,0,0,0,0,0,0,0,126000,0,0,0,126000,0,126000,126000
04269P,華通國票93售03  ,0,0,0,0,0,0,0,0,0,125000,0,0,0,125000,0,125000,125000
04463P,可成元富94售03  ,0,0,0,0,0,0,0,0,0,125000,0,0,0,210000,85000,125000,125000
046665,智原元大93購01  ,0,0,0,0,0,0,0,0,0,125000,0,0,0,544000,419000,125000,125000
046549,康友永豐92購02  ,0,0,0,0,0,0,0,0,0,125000,0,0,0,129000,4000,125000,125000
04940P,台積電國票95售02,0,0,0,0,0,0,0,0,0,125000,0,0,0,125000,0,125000,125000
053602,台虹元大96購01  ,0,0,0,0,0,0,0,0,0,124000,0,0,0,596000,472000,124000,124000
05263P,台積電元大96售09,0,0,0,0,0,0,0,0,0,124000,0,0,0,147000,23000,124000,124000
04314P,聯茂元富93售01  ,0,0,0,0,0,0,0,0,0,124000,0,0,0,124000,0,124000,124000
04076P,臺股指凱基93售12,0,0,0,0,0,0,0,0,0,124000,0,0,0,124000,0,124000,124000
046380,神基凱基93購01  ,0,0,0,0,0,0,0,0,0,124000,0,0,0,124000,0,124000,124000
049353,茂林永豐94購03  ,0,0,0,0,0,0,0,0,0,124000,0,0,0,249000,125000,124000,124000
2108,南帝            ,144000,20320,123680,0,0,0,0,0,0,0,0,0,0,0,0,0,123680
053126,健策凱基97購02  ,0,0,0,0,0,0,0,0,0,123000,0,0,0,141000,18000,123000,123000
04038P,聯茂群益93售03  ,0,0,0,0,0,0,0,0,0,123000,0,0,0,123000,0,123000,123000
00671R,富邦NASDAQ反1   ,3000,0,3000,0,0,0,0,0,0,120000,0,0,0,162000,42000,120000,123000
048878,康控國票95購02  ,0,0,0,0,0,0,0,0,0,123000,0,0,0,150000,27000,123000,123000
051122,美食群益95購01  ,0,0,0,0,0,0,0,0,0,123000,0,0,0,123000,0,123000,123000
051697,康友中信95購02  ,0,0,0,0,0,0,0,0,0,123000,0,0,0,256000,133000,123000,123000
052167,亞泥元大96購01  ,0,0,0,0,0,0,0,0,0,123000,0,0,0,123000,0,123000,123000
052925,日電貿永豐96購01,0,0,0,0,0,0,0,0,0,122000,0,0,0,260000,138000,122000,122000
053354,康控兆豐97購02  ,0,0,0,0,0,0,0,0,0,122000,0,0,0,122000,0,122000,122000
054252,奇力新元大96購04,0,0,0,0,0,0,0,0,0,122000,0,0,0,242000,120000,122000,122000
045077,國泰金元大92購01,0,0,0,0,0,0,0,0,0,122000,0,0,0,171000,49000,122000,122000
048978,晶相光元大94購02,0,0,0,0,0,0,0,0,0,122000,0,0,0,275000,153000,122000,122000
049211,昇陽半群益94購03,0,0,0,0,0,0,0,0,0,122000,0,0,0,138000,16000,122000,122000
049897,華新科統一94購07,0,0,0,0,0,0,0,0,0,122000,0,0,0,132000,10000,122000,122000
04614P,光罩群益94售02  ,0,0,0,0,0,0,0,0,0,122000,0,0,0,122000,0,122000,122000
046785,禾伸堂永豐93購01,0,0,0,0,0,0,0,0,0,122000,0,0,0,183000,61000,122000,122000
051831,緯穎元大96購04  ,0,0,0,0,0,0,0,0,0,122000,0,0,0,380000,258000,122000,122000
4737,華廣            ,136000,14000,122000,0,0,0,0,0,0,0,0,0,0,0,0,0,122000
05422P,大立光中信97售02,0,0,0,0,0,0,0,0,0,121000,0,0,0,141000,20000,121000,121000
053639,禾伸堂永豐96購01,0,0,0,0,0,0,0,0,0,121000,0,0,0,161000,40000,121000,121000
054192,國巨中信98購01  ,0,0,0,0,0,0,0,0,0,121000,0,0,0,554000,433000,121000,121000
053230,達方台新97購01  ,0,0,0,0,0,0,0,0,0,121000,0,0,0,121000,0,121000,121000
052874,超眾凱基96購01  ,0,0,0,0,0,0,0,0,0,121000,0,0,0,166000,45000,121000,121000
04120P,智邦凱基93售09  ,0,0,0,0,0,0,0,0,0,121000,0,0,0,121000,0,121000,121000
04201P,智原群益93售01  ,0,0,0,0,0,0,0,0,0,121000,0,0,0,122000,1000,121000,121000
047581,康控台新93購01  ,0,0,0,0,0,0,0,0,0,121000,0,0,0,132000,11000,121000,121000
048928,華新科永豐94購02,0,0,0,0,0,0,0,0,0,121000,0,0,0,243000,122000,121000,121000
050780,台表科元大96購01,0,0,0,0,0,0,0,0,0,121000,0,0,0,194000,73000,121000,121000
050808,台達電凱基96購02,0,0,0,0,0,0,0,0,0,121000,0,0,0,121000,0,121000,121000
054173,奇力新台新97購02,0,0,0,0,0,0,0,0,0,120000,0,0,0,120000,0,120000,120000
054382,康控群益96購03  ,0,0,0,0,0,0,0,0,0,120000,0,0,0,120000,0,120000,120000
05565P,鎧勝元大96售01  ,0,0,0,0,0,0,0,0,0,120000,0,0,0,170000,50000,120000,120000
05517P,臻鼎元大96售01  ,0,0,0,0,0,0,0,0,0,120000,0,0,0,120000,0,120000,120000
04228P,貿聯永豐93售03  ,0,0,0,0,0,0,0,0,0,120000,0,0,0,120000,0,120000,120000
03102P,臺股指凱基03售08,0,0,0,0,0,0,0,0,0,120000,0,0,0,200000,80000,120000,120000
039645,瑞儀群益91購01  ,0,0,0,0,0,0,0,0,0,120000,0,0,0,120000,0,120000,120000
044261,南寶國泰91購01  ,0,0,0,0,0,0,0,0,0,120000,0,0,0,120000,0,120000,120000
048012,嘉晶國票94購01  ,0,0,0,0,0,0,0,0,0,120000,0,0,0,120000,0,120000,120000
049688,台光電元大94購04,0,0,0,0,0,0,0,0,0,120000,0,0,0,202000,82000,120000,120000
5269,祥碩            ,231000,178229,52771,0,0,0,104000,50000,54000,13000,16000,20000,-4000,17000,0,17000,119771
053113,瀚宇博兆豐97購01,0,0,0,0,0,0,0,0,0,119000,0,0,0,119000,0,119000,119000
049774,元油2X統一94購05,0,0,0,0,0,0,0,0,0,119000,0,0,0,123000,4000,119000,119000
050368,國巨元大94購14  ,0,0,0,0,0,0,0,0,0,119000,0,0,0,145000,26000,119000,119000
053447,京鼎凱基96購03  ,0,0,0,0,0,0,0,0,0,118000,0,0,0,118000,0,118000,118000
045762,微星統一92購01  ,0,0,0,0,0,0,0,0,0,118000,0,0,0,153000,35000,118000,118000
048839,牧德凱基95購01  ,0,0,0,0,0,0,0,0,0,118000,0,0,0,247000,129000,118000,118000
050882,華泰國泰96購01  ,0,0,0,0,0,0,0,0,0,118000,0,0,0,133000,15000,118000,118000
053210,華邦電凱基97購02,0,0,0,0,0,0,0,0,0,117000,0,0,0,420000,303000,117000,117000
054366,和大中信98購01  ,0,0,0,0,0,0,0,0,0,117000,0,0,0,289000,172000,117000,117000
04517P,宏達電群益95售01,0,0,0,0,0,0,0,0,0,117000,0,0,0,140000,23000,117000,117000
03026X,元展23          ,0,0,0,0,0,0,0,0,0,117000,0,0,0,118000,1000,117000,117000
050317,和鑫國票95購02  ,0,0,0,0,0,0,0,0,0,117000,0,0,0,167000,50000,117000,117000
049803,華新科元大95購07,0,0,0,0,0,0,0,0,0,117000,0,0,0,140000,23000,117000,117000
053459,康控國泰97購01  ,0,0,0,0,0,0,0,0,0,116000,0,0,0,126000,10000,116000,116000
052764,景碩群益98購01  ,0,0,0,0,0,0,0,0,0,116000,0,0,0,138000,22000,116000,116000
045285,禾伸堂永豐92購01,0,0,0,0,0,0,0,0,0,116000,0,0,0,116000,0,116000,116000
044041,台郡群益91購01  ,0,0,0,0,0,0,0,0,0,116000,0,0,0,136000,20000,116000,116000
044201,群創國票95購01  ,0,0,0,0,0,0,0,0,0,116000,0,0,0,504000,388000,116000,116000
047747,致茂元富93購01  ,0,0,0,0,0,0,0,0,0,116000,0,0,0,116000,0,116000,116000
047274,華新科永豐93購02,0,0,0,0,0,0,0,0,0,116000,0,0,0,176000,60000,116000,116000
05047P,強茂永豐95售02  ,0,0,0,0,0,0,0,0,0,116000,0,0,0,160000,44000,116000,116000
9919,康那香          ,123000,7000,116000,0,0,0,0,0,0,0,0,0,0,0,0,0,116000
2428,興勤            ,171194,55375,115819,0,0,0,0,0,0,0,0,0,0,0,0,0,115819
044998,玉晶光國泰94購01,0,0,0,0,0,0,0,0,0,115000,0,0,0,115000,0,115000,115000
03062P,世紀鋼凱基02售02,0,0,0,0,0,0,0,0,0,115000,0,0,0,115000,0,115000,115000
04322P,可成元大94售01  ,0,0,0,0,0,0,0,0,0,115000,0,0,0,115000,0,115000,115000
044320,瀚宇博永豐91購01,0,0,0,0,0,0,0,0,0,115000,0,0,0,158000,43000,115000,115000
047587,義隆永豐93購02  ,0,0,0,0,0,0,0,0,0,115000,0,0,0,115000,0,115000,115000
046203,GIS凱基93購02   ,0,0,0,0,0,0,0,0,0,115000,0,0,0,115000,0,115000,115000
047370,聯發科國票93購03,0,0,0,0,0,0,0,0,0,115000,0,0,0,175000,60000,115000,115000
050633,義隆群益96購02  ,0,0,0,0,0,0,0,0,0,115000,0,0,0,233000,118000,115000,115000
05175P,TPK富邦99售01   ,0,0,0,0,0,0,0,0,0,115000,0,0,0,292000,177000,115000,115000
05333P,臺股指國票95售02,0,0,0,0,0,0,0,0,0,114000,0,0,0,114000,0,114000,114000
054083,智伸科元富96購01,0,0,0,0,0,0,0,0,0,114000,0,0,0,114000,0,114000,114000
05370P,矽創元富95售01  ,0,0,0,0,0,0,0,0,0,114000,0,0,0,134000,20000,114000,114000
046921,日電貿永豐93購01,0,0,0,0,0,0,0,0,0,114000,0,0,0,167000,53000,114000,114000
05632P,大立光群益96售02,0,0,0,0,0,0,0,0,0,114000,0,0,0,210000,96000,114000,114000
053587,京元電元大98購01,0,0,0,0,0,0,0,0,0,113000,0,0,0,401000,288000,113000,113000
052578,大立光統一97購01,0,0,0,0,0,0,0,0,0,113000,0,0,0,113000,0,113000,113000
044929,康控國泰93購01  ,0,0,0,0,0,0,0,0,0,113000,0,0,0,133000,20000,113000,113000
04853P,易華電永豐94售03,0,0,0,0,0,0,0,0,0,113000,0,0,0,145000,32000,113000,113000
051674,臻鼎元大95購02  ,0,0,0,0,0,0,0,0,0,113000,0,0,0,121000,8000,113000,113000
052145,京元電群益95購02,0,0,0,0,0,0,0,0,0,113000,0,0,0,133000,20000,113000,113000
042754,元黃金元大93購01,0,0,0,0,0,0,0,0,0,112000,0,0,0,170000,58000,112000,112000
03219P,台積電康和02售01,0,0,0,0,0,0,0,0,0,112000,0,0,0,132000,20000,112000,112000
04852P,臻鼎永豐94售02  ,0,0,0,0,0,0,0,0,0,112000,0,0,0,112000,0,112000,112000
047404,香港2X統一94購01,0,0,0,0,0,0,0,0,0,112000,0,0,0,123000,11000,112000,112000
04610P,世紀鋼永豐94售03,0,0,0,0,0,0,0,0,0,112000,0,0,0,142000,30000,112000,112000
051690,超眾凱基95購03  ,0,0,0,0,0,0,0,0,0,112000,0,0,0,142000,30000,112000,112000
051185,強茂永豐95購03  ,0,0,0,0,0,0,0,0,0,112000,0,0,0,304000,192000,112000,112000
051323,康控國票96購01  ,0,0,0,0,0,0,0,0,0,112000,0,0,0,113000,1000,112000,112000
051476,聯發科凱基95購09,0,0,0,0,0,0,0,0,0,112000,0,0,0,197000,85000,112000,112000
06017P,亞光凱基96售04  ,0,0,0,0,0,0,0,0,0,112000,0,0,0,120000,8000,112000,112000
04301P,微星中信93售01  ,0,0,0,0,0,0,0,0,0,111000,0,0,0,111000,0,111000,111000
048887,牧德元富94購01  ,0,0,0,0,0,0,0,0,0,111000,0,0,0,121000,10000,111000,111000
047578,新光金群益93購01,0,0,0,0,0,0,0,0,0,111000,0,0,0,141000,30000,111000,111000
048941,牧德永豐94購02  ,0,0,0,0,0,0,0,0,0,111000,0,0,0,349000,238000,111000,111000
051103,緯穎元大96購03  ,0,0,0,0,0,0,0,0,0,111000,0,0,0,298000,187000,111000,111000
9907,統一實          ,116000,5000,111000,0,0,0,0,0,0,0,0,0,0,0,0,0,111000
052988,智易元大96購02  ,0,0,0,0,0,0,0,0,0,110000,0,0,0,110000,0,110000,110000
053585,友達元大9C購03  ,0,0,0,0,0,0,0,0,0,110000,0,0,0,120000,10000,110000,110000
054389,為升元富96購02  ,0,0,0,0,0,0,0,0,0,110000,0,0,0,110000,0,110000,110000
042803,天鈺元大93購01  ,0,0,0,0,0,0,0,0,0,110000,0,0,0,110000,0,110000,110000
03269P,健策元大02售04  ,0,0,0,0,0,0,0,0,0,110000,0,0,0,110000,0,110000,110000
044733,潤泰全國票91購01,0,0,0,0,0,0,0,0,0,110000,0,0,0,110000,0,110000,110000
048740,富邦金統一94購01,0,0,0,0,0,0,0,0,0,110000,0,0,0,110000,0,110000,110000
048528,華泰國票94購01  ,0,0,0,0,0,0,0,0,0,110000,0,0,0,110000,0,110000,110000
047390,富邦金元大93購01,0,0,0,0,0,0,0,0,0,110000,0,0,0,120000,10000,110000,110000
051127,同欣電群益95購01,0,0,0,0,0,0,0,0,0,110000,0,0,0,125000,15000,110000,110000
051446,中壽元大96購01  ,0,0,0,0,0,0,0,0,0,110000,0,0,0,110000,0,110000,110000
051580,宏碁元大95購02  ,0,0,0,0,0,0,0,0,0,110000,0,0,0,110000,0,110000,110000
051804,新光金日盛95購01,0,0,0,0,0,0,0,0,0,110000,0,0,0,134000,24000,110000,110000
052004,泰碩國泰97購03  ,0,0,0,0,0,0,0,0,0,110000,0,0,0,132000,22000,110000,110000
050205,牧德群益94購02  ,0,0,0,0,0,0,0,0,0,110000,0,0,0,316000,206000,110000,110000
049854,超眾群益94購02  ,0,0,0,0,0,0,0,0,0,110000,0,0,0,183000,73000,110000,110000
050067,美食凱基94購02  ,0,0,0,0,0,0,0,0,0,110000,0,0,0,110000,0,110000,110000
08484P,台灣50中信96售01,0,0,0,0,0,0,0,0,0,110000,0,0,0,200000,90000,110000,110000
4977,眾達-KY         ,140000,56000,84000,0,0,0,0,0,0,26000,11000,0,11000,15000,0,15000,110000
053049,T50反1國票98購01,0,0,0,0,0,0,0,0,0,109000,0,0,0,109000,0,109000,109000
053136,彩晶國票97購01  ,0,0,0,0,0,0,0,0,0,109000,0,0,0,109000,0,109000,109000
043962,亞泥國泰92購01  ,0,0,0,0,0,0,0,0,0,109000,0,0,0,112000,3000,109000,109000
044515,禾伸堂凱基91購02,0,0,0,0,0,0,0,0,0,109000,0,0,0,139000,30000,109000,109000
047365,隆達群益93購01  ,0,0,0,0,0,0,0,0,0,109000,0,0,0,109000,0,109000,109000
04585P,楠梓電永豐94售02,0,0,0,0,0,0,0,0,0,109000,0,0,0,109000,0,109000,109000
048582,國泰金富邦93購01,0,0,0,0,0,0,0,0,0,109000,0,0,0,109000,0,109000,109000
04923P,GIS凱基94售06   ,0,0,0,0,0,0,0,0,0,109000,0,0,0,110000,1000,109000,109000
049837,臺股指凱基96購02,0,0,0,0,0,0,0,0,0,109000,0,0,0,194000,85000,109000,109000
049768,奇鋐元富94購01  ,0,0,0,0,0,0,0,0,0,109000,0,0,0,119000,10000,109000,109000
050602,訊芯國泰96購01  ,0,0,0,0,0,0,0,0,0,109000,0,0,0,420000,311000,109000,109000
051332,奇力新永豐95購01,0,0,0,0,0,0,0,0,0,109000,0,0,0,159000,50000,109000,109000
2369,菱生            ,245000,136000,109000,0,0,0,0,0,0,0,0,0,0,0,0,0,109000
05987P,健策統一96售02  ,0,0,0,0,0,0,0,0,0,109000,0,0,0,154000,45000,109000,109000
053864,義隆元大96購01  ,0,0,0,0,0,0,0,0,0,108000,0,0,0,296000,188000,108000,108000
04264P,宏碁統一93售01  ,0,0,0,0,0,0,0,0,0,108000,0,0,0,138000,30000,108000,108000
043018,新光金元大93購01,0,0,0,0,0,0,0,0,0,108000,0,0,0,108000,0,108000,108000
03415B,臺股指元大93熊49,0,0,0,0,0,0,0,0,0,108000,0,0,0,140000,32000,108000,108000
046250,全新群益92購04  ,0,0,0,0,0,0,0,0,0,108000,0,0,0,206000,98000,108000,108000
047279,日月光永豐93購01,0,0,0,0,0,0,0,0,0,108000,0,0,0,154000,46000,108000,108000
047527,高鐵元大93購02  ,0,0,0,0,0,0,0,0,0,108000,0,0,0,120000,12000,108000,108000
04745P,祥碩元大94售04  ,0,0,0,0,0,0,0,0,0,108000,0,0,0,171000,63000,108000,108000
048977,晶相光元大94購01,0,0,0,0,0,0,0,0,0,108000,0,0,0,295000,187000,108000,108000
050968,超眾永豐95購01  ,0,0,0,0,0,0,0,0,0,108000,0,0,0,131000,23000,108000,108000
051944,智邦統一95購02  ,0,0,0,0,0,0,0,0,0,108000,0,0,0,148000,40000,108000,108000
05041P,大立光凱基95售09,0,0,0,0,0,0,0,0,0,108000,0,0,0,114000,6000,108000,108000
05637P,聯電元大96售04  ,0,0,0,0,0,0,0,0,0,108000,0,0,0,285000,177000,108000,108000
05654P,台光電統一96售01,0,0,0,0,0,0,0,0,0,108000,0,0,0,108000,0,108000,108000
05616P,台光電永豐96售01,0,0,0,0,0,0,0,0,0,108000,0,0,0,108000,0,108000,108000
054149,達方元大96購01  ,0,0,0,0,0,0,0,0,0,107000,0,0,0,353000,246000,107000,107000
00650L,FH香港正2       ,0,0,0,0,0,0,0,0,0,107000,0,0,0,463000,356000,107000,107000
04282P,微星永豐93售02  ,0,0,0,0,0,0,0,0,0,107000,0,0,0,107000,0,107000,107000
050159,超眾群益94購03  ,0,0,0,0,0,0,0,0,0,107000,0,0,0,192000,85000,107000,107000
052070,GIS兆豐95購03   ,0,0,0,0,0,0,0,0,0,107000,0,0,0,177000,70000,107000,107000
051832,復盛元大95購01  ,0,0,0,0,0,0,0,0,0,107000,0,0,0,107000,0,107000,107000
051363,矽創元大95購03  ,0,0,0,0,0,0,0,0,0,107000,0,0,0,113000,6000,107000,107000
051272,嘉晶群益95購01  ,0,0,0,0,0,0,0,0,0,107000,0,0,0,114000,7000,107000,107000
05905P,晶技統一97售01  ,0,0,0,0,0,0,0,0,0,107000,0,0,0,225000,118000,107000,107000
06024P,台郡國票97售05  ,0,0,0,0,0,0,0,0,0,107000,0,0,0,113000,6000,107000,107000
053619,和碩群益96購01  ,0,0,0,0,0,0,0,0,0,106000,0,0,0,106000,0,106000,106000
04329P,TPK群益93售04   ,0,0,0,0,0,0,0,0,0,106000,0,0,0,147000,41000,106000,106000
048795,復盛元大94購01  ,0,0,0,0,0,0,0,0,0,106000,0,0,0,171000,65000,106000,106000
048700,和鑫國票95購01  ,0,0,0,0,0,0,0,0,0,106000,0,0,0,106000,0,106000,106000
046627,高鐵統一95購01  ,0,0,0,0,0,0,0,0,0,106000,0,0,0,192000,86000,106000,106000
046201,台郡凱基92購01  ,0,0,0,0,0,0,0,0,0,106000,0,0,0,109000,3000,106000,106000
052054,台表科凱基96購01,0,0,0,0,0,0,0,0,0,106000,0,0,0,295000,189000,106000,106000
050354,瀚宇博群益94購02,0,0,0,0,0,0,0,0,0,106000,0,0,0,118000,12000,106000,106000
08420P,國巨群益9C售12  ,0,0,0,0,0,0,0,0,0,106000,0,0,0,106000,0,106000,106000
054386,鴻海統一98購03  ,0,0,0,0,0,0,0,0,0,105000,0,0,0,125000,20000,105000,105000
054460,和大凱基97購01  ,0,0,0,0,0,0,0,0,0,105000,0,0,0,156000,51000,105000,105000
053449,超眾凱基98購01  ,0,0,0,0,0,0,0,0,0,105000,0,0,0,120000,15000,105000,105000
052721,友達統一96購01  ,0,0,0,0,0,0,0,0,0,105000,0,0,0,106000,1000,105000,105000
03118P,台積電國票01售07,0,0,0,0,0,0,0,0,0,105000,0,0,0,105000,0,105000,105000
043655,微星富邦93購01  ,0,0,0,0,0,0,0,0,0,105000,0,0,0,215000,110000,105000,105000
044914,元油2X永豐91購04,0,0,0,0,0,0,0,0,0,105000,0,0,0,120000,15000,105000,105000
045076,富邦金元大92購01,0,0,0,0,0,0,0,0,0,105000,0,0,0,105000,0,105000,105000
046915,禾伸堂台新93購01,0,0,0,0,0,0,0,0,0,105000,0,0,0,105000,0,105000,105000
046013,緯穎元富92購01  ,0,0,0,0,0,0,0,0,0,105000,0,0,0,204000,99000,105000,105000
045887,台光電元大92購07,0,0,0,0,0,0,0,0,0,105000,0,0,0,105000,0,105000,105000
046007,緯穎統一92購02  ,0,0,0,0,0,0,0,0,0,105000,0,0,0,155000,50000,105000,105000
051384,康友群益95購01  ,0,0,0,0,0,0,0,0,0,105000,0,0,0,385000,280000,105000,105000
05678P,群創群益97售01  ,0,0,0,0,0,0,0,0,0,105000,0,0,0,127000,22000,105000,105000
052499,合勤控永豐95購01,0,0,0,0,0,0,0,0,0,104000,0,0,0,114000,10000,104000,104000
053008,達方永豐96購01  ,0,0,0,0,0,0,0,0,0,104000,0,0,0,129000,25000,104000,104000
053926,晶相光國票97購01,0,0,0,0,0,0,0,0,0,104000,0,0,0,283000,179000,104000,104000
047040,台勝科群益93購01,0,0,0,0,0,0,0,0,0,104000,0,0,0,168000,64000,104000,104000
048426,超眾元富93購01  ,0,0,0,0,0,0,0,0,0,104000,0,0,0,114000,10000,104000,104000
049885,緯穎永豐94購01  ,0,0,0,0,0,0,0,0,0,104000,0,0,0,126000,22000,104000,104000
05726P,易華電永豐96售02,0,0,0,0,0,0,0,0,0,104000,0,0,0,147000,43000,104000,104000
05866P,致伸元大96售01  ,0,0,0,0,0,0,0,0,0,104000,0,0,0,252000,148000,104000,104000
054233,聯發科群益96購04,0,0,0,0,0,0,0,0,0,103000,0,0,0,104000,1000,103000,103000
053068,智伸科群益96購01,0,0,0,0,0,0,0,0,0,103000,0,0,0,114000,11000,103000,103000
046457,可成凱基92購09  ,0,0,0,0,0,0,0,0,0,103000,0,0,0,103000,0,103000,103000
047997,南亞科元大93購03,0,0,0,0,0,0,0,0,0,103000,0,0,0,204000,101000,103000,103000
048937,玉晶光永豐95購01,0,0,0,0,0,0,0,0,0,103000,0,0,0,132000,29000,103000,103000
047266,嘉聯益國票94購02,0,0,0,0,0,0,0,0,0,103000,0,0,0,122000,19000,103000,103000
049363,旺宏元大94購07  ,0,0,0,0,0,0,0,0,0,103000,0,0,0,608000,505000,103000,103000
04731P,臺股指中信96售03,0,0,0,0,0,0,0,0,0,103000,0,0,0,139000,36000,103000,103000
051462,世芯國泰97購01  ,0,0,0,0,0,0,0,0,0,103000,0,0,0,134000,31000,103000,103000
05682P,大立光元大98售03,0,0,0,0,0,0,0,0,0,103000,0,0,0,135000,32000,103000,103000
053324,康舒群益96購01  ,0,0,0,0,0,0,0,0,0,102000,0,0,0,123000,21000,102000,102000
052514,嘉澤凱基96購01  ,0,0,0,0,0,0,0,0,0,102000,0,0,0,112000,10000,102000,102000
052592,華通群益98購01  ,0,0,0,0,0,0,0,0,0,102000,0,0,0,301000,199000,102000,102000
054310,牧德凱基98購01  ,0,0,0,0,0,0,0,0,0,102000,0,0,0,179000,77000,102000,102000
048328,滬深2X永昌94購01,0,0,0,0,0,0,0,0,0,102000,0,0,0,102000,0,102000,102000
03098P,大立光凱基01售10,0,0,0,0,0,0,0,0,0,102000,0,0,0,104000,2000,102000,102000
00670L,富邦NASDAQ正2   ,0,0,0,0,0,0,0,0,0,102000,0,0,0,246000,144000,102000,102000
046955,康舒國票93購01  ,0,0,0,0,0,0,0,0,0,102000,0,0,0,102000,0,102000,102000
050989,台表科富邦95購01,0,0,0,0,0,0,0,0,0,102000,0,0,0,141000,39000,102000,102000
05111P,台積電統一95售04,0,0,0,0,0,0,0,0,0,102000,0,0,0,123000,21000,102000,102000
05173P,臺股指元大95售17,0,0,0,0,0,0,0,0,0,102000,0,0,0,102000,0,102000,102000
049542,鴻海群益94購05  ,0,0,0,0,0,0,0,0,0,102000,0,0,0,154000,52000,102000,102000
049593,群創元大9A購01  ,0,0,0,0,0,0,0,0,0,102000,0,0,0,330000,228000,102000,102000
050487,美食元富94購01  ,0,0,0,0,0,0,0,0,0,102000,0,0,0,200000,98000,102000,102000
050771,華新科元大94購06,0,0,0,0,0,0,0,0,0,102000,0,0,0,102000,0,102000,102000
3622,洋華            ,100000,10000,90000,0,0,0,0,0,0,12000,12000,0,12000,0,0,0,102000
053939,台表科元富96購03,0,0,0,0,0,0,0,0,0,101000,0,0,0,191000,90000,101000,101000
053984,康友元大96購05  ,0,0,0,0,0,0,0,0,0,101000,0,0,0,283000,182000,101000,101000
053852,南亞科國泰98購01,0,0,0,0,0,0,0,0,0,101000,0,0,0,203000,102000,101000,101000
052468,超眾統一96購02  ,0,0,0,0,0,0,0,0,0,101000,0,0,0,111000,10000,101000,101000
03973P,高鐵元大93售01  ,0,0,0,0,0,0,0,0,0,101000,0,0,0,101000,0,101000,101000
042196,元油2X元大93購02,0,0,0,0,0,0,0,0,0,101000,0,0,0,144000,43000,101000,101000
046792,京元電元富96購01,0,0,0,0,0,0,0,0,0,101000,0,0,0,318000,217000,101000,101000
04591P,上銀元大94售01  ,0,0,0,0,0,0,0,0,0,101000,0,0,0,101000,0,101000,101000
049663,正崴永豐94購01  ,0,0,0,0,0,0,0,0,0,101000,0,0,0,111000,10000,101000,101000
049874,全新康和94購01  ,0,0,0,0,0,0,0,0,0,101000,0,0,0,265000,164000,101000,101000
052215,樺漢元大96購02  ,0,0,0,0,0,0,0,0,0,101000,0,0,0,121000,20000,101000,101000
06064P,台積電台新98售01,0,0,0,0,0,0,0,0,0,101000,0,0,0,114000,13000,101000,101000
052794,群創兆豐97購01  ,0,0,0,0,0,0,0,0,0,100000,0,0,0,100000,0,100000,100000
05279P,上銀元大95售02  ,0,0,0,0,0,0,0,0,0,100000,0,0,0,100000,0,100000,100000
053276,友達元大9C購01  ,0,0,0,0,0,0,0,0,0,100000,0,0,0,102000,2000,100000,100000
053578,華新元大98購01  ,0,0,0,0,0,0,0,0,0,100000,0,0,0,100000,0,100000,100000
053149,京元電元大96購02,0,0,0,0,0,0,0,0,0,100000,0,0,0,196000,96000,100000,100000
053987,宏碁亞東96購01  ,0,0,0,0,0,0,0,0,0,100000,0,0,0,100000,0,100000,100000
054040,中石化元大9C購01,0,0,0,0,0,0,0,0,0,100000,0,0,0,139000,39000,100000,100000
054095,同欣電群益98購03,0,0,0,0,0,0,0,0,0,100000,0,0,0,120000,20000,100000,100000
054450,聯茂第一96購01  ,0,0,0,0,0,0,0,0,0,100000,0,0,0,100000,0,100000,100000
054427,潤泰全富邦97購01,0,0,0,0,0,0,0,0,0,100000,0,0,0,150000,50000,100000,100000
054601,奇鋐台新98購01  ,0,0,0,0,0,0,0,0,0,100000,0,0,0,100000,0,100000,100000
04135P,亞德客元大93售04,0,0,0,0,0,0,0,0,0,100000,0,0,0,100000,0,100000,100000
041462,揚明光元大93購01,0,0,0,0,0,0,0,0,0,100000,0,0,0,100000,0,100000,100000
04446P,元油2X凱基94售03,0,0,0,0,0,0,0,0,0,100000,0,0,0,325000,225000,100000,100000
044574,潤泰全凱基93購01,0,0,0,0,0,0,0,0,0,100000,0,0,0,100000,0,100000,100000
044667,滬深2X永昌93購01,0,0,0,0,0,0,0,0,0,100000,0,0,0,100000,0,100000,100000
044587,元油2X統一91購02,0,0,0,0,0,0,0,0,0,100000,0,0,0,100000,0,100000,100000
04001P,聯發科凱基93售15,0,0,0,0,0,0,0,0,0,100000,0,0,0,100000,0,100000,100000
040508,上証2X國泰93購01,0,0,0,0,0,0,0,0,0,100000,0,0,0,105000,5000,100000,100000
03350P,台積電麥證02售06,0,0,0,0,0,0,0,0,0,100000,0,0,0,100000,0,100000,100000
03351P,台積電麥證02售07,0,0,0,0,0,0,0,0,0,100000,0,0,0,188000,88000,100000,100000
03373P,聯發科元大02售11,0,0,0,0,0,0,0,0,0,100000,0,0,0,100000,0,100000,100000
03203P,台積電凱基01售26,0,0,0,0,0,0,0,0,0,100000,0,0,0,100000,0,100000,100000
03516P,臺股指國票02售05,0,0,0,0,0,0,0,0,0,100000,0,0,0,100000,0,100000,100000
03721P,卜蜂元大93售01  ,0,0,0,0,0,0,0,0,0,100000,0,0,0,100000,0,100000,100000
03539P,牧德元富08售01  ,0,0,0,0,0,0,0,0,0,100000,0,0,0,100000,0,100000,100000
03562P,台灣50群益02售13,0,0,0,0,0,0,0,0,0,100000,0,0,0,100000,0,100000,100000
046228,神基元大92購01  ,0,0,0,0,0,0,0,0,0,100000,0,0,0,100000,0,100000,100000
04375P,卜蜂元大94售01  ,0,0,0,0,0,0,0,0,0,100000,0,0,0,100000,0,100000,100000
045758,易華電國泰94購01,0,0,0,0,0,0,0,0,0,100000,0,0,0,100000,0,100000,100000
044202,易華電國票91購02,0,0,0,0,0,0,0,0,0,100000,0,0,0,100000,0,100000,100000
04402P,TPK兆豐95售01   ,0,0,0,0,0,0,0,0,0,100000,0,0,0,100000,0,100000,100000
045277,瑞儀統一92購01  ,0,0,0,0,0,0,0,0,0,100000,0,0,0,128000,28000,100000,100000
045891,健鼎元大92購01  ,0,0,0,0,0,0,0,0,0,100000,0,0,0,100000,0,100000,100000
046042,台勝科元大92購03,0,0,0,0,0,0,0,0,0,100000,0,0,0,100000,0,100000,100000
046855,嘉晶元大94購01  ,0,0,0,0,0,0,0,0,0,100000,0,0,0,100000,0,100000,100000
04691P,智邦群益94售02  ,0,0,0,0,0,0,0,0,0,100000,0,0,0,152000,52000,100000,100000
04613P,台積電群益94售10,0,0,0,0,0,0,0,0,0,100000,0,0,0,100000,0,100000,100000
046415,嘉晶元大92購03  ,0,0,0,0,0,0,0,0,0,100000,0,0,0,100000,0,100000,100000
048351,旺宏台新94購02  ,0,0,0,0,0,0,0,0,0,100000,0,0,0,100000,0,100000,100000
046661,冠德元大93購01  ,0,0,0,0,0,0,0,0,0,100000,0,0,0,100000,0,100000,100000
046520,瀚宇博元大92購02,0,0,0,0,0,0,0,0,0,100000,0,0,0,106000,6000,100000,100000
04916P,大立光永昌96售02,0,0,0,0,0,0,0,0,0,100000,0,0,0,151000,51000,100000,100000
047516,深中小第一93購01,0,0,0,0,0,0,0,0,0,100000,0,0,0,100000,0,100000,100000
048714,巨大康和94購01  ,0,0,0,0,0,0,0,0,0,100000,0,0,0,100000,0,100000,100000
048901,矽格國泰95購01  ,0,0,0,0,0,0,0,0,0,100000,0,0,0,100000,0,100000,100000
05214P,台積電國票97售02,0,0,0,0,0,0,0,0,0,100000,0,0,0,100000,0,100000,100000
052093,麗豐元大96購04  ,0,0,0,0,0,0,0,0,0,100000,0,0,0,100000,0,100000,100000
05204P,TPK元大95售03   ,0,0,0,0,0,0,0,0,0,100000,0,0,0,100000,0,100000,100000
052037,全新國泰96購02  ,0,0,0,0,0,0,0,0,0,100000,0,0,0,120000,20000,100000,100000
051134,燿華永豐95購05  ,0,0,0,0,0,0,0,0,0,100000,0,0,0,100000,0,100000,100000
051141,鈺齊永豐95購01  ,0,0,0,0,0,0,0,0,0,100000,0,0,0,100000,0,100000,100000
051417,揚明光國票96購01,0,0,0,0,0,0,0,0,0,100000,0,0,0,100000,0,100000,100000
049821,中石化凱基94購02,0,0,0,0,0,0,0,0,0,100000,0,0,0,100000,0,100000,100000
049998,奇力新永豐94購03,0,0,0,0,0,0,0,0,0,100000,0,0,0,139000,39000,100000,100000
049536,T50反1群益94購02,0,0,0,0,0,0,0,0,0,100000,0,0,0,100000,0,100000,100000
050803,康控兆豐96購01  ,0,0,0,0,0,0,0,0,0,100000,0,0,0,100000,0,100000,100000
050617,神基元大94購01  ,0,0,0,0,0,0,0,0,0,100000,0,0,0,100000,0,100000,100000
050663,麗豐元大96購03  ,0,0,0,0,0,0,0,0,0,100000,0,0,0,110000,10000,100000,100000
08070P,晶技國泰9C售02  ,0,0,0,0,0,0,0,0,0,100000,0,0,0,100000,0,100000,100000
05670P,台積電國票98售01,0,0,0,0,0,0,0,0,0,100000,0,0,0,100000,0,100000,100000
05784P,臺股指元大96售18,0,0,0,0,0,0,0,0,0,100000,0,0,0,101000,1000,100000,100000
05957P,友達國票97售04  ,0,0,0,0,0,0,0,0,0,100000,0,0,0,397000,297000,100000,100000
054532,強茂國泰98購01  ,0,0,0,0,0,0,0,0,0,99000,0,0,0,144000,45000,99000,99000
05441P,華通元大95售09  ,0,0,0,0,0,0,0,0,0,99000,0,0,0,179000,80000,99000,99000
054146,康友元大96購06  ,0,0,0,0,0,0,0,0,0,99000,0,0,0,249000,150000,99000,99000
05351P,臺股指元富95售05,0,0,0,0,0,0,0,0,0,99000,0,0,0,126000,27000,99000,99000
052732,新唐國泰97購01  ,0,0,0,0,0,0,0,0,0,99000,0,0,0,99000,0,99000,99000
03654P,GIS元大92售07   ,0,0,0,0,0,0,0,0,0,99000,0,0,0,126000,27000,99000,99000
03910P,GIS元大93售09   ,0,0,0,0,0,0,0,0,0,99000,0,0,0,100000,1000,99000,99000
04346P,大立光兆豐95售02,0,0,0,0,0,0,0,0,0,99000,0,0,0,99000,0,99000,99000
048730,智原麥證94購01  ,0,0,0,99000,0,99000,0,0,0,99000,0,0,0,99000,0,99000,99000
050454,嘉澤元大94購04  ,0,0,0,0,0,0,0,0,0,99000,0,0,0,112000,13000,99000,99000
051434,中磊元富95購02  ,0,0,0,0,0,0,0,0,0,99000,0,0,0,101000,2000,99000,99000
051289,大立光統一96購01,0,0,0,0,0,0,0,0,0,99000,0,0,0,99000,0,99000,99000
051050,鴻海群益95購03  ,0,0,0,0,0,0,0,0,0,99000,0,0,0,150000,51000,99000,99000
05630P,大立光永昌96售06,0,0,0,0,0,0,0,0,0,99000,0,0,0,155000,56000,99000,99000
052891,台泥群益96購01  ,0,0,0,0,0,0,0,0,0,98000,0,0,0,98000,0,98000,98000
053161,康友元大96購04  ,0,0,0,0,0,0,0,0,0,98000,0,0,0,229000,131000,98000,98000
052970,美律群益96購01  ,0,0,0,0,0,0,0,0,0,98000,0,0,0,179000,81000,98000,98000
052974,瀚宇博群益96購01,0,0,0,0,0,0,0,0,0,98000,0,0,0,108000,10000,98000,98000
05410P,聯發科元富95售04,0,0,0,0,0,0,0,0,0,98000,0,0,0,98000,0,98000,98000
053935,華通元富96購02  ,0,0,0,0,0,0,0,0,0,98000,0,0,0,98000,0,98000,98000
053771,華新元大97購01  ,0,0,0,0,0,0,0,0,0,98000,0,0,0,110000,12000,98000,98000
053618,新唐群益96購01  ,0,0,0,0,0,0,0,0,0,98000,0,0,0,98000,0,98000,98000
053737,華新科麥證96購01,0,0,0,113000,15000,98000,0,0,0,98000,0,0,0,113000,15000,98000,98000
03620P,GIS元大92售06   ,0,0,0,0,0,0,0,0,0,98000,0,0,0,100000,2000,98000,98000
047732,美利達群益93購01,0,0,0,0,0,0,0,0,0,98000,0,0,0,98000,0,98000,98000
048292,微星群益93購01  ,0,0,0,0,0,0,0,0,0,98000,0,0,0,98000,0,98000,98000
048295,泰鼎群益93購01  ,0,0,0,0,0,0,0,0,0,98000,0,0,0,116000,18000,98000,98000
047254,瀚宇博群益93購02,0,0,0,0,0,0,0,0,0,98000,0,0,0,98000,0,98000,98000
049287,可成兆豐95購01  ,0,0,0,0,0,0,0,0,0,98000,0,0,0,98000,0,98000,98000
049300,南電群益94購01  ,0,0,0,0,0,0,0,0,0,98000,0,0,0,98000,0,98000,98000
050951,緯創群益96購01  ,0,0,0,0,0,0,0,0,0,98000,0,0,0,98000,0,98000,98000
051221,嘉聯益元富95購01,0,0,0,0,0,0,0,0,0,98000,0,0,0,98000,0,98000,98000
051252,健鼎元大95購01  ,0,0,0,0,0,0,0,0,0,98000,0,0,0,190000,92000,98000,98000
051954,矽力元富95購04  ,0,0,0,0,0,0,0,0,0,98000,0,0,0,98000,0,98000,98000
051890,智邦元富95購03  ,0,0,0,0,0,0,0,0,0,98000,0,0,0,98000,0,98000,98000
051823,矽力元富95購02  ,0,0,0,0,0,0,0,0,0,98000,0,0,0,98000,0,98000,98000
051710,和碩群益95購01  ,0,0,0,0,0,0,0,0,0,98000,0,0,0,98000,0,98000,98000
051655,欣興元富95購04  ,0,0,0,0,0,0,0,0,0,98000,0,0,0,98000,0,98000,98000
050357,南電群益94購02  ,0,0,0,0,0,0,0,0,0,98000,0,0,0,98000,0,98000,98000
050117,麗豐元大96購02  ,0,0,0,0,0,0,0,0,0,98000,0,0,0,120000,22000,98000,98000
05945P,聯詠中信96售01  ,0,0,0,0,0,0,0,0,0,98000,0,0,0,244000,146000,98000,98000
2023,燁輝            ,234000,136000,98000,0,0,0,0,0,0,0,0,0,0,0,0,0,98000
053825,南電群益96購02  ,0,0,0,0,0,0,0,0,0,97000,0,0,0,150000,53000,97000,97000
03088P,大立光元大01售17,0,0,0,0,0,0,0,0,0,97000,0,0,0,148000,51000,97000,97000
03987P,亞光群益93售02  ,0,0,0,0,0,0,0,0,0,97000,0,0,0,180000,83000,97000,97000
046484,華泰國泰93購01  ,0,0,0,0,0,0,0,0,0,97000,0,0,0,97000,0,97000,97000
3563,牧德            ,238000,167000,71000,0,0,0,79000,0,79000,-53000,6000,27000,-21000,30000,62000,-32000,97000
05960P,欣興統一96售01  ,0,0,0,0,0,0,0,0,0,97000,0,0,0,179000,82000,97000,97000
052827,昇陽半永豐97購01,0,0,0,0,0,0,0,0,0,96000,0,0,0,111000,15000,96000,96000
04140P,聯茂國票93售03  ,0,0,0,0,0,0,0,0,0,96000,0,0,0,96000,0,96000,96000
04320P,亞德客元大93售07,0,0,0,0,0,0,0,0,0,96000,0,0,0,96000,0,96000,96000
045531,台郡永豐92購01  ,0,0,0,0,0,0,0,0,0,96000,0,0,0,114000,18000,96000,96000
047405,香港2X統一96購01,0,0,0,0,0,0,0,0,0,96000,0,0,0,98000,2000,96000,96000
04732P,聯茂群益94售01  ,0,0,0,0,0,0,0,0,0,96000,0,0,0,96000,0,96000,96000
051135,建準永豐95購01  ,0,0,0,0,0,0,0,0,0,96000,0,0,0,99000,3000,96000,96000
050913,全新中信97購01  ,0,0,0,0,0,0,0,0,0,96000,0,0,0,148000,52000,96000,96000
052467,嘉聯益統一96購01,0,0,0,0,0,0,0,0,0,95000,0,0,0,115000,20000,95000,95000
053318,全新群益99購01  ,0,0,0,0,0,0,0,0,0,95000,0,0,0,159000,64000,95000,95000
054586,健鼎國泰99購01  ,0,0,0,0,0,0,0,0,0,95000,0,0,0,138000,43000,95000,95000
048031,全新凱基93購02  ,0,0,0,0,0,0,0,0,0,95000,0,0,0,125000,30000,95000,95000
043874,可成元大91購06  ,0,0,0,0,0,0,0,0,0,95000,0,0,0,216000,121000,95000,95000
04813P,智邦元大94售07  ,0,0,0,0,0,0,0,0,0,95000,0,0,0,95000,0,95000,95000
048569,台虹元大93購03  ,0,0,0,0,0,0,0,0,0,95000,0,0,0,127000,32000,95000,95000
051435,聯茂元富95購01  ,0,0,0,0,0,0,0,0,0,95000,0,0,0,160000,65000,95000,95000
051614,元金2X凱基97購01,0,0,0,0,0,0,0,0,0,95000,0,0,0,707000,612000,95000,95000
050169,臺指反元大97購01,0,0,0,0,0,0,0,0,0,95000,0,0,0,95000,0,95000,95000
050183,奇鋐元大96購01  ,0,0,0,0,0,0,0,0,0,95000,0,0,0,386000,291000,95000,95000
050365,中石化元大94購02,0,0,0,0,0,0,0,0,0,95000,0,0,0,100000,5000,95000,95000
050261,國巨元大95購04  ,0,0,0,0,0,0,0,0,0,95000,0,0,0,154000,59000,95000,95000
05599P,欣興台新96售01  ,0,0,0,0,0,0,0,0,0,95000,0,0,0,95000,0,95000,95000
054459,鈺齊群益96購01  ,0,0,0,0,0,0,0,0,0,94000,0,0,0,587000,493000,94000,94000
046529,臻鼎中信92購01  ,0,0,0,0,0,0,0,0,0,94000,0,0,0,200000,106000,94000,94000
048538,美利達國票94購01,0,0,0,0,0,0,0,0,0,94000,0,0,0,94000,0,94000,94000
048794,易華電元大97購01,0,0,0,0,0,0,0,0,0,94000,0,0,0,94000,0,94000,94000
048675,台達電國泰94購02,0,0,0,0,0,0,0,0,0,94000,0,0,0,107000,13000,94000,94000
050240,聯發科凱基94購13,0,0,0,0,0,0,0,0,0,94000,0,0,0,112000,18000,94000,94000
050053,訊芯群益94購03  ,0,0,0,0,0,0,0,0,0,94000,0,0,0,171000,77000,94000,94000
050044,聯詠兆豐94購02  ,0,0,0,0,0,0,0,0,0,94000,0,0,0,102000,8000,94000,94000
049598,超眾元大95購03  ,0,0,0,0,0,0,0,0,0,94000,0,0,0,114000,20000,94000,94000
052105,南亞科兆豐95購01,0,0,0,0,0,0,0,0,0,94000,0,0,0,94000,0,94000,94000
053677,同欣電國泰97購01,0,0,0,0,0,0,0,0,0,93000,0,0,0,159000,66000,93000,93000
044671,台積電兆豐93購01,0,0,0,0,0,0,0,0,0,93000,0,0,0,122000,29000,93000,93000
03417B,臺股指凱基95熊19,0,0,0,0,0,0,0,0,0,93000,0,0,0,93000,0,93000,93000
03802P,GIS元大93售07   ,0,0,0,0,0,0,0,0,0,93000,0,0,0,100000,7000,93000,93000
047969,台達電富邦97購01,0,0,0,0,0,0,0,0,0,93000,0,0,0,148000,55000,93000,93000
046671,彩晶元大93購03  ,0,0,0,0,0,0,0,0,0,93000,0,0,0,121000,28000,93000,93000
052092,貿聯元大96購02  ,0,0,0,0,0,0,0,0,0,93000,0,0,0,415000,322000,93000,93000
050093,國巨永豐94購05  ,0,0,0,0,0,0,0,0,0,93000,0,0,0,297000,204000,93000,93000
050719,世紀鋼群益96購01,0,0,0,0,0,0,0,0,0,93000,0,0,0,98000,5000,93000,93000
8404,百和興業-KY     ,120000,27000,93000,0,0,0,0,0,0,0,0,0,0,0,0,0,93000
054047,富邦金元大97購01,0,0,0,0,0,0,0,0,0,92000,0,0,0,252000,160000,92000,92000
053270,台塑元大96購01  ,0,0,0,0,0,0,0,0,0,92000,0,0,0,92000,0,92000,92000
053003,國巨永豐96購02  ,0,0,0,0,0,0,0,0,0,92000,0,0,0,326000,234000,92000,92000
04182P,祥碩國票93售01  ,0,0,0,0,0,0,0,0,0,92000,0,0,0,92000,0,92000,92000
045638,強茂凱基93購02  ,0,0,0,0,0,0,0,0,0,92000,0,0,0,128000,36000,92000,92000
050594,康友永豐94購01  ,0,0,0,0,0,0,0,0,0,92000,0,0,0,180000,88000,92000,92000
050530,台表科元大95購04,0,0,0,0,0,0,0,0,0,92000,0,0,0,143000,51000,92000,92000
050175,台光電元大94購08,0,0,0,0,0,0,0,0,0,92000,0,0,0,151000,59000,92000,92000
050031,嘉澤元大95購01  ,0,0,0,0,0,0,0,0,0,92000,0,0,0,124000,32000,92000,92000
049892,國巨富邦96購01  ,0,0,0,0,0,0,0,0,0,92000,0,0,0,140000,48000,92000,92000
049453,新日興統一94購01,0,0,0,0,0,0,0,0,0,92000,0,0,0,92000,0,92000,92000
052197,台郡元富95購03  ,0,0,0,0,0,0,0,0,0,92000,0,0,0,98000,6000,92000,92000
051213,華新科統一95購01,0,0,0,0,0,0,0,0,0,92000,0,0,0,243000,151000,92000,92000
3583,辛耘            ,122000,30000,92000,0,0,0,0,0,0,0,0,0,0,0,0,0,92000
053710,華通凱基96購05  ,0,0,0,0,0,0,0,0,0,91000,0,0,0,101000,10000,91000,91000
054290,奇力新元大96購05,0,0,0,0,0,0,0,0,0,91000,0,0,0,127000,36000,91000,91000
046308,廣達元大92購02  ,0,0,0,0,0,0,0,0,0,91000,0,0,0,111000,20000,91000,91000
042093,台灣50群益94購02,12000,0,12000,0,0,0,0,0,0,79000,0,0,0,468000,389000,79000,91000
044704,新日興元大91購01,0,0,0,0,0,0,0,0,0,91000,0,0,0,91000,0,91000,91000
048184,達運群益93購01  ,0,0,0,0,0,0,0,0,0,91000,0,0,0,131000,40000,91000,91000
049901,瑞昱元富94購01  ,0,0,0,0,0,0,0,0,0,91000,0,0,0,96000,5000,91000,91000
049327,台郡元富94購01  ,0,0,0,0,0,0,0,0,0,91000,0,0,0,154000,63000,91000,91000
051656,嘉聯益元富95購02,0,0,0,0,0,0,0,0,0,91000,0,0,0,111000,20000,91000,91000
051668,智邦元大95購02  ,0,0,0,0,0,0,0,0,0,91000,0,0,0,116000,25000,91000,91000
050879,樺漢統一95購02  ,0,0,0,0,0,0,0,0,0,91000,0,0,0,171000,80000,91000,91000
2007,燁興            ,94000,3000,91000,0,0,0,0,0,0,0,0,0,0,0,0,0,91000
05775P,台積電國泰98售02,0,0,0,0,0,0,0,0,0,91000,0,0,0,91000,0,91000,91000
05571P,大立光統一96售03,0,0,0,0,0,0,0,0,0,90000,0,0,0,167000,77000,90000,90000
053988,友達亞東96購01  ,0,0,0,0,0,0,0,0,0,90000,0,0,0,100000,10000,90000,90000
04200P,奇力新群益93售07,0,0,0,0,0,0,0,0,0,90000,0,0,0,90000,0,90000,90000
03849P,大成鋼凱基93售03,0,0,0,0,0,0,0,0,0,90000,0,0,0,100000,10000,90000,90000
03993P,滬深2X中信94售03,0,0,0,0,0,0,0,0,0,90000,0,0,0,200000,110000,90000,90000
046239,中石化中信92購02,0,0,0,0,0,0,0,0,0,90000,0,0,0,100000,10000,90000,90000
045117,玉晶光日盛92購01,0,0,0,0,0,0,0,0,0,90000,0,0,0,90000,0,90000,90000
045163,瀚宇博國泰93購01,0,0,0,0,0,0,0,0,0,90000,0,0,0,90000,0,90000,90000
048670,華新科永豐93購03,0,0,0,0,0,0,0,0,0,90000,0,0,0,148000,58000,90000,90000
047952,華通永豐93購03  ,0,0,0,0,0,0,0,0,0,90000,0,0,0,355000,265000,90000,90000
048358,嘉晶永豐93購03  ,0,0,0,0,0,0,0,0,0,90000,0,0,0,90000,0,90000,90000
046822,亞光凱基93購04  ,0,0,0,0,0,0,0,0,0,90000,0,0,0,257000,167000,90000,90000
049519,新光金國票95購03,0,0,0,0,0,0,0,0,0,90000,0,0,0,104000,14000,90000,90000
049595,麗豐元大95購01  ,0,0,0,0,0,0,0,0,0,90000,0,0,0,100000,10000,90000,90000
049890,嘉澤國泰95購01  ,0,0,0,0,0,0,0,0,0,90000,0,0,0,100000,10000,90000,90000
05597P,鴻海元富96售06  ,0,0,0,0,0,0,0,0,0,90000,0,0,0,90000,0,90000,90000
052896,宏達電群益96購01,0,0,0,0,0,0,0,0,0,89000,0,0,0,114000,25000,89000,89000
04549P,茂林元大94售02  ,0,0,0,0,0,0,0,0,0,89000,0,0,0,89000,0,89000,89000
046246,嘉聯益亞東93購01,0,0,0,0,0,0,0,0,0,89000,0,0,0,89000,0,89000,89000
045873,元油2X元富98購04,0,0,0,0,0,0,0,0,0,89000,0,0,0,132000,43000,89000,89000
047123,中石化中信95購01,0,0,0,0,0,0,0,0,0,89000,0,0,0,89000,0,89000,89000
3437,榮創            ,161000,72000,89000,0,0,0,0,0,0,0,0,0,0,0,0,0,89000
053090,新唐元大96購01  ,0,0,0,0,0,0,0,0,0,88000,0,0,0,105000,17000,88000,88000
053350,台表科國票97購02,0,0,0,0,0,0,0,0,0,88000,0,0,0,113000,25000,88000,88000
054002,GIS群益96購03   ,0,0,0,0,0,0,0,0,0,88000,0,0,0,98000,10000,88000,88000
054124,達方永豐96購02  ,0,0,0,0,0,0,0,0,0,88000,0,0,0,98000,10000,88000,88000
054309,禾伸堂凱基98購01,0,0,0,0,0,0,0,0,0,88000,0,0,0,129000,41000,88000,88000
040381,元金2X元富95購01,0,0,0,0,0,0,0,0,0,88000,0,0,0,88000,0,88000,88000
04755P,大立光元富94售07,0,0,0,0,0,0,0,0,0,88000,0,0,0,88000,0,88000,88000
04899P,力成中信94售02  ,0,0,0,0,0,0,0,0,0,88000,0,0,0,110000,22000,88000,88000
049398,微星群益94購02  ,0,0,0,0,0,0,0,0,0,88000,0,0,0,119000,31000,88000,88000
048008,聯發科富邦95購02,0,0,0,0,0,0,0,0,0,88000,0,0,0,99000,11000,88000,88000
048422,瑞昱元富96購02  ,0,0,0,0,0,0,0,0,0,88000,0,0,0,98000,10000,88000,88000
046402,華泰元大92購03  ,0,0,0,0,0,0,0,0,0,88000,0,0,0,88000,0,88000,88000
049974,聯發科日盛94購02,0,0,0,0,0,0,0,0,0,88000,0,0,0,100000,12000,88000,88000
2359,所羅門          ,138000,50000,88000,0,0,0,0,0,0,0,0,0,0,0,0,0,88000
2834,臺企銀          ,2334000,2266098,67902,0,0,0,20000,0,20000,0,0,0,0,0,0,0,87902
053617,宏達電群益96購02,0,0,0,0,0,0,0,0,0,87000,0,0,0,98000,11000,87000,87000
053531,國泰金康和96購01,0,0,0,0,0,0,0,0,0,87000,0,0,0,88000,1000,87000,87000
052651,台表科永豐96購02,0,0,0,0,0,0,0,0,0,87000,0,0,0,97000,10000,87000,87000
04105P,東陽康和93售03  ,0,0,0,0,0,0,0,0,0,87000,0,0,0,87000,0,87000,87000
04414P,牧德元富94售04  ,0,0,0,0,0,0,0,0,0,87000,0,0,0,428000,341000,87000,87000
046832,嘉晶群益93購01  ,0,0,0,0,0,0,0,0,0,87000,0,0,0,87000,0,87000,87000
049042,玉晶光兆豐95購01,0,0,0,0,0,0,0,0,0,87000,0,0,0,120000,33000,87000,87000
050050,國泰金群益94購02,0,0,0,0,0,0,0,0,0,87000,0,0,0,119000,32000,87000,87000
05069P,鴻海統一96售03  ,0,0,0,0,0,0,0,0,0,87000,0,0,0,145000,58000,87000,87000
051709,TPK群益95購02   ,0,0,0,0,0,0,0,0,0,87000,0,0,0,118000,31000,87000,87000
052143,鴻海群益95購09  ,0,0,0,0,0,0,0,0,0,87000,0,0,0,103000,16000,87000,87000
051063,台郡群益95購01  ,0,0,0,0,0,0,0,0,0,87000,0,0,0,477000,390000,87000,87000
05961P,鴻海群益97售01  ,0,0,0,0,0,0,0,0,0,87000,0,0,0,98000,11000,87000,87000
06022P,緯穎永豐96售03  ,0,0,0,0,0,0,0,0,0,87000,0,0,0,87000,0,87000,87000
2511,太子            ,208750,122000,86750,0,0,0,0,0,0,0,0,0,0,0,0,0,86750
052540,華新科統一95購03,0,0,0,0,0,0,0,0,0,86000,0,0,0,108000,22000,86000,86000
052966,光磊群益96購01  ,0,0,0,0,0,0,0,0,0,86000,0,0,0,98000,12000,86000,86000
045107,超眾群益92購02  ,0,280000,-280000,0,0,0,0,0,0,366000,0,0,0,381000,15000,366000,86000
04507P,台光電元大94售03,0,0,0,0,0,0,0,0,0,86000,0,0,0,100000,14000,86000,86000
048835,牧德凱基94購02  ,0,0,0,0,0,0,0,0,0,86000,0,0,0,116000,30000,86000,86000
054093,智原群益97購01  ,0,0,0,0,0,0,0,0,0,85000,0,0,0,129000,44000,85000,85000
054145,嘉聯益元大98購01,0,0,0,0,0,0,0,0,0,85000,0,0,0,116000,31000,85000,85000
05526P,茂林群益96售03  ,0,0,0,0,0,0,0,0,0,85000,0,0,0,106000,21000,85000,85000
045814,可成麥證93購01  ,0,0,0,115000,30000,85000,0,0,0,85000,0,0,0,115000,30000,85000,85000
04138P,智邦國票93售02  ,0,0,0,0,0,0,0,0,0,85000,0,0,0,85000,0,85000,85000
04207P,臺股指元大93售47,0,0,0,0,0,0,0,0,0,85000,0,0,0,115000,30000,85000,85000
04239P,上銀凱基93售08  ,0,0,0,0,0,0,0,0,0,85000,0,0,0,85000,0,85000,85000
04454P,大立光富邦98售02,0,0,0,0,0,0,0,0,0,85000,0,0,0,173000,88000,85000,85000
043391,康控元大94購01  ,0,0,0,0,0,0,0,0,0,85000,0,0,0,97000,12000,85000,85000
049950,南亞科群益94購02,0,0,0,0,0,0,0,0,0,85000,0,0,0,151000,66000,85000,85000
047430,儒鴻元大93購05  ,0,0,0,0,0,0,0,0,0,85000,0,0,0,88000,3000,85000,85000
051243,微星元大95購01  ,0,0,0,0,0,0,0,0,0,85000,0,0,0,236000,151000,85000,85000
051290,大立光統一96購02,0,0,0,0,0,0,0,0,0,85000,0,0,0,100000,15000,85000,85000
051591,玉晶光元大97購01,0,0,0,0,0,0,0,0,0,85000,0,0,0,95000,10000,85000,85000
051733,中環國票96購02  ,0,0,0,0,0,0,0,0,0,85000,0,0,0,165000,80000,85000,85000
050595,緯穎永豐94購03  ,0,0,0,0,0,0,0,0,0,85000,0,0,0,290000,205000,85000,85000
050069,禾伸堂凱基94購04,0,0,0,0,0,0,0,0,0,85000,0,0,0,135000,50000,85000,85000
049600,緯穎元大95購02  ,0,0,0,0,0,0,0,0,0,85000,0,0,0,248000,163000,85000,85000
04963P,鴻海元大94售25  ,0,0,0,0,0,0,0,0,0,85000,0,0,0,150000,65000,85000,85000
049777,華新科統一94購06,0,0,0,0,0,0,0,0,0,85000,0,0,0,125000,40000,85000,85000
05452P,亞德客群益95售02,0,0,0,0,0,0,0,0,0,84000,0,0,0,95000,11000,84000,84000
054396,日電貿永豐96購02,0,0,0,0,0,0,0,0,0,84000,0,0,0,139000,55000,84000,84000
053021,國巨國泰97購04  ,0,0,0,0,0,0,0,0,0,84000,0,0,0,133000,49000,84000,84000
053574,奇力新元富99購01,0,0,0,0,0,0,0,0,0,84000,0,0,0,202000,118000,84000,84000
044583,易華電凱基93購02,0,0,0,0,0,0,0,0,0,84000,0,0,0,84000,0,84000,84000
03538P,景碩元富08售02  ,0,0,0,0,0,0,0,0,0,84000,0,0,0,95000,11000,84000,84000
046248,技嘉群益93購02  ,0,0,0,0,0,0,0,0,0,84000,0,0,0,84000,0,84000,84000
047431,儒鴻元大93購06  ,0,0,0,0,0,0,0,0,0,84000,0,0,0,111000,27000,84000,84000
046982,瀚宇博兆豐94購02,0,0,0,0,0,0,0,0,0,84000,0,0,0,94000,10000,84000,84000
046886,喬山群益93購01  ,0,0,0,0,0,0,0,0,0,84000,0,0,0,84000,0,84000,84000
051040,漢唐永豐95購01  ,0,0,0,0,0,0,0,0,0,84000,0,0,0,119000,35000,84000,84000
050970,康舒永豐95購01  ,0,0,0,0,0,0,0,0,0,84000,0,0,0,190000,106000,84000,84000
051160,亞德客元大95購02,0,0,0,0,0,0,0,0,0,84000,0,0,0,214000,130000,84000,84000
9105,泰金寶-DR       ,116000,32000,84000,0,0,0,0,0,0,0,0,0,0,0,0,0,84000
6409,旭隼            ,119000,35677,83323,0,0,0,0,0,0,0,0,0,0,0,0,0,83323
053186,健策中信9C購01  ,0,0,0,0,0,0,0,0,0,83000,0,0,0,176000,93000,83000,83000
052358,台表科永豐95購02,0,0,0,0,0,0,0,0,0,83000,0,0,0,153000,70000,83000,83000
052786,S&P500中信96購01,0,0,0,0,0,0,0,0,0,83000,0,0,0,83000,0,83000,83000
04254P,亞德客國票93售03,0,0,0,0,0,0,0,0,0,83000,0,0,0,83000,0,83000,83000
041861,欣興中信91購01  ,0,0,0,0,0,0,0,0,0,83000,0,0,0,90000,7000,83000,83000
049284,瑞昱中信94購02  ,0,0,0,0,0,0,0,0,0,83000,0,0,0,83000,0,83000,83000
050180,華新科元大95購08,0,0,0,0,0,0,0,0,0,83000,0,0,0,83000,0,83000,83000
050785,全新國泰96購01  ,0,0,0,0,0,0,0,0,0,83000,0,0,0,126000,43000,83000,83000
8463,潤泰材          ,92000,8000,84000,0,0,0,0,0,0,-1000,0,1000,-1000,0,0,0,83000
052790,智邦兆豐97購01  ,0,0,0,0,0,0,0,0,0,82000,0,0,0,92000,10000,82000,82000
052618,群創國泰98購01  ,0,0,0,0,0,0,0,0,0,82000,0,0,0,123000,41000,82000,82000
044576,禾伸堂凱基91購03,0,0,0,0,0,0,0,0,0,82000,0,0,0,82000,0,82000,82000
045650,超眾凱基93購05  ,0,0,0,0,0,0,0,0,0,82000,0,0,0,82000,0,82000,82000
049108,玉晶光富邦96購02,0,0,0,0,0,0,0,0,0,82000,0,0,0,109000,27000,82000,82000
047849,中工統一93購01  ,0,0,0,0,0,0,0,0,0,82000,0,0,0,92000,10000,82000,82000
05054P,臻鼎群益95售02  ,0,0,0,0,0,0,0,0,0,82000,0,0,0,143000,61000,82000,82000
050315,和碩兆豐95購01  ,0,0,0,0,0,0,0,0,0,82000,0,0,0,92000,10000,82000,82000
050181,富邦金元大94購02,0,0,0,0,0,0,0,0,0,82000,0,0,0,82000,0,82000,82000
049494,華新科元大95購05,0,0,0,0,0,0,0,0,0,82000,0,0,0,92000,10000,82000,82000
051702,鴻海群益95購08  ,0,0,0,0,0,0,0,0,0,82000,0,0,0,102000,20000,82000,82000
052606,聯發科元大97購04,0,0,0,0,0,0,0,0,0,81000,0,0,0,298000,217000,81000,81000
052671,祥碩群益96購01  ,0,0,0,0,0,0,0,0,0,81000,0,0,0,202000,121000,81000,81000
052227,瑞昱凱基95購05  ,0,0,0,0,0,0,0,0,0,81000,0,0,0,81000,0,81000,81000
052429,禾伸堂永豐95購02,0,0,0,0,0,0,0,0,0,81000,0,0,0,171000,90000,81000,81000
053465,聯電元大96購05  ,0,0,0,0,0,0,0,0,0,81000,0,0,0,218000,137000,81000,81000
05328P,臺股指凱基95售12,0,0,0,0,0,0,0,0,0,81000,0,0,0,91000,10000,81000,81000
053892,景碩群益96購02  ,0,0,0,0,0,0,0,0,0,81000,0,0,0,98000,17000,81000,81000
04216P,燿華國票93售02  ,0,0,0,0,0,0,0,0,0,81000,0,0,0,81000,0,81000,81000
048703,康控國票95購01  ,0,0,0,0,0,0,0,0,0,81000,0,0,0,81000,0,81000,81000
052077,可成元富98購02  ,0,0,0,0,0,0,0,0,0,81000,0,0,0,110000,29000,81000,81000
05698P,群創凱基96售01  ,0,0,0,0,0,0,0,0,0,81000,0,0,0,81000,0,81000,81000
054191,香港2X中信98購01,0,0,0,0,0,0,0,0,0,80000,0,0,0,80000,0,80000,80000
05564P,玉晶光元大97售02,0,0,0,0,0,0,0,0,0,80000,0,0,0,100000,20000,80000,80000
05353P,臺股指元富95售07,0,0,0,0,0,0,0,0,0,80000,0,0,0,80000,0,80000,80000
05321P,鴻海凱基95售17  ,0,0,0,0,0,0,0,0,0,80000,0,0,0,80000,0,80000,80000
052976,台表科群益96購03,0,0,0,0,0,0,0,0,0,80000,0,0,0,205000,125000,80000,80000
052580,高鐵元富96購01  ,0,0,0,0,0,0,0,0,0,80000,0,0,0,80000,0,80000,80000
052745,欣興元大96購04  ,0,0,0,0,0,0,0,0,0,80000,0,0,0,141000,61000,80000,80000
04012P,台積電元大93售23,0,0,0,0,0,0,0,0,0,80000,0,0,0,80000,0,80000,80000
03940P,訊芯元大93售05  ,0,0,0,0,0,0,0,0,0,80000,0,0,0,80000,0,80000,80000
03905P,華通元富93售01  ,0,0,0,0,0,0,0,0,0,80000,0,0,0,80000,0,80000,80000
03873P,智伸科群益93售03,0,0,0,0,0,0,0,0,0,80000,0,0,0,80000,0,80000,80000
03493P,世紀鋼元大02售02,0,0,0,0,0,0,0,0,0,80000,0,0,0,80000,0,80000,80000
046265,高鐵凱基92購03  ,0,0,0,0,0,0,0,0,0,80000,0,0,0,100000,20000,80000,80000
045516,聯茂統一94購01  ,0,0,0,0,0,0,0,0,0,80000,0,0,0,138000,58000,80000,80000
045501,國泰金凱基92購01,0,0,0,0,0,0,0,0,0,80000,0,0,0,100000,20000,80000,80000
047620,貿聯凱基93購01  ,0,0,0,0,0,0,0,0,0,80000,0,0,0,150000,70000,80000,80000
046703,瑞昱元富95購01  ,0,0,0,0,0,0,0,0,0,80000,0,0,0,112000,32000,80000,80000
045861,智邦統一93購02  ,0,0,0,0,0,0,0,0,0,80000,0,0,0,205000,125000,80000,80000
052185,奇力新群益95購03,0,0,0,0,0,0,0,0,0,80000,0,0,0,80000,0,80000,80000
052180,緯穎元大96購05  ,0,0,0,0,0,0,0,0,0,80000,0,0,0,228000,148000,80000,80000
051902,T50反1元大97購01,0,0,0,0,0,0,0,0,0,80000,0,0,0,80000,0,80000,80000
05163P,聯發科統一96售02,0,0,0,0,0,0,0,0,0,80000,0,0,0,93000,13000,80000,80000
051202,智邦麥證95購01  ,0,0,0,80000,0,80000,0,0,0,80000,0,0,0,80000,0,80000,80000
050013,淘帝國泰95購01  ,0,0,0,0,0,0,0,0,0,80000,0,0,0,80000,0,80000,80000
050760,矽力元富94購03  ,0,0,0,0,0,0,0,0,0,80000,0,0,0,120000,40000,80000,80000
2723,美食-KY         ,179000,105000,74000,0,0,0,0,0,0,6000,0,0,0,16000,10000,6000,80000
4739,康普            ,106761,23812,82949,0,0,0,0,0,0,-3000,0,1000,-1000,0,2000,-2000,79949
053376,鴻海元大96購19  ,0,0,0,0,0,0,0,0,0,79000,0,0,0,184000,105000,79000,79000
054246,國巨元大96購12  ,0,0,0,0,0,0,0,0,0,79000,0,0,0,79000,0,79000,79000
053831,台積電台新97購02,0,0,0,0,0,0,0,0,0,79000,0,0,0,97000,18000,79000,79000
054001,康友群益96購02  ,0,0,0,0,0,0,0,0,0,79000,0,0,0,150000,71000,79000,79000
053996,晶相光群益97購01,0,0,0,0,0,0,0,0,0,79000,0,0,0,520000,441000,79000,79000
043913,富邦金凱基92購01,0,0,0,0,0,0,0,0,0,79000,0,0,0,89000,10000,79000,79000
045311,GIS元大94購01   ,0,0,0,0,0,0,0,0,0,79000,0,0,0,90000,11000,79000,79000
045365,智邦兆豐93購04  ,0,0,0,0,0,0,0,0,0,79000,0,0,0,123000,44000,79000,79000
044898,旺宏凱基93購01  ,0,0,0,0,0,0,0,0,0,79000,0,0,0,212000,133000,79000,79000
04367P,滬深2X凱基95售04,0,0,0,0,0,0,0,0,0,79000,0,0,0,352000,273000,79000,79000
03425B,臺股指元大9A熊01,0,0,0,0,0,0,0,0,0,79000,0,0,0,130000,51000,79000,79000
03276P,聯發科台新02售01,0,0,0,0,0,0,0,0,0,79000,0,0,0,79000,0,79000,79000
040888,國泰金國票91購01,0,0,0,0,0,0,0,0,0,79000,0,0,0,79000,0,79000,79000
045935,台光電群益92購01,0,0,0,0,0,0,0,0,0,79000,0,0,0,99000,20000,79000,79000
050472,和大永豐94購01  ,0,0,0,0,0,0,0,0,0,79000,0,0,0,388000,309000,79000,79000
05110P,上銀統一95售01  ,0,0,0,0,0,0,0,0,0,79000,0,0,0,79000,0,79000,79000
05418P,瑞昱永豐95售02  ,0,0,0,0,0,0,0,0,0,78000,0,0,0,133000,55000,78000,78000
053103,瀚宇博元富96購01,0,0,0,0,0,0,0,0,0,78000,0,0,0,93000,15000,78000,78000
052688,新日興元大96購01,0,0,0,0,0,0,0,0,0,78000,0,0,0,78000,0,78000,78000
052898,樺漢群益96購01  ,0,0,0,0,0,0,0,0,0,78000,0,0,0,98000,20000,78000,78000
052848,聯發科統一96購03,0,0,0,0,0,0,0,0,0,78000,0,0,0,126000,48000,78000,78000
052386,鴻海群益96購02  ,0,0,0,0,0,0,0,0,0,78000,0,0,0,112000,34000,78000,78000
049386,嘉聯益元大95購01,0,0,0,0,0,0,0,0,0,78000,0,0,0,100000,22000,78000,78000
051058,景碩群益96購01  ,0,0,0,0,0,0,0,0,0,78000,0,0,0,98000,20000,78000,78000
052144,鴻海群益95購10  ,0,0,0,0,0,0,0,0,0,78000,0,0,0,98000,20000,78000,78000
050346,康友元富94購03  ,0,0,0,0,0,0,0,0,0,78000,0,0,0,93000,15000,78000,78000
050593,台表科永豐94購03,0,0,0,0,0,0,0,0,0,78000,0,0,0,88000,10000,78000,78000
05649P,矽創國票97售03  ,0,0,0,0,0,0,0,0,0,78000,0,0,0,78000,0,78000,78000
05928P,華邦電康和96售01,0,0,0,0,0,0,0,0,0,78000,0,0,0,78000,0,78000,78000
052483,超眾群益95購03  ,0,0,0,0,0,0,0,0,0,77000,0,0,0,131000,54000,77000,77000
052937,國巨兆豐97購01  ,0,0,0,0,0,0,0,0,0,77000,0,0,0,652000,575000,77000,77000
054266,緯穎元大96購07  ,0,0,0,0,0,0,0,0,0,77000,0,0,0,165000,88000,77000,77000
054334,超眾永豐96購04  ,0,0,0,0,0,0,0,0,0,77000,0,0,0,77000,0,77000,77000
05445P,聯詠元大95售05  ,0,0,0,0,0,0,0,0,0,77000,0,0,0,101000,24000,77000,77000
054584,貿聯元富97購01  ,0,0,0,0,0,0,0,0,0,77000,0,0,0,250000,173000,77000,77000
042298,群創元大92購01  ,0,0,0,0,0,0,0,0,0,77000,0,0,0,120000,43000,77000,77000
04121P,宏碁凱基93售02  ,0,0,0,0,0,0,0,0,0,77000,0,0,0,100000,23000,77000,77000
04566P,GIS凱基94售04   ,0,0,0,0,0,0,0,0,0,77000,0,0,0,78000,1000,77000,77000
049295,全新群益94購02  ,0,0,0,0,0,0,0,0,0,77000,0,0,0,99000,22000,77000,77000
05970P,超眾永豐96售03  ,0,0,0,0,0,0,0,0,0,77000,0,0,0,152000,75000,77000,77000
05520P,聯詠凱基96售01  ,0,0,0,0,0,0,0,0,0,76000,0,0,0,140000,64000,76000,76000
054298,台表科元大97購03,0,0,0,0,0,0,0,0,0,76000,0,0,0,106000,30000,76000,76000
053871,臻鼎元大96購03  ,0,0,0,0,0,0,0,0,0,76000,0,0,0,77000,1000,76000,76000
053184,世紀鋼元富96購01,0,0,0,0,0,0,0,0,0,76000,0,0,0,81000,5000,76000,76000
052479,TPK群益95購04   ,0,0,0,0,0,0,0,0,0,76000,0,0,0,98000,22000,76000,76000
052594,友訊群益98購01  ,0,0,0,0,0,0,0,0,0,76000,0,0,0,76000,0,76000,76000
045624,緯穎永豐92購01  ,0,0,0,0,0,0,0,0,0,76000,0,0,0,111000,35000,76000,76000
044528,元油2X國泰92購02,0,0,0,0,0,0,0,0,0,76000,0,0,0,76000,0,76000,76000
043511,上銀富邦93購01  ,0,0,0,0,0,0,0,0,0,76000,0,0,0,78000,2000,76000,76000
046881,智原富邦99購01  ,0,0,0,0,0,0,0,0,0,76000,0,0,0,118000,42000,76000,76000
049554,禾伸堂富邦96購01,0,0,0,0,0,0,0,0,0,76000,0,0,0,103000,27000,76000,76000
052078,大立光元富95購10,0,0,0,0,0,0,0,0,0,76000,0,0,0,151000,75000,76000,76000
06007P,世芯永豐96售01  ,0,0,0,0,0,0,0,0,0,76000,0,0,0,85000,9000,76000,76000
2701,萬企            ,81000,5000,76000,0,0,0,0,0,0,0,0,0,0,0,0,0,76000
053045,國巨中信97購01  ,0,0,0,0,0,0,0,0,0,75000,0,0,0,251000,176000,75000,75000
053509,華新群益98購01  ,0,0,0,0,0,0,0,0,0,75000,0,0,0,116000,41000,75000,75000
05383P,鴻海富邦95售06  ,0,0,0,0,0,0,0,0,0,75000,0,0,0,75000,0,75000,75000
054088,華新群益98購02  ,0,0,0,0,0,0,0,0,0,75000,0,0,0,106000,31000,75000,75000
054347,上緯控國票96購02,0,0,0,0,0,0,0,0,0,75000,0,0,0,90000,15000,75000,75000
05449P,臺股指元大95售26,0,0,0,0,0,0,0,0,0,75000,0,0,0,75000,0,75000,75000
054395,華新科永豐96購03,0,0,0,0,0,0,0,0,0,75000,0,0,0,131000,56000,75000,75000
04136P,智邦元大93售09  ,0,0,0,0,0,0,0,0,0,75000,0,0,0,75000,0,75000,75000
045036,TPK群益93購02   ,0,0,0,0,0,0,0,0,0,75000,0,0,0,96000,21000,75000,75000
04792P,智邦元大94售06  ,0,0,0,0,0,0,0,0,0,75000,0,0,0,195000,120000,75000,75000
048535,超眾國票94購02  ,0,0,0,0,0,0,0,0,0,75000,0,0,0,95000,20000,75000,75000
047639,聯發科元大93購16,0,0,0,0,0,0,0,0,0,75000,0,0,0,80000,5000,75000,75000
049023,玉晶光群益96購04,0,0,0,0,0,0,0,0,0,75000,0,0,0,118000,43000,75000,75000
048834,牧德凱基94購01  ,0,0,0,0,0,0,0,0,0,75000,0,0,0,107000,32000,75000,75000
048821,光磊凱基95購01  ,0,0,0,0,0,0,0,0,0,75000,0,0,0,103000,28000,75000,75000
047106,喬山元大93購01  ,0,0,0,0,0,0,0,0,0,75000,0,0,0,104000,29000,75000,75000
051915,日月光元大96購01,0,0,0,0,0,0,0,0,0,75000,0,0,0,303000,228000,75000,75000
051925,瀚宇博第一95購01,0,0,0,0,0,0,0,0,0,75000,0,0,0,75000,0,75000,75000
051449,玉晶光元大96購01,0,0,0,0,0,0,0,0,0,75000,0,0,0,80000,5000,75000,75000
049560,香港反統一95購01,0,0,0,0,0,0,0,0,0,75000,0,0,0,75000,0,75000,75000
050193,臻鼎元大94購02  ,0,0,0,0,0,0,0,0,0,75000,0,0,0,75000,0,75000,75000
1109,信大            ,132000,67000,65000,0,0,0,0,0,0,10000,10000,0,10000,0,0,0,75000
05674P,瑞昱群益96售02  ,0,0,0,0,0,0,0,0,0,75000,0,0,0,75000,0,75000,75000
053327,彩晶台新97購01  ,0,0,0,0,0,0,0,0,0,74000,0,0,0,174000,100000,74000,74000
045522,滬深2X永豐94購01,0,0,0,0,0,0,0,0,0,74000,0,0,0,474000,400000,74000,74000
044451,智邦永豐91購01  ,0,0,0,0,0,0,0,0,0,74000,0,0,0,74000,0,74000,74000
04457P,同欣電統一94售01,0,0,0,0,0,0,0,0,0,74000,0,0,0,74000,0,74000,74000
048841,聯茂凱基94購06  ,0,0,0,0,0,0,0,0,0,74000,0,0,0,74000,0,74000,74000
048037,台表科凱基93購05,0,0,0,0,0,0,0,0,0,74000,0,0,0,94000,20000,74000,74000
051632,全新國票96購01  ,0,0,0,0,0,0,0,0,0,74000,0,0,0,74000,0,74000,74000
053580,國巨元大96購10  ,0,0,0,0,0,0,0,0,0,73000,0,0,0,79000,6000,73000,73000
052922,國巨永豐96購01  ,0,0,0,0,0,0,0,0,0,73000,0,0,0,245000,172000,73000,73000
05280P,華通元大95售08  ,0,0,0,0,0,0,0,0,0,73000,0,0,0,113000,40000,73000,73000
052281,全新凱基97購01  ,0,0,0,0,0,0,0,0,0,73000,0,0,0,121000,48000,73000,73000
054370,台積電中信9A購01,0,0,0,0,0,0,0,0,0,73000,0,0,0,149000,76000,73000,73000
053823,茂林群益96購06  ,0,0,0,0,0,0,0,0,0,73000,0,0,0,83000,10000,73000,73000
044879,上証2X群益93購01,0,0,0,0,0,0,0,0,0,73000,0,0,0,105000,32000,73000,73000
043696,瑞儀兆豐93購01  ,0,0,0,0,0,0,0,0,0,73000,0,0,0,83000,10000,73000,73000
04826P,華新科麥證95售01,0,0,0,380000,307000,73000,0,0,0,73000,0,0,0,380000,307000,73000,73000
045864,致伸統一93購01  ,0,0,0,0,0,0,0,0,0,73000,0,0,0,73000,0,73000,73000
048631,遠東新元大93購01,0,0,0,0,0,0,0,0,0,73000,0,0,0,123000,50000,73000,73000
051712,嘉聯益群益95購01,0,0,0,0,0,0,0,0,0,73000,0,0,0,107000,34000,73000,73000
052017,奇鋐永豐95購01  ,0,0,0,0,0,0,0,0,0,73000,0,0,0,88000,15000,73000,73000
1339,昭輝            ,145000,72000,73000,0,0,0,0,0,0,0,0,0,0,0,0,0,73000
05984P,台積電統一98售01,0,0,0,0,0,0,0,0,0,73000,0,0,0,77000,4000,73000,73000
2849,安泰銀          ,121000,14000,107000,0,0,0,0,0,0,-34000,0,34000,-34000,0,0,0,73000
054166,日電貿凱基98購01,0,0,0,0,0,0,0,0,0,72000,0,0,0,72000,0,72000,72000
054409,亞光國票97購02  ,0,0,0,0,0,0,0,0,0,72000,0,0,0,103000,31000,72000,72000
052523,奇力新元大97購01,0,0,0,0,0,0,0,0,0,72000,0,0,0,174000,102000,72000,72000
052903,致茂國票97購01  ,0,0,0,0,0,0,0,0,0,72000,0,0,0,72000,0,72000,72000
053278,禾伸堂元大96購01,0,0,0,0,0,0,0,0,0,72000,0,0,0,409000,337000,72000,72000
048630,南亞元大93購01  ,0,0,0,0,0,0,0,0,0,72000,0,0,0,72000,0,72000,72000
049102,智伸科國泰96購01,0,0,0,0,0,0,0,0,0,72000,0,0,0,81000,9000,72000,72000
051932,康控國票96購02  ,0,0,0,0,0,0,0,0,0,72000,0,0,0,82000,10000,72000,72000
052130,國巨凱基9B購01  ,0,0,0,0,0,0,0,0,0,72000,0,0,0,194000,122000,72000,72000
05182P,嘉晶統一95售03  ,0,0,0,0,0,0,0,0,0,72000,0,0,0,72000,0,72000,72000
051815,百和凱基96購01  ,0,0,0,0,0,0,0,0,0,72000,0,0,0,73000,1000,72000,72000
051501,康友群益95購02  ,0,0,0,0,0,0,0,0,0,72000,0,0,0,232000,160000,72000,72000
050350,全新群益94購04  ,0,0,0,0,0,0,0,0,0,72000,0,0,0,103000,31000,72000,72000
05538P,玉晶光國票97售02,0,0,0,0,0,0,0,0,0,71000,0,0,0,71000,0,71000,71000
05459P,聯詠凱基95售03  ,0,0,0,0,0,0,0,0,0,71000,0,0,0,71000,0,71000,71000
054137,聯詠元大97購02  ,0,0,0,0,0,0,0,0,0,71000,0,0,0,111000,40000,71000,71000
053689,台光電元大96購01,0,0,0,0,0,0,0,0,0,71000,0,0,0,135000,64000,71000,71000
048283,亞德客中信94購01,0,0,0,0,0,0,0,0,0,71000,0,0,0,101000,30000,71000,71000
044156,華新科永豐91購02,0,0,0,0,0,0,0,0,0,71000,0,0,0,111000,40000,71000,71000
03958P,嘉聯益統一93售01,0,0,0,0,0,0,0,0,0,71000,0,0,0,91000,20000,71000,71000
03972P,可成元大93售07  ,0,0,0,0,0,0,0,0,0,71000,0,0,0,71000,0,71000,71000
04903P,全新永豐94售05  ,0,0,0,0,0,0,0,0,0,71000,0,0,0,216000,145000,71000,71000
047632,儒鴻元大93購08  ,0,0,0,0,0,0,0,0,0,71000,0,0,0,146000,75000,71000,71000
04589P,祥碩永豐94售01  ,0,0,0,0,0,0,0,0,0,71000,0,0,0,281000,210000,71000,71000
04599P,南亞科凱基94售03,0,0,0,0,0,0,0,0,0,71000,0,0,0,71000,0,71000,71000
046016,緯穎元富92購04  ,0,0,0,0,0,0,0,0,0,71000,0,0,0,121000,50000,71000,71000
050130,華新科凱基94購09,0,0,0,0,0,0,0,0,0,71000,0,0,0,93000,22000,71000,71000
049806,臺企銀元大94購01,0,0,0,0,0,0,0,0,0,71000,0,0,0,71000,0,71000,71000
9939,宏全            ,217000,134470,82530,0,0,0,0,0,0,-12000,9000,0,9000,4000,25000,-21000,70530
053872,臻鼎元大96購04  ,0,0,0,0,0,0,0,0,0,70000,0,0,0,70000,0,70000,70000
053752,超眾永豐96購02  ,0,0,0,0,0,0,0,0,0,70000,0,0,0,102000,32000,70000,70000
054078,鴻海中信98購01  ,0,0,0,0,0,0,0,0,0,70000,0,0,0,100000,30000,70000,70000
054471,T50反1中信9C購01,0,0,0,0,0,0,0,0,0,70000,0,0,0,70000,0,70000,70000
052964,台表科凱基96購03,0,0,0,0,0,0,0,0,0,70000,0,0,0,139000,69000,70000,70000
03257P,聯電永豐02售01  ,0,0,0,0,0,0,0,0,0,70000,0,0,0,70000,0,70000,70000
044682,和鑫凱基93購01  ,0,0,0,0,0,0,0,0,0,70000,0,0,0,70000,0,70000,70000
04313P,國巨元富95售03  ,0,0,0,0,0,0,0,0,0,70000,0,0,0,70000,0,70000,70000
04408P,台積電統一94售06,0,0,0,0,0,0,0,0,0,70000,0,0,0,170000,100000,70000,70000
045621,超眾永豐92購02  ,0,0,0,0,0,0,0,0,0,70000,0,0,0,70000,0,70000,70000
047740,樺漢永豐93購01  ,0,0,0,0,0,0,0,0,0,70000,0,0,0,70000,0,70000,70000
045135,味全兆豐92購01  ,0,0,0,0,0,0,0,0,0,70000,0,0,0,70000,0,70000,70000
045520,嘉聯益元富92購01,0,0,0,0,0,0,0,0,0,70000,0,0,0,74000,4000,70000,70000
046039,新日興元大92購02,0,0,0,0,0,0,0,0,0,70000,0,0,0,70000,0,70000,70000
046195,聯詠凱基92購08  ,0,0,0,0,0,0,0,0,0,70000,0,0,0,110000,40000,70000,70000
048036,隆達凱基93購01  ,0,0,0,0,0,0,0,0,0,70000,0,0,0,320000,250000,70000,70000
047869,景碩永豐93購01  ,0,0,0,0,0,0,0,0,0,70000,0,0,0,80000,10000,70000,70000
048407,貿聯群益93購04  ,0,0,0,0,0,0,0,0,0,70000,0,0,0,123000,53000,70000,70000
047928,禾伸堂凱基93購04,0,0,0,0,0,0,0,0,0,70000,0,0,0,120000,50000,70000,70000
047326,致伸元大93購03  ,0,0,0,0,0,0,0,0,0,70000,0,0,0,70000,0,70000,70000
047118,欣興元大93購06  ,0,0,0,0,0,0,0,0,0,70000,0,0,0,120000,50000,70000,70000
047126,拓凱中信93購01  ,0,0,0,0,0,0,0,0,0,70000,0,0,0,70000,0,70000,70000
048627,T50反1元大96購02,0,0,0,0,0,0,0,0,0,70000,0,0,0,80000,10000,70000,70000
04815P,致伸元大94售04  ,0,0,0,0,0,0,0,0,0,70000,0,0,0,70000,0,70000,70000
050818,華新科凱基95購02,0,0,0,0,0,0,0,0,0,70000,0,0,0,120000,50000,70000,70000
052208,力成麥證95購01  ,0,0,0,90000,20000,70000,0,0,0,70000,0,0,0,90000,20000,70000,70000
052001,寶成元大95購02  ,0,0,0,0,0,0,0,0,0,70000,0,0,0,70000,0,70000,70000
05650P,台積電富邦96售01,0,0,0,0,0,0,0,0,0,70000,0,0,0,70000,0,70000,70000
05643P,大立光中信98售01,0,0,0,0,0,0,0,0,0,70000,0,0,0,70000,0,70000,70000
053084,國巨元大98購01  ,0,0,0,0,0,0,0,0,0,69000,0,0,0,90000,21000,69000,69000
044031,致茂群益92購01  ,0,0,0,0,0,0,0,0,0,69000,0,0,0,80000,11000,69000,69000
04429P,和鑫元大94售01  ,0,0,0,0,0,0,0,0,0,69000,0,0,0,69000,0,69000,69000
045713,台達電凱基93購02,0,0,0,0,0,0,0,0,0,69000,0,0,0,91000,22000,69000,69000
04151P,日電貿康和93售01,0,0,0,0,0,0,0,0,0,69000,0,0,0,69000,0,69000,69000
04061P,臺股指群益93售15,0,0,0,0,0,0,0,0,0,69000,0,0,0,79000,10000,69000,69000
048982,牧德元大94購02  ,0,0,0,0,0,0,0,0,0,69000,0,0,0,79000,10000,69000,69000
04690P,國巨群益94售06  ,0,0,0,0,0,0,0,0,0,69000,0,0,0,220000,151000,69000,69000
051484,玉晶光凱基97購01,0,0,0,0,0,0,0,0,0,69000,0,0,0,218000,149000,69000,69000
049475,高鐵永豐94購01  ,0,0,0,0,0,0,0,0,0,69000,0,0,0,76000,7000,69000,69000
2882B,國泰金乙特      ,0,0,0,0,0,0,0,0,0,69000,69000,0,69000,0,0,0,69000
053232,友達永豐97購02  ,0,0,0,0,0,0,0,0,0,68000,0,0,0,68000,0,68000,68000
053434,國泰金日盛96購01,0,0,0,0,0,0,0,0,0,68000,0,0,0,78000,10000,68000,68000
052857,大成鋼凱基96購01,0,0,0,0,0,0,0,0,0,68000,0,0,0,108000,40000,68000,68000
052356,聯詠永豐95購03  ,0,0,0,0,0,0,0,0,0,68000,0,0,0,68000,0,68000,68000
054018,華新台新96購01  ,0,0,0,0,0,0,0,0,0,68000,0,0,0,68000,0,68000,68000
054014,宏達電永豐96購04,0,0,0,0,0,0,0,0,0,68000,0,0,0,68000,0,68000,68000
053958,京元電永豐96購01,0,0,0,0,0,0,0,0,0,68000,0,0,0,68000,0,68000,68000
00766L,台新MSCI中國正2 ,0,0,0,0,0,0,0,0,0,68000,0,0,0,278000,210000,68000,68000
04284P,瀚宇博永豐93售01,0,0,0,0,0,0,0,0,0,68000,0,0,0,68000,0,68000,68000
04380P,欣興元大94售02  ,0,0,0,0,0,0,0,0,0,68000,0,0,0,181000,113000,68000,68000
048314,京元電凱基93購04,0,0,0,0,0,0,0,0,0,68000,0,0,0,68000,0,68000,68000
046109,遠東新元大92購01,0,0,0,0,0,0,0,0,0,68000,0,0,0,68000,0,68000,68000
046816,智邦凱基93購02  ,0,0,0,0,0,0,0,0,0,68000,0,0,0,68000,0,68000,68000
047935,美利達凱基93購01,0,0,0,0,0,0,0,0,0,68000,0,0,0,68000,0,68000,68000
046371,儒鴻凱基92購03  ,0,0,0,0,0,0,0,0,0,68000,0,0,0,68000,0,68000,68000
048981,牧德元大94購01  ,0,0,0,0,0,0,0,0,0,68000,0,0,0,213000,145000,68000,68000
047225,京元電凱基93購01,0,0,0,0,0,0,0,0,0,68000,0,0,0,68000,0,68000,68000
047281,超眾永豐93購02  ,0,0,0,0,0,0,0,0,0,68000,0,0,0,68000,0,68000,68000
047502,超眾永豐93購03  ,0,0,0,0,0,0,0,0,0,68000,0,0,0,68000,0,68000,68000
047496,旺宏台新93購02  ,0,0,0,0,0,0,0,0,0,68000,0,0,0,95000,27000,68000,68000
048838,牧德凱基94購07  ,0,0,0,0,0,0,0,0,0,68000,0,0,0,101000,33000,68000,68000
049075,光磊凱基94購01  ,0,0,0,0,0,0,0,0,0,68000,0,0,0,68000,0,68000,68000
050008,超眾永豐94購02  ,0,0,0,0,0,0,0,0,0,68000,0,0,0,68000,0,68000,68000
050150,國巨群益95購01  ,0,0,0,0,0,0,0,0,0,68000,0,0,0,129000,61000,68000,68000
050060,光磊凱基94購03  ,0,0,0,0,0,0,0,0,0,68000,0,0,0,68000,0,68000,68000
050862,燿華永豐95購04  ,0,0,0,0,0,0,0,0,0,68000,0,0,0,68000,0,68000,68000
050866,景碩永豐95購01  ,0,0,0,0,0,0,0,0,0,68000,0,0,0,68000,0,68000,68000
050563,臻鼎元富94購07  ,0,0,0,0,0,0,0,0,0,68000,0,0,0,118000,50000,68000,68000
050329,超眾永豐94購03  ,0,0,0,0,0,0,0,0,0,68000,0,0,0,88000,20000,68000,68000
050412,全新永豐94購04  ,0,0,0,0,0,0,0,0,0,68000,0,0,0,68000,0,68000,68000
051481,聯詠凱基95購02  ,0,0,0,0,0,0,0,0,0,68000,0,0,0,68000,0,68000,68000
051555,聯茂永豐95購01  ,0,0,0,0,0,0,0,0,0,68000,0,0,0,68000,0,68000,68000
051549,健鼎永豐95購01  ,0,0,0,0,0,0,0,0,0,68000,0,0,0,68000,0,68000,68000
051329,智邦永豐95購01  ,0,0,0,0,0,0,0,0,0,68000,0,0,0,68000,0,68000,68000
051838,國巨國泰97購01  ,0,0,0,0,0,0,0,0,0,68000,0,0,0,68000,0,68000,68000
051782,昇陽半群益95購01,0,0,0,0,0,0,0,0,0,68000,0,0,0,101000,33000,68000,68000
051644,聯茂康和95購01  ,0,0,0,0,0,0,0,0,0,68000,0,0,0,68000,0,68000,68000
052221,東元凱基95購01  ,0,0,0,0,0,0,0,0,0,68000,0,0,0,88000,20000,68000,68000
05710P,禾伸堂國票97售02,0,0,0,0,0,0,0,0,0,68000,0,0,0,108000,40000,68000,68000
05895P,奇力新群益96售03,0,0,0,0,0,0,0,0,0,68000,0,0,0,486000,418000,68000,68000
053803,聯發科凱基96購18,0,0,0,0,0,0,0,0,0,67000,0,0,0,73000,6000,67000,67000
05388P,南亞科元大95售04,0,0,0,0,0,0,0,0,0,67000,0,0,0,143000,76000,67000,67000
054474,鴻海中信96購03  ,0,0,0,0,0,0,0,0,0,67000,0,0,0,72000,5000,67000,67000
052649,康控永豐96購01  ,0,0,0,0,0,0,0,0,0,67000,0,0,0,68000,1000,67000,67000
044922,玉晶光永豐93購01,0,0,0,0,0,0,0,0,0,67000,0,0,0,70000,3000,67000,67000
049159,同欣電中信96購01,0,0,0,0,0,0,0,0,0,67000,0,0,0,139000,72000,67000,67000
049401,可成群益94購04  ,0,0,0,0,0,0,0,0,0,67000,0,0,0,109000,42000,67000,67000
051977,泰碩凱基95購01  ,0,0,0,0,0,0,0,0,0,67000,0,0,0,77000,10000,67000,67000
049883,台表科永豐94購02,0,0,0,0,0,0,0,0,0,67000,0,0,0,67000,0,67000,67000
05628P,茂林國票97售02  ,0,0,0,0,0,0,0,0,0,67000,0,0,0,67000,0,67000,67000
06020P,燿華元富96售04  ,0,0,0,0,0,0,0,0,0,67000,0,0,0,67000,0,67000,67000
06073P,健策永豐97售01  ,0,0,0,0,0,0,0,0,0,67000,0,0,0,77000,10000,67000,67000
6491,晶碩            ,56000,6000,50000,0,0,0,6000,0,6000,11000,11000,0,11000,0,0,0,67000
2845,遠東銀          ,409000,324532,84468,0,0,0,9000,0,9000,-27000,0,27000,-27000,0,0,0,66468
052324,康友元大96購02  ,1000,0,1000,0,0,0,0,0,0,65000,0,0,0,322000,257000,65000,66000
053898,康友群益97購01  ,0,0,0,0,0,0,0,0,0,66000,0,0,0,149000,83000,66000,66000
054008,大立光元富96購06,0,0,0,0,0,0,0,0,0,66000,0,0,0,71000,5000,66000,66000
044221,群創凱基93購03  ,0,0,0,0,0,0,0,0,0,66000,0,0,0,68000,2000,66000,66000
04933P,中石化中信96售01,0,0,0,0,0,0,0,0,0,66000,0,0,0,66000,0,66000,66000
045839,台郡群益92購01  ,0,0,0,0,0,0,0,0,0,66000,0,0,0,78000,12000,66000,66000
04952P,台光電亞東94售01,0,0,0,0,0,0,0,0,0,66000,0,0,0,66000,0,66000,66000
049697,群創元大98購01  ,0,0,0,0,0,0,0,0,0,66000,0,0,0,100000,34000,66000,66000
050552,禾伸堂凱基94購05,0,0,0,0,0,0,0,0,0,66000,0,0,0,68000,2000,66000,66000
05167P,百和元富95售03  ,0,0,0,0,0,0,0,0,0,66000,0,0,0,66000,0,66000,66000
05183P,台積電元富95售07,0,0,0,0,0,0,0,0,0,66000,0,0,0,66000,0,66000,66000
051301,聯發科凱基95購08,0,0,0,0,0,0,0,0,0,66000,0,0,0,270000,204000,66000,66000
6670,復盛應用        ,174000,65975,108025,0,0,0,0,0,0,-43000,0,0,0,0,43000,-43000,65025
053848,聯發科元富96購03,0,0,0,0,0,0,0,0,0,65000,0,0,0,130000,65000,65000,65000
053669,台積電統一96購08,0,0,0,0,0,0,0,0,0,65000,0,0,0,110000,45000,65000,65000
05424P,台達電亞東96售02,0,0,0,0,0,0,0,0,0,65000,0,0,0,125000,60000,65000,65000
043764,康友元大92購03  ,0,0,0,0,0,0,0,0,0,65000,0,0,0,112000,47000,65000,65000
045695,英業達兆豐93購01,0,0,0,0,0,0,0,0,0,65000,0,0,0,65000,0,65000,65000
03703P,台郡元大93售02  ,0,0,0,0,0,0,0,0,0,65000,0,0,0,65000,0,65000,65000
03398P,瑞昱中信06售03  ,0,0,0,0,0,0,0,0,0,65000,0,0,0,65000,0,65000,65000
047912,台郡麥證94購01  ,0,0,0,70000,0,70000,0,0,0,65000,0,0,0,70000,5000,65000,65000
049362,國巨元大94購04  ,0,0,0,0,0,0,0,0,0,65000,0,0,0,65000,0,65000,65000
049917,華新科元大94購02,0,0,0,0,0,0,0,0,0,65000,0,0,0,120000,55000,65000,65000
047166,台達電康和93購01,0,0,0,0,0,0,0,0,0,65000,0,0,0,65000,0,65000,65000
052104,英業達兆豐96購01,0,0,0,0,0,0,0,0,0,65000,0,0,0,65000,0,65000,65000
049701,聯茂元大94購05  ,0,0,0,0,0,0,0,0,0,65000,0,0,0,65000,0,65000,65000
049424,中石化兆豐94購01,0,0,0,0,0,0,0,0,0,65000,0,0,0,165000,100000,65000,65000
05012P,台積電元大95售07,0,0,0,0,0,0,0,0,0,65000,0,0,0,70000,5000,65000,65000
9940,信義            ,85000,29000,56000,0,0,0,0,0,0,9000,9000,0,9000,0,0,0,65000
9908,大台北          ,76000,1000,75000,0,0,0,0,0,0,-10000,0,10000,-10000,0,0,0,65000
2388,威盛            ,146000,97000,49000,0,0,0,17000,0,17000,-1000,0,1000,-1000,0,0,0,65000
05612P,台積電元大96售13,0,0,0,0,0,0,0,0,0,65000,0,0,0,365000,300000,65000,65000
05506P,茂林凱基96售03  ,0,0,0,0,0,0,0,0,0,64000,0,0,0,64000,0,64000,64000
053627,宏碁兆豐97購01  ,0,0,0,0,0,0,0,0,0,64000,0,0,0,70000,6000,64000,64000
03928P,鎧勝康和93售01  ,0,0,0,0,0,0,0,0,0,64000,0,0,0,67000,3000,64000,64000
047541,深中小凱基94購01,0,0,0,0,0,0,0,0,0,64000,0,0,0,66000,2000,64000,64000
047246,華新科群益93購01,0,0,0,0,0,0,0,0,0,64000,0,0,0,173000,109000,64000,64000
049384,致伸元大94購02  ,0,0,0,0,0,0,0,0,0,64000,0,0,0,94000,30000,64000,64000
047893,嘉聯益兆豐94購01,0,0,0,0,0,0,0,0,0,64000,0,0,0,316000,252000,64000,64000
04584P,楠梓電永豐94售01,0,0,0,0,0,0,0,0,0,64000,0,0,0,64000,0,64000,64000
04598P,光罩凱基94售03  ,0,0,0,0,0,0,0,0,0,64000,0,0,0,100000,36000,64000,64000
050119,瀚宇博元大95購03,0,0,0,0,0,0,0,0,0,64000,0,0,0,111000,47000,64000,64000
049480,同欣電永豐94購01,0,0,0,0,0,0,0,0,0,64000,0,0,0,69000,5000,64000,64000
05050P,華通群益96售02  ,0,0,0,0,0,0,0,0,0,64000,0,0,0,84000,20000,64000,64000
051908,國泰金元大96購02,0,0,0,0,0,0,0,0,0,64000,0,0,0,74000,10000,64000,64000
051347,國巨元大95購06  ,0,0,0,0,0,0,0,0,0,64000,0,0,0,64000,0,64000,64000
05782P,聯詠元富96售02  ,0,0,0,0,0,0,0,0,0,64000,0,0,0,65000,1000,64000,64000
053628,微星兆豐96購01  ,0,0,0,0,0,0,0,0,0,63000,0,0,0,98000,35000,63000,63000
044217,華新科凱基93購03,0,0,0,0,0,0,0,0,0,63000,0,0,0,73000,10000,63000,63000
048271,可成富邦95購02  ,0,0,0,0,0,0,0,0,0,63000,0,0,0,63000,0,63000,63000
045880,超眾元富92購01  ,0,0,0,0,0,0,0,0,0,63000,0,0,0,176000,113000,63000,63000
047965,景碩中信93購01  ,0,0,0,0,0,0,0,0,0,63000,0,0,0,123000,60000,63000,63000
049343,華新科統一94購03,0,0,0,0,0,0,0,0,0,63000,0,0,0,82000,19000,63000,63000
049279,元油2X國票94購02,0,0,0,0,0,0,0,0,0,63000,0,0,0,63000,0,63000,63000
047102,潤泰全富邦95購01,0,0,0,0,0,0,0,0,0,63000,0,0,0,63000,0,63000,63000
052074,鴻海元富95購10  ,0,0,0,0,0,0,0,0,0,63000,0,0,0,63000,0,63000,63000
050601,台表科國泰96購01,0,0,0,0,0,0,0,0,0,63000,0,0,0,138000,75000,63000,63000
05721P,全新群益98售02  ,0,0,0,0,0,0,0,0,0,63000,0,0,0,63000,0,63000,63000
1503,士電            ,66000,3000,63000,0,0,0,0,0,0,0,0,0,0,0,0,0,63000
5519,隆大            ,229000,176000,53000,0,0,0,0,0,0,10000,10000,0,10000,0,0,0,63000
6592,和潤企業        ,48000,25000,23000,0,0,0,0,0,0,40000,40000,0,40000,0,0,0,63000
05503P,智邦日盛96售01  ,0,0,0,0,0,0,0,0,0,62000,0,0,0,151000,89000,62000,62000
043640,深中小國票91購01,0,0,0,0,0,0,0,0,0,62000,0,0,0,62000,0,62000,62000
04335P,大成鋼元大93售01,0,0,0,0,0,0,0,0,0,62000,0,0,0,107000,45000,62000,62000
049315,上緯控凱基94購03,0,0,0,0,0,0,0,0,0,62000,0,0,0,62000,0,62000,62000
04764P,台光電台新94售01,0,0,0,0,0,0,0,0,0,62000,0,0,0,83000,21000,62000,62000
047811,聯發科凱基93購23,0,0,0,0,0,0,0,0,0,62000,0,0,0,148000,86000,62000,62000
051583,可成元大95購07  ,0,0,0,0,0,0,0,0,0,62000,0,0,0,87000,25000,62000,62000
05099P,台積電凱基95售06,0,0,0,0,0,0,0,0,0,62000,0,0,0,67000,5000,62000,62000
2406,國碩            ,180000,118000,62000,0,0,0,0,0,0,0,0,0,0,0,0,0,62000
08837P,牧德國票03售01  ,0,0,0,0,0,0,0,0,0,62000,0,0,0,62000,0,62000,62000
05983P,聯詠國票96售02  ,0,0,0,0,0,0,0,0,0,62000,0,0,0,62000,0,62000,62000
054351,華新科國泰97購03,0,0,0,0,0,0,0,0,0,61000,0,0,0,112000,51000,61000,61000
054053,聯茂元大96購01  ,0,0,0,0,0,0,0,0,0,61000,0,0,0,77000,16000,61000,61000
054131,南亞科元大96購04,0,0,0,0,0,0,0,0,0,61000,0,0,0,150000,89000,61000,61000
052390,聯詠群益95購03  ,0,0,0,0,0,0,0,0,0,61000,0,0,0,72000,11000,61000,61000
052270,力成日盛95購01  ,0,0,0,0,0,0,0,0,0,61000,0,0,0,85000,24000,61000,61000
052687,國泰金元大96購03,0,0,0,0,0,0,0,0,0,61000,0,0,0,145000,84000,61000,61000
053198,亞德客日盛96購01,0,0,0,0,0,0,0,0,0,61000,0,0,0,79000,18000,61000,61000
03411P,欣興元大02售08  ,0,0,0,0,0,0,0,0,0,61000,0,0,0,61000,0,61000,61000
03567P,可成凱基02售06  ,0,0,0,0,0,0,0,0,0,61000,0,0,0,65000,4000,61000,61000
043851,國泰金永昌93購01,0,0,0,0,0,0,0,0,0,61000,0,0,0,79000,18000,61000,61000
044917,奇力新永豐91購02,0,0,0,0,0,0,0,0,0,61000,0,0,0,64000,3000,61000,61000
046572,貿聯國泰94購01  ,0,0,0,0,0,0,0,0,0,61000,0,0,0,209000,148000,61000,61000
04908P,南電國票95售03  ,0,0,0,0,0,0,0,0,0,61000,0,0,0,61000,0,61000,61000
047518,儒鴻元大93購07  ,0,0,0,0,0,0,0,0,0,61000,0,0,0,133000,72000,61000,61000
051377,鴻海群益95購07  ,0,0,0,0,0,0,0,0,0,61000,0,0,0,83000,22000,61000,61000
051802,同欣電永豐95購02,0,0,0,0,0,0,0,0,0,61000,0,0,0,81000,20000,61000,61000
052080,康友元富98購02  ,0,0,0,0,0,0,0,0,0,61000,0,0,0,91000,30000,61000,61000
05604P,聯發科元大96售10,0,0,0,0,0,0,0,0,0,61000,0,0,0,295000,234000,61000,61000
2233,宇隆            ,71000,9000,62000,0,0,0,0,0,0,-1000,0,1000,-1000,0,0,0,61000
4551,智伸科          ,82000,16000,66000,0,0,0,12000,0,12000,-17000,0,11000,-11000,8000,14000,-6000,61000
052981,鴻海元大97購05  ,0,0,0,0,0,0,0,0,0,60000,0,0,0,225000,165000,60000,60000
05347P,滬深2X元富9B售02,0,0,0,0,0,0,0,0,0,60000,0,0,0,60000,0,60000,60000
053483,嘉澤第一96購01  ,0,0,0,0,0,0,0,0,0,60000,0,0,0,65000,5000,60000,60000
052850,華新科統一96購02,0,0,0,0,0,0,0,0,0,60000,0,0,0,60000,0,60000,60000
053957,瑞昱永豐96購01  ,0,0,0,0,0,0,0,0,0,60000,0,0,0,60000,0,60000,60000
053949,康控富邦9A購01  ,0,0,0,0,0,0,0,0,0,60000,0,0,0,70000,10000,60000,60000
053784,奇力新元大97購02,0,0,0,0,0,0,0,0,0,60000,0,0,0,80000,20000,60000,60000
054394,奇力新永豐96購03,0,0,0,0,0,0,0,0,0,60000,0,0,0,60000,0,60000,60000
054455,楠梓電群益98購02,0,0,0,0,0,0,0,0,0,60000,0,0,0,70000,10000,60000,60000
054541,康控國票98購01  ,0,0,0,0,0,0,0,0,0,60000,0,0,0,60000,0,60000,60000
045109,GIS群益92購01   ,0,0,0,0,0,0,0,0,0,60000,0,0,0,60000,0,60000,60000
04508P,臺股指元大94售03,0,0,0,0,0,0,0,0,0,60000,0,0,0,60000,0,60000,60000
045121,康控元大93購03  ,0,0,0,0,0,0,0,0,0,60000,0,0,0,63000,3000,60000,60000
04504P,台積電元富94售04,0,0,0,0,0,0,0,0,0,60000,0,0,0,60000,0,60000,60000
045705,冠德日盛92購01  ,0,0,0,0,0,0,0,0,0,60000,0,0,0,60000,0,60000,60000
044124,燿華凱基93購01  ,0,0,0,0,0,0,0,0,0,60000,0,0,0,60000,0,60000,60000
03149P,鴻海群益01售12  ,0,0,0,0,0,0,0,0,0,60000,0,0,0,190000,130000,60000,60000
03441P,義隆凱基02售03  ,0,0,0,0,0,0,0,0,0,60000,0,0,0,60000,0,60000,60000
040553,滬深2X凱基91購01,0,0,0,0,0,0,0,0,0,60000,0,0,0,60000,0,60000,60000
044558,台虹永豐91購01  ,0,0,0,0,0,0,0,0,0,60000,0,0,0,60000,0,60000,60000
044461,滬深2X兆豐93購01,0,0,0,0,0,0,0,0,0,60000,0,0,0,60000,0,60000,60000
043178,柏文國泰92購01  ,0,0,0,0,0,0,0,0,0,60000,0,0,0,60000,0,60000,60000
04102P,臺股指國票93售09,0,0,0,0,0,0,0,0,0,60000,0,0,0,150000,90000,60000,60000
048922,光寶科永豐94購01,0,0,0,0,0,0,0,0,0,60000,0,0,0,60000,0,60000,60000
048917,和鑫台新94購01  ,0,0,0,0,0,0,0,0,0,60000,0,0,0,60000,0,60000,60000
048853,凌陽群益94購01  ,0,0,0,0,0,0,0,0,0,60000,0,0,0,100000,40000,60000,60000
048891,傳奇元富97購02  ,0,0,0,0,0,0,0,0,0,60000,0,0,0,60000,0,60000,60000
046629,群創統一98購01  ,0,0,0,0,0,0,0,0,0,60000,0,0,0,60000,0,60000,60000
048412,台勝科亞東93購01,0,0,0,0,0,0,0,0,0,60000,0,0,0,60000,0,60000,60000
048495,南亞科元大93購04,0,0,0,0,0,0,0,0,0,60000,0,0,0,100000,40000,60000,60000
048514,嘉澤凱基93購06  ,0,0,0,0,0,0,0,0,0,60000,0,0,0,74000,14000,60000,60000
04593P,台積電元大94售11,0,0,0,0,0,0,0,0,0,60000,0,0,0,60000,0,60000,60000
046150,欣興國票92購02  ,0,0,0,0,0,0,0,0,0,60000,0,0,0,80000,20000,60000,60000
04802P,國巨凱基94售07  ,0,0,0,0,0,0,0,0,0,60000,0,0,0,60000,0,60000,60000
046947,禾伸堂元大93購01,0,0,0,0,0,0,0,0,0,60000,0,0,0,60000,0,60000,60000
047406,香港反統一94購01,0,0,0,0,0,0,0,0,0,60000,0,0,0,90000,30000,60000,60000
047411,康控元富93購02  ,0,0,0,0,0,0,0,0,0,60000,0,0,0,75000,15000,60000,60000
052002,滬深2X國泰96購01,0,0,0,0,0,0,0,0,0,60000,0,0,0,60000,0,60000,60000
051584,可成元大95購08  ,0,0,0,0,0,0,0,0,0,60000,0,0,0,70000,10000,60000,60000
051700,深中小群益99購04,0,0,0,0,0,0,0,0,0,60000,0,0,0,400000,340000,60000,60000
051101,台表科元大96購02,0,0,0,0,0,0,0,0,0,60000,0,0,0,434000,374000,60000,60000
050580,強茂國票95購01  ,0,0,0,0,0,0,0,0,0,60000,0,0,0,60000,0,60000,60000
050648,全新凱基96購01  ,0,0,0,0,0,0,0,0,0,60000,0,0,0,64000,4000,60000,60000
050456,聯茂元大94購09  ,0,0,0,0,0,0,0,0,0,60000,0,0,0,90000,30000,60000,60000
049814,超眾元大95購04  ,0,0,0,0,0,0,0,0,0,60000,0,0,0,73000,13000,60000,60000
05706P,TPK永豐96售02   ,0,0,0,0,0,0,0,0,0,60000,0,0,0,86000,26000,60000,60000
06002P,華通康和96售01  ,0,0,0,0,0,0,0,0,0,60000,0,0,0,70000,10000,60000,60000
054478,可成中信97購01  ,0,0,0,0,0,0,0,0,0,59000,0,0,0,80000,21000,59000,59000
053597,牧德元大99購01  ,0,0,0,0,0,0,0,0,0,59000,0,0,0,143000,84000,59000,59000
052638,緯創凱基96購02  ,0,0,0,0,0,0,0,0,0,59000,0,0,0,59000,0,59000,59000
053490,為升兆豐97購01  ,0,0,0,0,0,0,0,0,0,59000,0,0,0,60000,1000,59000,59000
053582,英業達元大97購01,0,0,0,0,0,0,0,0,0,59000,0,0,0,59000,0,59000,59000
053268,日月光群益96購01,0,0,0,0,0,0,0,0,0,59000,0,0,0,98000,39000,59000,59000
042997,新光鋼元大94購01,0,0,0,0,0,0,0,0,0,59000,0,0,0,100000,41000,59000,59000
00638R,元大滬深300反1  ,50000,0,50000,0,0,0,0,0,0,9000,0,0,0,175000,166000,9000,59000
044297,台郡凱基91購02  ,0,0,0,0,0,0,0,0,0,59000,0,0,0,69000,10000,59000,59000
043652,微星國泰93購01  ,0,0,0,0,0,0,0,0,0,59000,0,0,0,199000,140000,59000,59000
045099,日股反中信93購01,0,0,0,0,0,0,0,0,0,59000,0,0,0,60000,1000,59000,59000
046978,復盛永豐93購01  ,0,0,0,0,0,0,0,0,0,59000,0,0,0,59000,0,59000,59000
046552,晶技麥證92購01  ,0,0,0,69000,10000,59000,0,0,0,59000,0,0,0,69000,10000,59000,59000
04971P,矽力元富94售02  ,0,0,0,0,0,0,0,0,0,59000,0,0,0,242000,183000,59000,59000
051064,鴻海國票95購01  ,0,0,0,0,0,0,0,0,0,59000,0,0,0,59000,0,59000,59000
051906,國巨元大95購09  ,0,0,0,0,0,0,0,0,0,59000,0,0,0,59000,0,59000,59000
05756P,臺股指中信99售05,0,0,0,0,0,0,0,0,0,59000,0,0,0,61000,2000,59000,59000
4942,嘉彰            ,156000,97000,59000,0,0,0,0,0,0,0,0,0,0,0,0,0,59000
9914,美利達          ,126000,72226,53774,0,0,0,0,0,0,5000,28000,0,28000,0,23000,-23000,58774
052724,力成統一97購01  ,0,0,0,0,0,0,0,0,0,58000,0,0,0,88000,30000,58000,58000
054186,高鐵永豐96購01  ,0,0,0,0,0,0,0,0,0,58000,0,0,0,58000,0,58000,58000
045392,滬深2X國泰93購01,0,0,0,0,0,0,0,0,0,58000,0,0,0,61000,3000,58000,58000
04014P,聯發科元大93售18,0,0,0,0,0,0,0,0,0,58000,0,0,0,80000,22000,58000,58000
04152P,喬山永豐93售02  ,0,0,0,0,0,0,0,0,0,58000,0,0,0,58000,0,58000,58000
046102,健鼎永豐92購01  ,0,0,0,0,0,0,0,0,0,58000,0,0,0,58000,0,58000,58000
047709,聯發科凱基93購18,0,0,0,0,0,0,0,0,0,58000,0,0,0,70000,12000,58000,58000
047305,卜蜂元大93購02  ,0,0,0,0,0,0,0,0,0,58000,0,0,0,58000,0,58000,58000
048668,奇力新永豐93購04,0,0,0,0,0,0,0,0,0,58000,0,0,0,139000,81000,58000,58000
052053,泰鼎凱基96購01  ,0,0,0,0,0,0,0,0,0,58000,0,0,0,58000,0,58000,58000
051302,可成凱基95購06  ,0,0,0,0,0,0,0,0,0,58000,0,0,0,168000,110000,58000,58000
04947P,聯詠元大94售05  ,0,0,0,0,0,0,0,0,0,58000,0,0,0,177000,119000,58000,58000
050243,華新科凱基94購10,0,0,0,0,0,0,0,0,0,58000,0,0,0,77000,19000,58000,58000
05923P,旺宏元富96售05  ,0,0,0,0,0,0,0,0,0,58000,0,0,0,58000,0,58000,58000
054519,禾伸堂元大97購02,0,0,0,0,0,0,0,0,0,57000,0,0,0,217000,160000,57000,57000
05566P,景碩永豐96售01  ,0,0,0,0,0,0,0,0,0,57000,0,0,0,57000,0,57000,57000
052955,國巨日盛96購01  ,0,0,0,0,0,0,0,0,0,57000,0,0,0,59000,2000,57000,57000
053032,國巨兆豐97購02  ,0,0,0,0,0,0,0,0,0,57000,0,0,0,236000,179000,57000,57000
053099,正崴元富96購01  ,0,0,0,0,0,0,0,0,0,57000,0,0,0,66000,9000,57000,57000
045393,寶齡國泰93購01  ,0,0,0,0,0,0,0,0,0,57000,0,0,0,80000,23000,57000,57000
045606,喬山群益92購01  ,0,0,0,0,0,0,0,0,0,57000,0,0,0,57000,0,57000,57000
048240,嘉聯益國票94購03,0,0,0,0,0,0,0,0,0,57000,0,0,0,72000,15000,57000,57000
045780,奇鋐元大94購01  ,0,0,0,0,0,0,0,0,0,57000,0,0,0,61000,4000,57000,57000
046365,禾伸堂永豐92購02,0,0,0,0,0,0,0,0,0,57000,0,0,0,57000,0,57000,57000
050209,華通國票95購01  ,0,0,0,0,0,0,0,0,0,57000,0,0,0,57000,0,57000,57000
050674,瑞昱富邦94購02  ,0,0,0,0,0,0,0,0,0,57000,0,0,0,67000,10000,57000,57000
049744,亞德客永豐94購01,0,0,0,0,0,0,0,0,0,57000,0,0,0,67000,10000,57000,57000
051331,全新永豐96購01  ,0,0,0,0,0,0,0,0,0,57000,0,0,0,68000,11000,57000,57000
051811,致伸凱基95購03  ,0,0,0,0,0,0,0,0,0,57000,0,0,0,57000,0,57000,57000
05844P,旺宏元大96售07  ,0,0,0,0,0,0,0,0,0,57000,0,0,0,622000,565000,57000,57000
05629P,聯發科永昌99售02,0,0,0,0,0,0,0,0,0,57000,0,0,0,167000,110000,57000,57000
1808,潤隆            ,193000,136000,57000,0,0,0,0,0,0,0,0,0,0,0,0,0,57000
052967,智邦群益96購01  ,0,0,0,0,0,0,0,0,0,56000,0,0,0,114000,58000,56000,56000
05523P,聯發科國票96售04,0,0,0,0,0,0,0,0,0,56000,0,0,0,56000,0,56000,56000
054325,奇力新台新97購03,0,0,0,0,0,0,0,0,0,56000,0,0,0,56000,0,56000,56000
04453P,聯發科富邦94售04,0,0,0,0,0,0,0,0,0,56000,0,0,0,72000,16000,56000,56000
049113,大立光統一94購06,0,0,0,0,0,0,0,0,0,56000,0,0,0,77000,21000,56000,56000
051849,旺宏中信98購01  ,0,0,0,0,0,0,0,0,0,56000,0,0,0,142000,86000,56000,56000
052177,京鼎元大95購02  ,0,0,0,0,0,0,0,0,0,56000,0,0,0,68000,12000,56000,56000
049507,和大凱基94購01  ,0,0,0,0,0,0,0,0,0,56000,0,0,0,86000,30000,56000,56000
050161,鴻海國泰96購03  ,0,0,0,0,0,0,0,0,0,56000,0,0,0,67000,11000,56000,56000
050570,聯發科中信97購02,0,0,0,0,0,0,0,0,0,56000,0,0,0,71000,15000,56000,56000
3031,佰鴻            ,114000,62000,52000,0,0,0,0,0,0,4000,4000,0,4000,0,0,0,56000
06069P,台積電永豐97售01,0,0,0,0,0,0,0,0,0,56000,0,0,0,67000,11000,56000,56000
054572,國巨元大98購03  ,0,0,0,0,0,0,0,0,0,55000,0,0,0,238000,183000,55000,55000
05412P,泰碩國票95售02  ,0,0,0,0,0,0,0,0,0,55000,0,0,0,55000,0,55000,55000
053814,美律群益97購02  ,0,0,0,0,0,0,0,0,0,55000,0,0,0,55000,0,55000,55000
05329P,臺股指凱基95售13,0,0,0,0,0,0,0,0,0,55000,0,0,0,65000,10000,55000,55000
052897,緯創群益96購03  ,0,0,0,0,0,0,0,0,0,55000,0,0,0,66000,11000,55000,55000
048326,滬深2X國泰94購03,0,0,0,0,0,0,0,0,0,55000,0,0,0,185000,130000,55000,55000
044184,南亞科國泰93購01,0,0,0,0,0,0,0,0,0,55000,0,0,0,55000,0,55000,55000
043986,奇鋐元大91購01  ,0,0,0,0,0,0,0,0,0,55000,0,0,0,55000,0,55000,55000
048185,台郡群益93購04  ,0,0,0,0,0,0,0,0,0,55000,0,0,0,55000,0,55000,55000
048677,智伸科國泰94購01,0,0,0,0,0,0,0,0,0,55000,0,0,0,115000,60000,55000,55000
047115,可成元大93購06  ,0,0,0,0,0,0,0,0,0,55000,0,0,0,104000,49000,55000,55000
046343,和鑫國票93購02  ,0,0,0,0,0,0,0,0,0,55000,0,0,0,55000,0,55000,55000
046032,全新元大92購04  ,0,0,0,0,0,0,0,0,0,55000,0,0,0,55000,0,55000,55000
046999,康控富邦99購01  ,0,0,0,0,0,0,0,0,0,55000,0,0,0,167000,112000,55000,55000
049829,裕民凱基94購01  ,0,0,0,0,0,0,0,0,0,55000,0,0,0,55000,0,55000,55000
051749,矽力國泰97購01  ,0,0,0,0,0,0,0,0,0,55000,0,0,0,105000,50000,55000,55000
051400,國巨永豐95購01  ,0,0,0,0,0,0,0,0,0,55000,0,0,0,64000,9000,55000,55000
05922P,京元電兆豐96售01,0,0,0,0,0,0,0,0,0,55000,0,0,0,531000,476000,55000,55000
05946P,和碩中信96售01  ,0,0,0,0,0,0,0,0,0,55000,0,0,0,110000,55000,55000,55000
053261,國巨群益96購05  ,0,0,0,0,0,0,0,0,0,54000,0,0,0,86000,32000,54000,54000
053475,華新科元大96購05,0,0,0,0,0,0,0,0,0,54000,0,0,0,219000,165000,54000,54000
054006,智易統一97購01  ,0,0,0,0,0,0,0,0,0,54000,0,0,0,54000,0,54000,54000
05532P,臺股指群益96售05,0,0,0,0,0,0,0,0,0,54000,0,0,0,59000,5000,54000,54000
03970P,奇鋐國票93售01  ,0,0,0,0,0,0,0,0,0,54000,0,0,0,54000,0,54000,54000
048916,華新科台新94購01,0,0,0,0,0,0,0,0,0,54000,0,0,0,54000,0,54000,54000
04811P,上銀元大94售02  ,0,0,0,0,0,0,0,0,0,54000,0,0,0,55000,1000,54000,54000
051471,國巨凱基97購01  ,0,0,0,0,0,0,0,0,0,54000,0,0,0,54000,0,54000,54000
051861,鴻海凱基98購01  ,0,0,0,0,0,0,0,0,0,54000,0,0,0,79000,25000,54000,54000
051701,華通群益97購01  ,0,0,0,0,0,0,0,0,0,54000,0,0,0,66000,12000,54000,54000
052123,泰碩國票95購01  ,0,0,0,0,0,0,0,0,0,54000,0,0,0,80000,26000,54000,54000
049756,瀚宇博永豐94購01,0,0,0,0,0,0,0,0,0,54000,0,0,0,55000,1000,54000,54000
050234,國巨凱基94購10  ,0,0,0,0,0,0,0,0,0,54000,0,0,0,67000,13000,54000,54000
05640P,旺宏元富96售03  ,0,0,0,0,0,0,0,0,0,54000,0,0,0,54000,0,54000,54000
05758P,光罩永豐96售02  ,0,0,0,0,0,0,0,0,0,54000,0,0,0,170000,116000,54000,54000
6591,動力-KY         ,120000,65000,55000,0,0,0,0,0,0,-1000,0,1000,-1000,0,0,0,54000
05545P,台表科國泰98售01,0,0,0,0,0,0,0,0,0,53000,0,0,0,65000,12000,53000,53000
054297,台郡元大98購01  ,0,0,0,0,0,0,0,0,0,53000,0,0,0,87000,34000,53000,53000
053817,華新科群益97購02,0,0,0,0,0,0,0,0,0,53000,0,0,0,53000,0,53000,53000
053208,鴻海凱基96購13  ,0,0,0,0,0,0,0,0,0,53000,0,0,0,73000,20000,53000,53000
045175,康控國票92購01  ,0,0,0,0,0,0,0,0,0,53000,0,0,0,53000,0,53000,53000
044110,智原國票91購02  ,0,0,0,0,0,0,0,0,0,53000,0,0,0,53000,0,53000,53000
049043,新唐兆豐94購01  ,0,0,0,0,0,0,0,0,0,53000,0,0,0,55000,2000,53000,53000
047909,超眾元大93購03  ,0,0,0,0,0,0,0,0,0,53000,0,0,0,54000,1000,53000,53000
052193,國巨元富95購06  ,0,0,0,0,0,0,0,0,0,53000,0,0,0,63000,10000,53000,53000
05701P,彩晶凱基96售01  ,0,0,0,0,0,0,0,0,0,53000,0,0,0,54000,1000,53000,53000
05902P,華通國票96售02  ,0,0,0,0,0,0,0,0,0,53000,0,0,0,120000,67000,53000,53000
05875P,旺宏群益98售01  ,0,0,0,0,0,0,0,0,0,53000,0,0,0,53000,0,53000,53000
4190,佐登-KY         ,138000,37000,101000,0,0,0,0,0,0,-48000,3000,33000,-30000,0,18000,-18000,53000
2426,鼎元            ,153000,100000,53000,0,0,0,0,0,0,0,0,0,0,0,0,0,53000
053206,聯發科麥證96購02,0,0,0,55000,3000,52000,0,0,0,52000,0,0,0,55000,3000,52000,52000
05299P,旺宏元大95售04  ,0,0,0,0,0,0,0,0,0,52000,0,0,0,100000,48000,52000,52000
053461,台郡永昌99購01  ,0,0,0,0,0,0,0,0,0,52000,0,0,0,56000,4000,52000,52000
052355,為升永豐95購02  ,0,0,0,0,0,0,0,0,0,52000,0,0,0,52000,0,52000,52000
052509,鴻海凱基96購10  ,0,0,0,0,0,0,0,0,0,52000,0,0,0,53000,1000,52000,52000
054042,華泰元大96購01  ,0,0,0,0,0,0,0,0,0,52000,0,0,0,52000,0,52000,52000
047758,康舒元富93購01  ,0,0,0,0,0,0,0,0,0,52000,0,0,0,52000,0,52000,52000
04327P,台積電國泰95售01,0,0,0,0,0,0,0,0,0,52000,0,0,0,542000,490000,52000,52000
051575,國巨元大96購03  ,0,0,0,0,0,0,0,0,0,52000,0,0,0,55000,3000,52000,52000
051889,智邦元富95購02  ,0,0,0,0,0,0,0,0,0,52000,0,0,0,99000,47000,52000,52000
054218,S&P反1統一98購02,0,0,0,0,0,0,0,0,0,51000,0,0,0,51000,0,51000,51000
054522,康友元大96購07  ,0,0,0,0,0,0,0,0,0,51000,0,0,0,186000,135000,51000,51000
053511,鴻海群益96購04  ,0,0,0,0,0,0,0,0,0,51000,0,0,0,127000,76000,51000,51000
053542,超眾永豐96購01  ,0,0,0,0,0,0,0,0,0,51000,0,0,0,51000,0,51000,51000
03421B,臺股指元大99熊01,0,0,0,0,0,0,0,0,0,51000,0,0,0,52000,1000,51000,51000
045690,啟碁元大92購01  ,0,0,0,0,0,0,0,0,0,51000,0,0,0,51000,0,51000,51000
046649,致伸國泰94購01  ,0,0,0,0,0,0,0,0,0,51000,0,0,0,51000,0,51000,51000
048179,臻鼎富邦97購01  ,0,0,0,0,0,0,0,0,0,51000,0,0,0,51000,0,51000,51000
051607,緯創群益96購02  ,0,0,0,0,0,0,0,0,0,51000,0,0,0,51000,0,51000,51000
050604,上証2X永昌94購01,0,0,0,0,0,0,0,0,0,51000,0,0,0,54000,3000,51000,51000
049694,華新科元大95購06,0,0,0,0,0,0,0,0,0,51000,0,0,0,61000,10000,51000,51000
04961P,貿聯凱基94售03  ,0,0,0,0,0,0,0,0,0,51000,0,0,0,51000,0,51000,51000
049437,可成國泰96購01  ,0,0,0,0,0,0,0,0,0,51000,0,0,0,154000,103000,51000,51000
05008P,大立光元富95售05,0,0,0,0,0,0,0,0,0,51000,0,0,0,51000,0,51000,51000
053284,樺漢元大97購01  ,0,0,0,0,0,0,0,0,0,50000,0,0,0,50000,0,50000,50000
052979,上銀元大96購02  ,0,0,0,0,0,0,0,0,0,50000,0,0,0,70000,20000,50000,50000
053016,鈺齊統一96購01  ,0,0,0,0,0,0,0,0,0,50000,0,0,0,50000,0,50000,50000
053234,奇鋐永豐96購01  ,0,0,0,0,0,0,0,0,0,50000,0,0,0,50000,0,50000,50000
052257,燿華國泰96購01  ,0,0,0,0,0,0,0,0,0,50000,0,0,0,83000,33000,50000,50000
052900,大成鋼國票97購01,0,0,0,0,0,0,0,0,0,50000,0,0,0,50000,0,50000,50000
052859,國巨凱基96購07  ,0,0,0,0,0,0,0,0,0,50000,0,0,0,180000,130000,50000,50000
052813,T50正2永豐96購01,0,0,0,0,0,0,0,0,0,50000,0,0,0,130000,80000,50000,50000
052817,楠梓電永豐96購02,0,0,0,0,0,0,0,0,0,50000,0,0,0,50000,0,50000,50000
052627,中壽中信98購01  ,0,0,0,0,0,0,0,0,0,50000,0,0,0,50000,0,50000,50000
054256,創意元大96購07  ,0,0,0,0,0,0,0,0,0,50000,0,0,0,62000,12000,50000,50000
054313,麗豐凱基96購02  ,0,0,0,0,0,0,0,0,0,50000,0,0,0,50000,0,50000,50000
054043,漢唐元大97購01  ,0,0,0,0,0,0,0,0,0,50000,0,0,0,128000,78000,50000,50000
054029,瀚宇博凱基96購02,0,0,0,0,0,0,0,0,0,50000,0,0,0,50000,0,50000,50000
053986,矽創第一96購01  ,0,0,0,0,0,0,0,0,0,50000,0,0,0,50000,0,50000,50000
054170,泰鼎凱基98購01  ,0,0,0,0,0,0,0,0,0,50000,0,0,0,50000,0,50000,50000
053762,T50反1富邦97購01,0,0,0,0,0,0,0,0,0,50000,0,0,0,50000,0,50000,50000
053661,嘉澤凱基97購01  ,0,0,0,0,0,0,0,0,0,50000,0,0,0,56000,6000,50000,50000
045652,緯穎凱基92購01  ,0,0,0,0,0,0,0,0,0,50000,0,0,0,50000,0,50000,50000
04377P,大立光元大94售04,0,0,0,0,0,0,0,0,0,50000,0,0,0,50000,0,50000,50000
043678,台達電凱基91購02,0,0,0,0,0,0,0,0,0,50000,0,0,0,50000,0,50000,50000
044216,華新科凱基93購02,0,0,0,0,0,0,0,0,0,50000,0,0,0,60000,10000,50000,50000
04415P,牧德元富94售05  ,0,0,0,0,0,0,0,0,0,50000,0,0,0,100000,50000,50000,50000
045622,康舒永豐92購01  ,0,0,0,0,0,0,0,0,0,50000,0,0,0,50000,0,50000,50000
045642,致伸凱基92購02  ,0,0,0,0,0,0,0,0,0,50000,0,0,0,60000,10000,50000,50000
044243,景碩統一91購01  ,0,0,0,0,0,0,0,0,0,50000,0,0,0,50000,0,50000,50000
04778P,可成凱基94售10  ,0,0,0,0,0,0,0,0,0,50000,0,0,0,62000,12000,50000,50000
047760,元油反元大96購03,0,0,0,0,0,0,0,0,0,50000,0,0,0,61000,11000,50000,50000
045775,可成元大92購06  ,0,0,0,0,0,0,0,0,0,50000,0,0,0,79000,29000,50000,50000
045777,強茂元大92購02  ,0,0,0,0,0,0,0,0,0,50000,0,0,0,108000,58000,50000,50000
048263,台積電元富95購01,0,0,0,0,0,0,0,0,0,50000,0,0,0,50000,0,50000,50000
046312,可成元大92購10  ,0,0,0,0,0,0,0,0,0,50000,0,0,0,50000,0,50000,50000
045104,中環群益92購01  ,0,0,0,0,0,0,0,0,0,50000,0,0,0,50000,0,50000,50000
045079,大立光元大93購05,0,0,0,0,0,0,0,0,0,50000,0,0,0,50000,0,50000,50000
045011,華新科元大92購08,0,0,0,0,0,0,0,0,0,50000,0,0,0,50000,0,50000,50000
044870,上銀統一91購02  ,0,0,0,0,0,0,0,0,0,50000,0,0,0,70000,20000,50000,50000
044953,中環凱基92購01  ,0,0,0,0,0,0,0,0,0,50000,0,0,0,50000,0,50000,50000
044808,聯茂凱基91購02  ,0,0,0,0,0,0,0,0,0,50000,0,0,0,50000,0,50000,50000
043931,京元電永豐91購01,0,0,0,0,0,0,0,0,0,50000,0,0,0,50000,0,50000,50000
045262,華固凱基92購01  ,0,0,0,0,0,0,0,0,0,50000,0,0,0,50000,0,50000,50000
045206,創意國泰93購02  ,0,0,0,0,0,0,0,0,0,50000,0,0,0,160000,110000,50000,50000
03434P,金融類元大02售01,0,0,0,0,0,0,0,0,0,50000,0,0,0,50000,0,50000,50000
03287P,台灣50元大02售08,0,0,0,0,0,0,0,0,0,50000,0,0,0,50000,0,50000,50000
03957P,創意統一94售02  ,0,0,0,0,0,0,0,0,0,50000,0,0,0,50000,0,50000,50000
03764P,大立光元富93售01,0,0,0,0,0,0,0,0,0,50000,0,0,0,50000,0,50000,50000
03771P,中磊元大93售03  ,0,0,0,0,0,0,0,0,0,50000,0,0,0,100000,50000,50000,50000
03655P,臺股指元大92售17,0,0,0,0,0,0,0,0,0,50000,0,0,0,1547000,1497000,50000,50000
04323P,強茂元大93售02  ,0,0,0,0,0,0,0,0,0,50000,0,0,0,50000,0,50000,50000
04266P,華新科元富93售02,0,0,0,0,0,0,0,0,0,50000,0,0,0,50000,0,50000,50000
04146P,可成凱基93售14  ,0,0,0,0,0,0,0,0,0,50000,0,0,0,64000,14000,50000,50000
042015,瑞昱元大91購01  ,0,0,0,0,0,0,0,0,0,50000,0,0,0,50000,0,50000,50000
044481,聯茂統一91購04  ,0,0,0,0,0,0,0,0,0,50000,0,0,0,50000,0,50000,50000
04333P,儒鴻凱基93售06  ,0,0,0,0,0,0,0,0,0,50000,0,0,0,50000,0,50000,50000
043539,鴻海國票91購01  ,0,0,0,0,0,0,0,0,0,50000,0,0,0,50000,0,50000,50000
043631,華新科凱基91購06,0,0,0,0,0,0,0,0,0,50000,0,0,0,50000,0,50000,50000
04431P,牧德元大94售03  ,0,0,0,0,0,0,0,0,0,50000,0,0,0,50000,0,50000,50000
049015,鴻海群益94購03  ,0,0,0,0,0,0,0,0,0,50000,0,0,0,416000,366000,50000,50000
048136,聯茂國票93購04  ,0,0,0,0,0,0,0,0,0,50000,0,0,0,50000,0,50000,50000
047495,新日興元富96購01,0,0,0,0,0,0,0,0,0,50000,0,0,0,85000,35000,50000,50000
048689,台光電群益94購01,0,0,0,0,0,0,0,0,0,50000,0,0,0,208000,158000,50000,50000
048652,巨大元大96購01  ,0,0,0,0,0,0,0,0,0,50000,0,0,0,50000,0,50000,50000
047105,和大元大94購01  ,0,0,0,0,0,0,0,0,0,50000,0,0,0,138000,88000,50000,50000
048735,美利達麥證95購01,0,0,0,60000,10000,50000,0,0,0,50000,0,0,0,60000,10000,50000,50000
04875P,台積電中信94售04,0,0,0,0,0,0,0,0,0,50000,0,0,0,50000,0,50000,50000
048945,訊連永豐94購01  ,0,0,0,0,0,0,0,0,0,50000,0,0,0,75000,25000,50000,50000
048618,超眾凱基93購08  ,0,0,0,0,0,0,0,0,0,50000,0,0,0,50000,0,50000,50000
046697,麗豐凱基94購01  ,0,0,0,0,0,0,0,0,0,50000,0,0,0,50000,0,50000,50000
046512,和鑫元大92購01  ,0,0,0,0,0,0,0,0,0,50000,0,0,0,50000,0,50000,50000
048349,美利達元大96購02,0,0,0,0,0,0,0,0,0,50000,0,0,0,56000,6000,50000,50000
047025,可成元大93購05  ,0,0,0,0,0,0,0,0,0,50000,0,0,0,50000,0,50000,50000
047403,香港2X統一93購01,0,0,0,0,0,0,0,0,0,50000,0,0,0,50000,0,50000,50000
04695P,正崴康和94售01  ,0,0,0,0,0,0,0,0,0,50000,0,0,0,50000,0,50000,50000
045931,緯穎永豐93購01  ,0,0,0,0,0,0,0,0,0,50000,0,0,0,50000,0,50000,50000
049827,正崴凱基94購01  ,0,0,0,0,0,0,0,0,0,50000,0,0,0,55000,5000,50000,50000
04988P,楠梓電元大94售01,0,0,0,0,0,0,0,0,0,50000,0,0,0,50000,0,50000,50000
049499,康控元大96購01  ,0,0,0,0,0,0,0,0,0,50000,0,0,0,341000,291000,50000,50000
049743,全新台新94購01  ,0,0,0,0,0,0,0,0,0,50000,0,0,0,60000,10000,50000,50000
05061P,鴻海富邦96售03  ,0,0,0,0,0,0,0,0,0,50000,0,0,0,50000,0,50000,50000
050706,柏文凱基94購01  ,0,0,0,0,0,0,0,0,0,50000,0,0,0,50000,0,50000,50000
050223,聯茂元富94購02  ,0,0,0,0,0,0,0,0,0,50000,0,0,0,60000,10000,50000,50000
05036P,義隆元大95售03  ,0,0,0,0,0,0,0,0,0,50000,0,0,0,50000,0,50000,50000
050548,華固凱基95購01  ,0,0,0,0,0,0,0,0,0,50000,0,0,0,50000,0,50000,50000
052191,超眾群益96購01  ,0,0,0,0,0,0,0,0,0,50000,0,0,0,50000,0,50000,50000
051998,昇陽半元大96購02,0,0,0,0,0,0,0,0,0,50000,0,0,0,50000,0,50000,50000
051070,正崴國票96購01  ,0,0,0,0,0,0,0,0,0,50000,0,0,0,50000,0,50000,50000
051071,聯發科國票96購01,0,0,0,0,0,0,0,0,0,50000,0,0,0,50000,0,50000,50000
2302,麗正            ,52000,2000,50000,0,0,0,0,0,0,0,0,0,0,0,0,0,50000
3702A,大聯大甲特      ,0,0,0,0,0,0,0,0,0,50000,50000,0,50000,0,0,0,50000
2887E,台新戊特        ,0,0,0,0,0,0,0,0,0,50000,50000,0,50000,0,0,0,50000
05741P,聯發科元大96售14,0,0,0,0,0,0,0,0,0,50000,0,0,0,226000,176000,50000,50000
08962P,大立光凱基03售05,0,0,0,0,0,0,0,0,0,50000,0,0,0,50000,0,50000,50000
054064,台郡國票97購04  ,0,0,0,0,0,0,0,0,0,49000,0,0,0,68000,19000,49000,49000
054077,中石化中信98購01,0,0,0,0,0,0,0,0,0,49000,0,0,0,50000,1000,49000,49000
052241,台郡國票96購01  ,0,0,0,0,0,0,0,0,0,49000,0,0,0,89000,40000,49000,49000
052393,康友群益95購05  ,0,0,0,0,0,0,0,0,0,49000,0,0,0,49000,0,49000,49000
052522,聯發科元大96購05,0,0,0,0,0,0,0,0,0,49000,0,0,0,149000,100000,49000,49000
053082,聯電元大98購03  ,0,0,0,0,0,0,0,0,0,49000,0,0,0,54000,5000,49000,49000
053012,國巨統一96購03  ,0,0,0,0,0,0,0,0,0,49000,0,0,0,207000,158000,49000,49000
03909P,奇鋐元大93售04  ,0,0,0,0,0,0,0,0,0,49000,0,0,0,150000,101000,49000,49000
047949,燿華台新93購01  ,0,0,0,0,0,0,0,0,0,49000,0,0,0,149000,100000,49000,49000
048836,牧德凱基94購03  ,0,0,0,0,0,0,0,0,0,49000,0,0,0,160000,111000,49000,49000
05193P,台郡台新95售01  ,0,0,0,0,0,0,0,0,0,49000,0,0,0,212000,163000,49000,49000
051725,緯穎永豐95購02  ,0,0,0,0,0,0,0,0,0,49000,0,0,0,148000,99000,49000,49000
051760,奇力新元大95購04,0,0,0,0,0,0,0,0,0,49000,0,0,0,82000,33000,49000,49000
050629,廣宇亞東96購01  ,0,0,0,0,0,0,0,0,0,49000,0,0,0,49000,0,49000,49000
05014P,臺股指元大95售05,0,0,0,0,0,0,0,0,0,49000,0,0,0,50000,1000,49000,49000
06087P,國巨永豐97售01  ,0,0,0,0,0,0,0,0,0,49000,0,0,0,87000,38000,49000,49000
2316,楠梓電          ,307000,314000,-7000,0,0,0,0,0,0,56000,0,1000,-1000,130000,73000,57000,49000
1717,長興            ,123000,79393,43607,0,0,0,5000,0,5000,0,0,0,0,0,0,0,48607
053108,南亞科兆豐96購01,0,0,0,0,0,0,0,0,0,48000,0,0,0,48000,0,48000,48000
05318P,臺股指永昌95售03,0,0,0,0,0,0,0,0,0,48000,0,0,0,50000,2000,48000,48000
052825,TPK永豐96購01   ,0,0,0,0,0,0,0,0,0,48000,0,0,0,68000,20000,48000,48000
052774,京元電亞東96購01,0,0,0,0,0,0,0,0,0,48000,0,0,0,48000,0,48000,48000
054034,景碩中信96購01  ,0,0,0,0,0,0,0,0,0,48000,0,0,0,48000,0,48000,48000
053654,聯發科凱基98購01,0,0,0,0,0,0,0,0,0,48000,0,0,0,69000,21000,48000,48000
04005P,樺漢凱基93售02  ,0,0,0,0,0,0,0,0,0,48000,0,0,0,58000,10000,48000,48000
04317P,樺漢國票93售03  ,0,0,0,0,0,0,0,0,0,48000,0,0,0,48000,0,48000,48000
045385,華新科元大93購04,0,0,0,0,0,0,0,0,0,48000,0,0,0,60000,12000,48000,48000
045532,台表科永豐92購01,0,0,0,0,0,0,0,0,0,48000,0,0,0,59000,11000,48000,48000
044950,玉晶光群益94購01,0,0,0,0,0,0,0,0,0,48000,0,0,0,93000,45000,48000,48000
045010,可成元大92購04  ,0,0,0,0,0,0,0,0,0,48000,0,0,0,195000,147000,48000,48000
045040,嘉晶日盛92購01  ,0,0,0,0,0,0,0,0,0,48000,0,0,0,48000,0,48000,48000
045103,上海銀亞東94購01,0,0,0,0,0,0,0,0,0,48000,0,0,0,48000,0,48000,48000
046289,群創兆豐92購03  ,0,0,0,0,0,0,0,0,0,48000,0,0,0,79000,31000,48000,48000
04379P,大立光元大94售06,0,0,0,0,0,0,0,0,0,48000,0,0,0,50000,2000,48000,48000
04898P,瑞儀中信95售01  ,0,0,0,0,0,0,0,0,0,48000,0,0,0,178000,130000,48000,48000
049003,智邦中信95購01  ,0,0,0,0,0,0,0,0,0,48000,0,0,0,48000,0,48000,48000
047298,聯茂元富96購01  ,0,0,0,0,0,0,0,0,0,48000,0,0,0,98000,50000,48000,48000
047984,禾伸堂群益93購01,0,0,0,0,0,0,0,0,0,48000,0,0,0,165000,117000,48000,48000
050179,全新元大96購02  ,0,0,0,0,0,0,0,0,0,48000,0,0,0,65000,17000,48000,48000
050883,嘉聯益國泰96購01,0,0,0,0,0,0,0,0,0,48000,0,0,0,67000,19000,48000,48000
050392,群創統一96購01  ,0,0,0,0,0,0,0,0,0,48000,0,0,0,48000,0,48000,48000
051608,新日興群益96購01,0,0,0,0,0,0,0,0,0,48000,0,0,0,128000,80000,48000,48000
051924,聯茂日盛95購01  ,0,0,0,0,0,0,0,0,0,48000,0,0,0,48000,0,48000,48000
052214,智伸科元大96購01,0,0,0,0,0,0,0,0,0,48000,0,0,0,68000,20000,48000,48000
052069,聯茂兆豐96購01  ,0,0,0,0,0,0,0,0,0,48000,0,0,0,58000,10000,48000,48000
051525,日月光凱基95購02,0,0,0,0,0,0,0,0,0,48000,0,0,0,72000,24000,48000,48000
051509,鴻海中信97購01  ,0,0,0,0,0,0,0,0,0,48000,0,0,0,48000,0,48000,48000
054080,微星中信98購01  ,0,0,0,0,0,0,0,0,0,47000,0,0,0,47000,0,47000,47000
054141,TPK元大96購02   ,0,0,0,0,0,0,0,0,0,47000,0,0,0,160000,113000,47000,47000
05486P,大立光凱基95售14,0,0,0,0,0,0,0,0,0,47000,0,0,0,47000,0,47000,47000
05251P,喬山台新95售02  ,0,0,0,0,0,0,0,0,0,47000,0,0,0,57000,10000,47000,47000
05226P,智邦統一95售01  ,0,0,0,0,0,0,0,0,0,47000,0,0,0,90000,43000,47000,47000
048548,緯穎永豐93購02  ,0,0,0,0,0,0,0,0,0,47000,0,0,0,91000,44000,47000,47000
048810,玉晶光第一94購01,0,0,0,0,0,0,0,0,0,47000,0,0,0,47000,0,47000,47000
05141P,華通台新96售01  ,0,0,0,0,0,0,0,0,0,47000,0,0,0,66000,19000,47000,47000
051768,臻鼎元大95購04  ,0,0,0,0,0,0,0,0,0,47000,0,0,0,87000,40000,47000,47000
051833,昇陽半元大96購01,0,0,0,0,0,0,0,0,0,47000,0,0,0,95000,48000,47000,47000
050291,聯發科凱基94購16,0,0,0,0,0,0,0,0,0,47000,0,0,0,111000,64000,47000,47000
2486,一詮            ,56000,9000,47000,0,0,0,0,0,0,0,0,0,0,0,0,0,47000
052290,鴻海元富97購01  ,0,0,0,0,0,0,0,0,0,46000,0,0,0,105000,59000,46000,46000
05247P,上銀群益95售01  ,0,0,0,0,0,0,0,0,0,46000,0,0,0,46000,0,46000,46000
05281P,南亞科元大95售03,0,0,0,0,0,0,0,0,0,46000,0,0,0,48000,2000,46000,46000
052894,國巨群益96購03  ,0,0,0,0,0,0,0,0,0,46000,0,0,0,63000,17000,46000,46000
052975,嘉聯益群益96購01,0,0,0,0,0,0,0,0,0,46000,0,0,0,46000,0,46000,46000
05514P,康舒永豐96售01  ,0,0,0,0,0,0,0,0,0,46000,0,0,0,93000,47000,46000,46000
046282,全新永豐92購01  ,0,0,0,0,0,0,0,0,0,46000,0,0,0,176000,130000,46000,46000
03331P,臺股指群益02售05,0,0,0,0,0,0,0,0,0,46000,0,0,0,46000,0,46000,46000
048992,昇陽半元大94購02,0,0,0,0,0,0,0,0,0,46000,0,0,0,46000,0,46000,46000
04639P,臺股指群益94售14,0,0,0,0,0,0,0,0,0,46000,0,0,0,143000,97000,46000,46000
047818,台郡凱基93購04  ,0,0,0,0,0,0,0,0,0,46000,0,0,0,46000,0,46000,46000
047381,台化元大93購01  ,0,0,0,0,0,0,0,0,0,46000,0,0,0,51000,5000,46000,46000
050219,台積電元富95購03,0,0,0,0,0,0,0,0,0,46000,0,0,0,67000,21000,46000,46000
049967,華新科國票94購07,0,0,0,0,0,0,0,0,0,46000,0,0,0,107000,61000,46000,46000
049765,上証2X元富94購01,0,0,0,0,0,0,0,0,0,46000,0,0,0,46000,0,46000,46000
049715,華泰凱基94購02  ,0,0,0,0,0,0,0,0,0,46000,0,0,0,46000,0,46000,46000
049590,華新科元大94購01,0,0,0,0,0,0,0,0,0,46000,0,0,0,57000,11000,46000,46000
051017,聯發科凱基95購04,0,0,0,0,0,0,0,0,0,46000,0,0,0,72000,26000,46000,46000
05744P,台表科元大96售04,0,0,0,0,0,0,0,0,0,46000,0,0,0,46000,0,46000,46000
054678,麗豐台新98購02  ,0,0,0,0,0,0,0,0,0,45000,0,0,0,56000,11000,45000,45000
054490,臻鼎台新96購02  ,0,0,0,0,0,0,0,0,0,45000,0,0,0,45000,0,45000,45000
054160,華泰凱基98購01  ,0,0,0,0,0,0,0,0,0,45000,0,0,0,45000,0,45000,45000
053586,建準元大96購01  ,0,0,0,0,0,0,0,0,0,45000,0,0,0,45000,0,45000,45000
05366P,鴻海元富95售12  ,0,0,0,0,0,0,0,0,0,45000,0,0,0,98000,53000,45000,45000
053724,聯詠凱基96購04  ,0,0,0,0,0,0,0,0,0,45000,0,0,0,61000,16000,45000,45000
05384P,大立光永豐95售02,0,0,0,0,0,0,0,0,0,45000,0,0,0,45000,0,45000,45000
052977,奇力新麥證97購01,0,0,0,140000,95000,45000,0,0,0,45000,0,0,0,140000,95000,45000,45000
053562,玉晶光國泰98購02,0,0,0,0,0,0,0,0,0,45000,0,0,0,70000,25000,45000,45000
052808,矽力元大96購02  ,0,0,0,0,0,0,0,0,0,45000,0,0,0,50000,5000,45000,45000
052574,茂林凱基96購02  ,0,0,0,0,0,0,0,0,0,45000,0,0,0,105000,60000,45000,45000
044608,奇力新富邦93購01,0,0,0,0,0,0,0,0,0,45000,0,0,0,45000,0,45000,45000
047769,大立光元大96購01,0,0,0,0,0,0,0,0,0,45000,0,0,0,45000,0,45000,45000
045074,華新科元大93購03,0,0,0,0,0,0,0,0,0,45000,0,0,0,45000,0,45000,45000
045573,喬山元大92購01  ,0,0,0,0,0,0,0,0,0,45000,0,0,0,45000,0,45000,45000
046119,國泰金元大92購02,0,0,0,0,0,0,0,0,0,45000,0,0,0,45000,0,45000,45000
046867,瑞昱統一93購01  ,0,0,0,0,0,0,0,0,0,45000,0,0,0,65000,20000,45000,45000
046403,技嘉元大92購01  ,0,0,0,0,0,0,0,0,0,45000,0,0,0,115000,70000,45000,45000
048753,智伸科元富94購01,0,0,0,0,0,0,0,0,0,45000,0,0,0,45000,0,45000,45000
047614,台郡群益93購02  ,0,0,0,0,0,0,0,0,0,45000,0,0,0,151000,106000,45000,45000
051827,智邦元大95購04  ,0,0,0,0,0,0,0,0,0,45000,0,0,0,96000,51000,45000,45000
05192P,玉晶光台新96售02,0,0,0,0,0,0,0,0,0,45000,0,0,0,45000,0,45000,45000
052041,鴻海日盛95購02  ,0,0,0,0,0,0,0,0,0,45000,0,0,0,55000,10000,45000,45000
049597,泰鼎元大96購01  ,0,0,0,0,0,0,0,0,0,45000,0,0,0,58000,13000,45000,45000
050204,華新科群益94購05,0,0,0,0,0,0,0,0,0,45000,0,0,0,65000,20000,45000,45000
05918P,大立光元大96售11,0,0,0,0,0,0,0,0,0,45000,0,0,0,46000,1000,45000,45000
05972P,瑞昱元大96售01  ,0,0,0,0,0,0,0,0,0,45000,0,0,0,45000,0,45000,45000
052806,玉晶光元大98購04,0,0,0,0,0,0,0,0,0,44000,0,0,0,118000,74000,44000,44000
054090,瑞昱群益97購01  ,0,0,0,0,0,0,0,0,0,44000,0,0,0,55000,11000,44000,44000
044966,台表科中信94購01,0,0,0,0,0,0,0,0,0,44000,0,0,0,159000,115000,44000,44000
048284,臺股指中信95購04,0,0,0,0,0,0,0,0,0,44000,0,0,0,50000,6000,44000,44000
044698,奇力新元大93購01,0,0,0,0,0,0,0,0,0,44000,0,0,0,44000,0,44000,44000
045993,美律富邦93購01  ,0,0,0,0,0,0,0,0,0,44000,0,0,0,60000,16000,44000,44000
04703P,樺漢統一95售01  ,0,0,0,0,0,0,0,0,0,44000,0,0,0,73000,29000,44000,44000
050415,力成永豐94購01  ,0,0,0,0,0,0,0,0,0,44000,0,0,0,149000,105000,44000,44000
049810,欣興元大95購03  ,0,0,0,0,0,0,0,0,0,44000,0,0,0,44000,0,44000,44000
051691,台表科凱基95購01,0,0,0,0,0,0,0,0,0,44000,0,0,0,104000,60000,44000,44000
050915,健策中信98購01  ,0,0,0,0,0,0,0,0,0,44000,0,0,0,71000,27000,44000,44000
05122P,鴻海永昌96售06  ,0,0,0,0,0,0,0,0,0,44000,0,0,0,371000,327000,44000,44000
05118P,超眾元大96售04  ,0,0,0,0,0,0,0,0,0,44000,0,0,0,44000,0,44000,44000
051250,大立光元大98購01,0,0,0,0,0,0,0,0,0,44000,0,0,0,70000,26000,44000,44000
05853P,欣興群益96售05  ,0,0,0,0,0,0,0,0,0,44000,0,0,0,47000,3000,44000,44000
05762P,昇陽半永豐96售04,0,0,0,0,0,0,0,0,0,44000,0,0,0,137000,93000,44000,44000
05634P,玉晶光台新97售01,0,0,0,0,0,0,0,0,0,44000,0,0,0,84000,40000,44000,44000
2702,華園            ,75000,31000,44000,0,0,0,0,0,0,0,0,0,0,0,0,0,44000
2608,嘉里大榮        ,53000,9000,44000,0,0,0,0,0,0,0,0,0,0,0,0,0,44000
3308,聯德            ,46000,2000,44000,0,0,0,0,0,0,0,0,0,0,0,0,0,44000
6283,淳安            ,64000,19000,45000,0,0,0,0,0,0,-1000,0,1000,-1000,0,0,0,44000
6142,友勁            ,19000,0,19000,0,0,0,0,0,0,25000,25000,0,25000,0,0,0,44000
9927,泰銘            ,45000,1000,44000,0,0,0,0,0,0,0,0,0,0,0,0,0,44000
2912,統一超          ,355354,324320,31034,0,0,0,12000,0,12000,0,1000,0,1000,0,1000,-1000,43034
05391P,鴻海統一95售12  ,0,0,0,0,0,0,0,0,0,43000,0,0,0,53000,10000,43000,43000
054359,南亞科日盛96購02,0,0,0,0,0,0,0,0,0,43000,0,0,0,43000,0,43000,43000
052740,聯發科元大96購07,0,0,0,0,0,0,0,0,0,43000,0,0,0,123000,80000,43000,43000
052342,茂林凱基96購01  ,0,0,0,0,0,0,0,0,0,43000,0,0,0,49000,6000,43000,43000
053114,聯茂兆豐97購01  ,0,0,0,0,0,0,0,0,0,43000,0,0,0,63000,20000,43000,43000
03871P,智邦群益93售02  ,0,0,0,0,0,0,0,0,0,43000,0,0,0,43000,0,43000,43000
03553P,可成元富08售03  ,0,0,0,0,0,0,0,0,0,43000,0,0,0,43000,0,43000,43000
00664R,國泰臺灣加權反1 ,0,0,0,0,0,0,0,0,0,43000,0,0,0,723000,680000,43000,43000
04772P,欣興元大94售08  ,0,0,0,0,0,0,0,0,0,43000,0,0,0,57000,14000,43000,43000
045743,台郡群益93購01  ,0,0,0,0,0,0,0,0,0,43000,0,0,0,43000,0,43000,43000
044925,漢唐國泰93購01  ,0,0,0,0,0,0,0,0,0,43000,0,0,0,121000,78000,43000,43000
048070,聯發科元富99購03,0,0,0,0,0,0,0,0,0,43000,0,0,0,80000,37000,43000,43000
046022,國喬元大92購01  ,0,0,0,0,0,0,0,0,0,43000,0,0,0,86000,43000,43000,43000
047685,嘉聯益國泰95購01,0,0,0,0,0,0,0,0,0,43000,0,0,0,48000,5000,43000,43000
04913P,聯詠元富94售02  ,0,0,0,0,0,0,0,0,0,43000,0,0,0,53000,10000,43000,43000
049351,揚明光永豐94購01,0,0,0,0,0,0,0,0,0,43000,0,0,0,53000,10000,43000,43000
048864,昇陽半群益94購01,0,0,0,0,0,0,0,0,0,43000,0,0,0,43000,0,43000,43000
05094P,大立光元大95售07,0,0,0,0,0,0,0,0,0,43000,0,0,0,103000,60000,43000,43000
051758,瑞昱元大95購01  ,0,0,0,0,0,0,0,0,0,43000,0,0,0,255000,212000,43000,43000
051996,康友元大95購01  ,0,0,0,0,0,0,0,0,0,43000,0,0,0,289000,246000,43000,43000
050860,喬山永豐95購01  ,0,0,0,0,0,0,0,0,0,43000,0,0,0,43000,0,43000,43000
2498,宏達電          ,378000,380000,-2000,0,0,0,0,0,0,45000,2000,0,2000,51000,8000,43000,43000
05667P,旺宏台新96售01  ,0,0,0,0,0,0,0,0,0,43000,0,0,0,43000,0,43000,43000
05915P,聯發科元大96售19,0,0,0,0,0,0,0,0,0,43000,0,0,0,82000,39000,43000,43000
054285,國巨元大98購02  ,0,0,0,0,0,0,0,0,0,42000,0,0,0,60000,18000,42000,42000
054221,華新科統一96購05,0,0,0,0,0,0,0,0,0,42000,0,0,0,70000,28000,42000,42000
054117,宏全康和96購01  ,0,0,0,0,0,0,0,0,0,42000,0,0,0,42000,0,42000,42000
054154,智易國泰97購01  ,0,0,0,0,0,0,0,0,0,42000,0,0,0,70000,28000,42000,42000
046217,康友富邦94購01  ,0,0,0,0,0,0,0,0,0,42000,0,0,0,147000,105000,42000,42000
046319,新日興元大92購03,0,0,0,0,0,0,0,0,0,42000,0,0,0,52000,10000,42000,42000
048973,禾伸堂元大94購01,0,0,0,0,0,0,0,0,0,42000,0,0,0,110000,68000,42000,42000
047584,元金2X永豐95購01,0,0,0,0,0,0,0,0,0,42000,0,0,0,50000,8000,42000,42000
04929P,同欣電凱基95售01,0,0,0,0,0,0,0,0,0,42000,0,0,0,55000,13000,42000,42000
048642,聯發科元大94購02,0,0,0,0,0,0,0,0,0,42000,0,0,0,55000,13000,42000,42000
050327,泰鼎永豐94購03  ,0,0,0,0,0,0,0,0,0,42000,0,0,0,42000,0,42000,42000
051798,國巨永豐95購03  ,0,0,0,0,0,0,0,0,0,42000,0,0,0,48000,6000,42000,42000
051788,奇力新國票97購02,0,0,0,0,0,0,0,0,0,42000,0,0,0,59000,17000,42000,42000
051011,國巨凱基95購03  ,0,0,0,0,0,0,0,0,0,42000,0,0,0,42000,0,42000,42000
051215,大立光統一95購03,0,0,0,0,0,0,0,0,0,42000,0,0,0,337000,295000,42000,42000
05131P,聯詠統一97售01  ,0,0,0,0,0,0,0,0,0,42000,0,0,0,52000,10000,42000,42000
051361,泰鼎元大95購01  ,0,0,0,0,0,0,0,0,0,42000,0,0,0,42000,0,42000,42000
05848P,臺股指元大96售24,0,0,0,0,0,0,0,0,0,42000,0,0,0,42000,0,42000,42000
1453,大將            ,44000,2000,42000,0,0,0,0,0,0,0,0,0,0,0,0,0,42000
3094,聯傑            ,43000,1000,42000,0,0,0,0,0,0,0,0,0,0,0,0,0,42000
4438,廣越            ,37000,4000,33000,0,0,0,0,0,0,9000,10000,0,10000,1000,2000,-1000,42000
1582,信錦            ,120000,78992,41008,0,0,0,0,0,0,0,0,0,0,0,0,0,41008
054126,和大元大96購02  ,0,0,0,0,0,0,0,0,0,41000,0,0,0,375000,334000,41000,41000
054420,緯穎元大96購08  ,0,0,0,0,0,0,0,0,0,41000,0,0,0,64000,23000,41000,41000
05556P,全新國票96售04  ,0,0,0,0,0,0,0,0,0,41000,0,0,0,41000,0,41000,41000
053576,智原元富96購01  ,0,0,0,0,0,0,0,0,0,41000,0,0,0,111000,70000,41000,41000
052648,茂林永豐96購01  ,0,0,0,0,0,0,0,0,0,41000,0,0,0,41000,0,41000,41000
04557P,茂林群益94售03  ,0,0,0,0,0,0,0,0,0,41000,0,0,0,116000,75000,41000,41000
00641R,富邦日本反1     ,0,0,0,0,0,0,0,0,0,41000,0,0,0,158000,117000,41000,41000
03146P,台灣50群益03售01,0,0,0,0,0,0,0,0,0,41000,0,0,0,41000,0,41000,41000
03982P,智易國票94售02  ,0,0,0,0,0,0,0,0,0,41000,0,0,0,41000,0,41000,41000
04339P,欣興元大93售08  ,0,0,0,0,0,0,0,0,0,41000,0,0,0,69000,28000,41000,41000
04684P,欣興元大94售07  ,0,0,0,0,0,0,0,0,0,41000,0,0,0,135000,94000,41000,41000
049028,麗豐群益94購01  ,0,0,0,0,0,0,0,0,0,41000,0,0,0,71000,30000,41000,41000
047188,聯詠元大93購04  ,0,0,0,0,0,0,0,0,0,41000,0,0,0,52000,11000,41000,41000
051175,國巨凱基95購04  ,0,0,0,0,0,0,0,0,0,41000,0,0,0,119000,78000,41000,41000
050395,大立光元富94購10,0,0,0,0,0,0,0,0,0,41000,0,0,0,144000,103000,41000,41000
050671,超眾永豐94購04  ,0,0,0,0,0,0,0,0,0,41000,0,0,0,55000,14000,41000,41000
050698,明泰凱基96購01  ,0,0,0,0,0,0,0,0,0,41000,0,0,0,51000,10000,41000,41000
3209,全科            ,62000,21000,41000,0,0,0,0,0,0,0,0,0,0,0,0,0,41000
6192,巨路            ,60000,19000,41000,0,0,0,0,0,0,0,0,0,0,0,0,0,41000
05272P,臻鼎中信97售03  ,0,0,0,0,0,0,0,0,0,40000,0,0,0,40000,0,40000,40000
052822,泰碩永豐97購01  ,0,0,0,0,0,0,0,0,0,40000,0,0,0,40000,0,40000,40000
052864,奇力新凱基96購02,0,0,0,0,0,0,0,0,0,40000,0,0,0,60000,20000,40000,40000
052231,景碩凱基96購01  ,0,0,0,0,0,0,0,0,0,40000,0,0,0,40000,0,40000,40000
053342,全新國票99購01  ,0,0,0,0,0,0,0,0,0,40000,0,0,0,60000,20000,40000,40000
052949,智易國票97購02  ,0,0,0,0,0,0,0,0,0,40000,0,0,0,40000,0,40000,40000
052950,超眾國票98購01  ,0,0,0,0,0,0,0,0,0,40000,0,0,0,48000,8000,40000,40000
05458P,台積電凱基97售02,0,0,0,0,0,0,0,0,0,40000,0,0,0,40000,0,40000,40000
054473,鴻海中信96購02  ,0,0,0,0,0,0,0,0,0,40000,0,0,0,48000,8000,40000,40000
054442,啟碁台新96購01  ,0,0,0,0,0,0,0,0,0,40000,0,0,0,60000,20000,40000,40000
054200,美律富邦97購02  ,0,0,0,0,0,0,0,0,0,40000,0,0,0,98000,58000,40000,40000
054281,世芯群益97購01  ,0,0,0,0,0,0,0,0,0,40000,0,0,0,100000,60000,40000,40000
054142,致伸元大97購01  ,0,0,0,0,0,0,0,0,0,40000,0,0,0,40000,0,40000,40000
053588,聯發科元大97購07,0,0,0,0,0,0,0,0,0,40000,0,0,0,61000,21000,40000,40000
04435P,台積電中信95售07,0,0,0,0,0,0,0,0,0,40000,0,0,0,40000,0,40000,40000
044641,上証2X國票93購02,0,0,0,0,0,0,0,0,0,40000,0,0,0,50000,10000,40000,40000
044437,台郡元大92購02  ,0,0,0,0,0,0,0,0,0,40000,0,0,0,52000,12000,40000,40000
04452P,超眾國泰95售01  ,0,0,0,0,0,0,0,0,0,40000,0,0,0,40000,0,40000,40000
043063,台郡中信92購01  ,0,0,0,0,0,0,0,0,0,40000,0,0,0,40000,0,40000,40000
041981,可成兆豐91購01  ,0,0,0,0,0,0,0,0,0,40000,0,0,0,50000,10000,40000,40000
041908,可成元大92購01  ,0,0,0,0,0,0,0,0,0,40000,0,0,0,40000,0,40000,40000
042168,台灣50凱基96購01,0,0,0,0,0,0,0,0,0,40000,0,0,0,60000,20000,40000,40000
03896P,長榮航凱基95售01,0,0,0,0,0,0,0,0,0,40000,0,0,0,50000,10000,40000,40000
04052P,上銀國泰94售01  ,0,0,0,0,0,0,0,0,0,40000,0,0,0,40000,0,40000,40000
04060P,臺股指群益93售14,0,0,0,0,0,0,0,0,0,40000,0,0,0,40000,0,40000,40000
03026P,國巨元大01售13  ,0,0,0,0,0,0,0,0,0,40000,0,0,0,40000,0,40000,40000
03416B,臺股指凱基95熊05,0,0,0,0,0,0,0,0,0,40000,0,0,0,65000,25000,40000,40000
03349P,台灣50麥證02售04,0,0,0,0,0,0,0,0,0,40000,0,0,0,40000,0,40000,40000
03069P,大毅群益01售04  ,0,0,0,0,0,0,0,0,0,40000,0,0,0,40000,0,40000,40000
03070P,台表科群益01售04,0,0,0,0,0,0,0,0,0,40000,0,0,0,40000,0,40000,40000
03807P,康友元富93售02  ,0,0,0,0,0,0,0,0,0,40000,0,0,0,40000,0,40000,40000
03563P,台灣50群益02售14,0,0,0,0,0,0,0,0,0,40000,0,0,0,40000,0,40000,40000
03580P,玉晶光永豐02售06,0,0,0,0,0,0,0,0,0,40000,0,0,0,40000,0,40000,40000
045584,奇鋐元大93購03  ,0,0,0,0,0,0,0,0,0,40000,0,0,0,40000,0,40000,40000
045261,華新科凱基92購01,0,0,0,0,0,0,0,0,0,40000,0,0,0,50000,10000,40000,40000
045307,群創元大93購04  ,0,0,0,0,0,0,0,0,0,40000,0,0,0,49000,9000,40000,40000
044959,彩晶凱基92購01  ,0,0,0,0,0,0,0,0,0,40000,0,0,0,40000,0,40000,40000
045072,可成元大92購05  ,0,0,0,0,0,0,0,0,0,40000,0,0,0,127000,87000,40000,40000
045041,康舒日盛92購01  ,0,0,0,0,0,0,0,0,0,40000,0,0,0,40000,0,40000,40000
04500P,燿華統一94售01  ,0,0,0,0,0,0,0,0,0,40000,0,0,0,144000,104000,40000,40000
044972,元金2X國票96購01,0,0,0,0,0,0,0,0,0,40000,0,0,0,55000,15000,40000,40000
048231,台表科凱基93購06,0,0,0,0,0,0,0,0,0,40000,0,0,0,98000,58000,40000,40000
045776,可成元大92購07  ,0,0,0,0,0,0,0,0,0,40000,0,0,0,50000,10000,40000,40000
04775P,台積電凱基94售29,0,0,0,0,0,0,0,0,0,40000,0,0,0,50000,10000,40000,40000
047733,友達兆豐95購01  ,0,0,0,0,0,0,0,0,0,40000,0,0,0,40000,0,40000,40000
04383P,泰鼎國泰95售01  ,0,0,0,0,0,0,0,0,0,40000,0,0,0,40000,0,40000,40000
04421P,玉晶光永豐94售02,0,0,0,0,0,0,0,0,0,40000,0,0,0,70000,30000,40000,40000
048808,美律亞東94購01  ,0,0,0,0,0,0,0,0,0,40000,0,0,0,40000,0,40000,40000
048843,台郡凱基94購01  ,0,0,0,0,0,0,0,0,0,40000,0,0,0,40000,0,40000,40000
047682,滬深2X國泰94購02,0,0,0,0,0,0,0,0,0,40000,0,0,0,40000,0,40000,40000
047592,長華永豐93購01  ,0,0,0,0,0,0,0,0,0,40000,0,0,0,40000,0,40000,40000
04728P,美律亞東94售02  ,0,0,0,0,0,0,0,0,0,40000,0,0,0,60000,20000,40000,40000
046854,可成元大93購04  ,0,0,0,0,0,0,0,0,0,40000,0,0,0,50000,10000,40000,40000
046862,台郡元大94購01  ,0,0,0,0,0,0,0,0,0,40000,0,0,0,71000,31000,40000,40000
046803,可成元大93購03  ,0,0,0,0,0,0,0,0,0,40000,0,0,0,50000,10000,40000,40000
046775,聯發科台新93購01,0,0,0,0,0,0,0,0,0,40000,0,0,0,40000,0,40000,40000
046110,中環元大92購01  ,0,0,0,0,0,0,0,0,0,40000,0,0,0,40000,0,40000,40000
046074,佐登凱基92購01  ,0,0,0,0,0,0,0,0,0,40000,0,0,0,150000,110000,40000,40000
047362,奇力新群益93購03,0,0,0,0,0,0,0,0,0,40000,0,0,0,40000,0,40000,40000
046180,裕隆凱基93購01  ,0,0,0,0,0,0,0,0,0,40000,0,0,0,50000,10000,40000,40000
048366,深中小統一93購02,0,0,0,0,0,0,0,0,0,40000,0,0,0,40000,0,40000,40000
048415,深中小統一93購03,0,0,0,0,0,0,0,0,0,40000,0,0,0,40000,0,40000,40000
048411,嘉聯益群益93購02,0,0,0,0,0,0,0,0,0,40000,0,0,0,40000,0,40000,40000
046725,可成元大93購02  ,0,0,0,0,0,0,0,0,0,40000,0,0,0,50000,10000,40000,40000
046584,可成元大92購11  ,0,0,0,0,0,0,0,0,0,40000,0,0,0,50000,10000,40000,40000
050814,微星凱基95購01  ,0,0,0,0,0,0,0,0,0,40000,0,0,0,40000,0,40000,40000
050830,嘉聯益凱基95購01,0,0,0,0,0,0,0,0,0,40000,0,0,0,40000,0,40000,40000
050373,奇鋐元大94購04  ,0,0,0,0,0,0,0,0,0,40000,0,0,0,40000,0,40000,40000
049843,康友中信95購01  ,0,0,0,0,0,0,0,0,0,40000,0,0,0,91000,51000,40000,40000
049558,深中小統一94購04,0,0,0,0,0,0,0,0,0,40000,0,0,0,40000,0,40000,40000
051203,微星麥證95購01  ,0,0,0,40000,0,40000,0,0,0,40000,0,0,0,40000,0,40000,40000
051117,臺指反群益95購02,0,0,0,0,0,0,0,0,0,40000,0,0,0,40000,0,40000,40000
051386,富邦金麥證96購01,0,0,0,40000,0,40000,0,0,0,40000,0,0,0,40000,0,40000,40000
051257,光寶科國泰96購01,0,0,0,0,0,0,0,0,0,40000,0,0,0,40000,0,40000,40000
051294,鴻海元富95購06  ,0,0,0,0,0,0,0,0,0,40000,0,0,0,49000,9000,40000,40000
051784,國巨兆豐95購01  ,0,0,0,0,0,0,0,0,0,40000,0,0,0,40000,0,40000,40000
052068,瑞儀兆豐96購01  ,0,0,0,0,0,0,0,0,0,40000,0,0,0,43000,3000,40000,40000
05213P,台積電國票96售05,0,0,0,0,0,0,0,0,0,40000,0,0,0,40000,0,40000,40000
052154,緯創台新95購01  ,0,0,0,0,0,0,0,0,0,40000,0,0,0,60000,20000,40000,40000
5264,鎧勝-KY         ,231000,177000,54000,0,0,0,0,0,0,-14000,0,0,0,15000,29000,-14000,40000
06026P,華通台新97售01  ,0,0,0,0,0,0,0,0,0,40000,0,0,0,117000,77000,40000,40000
06067P,華新科康和97售01,0,0,0,0,0,0,0,0,0,40000,0,0,0,70000,30000,40000,40000
05903P,聯發科統一96售09,0,0,0,0,0,0,0,0,0,40000,0,0,0,58000,18000,40000,40000
05581P,華新科凱基96售07,0,0,0,0,0,0,0,0,0,40000,0,0,0,40000,0,40000,40000
054151,瑞昱國泰97購01  ,0,0,0,0,0,0,0,0,0,39000,0,0,0,39000,0,39000,39000
052369,矽力國票96購02  ,0,0,0,0,0,0,0,0,0,39000,0,0,0,41000,2000,39000,39000
052538,和大統一95購02  ,0,0,0,0,0,0,0,0,0,39000,0,0,0,178000,139000,39000,39000
05246P,南電元大95售04  ,0,0,0,0,0,0,0,0,0,39000,0,0,0,175000,136000,39000,39000
04428P,台光電元大94售02,0,0,0,0,0,0,0,0,0,39000,0,0,0,100000,61000,39000,39000
044149,TPK群益92購01   ,0,0,0,0,0,0,0,0,0,39000,0,0,0,50000,11000,39000,39000
048379,台郡元富96購01  ,0,0,0,0,0,0,0,0,0,39000,0,0,0,46000,7000,39000,39000
045955,宏碁凱基93購01  ,0,0,0,0,0,0,0,0,0,39000,0,0,0,59000,20000,39000,39000
046860,致伸元大93購02  ,0,0,0,0,0,0,0,0,0,39000,0,0,0,45000,6000,39000,39000
048805,瀚宇博富邦95購01,0,0,0,0,0,0,0,0,0,39000,0,0,0,39000,0,39000,39000
048739,華新科統一94購02,0,0,0,0,0,0,0,0,0,39000,0,0,0,49000,10000,39000,39000
048786,瑞昱元大94購02  ,0,0,0,0,0,0,0,0,0,39000,0,0,0,63000,24000,39000,39000
05202P,鴻海元大95售16  ,0,0,0,0,0,0,0,0,0,39000,0,0,0,109000,70000,39000,39000
051390,京元電兆豐95購01,0,0,0,0,0,0,0,0,0,39000,0,0,0,133000,94000,39000,39000
051374,國泰金亞東95購01,0,0,0,0,0,0,0,0,0,39000,0,0,0,55000,16000,39000,39000
051123,和鑫群益95購01  ,0,0,0,0,0,0,0,0,0,39000,0,0,0,187000,148000,39000,39000
05731P,創意統一96售03  ,0,0,0,0,0,0,0,0,0,39000,0,0,0,97000,58000,39000,39000
06005P,晶豪科永豐96售04,0,0,0,0,0,0,0,0,0,39000,0,0,0,39000,0,39000,39000
3494,誠研            ,40000,1000,39000,0,0,0,0,0,0,0,0,0,0,0,0,0,39000
2539,櫻花建          ,39000,0,39000,0,0,0,0,0,0,0,0,0,0,0,0,0,39000
2109,華豐            ,39000,0,39000,0,0,0,0,0,0,0,0,0,0,0,0,0,39000
052496,華通台新96購02  ,0,0,0,0,0,0,0,0,0,38000,0,0,0,38000,0,38000,38000
052447,聯發科元大96購04,0,0,0,0,0,0,0,0,0,38000,0,0,0,69000,31000,38000,38000
052547,光磊兆豐96購01  ,0,0,0,0,0,0,0,0,0,38000,0,0,0,38000,0,38000,38000
052920,景碩台新96購02  ,0,0,0,0,0,0,0,0,0,38000,0,0,0,38000,0,38000,38000
052628,樺漢中信96購01  ,0,0,0,0,0,0,0,0,0,38000,0,0,0,80000,42000,38000,38000
053085,華新科元大97購04,0,0,0,0,0,0,0,0,0,38000,0,0,0,59000,21000,38000,38000
053238,麗豐永豐96購01  ,0,0,0,0,0,0,0,0,0,38000,0,0,0,75000,37000,38000,38000
053323,群創群益98購07  ,0,0,0,0,0,0,0,0,0,38000,0,0,0,98000,60000,38000,38000
053436,聯茂日盛96購01  ,0,0,0,0,0,0,0,0,0,38000,0,0,0,48000,10000,38000,38000
053952,南亞科台新96購01,0,0,0,0,0,0,0,0,0,38000,0,0,0,38000,0,38000,38000
053855,康友國泰98購01  ,0,0,0,0,0,0,0,0,0,38000,0,0,0,335000,297000,38000,38000
054323,旺宏台新96購02  ,0,0,0,0,0,0,0,0,0,38000,0,0,0,140000,102000,38000,38000
043660,華新科元大93購01,0,0,0,0,0,0,0,0,0,38000,0,0,0,61000,23000,38000,38000
044820,臻鼎兆豐93購02  ,0,0,0,0,0,0,0,0,0,38000,0,0,0,38000,0,38000,38000
044821,瑞儀兆豐93購03  ,0,0,0,0,0,0,0,0,0,38000,0,0,0,38000,0,38000,38000
044516,景碩凱基93購02  ,0,0,0,0,0,0,0,0,0,38000,0,0,0,65000,27000,38000,38000
047087,亞泥元富93購01  ,0,0,0,0,0,0,0,0,0,38000,0,0,0,130000,92000,38000,38000
046105,同欣電永豐92購02,0,0,0,0,0,0,0,0,0,38000,0,0,0,78000,40000,38000,38000
046975,元金2X永豐93購01,0,0,0,0,0,0,0,0,0,38000,0,0,0,38000,0,38000,38000
051738,全新國票96購02  ,0,0,0,0,0,0,0,0,0,38000,0,0,0,58000,20000,38000,38000
049559,香港反統一94購02,0,0,0,0,0,0,0,0,0,38000,0,0,0,40000,2000,38000,38000
050188,貿聯元大96購01  ,0,0,0,0,0,0,0,0,0,38000,0,0,0,226000,188000,38000,38000
050400,臻鼎中信97購01  ,0,0,0,0,0,0,0,0,0,38000,0,0,0,254000,216000,38000,38000
050458,台郡元大94購03  ,0,0,0,0,0,0,0,0,0,38000,0,0,0,53000,15000,38000,38000
2204,中華            ,122000,85000,37000,0,0,0,1000,0,1000,0,0,0,0,0,0,0,38000
2017,官田鋼          ,38000,0,38000,0,0,0,0,0,0,0,0,0,0,0,0,0,38000
2923,鼎固-KY         ,38000,0,38000,0,0,0,0,0,0,0,0,0,0,0,0,0,38000
05971P,世紀鋼永豐96售04,0,0,0,0,0,0,0,0,0,38000,0,0,0,59000,21000,38000,38000
1203,味王            ,38000,0,38000,0,0,0,0,0,0,0,0,0,0,0,0,0,38000
05699P,茂林凱基96售05  ,0,0,0,0,0,0,0,0,0,38000,0,0,0,38000,0,38000,38000
053642,瀚宇博永豐96購01,0,0,0,0,0,0,0,0,0,37000,0,0,0,37000,0,37000,37000
05414P,台表科國票96售02,0,0,0,0,0,0,0,0,0,37000,0,0,0,47000,10000,37000,37000
053027,玉晶光富邦98購01,0,0,0,0,0,0,0,0,0,37000,0,0,0,40000,3000,37000,37000
052946,智原國票97購02  ,0,0,0,0,0,0,0,0,0,37000,0,0,0,42000,5000,37000,37000
052714,義隆凱基96購02  ,0,0,0,0,0,0,0,0,0,37000,0,0,0,150000,113000,37000,37000
052892,大成鋼群益96購01,0,0,0,0,0,0,0,0,0,37000,0,0,0,113000,76000,37000,37000
052254,康友永豐95購03  ,0,0,0,0,0,0,0,0,0,37000,0,0,0,158000,121000,37000,37000
04310P,京元電統一93售03,0,0,0,0,0,0,0,0,0,37000,0,0,0,77000,40000,37000,37000
03722P,華通元大93售04  ,0,0,0,0,0,0,0,0,0,37000,0,0,0,87000,50000,37000,37000
047042,佐登群益93購01  ,0,0,0,0,0,0,0,0,0,37000,0,0,0,250000,213000,37000,37000
046893,華新科群益94購01,0,0,0,0,0,0,0,0,0,37000,0,0,0,37000,0,37000,37000
046438,群創群益95購01  ,0,0,0,0,0,0,0,0,0,37000,0,0,0,133000,96000,37000,37000
047288,台郡統一93購01  ,0,0,0,0,0,0,0,0,0,37000,0,0,0,62000,25000,37000,37000
047612,瑞昱群益93購03  ,0,0,0,0,0,0,0,0,0,37000,0,0,0,77000,40000,37000,37000
049149,華新科元大95購03,0,0,0,0,0,0,0,0,0,37000,0,0,0,48000,11000,37000,37000
049882,康控永豐94購01  ,0,0,0,0,0,0,0,0,0,37000,0,0,0,37000,0,37000,37000
052016,神基永豐95購01  ,0,0,0,0,0,0,0,0,0,37000,0,0,0,37000,0,37000,37000
051939,同欣電群益97購01,0,0,0,0,0,0,0,0,0,37000,0,0,0,67000,30000,37000,37000
051970,元黃金凱基98購01,0,0,0,0,0,0,0,0,0,37000,0,0,0,60000,23000,37000,37000
050987,台泥富邦95購01  ,0,0,0,0,0,0,0,0,0,37000,0,0,0,57000,20000,37000,37000
05934P,國巨凱基96售13  ,0,0,0,0,0,0,0,0,0,37000,0,0,0,37000,0,37000,37000
1507,永大            ,45000,9000,36000,0,0,0,0,0,0,1000,1000,0,1000,0,0,0,37000
06037P,超眾國票98售02  ,0,0,0,0,0,0,0,0,0,37000,0,0,0,73000,36000,37000,37000
1713,國化            ,37000,0,37000,0,0,0,0,0,0,0,0,0,0,0,0,0,37000
052577,台積電統一96購01,0,0,0,0,0,0,0,0,0,36000,0,0,0,72000,36000,36000,36000
052444,友訊元大95購01  ,0,0,0,0,0,0,0,0,0,36000,0,0,0,42000,6000,36000,36000
052746,泰碩元大97購01  ,0,0,0,0,0,0,0,0,0,36000,0,0,0,56000,20000,36000,36000
053132,國巨國票97購02  ,0,0,0,0,0,0,0,0,0,36000,0,0,0,59000,23000,36000,36000
00706L,元大S&P日圓正2  ,0,0,0,0,0,0,0,0,0,36000,0,0,0,49000,13000,36000,36000
03824P,燿華元大94售01  ,0,0,0,0,0,0,0,0,0,36000,0,0,0,236000,200000,36000,36000
04132P,瑞昱群益93售04  ,0,0,0,0,0,0,0,0,0,36000,0,0,0,36000,0,36000,36000
044466,和大群益93購01  ,0,0,0,0,0,0,0,0,0,36000,0,0,0,274000,238000,36000,36000
045172,欣興兆豐94購01  ,0,0,0,0,0,0,0,0,0,36000,0,0,0,96000,60000,36000,36000
045280,儒鴻富邦94購01  ,0,0,0,0,0,0,0,0,0,36000,0,0,0,337000,301000,36000,36000
045798,華邦電亞東93購02,0,0,0,0,0,0,0,0,0,36000,0,0,0,36000,0,36000,36000
04907P,超眾國票95售01  ,0,0,0,0,0,0,0,0,0,36000,0,0,0,111000,75000,36000,36000
048935,玉晶光永豐94購04,0,0,0,0,0,0,0,0,0,36000,0,0,0,63000,27000,36000,36000
048619,台表科凱基93購07,0,0,0,0,0,0,0,0,0,36000,0,0,0,36000,0,36000,36000
046476,鴻海統一96購01  ,0,0,0,0,0,0,0,0,0,36000,0,0,0,59000,23000,36000,36000
046980,智邦兆豐94購01  ,0,0,0,0,0,0,0,0,0,36000,0,0,0,36000,0,36000,36000
051978,泰碩凱基96購01  ,0,0,0,0,0,0,0,0,0,36000,0,0,0,46000,10000,36000,36000
05206P,南茂元大95售01  ,0,0,0,0,0,0,0,0,0,36000,0,0,0,39000,3000,36000,36000
051780,矽力群益95購01  ,0,0,0,0,0,0,0,0,0,36000,0,0,0,98000,62000,36000,36000
050088,禾伸堂台新94購01,0,0,0,0,0,0,0,0,0,36000,0,0,0,145000,109000,36000,36000
050515,聯電元大96購01  ,0,0,0,0,0,0,0,0,0,36000,0,0,0,36000,0,36000,36000
2444,兆勁            ,133000,97000,36000,0,0,0,0,0,0,0,0,0,0,0,0,0,36000
2908,特力            ,44000,8000,36000,0,0,0,0,0,0,0,0,0,0,0,0,0,36000
1526,日馳            ,79000,43000,36000,0,0,0,0,0,0,0,0,0,0,0,0,0,36000
8011,台通            ,46000,10000,36000,0,0,0,0,0,0,0,0,0,0,0,0,0,36000
9937,全國            ,36000,0,36000,0,0,0,0,0,0,0,0,0,0,0,0,0,36000
052667,漢唐群益96購01  ,0,0,0,0,0,0,0,0,0,35000,0,0,0,129000,94000,35000,35000
052405,聯茂凱基95購01  ,0,0,0,0,0,0,0,0,0,35000,0,0,0,35000,0,35000,35000
053811,國巨群益98購02  ,0,0,0,0,0,0,0,0,0,35000,0,0,0,36000,1000,35000,35000
053788,泰鼎元大97購01  ,0,0,0,0,0,0,0,0,0,35000,0,0,0,100000,65000,35000,35000
046334,緯穎元大92購05  ,0,0,0,0,0,0,0,0,0,35000,0,0,0,35000,0,35000,35000
045363,台達電兆豐92購01,0,0,0,0,0,0,0,0,0,35000,0,0,0,35000,0,35000,35000
045566,南寶國泰93購01  ,0,0,0,0,0,0,0,0,0,35000,0,0,0,35000,0,35000,35000
045108,康友群益93購02  ,0,0,0,0,0,0,0,0,0,35000,0,0,0,35000,0,35000,35000
044980,台光電國票92購01,0,0,0,0,0,0,0,0,0,35000,0,0,0,85000,50000,35000,35000
041816,元油2X凱基92購01,0,0,0,0,0,0,0,0,0,35000,0,0,0,45000,10000,35000,35000
040197,晶電群益92購01  ,0,0,0,0,0,0,0,0,0,35000,0,0,0,35000,0,35000,35000
03892P,元油2X中信95售01,0,0,0,0,0,0,0,0,0,35000,0,0,0,400000,365000,35000,35000
00686R,群益臺灣加權反1 ,0,0,0,0,0,0,0,0,0,35000,0,0,0,49000,14000,35000,35000
00752,中信中國50      ,0,0,0,0,0,0,0,0,0,35000,0,0,0,371000,336000,35000,35000
046068,國泰金凱基92購02,0,0,0,0,0,0,0,0,0,35000,0,0,0,74000,39000,35000,35000
045882,滬深2X元大95購01,0,0,0,0,0,0,0,0,0,35000,0,0,0,35000,0,35000,35000
046568,臻鼎元富95購01  ,0,0,0,0,0,0,0,0,0,35000,0,0,0,204000,169000,35000,35000
047882,超眾國泰94購01  ,0,0,0,0,0,0,0,0,0,35000,0,0,0,35000,0,35000,35000
046412,潤泰全元大92購02,0,0,0,0,0,0,0,0,0,35000,0,0,0,35000,0,35000,35000
047213,新日興富邦97購01,0,0,0,0,0,0,0,0,0,35000,0,0,0,43000,8000,35000,35000
048983,牧德元大95購01  ,0,0,0,0,0,0,0,0,0,35000,0,0,0,78000,43000,35000,35000
049926,智易元大95購02  ,0,0,0,0,0,0,0,0,0,35000,0,0,0,62000,27000,35000,35000
050502,聯發科凱基94購21,0,0,0,0,0,0,0,0,0,35000,0,0,0,68000,33000,35000,35000
050236,旺宏凱基94購06  ,0,0,0,0,0,0,0,0,0,35000,0,0,0,54000,19000,35000,35000
050622,昇陽半元大94購05,0,0,0,0,0,0,0,0,0,35000,0,0,0,55000,20000,35000,35000
050097,可成國泰96購02  ,0,0,0,0,0,0,0,0,0,35000,0,0,0,390000,355000,35000,35000
050125,中環凱基94購01  ,0,0,0,0,0,0,0,0,0,35000,0,0,0,50000,15000,35000,35000
051594,和碩元大96購01  ,0,0,0,0,0,0,0,0,0,35000,0,0,0,40000,5000,35000,35000
052173,廣達元大95購02  ,0,0,0,0,0,0,0,0,0,35000,0,0,0,41000,6000,35000,35000
051073,同欣電國票96購01,0,0,0,0,0,0,0,0,0,35000,0,0,0,35000,0,35000,35000
05147P,鴻海元大95售11  ,0,0,0,0,0,0,0,0,0,35000,0,0,0,255000,220000,35000,35000
1219,福壽            ,35000,0,35000,0,0,0,0,0,0,0,0,0,0,0,0,0,35000
06036P,台表科凱基96售04,0,0,0,0,0,0,0,0,0,35000,0,0,0,35000,0,35000,35000
06072P,牧德永豐97售01  ,0,0,0,0,0,0,0,0,0,35000,0,0,0,50000,15000,35000,35000
3645,達邁            ,97000,84000,13000,0,0,0,0,0,0,22000,30000,0,30000,0,8000,-8000,35000
1714,和桐            ,134000,99000,35000,0,0,0,0,0,0,0,0,0,0,0,0,0,35000
2034,允強            ,41000,6839,34161,0,0,0,0,0,0,0,0,0,0,0,0,0,34161
054098,嘉晶國票97購04  ,0,0,0,0,0,0,0,0,0,34000,0,0,0,34000,0,34000,34000
05431P,台光電統一97售01,0,0,0,0,0,0,0,0,0,34000,0,0,0,40000,6000,34000,34000
053216,京鼎凱基96購02  ,0,0,0,0,0,0,0,0,0,34000,0,0,0,49000,15000,34000,34000
04174P,上銀群益93售06  ,0,0,0,0,0,0,0,0,0,34000,0,0,0,34000,0,34000,34000
049155,同欣電元大94購01,0,0,0,0,0,0,0,0,0,34000,0,0,0,35000,1000,34000,34000
046085,儒鴻麥證92購01  ,0,0,0,54000,20000,34000,0,0,0,34000,0,0,0,54000,20000,34000,34000
051556,台表科永豐96購01,0,0,0,0,0,0,0,0,0,34000,0,0,0,44000,10000,34000,34000
05104P,智邦台新95售02  ,0,0,0,0,0,0,0,0,0,34000,0,0,0,68000,34000,34000,34000
050135,禾伸堂兆豐95購01,0,0,0,0,0,0,0,0,0,34000,0,0,0,112000,78000,34000,34000
050768,聯發科元大94購16,0,0,0,0,0,0,0,0,0,34000,0,0,0,47000,13000,34000,34000
2443,億麗            ,34000,0,34000,0,0,0,0,0,0,0,0,0,0,0,0,0,34000
3518,柏騰            ,212000,178000,34000,0,0,0,0,0,0,0,0,0,0,0,0,0,34000
3015,全漢            ,53000,19000,34000,0,0,0,0,0,0,0,0,0,0,0,0,0,34000
06044P,同欣電永豐96售03,0,0,0,0,0,0,0,0,0,34000,0,0,0,46000,12000,34000,34000
1416,廣豐            ,34000,0,34000,0,0,0,0,0,0,0,0,0,0,0,0,0,34000
05591P,義隆群益96售03  ,0,0,0,0,0,0,0,0,0,34000,0,0,0,34000,0,34000,34000
053078,昇陽半永豐97購02,0,0,0,0,0,0,0,0,0,33000,0,0,0,33000,0,33000,33000
05259P,臺股指凱基96售12,0,0,0,0,0,0,0,0,0,33000,0,0,0,43000,10000,33000,33000
054435,華新科台新97購02,0,0,0,0,0,0,0,0,0,33000,0,0,0,48000,15000,33000,33000
054194,國巨麥證96購02  ,0,0,0,43000,10000,33000,0,0,0,33000,0,0,0,43000,10000,33000,33000
044941,鴻海群益93購01  ,0,0,0,0,0,0,0,0,0,33000,0,0,0,58000,25000,33000,33000
045374,鴻海元大92購07  ,0,0,0,0,0,0,0,0,0,33000,0,0,0,33000,0,33000,33000
045415,聯茂群益92購02  ,0,0,0,0,0,0,0,0,0,33000,0,0,0,33000,0,33000,33000
045704,微星日盛92購01  ,0,0,0,0,0,0,0,0,0,33000,0,0,0,33000,0,33000,33000
046875,康友元富93購01  ,0,0,0,0,0,0,0,0,0,33000,0,0,0,42000,9000,33000,33000
048047,全新永豐93購02  ,0,0,0,0,0,0,0,0,0,33000,0,0,0,63000,30000,33000,33000
046933,台泥元富93購01  ,0,0,0,0,0,0,0,0,0,33000,0,0,0,33000,0,33000,33000
046653,鴻海元大93購05  ,0,0,0,0,0,0,0,0,0,33000,0,0,0,47000,14000,33000,33000
049151,大立光元大94購07,0,0,0,0,0,0,0,0,0,33000,0,0,0,72000,39000,33000,33000
049046,同欣電兆豐94購01,0,0,0,0,0,0,0,0,0,33000,0,0,0,61000,28000,33000,33000
049265,揚明光元大94購03,0,0,0,0,0,0,0,0,0,33000,0,0,0,50000,17000,33000,33000
050225,亞泥中信94購01  ,0,0,0,0,0,0,0,0,0,33000,0,0,0,33000,0,33000,33000
050549,慧洋凱基95購01  ,0,0,0,0,0,0,0,0,0,33000,0,0,0,33000,0,33000,33000
051526,超眾凱基95購02  ,0,0,0,0,0,0,0,0,0,33000,0,0,0,33000,0,33000,33000
052107,台積電統一95購06,0,0,0,0,0,0,0,0,0,33000,0,0,0,169000,136000,33000,33000
05862P,大立光國泰98售01,0,0,0,0,0,0,0,0,0,33000,0,0,0,226000,193000,33000,33000
05826P,臺股指凱基96售23,0,0,0,0,0,0,0,0,0,33000,0,0,0,43000,10000,33000,33000
08911P,力成凱基01售01  ,0,0,0,0,0,0,0,0,0,33000,0,0,0,33000,0,33000,33000
053969,瑞昱元大97購01  ,0,0,0,0,0,0,0,0,0,32000,0,0,0,93000,61000,32000,32000
053685,台積電元大96購18,0,0,0,0,0,0,0,0,0,32000,0,0,0,299000,267000,32000,32000
054322,國巨台新96購02  ,0,0,0,0,0,0,0,0,0,32000,0,0,0,77000,45000,32000,32000
052818,智邦永豐96購01  ,0,0,0,0,0,0,0,0,0,32000,0,0,0,42000,10000,32000,32000
052437,聯發科富邦99購02,0,0,0,0,0,0,0,0,0,32000,0,0,0,96000,64000,32000,32000
053088,奇鋐元大98購01  ,0,0,0,0,0,0,0,0,0,32000,0,0,0,60000,28000,32000,32000
053355,超眾兆豐97購01  ,0,0,0,0,0,0,0,0,0,32000,0,0,0,50000,18000,32000,32000
047749,富邦金元富93購01,0,0,0,0,0,0,0,0,0,32000,0,0,0,40000,8000,32000,32000
045182,瑞昱統一92購05  ,0,0,0,0,0,0,0,0,0,32000,0,0,0,37000,5000,32000,32000
045059,同欣電國泰93購01,0,0,0,0,0,0,0,0,0,32000,0,0,0,172000,140000,32000,32000
042560,康控兆豐92購01  ,0,0,0,0,0,0,0,0,0,32000,0,0,0,32000,0,32000,32000
04362P,聯詠統一94售01  ,0,0,0,0,0,0,0,0,0,32000,0,0,0,32000,0,32000,32000
047573,儒鴻群益93購04  ,0,0,0,0,0,0,0,0,0,32000,0,0,0,160000,128000,32000,32000
049345,富邦金統一94購02,0,0,0,0,0,0,0,0,0,32000,0,0,0,42000,10000,32000,32000
046796,南電元富93購01  ,0,0,0,0,0,0,0,0,0,32000,0,0,0,32000,0,32000,32000
052061,樺漢國票96購01  ,0,0,0,0,0,0,0,0,0,32000,0,0,0,52000,20000,32000,32000
051579,宏碁元大95購01  ,0,0,0,0,0,0,0,0,0,32000,0,0,0,173000,141000,32000,32000
051828,微星元大95購03  ,0,0,0,0,0,0,0,0,0,32000,0,0,0,123000,91000,32000,32000
050407,聯詠台新94購02  ,0,0,0,0,0,0,0,0,0,32000,0,0,0,94000,62000,32000,32000
049705,緯穎元大94購05  ,0,0,0,0,0,0,0,0,0,32000,0,0,0,135000,103000,32000,32000
05221P,玉晶光元大95售04,0,0,0,0,0,0,0,0,0,32000,0,0,0,112000,80000,32000,32000
1442,名軒            ,39000,12000,27000,0,0,0,0,0,0,5000,5000,0,5000,0,0,0,32000
5234,達興材料        ,64000,32000,32000,0,0,0,0,0,0,0,0,0,0,0,0,0,32000
1724,台硝            ,34000,2000,32000,0,0,0,0,0,0,0,0,0,0,0,0,0,32000
05240P,玉晶光永豐96售01,0,0,0,0,0,0,0,0,0,31000,0,0,0,31000,0,31000,31000
052826,嘉聯益永豐96購01,0,0,0,0,0,0,0,0,0,31000,0,0,0,34000,3000,31000,31000
05275P,國巨凱基95售05  ,0,0,0,0,0,0,0,0,0,31000,0,0,0,106000,75000,31000,31000
05530P,臺股指群益96售03,0,0,0,0,0,0,0,0,0,31000,0,0,0,31000,0,31000,31000
043267,旺宏麥證92購01  ,0,0,0,33000,2000,31000,0,0,0,31000,0,0,0,33000,2000,31000,31000
043854,華新科富邦93購01,0,0,0,0,0,0,0,0,0,31000,0,0,0,63000,32000,31000,31000
046965,復盛中信93購01  ,0,0,0,0,0,0,0,0,0,31000,0,0,0,31000,0,31000,31000
04805P,創意元富94售01  ,0,0,0,0,0,0,0,0,0,31000,0,0,0,36000,5000,31000,31000
047420,全新富邦97購01  ,0,0,0,0,0,0,0,0,0,31000,0,0,0,31000,0,31000,31000
04850P,全新永豐94售03  ,0,0,0,0,0,0,0,0,0,31000,0,0,0,40000,9000,31000,31000
047523,瑞昱元大93購09  ,0,0,0,0,0,0,0,0,0,31000,0,0,0,36000,5000,31000,31000
048705,GIS國票95購01   ,0,0,0,0,0,0,0,0,0,31000,0,0,0,31000,0,31000,31000
04941P,台達電台新94售02,0,0,0,0,0,0,0,0,0,31000,0,0,0,31000,0,31000,31000
050742,新日興永豐94購01,0,0,0,0,0,0,0,0,0,31000,0,0,0,102000,71000,31000,31000
051724,康控永豐95購03  ,0,0,0,0,0,0,0,0,0,31000,0,0,0,68000,37000,31000,31000
051506,台積電元富95購06,0,0,0,0,0,0,0,0,0,31000,0,0,0,137000,106000,31000,31000
2387,精元            ,232000,201000,31000,0,0,0,0,0,0,0,0,0,0,0,0,0,31000
2540,愛山林          ,33000,2000,31000,0,0,0,0,0,0,0,0,0,0,0,0,0,31000
5285,界霖            ,64000,33000,31000,0,0,0,0,0,0,0,0,0,0,0,0,0,31000
2911,麗嬰房          ,32000,1000,31000,0,0,0,0,0,0,0,0,0,0,0,0,0,31000
05973P,聯詠元大96售06  ,0,0,0,0,0,0,0,0,0,31000,0,0,0,53000,22000,31000,31000
05894P,友達群益98售02  ,0,0,0,0,0,0,0,0,0,31000,0,0,0,432000,401000,31000,31000
05648P,康控國票97售01  ,0,0,0,0,0,0,0,0,0,31000,0,0,0,31000,0,31000,31000
05745P,富邦金兆豐96售02,0,0,0,0,0,0,0,0,0,31000,0,0,0,38000,7000,31000,31000
6533,晶心科          ,76000,45000,31000,0,0,0,0,0,0,0,0,0,0,0,0,0,31000
1773,勝一            ,53800,7000,46800,0,0,0,0,0,0,-16000,0,16000,-16000,0,0,0,30800
05483P,國巨凱基95售07  ,0,0,0,0,0,0,0,0,0,30000,0,0,0,50000,20000,30000,30000
054606,台積電永豐97購02,0,0,0,0,0,0,0,0,0,30000,0,0,0,30000,0,30000,30000
054308,嘉晶凱基98購01  ,0,0,0,0,0,0,0,0,0,30000,0,0,0,50000,20000,30000,30000
054264,超眾元大97購02  ,0,0,0,0,0,0,0,0,0,30000,0,0,0,36000,6000,30000,30000
05439P,聯發科國票95售06,0,0,0,0,0,0,0,0,0,30000,0,0,0,30000,0,30000,30000
053635,技嘉永豐96購01  ,0,0,0,0,0,0,0,0,0,30000,0,0,0,30000,0,30000,30000
053770,元金2X元大98購01,0,0,0,0,0,0,0,0,0,30000,0,0,0,105000,75000,30000,30000
053942,超眾國泰96購02  ,0,0,0,0,0,0,0,0,0,30000,0,0,0,30000,0,30000,30000
053912,T50反1國票97購02,0,0,0,0,0,0,0,0,0,30000,0,0,0,30000,0,30000,30000
054143,茂林元大96購04  ,0,0,0,0,0,0,0,0,0,30000,0,0,0,30000,0,30000,30000
054097,淘帝國票97購01  ,0,0,0,0,0,0,0,0,0,30000,0,0,0,30000,0,30000,30000
054079,鴻海中信98購02  ,0,0,0,0,0,0,0,0,0,30000,0,0,0,30000,0,30000,30000
052739,國巨元大96購04  ,0,0,0,0,0,0,0,0,0,30000,0,0,0,30000,0,30000,30000
052426,國巨台新96購01  ,0,0,0,0,0,0,0,0,0,30000,0,0,0,30000,0,30000,30000
052524,新光金元大9B購01,0,0,0,0,0,0,0,0,0,30000,0,0,0,50000,20000,30000,30000
052248,元油反永豐95購01,0,0,0,0,0,0,0,0,0,30000,0,0,0,30000,0,30000,30000
053344,嘉晶國票97購02  ,0,0,0,0,0,0,0,0,0,30000,0,0,0,180000,150000,30000,30000
053421,南亞科永豐96購01,0,0,0,0,0,0,0,0,0,30000,0,0,0,30000,0,30000,30000
053262,華邦電群益96購02,0,0,0,0,0,0,0,0,0,30000,0,0,0,396000,366000,30000,30000
053510,聯電群益97購01  ,0,0,0,0,0,0,0,0,0,30000,0,0,0,157000,127000,30000,30000
052990,超眾元大97購01  ,0,0,0,0,0,0,0,0,0,30000,0,0,0,30000,0,30000,30000
052987,華新科元大99購01,0,0,0,0,0,0,0,0,0,30000,0,0,0,31000,1000,30000,30000
04576P,上海銀統一94售04,0,0,0,0,0,0,0,0,0,30000,0,0,0,30000,0,30000,30000
045721,中信金凱基92購01,0,0,0,0,0,0,0,0,0,30000,0,0,0,50000,20000,30000,30000
045679,欣興元大94購01  ,0,0,0,0,0,0,0,0,0,30000,0,0,0,30000,0,30000,30000
045653,南茂凱基93購02  ,0,0,0,0,0,0,0,0,0,30000,0,0,0,30000,0,30000,30000
045658,儒鴻國泰93購01  ,0,0,0,0,0,0,0,0,0,30000,0,0,0,330000,300000,30000,30000
044191,旺宏第一91購01  ,0,0,0,0,0,0,0,0,0,30000,0,0,0,30000,0,30000,30000
045619,強茂永豐92購01  ,0,0,0,0,0,0,0,0,0,30000,0,0,0,30000,0,30000,30000
047728,嘉聯益群益93購01,0,0,0,0,0,0,0,0,0,30000,0,0,0,40000,10000,30000,30000
047790,致伸群益93購04  ,0,0,0,0,0,0,0,0,0,30000,0,0,0,30000,0,30000,30000
046272,致伸凱基92購06  ,0,0,0,0,0,0,0,0,0,30000,0,0,0,40000,10000,30000,30000
04824P,亞泥中信94售02  ,0,0,0,0,0,0,0,0,0,30000,0,0,0,30000,0,30000,30000
048250,矽創兆豐93購02  ,0,0,0,0,0,0,0,0,0,30000,0,0,0,30000,0,30000,30000
048258,國泰金統一93購01,0,0,0,0,0,0,0,0,0,30000,0,0,0,60000,30000,30000,30000
045080,大立光元大93購06,0,0,0,0,0,0,0,0,0,30000,0,0,0,50000,20000,30000,30000
045033,全新群益92購02  ,0,0,0,0,0,0,0,0,0,30000,0,0,0,30000,0,30000,30000
045094,樺漢元大92購01  ,0,0,0,0,0,0,0,0,0,30000,0,0,0,30000,0,30000,30000
045111,亞德客永豐92購01,0,0,0,0,0,0,0,0,0,30000,0,0,0,77000,47000,30000,30000
045186,鴻海元富92購02  ,0,0,0,0,0,0,0,0,0,30000,0,0,0,30000,0,30000,30000
045575,智邦元大92購06  ,0,0,0,0,0,0,0,0,0,30000,0,0,0,36000,6000,30000,30000
043918,日月光凱基91購02,0,0,0,0,0,0,0,0,0,30000,0,0,0,50000,20000,30000,30000
04251P,欣興統一93售06  ,0,0,0,0,0,0,0,0,0,30000,0,0,0,30000,0,30000,30000
042425,台郡元大91購01  ,0,0,0,0,0,0,0,0,0,30000,0,0,0,40000,10000,30000,30000
04183P,大成鋼統一93售03,0,0,0,0,0,0,0,0,0,30000,0,0,0,30000,0,30000,30000
04218P,正文國票93售03  ,0,0,0,0,0,0,0,0,0,30000,0,0,0,30000,0,30000,30000
043425,禾伸堂國票91購01,0,0,0,0,0,0,0,0,0,30000,0,0,0,30000,0,30000,30000
043523,奇鋐元大93購01  ,0,0,0,0,0,0,0,0,0,30000,0,0,0,40000,10000,30000,30000
044525,台郡凱基91購03  ,0,0,0,0,0,0,0,0,0,30000,0,0,0,40000,10000,30000,30000
044680,華新科凱基93購06,0,0,0,0,0,0,0,0,0,30000,0,0,0,45000,15000,30000,30000
03760P,華通統一93售01  ,0,0,0,0,0,0,0,0,0,30000,0,0,0,30000,0,30000,30000
03762P,旺宏元富93售03  ,0,0,0,0,0,0,0,0,0,30000,0,0,0,30000,0,30000,30000
03991P,台積電統一93售03,0,0,0,0,0,0,0,0,0,30000,0,0,0,30000,0,30000,30000
03953P,易華電凱基94售01,0,0,0,0,0,0,0,0,0,30000,0,0,0,56000,26000,30000,30000
04040P,大立光統一93售09,0,0,0,0,0,0,0,0,0,30000,0,0,0,30000,0,30000,30000
040772,滬深2X元富92購02,0,0,0,0,0,0,0,0,0,30000,0,0,0,157000,127000,30000,30000
03249P,華擎元富04售01  ,0,0,0,0,0,0,0,0,0,30000,0,0,0,30000,0,30000,30000
047440,聯發科元大93購14,0,0,0,0,0,0,0,0,0,30000,0,0,0,30000,0,30000,30000
047216,欣興第一93購01  ,0,0,0,0,0,0,0,0,0,30000,0,0,0,30000,0,30000,30000
047155,智原國票93購01  ,0,0,0,0,0,0,0,0,0,30000,0,0,0,30000,0,30000,30000
049208,台郡群益94購01  ,0,0,0,0,0,0,0,0,0,30000,0,0,0,30000,0,30000,30000
049085,揚明光凱基94購03,0,0,0,0,0,0,0,0,0,30000,0,0,0,30000,0,30000,30000
047583,深中小永豐94購01,0,0,0,0,0,0,0,0,0,30000,0,0,0,30000,0,30000,30000
048498,嘉澤元大94購01  ,0,0,0,0,0,0,0,0,0,30000,0,0,0,44000,14000,30000,30000
048593,華新科群益93購04,0,0,0,0,0,0,0,0,0,30000,0,0,0,30000,0,30000,30000
047037,奇力新群益93購02,0,0,0,0,0,0,0,0,0,30000,0,0,0,30000,0,30000,30000
048061,鴻海統一95購03  ,0,0,0,0,0,0,0,0,0,30000,0,0,0,31000,1000,30000,30000
046977,潤泰全永豐93購01,0,0,0,0,0,0,0,0,0,30000,0,0,0,30000,0,30000,30000
046899,鴻海凱基93購21  ,0,0,0,0,0,0,0,0,0,30000,0,0,0,52000,22000,30000,30000
046174,高鐵永豐92購01  ,0,0,0,0,0,0,0,0,0,30000,0,0,0,30000,0,30000,30000
04601P,大立光凱基94售07,0,0,0,0,0,0,0,0,0,30000,0,0,0,104000,74000,30000,30000
04588P,茂林永豐94售04  ,0,0,0,0,0,0,0,0,0,30000,0,0,0,30000,0,30000,30000
051426,道瓊反統一95購02,0,0,0,0,0,0,0,0,0,30000,0,0,0,30000,0,30000,30000
051357,可成元大95購05  ,0,0,0,0,0,0,0,0,0,30000,0,0,0,30000,0,30000,30000
051207,聯茂麥證95購01  ,0,0,0,30000,0,30000,0,0,0,30000,0,0,0,30000,0,30000,30000
051596,超眾元大95購05  ,0,0,0,0,0,0,0,0,0,30000,0,0,0,30000,0,30000,30000
051582,聯發科元大97購02,0,0,0,0,0,0,0,0,0,30000,0,0,0,63000,33000,30000,30000
051616,鴻海凱基96購08  ,0,0,0,0,0,0,0,0,0,30000,0,0,0,72000,42000,30000,30000
051839,和鑫國泰96購01  ,0,0,0,0,0,0,0,0,0,30000,0,0,0,40000,10000,30000,30000
051819,燿華統一96購01  ,0,0,0,0,0,0,0,0,0,30000,0,0,0,30000,0,30000,30000
051772,玉山金中信95購01,0,0,0,0,0,0,0,0,0,30000,0,0,0,30000,0,30000,30000
05212P,台積電國票96售04,0,0,0,0,0,0,0,0,0,30000,0,0,0,30000,0,30000,30000
050902,南電元大96購01  ,0,0,0,0,0,0,0,0,0,30000,0,0,0,30000,0,30000,30000
050700,健策凱基96購01  ,0,0,0,0,0,0,0,0,0,30000,0,0,0,30000,0,30000,30000
05043P,佳世達元富95售01,0,0,0,0,0,0,0,0,0,30000,0,0,0,30000,0,30000,30000
050431,聯發科凱基94購18,0,0,0,0,0,0,0,0,0,30000,0,0,0,110000,80000,30000,30000
050228,中磊中信96購01  ,0,0,0,0,0,0,0,0,0,30000,0,0,0,40000,10000,30000,30000
050275,緯穎元大94購10  ,0,0,0,0,0,0,0,0,0,30000,0,0,0,33000,3000,30000,30000
049563,華新統一95購01  ,0,0,0,0,0,0,0,0,0,30000,0,0,0,70000,40000,30000,30000
049596,智伸科元大95購01,0,0,0,0,0,0,0,0,0,30000,0,0,0,50000,20000,30000,30000
049731,A50正2群益94購02,0,0,0,0,0,0,0,0,0,30000,0,0,0,40000,10000,30000,30000
049680,臺股指國票94購13,0,0,0,0,0,0,0,0,0,30000,0,0,0,30000,0,30000,30000
050154,可成群益94購05  ,0,0,0,0,0,0,0,0,0,30000,0,0,0,30000,0,30000,30000
050198,緯穎元大94購09  ,0,0,0,0,0,0,0,0,0,30000,0,0,0,40000,10000,30000,30000
050040,鴻海中信94購04  ,0,0,0,0,0,0,0,0,0,30000,0,0,0,35000,5000,30000,30000
049815,緯穎元大94購06  ,0,0,0,0,0,0,0,0,0,30000,0,0,0,72000,42000,30000,30000
052223,聯電凱基96購02  ,0,0,0,0,0,0,0,0,0,30000,0,0,0,30000,0,30000,30000
1726,永記            ,34000,4000,30000,0,0,0,0,0,0,0,0,0,0,0,0,0,30000
2514,龍邦            ,50000,20000,30000,0,0,0,0,0,0,0,0,0,0,0,0,0,30000
06013P,世芯國泰97售03  ,0,0,0,0,0,0,0,0,0,30000,0,0,0,30000,0,30000,30000
08422P,玉晶光群益02售03,0,0,0,0,0,0,0,0,0,30000,0,0,0,30000,0,30000,30000
1432,大魯閣          ,30000,0,30000,0,0,0,0,0,0,0,0,0,0,0,0,0,30000
6416,瑞祺電通        ,38000,9000,29000,0,0,0,0,0,0,1000,1000,0,1000,0,0,0,30000
9941,裕融            ,24400,14789,9611,0,0,0,0,0,0,20000,20000,0,20000,0,0,0,29611
053325,GIS群益96購02   ,0,0,0,0,0,0,0,0,0,29000,0,0,0,69000,40000,29000,29000
052666,瑞昱群益96購01  ,0,0,0,0,0,0,0,0,0,29000,0,0,0,100000,71000,29000,29000
053616,奇力新群益97購01,0,0,0,0,0,0,0,0,0,29000,0,0,0,242000,213000,29000,29000
043580,大立光元富94購01,0,0,0,0,0,0,0,0,0,29000,0,0,0,102000,73000,29000,29000
043357,聯詠國票92購02  ,0,0,0,0,0,0,0,0,0,29000,0,0,0,92000,63000,29000,29000
04308P,京元電凱基93售06,0,0,0,0,0,0,0,0,0,29000,0,0,0,60000,31000,29000,29000
04294P,台積電元大95售01,0,0,0,0,0,0,0,0,0,29000,0,0,0,139000,110000,29000,29000
046236,緯穎元大93購05  ,0,0,0,0,0,0,0,0,0,29000,0,0,0,29000,0,29000,29000
043653,可成國泰92購02  ,0,0,0,0,0,0,0,0,0,29000,0,0,0,30000,1000,29000,29000
045765,康控統一92購01  ,0,0,0,0,0,0,0,0,0,29000,0,0,0,39000,10000,29000,29000
045851,健策永豐92購01  ,0,0,0,0,0,0,0,0,0,29000,0,0,0,118000,89000,29000,29000
046638,台積電永豐93購01,0,0,0,0,0,0,0,0,0,29000,0,0,0,30000,1000,29000,29000
04851P,創意永豐94售02  ,0,0,0,0,0,0,0,0,0,29000,0,0,0,71000,42000,29000,29000
049949,燿華群益96購01  ,0,0,0,0,0,0,0,0,0,29000,0,0,0,29000,0,29000,29000
050385,貿聯國票95購02  ,0,0,0,0,0,0,0,0,0,29000,0,0,0,42000,13000,29000,29000
050843,富邦金國票96購01,0,0,0,0,0,0,0,0,0,29000,0,0,0,29000,0,29000,29000
050788,台郡國泰96購01  ,0,0,0,0,0,0,0,0,0,29000,0,0,0,29000,0,29000,29000
052159,瑞昱永豐95購01  ,0,0,0,0,0,0,0,0,0,29000,0,0,0,77000,48000,29000,29000
051973,華新科凱基96購04,0,0,0,0,0,0,0,0,0,29000,0,0,0,41000,12000,29000,29000
051076,緯創國泰96購01  ,0,0,0,0,0,0,0,0,0,29000,0,0,0,78000,49000,29000,29000
051000,台郡元大96購01  ,0,0,0,0,0,0,0,0,0,29000,0,0,0,508000,479000,29000,29000
1446,宏和            ,43000,14000,29000,0,0,0,0,0,0,0,0,0,0,0,0,0,29000
05742P,可成元大96售04  ,0,0,0,0,0,0,0,0,0,29000,0,0,0,81000,52000,29000,29000
2375,凱美            ,717000,688000,29000,0,0,0,0,0,0,0,0,0,0,0,0,0,29000
1806,冠軍            ,33000,4000,29000,0,0,0,0,0,0,0,0,0,0,0,0,0,29000
053609,華新中信9A購01  ,0,0,0,0,0,0,0,0,0,28000,0,0,0,128000,100000,28000,28000
054048,國泰金元大96購04,0,0,0,0,0,0,0,0,0,28000,0,0,0,28000,0,28000,28000
052512,全新凱基96購03  ,0,0,0,0,0,0,0,0,0,28000,0,0,0,58000,30000,28000,28000
052545,康控元富95購02  ,0,0,0,0,0,0,0,0,0,28000,0,0,0,48000,20000,28000,28000
052450,嘉澤元大95購03  ,0,0,0,0,0,0,0,0,0,28000,0,0,0,76000,48000,28000,28000
052998,拓凱康和96購01  ,0,0,0,0,0,0,0,0,0,28000,0,0,0,46000,18000,28000,28000
043895,鴻海群益92購01  ,0,0,0,0,0,0,0,0,0,28000,0,0,0,46000,18000,28000,28000
046300,嘉聯益富邦94購01,0,0,0,0,0,0,0,0,0,28000,0,0,0,68000,40000,28000,28000
045216,鴻海元大93購02  ,0,0,0,0,0,0,0,0,0,28000,0,0,0,83000,55000,28000,28000
045327,智伸科永豐92購01,0,0,0,0,0,0,0,0,0,28000,0,0,0,40000,12000,28000,28000
045823,康普凱基92購02  ,0,0,0,0,0,0,0,0,0,28000,0,0,0,28000,0,28000,28000
03016P,滬深2X群益01售09,0,0,0,0,0,0,0,0,0,28000,0,0,0,40000,12000,28000,28000
035274,華新台新97購01  ,0,0,0,0,0,0,0,0,0,28000,0,0,0,76000,48000,28000,28000
049260,華新科元大96購01,0,0,0,0,0,0,0,0,0,28000,0,0,0,42000,14000,28000,28000
049377,聯詠元大94購01  ,0,0,0,0,0,0,0,0,0,28000,0,0,0,33000,5000,28000,28000
048594,泰鼎群益93購02  ,0,0,0,0,0,0,0,0,0,28000,0,0,0,45000,17000,28000,28000
046891,南亞科群益93購01,0,0,0,0,0,0,0,0,0,28000,0,0,0,29000,1000,28000,28000
046062,遠東新凱基92購02,0,0,0,0,0,0,0,0,0,28000,0,0,0,30000,2000,28000,28000
051241,台積電元大95購13,0,0,0,0,0,0,0,0,0,28000,0,0,0,321000,293000,28000,28000
051774,聯茂中信96購01  ,0,0,0,0,0,0,0,0,0,28000,0,0,0,148000,120000,28000,28000
051869,康控凱基96購01  ,0,0,0,0,0,0,0,0,0,28000,0,0,0,30000,2000,28000,28000
05010P,台郡元富95售01  ,0,0,0,0,0,0,0,0,0,28000,0,0,0,38000,10000,28000,28000
049449,宏碁統一94購01  ,0,0,0,0,0,0,0,0,0,28000,0,0,0,28000,0,28000,28000
2029,盛餘            ,28000,0,28000,0,0,0,0,0,0,0,0,0,0,0,0,0,28000
2440,太空梭          ,30000,0,30000,0,0,0,0,0,0,-2000,0,2000,-2000,0,0,0,28000
1702,南僑            ,56000,26000,30000,0,0,0,0,0,0,-2000,0,2000,-2000,0,0,0,28000
052519,旺宏元大95購05  ,0,0,0,0,0,0,0,0,0,27000,0,0,0,178000,151000,27000,27000
053655,全新凱基98購02  ,0,0,0,0,0,0,0,0,0,27000,0,0,0,77000,50000,27000,27000
054367,鴻海中信98購03  ,0,0,0,0,0,0,0,0,0,27000,0,0,0,35000,8000,27000,27000
054234,可成群益96購05  ,0,0,0,0,0,0,0,0,0,27000,0,0,0,103000,76000,27000,27000
054615,牧德永豐98購01  ,0,0,0,0,0,0,0,0,0,27000,0,0,0,75000,48000,27000,27000
05495P,大立光統一95售07,0,0,0,0,0,0,0,0,0,27000,0,0,0,126000,99000,27000,27000
03888P,大立光元富93售03,0,0,0,0,0,0,0,0,0,27000,0,0,0,27000,0,27000,27000
044831,同欣電永豐91購01,0,0,0,0,0,0,0,0,0,27000,0,0,0,27000,0,27000,27000
046291,友達統一94購01  ,0,0,0,0,0,0,0,0,0,27000,0,0,0,70000,43000,27000,27000
045694,智邦兆豐93購05  ,0,0,0,0,0,0,0,0,0,27000,0,0,0,27000,0,27000,27000
044181,鴻海元富91購02  ,0,0,0,0,0,0,0,0,0,27000,0,0,0,27000,0,27000,27000
047714,禾伸堂凱基93購03,0,0,0,0,0,0,0,0,0,27000,0,0,0,54000,27000,27000,27000
049960,嘉聯益統一94購01,0,0,0,0,0,0,0,0,0,27000,0,0,0,27000,0,27000,27000
051756,台積電元大97購04,0,0,0,0,0,0,0,0,0,27000,0,0,0,199000,172000,27000,27000
051718,上証2X永豐95購01,0,0,0,0,0,0,0,0,0,27000,0,0,0,33000,6000,27000,27000
1617,榮星            ,27000,0,27000,0,0,0,0,0,0,0,0,0,0,0,0,0,27000
05847P,大立光元大96售08,0,0,0,0,0,0,0,0,0,27000,0,0,0,30000,3000,27000,27000
2524,京城            ,35000,8000,27000,0,0,0,0,0,0,0,0,0,0,0,0,0,27000
3266,昇陽            ,27000,0,27000,0,0,0,0,0,0,0,0,0,0,0,0,0,27000
6235,華孚            ,20000,1000,19000,0,0,0,0,0,0,8000,8000,0,8000,0,0,0,27000
5607,遠雄港          ,157000,130000,27000,0,0,0,0,0,0,0,0,0,0,0,0,0,27000
054492,嘉聯益台新96購01,0,0,0,0,0,0,0,0,0,26000,0,0,0,26000,0,26000,26000
053862,南亞科元大97購02,0,0,0,0,0,0,0,0,0,26000,0,0,0,26000,0,26000,26000
052992,冠德台新96購01  ,0,0,0,0,0,0,0,0,0,26000,0,0,0,38000,12000,26000,26000
053503,臻鼎兆豐97購01  ,0,0,0,0,0,0,0,0,0,26000,0,0,0,30000,4000,26000,26000
053518,聯茂群益96購03  ,0,0,0,0,0,0,0,0,0,26000,0,0,0,112000,86000,26000,26000
044218,禾伸堂凱基91購01,0,0,0,0,0,0,0,0,0,26000,0,0,0,38000,12000,26000,26000
044944,技嘉群益93購01  ,0,0,0,0,0,0,0,0,0,26000,0,0,0,36000,10000,26000,26000
03014P,玉晶光永豐01售05,0,0,0,0,0,0,0,0,0,26000,0,0,0,31000,5000,26000,26000
049387,緯穎元大94購03  ,0,0,0,0,0,0,0,0,0,26000,0,0,0,215000,189000,26000,26000
048936,玉晶光永豐94購05,0,0,0,0,0,0,0,0,0,26000,0,0,0,257000,231000,26000,26000
051985,智邦元大95購05  ,0,0,0,0,0,0,0,0,0,26000,0,0,0,103000,77000,26000,26000
05001P,華通統一95售01  ,0,0,0,0,0,0,0,0,0,26000,0,0,0,66000,40000,26000,26000
049824,鴻海凱基94購18  ,0,0,0,0,0,0,0,0,0,26000,0,0,0,144000,118000,26000,26000
050152,聯發科群益94購07,0,0,0,0,0,0,0,0,0,26000,0,0,0,77000,51000,26000,26000
050485,國巨統一96購01  ,0,0,0,0,0,0,0,0,0,26000,0,0,0,26000,0,26000,26000
2913,農林            ,72000,46000,26000,0,0,0,0,0,0,0,0,0,0,0,0,0,26000
1810,和成            ,20000,0,20000,0,0,0,0,0,0,6000,6000,0,6000,0,0,0,26000
1903,士紙            ,28000,0,28000,0,0,0,0,0,0,-2000,0,2000,-2000,0,0,0,26000
05800P,台積電兆豐96售04,0,0,0,0,0,0,0,0,0,26000,0,0,0,40000,14000,26000,26000
05718P,國巨元大96售09  ,0,0,0,0,0,0,0,0,0,26000,0,0,0,616000,590000,26000,26000
1337,再生-KY         ,28000,2000,26000,0,0,0,0,0,0,0,0,0,0,0,0,0,26000
8081,致新            ,178000,109714,68286,0,0,0,0,0,0,-43000,0,29000,-29000,6000,20000,-14000,25286
053301,華通凱基96購04  ,0,0,0,0,0,0,0,0,0,25000,0,0,0,35000,10000,25000,25000
052939,富邦金兆豐96購01,0,0,0,0,0,0,0,0,0,25000,0,0,0,129000,104000,25000,25000
052366,聯詠國票96購01  ,0,0,0,0,0,0,0,0,0,25000,0,0,0,25000,0,25000,25000
052930,華新科元大97購03,0,0,0,0,0,0,0,0,0,25000,0,0,0,25000,0,25000,25000
053749,揚明光永豐97購01,0,0,0,0,0,0,0,0,0,25000,0,0,0,35000,10000,25000,25000
05403P,台積電富邦95售08,0,0,0,0,0,0,0,0,0,25000,0,0,0,50000,25000,25000,25000
054025,鴻海凱基96購17  ,0,0,0,0,0,0,0,0,0,25000,0,0,0,51000,26000,25000,25000
05427P,聯發科凱基96售07,0,0,0,0,0,0,0,0,0,25000,0,0,0,25000,0,25000,25000
03732P,大立光元大93售16,0,0,0,0,0,0,0,0,0,25000,0,0,0,25000,0,25000,25000
042914,大立光元大92購06,0,0,0,0,0,0,0,0,0,25000,0,0,0,25000,0,25000,25000
042288,元油2X元大93購03,0,0,0,0,0,0,0,0,0,25000,0,0,0,50000,25000,25000,25000
045140,玉晶光兆豐93購02,0,0,0,0,0,0,0,0,0,25000,0,0,0,25000,0,25000,25000
043967,廣越國泰92購01  ,0,0,0,0,0,0,0,0,0,25000,0,0,0,85000,60000,25000,25000
045578,建準元大92購02  ,0,0,0,0,0,0,0,0,0,25000,0,0,0,25000,0,25000,25000
043663,大立光元大92購07,0,0,0,0,0,0,0,0,0,25000,0,0,0,25000,0,25000,25000
04368P,台積電凱基94售02,0,0,0,0,0,0,0,0,0,25000,0,0,0,25000,0,25000,25000
043770,亞德客兆豐92購01,0,0,0,0,0,0,0,0,0,25000,0,0,0,25000,0,25000,25000
043899,宏達電群益91購03,0,0,0,0,0,0,0,0,0,25000,0,0,0,25000,0,25000,25000
04832P,為升元大94售09  ,0,0,0,0,0,0,0,0,0,25000,0,0,0,25000,0,25000,25000
047191,同欣電元大93購02,0,0,0,0,0,0,0,0,0,25000,0,0,0,25000,0,25000,25000
047272,技嘉永豐93購01  ,0,0,0,0,0,0,0,0,0,25000,0,0,0,25000,0,25000,25000
047512,宏達電國票94購01,0,0,0,0,0,0,0,0,0,25000,0,0,0,155000,130000,25000,25000
047513,嘉晶國票93購03  ,0,0,0,0,0,0,0,0,0,25000,0,0,0,241000,216000,25000,25000
049364,燿華元大94購02  ,0,0,0,0,0,0,0,0,0,25000,0,0,0,100000,75000,25000,25000
050446,鴻海元大94購22  ,0,0,0,0,0,0,0,0,0,25000,0,0,0,32000,7000,25000,25000
050414,泰鼎永豐94購04  ,0,0,0,0,0,0,0,0,0,25000,0,0,0,27000,2000,25000,25000
050306,聯發科中信97購01,0,0,0,0,0,0,0,0,0,25000,0,0,0,30000,5000,25000,25000
050281,台積電日盛94購03,0,0,0,0,0,0,0,0,0,25000,0,0,0,25000,0,25000,25000
050267,奇鋐元大94購03  ,0,0,0,0,0,0,0,0,0,25000,0,0,0,40000,15000,25000,25000
050202,建準群益95購01  ,0,0,0,0,0,0,0,0,0,25000,0,0,0,46000,21000,25000,25000
050797,聯發科中信99購01,0,0,0,0,0,0,0,0,0,25000,0,0,0,72000,47000,25000,25000
05009P,大立光元富95售06,0,0,0,0,0,0,0,0,0,25000,0,0,0,55000,30000,25000,25000
049886,華通永昌95購01  ,0,0,0,0,0,0,0,0,0,25000,0,0,0,57000,32000,25000,25000
049964,強茂元富94購01  ,0,0,0,0,0,0,0,0,0,25000,0,0,0,40000,15000,25000,25000
049490,京元電元大95購02,0,0,0,0,0,0,0,0,0,25000,0,0,0,338000,313000,25000,25000
04959P,可成凱基94售14  ,0,0,0,0,0,0,0,0,0,25000,0,0,0,40000,15000,25000,25000
049700,瀚宇博元大97購01,0,0,0,0,0,0,0,0,0,25000,0,0,0,48000,23000,25000,25000
051693,華新科統一95購02,0,0,0,0,0,0,0,0,0,25000,0,0,0,25000,0,25000,25000
051647,華新科永豐95購02,0,0,0,0,0,0,0,0,0,25000,0,0,0,36000,11000,25000,25000
051559,宏達電國泰96購01,0,0,0,0,0,0,0,0,0,25000,0,0,0,25000,0,25000,25000
051416,創意國票96購02  ,0,0,0,0,0,0,0,0,0,25000,0,0,0,25000,0,25000,25000
051518,富邦金凱基95購01,0,0,0,0,0,0,0,0,0,25000,0,0,0,75000,50000,25000,25000
05148P,臻鼎元大95售01  ,0,0,0,0,0,0,0,0,0,25000,0,0,0,75000,50000,25000,25000
051021,啟碁凱基95購02  ,0,0,0,0,0,0,0,0,0,25000,0,0,0,69000,44000,25000,25000
050938,智原國票96購01  ,0,0,0,0,0,0,0,0,0,25000,0,0,0,27000,2000,25000,25000
051152,鴻海國泰97購01  ,0,0,0,0,0,0,0,0,0,25000,0,0,0,56000,31000,25000,25000
1618,合機            ,26000,1000,25000,0,0,0,0,0,0,0,0,0,0,0,0,0,25000
1474,弘裕            ,25000,0,25000,0,0,0,0,0,0,0,0,0,0,0,0,0,25000
06047P,聯發科富邦99售04,0,0,0,0,0,0,0,0,0,25000,0,0,0,36000,11000,25000,25000
06029P,聯發科台新96售02,0,0,0,0,0,0,0,0,0,25000,0,0,0,33000,8000,25000,25000
06000P,GIS元大96售04   ,0,0,0,0,0,0,0,0,0,25000,0,0,0,50000,25000,25000,25000
05815P,台積電凱基97售06,0,0,0,0,0,0,0,0,0,25000,0,0,0,617000,592000,25000,25000
2365,昆盈            ,47000,22000,25000,0,0,0,0,0,0,0,0,0,0,0,0,0,25000
2348,海悅            ,35000,8000,27000,0,0,0,0,0,0,-2000,0,2000,-2000,0,0,0,25000
2706,第一店          ,25000,0,25000,0,0,0,0,0,0,0,0,0,0,0,0,0,25000
2360,致茂            ,239000,491623,-252623,0,0,0,396000,3000,393000,-116000,103000,138000,-35000,0,81000,-81000,24377
05521P,創意永豐96售01  ,0,0,0,0,0,0,0,0,0,24000,0,0,0,56000,32000,24000,24000
054157,國巨亞東96購01  ,0,0,0,0,0,0,0,0,0,24000,0,0,0,24000,0,24000,24000
053818,富邦金群益98購01,0,0,0,0,0,0,0,0,0,24000,0,0,0,34000,10000,24000,24000
053820,大立光群益96購05,0,0,0,0,0,0,0,0,0,24000,0,0,0,250000,226000,24000,24000
052833,康控群益96購01  ,0,0,0,0,0,0,0,0,0,24000,0,0,0,34000,10000,24000,24000
052767,智伸科群益98購01,0,0,0,0,0,0,0,0,0,24000,0,0,0,24000,0,24000,24000
053175,矽力群益96購01  ,0,0,0,0,0,0,0,0,0,24000,0,0,0,68000,44000,24000,24000
045741,嘉晶群益92購01  ,0,0,0,0,0,0,0,0,0,24000,0,0,0,100000,76000,24000,24000
04381P,世紀鋼元大94售01,0,0,0,0,0,0,0,0,0,24000,0,0,0,24000,0,24000,24000
045605,儒鴻群益92購01  ,0,0,0,0,0,0,0,0,0,24000,0,0,0,122000,98000,24000,24000
045420,台積電凱基92購07,0,0,0,0,0,0,0,0,0,24000,0,0,0,175000,151000,24000,24000
045438,台郡統一94購01  ,0,0,0,0,0,0,0,0,0,24000,0,0,0,30000,6000,24000,24000
044968,旺宏麥證92購02  ,0,0,0,24000,0,24000,0,0,0,24000,0,0,0,24000,0,24000,24000
00866,新光Shiller CAPE,0,0,0,0,0,0,0,0,0,24000,0,0,0,51000,27000,24000,24000
03266P,寶成國票04售01  ,0,0,0,0,0,0,0,0,0,24000,0,0,0,24000,0,24000,24000
03950P,聯發科中信93售03,0,0,0,0,0,0,0,0,0,24000,0,0,0,55000,31000,24000,24000
04938P,亞德客國票95售01,0,0,0,0,0,0,0,0,0,24000,0,0,0,24000,0,24000,24000
04939P,國巨國票95售03  ,0,0,0,0,0,0,0,0,0,24000,0,0,0,30000,6000,24000,24000
04768P,大立光國泰96售03,0,0,0,0,0,0,0,0,0,24000,0,0,0,198000,174000,24000,24000
048098,嘉澤凱基93購04  ,0,0,0,0,0,0,0,0,0,24000,0,0,0,41000,17000,24000,24000
048745,儒鴻元富97購02  ,0,0,0,0,0,0,0,0,0,24000,0,0,0,168000,144000,24000,24000
046848,和大元大93購01  ,0,0,0,0,0,0,0,0,0,24000,0,0,0,95000,71000,24000,24000
048076,亞光第一94購01  ,0,0,0,0,0,0,0,0,0,24000,0,0,0,28000,4000,24000,24000
051539,瀚宇博國票97購01,0,0,0,0,0,0,0,0,0,24000,0,0,0,24000,0,24000,24000
051286,國巨統一97購01  ,0,0,0,0,0,0,0,0,0,24000,0,0,0,24000,0,24000,24000
051356,全新元大96購04  ,0,0,0,0,0,0,0,0,0,24000,0,0,0,27000,3000,24000,24000
051837,國巨國泰96購04  ,0,0,0,0,0,0,0,0,0,24000,0,0,0,24000,0,24000,24000
052019,創意永豐95購02  ,0,0,0,0,0,0,0,0,0,24000,0,0,0,24000,0,24000,24000
04943P,臻鼎康和94售01  ,0,0,0,0,0,0,0,0,0,24000,0,0,0,24000,0,24000,24000
050611,鴻海元大95購02  ,0,0,0,0,0,0,0,0,0,24000,0,0,0,273000,249000,24000,24000
050293,強茂凱基94購01  ,0,0,0,0,0,0,0,0,0,24000,0,0,0,74000,50000,24000,24000
050547,華新科凱基95購01,0,0,0,0,0,0,0,0,0,24000,0,0,0,35000,11000,24000,24000
2008,高興昌          ,24000,0,24000,0,0,0,0,0,0,0,0,0,0,0,0,0,24000
1789,神隆            ,94000,70000,24000,0,0,0,0,0,0,0,0,0,0,0,0,0,24000
05790P,臺股指永昌96售07,0,0,0,0,0,0,0,0,0,24000,0,0,0,37000,13000,24000,24000
1528,恩德            ,26000,2000,24000,0,0,0,0,0,0,0,0,0,0,0,0,0,24000
6197,佳必琪          ,67000,43000,24000,0,0,0,0,0,0,0,0,0,0,0,0,0,24000
052938,華新科兆豐96購01,0,0,0,0,0,0,0,0,0,23000,0,0,0,23000,0,23000,23000
052320,緯創元大95購05  ,0,0,0,0,0,0,0,0,0,23000,0,0,0,95000,72000,23000,23000
053703,緯穎兆豐96購01  ,0,0,0,0,0,0,0,0,0,23000,0,0,0,39000,16000,23000,23000
054229,超眾元富96購05  ,0,0,0,0,0,0,0,0,0,23000,0,0,0,31000,8000,23000,23000
03908P,致茂元大93售03  ,0,0,0,0,0,0,0,0,0,23000,0,0,0,78000,55000,23000,23000
00715L,街口布蘭特油正2 ,0,0,0,0,0,0,0,0,0,23000,0,0,0,33000,10000,23000,23000
00651R,FH香港反1       ,0,57000,-57000,0,0,0,0,0,0,80000,0,0,0,248000,168000,80000,23000
04165P,南亞科元富95售03,0,0,0,0,0,0,0,0,0,23000,0,0,0,43000,20000,23000,23000
045093,台表科元大93購02,0,0,0,0,0,0,0,0,0,23000,0,0,0,23000,0,23000,23000
044241,華新科統一92購01,0,0,0,0,0,0,0,0,0,23000,0,0,0,23000,0,23000,23000
046096,建準國票92購01  ,0,0,0,0,0,0,0,0,0,23000,0,0,0,33000,10000,23000,23000
046644,台達電國泰93購01,0,0,0,0,0,0,0,0,0,23000,0,0,0,45000,22000,23000,23000
047127,臻鼎中信95購01  ,0,0,0,0,0,0,0,0,0,23000,0,0,0,23000,0,23000,23000
047232,禾伸堂凱基93購02,0,0,0,0,0,0,0,0,0,23000,0,0,0,113000,90000,23000,23000
050447,廣達元大94購01  ,0,0,0,0,0,0,0,0,0,23000,0,0,0,34000,11000,23000,23000
050873,新唐永豐95購01  ,0,0,0,0,0,0,0,0,0,23000,0,0,0,23000,0,23000,23000
049467,致伸台新94購01  ,0,0,0,0,0,0,0,0,0,23000,0,0,0,23000,0,23000,23000
049835,緯穎凱基94購05  ,0,0,0,0,0,0,0,0,0,23000,0,0,0,81000,58000,23000,23000
051927,國巨中信96購01  ,0,0,0,0,0,0,0,0,0,23000,0,0,0,34000,11000,23000,23000
051339,智易永豐95購02  ,0,0,0,0,0,0,0,0,0,23000,0,0,0,23000,0,23000,23000
051450,世芯元大95購02  ,0,0,0,0,0,0,0,0,0,23000,0,0,0,31000,8000,23000,23000
1517,利奇            ,23000,0,23000,0,0,0,0,0,0,0,0,0,0,0,0,0,23000
1443,立益            ,23000,0,23000,0,0,0,0,0,0,0,0,0,0,0,0,0,23000
06032P,健策群益97售03  ,0,0,0,0,0,0,0,0,0,23000,0,0,0,33000,10000,23000,23000
05831P,臺股指元富96售03,0,0,0,0,0,0,0,0,0,23000,0,0,0,55000,32000,23000,23000
05861P,瀚宇博永豐96售02,0,0,0,0,0,0,0,0,0,23000,0,0,0,23000,0,23000,23000
05952P,台積電國票97售06,0,0,0,0,0,0,0,0,0,23000,0,0,0,56000,33000,23000,23000
1736,喬山            ,110000,78000,32000,0,0,0,0,0,0,-9000,0,0,0,4000,13000,-9000,23000
1725,元禎            ,24000,1000,23000,0,0,0,0,0,0,0,0,0,0,0,0,0,23000
2207,和泰車          ,144000,130000,14000,0,0,0,1000,0,1000,8000,9000,1000,8000,0,0,0,23000
2380,虹光            ,24000,1000,23000,0,0,0,0,0,0,0,0,0,0,0,0,0,23000
4930,燦星網          ,24000,1000,23000,0,0,0,0,0,0,0,0,0,0,0,0,0,23000
05473P,聯詠統一97售02  ,0,0,0,0,0,0,0,0,0,22000,0,0,0,53000,31000,22000,22000
053757,聯發科國泰96購04,0,0,0,0,0,0,0,0,0,22000,0,0,0,47000,25000,22000,22000
053940,康友元富96購01  ,0,0,0,0,0,0,0,0,0,22000,0,0,0,122000,100000,22000,22000
05232P,緯穎群益95售01  ,0,0,0,0,0,0,0,0,0,22000,0,0,0,22000,0,22000,22000
05234P,美食康和95售01  ,0,0,0,0,0,0,0,0,0,22000,0,0,0,22000,0,22000,22000
052945,嘉晶國票97購01  ,0,0,0,0,0,0,0,0,0,22000,0,0,0,25000,3000,22000,22000
053191,奇鋐統一96購01  ,0,0,0,0,0,0,0,0,0,22000,0,0,0,70000,48000,22000,22000
043778,智原兆豐92購01  ,0,0,0,0,0,0,0,0,0,22000,0,0,0,22000,0,22000,22000
046257,A50正2國票94購01,0,0,0,0,0,0,0,0,0,22000,0,0,0,80000,58000,22000,22000
045073,可成元大93購01  ,0,0,0,0,0,0,0,0,0,22000,0,0,0,70000,48000,22000,22000
044883,玉晶光群益93購01,0,0,0,0,0,0,0,0,0,22000,0,0,0,22000,0,22000,22000
045332,康友群益92購01  ,0,0,0,0,0,0,0,0,0,22000,0,0,0,23000,1000,22000,22000
045383,大毅元大92購01  ,0,0,0,0,0,0,0,0,0,22000,0,0,0,32000,10000,22000,22000
042382,康控兆豐91購01  ,0,0,0,0,0,0,0,0,0,22000,0,0,0,22000,0,22000,22000
042383,嘉聯益兆豐91購01,0,0,0,0,0,0,0,0,0,22000,0,0,0,22000,0,22000,22000
044310,元黃金台新93購01,0,0,0,0,0,0,0,0,0,22000,0,0,0,22000,0,22000,22000
044333,可成統一91購01  ,0,0,0,0,0,0,0,0,0,22000,0,0,0,22000,0,22000,22000
044654,建準永豐91購01  ,0,0,0,0,0,0,0,0,0,22000,0,0,0,22000,0,22000,22000
00654R,富邦印度反1     ,0,0,0,0,0,0,0,0,0,22000,0,0,0,23000,1000,22000,22000
048741,欣興統一94購02  ,0,0,0,0,0,0,0,0,0,22000,0,0,0,22000,0,22000,22000
048944,茂林永豐94購01  ,0,0,0,0,0,0,0,0,0,22000,0,0,0,22000,0,22000,22000
046433,康友中信92購01  ,0,0,0,0,0,0,0,0,0,22000,0,0,0,42000,20000,22000,22000
051510,新光金中信97購01,0,0,0,0,0,0,0,0,0,22000,0,0,0,22000,0,22000,22000
051285,鴻海統一95購07  ,0,0,0,0,0,0,0,0,0,22000,0,0,0,37000,15000,22000,22000
052187,奇鋐群益95購03  ,0,0,0,0,0,0,0,0,0,22000,0,0,0,62000,40000,22000,22000
052109,可成元富95購01  ,0,0,0,0,0,0,0,0,0,22000,0,0,0,30000,8000,22000,22000
051767,臻鼎元大95購03  ,0,0,0,0,0,0,0,0,0,22000,0,0,0,43000,21000,22000,22000
051590,玉晶光元大96購02,0,0,0,0,0,0,0,0,0,22000,0,0,0,37000,15000,22000,22000
049880,健策永豐94購02  ,0,0,0,0,0,0,0,0,0,22000,0,0,0,22000,0,22000,22000
050157,臻鼎群益94購02  ,0,0,0,0,0,0,0,0,0,22000,0,0,0,69000,47000,22000,22000
050806,華新科日盛95購01,0,0,0,0,0,0,0,0,0,22000,0,0,0,30000,8000,22000,22000
050678,美律統一94購04  ,0,0,0,0,0,0,0,0,0,22000,0,0,0,138000,116000,22000,22000
050484,世紀鋼國票95購02,0,0,0,0,0,0,0,0,0,22000,0,0,0,22000,0,22000,22000
2527,宏璟            ,26000,4000,22000,0,0,0,0,0,0,0,0,0,0,0,0,0,22000
2351,順德            ,79000,57000,22000,0,0,0,0,0,0,0,0,0,0,0,0,0,22000
05967P,臺股指麥證96售02,0,0,0,130000,108000,22000,0,0,0,22000,0,0,0,130000,108000,22000,22000
6243,迅杰            ,22000,0,22000,0,0,0,0,0,0,0,0,0,0,0,0,0,22000
6477,安集            ,31000,9000,22000,0,0,0,0,0,0,0,0,0,0,0,0,0,22000
053266,全新群益98購01  ,0,0,0,0,0,0,0,0,0,21000,0,0,0,101000,80000,21000,21000
053347,茂林國票98購01  ,0,0,0,0,0,0,0,0,0,21000,0,0,0,24000,3000,21000,21000
052533,聯發科國泰96購03,0,0,0,0,0,0,0,0,0,21000,0,0,0,50000,29000,21000,21000
052787,國巨中信96購02  ,0,0,0,0,0,0,0,0,0,21000,0,0,0,38000,17000,21000,21000
052757,華邦電群益96購01,0,0,0,0,0,0,0,0,0,21000,0,0,0,472000,451000,21000,21000
054240,訊芯群益96購03  ,0,0,0,0,0,0,0,0,0,21000,0,0,0,128000,107000,21000,21000
044401,亞光凱基93購01  ,0,0,0,0,0,0,0,0,0,21000,0,0,0,55000,34000,21000,21000
04115P,欣興群益93售06  ,0,0,0,0,0,0,0,0,0,21000,0,0,0,31000,10000,21000,21000
045833,京元電群益92購02,0,0,0,0,0,0,0,0,0,21000,0,0,0,131000,110000,21000,21000
04480P,微星兆豐94售01  ,0,0,0,0,0,0,0,0,0,21000,0,0,0,21000,0,21000,21000
04516P,台積電群益94售07,0,0,0,0,0,0,0,0,0,21000,0,0,0,21000,0,21000,21000
045675,友達元大93購01  ,0,0,0,0,0,0,0,0,0,21000,0,0,0,21000,0,21000,21000
045640,嘉晶凱基93購01  ,0,0,0,0,0,0,0,0,0,21000,0,0,0,21000,0,21000,21000
044139,鴻海群益91購06  ,0,0,0,0,0,0,0,0,0,21000,0,0,0,21000,0,21000,21000
048699,嘉晶國票95購01  ,0,0,0,0,0,0,0,0,0,21000,0,0,0,21000,0,21000,21000
047600,富邦金中信93購01,0,0,0,0,0,0,0,0,0,21000,0,0,0,21000,0,21000,21000
050490,上証2X國泰95購01,0,0,0,0,0,0,0,0,0,21000,0,0,0,26000,5000,21000,21000
050437,聯詠凱基94購04  ,0,0,0,0,0,0,0,0,0,21000,0,0,0,69000,48000,21000,21000
049524,可成兆豐95購02  ,0,0,0,0,0,0,0,0,0,21000,0,0,0,25000,4000,21000,21000
051845,世紀鋼富邦96購01,0,0,0,0,0,0,0,0,0,21000,0,0,0,25000,4000,21000,21000
1110,東泥            ,50000,29000,21000,0,0,0,0,0,0,0,0,0,0,0,0,0,21000
1457,宜進            ,26000,5000,21000,0,0,0,0,0,0,0,0,0,0,0,0,0,21000
1603,華電            ,23000,2000,21000,0,0,0,0,0,0,0,0,0,0,0,0,0,21000
05806P,宏達電永豐96售03,0,0,0,0,0,0,0,0,0,21000,0,0,0,21000,0,21000,21000
05681P,大立光元大96售05,0,0,0,0,0,0,0,0,0,21000,0,0,0,37000,16000,21000,21000
2033,佳大            ,22000,1000,21000,0,0,0,0,0,0,0,0,0,0,0,0,0,21000
5484,慧友            ,21000,0,21000,0,0,0,0,0,0,0,0,0,0,0,0,0,21000
054237,茂林群益97購01  ,0,0,0,0,0,0,0,0,0,20000,0,0,0,20000,0,20000,20000
054257,揚明光元大96購02,0,0,0,0,0,0,0,0,0,20000,0,0,0,25000,5000,20000,20000
054384,瀚宇博群益96購02,0,0,0,0,0,0,0,0,0,20000,0,0,0,20000,0,20000,20000
05475P,聯茂亞東95售01  ,0,0,0,0,0,0,0,0,0,20000,0,0,0,20000,0,20000,20000
05529P,臺股指群益96售02,0,0,0,0,0,0,0,0,0,20000,0,0,0,20000,0,20000,20000
05558P,鴻海麥證96售01  ,0,0,0,20000,0,20000,0,0,0,20000,0,0,0,20000,0,20000,20000
053999,台表科群益96購06,0,0,0,0,0,0,0,0,0,20000,0,0,0,121000,101000,20000,20000
05382P,電子類群益95售02,0,0,0,0,0,0,0,0,0,20000,0,0,0,20000,0,20000,20000
05371P,臺股指中信95售10,0,0,0,0,0,0,0,0,0,20000,0,0,0,43000,23000,20000,20000
053660,群創凱基98購08  ,0,0,0,0,0,0,0,0,0,20000,0,0,0,30000,10000,20000,20000
052654,友達統一97購01  ,0,0,0,0,0,0,0,0,0,20000,0,0,0,20000,0,20000,20000
052910,鴻海統一96購10  ,0,0,0,0,0,0,0,0,0,20000,0,0,0,48000,28000,20000,20000
052569,聯發科凱基96購08,0,0,0,0,0,0,0,0,0,20000,0,0,0,60000,40000,20000,20000
052463,聯電統一96購01  ,0,0,0,0,0,0,0,0,0,20000,0,0,0,88000,68000,20000,20000
05336P,臺股指國票95售05,0,0,0,0,0,0,0,0,0,20000,0,0,0,20000,0,20000,20000
053422,可成永豐96購01  ,0,0,0,0,0,0,0,0,0,20000,0,0,0,68000,48000,20000,20000
053420,華邦電永豐96購01,0,0,0,0,0,0,0,0,0,20000,0,0,0,126000,106000,20000,20000
053311,同欣電凱基96購01,0,0,0,0,0,0,0,0,0,20000,0,0,0,20000,0,20000,20000
053450,同欣電凱基96購02,0,0,0,0,0,0,0,0,0,20000,0,0,0,20000,0,20000,20000
05320P,華通凱基96售03  ,0,0,0,0,0,0,0,0,0,20000,0,0,0,20000,0,20000,20000
053228,康友台新97購01  ,0,0,0,0,0,0,0,0,0,20000,0,0,0,169000,149000,20000,20000
053159,同欣電元大96購02,0,0,0,0,0,0,0,0,0,20000,0,0,0,20000,0,20000,20000
053091,同欣電元大96購01,0,0,0,0,0,0,0,0,0,20000,0,0,0,20000,0,20000,20000
05295P,緯創凱基95售01  ,0,0,0,0,0,0,0,0,0,20000,0,0,0,20000,0,20000,20000
05297P,臻鼎凱基95售04  ,0,0,0,0,0,0,0,0,0,20000,0,0,0,20000,0,20000,20000
053025,燿華富邦98購02  ,0,0,0,0,0,0,0,0,0,20000,0,0,0,80000,60000,20000,20000
053040,全新凱基98購01  ,0,0,0,0,0,0,0,0,0,20000,0,0,0,20000,0,20000,20000
044142,華邦電群益91購01,0,0,0,0,0,0,0,0,0,20000,0,0,0,20000,0,20000,20000
044127,義隆凱基91購04  ,0,0,0,0,0,0,0,0,0,20000,0,0,0,40000,20000,20000,20000
044115,旺宏日盛91購01  ,0,0,0,0,0,0,0,0,0,20000,0,0,0,20000,0,20000,20000
044106,瀚宇博中信91購01,0,0,0,0,0,0,0,0,0,20000,0,0,0,20000,0,20000,20000
044182,鴻海元富92購01  ,0,0,0,0,0,0,0,0,0,20000,0,0,0,20000,0,20000,20000
04417P,光罩國泰95售02  ,0,0,0,0,0,0,0,0,0,20000,0,0,0,20000,0,20000,20000
044180,鴻海元富91購01  ,0,0,0,0,0,0,0,0,0,20000,0,0,0,20000,0,20000,20000
04419P,奇力新永豐94售01,0,0,0,0,0,0,0,0,0,20000,0,0,0,45000,25000,20000,20000
044258,超眾元大92購02  ,0,0,0,0,0,0,0,0,0,20000,0,0,0,20000,0,20000,20000
044270,群創中信95購02  ,0,0,0,0,0,0,0,0,0,20000,0,0,0,30000,10000,20000,20000
044277,彩晶群益92購01  ,0,0,0,0,0,0,0,0,0,20000,0,0,0,20000,0,20000,20000
045688,祥碩元大92購01  ,0,0,0,0,0,0,0,0,0,20000,0,0,0,20000,0,20000,20000
043810,祥碩永豐91購01  ,0,0,0,0,0,0,0,0,0,20000,0,0,0,20000,0,20000,20000
043888,台郡元大91購03  ,0,0,0,0,0,0,0,0,0,20000,0,0,0,30000,10000,20000,20000
046270,智易凱基92購02  ,0,0,0,0,0,0,0,0,0,20000,0,0,0,20000,0,20000,20000
046288,創意兆豐92購03  ,0,0,0,0,0,0,0,0,0,20000,0,0,0,20000,0,20000,20000
047737,義隆麥證94購01  ,0,0,0,20000,0,20000,0,0,0,20000,0,0,0,20000,0,20000,20000
048298,華通麥證94購01  ,0,0,0,50000,30000,20000,0,0,0,20000,0,0,0,50000,30000,20000,20000
048264,華新科元富93購01,0,0,0,0,0,0,0,0,0,20000,0,0,0,20000,0,20000,20000
046315,淘帝元大92購01  ,0,0,0,0,0,0,0,0,0,20000,0,0,0,20000,0,20000,20000
046330,祥碩元大92購02  ,0,0,0,0,0,0,0,0,0,20000,0,0,0,20000,0,20000,20000
046332,同欣電元大92購01,0,0,0,0,0,0,0,0,0,20000,0,0,0,20000,0,20000,20000
045167,玉晶光富邦92購01,0,0,0,0,0,0,0,0,0,20000,0,0,0,20000,0,20000,20000
045061,聯茂台新93購01  ,0,0,0,0,0,0,0,0,0,20000,0,0,0,20000,0,20000,20000
045055,聯發科元富98購03,0,0,0,0,0,0,0,0,0,20000,0,0,0,40000,20000,20000,20000
044713,南電元大91購04  ,0,0,0,0,0,0,0,0,0,20000,0,0,0,20000,0,20000,20000
044763,瀚宇博凱基93購01,0,0,0,0,0,0,0,0,0,20000,0,0,0,20000,0,20000,20000
044889,台泥凱基91購01  ,0,0,0,0,0,0,0,0,0,20000,0,0,0,20000,0,20000,20000
045203,同欣電凱基92購01,0,0,0,0,0,0,0,0,0,20000,0,0,0,30000,10000,20000,20000
045246,同欣電群益92購01,0,0,0,0,0,0,0,0,0,20000,0,0,0,20000,0,20000,20000
045247,遠東新凱基92購01,0,0,0,0,0,0,0,0,0,20000,0,0,0,77000,57000,20000,20000
045322,京元電統一92購02,0,0,0,0,0,0,0,0,0,20000,0,0,0,50000,30000,20000,20000
045457,光磊元大93購01  ,0,0,0,0,0,0,0,0,0,20000,0,0,0,40000,20000,20000,20000
045567,滬深2X富邦93購01,0,0,0,0,0,0,0,0,0,20000,0,0,0,20000,0,20000,20000
045528,宏達電永豐92購01,0,0,0,0,0,0,0,0,0,20000,0,0,0,20000,0,20000,20000
045517,元油2X元富98購01,0,0,0,0,0,0,0,0,0,20000,0,0,0,20000,0,20000,20000
043956,聯茂統一91購02  ,0,0,0,0,0,0,0,0,0,20000,0,0,0,20000,0,20000,20000
043949,啟碁兆豐91購01  ,0,0,0,0,0,0,0,0,0,20000,0,0,0,20000,0,20000,20000
043915,聯詠凱基91購03  ,0,0,0,0,0,0,0,0,0,20000,0,0,0,20000,0,20000,20000
043987,禾伸堂元大91購01,0,0,0,0,0,0,0,0,0,20000,0,0,0,40000,20000,20000,20000
043982,華邦電元大91購01,0,0,0,0,0,0,0,0,0,20000,0,0,0,20000,0,20000,20000
041817,鴻海凱基92購01  ,0,0,0,0,0,0,0,0,0,20000,0,0,0,20000,0,20000,20000
042152,亞光群益91購01  ,0,0,0,0,0,0,0,0,0,20000,0,0,0,30000,10000,20000,20000
04247P,宏達電永豐93售02,0,0,0,0,0,0,0,0,0,20000,0,0,0,20000,0,20000,20000
042792,T50反1台新9C購01,0,0,0,0,0,0,0,0,0,20000,0,0,0,20000,0,20000,20000
043137,嘉聯益永豐92購01,0,0,0,0,0,0,0,0,0,20000,0,0,0,20000,0,20000,20000
044354,奇鋐元大93購02  ,0,0,0,0,0,0,0,0,0,20000,0,0,0,45000,25000,20000,20000
043577,欣興統一91購01  ,0,0,0,0,0,0,0,0,0,20000,0,0,0,20000,0,20000,20000
04460P,元油2X元富96售04,0,0,0,0,0,0,0,0,0,20000,0,0,0,20000,0,20000,20000
044673,上銀凱基93購04  ,0,0,0,0,0,0,0,0,0,20000,0,0,0,60000,40000,20000,20000
04455P,台積電統一94售07,0,0,0,0,0,0,0,0,0,20000,0,0,0,50000,30000,20000,20000
044570,智邦凱基91購06  ,0,0,0,0,0,0,0,0,0,20000,0,0,0,20000,0,20000,20000
044500,超眾元大92購03  ,0,0,0,0,0,0,0,0,0,20000,0,0,0,20000,0,20000,20000
04059P,臺股指群益93售13,0,0,0,0,0,0,0,0,0,20000,0,0,0,20000,0,20000,20000
04043P,復盛元富93售02  ,0,0,0,0,0,0,0,0,0,20000,0,0,0,30000,10000,20000,20000
040039,上証2X元大91購01,0,0,0,0,0,0,0,0,0,20000,0,0,0,20000,0,20000,20000
03240P,臺股指元大02售05,0,0,0,0,0,0,0,0,0,20000,0,0,0,20000,0,20000,20000
03417P,瑞昱群益04售01  ,0,0,0,0,0,0,0,0,0,20000,0,0,0,40000,20000,20000,20000
03458P,玉晶光凱基03售08,0,0,0,0,0,0,0,0,0,20000,0,0,0,20000,0,20000,20000
047568,創意國票93購03  ,0,0,0,0,0,0,0,0,0,20000,0,0,0,20000,0,20000,20000
047675,群創元富96購03  ,0,0,0,0,0,0,0,0,0,20000,0,0,0,20000,0,20000,20000
048189,臺指反元大96購06,0,0,0,0,0,0,0,0,0,20000,0,0,0,20000,0,20000,20000
049285,宏碁兆豐94購01  ,0,0,0,0,0,0,0,0,0,20000,0,0,0,30000,10000,20000,20000
049334,上銀統一94購01  ,0,0,0,0,0,0,0,0,0,20000,0,0,0,20000,0,20000,20000
049336,台達電統一94購02,0,0,0,0,0,0,0,0,0,20000,0,0,0,20000,0,20000,20000
049014,台達電群益94購02,0,0,0,0,0,0,0,0,0,20000,0,0,0,55000,35000,20000,20000
049002,光寶科中信94購01,0,0,0,0,0,0,0,0,0,20000,0,0,0,20000,0,20000,20000
049144,瑞昱元大94購03  ,0,0,0,0,0,0,0,0,0,20000,0,0,0,20000,0,20000,20000
049173,鴻海凱基94購15  ,0,0,0,0,0,0,0,0,0,20000,0,0,0,41000,21000,20000,20000
048711,台郡台新94購01  ,0,0,0,0,0,0,0,0,0,20000,0,0,0,20000,0,20000,20000
048757,美利達元富96購01,0,0,0,0,0,0,0,0,0,20000,0,0,0,20000,0,20000,20000
04877P,聯發科麥證94售04,0,0,0,100000,80000,20000,0,0,0,20000,0,0,0,100000,80000,20000,20000
048748,國巨元富96購01  ,0,0,0,0,0,0,0,0,0,20000,0,0,0,20000,0,20000,20000
047068,南電凱基93購04  ,0,0,0,0,0,0,0,0,0,20000,0,0,0,20000,0,20000,20000
048669,強茂永豐93購01  ,0,0,0,0,0,0,0,0,0,20000,0,0,0,20000,0,20000,20000
048907,高鐵富邦94購01  ,0,0,0,0,0,0,0,0,0,20000,0,0,0,20000,0,20000,20000
04890P,台積電元大95售05,0,0,0,0,0,0,0,0,0,20000,0,0,0,20000,0,20000,20000
048910,和鑫富邦98購01  ,0,0,0,0,0,0,0,0,0,20000,0,0,0,60000,40000,20000,20000
047239,瀚宇博凱基94購01,0,0,0,0,0,0,0,0,0,20000,0,0,0,20000,0,20000,20000
048155,瑞昱兆豐93購01  ,0,0,0,0,0,0,0,0,0,20000,0,0,0,335000,315000,20000,20000
047261,聯詠國票93購02  ,0,0,0,0,0,0,0,0,0,20000,0,0,0,20000,0,20000,20000
047263,揚明光國票94購01,0,0,0,0,0,0,0,0,0,20000,0,0,0,20000,0,20000,20000
047283,世紀鋼永豐93購02,0,0,0,0,0,0,0,0,0,20000,0,0,0,20000,0,20000,20000
047509,技嘉國票93購01  ,0,0,0,0,0,0,0,0,0,20000,0,0,0,20000,0,20000,20000
047526,可成元大93購08  ,0,0,0,0,0,0,0,0,0,20000,0,0,0,50000,30000,20000,20000
048995,宏全元大94購01  ,0,0,0,0,0,0,0,0,0,20000,0,0,0,30000,10000,20000,20000
048970,裕民元大94購01  ,0,0,0,0,0,0,0,0,0,20000,0,0,0,20000,0,20000,20000
048391,友訊國票94購01  ,0,0,0,0,0,0,0,0,0,20000,0,0,0,28000,8000,20000,20000
048453,嘉澤凱基93購05  ,0,0,0,0,0,0,0,0,0,20000,0,0,0,59000,39000,20000,20000
048444,燿華凱基93購05  ,0,0,0,0,0,0,0,0,0,20000,0,0,0,20000,0,20000,20000
047843,超眾元大93購02  ,0,0,0,0,0,0,0,0,0,20000,0,0,0,20000,0,20000,20000
047846,滬深2X統一93購04,0,0,0,0,0,0,0,0,0,20000,0,0,0,20000,0,20000,20000
046626,台光電統一94購01,0,0,0,0,0,0,0,0,0,20000,0,0,0,70000,50000,20000,20000
046569,同欣電元富92購02,0,0,0,0,0,0,0,0,0,20000,0,0,0,30000,10000,20000,20000
048567,台郡元大93購03  ,0,0,0,0,0,0,0,0,0,20000,0,0,0,30000,10000,20000,20000
046521,台郡元大92購06  ,0,0,0,0,0,0,0,0,0,20000,0,0,0,30000,10000,20000,20000
046462,康控凱基92購01  ,0,0,0,0,0,0,0,0,0,20000,0,0,0,20000,0,20000,20000
046497,鴻海元大92購17  ,0,0,0,0,0,0,0,0,0,20000,0,0,0,95000,75000,20000,20000
046084,美利達凱基92購02,0,0,0,0,0,0,0,0,0,20000,0,0,0,20000,0,20000,20000
046080,同欣電凱基92購03,0,0,0,0,0,0,0,0,0,20000,0,0,0,20000,0,20000,20000
04606P,高股息中信96售01,0,0,0,0,0,0,0,0,0,20000,0,0,0,20000,0,20000,20000
046061,中石化凱基98購01,0,0,0,0,0,0,0,0,0,20000,0,0,0,70000,50000,20000,20000
04602P,聯詠凱基94售02  ,0,0,0,0,0,0,0,0,0,20000,0,0,0,20000,0,20000,20000
045900,臻鼎元大92購05  ,0,0,0,0,0,0,0,0,0,20000,0,0,0,20000,0,20000,20000
045926,康控康和92購01  ,0,0,0,0,0,0,0,0,0,20000,0,0,0,30000,10000,20000,20000
046852,燿華元大93購02  ,0,0,0,0,0,0,0,0,0,20000,0,0,0,93000,73000,20000,20000
046880,瑞昱永昌93購01  ,0,0,0,0,0,0,0,0,0,20000,0,0,0,31000,11000,20000,20000
048085,鴻海凱基93購32  ,0,0,0,0,0,0,0,0,0,20000,0,0,0,43000,23000,20000,20000
047414,智邦永昌93購01  ,0,0,0,0,0,0,0,0,0,20000,0,0,0,20000,0,20000,20000
046901,英業達凱基93購02,0,0,0,0,0,0,0,0,0,20000,0,0,0,20000,0,20000,20000
046903,友達凱基99購01  ,0,0,0,0,0,0,0,0,0,20000,0,0,0,41000,21000,20000,20000
046927,上銀富邦95購01  ,0,0,0,0,0,0,0,0,0,20000,0,0,0,22000,2000,20000,20000
051886,道瓊反統一95購03,0,0,0,0,0,0,0,0,0,20000,0,0,0,30000,10000,20000,20000
051829,玉晶光元大98購02,0,0,0,0,0,0,0,0,0,20000,0,0,0,30000,10000,20000,20000
051626,可成麥證95購02  ,0,0,0,20000,0,20000,0,0,0,20000,0,0,0,20000,0,20000,20000
052072,健策統一95購02  ,0,0,0,0,0,0,0,0,0,20000,0,0,0,66000,46000,20000,20000
051898,富邦金國泰97購01,0,0,0,0,0,0,0,0,0,20000,0,0,0,20000,0,20000,20000
051969,世紀鋼永豐95購01,0,0,0,0,0,0,0,0,0,20000,0,0,0,20000,0,20000,20000
051312,國泰金麥證95購01,0,0,0,30000,10000,20000,0,0,0,20000,0,0,0,30000,10000,20000,20000
051255,康控元大96購04  ,0,0,0,0,0,0,0,0,0,20000,0,0,0,20000,0,20000,20000
051365,瀚宇博國泰97購01,0,0,0,0,0,0,0,0,0,20000,0,0,0,20000,0,20000,20000
051388,大立光麥證95購03,0,0,0,20000,0,20000,0,0,0,20000,0,0,0,20000,0,20000,20000
051095,貿聯元大95購03  ,0,0,0,0,0,0,0,0,0,20000,0,0,0,20000,0,20000,20000
051100,同欣電元大95購01,0,0,0,0,0,0,0,0,0,20000,0,0,0,20000,0,20000,20000
051206,大立光麥證95購02,0,0,0,20000,0,20000,0,0,0,20000,0,0,0,20000,0,20000,20000
051199,鴻海麥證95購03  ,0,0,0,30000,10000,20000,0,0,0,20000,0,0,0,30000,10000,20000,20000
051014,智邦凱基95購01  ,0,0,0,0,0,0,0,0,0,20000,0,0,0,20000,0,20000,20000
050995,貿聯元大95購02  ,0,0,0,0,0,0,0,0,0,20000,0,0,0,106000,86000,20000,20000
049498,茂林元大95購01  ,0,0,0,0,0,0,0,0,0,20000,0,0,0,20000,0,20000,20000
049515,同欣電凱基94購01,0,0,0,0,0,0,0,0,0,20000,0,0,0,20000,0,20000,20000
049540,楠梓電群益94購01,0,0,0,0,0,0,0,0,0,20000,0,0,0,20000,0,20000,20000
049501,台郡元大95購01  ,0,0,0,0,0,0,0,0,0,20000,0,0,0,70000,50000,20000,20000
049415,智邦凱基94購02  ,0,0,0,0,0,0,0,0,0,20000,0,0,0,20000,0,20000,20000
049723,緯穎凱基94購04  ,0,0,0,0,0,0,0,0,0,20000,0,0,0,20000,0,20000,20000
049659,旺宏台新95購01  ,0,0,0,0,0,0,0,0,0,20000,0,0,0,20000,0,20000,20000
049816,緯穎元大94購07  ,0,0,0,0,0,0,0,0,0,20000,0,0,0,39000,19000,20000,20000
050441,和碩凱基94購01  ,0,0,0,0,0,0,0,0,0,20000,0,0,0,20000,0,20000,20000
050443,復盛凱基94購02  ,0,0,0,0,0,0,0,0,0,20000,0,0,0,36000,16000,20000,20000
050406,台積電台新95購02,0,0,0,0,0,0,0,0,0,20000,0,0,0,20000,0,20000,20000
050475,揚明光永豐95購01,0,0,0,0,0,0,0,0,0,20000,0,0,0,20000,0,20000,20000
050244,富邦金凱基94購01,0,0,0,0,0,0,0,0,0,20000,0,0,0,20000,0,20000,20000
05064P,台積電元大95售10,0,0,0,0,0,0,0,0,0,20000,0,0,0,20000,0,20000,20000
050641,上証反凱基96購01,0,0,0,0,0,0,0,0,0,20000,0,0,0,519000,499000,20000,20000
05075P,台積電麥證95售01,0,0,0,60000,40000,20000,0,0,0,20000,0,0,0,60000,40000,20000,20000
050899,旭富元大95購01  ,0,0,0,0,0,0,0,0,0,20000,0,0,0,20000,0,20000,20000
050825,嘉澤凱基95購01  ,0,0,0,0,0,0,0,0,0,20000,0,0,0,27000,7000,20000,20000
3356,奇偶            ,59000,39000,20000,0,0,0,0,0,0,0,0,0,0,0,0,0,20000
05700P,臻鼎凱基96售02  ,0,0,0,0,0,0,0,0,0,20000,0,0,0,20000,0,20000,20000
05627P,致伸國票97售01  ,0,0,0,0,0,0,0,0,0,20000,0,0,0,20000,0,20000,20000
05897P,國巨凱基96售12  ,0,0,0,0,0,0,0,0,0,20000,0,0,0,180000,160000,20000,20000
05917P,宏達電元大96售02,0,0,0,0,0,0,0,0,0,20000,0,0,0,60000,40000,20000,20000
1410,南染            ,21000,1000,20000,0,0,0,0,0,0,0,0,0,0,0,0,0,20000
06021P,世紀鋼元富96售03,0,0,0,0,0,0,0,0,0,20000,0,0,0,20000,0,20000,20000
5525,順天            ,32000,12000,20000,0,0,0,0,0,0,0,0,0,0,0,0,0,20000
053740,元油反國票99購01,0,0,0,0,0,0,0,0,0,19000,0,0,0,19000,0,19000,19000
053791,同欣電元大96購05,0,0,0,0,0,0,0,0,0,19000,0,0,0,19000,0,19000,19000
05398P,康控國票96售03  ,0,0,0,0,0,0,0,0,0,19000,0,0,0,50000,31000,19000,19000
054193,鴻海麥證96購02  ,0,0,0,20000,1000,19000,0,0,0,19000,0,0,0,20000,1000,19000,19000
054680,華新科康和97購02,0,0,0,0,0,0,0,0,0,19000,0,0,0,50000,31000,19000,19000
054215,創意國票97購02  ,0,0,0,0,0,0,0,0,0,19000,0,0,0,34000,15000,19000,19000
00665L,富邦恒生國企正2 ,94000,0,94000,0,0,0,0,0,0,-75000,0,0,0,7000,82000,-75000,19000
006204,永豐臺灣加權    ,0,0,0,0,0,0,0,0,0,19000,0,0,0,61000,42000,19000,19000
00865B,國泰US短期公債  ,0,0,0,0,0,0,0,0,0,19000,0,0,0,22000,3000,19000,19000
03128P,玉晶光國泰03售04,0,0,0,0,0,0,0,0,0,19000,0,0,0,19000,0,19000,19000
045015,玉晶光元大94購01,0,0,0,0,0,0,0,0,0,19000,0,0,0,59000,40000,19000,19000
044307,GIS兆豐93購01   ,0,0,0,0,0,0,0,0,0,19000,0,0,0,159000,140000,19000,19000
048025,鴻海凱基93購30  ,0,0,0,0,0,0,0,0,0,19000,0,0,0,34000,15000,19000,19000
047368,南電群益93購01  ,0,0,0,0,0,0,0,0,0,19000,0,0,0,30000,11000,19000,19000
045853,緯穎永豐92購02  ,0,0,0,0,0,0,0,0,0,19000,0,0,0,149000,130000,19000,19000
045878,欣興元富92購02  ,0,0,0,0,0,0,0,0,0,19000,0,0,0,19000,0,19000,19000
046737,鴻海群益93購04  ,0,0,0,0,0,0,0,0,0,19000,0,0,0,74000,55000,19000,19000
047149,聯鈞群益93購01  ,0,0,0,0,0,0,0,0,0,19000,0,0,0,201000,182000,19000,19000
050425,國巨凱基94購12  ,0,0,0,0,0,0,0,0,0,19000,0,0,0,25000,6000,19000,19000
049877,南亞科永豐94購01,0,0,0,0,0,0,0,0,0,19000,0,0,0,87000,68000,19000,19000
050176,正崴元大94購03  ,0,0,0,0,0,0,0,0,0,19000,0,0,0,20000,1000,19000,19000
051179,臺股指凱基95購04,0,0,0,0,0,0,0,0,0,19000,0,0,0,19000,0,19000,19000
051378,奇力新群益95購01,0,0,0,0,0,0,0,0,0,19000,0,0,0,62000,43000,19000,19000
051463,世芯國泰97購02  ,0,0,0,0,0,0,0,0,0,19000,0,0,0,22000,3000,19000,19000
051840,康友國泰97購02  ,0,0,0,0,0,0,0,0,0,19000,0,0,0,165000,146000,19000,19000
8422,可寧衛          ,28000,9000,19000,0,0,0,0,0,0,0,0,0,0,0,0,0,19000
06012P,世芯國票96售01  ,0,0,0,0,0,0,0,0,0,19000,0,0,0,24000,5000,19000,19000
1324,地球            ,19000,0,19000,0,0,0,0,0,0,0,0,0,0,0,0,0,19000
05886P,華通元富96售01  ,0,0,0,0,0,0,0,0,0,19000,0,0,0,238000,219000,19000,19000
05963P,貿聯國票97售02  ,0,0,0,0,0,0,0,0,0,19000,0,0,0,19000,0,19000,19000
05651P,大立光元大97售02,0,0,0,0,0,0,0,0,0,19000,0,0,0,21000,2000,19000,19000
3027,盛達            ,19000,3000,16000,0,0,0,0,0,0,3000,3000,0,3000,0,0,0,19000
2851,中再保          ,19000,0,19000,0,0,0,0,0,0,0,0,0,0,0,0,0,19000
1723,中碳            ,29000,10000,19000,0,0,0,0,0,0,0,0,0,0,0,0,0,19000
2429,銘旺科          ,27000,8000,19000,0,0,0,0,0,0,0,0,0,0,0,0,0,19000
054319,世紀鋼凱基96購02,0,0,0,0,0,0,0,0,0,18000,0,0,0,18000,0,18000,18000
054499,台光電永豐96購02,0,0,0,0,0,0,0,0,0,18000,0,0,0,18000,0,18000,18000
054533,泰碩國泰98購01  ,0,0,0,0,0,0,0,0,0,18000,0,0,0,18000,0,18000,18000
053727,麗豐凱基97購01  ,0,0,0,0,0,0,0,0,0,18000,0,0,0,50000,32000,18000,18000
053636,全新永豐96購02  ,0,0,0,0,0,0,0,0,0,18000,0,0,0,68000,50000,18000,18000
053611,聯茂麥證96購01  ,0,0,0,50000,32000,18000,0,0,0,18000,0,0,0,50000,32000,18000,18000
053037,國巨凱基96購08  ,0,0,0,0,0,0,0,0,0,18000,0,0,0,125000,107000,18000,18000
053411,深中小國票9B購01,0,0,0,0,0,0,0,0,0,18000,0,0,0,30000,12000,18000,18000
052788,開發金中信98購02,0,0,0,0,0,0,0,0,0,18000,0,0,0,18000,0,18000,18000
045795,瀚宇博兆豐94購01,0,0,0,0,0,0,0,0,0,18000,0,0,0,20000,2000,18000,18000
03178P,台積電群益01售23,0,0,0,0,0,0,0,0,0,18000,0,0,0,18000,0,18000,18000
04085P,欣興元富93售01  ,0,0,0,0,0,0,0,0,0,18000,0,0,0,18000,0,18000,18000
044480,瀚宇博統一91購01,0,0,0,0,0,0,0,0,0,18000,0,0,0,20000,2000,18000,18000
043557,元金2X永豐92購01,0,0,0,0,0,0,0,0,0,18000,0,0,0,18000,0,18000,18000
044407,聯茂凱基93購01  ,0,0,0,0,0,0,0,0,0,18000,0,0,0,28000,10000,18000,18000
044415,瑞昱統一91購02  ,0,0,0,0,0,0,0,0,0,18000,0,0,0,18000,0,18000,18000
047540,技嘉麥證93購01  ,0,0,0,33000,15000,18000,0,0,0,18000,0,0,0,33000,15000,18000,18000
047447,台郡元大94購02  ,0,0,0,0,0,0,0,0,0,18000,0,0,0,85000,67000,18000,18000
048800,瑞昱富邦94購01  ,0,0,0,0,0,0,0,0,0,18000,0,0,0,25000,7000,18000,18000
049189,訊芯康和94購01  ,0,0,0,0,0,0,0,0,0,18000,0,0,0,23000,5000,18000,18000
047354,訊芯凱基94購01  ,0,0,0,0,0,0,0,0,0,18000,0,0,0,51000,33000,18000,18000
047670,矽力永豐93購01  ,0,0,0,0,0,0,0,0,0,18000,0,0,0,20000,2000,18000,18000
047547,友達凱基99購02  ,0,0,0,0,0,0,0,0,0,18000,0,0,0,22000,4000,18000,18000
046604,康控群益93購02  ,0,0,0,0,0,0,0,0,0,18000,0,0,0,28000,10000,18000,18000
047950,滬深2X永豐94購02,0,0,0,0,0,0,0,0,0,18000,0,0,0,20000,2000,18000,18000
048476,同欣電永豐93購01,0,0,0,0,0,0,0,0,0,18000,0,0,0,40000,22000,18000,18000
051716,康控康和95購01  ,0,0,0,0,0,0,0,0,0,18000,0,0,0,45000,27000,18000,18000
051967,康友永豐95購02  ,0,0,0,0,0,0,0,0,0,18000,0,0,0,162000,144000,18000,18000
051945,智邦統一95購03  ,0,0,0,0,0,0,0,0,0,18000,0,0,0,58000,40000,18000,18000
051410,京元電國票96購01,0,0,0,0,0,0,0,0,0,18000,0,0,0,352000,334000,18000,18000
05152P,玉晶光群益96售05,0,0,0,0,0,0,0,0,0,18000,0,0,0,18000,0,18000,18000
051317,亞德客國票96購01,0,0,0,0,0,0,0,0,0,18000,0,0,0,18000,0,18000,18000
051304,緯創凱基96購01  ,0,0,0,0,0,0,0,0,0,18000,0,0,0,28000,10000,18000,18000
051183,建準永豐95購02  ,0,0,0,0,0,0,0,0,0,18000,0,0,0,30000,12000,18000,18000
049887,嘉聯益永昌95購01,0,0,0,0,0,0,0,0,0,18000,0,0,0,28000,10000,18000,18000
049888,智邦國泰96購01  ,0,0,0,0,0,0,0,0,0,18000,0,0,0,50000,32000,18000,18000
049746,全新永豐95購01  ,0,0,0,0,0,0,0,0,0,18000,0,0,0,68000,50000,18000,18000
049517,台光電國票94購02,0,0,0,0,0,0,0,0,0,18000,0,0,0,25000,7000,18000,18000
050745,茂林永豐94購06  ,0,0,0,0,0,0,0,0,0,18000,0,0,0,20000,2000,18000,18000
05056P,訊芯群益95售01  ,0,0,0,0,0,0,0,0,0,18000,0,0,0,60000,42000,18000,18000
1735,日勝化          ,19000,1000,18000,0,0,0,0,0,0,0,0,0,0,0,0,0,18000
2012,春雨            ,18000,0,18000,0,0,0,0,0,0,0,0,0,0,0,0,0,18000
2838A,聯邦銀甲特      ,0,0,0,0,0,0,0,0,0,18000,53000,35000,18000,0,0,0,18000
05625P,國巨國票97售01  ,0,0,0,0,0,0,0,0,0,18000,0,0,0,56000,38000,18000,18000
05884P,旺宏統一96售01  ,0,0,0,0,0,0,0,0,0,18000,0,0,0,83000,65000,18000,18000
1438,裕豐            ,18000,0,18000,0,0,0,0,0,0,0,0,0,0,0,0,0,18000
1616,億泰            ,18000,0,18000,0,0,0,0,0,0,0,0,0,0,0,0,0,18000
06041P,全新永豐96售03  ,0,0,0,0,0,0,0,0,0,18000,0,0,0,27000,9000,18000,18000
05982P,漢唐國票96售03  ,0,0,0,0,0,0,0,0,0,18000,0,0,0,18000,0,18000,18000
06071P,大立光永豐97售01,0,0,0,0,0,0,0,0,0,18000,0,0,0,56000,38000,18000,18000
8443,阿瘦            ,20000,2000,18000,0,0,0,0,0,0,0,0,0,0,0,0,0,18000
6133,金橋            ,18000,0,18000,0,0,0,0,0,0,0,0,0,0,0,0,0,18000
6206,飛捷            ,46000,48000,-2000,0,0,0,0,0,0,20000,20000,0,20000,0,0,0,18000
052803,冠德元大96購01  ,0,0,0,0,0,0,0,0,0,17000,0,0,0,17000,0,17000,17000
052404,臻鼎凱基95購05  ,0,0,0,0,0,0,0,0,0,17000,0,0,0,40000,23000,17000,17000
053054,禾伸堂國票97購01,0,0,0,0,0,0,0,0,0,17000,0,0,0,112000,95000,17000,17000
053143,昇陽半永豐96購03,0,0,0,0,0,0,0,0,0,17000,0,0,0,23000,6000,17000,17000
053743,康控國票97購02  ,0,0,0,0,0,0,0,0,0,17000,0,0,0,17000,0,17000,17000
05411P,台積電國票96售08,0,0,0,0,0,0,0,0,0,17000,0,0,0,17000,0,17000,17000
05443P,宏達電元大95售05,0,0,0,0,0,0,0,0,0,17000,0,0,0,17000,0,17000,17000
044369,全新永豐91購03  ,0,0,0,0,0,0,0,0,0,17000,0,0,0,41000,24000,17000,17000
044375,亞光兆豐92購01  ,0,0,0,0,0,0,0,0,0,17000,0,0,0,54000,37000,17000,17000
03932P,欣興統一93售01  ,0,0,0,0,0,0,0,0,0,17000,0,0,0,106000,89000,17000,17000
045782,欣興元大93購04  ,0,0,0,0,0,0,0,0,0,17000,0,0,0,17000,0,17000,17000
047773,超眾元大96購01  ,0,0,0,0,0,0,0,0,0,17000,0,0,0,22000,5000,17000,17000
047786,燿華群益93購03  ,0,0,0,0,0,0,0,0,0,17000,0,0,0,20000,3000,17000,17000
048310,台達電凱基93購05,0,0,0,0,0,0,0,0,0,17000,0,0,0,17000,0,17000,17000
044817,可成兆豐93購01  ,0,0,0,0,0,0,0,0,0,17000,0,0,0,20000,3000,17000,17000
044818,可成兆豐93購02  ,0,0,0,0,0,0,0,0,0,17000,0,0,0,25000,8000,17000,17000
046427,樺漢元大92購02  ,0,0,0,0,0,0,0,0,0,17000,0,0,0,60000,43000,17000,17000
047975,緯創兆豐93購01  ,0,0,0,0,0,0,0,0,0,17000,0,0,0,20000,3000,17000,17000
049958,華新科統一94購08,0,0,0,0,0,0,0,0,0,17000,0,0,0,17000,0,17000,17000
048918,上証2X永豐94購01,0,0,0,0,0,0,0,0,0,17000,0,0,0,47000,30000,17000,17000
05073P,臺股指中信95售09,0,0,0,0,0,0,0,0,0,17000,0,0,0,20000,3000,17000,17000
049594,揚明光元大95購01,0,0,0,0,0,0,0,0,0,17000,0,0,0,27000,10000,17000,17000
049438,嘉晶國泰96購01  ,0,0,0,0,0,0,0,0,0,17000,0,0,0,158000,141000,17000,17000
049769,和鑫元富96購01  ,0,0,0,0,0,0,0,0,0,17000,0,0,0,27000,10000,17000,17000
050016,緯穎富邦95購01  ,0,0,0,0,0,0,0,0,0,17000,0,0,0,19000,2000,17000,17000
051031,康友元富95購02  ,0,0,0,0,0,0,0,0,0,17000,0,0,0,425000,408000,17000,17000
051765,健鼎元大95購03  ,0,0,0,0,0,0,0,0,0,17000,0,0,0,22000,5000,17000,17000
8940,新天地          ,17000,0,17000,0,0,0,0,0,0,0,0,0,0,0,0,0,17000
9925,新保            ,33000,16000,17000,0,0,0,0,0,0,0,0,0,0,0,0,0,17000
3024,憶聲            ,39000,22000,17000,0,0,0,0,0,0,0,0,0,0,0,0,0,17000
1760,寶齡富錦        ,26000,6000,20000,0,0,0,0,0,0,-3000,0,0,0,1000,4000,-3000,17000
2477,美隆電          ,25000,7000,18000,0,0,0,0,0,0,-1000,0,1000,-1000,0,0,0,17000
2493,揚博            ,28000,11000,17000,0,0,0,0,0,0,0,0,0,0,0,0,0,17000
2015,豐興            ,71000,67681,3319,0,0,0,0,0,0,13000,13000,0,13000,0,0,0,16319
054670,康友元富97購01  ,0,0,0,0,0,0,0,0,0,16000,0,0,0,16000,0,16000,16000
054113,奇力新台新97購01,0,0,0,0,0,0,0,0,0,16000,0,0,0,24000,8000,16000,16000
053888,和大群益97購01  ,0,0,0,0,0,0,0,0,0,16000,0,0,0,143000,127000,16000,16000
053760,牧德國泰98購01  ,0,0,0,0,0,0,0,0,0,16000,0,0,0,214000,198000,16000,16000
053735,矽力中信97購01  ,0,0,0,0,0,0,0,0,0,16000,0,0,0,48000,32000,16000,16000
053392,致新元大96購01  ,0,0,0,0,0,0,0,0,0,16000,0,0,0,202000,186000,16000,16000
053463,可成富邦98購01  ,0,0,0,0,0,0,0,0,0,16000,0,0,0,23000,7000,16000,16000
053545,上銀凱基96購03  ,0,0,0,0,0,0,0,0,0,16000,0,0,0,16000,0,16000,16000
052558,新唐國票97購01  ,0,0,0,0,0,0,0,0,0,16000,0,0,0,16000,0,16000,16000
052543,聯詠元富95購01  ,0,0,0,0,0,0,0,0,0,16000,0,0,0,16000,0,16000,16000
052252,大立光永豐95購03,0,0,0,0,0,0,0,0,0,16000,0,0,0,37000,21000,16000,16000
052309,健策國泰97購01  ,0,0,0,0,0,0,0,0,0,16000,0,0,0,26000,10000,16000,16000
05230P,京元電群益95售01,0,0,0,0,0,0,0,0,0,16000,0,0,0,121000,105000,16000,16000
043907,鴻海凱基93購01  ,0,0,0,0,0,0,0,0,0,16000,0,0,0,38000,22000,16000,16000
047789,景碩群益93購01  ,0,0,0,0,0,0,0,0,0,16000,0,0,0,98000,82000,16000,16000
045797,健策中信93購01  ,0,0,0,0,0,0,0,0,0,16000,0,0,0,27000,11000,16000,16000
045751,智邦國泰93購01  ,0,0,0,0,0,0,0,0,0,16000,0,0,0,26000,10000,16000,16000
03202P,聯電凱基01售03  ,0,0,0,0,0,0,0,0,0,16000,0,0,0,16000,0,16000,16000
00656R,國泰中國A50反1  ,0,2000,-2000,0,0,0,0,0,0,18000,0,0,0,100000,82000,18000,16000
04230P,臺股指中信95售06,0,0,0,0,0,0,0,0,0,16000,0,0,0,20000,4000,16000,16000
048868,劍麟國票94購01  ,0,0,0,0,0,0,0,0,0,16000,0,0,0,39000,23000,16000,16000
047173,群創永豐93購01  ,0,0,0,0,0,0,0,0,0,16000,0,0,0,16000,0,16000,16000
048121,亞德客元大93購05,0,0,0,0,0,0,0,0,0,16000,0,0,0,56000,40000,16000,16000
049047,台達電台新94購01,0,0,0,0,0,0,0,0,0,16000,0,0,0,110000,94000,16000,16000
049168,卜蜂凱基94購01  ,0,0,0,0,0,0,0,0,0,16000,0,0,0,16000,0,16000,16000
047602,GIS中信93購02   ,0,0,0,0,0,0,0,0,0,16000,0,0,0,76000,60000,16000,16000
046843,上銀永豐93購01  ,0,0,0,0,0,0,0,0,0,16000,0,0,0,16000,0,16000,16000
046028,微星元大92購01  ,0,0,0,0,0,0,0,0,0,16000,0,0,0,19000,3000,16000,16000
047026,大毅元大93購02  ,0,0,0,0,0,0,0,0,0,16000,0,0,0,121000,105000,16000,16000
047814,宏達電凱基93購02,0,0,0,0,0,0,0,0,0,16000,0,0,0,22000,6000,16000,16000
051706,國泰金群益95購01,0,0,0,0,0,0,0,0,0,16000,0,0,0,16000,0,16000,16000
051652,昇陽半永豐96購02,0,0,0,0,0,0,0,0,0,16000,0,0,0,16000,0,16000,16000
051639,康友國票96購02  ,0,0,0,0,0,0,0,0,0,16000,0,0,0,46000,30000,16000,16000
05123P,鴻海永昌96售07  ,0,0,0,0,0,0,0,0,0,16000,0,0,0,40000,24000,16000,16000
050140,台郡第一94購01  ,0,0,0,0,0,0,0,0,0,16000,0,0,0,16000,0,16000,16000
050554,百和凱基95購01  ,0,0,0,0,0,0,0,0,0,16000,0,0,0,114000,98000,16000,16000
050241,聯發科凱基94購14,0,0,0,0,0,0,0,0,0,16000,0,0,0,36000,20000,16000,16000
1906,寶隆            ,20000,4000,16000,0,0,0,0,0,0,0,0,0,0,0,0,0,16000
2491,吉祥全          ,16000,0,16000,0,0,0,0,0,0,0,0,0,0,0,0,0,16000
1530,亞崴            ,16000,0,16000,0,0,0,0,0,0,0,0,0,0,0,0,0,16000
1232,大統益          ,19000,3000,16000,0,0,0,0,0,0,0,0,0,0,0,0,0,16000
2731,雄獅            ,20000,4132,15868,0,0,0,0,0,0,0,0,0,0,0,0,0,15868
05239P,欣興永豐95售03  ,0,0,0,0,0,0,0,0,0,15000,0,0,0,45000,30000,15000,15000
052832,益航群益96購01  ,0,0,0,0,0,0,0,0,0,15000,0,0,0,25000,10000,15000,15000
05291P,鴻海凱基95售16  ,0,0,0,0,0,0,0,0,0,15000,0,0,0,15000,0,15000,15000
052753,電子類元大96購02,0,0,0,0,0,0,0,0,0,15000,0,0,0,15000,0,15000,15000
052700,奇鋐國票97購02  ,0,0,0,0,0,0,0,0,0,15000,0,0,0,15000,0,15000,15000
053535,宏達電永豐96購02,0,0,0,0,0,0,0,0,0,15000,0,0,0,57000,42000,15000,15000
053526,正崴中信96購01  ,0,0,0,0,0,0,0,0,0,15000,0,0,0,15000,0,15000,15000
053481,同欣電元大97購01,0,0,0,0,0,0,0,0,0,15000,0,0,0,40000,25000,15000,15000
053397,國泰金中信96購01,0,0,0,0,0,0,0,0,0,15000,0,0,0,15000,0,15000,15000
053417,上銀永豐96購02  ,0,0,0,0,0,0,0,0,0,15000,0,0,0,45000,30000,15000,15000
05312P,臺股指群益95售11,0,0,0,0,0,0,0,0,0,15000,0,0,0,15000,0,15000,15000
053158,茂林元大96購01  ,0,0,0,0,0,0,0,0,0,15000,0,0,0,15000,0,15000,15000
053251,世紀鋼國票97購02,0,0,0,0,0,0,0,0,0,15000,0,0,0,15000,0,15000,15000
05489P,臺股指凱基95售22,0,0,0,0,0,0,0,0,0,15000,0,0,0,15000,0,15000,15000
054470,緯穎國票97購04  ,0,0,0,0,0,0,0,0,0,15000,0,0,0,17000,2000,15000,15000
054373,富邦金中信97購01,0,0,0,0,0,0,0,0,0,15000,0,0,0,15000,0,15000,15000
054295,世芯元大96購03  ,0,0,0,0,0,0,0,0,0,15000,0,0,0,20000,5000,15000,15000
054231,國巨群益98購03  ,0,0,0,0,0,0,0,0,0,15000,0,0,0,16000,1000,15000,15000
042942,永冠國票94購01  ,0,0,0,0,0,0,0,0,0,15000,0,0,0,15000,0,15000,15000
04289P,臺股指中信95售07,0,0,0,0,0,0,0,0,0,15000,0,0,0,15000,0,15000,15000
03145P,聯發科國票03售01,0,0,0,0,0,0,0,0,0,15000,0,0,0,15000,0,15000,15000
03119P,滬深2X元大01售13,0,0,0,0,0,0,0,0,0,15000,0,0,0,15000,0,15000,15000
03408P,南電國泰02售02  ,0,0,0,0,0,0,0,0,0,15000,0,0,0,15000,0,15000,15000
03025P,國巨元大01售12  ,0,0,0,0,0,0,0,0,0,15000,0,0,0,15000,0,15000,15000
03502P,奇力新元富03售01,0,0,0,0,0,0,0,0,0,15000,0,0,0,15000,0,15000,15000
040952,TPK群益91購01   ,0,0,0,0,0,0,0,0,0,15000,0,0,0,15000,0,15000,15000
043819,元金2X群益91購01,0,0,0,0,0,0,0,0,0,15000,0,0,0,15000,0,15000,15000
04568P,瑞昱兆豐94售02  ,0,0,0,0,0,0,0,0,0,15000,0,0,0,39000,24000,15000,15000
043729,和鑫國泰92購01  ,0,0,0,0,0,0,0,0,0,15000,0,0,0,30000,15000,15000,15000
044164,京元電元大92購01,0,0,0,0,0,0,0,0,0,15000,0,0,0,15000,0,15000,15000
044167,大立光元大93購03,0,0,0,0,0,0,0,0,0,15000,0,0,0,25000,10000,15000,15000
044101,聯茂國泰92購01  ,0,0,0,0,0,0,0,0,0,15000,0,0,0,15000,0,15000,15000
048291,台積電群益93購09,0,0,0,0,0,0,0,0,0,15000,0,0,0,18000,3000,15000,15000
048344,大立光元大93購30,0,0,0,0,0,0,0,0,0,15000,0,0,0,18000,3000,15000,15000
045530,明泰永豐92購01  ,0,0,0,0,0,0,0,0,0,15000,0,0,0,15000,0,15000,15000
045387,信邦元大92購01  ,0,0,0,0,0,0,0,0,0,15000,0,0,0,25000,10000,15000,15000
045251,鴻海凱基92購04  ,0,0,0,0,0,0,0,0,0,15000,0,0,0,15000,0,15000,15000
045258,漢唐凱基93購01  ,0,0,0,0,0,0,0,0,0,15000,0,0,0,15000,0,15000,15000
044875,玉晶光統一93購01,0,0,0,0,0,0,0,0,0,15000,0,0,0,26000,11000,15000,15000
04635P,臺股指群益94售10,0,0,0,0,0,0,0,0,0,15000,0,0,0,15000,0,15000,15000
048357,漢唐永豐93購04  ,0,0,0,0,0,0,0,0,0,15000,0,0,0,149000,134000,15000,15000
046684,致伸群益93購01  ,0,0,0,0,0,0,0,0,0,15000,0,0,0,15000,0,15000,15000
046510,大立光元大92購25,0,0,0,0,0,0,0,0,0,15000,0,0,0,18000,3000,15000,15000
04741P,台積電統一94售10,0,0,0,0,0,0,0,0,0,15000,0,0,0,15000,0,15000,15000
046981,智伸科兆豐94購01,0,0,0,0,0,0,0,0,0,15000,0,0,0,30000,15000,15000,15000
047372,創意國票94購01  ,0,0,0,0,0,0,0,0,0,15000,0,0,0,15000,0,15000,15000
047374,麗豐國票93購01  ,0,0,0,0,0,0,0,0,0,15000,0,0,0,15000,0,15000,15000
04607P,A50中信94售01   ,0,0,0,0,0,0,0,0,0,15000,0,0,0,15000,0,15000,15000
045971,智伸科凱基92購01,0,0,0,0,0,0,0,0,0,15000,0,0,0,15000,0,15000,15000
047653,上銀兆豐94購01  ,0,0,0,0,0,0,0,0,0,15000,0,0,0,15000,0,15000,15000
049318,樺漢凱基94購01  ,0,0,0,0,0,0,0,0,0,15000,0,0,0,15000,0,15000,15000
049124,可成元富94購02  ,0,0,0,0,0,0,0,0,0,15000,0,0,0,420000,405000,15000,15000
049242,佳世達元富96購01,0,0,0,0,0,0,0,0,0,15000,0,0,0,32000,17000,15000,15000
049258,美律元大94購03  ,0,0,0,0,0,0,0,0,0,15000,0,0,0,190000,175000,15000,15000
048149,泰鼎元富95購01  ,0,0,0,0,0,0,0,0,0,15000,0,0,0,15000,0,15000,15000
047450,南茂元大93購05  ,0,0,0,0,0,0,0,0,0,15000,0,0,0,20000,5000,15000,15000
047529,嘉晶元大94購02  ,0,0,0,0,0,0,0,0,0,15000,0,0,0,155000,140000,15000,15000
047077,日月光兆豐93購01,0,0,0,0,0,0,0,0,0,15000,0,0,0,50000,35000,15000,15000
048824,聯發科凱基94購03,0,0,0,0,0,0,0,0,0,15000,0,0,0,74000,59000,15000,15000
05030P,台積電元富95售04,0,0,0,0,0,0,0,0,0,15000,0,0,0,15000,0,15000,15000
050337,南電國泰95購01  ,0,0,0,0,0,0,0,0,0,15000,0,0,0,15000,0,15000,15000
050387,鴻海統一94購08  ,0,0,0,0,0,0,0,0,0,15000,0,0,0,67000,52000,15000,15000
050577,美律國票94購03  ,0,0,0,0,0,0,0,0,0,15000,0,0,0,15000,0,15000,15000
050864,亞光永豐95購01  ,0,0,0,0,0,0,0,0,0,15000,0,0,0,84000,69000,15000,15000
049861,正崴兆豐94購01  ,0,0,0,0,0,0,0,0,0,15000,0,0,0,20000,5000,15000,15000
04964P,鴻海元大94售26  ,0,0,0,0,0,0,0,0,0,15000,0,0,0,15000,0,15000,15000
049496,和鑫元大95購01  ,0,0,0,0,0,0,0,0,0,15000,0,0,0,26000,11000,15000,15000
049574,新日興統一94購03,0,0,0,0,0,0,0,0,0,15000,0,0,0,55000,40000,15000,15000
051177,可成凱基95購05  ,0,0,0,0,0,0,0,0,0,15000,0,0,0,15000,0,15000,15000
05113P,臺股指元富95售01,0,0,0,0,0,0,0,0,0,15000,0,0,0,15000,0,15000,15000
051321,建準國票96購01  ,0,0,0,0,0,0,0,0,0,15000,0,0,0,35000,20000,15000,15000
051566,鴻海富邦95購05  ,0,0,0,0,0,0,0,0,0,15000,0,0,0,30000,15000,15000,15000
051818,國巨統一95購02  ,0,0,0,0,0,0,0,0,0,15000,0,0,0,15000,0,15000,15000
051929,GIS中信96購01   ,0,0,0,0,0,0,0,0,0,15000,0,0,0,15000,0,15000,15000
052137,台表科凱基96購02,0,0,0,0,0,0,0,0,0,15000,0,0,0,187000,172000,15000,15000
052138,易華電凱基97購01,0,0,0,0,0,0,0,0,0,15000,0,0,0,15000,0,15000,15000
3591,艾笛森          ,20000,5000,15000,0,0,0,0,0,0,0,0,0,0,0,0,0,15000
2543,皇昌            ,15000,0,15000,0,0,0,0,0,0,0,0,0,0,0,0,0,15000
2373,震旦行          ,22000,5000,17000,0,0,0,0,0,0,-2000,0,2000,-2000,0,0,0,15000
1234,黑松            ,21000,6000,15000,0,0,0,0,0,0,0,0,0,0,0,0,0,15000
1468,昶和            ,15000,0,15000,0,0,0,0,0,0,0,0,0,0,0,0,0,15000
054525,奇鋐元富96購01  ,0,0,0,0,0,0,0,0,0,14000,0,0,0,14000,0,14000,14000
054197,台積電永昌96購07,0,0,0,0,0,0,0,0,0,14000,0,0,0,2300000,2286000,14000,14000
053155,晶技元大97購02  ,0,0,0,0,0,0,0,0,0,14000,0,0,0,14000,0,14000,14000
053429,彩晶永豐96購01  ,0,0,0,0,0,0,0,0,0,14000,0,0,0,17000,3000,14000,14000
053561,玉晶光國泰98購01,0,0,0,0,0,0,0,0,0,14000,0,0,0,70000,56000,14000,14000
052766,玉晶光群益9A購01,0,0,0,0,0,0,0,0,0,14000,0,0,0,18000,4000,14000,14000
044861,玉晶光兆豐93購01,0,0,0,0,0,0,0,0,0,14000,0,0,0,18000,4000,14000,14000
045568,上証2X元大95購01,0,0,0,0,0,0,0,0,0,14000,0,0,0,20000,6000,14000,14000
045646,瑞儀凱基93購05  ,0,0,0,0,0,0,0,0,0,14000,0,0,0,27000,13000,14000,14000
03049X,元展46          ,0,0,0,0,0,0,0,0,0,14000,0,0,0,14000,0,14000,14000
042561,南電兆豐92購01  ,0,0,0,0,0,0,0,0,0,14000,0,0,0,14000,0,14000,14000
043597,可成元大91購05  ,0,0,0,0,0,0,0,0,0,14000,0,0,0,14000,0,14000,14000
047084,嘉聯益永豐93購02,0,0,0,0,0,0,0,0,0,14000,0,0,0,74000,60000,14000,14000
047052,大毅國票93購01  ,0,0,0,0,0,0,0,0,0,14000,0,0,0,161000,147000,14000,14000
048624,美律台新93購01  ,0,0,0,0,0,0,0,0,0,14000,0,0,0,29000,15000,14000,14000
049049,玉晶光康和94購02,0,0,0,0,0,0,0,0,0,14000,0,0,0,15000,1000,14000,14000
045967,日電貿凱基92購01,0,0,0,0,0,0,0,0,0,14000,0,0,0,84000,70000,14000,14000
048557,瑞昱元大94購01  ,0,0,0,0,0,0,0,0,0,14000,0,0,0,84000,70000,14000,14000
046602,新日興群益94購01,0,0,0,0,0,0,0,0,0,14000,0,0,0,117000,103000,14000,14000
052067,中磊兆豐96購01  ,0,0,0,0,0,0,0,0,0,14000,0,0,0,14000,0,14000,14000
052146,泰碩群益95購01  ,0,0,0,0,0,0,0,0,0,14000,0,0,0,19000,5000,14000,14000
051742,欣興國票96購01  ,0,0,0,0,0,0,0,0,0,14000,0,0,0,25000,11000,14000,14000
051740,可成國票96購04  ,0,0,0,0,0,0,0,0,0,14000,0,0,0,33000,19000,14000,14000
051612,緯創日盛95購01  ,0,0,0,0,0,0,0,0,0,14000,0,0,0,14000,0,14000,14000
051429,智邦元富95購01  ,0,0,0,0,0,0,0,0,0,14000,0,0,0,14000,0,14000,14000
051230,聯詠群益95購01  ,0,0,0,0,0,0,0,0,0,14000,0,0,0,28000,14000,14000,14000
051212,國巨統一95購01  ,0,0,0,0,0,0,0,0,0,14000,0,0,0,14000,0,14000,14000
051005,緯創中信95購02  ,0,0,0,0,0,0,0,0,0,14000,0,0,0,14000,0,14000,14000
050936,國巨國票95購04  ,0,0,0,0,0,0,0,0,0,14000,0,0,0,21000,7000,14000,14000
049407,台積電日盛94購02,0,0,0,0,0,0,0,0,0,14000,0,0,0,26000,12000,14000,14000
049691,可成元大94購06  ,0,0,0,0,0,0,0,0,0,14000,0,0,0,72000,58000,14000,14000
050344,鴻海元富96購01  ,0,0,0,0,0,0,0,0,0,14000,0,0,0,14000,0,14000,14000
050356,緯穎群益94購05  ,0,0,0,0,0,0,0,0,0,14000,0,0,0,68000,54000,14000,14000
050210,華新科國票94購08,0,0,0,0,0,0,0,0,0,14000,0,0,0,16000,2000,14000,14000
1470,大統新創        ,14000,0,14000,0,0,0,0,0,0,0,0,0,0,0,0,0,14000
1220,台榮            ,14000,0,14000,0,0,0,0,0,0,0,0,0,0,0,0,0,14000
05798P,臺股指群益96售12,0,0,0,0,0,0,0,0,0,14000,0,0,0,14000,0,14000,14000
05820P,臺股指凱基96售17,0,0,0,0,0,0,0,0,0,14000,0,0,0,31000,17000,14000,14000
2374,佳能            ,34000,20000,14000,0,0,0,0,0,0,0,0,0,0,0,0,0,14000
2497,怡利電          ,15000,1000,14000,0,0,0,0,0,0,0,0,0,0,0,0,0,14000
1809,中釉            ,96000,82000,14000,0,0,0,0,0,0,0,0,0,0,0,0,0,14000
4540,全球傳動        ,58000,44000,14000,0,0,0,0,0,0,0,0,0,0,0,0,0,14000
2820,華票            ,65000,51000,14000,0,0,0,0,0,0,0,0,0,0,0,0,0,14000
8488,吉源-KY         ,14000,0,14000,0,0,0,0,0,0,0,0,0,0,0,0,0,14000
8429,金麗-KY         ,23000,9000,14000,0,0,0,0,0,0,0,0,0,0,0,0,0,14000
8411,福貞-KY         ,15000,1000,14000,0,0,0,0,0,0,0,0,0,0,0,0,0,14000
6165,捷泰            ,51000,36000,15000,0,0,0,0,0,0,-1000,0,1000,-1000,0,0,0,14000
2227,裕日車          ,28000,14652,13348,0,0,0,0,0,0,0,0,0,0,0,0,0,13348
053455,台光電元富96購02,0,0,0,0,0,0,0,0,0,13000,0,0,0,13000,0,13000,13000
053630,奇鋐兆豐97購01  ,0,0,0,0,0,0,0,0,0,13000,0,0,0,13000,0,13000,13000
053748,燿華永豐96購04  ,0,0,0,0,0,0,0,0,0,13000,0,0,0,54000,41000,13000,13000
054357,可成兆豐97購02  ,0,0,0,0,0,0,0,0,0,13000,0,0,0,27000,14000,13000,13000
03423B,臺股指元大94熊29,0,0,0,0,0,0,0,0,0,13000,0,0,0,17000,4000,13000,13000
020008,元大特股高息N   ,0,0,0,0,0,0,0,0,0,13000,0,0,0,41000,28000,13000,13000
040695,晶電群益91購02  ,0,0,0,0,0,0,0,0,0,13000,0,0,0,13000,0,13000,13000
044123,旺宏凱基91購06  ,0,0,0,0,0,0,0,0,0,13000,0,0,0,31000,18000,13000,13000
046324,健策元大92購05  ,0,0,0,0,0,0,0,0,0,13000,0,0,0,13000,0,13000,13000
046295,超眾統一92購01  ,0,0,0,0,0,0,0,0,0,13000,0,0,0,73000,60000,13000,13000
04579P,聯茂台新94售01  ,0,0,0,0,0,0,0,0,0,13000,0,0,0,13000,0,13000,13000
04544P,欣興富邦96售02  ,0,0,0,0,0,0,0,0,0,13000,0,0,0,13000,0,13000,13000
045086,玉晶光元大94購02,0,0,0,0,0,0,0,0,0,13000,0,0,0,89000,76000,13000,13000
046571,瑞昱國泰93購01  ,0,0,0,0,0,0,0,0,0,13000,0,0,0,18000,5000,13000,13000
046460,聯鈞凱基93購02  ,0,0,0,0,0,0,0,0,0,13000,0,0,0,28000,15000,13000,13000
046743,啟碁日盛93購01  ,0,0,0,0,0,0,0,0,0,13000,0,0,0,13000,0,13000,13000
046104,智伸科永豐92購02,0,0,0,0,0,0,0,0,0,13000,0,0,0,13000,0,13000,13000
046137,遠東新統一92購01,0,0,0,0,0,0,0,0,0,13000,0,0,0,33000,20000,13000,13000
049123,可成元富94購01  ,0,0,0,0,0,0,0,0,0,13000,0,0,0,52000,39000,13000,13000
049180,TPK凱基94購02   ,0,0,0,0,0,0,0,0,0,13000,0,0,0,13000,0,13000,13000
049249,台達電元大94購05,0,0,0,0,0,0,0,0,0,13000,0,0,0,14000,1000,13000,13000
048790,大立光元大95購05,0,0,0,0,0,0,0,0,0,13000,0,0,0,18000,5000,13000,13000
047461,大立光群益93購09,0,0,0,0,0,0,0,0,0,13000,0,0,0,26000,13000,13000,13000
050680,上銀元富94購01  ,0,0,0,0,0,0,0,0,0,13000,0,0,0,23000,10000,13000,13000
049653,緯穎凱基94購03  ,0,0,0,0,0,0,0,0,0,13000,0,0,0,80000,67000,13000,13000
049508,上銀凱基94購04  ,0,0,0,0,0,0,0,0,0,13000,0,0,0,47000,34000,13000,13000
051001,緯穎元大96購02  ,0,0,0,0,0,0,0,0,0,13000,0,0,0,160000,147000,13000,13000
051052,台積電群益95購01,0,0,0,0,0,0,0,0,0,13000,0,0,0,316000,303000,13000,13000
051661,華新科永昌96購01,0,0,0,0,0,0,0,0,0,13000,0,0,0,13000,0,13000,13000
051715,和碩台新95購01  ,0,0,0,0,0,0,0,0,0,13000,0,0,0,13000,0,13000,13000
052121,全新國票96購03  ,0,0,0,0,0,0,0,0,0,13000,0,0,0,33000,20000,13000,13000
2597,潤弘            ,13000,1000,12000,0,0,0,0,0,0,1000,2000,1000,1000,0,0,0,13000
2465,麗臺            ,13000,0,13000,0,0,0,0,0,0,0,0,0,0,0,0,0,13000
3593,力銘            ,13000,0,13000,0,0,0,0,0,0,0,0,0,0,0,0,0,13000
4764,雙鍵            ,14000,1000,13000,0,0,0,0,0,0,0,0,0,0,0,0,0,13000
05807P,泰鼎永豐96售03  ,0,0,0,0,0,0,0,0,0,13000,0,0,0,33000,20000,13000,13000
05776P,鴻海統一98售02  ,0,0,0,0,0,0,0,0,0,13000,0,0,0,13000,0,13000,13000
05717P,鴻海元大97售07  ,0,0,0,0,0,0,0,0,0,13000,0,0,0,268000,255000,13000,13000
8473,山林水          ,14000,1000,13000,0,0,0,0,0,0,0,0,0,0,0,0,0,13000
9918,欣天然          ,13000,0,13000,0,0,0,0,0,0,0,0,0,0,0,0,0,13000
054369,鴻海中信9C購01  ,0,0,0,0,0,0,0,0,0,12000,0,0,0,12000,0,12000,12000
054419,嘉聯益元大98購02,0,0,0,0,0,0,0,0,0,12000,0,0,0,41000,29000,12000,12000
054480,和碩中信98購01  ,0,0,0,0,0,0,0,0,0,12000,0,0,0,15000,3000,12000,12000
054199,大立光永昌96購07,0,0,0,0,0,0,0,0,0,12000,0,0,0,14000,2000,12000,12000
05455P,聯詠日盛95售01  ,0,0,0,0,0,0,0,0,0,12000,0,0,0,22000,10000,12000,12000
054587,玉晶光國泰99購01,0,0,0,0,0,0,0,0,0,12000,0,0,0,51000,39000,12000,12000
054567,拓凱群益98購01  ,0,0,0,0,0,0,0,0,0,12000,0,0,0,22000,10000,12000,12000
053880,智邦中信96購01  ,0,0,0,0,0,0,0,0,0,12000,0,0,0,12000,0,12000,12000
05369P,可成元富95售04  ,0,0,0,0,0,0,0,0,0,12000,0,0,0,12000,0,12000,12000
05367P,鴻海元富95售13  ,0,0,0,0,0,0,0,0,0,12000,0,0,0,14000,2000,12000,12000
054085,華新科統一96購04,0,0,0,0,0,0,0,0,0,12000,0,0,0,140000,128000,12000,12000
053351,A50正2兆豐97購01,0,0,0,0,0,0,0,0,0,12000,0,0,0,112000,100000,12000,12000
053123,京元電凱基96購01,0,0,0,0,0,0,0,0,0,12000,0,0,0,12000,0,12000,12000
052912,日月光統一96購01,0,0,0,0,0,0,0,0,0,12000,0,0,0,68000,56000,12000,12000
044807,瀚宇博凱基91購01,0,0,0,0,0,0,0,0,0,12000,0,0,0,22000,10000,12000,12000
045592,台郡元大92購04  ,0,0,0,0,0,0,0,0,0,12000,0,0,0,22000,10000,12000,12000
047782,燿華國泰95購01  ,0,0,0,0,0,0,0,0,0,12000,0,0,0,104000,92000,12000,12000
048223,微星凱基93購02  ,0,0,0,0,0,0,0,0,0,12000,0,0,0,50000,38000,12000,12000
043862,和大元大92購01  ,0,0,0,0,0,0,0,0,0,12000,0,0,0,188000,176000,12000,12000
03414B,臺股指凱基99熊01,0,0,0,0,0,0,0,0,0,12000,0,0,0,54000,42000,12000,12000
044696,旺宏元大91購04  ,0,0,0,0,0,0,0,0,0,12000,0,0,0,12000,0,12000,12000
04252P,台達電元富93售02,0,0,0,0,0,0,0,0,0,12000,0,0,0,52000,40000,12000,12000
04276P,聯發科凱基93售33,0,0,0,0,0,0,0,0,0,12000,0,0,0,22000,10000,12000,12000
041913,百和元大91購01  ,0,0,0,0,0,0,0,0,0,12000,0,0,0,12000,0,12000,12000
048818,台達電凱基94購01,0,0,0,0,0,0,0,0,0,12000,0,0,0,32000,20000,12000,12000
048754,瀚宇博元富97購01,0,0,0,0,0,0,0,0,0,12000,0,0,0,12000,0,12000,12000
047114,全新元大94購01  ,0,0,0,0,0,0,0,0,0,12000,0,0,0,12000,0,12000,12000
049040,亞光兆豐95購01  ,0,0,0,0,0,0,0,0,0,12000,0,0,0,20000,8000,12000,12000
048170,智原永豐93購02  ,0,0,0,0,0,0,0,0,0,12000,0,0,0,12000,0,12000,12000
046072,台勝科凱基92購03,0,0,0,0,0,0,0,0,0,12000,0,0,0,43000,31000,12000,12000
046503,京元電元大92購08,0,0,0,0,0,0,0,0,0,12000,0,0,0,12000,0,12000,12000
047911,晶技麥證94購01  ,0,0,0,15000,3000,12000,0,0,0,12000,0,0,0,15000,3000,12000,12000
046687,TPK國票93購01   ,0,0,0,0,0,0,0,0,0,12000,0,0,0,12000,0,12000,12000
048429,旺宏國票94購02  ,0,0,0,0,0,0,0,0,0,12000,0,0,0,50000,38000,12000,12000
052042,台積電日盛95購02,0,0,0,0,0,0,0,0,0,12000,0,0,0,28000,16000,12000,12000
051796,和碩康和95購01  ,0,0,0,0,0,0,0,0,0,12000,0,0,0,30000,18000,12000,12000
051249,潤泰全元大95購01,0,0,0,0,0,0,0,0,0,12000,0,0,0,17000,5000,12000,12000
049628,臺股指群益94購01,0,0,0,0,0,0,0,0,0,12000,0,0,0,12000,0,12000,12000
049991,臺股指凱基96購04,0,0,0,0,0,0,0,0,0,12000,0,0,0,27000,15000,12000,12000
050155,華新科群益95購01,0,0,0,0,0,0,0,0,0,12000,0,0,0,12000,0,12000,12000
050850,訊連國票96購01  ,0,0,0,0,0,0,0,0,0,12000,0,0,0,12000,0,12000,12000
05676P,欣興群益96售04  ,0,0,0,0,0,0,0,0,0,12000,0,0,0,25000,13000,12000,12000
05796P,臺股指群益96售10,0,0,0,0,0,0,0,0,0,12000,0,0,0,12000,0,12000,12000
05950P,台積電國票97售04,0,0,0,0,0,0,0,0,0,12000,0,0,0,14000,2000,12000,12000
1435,中福            ,12000,0,12000,0,0,0,0,0,0,0,0,0,0,0,0,0,12000
1423,利華            ,12000,0,12000,0,0,0,0,0,0,0,0,0,0,0,0,0,12000
1454,台富            ,13000,1000,12000,0,0,0,0,0,0,0,0,0,0,0,0,0,12000
1583,程泰            ,13000,1000,12000,0,0,0,0,0,0,0,0,0,0,0,0,0,12000
06055P,華通凱基97售04  ,0,0,0,0,0,0,0,0,0,12000,0,0,0,12000,0,12000,12000
05977P,旺宏永豐96售06  ,0,0,0,0,0,0,0,0,0,12000,0,0,0,12000,0,12000,12000
06019P,緯穎凱基96售03  ,0,0,0,0,0,0,0,0,0,12000,0,0,0,52000,40000,12000,12000
5215,科嘉-KY         ,27000,15000,12000,0,0,0,0,0,0,0,0,0,0,0,0,0,12000
4976,佳凌            ,87000,77000,10000,0,0,0,0,0,0,2000,2000,0,2000,0,0,0,12000
3055,蔚華科          ,34000,22000,12000,0,0,0,0,0,0,0,0,0,0,0,0,0,12000
2466,冠西電          ,13000,1000,12000,0,0,0,0,0,0,0,0,0,0,0,0,0,12000
2358,廷鑫            ,13000,1000,12000,0,0,0,0,0,0,0,0,0,0,0,0,0,12000
2030,彰源            ,8000,3000,5000,0,0,0,0,0,0,7000,7000,0,7000,0,0,0,12000
052800,國巨元大96購05  ,0,0,0,0,0,0,0,0,0,11000,0,0,0,17000,6000,11000,11000
052597,茂林群益96購01  ,0,0,0,0,0,0,0,0,0,11000,0,0,0,157000,146000,11000,11000
05260P,和碩元富95售02  ,0,0,0,0,0,0,0,0,0,11000,0,0,0,42000,31000,11000,11000
052350,鴻海統一96購06  ,0,0,0,0,0,0,0,0,0,11000,0,0,0,31000,20000,11000,11000
053072,國巨台新97購01  ,0,0,0,0,0,0,0,0,0,11000,0,0,0,19000,8000,11000,11000
052968,燿華群益98購01  ,0,0,0,0,0,0,0,0,0,11000,0,0,0,22000,11000,11000,11000
05325P,臺股指凱基95售09,0,0,0,0,0,0,0,0,0,11000,0,0,0,11000,0,11000,11000
054101,茂林國票97購04  ,0,0,0,0,0,0,0,0,0,11000,0,0,0,16000,5000,11000,11000
053873,力成元大96購03  ,0,0,0,0,0,0,0,0,0,11000,0,0,0,31000,20000,11000,11000
05567P,致伸群益96售01  ,0,0,0,0,0,0,0,0,0,11000,0,0,0,11000,0,11000,11000
054238,聯茂群益96購04  ,0,0,0,0,0,0,0,0,0,11000,0,0,0,51000,40000,11000,11000
054466,欣興凱基97購03  ,0,0,0,0,0,0,0,0,0,11000,0,0,0,11000,0,11000,11000
054416,禾伸堂元大97購01,0,0,0,0,0,0,0,0,0,11000,0,0,0,79000,68000,11000,11000
054368,鴻海中信9A購02  ,0,0,0,0,0,0,0,0,0,11000,0,0,0,11000,0,11000,11000
043483,和鑫群益92購01  ,0,0,0,0,0,0,0,0,0,11000,0,0,0,11000,0,11000,11000
03378P,台積電群益02售10,0,0,0,0,0,0,0,0,0,11000,0,0,0,11000,0,11000,11000
03869P,和大群益93售02  ,0,0,0,0,0,0,0,0,0,11000,0,0,0,11000,0,11000,11000
040762,滬深2X凱基92購01,0,0,0,0,0,0,0,0,0,11000,0,0,0,11000,0,11000,11000
04015P,可成元大93售10  ,0,0,0,0,0,0,0,0,0,11000,0,0,0,11000,0,11000,11000
03057P,亞德客凱基01售02,0,0,0,0,0,0,0,0,0,11000,0,0,0,11000,0,11000,11000
00678,群益NBI生技     ,0,0,0,0,0,0,0,0,0,11000,0,0,0,320000,309000,11000,11000
045752,全新國泰93購01  ,0,0,0,0,0,0,0,0,0,11000,0,0,0,31000,20000,11000,11000
04366P,全新元富95售01  ,0,0,0,0,0,0,0,0,0,11000,0,0,0,40000,29000,11000,11000
044109,宏達電國票92購02,0,0,0,0,0,0,0,0,0,11000,0,0,0,11000,0,11000,11000
045599,神基中信92購01  ,0,0,0,0,0,0,0,0,0,11000,0,0,0,11000,0,11000,11000
048272,新光金富邦98購01,0,0,0,0,0,0,0,0,0,11000,0,0,0,11000,0,11000,11000
047787,正崴群益93購01  ,0,0,0,0,0,0,0,0,0,11000,0,0,0,15000,4000,11000,11000
048202,瑞儀元大93購04  ,0,0,0,0,0,0,0,0,0,11000,0,0,0,111000,100000,11000,11000
043973,元金2X元大94購02,0,0,0,0,0,0,0,0,0,11000,0,0,0,27000,16000,11000,11000
044025,台表科凱基93購02,0,0,0,0,0,0,0,0,0,11000,0,0,0,21000,10000,11000,11000
045230,嘉聯益元大93購01,0,0,0,0,0,0,0,0,0,11000,0,0,0,29000,18000,11000,11000
045835,奇鋐群益92購01  ,0,0,0,0,0,0,0,0,0,11000,0,0,0,11000,0,11000,11000
044852,華邦電國泰93購02,0,0,0,0,0,0,0,0,0,11000,0,0,0,253000,242000,11000,11000
045160,致新凱基92購01  ,0,0,0,0,0,0,0,0,0,11000,0,0,0,56000,45000,11000,11000
045118,臻鼎日盛92購01  ,0,0,0,0,0,0,0,0,0,11000,0,0,0,11000,0,11000,11000
046389,百和凱基93購04  ,0,0,0,0,0,0,0,0,0,11000,0,0,0,31000,20000,11000,11000
046608,超眾兆豐93購02  ,0,0,0,0,0,0,0,0,0,11000,0,0,0,21000,10000,11000,11000
048770,揚明光凱基94購01,0,0,0,0,0,0,0,0,0,11000,0,0,0,11000,0,11000,11000
046613,元石油凱基93購01,0,0,0,0,0,0,0,0,0,11000,0,0,0,11000,0,11000,11000
04860P,鴻海群益94售07  ,0,0,0,0,0,0,0,0,0,11000,0,0,0,11000,0,11000,11000
045947,欣興兆豐93購04  ,0,0,0,0,0,0,0,0,0,11000,0,0,0,11000,0,11000,11000
045910,華通國票92購01  ,0,0,0,0,0,0,0,0,0,11000,0,0,0,15000,4000,11000,11000
046944,奇力新元大96購01,0,0,0,0,0,0,0,0,0,11000,0,0,0,11000,0,11000,11000
047358,儒鴻群益93購02  ,0,0,0,0,0,0,0,0,0,11000,0,0,0,11000,0,11000,11000
04915P,鴻海永昌96售02  ,0,0,0,0,0,0,0,0,0,11000,0,0,0,61000,50000,11000,11000
049203,智邦群益94購01  ,0,0,0,0,0,0,0,0,0,11000,0,0,0,11000,0,11000,11000
047462,和鑫群益93購02  ,0,0,0,0,0,0,0,0,0,11000,0,0,0,11000,0,11000,11000
047484,聯詠凱基93購03  ,0,0,0,0,0,0,0,0,0,11000,0,0,0,11000,0,11000,11000
05067P,欣興兆豐96售02  ,0,0,0,0,0,0,0,0,0,11000,0,0,0,23000,12000,11000,11000
050404,元大金麥證94購01,0,0,0,12000,1000,11000,0,0,0,11000,0,0,0,12000,1000,11000,11000
050411,聯發科永豐94購05,0,0,0,0,0,0,0,0,0,11000,0,0,0,62000,51000,11000,11000
050439,新日興凱基94購01,0,0,0,0,0,0,0,0,0,11000,0,0,0,41000,30000,11000,11000
050500,台積電凱基94購36,0,0,0,0,0,0,0,0,0,11000,0,0,0,11000,0,11000,11000
050109,國巨元大94購13  ,0,0,0,0,0,0,0,0,0,11000,0,0,0,11000,0,11000,11000
049670,鈺齊國泰96購01  ,0,0,0,0,0,0,0,0,0,11000,0,0,0,11000,0,11000,11000
049734,瑞昱群益94購02  ,0,0,0,0,0,0,0,0,0,11000,0,0,0,11000,0,11000,11000
04951P,緯創中信94售01  ,0,0,0,0,0,0,0,0,0,11000,0,0,0,11000,0,11000,11000
051295,國巨元富95購04  ,0,0,0,0,0,0,0,0,0,11000,0,0,0,11000,0,11000,11000
051468,智邦日盛95購01  ,0,0,0,0,0,0,0,0,0,11000,0,0,0,11000,0,11000,11000
050944,智邦群益95購01  ,0,0,0,0,0,0,0,0,0,11000,0,0,0,11000,0,11000,11000
051894,嘉聯益元富95購03,0,0,0,0,0,0,0,0,0,11000,0,0,0,11000,0,11000,11000
1732,毛寶            ,41000,30000,11000,0,0,0,0,0,0,0,0,0,0,0,0,0,11000
1614,三洋電          ,13000,2000,11000,0,0,0,0,0,0,0,0,0,0,0,0,0,11000
1466,聚隆            ,22000,11000,11000,0,0,0,0,0,0,0,0,0,0,0,0,0,11000
1506,正道            ,13000,2000,11000,0,0,0,0,0,0,0,0,0,0,0,0,0,11000
05954P,旺宏國票97售03  ,0,0,0,0,0,0,0,0,0,11000,0,0,0,19000,8000,11000,11000
05958P,聯發科國票97售04,0,0,0,0,0,0,0,0,0,11000,0,0,0,11000,0,11000,11000
05859P,台表科國票97售04,0,0,0,0,0,0,0,0,0,11000,0,0,0,13000,2000,11000,11000
05713P,大立光統一96售05,0,0,0,0,0,0,0,0,0,11000,0,0,0,70000,59000,11000,11000
05611P,康控群益96售02  ,0,0,0,0,0,0,0,0,0,11000,0,0,0,11000,0,11000,11000
9912,偉聯            ,11000,0,11000,0,0,0,0,0,0,0,0,0,0,0,0,0,11000
6579,研揚            ,19000,8000,11000,0,0,0,0,0,0,0,0,0,0,0,0,0,11000
054456,華泰群益99購01  ,0,0,0,0,0,0,0,0,0,10000,0,0,0,20000,10000,10000,10000
054481,鎧勝中信96購01  ,0,0,0,0,0,0,0,0,0,10000,0,0,0,10000,0,10000,10000
054475,鴻海中信96購04  ,0,0,0,0,0,0,0,0,0,10000,0,0,0,10000,0,10000,10000
054225,華新元富96購01  ,0,0,0,0,0,0,0,0,0,10000,0,0,0,10000,0,10000,10000
054293,健策元大98購02  ,0,0,0,0,0,0,0,0,0,10000,0,0,0,59000,49000,10000,10000
054317,昇陽半凱基98購01,0,0,0,0,0,0,0,0,0,10000,0,0,0,10000,0,10000,10000
054336,台積電統一96購11,0,0,0,0,0,0,0,0,0,10000,0,0,0,110000,100000,10000,10000
054338,全新統一96購01  ,1000,0,1000,0,0,0,0,0,0,9000,0,0,0,100000,91000,9000,10000
05522P,友達元富96售02  ,0,0,0,0,0,0,0,0,0,10000,0,0,0,510000,500000,10000,10000
054574,美律元大99購01  ,0,0,0,0,0,0,0,0,0,10000,0,0,0,117000,107000,10000,10000
054542,台表科國票98購01,0,0,0,0,0,0,0,0,0,10000,0,0,0,10000,0,10000,10000
054679,台積電康和99購01,0,0,0,0,0,0,0,0,0,10000,0,0,0,10000,0,10000,10000
05466P,旺宏富邦97售01  ,0,0,0,0,0,0,0,0,0,10000,0,0,0,100000,90000,10000,10000
053815,聯發科群益96購01,0,0,0,0,0,0,0,0,0,10000,0,0,0,10000,0,10000,10000
053804,富邦金凱基96購01,0,0,0,0,0,0,0,0,0,10000,0,0,0,20000,10000,10000,10000
053731,矽創凱基96購03  ,0,0,0,0,0,0,0,0,0,10000,0,0,0,10000,0,10000,10000
053632,新唐兆豐96購01  ,0,0,0,0,0,0,0,0,0,10000,0,0,0,10000,0,10000,10000
05365P,臺股指富邦95售05,0,0,0,0,0,0,0,0,0,10000,0,0,0,10000,0,10000,10000
053657,元大金凱基96購01,0,0,0,0,0,0,0,0,0,10000,0,0,0,10000,0,10000,10000
05404P,台積電群益95售06,0,0,0,0,0,0,0,0,0,10000,0,0,0,10000,0,10000,10000
054163,燿華凱基97購02  ,0,0,0,0,0,0,0,0,0,10000,0,0,0,10000,0,10000,10000
054135,大立光元大97購04,0,0,0,0,0,0,0,0,0,10000,0,0,0,33000,23000,10000,10000
053899,矽創群益96購02  ,0,0,0,0,0,0,0,0,0,10000,0,0,0,10000,0,10000,10000
053903,燿華凱基97購01  ,0,0,0,0,0,0,0,0,0,10000,0,0,0,10000,0,10000,10000
053937,光磊元富96購01  ,0,0,0,0,0,0,0,0,0,10000,0,0,0,10000,0,10000,10000
054013,聯發科永豐96購02,0,0,0,0,0,0,0,0,0,10000,0,0,0,10000,0,10000,10000
053302,國巨凱基96購10  ,0,0,0,0,0,0,0,0,0,10000,0,0,0,259000,249000,10000,10000
053398,和鑫中信99購01  ,0,0,0,0,0,0,0,0,0,10000,0,0,0,10000,0,10000,10000
053432,世紀鋼永豐96購02,0,0,0,0,0,0,0,0,0,10000,0,0,0,11000,1000,10000,10000
053553,聯詠凱基96購03  ,0,0,0,0,0,0,0,0,0,10000,0,0,0,10000,0,10000,10000
052940,玉晶光兆豐97購01,0,0,0,0,0,0,0,0,0,10000,0,0,0,10000,0,10000,10000
052996,聯電康和96購01  ,0,0,0,0,0,0,0,0,0,10000,0,0,0,10000,0,10000,10000
053129,緯穎凱基96購01  ,0,0,0,0,0,0,0,0,0,10000,0,0,0,10000,0,10000,10000
05313P,臺股指群益95售12,0,0,0,0,0,0,0,0,0,10000,0,0,0,10000,0,10000,10000
052345,矽力凱基95購01  ,0,0,0,0,0,0,0,0,0,10000,0,0,0,10000,0,10000,10000
052374,瑞昱元大95購02  ,0,0,0,0,0,0,0,0,0,10000,0,0,0,165000,155000,10000,10000
052286,力成凱基95購02  ,0,0,0,0,0,0,0,0,0,10000,0,0,0,10000,0,10000,10000
052228,聯發科凱基96購06,0,0,0,0,0,0,0,0,0,10000,0,0,0,10000,0,10000,10000
052526,智伸科元大96購02,0,0,0,0,0,0,0,0,0,10000,0,0,0,11000,1000,10000,10000
052508,矽力日盛95購02  ,0,0,0,0,0,0,0,0,0,10000,0,0,0,20000,10000,10000,10000
05242P,群創國泰97售01  ,0,0,0,0,0,0,0,0,0,10000,0,0,0,10000,0,10000,10000
052490,禾伸堂國票95購01,0,0,0,0,0,0,0,0,0,10000,0,0,0,14000,4000,10000,10000
052682,上銀元大97購01  ,0,0,0,0,0,0,0,0,0,10000,0,0,0,13000,3000,10000,10000
052791,友達兆豐97購01  ,0,0,0,0,0,0,0,0,0,10000,0,0,0,20000,10000,10000,10000
052797,樺漢兆豐96購01  ,0,0,0,0,0,0,0,0,0,10000,0,0,0,10000,0,10000,10000
052789,台積電麥證96購01,0,0,0,10000,0,10000,0,0,0,10000,0,0,0,10000,0,10000,10000
052776,力山國票97購01  ,0,0,0,0,0,0,0,0,0,10000,0,0,0,10000,0,10000,10000
045828,緯穎凱基92購03  ,0,0,0,0,0,0,0,0,0,10000,0,0,0,10000,0,10000,10000
045088,康控元大94購02  ,0,0,0,0,0,0,0,0,0,10000,0,0,0,25000,15000,10000,10000
04505P,佳世達元富96售03,0,0,0,0,0,0,0,0,0,10000,0,0,0,10000,0,10000,10000
045060,世紀鋼富邦93購01,0,0,0,0,0,0,0,0,0,10000,0,0,0,10000,0,10000,10000
044978,智邦國票92購01  ,0,0,0,0,0,0,0,0,0,10000,0,0,0,10000,0,10000,10000
044839,同欣電元大91購02,0,0,0,0,0,0,0,0,0,10000,0,0,0,10000,0,10000,10000
044846,旺宏統一93購01  ,0,0,0,0,0,0,0,0,0,10000,0,0,0,111000,101000,10000,10000
044804,嘉晶凱基91購02  ,0,0,0,0,0,0,0,0,0,10000,0,0,0,10000,0,10000,10000
044801,微星凱基93購01  ,0,0,0,0,0,0,0,0,0,10000,0,0,0,10000,0,10000,10000
044810,為升國票93購01  ,0,0,0,0,0,0,0,0,0,10000,0,0,0,160000,150000,10000,10000
044754,漢唐凱基91購05  ,0,0,0,0,0,0,0,0,0,10000,0,0,0,20000,10000,10000,10000
04474P,聯發科元大94售03,0,0,0,0,0,0,0,0,0,10000,0,0,0,10000,0,10000,10000
044886,台表科群益91購06,0,0,0,0,0,0,0,0,0,10000,0,0,0,20000,10000,10000,10000
044912,瀚宇博凱基91購02,0,0,0,0,0,0,0,0,0,10000,0,0,0,10000,0,10000,10000
044961,聯電中信94購01  ,0,0,0,0,0,0,0,0,0,10000,0,0,0,40000,30000,10000,10000
045195,TPK群益92購03   ,0,0,0,0,0,0,0,0,0,10000,0,0,0,10000,0,10000,10000
045222,華新科元大92購09,0,0,0,0,0,0,0,0,0,10000,0,0,0,10000,0,10000,10000
045240,世紀鋼國票92購02,0,0,0,0,0,0,0,0,0,10000,0,0,0,110000,100000,10000,10000
045215,鴻海元大92購05  ,0,0,0,0,0,0,0,0,0,10000,0,0,0,35000,25000,10000,10000
045270,南電凱基92購03  ,0,0,0,0,0,0,0,0,0,10000,0,0,0,10000,0,10000,10000
045310,康友元大92購04  ,0,0,0,0,0,0,0,0,0,10000,0,0,0,10000,0,10000,10000
045318,鴻海統一92購03  ,0,0,0,0,0,0,0,0,0,10000,0,0,0,10000,0,10000,10000
045324,嘉晶統一92購01  ,0,0,0,0,0,0,0,0,0,10000,0,0,0,10000,0,10000,10000
04532P,臺股指凱基94售04,0,0,0,0,0,0,0,0,0,10000,0,0,0,10000,0,10000,10000
045342,台光電凱基92購03,0,0,0,0,0,0,0,0,0,10000,0,0,0,10000,0,10000,10000
044015,全新凱基91購02  ,0,0,0,0,0,0,0,0,0,10000,0,0,0,20000,10000,10000,10000
044018,欣興凱基91購04  ,0,0,0,0,0,0,0,0,0,10000,0,0,0,10000,0,10000,10000
043992,康控元大93購02  ,0,0,0,0,0,0,0,0,0,10000,0,0,0,17000,7000,10000,10000
04554P,可成中信94售01  ,0,0,0,0,0,0,0,0,0,10000,0,0,0,10000,0,10000,10000
045579,全新元大93購03  ,0,0,0,0,0,0,0,0,0,10000,0,0,0,10000,0,10000,10000
045582,大立光元大93購08,0,0,0,0,0,0,0,0,0,10000,0,0,0,10000,0,10000,10000
045470,康控元大94購03  ,0,0,0,0,0,0,0,0,0,10000,0,0,0,17000,7000,10000,10000
045456,鴻海元大93購04  ,0,0,0,0,0,0,0,0,0,10000,0,0,0,94000,84000,10000,10000
047777,寶成元大93購01  ,0,0,0,0,0,0,0,0,0,10000,0,0,0,10000,0,10000,10000
045784,晶睿元大92購02  ,0,0,0,0,0,0,0,0,0,10000,0,0,0,10000,0,10000,10000
045779,大立光元大93購11,0,0,0,0,0,0,0,0,0,10000,0,0,0,10000,0,10000,10000
046233,臻鼎元大92購08  ,0,0,0,0,0,0,0,0,0,10000,0,0,0,10000,0,10000,10000
046277,可成台新92購01  ,0,0,0,0,0,0,0,0,0,10000,0,0,0,10000,0,10000,10000
04624P,台積電元大94售14,0,0,0,0,0,0,0,0,0,10000,0,0,0,10000,0,10000,10000
046261,中環凱基93購01  ,0,0,0,0,0,0,0,0,0,10000,0,0,0,10000,0,10000,10000
048236,A50正2國票97購02,0,0,0,0,0,0,0,0,0,10000,0,0,0,20000,10000,10000,10000
04823P,台積電元富94售09,0,0,0,0,0,0,0,0,0,10000,0,0,0,30000,20000,10000,10000
04630P,嘉聯益元大95售02,0,0,0,0,0,0,0,0,0,10000,0,0,0,231000,221000,10000,10000
046316,大立光元大92購20,0,0,0,0,0,0,0,0,0,10000,0,0,0,10000,0,10000,10000
046329,臻鼎元大92購10  ,0,0,0,0,0,0,0,0,0,10000,0,0,0,10000,0,10000,10000
045626,上銀凱基93購05  ,0,0,0,0,0,0,0,0,0,10000,0,0,0,10000,0,10000,10000
045636,京元電凱基92購03,0,0,0,0,0,0,0,0,0,10000,0,0,0,10000,0,10000,10000
044280,T50反1凱基94購02,0,0,0,0,0,0,0,0,0,10000,0,0,0,10000,0,10000,10000
044253,美律麥證92購01  ,0,0,0,10000,0,10000,0,0,0,10000,0,0,0,10000,0,10000,10000
044265,滬深2X中信95購05,0,0,0,0,0,0,0,0,0,10000,0,0,0,10000,0,10000,10000
044266,亞德客中信91購01,0,0,0,0,0,0,0,0,0,10000,0,0,0,10000,0,10000,10000
044117,創意兆豐92購01  ,0,0,0,0,0,0,0,0,0,10000,0,0,0,10000,0,10000,10000
044130,嘉澤凱基91購03  ,0,0,0,0,0,0,0,0,0,10000,0,0,0,10000,0,10000,10000
044158,景碩永豐91購01  ,0,0,0,0,0,0,0,0,0,10000,0,0,0,10000,0,10000,10000
044211,亞德客凱基91購02,0,0,0,0,0,0,0,0,0,10000,0,0,0,10000,0,10000,10000
045698,致伸兆豐93購01  ,0,0,0,0,0,0,0,0,0,10000,0,0,0,10000,0,10000,10000
045671,鴻海元大92購10  ,0,0,0,0,0,0,0,0,0,10000,0,0,0,57000,47000,10000,10000
043864,鴻海元大91購07  ,0,0,0,0,0,0,0,0,0,10000,0,0,0,10000,0,10000,10000
043865,鴻海元大91購08  ,0,0,0,0,0,0,0,0,0,10000,0,0,0,10000,0,10000,10000
04382P,美律國泰95售01  ,0,0,0,0,0,0,0,0,0,10000,0,0,0,81000,71000,10000,10000
043873,正崴元大91購01  ,0,0,0,0,0,0,0,0,0,10000,0,0,0,10000,0,10000,10000
043883,臻鼎元大91購02  ,0,0,0,0,0,0,0,0,0,10000,0,0,0,10000,0,10000,10000
03108P,台積電元大01售40,0,0,0,0,0,0,0,0,0,10000,0,0,0,10000,0,10000,10000
03734P,新日興元大93售01,0,0,0,0,0,0,0,0,0,10000,0,0,0,10000,0,10000,10000
03647C,T50反1元富99牛02,0,0,0,0,0,0,0,0,0,10000,0,0,0,10000,0,10000,10000
03569P,台積電元大02售41,0,0,0,0,0,0,0,0,0,10000,0,0,0,10000,0,10000,10000
03549P,聯發科凱基02售10,0,0,0,0,0,0,0,0,0,10000,0,0,0,10000,0,10000,10000
03995P,滬深2X國泰95售01,0,0,0,0,0,0,0,0,0,10000,0,0,0,10000,0,10000,10000
04046P,台積電元大93售24,0,0,0,0,0,0,0,0,0,10000,0,0,0,10000,0,10000,10000
040678,大立光國泰91購01,0,0,0,0,0,0,0,0,0,10000,0,0,0,10000,0,10000,10000
03936P,上銀元大93售06  ,0,0,0,0,0,0,0,0,0,10000,0,0,0,10000,0,10000,10000
03907P,易華電國泰94售03,0,0,0,0,0,0,0,0,0,10000,0,0,0,10000,0,10000,10000
03878P,康控國票93售01  ,0,0,0,0,0,0,0,0,0,10000,0,0,0,10000,0,10000,10000
03863P,臺股指麥證93售01,0,0,0,10000,0,10000,0,0,0,10000,0,0,0,10000,0,10000,10000
03039P,玉晶光國票02售04,0,0,0,0,0,0,0,0,0,10000,0,0,0,10000,0,10000,10000
03454P,台積電凱基03售14,0,0,0,0,0,0,0,0,0,10000,0,0,0,20000,10000,10000,10000
03003P,京鼎群益01售02  ,0,0,0,0,0,0,0,0,0,10000,0,0,0,10000,0,10000,10000
03422B,臺股指凱基96熊28,0,0,0,0,0,0,0,0,0,10000,0,0,0,10000,0,10000,10000
03419P,玉晶光群益03售04,0,0,0,0,0,0,0,0,0,10000,0,0,0,10000,0,10000,10000
03237P,大立光元大02售04,0,0,0,0,0,0,0,0,0,10000,0,0,0,10000,0,10000,10000
03250P,日月光元富07售02,0,0,0,0,0,0,0,0,0,10000,0,0,0,25000,15000,10000,10000
03252P,台積電台新02售01,0,0,0,0,0,0,0,0,0,10000,0,0,0,20000,10000,10000,10000
043487,新光金兆豐91購01,0,0,0,0,0,0,0,0,0,10000,0,0,0,10000,0,10000,10000
043377,全新元大92購01  ,0,0,0,0,0,0,0,0,0,10000,0,0,0,10000,0,10000,10000
04359P,中磊永豐94售01  ,0,0,0,0,0,0,0,0,0,10000,0,0,0,10000,0,10000,10000
04356P,嘉晶永豐94售01  ,0,0,0,0,0,0,0,0,0,10000,0,0,0,10000,0,10000,10000
044360,瀚宇博元大91購01,0,0,0,0,0,0,0,0,0,10000,0,0,0,10000,0,10000,10000
044406,臻鼎凱基92購01  ,0,0,0,0,0,0,0,0,0,10000,0,0,0,10000,0,10000,10000
044427,群創國泰93購01  ,0,0,0,0,0,0,0,0,0,10000,0,0,0,10000,0,10000,10000
044335,冠德統一91購05  ,0,0,0,0,0,0,0,0,0,10000,0,0,0,20000,10000,10000,10000
044676,台積電凱基91購20,0,0,0,0,0,0,0,0,0,10000,0,0,0,30000,20000,10000,10000
044711,台郡元大93購01  ,0,0,0,0,0,0,0,0,0,10000,0,0,0,20000,10000,10000,10000
044613,智易兆豐94購01  ,0,0,0,0,0,0,0,0,0,10000,0,0,0,10000,0,10000,10000
044622,旺宏元大92購06  ,0,0,0,0,0,0,0,0,0,10000,0,0,0,10000,0,10000,10000
044542,緯創群益91購01  ,0,0,0,0,0,0,0,0,0,10000,0,0,0,10000,0,10000,10000
044560,台光電日盛91購01,0,0,0,0,0,0,0,0,0,10000,0,0,0,10000,0,10000,10000
044489,鴻海元大91購09  ,0,0,0,0,0,0,0,0,0,10000,0,0,0,10000,0,10000,10000
04450P,京元電凱基94售01,0,0,0,0,0,0,0,0,0,10000,0,0,0,40000,30000,10000,10000
044469,華固群益91購01  ,0,0,0,0,0,0,0,0,0,10000,0,0,0,10000,0,10000,10000
044478,友達統一93購01  ,0,0,0,0,0,0,0,0,0,10000,0,0,0,20000,10000,10000,10000
044439,南電元大93購01  ,0,0,0,0,0,0,0,0,0,10000,0,0,0,20000,10000,10000,10000
042352,鴻海元大91購03  ,0,0,0,0,0,0,0,0,0,10000,0,0,0,10000,0,10000,10000
042294,大立光元大91購05,0,0,0,0,0,0,0,0,0,10000,0,0,0,10000,0,10000,10000
04155P,全新永豐93售01  ,0,0,0,0,0,0,0,0,0,10000,0,0,0,10000,0,10000,10000
04144P,瑞昱凱基93售10  ,0,0,0,0,0,0,0,0,0,10000,0,0,0,20000,10000,10000,10000
042796,永冠元大93購01  ,0,0,0,0,0,0,0,0,0,10000,0,0,0,10000,0,10000,10000
04280P,宏達電台新93售01,0,0,0,0,0,0,0,0,0,10000,0,0,0,20000,10000,10000,10000
04244P,可成元大93售12  ,0,0,0,0,0,0,0,0,0,10000,0,0,0,17000,7000,10000,10000
04232P,可成亞東93售02  ,0,0,0,0,0,0,0,0,0,10000,0,0,0,10000,0,10000,10000
043002,鴻海元大92購02  ,0,0,0,0,0,0,0,0,0,10000,0,0,0,10000,0,10000,10000
042991,南電凱基92購02  ,0,0,0,0,0,0,0,0,0,10000,0,0,0,10000,0,10000,10000
047522,微星元大93購02  ,0,0,0,0,0,0,0,0,0,10000,0,0,0,10000,0,10000,10000
047253,新唐群益93購01  ,0,0,0,0,0,0,0,0,0,10000,0,0,0,10000,0,10000,10000
048128,超眾元大95購01  ,0,0,0,0,0,0,0,0,0,10000,0,0,0,22000,12000,10000,10000
048774,麗豐凱基94購04  ,0,0,0,0,0,0,0,0,0,10000,0,0,0,60000,50000,10000,10000
047074,大立光兆豐94購02,0,0,0,0,0,0,0,0,0,10000,0,0,0,10000,0,10000,10000
048921,劍麟永豐94購01  ,0,0,0,0,0,0,0,0,0,10000,0,0,0,10000,0,10000,10000
04864P,欣興元大94售10  ,0,0,0,0,0,0,0,0,0,10000,0,0,0,10000,0,10000,10000
048742,瀚宇博統一94購01,0,0,0,0,0,0,0,0,0,10000,0,0,0,10000,0,10000,10000
048743,美利達統一94購01,0,0,0,0,0,0,0,0,0,10000,0,0,0,10000,0,10000,10000
048733,台勝科麥證95購02,0,0,0,130000,0,130000,0,0,0,10000,0,0,0,130000,120000,10000,10000
048758,美利達元富96購02,0,0,0,0,0,0,0,0,0,10000,0,0,0,10000,0,10000,10000
048756,志超元富96購02  ,0,0,0,0,0,0,0,0,0,10000,0,0,0,10000,0,10000,10000
049176,漢唐凱基94購02  ,0,0,0,0,0,0,0,0,0,10000,0,0,0,10000,0,10000,10000
049145,南亞科元大94購01,0,0,0,0,0,0,0,0,0,10000,0,0,0,68000,58000,10000,10000
04918P,華新科凱基94售12,0,0,0,0,0,0,0,0,0,10000,0,0,0,10000,0,10000,10000
049092,聯茂凱基94購07  ,0,0,0,0,0,0,0,0,0,10000,0,0,0,10000,0,10000,10000
049034,台達電兆豐94購01,0,0,0,0,0,0,0,0,0,10000,0,0,0,16000,6000,10000,10000
047353,台郡凱基93購03  ,0,0,0,0,0,0,0,0,0,10000,0,0,0,10000,0,10000,10000
047674,群創元富96購02  ,0,0,0,0,0,0,0,0,0,10000,0,0,0,10000,0,10000,10000
047323,利勤元大93購01  ,0,0,0,0,0,0,0,0,0,10000,0,0,0,10000,0,10000,10000
047641,可成元大93購09  ,0,0,0,0,0,0,0,0,0,10000,0,0,0,14000,4000,10000,10000
047634,亞德客元大93購01,0,0,0,0,0,0,0,0,0,10000,0,0,0,40000,30000,10000,10000
047622,中磊凱基93購02  ,0,0,0,0,0,0,0,0,0,10000,0,0,0,10000,0,10000,10000
047570,元上證群益93購02,0,0,0,0,0,0,0,0,0,10000,0,0,0,10000,0,10000,10000
04758P,國巨凱基94售03  ,0,0,0,0,0,0,0,0,0,10000,0,0,0,10000,0,10000,10000
047706,燿華凱基95購01  ,0,0,0,0,0,0,0,0,0,10000,0,0,0,10000,0,10000,10000
04927P,大立光凱基95售06,0,0,0,0,0,0,0,0,0,10000,0,0,0,10000,0,10000,10000
049911,智邦元大94購05  ,0,0,0,0,0,0,0,0,0,10000,0,0,0,17000,7000,10000,10000
049925,創意元大95購02  ,0,0,0,0,0,0,0,0,0,10000,0,0,0,10000,0,10000,10000
048040,百和凱基93購07  ,0,0,0,0,0,0,0,0,0,10000,0,0,0,30000,20000,10000,10000
048043,滬深2X永豐94購03,0,0,0,0,0,0,0,0,0,10000,0,0,0,10000,0,10000,10000
04696P,亞德客國泰95售02,0,0,0,0,0,0,0,0,0,10000,0,0,0,40000,30000,10000,10000
048027,京元電凱基93購03,0,0,0,0,0,0,0,0,0,10000,0,0,0,50000,40000,10000,10000
046905,新光金凱基99購01,0,0,0,0,0,0,0,0,0,10000,0,0,0,10000,0,10000,10000
046127,臻鼎元大92購07  ,0,0,0,0,0,0,0,0,0,10000,0,0,0,100000,90000,10000,10000
046121,大立光元大92購18,0,0,0,0,0,0,0,0,0,10000,0,0,0,10000,0,10000,10000
046148,友達中信94購01  ,0,0,0,0,0,0,0,0,0,10000,0,0,0,10000,0,10000,10000
046163,友達兆豐92購02  ,0,0,0,0,0,0,0,0,0,10000,0,0,0,10000,0,10000,10000
046181,智邦凱基92購04  ,0,0,0,0,0,0,0,0,0,10000,0,0,0,10000,0,10000,10000
046202,台表科凱基93購04,0,0,0,0,0,0,0,0,0,10000,0,0,0,50000,40000,10000,10000
048084,華通凱基93購05  ,0,0,0,0,0,0,0,0,0,10000,0,0,0,41000,31000,10000,10000
047387,美律元大93購05  ,0,0,0,0,0,0,0,0,0,10000,0,0,0,10000,0,10000,10000
048075,美利達元富93購02,0,0,0,0,0,0,0,0,0,10000,0,0,0,10000,0,10000,10000
048055,燿華國泰95購02  ,0,0,0,0,0,0,0,0,0,10000,0,0,0,20000,10000,10000,10000
047423,華新亞東93購01  ,0,0,0,0,0,0,0,0,0,10000,0,0,0,10000,0,10000,10000
047416,台泥富邦94購01  ,0,0,0,0,0,0,0,0,0,10000,0,0,0,10000,0,10000,10000
047010,聯詠統一93購05  ,0,0,0,0,0,0,0,0,0,10000,0,0,0,20000,10000,10000,10000
045899,臻鼎元大92購03  ,0,0,0,0,0,0,0,0,0,10000,0,0,0,10000,0,10000,10000
045903,緯穎元大92購02  ,0,0,0,0,0,0,0,0,0,10000,0,0,0,10000,0,10000,10000
045922,臺股指國票92購12,0,0,0,0,0,0,0,0,0,10000,0,0,0,10000,0,10000,10000
045919,臺股指國票92購09,0,0,0,0,0,0,0,0,0,10000,0,0,0,10000,0,10000,10000
045954,台積電凱基92購16,0,0,0,0,0,0,0,0,0,10000,0,0,0,10000,0,10000,10000
046002,美律統一93購01  ,0,0,0,0,0,0,0,0,0,10000,0,0,0,55000,45000,10000,10000
046004,群創統一93購02  ,0,0,0,0,0,0,0,0,0,10000,0,0,0,10000,0,10000,10000
046066,長榮航凱基94購01,0,0,0,0,0,0,0,0,0,10000,0,0,0,10000,0,10000,10000
046082,矽力凱基92購01  ,0,0,0,0,0,0,0,0,0,10000,0,0,0,10000,0,10000,10000
046098,南茂國票92購01  ,0,0,0,0,0,0,0,0,0,10000,0,0,0,10000,0,10000,10000
046024,鴻海元大92購11  ,0,0,0,0,0,0,0,0,0,10000,0,0,0,10000,0,10000,10000
046036,大立光元大92購15,0,0,0,0,0,0,0,0,0,10000,0,0,0,10000,0,10000,10000
046037,大立光元大92購16,0,0,0,0,0,0,0,0,0,10000,0,0,0,10000,0,10000,10000
048007,明基材元大96購01,0,0,0,0,0,0,0,0,0,10000,0,0,0,55000,45000,10000,10000
046821,奇鋐凱基93購02  ,0,0,0,0,0,0,0,0,0,10000,0,0,0,30000,20000,10000,10000
046829,義隆群益93購01  ,0,0,0,0,0,0,0,0,0,10000,0,0,0,10000,0,10000,10000
04856P,光磊元富94售01  ,0,0,0,0,0,0,0,0,0,10000,0,0,0,10000,0,10000,10000
048579,華新富邦93購01  ,0,0,0,0,0,0,0,0,0,10000,0,0,0,10000,0,10000,10000
048556,技嘉元大93購03  ,0,0,0,0,0,0,0,0,0,10000,0,0,0,25000,15000,10000,10000
046495,鴻海元大92購15  ,0,0,0,0,0,0,0,0,0,10000,0,0,0,10000,0,10000,10000
047937,元金2X國票97購02,0,0,0,0,0,0,0,0,0,10000,0,0,0,10000,0,10000,10000
046624,彩晶凱基94購02  ,0,0,0,0,0,0,0,0,0,10000,0,0,0,10000,0,10000,10000
046652,上銀元大93購02  ,0,0,0,0,0,0,0,0,0,10000,0,0,0,20000,10000,10000,10000
04664P,臺股指國票94售03,0,0,0,0,0,0,0,0,0,10000,0,0,0,10000,0,10000,10000
046565,康控凱基92購02  ,0,0,0,0,0,0,0,0,0,10000,0,0,0,20000,10000,10000,10000
046595,奇鋐第一93購01  ,0,0,0,0,0,0,0,0,0,10000,0,0,0,20000,10000,10000,10000
046588,大立光元大93購13,0,0,0,0,0,0,0,0,0,10000,0,0,0,13000,3000,10000,10000
046694,智邦凱基93購01  ,0,0,0,0,0,0,0,0,0,10000,0,0,0,10000,0,10000,10000
046720,元油2X元大95購08,0,0,0,0,0,0,0,0,0,10000,0,0,0,10000,0,10000,10000
047959,南電永豐93購03  ,0,0,0,0,0,0,0,0,0,10000,0,0,0,10000,0,10000,10000
046449,台達電凱基92購02,0,0,0,0,0,0,0,0,0,10000,0,0,0,10000,0,10000,10000
048493,微星元大93購04  ,0,0,0,0,0,0,0,0,0,10000,0,0,0,10000,0,10000,10000
048494,瑞昱元大93購13  ,0,0,0,0,0,0,0,0,0,10000,0,0,0,10000,0,10000,10000
048519,緯穎凱基93購02  ,0,0,0,0,0,0,0,0,0,10000,0,0,0,10000,0,10000,10000
048417,國巨統一94購01  ,0,0,0,0,0,0,0,0,0,10000,0,0,0,10000,0,10000,10000
048447,美律凱基93購06  ,0,0,0,0,0,0,0,0,0,10000,0,0,0,10000,0,10000,10000
048464,康控台新94購01  ,0,0,0,0,0,0,0,0,0,10000,0,0,0,30000,20000,10000,10000
046349,康控兆豐93購02  ,0,0,0,0,0,0,0,0,0,10000,0,0,0,10000,0,10000,10000
047833,全新元大94購02  ,0,0,0,0,0,0,0,0,0,10000,0,0,0,10000,0,10000,10000
047855,美律國票94購01  ,5000,0,5000,0,0,0,0,0,0,5000,0,0,0,44000,39000,5000,10000
051895,聯茂元富95購02  ,0,0,0,0,0,0,0,0,0,10000,0,0,0,108000,98000,10000,10000
051881,上証2X永豐95購02,0,0,0,0,0,0,0,0,0,10000,0,0,0,20000,10000,10000,10000
051909,潤泰全元大95購02,0,0,0,0,0,0,0,0,0,10000,0,0,0,10000,0,10000,10000
052048,景碩凱基95購01  ,0,0,0,0,0,0,0,0,0,10000,0,0,0,10000,0,10000,10000
052114,華固中信95購01  ,0,0,0,0,0,0,0,0,0,10000,0,0,0,10000,0,10000,10000
052056,緯穎凱基95購04  ,0,0,0,0,0,0,0,0,0,10000,0,0,0,20000,10000,10000,10000
052202,矽力統一96購01  ,0,0,0,0,0,0,0,0,0,10000,0,0,0,11000,1000,10000,10000
051787,燿華國票96購02  ,0,0,0,0,0,0,0,0,0,10000,0,0,0,11000,1000,10000,10000
051792,泰鼎國票96購02  ,0,0,0,0,0,0,0,0,0,10000,0,0,0,10000,0,10000,10000
05172P,臺股指元大95售16,0,0,0,0,0,0,0,0,0,10000,0,0,0,50000,40000,10000,10000
051759,全新元大95購04  ,0,0,0,0,0,0,0,0,0,10000,0,0,0,20000,10000,10000,10000
051822,和碩元富95購01  ,0,0,0,0,0,0,0,0,0,10000,0,0,0,20000,10000,10000,10000
051854,鴻海麥證95購04  ,0,0,0,20000,10000,10000,0,0,0,10000,0,0,0,20000,10000,10000,10000
05188P,可成凱基95售09  ,0,0,0,0,0,0,0,0,0,10000,0,0,0,10000,0,10000,10000
051884,樺漢永豐95購01  ,0,0,0,0,0,0,0,0,0,10000,0,0,0,10000,0,10000,10000
051659,力山國泰97購01  ,0,0,0,0,0,0,0,0,0,10000,0,0,0,10000,0,10000,10000
051610,GIS群益95購02   ,0,0,0,0,0,0,0,0,0,10000,0,0,0,20000,10000,10000,10000
051648,TPK永豐95購01   ,0,0,0,0,0,0,0,0,0,10000,0,0,0,48000,38000,10000,10000
051586,國泰金元大96購01,0,0,0,0,0,0,0,0,0,10000,0,0,0,10000,0,10000,10000
050918,南亞科日盛95購01,0,0,0,0,0,0,0,0,0,10000,0,0,0,13000,3000,10000,10000
050925,可成凱基95購02  ,0,0,0,0,0,0,0,0,0,10000,0,0,0,10000,0,10000,10000
050920,旺宏凱基95購01  ,0,0,0,0,0,0,0,0,0,10000,0,0,0,10000,0,10000,10000
051047,深中小群益99購01,0,0,0,0,0,0,0,0,0,10000,0,0,0,10000,0,10000,10000
051043,瀚宇博永豐95購01,0,0,0,0,0,0,0,0,0,10000,0,0,0,10000,0,10000,10000
051078,力山富邦97購01  ,0,0,0,0,0,0,0,0,0,10000,0,0,0,10000,0,10000,10000
051029,緯創元富95購01  ,0,0,0,0,0,0,0,0,0,10000,0,0,0,10000,0,10000,10000
051165,可成元大95購01  ,0,0,0,0,0,0,0,0,0,10000,0,0,0,10000,0,10000,10000
051148,聯發科凱基95購06,0,0,0,0,0,0,0,0,0,10000,0,0,0,12000,2000,10000,10000
051433,中磊元富95購01  ,0,0,0,0,0,0,0,0,0,10000,0,0,0,16000,6000,10000,10000
05154P,台積電兆豐95售05,0,0,0,0,0,0,0,0,0,10000,0,0,0,10000,0,10000,10000
051306,嘉聯益凱基96購01,0,0,0,0,0,0,0,0,0,10000,0,0,0,10000,0,10000,10000
051254,健策元大96購04  ,0,0,0,0,0,0,0,0,0,10000,0,0,0,10000,0,10000,10000
051282,GIS兆豐95購02   ,0,0,0,0,0,0,0,0,0,10000,0,0,0,10000,0,10000,10000
05134P,鴻海凱基96售06  ,0,0,0,0,0,0,0,0,0,10000,0,0,0,20000,10000,10000,10000
049477,泰鼎永豐94購01  ,0,0,0,0,0,0,0,0,0,10000,0,0,0,10000,0,10000,10000
049725,台郡國票94購03  ,0,0,0,0,0,0,0,0,0,10000,0,0,0,12000,2000,10000,10000
049719,義隆凱基94購03  ,0,0,0,0,0,0,0,0,0,10000,0,0,0,10000,0,10000,10000
049717,微星凱基94購01  ,0,0,0,0,0,0,0,0,0,10000,0,0,0,10000,0,10000,10000
04977P,力成凱基96售01  ,0,0,0,0,0,0,0,0,0,10000,0,0,0,50000,40000,10000,10000
049780,智易統一94購02  ,0,0,0,0,0,0,0,0,0,10000,0,0,0,40000,30000,10000,10000
049727,台積電中信94購02,0,0,0,0,0,0,0,0,0,10000,0,0,0,20000,10000,10000,10000
04973P,台積電凱基94售41,0,0,0,0,0,0,0,0,0,10000,0,0,0,10000,0,10000,10000
049603,富邦金亞東94購01,0,0,0,0,0,0,0,0,0,10000,0,0,0,10000,0,10000,10000
050122,臺指反凱基96購01,0,0,0,0,0,0,0,0,0,10000,0,0,0,10000,0,10000,10000
050118,臻鼎元大94購01  ,0,0,0,0,0,0,0,0,0,10000,0,0,0,10000,0,10000,10000
050052,致伸群益94購04  ,0,0,0,0,0,0,0,0,0,10000,0,0,0,10000,0,10000,10000
050039,鴻海中信94購03  ,0,0,0,0,0,0,0,0,0,10000,0,0,0,10000,0,10000,10000
050064,華新科凱基94購08,0,0,0,0,0,0,0,0,0,10000,0,0,0,15000,5000,10000,10000
050128,旺宏凱基94購04  ,0,0,0,0,0,0,0,0,0,10000,0,0,0,10000,0,10000,10000
050189,旭富元大94購01  ,0,0,0,0,0,0,0,0,0,10000,0,0,0,10000,0,10000,10000
05018P,臺股指元大95售09,0,0,0,0,0,0,0,0,0,10000,0,0,0,10000,0,10000,10000
050006,華擎永豐94購03  ,0,0,0,0,0,0,0,0,0,10000,0,0,0,10000,0,10000,10000
050012,台積電國泰95購03,0,0,0,0,0,0,0,0,0,10000,0,0,0,11000,1000,10000,10000
050030,嘉晶元大94購03  ,0,0,0,0,0,0,0,0,0,10000,0,0,0,25000,15000,10000,10000
049873,華新科台新94購02,0,0,0,0,0,0,0,0,0,10000,0,0,0,10000,0,10000,10000
049846,台泥群益94購01  ,0,0,0,0,0,0,0,0,0,10000,0,0,0,10000,0,10000,10000
049820,世紀鋼元大96購03,0,0,0,0,0,0,0,0,0,10000,0,0,0,10000,0,10000,10000
049807,新光金元大96購02,0,0,0,0,0,0,0,0,0,10000,0,0,0,10000,0,10000,10000
04980P,臺股指凱基96售08,0,0,0,0,0,0,0,0,0,10000,0,0,0,10000,0,10000,10000
050522,聯發科元大95購03,0,0,0,0,0,0,0,0,0,10000,0,0,0,10000,0,10000,10000
050460,GIS元大95購03   ,0,0,0,0,0,0,0,0,0,10000,0,0,0,185000,175000,10000,10000
050471,國泰金台新94購01,0,0,0,0,0,0,0,0,0,10000,0,0,0,10000,0,10000,10000
050213,華新科台新94購03,0,0,0,0,0,0,0,0,0,10000,0,0,0,10000,0,10000,10000
050221,TPK元富94購02   ,0,0,0,0,0,0,0,0,0,10000,0,0,0,10000,0,10000,10000
050248,臻鼎凱基94購03  ,0,0,0,0,0,0,0,0,0,10000,0,0,0,10000,0,10000,10000
050235,國巨凱基94購11  ,0,0,0,0,0,0,0,0,0,10000,0,0,0,10000,0,10000,10000
050343,鴻海元富94購01  ,0,0,0,0,0,0,0,0,0,10000,0,0,0,10000,0,10000,10000
050848,日月光國票95購01,0,0,0,0,0,0,0,0,0,10000,0,0,0,300000,290000,10000,10000
050833,台郡凱基95購01  ,0,0,0,0,0,0,0,0,0,10000,0,0,0,10000,0,10000,10000
050734,台積電台新94購02,0,0,0,0,0,0,0,0,0,10000,0,0,0,10000,0,10000,10000
050787,致伸國泰96購01  ,0,0,0,0,0,0,0,0,0,10000,0,0,0,14000,4000,10000,10000
050776,康控元大96購03  ,0,0,0,0,0,0,0,0,0,10000,0,0,0,10000,0,10000,10000
050777,臻鼎元大94購05  ,0,0,0,0,0,0,0,0,0,10000,0,0,0,10000,0,10000,10000
050782,台積電國泰96購03,0,0,0,0,0,0,0,0,0,10000,0,0,0,13000,3000,10000,10000
8101,華冠            ,11000,1000,10000,0,0,0,0,0,0,0,0,0,0,0,0,0,10000
8033,雷虎            ,14000,4000,10000,0,0,0,0,0,0,0,0,0,0,0,0,0,10000
9905,大華            ,10000,0,10000,0,0,0,0,0,0,0,0,0,0,0,0,0,10000
05617P,大立光統一97售02,0,0,0,0,0,0,0,0,0,10000,0,0,0,67000,57000,10000,10000
05601P,鴻海元大97售04  ,0,0,0,0,0,0,0,0,0,10000,0,0,0,64000,54000,10000,10000
05707P,中磊永豐96售01  ,0,0,0,0,0,0,0,0,0,10000,0,0,0,10000,0,10000,10000
05857P,旺宏中信98售02  ,0,0,0,0,0,0,0,0,0,10000,0,0,0,15000,5000,10000,10000
05787P,臺股指永昌96售04,0,0,0,0,0,0,0,0,0,10000,12000,0,12000,235000,237000,-2000,10000
05940P,聯發科凱基96售21,0,0,0,0,0,0,0,0,0,10000,0,0,0,10000,0,10000,10000
05942P,奇力新凱基96售04,0,0,0,0,0,0,0,0,0,10000,0,0,0,10000,0,10000,10000
05892P,大立光中信98售03,0,0,0,0,0,0,0,0,0,10000,0,0,0,10000,0,10000,10000
05916P,聯發科元大96售20,0,0,0,0,0,0,0,0,0,10000,0,0,0,10000,0,10000,10000
1476,儒鴻            ,156000,150000,6000,0,0,0,0,0,0,4000,14000,17000,-3000,31000,24000,7000,10000
1568,倉佑            ,12000,2000,10000,0,0,0,0,0,0,0,0,0,0,0,0,0,10000
1321,大洋            ,87000,76000,11000,0,0,0,0,0,0,-1000,0,1000,-1000,0,0,0,10000
05988P,光磊元富96售02  ,0,0,0,0,0,0,0,0,0,10000,0,0,0,10000,0,10000,10000
1712,興農            ,16000,5000,11000,0,0,0,0,0,0,-1000,0,0,0,0,1000,-1000,10000
2413,環科            ,15000,5000,10000,0,0,0,0,0,0,0,0,0,0,0,0,0,10000
2414,精技            ,20000,10000,10000,0,0,0,0,0,0,0,0,0,0,0,0,0,10000
2910,統領            ,12000,2000,10000,0,0,0,0,0,0,0,0,0,0,0,0,0,10000
2936,客思達-KY       ,11000,1000,10000,0,0,0,0,0,0,0,0,0,0,0,0,0,10000
052844,台積電統一96購02,0,0,0,0,0,0,0,0,0,9000,0,0,0,10000,1000,9000,9000
053223,台郡凱基96購02  ,0,0,0,0,0,0,0,0,0,9000,0,0,0,9000,0,9000,9000
053023,泰鼎國泰97購01  ,0,0,0,0,0,0,0,0,0,9000,0,0,0,12000,3000,9000,9000
053255,貿聯國泰97購01  ,0,0,0,0,0,0,0,0,0,9000,0,0,0,73000,64000,9000,9000
053938,彩晶元富96購01  ,0,0,0,0,0,0,0,0,0,9000,0,0,0,139000,130000,9000,9000
054168,貿聯凱基97購02  ,0,0,0,0,0,0,0,0,0,9000,0,0,0,31000,22000,9000,9000
05363P,臺股指富邦95售03,0,0,0,0,0,0,0,0,0,9000,0,0,0,30000,21000,9000,9000
053600,同欣電元大96購04,0,0,0,0,0,0,0,0,0,9000,0,0,0,20000,11000,9000,9000
05379P,可成凱基95售11  ,0,0,0,0,0,0,0,0,0,9000,0,0,0,10000,1000,9000,9000
053850,嘉澤元富96購03  ,0,0,0,0,0,0,0,0,0,9000,0,0,0,9000,0,9000,9000
054577,世芯元大98購01  ,0,0,0,0,0,0,0,0,0,9000,0,0,0,11000,2000,9000,9000
05433P,智原元富95售02  ,0,0,0,0,0,0,0,0,0,9000,0,0,0,30000,21000,9000,9000
054232,台積電群益96購12,0,0,0,0,0,0,0,0,0,9000,0,0,0,10000,1000,9000,9000
054479,緯創中信98購01  ,0,0,0,0,0,0,0,0,0,9000,0,0,0,9000,0,9000,9000
042918,矽格元大94購01  ,0,0,0,0,0,0,0,0,0,9000,0,0,0,9000,0,9000,9000
04196P,東陽中信93售02  ,0,0,0,0,0,0,0,0,0,9000,0,0,0,19000,10000,9000,9000
041978,貿聯中信93購01  ,0,0,0,0,0,0,0,0,0,9000,0,0,0,130000,121000,9000,9000
044426,欣興國泰93購02  ,0,0,0,0,0,0,0,0,0,9000,0,0,0,11000,2000,9000,9000
03055P,台積電康和01售02,0,0,0,0,0,0,0,0,0,9000,0,0,0,9000,0,9000,9000
00735,國泰臺韓科技    ,0,0,0,0,0,0,0,0,0,9000,0,0,0,111000,102000,9000,9000
044996,嘉晶國泰95購01  ,0,0,0,0,0,0,0,0,0,9000,0,0,0,28000,19000,9000,9000
047939,亞德客國票93購02,0,0,0,0,0,0,0,0,0,9000,0,0,0,11000,2000,9000,9000
046491,滬深2X富邦95購02,0,0,0,0,0,0,0,0,0,9000,0,0,0,10000,1000,9000,9000
046890,瑞昱群益93購02  ,0,0,0,0,0,0,0,0,0,9000,0,0,0,40000,31000,9000,9000
046750,鴻海凱基93購17  ,0,0,0,0,0,0,0,0,0,9000,0,0,0,27000,18000,9000,9000
048082,台苯凱基93購01  ,0,0,0,0,0,0,0,0,0,9000,0,0,0,9000,0,9000,9000
048015,致伸國票93購03  ,0,0,0,0,0,0,0,0,0,9000,0,0,0,9000,0,9000,9000
049264,奇鋐元大95購01  ,0,0,0,0,0,0,0,0,0,9000,0,0,0,514000,505000,9000,9000
047455,儒鴻群益93購03  ,0,0,0,0,0,0,0,0,0,9000,0,0,0,59000,50000,9000,9000
050854,世紀鋼國票97購01,0,0,0,0,0,0,0,0,0,9000,0,0,0,9000,0,9000,9000
050649,華新科凱基96購01,0,0,0,0,0,0,0,0,0,9000,0,0,0,11000,2000,9000,9000
050269,欣興元大94購09  ,0,0,0,0,0,0,0,0,0,9000,0,0,0,9000,0,9000,9000
050543,聯發科凱基95購01,0,0,0,0,0,0,0,0,0,9000,0,0,0,112000,103000,9000,9000
050479,上証2X國票95購02,0,0,0,0,0,0,0,0,0,9000,0,0,0,21000,12000,9000,9000
050168,緯創富邦95購01  ,0,0,0,0,0,0,0,0,0,9000,0,0,0,19000,10000,9000,9000
049493,可成元大94購05  ,0,0,0,0,0,0,0,0,0,9000,0,0,0,10000,1000,9000,9000
051270,百和富邦95購01  ,0,0,0,0,0,0,0,0,0,9000,0,0,0,9000,0,9000,9000
051313,緯創麥證95購02  ,0,0,0,19000,10000,9000,0,0,0,9000,0,0,0,19000,10000,9000,9000
051485,玉晶光凱基97購02,0,0,0,0,0,0,0,0,0,9000,0,0,0,87000,78000,9000,9000
051075,智邦國泰97購01  ,0,0,0,0,0,0,0,0,0,9000,0,0,0,80000,71000,9000,9000
051009,緯創麥證95購01  ,0,0,0,19000,10000,9000,0,0,0,9000,0,0,0,19000,10000,9000,9000
051791,智伸科國票96購01,0,0,0,0,0,0,0,0,0,9000,0,0,0,9000,0,9000,9000
051966,台表科永豐95購01,0,0,0,0,0,0,0,0,0,9000,0,0,0,19000,10000,9000,9000
2739,寒舍            ,9000,0,9000,0,0,0,0,0,0,0,0,0,0,0,0,0,9000
3057,喬鼎            ,9000,0,9000,0,0,0,0,0,0,0,0,0,0,0,0,0,9000
3059,華晶科          ,83000,73000,10000,0,0,0,0,0,0,-1000,0,1000,-1000,0,0,0,9000
4956,光鋐            ,25000,16000,9000,0,0,0,0,0,0,0,0,0,0,0,0,0,9000
3588,通嘉            ,31000,22000,9000,0,0,0,0,0,0,0,0,0,0,0,0,0,9000
2415,錩新            ,10000,1000,9000,0,0,0,0,0,0,0,0,0,0,0,0,0,9000
2459,敦吉            ,10000,1000,9000,0,0,0,0,0,0,0,0,0,0,0,0,0,9000
2069,運錩            ,17000,8000,9000,0,0,0,0,0,0,0,0,0,0,0,0,0,9000
1419,新紡            ,9000,0,9000,0,0,0,0,0,0,0,0,0,0,0,0,0,9000
1707,葡萄王          ,30000,29000,1000,0,0,0,0,0,0,8000,8000,0,8000,0,0,0,9000
05878P,創意群益98售01  ,0,0,0,0,0,0,0,0,0,9000,0,0,0,29000,20000,9000,9000
9955,佳龍            ,206000,197000,9000,0,0,0,0,0,0,0,0,0,0,0,0,0,9000
6442,光聖            ,13000,2000,11000,0,0,0,0,0,0,-2000,0,2000,-2000,0,0,0,9000
6405,悅城            ,10000,1000,9000,0,0,0,0,0,0,0,0,0,0,0,0,0,9000
6464,台數科          ,9000,0,9000,0,0,0,0,0,0,0,0,0,0,0,0,0,9000
5531,鄉林            ,93000,84000,9000,0,0,0,0,0,0,0,0,0,0,0,0,0,9000
5608,四維航          ,9000,0,9000,0,0,0,0,0,0,0,0,0,0,0,0,0,9000
6024,群益期          ,10000,1000,9000,0,0,0,0,0,0,0,0,0,0,0,0,0,9000
05435P,鴻海群益95售12  ,0,0,0,0,0,0,0,0,0,8000,0,0,0,11000,3000,8000,8000
054349,同欣電國票97購02,0,0,0,0,0,0,0,0,0,8000,0,0,0,10000,2000,8000,8000
054547,鴻海凱基98購02  ,0,0,0,0,0,0,0,0,0,8000,0,0,0,24000,16000,8000,8000
053893,京鼎群益97購02  ,0,0,0,0,0,0,0,0,0,8000,0,0,0,30000,22000,8000,8000
054183,亞光康和96購01  ,0,0,0,0,0,0,0,0,0,8000,0,0,0,229000,221000,8000,8000
053914,國巨國票96購08  ,0,0,0,0,0,0,0,0,0,8000,0,0,0,11000,3000,8000,8000
053919,可成國票97購02  ,0,0,0,0,0,0,0,0,0,8000,0,0,0,11000,3000,8000,8000
053309,泰鼎凱基96購03  ,0,0,0,0,0,0,0,0,0,8000,0,0,0,38000,30000,8000,8000
053348,彩晶國票97購02  ,0,0,0,0,0,0,0,0,0,8000,0,0,0,21000,13000,8000,8000
045165,台虹國泰93購01  ,0,0,0,0,0,0,0,0,0,8000,0,0,0,668000,660000,8000,8000
045166,深100富邦92購01 ,0,0,0,0,0,0,0,0,0,8000,0,0,0,108000,100000,8000,8000
045131,瑞昱統一92購02  ,0,0,0,0,0,0,0,0,0,8000,0,0,0,28000,20000,8000,8000
044888,華新日盛91購01  ,0,0,0,0,0,0,0,0,0,8000,0,0,0,8000,0,8000,8000
04394P,臻鼎凱基94售01  ,0,0,0,0,0,0,0,0,0,8000,0,0,0,10000,2000,8000,8000
044108,華新科國票91購03,0,0,0,0,0,0,0,0,0,8000,0,0,0,98000,90000,8000,8000
044095,大立光統一92購01,0,0,0,0,0,0,0,0,0,8000,0,0,0,8000,0,8000,8000
046327,康控元大92購01  ,0,0,0,0,0,0,0,0,0,8000,0,0,0,125000,117000,8000,8000
046311,聯發科元大92購16,0,0,0,0,0,0,0,0,0,8000,0,0,0,8000,0,8000,8000
00700,富邦恒生國企    ,0,0,0,0,0,0,0,0,0,8000,0,0,0,114000,106000,8000,8000
03186P,台積電元大01售50,0,0,0,0,0,0,0,0,0,8000,0,0,0,8000,0,8000,8000
044418,臻鼎統一91購01  ,0,0,0,0,0,0,0,0,0,8000,0,0,0,10000,2000,8000,8000
042618,台灣50群益92購04,0,0,0,0,0,0,0,0,0,8000,0,0,0,8000,0,8000,8000
048164,台光電康和93購01,0,0,0,0,0,0,0,0,0,8000,0,0,0,8000,0,8000,8000
048114,景碩群益93購02  ,0,0,0,0,0,0,0,0,0,8000,0,0,0,129000,121000,8000,8000
047167,農林康和93購01  ,0,0,0,0,0,0,0,0,0,8000,0,0,0,11000,3000,8000,8000
047569,世紀鋼國票94購02,0,0,0,0,0,0,0,0,0,8000,0,0,0,8000,0,8000,8000
048996,中環第一94購01  ,0,0,0,0,0,0,0,0,0,8000,0,0,0,8000,0,8000,8000
04914P,國巨國泰95售06  ,0,0,0,0,0,0,0,0,0,8000,0,0,0,23000,15000,8000,8000
046193,大立光凱基92購06,0,0,0,0,0,0,0,0,0,8000,0,0,0,8000,0,8000,8000
046184,台光電凱基93購08,0,0,0,0,0,0,0,0,0,8000,0,0,0,8000,0,8000,8000
04595P,臺股指元大94售13,0,0,0,0,0,0,0,0,0,8000,0,0,0,8000,0,8000,8000
046465,GIS凱基95購01   ,0,0,0,0,0,0,0,0,0,8000,0,0,0,10000,2000,8000,8000
046650,台表科國泰94購01,0,0,0,0,0,0,0,0,0,8000,0,0,0,10000,2000,8000,8000
052021,易華電永豐95購03,0,0,0,0,0,0,0,0,0,8000,0,0,0,8000,0,8000,8000
051577,台積電元大97購03,0,0,0,0,0,0,0,0,0,8000,0,0,0,154000,146000,8000,8000
051633,可成國票96購03  ,0,0,0,0,0,0,0,0,0,8000,0,0,0,9000,1000,8000,8000
051239,國巨元大96購02  ,0,0,0,0,0,0,0,0,0,8000,0,0,0,14000,6000,8000,8000
051512,超眾麥證95購01  ,0,0,0,8000,0,8000,0,0,0,8000,0,0,0,8000,0,8000,8000
049651,訊芯凱基94購04  ,0,0,0,0,0,0,0,0,0,8000,0,0,0,70000,62000,8000,8000
049969,泰鼎國票95購01  ,0,0,0,0,0,0,0,0,0,8000,0,0,0,8000,0,8000,8000
049983,智原凱基94購02  ,0,0,0,0,0,0,0,0,0,8000,0,0,0,47000,39000,8000,8000
050310,卜蜂兆豐94購01  ,0,0,0,0,0,0,0,0,0,8000,0,0,0,10000,2000,8000,8000
050351,華新科群益95購02,0,0,0,0,0,0,0,0,0,8000,0,0,0,8000,0,8000,8000
050791,聯發科富邦96購01,0,0,0,0,0,0,0,0,0,8000,0,0,0,26000,18000,8000,8000
050761,華通元大94購05  ,0,0,0,0,0,0,0,0,0,8000,0,0,0,112000,104000,8000,8000
8103,瀚荃            ,11000,3000,8000,0,0,0,0,0,0,0,0,0,0,0,0,0,8000
8481,政伸            ,10000,0,10000,0,0,0,0,0,0,-2000,0,2000,-2000,0,0,0,8000
8427,基勝-KY         ,8000,0,8000,0,0,0,0,0,0,0,0,0,0,0,0,0,8000
05789P,臺股指永昌96售06,0,0,0,0,0,0,0,0,0,8000,0,0,0,8000,0,8000,8000
05757P,旺宏永豐96售03  ,0,0,0,0,0,0,0,0,0,8000,0,0,0,38000,30000,8000,8000
05639P,欣興統一97售01  ,0,0,0,0,0,0,0,0,0,8000,0,0,0,8000,0,8000,8000
1608,華榮            ,22000,14000,8000,0,0,0,0,0,0,0,0,0,0,0,0,0,8000
1727,中華化          ,8000,0,8000,0,0,0,0,0,0,0,0,0,0,0,0,0,8000
3501,維熹            ,15000,7000,8000,0,0,0,0,0,0,0,0,0,0,0,0,0,8000
4532,瑞智            ,19000,11000,8000,0,0,0,0,0,0,0,0,0,0,0,0,0,8000
4144,康聯-KY         ,10000,2000,8000,0,0,0,0,0,0,0,0,0,0,0,0,0,8000
4763,材料-KY         ,13000,15000,-2000,0,0,0,0,0,0,10000,10000,0,10000,0,0,0,8000
4572,駐龍            ,8000,0,8000,0,0,0,0,0,0,0,0,0,0,0,0,0,8000
2712,遠雄來          ,10000,1000,9000,0,0,0,0,0,0,-1000,0,1000,-1000,0,0,0,8000
052889,致伸麥證97購01  ,0,0,0,20000,13000,7000,0,0,0,7000,0,0,0,20000,13000,7000,7000
054009,欣興元富96購03  ,0,0,0,0,0,0,0,0,0,7000,0,0,0,7000,0,7000,7000
054139,揚明光元大96購01,0,0,0,0,0,0,0,0,0,7000,0,0,0,7000,0,7000,7000
054540,泰鼎國票99購01  ,0,0,0,0,0,0,0,0,0,7000,0,0,0,7000,0,7000,7000
03839P,華通統一93售02  ,0,0,0,0,0,0,0,0,0,7000,0,0,0,7000,0,7000,7000
03875P,滬深2X國票05售01,0,0,0,0,0,0,0,0,0,7000,0,0,0,7000,0,7000,7000
039726,台積電群益91購01,0,0,0,0,0,0,0,0,0,7000,0,0,0,7000,0,7000,7000
00762,元大全球AI      ,0,0,0,0,0,0,0,0,0,7000,0,0,0,63000,56000,7000,7000
00763U,街口道瓊銅      ,0,0,0,0,0,0,0,0,0,7000,0,0,0,7000,0,7000,7000
00851,台新全球AI      ,0,0,0,0,0,0,0,0,0,7000,0,0,0,41000,34000,7000,7000
04625P,燿華元大94售03  ,0,0,0,0,0,0,0,0,0,7000,0,0,0,96000,89000,7000,7000
048201,智易元大93購06  ,0,0,0,0,0,0,0,0,0,7000,0,0,0,7000,0,7000,7000
045643,臻鼎凱基93購01  ,0,0,0,0,0,0,0,0,0,7000,0,0,0,10000,3000,7000,7000
046730,瀚宇博元大93購02,0,0,0,0,0,0,0,0,0,7000,0,0,0,8000,1000,7000,7000
048637,鴻海元大96購01  ,0,0,0,0,0,0,0,0,0,7000,0,0,0,8000,1000,7000,7000
048638,台光電元大94購01,0,0,0,0,0,0,0,0,0,7000,0,0,0,7000,0,7000,7000
048527,鴻海國票94購02  ,0,0,0,0,0,0,0,0,0,7000,0,0,0,22000,15000,7000,7000
046799,儒鴻元大93購01  ,0,0,0,0,0,0,0,0,0,7000,0,0,0,79000,72000,7000,7000
046828,聯發科群益94購01,0,0,0,0,0,0,0,0,0,7000,0,0,0,11000,4000,7000,7000
049956,國巨統一94購05  ,0,0,0,0,0,0,0,0,0,7000,0,0,0,7000,0,7000,7000
049325,智邦元富94購02  ,0,0,0,0,0,0,0,0,0,7000,0,0,0,32000,25000,7000,7000
047187,亞光元大94購01  ,0,0,0,0,0,0,0,0,0,7000,0,0,0,63000,56000,7000,7000
048789,大立光元大95購04,0,0,0,0,0,0,0,0,0,7000,0,0,0,18000,11000,7000,7000
048919,堤維西永豐94購01,0,0,0,0,0,0,0,0,0,7000,0,0,0,7000,0,7000,7000
047076,TPK兆豐94購01   ,0,0,0,0,0,0,0,0,0,7000,0,0,0,7000,0,7000,7000
050708,臺股指凱基96購06,0,0,0,0,0,0,0,0,0,7000,0,0,0,21000,14000,7000,7000
050591,智易永豐94購04  ,0,0,0,0,0,0,0,0,0,7000,0,0,0,7000,0,7000,7000
050608,台達電元大94購12,0,0,0,0,0,0,0,0,0,7000,0,0,0,17000,10000,7000,7000
050498,為升凱基94購07  ,0,0,0,0,0,0,0,0,0,7000,0,0,0,7000,0,7000,7000
050462,寶成元大94購01  ,0,0,0,0,0,0,0,0,0,7000,0,0,0,7000,0,7000,7000
049857,緯穎群益94購03  ,0,0,0,0,0,0,0,0,0,7000,0,0,0,77000,70000,7000,7000
050141,國巨統一94購07  ,0,0,0,0,0,0,0,0,0,7000,0,0,0,12000,5000,7000,7000
050028,華新科元大94購03,0,0,0,0,0,0,0,0,0,7000,0,0,0,7000,0,7000,7000
050037,金融類元大94購03,0,0,0,0,0,0,0,0,0,7000,0,0,0,7000,0,7000,7000
051499,康控群益95購02  ,0,0,0,0,0,0,0,0,0,7000,0,0,0,27000,20000,7000,7000
051482,玉晶光凱基96購01,0,0,0,0,0,0,0,0,0,7000,0,0,0,155000,148000,7000,7000
051319,光磊國票96購02  ,0,0,0,0,0,0,0,0,0,7000,0,0,0,11000,4000,7000,7000
052155,百和台新95購01  ,0,0,0,0,0,0,0,0,0,7000,0,0,0,7000,0,7000,7000
052220,T50反1凱基98購01,0,0,0,0,0,0,0,0,0,7000,0,0,0,7000,0,7000,7000
2939,凱羿-KY         ,10000,4000,6000,0,0,0,0,0,0,1000,1000,0,1000,0,0,0,7000
3701,大眾控          ,7000,0,7000,0,0,0,0,0,0,0,0,0,0,0,0,0,7000
1737,臺鹽            ,7000,0,7000,0,0,0,0,0,0,0,0,0,0,0,0,0,7000
1786,科妍            ,6000,2000,4000,0,0,0,0,0,0,3000,3000,0,3000,0,0,0,7000
1776,展宇            ,7000,0,7000,0,0,0,0,0,0,0,0,0,0,0,0,0,7000
2024,志聯            ,7000,0,7000,0,0,0,0,0,0,0,0,0,0,0,0,0,7000
2424,隴華            ,7000,0,7000,0,0,0,0,0,0,0,0,0,0,0,0,0,7000
1467,南緯            ,8000,1000,7000,0,0,0,0,0,0,0,0,0,0,0,0,0,7000
1325,恆大            ,17000,10000,7000,0,0,0,0,0,0,0,0,0,0,0,0,0,7000
1233,天仁            ,7000,0,7000,0,0,0,0,0,0,0,0,0,0,0,0,0,7000
05953P,台積電國票98售02,0,0,0,0,0,0,0,0,0,7000,0,0,0,9000,2000,7000,7000
8454,富邦媒          ,15000,3000,12000,0,0,0,0,5000,-5000,0,0,0,0,0,0,0,7000
8478,東哥遊艇        ,8000,1000,7000,0,0,0,0,0,0,0,0,0,0,0,0,0,7000
9929,秋雨            ,7000,0,7000,0,0,0,0,0,0,0,0,0,0,0,0,0,7000
9930,中聯資源        ,8000,1000,7000,0,0,0,0,0,0,0,0,0,0,0,0,0,7000
6531,愛普            ,132000,108000,24000,0,0,0,0,0,0,-17000,0,17000,-17000,0,0,0,7000
6117,迎廣            ,8000,1000,7000,0,0,0,0,0,0,0,0,0,0,0,0,0,7000
3708,上緯投控        ,72000,43076,28924,0,0,0,0,0,0,-22000,0,1000,-1000,1000,22000,-21000,6924
3033,威健            ,50000,43871,6129,0,0,0,0,0,0,0,0,0,0,0,0,0,6129
054617,超眾永豐97購01  ,0,0,0,0,0,0,0,0,0,6000,0,0,0,20000,14000,6000,6000
054614,玉晶光永豐97購03,0,0,0,0,0,0,0,0,0,6000,0,0,0,6000,0,6000,6000
05550P,臺股指元大96售07,0,0,0,0,0,0,0,0,0,6000,0,0,0,6000,0,6000,6000
054437,欣興台新97購02  ,0,0,0,0,0,0,0,0,0,6000,0,0,0,7000,1000,6000,6000
053979,健策元大98購01  ,0,0,0,0,0,0,0,0,0,6000,0,0,0,30000,24000,6000,6000
053861,台光電元大98購01,0,0,0,0,0,0,0,0,0,6000,0,0,0,42000,36000,6000,6000
053647,臺股指國票96購10,0,0,0,0,0,0,0,0,0,6000,0,0,0,13000,7000,6000,6000
052779,欣興國票97購01  ,0,0,0,0,0,0,0,0,0,6000,0,0,0,26000,20000,6000,6000
052717,正文凱基96購01  ,0,0,0,0,0,0,0,0,0,6000,0,0,0,68000,62000,6000,6000
052229,奇力新凱基96購01,0,0,0,0,0,0,0,0,0,6000,0,0,0,66000,60000,6000,6000
05223P,臻鼎凱基95售02  ,0,0,0,0,0,0,0,0,0,6000,0,0,0,84000,78000,6000,6000
052377,景碩元大96購02  ,0,0,0,0,0,0,0,0,0,6000,0,0,0,6000,0,6000,6000
053320,華新科群益97購01,0,0,0,0,0,0,0,0,0,6000,0,0,0,6000,0,6000,6000
053222,聯茂凱基96購03  ,0,0,0,0,0,0,0,0,0,6000,0,0,0,6000,0,6000,6000
044302,智邦兆豐93購02  ,0,0,0,0,0,0,0,0,0,6000,0,0,0,6000,0,6000,6000
044255,群創元大93購01  ,0,0,0,0,0,0,0,0,0,6000,0,0,0,151000,145000,6000,6000
044126,奇力新凱基93購01,0,0,0,0,0,0,0,0,0,6000,0,0,0,38000,32000,6000,6000
043891,羅麗芬元大94購01,0,0,0,0,0,0,0,0,0,6000,0,0,0,6000,0,6000,6000
045701,聯發科中信92購02,0,0,0,0,0,0,0,0,0,6000,0,0,0,6000,0,6000,6000
045781,聯詠元大92購03  ,0,0,0,0,0,0,0,0,0,6000,0,0,0,13000,7000,6000,6000
03639P,祥碩凱基93售05  ,0,0,0,0,0,0,0,0,0,6000,0,0,0,45000,39000,6000,6000
03992P,臺股指統一93售06,0,0,0,0,0,0,0,0,0,6000,0,0,0,6000,0,6000,6000
043561,和大凱基91購02  ,0,0,0,0,0,0,0,0,0,6000,0,0,0,6000,0,6000,6000
044665,京鼎國泰93購01  ,0,0,0,0,0,0,0,0,0,6000,0,0,0,6000,0,6000,6000
044707,合勤控元大93購01,0,0,0,0,0,0,0,0,0,6000,0,0,0,6000,0,6000,6000
048678,統一富邦93購01  ,0,0,0,0,0,0,0,0,0,6000,0,0,0,20000,14000,6000,6000
04743P,台積電元富94售07,0,0,0,0,0,0,0,0,0,6000,0,0,0,6000,0,6000,6000
049316,茂林凱基94購02  ,0,0,0,0,0,0,0,0,0,6000,0,0,0,7000,1000,6000,6000
047636,台達電元大93購03,0,0,0,0,0,0,0,0,0,6000,0,0,0,6000,0,6000,6000
047313,華新科元大93購08,0,0,0,0,0,0,0,0,0,6000,0,0,0,8000,2000,6000,6000
049157,矽創元大95購01  ,0,0,0,0,0,0,0,0,0,6000,0,0,0,7000,1000,6000,6000
046780,FB上証永豐93購01,0,0,0,0,0,0,0,0,0,6000,0,0,0,6000,0,6000,6000
046003,欣興統一92購02  ,0,0,0,0,0,0,0,0,0,6000,0,0,0,6000,0,6000,6000
046060,台塑凱基92購01  ,0,0,0,0,0,0,0,0,0,6000,0,0,0,6000,0,6000,6000
046095,鴻海國票92購02  ,0,0,0,0,0,0,0,0,0,6000,0,0,0,6000,0,6000,6000
046970,聯詠群益93購01  ,0,0,0,0,0,0,0,0,0,6000,0,0,0,66000,60000,6000,6000
048497,京元電元大93購02,0,0,0,0,0,0,0,0,0,6000,0,0,0,6000,0,6000,6000
047878,日股2X中信95購01,0,0,0,0,0,0,0,0,0,6000,0,0,0,13000,7000,6000,6000
047879,台積電中信93購04,0,0,0,0,0,0,0,0,0,6000,0,0,0,6000,0,6000,6000
048640,南亞科元大93購06,0,0,0,0,0,0,0,0,0,6000,0,0,0,6000,0,6000,6000
047866,得力永豐93購01  ,0,0,0,0,0,0,0,0,0,6000,0,0,0,26000,20000,6000,6000
047925,可成凱基94購01  ,0,0,0,0,0,0,0,0,0,6000,0,0,0,9000,3000,6000,6000
051868,貿聯凱基96購01  ,0,0,0,0,0,0,0,0,0,6000,0,0,0,10000,4000,6000,6000
051394,奇鋐兆豐95購01  ,0,0,0,0,0,0,0,0,0,6000,0,0,0,6000,0,6000,6000
050931,上証2X國票95購03,0,0,0,0,0,0,0,0,0,6000,0,0,0,6000,0,6000,6000
050107,鴻海元大94購12  ,0,0,0,0,0,0,0,0,0,6000,0,0,0,12000,6000,6000,6000
049988,貿聯凱基94購02  ,0,0,0,0,0,0,0,0,0,6000,0,0,0,150000,144000,6000,6000
049760,滬深2X國泰95購02,0,0,0,0,0,0,0,0,0,6000,0,0,0,6000,0,6000,6000
049699,祥碩元大94購01  ,0,0,0,0,0,0,0,0,0,6000,0,0,0,6000,0,6000,6000
050424,鴻海凱基96購03  ,0,0,0,0,0,0,0,0,0,6000,0,0,0,20000,14000,6000,6000
050218,世紀鋼統一94購02,0,0,0,0,0,0,0,0,0,6000,0,0,0,61000,55000,6000,6000
050842,旺宏國票97購01  ,0,0,0,0,0,0,0,0,0,6000,0,0,0,16000,10000,6000,6000
050868,智易永豐95購01  ,0,0,0,0,0,0,0,0,0,6000,0,0,0,6000,0,6000,6000
05087P,GIS國泰96售01   ,0,0,0,0,0,0,0,0,0,6000,0,0,0,20000,14000,6000,6000
2881B,富邦金乙特      ,0,0,0,0,0,0,0,0,0,6000,6000,0,6000,0,0,0,6000
2482,連宇            ,13000,7000,6000,0,0,0,0,0,0,0,0,0,0,0,0,0,6000
2013,中鋼構          ,15000,9000,6000,0,0,0,0,0,0,0,0,0,0,0,0,0,6000
2009,第一銅          ,6000,0,6000,0,0,0,0,0,0,0,0,0,0,0,0,0,6000
2243,宏旭-KY         ,7000,1000,6000,0,0,0,0,0,0,0,0,0,0,0,0,0,6000
2314,台揚            ,92000,139000,-47000,0,0,0,0,0,0,53000,1000,0,1000,52000,0,52000,6000
05711P,茂林國票97售03  ,0,0,0,0,0,0,0,0,0,6000,0,0,0,152000,146000,6000,6000
1307,三芳            ,19000,13000,6000,0,0,0,0,0,0,0,0,0,0,0,0,0,6000
1456,怡華            ,13000,6000,7000,0,0,0,0,0,0,-1000,0,1000,-1000,0,0,0,6000
1533,車王電          ,7000,1000,6000,0,0,0,0,0,0,0,0,0,0,0,0,0,6000
1535,中宇            ,10000,4000,6000,0,0,0,0,0,0,0,0,0,0,0,0,0,6000
6641,基士德-KY       ,9000,1000,8000,0,0,0,0,0,0,-2000,0,2000,-2000,0,0,0,6000
053247,麗豐國票97購01  ,0,0,0,0,0,0,0,0,0,5000,0,0,0,7000,2000,5000,5000
053231,奇力新康和96購01,0,0,0,0,0,0,0,0,0,5000,0,0,0,5000,0,5000,5000
053201,美律日盛96購01  ,0,0,0,0,0,0,0,0,0,5000,0,0,0,10000,5000,5000,5000
053116,華新科中信96購01,0,0,0,0,0,0,0,0,0,5000,0,0,0,5000,0,5000,5000
053064,國巨群益96購04  ,0,0,0,0,0,0,0,0,0,5000,0,0,0,35000,30000,5000,5000
052944,宏達電國票97購01,0,0,0,0,0,0,0,0,0,5000,0,0,0,5000,0,5000,5000
053385,聯詠元大96購02  ,0,0,0,0,0,0,0,0,0,5000,0,0,0,121000,116000,5000,5000
053423,亞光永豐96購01  ,0,0,0,0,0,0,0,0,0,5000,0,0,0,5000,0,5000,5000
05352P,臺股指元富95售06,0,0,0,0,0,0,0,0,0,5000,0,0,0,5000,0,5000,5000
053476,冠德元大96購03  ,0,0,0,0,0,0,0,0,0,5000,0,0,0,5000,0,5000,5000
052361,大成鋼國票96購01,0,0,0,0,0,0,0,0,0,5000,0,0,0,38000,33000,5000,5000
052265,聯發科亞東95購01,0,0,0,0,0,0,0,0,0,5000,0,0,0,5000,0,5000,5000
052285,康控凱基95購02  ,0,0,0,0,0,0,0,0,0,5000,0,0,0,80000,75000,5000,5000
05282P,可成元大95售09  ,0,0,0,0,0,0,0,0,0,5000,0,0,0,29000,24000,5000,5000
052872,智易凱基96購01  ,0,0,0,0,0,0,0,0,0,5000,0,0,0,5000,0,5000,5000
053718,全新凱基97購02  ,0,0,0,0,0,0,0,0,0,5000,0,0,0,10000,5000,5000,5000
053705,滬深2X凱基99購01,0,0,0,0,0,0,0,0,0,5000,0,0,0,5000,0,5000,5000
05559P,臺股指麥證96售01,0,0,0,70000,65000,5000,0,0,0,5000,0,0,0,70000,65000,5000,5000
05568P,台積電統一96售03,0,0,0,0,0,0,0,0,0,5000,0,0,0,5000,0,5000,5000
05490P,鴻海元大95售23  ,0,0,0,0,0,0,0,0,0,5000,0,0,0,75000,70000,5000,5000
05510P,燿華元富96售01  ,0,0,0,0,0,0,0,0,0,5000,0,0,0,5000,0,5000,5000
054531,聯發科國泰97購02,0,0,0,0,0,0,0,0,0,5000,0,0,0,5000,0,5000,5000
054590,嘉聯益國泰98購01,0,0,0,0,0,0,0,0,0,5000,0,0,0,53000,48000,5000,5000
044511,全新凱基92購01  ,0,0,0,0,0,0,0,0,0,5000,0,0,0,30000,25000,5000,5000
044555,聯鈞永豐91購02  ,0,0,0,0,0,0,0,0,0,5000,0,0,0,5000,0,5000,5000
044569,華邦電凱基92購01,0,0,0,0,0,0,0,0,0,5000,0,0,0,20000,15000,5000,5000
043436,和大元富91購01  ,0,0,0,0,0,0,0,0,0,5000,0,0,0,5000,0,5000,5000
044358,TPK元大92購02   ,0,0,0,0,0,0,0,0,0,5000,0,0,0,5000,0,5000,5000
042943,金寶國票92購01  ,0,0,0,0,0,0,0,0,0,5000,0,0,0,5000,0,5000,5000
043019,華晶科元大94購01,0,0,0,0,0,0,0,0,0,5000,0,0,0,5000,0,5000,5000
042346,創意富邦92購01  ,0,0,0,0,0,0,0,0,0,5000,0,0,0,5000,0,5000,5000
04117P,聯發科元大93售21,0,0,0,0,0,0,0,0,0,5000,0,0,0,5000,0,5000,5000
03421P,健策群益02售04  ,0,0,0,0,0,0,0,0,0,5000,0,0,0,5000,0,5000,5000
03248P,聯電元富03售03  ,0,0,0,0,0,0,0,0,0,5000,0,0,0,5000,0,5000,5000
03387P,台積電凱基03售11,0,0,0,0,0,0,0,0,0,5000,0,0,0,5000,0,5000,5000
03418P,大毅群益02售03  ,0,0,0,0,0,0,0,0,0,5000,0,0,0,5000,0,5000,5000
03661P,智邦兆豐92售01  ,0,0,0,0,0,0,0,0,0,5000,0,0,0,5000,0,5000,5000
03636P,可成凱基92售10  ,0,0,0,0,0,0,0,0,0,5000,0,0,0,5000,0,5000,5000
03615C,臺股指元大94牛01,0,0,0,0,0,0,0,0,0,5000,0,0,0,5000,0,5000,5000
048011,滬深2X國票93購02,0,0,0,0,0,0,0,0,0,5000,0,0,0,5000,0,5000,5000
045683,泰鼎元大93購03  ,0,0,0,0,0,0,0,0,0,5000,0,0,0,5000,0,5000,5000
043730,旭富國泰93購01  ,0,0,0,0,0,0,0,0,0,5000,0,0,0,5000,0,5000,5000
044085,群創國票91購01  ,0,0,0,0,0,0,0,0,0,5000,0,0,0,5000,0,5000,5000
043954,京元電統一91購02,0,0,0,0,0,0,0,0,0,5000,0,0,0,12000,7000,5000,5000
04399P,樺漢群益94售01  ,0,0,0,0,0,0,0,0,0,5000,0,0,0,64000,59000,5000,5000
04547P,高鐵元大94售01  ,0,0,0,0,0,0,0,0,0,5000,0,0,0,112000,107000,5000,5000
045529,大立光永豐92購03,0,0,0,0,0,0,0,0,0,5000,0,0,0,10000,5000,5000,5000
045585,欣興元大93購03  ,0,0,0,0,0,0,0,0,0,5000,0,0,0,10000,5000,5000,5000
045559,奇鋐國票92購01  ,0,0,0,0,0,0,0,0,0,5000,0,0,0,15000,10000,5000,5000
044838,同欣電元大91購01,0,0,0,0,0,0,0,0,0,5000,0,0,0,5000,0,5000,5000
044738,緯穎國泰93購02  ,0,0,0,0,0,0,0,0,0,5000,0,0,0,5000,0,5000,5000
04475P,欣興元大94售03  ,0,0,0,0,0,0,0,0,0,5000,0,0,0,5000,0,5000,5000
044824,元油2X永豐93購02,0,0,0,0,0,0,0,0,0,5000,0,0,0,5000,0,5000,5000
045134,嘉晶國票92購01  ,0,0,0,0,0,0,0,0,0,5000,0,0,0,5000,0,5000,5000
045141,創意兆豐92購02  ,0,0,0,0,0,0,0,0,0,5000,0,0,0,5000,0,5000,5000
045817,滬深2X凱基95購02,0,0,0,0,0,0,0,0,0,5000,0,0,0,103000,98000,5000,5000
044994,宏達電國泰93購01,0,0,0,0,0,0,0,0,0,5000,0,0,0,10000,5000,5000,5000
048565,康控元大94購04  ,0,0,0,0,0,0,0,0,0,5000,0,0,0,16000,11000,5000,5000
048573,世紀鋼元大93購05,0,0,0,0,0,0,0,0,0,5000,0,0,0,5000,0,5000,5000
047953,台積電永豐93購04,0,0,0,0,0,0,0,0,0,5000,0,0,0,15000,10000,5000,5000
046683,宏達電群益93購02,0,0,0,0,0,0,0,0,0,5000,0,0,0,20000,15000,5000,5000
046648,和鑫國泰94購01  ,0,0,0,0,0,0,0,0,0,5000,0,0,0,5000,0,5000,5000
047803,卜蜂凱基93購03  ,0,0,0,0,0,0,0,0,0,5000,0,0,0,5000,0,5000,5000
047805,台積電凱基93購21,0,0,0,0,0,0,0,0,0,5000,0,0,0,6000,1000,5000,5000
048646,上緯控元大93購01,0,0,0,0,0,0,0,0,0,5000,0,0,0,5000,0,5000,5000
046385,群創凱基98購03  ,0,0,0,0,0,0,0,0,0,5000,0,0,0,10000,5000,5000,5000
047872,貿聯永豐93購02  ,0,0,0,0,0,0,0,0,0,5000,0,0,0,10000,5000,5000,5000
046454,微星凱基92購04  ,0,0,0,0,0,0,0,0,0,5000,0,0,0,5000,0,5000,5000
046418,智原元大92購02  ,0,0,0,0,0,0,0,0,0,5000,0,0,0,5000,0,5000,5000
046971,致伸群益93購03  ,0,0,0,0,0,0,0,0,0,5000,0,0,0,5000,0,5000,5000
046146,南亞科第一92購01,0,0,0,0,0,0,0,0,0,5000,0,0,0,5000,0,5000,5000
046124,健策元大92購04  ,0,0,0,0,0,0,0,0,0,5000,0,0,0,5000,0,5000,5000
04605P,台積電兆豐94售03,0,0,0,0,0,0,0,0,0,5000,0,0,0,5000,0,5000,5000
046034,可成元大92購09  ,0,0,0,0,0,0,0,0,0,5000,0,0,0,30000,25000,5000,5000
04596P,臺股指元大94售14,0,0,0,0,0,0,0,0,0,5000,0,0,0,5000,0,5000,5000
045920,臺股指國票92購10,0,0,0,0,0,0,0,0,0,5000,0,0,0,5000,0,5000,5000
045904,勤誠元大92購01  ,0,0,0,0,0,0,0,0,0,5000,0,0,0,5000,0,5000,5000
046813,聯電凱基96購01  ,0,0,0,0,0,0,0,0,0,5000,0,0,0,17000,12000,5000,5000
046736,儒鴻群益93購01  ,0,0,0,0,0,0,0,0,0,5000,0,0,0,81000,76000,5000,5000
048006,瑞儀元大93購03  ,0,0,0,0,0,0,0,0,0,5000,0,0,0,5000,0,5000,5000
049126,玉晶光元富94購02,0,0,0,0,0,0,0,0,0,5000,0,0,0,5000,0,5000,5000
049133,為升元大94購02  ,0,0,0,0,0,0,0,0,0,5000,0,0,0,10000,5000,5000,5000
04904P,奇力新永豐94售05,0,0,0,0,0,0,0,0,0,5000,0,0,0,105000,100000,5000,5000
049346,新光金統一95購01,0,0,0,0,0,0,0,0,0,5000,0,0,0,10000,5000,5000,5000
04766P,緯穎永豐94售02  ,0,0,0,0,0,0,0,0,0,5000,0,0,0,5000,0,5000,5000
047329,聯茂元大93購04  ,0,0,0,0,0,0,0,0,0,5000,0,0,0,35000,30000,5000,5000
049947,S&P反1中信97購01,0,0,0,0,0,0,0,0,0,5000,0,0,0,5000,0,5000,5000
047275,宏達電永豐93購01,0,0,0,0,0,0,0,0,0,5000,0,0,0,5000,0,5000,5000
048162,矽力麥證93購01  ,0,0,0,10000,5000,5000,0,0,0,5000,0,0,0,10000,5000,5000,5000
047544,台積電凱基93購17,0,0,0,0,0,0,0,0,0,5000,0,0,0,8000,3000,5000,5000
04750P,臺股指元大94售26,0,0,0,0,0,0,0,0,0,5000,0,0,0,5000,0,5000,5000
047514,亞光國票94購01  ,0,0,0,0,0,0,0,0,0,5000,0,0,0,315000,310000,5000,5000
047194,世紀鋼元大96購01,0,0,0,0,0,0,0,0,0,5000,0,0,0,5000,0,5000,5000
047164,亞光台新93購01  ,0,0,0,0,0,0,0,0,0,5000,0,0,0,5000,0,5000,5000
048120,台泥元大93購02  ,0,0,0,0,0,0,0,0,0,5000,0,0,0,5000,0,5000,5000
04707P,喬山元大94售01  ,0,0,0,0,0,0,0,0,0,5000,0,0,0,5000,0,5000,5000
050756,京元電元富94購03,0,0,0,0,0,0,0,0,0,5000,0,0,0,108000,103000,5000,5000
050736,台積電康和94購01,0,0,0,0,0,0,0,0,0,5000,0,0,0,10000,5000,5000,5000
050737,聯詠康和94購01  ,0,0,0,0,0,0,0,0,0,5000,0,0,0,131000,126000,5000,5000
050585,矽格國票94購01  ,0,0,0,0,0,0,0,0,0,5000,0,0,0,5000,0,5000,5000
050665,南電台新94購01  ,0,0,0,0,0,0,0,0,0,5000,0,0,0,25000,20000,5000,5000
050661,景碩元大94購02  ,0,0,0,0,0,0,0,0,0,5000,0,0,0,11000,6000,5000,5000
050258,為升元大94購08  ,0,0,0,0,0,0,0,0,0,5000,0,0,0,20000,15000,5000,5000
050374,上緯控元大95購01,0,0,0,0,0,0,0,0,0,5000,0,0,0,25000,20000,5000,5000
050413,麗豐永豐94購01  ,0,0,0,0,0,0,0,0,0,5000,0,0,0,5000,0,5000,5000
049444,元石油統一94購03,0,0,0,0,0,0,0,0,0,5000,0,0,0,5000,0,5000,5000
049796,國巨元大94購10  ,0,0,0,0,0,0,0,0,0,5000,0,0,0,5000,0,5000,5000
050194,臻鼎元大94購03  ,0,0,0,0,0,0,0,0,0,5000,0,0,0,5000,0,5000,5000
05093P,可成元大95售03  ,0,0,0,0,0,0,0,0,0,5000,0,0,0,36000,31000,5000,5000
050965,揚明光永豐96購01,0,0,0,0,0,0,0,0,0,5000,0,0,0,34000,29000,5000,5000
051218,聯發科元富9B購02,0,0,0,0,0,0,0,0,0,5000,0,0,0,15000,10000,5000,5000
051201,台積電麥證95購02,0,0,0,30000,25000,5000,0,0,0,5000,0,0,0,30000,25000,5000,5000
051198,鴻海麥證95購02  ,0,0,0,20000,15000,5000,0,0,0,5000,0,0,0,20000,15000,5000,5000
051314,嘉聯益麥證96購01,0,0,0,10000,5000,5000,0,0,0,5000,0,0,0,10000,5000,5000,5000
051256,中磊元大95購01  ,0,0,0,0,0,0,0,0,0,5000,0,0,0,5000,0,5000,5000
05140P,台表科國票96售01,0,0,0,0,0,0,0,0,0,5000,0,0,0,85000,80000,5000,5000
051500,聯茂群益95購01  ,0,0,0,0,0,0,0,0,0,5000,0,0,0,10000,5000,5000,5000
051498,智易群益96購01  ,0,0,0,0,0,0,0,0,0,5000,0,0,0,103000,98000,5000,5000
051766,泰鼎元大95購02  ,0,0,0,0,0,0,0,0,0,5000,0,0,0,68000,63000,5000,5000
051734,台積電國票95購04,0,0,0,0,0,0,0,0,0,5000,0,0,0,5000,0,5000,5000
051737,瑞昱國票96購01  ,0,0,0,0,0,0,0,0,0,5000,0,0,0,5000,0,5000,5000
05157P,全新台新96售01  ,0,0,0,0,0,0,0,0,0,5000,0,0,0,8000,3000,5000,5000
051572,上銀元大95購01  ,0,0,0,0,0,0,0,0,0,5000,0,0,0,7000,2000,5000,5000
05205P,緯穎元大95售03  ,0,0,0,0,0,0,0,0,0,5000,0,0,0,11000,6000,5000,5000
052047,建準凱基96購01  ,0,0,0,0,0,0,0,0,0,5000,0,0,0,14000,9000,5000,5000
051982,深中小元大95購01,0,0,0,0,0,0,0,0,0,5000,0,0,0,5000,0,5000,5000
052013,台積電永豐95購04,0,0,0,0,0,0,0,0,0,5000,0,0,0,1239000,1234000,5000,5000
051974,華新科凱基96購05,0,0,0,0,0,0,0,0,0,5000,0,0,0,7000,2000,5000,5000
6605,帝寶            ,11000,6000,5000,0,0,0,0,0,0,0,0,0,0,0,0,0,5000
9931,欣高            ,6000,1000,5000,0,0,0,0,0,0,0,0,0,0,0,0,0,5000
9926,新海            ,5000,0,5000,0,0,0,0,0,0,0,0,0,0,0,0,0,5000
9902,台火            ,19000,14000,5000,0,0,0,0,0,0,0,0,0,0,0,0,0,5000
05999P,世芯元大96售01  ,0,0,0,0,0,0,0,0,0,5000,0,0,0,55000,50000,5000,5000
05659P,A50正2中信97售01,0,0,0,0,0,0,0,0,0,5000,0,0,0,5000,0,5000,5000
05626P,景碩國票97售03  ,0,0,0,0,0,0,0,0,0,5000,0,0,0,8000,3000,5000,5000
05856P,A50正2中信99售01,0,0,0,0,0,0,0,0,0,5000,0,0,0,5000,0,5000,5000
2397,友通            ,7000,2000,5000,0,0,0,0,0,0,0,0,0,0,0,0,0,5000
3054,立萬利          ,5000,0,5000,0,0,0,0,0,0,0,0,0,0,0,0,0,5000
4141,龍燈-KY         ,10000,5000,5000,0,0,0,0,0,0,0,0,0,0,0,0,0,5000
3694,海華            ,5000,0,5000,0,0,0,0,0,0,0,0,0,0,0,0,0,5000
4571,鈞興-KY         ,5000,0,5000,0,0,0,0,0,0,0,0,0,0,0,0,0,5000
5284,jpp-KY          ,5000,0,5000,0,0,0,0,0,0,0,0,0,0,0,0,0,5000
8926,台汽電          ,36000,31060,4940,0,0,0,0,0,0,0,0,0,0,0,0,0,4940
054651,台化麥證97購01  ,0,0,0,24000,20000,4000,0,0,0,4000,0,0,0,24000,20000,4000,4000
05448P,臺股指元大95售25,0,0,0,0,0,0,0,0,0,4000,0,0,0,9000,5000,4000,4000
054265,GIS元大96購03   ,0,0,0,0,0,0,0,0,0,4000,0,0,0,4000,0,4000,4000
054164,強茂凱基98購01  ,0,0,0,0,0,0,0,0,0,4000,0,0,0,4000,0,4000,4000
054172,易華電凱基98購01,0,0,0,0,0,0,0,0,0,4000,0,0,0,7000,3000,4000,4000
05284P,鴻海兆豐95售04  ,0,0,0,0,0,0,0,0,0,4000,0,0,0,4000,0,4000,4000
052262,華新亞東95購02  ,0,0,0,0,0,0,0,0,0,4000,0,0,0,4000,0,4000,4000
053487,台泥兆豐97購01  ,0,0,0,0,0,0,0,0,0,4000,0,0,0,4000,0,4000,4000
053538,京鼎永豐96購03  ,0,0,0,0,0,0,0,0,0,4000,0,0,0,33000,29000,4000,4000
053384,聯發科元大96購13,0,0,0,0,0,0,0,0,0,4000,0,0,0,357000,353000,4000,4000
053056,同欣電國票97購01,0,0,0,0,0,0,0,0,0,4000,0,0,0,4000,0,4000,4000
045031,上銀群益93購02  ,0,0,0,0,0,0,0,0,0,4000,0,0,0,24000,20000,4000,4000
045819,台積電凱基92購14,0,0,0,0,0,0,0,0,0,4000,0,0,0,55000,51000,4000,4000
045822,TPK凱基93購03   ,0,0,0,0,0,0,0,0,0,4000,0,0,0,41000,37000,4000,4000
04510P,臺股指元大94售05,0,0,0,0,0,0,0,0,0,4000,0,0,0,4000,0,4000,4000
044832,台表科永豐91購03,0,0,0,0,0,0,0,0,0,4000,0,0,0,14000,10000,4000,4000
044039,康控群益93購01  ,0,0,0,0,0,0,0,0,0,4000,0,0,0,24000,20000,4000,4000
044203,國泰金亞東92購01,0,0,0,0,0,0,0,0,0,4000,0,0,0,4000,0,4000,4000
04565P,聯詠凱基94售01  ,0,0,0,0,0,0,0,0,0,4000,0,0,0,4000,0,4000,4000
043842,寶滬深元富91購01,0,0,0,0,0,0,0,0,0,4000,0,0,0,4000,0,4000,4000
047765,瑞昱元大93購12  ,0,0,0,0,0,0,0,0,0,4000,0,0,0,7000,3000,4000,4000
047739,致伸永豐93購01  ,0,0,0,0,0,0,0,0,0,4000,0,0,0,4000,0,4000,4000
046264,美律凱基93購05  ,0,0,0,0,0,0,0,0,0,4000,0,0,0,45000,41000,4000,4000
046278,緯創台新92購01  ,0,0,0,0,0,0,0,0,0,4000,0,0,0,4000,0,4000,4000
048342,強茂元大93購01  ,0,0,0,0,0,0,0,0,0,4000,0,0,0,9000,5000,4000,4000
04833P,鴻海元大94售16  ,0,0,0,0,0,0,0,0,0,4000,0,0,0,12000,8000,4000,4000
048249,嘉澤兆豐94購01  ,0,0,0,0,0,0,0,0,0,4000,0,0,0,4000,0,4000,4000
048330,大立光永昌93購07,0,0,0,0,0,0,0,0,0,4000,0,0,0,7000,3000,4000,4000
00689R,國泰20年美債反1 ,0,0,0,0,0,0,0,0,0,4000,0,0,0,104000,100000,4000,4000
03334P,宏達電元大02售04,0,0,0,0,0,0,0,0,0,4000,0,0,0,4000,0,4000,4000
03290P,亞德客元大02售01,0,0,0,0,0,0,0,0,0,4000,0,0,0,14000,10000,4000,4000
03185P,台積電元大01售49,0,0,0,0,0,0,0,0,0,4000,0,0,0,4000,0,4000,4000
03027X,元展24          ,0,0,0,0,0,0,0,0,0,4000,0,0,0,4000,0,4000,4000
04181P,嘉晶國票93售04  ,0,0,0,0,0,0,0,0,0,4000,0,0,0,4000,0,4000,4000
041857,宏達電元大92購01,0,0,0,0,0,0,0,0,0,4000,0,0,0,4000,0,4000,4000
04194P,欣興永豐93售05  ,0,0,0,0,0,0,0,0,0,4000,0,0,0,23000,19000,4000,4000
04275P,南亞科凱基93售08,0,0,0,0,0,0,0,0,0,4000,0,0,0,4000,0,4000,4000
04353P,全新永豐94售01  ,0,0,0,0,0,0,0,0,0,4000,0,0,0,14000,10000,4000,4000
047090,緯創元富93購01  ,0,0,0,0,0,0,0,0,0,4000,0,0,0,24000,20000,4000,4000
048736,台達電統一94購01,0,0,0,0,0,0,0,0,0,4000,0,0,0,162000,158000,4000,4000
047157,智伸科國票93購01,0,0,0,0,0,0,0,0,0,4000,0,0,0,4000,0,4000,4000
047449,南茂元大93購04  ,0,0,0,0,0,0,0,0,0,4000,0,0,0,104000,100000,4000,4000
049230,台達電富邦96購01,0,0,0,0,0,0,0,0,0,4000,0,0,0,4000,0,4000,4000
049228,台塑富邦94購01  ,0,0,0,0,0,0,0,0,0,4000,0,0,0,14000,10000,4000,4000
046810,瑞昱第一93購01  ,0,0,0,0,0,0,0,0,0,4000,0,0,0,4000,0,4000,4000
04612P,上銀群益94售01  ,0,0,0,0,0,0,0,0,0,4000,0,0,0,40000,36000,4000,4000
048026,瑞昱凱基94購01  ,0,0,0,0,0,0,0,0,0,4000,0,0,0,4000,0,4000,4000
047415,欣興永昌93購01  ,0,0,0,0,0,0,0,0,0,4000,0,0,0,4000,0,4000,4000
046381,緯創凱基93購03  ,0,0,0,0,0,0,0,0,0,4000,0,0,0,4000,0,4000,4000
047804,鴻海凱基93購26  ,0,0,0,0,0,0,0,0,0,4000,0,0,0,29000,25000,4000,4000
047819,南茂凱基93購04  ,0,0,0,0,0,0,0,0,0,4000,0,0,0,4000,0,4000,4000
04838P,宏達電元大95售02,0,0,0,0,0,0,0,0,0,4000,0,0,0,4000,0,4000,4000
046504,聯發科元大92購19,0,0,0,0,0,0,0,0,0,4000,0,0,0,4000,0,4000,4000
046508,冠德元大92購04  ,0,0,0,0,0,0,0,0,0,4000,0,0,0,4000,0,4000,4000
052055,緯穎凱基95購03  ,0,0,0,0,0,0,0,0,0,4000,0,0,0,18000,14000,4000,4000
051643,瑞昱康和95購01  ,0,0,0,0,0,0,0,0,0,4000,0,0,0,4000,0,4000,4000
051516,全新凱基96購02  ,0,0,0,0,0,0,0,0,0,4000,0,0,0,10000,6000,4000,4000
051557,昇陽半永豐96購01,0,0,0,0,0,0,0,0,0,4000,0,0,0,4000,0,4000,4000
051427,聯發科統一95購04,0,0,0,0,0,0,0,0,0,4000,0,0,0,5000,1000,4000,4000
051397,聯茂兆豐95購03  ,0,0,0,0,0,0,0,0,0,4000,0,0,0,60000,56000,4000,4000
050934,喬山國票96購01  ,0,0,0,0,0,0,0,0,0,4000,0,0,0,4000,0,4000,4000
049811,聯鈞元大94購01  ,0,0,0,0,0,0,0,0,0,4000,0,0,0,58000,54000,4000,4000
049977,瑞昱凱基94購03  ,0,0,0,0,0,0,0,0,0,4000,0,0,0,4000,0,4000,4000
049544,台積電群益94購08,0,0,0,0,0,0,0,0,0,4000,0,0,0,4000,0,4000,4000
049656,臺股指凱基94購17,0,0,0,0,0,0,0,0,0,4000,0,0,0,4000,0,4000,4000
049618,美律群益94購03  ,0,0,0,0,0,0,0,0,0,4000,0,0,0,9000,5000,4000,4000
050523,義隆元大94購05  ,0,0,0,0,0,0,0,0,0,4000,0,0,0,10000,6000,4000,4000
050529,矽格元大94購05  ,0,0,0,0,0,0,0,0,0,4000,0,0,0,4000,0,4000,4000
050722,聯電國票96購01  ,0,0,0,0,0,0,0,0,0,4000,0,0,0,4000,0,4000,4000
050802,康控群益95購01  ,0,0,0,0,0,0,0,0,0,4000,0,0,0,5000,1000,4000,4000
050884,聯茂國泰96購01  ,0,0,0,0,0,0,0,0,0,4000,0,0,0,223000,219000,4000,4000
6582,申豐            ,4000,0,4000,0,0,0,0,0,0,0,0,0,0,0,0,0,4000
6573,虹揚-KY         ,7000,2000,5000,0,0,0,0,0,0,-1000,0,1000,-1000,0,0,0,4000
8249,菱光            ,8000,4000,4000,0,0,0,0,0,0,0,0,0,0,0,0,0,4000
3607,谷崧            ,4000,0,4000,0,0,0,0,0,0,0,0,0,0,0,0,0,4000
3617,碩天            ,25000,21000,4000,0,0,0,0,0,0,0,0,0,0,0,0,0,4000
3257,虹冠電          ,12000,8000,4000,0,0,0,0,0,0,0,0,0,0,0,0,0,4000
3025,星通            ,7000,3000,4000,0,0,0,0,0,0,0,0,0,0,0,0,0,4000
2722,夏都            ,4000,0,4000,0,0,0,0,0,0,0,0,0,0,0,0,0,4000
2705,六福            ,9000,5000,4000,0,0,0,0,0,0,0,0,0,0,0,0,0,4000
05827P,台積電統一96售10,0,0,0,0,0,0,0,0,0,4000,0,0,0,43000,39000,4000,4000
05913P,國巨元大96售11  ,0,0,0,0,0,0,0,0,0,4000,0,0,0,35000,31000,4000,4000
05732P,臺股指統一96售02,0,0,0,0,0,0,0,0,0,4000,0,0,0,4000,0,4000,4000
06023P,超眾國票96售03  ,0,0,0,0,0,0,0,0,0,4000,0,0,0,4000,0,4000,4000
08859P,奇鋐國票03售01  ,0,0,0,0,0,0,0,0,0,4000,0,0,0,4000,0,4000,4000
08897P,國巨群益01售10  ,0,0,0,0,0,0,0,0,0,4000,0,0,0,34000,30000,4000,4000
1341,富林-KY         ,4000,0,4000,0,0,0,0,0,0,0,0,0,0,0,0,0,4000
01003T,兆豐新光R1      ,4834,1000,3834,0,0,0,0,0,0,0,0,0,0,0,0,0,3834
6214,精誠            ,49000,50196,-1196,0,0,0,0,0,0,5000,5000,0,5000,0,0,0,3804
3022,威強電          ,32000,28440,3560,0,0,0,0,0,0,0,0,0,0,0,0,0,3560
052936,華通兆豐98購01  ,0,0,0,0,0,0,0,0,0,3000,0,0,0,18000,15000,3000,3000
053312,緯穎凱基96購02  ,0,0,0,0,0,0,0,0,0,3000,0,0,0,42000,39000,3000,3000
053273,國巨元大96購08  ,0,0,0,0,0,0,0,0,0,3000,0,0,0,115000,112000,3000,3000
053499,禾伸堂兆豐96購01,0,0,0,0,0,0,0,0,0,3000,0,0,0,3000,0,3000,3000
052250,光磊永豐95購01  ,0,0,0,0,0,0,0,0,0,3000,0,0,0,76000,73000,3000,3000
052549,喬山國票97購01  ,0,0,0,0,0,0,0,0,0,3000,0,0,0,3000,0,3000,3000
052570,華新科凱基96購06,0,0,0,0,0,0,0,0,0,3000,0,0,0,3000,0,3000,3000
052895,台積電群益96購04,0,0,0,0,0,0,0,0,0,3000,0,0,0,3000,0,3000,3000
05289P,鴻海永豐95售05  ,0,0,0,0,0,0,0,0,0,3000,0,0,0,3000,0,3000,3000
052685,技嘉元大96購01  ,0,0,0,0,0,0,0,0,0,3000,0,0,0,9000,6000,3000,3000
052696,玉晶光麥證97購01,0,0,0,3000,0,3000,0,0,0,3000,0,0,0,3000,0,3000,3000
052619,茂林國泰99購01  ,0,0,0,0,0,0,0,0,0,3000,0,0,0,43000,40000,3000,3000
053990,晶技兆豐96購01  ,0,0,0,0,0,0,0,0,0,3000,0,0,0,3000,0,3000,3000
05392P,鴻海統一95售13  ,0,0,0,0,0,0,0,0,0,3000,0,0,0,3000,0,3000,3000
053667,鴻海統一96購12  ,0,0,0,0,0,0,0,0,0,3000,0,0,0,3000,0,3000,3000
053595,創意元大96購02  ,0,0,0,0,0,0,0,0,0,3000,0,0,0,21000,18000,3000,3000
053844,GIS統一96購01   ,0,0,0,0,0,0,0,0,0,3000,0,0,0,59000,56000,3000,3000
054262,瀚宇博元大96購03,0,0,0,0,0,0,0,0,0,3000,0,0,0,86000,83000,3000,3000
054212,聯詠國票97購03  ,0,0,0,0,0,0,0,0,0,3000,0,0,0,38000,35000,3000,3000
054412,智邦元大96購03  ,0,0,0,0,0,0,0,0,0,3000,0,0,0,42000,39000,3000,3000
00668,國泰美國道瓊    ,0,0,0,0,0,0,0,0,0,3000,0,0,0,7000,4000,3000,3000
03637C,臺股指凱基94牛18,0,0,0,0,0,0,0,0,0,3000,0,0,0,43000,40000,3000,3000
03560P,台積電兆豐03售10,0,0,0,0,0,0,0,0,0,3000,0,0,0,3000,0,3000,3000
03775P,臺股指元大93售25,0,0,0,0,0,0,0,0,0,3000,0,0,0,3000,0,3000,3000
03364P,金像電元大02售05,0,0,0,0,0,0,0,0,0,3000,0,0,0,125000,122000,3000,3000
03959P,義隆元富96售01  ,0,0,0,0,0,0,0,0,0,3000,0,0,0,3000,0,3000,3000
044687,南寶凱基93購01  ,0,0,0,0,0,0,0,0,0,3000,0,0,0,3000,0,3000,3000
042895,鴻海永昌93購03  ,0,0,0,0,0,0,0,0,0,3000,0,0,0,3000,0,3000,3000
048234,美利達凱基93購03,0,0,0,0,0,0,0,0,0,3000,0,0,0,3000,0,3000,3000
046320,明泰元大92購02  ,0,0,0,0,0,0,0,0,0,3000,0,0,0,3000,0,3000,3000
046337,智原第一92購01  ,0,0,0,0,0,0,0,0,0,3000,0,0,0,3000,0,3000,3000
047776,志超元大93購01  ,0,0,0,0,0,0,0,0,0,3000,0,0,0,3000,0,3000,3000
047761,亞德客元大93購02,0,0,0,0,0,0,0,0,0,3000,0,0,0,3000,0,3000,3000
045685,康控元大95購01  ,0,0,0,0,0,0,0,0,0,3000,0,0,0,5000,2000,3000,3000
045682,致伸元大92購01  ,0,0,0,0,0,0,0,0,0,3000,0,0,0,3000,0,3000,3000
043924,世紀鋼凱基93購01,0,0,0,0,0,0,0,0,0,3000,0,0,0,3000,0,3000,3000
045586,創意元大93購03  ,0,0,0,0,0,0,0,0,0,3000,0,0,0,3000,0,3000,3000
045298,旺宏元大94購01  ,0,0,0,0,0,0,0,0,0,3000,0,0,0,5000,2000,3000,3000
044909,玉晶光凱基93購02,0,0,0,0,0,0,0,0,0,3000,0,0,0,3000,0,3000,3000
045138,技嘉兆豐92購01  ,0,0,0,0,0,0,0,0,0,3000,0,0,0,3000,0,3000,3000
045130,瑞昱統一92購01  ,0,0,0,0,0,0,0,0,0,3000,0,0,0,13000,10000,3000,3000
045045,南亞科凱基92購01,0,0,0,0,0,0,0,0,0,3000,0,0,0,13000,10000,3000,3000
047936,美利達凱基93購02,0,0,0,0,0,0,0,0,0,3000,0,0,0,3000,0,3000,3000
048577,GIS國泰94購01   ,0,0,0,0,0,0,0,0,0,3000,0,0,0,16000,13000,3000,3000
048571,美利達元大96購03,0,0,0,0,0,0,0,0,0,3000,0,0,0,3000,0,3000,3000
048572,美利達元大96購04,0,0,0,0,0,0,0,0,0,3000,0,0,0,28000,25000,3000,3000
046651,TPK富邦94購02   ,0,0,0,0,0,0,0,0,0,3000,0,0,0,3000,0,3000,3000
046630,京元電元富95購03,0,0,0,0,0,0,0,0,0,3000,0,0,0,5000,2000,3000,3000
046564,聯詠凱基92購09  ,0,0,0,0,0,0,0,0,0,3000,0,0,0,20000,17000,3000,3000
046688,超眾國票93購03  ,0,0,0,0,0,0,0,0,0,3000,0,0,0,48000,45000,3000,3000
046734,華通國票93購02  ,0,0,0,0,0,0,0,0,0,3000,0,0,0,33000,30000,3000,3000
04781P,欣興凱基94售06  ,0,0,0,0,0,0,0,0,0,3000,0,0,0,33000,30000,3000,3000
046366,上緯控永豐92購02,0,0,0,0,0,0,0,0,0,3000,0,0,0,3000,0,3000,3000
048645,創意元大94購02  ,0,0,0,0,0,0,0,0,0,3000,0,0,0,5000,2000,3000,3000
048533,景碩國票94購01  ,0,0,0,0,0,0,0,0,0,3000,0,0,0,23000,20000,3000,3000
046928,奇鋐富邦97購01  ,0,0,0,0,0,0,0,0,0,3000,0,0,0,217000,214000,3000,3000
046976,國巨永豐93購02  ,0,0,0,0,0,0,0,0,0,3000,0,0,0,3000,0,3000,3000
045905,志超元大92購01  ,0,0,0,0,0,0,0,0,0,3000,0,0,0,3000,0,3000,3000
046026,友訊元大92購01  ,0,0,0,0,0,0,0,0,0,3000,0,0,0,13000,10000,3000,3000
049199,茂林永豐95購01  ,0,0,0,0,0,0,0,0,0,3000,0,0,0,3000,0,3000,3000
049044,和碩兆豐94購01  ,0,0,0,0,0,0,0,0,0,3000,0,0,0,5000,2000,3000,3000
049000,元油2X中信95購02,0,0,0,0,0,0,0,0,0,3000,0,0,0,5000,2000,3000,3000
04911P,美律元富94售02  ,0,0,0,0,0,0,0,0,0,3000,0,0,0,10000,7000,3000,3000
049181,正文凱基94購03  ,0,0,0,0,0,0,0,0,0,3000,0,0,0,3000,0,3000,3000
047704,智邦凱基93購06  ,0,0,0,0,0,0,0,0,0,3000,0,0,0,3000,0,3000,3000
047695,聯發科國票93購06,0,0,0,0,0,0,0,0,0,3000,0,0,0,3000,0,3000,3000
047616,鴻海凱基94購10  ,0,0,0,0,0,0,0,0,0,3000,0,0,0,23000,20000,3000,3000
048158,大立光兆豐95購01,0,0,0,0,0,0,0,0,0,3000,0,0,0,3000,0,3000,3000
048096,大立光凱基93購33,0,0,0,0,0,0,0,0,0,3000,0,0,0,3000,0,3000,3000
048130,美利達元大96購01,0,0,0,0,0,0,0,0,0,3000,0,0,0,3000,0,3000,3000
048688,瑞昱群益94購01  ,0,0,0,0,0,0,0,0,0,3000,0,0,0,14000,11000,3000,3000
048869,光罩國票94購01  ,0,0,0,0,0,0,0,0,0,3000,0,0,0,8000,5000,3000,3000
048858,大立光群益94購03,0,0,0,0,0,0,0,0,0,3000,0,0,0,10000,7000,3000,3000
048681,漢唐富邦96購01  ,0,0,0,0,0,0,0,0,0,3000,0,0,0,3000,0,3000,3000
048651,美利達元大96購05,0,0,0,0,0,0,0,0,0,3000,0,0,0,3000,0,3000,3000
050790,昇陽半國泰96購02,0,0,0,0,0,0,0,0,0,3000,0,0,0,40000,37000,3000,3000
050556,道瓊銀統一95購01,0,0,0,0,0,0,0,0,0,3000,0,0,0,5000,2000,3000,3000
050557,台積電統一94購13,0,0,0,0,0,0,0,0,0,3000,0,0,0,3000,0,3000,3000
050621,易華電元大95購01,0,0,0,0,0,0,0,0,0,3000,0,0,0,3000,0,3000,3000
04967P,台表科永豐94售04,0,0,0,0,0,0,0,0,0,3000,0,0,0,3000,0,3000,3000
049568,台積電統一94購08,0,0,0,0,0,0,0,0,0,3000,0,0,0,3000,0,3000,3000
04997P,燿華台新95售02  ,0,0,0,0,0,0,0,0,0,3000,0,0,0,33000,30000,3000,3000
049990,志超凱基94購03  ,0,0,0,0,0,0,0,0,0,3000,0,0,0,3000,0,3000,3000
049870,南電兆豐94購01  ,0,0,0,0,0,0,0,0,0,3000,0,0,0,3000,0,3000,3000
050200,致新元大94購01  ,0,0,0,0,0,0,0,0,0,3000,0,0,0,3000,0,3000,3000
050171,臺指反元大97購03,0,0,0,0,0,0,0,0,0,3000,0,0,0,3000,0,3000,3000
050127,台積電凱基94購31,0,0,0,0,0,0,0,0,0,3000,0,0,0,3000,0,3000,3000
051045,南茂永豐95購01  ,0,0,0,0,0,0,0,0,0,3000,0,0,0,68000,65000,3000,3000
051204,正崴麥證95購01  ,0,0,0,3000,0,3000,0,0,0,3000,0,0,0,3000,0,3000,3000
05133P,臺股指日盛95售01,0,0,0,0,0,0,0,0,0,3000,0,0,0,3000,0,3000,3000
051545,裕隆康和95購01  ,0,0,0,0,0,0,0,0,0,3000,0,0,0,10000,7000,3000,3000
051536,玉晶光國票97購01,0,0,0,0,0,0,0,0,0,3000,0,0,0,7000,4000,3000,3000
051625,聯發科麥證95購01,0,0,0,10000,7000,3000,0,0,0,3000,0,0,0,10000,7000,3000,3000
051699,世紀鋼麥證95購01,0,0,0,3000,0,3000,0,0,0,3000,0,0,0,3000,0,3000,3000
051989,華固元大95購02  ,0,0,0,0,0,0,0,0,0,3000,0,0,0,3000,0,3000,3000
051950,旺宏元富95購02  ,0,0,0,0,0,0,0,0,0,3000,0,0,0,3000,0,3000,3000
3321,同泰            ,102000,79000,23000,0,0,0,0,0,0,-20000,0,20000,-20000,0,0,0,3000
2816,旺旺保          ,33000,30000,3000,0,0,0,0,0,0,0,0,0,0,0,0,0,3000
3679,新至陞          ,16000,12000,4000,0,0,0,0,0,0,-1000,0,1000,-1000,0,0,0,3000
3705,永信            ,14000,21000,-7000,0,0,0,0,0,0,10000,10000,0,10000,0,0,0,3000
5007,三星            ,13000,12000,1000,0,0,0,0,0,0,2000,2000,0,2000,0,0,0,3000
4562,穎漢            ,3000,0,3000,0,0,0,0,0,0,0,0,0,0,0,0,0,3000
4912,聯德控股-KY     ,3000,0,3000,0,0,0,0,0,0,0,0,0,0,0,0,0,3000
2506,太設            ,3000,0,3000,0,0,0,0,0,0,0,0,0,0,0,0,0,3000
2433,互盛電          ,9000,6000,3000,0,0,0,0,0,0,0,0,0,0,0,0,0,3000
2038,海光            ,9000,6000,3000,0,0,0,0,0,0,0,0,0,0,0,0,0,3000
2062,橋椿            ,20000,17000,3000,0,0,0,0,0,0,0,0,0,0,0,0,0,3000
2115,六暉-KY         ,4000,1000,3000,0,0,0,0,0,0,0,0,0,0,0,0,0,3000
2028,威致            ,3000,0,3000,0,0,0,0,0,0,0,0,0,0,0,0,0,3000
1312A,國喬特          ,0,0,0,0,0,0,0,0,0,3000,3000,0,3000,0,0,0,3000
1225,福懋油          ,10000,7000,3000,0,0,0,0,0,0,0,0,0,0,0,0,0,3000
1235,興泰            ,3000,0,3000,0,0,0,0,0,0,0,0,0,0,0,0,0,3000
1236,宏亞            ,3000,0,3000,0,0,0,0,0,0,0,0,0,0,0,0,0,3000
1108,幸福            ,3000,0,3000,0,0,0,0,0,0,0,0,0,0,0,0,0,3000
1464,得力            ,76000,72000,4000,0,0,0,0,0,0,-1000,0,0,0,0,1000,-1000,3000
1525,江申            ,3000,0,3000,0,0,0,0,0,0,0,0,0,0,0,0,0,3000
06078P,臺股指凱基9A售01,0,0,0,0,0,0,0,0,0,3000,0,0,0,3000,0,3000,3000
05788P,臺股指永昌96售05,0,0,0,0,0,0,0,0,0,3000,0,0,0,37000,34000,3000,3000
05785P,臺股指元大96售19,0,0,0,0,0,0,0,0,0,3000,0,0,0,3000,0,3000,3000
05876P,聯發科群益96售03,0,0,0,0,0,0,0,0,0,3000,0,0,0,10000,7000,3000,3000
6184,大豐電          ,5000,2000,3000,0,0,0,0,0,0,0,0,0,0,0,0,0,3000
6164,華興            ,3000,0,3000,0,0,0,0,0,0,0,0,0,0,0,0,0,3000
8497,格威傳媒        ,4000,1000,3000,0,0,0,0,0,0,0,0,0,0,0,0,0,3000
1227,佳格            ,221000,218200,2800,0,0,0,0,0,0,0,0,0,0,0,0,0,2800
01007T,兆豐國泰R2      ,2106,0,2106,0,0,0,0,0,0,0,0,0,0,0,0,0,2106
054276,國巨群益96購07  ,0,0,0,0,0,0,0,0,0,2000,0,0,0,152000,150000,2000,2000
05549P,臺股指元大96售03,0,0,0,0,0,0,0,0,0,2000,0,0,0,2000,0,2000,2000
053786,新日興元大96購02,0,0,0,0,0,0,0,0,0,2000,0,0,0,12000,10000,2000,2000
05358P,大立光元大95售09,0,0,0,0,0,0,0,0,0,2000,0,0,0,2000,0,2000,2000
05364P,臺股指富邦95售04,0,0,0,0,0,0,0,0,0,2000,0,0,0,2000,0,2000,2000
053640,上緯控永豐96購01,0,0,0,0,0,0,0,0,0,2000,0,0,0,2000,0,2000,2000
053729,聯茂凱基96購05  ,0,0,0,0,0,0,0,0,0,2000,0,0,0,2000,0,2000,2000
053964,上銀元大96購05  ,0,0,0,0,0,0,0,0,0,2000,0,0,0,5000,3000,2000,2000
054180,亞泥康和96購01  ,0,0,0,0,0,0,0,0,0,2000,0,0,0,2000,0,2000,2000
054111,緯穎凱基97購01  ,0,0,0,0,0,0,0,0,0,2000,0,0,0,2000,0,2000,2000
052601,大成鋼元大96購01,0,0,0,0,0,0,0,0,0,2000,0,0,0,72000,70000,2000,2000
052691,GIS元大96購01   ,0,0,0,0,0,0,0,0,0,2000,0,0,0,2000,0,2000,2000
052814,上証2X永豐96購02,0,0,0,0,0,0,0,0,0,2000,0,0,0,2000,0,2000,2000
05252P,華通凱基95售01  ,0,0,0,0,0,0,0,0,0,2000,0,0,0,5000,3000,2000,2000
052279,旺宏凱基95購07  ,0,0,0,0,0,0,0,0,0,2000,0,0,0,6000,4000,2000,2000
052349,鴻海統一95購15  ,0,0,0,0,0,0,0,0,0,2000,0,0,0,77000,75000,2000,2000
053546,台積電凱基96購13,0,0,0,0,0,0,0,0,0,2000,0,0,0,3000,1000,2000,2000
052934,中磊元大96購01  ,0,0,0,0,0,0,0,0,0,2000,0,0,0,25000,23000,2000,2000
053033,智易兆豐97購01  ,0,0,0,0,0,0,0,0,0,2000,0,0,0,2000,0,2000,2000
035277,景碩台新97購01  ,0,0,0,0,0,0,0,0,0,2000,0,0,0,2000,0,2000,2000
03614P,聯發科元大92售18,0,0,0,0,0,0,0,0,0,2000,0,0,0,2000,0,2000,2000
03640C,元油2X元大9B牛02,0,0,0,0,0,0,0,0,0,2000,0,0,0,3000,1000,2000,2000
03643C,臺股指元富99牛04,0,0,0,0,0,0,0,0,0,2000,0,0,0,3000,1000,2000,2000
041956,聯發科富邦91購01,0,0,0,0,0,0,0,0,0,2000,0,0,0,13000,11000,2000,2000
042326,元油2X國票94購01,0,0,0,0,0,0,0,0,0,2000,0,0,0,2000,0,2000,2000
041455,國巨元富93購05  ,0,0,0,0,0,0,0,0,0,2000,0,0,0,2000,0,2000,2000
044559,元油2X日盛91購01,0,0,0,0,0,0,0,0,0,2000,0,0,0,2000,0,2000,2000
043519,旺宏元大91購02  ,0,0,0,0,0,0,0,0,0,2000,0,0,0,2000,0,2000,2000
045009,可成元大92購03  ,0,0,0,0,0,0,0,0,0,2000,0,0,0,2000,0,2000,2000
044853,亞光國泰93購01  ,0,0,0,0,0,0,0,0,0,2000,0,0,0,40000,38000,2000,2000
045198,光磊凱基92購01  ,0,0,0,0,0,0,0,0,0,2000,0,0,0,5000,3000,2000,2000
045344,可成凱基92購06  ,0,0,0,0,0,0,0,0,0,2000,0,0,0,2000,0,2000,2000
045506,麗豐凱基92購02  ,0,0,0,0,0,0,0,0,0,2000,0,0,0,2000,0,2000,2000
043719,國巨統一93購02  ,0,0,0,0,0,0,0,0,0,2000,0,0,0,2000,0,2000,2000
043701,大立光永豐91購02,0,0,0,0,0,0,0,0,0,2000,0,0,0,27000,25000,2000,2000
043741,廣宇元大91購01  ,0,0,0,0,0,0,0,0,0,2000,0,0,0,2000,0,2000,2000
043869,台積電元大91購21,0,0,0,0,0,0,0,0,0,2000,0,0,0,2000,0,2000,2000
04416P,牧德元富94售06  ,0,0,0,0,0,0,0,0,0,2000,0,0,0,202000,200000,2000,2000
046979,台泥兆豐93購01  ,0,0,0,0,0,0,0,0,0,2000,0,0,0,2000,0,2000,2000
048321,欣興凱基93購03  ,0,0,0,0,0,0,0,0,0,2000,0,0,0,2000,0,2000,2000
048663,聯發科統一96購01,0,0,0,0,0,0,0,0,0,2000,0,0,0,50000,48000,2000,2000
048649,瀚宇博元大93購05,0,0,0,0,0,0,0,0,0,2000,0,0,0,47000,45000,2000,2000
047082,元上證永豐93購01,0,0,0,0,0,0,0,0,0,2000,0,0,0,2000,0,2000,2000
047075,群創兆豐93購01  ,0,0,0,0,0,0,0,0,0,2000,0,0,0,84000,82000,2000,2000
04882P,鴻海凱基94售19  ,0,0,0,0,0,0,0,0,0,2000,0,0,0,2000,0,2000,2000
048787,義隆元大94購02  ,0,0,0,0,0,0,0,0,0,2000,0,0,0,10000,8000,2000,2000
048966,佳世達元大95購01,0,0,0,0,0,0,0,0,0,2000,0,0,0,33000,31000,2000,2000
048990,台表科元大94購01,0,0,0,0,0,0,0,0,0,2000,0,0,0,2000,0,2000,2000
047240,樺漢凱基93購01  ,0,0,0,0,0,0,0,0,0,2000,0,0,0,2000,0,2000,2000
047649,啟碁元大93購07  ,0,0,0,0,0,0,0,0,0,2000,0,0,0,34000,32000,2000,2000
048178,上銀富邦95購02  ,0,0,0,0,0,0,0,0,0,2000,0,0,0,6000,4000,2000,2000
049016,國巨群益94購02  ,0,0,0,0,0,0,0,0,0,2000,0,0,0,3000,1000,2000,2000
049222,和碩國票94購01  ,0,0,0,0,0,0,0,0,0,2000,0,0,0,2000,0,2000,2000
049359,台達電元大94購06,0,0,0,0,0,0,0,0,0,2000,0,0,0,2000,0,2000,2000
049256,瑞昱元大94購04  ,0,0,0,0,0,0,0,0,0,2000,0,0,0,18000,16000,2000,2000
049248,台達電元大94購04,0,0,0,0,0,0,0,0,0,2000,0,0,0,2000,0,2000,2000
049382,牧德元大94購04  ,0,0,0,0,0,0,0,0,0,2000,0,0,0,2000,0,2000,2000
049370,可成元大94購03  ,0,0,0,0,0,0,0,0,0,2000,0,0,0,24000,22000,2000,2000
046878,康友國泰94購01  ,0,0,0,0,0,0,0,0,0,2000,0,0,0,3000,1000,2000,2000
047994,亞德客元大93購03,0,0,0,0,0,0,0,0,0,2000,0,0,0,62000,60000,2000,2000
048034,大立光凱基93購29,0,0,0,0,0,0,0,0,0,2000,0,0,0,2000,0,2000,2000
046948,聯詠元大93購03  ,0,0,0,0,0,0,0,0,0,2000,0,0,0,2000,0,2000,2000
046183,瑞昱凱基92購02  ,0,0,0,0,0,0,0,0,0,2000,0,0,0,2000,0,2000,2000
046986,台積電凱基93購09,0,0,0,0,0,0,0,0,0,2000,0,0,0,8000,6000,2000,2000
048501,GIS元大94購02   ,0,0,0,0,0,0,0,0,0,2000,0,0,0,2000,0,2000,2000
04785P,鴻海永豐94售03  ,0,0,0,0,0,0,0,0,0,2000,0,0,0,2000,0,2000,2000
048438,台表科麥證94購01,0,0,0,2000,0,2000,0,0,0,2000,0,0,0,2000,0,2000,2000
046567,正崴元富92購01  ,0,0,0,0,0,0,0,0,0,2000,0,0,0,2000,0,2000,2000
046636,亞德客永豐93購02,0,0,0,0,0,0,0,0,0,2000,0,0,0,2000,0,2000,2000
048589,國巨兆豐96購01  ,0,0,0,0,0,0,0,0,0,2000,0,0,0,2000,0,2000,2000
048558,漢唐元大93購06  ,0,0,0,0,0,0,0,0,0,2000,0,0,0,6000,4000,2000,2000
047930,嘉澤凱基93購03  ,0,0,0,0,0,0,0,0,0,2000,0,0,0,2000,0,2000,2000
052034,臺股指群益95購07,0,0,0,0,0,0,0,0,0,2000,0,0,0,2000,0,2000,2000
052089,聯發科元大96購02,0,0,0,0,0,0,0,0,0,2000,0,0,0,75000,73000,2000,2000
051677,達方元大95購01  ,0,0,0,0,0,0,0,0,0,2000,0,0,0,42000,40000,2000,2000
051640,GIS國票96購03   ,0,0,0,0,0,0,0,0,0,2000,0,0,0,2000,0,2000,2000
051736,旺宏國票96購01  ,0,0,0,0,0,0,0,0,0,2000,0,0,0,2000,0,2000,2000
051830,健策元大97購01  ,0,0,0,0,0,0,0,0,0,2000,0,0,0,83000,81000,2000,2000
051424,緯穎國票97購01  ,0,0,0,0,0,0,0,0,0,2000,0,0,0,2000,0,2000,2000
051284,上銀統一95購02  ,0,0,0,0,0,0,0,0,0,2000,0,0,0,2000,0,2000,2000
051030,康友元富95購01  ,0,0,0,0,0,0,0,0,0,2000,0,0,0,3000,1000,2000,2000
051015,南亞科凱基95購04,0,0,0,0,0,0,0,0,0,2000,0,0,0,7000,5000,2000,2000
050982,台積電國泰96購04,0,0,0,0,0,0,0,0,0,2000,0,0,0,15000,13000,2000,2000
050146,訊芯康和94購02  ,0,0,0,0,0,0,0,0,0,2000,0,0,0,70000,68000,2000,2000
050106,台達電元大94購11,0,0,0,0,0,0,0,0,0,2000,0,0,0,2000,0,2000,2000
050115,群創元大96購01  ,0,0,0,0,0,0,0,0,0,2000,0,0,0,73000,71000,2000,2000
049881,TPK永豐94購02   ,0,0,0,0,0,0,0,0,0,2000,0,0,0,2000,0,2000,2000
049577,台達電元大94購08,0,0,0,0,0,0,0,0,0,2000,0,0,0,2000,0,2000,2000
049578,台達電元大94購09,0,0,0,0,0,0,0,0,0,2000,0,0,0,2000,0,2000,2000
049537,元石油群益97購01,0,0,0,0,0,0,0,0,0,2000,0,0,0,5000,3000,2000,2000
049425,喬山兆豐95購01  ,0,0,0,0,0,0,0,0,0,2000,0,0,0,2000,0,2000,2000
049495,欣興元大94購06  ,0,0,0,0,0,0,0,0,0,2000,0,0,0,3000,1000,2000,2000
049462,康友元富94購01  ,0,0,0,0,0,0,0,0,0,2000,0,0,0,27000,25000,2000,2000
049693,可成元大94購08  ,0,0,0,0,0,0,0,0,0,2000,0,0,0,2000,0,2000,2000
049672,臺股指富邦94購01,0,0,0,0,0,0,0,0,0,2000,0,0,0,2000,0,2000,2000
049642,鴻海凱基94購16  ,0,0,0,0,0,0,0,0,0,2000,0,0,0,17000,15000,2000,2000
049716,台積電凱基94購24,0,0,0,0,0,0,0,0,0,2000,0,0,0,3000,1000,2000,2000
050576,南亞科國票95購01,20000,0,20000,0,0,0,0,0,0,-18000,0,0,0,2000,20000,-18000,2000
050716,可成群益96購01  ,0,0,0,0,0,0,0,0,0,2000,0,0,0,41000,39000,2000,2000
050769,聯發科元大94購17,0,0,0,0,0,0,0,0,0,2000,0,0,0,10000,8000,2000,2000
050836,緯穎凱基95購01  ,0,0,0,0,0,0,0,0,0,2000,0,0,0,19000,17000,2000,2000
050811,國巨凱基95購02  ,0,0,0,0,0,0,0,0,0,2000,0,0,0,2000,0,2000,2000
05052P,友達群益97售01  ,0,0,0,0,0,0,0,0,0,2000,0,0,0,2000,0,2000,2000
050540,台積電凱基94購38,0,0,0,0,0,0,0,0,0,2000,0,0,0,22000,20000,2000,2000
050459,台表科元大94購03,0,0,0,0,0,0,0,0,0,2000,0,0,0,2000,0,2000,2000
050334,鴻海國泰96購07  ,0,0,0,0,0,0,0,0,0,2000,0,0,0,50000,48000,2000,2000
1256,鮮活果汁-KY     ,6000,4000,2000,0,0,0,0,0,0,0,0,0,0,0,0,0,2000
1436,華友聯          ,3000,1000,2000,0,0,0,0,0,0,0,0,0,0,0,0,0,2000
1541,錩泰            ,3000,1000,2000,0,0,0,0,0,0,0,0,0,0,0,0,0,2000
06006P,欣興永豐96售04  ,0,0,0,0,0,0,0,0,0,2000,0,0,0,14000,12000,2000,2000
05907P,聯發科元富96售05,0,0,0,0,0,0,0,0,0,2000,0,0,0,11000,9000,2000,2000
05901P,臺股指凱基9C售01,0,0,0,0,0,0,0,0,0,2000,0,0,0,2000,0,2000,2000
05937P,台積電凱基96售21,0,0,0,0,0,0,0,0,0,2000,0,0,0,2000,0,2000,2000
05929P,宏達電康和96售01,0,0,0,0,0,0,0,0,0,2000,0,0,0,2000,0,2000,2000
1805,寶徠            ,2000,0,2000,0,0,0,0,0,0,0,0,0,0,0,0,0,2000
2236,百達-KY         ,2000,0,2000,0,0,0,0,0,0,0,0,0,0,0,0,0,2000
2611,志信            ,7000,5000,2000,0,0,0,0,0,0,0,0,0,0,0,0,0,2000
4555,氣立            ,3000,1000,2000,0,0,0,0,0,0,0,0,0,0,0,0,0,2000
4108,懷特            ,3000,1000,2000,0,0,0,0,0,0,0,0,0,0,0,0,0,2000
2891B,中信金乙特      ,0,0,0,0,0,0,0,0,0,2000,2000,0,2000,0,0,0,2000
2904,匯僑            ,7000,4000,3000,0,0,0,0,0,0,-1000,0,1000,-1000,0,0,0,2000
8466,美吉吉-KY       ,2000,0,2000,0,0,0,0,0,0,0,0,0,0,0,0,0,2000
9136,巨騰-DR         ,3000,1000,2000,0,0,0,0,0,0,0,0,0,0,0,0,0,2000
9911,櫻花            ,32000,30000,2000,0,0,0,0,0,0,0,0,0,0,0,0,0,2000
6128,上福            ,2000,0,2000,0,0,0,0,0,0,0,0,0,0,0,0,0,2000
5906,台南-KY         ,2000,0,2000,0,0,0,0,0,0,0,0,0,0,0,0,0,2000
5538,東明-KY         ,3000,0,3000,0,0,0,0,1000,-1000,0,0,0,0,0,0,0,2000
6625,必應            ,2000,0,2000,0,0,0,0,0,0,0,0,0,0,0,0,0,2000
6431,光麗-KY         ,2000,0,2000,0,0,0,0,0,0,0,0,0,0,0,0,0,2000
008201,BP上證50        ,0,0,0,0,0,0,0,0,0,1200,0,0,0,1200,0,1200,1200
053067,牧德群益96購01  ,0,0,0,0,0,0,0,0,0,1000,0,0,0,1000,0,1000,1000
052926,旺宏元大98購02  ,0,0,0,0,0,0,0,0,0,1000,0,0,0,1238000,1237000,1000,1000
053174,同欣電群益98購02,0,0,0,0,0,0,0,0,0,1000,0,0,0,1000,0,1000,1000
053212,友達凱基99購04  ,0,0,0,0,0,0,0,0,0,1000,0,0,0,140000,139000,1000,1000
05346P,臺股指統一95售06,0,0,0,0,0,0,0,0,0,1000,0,0,0,1000,0,1000,1000
053451,致新凱基96購02  ,0,0,0,0,0,0,0,0,0,1000,0,0,0,61000,60000,1000,1000
053280,群創元大9C購01  ,0,0,0,0,0,0,0,0,0,1000,0,0,0,75000,74000,1000,1000
052363,廣達國票96購01  ,0,0,0,0,0,0,0,0,0,1000,0,0,0,1000,0,1000,1000
052562,南亞科日盛96購01,0,0,0,0,0,0,0,0,0,1000,0,0,0,1000,0,1000,1000
052506,日月光日盛95購01,0,0,0,0,0,0,0,0,0,1000,0,0,0,1000,0,1000,1000
052417,聯發科兆豐9B購01,0,0,0,0,0,0,0,0,0,1000,0,0,0,1000,0,1000,1000
052841,群創富邦96購02  ,0,0,0,0,0,0,0,0,0,1000,0,0,0,1000,0,1000,1000
052890,FB上証群益9B購01,0,0,0,0,0,0,0,0,0,1000,0,0,0,5000,4000,1000,1000
052668,聯發科群益97購01,0,0,0,0,0,0,0,0,0,1000,0,0,0,46000,45000,1000,1000
053679,緯創富邦96購01  ,0,0,0,0,0,0,0,0,0,1000,0,0,0,1000,0,1000,1000
053866,景碩元大97購02  ,0,0,0,0,0,0,0,0,0,1000,0,0,0,1000,0,1000,1000
05535P,台積電元大97售06,0,0,0,0,0,0,0,0,0,1000,0,0,0,502000,501000,1000,1000
054639,台新金中信99購01,0,0,0,0,0,0,0,0,0,1000,0,0,0,1000,0,1000,1000
05460P,台郡凱基95售05  ,0,0,0,0,0,0,0,0,0,1000,0,0,0,1000,0,1000,1000
054402,康控永豐96購03  ,0,0,0,0,0,0,0,0,0,1000,0,0,0,1000,0,1000,1000
00691R,兆豐藍籌30反1   ,0,0,0,0,0,0,0,0,0,1000,0,0,0,1000,0,1000,1000
00702,國泰標普低波高息,0,0,0,0,0,0,0,0,0,1000,0,0,0,2000,1000,1000,1000
00657,國泰日經225     ,0,0,0,0,0,0,0,0,0,1000,0,0,0,107000,106000,1000,1000
03608P,鴻海元大92售14  ,0,0,0,0,0,0,0,0,0,1000,0,0,0,1000,0,1000,1000
03590P,臺股指元大03售13,0,0,0,0,0,0,0,0,0,1000,0,0,0,1000,0,1000,1000
04077P,臺股指凱基93售13,0,0,0,0,0,0,0,0,0,1000,0,0,0,1000,0,1000,1000
03004P,華擎群益02售02  ,0,0,0,0,0,0,0,0,0,1000,0,0,0,1000,0,1000,1000
020011,統一微波高息20N ,0,0,0,0,0,0,0,0,0,1000,0,0,0,3000,2000,1000,1000
04350P,欣興國票94售01  ,0,0,0,0,0,0,0,0,0,1000,0,0,0,1000,0,1000,1000
043593,台光電元大91購02,0,0,0,0,0,0,0,0,0,1000,0,0,0,1000,0,1000,1000
043346,TPK富邦93購01   ,0,0,0,0,0,0,0,0,0,1000,0,0,0,51000,50000,1000,1000
044334,華新科統一91購02,0,0,0,0,0,0,0,0,0,1000,0,0,0,1000,0,1000,1000
04438P,微星群益94售01  ,0,0,0,0,0,0,0,0,0,1000,0,0,0,11000,10000,1000,1000
044402,景碩凱基93購01  ,0,0,0,0,0,0,0,0,0,1000,0,0,0,1000,0,1000,1000
044538,南亞科群益91購05,0,0,0,0,0,0,0,0,0,1000,0,0,0,1000,0,1000,1000
044552,元油2X永豐91購02,0,0,0,0,0,0,0,0,0,1000,0,0,0,1000,0,1000,1000
044434,景碩元大91購03  ,0,0,0,0,0,0,0,0,0,1000,0,0,0,1000,0,1000,1000
044475,國巨元富95購02  ,0,0,0,0,0,0,0,0,0,1000,0,0,0,1000,0,1000,1000
044476,元油2X統一91購01,0,0,0,0,0,0,0,0,0,1000,0,0,0,6000,5000,1000,1000
044630,中磊元大91購03  ,0,0,0,0,0,0,0,0,0,1000,0,0,0,1000,0,1000,1000
041233,智易元大91購01  ,0,0,0,0,0,0,0,0,0,1000,0,0,0,1000,0,1000,1000
041844,台積電富邦93購01,0,0,0,0,0,0,0,0,0,1000,0,0,0,1000,0,1000,1000
04161P,全新國泰94售01  ,0,0,0,0,0,0,0,0,0,1000,0,0,0,30000,29000,1000,1000
041906,鴻海元大91購02  ,0,0,0,0,0,0,0,0,0,1000,0,0,0,121000,120000,1000,1000
04279P,超眾凱基93售07  ,0,0,0,0,0,0,0,0,0,1000,0,0,0,1000,0,1000,1000
042915,大立光元大93購01,0,0,0,0,0,0,0,0,0,1000,0,0,0,1000,0,1000,1000
043269,GIS麥證92購01   ,0,0,0,1000,0,1000,0,0,0,1000,0,0,0,1000,0,1000,1000
048281,矽力永豐93購02  ,0,0,0,0,0,0,0,0,0,1000,0,0,0,11000,10000,1000,1000
048230,瀚宇博凱基93購03,0,0,0,0,0,0,0,0,0,1000,0,0,0,1000,0,1000,1000
048273,南電富邦97購01  ,0,0,0,0,0,0,0,0,0,1000,0,0,0,1000,0,1000,1000
046318,聯詠元大92購04  ,0,0,0,0,0,0,0,0,0,1000,0,0,0,1000,0,1000,1000
047770,聯詠元大93購10  ,0,0,0,0,0,0,0,0,0,1000,0,0,0,101000,100000,1000,1000
04626P,聯發科元大94售07,0,0,0,0,0,0,0,0,0,1000,0,0,0,11000,10000,1000,1000
046247,南電亞東93購02  ,0,0,0,0,0,0,0,0,0,1000,0,0,0,1000,0,1000,1000
046238,嘉澤第一92購01  ,0,0,0,0,0,0,0,0,0,1000,0,0,0,1000,0,1000,1000
046224,中環元大92購02  ,0,0,0,0,0,0,0,0,0,1000,0,0,0,1000,0,1000,1000
046204,致新凱基93購01  ,0,0,0,0,0,0,0,0,0,1000,0,0,0,1000,0,1000,1000
044151,台表科康和91購01,0,0,0,0,0,0,0,0,0,1000,0,0,0,1000,0,1000,1000
044143,台光電群益91購01,0,0,0,0,0,0,0,0,0,1000,0,0,0,1000,0,1000,1000
044260,滬深2X國泰92購02,0,0,0,0,0,0,0,0,0,1000,0,0,0,1000,0,1000,1000
044231,樺漢群益91購01  ,0,0,0,0,0,0,0,0,0,1000,0,0,0,1000,0,1000,1000
044295,中磊凱基91購03  ,0,0,0,0,0,0,0,0,0,1000,0,0,0,1000,0,1000,1000
04559P,華通凱基94售03  ,0,0,0,0,0,0,0,0,0,1000,0,0,0,1000,0,1000,1000
045772,台光電元大93購01,0,0,0,0,0,0,0,0,0,1000,0,0,0,1000,0,1000,1000
045750,鈺齊富邦94購01  ,0,0,0,0,0,0,0,0,0,1000,0,0,0,1000,0,1000,1000
04558P,瑞昱日盛94售01  ,0,0,0,0,0,0,0,0,0,1000,0,0,0,1000,0,1000,1000
045577,台光電元大92購06,0,0,0,0,0,0,0,0,0,1000,0,0,0,1000,0,1000,1000
045556,可成國票93購01  ,0,0,0,0,0,0,0,0,0,1000,0,0,0,1000,0,1000,1000
04393P,牧德凱基94售06  ,0,0,0,0,0,0,0,0,0,1000,0,0,0,1000,0,1000,1000
044024,祥碩凱基93購01  ,0,0,0,0,0,0,0,0,0,1000,0,0,0,1000,0,1000,1000
044043,旺宏中信91購02  ,0,0,0,0,0,0,0,0,0,1000,0,0,0,21000,20000,1000,1000
045349,大立光凱基93購07,0,0,0,0,0,0,0,0,0,1000,0,0,0,1000,0,1000,1000
045418,上銀凱基92購01  ,0,0,0,0,0,0,0,0,0,1000,0,0,0,11000,10000,1000,1000
045268,康普凱基92購01  ,0,0,0,0,0,0,0,0,0,1000,0,0,0,1000,0,1000,1000
044741,玉山金富邦93購01,0,0,0,0,0,0,0,0,0,1000,0,0,0,1000,0,1000,1000
04479P,同欣電中信96售02,0,0,0,0,0,0,0,0,0,1000,0,0,0,1000,0,1000,1000
044956,聯詠凱基92購01  ,0,0,0,0,0,0,0,0,0,1000,0,0,0,31000,30000,1000,1000
045025,瑞昱國票92購01  ,0,0,0,0,0,0,0,0,0,1000,0,0,0,1000,0,1000,1000
045002,高股息元大92購02,0,0,0,0,0,0,0,0,0,1000,0,0,0,1000,0,1000,1000
045049,景碩凱基92購02  ,0,0,0,0,0,0,0,0,0,1000,0,0,0,1000,0,1000,1000
047916,台積電凱基93購22,0,0,0,0,0,0,0,0,0,1000,0,0,0,7000,6000,1000,1000
046513,景碩元大92購02  ,0,0,0,0,0,0,0,0,0,1000,0,0,0,1000,0,1000,1000
046473,晶技永豐92購01  ,0,0,0,0,0,0,0,0,0,1000,0,0,0,41000,40000,1000,1000
04645P,禾伸堂凱基94售03,0,0,0,0,0,0,0,0,0,1000,0,0,0,11000,10000,1000,1000
046582,聯發科元大92購23,0,0,0,0,0,0,0,0,0,1000,0,0,0,1000,0,1000,1000
048430,瑞昱國票93購02  ,0,0,0,0,0,0,0,0,0,1000,0,0,0,1000,0,1000,1000
048451,智原凱基93購02  ,0,0,0,0,0,0,0,0,0,1000,0,0,0,1000,0,1000,1000
048440,國巨凱基93購08  ,0,0,0,0,0,0,0,0,0,1000,0,0,0,1000,0,1000,1000
048355,國巨永豐93購04  ,0,0,0,0,0,0,0,0,0,1000,0,0,0,1000,0,1000,1000
046346,旺宏兆豐92購02  ,0,0,0,0,0,0,0,0,0,1000,0,0,0,1000,0,1000,1000
047432,台達電元大93購01,0,0,0,0,0,0,0,0,0,1000,0,0,0,1000,0,1000,1000
046991,健策凱基93購04  ,0,0,0,0,0,0,0,0,0,1000,0,0,0,1000,0,1000,1000
047393,景碩元大93購02  ,0,0,0,0,0,0,0,0,0,1000,0,0,0,1000,0,1000,1000
046189,聯發科凱基92購02,0,0,0,0,0,0,0,0,0,1000,0,0,0,6000,5000,1000,1000
046132,致新元大92購01  ,0,0,0,0,0,0,0,0,0,1000,0,0,0,1000,0,1000,1000
046164,健策兆豐93購03  ,0,0,0,0,0,0,0,0,0,1000,0,0,0,1000,0,1000,1000
046925,華新科國泰94購03,0,0,0,0,0,0,0,0,0,1000,0,0,0,1000,0,1000,1000
046898,南茂麥證93購01  ,0,0,0,1000,0,1000,0,0,0,1000,0,0,0,1000,0,1000,1000
048002,景碩元大93購04  ,0,0,0,0,0,0,0,0,0,1000,0,0,0,1000,0,1000,1000
046846,智伸科永豐93購01,0,0,0,0,0,0,0,0,0,1000,0,0,0,1000,0,1000,1000
046847,志超永豐93購01  ,0,0,0,0,0,0,0,0,0,1000,0,0,0,1000,0,1000,1000
046106,致新永豐92購01  ,0,0,0,0,0,0,0,0,0,1000,0,0,0,1000,0,1000,1000
046008,臺股指統一92購03,0,0,0,0,0,0,0,0,0,1000,0,0,0,1000,0,1000,1000
049251,國巨元大95購02  ,0,0,0,0,0,0,0,0,0,1000,0,0,0,1000,0,1000,1000
04935P,鴻海中信96售01  ,0,0,0,0,0,0,0,0,0,1000,0,0,0,1000,0,1000,1000
049360,台達電元大94購07,0,0,0,0,0,0,0,0,0,1000,0,0,0,1000,0,1000,1000
049361,華通元大94購02  ,0,0,0,0,0,0,0,0,0,1000,0,0,0,56000,55000,1000,1000
049063,緯穎日盛94購01  ,0,0,0,0,0,0,0,0,0,1000,0,0,0,1000,0,1000,1000
049077,佳世達凱基94購02,0,0,0,0,0,0,0,0,0,1000,0,0,0,1000,0,1000,1000
048191,亞德客元大93購06,0,0,0,0,0,0,0,0,0,1000,0,0,0,1000,0,1000,1000
04928P,大立光凱基95售07,0,0,0,0,0,0,0,0,0,1000,0,0,0,1000,0,1000,1000
049943,聯詠第一94購01  ,0,0,0,0,0,0,0,0,0,1000,0,0,0,1000,0,1000,1000
049916,台光電元大94購06,0,0,0,0,0,0,0,0,0,1000,0,0,0,1000,0,1000,1000
047658,全新麥證93購02  ,0,0,0,1000,0,1000,0,0,0,1000,0,0,0,1000,0,1000,1000
047567,欣興國票93購05  ,0,0,0,0,0,0,0,0,0,1000,0,0,0,1000,0,1000,1000
047687,元金2X富邦96購01,0,0,0,0,0,0,0,0,0,1000,0,0,0,1000,0,1000,1000
047317,聯詠元大93購06  ,0,0,0,0,0,0,0,0,0,1000,0,0,0,1000,0,1000,1000
047318,聯詠元大93購07  ,0,0,0,0,0,0,0,0,0,1000,0,0,0,1000,0,1000,1000
047215,華新科第一93購01,0,0,0,0,0,0,0,0,0,1000,0,0,0,1000,0,1000,1000
047211,華新科富邦99購01,0,0,0,0,0,0,0,0,0,1000,0,0,0,1000,0,1000,1000
048169,瑞昱永豐93購02  ,0,0,0,0,0,0,0,0,0,1000,0,0,0,1000,0,1000,1000
047442,聯詠元大93購09  ,0,0,0,0,0,0,0,0,0,1000,0,0,0,5000,4000,1000,1000
047485,景碩凱基94購01  ,0,0,0,0,0,0,0,0,0,1000,0,0,0,1000,0,1000,1000
048775,智伸科凱基94購01,0,0,0,0,0,0,0,0,0,1000,0,0,0,1000,0,1000,1000
047183,台光電元大93購05,0,0,0,0,0,0,0,0,0,1000,0,0,0,4000,3000,1000,1000
048738,台積電統一94購04,0,0,0,0,0,0,0,0,0,1000,0,0,0,1000,0,1000,1000
048788,華新科元大95購02,0,0,0,0,0,0,0,0,0,1000,0,0,0,1000,0,1000,1000
048704,台表科國票95購01,0,0,0,0,0,0,0,0,0,1000,0,0,0,1000,0,1000,1000
048798,華新科國泰95購01,0,0,0,0,0,0,0,0,0,1000,0,0,0,1000,0,1000,1000
048855,華新科群益94購02,0,0,0,0,0,0,0,0,0,1000,0,0,0,102000,101000,1000,1000
047111,台光電元大93購04,0,0,0,0,0,0,0,0,0,1000,0,0,0,1000,0,1000,1000
048650,台表科元大93購05,0,0,0,0,0,0,0,0,0,1000,0,0,0,1000,0,1000,1000
048911,玉晶光富邦96購01,0,0,0,0,0,0,0,0,0,1000,0,0,0,1000,0,1000,1000
050427,台積電凱基94購34,0,0,0,0,0,0,0,0,0,1000,0,0,0,1000,0,1000,1000
050891,喬山元大95購01  ,0,0,0,0,0,0,0,0,0,1000,0,0,0,29000,28000,1000,1000
050738,臺股指康和94購01,0,0,0,0,0,0,0,0,0,1000,0,0,0,1000,0,1000,1000
050696,台光電凱基96購01,0,0,0,0,0,0,0,0,0,1000,0,0,0,1000,0,1000,1000
050551,大立光凱基95購05,0,0,0,0,0,0,0,0,0,1000,0,0,0,1000,0,1000,1000
049463,華新科富邦97購01,0,0,0,0,0,0,0,0,0,1000,0,0,0,44000,43000,1000,1000
049430,國巨國票95購02  ,0,0,0,0,0,0,0,0,0,1000,0,0,0,1000,0,1000,1000
049538,元油2X群益98購01,0,0,0,0,0,0,0,0,0,1000,0,0,0,1000,0,1000,1000
049812,致伸元大94購03  ,0,0,0,0,0,0,0,0,0,1000,0,0,0,6000,5000,1000,1000
049809,聯詠元大94購04  ,0,0,0,0,0,0,0,0,0,1000,0,0,0,6000,5000,1000,1000
049793,為升元大94購04  ,0,0,0,0,0,0,0,0,0,1000,0,0,0,16000,15000,1000,1000
050003,景碩永豐94購01  ,0,0,0,0,0,0,0,0,0,1000,0,0,0,26000,25000,1000,1000
050023,國巨元大94購12  ,0,0,0,0,0,0,0,0,0,1000,0,0,0,13000,12000,1000,1000
049895,國巨統一94購04  ,0,0,0,0,0,0,0,0,0,1000,0,0,0,1000,0,1000,1000
051023,S&P反1統一95購02,0,0,0,0,0,0,0,0,0,1000,0,0,0,1000,0,1000,1000
050998,訊連元大95購01  ,0,0,0,0,0,0,0,0,0,1000,0,0,0,21000,20000,1000,1000
050994,欣興元大96購03  ,0,0,0,0,0,0,0,0,0,1000,0,0,0,1000,0,1000,1000
051093,聯詠元大95購01  ,0,0,0,0,0,0,0,0,0,1000,0,0,0,1000,0,1000,1000
05109P,臺股指麥證95售01,0,0,0,1000,0,1000,0,0,0,1000,0,0,0,1000,0,1000,1000
051300,台光電凱基96購02,0,0,0,0,0,0,0,0,0,1000,0,0,0,1000,0,1000,1000
051318,上銀國票96購01  ,0,0,0,0,0,0,0,0,0,1000,0,0,0,25000,24000,1000,1000
05130P,聯發科統一95售03,0,0,0,0,0,0,0,0,0,1000,0,0,0,53000,52000,1000,1000
051271,華新科群益95購04,0,0,0,0,0,0,0,0,0,1000,0,0,0,1000,0,1000,1000
051349,國巨元大95購08  ,0,0,0,0,0,0,0,0,0,1000,0,0,0,1000,0,1000,1000
051430,瑞昱元富95購02  ,0,0,0,0,0,0,0,0,0,1000,0,0,0,3000,2000,1000,1000
051458,臺股指元大95購18,0,0,0,0,0,0,0,0,0,1000,0,0,0,1000,0,1000,1000
051455,樺漢元大96購01  ,0,0,0,0,0,0,0,0,0,1000,0,0,0,83000,82000,1000,1000
051814,鈺齊凱基95購01  ,0,0,0,0,0,0,0,0,0,1000,0,0,0,1000,0,1000,1000
051618,智邦凱基95購06  ,0,0,0,0,0,0,0,0,0,1000,0,0,0,7000,6000,1000,1000
051664,鴻海元大96購07  ,0,0,0,0,0,0,0,0,0,1000,0,0,0,223000,222000,1000,1000
052045,瑞昱凱基96購01  ,0,0,0,0,0,0,0,0,0,1000,0,0,0,1000,0,1000,1000
051994,瀚宇博元大96購01,0,0,0,0,0,0,0,0,0,1000,0,0,0,24000,23000,1000,1000
052015,漢唐永豐95購02  ,0,0,0,0,0,0,0,0,0,1000,0,0,0,1000,0,1000,1000
052219,大立光日盛95購02,0,0,0,0,0,0,0,0,0,1000,0,0,0,16000,15000,1000,1000
6655,科定            ,1000,0,1000,0,0,0,0,0,0,0,0,0,0,0,0,0,1000
8114,振樺電          ,5000,6000,-1000,0,0,0,0,0,0,2000,2000,0,2000,0,0,0,1000
6671,三能-KY         ,1000,0,1000,0,0,0,0,0,0,0,0,0,0,0,0,0,1000
6715,嘉基            ,1000,0,1000,0,0,0,0,0,0,0,0,0,0,0,0,0,1000
6172,互億            ,7000,6000,1000,0,0,0,0,0,0,0,0,0,0,0,0,0,1000
2891C,中信金丙特      ,0,0,0,0,0,0,0,0,0,1000,1000,0,1000,0,0,0,1000
4545,銘鈺            ,2000,1000,1000,0,0,0,0,0,0,0,0,0,0,0,0,0,1000
4552,力達-KY         ,31000,30000,1000,0,0,0,0,0,0,0,0,0,0,0,0,0,1000
4755,三福化          ,2000,1000,1000,0,0,0,0,0,0,0,0,0,0,0,0,0,1000
4807,日成-KY         ,3000,2000,1000,0,0,0,0,0,0,0,0,0,0,0,0,0,1000
2630,亞航            ,2000,1000,1000,0,0,0,0,0,0,0,0,0,0,0,0,0,1000
2613,中櫃            ,1000,0,1000,0,0,0,0,0,0,0,0,0,0,0,0,0,1000
2546,根基            ,3000,2000,1000,0,0,0,0,0,0,0,0,0,0,0,0,0,1000
2530,華建            ,5000,4000,1000,0,0,0,0,0,0,0,0,0,0,0,0,0,1000
2462,良得電          ,4000,3000,1000,0,0,0,0,0,0,0,0,0,0,0,0,0,1000
2450,神腦            ,14000,13000,1000,0,0,0,0,0,0,0,0,0,0,0,0,0,1000
2239,英利-KY         ,9000,8000,1000,0,0,0,0,0,0,0,0,0,0,0,0,0,1000
05703P,矽力群益96售03  ,0,0,0,0,0,0,0,0,0,1000,0,0,0,32000,31000,1000,1000
05592P,可成群益96售03  ,0,0,0,0,0,0,0,0,0,1000,0,0,0,22000,21000,1000,1000
05968P,鴻海台新96售02  ,0,0,0,0,0,0,0,0,0,1000,0,0,0,1000,0,1000,1000
1531,高林股          ,20000,19000,1000,0,0,0,0,0,0,0,0,0,0,0,0,0,1000
1529,樂士            ,3000,2000,1000,0,0,0,0,0,0,0,0,0,0,0,0,0,1000
00636K,國泰中國A50+U   ,0,0,0,0,0,0,0,0,0,100,0,0,0,100,0,100,100
054414,全新元大97購02  ,0,0,0,0,0,0,0,0,0,0,0,0,0,35000,35000,0,0
054423,華新富邦96購01  ,0,0,0,0,0,0,0,0,0,0,0,0,0,94000,94000,0,0
05442P,鴻海元大96售13  ,0,0,0,0,0,0,0,0,0,0,0,0,0,93000,93000,0,0
054445,技嘉兆豐96購01  ,0,0,0,0,0,0,0,0,0,0,0,0,0,3000,3000,0,0
054463,瑞昱凱基97購01  ,0,0,0,0,0,0,0,0,0,0,0,0,0,16000,16000,0,0
054282,泰鼎群益98購02  ,0,0,0,0,0,0,0,0,0,0,0,0,0,4000,4000,0,0
054302,鴻海凱基96購18  ,0,0,0,0,0,0,0,0,0,0,0,0,0,3000,3000,0,0
054259,健策元大97購03  ,0,0,0,0,0,0,0,0,0,0,0,0,0,49000,49000,0,0
054605,鴻海永豐97購01  ,0,0,0,0,0,0,0,0,0,0,0,0,0,5000,5000,0,0
05468P,鴻海元大96售14  ,0,0,0,0,0,0,0,0,0,0,0,0,0,49000,49000,0,0
054593,滬深2X永昌9A購01,0,0,0,0,0,0,0,0,0,0,0,0,0,2000,2000,0,0
054570,易華電群益98購01,0,0,0,0,0,0,0,0,0,0,0,0,0,10000,10000,0,0
054521,TPK元大96購03   ,0,0,0,0,0,0,0,0,0,0,0,0,0,11000,11000,0,0
054558,劍麟群益99購01  ,0,0,0,0,0,0,0,0,0,0,0,0,0,20000,20000,0,0
05544P,台表科元富96售01,0,0,0,0,0,0,0,0,0,0,0,0,0,10000,10000,0,0
054826,復盛元大9A購01  ,0,0,0,0,0,0,0,0,0,0,0,0,0,11000,11000,0,0
054699,復盛永豐97購01  ,0,0,0,0,0,0,0,0,0,0,0,0,0,108000,108000,0,0
053869,嘉澤元大96購02  ,0,0,0,0,0,0,0,0,0,0,0,0,0,6000,6000,0,0
053854,聯茂國泰97購02  ,0,0,0,0,0,0,0,0,0,0,0,0,0,20000,20000,0,0
053840,燿華統一96購02  ,0,0,0,0,0,0,0,0,0,0,0,0,0,27000,27000,0,0
053785,聯詠元大96購05  ,0,0,0,0,0,0,0,0,0,0,0,0,0,68000,68000,0,0
053783,聯發科元大96購17,0,0,0,0,0,0,0,0,0,0,0,0,0,150000,150000,0,0
053819,大立光群益96購04,0,0,0,0,0,0,0,0,0,0,0,0,0,2000,2000,0,0
053753,啟碁永豐96購01  ,0,0,0,0,0,0,0,0,0,0,0,0,0,12000,12000,0,0
053773,上銀元大96購04  ,0,0,0,0,0,0,0,0,0,0,0,0,0,3000,3000,0,0
053774,台達電元大96購04,0,0,0,0,0,0,0,0,0,0,0,0,0,1000,1000,0,0
05377P,鴻海凱基95售18  ,0,0,0,0,0,0,0,0,0,0,0,0,0,4000,4000,0,0
053781,友達元大9B購03  ,0,0,0,0,0,0,0,0,0,0,0,0,0,2000,2000,0,0
053678,南亞科富邦97購01,0,0,0,0,0,0,0,0,0,0,0,0,0,17000,17000,0,0
053688,燿華元大96購05  ,0,0,0,0,0,0,0,0,0,0,0,0,0,73000,73000,0,0
053711,鴻海凱基96購14  ,0,0,0,0,0,0,0,0,0,0,0,0,0,4000,4000,0,0
053720,宏達電凱基97購01,0,0,0,0,0,0,0,0,0,0,0,0,0,6000,6000,0,0
053596,嘉澤元大96購01  ,0,0,0,0,0,0,0,0,0,0,0,0,0,26000,26000,0,0
054127,台積電元大96購21,0,0,0,0,0,0,0,0,0,0,0,0,0,50000,50000,0,0
054094,創意群益96購02  ,0,0,0,0,0,0,0,0,0,0,0,0,0,20000,20000,0,0
054144,康控元大97購02  ,0,0,0,0,0,0,0,0,0,0,0,0,0,5000,5000,0,0
054147,GIS元大96購02   ,0,0,0,0,0,0,0,0,0,0,0,0,0,82000,82000,0,0
053941,國巨國泰96購05  ,0,0,0,0,0,0,0,0,0,0,0,0,0,34000,34000,0,0
053920,新光金國票98購01,0,0,0,0,0,0,0,0,0,0,0,0,0,200000,200000,0,0
053909,致伸凱基97購01  ,0,0,0,0,0,0,0,0,0,0,0,0,0,1000,1000,0,0
053991,鴻海群益96購05  ,0,0,0,0,0,0,0,0,0,0,0,0,0,4000,4000,0,0
053978,創意元大96購05  ,0,0,0,0,0,0,0,0,0,0,0,0,0,144000,144000,0,0
053975,大立光元大98購04,0,0,0,0,0,0,0,0,0,0,0,0,0,1000,1000,0,0
053981,康控元大96購05  ,0,0,0,0,0,0,0,0,0,0,0,0,0,39000,39000,0,0
052657,友達元富96購01  ,0,0,0,0,0,0,0,0,0,0,0,0,0,1000,1000,0,0
052596,群創群益98購05  ,0,0,0,0,0,0,0,0,0,0,0,0,0,3000,3000,0,0
052611,力成元大96購02  ,0,0,0,0,0,0,0,0,0,0,0,0,0,37000,37000,0,0
052612,康舒元大97購01  ,0,0,0,0,0,0,0,0,0,0,0,0,0,17000,17000,0,0
052603,鴻海元大96購15  ,0,0,0,0,0,0,0,0,0,0,0,0,0,123000,123000,0,0
05261P,鴻海元大95售20  ,0,0,0,0,0,0,0,0,0,0,0,0,0,49000,49000,0,0
052633,國巨凱基96購05  ,0,0,0,0,0,0,0,0,0,0,0,0,0,6000,6000,0,0
052697,滬深2X國票98購01,0,0,0,0,0,0,0,0,0,0,0,0,0,40000,40000,0,0
052683,鴻海元大97購03  ,0,0,0,0,0,0,0,0,0,0,0,0,0,15000,15000,0,0
052704,TPK國票97購01   ,0,0,0,0,0,0,0,0,0,0,0,0,0,20000,20000,0,0
052763,晶技群益97購01  ,0,0,0,0,0,0,0,0,0,0,0,0,0,3000,3000,0,0
052863,友達凱基98購02  ,0,0,0,0,0,0,0,0,0,0,0,0,0,11000,11000,0,0
052860,旺宏凱基96購03  ,0,0,0,0,0,0,0,0,0,0,0,0,0,130000,130000,0,0
052835,滬深2X國泰98購01,0,0,0,0,0,0,0,0,0,0,0,0,0,101000,101000,0,0
052819,義隆永豐96購01  ,0,0,0,0,0,0,0,0,0,0,0,0,0,68000,68000,0,0
052771,GIS群益96購01   ,0,0,0,0,0,0,0,0,0,0,0,0,0,100000,100000,0,0
052801,友達元大9A購01  ,0,0,0,0,0,0,0,0,0,0,0,0,0,5000,5000,0,0
052445,南亞科元大95購05,0,0,0,0,0,0,0,0,0,0,0,0,0,19000,19000,0,0
052441,亞泥元大95購01  ,0,0,0,0,0,0,0,0,0,0,0,0,0,26000,26000,0,0
052546,友達中信98購01  ,0,0,0,0,0,0,0,0,0,0,0,0,0,3000,3000,0,0
052571,新光金凱基98購02,0,0,0,0,0,0,0,0,0,0,0,0,0,13000,13000,0,0
052576,聯茂凱基96購01  ,0,0,0,0,0,0,0,0,0,0,0,0,0,10000,10000,0,0
052585,友達永豐97購01  ,0,0,0,0,0,0,0,0,0,0,0,0,0,3000,3000,0,0
052529,力成元大95購03  ,0,0,0,0,0,0,0,0,0,0,0,0,0,36000,36000,0,0
052542,友達元富98購01  ,0,0,0,0,0,0,0,0,0,0,0,0,0,2000,2000,0,0
052510,聯發科凱基95購13,0,0,0,0,0,0,0,0,0,0,0,0,0,88000,88000,0,0
052373,鴻海元大95購22  ,0,0,0,0,0,0,0,0,0,0,0,0,0,5000,5000,0,0
052336,矽力日盛95購01  ,0,0,0,0,0,0,0,0,0,0,0,0,0,10000,10000,0,0
052318,友達元大98購01  ,0,0,0,0,0,0,0,0,0,0,0,0,0,1000,1000,0,0
052294,創意國票96購03  ,0,0,0,0,0,0,0,0,0,0,0,0,0,7000,7000,0,0
052301,華通康和95購01  ,0,0,0,0,0,0,0,0,0,0,0,0,0,600000,600000,0,0
052302,鴻海永豐95購06  ,0,0,0,0,0,0,0,0,0,0,0,0,0,73000,73000,0,0
052268,新光金亞東96購01,0,0,0,0,0,0,0,0,0,0,0,0,0,48000,48000,0,0
053307,泰碩凱基97購01  ,0,0,0,0,0,0,0,0,0,0,0,0,0,20000,20000,0,0
053381,友達元大9A購02  ,0,0,0,0,0,0,0,0,0,0,0,0,0,2000,2000,0,0
053382,友達元大9C購02  ,0,0,0,0,0,0,0,0,0,0,0,0,0,3000,3000,0,0
053375,鴻海元大96購18  ,0,0,0,0,0,0,0,0,0,0,0,0,0,158000,158000,0,0
053387,緯創元大97購01  ,0,0,0,0,0,0,0,0,0,0,0,0,0,68000,68000,0,0
053390,彩晶元大9A購01  ,0,0,0,0,0,0,0,0,0,0,0,0,0,3000,3000,0,0
053399,創意中信96購01  ,0,0,0,0,0,0,0,0,0,0,0,0,0,16000,16000,0,0
053403,彩晶群益98購01  ,0,0,0,0,0,0,0,0,0,0,0,0,0,3000,3000,0,0
053467,鴻海元大96購20  ,0,0,0,0,0,0,0,0,0,0,0,0,0,163000,163000,0,0
053495,聯發科兆豐96購02,0,0,0,0,0,0,0,0,0,0,0,0,0,5000,5000,0,0
053519,力成群益96購02  ,0,0,0,0,0,0,0,0,0,0,0,0,0,4000,4000,0,0
053508,元油反群益9A購01,0,0,0,0,0,0,0,0,0,0,0,0,0,10000,10000,0,0
053565,台光電富邦98購01,0,0,0,0,0,0,0,0,0,0,0,0,0,5000,5000,0,0
053566,大立光富邦99購03,0,0,0,0,0,0,0,0,0,0,0,0,0,36000,36000,0,0
053171,中磊群益96購01  ,0,0,0,0,0,0,0,0,0,0,0,0,0,13000,13000,0,0
053128,瀚宇博凱基96購01,0,0,0,0,0,0,0,0,0,0,0,0,0,58000,58000,0,0
052984,漢唐元大96購01  ,0,0,0,0,0,0,0,0,0,0,0,0,0,5000,5000,0,0
052972,義隆群益96購04  ,0,0,0,0,0,0,0,0,0,0,0,0,0,20000,20000,0,0
053059,聯發科永昌99購01,0,0,0,0,0,0,0,0,0,0,0,0,0,9000,9000,0,0
053060,大立光永昌96購05,0,0,0,0,0,0,0,0,0,0,0,0,0,77000,77000,0,0
053081,上銀元大97購02  ,0,0,0,0,0,0,0,0,0,0,0,0,0,3000,3000,0,0
053030,南亞科第一96購01,0,0,0,0,0,0,0,0,0,0,0,0,0,57000,57000,0,0
00625K,富邦上証+R      ,0,0,0,0,0,0,0,0,0,0,0,0,0,50000,50000,0,0
00657K,國泰日經225+U   ,0,0,0,0,0,0,0,0,0,0,0,0,0,100,100,0,0
00668K,國泰美國道瓊+U  ,0,0,0,0,0,0,0,0,0,0,0,0,0,100,100,0,0
00666R,富邦恒生國企反1 ,0,0,0,0,0,0,0,0,0,0,0,0,0,83000,83000,0,0
00690,兆豐藍籌30      ,0,0,0,0,0,0,0,0,0,0,0,0,0,187000,187000,0,0
00684R,元大美元指數反1 ,0,0,0,0,0,0,0,0,0,0,0,0,0,40000,40000,0,0
00742,新光內需收益    ,0,0,0,0,0,0,0,0,0,0,0,0,0,1000,1000,0,0
00736,國泰新興市場    ,0,104000,-104000,0,0,0,0,0,0,104000,0,0,0,205000,101000,104000,0
00732,國泰RMB短期報酬 ,0,0,0,0,0,0,0,0,0,0,0,0,0,100000,100000,0,0
00767,FH美國金融股    ,0,0,0,0,0,0,0,0,0,0,0,0,0,103000,103000,0,0
00774B,新光中國政金綠債,0,0,0,0,0,0,0,0,0,0,0,0,0,2000,2000,0,0
00775B,新光投等債15+   ,0,0,0,0,0,0,0,0,0,0,0,0,0,2000,2000,0,0
03602C,臺股指元大93牛01,0,0,0,0,0,0,0,0,0,0,0,0,0,25000,25000,0,0
03767P,瑞昱元大93售05  ,0,0,0,0,0,0,0,0,0,0,0,0,0,14000,14000,0,0
03857P,聯發科元富99售02,0,0,0,0,0,0,0,0,0,0,0,0,0,10000,10000,0,0
03858P,可成元富93售04  ,0,0,0,0,0,0,0,0,0,0,0,0,0,10000,10000,0,0
03383P,聯電凱基02售04  ,0,0,0,0,0,0,0,0,0,0,0,0,0,20000,20000,0,0
03335P,台積電兆豐03售07,0,0,0,0,0,0,0,0,0,0,0,0,0,20000,20000,0,0
04064P,臺股指兆豐93售03,0,0,0,0,0,0,0,0,0,0,0,0,0,50000,50000,0,0
04023P,臺股指元富99售02,0,0,0,0,0,0,0,0,0,0,0,0,0,30000,30000,0,0
03978P,瑞儀元大93售01  ,0,0,0,0,0,0,0,0,0,0,0,0,0,100000,100000,0,0
03903P,美律永豐93售01  ,0,0,0,0,0,0,0,0,0,0,0,0,0,324000,324000,0,0
043190,宏達電元大93購01,0,0,0,0,0,0,0,0,0,0,0,0,0,1000,1000,0,0
04316P,華新科國票94售05,0,0,0,0,0,0,0,0,0,0,0,0,0,90000,90000,0,0
043054,智邦富邦92購01  ,0,0,0,0,0,0,0,0,0,0,0,0,0,6000,6000,0,0
043050,欣興國泰93購01  ,0,0,0,0,0,0,0,0,0,0,0,0,0,10000,10000,0,0
042557,中石化中信92購01,0,0,0,0,0,0,0,0,0,0,0,0,0,30000,30000,0,0
042513,大立光凱基91購02,0,0,0,0,0,0,0,0,0,0,0,0,0,10000,10000,0,0
04248P,臺股指永豐93售03,0,0,0,0,0,0,0,0,0,0,0,0,0,30000,30000,0,0
042501,台灣50凱基96購06,0,0,0,0,0,0,0,0,0,0,0,0,0,1000,1000,0,0
041920,可成群益92購01  ,0,0,0,0,0,0,0,0,0,0,0,0,0,10000,10000,0,0
041473,滬深2X群益93購01,0,0,0,0,0,0,0,0,0,0,0,0,0,10000,10000,0,0
04461P,燿華元富94售01  ,0,0,0,0,0,0,0,0,0,0,0,0,0,10000,10000,0,0
04464P,可成元富94售04  ,0,0,0,0,0,0,0,0,0,0,0,0,0,10000,10000,0,0
044675,廣宇凱基93購02  ,0,0,0,0,0,0,0,0,0,0,0,0,0,9000,9000,0,0
044691,緯穎凱基91購05  ,0,0,0,0,0,0,0,0,0,0,0,0,0,30000,30000,0,0
044692,鈺齊凱基91購01  ,0,0,0,0,0,0,0,0,0,0,0,0,0,20000,20000,0,0
044716,上銀麥證93購01  ,0,0,0,10000,10000,0,0,0,0,0,0,0,0,10000,10000,0,0
044537,上銀群益92購01  ,0,0,0,0,0,0,0,0,0,0,0,0,0,20000,20000,0,0
044395,台積電凱基91購16,0,0,0,0,0,0,0,0,0,0,0,0,0,10000,10000,0,0
044386,滬深2X日盛91購01,0,0,0,0,0,0,0,0,0,0,0,0,0,10000,10000,0,0
044425,友達國泰92購01  ,0,0,0,0,0,0,0,0,0,0,0,0,0,4000,4000,0,0
044329,日月光元富91購01,0,0,0,0,0,0,0,0,0,0,0,0,0,20000,20000,0,0
043285,聯發科元大92購01,0,0,0,0,0,0,0,0,0,0,0,0,0,3000,3000,0,0
043394,易華電元大94購01,0,0,0,0,0,0,0,0,0,0,0,0,0,20000,20000,0,0
043564,台積電凱基91購09,0,0,0,0,0,0,0,0,0,0,0,0,0,30000,30000,0,0
043496,台郡統一91購01  ,0,0,0,0,0,0,0,0,0,0,0,0,0,18000,18000,0,0
043489,大立光兆豐92購03,0,0,0,0,0,0,0,0,0,0,0,0,0,10000,10000,0,0
045042,亞泥凱基92購01  ,0,0,0,0,0,0,0,0,0,0,0,0,0,10000,10000,0,0
045044,台積電凱基92購01,0,0,0,0,0,0,0,0,0,0,0,0,0,50000,50000,0,0
045027,漢唐國票92購02  ,0,0,0,0,0,0,0,0,0,0,0,0,0,5000,5000,0,0
045007,台光電元大92購04,0,0,0,0,0,0,0,0,0,0,0,0,0,105000,105000,0,0
045115,玉晶光永豐94購01,0,0,0,0,0,0,0,0,0,0,0,0,0,11000,11000,0,0
045085,新日興元大92購01,0,0,0,0,0,0,0,0,0,0,0,0,0,26000,26000,0,0
045821,聯詠凱基92購06  ,0,0,0,0,0,0,0,0,0,0,0,0,0,10000,10000,0,0
045145,百和兆豐92購01  ,0,0,0,0,0,0,0,0,0,0,0,0,0,60000,60000,0,0
044937,瀚宇博元大91購02,0,0,0,0,0,0,0,0,0,0,0,0,0,6000,6000,0,0
044923,TPK永豐91購04   ,0,0,0,0,0,0,0,0,0,0,0,0,0,93000,93000,0,0
044897,台積電凱基91購26,0,0,0,0,0,0,0,0,0,0,0,0,0,20000,20000,0,0
04489P,大立光凱基94售03,0,0,0,0,0,0,0,0,0,0,0,0,0,2000,2000,0,0
044904,聯詠凱基91購04  ,0,0,0,0,0,0,0,0,0,0,0,0,0,10000,10000,0,0
044815,宏碁兆豐93購01  ,0,0,0,0,0,0,0,0,0,0,0,0,0,39000,39000,0,0
045202,力成凱基92購01  ,0,0,0,0,0,0,0,0,0,0,0,0,0,30000,30000,0,0
045424,友達凱基92購02  ,0,0,0,0,0,0,0,0,0,0,0,0,0,2000,2000,0,0
045426,TPK凱基93購02   ,0,0,0,0,0,0,0,0,0,0,0,0,0,8000,8000,0,0
045455,鴻海元大92購08  ,0,0,0,0,0,0,0,0,0,0,0,0,0,32000,32000,0,0
045442,南亞科元富92購02,0,0,0,0,0,0,0,0,0,0,0,0,0,30000,30000,0,0
045336,GIS日盛92購01   ,0,0,0,0,0,0,0,0,0,0,0,0,0,10000,10000,0,0
04537P,新光金統一94售01,0,0,0,0,0,0,0,0,0,0,0,0,0,10000,10000,0,0
045339,鴻海凱基92購06  ,0,0,0,0,0,0,0,0,0,0,0,0,0,6000,6000,0,0
045366,富邦金兆豐92購01,0,0,0,0,0,0,0,0,0,0,0,0,0,10000,10000,0,0
044011,鴻海凱基93購03  ,0,0,0,0,0,0,0,0,0,0,0,0,0,10000,10000,0,0
043943,聯詠兆豐91購01  ,0,0,0,0,0,0,0,0,0,0,0,0,0,30000,30000,0,0
043908,鴻海凱基93購02  ,0,0,0,0,0,0,0,0,0,0,0,0,0,11000,11000,0,0
043910,聯發科凱基91購09,0,0,0,0,0,0,0,0,0,0,0,0,0,10000,10000,0,0
045496,鴻海凱基92購07  ,0,0,0,0,0,0,0,0,0,0,0,0,0,8000,8000,0,0
045766,上証2X元富92購01,0,0,0,0,0,0,0,0,0,0,0,0,0,10000,10000,0,0
045749,智邦富邦93購01  ,0,0,0,0,0,0,0,0,0,0,0,0,0,30000,30000,0,0
043775,友達兆豐92購01  ,0,0,0,0,0,0,0,0,0,0,0,0,0,110000,110000,0,0
043781,鴻海麥證91購01  ,0,0,0,1000,0,1000,0,0,0,0,0,0,0,1000,1000,0,0
043786,台積電凱基91購13,0,0,0,0,0,0,0,0,0,0,0,0,0,20000,20000,0,0
043681,台積電凱基91購11,0,0,0,0,0,0,0,0,0,0,0,0,0,20000,20000,0,0
043707,臺股指永豐91購01,0,0,0,0,0,0,0,0,0,0,0,0,0,1000,1000,0,0
043731,泰鼎國泰92購01  ,0,0,0,0,0,0,0,0,0,0,0,0,0,10000,10000,0,0
046213,可成統一92購06  ,0,0,0,0,0,0,0,0,0,0,0,0,0,40000,40000,0,0
046225,南亞科元大92購05,0,0,0,0,0,0,0,0,0,0,0,0,0,6000,6000,0,0
046227,聯發科元大92購12,0,0,0,0,0,0,0,0,0,0,0,0,0,1000,1000,0,0
046231,創意元大92購07  ,0,0,0,0,0,0,0,0,0,0,0,0,0,2000,2000,0,0
046251,宏達電群益92購03,0,0,0,0,0,0,0,0,0,0,0,0,0,11000,11000,0,0
048198,大立光元大93購28,0,0,0,0,0,0,0,0,0,0,0,0,0,1000,1000,0,0
048199,大立光元大94購03,0,0,0,0,0,0,0,0,0,0,0,0,0,3000,3000,0,0
047780,友達中信96購01  ,0,0,0,0,0,0,0,0,0,0,0,0,0,2000,2000,0,0
048200,欣興元大93購07  ,0,0,0,0,0,0,0,0,0,0,0,0,0,1000,1000,0,0
048222,台積電凱基93購26,0,0,0,0,0,0,0,0,0,0,0,0,0,20000,20000,0,0
046322,群創元大92購08  ,0,0,0,0,0,0,0,0,0,0,0,0,0,3000,3000,0,0
046314,宏達電元大92購05,0,0,0,0,0,0,0,0,0,0,0,0,0,8000,8000,0,0
048343,大立光元大93購29,0,0,0,0,0,0,0,0,0,0,0,0,0,2000,2000,0,0
048339,友達元大95購01  ,0,0,0,0,0,0,0,0,0,0,0,0,0,21000,21000,0,0
048336,光磊元大93購02  ,0,0,0,0,0,0,0,0,0,0,0,0,0,70000,70000,0,0
048329,台積電永昌93購07,0,0,0,0,0,0,0,0,0,0,0,0,0,100000,100000,0,0
04891P,友達元大94售01  ,0,0,0,0,0,0,0,0,0,0,0,0,0,499000,499000,0,0
048894,光罩國泰94購01  ,0,0,0,0,0,0,0,0,0,0,0,0,0,20000,20000,0,0
048658,鴻海統一93購09  ,0,0,0,0,0,0,0,0,0,0,0,0,0,10000,10000,0,0
047113,聯發科元大93購12,0,0,0,0,0,0,0,0,0,0,0,0,0,4000,4000,0,0
04709P,台積電元大94售15,0,0,0,0,0,0,0,0,0,0,0,0,0,485000,485000,0,0
048867,台積電兆豐95購01,0,0,0,0,0,0,0,0,0,0,0,0,0,2000,2000,0,0
04706P,力山元大95售01  ,0,0,0,0,0,0,0,0,0,0,0,0,0,90000,90000,0,0
047066,力成凱基93購04  ,0,0,0,0,0,0,0,0,0,0,0,0,0,10000,10000,0,0
047083,大立光永豐93購01,0,0,0,0,0,0,0,0,0,0,0,0,0,12000,12000,0,0
048706,緯穎國票94購01  ,0,0,0,0,0,0,0,0,0,0,0,0,0,1000,1000,0,0
048820,台積電凱基94購06,0,0,0,0,0,0,0,0,0,0,0,0,0,38000,38000,0,0
048814,上銀凱基94購01  ,0,0,0,0,0,0,0,0,0,0,0,0,0,13000,13000,0,0
048712,樺漢台新94購01  ,0,0,0,0,0,0,0,0,0,0,0,0,0,10000,10000,0,0
048718,台光電永豐94購01,0,0,0,0,0,0,0,0,0,0,0,0,0,68000,68000,0,0
048784,台積電元大94購04,0,0,0,0,0,0,0,0,0,0,0,0,0,2000,2000,0,0
04893P,創意元大94售03  ,0,0,0,0,0,0,0,0,0,0,0,0,0,171000,171000,0,0
047179,台積電元大93購17,0,0,0,0,0,0,0,0,0,0,0,0,0,5000,5000,0,0
047124,華新中信93購01  ,0,0,0,0,0,0,0,0,0,0,0,0,0,20000,20000,0,0
047132,台積電凱基93購12,0,0,0,0,0,0,0,0,0,0,0,0,0,1000,1000,0,0
047134,聯發科凱基93購10,0,0,0,0,0,0,0,0,0,0,0,0,0,20000,20000,0,0
047135,可成凱基93購05  ,0,0,0,0,0,0,0,0,0,0,0,0,0,6000,6000,0,0
048092,聯發科凱基93購29,0,0,0,0,0,0,0,0,0,0,0,0,0,1000,1000,0,0
048980,嘉澤元大94購02  ,0,0,0,0,0,0,0,0,0,0,0,0,0,17000,17000,0,0
048969,兆赫元大94購01  ,0,0,0,0,0,0,0,0,0,0,0,0,0,1000,1000,0,0
048122,台達電元大96購02,0,0,0,0,0,0,0,0,0,0,0,0,0,1000,1000,0,0
048123,大立光元大93購27,0,0,0,0,0,0,0,0,0,0,0,0,0,3000,3000,0,0
048124,大立光元大95購03,0,0,0,0,0,0,0,0,0,0,0,0,0,1000,1000,0,0
048127,麗豐元大94購01  ,0,0,0,0,0,0,0,0,0,0,0,0,0,50000,50000,0,0
047480,全新凱基93購01  ,0,0,0,0,0,0,0,0,0,0,0,0,0,1000,1000,0,0
047520,鴻海元大93購17  ,0,0,0,0,0,0,0,0,0,0,0,0,0,10000,10000,0,0
047545,智邦凱基93購05  ,0,0,0,0,0,0,0,0,0,0,0,0,0,2000,2000,0,0
047524,瑞昱元大93購10  ,0,0,0,0,0,0,0,0,0,0,0,0,0,29000,29000,0,0
047207,晶技國泰94購01  ,0,0,0,0,0,0,0,0,0,0,0,0,0,78000,78000,0,0
047235,嘉澤凱基93購01  ,0,0,0,0,0,0,0,0,0,0,0,0,0,17000,17000,0,0
04724P,可成凱基94售08  ,0,0,0,0,0,0,0,0,0,0,0,0,0,7000,7000,0,0
047322,日月光元大93購04,0,0,0,0,0,0,0,0,0,0,0,0,0,18000,18000,0,0
047314,大立光元大93購22,0,0,0,0,0,0,0,0,0,0,0,0,0,3000,3000,0,0
047308,鴻海元大93購12  ,0,0,0,0,0,0,0,0,0,0,0,0,0,1000,1000,0,0
047309,鴻海元大93購13  ,0,0,0,0,0,0,0,0,0,0,0,0,0,20000,20000,0,0
047290,台積電元富93購04,0,0,0,0,0,0,0,0,0,0,0,0,0,50000,50000,0,0
047345,鴻海凱基94購06  ,0,0,0,0,0,0,0,0,0,0,0,0,0,5000,5000,0,0
047347,台積電凱基93購14,0,0,0,0,0,0,0,0,0,0,0,0,0,2000,2000,0,0
047548,友達凱基99購03  ,0,0,0,0,0,0,0,0,0,0,0,0,0,7000,7000,0,0
047550,聯發科凱基93購13,0,0,0,0,0,0,0,0,0,0,0,0,0,1000,1000,0,0
047601,上海銀中信93購01,0,0,0,0,0,0,0,0,0,0,0,0,0,108000,108000,0,0
047660,南茂麥證93購02  ,0,0,0,100000,100000,0,0,0,0,0,0,0,0,100000,100000,0,0
047611,滬深2X群益93購02,0,0,0,0,0,0,0,0,0,0,0,0,0,30000,30000,0,0
047615,為升凱基93購05  ,0,0,0,0,0,0,0,0,0,0,0,0,0,25000,25000,0,0
049920,大立光元大94購15,0,0,0,0,0,0,0,0,0,0,0,0,0,3000,3000,0,0
049319,GIS凱基94購03   ,0,0,0,0,0,0,0,0,0,0,0,0,0,12000,12000,0,0
049913,微星元大94購01  ,0,0,0,0,0,0,0,0,0,0,0,0,0,46000,46000,0,0
049914,瑞昱元大94購06  ,0,0,0,0,0,0,0,0,0,0,0,0,0,6000,6000,0,0
049915,瑞昱元大94購07  ,0,0,0,0,0,0,0,0,0,0,0,0,0,6000,6000,0,0
049905,為升元大94購05  ,0,0,0,0,0,0,0,0,0,0,0,0,0,37000,37000,0,0
049909,國巨元大95購01  ,0,0,0,0,0,0,0,0,0,0,0,0,0,39000,39000,0,0
049305,元油2X凱基95購06,0,0,0,0,0,0,0,0,0,0,0,0,0,1000,1000,0,0
049267,瀚宇博元大95購02,0,0,0,0,0,0,0,0,0,0,0,0,0,10000,10000,0,0
047723,廣宇群益94購01  ,0,0,0,0,0,0,0,0,0,0,0,0,0,13000,13000,0,0
047702,鴻海凱基94購13  ,0,0,0,0,0,0,0,0,0,0,0,0,0,16000,16000,0,0
04771P,友達元大96售02  ,0,0,0,0,0,0,0,0,0,0,0,0,0,499000,499000,0,0
047708,聯發科凱基93購17,0,0,0,0,0,0,0,0,0,0,0,0,0,10000,10000,0,0
049074,光罩凱基94購02  ,20000,50000,-30000,0,0,0,0,0,0,30000,0,0,0,56000,26000,30000,0
049083,大立光凱基94購02,0,0,0,0,0,0,0,0,0,0,0,0,0,10000,10000,0,0
048998,玉晶光國票95購03,0,0,0,0,0,0,0,0,0,0,0,0,0,5000,5000,0,0
049172,鴻海凱基94購14  ,0,0,0,0,0,0,0,0,0,0,0,0,0,2000,2000,0,0
049139,台積電元大94購06,0,0,0,0,0,0,0,0,0,0,0,0,0,18000,18000,0,0
049106,大立光富邦94購01,0,0,0,0,0,0,0,0,0,0,0,0,0,2000,2000,0,0
049257,南亞科元大94購03,0,0,0,0,0,0,0,0,0,0,0,0,0,22000,22000,0,0
049245,和鑫元富95購01  ,0,0,0,0,0,0,0,0,0,0,0,0,0,20000,20000,0,0
04920P,智易凱基94售05  ,0,0,0,0,0,0,0,0,0,0,0,0,0,49000,49000,0,0
049375,大立光元大94購13,0,0,0,0,0,0,0,0,0,0,0,0,0,3000,3000,0,0
045975,祥碩凱基93購04  ,0,0,0,0,0,0,0,0,0,0,0,0,0,10000,10000,0,0
045907,鴻海中信94購02  ,0,0,0,0,0,0,0,0,0,0,0,0,0,10000,10000,0,0
045898,康控元大93購04  ,0,0,0,0,0,0,0,0,0,0,0,0,0,59000,59000,0,0
045890,欣興元大92購06  ,0,0,0,0,0,0,0,0,0,0,0,0,0,150000,150000,0,0
046081,康舒凱基92購01  ,0,0,0,0,0,0,0,0,0,0,0,0,0,18000,18000,0,0
046067,富邦金凱基92購02,0,0,0,0,0,0,0,0,0,0,0,0,0,48000,48000,0,0
046078,致伸凱基92購04  ,0,0,0,0,0,0,0,0,0,0,0,0,0,20000,20000,0,0
046038,欣興元大92購07  ,0,0,0,0,0,0,0,0,0,0,0,0,0,14000,14000,0,0
046857,群創元大93購06  ,0,0,0,0,0,0,0,0,0,0,0,0,0,4000,4000,0,0
046889,燿華群益93購02  ,0,0,0,0,0,0,0,0,0,0,0,0,0,10000,10000,0,0
047998,美律元大93購06  ,0,0,0,0,0,0,0,0,0,0,0,0,0,10000,10000,0,0
046738,台積電群益93購05,0,0,0,0,0,0,0,0,0,0,0,0,0,4000,4000,0,0
046804,群創元大94購01  ,0,0,0,0,0,0,0,0,0,0,0,0,0,19000,19000,0,0
046805,TPK元大93購05   ,0,0,0,0,0,0,0,0,0,0,0,0,0,200000,200000,0,0
046758,聯發科凱基93購05,0,0,0,0,0,0,0,0,0,0,0,0,0,40000,40000,0,0
046759,聯發科凱基93購06,0,0,0,0,0,0,0,0,0,0,0,0,0,10000,10000,0,0
048028,聯發科凱基93購25,0,0,0,0,0,0,0,0,0,0,0,0,0,10000,10000,0,0
048029,聯發科凱基93購26,0,0,0,0,0,0,0,0,0,0,0,0,0,1000,1000,0,0
046942,友達元大99購01  ,0,0,0,0,0,0,0,0,0,0,0,0,0,36000,36000,0,0
046953,嘉聯益國票94購01,0,0,0,0,0,0,0,0,0,0,0,0,0,8000,8000,0,0
046968,台積電群益94購03,0,0,0,0,0,0,0,0,0,0,0,0,0,21000,21000,0,0
046117,強茂元大92購03  ,0,0,0,0,0,0,0,0,0,0,0,0,0,19000,19000,0,0
046182,燿華凱基93購04  ,0,0,0,0,0,0,0,0,0,0,0,0,0,20000,20000,0,0
048022,儒鴻凱基93購04  ,0,0,0,0,0,0,0,0,0,0,0,0,0,41000,41000,0,0
048024,鴻海凱基93購29  ,0,0,0,0,0,0,0,0,0,0,0,0,0,11000,11000,0,0
047392,大立光元大93購24,0,0,0,0,0,0,0,0,0,0,0,0,0,3000,3000,0,0
047382,鴻海元大93購15  ,0,0,0,0,0,0,0,0,0,0,0,0,0,1000,1000,0,0
047395,聯茂元大94購01  ,0,0,0,0,0,0,0,0,0,0,0,0,0,210000,210000,0,0
04697P,臺股指元富94售03,0,0,0,0,0,0,0,0,0,0,0,0,0,3000,3000,0,0
048086,鴻海凱基93購33  ,0,0,0,0,0,0,0,0,0,0,0,0,0,19000,19000,0,0
048057,宏達電國泰94購02,0,0,0,0,0,0,0,0,0,0,0,0,0,20000,20000,0,0
048058,大立光國泰95購01,0,0,0,0,0,0,0,0,0,0,0,0,0,2000,2000,0,0
046990,奇鋐凱基93購03  ,0,0,0,0,0,0,0,0,0,0,0,0,0,55000,55000,0,0
046984,友達日盛93購01  ,0,0,0,0,0,0,0,0,0,0,0,0,0,33000,33000,0,0
04700P,臺股指元富94售06,0,0,0,0,0,0,0,0,0,0,0,0,0,10000,10000,0,0
047018,鴻海元大93購09  ,0,0,0,0,0,0,0,0,0,0,0,0,0,4000,4000,0,0
04701P,臺股指元富94售07,0,0,0,0,0,0,0,0,0,0,0,0,0,1088000,1088000,0,0
047033,日月光中信95購01,0,0,0,0,0,0,0,0,0,0,0,0,0,20000,20000,0,0
047809,瑞昱凱基93購08  ,0,0,0,0,0,0,0,0,0,0,0,0,0,77000,77000,0,0
047856,GIS國票94購01   ,0,0,0,0,0,0,0,0,0,0,0,0,0,50000,50000,0,0
047847,鴻海統一93購07  ,0,0,0,0,0,0,0,0,0,0,0,0,0,10000,10000,0,0
048448,京元電凱基93購05,0,0,0,0,0,0,0,0,0,0,0,0,0,400000,400000,0,0
048384,遠東新國票94購01,0,0,0,0,0,0,0,0,0,0,0,0,0,160000,160000,0,0
048373,A50正2元富95購01,0,0,0,0,0,0,0,0,0,0,0,0,0,17000,17000,0,0
048414,滬深2X統一98購01,0,0,0,0,0,0,0,0,0,0,0,0,0,10000,10000,0,0
04840P,大立光元大94售18,0,0,0,0,0,0,0,0,0,0,0,0,0,100000,100000,0,0
048496,南亞科元大93購05,0,0,0,0,0,0,0,0,0,0,0,0,0,10000,10000,0,0
048488,大立光富邦93購05,0,0,0,0,0,0,0,0,0,0,0,0,0,2000,2000,0,0
048534,貿聯國票94購01  ,0,0,0,0,0,0,0,0,0,0,0,0,0,6000,6000,0,0
048531,大立光國票93購05,0,0,0,0,0,0,0,0,0,0,0,0,0,3000,3000,0,0
048633,台達電元大94購02,0,0,0,0,0,0,0,0,0,0,0,0,0,1000,1000,0,0
048551,鴻海元大94購02  ,0,0,0,0,0,0,0,0,0,0,0,0,0,3000,3000,0,0
046375,友達凱基98購01  ,0,0,0,0,0,0,0,0,0,0,0,0,0,4000,4000,0,0
046416,聯詠元大92購05  ,0,0,0,0,0,0,0,0,0,0,0,0,0,2000,2000,0,0
046408,宏達電元大92購06,0,0,0,0,0,0,0,0,0,0,0,0,0,105000,105000,0,0
046420,群創元大92購10  ,0,0,0,0,0,0,0,0,0,0,0,0,0,42000,42000,0,0
046421,群創元大92購11  ,0,0,0,0,0,0,0,0,0,0,0,0,0,42000,42000,0,0
046425,臻鼎元大92購12  ,0,0,0,0,0,0,0,0,0,0,0,0,0,5000,5000,0,0
046435,聯發科群益92購06,0,0,0,0,0,0,0,0,0,0,0,0,0,11000,11000,0,0
046450,鴻海凱基93購12  ,0,0,0,0,0,0,0,0,0,0,0,0,0,3000,3000,0,0
046448,亞德客凱基92購03,0,0,0,0,0,0,0,0,0,0,0,0,0,30000,30000,0,0
04658P,臺股指永昌94售02,0,0,0,0,0,0,0,0,0,0,0,0,0,10000,10000,0,0
046586,大立光元大92購26,0,0,0,0,0,0,0,0,0,0,0,0,0,3000,3000,0,0
046587,大立光元大92購27,0,0,0,0,0,0,0,0,0,0,0,0,0,3000,3000,0,0
046559,台積電凱基92購23,0,0,0,0,0,0,0,0,0,0,0,0,0,1000,1000,0,0
048609,京元電凱基93購07,0,0,0,0,0,0,0,0,0,0,0,0,0,1000,1000,0,0
046654,鴻海元大93購06  ,0,0,0,0,0,0,0,0,0,0,0,0,0,10000,10000,0,0
047970,鴻海富邦95購01  ,0,0,0,0,0,0,0,0,0,0,0,0,0,1000,1000,0,0
046686,上銀國票93購01  ,0,0,0,0,0,0,0,0,0,0,0,0,0,1000,1000,0,0
046667,晶技元大93購01  ,0,0,0,0,0,0,0,0,0,0,0,0,0,4000,4000,0,0
046668,嘉澤元大93購01  ,0,0,0,0,0,0,0,0,0,0,0,0,0,31000,31000,0,0
046705,台積電台新93購01,0,0,0,0,0,0,0,0,0,0,0,0,0,140000,140000,0,0
047938,台化國票93購01  ,0,0,0,0,0,0,0,0,0,0,0,0,0,22000,22000,0,0
046496,鴻海元大92購16  ,0,0,0,0,0,0,0,0,0,0,0,0,0,83000,83000,0,0
046489,大立光永昌92購01,0,0,0,0,0,0,0,0,0,0,0,0,0,3000,3000,0,0
046505,聯發科元大92購20,0,0,0,0,0,0,0,0,0,0,0,0,0,30000,30000,0,0
048568,緯穎元大93購06  ,0,0,0,0,0,0,0,0,0,0,0,0,0,18000,18000,0,0
046516,TPK元大92購03   ,0,0,0,0,0,0,0,0,0,0,0,0,0,13000,13000,0,0
046522,樺漢元大92購03  ,0,0,0,0,0,0,0,0,0,0,0,0,0,30000,30000,0,0
048610,華新科凱基94購04,0,0,0,0,0,0,0,0,0,0,0,0,0,30000,30000,0,0
048580,台達電富邦93購01,0,0,0,0,0,0,0,0,0,0,0,0,0,20000,20000,0,0
048581,南亞科富邦93購02,0,0,0,0,0,0,0,0,0,0,0,0,0,1000,1000,0,0
048575,旺宏國泰94購04  ,0,0,0,0,0,0,0,0,0,0,0,0,0,1000,1000,0,0
052039,聯詠永昌96購01  ,0,0,0,0,0,0,0,0,0,0,0,0,0,40000,40000,0,0
051955,寶成元富95購01  ,0,0,0,0,0,0,0,0,0,0,0,0,0,10000,10000,0,0
051926,聯電中信97購01  ,0,0,0,0,0,0,0,0,0,0,0,0,0,10000,10000,0,0
052094,瀚宇博元大96購02,0,0,0,0,0,0,0,0,0,0,0,0,0,8000,8000,0,0
052084,台泥元大95購01  ,0,0,0,0,0,0,0,0,0,0,0,0,0,6000,6000,0,0
052118,鴻海國票96購04  ,35000,0,35000,0,0,0,0,0,0,-35000,0,0,0,0,35000,-35000,0
052160,美律永豐95購03  ,0,0,0,0,0,0,0,0,0,0,0,0,0,6000,6000,0,0
052171,台積電元大95購21,0,0,0,0,0,0,0,0,0,0,0,0,0,152000,152000,0,0
052203,T50反1中信99購03,0,0,0,0,0,0,0,0,0,0,0,0,0,20000,20000,0,0
052198,鴻海統一95購10  ,0,0,0,0,0,0,0,0,0,0,0,0,0,48000,48000,0,0
052199,鴻海統一95購11  ,0,0,0,0,0,0,0,0,0,0,0,0,0,10000,10000,0,0
05219P,鴻海元大95售17  ,0,0,0,0,0,0,0,0,0,0,0,0,0,182000,182000,0,0
052196,TPK元富95購01   ,0,0,0,0,0,0,0,0,0,0,0,0,0,24000,24000,0,0
051663,鴻海元大95購18  ,0,0,0,0,0,0,0,0,0,0,0,0,0,203000,203000,0,0
051686,宏達電凱基95購04,0,0,0,0,0,0,0,0,0,0,0,0,0,6000,6000,0,0
05168P,鴻海元大95售14  ,0,0,0,0,0,0,0,0,0,0,0,0,0,373000,373000,0,0
05161P,華新科國票96售01,0,0,0,0,0,0,0,0,0,0,0,0,0,100000,100000,0,0
051578,智邦元大96購01  ,0,0,0,0,0,0,0,0,0,0,0,0,0,12000,12000,0,0
051574,鴻海元大96購06  ,0,0,0,0,0,0,0,0,0,0,0,0,0,284000,284000,0,0
051585,美食元大95購01  ,0,0,0,0,0,0,0,0,0,0,0,0,0,100000,100000,0,0
051730,為升國票96購02  ,0,0,0,0,0,0,0,0,0,0,0,0,0,10000,10000,0,0
051744,嘉聯益國票97購01,0,0,0,0,0,0,0,0,0,0,0,0,0,9000,9000,0,0
051757,佳世達元大95購02,0,0,0,0,0,0,0,0,0,0,0,0,0,12000,12000,0,0
051754,廣宇元大95購01  ,0,0,0,0,0,0,0,0,0,0,0,0,0,5000,5000,0,0
05145P,道瓊反元大98售01,0,0,0,0,0,0,0,0,0,0,0,0,0,99000,99000,0,0
051469,友達日盛9B購01  ,0,0,0,0,0,0,0,0,0,0,0,0,0,1000,1000,0,0
051441,鴻海元大95購13  ,0,0,0,0,0,0,0,0,0,0,0,0,0,264000,264000,0,0
051504,TPK統一95購01   ,0,0,0,0,0,0,0,0,0,0,0,0,0,59000,59000,0,0
051344,鴻海元大95購08  ,0,0,0,0,0,0,0,0,0,0,0,0,0,397000,397000,0,0
051352,南亞科元大95購02,0,0,0,0,0,0,0,0,0,0,0,0,0,13000,13000,0,0
051261,鴻海永昌96購05  ,0,0,0,0,0,0,0,0,0,0,0,0,0,293000,293000,0,0
051309,卜蜂麥證95購01  ,0,0,0,3000,3000,0,0,0,0,0,0,0,0,3000,3000,0,0
051097,嘉聯益元大96購02,0,0,0,0,0,0,0,0,0,0,0,0,0,25000,25000,0,0
051086,鴻海元大96購04  ,0,0,0,0,0,0,0,0,0,0,0,0,0,273000,273000,0,0
051090,光磊元大96購01  ,0,0,0,0,0,0,0,0,0,0,0,0,0,27000,27000,0,0
051219,大立光元富95購07,0,0,0,0,0,0,0,0,0,0,0,0,0,14000,14000,0,0
05121P,創意國泰96售01  ,0,0,0,0,0,0,0,0,0,0,0,0,0,16000,16000,0,0
051236,鴻海元大96購05  ,0,0,0,0,0,0,0,0,0,0,0,0,0,248000,248000,0,0
051180,喬山永豐95購03  ,0,0,0,0,0,0,0,0,0,0,0,0,0,5000,5000,0,0
051166,可成元大95購02  ,0,0,0,0,0,0,0,0,0,0,0,0,0,10000,10000,0,0
051169,瀚宇博元大95購05,0,0,0,0,0,0,0,0,0,0,0,0,0,10000,10000,0,0
051159,力山元大96購01  ,0,0,0,0,0,0,0,0,0,0,0,0,0,25000,25000,0,0
050999,瀚宇博元大95購04,0,0,0,0,0,0,0,0,0,0,0,0,0,13000,13000,0,0
051016,京元電凱基95購03,0,0,0,0,0,0,0,0,0,0,0,0,0,1000,1000,0,0
051061,中磊群益95購01  ,0,0,0,0,0,0,0,0,0,0,0,0,0,3000,3000,0,0
050969,台郡永豐95購01  ,0,0,0,0,0,0,0,0,0,0,0,0,0,102000,102000,0,0
049987,智易凱基94購03  ,0,0,0,0,0,0,0,0,0,0,0,0,0,17000,17000,0,0
050020,為升元大94購06  ,0,0,0,0,0,0,0,0,0,0,0,0,0,15000,15000,0,0
050034,智伸科元大94購01,0,0,0,0,0,0,0,0,0,0,0,0,0,12000,12000,0,0
049764,TPK國泰95購01   ,0,0,0,0,0,0,0,0,0,0,0,0,0,10000,10000,0,0
049800,瑞昱元大94購05  ,0,0,0,0,0,0,0,0,0,0,0,0,0,25000,25000,0,0
049802,可成元大94購10  ,0,0,0,0,0,0,0,0,0,0,0,0,0,10000,10000,0,0
049826,光磊凱基94購02  ,0,0,0,0,0,0,0,0,0,0,0,0,0,50000,50000,0,0
049845,台積電麥證94購01,0,0,0,20000,20000,0,0,0,0,0,0,0,0,20000,20000,0,0
05011P,南電國泰96售01  ,0,0,0,0,0,0,0,0,0,0,0,0,0,60000,60000,0,0
050102,鴻海富邦95購04  ,0,0,0,0,0,0,0,0,0,0,0,0,0,1000,1000,0,0
050103,群創富邦94購01  ,0,0,0,0,0,0,0,0,0,0,0,0,0,10000,10000,0,0
050085,國泰金元富94購01,0,0,0,0,0,0,0,0,0,0,0,0,0,18000,18000,0,0
050092,鴻海永豐94購04  ,0,0,0,0,0,0,0,0,0,0,0,0,0,49000,49000,0,0
050063,聯發科凱基94購09,0,0,0,0,0,0,0,0,0,0,0,0,0,23000,23000,0,0
050071,明泰凱基94購01  ,0,0,0,0,0,0,0,0,0,0,0,0,0,50000,50000,0,0
049530,上銀台新94購01  ,0,0,0,0,0,0,0,0,0,0,0,0,0,2000,2000,0,0
049528,台積電中信94購01,0,0,0,0,0,0,0,0,0,0,0,0,0,20000,20000,0,0
049535,臻鼎永豐94購01  ,0,0,0,0,0,0,0,0,0,0,0,0,0,10000,10000,0,0
04956P,臺股指日盛94售02,0,0,0,0,0,0,0,0,0,0,0,0,0,70000,70000,0,0
049436,義隆國泰96購02  ,0,0,0,0,0,0,0,0,0,0,0,0,0,1000,1000,0,0
049419,欣興凱基94購04  ,0,0,0,0,0,0,0,0,0,0,0,0,0,1000,1000,0,0
049455,上海銀統一94購02,0,0,0,0,0,0,0,0,0,0,0,0,0,4000,4000,0,0
049481,為升元大94購03  ,0,0,0,0,0,0,0,0,0,0,0,0,0,30000,30000,0,0
049706,世紀鋼元大95購02,0,0,0,0,0,0,0,0,0,0,0,0,0,21000,21000,0,0
049720,欣興凱基94購05  ,0,0,0,0,0,0,0,0,0,0,0,0,0,1000,1000,0,0
04958P,和大凱基94售04  ,0,0,0,0,0,0,0,0,0,0,0,0,0,10000,10000,0,0
050628,美律中信94購02  ,0,0,0,0,0,0,0,0,0,0,0,0,0,20000,20000,0,0
050610,鴻海元大94購24  ,0,0,0,0,0,0,0,0,0,0,0,0,0,278000,278000,0,0
050607,為升元大94購10  ,0,0,0,0,0,0,0,0,0,0,0,0,0,15000,15000,0,0
050618,緯創元大95購01  ,0,0,0,0,0,0,0,0,0,0,0,0,0,16000,16000,0,0
050692,鴻海凱基96購04  ,0,0,0,0,0,0,0,0,0,0,0,0,0,41000,41000,0,0
050704,復盛凱基94購03  ,0,0,0,0,0,0,0,0,0,0,0,0,0,26000,26000,0,0
050682,南亞科元富94購02,0,0,0,0,0,0,0,0,0,0,0,0,0,20000,20000,0,0
050763,楠梓電元大94購03,0,0,0,0,0,0,0,0,0,0,0,0,0,40000,40000,0,0
050809,鴻海凱基95購08  ,0,0,0,0,0,0,0,0,0,0,0,0,0,19000,19000,0,0
050794,大立光富邦96購04,0,0,0,0,0,0,0,0,0,0,0,0,0,11000,11000,0,0
050897,嘉晶元大95購03  ,0,0,0,0,0,0,0,0,0,0,0,0,0,3000,3000,0,0
050861,鴻海永豐95購01  ,0,0,0,0,0,0,0,0,0,0,0,0,0,80000,80000,0,0
05082P,健策永豐95售02  ,0,0,0,0,0,0,0,0,0,0,0,0,0,10000,10000,0,0
050419,鴻海凱基95購02  ,0,0,0,0,0,0,0,0,0,0,0,0,0,26000,26000,0,0
050420,鴻海凱基95購03  ,0,0,0,0,0,0,0,0,0,0,0,0,0,14000,14000,0,0
050421,鴻海凱基95購04  ,0,0,0,0,0,0,0,0,0,0,0,0,0,14000,14000,0,0
050461,GIS元大95購04   ,0,0,0,0,0,0,0,0,0,0,0,0,0,2000,2000,0,0
050432,聯發科凱基94購19,0,0,0,0,0,0,0,0,0,0,0,0,0,94000,94000,0,0
050537,鴻海凱基95購05  ,0,0,0,0,0,0,0,0,0,0,0,0,0,21000,21000,0,0
050544,聯發科凱基95購02,0,0,0,0,0,0,0,0,0,0,0,0,0,83000,83000,0,0
050528,瑞儀元大94購02  ,0,0,0,0,0,0,0,0,0,0,0,0,0,172000,172000,0,0
050512,台泥元大94購01  ,0,0,0,0,0,0,0,0,0,0,0,0,0,6000,6000,0,0
050493,聯發科永昌96購01,0,0,0,0,0,0,0,0,0,0,0,0,0,15000,15000,0,0
050311,上銀兆豐95購01  ,0,0,0,0,0,0,0,0,0,0,0,0,0,3000,3000,0,0
050367,鴻海元大94購20  ,0,0,0,0,0,0,0,0,0,0,0,0,0,274000,274000,0,0
050348,鴻海群益94購06  ,0,0,0,0,0,0,0,0,0,0,0,0,0,11000,11000,0,0
050257,為升元大94購07  ,0,0,0,0,0,0,0,0,0,0,0,0,0,15000,15000,0,0
050270,景碩元大94購01  ,0,0,0,0,0,0,0,0,0,0,0,0,0,1000,1000,0,0
050286,為升凱基94購05  ,0,0,0,0,0,0,0,0,0,0,0,0,0,32000,32000,0,0
08475P,臺股指凱基9C售13,0,0,0,0,0,0,0,0,0,0,0,0,0,10000,10000,0,0
06110P,國巨國泰98售02  ,0,0,0,0,0,0,0,0,0,0,0,0,0,100000,100000,0,0
05583P,訊芯凱基96售01  ,0,0,0,0,0,0,0,0,0,0,0,0,0,300000,300000,0,0
05602P,國巨元大96售06  ,0,0,0,0,0,0,0,0,0,0,0,0,0,16000,16000,0,0
05868P,台積電凱基96售17,0,0,0,0,0,0,0,0,0,0,0,0,0,21000,21000,0,0
05852P,嘉晶群益96售01  ,0,0,0,0,0,0,0,0,0,0,0,0,0,60000,60000,0,0
05842P,台積電元大96售15,0,0,0,0,0,0,0,0,0,0,0,0,0,300000,300000,0,0
2468,華經            ,2000,2000,0,0,0,0,0,0,0,0,0,0,0,0,0,0,0
2516,新建            ,1000,1000,0,0,0,0,0,0,0,0,0,0,0,0,0,0,0
4927,泰鼎-KY         ,200000,169000,31000,0,0,0,20000,0,20000,-51000,40000,1000,39000,26000,116000,-90000,0
3528,安馳            ,1000,1000,0,0,0,0,0,0,0,0,0,0,0,0,0,0,0
3557,嘉威            ,11000,11000,0,0,0,0,0,0,0,0,0,0,0,0,0,0,0
3296,勝德            ,1000,1000,0,0,0,0,0,0,0,0,0,0,0,0,0,0,0
3229,晟鈦            ,1000,1000,0,0,0,0,0,0,0,0,0,0,0,0,0,0,0
3058,立德            ,5000,5000,0,0,0,0,0,0,0,0,0,0,0,0,0,0,0
6205,詮欣            ,2000,2000,0,0,0,0,0,0,0,0,0,0,0,0,0,0,0
6581,鋼聯            ,3000,3000,0,0,0,0,0,0,0,0,0,0,0,0,0,0,0
9944,新麗            ,4000,4000,0,0,0,0,0,0,0,0,0,0,0,0,0,0,0
8442,威宏-KY         ,2000,2000,0,0,0,0,0,0,0,0,0,0,0,0,0,0,0
911616,杜康-DR         ,6000,6000,0,0,0,0,0,0,0,0,0,0,0,0,0,0,0
052997,國巨康和96購01  ,0,0,0,0,0,0,0,0,0,-1000,0,0,0,4000,5000,-1000,-1000
053163,上証2X群益9A購02,0,0,0,0,0,0,0,0,0,-1000,0,0,0,0,1000,-1000,-1000
053236,群創永豐97購02  ,0,0,0,0,0,0,0,0,0,-1000,0,0,0,3000,4000,-1000,-1000
053239,崇越永豐96購01  ,0,0,0,0,0,0,0,0,0,-1000,0,0,0,0,1000,-1000,-1000
053552,華新科凱基96購08,0,0,0,0,0,0,0,0,0,-1000,0,0,0,20000,21000,-1000,-1000
053534,微星永豐96購02  ,0,0,0,0,0,0,0,0,0,-1000,0,0,0,34000,35000,-1000,-1000
05349P,可成元富98售03  ,0,0,0,0,0,0,0,0,0,-1000,0,0,0,1000,2000,-1000,-1000
053471,正崴元大96購01  ,0,0,0,0,0,0,0,0,0,-1000,0,0,0,2000,3000,-1000,-1000
053435,新光金日盛96購01,0,0,0,0,0,0,0,0,0,-1000,0,0,0,0,1000,-1000,-1000
05330P,臺股指凱基95售14,0,0,0,0,0,0,0,0,0,-1000,0,0,0,5000,6000,-1000,-1000
053258,上証2X群益9A購03,0,0,0,0,0,0,0,0,0,-1000,0,0,0,0,1000,-1000,-1000
052230,大立光凱基96購09,0,0,0,0,0,0,0,0,0,-1000,0,0,0,1000,2000,-1000,-1000
052364,全新國票95購02  ,0,0,0,0,0,0,0,0,0,-1000,0,0,0,7000,8000,-1000,-1000
052399,台光電凱基95購03,0,0,0,0,0,0,0,0,0,-1000,0,0,0,4000,5000,-1000,-1000
052491,泰碩國票99購01  ,0,0,0,0,0,0,0,0,0,-1000,0,0,0,3000,4000,-1000,-1000
052462,上銀統一95購03  ,0,0,0,0,0,0,0,0,0,-1000,0,0,0,8000,9000,-1000,-1000
052840,友達富邦96購01  ,0,0,0,0,0,0,0,0,0,-1000,0,0,0,0,1000,-1000,-1000
052877,矽創凱基96購01  ,0,0,0,0,0,0,0,0,0,-1000,0,0,0,0,1000,-1000,-1000
052718,新唐凱基96購01  ,0,0,0,0,0,0,0,0,0,-1000,0,0,0,0,1000,-1000,-1000
054032,上銀中信96購01  ,0,0,0,0,0,0,0,0,0,-1000,0,0,0,0,1000,-1000,-1000
054148,矽創元大96購03  ,0,0,0,0,0,0,0,0,0,-1000,0,0,0,0,1000,-1000,-1000
054096,佳世達國票97購01,0,0,0,0,0,0,0,0,0,-1000,0,0,0,5000,6000,-1000,-1000
053709,台達電凱基96購04,0,0,0,0,0,0,0,0,0,-1000,0,0,0,0,1000,-1000,-1000
053745,康友國票97購01  ,0,0,0,0,0,0,0,0,0,-1000,0,0,0,9000,10000,-1000,-1000
053668,鴻海統一97購01  ,0,0,0,0,0,0,0,0,0,-1000,0,0,0,0,1000,-1000,-1000
053683,上証2X元大96購03,0,0,0,0,0,0,0,0,0,-1000,0,0,0,0,1000,-1000,-1000
053780,南亞科元大96購03,0,0,0,0,0,0,0,0,0,-1000,0,0,0,26000,27000,-1000,-1000
053805,奇鋐凱基98購02  ,0,0,0,0,0,0,0,0,0,-1000,0,0,0,0,1000,-1000,-1000
053834,卜蜂永豐96購01  ,0,0,0,0,0,0,0,0,0,-1000,0,0,0,0,1000,-1000,-1000
053867,創意元大96購04  ,0,0,0,0,0,0,0,0,0,-1000,0,0,0,19000,20000,-1000,-1000
054788,華新科群益98購02,0,0,0,0,0,0,0,0,0,-1000,0,0,0,0,1000,-1000,-1000
05478P,智伸科國票96售02,0,0,0,0,0,0,0,0,0,-1000,0,0,0,0,1000,-1000,-1000
054808,東元元大9A購01  ,0,0,0,0,0,0,0,0,0,-1000,0,0,0,0,1000,-1000,-1000
054815,台積電元大97購14,0,0,0,0,0,0,0,0,0,-1000,0,0,0,160000,161000,-1000,-1000
054816,聯發科元大97購12,0,0,0,0,0,0,0,0,0,-1000,0,0,0,3000,4000,-1000,-1000
05553P,智原群益96售01  ,0,0,0,0,0,0,0,0,0,-1000,0,0,0,0,1000,-1000,-1000
05454P,奇鋐群益95售04  ,0,0,0,0,0,0,0,0,0,-1000,0,0,0,15000,16000,-1000,-1000
054555,欣興凱基98購01  ,0,0,0,0,0,0,0,0,0,-1000,0,0,0,0,1000,-1000,-1000
054544,統一中信97購01  ,0,0,0,0,0,0,0,0,0,-1000,0,0,0,0,1000,-1000,-1000
054217,台表科國票97購05,0,0,0,0,0,0,0,0,0,-1000,0,0,0,21000,22000,-1000,-1000
05421P,鴻海元大96售12  ,0,0,0,0,0,0,0,0,0,-1000,0,0,0,353000,354000,-1000,-1000
054223,大立光統一98購04,0,0,0,0,0,0,0,0,0,-1000,0,0,0,0,1000,-1000,-1000
054279,揚明光群益98購01,0,0,0,0,0,0,0,0,0,-1000,0,0,0,0,1000,-1000,-1000
05451P,臺股指元大95售28,0,0,0,0,0,0,0,0,0,-1000,0,0,0,7000,8000,-1000,-1000
054417,牧德元大96購01  ,0,0,0,0,0,0,0,0,0,-1000,0,0,0,11000,12000,-1000,-1000
04825P,元大金中信94售01,0,0,0,0,0,0,0,0,0,-1000,0,0,0,0,1000,-1000,-1000
048247,聯發科兆豐93購03,0,0,0,0,0,0,0,0,0,-1000,0,0,0,0,1000,-1000,-1000
046301,亞泥元大92購02  ,0,0,0,0,0,0,0,0,0,-1000,0,0,0,0,1000,-1000,-1000
047766,聯發科元大93購19,0,0,0,0,0,0,0,0,0,-1000,0,0,0,0,1000,-1000,-1000
046269,禾伸堂凱基92購03,0,0,0,0,0,0,0,0,0,-1000,0,0,0,0,1000,-1000,-1000
045799,微星亞東93購01  ,0,0,0,0,0,0,0,0,0,-1000,0,0,0,0,1000,-1000,-1000
043892,矽創元大92購01  ,0,0,0,0,0,0,0,0,0,-1000,0,0,0,0,1000,-1000,-1000
043929,燿華永豐91購01  ,0,0,0,0,0,0,0,0,0,-1000,0,0,0,0,1000,-1000,-1000
044002,聯發科兆豐91購02,0,0,0,0,0,0,0,0,0,-1000,0,0,0,0,1000,-1000,-1000
045361,鈺齊凱基93購01  ,0,0,0,0,0,0,0,0,0,-1000,0,0,0,10000,11000,-1000,-1000
045458,智邦元大92購05  ,0,0,0,0,0,0,0,0,0,-1000,0,0,0,0,1000,-1000,-1000
045452,儒鴻元大92購03  ,0,0,0,0,0,0,0,0,0,-1000,0,0,0,0,1000,-1000,-1000
045296,台積電元大93購03,0,0,0,0,0,0,0,0,0,-1000,0,0,0,0,1000,-1000,-1000
044822,南電兆豐93購01  ,0,0,0,0,0,0,0,0,0,-1000,0,0,0,0,1000,-1000,-1000
045149,聯發科凱基93購02,0,0,0,0,0,0,0,0,0,-1000,0,0,0,0,1000,-1000,-1000
045132,聯詠統一92購01  ,0,0,0,0,0,0,0,0,0,-1000,0,0,0,0,1000,-1000,-1000
045018,矽創元大93購01  ,0,0,0,0,0,0,0,0,0,-1000,0,0,0,0,1000,-1000,-1000
045024,宏達電兆豐93購01,0,0,0,0,0,0,0,0,0,-1000,0,0,0,0,1000,-1000,-1000
043628,南亞科凱基91購03,0,0,0,0,0,0,0,0,0,-1000,0,0,0,10000,11000,-1000,-1000
044379,A50正2群益92購01,0,0,0,0,0,0,0,0,0,-1000,0,0,0,0,1000,-1000,-1000
044482,訊芯統一91購01  ,0,0,0,0,0,0,0,0,0,-1000,0,0,0,0,1000,-1000,-1000
04468P,元油2X元大94售04,0,0,0,0,0,0,0,0,0,-1000,0,0,0,0,1000,-1000,-1000
04103P,臺股指國票93售10,0,0,0,0,0,0,0,0,0,-1000,0,0,0,0,1000,-1000,-1000
042542,台灣50元大93購14,0,0,0,0,0,0,0,0,0,-1000,0,0,0,0,1000,-1000,-1000
040498,滬深2X國票92購01,0,0,0,0,0,0,0,0,0,-1000,0,0,0,0,1000,-1000,-1000
03260P,技嘉凱基02售01  ,0,0,0,0,0,0,0,0,0,-1000,0,0,0,0,1000,-1000,-1000
03834P,漢唐群益93售03  ,0,0,0,0,0,0,0,0,0,-1000,0,0,0,0,1000,-1000,-1000
020007,凱基臺灣500N    ,0,0,0,0,0,0,0,0,0,-1000,0,0,0,0,1000,-1000,-1000
03071X,元展66          ,0,0,0,0,0,0,0,0,0,-1000,0,0,0,0,1000,-1000,-1000
03064P,台灣50群益01售14,0,0,0,0,0,0,0,0,0,-1000,0,0,0,0,1000,-1000,-1000
03602P,大立光凱基92售10,0,0,0,0,0,0,0,0,0,-1000,0,0,0,0,1000,-1000,-1000
00703,台新MSCI中國    ,0,0,0,0,0,0,0,0,0,-1000,0,0,0,194000,195000,-1000,-1000
00707R,元大S&P日圓反1  ,0,0,0,0,0,0,0,0,0,-1000,0,0,0,41000,42000,-1000,-1000
048574,台積電國泰95購02,0,0,0,0,0,0,0,0,0,-1000,0,0,0,0,1000,-1000,-1000
048605,百和國票93購02  ,0,0,0,0,0,0,0,0,0,-1000,0,0,0,0,1000,-1000,-1000
047931,日月光凱基93購01,0,0,0,0,0,0,0,0,0,-1000,0,0,0,20000,21000,-1000,-1000
047904,臺指反元大96購01,0,0,0,0,0,0,0,0,0,-1000,0,0,0,0,1000,-1000,-1000
046677,矽創元大93購03  ,0,0,0,0,0,0,0,0,0,-1000,0,0,0,0,1000,-1000,-1000
046609,深中小國票93購01,0,0,0,0,0,0,0,0,0,-1000,0,0,0,9000,10000,-1000,-1000
048431,瑞昱國票94購01  ,0,0,0,0,0,0,0,0,0,-1000,0,0,0,0,1000,-1000,-1000
04634P,臺股指群益94售09,0,0,0,0,0,0,0,0,0,-1000,0,0,0,0,1000,-1000,-1000
047796,臺股指群益93購07,0,0,0,0,0,0,0,0,0,-1000,0,0,0,0,1000,-1000,-1000
04779P,大立光凱基94售10,0,0,0,0,0,0,0,0,0,-1000,0,0,0,0,1000,-1000,-1000
047043,廣越群益93購01  ,0,0,0,0,0,0,0,0,0,-1000,0,0,0,0,1000,-1000,-1000
047014,元油反元大99購01,0,0,0,0,0,0,0,0,0,-1000,0,0,0,150000,151000,-1000,-1000
046988,南亞科凱基93購02,0,0,0,0,0,0,0,0,0,-1000,0,0,0,0,1000,-1000,-1000
048054,鴻海國泰95購01  ,0,0,0,0,0,0,0,0,0,-1000,0,0,0,0,1000,-1000,-1000
046190,宏盛凱基92購01  ,0,0,0,0,0,0,0,0,0,-1000,0,0,0,4000,5000,-1000,-1000
046178,聯發科日盛92購01,0,0,0,0,0,0,0,0,0,-1000,0,0,0,0,1000,-1000,-1000
046131,矽創元大92購03  ,0,0,0,0,0,0,0,0,0,-1000,0,0,0,0,1000,-1000,-1000
046958,鴻海中信93購01  ,0,0,0,0,0,0,0,0,0,-1000,0,0,0,19000,20000,-1000,-1000
046888,鴻海群益93購05  ,0,0,0,0,0,0,0,0,0,-1000,0,0,0,72000,73000,-1000,-1000
046025,台積電元大92購18,0,0,0,0,0,0,0,0,0,-1000,0,0,0,0,1000,-1000,-1000
049140,台積電元大94購07,0,0,0,0,0,0,0,0,0,-1000,0,0,0,0,1000,-1000,-1000
049165,元油2X凱基97購01,0,0,0,0,0,0,0,0,0,-1000,0,0,0,0,1000,-1000,-1000
049084,欣興凱基94購03  ,0,0,0,0,0,0,0,0,0,-1000,0,0,0,4000,5000,-1000,-1000
049068,元油2X凱基95購03,0,0,0,0,0,0,0,0,0,-1000,0,0,0,5000,6000,-1000,-1000
049072,台積電凱基94購08,0,0,0,0,0,0,0,0,0,-1000,0,0,0,10000,11000,-1000,-1000
049900,台積電元富94購06,0,0,0,0,0,0,0,0,0,-1000,0,0,0,0,1000,-1000,-1000
047330,康舒元大93購01  ,0,0,0,0,0,0,0,0,0,-1000,0,0,0,0,1000,-1000,-1000
047319,晶技元大93購02  ,0,0,0,0,0,0,0,0,0,-1000,0,0,0,3000,4000,-1000,-1000
048097,聯詠凱基93購07  ,0,0,0,0,0,0,0,0,0,-1000,0,0,0,10000,11000,-1000,-1000
047189,聯詠元大93購05  ,0,0,0,0,0,0,0,0,0,-1000,0,0,0,3000,4000,-1000,-1000
048852,旺宏群益96購02  ,0,0,0,0,0,0,0,0,0,-1000,0,0,0,0,1000,-1000,-1000
047112,聯發科元大93購11,0,0,0,0,0,0,0,0,0,-1000,0,0,0,1000,2000,-1000,-1000
048655,A50正2元富96購01,0,0,0,0,0,0,0,0,0,-1000,0,0,0,0,1000,-1000,-1000
048895,光罩國泰95購01  ,0,0,0,0,0,0,0,0,0,-1000,0,0,0,9000,10000,-1000,-1000
050375,矽創元大94購02  ,0,0,0,0,0,0,0,0,0,-1000,0,0,0,0,1000,-1000,-1000
050299,康普凱基94購01  ,0,0,0,0,0,0,0,0,0,-1000,0,0,0,0,1000,-1000,-1000
050301,矽創凱基94購03  ,0,0,0,0,0,0,0,0,0,-1000,0,0,0,0,1000,-1000,-1000
050513,亞泥元大94購02  ,0,0,0,0,0,0,0,0,0,-1000,0,0,0,38000,39000,-1000,-1000
050423,鴻海凱基96購02  ,0,0,0,0,0,0,0,0,0,-1000,0,0,0,18000,19000,-1000,-1000
050724,國巨國票96購01  ,0,0,0,0,0,0,0,0,0,-1000,0,0,0,4000,5000,-1000,-1000
050566,高股息中信97購02,0,0,0,0,0,0,0,0,0,-1000,0,0,0,0,1000,-1000,-1000
049770,康控元富95購01  ,0,0,0,0,0,0,0,0,0,-1000,0,0,0,29000,30000,-1000,-1000
049466,創意台新94購01  ,0,0,0,0,0,0,0,0,0,-1000,0,0,0,17000,18000,-1000,-1000
049551,電子類群益94購01,0,0,0,0,0,0,0,0,0,-1000,0,0,0,1000,2000,-1000,-1000
049526,緯穎兆豐95購01  ,0,0,0,0,0,0,0,0,0,-1000,0,0,0,6000,7000,-1000,-1000
050177,聯發科元大94購11,0,0,0,0,0,0,0,0,0,-1000,0,0,0,1000,2000,-1000,-1000
050197,矽格元大94購04  ,0,0,0,0,0,0,0,0,0,-1000,0,0,0,19000,20000,-1000,-1000
049836,矽創凱基94購02  ,0,0,0,0,0,0,0,0,0,-1000,0,0,0,0,1000,-1000,-1000
050984,大立光國泰97購01,0,0,0,0,0,0,0,0,0,-1000,0,0,0,3000,4000,-1000,-1000
050917,瀚宇博兆豐96購01,0,0,0,0,0,0,0,0,0,-1000,0,0,0,0,1000,-1000,-1000
051147,南亞科凱基95購05,0,0,0,0,0,0,0,0,0,-1000,0,0,0,0,1000,-1000,-1000
051502,南茂群益95購01  ,0,0,0,0,0,0,0,0,0,-1000,0,0,0,0,1000,-1000,-1000
051521,大立光凱基96購07,0,0,0,0,0,0,0,0,0,-1000,0,0,0,0,1000,-1000,-1000
051452,貿聯元大95購04  ,0,0,0,0,0,0,0,0,0,-1000,0,0,0,78000,79000,-1000,-1000
051813,GIS凱基96購02   ,0,0,0,0,0,0,0,0,0,-1000,0,0,0,2000,3000,-1000,-1000
051561,玉晶光國泰97購04,0,0,0,0,0,0,0,0,0,-1000,0,0,0,0,1000,-1000,-1000
051649,中磊永豐95購02  ,0,0,0,0,0,0,0,0,0,-1000,0,0,0,0,1000,-1000,-1000
052031,臺股指群益95購04,0,0,0,0,0,0,0,0,0,-1000,0,0,0,0,1000,-1000,-1000
051986,燿華元大96購04  ,0,0,0,0,0,0,0,0,0,-1000,0,0,0,0,1000,-1000,-1000
6668,中揚光          ,109000,88000,21000,0,0,0,0,0,0,-22000,0,20000,-20000,0,2000,-2000,-1000
6189,豐藝            ,7000,8000,-1000,0,0,0,0,0,0,0,0,0,0,0,0,0,-1000
6215,和椿            ,1000,2000,-1000,0,0,0,0,0,0,0,0,0,0,0,0,0,-1000
6183,關貿            ,4000,5000,-1000,0,0,0,0,0,0,0,0,0,0,0,0,0,-1000
6115,鎰勝            ,0,1000,-1000,0,0,0,0,0,0,0,0,0,0,0,0,0,-1000
3130,一零四          ,3000,4000,-1000,0,0,0,0,0,0,0,0,0,0,0,0,0,-1000
3032,偉訓            ,12000,13000,-1000,0,0,0,0,0,0,0,0,0,0,0,0,0,-1000
3040,遠見            ,0,1000,-1000,0,0,0,0,0,0,0,0,0,0,0,0,0,-1000
3046,建碁            ,0,1000,-1000,0,0,0,0,0,0,0,0,0,0,0,0,0,-1000
4106,雃博            ,1000,2000,-1000,0,0,0,0,0,0,0,0,0,0,0,0,0,-1000
4720,德淵            ,0,2000,-2000,0,0,0,0,0,0,1000,1000,0,1000,0,0,0,-1000
4989,榮科            ,11000,12000,-1000,0,0,0,0,0,0,0,0,0,0,0,0,0,-1000
2509,全坤建          ,1000,2000,-1000,0,0,0,0,0,0,0,0,0,0,0,0,0,-1000
2231,為升            ,56000,56000,0,0,0,0,12000,0,12000,-13000,0,5000,-5000,0,8000,-8000,-1000
05864P,元油反元大96售07,0,0,0,0,0,0,0,0,0,-1000,0,0,0,0,1000,-1000,-1000
05935P,台積電凱基96售19,0,0,0,0,0,0,0,0,0,-1000,0,0,0,0,1000,-1000,-1000
05679P,台表科群益96售05,0,0,0,0,0,0,0,0,0,-1000,0,0,0,10000,11000,-1000,-1000
08478P,臺股指凱基9C售16,0,0,0,0,0,0,0,0,0,-1000,0,0,0,0,1000,-1000,-1000
06086P,台積電康和97售01,0,0,0,0,0,0,0,0,0,-1000,0,0,0,2000,3000,-1000,-1000
06052P,台郡國票97售06  ,0,0,0,0,0,0,0,0,0,-1000,0,0,0,6000,7000,-1000,-1000
06045P,臺股指永豐96售03,0,0,0,0,0,0,0,0,0,-1000,0,0,0,12000,13000,-1000,-1000
1521,大億            ,0,1000,-1000,0,0,0,0,0,0,0,0,0,0,0,0,0,-1000
1473,台南            ,4000,5000,-1000,0,0,0,0,0,0,0,0,0,0,0,0,0,-1000
1323,永裕            ,1000,2000,-1000,0,0,0,0,0,0,0,0,0,0,0,0,0,-1000
054413,台光電元大96購03,0,0,0,0,0,0,0,0,0,-2000,0,0,0,32000,34000,-2000,-2000
054508,臺股指永豐96購04,0,0,0,0,0,0,0,0,0,-2000,0,0,0,0,2000,-2000,-2000
054495,滬深2X永豐97購02,0,0,0,0,0,0,0,0,0,-2000,0,0,0,0,2000,-2000,-2000
054444,緯穎台新97購01  ,0,0,0,0,0,0,0,0,0,-2000,0,0,0,36000,38000,-2000,-2000
054543,元金2X中信01購01,0,0,0,0,0,0,0,0,0,-2000,0,0,0,0,2000,-2000,-2000
054571,楠梓電元大99購01,0,0,0,0,0,0,0,0,0,-2000,0,0,0,0,2000,-2000,-2000
05457P,鴻海凱基95售20  ,0,0,0,0,0,0,0,0,0,-2000,0,0,0,0,2000,-2000,-2000
054592,美律永昌9A購01  ,0,0,0,0,0,0,0,0,0,-2000,0,0,0,5000,7000,-2000,-2000
054807,台化元大9A購02  ,0,0,0,0,0,0,0,0,0,-2000,0,0,0,0,2000,-2000,-2000
05387P,鴻海元大95售21  ,0,0,0,0,0,0,0,0,0,-2000,0,0,0,166000,168000,-2000,-2000
053881,南亞科中信97購01,0,0,0,0,0,0,0,0,0,-2000,0,0,0,3000,5000,-2000,-2000
05378P,台積電凱基96售02,0,0,0,0,0,0,0,0,0,-2000,0,0,0,7000,9000,-2000,-2000
053675,臺股指元富96購02,0,0,0,0,0,0,0,0,0,-2000,0,0,0,0,2000,-2000,-2000
053682,臺股指富邦96購03,0,0,0,0,0,0,0,0,0,-2000,0,0,0,0,2000,-2000,-2000
053721,國泰金凱基97購01,0,0,0,0,0,0,0,0,0,-2000,0,0,0,0,2000,-2000,-2000
053608,彩晶第一96購01  ,0,0,0,0,0,0,0,0,0,-2000,0,0,0,213000,215000,-2000,-2000
053605,臺股指永昌96購01,0,0,0,0,0,0,0,0,0,-2000,0,0,0,0,2000,-2000,-2000
053622,臺股指群益96購08,0,0,0,0,0,0,0,0,0,-2000,0,0,0,0,2000,-2000,-2000
054140,智易元大97購03  ,0,0,0,0,0,0,0,0,0,-2000,0,0,0,0,2000,-2000,-2000
05417P,燿華永豐95售07  ,0,0,0,0,0,0,0,0,0,-2000,0,0,0,37000,39000,-2000,-2000
054003,鴻海統一96購13  ,0,0,0,0,0,0,0,0,0,-2000,0,0,0,0,2000,-2000,-2000
053902,S&P反1凱基97購01,0,0,0,0,0,0,0,0,0,-2000,0,0,0,85000,87000,-2000,-2000
053974,大立光元大96購10,0,0,0,0,0,0,0,0,0,-2000,0,0,0,0,2000,-2000,-2000
052452,茂林元大95購03  ,0,0,0,0,0,0,0,0,0,-2000,0,0,0,97000,99000,-2000,-2000
052511,聯發科凱基95購14,0,0,0,0,0,0,0,0,0,-2000,0,0,0,50000,52000,-2000,-2000
052532,台積電國泰96購07,0,0,0,0,0,0,0,0,0,-2000,0,0,0,52000,54000,-2000,-2000
052587,景碩永豐97購01  ,0,0,0,0,0,0,0,0,0,-2000,0,0,0,0,2000,-2000,-2000
052579,亞泥元富96購01  ,0,0,0,0,0,0,0,0,0,-2000,0,0,0,0,2000,-2000,-2000
052553,技嘉國票96購01  ,0,0,0,0,0,0,0,0,0,-2000,0,0,0,0,2000,-2000,-2000
052346,訊芯凱基95購01  ,0,0,0,0,0,0,0,0,0,-2000,0,0,0,2000,4000,-2000,-2000
053259,卜蜂群益97購01  ,0,0,0,0,0,0,0,0,0,-2000,0,0,0,0,2000,-2000,-2000
053337,聯電國票97購01  ,0,0,0,0,0,0,0,0,0,-2000,0,0,0,0,2000,-2000,-2000
053484,國巨國票97購03  ,0,0,0,0,0,0,0,0,0,-2000,0,0,0,63000,65000,-2000,-2000
053515,致伸群益96購02  ,0,0,0,0,0,0,0,0,0,-2000,0,0,0,8000,10000,-2000,-2000
053245,全新國票97購01  ,0,0,0,0,0,0,0,0,0,-2000,0,0,0,3000,5000,-2000,-2000
053226,國巨台新97購02  ,0,0,0,0,0,0,0,0,0,-2000,0,0,0,27000,29000,-2000,-2000
053221,彩晶凱基98購01  ,0,0,0,0,0,0,0,0,0,-2000,0,0,0,0,2000,-2000,-2000
053203,智易日盛96購01  ,0,0,0,0,0,0,0,0,0,-2000,0,0,0,0,2000,-2000,-2000
020002,元富新中國N     ,0,0,0,0,0,0,0,0,0,-2000,0,0,0,0,2000,-2000,-2000
020004,兆豐電菁英30N   ,0,0,0,0,0,0,0,0,0,-2000,0,0,0,0,2000,-2000,-2000
020005,永豐外資50N     ,0,0,0,0,0,0,0,0,0,-2000,0,0,0,0,2000,-2000,-2000
020006,永昌中小300N    ,0,0,0,0,0,0,0,0,0,-2000,0,0,0,0,2000,-2000,-2000
00658L,國泰日本正2     ,0,0,0,0,0,0,0,0,0,-2000,0,0,0,3000,5000,-2000,-2000
00643K,群益深証中小+R  ,0,0,0,0,0,0,0,0,0,-2000,0,0,0,0,2000,-2000,-2000
03612C,臺股指元大95牛01,0,0,0,0,0,0,0,0,0,-2000,0,0,0,0,2000,-2000,-2000
03636C,元油2X元富04牛01,0,0,0,0,0,0,0,0,0,-2000,0,0,0,1000,3000,-2000,-2000
03706P,上銀群益93售03  ,0,0,0,0,0,0,0,0,0,-2000,0,0,0,0,2000,-2000,-2000
03064X,元展59          ,0,0,0,0,0,0,0,0,0,-2000,0,0,0,0,2000,-2000,-2000
03063X,元展58          ,0,0,0,0,0,0,0,0,0,-2000,0,0,0,0,2000,-2000,-2000
03420B,臺股指元大95熊31,0,0,0,0,0,0,0,0,0,-2000,0,0,0,1000,3000,-2000,-2000
03039X,元展36          ,0,0,0,0,0,0,0,0,0,-2000,0,0,0,3000,5000,-2000,-2000
038111,新光金中信91購01,0,0,0,0,0,0,0,0,0,-2000,0,0,0,108000,110000,-2000,-2000
03967P,聯發科國票93售04,0,0,0,0,0,0,0,0,0,-2000,0,0,0,0,2000,-2000,-2000
042724,群創群益93購01  ,0,0,0,0,0,0,0,0,0,-2000,0,0,0,162000,164000,-2000,-2000
043175,傳奇國泰93購01  ,0,0,0,0,0,0,0,0,0,-2000,0,0,0,0,2000,-2000,-2000
041400,大立光元大91購01,0,0,0,0,0,0,0,0,0,-2000,0,0,0,0,2000,-2000,-2000
041990,A50正2國票97購01,0,0,0,0,0,0,0,0,0,-2000,0,0,0,5000,7000,-2000,-2000
044636,創意統一94購01  ,0,0,0,0,0,0,0,0,0,-2000,0,0,0,8000,10000,-2000,-2000
045052,聯發科元富92購01,0,0,0,0,0,0,0,0,0,-2000,0,0,0,31000,33000,-2000,-2000
045295,台積電元大93購02,0,0,0,0,0,0,0,0,0,-2000,0,0,0,0,2000,-2000,-2000
04518P,高鐵群益95售01  ,0,0,0,0,0,0,0,0,0,-2000,0,0,0,14000,16000,-2000,-2000
045436,友達統一93購02  ,0,0,0,0,0,0,0,0,0,-2000,0,0,0,0,2000,-2000,-2000
043953,鴻海統一91購05  ,0,0,0,0,0,0,0,0,0,-2000,0,0,0,18000,20000,-2000,-2000
043861,和大元大91購01  ,0,0,0,0,0,0,0,0,0,-2000,0,0,0,0,2000,-2000,-2000
045663,元油2X元富94購01,0,0,0,0,0,0,0,0,0,-2000,0,0,0,129000,131000,-2000,-2000
044061,聯發科元大92購03,0,0,0,0,0,0,0,0,0,-2000,0,0,0,10000,12000,-2000,-2000
048208,臺股指元大93購42,0,0,0,0,0,0,0,0,0,-2000,0,0,0,0,2000,-2000,-2000
047794,臺股指群益93購05,0,0,0,0,0,0,0,0,0,-2000,0,0,0,1000,3000,-2000,-2000
048348,矽力元大93購03  ,0,0,0,0,0,0,0,0,0,-2000,0,0,0,0,2000,-2000,-2000
047057,瀚宇博國票93購01,0,0,0,0,0,0,0,0,0,-2000,0,0,0,2000,4000,-2000,-2000
048803,大立光富邦96購01,0,0,0,0,0,0,0,0,0,-2000,0,0,0,0,2000,-2000,-2000
048782,亞泥元大94購01  ,0,0,0,0,0,0,0,0,0,-2000,0,0,0,37000,39000,-2000,-2000
048747,華通元富97購01  ,0,0,0,0,0,0,0,0,0,-2000,0,0,0,8000,10000,-2000,-2000
047145,鴻海群益95購01  ,0,0,0,0,0,0,0,0,0,-2000,0,0,0,30000,32000,-2000,-2000
048132,冠德國票94購01  ,0,0,0,0,0,0,0,0,0,-2000,0,0,0,0,2000,-2000,-2000
048968,可成元大94購02  ,0,0,0,0,0,0,0,0,0,-2000,0,0,0,0,2000,-2000,-2000
047507,台塑國票93購01  ,0,0,0,0,0,0,0,0,0,-2000,0,0,0,8000,10000,-2000,-2000
047297,康控元富93購01  ,0,0,0,0,0,0,0,0,0,-2000,0,0,0,18000,20000,-2000,-2000
049921,大立光元大94購16,0,0,0,0,0,0,0,0,0,-2000,0,0,0,9000,11000,-2000,-2000
049940,臺股指元大94購21,0,0,0,0,0,0,0,0,0,-2000,0,0,0,0,2000,-2000,-2000
049056,玉晶光永豐95購03,0,0,0,0,0,0,0,0,0,-2000,0,0,0,148000,150000,-2000,-2000
046091,健鼎兆豐92購01  ,0,0,0,0,0,0,0,0,0,-2000,0,0,0,20000,22000,-2000,-2000
045877,友達元富95購01  ,0,0,0,0,0,0,0,0,0,-2000,0,0,0,0,2000,-2000,-2000
046149,宏達電國票93購01,0,0,0,0,0,0,0,0,0,-2000,0,0,0,0,2000,-2000,-2000
046152,廣宇亞東92購01  ,0,0,0,0,0,0,0,0,0,-2000,0,0,0,0,2000,-2000,-2000
046374,台積電凱基92購20,0,0,0,0,0,0,0,0,0,-2000,0,0,0,17000,19000,-2000,-2000
048632,大成鋼元大93購02,0,0,0,0,0,0,0,0,0,-2000,0,0,0,0,2000,-2000,-2000
048530,大立光國票93購04,0,0,0,0,0,0,0,0,0,-2000,0,0,0,1000,3000,-2000,-2000
048597,台達電國票93購02,0,0,0,0,0,0,0,0,0,-2000,0,0,0,0,2000,-2000,-2000
046536,聯發科群益92購08,0,0,0,0,0,0,0,0,0,-2000,0,0,0,0,2000,-2000,-2000
051990,泰碩元大95購01  ,0,0,0,0,0,0,0,0,0,-2000,0,0,0,103000,105000,-2000,-2000
051956,滬深2X台新96購01,0,0,0,0,0,0,0,0,0,-2000,0,0,0,0,2000,-2000,-2000
051951,聯發科元富95購02,0,0,0,0,0,0,0,0,0,-2000,0,0,0,0,2000,-2000,-2000
051949,鴻海元富95購08  ,0,0,0,0,0,0,0,0,0,-2000,0,0,0,8000,10000,-2000,-2000
052110,可成元富95購02  ,0,0,0,0,0,0,0,0,0,-2000,0,0,0,10000,12000,-2000,-2000
052062,臺股指國票95購09,0,0,0,0,0,0,0,0,0,-2000,0,0,0,0,2000,-2000,-2000
05164P,南亞科元富95售04,0,0,0,0,0,0,0,0,0,-2000,0,0,0,0,2000,-2000,-2000
051415,晶技國票96購01  ,0,0,0,0,0,0,0,0,0,-2000,0,0,0,0,2000,-2000,-2000
051343,鴻海元大95購07  ,0,0,0,0,0,0,0,0,0,-2000,0,0,0,160000,162000,-2000,-2000
051381,玉晶光群益98購01,0,0,0,0,0,0,0,0,0,-2000,0,0,0,0,2000,-2000,-2000
05119P,聯發科國泰96售02,0,0,0,0,0,0,0,0,0,-2000,0,0,0,209000,211000,-2000,-2000
050919,台積電凱基95購03,0,0,0,0,0,0,0,0,0,-2000,0,0,0,3000,5000,-2000,-2000
051041,大立光永豐95購01,0,0,0,0,0,0,0,0,0,-2000,0,0,0,2000,4000,-2000,-2000
050178,聯發科元大94購12,0,0,0,0,0,0,0,0,0,-2000,0,0,0,0,2000,-2000,-2000
050074,訊芯凱基94購05  ,0,0,0,0,0,0,0,0,0,-2000,0,0,0,74000,76000,-2000,-2000
049459,全新元富95購02  ,0,0,0,0,0,0,0,0,0,-2000,0,0,0,39000,41000,-2000,-2000
049671,上証2X富邦95購01,0,0,0,0,0,0,0,0,0,-2000,0,0,0,0,2000,-2000,-2000
050712,和碩中信94購01  ,0,0,0,0,0,0,0,0,0,-2000,0,0,0,1000,3000,-2000,-2000
050875,訊芯永豐95購01  ,0,0,0,0,0,0,0,0,0,-2000,0,0,0,502000,504000,-2000,-2000
050905,臺股指元大95購12,0,0,0,0,0,0,0,0,0,-2000,0,0,0,0,2000,-2000,-2000
050445,鴻海元大94購21  ,0,0,0,0,0,0,0,0,0,-2000,0,0,0,290000,292000,-2000,-2000
050305,正崴中信95購01  ,0,0,0,0,0,0,0,0,0,-2000,0,0,0,0,2000,-2000,-2000
050389,鴻海統一95購04  ,0,0,0,0,0,0,0,0,0,-2000,0,0,0,0,2000,-2000,-2000
050233,香港2X凱基96購01,0,0,0,0,0,0,0,0,0,-2000,0,0,0,0,2000,-2000,-2000
1532,勤美            ,18000,20000,-2000,0,0,0,0,0,0,0,0,0,0,0,0,0,-2000
1537,廣隆            ,19000,20000,-1000,0,0,0,0,0,0,-1000,0,1000,-1000,0,0,0,-2000
1615,大山            ,0,2000,-2000,0,0,0,0,0,0,0,0,0,0,0,0,0,-2000
06066P,群創台新98售01  ,0,0,0,0,0,0,0,0,0,-2000,0,0,0,0,2000,-2000,-2000
05737P,臺股指統一96售07,0,0,0,0,0,0,0,0,0,-2000,0,0,0,0,2000,-2000,-2000
05606P,TPK國票97售02   ,0,0,0,0,0,0,0,0,0,-2000,0,0,0,0,2000,-2000,-2000
05647P,聯發科國票97售02,0,0,0,0,0,0,0,0,0,-2000,0,0,0,0,2000,-2000,-2000
05877P,大立光群益96售06,0,0,0,0,0,0,0,0,0,-2000,0,0,0,235000,237000,-2000,-2000
2438,翔耀            ,2000,0,2000,0,0,0,0,0,0,-4000,0,4000,-4000,0,0,0,-2000
4746,台耀            ,55000,55000,0,0,0,0,0,0,0,-2000,2000,4000,-2000,0,0,0,-2000
3013,晟銘電          ,24000,22000,2000,0,0,0,0,0,0,-4000,0,4000,-4000,0,0,0,-2000
3416,融程電          ,0,2000,-2000,0,0,0,0,0,0,0,0,0,0,0,0,0,-2000
3004,豐達科          ,4000,6000,-2000,0,0,0,0,0,0,0,0,0,0,0,0,0,-2000
2748,雲品            ,6000,8000,-2000,0,0,0,0,0,0,0,0,0,0,0,0,0,-2000
2852,第一保          ,0,2000,-2000,0,0,0,0,0,0,0,0,0,0,0,0,0,-2000
6281,全國電          ,1000,3000,-2000,0,0,0,0,0,0,0,0,0,0,0,0,0,-2000
6277,宏正            ,8000,10000,-2000,0,0,0,0,0,0,0,0,0,0,0,0,0,-2000
8467,波力-KY         ,3000,2000,1000,0,0,0,0,0,0,-3000,0,3000,-3000,0,0,0,-2000
052963,智邦凱基96購02  ,0,0,0,0,0,0,0,0,0,-3000,0,0,0,4000,7000,-3000,-3000
053065,大立光群益96購01,0,0,0,0,0,0,0,0,0,-3000,0,0,0,3000,6000,-3000,-3000
053412,台達電國票97購02,0,0,0,0,0,0,0,0,0,-3000,0,0,0,0,3000,-3000,-3000
05340P,臺股指國票95售08,0,0,0,0,0,0,0,0,0,-3000,0,0,0,15000,18000,-3000,-3000
053277,大立光元大96購04,0,0,0,0,0,0,0,0,0,-3000,0,0,0,42000,45000,-3000,-3000
052275,日月光群益95購01,0,0,0,0,0,0,0,0,0,-3000,0,0,0,0,3000,-3000,-3000
052493,上証2X中信97購02,0,0,0,0,0,0,0,0,0,-3000,0,0,0,10000,13000,-3000,-3000
052741,聯發科元大96購08,0,0,0,0,0,0,0,0,0,-3000,0,0,0,62000,65000,-3000,-3000
052616,鴻海國泰98購02  ,0,0,0,0,0,0,0,0,0,-3000,0,0,0,30000,33000,-3000,-3000
052660,京元電國票97購01,0,0,0,0,0,0,0,0,0,-3000,0,0,0,2000,5000,-3000,-3000
052784,緯穎國票97購02  ,0,0,0,0,0,0,0,0,0,-3000,0,0,0,0,3000,-3000,-3000
053934,A50正2元富96購02,0,0,0,0,0,0,0,0,0,-3000,0,0,0,0,3000,-3000,-3000
054081,聯電元富96購01  ,0,0,0,0,0,0,0,0,0,-3000,0,0,0,78000,81000,-3000,-3000
053606,臺股指永昌96購02,0,0,0,0,0,0,0,0,0,-3000,0,0,0,0,3000,-3000,-3000
053758,華新科國泰97購02,0,0,0,0,0,0,0,0,0,-3000,0,0,0,1000,4000,-3000,-3000
053827,漢唐麥證9A購01  ,0,0,0,40000,43000,-3000,0,0,0,-3000,0,0,0,40000,43000,-3000,-3000
053838,正文永豐96購02  ,0,0,0,0,0,0,0,0,0,-3000,0,0,0,68000,71000,-3000,-3000
054707,聯茂亞東97購01  ,0,0,0,0,0,0,0,0,0,-3000,0,0,0,0,3000,-3000,-3000
054344,景碩國票97購04  ,0,0,0,0,0,0,0,0,0,-3000,0,0,0,5000,8000,-3000,-3000
054213,欣興國票97購04  ,0,0,0,0,0,0,0,0,0,-3000,0,0,0,154000,157000,-3000,-3000
045740,大立光群益92購05,0,0,0,0,0,0,0,0,0,-3000,0,0,0,0,3000,-3000,-3000
044010,華通凱基93購01  ,0,0,0,0,0,0,0,0,0,-3000,0,0,0,3000,6000,-3000,-3000
045500,聯發科凱基93購04,0,0,0,0,0,0,0,0,0,-3000,0,0,0,0,3000,-3000,-3000
045572,元油2X元大98購01,0,0,0,0,0,0,0,0,0,-3000,0,0,0,0,3000,-3000,-3000
045443,群創元富98購01  ,0,0,0,0,0,0,0,0,0,-3000,0,0,0,0,3000,-3000,-3000
045213,A50正2元大95購01,0,0,0,0,0,0,0,0,0,-3000,0,0,0,20000,23000,-3000,-3000
044905,欣興凱基91購07  ,0,0,0,0,0,0,0,0,0,-3000,0,0,0,0,3000,-3000,-3000
044867,漢唐國票91購03  ,0,0,0,0,0,0,0,0,0,-3000,0,0,0,44000,47000,-3000,-3000
044970,大毅永豐92購01  ,0,0,0,0,0,0,0,0,0,-3000,0,0,0,353000,356000,-3000,-3000
043381,大立光元大93購02,0,0,0,0,0,0,0,0,0,-3000,0,0,0,0,3000,-3000,-3000
042116,元油2X國票97購01,0,0,0,0,0,0,0,0,0,-3000,0,0,0,1000,4000,-3000,-3000
04265P,滬深2X元富93售04,0,0,0,0,0,0,0,0,0,-3000,0,0,0,5000,8000,-3000,-3000
03638C,T50反1元大94牛03,0,0,0,0,0,0,0,0,0,-3000,0,0,0,3000,6000,-3000,-3000
03635C,滬深2X元富99牛01,0,0,0,0,0,0,0,0,0,-3000,0,0,0,210000,213000,-3000,-3000
0054,元大台商50      ,0,0,0,0,0,0,0,0,0,-3000,0,0,0,0,3000,-3000,-3000
00660,元大歐洲50      ,0,0,0,0,0,0,0,0,0,-3000,0,0,0,0,3000,-3000,-3000
00661,元大日經225     ,0,0,0,0,0,0,0,0,0,-3000,0,0,0,0,3000,-3000,-3000
00770,國泰北美科技    ,0,0,0,0,0,0,0,0,0,-3000,0,0,0,0,3000,-3000,-3000
00757,統一FANG+       ,0,0,0,0,0,0,0,0,0,-3000,0,0,0,201000,204000,-3000,-3000
046735,聯發科國票93購01,0,0,0,0,0,0,0,0,0,-3000,0,0,0,0,3000,-3000,-3000
048480,FB上証中信94購01,0,0,0,0,0,0,0,0,0,-3000,0,0,0,10000,13000,-3000,-3000
048636,鴻海元大94購05  ,0,0,0,0,0,0,0,0,0,-3000,0,0,0,0,3000,-3000,-3000
046441,儒鴻兆豐92購01  ,0,0,0,0,0,0,0,0,0,-3000,0,0,0,155000,158000,-3000,-3000
047839,景碩元大93購03  ,0,0,0,0,0,0,0,0,0,-3000,0,0,0,1000,4000,-3000,-3000
047006,大立光統一93購04,0,0,0,0,0,0,0,0,0,-3000,0,0,0,20000,23000,-3000,-3000
04687P,全新凱基94售02  ,0,0,0,0,0,0,0,0,0,-3000,0,0,0,0,3000,-3000,-3000
046877,燿華國泰94購01  ,0,0,0,0,0,0,0,0,0,-3000,0,0,0,51000,54000,-3000,-3000
046798,元油2X元大96購01,0,0,0,0,0,0,0,0,0,-3000,0,0,0,0,3000,-3000,-3000
049166,元油2X凱基97購02,0,0,0,0,0,0,0,0,0,-3000,0,0,0,0,3000,-3000,-3000
049185,南電凱基94購03  ,0,0,0,0,0,0,0,0,0,-3000,0,0,0,0,3000,-3000,-3000
049111,元油2X統一94購03,0,0,0,0,0,0,0,0,0,-3000,0,0,0,0,3000,-3000,-3000
049402,奇鋐群益95購02  ,0,0,0,0,0,0,0,0,0,-3000,0,0,0,10000,13000,-3000,-3000
049215,國巨國票94購03  ,0,0,0,0,0,0,0,0,0,-3000,0,0,0,0,3000,-3000,-3000
049918,宏達電元大94購01,0,0,0,0,0,0,0,0,0,-3000,0,0,0,20000,23000,-3000,-3000
049310,台積電凱基94購15,0,0,0,0,0,0,0,0,0,-3000,0,0,0,17000,20000,-3000,-3000
047710,聯發科凱基93購21,0,0,0,0,0,0,0,0,0,-3000,0,0,0,11000,14000,-3000,-3000
049273,臺股指元大94購08,0,0,0,0,0,0,0,0,0,-3000,0,0,0,2000,5000,-3000,-3000
047667,新唐永豐93購02  ,0,0,0,0,0,0,0,0,0,-3000,0,0,0,0,3000,-3000,-3000
047321,日月光元大93購03,0,0,0,0,0,0,0,0,0,-3000,0,0,0,7000,10000,-3000,-3000
047312,聯發科元大93購13,0,0,0,0,0,0,0,0,0,-3000,0,0,0,0,3000,-3000,-3000
047243,為升群益93購02  ,0,0,0,0,0,0,0,0,0,-3000,0,0,0,0,3000,-3000,-3000
048781,臺股指凱基96購01,0,0,0,0,0,0,0,0,0,-3000,0,0,0,8000,11000,-3000,-3000
05027P,南電群益95售01  ,0,0,0,0,0,0,0,0,0,-3000,0,0,0,41000,44000,-3000,-3000
050466,瑞儀中信94購01  ,0,0,0,0,0,0,0,0,0,-3000,0,0,0,0,3000,-3000,-3000
050477,矽力永豐94購01  ,0,0,0,0,0,0,0,0,0,-3000,0,0,0,0,3000,-3000,-3000
050865,欣興永豐95購01  ,0,0,0,0,0,0,0,0,0,-3000,0,0,0,0,3000,-3000,-3000
050779,超眾元大96購03  ,0,0,0,0,0,0,0,0,0,-3000,0,0,0,0,3000,-3000,-3000
050766,燿華元大96購02  ,0,0,0,0,0,0,0,0,0,-3000,0,0,0,0,3000,-3000,-3000
050664,全新台新94購02  ,0,0,0,0,0,0,0,0,0,-3000,0,0,0,0,3000,-3000,-3000
050652,大立光凱基96購03,0,0,0,0,0,0,0,0,0,-3000,0,0,0,0,3000,-3000,-3000
050583,瑞儀國票94購01  ,0,0,0,0,0,0,0,0,0,-3000,0,0,0,5000,8000,-3000,-3000
050623,致新元大94購05  ,0,0,0,0,0,0,0,0,0,-3000,0,0,0,1000,4000,-3000,-3000
049646,旺宏凱基94購01  ,0,0,0,0,0,0,0,0,0,-3000,0,0,0,64000,67000,-3000,-3000
049534,華擎永豐94購02  ,0,0,0,0,0,0,0,0,0,-3000,0,0,0,0,3000,-3000,-3000
050116,嘉澤元大94購03  ,0,0,0,0,0,0,0,0,0,-3000,0,0,0,0,3000,-3000,-3000
050190,麗豐元大95購02  ,0,0,0,0,0,0,0,0,0,-3000,0,0,0,0,3000,-3000,-3000
049828,華新科凱基94購06,0,0,0,0,0,0,0,0,0,-3000,0,0,0,22000,25000,-3000,-3000
049869,訊芯兆豐94購01  ,0,0,0,0,0,0,0,0,0,-3000,0,0,0,77000,80000,-3000,-3000
050954,樺漢群益95購01  ,0,0,0,0,0,0,0,0,0,-3000,0,0,0,0,3000,-3000,-3000
051094,健策元大96購03  ,0,0,0,0,0,0,0,0,0,-3000,0,0,0,38000,41000,-3000,-3000
05136P,台積電凱基95售08,0,0,0,0,0,0,0,0,0,-3000,0,0,0,0,3000,-3000,-3000
051422,超眾國票96購01  ,0,0,0,0,0,0,0,0,0,-3000,0,0,0,0,3000,-3000,-3000
05143P,臻鼎台新95售01  ,0,0,0,0,0,0,0,0,0,-3000,0,0,0,0,3000,-3000,-3000
051432,群創元富99購03  ,0,0,0,0,0,0,0,0,0,-3000,0,0,0,10000,13000,-3000,-3000
051508,元黃金中信97購01,0,0,0,0,0,0,0,0,0,-3000,0,0,0,0,3000,-3000,-3000
051560,玉晶光國泰97購03,0,0,0,0,0,0,0,0,0,-3000,0,0,0,43000,46000,-3000,-3000
051812,臻鼎凱基95購03  ,0,0,0,0,0,0,0,0,0,-3000,0,0,0,0,3000,-3000,-3000
051863,技嘉凱基95購01  ,0,0,0,0,0,0,0,0,0,-3000,0,0,0,0,3000,-3000,-3000
051753,華通元大96購03  ,0,0,0,0,0,0,0,0,0,-3000,0,0,0,23000,26000,-3000,-3000
052090,聯發科元大97購03,0,0,0,0,0,0,0,0,0,-3000,0,0,0,10000,13000,-3000,-3000
051953,矽力元富95購03  ,0,0,0,0,0,0,0,0,0,-3000,0,0,0,0,3000,-3000,-3000
051897,台光電國泰97購01,0,0,0,0,0,0,0,0,0,-3000,0,0,0,17000,20000,-3000,-3000
8222,寶一            ,1000,4000,-3000,0,0,0,0,0,0,0,0,0,0,0,0,0,-3000
6201,亞弘電          ,1000,4000,-3000,0,0,0,0,0,0,0,0,0,0,0,0,0,-3000
6674,鋐寶科技        ,4000,3000,1000,0,0,0,0,0,0,-4000,0,4000,-4000,0,0,0,-3000
8072,陞泰            ,0,3000,-3000,0,0,0,0,0,0,0,0,0,0,0,0,0,-3000
3346,麗清            ,9000,12000,-3000,0,0,0,0,0,0,0,0,0,0,0,0,0,-3000
4557,永新-KY         ,0,3000,-3000,0,0,0,0,0,0,0,0,0,0,0,0,0,-3000
5515,建國            ,2000,5000,-3000,0,0,0,0,0,0,0,0,0,0,0,0,0,-3000
2114,鑫永銓          ,0,3000,-3000,0,0,0,0,0,0,0,0,0,0,0,0,0,-3000
1709,和益            ,3000,6000,-3000,0,0,0,0,0,0,0,0,0,0,0,0,0,-3000
1463,強盛            ,0,3000,-3000,0,0,0,0,0,0,0,0,0,0,0,0,0,-3000
1459,聯發            ,0,3000,-3000,0,0,0,0,0,0,0,0,0,0,0,0,0,-3000
1441,大東            ,4000,7000,-3000,0,0,0,0,0,0,0,0,0,0,0,0,0,-3000
054350,美律國泰98購01  ,0,0,0,0,0,0,0,0,0,-4000,0,0,0,72000,76000,-4000,-4000
054300,華通凱基96購07  ,0,0,0,0,0,0,0,0,0,-4000,0,0,0,67000,71000,-4000,-4000
054399,智易永豐96購03  ,0,0,0,0,0,0,0,0,0,-4000,0,0,0,5000,9000,-4000,-4000
054669,凌華元富97購01  ,0,0,0,0,0,0,0,0,0,-4000,0,0,0,0,4000,-4000,-4000
054609,正崴永豐97購01  ,0,0,0,0,0,0,0,0,0,-4000,0,0,0,0,4000,-4000,-4000
054638,國泰金中信99購01,0,0,0,0,0,0,0,0,0,-4000,0,0,0,0,4000,-4000,-4000
054813,鴻海元大97購09  ,0,0,0,0,0,0,0,0,0,-4000,0,0,0,56000,60000,-4000,-4000
053836,亞光永豐96購02  ,0,0,0,0,0,0,0,0,0,-4000,0,0,0,29000,33000,-4000,-4000
053612,T50反1群益96購01,0,0,0,0,0,0,0,0,0,-4000,0,0,0,1000,5000,-4000,-4000
053723,奇鋐凱基98購01  ,0,0,0,0,0,0,0,0,0,-4000,0,0,0,0,4000,-4000,-4000
053742,創意國票97購01  ,0,0,0,0,0,0,0,0,0,-4000,0,0,0,2000,6000,-4000,-4000
054061,晶技國票97購03  ,0,0,0,0,0,0,0,0,0,-4000,0,0,0,0,4000,-4000,-4000
054063,聯茂國票97購02  ,0,0,0,0,0,0,0,0,0,-4000,0,0,0,0,4000,-4000,-4000
054177,牧德台新97購01  ,0,0,0,0,0,0,0,0,0,-4000,0,0,0,9000,13000,-4000,-4000
053913,華新國票97購01  ,0,0,0,0,0,0,0,0,0,-4000,0,0,0,4000,8000,-4000,-4000
053944,亞泥富邦97購01  ,0,0,0,0,0,0,0,0,0,-4000,0,0,0,54000,58000,-4000,-4000
052931,麗豐元大97購01  ,0,0,0,0,0,0,0,0,0,-4000,0,0,0,9000,13000,-4000,-4000
052755,滬深2X群益9A購01,0,0,0,0,0,0,0,0,0,-4000,0,0,0,0,4000,-4000,-4000
053555,日月光凱基97購01,0,0,0,0,0,0,0,0,0,-4000,0,0,0,0,4000,-4000,-4000
053558,訊芯凱基96購02  ,0,0,0,0,0,0,0,0,0,-4000,0,0,0,42000,46000,-4000,-4000
053571,奇鋐統一96購02  ,0,0,0,0,0,0,0,0,0,-4000,0,0,0,0,4000,-4000,-4000
052947,晶技國票97購01  ,0,0,0,0,0,0,0,0,0,-4000,0,0,0,0,4000,-4000,-4000
035275,台積電台新97購01,0,0,0,0,0,0,0,0,0,-4000,0,0,0,0,4000,-4000,-4000
0057,富邦摩台        ,0,0,0,0,0,0,0,0,0,-4000,0,0,0,20000,24000,-4000,-4000
03899P,滬深2X群益95售03,0,0,0,0,0,0,0,0,0,-4000,0,0,0,0,4000,-4000,-4000
043144,台肥統一93購01  ,0,0,0,0,0,0,0,0,0,-4000,0,0,0,2000,6000,-4000,-4000
043424,奇力新國票91購01,0,0,0,0,0,0,0,0,0,-4000,0,0,0,96000,100000,-4000,-4000
044928,玉晶光國泰93購01,0,0,0,0,0,0,0,0,0,-4000,0,0,0,0,4000,-4000,-4000
044887,亞光麥證93購01  ,0,0,0,0,4000,-4000,0,0,0,-4000,0,0,0,0,4000,-4000,-4000
045219,瑞昱元大92購01  ,0,0,0,0,0,0,0,0,0,-4000,0,0,0,0,4000,-4000,-4000
045767,大立光元富95購01,0,0,0,0,0,0,0,0,0,-4000,0,0,0,0,4000,-4000,-4000
045665,聯電元富92購01  ,0,0,0,0,0,0,0,0,0,-4000,0,0,0,0,4000,-4000,-4000
048951,宏全永豐94購01  ,0,0,0,0,0,0,0,0,0,-4000,0,0,0,62000,66000,-4000,-4000
04869P,鴻海元富95售02  ,0,0,0,0,0,0,0,0,0,-4000,0,0,0,80000,84000,-4000,-4000
048696,台達電國票96購01,0,0,0,0,0,0,0,0,0,-4000,0,0,0,3000,7000,-4000,-4000
047070,華通兆豐93購01  ,0,0,0,0,0,0,0,0,0,-4000,0,0,0,0,4000,-4000,-4000
047119,臻鼎元大93購01  ,0,0,0,0,0,0,0,0,0,-4000,0,0,0,0,4000,-4000,-4000
047488,臺股指凱基93購04,0,0,0,0,0,0,0,0,0,-4000,0,0,0,10000,14000,-4000,-4000
048105,滬深2X群益99購02,0,0,0,0,0,0,0,0,0,-4000,0,0,0,1000,5000,-4000,-4000
047177,上銀元大93購05  ,0,0,0,0,0,0,0,0,0,-4000,0,0,0,3000,7000,-4000,-4000
047554,聯詠凱基93購04  ,0,0,0,0,0,0,0,0,0,-4000,0,0,0,1000,5000,-4000,-4000
04936P,大立光中信95售03,0,0,0,0,0,0,0,0,0,-4000,0,0,0,3000,7000,-4000,-4000
046869,聯發科統一95購01,0,0,0,0,0,0,0,0,0,-4000,0,0,0,0,4000,-4000,-4000
04600P,可成凱基94售07  ,0,0,0,0,0,0,0,0,0,-4000,0,0,0,7000,11000,-4000,-4000
047427,貿聯亞東93購01  ,0,0,0,0,0,0,0,0,0,-4000,0,0,0,0,4000,-4000,-4000
047861,臺股指國票93購16,0,0,0,0,0,0,0,0,0,-4000,0,0,0,0,4000,-4000,-4000
046353,聯發科群益92購04,0,0,0,0,0,0,0,0,0,-4000,0,0,0,6000,10000,-4000,-4000
048483,可成國泰95購01  ,0,0,0,0,0,0,0,0,0,-4000,0,0,0,225000,229000,-4000,-4000
052030,GIS群益95購04   ,0,0,0,0,0,0,0,0,0,-4000,0,0,0,10000,14000,-4000,-4000
05218P,大立光永昌96售04,0,0,0,0,0,0,0,0,0,-4000,0,0,0,2003000,2007000,-4000,-4000
051866,聯發科凱基96購05,0,0,0,0,0,0,0,0,0,-4000,0,0,0,19000,23000,-4000,-4000
051245,南亞科元大95購01,0,0,0,0,0,0,0,0,0,-4000,0,0,0,2000,6000,-4000,-4000
050196,嘉聯益元大97購01,0,0,0,0,0,0,0,0,0,-4000,0,0,0,401000,405000,-4000,-4000
049417,奇力新凱基94購02,0,0,0,0,0,0,0,0,0,-4000,0,0,0,16000,20000,-4000,-4000
050590,晶技永豐95購01  ,0,0,0,0,0,0,0,0,0,-4000,0,0,0,33000,37000,-4000,-4000
050822,亞光凱基95購01  ,0,0,0,0,0,0,0,0,0,-4000,0,0,0,25000,29000,-4000,-4000
050538,鴻海凱基95購06  ,0,0,0,0,0,0,0,0,0,-4000,0,0,0,18000,22000,-4000,-4000
050467,力成中信94購01  ,0,0,0,0,0,0,0,0,0,-4000,0,0,0,6000,10000,-4000,-4000
050295,大立光凱基94購16,0,0,0,0,0,0,0,0,0,-4000,0,0,0,0,4000,-4000,-4000
050353,華擎群益95購01  ,0,0,0,0,0,0,0,0,0,-4000,0,0,0,0,4000,-4000,-4000
1516,川飛            ,4000,5000,-1000,0,0,0,0,0,0,-3000,0,3000,-3000,0,0,0,-4000
05603P,聯發科元大96售09,0,0,0,0,0,0,0,0,0,-4000,0,0,0,15000,19000,-4000,-4000
05594P,旺宏國票96售04  ,0,0,0,0,0,0,0,0,0,-4000,0,0,0,0,4000,-4000,-4000
1734,杏輝            ,0,3000,-3000,0,0,0,0,0,0,-1000,0,1000,-1000,0,0,0,-4000
4133,亞諾法          ,0,4000,-4000,0,0,0,0,0,0,0,0,0,0,0,0,0,-4000
3305,昇貿            ,5000,9000,-4000,0,0,0,0,0,0,0,0,0,0,0,0,0,-4000
3018,同開            ,2000,6000,-4000,0,0,0,0,0,0,0,0,0,0,0,0,0,-4000
2906,高林            ,1000,5000,-4000,0,0,0,0,0,0,0,0,0,0,0,0,0,-4000
6666,羅麗芬-KY       ,5000,5000,0,0,0,0,0,0,0,-4000,0,0,0,0,4000,-4000,-4000
052980,上銀元大96購03  ,0,0,0,0,0,0,0,0,0,-5000,0,0,0,17000,22000,-5000,-5000
053189,聯發科統一96購05,0,0,0,0,0,0,0,0,0,-5000,0,0,0,0,5000,-5000,-5000
053156,緯創元大96購02  ,0,0,0,0,0,0,0,0,0,-5000,0,0,0,0,5000,-5000,-5000
053115,滬深2X中信97購01,0,0,0,0,0,0,0,0,0,-5000,0,0,0,0,5000,-5000,-5000
053496,義隆兆豐96購02  ,0,0,0,0,0,0,0,0,0,-5000,0,0,0,10000,15000,-5000,-5000
053443,智邦凱基97購01  ,0,0,0,0,0,0,0,0,0,-5000,0,0,0,12000,17000,-5000,-5000
052641,聯詠台新96購01  ,0,0,0,0,0,0,0,0,0,-5000,0,0,0,0,5000,-5000,-5000
052626,上証2X中信9A購01,0,0,0,0,0,0,0,0,0,-5000,0,0,0,0,5000,-5000,-5000
052785,滬深2X中信99購03,0,0,0,0,0,0,0,0,0,-5000,0,0,0,0,5000,-5000,-5000
052799,上銀元大96購01  ,0,0,0,0,0,0,0,0,0,-5000,0,0,0,8000,13000,-5000,-5000
052811,玉晶光台新96購03,0,0,0,0,0,0,0,0,0,-5000,0,0,0,0,5000,-5000,-5000
052235,聯發科國票96購02,0,0,0,0,0,0,0,0,0,-5000,0,0,0,2000,7000,-5000,-5000
052269,T50反1日盛9B購01,0,0,0,0,0,0,0,0,0,-5000,0,0,0,1000,6000,-5000,-5000
052388,旺宏群益96購05  ,0,0,0,0,0,0,0,0,0,-5000,0,0,0,0,5000,-5000,-5000
053904,漢唐凱基97購01  ,0,0,0,0,0,0,0,0,0,-5000,0,0,0,0,5000,-5000,-5000
053927,牧德國票97購01  ,0,0,0,0,0,0,0,0,0,-5000,0,0,0,0,5000,-5000,-5000
054036,T50反1元大96購08,0,0,0,0,0,0,0,0,0,-5000,0,0,0,0,5000,-5000,-5000
054051,貿聯元大97購03  ,0,0,0,0,0,0,0,0,0,-5000,0,0,0,82000,87000,-5000,-5000
053704,國巨群益96購06  ,0,0,0,0,0,0,0,0,0,-5000,0,0,0,126000,131000,-5000,-5000
053870,正文元大96購01  ,0,0,0,0,0,0,0,0,0,-5000,0,0,0,10000,15000,-5000,-5000
053766,友達富邦97購01  ,0,0,0,0,0,0,0,0,0,-5000,0,0,0,0,5000,-5000,-5000
053790,嘉聯益元大99購02,0,0,0,0,0,0,0,0,0,-5000,0,0,0,100000,105000,-5000,-5000
054796,康普群益98購01  ,0,0,0,0,0,0,0,0,0,-5000,0,0,0,0,5000,-5000,-5000
054762,奇力新國票99購01,0,0,0,0,0,0,0,0,0,-5000,0,0,0,0,5000,-5000,-5000
054671,國巨國泰98購01  ,0,0,0,0,0,0,0,0,0,-5000,0,0,0,83000,88000,-5000,-5000
05436P,台積電群益95售07,0,0,0,0,0,0,0,0,0,-5000,0,0,0,5000,10000,-5000,-5000
054509,上証反元大99購01,0,0,0,0,0,0,0,0,0,-5000,0,0,0,0,5000,-5000,-5000
054299,南電元大96購03  ,0,0,0,0,0,0,0,0,0,-5000,0,0,0,21000,26000,-5000,-5000
044105,聯詠中信95購01  ,0,0,0,0,0,0,0,0,0,-5000,0,0,0,18000,23000,-5000,-5000
044125,美律凱基93購01  ,0,0,0,0,0,0,0,0,0,-5000,0,0,0,25000,30000,-5000,-5000
048235,滬深2X國票93購04,0,0,0,0,0,0,0,0,0,-5000,0,0,0,0,5000,-5000,-5000
045429,復盛凱基92購01  ,0,0,0,0,0,0,0,0,0,-5000,0,0,0,17000,22000,-5000,-5000
045480,滬深2X中信94購01,0,0,0,0,0,0,0,0,0,-5000,0,0,0,0,5000,-5000,-5000
045462,美律元大93購04  ,0,0,0,0,0,0,0,0,0,-5000,0,0,0,0,5000,-5000,-5000
044030,台積電群益91購06,0,0,0,0,0,0,0,0,0,-5000,0,0,0,0,5000,-5000,-5000
045594,緯穎元大93購04  ,0,0,0,0,0,0,0,0,0,-5000,0,0,0,20000,25000,-5000,-5000
045598,上証2X中信94購02,0,0,0,0,0,0,0,0,0,-5000,0,0,0,5000,10000,-5000,-5000
044908,玉晶光凱基93購01,0,0,0,0,0,0,0,0,0,-5000,0,0,0,0,5000,-5000,-5000
044750,鴻海凱基93購07  ,0,0,0,0,0,0,0,0,0,-5000,0,0,0,14000,19000,-5000,-5000
045087,玉晶光元大95購01,0,0,0,0,0,0,0,0,0,-5000,0,0,0,15000,20000,-5000,-5000
045013,大立光元大93購04,0,0,0,0,0,0,0,0,0,-5000,0,0,0,0,5000,-5000,-5000
04355P,大立光永豐94售02,0,0,0,0,0,0,0,0,0,-5000,0,0,0,0,5000,-5000,-5000
044433,華新科元大92購06,0,0,0,0,0,0,0,0,0,-5000,0,0,0,5000,10000,-5000,-5000
044592,元油2X國票93購02,0,0,0,0,0,0,0,0,0,-5000,0,0,0,0,5000,-5000,-5000
044722,滬深2X永豐93購01,0,0,0,0,0,0,0,0,0,-5000,0,0,0,0,5000,-5000,-5000
041974,元油2X中信92購01,0,0,0,0,0,0,0,0,0,-5000,0,0,0,0,5000,-5000,-5000
042313,聯鈞凱基91購01  ,0,0,0,0,0,0,0,0,0,-5000,0,0,0,51000,56000,-5000,-5000
040987,上証2X凱基92購01,0,0,0,0,0,0,0,0,0,-5000,0,0,0,0,5000,-5000,-5000
03919P,可成凱基93售07  ,0,0,0,0,0,0,0,0,0,-5000,0,0,0,0,5000,-5000,-5000
04062P,可成兆豐93售04  ,0,0,0,0,0,0,0,0,0,-5000,0,0,0,200000,205000,-5000,-5000
03005P,旭富群益01售05  ,0,0,0,0,0,0,0,0,0,-5000,0,0,0,0,5000,-5000,-5000
03243P,台積電統一02售08,0,0,0,0,0,0,0,0,0,-5000,0,0,0,0,5000,-5000,-5000
03399P,欣興中信02售03  ,0,0,0,0,0,0,0,0,0,-5000,0,0,0,25000,30000,-5000,-5000
03409P,台積電元大02售26,0,0,0,0,0,0,0,0,0,-5000,0,0,0,0,5000,-5000,-5000
0051,元大中型100     ,0,1000,-1000,0,0,0,0,0,0,-4000,0,0,0,0,4000,-4000,-5000
00647L,元大S&P500正2   ,0,0,0,0,0,0,0,0,0,-5000,0,0,0,0,5000,-5000,-5000
03605P,美利達統一92售01,0,0,0,0,0,0,0,0,0,-5000,0,0,0,0,5000,-5000,-5000
03751P,旺宏富邦95售01  ,0,0,0,0,0,0,0,0,0,-5000,0,0,0,0,5000,-5000,-5000
046447,儒鴻凱基92購04  ,0,0,0,0,0,0,0,0,0,-5000,0,0,0,0,5000,-5000,-5000
048424,揚明光元富95購01,0,0,0,0,0,0,0,0,0,-5000,0,0,0,0,5000,-5000,-5000
048385,亞德客國票94購01,0,0,0,0,0,0,0,0,0,-5000,0,0,0,0,5000,-5000,-5000
048387,台達電國票94購01,0,0,0,0,0,0,0,0,0,-5000,0,0,0,0,5000,-5000,-5000
047942,華新科國票94購04,0,0,0,0,0,0,0,0,0,-5000,0,0,0,0,5000,-5000,-5000
047979,中石化群益95購01,0,0,0,0,0,0,0,0,0,-5000,0,0,0,30000,35000,-5000,-5000
046681,漢唐群益93購01  ,0,0,0,0,0,0,0,0,0,-5000,0,0,0,5000,10000,-5000,-5000
046593,臺股指元大92購27,0,0,0,0,0,0,0,0,0,-5000,0,0,0,0,5000,-5000,-5000
046528,聯詠中信94購01  ,0,0,0,0,0,0,0,0,0,-5000,0,0,0,20000,25000,-5000,-5000
046486,樺漢國泰94購01  ,0,0,0,0,0,0,0,0,0,-5000,0,0,0,15000,20000,-5000,-5000
048553,光磊元大93購03  ,0,0,0,0,0,0,0,0,0,-5000,0,0,0,38000,43000,-5000,-5000
047023,聯發科元大93購08,0,0,0,0,0,0,0,0,0,-5000,0,0,0,0,5000,-5000,-5000
047046,台積電國票94購01,0,0,0,0,0,0,0,0,0,-5000,0,0,0,0,5000,-5000,-5000
046141,康控統一92購02  ,0,0,0,0,0,0,0,0,0,-5000,0,0,0,5000,10000,-5000,-5000
046170,力山永豐92購02  ,0,0,0,0,0,0,0,0,0,-5000,0,0,0,0,5000,-5000,-5000
046089,南亞科兆豐92購01,0,0,0,0,0,0,0,0,0,-5000,0,0,0,0,5000,-5000,-5000
046806,瀚宇博元大93購03,0,0,0,0,0,0,0,0,0,-5000,0,0,0,10000,15000,-5000,-5000
046757,漢唐凱基93購02  ,0,0,0,0,0,0,0,0,0,-5000,0,0,0,20000,25000,-5000,-5000
046751,鴻海凱基93購18  ,0,0,0,0,0,0,0,0,0,-5000,0,0,0,64000,69000,-5000,-5000
049122,元油2X元富94購07,0,0,0,0,0,0,0,0,0,-5000,0,0,0,0,5000,-5000,-5000
047579,大立光群益94購02,0,0,0,0,0,0,0,0,0,-5000,0,0,0,0,5000,-5000,-5000
047644,揚明光元大94購02,0,0,0,0,0,0,0,0,0,-5000,0,0,0,0,5000,-5000,-5000
047304,元油2X元大96購02,0,0,0,0,0,0,0,0,0,-5000,0,0,0,2000,7000,-5000,-5000
047721,GIS凱基93購04   ,0,0,0,0,0,0,0,0,0,-5000,0,0,0,43000,48000,-5000,-5000
049919,美食元大94購03  ,0,0,0,0,0,0,0,0,0,-5000,0,0,0,0,5000,-5000,-5000
047186,大立光元大93購20,0,0,0,0,0,0,0,0,0,-5000,0,0,0,3000,8000,-5000,-5000
047131,鴻海凱基94購03  ,0,0,0,0,0,0,0,0,0,-5000,0,0,0,24000,29000,-5000,-5000
048143,聯發科統一94購03,0,0,0,0,0,0,0,0,0,-5000,0,0,0,5000,10000,-5000,-5000
048975,玉晶光元大94購03,0,0,0,0,0,0,0,0,0,-5000,0,0,0,10000,15000,-5000,-5000
048984,上緯控元大94購01,0,0,0,0,0,0,0,0,0,-5000,0,0,0,0,5000,-5000,-5000
047448,啟碁元大93購06  ,0,0,0,0,0,0,0,0,0,-5000,0,0,0,41000,46000,-5000,-5000
048865,世紀鋼群益94購01,0,0,0,0,0,0,0,0,0,-5000,0,0,0,0,5000,-5000,-5000
047089,聯詠元富93購03  ,0,0,0,0,0,0,0,0,0,-5000,0,0,0,0,5000,-5000,-5000
048647,正文元大93購01  ,0,0,0,0,0,0,0,0,0,-5000,0,0,0,5000,10000,-5000,-5000
04866P,台積電統一95售02,0,0,0,0,0,0,0,0,0,-5000,0,0,0,0,5000,-5000,-5000
048955,慧洋康和94購01  ,0,0,0,0,0,0,0,0,0,-5000,0,0,0,10000,15000,-5000,-5000
048926,燿華永豐95購01  ,0,0,0,0,0,0,0,0,0,-5000,0,0,0,59000,64000,-5000,-5000
048752,廣越元富95購01  ,0,0,0,0,0,0,0,0,0,-5000,0,0,0,10000,15000,-5000,-5000
048724,台達電日盛94購01,0,0,0,0,0,0,0,0,0,-5000,0,0,0,0,5000,-5000,-5000
05029P,鴻海元富95售04  ,0,0,0,0,0,0,0,0,0,-5000,0,0,0,0,5000,-5000,-5000
050410,燿華永豐95購03  ,0,0,0,0,0,0,0,0,0,-5000,0,0,0,0,5000,-5000,-5000
050852,矽創國票95購02  ,0,0,0,0,0,0,0,0,0,-5000,0,0,0,1000,6000,-5000,-5000
050886,台積電富邦95購04,0,0,0,0,0,0,0,0,0,-5000,0,0,0,10000,15000,-5000,-5000
050783,旺宏國泰96購02  ,0,0,0,0,0,0,0,0,0,-5000,0,0,0,15000,20000,-5000,-5000
049410,統一凱基94購02  ,0,0,0,0,0,0,0,0,0,-5000,0,0,0,2000,7000,-5000,-5000
049434,茂林國票95購01  ,0,0,0,0,0,0,0,0,0,-5000,0,0,0,5000,10000,-5000,-5000
049446,為升統一94購01  ,0,0,0,0,0,0,0,0,0,-5000,0,0,0,15000,20000,-5000,-5000
049447,聯電統一94購01  ,0,0,0,0,0,0,0,0,0,-5000,0,0,0,0,5000,-5000,-5000
04948P,瑞儀元大94售03  ,0,0,0,0,0,0,0,0,0,-5000,0,0,0,50000,55000,-5000,-5000
049655,臺股指凱基94購16,0,0,0,0,0,0,0,0,0,-5000,0,0,0,69000,74000,-5000,-5000
049624,嘉澤群益94購01  ,0,0,0,0,0,0,0,0,0,-5000,0,0,0,132000,137000,-5000,-5000
049633,臺股指群益94購06,0,0,0,0,0,0,0,0,0,-5000,0,0,0,0,5000,-5000,-5000
050167,T50反1富邦96購01,0,0,0,0,0,0,0,0,0,-5000,0,0,0,15000,20000,-5000,-5000
050151,台積電群益94購12,0,0,0,0,0,0,0,0,0,-5000,0,0,0,8000,13000,-5000,-5000
050137,臺指反國票96購01,0,0,0,0,0,0,0,0,0,-5000,0,0,0,0,5000,-5000,-5000
050091,喬山永豐94購02  ,0,0,0,0,0,0,0,0,0,-5000,0,0,0,0,5000,-5000,-5000
050072,京鼎凱基94購02  ,0,0,0,0,0,0,0,0,0,-5000,0,0,0,34000,39000,-5000,-5000
049963,聯發科元富94購02,0,0,0,0,0,0,0,0,0,-5000,0,0,0,0,5000,-5000,-5000
051217,聯發科元富95購01,0,0,0,0,0,0,0,0,0,-5000,0,0,0,0,5000,-5000,-5000
051389,台達電兆豐95購01,0,0,0,0,0,0,0,0,0,-5000,0,0,0,0,5000,-5000,-5000
051342,光寶科元大95購01,0,0,0,0,0,0,0,0,0,-5000,0,0,0,0,5000,-5000,-5000
051345,鴻海元大95購09  ,0,0,0,0,0,0,0,0,0,-5000,0,0,0,480000,485000,-5000,-5000
051322,國泰金國票96購01,0,0,0,0,0,0,0,0,0,-5000,0,0,0,50000,55000,-5000,-5000
051519,國泰金凱基95購02,0,0,0,0,0,0,0,0,0,-5000,0,0,0,9000,14000,-5000,-5000
051515,聯發科凱基95購10,0,0,0,0,0,0,0,0,0,-5000,0,0,0,40000,45000,-5000,-5000
051466,玉晶光富邦97購01,0,0,0,0,0,0,0,0,0,-5000,0,0,0,21000,26000,-5000,-5000
050963,強茂永豐95購01  ,0,0,0,0,0,0,0,0,0,-5000,0,0,0,0,5000,-5000,-5000
051824,華通元大95購07  ,0,0,0,0,0,0,0,0,0,-5000,0,0,0,0,5000,-5000,-5000
05174P,元金2X富邦9B售01,0,0,0,0,0,0,0,0,0,-5000,0,0,0,0,5000,-5000,-5000
051769,矽力元大95購01  ,0,0,0,0,0,0,0,0,0,-5000,0,0,0,2000,7000,-5000,-5000
051635,大立光國票96購04,0,0,0,0,0,0,0,0,0,-5000,0,0,0,0,5000,-5000,-5000
051620,可成凱基95購10  ,0,0,0,0,0,0,0,0,0,-5000,0,0,0,0,5000,-5000,-5000
051729,華新國票96購01  ,0,0,0,0,0,0,0,0,0,-5000,0,0,0,0,5000,-5000,-5000
052169,鴻海元大97購02  ,0,0,0,0,0,0,0,0,0,-5000,0,0,0,335000,340000,-5000,-5000
052059,臺股指凱基95購17,0,0,0,0,0,0,0,0,0,-5000,0,0,0,0,5000,-5000,-5000
051912,健鼎元大96購01  ,0,0,0,0,0,0,0,0,0,-5000,0,0,0,108000,113000,-5000,-5000
9943,好樂迪          ,8000,13000,-5000,0,0,0,0,0,0,0,0,0,0,0,0,0,-5000
3014,聯陽            ,74000,79000,-5000,0,0,0,0,0,0,0,0,0,0,0,0,0,-5000
4148,全宇生技-KY     ,17000,22000,-5000,0,0,0,0,0,0,0,0,0,0,0,0,0,-5000
3550,聯穎            ,0,5000,-5000,0,0,0,0,0,0,0,0,0,0,0,0,0,-5000
5258,虹堡            ,18000,23000,-5000,0,0,0,0,0,0,0,0,0,0,0,0,0,-5000
1817,凱撒衛          ,3000,8000,-5000,0,0,0,0,0,0,0,0,0,0,0,0,0,-5000
05642P,玉晶光兆豐97售02,0,0,0,0,0,0,0,0,0,-5000,0,0,0,0,5000,-5000,-5000
05719P,可成元大96售03  ,0,0,0,0,0,0,0,0,0,-5000,0,0,0,31000,36000,-5000,-5000
05863P,滬深2X元大96售09,0,0,0,0,0,0,0,0,0,-5000,0,0,0,0,5000,-5000,-5000
05804P,美律永豐96售01  ,0,0,0,0,0,0,0,0,0,-5000,0,0,0,93000,98000,-5000,-5000
1465,偉全            ,0,5000,-5000,0,0,0,0,0,0,0,0,0,0,0,0,0,-5000
1539,巨庭            ,0,5000,-5000,0,0,0,0,0,0,0,0,0,0,0,0,0,-5000
05976P,國巨凱基96售14  ,0,0,0,0,0,0,0,0,0,-5000,0,0,0,0,5000,-5000,-5000
1598,岱宇            ,13000,18000,-5000,0,0,0,0,0,0,-231,0,231,-231,0,0,0,-5231
05450P,臺股指元大95售27,0,0,0,0,0,0,0,0,0,-6000,0,0,0,47000,53000,-6000,-6000
054494,訊芯台新96購01  ,0,0,0,0,0,0,0,0,0,-6000,0,0,0,0,6000,-6000,-6000
054765,亞光國票98購02  ,0,0,0,0,0,0,0,0,0,-6000,0,0,0,0,6000,-6000,-6000
053732,S&P反1中信9C購01,0,0,0,0,0,0,0,0,0,-6000,0,0,0,0,6000,-6000,-6000
053637,強茂永豐96購01  ,0,0,0,0,0,0,0,0,0,-6000,0,0,0,66000,72000,-6000,-6000
054060,晶技國票97購02  ,0,0,0,0,0,0,0,0,0,-6000,0,0,0,0,6000,-6000,-6000
052276,力成群益96購01  ,0,0,0,0,0,0,0,0,0,-6000,0,0,0,4000,10000,-6000,-6000
052303,聯發科永豐95購05,0,0,0,0,0,0,0,0,0,-6000,0,0,0,68000,74000,-6000,-6000
052485,深中小國票96購01,0,0,0,0,0,0,0,0,0,-6000,0,0,0,0,6000,-6000,-6000
052422,聯電國票96購03  ,0,0,0,0,0,0,0,0,0,-6000,0,0,0,0,6000,-6000,-6000
052836,旺宏國泰98購01  ,0,0,0,0,0,0,0,0,0,-6000,0,0,0,10000,16000,-6000,-6000
052646,淘帝永豐96購01  ,0,0,0,0,0,0,0,0,0,-6000,0,0,0,0,6000,-6000,-6000
053550,聯發科凱基96購15,0,0,0,0,0,0,0,0,0,-6000,0,0,0,81000,87000,-6000,-6000
053196,康控元富96購01  ,0,0,0,0,0,0,0,0,0,-6000,0,0,0,4000,10000,-6000,-6000
053071,南電群益96購01  ,0,0,0,0,0,0,0,0,0,-6000,0,0,0,7000,13000,-6000,-6000
03642C,臺股指元大94牛27,0,0,0,0,0,0,0,0,0,-6000,0,0,0,0,6000,-6000,-6000
00663L,國泰臺灣加權正2 ,0,0,0,0,0,0,0,0,0,-6000,0,0,0,5000,11000,-6000,-6000
00681R,元大美債20反1   ,0,0,0,0,0,0,0,0,0,-6000,0,0,0,0,6000,-6000,-6000
00682U,元大美元指數    ,0,0,0,0,0,0,0,0,0,-6000,0,0,0,40000,46000,-6000,-6000
040744,滬深2X國票94購01,0,0,0,0,0,0,0,0,0,-6000,0,0,0,0,6000,-6000,-6000
044405,材料凱基93購01  ,0,0,0,0,0,0,0,0,0,-6000,0,0,0,4000,10000,-6000,-6000
044860,元油2X中信93購01,0,0,0,0,0,0,0,0,0,-6000,0,0,0,0,6000,-6000,-6000
046302,亞德客元大92購02,0,0,0,0,0,0,0,0,0,-6000,0,0,0,32000,38000,-6000,-6000
044174,農林統一91購01  ,0,0,0,0,0,0,0,0,0,-6000,0,0,0,0,6000,-6000,-6000
048744,儒鴻元富97購01  ,0,0,0,0,0,0,0,0,0,-6000,0,0,0,89000,95000,-6000,-6000
048089,智邦凱基93購10  ,0,0,0,0,0,0,0,0,0,-6000,0,0,0,0,6000,-6000,-6000
047174,百和永豐93購01  ,0,0,0,0,0,0,0,0,0,-6000,0,0,0,0,6000,-6000,-6000
04769P,高股息元大94售01,0,0,0,0,0,0,0,0,0,-6000,0,0,0,0,6000,-6000,-6000
049007,玉晶光中信96購01,0,0,0,0,0,0,0,0,0,-6000,0,0,0,132000,138000,-6000,-6000
046097,冠德國票92購02  ,0,0,0,0,0,0,0,0,0,-6000,0,0,0,0,6000,-6000,-6000
048063,聯發科統一93購03,0,0,0,0,0,0,0,0,0,-6000,0,0,0,7000,13000,-6000,-6000
048564,智易元大94購01  ,0,0,0,0,0,0,0,0,0,-6000,0,0,0,60000,66000,-6000,-6000
048410,和碩群益93購01  ,0,0,0,0,0,0,0,0,0,-6000,0,0,0,44000,50000,-6000,-6000
047795,臺股指群益93購06,0,0,0,0,0,0,0,0,0,-6000,0,0,0,100000,106000,-6000,-6000
048629,滬深2X元大96購04,0,0,0,0,0,0,0,0,0,-6000,0,0,0,30000,36000,-6000,-6000
052211,台積電元大95購22,0,0,0,0,0,0,0,0,0,-6000,0,0,0,796000,802000,-6000,-6000
050959,元金2X永豐95購02,0,0,0,0,0,0,0,0,0,-6000,0,0,0,47000,53000,-6000,-6000
050939,健鼎國票96購01  ,0,0,0,0,0,0,0,0,0,-6000,0,0,0,145000,151000,-6000,-6000
051012,台積電凱基95購04,0,0,0,0,0,0,0,0,0,-6000,0,0,0,4000,10000,-6000,-6000
051409,美律國票96購01  ,0,0,0,0,0,0,0,0,0,-6000,0,0,0,0,6000,-6000,-6000
051492,臻鼎凱基95購01  ,0,0,0,0,0,0,0,0,0,-6000,0,0,0,30000,36000,-6000,-6000
051268,創意富邦97購01  ,0,0,0,0,0,0,0,0,0,-6000,0,0,0,20000,26000,-6000,-6000
049627,嘉聯益群益94購02,0,0,0,0,0,0,0,0,0,-6000,0,0,0,0,6000,-6000,-6000
04974P,聯發科凱基96售02,0,0,0,0,0,0,0,0,0,-6000,0,0,0,21000,27000,-6000,-6000
050821,國泰金凱基95購01,0,0,0,0,0,0,0,0,0,-6000,0,0,0,5000,11000,-6000,-6000
06090P,旺宏統一97售06  ,0,0,0,0,0,0,0,0,0,-6000,0,0,0,0,6000,-6000,-6000
05845P,大立光元大96售06,0,0,0,0,0,0,0,0,0,-6000,0,0,0,20000,26000,-6000,-6000
2430,燦坤            ,1000,7000,-6000,0,0,0,0,0,0,0,0,0,0,0,0,0,-6000
2417,圓剛            ,23000,29000,-6000,0,0,0,0,0,0,0,0,0,0,0,0,0,-6000
2616,山隆            ,5000,11000,-6000,0,0,0,0,0,0,0,0,0,0,0,0,0,-6000
4999,鑫禾            ,2000,8000,-6000,0,0,0,0,0,0,0,0,0,0,0,0,0,-6000
4576,大銀微系統      ,6000,11000,-5000,0,0,0,0,0,0,-1000,0,1000,-1000,0,0,0,-6000
3028,增你強          ,6000,12000,-6000,0,0,0,0,0,0,0,0,0,0,0,0,0,-6000
3002,歐格            ,1000,7000,-6000,0,0,0,0,0,0,0,0,0,0,0,0,0,-6000
8374,羅昇            ,5000,11000,-6000,0,0,0,0,0,0,0,0,0,0,0,0,0,-6000
053039,聯發科凱基96購11,0,0,0,0,0,0,0,0,0,-7000,0,0,0,66000,73000,-7000,-7000
053170,茂林群益96購04  ,0,0,0,0,0,0,0,0,0,-7000,0,0,0,23000,30000,-7000,-7000
052659,上証2X國票99購01,0,0,0,0,0,0,0,0,0,-7000,0,0,0,0,7000,-7000,-7000
05270P,台表科元大95售05,0,0,0,0,0,0,0,0,0,-7000,0,0,0,58000,65000,-7000,-7000
052698,深中小國票99購01,0,0,0,0,0,0,0,0,0,-7000,0,0,0,5000,12000,-7000,-7000
052798,滬深2X元大96購07,0,0,0,0,0,0,0,0,0,-7000,0,0,0,0,7000,-7000,-7000
052932,正文元大97購01  ,0,0,0,0,0,0,0,0,0,-7000,0,0,0,7000,14000,-7000,-7000
052885,高鐵兆豐98購01  ,0,0,0,0,0,0,0,0,0,-7000,0,0,0,125000,132000,-7000,-7000
052853,友達日盛99購01  ,0,0,0,0,0,0,0,0,0,-7000,0,0,0,0,7000,-7000,-7000
052389,聯發科群益95購05,0,0,0,0,0,0,0,0,0,-7000,0,0,0,4000,11000,-7000,-7000
054138,晶技元大98購02  ,0,0,0,0,0,0,0,0,0,-7000,0,0,0,3000,10000,-7000,-7000
053983,樺漢元大97購02  ,0,0,0,0,0,0,0,0,0,-7000,0,0,0,3000,10000,-7000,-7000
053918,美律國票97購01  ,0,0,0,0,0,0,0,0,0,-7000,0,0,0,0,7000,-7000,-7000
053648,台積電凱基97購04,0,0,0,0,0,0,0,0,0,-7000,0,0,0,3000,10000,-7000,-7000
053801,台積電凱基96購18,0,0,0,0,0,0,0,0,0,-7000,0,0,0,4000,11000,-7000,-7000
053755,亞光元富96購01  ,0,0,0,0,0,0,0,0,0,-7000,0,0,0,0,7000,-7000,-7000
05531P,臺股指群益96售04,0,0,0,0,0,0,0,0,0,-7000,0,0,0,0,7000,-7000,-7000
054648,智原群益98購01  ,0,0,0,0,0,0,0,0,0,-7000,0,0,0,4000,11000,-7000,-7000
047792,美利達群益93購02,0,0,0,0,0,0,0,0,0,-7000,0,0,0,98000,105000,-7000,-7000
044857,玉晶光第一91購01,0,0,0,0,0,0,0,0,0,-7000,0,0,0,0,7000,-7000,-7000
045021,臺股指中信94購02,0,0,0,0,0,0,0,0,0,-7000,0,0,0,0,7000,-7000,-7000
045540,全新群益92購03  ,0,0,0,0,0,0,0,0,0,-7000,0,0,0,33000,40000,-7000,-7000
03935P,可成富邦95售01  ,0,0,0,0,0,0,0,0,0,-7000,0,0,0,0,7000,-7000,-7000
0053,元大電子        ,0,0,0,0,0,0,0,0,0,-7000,0,0,0,0,7000,-7000,-7000
00733,富邦臺灣中小    ,0,0,0,0,0,0,0,0,0,-7000,0,0,0,214000,221000,-7000,-7000
046144,康控元富92購01  ,0,0,0,0,0,0,0,0,0,-7000,0,0,0,18000,25000,-7000,-7000
049069,元油2X凱基95購04,0,0,0,0,0,0,0,0,0,-7000,0,0,0,0,7000,-7000,-7000
049380,欣興元大94購04  ,0,0,0,0,0,0,0,0,0,-7000,0,0,0,10000,17000,-7000,-7000
049311,漢唐凱基94購03  ,0,0,0,0,0,0,0,0,0,-7000,0,0,0,3000,10000,-7000,-7000
049312,亞光凱基94購02  ,0,0,0,0,0,0,0,0,0,-7000,0,0,0,34000,41000,-7000,-7000
047222,鴻海凱基94購04  ,0,0,0,0,0,0,0,0,0,-7000,0,0,0,8000,15000,-7000,-7000
048780,臺股指凱基94購03,0,0,0,0,0,0,0,0,0,-7000,0,0,0,9000,16000,-7000,-7000
050377,華通第一94購01  ,0,0,0,0,0,0,0,0,0,-7000,0,0,0,0,7000,-7000,-7000
049805,美食元大94購02  ,0,0,0,0,0,0,0,0,0,-7000,0,0,0,10000,17000,-7000,-7000
050077,臺股指凱基99購02,0,0,0,0,0,0,0,0,0,-7000,0,0,0,0,7000,-7000,-7000
051222,世紀鋼元富95購01,0,0,0,0,0,0,0,0,0,-7000,0,0,0,15000,22000,-7000,-7000
051688,大立光凱基97購02,0,0,0,0,0,0,0,0,0,-7000,0,0,0,0,7000,-7000,-7000
051682,元黃金凱基97購01,0,0,0,0,0,0,0,0,0,-7000,0,0,0,0,7000,-7000,-7000
051622,和碩凱基96購01  ,0,0,0,0,0,0,0,0,0,-7000,0,0,0,3000,10000,-7000,-7000
6216,居易            ,1000,8000,-7000,0,0,0,0,0,0,0,0,0,0,0,0,0,-7000
5203,訊連            ,33000,37000,-4000,0,0,0,0,0,0,-3000,2000,0,2000,2000,7000,-5000,-7000
4952,凌通            ,16000,23000,-7000,0,0,0,0,0,0,0,0,0,0,0,0,0,-7000
05801P,正崴兆豐96售01  ,0,0,0,0,0,0,0,0,0,-7000,0,0,0,86000,93000,-7000,-7000
05931P,鴻海凱基96售15  ,0,0,0,0,0,0,0,0,0,-7000,0,0,0,14000,21000,-7000,-7000
05755P,臺股指中信99售04,0,0,0,0,0,0,0,0,0,-7000,0,0,0,0,7000,-7000,-7000
06075P,智邦凱基97售02  ,0,0,0,0,0,0,0,0,0,-7000,0,0,0,3000,10000,-7000,-7000
1587,吉茂            ,0,7000,-7000,0,0,0,0,0,0,0,0,0,0,0,0,0,-7000
1413,宏洲            ,0,7000,-7000,0,0,0,0,0,0,0,0,0,0,0,0,0,-7000
054718,可成永豐97購01  ,0,0,0,0,0,0,0,0,0,-8000,0,0,0,0,8000,-8000,-8000
054292,欣興元大96購06  ,0,0,0,0,0,0,0,0,0,-8000,0,0,0,19000,27000,-8000,-8000
054287,台積電元大97購11,0,0,0,0,0,0,0,0,0,-8000,0,0,0,238000,246000,-8000,-8000
054210,台光電國票97購03,0,0,0,0,0,0,0,0,0,-8000,0,0,0,0,8000,-8000,-8000
05359P,嘉澤元大95售02  ,0,0,0,0,0,0,0,0,0,-8000,0,0,0,77000,85000,-8000,-8000
053693,欣興元大96購05  ,0,0,0,0,0,0,0,0,0,-8000,0,0,0,57000,65000,-8000,-8000
054010,致伸元富96購01  ,0,0,0,0,0,0,0,0,0,-8000,0,0,0,0,8000,-8000,-8000
052259,深100富邦95購01 ,0,0,0,0,0,0,0,0,0,-8000,0,0,0,0,8000,-8000,-8000
052453,崇越元大95購01  ,0,0,0,0,0,0,0,0,0,-8000,0,0,0,4000,12000,-8000,-8000
05283P,健鼎元大95售04  ,0,0,0,0,0,0,0,0,0,-8000,0,0,0,110000,118000,-8000,-8000
052943,奇力新國票96購02,0,0,0,0,0,0,0,0,0,-8000,0,0,0,5000,13000,-8000,-8000
053474,聯發科元大97購06,0,0,0,0,0,0,0,0,0,-8000,0,0,0,908000,916000,-8000,-8000
006203,元大MSCI台灣    ,0,1000,-1000,0,0,0,0,0,0,-7000,0,0,0,0,7000,-7000,-8000
00685L,群益臺灣加權正2 ,0,9000,-9000,0,0,0,0,0,0,1000,0,0,0,12000,11000,1000,-8000
04330P,台達電亞東93售02,0,0,0,0,0,0,0,0,0,-8000,0,0,0,12000,20000,-8000,-8000
04466P,大立光元富94售04,0,0,0,0,0,0,0,0,0,-8000,0,0,0,78000,86000,-8000,-8000
04202P,華新科元大93售10,0,0,0,0,0,0,0,0,0,-8000,0,0,0,2000,10000,-8000,-8000
042681,嘉聯益元大92購01,0,0,0,0,0,0,0,0,0,-8000,0,0,0,3000,11000,-8000,-8000
045444,群創元富98購02  ,0,0,0,0,0,0,0,0,0,-8000,0,0,0,0,8000,-8000,-8000
045176,台表科國票92購01,0,0,0,0,0,0,0,0,0,-8000,0,0,0,2000,10000,-8000,-8000
044957,貿聯凱基92購01  ,0,0,0,0,0,0,0,0,0,-8000,0,0,0,105000,113000,-8000,-8000
04774P,金融類元大94售02,0,0,0,0,0,0,0,0,0,-8000,0,0,0,0,8000,-8000,-8000
048293,聯詠群益93購04  ,0,0,0,0,0,0,0,0,0,-8000,0,0,0,16000,24000,-8000,-8000
045630,技嘉凱基93購02  ,0,0,0,0,0,0,0,0,0,-8000,0,0,0,2000,10000,-8000,-8000
047203,TPK元富93購02   ,0,0,0,0,0,0,0,0,0,-8000,0,0,0,12000,20000,-8000,-8000
049179,高鐵凱基94購01  ,0,0,0,0,0,0,0,0,0,-8000,0,0,0,51000,59000,-8000,-8000
046199,致伸凱基92購05  ,0,0,0,0,0,0,0,0,0,-8000,0,0,0,60000,68000,-8000,-8000
046432,宏達電中信94購01,0,0,0,0,0,0,0,0,0,-8000,0,0,0,1000,9000,-8000,-8000
046350,上銀群益92購02  ,0,0,0,0,0,0,0,0,0,-8000,0,0,0,2000,10000,-8000,-8000
051914,健策元大96購06  ,0,0,0,0,0,0,0,0,0,-8000,0,0,0,41000,49000,-8000,-8000
051910,大立光元大97購01,0,0,0,0,0,0,0,0,0,-8000,0,0,0,27000,35000,-8000,-8000
051176,聯發科凱基95購07,0,0,0,0,0,0,0,0,0,-8000,0,0,0,5000,13000,-8000,-8000
050950,健鼎群益96購01  ,0,0,0,0,0,0,0,0,0,-8000,0,0,0,5000,13000,-8000,-8000
050921,旺宏凱基95購02  ,0,0,0,0,0,0,0,0,0,-8000,0,0,0,119000,127000,-8000,-8000
051260,鴻海永昌96購04  ,0,0,0,0,0,0,0,0,0,-8000,0,0,0,3815000,3823000,-8000,-8000
049637,元石油凱基94購01,0,0,0,0,0,0,0,0,0,-8000,0,0,0,0,8000,-8000,-8000
049629,臺股指群益94購02,0,0,0,0,0,0,0,0,0,-8000,0,0,0,8000,16000,-8000,-8000
050347,上証2X群益98購01,0,0,0,0,0,0,0,0,0,-8000,0,0,0,0,8000,-8000,-8000
050288,台積電凱基94購32,0,0,0,0,0,0,0,0,0,-8000,0,0,0,3000,11000,-8000,-8000
050433,華新科凱基94購11,0,0,0,0,0,0,0,0,0,-8000,0,0,0,35000,43000,-8000,-8000
050495,大立光永昌96購01,0,0,0,0,0,0,0,0,0,-8000,0,0,0,4000,12000,-8000,-8000
050553,緯穎凱基94購06  ,0,0,0,0,0,0,0,0,0,-8000,0,0,0,61000,69000,-8000,-8000
1612,宏泰            ,4000,12000,-8000,0,0,0,0,0,0,0,0,0,0,0,0,0,-8000
05579P,友達凱基98售03  ,0,0,0,0,0,0,0,0,0,-8000,0,0,0,12000,20000,-8000,-8000
05904P,大立光統一96售07,0,0,0,0,0,0,0,0,0,-8000,0,0,0,342000,350000,-8000,-8000
4526,東台            ,0,8000,-8000,0,0,0,0,0,0,0,0,0,0,0,0,0,-8000
2832,台產            ,7000,15000,-8000,0,0,0,0,0,0,0,0,0,0,0,0,0,-8000
3021,鴻名            ,0,8000,-8000,0,0,0,0,0,0,0,0,0,0,0,0,0,-8000
8480,泰昇-KY         ,0,6000,-6000,0,0,0,0,2000,-2000,0,0,0,0,0,0,0,-8000
9941A,裕融甲特        ,0,0,0,0,0,0,0,0,0,-8000,2000,10000,-8000,0,0,0,-8000
053464,喬山元大96購01  ,0,0,0,0,0,0,0,0,0,-9000,0,0,0,11000,20000,-9000,-9000
053145,元黃金元大96購02,0,0,0,0,0,0,0,0,0,-9000,0,0,0,1000,10000,-9000,-9000
052858,華通凱基97購02  ,0,0,0,0,0,0,0,0,0,-9000,0,0,0,0,9000,-9000,-9000
052865,大立光凱基96購11,0,0,0,0,0,0,0,0,0,-9000,0,0,0,22000,31000,-9000,-9000
052866,大立光凱基96購12,0,0,0,0,0,0,0,0,0,-9000,0,0,0,1000,10000,-9000,-9000
052752,臺股指元大96購06,0,0,0,0,0,0,0,0,0,-9000,0,0,0,0,9000,-9000,-9000
05222P,致伸凱基95售02  ,0,0,0,0,0,0,0,0,0,-9000,0,0,0,0,9000,-9000,-9000
052277,台達電凱基97購01,0,0,0,0,0,0,0,0,0,-9000,0,0,0,79000,88000,-9000,-9000
053879,元油反中信98購02,0,0,0,0,0,0,0,0,0,-9000,0,0,0,0,9000,-9000,-9000
054273,宏達電中信98購01,0,0,0,0,0,0,0,0,0,-9000,0,0,0,0,9000,-9000,-9000
054504,聯鈞永豐96購01  ,0,0,0,0,0,0,0,0,0,-9000,0,0,0,101000,110000,-9000,-9000
044306,瑞儀兆豐93購02  ,0,0,0,0,0,0,0,0,0,-9000,0,0,0,1000,10000,-9000,-9000
04427P,滬深2X元大97售02,0,0,0,0,0,0,0,0,0,-9000,0,0,0,0,9000,-9000,-9000
048227,亞光凱基93購05  ,0,0,0,0,0,0,0,0,0,-9000,0,0,0,11000,20000,-9000,-9000
045161,玉晶光國泰94購03,0,0,0,0,0,0,0,0,0,-9000,0,0,0,1000,10000,-9000,-9000
043234,緯穎中信93購01  ,0,0,0,0,0,0,0,0,0,-9000,0,0,0,1000,10000,-9000,-9000
04229P,臺股指中信95售05,0,0,0,0,0,0,0,0,0,-9000,0,0,0,1000,10000,-9000,-9000
042173,台灣50永豐93購01,0,0,0,0,0,0,0,0,0,-9000,0,0,0,71000,80000,-9000,-9000
04332P,A50正2日盛93售01,0,0,0,0,0,0,0,0,0,-9000,0,0,0,7000,16000,-9000,-9000
044456,鈺齊永豐91購02  ,0,0,0,0,0,0,0,0,0,-9000,0,0,0,27000,36000,-9000,-9000
00645,富邦日本        ,0,0,0,0,0,0,0,0,0,-9000,0,0,0,92000,101000,-9000,-9000
00714,群益道瓊美國地產,0,0,0,0,0,0,0,0,0,-9000,0,0,0,100000,109000,-9000,-9000
03716P,大成鋼永豐93售01,0,0,0,0,0,0,0,0,0,-9000,0,0,0,10000,19000,-9000,-9000
047810,聯發科凱基93購22,0,0,0,0,0,0,0,0,0,-9000,0,0,0,212000,221000,-9000,-9000
04654P,臺股指凱基94售13,0,0,0,0,0,0,0,0,0,-9000,0,0,0,41000,50000,-9000,-9000
046477,台積電統一94購02,0,0,0,0,0,0,0,0,0,-9000,0,0,0,1000,10000,-9000,-9000
048772,智易凱基94購01  ,0,0,0,0,0,0,0,0,0,-9000,0,0,0,40000,49000,-9000,-9000
048083,台達電凱基93購04,0,0,0,0,0,0,0,0,0,-9000,0,0,0,1000,10000,-9000,-9000
04919P,聯詠凱基94售05  ,0,0,0,0,0,0,0,0,0,-9000,0,0,0,3000,12000,-9000,-9000
049376,奇鋐元大94購02  ,0,0,0,0,0,0,0,0,0,-9000,0,0,0,52000,61000,-9000,-9000
047334,南茂元大93購03  ,0,0,0,0,0,0,0,0,0,-9000,0,0,0,1000,10000,-9000,-9000
050847,創意國票96購01  ,0,0,0,0,0,0,0,0,0,-9000,0,0,0,0,9000,-9000,-9000
050841,國巨國票96購02  ,0,0,0,0,0,0,0,0,0,-9000,0,0,0,70000,79000,-9000,-9000
050784,美律國泰96購01  ,0,0,0,0,0,0,0,0,0,-9000,0,0,0,91000,100000,-9000,-9000
050079,元油2X統一94購06,0,0,0,0,0,0,0,0,0,-9000,0,0,0,0,9000,-9000,-9000
051503,玉晶光統一97購01,0,0,0,0,0,0,0,0,0,-9000,0,0,0,21000,30000,-9000,-9000
051448,聯詠元大95購02  ,0,0,0,0,0,0,0,0,0,-9000,0,0,0,72000,81000,-9000,-9000
050980,欣興元富95購02  ,0,0,0,0,0,0,0,0,0,-9000,0,0,0,11000,20000,-9000,-9000
051184,聯發科永豐95購03,0,0,0,0,0,0,0,0,0,-9000,0,0,0,7000,16000,-9000,-9000
05171P,臺股指元大95售15,0,0,0,0,0,0,0,0,0,-9000,0,0,0,1000,10000,-9000,-9000
910861,神州-DR         ,0,9000,-9000,0,0,0,0,0,0,0,0,0,0,0,0,0,-9000
8462,柏文            ,15000,17000,-2000,0,0,0,0,0,0,-7000,0,0,0,0,7000,-7000,-9000
8201,無敵            ,2000,11000,-9000,0,0,0,0,0,0,0,0,0,0,0,0,0,-9000
3432,台端            ,0,9000,-9000,0,0,0,0,0,0,0,0,0,0,0,0,0,-9000
5305,敦南            ,25000,34000,-9000,0,0,0,0,0,0,0,0,0,0,0,0,0,-9000
2612,中航            ,42000,51000,-9000,0,0,0,0,0,0,0,0,0,0,0,0,0,-9000
2002A,中鋼特          ,0,0,0,0,0,0,0,0,0,-9000,0,9000,-9000,0,0,0,-9000
05888P,友達元大97售01  ,0,0,0,0,0,0,0,0,0,-9000,0,0,0,100000,109000,-9000,-9000
1592,英瑞-KY         ,18000,27000,-9000,0,0,0,0,0,0,0,0,0,0,0,0,0,-9000
054244,華新元大96購01  ,0,0,0,0,0,0,0,0,0,-10000,0,0,0,8000,18000,-10000,-10000
05423P,聯電亞東95售02  ,0,0,0,0,0,0,0,0,0,-10000,0,0,0,0,10000,-10000,-10000
054340,大成鋼元富96購01,0,0,0,0,0,0,0,0,0,-10000,0,0,0,0,10000,-10000,-10000
054743,聯鈞凱基99購01  ,0,0,0,0,0,0,0,0,0,-10000,0,0,0,0,10000,-10000,-10000
054649,聯茂群益97購01  ,0,0,0,0,0,0,0,0,0,-10000,0,0,0,0,10000,-10000,-10000
054644,A50正2群益9B購01,0,0,0,0,0,0,0,0,0,-10000,0,0,0,3000,13000,-10000,-10000
054655,貿聯麥證98購01  ,0,0,0,0,10000,-10000,0,0,0,-10000,0,0,0,0,10000,-10000,-10000
054579,聯茂元大97購01  ,0,0,0,0,0,0,0,0,0,-10000,0,0,0,7000,17000,-10000,-10000
054537,南亞科亞東97購01,0,0,0,0,0,0,0,0,0,-10000,0,0,0,10000,20000,-10000,-10000
053875,GIS元大97購01   ,0,0,0,0,0,0,0,0,0,-10000,0,0,0,0,10000,-10000,-10000
053767,臻鼎富邦97購02  ,0,0,0,0,0,0,0,0,0,-10000,0,0,0,282000,292000,-10000,-10000
053702,智易兆豐97購02  ,0,0,0,0,0,0,0,0,0,-10000,0,0,0,0,10000,-10000,-10000
053722,新光金凱基9C購01,0,0,0,0,0,0,0,0,0,-10000,0,0,0,4000,14000,-10000,-10000
05360P,健策元大95售03  ,0,0,0,0,0,0,0,0,0,-10000,0,0,0,0,10000,-10000,-10000
053643,漢唐國票97購02  ,0,0,0,0,0,0,0,0,0,-10000,0,0,0,0,10000,-10000,-10000
053658,亞光凱基96購01  ,0,0,0,0,0,0,0,0,0,-10000,0,0,0,17000,27000,-10000,-10000
053989,奇力新兆豐97購01,0,0,0,0,0,0,0,0,0,-10000,0,0,0,27000,37000,-10000,-10000
054030,台苯中信98購01  ,0,0,0,0,0,0,0,0,0,-10000,0,0,0,0,10000,-10000,-10000
054027,欣興凱基96購04  ,0,0,0,0,0,0,0,0,0,-10000,0,0,0,20000,30000,-10000,-10000
054028,臻鼎凱基96購03  ,0,0,0,0,0,0,0,0,0,-10000,0,0,0,0,10000,-10000,-10000
053921,嘉晶國票97購03  ,0,0,0,0,0,0,0,0,0,-10000,0,0,0,10000,20000,-10000,-10000
054100,致伸國票97購03  ,0,0,0,0,0,0,0,0,0,-10000,0,0,0,0,10000,-10000,-10000
054116,順德康和96購01  ,0,0,0,0,0,0,0,0,0,-10000,0,0,0,0,10000,-10000,-10000
054123,易華電永豐96購03,0,0,0,0,0,0,0,0,0,-10000,0,0,0,0,10000,-10000,-10000
052274,大立光群益95購03,0,0,0,0,0,0,0,0,0,-10000,0,0,0,23000,33000,-10000,-10000
052249,大成鋼永豐95購01,0,0,0,0,0,0,0,0,0,-10000,0,0,0,10000,20000,-10000,-10000
052550,鴻海國票97購02  ,0,0,0,0,0,0,0,0,0,-10000,0,0,0,0,10000,-10000,-10000
052582,喬山台新96購01  ,0,0,0,0,0,0,0,0,0,-10000,0,0,0,0,10000,-10000,-10000
052531,台積電國泰96購06,0,0,0,0,0,0,0,0,0,-10000,0,0,0,100000,110000,-10000,-10000
052544,牧德元富95購01  ,0,0,0,0,0,0,0,0,0,-10000,0,0,0,0,10000,-10000,-10000
052520,南亞科元大95購06,0,0,0,0,0,0,0,0,0,-10000,0,0,0,0,10000,-10000,-10000
052708,楠梓電永豐97購01,0,0,0,0,0,0,0,0,0,-10000,0,0,0,15000,25000,-10000,-10000
05271P,國巨富邦97售01  ,0,0,0,0,0,0,0,0,0,-10000,0,0,0,0,10000,-10000,-10000
052605,聯發科元大96購06,0,0,0,0,0,0,0,0,0,-10000,0,0,0,0,10000,-10000,-10000
052617,景碩國泰98購01  ,0,0,0,0,0,0,0,0,0,-10000,0,0,0,0,10000,-10000,-10000
052854,聯詠日盛96購01  ,0,0,0,0,0,0,0,0,0,-10000,0,0,0,0,10000,-10000,-10000
052847,漢唐統一99購01  ,0,0,0,0,0,0,0,0,0,-10000,0,0,0,56000,66000,-10000,-10000
052911,友達統一97購02  ,0,0,0,0,0,0,0,0,0,-10000,0,0,0,0,10000,-10000,-10000
052905,潤泰全國票97購01,0,0,0,0,0,0,0,0,0,-10000,0,0,0,0,10000,-10000,-10000
052839,上海銀國泰97購01,0,0,0,0,0,0,0,0,0,-10000,0,0,0,10000,20000,-10000,-10000
053094,聯電統一97購02  ,0,0,0,0,0,0,0,0,0,-10000,0,0,0,20000,30000,-10000,-10000
053105,鴻海兆豐97購01  ,0,0,0,0,0,0,0,0,0,-10000,0,0,0,0,10000,-10000,-10000
053190,聯發科統一99購01,0,0,0,0,0,0,0,0,0,-10000,0,0,0,0,10000,-10000,-10000
053217,群創凱基99購02  ,0,0,0,0,0,0,0,0,0,-10000,0,0,0,10000,20000,-10000,-10000
05323P,瑞昱凱基96售02  ,0,0,0,0,0,0,0,0,0,-10000,0,0,0,0,10000,-10000,-10000
052956,聯發科日盛96購01,0,0,0,0,0,0,0,0,0,-10000,0,0,0,10000,20000,-10000,-10000
052989,麗豐元大98購01  ,0,0,0,0,0,0,0,0,0,-10000,0,0,0,0,10000,-10000,-10000
053044,南茂凱基96購02  ,0,0,0,0,0,0,0,0,0,-10000,0,0,0,0,10000,-10000,-10000
053080,力山元大96購02  ,0,0,0,0,0,0,0,0,0,-10000,0,0,0,0,10000,-10000,-10000
053448,智易凱基96購03  ,0,0,0,0,0,0,0,0,0,-10000,0,0,0,0,10000,-10000,-10000
053431,志超永豐96購01  ,0,0,0,0,0,0,0,0,0,-10000,0,0,0,0,10000,-10000,-10000
053516,茂林群益96購05  ,0,0,0,0,0,0,0,0,0,-10000,0,0,0,0,10000,-10000,-10000
053502,智伸科兆豐97購01,0,0,0,0,0,0,0,0,0,-10000,0,0,0,0,10000,-10000,-10000
053271,喬山元大97購01  ,0,0,0,0,0,0,0,0,0,-10000,0,0,0,3000,13000,-10000,-10000
053272,鴻海元大96購17  ,0,0,0,0,0,0,0,0,0,-10000,0,0,0,353000,363000,-10000,-10000
053326,瀚宇博台新96購01,0,0,0,0,0,0,0,0,0,-10000,0,0,0,0,10000,-10000,-10000
053316,友達群益9A購01  ,0,0,0,0,0,0,0,0,0,-10000,0,0,0,0,10000,-10000,-10000
053379,南亞科元大96購01,0,0,0,0,0,0,0,0,0,-10000,0,0,0,6000,16000,-10000,-10000
036628,統一台新99購01  ,0,0,0,0,0,0,0,0,0,-10000,0,0,0,0,10000,-10000,-10000
03695P,台表科永豐93售01,0,0,0,0,0,0,0,0,0,-10000,0,0,0,0,10000,-10000,-10000
03673P,康控元富92售02  ,0,0,0,0,0,0,0,0,0,-10000,0,0,0,0,10000,-10000,-10000
03607P,滬深2X富邦95售01,0,0,0,0,0,0,0,0,0,-10000,0,0,0,2000,12000,-10000,-10000
03792P,台光電永豐93售01,0,0,0,0,0,0,0,0,0,-10000,0,0,0,0,10000,-10000,-10000
03103P,聯發科元富01售02,0,0,0,0,0,0,0,0,0,-10000,0,0,0,0,10000,-10000,-10000
03173P,台灣50國票03售02,0,0,0,0,0,0,0,0,0,-10000,0,0,0,20000,30000,-10000,-10000
03175P,台積電國票03售04,0,0,0,0,0,0,0,0,0,-10000,0,0,0,40000,50000,-10000,-10000
03889P,國巨國泰94售04  ,0,0,0,0,0,0,0,0,0,-10000,0,0,0,0,10000,-10000,-10000
03414P,臺股指元大03售06,0,0,0,0,0,0,0,0,0,-10000,0,0,0,10000,20000,-10000,-10000
03347P,欣興台新02售01  ,0,0,0,0,0,0,0,0,0,-10000,0,0,0,0,10000,-10000,-10000
03191P,國巨國泰03售02  ,0,0,0,0,0,0,0,0,0,-10000,0,0,0,0,10000,-10000,-10000
03264P,聯茂國票04售01  ,0,0,0,0,0,0,0,0,0,-10000,0,0,0,0,10000,-10000,-10000
03271P,台積電群益02售06,0,0,0,0,0,0,0,0,0,-10000,0,0,0,0,10000,-10000,-10000
03035X,元展32          ,0,0,0,0,0,0,0,0,0,-10000,0,0,0,0,10000,-10000,-10000
044421,華邦電元富91購01,0,0,0,0,0,0,0,0,0,-10000,0,0,0,10000,20000,-10000,-10000
044399,南亞科凱基91購10,0,0,0,0,0,0,0,0,0,-10000,0,0,0,0,10000,-10000,-10000
043625,上銀凱基91購03  ,0,0,0,0,0,0,0,0,0,-10000,0,0,0,0,10000,-10000,-10000
044312,A50正2永豐92購01,0,0,0,0,0,0,0,0,0,-10000,0,0,0,450000,460000,-10000,-10000
044314,宏達電永豐91購01,0,0,0,0,0,0,0,0,0,-10000,0,0,0,0,10000,-10000,-10000
04344P,台達電國泰94售01,0,0,0,0,0,0,0,0,0,-10000,0,0,0,151000,161000,-10000,-10000
043585,道瓊反元大94購01,0,0,0,0,0,0,0,0,0,-10000,0,0,0,0,10000,-10000,-10000
044650,百和群益93購01  ,0,0,0,0,0,0,0,0,0,-10000,0,0,0,0,10000,-10000,-10000
044605,超眾國泰93購02  ,0,0,0,0,0,0,0,0,0,-10000,0,0,0,20000,30000,-10000,-10000
044678,南亞科凱基91購13,0,0,0,0,0,0,0,0,0,-10000,0,0,0,0,10000,-10000,-10000
044679,南亞科凱基91購14,0,0,0,0,0,0,0,0,0,-10000,0,0,0,0,10000,-10000,-10000
044517,新日興凱基91購01,0,0,0,0,0,0,0,0,0,-10000,0,0,0,0,10000,-10000,-10000
044571,南亞科凱基91購11,0,0,0,0,0,0,0,0,0,-10000,0,0,0,0,10000,-10000,-10000
044568,台積電凱基91購19,0,0,0,0,0,0,0,0,0,-10000,0,0,0,0,10000,-10000,-10000
04106P,滬深2X永豐93售02,0,0,0,0,0,0,0,0,0,-10000,0,0,0,0,10000,-10000,-10000
04107P,元黃金中信94售01,0,0,0,0,0,0,0,0,0,-10000,0,0,0,0,10000,-10000,-10000
041546,群創統一93購01  ,0,0,0,0,0,0,0,0,0,-10000,0,0,0,0,10000,-10000,-10000
041527,T50反1中信96購01,0,0,0,0,0,0,0,0,0,-10000,0,0,0,40000,50000,-10000,-10000
04188P,康控元富93售03  ,0,0,0,0,0,0,0,0,0,-10000,0,0,0,40000,50000,-10000,-10000
043231,鴻海中信95購01  ,0,0,0,0,0,0,0,0,0,-10000,0,0,0,30000,40000,-10000,-10000
04312P,聯茂統一93售02  ,0,0,0,0,0,0,0,0,0,-10000,0,0,0,0,10000,-10000,-10000
042784,上銀兆豐93購01  ,0,0,0,0,0,0,0,0,0,-10000,0,0,0,0,10000,-10000,-10000
042805,智邦統一93購01  ,0,0,0,0,0,0,0,0,0,-10000,0,0,0,0,10000,-10000,-10000
042441,大立光中信91購02,0,0,0,0,0,0,0,0,0,-10000,0,0,0,0,10000,-10000,-10000
045162,玉晶光國泰94購04,0,0,0,0,0,0,0,0,0,-10000,0,0,0,0,10000,-10000,-10000
045150,聯發科凱基93購03,0,0,0,0,0,0,0,0,0,-10000,0,0,0,0,10000,-10000,-10000
045151,大立光凱基93購02,0,0,0,0,0,0,0,0,0,-10000,0,0,0,0,10000,-10000,-10000
045092,聯茂元大92購03  ,0,0,0,0,0,0,0,0,0,-10000,0,0,0,0,10000,-10000,-10000
044991,T50反1國泰93購02,0,0,0,0,0,0,0,0,0,-10000,0,0,0,0,10000,-10000,-10000
044954,可成凱基92購01  ,0,0,0,0,0,0,0,0,0,-10000,0,0,0,0,10000,-10000,-10000
04492P,元油2X永豐94售03,0,0,0,0,0,0,0,0,0,-10000,0,0,0,0,10000,-10000,-10000
044935,玉晶光元大93購03,0,0,0,0,0,0,0,0,0,-10000,0,0,0,0,10000,-10000,-10000
044761,嘉澤凱基91購07  ,0,0,0,0,0,0,0,0,0,-10000,0,0,0,0,10000,-10000,-10000
044756,強茂凱基93購01  ,0,0,0,0,0,0,0,0,0,-10000,0,0,0,0,10000,-10000,-10000
044798,鴻海凱基93購09  ,0,0,0,0,0,0,0,0,0,-10000,0,0,0,300000,310000,-10000,-10000
044769,智邦元大91購03  ,0,0,0,0,0,0,0,0,0,-10000,0,0,0,0,10000,-10000,-10000
044773,創意元大93購02  ,0,0,0,0,0,0,0,0,0,-10000,0,0,0,0,10000,-10000,-10000
044802,南亞科凱基91購17,0,0,0,0,0,0,0,0,0,-10000,0,0,0,0,10000,-10000,-10000
04484P,台積電凱基94售09,0,0,0,0,0,0,0,0,0,-10000,0,0,0,0,10000,-10000,-10000
045196,瑞儀群益92購01  ,0,0,0,0,0,0,0,0,0,-10000,0,0,0,0,10000,-10000,-10000
045220,漢唐元大94購01  ,0,0,0,0,0,0,0,0,0,-10000,0,0,0,0,10000,-10000,-10000
045243,可成群益92購03  ,0,0,0,0,0,0,0,0,0,-10000,0,0,0,0,10000,-10000,-10000
045234,元黃金台新92購01,0,0,0,0,0,0,0,0,0,-10000,0,0,0,0,10000,-10000,-10000
045275,台光電統一92購03,0,0,0,0,0,0,0,0,0,-10000,0,0,0,2000,12000,-10000,-10000
045265,和鑫凱基94購01  ,0,0,0,0,0,0,0,0,0,-10000,0,0,0,0,10000,-10000,-10000
045255,華邦電凱基93購03,0,0,0,0,0,0,0,0,0,-10000,0,0,0,100000,110000,-10000,-10000
045453,上銀元大92購07  ,0,0,0,0,0,0,0,0,0,-10000,0,0,0,0,10000,-10000,-10000
045454,上銀元大93購01  ,0,0,0,0,0,0,0,0,0,-10000,0,0,0,1000,11000,-10000,-10000
045412,宏達電群益93購01,0,0,0,0,0,0,0,0,0,-10000,0,0,0,5000,15000,-10000,-10000
045357,麗豐凱基92購01  ,0,0,0,0,0,0,0,0,0,-10000,0,0,0,0,10000,-10000,-10000
045359,瑞儀凱基92購01  ,0,0,0,0,0,0,0,0,0,-10000,0,0,0,0,10000,-10000,-10000
04392P,牧德凱基94售05  ,0,0,0,0,0,0,0,0,0,-10000,0,0,0,0,10000,-10000,-10000
043920,瑞儀凱基93購01  ,0,0,0,0,0,0,0,0,0,-10000,0,0,0,0,10000,-10000,-10000
043951,喬山統一91購03  ,0,0,0,0,0,0,0,0,0,-10000,0,0,0,0,10000,-10000,-10000
044001,南亞科兆豐91購02,0,0,0,0,0,0,0,0,0,-10000,0,0,0,0,10000,-10000,-10000
048267,元金反中信93購01,0,0,0,0,0,0,0,0,0,-10000,0,0,0,0,10000,-10000,-10000
048259,新日興統一93購01,0,0,0,0,0,0,0,0,0,-10000,0,0,0,98000,108000,-10000,-10000
048296,康控群益93購03  ,0,0,0,0,0,0,0,0,0,-10000,0,0,0,10000,20000,-10000,-10000
048335,和大元大93購03  ,0,0,0,0,0,0,0,0,0,-10000,0,0,0,34000,44000,-10000,-10000
047735,華邦電台新94購01,0,0,0,0,0,0,0,0,0,-10000,0,0,0,0,10000,-10000,-10000
047736,聯發科台新94購01,0,0,0,0,0,0,0,0,0,-10000,0,0,0,0,10000,-10000,-10000
047751,玉山金元富93購01,0,0,0,0,0,0,0,0,0,-10000,0,0,0,0,10000,-10000,-10000
048212,美利達日盛93購01,0,0,0,0,0,0,0,0,0,-10000,0,0,0,0,10000,-10000,-10000
045802,國巨國票92購02  ,0,0,0,0,0,0,0,0,0,-10000,0,0,0,0,10000,-10000,-10000
046267,大立光凱基92購09,0,0,0,0,0,0,0,0,0,-10000,0,0,0,0,10000,-10000,-10000
046271,日月光凱基92購05,0,0,0,0,0,0,0,0,0,-10000,0,0,0,10000,20000,-10000,-10000
046252,冠德群益92購01  ,0,0,0,0,0,0,0,0,0,-10000,0,0,0,0,10000,-10000,-10000
044220,欣興凱基91購05  ,0,0,0,0,0,0,0,0,0,-10000,0,0,0,0,10000,-10000,-10000
045633,南亞科凱基92購02,0,0,0,0,0,0,0,0,0,-10000,0,0,0,0,10000,-10000,-10000
044171,訊芯元大91購02  ,0,0,0,0,0,0,0,0,0,-10000,0,0,0,0,10000,-10000,-10000
044178,和碩統一91購01  ,0,0,0,0,0,0,0,0,0,-10000,0,0,0,0,10000,-10000,-10000
044128,欣興凱基92購01  ,0,0,0,0,0,0,0,0,0,-10000,0,0,0,0,10000,-10000,-10000
045641,聯詠凱基92購05  ,0,0,0,0,0,0,0,0,0,-10000,0,0,0,0,10000,-10000,-10000
045660,欣興富邦93購03  ,0,0,0,0,0,0,0,0,0,-10000,0,0,0,0,10000,-10000,-10000
043790,南亞科凱基91購07,0,0,0,0,0,0,0,0,0,-10000,0,0,0,0,10000,-10000,-10000
04574P,台達電統一94售05,0,0,0,0,0,0,0,0,0,-10000,0,0,0,20000,30000,-10000,-10000
045710,儒鴻凱基92購02  ,0,0,0,0,0,0,0,0,0,-10000,0,0,0,0,10000,-10000,-10000
043898,可成群益92購02  ,0,0,0,0,0,0,0,0,0,-10000,0,0,0,10000,20000,-10000,-10000
047344,亞德客凱基93購02,0,0,0,0,0,0,0,0,0,-10000,0,0,0,0,10000,-10000,-10000
047315,大立光元大93購23,0,0,0,0,0,0,0,0,0,-10000,0,0,0,3000,13000,-10000,-10000
047655,聯發科兆豐93購02,0,0,0,0,0,0,0,0,0,-10000,0,0,0,1000,11000,-10000,-10000
047537,聯發科日盛93購01,0,0,0,0,0,0,0,0,0,-10000,0,0,0,0,10000,-10000,-10000
047560,超眾凱基94購01  ,0,0,0,0,0,0,0,0,0,-10000,0,0,0,0,10000,-10000,-10000
047589,奇鋐永豐93購01  ,0,0,0,0,0,0,0,0,0,-10000,0,0,0,0,10000,-10000,-10000
049326,聯發科元富94購01,0,0,0,0,0,0,0,0,0,-10000,0,0,0,0,10000,-10000,-10000
049330,元上證統一94購03,0,0,0,0,0,0,0,0,0,-10000,0,0,0,0,10000,-10000,-10000
049936,柏文元大94購02  ,0,0,0,0,0,0,0,0,0,-10000,0,0,0,0,10000,-10000,-10000
047712,宏達電凱基93購01,0,0,0,0,0,0,0,0,0,-10000,0,0,0,0,10000,-10000,-10000
047699,亞德客凱基93購04,0,0,0,0,0,0,0,0,0,-10000,0,0,0,0,10000,-10000,-10000
047705,燿華凱基94購01  ,0,0,0,0,0,0,0,0,0,-10000,0,0,0,10000,20000,-10000,-10000
049373,大立光元大94購11,0,0,0,0,0,0,0,0,0,-10000,0,0,0,3000,13000,-10000,-10000
049366,聯發科元大94購05,0,0,0,0,0,0,0,0,0,-10000,0,0,0,0,10000,-10000,-10000
049367,全新元大96購01  ,0,0,0,0,0,0,0,0,0,-10000,0,0,0,13000,23000,-10000,-10000
049195,全新永豐94購02  ,0,0,0,0,0,0,0,0,0,-10000,0,0,0,68000,78000,-10000,-10000
049218,燿華國票94購02  ,0,0,0,0,0,0,0,0,0,-10000,0,0,0,0,10000,-10000,-10000
049201,劍麟群益94購01  ,0,0,0,0,0,0,0,0,0,-10000,0,0,0,0,10000,-10000,-10000
049241,智邦元富94購01  ,0,0,0,0,0,0,0,0,0,-10000,0,0,0,5000,15000,-10000,-10000
049243,佳世達元富96購02,0,0,0,0,0,0,0,0,0,-10000,0,0,0,0,10000,-10000,-10000
049344,華固統一94購01  ,0,0,0,0,0,0,0,0,0,-10000,0,0,0,10000,20000,-10000,-10000
049066,元石油凱基97購01,0,0,0,0,0,0,0,0,0,-10000,0,0,0,0,10000,-10000,-10000
049955,崇越群益95購01  ,0,0,0,0,0,0,0,0,0,-10000,0,0,0,0,10000,-10000,-10000
049090,茂林凱基94購01  ,0,0,0,0,0,0,0,0,0,-10000,0,0,0,0,10000,-10000,-10000
049134,為升元大95購01  ,0,0,0,0,0,0,0,0,0,-10000,0,0,0,14000,24000,-10000,-10000
04912P,可成元富94售06  ,0,0,0,0,0,0,0,0,0,-10000,0,0,0,0,10000,-10000,-10000
049174,台積電凱基94購11,0,0,0,0,0,0,0,0,0,-10000,0,0,0,100000,110000,-10000,-10000
049156,緯穎元大96購01  ,0,0,0,0,0,0,0,0,0,-10000,0,0,0,175000,185000,-10000,-10000
048156,正崴兆豐93購01  ,0,0,0,0,0,0,0,0,0,-10000,0,0,0,0,10000,-10000,-10000
047221,日月光麥證93購01,0,0,0,50000,60000,-10000,0,0,0,-10000,0,0,0,50000,60000,-10000,-10000
047247,淘帝群益93購01  ,0,0,0,0,0,0,0,0,0,-10000,0,0,0,0,10000,-10000,-10000
047258,亞德客國票93購01,0,0,0,0,0,0,0,0,0,-10000,0,0,0,0,10000,-10000,-10000
047458,聯發科群益93購08,0,0,0,0,0,0,0,0,0,-10000,0,0,0,20000,30000,-10000,-10000
047170,廣宇永豐93購01  ,0,0,0,0,0,0,0,0,0,-10000,0,0,0,0,10000,-10000,-10000
047195,滬深2X統一93購01,0,0,0,0,0,0,0,0,0,-10000,0,0,0,0,10000,-10000,-10000
047142,中磊兆豐93購02  ,0,0,0,0,0,0,0,0,0,-10000,0,0,0,0,10000,-10000,-10000
048091,漢唐凱基93購03  ,0,0,0,0,0,0,0,0,0,-10000,0,0,0,10000,20000,-10000,-10000
048115,樺漢群益93購01  ,0,0,0,0,0,0,0,0,0,-10000,0,0,0,0,10000,-10000,-10000
048133,臻鼎國票94購01  ,0,0,0,0,0,0,0,0,0,-10000,0,0,0,0,10000,-10000,-10000
048137,力成國票93購01  ,0,0,0,0,0,0,0,0,0,-10000,0,0,0,0,10000,-10000,-10000
048112,宏達電群益93購05,0,0,0,0,0,0,0,0,0,-10000,0,0,0,100000,110000,-10000,-10000
048785,台積電元大96購01,0,0,0,0,0,0,0,0,0,-10000,0,0,0,0,10000,-10000,-10000
048755,志超元富96購01  ,0,0,0,0,0,0,0,0,0,-10000,0,0,0,0,10000,-10000,-10000
048762,寶齡凱基94購01  ,0,0,0,0,0,0,0,0,0,-10000,0,0,0,0,10000,-10000,-10000
048725,京元電日盛94購01,0,0,0,0,0,0,0,0,0,-10000,0,0,0,0,10000,-10000,-10000
048721,正文永豐94購01  ,0,0,0,0,0,0,0,0,0,-10000,0,0,0,0,10000,-10000,-10000
048728,台達電麥證94購01,0,0,0,30000,40000,-10000,0,0,0,-10000,0,0,0,30000,40000,-10000,-10000
048692,致伸群益94購01  ,0,0,0,0,0,0,0,0,0,-10000,0,0,0,0,10000,-10000,-10000
048702,正文國票95購01  ,0,0,0,0,0,0,0,0,0,-10000,0,0,0,0,10000,-10000,-10000
048806,光磊中信94購01  ,0,0,0,0,0,0,0,0,0,-10000,0,0,0,0,10000,-10000,-10000
048793,超眾元大95購02  ,0,0,0,0,0,0,0,0,0,-10000,0,0,0,43000,53000,-10000,-10000
048825,華新科凱基94購05,0,0,0,0,0,0,0,0,0,-10000,0,0,0,2000,12000,-10000,-10000
048822,燿華凱基94購03  ,0,0,0,0,0,0,0,0,0,-10000,0,0,0,0,10000,-10000,-10000
048862,中磊群益94購01  ,0,0,0,0,0,0,0,0,0,-10000,0,0,0,7000,17000,-10000,-10000
047085,柏文永豐93購01  ,0,0,0,0,0,0,0,0,0,-10000,0,0,0,0,10000,-10000,-10000
047091,南茂元富93購01  ,0,0,0,0,0,0,0,0,0,-10000,0,0,0,10000,20000,-10000,-10000
047094,聯發科麥證93購02,0,0,0,1000,10000,-9000,0,0,0,-10000,0,0,0,1000,11000,-10000,-10000
047081,晶技康和93購01  ,0,0,0,0,0,0,0,0,0,-10000,0,0,0,0,10000,-10000,-10000
047058,聯茂國票94購01  ,0,0,0,0,0,0,0,0,0,-10000,0,0,0,0,10000,-10000,-10000
048684,上海銀富邦93購02,0,0,0,0,0,0,0,0,0,-10000,0,0,0,0,10000,-10000,-10000
048080,元石油凱基96購01,0,0,0,0,0,0,0,0,0,-10000,0,0,0,0,10000,-10000,-10000
048071,創意元富93購03  ,0,0,0,0,0,0,0,0,0,-10000,0,0,0,0,10000,-10000,-10000
048051,大立光中信94購03,0,0,0,0,0,0,0,0,0,-10000,0,0,0,0,10000,-10000,-10000
047401,南茂永豐93購01  ,0,0,0,0,0,0,0,0,0,-10000,0,0,0,0,10000,-10000,-10000
047005,南亞科統一93購03,0,0,0,0,0,0,0,0,0,-10000,0,0,0,0,10000,-10000,-10000
048018,南亞科麥證93購01,0,0,0,0,10000,-10000,0,0,0,-10000,0,0,0,0,10000,-10000,-10000
046172,美律永豐92購01  ,0,0,0,0,0,0,0,0,0,-10000,0,0,0,21000,31000,-10000,-10000
046191,新光金凱基98購01,0,0,0,0,0,0,0,0,0,-10000,0,0,0,10000,20000,-10000,-10000
046156,光磊群益92購01  ,0,0,0,0,0,0,0,0,0,-10000,0,0,0,0,10000,-10000,-10000
046142,康舒統一93購01  ,0,0,0,0,0,0,0,0,0,-10000,0,0,0,0,10000,-10000,-10000
046969,聯發科群益93購05,0,0,0,0,0,0,0,0,0,-10000,0,0,0,6000,16000,-10000,-10000
048033,大立光凱基93購28,0,0,0,0,0,0,0,0,0,-10000,0,0,0,110000,120000,-10000,-10000
046940,瑞昱元大93購07  ,0,0,0,0,0,0,0,0,0,-10000,0,0,0,0,10000,-10000,-10000
046931,聯詠統一93購01  ,0,0,0,0,0,0,0,0,0,-10000,0,0,0,0,10000,-10000,-10000
046011,欣興元富95購01  ,0,0,0,0,0,0,0,0,0,-10000,0,0,0,0,10000,-10000,-10000
046056,材料群益92購01  ,0,0,0,0,0,0,0,0,0,-10000,0,0,0,0,10000,-10000,-10000
046057,致伸群益92購01  ,0,0,0,0,0,0,0,0,0,-10000,0,0,0,0,10000,-10000,-10000
046058,訊芯群益92購01  ,0,0,0,0,0,0,0,0,0,-10000,0,0,0,0,10000,-10000,-10000
045980,百和凱基93購03  ,0,0,0,0,0,0,0,0,0,-10000,0,0,0,0,10000,-10000,-10000
045985,台達電永昌93購01,0,0,0,0,0,0,0,0,0,-10000,0,0,0,0,10000,-10000,-10000
045986,南亞科永昌93購01,0,0,0,0,0,0,0,0,0,-10000,0,0,0,48000,58000,-10000,-10000
045959,京元電凱基92購05,0,0,0,0,0,0,0,0,0,-10000,0,0,0,0,10000,-10000,-10000
048000,義隆元大93購03  ,0,0,0,0,0,0,0,0,0,-10000,0,0,0,0,10000,-10000,-10000
046755,瑞昱凱基93購05  ,0,0,0,0,0,0,0,0,0,-10000,0,0,0,0,10000,-10000,-10000
046771,聯發科國泰94購02,0,0,0,0,0,0,0,0,0,-10000,0,0,0,10000,20000,-10000,-10000
046871,美律元富93購01  ,0,0,0,0,0,0,0,0,0,-10000,0,0,0,25000,35000,-10000,-10000
04682P,臺股指統一96售01,0,0,0,0,0,0,0,0,0,-10000,0,0,0,10000,20000,-10000,-10000
045856,南亞科國泰94購01,0,0,0,0,0,0,0,0,0,-10000,0,0,0,0,10000,-10000,-10000
047974,新光金兆豐93購01,0,0,0,0,0,0,0,0,0,-10000,0,0,0,10000,20000,-10000,-10000
046707,友達康和93購01  ,0,0,0,0,0,0,0,0,0,-10000,0,0,0,0,10000,-10000,-10000
046597,可成亞東93購01  ,0,0,0,0,0,0,0,0,0,-10000,0,0,0,0,10000,-10000,-10000
046591,康舒元大92購01  ,0,0,0,0,0,0,0,0,0,-10000,0,0,0,21000,31000,-10000,-10000
046560,南亞科凱基92購04,0,0,0,0,0,0,0,0,0,-10000,0,0,0,0,10000,-10000,-10000
046660,宏達電元大93購07,0,0,0,0,0,0,0,0,0,-10000,0,0,0,0,10000,-10000,-10000
047941,義隆國票94購02  ,0,0,0,0,0,0,0,0,0,-10000,0,0,0,0,10000,-10000,-10000
046646,冠德國泰94購01  ,0,0,0,0,0,0,0,0,0,-10000,0,0,0,0,10000,-10000,-10000
046468,日月光台新92購01,0,0,0,0,0,0,0,0,0,-10000,0,0,0,0,10000,-10000,-10000
046514,群創元大92購12  ,0,0,0,0,0,0,0,0,0,-10000,0,0,0,0,10000,-10000,-10000
047910,全新麥證94購01  ,0,0,0,50000,60000,-10000,0,0,0,-10000,0,0,0,50000,60000,-10000,-10000
047932,麗豐凱基93購01  ,0,0,0,0,0,0,0,0,0,-10000,0,0,0,30000,40000,-10000,-10000
047927,宏達電凱基93購03,0,0,0,0,0,0,0,0,0,-10000,0,0,0,0,10000,-10000,-10000
048561,可成元大93購13  ,0,0,0,0,0,0,0,0,0,-10000,0,0,0,12000,22000,-10000,-10000
048611,宏達電凱基93購04,0,0,0,0,0,0,0,0,0,-10000,0,0,0,16000,26000,-10000,-10000
048612,嘉晶凱基93購05  ,0,0,0,0,0,0,0,0,0,-10000,0,0,0,110000,120000,-10000,-10000
048585,瑞儀富邦93購01  ,0,0,0,0,0,0,0,0,0,-10000,0,0,0,0,10000,-10000,-10000
04857P,美律元富94售01  ,0,0,0,0,0,0,0,0,0,-10000,0,0,0,10000,20000,-10000,-10000
047821,臺股指凱基93購15,0,0,0,0,0,0,0,0,0,-10000,0,0,0,10000,20000,-10000,-10000
046348,嘉澤兆豐93購01  ,0,0,0,0,0,0,0,0,0,-10000,0,0,0,0,10000,-10000,-10000
047852,矽創元富93購01  ,0,0,0,0,0,0,0,0,0,-10000,0,0,0,0,10000,-10000,-10000
047832,漢唐元大94購03  ,0,0,0,0,0,0,0,0,0,-10000,0,0,0,0,10000,-10000,-10000
048376,台達電元富93購01,0,0,0,0,0,0,0,0,0,-10000,0,0,0,0,10000,-10000,-10000
048420,祥碩統一93購01  ,0,0,0,0,0,0,0,0,0,-10000,0,0,0,0,10000,-10000,-10000
048460,盛群凱基94購01  ,0,0,0,0,0,0,0,0,0,-10000,0,0,0,10000,20000,-10000,-10000
046446,技嘉麥證92購01  ,0,0,0,0,10000,-10000,0,0,0,-10000,0,0,0,0,10000,-10000,-10000
046456,聯發科凱基92購08,0,0,0,0,0,0,0,0,0,-10000,0,0,0,0,10000,-10000,-10000
046369,同欣電日盛92購01,0,0,0,0,0,0,0,0,0,-10000,0,0,0,0,10000,-10000,-10000
04638P,臺股指群益94售13,0,0,0,0,0,0,0,0,0,-10000,0,0,0,0,10000,-10000,-10000
048541,緯穎台新93購01  ,0,0,0,0,0,0,0,0,0,-10000,0,0,0,0,10000,-10000,-10000
048532,大立光國票93購06,0,0,0,0,0,0,0,0,0,-10000,0,0,0,0,10000,-10000,-10000
048523,TPK元富94購01   ,0,0,0,0,0,0,0,0,0,-10000,0,0,0,10000,20000,-10000,-10000
04846P,旺宏凱基94售07  ,0,0,0,0,0,0,0,0,0,-10000,0,0,0,0,10000,-10000,-10000
048487,華邦電富邦93購02,0,0,0,0,0,0,0,0,0,-10000,0,0,0,0,10000,-10000,-10000
051713,大立光台新95購03,0,0,0,0,0,0,0,0,0,-10000,0,0,0,0,10000,-10000,-10000
051708,創意群益95購02  ,0,0,0,0,0,0,0,0,0,-10000,0,0,0,0,10000,-10000,-10000
051564,和碩國泰96購01  ,0,0,0,0,0,0,0,0,0,-10000,0,0,0,10000,20000,-10000,-10000
05156P,群創兆豐95售01  ,0,0,0,0,0,0,0,0,0,-10000,0,0,0,0,10000,-10000,-10000
051589,健鼎元大95購02  ,0,0,0,0,0,0,0,0,0,-10000,0,0,0,0,10000,-10000,-10000
051595,康控元大95購04  ,0,0,0,0,0,0,0,0,0,-10000,0,0,0,10000,20000,-10000,-10000
051795,T50反1台新05購02,0,0,0,0,0,0,0,0,0,-10000,0,0,0,0,10000,-10000,-10000
051810,欣興凱基95購03  ,0,0,0,0,0,0,0,0,0,-10000,0,0,0,0,10000,-10000,-10000
051865,聯發科凱基96購04,0,0,0,0,0,0,0,0,0,-10000,0,0,0,2000,12000,-10000,-10000
051841,南茂國泰96購01  ,0,0,0,0,0,0,0,0,0,-10000,0,0,0,11000,21000,-10000,-10000
052038,國巨永昌96購01  ,0,0,0,0,0,0,0,0,0,-10000,0,0,0,0,10000,-10000,-10000
052052,嘉澤凱基95購02  ,0,0,0,0,0,0,0,0,0,-10000,0,0,0,6000,16000,-10000,-10000
051995,矽力元大95購03  ,0,0,0,0,0,0,0,0,0,-10000,0,0,0,0,10000,-10000,-10000
051988,台光電元大95購01,0,0,0,0,0,0,0,0,0,-10000,0,0,0,97000,107000,-10000,-10000
052192,SP黃豆元富95購04,0,0,0,0,0,0,0,0,0,-10000,0,0,0,0,10000,-10000,-10000
052163,康舒永豐95購02  ,0,0,0,0,0,0,0,0,0,-10000,0,0,0,67000,77000,-10000,-10000
052153,GIS富邦96購02   ,0,0,0,0,0,0,0,0,0,-10000,0,0,0,0,10000,-10000,-10000
052073,矽力統一95購03  ,0,0,0,0,0,0,0,0,0,-10000,0,0,0,0,10000,-10000,-10000
052119,漢唐國票96購01  ,0,0,0,0,0,0,0,0,0,-10000,0,0,0,20000,30000,-10000,-10000
051216,為升元富95購01  ,0,0,0,0,0,0,0,0,0,-10000,0,0,0,0,10000,-10000,-10000
051237,鴻海元大97購01  ,0,0,0,0,0,0,0,0,0,-10000,0,0,0,315000,325000,-10000,-10000
051092,禾伸堂元大95購02,0,0,0,0,0,0,0,0,0,-10000,0,0,0,145000,155000,-10000,-10000
050973,S&P反1統一95購01,0,0,0,0,0,0,0,0,0,-10000,0,0,0,0,10000,-10000,-10000
050964,晶技永豐95購02  ,0,0,0,0,0,0,0,0,0,-10000,0,0,0,0,10000,-10000,-10000
05101P,大立光凱基95售11,0,0,0,0,0,0,0,0,0,-10000,0,0,0,0,10000,-10000,-10000
051026,健策統一96購01  ,0,0,0,0,0,0,0,0,0,-10000,0,0,0,0,10000,-10000,-10000
051027,楠梓電元富95購01,0,0,0,0,0,0,0,0,0,-10000,0,0,0,0,10000,-10000,-10000
050997,麗豐元大95購03  ,0,0,0,0,0,0,0,0,0,-10000,0,0,0,0,10000,-10000,-10000
051059,康普群益95購01  ,0,0,0,0,0,0,0,0,0,-10000,0,0,0,9000,19000,-10000,-10000
051497,中磊亞東96購01  ,0,0,0,0,0,0,0,0,0,-10000,0,0,0,0,10000,-10000,-10000
051493,台郡凱基95購02  ,0,0,0,0,0,0,0,0,0,-10000,0,0,0,0,10000,-10000,-10000
05153P,台表科群益96售01,0,0,0,0,0,0,0,0,0,-10000,0,0,0,0,10000,-10000,-10000
051542,南茂國票96購01  ,0,0,0,0,0,0,0,0,0,-10000,0,0,0,0,10000,-10000,-10000
051535,新日興國票96購01,0,0,0,0,0,0,0,0,0,-10000,0,0,0,253000,263000,-10000,-10000
051264,道瓊反富邦97購01,0,0,0,0,0,0,0,0,0,-10000,0,0,0,0,10000,-10000,-10000
051303,奇鋐凱基95購01  ,0,0,0,0,0,0,0,0,0,-10000,0,0,0,0,10000,-10000,-10000
051324,康友國票96購01  ,0,0,0,0,0,0,0,0,0,-10000,0,0,0,35000,45000,-10000,-10000
051334,宏達電永豐95購01,0,0,0,0,0,0,0,0,0,-10000,0,0,0,0,10000,-10000,-10000
051385,矽創群益95購01  ,0,0,0,0,0,0,0,0,0,-10000,0,0,0,0,10000,-10000,-10000
050131,新光金凱基94購01,0,0,0,0,0,0,0,0,0,-10000,0,0,0,0,10000,-10000,-10000
049852,康控群益94購03  ,0,0,0,0,0,0,0,0,0,-10000,0,0,0,10000,20000,-10000,-10000
050026,友達元大96購01  ,0,0,0,0,0,0,0,0,0,-10000,0,0,0,25000,35000,-10000,-10000
050000,盟立永豐94購01  ,0,0,0,0,0,0,0,0,0,-10000,0,0,0,0,10000,-10000,-10000
049996,元油2X永豐94購05,0,0,0,0,0,0,0,0,0,-10000,0,0,0,10000,20000,-10000,-10000
049635,臺股指群益94購08,0,0,0,0,0,0,0,0,0,-10000,0,0,0,0,10000,-10000,-10000
049623,創意群益94購01  ,0,0,0,0,0,0,0,0,0,-10000,0,0,0,0,10000,-10000,-10000
049689,正崴元大94購02  ,0,0,0,0,0,0,0,0,0,-10000,0,0,0,20000,30000,-10000,-10000
04975P,華新科凱基96售02,0,0,0,0,0,0,0,0,0,-10000,0,0,0,0,10000,-10000,-10000
049761,亞德客國泰95購03,0,0,0,0,0,0,0,0,0,-10000,0,0,0,85000,95000,-10000,-10000
049763,美食國泰96購01  ,0,0,0,0,0,0,0,0,0,-10000,0,0,0,0,10000,-10000,-10000
049711,劍麟凱基94購01  ,0,0,0,0,0,0,0,0,0,-10000,0,0,0,0,10000,-10000,-10000
049729,日月光中信94購01,0,0,0,0,0,0,0,0,0,-10000,0,0,0,0,10000,-10000,-10000
049485,台積電元大96購03,0,0,0,0,0,0,0,0,0,-10000,0,0,0,0,10000,-10000,-10000
049432,聯詠國票95購01  ,0,0,0,0,0,0,0,0,0,-10000,0,0,0,0,10000,-10000,-10000
049550,柏文群益94購01  ,0,0,0,0,0,0,0,0,0,-10000,0,0,0,0,10000,-10000,-10000
050773,京鼎元大94購02  ,0,0,0,0,0,0,0,0,0,-10000,0,0,0,17000,27000,-10000,-10000
050750,上銀統一94購02  ,0,0,0,0,0,0,0,0,0,-10000,0,0,0,8000,18000,-10000,-10000
050827,致伸凱基95購01  ,0,0,0,0,0,0,0,0,0,-10000,0,0,0,6000,16000,-10000,-10000
050824,欣興凱基95購01  ,0,0,0,0,0,0,0,0,0,-10000,0,0,0,0,10000,-10000,-10000
050655,中磊凱基96購01  ,0,0,0,0,0,0,0,0,0,-10000,0,0,0,0,10000,-10000,-10000
050676,道瓊銀統一96購02,0,0,0,0,0,0,0,0,0,-10000,0,0,0,0,10000,-10000,-10000
050726,可成國票96購01  ,0,0,0,0,0,0,0,0,0,-10000,0,0,0,10000,20000,-10000,-10000
050690,台達電凱基96購01,0,0,0,0,0,0,0,0,0,-10000,0,0,0,0,10000,-10000,-10000
050514,聯電元大94購01  ,0,0,0,0,0,0,0,0,0,-10000,0,0,0,0,10000,-10000,-10000
050430,京元電凱基94購03,0,0,0,0,0,0,0,0,0,-10000,0,0,0,0,10000,-10000,-10000
050457,力成元大94購01  ,0,0,0,0,0,0,0,0,0,-10000,0,0,0,4000,14000,-10000,-10000
050422,鴻海凱基96購01  ,0,0,0,0,0,0,0,0,0,-10000,0,0,0,14000,24000,-10000,-10000
050287,台達電凱基94購10,0,0,0,0,0,0,0,0,0,-10000,0,0,0,68000,78000,-10000,-10000
050239,廣達凱基94購01  ,0,0,0,0,0,0,0,0,0,-10000,0,0,0,0,10000,-10000,-10000
050249,瑞儀凱基94購01  ,0,0,0,0,0,0,0,0,0,-10000,0,0,0,0,10000,-10000,-10000
050246,大立光凱基94購13,0,0,0,0,0,0,0,0,0,-10000,0,0,0,0,10000,-10000,-10000
050349,中環群益94購01  ,0,0,0,0,0,0,0,0,0,-10000,0,0,0,0,10000,-10000,-10000
050358,致新群益94購01  ,0,0,0,0,0,0,0,0,0,-10000,0,0,0,0,10000,-10000,-10000
050339,鴻海統一94購06  ,0,0,0,0,0,0,0,0,0,-10000,0,0,0,0,10000,-10000,-10000
050328,臻鼎永豐94購03  ,0,0,0,0,0,0,0,0,0,-10000,0,0,0,0,10000,-10000,-10000
06083P,華通統一98售02  ,0,0,0,0,0,0,0,0,0,-10000,0,0,0,0,10000,-10000,-10000
06054P,臺股指中信9A售01,0,0,0,0,0,0,0,0,0,-10000,0,0,0,0,10000,-10000,-10000
08100P,台灣50元富95售01,0,0,0,0,0,0,0,0,0,-10000,0,0,0,0,10000,-10000,-10000
07480P,FBVIX凱基94售01 ,0,0,0,0,0,0,0,0,0,-10000,0,0,0,0,10000,-10000,-10000
08056P,華通群益9B售06  ,0,0,0,0,0,0,0,0,0,-10000,0,0,0,0,10000,-10000,-10000
06108P,奇力新群益97售05,0,0,0,0,0,0,0,0,0,-10000,0,0,0,0,10000,-10000,-10000
05979P,華新科中信96售02,0,0,0,0,0,0,0,0,0,-10000,0,0,0,0,10000,-10000,-10000
05981P,可成永昌98售02  ,0,0,0,0,0,0,0,0,0,-10000,0,0,0,0,10000,-10000,-10000
05839P,臺股指富邦96售06,0,0,0,0,0,0,0,0,0,-10000,0,0,0,0,10000,-10000,-10000
05840P,臺股指富邦96售07,0,0,0,0,0,0,0,0,0,-10000,0,0,0,0,10000,-10000,-10000
05783P,嘉澤元富96售01  ,0,0,0,0,0,0,0,0,0,-10000,0,0,0,0,10000,-10000,-10000
05692P,聯發科中信9A售02,0,0,0,0,0,0,0,0,0,-10000,0,0,0,0,10000,-10000,-10000
2636,台驊投控        ,3000,13000,-10000,0,0,0,0,0,0,0,0,0,0,0,0,0,-10000
3167,大量            ,34000,44000,-10000,0,0,0,0,0,0,0,0,0,0,0,0,0,-10000
9942,茂順            ,1000,24000,-23000,0,0,0,0,0,0,13000,13000,0,13000,0,0,0,-10000
9906,欣巴巴          ,3000,13000,-10000,0,0,0,0,0,0,0,0,0,0,0,0,0,-10000
053349,台郡國票97購02  ,0,0,0,0,0,0,0,0,0,-11000,0,0,0,0,11000,-11000,-11000
053265,南亞科群益96購02,0,0,0,0,0,0,0,0,0,-11000,0,0,0,42000,53000,-11000,-11000
053517,崇越群益97購01  ,0,0,0,0,0,0,0,0,0,-11000,0,0,0,0,11000,-11000,-11000
053493,智邦兆豐97購02  ,0,0,0,0,0,0,0,0,0,-11000,0,0,0,0,11000,-11000,-11000
05305P,華新科國泰97售01,0,0,0,0,0,0,0,0,0,-11000,0,0,0,25000,36000,-11000,-11000
052762,欣興群益96購01  ,0,0,0,0,0,0,0,0,0,-11000,0,0,0,0,11000,-11000,-11000
052527,泰鼎元大96購02  ,0,0,0,0,0,0,0,0,0,-11000,0,0,0,85000,96000,-11000,-11000
052552,智邦國票97購01  ,0,0,0,0,0,0,0,0,0,-11000,0,0,0,65000,76000,-11000,-11000
052478,大立光群益95購05,0,0,0,0,0,0,0,0,0,-11000,0,0,0,3000,14000,-11000,-11000
052260,為升富邦97購02  ,0,0,0,0,0,0,0,0,0,-11000,0,0,0,2000,13000,-11000,-11000
052278,國巨凱基95購06  ,0,0,0,0,0,0,0,0,0,-11000,0,0,0,66000,77000,-11000,-11000
052280,聯發科凱基95購11,0,0,0,0,0,0,0,0,0,-11000,0,0,0,27000,38000,-11000,-11000
052297,旭富國票96購01  ,0,0,0,0,0,0,0,0,0,-11000,0,0,0,0,11000,-11000,-11000
054129,技嘉元大96購02  ,0,0,0,0,0,0,0,0,0,-11000,0,0,0,0,11000,-11000,-11000
054660,禾伸堂元大97購03,0,0,0,0,0,0,0,0,0,-11000,0,0,0,40000,51000,-11000,-11000
054817,聯發科元大97購13,0,0,0,0,0,0,0,0,0,-11000,0,0,0,13000,24000,-11000,-11000
054326,宏達電台新97購02,0,0,0,0,0,0,0,0,0,-11000,0,0,0,0,11000,-11000,-11000
054267,上銀第一96購01  ,0,0,0,0,0,0,0,0,0,-11000,0,0,0,0,11000,-11000,-11000
054436,高鐵台新97購02  ,0,0,0,0,0,0,0,0,0,-11000,0,0,0,9000,20000,-11000,-11000
054371,台積電中信9C購01,0,0,0,0,0,0,0,0,0,-11000,0,0,0,11000,22000,-11000,-11000
054411,光磊元大97購02  ,0,0,0,0,0,0,0,0,0,-11000,0,0,0,0,11000,-11000,-11000
054430,上銀台新96購02  ,0,0,0,0,0,0,0,0,0,-11000,0,0,0,0,11000,-11000,-11000
045618,元油2X永豐98購01,0,0,0,0,0,0,0,0,0,-11000,0,0,0,0,11000,-11000,-11000
045325,元油2X永豐94購01,0,0,0,0,0,0,0,0,0,-11000,0,0,0,0,11000,-11000,-11000
045254,台積電凱基92購05,0,0,0,0,0,0,0,0,0,-11000,0,0,0,1000,12000,-11000,-11000
044913,寶成凱基93購01  ,0,0,0,0,0,0,0,0,0,-11000,0,0,0,0,11000,-11000,-11000
045043,台達電凱基93購01,0,0,0,0,0,0,0,0,0,-11000,0,0,0,69000,80000,-11000,-11000
045100,亞光中信93購01  ,0,0,0,0,0,0,0,0,0,-11000,0,0,0,16000,27000,-11000,-11000
04263P,南電群益93售03  ,0,0,0,0,0,0,0,0,0,-11000,0,0,0,31000,42000,-11000,-11000
041042,美律群益92購01  ,0,0,0,0,0,0,0,0,0,-11000,0,0,0,10000,21000,-11000,-11000
043484,TPK群益93購01   ,0,0,0,0,0,0,0,0,0,-11000,0,0,0,0,11000,-11000,-11000
03819P,聯詠統一93售03  ,0,0,0,0,0,0,0,0,0,-11000,0,0,0,197000,208000,-11000,-11000
03872P,聯詠群益93售02  ,0,0,0,0,0,0,0,0,0,-11000,0,0,0,0,11000,-11000,-11000
04079P,燿華元大93售04  ,0,0,0,0,0,0,0,0,0,-11000,0,0,0,9000,20000,-11000,-11000
048405,嘉晶群益93購03  ,0,0,0,0,0,0,0,0,0,-11000,0,0,0,0,11000,-11000,-11000
048406,欣興群益93購09  ,0,0,0,0,0,0,0,0,0,-11000,0,0,0,0,11000,-11000,-11000
046355,欣興群益92購03  ,0,0,0,0,0,0,0,0,0,-11000,0,0,0,0,11000,-11000,-11000
047816,大立光凱基93購26,0,0,0,0,0,0,0,0,0,-11000,0,0,0,0,11000,-11000,-11000
046029,微星元大92購02  ,0,0,0,0,0,0,0,0,0,-11000,0,0,0,154000,165000,-11000,-11000
046939,燿華元大96購01  ,0,0,0,0,0,0,0,0,0,-11000,0,0,0,0,11000,-11000,-11000
048874,玉晶光國票96購01,0,0,0,0,0,0,0,0,0,-11000,0,0,0,1000,12000,-11000,-11000
048860,玉晶光群益96購03,0,0,0,0,0,0,0,0,0,-11000,0,0,0,11000,22000,-11000,-11000
048849,光寶科群益94購01,0,0,0,0,0,0,0,0,0,-11000,0,0,0,0,11000,-11000,-11000
047441,聯發科元大93購15,0,0,0,0,0,0,0,0,0,-11000,0,0,0,21000,32000,-11000,-11000
049079,聯發科凱基94購04,0,0,0,0,0,0,0,0,0,-11000,0,0,0,35000,46000,-11000,-11000
049021,慧洋群益94購01  ,0,0,0,0,0,0,0,0,0,-11000,0,0,0,0,11000,-11000,-11000
049204,京元電群益94購02,0,0,0,0,0,0,0,0,0,-11000,0,0,0,36000,47000,-11000,-11000
049308,台達電凱基94購04,0,0,0,0,0,0,0,0,0,-11000,0,0,0,0,11000,-11000,-11000
047588,大立光永豐94購01,0,0,0,0,0,0,0,0,0,-11000,0,0,0,13000,24000,-11000,-11000
050681,南亞科元富94購01,0,0,0,0,0,0,0,0,0,-11000,0,0,0,7000,18000,-11000,-11000
050555,道瓊銀統一94購01,0,0,0,0,0,0,0,0,0,-11000,0,0,0,0,11000,-11000,-11000
050573,光寶科國票94購01,0,0,0,0,0,0,0,0,0,-11000,0,0,0,0,11000,-11000,-11000
049418,大立光凱基94購05,0,0,0,0,0,0,0,0,0,-11000,0,0,0,0,11000,-11000,-11000
049492,聯發科元大95購02,0,0,0,0,0,0,0,0,0,-11000,0,0,0,23000,34000,-11000,-11000
049736,宏達電群益95購03,0,0,0,0,0,0,0,0,0,-11000,0,0,0,0,11000,-11000,-11000
049759,元黃金富邦9A購01,0,0,0,0,0,0,0,0,0,-11000,0,0,0,34000,45000,-11000,-11000
049830,智易凱基94購02  ,0,0,0,0,0,0,0,0,0,-11000,0,0,0,0,11000,-11000,-11000
051520,新光金凱基97購01,0,0,0,0,0,0,0,0,0,-11000,0,0,0,0,11000,-11000,-11000
051436,訊芯元富95購01  ,0,0,0,0,0,0,0,0,0,-11000,0,0,0,0,11000,-11000,-11000
051066,台積電國票96購02,0,0,0,0,0,0,0,0,0,-11000,0,0,0,1000,12000,-11000,-11000
051153,鴻海國泰97購02  ,0,0,0,0,0,0,0,0,0,-11000,0,0,0,78000,89000,-11000,-11000
051120,南亞科群益95購01,0,0,0,0,0,0,0,0,0,-11000,0,0,0,100000,111000,-11000,-11000
051121,裕民群益97購01  ,0,0,0,0,0,0,0,0,0,-11000,0,0,0,0,11000,-11000,-11000
051208,GIS麥證95購01   ,0,0,0,11000,22000,-11000,0,0,0,-11000,0,0,0,11000,22000,-11000,-11000
05117P,瑞昱群益95售02  ,0,0,0,0,0,0,0,0,0,-11000,0,0,0,0,11000,-11000,-11000
052181,南茂元大95購05  ,0,0,0,0,0,0,0,0,0,-11000,0,0,0,0,11000,-11000,-11000
052029,矽力群益95購02  ,0,0,0,0,0,0,0,0,0,-11000,0,0,0,0,11000,-11000,-11000
051778,全新群益95購01  ,0,0,0,0,0,0,0,0,0,-11000,0,0,0,0,11000,-11000,-11000
051707,欣興群益95購02  ,0,0,0,0,0,0,0,0,0,-11000,0,0,0,0,11000,-11000,-11000
8367,建新國際        ,4000,15000,-11000,0,0,0,0,0,0,0,0,0,0,0,0,0,-11000
6168,宏齊            ,45000,56000,-11000,0,0,0,0,0,0,0,0,0,0,0,0,0,-11000
4766,南寶            ,11000,18000,-7000,0,0,0,0,0,0,-4000,0,0,0,0,4000,-4000,-11000
1762,中化生          ,28000,39000,-11000,0,0,0,0,0,0,0,0,0,0,0,0,0,-11000
1701,中化            ,24000,35000,-11000,0,0,0,0,0,0,0,0,0,0,0,0,0,-11000
2228,劍麟            ,29000,37000,-8000,0,0,0,0,0,0,-3000,0,0,0,0,3000,-3000,-11000
2342,茂矽            ,71000,82000,-11000,0,0,0,0,0,0,0,0,0,0,0,0,0,-11000
05675P,美律群益97售01  ,0,0,0,0,0,0,0,0,0,-11000,0,0,0,0,11000,-11000,-11000
06043P,創意永豐96售06  ,0,0,0,0,0,0,0,0,0,-11000,0,0,0,99000,110000,-11000,-11000
06079P,燿華群益98售02  ,0,0,0,0,0,0,0,0,0,-11000,0,0,0,0,11000,-11000,-11000
1524,耿鼎            ,1000,12000,-11000,0,0,0,0,0,0,0,0,0,0,0,0,0,-11000
054410,國巨元大96購14  ,0,0,0,0,0,0,0,0,0,-12000,0,0,0,70000,82000,-12000,-12000
054452,華通亞東96購01  ,0,0,0,0,0,0,0,0,0,-12000,0,0,0,3000,15000,-12000,-12000
054216,聯茂國票97購03  ,0,0,0,0,0,0,0,0,0,-12000,0,0,0,0,12000,-12000,-12000
054549,台積電凱基98購01,0,0,0,0,0,0,0,0,0,-12000,0,0,0,4000,16000,-12000,-12000
054156,聯電亞東98購01  ,0,0,0,0,0,0,0,0,0,-12000,0,0,0,0,12000,-12000,-12000
054102,百和國票97購04  ,0,0,0,0,0,0,0,0,0,-12000,0,0,0,0,12000,-12000,-12000
053610,矽力中信98購01  ,0,0,0,0,0,0,0,0,0,-12000,0,0,0,48000,60000,-12000,-12000
053676,新光金國泰98購02,0,0,0,0,0,0,0,0,0,-12000,0,0,0,8000,20000,-12000,-12000
052525,聯詠元大95購06  ,0,0,0,0,0,0,0,0,0,-12000,0,0,0,0,12000,-12000,-12000
052816,上銀永豐96購01  ,0,0,0,0,0,0,0,0,0,-12000,0,0,0,0,12000,-12000,-12000
053086,宏達電元大97購01,0,0,0,0,0,0,0,0,0,-12000,0,0,0,43000,55000,-12000,-12000
053075,欣興永豐96購01  ,0,0,0,0,0,0,0,0,0,-12000,0,0,0,13000,25000,-12000,-12000
05293P,廣達凱基95售01  ,0,0,0,0,0,0,0,0,0,-12000,0,0,0,0,12000,-12000,-12000
053530,聯發科康和96購01,0,0,0,0,0,0,0,0,0,-12000,0,0,0,15000,27000,-12000,-12000
053330,燿華永豐96購03  ,0,0,0,0,0,0,0,0,0,-12000,0,0,0,25000,37000,-12000,-12000
040475,台表科群益92購01,0,0,0,0,0,0,0,0,0,-12000,0,0,0,0,12000,-12000,-12000
03208P,國巨中信02售02  ,0,0,0,0,0,0,0,0,0,-12000,0,0,0,0,12000,-12000,-12000
03092P,臺股指元大01售21,0,0,0,0,0,0,0,0,0,-12000,0,0,0,0,12000,-12000,-12000
03094X,大立光元大68展08,0,0,0,0,0,0,0,0,0,-12000,0,0,0,0,12000,-12000,-12000
00683L,元大美元指數正2 ,0,0,0,0,0,0,0,0,0,-12000,0,0,0,40000,52000,-12000,-12000
042953,鴻海台新01購01  ,0,0,0,0,0,0,0,0,0,-12000,0,0,0,0,12000,-12000,-12000
044819,新日興兆豐93購02,0,0,0,0,0,0,0,0,0,-12000,0,0,0,208000,220000,-12000,-12000
045384,強茂元大92購01  ,0,0,0,0,0,0,0,0,0,-12000,0,0,0,0,12000,-12000,-12000
045397,元油2X富邦93購03,0,0,0,0,0,0,0,0,0,-12000,0,0,0,0,12000,-12000,-12000
045437,大立光統一94購02,0,0,0,0,0,0,0,0,0,-12000,0,0,0,0,12000,-12000,-12000
045669,華通元大93購02  ,0,0,0,0,0,0,0,0,0,-12000,0,0,0,0,12000,-12000,-12000
047768,大立光元大95購01,0,0,0,0,0,0,0,0,0,-12000,0,0,0,3000,15000,-12000,-12000
049328,元上證統一94購01,0,0,0,0,0,0,0,0,0,-12000,0,0,0,0,12000,-12000,-12000
049357,微星富邦94購01  ,0,0,0,0,0,0,0,0,0,-12000,0,0,0,18000,30000,-12000,-12000
049091,訊連凱基94購01  ,0,0,0,0,0,0,0,0,0,-12000,0,0,0,1000,13000,-12000,-12000
049192,元油2X永豐96購02,0,0,0,0,0,0,0,0,0,-12000,0,0,0,0,12000,-12000,-12000
047434,台積電元大93購21,0,0,0,0,0,0,0,0,0,-12000,0,0,0,6000,18000,-12000,-12000
048160,GIS兆豐95購01   ,0,0,0,0,0,0,0,0,0,-12000,0,0,0,0,12000,-12000,-12000
048880,昇陽半國票94購01,0,0,0,0,0,0,0,0,0,-12000,0,0,0,0,12000,-12000,-12000
048656,大立光元富93購05,0,0,0,0,0,0,0,0,0,-12000,0,0,0,4000,16000,-12000,-12000
045957,技嘉凱基93購03  ,0,0,0,0,0,0,0,0,0,-12000,0,0,0,0,12000,-12000,-12000
046769,百和凱基93購06  ,0,0,0,0,0,0,0,0,0,-12000,0,0,0,25000,37000,-12000,-12000
046547,大立光永豐92購05,0,0,0,0,0,0,0,0,0,-12000,0,0,0,21000,33000,-12000,-12000
051807,瑞昱凱基95購03  ,0,0,0,0,0,0,0,0,0,-12000,0,0,0,0,12000,-12000,-12000
051088,台積電元大95購09,0,0,0,0,0,0,0,0,0,-12000,0,0,0,330000,342000,-12000,-12000
051028,台光電元富95購02,0,0,0,0,0,0,0,0,0,-12000,0,0,0,10000,22000,-12000,-12000
050961,美律永豐95購01  ,0,0,0,0,0,0,0,0,0,-12000,0,0,0,0,12000,-12000,-12000
05092P,全新元大95售03  ,0,0,0,0,0,0,0,0,0,-12000,0,0,0,76000,88000,-12000,-12000
051456,鈺齊元大95購01  ,0,0,0,0,0,0,0,0,0,-12000,0,0,0,31000,43000,-12000,-12000
049878,宏達電永豐94購01,0,0,0,0,0,0,0,0,0,-12000,0,0,0,0,12000,-12000,-12000
049965,矽創元富94購01  ,0,0,0,0,0,0,0,0,0,-12000,0,0,0,14000,26000,-12000,-12000
050046,矽力兆豐94購01  ,0,0,0,0,0,0,0,0,0,-12000,0,0,0,94000,106000,-12000,-12000
050695,台積電凱基94購40,0,0,0,0,0,0,0,0,0,-12000,0,0,0,3000,15000,-12000,-12000
050849,智伸科國票95購01,0,0,0,0,0,0,0,0,0,-12000,0,0,0,13000,25000,-12000,-12000
050907,臺股指元大95購14,0,0,0,0,0,0,0,0,0,-12000,0,0,0,0,12000,-12000,-12000
050801,元金2X群益98購01,0,0,0,0,0,0,0,0,0,-12000,0,0,0,10000,22000,-12000,-12000
050521,聯發科元大94購15,0,0,0,0,0,0,0,0,0,-12000,0,0,0,15000,27000,-12000,-12000
1540,喬福            ,1000,13000,-12000,0,0,0,0,0,0,0,0,0,0,0,0,0,-12000
06105P,國巨國票98售02  ,0,0,0,0,0,0,0,0,0,-12000,0,0,0,0,12000,-12000,-12000
05908P,大立光元富96售05,0,0,0,0,0,0,0,0,0,-12000,0,0,0,0,12000,-12000,-12000
2476,鉅祥            ,0,12000,-12000,0,0,0,0,0,0,0,0,0,0,0,0,0,-12000
1229,聯華            ,342000,354442,-12442,0,0,0,0,0,0,0,0,0,0,0,0,0,-12442
052679,致伸富邦98購01  ,0,0,0,0,0,0,0,0,0,-13000,0,0,0,17000,30000,-13000,-13000
052451,旭富元大95購02  ,0,0,0,0,0,0,0,0,0,-13000,0,0,0,17000,30000,-13000,-13000
054054,光磊國票97購02  ,0,0,0,0,0,0,0,0,0,-13000,0,0,0,998000,1011000,-13000,-13000
054159,T50正2凱基99購01,0,0,0,0,0,0,0,0,0,-13000,0,0,0,0,13000,-13000,-13000
054248,燿華元大97購02  ,0,0,0,0,0,0,0,0,0,-13000,0,0,0,27000,40000,-13000,-13000
054511,香港反元大98購01,0,0,0,0,0,0,0,0,0,-13000,0,0,0,0,13000,-13000,-13000
043934,致新永豐91購02  ,0,0,0,0,0,0,0,0,0,-13000,0,0,0,0,13000,-13000,-13000
04552P,南電元大94售06  ,0,0,0,0,0,0,0,0,0,-13000,0,0,0,48000,61000,-13000,-13000
044847,華邦電統一91購02,0,0,0,0,0,0,0,0,0,-13000,0,0,0,58000,71000,-13000,-13000
04141P,啟碁國票93售01  ,0,0,0,0,0,0,0,0,0,-13000,0,0,0,11000,24000,-13000,-13000
00711B,FH彭博新興債    ,0,0,0,0,0,0,0,0,0,-13000,0,0,0,124000,137000,-13000,-13000
03638P,嘉晶凱基93售03  ,0,0,0,0,0,0,0,0,0,-13000,0,0,0,5000,18000,-13000,-13000
047917,台積電凱基94購01,0,0,0,0,0,0,0,0,0,-13000,0,0,0,16000,29000,-13000,-13000
047906,中石化元大94購01,0,0,0,0,0,0,0,0,0,-13000,0,0,0,0,13000,-13000,-13000
047892,康控兆豐94購01  ,0,0,0,0,0,0,0,0,0,-13000,0,0,0,1000,14000,-13000,-13000
046748,喬山凱基93購01  ,0,0,0,0,0,0,0,0,0,-13000,0,0,0,0,13000,-13000,-13000
046079,瑞儀凱基92購03  ,0,0,0,0,0,0,0,0,0,-13000,0,0,0,0,13000,-13000,-13000
048690,美律群益94購01  ,0,0,0,0,0,0,0,0,0,-13000,0,0,0,20000,33000,-13000,-13000
047065,聯茂凱基93購07  ,0,0,0,0,0,0,0,0,0,-13000,0,0,0,0,13000,-13000,-13000
050550,大立光凱基95購04,0,0,0,0,0,0,0,0,0,-13000,0,0,0,0,13000,-13000,-13000
050508,上証2X元大97購01,0,0,0,0,0,0,0,0,0,-13000,0,0,0,0,13000,-13000,-13000
050363,臺指反元大98購04,0,0,0,0,0,0,0,0,0,-13000,0,0,0,152000,165000,-13000,-13000
050699,京鼎凱基96購01  ,0,0,0,0,0,0,0,0,0,-13000,0,0,0,50000,63000,-13000,-13000
050578,聯發科國票95購03,0,0,0,0,0,0,0,0,0,-13000,0,0,0,0,13000,-13000,-13000
050038,金融類元大94購04,0,0,0,0,0,0,0,0,0,-13000,0,0,0,0,13000,-13000,-13000
050059,旺宏凱基94購03  ,0,0,0,0,0,0,0,0,0,-13000,0,0,0,52000,65000,-13000,-13000
05000P,臺股指永豐95售01,0,0,0,0,0,0,0,0,0,-13000,0,0,0,0,13000,-13000,-13000
049661,喬山永豐94購01  ,0,0,0,0,0,0,0,0,0,-13000,0,0,0,12000,25000,-13000,-13000
051158,嘉晶富邦96購01  ,0,0,0,0,0,0,0,0,0,-13000,0,0,0,0,13000,-13000,-13000
052043,瑞昱日盛95購01  ,0,0,0,0,0,0,0,0,0,-13000,0,0,0,12000,25000,-13000,-13000
06027P,鴻海台新96售04  ,0,0,0,0,0,0,0,0,0,-13000,0,0,0,0,13000,-13000,-13000
05582P,群創凱基98售06  ,0,0,0,0,0,0,0,0,0,-13000,0,0,0,0,13000,-13000,-13000
2528,皇普            ,6000,29000,-23000,0,0,0,0,0,0,10000,10000,0,10000,0,0,0,-13000
2480,敦陽科          ,38000,51000,-13000,0,0,0,0,0,0,0,0,0,0,0,0,0,-13000
2495,普安            ,13000,26000,-13000,0,0,0,0,0,0,0,0,0,0,0,0,0,-13000
6525,捷敏-KY         ,17000,39000,-22000,0,0,0,10000,0,10000,-1000,0,1000,-1000,0,0,0,-13000
054352,世芯國泰98購01  ,0,0,0,0,0,0,0,0,0,-14000,0,0,0,13000,27000,-14000,-14000
054242,元油反元大98購02,0,0,0,0,0,0,0,0,0,-14000,0,0,0,0,14000,-14000,-14000
054328,台化康和96購01  ,0,0,0,0,0,0,0,0,0,-14000,0,0,0,0,14000,-14000,-14000
054321,上銀台新96購01  ,0,0,0,0,0,0,0,0,0,-14000,0,0,0,0,14000,-14000,-14000
054337,智邦統一96購01  ,0,0,0,0,0,0,0,0,0,-14000,0,0,0,61000,75000,-14000,-14000
054554,大立光凱基98購02,0,0,0,0,0,0,0,0,0,-14000,0,0,0,0,14000,-14000,-14000
054695,世芯永豐98購01  ,0,0,0,0,0,0,0,0,0,-14000,0,0,0,0,14000,-14000,-14000
054152,漢唐國泰98購02  ,0,0,0,0,0,0,0,0,0,-14000,0,0,0,158000,172000,-14000,-14000
054070,創意國泰96購02  ,0,0,0,0,0,0,0,0,0,-14000,0,0,0,143000,157000,-14000,-14000
053905,華新科凱基96購10,0,0,0,0,0,0,0,0,0,-14000,0,0,0,28000,42000,-14000,-14000
052362,瑞昱國票96購02  ,0,0,0,0,0,0,0,0,0,-14000,0,0,0,30000,44000,-14000,-14000
053522,臺股指群益99購01,0,0,0,0,0,0,0,0,0,-14000,0,0,0,0,14000,-14000,-14000
052991,台積電台新96購01,0,0,0,0,0,0,0,0,0,-14000,0,0,0,22000,36000,-14000,-14000
053066,欣興群益96購02  ,0,0,0,0,0,0,0,0,0,-14000,0,0,0,0,14000,-14000,-14000
053250,百和國票97購02  ,0,0,0,0,0,0,0,0,0,-14000,0,0,0,0,14000,-14000,-14000
04054P,滬深2X富邦96售02,0,0,0,0,0,0,0,0,0,-14000,0,0,0,36000,50000,-14000,-14000
043513,台灣50元大96購05,0,0,0,0,0,0,0,0,0,-14000,0,0,0,10000,24000,-14000,-14000
046897,康舒群益93購01  ,0,0,0,0,0,0,0,0,0,-14000,0,0,0,118000,132000,-14000,-14000
046249,聯發科群益92購03,0,0,0,0,0,0,0,0,0,-14000,0,0,0,32000,46000,-14000,-14000
045768,大立光元富95購02,0,0,0,0,0,0,0,0,0,-14000,0,0,0,0,14000,-14000,-14000
044199,亞光國票91購01  ,0,0,0,0,0,0,0,0,0,-14000,0,0,0,85000,99000,-14000,-14000
048837,牧德凱基94購04  ,0,0,0,0,0,0,0,0,0,-14000,0,0,0,104000,118000,-14000,-14000
047307,儒鴻元大93購04  ,0,0,0,0,0,0,0,0,0,-14000,0,0,0,96000,110000,-14000,-14000
046989,可成凱基93購03  ,0,0,0,0,0,0,0,0,0,-14000,0,0,0,0,14000,-14000,-14000
047386,南亞科元大93購01,0,0,0,0,0,0,0,0,0,-14000,0,0,0,8000,22000,-14000,-14000
046573,上緯控國泰94購01,0,0,0,0,0,0,0,0,0,-14000,0,0,0,1000,15000,-14000,-14000
051980,樺漢凱基96購01  ,0,0,0,0,0,0,0,0,0,-14000,0,0,0,0,14000,-14000,-14000
051145,台積電凱基95購05,0,0,0,0,0,0,0,0,0,-14000,0,0,0,2000,16000,-14000,-14000
049448,光磊統一94購01  ,0,0,0,0,0,0,0,0,0,-14000,0,0,0,34000,48000,-14000,-14000
049511,奇力新凱基94購03,0,0,0,0,0,0,0,0,0,-14000,0,0,0,6000,20000,-14000,-14000
049791,元油2X元大94購07,0,0,0,0,0,0,0,0,0,-14000,0,0,0,0,14000,-14000,-14000
050632,國巨群益94購07  ,0,0,0,0,0,0,0,0,0,-14000,0,0,0,88000,102000,-14000,-14000
050792,可成富邦96購01  ,0,0,0,0,0,0,0,0,0,-14000,0,0,0,61000,75000,-14000,-14000
05020P,廣達中信95售01  ,40000,0,40000,0,0,0,0,0,0,-54000,0,0,0,85000,139000,-54000,-14000
2496,卓越            ,0,14000,-14000,0,0,0,0,0,0,0,0,0,0,0,0,0,-14000
2483,百容            ,0,14000,-14000,0,0,0,0,0,0,0,0,0,0,0,0,0,-14000
2395,研華            ,143000,159000,-16000,0,0,0,2000,0,2000,0,0,0,0,0,0,0,-14000
4104,佳醫            ,15000,29000,-14000,0,0,0,0,0,0,0,0,0,0,0,0,0,-14000
053282,彩晶元大9C購01  ,0,0,0,0,0,0,0,0,0,-15000,0,0,0,3000,18000,-15000,-15000
052875,樺漢凱基96購02  ,0,0,0,0,0,0,0,0,0,-15000,0,0,0,0,15000,-15000,-15000
054174,宏達電台新97購01,0,0,0,0,0,0,0,0,0,-15000,0,0,0,0,15000,-15000,-15000
054664,台表科元大97購04,0,0,0,0,0,0,0,0,0,-15000,0,0,0,0,15000,-15000,-15000
054253,宏達電元大97購03,0,0,0,0,0,0,0,0,0,-15000,0,0,0,0,15000,-15000,-15000
045635,建準凱基93購02  ,0,0,0,0,0,0,0,0,0,-15000,0,0,0,79000,94000,-15000,-15000
044285,鴻海凱基93購06  ,0,0,0,0,0,0,0,0,0,-15000,0,0,0,23000,38000,-15000,-15000
045774,義隆元大92購02  ,0,0,0,0,0,0,0,0,0,-15000,0,0,0,0,15000,-15000,-15000
046273,和碩凱基92購02  ,0,0,0,0,0,0,0,0,0,-15000,0,0,0,4000,19000,-15000,-15000
04773P,金融類元大94售01,0,0,0,0,0,0,0,0,0,-15000,0,0,0,20000,35000,-15000,-15000
046339,訊芯中信92購01  ,0,0,0,0,0,0,0,0,0,-15000,0,0,0,10000,25000,-15000,-15000
046336,致新元大92購02  ,0,0,0,0,0,0,0,0,0,-15000,0,0,0,1000,16000,-15000,-15000
048270,T50反1富邦99購01,0,0,0,0,0,0,0,0,0,-15000,0,0,0,0,15000,-15000,-15000
044874,新日興統一91購02,0,0,0,0,0,0,0,0,0,-15000,0,0,0,0,15000,-15000,-15000
045157,台勝科凱基92購01,0,0,0,0,0,0,0,0,0,-15000,0,0,0,30000,45000,-15000,-15000
045174,美律國票92購01  ,0,0,0,0,0,0,0,0,0,-15000,0,0,0,0,15000,-15000,-15000
044988,玉晶光統一95購01,0,0,0,0,0,0,0,0,0,-15000,0,0,0,10000,25000,-15000,-15000
045834,兆豐金群益92購01,0,0,0,0,0,0,0,0,0,-15000,0,0,0,0,15000,-15000,-15000
043529,泰鼎元大92購01  ,0,0,0,0,0,0,0,0,0,-15000,0,0,0,0,15000,-15000,-15000
044508,微星凱基92購02  ,0,0,0,0,0,0,0,0,0,-15000,0,0,0,0,15000,-15000,-15000
044699,華新科元大91購10,0,0,0,0,0,0,0,0,0,-15000,0,0,0,0,15000,-15000,-15000
04458P,世紀鋼統一96售01,0,0,0,0,0,0,0,0,0,-15000,0,0,0,144000,159000,-15000,-15000
044639,京元電元富94購01,0,0,0,0,0,0,0,0,0,-15000,0,0,0,290000,305000,-15000,-15000
04033P,啟碁凱基93售04  ,0,0,0,0,0,0,0,0,0,-15000,0,0,0,49000,64000,-15000,-15000
03893P,為升凱基93售03  ,0,0,0,0,0,0,0,0,0,-15000,0,0,0,58000,73000,-15000,-15000
038944,上海銀國泰92購01,0,0,0,0,0,0,0,0,0,-15000,0,0,0,15000,30000,-15000,-15000
03832P,臺股指中信95售03,0,0,0,0,0,0,0,0,0,-15000,0,0,0,0,15000,-15000,-15000
03644P,建準永豐92售02  ,0,0,0,0,0,0,0,0,0,-15000,0,0,0,0,15000,-15000,-15000
03720P,元油2X富邦95售01,0,0,0,0,0,0,0,0,0,-15000,0,0,0,201000,216000,-15000,-15000
0055,元大MSCI金融    ,0,0,0,0,0,0,0,0,0,-15000,0,0,0,0,15000,-15000,-15000
048584,欣興富邦95購01  ,0,0,0,0,0,0,0,0,0,-15000,0,0,0,0,15000,-15000,-15000
048374,味全元富94購01  ,0,0,0,0,0,0,0,0,0,-15000,0,0,0,0,15000,-15000,-15000
048517,致伸凱基93購06  ,0,0,0,0,0,0,0,0,0,-15000,0,0,0,7000,22000,-15000,-15000
048073,南電元富93購02  ,0,0,0,0,0,0,0,0,0,-15000,0,0,0,0,15000,-15000,-15000
048013,智易國票93購01  ,0,0,0,0,0,0,0,0,0,-15000,0,0,0,5000,20000,-15000,-15000
04597P,為升凱基94售02  ,0,0,0,0,0,0,0,0,0,-15000,0,0,0,30000,45000,-15000,-15000
047999,聯發科元大93購22,0,0,0,0,0,0,0,0,0,-15000,0,0,0,73000,88000,-15000,-15000
049904,矽力元富94購01  ,0,0,0,0,0,0,0,0,0,-15000,0,0,0,0,15000,-15000,-15000
048192,華通元大96購01  ,0,0,0,0,0,0,0,0,0,-15000,0,0,0,136000,151000,-15000,-15000
048776,正文凱基94購01  ,0,0,0,0,0,0,0,0,0,-15000,0,0,0,5000,20000,-15000,-15000
04905P,國巨國票94售04  ,0,0,0,0,0,0,0,0,0,-15000,0,0,0,65000,80000,-15000,-15000
047433,鴻海元大93購16  ,0,0,0,0,0,0,0,0,0,-15000,0,0,0,140000,155000,-15000,-15000
047478,旺宏凱基93購04  ,0,0,0,0,0,0,0,0,0,-15000,0,0,0,16000,31000,-15000,-15000
047519,台達電元大93購02,0,0,0,0,0,0,0,0,0,-15000,0,0,0,2000,17000,-15000,-15000
050359,T50反1元大94購05,0,0,0,0,0,0,0,0,0,-15000,0,0,0,0,15000,-15000,-15000
050711,TPK中信94購01   ,0,0,0,0,0,0,0,0,0,-15000,0,0,0,0,15000,-15000,-15000
050651,大立光凱基96購02,0,0,0,0,0,0,0,0,0,-15000,0,0,0,0,15000,-15000,-15000
050129,聯發科凱基94購11,0,0,0,0,0,0,0,0,0,-15000,0,0,0,13000,28000,-15000,-15000
049532,同欣電台新94購01,0,0,0,0,0,0,0,0,0,-15000,0,0,0,0,15000,-15000,-15000
05112P,燿華統一95售01  ,0,0,0,0,0,0,0,0,0,-15000,0,0,0,54000,69000,-15000,-15000
051192,緯創兆豐96購01  ,0,0,0,0,0,0,0,0,0,-15000,0,0,0,0,15000,-15000,-15000
051210,S&P反1統一97購01,0,0,0,0,0,0,0,0,0,-15000,0,0,0,0,15000,-15000,-15000
051069,智邦國票96購01  ,0,0,0,0,0,0,0,0,0,-15000,0,0,0,195000,210000,-15000,-15000
051442,正崴元大95購02  ,0,0,0,0,0,0,0,0,0,-15000,0,0,0,5000,20000,-15000,-15000
051541,GIS國票96購02   ,0,0,0,0,0,0,0,0,0,-15000,0,0,0,0,15000,-15000,-15000
051905,道瓊銀元大95購01,0,0,0,0,0,0,0,0,0,-15000,0,0,0,0,15000,-15000,-15000
052170,台積電元大95購20,0,0,0,0,0,0,0,0,0,-15000,0,0,0,166000,181000,-15000,-15000
052149,電子類群益95購01,0,0,0,0,0,0,0,0,0,-15000,0,0,0,0,15000,-15000,-15000
052184,台光電群益95購03,0,0,0,0,0,0,0,0,0,-15000,0,0,0,33000,48000,-15000,-15000
052098,臺股指富邦95購01,0,0,0,0,0,0,0,0,0,-15000,0,0,0,0,15000,-15000,-15000
05176P,台積電凱基95售11,0,0,0,0,0,0,0,0,0,-15000,0,0,0,11000,26000,-15000,-15000
051721,玉晶光永豐96購02,0,0,0,0,0,0,0,0,0,-15000,0,0,0,0,15000,-15000,-15000
4155,訊映            ,19000,34000,-15000,0,0,0,0,0,0,0,0,0,0,0,0,0,-15000
2707,晶華            ,14000,29000,-15000,0,0,0,0,0,0,0,0,0,0,0,0,0,-15000
1731,美吾華          ,0,5000,-5000,0,0,0,0,0,0,-10000,0,10000,-10000,0,0,0,-15000
05586P,臺股指凱基96售15,0,0,0,0,0,0,0,0,0,-15000,0,0,0,0,15000,-15000,-15000
05910P,力山永豐96售02  ,0,0,0,0,0,0,0,0,0,-15000,0,0,0,0,15000,-15000,-15000
06038P,國泰金台新96售01,0,0,0,0,0,0,0,0,0,-15000,0,0,0,0,15000,-15000,-15000
1558,伸興            ,6000,11000,-5000,0,0,0,0,0,0,-10000,0,10000,-10000,0,0,0,-15000
1708,東鹼            ,2000,17000,-15000,0,0,0,0,0,0,0,0,0,0,0,0,0,-15000
5533,皇鼎            ,9000,24000,-15000,0,0,0,0,0,0,0,0,0,0,0,0,0,-15000
054565,玉晶光群益99購02,0,0,0,0,0,0,0,0,0,-16000,0,0,0,3000,19000,-16000,-16000
054782,國巨群益97購01  ,0,0,0,0,0,0,0,0,0,-16000,0,0,0,0,16000,-16000,-16000
053837,貿聯永豐96購02  ,0,0,0,0,0,0,0,0,0,-16000,0,0,0,30000,46000,-16000,-16000
053275,燿華元大97購01  ,0,0,0,0,0,0,0,0,0,-16000,0,0,0,86000,102000,-16000,-16000
053209,台積電凱基96購07,0,0,0,0,0,0,0,0,0,-16000,0,0,0,4000,20000,-16000,-16000
042527,台灣50永豐94購01,0,0,0,0,0,0,0,0,0,-16000,0,0,0,0,16000,-16000,-16000
045440,旺宏元富92購01  ,0,0,0,0,0,0,0,0,0,-16000,0,0,0,5000,21000,-16000,-16000
045101,玉晶光中信94購01,10000,10000,0,0,0,0,0,0,0,-16000,0,0,0,534000,550000,-16000,-16000
044934,玉晶光元大93購01,0,0,0,0,0,0,0,0,0,-16000,0,0,0,19000,35000,-16000,-16000
046317,亞光元大92購04  ,0,0,0,0,0,0,0,0,0,-16000,0,0,0,4000,20000,-16000,-16000
048708,智邦亞東94購01  ,0,0,0,0,0,0,0,0,0,-16000,0,0,0,0,16000,-16000,-16000
049004,聯發科中信96購01,0,0,0,0,0,0,0,0,0,-16000,0,0,0,21000,37000,-16000,-16000
045968,貿聯凱基92購03  ,0,0,0,0,0,0,0,0,0,-16000,0,0,0,17000,33000,-16000,-16000
046073,日月光凱基92購03,0,0,0,0,0,0,0,0,0,-16000,0,0,0,0,16000,-16000,-16000
04742P,瑞昱統一94售01  ,0,0,0,0,0,0,0,0,0,-16000,0,0,0,29000,45000,-16000,-16000
051522,玉晶光凱基95購05,0,0,0,0,0,0,0,0,0,-16000,0,0,0,34000,50000,-16000,-16000
051486,玉晶光凱基97購03,0,0,0,0,0,0,0,0,0,-16000,0,0,0,5000,21000,-16000,-16000
051333,義隆永豐95購02  ,0,0,0,0,0,0,0,0,0,-16000,0,0,0,20000,36000,-16000,-16000
051276,SGBR2X中信97購01,0,0,0,0,0,0,0,0,0,-16000,0,0,0,0,16000,-16000,-16000
051080,全新富邦96購01  ,0,0,0,0,0,0,0,0,0,-16000,0,0,0,10000,26000,-16000,-16000
05019P,喬山中信95售01  ,0,0,0,0,0,0,0,0,0,-16000,0,0,0,24000,40000,-16000,-16000
050612,台積電元大95購06,0,0,0,0,0,0,0,0,0,-16000,0,0,0,20000,36000,-16000,-16000
6136,富爾特          ,6000,22000,-16000,0,0,0,0,0,0,0,0,0,0,0,0,0,-16000
8104,錸寶            ,11000,27000,-16000,0,0,0,0,0,0,0,0,0,0,0,0,0,-16000
9103,美德醫療-DR     ,9000,25000,-16000,0,0,0,0,0,0,0,0,0,0,0,0,0,-16000
08476P,臺股指凱基9C售14,0,0,0,0,0,0,0,0,0,-16000,0,0,0,0,16000,-16000,-16000
2425,承啟            ,44000,60000,-16000,0,0,0,0,0,0,0,0,0,0,0,0,0,-16000
4439,冠星-KY         ,0,16000,-16000,0,0,0,0,0,0,0,0,0,0,0,0,0,-16000
053106,鴻海兆豐98購01  ,0,0,0,0,0,0,0,0,0,-17000,0,0,0,208000,225000,-17000,-17000
053001,力山永豐96購01  ,0,0,0,0,0,0,0,0,0,-17000,0,0,0,0,17000,-17000,-17000
053415,聯茂國票97購01  ,0,0,0,0,0,0,0,0,0,-17000,0,0,0,135000,152000,-17000,-17000
052384,臺股指元大95購30,0,0,0,0,0,0,0,0,0,-17000,0,0,0,0,17000,-17000,-17000
053882,聯發科中信98購02,0,0,0,0,0,0,0,0,0,-17000,0,0,0,0,17000,-17000,-17000
053662,矽力凱基97購01  ,0,0,0,0,0,0,0,0,0,-17000,0,0,0,53000,70000,-17000,-17000
053985,矽創元大96購02  ,0,0,0,0,0,0,0,0,0,-17000,0,0,0,0,17000,-17000,-17000
054562,亞光群益98購01  ,0,0,0,0,0,0,0,0,0,-17000,0,0,0,0,17000,-17000,-17000
054209,台積電國票97購08,0,0,0,0,0,0,0,0,0,-17000,0,0,0,7000,24000,-17000,-17000
054439,健策台新96購03  ,0,0,0,0,0,0,0,0,0,-17000,0,0,0,10000,27000,-17000,-17000
042712,元石油國票95購01,0,0,0,0,0,0,0,0,0,-17000,0,0,0,0,17000,-17000,-17000
044462,漢唐兆豐93購01  ,0,0,0,0,0,0,0,0,0,-17000,0,0,0,0,17000,-17000,-17000
044531,欣興富邦93購01  ,0,0,0,0,0,0,0,0,0,-17000,0,0,0,258000,275000,-17000,-17000
00709,富邦歐洲        ,0,0,0,0,0,0,0,0,0,-17000,0,0,0,100000,117000,-17000,-17000
03740P,奇鋐群益94售01  ,0,0,0,0,0,0,0,0,0,-17000,0,0,0,3000,20000,-17000,-17000
048529,京元電國票94購01,0,0,0,0,0,0,0,0,0,-17000,0,0,0,3000,20000,-17000,-17000
046546,義隆永豐92購03  ,0,0,0,0,0,0,0,0,0,-17000,0,0,0,3000,20000,-17000,-17000
049294,南亞科群益94購01,0,0,0,0,0,0,0,0,0,-17000,0,0,0,85000,102000,-17000,-17000
047703,台積電凱基93購19,0,0,0,0,0,0,0,0,0,-17000,0,0,0,67000,84000,-17000,-17000
048828,禾伸堂凱基94購02,0,0,0,0,0,0,0,0,0,-17000,0,0,0,75000,92000,-17000,-17000
04868P,可成統一94售03  ,0,0,0,0,0,0,0,0,0,-17000,0,0,0,0,17000,-17000,-17000
048661,瑞昱統一93購05  ,0,0,0,0,0,0,0,0,0,-17000,0,0,0,166000,183000,-17000,-17000
048892,台郡元富97購01  ,0,0,0,0,0,0,0,0,0,-17000,0,0,0,71000,88000,-17000,-17000
04749P,臺股指元大94售25,0,0,0,0,0,0,0,0,0,-17000,0,0,0,21000,38000,-17000,-17000
048168,致茂永豐93購02  ,0,0,0,0,0,0,0,0,0,-17000,0,0,0,0,17000,-17000,-17000
050409,華通永豐94購01  ,0,0,0,0,0,0,0,0,0,-17000,0,0,0,68000,85000,-17000,-17000
050114,群創元大95購01  ,0,0,0,0,0,0,0,0,0,-17000,0,0,0,104000,121000,-17000,-17000
049589,奇力新元大95購02,0,0,0,0,0,0,0,0,0,-17000,0,0,0,3000,20000,-17000,-17000
049608,旺宏兆豐94購02  ,0,0,0,0,0,0,0,0,0,-17000,0,0,0,60000,77000,-17000,-17000
051327,元油2X永豐95購02,0,0,0,0,0,0,0,0,0,-17000,0,0,0,0,17000,-17000,-17000
4722,國精化          ,0,17000,-17000,0,0,0,0,0,0,0,0,0,0,0,0,0,-17000
2882A,國泰特          ,0,0,0,0,0,0,0,0,0,-17000,33000,50000,-17000,0,0,0,-17000
3011,今皓            ,0,17000,-17000,0,0,0,0,0,0,0,0,0,0,0,0,0,-17000
2436,偉詮電          ,31000,48000,-17000,0,0,0,0,0,0,0,0,0,0,0,0,0,-17000
2032,新鋼            ,1000,18000,-17000,0,0,0,0,0,0,0,0,0,0,0,0,0,-17000
08751P,友達群益01售01  ,0,0,0,0,0,0,0,0,0,-17000,0,0,0,5000,22000,-17000,-17000
8341,日友            ,21000,37000,-16000,0,0,0,0,0,0,-1000,0,1000,-1000,0,0,0,-17000
054461,台積電凱基97購09,0,0,0,0,0,0,0,0,0,-18000,0,0,0,46000,64000,-18000,-18000
054548,鴻海凱基98購03  ,0,0,0,0,0,0,0,0,0,-18000,0,0,0,5000,23000,-18000,-18000
054642,訊芯中信9A購01  ,0,0,0,0,0,0,0,0,0,-18000,0,0,0,0,18000,-18000,-18000
053886,亞光兆豐96購01  ,0,0,0,0,0,0,0,0,0,-18000,0,0,0,9000,27000,-18000,-18000
053859,台積電元大97購09,0,0,0,0,0,0,0,0,0,-18000,0,0,0,182000,200000,-18000,-18000
052500,元翎永豐95購01  ,0,0,0,0,0,0,0,0,0,-18000,0,0,0,0,18000,-18000,-18000
052899,和大國票97購01  ,0,0,0,0,0,0,0,0,0,-18000,0,0,0,132000,150000,-18000,-18000
053121,上証2X凱基9C購01,0,0,0,0,0,0,0,0,0,-18000,0,0,0,2000,20000,-18000,-18000
053204,旺宏麥證96購01  ,0,0,0,23000,41000,-18000,0,0,0,-18000,0,0,0,23000,41000,-18000,-18000
053233,大立光永豐96購01,0,0,0,0,0,0,0,0,0,-18000,0,0,0,0,18000,-18000,-18000
03085P,台積電元大01售34,0,0,0,0,0,0,0,0,0,-18000,0,0,0,0,18000,-18000,-18000
039319,華新科國泰92購01,0,0,0,0,0,0,0,0,0,-18000,0,0,0,2000,20000,-18000,-18000
044416,台光電統一91購03,0,0,0,0,0,0,0,0,0,-18000,0,0,0,10000,28000,-18000,-18000
042020,佐登元大91購01  ,0,0,0,0,0,0,0,0,0,-18000,0,0,0,2000,20000,-18000,-18000
046298,聯發科富邦94購01,0,0,0,0,0,0,0,0,0,-18000,0,0,0,61000,79000,-18000,-18000
047752,健鼎元富93購01  ,0,0,0,0,0,0,0,0,0,-18000,0,0,0,4000,22000,-18000,-18000
043728,美律國泰93購01  ,0,0,0,0,0,0,0,0,0,-18000,0,0,0,22000,40000,-18000,-18000
044841,台光電元富91購04,0,0,0,0,0,0,0,0,0,-18000,0,0,0,0,18000,-18000,-18000
045346,潤泰全凱基92購02,0,0,0,0,0,0,0,0,0,-18000,0,0,0,0,18000,-18000,-18000
047482,新光金凱基99購03,0,0,0,0,0,0,0,0,0,-18000,0,0,0,2000,20000,-18000,-18000
048110,京元電群益94購01,0,0,0,0,0,0,0,0,0,-18000,0,0,0,2000,20000,-18000,-18000
047311,台積電元大93購19,0,0,0,0,0,0,0,0,0,-18000,0,0,0,10000,28000,-18000,-18000
047348,台光電凱基94購02,0,0,0,0,0,0,0,0,0,-18000,0,0,0,50000,68000,-18000,-18000
047696,聯發科國票94購02,0,0,0,0,0,0,0,0,0,-18000,0,0,0,15000,33000,-18000,-18000
049259,聯發科元大94購04,0,0,0,0,0,0,0,0,0,-18000,0,0,0,19000,37000,-18000,-18000
046961,大立光中信95購02,0,0,0,0,0,0,0,0,0,-18000,0,0,0,36000,54000,-18000,-18000
046753,台積電凱基93購04,0,0,0,0,0,0,0,0,0,-18000,0,0,0,47000,65000,-18000,-18000
046831,大立光群益94購01,0,0,0,0,0,0,0,0,0,-18000,0,0,0,5000,23000,-18000,-18000
051355,聯發科元大96購01,0,0,0,0,0,0,0,0,0,-18000,0,0,0,86000,104000,-18000,-18000
051281,健策兆豐96購01  ,0,0,0,0,0,0,0,0,0,-18000,0,0,0,6000,24000,-18000,-18000
05208P,TPK中信95售01   ,0,0,0,0,0,0,0,0,0,-18000,0,0,0,0,18000,-18000,-18000
049667,大立光國泰96購01,0,0,0,0,0,0,0,0,0,-18000,0,0,0,12000,30000,-18000,-18000
050184,信邦元大94購01  ,0,0,0,0,0,0,0,0,0,-18000,0,0,0,0,18000,-18000,-18000
050492,漢唐國泰96購01  ,0,0,0,0,0,0,0,0,0,-18000,0,0,0,12000,30000,-18000,-18000
050325,台積電永豐94購05,0,0,0,0,0,0,0,0,0,-18000,0,0,0,115000,133000,-18000,-18000
05068P,鴻海統一95售06  ,0,0,0,0,0,0,0,0,0,-18000,0,0,0,261000,279000,-18000,-18000
2020,美亞            ,15000,33000,-18000,0,0,0,0,0,0,0,0,0,0,0,0,0,-18000
1720,生達            ,11000,29000,-18000,0,0,0,0,0,0,0,0,0,0,0,0,0,-18000
2850,新產            ,11000,29000,-18000,0,0,0,0,0,0,0,0,0,0,0,0,0,-18000
2634,漢翔            ,990000,989390,610,0,0,0,0,0,0,-19000,11000,30000,-19000,0,0,0,-18390
053061,GIS富邦97購01   ,0,0,0,0,0,0,0,0,0,-19000,0,0,0,33000,52000,-19000,-19000
053298,SP黃豆凱基99購01,0,0,0,0,0,0,0,0,0,-19000,0,0,0,1000,20000,-19000,-19000
054189,貿聯永豐96購03  ,0,0,0,0,0,0,0,0,0,-19000,0,0,0,1000,20000,-19000,-19000
054107,上銀凱基97購01  ,0,0,0,0,0,0,0,0,0,-19000,0,0,0,60000,79000,-19000,-19000
054118,國巨永豐96購04  ,0,0,0,0,0,0,0,0,0,-19000,0,0,0,205000,224000,-19000,-19000
054489,牧德台新97購02  ,0,0,0,0,0,0,0,0,0,-19000,0,0,0,180000,199000,-19000,-19000
054482,大成鋼台新96購01,0,0,0,0,0,0,0,0,0,-19000,0,0,0,0,19000,-19000,-19000
045256,致茂凱基92購01  ,0,0,0,0,0,0,0,0,0,-19000,0,0,0,41000,60000,-19000,-19000
045068,台光電元大92購05,0,0,0,0,0,0,0,0,0,-19000,0,0,0,71000,90000,-19000,-19000
04563P,可成凱基94售05  ,0,0,0,0,0,0,0,0,0,-19000,0,0,0,47000,66000,-19000,-19000
045801,緯穎第一92購01  ,0,0,0,0,0,0,0,0,0,-19000,0,0,0,0,19000,-19000,-19000
041308,群創群益92購01  ,0,0,0,0,0,0,0,0,0,-19000,0,0,0,29000,48000,-19000,-19000
04177P,富邦金元大94售01,0,0,0,0,0,0,0,0,0,-19000,0,0,0,1000,20000,-19000,-19000
042919,GIS元大93購01   ,0,0,0,0,0,0,0,0,0,-19000,0,0,0,2000,21000,-19000,-19000
04311P,奇力新統一95售01,0,0,0,0,0,0,0,0,0,-19000,0,0,0,0,19000,-19000,-19000
044717,旺宏統一94購01  ,0,0,0,0,0,0,0,0,0,-19000,0,0,0,1081000,1100000,-19000,-19000
03126P,旭富凱基01售04  ,0,0,0,0,0,0,0,0,0,-19000,0,0,0,0,19000,-19000,-19000
045966,聯詠凱基92購07  ,0,0,0,0,0,0,0,0,0,-19000,0,0,0,40000,59000,-19000,-19000
045911,廣達國票92購01  ,0,0,0,0,0,0,0,0,0,-19000,0,0,0,0,19000,-19000,-19000
048570,鈺齊元大93購01  ,0,0,0,0,0,0,0,0,0,-19000,0,0,0,1000,20000,-19000,-19000
046472,亞光永豐92購01  ,0,0,0,0,0,0,0,0,0,-19000,0,0,0,33000,52000,-19000,-19000
046455,瑞昱凱基92購03  ,0,0,0,0,0,0,0,0,0,-19000,0,0,0,1000,20000,-19000,-19000
046453,台積電凱基92購21,0,0,0,0,0,0,0,0,0,-19000,0,0,0,42000,61000,-19000,-19000
049175,台積電凱基94購12,0,0,0,0,0,0,0,0,0,-19000,0,0,0,2000,21000,-19000,-19000
047677,亞德客台新93購01,0,0,0,0,0,0,0,0,0,-19000,0,0,0,7000,26000,-19000,-19000
048960,矽格康和94購01  ,0,0,0,0,0,0,0,0,0,-19000,0,0,0,0,19000,-19000,-19000
04870P,大立光元富94售11,0,0,0,0,0,0,0,0,0,-19000,0,0,0,1000,20000,-19000,-19000
048923,國巨永豐94購02  ,0,0,0,0,0,0,0,0,0,-19000,0,0,0,22000,41000,-19000,-19000
052168,鴻海元大96購10  ,0,0,0,0,0,0,0,0,0,-19000,0,0,0,205000,224000,-19000,-19000
051947,矽力統一95購01  ,0,0,0,0,0,0,0,0,0,-19000,0,0,0,1000,20000,-19000,-19000
051972,廣達凱基95購02  ,0,0,0,0,0,0,0,0,0,-19000,0,0,0,1000,20000,-19000,-19000
05178P,大立光凱基96售05,0,0,0,0,0,0,0,0,0,-19000,0,0,0,38000,57000,-19000,-19000
051842,大成鋼富邦97購01,0,0,0,0,0,0,0,0,0,-19000,0,0,0,100000,119000,-19000,-19000
051136,可成永豐95購02  ,0,0,0,0,0,0,0,0,0,-19000,0,0,0,280000,299000,-19000,-19000
2305,全友            ,6000,25000,-19000,0,0,0,0,0,0,0,0,0,0,0,0,0,-19000
1414,東和            ,5000,24000,-19000,0,0,0,0,0,0,0,0,0,0,0,0,0,-19000
05596P,可成統一96售01  ,0,0,0,0,0,0,0,0,0,-19000,0,0,0,0,19000,-19000,-19000
6552,易華電          ,25000,26000,-1000,0,0,0,0,0,0,-18000,1000,4000,-3000,17000,32000,-15000,-19000
6278,台表科          ,1015000,623000,392000,0,0,0,88000,153000,-65000,-346000,35000,251000,-216000,100000,230000,-130000,-19000
054388,漢唐統一97購02  ,0,0,0,0,0,0,0,0,0,-20000,0,0,0,0,20000,-20000,-20000
054383,傳奇群益97購01  ,0,0,0,0,0,0,0,0,0,-20000,0,0,0,0,20000,-20000,-20000
054214,京鼎國票97購02  ,0,0,0,0,0,0,0,0,0,-20000,0,0,0,0,20000,-20000,-20000
054314,嘉聯益凱基97購01,0,0,0,0,0,0,0,0,0,-20000,0,0,0,0,20000,-20000,-20000
054668,傳奇元富97購03  ,0,0,0,0,0,0,0,0,0,-20000,0,0,0,0,20000,-20000,-20000
054652,裕隆麥證97購01  ,0,0,0,0,20000,-20000,0,0,0,-20000,0,0,0,0,20000,-20000,-20000
054654,全新麥證99購01  ,0,0,0,0,20000,-20000,0,0,0,-20000,0,0,0,0,20000,-20000,-20000
054675,美律台新98購01  ,0,0,0,0,0,0,0,0,0,-20000,0,0,0,0,20000,-20000,-20000
054569,GIS群益98購01   ,0,0,0,0,0,0,0,0,0,-20000,0,0,0,10000,30000,-20000,-20000
054744,晶相光凱基99購01,0,0,0,0,0,0,0,0,0,-20000,0,0,0,0,20000,-20000,-20000
054736,南亞科凱基98購01,0,0,0,0,0,0,0,0,0,-20000,0,0,0,0,20000,-20000,-20000
054825,康友元大97購01  ,0,0,0,0,0,0,0,0,0,-20000,0,0,0,31000,51000,-20000,-20000
054128,台積電元大97購10,0,0,0,0,0,0,0,0,0,-20000,0,0,0,391000,411000,-20000,-20000
054074,健策富邦98購01  ,0,0,0,0,0,0,0,0,0,-20000,0,0,0,0,20000,-20000,-20000
054082,楠梓電元富96購01,0,0,0,0,0,0,0,0,0,-20000,0,0,0,0,20000,-20000,-20000
054179,上海銀台新97購01,0,0,0,0,0,0,0,0,0,-20000,0,0,0,49000,69000,-20000,-20000
054024,中鋼康和96購01  ,0,0,0,0,0,0,0,0,0,-20000,0,0,0,0,20000,-20000,-20000
054020,技嘉台新97購01  ,0,0,0,0,0,0,0,0,0,-20000,0,0,0,10000,30000,-20000,-20000
054041,鴻海元大96購22  ,0,0,0,0,0,0,0,0,0,-20000,0,0,0,148000,168000,-20000,-20000
053894,創意群益96購01  ,0,0,0,0,0,0,0,0,0,-20000,0,0,0,0,20000,-20000,-20000
053841,美律統一96購01  ,0,0,0,0,0,0,0,0,0,-20000,0,0,0,70000,90000,-20000,-20000
053824,樺漢群益96購02  ,0,0,0,0,0,0,0,0,0,-20000,0,0,0,0,20000,-20000,-20000
053775,鴻海元大96購21  ,0,0,0,0,0,0,0,0,0,-20000,0,0,0,225000,245000,-20000,-20000
053764,A50正2富邦99購01,0,0,0,0,0,0,0,0,0,-20000,0,0,0,0,20000,-20000,-20000
053800,華通凱基97購03  ,0,0,0,0,0,0,0,0,0,-20000,0,0,0,0,20000,-20000,-20000
053808,大成鋼群益97購01,0,0,0,0,0,0,0,0,0,-20000,0,0,0,0,20000,-20000,-20000
05368P,可成元富95售03  ,0,0,0,0,0,0,0,0,0,-20000,0,0,0,0,20000,-20000,-20000
053267,華新科群益96購02,0,0,0,0,0,0,0,0,0,-20000,0,0,0,45000,65000,-20000,-20000
053369,T50反1元大96購06,0,0,0,0,0,0,0,0,0,-20000,0,0,0,0,20000,-20000,-20000
053497,新光金兆豐97購01,0,0,0,0,0,0,0,0,0,-20000,0,0,0,0,20000,-20000,-20000
052953,百和國票97購01  ,0,0,0,0,0,0,0,0,0,-20000,0,0,0,51000,71000,-20000,-20000
052951,GIS國票97購02   ,0,0,0,0,0,0,0,0,0,-20000,0,0,0,0,20000,-20000,-20000
053095,台光電統一98購01,0,0,0,0,0,0,0,0,0,-20000,0,0,0,10000,30000,-20000,-20000
052804,淘帝元大96購01  ,0,0,0,0,0,0,0,0,0,-20000,0,0,0,0,20000,-20000,-20000
052769,達興群益96購01  ,0,0,0,0,0,0,0,0,0,-20000,0,0,0,0,20000,-20000,-20000
052614,聯電國泰97購01  ,0,0,0,0,0,0,0,0,0,-20000,0,0,0,1000,21000,-20000,-20000
052725,為升元富96購01  ,0,0,0,0,0,0,0,0,0,-20000,0,0,0,0,20000,-20000,-20000
052565,上銀凱基96購01  ,0,0,0,0,0,0,0,0,0,-20000,0,0,0,29000,49000,-20000,-20000
052440,上証2X元大95購02,0,0,0,0,0,0,0,0,0,-20000,0,0,0,0,20000,-20000,-20000
052454,力成元大95購02  ,0,0,0,0,0,0,0,0,0,-20000,0,0,0,61000,81000,-20000,-20000
052398,瑞昱凱基95購06  ,0,0,0,0,0,0,0,0,0,-20000,0,0,0,0,20000,-20000,-20000
052378,矽力元大96購01  ,0,0,0,0,0,0,0,0,0,-20000,0,0,0,0,20000,-20000,-20000
052332,美律亞東96購01  ,0,0,0,0,0,0,0,0,0,-20000,0,0,0,0,20000,-20000,-20000
03799P,京元電元大94售01,0,0,0,0,0,0,0,0,0,-20000,0,0,0,230000,250000,-20000,-20000
03885P,華新科統一96售01,0,0,0,0,0,0,0,0,0,-20000,0,0,0,10000,30000,-20000,-20000
03823P,嘉澤元富93售01  ,0,0,0,0,0,0,0,0,0,-20000,0,0,0,0,20000,-20000,-20000
03400P,滬深2X凱基05售01,0,0,0,0,0,0,0,0,0,-20000,0,0,0,0,20000,-20000,-20000
044700,亞光元大91購01  ,0,0,0,0,0,0,0,0,0,-20000,0,0,0,0,20000,-20000,-20000
044524,瑞儀凱基93購02  ,0,0,0,0,0,0,0,0,0,-20000,0,0,0,0,20000,-20000,-20000
044512,奇力新凱基93購02,0,0,0,0,0,0,0,0,0,-20000,0,0,0,1000,21000,-20000,-20000
043650,喬山國泰93購02  ,0,0,0,0,0,0,0,0,0,-20000,0,0,0,26000,46000,-20000,-20000
043474,創意元大92購01  ,0,0,0,0,0,0,0,0,0,-20000,0,0,0,0,20000,-20000,-20000
043060,欣興中信93購01  ,0,0,0,0,0,0,0,0,0,-20000,0,0,0,0,20000,-20000,-20000
043023,康普元大94購01  ,0,0,0,0,0,0,0,0,0,-20000,0,0,0,0,20000,-20000,-20000
04285P,超眾永豐93售04  ,0,0,0,0,0,0,0,0,0,-20000,0,0,0,0,20000,-20000,-20000
042566,新光金凱基91購02,0,0,0,0,0,0,0,0,0,-20000,0,0,0,0,20000,-20000,-20000
042502,上銀凱基93購01  ,0,0,0,0,0,0,0,0,0,-20000,0,0,0,10000,30000,-20000,-20000
04241P,欣興國泰95售02  ,0,0,0,0,0,0,0,0,0,-20000,0,0,0,10000,30000,-20000,-20000
04137P,元油反國票97售01,0,0,0,0,0,0,0,0,0,-20000,0,0,0,0,20000,-20000,-20000
04109P,臺股指永昌93售04,0,0,0,0,0,0,0,0,0,-20000,0,0,0,0,20000,-20000,-20000
046266,兆豐金凱基92購01,0,0,0,0,0,0,0,0,0,-20000,0,0,0,0,20000,-20000,-20000
048204,訊芯元大93購06  ,0,0,0,0,0,0,0,0,0,-20000,0,0,0,15000,35000,-20000,-20000
048206,臺股指元大93購40,0,0,0,0,0,0,0,0,0,-20000,0,0,0,0,20000,-20000,-20000
048219,為升凱基93購06  ,0,0,0,0,0,0,0,0,0,-20000,0,0,0,0,20000,-20000,-20000
048242,統一兆豐93購01  ,0,0,0,0,0,0,0,0,0,-20000,0,0,0,0,20000,-20000,-20000
048316,可成凱基93購15  ,0,0,0,0,0,0,0,0,0,-20000,0,0,0,0,20000,-20000,-20000
048320,聯詠凱基93購08  ,0,0,0,0,0,0,0,0,0,-20000,0,0,0,6000,26000,-20000,-20000
045615,樺漢群益92購01  ,0,0,0,0,0,0,0,0,0,-20000,0,0,0,0,20000,-20000,-20000
044275,欣興群益92購01  ,0,0,0,0,0,0,0,0,0,-20000,0,0,0,5000,25000,-20000,-20000
044267,潤泰全中信91購01,0,0,0,0,0,0,0,0,0,-20000,0,0,0,0,20000,-20000,-20000
044219,智原凱基91購03  ,0,0,0,0,0,0,0,0,0,-20000,0,0,0,0,20000,-20000,-20000
043685,聯詠凱基91購02  ,0,0,0,0,0,0,0,0,0,-20000,0,0,0,0,20000,-20000,-20000
045726,矽創凱基92購01  ,0,0,0,0,0,0,0,0,0,-20000,0,0,0,0,20000,-20000,-20000
045006,華邦電元大92購02,0,0,0,0,0,0,0,0,0,-20000,0,0,0,0,20000,-20000,-20000
045171,可成兆豐92購02  ,0,0,0,0,0,0,0,0,0,-20000,0,0,0,0,20000,-20000,-20000
045154,欣興凱基92購03  ,0,0,0,0,0,0,0,0,0,-20000,0,0,0,0,20000,-20000,-20000
044788,南亞科群益91購06,0,0,0,0,0,0,0,0,0,-20000,0,0,0,0,20000,-20000,-20000
044758,玉山金凱基93購01,0,0,0,0,0,0,0,0,0,-20000,0,0,0,0,20000,-20000,-20000
044911,和碩凱基91購01  ,0,0,0,0,0,0,0,0,0,-20000,0,0,0,0,20000,-20000,-20000
044906,晶技凱基91購01  ,0,0,0,0,0,0,0,0,0,-20000,0,0,0,12000,32000,-20000,-20000
045252,國巨凱基93購03  ,0,0,0,0,0,0,0,0,0,-20000,0,0,0,0,20000,-20000,-20000
045248,儒鴻凱基92購01  ,0,0,0,0,0,0,0,0,0,-20000,0,0,0,0,20000,-20000,-20000
045377,華邦電元大93購01,0,0,0,0,0,0,0,0,0,-20000,0,0,0,50000,70000,-20000,-20000
045372,台塑元大92購01  ,0,0,0,0,0,0,0,0,0,-20000,0,0,0,0,20000,-20000,-20000
045461,廣達元大92購01  ,0,0,0,0,0,0,0,0,0,-20000,0,0,0,0,20000,-20000,-20000
043911,可成凱基91購05  ,0,0,0,0,0,0,0,0,0,-20000,0,0,0,0,20000,-20000,-20000
043933,訊芯永豐91購01  ,0,0,0,0,0,0,0,0,0,-20000,0,0,0,49000,69000,-20000,-20000
04396P,玉晶光群益94售02,0,0,0,0,0,0,0,0,0,-20000,0,0,0,40000,60000,-20000,-20000
048952,川湖康和94購01  ,0,0,0,0,0,0,0,0,0,-20000,0,0,0,0,20000,-20000,-20000
048723,世紀鋼永豐94購02,0,0,0,0,0,0,0,0,0,-20000,0,0,0,0,20000,-20000,-20000
048830,和鑫凱基94購03  ,0,0,0,0,0,0,0,0,0,-20000,0,0,0,0,20000,-20000,-20000
048842,矽格凱基94購01  ,0,0,0,0,0,0,0,0,0,-20000,0,0,0,0,20000,-20000,-20000
048906,強茂富邦95購01  ,0,0,0,0,0,0,0,0,0,-20000,0,0,0,125000,145000,-20000,-20000
047064,致伸凱基93購03  ,0,0,0,0,0,0,0,0,0,-20000,0,0,0,3000,23000,-20000,-20000
048854,凌陽群益94購02  ,0,0,0,0,0,0,0,0,0,-20000,0,0,0,0,20000,-20000,-20000
048961,矽創康和94購01  ,0,0,0,0,0,0,0,0,0,-20000,0,0,0,0,20000,-20000,-20000
048101,致伸凱基93購05  ,0,0,0,0,0,0,0,0,0,-20000,0,0,0,0,20000,-20000,-20000
048139,南電國票94購02  ,0,0,0,0,0,0,0,0,0,-20000,0,0,0,0,20000,-20000,-20000
047140,滬深2X兆豐94購01,0,0,0,0,0,0,0,0,0,-20000,0,0,0,0,20000,-20000,-20000
047184,漢唐元大94購02  ,0,0,0,0,0,0,0,0,0,-20000,0,0,0,0,20000,-20000,-20000
047477,台積電凱基93購15,0,0,0,0,0,0,0,0,0,-20000,0,0,0,3000,23000,-20000,-20000
047444,晶技元大93購03  ,0,0,0,0,0,0,0,0,0,-20000,0,0,0,34000,54000,-20000,-20000
047208,智易國泰94購01  ,0,0,0,0,0,0,0,0,0,-20000,0,0,0,20000,40000,-20000,-20000
047242,上銀群益93購04  ,0,0,0,0,0,0,0,0,0,-20000,0,0,0,0,20000,-20000,-20000
047227,華新科凱基94購01,0,0,0,0,0,0,0,0,0,-20000,0,0,0,0,20000,-20000,-20000
047251,麗豐群益93購01  ,0,0,0,0,0,0,0,0,0,-20000,0,0,0,0,20000,-20000,-20000
047301,啟碁國泰94購01  ,0,0,0,0,0,0,0,0,0,-20000,0,0,0,59000,79000,-20000,-20000
047598,深中小統一94購01,0,0,0,0,0,0,0,0,0,-20000,0,0,0,167000,187000,-20000,-20000
049018,光罩群益94購01  ,0,0,0,0,0,0,0,0,0,-20000,0,0,0,0,20000,-20000,-20000
049088,上緯控凱基94購02,0,0,0,0,0,0,0,0,0,-20000,0,0,0,10000,30000,-20000,-20000
049254,台積電元大96購02,0,0,0,0,0,0,0,0,0,-20000,0,0,0,0,20000,-20000,-20000
049337,台達電統一94購03,0,0,0,0,0,0,0,0,0,-20000,0,0,0,10000,30000,-20000,-20000
049207,茂林群益94購02  ,0,0,0,0,0,0,0,0,0,-20000,0,0,0,0,20000,-20000,-20000
049374,大立光元大94購12,0,0,0,0,0,0,0,0,0,-20000,0,0,0,11000,31000,-20000,-20000
046382,明泰凱基93購01  ,0,0,0,0,0,0,0,0,0,-20000,0,0,0,0,20000,-20000,-20000
048641,美律元大94購01  ,0,0,0,0,0,0,0,0,0,-20000,0,0,0,0,20000,-20000,-20000
048536,南電國票93購04  ,0,0,0,0,0,0,0,0,0,-20000,0,0,0,0,20000,-20000,-20000
046691,儒鴻凱基93購02  ,0,0,0,0,0,0,0,0,0,-20000,0,0,0,38000,58000,-20000,-20000
046693,台積電凱基93購03,0,0,0,0,0,0,0,0,0,-20000,0,0,0,7000,27000,-20000,-20000
045932,亞泥群益92購01  ,0,0,0,0,0,0,0,0,0,-20000,0,0,0,20000,40000,-20000,-20000
046100,京元電永豐92購01,0,0,0,0,0,0,0,0,0,-20000,0,0,0,0,20000,-20000,-20000
046014,緯穎元富92購02  ,0,0,0,0,0,0,0,0,0,-20000,0,0,0,40000,60000,-20000,-20000
046746,儒鴻凱基93購03  ,0,0,0,0,0,0,0,0,0,-20000,0,0,0,0,20000,-20000,-20000
047987,力成群益93購01  ,0,0,0,0,0,0,0,0,0,-20000,0,0,0,0,20000,-20000,-20000
046998,同欣電國泰94購01,0,0,0,0,0,0,0,0,0,-20000,0,0,0,0,20000,-20000,-20000
047041,貿聯群益93購02  ,0,0,0,0,0,0,0,0,0,-20000,0,0,0,0,20000,-20000,-20000
048068,南亞科元富95購01,0,0,0,0,0,0,0,0,0,-20000,0,0,0,0,20000,-20000,-20000
048060,台達電統一93購01,0,0,0,0,0,0,0,0,0,-20000,0,0,0,10000,30000,-20000,-20000
051085,鴻海元大95購03  ,0,0,0,0,0,0,0,0,0,-20000,0,0,0,291000,311000,-20000,-20000
051109,美律統一95購02  ,0,0,0,0,0,0,0,0,0,-20000,0,0,0,60000,80000,-20000,-20000
051225,台積電群益95購02,0,0,0,0,0,0,0,0,0,-20000,0,0,0,4000,24000,-20000,-20000
051081,聯茂富邦96購01  ,0,0,0,0,0,0,0,0,0,-20000,0,0,0,0,20000,-20000,-20000
051053,台光電群益95購01,0,0,0,0,0,0,0,0,0,-20000,0,0,0,127000,147000,-20000,-20000
051307,康舒凱基95購01  ,0,0,0,0,0,0,0,0,0,-20000,0,0,0,18000,38000,-20000,-20000
051315,同欣電麥證95購01,0,0,0,0,20000,-20000,0,0,0,-20000,0,0,0,0,20000,-20000,-20000
051460,S&P反1國泰97購01,0,0,0,0,0,0,0,0,0,-20000,0,0,0,0,20000,-20000,-20000
051444,聯發科元大95購11,0,0,0,0,0,0,0,0,0,-20000,0,0,0,1000,21000,-20000,-20000
051779,大立光群益95購02,0,0,0,0,0,0,0,0,0,-20000,0,0,0,3000,23000,-20000,-20000
051728,道瓊反國票97購01,0,0,0,0,0,0,0,0,0,-20000,0,0,0,0,20000,-20000,-20000
051623,和碩凱基96購02  ,0,0,0,0,0,0,0,0,0,-20000,0,0,0,10000,30000,-20000,-20000
051938,旭富群益95購01  ,0,0,0,0,0,0,0,0,0,-20000,0,0,0,0,20000,-20000,-20000
052206,燿華中信95購02  ,0,0,0,0,0,0,0,0,0,-20000,0,0,0,0,20000,-20000,-20000
050693,鴻海凱基96購05  ,0,0,0,0,0,0,0,0,0,-20000,0,0,0,12000,32000,-20000,-20000
050656,瑞儀凱基96購01  ,0,0,0,0,0,0,0,0,0,-20000,0,0,0,0,20000,-20000,-20000
050620,和碩元大94購04  ,0,0,0,0,0,0,0,0,0,-20000,0,0,0,0,20000,-20000,-20000
050627,華通中信94購02  ,0,0,0,0,0,0,0,0,0,-20000,0,0,0,0,20000,-20000,-20000
050637,欣興國票94購02  ,0,0,0,0,0,0,0,0,0,-20000,0,0,0,0,20000,-20000,-20000
050810,鴻海凱基95購09  ,0,0,0,0,0,0,0,0,0,-20000,0,0,0,21000,41000,-20000,-20000
050721,台泥國票94購01  ,0,0,0,0,0,0,0,0,0,-20000,0,0,0,180000,200000,-20000,-20000
050222,瑞儀元富94購01  ,0,1000,-1000,0,0,0,0,0,0,-19000,0,0,0,60000,79000,-19000,-20000
050237,智邦凱基94購03  ,0,0,0,0,0,0,0,0,0,-20000,0,0,0,0,20000,-20000,-20000
050507,聯詠凱基94購06  ,0,0,0,0,0,0,0,0,0,-20000,0,0,0,0,20000,-20000,-20000
050532,矽創元大94購03  ,0,0,0,0,0,0,0,0,0,-20000,0,0,0,0,20000,-20000,-20000
050527,嘉聯益元大96購01,0,0,0,0,0,0,0,0,0,-20000,0,0,0,0,20000,-20000,-20000
050164,揚明光國泰95購01,0,0,0,0,0,0,0,0,0,-20000,0,0,0,0,20000,-20000,-20000
050139,華通亞東94購01  ,0,0,0,0,0,0,0,0,0,-20000,0,0,0,0,20000,-20000,-20000
050018,高股息元大94購02,0,0,0,0,0,0,0,0,0,-20000,0,0,0,0,20000,-20000,-20000
049662,燿華永豐95購02  ,0,0,0,0,0,0,0,0,0,-20000,0,0,0,0,20000,-20000,-20000
049718,南亞科凱基94購04,0,0,0,0,0,0,0,0,0,-20000,0,0,0,0,20000,-20000,-20000
049579,鴻海元大94購06  ,0,0,0,0,0,0,0,0,0,-20000,0,0,0,0,20000,-20000,-20000
8482,商億-KY         ,47000,67000,-20000,0,0,0,0,0,0,0,0,0,0,0,0,0,-20000
05575P,玉晶光元富96售01,0,0,0,0,0,0,0,0,0,-20000,0,0,0,0,20000,-20000,-20000
05771P,大立光凱基96售13,0,0,0,0,0,0,0,0,0,-20000,0,0,0,0,20000,-20000,-20000
05932P,鴻海凱基96售16  ,0,0,0,0,0,0,0,0,0,-20000,0,0,0,0,20000,-20000,-20000
05813P,臺股指國票96售06,0,0,0,0,0,0,0,0,0,-20000,0,0,0,0,20000,-20000,-20000
05858P,矽力中信96售01  ,0,0,0,0,0,0,0,0,0,-20000,0,0,0,0,20000,-20000,-20000
05854P,華新科凱基96售09,0,0,0,0,0,0,0,0,0,-20000,0,0,0,20000,40000,-20000,-20000
1315,達新            ,27000,47000,-20000,0,0,0,0,0,0,0,0,0,0,0,0,0,-20000
06065P,大立光台新97售01,0,0,0,0,0,0,0,0,0,-20000,0,0,0,0,20000,-20000,-20000
05997P,嘉聯益群益96售02,0,0,0,0,0,0,0,0,0,-20000,0,0,0,10000,30000,-20000,-20000
2488,漢平            ,7000,27000,-20000,0,0,0,0,0,0,0,0,0,0,0,0,0,-20000
2420,新巨            ,11000,31000,-20000,0,0,0,0,0,0,0,0,0,0,0,0,0,-20000
2727,王品            ,14000,34000,-20000,0,0,0,0,0,0,0,0,0,0,0,0,0,-20000
3311,閎暉            ,4000,24000,-20000,0,0,0,0,0,0,0,0,0,0,0,0,0,-20000
052329,台積電亞東96購01,0,0,0,0,0,0,0,0,0,-21000,0,0,0,22000,43000,-21000,-21000
052456,滬深2X元富9B購03,0,0,0,0,0,0,0,0,0,-21000,0,0,0,8000,29000,-21000,-21000
052676,聯發科永昌98購01,0,0,0,0,0,0,0,0,0,-21000,0,0,0,32000,53000,-21000,-21000
053119,日月光中信97購01,0,0,0,0,0,0,0,0,0,-21000,0,0,0,50000,71000,-21000,-21000
053498,大立光兆豐96購03,0,0,0,0,0,0,0,0,0,-21000,0,0,0,0,21000,-21000,-21000
053575,聯詠元富96購01  ,0,0,0,0,0,0,0,0,0,-21000,0,0,0,4000,25000,-21000,-21000
054026,台積電凱基97購08,0,0,0,0,0,0,0,0,0,-21000,0,0,0,4000,25000,-21000,-21000
053947,義隆富邦97購01  ,0,0,0,0,0,0,0,0,0,-21000,0,0,0,0,21000,-21000,-21000
045720,台光電凱基93購07,0,0,0,0,0,0,0,0,0,-21000,0,0,0,0,21000,-21000,-21000
048211,大立光日盛93購01,0,0,0,0,0,0,0,0,0,-21000,0,0,0,0,21000,-21000,-21000
047007,大立光統一93購05,0,0,0,0,0,0,0,0,0,-21000,0,0,0,0,21000,-21000,-21000
046773,GIS富邦94購01   ,0,0,0,0,0,0,0,0,0,-21000,0,0,0,0,21000,-21000,-21000
046866,台積電統一94購03,0,0,0,0,0,0,0,0,0,-21000,0,0,0,12000,33000,-21000,-21000
046540,創意群益92購04  ,0,0,0,0,0,0,0,0,0,-21000,0,0,0,0,21000,-21000,-21000
047822,臺股指凱基93購16,0,0,0,0,0,0,0,0,0,-21000,0,0,0,0,21000,-21000,-21000
046356,智伸科群益93購01,0,0,0,0,0,0,0,0,0,-21000,0,0,0,55000,76000,-21000,-21000
047865,健鼎康和93購01  ,0,0,0,0,0,0,0,0,0,-21000,0,0,0,39000,60000,-21000,-21000
047707,南亞科凱基93購03,0,0,0,0,0,0,0,0,0,-21000,0,0,0,0,21000,-21000,-21000
047202,欣興元富96購01  ,0,0,0,0,0,0,0,0,0,-21000,0,0,0,98000,119000,-21000,-21000
049562,和大統一94購01  ,0,0,0,0,0,0,0,0,0,-21000,0,0,0,39000,60000,-21000,-21000
050436,大立光凱基94購18,0,0,0,0,0,0,0,0,0,-21000,0,0,0,0,21000,-21000,-21000
050767,京元電元大96購01,0,0,0,0,0,0,0,0,0,-21000,0,0,0,80000,101000,-21000,-21000
050670,牧德永豐94購03  ,0,0,0,0,0,0,0,0,0,-21000,0,0,0,94000,115000,-21000,-21000
052165,訊芯永豐95購03  ,0,0,0,0,0,0,0,0,0,-21000,0,0,0,52000,73000,-21000,-21000
051876,宏達電國票96購01,0,0,0,0,0,0,0,0,0,-21000,0,0,0,11000,32000,-21000,-21000
051523,牧德凱基95購02  ,0,0,0,0,0,0,0,0,0,-21000,0,0,0,89000,110000,-21000,-21000
052218,大立光日盛95購01,0,0,0,0,0,0,0,0,0,-21000,0,0,0,0,21000,-21000,-21000
4164,承業醫          ,28000,52000,-24000,0,0,0,0,0,0,3000,3000,0,3000,0,0,0,-21000
05944P,富邦金中信96售01,0,0,0,0,0,0,0,0,0,-21000,0,0,0,0,21000,-21000,-21000
05899P,臺股指凱基96售30,0,0,0,0,0,0,0,0,0,-21000,0,0,0,31000,52000,-21000,-21000
8070,長華*           ,24000,43000,-19000,0,0,0,0,0,0,-2000,0,0,0,0,2000,-2000,-21000
8021,尖點            ,119000,140000,-21000,0,0,0,0,0,0,0,0,0,0,0,0,0,-21000
054171,台郡凱基97購01  ,0,0,0,0,0,0,0,0,0,-22000,0,0,0,0,22000,-22000,-22000
053810,台達電群益96購01,0,0,0,0,0,0,0,0,0,-22000,0,0,0,0,22000,-22000,-22000
054261,智伸科元大96購03,0,0,0,0,0,0,0,0,0,-22000,0,0,0,15000,37000,-22000,-22000
054462,旺宏凱基96購08  ,0,0,0,0,0,0,0,0,0,-22000,0,0,0,95000,117000,-22000,-22000
054438,群創台新96購01  ,0,0,0,0,0,0,0,0,0,-22000,0,0,0,0,22000,-22000,-22000
053401,臺股指中信99購01,0,0,0,0,0,0,0,0,0,-22000,0,0,0,0,22000,-22000,-22000
053294,聯發科中信9C購01,0,0,0,0,0,0,0,0,0,-22000,0,0,0,20000,42000,-22000,-22000
053168,晶技群益98購01  ,0,0,0,0,0,0,0,0,0,-22000,0,0,0,0,22000,-22000,-22000
053179,大立光統一96購04,0,0,0,0,0,0,0,0,0,-22000,0,0,0,61000,83000,-22000,-22000
053006,玉晶光永豐96購03,0,0,0,0,0,0,0,0,0,-22000,0,0,0,79000,101000,-22000,-22000
052528,茂林元大95購05  ,0,0,0,0,0,0,0,0,0,-22000,0,0,0,27000,49000,-22000,-22000
048203,矽力元大93購02  ,0,0,0,0,0,0,0,0,0,-22000,0,0,0,0,22000,-22000,-22000
045571,元油2X元大95購04,0,0,0,0,0,0,0,0,0,-22000,0,0,0,0,22000,-22000,-22000
041991,元油2X國票98購01,0,0,0,0,0,0,0,0,0,-22000,0,0,0,6000,28000,-22000,-22000
03998P,GIS群益93售01   ,0,0,0,0,0,0,0,0,0,-22000,0,0,0,0,22000,-22000,-22000
03756P,創意永豐93售01  ,0,0,0,0,0,0,0,0,0,-22000,0,0,0,139000,161000,-22000,-22000
03701P,祥碩元大93售01  ,0,0,0,0,0,0,0,0,0,-22000,0,0,0,0,22000,-22000,-22000
00753L,中信中國50正2   ,0,0,0,0,0,0,0,0,0,-22000,0,0,0,124000,146000,-22000,-22000
048850,聯電群益96購01  ,0,0,0,0,0,0,0,0,0,-22000,0,0,0,3000,25000,-22000,-22000
048949,昇陽半永豐94購01,0,0,0,0,0,0,0,0,0,-22000,0,0,0,30000,52000,-22000,-22000
048197,義隆元大93購04  ,0,0,0,0,0,0,0,0,0,-22000,0,0,0,0,22000,-22000,-22000
049397,台達電群益94購03,0,0,0,0,0,0,0,0,0,-22000,0,0,0,0,22000,-22000,-22000
049089,正文凱基94購02  ,0,0,0,0,0,0,0,0,0,-22000,0,0,0,0,22000,-22000,-22000
049167,元油2X凱基97購03,0,0,0,0,0,0,0,0,0,-22000,0,0,0,0,22000,-22000,-22000
046357,聯發科台新92購01,0,0,0,0,0,0,0,0,0,-22000,0,0,0,0,22000,-22000,-22000
046360,儒鴻永豐92購01  ,0,0,0,0,0,0,0,0,0,-22000,0,0,0,0,22000,-22000,-22000
046541,超眾群益93購01  ,0,0,0,0,0,0,0,0,0,-22000,0,0,0,0,22000,-22000,-22000
046055,欣興群益92購02  ,0,0,0,0,0,0,0,0,0,-22000,0,0,0,0,22000,-22000,-22000
047364,欣興群益93購04  ,0,0,0,0,0,0,0,0,0,-22000,0,0,0,0,22000,-22000,-22000
046973,矽力群益93購01  ,0,0,0,0,0,0,0,0,0,-22000,0,0,0,10000,32000,-22000,-22000
046158,聯發科群益92購02,0,0,0,0,0,0,0,0,0,-22000,0,0,0,44000,66000,-22000,-22000
04615P,華新科群益94售03,0,0,0,0,0,0,0,0,0,-22000,0,0,0,0,22000,-22000,-22000
051528,亞泥國票96購01  ,0,0,0,0,0,0,0,0,0,-22000,0,0,0,25000,47000,-22000,-22000
051534,景碩國票97購01  ,0,0,0,0,0,0,0,0,0,-22000,0,0,0,0,22000,-22000,-22000
050974,大成鋼統一95購01,0,0,0,0,0,0,0,0,0,-22000,0,0,0,0,22000,-22000,-22000
051879,健策台新96購01  ,0,0,0,0,0,0,0,0,0,-22000,0,0,0,71000,93000,-22000,-22000
051852,啟碁群益95購01  ,0,0,0,0,0,0,0,0,0,-22000,0,0,0,0,22000,-22000,-22000
05066P,康控元大95售03  ,0,0,0,0,0,0,0,0,0,-22000,0,0,0,7000,29000,-22000,-22000
050254,大立光富邦96購02,0,0,0,0,0,0,0,0,0,-22000,0,0,0,10000,32000,-22000,-22000
049737,美食群益94購03  ,0,0,0,0,0,0,0,0,0,-22000,0,0,0,0,22000,-22000,-22000
049621,美食群益94購02  ,0,0,0,0,0,0,0,0,0,-22000,0,0,0,0,22000,-22000,-22000
04999P,南電永豐95售01  ,0,0,0,0,0,0,0,0,0,-22000,0,0,0,24000,46000,-22000,-22000
5288,豐祥-KY         ,3000,25000,-22000,0,0,0,0,0,0,0,0,0,0,0,0,0,-22000
2431,聯昌            ,4000,26000,-22000,0,0,0,0,0,0,0,0,0,0,0,0,0,-22000
052407,樺漢凱基95購01  ,0,0,0,0,0,0,0,0,0,-23000,0,0,0,1000,24000,-23000,-23000
053178,南亞科統一98購01,0,0,0,0,0,0,0,0,0,-23000,0,0,0,85000,108000,-23000,-23000
053427,鎧勝永豐96購02  ,0,0,0,0,0,0,0,0,0,-23000,0,0,0,0,23000,-23000,-23000
053480,祥碩元大96購02  ,0,0,0,0,0,0,0,0,0,-23000,0,0,0,51000,74000,-23000,-23000
054235,欣興群益96購06  ,0,0,0,0,0,0,0,0,0,-23000,0,0,0,10000,33000,-23000,-23000
054568,訊芯群益97購01  ,0,0,0,0,0,0,0,0,0,-23000,0,0,0,71000,94000,-23000,-23000
054153,宏達電國泰97購01,0,0,0,0,0,0,0,0,0,-23000,0,0,0,62000,85000,-23000,-23000
00731,FH富時高息低波  ,0,0,0,0,0,0,0,0,0,-23000,0,0,0,138000,161000,-23000,-23000
00830,國泰費城半導體  ,0,0,0,0,0,0,0,0,0,-23000,0,0,0,105000,128000,-23000,-23000
042387,台積電永昌93購02,0,0,0,0,0,0,0,0,0,-23000,0,0,0,7000,30000,-23000,-23000
043991,TPK元大92購01   ,0,0,0,0,0,0,0,0,0,-23000,0,0,0,0,23000,-23000,-23000
046259,和大凱基92購02  ,0,0,0,0,0,0,0,0,0,-23000,0,0,0,56000,79000,-23000,-23000
045613,祥碩群益92購01  ,0,0,0,0,0,0,0,0,0,-23000,0,0,0,7000,30000,-23000,-23000
046787,和鑫永豐93購01  ,0,0,0,0,0,0,0,0,0,-23000,0,0,0,61000,84000,-23000,-23000
049017,旺宏群益96購03  ,0,0,0,0,0,0,0,0,0,-23000,0,0,0,0,23000,-23000,-23000
047306,儒鴻元大93購03  ,0,0,0,0,0,0,0,0,0,-23000,0,0,0,102000,125000,-23000,-23000
04867P,美律統一94售03  ,0,0,0,0,0,0,0,0,0,-23000,0,0,0,75000,98000,-23000,-23000
050058,國巨凱基94購06  ,0,0,0,0,0,0,0,0,0,-23000,0,0,0,14000,37000,-23000,-23000
050226,華新科中信94購01,0,0,0,0,0,0,0,0,0,-23000,0,0,0,60000,83000,-23000,-23000
050503,聯發科凱基94購22,0,0,0,0,0,0,0,0,0,-23000,0,0,0,47000,70000,-23000,-23000
05079P,可成永豐95售01  ,0,0,0,0,0,0,0,0,0,-23000,0,0,0,35000,58000,-23000,-23000
051673,玉晶光元大96購04,0,0,0,0,0,0,0,0,0,-23000,0,0,0,180000,203000,-23000,-23000
052032,臺股指群益95購05,0,0,0,0,0,0,0,0,0,-23000,0,0,0,0,23000,-23000,-23000
3703,欣陸            ,111000,136000,-25000,0,0,0,0,0,0,2000,2000,0,2000,0,0,0,-23000
06001P,樺漢台新96售01  ,0,0,0,0,0,0,0,0,0,-23000,0,0,0,50000,73000,-23000,-23000
6202,盛群            ,60000,83640,-23640,0,0,0,0,0,0,0,0,0,0,0,0,0,-23640
053951,T50反1台新06購02,0,0,0,0,0,0,0,0,0,-24000,0,0,0,0,24000,-24000,-24000
054304,台積電凱基96購23,0,0,0,0,0,0,0,0,0,-24000,0,0,0,10000,34000,-24000,-24000
054356,可成兆豐97購01  ,0,0,0,0,0,0,0,0,0,-24000,0,0,0,30000,54000,-24000,-24000
053477,大立光元大97購03,0,0,0,0,0,0,0,0,0,-24000,0,0,0,3000,27000,-24000,-24000
053295,奇力新中信96購01,0,0,0,0,0,0,0,0,0,-24000,0,0,0,50000,74000,-24000,-24000
05314P,臺股指群益95售13,0,0,0,0,0,0,0,0,0,-24000,0,0,0,17000,41000,-24000,-24000
052242,台達電台新96購01,0,0,0,0,0,0,0,0,0,-24000,0,0,0,0,24000,-24000,-24000
045000,鴻海富邦93購01  ,0,0,0,0,0,0,0,0,0,-24000,0,0,0,229000,253000,-24000,-24000
04158P,南電永豐93售04  ,0,0,0,0,0,0,0,0,0,-24000,0,0,0,83000,107000,-24000,-24000
044424,儒鴻國泰92購01  ,0,0,0,0,0,0,0,0,0,-24000,0,0,0,220000,244000,-24000,-24000
047338,臺股指元大93購33,0,0,0,0,0,0,0,0,0,-24000,0,0,0,0,24000,-24000,-24000
047332,訊芯元大93購04  ,0,0,0,0,0,0,0,0,0,-24000,0,0,0,13000,37000,-24000,-24000
04990P,臻鼎元大94售04  ,0,0,0,0,0,0,0,0,0,-24000,0,0,0,26000,50000,-24000,-24000
046107,勤誠永豐92購01  ,0,0,0,0,0,0,0,0,0,-24000,0,0,0,123000,147000,-24000,-24000
04855P,上証2X元富94售02,0,0,0,0,0,0,0,0,0,-24000,0,0,0,1000,25000,-24000,-24000
046396,矽創國泰93購01  ,0,0,0,0,0,0,0,0,0,-24000,0,0,0,0,24000,-24000,-24000
047871,健策永豐93購02  ,0,0,0,0,0,0,0,0,0,-24000,0,0,0,10000,34000,-24000,-24000
051634,大立光國票96購03,0,0,0,0,0,0,0,0,0,-24000,0,0,0,5000,29000,-24000,-24000
051353,聯發科元大95購08,0,0,0,0,0,0,0,0,0,-24000,0,0,0,1000,25000,-24000,-24000
049669,訊芯國泰95購01  ,0,0,0,0,0,0,0,0,0,-24000,0,0,0,36000,60000,-24000,-24000
8499,鼎炫-KY         ,6000,32000,-26000,0,0,0,0,0,0,2000,2000,0,2000,0,0,0,-24000
1452,宏益            ,1000,25000,-24000,0,0,0,0,0,0,0,0,0,0,0,0,0,-24000
05686P,臺股指元大96售11,0,0,0,0,0,0,0,0,0,-24000,0,0,0,0,24000,-24000,-24000
05687P,臺股指元大96售12,0,0,0,0,0,0,0,0,0,-24000,0,0,0,8000,32000,-24000,-24000
2471,資通            ,1000,25000,-24000,0,0,0,0,0,0,0,0,0,0,0,0,0,-24000
1711,永光            ,4000,28000,-24000,0,0,0,0,0,0,0,0,0,0,0,0,0,-24000
052296,TPK國票96購01   ,0,0,0,0,0,0,0,0,0,-25000,0,0,0,400000,425000,-25000,-25000
05250P,臻鼎國票96售01  ,0,0,0,0,0,0,0,0,0,-25000,0,0,0,0,25000,-25000,-25000
052647,晶技永豐97購01  ,0,0,0,0,0,0,0,0,0,-25000,0,0,0,0,25000,-25000,-25000
052719,致新凱基96購01  ,0,0,0,0,0,0,0,0,0,-25000,0,0,0,12000,37000,-25000,-25000
053058,台光電永昌99購01,0,0,0,0,0,0,0,0,0,-25000,0,0,0,10000,35000,-25000,-25000
053520,康友群益96購01  ,0,0,0,0,0,0,0,0,0,-25000,0,0,0,15000,40000,-25000,-25000
053521,緯穎群益96購02  ,0,0,0,0,0,0,0,0,0,-25000,0,0,0,97000,122000,-25000,-25000
054591,GIS國泰98購01   ,0,0,0,0,0,0,0,0,0,-25000,0,0,0,9000,34000,-25000,-25000
054733,鴻海凱基98購04  ,0,0,0,0,0,0,0,0,0,-25000,0,0,0,0,25000,-25000,-25000
054031,中鋼中信98購01  ,0,0,0,0,0,0,0,0,0,-25000,0,0,0,0,25000,-25000,-25000
054016,嘉晶永豐96購04  ,0,0,0,0,0,0,0,0,0,-25000,0,0,0,0,25000,-25000,-25000
054136,亞光元大96購04  ,0,0,0,0,0,0,0,0,0,-25000,0,0,0,60000,85000,-25000,-25000
054066,緯穎國票97購03  ,0,0,0,0,0,0,0,0,0,-25000,0,0,0,0,25000,-25000,-25000
054067,百和國票97購03  ,0,0,0,0,0,0,0,0,0,-25000,0,0,0,1000,26000,-25000,-25000
053671,可成統一96購03  ,0,0,0,0,0,0,0,0,0,-25000,0,0,0,312000,337000,-25000,-25000
053719,可成凱基96購08  ,0,0,0,0,0,0,0,0,0,-25000,0,0,0,66000,91000,-25000,-25000
043289,欣興元大92購01  ,0,0,0,0,0,0,0,0,0,-25000,0,0,0,5000,30000,-25000,-25000
044487,元油2X元大94購01,0,0,0,0,0,0,0,0,0,-25000,0,0,0,0,25000,-25000,-25000
042023,大立光富邦92購04,0,0,0,0,0,0,0,0,0,-25000,0,0,0,0,25000,-25000,-25000
03678P,欣興元大92售09  ,0,0,0,0,0,0,0,0,0,-25000,0,0,0,28000,53000,-25000,-25000
03369P,景碩中信02售01  ,0,0,0,0,0,0,0,0,0,-25000,0,0,0,0,25000,-25000,-25000
03307P,臺股指中信05售02,0,0,0,0,0,0,0,0,0,-25000,0,0,0,0,25000,-25000,-25000
045390,新唐元大92購01  ,0,0,0,0,0,0,0,0,0,-25000,0,0,0,5000,30000,-25000,-25000
04843P,致新元大94售02  ,0,0,0,0,0,0,0,0,0,-25000,0,0,0,50000,75000,-25000,-25000
048425,聯茂元富96購02  ,0,0,0,0,0,0,0,0,0,-25000,0,0,0,0,25000,-25000,-25000
047934,GIS凱基94購01   ,0,0,0,0,0,0,0,0,0,-25000,0,0,0,0,25000,-25000,-25000
047954,漢唐永豐93購02  ,0,0,0,0,0,0,0,0,0,-25000,0,0,0,59000,84000,-25000,-25000
046612,群創麥證93購01  ,0,0,0,20000,45000,-25000,0,0,0,-25000,0,0,0,20000,45000,-25000,-25000
045850,嘉澤永豐92購01  ,0,0,0,0,0,0,0,0,0,-25000,0,0,0,26000,51000,-25000,-25000
048062,南亞科統一93購05,0,0,0,0,0,0,0,0,0,-25000,0,0,0,28000,53000,-25000,-25000
047130,台達電凱基93購03,0,0,0,0,0,0,0,0,0,-25000,0,0,0,0,25000,-25000,-25000
048116,矽創群益93購02  ,0,0,0,0,0,0,0,0,0,-25000,0,0,0,0,25000,-25000,-25000
047205,GIS元富93購03   ,0,0,0,0,0,0,0,0,0,-25000,0,0,0,5000,30000,-25000,-25000
047446,TPK元大94購01   ,0,0,0,0,0,0,0,0,0,-25000,0,0,0,0,25000,-25000,-25000
049704,羅麗芬元大95購01,0,0,0,0,0,0,0,0,0,-25000,0,0,0,0,25000,-25000,-25000
05006P,華通元富95售01  ,0,0,0,0,0,0,0,0,0,-25000,0,0,0,503000,528000,-25000,-25000
050688,大立光日盛94購03,0,0,0,0,0,0,0,0,0,-25000,0,0,0,0,25000,-25000,-25000
050481,泰鼎國票96購01  ,0,0,0,0,0,0,0,0,0,-25000,0,0,0,0,25000,-25000,-25000
05139P,臺股指凱基95售06,0,0,0,0,0,0,0,0,0,-25000,0,0,0,0,25000,-25000,-25000
050937,可成國票96購02  ,0,0,0,0,0,0,0,0,0,-25000,0,0,0,19000,44000,-25000,-25000
050911,光磊中信98購01  ,0,0,0,0,0,0,0,0,0,-25000,0,0,0,20000,45000,-25000,-25000
051646,華通永豐96購01  ,0,0,0,0,0,0,0,0,0,-25000,0,0,0,0,25000,-25000,-25000
05195P,南茂康和95售01  ,0,0,0,0,0,0,0,0,0,-25000,0,0,0,0,25000,-25000,-25000
052096,力成元大95購01  ,0,0,0,0,0,0,0,0,0,-25000,0,0,0,0,25000,-25000,-25000
052076,可成元富98購01  ,0,0,0,0,0,0,0,0,0,-25000,0,0,0,2000,27000,-25000,-25000
052136,瑞儀凱基95購01  ,0,0,0,0,0,0,0,0,0,-25000,0,0,0,0,25000,-25000,-25000
05697P,友達凱基96售01  ,0,0,0,0,0,0,0,0,0,-25000,0,0,0,14000,39000,-25000,-25000
05995P,T50正2中信9C售01,0,0,0,0,0,0,0,0,0,-25000,0,0,0,9000,34000,-25000,-25000
053666,臺股指凱基96購29,0,0,0,0,0,0,0,0,0,-26000,0,0,0,0,26000,-26000,-26000
054624,台積電凱基98購03,0,0,0,0,0,0,0,0,0,-26000,0,0,0,6000,32000,-26000,-26000
054425,聯發科富邦99購03,0,0,0,0,0,0,0,0,0,-26000,0,0,0,2000,28000,-26000,-26000
053087,冠德元大96購02  ,0,0,0,0,0,0,0,0,0,-26000,0,0,0,10000,36000,-26000,-26000
052961,國巨凱基97購02  ,0,0,0,0,0,0,0,0,0,-26000,0,0,0,191000,217000,-26000,-26000
052383,臺股指元大95購29,0,0,0,0,0,0,0,0,0,-26000,0,0,0,0,26000,-26000,-26000
045205,鈺齊凱基92購01  ,0,0,0,0,0,0,0,0,0,-26000,0,0,0,22000,48000,-26000,-26000
045832,建準群益92購01  ,0,0,0,0,0,0,0,0,0,-26000,0,0,0,49000,75000,-26000,-26000
044964,旺宏中信94購01  ,0,0,0,0,0,0,0,0,0,-26000,0,0,0,1092000,1118000,-26000,-26000
03925P,大立光群益93售08,0,0,0,0,0,0,0,0,0,-26000,0,0,0,21000,47000,-26000,-26000
047483,新光金凱基99購04,0,0,0,0,0,0,0,0,0,-26000,0,0,0,573000,599000,-26000,-26000
049229,台化富邦94購01  ,0,0,0,0,0,0,0,0,0,-26000,0,0,0,5000,31000,-26000,-26000
048056,全新國泰94購02  ,0,0,0,0,0,0,0,0,0,-26000,0,0,0,88000,114000,-26000,-26000
047048,華邦電國票93購02,0,0,0,0,0,0,0,0,0,-26000,0,0,0,12000,38000,-26000,-26000
047419,聯發科富邦95購01,0,0,0,0,0,0,0,0,0,-26000,0,0,0,1000,27000,-26000,-26000
046782,建準永豐93購01  ,0,0,0,0,0,0,0,0,0,-26000,0,0,0,40000,66000,-26000,-26000
048443,旺宏凱基93購08  ,0,0,0,0,0,0,0,0,0,-26000,0,0,0,0,26000,-26000,-26000
050402,緯穎中信96購01  ,0,0,0,0,0,0,0,0,0,-26000,0,0,0,132000,158000,-26000,-26000
050203,美律群益94購04  ,0,0,0,0,0,0,0,0,0,-26000,0,0,0,50000,76000,-26000,-26000
050710,元黃金中信96購01,0,0,0,0,0,0,0,0,0,-26000,0,0,0,6000,32000,-26000,-26000
050813,旺宏凱基96購01  ,0,0,0,0,0,0,0,0,0,-26000,0,0,0,29000,55000,-26000,-26000
050132,日電貿凱基94購02,0,0,0,0,0,0,0,0,0,-26000,0,0,0,57000,83000,-26000,-26000
06101P,聯發科日盛97售03,0,0,0,0,0,0,0,0,0,-26000,0,0,0,0,26000,-26000,-26000
05872P,大立光凱基96售15,0,0,0,0,0,0,0,0,0,-26000,0,0,0,0,26000,-26000,-26000
6541,泰福-KY         ,36000,63000,-27000,0,0,0,0,0,0,1000,1000,0,1000,0,0,0,-26000
053248,智伸科國票97購01,0,0,0,0,0,0,0,0,0,-27000,0,0,0,5000,32000,-27000,-27000
053279,景碩元大97購01  ,0,0,0,0,0,0,0,0,0,-27000,0,0,0,291000,318000,-27000,-27000
053923,亞光國票97購01  ,0,0,0,0,0,0,0,0,0,-27000,0,0,0,110000,137000,-27000,-27000
03860P,群創元富97售01  ,0,0,0,0,0,0,0,0,0,-27000,0,0,0,0,27000,-27000,-27000
0052,富邦科技        ,5000,0,5000,0,0,0,0,0,0,-32000,0,0,0,72000,104000,-32000,-27000
042993,葡萄王元大94購01,0,0,0,0,0,0,0,0,0,-27000,0,0,0,109000,136000,-27000,-27000
044034,美律群益92購04  ,0,0,0,0,0,0,0,0,0,-27000,0,0,0,184000,211000,-27000,-27000
044104,鴻海中信95購03  ,0,0,0,0,0,0,0,0,0,-27000,0,0,0,40000,67000,-27000,-27000
047778,美利達元大93購01,0,0,0,0,0,0,0,0,0,-27000,0,0,0,3000,30000,-27000,-27000
047845,美利達元大93購02,0,0,0,0,0,0,0,0,0,-27000,0,0,0,3000,30000,-27000,-27000
04848P,康控凱基94售02  ,0,0,0,0,0,0,0,0,0,-27000,0,0,0,16000,43000,-27000,-27000
047922,聯發科凱基94購01,0,0,0,0,0,0,0,0,0,-27000,0,0,0,83000,110000,-27000,-27000
045949,貿聯日盛92購01  ,0,0,0,0,0,0,0,0,0,-27000,0,0,0,33000,60000,-27000,-27000
045970,日月光凱基92購02,0,0,0,0,0,0,0,0,0,-27000,0,0,0,3000,30000,-27000,-27000
047418,智邦富邦97購01  ,0,0,0,0,0,0,0,0,0,-27000,0,0,0,30000,57000,-27000,-27000
046197,日月光凱基92購04,0,0,0,0,0,0,0,0,0,-27000,0,0,0,3000,30000,-27000,-27000
046934,智邦元富96購01  ,0,0,0,0,0,0,0,0,0,-27000,0,0,0,0,27000,-27000,-27000
049117,矽格統一96購01  ,0,0,0,0,0,0,0,0,0,-27000,0,0,0,7000,34000,-27000,-27000
048093,聯發科凱基93購30,0,0,0,0,0,0,0,0,0,-27000,0,0,0,27000,54000,-27000,-27000
050165,泰鼎國泰95購02  ,0,0,0,0,0,0,0,0,0,-27000,0,0,0,0,27000,-27000,-27000
049773,臺股指元富94購02,0,0,0,0,0,0,0,0,0,-27000,0,0,0,0,27000,-27000,-27000
050308,矽創中信97購01  ,0,0,0,0,0,0,0,0,0,-27000,0,0,0,0,27000,-27000,-27000
050971,緯穎永豐95購01  ,0,0,0,0,0,0,0,0,0,-27000,0,0,0,162000,189000,-27000,-27000
050966,日月光永豐95購01,0,0,0,0,0,0,0,0,0,-27000,0,0,0,0,27000,-27000,-27000
051164,鴻海元大95購05  ,0,0,0,0,0,0,0,0,0,-27000,0,0,0,733000,760000,-27000,-27000
05748P,臺股指群益99售02,0,0,0,0,0,0,0,0,0,-27000,0,0,0,45000,72000,-27000,-27000
2423,固緯            ,29000,56000,-27000,0,0,0,0,0,0,0,0,0,0,0,0,0,-27000
053896,麗豐群益97購01  ,0,0,0,0,0,0,0,0,0,-28000,0,0,0,1000,29000,-28000,-28000
053842,聯發科統一96購08,0,0,0,0,0,0,0,0,0,-28000,0,0,0,0,28000,-28000,-28000
054332,世芯永豐97購01  ,0,0,0,0,0,0,0,0,0,-28000,0,0,0,5000,33000,-28000,-28000
05484P,台積電凱基95售18,0,0,0,0,0,0,0,0,0,-28000,0,0,0,0,28000,-28000,-28000
053557,聯茂凱基96購04  ,0,0,0,0,0,0,0,0,0,-28000,0,0,0,40000,68000,-28000,-28000
053500,新日興兆豐97購01,0,0,0,0,0,0,0,0,0,-28000,0,0,0,0,28000,-28000,-28000
053093,緯穎元大96購06  ,0,0,0,0,0,0,0,0,0,-28000,0,0,0,268000,296000,-28000,-28000
042037,台灣50群益93購03,0,0,0,0,0,0,0,0,0,-28000,0,0,0,19000,47000,-28000,-28000
043611,台積電群益92購03,0,0,0,0,0,0,0,0,0,-28000,0,0,0,74000,102000,-28000,-28000
047095,聯詠麥證93購01  ,0,0,0,100000,78000,22000,0,0,0,-28000,0,0,0,100000,128000,-28000,-28000
048797,美律國泰95購02  ,0,0,0,0,0,0,0,0,0,-28000,0,0,0,3000,31000,-28000,-28000
049055,聯詠永豐94購01  ,0,0,0,0,0,0,0,0,0,-28000,0,0,0,132000,160000,-28000,-28000
047689,瑞昱富邦97購01  ,0,0,0,0,0,0,0,0,0,-28000,0,0,0,7000,35000,-28000,-28000
047303,寶滬深元大96購01,0,0,0,0,0,0,0,0,0,-28000,0,0,0,0,28000,-28000,-28000
046964,祥碩中信93購01  ,0,0,0,0,0,0,0,0,0,-28000,0,0,0,2000,30000,-28000,-28000
048441,台積電凱基93購29,0,0,0,0,0,0,0,0,0,-28000,0,0,0,2000,30000,-28000,-28000
051573,鴻海元大95購15  ,0,0,0,0,0,0,0,0,0,-28000,0,0,0,39000,67000,-28000,-28000
050474,鴻海永豐94購05  ,0,0,0,0,0,0,0,0,0,-28000,0,0,0,56000,84000,-28000,-28000
050673,旺宏富邦96購02  ,0,0,0,0,0,0,0,0,0,-28000,0,0,0,127000,155000,-28000,-28000
049414,台積電凱基94購18,0,0,0,0,0,0,0,0,0,-28000,0,0,0,3000,31000,-28000,-28000
050090,鈺齊康和94購01  ,0,0,0,0,0,0,0,0,0,-28000,0,0,0,0,28000,-28000,-28000
4994,傳奇            ,25000,48000,-23000,0,0,0,0,0,0,-5000,0,0,0,5000,10000,-5000,-28000
05764P,世紀鋼永豐96售03,0,0,0,0,0,0,0,0,0,-28000,0,0,0,82000,110000,-28000,-28000
05914P,友達元大96售04  ,0,0,0,0,0,0,0,0,0,-28000,0,0,0,100000,128000,-28000,-28000
2206,三陽工業        ,45000,73068,-28068,0,0,0,0,0,0,0,0,0,0,0,0,0,-28068
053466,華通元大98購01  ,0,0,0,0,0,0,0,0,0,-29000,0,0,0,7000,36000,-29000,-29000
052387,台積電群益95購08,0,0,0,0,0,0,0,0,0,-29000,0,0,0,2000,31000,-29000,-29000
054629,華新科凱基98購01,0,0,0,0,0,0,0,0,0,-29000,0,0,0,0,29000,-29000,-29000
054564,玉晶光群益99購01,0,0,0,0,0,0,0,0,0,-29000,0,0,0,6000,35000,-29000,-29000
053601,台表科元大98購01,1000,0,1000,0,0,0,0,0,0,-30000,0,0,0,530000,560000,-30000,-29000
054057,晶豪科國票97購01,0,0,0,0,0,0,0,0,0,-29000,0,0,0,0,29000,-29000,-29000
04203P,超眾元大93售04  ,0,0,0,0,0,0,0,0,0,-29000,0,0,0,135000,164000,-29000,-29000
044752,台積電凱基91購23,0,0,0,0,0,0,0,0,0,-29000,0,0,0,11000,40000,-29000,-29000
04844P,京元電亞東94售01,0,0,0,0,0,0,0,0,0,-29000,0,0,0,1000,30000,-29000,-29000
048450,聯詠凱基93購09  ,0,0,0,0,0,0,0,0,0,-29000,0,0,0,39000,68000,-29000,-29000
048467,南電康和93購01  ,0,0,0,0,0,0,0,0,0,-29000,0,0,0,1000,30000,-29000,-29000
048409,致伸群益93購05  ,0,0,0,0,0,0,0,0,0,-29000,0,0,0,20000,49000,-29000,-29000
046645,技嘉國泰94購01  ,0,0,0,0,0,0,0,0,0,-29000,0,0,0,0,29000,-29000,-29000
046943,聯發科元大93購06,0,0,0,0,0,0,0,0,0,-29000,0,0,0,24000,53000,-29000,-29000
047032,台虹元大93購01  ,0,0,0,0,0,0,0,0,0,-29000,0,0,0,1000,30000,-29000,-29000
048088,台積電凱基93購23,0,0,0,0,0,0,0,0,0,-29000,0,0,0,25000,54000,-29000,-29000
049928,祥碩元大94購02  ,0,0,0,0,0,0,0,0,0,-29000,0,0,0,1000,30000,-29000,-29000
048881,美律統一94購02  ,0,0,0,0,0,0,0,0,0,-29000,0,0,0,20000,49000,-29000,-29000
050558,台積電統一94購14,0,0,0,0,0,0,0,0,0,-29000,0,0,0,3000,32000,-29000,-29000
052195,健策元富95購01  ,0,0,0,0,0,0,0,0,0,-29000,0,0,0,11000,40000,-29000,-29000
051020,健策凱基96購02  ,0,0,0,0,0,0,0,0,0,-29000,0,0,0,113000,142000,-29000,-29000
4566,時碩工業        ,5000,34000,-29000,0,0,0,0,0,0,0,0,0,0,0,0,0,-29000
3060,銘異            ,17000,46000,-29000,0,0,0,0,0,0,0,0,0,0,0,0,0,-29000
05867P,友達兆豐97售02  ,0,0,0,0,0,0,0,0,0,-29000,0,0,0,320000,349000,-29000,-29000
054121,奇鋐永豐96購02  ,0,0,0,0,0,0,0,0,0,-30000,0,0,0,65000,95000,-30000,-30000
053736,友達麥證96購01  ,0,0,0,0,30000,-30000,0,0,0,-30000,0,0,0,0,30000,-30000,-30000
053826,光磊麥證97購01  ,0,0,0,0,30000,-30000,0,0,0,-30000,0,0,0,0,30000,-30000,-30000
054245,鴻海元大96購23  ,0,0,0,0,0,0,0,0,0,-30000,0,0,0,470000,500000,-30000,-30000
054448,矽力兆豐96購01  ,0,0,0,0,0,0,0,0,0,-30000,0,0,0,15000,45000,-30000,-30000
052338,道瓊反凱基97購02,0,0,0,0,0,0,0,0,0,-30000,0,0,0,0,30000,-30000,-30000
052521,友達元大9B購01  ,0,0,0,0,0,0,0,0,0,-30000,0,0,0,3000,33000,-30000,-30000
052419,上証2X國票96購02,0,0,0,0,0,0,0,0,0,-30000,0,0,0,20000,50000,-30000,-30000
052423,宏達電國票96購02,0,0,0,0,0,0,0,0,0,-30000,0,0,0,0,30000,-30000,-30000
052713,智邦凱基96購01  ,0,0,0,0,0,0,0,0,0,-30000,0,0,0,0,30000,-30000,-30000
052742,可成元大96購01  ,0,0,0,0,0,0,0,0,0,-30000,0,0,0,354000,384000,-30000,-30000
052918,智易富邦97購02  ,0,0,0,0,0,0,0,0,0,-30000,0,0,0,0,30000,-30000,-30000
052851,滬深2X元富96購02,0,0,0,0,0,0,0,0,0,-30000,0,0,0,0,30000,-30000,-30000
053501,明泰兆豐96購01  ,0,0,0,0,0,0,0,0,0,-30000,0,0,0,0,30000,-30000,-30000
053579,華通元大97購01  ,0,0,0,0,0,0,0,0,0,-30000,0,0,0,70000,100000,-30000,-30000
053504,祥碩兆豐96購01  ,0,0,0,0,0,0,0,0,0,-30000,0,0,0,0,30000,-30000,-30000
053524,聯電中信97購02  ,0,0,0,0,0,0,0,0,0,-30000,0,0,0,0,30000,-30000,-30000
053283,同欣電元大96購03,0,0,0,0,0,0,0,0,0,-30000,0,0,0,20000,50000,-30000,-30000
053383,京元電元大97購01,0,0,0,0,0,0,0,0,0,-30000,0,0,0,101000,131000,-30000,-30000
053134,南亞科國票97購01,0,0,0,0,0,0,0,0,0,-30000,0,0,0,10000,40000,-30000,-30000
052952,矽創國票97購02  ,0,0,0,0,0,0,0,0,0,-30000,0,0,0,0,30000,-30000,-30000
053005,微星永豐96購01  ,0,0,0,0,0,0,0,0,0,-30000,0,0,0,5000,35000,-30000,-30000
053053,京元電國票97購02,0,0,0,0,0,0,0,0,0,-30000,0,0,0,30000,60000,-30000,-30000
044787,上銀群益93購01  ,0,0,0,0,0,0,0,0,0,-30000,0,0,0,0,30000,-30000,-30000
044052,鴻海元大92購04  ,0,0,0,0,0,0,0,0,0,-30000,0,0,0,20000,50000,-30000,-30000
045218,華邦電元大92購03,0,0,0,0,0,0,0,0,0,-30000,0,0,0,20000,50000,-30000,-30000
045287,元油2X元大95購01,0,0,0,0,0,0,0,0,0,-30000,0,0,0,98000,128000,-30000,-30000
045309,訊芯元大92購01  ,0,0,0,0,0,0,0,0,0,-30000,0,0,0,0,30000,-30000,-30000
045427,上海銀凱基92購01,0,0,0,0,0,0,0,0,0,-30000,0,0,0,0,30000,-30000,-30000
047781,上銀國泰94購02  ,0,0,0,0,0,0,0,0,0,-30000,0,0,0,21000,51000,-30000,-30000
047763,旺宏元大94購04  ,0,0,0,0,0,0,0,0,0,-30000,0,0,0,207000,237000,-30000,-30000
047772,泰鼎元大93購05  ,0,0,0,0,0,0,0,0,0,-30000,0,0,0,10000,40000,-30000,-30000
046234,彩晶元大92購01  ,0,0,0,0,0,0,0,0,0,-30000,0,0,0,0,30000,-30000,-30000
048229,華晶科凱基93購02,0,0,0,0,0,0,0,0,0,-30000,0,0,0,0,30000,-30000,-30000
04633P,旺宏群益96售04  ,0,0,0,0,0,0,0,0,0,-30000,0,0,0,0,30000,-30000,-30000
044252,友達麥證91購01  ,0,0,0,0,30000,-30000,0,0,0,-30000,0,0,0,0,30000,-30000,-30000
045717,微星凱基92購03  ,0,0,0,0,0,0,0,0,0,-30000,0,0,0,20000,50000,-30000,-30000
043758,創意元大92購03  ,0,0,0,0,0,0,0,0,0,-30000,0,0,0,0,30000,-30000,-30000
041976,可成中信92購01  ,0,0,0,0,0,0,0,0,0,-30000,0,0,0,0,30000,-30000,-30000
04235P,鴻海群益93售08  ,0,0,0,0,0,0,0,0,0,-30000,0,0,0,0,30000,-30000,-30000
043051,天鈺國泰93購01  ,0,0,0,0,0,0,0,0,0,-30000,0,0,0,20000,50000,-30000,-30000
04334P,中石化康和93售01,0,0,0,0,0,0,0,0,0,-30000,0,0,0,0,30000,-30000,-30000
044411,A50正2統一93購01,0,0,0,0,0,0,0,0,0,-30000,0,0,0,20000,50000,-30000,-30000
043629,美律凱基91購05  ,0,0,0,0,0,0,0,0,0,-30000,0,0,0,0,30000,-30000,-30000
044534,南亞科麥證92購01,0,0,0,0,30000,-30000,0,0,0,-30000,0,0,0,0,30000,-30000,-30000
044600,上銀國泰93購01  ,0,0,0,0,0,0,0,0,0,-30000,0,0,0,0,30000,-30000,-30000
03522P,牧德元大02售05  ,0,0,0,0,0,0,0,0,0,-30000,0,0,0,0,30000,-30000,-30000
040160,SP黃豆元富95購01,0,0,0,0,0,0,0,0,0,-30000,0,0,0,0,30000,-30000,-30000
047093,寶成元富93購01  ,0,0,0,0,0,0,0,0,0,-30000,0,0,0,0,30000,-30000,-30000
047086,群創統一93購03  ,0,0,0,0,0,0,0,0,0,-30000,0,0,0,20000,50000,-30000,-30000
048827,大立光凱基94購01,0,0,0,0,0,0,0,0,0,-30000,0,0,0,0,30000,-30000,-30000
048727,大成鋼麥證94購01,0,0,0,0,30000,-30000,0,0,0,-30000,0,0,0,0,30000,-30000,-30000
04872P,高股息中信94售01,0,0,0,0,0,0,0,0,0,-30000,0,0,0,0,30000,-30000,-30000
049286,美律兆豐94購01  ,0,0,0,0,0,0,0,0,0,-30000,0,0,0,0,30000,-30000,-30000
047351,聯詠凱基93購02  ,0,0,0,0,0,0,0,0,0,-30000,0,0,0,0,30000,-30000,-30000
047359,台達電群益93購01,0,0,0,0,0,0,0,0,0,-30000,0,0,0,40000,70000,-30000,-30000
047557,麗豐凱基94購02  ,0,0,0,0,0,0,0,0,0,-30000,0,0,0,0,30000,-30000,-30000
049053,可成永豐94購01  ,0,0,0,0,0,0,0,0,0,-30000,0,0,0,0,30000,-30000,-30000
049050,崇越康和94購01  ,0,0,0,0,0,0,0,0,0,-30000,0,0,0,60000,90000,-30000,-30000
047376,南電國票94購01  ,0,0,0,0,0,0,0,0,0,-30000,0,0,0,0,30000,-30000,-30000
047009,大立光統一93購07,0,0,0,0,0,0,0,0,0,-30000,0,0,0,0,30000,-30000,-30000
047029,日月光元大93購01,0,0,0,0,0,0,0,0,0,-30000,0,0,0,30000,60000,-30000,-30000
046950,隆達元大93購01  ,0,0,0,0,0,0,0,0,0,-30000,0,0,0,0,30000,-30000,-30000
048035,聯詠凱基93購06  ,0,0,0,0,0,0,0,0,0,-30000,0,0,0,20000,50000,-30000,-30000
048046,正崴永豐93購01  ,0,0,0,0,0,0,0,0,0,-30000,0,0,0,20000,50000,-30000,-30000
046200,上海銀凱基93購01,0,0,0,0,0,0,0,0,0,-30000,0,0,0,20000,50000,-30000,-30000
045930,康控永豐92購01  ,0,0,0,0,0,0,0,0,0,-30000,0,0,0,95000,125000,-30000,-30000
046870,大立光統一95購01,0,0,0,0,0,0,0,0,0,-30000,0,0,0,0,30000,-30000,-30000
046715,美律國泰94購01  ,0,0,0,0,0,0,0,0,0,-30000,0,0,0,10000,40000,-30000,-30000
047899,貿聯群益93購03  ,0,0,0,0,0,0,0,0,0,-30000,0,0,0,0,30000,-30000,-30000
048603,中磊國票94購02  ,0,0,0,0,0,0,0,0,0,-30000,0,0,0,0,30000,-30000,-30000
048508,元上證凱基94購02,0,0,0,0,0,0,0,0,0,-30000,0,0,0,0,30000,-30000,-30000
050948,華固群益95購01  ,0,0,0,0,0,0,0,0,0,-30000,0,0,0,3000,33000,-30000,-30000
051299,致茂凱基95購01  ,0,0,0,0,0,0,0,0,0,-30000,0,0,0,115000,145000,-30000,-30000
051533,健鼎國票96購02  ,0,0,0,0,0,0,0,0,0,-30000,0,0,0,0,30000,-30000,-30000
051453,智伸科元大95購02,0,0,0,0,0,0,0,0,0,-30000,0,0,0,10000,40000,-30000,-30000
052028,健策群益95購02  ,0,0,0,0,0,0,0,0,0,-30000,0,0,0,10000,40000,-30000,-30000
052010,兆豐金中信95購01,0,0,0,0,0,0,0,0,0,-30000,0,0,0,0,30000,-30000,-30000
051624,智邦麥證95購02  ,0,0,0,0,30000,-30000,0,0,0,-30000,0,0,0,0,30000,-30000,-30000
051660,緯穎國泰96購02  ,0,0,0,0,0,0,0,0,0,-30000,0,0,0,0,30000,-30000,-30000
051789,嘉澤國票96購01  ,0,0,0,0,0,0,0,0,0,-30000,0,0,0,0,30000,-30000,-30000
051735,台積電國票96購06,0,0,0,0,0,0,0,0,0,-30000,0,0,0,0,30000,-30000,-30000
050662,智易元大96購01  ,0,0,0,0,0,0,0,0,0,-30000,0,0,0,16000,46000,-30000,-30000
050789,矽創國泰96購01  ,0,0,0,0,0,0,0,0,0,-30000,0,0,0,0,30000,-30000,-30000
050743,京鼎永豐94購02  ,0,0,0,0,0,0,0,0,0,-30000,0,0,0,403000,433000,-30000,-30000
050391,大立光統一94購07,0,0,0,0,0,0,0,0,0,-30000,0,0,0,26000,56000,-30000,-30000
050303,S&P反1中信96購01,0,0,0,0,0,0,0,0,0,-30000,0,0,0,0,30000,-30000,-30000
050227,大立光中信96購01,0,0,0,0,0,0,0,0,0,-30000,0,0,0,10000,40000,-30000,-30000
050266,兆豐金元大94購01,0,0,0,0,0,0,0,0,0,-30000,0,0,0,70000,100000,-30000,-30000
049726,道瓊反中信96購01,0,0,0,0,0,0,0,0,0,-30000,0,0,0,0,30000,-30000,-30000
05870P,聯發科凱基96售19,0,0,0,0,0,0,0,0,0,-30000,0,0,0,0,30000,-30000,-30000
05873P,華通群益97售02  ,0,0,0,0,0,0,0,0,0,-30000,0,0,0,93000,123000,-30000,-30000
06018P,康控凱基96售03  ,0,0,0,0,0,0,0,0,0,-30000,0,0,0,20000,50000,-30000,-30000
2022,聚亨            ,13000,43000,-30000,0,0,0,0,0,0,0,0,0,0,0,0,0,-30000
2441,超豐            ,91000,121000,-30000,0,0,0,0,0,0,0,0,0,0,0,0,0,-30000
2535,達欣工          ,33000,63000,-30000,0,0,0,0,0,0,0,0,0,0,0,0,0,-30000
052466,聯詠統一95購03  ,0,0,0,0,0,0,0,0,0,-31000,0,0,0,45000,76000,-31000,-31000
052482,茂林群益95購01  ,0,0,0,0,0,0,0,0,0,-31000,0,0,0,28000,59000,-31000,-31000
03047X,元展44          ,0,0,0,0,0,0,0,0,0,-31000,0,0,0,0,31000,-31000,-31000
00771,元大US高息特別股,0,0,0,0,0,0,0,0,0,-31000,0,0,0,11000,42000,-31000,-31000
00631L,元大台灣50正2   ,11000,0,11000,0,0,0,0,0,0,-42000,121000,66000,55000,493000,590000,-97000,-31000
042909,順德元大94購01  ,0,0,0,0,0,0,0,0,0,-31000,0,0,0,101000,132000,-31000,-31000
046215,大立光統一92購03,0,0,0,0,0,0,0,0,0,-31000,0,0,0,0,31000,-31000,-31000
045533,南茂永豐92購01  ,0,0,0,0,0,0,0,0,0,-31000,0,0,0,0,31000,-31000,-31000
046390,旺宏統一94購02  ,0,0,0,0,0,0,0,0,0,-31000,0,0,0,22000,53000,-31000,-31000
047898,嘉澤群益93購02  ,0,0,0,0,0,0,0,0,0,-31000,0,0,0,15000,46000,-31000,-31000
046740,大立光群益95購01,0,0,0,0,0,0,0,0,0,-31000,0,0,0,3000,34000,-31000,-31000
049952,強茂群益94購01  ,0,0,0,0,0,0,0,0,0,-31000,0,0,0,0,31000,-31000,-31000
05005P,台表科統一95售01,0,0,0,0,0,0,0,0,0,-31000,0,0,0,8000,39000,-31000,-31000
049860,亞德客兆豐94購01,0,0,0,0,0,0,0,0,0,-31000,0,0,0,198000,229000,-31000,-31000
050296,亞光凱基94購03  ,0,0,0,0,0,0,0,0,0,-31000,0,0,0,106000,137000,-31000,-31000
051801,牧德永豐95購04  ,0,0,0,0,0,0,0,0,0,-31000,0,0,0,113000,144000,-31000,-31000
051711,臻鼎群益95購03  ,0,0,0,0,0,0,0,0,0,-31000,0,0,0,294000,325000,-31000,-31000
051598,瑞昱兆豐95購01  ,0,0,0,0,0,0,0,0,0,-31000,0,0,0,14000,45000,-31000,-31000
051981,南茂凱基96購01  ,0,0,0,0,0,0,0,0,0,-31000,0,0,0,40000,71000,-31000,-31000
052216,康友元大96購01  ,0,0,0,0,0,0,0,0,0,-31000,0,0,0,110000,141000,-31000,-31000
052065,臺股指國票95購12,0,0,0,0,0,0,0,0,0,-31000,0,0,0,0,31000,-31000,-31000
051402,玉晶光永豐95購04,0,0,0,0,0,0,0,0,0,-31000,0,0,0,47000,78000,-31000,-31000
2457,飛宏            ,59000,91000,-32000,0,0,0,0,0,0,1000,1000,0,1000,0,0,0,-31000
08218P,滬深2X凱基96售01,0,0,0,0,0,0,0,0,0,-31000,0,0,0,20000,51000,-31000,-31000
05808P,臺股指國票96售01,0,0,0,0,0,0,0,0,0,-31000,0,0,0,7000,38000,-31000,-31000
2059,川湖            ,20000,31107,-11107,0,0,0,0,12000,-12000,-8000,0,6000,-6000,0,2000,-2000,-31107
052226,旺宏凱基95購06  ,0,0,0,0,0,0,0,0,0,-32000,0,0,0,10000,42000,-32000,-32000
052706,台虹國票97購01  ,0,0,0,0,0,0,0,0,0,-32000,0,0,0,10000,42000,-32000,-32000
054335,緯穎永豐96購02  ,0,0,0,0,0,0,0,0,0,-32000,0,0,0,76000,108000,-32000,-32000
054315,訊芯凱基98購01  ,0,0,0,0,0,0,0,0,0,-32000,0,0,0,25000,57000,-32000,-32000
053665,臺股指凱基96購26,0,0,0,0,0,0,0,0,0,-32000,0,0,0,10000,42000,-32000,-32000
053955,華通永豐96購04  ,0,0,0,0,0,0,0,0,0,-32000,0,0,0,43000,75000,-32000,-32000
044975,台積電國票92購02,0,0,0,0,0,0,0,0,0,-32000,0,0,0,56000,88000,-32000,-32000
045106,玉晶光群益95購01,0,0,0,0,0,0,0,0,0,-32000,0,0,0,2000,34000,-32000,-32000
045035,潤泰全群益93購01,0,0,0,0,0,0,0,0,0,-32000,0,0,0,0,32000,-32000,-32000
04193P,智原永豐93售01  ,0,0,0,0,0,0,0,0,0,-32000,0,0,0,125000,157000,-32000,-32000
03946P,麗豐群益93售02  ,0,0,0,0,0,0,0,0,0,-32000,0,0,0,24000,56000,-32000,-32000
049933,GIS元大95購01   ,0,0,0,0,0,0,0,0,0,-32000,0,0,0,4000,36000,-32000,-32000
048851,台達電群益94購01,0,0,0,0,0,0,0,0,0,-32000,0,0,0,0,32000,-32000,-32000
046625,勤誠凱基93購01  ,0,0,0,0,0,0,0,0,0,-32000,0,0,0,1000,33000,-32000,-32000
05124P,華新科富邦97售02,0,0,0,0,0,0,0,0,0,-32000,0,0,0,8000,40000,-32000,-32000
051654,致新永豐95購01  ,0,0,0,0,0,0,0,0,0,-32000,0,0,0,0,32000,-32000,-32000
050844,大立光國票96購01,0,0,0,0,0,0,0,0,0,-32000,0,0,0,0,32000,-32000,-32000
050007,貿聯永豐94購01  ,0,0,0,0,0,0,0,0,0,-32000,0,0,0,12000,44000,-32000,-32000
049721,晶技凱基94購02  ,0,0,0,0,0,0,0,0,0,-32000,0,0,0,0,32000,-32000,-32000
3048,益登            ,85000,117000,-32000,0,0,0,0,0,0,0,0,0,0,0,0,0,-32000
05696P,南亞科凱基96售01,0,0,0,0,0,0,0,0,0,-32000,0,0,0,18000,50000,-32000,-32000
053680,臺股指富邦96購01,0,0,0,0,0,0,0,0,0,-33000,0,0,0,130000,163000,-33000,-33000
053865,欣興元大97購02  ,0,0,0,0,0,0,0,0,0,-33000,0,0,0,124000,157000,-33000,-33000
054255,亞光元大96購05  ,0,0,0,0,0,0,0,0,0,-33000,0,0,0,17000,50000,-33000,-33000
054376,聯茂中信97購01  ,0,0,0,0,0,0,0,0,0,-33000,0,0,0,110000,143000,-33000,-33000
054783,國巨群益98購04  ,0,0,0,0,0,0,0,0,0,-33000,0,0,0,0,33000,-33000,-33000
05249P,臻鼎國票95售01  ,0,0,0,0,0,0,0,0,0,-33000,0,0,0,0,33000,-33000,-33000
052502,瀚宇博永豐95購02,0,0,0,0,0,0,0,0,0,-33000,0,0,0,35000,68000,-33000,-33000
053122,美律凱基98購01  ,0,0,0,0,0,0,0,0,0,-33000,0,0,0,69000,102000,-33000,-33000
053482,矽力元大96購03  ,0,0,0,0,0,0,0,0,0,-33000,0,0,0,0,33000,-33000,-33000
044340,TPK統一93購01   ,0,0,0,0,0,0,0,0,0,-33000,0,0,0,20000,53000,-33000,-33000
044037,大立光群益92購01,0,0,0,0,0,0,0,0,0,-33000,0,0,0,0,33000,-33000,-33000
046741,GIS群益94購01   ,0,0,0,0,0,0,0,0,0,-33000,0,0,0,35000,68000,-33000,-33000
047380,統一元大93購01  ,0,0,0,0,0,0,0,0,0,-33000,0,0,0,15000,48000,-33000,-33000
049910,智邦元大94購04  ,0,0,0,0,0,0,0,0,0,-33000,0,0,0,35000,68000,-33000,-33000
049194,卜蜂永豐94購01  ,0,0,0,0,0,0,0,0,0,-33000,0,0,0,0,33000,-33000,-33000
050160,中石化國泰95購01,0,0,0,0,0,0,0,0,0,-33000,0,0,0,144000,177000,-33000,-33000
051604,喬山群益95購01  ,0,0,0,0,0,0,0,0,0,-33000,0,0,0,0,33000,-33000,-33000
052134,智邦凱基95購09  ,0,0,0,0,0,0,0,0,0,-33000,0,0,0,3000,36000,-33000,-33000
052188,欣興群益95購03  ,0,0,0,0,0,0,0,0,0,-33000,0,0,0,0,33000,-33000,-33000
050946,瑞昱群益95購01  ,0,0,0,0,0,0,0,0,0,-33000,0,0,0,37000,70000,-33000,-33000
051119,光寶科群益95購01,0,0,0,0,0,0,0,0,0,-33000,0,0,0,0,33000,-33000,-33000
052410,智邦亞東96購01  ,0,0,0,0,0,0,0,0,0,-34000,0,0,0,0,34000,-34000,-34000
05241P,鴻海國泰97售04  ,0,0,0,0,0,0,0,0,0,-34000,0,0,0,5000,39000,-34000,-34000
052645,美食永豐96購01  ,0,0,0,0,0,0,0,0,0,-34000,0,0,0,0,34000,-34000,-34000
052852,國巨元富96購02  ,0,0,0,0,0,0,0,0,0,-34000,0,0,0,757000,791000,-34000,-34000
054594,國巨麥證97購01  ,0,0,0,12000,96000,-84000,0,0,0,-34000,0,0,0,62000,96000,-34000,-34000
054286,台積電元大96購22,0,0,0,0,0,0,0,0,0,-34000,0,0,0,247000,281000,-34000,-34000
053891,欣興群益98購01  ,0,0,0,0,0,0,0,0,0,-34000,0,0,0,21000,55000,-34000,-34000
054012,廣達永豐96購01  ,0,0,0,0,0,0,0,0,0,-34000,0,0,0,0,34000,-34000,-34000
043705,力成永豐91購01  ,0,0,0,0,0,0,0,0,0,-34000,0,0,0,11000,45000,-34000,-34000
04456P,日月光統一94售01,0,0,0,0,0,0,0,0,0,-34000,0,0,0,36000,70000,-34000,-34000
048726,儒鴻麥證95購01  ,0,0,0,21000,55000,-34000,0,0,0,-34000,0,0,0,21000,55000,-34000,-34000
047399,華通康和93購01  ,0,0,0,0,0,0,0,0,0,-34000,0,0,0,0,34000,-34000,-34000
046951,GIS元大93購08   ,0,0,0,0,0,0,0,0,0,-34000,0,0,0,0,34000,-34000,-34000
052091,緯創元大95購04  ,0,0,0,0,0,0,0,0,0,-34000,0,0,0,87000,121000,-34000,-34000
049616,卜蜂群益94購01  ,0,0,0,0,0,0,0,0,0,-34000,0,0,0,17000,51000,-34000,-34000
05025P,聯發科群益95售02,0,0,0,0,0,0,0,0,0,-34000,0,0,0,7000,41000,-34000,-34000
05883P,致伸永豐96售03  ,0,0,0,0,0,0,0,0,0,-34000,0,0,0,61000,95000,-34000,-34000
06057P,大立光凱基98售01,0,0,0,0,0,0,0,0,0,-34000,0,0,0,0,34000,-34000,-34000
2548,華固            ,255684,258390,-2706,0,0,0,0,0,0,-32000,1000,2000,-1000,0,31000,-31000,-34706
05409P,京元電元富95售05,0,0,0,0,0,0,0,0,0,-35000,0,0,0,292000,327000,-35000,-35000
053857,宏達電富邦97購02,0,0,0,0,0,0,0,0,0,-35000,0,0,0,5000,40000,-35000,-35000
053681,臺股指富邦96購02,0,0,0,0,0,0,0,0,0,-35000,0,0,0,77000,112000,-35000,-35000
053613,元油反群益9A購02,0,0,0,0,0,0,0,0,0,-35000,0,0,0,0,35000,-35000,-35000
054627,義隆凱基98購01  ,0,0,0,0,0,0,0,0,0,-35000,0,0,0,10000,45000,-35000,-35000
052820,宏達電永豐96購01,0,0,0,0,0,0,0,0,0,-35000,0,0,0,0,35000,-35000,-35000
052692,滬深2X中信99購02,0,0,0,0,0,0,0,0,0,-35000,0,0,0,0,35000,-35000,-35000
053292,美律中信98購01  ,0,0,0,0,0,0,0,0,0,-35000,0,0,0,14000,49000,-35000,-35000
053022,欣興國泰98購01  ,0,0,0,0,0,0,0,0,0,-35000,0,0,0,10000,45000,-35000,-35000
044532,康控富邦93購01  ,0,0,0,0,0,0,0,0,0,-35000,0,0,0,45000,80000,-35000,-35000
045644,祥碩凱基92購01  ,0,0,0,0,0,0,0,0,0,-35000,0,0,0,10000,45000,-35000,-35000
045226,TPK元大93購02   ,0,0,0,0,0,0,0,0,0,-35000,0,0,0,0,35000,-35000,-35000
048030,聯發科凱基93購27,0,0,0,0,0,0,0,0,0,-35000,0,0,0,40000,75000,-35000,-35000
046788,貿聯永豐93購01  ,0,0,0,0,0,0,0,0,0,-35000,0,0,0,0,35000,-35000,-35000
047837,嘉晶元大93購01  ,0,0,0,0,0,0,0,0,0,-35000,0,0,0,2000,37000,-35000,-35000
046351,智邦群益92購01  ,0,0,0,0,0,0,0,0,0,-35000,0,0,0,11000,46000,-35000,-35000
049143,智邦元大94購02  ,0,0,0,0,0,0,0,0,0,-35000,0,0,0,0,35000,-35000,-35000
049272,世紀鋼元大96購02,0,0,0,0,0,0,0,0,0,-35000,0,0,0,2000,37000,-35000,-35000
050312,大立光兆豐94購04,0,0,0,0,0,0,0,0,0,-35000,0,0,0,0,35000,-35000,-35000
050774,健策元大96購02  ,0,0,0,0,0,0,0,0,0,-35000,0,0,0,15000,50000,-35000,-35000
050645,台積電凱基94購39,0,0,0,0,0,0,0,0,0,-35000,0,0,0,20000,55000,-35000,-35000
049607,台積電兆豐94購04,0,0,0,0,0,0,0,0,0,-35000,0,0,0,23000,58000,-35000,-35000
049986,嘉澤凱基94購02  ,0,0,0,0,0,0,0,0,0,-35000,0,0,0,28000,63000,-35000,-35000
049893,日月光富邦98購01,0,0,0,0,0,0,0,0,0,-35000,0,0,0,0,35000,-35000,-35000
052088,漢唐元大95購02  ,0,0,0,0,0,0,0,0,0,-35000,0,0,0,0,35000,-35000,-35000
051124,創意群益95購01  ,0,0,0,0,0,0,0,0,0,-35000,0,0,0,0,35000,-35000,-35000
051019,大立光凱基95購08,0,0,0,0,0,0,0,0,0,-35000,0,0,0,0,35000,-35000,-35000
051305,訊連凱基96購01  ,0,0,0,0,0,0,0,0,0,-35000,0,0,0,5000,40000,-35000,-35000
2208,台船            ,65000,100000,-35000,0,0,0,0,0,0,0,0,0,0,0,0,0,-35000
1721,三晃            ,1000,36000,-35000,0,0,0,0,0,0,0,0,0,0,0,0,0,-35000
06060P,玉晶光元大97售03,0,0,0,0,0,0,0,0,0,-35000,0,0,0,4000,39000,-35000,-35000
06010P,國泰金元富96售01,0,0,0,0,0,0,0,0,0,-35000,0,0,0,0,35000,-35000,-35000
9946,三發地產        ,53000,86000,-33000,0,0,0,0,0,0,-2000,0,2000,-2000,0,0,0,-35000
05228P,大立光元富95售09,0,0,0,0,0,0,0,0,0,-36000,0,0,0,10000,46000,-36000,-36000
054726,台積電日盛97購01,0,0,0,0,0,0,0,0,0,-36000,0,0,0,0,36000,-36000,-36000
054283,元油反元大99購02,0,0,0,0,0,0,0,0,0,-36000,0,0,0,0,36000,-36000,-36000
054108,台積電凱基96購22,0,0,0,0,0,0,0,0,0,-36000,0,0,0,4000,40000,-36000,-36000
04581P,楠梓電康和94售03,0,0,0,0,0,0,0,0,0,-36000,0,0,0,32000,68000,-36000,-36000
043896,台積電群益92購06,0,0,0,0,0,0,0,0,0,-36000,0,0,0,2000,38000,-36000,-36000
043776,奇力新兆豐92購01,0,0,0,0,0,0,0,0,0,-36000,0,0,0,16000,52000,-36000,-36000
044318,群創永豐91購01  ,0,0,0,0,0,0,0,0,0,-36000,0,0,0,0,36000,-36000,-36000
049024,玉晶光群益97購01,0,0,0,0,0,0,0,0,0,-36000,0,0,0,29000,65000,-36000,-36000
048427,百和元富95購01  ,0,0,0,0,0,0,0,0,0,-36000,0,0,0,34000,70000,-36000,-36000
048510,滬深2X凱基93購05,0,0,0,0,0,0,0,0,0,-36000,0,0,0,0,36000,-36000,-36000
046663,亞光元大93購02  ,0,0,0,0,0,0,0,0,0,-36000,0,0,0,1000,37000,-36000,-36000
046731,嘉聯益元大93購03,0,0,0,0,0,0,0,0,0,-36000,0,0,0,31000,67000,-36000,-36000
051960,美食永豐95購01  ,0,0,0,0,0,0,0,0,0,-36000,0,0,0,0,36000,-36000,-36000
050486,可成元富94購05  ,0,0,0,0,0,0,0,0,0,-36000,0,0,0,0,36000,-36000,-36000
6005,群益證          ,1334000,1379394,-45394,0,0,0,9000,0,9000,0,0,0,0,0,0,0,-36394
054316,矽創凱基97購01  ,0,0,0,0,0,0,0,0,0,-37000,0,0,0,32000,69000,-37000,-37000
054514,道瓊銀元大98購01,0,0,0,0,0,0,0,0,0,-37000,0,0,0,44000,81000,-37000,-37000
052965,廣宇群益97購01  ,0,0,0,0,0,0,0,0,0,-37000,0,0,0,0,37000,-37000,-37000
053140,燿華永豐96購02  ,0,0,0,0,0,0,0,0,0,-37000,0,0,0,0,37000,-37000,-37000
044321,超眾永豐91購01  ,0,0,0,0,0,0,0,0,0,-37000,0,0,0,0,37000,-37000,-37000
042904,金寶元大94購02  ,0,0,0,0,0,0,0,0,0,-37000,0,0,0,5000,42000,-37000,-37000
042983,亞光凱基92購01  ,0,0,0,0,0,0,0,0,0,-37000,0,0,0,107000,144000,-37000,-37000
03943P,可成群益93售01  ,0,0,0,0,0,0,0,0,0,-37000,0,0,0,0,37000,-37000,-37000
043753,聯發科元大92購02,0,0,0,0,0,0,0,0,0,-37000,0,0,0,10000,47000,-37000,-37000
047757,達運元富93購01  ,0,0,0,0,0,0,0,0,0,-37000,0,0,0,12000,49000,-37000,-37000
048634,華通元大94購01  ,0,0,0,0,0,0,0,0,0,-37000,0,0,0,119000,156000,-37000,-37000
048979,晶相光元大94購03,0,0,0,0,0,0,0,0,0,-37000,0,0,0,200000,237000,-37000,-37000
048972,晶豪科元大94購01,0,0,0,0,0,0,0,0,0,-37000,0,0,0,48000,85000,-37000,-37000
049742,日月光群益94購02,0,0,0,0,0,0,0,0,0,-37000,0,0,0,133000,170000,-37000,-37000
051987,廣達元大95購01  ,0,0,0,0,0,0,0,0,0,-37000,0,0,0,31000,68000,-37000,-37000
052141,百和凱基95購02  ,0,0,0,0,0,0,0,0,0,-37000,0,0,0,53000,90000,-37000,-37000
06028P,智邦台新97售01  ,0,0,0,0,0,0,0,0,0,-37000,0,0,0,122000,159000,-37000,-37000
2460,建通            ,0,24000,-24000,0,0,0,0,0,0,-13000,0,13000,-13000,0,0,0,-37000
053077,同欣電永豐96購01,0,0,0,0,0,0,0,0,0,-38000,0,0,0,20000,58000,-38000,-38000
053264,南亞科群益96購01,0,0,0,0,0,0,0,0,0,-38000,0,0,0,65000,103000,-38000,-38000
052414,聯電麥證95購01  ,0,0,0,22000,60000,-38000,0,0,0,-38000,0,0,0,22000,60000,-38000,-38000
054381,世芯群益98購01  ,0,0,0,0,0,0,0,0,0,-38000,0,0,0,1000,39000,-38000,-38000
054630,聯鈞凱基98購01  ,0,0,0,0,0,0,0,0,0,-38000,0,0,0,0,38000,-38000,-38000
053933,大立光統一96購06,0,0,0,0,0,0,0,0,0,-38000,0,0,0,0,38000,-38000,-38000
048244,廣宇兆豐93購01  ,0,0,0,0,0,0,0,0,0,-38000,0,0,0,7000,45000,-38000,-38000
044850,南亞科統一94購01,0,0,0,0,0,0,0,0,0,-38000,0,0,0,0,38000,-38000,-38000
045352,亞光凱基92購03  ,0,0,0,0,0,0,0,0,0,-38000,0,0,0,2000,40000,-38000,-38000
03444P,道瓊銀群益02售04,0,0,0,0,0,0,0,0,0,-38000,0,0,0,38000,76000,-38000,-38000
044352,南亞科元大91購11,0,0,0,0,0,0,0,0,0,-38000,0,0,0,30000,68000,-38000,-38000
044474,鈺齊群益91購01  ,0,0,0,0,0,0,0,0,0,-38000,0,0,0,2000,40000,-38000,-38000
048697,華新科國票94購06,0,0,0,0,0,0,0,0,0,-38000,0,0,0,0,38000,-38000,-38000
04925P,和碩元大94售03  ,0,0,0,0,0,0,0,0,0,-38000,0,0,0,150000,188000,-38000,-38000
048499,達運元大96購01  ,0,0,0,0,0,0,0,0,0,-38000,0,0,0,17000,55000,-38000,-38000
048400,矽創國票93購01  ,0,0,0,0,0,0,0,0,0,-38000,0,0,0,0,38000,-38000,-38000
04590P,元石油元大97售01,0,0,0,0,0,0,0,0,0,-38000,0,0,0,0,38000,-38000,-38000
050977,聯發科統一95購02,0,0,0,0,0,0,0,0,0,-38000,0,0,0,10000,48000,-38000,-38000
051189,鴻海兆豐96購01  ,0,0,0,0,0,0,0,0,0,-38000,0,0,0,38000,76000,-38000,-38000
050640,致新國票94購01  ,0,0,0,0,0,0,0,0,0,-38000,0,0,0,0,38000,-38000,-38000
2881A,富邦特          ,0,0,0,0,0,0,0,0,0,-38000,52000,90000,-38000,0,0,0,-38000
4961,天鈺            ,27000,49000,-22000,0,0,0,0,0,0,-16000,0,0,0,3000,19000,-16000,-38000
1449,佳和            ,49000,87000,-38000,0,0,0,0,0,0,0,0,0,0,0,0,0,-38000
054719,亞光永豐97購01  ,0,0,0,0,0,0,0,0,0,-39000,0,0,0,0,39000,-39000,-39000
052830,台光電群益96購01,0,0,0,0,0,0,0,0,0,-39000,0,0,0,47000,86000,-39000,-39000
052861,台光電凱基96購03,0,0,0,0,0,0,0,0,0,-39000,0,0,0,24000,63000,-39000,-39000
053142,緯穎永豐96購01  ,0,0,0,0,0,0,0,0,0,-39000,0,0,0,74000,113000,-39000,-39000
04262P,景碩群益93售03  ,0,0,0,0,0,0,0,0,0,-39000,0,0,0,194000,233000,-39000,-39000
045912,潤泰全國票92購01,0,0,0,0,0,0,0,0,0,-39000,0,0,0,0,39000,-39000,-39000
046744,元油2X凱基94購01,0,0,0,0,0,0,0,0,0,-39000,0,0,0,1000,40000,-39000,-39000
049051,滬深2X永豐94購05,0,0,0,0,0,0,0,0,0,-39000,0,0,0,0,39000,-39000,-39000
049903,大立光元富94購06,0,0,0,0,0,0,0,0,0,-39000,0,0,0,147000,186000,-39000,-39000
048815,川湖凱基94購01  ,0,0,0,0,0,0,0,0,0,-39000,0,0,0,29000,68000,-39000,-39000
047121,訊芯元大93購03  ,0,0,0,0,0,0,0,0,0,-39000,0,0,0,3000,42000,-39000,-39000
050076,百和凱基94購02  ,0,0,0,0,0,0,0,0,0,-39000,0,0,0,22000,61000,-39000,-39000
051310,台達電麥證95購01,0,0,0,31000,70000,-39000,0,0,0,-39000,0,0,0,31000,70000,-39000,-39000
051472,台積電凱基95購09,0,0,0,0,0,0,0,0,0,-39000,0,0,0,59000,98000,-39000,-39000
051638,聯茂國票96購01  ,0,0,0,0,0,0,0,0,0,-39000,0,0,0,0,39000,-39000,-39000
1338,廣華-KY         ,7000,46000,-39000,0,0,0,0,0,0,0,0,0,0,0,0,0,-39000
053057,聯電國泰97購02  ,0,0,0,0,0,0,0,0,0,-40000,0,0,0,58000,98000,-40000,-40000
053048,同欣電麥證96購01,0,0,0,0,40000,-40000,0,0,0,-40000,0,0,0,0,40000,-40000,-40000
053308,智易凱基96購02  ,0,0,0,0,0,0,0,0,0,-40000,0,0,0,10000,50000,-40000,-40000
053454,創意統一96購02  ,0,0,0,0,0,0,0,0,0,-40000,0,0,0,0,40000,-40000,-40000
052726,鴻海元富96購03  ,0,0,0,0,0,0,0,0,0,-40000,0,0,0,131000,171000,-40000,-40000
052731,宏達電國泰98購01,0,0,0,0,0,0,0,0,0,-40000,0,0,0,0,40000,-40000,-40000
052761,可成群益96購02  ,0,0,0,0,0,0,0,0,0,-40000,0,0,0,21000,61000,-40000,-40000
052663,奇鋐國票97購01  ,0,0,0,0,0,0,0,0,0,-40000,0,0,0,0,40000,-40000,-40000
052298,易華電國票96購01,0,0,0,0,0,0,0,0,0,-40000,0,0,0,0,40000,-40000,-40000
052307,潤泰全國泰96購01,0,0,0,0,0,0,0,0,0,-40000,0,0,0,0,40000,-40000,-40000
054637,智邦中信98購01  ,0,0,0,0,0,0,0,0,0,-40000,0,0,0,0,40000,-40000,-40000
054659,亞光元大97購02  ,0,0,0,0,0,0,0,0,0,-40000,0,0,0,157000,197000,-40000,-40000
054556,世芯凱基99購01  ,0,0,0,0,0,0,0,0,0,-40000,0,0,0,0,40000,-40000,-40000
054380,世芯群益97購02  ,0,0,0,0,0,0,0,0,0,-40000,0,0,0,2000,42000,-40000,-40000
054397,創意永豐96購05  ,0,0,0,0,0,0,0,0,0,-40000,0,0,0,0,40000,-40000,-40000
054510,S&P反1元大98購01,0,0,0,0,0,0,0,0,0,-40000,0,0,0,0,40000,-40000,-40000
054451,上銀亞東98購01  ,0,0,0,0,0,0,0,0,0,-40000,0,0,0,0,40000,-40000,-40000
054251,聯發科元大96購21,0,0,0,0,0,0,0,0,0,-40000,0,0,0,122000,162000,-40000,-40000
054188,欣興永豐96購03  ,0,0,0,0,0,0,0,0,0,-40000,0,0,0,28000,68000,-40000,-40000
053728,茂林凱基97購01  ,0,0,0,0,0,0,0,0,0,-40000,0,0,0,24000,64000,-40000,-40000
053751,康控永豐96購02  ,0,0,0,0,0,0,0,0,0,-40000,0,0,0,5000,45000,-40000,-40000
042734,大立光兆豐92購02,0,0,0,0,0,0,0,0,0,-40000,0,0,0,0,40000,-40000,-40000
042903,金寶元大94購01  ,0,0,0,0,0,0,0,0,0,-40000,0,0,0,160000,200000,-40000,-40000
042787,新日興兆豐93購01,0,0,0,0,0,0,0,0,0,-40000,0,0,0,10000,50000,-40000,-40000
044494,可成元大91購08  ,0,0,0,0,0,0,0,0,0,-40000,0,0,0,110000,150000,-40000,-40000
044595,鈺齊國票91購01  ,0,0,0,0,0,0,0,0,0,-40000,0,0,0,0,40000,-40000,-40000
04470P,為升元大94售01  ,0,0,0,0,0,0,0,0,0,-40000,0,0,0,44000,84000,-40000,-40000
044337,大立光統一91購10,0,0,0,0,0,0,0,0,0,-40000,0,0,0,28000,68000,-40000,-40000
044376,日月光兆豐92購01,0,0,0,0,0,0,0,0,0,-40000,0,0,0,0,40000,-40000,-40000
03852P,華邦電凱基93售05,0,0,0,0,0,0,0,0,0,-40000,0,0,0,10000,50000,-40000,-40000
00712,FH富時不動產    ,0,60000,-60000,0,0,0,0,0,0,20000,0,0,0,218000,198000,20000,-40000
03180P,台灣50元大01售39,0,0,0,0,0,0,0,0,0,-40000,0,0,0,20000,60000,-40000,-40000
045401,大立光兆豐93購01,0,0,0,0,0,0,0,0,0,-40000,0,0,0,0,40000,-40000,-40000
045242,台肥群益92購01  ,0,0,0,0,0,0,0,0,0,-40000,0,0,0,0,40000,-40000,-40000
045260,可成凱基92購04  ,0,0,0,0,0,0,0,0,0,-40000,0,0,0,0,40000,-40000,-40000
045493,台肥凱基92購01  ,0,0,0,0,0,0,0,0,0,-40000,0,0,0,0,40000,-40000,-40000
045509,聯茂凱基92購04  ,0,0,0,0,0,0,0,0,0,-40000,0,0,0,0,40000,-40000,-40000
044884,嘉澤群益93購01  ,0,0,0,0,0,0,0,0,0,-40000,0,0,0,15000,55000,-40000,-40000
045820,京元電凱基92購04,0,0,0,0,0,0,0,0,0,-40000,0,0,0,120000,160000,-40000,-40000
04513P,元石油中信94售01,0,0,0,0,0,0,0,0,0,-40000,0,0,0,0,40000,-40000,-40000
04628P,欣興元大95售01  ,0,0,0,0,0,0,0,0,0,-40000,0,0,0,0,40000,-40000,-40000
046281,正崴永豐92購01  ,0,0,0,0,0,0,0,0,0,-40000,0,0,0,45000,85000,-40000,-40000
043894,百和元大92購01  ,0,0,0,0,0,0,0,0,0,-40000,0,0,0,0,40000,-40000,-40000
045733,瑞昱國票93購01  ,0,0,0,0,0,0,0,0,0,-40000,0,0,0,20000,60000,-40000,-40000
045645,祥碩凱基93購03  ,0,0,0,0,0,0,0,0,0,-40000,0,0,0,0,40000,-40000,-40000
044186,宏達電國泰92購01,0,0,0,0,0,0,0,0,0,-40000,0,0,0,0,40000,-40000,-40000
047525,漢唐元大93購04  ,0,0,0,0,0,0,0,0,0,-40000,0,0,0,0,40000,-40000,-40000
048165,嘉澤康和93購01  ,0,0,0,0,0,0,0,0,0,-40000,0,0,0,60000,100000,-40000,-40000
047249,欣興群益93購03  ,0,0,0,0,0,0,0,0,0,-40000,0,0,0,0,40000,-40000,-40000
048759,巨大元富96購01  ,0,0,0,0,0,0,0,0,0,-40000,0,0,0,0,40000,-40000,-40000
047109,華邦電元大94購01,0,0,0,0,0,0,0,0,0,-40000,0,0,0,22000,62000,-40000,-40000
048683,日月光富邦93購01,0,0,0,0,0,0,0,0,0,-40000,0,0,0,0,40000,-40000,-40000
049323,百和凱基94購01  ,0,0,0,0,0,0,0,0,0,-40000,0,0,0,20000,60000,-40000,-40000
049931,矽力元大94購01  ,0,0,0,0,0,0,0,0,0,-40000,0,0,0,0,40000,-40000,-40000
049281,嘉聯益國票95購01,0,0,0,0,0,0,0,0,0,-40000,0,0,0,56000,96000,-40000,-40000
049131,元油2X元大94購02,0,0,0,0,0,0,0,0,0,-40000,0,0,0,0,40000,-40000,-40000
049372,華新科元大95購04,0,0,0,0,0,0,0,0,0,-40000,0,0,0,167000,207000,-40000,-40000
046830,大立光群益93購07,0,0,0,0,0,0,0,0,0,-40000,0,0,0,13000,53000,-40000,-40000
046064,中工凱基94購01  ,0,0,0,0,0,0,0,0,0,-40000,0,0,0,0,40000,-40000,-40000
046954,同欣電國票93購01,0,0,0,0,0,0,0,0,0,-40000,0,0,0,0,40000,-40000,-40000
047020,智邦元大93購04  ,0,0,0,0,0,0,0,0,0,-40000,0,0,0,0,40000,-40000,-40000
048454,合勤控凱基94購01,0,0,0,0,0,0,0,0,0,-40000,0,0,0,10000,50000,-40000,-40000
04671P,華通統一94售01  ,0,0,0,0,0,0,0,0,0,-40000,0,0,0,10000,50000,-40000,-40000
046603,貿聯群益93購01  ,0,0,0,0,0,0,0,0,0,-40000,0,0,0,8000,48000,-40000,-40000
051568,智邦富邦95購01  ,0,0,0,0,0,0,0,0,0,-40000,0,0,0,0,40000,-40000,-40000
051727,S&P反1國票97購01,0,0,0,0,0,0,0,0,0,-40000,0,0,0,0,40000,-40000,-40000
052057,臺股指凱基95購15,0,0,0,0,0,0,0,0,0,-40000,0,0,0,0,40000,-40000,-40000
052024,臺股指永豐95購04,0,0,0,0,0,0,0,0,0,-40000,0,0,0,0,40000,-40000,-40000
051265,鴻海富邦96購04  ,0,0,0,0,0,0,0,0,0,-40000,0,0,0,1000,41000,-40000,-40000
050923,南亞科凱基95購03,0,0,0,0,0,0,0,0,0,-40000,0,0,0,0,40000,-40000,-40000
049465,美律台新94購01  ,0,0,0,0,0,0,0,0,0,-40000,0,0,0,0,40000,-40000,-40000
050799,嘉聯益中信98購01,0,0,0,0,0,0,0,0,0,-40000,0,0,0,10000,50000,-40000,-40000
050333,鴻海國泰96購06  ,0,0,0,0,0,0,0,0,0,-40000,0,0,0,16000,56000,-40000,-40000
08614P,聯發科統一9C售18,0,0,0,0,0,0,0,0,0,-40000,0,0,0,0,40000,-40000,-40000
05881P,彩晶康和96售01  ,0,0,0,0,0,0,0,0,0,-40000,0,0,0,0,40000,-40000,-40000
05660P,玉晶光第一96售01,0,0,0,0,0,0,0,0,0,-40000,0,0,0,0,40000,-40000,-40000
054289,聯發科元大97購11,0,0,0,0,0,0,0,0,0,-41000,0,0,0,23000,64000,-41000,-41000
054477,聯發科中信9C購02,0,0,0,0,0,0,0,0,0,-41000,0,0,0,0,41000,-41000,-41000
054377,臺股指中信99購09,0,0,0,0,0,0,0,0,0,-41000,0,0,0,0,41000,-41000,-41000
052343,同欣電凱基95購03,0,0,0,0,0,0,0,0,0,-41000,0,0,0,20000,61000,-41000,-41000
03576P,台灣50元富06售01,0,0,0,0,0,0,0,0,0,-41000,0,0,0,160000,201000,-41000,-41000
041916,大立光中信93購01,0,0,0,0,0,0,0,0,0,-41000,0,0,0,0,41000,-41000,-41000
046574,泰鼎國泰94購01  ,0,0,0,0,0,0,0,0,0,-41000,0,0,0,5000,46000,-41000,-41000
046838,勤誠群益93購01  ,0,0,0,0,0,0,0,0,0,-41000,0,0,0,120000,161000,-41000,-41000
047724,智邦群益93購03  ,0,0,0,0,0,0,0,0,0,-41000,0,0,0,0,41000,-41000,-41000
048691,智伸科群益94購01,0,0,0,0,0,0,0,0,0,-41000,0,0,0,18000,59000,-41000,-41000
050863,聯發科永豐95購01,0,0,0,0,0,0,0,0,0,-41000,0,0,0,27000,68000,-41000,-41000
049411,大成鋼凱基94購01,0,0,0,0,0,0,0,0,0,-41000,0,0,0,40000,81000,-41000,-41000
049856,緯穎群益94購02  ,0,0,0,0,0,0,0,0,0,-41000,0,0,0,30000,71000,-41000,-41000
051483,玉晶光凱基96購02,0,0,0,0,0,0,0,0,0,-41000,0,0,0,60000,101000,-41000,-41000
052176,景碩元大96購01  ,0,0,0,0,0,0,0,0,0,-41000,0,0,0,21000,62000,-41000,-41000
05911P,南亞科永豐96售03,0,0,0,0,0,0,0,0,0,-41000,0,0,0,40000,81000,-41000,-41000
4916,事欣科          ,32000,73000,-41000,0,0,0,0,0,0,0,0,0,0,0,0,0,-41000
2390,云辰            ,36000,77000,-41000,0,0,0,0,0,0,0,0,0,0,0,0,0,-41000
2107,厚生            ,39000,80000,-41000,0,0,0,0,0,0,0,0,0,0,0,0,0,-41000
6558,興能高          ,70000,111000,-41000,0,0,0,0,0,0,0,0,0,0,0,0,0,-41000
052962,台積電凱基97購03,0,0,0,0,0,0,0,0,0,-42000,0,0,0,10000,52000,-42000,-42000
053131,華通國票97購03  ,0,0,0,0,0,0,0,0,0,-42000,0,0,0,22000,64000,-42000,-42000
04358P,TPK永豐94售01   ,0,0,0,0,0,0,0,0,0,-42000,0,0,0,79000,121000,-42000,-42000
03828P,致茂中信95售01  ,0,0,0,0,0,0,0,0,0,-42000,0,0,0,32000,74000,-42000,-42000
045114,玉晶光永豐93購02,0,0,0,0,0,0,0,0,0,-42000,0,0,0,0,42000,-42000,-42000
048159,聯詠兆豐93購03  ,0,0,0,0,0,0,0,0,0,-42000,0,0,0,38000,80000,-42000,-42000
046833,晶技群益93購01  ,0,0,0,0,0,0,0,0,0,-42000,0,0,0,33000,75000,-42000,-42000
052194,旺宏元富95購04  ,0,0,0,0,0,0,0,0,0,-42000,0,0,0,15000,57000,-42000,-42000
051382,玉晶光群益98購02,0,0,0,0,0,0,0,0,0,-42000,0,0,0,3000,45000,-42000,-42000
051193,新日興兆豐96購01,0,0,0,0,0,0,0,0,0,-42000,0,0,0,50000,92000,-42000,-42000
049520,TPK國票95購01   ,0,0,0,0,0,0,0,0,0,-42000,0,0,0,0,42000,-42000,-42000
6177,達麗            ,41000,83000,-42000,0,0,0,0,0,0,0,0,0,0,0,0,0,-42000
3149,正達            ,12000,54000,-42000,0,0,0,0,0,0,0,0,0,0,0,0,0,-42000
05665P,台積電凱基96售08,0,0,0,0,0,0,0,0,0,-42000,0,0,0,5000,47000,-42000,-42000
05761P,嘉澤永豐96售01  ,0,0,0,0,0,0,0,0,0,-42000,0,0,0,48000,90000,-42000,-42000
1611,中電            ,0,42100,-42100,0,0,0,0,0,0,0,0,0,0,0,0,0,-42100
052635,奇力新凱基98購01,0,0,0,0,0,0,0,0,0,-43000,0,0,0,60000,103000,-43000,-43000
053741,漢唐國票97購03  ,0,0,0,0,0,0,0,0,0,-43000,0,0,0,0,43000,-43000,-43000
053591,大立光元大99購03,0,0,0,0,0,0,0,0,0,-43000,0,0,0,0,43000,-43000,-43000
053924,京鼎國票97購01  ,0,0,0,0,0,0,0,0,0,-43000,0,0,0,5000,48000,-43000,-43000
054007,貿聯統一96購01  ,0,0,0,0,0,0,0,0,0,-43000,0,0,0,63000,106000,-43000,-43000
04482P,臺股指日盛94售01,0,0,0,0,0,0,0,0,0,-43000,0,0,0,0,43000,-43000,-43000
045796,廣達中信93購01  ,0,0,0,0,0,0,0,0,0,-43000,0,0,0,7000,50000,-43000,-43000
03891P,晶技國泰94售02  ,0,0,0,0,0,0,0,0,0,-43000,0,0,0,0,43000,-43000,-43000
047973,華通兆豐94購01  ,0,0,0,0,0,0,0,0,0,-43000,0,0,0,0,43000,-43000,-43000
048547,訊芯永豐93購03  ,0,0,0,0,0,0,0,0,0,-43000,0,0,0,67000,110000,-43000,-43000
047061,鴻海凱基93購23  ,0,0,0,0,0,0,0,0,0,-43000,0,0,0,14000,57000,-43000,-43000
049244,亞光元富94購01  ,0,0,0,0,0,0,0,0,0,-43000,0,0,0,3000,46000,-43000,-43000
050569,英業達中信94購01,0,0,0,0,0,0,0,0,0,-43000,0,0,0,17000,60000,-43000,-43000
050298,智伸科凱基94購02,0,0,0,0,0,0,0,0,0,-43000,0,0,0,0,43000,-43000,-43000
1340,勝悅-KY         ,14000,57000,-43000,0,0,0,0,0,0,0,0,0,0,0,0,0,-43000
05671P,友達國泰97售03  ,0,0,0,0,0,0,0,0,0,-43000,0,0,0,637000,680000,-43000,-43000
1730,花仙子          ,12000,55000,-43000,0,0,0,0,0,0,0,0,0,0,0,0,0,-43000
8261,富鼎            ,25000,68000,-43000,0,0,0,0,0,0,0,0,0,0,0,0,0,-43000
9917,中保科          ,21000,65548,-44548,0,0,0,1000,0,1000,0,0,0,0,0,0,0,-43548
052536,聯茂國泰97購01  ,0,0,0,0,0,0,0,0,0,-44000,0,0,0,57000,101000,-44000,-44000
03744P,致茂凱基93售01  ,0,0,0,0,0,0,0,0,0,-44000,0,0,0,24000,68000,-44000,-44000
041871,元油2X凱基92購02,0,0,0,0,0,0,0,0,0,-44000,0,0,0,0,44000,-44000,-44000
049853,上海銀群益94購02,0,0,0,0,0,0,0,0,0,-44000,0,0,0,0,44000,-44000,-44000
052152,創意富邦98購01  ,0,0,0,0,0,0,0,0,0,-44000,0,0,0,23000,67000,-44000,-44000
2103,台橡            ,69000,113000,-44000,0,0,0,0,0,0,0,0,0,0,0,0,0,-44000
053150,聯發科元大96購11,0,0,0,0,0,0,0,0,0,-45000,0,0,0,13000,58000,-45000,-45000
053117,大立光中信9A購02,0,0,0,0,0,0,0,0,0,-45000,0,0,0,0,45000,-45000,-45000
053205,台光電麥證96購01,0,0,0,149000,223000,-74000,0,0,0,-45000,0,0,0,178000,223000,-45000,-45000
053076,貿聯永豐96購01  ,0,0,0,0,0,0,0,0,0,-45000,0,0,0,0,45000,-45000,-45000
053380,南亞科元大97購01,0,0,0,0,0,0,0,0,0,-45000,0,0,0,2000,47000,-45000,-45000
053424,欣興永豐96購02  ,0,0,0,0,0,0,0,0,0,-45000,0,0,0,23000,68000,-45000,-45000
054583,玉晶光統一97購02,0,0,0,0,0,0,0,0,0,-45000,0,0,0,47000,92000,-45000,-45000
048261,鴻海元富95購01  ,0,0,0,0,0,0,0,0,0,-45000,0,0,0,51000,96000,-45000,-45000
048276,旺宏永豐94購01  ,0,0,0,0,0,0,0,0,0,-45000,0,0,0,90000,135000,-45000,-45000
043847,台光電國泰92購01,0,0,0,0,0,0,0,0,0,-45000,0,0,0,0,45000,-45000,-45000
049019,美律群益94購02  ,0,0,0,0,0,0,0,0,0,-45000,0,0,0,38000,83000,-45000,-45000
049022,聯詠群益94購01  ,0,0,0,0,0,0,0,0,0,-45000,0,0,0,45000,90000,-45000,-45000
049261,大立光元大94購08,0,0,0,0,0,0,0,0,0,-45000,0,0,0,2000,47000,-45000,-45000
04981P,華新科亞東94售01,0,0,0,0,0,0,0,0,0,-45000,0,0,0,0,45000,-45000,-45000
050470,智邦台新94購01  ,0,0,0,0,0,0,0,0,0,-45000,0,0,0,38000,83000,-45000,-45000
050686,欣興兆豐96購01  ,0,0,0,0,0,0,0,0,0,-45000,0,0,0,338000,383000,-45000,-45000
050859,訊芯康和95購01  ,0,0,0,0,0,0,0,0,0,-45000,0,0,0,0,45000,-45000,-45000
5471,松翰            ,37000,82000,-45000,0,0,0,0,0,0,0,0,0,0,0,0,0,-45000
05996P,華新科群益96售03,0,0,0,0,0,0,0,0,0,-45000,0,0,0,41000,86000,-45000,-45000
054625,旺宏凱基98購03  ,0,0,0,0,0,0,0,0,0,-46000,0,0,0,5000,51000,-46000,-46000
05487P,台表科凱基95售02,0,0,0,0,0,0,0,0,0,-46000,0,0,0,0,46000,-46000,-46000
054375,貿聯中信99購01  ,0,0,0,0,0,0,0,0,0,-46000,0,0,0,9000,55000,-46000,-46000
054275,華通群益97購03  ,0,0,0,0,0,0,0,0,0,-46000,0,0,0,110000,156000,-46000,-46000
054134,強茂元大96購01  ,0,0,0,0,0,0,0,0,0,-46000,0,0,0,160000,206000,-46000,-46000
053792,百和元大96購01  ,0,0,0,0,0,0,0,0,0,-46000,0,0,0,54000,100000,-46000,-46000
053010,鴻海統一96購11  ,0,0,0,0,0,0,0,0,0,-46000,0,0,0,3000,49000,-46000,-46000
053152,大立光元大99購01,0,0,0,0,0,0,0,0,0,-46000,0,0,0,31000,77000,-46000,-46000
045738,強茂群益92購01  ,0,0,0,0,0,0,0,0,0,-46000,0,0,0,0,46000,-46000,-46000
04477P,南電元大94售04  ,0,0,0,0,0,0,0,0,0,-46000,0,0,0,45000,91000,-46000,-46000
04550P,超眾元大94售01  ,0,0,0,0,0,0,0,0,0,-46000,0,0,0,274000,320000,-46000,-46000
042388,大立光永昌93購02,0,0,0,0,0,0,0,0,0,-46000,0,0,0,3000,49000,-46000,-46000
048823,漢唐凱基94購01  ,0,0,0,0,0,0,0,0,0,-46000,0,0,0,0,46000,-46000,-46000
046509,中壽元大92購01  ,0,0,0,0,0,0,0,0,0,-46000,0,0,0,0,46000,-46000,-46000
050642,和大凱基94購03  ,0,0,0,0,0,0,0,0,0,-46000,0,0,0,30000,76000,-46000,-46000
050444,卜蜂元大94購03  ,0,0,0,0,0,0,0,0,0,-46000,0,0,0,0,46000,-46000,-46000
050526,貿聯元大95購01  ,0,0,0,0,0,0,0,0,0,-46000,0,0,0,116000,162000,-46000,-46000
04979P,臺股指凱基96售07,0,0,0,0,0,0,0,0,0,-46000,0,0,0,4000,50000,-46000,-46000
050133,鈺齊凱基94購01  ,0,0,0,0,0,0,0,0,0,-46000,0,0,0,116000,162000,-46000,-46000
049423,臺股指凱基95購02,0,0,0,0,0,0,0,0,0,-46000,0,0,0,15000,61000,-46000,-46000
051678,鈺齊元大95購02  ,0,0,0,0,0,0,0,0,0,-46000,0,0,0,33000,79000,-46000,-46000
051846,S&P反1中信96購02,0,0,0,0,0,0,0,0,0,-46000,0,0,0,4000,50000,-46000,-46000
051558,元金2X國泰97購01,0,0,0,0,0,0,0,0,0,-46000,0,0,0,14000,60000,-46000,-46000
05805P,義隆永豐96售02  ,0,0,0,0,0,0,0,0,0,-46000,0,0,0,0,46000,-46000,-46000
9924,福興            ,6000,52000,-46000,0,0,0,0,0,0,0,0,0,0,0,0,0,-46000
053331,玉晶光永豐97購02,0,0,0,0,0,0,0,0,0,-47000,0,0,0,4000,51000,-47000,-47000
052401,智原凱基95購01  ,0,0,0,0,0,0,0,0,0,-47000,0,0,0,0,47000,-47000,-47000
053779,台光電元大96購02,0,0,0,0,0,0,0,0,0,-47000,0,0,0,40000,87000,-47000,-47000
054407,美律國票97購02  ,40000,0,40000,0,0,0,0,0,0,-87000,0,0,0,0,87000,-87000,-47000
039727,台積電群益91購02,0,0,0,0,0,0,0,0,0,-47000,0,0,0,310000,357000,-47000,-47000
043774,瑞昱兆豐92購01  ,0,0,0,0,0,0,0,0,0,-47000,0,0,0,14000,61000,-47000,-47000
047944,中石化元富96購01,0,0,0,0,0,0,0,0,0,-47000,0,0,0,53000,100000,-47000,-47000
045960,聯發科凱基92購01,0,0,0,0,0,0,0,0,0,-47000,0,0,0,77000,124000,-47000,-47000
045939,緯穎群益92購03  ,0,0,0,0,0,0,0,0,0,-47000,0,0,0,30000,77000,-47000,-47000
051130,百和群益96購01  ,0,0,0,0,0,0,0,0,0,-47000,0,0,0,187000,234000,-47000,-47000
04976P,中磊凱基94售01  ,0,0,0,0,0,0,0,0,0,-47000,0,0,0,0,47000,-47000,-47000
050049,華通群益96購01  ,0,0,0,0,0,0,0,0,0,-47000,0,0,0,97000,144000,-47000,-47000
4536,拓凱            ,15000,51000,-36000,0,0,0,0,0,0,-11000,5000,12000,-7000,0,4000,-4000,-47000
2642,宅配通          ,17000,63000,-46000,0,0,0,0,0,0,-1000,0,1000,-1000,0,0,0,-47000
054576,健策元大98購03  ,0,0,0,0,0,0,0,0,0,-48000,0,0,0,13000,61000,-48000,-48000
053697,臻鼎元大96購02  ,0,0,0,0,0,0,0,0,0,-48000,0,0,0,56000,104000,-48000,-48000
054046,義隆元大96購02  ,0,0,0,0,0,0,0,0,0,-48000,0,0,0,100000,148000,-48000,-48000
053908,貿聯凱基98購01  ,0,0,0,0,0,0,0,0,0,-48000,0,0,0,32000,80000,-48000,-48000
052551,台積電國票97購03,0,0,0,0,0,0,0,0,0,-48000,0,0,0,9000,57000,-48000,-48000
052720,鴻海統一96購07  ,0,0,0,0,0,0,0,0,0,-48000,0,0,0,0,48000,-48000,-48000
053569,漢唐統一98購01  ,0,0,0,0,0,0,0,0,0,-48000,0,0,0,0,48000,-48000,-48000
043930,南亞科永豐91購01,0,0,0,0,0,0,0,0,0,-48000,0,0,0,0,48000,-48000,-48000
045830,亞德客群益92購02,0,0,0,0,0,0,0,0,0,-48000,0,0,0,22000,70000,-48000,-48000
044689,超眾凱基93購03  ,0,0,0,0,0,0,0,0,0,-48000,0,0,0,73000,121000,-48000,-48000
047960,鈺齊永豐93購01  ,0,0,0,0,0,0,0,0,0,-48000,0,0,0,2000,50000,-48000,-48000
048665,欣興統一93購07  ,0,0,0,0,0,0,0,0,0,-48000,0,0,0,5000,53000,-48000,-48000
048871,晶豪科國票94購01,0,0,0,0,0,0,0,0,0,-48000,0,0,0,56000,104000,-48000,-48000
047144,華通群益94購01  ,0,0,0,0,0,0,0,0,0,-48000,0,0,0,11000,59000,-48000,-48000
049645,台積電凱基94購22,0,0,0,0,0,0,0,0,0,-48000,0,0,0,0,48000,-48000,-48000
050718,茂林群益94購04  ,0,0,0,0,0,0,0,0,0,-48000,0,0,0,10000,58000,-48000,-48000
050793,大立光富邦96購03,0,0,0,0,0,0,0,0,0,-48000,0,0,0,15000,63000,-48000,-48000
050960,台光電永豐95購01,0,0,0,0,0,0,0,0,0,-48000,0,0,0,20000,68000,-48000,-48000
051406,泰鼎永豐96購01  ,0,0,0,0,0,0,0,0,0,-48000,0,0,0,20000,68000,-48000,-48000
2355,敬鵬            ,138000,189000,-51000,0,0,0,0,0,0,3000,4000,1000,3000,0,0,0,-48000
1101B,台泥乙特        ,0,0,0,0,0,0,0,0,0,-48000,0,48000,-48000,0,0,0,-48000
1218,泰山            ,25000,72000,-47000,0,0,0,0,0,0,-1000,0,1000,-1000,0,0,0,-48000
053167,欣興群益96購03  ,0,0,0,0,0,0,0,0,0,-49000,0,0,0,13000,62000,-49000,-49000
052661,奇力新國票97購03,0,0,0,0,0,0,0,0,0,-49000,0,0,0,1000,50000,-49000,-49000
052809,訊芯元大97購01  ,0,0,0,0,0,0,0,0,0,-49000,0,0,0,1000,50000,-49000,-49000
052256,台泥國泰96購01  ,0,0,0,0,0,0,0,0,0,-49000,0,0,0,356000,405000,-49000,-49000
054089,台積電群益96購11,0,0,0,0,0,0,0,0,0,-49000,0,0,0,136000,185000,-49000,-49000
053782,京元電元大98購02,0,0,0,0,0,0,0,0,0,-49000,0,0,0,25000,74000,-49000,-49000
054578,世芯元大99購01  ,0,0,0,0,0,0,0,0,0,-49000,0,0,0,0,49000,-49000,-49000
043990,智易元大93購01  ,0,0,0,0,0,0,0,0,0,-49000,0,0,0,13000,62000,-49000,-49000
043980,旺宏元大92購05  ,0,0,0,0,0,0,0,0,0,-49000,0,0,0,1000,50000,-49000,-49000
045576,智邦元大92購07  ,0,0,0,0,0,0,0,0,0,-49000,0,0,0,0,49000,-49000,-49000
043848,日月光國泰92購01,0,0,0,0,0,0,0,0,0,-49000,0,0,0,0,49000,-49000,-49000
048269,瀚宇博國泰95購01,0,0,0,0,0,0,0,0,0,-49000,0,0,0,329000,378000,-49000,-49000
046342,聯發科國票92購02,0,0,0,0,0,0,0,0,0,-49000,0,0,0,3000,52000,-49000,-49000
048693,GIS群益94購02   ,0,0,0,0,0,0,0,0,0,-49000,0,0,0,16000,65000,-49000,-49000
049137,華通元大95購02  ,0,0,0,0,0,0,0,0,0,-49000,0,0,0,65000,114000,-49000,-49000
047798,臺股指群益93購09,0,0,0,0,0,0,0,0,0,-49000,0,0,0,66000,115000,-49000,-49000
052113,漢唐中信98購01  ,0,0,0,0,0,0,0,0,0,-49000,0,0,0,0,49000,-49000,-49000
050765,鴻海元大96購02  ,0,0,0,0,0,0,0,0,0,-49000,0,0,0,1084000,1133000,-49000,-49000
050260,鴻海元大94購15  ,0,0,0,0,0,0,0,0,0,-49000,0,0,0,255000,304000,-49000,-49000
049489,美律元大94購05  ,0,0,0,0,0,0,0,0,0,-49000,0,0,0,7000,56000,-49000,-49000
1445,大宇            ,0,49000,-49000,0,0,0,0,0,0,0,0,0,0,0,0,0,-49000
06068P,玉晶光康和97售01,0,0,0,0,0,0,0,0,0,-49000,0,0,0,51000,100000,-49000,-49000
05930P,景碩康和96售01  ,0,0,0,0,0,0,0,0,0,-49000,0,0,0,0,49000,-49000,-49000
8996,高力            ,238000,297000,-59000,0,0,0,0,0,0,10000,10000,0,10000,0,0,0,-49000
6152,百一            ,4000,52000,-48000,0,0,0,0,0,0,-1000,0,1000,-1000,0,0,0,-49000
054632,緯穎凱基9A購01  ,0,0,0,0,0,0,0,0,0,-50000,0,0,0,0,50000,-50000,-50000
054750,聯茂凱基98購02  ,0,0,0,0,0,0,0,0,0,-50000,0,0,0,0,50000,-50000,-50000
054387,台積電統一98購02,0,0,0,0,0,0,0,0,0,-50000,0,0,0,129000,179000,-50000,-50000
054312,TPK凱基98購01   ,0,0,0,0,0,0,0,0,0,-50000,0,0,0,0,50000,-50000,-50000
053750,致伸永豐96購02  ,0,0,0,0,0,0,0,0,0,-50000,0,0,0,0,50000,-50000,-50000
053798,台積電中信98購02,0,0,0,0,0,0,0,0,0,-50000,0,0,0,0,50000,-50000,-50000
053726,TPK凱基96購02   ,0,0,0,0,0,0,0,0,0,-50000,0,0,0,0,50000,-50000,-50000
053716,京元電凱基97購01,0,0,0,0,0,0,0,0,0,-50000,0,0,0,0,50000,-50000,-50000
053598,日月光元大96購04,0,0,0,0,0,0,0,0,0,-50000,0,0,0,0,50000,-50000,-50000
054052,日月光元大96購06,0,0,0,0,0,0,0,0,0,-50000,0,0,0,12000,62000,-50000,-50000
054162,光罩凱基98購01  ,0,0,0,0,0,0,0,0,0,-50000,0,0,0,0,50000,-50000,-50000
053922,亞光國票96購01  ,0,0,0,0,0,0,0,0,0,-50000,0,0,0,0,50000,-50000,-50000
053930,S&P反1統一98購01,0,0,0,0,0,0,0,0,0,-50000,0,0,0,10000,60000,-50000,-50000
052282,宏達電凱基95購05,0,0,0,0,0,0,0,0,0,-50000,0,0,0,6000,56000,-50000,-50000
052367,聯茂國票96購02  ,0,0,0,0,0,0,0,0,0,-50000,0,0,0,0,50000,-50000,-50000
05243P,鴻海元大95售19  ,0,0,0,0,0,0,0,0,0,-50000,0,0,0,334000,384000,-50000,-50000
052465,聯詠統一95購02  ,0,0,0,0,0,0,0,0,0,-50000,0,0,0,40000,90000,-50000,-50000
052780,玉晶光國票96購04,0,0,0,0,0,0,0,0,0,-50000,0,0,0,0,50000,-50000,-50000
052867,晶技凱基96購01  ,0,0,0,0,0,0,0,0,0,-50000,0,0,0,0,50000,-50000,-50000
053246,聯詠國票97購02  ,0,0,0,0,0,0,0,0,0,-50000,0,0,0,23000,73000,-50000,-50000
053063,力山群益98購01  ,0,0,0,0,0,0,0,0,0,-50000,0,0,0,0,50000,-50000,-50000
052982,鴻海元大97購06  ,0,0,0,0,0,0,0,0,0,-50000,0,0,0,101000,151000,-50000,-50000
047729,聯茂群益93購02  ,0,0,0,0,0,0,0,0,0,-50000,0,0,0,0,50000,-50000,-50000
048217,亞德客凱基93購06,0,0,0,0,0,0,0,0,0,-50000,0,0,0,0,50000,-50000,-50000
044173,矽創元大92購02  ,0,0,0,0,0,0,0,0,0,-50000,0,0,0,0,50000,-50000,-50000
045558,冠德國票92購01  ,0,0,0,0,0,0,0,0,0,-50000,0,0,0,60000,110000,-50000,-50000
045478,世紀鋼元大93購02,0,0,0,0,0,0,0,0,0,-50000,0,0,0,0,50000,-50000,-50000
04548P,大立光元大94售14,0,0,0,0,0,0,0,0,0,-50000,0,0,0,0,50000,-50000,-50000
045512,訊芯凱基92購01  ,0,0,0,0,0,0,0,0,0,-50000,0,0,0,0,50000,-50000,-50000
044003,聯發科兆豐93購01,0,0,0,0,0,0,0,0,0,-50000,0,0,0,1000,51000,-50000,-50000
043940,京元電兆豐92購01,0,0,0,0,0,0,0,0,0,-50000,0,0,0,0,50000,-50000,-50000
045283,上銀永豐92購01  ,0,0,0,0,0,0,0,0,0,-50000,0,0,0,0,50000,-50000,-50000
044873,聯詠統一91購02  ,0,0,0,0,0,0,0,0,0,-50000,0,0,0,10000,60000,-50000,-50000
044900,建準凱基93購01  ,0,0,0,0,0,0,0,0,0,-50000,0,0,0,0,50000,-50000,-50000
044708,臻鼎元大91購03  ,0,0,0,0,0,0,0,0,0,-50000,0,0,0,0,50000,-50000,-50000
044718,宏達電統一93購02,0,0,0,0,0,0,0,0,0,-50000,0,0,0,0,50000,-50000,-50000
044640,力成元富91購01  ,0,0,0,0,0,0,0,0,0,-50000,0,0,0,0,50000,-50000,-50000
044459,康控國票91購04  ,0,0,0,0,0,0,0,0,0,-50000,0,0,0,0,50000,-50000,-50000
043493,日月光統一91購01,0,0,0,0,0,0,0,0,0,-50000,0,0,0,0,50000,-50000,-50000
044355,景碩元大91購02  ,0,0,0,0,0,0,0,0,0,-50000,0,0,0,0,50000,-50000,-50000
04253P,聯發科元富93售01,0,0,0,0,0,0,0,0,0,-50000,0,0,0,299000,349000,-50000,-50000
03344P,台積電元富08售15,0,0,0,0,0,0,0,0,0,-50000,0,0,0,0,50000,-50000,-50000
03247P,聯電元富03售02  ,0,0,0,0,0,0,0,0,0,-50000,0,0,0,20000,70000,-50000,-50000
03715P,元油2X永豐93售03,0,0,0,0,0,0,0,0,0,-50000,0,0,0,0,50000,-50000,-50000
047829,旺宏元大93購06  ,0,0,0,0,0,0,0,0,0,-50000,0,0,0,47000,97000,-50000,-50000
048428,滬深2X國票93購05,0,0,0,0,0,0,0,0,0,-50000,0,0,0,70000,120000,-50000,-50000
048437,義隆麥證93購01  ,0,0,0,0,50000,-50000,0,0,0,-50000,0,0,0,0,50000,-50000,-50000
048474,嘉聯益永豐93購03,0,0,0,0,0,0,0,0,0,-50000,0,0,0,0,50000,-50000,-50000
046362,華通永豐92購02  ,0,0,0,0,0,0,0,0,0,-50000,0,0,0,0,50000,-50000,-50000
046698,致伸凱基93購01  ,0,0,0,0,0,0,0,0,0,-50000,0,0,0,0,50000,-50000,-50000
046590,同欣電元大92購02,0,0,0,0,0,0,0,0,0,-50000,0,0,0,10000,60000,-50000,-50000
048771,嘉澤凱基94購01  ,0,0,0,0,0,0,0,0,0,-50000,0,0,0,11000,61000,-50000,-50000
04646P,TPK凱基94售03   ,0,0,0,0,0,0,0,0,0,-50000,0,0,0,0,50000,-50000,-50000
048595,儒鴻國票96購01  ,0,0,0,0,0,0,0,0,0,-50000,0,0,0,0,50000,-50000,-50000
048592,漢唐群益93購04  ,0,0,0,0,0,0,0,0,0,-50000,0,0,0,20000,70000,-50000,-50000
046045,聯茂元大92購07  ,0,0,0,0,0,0,0,0,0,-50000,0,0,0,0,50000,-50000,-50000
047410,上銀元富96購01  ,0,0,0,0,0,0,0,0,0,-50000,0,0,0,0,50000,-50000,-50000
048048,大立光永豐93購03,0,0,0,0,0,0,0,0,0,-50000,0,0,0,0,50000,-50000,-50000
048019,GIS麥證94購01   ,0,0,0,30000,80000,-50000,0,0,0,-50000,0,0,0,30000,80000,-50000,-50000
046188,京元電凱基92購06,0,0,0,0,0,0,0,0,0,-50000,0,0,0,0,50000,-50000,-50000
049101,聯詠國泰95購01  ,0,0,0,0,0,0,0,0,0,-50000,0,0,0,40000,90000,-50000,-50000
049036,燿華兆豐95購01  ,0,0,0,0,0,0,0,0,0,-50000,0,0,0,0,50000,-50000,-50000
049339,鴻海統一94購02  ,0,0,0,0,0,0,0,0,0,-50000,0,0,0,0,50000,-50000,-50000
049209,GIS群益94購03   ,0,0,0,0,0,0,0,0,0,-50000,0,0,0,0,50000,-50000,-50000
049365,美律元大94購04  ,0,0,0,0,0,0,0,0,0,-50000,0,0,0,0,50000,-50000,-50000
049262,大立光元大94購09,0,0,0,0,0,0,0,0,0,-50000,0,0,0,0,50000,-50000,-50000
049930,上海銀元大94購02,0,0,0,0,0,0,-50000,0,0,0,18000,68000,-50000,-50000,,,
04757P,元油2X凱基94售04,0,0,0,0,0,0,0,0,0,-50000,0,0,0,0,50000,-50000,-50000
048695,滬深2X國票95購03,0,0,0,0,0,0,0,0,0,-50000,0,0,0,0,50000,-50000,-50000
048792,瑞儀元大94購01  ,0,0,0,0,0,0,0,0,0,-50000,0,0,0,30000,80000,-50000,-50000
04714P,上海銀元大94售01,0,0,0,0,0,0,0,0,0,-50000,0,0,0,0,50000,-50000,-50000
048142,聯電統一93購01  ,0,0,0,0,0,0,0,0,0,-50000,0,0,0,0,50000,-50000,-50000
047270,元油2X永豐94購02,0,0,0,0,0,0,0,0,0,-50000,0,0,0,1000,51000,-50000,-50000
049491,聯發科元大95購01,0,0,0,0,0,0,0,0,0,-50000,0,0,0,8000,58000,-50000,-50000
050099,台積電永昌96購01,0,0,0,0,0,0,0,0,0,-50000,0,0,0,0,50000,-50000,-50000
050195,上海銀元大94購03,0,0,0,0,0,0,0,0,0,-50000,0,0,0,0,50000,-50000,-50000
049788,智伸科兆豐95購01,0,0,0,0,0,0,0,0,0,-50000,0,0,0,0,50000,-50000,-50000
049825,台積電凱基94購26,0,0,0,0,0,0,0,0,0,-50000,0,0,0,10000,60000,-50000,-50000
050417,喬山凱基94購01  ,0,0,0,0,0,0,0,0,0,-50000,0,0,0,0,50000,-50000,-50000
050855,華通台新95購01  ,0,0,0,0,0,0,0,0,0,-50000,0,0,0,0,50000,-50000,-50000
050817,可成凱基95購01  ,0,0,0,0,0,0,0,0,0,-50000,0,0,0,0,50000,-50000,-50000
052112,滬深2X中信99購01,0,0,0,0,0,0,0,0,0,-50000,0,0,0,0,50000,-50000,-50000
051940,康舒群益95購01  ,0,0,0,0,0,0,0,0,0,-50000,0,0,0,0,50000,-50000,-50000
051862,旺宏凱基95購05  ,0,0,0,0,0,0,0,0,0,-50000,0,0,0,64000,114000,-50000,-50000
051676,康舒元大95購01  ,0,0,0,0,0,0,0,0,0,-50000,0,0,0,14000,64000,-50000,-50000
051645,光寶科永豐95購01,0,0,0,0,0,0,0,0,0,-50000,0,0,0,0,50000,-50000,-50000
05146P,鴻海元大95售10  ,0,0,0,0,0,0,0,0,0,-50000,0,0,0,231000,281000,-50000,-50000
051387,新光金麥證96購01,0,0,0,20000,70000,-50000,0,0,0,-50000,0,0,0,20000,70000,-50000,-50000
051287,台積電統一95購05,0,0,0,0,0,0,0,0,0,-50000,0,0,0,235000,285000,-50000,-50000
051025,晶華統一95購01  ,0,0,0,0,0,0,0,0,0,-50000,0,0,0,0,50000,-50000,-50000
051072,強茂國票95購02  ,0,0,0,0,0,0,0,0,0,-50000,0,0,0,4000,54000,-50000,-50000
06082P,華通統一98售01  ,0,0,0,0,0,0,0,0,0,-50000,0,0,0,20000,70000,-50000,-50000
08865P,欣興元大01售02  ,0,0,0,0,0,0,0,0,0,-50000,0,0,0,0,50000,-50000,-50000
3454,晶睿            ,10000,60000,-50000,0,0,0,0,0,0,0,0,0,0,0,0,0,-50000
05307P,光寶科中信95售01,0,0,0,0,0,0,0,0,0,-51000,0,0,0,0,51000,-51000,-51000
052319,可成元大95購12  ,0,0,0,0,0,0,0,0,0,-51000,0,0,0,407000,458000,-51000,-51000
053659,智原凱基97購01  ,0,0,0,0,0,0,0,0,0,-51000,0,0,0,0,51000,-51000,-51000
053713,漢唐凱基96購04  ,0,0,0,0,0,0,0,0,0,-51000,0,0,0,0,51000,-51000,-51000
054400,健策永豐96購02  ,0,0,0,0,0,0,0,0,0,-51000,0,0,0,0,51000,-51000,-51000
03945P,欣興群益94售01  ,0,0,0,0,0,0,0,0,0,-51000,0,0,0,80000,131000,-51000,-51000
04296P,技嘉元大93售01  ,0,0,0,0,0,0,0,0,0,-51000,0,0,0,59000,110000,-51000,-51000
04318P,大成鋼永豐93售02,0,0,0,0,0,0,0,0,0,-51000,0,0,0,49000,100000,-51000,-51000
048931,晶華永豐94購01  ,0,0,0,0,0,0,0,0,0,-51000,0,0,0,9000,60000,-51000,-51000
04871P,力成元富94售02  ,0,0,0,0,0,0,0,0,0,-51000,0,0,0,0,51000,-51000,-51000
04760P,旺宏凱基94售02  ,0,0,0,0,0,0,0,0,0,-51000,0,0,0,42000,93000,-51000,-51000
049032,百和群益94購04  ,0,0,0,0,0,0,0,0,0,-51000,0,0,0,111000,162000,-51000,-51000
046162,致新群益92購01  ,0,0,0,0,0,0,0,0,0,-51000,0,0,0,39000,90000,-51000,-51000
051567,台積電富邦95購06,0,0,0,0,0,0,0,0,0,-51000,0,0,0,1000,52000,-51000,-51000
050147,為升永豐94購01  ,0,0,0,0,0,0,0,0,0,-51000,0,0,0,2000,53000,-51000,-51000
050087,美食台新94購01  ,0,0,0,0,0,0,0,0,0,-51000,0,0,0,0,51000,-51000,-51000
3052,夆典            ,37000,90000,-53000,0,0,0,0,0,0,2000,2000,0,2000,0,0,0,-51000
3041,揚智            ,43000,94000,-51000,0,0,0,0,0,0,0,0,0,0,0,0,0,-51000
05402P,台郡永豐95售02  ,0,0,0,0,0,0,0,0,0,-52000,0,0,0,286000,338000,-52000,-52000
052380,臺股指元大95購21,0,0,0,0,0,0,0,0,0,-52000,0,0,0,0,52000,-52000,-52000
052255,T50反1國泰96購01,0,0,0,0,0,0,0,0,0,-52000,0,0,0,48000,100000,-52000,-52000
052567,台積電凱基96購05,0,0,0,0,0,0,0,0,0,-52000,0,0,0,161000,213000,-52000,-52000
052759,京元電群益96購01,0,0,0,0,0,0,0,0,0,-52000,0,0,0,152000,204000,-52000,-52000
053166,聯詠群益96購02  ,0,0,0,0,0,0,0,0,0,-52000,0,0,0,0,52000,-52000,-52000
053548,旺宏凱基96購04  ,0,0,0,0,0,0,0,0,0,-52000,0,0,0,86000,138000,-52000,-52000
053335,易華電永豐96購01,0,0,0,0,0,0,0,0,0,-52000,0,0,0,0,52000,-52000,-52000
04256P,美律國票93售03  ,0,0,0,0,0,0,0,0,0,-52000,0,0,0,12000,64000,-52000,-52000
046242,大立光中信93購02,0,0,0,0,0,0,0,0,0,-52000,0,0,0,0,52000,-52000,-52000
047389,義隆元大94購01  ,0,0,0,0,0,0,0,0,0,-52000,0,0,0,0,52000,-52000,-52000
049922,禾伸堂元大95購01,0,0,0,0,0,0,0,0,0,-52000,0,0,0,482000,534000,-52000,-52000
052099,臺股指富邦95購02,0,0,0,0,0,0,0,0,0,-52000,0,0,0,10000,62000,-52000,-52000
052164,啟碁永豐95購01  ,0,0,0,0,0,0,0,0,0,-52000,0,0,0,17000,69000,-52000,-52000
051211,道瓊反統一95購01,0,0,0,0,0,0,0,0,0,-52000,0,0,0,1000,53000,-52000,-52000
051437,百和元富95購02  ,0,0,0,0,0,0,0,0,0,-52000,0,0,0,28000,80000,-52000,-52000
06030P,友達兆豐96售02  ,0,0,0,0,0,0,0,0,0,-52000,0,0,0,96000,148000,-52000,-52000
6504,南六            ,6000,58000,-52000,0,0,0,0,0,0,0,0,0,0,0,0,0,-52000
053407,台積電兆豐96購02,0,0,0,0,0,0,0,0,0,-53000,0,0,0,6000,59000,-53000,-53000
052432,康友永豐95購04  ,0,0,0,0,0,0,0,0,0,-53000,0,0,0,98000,151000,-53000,-53000
052339,光寶科凱基95購01,0,0,0,0,0,0,0,0,0,-53000,0,0,0,0,53000,-53000,-53000
054277,亞光群益97購01  ,0,0,0,0,0,0,0,0,0,-53000,0,0,0,4000,57000,-53000,-53000
054697,凌華永豐97購01  ,0,0,0,0,0,0,0,0,0,-53000,0,0,0,101000,154000,-53000,-53000
045570,元油2X元大92購02,0,0,0,0,0,0,0,0,0,-53000,0,0,0,0,53000,-53000,-53000
040745,滬深2X群益92購01,0,0,0,0,0,0,0,0,0,-53000,0,0,0,2000,55000,-53000,-53000
03564P,為升群益02售02  ,0,0,0,0,0,0,0,0,0,-53000,0,0,0,130000,183000,-53000,-53000
048671,大立光永豐93購04,0,0,0,0,0,0,0,0,0,-53000,0,0,0,0,53000,-53000,-53000
045871,元油2X元富96購03,0,0,0,0,0,0,0,0,0,-53000,0,0,0,147000,200000,-53000,-53000
050242,義隆凱基94購04  ,0,0,0,0,0,0,0,0,0,-53000,0,0,0,0,53000,-53000,-53000
050211,貿聯國票95購01  ,0,0,0,0,0,0,0,0,0,-53000,0,0,0,25000,78000,-53000,-53000
06076P,大立光凱基98售03,0,0,0,0,0,0,0,0,0,-53000,0,0,0,50000,103000,-53000,-53000
1451,年興            ,8000,61000,-53000,0,0,0,0,0,0,0,0,0,0,0,0,0,-53000
052693,微星中信96購01  ,0,0,0,0,0,0,0,0,0,-54000,0,0,0,0,54000,-54000,-54000
053002,鴻海永豐96購01  ,0,0,0,0,0,0,0,0,0,-54000,0,0,0,19000,73000,-54000,-54000
00675L,富邦臺灣加權正2 ,0,0,0,0,0,0,0,0,0,-54000,0,0,0,4000,58000,-54000,-54000
039900,上証2X國泰92購01,0,0,0,0,0,0,0,0,0,-54000,0,0,0,97000,151000,-54000,-54000
03283P,台灣50群益03售03,0,0,0,0,0,0,0,0,0,-54000,0,0,0,86000,140000,-54000,-54000
042143,奇鋐元大92購01  ,0,0,0,0,0,0,-54000,0,0,0,48000,102000,-54000,-54000,,,
044465,元油2X群益97購01,0,0,0,0,0,0,0,0,0,-54000,0,0,0,0,54000,-54000,-54000
04528P,智原凱基94售01  ,0,0,0,0,0,0,0,0,0,-54000,0,0,0,116000,170000,-54000,-54000
045019,臺股指元大92購13,0,0,0,0,0,0,0,0,0,-54000,0,0,0,6000,60000,-54000,-54000
045715,華邦電凱基92購04,0,0,0,0,0,0,0,0,0,-54000,0,0,0,46000,100000,-54000,-54000
046827,漢唐群益93購02  ,0,0,0,0,0,0,0,0,0,-54000,0,0,0,28000,82000,-54000,-54000
046756,廣達凱基93購01  ,0,0,0,0,0,0,0,0,0,-54000,0,0,0,0,54000,-54000,-54000
04608P,晶相光永豐94售02,0,0,0,0,0,0,0,0,0,-54000,0,0,0,180000,234000,-54000,-54000
049128,滬深2X元大97購03,0,0,0,0,0,0,0,0,0,-54000,0,0,0,52000,106000,-54000,-54000
049250,華通元大95購04  ,0,0,0,0,0,0,0,0,0,-54000,0,0,0,184000,238000,-54000,-54000
05049P,矽創永豐95售01  ,0,0,0,0,0,0,0,0,0,-54000,0,0,0,427000,481000,-54000,-54000
050613,台光電元大94購09,0,0,0,0,0,0,0,0,0,-54000,0,0,0,167000,221000,-54000,-54000
049787,麗豐兆豐94購01  ,0,0,0,0,0,0,0,0,0,-54000,0,0,0,0,54000,-54000,-54000
051182,旺宏永豐95購01  ,0,0,0,0,0,0,0,0,0,-54000,0,0,0,147000,201000,-54000,-54000
2485,兆赫            ,33000,150000,-117000,0,0,0,0,0,0,63000,4000,14000,-10000,73000,0,73000,-54000
6112,聚碩            ,27000,81000,-54000,0,0,0,0,0,0,0,0,0,0,0,0,0,-54000
1444,力麗            ,58000,112780,-54780,0,0,0,0,0,0,0,0,0,0,0,0,0,-54780
6505,台塑化          ,1735000,1972831,-237831,0,0,0,242000,0,242000,-59000,60000,119000,-59000,0,0,0,-54831
053583,漢唐元大96購03  ,0,0,0,0,0,0,0,0,0,-55000,0,0,0,0,55000,-55000,-55000
053442,光罩凱基96購01  ,0,0,0,0,0,0,0,0,0,-55000,0,0,0,0,55000,-55000,-55000
054487,京元電台新97購01,0,0,0,0,0,0,0,0,0,-55000,0,0,0,8000,63000,-55000,-55000
045450,元油2X富邦93購04,0,0,0,0,0,0,0,0,0,-55000,0,0,0,0,55000,-55000,-55000
043647,台積電國票92購01,0,0,0,0,0,0,0,0,0,-55000,0,0,0,110000,165000,-55000,-55000
04325P,創意元大93售06  ,0,0,0,0,0,0,0,0,0,-55000,0,0,0,0,55000,-55000,-55000
04003P,麗豐凱基94售03  ,0,0,0,0,0,0,0,0,0,-55000,0,0,0,10000,65000,-55000,-55000
049246,大成鋼元大94購02,0,0,0,0,0,0,0,0,0,-55000,0,0,0,9000,64000,-55000,-55000
049170,亞德客凱基94購01,0,0,0,0,0,0,0,0,0,-55000,0,0,0,36000,91000,-55000,-55000
047277,晶技永豐93購01  ,0,0,0,0,0,0,0,0,0,-55000,0,0,0,0,55000,-55000,-55000
052006,康友富邦98購01  ,0,0,0,0,0,0,0,0,0,-55000,0,0,0,319000,374000,-55000,-55000
049980,奇力新凱基94購04,0,0,0,0,0,0,0,0,0,-55000,0,0,0,0,55000,-55000,-55000
050158,上海銀群益96購01,0,0,0,0,0,0,0,0,0,-55000,0,0,0,98000,153000,-55000,-55000
049778,宏達電統一94購02,0,0,0,0,0,0,0,0,0,-55000,0,0,0,0,55000,-55000,-55000
050653,聯鈞凱基96購01  ,0,0,0,0,0,0,0,0,0,-55000,0,0,0,37000,92000,-55000,-55000
05708P,奇力新國票97售04,0,0,0,0,0,0,0,0,0,-55000,0,0,0,10000,65000,-55000,-55000
054324,美律台新97購01  ,0,0,0,0,0,0,0,0,0,-56000,0,0,0,81000,137000,-56000,-56000
045263,高鐵凱基92購01  ,0,0,0,0,0,0,0,0,0,-56000,0,0,0,0,56000,-56000,-56000
045119,美律元大92購06  ,0,0,0,0,0,0,0,0,0,-56000,0,0,0,0,56000,-56000,-56000
044963,台積電中信96購01,0,0,0,0,0,0,0,0,0,-56000,0,0,0,10000,66000,-56000,-56000
04430P,晶相光元大94售04,0,0,0,0,0,0,0,0,0,-56000,0,0,0,145000,201000,-56000,-56000
048134,祥碩國票93購02  ,0,0,0,0,0,0,0,0,0,-56000,0,0,0,0,56000,-56000,-56000
046113,旺宏元大93購04  ,0,0,0,0,0,0,0,0,0,-56000,0,0,0,5000,61000,-56000,-56000
050393,樺漢統一94購01  ,0,0,0,0,0,0,0,0,0,-56000,0,0,0,56000,112000,-56000,-56000
049622,聯詠群益94購02  ,0,0,0,0,0,0,0,0,0,-56000,0,0,0,38000,94000,-56000,-56000
049569,光磊統一94購02  ,0,0,0,0,0,0,0,0,0,-56000,0,0,0,20000,76000,-56000,-56000
050024,旺宏元大94購09  ,0,0,0,0,0,0,0,0,0,-56000,0,0,0,136000,192000,-56000,-56000
049847,旺宏群益94購04  ,0,0,0,0,0,0,0,0,0,-56000,0,0,0,5000,61000,-56000,-56000
04987P,昇陽半永豐94售04,0,0,0,0,0,0,0,0,0,-56000,0,0,0,100000,156000,-56000,-56000
052060,旺宏國票96購02  ,0,0,0,0,0,0,0,0,0,-56000,0,0,0,1000,57000,-56000,-56000
051404,牧德永豐96購01  ,0,0,0,0,0,0,0,0,0,-56000,0,0,0,90000,146000,-56000,-56000
051411,聯發科國票95購05,0,0,0,0,0,0,0,0,0,-56000,0,0,0,15000,71000,-56000,-56000
051380,禾伸堂群益95購01,0,0,0,0,0,0,0,0,0,-56000,0,0,0,203000,259000,-56000,-56000
1460,宏遠            ,16000,72000,-56000,0,0,0,0,0,0,0,0,0,0,0,0,0,-56000
2453,凌群            ,32000,88000,-56000,0,0,0,0,0,0,0,0,0,0,0,0,0,-56000
3443,創意            ,52000,84000,-32000,0,0,0,5000,0,5000,-29000,16000,37000,-21000,6000,14000,-8000,-56000
4119,旭富            ,48000,121000,-73000,0,0,0,0,0,0,17000,25000,0,25000,0,8000,-8000,-56000
054049,亞光元大96購03  ,0,0,0,0,0,0,0,0,0,-57000,0,0,0,9000,66000,-57000,-57000
053460,緯穎國泰97購01  ,0,0,0,0,0,0,0,0,0,-57000,0,0,0,123000,180000,-57000,-57000
053507,百和兆豐96購01  ,0,0,0,0,0,0,0,0,0,-57000,0,0,0,41000,98000,-57000,-57000
05315P,鴻海永昌96售08  ,0,0,0,0,0,0,0,0,0,-57000,0,0,0,0,57000,-57000,-57000
052313,聯電元大98購01  ,0,0,0,0,0,0,0,0,0,-57000,0,0,0,15000,72000,-57000,-57000
043879,貿聯元大92購01  ,0,0,0,0,0,0,0,0,0,-57000,0,0,0,0,57000,-57000,-57000
045433,康友永豐92購01  ,0,0,0,0,0,0,0,0,0,-57000,0,0,0,151000,208000,-57000,-57000
03644C,臺股指元大94牛28,0,0,0,0,0,0,0,0,0,-57000,0,0,0,0,57000,-57000,-57000
046789,祥碩永豐93購01  ,0,0,0,0,0,0,0,0,0,-57000,0,0,0,0,57000,-57000,-57000
047021,台光電元大93購03,0,0,0,0,0,0,0,0,0,-57000,0,0,0,11000,68000,-57000,-57000
046561,可成凱基92購11  ,0,0,0,0,0,0,0,0,0,-57000,0,0,0,0,57000,-57000,-57000
051065,台積電國票96購01,0,0,0,0,0,0,0,0,0,-57000,0,0,0,40000,97000,-57000,-57000
049842,道瓊反中信98購01,0,0,0,0,0,0,0,0,0,-57000,0,0,0,13000,70000,-57000,-57000
05947P,大成鋼元大96售03,0,0,0,0,0,0,0,0,0,-57000,0,0,0,75000,132000,-57000,-57000
6224,聚鼎            ,48000,105000,-57000,0,0,0,0,0,0,0,0,0,0,0,0,0,-57000
052334,大成鋼日盛95購01,0,0,0,0,0,0,0,0,0,-58000,0,0,0,0,58000,-58000,-58000
052749,日月光元大96購02,0,0,0,0,0,0,0,0,0,-58000,0,0,0,0,58000,-58000,-58000
052674,智邦國泰98購01  ,0,0,0,0,0,0,0,0,0,-58000,0,0,0,53000,111000,-58000,-58000
052823,創意永豐96購02  ,0,0,0,0,0,0,0,0,0,-58000,0,0,0,12000,70000,-58000,-58000
053225,昇陽半凱基96購01,0,0,0,0,0,0,0,0,0,-58000,0,0,0,10000,68000,-58000,-58000
053426,創意永豐96購04  ,0,0,0,0,0,0,0,0,0,-58000,0,0,0,5000,63000,-58000,-58000
053304,可成凱基96購03  ,0,0,0,0,0,0,0,0,0,-58000,0,0,0,25000,83000,-58000,-58000
053851,鴻海國泰98購03  ,0,0,0,0,0,0,0,0,0,-58000,0,0,0,147000,205000,-58000,-58000
054526,道瓊反統一98購01,0,0,0,0,0,0,0,0,0,-58000,0,0,0,0,58000,-58000,-58000
04176P,台達電元大94售01,0,0,0,0,0,0,0,0,0,-58000,0,0,0,150000,208000,-58000,-58000
042548,新光金元大91購01,0,0,0,0,0,0,0,0,0,-58000,0,0,0,0,58000,-58000,-58000
044764,聯茂凱基93購03  ,0,0,0,0,0,0,0,0,0,-58000,0,0,0,10000,68000,-58000,-58000
044134,訊芯凱基93購01  ,0,0,0,0,0,0,0,0,0,-58000,0,0,0,29000,87000,-58000,-58000
046696,可成凱基93購02  ,0,0,0,0,0,0,0,0,0,-58000,0,0,0,10000,68000,-58000,-58000
047908,南亞科元大93購02,0,0,0,0,0,0,0,0,0,-58000,0,0,0,22000,80000,-58000,-58000
048032,可成凱基93購13  ,0,0,0,0,0,0,0,0,0,-58000,0,0,0,10000,68000,-58000,-58000
047141,宏達電兆豐94購01,0,0,0,0,0,0,0,0,0,-58000,0,0,0,50000,108000,-58000,-58000
047498,力成康和93購01  ,0,0,0,0,0,0,0,0,0,-58000,0,0,0,12000,70000,-58000,-58000
048653,巨大元大96購02  ,0,0,0,0,0,0,0,0,0,-58000,0,0,0,42000,100000,-58000,-58000
050992,台積電元大97購01,0,0,0,0,0,0,0,0,0,-58000,0,0,0,5000,63000,-58000,-58000
051991,泰碩元大95購02  ,0,0,0,0,0,0,0,0,0,-58000,0,0,0,40000,98000,-58000,-58000
051923,聯發科日盛95購02,0,0,0,0,0,0,0,0,0,-58000,0,0,0,0,58000,-58000,-58000
6155,鈞寶            ,158000,216000,-58000,0,0,0,0,0,0,0,0,0,0,0,0,0,-58000
2399,映泰            ,120000,178000,-58000,0,0,0,0,0,0,0,0,0,0,0,0,0,-58000
1733,五鼎            ,28000,88000,-60000,0,0,0,0,0,0,2000,4000,2000,2000,0,0,0,-58000
054633,臺股指凱基9A購02,0,0,0,0,0,0,0,0,0,-59000,0,0,0,0,59000,-59000,-59000
054672,華新科國泰99購01,0,0,0,0,0,0,0,0,0,-59000,0,0,0,6000,65000,-59000,-59000
054271,中石化中信99購01,0,0,0,0,0,0,0,0,0,-59000,0,0,0,10000,69000,-59000,-59000
054236,貿聯群益96購01  ,0,0,0,0,0,0,0,0,0,-59000,0,0,0,4000,63000,-59000,-59000
054501,強茂永豐96購02  ,0,0,0,0,0,0,0,0,0,-59000,0,0,0,0,59000,-59000,-59000
053694,創意元大96購03  ,0,0,0,0,0,0,0,0,0,-59000,0,0,0,17000,76000,-59000,-59000
043757,欣興元大93購01  ,0,0,0,0,0,0,0,0,0,-59000,0,0,0,0,59000,-59000,-59000
045271,元油2X統一93購01,0,0,0,0,0,0,0,0,0,-59000,0,0,0,0,59000,-59000,-59000
04008P,京元電國票93售01,0,0,0,0,0,0,0,0,0,-59000,0,0,0,0,59000,-59000,-59000
046800,儒鴻元大93購02  ,0,0,0,0,0,0,0,0,0,-59000,0,0,0,57000,116000,-59000,-59000
05165P,欣興元富95售03  ,0,0,0,0,0,0,0,0,0,-59000,0,0,0,118000,177000,-59000,-59000
050684,台郡元富94購02  ,0,0,0,0,0,0,0,0,0,-59000,0,0,0,34000,93000,-59000,-59000
2467,志聖            ,25000,84000,-59000,0,0,0,0,0,0,0,0,0,0,0,0,0,-59000
3698,隆達            ,64000,170000,-106000,0,0,0,0,0,0,47000,54000,0,54000,0,7000,-7000,-59000
1626,艾美特-KY       ,12000,71000,-59000,0,0,0,0,0,0,0,0,0,0,0,0,0,-59000
1417,嘉裕            ,17000,76000,-59000,0,0,0,0,0,0,0,0,0,0,0,0,0,-59000
053620,臺股指群益96購06,0,0,0,0,0,0,0,0,0,-60000,0,0,0,0,60000,-60000,-60000
054187,亞光永豐96購03  ,0,0,0,0,0,0,0,0,0,-60000,0,0,0,0,60000,-60000,-60000
054301,楠梓電凱基98購01,0,0,0,0,0,0,0,0,0,-60000,0,0,0,40000,100000,-60000,-60000
054645,奇力新群益97購04,0,0,0,0,0,0,0,0,0,-60000,0,0,0,0,60000,-60000,-60000
053413,台積電國票99購01,0,0,0,0,0,0,0,0,0,-60000,0,0,0,2000,62000,-60000,-60000
053362,元油反國泰98購01,0,0,0,0,0,0,0,0,0,-60000,0,0,0,0,60000,-60000,-60000
053185,友達中信99購01  ,0,0,0,0,0,0,0,0,0,-60000,0,0,0,10000,70000,-60000,-60000
053165,大立光群益96購03,0,0,0,0,0,0,0,0,0,-60000,0,0,0,28000,88000,-60000,-60000
052929,可成元大96購02  ,0,0,0,0,0,0,0,0,0,-60000,0,0,0,101000,161000,-60000,-60000
052831,華固群益96購01  ,0,0,0,0,0,0,0,0,0,-60000,0,0,0,0,60000,-60000,-60000
052868,緯創凱基96購03  ,0,0,0,0,0,0,0,0,0,-60000,0,0,0,8000,68000,-60000,-60000
03404B,臺股指元富91熊09,0,0,0,0,0,0,0,0,0,-60000,0,0,0,0,60000,-60000,-60000
03412P,滬深2X群益98售01,0,0,0,0,0,0,0,0,0,-60000,0,0,0,0,60000,-60000,-60000
03864P,台積電元大93售15,0,0,0,0,0,0,0,0,0,-60000,0,0,0,0,60000,-60000,-60000
03591P,台積電國票03售10,0,0,0,0,0,0,0,0,0,-60000,0,0,0,0,60000,-60000,-60000
03127P,台表科凱基01售03,0,0,0,0,0,0,0,0,0,-60000,0,0,0,0,60000,-60000,-60000
04261P,大立光群益93售12,0,0,0,0,0,0,0,0,0,-60000,0,0,0,40000,100000,-60000,-60000
044563,亞德客凱基92購01,0,0,0,0,0,0,0,0,0,-60000,0,0,0,0,60000,-60000,-60000
044705,群創元大93購03  ,0,0,0,0,0,0,0,0,0,-60000,0,0,0,43000,103000,-60000,-60000
045734,全新國票93購01  ,0,0,0,0,0,0,0,0,0,-60000,0,0,0,0,60000,-60000,-60000
044129,群創凱基93購02  ,0,0,0,0,0,0,0,0,0,-60000,0,0,0,10000,70000,-60000,-60000
048324,訊芯凱基93購03  ,0,0,0,0,0,0,0,0,0,-60000,0,0,0,2000,62000,-60000,-60000
046858,群創元大94購02  ,0,0,0,0,0,0,0,0,0,-60000,0,0,0,0,60000,-60000,-60000
046896,臻鼎群益94購01  ,0,0,0,0,0,0,0,0,0,-60000,0,0,0,170000,230000,-60000,-60000
046010,大立光元富92購03,0,0,0,0,0,0,0,0,0,-60000,0,0,0,10000,70000,-60000,-60000
048053,美利達中信93購01,0,0,0,0,0,0,0,0,0,-60000,0,0,0,0,60000,-60000,-60000
048079,燿華日盛93購01  ,0,0,0,0,0,0,0,0,0,-60000,0,0,0,0,60000,-60000,-60000
046628,大立光統一98購01,0,0,0,0,0,0,0,0,0,-60000,0,0,0,0,60000,-60000,-60000
04863P,技嘉元大94售02  ,0,0,0,0,0,0,0,0,0,-60000,0,0,0,50000,110000,-60000,-60000
047864,信邦康和93購01  ,0,0,0,0,0,0,0,0,0,-60000,0,0,0,0,60000,-60000,-60000
048698,宏達電國票95購01,0,0,0,0,0,0,0,0,0,-60000,0,0,0,0,60000,-60000,-60000
048126,TPK元大94購02   ,0,0,0,0,0,0,0,0,0,-60000,0,0,0,0,60000,-60000,-60000
049388,南電元大94購05  ,0,0,0,0,0,0,0,0,0,-60000,0,0,0,0,60000,-60000,-60000
047640,聯發科元大93購17,0,0,0,0,0,0,0,0,0,-60000,0,0,0,2000,62000,-60000,-60000
047325,材料元大93購01  ,0,0,0,0,0,0,0,0,0,-60000,0,0,0,0,60000,-60000,-60000
050890,南電富邦99購01  ,0,0,0,0,0,0,0,0,0,-60000,0,0,0,0,60000,-60000,-60000
050273,GIS元大94購04   ,0,0,0,0,0,0,0,0,0,-60000,0,0,0,8000,68000,-60000,-60000
049849,欣興群益94購04  ,0,0,0,0,0,0,0,0,0,-60000,0,0,0,0,60000,-60000,-60000
049884,訊芯永豐94購01  ,0,0,0,0,0,0,0,0,0,-60000,0,0,0,68000,128000,-60000,-60000
050124,元金2X凱基95購01,0,0,0,0,0,0,0,0,0,-60000,0,0,0,0,60000,-60000,-60000
050066,華固凱基94購01  ,0,0,0,0,0,0,0,0,0,-60000,0,0,0,0,60000,-60000,-60000
05007P,旺宏元富95售01  ,0,0,0,0,0,0,0,0,0,-60000,0,0,0,20000,80000,-60000,-60000
051820,道瓊反元富95購01,0,0,0,0,0,0,0,0,0,-60000,0,0,0,0,60000,-60000,-60000
051786,A50正2國票95購02,0,0,0,0,0,0,0,0,0,-60000,0,0,0,0,60000,-60000,-60000
051993,和碩元大95購03  ,0,0,0,0,0,0,0,0,0,-60000,0,0,0,20000,80000,-60000,-60000
052036,臺股指群益95購09,0,0,0,0,0,0,0,0,0,-60000,0,0,0,0,60000,-60000,-60000
051034,正崴兆豐95購01  ,0,0,0,0,0,0,0,0,0,-60000,0,0,0,0,60000,-60000,-60000
051350,台積電元大95購14,0,0,0,0,0,0,0,0,0,-60000,0,0,0,170000,230000,-60000,-60000
06058P,玉晶光凱基97售04,0,0,0,0,0,0,0,0,0,-60000,0,0,0,0,60000,-60000,-60000
01002T,土銀國泰R1      ,3976,64000,-60024,0,0,0,0,0,0,0,0,0,0,0,0,0,-60024
052593,台積電群益96購02,0,0,0,0,0,0,0,0,0,-61000,0,0,0,299000,360000,-61000,-61000
054406,旺宏國票98購01  ,0,0,0,0,0,0,0,0,0,-61000,0,0,0,9000,70000,-61000,-61000
054165,亞光凱基96購02  ,0,0,0,0,0,0,0,0,0,-61000,0,0,0,34000,95000,-61000,-61000
03963P,啟碁康和93售01  ,0,0,0,0,0,0,0,0,0,-61000,0,0,0,38000,99000,-61000,-61000
044632,超眾元大91購03  ,0,0,0,0,0,0,0,0,0,-61000,0,0,0,10000,71000,-61000,-61000
044578,緯創凱基93購02  ,0,0,0,0,0,0,0,0,0,-61000,0,0,0,4000,65000,-61000,-61000
049210,昇陽半群益94購02,0,0,0,0,0,0,0,0,0,-61000,0,0,0,10000,71000,-61000,-61000
049141,旺宏元大95購01  ,0,0,0,0,0,0,0,0,0,-61000,0,0,0,87000,148000,-61000,-61000
048111,奇力新群益93購06,0,0,0,0,0,0,0,0,0,-61000,0,0,0,0,61000,-61000,-61000
047894,大成鋼群益93購01,0,0,0,0,0,0,0,0,0,-61000,0,0,0,50000,111000,-61000,-61000
047030,日月光元大93購02,0,0,0,0,0,0,0,0,0,-61000,0,0,0,0,61000,-61000,-61000
046932,聯詠統一93購02  ,0,0,0,0,0,0,0,0,0,-61000,0,0,0,0,61000,-61000,-61000
051010,美律日盛95購01  ,0,0,0,0,0,0,0,0,0,-61000,0,0,0,37000,98000,-61000,-61000
049875,台積電永豐94購04,0,0,0,0,0,0,0,0,0,-61000,0,0,0,1432000,1493000,-61000,-61000
1455,集盛            ,76000,137000,-61000,0,0,0,0,0,0,0,0,0,0,0,0,0,-61000
05429P,鴻海統一95售16  ,0,0,0,0,0,0,0,0,0,-62000,0,0,0,48000,110000,-62000,-62000
054303,國巨凱基96購15  ,0,0,0,0,0,0,0,0,0,-62000,0,0,0,3000,65000,-62000,-62000
054628,可成凱基98購01  ,0,0,0,0,0,0,0,0,0,-62000,0,0,0,122000,184000,-62000,-62000
054622,漢唐第一97購01  ,0,0,0,0,0,0,0,0,0,-62000,0,0,0,0,62000,-62000,-62000
052909,上銀統一96購01  ,0,0,0,0,0,0,0,0,0,-62000,0,0,0,0,62000,-62000,-62000
052359,百和永豐95購01  ,0,0,0,0,0,0,0,0,0,-62000,0,0,0,53000,115000,-62000,-62000
053089,貿聯元大97購02  ,0,0,0,0,0,0,0,0,0,-62000,0,0,0,34000,96000,-62000,-62000
053183,大立光元富96購03,0,0,0,0,0,0,0,0,0,-62000,0,0,0,58000,120000,-62000,-62000
053359,矽力統一96購02  ,0,0,0,0,0,0,0,0,0,-62000,0,0,0,1000,63000,-62000,-62000
053386,聯詠元大96購03  ,0,0,0,0,0,0,0,0,0,-62000,0,0,0,10000,72000,-62000,-62000
043344,可成富邦93購01  ,0,0,0,0,0,0,0,0,0,-62000,0,0,0,38000,100000,-62000,-62000
047039,晶技群益93購02  ,0,0,0,0,0,0,0,0,0,-62000,0,0,0,3000,65000,-62000,-62000
047036,台光電群益93購02,0,0,0,0,0,0,0,0,0,-62000,0,0,0,0,62000,-62000,-62000
046116,京元電元大92購05,0,0,0,0,0,0,0,0,0,-62000,0,0,0,69000,131000,-62000,-62000
046892,聯發科群益93購04,0,0,0,0,0,0,0,0,0,-62000,0,0,0,551000,613000,-62000,-62000
048484,大立光國泰95購02,0,0,0,0,0,0,0,0,0,-62000,0,0,0,13000,75000,-62000,-62000
049978,瑞昱凱基94購04  ,0,0,0,0,0,0,0,0,0,-62000,0,0,0,6000,68000,-62000,-62000
04944P,元油2X永豐94售06,0,0,0,0,0,0,0,0,0,-62000,0,0,0,50000,112000,-62000,-62000
051278,臻鼎中信97購02  ,0,0,0,0,0,0,0,0,0,-62000,0,0,0,57000,119000,-62000,-62000
051491,貿聯凱基95購01  ,0,0,0,0,0,0,0,0,0,-62000,0,0,0,0,62000,-62000,-62000
052014,光罩永豐95購01  ,0,0,0,0,0,0,0,0,0,-62000,0,0,0,110000,172000,-62000,-62000
051875,聯發科兆豐95購04,0,0,0,0,0,0,0,0,0,-62000,0,0,0,39000,101000,-62000,-62000
06109P,華新科群益97售05,0,0,0,0,0,0,0,0,0,-62000,0,0,0,0,62000,-62000,-62000
4967,十銓            ,78000,50000,28000,0,0,0,0,0,0,-90000,0,90000,-90000,0,0,0,-62000
1783,和康生          ,21000,83000,-62000,0,0,0,0,0,0,0,0,0,0,0,0,0,-62000
6449,鈺邦            ,73000,138000,-65000,0,0,0,0,0,0,3000,3000,0,3000,0,0,0,-62000
052838,新唐國泰98購01  ,0,0,0,0,0,0,0,0,0,-63000,0,0,0,8000,71000,-63000,-63000
054433,南亞科台新96購02,0,0,0,0,0,0,0,0,0,-63000,0,0,0,0,63000,-63000,-63000
039212,台達電台新9A購01,0,0,0,0,0,0,0,0,0,-63000,0,0,0,0,63000,-63000,-63000
047926,可成凱基94購02  ,0,0,0,0,0,0,0,0,0,-63000,0,0,0,33000,96000,-63000,-63000
048844,訊芯凱基94購02  ,0,0,0,0,0,0,0,0,0,-63000,0,0,0,0,63000,-63000,-63000
049219,聯發科國票95購01,0,0,0,0,0,0,0,0,0,-63000,0,0,0,26000,89000,-63000,-63000
04992P,元油2X富邦97售04,0,0,0,0,0,0,0,0,0,-63000,0,0,0,0,63000,-63000,-63000
049307,上銀凱基94購03  ,0,0,0,0,0,0,0,0,0,-63000,0,0,0,5000,68000,-63000,-63000
051662,大立光永昌96購03,0,0,0,0,0,0,0,0,0,-63000,0,0,0,1021000,1084000,-63000,-63000
051665,台積電元大96購07,0,0,0,0,0,0,0,0,0,-63000,0,0,0,283000,346000,-63000,-63000
051681,日月光兆豐95購01,0,0,0,0,0,0,0,0,0,-63000,0,0,0,10000,73000,-63000,-63000
052020,聯茂永豐95購02  ,0,0,0,0,0,0,0,0,0,-63000,0,0,0,5000,68000,-63000,-63000
051529,東元國票96購01  ,0,0,0,0,0,0,0,0,0,-63000,0,0,0,3000,66000,-63000,-63000
051150,宏達電凱基95購02,0,0,0,0,0,0,0,0,0,-63000,0,0,0,59000,122000,-63000,-63000
050717,京鼎群益96購01  ,0,0,0,0,0,0,0,0,0,-63000,0,0,0,157000,220000,-63000,-63000
4426,利勤            ,44000,56000,-12000,0,0,0,0,0,0,-51000,1000,1000,0,0,51000,-51000,-63000
3003,健和興          ,87000,149000,-62000,0,0,0,0,0,0,-1000,0,1000,-1000,0,0,0,-63000
05666P,聯發科凱基96售14,0,0,0,0,0,0,0,0,0,-63000,0,0,0,25000,88000,-63000,-63000
054621,華新科兆豐98購01,0,0,0,0,0,0,0,0,0,-64000,0,0,0,10000,74000,-64000,-64000
054058,晶豪科國票98購01,0,0,0,0,0,0,0,0,0,-64000,0,0,0,0,64000,-64000,-64000
052564,美食日盛96購01  ,0,0,0,0,0,0,0,0,0,-64000,0,0,0,0,64000,-64000,-64000
053532,台積電永豐96購03,0,0,0,0,0,0,0,0,0,-64000,0,0,0,130000,194000,-64000,-64000
053127,貿聯凱基97購01  ,0,0,0,0,0,0,0,0,0,-64000,0,0,0,2000,66000,-64000,-64000
03426P,道瓊銀元大03售05,0,0,0,0,0,0,0,0,0,-64000,0,0,0,0,64000,-64000,-64000
03419B,臺股指元富99熊03,0,0,0,0,0,0,0,0,0,-64000,0,0,0,0,64000,-64000,-64000
00652,富邦印度        ,0,96000,-96000,0,0,0,0,0,0,32000,0,0,0,44000,12000,32000,-64000
04432P,昇陽半元大94售04,0,0,0,0,0,0,0,0,0,-64000,0,0,0,0,64000,-64000,-64000
049301,致新群益95購01  ,0,0,0,0,0,0,0,0,0,-64000,0,0,0,11000,75000,-64000,-64000
048662,京元電統一93購04,0,0,0,0,0,0,0,0,0,-64000,0,0,0,76000,140000,-64000,-64000
048469,微星永豐93購03  ,0,0,0,0,0,0,0,0,0,-64000,0,0,0,0,64000,-64000,-64000
046929,大立光統一93購03,0,0,0,0,0,0,0,0,0,-64000,0,0,0,0,64000,-64000,-64000
049863,京元電兆豐94購01,0,0,0,0,0,0,0,0,0,-64000,0,0,0,48000,112000,-64000,-64000
052431,茂林永豐95購03  ,0,0,0,0,0,0,0,0,0,-65000,0,0,0,0,65000,-65000,-65000
052365,聯詠國票95購02  ,0,0,0,0,0,0,0,0,0,-65000,0,0,0,0,65000,-65000,-65000
04336P,台達電元大93售04,0,0,0,0,0,0,0,0,0,-65000,0,0,0,100000,165000,-65000,-65000
04028P,燿華凱基94售02  ,0,0,0,0,0,0,0,0,0,-65000,0,0,0,0,65000,-65000,-65000
044247,道瓊反元富97購01,0,0,0,0,0,0,0,0,0,-65000,0,0,0,0,65000,-65000,-65000
043771,鴻海兆豐92購01  ,0,0,0,0,0,0,0,0,0,-65000,0,0,0,110000,175000,-65000,-65000
04502P,元油2X元富98售08,0,0,0,0,0,0,0,0,0,-65000,0,0,0,0,65000,-65000,-65000
047834,義隆元大93購02  ,0,0,0,0,0,0,0,0,0,-65000,0,0,0,0,65000,-65000,-65000
047264,貿聯國票93購02  ,0,0,0,0,0,0,0,0,0,-65000,0,0,0,0,65000,-65000,-65000
04930P,國巨統一94售08  ,0,0,0,0,0,0,0,0,0,-65000,0,0,0,155000,220000,-65000,-65000
049924,欣興元大95購04  ,0,0,0,0,0,0,0,0,0,-65000,0,0,0,0,65000,-65000,-65000
050869,健策永豐95購01  ,0,0,0,0,0,0,0,0,0,-65000,0,0,0,41000,106000,-65000,-65000
050823,信邦凱基95購01  ,0,0,0,0,0,0,0,0,0,-65000,0,0,0,0,65000,-65000,-65000
6230,超眾            ,468000,301000,167000,0,0,0,0,120000,-120000,-112000,31000,77000,-46000,3000,69000,-66000,-65000
3312,弘憶股          ,29047,95000,-65953,0,0,0,0,0,0,0,0,0,0,0,0,0,-65953
053011,鴻海統一98購01  ,0,0,0,0,0,0,0,0,0,-66000,0,0,0,37000,103000,-66000,-66000
053560,漢唐國泰98購01  ,0,0,0,0,0,0,0,0,0,-66000,0,0,0,60000,126000,-66000,-66000
053995,奇力新群益97購02,0,0,0,0,0,0,0,0,0,-66000,0,0,0,80000,146000,-66000,-66000
053970,聯發科元大97購08,0,0,0,0,0,0,0,0,0,-66000,0,0,0,0,66000,-66000,-66000
04412P,欣興元富94售01  ,0,0,0,0,0,0,0,0,0,-66000,0,0,0,45000,111000,-66000,-66000
044518,京鼎凱基92購01  ,0,0,0,0,0,0,0,0,0,-66000,0,0,0,9000,75000,-66000,-66000
04472P,中環元大94售01  ,0,0,0,0,0,0,0,0,0,-66000,0,0,0,0,66000,-66000,-66000
048193,旺宏元大94購05  ,0,0,0,0,0,0,0,0,0,-66000,0,0,0,311000,377000,-66000,-66000
048872,玉晶光國票94購02,0,0,0,0,0,0,0,0,0,-66000,0,0,0,0,66000,-66000,-66000
046404,友達元大93購02  ,0,0,0,0,0,0,0,0,0,-66000,0,0,0,0,66000,-66000,-66000
049445,遠東新統一94購01,0,0,0,0,0,0,0,0,0,-66000,0,0,0,10000,76000,-66000,-66000
051781,緯穎群益96購01  ,0,0,0,0,0,0,0,0,0,-66000,0,0,0,33000,99000,-66000,-66000
2442,新美齊          ,51000,117000,-66000,0,0,0,0,0,0,0,0,0,0,0,0,0,-66000
5522,遠雄            ,291000,354000,-63000,0,0,0,0,0,0,-3000,0,3000,-3000,0,0,0,-66000
053592,亞光元大96購01  ,0,0,0,0,0,0,0,0,0,-67000,0,0,0,67000,134000,-67000,-67000
053895,智易群益96購02  ,0,0,0,0,0,0,0,0,0,-67000,0,0,0,0,67000,-67000,-67000
054528,台光電統一96購02,0,0,0,0,0,0,0,0,0,-67000,0,0,0,90000,157000,-67000,-67000
05505P,聯發科凱基96售09,0,0,0,0,0,0,0,0,0,-67000,0,0,0,1000,68000,-67000,-67000
05562P,鴻海元大96售16  ,0,0,0,0,0,0,0,0,0,-67000,0,0,0,40000,107000,-67000,-67000
054201,聯詠富邦97購02  ,0,0,0,0,0,0,0,0,0,-67000,0,0,0,101000,168000,-67000,-67000
053274,旺宏元大98購03  ,0,0,0,0,0,0,0,0,0,-67000,0,0,0,214000,281000,-67000,-67000
052869,新日興凱基96購01,0,0,0,0,0,0,0,0,0,-67000,0,0,0,1000,68000,-67000,-67000
040430,和大群益92購01  ,0,0,0,0,0,0,0,0,0,-67000,0,0,0,71000,138000,-67000,-67000
03641C,臺股指凱基95牛18,0,0,0,0,0,0,0,0,0,-67000,0,0,0,16000,83000,-67000,-67000
045518,可成元富92購01  ,0,0,0,0,0,0,0,0,0,-67000,0,0,0,0,67000,-67000,-67000
047870,嘉澤永豐93購02  ,0,0,0,0,0,0,0,0,0,-67000,0,0,0,6000,73000,-67000,-67000
04879P,康控永豐94售02  ,0,0,0,0,0,0,0,0,0,-67000,0,0,0,16000,83000,-67000,-67000
049929,祥碩元大94購03  ,0,0,0,0,0,0,0,0,0,-67000,0,0,0,28000,95000,-67000,-67000
049071,台達電凱基94購02,0,0,0,0,0,0,0,0,0,-67000,0,0,0,1000,68000,-67000,-67000
052135,聯發科凱基9B購01,0,0,0,0,0,0,0,0,0,-67000,0,0,0,5000,72000,-67000,-67000
051168,訊連元大95購02  ,0,0,0,0,0,0,0,0,0,-67000,0,0,0,1000,68000,-67000,-67000
049733,旺宏群益94購03  ,0,0,0,0,0,0,0,0,0,-67000,0,0,0,63000,130000,-67000,-67000
06088P,建準永豐97售01  ,0,0,0,0,0,0,0,0,0,-67000,0,0,0,0,67000,-67000,-67000
052347,GIS凱基95購05   ,0,0,0,0,0,0,0,0,0,-68000,0,0,0,35000,103000,-68000,-68000
053305,聯詠凱基96購02  ,0,0,0,0,0,0,0,0,0,-68000,0,0,0,0,68000,-68000,-68000
053556,康控凱基97購02  ,0,0,0,0,0,0,0,0,0,-68000,0,0,0,0,68000,-68000,-68000
053549,南亞科凱基96購02,0,0,0,0,0,0,0,0,0,-68000,0,0,0,0,68000,-68000,-68000
053004,燿華永豐96購01  ,0,0,0,0,0,0,0,0,0,-68000,0,0,0,0,68000,-68000,-68000
052971,京元電群益98購01,0,0,0,0,0,0,0,0,0,-68000,0,0,0,275000,343000,-68000,-68000
053157,日月光元大96購03,0,0,0,0,0,0,0,0,0,-68000,0,0,0,0,68000,-68000,-68000
053192,創意統一96購01  ,0,0,0,0,0,0,0,0,0,-68000,0,0,0,28000,96000,-68000,-68000
05426P,聯發科凱基95售12,0,0,0,0,0,0,0,0,0,-68000,0,0,0,0,68000,-68000,-68000
054305,光磊凱基98購01  ,0,0,0,0,0,0,0,0,0,-68000,0,0,0,0,68000,-68000,-68000
053802,南亞科凱基96購04,0,0,0,0,0,0,0,0,0,-68000,0,0,0,0,68000,-68000,-68000
053772,大成鋼元大96購02,0,0,0,0,0,0,0,0,0,-68000,0,0,0,0,68000,-68000,-68000
053670,台積電統一96購09,0,0,0,0,0,0,0,0,0,-68000,0,0,0,10000,78000,-68000,-68000
053714,南亞科凱基96購03,0,0,0,0,0,0,0,0,0,-68000,0,0,0,0,68000,-68000,-68000
053715,美律凱基96購04  ,0,0,0,0,0,0,0,0,0,-68000,0,0,0,5000,73000,-68000,-68000
048218,上銀凱基93購07  ,0,0,0,0,0,0,0,0,0,-68000,0,0,0,0,68000,-68000,-68000
047738,美律永豐93購02  ,0,0,0,0,0,0,0,0,0,-68000,0,0,0,0,68000,-68000,-68000
03425P,台灣50元大03售04,0,0,0,0,0,0,0,0,0,-68000,0,0,0,0,68000,-68000,-68000
03033P,微星國票03售01  ,0,0,0,0,0,0,0,0,0,-68000,0,0,0,664000,732000,-68000,-68000
049171,台達電凱基94購03,0,0,0,0,0,0,0,0,0,-68000,0,0,0,0,68000,-68000,-68000
049923,智原元大95購02  ,0,0,0,0,0,0,0,0,0,-68000,0,0,0,437000,505000,-68000,-68000
049299,矽創群益94購01  ,0,0,0,0,0,0,0,0,0,-68000,0,0,0,80000,148000,-68000,-68000
048764,台光電凱基94購03,0,0,0,0,0,0,0,0,0,-68000,0,0,0,0,68000,-68000,-68000
047053,益航國票93購01  ,0,0,0,0,0,0,0,0,0,-68000,0,0,0,0,68000,-68000,-68000
047067,啟碁凱基93購01  ,0,0,0,0,0,0,0,0,0,-68000,0,0,0,0,68000,-68000,-68000
047226,義隆凱基94購01  ,0,0,0,0,0,0,0,0,0,-68000,0,0,0,0,68000,-68000,-68000
048971,美食元大94購01  ,0,0,0,0,0,0,0,0,0,-68000,0,0,0,0,68000,-68000,-68000
048439,上銀凱基93購09  ,0,0,0,0,0,0,0,0,0,-68000,0,0,0,0,68000,-68000,-68000
046065,益航凱基93購02  ,0,0,0,0,0,0,0,0,0,-68000,0,0,0,200000,268000,-68000,-68000
049758,GIS永豐94購01   ,0,0,0,0,0,0,0,0,0,-68000,0,0,0,0,68000,-68000,-68000
049650,啟碁凱基94購03  ,0,0,0,0,0,0,0,0,0,-68000,0,0,0,0,68000,-68000,-68000
049412,為升凱基94購01  ,0,0,0,0,0,0,0,0,0,-68000,0,0,0,0,68000,-68000,-68000
049474,台光電永豐94購02,0,0,0,0,0,0,0,0,0,-68000,0,0,0,0,68000,-68000,-68000
04978P,台表科凱基94售02,0,0,0,0,0,0,0,0,0,-68000,0,0,0,0,68000,-68000,-68000
050764,鴻海元大94購27  ,0,0,0,0,0,0,0,0,0,-68000,0,0,0,801000,869000,-68000,-68000
050703,矽格凱基94購02  ,0,0,0,0,0,0,0,0,0,-68000,0,0,0,0,68000,-68000,-68000
050284,台泥凱基94購01  ,0,0,0,0,0,0,0,0,0,-68000,0,0,0,0,68000,-68000,-68000
05028P,康控永豐95售02  ,0,0,0,0,0,0,0,0,0,-68000,0,0,0,48000,116000,-68000,-68000
050505,可成凱基94購12  ,0,0,0,0,0,0,0,0,0,-68000,0,0,0,0,68000,-68000,-68000
051181,鴻海永豐95購03  ,0,0,0,0,0,0,0,0,0,-68000,0,0,0,9000,77000,-68000,-68000
051018,可成凱基95購03  ,0,0,0,0,0,0,0,0,0,-68000,0,0,0,0,68000,-68000,-68000
050962,聯發科永豐95購02,0,0,0,0,0,0,0,0,0,-68000,0,0,0,0,68000,-68000,-68000
051479,兆豐金凱基95購01,0,0,0,0,0,0,0,0,0,-68000,0,0,0,0,68000,-68000,-68000
051975,美食凱基95購02  ,0,0,0,0,0,0,0,0,0,-68000,0,0,0,0,68000,-68000,-68000
051803,矽創永豐95購03  ,0,0,0,0,0,0,0,0,0,-68000,0,0,0,0,68000,-68000,-68000
051797,卜蜂永豐95購01  ,0,0,0,0,0,0,0,0,0,-68000,0,0,0,0,68000,-68000,-68000
051684,瑞昱凱基95購02  ,0,0,0,0,0,0,0,0,0,-68000,0,0,0,9000,77000,-68000,-68000
051723,嘉澤永豐95購01  ,0,0,0,0,0,0,0,0,0,-68000,0,0,0,6000,74000,-68000,-68000
05645P,聯發科凱基96售13,0,0,0,0,0,0,0,0,0,-68000,0,0,0,0,68000,-68000,-68000
05608P,聯發科凱基96售10,0,0,0,0,0,0,0,0,0,-68000,0,0,0,0,68000,-68000,-68000
05724P,致茂永豐96售01  ,0,0,0,0,0,0,0,0,0,-68000,0,0,0,116000,184000,-68000,-68000
5388,中磊            ,50000,178000,-128000,0,0,0,0,3000,-3000,63000,2000,0,2000,62000,1000,61000,-68000
4306,炎洲            ,136000,209934,-73934,0,0,0,0,0,0,5000,5000,0,5000,0,0,0,-68934
05501P,健策國票97售01  ,0,0,0,0,0,0,0,0,0,-69000,0,0,0,101000,170000,-69000,-69000
048340,聯發科元大93購25,0,0,0,0,0,0,0,0,0,-69000,0,0,0,16000,85000,-69000,-69000
048613,智原凱基93購03  ,0,0,0,0,0,0,0,0,0,-69000,0,0,0,2000,71000,-69000,-69000
048924,光罩永豐94購01  ,0,0,0,0,0,0,0,0,0,-69000,0,0,0,2000,71000,-69000,-69000
048186,元黃金元大96購01,0,0,0,0,0,0,0,0,0,-69000,0,0,0,45000,114000,-69000,-69000
049317,啟碁凱基94購02  ,0,0,0,0,0,0,0,0,0,-69000,0,0,0,0,69000,-69000,-69000
052174,聯發科元大95購13,0,0,0,0,0,0,0,0,0,-69000,0,0,0,3000,72000,-69000,-69000
050748,道瓊銀統一94購04,0,0,0,0,0,0,0,0,0,-69000,0,0,0,1000,70000,-69000,-69000
049989,臻鼎凱基94購02  ,0,0,0,0,0,0,0,0,0,-69000,0,0,0,0,69000,-69000,-69000
049735,台光電群益94購03,0,0,0,0,0,0,0,0,0,-69000,0,0,0,224000,293000,-69000,-69000
05613P,臻鼎台新96售01  ,0,0,0,0,0,0,0,0,0,-69000,0,0,0,31000,100000,-69000,-69000
054434,友達台新96購03  ,0,0,0,0,0,0,0,0,0,-70000,0,0,0,0,70000,-70000,-70000
054404,新日興康和96購01,0,0,0,0,0,0,0,0,0,-70000,0,0,0,0,70000,-70000,-70000
053734,友達中信98購02  ,0,0,0,0,0,0,0,0,0,-70000,0,0,0,0,70000,-70000,-70000
054075,GIS富邦97購02   ,0,0,0,0,0,0,0,0,0,-70000,0,0,0,0,70000,-70000,-70000
053102,祥碩元富96購01  ,0,0,0,0,0,0,0,0,0,-70000,0,0,0,0,70000,-70000,-70000
053300,大成鋼凱基96購02,0,0,0,0,0,0,0,0,0,-70000,0,0,0,0,70000,-70000,-70000
053378,台積電元大98購02,0,0,0,0,0,0,0,0,0,-70000,0,0,0,190000,260000,-70000,-70000
05225P,鴻海統一95售09  ,0,0,0,0,0,0,0,0,0,-70000,0,0,0,0,70000,-70000,-70000
052653,臺股指永豐97購01,0,0,0,0,0,0,0,0,0,-70000,0,0,0,20000,90000,-70000,-70000
048268,長榮航中信95購01,0,0,0,0,0,0,0,0,0,-70000,0,0,0,0,70000,-70000,-70000
048224,聯發科凱基93購31,0,0,0,0,0,0,0,0,0,-70000,0,0,0,51000,121000,-70000,-70000
045786,台勝科元大92購02,0,0,0,0,0,0,0,0,0,-70000,0,0,0,0,70000,-70000,-70000
044157,大立光永豐91購05,0,0,0,0,0,0,0,0,0,-70000,0,0,0,0,70000,-70000,-70000
044755,可成凱基91購10  ,0,0,0,0,0,0,0,0,0,-70000,0,0,0,0,70000,-70000,-70000
044604,嘉聯益國泰93購01,0,0,0,0,0,0,0,0,0,-70000,0,0,0,121000,191000,-70000,-70000
044495,可成元大91購09  ,0,0,0,0,0,0,0,0,0,-70000,0,0,0,51000,121000,-70000,-70000
04352P,國巨永豐94售01  ,0,0,0,0,0,0,0,0,0,-70000,0,0,0,0,70000,-70000,-70000
042194,揚明光富邦93購01,0,0,0,0,0,0,0,0,0,-70000,0,0,0,0,70000,-70000,-70000
049146,南亞科元大94購02,0,0,0,0,0,0,0,0,0,-70000,0,0,0,4000,74000,-70000,-70000
048715,A50正2永豐94購01,0,0,0,0,0,0,0,0,0,-70000,0,0,0,100000,170000,-70000,-70000
048709,瑞昱亞東94購01  ,0,0,0,0,0,0,0,0,0,-70000,0,0,0,0,70000,-70000,-70000
047103,台苯元大93購01  ,0,0,0,0,0,0,0,0,0,-70000,0,0,0,407000,477000,-70000,-70000
048986,訊連元大94購01  ,0,0,0,0,0,0,0,0,0,-70000,0,0,0,0,70000,-70000,-70000
047481,可成凱基93購08  ,0,0,0,0,0,0,0,0,0,-70000,0,0,0,13000,83000,-70000,-70000
046557,亞泥凱基93購02  ,0,0,0,0,0,0,0,0,0,-70000,0,0,0,0,70000,-70000,-70000
047920,南亞科凱基93購04,0,0,0,0,0,0,0,0,0,-70000,0,0,0,0,70000,-70000,-70000
047895,台積電群益94購04,0,0,0,0,0,0,0,0,0,-70000,0,0,0,233000,303000,-70000,-70000
046728,明泰元大93購01  ,0,0,0,0,0,0,0,0,0,-70000,0,0,0,0,70000,-70000,-70000
047947,欣興統一93購04  ,0,0,0,0,0,0,0,0,0,-70000,0,0,0,30000,100000,-70000,-70000
048491,A50元大93購01   ,0,0,0,0,0,0,0,0,0,-70000,0,0,0,135000,205000,-70000,-70000
045886,華邦電元大92購04,0,0,0,0,0,0,0,0,0,-70000,0,0,0,10000,80000,-70000,-70000
046894,日月光群益93購01,0,0,0,0,0,0,0,0,0,-70000,0,0,0,20000,90000,-70000,-70000
049703,訊芯元大95購01  ,0,0,0,0,0,0,0,0,0,-70000,0,0,0,5000,75000,-70000,-70000
04969P,道瓊銀統一94售02,0,0,0,0,0,0,0,0,0,-70000,0,0,0,0,70000,-70000,-70000
049456,上海銀統一94購03,0,0,0,0,0,0,0,0,0,-70000,0,0,0,10000,80000,-70000,-70000
049545,台積電群益94購09,0,0,0,0,0,0,0,0,0,-70000,0,0,0,159000,229000,-70000,-70000
050017,百和富邦94購01  ,0,0,0,0,0,0,0,0,0,-70000,0,0,0,0,70000,-70000,-70000
050065,冠德凱基94購01  ,0,0,0,0,0,0,0,0,0,-70000,0,0,0,0,70000,-70000,-70000
050751,聯電統一94購05  ,0,0,0,0,0,0,0,0,0,-70000,0,0,0,10000,80000,-70000,-70000
051979,群創凱基97購01  ,0,0,0,0,0,0,0,0,0,-70000,0,0,0,0,70000,-70000,-70000
051958,貿聯台新95購01  ,0,0,0,0,0,0,0,0,0,-70000,0,0,0,0,70000,-70000,-70000
051959,台郡台新95購03  ,0,0,0,0,0,0,0,0,0,-70000,0,0,0,0,70000,-70000,-70000
051642,鈺齊台新95購01  ,0,0,0,0,0,0,0,0,0,-70000,0,0,0,15000,85000,-70000,-70000
051383,京鼎群益96購02  ,0,0,0,0,0,0,0,0,0,-70000,0,0,0,51000,121000,-70000,-70000
054483,聯電台新96購01  ,0,0,0,0,0,0,0,0,0,-71000,0,0,0,0,71000,-71000,-71000
03543P,台泥中信02售01  ,0,0,0,0,0,0,0,0,0,-71000,0,0,0,0,71000,-71000,-71000
046873,可成元富93購01  ,0,0,0,0,0,0,0,0,0,-71000,0,0,0,0,71000,-71000,-71000
046702,旺宏元富93購02  ,0,0,0,0,0,0,0,0,0,-71000,0,0,0,40000,111000,-71000,-71000
051451,世芯元大95購03  ,0,0,0,0,0,0,0,0,0,-71000,0,0,0,40000,111000,-71000,-71000
050928,日月光凱基95購01,0,0,0,0,0,0,0,0,0,-71000,0,0,0,10000,81000,-71000,-71000
051194,大立光中信96購02,0,0,0,0,0,0,0,0,0,-71000,0,0,0,0,71000,-71000,-71000
051611,鈺齊群益95購02  ,0,0,0,0,0,0,0,0,0,-71000,0,0,0,145000,216000,-71000,-71000
051777,聯發科群益95購04,0,0,0,0,0,0,0,0,0,-71000,0,0,0,9000,80000,-71000,-71000
052026,漢唐群益95購01  ,0,0,0,0,0,0,0,0,0,-71000,0,0,0,10000,81000,-71000,-71000
1310,台苯            ,295000,366887,-71887,0,0,0,0,0,0,0,0,0,0,0,0,0,-71887
052379,鈺齊元大95購04  ,0,0,0,0,0,0,0,0,0,-72000,0,0,0,129000,201000,-72000,-72000
044332,華邦電統一91購01,0,0,0,0,0,0,0,0,0,-72000,0,0,0,192000,264000,-72000,-72000
048883,玉晶光統一94購01,0,0,0,0,0,0,0,0,0,-72000,0,0,0,7000,79000,-72000,-72000
047413,台積電永昌93購05,0,0,0,0,0,0,0,0,0,-72000,0,0,0,1000,73000,-72000,-72000
047234,晶技凱基93購01  ,0,0,0,0,0,0,0,0,0,-72000,0,0,0,20000,92000,-72000,-72000
052200,台光電統一95購02,0,0,0,0,0,0,0,0,0,-72000,0,0,0,133000,205000,-72000,-72000
050732,台虹國票94購01  ,0,0,0,0,0,0,0,0,0,-72000,0,0,0,22000,94000,-72000,-72000
050379,易華電群益96購01,0,0,0,0,0,0,0,0,0,-72000,0,0,0,26000,98000,-72000,-72000
050078,臺指反統一97購01,0,0,0,0,0,0,0,0,0,-72000,0,0,0,0,72000,-72000,-72000
052644,聯發科永豐96購01,0,0,0,0,0,0,0,0,0,-73000,0,0,0,16000,89000,-73000,-73000
052602,聯電元大97購01  ,0,0,0,0,0,0,0,0,0,-73000,0,0,0,0,73000,-73000,-73000
054647,禾伸堂群益99購01,0,0,0,0,0,0,0,0,0,-73000,0,0,0,10000,83000,-73000,-73000
054109,南亞科凱基96購05,0,0,0,0,0,0,0,0,0,-73000,0,0,0,0,73000,-73000,-73000
042977,京元電凱基92購01,0,0,0,0,0,0,0,0,0,-73000,0,0,0,1000,74000,-73000,-73000
045763,南亞科統一93購01,0,0,0,0,0,0,0,0,0,-73000,0,0,0,25000,98000,-73000,-73000
046352,智邦群益92購02  ,0,0,0,0,0,0,0,0,0,-73000,0,0,0,11000,84000,-73000,-73000
050120,GIS元大95購02   ,0,0,0,0,0,0,0,0,0,-73000,0,0,0,32000,105000,-73000,-73000
049813,康控元大96購02  ,0,0,0,0,0,0,0,0,0,-73000,0,0,0,70000,143000,-73000,-73000
050657,宏達電麥證94購01,0,0,0,10000,83000,-73000,0,0,0,-73000,0,0,0,10000,83000,-73000,-73000
051592,健策元大96購05  ,0,0,0,0,0,0,0,0,0,-73000,0,0,0,89000,162000,-73000,-73000
051513,台積電凱基95購13,0,0,0,0,0,0,0,0,0,-73000,0,0,0,7000,80000,-73000,-73000
05588P,群創兆豐97售02  ,0,0,0,0,0,0,0,0,0,-73000,0,0,0,0,73000,-73000,-73000
05572P,群創統一96售02  ,0,0,0,0,0,0,0,0,0,-74000,0,0,0,0,74000,-74000,-74000
044943,旺宏群益93購03  ,0,0,0,0,0,0,0,0,0,-74000,0,0,0,0,74000,-74000,-74000
045014,和鑫元大93購02  ,0,0,0,0,0,0,0,0,0,-74000,0,0,0,6000,80000,-74000,-74000
03027P,玉晶光元大01售09,0,0,0,0,0,0,0,0,0,-74000,0,0,0,0,74000,-74000,-74000
051490,世芯凱基96購01  ,0,0,0,0,0,0,0,0,0,-74000,0,0,0,27000,101000,-74000,-74000
05108P,欣興中信95售02  ,0,0,0,0,0,0,0,0,0,-74000,0,0,0,0,74000,-74000,-74000
050914,健鼎中信95購01  ,0,0,0,0,0,0,0,0,0,-74000,0,0,0,12000,86000,-74000,-74000
051808,美律凱基96購02  ,0,0,0,0,0,0,0,0,0,-74000,0,0,0,25000,99000,-74000,-74000
05589P,大立光中信9A售01,0,0,0,0,0,0,0,0,0,-74000,0,0,0,8000,82000,-74000,-74000
05949P,台積電國票96售09,0,0,0,0,0,0,0,0,0,-74000,0,0,0,160000,234000,-74000,-74000
3050,鈺德            ,36000,110000,-74000,0,0,0,0,0,0,0,0,0,0,0,0,0,-74000
05547P,群創元大96售03  ,0,0,0,0,0,0,0,0,0,-75000,0,0,0,125000,200000,-75000,-75000
054362,亞光凱基96購03  ,0,0,0,0,0,0,0,0,0,-75000,0,0,0,22000,97000,-75000,-75000
054000,訊芯群益96購02  ,0,0,0,0,0,0,0,0,0,-75000,0,0,0,96000,171000,-75000,-75000
053890,華新科群益98購01,10000,0,10000,0,0,0,0,0,0,-85000,0,0,0,403000,488000,-85000,-75000
053303,建準凱基96購03  ,0,0,0,0,0,0,0,0,0,-75000,0,0,0,33000,108000,-75000,-75000
045447,鴻海國泰94購02  ,0,0,0,0,0,0,0,0,0,-75000,0,0,0,61000,136000,-75000,-75000
046543,京元電台新92購01,0,0,0,0,0,0,0,0,0,-75000,0,0,0,0,75000,-75000,-75000
048166,滬深2X永豐96購02,0,0,0,0,0,0,0,0,0,-75000,0,0,0,0,75000,-75000,-75000
048094,大立光凱基93購31,0,0,0,0,0,0,0,0,0,-75000,0,0,0,80000,155000,-75000,-75000
049216,華邦電國票95購01,0,0,0,0,0,0,0,0,0,-75000,0,0,0,195000,270000,-75000,-75000
047725,廣達群益93購01  ,0,0,0,0,0,0,0,0,0,-75000,0,0,0,57000,132000,-75000,-75000
051600,新日興兆豐96購02,0,0,0,0,0,0,0,0,0,-75000,0,0,0,32000,107000,-75000,-75000
052175,可成元大95購10  ,0,0,0,0,0,0,0,0,0,-75000,0,0,0,175000,250000,-75000,-75000
051115,華通麥證96購01  ,0,0,0,0,75000,-75000,0,0,0,-75000,0,0,0,0,75000,-75000,-75000
051495,玉晶光第一95購02,0,0,0,0,0,0,0,0,0,-75000,0,0,0,5000,80000,-75000,-75000
05132P,鴻海元富95售07  ,0,0,0,0,0,0,0,0,0,-75000,0,0,0,30000,105000,-75000,-75000
050752,美律統一94購05  ,0,0,0,0,0,0,0,0,0,-75000,0,0,0,93000,168000,-75000,-75000
050335,正崴國泰96購01  ,0,0,0,0,0,0,0,0,0,-75000,0,0,0,100000,175000,-75000,-75000
049617,光罩群益94購03  ,0,0,0,0,0,0,0,0,0,-75000,0,0,0,95000,170000,-75000,-75000
053281,茂林元大96購02  ,0,0,0,0,0,0,0,0,0,-76000,0,0,0,85000,161000,-76000,-76000
053966,旺宏元大96購08  ,0,0,0,0,0,0,0,0,0,-76000,0,0,0,520000,596000,-76000,-76000
00852L,國泰美國道瓊正2 ,0,0,0,0,0,0,0,0,0,-76000,0,0,0,123000,199000,-76000,-76000
047286,美律統一93購02  ,0,0,0,0,0,0,0,0,0,-76000,0,0,0,108000,184000,-76000,-76000
049971,台郡國票95購01  ,0,0,0,0,0,0,0,0,0,-76000,0,0,0,54000,130000,-76000,-76000
050559,聯發科統一94購10,0,0,0,0,0,0,0,0,0,-76000,0,0,0,20000,96000,-76000,-76000
051461,聯詠國泰96購01  ,0,0,0,0,0,0,0,0,0,-76000,0,0,0,144000,220000,-76000,-76000
05833P,臺股指元富96售05,0,0,0,0,0,0,0,0,0,-76000,0,0,0,0,76000,-76000,-76000
053863,聯發科元大96購18,0,0,0,0,0,0,0,0,0,-77000,0,0,0,458000,535000,-77000,-77000
054318,台虹凱基98購01  ,0,0,0,0,0,0,0,0,0,-77000,0,0,0,215000,292000,-77000,-77000
052305,GIS永豐95購03   ,0,0,0,0,0,0,0,0,0,-77000,0,0,0,48000,125000,-77000,-77000
043048,金寶國泰93購01  ,0,0,0,0,0,0,0,0,0,-77000,0,0,0,28000,105000,-77000,-77000
04163P,可成統一93售03  ,0,0,0,0,0,0,0,0,0,-77000,0,0,0,28000,105000,-77000,-77000
04752P,大立光群益94售07,0,0,0,0,0,0,0,0,0,-77000,0,0,0,125000,202000,-77000,-77000
047631,味全元大93購01  ,0,0,0,0,0,0,0,0,0,-77000,0,0,0,3000,80000,-77000,-77000
049400,可成群益94購03  ,0,0,0,0,0,0,0,0,0,-77000,0,0,0,21000,98000,-77000,-77000
046354,聯詠群益92購02  ,0,0,0,0,0,0,0,0,0,-77000,0,0,0,8000,85000,-77000,-77000
048511,美律凱基93購07  ,0,0,0,0,0,0,0,0,0,-77000,0,0,0,36000,113000,-77000,-77000
048525,華通國票94購02  ,0,0,0,0,0,0,0,0,0,-77000,0,0,0,1000,78000,-77000,-77000
051340,健策永豐95購03  ,0,0,0,0,0,0,0,0,0,-77000,0,0,0,95000,172000,-77000,-77000
050956,鈺齊群益95購01  ,0,0,0,0,0,0,0,0,0,-77000,0,0,0,165000,242000,-77000,-77000
050747,道瓊銀統一94購03,0,0,0,0,0,0,0,0,0,-77000,0,0,0,0,77000,-77000,-77000
052586,晶豪科永豐96購01,0,0,0,0,0,0,0,0,0,-78000,0,0,0,5000,83000,-78000,-78000
052846,智邦統一97購01  ,0,0,0,0,0,0,0,0,0,-78000,0,0,0,30000,108000,-78000,-78000
05446P,緯穎元大95售04  ,0,0,0,0,0,0,0,0,0,-78000,0,0,0,115000,193000,-78000,-78000
053687,智邦元大96購02  ,0,0,0,0,0,0,0,0,0,-78000,0,0,0,100000,178000,-78000,-78000
053971,聯發科元大97購09,0,0,0,0,0,0,0,0,0,-78000,0,0,0,51000,129000,-78000,-78000
043457,鴻海元大93購01  ,0,0,0,0,0,0,0,0,0,-78000,0,0,0,361000,439000,-78000,-78000
04018P,亞光永豐93售01  ,0,0,0,0,0,0,0,0,0,-78000,0,0,0,5000,83000,-78000,-78000
045179,義隆永豐92購02  ,0,0,0,0,0,0,0,0,0,-78000,0,0,0,0,78000,-78000,-78000
044995,大立光國泰94購01,0,0,0,0,0,0,0,0,0,-78000,0,0,0,400000,478000,-78000,-78000
048452,緯創凱基93購04  ,0,0,0,0,0,0,0,0,0,-78000,0,0,0,5000,83000,-78000,-78000
048598,瑞昱國票93購03  ,0,0,0,0,0,0,0,0,0,-78000,0,0,0,0,78000,-78000,-78000
047013,超眾元富96購01  ,0,0,0,0,0,0,0,0,0,-78000,0,0,0,52000,130000,-78000,-78000
049132,大成鋼元大94購01,0,0,0,0,0,0,0,0,0,-78000,0,0,0,0,78000,-78000,-78000
050828,康控凱基95購01  ,0,0,0,0,0,0,0,0,0,-78000,0,0,0,0,78000,-78000,-78000
050560,聯詠統一94購02  ,0,0,0,0,0,0,0,0,0,-78000,0,0,0,83000,161000,-78000,-78000
050646,美律凱基96購01  ,0,0,0,0,0,0,0,0,0,-78000,0,0,0,0,78000,-78000,-78000
049858,百和群益94購05  ,0,0,0,0,0,0,0,0,0,-78000,0,0,0,38000,116000,-78000,-78000
049486,旺宏元大94購08  ,0,0,0,0,0,0,0,0,0,-78000,0,0,0,199000,277000,-78000,-78000
05186P,鈺齊中信95售02  ,0,0,0,0,0,0,0,0,0,-78000,0,0,0,2000,80000,-78000,-78000
051794,臻鼎國票96購02  ,0,0,0,0,0,0,0,0,0,-78000,0,0,0,68000,146000,-78000,-78000
053976,亞光元大96購02  ,0,0,0,0,0,0,0,0,0,-79000,0,0,0,105000,184000,-79000,-79000
052396,台積電凱基97購01,0,0,0,0,0,0,0,0,0,-79000,0,0,0,8000,87000,-79000,-79000
045001,旺宏富邦94購01  ,0,0,0,0,0,0,0,0,0,-79000,0,0,0,519000,598000,-79000,-79000
049154,玉晶光元大95購02,0,0,0,0,0,0,0,0,0,-79000,0,0,0,31000,110000,-79000,-79000
048107,華通群益93購02  ,0,0,0,0,0,0,0,0,0,-79000,0,0,0,0,79000,-79000,-79000
046801,中橡元大93購01  ,0,0,0,0,0,0,0,0,0,-79000,0,0,0,30000,109000,-79000,-79000
048550,中鴻元大96購01  ,0,0,0,0,0,0,0,0,0,-79000,0,0,0,0,79000,-79000,-79000
052162,智伸科永豐95購01,0,0,0,0,0,0,0,0,0,-79000,0,0,0,0,79000,-79000,-79000
050953,臻鼎群益95購01  ,0,0,0,0,0,0,0,0,0,-79000,0,0,0,31000,110000,-79000,-79000
051489,世芯凱基95購01  ,0,0,0,0,0,0,0,0,0,-79000,0,0,0,6000,85000,-79000,-79000
6443,元晶            ,49000,128000,-79000,0,0,0,0,0,0,0,0,0,0,0,0,0,-79000
05238P,禾伸堂永豐95售01,0,0,0,0,0,0,0,0,0,-80000,0,0,0,584000,664000,-80000,-80000
052883,百和亞東97購01  ,0,0,0,0,0,0,0,0,0,-80000,0,0,0,34000,114000,-80000,-80000
053256,上銀富邦98購01  ,0,0,0,0,0,0,0,0,0,-80000,0,0,0,2000,82000,-80000,-80000
053341,聯發科國票97購03,0,0,0,0,0,0,0,0,0,-80000,0,0,0,0,80000,-80000,-80000
053389,彩晶元大98購01  ,0,0,0,0,0,0,0,0,0,-80000,0,0,0,3000,83000,-80000,-80000
054011,旺宏永豐96購05  ,0,0,0,0,0,0,0,0,0,-80000,0,0,0,0,80000,-80000,-80000
053828,貿聯麥證96購01  ,0,0,0,0,80000,-80000,0,0,0,-80000,0,0,0,0,80000,-80000,-80000
053822,正文群益97購01  ,0,0,0,0,0,0,0,0,0,-80000,0,0,0,0,80000,-80000,-80000
054575,聯鈞元大97購01  ,0,0,0,0,0,0,0,0,0,-80000,0,0,0,5000,85000,-80000,-80000
045441,南亞科元富92購01,0,0,0,0,0,0,0,0,0,-80000,0,0,0,0,80000,-80000,-80000
046241,聯發科中信94購02,0,0,0,0,0,0,0,0,0,-80000,0,0,0,95000,175000,-80000,-80000
042912,凌陽元大94購01  ,0,0,0,0,0,0,0,0,0,-80000,0,0,0,30000,110000,-80000,-80000
048545,嘉澤永豐93購03  ,0,0,0,0,0,0,0,0,0,-80000,0,0,0,74000,154000,-80000,-80000
048442,友訊凱基94購01  ,0,0,0,0,0,0,0,0,0,-80000,0,0,0,0,80000,-80000,-80000
047806,旺宏凱基93購05  ,0,0,0,0,0,0,0,0,0,-80000,0,0,0,52000,132000,-80000,-80000
04798P,牧德元大95售02  ,0,0,0,0,0,0,0,0,0,-80000,0,0,0,0,80000,-80000,-80000
048845,GIS凱基94購02   ,0,0,0,0,0,0,0,0,0,-80000,0,0,0,2000,82000,-80000,-80000
049371,可成元大94購04  ,0,0,0,0,0,0,0,0,0,-80000,0,0,0,0,80000,-80000,-80000
052046,漢唐凱基96購01  ,0,0,0,0,0,0,0,0,0,-80000,0,0,0,0,80000,-80000,-80000
051755,台積電元大96購08,0,0,0,0,0,0,0,0,0,-80000,0,0,0,130000,210000,-80000,-80000
051826,智邦元大95購03  ,0,0,0,0,0,0,0,0,0,-80000,0,0,0,10000,90000,-80000,-80000
050729,聯鈞國票94購01  ,0,0,0,0,0,0,0,0,0,-80000,0,0,0,0,80000,-80000,-80000
05851P,力山群益97售01  ,0,0,0,0,0,0,0,0,0,-80000,0,0,0,0,80000,-80000,-80000
05610P,國巨群益98售01  ,0,0,0,0,0,0,0,0,0,-80000,0,0,0,22000,102000,-80000,-80000
2897,王道銀行        ,50000,130000,-80000,0,0,0,0,0,0,0,0,0,0,0,0,0,-80000
2617,台航            ,27000,107000,-80000,0,0,0,0,0,0,0,0,0,0,0,0,0,-80000
053765,智邦富邦96購01  ,0,0,0,0,0,0,0,0,0,-81000,0,0,0,20000,101000,-81000,-81000
03996P,旺宏國泰95售01  ,0,0,0,0,0,0,0,0,0,-81000,0,0,0,650000,731000,-81000,-81000
045373,台化元大92購01  ,0,0,0,0,0,0,0,0,0,-81000,0,0,0,0,81000,-81000,-81000
049009,南亞科麥證94購01,0,0,0,37000,118000,-81000,0,0,0,-81000,0,0,0,37000,118000,-81000,-81000
047438,台光電元大93購06,0,0,0,0,0,0,0,0,0,-81000,0,0,0,1000,82000,-81000,-81000
048386,華新國票94購01  ,0,0,0,0,0,0,0,0,0,-81000,0,0,0,9000,90000,-81000,-81000
051089,旺宏元大96購04  ,0,0,0,0,0,0,0,0,0,-81000,0,0,0,331000,412000,-81000,-81000
051228,聯發科群益95購03,0,0,0,0,0,0,0,0,0,-81000,0,0,0,11000,92000,-81000,-81000
054190,矽創永豐96購01  ,0,0,0,0,0,0,0,0,0,-82000,0,0,0,0,82000,-82000,-82000
053570,京元電統一96購01,0,0,0,0,0,0,0,0,0,-82000,0,0,0,76000,158000,-82000,-82000
052805,晶技元大97購01  ,0,0,0,0,0,0,0,0,0,-82000,0,0,0,137000,219000,-82000,-82000
052711,滬深2X凱基97購01,0,0,0,0,0,0,0,0,0,-82000,0,0,0,5000,87000,-82000,-82000
044823,華邦電台新93購01,0,0,0,0,0,0,0,0,0,-82000,0,0,0,15000,97000,-82000,-82000
03256P,聯發科富邦03售08,0,0,0,0,0,0,0,0,0,-82000,0,0,0,0,82000,-82000,-82000
043066,上銀兆豐93購02  ,0,0,0,0,0,0,0,0,0,-82000,0,0,0,12000,94000,-82000,-82000
042558,瑞昱中信94購01  ,0,0,0,0,0,0,0,0,0,-82000,0,0,0,4000,86000,-82000,-82000
042040,大立光群益93購01,0,0,0,0,0,0,0,0,0,-82000,0,0,0,5000,87000,-82000,-82000
048393,台光電國票93購02,0,0,0,0,0,0,0,0,0,-82000,0,0,0,200000,282000,-82000,-82000
047897,可成群益94購01  ,0,0,0,0,0,0,0,0,0,-82000,0,0,0,122000,204000,-82000,-82000
047946,南亞科統一93購04,0,0,0,0,0,0,0,0,0,-82000,0,0,0,51000,133000,-82000,-82000
047494,華邦電元富96購01,0,0,0,0,0,0,0,0,0,-82000,0,0,0,291000,373000,-82000,-82000
049306,元油2X凱基96購01,0,0,0,0,0,0,0,0,0,-82000,0,0,0,83000,165000,-82000,-82000
051431,群創元富99購02  ,0,0,0,0,0,0,0,0,0,-82000,0,0,0,0,82000,-82000,-82000
051576,台積電元大97購02,0,0,0,0,0,0,0,0,0,-82000,0,0,0,74000,156000,-82000,-82000
050324,訊芯台新94購01  ,0,0,0,0,0,0,0,0,0,-82000,0,0,0,0,82000,-82000,-82000
1316,上曜            ,32000,114000,-82000,0,0,0,0,0,0,0,0,0,0,0,0,0,-82000
052539,華邦電統一95購01,0,0,0,0,0,0,0,0,0,-83000,0,0,0,196000,279000,-83000,-83000
053540,健策永豐96購01  ,0,0,0,0,0,0,0,0,0,-83000,0,0,0,41000,124000,-83000,-83000
053513,義隆群益96購05  ,0,0,0,0,0,0,0,0,0,-83000,0,0,0,30000,113000,-83000,-83000
05394P,聯詠中信95售02  ,0,0,0,0,0,0,0,0,0,-83000,0,0,0,0,83000,-83000,-83000
053634,劍麟永豐96購01  ,0,0,0,0,0,0,0,0,0,-83000,0,0,0,0,83000,-83000,-83000
042280,元石油富邦96購01,0,0,0,0,0,0,0,0,0,-83000,0,0,0,335000,418000,-83000,-83000
03868P,統一凱基93售02  ,0,0,0,0,0,0,0,0,0,-83000,0,0,0,0,83000,-83000,-83000
044960,京元電兆豐93購01,0,0,0,0,0,0,0,0,0,-83000,0,0,0,55000,138000,-83000,-83000
044999,滬深2X永昌93購02,0,0,0,0,0,0,0,0,0,-83000,0,0,0,0,83000,-83000,-83000
049899,台積電元富94購05,0,0,0,0,0,0,0,0,0,-83000,0,0,0,0,83000,-83000,-83000
049086,晶相光凱基94購01,0,0,0,0,0,0,0,0,0,-83000,0,0,0,51000,134000,-83000,-83000
047284,華通統一93購03  ,0,0,0,0,0,0,0,0,0,-83000,0,0,0,23000,106000,-83000,-83000
051395,聯詠兆豐95購01  ,0,0,0,0,0,0,0,0,0,-83000,0,0,0,152000,235000,-83000,-83000
053625,國巨兆豐96購03  ,0,0,0,0,0,0,0,0,0,-84000,0,0,0,117000,201000,-84000,-84000
054330,世芯永豐96購02  ,0,0,0,0,0,0,0,0,0,-84000,0,0,0,0,84000,-84000,-84000
053254,群創國泰98購02  ,0,0,0,0,0,0,0,0,0,-84000,0,0,0,10000,94000,-84000,-84000
051240,台積電元大95購12,0,0,0,0,0,0,0,0,0,-84000,0,0,0,307000,391000,-84000,-84000
050975,楠梓電統一95購01,0,0,0,0,0,0,0,0,0,-84000,0,0,0,40000,124000,-84000,-84000
051962,晶相光永豐95購02,0,0,0,0,0,0,0,0,0,-84000,0,0,0,228000,312000,-84000,-84000
5534,長虹            ,59566,145000,-85434,0,0,0,0,0,0,1000,6000,5000,1000,0,0,0,-84434
053130,聯發科麥證96購01,0,0,0,0,85000,-85000,0,0,0,-85000,0,0,0,0,85000,-85000,-85000
052486,元油反國票96購01,0,0,0,0,0,0,0,0,0,-85000,0,0,0,0,85000,-85000,-85000
054440,TPK台新98購01   ,0,0,0,0,0,0,0,0,0,-85000,0,0,0,0,85000,-85000,-85000
053997,健策群益97購02  ,0,0,0,0,0,0,0,0,0,-85000,0,0,0,45000,130000,-85000,-85000
045537,華新群益94購01  ,0,0,0,0,0,0,0,0,0,-85000,0,0,0,25000,110000,-85000,-85000
03388P,元油2X元富98售02,0,0,0,0,0,0,0,0,0,-85000,0,0,0,10000,95000,-85000,-85000
044562,元油2X凱基92購05,0,0,0,0,0,0,0,0,0,-85000,0,0,0,75000,160000,-85000,-85000
047250,日月光群益94購01,0,0,0,0,0,0,0,0,0,-85000,0,0,0,35000,120000,-85000,-85000
049902,大立光元富94購05,0,0,0,0,0,0,0,0,0,-85000,0,0,0,20000,105000,-85000,-85000
047923,聯發科凱基94購02,0,0,0,0,0,0,0,0,0,-85000,0,0,0,147000,232000,-85000,-85000
047827,東陽元大93購01  ,0,0,0,0,0,0,0,0,0,-85000,0,0,0,20000,105000,-85000,-85000
048506,華通群益94購03  ,0,0,0,0,0,0,0,0,0,-85000,0,0,0,10000,95000,-85000,-85000
046134,致新國泰93購02  ,0,0,0,0,0,0,0,0,0,-85000,0,0,0,35000,120000,-85000,-85000
052011,欣興中信96購01  ,0,0,0,0,0,0,0,0,0,-85000,0,0,0,20000,105000,-85000,-85000
052087,鴻海元大96購09  ,0,0,0,0,0,0,0,0,0,-85000,0,0,0,7000,92000,-85000,-85000
051717,祥碩康和95購01  ,0,0,0,0,0,0,0,0,0,-85000,0,0,0,15000,100000,-85000,-85000
050518,台積電元大94購28,0,0,0,0,0,0,0,0,0,-85000,0,0,0,91000,176000,-85000,-85000
053993,旺宏群益98購02  ,0,0,0,0,0,0,0,0,0,-86000,0,0,0,5000,91000,-86000,-86000
054708,華通統一97購02  ,0,0,0,0,0,0,0,0,0,-86000,0,0,0,0,86000,-86000,-86000
053366,樺漢國泰98購01  ,0,0,0,0,0,0,0,0,0,-86000,0,0,0,158000,244000,-86000,-86000
053523,T50反1中信9A購01,0,0,0,0,0,0,0,0,0,-86000,0,0,0,116000,202000,-86000,-86000
03520P,臺股指國票02售09,0,0,0,0,0,0,0,0,0,-86000,0,0,0,0,86000,-86000,-86000
00701,國泰股利精選30  ,0,0,0,0,0,0,0,0,0,-86000,0,0,0,289000,375000,-86000,-86000
048237,致茂國票94購01  ,0,0,0,0,0,0,0,0,0,-86000,0,0,0,0,86000,-86000,-86000
044190,聯詠富邦93購01  ,0,0,0,0,0,0,0,0,0,-86000,0,0,0,106000,192000,-86000,-86000
044296,嘉聯益凱基93購01,0,0,0,0,0,0,0,0,0,-86000,0,0,0,1000,87000,-86000,-86000
046675,GIS元大93購06   ,0,0,0,0,0,0,0,0,0,-86000,0,0,0,0,86000,-86000,-86000
048687,旺宏群益96購01  ,0,0,0,0,0,0,0,0,0,-86000,0,0,0,6000,92000,-86000,-86000
050263,旺宏元大94購10  ,0,0,0,0,0,0,0,0,0,-86000,0,0,0,134000,220000,-86000,-86000
049420,日電貿凱基94購01,0,0,0,0,0,0,0,0,0,-86000,0,0,0,32000,118000,-86000,-86000
052103,台積電兆豐95購06,0,0,0,0,0,0,0,0,0,-86000,0,0,0,100000,186000,-86000,-86000
052205,台積電中信95購09,0,0,0,0,0,0,0,0,0,-86000,0,0,0,34000,120000,-86000,-86000
051291,聯詠統一95購01  ,0,0,0,0,0,0,0,0,0,-86000,0,0,0,198000,284000,-86000,-86000
051440,鴻海元大95購12  ,0,0,0,0,0,0,0,0,0,-86000,0,0,0,380000,466000,-86000,-86000
08941P,臺股指中信04售04,0,0,0,0,0,0,0,0,0,-86000,0,0,0,0,86000,-86000,-86000
1231,聯華食          ,8000,94810,-86810,0,0,0,0,0,0,0,0,0,0,0,0,0,-86810
052590,祥碩永豐96購01  ,0,0,0,0,0,0,0,0,0,-87000,0,0,0,68000,155000,-87000,-87000
052563,京元電日盛96購01,0,0,0,0,0,0,0,0,0,-87000,0,0,0,57000,144000,-87000,-87000
052712,旺宏凱基96購02  ,0,0,0,0,0,0,0,0,0,-87000,0,0,0,53000,140000,-87000,-87000
052792,大立光兆豐96購01,0,0,0,0,0,0,0,0,0,-87000,0,0,0,0,87000,-87000,-87000
054673,京鼎國泰98購01  ,0,0,0,0,0,0,0,0,0,-87000,0,0,0,0,87000,-87000,-87000
053876,可成永昌98購01  ,0,0,0,0,0,0,0,0,0,-87000,0,0,0,244000,331000,-87000,-87000
044344,傳奇國泰92購01  ,0,0,0,0,0,0,0,0,0,-87000,0,0,0,3000,90000,-87000,-87000
051609,貿聯群益95購03  ,0,0,0,0,0,0,0,0,0,-87000,0,0,0,71000,158000,-87000,-87000
050009,昇陽半永豐94購02,0,0,0,0,0,0,0,0,0,-87000,0,0,0,13000,100000,-87000,-87000
050520,凌陽元大94購02  ,0,0,0,0,0,0,0,0,0,-87000,0,0,0,13000,100000,-87000,-87000
06089P,矽創永豐97售01  ,0,0,0,0,0,0,0,0,0,-87000,0,0,0,0,87000,-87000,-87000
06014P,聯發科富邦97售02,0,0,0,0,0,0,0,0,0,-87000,0,0,0,64000,151000,-87000,-87000
054674,台光電台新97購01,0,0,0,0,0,0,0,0,0,-88000,0,0,0,0,88000,-88000,-88000
053527,創意中信97購01  ,0,0,0,0,0,0,0,0,0,-88000,0,0,0,0,88000,-88000,-88000
053169,貿聯群益97購01  ,0,0,0,0,0,0,0,0,0,-88000,0,0,0,84000,172000,-88000,-88000
04149P,景碩台新93售02  ,0,0,0,0,0,0,0,0,0,-88000,0,0,0,5000,93000,-88000,-88000
04496P,國巨國泰96售02  ,0,0,0,0,0,0,0,0,0,-88000,0,0,0,0,88000,-88000,-88000
047991,元油反元大96購05,0,0,0,0,0,0,0,0,0,-88000,0,0,0,2000,90000,-88000,-88000
050587,緯穎國票94購02  ,0,0,0,0,0,0,0,0,0,-88000,0,0,0,12000,100000,-88000,-88000
050033,日月光元大94購01,0,0,0,0,0,0,0,0,0,-88000,0,0,0,14000,102000,-88000,-88000
049795,華通元大96購02  ,0,0,0,0,0,0,0,0,0,-88000,0,0,0,17000,105000,-88000,-88000
049644,台積電凱基94購21,0,0,0,0,0,0,0,0,0,-88000,0,0,0,4000,92000,-88000,-88000
051293,鴻海元富95購05  ,0,0,0,0,0,0,0,0,0,-88000,0,0,0,42000,130000,-88000,-88000
1590,亞德客-KY       ,409000,509000,-100000,0,0,0,15000,0,15000,-3000,4000,6000,-2000,7000,8000,-1000,-88000
3535,晶彩科          ,20000,108000,-88000,0,0,0,0,0,0,0,0,0,0,0,0,0,-88000
1560,中砂            ,110000,95183,14817,0,0,0,0,0,0,-103000,12000,115000,-103000,0,0,0,-88183
054374,信邦中信96購01  ,0,0,0,0,0,0,0,0,0,-89000,0,0,0,0,89000,-89000,-89000
054155,美律第一96購01  ,0,0,0,0,0,0,0,0,0,-89000,0,0,0,20000,109000,-89000,-89000
046031,建準元大92購03  ,0,0,0,0,0,0,0,0,0,-89000,0,0,0,11000,100000,-89000,-89000
046506,全新元大92購05  ,0,0,0,0,0,0,0,0,0,-89000,0,0,0,10000,99000,-89000,-89000
052128,聯發科日盛95購03,0,0,0,0,0,0,0,0,0,-89000,0,0,0,0,89000,-89000,-89000
05677P,玉晶光群益98售03,0,0,0,0,0,0,0,0,0,-89000,0,0,0,117000,206000,-89000,-89000
2501,國建            ,71000,160307,-89307,0,0,0,0,0,0,0,0,0,0,0,0,0,-89307
053754,英業達元富96購02,0,0,0,0,0,0,0,0,0,-90000,0,0,0,10000,100000,-90000,-90000
054538,台光電國票98購01,0,0,0,0,0,0,0,0,0,-90000,0,0,0,3000,93000,-90000,-90000
05480P,滬深2X凱基96售05,0,0,0,0,0,0,0,0,0,-90000,0,0,0,0,90000,-90000,-90000
048334,A50正2元大96購01,0,0,0,0,0,0,0,0,0,-90000,0,0,0,0,90000,-90000,-90000
044327,大立光元富91購04,0,0,0,0,0,0,0,0,0,-90000,0,0,0,0,90000,-90000,-90000
047896,京元電群益93購01,0,0,0,0,0,0,0,0,0,-90000,0,0,0,0,90000,-90000,-90000
046618,南亞科凱基93購01,0,0,0,0,0,0,0,0,0,-90000,0,0,0,0,90000,-90000,-90000
048394,正崴國票94購01  ,0,0,0,0,0,0,0,0,0,-90000,0,0,0,15000,105000,-90000,-90000
050993,聯發科元大95購05,0,0,0,0,0,0,0,0,0,-90000,0,0,0,0,90000,-90000,-90000
049409,滬深2X凱基96購04,0,0,0,0,0,0,0,0,0,-90000,0,0,0,0,90000,-90000,-90000
049516,光罩國票94購02  ,0,0,0,0,0,0,0,0,0,-90000,0,0,0,60000,150000,-90000,-90000
049851,致伸群益94購03  ,0,0,0,0,0,0,0,0,0,-90000,0,0,0,21000,111000,-90000,-90000
050894,旺宏元大96購03  ,0,0,0,0,0,0,0,0,0,-90000,0,0,0,0,90000,-90000,-90000
2010,春源            ,0,90000,-90000,0,0,0,0,0,0,0,0,0,0,0,0,0,-90000
054429,中石化台新97購01,0,0,0,0,0,0,0,0,0,-91000,0,0,0,19000,110000,-91000,-91000
052477,美律群益98購01  ,0,0,0,0,0,0,0,0,0,-91000,0,0,0,47000,138000,-91000,-91000
043538,元石油國票97購01,0,0,0,0,0,0,0,0,0,-91000,0,0,0,10000,101000,-91000,-91000
048540,百和國票93購01  ,0,0,0,0,0,0,0,0,0,-91000,0,0,0,28000,119000,-91000,-91000
049831,日月光凱基94購01,0,0,0,0,0,0,0,0,0,-91000,0,0,0,0,91000,-91000,-91000
051423,GIS國票97購01   ,0,0,0,0,0,0,0,0,0,-91000,0,0,0,400000,491000,-91000,-91000
05739P,臺股指統一97售02,0,0,0,0,0,0,0,0,0,-91000,0,0,0,16000,107000,-91000,-91000
053031,華新科第一96購01,0,0,0,0,0,0,0,0,0,-92000,0,0,0,38000,130000,-92000,-92000
041421,滬深2X凱基93購01,0,0,0,0,0,0,0,0,0,-92000,0,0,0,2000,94000,-92000,-92000
047961,百和永豐93購03  ,0,0,0,0,0,0,0,0,0,-92000,0,0,0,100000,192000,-92000,-92000
047968,南電國泰94購01  ,0,0,0,0,0,0,0,0,0,-92000,0,0,0,3000,95000,-92000,-92000
048896,凌陽國泰95購01  ,0,0,0,0,0,0,0,0,0,-92000,0,0,0,30000,122000,-92000,-92000
047343,台達電中信95購01,0,0,0,0,0,0,0,0,0,-92000,0,0,0,22000,114000,-92000,-92000
049030,凌華群益94購01  ,0,0,0,0,0,0,0,0,0,-92000,0,0,0,156000,248000,-92000,-92000
049676,美食國票94購01  ,0,0,0,0,0,0,0,0,0,-92000,0,0,0,0,92000,-92000,-92000
050697,冠德凱基96購01  ,0,0,0,0,0,0,0,0,0,-92000,0,0,0,10000,102000,-92000,-92000
05664P,國巨凱基96售09  ,0,0,0,0,0,0,0,0,0,-92000,0,0,0,8000,100000,-92000,-92000
1519,華城            ,27000,114000,-87000,0,0,0,0,0,0,-5000,0,5000,-5000,0,0,0,-92000
052518,道瓊反元大95購02,0,0,0,0,0,0,0,0,0,-93000,0,0,0,0,93000,-93000,-93000
054348,康控國票97購03  ,0,0,0,0,0,0,0,0,0,-93000,0,0,0,17000,110000,-93000,-93000
05479P,華新科台新96售01,0,0,0,0,0,0,0,0,0,-93000,0,0,0,228000,321000,-93000,-93000
054694,聯鈞永豐97購01  ,0,0,0,0,0,0,0,0,0,-93000,0,0,0,0,93000,-93000,-93000
053839,華通統一96購01  ,0,0,0,0,0,0,0,0,0,-93000,0,0,0,0,93000,-93000,-93000
053594,京鼎元大96購02  ,0,0,0,0,0,0,0,0,0,-93000,0,0,0,15000,108000,-93000,-93000
048279,聯鈞永豐93購01  ,0,0,0,0,0,0,0,0,0,-93000,0,0,0,119000,212000,-93000,-93000
047956,麗豐永豐93購02  ,0,0,0,0,0,0,0,0,0,-93000,0,0,0,0,93000,-93000,-93000
049708,滬深2X凱基94購02,0,0,0,0,0,0,0,0,0,-93000,0,0,0,20000,113000,-93000,-93000
049583,台積電元大95購04,0,0,0,0,0,0,0,0,0,-93000,0,0,0,10000,103000,-93000,-93000
052744,聯詠元大97購01  ,0,0,0,0,0,0,0,0,0,-94000,0,0,0,357000,451000,-94000,-94000
043947,致伸兆豐91購01  ,0,0,0,0,0,0,0,0,0,-94000,0,0,0,0,94000,-94000,-94000
044430,上銀元大92購03  ,0,0,0,0,0,0,0,0,0,-94000,0,0,0,2000,96000,-94000,-94000
04808P,訊芯永豐94售02  ,0,0,0,0,0,0,0,0,0,-94000,0,0,0,10000,104000,-94000,-94000
2704,國賓            ,38000,132000,-94000,0,0,0,0,0,0,0,0,0,0,0,0,0,-94000
053699,臺股指元大96購22,0,0,0,0,0,0,0,0,0,-95000,0,0,0,95000,190000,-95000,-95000
043492,大立光統一91購04,0,0,0,0,0,0,0,0,0,-95000,0,0,0,15000,110000,-95000,-95000
045367,新光金兆豐92購01,0,0,0,0,0,0,0,0,0,-95000,0,0,0,70000,165000,-95000,-95000
044779,GIS元大93購05   ,0,0,0,0,0,0,0,0,0,-95000,0,0,0,2000,97000,-95000,-95000
047296,日月光元富96購01,0,0,0,0,0,0,0,0,0,-95000,0,0,0,98000,193000,-95000,-95000
045937,臻鼎群益93購02  ,0,0,0,0,0,0,0,0,0,-95000,0,0,0,110000,205000,-95000,-95000
04676P,彩晶統一94售03  ,0,0,0,0,0,0,0,0,0,-95000,0,0,0,5000,100000,-95000,-95000
046764,亞光凱基93購03  ,0,0,0,0,0,0,0,0,0,-95000,0,0,0,4000,99000,-95000,-95000
049601,矽創元大95購02  ,0,0,0,0,0,0,0,0,0,-95000,0,0,0,9000,104000,-95000,-95000
2545,皇翔            ,35000,129000,-94000,0,0,0,0,0,0,-1000,0,1000,-1000,0,0,0,-95000
3533,嘉澤            ,140000,51000,89000,0,0,0,0,119000,-119000,-65000,5000,54000,-49000,0,16000,-16000,-95000
048069,南亞科元富95購02,0,0,0,0,0,0,0,0,0,-96000,0,0,0,4000,100000,-96000,-96000
048370,可成統一93購04  ,0,0,0,0,0,0,0,0,0,-96000,0,0,0,70000,166000,-96000,-96000
047341,貿聯第一93購01  ,0,0,0,0,0,0,0,0,0,-96000,0,0,0,0,96000,-96000,-96000
04965P,日月光元大94售02,0,0,0,0,0,0,0,0,0,-96000,0,0,0,23000,119000,-96000,-96000
049416,美律凱基94購04  ,0,0,0,0,0,0,0,0,0,-96000,0,0,0,80000,176000,-96000,-96000
049442,滬深2X統一99購01,0,0,0,0,0,0,0,0,0,-96000,0,0,0,5000,101000,-96000,-96000
051266,國巨富邦99購01  ,0,0,0,0,0,0,0,0,0,-96000,0,0,0,131000,227000,-96000,-96000
051231,健策群益97購01  ,0,0,0,0,0,0,0,0,0,-96000,0,0,0,70000,166000,-96000,-96000
051105,台光電國票96購01,0,0,0,0,0,0,0,0,0,-96000,0,0,0,0,96000,-96000,-96000
05906P,國巨元富96售05  ,0,0,0,0,0,0,0,0,0,-96000,0,0,0,0,96000,-96000,-96000
054331,世芯永豐96購03  ,0,0,0,0,0,0,0,0,0,-97000,0,0,0,5000,102000,-97000,-97000
05438P,康控永豐95售05  ,0,0,0,0,0,0,0,0,0,-97000,0,0,0,14000,111000,-97000,-97000
042227,元油2X永豐93購01,0,0,0,0,0,0,0,0,0,-97000,0,0,0,4000,101000,-97000,-97000
048052,力成中信93購01  ,0,0,0,0,0,0,0,0,0,-97000,0,0,0,3000,100000,-97000,-97000
045874,東元元富92購01  ,0,0,0,0,0,0,0,0,0,-97000,0,0,0,137000,234000,-97000,-97000
051685,台光電凱基95購01,0,0,0,0,0,0,0,0,0,-97000,0,0,0,11000,108000,-97000,-97000
06080P,景碩群益98售02  ,0,0,0,0,0,0,0,0,0,-97000,0,0,0,0,97000,-97000,-97000
054284,和大元大96購03  ,0,0,0,0,0,0,0,0,0,-98000,0,0,0,23000,121000,-98000,-98000
03937P,聯詠元大93售08  ,0,0,0,0,0,0,0,0,0,-98000,0,0,0,102000,200000,-98000,-98000
03947P,新光金國泰94售01,0,0,0,0,0,0,0,0,0,-98000,0,0,0,0,98000,-98000,-98000
045184,京元電統一93購01,0,0,0,0,0,0,0,0,0,-98000,0,0,0,53000,151000,-98000,-98000
044065,亞光元大92購02  ,0,0,0,0,0,0,0,0,0,-98000,0,0,0,2000,100000,-98000,-98000
049147,美律元大94購02  ,0,0,0,0,0,0,0,0,0,-98000,0,0,0,70000,168000,-98000,-98000
047078,上海銀兆豐93購01,0,0,0,0,0,0,0,0,0,-98000,0,0,0,0,98000,-98000,-98000
049556,智易元富94購01  ,0,0,0,0,0,0,0,0,0,-98000,0,0,0,0,98000,-98000,-98000
054405,樺漢康和96購01  ,0,0,0,0,0,0,0,0,0,-99000,0,0,0,1000,100000,-99000,-99000
052344,台表科凱基98購01,0,0,0,0,0,0,0,0,0,-99000,0,0,0,93000,192000,-99000,-99000
053153,大立光元大99購02,0,0,0,0,0,0,0,0,0,-99000,0,0,0,267000,366000,-99000,-99000
046335,矽創元大92購04  ,0,0,0,0,0,0,0,0,0,-99000,0,0,0,1000,100000,-99000,-99000
044835,南亞科元大91購14,0,0,0,0,0,0,0,0,0,-99000,0,0,0,0,99000,-99000,-99000
044833,亞德客元大91購06,0,0,0,0,0,0,0,0,0,-99000,0,0,0,0,99000,-99000,-99000
048064,可成統一93購02  ,0,0,0,0,0,0,0,0,0,-99000,0,0,0,310000,409000,-99000,-99000
049997,聯發科永豐94購04,0,0,0,0,0,0,0,0,0,-99000,0,0,0,0,99000,-99000,-99000
05084P,嘉聯益永豐95售02,0,0,0,0,0,0,0,0,0,-99000,0,0,0,27000,126000,-99000,-99000
050416,高股息凱基96購02,0,0,0,0,0,0,0,0,0,-99000,0,0,0,1000,100000,-99000,-99000
050976,台光電統一95購01,0,0,0,0,0,0,0,0,0,-99000,0,0,0,108000,207000,-99000,-99000
1104,環泥            ,21000,170000,-149000,0,0,0,0,0,0,50000,50000,0,50000,0,0,0,-99000
053009,大成鋼統一96購02,0,0,0,0,0,0,0,0,0,-100000,0,0,0,80000,180000,-100000,-100000
053440,台積電凱基96購12,0,0,0,0,0,0,0,0,0,-100000,0,0,0,2000,102000,-100000,-100000
053388,群創元大9C購02  ,0,0,0,0,0,0,0,0,0,-100000,0,0,0,0,100000,-100000,-100000
052360,FB上証國票96購01,0,0,0,0,0,0,0,0,0,-100000,0,0,0,0,100000,-100000,-100000
052291,鴻海元富97購02  ,0,0,0,0,0,0,0,0,0,-100000,0,0,0,100000,200000,-100000,-100000
052448,新光金元大96購03,0,0,0,0,0,0,0,0,0,-100000,0,0,0,0,100000,-100000,-100000
052738,聯電元大98購02  ,0,0,0,0,0,0,0,0,0,-100000,0,0,0,0,100000,-100000,-100000
052630,滬深2X日盛96購01,0,0,0,0,0,0,0,0,0,-100000,0,0,0,0,100000,-100000,-100000
054355,上海銀富邦98購01,0,0,0,0,0,0,0,0,0,-100000,0,0,0,0,100000,-100000,-100000
05462P,美律亞東97售01  ,0,0,0,0,0,0,0,0,0,-100000,0,0,0,0,100000,-100000,-100000
054581,訊芯元大97購02  ,0,0,0,0,0,0,0,0,0,-100000,0,0,0,41000,141000,-100000,-100000
054800,訊芯群益99購01  ,0,0,0,0,0,0,0,0,0,-100000,0,0,0,0,100000,-100000,-100000
053615,光罩群益96購01  ,0,0,0,0,0,0,0,0,0,-100000,0,0,0,0,100000,-100000,-100000
053910,嘉聯益凱基98購01,0,0,0,0,0,0,0,0,0,-100000,0,0,0,0,100000,-100000,-100000
044771,南亞科元大91購13,0,0,0,0,0,0,0,0,0,-100000,0,0,0,0,100000,-100000,-100000
045083,智原元大92購01  ,0,0,0,0,0,0,0,0,0,-100000,0,0,0,6000,106000,-100000,-100000
04534P,臻鼎元富94售03  ,0,0,0,0,0,0,0,0,0,-100000,0,0,0,0,100000,-100000,-100000
043984,京元電元大91購04,0,0,0,0,0,0,0,0,0,-100000,0,0,0,0,100000,-100000,-100000
044050,中石化元大91購01,0,0,0,0,0,0,0,0,0,-100000,0,0,0,0,100000,-100000,-100000
046243,麗豐中信92購01  ,0,0,0,0,0,0,0,0,0,-100000,0,0,0,0,100000,-100000,-100000
043856,GIS富邦92購01   ,0,0,0,0,0,0,0,0,0,-100000,0,0,0,0,100000,-100000,-100000
03922P,中磊凱基93售01  ,0,0,0,0,0,0,0,0,0,-100000,0,0,0,0,100000,-100000,-100000
00635U,元大S&P黃金     ,232000,0,232000,0,0,0,0,0,0,-332000,0,0,0,131000,463000,-332000,-100000
03651P,統一元大92售01  ,0,0,0,0,0,0,0,0,0,-100000,0,0,0,0,100000,-100000,-100000
043028,南電元大92購01  ,0,0,0,0,0,0,0,0,0,-100000,0,0,0,0,100000,-100000,-100000
043454,上銀元大92購02  ,0,0,0,0,0,0,0,0,0,-100000,0,0,0,0,100000,-100000,-100000
044564,喬山凱基92購01  ,0,0,0,0,0,0,0,0,0,-100000,0,0,0,0,100000,-100000,-100000
044493,京元電元大92購02,0,0,0,0,0,0,0,0,0,-100000,0,0,0,0,100000,-100000,-100000
044646,旺宏群益93購01  ,0,0,0,0,0,0,0,0,0,-100000,0,0,0,50000,150000,-100000,-100000
044668,滬深2X富邦91購01,0,0,0,0,0,0,0,0,0,-100000,0,0,0,0,100000,-100000,-100000
044697,美律元大93購02  ,0,0,0,0,0,0,0,0,0,-100000,0,0,0,17000,117000,-100000,-100000
044694,道瓊反元大94購02,0,0,0,0,0,0,0,0,0,-100000,0,0,0,0,100000,-100000,-100000
046155,道瓊反群益94購01,0,0,0,0,0,0,0,0,0,-100000,0,0,0,0,100000,-100000,-100000
047986,明泰群益93購01  ,0,0,0,0,0,0,0,0,0,-100000,0,0,0,0,100000,-100000,-100000
04799P,健策元大94售03  ,0,0,0,0,0,0,0,0,0,-100000,0,0,0,0,100000,-100000,-100000
046043,日月光元大92購02,0,0,0,0,0,0,0,0,0,-100000,0,0,0,0,100000,-100000,-100000
048402,聯茂兆豐95購01  ,0,0,0,0,0,0,0,0,0,-100000,0,0,0,100000,200000,-100000,-100000
04839P,大立光元大94售17,0,0,0,0,0,0,0,0,0,-100000,0,0,0,0,100000,-100000,-100000
048521,華通統一93購05  ,0,0,0,0,0,0,0,0,0,-100000,0,0,0,5000,105000,-100000,-100000
048470,神基永豐93購01  ,0,0,0,0,0,0,0,0,0,-100000,0,0,0,0,100000,-100000,-100000
046388,GIS凱基92購02   ,0,0,0,0,0,0,0,0,0,-100000,0,0,0,0,100000,-100000,-100000
046372,東元凱基92購01  ,0,0,0,0,0,0,0,0,0,-100000,0,0,0,0,100000,-100000,-100000
047966,華通國泰94購01  ,0,0,0,0,0,0,0,0,0,-100000,0,0,0,0,100000,-100000,-100000
04797P,華新科元大94售04,0,0,0,0,0,0,0,0,0,-100000,0,0,0,0,100000,-100000,-100000
046563,奇鋐凱基92購01  ,0,0,0,0,0,0,0,0,0,-100000,0,0,0,30000,130000,-100000,-100000
048616,智伸科凱基93購07,0,0,0,0,0,0,0,0,0,-100000,0,0,0,0,100000,-100000,-100000
04876P,台光電中信94售02,0,0,0,0,0,0,0,0,0,-100000,0,0,0,0,100000,-100000,-100000
046479,群創元富94購01  ,0,0,0,0,0,0,0,0,0,-100000,0,0,0,0,100000,-100000,-100000
048777,瀚宇博凱基94購02,0,0,0,0,0,0,0,0,0,-100000,0,0,0,0,100000,-100000,-100000
047534,聯茂元大93購05  ,0,0,0,0,0,0,0,0,0,-100000,0,0,0,0,100000,-100000,-100000
049177,美律凱基94購02  ,0,0,0,0,0,0,0,0,0,-100000,0,0,0,57000,157000,-100000,-100000
049957,智邦統一94購01  ,0,0,0,0,0,0,0,0,0,-100000,0,0,0,48000,148000,-100000,-100000
05095P,景碩元大95售01  ,0,0,0,0,0,0,0,0,0,-100000,0,0,0,100000,200000,-100000,-100000
051246,美律元大96購01  ,0,0,0,0,0,0,0,0,0,-100000,0,0,0,0,100000,-100000,-100000
051517,可成凱基95購08  ,0,0,0,0,0,0,0,0,0,-100000,0,0,0,0,100000,-100000,-100000
052005,矽力國泰97購02  ,0,0,0,0,0,0,0,0,0,-100000,0,0,0,10000,110000,-100000,-100000
050405,新光金麥證94購01,0,0,0,20000,120000,-100000,0,0,0,-100000,0,0,0,20000,120000,-100000,-100000
050731,昇陽半國票96購01,0,0,0,0,0,0,0,0,0,-100000,0,0,0,0,100000,-100000,-100000
050123,群臺反凱基96購01,0,0,0,0,0,0,0,0,0,-100000,0,0,0,0,100000,-100000,-100000
049502,訊芯元大94購01  ,0,0,0,0,0,0,0,0,0,-100000,0,0,0,0,100000,-100000,-100000
04949P,致新元大94售04  ,0,0,0,0,0,0,0,0,0,-100000,0,0,0,100000,200000,-100000,-100000
049664,聯發科永豐94購03,0,0,0,0,0,0,0,0,0,-100000,0,0,0,0,100000,-100000,-100000
049675,台光電國票95購01,0,0,0,0,0,0,0,0,0,-100000,0,0,0,0,100000,-100000,-100000
049641,台達電凱基94購08,0,0,0,0,0,0,0,0,0,-100000,0,0,0,0,100000,-100000,-100000
08163P,T50正2中信95售01,0,0,0,0,0,0,0,0,0,-100000,0,0,0,0,100000,-100000,-100000
06077P,GIS凱基97售02   ,0,0,0,0,0,0,0,0,0,-100000,0,0,0,0,100000,-100000,-100000
06031P,新光金兆豐96售02,0,0,0,0,0,0,0,0,0,-100000,0,0,0,0,100000,-100000,-100000
053296,貿聯中信98購01  ,0,0,0,0,0,0,0,0,0,-101000,0,0,0,6000,107000,-101000,-101000
052928,美律元大98購01  ,0,0,0,0,0,0,0,0,0,-101000,0,0,0,75000,176000,-101000,-101000
044212,鴻海凱基93購04  ,0,0,0,0,0,0,0,0,0,-101000,0,0,0,13000,114000,-101000,-101000
050516,華通元大95購05  ,0,0,0,0,0,0,0,0,0,-101000,0,0,0,502000,603000,-101000,-101000
051405,世芯永豐95購01  ,0,0,0,0,0,0,0,0,0,-101000,0,0,0,252000,353000,-101000,-101000
052985,美律元大96購02  ,0,0,0,0,0,0,0,0,0,-102000,0,0,0,34000,136000,-102000,-102000
053787,健策元大97購02  ,0,0,0,0,0,0,0,0,0,-102000,0,0,0,186000,288000,-102000,-102000
044264,大立光富邦93購03,0,0,0,0,0,0,0,0,0,-102000,0,0,0,0,102000,-102000,-102000
044834,旺宏元大93購02  ,0,0,0,0,0,0,0,0,0,-102000,0,0,0,183000,285000,-102000,-102000
03321P,智邦凱基03售01  ,0,0,0,0,0,0,0,0,0,-102000,0,0,0,0,102000,-102000,-102000
047437,旺宏元大94購02  ,0,0,0,0,0,0,0,0,0,-102000,0,0,0,126000,228000,-102000,-102000
051126,訊連群益95購01  ,0,0,0,0,0,0,0,0,0,-102000,0,0,0,0,102000,-102000,-102000
2538,基泰            ,29000,131000,-102000,0,0,0,0,0,0,0,0,0,0,0,0,0,-102000
054195,亞泥國泰98購01  ,0,0,0,0,0,0,0,0,0,-103000,0,0,0,0,103000,-103000,-103000
053458,聯詠國泰97購01  ,0,0,0,0,0,0,0,0,0,-103000,0,0,0,110000,213000,-103000,-103000
052535,日月光國泰96購01,0,0,0,0,0,0,0,0,0,-103000,0,0,0,1000,104000,-103000,-103000
00730,富邦臺灣優質高息,0,0,0,0,0,0,0,0,0,-103000,0,0,0,197000,300000,-103000,-103000
047676,臺股指元富99購01,0,0,0,0,0,0,0,0,0,-103000,0,0,0,0,103000,-103000,-103000
050947,聯發科群益95購01,0,0,0,0,0,0,0,0,0,-103000,0,0,0,51000,154000,-103000,-103000
051617,台積電凱基95購14,0,0,0,0,0,0,0,0,0,-103000,0,0,0,12000,115000,-103000,-103000
050758,聯發科元富9B購01,0,0,0,0,0,0,0,0,0,-103000,0,0,0,7000,110000,-103000,-103000
050804,和大日盛95購01  ,0,0,0,0,0,0,0,0,0,-103000,0,0,0,172000,275000,-103000,-103000
050055,道瓊反凱基95購01,0,0,0,0,0,0,0,0,0,-103000,0,0,0,0,103000,-103000,-103000
05939P,聯發科凱基96售20,0,0,0,0,0,0,0,0,0,-103000,0,0,0,10000,113000,-103000,-103000
052607,大立光元大96購03,0,0,0,0,0,0,0,0,0,-104000,0,0,0,59000,163000,-104000,-104000
052829,上銀群益96購01  ,0,0,0,0,0,0,0,0,0,-104000,0,0,0,35000,139000,-104000,-104000
049585,旺宏元大95購02  ,0,0,0,0,0,0,0,0,0,-104000,0,0,0,213000,317000,-104000,-104000
049529,華新科中信95購01,0,0,0,0,0,0,0,0,0,-104000,0,0,0,205000,309000,-104000,-104000
050778,瑞儀元大96購01  ,0,0,0,0,0,0,0,0,0,-104000,0,0,0,74000,178000,-104000,-104000
050390,聯發科統一94購09,0,0,0,0,0,0,0,0,0,-104000,0,0,0,0,104000,-104000,-104000
051163,鴻海元大95購04  ,0,0,0,0,0,0,0,0,0,-104000,0,0,0,788000,892000,-104000,-104000
051465,鴻海富邦97購02  ,0,0,0,0,0,0,0,0,0,-104000,0,0,0,0,104000,-104000,-104000
2402,毅嘉            ,24000,128000,-104000,0,0,0,0,0,0,0,0,0,0,0,0,0,-104000
053164,台光電群益96購02,0,0,0,0,0,0,0,0,0,-105000,0,0,0,21000,126000,-105000,-105000
053651,台光電凱基98購01,0,0,0,0,0,0,0,0,0,-105000,0,0,0,60000,165000,-105000,-105000
03177P,國巨群益01售12  ,0,0,0,0,0,0,0,0,0,-105000,0,0,0,115000,220000,-105000,-105000
047492,儒鴻元富93購01  ,0,0,0,0,0,0,0,0,0,-105000,0,0,0,9000,114000,-105000,-105000
047198,奇鋐統一93購01  ,0,0,0,0,0,0,0,0,0,-105000,0,0,0,150000,255000,-105000,-105000
048038,樺漢凱基93購03  ,0,0,0,0,0,0,0,0,0,-105000,0,0,0,45000,150000,-105000,-105000
047379,元油2X元大96購03,0,0,0,0,0,0,0,0,0,-105000,0,0,0,0,105000,-105000,-105000
051764,欣興元大95購07  ,0,0,0,0,0,0,0,0,0,-105000,0,0,0,0,105000,-105000,-105000
049649,信邦凱基94購01  ,0,0,0,0,0,0,0,0,0,-105000,0,0,0,0,105000,-105000,-105000
049695,新光金元大9A購01,0,0,0,0,0,0,0,0,0,-105000,0,0,0,0,105000,-105000,-105000
050173,旺宏元大96購02  ,0,0,0,0,0,0,0,0,0,-105000,0,0,0,655000,760000,-105000,-105000
6226,光鼎            ,9000,114000,-105000,0,0,0,0,0,0,0,0,0,0,0,0,0,-105000
053776,台積電元大96購19,0,0,0,0,0,0,0,0,0,-106000,0,0,0,250000,356000,-106000,-106000
054798,超眾群益97購01  ,0,0,0,0,0,0,0,0,0,-106000,0,0,0,0,106000,-106000,-106000
052879,滬深2X凱基97購02,0,0,0,0,0,0,0,0,0,-106000,0,0,0,0,106000,-106000,-106000
03162P,泰碩元大01售02  ,0,0,0,0,0,0,0,0,0,-106000,0,0,0,0,106000,-106000,-106000
052003,泰碩國泰97購02  ,0,0,0,0,0,0,0,0,0,-106000,0,0,0,54000,160000,-106000,-106000
1437,勤益控          ,27000,133000,-106000,0,0,0,0,0,0,0,0,0,0,0,0,0,-106000
054573,漢唐元大98購01  ,0,0,0,0,0,0,0,0,0,-107000,0,0,0,0,107000,-107000,-107000
054415,奇力新元大96購06,0,0,0,0,0,0,0,0,0,-107000,0,0,0,129000,236000,-107000,-107000
048404,大立光群益93購11,0,0,0,0,0,0,0,0,0,-107000,0,0,0,27000,134000,-107000,-107000
051937,廣達群益95購01  ,0,0,0,0,0,0,0,0,0,-107000,0,0,0,50000,157000,-107000,-107000
050519,旺宏元大95購03  ,0,0,0,0,0,0,0,0,0,-107000,0,0,0,246000,353000,-107000,-107000
06003P,亞光康和96售02  ,0,0,0,0,0,0,0,0,0,-107000,0,0,0,0,107000,-107000,-107000
053293,聯發科中信9B購01,0,0,0,0,0,0,0,0,0,-108000,0,0,0,0,108000,-108000,-108000
044735,光磊國泰93購01  ,0,0,0,0,0,0,0,0,0,-108000,0,0,0,62000,170000,-108000,-108000
045764,智易統一94購01  ,0,0,0,0,0,0,0,0,0,-108000,0,0,0,0,108000,-108000,-108000
043671,GIS元大93購03   ,0,0,0,0,0,0,0,0,0,-108000,0,0,0,0,108000,-108000,-108000
2049,上銀            ,734000,834969,-100969,0,0,0,40000,0,40000,-48000,22000,75000,-53000,12000,7000,5000,-108969
054631,台郡凱基98購02  ,0,0,0,0,0,0,0,0,0,-109000,0,0,0,1000,110000,-109000,-109000
042930,大立光中信94購01,0,0,0,0,0,0,0,0,0,-109000,0,0,0,0,109000,-109000,-109000
050533,致新元大94購03  ,0,0,0,0,0,0,0,0,0,-109000,0,0,0,6000,115000,-109000,-109000
050201,光磊群益94購01  ,0,0,0,0,0,0,0,0,0,-109000,0,0,0,0,109000,-109000,-109000
051049,亞德客群益95購01,0,0,0,0,0,0,0,0,0,-109000,0,0,0,20000,129000,-109000,-109000
054206,鴻海國票99購01  ,0,0,0,0,0,0,0,0,0,-110000,0,0,0,0,110000,-110000,-110000
054091,晶豪科群益96購01,0,0,0,0,0,0,0,0,0,-110000,0,0,0,1000,111000,-110000,-110000
053931,楠梓電統一96購01,0,0,0,0,0,0,0,0,0,-110000,0,0,0,0,110000,-110000,-110000
053973,晶豪科元大96購01,0,0,0,0,0,0,0,0,0,-110000,0,0,0,3000,113000,-110000,-110000
053290,元油反中信97購01,0,0,0,0,0,0,0,0,0,-110000,0,0,0,10000,120000,-110000,-110000
053219,祥碩凱基96購01  ,0,0,0,0,0,0,0,0,0,-110000,0,0,0,20000,130000,-110000,-110000
05237P,為升永豐95售01  ,0,0,0,0,0,0,0,0,0,-110000,0,0,0,10000,120000,-110000,-110000
044648,奇鋐群益93購01  ,0,0,0,0,0,0,0,0,0,-110000,0,0,0,0,110000,-110000,-110000
044303,群創兆豐92購01  ,0,0,0,0,0,0,0,0,0,-110000,0,0,0,199000,309000,-110000,-110000
044813,為升兆豐93購02  ,0,0,0,0,0,0,0,0,0,-110000,0,0,0,0,110000,-110000,-110000
048066,樺漢統一93購01  ,0,0,0,0,0,0,0,0,0,-110000,0,0,0,40000,150000,-110000,-110000
047034,東陽群益93購01  ,0,0,0,0,0,0,0,0,0,-110000,0,0,0,0,110000,-110000,-110000
045999,華通統一92購02  ,0,0,0,0,0,0,0,0,0,-110000,0,0,0,0,110000,-110000,-110000
047212,宏達電富邦97購01,0,0,0,0,0,0,0,0,0,-110000,0,0,0,0,110000,-110000,-110000
047591,訊芯永豐93購02  ,0,0,0,0,0,0,0,0,0,-110000,0,0,0,82000,192000,-110000,-110000
049934,緯穎元大94購08  ,0,0,0,0,0,0,0,0,0,-110000,0,0,0,81000,191000,-110000,-110000
049027,智易群益94購02  ,0,0,0,0,0,0,0,0,0,-110000,0,0,0,0,110000,-110000,-110000
051689,智易凱基95購02  ,0,0,0,0,0,0,0,0,0,-110000,0,0,0,0,110000,-110000,-110000
050800,百和中信95購01  ,0,0,0,0,0,0,0,0,0,-110000,0,0,0,0,110000,-110000,-110000
050749,道瓊銀統一96購03,0,0,0,0,0,0,0,0,0,-110000,0,0,0,0,110000,-110000,-110000
052400,聯詠凱基97購01  ,0,0,0,0,0,0,0,0,0,-111000,0,0,0,50000,161000,-111000,-111000
052581,訊芯元富98購01  ,0,0,0,0,0,0,0,0,0,-111000,0,0,0,10000,121000,-111000,-111000
052438,瑞儀富邦95購01  ,0,0,0,0,0,0,0,0,0,-111000,0,0,0,0,111000,-111000,-111000
053257,華通富邦97購01  ,0,0,0,0,0,0,0,0,0,-111000,0,0,0,56000,167000,-111000,-111000
045054,聯發科元富98購02,0,0,0,0,0,0,0,0,0,-111000,0,0,0,32000,143000,-111000,-111000
048277,建準永豐93購02  ,0,0,0,0,0,0,0,0,0,-111000,0,0,0,5000,116000,-111000,-111000
047292,台光電元富96購01,0,0,0,0,0,0,0,0,0,-111000,0,0,0,9000,120000,-111000,-111000
04716P,中石化凱基94售01,0,0,0,0,0,0,0,0,0,-111000,0,0,0,14000,125000,-111000,-111000
048667,旺宏永豐94購02  ,0,0,0,0,0,0,0,0,0,-111000,0,0,0,429000,540000,-111000,-111000
050740,旺宏永豐94購03  ,0,0,0,0,0,0,0,0,0,-111000,0,0,0,0,111000,-111000,-111000
051083,A50正2元大98購01,0,0,0,0,0,0,0,0,0,-111000,0,0,0,13000,124000,-111000,-111000
051157,華新科富邦98購01,0,0,0,0,0,0,0,0,0,-111000,0,0,0,401000,512000,-111000,-111000
08886P,台積電富邦04售04,0,0,0,0,0,0,0,0,0,-111000,0,0,0,0,111000,-111000,-111000
05725P,嘉聯益永豐96售02,0,0,0,0,0,0,0,0,0,-111000,0,0,0,31000,142000,-111000,-111000
2607,榮運            ,58000,169288,-111288,0,0,0,0,0,0,0,0,0,0,0,0,0,-111288
048248,聯發科兆豐95購01,0,0,0,0,0,0,0,0,0,-112000,0,0,0,0,112000,-112000,-112000
043599,宏達電元大93購03,0,0,0,0,0,0,0,0,0,-112000,0,0,0,20000,132000,-112000,-112000
048769,聯鈞凱基94購01  ,0,0,0,0,0,0,0,0,0,-112000,0,0,0,40000,152000,-112000,-112000
047136,潤泰全凱基94購01,0,0,0,0,0,0,0,0,0,-112000,0,0,0,68000,180000,-112000,-112000
047967,南亞科國泰95購01,0,0,0,0,0,0,0,0,0,-112000,0,0,0,96000,208000,-112000,-112000
051732,華通國票97購01  ,0,0,0,0,0,0,0,0,0,-112000,0,0,0,186000,298000,-112000,-112000
050331,鈺齊永豐94購02  ,0,0,0,0,0,0,0,0,0,-112000,0,0,0,12000,124000,-112000,-112000
050149,東元群益94購01  ,0,0,0,0,0,0,0,0,0,-112000,0,0,0,177000,289000,-112000,-112000
2106,建大            ,62000,174000,-112000,0,0,0,0,0,0,0,0,0,0,0,0,0,-112000
8464,億豐            ,135000,247300,-112300,0,0,0,0,0,0,0,0,0,0,0,0,0,-112300
053547,台積電凱基96購14,0,0,0,0,0,0,0,0,0,-113000,0,0,0,49000,162000,-113000,-113000
044799,華邦電凱基93購01,0,0,0,0,0,0,0,0,0,-113000,0,0,0,1000,114000,-113000,-113000
045355,聯鈞凱基92購01  ,0,0,0,0,0,0,0,0,0,-113000,0,0,0,8000,121000,-113000,-113000
04618P,電子類群益94售02,0,0,0,0,0,0,0,0,0,-113000,0,0,0,5000,118000,-113000,-113000
05060P,台達電富邦97售02,0,0,0,0,0,0,0,0,0,-113000,0,0,0,195000,308000,-113000,-113000
051666,旺宏元大96購05  ,0,0,0,0,0,0,0,0,0,-113000,0,0,0,37000,150000,-113000,-113000
051137,聯詠永豐95購01  ,0,0,0,0,0,0,0,0,0,-113000,0,0,0,68000,181000,-113000,-113000
6141,柏承            ,166000,279000,-113000,0,0,0,0,0,0,0,0,0,0,0,0,0,-113000
3504,揚明光          ,64000,163000,-99000,0,0,0,0,0,0,-14000,0,0,0,14000,28000,-14000,-113000
053537,玉晶光永豐98購02,0,0,0,0,0,0,0,0,0,-114000,0,0,0,173000,287000,-114000,-114000
054536,宏達電富邦97購03,0,0,0,0,0,0,0,0,0,-114000,0,0,0,0,114000,-114000,-114000
047231,大立光凱基95購03,0,0,0,0,0,0,0,0,0,-114000,0,0,0,19000,133000,-114000,-114000
048657,大成鋼統一93購04,0,0,0,0,0,0,0,0,0,-114000,0,0,0,16000,130000,-114000,-114000
049946,智邦兆豐95購01  ,0,0,0,0,0,0,0,0,0,-114000,0,0,0,1000,115000,-114000,-114000
051553,牧德永豐96購02  ,0,0,0,0,0,0,0,0,0,-114000,0,0,0,153000,267000,-114000,-114000
052186,宏達電群益95購04,0,0,0,0,0,0,0,0,0,-114000,0,0,0,5000,119000,-114000,-114000
049668,大立光國泰96購02,0,0,0,0,0,0,0,0,0,-114000,0,0,0,48000,162000,-114000,-114000
054112,台積電麥證96購02,0,0,0,30000,145000,-115000,0,0,0,-115000,0,0,0,30000,145000,-115000,-115000
052610,貿聯元大97購01  ,0,0,0,0,0,0,0,0,0,-115000,0,0,0,227000,342000,-115000,-115000
048346,智易元大95購01  ,0,0,0,0,0,0,0,0,0,-115000,0,0,0,0,115000,-115000,-115000
049255,旺宏元大97購02  ,0,0,0,0,0,0,0,0,0,-115000,0,0,0,121000,236000,-115000,-115000
049961,GIS統一94購01   ,0,0,0,0,0,0,0,0,0,-115000,0,0,0,65000,180000,-115000,-115000
049848,聯發科群益94購06,0,0,0,0,0,0,0,0,0,-115000,0,0,0,14000,129000,-115000,-115000
3712,永崴投控        ,45000,160000,-115000,0,0,0,0,0,0,0,0,0,0,0,0,0,-115000
06004P,奇力新永豐96售02,0,0,0,0,0,0,0,0,0,-115000,0,0,0,190000,305000,-115000,-115000
052919,鈺齊富邦98購01  ,0,0,0,0,0,0,0,0,0,-116000,0,0,0,44000,160000,-116000,-116000
048313,南亞科凱基93購06,0,0,0,0,0,0,0,0,0,-116000,0,0,0,0,116000,-116000,-116000
049198,聯鈞永豐94購01  ,0,0,0,0,0,0,0,0,0,-116000,0,0,0,54000,170000,-116000,-116000
048172,祥碩永豐93購02  ,0,0,0,0,0,0,0,0,0,-116000,0,0,0,0,116000,-116000,-116000
051308,GIS凱基95購04   ,0,0,0,0,0,0,0,0,0,-116000,0,0,0,34000,150000,-116000,-116000
3008,大立光          ,533280,470705,62575,0,0,0,1000,161000,-160000,-19000,15000,42000,-27000,14000,6000,8000,-116425
052880,台積電凱基96購06,0,0,0,0,0,0,0,0,0,-117000,0,0,0,17000,134000,-117000,-117000
04503P,元油2X元富98售09,0,0,0,0,0,0,0,0,0,-117000,0,0,0,0,117000,-117000,-117000
03926P,麗豐元大93售02  ,0,0,0,0,0,0,0,0,0,-117000,0,0,0,0,117000,-117000,-117000
049291,華通群益94購04  ,0,0,0,0,0,0,0,0,0,-117000,0,0,0,0,117000,-117000,-117000
048912,牧德富邦94購01  ,0,0,0,0,0,0,0,0,0,-117000,0,0,0,227000,344000,-117000,-117000
052161,義隆永豐95購03  ,0,0,0,0,0,0,0,0,0,-117000,0,0,0,18000,135000,-117000,-117000
050744,健策永豐94購04  ,0,0,0,0,0,0,0,0,0,-117000,0,0,0,91000,208000,-117000,-117000
3047,訊舟            ,28000,145000,-117000,0,0,0,0,0,0,0,0,0,0,0,0,0,-117000
2484,希華            ,36000,160000,-124000,0,0,0,0,0,0,7000,7000,0,7000,0,0,0,-117000
6672,騰輝電子-KY     ,16000,133000,-117000,0,0,0,0,0,0,0,0,0,0,0,0,0,-117000
053322,京鼎群益97購01  ,0,0,0,0,0,0,0,0,0,-118000,0,0,0,54000,172000,-118000,-118000
054559,台光電群益99購01,0,0,0,0,0,0,0,0,0,-118000,0,0,0,16000,134000,-118000,-118000
05536P,奇力新元大96售03,0,0,0,0,0,0,0,0,0,-118000,0,0,0,708000,826000,-118000,-118000
041753,大立光兆豐92購01,0,0,0,0,0,0,0,0,0,-118000,0,0,0,0,118000,-118000,-118000
047783,聯茂國泰94購02  ,0,0,0,0,0,0,0,0,0,-118000,0,0,0,0,118000,-118000,-118000
048196,聯發科元大93購24,0,0,0,0,0,0,0,0,0,-118000,0,0,0,43000,161000,-118000,-118000
049045,上海銀兆豐94購01,0,0,0,0,0,0,0,0,0,-118000,0,0,0,0,118000,-118000,-118000
054503,京鼎永豐96購04  ,0,0,0,0,0,0,0,0,0,-119000,0,0,0,0,119000,-119000,-119000
048861,牧德群益94購01  ,0,0,0,0,0,0,0,0,0,-119000,0,0,0,433000,552000,-119000,-119000
047285,鴻海統一95購02  ,0,0,0,0,0,0,0,0,0,-119000,0,0,0,132000,251000,-119000,-119000
049867,日月光兆豐94購01,0,0,0,0,0,0,0,0,0,-119000,0,0,0,1000,120000,-119000,-119000
051372,樺漢富邦96購01  ,0,0,0,0,0,0,0,0,0,-119000,0,0,0,39000,158000,-119000,-119000
051056,華新科群益95購03,0,0,0,0,0,0,0,0,0,-119000,0,0,0,1927000,2046000,-119000,-119000
05763P,致新永豐96售01  ,0,0,0,0,0,0,0,0,0,-119000,0,0,0,161000,280000,-119000,-119000
053101,創意元富96購03  ,0,0,0,0,0,0,0,0,0,-120000,0,0,0,0,120000,-120000,-120000
044175,亞光統一92購01  ,0,0,0,0,0,0,0,0,0,-120000,0,0,0,47000,167000,-120000,-120000
04190P,大立光兆豐94售03,0,0,0,0,0,0,0,0,0,-120000,0,0,0,0,120000,-120000,-120000
03898P,新日興凱基93售02,0,0,0,0,0,0,0,0,0,-120000,0,0,0,160000,280000,-120000,-120000
04084P,台表科統一93售01,0,0,0,0,0,0,0,0,0,-120000,0,0,0,0,120000,-120000,-120000
03629C,元油2X元富98牛06,0,0,0,0,0,0,0,0,0,-120000,0,0,0,1000,121000,-120000,-120000
047165,東陽康和93購01  ,0,0,0,0,0,0,0,0,0,-120000,0,0,0,0,120000,-120000,-120000
047147,嘉晶群益93購02  ,0,0,0,0,0,0,0,0,0,-120000,0,0,0,0,120000,-120000,-120000
048059,欣興國泰95購01  ,0,0,0,0,0,0,0,0,0,-120000,0,0,0,0,120000,-120000,-120000
046108,A50正2元大95購02,0,0,0,0,0,0,0,0,0,-120000,0,0,0,22000,142000,-120000,-120000
051084,華通元大95購06  ,0,0,0,0,0,0,0,0,0,-120000,0,0,0,390000,510000,-120000,-120000
051102,訊芯元大96購01  ,0,0,0,0,0,0,0,0,0,-120000,0,0,0,0,120000,-120000,-120000
051511,鈺齊中信97購01  ,0,0,0,0,0,0,0,0,0,-120000,0,0,0,110000,230000,-120000,-120000
050753,百和統一94購01  ,0,0,0,0,0,0,0,0,0,-120000,0,0,0,85000,205000,-120000,-120000
06063P,玉晶光元富97售01,0,0,0,0,0,0,0,0,0,-120000,0,0,0,49000,169000,-120000,-120000
053581,台積電元大96購14,0,0,0,0,0,0,0,0,0,-121000,0,0,0,165000,286000,-121000,-121000
052747,京鼎元大97購01  ,0,0,0,0,0,0,0,0,0,-121000,0,0,0,221000,342000,-121000,-121000
052317,台積電元大96購11,0,0,0,0,0,0,0,0,0,-121000,0,0,0,0,121000,-121000,-121000
048100,貿聯凱基93購02  ,0,0,0,0,0,0,0,0,0,-121000,0,0,0,1000,122000,-121000,-121000
047287,貿聯統一95購01  ,0,0,0,0,0,0,0,0,0,-121000,0,0,0,2000,123000,-121000,-121000
050309,亞泥兆豐94購01  ,0,0,0,0,0,0,0,0,0,-121000,0,0,0,2000,123000,-121000,-121000
051113,聯電元富95購01  ,0,0,0,0,0,0,0,0,0,-121000,0,0,0,228000,349000,-121000,-121000
2915,潤泰全          ,280000,359817,-79817,0,0,0,0,0,0,-42000,6000,8000,-2000,16000,56000,-40000,-121817
05276P,GIS永豐95售02   ,0,0,0,0,0,0,0,0,0,-122000,0,0,0,68000,190000,-122000,-122000
053479,達興元大96購01  ,0,0,0,0,0,0,0,0,0,-122000,0,0,0,13000,135000,-122000,-122000
052969,建準群益97購01  ,0,0,0,0,0,0,0,0,0,-122000,0,0,0,76000,198000,-122000,-122000
044315,大立光永豐92購01,0,0,0,0,0,0,0,0,0,-122000,0,0,0,128000,250000,-122000,-122000
048118,百和群益94購03  ,0,0,0,0,0,0,0,0,0,-122000,0,0,0,194000,316000,-122000,-122000
050568,為升中信97購01  ,0,0,0,0,0,0,0,0,0,-122000,0,0,0,0,122000,-122000,-122000
053400,緯穎中信9A購01  ,0,0,0,0,0,0,0,0,0,-123000,0,0,0,10000,133000,-123000,-123000
047924,可成凱基93購10  ,0,0,0,0,0,0,0,0,0,-123000,0,0,0,0,123000,-123000,-123000
048502,百和元大93購01  ,0,0,0,0,0,0,0,0,0,-123000,0,0,0,190000,313000,-123000,-123000
052140,鈺齊凱基95購02  ,0,0,0,0,0,0,0,0,0,-123000,0,0,0,106000,229000,-123000,-123000
050988,廣達富邦95購01  ,0,0,0,0,0,0,0,0,0,-124000,0,0,0,22000,146000,-124000,-124000
050313,大立光兆豐94購05,0,0,0,0,0,0,0,0,0,-124000,0,0,0,1000,125000,-124000,-124000
05035P,聯發科元大95售06,0,0,0,0,0,0,0,0,0,-124000,0,0,0,1151000,1275000,-124000,-124000
3010,華立            ,57000,181000,-124000,0,0,0,0,0,0,0,0,0,0,0,0,0,-124000
053404,致新群益96購01  ,0,0,0,0,0,0,0,0,0,-125000,0,0,0,30000,155000,-125000,-125000
053100,美律元富96購01  ,0,0,0,0,0,0,0,0,0,-125000,0,0,0,0,125000,-125000,-125000
054793,牧德群益9A購01  ,0,0,0,0,0,0,0,0,0,-125000,0,0,0,0,125000,-125000,-125000
054610,聯發科永豐97購01,0,0,0,0,0,0,0,0,0,-125000,0,0,0,0,125000,-125000,-125000
054618,訊芯永豐97購01  ,0,0,0,0,0,0,0,0,0,-125000,0,0,0,0,125000,-125000,-125000
045288,元油2X元大95購02,0,0,0,0,0,0,0,0,0,-125000,0,0,0,0,125000,-125000,-125000
045491,東陽凱基92購01  ,0,0,0,0,0,0,0,0,0,-125000,0,0,0,60000,185000,-125000,-125000
048590,貿聯兆豐94購02  ,0,0,0,0,0,0,0,0,0,-125000,0,0,0,30000,155000,-125000,-125000
047197,美律統一94購01  ,0,0,0,0,0,0,0,0,0,-125000,0,0,0,0,125000,-125000,-125000
048939,華擎永豐94購01  ,0,0,0,0,0,0,0,0,0,-125000,0,0,0,0,125000,-125000,-125000
2536,宏普            ,85000,210000,-125000,0,0,0,0,0,0,0,0,0,0,0,0,0,-125000
05502P,台表科國票97售01,0,0,0,0,0,0,0,0,0,-126000,0,0,0,104000,230000,-126000,-126000
054424,大成鋼富邦97購02,0,0,0,0,0,0,0,0,0,-126000,0,0,0,0,126000,-126000,-126000
053199,旺宏日盛96購01  ,0,0,0,0,0,0,0,0,0,-126000,0,0,0,45000,171000,-126000,-126000
044071,聯發科永豐91購01,0,0,0,0,0,0,0,0,0,-126000,0,0,0,0,126000,-126000,-126000
047980,東陽群益93購02  ,0,0,0,0,0,0,0,0,0,-126000,0,0,0,0,126000,-126000,-126000
05893P,國巨兆豐96售04  ,0,0,0,0,0,0,0,0,0,-126000,0,0,0,27000,153000,-126000,-126000
052371,元金2X元大95購01,0,0,0,0,0,0,0,0,0,-127000,0,0,0,15000,142000,-127000,-127000
049625,智易群益95購01  ,0,0,0,0,0,0,0,0,0,-127000,0,0,0,38000,165000,-127000,-127000
047146,智邦群益93購01  ,0,0,0,0,0,0,0,0,0,-128000,0,0,0,47000,175000,-128000,-128000
051871,同欣電凱基95購02,0,0,0,0,0,0,0,0,0,-128000,0,0,0,10000,138000,-128000,-128000
048333,大立光富邦95購01,0,0,0,0,0,0,0,0,0,-129000,0,0,0,56000,185000,-129000,-129000
048813,元黃金凱基94購01,0,0,0,0,0,0,0,0,0,-129000,0,0,0,25000,154000,-129000,-129000
048503,百和元大93購02  ,0,0,0,0,0,0,0,0,0,-129000,0,0,0,75000,204000,-129000,-129000
051325,台光電台新96購01,0,0,0,0,0,0,0,0,0,-129000,0,0,0,0,129000,-129000,-129000
052675,新光金國泰98購01,0,0,0,0,0,0,0,0,0,-130000,0,0,0,7000,137000,-130000,-130000
053377,台積電元大98購01,0,0,0,0,0,0,0,0,0,-130000,0,0,0,920000,1050000,-130000,-130000
049127,上海銀元富94購01,0,0,0,0,0,0,0,0,0,-130000,0,0,0,139000,269000,-130000,-130000
049755,中磊永豐94購02  ,0,0,0,0,0,0,0,0,0,-130000,0,0,0,0,130000,-130000,-130000
050192,康控元大97購01  ,0,0,0,0,0,0,0,0,0,-130000,0,0,0,310000,440000,-130000,-130000
054641,祥碩中信98購01  ,0,0,0,0,0,0,0,0,0,-131000,0,0,0,0,131000,-131000,-131000
04328P,台達電中信93售02,0,0,0,0,0,0,0,0,0,-131000,0,0,0,0,131000,-131000,-131000
050035,聯茂元大94購07  ,0,0,0,0,0,0,0,0,0,-131000,0,0,0,76000,207000,-131000,-131000
1440,南紡            ,156000,287000,-131000,0,0,0,0,0,0,0,0,0,0,0,0,0,-131000
2461,光群雷          ,32000,167000,-135000,0,0,0,0,0,0,4000,4000,0,4000,0,0,0,-131000
3596,智易            ,106000,296000,-190000,0,0,0,0,0,0,59000,39000,0,39000,73000,53000,20000,-131000
054515,華通元大98購02  ,0,0,0,0,0,0,0,0,0,-132000,0,0,0,79000,211000,-132000,-132000
052251,台光電永豐95購03,0,0,0,0,0,0,0,0,0,-132000,0,0,0,0,132000,-132000,-132000
049439,牧德國泰96購01  ,0,0,0,0,0,0,0,0,0,-132000,0,0,0,6000,138000,-132000,-132000
049408,旺宏日盛94購01  ,0,0,0,0,0,0,0,0,0,-132000,0,0,0,16000,148000,-132000,-132000
050491,旺宏國泰96購01  ,0,0,0,0,0,0,0,0,0,-132000,0,0,0,73000,205000,-132000,-132000
051930,國泰金兆豐97購01,0,0,0,0,0,0,0,0,0,-132000,0,0,0,0,132000,-132000,-132000
054115,台塑康和96購01  ,50000,0,50000,0,0,0,0,0,0,-183000,0,0,0,0,183000,-183000,-133000
053641,正文永豐96購01  ,0,0,0,0,0,0,0,0,0,-133000,0,0,0,0,133000,-133000,-133000
048148,欣興元富93購02  ,0,0,0,0,0,0,0,0,0,-133000,0,0,0,0,133000,-133000,-133000
050877,美律統一95購01  ,0,0,0,0,0,0,0,0,0,-133000,0,0,0,33000,166000,-133000,-133000
06040P,亞光康和96售03  ,0,0,0,0,0,0,0,0,0,-133000,0,0,0,245000,378000,-133000,-133000
3026,禾伸堂          ,741000,577832,163168,0,0,0,0,0,0,-297000,3000,0,3000,29000,329000,-300000,-133832
054485,華邦電台新96購01,0,0,0,0,0,0,0,0,0,-134000,0,0,0,169000,303000,-134000,-134000
04116P,京元電元大94售02,0,0,0,0,0,0,0,0,0,-134000,0,0,0,100000,234000,-134000,-134000
042538,新光金國泰92購01,0,0,0,0,0,0,0,0,0,-134000,0,0,0,38000,172000,-134000,-134000
045337,滬深2X凱基95購01,0,0,0,0,0,0,0,0,0,-134000,0,0,0,33000,167000,-134000,-134000
047196,上銀統一97購01  ,0,1000,-1000,0,0,0,0,0,0,-133000,0,0,0,80000,213000,-133000,-134000
050531,訊芯元大95購02  ,0,0,0,0,0,0,0,0,0,-134000,0,0,0,6000,140000,-134000,-134000
050207,百和群益95購01  ,0,0,0,0,0,0,0,0,0,-134000,0,0,0,159000,293000,-134000,-134000
054055,全新國票99購02  ,0,0,0,0,0,0,0,0,0,-135000,0,0,0,134000,269000,-135000,-135000
054005,旺宏統一97購04  ,0,0,0,0,0,0,0,0,0,-135000,0,0,0,5000,140000,-135000,-135000
043390,康控元大93購01  ,0,0,0,0,0,0,0,0,0,-135000,0,0,0,10000,145000,-135000,-135000
047690,美律富邦97購01  ,0,0,0,0,0,0,0,0,0,-135000,0,0,0,50000,185000,-135000,-135000
050255,GIS富邦95購01   ,0,0,0,0,0,0,0,0,0,-135000,0,0,0,5000,140000,-135000,-135000
050759,貿聯元富94購02  ,0,0,0,0,0,0,0,0,0,-135000,0,0,0,304000,439000,-135000,-135000
051919,台郡元大96購02  ,0,0,0,0,0,0,0,0,0,-135000,0,0,0,176000,311000,-135000,-135000
051587,大立光元大95購08,0,0,0,0,0,0,0,0,0,-135000,0,0,0,12000,147000,-135000,-135000
053653,京元電凱基96購02,0,0,0,0,0,0,0,0,0,-136000,0,0,0,0,136000,-136000,-136000
052232,貿聯凱基96購02  ,0,0,0,0,0,0,0,0,0,-136000,0,0,0,0,136000,-136000,-136000
05233P,台郡台新95售02  ,0,0,0,0,0,0,0,0,0,-136000,0,0,0,183000,319000,-136000,-136000
047316,大立光元大94購01,0,0,0,0,0,0,0,0,0,-136000,0,0,0,3000,139000,-136000,-136000
048559,京元電元大93購03,0,0,0,0,0,0,0,0,0,-136000,0,0,0,0,136000,-136000,-136000
052233,台郡凱基96購01  ,0,0,0,0,0,0,0,0,0,-137000,0,0,0,16000,153000,-137000,-137000
052795,健策兆豐97購01  ,0,0,0,0,0,0,0,0,0,-137000,0,0,0,0,137000,-137000,-137000
053332,創意永豐96購03  ,0,0,0,0,0,0,0,0,0,-137000,0,0,0,25000,162000,-137000,-137000
047903,滬深2X元大96購01,0,0,0,0,0,0,0,0,0,-137000,0,0,0,12000,149000,-137000,-137000
046719,元石油元大95購02,0,0,0,0,0,0,0,0,0,-137000,0,0,0,30000,167000,-137000,-137000
048956,美食康和94購01  ,0,0,0,0,0,0,0,0,0,-137000,0,0,0,0,137000,-137000,-137000
051806,華通凱基96購02  ,0,0,0,0,0,0,0,0,0,-137000,0,0,0,38000,175000,-137000,-137000
052402,健策凱基97購01  ,0,0,0,0,0,0,0,0,0,-138000,0,0,0,24000,162000,-138000,-138000
03050X,元展47          ,0,0,0,0,0,0,0,0,0,-138000,0,0,0,5000,143000,-138000,-138000
046230,亞光元大92購03  ,0,0,0,0,0,0,0,0,0,-138000,0,0,0,3000,141000,-138000,-138000
051858,上銀凱基95購01  ,0,0,0,0,0,0,0,0,0,-138000,0,0,0,0,138000,-138000,-138000
051156,鴻海富邦97購01  ,0,0,0,0,0,0,0,0,0,-138000,0,0,0,723000,861000,-138000,-138000
049561,道瓊銀統一96購01,0,0,0,0,0,0,0,0,0,-138000,0,0,0,29000,167000,-138000,-138000
4564,元翎            ,32000,158000,-126000,0,0,0,0,0,0,-12000,0,0,0,0,12000,-12000,-138000
046945,大毅元大93購01  ,0,0,0,0,0,0,0,0,0,-139000,0,0,0,2000,141000,-139000,-139000
05114P,臺股指元富95售02,0,0,0,0,0,0,0,0,0,-139000,0,0,0,177000,316000,-139000,-139000
051771,上銀中信95購01  ,0,0,0,0,0,0,0,0,0,-139000,0,0,0,0,139000,-139000,-139000
1795,美時            ,160000,232000,-72000,0,0,0,1000,10000,-9000,-58000,15000,73000,-58000,0,0,0,-139000
052253,康控永豐95購04  ,0,0,0,0,0,0,0,0,0,-140000,0,0,0,30000,170000,-140000,-140000
053439,台積電凱基96購11,0,0,0,0,0,0,0,0,0,-140000,0,0,0,50000,190000,-140000,-140000
054122,康友永豐96購01  ,0,0,0,0,0,0,0,0,0,-140000,0,0,0,98000,238000,-140000,-140000
054327,亞光台新96購02  ,0,0,0,0,0,0,0,0,0,-140000,0,0,0,36000,176000,-140000,-140000
054818,奇力新元大97購05,0,0,0,0,0,0,0,0,0,-140000,0,0,0,0,140000,-140000,-140000
03788P,聯發科群益94售02,0,0,0,0,0,0,0,0,0,-140000,0,0,0,0,140000,-140000,-140000
048885,中環元富94購01  ,0,0,0,0,0,0,0,0,0,-140000,0,0,0,0,140000,-140000,-140000
047663,亞德客永豐93購03,0,0,0,0,0,0,0,0,0,-140000,0,0,0,0,140000,-140000,-140000
049289,樺漢兆豐94購01  ,0,0,0,0,0,0,0,0,0,-140000,0,0,0,10000,150000,-140000,-140000
049473,光罩永豐94購03  ,0,0,0,0,0,0,0,0,0,-140000,0,0,0,1000,141000,-140000,-140000
1217,愛之味          ,14000,154000,-140000,0,0,0,0,0,0,0,0,0,0,0,0,0,-140000
054224,亞光統一98購01  ,0,0,0,0,0,0,0,0,0,-141000,0,0,0,75000,216000,-141000,-141000
052986,聯發科元大97購05,0,0,0,0,0,0,0,0,0,-141000,0,0,0,885000,1026000,-141000,-141000
052733,台郡國泰97購01  ,0,0,0,0,0,0,0,0,0,-141000,0,0,0,242000,383000,-141000,-141000
03155P,玉晶光群益01售08,0,0,0,0,0,0,0,0,0,-141000,0,0,0,210000,351000,-141000,-141000
04995P,台達電凱基96售03,0,0,0,0,0,0,0,0,0,-141000,0,0,0,345000,486000,-141000,-141000
047104,和大元大93購02  ,0,0,0,0,0,0,0,0,0,-141000,0,0,0,29000,170000,-141000,-141000
047056,正文國票93購02  ,0,0,0,0,0,0,0,0,0,-141000,0,0,0,0,141000,-141000,-141000
050307,欣興中信95購01  ,0,0,0,0,0,0,0,0,0,-141000,0,0,0,5000,146000,-141000,-141000
3532,台勝科          ,93000,242000,-149000,0,0,0,0,0,0,8000,0,0,0,27000,19000,8000,-141000
054198,台積電永昌96購08,0,0,0,0,0,0,0,0,0,-142000,0,0,0,110000,252000,-142000,-142000
048161,旺宏麥證94購01  ,0,0,0,18000,160000,-142000,0,0,0,-142000,0,0,0,18000,160000,-142000,-142000
050581,美食國票94購02  ,0,0,0,0,0,0,0,0,0,-142000,0,0,0,0,142000,-142000,-142000
050100,台積電永昌96購02,0,0,0,0,0,0,0,0,0,-142000,0,0,0,859000,1001000,-142000,-142000
052129,鴻海凱基97購02  ,0,0,0,0,0,0,0,0,0,-142000,0,0,0,100000,242000,-142000,-142000
049188,可成台新94購01  ,0,0,0,0,0,0,0,0,0,-143000,0,0,0,0,143000,-143000,-143000
048615,貿聯凱基93購04  ,0,0,0,0,0,0,0,0,0,-143000,0,0,0,0,143000,-143000,-143000
052322,力成元大96購01  ,0,0,0,0,0,0,0,0,0,-144000,0,0,0,3000,147000,-144000,-144000
052575,茂林凱基96購04  ,0,0,0,0,0,0,0,0,0,-144000,0,0,0,7000,151000,-144000,-144000
045376,友訊元大93購01  ,0,0,0,0,0,0,0,0,0,-144000,0,0,0,26000,170000,-144000,-144000
04786P,鴻海永昌96售01  ,0,0,0,0,0,0,0,0,0,-144000,0,0,0,56000,200000,-144000,-144000
048664,華新科統一94購01,0,0,0,0,0,0,0,0,0,-144000,0,0,0,31000,175000,-144000,-144000
048812,上証2X凱基96購01,0,0,0,0,0,0,0,0,0,-144000,0,0,0,97000,241000,-144000,-144000
2905,三商            ,45000,189000,-144000,0,0,0,0,0,0,0,0,0,0,0,0,0,-144000
2601,益航            ,298000,442000,-144000,0,0,0,0,0,0,0,0,0,0,0,0,0,-144000
053334,訊芯永豐96購01  ,0,0,0,0,0,0,0,0,0,-145000,0,0,0,83000,228000,-145000,-145000
044281,滬深2X凱基91購02,0,0,0,0,0,0,0,0,0,-145000,0,0,0,0,145000,-145000,-145000
049932,GIS元大94購03   ,0,0,0,0,0,0,0,0,0,-145000,0,0,0,0,145000,-145000,-145000
046793,聯發科元富99購01,0,0,0,0,0,0,0,0,0,-145000,0,0,0,72000,217000,-145000,-145000
051805,元黃金凱基97購02,0,0,0,0,0,0,0,0,0,-145000,0,0,0,27000,172000,-145000,-145000
049976,台積電凱基94購28,0,0,0,0,0,0,0,0,0,-145000,0,0,0,11000,156000,-145000,-145000
05786P,臺股指永昌96售03,0,0,0,0,0,0,0,0,0,-145000,21000,0,21000,1792000,1958000,-166000,-145000
052748,群創元大9A購02  ,0,0,0,0,0,0,0,0,0,-146000,0,0,0,24000,170000,-146000,-146000
04324P,新光金元大94售01,0,0,0,0,0,0,0,0,0,-146000,0,0,0,0,146000,-146000,-146000
049271,百和元大94購01  ,0,0,0,0,0,0,0,0,0,-146000,0,0,0,77000,223000,-146000,-146000
049575,美食康和94購02  ,0,0,0,0,0,0,0,0,0,-146000,0,0,0,0,146000,-146000,-146000
050715,台積電群益96購01,0,0,0,0,0,0,0,0,0,-147000,0,0,0,23000,170000,-147000,-147000
050268,智原元大95購03  ,0,0,0,0,0,0,0,0,0,-147000,0,0,0,624000,771000,-147000,-147000
049026,晶相光群益94購01,0,0,0,0,0,0,0,0,0,-148000,0,0,0,350000,498000,-148000,-148000
047491,旺宏統一94購03  ,0,0,0,0,0,0,0,0,0,-148000,0,0,0,25000,173000,-148000,-148000
05078P,義隆永豐95售01  ,0,0,0,0,0,0,0,0,0,-148000,0,0,0,31000,179000,-148000,-148000
053472,漢唐元大96購02  ,0,0,0,0,0,0,0,0,0,-149000,0,0,0,3000,152000,-149000,-149000
053725,晶相光凱基96購01,0,0,0,0,0,0,0,0,0,-149000,0,0,0,16000,165000,-149000,-149000
044848,華邦電統一94購01,0,0,0,0,0,0,0,0,0,-149000,0,0,0,93000,242000,-149000,-149000
050394,大立光元富94購09,0,0,0,0,0,0,0,0,0,-149000,0,0,0,29000,178000,-149000,-149000
051114,鈺齊中信95購01  ,0,0,0,0,0,0,0,0,0,-149000,0,0,0,116000,265000,-149000,-149000
2881,富邦金          ,3515000,3486784,28216,0,0,0,40000,0,40000,-218000,10000,0,10000,56000,284000,-228000,-149784
05375P,健策國票96售02  ,0,0,0,0,0,0,0,0,0,-150000,0,0,0,160000,310000,-150000,-150000
054035,聯詠麥證96購01  ,0,0,0,0,150000,-150000,0,0,0,-150000,0,0,0,0,150000,-150000,-150000
054689,華新科永豐97購01,0,0,0,0,0,0,0,0,0,-150000,0,0,0,57000,207000,-150000,-150000
054604,麗豐台新98購01  ,0,0,0,0,0,0,0,0,0,-150000,0,0,0,0,150000,-150000,-150000
053469,光磊元大97購01  ,0,0,0,0,0,0,0,0,0,-150000,0,0,0,39000,189000,-150000,-150000
053418,旺宏永豐96購02  ,0,0,0,0,0,0,0,0,0,-150000,0,0,0,124000,274000,-150000,-150000
052669,群創群益98購06  ,0,0,0,0,0,0,0,0,0,-150000,0,0,0,30000,180000,-150000,-150000
044778,力成元大91購02  ,0,0,0,0,0,0,0,0,0,-150000,0,0,0,0,150000,-150000,-150000
045676,京元電元大92購03,0,0,0,0,0,0,0,0,0,-150000,0,0,0,0,150000,-150000,-150000
043281,漢唐元大92購02  ,0,0,0,0,0,0,0,0,0,-150000,0,0,0,5000,155000,-150000,-150000
04104P,臺股指國票93售11,0,0,0,0,0,0,0,0,0,-150000,0,0,0,47000,197000,-150000,-150000
042137,元油2X元大93購01,0,0,0,0,0,0,0,0,0,-150000,0,0,0,50000,200000,-150000,-150000
00676R,富邦臺灣加權反1 ,0,0,0,0,0,0,0,0,0,-150000,0,0,0,250000,400000,-150000,-150000
047152,旺宏國票93購02  ,0,0,0,0,0,0,0,0,0,-150000,0,0,0,0,150000,-150000,-150000
047637,旺宏元大94購03  ,0,0,0,0,0,0,0,0,0,-150000,0,0,0,221000,371000,-150000,-150000
051911,大立光元大98購02,0,0,0,0,0,0,0,0,0,-150000,0,0,0,114000,264000,-150000,-150000
05920P,力成元大96售04  ,0,0,0,0,0,0,0,0,0,-150000,0,0,0,50000,200000,-150000,-150000
052476,台光電群益98購01,0,0,0,0,0,0,0,0,0,-151000,0,0,0,17000,168000,-151000,-151000
054764,亞光國票98購01  ,0,0,0,0,0,0,0,0,0,-151000,0,0,0,0,151000,-151000,-151000
054219,楠梓電統一97購01,0,0,0,0,0,0,0,0,0,-151000,0,0,0,10000,161000,-151000,-151000
052183,華邦電群益95購01,0,0,0,0,0,0,0,0,0,-151000,0,0,0,117000,268000,-151000,-151000
050812,台積電凱基95購01,0,0,0,0,0,0,0,0,0,-151000,0,0,0,0,151000,-151000,-151000
053777,台積電元大96購20,0,0,0,0,0,0,0,0,0,-152000,0,0,0,361000,513000,-152000,-152000
05361P,聯發科富邦97售01,0,0,0,0,0,0,0,0,0,-152000,0,0,0,0,152000,-152000,-152000
052354,健策群益96購02  ,0,0,0,0,0,0,0,0,0,-152000,0,0,0,85000,237000,-152000,-152000
052924,旺宏永豐96購01  ,0,0,0,0,0,0,0,0,0,-152000,0,0,0,73000,225000,-152000,-152000
049052,台積電永豐94購02,0,0,0,0,0,0,0,0,0,-152000,0,0,0,123000,275000,-152000,-152000
052855,群創日盛99購01  ,0,0,0,0,0,0,0,0,0,-153000,0,0,0,18000,171000,-153000,-153000
053052,旺宏國票97購02  ,0,0,0,0,0,0,0,0,0,-153000,0,0,0,44000,197000,-153000,-153000
048791,智原元大94購02  ,0,0,0,0,0,0,0,0,0,-153000,0,0,0,449000,602000,-153000,-153000
050757,聯發科元富94購03,0,0,0,0,0,0,0,0,0,-153000,0,0,0,0,153000,-153000,-153000
051379,新光金群益95購01,0,0,0,0,0,0,0,0,0,-153000,0,0,0,0,153000,-153000,-153000
053593,晶技元大98購01  ,0,0,0,0,0,0,0,0,0,-154000,0,0,0,0,154000,-154000,-154000
043442,大立光台新01購01,0,0,0,0,0,0,0,0,0,-154000,0,0,0,0,154000,-154000,-154000
044449,元油2X永豐91購01,0,0,0,0,0,0,0,0,0,-154000,0,0,0,89000,243000,-154000,-154000
04738P,揚明光永豐94售03,0,0,0,0,0,0,0,0,0,-154000,0,0,0,60000,214000,-154000,-154000
050624,鈺齊元大94購01  ,0,0,0,0,0,0,0,0,0,-154000,0,0,0,11000,165000,-154000,-154000
04223P,友達統一93售05  ,0,0,0,0,0,0,0,0,0,-155000,0,0,0,128000,283000,-155000,-155000
04041P,大立光統一94售03,0,0,0,0,0,0,0,0,0,-155000,0,0,0,0,155000,-155000,-155000
048297,GIS群益93購02   ,0,0,0,0,0,0,0,0,0,-155000,0,0,0,0,155000,-155000,-155000
046690,元油2X凱基93購03,0,0,0,0,0,0,0,0,0,-155000,0,0,0,0,155000,-155000,-155000
051850,臻鼎中信96購01  ,0,0,0,0,0,0,0,0,0,-155000,0,0,0,40000,195000,-155000,-155000
2836,高雄銀          ,29000,184000,-155000,0,0,0,0,0,0,0,0,0,0,0,0,0,-155000
054398,牧德永豐96購03  ,0,0,0,0,0,0,0,0,0,-156000,0,0,0,57000,213000,-156000,-156000
047692,T50反1國票94購01,0,0,0,0,0,0,0,0,0,-156000,0,0,0,644000,800000,-156000,-156000
049962,台光電元富94購01,0,0,0,0,0,0,0,0,0,-156000,0,0,0,20000,176000,-156000,-156000
052244,廣達康和95購01  ,0,0,0,0,0,0,0,0,0,-157000,0,0,0,68000,225000,-157000,-157000
046293,聯發科統一94購01,0,0,0,0,0,0,0,0,0,-157000,0,0,0,122000,279000,-157000,-157000
043765,GIS元大93購04   ,0,0,0,0,0,0,0,0,0,-157000,0,0,0,19000,176000,-157000,-157000
047062,鴻海凱基93購24  ,0,0,0,0,0,0,0,0,0,-157000,0,0,0,669000,826000,-157000,-157000
051551,新日興永豐95購01,0,0,0,0,0,0,0,0,0,-157000,0,0,0,48000,205000,-157000,-157000
051096,日月光元大95購01,0,0,0,0,0,0,0,0,0,-157000,0,0,0,40000,197000,-157000,-157000
048967,凌陽元大95購01  ,0,0,0,0,0,0,0,0,0,-158000,0,0,0,0,158000,-158000,-158000
053551,可成凱基96購05  ,0,0,0,0,0,0,0,0,0,-159000,0,0,0,0,159000,-159000,-159000
053956,旺宏永豐96購04  ,0,0,0,0,0,0,0,0,0,-159000,0,0,0,0,159000,-159000,-159000
053954,貿聯康和96購01  ,0,0,0,0,0,0,0,0,0,-159000,0,0,0,0,159000,-159000,-159000
048154,旺宏兆豐94購01  ,0,0,0,0,0,0,0,0,0,-159000,0,0,0,10000,169000,-159000,-159000
049078,瑞昱凱基94購02  ,0,0,0,0,0,0,0,0,0,-159000,0,0,0,70000,229000,-159000,-159000
046577,東元元大92購02  ,0,0,0,0,0,0,0,0,0,-159000,0,0,0,141000,300000,-159000,-159000
049739,大立光群益94購05,0,0,0,0,0,0,0,0,0,-159000,0,0,0,123000,282000,-159000,-159000
1515,力山            ,95000,249000,-154000,0,0,0,0,0,0,-5000,0,0,0,0,5000,-5000,-159000
054125,元油反元大96購09,0,0,0,0,0,0,0,0,0,-160000,0,0,0,0,160000,-160000,-160000
054050,創意元大96購06  ,0,0,0,0,0,0,0,0,0,-160000,0,0,0,0,160000,-160000,-160000
048312,致茂凱基93購02  ,0,0,0,0,0,0,0,0,0,-160000,0,0,0,10000,170000,-160000,-160000
043236,台灣50兆豐93購02,13000,0,13000,0,0,0,0,0,0,-173000,0,0,0,84000,257000,-173000,-160000
047503,T50反1國票93購03,0,0,0,0,0,0,0,0,0,-160000,0,0,0,0,160000,-160000,-160000
050004,明泰永豐94購01  ,0,0,0,0,0,0,0,0,0,-160000,0,0,0,0,160000,-160000,-160000
03418B,臺股指元大95熊20,0,0,0,0,0,0,0,0,0,-161000,0,0,0,125000,286000,-161000,-161000
047586,聯發科永豐94購01,0,0,0,0,0,0,0,0,0,-161000,0,0,0,429000,590000,-161000,-161000
1447,力鵬            ,27000,188000,-161000,0,0,0,0,0,0,0,0,0,0,0,0,0,-161000
05890P,彩晶元大99售01  ,0,0,0,0,0,0,0,0,0,-161000,0,0,0,0,161000,-161000,-161000
051002,華邦電亞東96購01,0,0,0,0,0,0,0,0,0,-162000,0,0,0,0,162000,-162000,-162000
5907,大洋-KY         ,14000,176000,-162000,0,0,0,0,0,0,0,0,0,0,0,0,0,-162000
053778,旺宏元大97購03  ,0,0,0,0,0,0,0,0,0,-163000,0,0,0,216000,379000,-163000,-163000
00713,元大台灣高息低波,0,25000,-25000,0,0,0,0,0,0,-138000,0,0,0,0,138000,-138000,-163000
050083,旺宏元富94購01  ,0,0,0,0,0,0,0,0,0,-163000,0,0,0,5000,168000,-163000,-163000
050660,欣興元大96購02  ,0,0,0,0,0,0,0,0,0,-163000,0,0,0,0,163000,-163000,-163000
1589,永冠-KY         ,19000,162000,-143000,0,0,0,0,0,0,-20000,10000,0,10000,23000,53000,-30000,-163000
2456,奇力新          ,1875000,1720000,155000,0,0,0,330000,307000,23000,-341000,287000,558000,-271000,119000,189000,-70000,-163000
05425P,華邦電亞東96售02,0,0,0,0,0,0,0,0,0,-164000,0,0,0,89000,253000,-164000,-164000
050463,百和元大94購04  ,0,0,0,0,0,0,0,0,0,-164000,0,0,0,56000,220000,-164000,-164000
049478,祥碩永豐94購02  ,0,0,0,0,0,0,0,0,0,-164000,0,0,0,40000,204000,-164000,-164000
053847,美律元富96購02  ,0,0,0,0,0,0,0,0,0,-165000,0,0,0,90000,255000,-165000,-165000
048902,昇陽半國泰96購01,0,0,0,0,0,0,0,0,0,-165000,0,0,0,85000,250000,-165000,-165000
051251,信邦元大95購01  ,0,0,0,0,0,0,0,0,0,-165000,0,0,0,31000,196000,-165000,-165000
2362,藍天            ,192000,357000,-165000,0,0,0,0,0,0,0,0,0,0,0,0,0,-165000
6213,聯茂            ,247000,505000,-258000,0,0,0,100000,21000,79000,14000,159000,120000,39000,47000,72000,-25000,-165000
05229P,台積電群益95售05,0,0,0,0,0,0,0,0,0,-166000,0,0,0,334000,500000,-166000,-166000
049020,可成群益94購02  ,0,0,0,0,0,0,0,0,0,-166000,0,0,0,74000,240000,-166000,-166000
051428,玉晶光統一96購01,0,0,0,0,0,0,0,0,0,-166000,0,0,0,50000,216000,-166000,-166000
3090,日電貿          ,483000,254736,228264,0,0,0,0,0,0,-395000,0,0,0,44000,439000,-395000,-166736
053696,日月光元大96購05,0,0,0,0,0,0,0,0,0,-167000,0,0,0,201000,368000,-167000,-167000
054616,智伸科永豐97購01,0,0,0,0,0,0,0,0,0,-167000,0,0,0,0,167000,-167000,-167000
049200,元黃金群益98購01,0,0,0,0,0,0,0,0,0,-167000,0,0,0,3000,170000,-167000,-167000
047831,台光電元大93購07,0,0,0,0,0,0,0,0,0,-167000,0,0,0,1000,168000,-167000,-167000
051283,亞德客統一95購01,0,0,0,0,0,0,0,0,0,-167000,0,0,0,105000,272000,-167000,-167000
054130,漢唐元大97購02  ,0,0,0,0,0,0,0,0,0,-168000,0,0,0,19000,187000,-168000,-168000
6108,競國            ,15000,183000,-168000,0,0,0,0,0,0,0,0,0,0,0,0,0,-168000
00674R,元大S&P黃金反1  ,0,0,0,0,0,0,0,0,0,-169000,0,0,0,0,169000,-169000,-169000
05555P,健策群益98售01  ,0,0,0,0,0,0,0,0,0,-170000,0,0,0,0,170000,-170000,-170000
054260,貿聯元大96購03  ,0,0,0,0,0,0,0,0,0,-170000,0,0,0,10000,180000,-170000,-170000
049008,傳奇中信95購01  ,0,0,0,0,0,0,0,0,0,-170000,0,0,0,0,170000,-170000,-170000
053291,旺宏中信9A購01  ,0,0,0,0,0,0,0,0,0,-171000,0,0,0,214000,385000,-171000,-171000
044927,聯詠國泰94購01  ,0,0,0,0,0,0,0,0,0,-171000,0,0,0,82000,253000,-171000,-171000
051835,百和元大95購03  ,0,0,0,0,0,0,0,0,0,-171000,0,0,0,374000,545000,-171000,-171000
052075,旺宏元富95購03  ,0,0,0,0,0,0,0,0,0,-171000,0,0,0,86000,257000,-171000,-171000
051968,勤誠永豐95購01  ,0,0,0,0,0,0,0,0,0,-171000,0,0,0,201000,372000,-171000,-171000
052018,京鼎永豐95購02  ,0,0,0,0,0,0,0,0,0,-171000,0,0,0,201000,372000,-171000,-171000
052845,旺宏統一97購01  ,0,0,0,0,0,0,0,0,0,-172000,0,0,0,11000,183000,-172000,-172000
051928,大立光中信96購03,0,0,0,0,0,0,0,0,0,-172000,0,0,0,18000,190000,-172000,-172000
03960P,新日興元富96售02,0,0,0,0,0,0,0,0,0,-173000,0,0,0,336000,509000,-173000,-173000
6456,GIS-KY          ,311000,434000,-123000,0,0,0,0,0,0,-50000,0,0,0,7000,57000,-50000,-173000
052446,聯發科元大96購03,0,0,0,0,0,0,0,0,0,-174000,0,0,0,630000,804000,-174000,-174000
8105,凌巨            ,321000,491000,-170000,0,0,0,0,0,0,-4000,0,4000,-4000,0,0,0,-174000
05631P,國巨富邦9A售01  ,0,0,0,0,0,0,0,0,0,-174000,0,0,0,100000,274000,-174000,-174000
053812,台積電群益96購09,0,0,0,0,0,0,0,0,0,-175000,0,0,0,10000,185000,-175000,-175000
045803,旺宏國票93購01  ,0,0,0,0,0,0,0,0,0,-175000,0,0,0,111000,286000,-175000,-175000
049116,瑞儀統一94購01  ,0,0,0,0,0,0,0,0,0,-175000,0,0,0,117000,292000,-175000,-175000
047716,晶技凱基93購03  ,0,0,0,0,0,0,0,0,0,-175000,0,0,0,0,175000,-175000,-175000
05729P,臺股指凱基97售02,0,0,0,0,0,0,0,0,0,-175000,0,0,0,0,175000,-175000,-175000
053959,晶豪科永豐96購02,0,0,0,0,0,0,0,0,0,-176000,0,0,0,0,176000,-176000,-176000
052933,祥碩元大96購01  ,0,0,0,0,0,0,0,0,0,-176000,0,0,0,104000,280000,-176000,-176000
047171,聯發科永豐93購01,0,0,0,0,0,0,0,0,0,-176000,0,0,0,0,176000,-176000,-176000
051393,新光金兆豐96購01,0,0,0,0,0,0,0,0,0,-176000,0,0,0,0,176000,-176000,-176000
049766,滬深2X元富94購02,0,0,0,0,0,0,0,0,0,-176000,0,0,0,56000,232000,-176000,-176000
049767,奇力新元富94購01,0,0,0,0,0,0,0,0,0,-176000,0,0,0,14000,190000,-176000,-176000
052308,大立光國泰97購02,0,0,0,0,0,0,0,0,0,-177000,0,0,0,179000,356000,-177000,-177000
054176,亞光台新96購01  ,0,0,0,0,0,0,0,0,0,-177000,0,0,0,0,177000,-177000,-177000
054254,晶豪科元大96購02,0,0,0,0,0,0,0,0,0,-177000,0,0,0,221000,398000,-177000,-177000
1308,亞聚            ,30000,66000,-36000,0,0,0,0,0,0,-141000,0,141000,-141000,0,0,0,-177000
2606,裕民            ,121000,280000,-159000,0,0,0,2000,0,2000,-20000,20000,30000,-10000,0,10000,-10000,-177000
054280,牧德群益98購01  ,0,0,0,0,0,0,0,0,0,-178000,0,0,0,82000,260000,-178000,-178000
00653L,富邦印度正2     ,0,153000,-153000,0,0,0,0,0,0,-25000,0,0,0,0,25000,-25000,-178000
046895,智伸科群益93購02,0,0,0,0,0,0,0,0,0,-178000,0,0,0,21000,199000,-178000,-178000
051480,大立光凱基97購01,0,0,0,0,0,0,0,0,0,-178000,0,0,0,0,178000,-178000,-178000
053691,聯發科元大96購16,0,0,0,0,0,0,0,0,0,-179000,0,0,0,99000,278000,-179000,-179000
052677,景碩富邦97購01  ,0,0,0,0,0,0,0,0,0,-179000,0,0,0,0,179000,-179000,-179000
049539,元油2X群益9A購01,0,0,0,0,0,0,0,0,0,-179000,0,0,0,0,179000,-179000,-179000
1439,中和            ,86000,265000,-179000,0,0,0,0,0,0,0,0,0,0,0,0,0,-179000
2324,仁寶            ,1991888,2124000,-132112,0,0,0,17000,0,17000,-64000,10000,1000,9000,52000,125000,-73000,-179112
053338,台光電國票97購01,0,0,0,0,0,0,0,0,0,-180000,0,0,0,0,180000,-180000,-180000
053858,台達電元大96購05,0,0,0,0,0,0,0,0,0,-180000,0,0,0,18000,198000,-180000,-180000
054385,矽創群益98購01  ,0,0,0,0,0,0,0,0,0,-180000,0,0,0,20000,200000,-180000,-180000
045807,上緯控國票93購01,0,0,0,0,0,0,0,0,0,-180000,0,0,0,120000,300000,-180000,-180000
047385,華邦電元大94購02,0,0,0,0,0,0,0,0,0,-180000,0,0,0,49000,229000,-180000,-180000
048587,康控中信93購01  ,0,0,0,0,0,0,0,0,0,-180000,0,0,0,20000,200000,-180000,-180000
05889P,群創元大98售02  ,0,0,0,0,0,0,0,0,0,-180000,0,0,0,35000,215000,-180000,-180000
03984P,上銀群益93售05  ,0,0,0,0,0,0,0,0,0,-181000,0,0,0,26000,207000,-181000,-181000
046745,國喬凱基93購01  ,0,0,0,0,0,0,0,0,0,-181000,0,0,0,14000,195000,-181000,-181000
050488,美食元富94購02  ,0,0,0,0,0,0,0,0,0,-181000,0,0,0,50000,231000,-181000,-181000
050304,台光電中信94購01,0,0,0,0,0,0,0,0,0,-181000,0,0,0,227000,408000,-181000,-181000
3062,建漢            ,58000,241000,-183000,0,0,0,0,0,0,2000,2000,0,2000,0,0,0,-181000
053911,臺股指凱基96購31,0,0,0,0,0,0,0,0,0,-182000,0,0,0,17000,199000,-182000,-182000
044724,亞光永豐91購01  ,0,0,0,0,0,0,0,0,0,-182000,0,0,0,107000,289000,-182000,-182000
050909,華夏中信95購01  ,0,0,0,0,0,0,0,0,0,-182000,0,0,0,30000,212000,-182000,-182000
049730,滬深2X群益94購02,0,0,0,0,0,0,0,0,0,-182000,0,0,0,11000,193000,-182000,-182000
051943,台積電麥證95購03,0,0,0,330000,512000,-182000,0,0,0,-182000,0,0,0,330000,512000,-182000,-182000
9935,慶豐富          ,44000,211000,-167000,0,0,0,0,0,0,-15000,0,15000,-15000,0,0,0,-182000
053626,台積電兆豐96購03,0,0,0,0,0,0,0,0,0,-183000,0,0,0,102000,285000,-183000,-183000
054272,華通中信98購01  ,0,0,0,0,0,0,0,0,0,-183000,0,0,0,100000,283000,-183000,-183000
043282,美律元大92購02  ,0,0,0,0,0,0,0,0,0,-183000,0,0,0,0,183000,-183000,-183000
045893,貿聯元大92購04  ,0,0,0,0,0,0,0,0,0,-183000,0,0,0,50000,233000,-183000,-183000
048359,奇鋐永豐93購02  ,0,0,0,0,0,0,0,0,0,-183000,0,0,0,20000,203000,-183000,-183000
048418,瑞昱統一93購04  ,0,0,0,0,0,0,0,0,0,-183000,0,0,0,22000,205000,-183000,-183000
050094,T50反1國泰95購01,0,0,0,0,0,0,0,0,0,-183000,0,0,0,352000,535000,-183000,-183000
052591,康友永豐97購01  ,0,0,0,0,0,0,0,0,0,-184000,0,0,0,111000,295000,-184000,-184000
04131P,裕隆群益93售01  ,0,0,0,0,0,0,0,0,0,-184000,0,0,0,0,184000,-184000,-184000
043893,百和元大91購03  ,0,0,0,0,0,0,0,0,0,-184000,0,0,0,16000,200000,-184000,-184000
050142,聯發科元富9A購01,0,0,0,0,0,0,0,0,0,-184000,0,0,0,103000,287000,-184000,-184000
050355,瑞儀群益94購01  ,0,0,0,0,0,0,0,0,0,-184000,0,0,0,73000,257000,-184000,-184000
053809,上銀群益96購02  ,0,0,0,0,0,0,0,0,0,-185000,0,0,0,12000,197000,-185000,-185000
04259P,滬深2X群益93售03,0,0,0,0,0,0,0,0,0,-185000,0,0,0,25000,210000,-185000,-185000
047599,大立光統一93購08,0,0,0,0,0,0,0,0,0,-185000,0,0,0,10000,195000,-185000,-185000
049404,訊芯群益94購02  ,0,0,0,0,0,0,0,0,0,-185000,0,0,0,21000,206000,-185000,-185000
050386,智伸科國票94購01,0,0,0,0,0,0,0,0,0,-185000,0,0,0,9000,194000,-185000,-185000
3038,全台            ,62000,239000,-177000,0,0,0,0,0,0,-8000,0,8000,-8000,0,0,0,-185000
05584P,臺股指凱基96售13,0,0,0,0,0,0,0,0,0,-185000,0,0,0,141000,326000,-185000,-185000
03298P,台積電統一03售15,0,0,0,0,0,0,0,0,0,-186000,0,0,0,6000,192000,-186000,-186000
051057,信邦群益95購01  ,0,0,0,0,0,0,0,0,0,-186000,0,0,0,27000,213000,-186000,-186000
04051P,友達中信94售02  ,0,0,0,0,0,0,0,0,0,-187000,0,0,0,13000,200000,-187000,-187000
046240,中鋼中信94購01  ,0,0,0,0,0,0,0,0,0,-187000,0,0,0,32000,219000,-187000,-187000
4137,麗豐-KY         ,18000,174000,-156000,0,0,0,0,26000,-26000,-5000,0,0,0,6000,11000,-5000,-187000
050933,南亞國票95購01  ,0,0,0,0,0,0,0,0,0,-188000,0,0,0,54000,242000,-188000,-188000
05044P,亞德客永豐95售01,0,0,0,0,0,0,0,0,0,-188000,0,0,0,136000,324000,-188000,-188000
053883,大立光中信98購02,0,0,0,0,0,0,0,0,0,-189000,0,0,0,0,189000,-189000,-189000
052385,滬深2X群益99購05,0,0,0,0,0,0,0,0,0,-189000,0,0,0,0,189000,-189000,-189000
044093,南亞科統一91購06,0,0,0,0,0,0,0,0,0,-189000,0,0,0,10000,199000,-189000,-189000
044326,大立光元富91購03,0,0,0,0,0,0,0,0,0,-189000,0,0,0,0,189000,-189000,-189000
05727P,新光金日盛96售02,0,0,0,0,0,0,0,0,0,-189000,0,0,0,0,189000,-189000,-189000
052893,聯電群益98購01  ,0,0,0,0,0,0,0,0,0,-190000,0,0,0,81000,271000,-190000,-190000
053799,矽創中信9A購01  ,0,0,0,0,0,0,0,0,0,-190000,0,0,0,0,190000,-190000,-190000
053656,可成凱基96購06  ,0,0,0,0,0,0,0,0,0,-190000,0,0,0,10000,200000,-190000,-190000
03154P,華新科群益01售07,0,0,0,0,0,0,0,0,0,-190000,0,0,0,10000,200000,-190000,-190000
045535,A50正2群益94購01,0,0,0,0,0,0,0,0,0,-190000,0,0,0,13000,203000,-190000,-190000
047582,滬深2X永豐95購02,0,0,0,0,0,0,0,0,0,-190000,0,0,0,10000,200000,-190000,-190000
046000,台光電統一92購06,0,0,0,0,0,0,0,0,0,-190000,0,0,0,188000,378000,-190000,-190000
051844,宏達電富邦96購01,0,0,0,0,0,0,0,0,0,-190000,0,0,0,148000,338000,-190000,-190000
044683,聯鈞凱基93購01  ,0,0,0,0,0,0,0,0,0,-191000,0,0,0,13000,204000,-191000,-191000
06039P,亞光台新96售03  ,0,0,0,0,0,0,0,0,0,-191000,0,0,0,55000,246000,-191000,-191000
3419,譁裕            ,19000,210000,-191000,0,0,0,0,0,0,0,0,0,0,0,0,0,-191000
052783,台郡國票97購01  ,0,0,0,0,0,0,0,0,0,-192000,0,0,0,73000,265000,-192000,-192000
047981,南亞科群益93購02,0,0,0,0,0,0,0,0,0,-192000,0,0,0,6000,198000,-192000,-192000
049138,台積電元大94購05,0,0,0,0,0,0,0,0,0,-192000,0,0,0,75000,267000,-192000,-192000
051843,聯發科富邦99購01,0,0,0,0,0,0,0,0,0,-192000,0,0,0,12000,204000,-192000,-192000
6257,矽格            ,368000,515903,-147903,0,0,0,50000,80000,-30000,-15000,123000,80000,43000,0,58000,-58000,-192903
04168P,元金2X凱基99售01,0,0,0,0,0,0,0,0,0,-193000,0,0,0,15000,208000,-193000,-193000
053118,大立光中信9C購01,0,0,0,0,0,0,0,0,0,-194000,0,0,0,44000,238000,-194000,-194000
047681,滬深反中信95購01,0,0,0,0,0,0,0,0,0,-194000,0,0,0,6000,200000,-194000,-194000
045858,元油2X統一94購02,0,0,0,0,0,0,0,0,0,-194000,0,0,0,0,194000,-194000,-194000
053314,A50正2群益9A購01,0,0,0,0,0,0,0,0,0,-195000,0,0,0,15000,210000,-195000,-195000
052132,旺宏凱基9B購01  ,0,0,0,0,0,0,0,0,0,-195000,0,0,0,11000,206000,-195000,-195000
04896P,上証2X中信95售01,0,0,0,0,0,0,0,0,0,-196000,0,0,0,4000,200000,-196000,-196000
053146,滬深2X元大96購08,0,0,0,0,0,0,0,0,0,-197000,0,0,0,0,197000,-197000,-197000
052391,瑞儀群益95購01  ,0,0,0,0,0,0,0,0,0,-197000,0,0,0,40000,237000,-197000,-197000
04859P,台達電群益94售04,0,0,0,0,0,0,0,0,0,-197000,0,0,0,324000,521000,-197000,-197000
050381,鴻海兆豐94購01  ,0,0,0,0,0,0,0,0,0,-197000,0,0,0,17000,214000,-197000,-197000
2464,盟立            ,54000,249000,-195000,0,0,0,0,0,0,-2000,0,0,0,0,2000,-2000,-197000
05574P,英業達元富96售01,0,0,0,0,0,0,0,0,0,-197000,0,0,0,2000,199000,-197000,-197000
053213,建準凱基96購02  ,0,0,0,0,0,0,0,0,0,-198000,0,0,0,35000,233000,-198000,-198000
042927,道瓊反中信94購01,0,0,0,0,0,0,0,0,0,-198000,0,0,0,0,198000,-198000,-198000
045089,中磊元大94購01  ,0,0,0,0,0,0,0,0,0,-198000,0,0,0,25000,223000,-198000,-198000
053177,華邦電統一96購01,0,0,0,0,0,0,0,0,0,-199000,0,0,0,98000,297000,-199000,-199000
053559,台積電國泰98購01,0,0,0,0,0,0,0,0,0,-199000,0,0,0,5000,204000,-199000,-199000
052842,滬深2X統一96購01,0,0,0,0,0,0,0,0,0,-199000,0,0,0,0,199000,-199000,-199000
045991,為升富邦95購01  ,0,0,0,0,0,0,0,0,0,-199000,0,0,0,1000,200000,-199000,-199000
049087,晶相光凱基94購02,0,0,0,0,0,0,0,0,0,-199000,0,0,0,3000,202000,-199000,-199000
2547,日勝生          ,60000,265000,-205000,0,0,0,0,0,0,6000,6000,0,6000,0,0,0,-199000
1905,華紙            ,75000,274000,-199000,0,0,0,0,0,0,0,0,0,0,0,0,0,-199000
053568,智伸科富邦98購01,0,0,0,0,0,0,0,0,0,-200000,0,0,0,0,200000,-200000,-200000
05300P,健策元大95售02  ,0,0,0,0,0,0,0,0,0,-200000,0,0,0,100000,300000,-200000,-200000
054241,深中小元大98購01,0,0,0,0,0,0,0,0,0,-200000,0,0,0,0,200000,-200000,-200000
054364,智伸科凱基96購01,0,0,0,0,0,0,0,0,0,-200000,0,0,0,0,200000,-200000,-200000
044864,道瓊反國票96購01,0,0,0,0,0,0,0,0,0,-200000,0,0,0,0,200000,-200000,-200000
043961,道瓊反國泰94購01,0,0,0,0,0,0,0,0,0,-200000,0,0,0,0,200000,-200000,-200000
045417,華新凱基93購01  ,0,0,0,0,0,0,0,0,0,-200000,0,0,0,0,200000,-200000,-200000
045315,矽創國票92購01  ,0,0,0,0,0,0,0,0,0,-200000,0,0,0,0,200000,-200000,-200000
044060,美律元大92購05  ,0,0,0,0,0,0,0,0,0,-200000,0,0,0,0,200000,-200000,-200000
044242,宏達電統一93購01,0,0,0,0,0,0,0,0,0,-200000,0,0,0,0,200000,-200000,-200000
044290,群創凱基93購05  ,0,0,0,0,0,0,0,0,0,-200000,0,0,0,0,200000,-200000,-200000
048286,滬深2X兆豐94購04,0,0,0,0,0,0,0,0,0,-200000,0,0,0,0,200000,-200000,-200000
04226P,宏達電元富93售01,0,0,0,0,0,0,0,0,0,-200000,0,0,0,0,200000,-200000,-200000
03796P,宏碁元大93售01  ,0,0,0,0,0,0,0,0,0,-200000,0,0,0,0,200000,-200000,-200000
03392P,奇鋐永豐02售02  ,0,0,0,0,0,0,0,0,0,-200000,0,0,0,0,200000,-200000,-200000
047593,百和永豐93購02  ,0,0,0,0,0,0,0,0,0,-200000,0,0,0,0,200000,-200000,-200000
048840,上海銀凱基94購02,0,0,0,0,0,0,0,0,0,-200000,0,0,0,0,200000,-200000,-200000
046882,智易富邦97購01  ,0,0,0,0,0,0,0,0,0,-200000,0,0,0,0,200000,-200000,-200000
050714,深中小群益98購01,0,0,0,0,0,0,0,0,0,-200000,0,0,0,0,200000,-200000,-200000
05071P,鴻海統一96售05  ,0,0,0,0,0,0,0,0,0,-200000,0,0,0,0,200000,-200000,-200000
050639,GIS國票96購01   ,0,0,0,0,0,0,0,0,0,-200000,0,0,0,0,200000,-200000,-200000
050148,啟碁永豐94購01  ,0,0,0,0,0,0,0,0,0,-200000,0,0,0,0,200000,-200000,-200000
050187,群創元大94購03  ,0,0,0,0,0,0,0,0,0,-200000,0,0,0,34000,234000,-200000,-200000
049615,香港2X群益98購01,0,0,0,0,0,0,0,0,0,-200000,0,0,0,0,200000,-200000,-200000
049533,美食永豐94購03  ,0,0,0,0,0,0,0,0,0,-200000,0,0,0,0,200000,-200000,-200000
052116,T50反1國票97購01,0,0,0,0,0,0,0,0,0,-200000,0,0,0,0,200000,-200000,-200000
051296,鴻海凱基97購01  ,0,0,0,0,0,0,0,0,0,-200000,0,0,0,4000,204000,-200000,-200000
052224,楠梓電凱基97購01,0,0,0,0,0,0,0,0,0,-200000,0,0,0,0,200000,-200000,-200000
3605,宏致            ,125000,325000,-200000,0,0,0,0,0,0,0,0,0,0,0,0,0,-200000
053830,台積電台新96購02,0,0,0,0,0,0,0,0,0,-201000,0,0,0,35000,236000,-201000,-201000
053789,彩晶元大9C購02  ,0,0,0,0,0,0,0,0,0,-202000,0,0,0,3000,205000,-202000,-202000
050926,禾伸堂凱基95購01,0,0,0,0,0,0,0,0,0,-202000,0,0,0,87000,289000,-202000,-202000
051051,鴻海群益95購04  ,0,0,0,0,0,0,0,0,0,-202000,0,0,0,253000,455000,-202000,-202000
048773,貿聯凱基94購01  ,0,0,0,0,0,0,0,0,0,-203000,0,0,0,38000,241000,-203000,-203000
050949,亞光群益96購01  ,0,0,0,0,0,0,0,0,0,-203000,0,0,0,23000,226000,-203000,-203000
049979,美律凱基94購07  ,0,0,0,0,0,0,0,0,0,-203000,0,0,0,29000,232000,-203000,-203000
05684P,臺股指元大96售09,0,0,0,0,0,0,0,0,0,-203000,0,0,0,36000,239000,-203000,-203000
8210,勤誠            ,132000,366000,-234000,0,0,0,0,0,0,31000,36000,30000,6000,70000,45000,25000,-203000
05296P,牧德凱基96售01  ,0,0,0,0,0,0,0,0,0,-204000,0,0,0,0,204000,-204000,-204000
03758P,GIS永豐93售01   ,0,0,0,0,0,0,0,0,0,-204000,0,0,0,0,204000,-204000,-204000
046664,聯詠元大93購01  ,0,0,0,0,0,0,0,0,0,-204000,0,0,0,1000,205000,-204000,-204000
00640L,富邦日本正2     ,0,0,0,0,0,0,0,0,0,-205000,0,0,0,450000,655000,-205000,-205000
051948,滬深2X元富9B購01,0,0,0,0,0,0,0,0,0,-206000,0,0,0,0,206000,-206000,-206000
052494,百和中信95購02  ,0,0,0,0,0,0,0,0,0,-207000,0,0,0,49000,256000,-207000,-207000
042644,貿聯兆豐92購01  ,0,0,0,0,0,0,0,0,0,-207000,0,0,0,110000,317000,-207000,-207000
2841,台開            ,324000,531127,-207127,0,0,0,0,0,0,0,0,0,0,0,0,0,-207127
046419,聯鈞元大92購01  ,0,0,0,0,0,0,0,0,0,-208000,0,0,0,93000,301000,-208000,-208000
047646,貿聯元大94購01  ,0,0,0,0,0,0,0,0,0,-208000,0,0,0,102000,310000,-208000,-208000
051104,鈺齊元大96購01  ,0,0,0,0,0,0,0,0,0,-208000,0,0,0,69000,277000,-208000,-208000
046533,為升群益92購02  ,0,0,0,0,0,0,0,0,0,-209000,0,0,0,0,209000,-209000,-209000
048067,台光電元富93購01,0,0,0,0,0,0,0,0,0,-209000,0,0,0,0,209000,-209000,-209000
050636,上証2X國票94購01,0,0,0,0,0,0,0,0,0,-209000,0,0,0,86000,295000,-209000,-209000
2542,興富發          ,572644,631021,-58377,0,0,0,0,151000,-151000,0,0,0,0,0,0,0,-209377
052765,新日興群益97購01,0,0,0,0,0,0,0,0,0,-210000,0,0,0,84000,294000,-210000,-210000
053287,臺股指元大96購15,0,0,0,0,0,0,0,0,0,-210000,0,0,0,0,210000,-210000,-210000
054534,台積電富邦98購03,0,0,0,0,0,0,0,0,0,-210000,0,0,0,10000,220000,-210000,-210000
050874,康控永豐95購01  ,0,0,0,0,0,0,0,0,0,-210000,0,0,0,0,210000,-210000,-210000
049620,美食群益94購01  ,0,0,0,0,0,0,0,0,0,-210000,0,0,0,0,210000,-210000,-210000
05767P,國巨凱基96售11  ,0,0,0,0,0,0,0,0,0,-210000,0,0,0,1058000,1268000,-210000,-210000
6414,樺漢            ,36000,131000,-95000,0,0,0,0,71000,-71000,-44000,7000,42000,-35000,33000,42000,-9000,-210000
054204,元金2X國票9B購02,0,0,0,0,0,0,0,0,0,-211000,0,0,0,0,211000,-211000,-211000
053310,彩晶凱基98購02  ,0,0,0,0,0,0,0,0,0,-211000,0,0,0,30000,241000,-211000,-211000
053572,彩晶統一96購01  ,0,0,0,0,0,0,0,0,0,-211000,0,0,0,0,211000,-211000,-211000
052849,可成統一97購01  ,0,0,0,0,0,0,0,0,0,-211000,0,0,0,172000,383000,-211000,-211000
045084,欣興元大93購02  ,0,0,0,0,0,0,0,0,0,-211000,0,0,0,0,211000,-211000,-211000
048857,晶豪科群益94購01,0,0,0,0,0,0,0,0,0,-211000,0,0,0,52000,263000,-211000,-211000
052086,鴻海元大96購08  ,0,0,0,0,0,0,0,0,0,-211000,0,0,0,7000,218000,-211000,-211000
00710B,FH彭博高收益債  ,0,0,0,0,0,0,0,0,0,-213000,0,0,0,24000,237000,-213000,-213000
053133,華邦電國票97購01,0,0,0,0,0,0,0,0,0,-214000,0,0,0,30000,244000,-214000,-214000
051946,健策統一98購01  ,0,0,0,0,0,0,0,0,0,-214000,0,0,0,104000,318000,-214000,-214000
1434,福懋            ,248000,467083,-219083,0,0,0,5000,0,5000,0,0,0,0,0,0,0,-214083
052658,友達元富9C購01  ,0,0,0,0,0,0,0,0,0,-215000,0,0,0,2000,217000,-215000,-215000
03754P,致茂永豐93售01  ,0,0,0,0,0,0,0,0,0,-215000,0,0,0,217000,432000,-215000,-215000
048305,深100凱基96購01 ,0,0,0,0,0,0,0,0,0,-215000,0,0,0,0,215000,-215000,-215000
050272,訊芯元大94購03  ,0,0,0,0,0,0,0,0,0,-215000,0,0,0,134000,349000,-215000,-215000
05393P,鴻海統一95售14  ,0,0,0,0,0,0,0,0,0,-216000,0,0,0,10000,226000,-216000,-216000
044013,友達凱基93購01  ,0,0,0,0,0,0,0,0,0,-216000,0,0,0,5000,221000,-216000,-216000
04794P,友達元大96售03  ,0,0,0,0,0,0,0,0,0,-216000,0,0,0,0,216000,-216000,-216000
050666,道瓊銀永豐94購01,0,0,0,0,0,0,0,0,0,-216000,0,0,0,1000,217000,-216000,-216000
2489,瑞軒            ,57000,276000,-219000,0,0,0,0,0,0,3000,4000,1000,3000,0,0,0,-216000
04047P,華邦電元大94售03,0,0,0,0,0,0,0,0,0,-217000,0,0,0,158000,375000,-217000,-217000
049212,T50反1國票94購04,0,0,0,0,0,0,0,0,0,-217000,0,0,0,1250000,1467000,-217000,-217000
050499,台達電凱基94購11,0,0,0,0,0,0,0,0,0,-217000,0,0,0,15000,232000,-217000,-217000
052392,台表科群益96購02,0,0,0,0,0,0,0,0,0,-218000,0,0,0,131000,349000,-218000,-218000
045662,華邦電統一94購02,0,0,0,0,0,0,0,0,0,-218000,0,0,0,382000,600000,-218000,-218000
051375,道瓊反群益9A購01,0,0,0,0,0,0,0,0,0,-219000,0,0,0,0,219000,-219000,-219000
044269,群創中信95購01  ,0,0,0,0,0,0,0,0,0,-220000,0,0,0,10000,230000,-220000,-220000
020000,富邦特選蘋果N   ,0,0,0,0,0,0,0,0,0,-220000,0,0,0,126000,346000,-220000,-220000
047271,華通永豐93購01  ,0,0,0,0,0,0,0,0,0,-220000,0,0,0,104000,324000,-220000,-220000
051916,和碩元大95購02  ,0,0,0,0,0,0,0,0,0,-220000,0,0,0,5000,225000,-220000,-220000
051670,欣興元大95購06  ,0,0,0,0,0,0,0,0,0,-220000,0,0,0,230000,450000,-220000,-220000
054239,台郡群益96購02  ,0,0,0,0,0,0,0,0,0,-222000,0,0,0,221000,443000,-222000,-222000
049799,旺宏元大96購01  ,0,0,0,0,0,0,0,0,0,-222000,0,0,0,194000,416000,-222000,-222000
054228,貿聯元富96購03  ,0,0,0,0,0,0,0,0,0,-223000,0,0,0,0,223000,-223000,-223000
051369,新光金富邦9A購01,0,0,0,0,0,0,0,0,0,-224000,0,0,0,0,224000,-224000,-224000
048157,美律兆豐93購01  ,0,0,0,0,0,0,0,0,0,-225000,0,0,0,34000,259000,-225000,-225000
046656,華邦電元大93購02,0,0,0,0,0,0,0,0,0,-225000,0,0,0,16000,241000,-225000,-225000
051548,鈺齊康和95購01  ,0,0,0,0,0,0,0,0,0,-225000,0,0,0,99000,324000,-225000,-225000
1802,台玻            ,241000,459000,-218000,0,0,0,0,0,0,-7000,0,7000,-7000,0,0,0,-225000
051414,新光金國票95購04,0,0,0,0,0,0,0,0,0,-226000,0,0,0,7000,233000,-226000,-226000
05795P,華邦電群益96售05,0,0,0,0,0,0,0,0,0,-226000,0,0,0,90000,316000,-226000,-226000
04673P,友達統一94售04  ,0,0,0,0,0,0,0,0,0,-228000,0,0,0,0,228000,-228000,-228000
050376,百和元大95購01  ,0,0,0,0,0,0,0,0,0,-229000,0,0,0,41000,270000,-229000,-229000
054288,華邦電元大96購05,0,0,0,0,0,0,0,0,0,-230000,0,0,0,38000,268000,-230000,-230000
052878,台虹凱基96購01  ,0,0,0,0,0,0,0,0,0,-230000,0,0,0,124000,354000,-230000,-230000
045139,台光電兆豐92購01,0,0,0,0,0,0,0,0,0,-231000,0,0,0,0,231000,-231000,-231000
053968,華邦電元大97購01,0,0,0,0,0,0,0,0,0,-232000,0,0,0,102000,334000,-232000,-232000
043748,漢唐元大93購01  ,0,0,0,0,0,0,0,0,0,-234000,0,0,0,24000,258000,-234000,-234000
047574,和大群益93購03  ,0,0,0,0,0,0,0,0,0,-234000,0,0,0,176000,410000,-234000,-234000
3036,文曄            ,234000,470144,-236144,0,0,0,0,0,0,2000,2000,0,2000,0,0,0,-234144
9910,豐泰            ,269460,524300,-254840,0,0,0,12000,0,12000,8000,8000,0,8000,0,0,0,-234840
053020,貿聯元富96購01  ,0,0,0,0,0,0,0,0,0,-235000,0,0,0,7000,242000,-235000,-235000
048628,T50反1元大96購03,0,0,0,0,0,0,0,0,0,-235000,0,0,0,65000,300000,-235000,-235000
046088,台光電兆豐92購02,0,0,0,0,0,0,0,0,0,-235000,0,0,0,0,235000,-235000,-235000
044602,大立光國泰93購01,0,0,0,0,0,0,0,0,0,-236000,0,0,0,128000,364000,-236000,-236000
047038,亞光群益93購01  ,0,0,0,0,0,0,0,0,0,-236000,0,0,0,135000,371000,-236000,-236000
050005,京鼎永豐94購01  ,0,0,0,0,0,0,0,0,0,-236000,0,0,0,97000,333000,-236000,-236000
05887P,友達元富99售03  ,0,0,0,0,0,0,0,0,0,-236000,0,0,0,498000,734000,-236000,-236000
053492,華邦電兆豐97購01,0,0,0,0,0,0,0,0,0,-237000,0,0,0,35000,272000,-237000,-237000
051773,元大金中信95購02,0,0,0,0,0,0,0,0,0,-238000,0,0,0,20000,258000,-238000,-238000
046466,台虹凱基92購01  ,0,0,0,0,0,0,0,0,0,-239000,0,0,0,160000,399000,-239000,-239000
052604,建準元大97購01  ,0,0,0,0,0,0,0,0,0,-240000,0,0,0,63000,303000,-240000,-240000
01010T,京城樂富R1      ,0,0,0,0,0,0,0,0,0,-240000,0,240000,-240000,0,0,0,-240000
050045,祥碩兆豐94購01  ,0,0,0,0,0,0,0,0,0,-240000,0,0,0,0,240000,-240000,-240000
1319,東陽            ,49000,217000,-168000,0,0,0,0,0,0,-73000,2000,40000,-38000,0,35000,-35000,-241000
053756,亞光元富96購02  ,0,0,0,0,0,0,0,0,0,-242000,0,0,0,9000,251000,-242000,-242000
042470,元油2X元大93購04,0,0,0,0,0,0,0,0,0,-242000,0,0,0,0,242000,-242000,-242000
4934,太極            ,491000,733000,-242000,0,0,0,0,0,0,0,0,0,0,0,0,0,-242000
053470,華邦電元大96購02,0,0,0,0,0,0,0,0,0,-243000,0,0,0,686000,929000,-243000,-243000
044347,上証2X元大94購01,0,0,0,0,0,0,0,0,0,-244000,0,0,0,10000,254000,-244000,-244000
049082,晶豪科凱基94購01,0,0,0,0,0,0,0,0,0,-244000,0,0,0,33000,277000,-244000,-244000
4919,新唐            ,41000,197000,-156000,0,0,0,0,0,0,-88000,0,0,0,1000,89000,-88000,-244000
053525,台積電中信96購04,0,0,0,0,0,0,0,0,0,-245000,0,0,0,25000,270000,-245000,-245000
054530,台光電國泰97購03,0,0,0,0,0,0,0,0,0,-246000,0,0,0,5000,251000,-246000,-246000
048959,凌華康和94購01  ,0,0,0,0,0,0,0,0,0,-246000,0,0,0,289000,535000,-246000,-246000
04506P,旺宏元大94售06  ,0,0,0,0,0,0,0,0,0,-247000,0,0,0,207000,454000,-247000,-247000
047400,欣興永豐93購03  ,0,0,0,0,0,0,0,0,0,-247000,0,0,0,0,247000,-247000,-247000
047885,元金2X富邦99購01,0,0,0,0,0,0,0,0,0,-248000,0,0,0,85000,333000,-248000,-248000
052673,T50反1國泰97購01,0,0,0,0,0,0,0,0,0,-249000,0,0,0,1000,250000,-249000,-249000
044509,台光電凱基93購03,0,0,0,0,0,0,0,0,0,-249000,0,0,0,51000,300000,-249000,-249000
054161,友訊凱基98購01  ,0,0,0,0,0,0,0,0,0,-251000,0,0,0,0,251000,-251000,-251000
045058,華邦電國泰94購01,0,0,0,0,0,0,0,0,0,-251000,0,0,0,698000,949000,-251000,-251000
3376,新日興          ,149000,374000,-225000,0,0,0,20000,47000,-27000,1000,65000,8000,57000,7000,63000,-56000,-251000
054247,華邦電元大96購04,0,0,0,0,0,0,0,0,0,-252000,0,0,0,102000,354000,-252000,-252000
045543,百和群益94購01  ,0,0,0,0,0,0,0,0,0,-252000,0,0,0,69000,321000,-252000,-252000
043156,大立光統一94購01,0,0,0,0,0,0,0,0,0,-252000,0,0,0,0,252000,-252000,-252000
00634R,富邦上証反1     ,50000,0,50000,0,0,0,0,0,0,-302000,0,0,0,217000,519000,-302000,-252000
048378,貿聯元富93購01  ,0,0,0,0,0,0,0,0,0,-252000,0,0,0,50000,302000,-252000,-252000
049136,華通元大95購01  ,0,0,0,0,0,0,0,0,0,-252000,0,0,0,86000,338000,-252000,-252000
049605,旺宏第一94購01  ,0,0,0,0,0,0,0,0,0,-252000,0,0,0,0,252000,-252000,-252000
044784,華邦電中信96購01,0,0,0,0,0,0,0,0,0,-253000,0,0,0,191000,444000,-253000,-253000
05794P,華邦電群益96售04,0,0,0,0,0,0,0,0,0,-254000,0,0,0,11000,265000,-254000,-254000
048848,滬深2X群益98購02,0,0,0,0,0,0,0,0,0,-255000,0,0,0,10000,265000,-255000,-255000
054446,美食兆豐97購01  ,0,0,0,0,0,0,0,0,0,-257000,0,0,0,0,257000,-257000,-257000
00728,第一金工業30    ,0,0,0,0,0,0,0,0,0,-257000,0,0,0,626000,883000,-257000,-257000
046159,群創群益98購04  ,0,0,0,0,0,0,0,0,0,-257000,0,0,0,80000,337000,-257000,-257000
049819,百和元大94購02  ,0,0,0,0,0,0,0,0,0,-257000,0,0,0,67000,324000,-257000,-257000
6412,群電            ,88000,343000,-255000,0,0,0,0,0,0,-2000,0,2000,-2000,0,0,0,-257000
6698,旭暉應材        ,162000,24000,138000,0,0,0,10000,0,10000,-405000,15000,420000,-405000,0,0,0,-257000
2534,宏盛            ,39216,251000,-211784,0,0,0,0,0,0,-46000,0,0,0,0,46000,-46000,-257784
053967,華邦電元大96購03,0,0,0,0,0,0,0,0,0,-258000,0,0,0,50000,308000,-258000,-258000
047532,上海銀元大93購02,0,0,0,0,0,0,0,0,0,-258000,0,0,0,0,258000,-258000,-258000
9934,成霖            ,34000,292000,-258000,0,0,0,0,0,0,0,0,0,0,0,0,0,-258000
044339,亞光統一91購01  ,0,0,0,0,0,0,0,0,0,-259000,0,0,0,34000,293000,-259000,-259000
048190,道瓊反元大96購02,0,0,0,0,0,0,0,0,0,-260000,0,0,0,0,260000,-260000,-260000
04970P,中環元富94售02  ,0,0,0,0,0,0,0,0,0,-261000,0,0,0,0,261000,-261000,-261000
045053,聯發科元富98購01,0,0,0,0,0,0,0,0,0,-263000,0,0,0,50000,313000,-263000,-263000
048486,傳奇國泰95購01  ,0,0,0,0,0,0,0,0,0,-263000,0,0,0,10000,273000,-263000,-263000
052815,滬深2X永豐97購01,0,0,0,0,0,0,0,0,0,-264000,0,0,0,0,264000,-264000,-264000
04594P,緯穎元大94售04  ,0,0,0,0,0,0,0,0,0,-265000,0,0,0,0,265000,-265000,-265000
049775,旺宏統一95購02  ,0,0,0,0,0,0,0,0,0,-265000,0,0,0,0,265000,-265000,-265000
049591,開發金元大98購01,0,0,0,0,0,0,0,0,0,-265000,0,0,0,50000,315000,-265000,-265000
052131,台積電凱基96購01,0,0,0,0,0,0,0,0,0,-265000,0,0,0,128000,393000,-265000,-265000
051209,百和麥證95購01  ,0,0,0,90000,355000,-265000,0,0,0,-265000,0,0,0,90000,355000,-265000,-265000
1907,永豐餘          ,388000,653098,-265098,0,0,0,0,0,0,0,0,0,0,0,0,0,-265098
2455,全新            ,521000,322000,199000,0,0,0,0,0,0,-465000,126000,141000,-15000,18000,468000,-450000,-266000
1604,聲寶            ,41000,307000,-266000,0,0,0,0,0,0,0,0,0,0,0,0,0,-266000
052642,滬深2X永豐96購03,0,0,0,0,0,0,0,0,0,-267000,0,0,0,0,267000,-267000,-267000
053649,台積電凱基97購05,0,0,0,0,0,0,0,0,0,-267000,0,0,0,1000,268000,-267000,-267000
04998P,京元電永豐95售01,0,0,0,0,0,0,0,0,0,-267000,0,0,0,173000,440000,-267000,-267000
053733,華邦電中信98購01,0,0,0,0,0,0,0,0,0,-269000,0,0,0,10000,279000,-269000,-269000
049025,華擎群益94購01  ,0,0,0,0,0,0,0,0,0,-269000,0,0,0,1000,270000,-269000,-269000
2201,裕隆            ,376000,643000,-267000,0,0,0,0,0,0,-2000,0,0,0,0,2000,-2000,-269000
047825,道瓊反元大96購01,0,0,0,0,0,0,0,0,0,-270000,0,0,0,0,270000,-270000,-270000
047972,康控富邦95購01  ,0,0,0,0,0,0,0,0,0,-270000,0,0,0,0,270000,-270000,-270000
050101,台積電永昌96購03,0,0,0,0,0,0,0,0,0,-270000,0,0,0,1000,271000,-270000,-270000
043750,美律元大93購01  ,0,0,0,0,0,0,0,0,0,-271000,0,0,0,76000,347000,-271000,-271000
047996,華邦電元大93購04,0,0,0,0,0,0,0,0,0,-271000,0,0,0,46000,317000,-271000,-271000
051297,台積電凱基95購07,0,0,0,0,0,0,0,0,0,-271000,0,0,0,50000,321000,-271000,-271000
043983,華邦電元大92購01,0,0,0,0,0,0,0,0,0,-272000,0,0,0,4000,276000,-272000,-272000
047571,滬深2X群益99購01,0,0,0,0,0,0,0,0,0,-272000,0,0,0,80000,352000,-272000,-272000
048435,致新國票93購01  ,0,0,0,0,0,0,0,0,0,-273000,0,0,0,71000,344000,-273000,-273000
054258,牧德元大97購01  ,0,0,0,0,0,0,0,0,0,-274000,0,0,0,121000,395000,-274000,-274000
1522,堤維西          ,39000,311000,-272000,0,0,0,0,0,0,-2000,0,0,0,0,2000,-2000,-274000
053686,台積電元大97購08,0,0,0,0,0,0,0,0,0,-277000,0,0,0,184000,461000,-277000,-277000
053263,華邦電群益96購03,0,0,0,0,0,0,0,0,0,-277000,0,0,0,89000,366000,-277000,-277000
048933,晶豪科永豐94購01,0,0,0,0,0,0,0,0,0,-277000,0,0,0,28000,305000,-277000,-277000
051703,台積電群益95購04,0,0,0,0,0,0,0,0,0,-277000,0,0,0,33000,310000,-277000,-277000
050276,百和元大94購03  ,0,0,0,0,0,0,0,0,0,-277000,0,0,0,27000,304000,-277000,-277000
4906,正文            ,135000,483000,-348000,0,0,0,0,0,0,71000,44000,0,44000,71000,44000,27000,-277000
052530,台郡元大96購04  ,0,0,0,0,0,0,0,0,0,-278000,0,0,0,267000,545000,-278000,-278000
045553,華邦電國票92購02,0,0,0,0,0,0,0,0,0,-278000,0,0,0,0,278000,-278000,-278000
045274,華邦電統一92購03,0,0,0,0,0,0,0,0,0,-278000,0,0,0,161000,439000,-278000,-278000
051679,百和元大95購02  ,0,0,0,0,0,0,0,0,0,-278000,0,0,0,306000,584000,-278000,-278000
051741,可成國票97購01  ,0,0,0,0,0,0,0,0,0,-278000,0,0,0,50000,328000,-278000,-278000
043734,大立光富邦92購07,0,0,0,0,0,0,0,0,0,-279000,0,0,0,0,279000,-279000,-279000
047163,義隆台新93購01  ,0,0,0,0,0,0,0,0,0,-279000,0,0,0,30000,309000,-279000,-279000
05493P,華新科富邦99售02,0,0,0,0,0,0,0,0,0,-280000,0,0,0,0,280000,-280000,-280000
050496,鴻海富邦96購01  ,0,0,0,0,0,0,0,0,0,-280000,0,0,0,264000,544000,-280000,-280000
050511,元油2X元大94購11,0,0,0,0,0,0,0,0,0,-280000,0,0,0,0,280000,-280000,-280000
054787,華新科群益97購04,0,0,0,0,0,0,0,0,0,-281000,0,0,0,0,281000,-281000,-281000
052517,滬深2X元大95購05,0,0,0,0,0,0,0,0,0,-281000,0,0,0,5000,286000,-281000,-281000
048367,華邦電統一93購01,0,0,0,0,0,0,0,0,0,-281000,0,0,0,193000,474000,-281000,-281000
00648R,元大S&P500反1   ,0,0,0,0,0,0,0,0,0,-282000,0,0,0,52000,334000,-282000,-282000
05004P,健策統一95售01  ,0,0,0,0,0,0,0,0,0,-282000,0,0,0,420000,702000,-282000,-282000
046139,京元電統一92購04,0,0,0,0,0,0,0,0,0,-283000,0,0,0,227000,510000,-283000,-283000
049797,台積電元大94購17,0,0,0,0,0,0,0,0,0,-284000,0,0,0,10000,294000,-284000,-284000
052737,滬深2X元大96購06,0,0,0,0,0,0,0,0,0,-287000,0,0,0,0,287000,-287000,-287000
04034P,技嘉群益93售03  ,0,0,0,0,0,0,0,0,0,-288000,0,0,0,0,288000,-288000,-288000
047628,新光金國票95購02,0,0,0,0,0,0,0,0,0,-288000,0,0,0,32000,320000,-288000,-288000
051999,勤誠元大95購01  ,0,0,0,0,0,0,0,0,0,-288000,0,0,0,303000,591000,-288000,-288000
046930,亞光統一93購01  ,0,0,0,0,0,0,0,0,0,-290000,0,0,0,3000,293000,-290000,-290000
04790P,台積電元大94售19,0,0,0,0,0,0,0,0,0,-290000,0,0,0,0,290000,-290000,-290000
05714P,群創統一97售03  ,0,0,0,0,0,0,0,0,0,-290000,0,0,0,55000,345000,-290000,-290000
03713P,GIS元富93售02   ,0,0,0,0,0,0,0,0,0,-291000,0,0,0,70000,361000,-291000,-291000
043601,亞光元大93購01  ,0,0,0,0,0,0,0,0,0,-292000,0,0,0,55000,347000,-292000,-292000
041210,群創元富93購01  ,0,0,0,0,0,0,0,0,0,-292000,0,0,0,398000,690000,-292000,-292000
047698,瑞儀日盛93購01  ,0,0,0,0,0,0,0,0,0,-293000,0,0,0,100000,393000,-293000,-293000
053444,奇力新凱基96購03,0,0,0,0,0,0,0,0,0,-294000,0,0,0,247000,541000,-294000,-294000
053590,新光金元大9A購02,0,0,0,0,0,0,0,0,0,-294000,0,0,0,8000,302000,-294000,-294000
044408,聯茂凱基93購02  ,0,0,0,0,0,0,0,0,0,-294000,0,0,0,11000,305000,-294000,-294000
051907,台積電元大97購05,0,0,0,0,0,0,0,0,0,-294000,0,0,0,120000,414000,-294000,-294000
04288P,台積電中信95售06,0,0,0,0,0,0,0,0,0,-295000,0,0,0,130000,425000,-295000,-295000
045082,聯詠元大92購01  ,0,0,0,0,0,0,0,0,0,-295000,0,0,0,1000,296000,-295000,-295000
051888,國巨元富95購05  ,0,0,0,0,0,0,0,0,0,-295000,0,0,0,919000,1214000,-295000,-295000
03647P,京元電元富95售02,0,0,0,0,0,0,0,0,0,-298000,0,0,0,157000,455000,-298000,-298000
053963,百和永豐96購01  ,0,0,0,0,0,0,0,0,0,-300000,0,0,0,37000,337000,-300000,-300000
052856,滬深2X凱基98購01,0,0,0,0,0,0,0,0,0,-300000,0,0,0,6000,306000,-300000,-300000
03402P,大立光凱基02售07,0,0,0,0,0,0,0,0,0,-300000,0,0,0,300000,600000,-300000,-300000
049178,宏達電凱基94購02,0,0,0,0,0,0,0,0,0,-300000,0,0,0,0,300000,-300000,-300000
04719P,台達電凱基94售09,0,0,0,0,0,0,0,0,0,-300000,0,0,0,300000,600000,-300000,-300000
05137P,華新科凱基96售03,0,0,0,0,0,0,0,0,0,-300000,0,0,0,0,300000,-300000,-300000
051178,大立光凱基95購10,0,0,0,0,0,0,0,0,0,-301000,0,0,0,140000,441000,-301000,-301000
4935,茂林-KY         ,122000,128000,-6000,0,0,0,0,271000,-271000,-26000,32000,56000,-24000,45000,47000,-2000,-303000
054566,貿聯群益97購02  ,0,0,0,0,0,0,0,0,0,-304000,0,0,0,12000,316000,-304000,-304000
054207,國巨國票98購01  ,0,0,0,0,0,0,0,0,0,-304000,0,0,0,12000,316000,-304000,-304000
047948,瑞儀統一93購01  ,0,0,0,0,0,0,0,0,0,-304000,0,0,0,108000,412000,-304000,-304000
048432,全新國票95購01  ,0,0,0,0,0,0,0,0,0,-304000,0,0,0,0,304000,-304000,-304000
044997,信邦國泰93購01  ,0,0,0,0,0,0,0,0,0,-305000,0,0,0,125000,430000,-305000,-305000
051488,健策凱基96購04  ,0,0,0,0,0,0,0,0,0,-305000,0,0,0,221000,526000,-305000,-305000
049518,宏達電國票95購02,0,0,0,0,0,0,0,0,0,-305000,0,0,0,0,305000,-305000,-305000
6271,同欣電          ,873000,330961,542039,0,0,0,10000,818000,-808000,-40000,29000,33000,-4000,5000,41000,-36000,-305961
05306P,泰碩國泰97售01  ,0,0,0,0,0,0,0,0,0,-306000,0,0,0,58000,364000,-306000,-306000
050252,聯發科國泰95購01,0,0,0,0,0,0,0,0,0,-306000,0,0,0,1000,307000,-306000,-306000
2499,東貝            ,44000,351000,-307000,0,0,0,0,0,0,-1000,0,1000,-1000,0,0,0,-308000
050867,聯鈞永豐95購01  ,0,0,0,0,0,0,0,0,0,-309000,0,0,0,104000,413000,-309000,-309000
045008,南亞科元大92購02,0,0,0,0,0,0,0,0,0,-310000,0,0,0,0,310000,-310000,-310000
049573,長榮航統一95購01,0,0,0,0,0,0,0,0,0,-310000,0,0,0,0,310000,-310000,-310000
05494P,華邦電統一95售02,0,0,0,0,0,0,0,0,0,-314000,0,0,0,108000,422000,-314000,-314000
045854,貿聯富邦93購01  ,0,0,0,0,0,0,0,0,0,-314000,0,0,0,0,314000,-314000,-314000
049745,國巨永豐94購04  ,0,0,0,0,0,0,0,0,0,-314000,0,0,0,538000,852000,-314000,-314000
051530,鴻海國票97購01  ,0,0,0,0,0,0,0,0,0,-315000,0,0,0,325000,640000,-315000,-315000
051068,台積電國票97購01,0,0,0,0,0,0,0,0,0,-316000,0,0,0,26000,342000,-316000,-316000
052807,貿聯元大98購01  ,0,0,0,0,0,0,0,0,0,-317000,0,0,0,236000,553000,-317000,-317000
044965,大立光中信95購01,0,0,0,0,0,0,0,0,0,-318000,0,0,0,0,318000,-318000,-318000
9921,巨大            ,244000,533174,-289174,0,0,0,1000,28000,-27000,-2000,0,0,0,0,2000,-2000,-318174
053843,訊芯統一96購01  ,0,0,0,0,0,0,0,0,0,-319000,0,0,0,55000,374000,-319000,-319000
047001,大成鋼統一93購01,0,0,0,0,0,0,0,0,0,-319000,0,0,0,27000,346000,-319000,-319000
9958,世紀鋼          ,24000,307000,-283000,0,0,0,0,0,0,-36000,15000,0,15000,9000,60000,-51000,-319000
054158,國巨日盛99購01  ,0,0,0,0,0,0,0,0,0,-320000,0,0,0,135000,455000,-320000,-320000
051408,台積電國票95購03,0,0,0,0,0,0,0,0,0,-321000,0,0,0,12000,333000,-321000,-321000
052284,日月光凱基96購01,0,0,0,0,0,0,0,0,0,-322000,0,0,0,8000,330000,-322000,-322000
051311,瑞昱麥證95購01  ,0,0,0,191000,513000,-322000,0,0,0,-322000,0,0,0,191000,513000,-322000,-322000
3044,健鼎            ,319865,572000,-252135,0,0,0,0,40000,-40000,-30000,20000,20000,0,3000,33000,-30000,-322135
054015,晶豪科永豐96購03,0,0,0,0,0,0,0,0,0,-324000,0,0,0,0,324000,-324000,-324000
05144P,美律永豐95售02  ,0,0,0,0,0,0,0,0,0,-324000,0,0,0,0,324000,-324000,-324000
050603,致新國泰96購01  ,0,0,0,0,0,0,0,0,0,-324000,0,0,0,27000,351000,-324000,-324000
2605,新興            ,47000,242000,-195000,0,0,0,0,0,0,-131000,10000,141000,-131000,0,0,0,-326000
2105,正新            ,361829,699000,-337171,0,0,0,11000,0,11000,0,0,0,0,0,0,0,-326171
053948,大立光富邦99購04,0,0,0,0,0,0,0,0,0,-327000,0,0,0,125000,452000,-327000,-327000
054084,旺宏統一97購05  ,0,0,0,0,0,0,0,0,0,-327000,0,0,0,0,327000,-327000,-327000
050895,聯發科元大97購01,0,0,0,0,0,0,0,0,0,-327000,0,0,0,11000,338000,-327000,-327000
050220,台積電元富96購01,0,0,0,0,0,0,0,0,0,-327000,0,0,0,242000,569000,-327000,-327000
3029,零壹            ,30000,350000,-320000,0,0,0,0,0,0,-9000,0,9000,-9000,0,0,0,-329000
053172,瑞儀群益97購01  ,0,0,0,0,0,0,0,0,0,-332000,0,0,0,0,332000,-332000,-332000
046445,台化麥證92購01  ,0,0,0,18000,350000,-332000,0,0,0,-332000,0,0,0,18000,350000,-332000,-332000
050541,智邦凱基94購04  ,0,0,0,0,0,0,0,0,0,-333000,0,0,0,22000,355000,-333000,-333000
051173,元油2X凱基98購01,0,0,0,0,0,0,0,0,0,-333000,0,0,0,86000,419000,-333000,-333000
05595P,友達統一96售02  ,0,0,0,0,0,0,0,0,0,-336000,0,0,0,108000,444000,-336000,-336000
048109,旺宏群益94購02  ,0,0,0,0,0,0,0,0,0,-338000,0,0,0,10000,348000,-338000,-338000
048131,全新國票94購02  ,0,0,0,0,0,0,0,0,0,-338000,0,0,0,10000,348000,-338000,-338000
049112,可成統一94購01  ,0,0,0,0,0,0,0,0,0,-338000,0,0,0,60000,398000,-338000,-338000
3016,嘉晶            ,77000,210000,-133000,0,0,0,0,0,0,-205000,0,0,0,25000,230000,-205000,-338000
1326,台化            ,987000,1305553,-318553,0,0,0,18000,0,18000,-39000,0,50000,-50000,11000,0,11000,-339553
049263,大立光元大94購10,0,0,0,0,0,0,0,0,0,-340000,0,0,0,0,340000,-340000,-340000
1201,味全            ,176000,479000,-303000,0,0,0,0,0,0,-38000,0,0,0,0,38000,-38000,-341000
2329,華泰            ,184000,325000,-141000,0,0,0,0,0,0,-201000,0,0,0,0,201000,-201000,-342000
036804,國巨元富93購01  ,0,0,0,0,0,0,0,0,0,-344000,0,0,0,249000,593000,-344000,-344000
4943,康控-KY         ,86000,222000,-136000,0,0,0,0,169000,-169000,-39000,101000,66000,35000,9000,83000,-74000,-344000
053070,訊芯群益96購01  ,0,0,0,0,0,0,0,0,0,-346000,0,0,0,91000,437000,-346000,-346000
053816,聯發科群益96購02,0,0,0,0,0,0,0,0,0,-348000,0,0,0,62000,410000,-348000,-348000
05498P,友達元富95售02  ,0,0,0,0,0,0,0,0,0,-350000,0,0,0,499000,849000,-350000,-350000
054339,聯詠統一96購02  ,0,0,0,0,0,0,0,0,0,-350000,0,0,0,115000,465000,-350000,-350000
04729P,臺股指中信96售01,0,0,0,0,0,0,0,0,0,-350000,0,0,0,0,350000,-350000,-350000
049153,大立光元大96購02,0,0,0,0,0,0,0,0,0,-350000,0,0,0,10000,360000,-350000,-350000
3380,明泰            ,148000,556000,-408000,0,0,0,0,0,0,58000,187000,68000,119000,18000,79000,-61000,-350000
05477P,華新科群益95售06,0,0,0,0,0,0,0,0,0,-351000,0,0,0,189000,540000,-351000,-351000
053759,晶相光國泰98購01,0,0,0,0,0,0,0,0,0,-351000,0,0,0,574000,925000,-351000,-351000
2345,智邦            ,219000,529000,-310000,0,0,0,12000,40000,-28000,-15000,69000,76000,-7000,56000,64000,-8000,-353000
054132,聯發科元大97購10,0,0,0,0,0,0,0,0,0,-354000,0,0,0,142000,496000,-354000,-354000
053018,旺宏元富96購02  ,0,0,0,0,0,0,0,0,0,-355000,0,0,0,68000,423000,-355000,-355000
053154,聯詠元大96購01  ,0,0,0,0,0,0,0,0,0,-355000,0,0,0,230000,585000,-355000,-355000
045883,元油2X元大95購07,0,0,0,0,0,0,0,0,0,-355000,0,0,0,3000,358000,-355000,-355000
049269,超眾元大96購02  ,0,0,0,0,0,0,0,0,0,-356000,0,0,0,115000,471000,-356000,-356000
049681,旺宏統一94購04  ,0,0,0,0,0,0,0,0,0,-356000,0,0,0,20000,376000,-356000,-356000
049966,旺宏國票95購02  ,0,0,0,0,0,0,0,0,0,-356000,0,0,0,0,356000,-356000,-356000
049341,旺宏統一95購01  ,0,0,0,0,0,0,0,0,0,-357000,0,0,0,0,357000,-357000,-357000
049587,美律元大95購01  ,0,0,0,0,0,0,0,0,0,-357000,0,0,0,226000,583000,-357000,-357000
05746P,台積電群益96售07,0,0,0,0,0,0,0,0,0,-357000,0,0,0,658000,1015000,-357000,-357000
054069,亞光國泰98購01  ,0,0,0,0,0,0,0,0,0,-358000,0,0,0,670000,1028000,-358000,-358000
050282,T50反1凱基97購01,0,0,0,0,0,0,0,0,0,-359000,0,0,0,32000,391000,-359000,-359000
03626P,可成兆豐93售03  ,0,0,0,0,0,0,0,0,0,-360000,0,0,0,0,360000,-360000,-360000
048481,瑞儀中信93購01  ,0,0,0,0,0,0,0,0,0,-360000,0,0,0,0,360000,-360000,-360000
5243,乙盛-KY         ,39000,400000,-361000,0,0,0,0,0,0,0,0,0,0,0,0,0,-361000
054545,奇力新中信98購01,0,0,0,0,0,0,0,0,0,-364000,0,0,0,138000,502000,-364000,-364000
053188,旺宏統一97購03  ,0,0,0,0,0,0,0,0,0,-364000,0,0,0,35000,399000,-364000,-364000
046844,旺宏永豐93購01  ,0,0,0,0,0,0,0,0,0,-364000,0,0,0,40000,404000,-364000,-364000
5521,工信            ,69000,433000,-364000,0,0,0,0,0,0,0,0,0,0,0,0,0,-364000
044933,華邦電元大91購03,0,0,0,0,0,0,0,0,0,-365000,0,0,0,81000,446000,-365000,-365000
1527,鑽全            ,35000,400000,-365000,0,0,0,0,0,0,0,0,0,0,0,0,0,-365000
8028,昇陽半導體      ,70000,403000,-333000,0,0,0,0,0,0,-33000,2000,0,2000,4000,39000,-35000,-366000
4960,誠美材          ,0,370000,-370000,0,0,0,0,0,0,0,0,0,0,0,0,0,-370000
054270,寶滬深中信98購01,0,0,0,0,0,0,0,0,0,-371000,0,0,0,0,371000,-371000,-371000
05882P,華新科永豐96售01,0,0,0,0,0,0,0,0,0,-372000,0,0,0,160000,532000,-372000,-372000
049342,聯發科統一94購05,0,0,0,0,0,0,0,0,0,-373000,0,0,0,0,373000,-373000,-373000
045113,玉晶光永豐92購01,0,0,0,0,0,0,0,0,0,-375000,0,0,0,360000,735000,-375000,-375000
047750,開發金元富93購01,0,0,0,0,0,0,0,0,0,-375000,0,0,0,0,375000,-375000,-375000
048146,大立光統一93購11,0,0,0,0,0,0,0,0,0,-376000,0,0,0,139000,515000,-376000,-376000
05849P,臺股指元大96售25,0,0,0,0,0,0,0,0,0,-379000,0,0,0,616000,995000,-379000,-379000
047108,華邦電元大93購03,0,0,0,0,0,0,0,0,0,-380000,0,0,0,258000,638000,-380000,-380000
2505,國揚            ,90000,471000,-381000,0,0,0,0,0,0,0,0,0,0,0,0,0,-381000
054120,奇力新永豐96購01,0,0,0,0,0,0,0,0,0,-384000,0,0,0,196000,580000,-384000,-384000
054646,華新科群益97購03,0,0,0,0,0,0,0,0,0,-385000,0,0,0,66000,451000,-385000,-385000
044877,旺宏元富91購01  ,60000,0,60000,0,0,0,0,0,0,-448000,0,0,0,106000,554000,-448000,-388000
2357,華碩            ,223099,620770,-397671,0,0,0,4000,0,4000,5000,0,0,0,5000,0,5000,-388671
048194,華邦電元大94購04,0,0,0,0,0,0,0,0,0,-389000,0,0,0,416000,805000,-389000,-389000
05658P,日月光元富96售02,0,0,0,0,0,0,0,0,0,-390000,0,0,0,56000,446000,-390000,-390000
05620P,大立光富邦9B售01,0,0,0,0,0,0,0,0,0,-391000,0,0,0,124000,515000,-391000,-391000
053452,臺股指凱基97購01,0,0,0,0,0,0,0,0,0,-393000,0,0,0,369000,762000,-393000,-393000
048875,晶相光國票94購01,0,0,0,0,0,0,0,0,0,-393000,0,0,0,242000,635000,-393000,-393000
8016,矽創            ,194000,365200,-171200,0,0,0,0,200000,-200000,-22000,0,0,0,7000,29000,-22000,-393200
04219P,鴻海兆豐93售02  ,0,0,0,0,0,0,0,0,0,-394000,0,0,0,0,394000,-394000,-394000
053215,禾伸堂凱基96購01,0,0,0,0,0,0,0,0,0,-395000,0,0,0,104000,499000,-395000,-395000
2379,瑞昱            ,495042,997000,-501958,0,0,0,191000,0,191000,-85000,50000,110000,-60000,12000,37000,-25000,-395958
051232,貿聯群益95購02  ,0,0,0,0,0,0,0,0,0,-396000,0,0,0,17000,413000,-396000,-396000
047470,聯發科中信94購03,0,0,0,0,0,0,0,0,0,-398000,0,0,0,138000,536000,-398000,-398000
046393,瀚宇博元富92購01,0,0,0,0,0,0,0,0,0,-398000,0,0,0,0,398000,-398000,-398000
050010,鈺齊永豐94購01  ,0,0,0,0,0,0,0,0,0,-399000,0,0,0,57000,456000,-399000,-399000
054794,貿聯群益98購01  ,0,0,0,0,0,0,0,0,0,-400000,0,0,0,4000,404000,-400000,-400000
03181P,台灣50元大01售40,0,0,0,0,0,0,0,0,0,-400000,0,0,0,0,400000,-400000,-400000
048947,凌華永豐94購01  ,0,0,0,0,0,0,0,0,0,-400000,0,0,0,60000,460000,-400000,-400000
049152,大立光元大95購06,0,0,0,0,0,0,0,0,0,-400000,0,0,0,210000,610000,-400000,-400000
053512,台積電群益96購06,0,0,0,0,0,0,0,0,0,-401000,0,0,0,60000,461000,-401000,-401000
04268P,南電元富93售03  ,0,0,0,0,0,0,0,0,0,-401000,0,0,0,41000,442000,-401000,-401000
2472,立隆電          ,29000,487000,-458000,0,0,0,0,0,0,57000,79000,22000,57000,0,0,0,-401000
8213,志超            ,60000,460000,-400000,0,0,0,0,0,0,-1000,0,0,0,0,1000,-1000,-401000
2520,冠德            ,136074,398000,-261926,0,0,0,0,0,0,-140000,0,94000,-94000,3000,49000,-46000,-401926
054208,台積電國票97購07,0,0,0,0,0,0,0,0,0,-403000,0,0,0,7000,410000,-403000,-403000
06042P,華新科永豐96售04,0,0,0,0,0,0,0,0,0,-403000,0,0,0,0,403000,-403000,-403000
054516,國巨元大97購02  ,0,0,0,0,0,0,0,0,0,-405000,0,0,0,176000,581000,-405000,-405000
047454,滬深2X群益96購03,0,0,0,0,0,0,0,0,0,-405000,0,0,0,0,405000,-405000,-405000
046208,滬深2X元富95購03,0,0,0,0,0,0,0,0,0,-406000,0,0,0,1000,407000,-406000,-406000
053098,國巨元富96購04  ,0,0,0,0,0,0,0,0,0,-407000,0,0,0,463000,870000,-407000,-407000
04148P,GIS凱基93售05   ,0,0,0,0,0,0,0,0,0,-409000,0,0,0,280000,689000,-409000,-409000
051368,國泰金富邦97購01,0,0,0,0,0,0,0,0,0,-410000,0,0,0,200000,610000,-410000,-410000
051851,TPK群益95購03   ,0,0,0,0,0,0,0,0,0,-410000,0,0,0,7000,417000,-410000,-410000
05294P,亞光凱基95售02  ,0,0,0,0,0,0,0,0,0,-411000,0,0,0,64000,475000,-411000,-411000
6452,康友-KY         ,215000,571000,-356000,0,0,0,0,0,0,-56000,13000,5000,8000,69000,133000,-64000,-412000
006208,富邦台50        ,0,0,0,0,0,0,0,0,0,-414000,0,0,0,331000,745000,-414000,-414000
046904,大毅凱基93購01  ,0,0,0,0,0,0,0,0,0,-415000,0,0,0,87000,502000,-415000,-415000
2376,技嘉            ,818000,1227816,-409816,0,0,0,0,0,0,-6000,2000,14000,-12000,17000,11000,6000,-415816
05638P,國巨統一96售04  ,0,0,0,0,0,0,0,0,0,-418000,0,0,0,101000,519000,-418000,-418000
045523,元油2X永豐92購03,0,0,0,0,0,0,0,0,0,-419000,0,0,0,0,419000,-419000,-419000
05780P,台積電統一96售07,0,0,0,0,0,0,0,0,0,-419000,0,0,0,103000,522000,-419000,-419000
050253,百和國泰96購01  ,0,0,0,0,0,0,0,0,0,-421000,0,0,0,16000,437000,-421000,-421000
051366,康友國泰97購01  ,0,0,0,0,0,0,0,0,0,-424000,0,0,0,357000,781000,-424000,-424000
053148,華邦電元大96購01,0,0,0,0,0,0,0,0,0,-425000,0,0,0,422000,847000,-425000,-425000
051524,貿聯凱基95購02  ,0,0,0,0,0,0,0,0,0,-428000,0,0,0,24000,452000,-428000,-428000
2340,光磊            ,206000,477000,-271000,0,0,0,0,0,0,-161000,0,31000,-31000,18000,148000,-130000,-432000
2102,泰豐            ,157000,589000,-432000,0,0,0,0,0,0,0,0,0,0,0,0,0,-432000
054589,聯鈞國泰99購01  ,0,0,0,0,0,0,0,0,0,-440000,0,0,0,29000,469000,-440000,-440000
051597,T50反1中信99購02,0,0,0,0,0,0,0,0,0,-440000,0,0,0,0,440000,-440000,-440000
05201P,玉晶光國泰97售02,0,0,0,0,0,0,0,0,0,-443000,0,0,0,23000,466000,-443000,-443000
4142,國光生          ,168000,761000,-593000,0,0,0,0,0,0,150000,150000,0,150000,0,0,0,-443000
049205,聯發科群益94購05,0,0,0,0,0,0,0,0,0,-444000,0,0,0,58000,502000,-444000,-444000
047153,聯發科國票93購02,0,0,0,0,0,0,0,0,0,-449000,0,0,0,1000,450000,-449000,-449000
051391,聯發科兆豐95購02,0,0,0,0,0,0,0,0,0,-449000,0,0,0,1000,450000,-449000,-449000
00738U,元大道瓊白銀    ,0,553000,-553000,0,0,0,0,0,0,102000,0,50000,-50000,1018000,866000,152000,-451000
08714P,華碩元富01售03  ,0,0,0,0,0,0,0,0,0,-453000,0,0,0,0,453000,-453000,-453000
048395,南亞科國票93購02,0,0,0,0,0,0,0,0,0,-454000,0,0,0,0,454000,-454000,-454000
053887,聯茂兆豐97購02  ,0,0,0,0,0,0,0,0,0,-455000,0,0,0,135000,590000,-455000,-455000
05546P,全新元大97售01  ,0,0,0,0,0,0,0,0,0,-457000,0,0,0,208000,665000,-457000,-457000
9945,潤泰新          ,125744,611000,-485256,0,0,0,0,0,0,27000,30000,0,30000,0,3000,-3000,-458256
054150,國巨國泰97購05  ,0,0,0,0,0,0,0,0,0,-459000,0,0,0,143000,602000,-459000,-459000
045142,聯茂兆豐93購02  ,0,0,0,0,0,0,0,0,0,-459000,0,0,0,1000,460000,-459000,-459000
053269,同欣電群益96購01,0,0,0,0,0,0,0,0,0,-460000,0,0,0,130000,590000,-460000,-460000
05974P,國巨富邦97售03  ,0,0,0,0,0,0,0,0,0,-464000,0,0,0,62000,526000,-464000,-464000
053014,旺宏統一97購02  ,0,0,0,0,0,0,0,0,0,-466000,0,0,0,0,466000,-466000,-466000
00717,富邦美國特別股  ,1000,0,1000,0,0,0,0,0,0,-467000,0,0,0,451000,918000,-467000,-466000
2328,廣宇            ,212000,565000,-353000,0,0,0,0,0,0,-113000,3000,0,3000,2000,118000,-116000,-466000
1409,新纖            ,81000,549000,-468000,0,0,0,0,0,0,0,0,0,0,0,0,0,-468000
052871,群創凱基98購07  ,0,0,0,0,0,0,0,0,0,-470000,0,0,0,0,470000,-470000,-470000
1215,卜蜂            ,131000,376000,-245000,0,0,0,0,221000,-221000,-4000,0,0,0,0,4000,-4000,-470000
047004,台積電統一99購01,1000,0,1000,0,0,0,0,0,0,-473000,0,0,0,219000,692000,-473000,-472000
6120,達運            ,142000,615000,-473000,0,0,0,0,0,0,0,0,0,0,0,0,0,-473000
03712P,京元電統一93售02,0,0,0,0,0,0,0,0,0,-475000,0,0,0,95000,570000,-475000,-475000
05712P,友達統一97售03  ,0,0,0,0,0,0,0,0,0,-484000,0,0,0,341000,825000,-484000,-484000
045189,大立光元富98購01,0,0,0,0,0,0,0,0,0,-485000,0,0,0,126000,611000,-485000,-485000
045183,台光電統一92購02,0,0,0,0,0,0,0,0,0,-486000,0,0,0,269000,755000,-486000,-486000
051142,臺股指永豐95購02,0,0,0,0,0,0,0,0,0,-486000,0,0,0,15000,501000,-486000,-486000
043972,大立光富邦93購02,0,0,0,0,0,0,0,0,0,-488000,0,0,0,10000,498000,-488000,-488000
3005,神基            ,87000,539000,-452000,0,0,0,0,0,0,-36000,0,0,0,21000,57000,-36000,-488000
045936,富邦金群益94購01,0,0,0,0,0,0,0,0,0,-490000,0,0,0,130000,620000,-490000,-490000
047788,欣興群益93購05  ,0,0,0,0,0,0,0,0,0,-491000,0,0,0,950000,1441000,-491000,-491000
6239,力成            ,556000,767104,-211104,0,0,0,0,114000,-114000,-166000,1000,56000,-55000,12000,123000,-111000,-491104
049584,台積電元大96購04,0,0,0,0,0,0,0,0,0,-495000,0,0,0,89000,584000,-495000,-495000
044751,鴻海凱基93購08  ,0,0,0,0,0,0,0,0,0,-498000,0,0,0,698000,1196000,-498000,-498000
03974P,大立光元大93售25,0,0,0,0,0,0,0,0,0,-499000,0,0,0,0,499000,-499000,-499000
03975P,大立光元大94售02,0,0,0,0,0,0,0,0,0,-499000,0,0,0,0,499000,-499000,-499000
043047,永冠國泰93購01  ,0,0,0,0,0,0,0,0,0,-499000,0,0,0,0,499000,-499000,-499000
04849P,GIS中信94售01   ,0,0,0,0,0,0,0,0,0,-499000,0,0,0,0,499000,-499000,-499000
05203P,華新科元大95售10,0,0,0,0,0,0,0,0,0,-499000,0,0,0,0,499000,-499000,-499000
052124,京鼎國票95購01  ,0,0,0,0,0,0,0,0,0,-499000,0,0,0,0,499000,-499000,-499000
048364,臺股指永豐93購04,0,0,0,0,0,0,0,0,0,-500000,0,0,0,0,500000,-500000,-500000
04880P,GIS永豐94售02   ,0,0,0,0,0,0,0,0,0,-500000,0,0,0,75000,575000,-500000,-500000
2349,錸德            ,121000,689000,-568000,0,0,0,62000,0,62000,0,0,0,0,0,0,0,-506000
044457,滬深2X國票97購01,0,0,0,0,0,0,0,0,0,-507000,0,0,0,3000,510000,-507000,-507000
2458,義隆            ,112000,531639,-419639,0,0,0,0,0,0,-93000,8000,96000,-88000,26000,31000,-5000,-512639
2377,微星            ,254227,751019,-496792,0,0,0,16000,0,16000,-32000,25000,15000,10000,22000,64000,-42000,-512792
049197,信邦永豐94購01  ,0,0,0,0,0,0,0,0,0,-515000,0,0,0,0,515000,-515000,-515000
053137,旺宏富邦98購01  ,0,0,0,0,0,0,0,0,0,-517000,0,0,0,322000,839000,-517000,-517000
053034,上海銀兆豐96購01,0,0,0,0,0,0,0,0,0,-519000,0,0,0,17000,536000,-519000,-519000
053845,和大元富96購01  ,0,0,0,0,0,0,0,0,0,-521000,0,0,0,1122000,1643000,-521000,-521000
054507,鈺齊永豐96購01  ,0,0,0,0,0,0,0,0,0,-525000,0,0,0,100000,625000,-525000,-525000
3702,大聯大          ,592000,1158671,-566671,0,0,0,0,0,0,40000,14000,0,14000,26000,0,26000,-526671
3706,神達            ,470000,1072000,-602000,0,0,0,0,0,0,75000,75000,0,75000,0,0,0,-527000
8150,南茂            ,656000,1114000,-458000,0,0,0,0,0,0,-70000,0,13000,-13000,3000,60000,-57000,-528000
054068,華通國泰96購02  ,0,0,0,0,0,0,0,0,0,-530000,0,0,0,10000,540000,-530000,-530000
3704,合勤控          ,168000,648000,-480000,0,0,0,0,0,0,-52000,0,0,0,0,52000,-52000,-532000
03281P,台積電凱基04售01,0,0,0,0,0,0,0,0,0,-534000,0,0,0,0,534000,-534000,-534000
04819P,嘉澤永豐94售01  ,0,0,0,0,0,0,0,0,0,-535000,0,0,0,29000,564000,-535000,-535000
044514,亞光凱基93購02  ,0,0,0,0,0,0,0,0,0,-538000,0,0,0,240000,778000,-538000,-538000
047802,滬深2X凱基95購03,0,0,0,0,0,0,0,0,0,-539000,0,0,0,400000,939000,-539000,-539000
052734,台表科國泰98購02,0,0,0,0,0,0,0,0,0,-541000,0,0,0,901000,1442000,-541000,-541000
051242,台積電元大96購06,0,0,0,0,0,0,0,0,0,-542000,0,0,0,231000,773000,-542000,-542000
048905,旺宏富邦96購01  ,0,0,0,0,0,0,0,0,0,-545000,0,0,0,106000,651000,-545000,-545000
053638,信邦永豐96購01  ,0,0,0,0,0,0,0,0,0,-549000,0,0,0,176000,725000,-549000,-549000
04345P,景碩國泰94售02  ,0,0,0,0,0,0,0,0,0,-550000,0,0,0,296000,846000,-550000,-550000
048243,儒鴻兆豐94購01  ,0,0,0,0,0,0,0,0,0,-550000,0,0,0,129000,679000,-550000,-550000
051106,華通統一95購02  ,0,0,0,0,0,0,0,0,0,-553000,0,0,0,420000,973000,-553000,-553000
047047,旺宏國票95購01  ,0,0,0,0,0,0,0,0,0,-556000,0,0,0,8000,564000,-556000,-556000
6285,啟碁            ,111000,715597,-604597,0,0,0,0,1000,-1000,41000,9000,0,9000,71000,39000,32000,-564597
051983,道瓊反元大95購01,0,0,0,0,0,0,0,0,0,-567000,0,0,0,15000,582000,-567000,-567000
052314,鴻海元大96購11  ,0,0,0,0,0,0,0,0,0,-569000,0,0,0,363000,932000,-569000,-569000
051790,貿聯國票95購03  ,0,0,0,0,0,0,0,0,0,-572000,0,0,0,0,572000,-572000,-572000
053468,鴻海元大98購01  ,0,0,0,0,0,0,0,0,0,-573000,0,0,0,16000,589000,-573000,-573000
054561,奇力新群益97購03,0,0,0,0,0,0,0,0,0,-580000,0,0,0,163000,743000,-580000,-580000
044866,旺宏國票91購05  ,0,0,0,0,0,0,0,0,0,-586000,0,0,0,10000,596000,-586000,-586000
043938,華邦電兆豐93購01,0,0,0,0,0,0,0,0,0,-588000,0,0,0,245000,833000,-588000,-588000
047867,旺宏永豐93購02  ,0,0,0,0,0,0,0,0,0,-589000,0,0,0,190000,779000,-589000,-589000
2367,燿華            ,907000,1404000,-497000,0,0,0,0,0,0,-98000,0,0,0,99000,197000,-98000,-595000
053614,台積電群益96購08,0,0,0,0,0,0,0,0,0,-597000,0,0,0,342000,939000,-597000,-597000
05653P,華邦電統一96售02,0,0,0,0,0,0,0,0,0,-597000,0,0,0,237000,834000,-597000,-597000
051033,台積電兆豐95購03,0,0,0,0,0,0,0,0,0,-599000,0,0,0,289000,888000,-599000,-599000
047983,宏達電群益93購04,0,0,0,0,0,0,0,0,0,-600000,0,0,0,0,600000,-600000,-600000
051903,T50反1元大97購02,0,0,0,0,0,0,0,0,0,-600000,0,0,0,0,600000,-600000,-600000
048167,旺宏永豐93購04  ,0,0,0,0,0,0,0,0,0,-602000,0,0,0,130000,732000,-602000,-602000
054725,國巨日盛97購01  ,0,0,0,0,0,0,0,0,0,-603000,0,0,0,0,603000,-603000,-603000
050835,GIS凱基96購01   ,0,0,0,0,0,0,0,0,0,-605000,0,0,0,105000,710000,-605000,-605000
4915,致伸            ,381000,944000,-563000,0,0,0,0,0,0,-44000,0,0,0,25000,69000,-44000,-607000
03727P,致茂元大93售01  ,0,0,0,0,0,0,0,0,0,-612000,0,0,0,120000,732000,-612000,-612000
054626,建準凱基98購01  ,0,0,0,0,0,0,0,0,0,-620000,0,0,0,0,620000,-620000,-620000
054518,亞光元大97購01  ,0,0,0,0,0,0,0,0,0,-623000,0,0,0,52000,675000,-623000,-623000
050770,全新元大94購04  ,0,0,0,0,0,0,0,0,0,-624000,0,0,0,106000,730000,-624000,-624000
047493,旺宏元富96購01  ,0,0,0,0,0,0,0,0,0,-629000,0,0,0,10000,639000,-629000,-629000
05042P,GIS凱基95售03   ,0,0,0,0,0,0,0,0,0,-638000,0,0,0,72000,710000,-638000,-638000
054342,亞光元富99購01  ,0,0,0,0,0,0,0,0,0,-642000,0,0,0,133000,775000,-642000,-642000
052157,東元永豐95購01  ,0,0,0,0,0,0,0,0,0,-647000,0,0,0,1000,648000,-647000,-647000
1102,亞泥            ,2528832,3031892,-503060,0,0,0,12000,375000,-363000,217000,208000,60000,148000,119000,50000,69000,-649060
052917,大立光富邦99購02,0,0,0,0,0,0,0,0,0,-650000,0,0,0,10000,660000,-650000,-650000
045527,建準永豐92購01  ,0,0,0,0,0,0,0,0,0,-650000,0,0,0,55000,705000,-650000,-650000
05646P,聯發科國票96售05,0,0,0,0,0,0,0,0,0,-650000,0,0,0,0,650000,-650000,-650000
3338,泰碩            ,45000,224000,-179000,0,0,0,0,0,0,-471000,2000,406000,-404000,1000,68000,-67000,-650000
2867,三商壽          ,318000,973000,-655000,0,0,0,0,0,0,0,0,0,0,0,0,0,-655000
054464,奇力新凱基98購02,0,0,0,0,0,0,0,0,0,-657000,0,0,0,31000,688000,-657000,-657000
043916,群創凱基93購01  ,0,0,0,0,0,0,0,0,0,-659000,0,0,0,270000,929000,-659000,-659000
6251,定穎            ,61000,283000,-222000,0,0,0,0,445000,-445000,5000,5000,0,5000,0,0,0,-662000
052000,鈺齊元大95購03  ,0,0,0,0,0,0,0,0,0,-672000,0,0,0,527000,1199000,-672000,-672000
05037P,華新科元大95售09,0,0,0,0,0,0,0,0,0,-680000,0,0,0,19000,699000,-680000,-680000
051370,聯詠富邦97購01  ,0,0,0,0,0,0,0,0,0,-682000,0,0,0,88000,770000,-682000,-682000
8215,明基材          ,91000,729000,-638000,0,0,0,0,0,0,-48000,0,1000,-1000,0,47000,-47000,-686000
045872,元油2X元富98購03,0,0,0,0,0,0,0,0,0,-689000,0,0,0,25000,714000,-689000,-689000
2352,佳世達          ,299000,950061,-651061,0,0,0,0,0,0,-38000,0,0,0,0,38000,-38000,-689061
054713,國巨中信9B購01  ,0,0,0,0,0,0,0,0,0,-691000,0,0,0,0,691000,-691000,-691000
053945,國巨富邦98購02  ,0,0,0,0,0,0,0,0,0,-693000,0,0,0,1048000,1741000,-693000,-693000
053104,台表科元富96購02,0,0,0,0,0,0,0,0,0,-699000,0,0,0,216000,915000,-699000,-699000
3673,TPK-KY          ,148000,863572,-715572,0,0,0,2000,0,2000,12000,1000,0,1000,25000,14000,11000,-701572
2371,大同            ,808000,1514000,-706000,0,0,0,0,0,0,-2000,0,2000,-2000,0,0,0,-708000
6153,嘉聯益          ,285000,512000,-227000,0,0,0,0,0,0,-482000,30000,56000,-26000,62000,518000,-456000,-709000
2615,萬海            ,130000,405000,-275000,0,0,0,3000,440000,-437000,1000,1000,0,1000,0,0,0,-711000
2478,大毅            ,707000,1884000,-1177000,0,0,0,0,0,0,450000,0,1000,-1000,579000,128000,451000,-727000
1309,台達化          ,88000,809000,-721000,0,0,0,0,0,0,-10000,0,10000,-10000,0,0,0,-731000
048278,聯發科永豐93購03,0,0,0,0,0,0,0,0,0,-734000,0,0,0,142000,876000,-734000,-734000
6176,瑞儀            ,63000,799000,-736000,0,0,0,0,0,0,1000,0,12000,-12000,22000,9000,13000,-735000
4958,臻鼎-KY         ,277000,1041000,-764000,0,0,0,255000,150000,105000,-77000,87000,109000,-22000,8000,63000,-55000,-736000
1477,聚陽            ,216000,831455,-615455,0,0,0,0,123000,-123000,2300,10000,5000,5000,0,2700,-2700,-736155
053013,台積電統一97購01,0,0,0,0,0,0,0,0,0,-745000,0,0,0,9000,754000,-745000,-745000
6166,凌華            ,177000,945000,-768000,0,0,0,0,0,0,14000,0,0,0,38000,24000,14000,-754000
054465,亞光凱基97購01  ,0,0,0,0,0,0,0,0,0,-757000,0,0,0,145000,902000,-757000,-757000
053563,台積電富邦97購01,0,0,0,0,0,0,0,0,0,-761000,0,0,0,202000,963000,-761000,-761000
052722,群創統一97購02  ,0,0,0,0,0,0,0,0,0,-770000,0,0,0,0,770000,-770000,-770000
053860,台積電元大98購03,0,0,0,0,0,0,0,0,0,-772000,0,0,0,365000,1137000,-772000,-772000
044825,旺宏永豐91購05  ,0,0,0,0,0,0,0,0,0,-777000,0,0,0,0,777000,-777000,-777000
047542,華通凱基94購02  ,0,0,0,0,0,0,0,0,0,-795000,0,0,0,36000,831000,-795000,-795000
2101,南港            ,327000,1117000,-790000,0,0,0,0,0,0,-6000,0,6000,-6000,0,0,0,-796000
053200,華邦電日盛96購01,0,0,0,0,0,0,0,0,0,-798000,0,0,0,0,798000,-798000,-798000
048940,晶相光永豐94購01,0,0,0,0,0,0,0,0,0,-799000,0,0,0,519000,1318000,-799000,-799000
050098,嘉聯益國泰95購02,0,0,0,0,0,0,0,0,0,-816000,0,0,0,319000,1135000,-816000,-816000
041900,元油2X富邦96購01,0,0,0,0,0,0,0,0,0,-817000,0,0,0,83000,900000,-817000,-817000
047824,臺股指凱基93購18,0,0,0,0,0,0,0,0,0,-819000,0,0,0,492000,1311000,-819000,-819000
054535,旺宏富邦97購02  ,0,0,0,0,0,0,0,0,0,-822000,0,0,0,142000,964000,-822000,-822000
051277,聯發科中信9A購01,0,0,0,0,0,0,0,0,0,-828000,0,0,0,148000,976000,-828000,-828000
049125,禾伸堂元富94購01,0,0,0,0,0,0,0,0,0,-831000,0,0,0,241000,1072000,-831000,-831000
053607,大立光第一96購01,0,0,0,0,0,0,0,0,0,-842000,0,0,0,0,842000,-842000,-842000
047098,大毅國泰94購01  ,0,0,0,0,0,0,0,0,0,-853000,0,0,0,1063000,1916000,-853000,-853000
054588,玉晶光國泰99購02,0,0,0,0,0,0,0,0,0,-860000,0,0,0,140000,1000000,-860000,-860000
049240,華通元富94購01  ,0,0,0,0,0,0,0,0,0,-860000,0,0,0,44000,904000,-860000,-860000
2421,建準            ,542000,1259199,-717199,0,0,0,0,0,0,-143000,0,53000,-53000,50000,140000,-90000,-860199
2385,群光            ,612169,1349671,-737502,0,0,0,2000,120000,-118000,-7000,1000,18000,-17000,10000,0,10000,-862502
049798,台積電元大94購18,0,0,0,0,0,0,0,0,0,-887000,0,0,0,755000,1642000,-887000,-887000
4938,和碩            ,1404700,2278480,-873780,0,0,0,11000,0,11000,-42000,1000,18000,-17000,14000,39000,-25000,-904780
053936,旺宏元富96購04  ,0,0,0,0,0,0,0,0,0,-914000,0,0,0,15000,929000,-914000,-914000
2392,正崴            ,255000,1113000,-858000,0,0,0,0,0,0,-57000,114000,66000,48000,6000,111000,-105000,-915000
051351,台積電元大95購15,0,0,0,0,0,0,0,0,0,-923000,0,0,0,424000,1347000,-923000,-923000
2823,中壽            ,1680000,2619000,-939000,0,0,0,16000,0,16000,-3000,0,0,0,4000,7000,-3000,-926000
9933,中鼎            ,693000,1663108,-970108,0,0,0,0,0,0,2000,2000,0,2000,0,0,0,-968108
053138,華邦電富邦96購01,0,0,0,0,0,0,0,0,0,-999000,0,0,0,549000,1548000,-999000,-999000
0056,元大高股息      ,5068,4000,1068,0,0,0,20000,0,20000,-1021000,69000,0,69000,1000,1091000,-1090000,-999932
042157,上証2X中信91購04,0,0,0,0,0,0,0,0,0,-1000000,0,0,0,0,1000000,-1000000,-1000000
051687,大立光凱基95購12,0,0,0,0,0,0,0,0,0,-1001000,0,0,0,10000,1011000,-1001000,-1001000
045181,華邦電統一92購01,0,0,0,0,0,0,0,0,0,-1009000,0,0,0,819000,1828000,-1009000,-1009000
2448,晶電            ,650000,961000,-311000,0,0,0,0,544000,-544000,-165000,74000,199000,-125000,0,40000,-40000,-1020000
2301,光寶科          ,392368,1433375,-1041007,0,0,0,12000,0,12000,7000,0,0,0,16000,9000,7000,-1022007
053761,健策國泰98購01  ,0,0,0,0,0,0,0,0,0,-1028000,0,0,0,383000,1411000,-1028000,-1028000
051836,華通國泰95購02  ,0,0,0,0,0,0,0,0,0,-1032000,0,0,0,23000,1055000,-1032000,-1032000
054829,亞光國泰99購01  ,0,0,0,0,0,0,0,0,0,-1041000,0,0,0,0,1041000,-1041000,-1041000
5283,禾聯碩          ,156000,1202000,-1046000,0,0,0,0,0,0,-4000,2000,6000,-4000,0,0,0,-1050000
05380P,鴻海群益95售11  ,0,0,0,0,0,0,0,0,0,-1057000,0,0,0,0,1057000,-1057000,-1057000
2354,鴻準            ,307718,1356000,-1048282,0,0,0,0,0,0,-13000,0,4000,-4000,0,9000,-9000,-1061282
047357,欣興麥證93購01  ,0,0,0,210000,1333000,-1123000,0,0,0,-1123000,0,0,0,210000,1333000,-1123000,-1123000
1101,台泥            ,2413000,3822823,-1409823,0,0,0,375000,0,375000,-96000,65000,228000,-163000,164000,97000,67000,-1130823
2401,凌陽            ,211000,1350000,-1139000,0,0,0,0,0,0,-1000,15000,44000,-29000,41000,13000,28000,-1140000
5469,瀚宇博          ,502000,1219000,-717000,0,0,0,0,0,0,-431000,60000,192000,-132000,44000,343000,-299000,-1148000
2439,美律            ,117000,1257665,-1140665,0,0,0,100000,251000,-151000,137000,163000,59000,104000,63000,30000,33000,-1154665
051473,台積電凱基95購10,0,0,0,0,0,0,0,0,0,-1158000,0,0,0,98000,1256000,-1158000,-1158000
2618,長榮航          ,710000,1837563,-1127563,0,0,0,10000,0,10000,-50000,0,34000,-34000,0,16000,-16000,-1167563
048898,晶相光國泰96購01,0,0,0,0,0,0,0,0,0,-1179000,0,0,0,598000,1777000,-1179000,-1179000
054497,國巨永豐96購05  ,0,0,0,0,0,0,0,0,0,-1183000,0,0,0,41000,1224000,-1183000,-1183000
054422,T50反1富邦9A購01,0,0,0,0,0,0,0,0,0,-1200000,0,0,0,20000,1220000,-1200000,-1200000
9904,寶成            ,576000,1766000,-1190000,0,0,0,14000,0,14000,-34000,0,28000,-28000,0,6000,-6000,-1210000
5880,合庫金          ,2714000,3980507,-1266507,0,0,0,50000,0,50000,0,0,0,0,0,0,0,-1216507
4904,遠傳            ,600600,1825922,-1225322,0,0,0,8000,0,8000,-2000,0,2000,-2000,0,0,0,-1219322
2347,聯強            ,473000,1718924,-1245924,0,0,0,0,0,0,23000,0,0,0,23000,0,23000,-1222924
2412,中華電          ,732000,1985604,-1253604,0,0,0,21000,0,21000,9000,0,0,0,9000,0,9000,-1223604
3035,智原            ,352000,1027000,-675000,0,0,0,225000,0,225000,-784000,138000,199000,-61000,68000,791000,-723000,-1234000
8039,台虹            ,498000,1433000,-935000,0,0,0,0,0,0,-304000,107000,147000,-40000,116000,380000,-264000,-1239000
05199P,訊芯永豐95售02  ,0,0,0,0,0,0,0,0,0,-1247000,0,0,0,12000,1259000,-1247000,-1247000
2492,華新科          ,2368000,3120503,-752503,0,0,0,297000,505000,-208000,-292000,215000,372000,-157000,88000,223000,-135000,-1252503
051750,華通富邦96購01  ,0,0,0,0,0,0,0,0,0,-1269000,0,0,0,87000,1356000,-1269000,-1269000
1305,華夏            ,178000,1427000,-1249000,0,0,0,0,0,0,-39000,65000,54000,11000,9000,59000,-50000,-1288000
6191,精成科          ,116000,1348000,-1232000,0,0,0,0,0,0,-87000,0,0,0,37000,124000,-87000,-1319000
2308,台達電          ,2819000,4180000,-1361000,0,0,0,12000,0,12000,-10000,46000,27000,19000,11000,40000,-29000,-1359000
2504,國產            ,169000,1468266,-1299266,0,0,0,0,0,0,-60000,0,60000,-60000,0,0,0,-1359266
3034,聯詠            ,3503053,3877405,-374352,0,0,0,3000,1025000,-1022000,-48000,49000,146000,-97000,79000,30000,49000,-1444352
054623,華新科第一97購01,0,0,0,0,0,0,0,0,0,-1445000,0,0,0,243000,1688000,-1445000,-1445000
046173,聯發科永豐92購01,0,0,0,0,0,0,0,0,0,-1450000,0,0,0,1689000,3139000,-1450000,-1450000
053856,台積電富邦98購01,0,0,0,0,0,0,0,0,0,-1507000,0,0,0,0,1507000,-1507000,-1507000
3189,景碩            ,1144000,683000,461000,0,0,0,0,1703000,-1703000,-278000,5000,128000,-123000,28000,183000,-155000,-1520000
2515,中工            ,246000,1640000,-1394000,0,0,0,0,0,0,-136000,12000,7000,5000,6000,147000,-141000,-1530000
052884,台積電兆豐96購01,0,0,0,0,0,0,0,0,0,-1535000,0,0,0,254000,1789000,-1535000,-1535000
054685,國巨永豐97購02  ,0,0,0,0,0,0,0,0,0,-1567000,0,0,0,23000,1590000,-1567000,-1567000
040721,大立光富邦92購01,0,0,0,0,0,0,0,0,0,-1583000,0,0,0,14000,1597000,-1583000,-1583000
052636,大立光凱基96購10,0,0,0,0,0,0,0,0,0,-1615000,0,0,0,0,1615000,-1615000,-1615000
2327,國巨            ,810052,2742489,-1932437,0,0,0,226000,2000,224000,92000,268000,207000,61000,119000,88000,31000,-1616437
1313,聯成            ,163000,1783000,-1620000,0,0,0,0,0,0,0,0,0,0,0,0,0,-1620000
2633,台灣高鐵        ,720000,1659000,-939000,0,0,0,12000,0,12000,-694000,5000,32000,-27000,61000,728000,-667000,-1621000
2317,鴻海            ,10238627,11051127,-812500,0,0,0,766000,33000,733000,-1545000,62000,184000,-122000,185000,1608000,-1423000,-1624500
050754,元金2X元富9B購01,0,0,0,0,0,0,0,0,0,-1666000,0,0,0,194000,1860000,-1666000,-1666000
2637,慧洋-KY         ,119000,1780000,-1661000,0,0,0,0,0,0,-15000,0,0,0,0,15000,-15000,-1676000
2892,第一金          ,2725000,4494171,-1769171,0,0,0,53000,0,53000,0,0,0,0,0,0,0,-1716171
046919,大毅永豐93購01  ,0,0,0,0,0,0,0,0,0,-1725000,0,0,0,355000,2080000,-1725000,-1725000
042255,群創國票92購01  ,0,0,0,0,0,0,0,0,0,-1729000,0,0,0,130000,1859000,-1729000,-1729000
052044,華通凱基97購01  ,0,0,0,0,0,0,0,0,0,-1741000,0,0,0,0,1741000,-1741000,-1741000
2353,宏碁            ,1613000,3315529,-1702529,0,0,0,13000,0,13000,-107000,4000,10000,-6000,45000,146000,-101000,-1796529
052316,台積電元大96購10,0,0,0,0,0,0,0,0,0,-1804000,0,0,0,602000,2406000,-1804000,-1804000
2903,遠百            ,579000,2416773,-1837773,0,0,0,0,0,0,29000,30000,1000,29000,0,0,0,-1808773
2356,英業達          ,541000,2446669,-1905669,0,0,0,13000,0,13000,44000,32000,0,32000,38000,26000,12000,-1848669
03648C,T50反1元大96牛07,0,0,0,0,0,0,0,0,0,-1920000,0,0,0,0,1920000,-1920000,-1920000
2603,長榮            ,1620000,5348000,-3728000,0,0,0,466000,0,466000,1329000,1860000,536000,1324000,5000,0,5000,-1933000
2363,矽統            ,110000,2050000,-1940000,0,0,0,0,0,0,-1000,0,1000,-1000,0,0,0,-1941000
00692,富邦公司治理    ,0,0,0,0,0,0,0,0,0,-1948000,0,0,0,1525000,3473000,-1948000,-1948000
051280,台積電兆豐95購04,0,0,0,0,0,0,0,0,0,-1949000,0,0,0,156000,2105000,-1949000,-1949000
2801,彰銀            ,1451000,3450000,-1999000,0,0,0,34000,0,34000,-6000,0,6000,-6000,0,0,0,-1971000
1402,遠東新          ,534203,2648123,-2113920,0,0,0,21000,0,21000,63000,20000,0,20000,47000,4000,43000,-2029920
2880,華南金          ,1106000,3188780,-2082780,0,0,0,49000,0,49000,0,0,0,0,0,0,0,-2033780
00669R,國泰美國道瓊反1 ,0,86000,-86000,0,0,0,0,0,0,-1953000,0,45000,-45000,725000,2633000,-1908000,-2039000
2887,台新金          ,2022000,3933517,-1911517,0,0,0,54000,0,54000,-316000,0,0,0,178000,494000,-316000,-2173517
3017,奇鋐            ,324000,2500000,-2176000,0,0,0,50000,0,50000,-140000,0,0,0,41000,181000,-140000,-2266000
00642U,元大S&P石油     ,8000,672000,-664000,0,0,0,0,0,0,-1636000,0,232000,-232000,739000,2143000,-1404000,-2300000
1312,國喬            ,347000,2633000,-2286000,0,0,0,0,0,0,-73000,0,6000,-6000,2000,69000,-67000,-2359000
2454,聯發科          ,2622853,4227362,-1604509,0,0,0,7000,570000,-563000,-219000,41000,319000,-278000,91000,32000,59000,-2386509
1216,統一            ,3292993,5724576,-2431583,0,0,0,27000,0,27000,10000,10000,0,10000,4000,4000,0,-2394583
044291,群創凱基93購06  ,0,0,0,0,0,0,0,0,0,-2433000,0,0,0,837000,3270000,-2433000,-2433000
2610,華航            ,1234000,3700000,-2466000,0,0,0,11000,0,11000,10000,10000,0,10000,0,0,0,-2445000
052225,台積電凱基96購03,0,0,0,0,0,0,0,0,0,-2510000,0,0,0,339000,2849000,-2510000,-2510000
2884,玉山金          ,2039000,4924289,-2885289,0,0,0,61000,0,61000,292000,300000,0,300000,0,8000,-8000,-2532289
3049,和鑫            ,70000,2400000,-2330000,0,0,0,0,0,0,-212000,0,0,0,7000,219000,-212000,-2542000
2886,兆豐金          ,2249000,5049557,-2800557,0,0,0,59000,0,59000,46000,0,0,0,46000,0,46000,-2695557
3045,台灣大          ,725432,3476724,-2751292,0,0,0,9000,0,9000,0,0,0,0,0,0,0,-2742292
3450,聯鈞            ,502000,3515000,-3013000,0,0,0,53000,0,53000,185000,75000,15000,60000,134000,9000,125000,-2775000
8046,南電            ,549000,2082000,-1533000,0,0,0,17000,988000,-971000,-275000,0,123000,-123000,0,152000,-152000,-2779000
2382,廣達            ,1414000,4163830,-2749830,0,0,0,15000,0,15000,-86000,41000,114000,-73000,25000,38000,-13000,-2820830
3019,亞光            ,1332000,3626000,-2294000,0,0,0,0,0,0,-553000,88000,704000,-616000,176000,113000,63000,-2847000
0050,元大台灣50      ,464100,4190000,-3725900,0,0,0,55000,0,55000,506000,48000,328000,-280000,2019000,1233000,786000,-3164900
053564,台積電富邦99購01,0,0,0,0,0,0,0,0,0,-3225000,0,0,0,572000,3797000,-3225000,-3225000
2002,中鋼            ,1306000,4730847,-3424847,0,0,0,67000,0,67000,-40000,0,0,0,0,40000,-40000,-3397847
052150,台積電富邦95購07,0,0,0,0,0,0,0,0,0,-3521000,0,0,0,670000,4191000,-3521000,-3521000
00850,元大臺灣ESG永續 ,10000,156000,-146000,0,0,0,0,0,0,-3425000,0,0,0,571000,3996000,-3425000,-3571000
2313,華通            ,11986000,4872000,7114000,0,0,0,40000,5821000,-5781000,-5111000,423000,5715000,-5292000,503000,322000,181000,-3778000
051133,台積電永豐95購02,0,0,0,0,0,0,0,0,0,-4021000,0,0,0,1322000,5343000,-4021000,-4021000
3711,日月光投控      ,4406000,8723000,-4317000,0,0,0,18000,451000,-433000,108000,191000,68000,123000,55000,70000,-15000,-4642000
2890,永豐金          ,2383780,7230270,-4846490,0,0,0,57000,0,57000,-84000,0,110000,-110000,26000,0,26000,-4873490
2323,中環            ,276000,5070042,-4794042,0,0,0,72000,0,72000,-715000,11000,23000,-12000,14000,717000,-703000,-5437042
020012,富邦行動通訊N   ,0,0,0,0,0,0,0,0,0,-5761000,0,0,0,40000,5801000,-5761000,-5761000
051107,鴻海統一95購05  ,0,0,0,0,0,0,0,0,0,-5787000,0,0,0,646000,6433000,-5787000,-5787000
2885,元大金          ,1689000,8103762,-6414762,0,0,0,60000,0,60000,201000,201000,0,201000,0,0,0,-6153762
2882,國泰金          ,1275000,7342797,-6067797,0,0,0,45000,0,45000,-230000,18000,0,18000,2000,250000,-248000,-6252797
2888,新光金          ,6559000,9633000,-3074000,0,0,0,62000,0,62000,-3505000,5000,2000000,-1995000,394000,1904000,-1510000,-6517000
3481,群創            ,46020000,52826000,-6806000,0,0,0,0,1180000,-1180000,1383000,1937000,32000,1905000,526000,1048000,-522000,-6603000
2449,京元電子        ,3803000,6146000,-2343000,0,0,0,0,3708000,-3708000,-777000,78000,225000,-147000,153000,783000,-630000,-6828000
3037,欣興            ,2591300,6263070,-3671770,0,0,0,23000,3997000,-3974000,-43000,32000,111000,-79000,357000,321000,36000,-7688770
2891,中信金          ,6235000,13478630,-7243630,0,0,0,99000,640000,-541000,20000,100000,0,100000,0,80000,-80000,-7764630
2883,開發金          ,1414000,12037000,-10623000,0,0,0,76000,0,76000,8000,0,2000,-2000,10000,0,10000,-10539000
2330,台積電          ,9239458,25334567,-16095109,0,0,0,92000,956000,-864000,822000,564000,656000,-92000,1029000,115000,914000,-16137109
00677U,富邦VIX         ,677000,11142000,-10465000,0,0,0,0,0,0,-7787000,5000,855000,-850000,465000,7402000,-6937000,-18252000
2344,華邦電          ,19403000,45334310,-25931310,0,0,0,3277000,0,3277000,2122000,2935000,1385000,1550000,3343000,2771000,572000,-20532310
1314,中石化          ,9992000,39237000,-29245000,0,0,0,0,0,0,110000,336000,0,336000,61000,287000,-226000,-29135000
00672L,元大S&P原油正2  ,63000,17907000,-17844000,0,0,0,0,0,0,-13131000,0,764000,-764000,8721000,21088000,-12367000,-30975000
