證券代號,證券名稱,外陸資買進股數(不含外資自營商),外陸資賣出股數(不含外資自營商),外陸資買賣超股數(不含外資自營商),外資自營商買進股數,外資自營商賣出股數,外資自營商買賣超股數,投信買進股數,投信賣出股數,投信買賣超股數,自營商買賣超股數,自營商買進股數(自行買賣),自營商賣出股數(自行買賣),自營商買賣超股數(自行買賣),自營商買進股數(避險),自營商賣出股數(避險),自營商買賣超股數(避險),三大法人買賣超股數
00632R,元大台灣50反1   ,12718000,47465000,-34747000,0,0,0,0,0,0,184614000,4261000,6029000,-1768000,226292000,39910000,186382000,149867000
00677U,富邦VIX         ,141189000,93672000,47517000,0,0,0,0,0,0,56527000,15202000,220000,14982000,59937000,18392000,41545000,104044000
00638R,元大滬深300反1  ,3130000,26000,3104000,0,0,0,0,0,0,6734000,530000,0,530000,9960000,3756000,6204000,9838000
00634R,富邦上証反1     ,3974000,67000,3907000,0,0,0,0,0,0,5224000,500000,0,500000,6858000,2134000,4724000,9131000
2412,中華電          ,14759043,7642974,7116069,0,0,0,1044000,0,1044000,-24000,140000,162000,-22000,4000,6000,-2000,8136069
6116,彩晶            ,11193000,4424000,6769000,0,0,0,0,0,0,160000,202000,55000,147000,190000,177000,13000,6929000
2603,長榮            ,15868000,7844872,8023128,0,0,0,49000,998000,-949000,-487000,168000,811000,-643000,156000,0,156000,6587128
00664R,國泰臺灣加權反1 ,0,0,0,0,0,0,0,0,0,5834000,0,0,0,8472000,2638000,5834000,5834000
2881,富邦金          ,24875640,19042197,5833443,0,0,0,136000,160000,-24000,-245000,24000,258000,-234000,67000,78000,-11000,5564443
2323,中環            ,10837000,5712000,5125000,0,0,0,0,17000,-17000,76000,189000,100000,89000,32000,45000,-13000,5184000
00676R,富邦臺灣加權反1 ,0,0,0,0,0,0,0,0,0,5046000,0,0,0,8414000,3368000,5046000,5046000
2448,晶電            ,9350000,4834947,4515053,0,0,0,941000,4000,937000,-453000,657000,828000,-171000,0,282000,-282000,4999053
00861,元大全球未來通訊,738000,105000,633000,0,0,0,0,0,0,4120000,0,0,0,4309000,189000,4120000,4753000
1605,華新            ,5217000,6566000,-1349000,0,0,0,26000,774000,-748000,6662000,276000,85000,191000,6512000,41000,6471000,4565000
1314,中石化          ,9040000,4814000,4226000,0,0,0,26000,0,26000,265000,271000,6000,265000,0,0,0,4517000
2027,大成鋼          ,2599000,1226000,1373000,0,0,0,0,306000,-306000,2547000,199000,150000,49000,2607000,109000,2498000,3614000
4904,遠傳            ,8566000,5330502,3235498,0,0,0,68000,0,68000,-6000,75000,81000,-6000,0,0,0,3297498
08447P,緯穎永豐9C售02  ,0,0,0,0,0,0,0,0,0,3050000,0,0,0,3050000,0,3050000,3050000
04545P,國巨元大94售05  ,0,0,0,0,0,0,0,0,0,2689000,0,0,0,2689000,0,2689000,2689000
6153,嘉聯益          ,4084340,1546000,2538340,0,0,0,0,0,0,136000,341000,169000,172000,37000,73000,-36000,2674340
4927,泰鼎-KY         ,2306000,1575000,731000,0,0,0,1661000,0,1661000,224000,10000,45000,-35000,309000,50000,259000,2616000
2498,宏達電          ,3499000,1134000,2365000,0,0,0,0,0,0,204000,351000,139000,212000,67000,75000,-8000,2569000
00648R,元大S&P500反1   ,0,4000,-4000,0,0,0,0,0,0,2486000,0,0,0,3139000,653000,2486000,2482000
2371,大同            ,7571500,5536266,2035234,0,0,0,0,0,0,427000,506000,53000,453000,0,26000,-26000,2462234
3016,嘉晶            ,3985000,1689000,2296000,0,0,0,0,0,0,143000,1000,14000,-13000,316000,160000,156000,2439000
05174P,元金2X富邦9B售01,0,0,0,0,0,0,0,0,0,2423000,0,0,0,2423000,0,2423000,2423000
8046,南電            ,3890000,2247000,1643000,0,0,0,1637000,872000,765000,-8000,143000,145000,-2000,87000,93000,-6000,2400000
03050X,元展47          ,0,0,0,0,0,0,0,0,0,2356000,0,0,0,2570000,214000,2356000,2356000
2104,國際中橡        ,3350000,1001000,2349000,0,0,0,0,0,0,-3000,7000,10000,-3000,0,0,0,2346000
08679P,台灣50元大01售15,0,0,0,0,0,0,0,0,0,2316000,0,0,0,2361000,45000,2316000,2316000
041832,T50反1統一94購01,0,0,0,0,0,0,0,0,0,2252000,0,0,0,2252000,0,2252000,2252000
038095,T50反1群益93購02,0,0,0,0,0,0,0,0,0,2241000,0,0,0,2254000,13000,2241000,2241000
00656R,國泰中國A50反1  ,191000,0,191000,0,0,0,0,0,0,1914000,0,0,0,2366000,452000,1914000,2105000
2201,裕隆            ,2909000,1560000,1349000,0,0,0,786000,0,786000,-45000,0,38000,-38000,0,7000,-7000,2090000
04400P,台積電兆豐95售02,0,0,0,0,0,0,0,0,0,2075000,0,0,0,2075000,0,2075000,2075000
042315,T50反1台新96購01,0,0,0,0,0,0,0,0,0,2052000,0,0,0,2082000,30000,2052000,2052000
2368,金像電          ,11908000,9572000,2336000,0,0,0,1650000,0,1650000,-1938000,318000,2256000,-1938000,0,0,0,2048000
057094,祥碩元富98購01  ,0,0,0,0,0,0,0,0,0,2045000,0,0,0,2050000,5000,2045000,2045000
9958,世紀鋼          ,3355432,1365000,1990432,0,0,0,0,0,0,-42000,156000,53000,103000,289000,434000,-145000,1948432
04189P,台積電兆豐94售02,0,0,0,0,0,0,0,0,0,1935000,0,0,0,1965000,30000,1935000,1935000
2478,大毅            ,3166000,1271000,1895000,0,0,0,0,0,0,6000,0,0,0,41000,35000,6000,1901000
050172,臺指反元大98購02,0,0,0,0,0,0,0,0,0,1868000,0,0,0,1868000,0,1868000,1868000
00708L,元大S&P黃金正2  ,8000,712000,-704000,0,0,0,0,0,0,2481000,0,0,0,7790000,5309000,2481000,1777000
3704,合勤控          ,3055000,1294000,1761000,0,0,0,0,0,0,11000,11000,0,11000,0,0,0,1772000
07118P,台積電凱基99售09,0,0,0,0,0,0,0,0,0,1771000,0,0,0,2197000,426000,1771000,1771000
2345,智邦            ,4912000,3651344,1260656,0,0,0,397000,0,397000,79000,354000,415000,-61000,221000,81000,140000,1736656
00671R,富邦NASDAQ反1   ,0,4000,-4000,0,0,0,0,0,0,1674000,0,0,0,1724000,50000,1674000,1670000
3338,泰碩            ,2963000,1333000,1630000,0,0,0,0,0,0,20000,39000,49000,-10000,104000,74000,30000,1650000
2342,茂矽            ,2641000,966000,1675000,0,0,0,0,0,0,-48000,2000,50000,-48000,0,0,0,1627000
8215,明基材          ,2073000,445000,1628000,0,0,0,0,0,0,-34000,6000,40000,-34000,0,0,0,1594000
045479,T50反1中信95購01,0,0,0,0,0,0,0,0,0,1593000,0,0,0,1603000,10000,1593000,1593000
07866P,上証2X國票97售01,0,0,0,0,0,0,0,0,0,1586000,0,0,0,1586000,0,1586000,1586000
3545,敦泰            ,3087000,1595866,1491134,0,0,0,0,0,0,77000,5000,120000,-115000,192000,0,192000,1568134
08663P,台灣50元大96售01,0,0,0,0,0,0,0,0,0,1562000,0,0,0,1562000,0,1562000,1562000
5264,鎧勝-KY         ,2371000,922000,1449000,0,0,0,79000,0,79000,12000,6000,0,6000,9000,3000,6000,1540000
00673R,元大S&P原油反1  ,575000,469000,106000,0,0,0,0,0,0,1431000,0,0,0,3438000,2007000,1431000,1537000
08674P,嘉晶元富07售02  ,0,0,0,0,0,0,0,0,0,1521000,0,0,0,1526000,5000,1521000,1521000
3380,明泰            ,1283226,649000,634226,0,0,0,0,0,0,884000,972000,41000,931000,10000,57000,-47000,1518226
3673,TPK-KY          ,2582000,1203000,1379000,0,0,0,1000,0,1000,116000,286000,107000,179000,17000,80000,-63000,1496000
05540P,亞德客凱基96售01,0,0,0,0,0,0,0,0,0,1485000,0,0,0,1525000,40000,1485000,1485000
08637P,台灣50中信96售03,0,0,0,0,0,0,0,0,0,1452000,0,0,0,1452000,0,1452000,1452000
3035,智原            ,2022000,957000,1065000,0,0,0,441000,129000,312000,60000,280000,163000,117000,5000,62000,-57000,1437000
04890P,台積電元大95售05,0,0,0,0,0,0,0,0,0,1417000,0,0,0,1594000,177000,1417000,1417000
6230,超眾            ,1901000,367000,1534000,0,0,0,30000,200000,-170000,28000,0,5000,-5000,36000,3000,33000,1392000
040215,上証反凱基95購01,0,0,0,0,0,0,0,0,0,1391000,0,0,0,1391000,0,1391000,1391000
1216,統一            ,14065000,12830926,1234074,0,0,0,80000,0,80000,73000,119000,22000,97000,0,24000,-24000,1387074
03808P,旺宏國泰94售02  ,0,0,0,0,0,0,0,0,0,1366000,0,0,0,1366000,0,1366000,1366000
053777,台積電元大96購20,0,0,0,0,0,0,0,0,0,1361000,0,0,0,1361000,0,1361000,1361000
05180P,玉晶光凱基95售04,0,0,0,0,0,0,0,0,0,1335000,0,0,0,2153000,818000,1335000,1335000
3017,奇鋐            ,3077000,2500000,577000,0,0,0,1250000,545000,705000,16000,7000,0,7000,56000,47000,9000,1298000
05201P,玉晶光國泰97售02,0,0,0,0,0,0,0,0,0,1280000,0,0,0,1383000,103000,1280000,1280000
05642P,玉晶光兆豐97售02,0,0,0,0,0,0,0,0,0,1209000,0,0,0,1495000,286000,1209000,1209000
00669R,國泰美國道瓊反1 ,5000,26000,-21000,0,0,0,0,0,0,1225000,0,0,0,4410000,3185000,1225000,1204000
3450,聯鈞            ,1966000,1165000,801000,0,0,0,414000,0,414000,-14000,6000,30000,-24000,33000,23000,10000,1201000
00635U,元大S&P黃金     ,753000,1000,752000,0,0,0,0,0,0,440000,0,300000,-300000,1191000,451000,740000,1192000
07119P,台積電凱基9A售08,0,0,0,0,0,0,0,0,0,1103000,0,0,0,1483000,380000,1103000,1103000
8996,高力            ,1866000,773000,1093000,0,0,0,0,0,0,10000,10000,0,10000,0,0,0,1103000
050123,群臺反凱基96購01,0,0,0,0,0,0,0,0,0,1091000,0,0,0,1091000,0,1091000,1091000
055303,鈺齊元大97購01  ,0,0,0,0,0,0,0,0,0,1085000,0,0,0,1085000,0,1085000,1085000
05966P,矽力凱基96售03  ,0,0,0,0,0,0,0,0,0,1082000,0,0,0,1216000,134000,1082000,1082000
049438,嘉晶國泰96購01  ,0,0,0,0,0,0,0,0,0,1074000,0,0,0,1090000,16000,1074000,1074000
044974,鴻海國票94購01  ,0,0,0,0,0,0,0,0,0,1067000,0,0,0,1067000,0,1067000,1067000
3036,文曄            ,1426000,344000,1082000,0,0,0,4000,0,4000,-44000,94000,142000,-48000,4000,0,4000,1042000
2812,台中銀          ,3216000,2253000,963000,0,0,0,0,0,0,60000,60000,0,60000,0,0,0,1023000
07010P,T50正2凱基9C售01,0,0,0,0,0,0,0,0,0,1009000,0,0,0,1017000,8000,1009000,1009000
055651,富邦金元富97購01,0,0,0,0,0,0,0,0,0,1008000,0,0,0,1008000,0,1008000,1008000
06874P,台積電台新98售02,0,0,0,0,0,0,0,0,0,993000,0,0,0,1028000,35000,993000,993000
08484P,台灣50中信96售01,0,0,0,0,0,0,0,0,0,981000,0,0,0,981000,0,981000,981000
05549P,臺股指元大96售03,0,0,0,0,0,0,0,0,0,977000,0,0,0,1051000,74000,977000,977000
07104P,聯發科元富99售04,0,0,0,0,0,0,0,0,0,973000,0,0,0,1008000,35000,973000,973000
06859P,元金2X中信9C售01,0,0,0,0,0,0,0,0,0,971000,0,0,0,971000,0,971000,971000
052445,南亞科元大95購05,0,0,0,0,0,0,0,0,0,970000,0,0,0,970000,0,970000,970000
05598P,國巨元富96售03  ,0,0,0,0,0,0,0,0,0,954000,0,0,0,978000,24000,954000,954000
057724,亞德客國泰99購01,0,0,0,0,0,0,0,0,0,952000,0,0,0,1059000,107000,952000,952000
4934,太極            ,1231000,285000,946000,0,0,0,0,0,0,0,0,0,0,0,0,0,946000
06081P,深中小元大97售02,0,0,0,0,0,0,0,0,0,922000,0,0,0,955000,33000,922000,922000
2353,宏碁            ,9621000,9030578,590422,0,0,0,13000,0,13000,308000,543000,249000,294000,14000,0,14000,911422
2031,新光鋼          ,1456000,381000,1075000,0,0,0,0,0,0,-164000,39000,203000,-164000,0,0,0,911000
2618,長榮航          ,13675000,11853221,1821779,0,0,0,50000,0,50000,-969000,983000,1198000,-215000,82000,836000,-754000,902779
00641R,富邦日本反1     ,2000,12000,-10000,0,0,0,0,0,0,900000,0,0,0,1534000,634000,900000,890000
2349,錸德            ,1729000,827000,902000,0,0,0,0,25000,-25000,2000,2000,0,2000,0,0,0,879000
049114,玉晶光統一94購02,0,0,0,0,0,0,0,0,0,859000,0,0,0,859000,0,859000,859000
045657,T50反1國泰94購01,0,0,0,0,0,0,0,0,0,847000,0,0,0,847000,0,847000,847000
3532,台勝科          ,1048000,921392,126608,0,0,0,3000,98000,-95000,810000,10000,14000,-4000,821000,7000,814000,841608
2439,美律            ,1536000,1018000,518000,0,0,0,0,198000,-198000,514000,308000,273000,35000,506000,27000,479000,834000
9933,中鼎            ,1130000,283000,847000,0,0,0,0,0,0,-13000,5000,18000,-13000,0,0,0,834000
06375P,矽力元大97售06  ,0,0,0,0,0,0,0,0,0,822000,0,0,0,938000,116000,822000,822000
052326,滬深反中信99購01,0,0,0,0,0,0,0,0,0,822000,0,0,0,924000,102000,822000,822000
06966P,健策台新9A售02  ,0,0,0,0,0,0,0,0,0,819000,0,0,0,819000,0,819000,819000
6288,聯嘉            ,1178000,378000,800000,0,0,0,0,0,0,7000,32000,25000,7000,0,0,0,807000
04433P,上証2X國票95售01,0,0,0,0,0,0,0,0,0,805000,0,0,0,805000,0,805000,805000
053936,旺宏元富96購04  ,0,0,0,0,0,0,0,0,0,800000,0,0,0,800000,0,800000,800000
2915,潤泰全          ,1301000,1387228,-86228,0,0,0,0,123000,-123000,1007000,25000,0,25000,1034000,52000,982000,797772
6278,台表科          ,3114000,2022000,1092000,0,0,0,115000,406000,-291000,-12000,8000,0,8000,4000,24000,-20000,789000
4746,台耀            ,818000,694000,124000,0,0,0,589000,0,589000,68000,86000,18000,68000,0,0,0,781000
056516,晶豪科兆豐98購01,0,0,0,0,0,0,0,0,0,780000,0,0,0,889000,109000,780000,780000
8150,南茂            ,2794000,2011000,783000,0,0,0,0,0,0,-14000,11000,0,11000,54000,79000,-25000,769000
057210,T50反1群益98購01,0,0,0,0,0,0,0,0,0,756000,0,0,0,778000,22000,756000,756000
2369,菱生            ,1047000,301000,746000,0,0,0,0,0,0,9000,9000,0,9000,0,0,0,755000
049636,上証反凱基9A購01,0,0,0,0,0,0,0,0,0,752000,0,0,0,752000,0,752000,752000
3019,亞光            ,1699000,1078000,621000,0,0,0,0,0,0,124000,428000,302000,126000,13000,15000,-2000,745000
07025P,玉晶光凱基99售01,0,0,0,0,0,0,0,0,0,741000,0,0,0,1167000,426000,741000,741000
2390,云辰            ,1011000,276000,735000,0,0,0,0,0,0,5000,5000,0,5000,0,0,0,740000
05483P,國巨凱基95售07  ,0,0,0,0,0,0,0,0,0,731000,0,0,0,982000,251000,731000,731000
3041,揚智            ,1385000,657000,728000,0,0,0,0,0,0,0,0,0,0,0,0,0,728000
06738P,瑞昱兆豐98售02  ,0,0,0,0,0,0,0,0,0,727000,0,0,0,824000,97000,727000,727000
4906,正文            ,1669000,862000,807000,0,0,0,0,0,0,-89000,47000,43000,4000,17000,110000,-93000,718000
08609P,世紀鋼永豐9C售03,0,0,0,0,0,0,0,0,0,716000,0,0,0,716000,0,716000,716000
2208,台船            ,933000,224000,709000,0,0,0,0,0,0,3000,3000,0,3000,0,0,0,712000
04812P,國巨元大95售03  ,0,0,0,0,0,0,0,0,0,708000,0,0,0,753000,45000,708000,708000
058547,世紀鋼富邦9A購01,0,0,0,0,0,0,0,0,0,704000,0,0,0,1328000,624000,704000,704000
2504,國產            ,2844000,2096000,748000,0,0,0,0,0,0,-46000,0,0,0,4000,50000,-46000,702000
5469,瀚宇博          ,1995130,1312000,683130,0,0,0,0,0,0,18000,11000,0,11000,41000,34000,7000,701130
07240P,台灣50台新94售01,0,0,0,0,0,0,0,0,0,690000,0,0,0,690000,0,690000,690000
1718,中纖            ,1905000,1218000,687000,0,0,0,0,0,0,0,0,0,0,0,0,0,687000
055211,A50反1凱基9A購01,0,0,0,0,0,0,0,0,0,687000,0,0,0,692000,5000,687000,687000
03638C,T50反1元大94牛03,60000,20000,40000,0,0,0,0,0,0,640000,0,0,0,929000,289000,640000,680000
049406,T50反1日盛97購01,0,0,0,0,0,0,0,0,0,680000,0,0,0,681000,1000,680000,680000
8105,凌巨            ,1140000,477000,663000,0,0,0,0,0,0,11000,11000,0,11000,0,0,0,674000
1736,喬山            ,1253000,547000,706000,0,0,0,0,40000,-40000,1000,0,0,0,8000,7000,1000,667000
03840P,台積電統一99售02,0,0,0,0,0,0,0,0,0,664000,0,0,0,719000,55000,664000,664000
048270,T50反1富邦99購01,0,0,0,0,0,0,0,0,0,660000,0,0,0,660000,0,660000,660000
03412P,滬深2X群益98售01,0,0,0,0,0,0,0,0,0,659000,0,0,0,701000,42000,659000,659000
2365,昆盈            ,657000,15000,642000,0,0,0,0,0,0,5000,5000,0,5000,0,0,0,647000
06757P,台灣50元大9B售01,0,0,0,0,0,0,0,0,0,645000,0,0,0,689000,44000,645000,645000
2414,精技            ,744000,101660,642340,0,0,0,0,0,0,1000,4000,3000,1000,0,0,0,643340
051749,矽力國泰97購01  ,0,0,0,0,0,0,0,0,0,639000,0,0,0,639000,0,639000,639000
050363,臺指反元大98購04,0,0,0,0,0,0,0,0,0,638000,0,0,0,638000,0,638000,638000
3576,聯合再生        ,1312000,684000,628000,0,0,0,0,0,0,6000,6000,0,6000,0,0,0,634000
2456,奇力新          ,2584000,1752000,832000,0,0,0,0,198000,-198000,-3000,19000,9000,10000,12000,25000,-13000,631000
03427P,聯電元大02售11  ,0,0,0,0,0,0,0,0,0,630000,0,0,0,660000,30000,630000,630000
056921,京元電兆豐98購01,0,0,0,0,0,0,0,0,0,629000,0,0,0,649000,20000,629000,629000
06662P,玉晶光中信9A售01,0,0,0,0,0,0,0,0,0,626000,0,0,0,668000,42000,626000,626000
058191,祥碩永豐99購01  ,0,0,0,0,0,0,0,0,0,612000,0,0,0,695000,83000,612000,612000
03777P,華通中信95售01  ,0,0,0,0,0,0,0,0,0,610000,0,0,0,610000,0,610000,610000
04960P,大立光凱基96售04,0,0,0,0,0,0,0,0,0,609000,0,0,0,610000,1000,609000,609000
042676,臺指反元大93購01,0,0,0,0,0,0,0,0,0,606000,0,0,0,606000,0,606000,606000
2537,聯上發          ,1274000,669000,605000,0,0,0,0,0,0,0,0,0,0,0,0,0,605000
4943,康控-KY         ,1138000,528000,610000,0,0,0,0,0,0,-9000,0,0,0,13000,22000,-9000,601000
2360,致茂            ,2691000,1027296,1663704,0,0,0,0,780000,-780000,-283000,128000,409000,-281000,6000,8000,-2000,600704
048875,晶相光國票94購01,0,0,0,0,0,0,0,0,0,600000,0,0,0,600000,0,600000,600000
039550,滬深反凱基94購01,0,0,0,0,0,0,0,0,0,595000,0,0,0,595000,0,595000,595000
8028,昇陽半導體      ,1053000,531000,522000,0,0,0,0,0,0,69000,76000,0,76000,0,7000,-7000,591000
048972,晶豪科元大94購01,0,0,0,0,0,0,0,0,0,590000,0,0,0,590000,0,590000,590000
047681,滬深反中信95購01,0,0,0,0,0,0,0,0,0,589000,0,0,0,790000,201000,589000,589000
055120,南港兆豐97購01  ,0,0,0,0,0,0,0,0,0,586000,0,0,0,588000,2000,586000,586000
06860P,台灣50兆豐98售01,0,0,0,0,0,0,0,0,0,582000,0,0,0,582000,0,582000,582000
04979P,臺股指凱基96售07,0,0,0,0,0,0,0,0,0,582000,0,0,0,582000,0,582000,582000
2375,凱美            ,1334000,750000,584000,0,0,0,0,0,0,-2000,0,0,0,0,2000,-2000,582000
057272,台積電元大98購14,0,0,0,0,0,0,0,0,0,581000,0,0,0,642000,61000,581000,581000
058740,T50反1日盛9B購02,0,0,0,0,0,0,0,0,0,580000,0,0,0,610000,30000,580000,580000
04557P,茂林群益94售03  ,0,0,0,0,0,0,0,0,0,580000,0,0,0,580000,0,580000,580000
2515,中工            ,1765000,1168000,597000,0,0,0,0,0,0,-17000,25000,85000,-60000,53000,10000,43000,580000
06740P,台灣50國泰9A售02,0,0,0,0,0,0,0,0,0,574000,0,0,0,574000,0,574000,574000
058391,T50反1元大99購02,0,0,0,0,0,0,0,0,0,567000,0,0,0,674000,107000,567000,567000
054127,台積電元大96購21,0,0,0,0,0,0,0,0,0,567000,0,0,0,604000,37000,567000,567000
06682P,玉晶光元大99售08,0,0,0,0,0,0,0,0,0,564000,0,0,0,644000,80000,564000,564000
042792,T50反1台新9C購01,0,0,0,0,0,0,0,0,0,561000,0,0,0,561000,0,561000,561000
05421P,鴻海元大96售12  ,0,0,0,0,0,0,0,0,0,561000,0,0,0,644000,83000,561000,561000
06034P,世芯凱基96售03  ,0,0,0,0,0,0,0,0,0,560000,0,0,0,904000,344000,560000,560000
052417,聯發科兆豐9B購01,0,0,0,0,0,0,0,0,0,560000,0,0,0,570000,10000,560000,560000
06987P,鴻海元富99售08  ,0,0,0,0,0,0,0,0,0,552000,0,0,0,577000,25000,552000,552000
6531,愛普            ,1263000,691000,572000,0,0,0,0,0,0,-23000,10000,33000,-23000,0,0,0,549000
050491,旺宏國泰96購01  ,0,0,0,0,0,0,0,0,0,548000,0,0,0,548000,0,548000,548000
2426,鼎元            ,843000,311000,532000,0,0,0,0,0,0,12000,13000,1000,12000,0,0,0,544000
3698,隆達            ,905000,271000,634000,0,0,0,0,0,0,-94000,168000,212000,-44000,0,50000,-50000,540000
2499,東貝            ,622000,84000,538000,0,0,0,0,0,0,0,0,0,0,0,0,0,538000
057167,台積電元大99購03,0,0,0,0,0,0,0,0,0,537000,0,0,0,597000,60000,537000,537000
03647C,T50反1元富99牛02,0,0,0,0,0,0,0,0,0,532000,0,0,0,559000,27000,532000,532000
6552,易華電          ,816000,290000,526000,0,0,0,0,0,0,6000,12000,0,12000,1000,7000,-6000,532000
05906P,國巨元富96售05  ,0,0,0,0,0,0,0,0,0,527000,0,0,0,528000,1000,527000,527000
6120,達運            ,1153000,644000,509000,0,0,0,0,0,0,15000,16000,1000,15000,0,0,0,524000
05767P,國巨凱基96售11  ,0,0,0,0,0,0,0,0,0,522000,0,0,0,982000,460000,522000,522000
05670P,台積電國票98售01,0,0,0,0,0,0,0,0,0,520000,0,0,0,521000,1000,520000,520000
1305,華夏            ,1357000,623000,734000,0,0,0,0,200000,-200000,-17000,1000,18000,-17000,0,0,0,517000
04434P,玉晶光國票96售02,0,0,0,0,0,0,0,0,0,517000,0,0,0,598000,81000,517000,517000
00739,元大MSCI A股    ,10000,6000,4000,0,0,0,0,0,0,510000,0,0,0,764000,254000,510000,514000
8464,億豐            ,1647000,1059114,587886,0,0,0,3000,80000,-77000,1000,1000,0,1000,0,0,0,511886
2485,兆赫            ,737000,262000,475000,0,0,0,0,0,0,36000,43000,23000,20000,16000,0,16000,511000
057664,台積電元大9A購03,10000,10000,0,0,0,0,0,0,0,510000,0,0,0,747000,237000,510000,510000
052958,T50反1凱基99購02,0,0,0,0,0,0,0,0,0,510000,0,0,0,510000,0,510000,510000
06970P,旺宏元大99售08  ,0,0,0,0,0,0,0,0,0,503000,0,0,0,727000,224000,503000,503000
058750,緯穎凱基9A購03  ,0,0,0,0,0,0,0,0,0,500000,0,0,0,510000,10000,500000,500000
055798,聯茂富邦98購01  ,0,0,0,0,0,0,0,0,0,498000,0,0,0,519000,21000,498000,498000
04768P,大立光國泰96售03,0,0,0,0,0,0,0,0,0,495000,0,0,0,516000,21000,495000,495000
03999P,鴻海凱基94售11  ,0,0,0,0,0,0,0,0,0,492000,0,0,0,494000,2000,492000,492000
052322,力成元大96購01  ,0,0,0,0,0,0,0,0,0,489000,0,0,0,499000,10000,489000,489000
06529P,貿聯富邦99售03  ,0,0,0,0,0,0,0,0,0,484000,0,0,0,501000,17000,484000,484000
06013P,世芯國泰97售03  ,0,0,0,0,0,0,0,0,0,483000,0,0,0,891000,408000,483000,483000
050142,聯發科元富9A購01,0,0,0,0,0,0,0,0,0,483000,0,0,0,493000,10000,483000,483000
053118,大立光中信9C購01,0,0,0,0,0,0,0,0,0,481000,0,0,0,602000,121000,481000,481000
052784,緯穎國票97購02  ,0,0,0,0,0,0,0,0,0,480000,0,0,0,480000,0,480000,480000
2841,台開            ,885962,409000,476962,0,0,0,0,0,0,3000,4000,1000,3000,0,0,0,479962
00686R,群益臺灣加權反1 ,0,0,0,0,0,0,0,0,0,478000,0,0,0,976000,498000,478000,478000
00651R,FH香港反1       ,27000,0,27000,0,0,0,0,0,0,449000,0,0,0,805000,356000,449000,476000
2363,矽統            ,971000,509000,462000,0,0,0,0,0,0,14000,14000,0,14000,0,0,0,476000
04657P,國巨永豐94售03  ,0,0,0,0,0,0,0,0,0,474000,0,0,0,494000,20000,474000,474000
055067,禾聯碩永豐97購01,0,0,0,0,0,0,0,0,0,471000,0,0,0,471000,0,471000,471000
4967,十銓            ,1931000,1199000,732000,0,0,0,50000,228000,-178000,-84000,22000,106000,-84000,0,0,0,470000
03686P,大立光統一98售02,0,0,0,0,0,0,0,0,0,468000,0,0,0,558000,90000,468000,468000
05408P,臺股指中信95售13,0,0,0,0,0,0,0,0,0,468000,0,0,0,468000,0,468000,468000
05901P,臺股指凱基9C售01,0,0,0,0,0,0,0,0,0,466000,0,0,0,466000,0,466000,466000
04023P,臺股指元富99售02,0,0,0,0,0,0,0,0,0,463000,0,0,0,473000,10000,463000,463000
2388,威盛            ,816000,352000,464000,0,0,0,0,4000,-4000,1000,1000,0,1000,0,0,0,461000
1789,神隆            ,1053000,559000,494000,0,0,0,0,0,0,-35000,0,35000,-35000,0,0,0,459000
058571,緯穎凱基9A購02  ,0,0,0,0,0,0,0,0,0,457000,0,0,0,520000,63000,457000,457000
00738U,元大道瓊白銀    ,30000,98000,-68000,0,0,0,0,0,0,523000,0,0,0,2791000,2268000,523000,455000
3052,夆典            ,772000,319000,453000,0,0,0,0,0,0,0,0,0,0,0,0,0,453000
044340,TPK統一93購01   ,0,0,0,0,0,0,0,0,0,450000,0,0,0,450000,0,450000,450000
06668P,祥碩凱基98售02  ,0,0,0,0,0,0,0,0,0,449000,0,0,0,607000,158000,449000,449000
055631,創意永豐98購01  ,0,0,0,0,0,0,0,0,0,448000,0,0,0,448000,0,448000,448000
06311P,嘉聯益元富97售02,0,0,0,0,0,0,0,0,0,446000,0,0,0,451000,5000,446000,446000
046703,瑞昱元富95購01  ,0,0,0,0,0,0,0,0,0,446000,0,0,0,460000,14000,446000,446000
054585,禾伸堂國泰99購01,0,0,0,0,0,0,0,0,0,445000,0,0,0,545000,100000,445000,445000
045829,滬深2X群益95購02,0,0,0,0,0,0,0,0,0,444000,0,0,0,444000,0,444000,444000
05306P,泰碩國泰97售01  ,0,0,0,0,0,0,0,0,0,441000,0,0,0,655000,214000,441000,441000
058529,S&P正2元富9B購01,0,0,0,0,0,0,0,0,0,440000,0,0,0,440000,0,440000,440000
03889P,國巨國泰94售04  ,0,0,0,0,0,0,0,0,0,440000,0,0,0,440000,0,440000,440000
055367,台積電元大97購23,0,0,0,0,0,0,0,0,0,437000,0,0,0,437000,0,437000,437000
4976,佳凌            ,615000,182000,433000,0,0,0,0,0,0,3000,3000,0,3000,0,0,0,436000
051613,S&P反1凱基96購01,0,0,0,0,0,0,0,0,0,435000,0,0,0,435000,0,435000,435000
048627,T50反1元大96購02,0,0,0,0,0,0,0,0,0,434000,0,0,0,434000,0,434000,434000
2049,上銀            ,1930750,1157060,773690,0,0,0,12000,412000,-400000,60000,368000,274000,94000,11000,45000,-34000,433690
03413B,臺股指凱基94熊19,0,36000,-36000,0,0,0,0,0,0,469000,0,0,0,857000,388000,469000,433000
04710P,台積電元大94售16,0,0,0,0,0,0,0,0,0,432000,0,0,0,433000,1000,432000,432000
058332,鴻海元富99購03  ,0,0,0,0,0,0,0,0,0,424000,0,0,0,429000,5000,424000,424000
04977P,力成凱基96售01  ,0,0,0,0,0,0,0,0,0,421000,0,0,0,461000,40000,421000,421000
6209,今國光          ,652000,235000,417000,0,0,0,0,0,0,4000,4000,0,4000,0,0,0,421000
3535,晶彩科          ,687000,267000,420000,0,0,0,0,0,0,0,0,0,0,0,0,0,420000
050169,臺指反元大97購01,0,0,0,0,0,0,0,0,0,417000,0,0,0,417000,0,417000,417000
9907,統一實          ,697000,288000,409000,0,0,0,0,0,0,8000,9000,1000,8000,0,0,0,417000
00674R,元大S&P黃金反1  ,0,0,0,0,0,0,0,0,0,414000,0,0,0,514000,100000,414000,414000
05154P,台積電兆豐95售05,0,0,0,0,0,0,0,0,0,413000,0,0,0,545000,132000,413000,413000
047457,旺宏群益95購01  ,0,0,0,0,0,0,0,0,0,412000,0,0,0,412000,0,412000,412000
2314,台揚            ,796000,252000,544000,0,0,0,0,0,0,-133000,6000,146000,-140000,7000,0,7000,411000
057270,遠東新元大98購01,0,0,0,0,0,0,0,0,0,410000,0,0,0,470000,60000,410000,410000
4935,茂林-KY         ,1711000,1067000,644000,0,0,0,0,151000,-151000,-83000,2000,35000,-33000,18000,68000,-50000,410000
05609P,國泰金凱基96售01,0,0,0,0,0,0,0,0,0,407000,0,0,0,981000,574000,407000,407000
06229P,欣興凱基97售07  ,0,0,0,0,0,0,0,0,0,406000,0,0,0,415000,9000,406000,406000
05076P,深中小群益99售02,0,0,0,0,0,0,0,0,0,401000,0,0,0,401000,0,401000,401000
052227,瑞昱凱基95購05  ,0,0,0,0,0,0,0,0,0,400000,0,0,0,400000,0,400000,400000
054999,玉晶光元富97購03,0,0,0,0,0,0,0,0,0,400000,0,0,0,400000,0,400000,400000
053981,康控元大96購05  ,0,0,0,0,0,0,0,0,0,400000,0,0,0,400000,0,400000,400000
05898P,旺宏凱基96售06  ,0,0,0,0,0,0,0,0,0,399000,0,0,0,437000,38000,399000,399000
3504,揚明光          ,694000,297000,397000,0,0,0,1000,0,1000,1000,2000,0,2000,0,1000,-1000,399000
03237P,大立光元大02售04,0,0,0,0,0,0,0,0,0,397000,0,0,0,407000,10000,397000,397000
04568P,瑞昱兆豐94售02  ,0,0,0,0,0,0,0,0,0,396000,0,0,0,396000,0,396000,396000
057143,台郡兆豐98購01  ,0,0,0,0,0,0,0,0,0,395000,0,0,0,536000,141000,395000,395000
057838,台郡國泰99購01  ,0,0,0,0,0,0,0,0,0,388000,0,0,0,505000,117000,388000,388000
00665L,富邦恒生國企正2 ,0,0,0,0,0,0,0,0,0,386000,0,0,0,488000,102000,386000,386000
051429,智邦元富95購01  ,0,0,0,0,0,0,0,0,0,384000,0,0,0,419000,35000,384000,384000
04775P,台積電凱基94售29,0,0,0,0,0,0,0,0,0,383000,0,0,0,383000,0,383000,383000
05322P,台積電凱基95售17,0,0,0,0,0,0,0,0,0,382000,0,0,0,412000,30000,382000,382000
058526,鈺齊元大99購02  ,0,0,0,0,0,0,0,0,0,380000,0,0,0,400000,20000,380000,380000
058330,鴻海元富99購01  ,0,0,0,0,0,0,0,0,0,377000,0,0,0,377000,0,377000,377000
05301P,矽力元大95售02  ,0,0,0,0,0,0,0,0,0,377000,0,0,0,457000,80000,377000,377000
1455,集盛            ,472000,91000,381000,0,0,0,0,0,0,-5000,3000,8000,-5000,0,0,0,376000
05718P,國巨元大96售09  ,0,0,0,0,0,0,0,0,0,374000,0,0,0,384000,10000,374000,374000
1201,味全            ,682000,312000,370000,0,0,0,0,0,0,0,0,0,0,0,0,0,370000
04980P,臺股指凱基96售08,0,0,0,0,0,0,0,0,0,370000,0,0,0,370000,0,370000,370000
8271,宇瞻            ,1086000,678000,408000,0,0,0,0,0,0,-39000,14000,53000,-39000,0,0,0,369000
047683,亞德客國泰95購01,0,0,0,0,0,0,0,0,0,367000,0,0,0,419000,52000,367000,367000
04773P,金融類元大94售01,0,0,0,0,0,0,0,0,0,364000,0,0,0,474000,110000,364000,364000
1465,偉全            ,377000,15000,362000,0,0,0,0,0,0,0,0,0,0,0,0,0,362000
1460,宏遠            ,503000,142000,361000,0,0,0,0,0,0,0,0,0,0,0,0,0,361000
1710,東聯            ,754000,403000,351000,0,0,0,3000,0,3000,4000,5000,1000,4000,0,0,0,358000
05635P,健策台新96售02  ,0,0,0,0,0,0,0,0,0,356000,0,0,0,361000,5000,356000,356000
3062,建漢            ,731000,383000,348000,0,0,0,0,0,0,8000,8000,0,8000,0,0,0,356000
055909,大成鋼凱基98購02,0,0,0,0,0,0,0,0,0,354000,0,0,0,354000,0,354000,354000
058904,晶技元大99購05  ,0,0,0,0,0,0,0,0,0,353000,0,0,0,353000,0,353000,353000
4915,致伸            ,1832000,1493457,338543,0,0,0,0,0,0,13000,9000,0,9000,4000,0,4000,351543
057529,嘉晶元大99購02  ,0,0,0,0,0,0,0,0,0,351000,0,0,0,449000,98000,351000,351000
048509,上証反凱基99購02,0,0,0,0,0,0,0,0,0,351000,0,0,0,351000,0,351000,351000
057434,國巨國票99購03  ,0,0,0,0,0,0,0,0,0,350000,0,0,0,350000,0,350000,350000
06722P,臺股指中信9A售04,0,0,0,0,0,0,0,0,0,349000,0,0,0,349000,0,349000,349000
05506P,茂林凱基96售03  ,0,0,0,0,0,0,0,0,0,349000,0,0,0,489000,140000,349000,349000
2102,泰豐            ,687000,340000,347000,0,0,0,0,0,0,0,0,0,0,0,0,0,347000
056913,臺股指元大99購05,0,0,0,0,0,0,0,0,0,346000,0,0,0,356000,10000,346000,346000
053407,台積電兆豐96購02,10000,0,10000,0,0,0,0,0,0,336000,0,0,0,336000,0,336000,346000
059094,臻鼎元大99購03  ,0,0,0,0,0,0,0,0,0,345000,0,0,0,460000,115000,345000,345000
040761,T50反1凱基95購02,0,0,0,0,0,0,0,0,0,345000,0,0,0,345000,0,345000,345000
06219P,國巨元富97售05  ,0,0,0,0,0,0,0,0,0,339000,0,0,0,1682000,1343000,339000,339000
06427P,鴻海元大97售13  ,0,0,0,0,0,0,0,0,0,339000,0,0,0,339000,0,339000,339000
3037,欣興            ,9297487,9922000,-624513,0,0,0,881000,262000,619000,343000,871000,545000,326000,236000,219000,17000,337487
2601,益航            ,927000,593000,334000,0,0,0,0,0,0,0,0,0,0,0,0,0,334000
05090P,國巨元大95售05  ,0,0,0,0,0,0,0,0,0,333000,0,0,0,356000,23000,333000,333000
04383P,泰鼎國泰95售01  ,0,0,0,0,0,0,0,0,0,332000,0,0,0,450000,118000,332000,332000
03414B,臺股指凱基99熊01,0,0,0,0,0,0,0,0,0,331000,0,0,0,758000,427000,331000,331000
06134P,緯穎元富97售03  ,0,0,0,0,0,0,0,0,0,330000,0,0,0,330000,0,330000,330000
051699,世紀鋼麥證95購01,0,0,0,329000,0,329000,0,0,0,329000,0,0,0,329000,0,329000,329000
053123,京元電凱基96購01,0,0,0,0,0,0,0,0,0,329000,0,0,0,329000,0,329000,329000
1103,嘉泥            ,805000,445000,360000,0,0,0,0,0,0,-32000,24000,56000,-32000,0,0,0,328000
05583P,訊芯凱基96售01  ,0,0,0,0,0,0,0,0,0,326000,0,0,0,386000,60000,326000,326000
00680L,元大美債20正2   ,0,0,0,0,0,0,0,0,0,326000,0,0,0,339000,13000,326000,326000
053706,S&P反1凱基99購01,0,0,0,0,0,0,0,0,0,326000,0,0,0,346000,20000,326000,326000
05293P,廣達凱基95售01  ,0,0,0,0,0,0,0,0,0,325000,0,0,0,330000,5000,325000,325000
055349,京元電凱基97購02,0,0,0,0,0,0,0,0,0,324000,0,0,0,324000,0,324000,324000
06503P,臺股指中信9A售02,0,0,0,0,0,0,0,0,0,322000,0,0,0,322000,0,322000,322000
06222P,致茂元富97售02  ,0,0,0,0,0,0,0,0,0,321000,0,0,0,321000,0,321000,321000
053300,大成鋼凱基96購02,0,0,0,0,0,0,0,0,0,321000,0,0,0,321000,0,321000,321000
052101,滬深2X兆豐96購01,0,0,0,0,0,0,0,0,0,320000,0,0,0,330000,10000,320000,320000
052053,泰鼎凱基96購01  ,0,0,0,0,0,0,0,0,0,319000,0,0,0,319000,0,319000,319000
2489,瑞軒            ,1002000,687000,315000,0,0,0,0,0,0,4000,33000,29000,4000,0,0,0,319000
4426,利勤            ,510000,191000,319000,0,0,0,0,0,0,0,0,0,0,0,0,0,319000
058226,世芯元富99購01  ,0,0,0,0,0,0,0,0,0,315000,0,0,0,335000,20000,315000,315000
06521P,矽力元大98售01  ,0,0,0,0,0,0,0,0,0,314000,0,0,0,389000,75000,314000,314000
054998,玉晶光元富97購02,0,0,0,0,0,0,0,0,0,314000,0,0,0,314000,0,314000,314000
052003,泰碩國泰97購02  ,0,0,0,0,0,0,0,0,0,312000,0,0,0,312000,0,312000,312000
056636,台積電日盛9A購01,0,0,0,0,0,0,0,0,0,311000,0,0,0,321000,10000,311000,311000
08653P,台灣50凱基96售07,0,0,0,0,0,0,0,0,0,309000,0,0,0,310000,1000,309000,309000
050566,高股息中信97購02,0,0,0,0,0,0,0,0,0,309000,0,0,0,309000,0,309000,309000
2404,漢唐            ,546020,496000,50020,0,0,0,0,46000,-46000,303000,35000,138000,-103000,417000,11000,406000,307020
2637,慧洋-KY         ,418000,512000,-94000,0,0,0,6000,0,6000,395000,382000,0,382000,32000,19000,13000,307000
06152P,玉晶光元大98售06,0,0,0,0,0,0,0,0,0,306000,0,0,0,318000,12000,306000,306000
04717P,和大凱基94售02  ,0,0,0,0,0,0,0,0,0,305000,0,0,0,305000,0,305000,305000
5471,松翰            ,1005000,696000,309000,0,0,0,0,0,0,-5000,4000,9000,-5000,0,0,0,304000
07011P,宏達電凱基99售02,0,0,0,0,0,0,0,0,0,302000,0,0,0,333000,31000,302000,302000
056618,京元電永豐98購01,0,0,0,0,0,0,0,0,0,302000,0,0,0,587000,285000,302000,302000
056652,上証反元大9B購01,0,0,0,0,0,0,0,0,0,301000,0,0,0,302000,1000,301000,301000
05480P,滬深2X凱基96售05,0,0,0,0,0,0,0,0,0,301000,0,0,0,301000,0,301000,301000
045173,A50正2國票95購01,0,0,0,0,0,0,0,0,0,300000,0,0,0,300000,0,300000,300000
051977,泰碩凱基95購01  ,0,0,0,0,0,0,0,0,0,300000,0,0,0,300000,0,300000,300000
05009P,大立光元富95售06,0,0,0,0,0,0,0,0,0,300000,0,0,0,300000,0,300000,300000
051268,創意富邦97購01  ,0,0,0,0,0,0,0,0,0,300000,0,0,0,300000,0,300000,300000
057448,致茂元富98購01  ,0,0,0,0,0,0,0,0,0,299000,0,0,0,299000,0,299000,299000
058865,群創凱基01購01  ,0,0,0,0,0,0,0,0,0,299000,0,0,0,339000,40000,299000,299000
06790P,台積電凱基9A售04,0,0,0,0,0,0,0,0,0,298000,0,0,0,408000,110000,298000,298000
2451,創見            ,487000,934000,-447000,0,0,0,0,103000,-103000,848000,12000,17000,-5000,863000,10000,853000,298000
9945,潤泰新          ,1821568,1295792,525776,0,0,0,0,0,0,-228000,31000,15000,16000,0,244000,-244000,297776
053537,玉晶光永豐98購02,0,0,0,0,0,0,0,0,0,297000,0,0,0,347000,50000,297000,297000
06760P,台積電元大98售18,0,0,0,0,0,0,0,0,0,296000,0,0,0,320000,24000,296000,296000
07026P,超眾凱基99售03  ,0,0,0,0,0,0,0,0,0,295000,0,0,0,295000,0,295000,295000
4977,眾達-KY         ,729000,455000,274000,0,0,0,90000,100000,-10000,31000,36000,9000,27000,4000,0,4000,295000
5203,訊連            ,1066000,439000,627000,0,0,0,20000,200000,-180000,-153000,0,146000,-146000,5000,12000,-7000,294000
04731P,臺股指中信96售03,0,0,0,0,0,0,0,0,0,293000,0,0,0,293000,0,293000,293000
05905P,晶技統一97售01  ,0,0,0,0,0,0,0,0,0,290000,0,0,0,424000,134000,290000,290000
2913,農林            ,750000,406000,344000,0,0,0,0,0,0,-54000,15000,69000,-54000,0,0,0,290000
058462,台積電兆豐99購01,0,0,0,0,0,0,0,0,0,289000,0,0,0,301000,12000,289000,289000
044763,瀚宇博凱基93購01,0,0,0,0,0,0,0,0,0,288000,0,0,0,288000,0,288000,288000
2399,映泰            ,587000,286000,301000,0,0,0,0,0,0,-13000,4000,17000,-13000,0,0,0,288000
00662,富邦NASDAQ      ,7000,8000,-1000,0,0,0,0,0,0,288000,0,62000,-62000,408000,58000,350000,287000
048331,臺指反富邦97購01,0,0,0,0,0,0,0,0,0,287000,0,0,0,287000,0,287000,287000
4961,天鈺            ,393000,110000,283000,0,0,0,0,0,0,4000,4000,0,4000,0,0,0,287000
054376,聯茂中信97購01  ,0,0,0,0,0,0,0,0,0,286000,0,0,0,286000,0,286000,286000
9938,百和            ,1825000,788000,1037000,0,0,0,0,728000,-728000,-23000,11000,6000,5000,7000,35000,-28000,286000
047688,亞德客富邦95購01,0,0,0,0,0,0,0,0,0,285000,0,0,0,285000,0,285000,285000
058926,勤誠元富99購01  ,0,0,0,0,0,0,0,0,0,284000,0,0,0,325000,41000,284000,284000
05305P,華新科國泰97售01,0,0,0,0,0,0,0,0,0,284000,0,0,0,328000,44000,284000,284000
04816P,台積電兆豐94售06,0,0,0,0,0,0,0,0,0,282000,0,0,0,559000,277000,282000,282000
049789,世紀鋼兆豐94購01,0,0,0,0,0,0,0,0,0,282000,0,0,0,282000,0,282000,282000
056357,台積電元大9A購01,0,0,0,0,0,0,0,0,0,282000,0,0,0,321000,39000,282000,282000
3033,威健            ,347000,72000,275000,0,0,0,0,0,0,7000,7000,0,7000,0,0,0,282000
051912,健鼎元大96購01  ,0,0,0,0,0,0,0,0,0,281000,0,0,0,281000,0,281000,281000
3006,晶豪科          ,679000,584000,95000,0,0,0,250000,0,250000,-64000,46000,41000,5000,20000,89000,-69000,281000
058531,華通元富99購01  ,0,0,0,0,0,0,0,0,0,280000,0,0,0,280000,0,280000,280000
07058P,台積電凱基9A售07,0,0,0,0,0,0,0,0,0,280000,0,0,0,281000,1000,280000,280000
04838P,宏達電元大95售02,0,0,0,0,0,0,0,0,0,279000,0,0,0,289000,10000,279000,279000
054868,國泰金群益9A購01,0,0,0,0,0,0,0,0,0,279000,0,0,0,619000,340000,279000,279000
053653,京元電凱基96購02,0,0,0,0,0,0,0,0,0,276000,0,0,0,276000,0,276000,276000
06915P,晶技元富98售02  ,0,0,0,0,0,0,0,0,0,274000,0,0,0,681000,407000,274000,274000
2367,燿華            ,7136000,6889000,247000,0,0,0,0,0,0,26000,15000,0,15000,26000,15000,11000,273000
05807P,泰鼎永豐96售03  ,0,0,0,0,0,0,0,0,0,272000,0,0,0,452000,180000,272000,272000
04354P,華新科永豐94售01,0,0,0,0,0,0,0,0,0,271000,0,0,0,273000,2000,271000,271000
05194P,玉晶光康和95售01,0,0,0,0,0,0,0,0,0,271000,0,0,0,656000,385000,271000,271000
03517P,臺股指國票02售06,0,0,0,0,0,0,0,0,0,269000,0,0,0,994000,725000,269000,269000
052857,大成鋼凱基96購01,0,0,0,0,0,0,0,0,0,269000,0,0,0,269000,0,269000,269000
057927,勤誠凱基98購01  ,0,0,0,0,0,0,0,0,0,268000,0,0,0,268000,0,268000,268000
00654R,富邦印度反1     ,10000,0,10000,0,0,0,0,0,0,258000,0,0,0,474000,216000,258000,268000
04588P,茂林永豐94售04  ,0,0,0,0,0,0,0,0,0,268000,0,0,0,268000,0,268000,268000
5521,工信            ,600000,332000,268000,0,0,0,0,0,0,0,0,0,0,0,0,0,268000
3437,榮創            ,472000,205000,267000,0,0,0,0,0,0,0,0,0,0,0,0,0,267000
06021P,世紀鋼元富96售03,0,0,0,0,0,0,0,0,0,266000,0,0,0,301000,35000,266000,266000
04831P,聯詠富邦96售01  ,0,0,0,0,0,0,0,0,0,265000,0,0,0,280000,15000,265000,265000
050988,廣達富邦95購01  ,0,0,0,0,0,0,0,0,0,263000,0,0,0,263000,0,263000,263000
06121P,同欣電凱基97售02,0,0,0,0,0,0,0,0,0,262000,0,0,0,282000,20000,262000,262000
08795P,聯發科凱基01售11,0,0,0,0,0,0,0,0,0,262000,0,0,0,262000,0,262000,262000
3209,全科            ,316000,61000,255000,0,0,0,0,0,0,7000,7000,0,7000,0,0,0,262000
056311,泰鼎元大98購01  ,0,0,0,0,0,0,0,0,0,259000,0,0,0,259000,0,259000,259000
08818P,台灣50凱基01售18,0,0,0,0,0,0,0,0,0,258000,0,0,0,258000,0,258000,258000
3596,智易            ,1413000,1159000,254000,0,0,0,0,28000,-28000,32000,96000,68000,28000,11000,7000,4000,258000
05101P,大立光凱基95售11,0,0,0,0,0,0,0,0,0,257000,0,0,0,277000,20000,257000,257000
051390,京元電兆豐95購01,0,0,0,0,0,0,0,0,0,257000,0,0,0,323000,66000,257000,257000
3515,華擎            ,439000,1172000,-733000,0,0,0,963000,0,963000,27000,2000,32000,-30000,68000,11000,57000,257000
04208P,臺股指元大93售48,0,0,0,0,0,0,0,0,0,256000,0,0,0,256000,0,256000,256000
06872P,亞德客元富98售04,0,0,0,0,0,0,0,0,0,255000,0,0,0,278000,23000,255000,255000
3533,嘉澤            ,526000,599000,-73000,0,0,0,289000,0,289000,39000,74000,35000,39000,8000,8000,0,255000
08852P,台灣50台新01售01,0,0,0,0,0,0,0,0,0,253000,0,0,0,352000,99000,253000,253000
3708,上緯投控        ,434000,179000,255000,0,0,0,1000,0,1000,-3000,0,0,0,0,3000,-3000,253000
6166,凌華            ,771844,523000,248844,0,0,0,0,0,0,4000,4000,0,4000,0,0,0,252844
058978,SGBR2X凱基9A購03,0,0,0,0,0,0,0,0,0,250000,0,0,0,250000,0,250000,250000
058745,元金2X凱基9C購02,0,0,0,0,0,0,0,0,0,250000,0,0,0,250000,0,250000,250000
04915P,鴻海永昌96售02  ,0,0,0,0,0,0,0,0,0,250000,0,0,0,250000,0,250000,250000
055475,臻鼎凱基97購02  ,0,0,0,0,0,0,0,0,0,250000,0,0,0,250000,0,250000,250000
056250,瑞昱兆豐97購02  ,0,0,0,0,0,0,0,0,0,250000,0,0,0,250000,0,250000,250000
056973,T50反1永昌9C購01,0,0,0,0,0,0,0,0,0,250000,0,0,0,250000,0,250000,250000
07077P,緯穎凱基99售01  ,0,0,0,0,0,0,0,0,0,249000,0,0,0,276000,27000,249000,249000
053313,世紀鋼凱基96購01,0,0,0,0,0,0,0,0,0,249000,0,0,0,253000,4000,249000,249000
050807,群臺反凱基95購01,0,0,0,0,0,0,0,0,0,248000,0,0,0,248000,0,248000,248000
041534,T50反1凱基96購01,0,0,0,0,0,0,0,0,0,246000,0,0,0,246000,0,246000,246000
07084P,S&P正2元富9B售02,0,0,0,0,0,0,0,0,0,244000,0,0,0,269000,25000,244000,244000
04596P,臺股指元大94售14,0,0,0,0,0,0,0,0,0,244000,0,0,0,570000,326000,244000,244000
056291,聯茂永豐97購03  ,0,0,0,0,0,0,0,0,0,244000,0,0,0,294000,50000,244000,244000
06347P,祥碩元富97售02  ,0,0,0,0,0,0,0,0,0,243000,0,0,0,270000,27000,243000,243000
052269,T50反1日盛9B購01,0,0,0,0,0,0,0,0,0,242000,0,0,0,297000,55000,242000,242000
3530,晶相光          ,740000,446000,294000,0,0,0,0,0,0,-52000,0,42000,-42000,8000,18000,-10000,242000
3029,零壹            ,620000,380000,240000,0,0,0,0,0,0,2000,2000,0,2000,0,0,0,242000
05644P,大立光中信9A售03,0,0,0,0,0,0,0,0,0,241000,0,0,0,272000,31000,241000,241000
4739,康普            ,430000,189000,241000,0,0,0,0,0,0,0,0,0,0,0,0,0,241000
05209P,鴻海凱基96售09  ,0,0,0,0,0,0,0,0,0,240000,0,0,0,240000,0,240000,240000
050431,聯發科凱基94購18,0,0,0,0,0,0,0,0,0,240000,0,0,0,240000,0,240000,240000
055425,聚陽群益99購01  ,0,0,0,0,0,0,0,0,0,239000,0,0,0,239000,0,239000,239000
055341,台達電凱基97購02,0,0,0,0,0,0,0,0,0,239000,0,0,0,299000,60000,239000,239000
05753P,臺股指中信99售02,0,0,0,0,0,0,0,0,0,237000,0,0,0,237000,0,237000,237000
04712P,國泰金元大94售01,0,0,0,0,0,0,0,0,0,237000,0,0,0,454000,217000,237000,237000
05774P,臺股指凱基99售04,0,0,0,0,0,0,0,0,0,234000,0,0,0,234000,0,234000,234000
1809,中釉            ,329000,96000,233000,0,0,0,0,0,0,0,0,0,0,0,0,0,233000
06996P,臺股指凱基99售17,0,0,0,0,0,0,0,0,0,232000,0,0,0,232000,0,232000,232000
051153,鴻海國泰97購02  ,0,0,0,0,0,0,0,0,0,232000,0,0,0,232000,0,232000,232000
06035P,同欣電凱基96售03,0,0,0,0,0,0,0,0,0,231000,0,0,0,256000,25000,231000,231000
051879,健策台新96購01  ,0,0,0,0,0,0,0,0,0,230000,0,0,0,230000,0,230000,230000
05780P,台積電統一96售07,0,0,0,0,0,0,0,0,0,229000,0,0,0,229000,0,229000,229000
054053,聯茂元大96購01  ,0,0,0,0,0,0,0,0,0,228000,0,0,0,238000,10000,228000,228000
2912,統一超          ,2600010,2496286,103724,0,0,0,91000,0,91000,33000,33000,0,33000,0,0,0,227724
3056,總太            ,740000,517000,223000,0,0,0,0,0,0,4000,7000,3000,4000,0,0,0,227000
9935,慶豐富          ,459000,232000,227000,0,0,0,0,0,0,0,0,0,0,0,0,0,227000
03016P,滬深2X群益01售09,0,0,0,0,0,0,0,0,0,225000,0,0,0,225000,0,225000,225000
050979,鴻海元富96購02  ,0,0,0,0,0,0,0,0,0,225000,0,0,0,225000,0,225000,225000
2474,可成            ,3418000,3263522,154478,0,0,0,201000,27000,174000,-104000,246000,355000,-109000,31000,26000,5000,224478
051746,玉晶光國泰97購07,0,0,0,0,0,0,0,0,0,224000,0,0,0,373000,149000,224000,224000
2340,光磊            ,1048000,868000,180000,0,0,0,0,0,0,43000,164000,127000,37000,6000,0,6000,223000
052004,泰碩國泰97購03  ,0,0,0,0,0,0,0,0,0,222000,0,0,0,222000,0,222000,222000
6251,定穎            ,1874000,1853000,21000,0,0,0,0,0,0,201000,201000,0,201000,0,0,0,222000
04954P,健策國票96售01  ,0,0,0,0,0,0,0,0,0,220000,0,0,0,220000,0,220000,220000
03612C,臺股指元大95牛01,0,0,0,0,0,0,0,0,0,220000,0,0,0,267000,47000,220000,220000
04658P,臺股指永昌94售02,0,0,0,0,0,0,0,0,0,220000,0,0,0,220000,0,220000,220000
06992P,玉晶光日盛9B售01,0,0,0,0,0,0,0,0,0,219000,0,0,0,253000,34000,219000,219000
055018,緯穎元富97購02  ,0,0,0,0,0,0,0,0,0,219000,0,0,0,219000,0,219000,219000
054319,世紀鋼凱基96購02,0,0,0,0,0,0,0,0,0,219000,0,0,0,311000,92000,219000,219000
08602P,台灣50凱基96售04,0,0,0,0,0,0,0,0,0,217000,0,0,0,319000,102000,217000,217000
1760,寶齡富錦        ,277000,55000,222000,0,0,0,0,0,0,-7000,0,0,0,0,7000,-7000,215000
058207,南茂凱基99購01  ,0,0,0,0,0,0,0,0,0,215000,0,0,0,245000,30000,215000,215000
3712,永崴投控        ,293000,86000,207000,0,0,0,0,0,0,8000,9000,1000,8000,0,0,0,215000
08570P,台灣50凱基96售03,0,20000,-20000,0,0,0,0,0,0,234000,0,0,0,244000,10000,234000,214000
00693U,街口S&P黃豆     ,0,175000,-175000,0,0,0,0,0,0,389000,0,0,0,481000,92000,389000,214000
055363,緯穎凱基98購03  ,0,0,0,0,0,0,0,0,0,214000,0,0,0,434000,220000,214000,214000
051855,道瓊反凱基97購01,0,0,0,0,0,0,0,0,0,212000,0,0,0,212000,0,212000,212000
04929P,同欣電凱基95售01,0,0,0,0,0,0,0,0,0,212000,0,0,0,240000,28000,212000,212000
05142P,華新科台新95售01,0,0,0,0,0,0,0,0,0,212000,0,0,0,254000,42000,212000,212000
2615,萬海            ,799756,569000,230756,0,0,0,21000,0,21000,-40000,0,40000,-40000,0,0,0,211756
05263P,台積電元大96售09,0,0,0,0,0,0,0,0,0,211000,0,0,0,231000,20000,211000,211000
04885P,大立光凱基94售19,0,0,0,0,0,0,0,0,0,210000,0,0,0,210000,0,210000,210000
050521,聯發科元大94購15,0,0,0,0,0,0,0,0,0,210000,0,0,0,210000,0,210000,210000
006206,元大上證50      ,11000,5000,6000,0,0,0,0,0,0,204000,0,0,0,208000,4000,204000,210000
04235P,鴻海群益93售08  ,0,0,0,0,0,0,0,0,0,210000,0,0,0,210000,0,210000,210000
048562,宏達電元大95購01,0,0,0,0,0,0,0,0,0,210000,0,0,0,210000,0,210000,210000
055385,昇陽半元大98購01,0,0,0,0,0,0,0,0,0,210000,0,0,0,220000,10000,210000,210000
056529,中環凱基98購01  ,0,0,0,0,0,0,0,0,0,210000,0,0,0,210000,0,210000,210000
058689,元油2X國票99購03,0,0,0,0,0,0,0,0,0,209000,0,0,0,209000,0,209000,209000
03033P,微星國票03售01  ,0,0,0,0,0,0,0,0,0,209000,0,0,0,710000,501000,209000,209000
04908P,南電國票95售03  ,0,0,0,0,0,0,0,0,0,208000,0,0,0,208000,0,208000,208000
055637,亞德客元富97購01,0,0,0,0,0,0,0,0,0,207000,0,0,0,207000,0,207000,207000
048628,T50反1元大96購03,0,0,0,0,0,0,0,0,0,207000,0,0,0,347000,140000,207000,207000
057265,聯詠兆豐98購01  ,0,0,0,0,0,0,0,0,0,207000,0,0,0,258000,51000,207000,207000
07092P,上銀凱基99售03  ,0,0,0,0,0,0,0,0,0,206000,0,0,0,277000,71000,206000,206000
04730P,臺股指中信96售02,0,0,0,0,0,0,0,0,0,206000,0,0,0,206000,0,206000,206000
058326,祥碩台新99購01  ,0,0,0,0,0,0,0,0,0,205000,0,0,0,205000,0,205000,205000
058768,南港兆豐99購01  ,0,0,0,0,0,0,0,0,0,205000,0,0,0,273000,68000,205000,205000
046218,T50反1元大93購02,0,0,0,0,0,0,0,0,0,205000,0,0,0,205000,0,205000,205000
051970,元黃金凱基98購01,0,0,0,0,0,0,0,0,0,205000,0,0,0,215000,10000,205000,205000
053083,中環元大99購01  ,0,0,0,0,0,0,0,0,0,204000,0,0,0,307000,103000,204000,204000
055701,亞德客富邦99購01,0,0,0,0,0,0,0,0,0,203000,0,0,0,219000,16000,203000,203000
6669,緯穎            ,935000,810322,124678,0,0,0,120000,51000,69000,9000,7000,5000,2000,43000,36000,7000,202678
058188,華擎永豐99購01  ,0,0,0,0,0,0,0,0,0,200000,0,0,0,200000,0,200000,200000
055944,日月光麥證97購01,0,0,0,200000,0,200000,0,0,0,200000,0,0,0,200000,0,200000,200000
048177,臺指反富邦99購01,0,0,0,0,0,0,0,0,0,200000,0,0,0,200000,0,200000,200000
04705P,臺股指統一95售02,0,0,0,0,0,0,0,0,0,200000,0,0,0,200000,0,200000,200000
050552,禾伸堂凱基94購05,0,0,0,0,0,0,0,0,0,200000,0,0,0,200000,0,200000,200000
050423,鴻海凱基96購02  ,0,0,0,0,0,0,0,0,0,200000,0,0,0,200000,0,200000,200000
056549,嘉聯益凱基98購04,0,0,0,0,0,0,0,0,0,200000,0,0,0,200000,0,200000,200000
05710P,禾伸堂國票97售02,0,0,0,0,0,0,0,0,0,200000,0,0,0,200000,0,200000,200000
057228,友達凱基9B購01  ,0,0,0,0,0,0,0,0,0,200000,0,0,0,200000,0,200000,200000
053805,奇鋐凱基98購02  ,0,0,0,0,0,0,0,0,0,200000,0,0,0,200000,0,200000,200000
6177,達麗            ,312000,112000,200000,0,0,0,0,0,0,0,0,0,0,0,0,0,200000
057455,景碩國泰99購01  ,0,0,0,0,0,0,0,0,0,199000,0,0,0,299000,100000,199000,199000
051795,T50反1台新05購02,0,0,0,0,0,0,0,0,0,199000,0,0,0,199000,0,199000,199000
03763P,聯發科元富96售01,0,0,0,0,0,0,0,0,0,199000,0,0,0,220000,21000,199000,199000
056219,T50反1日盛02購01,0,0,0,0,0,0,0,0,0,199000,0,0,0,199000,0,199000,199000
03647P,京元電元富95售02,0,0,0,0,0,0,0,0,0,198000,0,0,0,243000,45000,198000,198000
043656,上証反元大94購01,0,0,0,0,0,0,0,0,0,198000,0,0,0,198000,0,198000,198000
05745P,富邦金兆豐96售02,0,0,0,0,0,0,0,0,0,197000,0,0,0,201000,4000,197000,197000
1444,力麗            ,460000,254000,206000,0,0,0,0,0,0,-9000,5000,14000,-9000,0,0,0,197000
06982P,義隆凱基99售02  ,0,0,0,0,0,0,0,0,0,196000,0,0,0,208000,12000,196000,196000
05206P,南茂元大95售01  ,0,0,0,0,0,0,0,0,0,196000,0,0,0,196000,0,196000,196000
3049,和鑫            ,3399000,3234000,165000,0,0,0,0,0,0,31000,33000,0,33000,0,2000,-2000,196000
054340,大成鋼元富96購01,0,0,0,0,0,0,0,0,0,195000,0,0,0,195000,0,195000,195000
2511,太子            ,616382,434000,182382,0,0,0,0,0,0,12000,12000,0,12000,0,0,0,194382
05942P,奇力新凱基96售04,0,0,0,0,0,0,0,0,0,194000,0,0,0,210000,16000,194000,194000
06557P,台積電兆豐98售02,0,0,0,0,0,0,0,0,0,194000,0,0,0,224000,30000,194000,194000
053205,台光電麥證96購01,0,0,0,194000,0,194000,0,0,0,194000,0,0,0,194000,0,194000,194000
055289,泰碩元大98購01  ,0,0,0,0,0,0,0,0,0,194000,0,0,0,197000,3000,194000,194000
05411P,台積電國票96售08,0,0,0,0,0,0,0,0,0,194000,0,0,0,229000,35000,194000,194000
055012,茂林元富97購01  ,0,0,0,0,0,0,0,0,0,194000,0,0,0,194000,0,194000,194000
08625P,台灣50凱基96售05,0,0,0,0,0,0,0,0,0,193000,0,0,0,485000,292000,193000,193000
03425B,臺股指元大9A熊01,0,0,0,0,0,0,0,0,0,193000,0,0,0,194000,1000,193000,193000
2329,華泰            ,1298000,1107000,191000,0,0,0,0,0,0,2000,9000,0,9000,1000,8000,-7000,193000
6533,晶心科          ,398000,206000,192000,0,0,0,0,0,0,1000,1000,0,1000,0,0,0,193000
06772P,國巨中信99售01  ,0,0,0,0,0,0,0,0,0,192000,0,0,0,192000,0,192000,192000
05912P,和大元大96售01  ,0,0,0,0,0,0,0,0,0,192000,0,0,0,195000,3000,192000,192000
08218P,滬深2X凱基96售01,0,0,0,0,0,0,0,0,0,191000,0,0,0,213000,22000,191000,191000
04794P,友達元大96售03  ,0,0,0,0,0,0,0,0,0,191000,0,0,0,211000,20000,191000,191000
4190,佐登-KY         ,280000,89000,191000,0,0,0,0,0,0,0,0,0,0,0,0,0,191000
057710,金融類群益98購01,0,0,0,0,0,0,0,0,0,190000,0,0,0,190000,0,190000,190000
051755,台積電元大96購08,0,0,0,0,0,0,0,0,0,190000,0,0,0,190000,0,190000,190000
053630,奇鋐兆豐97購01  ,0,0,0,0,0,0,0,0,0,189000,0,0,0,204000,15000,189000,189000
056676,國產元富98購01  ,0,0,0,0,0,0,0,0,0,188000,0,0,0,188000,0,188000,188000
1722,台肥            ,1266000,1084000,182000,0,0,0,4000,0,4000,1000,1000,0,1000,0,0,0,187000
1439,中和            ,257000,72000,185000,0,0,0,0,0,0,0,0,0,0,0,0,0,185000
07067P,旺宏台新99售02  ,0,0,0,0,0,0,0,0,0,185000,0,0,0,185000,0,185000,185000
06159P,牧德元富97售02  ,0,0,0,0,0,0,0,0,0,185000,0,0,0,185000,0,185000,185000
05766P,A50正2凱基99售01,0,0,0,0,0,0,0,0,0,185000,0,0,0,185000,0,185000,185000
056147,鴻海日盛97購05  ,0,0,0,0,0,0,0,0,0,185000,0,0,0,185000,0,185000,185000
056501,貿聯富邦99購01  ,0,0,0,0,0,0,0,0,0,185000,0,0,0,200000,15000,185000,185000
8081,致新            ,566000,387000,179000,0,0,0,0,0,0,6000,2000,0,2000,6000,2000,4000,185000
06924P,台積電群益98售07,0,0,0,0,0,0,0,0,0,184000,0,0,0,184000,0,184000,184000
056580,泰鼎元大9A購01  ,0,0,0,0,0,0,0,0,0,184000,0,0,0,216000,32000,184000,184000
047623,世紀鋼凱基94購02,0,0,0,0,0,0,0,0,0,183000,0,0,0,183000,0,183000,183000
05509P,智邦元富96售02  ,0,0,0,0,0,0,0,0,0,183000,0,0,0,183000,0,183000,183000
05715P,創意元富96售05  ,0,0,0,0,0,0,0,0,0,183000,0,0,0,183000,0,183000,183000
06118P,上証2X凱基98售03,0,0,0,0,0,0,0,0,0,182000,0,0,0,182000,0,182000,182000
058472,亞德客凱基9A購01,0,0,0,0,0,0,0,0,0,180000,0,0,0,281000,101000,180000,180000
047263,揚明光國票94購01,0,0,0,0,0,0,0,0,0,180000,0,0,0,180000,0,180000,180000
047436,台積電元大94購02,0,0,0,0,0,0,0,0,0,180000,0,0,0,180000,0,180000,180000
00639,富邦深100       ,21000,108000,-87000,0,0,0,0,0,0,267000,230000,230000,0,1658000,1391000,267000,180000
2455,全新            ,1065000,742615,322385,0,0,0,3000,120000,-117000,-26000,122000,124000,-2000,9000,33000,-24000,179385
2401,凌陽            ,648000,457000,191000,0,0,0,0,0,0,-12000,140000,152000,-12000,0,0,0,179000
8261,富鼎            ,302000,126000,176000,0,0,0,0,0,0,2000,2000,0,2000,0,0,0,178000
058896,中環元大99購03  ,0,0,0,0,0,0,0,0,0,177000,0,0,0,302000,125000,177000,177000
040760,T50反1凱基95購01,0,0,0,0,0,0,0,0,0,176000,0,0,0,176000,0,176000,176000
05577P,上銀凱基96售02  ,0,0,0,0,0,0,0,0,0,176000,0,0,0,200000,24000,176000,176000
2534,宏盛            ,488130,314000,174130,0,0,0,0,0,0,1000,1000,0,1000,0,0,0,175130
058961,台灣50兆豐9C購01,0,0,0,0,0,0,0,0,0,175000,0,0,0,185000,10000,175000,175000
06414P,矽力凱基97售03  ,0,0,0,0,0,0,0,0,0,175000,0,0,0,331000,156000,175000,175000
059053,鴻海凱基99購07  ,0,0,0,0,0,0,0,0,0,174000,0,0,0,350000,176000,174000,174000
058186,聯發科永豐99購01,0,0,0,0,0,0,0,0,0,174000,0,0,0,785000,611000,174000,174000
044694,道瓊反元大94購02,0,0,0,0,0,0,0,0,0,173000,0,0,0,196000,23000,173000,173000
04833P,鴻海元大94售16  ,0,0,0,0,0,0,0,0,0,173000,0,0,0,173000,0,173000,173000
0061,元大寶滬深      ,2000,1000,1000,0,0,0,0,0,0,171000,540000,530000,10000,270000,109000,161000,172000
055489,瑞昱元大97購02  ,0,0,0,0,0,0,0,0,0,172000,0,0,0,182000,10000,172000,172000
054979,南港元富97購01  ,0,0,0,0,0,0,0,0,0,172000,0,0,0,172000,0,172000,172000
2457,飛宏            ,282000,118000,164000,0,0,0,0,0,0,8000,8000,0,8000,0,0,0,172000
8163,達方            ,1477000,1351000,126000,0,0,0,2000,0,2000,44000,81000,24000,57000,0,13000,-13000,172000
05133P,臺股指日盛95售01,0,0,0,0,0,0,0,0,0,171000,0,0,0,171000,0,171000,171000
056526,力山凱基98購01  ,0,0,0,0,0,0,0,0,0,171000,0,0,0,192000,21000,171000,171000
6283,淳安            ,341000,173000,168000,0,0,0,0,0,0,3000,3000,0,3000,0,0,0,171000
2536,宏普            ,296932,129000,167932,0,0,0,0,0,0,3000,3000,0,3000,0,0,0,170932
052336,矽力日盛95購01  ,0,0,0,0,0,0,0,0,0,170000,0,0,0,170000,0,170000,170000
03632C,臺股指元大95牛03,0,0,0,0,0,0,0,0,0,170000,0,0,0,171000,1000,170000,170000
050477,矽力永豐94購01  ,0,0,0,0,0,0,0,0,0,170000,0,0,0,170000,0,170000,170000
056533,友達凱基9A購02  ,0,0,0,0,0,0,0,0,0,170000,0,0,0,200000,30000,170000,170000
05434P,世紀鋼元富95售02,0,0,0,0,0,0,0,0,0,170000,0,0,0,859000,689000,170000,170000
07001P,國巨元大99售12  ,0,0,0,0,0,0,0,0,0,169000,0,0,0,741000,572000,169000,169000
04932P,香港2X中信96售01,0,0,0,0,0,0,0,0,0,169000,0,0,0,170000,1000,169000,169000
05261P,鴻海元大95售20  ,0,0,0,0,0,0,0,0,0,169000,0,0,0,530000,361000,169000,169000
058602,台積電元大99購11,0,0,0,0,0,0,0,0,0,168000,0,0,0,190000,22000,168000,168000
054841,亞德客兆豐97購01,40000,0,40000,0,0,0,0,0,0,128000,0,0,0,447000,319000,128000,168000
05136P,台積電凱基95售08,0,0,0,0,0,0,0,0,0,167000,0,0,0,167000,0,167000,167000
050320,台表科國票94購01,0,0,0,0,0,0,0,0,0,167000,0,0,0,167000,0,167000,167000
5243,乙盛-KY         ,299000,135000,164000,0,0,0,0,0,0,3000,3000,0,3000,0,0,0,167000
3018,同開            ,268000,102000,166000,0,0,0,0,0,0,0,0,0,0,0,0,0,166000
6452,康友-KY         ,536000,342000,194000,0,0,0,0,0,0,-28538,0,6000,-6000,15000,37538,-22538,165462
058073,大立光凱基99購04,0,0,0,0,0,0,0,0,0,165000,0,0,0,330000,165000,165000,165000
057842,緯穎富邦99購02  ,0,0,0,0,0,0,0,0,0,165000,0,0,0,171000,6000,165000,165000
05214P,台積電國票97售02,0,0,0,0,0,0,0,0,0,165000,0,0,0,165000,0,165000,165000
052606,聯發科元大97購04,0,0,0,0,0,0,0,0,0,165000,0,0,0,165000,0,165000,165000
051222,世紀鋼元富95購01,0,0,0,0,0,0,0,0,0,163000,0,0,0,168000,5000,163000,163000
05536P,奇力新元大96售03,0,0,0,0,0,0,0,0,0,163000,0,0,0,247000,84000,163000,163000
05196P,台積電永豐95售03,0,0,0,0,0,0,0,0,0,162000,0,0,0,192000,30000,162000,162000
03253P,台灣50國泰03售02,0,0,0,0,0,0,0,0,0,162000,0,0,0,547000,385000,162000,162000
03388P,元油2X元富98售02,0,0,0,0,0,0,0,0,0,162000,0,0,0,162000,0,162000,162000
05255P,義隆凱基95售01  ,0,0,0,0,0,0,0,0,0,161000,0,0,0,211000,50000,161000,161000
052821,晶技永豐96購01  ,0,0,0,0,0,0,0,0,0,161000,0,0,0,171000,10000,161000,161000
058407,滬深2X兆豐9A購01,0,0,0,0,0,0,0,0,0,160000,0,0,0,170000,10000,160000,160000
05895P,奇力新群益96售03,0,0,0,0,0,0,0,0,0,160000,0,0,0,160000,0,160000,160000
05600P,玉晶光台新96售04,0,0,0,0,0,0,0,0,0,160000,0,0,0,940000,780000,160000,160000
056538,國泰金凱基98購01,0,0,0,0,0,0,0,0,0,160000,0,0,0,195000,35000,160000,160000
05474P,智邦亞東95售01  ,0,0,0,0,0,0,0,0,0,160000,0,0,0,160000,0,160000,160000
2467,志聖            ,431000,274000,157000,0,0,0,0,0,0,3000,3000,0,3000,0,0,0,160000
057806,國巨元大98購20  ,0,0,0,0,0,0,0,0,0,159000,0,0,0,173000,14000,159000,159000
03662C,FBVIX凱基03牛01 ,0,0,0,0,0,0,0,0,0,159000,0,0,0,159000,0,159000,159000
053887,聯茂兆豐97購02  ,0,0,0,0,0,0,0,0,0,159000,0,0,0,159000,0,159000,159000
058990,GIS凱基99購02   ,0,0,0,0,0,0,0,0,0,158000,0,0,0,273000,115000,158000,158000
07009P,臺股指中信9B售01,0,0,0,0,0,0,0,0,0,158000,0,0,0,158000,0,158000,158000
048021,滬深反凱基93購02,0,0,0,0,0,0,0,0,0,158000,0,0,0,158000,0,158000,158000
056229,可成凱基97購04  ,0,0,0,0,0,0,0,0,0,158000,0,0,0,183000,25000,158000,158000
2441,超豐            ,511000,368000,143000,0,0,0,5000,0,5000,10000,12000,2000,10000,0,0,0,158000
6271,同欣電          ,1323000,1286000,37000,0,0,0,202000,125000,77000,44000,85000,74000,11000,49000,16000,33000,158000
06800P,台灣50群益9A售02,0,0,0,0,0,0,0,0,0,157000,0,0,0,157000,0,157000,157000
05693P,滬深2X凱基98售02,0,0,0,0,0,0,0,0,0,157000,0,0,0,159000,2000,157000,157000
058163,道瓊反凱基9B購01,0,0,0,0,0,0,0,0,0,156000,0,0,0,156000,0,156000,156000
01003T,兆豐新光R1      ,161490,6000,155490,0,0,0,0,0,0,0,0,0,0,0,0,0,155490
07121P,華新科凱基99售03,0,0,0,0,0,0,0,0,0,155000,0,0,0,384000,229000,155000,155000
1215,卜蜂            ,360000,203000,157000,0,0,0,0,0,0,-2000,0,0,0,0,2000,-2000,155000
055498,大立光元大97購07,0,0,0,0,0,0,0,0,0,155000,0,0,0,160000,5000,155000,155000
057258,中環兆豐98購01  ,0,0,0,0,0,0,0,0,0,155000,0,0,0,155000,0,155000,155000
055164,矽創元大98購01  ,0,0,0,0,0,0,0,0,0,155000,0,0,0,155000,0,155000,155000
052684,旺宏元大98購01  ,0,0,0,0,0,0,0,0,0,155000,0,0,0,155000,0,155000,155000
06016P,京元電凱基96售03,0,0,0,0,0,0,0,0,0,153000,0,0,0,205000,52000,153000,153000
053545,上銀凱基96購03  ,0,0,0,0,0,0,0,0,0,153000,0,0,0,153000,0,153000,153000
1303,南亞            ,11088000,11127550,-39550,0,0,0,170000,0,170000,21000,21000,0,21000,0,0,0,151450
051957,旺宏台新95購02  ,0,0,0,0,0,0,0,0,0,151000,0,0,0,151000,0,151000,151000
03183P,鴻海元大01售28  ,0,0,0,0,0,0,0,0,0,151000,0,0,0,201000,50000,151000,151000
051845,世紀鋼富邦96購01,0,0,0,0,0,0,0,0,0,151000,0,0,0,391000,240000,151000,151000
07146P,瑞昱元大99售02  ,0,0,0,0,0,0,0,0,0,150000,0,0,0,170000,20000,150000,150000
07075P,FBVIX凱基9C售04 ,0,0,0,0,0,0,0,0,0,150000,0,0,0,160000,10000,150000,150000
06063P,玉晶光元富97售01,0,0,0,0,0,0,0,0,0,150000,0,0,0,150000,0,150000,150000
050543,聯發科凱基95購01,0,0,0,0,0,0,0,0,0,150000,0,0,0,150000,0,150000,150000
042719,臺指反群益93購01,0,0,0,0,0,0,0,0,0,150000,0,0,0,152000,2000,150000,150000
049486,旺宏元大94購08  ,0,0,0,0,0,0,0,0,0,150000,0,0,0,150000,0,150000,150000
057381,微星國泰9A購01  ,0,0,0,0,0,0,0,0,0,150000,0,0,0,200000,50000,150000,150000
056657,華邦電元大99購01,0,0,0,0,0,0,0,0,0,150000,0,0,0,230000,80000,150000,150000
1435,中福            ,186000,37000,149000,0,0,0,0,0,0,0,0,0,0,0,0,0,149000
058235,大立光元大99購08,0,0,0,0,0,0,0,0,0,149000,0,0,0,172000,23000,149000,149000
04902P,國巨台新94售04  ,0,0,0,0,0,0,0,0,0,149000,0,0,0,149000,0,149000,149000
00678,群益NBI生技     ,323000,32000,291000,0,0,0,0,0,0,-142000,0,0,0,49000,191000,-142000,149000
3031,佰鴻            ,189000,46000,143000,0,0,0,0,0,0,6000,6000,0,6000,0,0,0,149000
06228P,亞德客凱基97售04,0,0,0,0,0,0,0,0,0,148000,0,0,0,194000,46000,148000,148000
04222P,台積電統一93售08,0,0,0,0,0,0,0,0,0,148000,0,0,0,148000,0,148000,148000
03267P,台灣50元大02售06,0,0,0,0,0,0,0,0,0,148000,0,0,0,148000,0,148000,148000
053114,聯茂兆豐97購01  ,0,0,0,0,0,0,0,0,0,148000,0,0,0,158000,10000,148000,148000
055193,世芯元富97購02  ,0,0,0,0,0,0,0,0,0,148000,0,0,0,148000,0,148000,148000
058658,瑞儀中信99購01  ,0,0,0,0,0,0,0,0,0,147000,0,0,0,355000,208000,147000,147000
6196,帆宣            ,687000,535000,152000,0,0,0,0,0,0,-5000,0,0,0,5000,10000,-5000,147000
06964P,臺股指凱基9B售01,0,0,0,0,0,0,0,0,0,146000,0,0,0,146000,0,146000,146000
06894P,鈺齊元富98售03  ,0,0,0,0,0,0,0,0,0,146000,0,0,0,146000,0,146000,146000
03557P,欣興元大02售17  ,0,0,0,0,0,0,0,0,0,146000,0,0,0,146000,0,146000,146000
6141,柏承            ,401000,258000,143000,0,0,0,0,0,0,3000,3000,0,3000,0,0,0,146000
057518,世紀鋼元富98購01,0,0,0,0,0,0,0,0,0,145000,0,0,0,202000,57000,145000,145000
055966,茂林元大99購01  ,0,0,0,0,0,0,0,0,0,145000,0,0,0,180000,35000,145000,145000
048945,訊連永豐94購01  ,0,0,0,0,0,0,0,0,0,145000,0,0,0,150000,5000,145000,145000
053483,嘉澤第一96購01  ,0,0,0,0,0,0,0,0,0,145000,0,0,0,155000,10000,145000,145000
4994,傳奇            ,239000,96000,143000,0,0,0,0,0,0,2000,2000,0,2000,0,0,0,145000
4306,炎洲            ,228000,83000,145000,0,0,0,0,0,0,0,33000,33000,0,0,0,0,145000
4956,光鋐            ,215000,72000,143000,0,0,0,0,0,0,2000,2000,0,2000,0,0,0,145000
058468,聯茂中信99購02  ,0,0,0,0,0,0,0,0,0,144000,0,0,0,144000,0,144000,144000
06569P,可成永豐98售01  ,0,0,0,0,0,0,0,0,0,144000,0,0,0,231000,87000,144000,144000
06674P,祥碩群益98售02  ,0,0,0,0,0,0,0,0,0,144000,0,0,0,154000,10000,144000,144000
04953P,台積電群益94售13,0,0,0,0,0,0,0,0,0,144000,0,0,0,151000,7000,144000,144000
050797,聯發科中信99購01,0,0,0,0,0,0,0,0,0,144000,0,0,0,320000,176000,144000,144000
056608,力山永豐98購01  ,0,0,0,0,0,0,0,0,0,144000,0,0,0,144000,0,144000,144000
3665,貿聯-KY         ,968000,619453,348547,0,0,0,32000,245000,-213000,8000,3000,0,3000,15000,10000,5000,143547
06595P,祥碩元大98售03  ,0,0,0,0,0,0,0,0,0,143000,0,0,0,329000,186000,143000,143000
3653,健策            ,902000,816000,86000,0,0,0,261000,290000,-29000,86000,71000,17000,54000,118000,86000,32000,143000
05909P,康友元富96售02  ,0,0,0,0,0,0,0,0,0,142000,0,0,0,142000,0,142000,142000
03765P,大立光元富96售01,0,0,0,0,0,0,0,0,0,142000,0,0,0,152000,10000,142000,142000
046630,京元電元富95購03,0,0,0,0,0,0,0,0,0,142000,0,0,0,142000,0,142000,142000
052674,智邦國泰98購01  ,0,0,0,0,0,0,0,0,0,142000,0,0,0,295000,153000,142000,142000
05512P,華新科台新97售01,0,0,0,0,0,0,0,0,0,142000,0,0,0,263000,121000,142000,142000
058341,T50反1群益99購01,0,0,0,0,0,0,0,0,0,141000,0,0,0,181000,40000,141000,141000
2338,光罩            ,1346000,1187000,159000,0,0,0,0,0,0,-18000,7000,108000,-101000,106000,23000,83000,141000
051536,玉晶光國票97購01,0,0,0,0,0,0,0,0,0,140000,0,0,0,425000,285000,140000,140000
056155,嘉晶凱基97購01  ,0,0,0,0,0,0,0,0,0,139000,0,0,0,139000,0,139000,139000
6142,友勁            ,2000,8000,-6000,0,0,0,0,0,0,145000,145000,0,145000,0,0,0,139000
05925P,晶技永豐96售03  ,0,0,0,0,0,0,0,0,0,138000,0,0,0,138000,0,138000,138000
1457,宜進            ,216000,78000,138000,0,0,0,0,0,0,0,0,0,0,0,0,0,138000
00643,群益深証中小    ,63000,119000,-56000,0,0,0,0,0,0,194000,390000,390000,0,703000,509000,194000,138000
054743,聯鈞凱基99購01  ,0,0,0,0,0,0,0,0,0,138000,0,0,0,138000,0,138000,138000
06669P,緯穎凱基98售05  ,0,0,0,0,0,0,0,0,0,137000,0,0,0,383000,246000,137000,137000
03648C,T50反1元大96牛07,0,0,0,0,0,0,0,0,0,137000,0,0,0,190000,53000,137000,137000
03960P,新日興元富96售02,0,0,0,0,0,0,0,0,0,137000,0,0,0,137000,0,137000,137000
03498P,矽創凱基02售02  ,0,0,0,0,0,0,0,0,0,137000,0,0,0,137000,0,137000,137000
055477,同欣電凱基98購01,0,0,0,0,0,0,0,0,0,137000,0,0,0,137000,0,137000,137000
054295,世芯元大96購03  ,0,0,0,0,0,0,0,0,0,137000,0,0,0,138000,1000,137000,137000
06125P,楠梓電元富99售01,0,10000,-10000,0,0,0,0,0,0,146000,0,0,0,151000,5000,146000,136000
05900P,臺股指凱基99售05,0,0,0,0,0,0,0,0,0,136000,0,0,0,136000,0,136000,136000
05294P,亞光凱基95售02  ,0,0,0,0,0,0,0,0,0,136000,0,0,0,141000,5000,136000,136000
05891P,聯發科中信98售03,0,0,0,0,0,0,0,0,0,135000,0,0,0,155000,20000,135000,135000
057635,中鋼元大98購01  ,0,0,0,0,0,0,0,0,0,135000,0,0,0,270000,135000,135000,135000
06555P,臺股指元大99售07,0,0,0,0,0,0,0,0,0,134000,0,0,0,134000,0,134000,134000
049871,T50反1台新9A購02,0,0,0,0,0,0,0,0,0,134000,0,0,0,134000,0,134000,134000
04771P,友達元大96售02  ,0,0,0,0,0,0,0,0,0,134000,0,0,0,407000,273000,134000,134000
057018,亞德客凱基98購01,0,0,0,0,0,0,0,0,0,134000,0,0,0,134000,0,134000,134000
3419,譁裕            ,231000,99000,132000,0,0,0,0,0,0,2000,2000,0,2000,0,0,0,134000
07113P,台積電兆豐99售03,0,0,0,0,0,0,0,0,0,133000,0,0,0,195000,62000,133000,133000
050590,晶技永豐95購01  ,0,0,0,0,0,0,0,0,0,133000,0,0,0,136000,3000,133000,133000
055240,京元電元富97購01,0,0,0,0,0,0,0,0,0,133000,0,0,0,133000,0,133000,133000
054509,上証反元大99購01,0,0,0,0,0,0,0,0,0,133000,0,0,0,159000,26000,133000,133000
053291,旺宏中信9A購01  ,0,0,0,0,0,0,0,0,0,133000,0,0,0,133000,0,133000,133000
1808,潤隆            ,248000,116000,132000,0,0,0,0,0,0,0,0,0,0,0,0,0,132000
06514P,國巨凱基98售05  ,0,0,0,0,0,0,0,0,0,132000,0,0,0,163000,31000,132000,132000
05782P,聯詠元富96售02  ,0,0,0,0,0,0,0,0,0,132000,0,0,0,132000,0,132000,132000
04550P,超眾元大94售01  ,0,0,0,0,0,0,0,0,0,132000,0,0,0,142000,10000,132000,132000
3645,達邁            ,311000,179000,132000,0,0,0,0,0,0,0,0,0,0,0,0,0,132000
06346P,聯鈞元富97售02  ,0,0,0,0,0,0,0,0,0,131000,0,0,0,131000,0,131000,131000
03650C,T50反1元大98牛05,0,0,0,0,0,0,0,0,0,131000,0,0,0,172000,41000,131000,131000
00737,國泰AI+Robo     ,114000,152000,-38000,0,0,0,0,0,0,169000,0,0,0,239000,70000,169000,131000
057634,道瓊反元大99購01,0,0,0,0,0,0,0,0,0,130000,0,0,0,219000,89000,130000,130000
00865B,國泰US短期公債  ,0,0,0,0,0,0,0,0,0,130000,0,0,0,130000,0,130000,130000
049518,宏達電國票95購02,0,0,0,0,0,0,0,0,0,130000,0,0,0,130000,0,130000,130000
05286P,矽力統一95售02  ,0,0,0,0,0,0,0,0,0,130000,0,0,0,139000,9000,130000,130000
053460,緯穎國泰97購01  ,0,0,0,0,0,0,0,0,0,130000,0,0,0,130000,0,130000,130000
055133,致新康和97購01  ,0,0,0,0,0,0,0,0,0,130000,0,0,0,130000,0,130000,130000
055015,帆宣元富97購01  ,0,0,0,0,0,0,0,0,0,130000,0,0,0,130000,0,130000,130000
057313,聯發科麥證99購01,0,0,0,130000,0,130000,0,0,0,130000,0,0,0,130000,0,130000,130000
056527,大成鋼凱基98購03,0,0,0,0,0,0,0,0,0,129000,0,0,0,219000,90000,129000,129000
058382,S&P500中信99購01,0,0,0,0,0,0,0,0,0,128000,0,0,0,128000,0,128000,128000
056092,亞德客元富97購02,0,0,0,0,0,0,0,0,0,128000,0,0,0,130000,2000,128000,128000
052952,矽創國票97購02  ,0,0,0,0,0,0,0,0,0,128000,0,0,0,128000,0,128000,128000
8011,台通            ,156000,31000,125000,0,0,0,0,0,0,3000,6000,3000,3000,0,0,0,128000
9941,裕融            ,246000,121200,124800,0,0,0,3000,0,3000,0,0,0,0,0,0,0,127800
058982,台積電凱基99購08,0,0,0,0,0,0,0,0,0,126000,0,0,0,621000,495000,126000,126000
054669,凌華元富97購01  ,0,0,0,0,0,0,0,0,0,126000,0,0,0,126000,0,126000,126000
054070,創意國泰96購02  ,0,0,0,0,0,0,0,0,0,126000,0,0,0,241000,115000,126000,126000
2538,基泰            ,231500,106000,125500,0,0,0,0,0,0,0,0,0,0,0,0,0,125500
07087P,聯發科台新99售02,0,0,0,0,0,0,0,0,0,125000,0,0,0,125000,0,125000,125000
06393P,台積電元大97售27,0,0,0,0,0,0,0,0,0,124000,0,0,0,159000,35000,124000,124000
06496P,台灣50日盛98售01,0,0,0,0,0,0,0,0,0,124000,0,0,0,124000,0,124000,124000
05038P,牧德元大95售03  ,0,0,0,0,0,0,0,0,0,124000,0,0,0,144000,20000,124000,124000
3060,銘異            ,424000,303000,121000,0,0,0,0,0,0,3000,3000,0,3000,0,0,0,124000
1440,南紡            ,577000,462000,115000,0,0,0,0,0,0,8000,9000,1000,8000,0,0,0,123000
05504P,台積電凱基96售04,0,0,0,0,0,0,0,0,0,123000,0,0,0,123000,0,123000,123000
8404,百和興業-KY     ,236000,113000,123000,0,0,0,0,0,0,0,0,0,0,0,0,0,123000
1447,力鵬            ,206000,85000,121000,0,0,0,0,0,0,1000,1000,0,1000,0,0,0,122000
07014P,華通元大99售04  ,0,0,0,0,0,0,0,0,0,122000,0,0,0,192000,70000,122000,122000
052272,T50反1群益95購03,0,0,0,0,0,0,0,0,0,122000,0,0,0,122000,0,122000,122000
6155,鈞寶            ,223000,101000,122000,0,0,0,0,0,0,0,0,0,0,0,0,0,122000
06694P,臺股指凱基99售13,0,0,0,0,0,0,0,0,0,121000,0,0,0,121000,0,121000,121000
055652,聯詠元富01購01  ,0,0,0,0,0,0,0,0,0,121000,0,0,0,121000,0,121000,121000
047014,元油反元大99購01,0,0,0,0,0,0,0,0,0,121000,0,0,0,133000,12000,121000,121000
08070P,晶技國泰9C售02  ,0,0,0,0,0,0,0,0,0,120000,0,0,0,120000,0,120000,120000
058375,群創凱基9B購04  ,0,0,0,0,0,0,0,0,0,120000,0,0,0,150000,30000,120000,120000
058355,旺宏凱基99購04  ,0,0,0,0,0,0,0,0,0,120000,0,0,0,120000,0,120000,120000
044987,宏達電統一94購01,0,0,0,0,0,0,0,0,0,120000,0,0,0,120000,0,120000,120000
047685,嘉聯益國泰95購01,0,0,0,0,0,0,0,0,0,120000,0,0,0,120000,0,120000,120000
050180,華新科元大95購08,0,0,0,0,0,0,0,0,0,120000,0,0,0,120000,0,120000,120000
03861P,群創元富99售01  ,0,0,0,0,0,0,0,0,0,120000,0,0,0,120000,0,120000,120000
051636,嘉晶國票95購02  ,0,0,0,0,0,0,0,0,0,120000,0,0,0,123000,3000,120000,120000
050616,潤泰全元大94購01,0,0,0,0,0,0,0,0,0,120000,0,0,0,120000,0,120000,120000
049721,晶技凱基94購02  ,0,0,0,0,0,0,0,0,0,120000,0,0,0,120000,0,120000,120000
054753,復盛凱基98購01  ,0,0,0,0,0,0,0,0,0,120000,0,0,0,120000,0,120000,120000
053043,嘉晶凱基96購01  ,0,0,0,0,0,0,0,0,0,120000,0,0,0,132000,12000,120000,120000
05262P,台積電元大95售19,0,0,0,0,0,0,0,0,0,120000,0,0,0,160000,40000,120000,120000
053389,彩晶元大98購01  ,0,0,0,0,0,0,0,0,0,120000,0,0,0,120000,0,120000,120000
056348,S&P反1元大9A購01,0,0,0,0,0,0,0,0,0,120000,0,0,0,130000,10000,120000,120000
06877P,台積電兆豐98售04,0,0,0,0,0,0,0,0,0,119000,0,0,0,219000,100000,119000,119000
056230,可成凱基98購03  ,0,0,0,0,0,0,0,0,0,119000,0,0,0,119000,0,119000,119000
052948,景碩國票97購02  ,0,0,0,0,0,0,0,0,0,119000,0,0,0,119000,0,119000,119000
052434,茂林國泰97購01  ,0,0,0,0,0,0,0,0,0,119000,0,0,0,119000,0,119000,119000
4540,全球傳動        ,268000,149000,119000,0,0,0,0,0,0,0,0,0,0,0,0,0,119000
06726P,欣興元富98售04  ,0,0,0,0,0,0,0,0,0,118000,0,0,0,119000,1000,118000,118000
05460P,台郡凱基95售05  ,0,0,0,0,0,0,0,0,0,118000,0,0,0,138000,20000,118000,118000
06736P,新日興凱基98售03,0,0,0,0,0,0,0,0,0,117000,0,0,0,119000,2000,117000,117000
05855P,滬深2X中信9C售01,0,0,0,0,0,0,0,0,0,117000,0,0,0,191000,74000,117000,117000
056362,聯發科元大99購01,0,0,0,0,0,0,0,0,0,117000,0,0,0,121000,4000,117000,117000
06489P,台積電元富98售06,0,0,0,0,0,0,0,0,0,116000,0,0,0,117000,1000,116000,116000
06300P,緯穎元大97售04  ,0,0,0,0,0,0,0,0,0,116000,0,0,0,172000,56000,116000,116000
00691R,兆豐藍籌30反1   ,0,0,0,0,0,0,0,0,0,116000,0,0,0,156000,40000,116000,116000
04571P,華新科國泰95售03,0,0,0,0,0,0,0,0,0,116000,0,0,0,118000,2000,116000,116000
055213,大成鋼凱基98購01,0,0,0,0,0,0,0,0,0,116000,0,0,0,336000,220000,116000,116000
057669,嘉晶元大99購03  ,0,0,0,0,0,0,0,0,0,115000,0,0,0,214000,99000,115000,115000
04003P,麗豐凱基94售03  ,0,0,0,0,0,0,0,0,0,115000,0,0,0,115000,0,115000,115000
05443P,宏達電元大95售05,0,0,0,0,0,0,0,0,0,115000,0,0,0,127000,12000,115000,115000
056340,可成凱基98購04  ,0,0,0,0,0,0,0,0,0,115000,0,0,0,125000,10000,115000,115000
054234,可成群益96購05  ,0,0,0,0,0,0,0,0,0,115000,0,0,0,115000,0,115000,115000
06383P,聯茂元富97售01  ,0,0,0,0,0,0,0,0,0,114000,0,0,0,114000,0,114000,114000
06199P,聯發科元大97售17,0,0,0,0,0,0,0,0,0,114000,0,0,0,134000,20000,114000,114000
3321,同泰            ,119000,5000,114000,0,0,0,0,0,0,0,0,0,0,0,0,0,114000
2022,聚亨            ,180000,58000,122000,0,0,0,0,0,0,-8000,3000,11000,-8000,0,0,0,114000
8429,金麗-KY         ,203000,90000,113000,0,0,0,0,0,0,1000,1000,0,1000,0,0,0,114000
03658C,T50反1元大9A牛02,0,0,0,0,0,0,0,0,0,113000,0,0,0,145000,32000,113000,113000
00706L,元大S&P日圓正2  ,0,0,0,0,0,0,0,0,0,113000,0,0,0,113000,0,113000,113000
05696P,南亞科凱基96售01,0,0,0,0,0,0,0,0,0,113000,0,0,0,135000,22000,113000,113000
048852,旺宏群益96購02  ,0,0,0,0,0,0,0,0,0,112000,0,0,0,112000,0,112000,112000
056616,台光電永豐98購01,0,0,0,0,0,0,0,0,0,112000,0,0,0,112000,0,112000,112000
2436,偉詮電          ,586000,477000,109000,0,0,0,0,0,0,3000,3000,0,3000,0,0,0,112000
3026,禾伸堂          ,1311000,1216000,95000,0,0,0,0,0,0,17000,25000,22000,3000,46000,32000,14000,112000
06224P,可成元富97售02  ,0,0,0,0,0,0,0,0,0,111000,0,0,0,115000,4000,111000,111000
1316,上曜            ,311000,187000,124000,0,0,0,0,0,0,-13000,1000,14000,-13000,0,0,0,111000
04327P,台積電國泰95售01,0,0,0,0,0,0,0,0,0,111000,0,0,0,301000,190000,111000,111000
054152,漢唐國泰98購02  ,0,0,0,0,0,0,0,0,0,111000,0,0,0,161000,50000,111000,111000
05575P,玉晶光元富96售01,0,0,0,0,0,0,0,0,0,111000,0,0,0,112000,1000,111000,111000
06862P,大立光凱基98售16,0,0,0,0,0,0,0,0,0,110000,0,0,0,130000,20000,110000,110000
057561,大立光兆豐98購02,0,0,0,0,0,0,0,0,0,110000,0,0,0,110000,0,110000,110000
047058,聯茂國票94購01  ,0,0,0,0,0,0,0,0,0,110000,0,0,0,110000,0,110000,110000
047886,京元電富邦95購01,0,0,0,0,0,0,0,0,0,110000,0,0,0,160000,50000,110000,110000
050370,台積電元大94購24,0,0,0,0,0,0,0,0,0,110000,0,0,0,140000,30000,110000,110000
049670,鈺齊國泰96購01  ,0,0,0,0,0,0,0,0,0,110000,0,0,0,110000,0,110000,110000
053279,景碩元大97購01  ,0,0,0,0,0,0,0,0,0,110000,0,0,0,120000,10000,110000,110000
053363,旺宏國泰98購02  ,0,0,0,0,0,0,0,0,0,110000,0,0,0,110000,0,110000,110000
05695P,台積電凱基96售10,0,0,0,0,0,0,0,0,0,110000,0,0,0,111000,1000,110000,110000
053875,GIS元大97購01   ,0,0,0,0,0,0,0,0,0,110000,0,0,0,150000,40000,110000,110000
054667,神基元富97購01  ,0,0,0,0,0,0,0,0,0,110000,0,0,0,110000,0,110000,110000
054640,健策中信9B購01  ,0,0,0,0,0,0,0,0,0,110000,0,0,0,200000,90000,110000,110000
8101,華冠            ,172000,62000,110000,0,0,0,0,0,0,0,0,0,0,0,0,0,110000
058506,台積電元大99購09,0,0,0,0,0,0,0,0,0,109000,0,0,0,150000,41000,109000,109000
06461P,玉晶光國泰9A售01,0,0,0,0,0,0,0,0,0,109000,0,0,0,109000,0,109000,109000
051107,鴻海統一95購05  ,0,0,0,0,0,0,0,0,0,109000,0,0,0,109000,0,109000,109000
03857P,聯發科元富99售02,0,0,0,0,0,0,0,0,0,109000,0,0,0,119000,10000,109000,109000
03399P,欣興中信02售03  ,0,0,0,0,0,0,0,0,0,109000,0,0,0,109000,0,109000,109000
05479P,華新科台新96售01,0,0,0,0,0,0,0,0,0,109000,0,0,0,992000,883000,109000,109000
6591,動力-KY         ,217000,110000,107000,0,0,0,0,0,0,2000,2000,0,2000,0,0,0,109000
056193,聯發科富邦99購08,0,0,0,0,0,0,0,0,0,108000,0,0,0,784000,676000,108000,108000
05275P,國巨凱基95售05  ,0,0,0,0,0,0,0,0,0,108000,0,0,0,113000,5000,108000,108000
056059,美律元大98購02  ,0,0,0,0,0,0,0,0,0,108000,0,0,0,178000,70000,108000,108000
2405,浩鑫            ,444000,336000,108000,0,0,0,0,0,0,0,0,0,0,0,0,0,108000
05946P,和碩中信96售01  ,0,0,0,0,0,0,0,0,0,107000,0,0,0,107000,0,107000,107000
05638P,國巨統一96售04  ,0,0,0,0,0,0,0,0,0,107000,0,0,0,107000,0,107000,107000
2376,技嘉            ,1408000,2225000,-817000,0,0,0,0,137000,-137000,1061000,141000,214000,-73000,1163000,29000,1134000,107000
2030,彰源            ,169000,62000,107000,0,0,0,0,0,0,0,0,0,0,0,0,0,107000
06538P,國巨凱基98售11  ,0,0,0,0,0,0,0,0,0,106000,0,0,0,141000,35000,106000,106000
058354,台積電凱基9A購06,0,0,0,0,0,0,0,0,0,106000,0,0,0,137000,31000,106000,106000
058646,聯茂富邦9A購01  ,0,0,0,0,0,0,0,0,0,106000,0,0,0,207000,101000,106000,106000
050122,臺指反凱基96購01,0,0,0,0,0,0,0,0,0,106000,0,0,0,106000,0,106000,106000
2355,敬鵬            ,763000,669000,94000,0,0,0,0,0,0,12000,17000,4000,13000,0,1000,-1000,106000
057556,智易凱基99購01  ,0,0,0,0,0,0,0,0,0,105000,0,0,0,105000,0,105000,105000
05759P,智邦永豐96售02  ,0,0,0,0,0,0,0,0,0,105000,0,0,0,210000,105000,105000,105000
057787,TPK國票99購01   ,0,0,0,0,0,0,0,0,0,105000,0,0,0,105000,0,105000,105000
06246P,茂林元富97售03  ,0,0,0,0,0,0,0,0,0,105000,0,0,0,127000,22000,105000,105000
06307P,聚陽元富97售02  ,0,0,0,0,0,0,0,0,0,105000,0,0,0,105000,0,105000,105000
06766P,玉晶光元大99售10,0,0,0,0,0,0,0,0,0,105000,0,0,0,143000,38000,105000,105000
050927,聯詠凱基95購01  ,0,0,0,0,0,0,0,0,0,105000,0,0,0,105000,0,105000,105000
00710B,FH彭博高收益債  ,0,0,0,0,0,0,0,0,0,105000,0,0,0,205000,100000,105000,105000
048793,超眾元大95購02  ,0,0,0,0,0,0,0,0,0,105000,0,0,0,105000,0,105000,105000
2014,中鴻            ,1915000,1810000,105000,0,0,0,0,0,0,0,0,0,0,0,0,0,105000
06750P,聯發科元富02售03,0,0,0,0,0,0,0,0,0,104000,0,0,0,104000,0,104000,104000
04919P,聯詠凱基94售05  ,0,0,0,0,0,0,0,0,0,104000,0,0,0,111000,7000,104000,104000
052957,T50反1凱基99購01,0,0,0,0,0,0,0,0,0,104000,0,0,0,104000,0,104000,104000
06482P,台積電凱基98售13,0,0,0,0,0,0,0,0,0,103000,0,0,0,103000,0,103000,103000
06132P,正文元富97售01  ,0,0,0,0,0,0,0,0,0,103000,0,0,0,105000,2000,103000,103000
058450,旺宏永豐99購01  ,0,0,0,0,0,0,0,0,0,103000,0,0,0,146000,43000,103000,103000
04927P,大立光凱基95售06,0,0,0,0,0,0,0,0,0,103000,0,0,0,118000,15000,103000,103000
050030,嘉晶元大94購03  ,0,0,0,0,0,0,0,0,0,103000,0,0,0,117000,14000,103000,103000
05178P,大立光凱基96售05,0,0,0,0,0,0,0,0,0,103000,0,0,0,115000,12000,103000,103000
056451,可成凱基99購01  ,0,0,0,0,0,0,0,0,0,103000,0,0,0,103000,0,103000,103000
5258,虹堡            ,166000,65000,101000,0,0,0,0,0,0,2000,2000,0,2000,0,0,0,103000
058932,FBVIX台新99購01 ,0,0,0,0,0,0,0,0,0,102000,0,0,0,115000,13000,102000,102000
056546,致伸凱基98購01  ,0,0,0,0,0,0,0,0,0,102000,0,0,0,125000,23000,102000,102000
056701,國產國泰9A購01  ,0,0,0,0,0,0,0,0,0,102000,0,0,0,117000,15000,102000,102000
055198,奇力新第一97購01,0,0,0,0,0,0,0,0,0,102000,0,0,0,102000,0,102000,102000
05245P,台積電元大95售18,0,0,0,0,0,0,0,0,0,102000,0,0,0,637000,535000,102000,102000
2472,立隆電          ,223000,113000,110000,0,0,0,0,0,0,-8000,27000,35000,-8000,0,0,0,102000
058627,聯發科國票99購04,0,0,0,0,0,0,0,0,0,101000,0,0,0,101000,0,101000,101000
048485,泰鼎國泰94購02  ,0,0,0,0,0,0,0,0,0,101000,0,0,0,160000,59000,101000,101000
052042,台積電日盛95購02,0,0,0,0,0,0,0,0,0,101000,0,0,0,315000,214000,101000,101000
058541,T50反1富邦01購01,0,0,0,0,0,0,0,0,0,100000,0,0,0,100000,0,100000,100000
058755,SGBR2X群益99購01,0,0,0,0,0,0,0,0,0,100000,0,0,0,100000,0,100000,100000
057766,矽力凱基98購03  ,0,0,0,0,0,0,0,0,0,100000,0,0,0,100000,0,100000,100000
058296,明泰凱基99購01  ,0,0,0,0,0,0,0,0,0,100000,0,0,0,120000,20000,100000,100000
06085P,義隆台新97售01  ,0,0,0,0,0,0,0,0,0,100000,0,0,0,100000,0,100000,100000
06358P,力成中信97售02  ,0,0,0,0,0,0,0,0,0,100000,0,0,0,100000,0,100000,100000
06572P,台積電永昌99售01,0,0,0,0,0,0,0,0,0,100000,0,0,0,103000,3000,100000,100000
07036P,台灣50台新9C售01,0,0,0,0,0,0,0,0,0,100000,0,0,0,110000,10000,100000,100000
050641,上証反凱基96購01,0,0,0,0,0,0,0,0,0,100000,0,0,0,100000,0,100000,100000
051101,台表科元大96購02,0,0,0,0,0,0,0,0,0,100000,0,0,0,100000,0,100000,100000
052328,台表科中信99購01,0,0,0,0,0,0,0,0,0,100000,0,0,0,100000,0,100000,100000
052307,潤泰全國泰96購01,0,0,0,0,0,0,0,0,0,100000,0,0,0,140000,40000,100000,100000
051526,超眾凱基95購02  ,0,0,0,0,0,0,0,0,0,100000,0,0,0,100000,0,100000,100000
05156P,群創兆豐95售01  ,0,0,0,0,0,0,0,0,0,100000,0,0,0,100000,0,100000,100000
055624,聯發科富邦99購07,0,0,0,0,0,0,0,0,0,100000,0,0,0,765000,665000,100000,100000
048429,旺宏國票94購02  ,0,0,0,0,0,0,0,0,0,100000,0,0,0,100000,0,100000,100000
04431P,牧德元大94售03  ,0,0,0,0,0,0,0,0,0,100000,0,0,0,100000,0,100000,100000
042379,T50反1群益93購03,0,0,0,0,0,0,0,0,0,100000,0,0,0,130000,30000,100000,100000
04417P,光罩國泰95售02  ,0,0,0,0,0,0,0,0,0,100000,0,0,0,100000,0,100000,100000
050282,T50反1凱基97購01,0,0,0,0,0,0,0,0,0,100000,0,0,0,100000,0,100000,100000
04749P,臺股指元大94售25,0,0,0,0,0,0,0,0,0,100000,0,0,0,100000,0,100000,100000
04733P,康控兆豐95售01  ,0,0,0,0,0,0,0,0,0,100000,0,0,0,100000,0,100000,100000
04684P,欣興元大94售07  ,0,0,0,0,0,0,0,0,0,100000,0,0,0,100000,0,100000,100000
044950,玉晶光群益94購01,0,0,0,0,0,0,0,0,0,100000,0,0,0,100000,0,100000,100000
045907,鴻海中信94購02  ,0,0,0,0,0,0,0,0,0,100000,0,0,0,100000,0,100000,100000
05462P,美律亞東97售01  ,0,0,0,0,0,0,0,0,0,100000,0,0,0,100000,0,100000,100000
05396P,台郡元大95售05  ,0,0,0,0,0,0,0,0,0,100000,0,0,0,100000,0,100000,100000
054040,中石化元大9C購01,0,0,0,0,0,0,0,0,0,100000,0,0,0,100000,0,100000,100000
055144,T50反1元大97購03,0,0,0,0,0,0,0,0,0,100000,0,0,0,100000,0,100000,100000
05685P,臺股指元大96售10,0,0,0,0,0,0,0,0,0,100000,0,0,0,100000,0,100000,100000
056937,智原元富98購01  ,0,0,0,0,0,0,0,0,0,100000,0,0,0,100000,0,100000,100000
053251,世紀鋼國票97購02,0,0,0,0,0,0,0,0,0,100000,0,0,0,100000,0,100000,100000
052877,矽創凱基96購01  ,0,0,0,0,0,0,0,0,0,100000,0,0,0,100000,0,100000,100000
056441,燿華凱基98購01  ,0,0,0,0,0,0,0,0,0,100000,0,0,0,100000,0,100000,100000
056552,台表科凱基99購01,0,0,0,0,0,0,0,0,0,100000,0,0,0,120000,20000,100000,100000
053170,茂林群益96購04  ,0,0,0,0,0,0,0,0,0,100000,0,0,0,100000,0,100000,100000
3376,新日興          ,1298000,763000,535000,0,0,0,56000,468000,-412000,-23000,18000,35000,-17000,8000,14000,-6000,100000
05882P,華新科永豐96售01,0,0,0,0,0,0,0,0,0,99000,0,0,0,101000,2000,99000,99000
00647L,元大S&P500正2   ,25000,25000,0,0,0,0,0,0,0,99000,0,0,0,834000,735000,99000,99000
04913P,聯詠元富94售02  ,0,0,0,0,0,0,0,0,0,99000,0,0,0,99000,0,99000,99000
055238,茂林台新97購01  ,0,0,0,0,0,0,0,0,0,99000,0,0,0,99000,0,99000,99000
058682,聯發科凱基99購07,0,0,0,0,0,0,0,0,0,98000,0,0,0,104000,6000,98000,98000
043585,道瓊反元大94購01,0,0,0,0,0,0,0,0,0,98000,0,0,0,103000,5000,98000,98000
04373P,滬深2X元大97售01,0,0,0,0,0,0,0,0,0,98000,0,0,0,121000,23000,98000,98000
053827,漢唐麥證9A購01  ,0,0,0,98000,0,98000,0,0,0,98000,0,0,0,98000,0,98000,98000
058142,瑞儀元大99購01  ,0,0,0,0,0,0,0,0,0,97000,0,0,0,232000,135000,97000,97000
07099P,台積電元大99售19,0,0,0,0,0,0,0,0,0,97000,0,0,0,314000,217000,97000,97000
04777P,聯發科凱基94售10,0,0,0,0,0,0,0,0,0,97000,0,0,0,97000,0,97000,97000
052400,聯詠凱基97購01  ,0,0,0,0,0,0,0,0,0,97000,0,0,0,98000,1000,97000,97000
05694P,台積電凱基96售09,0,0,0,0,0,0,0,0,0,97000,0,0,0,97000,0,97000,97000
056982,華新科群益98購05,0,0,0,0,0,0,0,0,0,97000,0,0,0,107000,10000,97000,97000
055330,上銀兆豐98購02  ,0,0,0,0,0,0,0,0,0,97000,0,0,0,97000,0,97000,97000
06550P,健策元大99售01  ,0,0,0,0,0,0,0,0,0,96000,0,0,0,259000,163000,96000,96000
057981,臻鼎永豐98購01  ,0,0,0,0,0,0,0,0,0,96000,0,0,0,96000,0,96000,96000
058767,亞德客兆豐99購01,0,0,0,0,0,0,0,0,0,96000,0,0,0,233000,137000,96000,96000
04729P,臺股指中信96售01,0,0,0,0,0,0,0,0,0,96000,0,0,0,96000,0,96000,96000
052104,英業達兆豐96購01,0,0,0,0,0,0,0,0,0,96000,0,0,0,116000,20000,96000,96000
04923P,GIS凱基94售06   ,0,0,0,0,0,0,0,0,0,96000,0,0,0,106000,10000,96000,96000
053085,華新科元大97購04,0,0,0,0,0,0,0,0,0,96000,0,0,0,100000,4000,96000,96000
053372,元油反元大98購01,0,0,0,0,0,0,0,0,0,96000,0,0,0,96000,0,96000,96000
056698,T50反1國泰9A購01,0,0,0,0,0,0,0,0,0,96000,0,0,0,96000,0,96000,96000
06637P,大立光凱基98售15,0,0,0,0,0,0,0,0,0,95000,0,0,0,99000,4000,95000,95000
04996P,台積電凱基95售02,0,0,0,0,0,0,0,0,0,95000,0,0,0,95000,0,95000,95000
050773,京鼎元大94購02  ,0,0,0,0,0,0,0,0,0,95000,0,0,0,95000,0,95000,95000
050652,大立光凱基96購03,0,0,0,0,0,0,0,0,0,95000,0,0,0,95000,0,95000,95000
051847,香港反中信99購01,0,0,0,0,0,0,0,0,0,95000,0,0,0,95000,0,95000,95000
056450,可成凱基98購05  ,0,0,0,0,0,0,0,0,0,95000,0,0,0,105000,10000,95000,95000
055013,訊連元富97購01  ,0,0,0,0,0,0,0,0,0,95000,0,0,0,125000,30000,95000,95000
06702P,智邦元富98售01  ,0,0,0,0,0,0,0,0,0,94000,0,0,0,94000,0,94000,94000
06133P,帆宣元富97售02  ,0,0,0,0,0,0,0,0,0,94000,0,0,0,94000,0,94000,94000
057596,聯茂兆豐99購01  ,0,0,0,0,0,0,0,0,0,94000,0,0,0,94000,0,94000,94000
03242P,聯電統一02售04  ,0,0,0,0,0,0,0,0,0,94000,0,0,0,94000,0,94000,94000
049982,嘉晶凱基94購01  ,0,0,0,0,0,0,0,0,0,94000,0,0,0,200000,106000,94000,94000
06719P,台灣50群益9A售01,0,0,0,0,0,0,0,0,0,93000,0,0,0,93000,0,93000,93000
1762,中化生          ,319000,227000,92000,0,0,0,0,0,0,0,0,0,0,0,0,0,92000
058501,S&P正2元大99購01,0,0,0,0,0,0,0,0,0,92000,0,0,0,92000,0,92000,92000
051103,緯穎元大96購03  ,0,0,0,0,0,0,0,0,0,92000,0,0,0,97000,5000,92000,92000
04770P,鴻海元大94售09  ,0,0,0,0,0,0,0,0,0,92000,0,0,0,140000,48000,92000,92000
05830P,滬深2X元富99售03,0,0,0,0,0,0,0,0,0,91000,0,0,0,91000,0,91000,91000
06822P,上銀富邦99售03  ,0,0,0,0,0,0,0,0,0,91000,0,0,0,110000,19000,91000,91000
04289P,臺股指中信95售07,0,0,0,0,0,0,0,0,0,91000,0,0,0,91000,0,91000,91000
3028,增你強          ,149000,61000,88000,0,0,0,0,0,0,3000,4000,1000,3000,0,0,0,91000
2431,聯昌            ,138000,49000,89000,0,0,0,0,0,0,2000,2000,0,2000,0,0,0,91000
2505,國揚            ,595192,433000,162192,0,0,0,0,0,0,-72000,0,0,0,0,72000,-72000,90192
06617P,智邦元大98售03  ,0,0,0,0,0,0,0,0,0,90000,0,0,0,345000,255000,90000,90000
057993,中環中信98購01  ,0,0,0,0,0,0,0,0,0,90000,0,0,0,100000,10000,90000,90000
058097,台灣50國泰99購01,0,0,0,0,0,0,0,0,0,90000,0,0,0,92000,2000,90000,90000
057656,大成鋼兆豐98購01,0,0,0,0,0,0,0,0,0,90000,0,0,0,480000,390000,90000,90000
058324,嘉聯益永豐9A購01,0,0,0,0,0,0,0,0,0,90000,0,0,0,90000,0,90000,90000
058753,元石油群益9B購03,0,0,0,0,0,0,0,0,0,90000,0,0,0,90000,0,90000,90000
052182,鴻海群益96購01  ,0,0,0,0,0,0,0,0,0,90000,0,0,0,100000,10000,90000,90000
049589,奇力新元大95購02,0,0,0,0,0,0,0,0,0,90000,0,0,0,120000,30000,90000,90000
052381,臺股指元大95購22,0,0,0,0,0,0,0,0,0,90000,0,0,0,90000,0,90000,90000
053532,台積電永豐96購03,0,0,0,0,0,0,0,0,0,90000,0,0,0,100000,10000,90000,90000
058908,貿聯元大99購03  ,0,0,0,0,0,0,0,0,0,89000,0,0,0,114000,25000,89000,89000
058398,中環元大99購02  ,0,0,0,0,0,0,0,0,0,89000,0,0,0,90000,1000,89000,89000
047074,大立光兆豐94購02,0,0,0,0,0,0,0,0,0,89000,0,0,0,89000,0,89000,89000
05724P,致茂永豐96售01  ,0,0,0,0,0,0,0,0,0,89000,0,0,0,119000,30000,89000,89000
5215,科嘉-KY         ,129000,214000,-85000,0,0,0,183000,5000,178000,-4000,1000,5000,-4000,0,0,0,89000
058482,祥碩凱基99購02  ,0,0,0,0,0,0,0,0,0,88000,0,0,0,98000,10000,88000,88000
058464,矽創兆豐9A購01  ,0,0,0,0,0,0,0,0,0,88000,0,0,0,95000,7000,88000,88000
07085P,超眾元富9C售01  ,0,0,0,0,0,0,0,0,0,88000,0,0,0,89000,1000,88000,88000
07006P,旺宏統一9B售03  ,0,0,0,0,0,0,0,0,0,88000,0,0,0,88000,0,88000,88000
00652,富邦印度        ,87000,2000,85000,0,0,0,0,0,0,3000,0,0,0,88000,85000,3000,88000
053951,T50反1台新06購02,0,0,0,0,0,0,0,0,0,88000,0,0,0,88000,0,88000,88000
5288,豐祥-KY         ,126000,38000,88000,0,0,0,0,0,0,0,0,0,0,0,0,0,88000
4164,承業醫          ,168000,78000,90000,0,0,0,0,0,0,-2000,4000,6000,-2000,0,0,0,88000
3557,嘉威            ,138000,50000,88000,0,0,0,0,0,0,0,0,0,0,0,0,0,88000
055831,台達電元大97購01,0,0,0,0,0,0,0,0,0,87000,0,0,0,100000,13000,87000,87000
3703,欣陸            ,243000,156000,87000,0,0,0,0,0,0,0,0,0,0,0,0,0,87000
4919,新唐            ,436000,363000,73000,0,0,0,2000,0,2000,12000,5000,0,5000,14000,7000,7000,87000
06739P,聯詠兆豐98售02  ,0,0,0,0,0,0,0,0,0,86000,0,0,0,90000,4000,86000,86000
06445P,大立光凱基98售09,0,0,0,0,0,0,0,0,0,86000,0,0,0,86000,0,86000,86000
03177P,國巨群益01售12  ,0,0,0,0,0,0,0,0,0,86000,0,0,0,86000,0,86000,86000
04801P,矽力元大94售02  ,0,0,0,0,0,0,0,0,0,86000,0,0,0,86000,0,86000,86000
4137,麗豐-KY         ,226000,141000,85000,0,0,0,0,0,0,1000,0,0,0,2000,1000,1000,86000
06408P,聯茂元富97售02  ,0,0,0,0,0,0,0,0,0,85000,0,0,0,85000,0,85000,85000
057862,智邦凱基99購01  ,0,0,0,0,0,0,0,0,0,85000,0,0,0,85000,0,85000,85000
06309P,光罩元富97售03  ,0,0,0,0,0,0,0,0,0,84000,0,0,0,84000,0,84000,84000
06165P,臺股指凱基9A售03,0,0,0,0,0,0,0,0,0,84000,0,0,0,84000,0,84000,84000
05989P,健策元富96售01  ,0,0,0,0,0,0,0,0,0,84000,0,0,0,99000,15000,84000,84000
06942P,台灣50台新02售01,0,0,0,0,0,0,0,0,0,84000,0,1000,-1000,95000,10000,85000,84000
05091P,台積電元大95售11,0,0,0,0,0,0,0,0,0,84000,0,0,0,144000,60000,84000,84000
053450,同欣電凱基96購02,0,0,0,0,0,0,0,0,0,84000,0,0,0,84000,0,84000,84000
057292,國巨國泰9B購01  ,0,0,0,0,0,0,0,0,0,84000,0,0,0,84000,0,84000,84000
057071,華擎永豐98購02  ,0,0,0,0,0,0,0,0,0,84000,0,0,0,211000,127000,84000,84000
06984P,上銀富邦9B售01  ,0,0,0,0,0,0,0,0,0,83000,0,0,0,83000,0,83000,83000
06718P,聯詠元大98售01  ,0,0,0,0,0,0,0,0,0,83000,0,0,0,93000,10000,83000,83000
049638,A50反1凱基94購01,0,0,0,0,0,0,0,0,0,83000,0,0,0,83000,0,83000,83000
06995P,臺股指凱基99售16,0,0,0,0,0,0,0,0,0,82000,0,0,0,82000,0,82000,82000
05100P,智邦凱基95售02  ,0,0,0,0,0,0,0,0,0,82000,0,0,0,92000,10000,82000,82000
051673,玉晶光元大96購04,0,0,0,0,0,0,0,0,0,82000,0,0,0,177000,95000,82000,82000
055724,祥碩元大97購03  ,0,0,0,0,0,0,0,0,0,82000,0,0,0,92000,10000,82000,82000
05477P,華新科群益95售06,0,0,0,0,0,0,0,0,0,82000,0,0,0,157000,75000,82000,82000
07106P,國巨統一9B售05  ,0,0,0,0,0,0,0,0,0,81000,0,0,0,96000,15000,81000,81000
1104,環泥            ,154000,73000,81000,0,0,0,0,0,0,0,0,0,0,0,0,0,81000
06247P,同欣電元富97售02,0,0,0,0,0,0,0,0,0,81000,0,0,0,111000,30000,81000,81000
06665P,欣興兆豐99售01  ,0,0,0,0,0,0,0,0,0,81000,0,0,0,103000,22000,81000,81000
058766,力山兆豐99購01  ,0,0,0,0,0,0,0,0,0,81000,0,0,0,121000,40000,81000,81000
05886P,華通元富96售01  ,0,0,0,0,0,0,0,0,0,81000,0,0,0,81000,0,81000,81000
050897,嘉晶元大95購03  ,0,0,0,0,0,0,0,0,0,81000,0,0,0,81000,0,81000,81000
050497,臺指反凱基96購02,0,0,0,0,0,0,0,0,0,81000,0,0,0,81000,0,81000,81000
052805,晶技元大97購01  ,0,0,0,0,0,0,0,0,0,81000,0,0,0,81000,0,81000,81000
9955,佳龍            ,229000,148000,81000,0,0,0,0,0,0,0,0,0,0,0,0,0,81000
058936,國喬中信99購01  ,0,0,0,0,0,0,0,0,0,80000,0,0,0,160000,80000,80000,80000
058420,聯發科麥證99購03,0,0,0,80000,130000,-50000,0,0,0,80000,0,0,0,210000,130000,80000,80000
058338,康友元富99購01  ,0,0,0,0,0,0,0,0,0,80000,0,0,0,80000,0,80000,80000
057757,鴻海凱基98購13  ,0,0,0,0,0,0,0,0,0,80000,0,0,0,80000,0,80000,80000
057570,技嘉永豐98購02  ,0,0,0,0,0,0,0,0,0,80000,0,0,0,100000,20000,80000,80000
06610P,台積電凱基9A售03,0,0,0,0,0,0,0,0,0,80000,0,0,0,80000,0,80000,80000
06197P,國巨元大97售08  ,0,0,0,0,0,0,0,0,0,80000,0,0,0,80000,0,80000,80000
08897P,國巨群益01售10  ,0,0,0,0,0,0,0,0,0,80000,0,0,0,80000,0,80000,80000
051820,道瓊反元富95購01,0,0,0,0,0,0,0,0,0,80000,0,0,0,80000,0,80000,80000
04787P,台積電永昌96售04,0,0,0,0,0,0,0,0,0,80000,0,0,0,399000,319000,80000,80000
037839,T50反1群益93購01,0,0,0,0,0,0,0,0,0,80000,0,0,0,85000,5000,80000,80000
03828P,致茂中信95售01  ,0,0,0,0,0,0,0,0,0,80000,0,0,0,80000,0,80000,80000
04840P,大立光元大94售18,0,0,0,0,0,0,0,0,0,80000,0,0,0,80000,0,80000,80000
055879,神達元富97購01  ,0,0,0,0,0,0,0,0,0,80000,0,0,0,80000,0,80000,80000
049483,台積電元大94購12,0,0,0,0,0,0,0,0,0,80000,0,0,0,139000,59000,80000,80000
050823,信邦凱基95購01  ,0,0,0,0,0,0,0,0,0,80000,0,0,0,80000,0,80000,80000
052930,華新科元大97購03,0,0,0,0,0,0,0,0,0,80000,0,0,0,80000,0,80000,80000
053361,友達元富99購01  ,0,0,0,0,0,0,0,0,0,80000,0,0,0,80000,0,80000,80000
053285,臺股指元大96購08,0,0,0,0,0,0,0,0,0,80000,0,0,0,80000,0,80000,80000
05631P,國巨富邦9A售01  ,0,0,0,0,0,0,0,0,0,80000,0,0,0,109000,29000,80000,80000
053130,聯發科麥證96購01,0,0,0,80000,0,80000,0,0,0,80000,0,0,0,80000,0,80000,80000
057054,立積元大98購03  ,0,0,0,0,0,0,0,0,0,80000,0,0,0,80000,0,80000,80000
05728P,滬深2X凱基98售03,0,0,0,0,0,0,0,0,0,80000,0,0,0,80000,0,80000,80000
05239P,欣興永豐95售03  ,0,0,0,0,0,0,0,0,0,80000,0,0,0,80000,0,80000,80000
05464P,華通康和95售02  ,0,0,0,0,0,0,0,0,0,80000,0,0,0,94000,14000,80000,80000
054744,晶相光凱基99購01,0,0,0,0,0,0,0,0,0,80000,0,0,0,90000,10000,80000,80000
2501,國建            ,424534,335000,89534,0,0,0,0,0,0,-10000,0,10000,-10000,0,0,0,79534
1721,三晃            ,108000,30000,78000,0,0,0,0,0,0,1000,1000,0,1000,0,0,0,79000
06129P,玉晶光元富97售06,0,0,0,0,0,0,0,0,0,79000,0,0,0,79000,0,79000,79000
06554P,臺股指元大99售06,0,0,0,0,0,0,0,0,0,79000,0,0,0,79000,0,79000,79000
05755P,臺股指中信99售04,0,0,0,0,0,0,0,0,0,79000,0,0,0,87000,8000,79000,79000
058045,鴻海元大99購08  ,0,0,0,0,0,0,0,0,0,79000,0,0,0,133000,54000,79000,79000
054025,鴻海凱基96購17  ,0,0,0,0,0,0,0,0,0,79000,0,0,0,79000,0,79000,79000
054308,嘉晶凱基98購01  ,0,0,0,0,0,0,0,0,0,79000,0,0,0,79000,0,79000,79000
5706,鳳凰            ,94000,15000,79000,0,0,0,0,0,0,0,0,0,0,0,0,0,79000
06537P,華通凱基98售04  ,0,0,0,0,0,0,0,0,0,78000,0,0,0,108000,30000,78000,78000
05923P,旺宏元富96售05  ,0,0,0,0,0,0,0,0,0,78000,0,0,0,78000,0,78000,78000
07093P,台積電凱基99售07,0,0,0,0,0,0,0,0,0,78000,0,0,0,157000,79000,78000,78000
055683,晶技凱基99購01  ,0,0,0,0,0,0,0,0,0,78000,0,0,0,80000,2000,78000,78000
03543P,台泥中信02售01  ,0,0,0,0,0,0,0,0,0,78000,0,0,0,78000,0,78000,78000
006207,FH滬深          ,6000,89000,-83000,0,0,0,0,0,0,161000,0,0,0,291000,130000,161000,78000
04484P,台積電凱基94售09,0,0,0,0,0,0,0,0,0,78000,0,0,0,88000,10000,78000,78000
056755,聯茂兆豐98購01  ,0,0,0,0,0,0,0,0,0,78000,0,0,0,78000,0,78000,78000
056459,茂林凱基99購01  ,0,0,0,0,0,0,0,0,0,78000,0,0,0,78000,0,78000,78000
05370P,矽創元富95售01  ,0,0,0,0,0,0,0,0,0,78000,0,0,0,78000,0,78000,78000
4989,榮科            ,104000,30000,74000,0,0,0,0,0,0,4000,4000,0,4000,0,0,0,78000
8341,日友            ,149000,72000,77000,0,0,0,1000,0,1000,0,0,0,0,0,0,0,78000
01002T,土銀國泰R1      ,77428,0,77428,0,0,0,0,0,0,0,0,0,0,0,0,0,77428
1503,士電            ,144000,67000,77000,0,0,0,0,0,0,0,0,0,0,0,0,0,77000
06308P,國巨元富97售06  ,0,0,0,0,0,0,0,0,0,77000,0,0,0,153000,76000,77000,77000
057893,亞德客元富98購03,0,0,0,0,0,0,0,0,0,77000,0,0,0,77000,0,77000,77000
058615,矽創元大99購01  ,0,0,0,0,0,0,0,0,0,77000,0,0,0,77000,0,77000,77000
056446,聯發科凱基98購08,0,0,0,0,0,0,0,0,0,77000,0,0,0,77000,0,77000,77000
3413,京鼎            ,815000,273000,542000,0,0,0,1000,462000,-461000,-4000,1000,3000,-2000,1000,3000,-2000,77000
2206,三陽工業        ,309000,237000,72000,0,0,0,0,0,0,5000,5000,0,5000,0,0,0,77000
1476,儒鴻            ,1125000,1029312,95688,0,0,0,3000,35000,-32000,13000,77000,56000,21000,1000,9000,-8000,76688
058817,嘉聯益台新99購01,0,0,0,0,0,0,0,0,0,76000,0,0,0,147000,71000,76000,76000
046793,聯發科元富99購01,0,0,0,0,0,0,0,0,0,76000,0,0,0,76000,0,76000,76000
055482,聚陽元大97購02  ,0,0,0,0,0,0,0,0,0,76000,0,0,0,156000,80000,76000,76000
052123,泰碩國票95購01  ,0,0,0,0,0,0,0,0,0,76000,0,0,0,86000,10000,76000,76000
05260P,和碩元富95售02  ,0,0,0,0,0,0,0,0,0,76000,0,0,0,76000,0,76000,76000
057883,中環群益98購01  ,0,0,0,0,0,0,0,0,0,75000,0,0,0,150000,75000,75000,75000
05742P,可成元大96售04  ,0,0,0,0,0,0,0,0,0,75000,0,0,0,75000,0,75000,75000
07076P,鴻海凱基9A售08  ,0,0,0,0,0,0,0,0,0,75000,0,0,0,78000,3000,75000,75000
06244P,智易元富97售02  ,0,0,0,0,0,0,0,0,0,75000,0,0,0,75000,0,75000,75000
06474P,鴻海富邦98售03  ,0,0,0,0,0,0,0,0,0,75000,0,0,0,75000,0,75000,75000
048868,劍麟國票94購01  ,0,0,0,0,0,0,0,0,0,75000,0,0,0,75000,0,75000,75000
049612,香港反中信96購01,0,0,0,0,0,0,0,0,0,75000,0,0,0,75000,0,75000,75000
04738P,揚明光永豐94售03,0,0,0,0,0,0,0,0,0,75000,0,0,0,75000,0,75000,75000
04709P,台積電元大94售15,0,0,0,0,0,0,0,0,0,75000,0,0,0,75000,0,75000,75000
00636,國泰中國A50     ,91000,117000,-26000,0,0,0,0,0,0,101000,170000,170000,0,769000,668000,101000,75000
03615C,臺股指元大94牛01,0,0,0,0,0,0,0,0,0,75000,0,0,0,117000,42000,75000,75000
4766,南寶            ,143000,56000,87000,0,0,0,0,0,0,-12000,0,12000,-12000,0,0,0,75000
3443,創意            ,562000,489087,72913,0,0,0,1000,1000,0,2000,22000,36000,-14000,22000,6000,16000,74913
06018P,康控凱基96售03  ,0,0,0,0,0,0,0,0,0,74000,0,0,0,80000,6000,74000,74000
042387,台積電永昌93購02,0,0,0,0,0,0,0,0,0,74000,0,0,0,74000,0,74000,74000
05558P,鴻海麥證96售01  ,0,0,0,74000,0,74000,0,0,0,74000,0,0,0,74000,0,74000,74000
056196,聯茂富邦98購02  ,0,0,0,0,0,0,0,0,0,74000,0,0,0,74000,0,74000,74000
053307,泰碩凱基97購01  ,0,0,0,0,0,0,0,0,0,74000,0,0,0,84000,10000,74000,74000
05663P,創意元富96售04  ,0,0,0,0,0,0,0,0,0,74000,0,0,0,74000,0,74000,74000
056240,嘉晶群益97購02  ,0,0,0,0,0,0,0,0,0,74000,0,0,0,74000,0,74000,74000
9914,美利達          ,1007000,477000,530000,0,0,0,4000,456000,-452000,-4000,28000,28000,0,0,4000,-4000,74000
06188P,大立光元富97售01,0,0,0,0,0,0,0,0,0,73000,0,0,0,73000,0,73000,73000
06238P,台積電元大98售07,0,0,0,0,0,0,0,0,0,73000,0,0,0,434000,361000,73000,73000
06310P,精元元富97售02  ,0,0,0,0,0,0,0,0,0,73000,0,0,0,100000,27000,73000,73000
06604P,聯發科元富02售02,0,0,0,0,0,0,0,0,0,73000,0,0,0,83000,10000,73000,73000
04294P,台積電元大95售01,0,0,0,0,0,0,0,0,0,73000,0,0,0,342000,269000,73000,73000
05437P,聯詠永豐95售02  ,0,0,0,0,0,0,0,0,0,73000,0,0,0,80000,7000,73000,73000
6451,訊芯-KY         ,638000,591000,47000,0,0,0,0,0,0,26000,23000,18000,5000,21000,0,21000,73000
05863P,滬深2X元大96售09,0,0,0,0,0,0,0,0,0,72000,0,0,0,72000,0,72000,72000
050173,旺宏元大96購02  ,0,0,0,0,0,0,0,0,0,72000,0,0,0,80000,8000,72000,72000
055272,國巨元大98購04  ,0,0,0,0,0,0,0,0,0,72000,0,0,0,72000,0,72000,72000
6706,惠特            ,185000,113000,72000,0,0,0,0,0,0,0,0,0,0,0,0,0,72000
3356,奇偶            ,123000,53000,70000,0,0,0,0,0,0,2000,2000,0,2000,0,0,0,72000
058366,元大金凱基99購01,0,0,0,0,0,0,0,0,0,71000,0,0,0,225000,154000,71000,71000
058914,元油2X元富01購02,0,0,0,0,0,0,0,0,0,71000,0,0,0,71000,0,71000,71000
057516,和鑫元富98購01  ,0,0,0,0,0,0,0,0,0,71000,0,0,0,101000,30000,71000,71000
06646P,國巨元大98售16  ,0,0,0,0,0,0,0,0,0,71000,0,0,0,83000,12000,71000,71000
06647P,台積電元大98售13,0,0,0,0,0,0,0,0,0,71000,0,0,0,71000,0,71000,71000
06488P,台積電元富98售05,0,0,0,0,0,0,0,0,0,71000,0,0,0,74000,3000,71000,71000
06036P,台表科凱基96售04,0,0,0,0,0,0,0,0,0,71000,0,0,0,78000,7000,71000,71000
06089P,矽創永豐97售01  ,0,0,0,0,0,0,0,0,0,71000,0,0,0,71000,0,71000,71000
04939P,國巨國票95售03  ,0,0,0,0,0,0,0,0,0,71000,0,0,0,71000,0,71000,71000
05215P,台積電台新95售03,0,0,0,0,0,0,0,0,0,71000,0,0,0,97000,26000,71000,71000
05082P,健策永豐95售02  ,0,0,0,0,0,0,0,0,0,71000,0,0,0,206000,135000,71000,71000
050685,緯穎元富94購02  ,0,0,0,0,0,0,0,0,0,71000,0,0,0,71000,0,71000,71000
05420P,大立光國泰97售03,0,0,0,0,0,0,0,0,0,71000,0,0,0,71000,0,71000,71000
05289P,鴻海永豐95售05  ,0,0,0,0,0,0,0,0,0,71000,0,0,0,121000,50000,71000,71000
05366P,鴻海元富95售12  ,0,0,0,0,0,0,0,0,0,71000,0,0,0,71000,0,71000,71000
06444P,大立光凱基98售08,0,0,0,0,0,0,0,0,0,70000,0,0,0,70000,0,70000,70000
06767P,台積電永昌99售03,0,0,0,0,0,0,0,0,0,70000,0,0,0,80000,10000,70000,70000
058257,聯陽國泰9B購01  ,0,0,0,0,0,0,0,0,0,70000,0,0,0,70000,0,70000,70000
058568,宏達電凱基9A購02,0,0,0,0,0,0,0,0,0,70000,0,0,0,100000,30000,70000,70000
055691,訊芯凱基97購02  ,0,0,0,0,0,0,0,0,0,70000,0,0,0,70000,0,70000,70000
051355,聯發科元大96購01,0,0,0,0,0,0,0,0,0,70000,0,0,0,70000,0,70000,70000
05049P,矽創永豐95售01  ,0,0,0,0,0,0,0,0,0,70000,0,0,0,120000,50000,70000,70000
050406,台積電台新95購02,0,0,0,0,0,0,0,0,0,70000,0,0,0,170000,100000,70000,70000
04881P,高股息凱基96售01,0,0,0,0,0,0,0,0,0,70000,0,0,0,91000,21000,70000,70000
04699P,臺股指元富94售05,0,0,0,0,0,0,0,0,0,70000,0,0,0,70000,0,70000,70000
00766L,台新MSCI中國正2 ,0,0,0,0,0,0,0,0,0,70000,0,0,0,139000,69000,70000,70000
044439,南電元大93購01  ,0,0,0,0,0,0,0,0,0,70000,0,0,0,170000,100000,70000,70000
054112,台積電麥證96購02,0,0,0,0,10000,-10000,0,0,0,70000,0,0,0,80000,10000,70000,70000
054665,華通元富97購02  ,0,0,0,0,0,0,0,0,0,70000,0,0,0,70000,0,70000,70000
054940,台積電元大97購16,0,0,0,0,0,0,0,0,0,70000,0,0,0,70000,0,70000,70000
057372,華新科元大99購10,0,0,0,0,0,0,0,0,0,70000,0,0,0,130000,60000,70000,70000
052834,彩晶群益96購01  ,0,0,0,0,0,0,0,0,0,70000,0,0,0,70000,0,70000,70000
053351,A50正2兆豐97購01,0,0,0,0,0,0,0,0,0,70000,0,0,0,70000,0,70000,70000
05256P,義隆凱基95售02  ,0,0,0,0,0,0,0,0,0,70000,0,0,0,70000,0,70000,70000
053098,國巨元富96購04  ,0,0,0,0,0,0,0,0,0,70000,0,0,0,70000,0,70000,70000
053154,聯詠元大96購01  ,0,0,0,0,0,0,0,0,0,70000,0,0,0,110000,40000,70000,70000
2233,宇隆            ,129000,59000,70000,0,0,0,0,0,0,0,0,0,0,0,0,0,70000
04345P,景碩國泰94售02  ,0,0,0,0,0,0,0,0,0,69000,0,0,0,77000,8000,69000,69000
04760P,旺宏凱基94售02  ,0,0,0,0,0,0,0,0,0,69000,0,0,0,71000,2000,69000,69000
050854,世紀鋼國票97購01,1000,0,1000,0,0,0,0,0,0,68000,0,0,0,70000,2000,68000,69000
05727P,新光金日盛96售02,0,0,0,0,0,0,0,0,0,69000,0,0,0,127000,58000,69000,69000
055030,帆宣國泰99購02  ,0,0,0,0,0,0,0,0,0,69000,0,0,0,209000,140000,69000,69000
4532,瑞智            ,174000,108000,66000,0,0,0,0,0,0,3000,3000,0,3000,0,0,0,69000
6541,泰福-KY         ,164000,95000,69000,0,0,0,0,0,0,0,0,0,0,0,0,0,69000
06791P,聯發科凱基98售16,0,0,0,0,0,0,0,0,0,68000,0,0,0,82000,14000,68000,68000
06715P,台積電元大99售04,0,0,0,0,0,0,0,0,0,68000,0,0,0,68000,0,68000,68000
06087P,國巨永豐97售01  ,0,0,0,0,0,0,0,0,0,68000,0,0,0,73000,5000,68000,68000
06073P,健策永豐97售01  ,0,0,0,0,0,0,0,0,0,68000,0,0,0,108000,40000,68000,68000
049860,亞德客兆豐94購01,0,0,0,0,0,0,0,0,0,68000,0,0,0,159000,91000,68000,68000
03576P,台灣50元富06售01,0,0,0,0,0,0,0,0,0,68000,0,0,0,68000,0,68000,68000
054910,信錦凱基97購01  ,0,0,0,0,0,0,0,0,0,68000,0,0,0,68000,0,68000,68000
05470P,康控元大95售05  ,0,0,0,0,0,0,0,0,0,68000,0,0,0,68000,0,68000,68000
5907,大洋-KY         ,126000,58000,68000,0,0,0,0,0,0,0,0,0,0,0,0,0,68000
6139,亞翔            ,222000,157000,65000,0,0,0,0,0,0,3000,4000,0,4000,0,1000,-1000,68000
3149,正達            ,88000,20000,68000,0,0,0,0,0,0,0,0,0,0,0,0,0,68000
06177P,玉晶光元大98售07,0,0,0,0,0,0,0,0,0,67000,0,0,0,97000,30000,67000,67000
06434P,超眾群益98售02  ,0,0,0,0,0,0,0,0,0,67000,0,0,0,100000,33000,67000,67000
044247,道瓊反元富97購01,0,0,0,0,0,0,0,0,0,67000,0,0,0,176000,109000,67000,67000
04802P,國巨凱基94售07  ,0,0,0,0,0,0,0,0,0,67000,0,0,0,69000,2000,67000,67000
053443,智邦凱基97購01  ,0,0,0,0,0,0,0,0,0,67000,0,0,0,107000,40000,67000,67000
054793,牧德群益9A購01  ,0,0,0,0,0,0,0,0,0,67000,0,0,0,211000,144000,67000,67000
057203,麗豐元富98購02  ,0,0,0,0,0,0,0,0,0,67000,0,0,0,67000,0,67000,67000
2425,承啟            ,377000,312000,65000,0,0,0,0,0,0,2000,2000,0,2000,0,0,0,67000
06898P,FBVIX群益9C售03 ,0,0,0,0,0,0,0,0,0,66000,0,0,0,193000,127000,66000,66000
08801P,聯發科元大01售13,0,0,0,0,0,0,0,0,0,66000,0,0,0,66000,0,66000,66000
058370,聯詠凱基99購01  ,0,0,0,0,0,0,0,0,0,66000,0,0,0,68000,2000,66000,66000
047784,元油反富邦94購03,0,0,0,0,0,0,0,0,0,66000,0,0,0,66000,0,66000,66000
04215P,鴻海國票93售02  ,0,0,0,0,0,0,0,0,0,66000,0,0,0,66000,0,66000,66000
058632,世紀鋼國票9A購01,0,0,0,0,0,0,0,0,0,65000,0,0,0,78000,13000,65000,65000
06887P,華新科元大98售04,0,0,0,0,0,0,0,0,0,65000,0,0,0,70000,5000,65000,65000
06832P,玉晶光凱基98售03,0,0,0,0,0,0,0,0,0,65000,0,0,0,315000,250000,65000,65000
04782P,智伸科統一96售01,0,0,0,0,0,0,0,0,0,65000,0,0,0,65000,0,65000,65000
048133,臻鼎國票94購01  ,0,0,0,0,0,0,0,0,0,65000,0,0,0,65000,0,65000,65000
049726,道瓊反中信96購01,0,0,0,0,0,0,0,0,0,65000,0,0,0,65000,0,65000,65000
051490,世芯凱基96購01  ,0,0,0,0,0,0,0,0,0,65000,0,0,0,84000,19000,65000,65000
056313,聯茂元大98購01  ,0,0,0,0,0,0,0,0,0,65000,0,0,0,75000,10000,65000,65000
056534,京元電凱基98購01,0,0,0,0,0,0,0,0,0,65000,0,0,0,65000,0,65000,65000
053255,貿聯國泰97購01  ,0,0,0,0,0,0,0,0,0,65000,0,0,0,205000,140000,65000,65000
1229,聯華            ,714000,588000,126000,0,0,0,0,0,0,-62000,2000,64000,-62000,0,0,0,64000
06679P,旺宏元大98售09  ,0,0,0,0,0,0,0,0,0,64000,0,0,0,166000,102000,64000,64000
05118P,超眾元大96售04  ,0,0,0,0,0,0,0,0,0,64000,0,0,0,251000,187000,64000,64000
051896,柏文元富95購01  ,0,0,0,0,0,0,0,0,0,64000,0,0,0,64000,0,64000,64000
053006,玉晶光永豐96購03,0,0,0,0,0,0,0,0,0,64000,0,0,0,68000,4000,64000,64000
056628,矽創永豐98購01  ,0,0,0,0,0,0,0,0,0,64000,0,0,0,64000,0,64000,64000
05367P,鴻海元富95售13  ,0,0,0,0,0,0,0,0,0,64000,0,0,0,64000,0,64000,64000
3013,晟銘電          ,116000,54000,62000,0,0,0,0,0,0,2000,2000,0,2000,0,0,0,64000
057902,嘉晶永豐98購02  ,0,0,0,0,0,0,0,0,0,63000,0,0,0,135000,72000,63000,63000
047825,道瓊反元大96購01,0,0,0,0,0,0,0,0,0,63000,0,0,0,92000,29000,63000,63000
04957P,上証2X凱基96售02,0,0,0,0,0,0,0,0,0,63000,0,0,0,63000,0,63000,63000
057199,台達電元富02購01,0,0,0,0,0,0,0,0,0,63000,0,0,0,63000,0,63000,63000
05485P,旺宏凱基95售08  ,0,0,0,0,0,0,0,0,0,63000,0,0,0,95000,32000,63000,63000
057028,台郡凱基99購02  ,0,0,0,0,0,0,0,0,0,63000,0,0,0,63000,0,63000,63000
4155,訊映            ,197000,134000,63000,0,0,0,0,0,0,0,0,0,0,0,0,0,63000
057523,大成鋼元大99購01,0,0,0,0,0,0,0,0,0,62000,0,0,0,72000,10000,62000,62000
06078P,臺股指凱基9A售01,0,0,0,0,0,0,0,0,0,62000,0,0,0,62000,0,62000,62000
08100P,台灣50元富95售01,0,0,0,0,0,0,0,0,0,62000,0,0,0,115000,53000,62000,62000
06731P,聯茂元大98售05  ,0,0,0,0,0,0,0,0,0,62000,0,0,0,100000,38000,62000,62000
051555,聯茂永豐95購01  ,0,0,0,0,0,0,0,0,0,62000,0,0,0,62000,0,62000,62000
05561P,大立光兆豐96售02,0,0,0,0,0,0,0,0,0,62000,0,0,0,80000,18000,62000,62000
050196,嘉聯益元大97購01,0,0,0,0,0,0,0,0,0,62000,0,0,0,72000,10000,62000,62000
03197P,台積電統一01售14,0,0,0,0,0,0,0,0,0,62000,0,0,0,62000,0,62000,62000
05527P,聯茂群益96售01  ,0,0,0,0,0,0,0,0,0,62000,0,0,0,62000,0,62000,62000
3004,豐達科          ,176000,114000,62000,0,0,0,0,0,0,0,0,0,0,0,0,0,62000
06988P,鴻海元富99售09  ,0,0,0,0,0,0,0,0,0,61000,0,0,0,61000,0,61000,61000
06640P,國巨兆豐99售02  ,0,0,0,0,0,0,0,0,0,61000,0,0,0,61000,0,61000,61000
058827,聯發科永豐9A購01,0,0,0,0,0,0,0,0,0,61000,0,0,0,503000,442000,61000,61000
05888P,友達元大97售01  ,0,0,0,0,0,0,0,0,0,61000,0,0,0,61000,0,61000,61000
051902,T50反1元大97購01,0,0,0,0,0,0,0,0,0,61000,0,0,0,61000,0,61000,61000
055986,祥碩元富97購01  ,0,0,0,0,0,0,0,0,0,61000,0,0,0,148000,87000,61000,61000
049129,S&P反1元大97購01,0,0,0,0,0,0,0,0,0,61000,0,0,0,62000,1000,61000,61000
056594,台積電元富98購03,0,0,0,0,0,0,0,0,0,61000,0,0,0,113000,52000,61000,61000
2413,環科            ,133000,75000,58000,0,0,0,0,0,0,3000,3000,0,3000,0,0,0,61000
058408,華通兆豐99購02  ,0,0,0,0,0,0,0,0,0,60000,0,0,0,60000,0,60000,60000
058237,嘉晶元大99購04  ,0,0,0,0,0,0,0,0,0,60000,0,0,0,72000,12000,60000,60000
058161,T50反1日盛03購01,0,0,0,0,0,0,0,0,0,60000,0,0,0,110000,50000,60000,60000
06623P,立積元大98售04  ,0,0,0,0,0,0,0,0,0,60000,0,0,0,85000,25000,60000,60000
06170P,禾伸堂元富97售02,0,0,0,0,0,0,0,0,0,60000,0,0,0,70000,10000,60000,60000
06981P,台灣50麥證99售02,0,0,0,60000,0,60000,0,0,0,60000,0,0,0,60000,0,60000,60000
050884,聯茂國泰96購01  ,0,0,0,0,0,0,0,0,0,60000,0,0,0,60000,0,60000,60000
05545P,台表科國泰98售01,0,0,0,0,0,0,0,0,0,60000,0,0,0,60000,0,60000,60000
049488,智邦元大95購01  ,0,0,0,0,0,0,0,0,0,60000,0,0,0,60000,0,60000,60000
04797P,華新科元大94售04,0,0,0,0,0,0,0,0,0,60000,0,0,0,60000,0,60000,60000
047962,T50反1中信96購02,0,0,0,0,0,0,0,0,0,60000,0,0,0,60000,0,60000,60000
04603P,訊芯凱基94售03  ,0,0,0,0,0,0,0,0,0,60000,0,0,0,60000,0,60000,60000
04687P,全新凱基94售02  ,0,0,0,0,0,0,0,0,0,60000,0,0,0,60000,0,60000,60000
04714P,上海銀元大94售01,0,0,0,0,0,0,0,0,0,60000,0,0,0,60000,0,60000,60000
048192,華通元大96購01  ,0,0,0,0,0,0,0,0,0,60000,0,0,0,60000,0,60000,60000
04462P,全新元富96售01  ,0,0,0,0,0,0,0,0,0,60000,0,0,0,60000,0,60000,60000
04845P,台積電凱基94售33,0,0,0,0,0,0,0,0,0,60000,0,0,0,60000,0,60000,60000
056604,鴻海富邦9A購01  ,0,0,0,0,0,0,0,0,0,60000,0,0,0,110000,50000,60000,60000
056573,華新科元大99購06,0,0,0,0,0,0,0,0,0,60000,0,0,0,70000,10000,60000,60000
056474,華新科元大99購05,0,0,0,0,0,0,0,0,0,60000,0,0,0,60000,0,60000,60000
056805,元石油統一9B購01,0,0,0,0,0,0,0,0,0,60000,0,0,0,60000,0,60000,60000
056756,T50反1元大98購06,0,0,0,0,0,0,0,0,0,60000,0,0,0,60000,0,60000,60000
054312,TPK凱基98購01   ,0,0,0,0,0,0,0,0,0,60000,0,0,0,60000,0,60000,60000
052696,玉晶光麥證97購01,0,0,0,60000,0,60000,0,0,0,60000,0,0,0,60000,0,60000,60000
057298,旭富永豐98購01  ,0,0,0,0,0,0,0,0,0,60000,0,0,0,72000,12000,60000,60000
057242,台郡凱基98購05  ,0,0,0,0,0,0,0,0,0,60000,0,0,0,60000,0,60000,60000
053719,可成凱基96購08  ,0,0,0,0,0,0,0,0,0,60000,0,0,0,60000,0,60000,60000
054658,道瓊銀元大9A購01,0,0,0,0,0,0,0,0,0,60000,0,0,0,60000,0,60000,60000
2612,中航            ,124000,64000,60000,0,0,0,0,0,0,0,0,0,0,0,0,0,60000
3607,谷崧            ,85000,28000,57000,0,0,0,0,0,0,3000,3000,0,3000,0,0,0,60000
6668,中揚光          ,489000,166000,323000,0,0,0,0,263000,-263000,0,0,0,0,0,0,0,60000
00666R,富邦恒生國企反1 ,0,0,0,0,0,0,0,0,0,59000,0,0,0,62000,3000,59000,59000
04723P,美律凱基94售06  ,0,0,0,0,0,0,0,0,0,59000,0,0,0,73000,14000,59000,59000
055911,可成凱基98購02  ,0,0,0,0,0,0,0,0,0,59000,0,0,0,59000,0,59000,59000
057049,新日興元大98購02,0,0,0,0,0,0,0,0,0,59000,0,0,0,69000,10000,59000,59000
052647,晶技永豐97購01  ,0,0,0,0,0,0,0,0,0,59000,0,0,0,59000,0,59000,59000
07034P,大立光元富99售03,0,0,0,0,0,0,0,0,0,58000,0,0,0,80000,22000,58000,58000
06240P,奇力新元富97售03,0,0,0,0,0,0,0,0,0,58000,0,0,0,58000,0,58000,58000
05772P,景碩凱基96售02  ,0,0,0,0,0,0,0,0,0,58000,0,0,0,58000,0,58000,58000
050429,漢唐凱基94購04  ,0,0,0,0,0,0,0,0,0,58000,0,0,0,68000,10000,58000,58000
6168,宏齊            ,149000,96000,53000,0,0,0,0,0,0,5000,6000,1000,5000,0,0,0,58000
06312P,樺漢元富97售02  ,0,0,0,0,0,0,0,0,0,57000,0,0,0,57000,0,57000,57000
1514,亞力            ,476000,419000,57000,0,0,0,0,0,0,0,0,0,0,0,0,0,57000
04696P,亞德客國泰95售02,0,0,0,0,0,0,0,0,0,57000,0,0,0,321000,264000,57000,57000
05458P,台積電凱基97售02,0,0,0,0,0,0,0,0,0,57000,0,0,0,108000,51000,57000,57000
08671P,友訊國票01售01  ,0,0,0,0,0,0,0,0,0,56000,0,0,0,56000,0,56000,56000
06734P,智邦凱基98售05  ,0,0,0,0,0,0,0,0,0,56000,0,0,0,112000,56000,56000,56000
06571P,欣興永豐98售03  ,0,0,0,0,0,0,0,0,0,56000,0,0,0,61000,5000,56000,56000
06201P,可成元大97售01  ,0,0,0,0,0,0,0,0,0,56000,0,0,0,91000,35000,56000,56000
058385,創意中信99購01  ,0,0,0,0,0,0,0,0,0,56000,0,0,0,423000,367000,56000,56000
055718,可成元大97購02  ,0,0,0,0,0,0,0,0,0,56000,0,0,0,66000,10000,56000,56000
055582,亞德客元大97購01,0,0,0,0,0,0,0,0,0,56000,0,0,0,68000,12000,56000,56000
056396,祥碩永豐98購01  ,0,0,0,0,0,0,0,0,0,56000,0,0,0,127000,71000,56000,56000
057896,嘉晶元富98購01  ,0,0,0,0,0,0,0,0,0,55000,0,0,0,65000,10000,55000,55000
057912,美律日盛99購01  ,0,0,0,0,0,0,0,0,0,55000,0,0,0,55000,0,55000,55000
05791P,臺股指中信99售06,0,0,0,0,0,0,0,0,0,55000,0,0,0,55000,0,55000,55000
06194P,台積電元富97售05,0,0,0,0,0,0,0,0,0,55000,0,0,0,118000,63000,55000,55000
06730P,祥碩元大98售07  ,0,0,0,0,0,0,0,0,0,55000,0,0,0,514000,459000,55000,55000
055650,華新科元富98購01,0,0,0,0,0,0,0,0,0,55000,0,0,0,55000,0,55000,55000
051786,A50正2國票95購02,0,0,0,0,0,0,0,0,0,55000,0,0,0,55000,0,55000,55000
050215,TPK台新96購01   ,0,0,0,0,0,0,0,0,0,55000,0,0,0,55000,0,55000,55000
04682P,臺股指統一96售01,0,0,0,0,0,0,0,0,0,55000,0,0,0,55000,0,55000,55000
03433B,臺股指元大9C熊01,0,0,0,0,0,0,0,0,0,55000,0,0,0,75000,20000,55000,55000
04028P,燿華凱基94售02  ,0,0,0,0,0,0,0,0,0,55000,0,0,0,55000,0,55000,55000
056443,南亞科凱基98購03,0,0,0,0,0,0,0,0,0,55000,0,0,0,60000,5000,55000,55000
05369P,可成元富95售04  ,0,0,0,0,0,0,0,0,0,55000,0,0,0,55000,0,55000,55000
057252,牧德元富98購01  ,0,0,0,0,0,0,0,0,0,55000,0,0,0,55000,0,55000,55000
6112,聚碩            ,185000,111000,74000,0,0,0,0,0,0,-19000,4000,23000,-19000,0,0,0,55000
2062,橋椿            ,118000,63000,55000,0,0,0,0,0,0,0,0,0,0,0,0,0,55000
6282,康舒            ,1309000,1281000,28000,0,0,0,0,0,0,27000,63000,15000,48000,1000,22000,-21000,55000
06880P,鈺齊凱基98售03  ,0,0,0,0,0,0,0,0,0,54000,0,0,0,54000,0,54000,54000
06858P,道瓊指中信9B售01,0,0,0,0,0,0,0,0,0,54000,0,0,0,54000,0,54000,54000
07020P,玉晶光台新99售02,0,0,0,0,0,0,0,0,0,54000,0,0,0,3168000,3114000,54000,54000
06019P,緯穎凱基96售03  ,0,0,0,0,0,0,0,0,0,54000,0,0,0,105000,51000,54000,54000
05847P,大立光元大96售08,0,0,0,0,0,0,0,0,0,54000,0,0,0,54000,0,54000,54000
05885P,牧德統一96售01  ,0,0,0,0,0,0,0,0,0,54000,0,0,0,54000,0,54000,54000
058845,元油2X群益9C購04,0,0,0,0,0,0,0,0,0,54000,0,0,0,54000,0,54000,54000
04287P,A50正2中信96售01,0,0,0,0,0,0,0,0,0,54000,0,0,0,77000,23000,54000,54000
04392P,牧德凱基94售05  ,0,0,0,0,0,0,0,0,0,54000,0,0,0,60000,6000,54000,54000
056938,泰碩元富98購01  ,0,0,0,0,0,0,0,0,0,54000,0,0,0,64000,10000,54000,54000
4912,聯德控股-KY     ,73000,19000,54000,0,0,0,0,0,0,0,1000,1000,0,0,0,0,54000
05773P,臺股指凱基99售03,0,0,0,0,0,0,0,0,0,53000,0,0,0,53000,0,53000,53000
06961P,台積電凱基99售05,0,0,0,0,0,0,0,0,0,53000,0,0,0,60000,7000,53000,53000
04230P,臺股指中信95售06,0,0,0,0,0,0,0,0,0,53000,0,0,0,53000,0,53000,53000
055697,牧德國票98購01  ,0,0,0,0,0,0,0,0,0,53000,0,0,0,53000,0,53000,53000
053668,鴻海統一97購01  ,0,0,0,0,0,0,0,0,0,53000,0,0,0,113000,60000,53000,53000
056833,和大元富9B購01  ,0,0,0,0,0,0,0,0,0,53000,0,0,0,60000,7000,53000,53000
05323P,瑞昱凱基96售02  ,0,0,0,0,0,0,0,0,0,53000,0,0,0,93000,40000,53000,53000
4566,時碩工業        ,102000,49000,53000,0,0,0,0,0,0,0,0,0,0,0,0,0,53000
5285,界霖            ,70000,19000,51000,0,0,0,0,0,0,2000,2000,0,2000,0,0,0,53000
3003,健和興          ,343000,284000,59000,0,0,0,0,0,0,-6000,3000,9000,-6000,0,0,0,53000
06959P,鴻海凱基9A售02  ,0,0,0,0,0,0,0,0,0,52000,0,0,0,52000,0,52000,52000
07022P,嘉晶永豐99售02  ,0,0,0,0,0,0,0,0,0,52000,0,0,0,110000,58000,52000,52000
06128P,玉晶光元富97售05,0,0,0,0,0,0,0,0,0,52000,0,0,0,52000,0,52000,52000
06539P,聯發科凱基98售12,0,0,0,0,0,0,0,0,0,52000,0,0,0,52000,0,52000,52000
06262P,國巨凱基97售07  ,0,0,0,0,0,0,0,0,0,52000,0,0,0,102000,50000,52000,52000
06459P,亞德客元富98售01,0,0,0,0,0,0,0,0,0,52000,0,0,0,52000,0,52000,52000
03860P,群創元富97售01  ,0,0,0,0,0,0,0,0,0,52000,0,0,0,52000,0,52000,52000
05618P,聯發科元富96售02,0,0,0,0,0,0,0,0,0,52000,0,0,0,129000,77000,52000,52000
057116,鴻海日盛9A購01  ,0,0,0,0,0,0,0,0,0,52000,0,0,0,53000,1000,52000,52000
057232,京元電凱基98購02,0,0,0,0,0,0,0,0,0,52000,0,0,0,92000,40000,52000,52000
06508P,台灣50統一98售01,0,0,0,0,0,0,0,0,0,51000,0,0,0,66000,15000,51000,51000
06725P,聯電元富98售01  ,0,0,0,0,0,0,0,0,0,51000,0,0,0,51000,0,51000,51000
1786,科妍            ,104000,57000,47000,0,0,0,0,0,0,4000,7000,3000,4000,0,0,0,51000
057942,可成國票99購02  ,0,0,0,0,0,0,0,0,0,51000,0,0,0,51000,0,51000,51000
058956,健策國票9A購02  ,0,0,0,0,0,0,0,0,0,51000,0,0,0,51000,0,51000,51000
05023P,和碩凱基95售01  ,0,0,0,0,0,0,0,0,0,51000,0,0,0,51000,0,51000,51000
05159P,聯發科永豐95售04,0,0,0,0,0,0,0,0,0,51000,0,0,0,145000,94000,51000,51000
05104P,智邦台新95售02  ,0,0,0,0,0,0,0,0,0,51000,0,0,0,111000,60000,51000,51000
056930,晶豪科台新98購01,0,0,0,0,0,0,0,0,0,51000,0,0,0,51000,0,51000,51000
05486P,大立光凱基95售14,0,0,0,0,0,0,0,0,0,51000,0,0,0,64000,13000,51000,51000
056312,茂林元大98購01  ,0,0,0,0,0,0,0,0,0,51000,0,0,0,77000,26000,51000,51000
2374,佳能            ,92000,49000,43000,0,0,0,0,0,0,8000,8000,0,8000,0,0,0,51000
8114,振樺電          ,93000,44000,49000,0,0,0,0,0,0,2000,2000,0,2000,0,0,0,51000
058969,亞德客永豐99購01,0,0,0,0,0,0,0,0,0,50000,0,0,0,77000,27000,50000,50000
058858,元油2X凱基9A購07,0,0,0,0,0,0,0,0,0,50000,0,0,0,50000,0,50000,50000
058722,台郡元富99購01  ,0,0,0,0,0,0,0,0,0,50000,0,0,0,50000,0,50000,50000
058458,牧德永豐9A購01  ,0,0,0,0,0,0,0,0,0,50000,0,0,0,50000,0,50000,50000
057985,華通元富02購03  ,0,0,0,0,0,0,0,0,0,50000,0,0,0,50000,0,50000,50000
057894,華通元富02購02  ,0,0,0,0,0,0,0,0,0,50000,0,0,0,50000,0,50000,50000
058110,光寶科元富98購01,0,0,0,0,0,0,0,0,0,50000,0,0,0,50000,0,50000,50000
058070,華新科凱基98購07,0,0,0,0,0,0,0,0,0,50000,0,0,0,50000,0,50000,50000
057737,國巨富邦99購02  ,50000,0,50000,0,0,0,0,0,0,0,0,0,0,0,0,0,50000
057718,旺宏元富02購02  ,0,0,0,0,0,0,0,0,0,50000,0,0,0,50000,0,50000,50000
1537,廣隆            ,100000,50000,50000,0,0,0,0,0,0,0,2000,2000,0,0,0,0,50000
1340,勝悅-KY         ,85000,35000,50000,0,0,0,0,0,0,0,0,0,0,0,0,0,50000
06773P,台灣50兆豐9A售01,0,0,0,0,0,0,0,0,0,50000,0,0,0,50000,0,50000,50000
06873P,嘉晶元富98售02  ,0,0,0,0,0,0,0,0,0,50000,0,0,0,50000,0,50000,50000
06989P,鴻海元富99售10  ,0,0,0,0,0,0,0,0,0,50000,0,0,0,50000,0,50000,50000
06993P,鴻海凱基99售05  ,0,0,0,0,0,0,0,0,0,50000,0,0,0,230000,180000,50000,50000
06382P,大毅元富97售02  ,0,0,0,0,0,0,0,0,0,50000,0,0,0,50000,0,50000,50000
06057P,大立光凱基98售01,0,0,0,0,0,0,0,0,0,50000,0,0,0,50000,0,50000,50000
051113,聯電元富95購01  ,0,0,0,0,0,0,0,0,0,50000,0,0,0,50000,0,50000,50000
052079,康友元富98購01  ,0,0,0,0,0,0,0,0,0,50000,0,0,0,50000,0,50000,50000
049797,台積電元大94購17,0,0,0,0,0,0,0,0,0,50000,0,0,0,50000,0,50000,50000
05004P,健策統一95售01  ,0,0,0,0,0,0,0,0,0,50000,0,0,0,60000,10000,50000,50000
049313,晶技凱基94購01  ,0,0,0,0,0,0,0,0,0,50000,0,0,0,50000,0,50000,50000
055858,聯茂元大97購03  ,0,0,0,0,0,0,0,0,0,50000,0,0,0,60000,10000,50000,50000
050900,台郡元大95購02  ,0,0,0,0,0,0,0,0,0,50000,0,0,0,50000,0,50000,50000
050227,大立光中信96購01,0,0,0,0,0,0,0,0,0,50000,0,0,0,50000,0,50000,50000
051903,T50反1元大97購02,0,0,0,0,0,0,0,0,0,50000,0,0,0,50000,0,50000,50000
051833,昇陽半元大96購01,0,0,0,0,0,0,0,0,0,50000,0,0,0,50000,0,50000,50000
046884,元油反群益95購01,0,0,0,0,0,0,0,0,0,50000,0,0,0,50000,0,50000,50000
04875P,台積電中信94售04,0,0,0,0,0,0,0,0,0,50000,0,0,0,50000,0,50000,50000
047693,T50反1國票95購01,0,0,0,0,0,0,0,0,0,50000,0,0,0,50000,0,50000,50000
047989,深中小元大96購02,0,0,0,0,0,0,0,0,0,50000,0,0,0,80000,30000,50000,50000
048131,全新國票94購02  ,0,0,0,0,0,0,0,0,0,50000,0,0,0,50000,0,50000,50000
041427,滬深2X國票93購01,0,0,0,0,0,0,0,0,0,50000,0,0,0,50000,0,50000,50000
048572,美利達元大96購04,0,0,0,0,0,0,0,0,0,50000,0,0,0,140000,90000,50000,50000
044216,華新科凱基93購02,0,0,0,0,0,0,0,0,0,50000,0,0,0,50000,0,50000,50000
05316P,台積電永昌96售06,0,0,0,0,0,0,0,0,0,50000,0,0,0,70000,20000,50000,50000
055729,金寶元富99購01  ,0,0,0,0,0,0,0,0,0,50000,0,0,0,50000,0,50000,50000
052580,高鐵元富96購01  ,0,0,0,0,0,0,0,0,0,50000,0,0,0,50000,0,50000,50000
053183,大立光元富96購03,0,0,0,0,0,0,0,0,0,50000,0,0,0,100000,50000,50000,50000
05675P,美律群益97售01  ,0,0,0,0,0,0,0,0,0,50000,0,0,0,50000,0,50000,50000
052741,聯發科元大96購08,0,0,0,0,0,0,0,0,0,50000,0,0,0,50000,0,50000,50000
054367,鴻海中信98購03  ,70000,0,70000,0,0,0,0,0,0,-20000,0,0,0,0,20000,-20000,50000
05499P,聯詠元富95售02  ,0,0,0,0,0,0,0,0,0,50000,0,0,0,50000,0,50000,50000
054559,台光電群益99購01,0,0,0,0,0,0,0,0,0,50000,0,0,0,110000,60000,50000,50000
056151,建準凱基97購01  ,0,0,0,0,0,0,0,0,0,50000,0,0,0,50000,0,50000,50000
053456,大立光元富96購04,0,0,0,0,0,0,0,0,0,50000,0,0,0,50000,0,50000,50000
05410P,聯發科元富95售04,0,0,0,0,0,0,0,0,0,50000,0,0,0,50000,0,50000,50000
05404P,台積電群益95售06,0,0,0,0,0,0,0,0,0,50000,0,0,0,50000,0,50000,50000
05363P,臺股指富邦95售03,0,0,0,0,0,0,0,0,0,50000,0,0,0,50000,0,50000,50000
055089,金寶群益98購01  ,0,0,0,0,0,0,0,0,0,50000,0,0,0,50000,0,50000,50000
05519P,上証2X凱基98售01,0,0,0,0,0,0,0,0,0,50000,0,0,0,50000,0,50000,50000
05723P,華通永豐96售03  ,0,0,0,0,0,0,0,0,0,50000,0,0,0,50000,0,50000,50000
057377,康控元大99購02  ,0,0,0,0,0,0,0,0,0,50000,0,0,0,50000,0,50000,50000
057194,南電元大98購01  ,0,0,0,0,0,0,0,0,0,50000,0,0,0,55000,5000,50000,50000
05714P,群創統一97售03  ,0,0,0,0,0,0,0,0,0,50000,0,0,0,50000,0,50000,50000
2013,中鋼構          ,104000,54000,50000,0,0,0,0,0,0,0,0,0,0,0,0,0,50000
06026P,華通台新97售01  ,0,0,0,0,0,0,0,0,0,49000,0,0,0,49000,0,49000,49000
05980P,台積電永昌96售09,0,0,0,0,0,0,0,0,0,49000,0,0,0,49000,0,49000,49000
06470P,臺股指凱基99售10,0,0,0,0,0,0,0,0,0,49000,0,0,0,49000,0,49000,49000
07071P,立積元富99售01  ,0,0,0,0,0,0,0,0,0,49000,0,0,0,49000,0,49000,49000
06901P,亞德客凱基98售02,0,0,0,0,0,0,0,0,0,49000,0,0,0,151000,102000,49000,49000
1337,再生-KY         ,80000,29000,51000,0,0,0,0,0,0,-2000,1000,3000,-2000,0,0,0,49000
057821,晶相光元大98購03,0,0,0,0,0,0,0,0,0,49000,0,0,0,65000,16000,49000,49000
057487,聯發科元大98購10,0,0,0,0,0,0,0,0,0,49000,0,0,0,254000,205000,49000,49000
04313P,國巨元富95售03  ,0,0,0,0,0,0,0,0,0,49000,0,0,0,54000,5000,49000,49000
055790,南電凱基97購01  ,0,0,0,0,0,0,0,0,0,49000,0,0,0,59000,10000,49000,49000
2702,華園            ,79000,30000,49000,0,0,0,0,0,0,0,0,0,0,0,0,0,49000
058925,旭富元富99購02  ,0,0,0,0,0,0,0,0,0,48000,0,0,0,48000,0,48000,48000
05617P,大立光統一97售02,0,0,0,0,0,0,0,0,0,48000,0,0,0,48000,0,48000,48000
057300,訊連永豐98購01  ,0,0,0,0,0,0,0,0,0,48000,0,0,0,68000,20000,48000,48000
055021,亞德客國泰98購01,0,0,0,0,0,0,0,0,0,48000,0,0,0,128000,80000,48000,48000
05691P,聯發科中信98售01,0,0,0,0,0,0,0,0,0,48000,0,0,0,62000,14000,48000,48000
2009,第一銅          ,80000,34000,46000,0,0,0,0,0,0,2000,2000,0,2000,0,0,0,48000
4148,全宇生技-KY     ,58000,15000,43000,0,0,0,0,0,0,5000,5000,0,5000,0,0,0,48000
1321,大洋            ,80000,33000,47000,0,0,0,0,0,0,0,0,0,0,0,0,0,47000
06979P,台灣50永豐9A售02,0,0,0,0,0,0,0,0,0,47000,0,0,0,47000,0,47000,47000
06581P,南亞科凱基98售04,0,0,0,0,0,0,0,0,0,47000,0,0,0,51000,4000,47000,47000
04843P,致新元大94售02  ,0,0,0,0,0,0,0,0,0,47000,0,0,0,50000,3000,47000,47000
050548,華固凱基95購01  ,0,0,0,0,0,0,0,0,0,47000,0,0,0,181000,134000,47000,47000
056507,創意永豐98購02  ,0,0,0,0,0,0,0,0,0,47000,0,0,0,232000,185000,47000,47000
6414,樺漢            ,484000,445324,38676,0,0,0,0,0,0,8000,121000,109000,12000,2000,6000,-4000,46676
1526,日馳            ,121000,75000,46000,0,0,0,0,0,0,0,0,0,0,0,0,0,46000
057442,玉晶光統一98購03,0,0,0,0,0,0,0,0,0,46000,0,0,0,46000,0,46000,46000
057802,卜蜂元大98購01  ,0,0,0,0,0,0,0,0,0,46000,0,0,0,60000,14000,46000,46000
04177P,富邦金元大94售01,0,0,0,0,0,0,0,0,0,46000,0,0,0,47000,1000,46000,46000
055409,元黃金富邦01購01,0,0,0,0,0,0,0,0,0,46000,0,0,0,78000,32000,46000,46000
052822,泰碩永豐97購01  ,0,0,0,0,0,0,0,0,0,46000,0,0,0,46000,0,46000,46000
054963,牧德元大97購02  ,0,0,0,0,0,0,0,0,0,46000,0,0,0,46000,0,46000,46000
054670,康友元富97購01  ,0,0,0,0,0,0,0,0,0,46000,0,0,0,46000,0,46000,46000
8103,瀚荃            ,50000,6000,44000,0,0,0,0,0,0,2000,2000,0,2000,0,0,0,46000
058103,台積電永豐98購06,0,0,0,0,0,0,0,0,0,45000,0,0,0,160000,115000,45000,45000
058663,瑞儀兆豐9A購01  ,0,0,0,0,0,0,0,0,0,45000,0,0,0,1132000,1087000,45000,45000
06998P,S&P正2中信9B售01,0,0,0,0,0,0,0,0,0,45000,0,0,0,45000,0,45000,45000
06868P,電子類元大99售01,0,0,0,0,0,0,0,0,0,45000,0,0,0,93000,48000,45000,45000
06844P,智邦元大98售13  ,0,0,0,0,0,0,0,0,0,45000,0,0,0,78000,33000,45000,45000
04168P,元金2X凱基99售01,0,0,0,0,0,0,0,0,0,45000,0,0,0,45000,0,45000,45000
04471P,華通元大95售03  ,0,0,0,0,0,0,0,0,0,45000,0,0,0,115000,70000,45000,45000
00757,統一FANG+       ,0,0,0,0,0,0,0,0,0,45000,0,0,0,245000,200000,45000,45000
04493P,漢唐永豐94售01  ,0,0,0,0,0,0,0,0,0,45000,0,0,0,45000,0,45000,45000
051347,國巨元大95購06  ,0,0,0,0,0,0,0,0,0,45000,0,0,0,55000,10000,45000,45000
054749,聯茂凱基98購01  ,0,0,0,0,0,0,0,0,0,45000,0,0,0,45000,0,45000,45000
054554,大立光凱基98購02,0,0,0,0,0,0,0,0,0,45000,0,0,0,80000,35000,45000,45000
054535,旺宏富邦97購02  ,0,0,0,0,0,0,0,0,0,45000,0,0,0,50000,5000,45000,45000
055358,臻鼎凱基97購01  ,0,0,0,0,0,0,0,0,0,45000,0,0,0,100000,55000,45000,45000
055019,福懋科元富97購01,0,0,0,0,0,0,0,0,0,45000,0,0,0,45000,0,45000,45000
057171,台光電元大9B購01,0,0,0,0,0,0,0,0,0,45000,0,0,0,140000,95000,45000,45000
053305,聯詠凱基96購02  ,0,0,0,0,0,0,0,0,0,45000,0,0,0,60000,15000,45000,45000
056482,貿聯元大99購01  ,0,0,0,0,0,0,0,0,0,45000,0,0,0,45000,0,45000,45000
06615P,鴻海元大9C售02  ,0,0,0,0,0,0,0,0,0,44000,0,0,0,154000,110000,44000,44000
06373P,聯發科元大97售22,0,0,0,0,0,0,0,0,0,44000,0,0,0,64000,20000,44000,44000
06102P,智邦凱基97售03  ,0,0,0,0,0,0,0,0,0,44000,0,0,0,60000,16000,44000,44000
06198P,台積電元大98售06,0,0,0,0,0,0,0,0,0,44000,0,0,0,44000,0,44000,44000
055457,聚陽永豐97購01  ,0,0,0,0,0,0,0,0,0,44000,0,0,0,44000,0,44000,44000
05544P,台表科元富96售01,0,0,0,0,0,0,0,0,0,44000,0,0,0,44000,0,44000,44000
050484,世紀鋼國票95購02,0,0,0,0,0,0,0,0,0,44000,0,0,0,70000,26000,44000,44000
047408,嘉晶統一95購01  ,0,0,0,0,0,0,0,0,0,44000,0,0,0,44000,0,44000,44000
04272P,元上證凱基94售01,0,0,0,0,0,0,0,0,0,44000,0,0,0,44000,0,44000,44000
04165P,南亞科元富95售03,0,0,0,0,0,0,0,0,0,44000,0,0,0,55000,11000,44000,44000
053482,矽力元大96購03  ,0,0,0,0,0,0,0,0,0,44000,0,0,0,44000,0,44000,44000
8104,錸寶            ,99000,57000,42000,0,0,0,0,0,0,2000,2000,0,2000,0,0,0,44000
4968,立積            ,1365000,1319000,46000,0,0,0,0,0,0,-2000,0,0,0,19000,21000,-2000,44000
2429,銘旺科          ,70000,26000,44000,0,0,0,0,0,0,0,0,0,0,0,0,0,44000
2527,宏璟            ,61000,25000,36000,0,0,0,0,0,0,8000,9000,1000,8000,0,0,0,44000
06130P,玉晶光元富97售07,0,0,0,0,0,0,0,0,0,43000,0,0,0,43000,0,43000,43000
06093P,華通元富97售03  ,0,0,0,0,0,0,0,0,0,43000,0,0,0,43000,0,43000,43000
1592,英瑞-KY         ,87000,44000,43000,0,0,0,0,0,0,0,0,0,0,0,0,0,43000
1446,宏和            ,93000,50000,43000,0,0,0,0,0,0,0,1000,1000,0,0,0,0,43000
057879,電子類元大99購02,0,0,0,0,0,0,0,0,0,43000,0,0,0,60000,17000,43000,43000
058243,華擎元大99購01  ,0,0,0,0,0,0,0,0,0,43000,0,0,0,43000,0,43000,43000
05764P,世紀鋼永豐96售03,0,0,0,0,0,0,0,0,0,43000,0,0,0,43000,0,43000,43000
00702,國泰標普低波高息,0,0,0,0,0,0,0,0,0,43000,0,0,0,56000,13000,43000,43000
04759P,台積電凱基94售27,0,0,0,0,0,0,0,0,0,43000,0,0,0,43000,0,43000,43000
04496P,國巨國泰96售02  ,0,0,0,0,0,0,0,0,0,43000,0,0,0,43000,0,43000,43000
051660,緯穎國泰96購02  ,0,0,0,0,0,0,0,0,0,43000,0,0,0,55000,12000,43000,43000
05375P,健策國票96售02  ,0,0,0,0,0,0,0,0,0,43000,0,0,0,43000,0,43000,43000
05272P,臻鼎中信97售03  ,0,0,0,0,0,0,0,0,0,43000,0,0,0,95000,52000,43000,43000
2420,新巨            ,96000,61000,35000,0,0,0,0,0,0,8000,8000,0,8000,0,0,0,43000
3094,聯傑            ,131000,90000,41000,0,0,0,0,0,0,2000,2000,0,2000,0,0,0,43000
6715,嘉基            ,69000,26000,43000,0,0,0,0,0,0,0,0,0,0,0,0,0,43000
057446,旺宏元富02購01  ,0,0,0,0,0,0,0,0,0,42000,0,0,0,47000,5000,42000,42000
1732,毛寶            ,10000,0,10000,0,0,0,0,0,0,32000,0,0,0,32000,0,32000,42000
1608,華榮            ,197000,158000,39000,0,0,0,0,0,0,3000,4000,1000,3000,0,0,0,42000
055476,台郡凱基97購02  ,0,0,0,0,0,0,0,0,0,42000,0,0,0,67000,25000,42000,42000
050594,康友永豐94購01  ,0,0,0,0,0,0,0,0,0,42000,0,0,0,49000,7000,42000,42000
052080,康友元富98購02  ,0,0,0,0,0,0,0,0,0,42000,0,0,0,42000,0,42000,42000
006205,富邦上証        ,30000,426000,-396000,0,0,0,0,0,0,438000,30000,30000,0,2168000,1730000,438000,42000
042501,台灣50凱基96購06,0,0,0,0,0,0,0,0,0,42000,0,0,0,42000,0,42000,42000
04844P,京元電亞東94售01,0,0,0,0,0,0,0,0,0,42000,0,0,0,42000,0,42000,42000
056767,大毅元大99購01  ,0,0,0,0,0,0,0,0,0,42000,0,0,0,42000,0,42000,42000
053844,GIS統一96購01   ,0,0,0,0,0,0,0,0,0,42000,0,0,0,42000,0,42000,42000
053528,南電中信9A購01  ,0,0,0,0,0,0,0,0,0,42000,0,0,0,42000,0,42000,42000
3047,訊舟            ,106000,69000,37000,0,0,0,0,0,0,5000,5000,0,5000,0,0,0,42000
2464,盟立            ,240000,205000,35000,0,0,0,0,0,0,7000,8000,1000,7000,0,0,0,42000
06733P,鴻海凱基99售02  ,0,0,0,0,0,0,0,0,0,41000,0,0,0,226000,185000,41000,41000
06749P,技嘉元富98售03  ,0,0,0,0,0,0,0,0,0,41000,0,0,0,41000,0,41000,41000
06189P,華新科永豐97售03,0,0,0,0,0,0,0,0,0,41000,0,0,0,46000,5000,41000,41000
06409P,康友元富97售03  ,0,0,0,0,0,0,0,0,0,41000,0,0,0,41000,0,41000,41000
06217P,鴻海元富97售05  ,0,0,0,0,0,0,0,0,0,41000,0,0,0,41000,0,41000,41000
04549P,茂林元大94售02  ,0,0,0,0,0,0,0,0,0,41000,0,0,0,91000,50000,41000,41000
047383,鴻海元大95購01  ,0,0,0,0,0,0,0,0,0,41000,0,0,0,280000,239000,41000,41000
048985,茂林元大94購01  ,0,0,0,0,0,0,0,0,0,41000,0,0,0,41000,0,41000,41000
05348P,美律元富98售01  ,0,0,0,0,0,0,0,0,0,41000,0,0,0,41000,0,41000,41000
057140,宏達電兆豐98購01,0,0,0,0,0,0,0,0,0,41000,0,0,0,41000,0,41000,41000
05683P,矽創元大96售01  ,0,0,0,0,0,0,0,0,0,41000,0,0,0,45000,4000,41000,41000
054282,泰鼎群益98購02  ,0,0,0,0,0,0,0,0,0,41000,0,0,0,41000,0,41000,41000
06296P,燿華元大98售01  ,0,0,0,0,0,0,0,0,0,40000,0,0,0,40000,0,40000,40000
06403P,鴻海元富97售15  ,0,0,0,0,0,0,0,0,0,40000,0,0,0,40000,0,40000,40000
06407P,創意元富97售02  ,0,0,0,0,0,0,0,0,0,40000,0,0,0,40000,0,40000,40000
06190P,玉晶光永豐97售05,0,0,0,0,0,0,0,0,0,40000,0,0,0,40000,0,40000,40000
06160P,台達電群益97售01,0,0,0,0,0,0,0,0,0,40000,0,0,0,43000,3000,40000,40000
06084P,宏達電元富97售02,0,0,0,0,0,0,0,0,0,40000,0,0,0,41000,1000,40000,40000
06759P,台積電元大98售17,0,0,0,0,0,0,0,0,0,40000,0,0,0,50000,10000,40000,40000
06990P,康友元富99售03  ,0,0,0,0,0,0,0,0,0,40000,0,0,0,40000,0,40000,40000
1598,岱宇            ,62000,28000,34000,0,0,0,0,0,0,6000,7000,1000,6000,0,0,0,40000
057525,光磊元大99購01  ,0,0,0,0,0,0,0,0,0,40000,0,0,0,100000,60000,40000,40000
057600,大立光群益99購03,0,0,0,0,0,0,0,0,0,40000,0,0,0,40000,0,40000,40000
058143,瑞儀元大99購02  ,0,0,0,0,0,0,0,0,0,40000,0,0,0,101000,61000,40000,40000
058177,華新科凱基99購02,0,0,0,0,0,0,0,0,0,40000,0,0,0,40000,0,40000,40000
058585,S&P正2中信9B購02,0,0,0,0,0,0,0,0,0,40000,0,0,0,40000,0,40000,40000
048996,中環第一94購01  ,0,0,0,0,0,0,0,0,0,40000,0,0,0,40000,0,40000,40000
04900P,矽格中信94售02  ,0,0,0,0,0,0,0,0,0,40000,0,0,0,40000,0,40000,40000
049058,茂林永豐94購02  ,0,0,0,0,0,0,0,0,0,40000,0,0,0,40000,0,40000,40000
05229P,台積電群益95售05,0,0,0,0,0,0,0,0,0,40000,0,0,0,75000,35000,40000,40000
052323,矽力元大95購04  ,0,0,0,0,0,0,0,0,0,40000,0,0,0,40000,0,40000,40000
052292,緯穎元富95購02  ,0,0,0,0,0,0,0,0,0,40000,0,0,0,40000,0,40000,40000
049170,亞德客凱基94購01,0,0,0,0,0,0,0,0,0,40000,0,0,0,40000,0,40000,40000
055908,GIS日盛97購01   ,0,0,0,0,0,0,0,0,0,40000,0,0,0,40000,0,40000,40000
056038,可成凱基97購01  ,0,0,0,0,0,0,0,0,0,40000,0,0,0,40000,0,40000,40000
052134,智邦凱基95購09  ,0,0,0,0,0,0,0,0,0,40000,0,0,0,60000,20000,40000,40000
051168,訊連元大95購02  ,0,0,0,0,0,0,0,0,0,40000,0,0,0,40000,0,40000,40000
05176P,台積電凱基95售11,0,0,0,0,0,0,0,0,0,40000,0,0,0,40000,0,40000,40000
051946,健策統一98購01  ,0,0,0,0,0,0,0,0,0,40000,0,0,0,40000,0,40000,40000
050525,嘉晶元大95購02  ,0,0,0,0,0,0,0,0,0,40000,0,0,0,40000,0,40000,40000
050381,鴻海兆豐94購01  ,0,0,0,0,0,0,0,0,0,40000,0,0,0,50000,10000,40000,40000
048058,大立光國泰95購01,0,0,0,0,0,0,0,0,0,40000,0,0,0,190000,150000,40000,40000
048273,南電富邦97購01  ,0,0,0,0,0,0,0,0,0,40000,0,0,0,50000,10000,40000,40000
048306,A50反1凱基93購01,0,0,0,0,0,0,0,0,0,40000,0,0,0,40000,0,40000,40000
04144P,瑞昱凱基93售10  ,0,0,0,0,0,0,0,0,0,40000,0,0,0,40000,0,40000,40000
03103P,聯發科元富01售02,0,0,0,0,0,0,0,0,0,40000,0,0,0,40000,0,40000,40000
03428P,台積電元大02售28,0,0,0,0,0,0,0,0,0,40000,0,0,0,40000,0,40000,40000
048189,臺指反元大96購06,0,0,0,0,0,0,0,0,0,40000,0,0,0,40000,0,40000,40000
055310,聯詠群益97購02  ,0,0,0,0,0,0,0,0,0,40000,0,0,0,40000,0,40000,40000
053148,華邦電元大96購01,0,0,0,0,0,0,0,0,0,40000,0,0,0,40000,0,40000,40000
05647P,聯發科國票97售02,0,0,0,0,0,0,0,0,0,40000,0,0,0,40000,0,40000,40000
056476,智原元大98購02  ,0,0,0,0,0,0,0,0,0,40000,0,0,0,80000,40000,40000,40000
05643P,大立光中信98售01,0,0,0,0,0,0,0,0,0,40000,0,0,0,60000,20000,40000,40000
056460,同欣電凱基99購01,0,0,0,0,0,0,0,0,0,40000,0,0,0,40000,0,40000,40000
056639,國產康和98購01  ,0,0,0,0,0,0,0,0,0,40000,0,0,0,100000,60000,40000,40000
056617,美律永豐98購01  ,0,0,0,0,0,0,0,0,0,40000,0,0,0,44000,4000,40000,40000
05619P,創意元富96售02  ,0,0,0,0,0,0,0,0,0,40000,0,0,0,40000,0,40000,40000
056414,國巨中信98購02  ,0,0,0,0,0,0,0,0,0,40000,0,0,0,40000,0,40000,40000
056836,國巨元富98購01  ,0,0,0,0,0,0,0,0,0,40000,0,0,0,50000,10000,40000,40000
052658,友達元富9C購01  ,0,0,0,0,0,0,0,0,0,40000,0,0,0,40000,0,40000,40000
053459,康控國泰97購01  ,0,0,0,0,0,0,0,0,0,40000,0,0,0,40000,0,40000,40000
054939,台積電元大97購15,0,0,0,0,0,0,0,0,0,40000,0,0,0,40000,0,40000,40000
2616,山隆            ,61000,21000,40000,0,0,0,0,0,0,0,0,0,0,0,0,0,40000
3022,威強電          ,40000,0,40000,0,0,0,0,0,0,0,0,0,0,0,0,0,40000
3312,弘憶股          ,203000,163000,40000,0,0,0,0,0,0,0,0,0,0,0,0,0,40000
2545,皇翔            ,118398,107000,11398,0,0,0,0,0,0,28000,28000,0,28000,0,0,0,39398
057813,京元電元大98購03,0,0,0,0,0,0,0,0,0,39000,0,0,0,140000,101000,39000,39000
07000P,T50反1元大99售03,0,0,0,0,0,0,0,0,0,39000,0,0,0,69000,30000,39000,39000
07069P,欣興元富99售02  ,0,0,0,0,0,0,0,0,0,39000,0,0,0,39000,0,39000,39000
06892P,聯鈞元富98售01  ,0,0,0,0,0,0,0,0,0,39000,0,0,0,39000,0,39000,39000
06212P,華新科元大97售11,0,0,0,0,0,0,0,0,0,39000,0,0,0,42000,3000,39000,39000
049130,臺指反元大98購01,0,0,0,0,0,0,0,0,0,39000,0,0,0,39000,0,39000,39000
053626,台積電兆豐96購03,0,0,0,0,0,0,0,0,0,39000,0,0,0,310000,271000,39000,39000
056749,滬深2X兆豐99購01,0,0,0,0,0,0,0,0,0,39000,0,0,0,49000,10000,39000,39000
05673P,台積電群益96售05,0,0,0,0,0,0,0,0,0,39000,0,0,0,46000,7000,39000,39000
053019,禾伸堂元富96購01,0,0,0,0,0,0,0,0,0,39000,0,0,0,39000,0,39000,39000
053101,創意元富96購03  ,0,0,0,0,0,0,0,0,0,39000,0,0,0,39000,0,39000,39000
3059,華晶科          ,284000,255000,29000,0,0,0,0,0,0,10000,10000,0,10000,0,0,0,39000
06207P,聯發科凱基97售07,0,0,0,0,0,0,0,0,0,38000,0,0,0,38000,0,38000,38000
06183P,大立光元大97售05,0,0,0,0,0,0,0,0,0,38000,0,0,0,50000,12000,38000,38000
06010P,國泰金元富96售01,0,0,0,0,0,0,0,0,0,38000,0,0,0,59000,21000,38000,38000
06043P,創意永豐96售06  ,0,0,0,0,0,0,0,0,0,38000,0,0,0,38000,0,38000,38000
1437,勤益控          ,60000,23000,37000,0,0,0,0,0,0,1000,1000,0,1000,0,0,0,38000
1417,嘉裕            ,72000,34000,38000,0,0,0,0,0,0,0,0,0,0,0,0,0,38000
057512,華邦電台新98購01,0,0,0,0,0,0,0,0,0,38000,0,0,0,38000,0,38000,38000
057961,茂林元大9A購01  ,0,0,0,0,0,0,0,0,0,38000,0,0,0,58000,20000,38000,38000
051600,新日興兆豐96購02,0,0,0,0,0,0,0,0,0,38000,0,0,0,38000,0,38000,38000
052115,T50反1國票95購03,0,0,0,0,0,0,0,0,0,38000,0,0,0,38000,0,38000,38000
050451,嘉晶元大95購01  ,0,0,0,0,0,0,0,0,0,38000,0,0,0,73000,35000,38000,38000
046797,T50反1元大96購01,0,0,0,0,0,0,0,0,0,38000,0,0,0,92000,54000,38000,38000
05405P,大立光群益95售04,0,0,0,0,0,0,0,0,0,38000,0,0,0,48000,10000,38000,38000
05472P,國巨統一96售02  ,0,0,0,0,0,0,0,0,0,38000,0,0,0,38000,0,38000,38000
054565,玉晶光群益99購02,0,0,0,0,0,0,0,0,0,38000,0,0,0,52000,14000,38000,38000
3705,永信            ,89000,51000,38000,0,0,0,0,0,0,0,0,0,0,0,0,0,38000
2617,台航            ,150000,116000,34000,0,0,0,0,0,0,4000,4000,0,4000,0,0,0,38000
00771,元大US高息特別股,0,0,0,0,0,0,0,0,0,37700,0,0,0,38000,300,37700,37700
057563,旭富國泰9A購01  ,0,0,0,0,0,0,0,0,0,37000,0,0,0,444000,407000,37000,37000
05908P,大立光元富96售05,0,0,0,0,0,0,0,0,0,37000,0,0,0,37000,0,37000,37000
07035P,大立光元富99售04,0,0,0,0,0,0,0,0,0,37000,0,0,0,48000,11000,37000,37000
06077P,GIS凱基97售02   ,0,0,0,0,0,0,0,0,0,37000,0,0,0,37000,0,37000,37000
06094P,台達電中信97售01,0,0,0,0,0,0,0,0,0,37000,0,0,0,40000,3000,37000,37000
06223P,漢唐元富97售02  ,0,0,0,0,0,0,0,0,0,37000,0,0,0,37000,0,37000,37000
06283P,祥碩永豐97售01  ,0,0,0,0,0,0,0,0,0,37000,0,0,0,57000,20000,37000,37000
052060,旺宏國票96購02  ,0,0,0,0,0,0,0,0,0,37000,0,0,0,37000,0,37000,37000
049985,華擎凱基94購01  ,0,0,0,0,0,0,0,0,0,37000,0,0,0,113000,76000,37000,37000
05491P,茂林元大95售04  ,0,0,0,0,0,0,0,0,0,37000,0,0,0,68000,31000,37000,37000
01004T,土銀富邦R2      ,36430,0,36430,0,0,0,0,0,0,0,0,0,0,0,0,0,36430
06370P,貿聯凱基97售03  ,0,0,0,0,0,0,0,0,0,36000,0,0,0,36000,0,36000,36000
06839P,玉晶光統一9A售05,0,0,0,0,0,0,0,0,0,36000,0,0,0,37000,1000,36000,36000
057535,泰鼎元大99購01  ,0,0,0,0,0,0,0,0,0,36000,0,0,0,53000,17000,36000,36000
03951P,新光金凱基95售01,0,0,0,0,0,0,0,0,0,36000,0,0,0,56000,20000,36000,36000
050784,美律國泰96購01  ,0,0,0,0,0,0,0,0,0,36000,0,0,0,36000,0,36000,36000
056015,華通群益99購01  ,0,0,0,0,0,0,0,0,0,36000,0,0,0,110000,74000,36000,36000
054630,聯鈞凱基98購01  ,0,0,0,0,0,0,0,0,0,36000,0,0,0,36000,0,36000,36000
05457P,鴻海凱基95售20  ,0,0,0,0,0,0,0,0,0,36000,0,0,0,196000,160000,36000,36000
056969,智易永豐98購01  ,0,0,0,0,0,0,0,0,0,36000,0,0,0,39000,3000,36000,36000
052926,旺宏元大98購02  ,0,0,0,0,0,0,0,0,0,36000,0,0,0,46000,10000,36000,36000
052885,高鐵兆豐98購01  ,0,0,0,0,0,0,0,0,0,36000,0,0,0,126000,90000,36000,36000
056851,瑞儀元富98購01  ,0,0,0,0,0,0,0,0,0,36000,0,0,0,116000,80000,36000,36000
4564,元翎            ,286000,250000,36000,0,0,0,0,0,0,0,0,0,0,0,0,0,36000
6024,群益期          ,85000,49000,36000,0,0,0,0,0,0,0,0,0,0,0,0,0,36000
05763P,致新永豐96售01  ,0,0,0,0,0,0,0,0,0,35000,0,0,0,35000,0,35000,35000
058269,世芯永豐9A購01  ,0,0,0,0,0,0,0,0,0,35000,0,0,0,35000,0,35000,35000
06954P,大立光元富99售01,0,0,0,0,0,0,0,0,0,35000,0,0,0,55000,20000,35000,35000
06658P,台灣50富邦9C售01,0,0,0,0,0,0,0,0,0,35000,0,0,0,37000,2000,35000,35000
06193P,台積電元富97售04,0,0,0,0,0,0,0,0,0,35000,0,0,0,90000,55000,35000,35000
06154P,超眾元大98售01  ,0,0,0,0,0,0,0,0,0,35000,0,0,0,190000,155000,35000,35000
049394,T50反1群益94購01,0,0,0,0,0,0,0,0,0,35000,0,0,0,35000,0,35000,35000
03421B,臺股指元大99熊01,0,0,0,0,0,0,0,0,0,35000,0,0,0,54000,19000,35000,35000
04437P,滬深2X群益98售03,0,0,0,0,0,0,0,0,0,35000,0,0,0,35000,0,35000,35000
00703,台新MSCI中國    ,2000,1000,1000,0,0,0,0,0,0,34000,0,0,0,522000,488000,34000,35000
04708P,國巨元大94售11  ,0,0,0,0,0,0,0,0,0,35000,0,0,0,667000,632000,35000,35000
056699,光罩國泰99購01  ,0,0,0,0,0,0,0,0,0,35000,0,0,0,35000,0,35000,35000
054318,台虹凱基98購01  ,0,0,0,0,0,0,0,0,0,35000,0,0,0,110000,75000,35000,35000
05278P,台郡元富95售02  ,0,0,0,0,0,0,0,0,0,35000,0,0,0,35000,0,35000,35000
056077,矽力元大97購07  ,0,0,0,0,0,0,0,0,0,35000,0,0,0,35000,0,35000,35000
05640P,旺宏元富96售03  ,0,0,0,0,0,0,0,0,0,35000,0,0,0,35000,0,35000,35000
056512,易華電永豐98購01,0,0,0,0,0,0,0,0,0,35000,0,0,0,35000,0,35000,35000
056463,台虹凱基98購02  ,0,0,0,0,0,0,0,0,0,35000,0,0,0,35000,0,35000,35000
057074,立積永豐98購01  ,0,0,0,0,0,0,0,0,0,35000,0,0,0,133000,98000,35000,35000
057216,聯發科群益99購01,0,0,0,0,0,0,0,0,0,35000,0,0,0,35000,0,35000,35000
055356,大立光凱基97購06,0,0,0,0,0,0,0,0,0,35000,0,0,0,35000,0,35000,35000
05379P,可成凱基95售11  ,0,0,0,0,0,0,0,0,0,35000,0,0,0,35000,0,35000,35000
3032,偉訓            ,48000,18000,30000,0,0,0,0,0,0,5000,5000,0,5000,0,0,0,35000
2415,錩新            ,41000,8000,33000,0,0,0,0,0,0,2000,2000,0,2000,0,0,0,35000
06176P,台積電元大97售22,0,0,0,0,0,0,0,0,0,34000,0,0,0,144000,110000,34000,34000
06066P,群創台新98售01  ,0,0,0,0,0,0,0,0,0,34000,0,0,0,40000,6000,34000,34000
06072P,牧德永豐97售01  ,0,0,0,0,0,0,0,0,0,34000,0,0,0,36000,2000,34000,34000
06047P,聯發科富邦99售04,0,0,0,0,0,0,0,0,0,34000,0,0,0,58000,24000,34000,34000
06556P,臺股指元大99售08,0,0,0,0,0,0,0,0,0,34000,0,0,0,34000,0,34000,34000
06327P,台積電中信01售01,0,0,0,0,0,0,0,0,0,34000,0,0,0,34000,0,34000,34000
058069,美律凱基99購05  ,0,0,0,0,0,0,0,0,0,34000,0,0,0,34000,0,34000,34000
058638,矽力兆豐99購01  ,0,0,0,0,0,0,0,0,0,34000,0,0,0,35000,1000,34000,34000
04488P,聯發科凱基94售05,0,0,0,0,0,0,0,0,0,34000,0,0,0,34000,0,34000,34000
047722,南電凱基94購02  ,0,0,0,0,0,0,0,0,0,34000,0,0,0,188000,154000,34000,34000
04286P,滬深2X中信96售01,0,0,0,0,0,0,0,0,0,34000,0,0,0,237000,203000,34000,34000
03996P,旺宏國泰95售01  ,0,0,0,0,0,0,0,0,0,34000,0,0,0,64000,30000,34000,34000
049272,世紀鋼元大96購02,0,0,0,0,0,0,0,0,0,34000,0,0,0,141000,107000,34000,34000
04973P,台積電凱基94售41,0,0,0,0,0,0,0,0,0,34000,0,0,0,274000,240000,34000,34000
056642,旺宏凱基98購07  ,0,0,0,0,0,0,0,0,0,34000,0,0,0,34000,0,34000,34000
052882,南電凱基96購02  ,0,0,0,0,0,0,0,0,0,34000,0,0,0,34000,0,34000,34000
052743,華新科元大97購01,0,0,0,0,0,0,0,0,0,34000,0,0,0,114000,80000,34000,34000
3550,聯穎            ,40000,8000,32000,0,0,0,0,0,0,2000,2000,0,2000,0,0,0,34000
05858P,矽力中信96售01  ,0,0,0,0,0,0,0,0,0,33000,0,0,0,78000,45000,33000,33000
05805P,義隆永豐96售02  ,0,0,0,0,0,0,0,0,0,33000,0,0,0,33000,0,33000,33000
057823,神達元大98購01  ,0,0,0,0,0,0,0,0,0,33000,0,0,0,44000,11000,33000,33000
06600P,貿聯永豐98售01  ,0,0,0,0,0,0,0,0,0,33000,0,0,0,33000,0,33000,33000
06997P,台灣50中信03售01,0,0,0,0,0,0,0,0,0,33000,0,0,0,33000,0,33000,33000
06857P,超眾永豐98售02  ,0,0,0,0,0,0,0,0,0,33000,0,0,0,33000,0,33000,33000
07122P,欣興凱基99售05  ,0,0,0,0,0,0,0,0,0,33000,0,0,0,155000,122000,33000,33000
051751,聯茂富邦95購01  ,0,0,0,0,0,0,0,0,0,33000,0,0,0,33000,0,33000,33000
051193,新日興兆豐96購01,0,0,0,0,0,0,0,0,0,33000,0,0,0,33000,0,33000,33000
051001,緯穎元大96購02  ,0,0,0,0,0,0,0,0,0,33000,0,0,0,37000,4000,33000,33000
05237P,為升永豐95售01  ,0,0,0,0,0,0,0,0,0,33000,0,0,0,33000,0,33000,33000
03959P,義隆元富96售01  ,0,0,0,0,0,0,0,0,0,33000,0,0,0,33000,0,33000,33000
04846P,旺宏凱基94售07  ,0,0,0,0,0,0,0,0,0,33000,0,0,0,98000,65000,33000,33000
04410P,大立光統一94售05,0,0,0,0,0,0,0,0,0,33000,0,0,0,33000,0,33000,33000
04404P,玉晶光國票94售01,0,0,0,0,0,0,0,0,0,33000,0,0,0,33000,0,33000,33000
00689R,國泰20年美債反1 ,0,0,0,0,0,0,0,0,0,33000,0,0,0,136000,103000,33000,33000
054614,玉晶光永豐97購03,0,0,0,0,0,0,0,0,0,33000,0,0,0,39000,6000,33000,33000
054830,世芯國泰99購01  ,0,0,0,0,0,0,0,0,0,33000,0,0,0,33000,0,33000,33000
3057,喬鼎            ,37000,4000,33000,0,0,0,0,0,0,0,0,0,0,0,0,0,33000
6235,華孚            ,87000,58000,29000,0,0,0,0,0,0,4000,4000,0,4000,0,0,0,33000
1783,和康生          ,57000,25000,32000,0,0,0,0,0,0,0,0,0,0,0,0,0,32000
06466P,台積電統一9B售01,0,0,0,0,0,0,0,0,0,32000,0,0,0,35000,3000,32000,32000
06032P,健策群益97售03  ,0,0,0,0,0,0,0,0,0,32000,0,0,0,32000,0,32000,32000
06156P,大立光統一97售05,0,0,0,0,0,0,0,0,0,32000,0,0,0,32000,0,32000,32000
06185P,台表科元大97售05,0,0,0,0,0,0,0,0,0,32000,0,0,0,32000,0,32000,32000
058020,大立光凱基99購03,0,0,0,0,0,0,0,0,0,32000,0,0,0,32000,0,32000,32000
058471,台積電日盛9C購01,0,0,0,0,0,0,0,0,0,32000,0,0,0,86000,54000,32000,32000
03314P,台積電元大02售16,0,0,0,0,0,0,0,0,0,32000,0,0,0,32000,0,32000,32000
047543,鴻海凱基94購09  ,0,0,0,0,0,0,0,0,0,32000,0,0,0,32000,0,32000,32000
05234P,美食康和95售01  ,0,0,0,0,0,0,0,0,0,32000,0,0,0,34000,2000,32000,32000
049761,亞德客國泰95購03,0,0,0,0,0,0,0,0,0,32000,0,0,0,177000,145000,32000,32000
052005,矽力國泰97購02  ,0,0,0,0,0,0,0,0,0,32000,0,0,0,32000,0,32000,32000
055095,啟碁群益98購01  ,0,0,0,0,0,0,0,0,0,32000,0,0,0,32000,0,32000,32000
052970,美律群益96購01  ,0,0,0,0,0,0,0,0,0,32000,0,0,0,32000,0,32000,32000
056145,緯穎元大98購03  ,0,0,0,0,0,0,0,0,0,32000,0,0,0,35000,3000,32000,32000
6136,富爾特          ,39000,10000,29000,0,0,0,0,0,0,3000,4000,1000,3000,0,0,0,32000
4722,國精化          ,42000,11000,31000,0,0,0,0,0,0,1000,1000,0,1000,0,0,0,32000
2488,漢平            ,109000,77000,32000,0,0,0,0,0,0,0,0,0,0,0,0,0,32000
058834,GIS永豐99購01   ,0,0,0,0,0,0,0,0,0,31000,0,0,0,100000,69000,31000,31000
05783P,嘉澤元富96售01  ,0,0,0,0,0,0,0,0,0,31000,0,0,0,31000,0,31000,31000
06410P,祥碩統一97售01  ,0,0,0,0,0,0,0,0,0,31000,0,0,0,31000,0,31000,31000
1626,艾美特-KY       ,128000,97000,31000,0,0,0,0,0,0,0,0,0,0,0,0,0,31000
050019,T50反1元大94購04,0,0,0,0,0,0,0,0,0,31000,0,0,0,34000,3000,31000,31000
04892P,聯發科元大94售14,0,0,0,0,0,0,0,0,0,31000,0,0,0,62000,31000,31000,31000
04898P,瑞儀中信95售01  ,0,0,0,0,0,0,0,0,0,31000,0,0,0,36000,5000,31000,31000
054208,台積電國票97購07,0,0,0,0,0,0,0,0,0,31000,0,0,0,160000,129000,31000,31000
2484,希華            ,211000,183000,28000,0,0,0,0,0,0,3000,3000,0,3000,0,0,0,31000
08164P,滬深2X中信95售04,0,0,0,0,0,0,0,0,0,30000,0,0,0,30000,0,30000,30000
06846P,美律元大98售05  ,0,0,0,0,0,0,0,0,0,30000,0,0,0,30000,0,30000,30000
06808P,電子類群益98售02,0,0,0,0,0,0,0,0,0,30000,0,0,0,30000,0,30000,30000
06980P,緯穎永豐99售02  ,0,0,0,0,0,0,0,0,0,30000,0,0,0,93000,63000,30000,30000
07054P,華新科兆豐99售04,0,0,0,0,0,0,0,0,0,30000,0,0,0,30000,0,30000,30000
06448P,華通元大99售01  ,0,0,0,0,0,0,0,0,0,30000,0,0,0,30000,0,30000,30000
06353P,電子類富邦99售02,0,0,0,0,0,0,0,0,0,30000,0,0,0,30000,0,30000,30000
06273P,台表科凱基97售04,0,0,0,0,0,0,0,0,0,30000,0,0,0,30000,0,30000,30000
06546P,聯發科元大98售05,0,0,0,0,0,0,0,0,0,30000,0,0,0,40000,10000,30000,30000
06667P,鴻海凱基98售11  ,0,0,0,0,0,0,0,0,0,30000,0,0,0,613000,583000,30000,30000
06706P,智原台新98售02  ,0,0,0,0,0,0,0,0,0,30000,0,0,0,30000,0,30000,30000
06169P,華新科元富97售02,0,0,0,0,0,0,0,0,0,30000,0,0,0,30000,0,30000,30000
06131P,京鼎元富97售02  ,0,0,0,0,0,0,0,0,0,30000,0,0,0,30000,0,30000,30000
05979P,華新科中信96售02,0,0,0,0,0,0,0,0,0,30000,0,0,0,40000,10000,30000,30000
057855,晶技國票99購01  ,0,0,0,0,0,0,0,0,0,30000,0,0,0,30000,0,30000,30000
057811,南亞科元大98購08,0,0,0,0,0,0,0,0,0,30000,0,0,0,30000,0,30000,30000
057645,華新科元大99購11,0,0,0,0,0,0,0,0,0,30000,0,0,0,70000,40000,30000,30000
057540,緯穎日盛99購01  ,0,0,0,0,0,0,0,0,0,30000,0,0,0,30000,0,30000,30000
057925,貿聯凱基99購01  ,0,0,0,0,0,0,0,0,0,30000,0,0,0,30000,0,30000,30000
05817P,可成凱基96售07  ,0,0,0,0,0,0,0,0,0,30000,0,0,0,40000,10000,30000,30000
058225,旺宏元富99購01  ,0,0,0,0,0,0,0,0,0,30000,0,0,0,30000,0,30000,30000
058862,聯發科凱基99購08,0,0,0,0,0,0,0,0,0,30000,0,0,0,30000,0,30000,30000
05871P,全新凱基96售04  ,0,0,0,0,0,0,0,0,0,30000,0,0,0,30000,0,30000,30000
058720,旭富元富99購01  ,0,0,0,0,0,0,0,0,0,30000,0,0,0,30000,0,30000,30000
05904P,大立光統一96售07,0,0,0,0,0,0,0,0,0,30000,0,0,0,30000,0,30000,30000
058365,奇力新凱基9A購01,0,0,0,0,0,0,0,0,0,30000,0,0,0,30000,0,30000,30000
058406,聯茂元大99購06  ,0,0,0,0,0,0,0,0,0,30000,0,0,0,40000,10000,30000,30000
058539,聯發科台新99購01,0,0,0,0,0,0,0,0,0,30000,0,0,0,30000,0,30000,30000
058601,台積電元大99購10,0,0,0,0,0,0,0,0,0,30000,0,0,0,50000,20000,30000,30000
058640,台灣50麥證9A購01,0,0,0,30000,0,30000,0,0,0,30000,0,0,0,30000,0,30000,30000
050984,大立光國泰97購01,0,0,0,0,0,0,0,0,0,30000,0,0,0,30000,0,30000,30000
04907P,超眾國票95售01  ,0,0,0,0,0,0,0,0,0,30000,0,0,0,30000,0,30000,30000
04914P,國巨國泰95售06  ,0,0,0,0,0,0,0,0,0,30000,0,0,0,30000,0,30000,30000
05086P,鴻海凱基95售13  ,0,0,0,0,0,0,0,0,0,30000,0,0,0,110000,80000,30000,30000
050894,旺宏元大96購03  ,0,0,0,0,0,0,0,0,0,30000,0,0,0,140000,110000,30000,30000
051598,瑞昱兆豐95購01  ,0,0,0,0,0,0,0,0,0,30000,0,0,0,120000,90000,30000,30000
055465,和大凱基97購03  ,0,0,0,0,0,0,0,0,0,30000,0,0,0,30000,0,30000,30000
051666,旺宏元大96購05  ,0,0,0,0,0,0,0,0,0,30000,0,0,0,30000,0,30000,30000
055834,國巨元大97購13  ,0,0,0,0,0,0,0,0,0,30000,0,0,0,30000,0,30000,30000
055557,華新科凱基97購01,0,0,0,0,0,0,0,0,0,30000,0,0,0,30000,0,30000,30000
055596,新光金元大9B購02,0,0,0,0,0,0,0,0,0,30000,0,0,0,150000,120000,30000,30000
055674,南港康和97購02  ,0,0,0,0,0,0,0,0,0,30000,0,0,0,148000,118000,30000,30000
052179,康友元大95購03  ,0,0,0,0,0,0,0,0,0,30000,0,0,0,40000,10000,30000,30000
05007P,旺宏元富95售01  ,0,0,0,0,0,0,0,0,0,30000,0,0,0,30000,0,30000,30000
049668,大立光國泰96購02,0,0,0,0,0,0,0,0,0,30000,0,0,0,30000,0,30000,30000
049922,禾伸堂元大95購01,0,0,0,0,0,0,0,0,0,30000,0,0,0,40000,10000,30000,30000
051978,泰碩凱基96購01  ,0,0,0,0,0,0,0,0,0,30000,0,0,0,30000,0,30000,30000
051987,廣達元大95購01  ,0,0,0,0,0,0,0,0,0,30000,0,0,0,82000,52000,30000,30000
051931,美律國票96購02  ,0,0,0,0,0,0,0,0,0,30000,0,0,0,30000,0,30000,30000
049377,聯詠元大94購01  ,0,0,0,0,0,0,0,0,0,30000,0,0,0,30000,0,30000,30000
050252,聯發科國泰95購01,0,0,0,0,0,0,0,0,0,30000,0,0,0,30000,0,30000,30000
04742P,瑞昱統一94售01  ,0,0,0,0,0,0,0,0,0,30000,0,0,0,30000,0,30000,30000
05030P,台積電元富95售04,0,0,0,0,0,0,0,0,0,30000,0,0,0,60000,30000,30000,30000
04608P,晶相光永豐94售02,0,0,0,0,0,0,0,0,0,30000,0,0,0,30000,0,30000,30000
04589P,祥碩永豐94售01  ,0,0,0,0,0,0,0,0,0,30000,0,0,0,30000,0,30000,30000
045858,元油2X統一94購02,0,0,0,0,0,0,0,0,0,30000,0,0,0,30000,0,30000,30000
04788P,台積電永昌96售05,0,0,0,0,0,0,0,0,0,30000,0,0,0,70000,40000,30000,30000
047137,健策凱基94購01  ,0,0,0,0,0,0,0,0,0,30000,0,0,0,30000,0,30000,30000
03564P,為升群益02售02  ,0,0,0,0,0,0,0,0,0,30000,0,0,0,30000,0,30000,30000
03885P,華新科統一96售01,0,0,0,0,0,0,0,0,0,30000,0,0,0,30000,0,30000,30000
03832P,臺股指中信95售03,0,0,0,0,0,0,0,0,0,30000,0,0,0,30000,0,30000,30000
048461,緯穎凱基93購01  ,0,0,0,0,0,0,0,0,0,30000,0,0,0,30000,0,30000,30000
05612P,台積電元大96售13,0,0,0,0,0,0,0,0,0,30000,0,0,0,52000,22000,30000,30000
055291,京鼎元大97購02  ,0,0,0,0,0,0,0,0,0,30000,0,0,0,30000,0,30000,30000
053153,大立光元大99購02,0,0,0,0,0,0,0,0,0,30000,0,0,0,30000,0,30000,30000
055741,健策元富97購01  ,0,0,0,0,0,0,0,0,0,30000,0,0,0,30000,0,30000,30000
055810,T50反1國票99購01,0,0,0,0,0,0,0,0,0,30000,0,0,0,30000,0,30000,30000
056485,同欣電元大98購01,0,0,0,0,0,0,0,0,0,30000,0,0,0,116000,86000,30000,30000
056354,國巨元大98購10  ,0,0,0,0,0,0,0,0,0,30000,0,0,0,40000,10000,30000,30000
05292P,台積電凱基95售16,0,0,0,0,0,0,0,0,0,30000,0,0,0,30000,0,30000,30000
052870,玉晶光凱基96購03,0,0,0,0,0,0,0,0,0,30000,0,0,0,30000,0,30000,30000
052861,台光電凱基96購03,0,0,0,0,0,0,0,0,0,30000,0,0,0,30000,0,30000,30000
056180,南茂元富97購01  ,0,0,0,0,0,0,0,0,0,30000,0,0,0,30000,0,30000,30000
056774,和鑫元大98購01  ,0,0,0,0,0,0,0,0,0,30000,0,0,0,60000,30000,30000,30000
054627,義隆凱基98購01  ,0,0,0,0,0,0,0,0,0,30000,0,0,0,80000,50000,30000,30000
054519,禾伸堂元大97購02,0,0,0,0,0,0,0,0,0,30000,0,0,0,30000,0,30000,30000
053481,同欣電元大97購01,0,0,0,0,0,0,0,0,0,30000,0,0,0,30000,0,30000,30000
05382P,電子類群益95售02,0,0,0,0,0,0,0,0,0,30000,0,0,0,30000,0,30000,30000
05395P,旺宏元大96售06  ,0,0,0,0,0,0,0,0,0,30000,0,0,0,108000,78000,30000,30000
053744,台郡國票97購03  ,0,0,0,0,0,0,0,0,0,30000,0,0,0,30000,0,30000,30000
054121,奇鋐永豐96購02  ,0,0,0,0,0,0,0,0,0,30000,0,0,0,30000,0,30000,30000
05839P,臺股指富邦96售06,0,0,0,0,0,0,0,0,0,29000,0,0,0,29000,0,29000,29000
058351,上銀凱基9A購02  ,0,0,0,0,0,0,0,0,0,29000,0,0,0,30000,1000,29000,29000
05792P,臺股指中信99售07,0,0,0,0,0,0,0,0,0,29000,0,0,0,29000,0,29000,29000
057406,茂林群益98購03  ,0,0,0,0,0,0,0,0,0,29000,0,0,0,50000,21000,29000,29000
06243P,亞光元富97售01  ,0,0,0,0,0,0,0,0,0,29000,0,0,0,29000,0,29000,29000
051989,華固元大95購02  ,0,0,0,0,0,0,0,0,0,29000,0,0,0,30000,1000,29000,29000
055648,可成元富97購01  ,0,0,0,0,0,0,0,0,0,29000,0,0,0,29000,0,29000,29000
051544,T50反1康和98購01,0,0,0,0,0,0,0,0,0,29000,0,0,0,31000,2000,29000,29000
054130,漢唐元大97購02  ,0,0,0,0,0,0,0,0,0,29000,0,0,0,50000,21000,29000,29000
053602,台虹元大96購01  ,0,0,0,0,0,0,0,0,0,29000,0,0,0,112000,83000,29000,29000
05484P,台積電凱基95售18,0,0,0,0,0,0,0,0,0,29000,0,0,0,50000,21000,29000,29000
057091,華新科元富9A購01,0,0,0,0,0,0,0,0,0,29000,0,0,0,30000,1000,29000,29000
056777,矽力元大98購02  ,0,0,0,0,0,0,0,0,0,29000,0,0,0,29000,0,29000,29000
056848,泰鼎元富98購01  ,0,0,0,0,0,0,0,0,0,29000,0,0,0,39000,10000,29000,29000
056659,泰碩元大99購01  ,0,0,0,0,0,0,0,0,0,29000,0,0,0,31000,2000,29000,29000
05579P,友達凱基98售03  ,0,0,0,0,0,0,0,0,0,29000,0,0,0,29000,0,29000,29000
06439P,上銀凱基98售02  ,0,0,0,0,0,0,0,0,0,28000,0,0,0,28000,0,28000,28000
07012P,智邦群益9A售01  ,0,0,0,0,0,0,0,0,0,28000,0,0,0,120000,92000,28000,28000
05757P,旺宏永豐96售03  ,0,0,0,0,0,0,0,0,0,28000,0,0,0,28000,0,28000,28000
058687,聯茂凱基9A購01  ,0,0,0,0,0,0,0,0,0,28000,0,0,0,28000,0,28000,28000
05063P,聯電元大96售03  ,0,0,0,0,0,0,0,0,0,28000,0,0,0,60000,32000,28000,28000
050106,台達電元大94購11,0,0,0,0,0,0,0,0,0,28000,0,0,0,28000,0,28000,28000
048153,台積電兆豐94購01,0,0,0,0,0,0,0,0,0,28000,0,0,0,65000,37000,28000,28000
053071,南電群益96購01  ,0,0,0,0,0,0,0,0,0,28000,0,0,0,30000,2000,28000,28000
2010,春源            ,121000,93000,28000,0,0,0,0,0,0,0,0,0,0,0,0,0,28000
058154,泰碩統一9A購01  ,0,0,0,0,0,0,0,0,0,27000,0,0,0,27000,0,27000,27000
06994P,台光電凱基99售02,0,0,0,0,0,0,0,0,0,27000,0,0,0,37000,10000,27000,27000
07004P,大立光兆豐9A售01,0,0,0,0,0,0,0,0,0,27000,0,0,0,27000,0,27000,27000
07070P,晶相光元富99售01,0,0,0,0,0,0,0,0,0,27000,0,0,0,30000,3000,27000,27000
06721P,臺股指中信9A售03,0,0,0,0,0,0,0,0,0,27000,0,0,0,27000,0,27000,27000
1410,南染            ,33000,6000,27000,0,0,0,0,0,0,0,0,0,0,0,0,0,27000
1540,喬福            ,33000,6000,27000,0,0,0,0,0,0,0,0,0,0,0,0,0,27000
06406P,可成元富97售04  ,0,0,0,0,0,0,0,0,0,27000,0,0,0,28000,1000,27000,27000
06235P,國巨元大97售12  ,0,0,0,0,0,0,0,0,0,27000,0,0,0,577000,550000,27000,27000
06179P,國巨群益97售04  ,0,0,0,0,0,0,0,0,0,27000,0,0,0,30000,3000,27000,27000
045054,聯發科元富98購02,0,0,0,0,0,0,0,0,0,27000,0,0,0,412000,385000,27000,27000
03831P,臺股指中信95售02,0,0,0,0,0,0,0,0,0,27000,0,0,0,27000,0,27000,27000
03896P,長榮航凱基95售01,0,0,0,0,0,0,0,0,0,27000,0,0,0,78000,51000,27000,27000
048221,鴻海凱基95購01  ,0,0,0,0,0,0,0,0,0,27000,0,0,0,28000,1000,27000,27000
050137,臺指反國票96購01,0,0,0,0,0,0,0,0,0,27000,0,0,0,27000,0,27000,27000
05140P,台表科國票96售01,0,0,0,0,0,0,0,0,0,27000,0,0,0,27000,0,27000,27000
05137P,華新科凱基96售03,0,0,0,0,0,0,0,0,0,27000,0,0,0,53000,26000,27000,27000
056602,嘉澤國泰99購01  ,0,0,0,0,0,0,0,0,0,27000,0,0,0,208000,181000,27000,27000
056198,台光電永豐97購02,0,0,0,0,0,0,0,0,0,27000,0,0,0,27000,0,27000,27000
05368P,可成元富95售03  ,0,0,0,0,0,0,0,0,0,27000,0,0,0,27000,0,27000,27000
2002A,中鋼特          ,0,0,0,0,0,0,0,0,0,27000,29000,2000,27000,0,0,0,27000
4916,事欣科          ,84000,59000,25000,0,0,0,0,0,0,2000,2000,0,2000,0,0,0,27000
4560,強信-KY         ,100000,73000,27000,0,0,0,0,0,0,0,0,0,0,0,0,0,27000
3015,全漢            ,35000,13000,22000,0,0,0,0,0,0,5000,5000,0,5000,0,0,0,27000
06012P,世芯國票96售01  ,0,0,0,0,0,0,0,0,0,26000,0,0,0,26000,0,26000,26000
05975P,國巨日盛99售02  ,0,0,0,0,0,0,0,0,0,26000,0,0,0,378000,352000,26000,26000
05976P,國巨凱基96售14  ,0,0,0,0,0,0,0,0,0,26000,0,0,0,26000,0,26000,26000
06359P,上銀群益97售03  ,0,0,0,0,0,0,0,0,0,26000,0,0,0,26000,0,26000,26000
06400P,鴻海元富97售12  ,0,0,0,0,0,0,0,0,0,26000,0,0,0,26000,0,26000,26000
07089P,臺指2X中信01售01,0,0,0,0,0,0,0,0,0,26000,0,0,0,36000,10000,26000,26000
057499,奇鋐群益98購01  ,0,0,0,0,0,0,0,0,0,26000,0,0,0,26000,0,26000,26000
058376,貿聯凱基9A購01  ,0,0,0,0,0,0,0,0,0,26000,0,0,0,105000,79000,26000,26000
04855P,上証2X元富94售02,0,0,0,0,0,0,0,0,0,26000,0,0,0,26000,0,26000,26000
04308P,京元電凱基93售06,0,0,0,0,0,0,0,0,0,26000,0,0,0,26000,0,26000,26000
045842,T50反1台新98購01,0,0,0,0,0,0,0,0,0,26000,0,0,0,36000,10000,26000,26000
04627P,聯發科元大94售08,0,0,0,0,0,0,0,0,0,26000,0,0,0,71000,45000,26000,26000
053769,香港反元大99購01,0,0,0,0,0,0,0,0,0,26000,0,0,0,45000,19000,26000,26000
054515,華通元大98購02  ,0,0,0,0,0,0,0,0,0,26000,0,0,0,26000,0,26000,26000
057236,聯詠凱基98購03  ,0,0,0,0,0,0,0,0,0,26000,0,0,0,26000,0,26000,26000
05580P,美律凱基96售03  ,0,0,0,0,0,0,0,0,0,26000,0,0,0,88000,62000,26000,26000
05682P,大立光元大98售03,0,0,0,0,0,0,0,0,0,26000,0,0,0,52000,26000,26000,26000
3025,星通            ,41000,19000,22000,0,0,0,0,0,0,4000,5000,1000,4000,0,0,0,26000
3591,艾笛森          ,57000,35000,22000,0,0,0,0,0,0,4000,4000,0,4000,0,0,0,26000
6666,羅麗芬-KY       ,54000,28000,26000,0,0,0,0,0,0,0,0,0,0,0,0,0,26000
3661,世芯-KY         ,1865500,1745000,120500,0,0,0,0,110000,-110000,15000,3000,18000,-15000,63000,33000,30000,25500
058347,玉晶光群益9B購01,0,0,0,0,0,0,0,0,0,25000,0,0,0,30000,5000,25000,25000
057603,樺漢群益98購02  ,0,0,0,0,0,0,0,0,0,25000,0,0,0,25000,0,25000,25000
05819P,臺股指凱基96售16,0,0,0,0,0,0,0,0,0,25000,0,0,0,25000,0,25000,25000
07007P,台灣50台新01售02,0,0,0,0,0,0,0,0,0,25000,0,0,0,25000,0,25000,25000
06620P,聯發科元大98售07,0,0,0,0,0,0,0,0,0,25000,0,0,0,95000,70000,25000,25000
06549P,大立光元大98售11,0,0,0,0,0,0,0,0,0,25000,0,0,0,80000,55000,25000,25000
06584P,欣興凱基98售03  ,0,0,0,0,0,0,0,0,0,25000,0,0,0,35000,10000,25000,25000
05984P,台積電統一98售01,0,0,0,0,0,0,0,0,0,25000,0,0,0,25000,0,25000,25000
05934P,國巨凱基96售13  ,0,0,0,0,0,0,0,0,0,25000,0,0,0,535000,510000,25000,25000
04649P,臺股指凱基94售08,0,0,0,0,0,0,0,0,0,25000,0,0,0,25000,0,25000,25000
04747P,臺股指元大94售22,0,0,0,0,0,0,0,0,0,25000,0,0,0,25000,0,25000,25000
05034P,台積電元大95售08,0,0,0,0,0,0,0,0,0,25000,0,0,0,87000,62000,25000,25000
047630,元油反元大96購02,0,0,0,0,0,0,0,0,0,25000,0,0,0,42000,17000,25000,25000
046219,T50反1元大93購03,0,0,0,0,0,0,0,0,0,25000,0,0,0,25000,0,25000,25000
04408P,台積電統一94售06,0,0,0,0,0,0,0,0,0,25000,0,0,0,25000,0,25000,25000
04107P,元黃金中信94售01,0,0,0,0,0,0,0,0,0,25000,0,0,0,25000,0,25000,25000
051551,新日興永豐95購01,0,0,0,0,0,0,0,0,0,25000,0,0,0,25000,0,25000,25000
055606,矽創元大97購01  ,0,0,0,0,0,0,0,0,0,25000,0,0,0,94000,69000,25000,25000
055710,亞德客元大97購03,0,0,0,0,0,0,0,0,0,25000,0,0,0,30000,5000,25000,25000
04930P,國巨統一94售08  ,0,0,0,0,0,0,0,0,0,25000,0,0,0,25000,0,25000,25000
048911,玉晶光富邦96購01,0,0,0,0,0,0,0,0,0,25000,0,0,0,100000,75000,25000,25000
05320P,華通凱基96售03  ,0,0,0,0,0,0,0,0,0,25000,0,0,0,25000,0,25000,25000
053199,旺宏日盛96購01  ,0,0,0,0,0,0,0,0,0,25000,0,0,0,25000,0,25000,25000
052520,南亞科元大95購06,0,0,0,0,0,0,0,0,0,25000,0,0,0,45000,20000,25000,25000
053344,嘉晶國票97購02  ,0,0,0,0,0,0,0,0,0,25000,0,0,0,25000,0,25000,25000
056596,光磊元富98購01  ,0,0,0,0,0,0,0,0,0,25000,0,0,0,25000,0,25000,25000
056506,晶豪科永豐98購02,0,0,0,0,0,0,0,0,0,25000,0,0,0,25000,0,25000,25000
056445,聯發科凱基98購07,0,0,0,0,0,0,0,0,0,25000,0,0,0,35000,10000,25000,25000
057040,國巨元大98購12  ,0,0,0,0,0,0,0,0,0,25000,0,0,0,45000,20000,25000,25000
05469P,台積電元大95售24,0,0,0,0,0,0,0,0,0,25000,0,0,0,25000,0,25000,25000
054914,億光凱基98購01  ,0,0,0,0,0,0,0,0,0,25000,0,0,0,25000,0,25000,25000
8374,羅昇            ,36000,11000,25000,0,0,0,0,0,0,0,0,0,0,0,0,0,25000
06123P,玉晶光元大97售04,0,0,0,0,0,0,0,0,0,24000,0,0,0,44000,20000,24000,24000
06513P,鴻海凱基98售10  ,0,0,0,0,0,0,0,0,0,24000,0,0,0,204000,180000,24000,24000
06648P,華邦電元大98售03,0,0,0,0,0,0,0,0,0,24000,0,0,0,83000,59000,24000,24000
06399P,台表科凱基97售05,0,0,0,0,0,0,0,0,0,24000,0,0,0,24000,0,24000,24000
1528,恩德            ,52000,20000,32000,0,0,0,0,0,0,-8000,1000,9000,-8000,0,0,0,24000
058367,大立光凱基9A購01,0,0,0,0,0,0,0,0,0,24000,0,0,0,40000,16000,24000,24000
058697,亞德客元大99購01,0,0,0,0,0,0,0,0,0,24000,0,0,0,34000,10000,24000,24000
051739,奇力新國票97購01,0,0,0,0,0,0,0,0,0,24000,0,0,0,24000,0,24000,24000
050069,禾伸堂凱基94購04,0,0,0,0,0,0,0,0,0,24000,0,0,0,30000,6000,24000,24000
05546P,全新元大97售01  ,0,0,0,0,0,0,0,0,0,24000,0,0,0,24000,0,24000,24000
051560,玉晶光國泰97購03,0,0,0,0,0,0,0,0,0,24000,0,0,0,53000,29000,24000,24000
051500,聯茂群益95購01  ,0,0,0,0,0,0,0,0,0,24000,0,0,0,24000,0,24000,24000
050869,健策永豐95購01  ,0,0,0,0,0,0,0,0,0,24000,0,0,0,44000,20000,24000,24000
03899P,滬深2X群益95售03,0,0,0,0,0,0,0,0,0,24000,0,0,0,24000,0,24000,24000
00783,富邦中証500     ,34000,1000,33000,0,0,0,0,0,0,-9000,0,0,0,833000,842000,-9000,24000
053477,大立光元大97購03,0,0,0,0,0,0,0,0,0,24000,0,0,0,24000,0,24000,24000
05360P,健策元大95售03  ,0,0,0,0,0,0,0,0,0,24000,0,0,0,59000,35000,24000,24000
057321,台泥群益98購01  ,0,0,0,0,0,0,0,0,0,24000,0,0,0,24000,0,24000,24000
056649,智易凱基98購01  ,0,0,0,0,0,0,0,0,0,24000,0,0,0,34000,10000,24000,24000
05621P,聯電中信96售01  ,0,0,0,0,0,0,0,0,0,24000,0,0,0,66000,42000,24000,24000
056519,創意國票99購01  ,0,0,0,0,0,0,0,0,0,24000,0,0,0,24000,0,24000,24000
053074,嘉晶永豐96購02  ,0,0,0,0,0,0,0,0,0,24000,0,0,0,240000,216000,24000,24000
055292,聯鈞元大97購02  ,0,0,0,0,0,0,0,0,0,24000,0,0,0,25000,1000,24000,24000
2493,揚博            ,52000,30000,22000,0,0,0,0,0,0,2000,3000,1000,2000,0,0,0,24000
2528,皇普            ,50000,28000,22000,0,0,0,0,0,0,2000,5000,3000,2000,0,0,0,24000
01007T,兆豐國泰R2      ,23088,0,23088,0,0,0,0,0,0,0,0,0,0,0,0,0,23088
057550,聯發科凱基02購01,0,0,0,0,0,0,0,0,0,23000,0,0,0,23000,0,23000,23000
06952P,大立光統一9A售03,0,0,0,0,0,0,0,0,0,23000,0,0,0,41000,18000,23000,23000
06812P,台灣50元富9C售01,0,0,0,0,0,0,0,0,0,23000,0,0,0,227000,204000,23000,23000
06848P,聯詠元大98售04  ,0,0,0,0,0,0,0,0,0,23000,0,0,0,23000,0,23000,23000
04288P,台積電中信95售06,0,0,0,0,0,0,0,0,0,23000,0,0,0,63000,40000,23000,23000
03419B,臺股指元富99熊03,0,0,0,0,0,0,0,0,0,23000,0,0,0,24000,1000,23000,23000
045931,緯穎永豐93購01  ,0,0,0,0,0,0,0,0,0,23000,0,0,0,23000,0,23000,23000
050371,台積電元大94購25,0,0,0,0,0,0,0,0,0,23000,0,0,0,33000,10000,23000,23000
049270,台表科元大95購02,0,0,0,0,0,0,0,0,0,23000,0,0,0,23000,0,23000,23000
05531P,臺股指群益96售04,0,0,0,0,0,0,0,0,0,23000,0,0,0,23000,0,23000,23000
056497,GIS國泰99購01   ,0,0,0,0,0,0,0,0,0,23000,0,0,0,89000,66000,23000,23000
05300P,健策元大95售02  ,0,0,0,0,0,0,0,0,0,23000,0,0,0,92000,69000,23000,23000
056762,亞德客元大98購01,0,0,0,0,0,0,0,0,0,23000,0,0,0,31000,8000,23000,23000
052631,T50反1凱基98購02,0,0,0,0,0,0,0,0,0,23000,0,0,0,23000,0,23000,23000
054317,昇陽半凱基98購01,0,0,0,0,0,0,0,0,0,23000,0,0,0,33000,10000,23000,23000
053441,旺宏凱基98購01  ,0,0,0,0,0,0,0,0,0,23000,0,0,0,23000,0,23000,23000
2850,新產            ,108000,87000,21000,0,0,0,0,0,0,2000,3000,1000,2000,0,0,0,23000
4551,智伸科          ,327000,302000,25000,0,0,0,0,0,0,-2000,33000,32000,1000,2000,5000,-3000,23000
06724P,台灣50國票98售01,0,0,0,0,0,0,0,0,0,22000,0,0,0,22000,0,22000,22000
06762P,智邦元大98售11  ,0,0,0,0,0,0,0,0,0,22000,0,0,0,24000,2000,22000,22000
06743P,創意永豐98售03  ,0,0,0,0,0,0,0,0,0,22000,0,0,0,32000,10000,22000,22000
1817,凱撒衛          ,36000,15000,21000,0,0,0,0,0,0,1000,1000,0,1000,0,0,0,22000
06372P,聯發科元大97售21,0,0,0,0,0,0,0,0,0,22000,0,0,0,47000,25000,22000,22000
06192P,高股息中信98售01,0,0,0,0,0,0,0,0,0,22000,0,0,0,22000,0,22000,22000
06202P,大立光元大98售06,0,0,0,0,0,0,0,0,0,22000,0,0,0,22000,0,22000,22000
06155P,智邦統一97售02  ,0,0,0,0,0,0,0,0,0,22000,0,0,0,32000,10000,22000,22000
057416,T50反1凱基9C購01,0,0,0,0,0,0,0,0,0,22000,0,0,0,22000,0,22000,22000
05869P,旺宏凱基96售05  ,0,0,0,0,0,0,0,0,0,22000,0,0,0,47000,25000,22000,22000
04966P,台表科元大94售04,0,0,0,0,0,0,0,0,0,22000,0,0,0,32000,10000,22000,22000
05072P,聯電元富95售02  ,0,0,0,0,0,0,0,0,0,22000,0,0,0,22000,0,22000,22000
05543P,鴻海元富96售04  ,0,0,0,0,0,0,0,0,0,22000,0,0,0,23000,1000,22000,22000
050333,鴻海國泰96購06  ,0,0,0,0,0,0,0,0,0,22000,0,0,0,22000,0,22000,22000
04628P,欣興元大95售01  ,0,0,0,0,0,0,0,0,0,22000,0,0,0,22000,0,22000,22000
04745P,祥碩元大94售04  ,0,0,0,0,0,0,0,0,0,22000,0,0,0,22000,0,22000,22000
047298,聯茂元富96購01  ,0,0,0,0,0,0,0,0,0,22000,0,0,0,22000,0,22000,22000
04564P,大立光凱基94售06,0,0,0,0,0,0,0,0,0,22000,0,0,0,90000,68000,22000,22000
056164,聯茂凱基98購03  ,0,0,0,0,0,0,0,0,0,22000,0,0,0,22000,0,22000,22000
05461P,台積電亞東97售01,0,0,0,0,0,0,0,0,0,22000,0,0,0,539000,517000,22000,22000
053591,大立光元大99購03,0,0,0,0,0,0,0,0,0,22000,0,0,0,22000,0,22000,22000
05400P,台積電永豐95售05,0,0,0,0,0,0,0,0,0,22000,0,0,0,22000,0,22000,22000
053274,旺宏元大98購03  ,0,0,0,0,0,0,0,0,0,22000,0,0,0,22000,0,22000,22000
05264P,微星元大95售02  ,0,0,0,0,0,0,0,0,0,22000,0,0,0,22000,0,22000,22000
056727,滬深反凱基9B購01,0,0,0,0,0,0,0,0,0,22000,0,0,0,22000,0,22000,22000
056651,聯茂凱基98購04  ,0,0,0,0,0,0,0,0,0,22000,0,0,0,32000,10000,22000,22000
3090,日電貿          ,1079000,1054000,25000,0,0,0,0,0,0,-3000,10000,0,10000,1000,14000,-13000,22000
9902,台火            ,37000,15000,22000,0,0,0,0,0,0,0,0,0,0,0,0,0,22000
06216P,上銀元富97售03  ,0,0,0,0,0,0,0,0,0,21000,0,0,0,41000,20000,21000,21000
06106P,國巨群益97售02  ,0,0,0,0,0,0,0,0,0,21000,0,0,0,21000,0,21000,21000
05915P,聯發科元大96售19,0,0,0,0,0,0,0,0,0,21000,0,0,0,21000,0,21000,21000
06395P,台積電元大97售29,0,0,0,0,0,0,0,0,0,21000,0,0,0,319000,298000,21000,21000
06460P,亞德客元富98售02,0,0,0,0,0,0,0,0,0,21000,0,0,0,21000,0,21000,21000
06644P,亞德客元大98售03,0,0,0,0,0,0,0,0,0,21000,0,0,0,75000,54000,21000,21000
06788P,臺股指元大98售05,0,0,0,0,0,0,0,0,0,21000,0,0,0,21000,0,21000,21000
06782P,大立光元大99售07,0,0,0,0,0,0,0,0,0,21000,0,0,0,76000,55000,21000,21000
04704P,臺股指統一95售01,0,0,0,0,0,0,0,0,0,21000,0,0,0,21000,0,21000,21000
04495P,台積電國票95售01,0,0,0,0,0,0,0,0,0,21000,0,0,0,21000,0,21000,21000
04869P,鴻海元富95售02  ,0,0,0,0,0,0,0,0,0,21000,0,0,0,21000,0,21000,21000
03298P,台積電統一03售15,0,0,0,0,0,0,0,0,0,21000,0,0,0,321000,300000,21000,21000
051248,華固元大95購01  ,0,0,0,0,0,0,0,0,0,21000,0,0,0,32000,11000,21000,21000
05662P,景碩元富96售01  ,0,0,0,0,0,0,0,0,0,21000,0,0,0,21000,0,21000,21000
055331,國巨兆豐99購01  ,0,0,0,0,0,0,0,0,0,21000,0,0,0,21000,0,21000,21000
052602,聯電元大97購01  ,0,0,0,0,0,0,0,0,0,21000,0,0,0,31000,10000,21000,21000
05362P,可成富邦97售02  ,0,0,0,0,0,0,0,0,0,21000,0,0,0,21000,0,21000,21000
05722P,玉晶光國票97售03,0,0,0,0,0,0,0,0,0,21000,0,0,0,50000,29000,21000,21000
06777P,鴻海元大99售06  ,0,0,0,0,0,0,0,0,0,20000,0,0,0,110000,90000,20000,20000
06921P,台光電凱基98售06,0,0,0,0,0,0,0,0,0,20000,0,0,0,20000,0,20000,20000
06962P,華新科永豐99售01,0,0,0,0,0,0,0,0,0,20000,0,0,0,20000,0,20000,20000
06963P,鴻海凱基99售04  ,0,0,0,0,0,0,0,0,0,20000,0,0,0,575000,555000,20000,20000
07094P,華通國票9A售03  ,0,0,0,0,0,0,0,0,0,20000,0,0,0,20000,0,20000,20000
1522,堤維西          ,247000,194000,53000,0,0,0,0,0,0,-33000,1000,34000,-33000,0,0,0,20000
06631P,玉晶光群益9A售03,0,0,0,0,0,0,0,0,0,20000,0,0,0,20000,0,20000,20000
06507P,台表科國票99售01,0,0,0,0,0,0,0,0,0,20000,0,0,0,20000,0,20000,20000
06605P,玉晶光元富98售03,0,0,0,0,0,0,0,0,0,20000,0,0,0,20000,0,20000,20000
06606P,訊芯元富98售02  ,0,0,0,0,0,0,0,0,0,20000,0,0,0,20000,0,20000,20000
06430P,大立光元大97售16,0,0,0,0,0,0,0,0,0,20000,0,0,0,20000,0,20000,20000
06348P,鈺齊元富97售02  ,0,0,0,0,0,0,0,0,0,20000,0,0,0,20000,0,20000,20000
06064P,台積電台新98售01,0,0,0,0,0,0,0,0,0,20000,0,0,0,140000,120000,20000,20000
06075P,智邦凱基97售02  ,0,0,0,0,0,0,0,0,0,20000,0,0,0,22000,2000,20000,20000
06042P,華新科永豐96售04,0,0,0,0,0,0,0,0,0,20000,0,0,0,20000,0,20000,20000
06139P,台積電中信99售02,0,0,0,0,0,0,0,0,0,20000,0,0,0,30000,10000,20000,20000
058701,鴻海元大99購16  ,0,0,0,0,0,0,0,0,0,20000,0,0,0,20000,0,20000,20000
058637,晶技兆豐99購01  ,0,0,0,0,0,0,0,0,0,20000,0,0,0,20000,0,20000,20000
058353,國巨凱基99購09  ,0,0,0,0,0,0,0,0,0,20000,0,0,0,20000,0,20000,20000
058335,鴻海元富99購06  ,0,0,0,0,0,0,0,0,0,20000,0,0,0,20000,0,20000,20000
058331,鴻海元富99購02  ,0,0,0,0,0,0,0,0,0,20000,0,0,0,20000,0,20000,20000
058405,訊連元大99購02  ,0,0,0,0,0,0,0,0,0,20000,0,0,0,30000,10000,20000,20000
058438,大立光統一9B購01,0,0,0,0,0,0,0,0,0,20000,0,0,0,20000,0,20000,20000
059016,晶相光元富99購03,0,0,0,0,0,0,0,0,0,20000,0,0,0,20000,0,20000,20000
058791,鴻海元大99購17  ,0,0,0,0,0,0,0,0,0,20000,0,0,0,61000,41000,20000,20000
057445,華通元富02購01  ,0,0,0,0,0,0,0,0,0,20000,0,0,0,50000,30000,20000,20000
057524,旺宏元大99購04  ,0,0,0,0,0,0,0,0,0,20000,0,0,0,20000,0,20000,20000
057545,國巨凱基99購05  ,0,0,0,0,0,0,0,0,0,20000,0,0,0,20000,0,20000,20000
057536,康控元大99購03  ,0,0,0,0,0,0,0,0,0,20000,0,0,0,20000,0,20000,20000
057713,美律統一99購01  ,0,0,0,0,0,0,0,0,0,20000,0,0,0,20000,0,20000,20000
057786,聯發科國票98購05,0,0,0,0,0,0,0,0,0,20000,0,0,0,20000,0,20000,20000
057791,可成統一99購01  ,0,0,0,0,0,0,0,0,0,20000,0,0,0,20000,0,20000,20000
057820,華擎元大98購02  ,0,0,0,0,0,0,0,0,0,20000,0,0,0,20000,0,20000,20000
058236,大立光元大99購09,0,0,0,0,0,0,0,0,0,20000,0,0,0,40000,20000,20000,20000
058273,同欣電永豐99購01,0,0,0,0,0,0,0,0,0,20000,0,0,0,20000,0,20000,20000
057998,玉晶光麥證9A購01,0,0,0,20000,0,20000,0,0,0,20000,0,0,0,20000,0,20000,20000
057875,京鼎元大98購03  ,0,0,0,0,0,0,0,0,0,20000,0,0,0,20000,0,20000,20000
058098,T50反1國泰9A購02,0,0,0,0,0,0,0,0,0,20000,0,0,0,20000,0,20000,20000
051239,國巨元大96購02  ,0,0,0,0,0,0,0,0,0,20000,0,0,0,20000,0,20000,20000
051382,玉晶光群益98購02,0,0,0,0,0,0,0,0,0,20000,0,0,0,50000,30000,20000,20000
050881,大立光元富95購04,0,0,0,0,0,0,0,0,0,20000,0,0,0,20000,0,20000,20000
050964,晶技永豐95購02  ,0,0,0,0,0,0,0,0,0,20000,0,0,0,45000,25000,20000,20000
049024,玉晶光群益97購01,0,0,0,0,0,0,0,0,0,20000,0,0,0,40000,20000,20000,20000
049091,訊連凱基94購01  ,0,0,0,0,0,0,0,0,0,20000,0,0,0,20000,0,20000,20000
05224P,華通統一95售03  ,0,0,0,0,0,0,0,0,0,20000,0,0,0,20000,0,20000,20000
055971,矽力元大97購05  ,0,0,0,0,0,0,0,0,0,20000,0,0,0,20000,0,20000,20000
055951,大成鋼元大97購02,0,0,0,0,0,0,0,0,0,20000,0,0,0,20000,0,20000,20000
055861,矽力元大97購03  ,0,0,0,0,0,0,0,0,0,20000,0,0,0,20000,0,20000,20000
051647,華新科永豐95購02,0,0,0,0,0,0,0,0,0,20000,0,0,0,20000,0,20000,20000
05547P,群創元大96售03  ,0,0,0,0,0,0,0,0,0,20000,0,0,0,20000,0,20000,20000
055499,大立光元大98購05,0,0,0,0,0,0,0,0,0,20000,0,0,0,20000,0,20000,20000
05551P,電子類元大96售01,0,0,0,0,0,0,0,0,0,20000,0,0,0,27000,7000,20000,20000
050687,上銀日盛94購01  ,0,0,0,0,0,0,0,0,0,20000,0,0,0,20000,0,20000,20000
04958P,和大凱基94售04  ,0,0,0,0,0,0,0,0,0,20000,0,0,0,20000,0,20000,20000
05216P,國巨永豐95售02  ,0,0,0,0,0,0,0,0,0,20000,0,0,0,20000,0,20000,20000
051688,大立光凱基97購02,0,0,0,0,0,0,0,0,0,20000,0,0,0,20000,0,20000,20000
052133,華邦電凱基9B購01,0,0,0,0,0,0,0,0,0,20000,0,0,0,20000,0,20000,20000
051160,亞德客元大95購02,0,0,0,0,0,0,0,0,0,20000,0,0,0,20000,0,20000,20000
051202,智邦麥證95購01  ,0,0,0,20000,0,20000,0,0,0,20000,0,0,0,20000,0,20000,20000
051225,台積電群益95購02,0,0,0,0,0,0,0,0,0,20000,0,0,0,20000,0,20000,20000
049676,美食國票94購01  ,0,0,0,0,0,0,0,0,0,20000,0,0,0,20000,0,20000,20000
049685,T50反1元大94購01,0,0,0,0,0,0,0,0,0,20000,0,0,0,20000,0,20000,20000
049316,茂林凱基94購02  ,0,0,0,0,0,0,0,0,0,20000,0,0,0,20000,0,20000,20000
04920P,智易凱基94售05  ,0,0,0,0,0,0,0,0,0,20000,0,0,0,20000,0,20000,20000
049385,茂林元大94購03  ,0,0,0,0,0,0,0,0,0,20000,0,0,0,20000,0,20000,20000
051933,嘉聯益國票97購03,0,0,0,0,0,0,0,0,0,20000,0,0,0,20000,0,20000,20000
050572,大立光中信97購01,0,0,0,0,0,0,0,0,0,20000,0,0,0,20000,0,20000,20000
050609,鴻海元大94購23  ,0,0,0,0,0,0,0,0,0,20000,0,0,0,30000,10000,20000,20000
051971,元金2X凱基97購02,0,0,0,0,0,0,0,0,0,20000,0,0,0,20000,0,20000,20000
051961,泰碩永豐95購01  ,0,0,0,0,0,0,0,0,0,20000,0,0,0,20000,0,20000,20000
051969,世紀鋼永豐95購01,0,0,0,0,0,0,0,0,0,20000,0,0,0,20000,0,20000,20000
03154P,華新科群益01售07,0,0,0,0,0,0,0,0,0,20000,0,0,0,30000,10000,20000,20000
03890P,聯詠國泰94售02  ,0,0,0,0,0,0,0,0,0,20000,0,0,0,20000,0,20000,20000
04022P,群創元富96售04  ,0,0,0,0,0,0,0,0,0,20000,0,0,0,20000,0,20000,20000
04842P,群創元大96售02  ,0,0,0,0,0,0,0,0,0,20000,0,0,0,30000,10000,20000,20000
04451P,可成凱基94售04  ,0,0,0,0,0,0,0,0,0,20000,0,0,0,20000,0,20000,20000
04419P,奇力新永豐94售01,0,0,0,0,0,0,0,0,0,20000,0,0,0,20000,0,20000,20000
04865P,台積電亞東95售01,0,0,0,0,0,0,0,0,0,20000,0,0,0,560000,540000,20000,20000
04249P,大立光統一94售04,0,0,0,0,0,0,0,0,0,20000,0,0,0,20000,0,20000,20000
04293P,滬深2X元大96售02,0,0,0,0,0,0,0,0,0,20000,0,0,0,20000,0,20000,20000
043202,緯穎元大94購01  ,0,0,0,0,0,0,0,0,0,20000,0,0,0,20000,0,20000,20000
04198P,滬深2X群益95售04,0,0,0,0,0,0,0,0,0,20000,0,0,0,20000,0,20000,20000
04690P,國巨群益94售06  ,0,0,0,0,0,0,0,0,0,20000,0,0,0,65000,45000,20000,20000
04882P,鴻海凱基94售19  ,0,0,0,0,0,0,0,0,0,20000,0,0,0,20000,0,20000,20000
047073,大立光兆豐94購01,0,0,0,0,0,0,0,0,0,20000,0,0,0,20000,0,20000,20000
045754,大立光國泰94購03,0,0,0,0,0,0,0,0,0,20000,0,0,0,20000,0,20000,20000
04807P,聯茂元富94售01  ,0,0,0,0,0,0,0,0,0,20000,0,0,0,20000,0,20000,20000
04798P,牧德元大95售02  ,0,0,0,0,0,0,0,0,0,20000,0,0,0,116000,96000,20000,20000
04734P,上海銀兆豐94售02,0,0,0,0,0,0,0,0,0,20000,0,0,0,20000,0,20000,20000
048186,元黃金元大96購01,0,0,0,0,0,0,0,0,0,20000,0,0,0,20000,0,20000,20000
04630P,嘉聯益元大95售02,0,0,0,0,0,0,0,0,0,20000,0,0,0,20000,0,20000,20000
04633P,旺宏群益96售04  ,0,0,0,0,0,0,0,0,0,20000,0,0,0,20000,0,20000,20000
046341,A50正2國票93購01,0,0,0,0,0,0,0,0,0,20000,0,0,0,20000,0,20000,20000
050264,聯發科元大94購13,0,0,0,0,0,0,0,0,0,20000,0,0,0,20000,0,20000,20000
050303,S&P反1中信96購01,0,0,0,0,0,0,0,0,0,20000,0,0,0,20000,0,20000,20000
050395,大立光元富94購10,0,0,0,0,0,0,0,0,0,20000,0,0,0,20000,0,20000,20000
051906,國巨元大95購09  ,0,0,0,0,0,0,0,0,0,20000,0,0,0,20000,0,20000,20000
05720P,可成中信98售01  ,0,0,0,0,0,0,0,0,0,20000,0,0,0,23000,3000,20000,20000
057312,美律麥證98購01  ,0,0,0,20000,0,20000,0,0,0,20000,0,0,0,20000,0,20000,20000
057279,國揚元大98購01  ,0,0,0,0,0,0,0,0,0,20000,0,0,0,50000,30000,20000,20000
057013,聯發科麥證98購01,0,0,0,50000,160000,-110000,0,0,0,20000,0,0,0,180000,160000,20000,20000
05702P,矽創凱基96售02  ,0,0,0,0,0,0,0,0,0,20000,0,0,0,30000,10000,20000,20000
056936,禾伸堂元富98購01,0,0,0,0,0,0,0,0,0,20000,0,0,0,20000,0,20000,20000
057055,立積元大99購01  ,0,0,0,0,0,0,0,0,0,20000,0,0,0,20000,0,20000,20000
055152,旺宏元大98購04  ,0,0,0,0,0,0,0,0,0,20000,0,0,0,20000,0,20000,20000
05501P,健策國票97售01  ,0,0,0,0,0,0,0,0,0,20000,0,0,0,20000,0,20000,20000
055241,T50反1統一99購01,0,0,0,0,0,0,0,0,0,20000,0,0,0,20000,0,20000,20000
055248,可成統一97購02  ,0,0,0,0,0,0,0,0,0,20000,0,0,0,20000,0,20000,20000
055355,大立光凱基97購05,0,0,0,0,0,0,0,0,0,20000,0,0,0,20000,0,20000,20000
053977,新日興元大96購03,0,0,0,0,0,0,0,0,0,20000,0,0,0,20000,0,20000,20000
054082,楠梓電元富96購01,0,0,0,0,0,0,0,0,0,20000,0,0,0,20000,0,20000,20000
053778,旺宏元大97購03  ,0,0,0,0,0,0,0,0,0,20000,0,0,0,20000,0,20000,20000
053729,聯茂凱基96購05  ,0,0,0,0,0,0,0,0,0,20000,0,0,0,20000,0,20000,20000
053787,健策元大97購02  ,0,0,0,0,0,0,0,0,0,20000,0,0,0,20000,0,20000,20000
053818,富邦金群益98購01,0,0,0,0,0,0,0,0,0,20000,0,0,0,20000,0,20000,20000
054951,大毅元大97購01  ,0,0,0,0,0,0,0,0,0,20000,0,0,0,20000,0,20000,20000
054986,藍天元富97購01  ,0,0,0,0,0,0,0,0,0,20000,0,0,0,20000,0,20000,20000
054972,聯茂元大97購02  ,0,0,0,0,0,0,0,0,0,20000,0,0,0,20000,0,20000,20000
052607,大立光元大96購03,0,0,0,0,0,0,0,0,0,20000,0,0,0,20000,0,20000,20000
052519,旺宏元大95購05  ,0,0,0,0,0,0,0,0,0,20000,0,0,0,42000,22000,20000,20000
052530,台郡元大96購04  ,0,0,0,0,0,0,0,0,0,20000,0,0,0,20000,0,20000,20000
052532,台積電國泰96購07,0,0,0,0,0,0,0,0,0,20000,0,0,0,20000,0,20000,20000
053369,T50反1元大96購06,0,0,0,0,0,0,0,0,0,20000,0,0,0,20000,0,20000,20000
053382,友達元大9C購02  ,0,0,0,0,0,0,0,0,0,20000,0,0,0,20000,0,20000,20000
053400,緯穎中信9A購01  ,0,0,0,0,0,0,0,0,0,20000,0,0,0,20000,0,20000,20000
056768,宏達電元大99購03,0,0,0,0,0,0,0,0,0,20000,0,0,0,50000,30000,20000,20000
056775,康控元大99購01  ,0,0,0,0,0,0,0,0,0,20000,0,0,0,20000,0,20000,20000
05680P,聯發科元大96售12,0,0,0,0,0,0,0,0,0,20000,0,0,0,20000,0,20000,20000
05679P,台表科群益96售05,0,0,0,0,0,0,0,0,0,20000,0,0,0,20000,0,20000,20000
052727,仁寶元富96購01  ,0,0,0,0,0,0,0,0,0,20000,0,0,0,30000,10000,20000,20000
056140,康控元大98購01  ,0,0,0,0,0,0,0,0,0,20000,0,0,0,20000,0,20000,20000
053112,中磊兆豐97購01  ,0,0,0,0,0,0,0,0,0,20000,0,0,0,20000,0,20000,20000
056646,奇鋐凱基99購02  ,0,0,0,0,0,0,0,0,0,20000,0,0,0,20000,0,20000,20000
056550,瑞儀凱基99購01  ,0,0,0,0,0,0,0,0,0,20000,0,0,0,60000,40000,20000,20000
056551,台郡凱基98購04  ,0,0,0,0,0,0,0,0,0,20000,0,0,0,20000,0,20000,20000
2486,一詮            ,79000,69000,10000,0,0,0,0,0,0,10000,11000,1000,10000,0,0,0,20000
058035,旭富永豐98購02  ,0,0,0,0,0,0,0,0,0,19000,0,0,0,29000,10000,19000,19000
057870,大立光凱基99購02,0,0,0,0,0,0,0,0,0,19000,0,0,0,30000,11000,19000,19000
057923,晶豪科凱基98購02,0,0,0,0,0,0,0,0,0,19000,0,0,0,20000,1000,19000,19000
058421,國泰金麥證01購01,0,0,0,19000,0,19000,0,0,0,19000,0,0,0,19000,0,19000,19000
058499,滬深2X元大9C購01,0,0,0,0,0,0,0,0,0,19000,0,0,0,25000,6000,19000,19000
06573P,台積電永昌99售02,0,0,0,0,0,0,0,0,0,19000,0,0,0,32000,13000,19000,19000
08672P,聯發科統一01售09,0,0,0,0,0,0,0,0,0,19000,0,0,0,19000,0,19000,19000
07082P,美律元大99售06  ,0,0,0,0,0,0,0,0,0,19000,0,0,0,39000,20000,19000,19000
06852P,臺股指元大98售11,0,0,0,0,0,0,0,0,0,19000,0,0,0,86000,67000,19000,19000
050218,世紀鋼統一94購02,0,0,0,0,0,0,0,0,0,19000,0,0,0,19000,0,19000,19000
050579,聯發科國票95購04,0,0,0,0,0,0,0,0,0,19000,0,0,0,19000,0,19000,19000
04935P,鴻海中信96售01  ,0,0,0,0,0,0,0,0,0,19000,0,0,0,30000,11000,19000,19000
049973,T50反1日盛9A購01,0,0,0,0,0,0,0,0,0,19000,0,0,0,40000,21000,19000,19000
052378,矽力元大96購01  ,0,0,0,0,0,0,0,0,0,19000,0,0,0,19000,0,19000,19000
056764,友達元大9A購03  ,0,0,0,0,0,0,0,0,0,19000,0,0,0,29000,10000,19000,19000
053345,欣興國票97購02  ,0,0,0,0,0,0,0,0,0,19000,0,0,0,19000,0,19000,19000
052518,道瓊反元大95購02,0,0,0,0,0,0,0,0,0,19000,0,0,0,55000,36000,19000,19000
053732,S&P反1中信9C購01,0,0,0,0,0,0,0,0,0,19000,0,0,0,19000,0,19000,19000
053975,大立光元大98購04,0,0,0,0,0,0,0,0,0,19000,0,0,0,19000,0,19000,19000
055365,華通元大97購03  ,0,0,0,0,0,0,0,0,0,19000,0,0,0,20000,1000,19000,19000
055063,玉晶光永豐99購01,0,0,0,0,0,0,0,0,0,19000,0,0,0,29000,10000,19000,19000
057096,緯穎元富98購01  ,0,0,0,0,0,0,0,0,0,19000,0,0,0,30000,11000,19000,19000
3494,誠研            ,21000,2000,19000,0,0,0,0,0,0,0,0,0,0,0,0,0,19000
4571,鈞興-KY         ,19000,0,19000,0,0,0,0,0,0,0,0,0,0,0,0,0,19000
4108,懷特            ,20000,1000,19000,0,0,0,0,0,0,0,0,0,0,0,0,0,19000
6152,百一            ,35000,16000,19000,0,0,0,0,0,0,0,0,0,0,0,0,0,19000
5519,隆大            ,203000,164000,39000,0,0,0,0,0,0,-20000,0,20000,-20000,0,0,0,19000
06926P,可成群益9A售04  ,0,0,0,0,0,0,0,0,0,18000,0,0,0,19000,1000,18000,18000
06751P,旺宏凱基98售10  ,0,0,0,0,0,0,0,0,0,18000,0,0,0,18000,0,18000,18000
08539P,元油2X國票99售01,0,0,0,0,0,0,0,0,0,18000,0,0,0,18000,0,18000,18000
1737,臺鹽            ,56000,38000,18000,0,0,0,0,0,0,0,0,0,0,0,0,0,18000
1708,東鹼            ,62000,43000,19000,0,0,0,0,0,0,-1000,1000,2000,-1000,0,0,0,18000
06656P,GIS元大98售02   ,0,0,0,0,0,0,0,0,0,18000,0,0,0,22000,4000,18000,18000
06232P,智易永豐97售01  ,0,0,0,0,0,0,0,0,0,18000,0,0,0,28000,10000,18000,18000
05965P,健策凱基96售05  ,0,0,0,0,0,0,0,0,0,18000,0,0,0,20000,2000,18000,18000
051272,嘉晶群益95購01  ,0,0,0,0,0,0,0,0,0,18000,0,0,0,18000,0,18000,18000
05097P,聯發科日盛95售01,0,0,0,0,0,0,0,0,0,18000,0,0,0,18000,0,18000,18000
055852,聯鈞元大98購01  ,0,0,0,0,0,0,0,0,0,18000,0,0,0,18000,0,18000,18000
051722,玉晶光永豐97購01,0,0,0,0,0,0,0,0,0,18000,0,0,0,41000,23000,18000,18000
049559,香港反統一94購02,0,0,0,0,0,0,0,0,0,18000,0,0,0,18000,0,18000,18000
043784,鴻海凱基94購01  ,0,0,0,0,0,0,0,0,0,18000,0,0,0,20000,2000,18000,18000
048440,國巨凱基93購08  ,0,0,0,0,0,0,0,0,0,18000,0,0,0,30000,12000,18000,18000
03422B,臺股指凱基96熊28,0,0,0,0,0,0,0,0,0,18000,0,0,0,40000,22000,18000,18000
057223,富邦金日盛99購01,0,0,0,0,0,0,0,0,0,18000,0,0,0,18000,0,18000,18000
057138,亞德客兆豐98購01,0,0,0,0,0,0,0,0,0,18000,0,0,0,97000,79000,18000,18000
05729P,臺股指凱基97售02,0,0,0,0,0,0,0,0,0,18000,0,0,0,18000,0,18000,18000
057022,智邦凱基98購04  ,0,0,0,0,0,0,0,0,0,18000,0,0,0,38000,20000,18000,18000
053557,聯茂凱基96購04  ,0,0,0,0,0,0,0,0,0,18000,0,0,0,18000,0,18000,18000
05380P,鴻海群益95售11  ,0,0,0,0,0,0,0,0,0,18000,0,0,0,18000,0,18000,18000
052421,元油反國票9B購01,0,0,0,0,0,0,0,0,0,18000,0,0,0,18000,0,18000,18000
052576,聯茂凱基96購01  ,0,0,0,0,0,0,0,0,0,18000,0,0,0,18000,0,18000,18000
05295P,緯創凱基95售01  ,0,0,0,0,0,0,0,0,0,18000,0,0,0,129000,111000,18000,18000
056346,聯茂凱基99購02  ,0,0,0,0,0,0,0,0,0,18000,0,0,0,18000,0,18000,18000
055809,T50反1國票98購02,0,0,0,0,0,0,0,0,0,18000,0,0,0,18000,0,18000,18000
05576P,群創日盛99售02  ,0,0,0,0,0,0,0,0,0,18000,0,0,0,18000,0,18000,18000
2471,資通            ,27000,10000,17000,0,0,0,0,0,0,1000,1000,0,1000,0,0,0,18000
2028,威致            ,25000,7000,18000,0,0,0,0,0,0,0,0,0,0,0,0,0,18000
06014P,聯發科富邦97售02,0,0,0,0,0,0,0,0,0,17000,0,0,0,77000,60000,17000,17000
06270P,致伸凱基97售03  ,0,0,0,0,0,0,0,0,0,17000,0,0,0,17000,0,17000,17000
06402P,鴻海元富97售14  ,0,0,0,0,0,0,0,0,0,17000,0,0,0,17000,0,17000,17000
1312A,國喬特          ,0,0,0,0,0,0,0,0,0,17000,17000,0,17000,0,0,0,17000
06761P,台積電元大99售05,0,0,0,0,0,0,0,0,0,17000,0,0,0,221000,204000,17000,17000
06834P,訊芯群益99售02  ,0,0,0,0,0,0,0,0,0,17000,0,0,0,17000,0,17000,17000
06934P,聯鈞元大98售03  ,0,0,0,0,0,0,0,0,0,17000,0,0,0,17000,0,17000,17000
06939P,國巨永豐98售09  ,0,0,0,0,0,0,0,0,0,17000,0,0,0,17000,0,17000,17000
058397,大成鋼元大99購02,0,0,0,0,0,0,0,0,0,17000,0,0,0,36000,19000,17000,17000
058732,矽格永豐99購01  ,0,0,0,0,0,0,0,0,0,17000,0,0,0,17000,0,17000,17000
058038,滬深反元大98購01,0,0,0,0,0,0,0,0,0,17000,0,0,0,17000,0,17000,17000
058248,聯茂元大99購05  ,0,0,0,0,0,0,0,0,0,17000,0,0,0,40000,23000,17000,17000
057769,T50反1群益98購02,0,0,0,0,0,0,0,0,0,17000,0,0,0,17000,0,17000,17000
046740,大立光群益95購01,0,0,0,0,0,0,0,0,0,17000,0,0,0,17000,0,17000,17000
048051,大立光中信94購03,0,0,0,0,0,0,0,0,0,17000,0,0,0,17000,0,17000,17000
050745,茂林永豐94購06  ,0,0,0,0,0,0,0,0,0,17000,0,0,0,40000,23000,17000,17000
052142,滬深2X群益99購04,0,0,0,0,0,0,0,0,0,17000,0,0,0,17000,0,17000,17000
051721,玉晶光永豐96購02,0,0,0,0,0,0,0,0,0,17000,0,0,0,33000,16000,17000,17000
055494,華新科元大98購01,0,0,0,0,0,0,0,0,0,17000,0,0,0,17000,0,17000,17000
053135,信邦國票96購01  ,0,0,0,0,0,0,0,0,0,17000,0,0,0,17000,0,17000,17000
056131,鴻海元大97購12  ,0,0,0,0,0,0,0,0,0,17000,0,0,0,17000,0,17000,17000
052937,國巨兆豐97購01  ,0,0,0,0,0,0,0,0,0,17000,0,0,0,27000,10000,17000,17000
05304P,國巨國泰97售02  ,0,0,0,0,0,0,0,0,0,17000,0,0,0,17000,0,17000,17000
056776,聯茂元大99購01  ,0,0,0,0,0,0,0,0,0,17000,0,0,0,20000,3000,17000,17000
056846,晶相光元富98購01,0,0,0,0,0,0,0,0,0,17000,0,0,0,20000,3000,17000,17000
053876,可成永昌98購01  ,0,0,0,0,0,0,0,0,0,17000,0,0,0,17000,0,17000,17000
057006,國巨中信98購03  ,0,0,0,0,0,0,0,0,0,17000,0,0,0,17000,0,17000,17000
054809,大成鋼元大97購01,0,0,0,0,0,0,0,0,0,17000,0,0,0,20000,3000,17000,17000
056919,英業達兆豐98購01,0,0,0,0,0,0,0,0,0,17000,0,0,0,117000,100000,17000,17000
2423,固緯            ,56000,45000,11000,0,0,0,0,0,0,6000,6000,0,6000,0,0,0,17000
8249,菱光            ,49000,35000,14000,0,0,0,0,0,0,3000,3000,0,3000,0,0,0,17000
8454,富邦媒          ,84000,69866,14134,0,0,0,1000,0,1000,1000,1000,0,1000,0,0,0,16134
058368,奇鋐凱基9A購01  ,0,0,0,0,0,0,0,0,0,16000,0,0,0,16000,0,16000,16000
07079P,台積電群益99售06,0,0,0,0,0,0,0,0,0,16000,0,0,0,16000,0,16000,16000
06342P,世芯統一98售01  ,0,0,0,0,0,0,0,0,0,16000,0,0,0,16000,0,16000,16000
06338P,亞德客統一97售02,0,0,0,0,0,0,0,0,0,16000,0,0,0,18000,2000,16000,16000
06688P,鴻海中信02售01  ,0,0,0,0,0,0,0,0,0,16000,0,0,0,16000,0,16000,16000
049582,台積電元大95購03,0,0,0,0,0,0,0,0,0,16000,0,0,0,16000,0,16000,16000
049484,台積電元大95購02,0,0,0,0,0,0,0,0,0,16000,0,0,0,113000,97000,16000,16000
04559P,華通凱基94售03  ,0,0,0,0,0,0,0,0,0,16000,0,0,0,16000,0,16000,16000
051848,元金2X中信98購02,0,0,0,0,0,0,0,0,0,16000,0,0,0,18000,2000,16000,16000
04322P,可成元大94售01  ,0,0,0,0,0,0,0,0,0,16000,0,0,0,16000,0,16000,16000
054922,文曄凱基98購01  ,0,0,0,0,0,0,0,0,0,16000,0,0,0,186000,170000,16000,16000
055753,貿聯第一98購01  ,0,0,0,0,0,0,0,0,0,16000,0,0,0,16000,0,16000,16000
056536,義隆凱基98購04  ,0,0,0,0,0,0,0,0,0,16000,0,0,0,68000,52000,16000,16000
6226,光鼎            ,179000,167000,12000,0,0,0,0,0,0,4000,5000,1000,4000,0,0,0,16000
3257,虹冠電          ,46000,30000,16000,0,0,0,0,0,0,0,0,0,0,0,0,0,16000
2891B,中信金乙特      ,14000,0,14000,0,0,0,0,0,0,2000,2000,0,2000,0,0,0,16000
06386P,欣興永豐97售03  ,0,0,0,0,0,0,0,0,0,15000,0,0,0,15000,0,15000,15000
06114P,台積電統一97售03,0,0,0,0,0,0,0,0,0,15000,0,0,0,15000,0,15000,15000
06208P,台郡凱基97售03  ,0,0,0,0,0,0,0,0,0,15000,0,0,0,21000,6000,15000,15000
07053P,台灣50兆豐01售01,0,0,0,0,0,0,0,0,0,15000,0,0,0,15000,0,15000,15000
07038P,華新科台新99售01,0,0,0,0,0,0,0,0,0,15000,0,0,0,15000,0,15000,15000
1452,宏益            ,43000,28000,15000,0,0,0,0,0,0,0,0,0,0,0,0,0,15000
05862P,大立光國泰98售01,0,0,0,0,0,0,0,0,0,15000,0,0,0,15000,0,15000,15000
058544,FBVIX富邦9B購01 ,0,0,0,0,0,0,0,0,0,15000,0,0,0,15000,0,15000,15000
057826,祥碩元大98購08  ,0,0,0,0,0,0,0,0,0,15000,0,0,0,40000,25000,15000,15000
057851,鴻海國票99購06  ,0,0,0,0,0,0,0,0,0,15000,0,0,0,30000,15000,15000,15000
057686,中50凱基99購01  ,0,0,0,0,0,0,0,0,0,15000,0,0,0,15000,0,15000,15000
057400,全新群益9A購01  ,0,0,0,0,0,0,0,0,0,15000,0,0,0,15000,0,15000,15000
058204,世芯凱基9A購01  ,0,0,0,0,0,0,0,0,0,15000,0,0,0,15000,0,15000,15000
058042,鴻海元大98購12  ,0,0,0,0,0,0,0,0,0,15000,0,0,0,83000,68000,15000,15000
058019,美律凱基99購04  ,0,0,0,0,0,0,0,0,0,15000,0,0,0,15000,0,15000,15000
05790P,臺股指永昌96售07,0,0,0,0,0,0,0,0,0,15000,0,0,0,25000,10000,15000,15000
057964,緯穎元大99購03  ,0,0,0,0,0,0,0,0,0,15000,0,0,0,20000,5000,15000,15000
057969,緯穎國泰99購01  ,0,0,0,0,0,0,0,0,0,15000,0,0,0,15000,0,15000,15000
042927,道瓊反中信94購01,0,0,0,0,0,0,0,0,0,15000,0,0,0,15000,0,15000,15000
04384P,上証2X中信96售01,0,0,0,0,0,0,0,0,0,15000,0,0,0,15000,0,15000,15000
04083P,欣興統一94售01  ,0,0,0,0,0,0,0,0,0,15000,0,0,0,15000,0,15000,15000
04591P,上銀元大94售01  ,0,0,0,0,0,0,0,0,0,15000,0,0,0,15000,0,15000,15000
04605P,台積電兆豐94售03,0,0,0,0,0,0,0,0,0,15000,0,0,0,499000,484000,15000,15000
05107P,鴻海兆豐96售02  ,0,0,0,0,0,0,0,0,0,15000,0,0,0,15000,0,15000,15000
050948,華固群益95購01  ,0,0,0,0,0,0,0,0,0,15000,0,0,0,15000,0,15000,15000
052231,景碩凱基96購01  ,0,0,0,0,0,0,0,0,0,15000,0,0,0,15000,0,15000,15000
052234,GIS凱基97購01   ,0,0,0,0,0,0,0,0,0,15000,0,0,0,20000,5000,15000,15000
055775,友達凱基9A購01  ,0,0,0,0,0,0,0,0,0,15000,0,0,0,15000,0,15000,15000
056054,亞德客元大97購05,0,0,0,0,0,0,0,0,0,15000,0,0,0,20000,5000,15000,15000
055286,晶技元大98購03  ,0,0,0,0,0,0,0,0,0,15000,0,0,0,15000,0,15000,15000
05291P,鴻海凱基95售16  ,0,0,0,0,0,0,0,0,0,15000,0,0,0,65000,50000,15000,15000
053331,玉晶光永豐97購02,0,0,0,0,0,0,0,0,0,15000,0,0,0,20000,5000,15000,15000
054520,健鼎元大96購02  ,0,0,0,0,0,0,0,0,0,15000,0,0,0,20000,5000,15000,15000
053823,茂林群益96購06  ,0,0,0,0,0,0,0,0,0,15000,0,0,0,15000,0,15000,15000
05444P,大立光元大95售10,0,0,0,0,0,0,0,0,0,15000,0,0,0,70000,55000,15000,15000
05445P,聯詠元大95售05  ,0,0,0,0,0,0,0,0,0,15000,0,0,0,15000,0,15000,15000
054811,裕隆元大9A購01  ,0,0,0,0,0,0,0,0,0,15000,0,0,0,55000,40000,15000,15000
055218,彩晶凱基99購01  ,0,0,0,0,0,0,0,0,0,15000,0,0,0,15000,0,15000,15000
057333,智邦國票99購01  ,0,0,0,0,0,0,0,0,0,15000,0,0,0,15000,0,15000,15000
057089,奇力新元富98購01,0,0,0,0,0,0,0,0,0,15000,0,0,0,15000,0,15000,15000
6281,全國電          ,27000,15000,12000,0,0,0,0,0,0,3000,4000,1000,3000,0,0,0,15000
8473,山林水          ,28000,13000,15000,0,0,0,0,0,0,0,0,0,0,0,0,0,15000
9911,櫻花            ,451000,397000,54000,0,0,0,0,0,0,-39000,1000,40000,-39000,0,0,0,15000
058598,T50反1元大99購04,0,0,0,0,0,0,0,0,0,14000,0,0,0,24000,10000,14000,14000
058399,美律元大99購05  ,0,0,0,0,0,0,0,0,0,14000,0,0,0,55000,41000,14000,14000
1467,南緯            ,19000,11000,8000,0,0,0,0,0,0,6000,12000,6000,6000,0,0,0,14000
1109,信大            ,84000,70000,14000,0,0,0,0,0,0,0,0,0,0,0,0,0,14000
06977P,臺股指元大9A售15,0,0,0,0,0,0,0,0,0,14000,0,0,0,17000,3000,14000,14000
07003P,聯發科兆豐99售02,0,0,0,0,0,0,0,0,0,14000,0,0,0,42000,28000,14000,14000
06161P,聯發科群益97售03,0,0,0,0,0,0,0,0,0,14000,0,0,0,14000,0,14000,14000
06015P,大立光富邦98售04,0,0,0,0,0,0,0,0,0,14000,0,0,0,20000,6000,14000,14000
05995P,T50正2中信9C售01,0,0,0,0,0,0,0,0,0,14000,0,0,0,14000,0,14000,14000
06349P,臺股指台新99售01,0,0,0,0,0,0,0,0,0,14000,0,0,0,14000,0,14000,14000
06608P,立積群益99售02  ,0,0,0,0,0,0,0,0,0,14000,0,0,0,55000,41000,14000,14000
06493P,聯發科永豐98售02,0,0,0,0,0,0,0,0,0,14000,0,0,0,39000,25000,14000,14000
04997P,燿華台新95售02  ,0,0,0,0,0,0,0,0,0,14000,0,0,0,14000,0,14000,14000
04994P,大成鋼凱基95售01,0,0,0,0,0,0,0,0,0,14000,0,0,0,20000,6000,14000,14000
049892,國巨富邦96購01  ,0,0,0,0,0,0,0,0,0,14000,0,0,0,14000,0,14000,14000
049843,康友中信95購01  ,0,0,0,0,0,0,0,0,0,14000,0,0,0,24000,10000,14000,14000
04961P,貿聯凱基94售03  ,0,0,0,0,0,0,0,0,0,14000,0,0,0,24000,10000,14000,14000
04767P,台積電國泰95售04,0,0,0,0,0,0,0,0,0,14000,0,0,0,414000,400000,14000,14000
04497P,元油2X富邦97售03,0,0,0,0,0,0,0,0,0,14000,0,0,0,14000,0,14000,14000
04693P,超眾群益95售01  ,0,0,0,0,0,0,0,0,0,14000,0,0,0,14000,0,14000,14000
04640P,上銀凱基94售05  ,0,0,0,0,0,0,0,0,0,14000,0,0,0,20000,6000,14000,14000
047303,寶滬深元大96購01,0,0,0,0,0,0,0,0,0,14000,0,0,0,14000,0,14000,14000
04025P,宏達電國泰94售01,0,0,0,0,0,0,0,0,0,14000,0,0,0,14000,0,14000,14000
044533,S&P反1中信94購02,0,0,0,0,0,0,0,0,0,14000,0,0,0,14000,0,14000,14000
057201,華擎元富98購01  ,0,0,0,0,0,0,0,0,0,14000,0,0,0,41000,27000,14000,14000
055060,聯陽永豐97購01  ,0,0,0,0,0,0,0,0,0,14000,0,0,0,37000,23000,14000,14000
054061,晶技國票97購03  ,0,0,0,0,0,0,0,0,0,14000,0,0,0,14000,0,14000,14000
053062,緯穎富邦97購01  ,0,0,0,0,0,0,0,0,0,14000,0,0,0,24000,10000,14000,14000
05668P,滬深2X永豐96售04,0,0,0,0,0,0,0,0,0,14000,0,0,0,15000,1000,14000,14000
052669,群創群益98購06  ,0,0,0,0,0,0,0,0,0,14000,0,0,0,14000,0,14000,14000
9906,欣巴巴          ,16000,2000,14000,0,0,0,0,0,0,0,0,0,0,0,0,0,14000
01001T,土銀富邦R1      ,13806,0,13806,0,0,0,0,0,0,0,0,0,0,0,0,0,13806
07065P,臺股指元大9A售26,0,0,0,0,0,0,0,0,0,13000,0,0,0,14000,1000,13000,13000
06843P,鴻海元大98售11  ,0,0,0,0,0,0,0,0,0,13000,0,0,0,105000,92000,13000,13000
1323,永裕            ,27000,14000,13000,0,0,0,0,0,0,0,0,0,0,0,0,0,13000
08599P,台表科元大9C售11,0,0,0,0,0,0,0,0,0,13000,0,0,0,13000,0,13000,13000
058410,國巨兆豐99購03  ,0,0,0,0,0,0,0,0,0,13000,0,0,0,23000,10000,13000,13000
058790,楠梓電元大99購03,0,0,0,0,0,0,0,0,0,13000,0,0,0,13000,0,13000,13000
058271,訊連永豐99購01  ,0,0,0,0,0,0,0,0,0,13000,0,0,0,13000,0,13000,13000
05740P,宏達電元富96售01,0,0,0,0,0,0,0,0,0,13000,0,0,0,13000,0,13000,13000
042692,台灣50凱基96購09,0,0,0,0,0,0,0,0,0,13000,0,0,0,13000,0,13000,13000
048288,T50反1群益93購05,0,0,0,0,0,0,0,0,0,13000,0,0,0,13000,0,13000,13000
03560P,台積電兆豐03售10,0,0,0,0,0,0,0,0,0,13000,0,0,0,14000,1000,13000,13000
05183P,台積電元富95售07,0,0,0,0,0,0,0,0,0,13000,0,0,0,13000,0,13000,13000
047024,奇力新元大95購01,0,0,0,0,0,0,0,0,0,13000,0,0,0,71000,58000,13000,13000
04479P,同欣電中信96售02,0,0,0,0,0,0,0,0,0,13000,0,0,0,13000,0,13000,13000
045250,華通凱基94購01  ,0,0,0,0,0,0,0,0,0,13000,0,0,0,13000,0,13000,13000
048102,矽力凱基94購01  ,0,0,0,0,0,0,0,0,0,13000,0,0,0,13000,0,13000,13000
047832,漢唐元大94購03  ,0,0,0,0,0,0,0,0,0,13000,0,0,0,23000,10000,13000,13000
049931,矽力元大94購01  ,0,0,0,0,0,0,0,0,0,13000,0,0,0,13000,0,13000,13000
04978P,台表科凱基94售02,0,0,0,0,0,0,0,0,0,13000,0,0,0,13000,0,13000,13000
05089P,亞德客元大95售01,0,0,0,0,0,0,0,0,0,13000,0,0,0,107000,94000,13000,13000
051452,貿聯元大95購04  ,0,0,0,0,0,0,0,0,0,13000,0,0,0,113000,100000,13000,13000
051597,T50反1中信99購02,0,0,0,0,0,0,0,0,0,13000,0,0,0,13000,0,13000,13000
055519,茂林中信99購01  ,0,0,0,0,0,0,0,0,0,13000,0,0,0,73000,60000,13000,13000
055722,聯鈞元大97購03  ,0,0,0,0,0,0,0,0,0,13000,0,0,0,13000,0,13000,13000
053383,京元電元大97購01,0,0,0,0,0,0,0,0,0,13000,0,0,0,52000,39000,13000,13000
055300,緯穎元大98購01  ,0,0,0,0,0,0,0,0,0,13000,0,0,0,53000,40000,13000,13000
053093,緯穎元大96購06  ,0,0,0,0,0,0,0,0,0,13000,0,0,0,24000,11000,13000,13000
053989,奇力新兆豐97購01,0,0,0,0,0,0,0,0,0,13000,0,0,0,203000,190000,13000,13000
054575,聯鈞元大97購01  ,0,0,0,0,0,0,0,0,0,13000,0,0,0,23000,10000,13000,13000
056979,微星群益98購01  ,0,0,0,0,0,0,0,0,0,13000,0,0,0,13000,0,13000,13000
2911,麗嬰房          ,29000,17000,12000,0,0,0,0,0,0,1000,1000,0,1000,0,0,0,13000
4999,鑫禾            ,21000,10000,11000,0,0,0,0,0,0,2000,2000,0,2000,0,0,0,13000
4552,力達-KY         ,79000,67000,12000,0,0,0,0,0,0,1000,1000,0,1000,0,0,0,13000
2358,廷鑫            ,55000,42000,13000,0,0,0,0,0,0,0,0,0,0,0,0,0,13000
2029,盛餘            ,40000,28000,12000,0,0,0,0,0,0,1000,1000,0,1000,0,0,0,13000
2705,六福            ,23000,10000,13000,0,0,0,0,0,0,0,0,0,0,0,0,0,13000
2476,鉅祥            ,29000,18400,10600,0,0,0,0,0,0,2000,2000,0,2000,0,0,0,12600
05781P,臺股指統一99售02,0,0,0,0,0,0,0,0,0,12000,0,0,0,12000,0,12000,12000
058246,帆宣元大99購01  ,0,0,0,0,0,0,0,0,0,12000,0,0,0,21000,9000,12000,12000
058167,鴻海凱基9A購03  ,0,0,0,0,0,0,0,0,0,12000,0,0,0,61000,49000,12000,12000
05850P,台積電兆豐96售06,0,0,0,0,0,0,0,0,0,12000,0,0,0,12000,0,12000,12000
1338,廣華-KY         ,103000,93000,10000,0,0,0,0,0,0,2000,2000,0,2000,0,0,0,12000
1517,利奇            ,26000,14000,12000,0,0,0,0,0,0,0,0,0,0,0,0,0,12000
06863P,欣興凱基98售05  ,0,0,0,0,0,0,0,0,0,12000,0,0,0,12000,0,12000,12000
06849P,欣興元大98售12  ,0,0,0,0,0,0,0,0,0,12000,0,0,0,13000,1000,12000,12000
06845P,億光元大98售02  ,0,0,0,0,0,0,0,0,0,12000,0,0,0,12000,0,12000,12000
06867P,訊芯元大98售08  ,0,0,0,0,0,0,0,0,0,12000,0,0,0,12000,0,12000,12000
06912P,台光電元大99售02,0,0,0,0,0,0,0,0,0,12000,0,0,0,12000,0,12000,12000
06967P,台郡台新99售02  ,0,0,0,0,0,0,0,0,0,12000,0,0,0,13000,1000,12000,12000
06943P,致茂元富98售03  ,0,0,0,0,0,0,0,0,0,12000,0,0,0,12000,0,12000,12000
06486P,麗豐元大98售02  ,0,0,0,0,0,0,0,0,0,12000,0,0,0,53000,41000,12000,12000
059121,瑞儀永豐99購01  ,0,0,0,0,0,0,0,0,0,12000,0,0,0,29000,17000,12000,12000
06181P,國巨中信97售02  ,0,0,0,0,0,0,0,0,0,12000,0,0,0,12000,0,12000,12000
055588,瑞昱元大97購03  ,0,0,0,0,0,0,0,0,0,12000,0,0,0,42000,30000,12000,12000
055953,上銀元大97購09  ,0,0,0,0,0,0,0,0,0,12000,0,0,0,12000,0,12000,12000
051734,台積電國票95購04,0,0,0,0,0,0,0,0,0,12000,0,0,0,12000,0,12000,12000
04566P,GIS凱基94售04   ,0,0,0,0,0,0,0,0,0,12000,0,0,0,12000,0,12000,12000
04819P,嘉澤永豐94售01  ,0,0,0,0,0,0,0,0,0,12000,0,0,0,36000,24000,12000,12000
04863P,技嘉元大94售02  ,0,0,0,0,0,0,0,0,0,12000,0,0,0,12000,0,12000,12000
05347P,滬深2X元富9B售02,0,0,0,0,0,0,0,0,0,12000,0,0,0,12000,0,12000,12000
054929,群電凱基97購01  ,0,0,0,0,0,0,0,0,0,12000,0,0,0,12000,0,12000,12000
055787,聯茂凱基99購01  ,0,0,0,0,0,0,0,0,0,12000,0,0,0,12000,0,12000,12000
056458,日月光凱基98購02,0,0,0,0,0,0,0,0,0,12000,0,0,0,12000,0,12000,12000
052915,創意元富96購01  ,0,0,0,0,0,0,0,0,0,12000,0,0,0,12000,0,12000,12000
052682,上銀元大97購01  ,0,0,0,0,0,0,0,0,0,12000,0,0,0,32000,20000,12000,12000
056771,嘉晶元大99購01  ,0,0,0,0,0,0,0,0,0,12000,0,0,0,43000,31000,12000,12000
5533,皇鼎            ,28000,18000,10000,0,0,0,0,0,0,2000,3000,1000,2000,0,0,0,12000
8499,鼎炫-KY         ,52000,40000,12000,0,0,0,0,0,0,0,0,0,0,0,0,0,12000
6201,亞弘電          ,15000,4000,11000,0,0,0,0,0,0,1000,2000,1000,1000,0,0,0,12000
06184P,大立光元大97售06,0,0,0,0,0,0,0,0,0,11000,0,0,0,23000,12000,11000,11000
06135P,志超元富97售01  ,0,0,0,0,0,0,0,0,0,11000,0,0,0,11000,0,11000,11000
06097P,茂林永豐97售01  ,0,0,0,0,0,0,0,0,0,11000,0,0,0,21000,10000,11000,11000
06245P,健策元富97售03  ,0,0,0,0,0,0,0,0,0,11000,0,0,0,11000,0,11000,11000
06545P,致茂元大98售01  ,0,0,0,0,0,0,0,0,0,11000,0,0,0,21000,10000,11000,11000
06690P,玉晶光群益9A售05,0,0,0,0,0,0,0,0,0,11000,0,0,0,11000,0,11000,11000
06973P,臺股指元大9A售11,0,0,0,0,0,0,0,0,0,11000,0,0,0,11000,0,11000,11000
07049P,聯發科中信99售03,0,0,0,0,0,0,0,0,0,11000,0,0,0,16000,5000,11000,11000
06914P,南茂元大98售03  ,0,0,0,0,0,0,0,0,0,11000,0,0,0,18000,7000,11000,11000
06779P,智邦元大98售12  ,0,0,0,0,0,0,0,0,0,11000,0,0,0,21000,10000,11000,11000
06758P,鴻海元大98售10  ,0,0,0,0,0,0,0,0,0,11000,0,0,0,91000,80000,11000,11000
1615,大山            ,21000,10000,11000,0,0,0,0,0,0,0,0,0,0,0,0,0,11000
07117P,SGBR2X凱基9C售01,0,0,0,0,0,0,0,0,0,11000,0,0,0,11000,0,11000,11000
058082,美律群益98購05  ,0,0,0,0,0,0,0,0,0,11000,0,0,0,11000,0,11000,11000
057759,聯發科凱基98購17,0,0,0,0,0,0,0,0,0,11000,0,0,0,11000,0,11000,11000
04455P,台積電統一94售07,0,0,0,0,0,0,0,0,0,11000,0,0,0,12000,1000,11000,11000
048289,臺指反群益95購01,0,0,0,0,0,0,0,0,0,11000,0,0,0,11000,0,11000,11000
03416B,臺股指凱基95熊05,0,0,0,0,0,0,0,0,0,11000,0,0,0,41000,30000,11000,11000
04172P,大立光凱基93售34,0,0,0,0,0,0,0,0,0,11000,0,0,0,11000,0,11000,11000
03064P,台灣50群益01售14,0,0,0,0,0,0,0,0,0,11000,0,0,0,11000,0,11000,11000
04483P,元油2X凱基97售04,0,0,0,0,0,0,0,0,0,11000,0,0,0,11000,0,11000,11000
04672P,台積電統一94售09,0,0,0,0,0,0,0,0,0,11000,0,0,0,11000,0,11000,11000
05586P,臺股指凱基96售15,0,0,0,0,0,0,0,0,0,11000,0,0,0,11000,0,11000,11000
055726,台表科元大98購03,0,0,0,0,0,0,0,0,0,11000,0,0,0,11000,0,11000,11000
055700,緯穎國泰98購02  ,0,0,0,0,0,0,0,0,0,11000,0,0,0,11000,0,11000,11000
051316,T50反1國票95購02,0,0,0,0,0,0,0,0,0,11000,0,0,0,11000,0,11000,11000
05282P,可成元大95售09  ,0,0,0,0,0,0,0,0,0,11000,0,0,0,11000,0,11000,11000
056093,大毅元富97購01  ,0,0,0,0,0,0,0,0,0,11000,0,0,0,13000,2000,11000,11000
053464,喬山元大96購01  ,0,0,0,0,0,0,0,0,0,11000,0,0,0,11000,0,11000,11000
054516,國巨元大97購02  ,0,0,0,0,0,0,0,0,0,11000,0,0,0,27000,16000,11000,11000
054001,康友群益96購02  ,0,0,0,0,0,0,0,0,0,11000,0,0,0,11000,0,11000,11000
054826,復盛元大9A購01  ,0,0,0,0,0,0,0,0,0,11000,0,0,0,11000,0,11000,11000
057066,緯穎富邦99購01  ,0,0,0,0,0,0,0,0,0,11000,0,0,0,216000,205000,11000,11000
6641,基士德-KY       ,15000,4000,11000,0,0,0,0,0,0,0,0,0,0,0,0,0,11000
9905,大華            ,31000,22000,9000,0,0,0,0,0,0,2000,3000,1000,2000,0,0,0,11000
4141,龍燈-KY         ,16000,5000,11000,0,0,0,0,0,0,0,0,0,0,0,0,0,11000
4576,大銀微系統      ,63000,52000,11000,0,0,0,0,0,0,0,0,0,0,0,0,0,11000
3416,融程電          ,30000,20000,10000,0,0,0,0,0,0,1000,2000,1000,1000,0,0,0,11000
3605,宏致            ,320000,280000,40000,0,0,0,0,0,0,-29000,3000,32000,-29000,0,0,0,11000
2491,吉祥全          ,18000,7000,11000,0,0,0,0,0,0,0,0,0,0,0,0,0,11000
2748,雲品            ,21000,8000,13000,0,0,0,0,2000,-2000,0,0,0,0,0,0,0,11000
057750,神達國票99購01  ,0,0,0,0,0,0,0,0,0,10000,0,0,0,10000,0,10000,10000
057682,台積電日盛9A購03,0,0,0,0,0,0,0,0,0,10000,0,0,0,60000,50000,10000,10000
057689,南亞科凱基99購02,0,0,0,0,0,0,0,0,0,10000,0,0,0,10000,0,10000,10000
057690,美律凱基99購03  ,0,0,0,0,0,0,0,0,0,10000,0,0,0,10000,0,10000,10000
057651,矽力元大98購03  ,0,0,0,0,0,0,0,0,0,10000,0,0,0,10000,0,10000,10000
057827,康友元大98購03  ,0,0,0,0,0,0,0,0,0,10000,0,0,0,20000,10000,10000,10000
057860,金寶凱基98購01  ,0,0,0,0,0,0,0,0,0,10000,0,0,0,10000,0,10000,10000
057864,奇力新凱基99購03,0,0,0,0,0,0,0,0,0,10000,0,0,0,10000,0,10000,10000
057805,華通元大98購06  ,0,0,0,0,0,0,0,0,0,10000,0,0,0,10000,0,10000,10000
057817,景碩元大98購01  ,0,0,0,0,0,0,0,0,0,10000,0,0,0,10000,0,10000,10000
057485,友達元大9C購04  ,0,0,0,0,0,0,0,0,0,10000,0,0,0,10000,0,10000,10000
057552,禾伸堂凱基98購05,0,0,0,0,0,0,0,0,0,10000,0,0,0,10000,0,10000,10000
058023,南電凱基98購02  ,0,0,0,0,0,0,0,0,0,10000,0,0,0,10000,0,10000,10000
057990,美律統一99購02  ,0,0,0,0,0,0,0,0,0,10000,0,0,0,10000,0,10000,10000
058057,FBVIX元富98購02 ,0,0,0,0,0,0,0,0,0,10000,0,0,0,10000,0,10000,10000
057968,可成國泰9A購01  ,0,0,0,0,0,0,0,0,0,10000,0,0,0,10000,0,10000,10000
057957,嘉晶元大98購01  ,0,0,0,0,0,0,0,0,0,10000,0,0,0,17000,7000,10000,10000
057872,旺宏元大99購06  ,0,0,0,0,0,0,0,0,0,10000,0,0,0,20000,10000,10000,10000
058132,義隆元大99購03  ,0,0,0,0,0,0,0,0,0,10000,0,0,0,10000,0,10000,10000
058249,緯穎元大99購04  ,0,0,0,0,0,0,0,0,0,10000,0,0,0,30000,20000,10000,10000
058268,泰碩永豐9A購01  ,0,0,0,0,0,0,0,0,0,10000,0,0,0,10000,0,10000,10000
058272,超眾永豐9A購01  ,0,0,0,0,0,0,0,0,0,10000,0,0,0,10000,0,10000,10000
058293,光寶科凱基9A購01,0,0,0,0,0,0,0,0,0,10000,0,0,0,10000,0,10000,10000
058422,百和麥證99購01  ,0,0,0,10000,0,10000,0,0,0,10000,0,0,0,10000,0,10000,10000
058419,聯發科麥證99購02,0,0,0,10000,10000,0,0,0,0,10000,0,0,0,20000,10000,10000,10000
058396,力山元大99購01  ,0,0,0,0,0,0,0,0,0,10000,0,0,0,10000,0,10000,10000
058381,元石油中信9C購01,0,0,0,0,0,0,0,0,0,10000,0,0,0,10000,0,10000,10000
058361,美律凱基99購06  ,0,0,0,0,0,0,0,0,0,10000,0,0,0,20000,10000,10000,10000
058336,鴻海元富99購07  ,0,0,0,0,0,0,0,0,0,10000,0,0,0,10000,0,10000,10000
058333,鴻海元富99購04  ,0,0,0,0,0,0,0,0,0,10000,0,0,0,10000,0,10000,10000
058334,鴻海元富99購05  ,0,0,0,0,0,0,0,0,0,10000,0,0,0,10000,0,10000,10000
058591,台灣50統一9B購02,0,0,0,0,0,0,0,0,0,10000,0,0,0,33000,23000,10000,10000
058617,南電元大99購01  ,0,0,0,0,0,0,0,0,0,10000,0,0,0,10000,0,10000,10000
058618,南電元大99購02  ,0,0,0,0,0,0,0,0,0,10000,0,0,0,10000,0,10000,10000
058641,鴻海麥證99購02  ,0,0,0,10000,0,10000,0,0,0,10000,0,0,0,10000,0,10000,10000
058654,鴻海中信03購01  ,0,0,0,0,0,0,0,0,0,10000,0,0,0,10000,0,10000,10000
058704,台積電元大99購17,0,0,0,0,0,0,0,0,0,10000,0,0,0,50000,40000,10000,10000
058666,上証反群益01購01,0,0,0,0,0,0,0,0,0,10000,0,0,0,10000,0,10000,10000
058881,全新永豐99購01  ,0,0,0,0,0,0,0,0,0,10000,0,0,0,10000,0,10000,10000
058902,聯發科元大99購15,0,0,0,0,0,0,0,0,0,10000,0,0,0,290000,280000,10000,10000
059047,元油2X凱基9A購10,0,0,0,0,0,0,0,0,0,10000,0,0,0,10000,0,10000,10000
058998,鴻海元大99購22  ,0,0,0,0,0,0,0,0,0,10000,0,0,0,57000,47000,10000,10000
05892P,大立光中信98售03,0,0,0,0,0,0,0,0,0,10000,0,0,0,30000,20000,10000,10000
058944,元石油群益9C購02,0,0,0,0,0,0,0,0,0,10000,0,0,0,10000,0,10000,10000
1529,樂士            ,5000,4000,1000,0,0,0,0,0,0,9000,10000,1000,9000,0,0,0,10000
06729P,聯詠元大98售03  ,0,0,0,0,0,0,0,0,0,10000,0,0,0,11000,1000,10000,10000
06783P,亞光元大98售03  ,0,0,0,0,0,0,0,0,0,10000,0,0,0,16000,6000,10000,10000
06764P,聯發科元大98售11,0,0,0,0,0,0,0,0,0,10000,0,0,0,47000,37000,10000,10000
06823P,台灣50永豐98售02,0,0,0,0,0,0,0,0,0,10000,0,0,0,30000,20000,10000,10000
06936P,瑞儀元大98售01  ,0,0,0,0,0,0,0,0,0,10000,0,0,0,92000,82000,10000,10000
06938P,南電元大98售03  ,0,0,0,0,0,0,0,0,0,10000,0,0,0,18000,8000,10000,10000
07064P,臺股指元大9A售25,0,0,0,0,0,0,0,0,0,10000,0,0,0,21000,11000,10000,10000
07030P,鈺齊群益99售01  ,0,0,0,0,0,0,0,0,0,10000,0,0,0,10000,0,10000,10000
06986P,台積電台新9A售01,0,0,0,0,0,0,0,0,0,10000,0,0,0,21000,11000,10000,10000
07018P,台灣50統一9B售01,0,0,0,0,0,0,0,0,0,10000,0,0,0,10000,0,10000,10000
06689P,鴻海中信9C售02  ,0,0,0,0,0,0,0,0,0,10000,0,0,0,10000,0,10000,10000
06659P,T50正2富邦9A售01,0,0,0,0,0,0,0,0,0,10000,0,0,0,10000,0,10000,10000
06683P,訊芯元大98售07  ,0,0,0,0,0,0,0,0,0,10000,0,0,0,10000,0,10000,10000
06583P,可成凱基98售07  ,0,0,0,0,0,0,0,0,0,10000,0,0,0,10000,0,10000,10000
06551P,貿聯元大98售05  ,0,0,0,0,0,0,0,0,0,10000,0,0,0,10000,0,10000,10000
06271P,彩晶凱基97售01  ,0,0,0,0,0,0,0,0,0,10000,0,0,0,10000,0,10000,10000
06298P,聯發科元大97售20,0,0,0,0,0,0,0,0,0,10000,0,0,0,35000,25000,10000,10000
06363P,臺股指麥證97售02,0,0,0,10000,0,10000,0,0,0,10000,0,0,0,10000,0,10000,10000
06440P,台積電凱基98售07,0,0,0,0,0,0,0,0,0,10000,0,0,0,10000,0,10000,10000
06398P,禾伸堂凱基97售02,0,0,0,0,0,0,0,0,0,10000,0,0,0,30000,20000,10000,10000
06389P,聯發科兆豐97售01,0,0,0,0,0,0,0,0,0,10000,0,0,0,10000,0,10000,10000
06404P,鴻海元富97售16  ,0,0,0,0,0,0,0,0,0,10000,0,0,0,10000,0,10000,10000
06412P,南亞科日盛97售01,0,0,0,0,0,0,0,0,0,10000,0,0,0,10000,0,10000,10000
06110P,國巨國泰98售02  ,0,0,0,0,0,0,0,0,0,10000,0,0,0,10000,0,10000,10000
06049P,創意亞東97售01  ,0,0,0,0,0,0,0,0,0,10000,0,0,0,10000,0,10000,10000
06151P,華新科元大97售07,0,20000,-20000,0,0,0,0,0,0,30000,0,0,0,30000,0,30000,10000
06196P,元上證元大97售01,0,0,0,0,0,0,0,0,0,10000,0,0,0,10000,0,10000,10000
06009P,宏達電元富96售03,0,0,0,0,0,0,0,0,0,10000,0,0,0,10000,0,10000,10000
05944P,富邦金中信96售01,0,0,0,0,0,0,0,0,0,10000,0,0,0,10000,0,10000,10000
05958P,聯發科國票97售04,0,0,0,0,0,0,0,0,0,10000,0,0,0,10000,0,10000,10000
05959P,聯發科國票98售01,0,0,0,0,0,0,0,0,0,10000,0,0,0,10000,0,10000,10000
05927P,正文永豐96售03  ,0,0,0,0,0,0,0,0,0,10000,0,0,0,10000,0,10000,10000
05921P,同欣電元大96售06,0,0,0,0,0,0,0,0,0,10000,0,0,0,10000,0,10000,10000
051294,鴻海元富95購06  ,0,0,0,0,0,0,0,0,0,10000,0,0,0,10000,0,10000,10000
051269,康友富邦97購01  ,0,0,0,0,0,0,0,0,0,10000,0,0,0,10000,0,10000,10000
052374,瑞昱元大95購02  ,0,0,0,0,0,0,0,0,0,10000,0,0,0,10000,0,10000,10000
051048,臺指反群益96購01,0,0,0,0,0,0,0,0,0,10000,0,0,0,10000,0,10000,10000
051590,玉晶光元大96購02,0,0,0,0,0,0,0,0,0,10000,0,0,0,40000,30000,10000,10000
05157P,全新台新96售01  ,0,0,0,0,0,0,0,0,0,10000,0,0,0,10000,0,10000,10000
051435,聯茂元富95購01  ,0,0,0,0,0,0,0,0,0,10000,0,0,0,10000,0,10000,10000
051412,奇力新國票96購01,0,0,0,0,0,0,0,0,0,10000,0,0,0,10000,0,10000,10000
05087P,GIS國泰96售01   ,0,0,0,0,0,0,0,0,0,10000,0,0,0,10000,0,10000,10000
049189,訊芯康和94購01  ,0,0,0,0,0,0,0,0,0,10000,0,0,0,10000,0,10000,10000
052239,泰鼎國票97購01  ,0,0,0,0,0,0,0,0,0,10000,0,0,0,10000,0,10000,10000
052297,旭富國票96購01  ,0,0,0,0,0,0,0,0,0,10000,0,0,0,70000,60000,10000,10000
052299,T50反1台新05購03,0,0,0,0,0,0,0,0,0,10000,0,0,0,10000,0,10000,10000
04909P,鴻海統一94售10  ,0,0,0,0,0,0,0,0,0,10000,0,0,0,40000,30000,10000,10000
048990,台表科元大94購01,0,0,0,0,0,0,0,0,0,10000,0,0,0,10000,0,10000,10000
048975,玉晶光元大94購03,0,0,0,0,0,0,0,0,0,10000,0,0,0,10000,0,10000,10000
05560P,友達兆豐96售01  ,0,0,0,0,0,0,0,0,0,10000,0,0,0,10000,0,10000,10000
055641,鴻海元富97購04  ,0,0,0,0,0,0,0,0,0,10000,0,0,0,10000,0,10000,10000
055589,台光電元大98購04,0,0,0,0,0,0,0,0,0,10000,0,0,0,10000,0,10000,10000
055584,國巨元大97購11  ,0,0,0,0,0,0,0,0,0,10000,0,0,0,10000,0,10000,10000
055525,國巨群益98購05  ,0,0,0,0,0,0,0,0,0,10000,0,0,0,10000,0,10000,10000
055493,華新科元大97購09,0,0,0,0,0,0,0,0,0,10000,0,0,0,10000,0,10000,10000
055480,元上證元大97購02,0,0,0,0,0,0,0,0,0,10000,0,0,0,10000,0,10000,10000
055484,華通元大97購04  ,0,0,0,0,0,0,0,0,0,10000,0,0,0,10000,0,10000,10000
055486,國巨元大98購06  ,0,0,0,0,0,0,0,0,0,10000,0,0,0,10000,0,10000,10000
051653,南電永豐95購02  ,0,0,0,0,0,0,0,0,0,10000,0,0,0,10000,0,10000,10000
055844,大毅元大98購01  ,0,0,0,0,0,0,0,0,0,10000,0,0,0,10000,0,10000,10000
055839,瑞昱元大97購04  ,0,0,0,0,0,0,0,0,0,10000,0,0,0,10000,0,10000,10000
05590P,臺股指中信96售05,0,0,0,0,0,0,0,0,0,10000,0,0,0,10000,0,10000,10000
05163P,聯發科統一96售02,0,0,0,0,0,0,0,0,0,10000,0,0,0,10000,0,10000,10000
055949,亞德客元大97購04,0,0,0,0,0,0,0,0,0,10000,0,0,0,10000,0,10000,10000
05597P,鴻海元富96售06  ,0,0,0,0,0,0,0,0,0,10000,0,0,0,10000,0,10000,10000
051729,華新國票96購01  ,0,0,0,0,0,0,0,0,0,10000,0,0,0,10000,0,10000,10000
051696,新日興中信96購01,0,0,0,0,0,0,0,0,0,10000,0,0,0,30000,20000,10000,10000
048937,玉晶光永豐95購01,0,0,0,0,0,0,0,0,0,10000,0,0,0,20000,10000,10000,10000
04888P,臺股指凱基95售03,0,0,0,0,0,0,0,0,0,10000,0,0,0,10000,0,10000,10000
048892,台郡元富97購01  ,0,0,0,0,0,0,0,0,0,10000,0,0,0,10000,0,10000,10000
05222P,致伸凱基95售02  ,0,0,0,0,0,0,0,0,0,10000,0,0,0,10000,0,10000,10000
051200,國巨麥證95購01  ,0,0,0,10000,0,10000,0,0,0,10000,0,0,0,10000,0,10000,10000
049572,華固統一94購03  ,0,0,0,0,0,0,0,0,0,10000,0,0,0,10000,0,10000,10000
052107,台積電統一95購06,0,0,0,0,0,0,0,0,0,10000,0,0,0,10000,0,10000,10000
050789,矽創國泰96購01  ,0,0,0,0,0,0,0,0,0,10000,0,0,0,10000,0,10000,10000
05085P,鴻海日盛95售01  ,0,0,0,0,0,0,0,0,0,10000,0,0,0,10000,0,10000,10000
04975P,華新科凱基96售02,0,0,0,0,0,0,0,0,0,10000,0,0,0,20000,10000,10000,10000
04989P,國巨元大94售15  ,0,0,0,0,0,0,0,0,0,10000,0,0,0,10000,0,10000,10000
049809,聯詠元大94購04  ,0,0,0,0,0,0,0,0,0,10000,0,0,0,32000,22000,10000,10000
04982P,臺股指中信94售03,0,0,0,0,0,0,0,0,0,10000,0,0,0,10000,0,10000,10000
050024,旺宏元大94購09  ,0,0,0,0,0,0,0,0,0,10000,0,0,0,10000,0,10000,10000
05002P,台積電統一95售03,0,0,0,0,0,0,0,0,0,10000,0,0,0,10000,0,10000,10000
050078,臺指反統一97購01,0,0,0,0,0,0,0,0,0,10000,0,0,0,10000,0,10000,10000
050109,國巨元大94購13  ,0,0,0,0,0,0,0,0,0,10000,0,0,0,10000,0,10000,10000
050135,禾伸堂兆豐95購01,0,0,0,0,0,0,0,0,0,10000,0,0,0,140000,130000,10000,10000
049613,華通中信94購01  ,0,0,0,0,0,0,0,0,0,10000,0,0,0,10000,0,10000,10000
049360,台達電元大94購07,0,0,0,0,0,0,0,0,0,10000,0,0,0,10000,0,10000,10000
049378,聯詠元大94購02  ,0,0,0,0,0,0,0,0,0,10000,0,0,0,10000,0,10000,10000
049233,聯發科統一94購04,0,0,0,0,0,0,0,0,0,10000,0,0,0,10000,0,10000,10000
050586,康友國票94購01  ,0,0,0,0,0,0,0,0,0,10000,0,0,0,70000,60000,10000,10000
050603,致新國泰96購01  ,0,0,0,0,0,0,0,0,0,10000,0,0,0,10000,0,10000,10000
051997,康友元大95購02  ,0,0,0,0,0,0,0,0,0,10000,0,0,0,10000,0,10000,10000
04647P,上海銀凱基94售04,0,0,0,0,0,0,0,0,0,10000,0,0,0,10000,0,10000,10000
04645P,禾伸堂凱基94售03,0,0,0,0,0,0,0,0,0,10000,0,0,0,10000,0,10000,10000
04646P,TPK凱基94售03   ,0,0,0,0,0,0,0,0,0,10000,0,0,0,10000,0,10000,10000
04655P,臺股指凱基94售14,0,0,0,0,0,0,0,0,0,10000,0,0,0,10000,0,10000,10000
04635P,臺股指群益94售10,0,0,0,0,0,0,0,0,0,10000,0,0,0,10000,0,10000,10000
04726P,TPK凱基94售04   ,0,0,0,0,0,0,0,0,0,10000,0,0,0,10000,0,10000,10000
050197,矽格元大94購04  ,0,0,0,0,0,0,0,0,0,10000,0,0,0,10000,0,10000,10000
050184,信邦元大94購01  ,0,0,0,0,0,0,0,0,0,10000,0,0,0,10000,0,10000,10000
050250,台郡凱基94購03  ,0,0,0,0,0,0,0,0,0,10000,0,0,0,10000,0,10000,10000
050239,廣達凱基94購01  ,0,0,0,0,0,0,0,0,0,10000,0,0,0,10000,0,10000,10000
051841,南茂國泰96購01  ,0,0,0,0,0,0,0,0,0,10000,0,0,0,30000,20000,10000,10000
05186P,鈺齊中信95售02  ,0,0,0,0,0,0,0,0,0,10000,0,0,0,13000,3000,10000,10000
050459,台表科元大94購03,0,0,0,0,0,0,0,0,0,10000,0,0,0,10000,0,10000,10000
05046P,台光電永豐95售02,0,0,0,0,0,0,0,0,0,10000,0,0,0,10000,0,10000,10000
050530,台表科元大95購04,0,0,0,0,0,0,0,0,0,10000,0,0,0,10000,0,10000,10000
05039P,鴻海凱基95售10  ,0,0,0,0,0,0,0,0,0,10000,0,0,0,130000,120000,10000,10000
050306,聯發科中信97購01,0,0,0,0,0,0,0,0,0,10000,0,0,0,10000,0,10000,10000
04506P,旺宏元大94售06  ,0,0,0,0,0,0,0,0,0,10000,0,0,0,10000,0,10000,10000
04529P,正文凱基94售04  ,0,0,0,0,0,0,0,0,0,10000,0,0,0,10000,0,10000,10000
04553P,S&P正2中信95售01,0,0,0,0,0,0,0,0,0,10000,0,0,0,10000,0,10000,10000
048766,禾伸堂凱基94購01,0,0,0,0,0,0,0,0,0,10000,0,0,0,10000,0,10000,10000
04877P,聯發科麥證94售04,0,0,0,10000,0,10000,0,0,0,10000,0,0,0,10000,0,10000,10000
04781P,欣興凱基94售06  ,0,0,0,0,0,0,0,0,0,10000,0,0,0,10000,0,10000,10000
04790P,台積電元大94售19,0,0,0,0,0,0,0,0,0,10000,0,0,0,367000,357000,10000,10000
047944,中石化元富96購01,0,0,0,0,0,0,0,0,0,10000,0,0,0,10000,0,10000,10000
04804P,聯發科凱基94售12,0,0,0,0,0,0,0,0,0,10000,0,0,0,10000,0,10000,10000
048097,聯詠凱基93購07  ,0,0,0,0,0,0,0,0,0,10000,0,0,0,10000,0,10000,10000
048162,矽力麥證93購01  ,0,0,0,10000,0,10000,0,0,0,10000,0,0,0,10000,0,10000,10000
048150,矽力元富93購01  ,0,0,0,0,0,0,0,0,0,10000,0,0,0,10000,0,10000,10000
04774P,金融類元大94售02,0,0,0,0,0,0,0,0,0,10000,0,0,0,152000,142000,10000,10000
047692,T50反1國票94購01,0,0,0,0,0,0,0,0,0,10000,0,0,0,10000,0,10000,10000
04599P,南亞科凱基94售03,0,0,0,0,0,0,0,0,0,10000,0,0,0,10000,0,10000,10000
045753,大立光國泰94購02,0,0,0,0,0,0,0,0,0,10000,0,0,0,10000,0,10000,10000
03085P,台積電元大01售34,0,0,0,0,0,0,0,0,0,10000,0,0,0,10000,0,10000,10000
04382P,美律國泰95售01  ,0,0,0,0,0,0,0,0,0,10000,0,0,0,10000,0,10000,10000
04402P,TPK兆豐95售01   ,0,0,0,0,0,0,0,0,0,10000,0,0,0,10000,0,10000,10000
042712,元石油國票95購01,0,0,0,0,0,0,0,0,0,10000,0,0,0,10000,0,10000,10000
04278P,大立光凱基93售38,0,0,0,0,0,0,0,0,0,10000,0,0,0,10000,0,10000,10000
042904,金寶元大94購02  ,0,0,0,0,0,0,0,0,0,10000,0,0,0,10000,0,10000,10000
04279P,超眾凱基93售07  ,0,0,0,0,0,0,0,0,0,10000,0,0,0,10000,0,10000,10000
04255P,台積電國票94售03,0,0,0,0,0,0,0,0,0,10000,0,0,0,10000,0,10000,10000
042918,矽格元大94購01  ,0,0,0,0,0,0,0,0,0,10000,0,0,0,10000,0,10000,10000
04297P,微星元大93售03  ,0,0,0,0,0,0,0,0,0,10000,0,0,0,10000,0,10000,10000
04372P,臺股指凱基94售02,0,0,0,0,0,0,0,0,0,10000,0,0,0,10000,0,10000,10000
04351P,鴻海永豐94售01  ,0,0,0,0,0,0,0,0,0,10000,0,0,0,10000,0,10000,10000
04367P,滬深2X凱基95售04,0,0,0,0,0,0,0,0,0,10000,0,0,0,10000,0,10000,10000
0054,元大台商50      ,0,0,0,0,0,0,0,0,0,10000,0,0,0,24000,14000,10000,10000
04173P,上海銀凱基93售02,0,0,0,0,0,0,0,0,0,10000,0,0,0,10000,0,10000,10000
04169P,鴻海凱基93售34  ,0,0,0,0,0,0,0,0,0,10000,0,0,0,60000,50000,10000,10000
04162P,南亞科統一94售02,0,0,0,0,0,0,0,0,0,10000,0,0,0,10000,0,10000,10000
04128P,台積電統一93售05,0,0,0,0,0,0,0,0,0,10000,0,0,0,10000,0,10000,10000
03975P,大立光元大94售02,0,0,0,0,0,0,0,0,0,10000,0,0,0,30000,20000,10000,10000
048193,旺宏元大94購05  ,0,0,0,0,0,0,0,0,0,10000,0,0,0,10000,0,10000,10000
048190,道瓊反元大96購02,0,0,0,0,0,0,0,0,0,10000,0,0,0,30000,20000,10000,10000
048427,百和元富95購01  ,0,0,0,0,0,0,0,0,0,10000,0,0,0,10000,0,10000,10000
04851P,創意永豐94售02  ,0,0,0,0,0,0,0,0,0,10000,0,0,0,20000,10000,10000,10000
044567,華通凱基93購03  ,0,0,0,0,0,0,0,0,0,10000,0,0,0,10000,0,10000,10000
04474P,聯發科元大94售03,0,0,0,0,0,0,0,0,0,10000,0,0,0,10000,0,10000,10000
04475P,欣興元大94售03  ,0,0,0,0,0,0,0,0,0,10000,0,0,0,10000,0,10000,10000
044407,聯茂凱基93購01  ,0,0,0,0,0,0,0,0,0,10000,0,0,0,10000,0,10000,10000
048642,聯發科元大94購02,0,0,0,0,0,0,0,0,0,10000,0,0,0,10000,0,10000,10000
048644,華固元大93購01  ,0,0,0,0,0,0,0,0,0,10000,0,0,0,10000,0,10000,10000
057070,美律永豐98購02  ,0,0,0,0,0,0,0,0,0,10000,0,0,0,10000,0,10000,10000
056897,南亞科元大98購02,0,0,0,0,0,0,0,0,0,10000,0,0,0,10000,0,10000,10000
054831,緯穎國泰98購01  ,0,0,0,0,0,0,0,0,0,10000,0,0,0,10000,0,10000,10000
057023,美律凱基99購02  ,0,0,0,0,0,0,0,0,0,10000,0,0,0,10000,0,10000,10000
057026,長榮航凱基98購01,0,0,0,0,0,0,0,0,0,10000,0,0,0,20000,10000,10000,10000
055103,南港凱基97購01  ,0,0,0,0,0,0,0,0,0,10000,0,0,0,10000,0,10000,10000
05514P,康舒永豐96售01  ,0,0,0,0,0,0,0,0,0,10000,0,0,0,10000,0,10000,10000
055117,臻鼎凱基98購02  ,0,0,0,0,0,0,0,0,0,10000,0,0,0,10000,0,10000,10000
055032,億光富邦99購01  ,0,0,0,0,0,0,0,0,0,10000,0,0,0,10000,0,10000,10000
055158,亞光元大99購01  ,0,0,0,0,0,0,0,0,0,10000,0,0,0,10000,0,10000,10000
055255,欣興統一97購02  ,0,0,0,0,0,0,0,0,0,10000,0,0,0,10000,0,10000,10000
056989,鴻海兆豐98購02  ,0,0,0,0,0,0,0,0,0,10000,0,0,0,25000,15000,10000,10000
056941,台郡元富9B購01  ,0,0,0,0,0,0,0,0,0,10000,0,0,0,10000,0,10000,10000
056942,昇陽半元富98購01,0,0,0,0,0,0,0,0,0,10000,0,0,0,10000,0,10000,10000
05708P,奇力新國票97售04,0,0,0,0,0,0,0,0,0,10000,0,0,0,10000,0,10000,10000
057129,聯發科凱基99購03,0,0,0,0,0,0,0,0,0,10000,0,0,0,10000,0,10000,10000
05721P,全新群益98售02  ,0,0,0,0,0,0,0,0,0,10000,0,0,0,10000,0,10000,10000
057177,奇力新元大99購04,0,0,0,0,0,0,0,0,0,10000,0,0,0,10000,0,10000,10000
057183,玉晶光元大99購07,0,0,0,0,0,0,0,0,0,10000,0,0,0,10000,0,10000,10000
057353,玉晶光統一99購01,0,0,0,0,0,0,0,0,0,10000,0,0,0,10000,0,10000,10000
057363,華通元大99購02  ,0,0,0,0,0,0,0,0,0,10000,0,0,0,14000,4000,10000,10000
057382,聯發科國泰9A購01,0,0,0,0,0,0,0,0,0,10000,0,0,0,10000,0,10000,10000
053980,泰鼎元大97購02  ,0,0,0,0,0,0,0,0,0,10000,0,0,0,10000,0,10000,10000
054051,貿聯元大97購03  ,0,0,0,0,0,0,0,0,0,10000,0,0,0,10000,0,10000,10000
054103,T50反1凱基99購04,0,0,0,0,0,0,0,0,0,10000,0,0,0,10000,0,10000,10000
054511,香港反元大98購01,0,0,0,0,0,0,0,0,0,10000,0,0,0,10000,0,10000,10000
053708,道瓊反凱基98購01,0,0,0,0,0,0,0,0,0,10000,0,0,0,13000,3000,10000,10000
053754,英業達元富96購02,0,0,0,0,0,0,0,0,0,10000,0,0,0,30000,20000,10000,10000
053896,麗豐群益97購01  ,0,0,0,0,0,0,0,0,0,10000,0,0,0,10000,0,10000,10000
05451P,臺股指元大95售28,0,0,0,0,0,0,0,0,0,10000,0,0,0,10000,0,10000,10000
05452P,亞德客群益95售02,0,0,0,0,0,0,0,0,0,10000,0,0,0,10000,0,10000,10000
054543,元金2X中信01購01,0,0,0,0,0,0,0,0,0,10000,0,0,0,10000,0,10000,10000
054573,漢唐元大98購01  ,0,0,0,0,0,0,0,0,0,10000,0,0,0,10000,0,10000,10000
056158,新日興凱基98購02,0,0,0,0,0,0,0,0,0,10000,0,0,0,10000,0,10000,10000
052399,台光電凱基95購03,0,0,0,0,0,0,0,0,0,10000,0,0,0,10000,0,10000,10000
052491,泰碩國票99購01  ,0,0,0,0,0,0,0,0,0,10000,0,0,0,10000,0,10000,10000
052439,寶成富邦97購01  ,0,0,0,0,0,0,0,0,0,10000,0,0,0,10000,0,10000,10000
05493P,華新科富邦99售02,0,0,0,0,0,0,0,0,0,10000,0,0,0,75000,65000,10000,10000
054935,華通元大98購03  ,0,0,0,0,0,0,0,0,0,10000,0,0,0,10000,0,10000,10000
054985,光罩元富97購01  ,0,0,0,0,0,0,0,0,0,10000,0,0,0,10000,0,10000,10000
055006,晶相光元富9A購01,0,0,0,0,0,0,0,0,0,10000,0,0,0,10000,0,10000,10000
054964,智易元大99購01  ,0,0,0,0,0,0,0,0,0,10000,0,0,0,10000,0,10000,10000
054678,麗豐台新98購02  ,0,0,0,0,0,0,0,0,0,10000,0,0,0,10000,0,10000,10000
05350P,可成元富98售04  ,0,0,0,0,0,0,0,0,0,10000,0,0,0,10000,0,10000,10000
056076,超眾元大97購05  ,0,0,0,0,0,0,0,0,0,10000,0,0,0,10000,0,10000,10000
05309P,康友中信95售03  ,0,0,0,0,0,0,0,0,0,10000,0,0,0,10000,0,10000,10000
055747,康舒元富97購01  ,0,0,0,0,0,0,0,0,0,10000,0,0,0,10000,0,10000,10000
055728,緯穎元大97購03  ,0,0,0,0,0,0,0,0,0,10000,0,0,0,20000,10000,10000,10000
055730,建準元富97購02  ,0,0,0,0,0,0,0,0,0,10000,0,0,0,10000,0,10000,10000
053091,同欣電元大96購01,0,0,0,0,0,0,0,0,0,10000,0,0,0,10000,0,10000,10000
053092,台表科元大97購02,0,0,0,0,0,0,0,0,0,10000,0,0,0,10000,0,10000,10000
053084,國巨元大98購01  ,0,0,0,0,0,0,0,0,0,10000,0,0,0,10000,0,10000,10000
055322,欣興國票97購06  ,0,0,0,0,0,0,0,0,0,10000,0,0,0,10000,0,10000,10000
055351,聯發科凱基97購03,0,0,0,0,0,0,0,0,0,10000,0,0,0,20000,10000,10000,10000
056509,晶相光永豐98購01,0,0,0,0,0,0,0,0,0,10000,0,0,0,10000,0,10000,10000
055378,晶相光元大97購02,0,0,0,0,0,0,0,0,0,10000,0,0,0,10000,0,10000,10000
054148,矽創元大96購03  ,0,0,0,0,0,0,0,0,0,10000,0,0,0,10000,0,10000,10000
056439,華邦電凱基98購02,0,0,0,0,0,0,0,0,0,10000,0,0,0,10000,0,10000,10000
056655,旺宏元大99購02  ,0,0,0,0,0,0,0,0,0,10000,0,0,0,20000,10000,10000,10000
056486,樺漢元大98購04  ,0,0,0,0,0,0,0,0,0,10000,0,0,0,10000,0,10000,10000
056597,宏碁元富98購01  ,0,0,0,0,0,0,0,0,0,10000,0,0,0,10000,0,10000,10000
056583,昇陽半元大98購02,0,0,0,0,0,0,0,0,0,10000,0,0,0,10000,0,10000,10000
056543,京鼎凱基98購01  ,0,0,0,0,0,0,0,0,0,10000,0,0,0,10000,0,10000,10000
056310,神達元大97購02  ,0,0,0,0,0,0,0,0,0,10000,0,0,0,20000,10000,10000,10000
056285,可成永豐97購02  ,0,0,0,0,0,0,0,0,0,10000,0,0,0,10000,0,10000,10000
05623P,台積電中信96售03,0,0,0,0,0,0,0,0,0,10000,0,0,0,10000,0,10000,10000
05626P,景碩國票97售03  ,0,0,0,0,0,0,0,0,0,10000,0,0,0,10000,0,10000,10000
05283P,健鼎元大95售04  ,0,0,0,0,0,0,0,0,0,10000,0,0,0,10000,0,10000,10000
052884,台積電兆豐96購01,0,0,0,0,0,0,0,0,0,10000,0,0,0,40000,30000,10000,10000
052816,上銀永豐96購01  ,0,0,0,0,0,0,0,0,0,10000,0,0,0,10000,0,10000,10000
054387,台積電統一98購02,0,0,0,0,0,0,0,0,0,10000,0,0,0,20000,10000,10000,10000
054404,新日興康和96購01,0,0,0,0,0,0,0,0,0,10000,0,0,0,10000,0,10000,10000
056172,鴻海元富97購11  ,0,0,0,0,0,0,0,0,0,10000,0,0,0,10000,0,10000,10000
052531,台積電國泰96購06,0,0,0,0,0,0,0,0,0,10000,0,0,0,10000,0,10000,10000
05254P,瑞昱凱基95售04  ,0,0,0,0,0,0,0,0,0,10000,0,0,0,30000,20000,10000,10000
05257P,欣興凱基95售04  ,0,0,0,0,0,0,0,0,0,10000,0,0,0,10000,0,10000,10000
052581,訊芯元富98購01  ,0,0,0,0,0,0,0,0,0,10000,0,0,0,10000,0,10000,10000
052590,祥碩永豐96購01  ,0,0,0,0,0,0,0,0,0,10000,0,0,0,10000,0,10000,10000
05331P,上証2X國票96售01,0,0,0,0,0,0,0,0,0,10000,0,0,0,10000,0,10000,10000
056746,超眾凱基99購01  ,0,0,0,0,0,0,0,0,0,10000,0,0,0,10000,0,10000,10000
056747,致新凱基99購01  ,0,0,0,0,0,0,0,0,0,10000,0,0,0,10000,0,10000,10000
056677,智伸科元富98購01,0,0,0,0,0,0,0,0,0,10000,0,0,0,22000,12000,10000,10000
056707,鴻海富邦99購03  ,0,0,0,0,0,0,0,0,0,10000,0,0,0,10000,0,10000,10000
05672P,鴻海群益96售03  ,0,0,0,0,0,0,0,0,0,10000,0,0,0,10000,0,10000,10000
056723,國巨中信9A購01  ,0,0,0,0,0,0,0,0,0,10000,0,0,0,10000,0,10000,10000
05671P,友達國泰97售03  ,0,0,0,0,0,0,0,0,0,10000,0,0,0,10000,0,10000,10000
056839,台光電元富98購02,0,0,0,0,0,0,0,0,0,10000,0,0,0,10000,0,10000,10000
052746,泰碩元大97購01  ,0,0,0,0,0,0,0,0,0,10000,0,0,0,10000,0,10000,10000
052686,華新科元大96購03,0,0,0,0,0,0,0,0,0,10000,0,0,0,10000,0,10000,10000
052640,台表科凱基97購01,0,0,0,0,0,0,0,0,0,10000,0,0,0,10000,0,10000,10000
056380,麗豐元富98購01  ,0,0,0,0,0,0,0,0,0,10000,0,0,0,10000,0,10000,10000
056371,樺漢元大98購03  ,0,0,0,0,0,0,0,0,0,10000,0,0,0,10000,0,10000,10000
053282,彩晶元大9C購01  ,0,0,0,0,0,0,0,0,0,10000,0,0,0,37000,27000,10000,10000
053283,同欣電元大96購03,0,0,0,0,0,0,0,0,0,10000,0,0,0,10000,0,10000,10000
054296,世芯元大97購01  ,0,0,0,0,0,0,0,0,0,10000,0,0,0,10000,0,10000,10000
054298,台表科元大97購03,0,0,0,0,0,0,0,0,0,10000,0,0,0,10000,0,10000,10000
05431P,台光電統一97售01,0,0,0,0,0,0,0,0,0,10000,0,0,0,10000,0,10000,10000
054361,技嘉凱基96購01  ,0,0,0,0,0,0,0,0,0,10000,0,0,0,70000,60000,10000,10000
4526,東台            ,29000,20000,9000,0,0,0,0,0,0,1000,1000,0,1000,0,0,0,10000
05938P,旺宏凱基96售07  ,0,0,0,0,0,0,0,0,0,9000,0,0,0,61000,52000,9000,9000
06062P,宏達電元富97售01,0,0,0,0,0,0,0,0,0,9000,0,0,0,10000,1000,9000,9000
06469P,臺股指凱基99售09,0,0,0,0,0,0,0,0,0,9000,0,0,0,9000,0,9000,9000
06558P,旺宏元富98售02  ,0,0,0,0,0,0,0,0,0,9000,0,0,0,9000,0,9000,9000
06696P,台灣50國票99售01,0,0,0,0,0,0,0,0,0,9000,0,0,0,9000,0,9000,9000
06681P,致茂元大98售02  ,0,0,0,0,0,0,0,0,0,9000,0,0,0,9000,0,9000,9000
07062P,台積電元大99售15,0,0,0,0,0,0,0,0,0,9000,0,0,0,108000,99000,9000,9000
07078P,鴻海群益99售02  ,0,0,0,0,0,0,0,0,0,9000,0,0,0,29000,20000,9000,9000
07111P,台積電群益99售08,0,0,0,0,0,0,0,0,0,9000,0,0,0,16000,7000,9000,9000
1532,勤美            ,88000,79000,9000,0,0,0,0,0,0,0,0,0,0,0,0,0,9000
1733,五鼎            ,104000,96000,8000,0,0,0,0,0,0,1000,4000,3000,1000,0,0,0,9000
08864P,欣興元大01售01  ,0,0,0,0,0,0,0,0,0,9000,0,0,0,9000,0,9000,9000
05903P,聯發科統一96售09,0,0,0,0,0,0,0,0,0,9000,0,0,0,9000,0,9000,9000
05860P,旺宏康和96售01  ,0,0,0,0,0,0,0,0,0,9000,0,0,0,9000,0,9000,9000
058318,致茂永豐9A購01  ,0,0,0,0,0,0,0,0,0,9000,0,0,0,27000,18000,9000,9000
04841P,群創元大94售04  ,0,0,0,0,0,0,0,0,0,9000,0,0,0,9000,0,9000,9000
048381,T50反1國票94購03,0,0,0,0,0,0,0,0,0,9000,0,0,0,9000,0,9000,9000
00707R,元大S&P日圓反1  ,0,0,0,0,0,0,0,0,0,9000,0,0,0,20000,11000,9000,9000
05022P,智易凱基95售01  ,0,0,0,0,0,0,0,0,0,9000,0,0,0,9000,0,9000,9000
05060P,台達電富邦97售02,0,0,0,0,0,0,0,0,0,9000,0,0,0,10000,1000,9000,9000
050107,鴻海元大94購12  ,0,0,0,0,0,0,0,0,0,9000,0,0,0,30000,21000,9000,9000
055605,緯穎元大97購02  ,0,0,0,0,0,0,0,0,0,9000,0,0,0,24000,15000,9000,9000
05128P,聯發科中信97售03,0,0,0,0,0,0,0,0,0,9000,0,0,0,20000,11000,9000,9000
056579,麗豐元大99購01  ,0,0,0,0,0,0,0,0,0,9000,0,0,0,25000,16000,9000,9000
056484,聯茂元大98購02  ,0,0,0,0,0,0,0,0,0,9000,0,0,0,10000,1000,9000,9000
055382,台郡元大99購01  ,0,0,0,0,0,0,0,0,0,9000,0,0,0,10000,1000,9000,9000
053079,世紀鋼永豐96購01,0,0,0,0,0,0,0,0,0,9000,0,0,0,14000,5000,9000,9000
05242P,群創國泰97售01  ,0,0,0,0,0,0,0,0,0,9000,0,0,0,19000,10000,9000,9000
053921,嘉晶國票97購03  ,0,0,0,0,0,0,0,0,0,9000,0,0,0,10000,1000,9000,9000
053972,華新科元大96購06,0,0,0,0,0,0,0,0,0,9000,0,0,0,10000,1000,9000,9000
057200,技嘉元富98購01  ,0,0,0,0,0,0,0,0,0,9000,0,0,0,10000,1000,9000,9000
057205,元翎元富98購01  ,0,0,0,0,0,0,0,0,0,9000,0,0,0,10000,1000,9000,9000
057189,康控元大98購02  ,0,0,0,0,0,0,0,0,0,9000,0,0,0,9000,0,9000,9000
055262,台虹國泰98購01  ,0,0,0,0,0,0,0,0,0,9000,0,0,0,69000,60000,9000,9000
055023,億光國泰98購01  ,0,0,0,0,0,0,0,0,0,9000,0,0,0,19000,10000,9000,9000
2069,運錩            ,22000,13000,9000,0,0,0,0,0,0,0,0,0,0,0,0,0,9000
6215,和椿            ,14000,7000,7000,0,0,0,0,0,0,2000,2000,0,2000,0,0,0,9000
9946,三發地產        ,9000,0,9000,0,0,0,0,0,0,0,0,0,0,0,0,0,9000
8070,長華*           ,117780,110000,7780,0,0,0,0,0,0,1000,2000,1000,1000,0,0,0,8780
05842P,台積電元大96售15,0,0,0,0,0,0,0,0,0,8000,0,0,0,8000,0,8000,8000
057528,南亞科元大99購01,0,0,0,0,0,0,0,0,0,8000,0,0,0,10000,2000,8000,8000
057407,超眾群益99購01  ,0,0,0,0,0,0,0,0,0,8000,0,0,0,8000,0,8000,8000
1232,大統益          ,42000,27000,15000,0,0,0,0,0,0,-7000,2000,9000,-7000,0,0,0,8000
06888P,日月光元大98售02,0,0,0,0,0,0,0,0,0,8000,0,0,0,31000,23000,8000,8000
06613P,華新科富邦9A售03,0,0,0,0,0,0,0,0,0,8000,0,0,0,11000,3000,8000,8000
06577P,聯發科日盛9A售02,0,0,0,0,0,0,0,0,0,8000,0,0,0,18000,10000,8000,8000
06540P,聯發科凱基98售13,0,0,0,0,0,0,0,0,0,8000,0,0,0,8000,0,8000,8000
06506P,台郡國票99售02  ,0,0,0,0,0,0,0,0,0,8000,0,0,0,8000,0,8000,8000
06286P,世芯國票97售02  ,0,0,0,0,0,0,0,0,0,8000,0,0,0,8000,0,8000,8000
05960P,欣興統一96售01  ,0,0,0,0,0,0,0,0,0,8000,0,0,0,8000,0,8000,8000
05973P,聯詠元大96售06  ,0,0,0,0,0,0,0,0,0,8000,0,0,0,11000,3000,8000,8000
055503,健策元大98購05  ,0,0,0,0,0,0,0,0,0,8000,0,0,0,8000,0,8000,8000
05167P,百和元富95售03  ,0,0,0,0,0,0,0,0,0,8000,0,0,0,25000,17000,8000,8000
04204P,臺股指元大93售44,0,0,0,0,0,0,0,0,0,8000,0,0,0,362000,354000,8000,8000
044584,世紀鋼凱基93購05,0,0,0,0,0,0,0,0,0,8000,0,0,0,8000,0,8000,8000
055101,台肥凱基97購01  ,0,0,0,0,0,0,0,0,0,8000,0,0,0,10000,2000,8000,8000
05507P,聯茂凱基96售02  ,0,0,0,0,0,0,0,0,0,8000,0,0,0,55000,47000,8000,8000
055245,凱美統一99購01  ,0,0,0,0,0,0,0,0,0,8000,0,0,0,8000,0,8000,8000
055229,大毅國票97購02  ,0,0,0,0,0,0,0,0,0,8000,0,0,0,8000,0,8000,8000
057031,滬深反元大9B購02,0,0,0,0,0,0,0,0,0,8000,0,0,0,10000,2000,8000,8000
054808,東元元大9A購01  ,0,0,0,0,0,0,0,0,0,8000,0,0,0,128000,120000,8000,8000
054957,興富發元大97購01,0,0,0,0,0,0,0,0,0,8000,0,0,0,30000,22000,8000,8000
055007,晶相光元富9A購02,0,0,0,0,0,0,0,0,0,8000,0,0,0,10000,2000,8000,8000
055814,晶豪科國票97購02,0,0,0,0,0,0,0,0,0,8000,0,0,0,8000,0,8000,8000
05541P,鴻海統一96售08  ,0,0,0,0,0,0,0,0,0,8000,0,0,0,8000,0,8000,8000
055333,晶豪科兆豐97購01,0,0,0,0,0,0,0,0,0,8000,0,0,0,25000,17000,8000,8000
05532P,臺股指群益96售05,0,0,0,0,0,0,0,0,0,8000,0,0,0,8000,0,8000,8000
056505,聯發科永豐98購01,0,0,0,0,0,0,0,0,0,8000,0,0,0,983000,975000,8000,8000
056557,世紀鋼凱基98購02,0,0,0,0,0,0,0,0,0,8000,0,0,0,18000,10000,8000,8000
054294,世芯元大96購02  ,0,0,0,0,0,0,0,0,0,8000,0,0,0,10000,2000,8000,8000
053256,上銀富邦98購01  ,0,0,0,0,0,0,0,0,0,8000,0,0,0,63000,55000,8000,8000
052604,建準元大97購01  ,0,0,0,0,0,0,0,0,0,8000,0,0,0,8000,0,8000,8000
053412,台達電國票97購02,0,0,0,0,0,0,0,0,0,8000,0,0,0,23000,15000,8000,8000
05279P,上銀元大95售02  ,0,0,0,0,0,0,0,0,0,8000,0,0,0,19000,11000,8000,8000
052989,麗豐元大98購01  ,0,0,0,0,0,0,0,0,0,8000,0,0,0,8000,0,8000,8000
9136,巨騰-DR         ,12000,2000,10000,0,0,0,0,0,0,-2000,0,2000,-2000,0,0,0,8000
3346,麗清            ,44000,36000,8000,0,0,0,0,0,0,0,0,0,0,0,0,0,8000
3058,立德            ,18000,13000,5000,0,0,0,0,0,0,3000,3000,0,3000,0,0,0,8000
05968P,鴻海台新96售02  ,0,0,0,0,0,0,0,0,0,7000,0,0,0,187000,180000,7000,7000
06127P,泰碩元富97售01  ,0,0,0,0,0,0,0,0,0,7000,0,0,0,297000,290000,7000,7000
06173P,華通元大97售02  ,0,0,0,0,0,0,0,0,0,7000,0,0,0,7000,0,7000,7000
06821P,臺股指元富98售10,0,0,0,0,0,0,0,0,0,7000,0,0,0,7000,0,7000,7000
07021P,台積電富邦9C售02,0,0,0,0,0,0,0,0,0,7000,0,0,0,17000,10000,7000,7000
06944P,健鼎元富98售02  ,0,0,0,0,0,0,0,0,0,7000,0,0,0,7000,0,7000,7000
05750P,臺股指群益99售04,0,0,0,0,0,0,0,0,0,7000,0,0,0,7000,0,7000,7000
05749P,臺股指群益99售03,0,0,0,0,0,0,0,0,0,7000,0,0,0,7000,0,7000,7000
057932,美律群益98購04  ,0,0,0,0,0,0,0,0,0,7000,0,0,0,7000,0,7000,7000
058927,勤誠元富99購02  ,0,0,0,0,0,0,0,0,0,7000,0,0,0,58000,51000,7000,7000
058933,FBVIX台新9B購01 ,0,0,0,0,0,0,0,0,0,7000,0,0,0,22000,15000,7000,7000
058730,玉晶光永豐9A購01,0,0,0,0,0,0,0,0,0,7000,0,0,0,10000,3000,7000,7000
03497P,金像電凱基02售06,0,0,0,0,0,0,0,0,0,7000,0,0,0,7000,0,7000,7000
00866,新光Shiller CAPE,0,0,0,0,0,0,0,0,0,7000,0,0,0,33000,26000,7000,7000
050322,世紀鋼國票95購01,0,0,0,0,0,0,0,0,0,7000,0,0,0,10000,3000,7000,7000
050366,鴻海元大94購19  ,0,0,0,0,0,0,0,0,0,7000,0,0,0,20000,13000,7000,7000
04763P,臺股指凱基96售05,0,0,0,0,0,0,0,0,0,7000,0,0,0,53000,46000,7000,7000
044809,道瓊反國票93購01,0,0,0,0,0,0,0,0,0,7000,0,0,0,7000,0,7000,7000
048860,玉晶光群益96購03,0,0,0,0,0,0,0,0,0,7000,0,0,0,10000,3000,7000,7000
052192,SP黃豆元富95購04,0,0,0,0,0,0,0,0,0,7000,0,0,0,7000,0,7000,7000
05013P,台積電元大96售05,0,0,0,0,0,0,0,0,0,7000,0,0,0,120000,113000,7000,7000
04964P,鴻海元大94售26  ,0,0,0,0,0,0,0,0,0,7000,0,0,0,7000,0,7000,7000
049667,大立光國泰96購01,0,0,0,0,0,0,0,0,0,7000,0,0,0,7000,0,7000,7000
05548P,臺股指元大96售02,0,0,0,0,0,0,0,0,0,7000,0,0,0,7000,0,7000,7000
055993,致茂國泰99購01  ,0,0,0,0,0,0,0,0,0,7000,0,0,0,57000,50000,7000,7000
051624,智邦麥證95購02  ,0,0,0,17000,10000,7000,0,0,0,7000,0,0,0,17000,10000,7000,7000
052990,超眾元大97購01  ,0,0,0,0,0,0,0,0,0,7000,0,0,0,7000,0,7000,7000
053292,美律中信98購01  ,0,0,0,0,0,0,0,0,0,7000,0,0,0,7000,0,7000,7000
052685,技嘉元大96購01  ,0,0,0,0,0,0,0,0,0,7000,0,0,0,66000,59000,7000,7000
053534,微星永豐96購02  ,0,0,0,0,0,0,0,0,0,7000,0,0,0,71000,64000,7000,7000
053506,南茂兆豐97購01  ,0,0,0,0,0,0,0,0,0,7000,0,0,0,32000,25000,7000,7000
054697,凌華永豐97購01  ,0,0,0,0,0,0,0,0,0,7000,0,0,0,7000,0,7000,7000
054016,嘉晶永豐96購04  ,0,0,0,0,0,0,0,0,0,7000,0,0,0,64000,57000,7000,7000
054039,元油反元大96購08,0,0,0,0,0,0,0,0,0,7000,0,0,0,43000,36000,7000,7000
053902,S&P反1凱基97購01,0,0,0,0,0,0,0,0,0,7000,0,0,0,7000,0,7000,7000
056862,聯發科群益98購03,0,0,0,0,0,0,0,0,0,7000,0,0,0,7000,0,7000,7000
056958,喬山永豐98購01  ,0,0,0,0,0,0,0,0,0,7000,0,0,0,7000,0,7000,7000
056980,建準群益98購02  ,0,0,0,0,0,0,0,0,0,7000,0,0,0,10000,3000,7000,7000
3024,憶聲            ,39000,26000,13000,0,0,0,0,0,0,-6000,0,6000,-6000,0,0,0,7000
3622,洋華            ,62000,59000,3000,0,0,0,0,0,0,4000,4000,0,4000,0,0,0,7000
6128,上福            ,17000,13000,4000,0,0,0,0,0,0,3000,3000,0,3000,0,0,0,7000
2427,三商電          ,9000,7000,2000,0,0,0,0,0,0,5000,5000,0,5000,0,0,0,7000
2731,雄獅            ,37000,30000,7000,0,0,0,0,0,0,0,0,0,0,0,0,0,7000
2530,華建            ,20000,13000,7000,0,0,0,0,0,0,0,0,0,0,0,0,0,7000
9941A,裕融甲特        ,0,0,0,0,0,0,0,0,0,7000,7000,0,7000,0,0,0,7000
05897P,國巨凱基96售12  ,0,0,0,0,0,0,0,0,0,6000,0,0,0,15000,9000,6000,6000
058554,瀚宇博永豐99購01,0,0,0,0,0,0,0,0,0,6000,0,0,0,6000,0,6000,6000
058651,FBVIX中信9C購01 ,0,0,0,0,0,0,0,0,0,6000,0,0,0,6000,0,6000,6000
058233,聯發科元大99購06,0,0,0,0,0,0,0,0,0,6000,0,0,0,304000,298000,6000,6000
057610,致茂元富98購02  ,0,0,0,0,0,0,0,0,0,6000,0,0,0,6000,0,6000,6000
07063P,臺股指元大9A售24,0,0,0,0,0,0,0,0,0,6000,0,0,0,6000,0,6000,6000
07060P,台表科國票9A售01,0,0,0,0,0,0,0,0,0,6000,0,0,0,22000,16000,6000,6000
07031P,台灣50中信03售02,0,0,0,0,0,0,0,0,0,6000,0,0,0,6000,0,6000,6000
06763P,技嘉元大98售05  ,0,0,0,0,0,0,0,0,0,6000,0,0,0,10000,4000,6000,6000
06935P,神達元大98售02  ,0,0,0,0,0,0,0,0,0,6000,0,0,0,11000,5000,6000,6000
06916P,聯鈞元富98售02  ,0,0,0,0,0,0,0,0,0,6000,0,0,0,6000,0,6000,6000
1256,鮮活果汁-KY     ,63000,53000,10000,0,0,0,0,0,0,-4000,0,4000,-4000,0,0,0,6000
1541,錩泰            ,1000,3000,-2000,0,0,0,0,0,0,8000,8000,0,8000,0,0,0,6000
06174P,國巨元大97售07  ,0,0,0,0,0,0,0,0,0,6000,0,0,0,7000,1000,6000,6000
06140P,華新科群益97售06,0,0,0,0,0,0,0,0,0,6000,0,0,0,6000,0,6000,6000
06046P,健策統一96售03  ,0,0,0,0,0,0,0,0,0,6000,0,0,0,7000,1000,6000,6000
05947P,大成鋼元大96售03,0,0,0,0,0,0,0,0,0,6000,0,0,0,16000,10000,6000,6000
06299P,可成元大97售04  ,0,0,0,0,0,0,0,0,0,6000,0,0,0,10000,4000,6000,6000
06494P,鴻海永昌98售03  ,0,0,0,0,0,0,0,0,0,6000,0,0,0,6000,0,6000,6000
06534P,聯發科群益98售04,0,0,0,0,0,0,0,0,0,6000,0,0,0,10000,4000,6000,6000
055922,台郡凱基98購03  ,0,0,0,0,0,0,0,0,0,6000,0,0,0,6000,0,6000,6000
05602P,國巨元大96售06  ,0,0,0,0,0,0,0,0,0,6000,0,0,0,6000,0,6000,6000
051448,聯詠元大95購02  ,0,0,0,0,0,0,0,0,0,6000,0,0,0,6000,0,6000,6000
051991,泰碩元大95購02  ,0,0,0,0,0,0,0,0,0,6000,0,0,0,36000,30000,6000,6000
050055,道瓊反凱基95購01,0,0,0,0,0,0,0,0,0,6000,0,0,0,6000,0,6000,6000
052191,超眾群益96購01  ,0,0,0,0,0,0,0,0,0,6000,0,0,0,6000,0,6000,6000
04602P,聯詠凱基94售02  ,0,0,0,0,0,0,0,0,0,6000,0,0,0,6000,0,6000,6000
05032P,台積電國泰96售05,0,0,0,0,0,0,0,0,0,6000,0,0,0,11000,5000,6000,6000
00770,國泰北美科技    ,2000,4000,-2000,0,0,0,0,0,0,8000,0,0,0,21000,13000,8000,6000
04436P,聯發科中信96售02,0,0,0,0,0,0,0,0,0,6000,0,0,0,21000,15000,6000,6000
04860P,鴻海群益94售07  ,0,0,0,0,0,0,0,0,0,6000,0,0,0,6000,0,6000,6000
05705P,上証2X永豐96售03,0,0,0,0,0,0,0,0,0,6000,0,0,0,6000,0,6000,6000
055042,得力永豐97購01  ,0,0,0,0,0,0,0,0,0,6000,0,0,0,6000,0,6000,6000
053612,T50反1群益96購01,0,0,0,0,0,0,0,0,0,6000,0,0,0,6000,0,6000,6000
054684,裕隆永豐97購01  ,0,0,0,0,0,0,0,0,0,6000,0,0,0,46000,40000,6000,6000
054941,凱美元大97購01  ,0,0,0,0,0,0,0,0,0,6000,0,0,0,24000,18000,6000,6000
054547,鴻海凱基98購02  ,0,0,0,0,0,0,0,0,0,6000,0,0,0,6000,0,6000,6000
053312,緯穎凱基96購02  ,0,0,0,0,0,0,0,0,0,6000,0,0,0,8000,2000,6000,6000
056744,麗豐凱基9A購01  ,0,0,0,0,0,0,0,0,0,6000,0,0,0,66000,60000,6000,6000
052967,智邦群益96購01  ,0,0,0,0,0,0,0,0,0,6000,0,0,0,6000,0,6000,6000
05288P,寶成元富95售02  ,0,0,0,0,0,0,0,0,0,6000,0,0,0,6000,0,6000,6000
056444,南亞科凱基99購01,0,0,0,0,0,0,0,0,0,6000,0,0,0,12000,6000,6000,6000
05574P,英業達元富96售01,0,0,0,0,0,0,0,0,0,6000,0,0,0,16000,10000,6000,6000
055761,創意群益97購01  ,0,0,0,0,0,0,0,0,0,6000,0,0,0,6000,0,6000,6000
053155,晶技元大97購02  ,0,0,0,0,0,0,0,0,0,6000,0,0,0,21000,15000,6000,6000
9943,好樂迪          ,81000,75000,6000,0,0,0,0,0,0,0,0,0,0,0,0,0,6000
6525,捷敏-KY         ,121000,65000,56000,0,0,0,0,50000,-50000,0,0,0,0,0,0,0,6000
2611,志信            ,20000,14000,6000,0,0,0,0,0,0,0,0,0,0,0,0,0,6000
4144,康聯-KY         ,21000,15000,6000,0,0,0,0,0,0,0,0,0,0,0,0,0,6000
3454,晶睿            ,97000,91000,6000,0,0,0,0,0,0,0,0,0,0,0,0,0,6000
1477,聚陽            ,1301000,1441050,-140050,0,0,0,0,0,0,146000,134000,2000,132000,14000,0,14000,5950
9940,信義            ,98438,97000,1438,0,0,0,0,0,0,4000,4000,0,4000,0,0,0,5438
08749P,鴻海台新01售02  ,0,0,0,0,0,0,0,0,0,5000,0,0,0,5000,0,5000,5000
06811P,聯發科統一98售06,0,0,0,0,0,0,0,0,0,5000,0,0,0,5000,0,5000,5000
06771P,台灣50中信02售01,0,0,0,0,0,0,0,0,0,5000,0,0,0,5000,0,5000,5000
07005P,台積電統一9B售05,0,0,0,0,0,0,0,0,0,5000,0,0,0,5000,0,5000,5000
06532P,友達元富98售04  ,0,0,0,0,0,0,0,0,0,5000,0,0,0,5000,0,5000,5000
06490P,鴻海富邦99售02  ,0,0,0,0,0,0,0,0,0,5000,0,0,0,85000,80000,5000,5000
06515P,國巨凱基98售06  ,0,0,0,0,0,0,0,0,0,5000,0,0,0,5000,0,5000,5000
06627P,華新科元富99售01,0,0,0,0,0,0,0,0,0,5000,0,0,0,5000,0,5000,5000
06624P,訊芯元大98售06  ,0,0,0,0,0,0,0,0,0,5000,0,0,0,15000,10000,5000,5000
06666P,台積電日盛9A售02,0,0,0,0,0,0,0,0,0,5000,0,0,0,5000,0,5000,5000
06234P,亞德客元大97售02,0,0,0,0,0,0,0,0,0,5000,0,0,0,15000,10000,5000,5000
06366P,鴻海凱基97售10  ,0,0,0,0,0,0,0,0,0,5000,0,0,0,95000,90000,5000,5000
06354P,大立光永豐97售04,0,0,0,0,0,0,0,0,0,5000,0,0,0,5000,0,5000,5000
06417P,台積電兆豐97售03,0,0,0,0,0,0,0,0,0,5000,0,0,0,5000,0,5000,5000
06374P,台表科元大97售06,0,0,0,0,0,0,0,0,0,5000,0,0,0,7000,2000,5000,5000
05920P,力成元大96售04  ,0,0,0,0,0,0,0,0,0,5000,0,0,0,32000,27000,5000,5000
05977P,旺宏永豐96售06  ,0,0,0,0,0,0,0,0,0,5000,0,0,0,5000,0,5000,5000
05910P,力山永豐96售02  ,0,0,0,0,0,0,0,0,0,5000,0,0,0,5000,0,5000,5000
06143P,鴻海永豐97售02  ,0,0,0,0,0,0,0,0,0,5000,0,0,0,5000,0,5000,5000
057544,鴻海凱基02購01  ,0,0,0,0,0,0,0,0,0,5000,0,0,0,5000,0,5000,5000
057473,T50反1元大98購08,0,0,0,0,0,0,0,0,0,5000,0,0,0,16000,11000,5000,5000
057831,聯發科元富02購04,0,0,0,0,0,0,0,0,0,5000,0,0,0,10000,5000,5000,5000
057681,T50反1日盛9C購01,0,0,0,0,0,0,0,0,0,5000,0,0,0,5000,0,5000,5000
057672,茂林元大98購02  ,0,0,0,0,0,0,0,0,0,5000,0,0,0,15000,10000,5000,5000
057919,技嘉凱基98購03  ,0,0,0,0,0,0,0,0,0,5000,0,0,0,5000,0,5000,5000
05800P,台積電兆豐96售04,0,0,0,0,0,0,0,0,0,5000,0,0,0,14000,9000,5000,5000
058084,大立光群益98購04,0,0,0,0,0,0,0,0,0,5000,0,0,0,5000,0,5000,5000
058630,日月光國票9A購01,0,0,0,0,0,0,0,0,0,5000,0,0,0,5000,0,5000,5000
058680,國巨麥證99購02  ,0,0,0,5000,0,5000,0,0,0,5000,0,0,0,5000,0,5000,5000
058362,聯發科凱基99購06,0,0,0,0,0,0,0,0,0,5000,0,0,0,5000,0,5000,5000
058373,晶技凱基99購02  ,0,0,0,0,0,0,0,0,0,5000,0,0,0,288000,283000,5000,5000
05880P,創意康和96售01  ,0,0,0,0,0,0,0,0,0,5000,0,0,0,5000,0,5000,5000
044249,T50反1中信94購01,0,0,0,0,0,0,0,0,0,5000,0,0,0,5000,0,5000,5000
04440P,訊芯群益94售01  ,0,0,0,0,0,0,0,0,0,5000,0,0,0,5000,0,5000,5000
048348,矽力元大93購03  ,0,0,0,0,0,0,0,0,0,5000,0,0,0,5000,0,5000,5000
03520P,臺股指國票02售09,0,0,0,0,0,0,0,0,0,5000,0,0,0,5000,0,5000,5000
039212,台達電台新9A購01,0,0,0,0,0,0,0,0,0,5000,0,0,0,5000,0,5000,5000
04366P,全新元富95售01  ,0,0,0,0,0,0,0,0,0,5000,0,0,0,5000,0,5000,5000
042994,葡萄王元大94購02,0,0,0,0,0,0,0,0,0,5000,0,0,0,133000,128000,5000,5000
04225P,台積電元富94售02,0,0,0,0,0,0,0,0,0,5000,0,0,0,45000,40000,5000,5000
03038X,元展35          ,0,0,0,0,0,0,0,0,0,5000,0,0,0,5000,0,5000,5000
050336,緯穎國泰94購02  ,0,0,0,0,0,0,0,0,0,5000,0,0,0,5000,0,5000,5000
05041P,大立光凱基95售09,0,0,0,0,0,0,0,0,0,5000,0,0,0,5000,0,5000,5000
047406,香港反統一94購01,0,0,0,0,0,0,0,0,0,5000,0,0,0,5000,0,5000,5000
047435,台積電元大94購01,0,0,0,0,0,0,0,0,0,5000,0,0,0,10000,5000,5000,5000
047626,全新國票94購01  ,0,0,0,0,0,0,0,0,0,5000,0,0,0,5000,0,5000,5000
04578P,微星富邦96售01  ,0,0,0,0,0,0,0,0,0,5000,0,0,0,5000,0,5000,5000
045759,T50反1統一94購02,0,0,0,0,0,0,0,0,0,5000,0,0,0,5000,0,5000,5000
04517P,宏達電群益95售01,0,0,0,0,0,0,0,0,0,5000,0,0,0,5000,0,5000,5000
051704,智邦群益95購02  ,0,0,0,0,0,0,0,0,0,5000,0,0,0,95000,90000,5000,5000
04884P,聯發科凱基94售20,0,0,0,0,0,0,0,0,0,5000,0,0,0,5000,0,5000,5000
052180,緯穎元大96購05  ,0,0,0,0,0,0,0,0,0,5000,0,0,0,5000,0,5000,5000
05121P,創意國泰96售01  ,0,0,0,0,0,0,0,0,0,5000,0,0,0,10000,5000,5000,5000
05119P,聯發科國泰96售02,0,0,0,0,0,0,0,0,0,5000,0,0,0,5000,0,5000,5000
050850,訊連國票96購01  ,0,0,0,0,0,0,0,0,0,5000,0,0,0,5000,0,5000,5000
05081P,京鼎永豐95售01  ,0,0,0,0,0,0,0,0,0,5000,0,0,0,5000,0,5000,5000
052078,大立光元富95購10,0,0,0,0,0,0,0,0,0,5000,0,0,0,5000,0,5000,5000
052132,旺宏凱基9B購01  ,0,0,0,0,0,0,0,0,0,5000,0,0,0,6000,1000,5000,5000
04955P,大立光日盛94售02,0,0,0,0,0,0,0,0,0,5000,0,0,0,5000,0,5000,5000
049563,華新統一95購01  ,0,0,0,0,0,0,0,0,0,5000,0,0,0,5000,0,5000,5000
05005P,台表科統一95售01,0,0,0,0,0,0,0,0,0,5000,0,0,0,5000,0,5000,5000
05010P,台郡元富95售01  ,0,0,0,0,0,0,0,0,0,5000,0,0,0,5000,0,5000,5000
049686,T50反1元大94購02,0,0,0,0,0,0,0,0,0,5000,0,0,0,5000,0,5000,5000
04936P,大立光中信95售03,0,0,0,0,0,0,0,0,0,5000,0,0,0,20000,15000,5000,5000
049231,鴻海富邦95購02  ,0,0,0,0,0,0,0,0,0,5000,0,0,0,5000,0,5000,5000
049212,T50反1國票94購04,0,0,0,0,0,0,0,0,0,5000,0,0,0,5000,0,5000,5000
05145P,道瓊反元大98售01,0,0,0,0,0,0,0,0,0,5000,0,0,0,5000,0,5000,5000
048987,崇越元大94購01  ,0,0,0,0,0,0,0,0,0,5000,0,0,0,15000,10000,5000,5000
055958,台光電元大97購02,0,0,0,0,0,0,0,0,0,5000,0,0,0,5000,0,5000,5000
055892,國巨統一99購01  ,0,0,0,0,0,0,0,0,0,5000,0,0,0,5000,0,5000,5000
055471,聯發科凱基97購04,0,0,0,0,0,0,0,0,0,5000,0,0,0,5000,0,5000,5000
053162,緯穎元大97購01  ,0,0,0,0,0,0,0,0,0,5000,0,0,0,10000,5000,5000,5000
055739,健鼎元富97購01  ,0,0,0,0,0,0,0,0,0,5000,0,0,0,5000,0,5000,5000
055277,旺宏元大97購04  ,0,0,0,0,0,0,0,0,0,5000,0,0,0,5000,0,5000,5000
056146,台虹元大98購01  ,0,0,0,0,0,0,0,0,0,5000,0,0,0,5000,0,5000,5000
056305,群創元大9A購03  ,0,0,0,0,0,0,0,0,0,5000,0,0,0,5000,0,5000,5000
05652P,臻鼎群益96售01  ,0,0,0,0,0,0,0,0,0,5000,0,0,0,5000,0,5000,5000
056531,佳世達凱基98購01,0,0,0,0,0,0,0,0,0,5000,0,0,0,20000,15000,5000,5000
052947,晶技國票97購01  ,0,0,0,0,0,0,0,0,0,5000,0,0,0,5000,0,5000,5000
053194,緯穎統一99購01  ,0,0,0,0,0,0,0,0,0,5000,0,0,0,10000,5000,5000,5000
053281,茂林元大96購02  ,0,0,0,0,0,0,0,0,0,5000,0,0,0,10000,5000,5000,5000
056149,亞光康和97購01  ,0,0,0,0,0,0,0,0,0,5000,0,0,0,5000,0,5000,5000
05238P,禾伸堂永豐95售01,0,0,0,0,0,0,0,0,0,5000,0,0,0,76000,71000,5000,5000
053490,為升兆豐97購01  ,0,0,0,0,0,0,0,0,0,5000,0,0,0,5000,0,5000,5000
054959,禾伸堂元大98購01,0,0,0,0,0,0,0,0,0,5000,0,0,0,25000,20000,5000,5000
054730,上証2X凱基98購02,0,0,0,0,0,0,0,0,0,5000,0,0,0,5000,0,5000,5000
054133,奇力新元大97購04,0,0,0,0,0,0,0,0,0,5000,0,0,0,5000,0,5000,5000
055176,大毅統一98購02  ,0,0,0,0,0,0,0,0,0,5000,0,0,0,5000,0,5000,5000
05700P,臻鼎凱基96售02  ,0,0,0,0,0,0,0,0,0,5000,0,0,0,5000,0,5000,5000
056983,大立光群益99購02,0,0,0,0,0,0,0,0,0,5000,0,0,0,5000,0,5000,5000
05712P,友達統一97售03  ,0,0,0,0,0,0,0,0,0,5000,0,0,0,5000,0,5000,5000
057231,美律凱基98購05  ,0,0,0,0,0,0,0,0,0,5000,0,0,0,26000,21000,5000,5000
057367,技嘉元大98購02  ,0,0,0,0,0,0,0,0,0,5000,0,0,0,15000,10000,5000,5000
057391,樺漢永豐98購01  ,0,0,0,0,0,0,0,0,0,5000,0,0,0,5000,0,5000,5000
05730P,臺股指凱基97售03,0,0,0,0,0,0,0,0,0,5000,0,0,0,5000,0,5000,5000
6216,居易            ,25000,23000,2000,0,0,0,0,0,0,3000,3000,0,3000,0,0,0,5000
6165,捷泰            ,70000,65000,5000,0,0,0,0,0,0,0,0,0,0,0,0,0,5000
5225,東科-KY         ,140000,136000,4000,0,0,0,0,0,0,1000,2000,1000,1000,0,0,0,5000
2462,良得電          ,14000,12000,2000,0,0,0,0,0,0,3000,3000,0,3000,0,0,0,5000
058994,道瓊指元大99購01,0,0,0,0,0,0,0,0,0,4000,0,0,0,6000,2000,4000,4000
058951,南電群益99購01  ,0,0,0,0,0,0,0,0,0,4000,0,0,0,4000,0,4000,4000
05808P,臺股指國票96售01,0,0,0,0,0,0,0,0,0,4000,0,0,0,4000,0,4000,4000
058091,欣興元大99購03  ,0,0,0,0,0,0,0,0,0,4000,0,0,0,14000,10000,4000,4000
058311,緯穎元大99購05  ,0,0,0,0,0,0,0,0,0,4000,0,0,0,49000,45000,4000,4000
057779,禾伸堂群益98購02,0,0,0,0,0,0,0,0,0,4000,0,0,0,4000,0,4000,4000
057402,嘉晶群益98購02  ,0,0,0,0,0,0,0,0,0,4000,0,0,0,4000,0,4000,4000
057403,亞光群益98購04  ,0,0,0,0,0,0,0,0,0,4000,0,0,0,9000,5000,4000,4000
06038P,國泰金台新96售01,0,0,0,0,0,0,0,0,0,4000,0,0,0,469000,465000,4000,4000
05954P,旺宏國票97售03  ,0,0,0,0,0,0,0,0,0,4000,0,0,0,4000,0,4000,4000
05948P,茂林元大96售03  ,0,0,0,0,0,0,0,0,0,4000,0,0,0,289000,285000,4000,4000
06452P,大立光元大98售08,0,0,0,0,0,0,0,0,0,4000,0,0,0,25000,21000,4000,4000
06498P,臺股指元大9A售03,0,0,0,0,0,0,0,0,0,4000,0,0,0,4000,0,4000,4000
07088P,訊芯永豐99售02  ,0,0,0,0,0,0,0,0,0,4000,0,0,0,4000,0,4000,4000
06870P,台灣50群益9A售03,0,0,0,0,0,0,0,0,0,4000,0,0,0,4000,0,4000,4000
06902P,聯電凱基98售02  ,0,0,0,0,0,0,0,0,0,4000,0,0,0,10000,6000,4000,4000
06878P,台灣50日盛9B售01,0,0,0,0,0,0,0,0,0,4000,0,0,0,117000,113000,4000,4000
06865P,亞德客元大98售04,0,0,0,0,0,0,0,0,0,4000,0,0,0,14000,10000,4000,4000
1535,中宇            ,13000,9000,4000,0,0,0,0,0,0,0,0,0,0,0,0,0,4000
05230P,京元電群益95售01,0,0,0,0,0,0,0,0,0,4000,0,0,0,4000,0,4000,4000
050990,T50反1元大95購01,0,0,0,0,0,0,0,0,0,4000,0,0,0,4000,0,4000,4000
049815,緯穎元大94購06  ,0,0,0,0,0,0,0,0,0,4000,0,0,0,4000,0,4000,4000
049891,T50反1富邦94購02,0,0,0,0,0,0,0,0,0,4000,0,0,0,4000,0,4000,4000
04612P,上銀群益94售01  ,0,0,0,0,0,0,0,0,0,4000,0,0,0,4000,0,4000,4000
050402,緯穎中信96購01  ,0,0,0,0,0,0,0,0,0,4000,0,0,0,4000,0,4000,4000
050275,緯穎元大94購10  ,0,0,0,0,0,0,0,0,0,4000,0,0,0,4000,0,4000,4000
04396P,玉晶光群益94售02,0,0,0,0,0,0,0,0,0,4000,0,0,0,4000,0,4000,4000
03604P,群創凱基98售05  ,0,0,0,0,0,0,0,0,0,4000,0,0,0,10000,6000,4000,4000
04234P,華通群益94售02  ,0,0,0,0,0,0,0,0,0,4000,0,0,0,42000,38000,4000,4000
00650L,FH香港正2       ,0,0,0,0,0,0,0,0,0,4000,0,0,0,227000,223000,4000,4000
048349,美利達元大96購02,0,0,0,0,0,0,0,0,0,4000,0,0,0,4000,0,4000,4000
04864P,欣興元大94售10  ,0,0,0,0,0,0,0,0,0,4000,0,0,0,4000,0,4000,4000
04427P,滬深2X元大97售02,0,0,0,0,0,0,0,0,0,4000,0,0,0,4000,0,4000,4000
057188,佐登元大98購01  ,0,0,0,0,0,0,0,0,0,4000,0,0,0,14000,10000,4000,4000
057073,康控永豐98購01  ,0,0,0,0,0,0,0,0,0,4000,0,0,0,10000,6000,4000,4000
056904,大立光元大99購05,0,0,0,0,0,0,0,0,0,4000,0,0,0,50000,46000,4000,4000
052451,旭富元大95購02  ,0,0,0,0,0,0,0,0,0,4000,0,0,0,83000,79000,4000,4000
053280,群創元大9C購01  ,0,0,0,0,0,0,0,0,0,4000,0,0,0,4000,0,4000,4000
056548,瀚宇博凱基98購02,0,0,0,0,0,0,0,0,0,4000,0,0,0,4000,0,4000,4000
056273,祥碩統一97購02  ,0,0,0,0,0,0,0,0,0,4000,0,0,0,14000,10000,4000,4000
056447,聯發科凱基98購09,0,0,0,0,0,0,0,0,0,4000,0,0,0,4000,0,4000,4000
055403,泰鼎元富97購01  ,0,0,0,0,0,0,0,0,0,4000,0,0,0,4000,0,4000,4000
053173,矽格群益97購01  ,0,0,0,0,0,0,0,0,0,4000,0,0,0,5000,1000,4000,4000
2614,東森            ,534000,530000,4000,0,0,0,0,0,0,0,0,0,0,0,0,0,4000
2852,第一保          ,24000,26000,-2000,0,0,0,0,0,0,6000,7000,1000,6000,0,0,0,4000
3686,達能            ,8000,4000,4000,0,0,0,0,0,0,0,0,0,0,0,0,0,4000
6409,旭隼            ,104000,103154,846,0,0,0,1000,0,1000,2000,2000,0,2000,0,0,0,3846
08714P,華碩元富01售03  ,0,0,0,0,0,0,0,0,0,3000,0,0,0,53000,50000,3000,3000
08966P,臺指反元大04售07,0,0,0,0,0,0,0,0,0,3000,0,0,0,8000,5000,3000,3000
1339,昭輝            ,91000,96000,-5000,0,0,0,0,1000,-1000,9000,9000,0,9000,0,0,0,3000
06903P,技嘉凱基98售04  ,0,0,0,0,0,0,0,0,0,3000,0,0,0,3000,0,3000,3000
06895P,台灣50統一9A售01,0,0,0,0,0,0,0,0,0,3000,0,0,0,145000,142000,3000,3000
06765P,欣興元大98售11  ,0,0,0,0,0,0,0,0,0,3000,0,0,0,3000,0,3000,3000
06792P,臺股指凱基98售02,0,0,0,0,0,0,0,0,0,3000,0,0,0,3000,0,3000,3000
06965P,台積電台新99售02,0,0,0,0,0,0,0,0,0,3000,0,0,0,1043000,1040000,3000,3000
06516P,國巨凱基98售08  ,0,0,0,0,0,0,0,0,0,3000,0,0,0,3000,0,3000,3000
06524P,臺股指麥證98售02,0,0,0,3000,0,3000,0,0,0,3000,0,0,0,3000,0,3000,3000
06576P,台光電群益98售03,0,0,0,0,0,0,0,0,0,3000,0,0,0,3000,0,3000,3000
06593P,欣興元大98售05  ,0,0,0,0,0,0,0,0,0,3000,0,0,0,13000,10000,3000,3000
06456P,聯發科統一98售03,0,0,0,0,0,0,0,0,0,3000,0,0,0,3000,0,3000,3000
06471P,臺股指凱基99售11,0,0,0,0,0,0,0,0,0,3000,0,0,0,3000,0,3000,3000
06428P,國巨元大97售17  ,0,0,0,0,0,0,0,0,0,3000,0,0,0,465000,462000,3000,3000
06345P,臺股指統一9A售01,0,0,0,0,0,0,0,0,0,3000,0,0,0,3000,0,3000,3000
06112P,台積電兆豐97售01,0,0,0,0,0,0,0,0,0,3000,0,0,0,3000,0,3000,3000
06213P,大立光元大98售07,0,0,0,0,0,0,0,0,0,3000,0,0,0,7000,4000,3000,3000
06187P,國巨統一97售05  ,0,0,0,0,0,0,0,0,0,3000,0,0,0,3000,0,3000,3000
05747P,漢唐群益96售03  ,0,0,0,0,0,0,0,0,0,3000,0,0,0,3000,0,3000,3000
057483,微星元大98購04  ,0,0,0,0,0,0,0,0,0,3000,0,0,0,3000,0,3000,3000
05748P,臺股指群益99售02,0,0,0,0,0,0,0,0,0,3000,0,0,0,3000,0,3000,3000
05788P,臺股指永昌96售05,0,0,0,0,0,0,0,0,0,3000,0,0,0,13000,10000,3000,3000
058916,SGBR2X元富99購02,0,0,0,0,0,0,0,0,0,3000,0,0,0,3000,0,3000,3000
058346,嘉晶群益99購01  ,0,0,0,0,0,0,0,0,0,3000,0,0,0,3000,0,3000,3000
058456,京鼎永豐99購01  ,0,0,0,0,0,0,0,0,0,3000,0,0,0,3000,0,3000,3000
05844P,旺宏元大96售07  ,0,0,0,0,0,0,0,0,0,3000,0,0,0,73000,70000,3000,3000
058582,禾伸堂群益99購02,0,0,0,0,0,0,0,0,0,3000,0,0,0,3000,0,3000,3000
038489,T50反1台新9A購01,0,0,0,0,0,0,0,0,0,3000,0,0,0,3000,0,3000,3000
04820P,聯茂永豐94售02  ,0,0,0,0,0,0,0,0,0,3000,0,0,0,3000,0,3000,3000
04824P,亞泥中信94售02  ,0,0,0,0,0,0,0,0,0,3000,0,0,0,3000,0,3000,3000
006203,元大MSCI台灣    ,1000,0,1000,0,0,0,0,0,0,2000,0,0,0,8000,6000,2000,3000
00735,國泰臺韓科技    ,58000,0,58000,0,0,0,0,0,0,-55000,0,0,0,102000,157000,-55000,3000
00700,富邦恒生國企    ,0,0,0,0,0,0,0,0,0,3000,0,0,0,17000,14000,3000,3000
04290P,滬深2X富邦96售03,0,0,0,0,0,0,0,0,0,3000,0,0,0,3000,0,3000,3000
04274P,滬深2X凱基94售01,0,0,0,0,0,0,0,0,0,3000,0,0,0,3000,0,3000,3000
04342P,揚明光永豐93售03,0,0,0,0,0,0,0,0,0,3000,0,0,0,13000,10000,3000,3000
05037P,華新科元大95售09,0,0,0,0,0,0,0,0,0,3000,0,0,0,33000,30000,3000,3000
05040P,聯發科凱基95售05,0,0,0,0,0,0,0,0,0,3000,0,0,0,3000,0,3000,3000
05181P,健策凱基95售01  ,0,0,0,0,0,0,0,0,0,3000,0,0,0,65000,62000,3000,3000
046087,亞德客兆豐93購01,0,0,0,0,0,0,0,0,0,3000,0,0,0,3000,0,3000,3000
04584P,楠梓電永豐94售01,0,0,0,0,0,0,0,0,0,3000,0,0,0,3000,0,3000,3000
04616P,臺股指群益95售02,0,0,0,0,0,0,0,0,0,3000,0,0,0,3000,0,3000,3000
04765P,宏達電永豐94售02,0,0,0,0,0,0,0,0,0,3000,0,0,0,3000,0,3000,3000
04814P,健策元大96售01  ,0,0,0,0,0,0,0,0,0,3000,0,0,0,15000,12000,3000,3000
04779P,大立光凱基94售10,0,0,0,0,0,0,0,0,0,3000,0,0,0,3000,0,3000,3000
04971P,矽力元富94售02  ,0,0,0,0,0,0,0,0,0,3000,0,0,0,26000,23000,3000,3000
05001P,華通統一95售01  ,0,0,0,0,0,0,0,0,0,3000,0,0,0,3000,0,3000,3000
050673,旺宏富邦96購02  ,0,0,0,0,0,0,0,0,0,3000,0,0,0,30000,27000,3000,3000
050719,世紀鋼群益96購01,0,0,0,0,0,0,0,0,0,3000,0,0,0,65000,62000,3000,3000
05116P,台積電群益95售03,0,0,0,0,0,0,0,0,0,3000,0,0,0,8000,5000,3000,3000
052203,T50反1中信99購03,0,0,0,0,0,0,0,0,0,3000,0,0,0,3000,0,3000,3000
05177P,台積電凱基95售12,0,0,0,0,0,0,0,0,0,3000,0,0,0,3000,0,3000,3000
050957,T50反1台新05購01,0,0,0,0,0,0,0,0,0,3000,0,0,0,3000,0,3000,3000
05223P,臻鼎凱基95售02  ,0,0,0,0,0,0,0,0,0,3000,0,0,0,3000,0,3000,3000
052255,T50反1國泰96購01,0,0,0,0,0,0,0,0,0,3000,0,0,0,3000,0,3000,3000
05141P,華通台新96售01  ,0,0,0,0,0,0,0,0,0,3000,0,0,0,10000,7000,3000,3000
051482,玉晶光凱基96購01,0,0,0,0,0,0,0,0,0,3000,0,0,0,3000,0,3000,3000
051424,緯穎國票97購01  ,0,0,0,0,0,0,0,0,0,3000,0,0,0,3000,0,3000,3000
052369,矽力國票96購02  ,0,0,0,0,0,0,0,0,0,3000,0,0,0,3000,0,3000,3000
055644,致茂元富97購01  ,0,0,0,0,0,0,0,0,0,3000,0,0,0,3000,0,3000,3000
055878,泰碩元富97購02  ,0,0,0,0,0,0,0,0,0,3000,0,0,0,3000,0,3000,3000
055960,義隆元大97購01  ,0,0,0,0,0,0,0,0,0,3000,0,0,0,18000,15000,3000,3000
056029,國巨麥證98購01  ,0,0,0,3000,0,3000,0,0,0,3000,0,0,0,3000,0,3000,3000
056082,旺宏統一99購02  ,0,0,0,0,0,0,0,0,0,3000,0,0,0,3000,0,3000,3000
055384,緯穎元大98購02  ,0,0,0,0,0,0,0,0,0,3000,0,0,0,31000,28000,3000,3000
05422P,大立光中信97售02,0,0,0,0,0,0,0,0,0,3000,0,0,0,26000,23000,3000,3000
056442,瑞昱凱基98購02  ,0,0,0,0,0,0,0,0,0,3000,0,0,0,3000,0,3000,3000
05654P,台光電統一96售01,0,0,0,0,0,0,0,0,0,3000,0,0,0,3000,0,3000,3000
05653P,華邦電統一96售02,0,0,0,0,0,0,0,0,0,3000,0,0,0,3000,0,3000,3000
05651P,大立光元大97售02,0,0,0,0,0,0,0,0,0,3000,0,0,0,13000,10000,3000,3000
056398,南茂永豐98購01  ,0,0,0,0,0,0,0,0,0,3000,0,0,0,20000,17000,3000,3000
056825,深中小富邦9B購01,0,0,0,0,0,0,0,0,0,3000,0,0,0,6000,3000,3000,3000
052836,旺宏國泰98購01  ,0,0,0,0,0,0,0,0,0,3000,0,0,0,3000,0,3000,3000
05342P,臺股指兆豐95售03,0,0,0,0,0,0,0,0,0,3000,0,0,0,3000,0,3000,3000
054390,智邦元富96購03  ,0,0,0,0,0,0,0,0,0,3000,0,0,0,3000,0,3000,3000
053336,元油反國票9B購02,0,0,0,0,0,0,0,0,0,3000,0,0,0,3000,0,3000,3000
05240P,玉晶光永豐96售01,0,0,0,0,0,0,0,0,0,3000,0,0,0,3000,0,3000,3000
056162,祥碩凱基97購03  ,0,0,0,0,0,0,0,0,0,3000,0,0,0,6000,3000,3000,3000
05468P,鴻海元大96售14  ,0,0,0,0,0,0,0,0,0,3000,0,0,0,172000,169000,3000,3000
056892,旺宏元大9A購02  ,0,0,0,0,0,0,0,0,0,3000,0,0,0,20000,17000,3000,3000
05688P,臺股指元大96售13,0,0,0,0,0,0,0,0,0,3000,0,0,0,3000,0,3000,3000
055026,健和興國泰98購01,0,0,0,0,0,0,0,0,0,3000,0,0,0,3000,0,3000,3000
05500P,臺股指中信96售04,0,0,0,0,0,0,0,0,0,3000,0,0,0,3000,0,3000,3000
055099,可成日盛97購01  ,0,0,0,0,0,0,0,0,0,3000,0,0,0,3000,0,3000,3000
057293,力成國泰99購01  ,0,0,0,0,0,0,0,0,0,3000,0,0,0,3000,0,3000,3000
05726P,易華電永豐96售02,0,0,0,0,0,0,0,0,0,3000,0,0,0,3000,0,3000,3000
911868,同方友友-DR     ,3000,0,3000,0,0,0,0,0,0,0,0,0,0,0,0,0,3000
9912,偉聯            ,2000,1000,1000,0,0,0,0,0,0,2000,2000,0,2000,0,0,0,3000
8466,美吉吉-KY       ,6000,3000,3000,0,0,0,0,0,0,0,0,0,0,0,0,0,3000
3164,景岳            ,12000,10000,2000,0,0,0,0,0,0,1000,1000,0,1000,0,0,0,3000
3038,全台            ,321000,323000,-2000,0,0,0,0,0,0,5000,5000,0,5000,0,0,0,3000
058588,致茂中信9B購01  ,0,0,0,0,0,0,0,0,0,2000,0,0,0,32000,30000,2000,2000
058428,大立光元富99購02,0,0,0,0,0,0,0,0,0,2000,0,0,0,22000,20000,2000,2000
058360,台光電凱基9A購02,0,0,0,0,0,0,0,0,0,2000,0,0,0,2000,0,2000,2000
05875P,旺宏群益98售01  ,0,0,0,0,0,0,0,0,0,2000,0,0,0,2000,0,2000,2000
058127,FBVIX元大9C購01 ,0,0,0,0,0,0,0,0,0,2000,0,0,0,2000,0,2000,2000
057574,中磊永豐98購01  ,0,0,0,0,0,0,0,0,0,2000,0,0,0,2000,0,2000,2000
057730,聯鈞國泰9A購01  ,0,0,0,0,0,0,0,0,0,2000,0,0,0,2000,0,2000,2000
06200P,聯發科元大97售18,0,0,0,0,0,0,0,0,0,2000,0,0,0,22000,20000,2000,2000
06120P,大立光凱基98售05,0,0,0,0,0,0,0,0,0,2000,0,0,0,22000,20000,2000,2000
06068P,玉晶光康和97售01,0,0,0,0,0,0,0,0,0,2000,0,0,0,14000,12000,2000,2000
05930P,景碩康和96售01  ,0,0,0,0,0,0,0,0,0,2000,0,0,0,2000,0,2000,2000
05990P,台積電群益96售13,0,0,0,0,0,0,0,0,0,2000,0,0,0,2000,0,2000,2000
05992P,華通元大96售05  ,0,0,0,0,0,0,0,0,0,2000,0,0,0,10000,8000,2000,2000
06364P,鴻海凱基97售08  ,0,0,0,0,0,0,0,0,0,2000,0,0,0,2000,0,2000,2000
06257P,臺股指群益97售10,0,0,0,0,0,0,0,0,0,2000,0,0,0,2000,0,2000,2000
06416P,大立光群益97售06,0,0,0,0,0,0,0,0,0,2000,0,0,0,27000,25000,2000,2000
06401P,鴻海元富97售13  ,0,0,0,0,0,0,0,0,0,2000,0,0,0,2000,0,2000,2000
06376P,上銀統一99售01  ,0,0,0,0,0,0,0,0,0,2000,0,0,0,2000,0,2000,2000
06451P,聯發科元大98售04,0,0,0,0,0,0,0,0,0,2000,0,0,0,40000,38000,2000,2000
06707P,臺股指台新99售04,0,0,0,0,0,0,0,0,0,2000,0,0,0,2000,0,2000,2000
06630P,國巨群益98售08  ,0,0,0,0,0,0,0,0,0,2000,0,0,0,2000,0,2000,2000
06645P,上銀元大98售05  ,0,0,0,0,0,0,0,0,0,2000,0,0,0,7000,5000,2000,2000
06654P,欣興元大98售08  ,0,0,0,0,0,0,0,0,0,2000,0,0,0,2000,0,2000,2000
06976P,臺股指元大9A售14,0,0,0,0,0,0,0,0,0,2000,0,0,0,2000,0,2000,2000
07102P,南電元大99售03  ,0,0,0,0,0,0,0,0,0,2000,0,0,0,2000,0,2000,2000
06842P,臺股指統一9A售03,0,0,0,0,0,0,0,0,0,2000,0,0,0,2000,0,2000,2000
06835P,台灣50國票9A售01,0,0,0,0,0,0,0,0,0,2000,0,0,0,2000,0,2000,2000
06737P,台郡凱基98售07  ,0,0,0,0,0,0,0,0,0,2000,0,0,0,5000,3000,2000,2000
06893P,致新元富98售02  ,0,0,0,0,0,0,0,0,0,2000,0,0,0,2000,0,2000,2000
1101B,台泥乙特        ,0,0,0,0,0,0,0,0,0,2000,2000,0,2000,0,0,0,2000
1233,天仁            ,8000,7000,1000,0,0,0,0,0,0,1000,1000,0,1000,0,0,0,2000
08163P,T50正2中信95售01,0,0,0,0,0,0,0,0,0,2000,0,0,0,2000,0,2000,2000
07135P,臺股指元大9A售29,0,0,0,0,0,0,0,0,0,2000,0,0,0,2000,0,2000,2000
1730,花仙子          ,114000,112000,2000,0,0,0,0,0,0,0,0,0,0,0,0,0,2000
1726,永記            ,14000,12000,2000,0,0,0,0,0,0,0,0,0,0,0,0,0,2000
052312,美律富邦96購02  ,0,0,0,0,0,0,0,0,0,2000,0,0,0,2000,0,2000,2000
05109P,臺股指麥證95售01,0,0,0,2000,0,2000,0,0,0,2000,0,0,0,2000,0,2000,2000
048871,晶豪科國票94購01,0,0,0,0,0,0,0,0,0,2000,0,0,0,2000,0,2000,2000
048899,茂林國泰95購01  ,0,0,0,0,0,0,0,0,0,2000,0,0,0,2000,0,2000,2000
051703,台積電群益95購04,0,0,0,0,0,0,0,0,0,2000,0,0,0,2000,0,2000,2000
049505,臺股指元大94購16,0,0,0,0,0,0,0,0,0,2000,0,0,0,2000,0,2000,2000
04987P,昇陽半永豐94售04,0,0,0,0,0,0,0,0,0,2000,0,0,0,2000,0,2000,2000
047783,聯茂國泰94購02  ,0,0,0,0,0,0,0,0,0,2000,0,0,0,2000,0,2000,2000
04593P,台積電元大94售11,0,0,0,0,0,0,0,0,0,2000,0,0,0,2000,0,2000,2000
04504P,台積電元富94售04,0,0,0,0,0,0,0,0,0,2000,0,0,0,2000,0,2000,2000
05036P,義隆元大95售03  ,0,0,0,0,0,0,0,0,0,2000,0,0,0,2000,0,2000,2000
05179P,大立光凱基96售06,0,0,0,0,0,0,0,0,0,2000,0,0,0,122000,120000,2000,2000
03039X,元展36          ,0,0,0,0,0,0,0,0,0,2000,0,0,0,3000,1000,2000,2000
04370P,聯茂凱基94售05  ,0,0,0,0,0,0,0,0,0,2000,0,0,0,2000,0,2000,2000
020004,兆豐電菁英30N   ,0,0,0,0,0,0,0,0,0,2000,0,0,0,3000,1000,2000,2000
00681R,元大美債20反1   ,0,0,0,0,0,0,0,0,0,2000,0,0,0,73000,71000,2000,2000
03935P,可成富邦95售01  ,0,0,0,0,0,0,0,0,0,2000,0,0,0,10000,8000,2000,2000
04053P,聯茂國泰94售01  ,0,0,0,0,0,0,0,0,0,2000,0,0,0,2000,0,2000,2000
048589,國巨兆豐96購01  ,0,0,0,0,0,0,0,0,0,2000,0,0,0,12000,10000,2000,2000
048412,台勝科亞東93購01,0,0,0,0,0,0,0,0,0,2000,0,0,0,2000,0,2000,2000
056976,喬山群益98購01  ,0,0,0,0,0,0,0,0,0,2000,0,0,0,2000,0,2000,2000
057222,鴻海國票99購04  ,0,0,0,0,0,0,0,0,0,2000,0,0,0,2000,0,2000,2000
057000,亞德客國票99購01,0,0,0,0,0,0,0,0,0,2000,0,0,0,7000,5000,2000,2000
053523,T50反1中信9A購01,0,0,0,0,0,0,0,0,0,2000,0,0,0,2000,0,2000,2000
054871,明泰群益98購01  ,0,0,0,0,0,0,0,0,0,2000,0,0,0,2000,0,2000,2000
05487P,台表科凱基95售02,0,0,0,0,0,0,0,0,0,2000,0,0,0,2000,0,2000,2000
053655,全新凱基98購02  ,0,0,0,0,0,0,0,0,0,2000,0,0,0,3000,1000,2000,2000
054037,T50反1元大96購09,0,0,0,0,0,0,0,0,0,2000,0,0,0,2000,0,2000,2000
053939,台表科元富96購03,0,0,0,0,0,0,0,0,0,2000,0,0,0,2000,0,2000,2000
056395,玉晶光永豐9B購01,0,0,0,0,0,0,0,0,0,2000,0,0,0,2000,0,2000,2000
056279,新日興富邦99購01,0,0,0,0,0,0,0,0,0,2000,0,0,0,2000,0,2000,2000
056331,聯鈞國票99購01  ,0,0,0,0,0,0,0,0,0,2000,0,0,0,2000,0,2000,2000
05416P,喬山永豐95售04  ,0,0,0,0,0,0,0,0,0,2000,0,0,0,2000,0,2000,2000
055392,凱美統一97購03  ,0,0,0,0,0,0,0,0,0,2000,0,0,0,2000,0,2000,2000
056075,瀚宇博元大97購03,0,0,0,0,0,0,0,0,0,2000,0,0,0,2000,0,2000,2000
05315P,鴻海永昌96售08  ,0,0,0,0,0,0,0,0,0,2000,0,0,0,2000,0,2000,2000
05307P,光寶科中信95售01,0,0,0,0,0,0,0,0,0,2000,0,0,0,15000,13000,2000,2000
2891C,中信金丙特      ,0,0,0,0,0,0,0,0,0,2000,2000,0,2000,0,0,0,2000
3011,今皓            ,4000,2000,2000,0,0,0,0,0,0,0,0,0,0,0,0,0,2000
4438,廣越            ,80000,78000,2000,0,0,0,0,0,0,0,0,0,0,0,0,0,2000
2881B,富邦金乙特      ,0,0,0,0,0,0,0,0,0,2000,2000,0,2000,0,0,0,2000
2460,建通            ,2000,4000,-2000,0,0,0,0,0,0,4000,4000,0,4000,0,0,0,2000
910322,康師傅-DR       ,2000,0,2000,0,0,0,0,0,0,0,0,0,0,0,0,0,2000
6205,詮欣            ,7000,6000,1000,0,0,0,0,0,0,1000,1000,0,1000,0,0,0,2000
9930,中聯資源        ,42000,41000,1000,0,0,0,0,0,0,1000,1000,0,1000,0,0,0,2000
1507,永大            ,121000,120000,1000,0,0,0,0,0,0,0,0,0,0,0,0,0,1000
1419,新紡            ,9000,8000,1000,0,0,0,0,0,0,0,0,0,0,0,0,0,1000
06919P,臺股指日盛98售02,0,0,0,0,0,0,0,0,0,1000,0,0,0,1000,0,1000,1000
06883P,聯茂群益98售03  ,0,0,0,0,0,0,0,0,0,1000,0,0,0,1000,0,1000,1000
06886P,旺宏元大99售07  ,0,0,0,0,0,0,0,0,0,1000,0,0,0,11000,10000,1000,1000
06840P,臺股指統一98售04,0,0,0,0,0,0,0,0,0,1000,0,0,0,1000,0,1000,1000
07091P,SGBR2X凱基9A售02,0,0,0,0,0,0,0,0,0,1000,0,0,0,1000,0,1000,1000
07037P,台積電台新99售03,0,0,0,0,0,0,0,0,0,1000,0,0,0,1000,0,1000,1000
06945P,國巨群益99售04  ,0,0,0,0,0,0,0,0,0,1000,0,0,0,1000,0,1000,1000
06633P,國巨國票99售01  ,0,0,0,0,0,0,0,0,0,1000,0,0,0,1000,0,1000,1000
06705P,臻鼎元富98售03  ,0,0,0,0,0,0,0,0,0,1000,0,0,0,51000,50000,1000,1000
06703P,新日興元富98售02,0,0,0,0,0,0,0,0,0,1000,0,0,0,1000,0,1000,1000
06559P,玉晶光元富98售02,0,0,0,0,0,0,0,0,0,1000,0,0,0,1000,0,1000,1000
06499P,臺股指元大9A售04,0,0,0,0,0,0,0,0,0,1000,0,0,0,1000,0,1000,1000
06500P,臺股指元大9A售05,0,0,0,0,0,0,0,0,0,1000,0,0,0,1000,0,1000,1000
06379P,群創統一97售05  ,0,0,0,0,0,0,0,0,0,1000,0,0,0,1000,0,1000,1000
06387P,緯穎永豐97售02  ,0,0,0,0,0,0,0,0,0,1000,0,0,0,20000,19000,1000,1000
06405P,億光元富97售02  ,0,0,0,0,0,0,0,0,0,1000,0,0,0,1000,0,1000,1000
06230P,亞德客永豐97售03,0,0,0,0,0,0,0,0,0,1000,0,0,0,1000,0,1000,1000
06255P,臺股指群益97售08,0,0,0,0,0,0,0,0,0,1000,0,0,0,1000,0,1000,1000
06335P,台積電麥證97售02,0,0,0,1000,0,1000,0,0,0,1000,0,0,0,1000,0,1000,1000
06330P,南亞科群益97售03,0,0,0,0,0,0,0,0,0,1000,0,0,0,1000,0,1000,1000
06320P,上銀統一97售04  ,0,0,0,0,0,0,0,0,0,1000,0,0,0,1000,0,1000,1000
05993P,國巨元大96售13  ,0,0,0,0,0,0,0,0,0,1000,0,0,0,9000,8000,1000,1000
06005P,晶豪科永豐96售04,0,0,0,0,0,0,0,0,0,1000,0,0,0,4000,3000,1000,1000
05998P,台積電元大97售12,0,0,0,0,0,0,0,0,0,1000,0,0,0,1000,0,1000,1000
05918P,大立光元大96售11,0,0,0,0,0,0,0,0,0,1000,0,0,0,1000,0,1000,1000
06122P,亞光元大98售01  ,0,0,0,0,0,0,0,0,0,1000,0,0,0,1000,0,1000,1000
06101P,聯發科日盛97售03,0,0,0,0,0,0,0,0,0,1000,0,0,0,1000,0,1000,1000
06048P,大立光富邦96售05,0,0,0,0,0,0,0,0,0,1000,0,0,0,1000,0,1000,1000
06011P,貿聯元富96售04  ,0,0,0,0,0,0,0,0,0,1000,0,0,0,1000,0,1000,1000
06024P,台郡國票97售05  ,0,0,0,0,0,0,0,0,0,1000,0,0,0,1000,0,1000,1000
06195P,台積電元富97售06,0,0,0,0,0,0,0,0,0,1000,0,0,0,6000,5000,1000,1000
05769P,台積電凱基96售16,0,0,0,0,0,0,0,0,0,1000,0,0,0,33000,32000,1000,1000
05756P,臺股指中信99售05,0,0,0,0,0,0,0,0,0,1000,0,0,0,1000,0,1000,1000
057604,鴻海統一9C購01  ,0,0,0,0,0,0,0,0,0,1000,0,0,0,1000,0,1000,1000
05787P,臺股指永昌96售04,0,0,0,0,0,0,0,0,0,1000,0,0,0,11000,10000,1000,1000
058075,貿聯凱基99購02  ,0,0,0,0,0,0,0,0,0,1000,0,0,0,41000,40000,1000,1000
05877P,大立光群益96售06,0,0,0,0,0,0,0,0,0,1000,0,0,0,1000,0,1000,1000
05846P,大立光元大96售07,0,0,0,0,0,0,0,0,0,1000,0,0,0,14000,13000,1000,1000
058473,上銀凱基9A購03  ,0,0,0,0,0,0,0,0,0,1000,0,0,0,1000,0,1000,1000
05848P,臺股指元大96售24,0,0,0,0,0,0,0,0,0,1000,0,0,0,1000,0,1000,1000
05849P,臺股指元大96售25,0,0,0,0,0,0,0,0,0,1000,0,0,0,1000,0,1000,1000
058693,旭富國票9A購01  ,0,0,0,0,0,0,0,0,0,1000,0,0,0,10000,9000,1000,1000
058619,台灣50國票99購04,0,0,0,0,0,0,0,0,0,1000,0,0,0,11000,10000,1000,1000
04828P,聯發科凱基94售15,0,0,0,0,0,0,0,0,0,1000,0,0,0,1000,0,1000,1000
04858P,健策元富94售01  ,0,0,0,0,0,0,0,0,0,1000,0,0,0,41000,40000,1000,1000
04862P,台積電元大94售26,0,0,0,0,0,0,0,0,0,1000,0,0,0,61000,60000,1000,1000
04052P,上銀國泰94售01  ,0,0,0,0,0,0,0,0,0,1000,0,0,0,1000,0,1000,1000
04151P,日電貿康和93售01,0,0,0,0,0,0,0,0,0,1000,0,0,0,1000,0,1000,1000
03969P,華新科國票94售01,0,0,0,0,0,0,0,0,0,1000,0,0,0,1000,0,1000,1000
03566P,臺股指日盛03售01,0,0,0,0,0,0,0,0,0,1000,0,0,0,1000,0,1000,1000
020011,統一微波高息20N ,0,0,0,0,0,0,0,0,0,1000,0,8000,-8000,14000,5000,9000,1000
03006X,元展06          ,0,0,0,0,0,0,0,0,0,1000,0,0,0,2000,1000,1000,1000
04388P,滬深2X凱基95售05,0,0,0,0,0,0,0,0,0,1000,0,0,0,1000,0,1000,1000
043961,道瓊反國泰94購01,0,0,0,0,0,0,0,0,0,1000,0,0,0,1000,0,1000,1000
04416P,牧德元富94售06  ,0,0,0,0,0,0,0,0,0,1000,0,0,0,1000,0,1000,1000
03583P,微星元大02售03  ,0,0,0,0,0,0,0,0,0,1000,0,0,0,1000,0,1000,1000
050283,T50反1凱基9A購01,0,0,0,0,0,0,0,0,0,1000,0,0,0,1000,0,1000,1000
051823,矽力元富95購02  ,0,0,0,0,0,0,0,0,0,1000,0,0,0,1000,0,1000,1000
051831,緯穎元大96購04  ,0,0,0,0,0,0,0,0,0,1000,0,0,0,1000,0,1000,1000
05048P,同欣電永豐95售01,0,0,0,0,0,0,0,0,0,1000,0,0,0,1000,0,1000,1000
04638P,臺股指群益94售13,0,0,0,0,0,0,0,0,0,1000,0,0,0,1000,0,1000,1000
04629P,康控元大94售05  ,0,0,0,0,0,0,0,0,0,1000,0,0,0,1000,0,1000,1000
046600,鴻海群益94購01  ,0,0,0,0,0,0,0,0,0,1000,0,0,0,1000,0,1000,1000
04670P,臺股指國票94售09,0,0,0,0,0,0,0,0,0,1000,0,0,0,1000,0,1000,1000
05021P,瑞昱凱基95售01  ,0,0,0,0,0,0,0,0,0,1000,0,0,0,23000,22000,1000,1000
04748P,臺股指元大94售23,0,0,0,0,0,0,0,0,0,1000,0,0,0,1000,0,1000,1000
04516P,台積電群益94售07,0,0,0,0,0,0,0,0,0,1000,0,0,0,1000,0,1000,1000
04482P,臺股指日盛94售01,0,0,0,0,0,0,0,0,0,1000,0,0,0,1000,0,1000,1000
04473P,國巨元大94售03  ,0,0,0,0,0,0,0,0,0,1000,0,0,0,1000,0,1000,1000
047096,元油反國泰96購01,0,0,0,0,0,0,0,0,0,1000,0,0,0,1000,0,1000,1000
04718P,亞德客凱基94售03,0,0,0,0,0,0,0,0,0,1000,0,0,0,1000,0,1000,1000
04622P,臺股指統一94售01,0,0,0,0,0,0,0,0,0,1000,0,0,0,1000,0,1000,1000
048175,矽力國泰95購01  ,0,0,0,0,0,0,0,0,0,1000,0,0,0,1000,0,1000,1000
049811,聯鈞元大94購01  ,0,0,0,0,0,0,0,0,0,1000,0,0,0,1000,0,1000,1000
049872,聯發科台新94購03,0,0,0,0,0,0,0,0,0,1000,0,0,0,31000,30000,1000,1000
049716,台積電凱基94購24,0,0,0,0,0,0,0,0,0,1000,0,0,0,1000,0,1000,1000
050005,京鼎永豐94購01  ,0,0,0,0,0,0,0,0,0,1000,0,0,0,1000,0,1000,1000
04995P,台達電凱基96售03,0,0,0,0,0,0,0,0,0,1000,0,0,0,19000,18000,1000,1000
05008P,大立光元富95售05,0,0,0,0,0,0,0,0,0,1000,0,0,0,1000,0,1000,1000
049431,光罩國票96購01  ,0,0,0,0,0,0,0,0,0,1000,0,0,0,1000,0,1000,1000
04926P,聯發科凱基95售03,0,0,0,0,0,0,0,0,0,1000,0,0,0,51000,50000,1000,1000
04934P,鴻海中信94售05  ,0,0,0,0,0,0,0,0,0,1000,0,0,0,1000,0,1000,1000
049610,奇力新兆豐95購01,0,0,0,0,0,0,0,0,0,1000,0,0,0,25000,24000,1000,1000
050617,神基元大94購01  ,0,0,0,0,0,0,0,0,0,1000,0,0,0,1000,0,1000,1000
05073P,臺股指中信95售09,0,0,0,0,0,0,0,0,0,1000,0,0,0,1000,0,1000,1000
050669,嘉晶永豐96購01  ,0,0,0,0,0,0,0,0,0,1000,0,0,0,1000,0,1000,1000
049588,聯發科元大94購06,0,0,0,0,0,0,0,0,0,1000,0,0,0,1000,0,1000,1000
050778,瑞儀元大96購01  ,0,0,0,0,0,0,0,0,0,1000,0,0,0,1000,0,1000,1000
05173P,臺股指元大95售17,0,0,0,0,0,0,0,0,0,1000,0,0,0,1000,0,1000,1000
05096P,台積電日盛95售01,0,0,0,0,0,0,0,0,0,1000,0,0,0,20000,19000,1000,1000
05599P,欣興台新96售01  ,0,0,0,0,0,0,0,0,0,1000,0,0,0,1000,0,1000,1000
055862,矽力元大97購04  ,0,0,0,0,0,0,0,0,0,1000,0,0,0,1000,0,1000,1000
05164P,南亞科元富95售04,0,0,0,0,0,0,0,0,0,1000,0,0,0,11000,10000,1000,1000
05606P,TPK國票97售02   ,0,0,0,0,0,0,0,0,0,1000,0,0,0,1000,0,1000,1000
056407,嘉晶國票99購01  ,0,0,0,0,0,0,0,0,0,1000,0,0,0,1000,0,1000,1000
056556,南電凱基98購01  ,0,0,0,0,0,0,0,0,0,1000,0,0,0,5000,4000,1000,1000
05252P,華通凱基95售01  ,0,0,0,0,0,0,0,0,0,1000,0,0,0,1000,0,1000,1000
052895,台積電群益96購04,0,0,0,0,0,0,0,0,0,1000,0,0,0,3000,2000,1000,1000
05298P,上銀元大95售03  ,0,0,0,0,0,0,0,0,0,1000,0,0,0,1000,0,1000,1000
052977,奇力新麥證97購01,0,0,0,1000,0,1000,0,0,0,1000,0,0,0,1000,0,1000,1000
054290,奇力新元大96購05,0,0,0,0,0,0,0,0,0,1000,0,0,0,1000,0,1000,1000
052671,祥碩群益96購01  ,0,0,0,0,0,0,0,0,0,1000,0,0,0,1000,0,1000,1000
053788,泰鼎元大97購01  ,0,0,0,0,0,0,0,0,0,1000,0,0,0,1000,0,1000,1000
053808,大成鋼群益97購01,0,0,0,0,0,0,0,0,0,1000,0,0,0,1000,0,1000,1000
053852,南亞科國泰98購01,0,0,0,0,0,0,0,0,0,1000,0,0,0,1000,0,1000,1000
054466,欣興凱基97購03  ,0,0,0,0,0,0,0,0,0,1000,0,0,0,1000,0,1000,1000
054064,台郡國票97購04  ,0,0,0,0,0,0,0,0,0,1000,0,0,0,1000,0,1000,1000
053671,可成統一96購03  ,0,0,0,0,0,0,0,0,0,1000,0,0,0,1000,0,1000,1000
05365P,臺股指富邦95售05,0,0,0,0,0,0,0,0,0,1000,0,0,0,1000,0,1000,1000
054891,聯鈞統一99購02  ,0,0,0,0,0,0,0,0,0,1000,0,0,0,1000,0,1000,1000
054687,建準永豐97購02  ,0,0,0,0,0,0,0,0,0,1000,0,0,0,1000,0,1000,1000
05614P,臺股指康和96售03,0,0,0,0,0,0,0,0,0,1000,0,0,0,1000,0,1000,1000
05454P,奇鋐群益95售04  ,0,0,0,0,0,0,0,0,0,1000,0,0,0,2000,1000,1000,1000
05345P,臺股指統一95售05,0,0,0,0,0,0,0,0,0,1000,0,0,0,1000,0,1000,1000
054801,康友群益97購02  ,0,0,0,0,0,0,0,0,0,1000,0,0,0,1000,0,1000,1000
05706P,TPK永豐96售02   ,0,0,0,0,0,0,0,0,0,1000,0,0,0,1000,0,1000,1000
05515P,台積電群益96售03,0,0,0,0,0,0,0,0,0,1000,0,0,0,1000,0,1000,1000
057214,瑞昱群益98購01  ,0,0,0,0,0,0,0,0,0,1000,0,0,0,1000,0,1000,1000
057390,台表科永豐98購01,0,0,0,0,0,0,0,0,0,1000,0,0,0,1000,0,1000,1000
057376,新日興元大98購04,0,0,0,0,0,0,0,0,0,1000,0,0,0,20000,19000,1000,1000
8480,泰昇-KY         ,20000,19000,1000,0,0,0,0,0,0,0,0,0,0,0,0,0,1000
8940,新天地          ,0,0,0,0,0,0,0,0,0,1000,1000,0,1000,0,0,0,1000
910861,神州-DR         ,1000,0,1000,0,0,0,0,0,0,0,0,0,0,0,0,0,1000
8443,阿瘦            ,2000,2000,0,0,0,0,0,0,0,1000,2000,1000,1000,0,0,0,1000
2032,新鋼            ,13000,12000,1000,0,0,0,0,0,0,0,0,0,0,0,0,0,1000
2033,佳大            ,13000,12000,1000,0,0,0,0,0,0,0,0,0,0,0,0,0,1000
2114,鑫永銓          ,7000,6000,1000,0,0,0,0,0,0,0,0,0,0,0,0,0,1000
4439,冠星-KY         ,1000,0,1000,0,0,0,0,0,0,0,0,0,0,0,0,0,1000
3305,昇貿            ,15000,17000,-2000,0,0,0,0,0,0,3000,3000,0,3000,0,0,0,1000
008201,BP上證50        ,0,0,0,0,0,0,0,0,0,100,0,0,0,100,0,100,100
058608,華新科元大99購13,0,0,0,0,0,0,0,0,0,0,0,0,0,120000,120000,0,0
058699,楠梓電元大99購02,0,0,0,0,0,0,0,0,0,0,0,0,0,10000,10000,0,0
058612,健策元大99購02  ,0,0,0,0,0,0,0,0,0,0,0,0,0,20000,20000,0,0
058613,茂林元大99購03  ,0,0,0,0,0,0,0,0,0,0,0,0,0,10000,10000,0,0
058474,鴻海凱基9A購06  ,0,0,0,0,0,0,0,0,0,0,0,0,0,16000,16000,0,0
058378,南電凱基99購01  ,0,0,0,0,0,0,0,0,0,0,0,0,0,4000,4000,0,0
058404,貿聯元大99購02  ,0,0,0,0,0,0,0,0,0,0,0,0,0,10000,10000,0,0
05879P,台積電台新96售03,0,0,0,0,0,0,0,0,0,0,0,0,0,50000,50000,0,0
058752,鈺齊凱基9A購01  ,0,0,0,0,0,0,0,0,0,0,0,0,0,50000,50000,0,0
058725,美律富邦9A購01  ,0,0,0,0,0,0,0,0,0,0,0,0,0,1000,1000,0,0
058873,美律國票9A購02  ,0,0,0,0,0,0,0,0,0,0,0,0,0,2000,2000,0,0
059061,晶技凱基9A購01  ,0,0,0,0,0,0,0,0,0,0,0,0,0,100000,100000,0,0
059092,聯陽元大99購01  ,0,0,0,0,0,0,0,0,0,0,0,0,0,40000,40000,0,0
058093,神達元大9A購01  ,0,0,0,0,0,0,0,0,0,0,0,0,0,10000,10000,0,0
058067,台積電第一9C購01,0,0,0,0,0,0,0,0,0,0,0,0,0,156000,156000,0,0
057873,義隆元大98購03  ,0,0,0,0,0,0,0,0,0,0,0,0,0,10000,10000,0,0
05789P,臺股指永昌96售06,0,0,0,0,0,0,0,0,0,0,0,0,0,10000,10000,0,0
057928,鈺齊凱基98購02  ,0,0,0,0,0,0,0,0,0,0,0,0,0,100000,100000,0,0
057959,欣興元大98購14  ,0,0,0,0,0,0,0,0,0,0,0,0,0,10000,10000,0,0
058129,國巨元大99購10  ,0,0,0,0,0,0,0,0,0,0,0,0,0,10000,10000,0,0
058144,聯茂元大99購02  ,0,0,0,0,0,0,0,0,0,0,0,0,0,50000,50000,0,0
058157,華通台新99購01  ,0,0,0,0,0,0,0,0,0,0,0,0,0,620000,620000,0,0
058148,百和元大99購01  ,0,0,0,0,0,0,0,0,0,0,0,0,0,10000,10000,0,0
05816P,台積電凱基97售07,0,0,0,0,0,0,0,0,0,0,0,0,0,64000,64000,0,0
058194,勤誠永豐99購01  ,0,0,0,0,0,0,0,0,0,0,0,0,0,27000,27000,0,0
058313,台積電富邦9B購04,0,0,0,0,0,0,0,0,0,0,0,0,0,10000,10000,0,0
058284,滬深反群益01購01,0,0,0,0,0,0,0,0,0,0,0,0,0,20000,20000,0,0
05761P,嘉澤永豐96售01  ,0,0,0,0,0,0,0,0,0,0,0,0,0,20000,20000,0,0
057584,國巨亞東99購01  ,0,0,0,0,0,0,0,0,0,0,0,0,0,200000,200000,0,0
05758P,光罩永豐96售02  ,0,0,0,0,0,0,0,0,0,0,0,0,0,1000,1000,0,0
057527,億光元大98購01  ,0,0,0,0,0,0,0,0,0,0,0,0,0,10000,10000,0,0
057532,智原元大98購03  ,0,0,0,0,0,0,0,0,0,0,0,0,0,90000,90000,0,0
057670,欣興元大99購02  ,0,0,0,0,0,0,0,0,0,0,0,0,0,10000,10000,0,0
05776P,鴻海統一98售02  ,0,0,0,0,0,0,0,0,0,0,0,0,0,12000,12000,0,0
057809,英業達元大98購01,0,0,0,0,0,0,0,0,0,0,0,0,0,10000,10000,0,0
05786P,臺股指永昌96售03,0,0,0,0,0,0,0,0,0,0,0,0,0,10000,10000,0,0
06180P,禾伸堂群益97售01,0,0,0,0,0,0,0,0,0,0,0,0,0,40000,40000,0,0
06178P,大立光第一99售01,0,0,0,0,0,0,0,0,0,0,0,0,0,3000,3000,0,0
06027P,鴻海台新96售04  ,0,0,0,0,0,0,0,0,0,0,0,0,0,660000,660000,0,0
059164,旺宏凱基99購06  ,0,0,0,0,0,0,0,0,0,0,0,0,0,6000,6000,0,0
05911P,南亞科永豐96售03,0,0,0,0,0,0,0,0,0,0,0,0,0,10000,10000,0,0
05932P,鴻海凱基96售16  ,0,0,0,0,0,0,0,0,0,0,0,0,0,10000,10000,0,0
059221,聯發科元大99購21,0,0,0,0,0,0,0,0,0,0,0,0,0,107000,107000,0,0
06339P,上銀統一97售06  ,0,0,0,0,0,0,0,0,0,0,0,0,0,10000,10000,0,0
06361P,聯發科群益97售06,0,0,0,0,0,0,0,0,0,0,0,0,0,930000,930000,0,0
06385P,聯發科永豐97售02,0,0,0,0,0,0,0,0,0,0,0,0,0,20000,20000,0,0
06443P,台積電凱基99售01,0,0,0,0,0,0,0,0,0,0,0,0,0,212000,212000,0,0
06481P,台積電凱基98售12,0,0,0,0,0,0,0,0,0,0,0,0,0,9000,9000,0,0
06562P,台積電國泰99售02,0,0,0,0,0,0,0,0,0,0,0,0,0,134000,134000,0,0
06692P,瑞昱凱基98售03  ,0,0,0,0,0,0,0,0,0,0,0,0,0,20000,20000,0,0
07016P,聯發科元大99售10,0,0,0,0,0,0,0,0,0,0,0,0,0,20000,20000,0,0
07050P,宏達電中信9B售01,0,0,0,0,0,0,0,0,0,0,0,0,0,10000,10000,0,0
06778P,台積電元大99售06,0,0,0,0,0,0,0,0,0,0,0,0,0,248000,248000,0,0
06744P,嘉聯益永豐98售03,0,0,0,0,0,0,0,0,0,0,0,0,0,10000,10000,0,0
06882P,聯發科群益98售07,0,0,0,0,0,0,0,0,0,0,0,0,0,10000,10000,0,0
06876P,台灣50兆豐9B售01,0,0,0,0,0,0,0,0,0,0,0,1000,-1000,1000,0,1000,0
06866P,聯發科元大98售13,0,0,0,0,0,0,0,0,0,0,0,0,0,30000,30000,0,0
06918P,嘉聯益亞東99售01,0,0,0,0,0,0,0,0,0,0,0,0,0,49000,49000,0,0
06929P,鴻海元大99售11  ,0,0,0,0,0,0,0,0,0,0,0,0,0,90000,90000,0,0
06908P,健策國泰99售02  ,0,0,0,0,0,0,0,0,0,0,0,0,0,112000,112000,0,0
06911P,鴻海元大99售09  ,0,0,0,0,0,0,0,0,0,0,0,0,0,90000,90000,0,0
07193P,聯發科元大99售24,0,0,0,0,0,0,0,0,0,0,0,0,0,20000,20000,0,0
1603,華電            ,16000,16000,0,0,0,0,0,0,0,0,0,0,0,0,0,0,0
1713,國化            ,8000,8000,0,0,0,0,0,0,0,0,0,0,0,0,0,0,0
00774B,新光中國政金綠債,0,0,0,0,0,0,0,0,0,0,0,0,0,2000,2000,0,0
00775B,新光投等債15+   ,0,0,0,0,0,0,0,0,0,0,0,0,0,2000,2000,0,0
00776,新光ICE美國權值 ,0,0,0,0,0,0,0,0,0,0,0,0,0,2000,2000,0,0
00732,國泰RMB短期報酬 ,0,0,0,0,0,0,0,0,0,0,0,0,0,100000,100000,0,0
00668K,國泰美國道瓊+U  ,0,0,0,0,0,0,0,0,0,0,0,0,0,100,100,0,0
00657K,國泰日經225+U   ,0,0,0,0,0,0,0,0,0,0,0,0,0,100,100,0,0
0053,元大電子        ,0,0,0,0,0,0,0,0,0,0,0,0,0,5000,5000,0,0
00625K,富邦上証+R      ,0,0,0,0,0,0,0,0,0,0,0,0,0,50000,50000,0,0
04337P,台積電元大93售25,0,0,0,0,0,0,0,0,0,0,0,0,0,201000,201000,0,0
04221P,大立光兆豐93售05,0,0,0,0,0,0,0,0,0,0,0,0,0,10000,10000,0,0
04823P,台積電元富94售09,0,0,0,0,0,0,0,0,0,0,0,0,0,10000,10000,0,0
048191,亞德客元大93購06,0,0,0,0,0,0,0,0,0,0,0,0,0,10000,10000,0,0
04818P,華新科永豐94售03,0,0,0,0,0,0,0,0,0,0,0,0,0,67000,67000,0,0
03415B,臺股指元大93熊49,0,0,0,0,0,0,0,0,0,0,0,0,0,12000,12000,0,0
03387P,台積電凱基03售11,0,0,0,0,0,0,0,0,0,0,0,0,0,621000,621000,0,0
04453P,聯發科富邦94售04,0,0,0,0,0,0,0,0,0,0,0,0,0,1000,1000,0,0
04459P,元油2X元富94售08,0,0,0,0,0,0,0,0,0,0,0,0,0,191000,191000,0,0
04467P,元油2X元大94售03,0,0,0,0,0,0,0,0,0,0,0,0,0,700000,700000,0,0
048329,台積電永昌93購07,0,0,0,0,0,0,0,0,0,0,0,0,0,10000,10000,0,0
04803P,台積電凱基94售30,0,0,0,0,0,0,0,0,0,0,0,0,0,50000,50000,0,0
046208,滬深2X元富95購03,0,0,0,0,0,0,0,0,0,0,0,0,0,20000,20000,0,0
047701,鴻海凱基94購12  ,0,0,0,0,0,0,0,0,0,0,0,0,0,4000,4000,0,0
047184,漢唐元大94購02  ,0,0,0,0,0,0,0,0,0,0,0,0,0,10000,10000,0,0
04555P,元油2X群益95售01,0,0,0,0,0,0,0,0,0,0,0,0,0,10000,10000,0,0
04515P,元油2X群益97售02,0,0,0,0,0,0,0,0,0,0,0,0,0,6000,6000,0,0
045468,健策元大94購01  ,0,0,0,0,0,0,0,0,0,0,0,0,0,10000,10000,0,0
04546P,台積電元大94售09,0,0,0,0,0,0,0,0,0,0,0,0,0,142000,142000,0,0
047556,群創凱基95購01  ,0,0,0,0,0,0,0,0,0,0,0,0,0,49000,49000,0,0
04757P,元油2X凱基94售04,0,0,0,0,0,0,0,0,0,0,0,0,0,340000,340000,0,0
046628,大立光統一98購01,0,0,0,0,0,0,0,0,0,0,0,0,0,4000,4000,0,0
046598,T50反1群益93購04,0,0,0,0,0,0,0,0,0,0,0,0,0,260000,260000,0,0
04681P,臺股指統一94售06,0,0,0,0,0,0,0,0,0,0,0,0,0,20000,20000,0,0
051875,聯發科兆豐95購04,0,0,0,0,0,0,0,0,0,0,0,0,0,30000,30000,0,0
050280,國巨日盛94購01  ,0,0,0,0,0,0,0,0,0,0,0,0,0,50000,50000,0,0
050380,台積電亞東94購02,0,0,0,0,0,0,0,0,0,0,0,0,0,50000,50000,0,0
05035P,聯發科元大95售06,0,0,0,0,0,0,0,0,0,0,0,0,0,5000,5000,0,0
054146,康友元大96購06  ,0,0,0,0,0,0,0,0,0,0,0,0,0,10000,10000,0,0
05162P,玉晶光國票96售03,0,0,0,0,0,0,0,0,0,0,0,0,0,140000,140000,0,0
051605,奇力新群益95購02,0,0,0,0,0,0,0,0,0,0,0,0,0,30000,30000,0,0
055874,中環元富9A購01  ,0,0,0,0,0,0,0,0,0,0,0,0,0,40000,40000,0,0
055830,上銀元大97購07  ,0,0,0,0,0,0,0,0,0,0,0,0,0,18000,18000,0,0
055653,聯詠元富01購02  ,0,0,0,0,0,0,0,0,0,0,0,0,0,10000,10000,0,0
055511,大立光兆豐97購02,0,0,0,0,0,0,0,0,0,0,0,0,0,1000,1000,0,0
055573,國巨統一97購06  ,0,0,0,0,0,0,0,0,0,0,0,0,0,20000,20000,0,0
051030,康友元富95購01  ,0,0,0,0,0,0,0,0,0,0,0,0,0,8000,8000,0,0
050886,台積電富邦95購04,0,0,0,0,0,0,0,0,0,0,0,0,0,10000,10000,0,0
050887,台積電富邦95購05,0,0,0,0,0,0,0,0,0,0,0,0,0,10000,10000,0,0
052321,華擎元大95購01  ,0,0,0,0,0,0,0,0,0,0,0,0,0,58000,58000,0,0
05228P,大立光元富95售09,0,0,0,0,0,0,0,0,0,0,0,0,0,81000,81000,0,0
048986,訊連元大94購01  ,0,0,0,0,0,0,0,0,0,0,0,0,0,10000,10000,0,0
052377,景碩元大96購02  ,0,0,0,0,0,0,0,0,0,0,0,0,0,10000,10000,0,0
051257,光寶科國泰96購01,0,0,0,0,0,0,0,0,0,0,0,0,0,100000,100000,0,0
051251,信邦元大95購01  ,0,0,0,0,0,0,0,0,0,0,0,0,0,30000,30000,0,0
051408,台積電國票95購03,0,0,0,0,0,0,0,0,0,0,0,0,0,12000,12000,0,0
051409,美律國票96購01  ,0,0,0,0,0,0,0,0,0,0,0,0,0,80000,80000,0,0
051489,世芯凱基95購01  ,0,0,0,0,0,0,0,0,0,0,0,0,0,6000,6000,0,0
051588,聯詠元大95購03  ,0,0,0,0,0,0,0,0,0,0,0,0,0,25000,25000,0,0
05158P,華通永豐95售01  ,0,0,0,0,0,0,0,0,0,0,0,0,0,10000,10000,0,0
051745,玉晶光國泰97購06,0,0,0,0,0,0,0,0,0,0,0,0,0,200000,200000,0,0
048909,聯詠富邦94購01  ,0,0,0,0,0,0,0,0,0,0,0,0,0,10000,10000,0,0
05219P,鴻海元大95售17  ,0,0,0,0,0,0,0,0,0,0,0,0,0,23000,23000,0,0
052076,可成元富98購01  ,0,0,0,0,0,0,0,0,0,0,0,0,0,10000,10000,0,0
050734,台積電台新94購02,0,0,0,0,0,0,0,0,0,0,0,0,0,100000,100000,0,0
049498,茂林元大95購01  ,0,0,0,0,0,0,0,0,0,0,0,0,0,10000,10000,0,0
050630,大立光亞東96購01,0,0,0,0,0,0,0,0,0,0,0,0,0,400000,400000,0,0
05191P,鴻海台新95售01  ,0,0,0,0,0,0,0,0,0,0,0,0,0,450000,450000,0,0
051988,台光電元大95購01,0,0,0,0,0,0,0,0,0,0,0,0,0,30000,30000,0,0
049599,樺漢元大95購01  ,0,0,0,0,0,0,0,0,0,0,0,0,0,10000,10000,0,0
049297,日電貿群益95購01,0,0,0,0,0,0,0,0,0,0,0,0,0,20000,20000,0,0
04922P,日月光凱基94售02,0,0,0,0,0,0,0,0,0,0,0,0,0,10000,10000,0,0
049253,台積電元大94購08,0,0,0,0,0,0,0,0,0,0,0,0,0,10000,10000,0,0
04942P,台積電台新94售01,0,0,0,0,0,0,0,0,0,0,0,0,0,50000,50000,0,0
050126,國巨凱基94購08  ,0,0,0,0,0,0,0,0,0,0,0,0,0,10000,10000,0,0
049705,緯穎元大94購05  ,0,0,0,0,0,0,0,0,0,0,0,0,0,10000,10000,0,0
04968P,台積電富邦94售06,0,0,0,0,0,0,0,0,0,0,0,0,0,10000,10000,0,0
04991P,台表科元大94售05,0,0,0,0,0,0,0,0,0,0,0,0,0,10000,10000,0,0
049808,聯詠元大94購03  ,0,0,0,0,0,0,0,0,0,0,0,0,0,20000,20000,0,0
057274,友達元大98購03  ,0,0,0,0,0,0,0,0,0,0,0,0,0,30000,30000,0,0
057296,智原永豐98購01  ,0,0,0,0,0,0,0,0,0,0,0,0,0,20000,20000,0,0
057125,國巨凱基98購12  ,0,0,0,0,0,0,0,0,0,0,0,0,0,10000,10000,0,0
056986,超眾群益98購03  ,0,0,0,0,0,0,0,0,0,0,0,0,0,20000,20000,0,0
057110,立積群益98購01  ,0,0,0,0,0,0,0,0,0,0,0,0,0,10000,10000,0,0
057111,立積群益98購02  ,0,0,0,0,0,0,0,0,0,0,0,0,0,5000,5000,0,0
05517P,臻鼎元大96售01  ,0,0,0,0,0,0,0,0,0,0,0,0,0,5000,5000,0,0
055235,金寶台新98購01  ,0,0,0,0,0,0,0,0,0,0,0,0,0,38000,38000,0,0
055214,聯電凱基97購02  ,0,0,0,0,0,0,0,0,0,0,0,0,0,10000,10000,0,0
055374,明泰元大97購01  ,0,0,0,0,0,0,0,0,0,0,0,0,0,10000,10000,0,0
055135,聯發科富邦99購05,0,0,0,0,0,0,0,0,0,0,0,0,0,145000,145000,0,0
05505P,聯發科凱基96售09,0,0,0,0,0,0,0,0,0,0,0,0,0,22000,22000,0,0
054842,台達電兆豐98購01,0,0,0,0,0,0,0,0,0,0,0,0,0,10000,10000,0,0
054825,康友元大97購01  ,0,0,0,0,0,0,0,0,0,0,0,0,0,10000,10000,0,0
053486,T50反1兆豐96購01,0,0,0,0,0,0,0,0,0,0,0,0,0,10000,10000,0,0
05241P,鴻海國泰97售04  ,0,0,0,0,0,0,0,0,0,0,0,0,0,5000,5000,0,0
054569,GIS群益98購01   ,0,0,0,0,0,0,0,0,0,0,0,0,0,20000,20000,0,0
054590,嘉聯益國泰98購01,0,0,0,0,0,0,0,0,0,0,0,0,0,50000,50000,0,0
054739,義隆凱基98購02  ,0,0,0,0,0,0,0,0,0,0,0,0,0,30000,30000,0,0
054726,台積電日盛97購01,0,0,0,0,0,0,0,0,0,0,0,0,0,60000,60000,0,0
05471P,聯電統一95售01  ,0,0,0,0,0,0,0,0,0,0,0,0,0,7000,7000,0,0
054943,群光元大97購01  ,0,0,0,0,0,0,0,0,0,0,0,0,0,40000,40000,0,0
05361P,聯發科富邦97售01,0,0,0,0,0,0,0,0,0,0,0,0,0,25000,25000,0,0
053991,鴻海群益96購05  ,0,0,0,0,0,0,0,0,0,0,0,0,0,100000,100000,0,0
054450,聯茂第一96購01  ,0,0,0,0,0,0,0,0,0,0,0,0,0,50000,50000,0,0
054458,復盛群益96購01  ,0,0,0,0,0,0,0,0,0,0,0,0,0,3000,3000,0,0
053771,華新元大97購01  ,0,0,0,0,0,0,0,0,0,0,0,0,0,20000,20000,0,0
053830,台積電台新96購02,0,0,0,0,0,0,0,0,0,0,0,0,0,20000,20000,0,0
053814,美律群益97購02  ,0,0,0,0,0,0,0,0,0,0,0,0,0,5000,5000,0,0
053966,旺宏元大96購08  ,0,0,0,0,0,0,0,0,0,0,0,0,0,20000,20000,0,0
052747,京鼎元大97購01  ,0,0,0,0,0,0,0,0,0,0,0,0,0,70000,70000,0,0
052760,盟立群益96購01  ,0,0,0,0,0,0,0,0,0,0,0,0,0,100000,100000,0,0
05684P,臺股指元大96售09,0,0,0,0,0,0,0,0,0,0,0,0,0,780000,780000,0,0
05321P,鴻海凱基95售17  ,0,0,0,0,0,0,0,0,0,0,0,0,0,20000,20000,0,0
056739,美律凱基98購04  ,0,0,0,0,0,0,0,0,0,0,0,0,0,100000,100000,0,0
052950,超眾國票98購01  ,0,0,0,0,0,0,0,0,0,0,0,0,0,20000,20000,0,0
052927,友達元大98購02  ,0,0,0,0,0,0,0,0,0,0,0,0,0,24000,24000,0,0
052911,友達統一97購02  ,0,0,0,0,0,0,0,0,0,0,0,0,0,108000,108000,0,0
052800,國巨元大96購05  ,0,0,0,0,0,0,0,0,0,0,0,0,0,10000,10000,0,0
052819,義隆永豐96購01  ,0,0,0,0,0,0,0,0,0,0,0,0,0,15000,15000,0,0
052527,泰鼎元大96購02  ,0,0,0,0,0,0,0,0,0,0,0,0,0,10000,10000,0,0
05259P,臺股指凱基96售12,0,0,0,0,0,0,0,0,0,0,0,0,0,80000,80000,0,0
052619,茂林國泰99購01  ,0,0,0,0,0,0,0,0,0,0,0,0,0,23000,23000,0,0
053405,台達電兆豐96購01,0,0,0,0,0,0,0,0,0,0,0,0,0,38000,38000,0,0
05341P,臺股指兆豐95售02,0,0,0,0,0,0,0,0,0,0,0,0,0,12000,12000,0,0
054416,禾伸堂元大97購01,0,0,0,0,0,0,0,0,0,0,0,0,0,10000,10000,0,0
054420,緯穎元大96購08  ,0,0,0,0,0,0,0,0,0,0,0,0,0,20000,20000,0,0
056572,義隆元大99購01  ,0,0,0,0,0,0,0,0,0,0,0,0,0,10000,10000,0,0
056566,臻鼎群益98購01  ,0,0,0,0,0,0,0,0,0,0,0,0,0,1000,1000,0,0
05659P,A50正2中信97售01,0,0,0,0,0,0,0,0,0,0,0,0,0,20000,20000,0,0
056611,國巨永豐98購03  ,0,0,0,0,0,0,0,0,0,0,0,0,0,10000,10000,0,0
056433,鴻海凱基98購09  ,0,0,0,0,0,0,0,0,0,0,0,0,0,3000,3000,0,0
056473,奇力新元大99購02,0,0,0,0,0,0,0,0,0,0,0,0,0,20000,20000,0,0
056483,TPK元大98購01   ,0,0,0,0,0,0,0,0,0,0,0,0,0,10000,10000,0,0
056323,旺宏兆豐98購01  ,0,0,0,0,0,0,0,0,0,0,0,0,0,74000,74000,0,0
053149,京元電元大96購02,0,0,0,0,0,0,0,0,0,0,0,0,0,10000,10000,0,0
055735,宏達電元富98購01,0,0,0,0,0,0,0,0,0,0,0,0,0,10000,10000,0,0
055795,茂林國泰98購01  ,0,0,0,0,0,0,0,0,0,0,0,0,0,104000,104000,0,0
05578P,鴻海凱基96售11  ,0,0,0,0,0,0,0,0,0,0,0,0,0,65000,65000,0,0
056132,台光電元大97購03,0,0,0,0,0,0,0,0,0,0,0,0,0,10000,10000,0,0
054230,上銀群益96購03  ,0,0,0,0,0,0,0,0,0,0,0,0,0,3000,3000,0,0
054194,國巨麥證96購02  ,0,0,0,0,30000,-30000,0,0,0,0,0,0,0,30000,30000,0,0
054266,緯穎元大96購07  ,0,0,0,0,0,0,0,0,0,0,0,0,0,5000,5000,0,0
055315,晶技麥證97購01  ,0,0,0,10000,10000,0,0,0,0,0,0,0,0,10000,10000,0,0
3528,安馳            ,13000,15000,-2000,0,0,0,0,0,0,2000,2000,0,2000,0,0,0,0
5906,台南-KY         ,1000,1000,0,0,0,0,0,0,0,0,0,0,0,0,0,0,0
2236,百達-KY         ,1000,1000,0,0,0,0,0,0,0,0,0,0,0,0,0,0,0
2109,華豐            ,7000,7000,0,0,0,0,0,0,0,0,0,0,0,0,0,0,0
2440,太空梭          ,1000,1000,0,0,0,0,0,0,0,0,0,0,0,0,0,0,0
2630,亞航            ,2000,2000,0,0,0,0,0,0,0,0,0,0,0,0,0,0,0
9926,新海            ,3000,3000,0,0,0,0,0,0,0,0,0,0,0,0,0,0,0
00636K,國泰中國A50+U   ,0,0,0,0,0,0,0,0,0,-100,0,0,0,100,200,-100,-100
1539,巨庭            ,5000,6000,-1000,0,0,0,0,0,0,0,0,0,0,0,0,0,-1000
1525,江申            ,7000,8000,-1000,0,0,0,0,0,0,0,0,0,0,0,0,0,-1000
1506,正道            ,0,1000,-1000,0,0,0,0,0,0,0,0,0,0,0,0,0,-1000
07191P,台積電元大99售32,0,0,0,0,0,0,0,0,0,-1000,0,0,0,40000,41000,-1000,-1000
1341,富林-KY         ,0,0,0,0,0,0,0,0,0,-1000,0,1000,-1000,0,0,0,-1000
06727P,台光電元大98售05,0,0,0,0,0,0,0,0,0,-1000,0,0,0,39000,40000,-1000,-1000
07033P,大立光統一9B售03,0,0,0,0,0,0,0,0,0,-1000,0,0,0,0,1000,-1000,-1000
06951P,台積電統一9B售02,0,0,0,0,0,0,0,0,0,-1000,0,0,0,33000,34000,-1000,-1000
06611P,祥碩國票98售01  ,0,0,0,0,0,0,0,0,0,-1000,0,0,0,0,1000,-1000,-1000
06543P,鴻海元大98售08  ,0,0,0,0,0,0,0,0,0,-1000,0,0,0,155000,156000,-1000,-1000
06369P,台積電凱基97售16,0,0,0,0,0,0,0,0,0,-1000,0,0,0,0,1000,-1000,-1000
05981P,可成永昌98售02  ,0,0,0,0,0,0,0,0,0,-1000,0,0,0,0,1000,-1000,-1000
059136,臺股指群益99購11,0,0,0,0,0,0,0,0,0,-1000,0,0,0,0,1000,-1000,-1000
05913P,國巨元大96售11  ,0,0,0,0,0,0,0,0,0,-1000,0,0,0,20000,21000,-1000,-1000
059115,美食永豐99購01  ,0,0,0,0,0,0,0,0,0,-1000,0,0,0,0,1000,-1000,-1000
057764,台表科凱基9A購01,0,0,0,0,0,0,0,0,0,-1000,0,0,0,0,1000,-1000,-1000
057567,嘉聯益富邦9A購01,0,0,0,0,0,0,0,0,0,-1000,0,0,0,0,1000,-1000,-1000
057515,智原元富98購02  ,0,0,0,0,0,0,0,0,0,-1000,0,0,0,0,1000,-1000,-1000
058282,聯茂中信99購01  ,0,0,0,0,0,0,0,0,0,-1000,0,0,0,93000,94000,-1000,-1000
058121,國巨國票9A購01  ,0,0,0,0,0,0,0,0,0,-1000,0,0,0,0,1000,-1000,-1000
057886,聯詠群益98購01  ,0,0,0,0,0,0,0,0,0,-1000,0,0,0,0,1000,-1000,-1000
059036,可成群益9B購03  ,0,0,0,0,0,0,0,0,0,-1000,0,0,0,0,1000,-1000,-1000
059017,台灣50統一9B購03,0,0,0,0,0,0,0,0,0,-1000,0,0,0,0,1000,-1000,-1000
05890P,彩晶元大99售01  ,0,0,0,0,0,0,0,0,0,-1000,0,0,0,80000,81000,-1000,-1000
058939,台積電中信9B購01,0,0,0,0,0,0,0,0,0,-1000,0,0,0,0,1000,-1000,-1000
058777,台光電國票9A購01,0,0,0,0,0,0,0,0,0,-1000,0,0,0,0,1000,-1000,-1000
006204,永豐臺灣加權    ,0,0,0,0,0,0,0,0,0,-1000,0,0,0,1000,2000,-1000,-1000
00711B,FH彭博新興債    ,0,0,0,0,0,0,0,0,0,-1000,0,0,0,300000,301000,-1000,-1000
04214P,美利達凱基93售04,0,0,0,0,0,0,0,0,0,-1000,0,0,0,0,1000,-1000,-1000
03091X,元展85          ,0,0,0,0,0,0,0,0,0,-1000,0,0,0,0,1000,-1000,-1000
04395P,台積電群益94售06,0,0,0,0,0,0,0,0,0,-1000,0,0,0,0,1000,-1000,-1000
04837P,華新科元大94售05,0,0,0,0,0,0,0,0,0,-1000,0,0,0,17000,18000,-1000,-1000
044734,台積電國泰93購01,0,0,0,0,0,0,0,0,0,-1000,0,0,0,0,1000,-1000,-1000
04465P,大立光元富94售03,0,0,0,0,0,0,0,0,0,-1000,0,0,0,0,1000,-1000,-1000
04466P,大立光元富94售04,0,0,0,0,0,0,0,0,0,-1000,0,0,0,0,1000,-1000,-1000
03296P,台積電統一02售13,0,0,0,0,0,0,0,0,0,-1000,0,0,0,0,1000,-1000,-1000
050288,台積電凱基94購32,0,0,0,0,0,0,0,0,0,-1000,0,0,0,0,1000,-1000,-1000
05045P,台積電永豐95售01,0,0,0,0,0,0,0,0,0,-1000,0,0,0,0,1000,-1000,-1000
046568,臻鼎元富95購01  ,0,0,0,0,0,0,0,0,0,-1000,0,0,0,0,1000,-1000,-1000
050155,華新科群益95購01,0,0,0,0,0,0,0,0,0,-1000,0,0,0,84000,85000,-1000,-1000
04746P,臺股指元大94售17,0,0,0,0,0,0,0,0,0,-1000,0,0,0,0,1000,-1000,-1000
046882,智易富邦97購01  ,0,0,0,0,0,0,0,0,0,-1000,0,0,0,0,1000,-1000,-1000
046187,友達凱基93購03  ,0,0,0,0,0,0,0,0,0,-1000,0,0,0,0,1000,-1000,-1000
045996,南電富邦94購01  ,0,0,0,0,0,0,0,0,0,-1000,0,0,0,0,1000,-1000,-1000
04813P,智邦元大94售07  ,0,0,0,0,0,0,0,0,0,-1000,0,0,0,0,1000,-1000,-1000
049695,新光金元大9A購01,0,0,0,0,0,0,0,0,0,-1000,0,0,0,0,1000,-1000,-1000
050093,國巨永豐94購05  ,0,0,0,0,0,0,0,0,0,-1000,0,0,0,0,1000,-1000,-1000
04938P,亞德客國票95售01,0,0,0,0,0,0,0,0,0,-1000,0,0,0,0,1000,-1000,-1000
049347,群創統一95購01  ,0,0,0,0,0,0,0,0,0,-1000,0,0,0,0,1000,-1000,-1000
050671,超眾永豐94購04  ,0,0,0,0,0,0,0,0,0,-1000,0,0,0,0,1000,-1000,-1000
05079P,可成永豐95售01  ,0,0,0,0,0,0,0,0,0,-1000,0,0,0,0,1000,-1000,-1000
052152,創意富邦98購01  ,0,0,0,0,0,0,0,0,0,-1000,0,0,0,0,1000,-1000,-1000
052217,台光電日盛95購01,0,0,0,0,0,0,0,0,0,-1000,0,0,0,0,1000,-1000,-1000
04889P,華通元大94售03  ,0,0,0,0,0,0,0,0,0,-1000,0,0,0,1000,2000,-1000,-1000
051561,玉晶光國泰97購04,0,0,0,0,0,0,0,0,0,-1000,0,0,0,0,1000,-1000,-1000
052342,茂林凱基96購01  ,0,0,0,0,0,0,0,0,0,-1000,0,0,0,0,1000,-1000,-1000
05550P,臺股指元大96售07,0,0,0,0,0,0,0,0,0,-1000,0,0,0,50000,51000,-1000,-1000
051627,華新科麥證95購03,0,0,0,10000,11000,-1000,0,0,0,-1000,0,0,0,10000,11000,-1000,-1000
055442,矽創國票98購02  ,0,0,0,0,0,0,0,0,0,-1000,0,0,0,0,1000,-1000,-1000
055446,奇力新統一9A購01,0,0,0,0,0,0,0,0,0,-1000,0,0,0,0,1000,-1000,-1000
055283,聯發科元大97購16,0,0,0,0,0,0,0,0,0,-1000,0,0,0,0,1000,-1000,-1000
054256,創意元大96購07  ,0,0,0,0,0,0,0,0,0,-1000,0,0,0,0,1000,-1000,-1000
055380,智易元大98購02  ,0,0,0,0,0,0,0,0,0,-1000,0,0,0,50000,51000,-1000,-1000
055786,彩晶凱基99購02  ,0,0,0,0,0,0,0,0,0,-1000,0,0,0,0,1000,-1000,-1000
055744,茂林元富97購02  ,0,0,0,0,0,0,0,0,0,-1000,0,0,0,0,1000,-1000,-1000
05581P,華新科凱基96售07,0,0,0,0,0,0,0,0,0,-1000,0,0,0,0,1000,-1000,-1000
053152,大立光元大99購01,0,0,0,0,0,0,0,0,0,-1000,0,0,0,0,1000,-1000,-1000
056204,嘉澤永豐97購01  ,0,0,0,0,0,0,0,0,0,-1000,0,0,0,0,1000,-1000,-1000
056426,上証2X凱基9A購01,0,0,0,0,0,0,0,0,0,-1000,0,0,0,0,1000,-1000,-1000
056455,群創凱基9A購01  ,0,0,0,0,0,0,0,0,0,-1000,0,0,0,0,1000,-1000,-1000
056457,嘉澤凱基98購01  ,0,0,0,0,0,0,0,0,0,-1000,0,0,0,71000,72000,-1000,-1000
053438,玉晶光麥證97購02,0,0,0,0,1000,-1000,0,0,0,-1000,0,0,0,0,1000,-1000,-1000
053323,群創群益98購07  ,0,0,0,0,0,0,0,0,0,-1000,0,0,0,0,1000,-1000,-1000
056173,廣達元富97購01  ,0,0,0,0,0,0,0,0,0,-1000,0,0,0,75000,76000,-1000,-1000
052565,上銀凱基96購01  ,0,0,0,0,0,0,0,0,0,-1000,0,0,0,0,1000,-1000,-1000
052568,漢唐凱基96購02  ,0,0,0,0,0,0,0,0,0,-1000,0,0,0,0,1000,-1000,-1000
052938,華新科兆豐96購01,0,0,0,0,0,0,0,0,0,-1000,0,0,0,0,1000,-1000,-1000
056375,玉晶光統一01購01,0,0,0,0,0,0,0,0,0,-1000,0,0,0,0,1000,-1000,-1000
054373,富邦金中信97購01,0,0,0,0,0,0,0,0,0,-1000,0,0,0,0,1000,-1000,-1000
05388P,南亞科元大95售04,0,0,0,0,0,0,0,0,0,-1000,0,0,0,19000,20000,-1000,-1000
053742,創意國票97購01  ,0,0,0,0,0,0,0,0,0,-1000,0,0,0,50000,51000,-1000,-1000
053973,晶豪科元大96購01,0,0,0,0,0,0,0,0,0,-1000,0,0,0,0,1000,-1000,-1000
054008,大立光元富96購06,0,0,0,0,0,0,0,0,0,-1000,0,0,0,0,1000,-1000,-1000
057005,元油2X中信9C購01,0,0,0,0,0,0,0,0,0,-1000,0,0,0,0,1000,-1000,-1000
056860,正崴群益98購01  ,0,0,0,0,0,0,0,0,0,-1000,0,0,0,0,1000,-1000,-1000
055263,華新科富邦9A購01,0,0,0,0,0,0,0,0,0,-1000,0,0,0,0,1000,-1000,-1000
055232,泰碩國票98購01  ,0,0,0,0,0,0,0,0,0,-1000,0,0,0,0,1000,-1000,-1000
055180,文曄統一97購01  ,0,0,0,0,0,0,0,0,0,-1000,0,0,0,0,1000,-1000,-1000
057103,禾伸堂中信9A購01,0,0,0,0,0,0,0,0,0,-1000,0,0,0,0,1000,-1000,-1000
057282,大立光元大99購06,0,0,0,0,0,0,0,0,0,-1000,0,0,0,26000,27000,-1000,-1000
057389,玉晶光永豐98購06,0,0,0,0,0,0,0,0,0,-1000,0,0,0,0,1000,-1000,-1000
8427,基勝-KY         ,0,1000,-1000,0,0,0,0,0,0,0,0,0,0,0,0,0,-1000
911616,杜康-DR         ,1000,2000,-1000,0,0,0,0,0,0,0,0,0,0,0,0,0,-1000
6243,迅杰            ,10000,11000,-1000,0,0,0,0,0,0,0,0,0,0,0,0,0,-1000
6442,光聖            ,14000,17000,-3000,0,0,0,0,0,0,2000,2000,0,2000,0,0,0,-1000
6674,鋐寶科技        ,3000,4000,-1000,0,0,0,0,0,0,0,0,0,0,0,0,0,-1000
2482,連宇            ,16000,23000,-7000,0,0,0,0,0,0,6000,6000,0,6000,0,0,0,-1000
2243,宏旭-KY         ,7000,8000,-1000,0,0,0,0,0,0,0,0,0,0,0,0,0,-1000
4545,銘鈺            ,10000,19000,-9000,0,0,0,0,0,0,8000,8000,0,8000,0,0,0,-1000
4737,華廣            ,26000,28000,-2000,0,0,0,0,0,0,1000,1000,0,1000,0,0,0,-1000
3694,海華            ,23000,27000,-4000,0,0,0,0,0,0,3000,3000,0,3000,0,0,0,-1000
3679,新至陞          ,17000,18000,-1000,0,0,0,0,0,0,0,0,0,0,0,0,0,-1000
2910,統領            ,1000,2000,-1000,0,0,0,0,0,0,0,0,0,0,0,0,0,-1000
3054,立萬利          ,6000,7000,-1000,0,0,0,0,0,0,0,0,0,0,0,0,0,-1000
058801,致伸元大99購01  ,0,0,0,0,0,0,0,0,0,-2000,0,0,0,0,2000,-2000,-2000
058919,SGBR2X元富99購05,0,0,0,0,0,0,0,0,0,-2000,0,0,0,0,2000,-2000,-2000
058958,台表科國票9A購03,0,0,0,0,0,0,0,0,0,-2000,0,0,0,0,2000,-2000,-2000
058975,台灣50凱基01購02,0,0,0,0,0,0,0,0,0,-2000,0,0,0,0,2000,-2000,-2000
059073,元油2X元大9C購14,0,0,0,0,0,0,0,0,0,-2000,0,0,0,0,2000,-2000,-2000
058319,大毅永豐9A購01  ,0,0,0,0,0,0,0,0,0,-2000,0,0,0,8000,10000,-2000,-2000
058465,元石油中信01購01,0,0,0,0,0,0,0,0,0,-2000,0,0,0,0,2000,-2000,-2000
058448,滬深2X永豐9A購01,0,0,0,0,0,0,0,0,0,-2000,0,0,0,0,2000,-2000,-2000
05865P,大立光元大96售09,0,0,0,0,0,0,0,0,0,-2000,0,0,0,0,2000,-2000,-2000
058006,台郡群益98購04  ,0,0,0,0,0,0,0,0,0,-2000,0,0,0,0,2000,-2000,-2000
058052,南電元大98購02  ,0,0,0,0,0,0,0,0,0,-2000,0,0,0,10000,12000,-2000,-2000
058266,宏達電永豐99購01,0,0,0,0,0,0,0,0,0,-2000,0,0,0,0,2000,-2000,-2000
057398,台郡中信99購01  ,0,0,0,0,0,0,0,0,0,-2000,0,0,0,0,2000,-2000,-2000
057771,鴻海群益99購01  ,0,0,0,0,0,0,0,0,0,-2000,0,0,0,3000,5000,-2000,-2000
057751,神達國票99購02  ,0,0,0,0,0,0,0,0,0,-2000,0,0,0,0,2000,-2000,-2000
059114,華新科永豐99購05,0,0,0,0,0,0,0,0,0,-2000,0,0,0,0,2000,-2000,-2000
059188,京元電富邦9B購01,0,0,0,0,0,0,0,0,0,-2000,0,0,0,0,2000,-2000,-2000
05919P,京鼎元大96售03  ,0,0,0,0,0,0,0,0,0,-2000,0,0,0,4000,6000,-2000,-2000
06007P,世芯永豐96售01  ,0,0,0,0,0,0,0,0,0,-2000,0,0,0,216000,218000,-2000,-2000
059208,SGBR2X元大99購02,0,0,0,0,0,0,0,0,0,-2000,0,0,0,0,2000,-2000,-2000
05951P,台積電國票97售05,0,0,0,0,0,0,0,0,0,-2000,0,0,0,0,2000,-2000,-2000
06264P,友達凱基98售06  ,0,0,0,0,0,0,0,0,0,-2000,0,0,0,0,2000,-2000,-2000
06483P,聯發科凱基98售10,0,0,0,0,0,0,0,0,0,-2000,0,0,0,0,2000,-2000,-2000
07028P,大立光群益99售06,0,0,0,0,0,0,0,0,0,-2000,0,0,0,0,2000,-2000,-2000
06920P,台灣50凱基9A售01,0,0,0,0,0,0,0,0,0,-2000,0,0,0,2000,4000,-2000,-2000
06932P,大立光元大98售21,0,0,0,0,0,0,0,0,0,-2000,0,0,0,10000,12000,-2000,-2000
1413,宏洲            ,0,2000,-2000,0,0,0,0,0,0,0,0,0,0,0,0,0,-2000
07172P,臺股指國票99售09,0,0,0,0,0,0,0,0,0,-2000,0,0,0,199000,201000,-2000,-2000
07161P,臺股指群益99售12,0,0,0,0,0,0,0,0,0,-2000,0,0,0,0,2000,-2000,-2000
07162P,臺股指群益99售13,0,0,0,0,0,0,0,0,0,-2000,0,0,0,0,2000,-2000,-2000
07165P,臺股指群益99售16,0,0,0,0,0,0,0,0,0,-2000,0,0,0,0,2000,-2000,-2000
07144P,FBVIX元大99售03 ,0,0,0,0,0,0,0,0,0,-2000,0,0,0,0,2000,-2000,-2000
1583,程泰            ,0,2000,-2000,0,0,0,0,0,0,0,0,0,0,0,0,0,-2000
1468,昶和            ,0,2000,-2000,0,0,0,0,0,0,0,0,0,0,0,0,0,-2000
1617,榮星            ,0,1000,-1000,0,0,0,0,0,0,-1000,0,1000,-1000,0,0,0,-2000
056036,鴻海凱基97購07  ,0,0,0,0,0,0,0,0,0,-2000,0,0,0,0,2000,-2000,-2000
055985,聯鈞元富97購01  ,0,0,0,0,0,0,0,0,0,-2000,0,0,0,0,2000,-2000,-2000
055487,國巨元大98購07  ,0,0,0,0,0,0,0,0,0,-2000,0,0,0,2000,4000,-2000,-2000
055707,聯鈞永豐98購01  ,0,0,0,0,0,0,0,0,0,-2000,0,0,0,0,2000,-2000,-2000
05094P,大立光元大95售07,0,0,0,0,0,0,0,0,0,-2000,0,0,0,1000,3000,-2000,-2000
051495,玉晶光第一95購02,0,0,0,0,0,0,0,0,0,-2000,0,0,0,0,2000,-2000,-2000
049552,鴻海國泰96購01  ,0,0,0,0,0,0,0,0,0,-2000,0,0,0,250000,252000,-2000,-2000
051979,群創凱基97購01  ,0,0,0,0,0,0,0,0,0,-2000,0,0,0,0,2000,-2000,-2000
050007,貿聯永豐94購01  ,0,0,0,0,0,0,0,0,0,-2000,0,0,0,0,2000,-2000,-2000
04530P,上海銀凱基94售03,0,0,0,0,0,0,0,0,0,-2000,0,0,0,0,2000,-2000,-2000
046299,大立光富邦93購04,0,0,0,0,0,0,0,0,0,-2000,0,0,0,0,2000,-2000,-2000
046477,台積電統一94購02,0,0,0,0,0,0,0,0,0,-2000,0,0,0,0,2000,-2000,-2000
046866,台積電統一94購03,0,0,0,0,0,0,0,0,0,-2000,0,0,0,1000,3000,-2000,-2000
050419,鴻海凱基95購02  ,0,0,0,0,0,0,0,0,0,-2000,0,0,0,0,2000,-2000,-2000
03567P,可成凱基02售06  ,0,0,0,0,0,0,0,0,0,-2000,0,0,0,0,2000,-2000,-2000
048610,華新科凱基94購04,0,0,0,0,0,0,0,0,0,-2000,0,0,0,0,2000,-2000,-2000
03039P,玉晶光國票02售04,0,0,0,0,0,0,0,0,0,-2000,0,0,0,0,2000,-2000,-2000
03016X,元展16          ,0,0,0,0,0,0,0,0,0,-2000,0,0,0,0,2000,-2000,-2000
057271,國巨元大98購17  ,0,0,0,0,0,0,0,0,0,-2000,0,0,0,18000,20000,-2000,-2000
057249,華邦電統一9A購01,0,0,0,0,0,0,0,0,0,-2000,0,0,0,0,2000,-2000,-2000
057250,大立光統一98購08,0,0,0,0,0,0,0,0,0,-2000,0,0,0,0,2000,-2000,-2000
057120,茂林康和98購01  ,0,0,0,0,0,0,0,0,0,-2000,0,0,0,0,2000,-2000,-2000
057182,禾伸堂元大99購02,0,0,0,0,0,0,0,0,0,-2000,0,0,0,28000,30000,-2000,-2000
057020,台積電凱基99購02,0,0,0,0,0,0,0,0,0,-2000,0,0,0,0,2000,-2000,-2000
053614,台積電群益96購08,0,0,0,0,0,0,0,0,0,-2000,0,0,0,78000,80000,-2000,-2000
05377P,鴻海凱基95售18  ,0,0,0,0,0,0,0,0,0,-2000,0,0,0,10000,12000,-2000,-2000
054455,楠梓電群益98購02,0,0,0,0,0,0,0,0,0,-2000,0,0,0,0,2000,-2000,-2000
054661,嘉聯益元大97購03,0,0,0,0,0,0,0,0,0,-2000,0,0,0,0,2000,-2000,-2000
054564,玉晶光群益99購01,0,0,0,0,0,0,0,0,0,-2000,0,0,0,0,2000,-2000,-2000
054628,可成凱基98購01  ,0,0,0,0,0,0,0,0,0,-2000,0,0,0,0,2000,-2000,-2000
053480,祥碩元大96購02  ,0,0,0,0,0,0,0,0,0,-2000,0,0,0,0,2000,-2000,-2000
053463,可成富邦98購01  ,0,0,0,0,0,0,0,0,0,-2000,0,0,0,0,2000,-2000,-2000
054292,欣興元大96購06  ,0,0,0,0,0,0,0,0,0,-2000,0,0,0,0,2000,-2000,-2000
053024,國巨富邦97購02  ,0,0,0,0,0,0,0,0,0,-2000,0,0,0,0,2000,-2000,-2000
056449,義隆凱基98購03  ,0,0,0,0,0,0,0,0,0,-2000,0,0,0,0,2000,-2000,-2000
056475,宏達電元大99購02,0,0,0,0,0,0,0,0,0,-2000,0,0,0,10000,12000,-2000,-2000
056488,致新元大99購01  ,0,0,0,0,0,0,0,0,0,-2000,0,0,0,5000,7000,-2000,-2000
056125,旺宏國票98購02  ,0,0,0,0,0,0,0,0,0,-2000,0,0,0,0,2000,-2000,-2000
055827,中石化元大98購01,0,0,0,0,0,0,0,0,0,-2000,0,0,0,0,2000,-2000,-2000
054169,上緯控凱基98購01,0,0,0,0,0,0,0,0,0,-2000,0,0,0,1000,3000,-2000,-2000
3021,鴻名            ,1000,5000,-4000,0,0,0,0,0,0,2000,2000,0,2000,0,0,0,-2000
4807,日成-KY         ,4000,6000,-2000,0,0,0,0,0,0,0,0,0,0,0,0,0,-2000
4763,材料-KY         ,166000,167000,-1000,0,0,0,0,0,0,-1000,67000,64000,3000,0,4000,-4000,-2000
4557,永新-KY         ,6000,8000,-2000,0,0,0,0,0,0,0,0,0,0,0,0,0,-2000
6117,迎廣            ,0,2000,-2000,0,0,0,0,0,0,0,0,0,0,0,0,0,-2000
2419,仲琦            ,202000,208000,-6000,0,0,0,0,0,0,4000,4000,0,4000,0,0,0,-2000
2331,精英            ,161000,209000,-48000,0,0,0,0,0,0,46000,124000,78000,46000,0,0,0,-2000
2483,百容            ,7000,9000,-2000,0,0,0,0,0,0,0,3000,3000,0,0,0,0,-2000
6431,光麗-KY         ,0,2000,-2000,0,0,0,0,0,0,0,0,0,0,0,0,0,-2000
8481,政伸            ,1000,3000,-2000,0,0,0,0,0,0,0,0,0,0,0,0,0,-2000
8467,波力-KY         ,2000,3000,-1000,0,0,0,0,0,0,-1000,0,1000,-1000,0,0,0,-2000
8411,福貞-KY         ,3000,5000,-2000,0,0,0,0,0,0,0,1000,1000,0,0,0,0,-2000
9918,欣天然          ,1000,3000,-2000,0,0,0,0,0,0,0,0,0,0,0,0,0,-2000
1805,寶徠            ,0,3000,-3000,0,0,0,0,0,0,0,0,0,0,0,0,0,-3000
1453,大將            ,0,3000,-3000,0,0,0,0,0,0,0,0,0,0,0,0,0,-3000
1533,車王電          ,26000,29000,-3000,0,0,0,0,0,0,0,0,0,0,0,0,0,-3000
1324,地球            ,0,5000,-5000,0,0,0,0,0,0,2000,2000,0,2000,0,0,0,-3000
06853P,華擎元富98售03  ,0,0,0,0,0,0,0,0,0,-3000,0,0,0,1000,4000,-3000,-3000
07041P,T50反1元大9C售01,0,0,0,0,0,0,0,0,0,-3000,0,0,0,899000,902000,-3000,-3000
07101P,台郡元大99售06  ,0,0,0,0,0,0,0,0,0,-3000,0,0,0,3000,6000,-3000,-3000
06969P,上銀元大99售02  ,0,0,0,0,0,0,0,0,0,-3000,0,0,0,56000,59000,-3000,-3000
06433P,大立光群益99售01,0,0,0,0,0,0,0,0,0,-3000,0,0,0,0,3000,-3000,-3000
06509P,鴻海群益98售03  ,0,0,0,0,0,0,0,0,0,-3000,0,0,0,0,3000,-3000,-3000
06619P,聯發科元大98售06,0,0,0,0,0,0,0,0,0,-3000,0,0,0,32000,35000,-3000,-3000
05922P,京元電兆豐96售01,0,0,0,0,0,0,0,0,0,-3000,0,0,0,10000,13000,-3000,-3000
06070P,漢唐永豐97售01  ,0,0,0,0,0,0,0,0,0,-3000,0,0,0,47000,50000,-3000,-3000
057824,日月光元大98購01,0,0,0,0,0,0,0,0,0,-3000,0,0,0,21000,24000,-3000,-3000
057869,大立光凱基99購01,0,0,0,0,0,0,0,0,0,-3000,0,0,0,0,3000,-3000,-3000
057423,台郡凱基98購06  ,0,0,0,0,0,0,0,0,0,-3000,0,0,0,0,3000,-3000,-3000
057577,廣宇中信9A購01  ,0,0,0,0,0,0,0,0,0,-3000,0,0,0,0,3000,-3000,-3000
058156,超眾統一9A購02  ,0,0,0,0,0,0,0,0,0,-3000,0,0,0,0,3000,-3000,-3000
058034,神達永豐98購02  ,0,0,0,0,0,0,0,0,0,-3000,0,0,0,0,3000,-3000,-3000
058449,台積電永豐99購01,0,0,0,0,0,0,0,0,0,-3000,0,0,0,0,3000,-3000,-3000
058729,國巨永豐99購03  ,0,0,0,0,0,0,0,0,0,-3000,0,0,0,0,3000,-3000,-3000
043973,元金2X元大94購02,0,0,0,0,0,0,0,0,0,-3000,0,0,0,901000,904000,-3000,-3000
03094X,大立光元大68展08,0,1000,-1000,0,0,0,0,0,0,-2000,0,0,0,1000,3000,-2000,-3000
04273P,上証反凱基99售01,0,0,0,0,0,0,0,0,0,-3000,0,0,0,2000,5000,-3000,-3000
04363P,儒鴻元富94售01  ,0,0,0,0,0,0,0,0,0,-3000,0,0,0,2000,5000,-3000,-3000
04444P,玉晶光永豐94售06,0,0,0,0,0,0,0,0,0,-3000,0,0,0,0,3000,-3000,-3000
03518P,臺股指國票02售07,0,0,0,0,0,0,0,0,0,-3000,0,0,0,510000,513000,-3000,-3000
050230,聯發科麥證94購02,0,0,0,0,3000,-3000,0,0,0,-3000,0,0,0,0,3000,-3000,-3000
04623P,台積電元大94售13,0,0,0,0,0,0,0,0,0,-3000,0,0,0,0,3000,-3000,-3000
05199P,訊芯永豐95售02  ,0,0,0,0,0,0,0,0,0,-3000,0,0,0,0,3000,-3000,-3000
049528,台積電中信94購01,0,0,0,0,0,0,0,0,0,-3000,0,0,0,0,3000,-3000,-3000
049593,群創元大9A購01  ,0,0,0,0,0,0,0,0,0,-3000,0,0,0,29000,32000,-3000,-3000
051752,緯穎富邦96購01  ,0,0,0,0,0,0,0,0,0,-3000,0,0,0,0,3000,-3000,-3000
051575,國巨元大96購03  ,0,0,0,0,0,0,0,0,0,-3000,0,0,0,0,3000,-3000,-3000
055693,南茂凱基97購01  ,0,0,0,0,0,0,0,0,0,-3000,0,0,0,0,3000,-3000,-3000
055586,旺宏元大98購06  ,0,0,0,0,0,0,0,0,0,-3000,0,0,0,2000,5000,-3000,-3000
055521,S&P反1群益01購01,0,0,0,0,0,0,0,0,0,-3000,0,0,0,0,3000,-3000,-3000
055264,國巨永豐98購01  ,0,0,0,0,0,0,0,0,0,-3000,0,0,0,0,3000,-3000,-3000
051665,台積電元大96購07,0,0,0,0,0,0,0,0,0,-3000,0,0,0,0,3000,-3000,-3000
055902,同欣電中信99購01,0,0,0,0,0,0,0,0,0,-3000,0,0,0,0,3000,-3000,-3000
055299,康友元大97購02  ,0,0,0,0,0,0,0,0,0,-3000,0,0,0,0,3000,-3000,-3000
056665,上証2X國票99購02,0,0,0,0,0,0,0,0,0,-3000,0,0,0,0,3000,-3000,-3000
056417,欣興中信98購01  ,0,0,0,0,0,0,0,0,0,-3000,0,0,0,0,3000,-3000,-3000
05290P,國巨永豐95售04  ,0,0,0,0,0,0,0,0,0,-3000,0,0,0,30000,33000,-3000,-3000
052754,上証2X群益9A購01,0,0,0,0,0,0,0,0,0,-3000,0,0,0,0,3000,-3000,-3000
056670,樺漢國票99購01  ,0,0,0,0,0,0,0,0,0,-3000,0,0,0,0,3000,-3000,-3000
05247P,上銀群益95售01  ,0,0,0,0,0,0,0,0,0,-3000,0,0,0,0,3000,-3000,-3000
054570,易華電群益98購01,0,0,0,0,0,0,0,0,0,-3000,0,0,0,0,3000,-3000,-3000
055005,晶相光元富97購01,0,0,0,0,0,0,0,0,0,-3000,0,0,0,17000,20000,-3000,-3000
053746,彰銀康和96購01  ,0,0,0,0,0,0,0,0,0,-3000,0,0,0,0,3000,-3000,-3000
053789,彩晶元大9C購02  ,0,0,0,0,0,0,0,0,0,-3000,0,0,0,0,3000,-3000,-3000
053580,國巨元大96購10  ,0,0,0,0,0,0,0,0,0,-3000,0,0,0,17000,20000,-3000,-3000
05703P,矽力群益96售03  ,0,0,0,0,0,0,0,0,0,-3000,0,0,0,2000,5000,-3000,-3000
055257,景碩統一97購01  ,0,0,0,0,0,0,0,0,0,-3000,0,0,0,27000,30000,-3000,-3000
057191,祥碩元大98購05  ,0,0,0,0,0,0,0,0,0,-3000,0,0,0,2000,5000,-3000,-3000
056992,祥碩兆豐98購01  ,0,0,0,0,0,0,0,0,0,-3000,0,0,0,0,3000,-3000,-3000
057281,大立光元大98購16,0,0,0,0,0,0,0,0,0,-3000,0,0,0,10000,13000,-3000,-3000
057396,健鼎中信99購01  ,0,0,0,0,0,0,0,0,0,-3000,0,0,0,0,3000,-3000,-3000
057342,玉晶光台新98購01,0,0,0,0,0,0,0,0,0,-3000,0,0,0,7000,10000,-3000,-3000
8488,吉源-KY         ,4000,7000,-3000,0,0,0,0,0,0,0,0,0,0,0,0,0,-3000
6672,騰輝電子-KY     ,199000,202000,-3000,0,0,0,0,0,0,0,0,0,0,0,0,0,-3000
6573,虹揚-KY         ,10000,13000,-3000,0,0,0,0,0,0,0,0,0,0,0,0,0,-3000
2540,愛山林          ,0,3000,-3000,0,0,0,0,0,0,0,0,0,0,0,0,0,-3000
2380,虹光            ,0,3000,-3000,0,0,0,0,0,0,0,0,0,0,0,0,0,-3000
4581,光隆精密-KY     ,1000,4000,-3000,0,0,0,0,0,0,0,0,0,0,0,0,0,-3000
058744,FBVIX凱基9C購03 ,0,0,0,0,0,0,0,0,0,-4000,0,0,0,6000,10000,-4000,-4000
058776,台積電國票9A購03,0,0,0,0,0,0,0,0,0,-4000,0,0,0,13000,17000,-4000,-4000
059050,元油2X凱基9B購08,0,0,0,0,0,0,0,0,0,-4000,0,0,0,0,4000,-4000,-4000
058328,世紀鋼統一9B購01,0,0,0,0,0,0,0,0,0,-4000,0,0,0,6000,10000,-4000,-4000
057652,欣興永昌9C購01  ,0,0,0,0,0,0,0,0,0,-4000,0,0,0,0,4000,-4000,-4000
06067P,華新科康和97售01,0,0,0,0,0,0,0,0,0,-4000,0,0,0,2000,6000,-4000,-4000
059133,臺股指群益99購08,0,0,0,0,0,0,0,0,0,-4000,0,0,0,11000,15000,-4000,-4000
06591P,大立光元大98售14,0,0,0,0,0,0,0,0,0,-4000,0,0,0,20000,24000,-4000,-4000
06586P,鴻海元大9C售01  ,0,0,0,0,0,0,0,0,0,-4000,0,0,0,0,4000,-4000,-4000
06328P,台積電中信01售02,0,0,0,0,0,0,0,0,0,-4000,0,0,0,31000,35000,-4000,-4000
06949P,台表科元大99售01,0,0,0,0,0,0,0,0,0,-4000,0,0,0,6000,10000,-4000,-4000
06813P,友訊元富98售03  ,0,0,0,0,0,0,0,0,0,-4000,0,0,0,0,4000,-4000,-4000
1235,興泰            ,0,4000,-4000,0,0,0,0,0,0,0,0,0,0,0,0,0,-4000
07184P,台灣50元富01售01,0,0,0,0,0,0,0,0,0,-4000,0,0,0,0,4000,-4000,-4000
08525P,台灣50凱基96售02,0,0,0,0,0,0,0,0,0,-4000,0,0,0,30000,34000,-4000,-4000
1454,台富            ,5000,9000,-4000,0,0,0,0,0,0,0,0,0,0,0,0,0,-4000
1463,強盛            ,8000,13000,-5000,0,0,0,0,0,0,1000,1000,0,1000,0,0,0,-4000
1735,日勝化          ,0,4000,-4000,0,0,0,0,0,0,0,0,0,0,0,0,0,-4000
055955,微星元大97購01  ,0,0,0,0,0,0,0,0,0,-4000,0,0,0,0,4000,-4000,-4000
051397,聯茂兆豐95購03  ,0,0,0,0,0,0,0,0,0,-4000,0,0,0,126000,130000,-4000,-4000
049485,台積電元大96購03,0,0,0,0,0,0,0,0,0,-4000,0,0,0,16000,20000,-4000,-4000
050012,台積電國泰95購03,0,0,0,0,0,0,0,0,0,-4000,0,0,0,4000,8000,-4000,-4000
050058,國巨凱基94購06  ,0,0,0,0,0,0,0,0,0,-4000,0,0,0,0,4000,-4000,-4000
045767,大立光元富95購01,0,0,0,0,0,0,0,0,0,-4000,0,0,0,18000,22000,-4000,-4000
048385,亞德客國票94購01,0,0,0,0,0,0,0,0,0,-4000,0,0,0,0,4000,-4000,-4000
04827P,國巨凱基94售09  ,0,0,0,0,0,0,0,0,0,-4000,0,0,0,40000,44000,-4000,-4000
04368P,台積電凱基94售02,0,0,0,0,0,0,0,0,0,-4000,0,0,0,0,4000,-4000,-4000
01010T,京城樂富R1      ,0,4000,-4000,0,0,0,0,0,0,0,0,0,0,0,0,0,-4000
00743,國泰中國A150    ,0,167000,-167000,0,0,0,0,0,0,163000,0,0,0,182000,19000,163000,-4000
055373,聯詠元大97購03  ,0,0,0,0,0,0,0,0,0,-4000,0,0,0,36000,40000,-4000,-4000
055166,台積電統一97購05,0,0,0,0,0,0,0,0,0,-4000,0,0,0,0,4000,-4000,-4000
05692P,聯發科中信9A售02,0,0,0,0,0,0,0,0,0,-4000,0,0,0,31000,35000,-4000,-4000
054632,緯穎凱基9A購01  ,0,0,0,0,0,0,0,0,0,-4000,0,0,0,0,4000,-4000,-4000
053465,聯電元大96購05  ,0,0,0,0,0,0,0,0,0,-4000,0,0,0,1000,5000,-4000,-4000
052452,茂林元大95購03  ,0,0,0,0,0,0,0,0,0,-4000,0,0,0,6000,10000,-4000,-4000
056738,國巨凱基9A購02  ,0,0,0,0,0,0,0,0,0,-4000,0,0,0,0,4000,-4000,-4000
052706,台虹國票97購01  ,0,0,0,0,0,0,0,0,0,-4000,0,0,0,0,4000,-4000,-4000
054343,世紀鋼元富96購02,0,0,0,0,0,0,0,0,0,-4000,0,0,0,8000,12000,-4000,-4000
052867,晶技凱基96購01  ,0,0,0,0,0,0,0,0,0,-4000,0,0,0,53000,57000,-4000,-4000
052998,拓凱康和96購01  ,0,0,0,0,0,0,0,0,0,-4000,0,0,0,1000,5000,-4000,-4000
056192,智邦富邦98購01  ,0,0,0,0,0,0,0,0,0,-4000,0,0,0,248000,252000,-4000,-4000
056405,聯茂群益98購01  ,0,0,0,0,0,0,0,0,0,-4000,0,0,0,17000,21000,-4000,-4000
056342,中工凱基98購01  ,0,0,0,0,0,0,0,0,0,-4000,0,0,0,0,4000,-4000,-4000
055816,新日興國票98購01,0,0,0,0,0,0,0,0,0,-4000,0,0,0,0,4000,-4000,-4000
6172,互億            ,8000,12000,-4000,0,0,0,0,0,0,0,0,0,0,0,0,0,-4000
5284,jpp-KY          ,5000,9000,-4000,0,0,0,0,0,0,0,0,0,0,0,0,0,-4000
3046,建碁            ,2000,6000,-4000,0,0,0,0,0,0,0,0,0,0,0,0,0,-4000
3593,力銘            ,0,4000,-4000,0,0,0,0,0,0,0,0,0,0,0,0,0,-4000
2433,互盛電          ,61000,65000,-4000,0,0,0,0,0,0,0,0,0,0,0,0,0,-4000
1905,華紙            ,344000,348000,-4000,0,0,0,0,0,0,0,0,0,0,0,0,0,-4000
2468,華經            ,8000,12000,-4000,0,0,0,0,0,0,0,0,0,0,0,0,0,-4000
2851,中再保          ,103000,77000,26000,0,0,0,0,0,0,-30000,2000,32000,-30000,0,0,0,-4000
9942,茂順            ,26000,30000,-4000,0,0,0,0,0,0,0,0,0,0,0,0,0,-4000
00733,富邦臺灣中小    ,250,0,250,0,0,0,0,0,0,-5000,0,0,0,218000,223000,-5000,-4750
1530,亞崴            ,0,5000,-5000,0,0,0,0,0,0,0,0,0,0,0,0,0,-5000
1516,川飛            ,4000,9000,-5000,0,0,0,0,0,0,0,0,0,0,0,0,0,-5000
06742P,可成富邦99售02  ,0,0,0,0,0,0,0,0,0,-5000,0,0,0,0,5000,-5000,-5000
06940P,旺宏永豐98售05  ,0,0,0,0,0,0,0,0,0,-5000,0,0,0,0,5000,-5000,-5000
07098P,台積電元大99售18,0,0,0,0,0,0,0,0,0,-5000,0,0,0,50000,55000,-5000,-5000
07103P,南電元大99售04  ,0,0,0,0,0,0,0,0,0,-5000,0,0,0,15000,20000,-5000,-5000
07068P,欣興台新99售01  ,0,0,0,0,0,0,0,0,0,-5000,0,0,0,0,5000,-5000,-5000
06265P,美律凱基97售01  ,0,0,0,0,0,0,0,0,0,-5000,0,0,0,21000,26000,-5000,-5000
06467P,旺宏統一98售01  ,0,0,0,0,0,0,0,0,0,-5000,0,0,0,0,5000,-5000,-5000
06622P,牧德元大98售01  ,0,0,0,0,0,0,0,0,0,-5000,0,0,0,0,5000,-5000,-5000
06680P,智邦元大98售06  ,0,0,0,0,0,0,0,0,0,-5000,0,0,0,316000,321000,-5000,-5000
059143,國巨國票9A購04  ,0,0,0,0,0,0,0,0,0,-5000,0,0,0,0,5000,-5000,-5000
05964P,華通凱基96售06  ,0,0,0,0,0,0,0,0,0,-5000,0,0,0,0,5000,-5000,-5000
05972P,瑞昱元大96售01  ,0,0,0,0,0,0,0,0,0,-5000,0,0,0,35000,40000,-5000,-5000
05974P,國巨富邦97售03  ,0,0,0,0,0,0,0,0,0,-5000,0,0,0,5000,10000,-5000,-5000
06172P,台虹永豐97售02  ,0,0,0,0,0,0,0,0,0,-5000,0,0,0,7000,12000,-5000,-5000
057847,聯茂永豐98購01  ,0,0,0,0,0,0,0,0,0,-5000,0,0,0,91000,96000,-5000,-5000
057819,新日興元大99購01,0,0,0,0,0,0,0,0,0,-5000,0,0,0,25000,30000,-5000,-5000
057781,國巨國票99購04  ,0,0,0,0,0,0,0,0,0,-5000,0,0,0,0,5000,-5000,-5000
057591,鴻海兆豐99購01  ,0,0,0,0,0,0,0,0,0,-5000,0,0,0,0,5000,-5000,-5000
058028,國巨富邦99購04  ,0,0,0,0,0,0,0,0,0,-5000,0,0,0,0,5000,-5000,-5000
058096,南電元大98購04  ,0,0,0,0,0,0,0,0,0,-5000,0,0,0,15000,20000,-5000,-5000
057965,臺股指元大98購14,0,0,0,0,0,0,0,0,0,-5000,0,0,0,238000,243000,-5000,-5000
057880,金融類元大99購02,0,0,0,0,0,0,0,0,0,-5000,0,0,0,0,5000,-5000,-5000
058152,聯發科統一9B購02,0,0,0,0,0,0,0,0,0,-5000,0,0,0,0,5000,-5000,-5000
058208,百和凱基99購01  ,0,0,0,0,0,0,0,0,0,-5000,0,0,0,25000,30000,-5000,-5000
058228,為升元大99購01  ,0,0,0,0,0,0,0,0,0,-5000,0,0,0,0,5000,-5000,-5000
058286,道瓊指國票9B購01,0,0,0,0,0,0,0,0,0,-5000,0,0,0,0,5000,-5000,-5000
058356,華邦電凱基99購01,0,0,0,0,0,0,0,0,0,-5000,0,0,0,0,5000,-5000,-5000
058393,元油2X元大99購13,0,0,0,0,0,0,0,0,0,-5000,0,0,0,0,5000,-5000,-5000
058439,玉晶光統一01購02,0,0,0,0,0,0,0,0,0,-5000,0,0,0,0,5000,-5000,-5000
058485,智邦國票9A購01  ,0,0,0,0,0,0,0,0,0,-5000,0,0,0,0,5000,-5000,-5000
058628,宏達電國票9A購01,0,0,0,0,0,0,0,0,0,-5000,0,0,0,0,5000,-5000,-5000
058605,華邦電元大99購04,0,0,0,0,0,0,0,0,0,-5000,0,0,0,20000,25000,-5000,-5000
059048,元油2X凱基9A購11,0,0,0,0,0,0,0,0,0,-5000,0,0,0,5000,10000,-5000,-5000
058760,嘉晶群益9A購01  ,0,0,0,0,0,0,0,0,0,-5000,0,0,0,6000,11000,-5000,-5000
0052,富邦科技        ,9000,8000,1000,0,0,0,0,0,0,-6000,0,0,0,112000,118000,-6000,-5000
00657,國泰日經225     ,0,0,0,0,0,0,0,0,0,-5000,0,0,0,100000,105000,-5000,-5000
043642,元金2X國票97購01,0,0,0,0,0,0,0,0,0,-5000,0,0,0,295000,300000,-5000,-5000
03012X,元展12          ,0,0,0,0,0,0,0,0,0,-5000,0,0,0,0,5000,-5000,-5000
04463P,可成元富94售03  ,0,0,0,0,0,0,0,0,0,-5000,0,0,0,0,5000,-5000,-5000
03751P,旺宏富邦95售01  ,0,0,0,0,0,0,0,0,0,-5000,0,0,0,0,5000,-5000,-5000
045866,南茂統一94購01  ,0,0,0,0,0,0,0,0,0,-5000,0,0,0,0,5000,-5000,-5000
046242,大立光中信93購02,0,0,0,0,0,0,0,0,0,-5000,0,0,0,0,5000,-5000,-5000
04874P,高股息中信97售01,0,0,0,0,0,0,0,0,0,-5000,0,0,0,101000,106000,-5000,-5000
04724P,可成凱基94售08  ,0,0,0,0,0,0,0,0,0,-5000,0,0,0,10000,15000,-5000,-5000
047529,嘉晶元大94購02  ,0,0,0,0,0,0,0,0,0,-5000,0,0,0,35000,40000,-5000,-5000
050163,群創國泰95購01  ,0,0,0,0,0,0,0,0,0,-5000,0,0,0,0,5000,-5000,-5000
050385,貿聯國票95購02  ,0,0,0,0,0,0,0,0,0,-5000,0,0,0,0,5000,-5000,-5000
050403,台積電麥證94購02,0,0,0,0,5000,-5000,0,0,0,-5000,0,0,0,0,5000,-5000,-5000
05047P,強茂永豐95售02  ,0,0,0,0,0,0,0,0,0,-5000,0,0,0,0,5000,-5000,-5000
050495,大立光永昌96購01,0,0,0,0,0,0,0,0,0,-5000,0,0,0,0,5000,-5000,-5000
051818,國巨統一95購02  ,0,0,0,0,0,0,0,0,0,-5000,0,0,0,0,5000,-5000,-5000
052029,矽力群益95購02  ,0,0,0,0,0,0,0,0,0,-5000,0,0,0,5000,10000,-5000,-5000
05057P,鴻海國票96售01  ,0,0,0,0,0,0,0,0,0,-5000,0,0,0,0,5000,-5000,-5000
049260,華新科元大96購01,0,0,0,0,0,0,0,0,0,-5000,0,0,0,2000,7000,-5000,-5000
05064P,台積電元大95售10,0,0,0,0,0,0,0,0,0,-5000,0,0,0,145000,150000,-5000,-5000
049592,欣興元大96購01  ,0,0,0,0,0,0,0,0,0,-5000,0,0,0,0,5000,-5000,-5000
052097,GIS元大95購05   ,0,0,0,0,0,0,0,0,0,-5000,0,0,0,0,5000,-5000,-5000
05207P,高股息中信97售03,0,0,0,0,0,0,0,0,0,-5000,0,0,0,45000,50000,-5000,-5000
048938,玉晶光永豐95購02,0,0,0,0,0,0,0,0,0,-5000,0,0,0,0,5000,-5000,-5000
051403,玉晶光永豐95購05,0,0,0,0,0,0,0,0,0,-5000,0,0,0,0,5000,-5000,-5000
05135P,鴻海凱基96售07  ,0,0,0,0,0,0,0,0,0,-5000,0,0,0,140000,145000,-5000,-5000
052375,奇力新元大96購02,0,0,0,0,0,0,0,0,0,-5000,0,0,0,0,5000,-5000,-5000
049149,華新科元大95購03,0,0,0,0,0,0,0,0,0,-5000,0,0,0,0,5000,-5000,-5000
049023,玉晶光群益96購04,0,0,0,0,0,0,0,0,0,-5000,0,0,0,190000,195000,-5000,-5000
052243,致茂康和95購01  ,0,0,0,0,0,0,0,0,0,-5000,0,0,0,0,5000,-5000,-5000
055438,鴻海國票98購01  ,0,0,0,0,0,0,0,0,0,-5000,0,0,0,0,5000,-5000,-5000
055854,群創元大98購04  ,0,0,0,0,0,0,0,0,0,-5000,0,0,0,0,5000,-5000,-5000
053069,同欣電群益98購01,0,0,0,0,0,0,0,0,0,-5000,0,0,0,0,5000,-5000,-5000
055698,茂林國票98購03  ,0,0,0,0,0,0,0,0,0,-5000,0,0,0,0,5000,-5000,-5000
053088,奇鋐元大98購01  ,0,0,0,0,0,0,0,0,0,-5000,0,0,0,0,5000,-5000,-5000
056359,旺宏元大9A購01  ,0,0,0,0,0,0,0,0,0,-5000,0,0,0,0,5000,-5000,-5000
05611P,康控群益96售02  ,0,0,0,0,0,0,0,0,0,-5000,0,0,0,0,5000,-5000,-5000
055314,華邦電中信99購01,0,0,0,0,0,0,0,0,0,-5000,0,0,0,0,5000,-5000,-5000
056293,上銀元大97購10  ,0,0,0,0,0,0,0,0,0,-5000,0,0,0,0,5000,-5000,-5000
05664P,國巨凱基96售09  ,0,0,0,0,0,0,0,0,0,-5000,0,0,0,19000,24000,-5000,-5000
056635,亞德客日盛99購01,0,0,0,0,0,0,0,0,0,-5000,0,0,0,0,5000,-5000,-5000
052535,日月光國泰96購01,0,0,0,0,0,0,0,0,0,-5000,0,0,0,0,5000,-5000,-5000
052541,大立光統一95購06,0,0,0,0,0,0,0,0,0,-5000,0,0,0,0,5000,-5000,-5000
052594,友訊群益98購01  ,0,0,0,0,0,0,0,0,0,-5000,0,0,0,15000,20000,-5000,-5000
054397,創意永豐96購05  ,0,0,0,0,0,0,0,0,0,-5000,0,0,0,0,5000,-5000,-5000
052985,美律元大96購02  ,0,0,0,0,0,0,0,0,0,-5000,0,0,0,0,5000,-5000,-5000
052903,致茂國票97購01  ,0,0,0,0,0,0,0,0,0,-5000,0,0,0,5000,10000,-5000,-5000
054336,台積電統一96購11,0,0,0,0,0,0,0,0,0,-5000,0,0,0,30000,35000,-5000,-5000
052707,景碩台新96購01  ,0,0,0,0,0,0,0,0,0,-5000,0,0,0,0,5000,-5000,-5000
054375,貿聯中信99購01  ,0,0,0,0,0,0,0,0,0,-5000,0,0,0,0,5000,-5000,-5000
052633,國巨凱基96購05  ,0,0,0,0,0,0,0,0,0,-5000,0,0,0,0,5000,-5000,-5000
056681,鴻海統一98購09  ,0,0,0,0,0,0,0,0,0,-5000,0,0,0,0,5000,-5000,-5000
054578,世芯元大99購01  ,0,0,0,0,0,0,0,0,0,-5000,0,0,0,0,5000,-5000,-5000
053535,宏達電永豐96購02,0,0,0,0,0,0,0,0,0,-5000,0,0,0,0,5000,-5000,-5000
054996,聯陽元富97購01  ,0,0,0,0,0,0,0,0,0,-5000,0,0,0,0,5000,-5000,-5000
054936,鴻海元大97購10  ,0,0,0,0,0,0,0,0,0,-5000,0,0,0,0,5000,-5000,-5000
054138,晶技元大98購02  ,0,0,0,0,0,0,0,0,0,-5000,0,0,0,2000,7000,-5000,-5000
05402P,台郡永豐95售02  ,0,0,0,0,0,0,0,0,0,-5000,0,0,0,0,5000,-5000,-5000
053905,華新科凱基96購10,0,0,0,0,0,0,0,0,0,-5000,0,0,0,0,5000,-5000,-5000
053869,嘉澤元大96購02  ,0,0,0,0,0,0,0,0,0,-5000,0,0,0,0,5000,-5000,-5000
057009,信邦中信99購01  ,0,0,0,0,0,0,0,0,0,-5000,0,0,0,0,5000,-5000,-5000
054763,宏達電國票99購01,0,0,0,0,0,0,0,0,0,-5000,0,0,0,0,5000,-5000,-5000
055243,國巨統一97購04  ,0,0,0,0,0,0,0,0,0,-5000,0,0,0,0,5000,-5000,-5000
057329,緯穎群益98購02  ,0,0,0,0,0,0,0,0,0,-5000,0,0,0,0,5000,-5000,-5000
057251,泰鼎統一98購02  ,0,0,0,0,0,0,0,0,0,-5000,0,0,0,0,5000,-5000,-5000
057115,元油2X日盛9A購01,0,0,0,0,0,0,0,0,0,-5000,0,0,0,0,5000,-5000,-5000
057112,立積群益99購01  ,0,0,0,0,0,0,0,0,0,-5000,0,0,0,0,5000,-5000,-5000
057198,智伸科統一9B購01,0,0,0,0,0,0,0,0,0,-5000,0,0,0,0,5000,-5000,-5000
6655,科定            ,1000,6000,-5000,0,0,0,0,0,0,0,0,0,0,0,0,0,-5000
8033,雷虎            ,8000,13000,-5000,0,0,0,0,0,0,0,0,0,0,0,0,0,-5000
2597,潤弘            ,10000,15000,-5000,0,0,0,0,0,0,0,0,0,0,0,0,0,-5000
3296,勝德            ,0,9000,-9000,0,0,0,0,0,0,4000,4000,0,4000,0,0,0,-5000
2901,欣欣            ,2000,2000,0,0,0,0,0,0,0,-5000,0,5000,-5000,0,0,0,-5000
4555,氣立            ,5000,10000,-5000,0,0,0,0,0,0,0,0,0,0,0,0,0,-5000
058875,台表科國票9A購02,0,0,0,0,0,0,0,0,0,-6000,0,0,0,0,6000,-6000,-6000
059007,南電元大99購05  ,0,0,0,0,0,0,0,0,0,-6000,0,0,0,0,6000,-6000,-6000
059071,元油2X元大9C購12,0,0,0,0,0,0,0,0,0,-6000,0,0,0,0,6000,-6000,-6000
058566,聯發科凱基9A購02,0,0,0,0,0,0,0,0,0,-6000,0,0,0,3000,9000,-6000,-6000
058523,聯茂元大99購08  ,0,0,0,0,0,0,0,0,0,-6000,0,0,0,0,6000,-6000,-6000
058247,聯茂元大99購04  ,0,0,0,0,0,0,0,0,0,-6000,0,0,0,75000,81000,-6000,-6000
057595,健鼎兆豐98購01  ,0,0,0,0,0,0,0,0,0,-6000,0,0,0,0,6000,-6000,-6000
057558,致新凱基98購01  ,0,0,0,0,0,0,0,0,0,-6000,0,0,0,0,6000,-6000,-6000
06225P,華新科元富97售04,0,0,0,0,0,0,0,0,0,-6000,0,0,0,24000,30000,-6000,-6000
05914P,友達元大96售04  ,0,0,0,0,0,0,0,0,0,-6000,0,0,0,0,6000,-6000,-6000
06673P,大立光群益98售01,0,0,0,0,0,0,0,0,0,-6000,0,0,0,0,6000,-6000,-6000
06685P,鴻海國泰9A售01  ,0,0,0,0,0,0,0,0,0,-6000,0,0,0,5000,11000,-6000,-6000
06587P,國巨元大98售13  ,0,0,0,0,0,0,0,0,0,-6000,0,0,0,4000,10000,-6000,-6000
06261P,上銀凱基97售03  ,0,0,0,0,0,0,0,0,0,-6000,0,0,0,52000,58000,-6000,-6000
06305P,臺股指元大97售11,0,0,0,0,0,0,0,0,0,-6000,0,0,0,0,6000,-6000,-6000
1587,吉茂            ,1000,7000,-6000,0,0,0,0,0,0,0,0,0,0,0,0,0,-6000
1459,聯發            ,0,6000,-6000,0,0,0,0,0,0,0,0,0,0,0,0,0,-6000
1236,宏亞            ,0,6000,-6000,0,0,0,0,0,0,0,0,0,0,0,0,0,-6000
055688,力成凱基98購02  ,0,0,0,0,0,0,0,0,0,-6000,0,0,0,0,6000,-6000,-6000
055713,國巨元大98購09  ,0,0,0,0,0,0,0,0,0,-6000,0,0,0,10000,16000,-6000,-6000
055522,道瓊反群益01購01,0,0,0,0,0,0,0,0,0,-6000,0,0,0,4000,10000,-6000,-6000
051383,京鼎群益96購02  ,0,0,0,0,0,0,0,0,0,-6000,0,0,0,0,6000,-6000,-6000
051784,國巨兆豐95購01  ,0,0,0,0,0,0,0,0,0,-6000,0,0,0,0,6000,-6000,-6000
050692,鴻海凱基96購04  ,0,0,0,0,0,0,0,0,0,-6000,0,0,0,0,6000,-6000,-6000
049387,緯穎元大94購03  ,0,0,0,0,0,0,0,0,0,-6000,0,0,0,4000,10000,-6000,-6000
049630,臺股指群益94購03,0,0,0,0,0,0,0,0,0,-6000,0,0,0,0,6000,-6000,-6000
051907,台積電元大97購05,0,0,0,0,0,0,0,0,0,-6000,0,0,0,6000,12000,-6000,-6000
050256,臺指反元大98購03,0,0,0,0,0,0,0,0,0,-6000,0,0,0,20000,26000,-6000,-6000
03993P,滬深2X中信94售03,0,0,0,0,0,0,0,0,0,-6000,0,0,0,10000,16000,-6000,-6000
048541,緯穎台新93購01  ,0,0,0,0,0,0,0,0,0,-6000,0,0,0,0,6000,-6000,-6000
03052X,元展49          ,0,0,0,0,0,0,0,0,0,-6000,0,0,0,0,6000,-6000,-6000
00682U,元大美元指數    ,0,0,0,0,0,0,0,0,0,-6000,0,0,0,4000,10000,-6000,-6000
00742,新光內需收益    ,0,1000,-1000,0,0,0,0,0,0,-5000,0,0,0,2000,7000,-5000,-6000
055056,億光永豐97購01  ,0,0,0,0,0,0,0,0,0,-6000,0,0,0,0,6000,-6000,-6000
054759,台化國票98購01  ,0,0,0,0,0,0,0,0,0,-6000,0,0,0,0,6000,-6000,-6000
053703,緯穎兆豐96購01  ,0,0,0,0,0,0,0,0,0,-6000,0,0,0,5000,11000,-6000,-6000
054896,聯茂日盛97購01  ,0,0,0,0,0,0,0,0,0,-6000,0,0,0,0,6000,-6000,-6000
054679,台積電康和99購01,0,0,0,0,0,0,0,0,0,-6000,0,0,0,0,6000,-6000,-6000
05246P,南電元大95售04  ,0,0,0,0,0,0,0,0,0,-6000,0,0,0,84000,90000,-6000,-6000
052744,聯詠元大97購01  ,0,0,0,0,0,0,0,0,0,-6000,0,0,0,0,6000,-6000,-6000
05432P,國巨元富95售07  ,0,0,0,0,0,0,0,0,0,-6000,0,0,0,0,6000,-6000,-6000
052979,上銀元大96購02  ,0,0,0,0,0,0,0,0,0,-6000,0,0,0,0,6000,-6000,-6000
056600,聯茂元富98購01  ,0,0,0,0,0,0,0,0,0,-6000,0,0,0,0,6000,-6000,-6000
055301,台虹元大97購01  ,0,0,0,0,0,0,0,0,0,-6000,0,0,0,0,6000,-6000,-6000
054224,亞光統一98購01  ,0,0,0,0,0,0,0,0,0,-6000,0,0,0,0,6000,-6000,-6000
056118,聯詠群益97購03  ,0,0,0,0,0,0,0,0,0,-6000,0,0,0,0,6000,-6000,-6000
056095,臻鼎元富9A購01  ,0,0,0,0,0,0,0,0,0,-6000,0,0,0,41000,47000,-6000,-6000
5538,東明-KY         ,0,6000,-6000,0,0,0,0,0,0,0,0,0,0,0,0,0,-6000
2936,客思達-KY       ,4000,10000,-6000,0,0,0,0,0,0,0,0,0,0,0,0,0,-6000
2543,皇昌            ,0,6000,-6000,0,0,0,0,0,0,0,0,0,0,0,0,0,-6000
2739,寒舍            ,0,6000,-6000,0,0,0,0,0,0,0,0,0,0,0,0,0,-6000
2362,藍天            ,167000,186000,-19000,0,0,0,0,0,0,13000,14000,1000,13000,0,0,0,-6000
8442,威宏-KY         ,15000,21000,-6000,0,0,0,0,0,0,0,0,0,0,0,0,0,-6000
6558,興能高          ,451000,279000,172000,0,0,0,0,178000,-178000,0,0,0,0,0,0,0,-6000
1110,東泥            ,0,7000,-7000,0,0,0,0,0,0,0,0,0,0,0,0,0,-7000
1414,東和            ,21000,29000,-8000,0,0,0,0,0,0,1000,1000,0,1000,0,0,0,-7000
07138P,台灣50群益9B售04,0,0,0,0,0,0,0,0,0,-7000,0,0,0,11000,18000,-7000,-7000
07149P,健鼎元大99售03  ,0,0,0,0,0,0,0,0,0,-7000,0,0,0,0,7000,-7000,-7000
07051P,大立光中信99售02,0,0,0,0,0,0,0,0,0,-7000,0,0,0,0,7000,-7000,-7000
06337P,祥碩元大97售05  ,0,0,0,0,0,0,0,0,0,-7000,0,0,0,280000,287000,-7000,-7000
06714P,台積電元大98售15,0,0,0,0,0,0,0,0,0,-7000,0,0,0,142000,149000,-7000,-7000
06060P,玉晶光元大97售03,0,0,0,0,0,0,0,0,0,-7000,0,0,0,122000,129000,-7000,-7000
057673,臻鼎元大98購01  ,0,0,0,0,0,0,0,0,0,-7000,0,0,0,165000,172000,-7000,-7000
058059,晶技元富98購01  ,0,0,0,0,0,0,0,0,0,-7000,0,0,0,3000,10000,-7000,-7000
058574,台積電群益99購03,0,0,0,0,0,0,0,0,0,-7000,0,0,0,0,7000,-7000,-7000
058624,台積電國票99購09,0,0,0,0,0,0,0,0,0,-7000,0,0,0,0,7000,-7000,-7000
058415,祥碩兆豐99購01  ,0,0,0,0,0,0,0,0,0,-7000,0,0,0,0,7000,-7000,-7000
058322,玉晶光永豐99購02,0,0,0,0,0,0,0,0,0,-7000,0,0,0,13000,20000,-7000,-7000
00712,FH富時不動產    ,2000,0,2000,0,0,0,0,0,0,-9000,0,0,0,100000,109000,-9000,-7000
03077X,元展72          ,0,0,0,0,0,0,0,0,0,-7000,0,0,0,0,7000,-7000,-7000
04464P,可成元富94售04  ,0,0,0,0,0,0,0,0,0,-7000,0,0,0,0,7000,-7000,-7000
051856,亞德客凱基95購01,0,0,0,0,0,0,0,0,0,-7000,0,0,0,0,7000,-7000,-7000
04795P,聯發科元大94售09,0,0,0,0,0,0,0,0,0,-7000,0,0,0,34000,41000,-7000,-7000
050006,華擎永豐94購03  ,0,0,0,0,0,0,0,0,0,-7000,0,0,0,29000,36000,-7000,-7000
052083,S&P反1元大97購02,0,0,0,0,0,0,0,0,0,-7000,0,0,0,0,7000,-7000,-7000
05123P,鴻海永昌96售07  ,0,0,0,0,0,0,0,0,0,-7000,0,0,0,0,7000,-7000,-7000
04918P,華新科凱基94售12,0,0,0,0,0,0,0,0,0,-7000,0,0,0,0,7000,-7000,-7000
05603P,聯發科元大96售09,0,0,0,0,0,0,0,0,0,-7000,0,0,0,0,7000,-7000,-7000
052736,T50反1元大96購05,0,0,0,0,0,0,0,0,0,-7000,0,0,0,3000,10000,-7000,-7000
056816,華通永豐98購02  ,0,0,0,0,0,0,0,0,0,-7000,0,0,0,0,7000,-7000,-7000
054049,亞光元大96購03  ,0,0,0,0,0,0,0,0,0,-7000,0,0,0,3000,10000,-7000,-7000
057056,立積元大99購02  ,0,0,0,0,0,0,0,0,0,-7000,0,0,0,3000,10000,-7000,-7000
057230,建準凱基98購02  ,0,0,0,0,0,0,0,0,0,-7000,0,0,0,20000,27000,-7000,-7000
6464,台數科          ,0,7000,-7000,0,0,0,0,0,0,0,0,0,0,0,0,0,-7000
8367,建新國際        ,6000,13000,-7000,0,0,0,0,0,0,0,0,0,0,0,0,0,-7000
8072,陞泰            ,1000,10000,-9000,0,0,0,0,0,0,2000,2000,0,2000,0,0,0,-7000
8201,無敵            ,0,7000,-7000,0,0,0,0,0,0,0,0,0,0,0,0,0,-7000
9931,欣高            ,0,7000,-7000,0,0,0,0,0,0,0,0,0,0,0,0,0,-7000
2007,燁興            ,2000,9000,-7000,0,0,0,0,0,0,0,0,0,0,0,0,0,-7000
2239,英利-KY         ,26000,33000,-7000,0,0,0,0,0,0,0,0,0,0,0,0,0,-7000
2712,遠雄來          ,3000,10000,-7000,0,0,0,0,0,0,0,0,0,0,0,0,0,-7000
2838A,聯邦銀甲特      ,0,9000,-9000,0,0,0,0,0,0,2000,4000,2000,2000,0,0,0,-7000
3701,大眾控          ,0,7000,-7000,0,0,0,0,0,0,0,0,0,0,0,0,0,-7000
4720,德淵            ,4000,11000,-7000,0,0,0,0,0,0,0,0,0,0,0,0,0,-7000
058719,智邦元富99購01  ,0,0,0,0,0,0,0,0,0,-8000,0,0,0,52000,60000,-8000,-8000
058050,台郡元大99購05  ,0,0,0,0,0,0,0,0,0,-8000,0,0,0,0,8000,-8000,-8000
057409,台虹群益98購02  ,0,0,0,0,0,0,0,0,0,-8000,0,0,0,3000,11000,-8000,-8000
05743P,創意元大96售01  ,0,0,0,0,0,0,0,0,0,-8000,0,0,0,0,8000,-8000,-8000
07095P,台灣50元大9C售03,0,0,0,0,0,0,0,0,0,-8000,0,0,0,2000,10000,-8000,-8000
06896P,信邦中信98售01  ,0,0,0,0,0,0,0,0,0,-8000,0,0,0,2000,10000,-8000,-8000
07147P,高鐵元大99售01  ,0,0,0,0,0,0,0,0,0,-8000,0,0,0,0,8000,-8000,-8000
07126P,台積電元大99售23,0,0,0,0,0,0,0,0,0,-8000,0,0,0,110000,118000,-8000,-8000
07189P,聯發科富邦9B售03,0,0,0,0,0,0,0,0,0,-8000,0,0,0,0,8000,-8000,-8000
1231,聯華食          ,62000,70000,-8000,0,0,0,0,0,0,0,0,0,0,0,0,0,-8000
049128,滬深2X元大97購03,0,0,0,0,0,0,0,0,0,-8000,0,0,0,0,8000,-8000,-8000
051416,創意國票96購02  ,0,0,0,0,0,0,0,0,0,-8000,0,0,0,12000,20000,-8000,-8000
051126,訊連群益95購01  ,0,0,0,0,0,0,0,0,0,-8000,0,0,0,0,8000,-8000,-8000
050028,華新科元大94購03,0,0,0,0,0,0,0,0,0,-8000,0,0,0,40000,48000,-8000,-8000
049784,台積電兆豐94購05,0,0,0,0,0,0,0,0,0,-8000,0,0,0,519000,527000,-8000,-8000
049346,新光金統一95購01,0,0,0,0,0,0,0,0,0,-8000,0,0,0,2000,10000,-8000,-8000
04703P,樺漢統一95售01  ,0,0,0,0,0,0,0,0,0,-8000,0,0,0,2000,10000,-8000,-8000
054056,華新科國票96購02,0,0,0,0,0,0,0,0,0,-8000,0,0,0,0,8000,-8000,-8000
052493,上証2X中信97購02,0,0,0,0,0,0,0,0,0,-8000,0,0,0,17000,25000,-8000,-8000
056159,牧德凱基99購01  ,0,0,0,0,0,0,0,0,0,-8000,0,0,0,2000,10000,-8000,-8000
056061,國泰金元大97購02,0,0,0,0,0,0,0,0,0,-8000,0,0,0,2000,10000,-8000,-8000
056404,嘉聯益群益9A購01,0,0,0,0,0,0,0,0,0,-8000,0,0,0,0,8000,-8000,-8000
5283,禾聯碩          ,32000,35000,-3000,0,0,0,0,0,0,-5000,1000,0,1000,0,6000,-6000,-8000
3501,維熹            ,35000,48000,-13000,0,0,0,0,0,0,5000,5000,0,5000,0,0,0,-8000
2466,冠西電          ,11000,22000,-11000,0,0,0,0,0,0,3000,3000,0,3000,0,0,0,-8000
1219,福壽            ,3000,13000,-10000,0,0,0,0,0,0,1000,2000,1000,1000,0,0,0,-9000
1432,大魯閣          ,0,9000,-9000,0,0,0,0,0,0,0,0,0,0,0,0,0,-9000
1309,台達化          ,225000,106000,119000,0,0,0,0,130000,-130000,2000,2000,0,2000,0,0,0,-9000
1810,和成            ,45000,56000,-11000,0,0,0,0,0,0,2000,2000,0,2000,0,0,0,-9000
1724,台硝            ,2000,12000,-10000,0,0,0,0,0,0,1000,1000,0,1000,0,0,0,-9000
07105P,大毅元富99售02  ,0,0,0,0,0,0,0,0,0,-9000,0,0,0,17000,26000,-9000,-9000
06103P,漢唐凱基97售02  ,0,0,0,0,0,0,0,0,0,-9000,0,0,0,0,9000,-9000,-9000
06657P,寶成元大98售01  ,0,0,0,0,0,0,0,0,0,-9000,0,0,0,20000,29000,-9000,-9000
058114,台積電第一01購01,0,0,0,0,0,0,0,0,0,-9000,0,0,0,5000,14000,-9000,-9000
00731,FH富時高息低波  ,7000,7000,0,0,0,0,0,140000,-140000,131000,0,0,0,292000,161000,131000,-9000
03010X,元展10          ,0,0,0,0,0,0,0,0,0,-9000,0,0,0,2000,11000,-9000,-9000
0057,富邦摩台        ,0,0,0,0,0,0,0,0,0,-9000,0,0,0,21000,30000,-9000,-9000
049274,臺股指元大94購09,0,0,0,0,0,0,0,0,0,-9000,0,0,0,0,9000,-9000,-9000
049864,聯發科兆豐94購01,0,0,0,0,0,0,0,0,0,-9000,0,0,0,1000,10000,-9000,-9000
052237,嘉澤國票96購02  ,0,0,0,0,0,0,0,0,0,-9000,0,0,0,1000,10000,-9000,-9000
056582,易華電元大98購01,0,0,0,0,0,0,0,0,0,-9000,0,0,0,11000,20000,-9000,-9000
056555,矽創凱基98購01  ,0,0,0,0,0,0,0,0,0,-9000,0,0,0,30000,39000,-9000,-9000
053181,滬深2X元富99購02,0,0,0,0,0,0,0,0,0,-9000,0,0,0,6000,15000,-9000,-9000
052807,貿聯元大98購01  ,0,0,0,0,0,0,0,0,0,-9000,0,0,0,6000,15000,-9000,-9000
053947,義隆富邦97購01  ,0,0,0,0,0,0,0,0,0,-9000,0,0,0,4000,13000,-9000,-9000
053855,康友國泰98購01  ,0,0,0,0,0,0,0,0,0,-9000,0,0,0,31000,40000,-9000,-9000
057388,奇鋐永豐98購02  ,0,0,0,0,0,0,0,0,0,-9000,0,0,0,0,9000,-9000,-9000
2444,兆勁            ,57000,66000,-9000,0,0,0,0,0,0,0,0,0,0,0,0,0,-9000
2495,普安            ,76000,92000,-16000,0,0,0,0,0,0,7000,7000,0,7000,0,0,0,-9000
2115,六暉-KY         ,9000,18000,-9000,0,0,0,0,0,0,0,0,0,0,0,0,0,-9000
2008,高興昌          ,0,9000,-9000,0,0,0,0,0,0,0,0,0,0,0,0,0,-9000
2359,所羅門          ,143000,157000,-14000,0,0,0,0,0,0,5000,5000,0,5000,0,0,0,-9000
3027,盛達            ,22000,33000,-11000,0,0,0,0,0,0,2000,2000,0,2000,0,0,0,-9000
8462,柏文            ,69000,48000,21000,0,0,0,0,30000,-30000,0,0,0,0,0,0,0,-9000
6671,三能-KY         ,8000,17000,-9000,0,0,0,0,0,0,0,0,0,0,0,0,0,-9000
058051,同欣電元大98購03,0,0,0,0,0,0,0,0,0,-10000,0,0,0,0,10000,-10000,-10000
058037,台灣50元大9B購02,0,0,0,0,0,0,0,0,0,-10000,0,0,0,0,10000,-10000,-10000
057970,國巨富邦99購03  ,0,0,0,0,0,0,0,0,0,-10000,0,0,0,0,10000,-10000,-10000
057974,上銀永豐98購02  ,0,0,0,0,0,0,0,0,0,-10000,0,0,0,0,10000,-10000,-10000
057958,禾伸堂元大99購05,0,0,0,0,0,0,0,0,0,-10000,0,0,0,0,10000,-10000,-10000
057954,宏碁元大99購01  ,0,0,0,0,0,0,0,0,0,-10000,0,0,0,85000,95000,-10000,-10000
057955,技嘉元大98購07  ,0,0,0,0,0,0,0,0,0,-10000,0,0,0,0,10000,-10000,-10000
058262,大立光富邦9C購02,0,0,0,0,0,0,0,0,0,-10000,0,0,0,0,10000,-10000,-10000
058239,景碩元大99購03  ,0,0,0,0,0,0,0,0,0,-10000,0,0,0,0,10000,-10000,-10000
058240,景碩元大99購04  ,0,0,0,0,0,0,0,0,0,-10000,0,0,0,0,10000,-10000,-10000
058295,欣興凱基99購02  ,0,0,0,0,0,0,0,0,0,-10000,0,0,0,0,10000,-10000,-10000
058315,TPK富邦9C購01   ,0,0,0,0,0,0,0,0,0,-10000,0,0,0,0,10000,-10000,-10000
058312,大毅國泰9B購01  ,0,0,0,0,0,0,0,0,0,-10000,0,0,0,20000,30000,-10000,-10000
058218,緯穎群益99購01  ,0,0,0,0,0,0,0,0,0,-10000,0,0,0,0,10000,-10000,-10000
058149,百和元大99購02  ,0,0,0,0,0,0,0,0,0,-10000,0,0,0,0,10000,-10000,-10000
058140,臻鼎元大99購02  ,0,0,0,0,0,0,0,0,0,-10000,0,0,0,50000,60000,-10000,-10000
058120,台灣50國票99購03,0,0,0,0,0,0,0,0,0,-10000,0,0,0,0,10000,-10000,-10000
058145,聯茂元大99購03  ,0,0,0,0,0,0,0,0,0,-10000,0,0,0,20000,30000,-10000,-10000
057429,華新科兆豐98購03,0,0,0,0,0,0,0,0,0,-10000,0,0,0,0,10000,-10000,-10000
057410,南電群益98購01  ,0,0,0,0,0,0,0,0,0,-10000,0,0,0,0,10000,-10000,-10000
057404,貿聯群益99購01  ,0,0,0,0,0,0,0,0,0,-10000,0,0,0,0,10000,-10000,-10000
057426,元油2X兆豐9B購01,0,0,0,0,0,0,0,0,0,-10000,0,0,0,0,10000,-10000,-10000
057427,華通兆豐99購01  ,0,0,0,0,0,0,0,0,0,-10000,0,0,0,0,10000,-10000,-10000
057530,奇鋐元大99購01  ,0,0,0,0,0,0,0,0,0,-10000,0,0,0,20000,30000,-10000,-10000
057616,聯電凱基99購01  ,0,0,0,0,0,0,0,0,0,-10000,0,0,0,0,10000,-10000,-10000
057590,元油2X兆豐98購02,0,0,0,0,0,0,0,0,0,-10000,0,0,0,0,10000,-10000,-10000
057581,元大金中信9A購01,0,0,0,0,0,0,0,0,0,-10000,0,0,0,0,10000,-10000,-10000
057674,台郡元大99購03  ,0,0,0,0,0,0,0,0,0,-10000,0,0,0,10000,20000,-10000,-10000
057668,華新科元大9A購01,0,0,0,0,0,0,0,0,0,-10000,0,0,0,0,10000,-10000,-10000
057657,國巨兆豐98購04  ,0,0,0,0,0,0,0,0,0,-10000,0,0,0,0,10000,-10000,-10000
057666,奇力新元大9A購01,0,0,0,0,0,0,0,0,0,-10000,0,0,0,0,10000,-10000,-10000
057644,奇力新元大98購04,0,0,0,0,0,0,0,0,0,-10000,0,0,0,0,10000,-10000,-10000
057707,臺股指群益98購07,0,0,0,0,0,0,0,0,0,-10000,0,0,0,0,10000,-10000,-10000
05770P,聯發科凱基96售16,0,0,0,0,0,0,0,0,0,-10000,0,0,0,15000,25000,-10000,-10000
057728,瑞昱國泰99購01  ,0,0,0,0,0,0,0,0,0,-10000,0,0,0,0,10000,-10000,-10000
057850,上銀兆豐99購02  ,0,0,0,0,0,0,0,0,0,-10000,0,0,0,0,10000,-10000,-10000
057833,聯發科元富02購06,0,0,0,0,0,0,0,0,0,-10000,0,0,0,0,10000,-10000,-10000
057845,晶相光永豐98購03,0,0,0,0,0,0,0,0,0,-10000,0,0,0,0,10000,-10000,-10000
058751,南茂凱基9A購01  ,0,0,0,0,0,0,0,0,0,-10000,0,0,0,0,10000,-10000,-10000
058764,康友群益99購01  ,0,0,0,0,0,0,0,0,0,-10000,0,0,0,0,10000,-10000,-10000
058792,鴻海元大99購18  ,0,0,0,0,0,0,0,0,0,-10000,0,0,0,39000,49000,-10000,-10000
058793,鴻海元大99購19  ,0,0,0,0,0,0,0,0,0,-10000,0,0,0,15000,25000,-10000,-10000
058796,可成元大99購04  ,0,0,0,0,0,0,0,0,0,-10000,0,0,0,0,10000,-10000,-10000
058852,貿聯群益99購04  ,0,0,0,0,0,0,0,0,0,-10000,0,0,0,0,10000,-10000,-10000
058802,矽創元大99購02  ,0,0,0,0,0,0,0,0,0,-10000,0,0,0,0,10000,-10000,-10000
058811,台積電統一9A購05,0,0,0,0,0,0,0,0,0,-10000,0,0,0,0,10000,-10000,-10000
059045,高股息凱基99購01,0,0,0,0,0,0,0,0,0,-10000,0,0,0,0,10000,-10000,-10000
059066,道瓊指國票04購01,0,0,0,0,0,0,0,0,0,-10000,0,0,0,0,10000,-10000,-10000
059063,康控凱基99購04  ,0,0,0,0,0,0,0,0,0,-10000,0,0,0,0,10000,-10000,-10000
059083,華通元大99購07  ,0,0,0,0,0,0,0,0,0,-10000,0,0,0,0,10000,-10000,-10000
059085,鴻海元大99購25  ,0,0,0,0,0,0,0,0,0,-10000,0,0,0,12000,22000,-10000,-10000
059008,鈺齊元大99購03  ,0,0,0,0,0,0,0,0,0,-10000,0,0,0,0,10000,-10000,-10000
059001,聯發科元大99購17,0,0,0,0,0,0,0,0,0,-10000,0,0,0,73000,83000,-10000,-10000
059022,聯發科統一9B購04,0,0,0,0,0,0,0,0,0,-10000,0,0,0,0,10000,-10000,-10000
058980,鴻海凱基99購06  ,0,0,0,0,0,0,0,0,0,-10000,0,0,0,33000,43000,-10000,-10000
058923,華新科元富99購06,0,0,0,0,0,0,0,0,0,-10000,0,0,0,0,10000,-10000,-10000
058906,晶相光元大99購01,0,0,0,0,0,0,0,0,0,-10000,0,0,0,0,10000,-10000,-10000
058907,健策元大99購04  ,0,0,0,0,0,0,0,0,0,-10000,0,0,0,0,10000,-10000,-10000
058414,大立光兆豐99購02,0,0,0,0,0,0,0,0,0,-10000,0,0,0,0,10000,-10000,-10000
058424,滬深2X元富99購04,0,0,0,0,0,0,0,0,0,-10000,0,0,0,0,10000,-10000,-10000
058425,S&P正2元富01購02,0,0,0,0,0,0,0,0,0,-10000,0,0,0,0,10000,-10000,-10000
058434,旺宏統一9B購01  ,0,0,0,0,0,0,0,0,0,-10000,0,0,0,0,10000,-10000,-10000
058483,道瓊指國票9A購01,0,0,0,0,0,0,0,0,0,-10000,0,0,0,0,10000,-10000,-10000
058510,全新元大9B購02  ,0,0,0,0,0,0,0,0,0,-10000,0,0,0,2000,12000,-10000,-10000
058498,世紀鋼群益99購01,0,0,0,0,0,0,0,0,0,-10000,0,0,0,0,10000,-10000,-10000
058495,元大金群益9B購01,0,0,0,0,0,0,0,0,0,-10000,0,0,0,0,10000,-10000,-10000
058502,鴻海元大99購13  ,0,0,0,0,0,0,0,0,0,-10000,0,0,0,60000,70000,-10000,-10000
058633,台灣50兆豐99購01,0,0,0,0,0,0,0,0,0,-10000,0,0,0,0,10000,-10000,-10000
058645,康控富邦01購01  ,0,0,0,0,0,0,0,0,0,-10000,0,0,0,0,10000,-10000,-10000
058702,國巨元大99購16  ,0,0,0,0,0,0,0,0,0,-10000,0,0,0,0,10000,-10000,-10000
058573,鴻海群益9A購02  ,0,0,0,0,0,0,0,0,0,-10000,0,0,0,0,10000,-10000,-10000
058599,T50反1元大99購05,0,0,0,0,0,0,0,0,0,-10000,0,0,0,0,10000,-10000,-10000
058516,健鼎元大99購02  ,0,0,0,0,0,0,0,0,0,-10000,0,0,0,0,10000,-10000,-10000
058519,嘉澤元大99購01  ,0,0,0,0,0,0,0,0,0,-10000,0,0,0,70000,80000,-10000,-10000
058533,玉晶光元富99購01,0,0,0,0,0,0,0,0,0,-10000,0,0,0,0,10000,-10000,-10000
06602P,國巨統一99售02  ,0,0,0,0,0,0,0,0,0,-10000,0,0,0,0,10000,-10000,-10000
06603P,立積統一99售01  ,0,0,0,0,0,0,0,0,0,-10000,0,0,0,0,10000,-10000,-10000
06535P,可成群益99售02  ,0,0,0,0,0,0,0,0,0,-10000,0,0,0,0,10000,-10000,-10000
06450P,聯發科元大98售03,0,0,0,0,0,0,0,0,0,-10000,0,0,0,58000,68000,-10000,-10000
06111P,上銀兆豐98售01  ,0,0,0,0,0,0,0,0,0,-10000,0,0,0,0,10000,-10000,-10000
06076P,大立光凱基98售03,0,0,0,0,0,0,0,0,0,-10000,0,0,0,45000,55000,-10000,-10000
059176,臺股指凱基99購27,0,0,0,0,0,0,0,0,0,-10000,0,0,0,0,10000,-10000,-10000
059207,臺指反元大9C購02,1000,0,1000,0,0,0,0,0,0,-11000,0,0,0,0,11000,-11000,-10000
059183,T50反1台新03購02,0,0,0,0,0,0,0,0,0,-10000,0,0,0,99000,109000,-10000,-10000
059120,致伸永豐99購01  ,0,0,0,0,0,0,0,0,0,-10000,0,0,0,0,10000,-10000,-10000
059107,南茂國泰9A購01  ,0,0,0,0,0,0,0,0,0,-10000,0,0,0,0,10000,-10000,-10000
059118,晶技永豐9A購01  ,0,0,0,0,0,0,0,0,0,-10000,0,0,0,0,10000,-10000,-10000
059122,超眾永豐99購01  ,0,0,0,0,0,0,0,0,0,-10000,0,0,0,0,10000,-10000,-10000
05929P,宏達電康和96售01,0,0,0,0,0,0,0,0,0,-10000,0,0,0,10000,20000,-10000,-10000
05943P,欣興凱基96售03  ,0,0,0,0,0,0,0,0,0,-10000,0,0,0,0,10000,-10000,-10000
059223,大立光元大99購14,0,0,0,0,0,0,0,0,0,-10000,0,0,0,0,10000,-10000,-10000
07107P,臺股指統一99售07,0,0,0,0,0,0,0,0,0,-10000,0,0,0,0,10000,-10000,-10000
07042P,T50反1元大9C售02,0,0,0,0,0,0,0,0,0,-10000,0,0,0,0,10000,-10000,-10000
06953P,景碩統一9A售01  ,0,0,0,0,0,0,0,0,0,-10000,0,0,0,0,10000,-10000,-10000
06752P,訊芯凱基98售05  ,0,0,0,0,0,0,0,0,0,-10000,0,0,0,0,10000,-10000,-10000
06728P,全新元大98售03  ,0,0,0,0,0,0,0,0,0,-10000,0,0,0,20000,30000,-10000,-10000
06723P,台灣50麥證99售01,0,0,0,0,10000,-10000,0,0,0,-10000,0,0,0,0,10000,-10000,-10000
06776P,鴻海元大99售05  ,0,0,0,0,0,0,0,0,0,-10000,0,0,0,90000,100000,-10000,-10000
1725,元禎            ,0,10000,-10000,0,0,0,0,0,0,0,0,0,0,0,0,0,-10000
1612,宏泰            ,47000,59000,-12000,0,0,0,0,0,0,2000,2000,0,2000,0,0,0,-10000
1474,弘裕            ,32000,44000,-12000,0,0,0,0,0,0,2000,3000,1000,2000,0,0,0,-10000
1220,台榮            ,21000,34000,-13000,0,0,0,0,0,0,3000,3000,0,3000,0,0,0,-10000
052324,康友元大96購02  ,0,0,0,0,0,0,0,0,0,-10000,0,0,0,10000,20000,-10000,-10000
049036,燿華兆豐95購01  ,0,0,0,0,0,0,0,0,0,-10000,0,0,0,0,10000,-10000,-10000
049010,台表科麥證95購01,0,0,0,0,10000,-10000,0,0,0,-10000,0,0,0,0,10000,-10000,-10000
049017,旺宏群益96購03  ,0,0,0,0,0,0,0,0,0,-10000,0,0,0,0,10000,-10000,-10000
048983,牧德元大95購01  ,0,0,0,0,0,0,0,0,0,-10000,0,0,0,10000,20000,-10000,-10000
04916P,大立光永昌96售02,0,0,0,0,0,0,0,0,0,-10000,0,0,0,0,10000,-10000,-10000
049117,矽格統一96購01  ,0,0,0,0,0,0,0,0,0,-10000,0,0,0,0,10000,-10000,-10000
050987,台泥富邦95購01  ,0,0,0,0,0,0,0,0,0,-10000,0,0,0,0,10000,-10000,-10000
051003,中環中信97購01  ,0,0,0,0,0,0,0,0,0,-10000,0,0,0,0,10000,-10000,-10000
051415,晶技國票96購01  ,0,0,0,0,0,0,0,0,0,-10000,0,0,0,0,10000,-10000,-10000
051592,健策元大96購05  ,0,0,0,0,0,0,0,0,0,-10000,0,0,0,0,10000,-10000,-10000
051564,和碩國泰96購01  ,0,0,0,0,0,0,0,0,0,-10000,0,0,0,0,10000,-10000,-10000
051494,中環兆豐95購01  ,0,0,0,0,0,0,0,0,0,-10000,0,0,0,0,10000,-10000,-10000
051047,深中小群益99購01,0,0,0,0,0,0,0,0,0,-10000,0,0,0,0,10000,-10000,-10000
051280,台積電兆豐95購04,0,0,0,0,0,0,0,0,0,-10000,0,0,0,0,10000,-10000,-10000
051392,玉山金兆豐95購01,0,0,0,0,0,0,0,0,0,-10000,0,0,0,0,10000,-10000,-10000
051364,鴻海國泰97購03  ,0,0,0,0,0,0,0,0,0,-10000,0,0,0,0,10000,-10000,-10000
051370,聯詠富邦97購01  ,0,0,0,0,0,0,0,0,0,-10000,0,0,0,0,10000,-10000,-10000
051359,中信金元大95購01,0,0,0,0,0,0,0,0,0,-10000,0,0,0,0,10000,-10000,-10000
055439,台表科國票98購02,0,0,0,0,0,0,0,0,0,-10000,0,0,0,0,10000,-10000,-10000
055962,晶豪科元大97購02,0,0,0,0,0,0,0,0,0,-10000,0,0,0,0,10000,-10000,-10000
055959,美律元大97購03  ,0,0,0,0,0,0,0,0,0,-10000,0,0,0,0,10000,-10000,-10000
055977,南亞科統一97購01,0,0,0,0,0,0,0,0,0,-10000,0,0,0,0,10000,-10000,-10000
051623,和碩凱基96購02  ,0,0,0,0,0,0,0,0,0,-10000,0,0,0,0,10000,-10000,-10000
051638,聯茂國票96購01  ,0,0,0,0,0,0,0,0,0,-10000,0,0,0,0,10000,-10000,-10000
055855,牧德元大99購02  ,0,0,0,0,0,0,0,0,0,-10000,0,0,0,0,10000,-10000,-10000
055906,大立光兆豐97購03,0,0,0,0,0,0,0,0,0,-10000,0,0,0,0,10000,-10000,-10000
055532,中工群益98購01  ,0,0,0,0,0,0,0,0,0,-10000,0,0,0,10000,20000,-10000,-10000
055538,鴻海日盛97購04  ,0,0,0,0,0,0,0,0,0,-10000,0,0,0,10000,20000,-10000,-10000
055551,致茂凱基98購01  ,0,0,0,0,0,0,0,0,0,-10000,0,0,0,0,10000,-10000,-10000
055696,華新科國票98購01,0,0,0,0,0,0,0,0,0,-10000,0,0,0,0,10000,-10000,-10000
055639,上銀元富97購02  ,0,0,0,0,0,0,0,0,0,-10000,0,0,0,0,10000,-10000,-10000
055615,宏達電國票99購02,0,0,0,0,0,0,0,0,0,-10000,0,0,0,0,10000,-10000,-10000
049928,祥碩元大94購02  ,0,0,0,0,0,0,0,0,0,-10000,0,0,0,0,10000,-10000,-10000
04976P,中磊凱基94售01  ,0,0,0,0,0,0,0,0,0,-10000,0,0,0,0,10000,-10000,-10000
050016,緯穎富邦95購01  ,0,0,0,0,0,0,0,0,0,-10000,0,0,0,50000,60000,-10000,-10000
049430,國巨國票95購02  ,0,0,0,0,0,0,0,0,0,-10000,0,0,0,0,10000,-10000,-10000
04925P,和碩元大94售03  ,0,0,0,0,0,0,0,0,0,-10000,0,0,0,0,10000,-10000,-10000
049200,元黃金群益98購01,0,0,0,0,0,0,0,0,0,-10000,0,0,0,5000,15000,-10000,-10000
04921P,TPK凱基94售05   ,0,0,0,0,0,0,0,0,0,-10000,0,0,0,0,10000,-10000,-10000
049382,牧德元大94購04  ,0,0,0,0,0,0,0,0,0,-10000,0,0,0,50000,60000,-10000,-10000
05203P,華新科元大95售10,0,0,0,0,0,0,0,0,0,-10000,0,0,0,0,10000,-10000,-10000
052017,奇鋐永豐95購01  ,0,0,0,0,0,0,0,0,0,-10000,0,0,0,0,10000,-10000,-10000
052011,欣興中信96購01  ,0,0,0,0,0,0,0,0,0,-10000,0,0,0,0,10000,-10000,-10000
051980,樺漢凱基96購01  ,0,0,0,0,0,0,0,0,0,-10000,0,0,0,0,10000,-10000,-10000
051974,華新科凱基96購05,0,0,0,0,0,0,0,0,0,-10000,0,0,0,0,10000,-10000,-10000
051135,建準永豐95購01  ,0,0,0,0,0,0,0,0,0,-10000,0,0,0,0,10000,-10000,-10000
051175,國巨凱基95購04  ,0,0,0,0,0,0,0,0,0,-10000,0,0,0,0,10000,-10000,-10000
05117P,瑞昱群益95售02  ,0,0,0,0,0,0,0,0,0,-10000,0,0,0,0,10000,-10000,-10000
051188,鴻海兆豐95購01  ,0,0,0,0,0,0,0,0,0,-10000,0,0,0,0,10000,-10000,-10000
051073,同欣電國票96購01,0,0,0,0,0,0,0,0,0,-10000,0,0,0,0,10000,-10000,-10000
048941,牧德永豐94購02  ,0,0,0,0,0,0,0,0,0,-10000,0,0,0,0,10000,-10000,-10000
048902,昇陽半國泰96購01,0,0,0,0,0,0,0,0,0,-10000,0,0,0,0,10000,-10000,-10000
051723,嘉澤永豐95購01  ,0,0,0,0,0,0,0,0,0,-10000,0,0,0,0,10000,-10000,-10000
052084,台泥元大95購01  ,0,0,0,0,0,0,0,0,0,-10000,0,0,0,0,10000,-10000,-10000
052066,華邦電兆豐96購01,0,0,0,0,0,0,0,0,0,-10000,0,0,0,0,10000,-10000,-10000
050727,華新科國票94購09,0,0,0,0,0,0,0,0,0,-10000,0,0,0,0,10000,-10000,-10000
050732,台虹國票94購01  ,0,0,0,0,0,0,0,0,0,-10000,0,0,0,0,10000,-10000,-10000
049591,開發金元大98購01,0,0,0,0,0,0,0,0,0,-10000,0,0,0,0,10000,-10000,-10000
049524,可成兆豐95購02  ,0,0,0,0,0,0,0,0,0,-10000,0,0,0,0,10000,-10000,-10000
049544,台積電群益94購08,0,0,0,0,0,0,0,0,0,-10000,0,0,0,70000,80000,-10000,-10000
03019X,元展19          ,0,0,0,0,0,0,0,0,0,-10000,0,0,0,0,10000,-10000,-10000
04364P,台積電元富94售03,0,0,0,0,0,0,0,0,0,-10000,0,0,0,0,10000,-10000,-10000
04314P,聯茂元富93售01  ,0,0,0,0,0,0,0,0,0,-10000,0,0,0,0,10000,-10000,-10000
044429,元金2X元大94購04,0,0,0,0,0,0,0,0,0,-10000,0,0,0,0,10000,-10000,-10000
044270,群創中信95購02  ,0,0,0,0,0,0,0,0,0,-10000,0,0,0,0,10000,-10000,-10000
048567,台郡元大93購03  ,0,0,0,0,0,0,0,0,0,-10000,0,0,0,0,10000,-10000,-10000
048568,緯穎元大93購06  ,0,0,0,0,0,0,0,0,0,-10000,0,0,0,0,10000,-10000,-10000
048571,美利達元大96購03,0,0,0,0,0,0,0,0,0,-10000,0,0,0,0,10000,-10000,-10000
048248,聯發科兆豐95購01,0,0,0,0,0,0,0,0,0,-10000,0,0,0,0,10000,-10000,-10000
048286,滬深2X兆豐94購04,0,0,0,0,0,0,0,0,0,-10000,0,0,0,0,10000,-10000,-10000
048328,滬深2X永昌94購01,0,0,0,0,0,0,0,0,0,-10000,0,0,0,0,10000,-10000,-10000
041527,T50反1中信96購01,0,0,0,0,0,0,0,0,0,-10000,0,0,0,13000,23000,-10000,-10000
035276,南亞科台新97購01,0,0,0,0,0,0,0,0,0,-10000,0,0,0,0,10000,-10000,-10000
047033,日月光中信95購01,0,0,0,0,0,0,0,0,0,-10000,0,0,0,0,10000,-10000,-10000
047013,超眾元富96購01  ,0,0,0,0,0,0,0,0,0,-10000,0,0,0,0,10000,-10000,-10000
046998,同欣電國泰94購01,0,0,0,0,0,0,0,0,0,-10000,0,0,0,0,10000,-10000,-10000
04715P,聯茂元大94售06  ,0,0,0,0,0,0,0,0,0,-10000,0,0,0,0,10000,-10000,-10000
047214,啟碁富邦97購01  ,0,0,0,0,0,0,0,0,0,-10000,0,0,0,0,10000,-10000,-10000
048748,國巨元富96購01  ,0,0,0,0,0,0,0,0,0,-10000,0,0,0,2000,12000,-10000,-10000
04551P,台表科元大94售02,0,0,0,0,0,0,0,0,0,-10000,0,0,0,20000,30000,-10000,-10000
04563P,可成凱基94售05  ,0,0,0,0,0,0,0,0,0,-10000,0,0,0,1000,11000,-10000,-10000
045208,力成國泰94購01  ,0,0,0,0,0,0,0,0,0,-10000,0,0,0,0,10000,-10000,-10000
045213,A50正2元大95購01,0,0,0,0,0,0,0,0,0,-10000,0,0,0,0,10000,-10000,-10000
045220,漢唐元大94購01  ,0,0,0,0,0,0,0,0,0,-10000,0,0,0,20000,30000,-10000,-10000
04534P,臻鼎元富94售03  ,0,0,0,0,0,0,0,0,0,-10000,0,0,0,0,10000,-10000,-10000
04509P,臺股指元大94售04,0,0,0,0,0,0,0,0,0,-10000,0,0,0,0,10000,-10000,-10000
045106,玉晶光群益95購01,0,0,0,0,0,0,0,0,0,-10000,0,0,0,0,10000,-10000,-10000
047877,滬深2X中信95購07,0,0,0,0,0,0,0,0,0,-10000,0,0,0,0,10000,-10000,-10000
048076,亞光第一94購01  ,0,0,0,0,0,0,0,0,0,-10000,0,0,0,0,10000,-10000,-10000
04586P,光罩永豐94售02  ,0,0,0,0,0,0,0,0,0,-10000,0,0,0,0,10000,-10000,-10000
046049,臺股指元大93購19,0,0,0,0,0,0,0,0,0,-10000,0,0,0,0,10000,-10000,-10000
05187P,力山凱基95售01  ,0,0,0,0,0,0,0,0,0,-10000,0,0,0,0,10000,-10000,-10000
050397,力成元富94購01  ,0,0,0,0,0,0,0,0,0,-10000,0,0,0,0,10000,-10000,-10000
050427,台積電凱基94購34,0,0,0,0,0,0,0,0,0,-10000,0,0,0,10000,20000,-10000,-10000
050444,卜蜂元大94購03  ,0,0,0,0,0,0,0,0,0,-10000,0,0,0,0,10000,-10000,-10000
050446,鴻海元大94購22  ,0,0,0,0,0,0,0,0,0,-10000,0,0,0,0,10000,-10000,-10000
051788,奇力新國票97購02,0,0,0,0,0,0,0,0,0,-10000,0,0,0,0,10000,-10000,-10000
050179,全新元大96購02  ,0,0,0,0,0,0,0,0,0,-10000,0,0,0,0,10000,-10000,-10000
050191,和碩元大94購02  ,0,0,0,0,0,0,0,0,0,-10000,0,0,0,0,10000,-10000,-10000
047572,深中小群益95購01,0,0,0,0,0,0,0,0,0,-10000,0,0,0,0,10000,-10000,-10000
04761P,可成凱基94售09  ,0,0,0,0,0,0,0,0,0,-10000,0,0,0,10000,20000,-10000,-10000
047483,新光金凱基99購04,0,0,0,0,0,0,0,0,0,-10000,0,0,0,0,10000,-10000,-10000
047505,元金2X國票9B購01,0,0,0,0,0,0,0,0,0,-10000,0,0,0,0,10000,-10000,-10000
046685,世紀鋼群益93購02,0,0,0,0,0,0,0,0,0,-10000,0,0,0,0,10000,-10000,-10000
057373,大立光元大98購17,0,0,0,0,0,0,0,0,0,-10000,0,0,0,20000,30000,-10000,-10000
057397,茂林中信9A購01  ,0,0,0,0,0,0,0,0,0,-10000,0,0,0,0,10000,-10000,-10000
057234,宏達電凱基98購05,0,0,0,0,0,0,0,0,0,-10000,0,0,0,57000,67000,-10000,-10000
057256,元油2X兆豐98購01,0,0,0,0,0,0,0,0,0,-10000,0,0,0,0,10000,-10000,-10000
057262,友達兆豐98購03  ,0,0,0,0,0,0,0,0,0,-10000,0,0,0,0,10000,-10000,-10000
057268,臻鼎兆豐99購01  ,0,0,0,0,0,0,0,0,0,-10000,0,0,0,0,10000,-10000,-10000
057276,全新元大99購03  ,0,0,0,0,0,0,0,0,0,-10000,0,0,0,0,10000,-10000,-10000
057280,大立光元大98購15,0,0,0,0,0,0,0,0,0,-10000,0,0,0,40000,50000,-10000,-10000
057284,新日興元大98購03,0,0,0,0,0,0,0,0,0,-10000,0,0,0,0,10000,-10000,-10000
057286,群創元大9B購05  ,0,0,0,0,0,0,0,0,0,-10000,0,0,0,0,10000,-10000,-10000
057311,玉晶光日盛9A購01,0,0,0,0,0,0,0,0,0,-10000,0,0,0,0,10000,-10000,-10000
057224,和碩日盛9A購01  ,0,0,0,0,0,0,0,0,0,-10000,0,0,0,0,10000,-10000,-10000
05717P,鴻海元大97售07  ,0,0,0,0,0,0,0,0,0,-10000,0,0,0,0,10000,-10000,-10000
057170,瑞昱元大98購01  ,0,0,0,0,0,0,0,0,0,-10000,0,0,0,40000,50000,-10000,-10000
057139,華新科兆豐98購02,0,0,0,0,0,0,0,0,0,-10000,0,0,0,0,10000,-10000,-10000
05707P,中磊永豐96售01  ,0,0,0,0,0,0,0,0,0,-10000,0,0,0,0,10000,-10000,-10000
057080,華新科統一99購02,0,0,0,0,0,0,0,0,0,-10000,0,0,0,0,10000,-10000,-10000
057046,奇力新元大99購03,0,0,0,0,0,0,0,0,0,-10000,0,0,0,0,10000,-10000,-10000
057065,牧德富邦99購01  ,0,0,0,0,0,0,0,0,0,-10000,0,0,0,0,10000,-10000,-10000
056925,群創兆豐98購03  ,0,0,0,0,0,0,0,0,0,-10000,0,0,0,0,10000,-10000,-10000
056917,國巨兆豐98購03  ,0,0,0,0,0,0,0,0,0,-10000,0,0,0,0,10000,-10000,-10000
056901,華新科元大98購03,0,0,0,0,0,0,0,0,0,-10000,0,0,0,20000,30000,-10000,-10000
054802,高股息元大97購01,0,0,0,0,0,0,0,0,0,-10000,0,0,0,0,10000,-10000,-10000
054806,台化元大9A購01  ,0,0,0,0,0,0,0,0,0,-10000,0,0,0,0,10000,-10000,-10000
05701P,彩晶凱基96售01  ,0,0,0,0,0,0,0,0,0,-10000,0,0,0,10000,20000,-10000,-10000
054848,群創兆豐98購01  ,0,0,0,0,0,0,0,0,0,-10000,0,0,0,0,10000,-10000,-10000
057003,立積國票98購01  ,0,0,0,0,0,0,0,0,0,-10000,0,0,0,0,10000,-10000,-10000
057027,祥碩凱基98購01  ,0,0,0,0,0,0,0,0,0,-10000,0,0,0,0,10000,-10000,-10000
055046,上銀永豐97購01  ,0,0,0,0,0,0,0,0,0,-10000,0,0,0,0,10000,-10000,-10000
055122,國巨兆豐98購01  ,0,0,0,0,0,0,0,0,0,-10000,0,0,0,0,10000,-10000,-10000
055130,京鼎康和97購01  ,0,0,0,0,0,0,0,0,0,-10000,0,0,0,0,10000,-10000,-10000
055072,康友永豐97購02  ,0,0,0,0,0,0,0,0,0,-10000,0,0,0,0,10000,-10000,-10000
055249,大毅統一99購01  ,0,0,0,0,0,0,0,0,0,-10000,0,0,0,0,10000,-10000,-10000
054757,南亞國票98購01  ,0,0,0,0,0,0,0,0,0,-10000,0,0,0,0,10000,-10000,-10000
055371,正崴元大97購02  ,0,0,0,0,0,0,0,0,0,-10000,0,0,0,0,10000,-10000,-10000
055200,和大群益98購01  ,0,0,0,0,0,0,0,0,0,-10000,0,0,0,0,10000,-10000,-10000
055173,瑞昱統一97購01  ,0,0,0,0,0,0,0,0,0,-10000,0,0,0,0,10000,-10000,-10000
053862,南亞科元大97購02,0,0,0,0,0,0,0,0,0,-10000,0,0,0,0,10000,-10000,-10000
053851,鴻海國泰98購03  ,0,0,0,0,0,0,0,0,0,-10000,0,0,0,0,10000,-10000,-10000
053790,嘉聯益元大99購02,0,0,0,0,0,0,0,0,0,-10000,0,0,0,0,10000,-10000,-10000
053792,百和元大96購01  ,0,0,0,0,0,0,0,0,0,-10000,0,0,0,0,10000,-10000,-10000
053809,上銀群益96購02  ,0,0,0,0,0,0,0,0,0,-10000,0,0,0,0,10000,-10000,-10000
053768,S&P反1元大99購01,0,0,0,0,0,0,0,0,0,-10000,0,0,0,0,10000,-10000,-10000
053825,南電群益96購02  ,0,0,0,0,0,0,0,0,0,-10000,0,0,0,0,10000,-10000,-10000
053923,亞光國票97購01  ,0,0,0,0,0,0,0,0,0,-10000,0,0,0,0,10000,-10000,-10000
053926,晶相光國票97購01,0,0,0,0,0,0,0,0,0,-10000,0,0,0,0,10000,-10000,-10000
053867,創意元大96購04  ,0,0,0,0,0,0,0,0,0,-10000,0,0,0,0,10000,-10000,-10000
053916,漢唐國票97購04  ,0,0,0,0,0,0,0,0,0,-10000,0,0,0,0,10000,-10000,-10000
053772,大成鋼元大96購02,0,0,0,0,0,0,0,0,0,-10000,0,0,0,0,10000,-10000,-10000
05446P,緯穎元大95售04  ,0,0,0,0,0,0,0,0,0,-10000,0,0,0,10000,20000,-10000,-10000
054484,仁寶台新96購01  ,0,0,0,0,0,0,0,0,0,-10000,0,0,0,0,10000,-10000,-10000
054510,S&P反1元大98購01,0,0,0,0,0,0,0,0,0,-10000,0,0,0,0,10000,-10000,-10000
054504,聯鈞永豐96購01  ,0,0,0,0,0,0,0,0,0,-10000,0,0,0,0,10000,-10000,-10000
053676,新光金國泰98購02,0,0,0,0,0,0,0,0,0,-10000,0,0,0,0,10000,-10000,-10000
053701,台積電兆豐96購05,0,0,0,0,0,0,0,0,0,-10000,0,0,0,0,10000,-10000,-10000
054059,欣興國票97購03  ,0,0,0,0,0,0,0,0,0,-10000,0,0,0,0,10000,-10000,-10000
05406P,台光電凱基95售02,0,0,0,0,0,0,0,0,0,-10000,0,0,0,80000,90000,-10000,-10000
054095,同欣電群益98購03,0,0,0,0,0,0,0,0,0,-10000,0,0,0,0,10000,-10000,-10000
054113,奇力新台新97購01,0,0,0,0,0,0,0,0,0,-10000,0,0,0,0,10000,-10000,-10000
053965,聯電元大98購04  ,0,0,0,0,0,0,0,0,0,-10000,0,0,0,20000,30000,-10000,-10000
055354,宏達電凱基98購01,0,0,0,0,0,0,0,0,0,-10000,0,0,0,0,10000,-10000,-10000
053552,華新科凱基96購08,0,0,0,0,0,0,0,0,0,-10000,0,0,0,0,10000,-10000,-10000
053625,國巨兆豐96購03  ,0,0,0,0,0,0,0,0,0,-10000,0,0,0,0,10000,-10000,-10000
053628,微星兆豐96購01  ,0,0,0,0,0,0,0,0,0,-10000,0,0,0,0,10000,-10000,-10000
053578,華新元大98購01  ,0,0,0,0,0,0,0,0,0,-10000,0,0,0,0,10000,-10000,-10000
054621,華新科兆豐98購01,0,0,0,0,0,0,0,0,0,-10000,0,0,0,0,10000,-10000,-10000
054545,奇力新中信98購01,0,0,0,0,0,0,0,0,0,-10000,0,0,0,0,10000,-10000,-10000
052475,滬深2X群益99購06,0,0,0,0,0,0,0,0,0,-10000,0,0,0,0,10000,-10000,-10000
052420,道瓊反國票9B購01,0,0,0,0,0,0,0,0,0,-10000,0,0,0,0,10000,-10000,-10000
052416,滬深2X兆豐96購02,0,0,0,0,0,0,0,0,0,-10000,0,0,0,0,10000,-10000,-10000
052456,滬深2X元富9B購03,0,0,0,0,0,0,0,0,0,-10000,0,0,0,0,10000,-10000,-10000
053484,國巨國票97購03  ,0,0,0,0,0,0,0,0,0,-10000,0,0,0,0,10000,-10000,-10000
054740,強茂凱基99購01  ,0,0,0,0,0,0,0,0,0,-10000,0,0,0,0,10000,-10000,-10000
053504,祥碩兆豐96購01  ,0,0,0,0,0,0,0,0,0,-10000,0,0,0,0,10000,-10000,-10000
054934,金寶元大97購01  ,0,0,0,0,0,0,0,0,0,-10000,0,0,0,0,10000,-10000,-10000
054969,亞翔元大97購01  ,0,0,0,0,0,0,0,0,0,-10000,0,0,0,0,10000,-10000,-10000
054987,凱美元富97購01  ,0,0,0,0,0,0,0,0,0,-10000,0,0,0,0,10000,-10000,-10000
054988,凱美元富97購02  ,0,0,0,0,0,0,0,0,0,-10000,0,0,0,0,10000,-10000,-10000
055008,隆達元富97購01  ,0,0,0,0,0,0,0,0,0,-10000,0,0,0,0,10000,-10000,-10000
054956,宏盛元大97購01  ,0,0,0,0,0,0,0,0,0,-10000,0,0,0,0,10000,-10000,-10000
052801,友達元大9A購01  ,0,0,0,0,0,0,0,0,0,-10000,0,0,0,10000,20000,-10000,-10000
052792,大立光兆豐96購01,0,0,0,0,0,0,0,0,0,-10000,0,0,0,0,10000,-10000,-10000
052890,FB上証群益9B購01,0,0,0,0,0,0,0,0,0,-10000,0,0,0,0,10000,-10000,-10000
052987,華新科元大99購01,0,0,0,0,0,0,0,0,0,-10000,0,0,0,0,10000,-10000,-10000
053022,欣興國泰98購01  ,0,0,0,0,0,0,0,0,0,-10000,0,0,0,0,10000,-10000,-10000
053005,微星永豐96購01  ,0,0,0,0,0,0,0,0,0,-10000,0,0,0,0,10000,-10000,-10000
053032,國巨兆豐97購02  ,0,0,0,0,0,0,0,0,0,-10000,0,0,0,0,10000,-10000,-10000
053056,同欣電國票97購01,0,0,0,0,0,0,0,0,0,-10000,0,0,0,0,10000,-10000,-10000
052936,華通兆豐98購01  ,0,0,0,0,0,0,0,0,0,-10000,0,0,0,0,10000,-10000,-10000
052975,嘉聯益群益96購01,0,0,0,0,0,0,0,0,0,-10000,0,0,0,0,10000,-10000,-10000
054419,嘉聯益元大98購02,0,0,0,0,0,0,0,0,0,-10000,0,0,0,0,10000,-10000,-10000
054386,鴻海統一98購03  ,0,0,0,0,0,0,0,0,0,-10000,0,0,0,0,10000,-10000,-10000
054413,台光電元大96購03,0,0,0,0,0,0,0,0,0,-10000,0,0,0,24000,34000,-10000,-10000
054408,義隆國票98購01  ,0,0,0,0,0,0,0,0,0,-10000,0,0,0,0,10000,-10000,-10000
053349,台郡國票97購02  ,0,0,0,0,0,0,0,0,0,-10000,0,0,0,0,10000,-10000,-10000
053337,聯電國票97購01  ,0,0,0,0,0,0,0,0,0,-10000,0,0,0,0,10000,-10000,-10000
053387,緯創元大97購01  ,0,0,0,0,0,0,0,0,0,-10000,0,0,0,0,10000,-10000,-10000
052601,大成鋼元大96購01,0,0,0,0,0,0,0,0,0,-10000,0,0,0,71000,81000,-10000,-10000
052621,台郡富邦97購01  ,0,0,0,0,0,0,0,0,0,-10000,0,0,0,0,10000,-10000,-10000
052528,茂林元大95購05  ,0,0,0,0,0,0,0,0,0,-10000,0,0,0,0,10000,-10000,-10000
056803,群創台新99購02  ,0,0,0,0,0,0,0,0,0,-10000,0,0,0,0,10000,-10000,-10000
056808,台積電統一98購06,0,0,0,0,0,0,0,0,0,-10000,0,0,0,70000,80000,-10000,-10000
056766,義隆元大98購01  ,0,0,0,0,0,0,0,0,0,-10000,0,0,0,20000,30000,-10000,-10000
056844,欣興元富98購03  ,0,0,0,0,0,0,0,0,0,-10000,0,0,0,10000,20000,-10000,-10000
056683,台積電統一98購05,0,0,0,0,0,0,0,0,0,-10000,0,0,0,10000,20000,-10000,-10000
056686,可成統一98購01  ,0,0,0,0,0,0,0,0,0,-10000,0,0,0,0,10000,-10000,-10000
056737,國巨凱基9A購01  ,0,0,0,0,0,0,0,0,0,-10000,0,0,0,0,10000,-10000,-10000
056740,大立光凱基98購13,0,0,0,0,0,0,0,0,0,-10000,0,0,0,0,10000,-10000,-10000
056750,元油2X兆豐9A購01,0,0,0,0,0,0,0,0,0,-10000,0,0,0,0,10000,-10000,-10000
056753,群創兆豐98購02  ,0,0,0,0,0,0,0,0,0,-10000,0,0,0,0,10000,-10000,-10000
05270P,台表科元大95售05,0,0,0,0,0,0,0,0,0,-10000,0,0,0,15000,25000,-10000,-10000
052749,日月光元大96購02,0,0,0,0,0,0,0,0,0,-10000,0,0,0,0,10000,-10000,-10000
052733,台郡國泰97購01  ,0,0,0,0,0,0,0,0,0,-10000,0,0,0,0,10000,-10000,-10000
056373,上銀統一99購02  ,0,0,0,0,0,0,0,0,0,-10000,0,0,0,0,10000,-10000,-10000
056374,聯發科統一9B購01,0,0,0,0,0,0,0,0,0,-10000,0,0,0,0,10000,-10000,-10000
052681,T50反1元大98購02,0,0,0,0,0,0,0,0,0,-10000,0,0,0,0,10000,-10000,-10000
05436P,台積電群益95售07,0,0,0,0,0,0,0,0,0,-10000,0,0,0,21000,31000,-10000,-10000
054299,南電元大96購03  ,0,0,0,0,0,0,0,0,0,-10000,0,0,0,0,10000,-10000,-10000
054301,楠梓電凱基98購01,0,0,0,0,0,0,0,0,0,-10000,0,0,0,0,10000,-10000,-10000
054305,光磊凱基98購01  ,0,0,0,0,0,0,0,0,0,-10000,0,0,0,0,10000,-10000,-10000
056498,A50正2富邦9B購01,0,0,0,0,0,0,0,0,0,-10000,0,0,0,0,10000,-10000,-10000
05655P,南亞科統一96售01,0,0,0,0,0,0,0,0,0,-10000,0,0,0,0,10000,-10000,-10000
056561,台光電群益98購02,0,0,0,0,0,0,0,0,0,-10000,0,0,0,1000,11000,-10000,-10000
056577,玉晶光元大99購06,0,0,0,0,0,0,0,0,0,-10000,0,0,0,0,10000,-10000,-10000
05658P,日月光元富96售02,0,0,0,0,0,0,0,0,0,-10000,0,0,0,10000,20000,-10000,-10000
056471,台光電元大99購01,0,0,0,0,0,0,0,0,0,-10000,0,0,0,10000,20000,-10000,-10000
056472,美律元大99購03  ,0,0,0,0,0,0,0,0,0,-10000,0,0,0,17000,27000,-10000,-10000
056668,光磊國票99購01  ,0,0,0,0,0,0,0,0,0,-10000,0,0,0,5000,15000,-10000,-10000
056658,美食元大98購01  ,0,0,0,0,0,0,0,0,0,-10000,0,0,0,10000,20000,-10000,-10000
056353,鴻海元大99購02  ,0,0,0,0,0,0,0,0,0,-10000,0,0,0,0,10000,-10000,-10000
056409,麗豐國票99購01  ,0,0,0,0,0,0,0,0,0,-10000,0,0,0,0,10000,-10000,-10000
056384,玉晶光國泰9A購02,0,0,0,0,0,0,0,0,0,-10000,0,0,0,20000,30000,-10000,-10000
056248,康友群益97購04  ,0,0,0,0,0,0,0,0,0,-10000,0,0,0,0,10000,-10000,-10000
056242,緯創群益9A購01  ,0,0,0,0,0,0,0,0,0,-10000,0,0,0,0,10000,-10000,-10000
056047,台積電兆豐97購02,0,0,0,0,0,0,0,0,0,-10000,0,0,0,0,10000,-10000,-10000
056106,晶相光永豐97購02,0,0,0,0,0,0,0,0,0,-10000,0,0,0,0,10000,-10000,-10000
056088,台郡統一97購02  ,0,0,0,0,0,0,0,0,0,-10000,0,0,0,0,10000,-10000,-10000
056124,華通國票98購02  ,0,0,0,0,0,0,0,0,0,-10000,0,0,0,30000,40000,-10000,-10000
053144,上証2X元大96購01,0,0,0,0,0,0,0,0,0,-10000,0,0,0,0,10000,-10000,-10000
053108,南亞科兆豐96購01,0,0,0,0,0,0,0,0,0,-10000,0,0,0,0,10000,-10000,-10000
053075,欣興永豐96購01  ,0,0,0,0,0,0,0,0,0,-10000,0,0,0,0,10000,-10000,-10000
055811,國巨國票98購05  ,0,0,0,0,0,0,0,0,0,-10000,0,0,0,0,10000,-10000,-10000
055820,矽力國票98購02  ,0,0,0,0,0,0,0,0,0,-10000,0,0,0,0,10000,-10000,-10000
055801,景碩永豐97購02  ,0,0,0,0,0,0,0,0,0,-10000,0,0,0,0,10000,-10000,-10000
055736,宏達電元富99購01,0,0,0,0,0,0,0,0,0,-10000,0,0,0,0,10000,-10000,-10000
055756,臺股指兆豐97購01,0,0,0,0,0,0,0,0,0,-10000,0,0,0,0,10000,-10000,-10000
054197,台積電永昌96購07,0,0,0,0,0,0,0,0,0,-10000,0,0,0,0,10000,-10000,-10000
054204,元金2X國票9B購02,0,0,0,0,0,0,0,0,0,-10000,0,0,0,0,10000,-10000,-10000
054207,國巨國票98購01  ,0,0,0,0,0,0,0,0,0,-10000,0,0,0,0,10000,-10000,-10000
05418P,瑞昱永豐95售02  ,0,0,0,0,0,0,0,0,0,-10000,0,0,0,0,10000,-10000,-10000
055323,貿聯國票98購01  ,0,0,0,0,0,0,0,0,0,-10000,0,0,0,0,10000,-10000,-10000
055311,健策群益98購02  ,0,0,0,0,0,0,0,0,0,-10000,0,0,0,0,10000,-10000,-10000
054215,創意國票97購02  ,0,0,0,0,0,0,0,0,0,-10000,0,0,0,0,10000,-10000,-10000
055271,鴻海元大98購03  ,0,0,0,0,0,0,0,0,0,-10000,0,0,0,30000,40000,-10000,-10000
3617,碩天            ,73000,72000,1000,0,0,0,0,0,0,-11000,4000,15000,-11000,0,0,0,-10000
6164,華興            ,0,13000,-13000,0,0,0,0,0,0,3000,3000,0,3000,0,0,0,-10000
4764,雙鍵            ,7000,17000,-10000,0,0,0,0,0,0,0,0,0,0,0,0,0,-10000
1451,年興            ,31000,42000,-11000,0,0,0,0,0,0,0,0,0,0,0,0,0,-11000
1616,億泰            ,0,11000,-11000,0,0,0,0,0,0,0,0,0,0,0,0,0,-11000
1776,展宇            ,0,11000,-11000,0,0,0,0,0,0,0,0,0,0,0,0,0,-11000
06928P,鴻海元大99售10  ,0,0,0,0,0,0,0,0,0,-11000,0,0,0,127000,138000,-11000,-11000
059201,祥碩永豐99購02  ,0,0,0,0,0,0,0,0,0,-11000,0,0,0,400000,411000,-11000,-11000
06465P,國巨統一98售04  ,0,0,0,0,0,0,0,0,0,-11000,0,0,0,0,11000,-11000,-11000
06392P,T50反1元大9A售01,0,0,0,0,0,0,0,0,0,-11000,0,0,0,0,11000,-11000,-11000
06502P,A50中信98售01   ,0,0,0,0,0,0,0,0,0,-11000,0,0,0,30000,41000,-11000,-11000
058580,華新科群益99購02,0,0,0,0,0,0,0,0,0,-11000,0,0,0,0,11000,-11000,-11000
058644,元黃金富邦03購01,0,0,0,0,0,0,0,0,0,-11000,0,0,0,0,11000,-11000,-11000
058342,鴻海群益9A購01  ,0,0,0,0,0,0,0,0,0,-11000,0,0,0,0,11000,-11000,-11000
058949,上銀群益99購02  ,0,0,0,0,0,0,0,0,0,-11000,0,0,0,0,11000,-11000,-11000
058897,國巨元大99購17  ,0,0,0,0,0,0,0,0,0,-11000,0,0,0,289000,300000,-11000,-11000
058798,大立光元大99購11,0,0,0,0,0,0,0,0,0,-11000,0,0,0,169000,180000,-11000,-11000
058765,緯穎群益99購03  ,0,0,0,0,0,0,0,0,0,-11000,0,0,0,0,11000,-11000,-11000
057704,台虹群益98購03  ,0,0,0,0,0,0,0,0,0,-11000,0,0,0,0,11000,-11000,-11000
05744P,台表科元大96售04,0,0,0,0,0,0,0,0,0,-11000,0,0,0,0,11000,-11000,-11000
058158,台積電台新99購01,0,0,0,0,0,0,0,0,0,-11000,0,0,0,140000,151000,-11000,-11000
058081,技嘉群益9A購03  ,0,0,0,0,0,0,0,0,0,-11000,0,0,0,0,11000,-11000,-11000
046011,欣興元富95購01  ,0,0,0,0,0,0,0,0,0,-11000,0,0,0,0,11000,-11000,-11000
04519P,國泰金群益94售01,0,0,0,0,0,0,0,0,0,-11000,0,0,0,0,11000,-11000,-11000
048480,FB上証中信94購01,0,0,0,0,0,0,0,0,0,-11000,0,0,0,0,11000,-11000,-11000
051057,信邦群益95購01  ,0,0,0,0,0,0,0,0,0,-11000,0,0,0,0,11000,-11000,-11000
052028,健策群益95購02  ,0,0,0,0,0,0,0,0,0,-11000,0,0,0,0,11000,-11000,-11000
055464,聚陽凱基97購01  ,0,0,0,0,0,0,0,0,0,-11000,0,0,0,0,11000,-11000,-11000
055474,欣興凱基97購05  ,0,0,0,0,0,0,0,0,0,-11000,0,0,0,0,11000,-11000,-11000
055954,南港元大97購02  ,0,0,0,0,0,0,0,0,0,-11000,0,0,0,0,11000,-11000,-11000
051283,亞德客統一95購01,0,0,0,0,0,0,0,0,0,-11000,0,0,0,0,11000,-11000,-11000
050890,南電富邦99購01  ,0,0,0,0,0,0,0,0,0,-11000,0,0,0,0,11000,-11000,-11000
055276,台積電元大97購20,0,0,0,0,0,0,0,0,0,-11000,0,0,0,0,11000,-11000,-11000
053081,上銀元大97購02  ,0,0,0,0,0,0,0,0,0,-11000,0,0,0,0,11000,-11000,-11000
05624P,同欣電中信98售01,0,0,0,0,0,0,0,0,0,-11000,0,0,0,1000,12000,-11000,-11000
053309,泰鼎凱基96購03  ,0,0,0,0,0,0,0,0,0,-11000,0,0,0,14000,25000,-11000,-11000
052672,世紀鋼群益96購02,0,0,0,0,0,0,0,0,0,-11000,0,0,0,160000,171000,-11000,-11000
052765,新日興群益97購01,0,0,0,0,0,0,0,0,0,-11000,0,0,0,0,11000,-11000,-11000
054602,聯詠台新97購01  ,0,0,0,0,0,0,0,0,0,-11000,0,0,0,0,11000,-11000,-11000
053661,嘉澤凱基97購01  ,0,0,0,0,0,0,0,0,0,-11000,0,0,0,0,11000,-11000,-11000
053978,創意元大96購05  ,0,0,0,0,0,0,0,0,0,-11000,0,0,0,240000,251000,-11000,-11000
056895,技嘉元大98購01  ,0,0,0,0,0,0,0,0,0,-11000,0,0,0,0,11000,-11000,-11000
056856,華通群益9A購01  ,0,0,0,0,0,0,0,0,0,-11000,0,0,0,0,11000,-11000,-11000
057259,台積電兆豐98購03,0,0,0,0,0,0,0,0,0,-11000,0,0,0,0,11000,-11000,-11000
6115,鎰勝            ,52000,67000,-15000,0,0,0,0,0,0,4000,5000,1000,4000,0,0,0,-11000
6133,金橋            ,1000,16000,-15000,0,0,0,0,0,0,4000,4000,0,4000,0,0,0,-11000
2904,匯僑            ,1000,10000,-9000,0,0,0,0,0,0,-2000,0,2000,-2000,0,0,0,-11000
2465,麗臺            ,7000,18000,-11000,0,0,0,0,0,0,0,0,0,0,0,0,0,-11000
6405,悅城            ,1000,14000,-13000,0,0,0,0,0,0,2000,2000,0,2000,0,0,0,-11000
057978,聯發科永豐98購05,0,0,0,0,0,0,0,0,0,-12000,0,0,0,720000,732000,-12000,-12000
05741P,聯發科元大96售14,0,0,0,0,0,0,0,0,0,-12000,0,0,0,115000,127000,-12000,-12000
057662,上銀元大9A購01  ,0,0,0,0,0,0,0,0,0,-12000,0,0,0,0,12000,-12000,-12000
058800,健策元大99購03  ,0,0,0,0,0,0,0,0,0,-12000,0,0,0,0,12000,-12000,-12000
058986,華新科凱基9A購03,0,0,0,0,0,0,0,0,0,-12000,0,0,0,0,12000,-12000,-12000
058358,技嘉凱基9A購01  ,0,0,0,0,0,0,0,0,0,-12000,0,0,0,0,12000,-12000,-12000
058567,華新科凱基9A購02,0,0,0,0,0,0,0,0,0,-12000,0,0,0,0,12000,-12000,-12000
06655P,TPK元大98售02   ,0,0,0,0,0,0,0,0,0,-12000,0,0,0,5000,17000,-12000,-12000
059187,國巨富邦9B購02  ,0,0,0,0,0,0,0,0,0,-12000,0,0,0,0,12000,-12000,-12000
06950P,鴻海統一9B售02  ,0,0,0,0,0,0,0,0,0,-12000,0,0,0,1000,13000,-12000,-12000
051380,禾伸堂群益95購01,0,0,0,0,0,0,0,0,0,-12000,0,0,0,0,12000,-12000,-12000
051603,深中小群益99購03,0,0,0,0,0,0,0,0,0,-12000,0,0,0,0,12000,-12000,-12000
055669,緯穎群益97購02  ,0,0,0,0,0,0,0,0,0,-12000,0,0,0,0,12000,-12000,-12000
052016,神基永豐95購01  ,0,0,0,0,0,0,0,0,0,-12000,0,0,0,0,12000,-12000,-12000
049694,華新科元大95購06,0,0,0,0,0,0,0,0,0,-12000,0,0,0,0,12000,-12000,-12000
048944,茂林永豐94購01  ,0,0,0,0,0,0,0,0,0,-12000,0,0,0,30000,42000,-12000,-12000
048311,台積電凱基93購28,0,0,0,0,0,0,0,0,0,-12000,0,0,0,481000,493000,-12000,-12000
03033X,元展30          ,0,0,0,0,0,0,0,0,0,-12000,0,0,0,2000,14000,-12000,-12000
044871,國巨統一93購05  ,0,0,0,0,0,0,0,0,0,-12000,0,0,0,0,12000,-12000,-12000
04618P,電子類群益94售02,0,0,0,0,0,0,0,0,0,-12000,0,0,0,45000,57000,-12000,-12000
046164,健策兆豐93購03  ,0,0,0,0,0,0,0,0,0,-12000,0,0,0,0,12000,-12000,-12000
050437,聯詠凱基94購04  ,0,0,0,0,0,0,0,0,0,-12000,0,0,0,0,12000,-12000,-12000
057058,祥碩元大98購04  ,0,0,0,0,0,0,0,0,0,-12000,0,0,0,72000,84000,-12000,-12000
055233,康友國票98購01  ,0,0,0,0,0,0,0,0,0,-12000,0,0,0,13000,25000,-12000,-12000
053725,晶相光凱基96購01,0,0,0,0,0,0,0,0,0,-12000,0,0,0,0,12000,-12000,-12000
053877,奇力新亞東96購01,0,0,0,0,0,0,0,0,0,-12000,0,0,0,0,12000,-12000,-12000
053831,台積電台新97購02,0,0,0,0,0,0,0,0,0,-12000,0,0,0,0,12000,-12000,-12000
05453P,智邦群益95售03  ,0,0,0,0,0,0,0,0,0,-12000,0,0,0,0,12000,-12000,-12000
053497,新光金兆豐97購01,0,0,0,0,0,0,0,0,0,-12000,0,0,0,0,12000,-12000,-12000
053302,國巨凱基96購10  ,0,0,0,0,0,0,0,0,0,-12000,0,0,0,0,12000,-12000,-12000
056513,臻鼎亞東99購01  ,0,0,0,0,0,0,0,0,0,-12000,0,0,0,10000,22000,-12000,-12000
056544,貿聯凱基98購03  ,0,0,0,0,0,0,0,0,0,-12000,0,0,0,0,12000,-12000,-12000
053134,南亞科國票97購01,0,0,0,0,0,0,0,0,0,-12000,0,0,0,0,12000,-12000,-12000
054258,牧德元大97購01  ,0,0,0,0,0,0,0,0,0,-12000,0,0,0,45000,57000,-12000,-12000
8478,東哥遊艇        ,7000,19000,-12000,0,0,0,0,0,0,0,0,0,0,0,0,0,-12000
8497,格威傳媒        ,0,12000,-12000,0,0,0,0,0,0,0,0,0,0,0,0,0,-12000
912000,晨訊科-DR       ,0,12000,-12000,0,0,0,0,0,0,0,0,0,0,0,0,0,-12000
2450,神腦            ,18000,36000,-18000,0,0,0,0,0,0,6000,6000,0,6000,0,0,0,-12000
1903,士紙            ,0,12000,-12000,0,0,0,0,0,0,0,0,0,0,0,0,0,-12000
4725,信昌化          ,56000,68000,-12000,0,0,0,0,0,0,0,0,0,0,0,0,0,-12000
06999P,玉晶光國票9B售01,0,0,0,0,0,0,0,0,0,-13000,0,0,0,0,13000,-13000,-13000
06837P,上銀統一9A售02  ,0,0,0,0,0,0,0,0,0,-13000,0,0,0,0,13000,-13000,-13000
07132P,臺股指元大99售11,0,0,0,0,0,0,0,0,0,-13000,0,0,0,0,13000,-13000,-13000
07120P,聯發科凱基99售09,0,0,0,0,0,0,0,0,0,-13000,0,0,0,0,13000,-13000,-13000
06525P,上証2X國泰99售01,0,0,0,0,0,0,0,0,0,-13000,0,0,0,2000,15000,-13000,-13000
058887,元石油元大9C購04,0,0,0,0,0,0,0,0,0,-13000,0,0,0,0,13000,-13000,-13000
020008,元大特股高息N   ,0,0,0,0,0,0,0,0,0,-13000,0,0,0,87000,100000,-13000,-13000
049857,緯穎群益94購03  ,0,0,0,0,0,0,0,0,0,-13000,0,0,0,0,13000,-13000,-13000
050612,台積電元大95購06,0,0,0,0,0,0,0,0,0,-13000,0,0,0,0,13000,-13000,-13000
055672,國巨日盛97購02  ,0,0,0,0,0,0,0,0,0,-13000,0,0,0,290000,303000,-13000,-13000
055497,開發金元大97購01,0,0,0,0,0,0,0,0,0,-13000,0,0,0,0,13000,-13000,-13000
051305,訊連凱基96購01  ,0,0,0,0,0,0,0,0,0,-13000,0,0,0,0,13000,-13000,-13000
054178,中磊台新97購01  ,0,0,0,0,0,0,0,0,0,-13000,0,0,0,7000,20000,-13000,-13000
055400,緯穎統一97購01  ,0,0,0,0,0,0,0,0,0,-13000,0,0,0,0,13000,-13000,-13000
054353,世紀鋼國泰98購01,0,0,0,0,0,0,0,0,0,-13000,0,0,0,241000,254000,-13000,-13000
056849,瀚宇博元富98購01,0,0,0,0,0,0,0,0,0,-13000,0,0,0,27000,40000,-13000,-13000
053542,超眾永豐96購01  ,0,0,0,0,0,0,0,0,0,-13000,0,0,0,0,13000,-13000,-13000
054428,禾伸堂富邦98購01,0,0,0,0,0,0,0,0,0,-13000,0,0,0,25000,38000,-13000,-13000
053984,康友元大96購05  ,0,0,0,0,0,0,0,0,0,-13000,0,0,0,0,13000,-13000,-13000
057145,上銀國票98購03  ,0,0,0,0,0,0,0,0,0,-13000,0,0,0,0,13000,-13000,-13000
057159,晶技永豐98購01  ,0,0,0,0,0,0,0,0,0,-13000,0,0,0,16000,29000,-13000,-13000
9937,全國            ,5000,10000,-5000,0,0,0,0,0,0,-8000,0,8000,-8000,0,0,0,-13000
058357,智邦凱基99購02  ,0,0,0,0,0,0,0,0,0,-14000,0,0,0,20000,34000,-14000,-14000
05845P,大立光元大96售06,0,0,0,0,0,0,0,0,0,-14000,0,0,0,19000,33000,-14000,-14000
06716P,台積電元大9A售02,0,0,0,0,0,0,0,0,0,-14000,0,0,0,207000,221000,-14000,-14000
07129P,華新科元大99售14,0,0,0,0,0,0,0,0,0,-14000,0,0,0,0,14000,-14000,-14000
1225,福懋油          ,2000,16000,-14000,0,0,0,0,0,0,0,0,0,0,0,0,0,-14000
1308,亞聚            ,252000,268000,-16000,0,0,0,0,0,0,2000,3000,1000,2000,0,0,0,-14000
1456,怡華            ,16000,30000,-14000,0,0,0,0,0,0,0,0,0,0,0,0,0,-14000
07013P,玉晶光群益9A售06,0,0,0,0,0,0,0,0,0,-14000,0,0,0,5000,19000,-14000,-14000
051567,台積電富邦95購06,0,0,0,0,0,0,0,0,0,-14000,0,0,0,0,14000,-14000,-14000
055714,智邦元大97購03  ,0,0,0,0,0,0,0,0,0,-14000,0,0,0,112000,126000,-14000,-14000
051608,新日興群益96購01,0,0,0,0,0,0,0,0,0,-14000,0,0,0,0,14000,-14000,-14000
049804,華固元大94購01  ,0,0,0,0,0,0,0,0,0,-14000,0,0,0,36000,50000,-14000,-14000
049969,泰鼎國票95購01  ,0,0,0,0,0,0,0,0,0,-14000,0,0,0,0,14000,-14000,-14000
03049X,元展46          ,0,0,0,0,0,0,0,0,0,-14000,0,0,0,0,14000,-14000,-14000
04786P,鴻海永昌96售01  ,0,0,0,0,0,0,0,0,0,-14000,0,0,0,0,14000,-14000,-14000
044927,聯詠國泰94購01  ,0,0,0,0,0,0,0,0,0,-14000,0,0,0,0,14000,-14000,-14000
04547P,高鐵元大94售01  ,0,0,0,0,0,0,0,0,0,-14000,0,0,0,6000,20000,-14000,-14000
04867P,美律統一94售03  ,0,0,0,0,0,0,0,0,0,-14000,0,0,0,0,14000,-14000,-14000
048788,華新科元大95購02,0,0,0,0,0,0,0,0,0,-14000,0,0,0,30000,44000,-14000,-14000
04878P,國巨康和94售02  ,0,0,0,0,0,0,0,0,0,-14000,0,0,0,98000,112000,-14000,-14000
05719P,可成元大96售03  ,0,0,0,0,0,0,0,0,0,-14000,0,0,0,27000,41000,-14000,-14000
057349,聯發科統一98購04,0,0,0,0,0,0,0,0,0,-14000,0,0,0,4000,18000,-14000,-14000
056909,嘉聯益元大99購03,0,0,0,0,0,0,0,0,0,-14000,0,0,0,1000,15000,-14000,-14000
053786,新日興元大96購02,0,0,0,0,0,0,0,0,0,-14000,0,0,0,20000,34000,-14000,-14000
053502,智伸科兆豐97購01,0,0,0,0,0,0,0,0,0,-14000,0,0,0,2000,16000,-14000,-14000
05271P,國巨富邦97售01  ,0,0,0,0,0,0,0,0,0,-14000,0,0,0,1000,15000,-14000,-14000
055288,日電貿元大97購02,0,0,0,0,0,0,0,0,0,-14000,0,0,0,1000,15000,-14000,-14000
056510,正文永豐98購02  ,0,0,0,0,0,0,0,0,0,-14000,0,0,0,10000,24000,-14000,-14000
6491,晶碩            ,64000,38000,26000,0,0,0,0,40000,-40000,0,0,0,0,0,0,0,-14000
6449,鈺邦            ,89000,103000,-14000,0,0,0,0,0,0,0,0,0,0,0,0,0,-14000
4536,拓凱            ,38000,53000,-15000,0,0,0,0,0,0,1000,0,0,0,1000,0,1000,-14000
2906,高林            ,8000,22000,-14000,0,0,0,0,0,0,0,0,0,0,0,0,0,-14000
3432,台端            ,0,14000,-14000,0,0,0,0,0,0,0,0,0,0,0,0,0,-14000
2302,麗正            ,10000,24000,-14000,0,0,0,0,0,0,0,0,0,0,0,0,0,-14000
2613,中櫃            ,4000,18000,-14000,0,0,0,0,0,0,0,0,0,0,0,0,0,-14000
2377,微星            ,2437000,3431920,-994920,0,0,0,429000,192000,237000,743000,113000,121000,-8000,782000,31000,751000,-14920
1441,大東            ,23000,38000,-15000,0,0,0,0,0,0,0,0,0,0,0,0,0,-15000
06636P,可成凱基98售08  ,0,0,0,0,0,0,0,0,0,-15000,0,0,0,111000,126000,-15000,-15000
058594,台灣50元富9B購03,0,0,0,0,0,0,0,0,0,-15000,0,0,0,0,15000,-15000,-15000
058648,聯陽永豐99購01  ,0,0,0,0,0,0,0,0,0,-15000,0,0,0,30000,45000,-15000,-15000
058809,國巨統一9B購03  ,0,0,0,0,0,0,0,0,0,-15000,0,0,0,0,15000,-15000,-15000
058987,華新科凱基9B購01,0,0,0,0,0,0,0,0,0,-15000,0,0,0,20000,35000,-15000,-15000
058989,茂林凱基99購02  ,0,0,0,0,0,0,0,0,0,-15000,0,0,0,10000,25000,-15000,-15000
058996,台達電元大99購02,0,0,0,0,0,0,0,0,0,-15000,0,0,0,5000,20000,-15000,-15000
057495,牧德元大99購04  ,0,0,0,0,0,0,0,0,0,-15000,0,0,0,0,15000,-15000,-15000
057601,中磊群益98購01  ,0,0,0,0,0,0,0,0,0,-15000,0,0,0,20000,35000,-15000,-15000
057569,光磊永豐98購03  ,0,0,0,0,0,0,0,0,0,-15000,0,0,0,0,15000,-15000,-15000
058146,勤誠元大99購01  ,0,0,0,0,0,0,0,0,0,-15000,0,0,0,0,15000,-15000,-15000
045331,旺宏群益94購01  ,0,0,0,0,0,0,0,0,0,-15000,0,0,0,5000,20000,-15000,-15000
045768,大立光元富95購02,0,0,0,0,0,0,0,0,0,-15000,0,0,0,0,15000,-15000,-15000
050245,大立光凱基94購12,0,0,0,0,0,0,0,0,0,-15000,0,0,0,0,15000,-15000,-15000
03035X,元展32          ,0,0,0,0,0,0,0,0,0,-15000,0,0,0,0,15000,-15000,-15000
048379,台郡元富96購01  ,0,0,0,0,0,0,0,0,0,-15000,0,0,0,5000,20000,-15000,-15000
048187,臺指反元大96購04,0,0,0,0,0,0,0,0,0,-15000,0,0,0,0,15000,-15000,-15000
050021,鴻海元大94購10  ,0,0,0,0,0,0,0,0,0,-15000,0,0,0,20000,35000,-15000,-15000
049447,聯電統一94購01  ,0,0,0,0,0,0,0,0,0,-15000,0,0,0,0,15000,-15000,-15000
055905,可成兆豐97購03  ,0,0,0,0,0,0,0,0,0,-15000,0,0,0,0,15000,-15000,-15000
052353,高鐵群益97購01  ,0,0,0,0,0,0,0,0,0,-15000,0,0,0,0,15000,-15000,-15000
05632P,大立光群益96售02,0,0,0,0,0,0,0,0,0,-15000,0,0,0,5000,20000,-15000,-15000
05539P,鎧勝永豐96售01  ,0,0,0,0,0,0,0,0,0,-15000,0,0,0,1000,16000,-15000,-15000
053143,昇陽半永豐96購03,0,0,0,0,0,0,0,0,0,-15000,0,0,0,0,15000,-15000,-15000
055738,玉山金元富97購01,0,0,0,0,0,0,0,0,0,-15000,0,0,0,10000,25000,-15000,-15000
052676,聯發科永昌98購01,0,0,0,0,0,0,0,0,0,-15000,0,0,0,0,15000,-15000,-15000
056792,訊芯群益98購01  ,0,0,0,0,0,0,0,0,0,-15000,0,0,0,0,15000,-15000,-15000
05299P,旺宏元大95售04  ,0,0,0,0,0,0,0,0,0,-15000,0,0,0,40000,55000,-15000,-15000
052991,台積電台新96購01,0,0,0,0,0,0,0,0,0,-15000,0,0,0,1018000,1033000,-15000,-15000
054933,南港元大97購01  ,0,0,0,0,0,0,0,0,0,-15000,0,0,0,0,15000,-15000,-15000
053489,上銀兆豐97購01  ,0,0,0,0,0,0,0,0,0,-15000,0,0,0,20000,35000,-15000,-15000
054593,滬深2X永昌9A購01,0,0,0,0,0,0,0,0,0,-15000,0,0,0,0,15000,-15000,-15000
053782,京元電元大98購02,0,0,0,0,0,0,0,0,0,-15000,0,0,0,0,15000,-15000,-15000
054128,台積電元大97購10,0,0,0,0,0,0,0,0,0,-15000,0,0,0,0,15000,-15000,-15000
054090,瑞昱群益97購01  ,0,0,0,0,0,0,0,0,0,-15000,0,0,0,0,15000,-15000,-15000
054102,百和國票97購04  ,0,0,0,0,0,0,0,0,0,-15000,0,0,0,0,15000,-15000,-15000
054058,晶豪科國票98購01,0,0,0,0,0,0,0,0,0,-15000,0,0,0,0,15000,-15000,-15000
053654,聯發科凱基98購01,0,0,0,0,0,0,0,0,0,-15000,0,0,0,0,15000,-15000,-15000
057004,滬深反中信9A購01,0,0,0,0,0,0,0,0,0,-15000,0,0,0,10000,25000,-15000,-15000
055167,友訊統一97購01  ,0,0,0,0,0,0,0,0,0,-15000,0,0,0,0,15000,-15000,-15000
055161,貿聯元大98購03  ,0,0,0,0,0,0,0,0,0,-15000,0,0,0,0,15000,-15000,-15000
055153,台光電元大98購02,0,0,0,0,0,0,0,0,0,-15000,0,0,0,10000,25000,-15000,-15000
057330,台積電國票99購03,0,0,0,0,0,0,0,0,0,-15000,0,0,0,0,15000,-15000,-15000
057340,玉晶光元富98購04,0,0,0,0,0,0,0,0,0,-15000,0,0,0,20000,35000,-15000,-15000
057261,瑞昱兆豐98購01  ,0,0,0,0,0,0,0,0,0,-15000,0,0,0,40000,55000,-15000,-15000
4755,三福化          ,1000,16000,-15000,0,0,0,0,0,0,0,1000,1000,0,0,0,0,-15000
5608,四維航          ,54000,69000,-15000,0,0,0,0,0,0,0,0,0,0,0,0,0,-15000
6581,鋼聯            ,6000,21000,-15000,0,0,0,0,0,0,0,0,0,0,0,0,0,-15000
058270,上緯控永豐99購01,0,0,0,0,0,0,0,0,0,-16000,0,0,0,0,16000,-16000,-16000
058245,訊連元大99購01  ,0,0,0,0,0,0,0,0,0,-16000,0,0,0,66000,82000,-16000,-16000
057908,國泰金亞東99購01,0,0,0,0,0,0,0,0,0,-16000,0,0,0,0,16000,-16000,-16000
058095,昇陽半元大98購03,0,0,0,0,0,0,0,0,0,-16000,0,0,0,0,16000,-16000,-16000
059084,鴻海元大99購24  ,0,0,0,0,0,0,0,0,0,-16000,0,0,0,66000,82000,-16000,-16000
058508,聯發科元大99購11,0,0,0,0,0,0,0,0,0,-16000,0,0,0,220000,236000,-16000,-16000
06588P,台積電元大98售11,0,0,0,0,0,0,0,0,0,-16000,0,0,0,172000,188000,-16000,-16000
059189,國泰金富邦9B購01,0,0,0,0,0,0,0,0,0,-16000,0,0,0,0,16000,-16000,-16000
06147P,國巨元大97售05  ,0,0,0,0,0,0,0,0,0,-16000,0,0,0,241000,257000,-16000,-16000
1806,冠軍            ,14000,32000,-18000,0,0,0,0,0,0,2000,3000,1000,2000,0,0,0,-16000
1423,利華            ,2000,18000,-16000,0,0,0,0,0,0,0,0,0,0,0,0,0,-16000
05236P,緯穎康和95售01  ,0,0,0,0,0,0,0,0,0,-16000,0,0,0,0,16000,-16000,-16000
055989,矽力元富9A購01  ,0,0,0,0,0,0,0,0,0,-16000,0,0,0,0,16000,-16000,-16000
055479,GIS凱基97購04   ,0,0,0,0,0,0,0,0,0,-16000,0,0,0,0,16000,-16000,-16000
04891P,友達元大94售01  ,0,0,0,0,0,0,0,0,0,-16000,0,0,0,0,16000,-16000,-16000
051139,康友永豐95購01  ,0,0,0,0,0,0,0,0,0,-16000,0,0,0,0,16000,-16000,-16000
042993,葡萄王元大94購01,0,0,0,0,0,0,0,0,0,-16000,0,0,0,35000,51000,-16000,-16000
04190P,大立光兆豐94售03,0,0,0,0,0,0,0,0,0,-16000,0,0,0,0,16000,-16000,-16000
047355,世紀鋼凱基94購01,0,0,0,0,0,0,0,0,0,-16000,0,0,0,98000,114000,-16000,-16000
048119,臺指反元大96購03,0,0,0,0,0,0,0,0,0,-16000,0,0,0,40000,56000,-16000,-16000
056910,超眾元大99購02  ,0,0,0,0,0,0,0,0,0,-16000,0,0,0,49000,65000,-16000,-16000
053561,玉晶光國泰98購01,0,0,0,0,0,0,0,0,0,-16000,0,0,0,7000,23000,-16000,-16000
054129,技嘉元大96購02  ,0,0,0,0,0,0,0,0,0,-16000,0,0,0,0,16000,-16000,-16000
053501,明泰兆豐96購01  ,0,0,0,0,0,0,0,0,0,-16000,0,0,0,50000,66000,-16000,-16000
052997,國巨康和96購01  ,0,0,0,0,0,0,0,0,0,-16000,0,0,0,0,16000,-16000,-16000
053392,致新元大96購01  ,0,0,0,0,0,0,0,0,0,-16000,0,0,0,110000,126000,-16000,-16000
053347,茂林國票98購01  ,0,0,0,0,0,0,0,0,0,-16000,0,0,0,0,16000,-16000,-16000
054157,國巨亞東96購01  ,0,0,0,0,0,0,0,0,0,-16000,0,0,0,0,16000,-16000,-16000
056271,嘉澤統一97購01  ,0,0,0,0,0,0,0,0,0,-16000,0,0,0,0,16000,-16000,-16000
6477,安集            ,140000,159000,-19000,0,0,0,1000,0,1000,2000,2000,0,2000,0,0,0,-16000
2373,震旦行          ,3000,22000,-19000,0,0,0,0,0,0,3000,3000,0,3000,0,0,0,-16000
2024,志聯            ,3000,19000,-16000,0,0,0,0,0,0,0,0,0,0,0,0,0,-16000
2701,萬企            ,0,16000,-16000,0,0,0,0,0,0,0,0,0,0,0,0,0,-16000
1445,大宇            ,4000,22000,-18000,0,0,0,0,0,0,1000,1000,0,1000,0,0,0,-17000
1524,耿鼎            ,7000,24000,-17000,0,0,0,0,0,0,0,0,0,0,0,0,0,-17000
058705,長榮航元大99購01,0,0,0,0,0,0,0,0,0,-17000,0,0,0,248000,265000,-17000,-17000
059058,可成凱基9B購01  ,0,0,0,0,0,0,0,0,0,-17000,0,0,0,0,17000,-17000,-17000
058979,上銀凱基99購04  ,0,0,0,0,0,0,0,0,0,-17000,0,0,0,0,17000,-17000,-17000
058850,華新科群益99購03,0,0,0,0,0,0,0,0,0,-17000,0,0,0,0,17000,-17000,-17000
057934,華新科群益98購07,0,0,0,0,0,0,0,0,0,-17000,0,0,0,0,17000,-17000,-17000
057492,大立光元大98購18,0,0,0,0,0,0,0,0,0,-17000,0,0,0,20000,37000,-17000,-17000
05017P,臺股指元大95售08,0,0,0,0,0,0,0,0,0,-17000,0,0,0,0,17000,-17000,-17000
047564,滬深2X國票99購01,0,0,0,0,0,0,0,0,0,-17000,0,0,0,0,17000,-17000,-17000
04756P,大立光元富94售08,0,0,0,0,0,0,0,0,0,-17000,0,0,0,18000,35000,-17000,-17000
050369,台積電元大94購23,0,0,0,0,0,0,0,0,0,-17000,0,0,0,123000,140000,-17000,-17000
00683L,元大美元指數正2 ,0,0,0,0,0,0,0,0,0,-17000,0,0,0,11000,28000,-17000,-17000
05105P,大立光台新95售02,0,0,0,0,0,0,0,0,0,-17000,0,0,0,3000,20000,-17000,-17000
05062P,大立光富邦98售03,0,0,0,0,0,0,0,0,0,-17000,0,0,0,3000,20000,-17000,-17000
055703,緯穎富邦98購01  ,0,0,0,0,0,0,0,0,0,-17000,0,0,0,250000,267000,-17000,-17000
05628P,茂林國票97售02  ,0,0,0,0,0,0,0,0,0,-17000,0,0,0,10000,27000,-17000,-17000
05634P,玉晶光台新97售01,0,0,0,0,0,0,0,0,0,-17000,0,0,0,80000,97000,-17000,-17000
056468,鴻海元大98購07  ,0,0,0,0,0,0,0,0,0,-17000,0,0,0,10000,27000,-17000,-17000
056427,上銀凱基98購03  ,0,0,0,0,0,0,0,0,0,-17000,0,0,0,0,17000,-17000,-17000
056578,智易元大99購02  ,0,0,0,0,0,0,0,0,0,-17000,0,0,0,10000,27000,-17000,-17000
055339,緯穎兆豐98購01  ,0,0,0,0,0,0,0,0,0,-17000,0,0,0,2000,19000,-17000,-17000
053391,嘉聯益元大99購01,0,0,0,0,0,0,0,0,0,-17000,0,0,0,0,17000,-17000,-17000
052610,貿聯元大97購01  ,0,0,0,0,0,0,0,0,0,-17000,0,0,0,0,17000,-17000,-17000
054862,群光群益97購01  ,0,0,0,0,0,0,0,0,0,-17000,0,0,0,0,17000,-17000,-17000
055215,智邦凱基98購02  ,0,0,0,0,0,0,0,0,0,-17000,0,0,0,10000,27000,-17000,-17000
2038,海光            ,8000,25000,-17000,0,0,0,0,0,0,0,0,0,0,0,0,0,-17000
6189,豐藝            ,84000,61000,23000,0,0,0,0,0,0,-40000,12000,52000,-40000,0,0,0,-17000
3167,大量            ,21000,38000,-17000,0,0,0,0,0,0,0,0,0,0,0,0,0,-17000
2939,凱羿-KY         ,23000,40000,-17000,0,0,0,0,0,0,0,0,0,0,0,0,0,-17000
8482,商億-KY         ,39000,56000,-17000,0,0,0,0,0,0,0,0,0,0,0,0,0,-17000
057667,可成元大99購01  ,0,0,0,0,0,0,0,0,0,-18000,0,0,0,30000,48000,-18000,-18000
058230,國巨元大99購11  ,0,0,0,0,0,0,0,0,0,-18000,0,0,0,0,18000,-18000,-18000
058314,欣興富邦9B購01  ,0,0,0,0,0,0,0,0,0,-18000,0,0,0,0,18000,-18000,-18000
058298,聯茂凱基99購05  ,0,0,0,0,0,0,0,0,0,-18000,0,0,0,6000,24000,-18000,-18000
058738,FBVIX中信03購04 ,0,4000,-4000,0,0,0,0,0,0,-14000,0,0,0,142000,156000,-14000,-18000
059080,亞泥元大99購01  ,0,0,0,0,0,0,0,0,0,-18000,0,0,0,0,18000,-18000,-18000
1466,聚隆            ,2000,19000,-17000,0,0,0,0,0,0,-1000,0,1000,-1000,0,0,0,-18000
1614,三洋電          ,14000,32000,-18000,0,0,0,0,0,0,0,0,0,0,0,0,0,-18000
1203,味王            ,13000,31000,-18000,0,0,0,0,0,0,0,0,0,0,0,0,0,-18000
06022P,緯穎永豐96售03  ,0,0,0,0,0,0,0,0,0,-18000,0,0,0,112000,130000,-18000,-18000
06544P,鴻海元大98售09  ,0,0,0,0,0,0,0,0,0,-18000,0,0,0,0,18000,-18000,-18000
06431P,新日興元大97售05,0,0,0,0,0,0,0,0,0,-18000,0,0,0,1000,19000,-18000,-18000
049611,緯穎兆豐95購02  ,0,0,0,0,0,0,0,0,0,-18000,0,0,0,10000,28000,-18000,-18000
04998P,京元電永豐95售01,0,0,0,0,0,0,0,0,0,-18000,0,0,0,12000,30000,-18000,-18000
04999P,南電永豐95售01  ,0,0,0,0,0,0,0,0,0,-18000,0,0,0,10000,28000,-18000,-18000
04450P,京元電凱基94售01,0,0,0,0,0,0,0,0,0,-18000,0,0,0,8000,26000,-18000,-18000
04753P,台積電統一94售11,0,0,0,0,0,0,0,0,0,-18000,0,0,0,2000,20000,-18000,-18000
044864,道瓊反國票96購01,0,8000,-8000,0,0,0,0,0,0,-10000,0,0,0,0,10000,-10000,-18000
056987,南茂群益98購01  ,0,0,0,0,0,0,0,0,0,-18000,0,0,0,3000,21000,-18000,-18000
054447,國泰金兆豐96購01,0,0,0,0,0,0,0,0,0,-18000,0,0,0,0,18000,-18000,-18000
053932,華新科統一96購03,0,0,0,0,0,0,0,0,0,-18000,0,0,0,0,18000,-18000,-18000
053316,友達群益9A購01  ,0,0,0,0,0,0,0,0,0,-18000,0,0,0,500000,518000,-18000,-18000
056845,揚明光元富98購01,0,0,0,0,0,0,0,0,0,-18000,0,0,0,20000,38000,-18000,-18000
056719,台虹永豐98購01  ,0,0,0,0,0,0,0,0,0,-18000,0,0,0,0,18000,-18000,-18000
05268P,玉晶光元大98售01,0,0,0,0,0,0,0,0,0,-18000,0,0,0,661000,679000,-18000,-18000
053278,禾伸堂元大96購01,0,0,0,0,0,0,0,0,0,-18000,0,0,0,15000,33000,-18000,-18000
055302,達方元大97購01  ,0,0,0,0,0,0,0,0,0,-18000,0,0,0,17000,35000,-18000,-18000
6579,研揚            ,8000,27000,-19000,0,0,0,0,0,0,1000,1000,0,1000,0,0,0,-18000
6698,旭暉應材        ,91000,15000,76000,0,0,0,0,99000,-99000,5000,5000,0,5000,0,0,0,-18000
2516,新建            ,12000,30000,-18000,0,0,0,0,0,0,0,0,0,0,0,0,0,-18000
07116P,台灣50麥證9A售02,0,0,0,10000,29000,-19000,0,0,0,-19000,0,0,0,10000,29000,-19000,-19000
07196P,大立光元大99售13,0,0,0,0,0,0,0,0,0,-19000,0,0,0,0,19000,-19000,-19000
1618,合機            ,9000,37000,-28000,0,0,0,0,0,0,9000,9000,0,9000,0,0,0,-19000
06913P,聯發科元大98售14,0,0,0,0,0,0,0,0,0,-19000,0,0,0,30000,49000,-19000,-19000
058276,道瓊指中信9C購01,0,0,0,0,0,0,0,0,0,-19000,0,0,0,0,19000,-19000,-19000
04713P,創意元大95售01  ,0,0,0,0,0,0,0,0,0,-19000,0,0,0,11000,30000,-19000,-19000
04796P,聯發科元大94售10,0,0,0,0,0,0,0,0,0,-19000,0,0,0,196000,215000,-19000,-19000
04643P,京元電凱基94售02,0,0,0,0,0,0,0,0,0,-19000,0,0,0,10000,29000,-19000,-19000
0051,元大中型100     ,0,0,0,0,0,0,0,0,0,-19000,0,0,0,1000,20000,-19000,-19000
050893,鴻海元大96購03  ,0,0,0,0,0,0,0,0,0,-19000,0,0,0,1000,20000,-19000,-19000
056593,台積電元富98購02,0,0,0,0,0,0,0,0,0,-19000,0,0,0,45000,64000,-19000,-19000
05358P,大立光元大95售09,0,0,0,0,0,0,0,0,0,-19000,0,0,0,28000,47000,-19000,-19000
057166,國巨元大99購06  ,0,0,0,0,0,0,0,0,0,-19000,0,0,0,8000,27000,-19000,-19000
057151,易華電國票99購01,0,0,0,0,0,0,0,0,0,-19000,0,0,0,9000,28000,-19000,-19000
056891,國巨元大99購03  ,0,0,0,0,0,0,0,0,0,-19000,0,0,0,20000,39000,-19000,-19000
2509,全坤建          ,6000,25000,-19000,0,0,0,0,0,0,0,0,0,0,0,0,0,-19000
2882B,國泰金乙特      ,0,43000,-43000,0,0,0,0,0,0,24000,24000,0,24000,0,0,0,-19000
2012,春雨            ,1000,19000,-18000,0,0,0,0,0,0,-1000,0,1000,-1000,0,0,0,-19000
3040,遠見            ,0,19000,-19000,0,0,0,0,0,0,0,0,0,0,0,0,0,-19000
5007,三星            ,18000,37000,-19000,0,0,0,0,0,0,0,0,0,0,0,0,0,-19000
058241,景碩元大99購05  ,0,0,0,0,0,0,0,0,0,-20000,0,0,0,0,20000,-20000,-20000
058244,神達元大99購02  ,0,0,0,0,0,0,0,0,0,-20000,0,0,0,0,20000,-20000,-20000
058182,日電貿國泰9A購01,0,0,0,0,0,0,0,0,0,-20000,0,0,0,0,20000,-20000,-20000
057877,神達元大99購01  ,0,0,0,0,0,0,0,0,0,-20000,0,0,0,0,20000,-20000,-20000
057878,台郡元大99購04  ,0,0,0,0,0,0,0,0,0,-20000,0,0,0,0,20000,-20000,-20000
058044,鴻海元大99購07  ,0,0,0,0,0,0,0,0,0,-20000,0,0,0,52000,72000,-20000,-20000
057717,友訊元富98購02  ,0,0,0,0,0,0,0,0,0,-20000,0,0,0,0,20000,-20000,-20000
057493,聯詠元大98購02  ,0,0,0,0,0,0,0,0,0,-20000,0,0,0,30000,50000,-20000,-20000
057450,國泰金元富98購01,0,0,0,0,0,0,0,0,0,-20000,0,0,0,39000,59000,-20000,-20000
059082,華通元大99購06  ,0,0,0,0,0,0,0,0,0,-20000,0,0,0,0,20000,-20000,-20000
059079,SGBR2X元大99購01,0,0,0,0,0,0,0,0,0,-20000,0,0,0,0,20000,-20000,-20000
059090,台新金元大99購01,0,0,0,0,0,0,0,0,0,-20000,0,0,0,0,20000,-20000,-20000
059024,大立光統一9B購04,0,0,0,0,0,0,0,0,0,-20000,0,0,0,0,20000,-20000,-20000
058736,鈺齊永豐99購02  ,0,0,0,0,0,0,0,0,0,-20000,0,0,0,0,20000,-20000,-20000
058840,T50反1群益99購02,0,0,0,0,0,0,0,0,0,-20000,0,0,0,10000,30000,-20000,-20000
058825,同欣電富邦9A購01,0,0,0,0,0,0,0,0,0,-20000,0,0,0,0,20000,-20000,-20000
058826,台積電永豐99購02,0,0,0,0,0,0,0,0,0,-20000,0,0,0,0,20000,-20000,-20000
058829,華新科永豐99購04,0,0,0,0,0,0,0,0,0,-20000,0,0,0,0,20000,-20000,-20000
058890,元油2X元大9C購06,0,0,0,0,0,0,0,0,0,-20000,0,0,0,40000,60000,-20000,-20000
058698,華通元大99購05  ,0,0,0,0,0,0,0,0,0,-20000,0,0,0,80000,100000,-20000,-20000
058649,健策永豐99購01  ,0,0,0,0,0,0,0,0,0,-20000,0,0,0,0,20000,-20000,-20000
058616,台虹元大9A購01  ,0,0,0,0,0,0,0,0,0,-20000,0,0,0,0,20000,-20000,-20000
058525,台虹元大99購02  ,0,0,0,0,0,0,0,0,0,-20000,0,0,0,0,20000,-20000,-20000
05857P,旺宏中信98售02  ,0,0,0,0,0,0,0,0,0,-20000,0,0,0,40000,60000,-20000,-20000
058470,台灣50日盛9B購02,0,0,0,0,0,0,0,0,0,-20000,0,0,0,0,20000,-20000,-20000
07127P,精元元大99售01  ,0,0,0,0,0,0,0,0,0,-20000,0,0,0,10000,30000,-20000,-20000
07150P,和碩元大99售01  ,0,0,0,0,0,0,0,0,0,-20000,0,0,0,0,20000,-20000,-20000
08865P,欣興元大01售02  ,0,0,0,0,0,0,0,0,0,-20000,0,0,0,0,20000,-20000,-20000
06336P,鴻海元大98售05  ,0,0,0,0,0,0,0,0,0,-20000,0,0,0,0,20000,-20000,-20000
06282P,聯鈞永豐97售02  ,0,0,0,0,0,0,0,0,0,-20000,0,0,0,0,20000,-20000,-20000
06638P,鴻海統一99售02  ,0,0,0,0,0,0,0,0,0,-20000,0,0,0,0,20000,-20000,-20000
06031P,新光金兆豐96售02,0,0,0,0,0,0,0,0,0,-20000,0,0,0,0,20000,-20000,-20000
059168,奇力新凱基99購05,0,0,0,0,0,0,0,0,0,-20000,0,0,0,0,20000,-20000,-20000
059096,百和元大99購04  ,0,0,0,0,0,0,0,0,0,-20000,0,0,0,0,20000,-20000,-20000
059089,聯發科元大99購19,0,0,0,0,0,0,0,0,0,-20000,0,0,0,60000,80000,-20000,-20000
059125,台積電第一03購02,0,0,0,0,0,0,0,0,0,-20000,0,0,0,100000,120000,-20000,-20000
059128,友達中信99購02  ,0,0,0,0,0,0,0,0,0,-20000,0,0,0,0,20000,-20000,-20000
059220,聯發科元大99購20,0,0,0,0,0,0,0,0,0,-20000,0,0,0,102000,122000,-20000,-20000
05936P,台積電凱基96售20,0,0,0,0,0,0,0,0,0,-20000,0,0,0,116000,136000,-20000,-20000
05924P,超眾元富96售04  ,0,0,0,0,0,0,0,0,0,-20000,0,0,0,0,20000,-20000,-20000
050892,聯電元大96購02  ,0,0,0,0,0,0,0,0,0,-20000,0,0,0,30000,50000,-20000,-20000
052333,嘉聯益兆豐96購01,0,0,0,0,0,0,0,0,0,-20000,0,0,0,0,20000,-20000,-20000
049090,茂林凱基94購01  ,0,0,0,0,0,0,0,0,0,-20000,0,0,0,40000,60000,-20000,-20000
051339,智易永豐95購02  ,0,0,0,0,0,0,0,0,0,-20000,0,0,0,0,20000,-20000,-20000
051302,可成凱基95購06  ,0,0,0,0,0,0,0,0,0,-20000,0,0,0,0,20000,-20000,-20000
051510,新光金中信97購01,0,0,0,0,0,0,0,0,0,-20000,0,0,0,0,20000,-20000,-20000
051572,上銀元大95購01  ,0,0,0,0,0,0,0,0,0,-20000,0,0,0,0,20000,-20000,-20000
051439,川湖元大95購01  ,0,0,0,0,0,0,0,0,0,-20000,0,0,0,0,20000,-20000,-20000
051509,鴻海中信97購01  ,0,0,0,0,0,0,0,0,0,-20000,0,0,0,0,20000,-20000,-20000
055709,深中小元大97購03,0,0,0,0,0,0,0,0,0,-20000,0,0,0,30000,50000,-20000,-20000
055681,奇鋐凱基98購03  ,0,0,0,0,0,0,0,0,0,-20000,0,0,0,0,20000,-20000,-20000
055661,亞德客中信98購01,0,0,0,0,0,0,0,0,0,-20000,0,0,0,15000,35000,-20000,-20000
055612,台光電國票97購04,0,0,0,0,0,0,0,0,0,-20000,0,0,0,0,20000,-20000,-20000
055629,華新科永豐97購04,0,0,0,0,0,0,0,0,0,-20000,0,0,0,0,20000,-20000,-20000
05563P,台積電元大97售07,0,0,0,0,0,0,0,0,0,-20000,0,0,0,250000,270000,-20000,-20000
055597,禾伸堂元大98購02,0,0,0,0,0,0,0,0,0,-20000,0,0,0,0,20000,-20000,-20000
055933,欣興群益98購02  ,0,0,0,0,0,0,0,0,0,-20000,0,0,0,0,20000,-20000,-20000
055934,景碩群益98購03  ,0,0,0,0,0,0,0,0,0,-20000,0,0,0,0,20000,-20000,-20000
051601,群創兆豐95購02  ,0,0,0,0,0,0,0,0,0,-20000,0,0,0,0,20000,-20000,-20000
055829,上銀元大97購06  ,0,0,0,0,0,0,0,0,0,-20000,0,0,0,0,20000,-20000,-20000
05582P,群創凱基98售06  ,0,0,0,0,0,0,0,0,0,-20000,0,0,0,0,20000,-20000,-20000
050022,鴻海元大94購11  ,0,0,0,0,0,0,0,0,0,-20000,0,0,0,0,20000,-20000,-20000
050036,矽格元大94購03  ,0,0,0,0,0,0,0,0,0,-20000,0,0,0,10000,30000,-20000,-20000
050061,聯發科凱基94購07,0,0,0,0,0,0,0,0,0,-20000,0,0,0,0,20000,-20000,-20000
049907,鴻海元大94購07  ,0,0,0,0,0,0,0,0,0,-20000,0,0,0,10000,30000,-20000,-20000
049908,鴻海元大94購08  ,0,0,0,0,0,0,0,0,0,-20000,0,0,0,10000,30000,-20000,-20000
049221,健策國票95購02  ,0,0,0,0,0,0,0,0,0,-20000,0,0,0,0,20000,-20000,-20000
051918,聯茂元大95購01  ,0,0,0,0,0,0,0,0,0,-20000,0,0,0,40000,60000,-20000,-20000
050547,華新科凱基95購01,0,0,0,0,0,0,0,0,0,-20000,0,0,0,0,20000,-20000,-20000
052013,台積電永豐95購04,0,0,0,0,0,0,0,0,0,-20000,0,0,0,0,20000,-20000,-20000
051775,旺宏亞東95購01  ,0,0,0,0,0,0,0,0,0,-20000,0,0,0,0,20000,-20000,-20000
052201,超眾統一96購01  ,0,0,0,0,0,0,0,0,0,-20000,0,0,0,0,20000,-20000,-20000
051677,達方元大95購01  ,0,0,0,0,0,0,0,0,0,-20000,0,0,0,0,20000,-20000,-20000
050754,元金2X元富9B購01,0,0,0,0,0,0,0,0,0,-20000,0,0,0,20000,40000,-20000,-20000
050714,深中小群益98購01,0,0,0,0,0,0,0,0,0,-20000,0,0,0,0,20000,-20000,-20000
050788,台郡國泰96購01  ,0,0,0,0,0,0,0,0,0,-20000,0,0,0,10000,30000,-20000,-20000
04365P,台積電元富95售02,0,0,0,0,0,0,0,0,0,-20000,0,0,0,110000,130000,-20000,-20000
03021P,玉晶光群益02售25,0,0,0,0,0,0,0,0,0,-20000,0,0,0,340000,360000,-20000,-20000
03017X,元展17          ,0,0,0,0,0,0,0,0,0,-20000,0,0,0,0,20000,-20000,-20000
044104,鴻海中信95購03  ,0,0,0,0,0,0,0,0,0,-20000,0,0,0,0,20000,-20000,-20000
044302,智邦兆豐93購02  ,0,0,0,0,0,0,0,0,0,-20000,0,0,0,0,20000,-20000,-20000
048653,巨大元大96購02  ,0,0,0,0,0,0,0,0,0,-20000,0,0,0,0,20000,-20000,-20000
048648,祥碩元大93購03  ,0,0,0,0,0,0,0,0,0,-20000,0,0,0,0,20000,-20000,-20000
048305,深100凱基96購01 ,0,0,0,0,0,0,0,0,0,-20000,0,0,0,0,20000,-20000,-20000
048552,鴻海元大94購03  ,0,0,0,0,0,0,0,0,0,-20000,0,0,0,7000,27000,-20000,-20000
03102P,臺股指凱基03售08,0,0,0,0,0,0,0,0,0,-20000,0,0,0,0,20000,-20000,-20000
046390,旺宏統一94購02  ,0,0,0,0,0,0,0,0,0,-20000,0,0,0,0,20000,-20000,-20000
047468,為升中信95購01  ,0,0,0,0,0,0,0,0,0,-20000,0,0,0,0,20000,-20000,-20000
046862,台郡元大94購01  ,0,0,0,0,0,0,0,0,0,-20000,0,0,0,0,20000,-20000,-20000
050167,T50反1富邦96購01,0,0,0,0,0,0,0,0,0,-20000,0,0,0,0,20000,-20000,-20000
050243,華新科凱基94購10,0,0,0,0,0,0,0,0,0,-20000,0,0,0,0,20000,-20000,-20000
050266,兆豐金元大94購01,0,0,0,0,0,0,0,0,0,-20000,0,0,0,0,20000,-20000,-20000
050493,聯發科永昌96購01,0,0,0,0,0,0,0,0,0,-20000,0,0,0,0,20000,-20000,-20000
050550,大立光凱基95購04,0,0,0,0,0,0,0,0,0,-20000,0,0,0,0,20000,-20000,-20000
04785P,鴻海永豐94售03  ,0,0,0,0,0,0,0,0,0,-20000,0,0,0,0,20000,-20000,-20000
048010,嘉聯益富邦97購01,0,0,0,0,0,0,0,0,0,-20000,0,0,0,0,20000,-20000,-20000
047774,台表科元大95購01,0,0,0,0,0,0,0,0,0,-20000,0,0,0,10000,30000,-20000,-20000
04487P,南亞科凱基94售01,0,0,0,0,0,0,0,0,0,-20000,0,0,0,10000,30000,-20000,-20000
045172,欣興兆豐94購01  ,0,0,0,0,0,0,0,0,0,-20000,0,0,0,0,20000,-20000,-20000
048738,台積電統一94購04,0,0,0,0,0,0,0,0,0,-20000,0,0,0,0,20000,-20000,-20000
057057,立積元大9A購01  ,0,0,0,0,0,0,0,0,0,-20000,0,0,0,0,20000,-20000,-20000
054854,台積電麥證97購01,0,0,0,0,20000,-20000,0,0,0,-20000,0,0,0,0,20000,-20000,-20000
057010,景碩中信98購01  ,0,0,0,0,0,0,0,0,0,-20000,0,0,0,0,20000,-20000,-20000
054788,華新科群益98購02,0,0,0,0,0,0,0,0,0,-20000,0,0,0,0,20000,-20000,-20000
054820,新日興元大97購01,0,0,0,0,0,0,0,0,0,-20000,0,0,0,0,20000,-20000,-20000
055186,正文統一97購01  ,0,0,0,0,0,0,0,0,0,-20000,0,0,0,0,20000,-20000,-20000
055131,茂林康和97購01  ,0,0,0,0,0,0,0,0,0,-20000,0,0,0,0,20000,-20000,-20000
057164,國巨元大98購14  ,0,0,0,0,0,0,0,0,0,-20000,0,0,0,10000,30000,-20000,-20000
057178,可成元大98購03  ,0,0,0,0,0,0,0,0,0,-20000,0,0,0,45000,65000,-20000,-20000
057179,可成元大98購04  ,0,0,0,0,0,0,0,0,0,-20000,0,0,0,103000,123000,-20000,-20000
057195,南茂元大98購01  ,0,0,0,0,0,0,0,0,0,-20000,0,0,0,19000,39000,-20000,-20000
057215,友達群益98購03  ,0,0,0,0,0,0,0,0,0,-20000,0,0,0,0,20000,-20000,-20000
056962,技嘉永豐98購01  ,0,0,0,0,0,0,0,0,0,-20000,0,0,0,0,20000,-20000,-20000
056948,旺宏統一9A購01  ,0,0,0,0,0,0,0,0,0,-20000,0,0,0,0,20000,-20000,-20000
057277,可成元大98購05  ,0,0,0,0,0,0,0,0,0,-20000,0,0,0,10000,30000,-20000,-20000
057248,台積電統一98購08,0,0,0,0,0,0,0,0,0,-20000,0,0,0,0,20000,-20000,-20000
057233,聯發科凱基98購14,0,0,0,0,0,0,0,0,0,-20000,0,0,0,0,20000,-20000,-20000
057316,國巨凱基99購04  ,0,0,0,0,0,0,0,0,0,-20000,0,0,0,0,20000,-20000,-20000
057370,可成元大98購07  ,0,0,0,0,0,0,0,0,0,-20000,0,0,0,10000,30000,-20000,-20000
057378,康友元大98購02  ,0,0,0,0,0,0,0,0,0,-20000,0,0,0,10000,30000,-20000,-20000
057352,大立光統一9A購02,0,0,0,0,0,0,0,0,0,-20000,0,0,0,0,20000,-20000,-20000
057354,聯鈞統一99購03  ,0,0,0,0,0,0,0,0,0,-20000,0,0,0,0,20000,-20000,-20000
053546,台積電凱基96購13,0,0,0,0,0,0,0,0,0,-20000,0,0,0,0,20000,-20000,-20000
054066,緯穎國票97購03  ,0,0,0,0,0,0,0,0,0,-20000,0,0,0,0,20000,-20000,-20000
054017,茂林永豐96購02  ,0,0,0,0,0,0,0,0,0,-20000,0,0,0,40000,60000,-20000,-20000
053938,彩晶元富96購01  ,0,0,0,0,0,0,0,0,0,-20000,0,0,0,0,20000,-20000,-20000
053948,大立光富邦99購04,0,0,0,0,0,0,0,0,0,-20000,0,0,0,0,20000,-20000,-20000
053898,康友群益97購01  ,0,0,0,0,0,0,0,0,0,-20000,0,0,0,0,20000,-20000,-20000
053797,台積電中信98購01,0,0,0,0,0,0,0,0,0,-20000,0,0,0,0,20000,-20000,-20000
053798,台積電中信98購02,0,0,0,0,0,0,0,0,0,-20000,0,0,0,0,20000,-20000,-20000
053784,奇力新元大97購02,0,0,0,0,0,0,0,0,0,-20000,0,0,0,40000,60000,-20000,-20000
053773,上銀元大96購04  ,0,0,0,0,0,0,0,0,0,-20000,0,0,0,0,20000,-20000,-20000
054905,國揚康和97購01  ,0,0,0,0,0,0,0,0,0,-20000,0,0,0,0,20000,-20000,-20000
054937,國巨元大97購03  ,0,0,0,0,0,0,0,0,0,-20000,0,0,0,0,20000,-20000,-20000
054924,景碩凱基98購01  ,0,0,0,0,0,0,0,0,0,-20000,0,0,0,0,20000,-20000,-20000
054952,大毅元大97購02  ,0,0,0,0,0,0,0,0,0,-20000,0,0,0,40000,60000,-20000,-20000
054974,台表科元大98購02,0,0,0,0,0,0,0,0,0,-20000,0,0,0,10000,30000,-20000,-20000
053509,華新群益98購01  ,0,0,0,0,0,0,0,0,0,-20000,0,0,0,0,20000,-20000,-20000
053525,台積電中信96購04,0,0,0,0,0,0,0,0,0,-20000,0,0,0,0,20000,-20000,-20000
054652,裕隆麥證97購01  ,0,0,0,0,20000,-20000,0,0,0,-20000,0,0,0,0,20000,-20000,-20000
054714,和鑫台新98購01  ,0,0,0,0,0,0,0,0,0,-20000,0,0,0,0,20000,-20000,-20000
054683,川湖永豐97購01  ,0,0,0,0,0,0,0,0,0,-20000,0,0,0,0,20000,-20000,-20000
054514,道瓊銀元大98購01,0,0,0,0,0,0,0,0,0,-20000,0,0,0,84000,104000,-20000,-20000
052413,上証反中信97購01,0,0,0,0,0,0,0,0,0,-20000,0,0,0,115000,135000,-20000,-20000
052453,崇越元大95購01  ,0,0,0,0,0,0,0,0,0,-20000,0,0,0,0,20000,-20000,-20000
056574,亞光元大99購03  ,0,0,0,0,0,0,0,0,0,-20000,0,0,0,0,20000,-20000,-20000
056564,亞光群益98購02  ,0,0,0,0,0,0,0,0,0,-20000,0,0,0,0,20000,-20000,-20000
056408,奇鋐國票99購01  ,0,0,0,0,0,0,0,0,0,-20000,0,0,0,0,20000,-20000,-20000
056316,訊芯元大98購03  ,0,0,0,0,0,0,0,0,0,-20000,0,0,0,0,20000,-20000,-20000
055298,啟碁元大97購02  ,0,0,0,0,0,0,0,0,0,-20000,0,0,0,0,20000,-20000,-20000
054272,華通中信98購01  ,0,0,0,0,0,0,0,0,0,-20000,0,0,0,0,20000,-20000,-20000
054245,鴻海元大96購23  ,0,0,0,0,0,0,0,0,0,-20000,0,0,0,0,20000,-20000,-20000
055287,日電貿元大97購01,0,0,0,0,0,0,0,0,0,-20000,0,0,0,0,20000,-20000,-20000
055265,玉晶光永豐98購03,0,0,0,0,0,0,0,0,0,-20000,0,0,0,5000,25000,-20000,-20000
05526P,茂林群益96售03  ,0,0,0,0,0,0,0,0,0,-20000,0,0,0,0,20000,-20000,-20000
054161,友訊凱基98購01  ,0,0,0,0,0,0,0,0,0,-20000,0,0,0,0,20000,-20000,-20000
054162,光罩凱基98購01  ,0,0,0,0,0,0,0,0,0,-20000,0,0,0,0,20000,-20000,-20000
054191,香港2X中信98購01,0,0,0,0,0,0,0,0,0,-20000,0,0,0,0,20000,-20000,-20000
056137,聯鈞元大9A購01  ,0,0,0,0,0,0,0,0,0,-20000,0,0,0,0,20000,-20000,-20000
055828,上銀元大97購05  ,0,0,0,0,0,0,0,0,0,-20000,0,0,0,8000,28000,-20000,-20000
054347,上緯控國票96購02,0,0,0,0,0,0,0,0,0,-20000,0,0,0,0,20000,-20000,-20000
054368,鴻海中信9A購02  ,0,0,0,0,0,0,0,0,0,-20000,0,0,0,0,20000,-20000,-20000
054369,鴻海中信9C購01  ,0,0,0,0,0,0,0,0,0,-20000,0,0,0,0,20000,-20000,-20000
054342,亞光元富99購01  ,0,0,0,0,0,0,0,0,0,-20000,0,0,0,0,20000,-20000,-20000
052739,國巨元大96購04  ,0,0,0,0,0,0,0,0,0,-20000,0,0,0,0,20000,-20000,-20000
052661,奇力新國票97購03,0,0,0,0,0,0,0,0,0,-20000,0,0,0,0,20000,-20000,-20000
056731,國巨凱基98購04  ,0,0,0,0,0,0,0,0,0,-20000,0,0,0,0,20000,-20000,-20000
056697,緯穎群益98購01  ,0,0,0,0,0,0,0,0,0,-20000,0,0,0,0,20000,-20000,-20000
056703,群創國泰9A購01  ,0,0,0,0,0,0,0,0,0,-20000,0,0,0,0,20000,-20000,-20000
056847,佐登元富98購01  ,0,0,0,0,0,0,0,0,0,-20000,0,0,0,10000,30000,-20000,-20000
056366,玉晶光元大99購04,0,0,0,0,0,0,0,0,0,-20000,0,0,0,0,20000,-20000,-20000
056367,祥碩元大98購01  ,0,0,0,0,0,0,0,0,0,-20000,0,0,0,0,20000,-20000,-20000
053192,創意統一96購01  ,0,0,0,0,0,0,0,0,0,-20000,0,0,0,0,20000,-20000,-20000
053224,矽力凱基96購02  ,0,0,0,0,0,0,0,0,0,-20000,0,0,0,0,20000,-20000,-20000
053271,喬山元大97購01  ,0,0,0,0,0,0,0,0,0,-20000,0,0,0,10000,30000,-20000,-20000
053398,和鑫中信99購01  ,0,0,0,0,0,0,0,0,0,-20000,0,0,0,0,20000,-20000,-20000
053380,南亞科元大97購01,0,0,0,0,0,0,0,0,0,-20000,0,0,0,0,20000,-20000,-20000
053370,上証2X元大97購03,0,0,0,0,0,0,0,0,0,-20000,0,0,0,0,20000,-20000,-20000
054424,大成鋼富邦97購02,0,0,0,0,0,0,0,0,0,-20000,0,0,0,0,20000,-20000,-20000
053439,台積電凱基96購11,0,0,0,0,0,0,0,0,0,-20000,0,0,0,0,20000,-20000,-20000
053029,國巨第一96購01  ,0,0,0,0,0,0,0,0,0,-20000,0,0,0,0,20000,-20000,-20000
052971,京元電群益98購01,0,0,0,0,0,0,0,0,0,-20000,0,0,0,0,20000,-20000,-20000
052934,中磊元大96購01  ,0,0,0,0,0,0,0,0,0,-20000,0,0,0,0,20000,-20000,-20000
052826,嘉聯益永豐96購01,0,0,0,0,0,0,0,0,0,-20000,0,0,0,0,20000,-20000,-20000
052838,新唐國泰98購01  ,0,0,0,0,0,0,0,0,0,-20000,0,0,0,0,20000,-20000,-20000
052845,旺宏統一97購01  ,0,0,0,0,0,0,0,0,0,-20000,0,0,0,0,20000,-20000,-20000
3002,歐格            ,18000,31000,-13000,0,0,0,0,0,0,-7000,3000,10000,-7000,0,0,0,-20000
2497,怡利電          ,2000,23000,-21000,0,0,0,0,0,0,1000,1000,0,1000,0,0,0,-20000
06649P,聯發科元大98售08,0,0,0,0,0,0,0,0,0,-21000,0,0,0,133000,154000,-21000,-21000
07081P,南電群益9A售01  ,0,0,0,0,0,0,0,0,0,-21000,0,0,0,0,21000,-21000,-21000
058960,臺股指國票99購05,0,0,0,0,0,0,0,0,0,-21000,0,0,0,11000,32000,-21000,-21000
058901,美律元大99購07  ,0,0,0,0,0,0,0,0,0,-21000,0,0,0,62000,83000,-21000,-21000
057783,台積電國票9A購01,0,0,0,0,0,0,0,0,0,-21000,0,0,0,0,21000,-21000,-21000
058005,茂林群益98購04  ,0,0,0,0,0,0,0,0,0,-21000,0,0,0,0,21000,-21000,-21000
04592P,台積電元大94售10,0,0,0,0,0,0,0,0,0,-21000,0,0,0,84000,105000,-21000,-21000
051805,元黃金凱基97購02,0,0,0,0,0,0,0,0,0,-21000,0,0,0,0,21000,-21000,-21000
00661,元大日經225     ,0,0,0,0,0,0,0,0,0,-21000,0,0,0,2000,23000,-21000,-21000
050610,鴻海元大94購24  ,0,0,0,0,0,0,0,0,0,-21000,0,0,0,0,21000,-21000,-21000
049339,鴻海統一94購02  ,0,0,0,0,0,0,0,0,0,-21000,0,0,0,0,21000,-21000,-21000
049671,上証2X富邦95購01,0,0,0,0,0,0,0,0,0,-21000,0,0,0,0,21000,-21000,-21000
05565P,鎧勝元大96售01  ,0,0,0,0,0,0,0,0,0,-21000,0,0,0,0,21000,-21000,-21000
05088P,大立光富邦99售01,0,0,0,0,0,0,0,0,0,-21000,0,0,0,0,21000,-21000,-21000
052813,T50正2永豐96購01,0,0,0,0,0,0,0,0,0,-21000,0,0,0,0,21000,-21000,-21000
056696,茂林群益98購02  ,0,0,0,0,0,0,0,0,0,-21000,0,0,0,0,21000,-21000,-21000
055805,矽力永豐97購01  ,0,0,0,0,0,0,0,0,0,-21000,0,0,0,0,21000,-21000,-21000
055757,大成鋼群益99購01,0,0,0,0,0,0,0,0,0,-21000,0,0,0,0,21000,-21000,-21000
056114,台達電群益97購02,0,0,0,0,0,0,0,0,0,-21000,0,0,0,0,21000,-21000,-21000
056069,新日興元大97購03,0,0,0,0,0,0,0,0,0,-21000,0,0,0,100000,121000,-21000,-21000
056575,禾伸堂元大99購01,0,0,0,0,0,0,0,0,0,-21000,0,0,0,142000,163000,-21000,-21000
054932,台肥元大97購01  ,0,0,0,0,0,0,0,0,0,-21000,0,0,0,11000,32000,-21000,-21000
05699P,茂林凱基96售05  ,0,0,0,0,0,0,0,0,0,-21000,0,0,0,342000,363000,-21000,-21000
5525,順天            ,27000,48000,-21000,0,0,0,0,0,0,0,0,0,0,0,0,0,-21000
057962,超眾元大99購03  ,0,0,0,0,0,0,0,0,0,-22000,0,0,0,10000,32000,-22000,-22000
057888,貿聯群益98購02  ,0,0,0,0,0,0,0,0,0,-22000,0,0,0,0,22000,-22000,-22000
057501,超眾群益98購04  ,0,0,0,0,0,0,0,0,0,-22000,0,0,0,0,22000,-22000,-22000
058507,美律元大9A購01  ,0,0,0,0,0,0,0,0,0,-22000,0,0,0,22000,44000,-22000,-22000
06033P,可成凱基96售09  ,0,0,0,0,0,0,0,0,0,-22000,0,0,0,260000,282000,-22000,-22000
052309,健策國泰97購01  ,0,0,0,0,0,0,0,0,0,-22000,0,0,0,0,22000,-22000,-22000
055890,鴻海統一99購01  ,0,0,0,0,0,0,0,0,0,-22000,0,0,0,0,22000,-22000,-22000
055932,玉山金群益99購01,0,0,0,0,0,0,0,0,0,-22000,0,0,0,0,22000,-22000,-22000
049723,緯穎凱基94購04  ,0,0,0,0,0,0,0,0,0,-22000,0,0,0,0,22000,-22000,-22000
050818,華新科凱基95購02,0,0,0,0,0,0,0,0,0,-22000,0,0,0,120000,142000,-22000,-22000
03022X,富展01          ,0,0,0,0,0,0,0,0,0,-22000,0,0,0,0,22000,-22000,-22000
04518P,高鐵群益95售01  ,0,0,0,0,0,0,0,0,0,-22000,0,0,0,3000,25000,-22000,-22000
045750,鈺齊富邦94購01  ,0,0,0,0,0,0,0,0,0,-22000,0,0,0,0,22000,-22000,-22000
048783,國巨元大94購01  ,0,0,0,0,0,0,0,0,0,-22000,0,0,0,3000,25000,-22000,-22000
054742,京鼎凱基99購01  ,0,0,0,0,0,0,0,0,0,-22000,0,0,0,0,22000,-22000,-22000
053521,緯穎群益96購02  ,0,0,0,0,0,0,0,0,0,-22000,0,0,0,7000,29000,-22000,-22000
056560,旺宏群益98購03  ,0,0,0,0,0,0,0,0,0,-22000,0,0,0,0,22000,-22000,-22000
056647,晶技凱基98購02  ,0,0,0,0,0,0,0,0,0,-22000,0,0,0,2000,24000,-22000,-22000
056843,冠德元富98購01  ,0,0,0,0,0,0,0,0,0,-22000,0,0,0,14000,36000,-22000,-22000
054349,同欣電國票97購02,0,0,0,0,0,0,0,0,0,-22000,0,0,0,0,22000,-22000,-22000
052768,泰鼎群益96購01  ,0,0,0,0,0,0,0,0,0,-22000,0,0,0,23000,45000,-22000,-22000
3311,閎暉            ,18000,42000,-24000,0,0,0,0,0,0,2000,2000,0,2000,0,0,0,-22000
3588,通嘉            ,58000,80000,-22000,0,0,0,0,0,0,0,0,0,0,0,0,0,-22000
2034,允強            ,222020,247000,-24980,0,0,0,0,0,0,2000,3000,1000,2000,0,0,0,-22980
06704P,玉晶光元富98售05,0,0,0,0,0,0,0,0,0,-23000,0,0,0,27000,50000,-23000,-23000
07048P,台積電中信03售01,0,0,0,0,0,0,0,0,0,-23000,0,0,0,13000,36000,-23000,-23000
07137P,大立光中信9B售01,0,0,0,0,0,0,0,0,0,-23000,0,0,0,0,23000,-23000,-23000
1568,倉佑            ,17000,40000,-23000,0,0,0,0,0,0,0,0,0,0,0,0,0,-23000
058734,康友永豐99購01  ,0,0,0,0,0,0,0,0,0,-23000,0,0,0,0,23000,-23000,-23000
057479,致茂元大98購03  ,0,0,0,0,0,0,0,0,0,-23000,0,0,0,10000,33000,-23000,-23000
057762,全新凱基99購03  ,0,0,0,0,0,0,0,0,0,-23000,0,0,0,0,23000,-23000,-23000
052598,滬深2X元大96購05,0,0,0,0,0,0,0,0,0,-23000,0,0,0,0,23000,-23000,-23000
056656,華邦電元大98購02,0,0,0,0,0,0,0,0,0,-23000,0,0,0,30000,53000,-23000,-23000
057348,台積電統一98購09,0,0,0,0,0,0,0,0,0,-23000,0,0,0,0,23000,-23000,-23000
057331,台積電國票99購04,0,0,0,0,0,0,0,0,0,-23000,0,0,0,0,23000,-23000,-23000
057392,福懋科永豐98購01,0,0,0,0,0,0,0,0,0,-23000,0,0,0,0,23000,-23000,-23000
3266,昇陽            ,9000,32000,-23000,0,0,0,0,0,0,0,0,0,0,0,0,0,-23000
3055,蔚華科          ,12000,35000,-23000,0,0,0,0,0,0,0,0,0,0,0,0,0,-23000
6191,精成科          ,696000,725000,-29000,0,0,0,0,0,0,6000,9000,1000,8000,0,2000,-2000,-23000
058206,祥碩凱基99購01  ,0,0,0,0,0,0,0,0,0,-24000,0,0,0,7000,31000,-24000,-24000
058922,聯發科元富03購02,0,0,0,0,0,0,0,0,0,-24000,0,0,0,25000,49000,-24000,-24000
058477,億光凱基9A購01  ,0,0,0,0,0,0,0,0,0,-24000,0,0,0,68000,92000,-24000,-24000
1515,力山            ,701000,717000,-16000,0,0,0,0,0,0,-8000,0,0,0,1000,9000,-8000,-24000
06931P,大立光元大98售20,0,0,0,0,0,0,0,0,0,-24000,0,0,0,0,24000,-24000,-24000
046905,新光金凱基99購01,0,0,0,0,0,0,0,0,0,-24000,0,0,0,0,24000,-24000,-24000
047211,華新科富邦99購01,0,0,0,0,0,0,0,0,0,-24000,0,0,0,0,24000,-24000,-24000
03417B,臺股指凱基95熊19,0,0,0,0,0,0,0,0,0,-24000,0,0,0,15000,39000,-24000,-24000
04847P,聯發科凱基94售17,0,0,0,0,0,0,0,0,0,-24000,0,0,0,0,24000,-24000,-24000
048283,亞德客中信94購01,0,0,0,0,0,0,0,0,0,-24000,0,0,0,16000,40000,-24000,-24000
055716,致茂元大97購01  ,0,0,0,0,0,0,0,0,0,-24000,0,0,0,36000,60000,-24000,-24000
051486,玉晶光凱基97購03,0,0,0,0,0,0,0,0,0,-24000,0,0,0,0,24000,-24000,-24000
054634,FB上証中信99購01,0,0,0,0,0,0,0,0,0,-24000,0,0,0,0,24000,-24000,-24000
053731,矽創凱基96購03  ,0,0,0,0,0,0,0,0,0,-24000,0,0,0,0,24000,-24000,-24000
053969,瑞昱元大97購01  ,0,0,0,0,0,0,0,0,0,-24000,0,0,0,0,24000,-24000,-24000
054111,緯穎凱基97購01  ,0,0,0,0,0,0,0,0,0,-24000,0,0,0,0,24000,-24000,-24000
054195,亞泥國泰98購01  ,0,0,0,0,0,0,0,0,0,-24000,0,0,0,96000,120000,-24000,-24000
4952,凌通            ,43000,68000,-25000,0,0,0,0,0,0,1000,2000,1000,1000,0,0,0,-24000
3050,鈺德            ,30000,54000,-24000,0,0,0,0,0,0,0,0,0,0,0,0,0,-24000
3583,辛耘            ,107000,133000,-26000,0,0,0,0,0,0,2000,2000,0,2000,0,0,0,-24000
2020,美亞            ,47000,71000,-24000,0,0,0,0,0,0,0,0,0,0,0,0,0,-24000
2496,卓越            ,1000,25000,-24000,0,0,0,0,0,0,0,0,0,0,0,0,0,-24000
07043P,國巨元大99售14  ,0,0,0,0,0,0,0,0,0,-25000,0,0,0,3000,28000,-25000,-25000
06597P,國巨富邦9A售05  ,0,0,0,0,0,0,0,0,0,-25000,0,0,0,1000,26000,-25000,-25000
06421P,嘉澤統一97售02  ,0,0,0,0,0,0,0,0,0,-25000,0,0,0,0,25000,-25000,-25000
059137,電子類群益99購01,0,0,0,0,0,0,0,0,0,-25000,0,0,0,0,25000,-25000,-25000
059131,國巨群益99購07  ,0,0,0,0,0,0,0,0,0,-25000,0,0,0,10000,35000,-25000,-25000
058655,鴻海中信03購02  ,0,0,0,0,0,0,0,0,0,-25000,0,0,0,0,25000,-25000,-25000
058847,國巨群益99購05  ,0,0,0,0,0,0,0,0,0,-25000,0,0,0,10000,35000,-25000,-25000
058231,技嘉元大99購02  ,0,0,0,0,0,0,0,0,0,-25000,0,0,0,5000,30000,-25000,-25000
058274,世紀鋼永豐99購01,0,0,0,0,0,0,0,0,0,-25000,0,0,0,4000,29000,-25000,-25000
058309,大毅元大99購02  ,0,0,0,0,0,0,0,0,0,-25000,0,0,0,65000,90000,-25000,-25000
057973,神達富邦9A購01  ,0,0,0,0,0,0,0,0,0,-25000,0,0,0,1000,26000,-25000,-25000
058060,貿聯元富98購01  ,0,0,0,0,0,0,0,0,0,-25000,0,0,0,0,25000,-25000,-25000
049046,同欣電兆豐94購01,0,0,0,0,0,0,0,0,0,-25000,0,0,0,0,25000,-25000,-25000
049136,華通元大95購01  ,0,0,0,0,0,0,0,0,0,-25000,0,0,0,0,25000,-25000,-25000
049820,世紀鋼元大96購03,0,0,0,0,0,0,0,0,0,-25000,0,0,0,20000,45000,-25000,-25000
051995,矽力元大95購03  ,0,0,0,0,0,0,0,0,0,-25000,0,0,0,5000,30000,-25000,-25000
048636,鴻海元大94購05  ,0,0,0,0,0,0,0,0,0,-25000,0,0,0,15000,40000,-25000,-25000
04379P,大立光元大94售06,0,0,0,0,0,0,0,0,0,-25000,0,0,0,0,25000,-25000,-25000
047629,深中小元大96購01,0,0,0,0,0,0,0,0,0,-25000,0,0,0,0,25000,-25000,-25000
055335,健策兆豐98購01  ,0,0,0,0,0,0,0,0,0,-25000,0,0,0,0,25000,-25000,-25000
056479,玉晶光元大99購05,0,0,0,0,0,0,0,0,0,-25000,0,0,0,0,25000,-25000,-25000
056558,台達電群益98購01,0,0,0,0,0,0,0,0,0,-25000,0,0,0,0,25000,-25000,-25000
056281,深中小永豐97購01,0,0,0,0,0,0,0,0,0,-25000,0,0,0,10000,35000,-25000,-25000
056294,上銀元大97購11  ,0,0,0,0,0,0,0,0,0,-25000,0,0,0,0,25000,-25000,-25000
05650P,台積電富邦96售01,0,0,0,0,0,0,0,0,0,-25000,0,0,0,5000,30000,-25000,-25000
056381,台虹元富98購01  ,0,0,0,0,0,0,0,0,0,-25000,0,0,0,10000,35000,-25000,-25000
052692,滬深2X中信99購02,0,0,0,0,0,0,0,0,0,-25000,0,0,0,0,25000,-25000,-25000
056828,國巨富邦9A購03  ,0,0,0,0,0,0,0,0,0,-25000,0,0,0,0,25000,-25000,-25000
057283,欣興元大98購07  ,0,0,0,0,0,0,0,0,0,-25000,0,0,0,20000,45000,-25000,-25000
056939,康控元富98購01  ,0,0,0,0,0,0,0,0,0,-25000,0,0,0,85000,110000,-25000,-25000
055127,台虹兆豐97購01  ,0,0,0,0,0,0,0,0,0,-25000,0,0,0,0,25000,-25000,-25000
057062,立積國泰99購01  ,0,0,0,0,0,0,0,0,0,-25000,0,0,0,420000,445000,-25000,-25000
3130,一零四          ,0,24000,-24000,0,0,0,0,0,0,-1000,0,1000,-1000,0,0,0,-25000
4572,駐龍            ,9000,34000,-25000,0,0,0,0,0,0,0,0,0,0,0,0,0,-25000
058043,鴻海元大98購13  ,0,0,0,0,0,0,0,0,0,-26000,0,0,0,76000,102000,-26000,-26000
058895,鴻海元大99購20  ,0,0,0,0,0,0,0,0,0,-26000,0,0,0,204000,230000,-26000,-26000
058710,臺股指元大9A購23,0,0,0,0,0,0,0,0,0,-26000,0,0,0,4000,30000,-26000,-26000
058910,泰鼎元大99購03  ,0,0,0,0,0,0,0,0,0,-26000,0,0,0,30000,56000,-26000,-26000
059086,國巨元大99購18  ,0,0,0,0,0,0,0,0,0,-26000,0,0,0,9000,35000,-26000,-26000
058586,鴻海中信01購02  ,0,0,0,0,0,0,0,0,0,-26000,0,0,0,0,26000,-26000,-26000
05971P,世紀鋼永豐96售04,0,0,0,0,0,0,0,0,0,-26000,0,0,0,17000,43000,-26000,-26000
06150P,奇力新元大97售06,0,0,0,0,0,0,0,0,0,-26000,0,0,0,10000,36000,-26000,-26000
06153P,健策元大97售04  ,0,0,0,0,0,0,0,0,0,-26000,0,0,0,77000,103000,-26000,-26000
1436,華友聯          ,13000,39000,-26000,0,0,0,0,0,0,0,0,0,0,0,0,0,-26000
04250P,嘉晶統一95售02  ,0,0,0,0,0,0,0,0,0,-26000,0,0,0,22000,48000,-26000,-26000
04834P,鴻海元大94售17  ,0,0,0,0,0,0,0,0,0,-26000,0,0,0,100000,126000,-26000,-26000
048832,玉晶光凱基95購02,0,0,0,0,0,0,0,0,0,-26000,0,0,0,10000,36000,-26000,-26000
051023,S&P反1統一95購02,0,0,0,0,0,0,0,0,0,-26000,0,0,0,0,26000,-26000,-26000
057059,易華電元大99購01,0,0,0,0,0,0,0,0,0,-26000,0,0,0,4000,30000,-26000,-26000
054791,泰碩群益99購02  ,0,0,0,0,0,0,0,0,0,-26000,0,0,0,23000,49000,-26000,-26000
054778,世紀鋼國票99購01,0,0,0,0,0,0,0,0,0,-26000,0,0,0,47000,73000,-26000,-26000
053427,鎧勝永豐96購02  ,0,0,0,0,0,0,0,0,0,-26000,0,0,0,20000,46000,-26000,-26000
053352,義隆兆豐96購01  ,0,0,0,0,0,0,0,0,0,-26000,0,0,0,76000,102000,-26000,-26000
053013,台積電統一97購01,0,0,0,0,0,0,0,0,0,-26000,0,0,0,0,26000,-26000,-26000
4930,燦星網          ,5000,31000,-26000,0,0,0,0,0,0,0,0,0,0,0,0,0,-26000
2923,鼎固-KY         ,6000,32000,-26000,0,0,0,0,0,0,0,0,0,0,0,0,0,-26000
2849,安泰銀          ,40000,66000,-26000,0,0,0,0,0,0,0,0,0,0,0,0,0,-26000
2397,友通            ,11000,17000,-6000,0,0,0,0,0,0,-20000,0,20000,-20000,0,0,0,-26000
2449,京元電子        ,4691000,6753745,-2062745,0,0,0,984000,165000,819000,1217000,266000,259000,7000,1415000,205000,1210000,-26745
1442,名軒            ,48000,78000,-30000,0,0,0,0,0,0,3000,3000,0,3000,0,0,0,-27000
059228,臺股指元大99購21,0,0,0,0,0,0,0,0,0,-27000,0,0,0,0,27000,-27000,-27000
059123,訊芯永豐99購03  ,0,0,0,0,0,0,0,0,0,-27000,0,0,0,0,27000,-27000,-27000
059190,欣興富邦9A購01  ,0,0,0,0,0,0,0,0,0,-27000,0,0,0,1100000,1127000,-27000,-27000
058524,超眾元大99購04  ,0,0,0,0,0,0,0,0,0,-27000,0,0,0,10000,37000,-27000,-27000
059077,FBVIX元大99購05 ,0,0,0,0,0,0,0,0,0,-27000,0,0,0,3000,30000,-27000,-27000
058008,禾伸堂國票99購02,0,0,0,0,0,0,0,0,0,-27000,0,0,0,0,27000,-27000,-27000
055727,矽力元大97購02  ,0,0,0,0,0,0,0,0,0,-27000,0,0,0,1000,28000,-27000,-27000
051725,緯穎永豐95購02  ,0,0,0,0,0,0,0,0,0,-27000,0,0,0,45000,72000,-27000,-27000
051082,上証2X元大98購01,0,0,0,0,0,0,0,0,0,-27000,0,0,0,0,27000,-27000,-27000
050458,台郡元大94購03  ,0,0,0,0,0,0,0,0,0,-27000,0,0,0,13000,40000,-27000,-27000
052808,矽力元大96購02  ,0,0,0,0,0,0,0,0,0,-27000,0,0,0,3000,30000,-27000,-27000
05258P,臺股指凱基96售11,0,0,0,0,0,0,0,0,0,-27000,0,0,0,97000,124000,-27000,-27000
056644,宏達電凱基98購04,0,0,0,0,0,0,0,0,0,-27000,0,0,0,12000,39000,-27000,-27000
056467,上証2X元大98購02,0,0,0,0,0,0,0,0,0,-27000,0,0,0,4000,31000,-27000,-27000
054821,貿聯元大9A購01  ,0,0,0,0,0,0,0,0,0,-27000,0,0,0,0,27000,-27000,-27000
056922,全新兆豐99購01  ,0,0,0,0,0,0,0,0,0,-27000,0,0,0,0,27000,-27000,-27000
054680,華新科康和97購02,0,0,0,0,0,0,0,0,0,-27000,0,0,0,15000,42000,-27000,-27000
2882A,國泰特          ,0,29000,-29000,0,0,0,0,0,0,2000,2000,0,2000,0,0,0,-27000
058250,台虹元大99購01  ,0,0,0,0,0,0,0,0,0,-28000,0,0,0,0,28000,-28000,-28000
058885,元石油元大9C購02,0,0,0,0,0,0,0,0,0,-28000,0,0,0,12000,40000,-28000,-28000
058675,康控群益9B購01  ,0,0,0,0,0,0,0,0,0,-28000,0,0,0,0,28000,-28000,-28000
059124,台積電第一03購01,0,0,0,0,0,0,0,0,0,-28000,0,0,0,130000,158000,-28000,-28000
059212,鴻海元大99購28  ,0,0,0,0,0,0,0,0,0,-28000,0,0,0,0,28000,-28000,-28000
050189,旭富元大94購01  ,0,0,0,0,0,0,0,0,0,-28000,0,0,0,0,28000,-28000,-28000
04792P,智邦元大94售06  ,0,0,0,0,0,0,0,0,0,-28000,0,0,0,0,28000,-28000,-28000
04454P,大立光富邦98售02,0,0,0,0,0,0,0,0,0,-28000,0,0,0,0,28000,-28000,-28000
052135,聯發科凱基9B購01,0,0,0,0,0,0,0,0,0,-28000,0,0,0,2000,30000,-28000,-28000
049803,華新科元大95購07,0,0,0,0,0,0,0,0,0,-28000,0,0,0,0,28000,-28000,-28000
049759,元黃金富邦9A購01,0,0,0,0,0,0,0,0,0,-28000,0,0,0,3000,31000,-28000,-28000
051471,國巨凱基97購01  ,0,0,0,0,0,0,0,0,0,-28000,0,0,0,32000,60000,-28000,-28000
053505,瑞儀兆豐97購01  ,0,0,0,0,0,0,0,0,0,-28000,0,0,0,82000,110000,-28000,-28000
057079,台積電統一9A購02,0,0,0,0,0,0,0,0,0,-28000,0,0,0,0,28000,-28000,-28000
9908,大台北          ,39000,69000,-30000,0,0,0,0,0,0,2000,3000,1000,2000,0,0,0,-28000
1714,和桐            ,1768000,1794000,-26000,0,0,0,0,0,0,-3000,0,3000,-3000,0,0,0,-29000
059064,緯穎凱基99購02  ,0,0,0,0,0,0,0,0,0,-29000,0,0,0,100000,129000,-29000,-29000
058304,鴻海元大99購12  ,0,0,0,0,0,0,0,0,0,-29000,0,0,0,214000,243000,-29000,-29000
056023,晶豪科群益97購01,0,0,0,0,0,0,0,0,0,-29000,0,0,0,0,29000,-29000,-29000
04963P,鴻海元大94售25  ,0,0,0,0,0,0,0,0,0,-29000,0,0,0,6000,35000,-29000,-29000
03618C,高股息凱基95牛01,0,0,0,0,0,0,0,0,0,-29000,0,0,0,0,29000,-29000,-29000
046492,旺宏富邦94購02  ,0,0,0,0,0,0,0,0,0,-29000,0,0,0,0,29000,-29000,-29000
057158,義隆永豐99購01  ,0,0,0,0,0,0,0,0,0,-29000,0,0,0,42000,71000,-29000,-29000
055028,佐登國泰98購01  ,0,0,0,0,0,0,0,0,0,-29000,0,0,0,121000,150000,-29000,-29000
053273,國巨元大96購08  ,0,0,0,0,0,0,0,0,0,-29000,0,0,0,0,29000,-29000,-29000
9925,新保            ,48000,60000,-12000,0,0,0,0,0,0,-17000,1000,18000,-17000,0,0,0,-29000
5234,達興材料        ,108000,139000,-31000,0,0,0,0,0,0,2000,2000,0,2000,0,0,0,-29000
2453,凌群            ,107000,139000,-32000,0,0,0,0,0,0,3000,3000,0,3000,0,0,0,-29000
058299,同欣電凱基9A購01,0,0,0,0,0,0,0,0,0,-30000,0,0,0,0,30000,-30000,-30000
058213,欣興群益99購01  ,0,0,0,0,0,0,0,0,0,-30000,0,0,0,0,30000,-30000,-30000
058124,玉晶光國票9A購01,0,0,0,0,0,0,0,0,0,-30000,0,0,0,0,30000,-30000,-30000
058168,國巨凱基9A購04  ,0,0,0,0,0,0,0,0,0,-30000,0,0,0,100000,130000,-30000,-30000
058141,嘉聯益元大99購05,0,0,0,0,0,0,0,0,0,-30000,0,0,0,0,30000,-30000,-30000
057987,大立光元富98購02,0,0,0,0,0,0,0,0,0,-30000,0,0,0,0,30000,-30000,-30000
057770,亞德客群益98購01,0,0,0,0,0,0,0,0,0,-30000,0,0,0,0,30000,-30000,-30000
057861,台積電凱基98購16,0,0,0,0,0,0,0,0,0,-30000,0,0,0,0,30000,-30000,-30000
057444,台泥元富98購01  ,0,0,0,0,0,0,0,0,0,-30000,0,0,0,30000,60000,-30000,-30000
057534,旭富元大98購01  ,0,0,0,0,0,0,0,0,0,-30000,0,0,0,18000,48000,-30000,-30000
057539,南茂元大98購02  ,0,0,0,0,0,0,0,0,0,-30000,0,0,0,10000,40000,-30000,-30000
057580,玉山金中信9A購01,0,0,0,0,0,0,0,0,0,-30000,0,0,0,0,30000,-30000,-30000
057576,南亞科第一9C購01,0,0,0,0,0,0,0,0,0,-30000,0,0,0,0,30000,-30000,-30000
059091,中信金元大99購01,0,0,0,0,0,0,0,0,0,-30000,0,0,0,0,30000,-30000,-30000
058955,台積電國票9A購04,0,0,0,0,0,0,0,0,0,-30000,0,0,0,0,30000,-30000,-30000
058749,康控凱基99購03  ,0,0,0,0,0,0,0,0,0,-30000,0,0,0,0,30000,-30000,-30000
058775,台積電國票9A購02,0,0,0,0,0,0,0,0,0,-30000,0,0,0,0,30000,-30000,-30000
058700,鴻海元大99購15  ,0,0,0,0,0,0,0,0,0,-30000,0,0,0,21000,51000,-30000,-30000
05854P,華新科凱基96售09,0,0,0,0,0,0,0,0,0,-30000,0,0,0,10000,40000,-30000,-30000
058491,滬深2X群益01購01,0,0,0,0,0,0,0,0,0,-30000,0,0,0,15000,45000,-30000,-30000
06803P,臺股指群益98售09,0,0,0,0,0,0,0,0,0,-30000,0,0,0,0,30000,-30000,-30000
06780P,義隆元大98售02  ,0,0,0,0,0,0,0,0,0,-30000,0,0,0,100000,130000,-30000,-30000
059211,鴻海元大99購27  ,0,0,0,0,0,0,0,0,0,-30000,0,0,0,0,30000,-30000,-30000
059098,元油2X統一9B購03,0,0,0,0,0,0,0,0,0,-30000,0,0,0,0,30000,-30000,-30000
059135,臺股指群益99購10,0,0,0,0,0,0,0,0,0,-30000,0,0,0,0,30000,-30000,-30000
059196,聯發科永豐99購02,0,0,0,0,0,0,0,0,0,-30000,0,0,0,500000,530000,-30000,-30000
06145P,華新科永豐97售02,0,0,0,0,0,0,0,0,0,-30000,0,0,0,0,30000,-30000,-30000
046570,旺宏國泰94購01  ,0,0,0,0,0,0,0,0,0,-30000,0,0,0,0,30000,-30000,-30000
050263,旺宏元大94購10  ,0,0,0,0,0,0,0,0,0,-30000,0,0,0,30000,60000,-30000,-30000
050514,聯電元大94購01  ,0,0,0,0,0,0,0,0,0,-30000,0,0,0,10000,40000,-30000,-30000
05188P,可成凱基95售09  ,0,0,0,0,0,0,0,0,0,-30000,0,0,0,10000,40000,-30000,-30000
05033P,T50反1元大98售01,0,0,0,0,0,0,0,0,0,-30000,0,0,0,0,30000,-30000,-30000
046155,道瓊反群益94購01,0,0,0,0,0,0,0,0,0,-30000,0,0,0,0,30000,-30000,-30000
045685,康控元大95購01  ,0,0,0,0,0,0,0,0,0,-30000,0,0,0,0,30000,-30000,-30000
04540P,聯詠永豐94售02  ,0,0,0,0,0,0,0,0,0,-30000,0,0,0,0,30000,-30000,-30000
03627P,大立光兆豐93售03,0,0,0,0,0,0,0,0,0,-30000,0,0,0,20000,50000,-30000,-30000
03670C,元油2X元富99牛01,0,0,0,0,0,0,0,0,0,-30000,0,0,0,20000,50000,-30000,-30000
044468,台積電群益93購01,0,0,0,0,0,0,0,0,0,-30000,0,0,0,0,30000,-30000,-30000
048635,鴻海元大94購04  ,0,0,0,0,0,0,0,0,0,-30000,0,0,0,20000,50000,-30000,-30000
048417,國巨統一94購01  ,0,0,0,0,0,0,0,0,0,-30000,0,0,0,20000,50000,-30000,-30000
04145P,聯發科凱基93售28,0,0,0,0,0,0,0,0,0,-30000,0,0,0,0,30000,-30000,-30000
049207,茂林群益94購02  ,0,0,0,0,0,0,0,0,0,-30000,0,0,0,0,30000,-30000,-30000
049287,可成兆豐95購01  ,0,0,0,0,0,0,0,0,0,-30000,0,0,0,0,30000,-30000,-30000
051983,道瓊反元大95購01,0,0,0,0,0,0,0,0,0,-30000,0,0,0,4000,34000,-30000,-30000
052014,光罩永豐95購01  ,0,0,0,0,0,0,0,0,0,-30000,0,0,0,0,30000,-30000,-30000
050618,緯創元大95購01  ,0,0,0,0,0,0,0,0,0,-30000,0,0,0,0,30000,-30000,-30000
051914,健策元大96購06  ,0,0,0,0,0,0,0,0,0,-30000,0,0,0,10000,40000,-30000,-30000
049700,瀚宇博元大97購01,0,0,0,0,0,0,0,0,0,-30000,0,0,0,0,30000,-30000,-30000
050035,聯茂元大94購07  ,0,0,0,0,0,0,0,0,0,-30000,0,0,0,114000,144000,-30000,-30000
049433,健策國票95購03  ,0,0,0,0,0,0,0,0,0,-30000,0,0,0,0,30000,-30000,-30000
050151,台積電群益94購12,0,0,0,0,0,0,0,0,0,-30000,0,0,0,0,30000,-30000,-30000
052054,台表科凱基96購01,0,0,0,0,0,0,0,0,0,-30000,0,0,0,0,30000,-30000,-30000
050717,京鼎群益96購01  ,0,0,0,0,0,0,0,0,0,-30000,0,0,0,0,30000,-30000,-30000
050710,元黃金中信96購01,0,0,0,0,0,0,0,0,0,-30000,0,0,0,0,30000,-30000,-30000
051231,健策群益97購01  ,0,0,0,0,0,0,0,0,0,-30000,0,0,0,0,30000,-30000,-30000
055850,聯詠元大97購06  ,0,0,0,0,0,0,0,0,0,-30000,0,0,0,30000,60000,-30000,-30000
051650,矽力永豐95購01  ,0,0,0,0,0,0,0,0,0,-30000,0,0,0,0,30000,-30000,-30000
055690,矽力凱基97購02  ,0,0,0,0,0,0,0,0,0,-30000,0,0,0,0,30000,-30000,-30000
055704,亞德客永豐97購04,0,0,0,0,0,0,0,0,0,-30000,0,0,0,0,30000,-30000,-30000
055658,南電元富97購01  ,0,0,0,0,0,0,0,0,0,-30000,0,0,0,0,30000,-30000,-30000
051402,玉晶光永豐95購04,0,0,0,0,0,0,0,0,0,-30000,0,0,0,0,30000,-30000,-30000
051570,和碩富邦97購01  ,0,0,0,0,0,0,0,0,0,-30000,0,0,0,0,30000,-30000,-30000
051534,景碩國票97購01  ,0,0,0,0,0,0,0,0,0,-30000,0,0,0,0,30000,-30000,-30000
052247,深中小永豐95購01,0,0,0,0,0,0,0,0,0,-30000,0,0,0,0,30000,-30000,-30000
056716,康舒永豐98購01  ,0,0,0,0,0,0,0,0,0,-30000,0,0,0,0,30000,-30000,-30000
056717,康友永豐98購01  ,0,0,0,0,0,0,0,0,0,-30000,0,0,0,0,30000,-30000,-30000
056761,元油2X元大98購07,0,0,0,0,0,0,0,0,0,-30000,0,0,0,0,30000,-30000,-30000
056763,國巨元大99購02  ,0,0,0,0,0,0,0,0,0,-30000,0,0,0,40000,70000,-30000,-30000
054310,牧德凱基98購01  ,0,0,0,0,0,0,0,0,0,-30000,0,0,0,0,30000,-30000,-30000
053250,百和國票97購02  ,0,0,0,0,0,0,0,0,0,-30000,0,0,0,0,30000,-30000,-30000
052557,群創國票97購02  ,0,0,0,0,0,0,0,0,0,-30000,0,0,0,0,30000,-30000,-30000
052844,台積電統一96購02,0,0,0,0,0,0,0,0,0,-30000,0,0,0,0,30000,-30000,-30000
056430,鴻海凱基98購06  ,0,0,0,0,0,0,0,0,0,-30000,0,0,0,3000,33000,-30000,-30000
056272,嘉澤統一99購01  ,0,0,0,0,0,0,0,0,0,-30000,0,0,0,0,30000,-30000,-30000
056207,茂林永豐97購03  ,0,0,0,0,0,0,0,0,0,-30000,0,0,0,0,30000,-30000,-30000
05660P,玉晶光第一96售01,0,0,0,0,0,0,0,0,0,-30000,0,0,0,2000,32000,-30000,-30000
055275,台積電元大97購19,0,0,0,0,0,0,0,0,0,-30000,0,0,0,0,30000,-30000,-30000
054254,晶豪科元大96購02,0,0,0,0,0,0,0,0,0,-30000,0,0,0,0,30000,-30000,-30000
054158,國巨日盛99購01  ,0,0,0,0,0,0,0,0,0,-30000,0,0,0,10000,40000,-30000,-30000
054156,聯電亞東98購01  ,0,0,0,0,0,0,0,0,0,-30000,0,0,0,0,30000,-30000,-30000
056074,茂林元大97購04  ,0,0,0,0,0,0,0,0,0,-30000,0,0,0,0,30000,-30000,-30000
056127,致新國票98購02  ,0,0,0,0,0,0,0,0,0,-30000,0,0,0,0,30000,-30000,-30000
053117,大立光中信9A購02,0,0,0,0,0,0,0,0,0,-30000,0,0,0,10000,40000,-30000,-30000
055369,友訊元大97購01  ,0,0,0,0,0,0,0,0,0,-30000,0,0,0,10000,40000,-30000,-30000
055258,玉晶光統一97購03,0,0,0,0,0,0,0,0,0,-30000,0,0,0,0,30000,-30000,-30000
055197,致新元富97購02  ,0,0,0,0,0,0,0,0,0,-30000,0,0,0,0,30000,-30000,-30000
055225,華邦電國票99購01,0,0,0,0,0,0,0,0,0,-30000,0,0,0,0,30000,-30000,-30000
056899,可成元大98購01  ,0,0,0,0,0,0,0,0,0,-30000,0,0,0,10000,40000,-30000,-30000
057048,新日興元大98購01,0,0,0,0,0,0,0,0,0,-30000,0,0,0,30000,60000,-30000,-30000
057045,美律元大99購04  ,0,0,0,0,0,0,0,0,0,-30000,0,0,0,26000,56000,-30000,-30000
056870,全新日盛9A購01  ,0,0,0,0,0,0,0,0,0,-30000,0,0,0,0,30000,-30000,-30000
057052,華擎元大98購01  ,0,0,0,0,0,0,0,0,0,-30000,0,0,0,0,30000,-30000,-30000
057187,群創元大9B購04  ,0,0,0,0,0,0,0,0,0,-30000,0,0,0,0,30000,-30000,-30000
057181,亞光元大98購02  ,0,0,0,0,0,0,0,0,0,-30000,0,0,0,10000,40000,-30000,-30000
057212,台積電群益98購03,0,0,0,0,0,0,0,0,0,-30000,0,0,0,0,30000,-30000,-30000
057227,台積電凱基98購15,0,0,0,0,0,0,0,0,0,-30000,0,0,0,0,30000,-30000,-30000
056954,聯詠富邦9A購01  ,0,0,0,0,0,0,0,0,0,-30000,0,0,0,0,30000,-30000,-30000
056990,聯發科兆豐98購01,0,0,0,0,0,0,0,0,0,-30000,0,0,0,480000,510000,-30000,-30000
057365,智邦元大98購07  ,0,0,0,0,0,0,0,0,0,-30000,0,0,0,3000,33000,-30000,-30000
054928,帆宣凱基98購01  ,0,0,0,0,0,0,0,0,0,-30000,0,0,0,0,30000,-30000,-30000
054517,高鐵元大96購01  ,0,0,0,0,0,0,0,0,0,-30000,0,0,0,0,30000,-30000,-30000
054089,台積電群益96購11,0,0,0,0,0,0,0,0,0,-30000,0,0,0,0,30000,-30000,-30000
054031,中鋼中信98購01  ,0,0,0,0,0,0,0,0,0,-30000,0,0,0,0,30000,-30000,-30000
054026,台積電凱基97購08,0,0,0,0,0,0,0,0,0,-30000,0,0,0,0,30000,-30000,-30000
054048,國泰金元大96購04,0,0,0,0,0,0,0,0,0,-30000,0,0,0,0,30000,-30000,-30000
053567,群創富邦97購01  ,0,0,0,0,0,0,0,0,0,-30000,0,0,0,0,30000,-30000,-30000
053637,強茂永豐96購01  ,0,0,0,0,0,0,0,0,0,-30000,0,0,0,0,30000,-30000,-30000
053904,漢唐凱基97購01  ,0,0,0,0,0,0,0,0,0,-30000,0,0,0,0,30000,-30000,-30000
053838,正文永豐96購02  ,0,0,0,0,0,0,0,0,0,-30000,0,0,0,0,30000,-30000,-30000
2727,王品            ,71000,101000,-30000,0,0,0,0,0,0,0,0,0,0,0,0,0,-30000
059174,訊芯凱基99購01  ,0,0,0,0,0,0,0,0,0,-31000,0,0,0,0,31000,-31000,-31000
059111,元油2X永豐99購03,0,0,0,0,0,0,0,0,0,-31000,0,0,0,9000,40000,-31000,-31000
06475P,牧德永豐98售03  ,0,0,0,0,0,0,0,0,0,-31000,0,0,0,30000,61000,-31000,-31000
1234,黑松            ,5000,36000,-31000,0,0,0,0,0,0,0,0,0,0,0,0,0,-31000
058492,華通群益9B購01  ,0,0,0,0,0,0,0,0,0,-31000,0,0,0,0,31000,-31000,-31000
059037,宏達電群益99購02,0,0,0,0,0,0,0,0,0,-31000,0,0,0,0,31000,-31000,-31000
049108,玉晶光富邦96購02,0,0,0,0,0,0,0,0,0,-31000,0,0,0,19000,50000,-31000,-31000
051506,台積電元富95購06,0,0,0,0,0,0,0,0,0,-31000,0,0,0,0,31000,-31000,-31000
00851,台新全球AI      ,0,0,0,0,0,0,0,0,0,-31000,0,0,0,33000,64000,-31000,-31000
045444,群創元富98購02  ,0,0,0,0,0,0,0,0,0,-31000,0,0,0,0,31000,-31000,-31000
053629,玉山金兆豐96購01,0,0,0,0,0,0,0,0,0,-31000,0,0,0,0,31000,-31000,-31000
054074,健策富邦98購01  ,0,0,0,0,0,0,0,0,0,-31000,0,0,0,0,31000,-31000,-31000
057371,可成元大98購08  ,0,0,0,0,0,0,0,0,0,-31000,0,0,0,50000,81000,-31000,-31000
057095,祥碩元富98購02  ,0,0,0,0,0,0,0,0,0,-31000,0,0,0,20000,51000,-31000,-31000
053102,祥碩元富96購01  ,0,0,0,0,0,0,0,0,0,-31000,0,0,0,0,31000,-31000,-31000
053151,華新科元大96購04,0,0,0,0,0,0,0,0,0,-31000,0,0,0,0,31000,-31000,-31000
053163,上証2X群益9A購02,0,0,0,0,0,0,0,0,0,-31000,0,0,0,30000,61000,-31000,-31000
054237,茂林群益97購01  ,0,0,0,0,0,0,0,0,0,-31000,0,0,0,0,31000,-31000,-31000
2477,美隆電          ,6000,41000,-35000,0,0,0,0,0,0,4000,4000,0,4000,0,0,0,-31000
2506,太設            ,0,31000,-31000,0,0,0,0,0,0,0,0,0,0,0,0,0,-31000
6183,關貿            ,27000,61000,-34000,0,0,0,0,0,0,3000,3000,0,3000,0,0,0,-31000
058369,亞光凱基99購02  ,0,0,0,0,0,0,0,0,0,-32000,0,0,0,30000,62000,-32000,-32000
058068,旺宏凱基98購11  ,0,0,0,0,0,0,0,0,0,-32000,0,0,0,26000,58000,-32000,-32000
07123P,鴻海元大99售23  ,0,0,0,0,0,0,0,0,0,-32000,0,0,0,0,32000,-32000,-32000
06594P,立積元大98售01  ,0,0,0,0,0,0,0,0,0,-32000,0,0,0,125000,157000,-32000,-32000
06642P,可成兆豐98售01  ,0,0,0,0,0,0,0,0,0,-32000,0,0,0,18000,50000,-32000,-32000
059144,嘉晶國票9A購02  ,0,0,0,0,0,0,0,0,0,-32000,0,0,0,0,32000,-32000,-32000
06056P,台積電凱基98售02,0,0,0,0,0,0,0,0,0,-32000,0,0,0,14000,46000,-32000,-32000
047904,臺指反元大96購01,0,0,0,0,0,0,0,0,0,-32000,0,0,0,0,32000,-32000,-32000
051840,康友國泰97購02  ,0,0,0,0,0,0,0,0,0,-32000,0,0,0,18000,50000,-32000,-32000
050253,百和國泰96購01  ,0,0,0,0,0,0,0,0,0,-32000,0,0,0,18000,50000,-32000,-32000
00762,元大全球AI      ,3000,1000,2000,0,0,0,0,0,0,-34000,0,0,0,18000,52000,-34000,-32000
044475,國巨元富95購02  ,0,0,0,0,0,0,0,0,0,-32000,0,0,0,0,32000,-32000,-32000
051450,世芯元大95購02  ,0,0,0,0,0,0,0,0,0,-32000,0,0,0,10000,42000,-32000,-32000
055568,緯穎凱基97購02  ,0,0,0,0,0,0,0,0,0,-32000,0,0,0,0,32000,-32000,-32000
056588,聯發科統一9A購02,0,0,0,0,0,0,0,0,0,-32000,0,0,0,0,32000,-32000,-32000
052780,玉晶光國票96購04,0,0,0,0,0,0,0,0,0,-32000,0,0,0,16000,48000,-32000,-32000
056743,貿聯凱基98購04  ,0,0,0,0,0,0,0,0,0,-32000,0,0,0,0,32000,-32000,-32000
054887,大毅統一98購01  ,0,0,0,0,0,0,0,0,0,-32000,0,0,0,0,32000,-32000,-32000
054873,帆宣群益99購01  ,0,0,0,0,0,0,0,0,0,-32000,0,0,0,0,32000,-32000,-32000
3229,晟鈦            ,10000,42000,-32000,0,0,0,0,0,0,0,0,0,0,0,0,0,-32000
2430,燦坤            ,6000,44000,-38000,0,0,0,0,0,0,6000,6000,0,6000,0,0,0,-32000
8222,寶一            ,5000,5000,0,0,0,0,0,32000,-32000,0,0,0,0,0,0,0,-32000
06204P,鴻海群益97售04  ,0,0,0,0,0,0,0,0,0,-33000,0,0,0,6000,39000,-33000,-33000
059209,華通元大99購08  ,0,0,0,0,0,0,0,0,0,-33000,0,0,0,10000,43000,-33000,-33000
06560P,台積電統一98售07,0,0,0,0,0,0,0,0,0,-33000,0,0,0,1000,34000,-33000,-33000
06473P,鴻海元大99售03  ,0,0,0,0,0,0,0,0,0,-33000,0,0,0,90000,123000,-33000,-33000
06326P,鴻海中信01售01  ,0,0,0,0,0,0,0,0,0,-33000,0,0,0,0,33000,-33000,-33000
1773,勝一            ,51000,80000,-29000,0,0,0,0,0,0,-4000,0,4000,-4000,0,0,0,-33000
058024,台積電國泰9A購01,0,0,0,0,0,0,0,0,0,-33000,0,0,0,0,33000,-33000,-33000
057537,聯茂元大98購04  ,0,0,0,0,0,0,0,0,0,-33000,0,0,0,10000,43000,-33000,-33000
057740,茂林富邦9A購01  ,0,0,0,0,0,0,0,0,0,-33000,0,0,0,7000,40000,-33000,-33000
058383,道瓊指中信9C購02,0,0,0,0,0,0,0,0,0,-33000,0,0,0,0,33000,-33000,-33000
058851,大立光群益99購07,0,0,0,0,0,0,0,0,0,-33000,0,0,0,17000,50000,-33000,-33000
055508,矽力元大97購01  ,0,0,0,0,0,0,0,0,0,-33000,0,0,0,10000,43000,-33000,-33000
055965,泰鼎元大97購03  ,0,0,0,0,0,0,0,0,0,-33000,0,0,0,20000,53000,-33000,-33000
0055,元大MSCI金融    ,2000,2000,0,0,0,0,0,0,0,-33000,0,0,0,1000,34000,-33000,-33000
056789,和碩群益98購01  ,0,0,0,0,0,0,0,0,0,-33000,0,0,0,0,33000,-33000,-33000
2929,淘帝-KY         ,282000,315000,-33000,0,0,0,0,0,0,0,0,0,0,0,0,0,-33000
059040,訊芯群益99購03  ,0,0,0,0,0,0,0,0,0,-34000,0,0,0,0,34000,-34000,-34000
06869P,金融類元大99售01,0,0,0,0,0,0,0,0,0,-34000,0,0,0,40000,74000,-34000,-34000
07109P,聯發科中信9B售02,0,0,0,0,0,0,0,0,0,-34000,0,0,0,0,34000,-34000,-34000
049560,香港反統一95購01,0,0,0,0,0,0,0,0,0,-34000,0,0,0,0,34000,-34000,-34000
055760,新日興群益98購02,0,0,0,0,0,0,0,0,0,-34000,0,0,0,0,34000,-34000,-34000
052435,滬深2X富邦96購05,0,0,0,0,0,0,0,0,0,-34000,0,0,0,0,34000,-34000,-34000
2636,台驊投控        ,17000,51000,-34000,0,0,0,0,0,0,0,0,0,0,0,0,0,-34000
6605,帝寶            ,12000,46000,-34000,0,0,0,0,0,0,0,0,0,0,0,0,0,-34000
1731,美吾華          ,107000,142000,-35000,0,0,0,0,0,0,0,0,0,0,0,0,0,-35000
07145P,為升元大99售03  ,0,0,0,0,0,0,0,0,0,-35000,0,0,0,52000,87000,-35000,-35000
059224,大立光元大99購15,0,0,0,0,0,0,0,0,0,-35000,0,0,0,0,35000,-35000,-35000
05996P,華新科群益96售03,0,0,0,0,0,0,0,0,0,-35000,0,0,0,0,35000,-35000,-35000
059059,宏達電凱基99購03,0,0,0,0,0,0,0,0,0,-35000,0,0,0,0,35000,-35000,-35000
058894,元油2X元大9C購11,0,0,0,0,0,0,0,0,0,-35000,0,0,0,0,35000,-35000,-35000
058713,國巨統一9B購02  ,0,0,0,0,0,0,0,0,0,-35000,0,0,0,0,35000,-35000,-35000
058256,臺股指元大9A購20,0,0,0,0,0,0,0,0,0,-35000,0,0,0,0,35000,-35000,-35000
049482,國巨元大94購06  ,0,0,0,0,0,0,0,0,0,-35000,0,0,0,0,35000,-35000,-35000
051908,國泰金元大96購02,0,0,0,0,0,0,0,0,0,-35000,0,0,0,0,35000,-35000,-35000
05589P,大立光中信9A售01,0,0,0,0,0,0,0,0,0,-35000,0,0,0,20000,55000,-35000,-35000
048222,台積電凱基93購26,0,0,0,0,0,0,0,0,0,-35000,0,0,0,0,35000,-35000,-35000
053492,華邦電兆豐97購01,0,0,0,0,0,0,0,0,0,-35000,0,0,0,0,35000,-35000,-35000
053582,英業達元大97購01,0,0,0,0,0,0,0,0,0,-35000,0,0,0,0,35000,-35000,-35000
054823,祥碩元大97購02  ,0,0,0,0,0,0,0,0,0,-35000,0,0,0,0,35000,-35000,-35000
053129,緯穎凱基96購01  ,0,0,0,0,0,0,0,0,0,-35000,0,0,0,0,35000,-35000,-35000
056425,聯發科日盛9A購01,0,0,0,0,0,0,0,0,0,-35000,0,0,0,890000,925000,-35000,-35000
053219,祥碩凱基96購01  ,0,0,0,0,0,0,0,0,0,-35000,0,0,0,17000,52000,-35000,-35000
056741,大立光凱基98購14,0,0,0,0,0,0,0,0,0,-35000,0,0,0,0,35000,-35000,-35000
054374,信邦中信96購01  ,0,0,0,0,0,0,0,0,0,-35000,0,0,0,0,35000,-35000,-35000
052878,台虹凱基96購01  ,0,0,0,0,0,0,0,0,0,-35000,0,0,0,0,35000,-35000,-35000
052559,茂林國票97購01  ,0,0,0,0,0,0,0,0,0,-35000,0,0,0,0,35000,-35000,-35000
056178,嘉澤元富97購02  ,0,0,0,0,0,0,0,0,0,-35000,0,0,0,0,35000,-35000,-35000
3518,柏騰            ,141000,178000,-37000,0,0,0,0,0,0,2000,2000,0,2000,0,0,0,-35000
058007,南電群益98購02  ,0,0,0,0,0,0,0,0,0,-36000,0,0,0,0,36000,-36000,-36000
059034,華通群益9B購02  ,0,0,0,0,0,0,0,0,0,-36000,0,0,0,0,36000,-36000,-36000
058691,友訊國票9A購01  ,0,0,0,0,0,0,0,0,0,-36000,0,0,0,0,36000,-36000,-36000
05987P,健策統一96售02  ,0,0,0,0,0,0,0,0,0,-36000,0,0,0,4000,40000,-36000,-36000
05917P,宏達電元大96售02,0,0,0,0,0,0,0,0,0,-36000,0,0,0,0,36000,-36000,-36000
06533P,上証2X中信9B售01,0,0,0,0,0,0,0,0,0,-36000,0,0,0,79000,115000,-36000,-36000
06933P,禾伸堂元大98售03,0,0,0,0,0,0,0,0,0,-36000,0,0,0,95000,131000,-36000,-36000
055545,國巨凱基97購06  ,0,0,0,0,0,0,0,0,0,-36000,0,0,0,0,36000,-36000,-36000
050995,貿聯元大95購02  ,0,0,0,0,0,0,0,0,0,-36000,0,0,0,0,36000,-36000,-36000
050729,聯鈞國票94購01  ,0,0,0,0,0,0,0,0,0,-36000,0,0,0,0,36000,-36000,-36000
049597,泰鼎元大96購01  ,0,0,0,0,0,0,0,0,0,-36000,0,0,0,65000,101000,-36000,-36000
051227,技嘉群益97購01  ,0,0,0,0,0,0,0,0,0,-36000,0,0,0,12000,48000,-36000,-36000
053322,京鼎群益97購01  ,0,0,0,0,0,0,0,0,0,-36000,0,0,0,0,36000,-36000,-36000
056769,國產元大98購01  ,0,0,0,0,0,0,0,0,0,-36000,0,0,0,14000,50000,-36000,-36000
056320,京鼎群益99購01  ,0,0,0,0,0,0,0,0,0,-36000,0,0,0,0,36000,-36000,-36000
056356,台積電元大99購01,0,0,0,0,0,0,0,0,0,-36000,0,0,0,170000,206000,-36000,-36000
055093,京鼎群益98購01  ,0,0,0,0,0,0,0,0,0,-36000,0,0,0,0,36000,-36000,-36000
057165,國巨元大99購05  ,0,0,0,0,0,0,0,0,0,-36000,0,0,0,40000,76000,-36000,-36000
057394,台積電中信9C購02,0,0,0,0,0,0,0,0,0,-36000,0,0,0,0,36000,-36000,-36000
057239,貿聯凱基98購05  ,0,0,0,0,0,0,0,0,0,-36000,0,0,0,0,36000,-36000,-36000
056156,禾伸堂凱基98購04,0,0,0,0,0,0,0,0,0,-36000,0,0,0,0,36000,-36000,-36000
1906,寶隆            ,45000,81000,-36000,0,0,0,0,0,0,0,0,0,0,0,0,0,-36000
1727,中華化          ,1000,38000,-37000,0,0,0,0,0,0,0,0,0,0,0,0,0,-37000
1720,生達            ,25000,62000,-37000,0,0,0,0,0,0,0,0,0,0,0,0,0,-37000
06332P,世紀鋼群益98售01,0,0,0,0,0,0,0,0,0,-37000,0,0,0,135000,172000,-37000,-37000
059222,聯發科元大99購22,0,0,0,0,0,0,0,0,0,-37000,0,0,0,79000,116000,-37000,-37000
058685,TPK凱基99購01   ,0,0,0,0,0,0,0,0,0,-37000,0,0,0,0,37000,-37000,-37000
058522,聯茂元大99購07  ,0,0,0,0,0,0,0,0,0,-37000,0,0,0,140000,177000,-37000,-37000
05170P,世芯元大95售01  ,0,0,0,0,0,0,0,0,0,-37000,0,0,0,578000,615000,-37000,-37000
051281,健策兆豐96購01  ,0,0,0,0,0,0,0,0,0,-37000,0,0,0,60000,97000,-37000,-37000
051643,瑞昱康和95購01  ,0,0,0,0,0,0,0,0,0,-37000,0,0,0,0,37000,-37000,-37000
03420B,臺股指元大95熊31,0,0,0,0,0,0,0,0,0,-37000,0,0,0,69000,106000,-37000,-37000
042928,台積電中信95購01,0,0,0,0,0,0,0,0,0,-37000,0,0,0,13000,50000,-37000,-37000
057240,茂林凱基9A購01  ,0,0,0,0,0,0,0,0,0,-37000,0,0,0,11000,48000,-37000,-37000
055427,技嘉群益98購01  ,0,0,0,0,0,0,0,0,0,-37000,0,0,0,0,37000,-37000,-37000
056295,國巨元大97購16  ,0,0,0,0,0,0,0,0,0,-37000,0,0,0,10000,47000,-37000,-37000
056720,世紀鋼永豐98購01,0,0,0,0,0,0,0,0,0,-37000,0,0,0,28000,65000,-37000,-37000
054297,台郡元大98購01  ,0,0,0,0,0,0,0,0,0,-37000,0,0,0,11000,48000,-37000,-37000
053373,台泥元大96購01  ,0,0,0,0,0,0,0,0,0,-37000,0,0,0,3000,40000,-37000,-37000
052935,康友元大96購03  ,0,0,0,0,0,0,0,0,0,-37000,0,0,0,3000,40000,-37000,-37000
2524,京城            ,135000,180000,-45000,0,0,0,0,0,0,8000,8000,0,8000,0,0,0,-37000
6214,精誠            ,358000,488000,-130000,0,0,0,0,0,0,93000,94000,1000,93000,0,0,0,-37000
058707,泰鼎元大99購02  ,0,0,0,0,0,0,0,0,0,-38000,0,0,0,0,38000,-38000,-38000
058025,聯茂國泰99購01  ,0,0,0,0,0,0,0,0,0,-38000,0,0,0,24000,62000,-38000,-38000
06263P,燿華凱基97售04  ,0,0,0,0,0,0,0,0,0,-38000,0,0,0,21000,59000,-38000,-38000
1416,廣豐            ,0,38000,-38000,0,0,0,0,0,0,0,0,0,0,0,0,0,-38000
07019P,鴻海台新99售01  ,0,0,0,0,0,0,0,0,0,-38000,0,0,0,1527000,1565000,-38000,-38000
048873,玉晶光國票95購02,0,0,0,0,0,0,0,0,0,-38000,0,0,0,2000,40000,-38000,-38000
055336,茂林兆豐98購01  ,0,0,0,0,0,0,0,0,0,-38000,0,0,0,12000,50000,-38000,-38000
057379,寶成元大98購02  ,0,0,0,0,0,0,0,0,0,-38000,0,0,0,14000,52000,-38000,-38000
055085,大毅國票97購01  ,0,0,0,0,0,0,0,0,0,-38000,0,0,0,0,38000,-38000,-38000
6582,申豐            ,51000,89000,-38000,0,0,0,0,0,0,0,0,0,0,0,0,0,-38000
3189,景碩            ,2821000,2944000,-123000,0,0,0,420000,413000,7000,78000,415000,323000,92000,40000,54000,-14000,-38000
058803,世紀鋼元大99購03,0,0,0,0,0,0,0,0,0,-39000,0,0,0,89000,128000,-39000,-39000
057299,立積永豐98購02  ,0,0,0,0,0,0,0,0,0,-39000,0,0,0,0,39000,-39000,-39000
057190,立積元大9A購02  ,0,0,0,0,0,0,0,0,0,-39000,0,0,0,20000,59000,-39000,-39000
057085,立積統一9B購02  ,0,0,0,0,0,0,0,0,0,-39000,0,0,0,0,39000,-39000,-39000
054033,欣興中信96購02  ,0,0,0,0,0,0,0,0,0,-39000,0,0,0,0,39000,-39000,-39000
052667,漢唐群益96購01  ,0,0,0,0,0,0,0,0,0,-39000,0,0,0,11000,50000,-39000,-39000
2305,全友            ,18000,61000,-43000,0,0,0,0,0,0,4000,4000,0,4000,0,0,0,-39000
058864,欣興凱基99購04  ,0,0,0,0,0,0,0,0,0,-40000,0,0,0,0,40000,-40000,-40000
058780,牧德國票9A購01  ,0,0,0,0,0,0,0,0,0,-40000,0,0,0,0,40000,-40000,-40000
058985,可成凱基99購03  ,0,0,0,0,0,0,0,0,0,-40000,0,0,0,10000,50000,-40000,-40000
059060,大立光凱基9A購03,0,0,0,0,0,0,0,0,0,-40000,0,0,0,100000,140000,-40000,-40000
058706,聯鈞元大9C購01  ,0,0,0,0,0,0,0,0,0,-40000,0,0,0,0,40000,-40000,-40000
058692,華邦電國票9B購01,0,0,0,0,0,0,0,0,0,-40000,0,0,0,0,40000,-40000,-40000
058635,華新科兆豐99購03,0,0,0,0,0,0,0,0,0,-40000,0,0,0,0,40000,-40000,-40000
05852P,嘉晶群益96售01  ,0,0,0,0,0,0,0,0,0,-40000,0,0,0,0,40000,-40000,-40000
058558,鴻海日盛9A購02  ,0,0,0,0,0,0,0,0,0,-40000,0,0,0,0,40000,-40000,-40000
058402,欣興元大99購04  ,0,0,0,0,0,0,0,0,0,-40000,0,0,0,0,40000,-40000,-40000
058055,華擎統一9A購01  ,0,0,0,0,0,0,0,0,0,-40000,0,0,0,0,40000,-40000,-40000
058046,國巨元大9A購01  ,0,0,0,0,0,0,0,0,0,-40000,0,0,0,10000,50000,-40000,-40000
058076,神達凱基98購02  ,0,0,0,0,0,0,0,0,0,-40000,0,0,0,10000,50000,-40000,-40000
058077,超眾凱基98購02  ,0,0,0,0,0,0,0,0,0,-40000,0,0,0,20000,60000,-40000,-40000
057876,隆達元大98購01  ,0,0,0,0,0,0,0,0,0,-40000,0,0,0,0,40000,-40000,-40000
058130,瑞昱元大99購01  ,0,0,0,0,0,0,0,0,0,-40000,0,0,0,123000,163000,-40000,-40000
057451,大立光元富9B購01,0,0,0,0,0,0,0,0,0,-40000,0,0,0,20000,60000,-40000,-40000
07029P,緯穎群益99售02  ,0,0,0,0,0,0,0,0,0,-40000,0,0,0,0,40000,-40000,-40000
06626P,大立光統一9A售01,0,0,0,0,0,0,0,0,0,-40000,0,0,0,0,40000,-40000,-40000
059181,世紀鋼元富9C購01,0,0,0,0,0,0,0,0,0,-40000,0,0,0,0,40000,-40000,-40000
06162P,大立光群益97售02,0,0,0,0,0,0,0,0,0,-40000,0,0,0,85000,125000,-40000,-40000
052189,玉晶光群益96購06,0,0,0,0,0,0,0,0,0,-40000,0,0,0,0,40000,-40000,-40000
051194,大立光中信96購02,0,0,0,0,0,0,0,0,0,-40000,0,0,0,0,40000,-40000,-40000
051100,同欣電元大95購01,0,0,0,0,0,0,0,0,0,-40000,0,0,0,0,40000,-40000,-40000
05111P,台積電統一95售04,0,0,0,0,0,0,0,0,0,-40000,0,0,0,30000,70000,-40000,-40000
050680,上銀元富94購01  ,0,0,0,0,0,0,0,0,0,-40000,0,0,0,0,40000,-40000,-40000
050744,健策永豐94購04  ,0,0,0,0,0,0,0,0,0,-40000,0,0,0,0,40000,-40000,-40000
04945P,鴻海永豐94售06  ,0,0,0,0,0,0,0,0,0,-40000,0,0,0,6000,46000,-40000,-40000
050774,健策元大96購02  ,0,0,0,0,0,0,0,0,0,-40000,0,0,0,140000,180000,-40000,-40000
052095,彩晶元大97購01  ,0,0,0,0,0,0,0,0,0,-40000,0,0,0,0,40000,-40000,-40000
049362,國巨元大94購04  ,0,0,0,0,0,0,0,0,0,-40000,0,0,0,0,40000,-40000,-40000
050031,嘉澤元大95購01  ,0,0,0,0,0,0,0,0,0,-40000,0,0,0,50000,90000,-40000,-40000
049859,味全兆豐95購01  ,0,0,0,0,0,0,0,0,0,-40000,0,0,0,0,40000,-40000,-40000
055976,台積電統一99購03,0,0,0,0,0,0,0,0,0,-40000,0,0,0,0,40000,-40000,-40000
055603,超眾元大97購04  ,0,0,0,0,0,0,0,0,0,-40000,0,0,0,0,40000,-40000,-40000
055483,和大元大97購03  ,0,0,0,0,0,0,0,0,0,-40000,0,0,0,0,40000,-40000,-40000
055711,上銀元大97購04  ,0,0,0,0,0,0,0,0,0,-40000,0,0,0,0,40000,-40000,-40000
051348,國巨元大95購07  ,0,0,0,0,0,0,0,0,0,-40000,0,0,0,0,40000,-40000,-40000
05152P,玉晶光群益96售05,0,0,0,0,0,0,0,0,0,-40000,0,0,0,0,40000,-40000,-40000
049143,智邦元大94購02  ,0,0,0,0,0,0,0,0,0,-40000,0,0,0,0,40000,-40000,-40000
052276,力成群益96購01  ,0,0,0,0,0,0,0,0,0,-40000,0,0,0,0,40000,-40000,-40000
04896P,上証2X中信95售01,0,0,0,0,0,0,0,0,0,-40000,0,0,0,35000,75000,-40000,-40000
03657C,T50反1元大99牛01,0,0,0,0,0,0,0,0,0,-40000,0,0,0,0,40000,-40000,-40000
04407P,滬深2X統一94售02,0,0,0,0,0,0,0,0,0,-40000,0,0,0,0,40000,-40000,-40000
048257,台積電統一93購07,0,0,0,0,0,0,0,0,0,-40000,0,0,0,0,40000,-40000,-40000
048350,世紀鋼元大95購01,0,0,0,0,0,0,0,0,0,-40000,0,0,0,120000,160000,-40000,-40000
04830P,大立光凱基94售15,0,0,0,0,0,0,0,0,0,-40000,0,0,0,0,40000,-40000,-40000
050259,鴻海元大94購14  ,0,0,0,0,0,0,0,0,0,-40000,0,0,0,0,40000,-40000,-40000
050174,技嘉元大94購01  ,0,0,0,0,0,0,0,0,0,-40000,0,0,0,0,40000,-40000,-40000
05189P,新光金凱基97售02,0,0,0,0,0,0,0,0,0,-40000,0,0,0,25000,65000,-40000,-40000
051798,國巨永豐95購03  ,0,0,0,0,0,0,0,0,0,-40000,0,0,0,0,40000,-40000,-40000
045906,鴻海中信94購01  ,0,0,0,0,0,0,0,0,0,-40000,0,0,0,0,40000,-40000,-40000
052691,GIS元大96購01   ,0,0,0,0,0,0,0,0,0,-40000,0,0,0,0,40000,-40000,-40000
054303,國巨凱基96購15  ,0,0,0,0,0,0,0,0,0,-40000,0,0,0,10000,50000,-40000,-40000
056678,力成元富98購01  ,0,0,0,0,0,0,0,0,0,-40000,0,0,0,100000,140000,-40000,-40000
052943,奇力新國票96購02,0,0,0,0,0,0,0,0,0,-40000,0,0,0,0,40000,-40000,-40000
052831,華固群益96購01  ,0,0,0,0,0,0,0,0,0,-40000,0,0,0,0,40000,-40000,-40000
05277P,深中小統一95售02,0,0,0,0,0,0,0,0,0,-40000,0,0,0,0,40000,-40000,-40000
053381,友達元大9A購02  ,0,0,0,0,0,0,0,0,0,-40000,0,0,0,10000,50000,-40000,-40000
052548,旺宏亞東96購01  ,0,0,0,0,0,0,0,0,0,-40000,0,0,0,0,40000,-40000,-40000
054263,聯茂元大96購02  ,0,0,0,0,0,0,0,0,0,-40000,0,0,0,0,40000,-40000,-40000
055776,宏達電凱基98購02,0,0,0,0,0,0,0,0,0,-40000,0,0,0,0,40000,-40000,-40000
053146,滬深2X元大96購08,0,0,0,0,0,0,0,0,0,-40000,0,0,0,0,40000,-40000,-40000
056073,智伸科元大97購01,0,0,0,0,0,0,0,0,0,-40000,0,0,0,0,40000,-40000,-40000
056297,台光電元大97購04,0,0,0,0,0,0,0,0,0,-40000,0,0,0,20000,60000,-40000,-40000
056581,超眾元大99購01  ,0,0,0,0,0,0,0,0,0,-40000,0,0,0,20000,60000,-40000,-40000
053713,漢唐凱基96購04  ,0,0,0,0,0,0,0,0,0,-40000,0,0,0,0,40000,-40000,-40000
053745,康友國票97購01  ,0,0,0,0,0,0,0,0,0,-40000,0,0,0,0,40000,-40000,-40000
054437,欣興台新97購02  ,0,0,0,0,0,0,0,0,0,-40000,0,0,0,0,40000,-40000,-40000
054467,隆達凱基97購01  ,0,0,0,0,0,0,0,0,0,-40000,0,0,0,0,40000,-40000,-40000
053690,南亞科元大96購02,0,0,0,0,0,0,0,0,0,-40000,0,0,0,60000,100000,-40000,-40000
054861,智邦群益97購01  ,0,0,0,0,0,0,0,0,0,-40000,0,0,0,0,40000,-40000,-40000
057304,為升兆豐99購02  ,0,0,0,0,0,0,0,0,0,-40000,0,0,0,0,40000,-40000,-40000
055080,正崴中信99購01  ,0,0,0,0,0,0,0,0,0,-40000,0,0,0,0,40000,-40000,-40000
055031,南港富邦99購01  ,0,0,0,0,0,0,0,0,0,-40000,0,0,0,0,40000,-40000,-40000
055231,大毅國票98購02  ,0,0,0,0,0,0,0,0,0,-40000,0,0,0,0,40000,-40000,-40000
055368,台積電元大97購24,0,0,0,0,0,0,0,0,0,-40000,0,0,0,0,40000,-40000,-40000
06589P,台積電元大98售12,0,0,0,0,0,0,0,0,0,-41000,0,0,0,301000,342000,-41000,-41000
06472P,道瓊銀元大98售03,0,0,0,0,0,0,0,0,0,-41000,0,0,0,0,41000,-41000,-41000
1711,永光            ,64000,107000,-43000,0,0,0,0,0,0,2000,3000,1000,2000,0,0,0,-41000
058372,欣興凱基99購03  ,0,0,0,0,0,0,0,0,0,-41000,0,0,0,0,41000,-41000,-41000
058503,鴻海元大99購14  ,0,0,0,0,0,0,0,0,0,-41000,0,0,0,47000,88000,-41000,-41000
059054,國巨凱基99購11  ,0,0,0,0,0,0,0,0,0,-41000,0,0,0,10000,51000,-41000,-41000
059021,台積電統一9B購07,0,0,0,0,0,0,0,0,0,-41000,0,0,0,10000,51000,-41000,-41000
058953,S&P反1國票03購01,0,0,0,0,0,0,0,0,0,-41000,0,0,0,0,41000,-41000,-41000
058757,道瓊銀群益9A購02,0,0,0,0,0,0,0,0,0,-41000,0,0,0,200000,241000,-41000,-41000
03009X,元展09          ,0,0,0,0,0,0,0,0,0,-41000,0,0,0,0,41000,-41000,-41000
052829,上銀群益96購01  ,0,0,0,0,0,0,0,0,0,-41000,0,0,0,0,41000,-41000,-41000
2816,旺旺保          ,21000,50000,-29000,0,0,0,0,0,0,-12000,0,12000,-12000,0,0,0,-41000
5484,慧友            ,0,41000,-41000,0,0,0,0,0,0,0,0,0,0,0,0,0,-41000
058912,祥碩元大99購01  ,0,0,0,0,0,0,0,0,0,-42000,0,0,0,150000,192000,-42000,-42000
058400,聯發科元大99購09,0,0,0,0,0,0,0,0,0,-42000,0,0,0,230000,272000,-42000,-42000
00660,元大歐洲50      ,0,0,0,0,0,0,0,0,0,-42000,0,0,0,20000,62000,-42000,-42000
04835P,鴻海元大94售18  ,0,0,0,0,0,0,0,0,0,-42000,0,0,0,3000,45000,-42000,-42000
046813,聯電凱基96購01  ,0,0,0,0,0,0,0,0,0,-42000,0,0,0,1000,43000,-42000,-42000
051578,智邦元大96購01  ,0,0,0,0,0,0,0,0,0,-42000,0,0,0,213000,255000,-42000,-42000
052806,玉晶光元大98購04,0,0,0,0,0,0,0,0,0,-42000,0,0,0,142000,184000,-42000,-42000
056440,智邦凱基98購03  ,0,0,0,0,0,0,0,0,0,-42000,0,0,0,0,42000,-42000,-42000
056226,聯發科凱基97購10,0,0,0,0,0,0,0,0,0,-42000,0,0,0,0,42000,-42000,-42000
054755,世紀鋼凱基98購01,0,0,0,0,0,0,0,0,0,-42000,0,0,0,93000,135000,-42000,-42000
055221,矽創凱基97購02  ,0,0,0,0,0,0,0,0,0,-42000,0,0,0,0,42000,-42000,-42000
055017,緯穎元富97購01  ,0,0,0,0,0,0,0,0,0,-42000,0,0,0,64000,106000,-42000,-42000
055145,T50反1元大97購04,0,0,0,0,0,0,0,0,0,-42000,0,0,0,0,42000,-42000,-42000
056911,緯穎元大99購01  ,0,0,0,0,0,0,0,0,0,-42000,0,0,0,63000,105000,-42000,-42000
056153,華新科凱基97購02,0,0,0,0,0,0,0,0,0,-42000,0,0,0,0,42000,-42000,-42000
052454,力成元大95購02  ,0,0,0,0,0,0,0,0,0,-42000,0,0,0,35000,77000,-42000,-42000
058344,旺宏群益99購05  ,0,0,0,0,0,0,0,0,0,-43000,0,0,0,0,43000,-43000,-43000
058984,全新凱基9A購03  ,0,0,0,0,0,0,0,0,0,-43000,0,0,0,17000,60000,-43000,-43000
058839,瑞儀中信99購02  ,0,0,0,0,0,0,0,0,0,-43000,0,0,0,10000,53000,-43000,-43000
1108,幸福            ,8000,51000,-43000,0,0,0,0,0,0,0,0,0,0,0,0,0,-43000
06491P,台積電富邦99售02,0,0,0,0,0,0,0,0,0,-43000,0,0,0,0,43000,-43000,-43000
05994P,奇鋐元大96售02  ,0,0,0,0,0,0,0,0,0,-43000,0,0,0,218000,261000,-43000,-43000
049490,京元電元大95購02,0,0,0,0,0,0,0,0,0,-43000,0,0,0,20000,63000,-43000,-43000
048733,台勝科麥證95購02,0,0,0,42000,85000,-43000,0,0,0,-43000,0,0,0,42000,85000,-43000,-43000
052428,嘉晶永豐95購01  ,0,0,0,0,0,0,0,0,0,-43000,0,0,0,75000,118000,-43000,-43000
057243,樺漢凱基99購01  ,0,0,0,0,0,0,0,0,0,-43000,0,0,0,0,43000,-43000,-43000
2706,第一店          ,4000,47000,-43000,0,0,0,0,0,0,0,0,0,0,0,0,0,-43000
058166,鴻海凱基9A購01  ,0,0,0,0,0,0,0,0,0,-44000,0,0,0,27000,71000,-44000,-44000
058173,台積電凱基99購04,0,0,0,0,0,0,0,0,0,-44000,0,0,0,30000,74000,-44000,-44000
04565P,聯詠凱基94售01  ,0,0,0,0,0,0,0,0,0,-44000,0,0,0,6000,50000,-44000,-44000
00690,兆豐藍籌30      ,6000,6000,0,0,0,0,0,0,0,-44000,0,0,0,180000,224000,-44000,-44000
00688L,國泰20年美債正2 ,0,0,0,0,0,0,0,0,0,-44000,0,0,0,106000,150000,-44000,-44000
057042,台積電元大98購10,0,0,0,0,0,0,0,0,0,-44000,0,0,0,31000,75000,-44000,-44000
053467,鴻海元大96購20  ,0,0,0,0,0,0,0,0,0,-44000,0,0,0,80000,124000,-44000,-44000
055304,瑞昱第一98購01  ,0,0,0,0,0,0,0,0,0,-44000,0,0,0,0,44000,-44000,-44000
2227,裕日車          ,9000,57000,-48000,0,0,0,4000,0,4000,0,0,0,0,0,0,0,-44000
058224,世芯統一9B購02  ,0,0,0,0,0,0,0,0,0,-45000,0,0,0,0,45000,-45000,-45000
058983,旺宏凱基99購05  ,0,0,0,0,0,0,0,0,0,-45000,0,0,0,0,45000,-45000,-45000
059010,臺股指元大99購12,0,0,0,0,0,0,0,0,0,-45000,0,0,0,5000,50000,-45000,-45000
05856P,A50正2中信99售01,0,0,0,0,0,0,0,0,0,-45000,0,0,0,55000,100000,-45000,-45000
06069P,台積電永豐97售01,0,0,0,0,0,0,0,0,0,-45000,0,0,0,1000,46000,-45000,-45000
1712,興農            ,263000,308000,-45000,0,0,0,0,0,0,0,0,0,0,0,0,0,-45000
1560,中砂            ,111000,156000,-45000,0,0,0,0,0,0,0,0,0,0,0,0,0,-45000
00668,國泰美國道瓊    ,133000,0,133000,0,0,0,0,0,0,-178000,0,0,0,102000,280000,-178000,-45000
046870,大立光統一95購01,0,0,0,0,0,0,0,0,0,-45000,0,0,0,0,45000,-45000,-45000
04799P,健策元大94售03  ,0,0,0,0,0,0,0,0,0,-45000,0,0,0,10000,55000,-45000,-45000
052055,緯穎凱基95購03  ,0,0,0,0,0,0,0,0,0,-45000,0,0,0,8000,53000,-45000,-45000
051393,新光金兆豐96購01,0,0,0,0,0,0,0,0,0,-45000,0,0,0,0,45000,-45000,-45000
055468,智邦凱基97購04  ,0,0,0,0,0,0,0,0,0,-45000,0,0,0,0,45000,-45000,-45000
054270,寶滬深中信98購01,0,0,0,0,0,0,0,0,0,-45000,0,0,0,0,45000,-45000,-45000
056598,京元電元富98購01,0,0,0,0,0,0,0,0,0,-45000,0,0,0,0,45000,-45000,-45000
054418,茂林元大97購01  ,0,0,0,0,0,0,0,0,0,-45000,0,0,0,10000,55000,-45000,-45000
054079,鴻海中信98購02  ,0,0,0,0,0,0,0,0,0,-45000,0,0,0,0,45000,-45000,-45000
05704P,矽力群益96售04  ,0,0,0,0,0,0,0,0,0,-45000,0,0,0,3000,48000,-45000,-45000
2704,國賓            ,21000,66000,-45000,0,0,0,0,0,0,0,0,0,0,0,0,0,-45000
8463,潤泰材          ,132000,177000,-45000,0,0,0,0,0,0,0,0,0,0,0,0,0,-45000
6277,宏正            ,50000,61710,-11710,0,0,0,0,0,0,-34000,4000,38000,-34000,0,0,0,-45710
06660P,大立光富邦9B售03,0,0,0,0,0,0,0,0,0,-46000,0,0,0,29000,75000,-46000,-46000
058899,旺宏元大99購10  ,0,0,0,0,0,0,0,0,0,-46000,0,0,0,10000,56000,-46000,-46000
058886,元石油元大9C購03,0,0,0,0,0,0,0,0,0,-46000,0,0,0,0,46000,-46000,-46000
058238,奇鋐元大99購02  ,0,0,0,0,0,0,0,0,0,-46000,0,0,0,9000,55000,-46000,-46000
050311,上銀兆豐95購01  ,0,0,0,0,0,0,0,0,0,-46000,0,0,0,306000,352000,-46000,-46000
056893,智邦元大98購02  ,0,0,0,0,0,0,0,0,0,-46000,0,0,0,50000,96000,-46000,-46000
056545,TPK凱基98購02   ,0,0,0,0,0,0,0,0,0,-46000,0,0,0,0,46000,-46000,-46000
056071,創意元大97購02  ,0,0,0,0,0,0,0,0,0,-46000,0,0,0,10000,56000,-46000,-46000
6443,元晶            ,98000,144000,-46000,0,0,0,0,0,0,0,0,0,0,0,0,0,-46000
8016,矽創            ,824000,883000,-59000,0,0,0,34000,20000,14000,-1000,3000,22000,-19000,22000,4000,18000,-46000
2546,根基            ,24000,70000,-46000,0,0,0,0,0,0,0,0,0,0,0,0,0,-46000
2352,佳世達          ,1353000,1498000,-145000,0,0,0,16000,0,16000,83000,156000,49000,107000,0,24000,-24000,-46000
6192,巨路            ,84000,131000,-47000,0,0,0,0,0,0,1000,2000,1000,1000,0,0,0,-46000
3702A,大聯大甲特      ,0,26000,-26000,0,0,0,0,0,0,-20000,0,20000,-20000,0,0,0,-46000
046476,鴻海統一96購01  ,0,0,0,0,0,0,0,0,0,-47000,0,0,0,0,47000,-47000,-47000
048732,台勝科麥證95購01,0,0,0,19000,66000,-47000,0,0,0,-47000,0,0,0,19000,66000,-47000,-47000
056334,台積電凱基98購06,0,0,0,0,0,0,0,0,0,-47000,0,0,0,0,47000,-47000,-47000
054293,健策元大98購02  ,0,0,0,0,0,0,0,0,0,-47000,0,0,0,278000,325000,-47000,-47000
054309,禾伸堂凱基98購01,0,0,0,0,0,0,0,0,0,-47000,0,0,0,10000,57000,-47000,-47000
054071,泰鼎國泰97購02  ,0,0,0,0,0,0,0,0,0,-47000,0,0,0,3000,50000,-47000,-47000
2867,三商壽          ,1211000,1307000,-96000,0,0,0,0,0,0,49000,53000,4000,49000,0,0,0,-47000
058092,牧德元大98購02  ,0,0,0,0,0,0,0,0,0,-48000,0,0,0,2000,50000,-48000,-48000
057818,泰碩元大9A購01  ,0,0,0,0,0,0,0,0,0,-48000,0,0,0,18000,66000,-48000,-48000
058758,台積電群益99購05,0,0,0,0,0,0,0,0,0,-48000,0,0,0,0,48000,-48000,-48000
050217,健策永豐94購03  ,0,0,0,0,0,0,0,0,0,-48000,0,0,0,50000,98000,-48000,-48000
050305,正崴中信95購01  ,0,0,0,0,0,0,0,0,0,-48000,0,0,0,0,48000,-48000,-48000
052230,大立光凱基96購09,0,0,0,0,0,0,0,0,0,-48000,0,0,0,2000,50000,-48000,-48000
048874,玉晶光國票96購01,0,0,0,0,0,0,0,0,0,-48000,0,0,0,25000,73000,-48000,-48000
051939,同欣電群益97購01,0,0,0,0,0,0,0,0,0,-48000,0,0,0,11000,59000,-48000,-48000
053759,晶相光國泰98購01,0,0,0,0,0,0,0,0,0,-48000,0,0,0,1000,49000,-48000,-48000
054899,南港康和97購01  ,0,0,0,0,0,0,0,0,0,-48000,0,0,0,2000,50000,-48000,-48000
052521,友達元大9B購01  ,0,0,0,0,0,0,0,0,0,-48000,0,0,0,20000,68000,-48000,-48000
055406,大毅國泰99購01  ,0,0,0,0,0,0,0,0,0,-48000,0,0,0,153000,201000,-48000,-48000
2832,台產            ,44000,96000,-52000,0,0,0,0,0,0,4000,5000,1000,4000,0,0,0,-48000
4960,誠美材          ,0,48000,-48000,0,0,0,0,0,0,0,0,0,0,0,0,0,-48000
058088,鴻海元大9A購01  ,0,0,0,0,0,0,0,0,0,-49000,0,0,0,59000,108000,-49000,-49000
1709,和益            ,143000,192000,-49000,0,0,0,0,0,0,0,0,0,0,0,0,0,-49000
052482,茂林群益95購01  ,0,0,0,0,0,0,0,0,0,-49000,0,0,0,0,49000,-49000,-49000
053724,聯詠凱基96購04  ,0,0,0,0,0,0,0,0,0,-49000,0,0,0,150000,199000,-49000,-49000
053686,台積電元大97購08,0,0,0,0,0,0,0,0,0,-49000,0,0,0,0,49000,-49000,-49000
057033,A50反1元大9B購02,0,0,0,0,0,0,0,0,0,-49000,0,0,0,0,49000,-49000,-49000
3010,華立            ,67000,130000,-63000,0,0,0,0,0,0,14000,15000,1000,14000,0,0,0,-49000
06958P,FBVIX凱基9C售02 ,0,0,0,0,0,0,0,0,0,-50000,0,0,0,0,50000,-50000,-50000
06268P,聯詠凱基97售02  ,0,0,0,0,0,0,0,0,0,-50000,0,0,0,0,50000,-50000,-50000
06237P,台積電元大97售26,0,0,0,0,0,0,0,0,0,-50000,0,0,0,368000,418000,-50000,-50000
058049,帆宣元大98購01  ,0,0,0,0,0,0,0,0,0,-50000,0,0,0,0,50000,-50000,-50000
058307,聯發科元大99購08,0,0,0,0,0,0,0,0,0,-50000,0,0,0,75000,125000,-50000,-50000
058289,奇鋐國票9A購01  ,0,0,0,0,0,0,0,0,0,-50000,0,0,0,0,50000,-50000,-50000
058135,景碩元大99購01  ,0,0,0,0,0,0,0,0,0,-50000,0,0,0,0,50000,-50000,-50000
057863,美律凱基9A購01  ,0,0,0,0,0,0,0,0,0,-50000,0,0,0,0,50000,-50000,-50000
057849,南茂永豐98購02  ,0,0,0,0,0,0,0,0,0,-50000,0,0,0,0,50000,-50000,-50000
057430,富邦金兆豐98購01,0,0,0,0,0,0,0,0,0,-50000,0,0,0,0,50000,-50000,-50000
057585,鴻海國票99購05  ,0,0,0,0,0,0,0,0,0,-50000,0,0,0,100000,150000,-50000,-50000
058735,南茂永豐99購01  ,0,0,0,0,0,0,0,0,0,-50000,0,0,0,0,50000,-50000,-50000
058903,聯發科元大99購16,0,0,0,0,0,0,0,0,0,-50000,0,0,0,327000,377000,-50000,-50000
058846,鴻海群益99購03  ,0,0,0,0,0,0,0,0,0,-50000,0,0,0,0,50000,-50000,-50000
058411,技嘉兆豐99購01  ,0,0,0,0,0,0,0,0,0,-50000,0,0,0,0,50000,-50000,-50000
050634,華新科群益96購01,0,0,0,0,0,0,0,0,0,-50000,0,0,0,0,50000,-50000,-50000
049929,祥碩元大94購03  ,0,0,0,0,0,0,0,0,0,-50000,0,0,0,0,50000,-50000,-50000
050115,群創元大96購01  ,0,0,0,0,0,0,0,0,0,-50000,0,0,0,0,50000,-50000,-50000
051697,康友中信95購02  ,0,0,0,0,0,0,0,0,0,-50000,0,0,0,0,50000,-50000,-50000
051735,台積電國票96購06,0,0,0,0,0,0,0,0,0,-50000,0,0,0,1350000,1400000,-50000,-50000
051756,台積電元大97購04,0,0,0,0,0,0,0,0,0,-50000,0,0,0,0,50000,-50000,-50000
051234,南電群益95購02  ,0,0,0,0,0,0,0,0,0,-50000,0,0,0,50000,100000,-50000,-50000
051083,A50正2元大98購01,0,0,0,0,0,0,0,0,0,-50000,0,0,0,1000,51000,-50000,-50000
052067,中磊兆豐96購01  ,0,0,0,0,0,0,0,0,0,-50000,0,0,0,0,50000,-50000,-50000
052120,友達國票96購01  ,0,0,0,0,0,0,0,0,0,-50000,0,0,0,80000,130000,-50000,-50000
049583,台積電元大95購04,0,0,0,0,0,0,0,0,0,-50000,0,0,0,20000,70000,-50000,-50000
055513,旺宏亞東98購01  ,0,0,0,0,0,0,0,0,0,-50000,0,0,0,1060000,1110000,-50000,-50000
05562P,鴻海元大96售16  ,0,0,0,0,0,0,0,0,0,-50000,0,0,0,0,50000,-50000,-50000
051667,光磊元大96購02  ,0,0,0,0,0,0,0,0,0,-50000,0,0,0,0,50000,-50000,-50000
052348,台光電富邦95購01,0,0,0,0,0,0,0,0,0,-50000,0,0,0,0,50000,-50000,-50000
049044,和碩兆豐94購01  ,0,0,0,0,0,0,0,0,0,-50000,0,0,0,0,50000,-50000,-50000
049150,新光金元大96購01,0,0,0,0,0,0,0,0,0,-50000,0,0,0,0,50000,-50000,-50000
051025,晶華統一95購01  ,0,0,0,0,0,0,0,0,0,-50000,0,0,0,0,50000,-50000,-50000
050309,亞泥兆豐94購01  ,0,0,0,0,0,0,0,0,0,-50000,0,0,0,0,50000,-50000,-50000
050374,上緯控元大95購01,0,0,0,0,0,0,0,0,0,-50000,0,0,0,0,50000,-50000,-50000
050456,聯茂元大94購09  ,0,0,0,0,0,0,0,0,0,-50000,0,0,0,0,50000,-50000,-50000
051801,牧德永豐95購04  ,0,0,0,0,0,0,0,0,0,-50000,0,0,0,0,50000,-50000,-50000
051842,大成鋼富邦97購01,0,0,0,0,0,0,0,0,0,-50000,0,0,0,0,50000,-50000,-50000
046865,鴻海統一95購01  ,0,0,0,0,0,0,0,0,0,-50000,0,0,0,0,50000,-50000,-50000
047439,漢唐元大95購01  ,0,0,0,0,0,0,0,0,0,-50000,0,0,0,10000,60000,-50000,-50000
045598,上証2X中信94購02,0,0,0,0,0,0,0,0,0,-50000,0,0,0,0,50000,-50000,-50000
04791P,台積電元大94售20,0,0,0,0,0,0,0,0,0,-50000,0,0,0,0,50000,-50000,-50000
048128,超眾元大95購01  ,0,0,0,0,0,0,0,0,0,-50000,0,0,0,0,50000,-50000,-50000
048181,A50正2群益95購01,0,0,0,0,0,0,0,0,0,-50000,0,0,0,0,50000,-50000,-50000
044589,國巨統一93購03  ,0,0,0,0,0,0,0,0,0,-50000,0,0,0,0,50000,-50000,-50000
057021,台積電凱基9A購02,0,0,0,0,0,0,0,0,0,-50000,0,0,0,0,50000,-50000,-50000
056900,可成元大98購02  ,0,0,0,0,0,0,0,0,0,-50000,0,0,0,20000,70000,-50000,-50000
056855,祥碩中信98購02  ,0,0,0,0,0,0,0,0,0,-50000,0,0,0,0,50000,-50000,-50000
055110,美律凱基98購02  ,0,0,0,0,0,0,0,0,0,-50000,0,0,0,0,50000,-50000,-50000
055014,達興元富97購01  ,0,0,0,0,0,0,0,0,0,-50000,0,0,0,50000,100000,-50000,-50000
055035,興勤富邦98購01  ,0,0,0,0,0,0,0,0,0,-50000,0,0,0,0,50000,-50000,-50000
054758,南亞國票9A購01  ,0,0,0,0,0,0,0,0,0,-50000,0,0,0,0,50000,-50000,-50000
055375,京鼎元大97購03  ,0,0,0,0,0,0,0,0,0,-50000,0,0,0,0,50000,-50000,-50000
055366,國巨元大98購05  ,0,0,0,0,0,0,0,0,0,-50000,0,0,0,0,50000,-50000,-50000
057335,技嘉國票99購01  ,0,0,0,0,0,0,0,0,0,-50000,0,0,0,0,50000,-50000,-50000
056968,揚明光永豐98購02,0,0,0,0,0,0,0,0,0,-50000,0,0,0,0,50000,-50000,-50000
057149,京鼎國票99購02  ,0,0,0,0,0,0,0,0,0,-50000,0,0,0,0,50000,-50000,-50000
053723,奇鋐凱基98購01  ,0,0,0,0,0,0,0,0,0,-50000,0,0,0,0,50000,-50000,-50000
053857,宏達電富邦97購02,0,0,0,0,0,0,0,0,0,-50000,0,0,0,0,50000,-50000,-50000
054043,漢唐元大97購01  ,0,0,0,0,0,0,0,0,0,-50000,0,0,0,0,50000,-50000,-50000
054126,和大元大96購02  ,0,0,0,0,0,0,0,0,0,-50000,0,0,0,0,50000,-50000,-50000
054926,神達凱基98購01  ,0,0,0,0,0,0,0,0,0,-50000,0,0,0,0,50000,-50000,-50000
054918,華新科凱基98購02,0,0,0,0,0,0,0,0,0,-50000,0,0,0,0,50000,-50000,-50000
054968,佐登元大97購01  ,0,0,0,0,0,0,0,0,0,-50000,0,0,0,0,50000,-50000,-50000
054960,新日興元大97購02,0,0,0,0,0,0,0,0,0,-50000,0,0,0,50000,100000,-50000,-50000
054691,裕民永豐97購01  ,0,0,0,0,0,0,0,0,0,-50000,0,0,0,0,50000,-50000,-50000
054249,技嘉元大96購03  ,0,0,0,0,0,0,0,0,0,-50000,0,0,0,0,50000,-50000,-50000
054275,華通群益97購03  ,0,0,0,0,0,0,0,0,0,-50000,0,0,0,0,50000,-50000,-50000
056062,大立光元大97購12,0,0,0,0,0,0,0,0,0,-50000,0,0,0,0,50000,-50000,-50000
05665P,台積電凱基96售08,0,0,0,0,0,0,0,0,0,-50000,0,0,0,0,50000,-50000,-50000
052553,技嘉國票96購01  ,0,0,0,0,0,0,0,0,0,-50000,0,0,0,0,50000,-50000,-50000
052575,茂林凱基96購04  ,0,0,0,0,0,0,0,0,0,-50000,0,0,0,0,50000,-50000,-50000
052620,上証2X富邦97購02,0,0,0,0,0,0,0,0,0,-50000,0,0,0,0,50000,-50000,-50000
054410,國巨元大96購14  ,0,0,0,0,0,0,0,0,0,-50000,0,0,0,20000,70000,-50000,-50000
053385,聯詠元大96購02  ,0,0,0,0,0,0,0,0,0,-50000,0,0,0,65000,115000,-50000,-50000
053403,彩晶群益98購01  ,0,0,0,0,0,0,0,0,0,-50000,0,0,0,0,50000,-50000,-50000
052866,大立光凱基96購12,0,0,0,0,0,0,0,0,0,-50000,0,0,0,0,50000,-50000,-50000
052933,祥碩元大96購01  ,0,0,0,0,0,0,0,0,0,-50000,0,0,0,170000,220000,-50000,-50000
052925,日電貿永豐96購01,0,0,0,0,0,0,0,0,0,-50000,0,0,0,0,50000,-50000,-50000
053012,國巨統一96購03  ,0,0,0,0,0,0,0,0,0,-50000,0,0,0,0,50000,-50000,-50000
054350,美律國泰98購01  ,0,0,0,0,0,0,0,0,0,-50000,0,0,0,50000,100000,-50000,-50000
054306,聯發科凱基96購23,0,0,0,0,0,0,0,0,0,-50000,0,0,0,0,50000,-50000,-50000
052753,電子類元大96購02,0,0,0,0,0,0,0,0,0,-50000,0,0,0,0,50000,-50000,-50000
056772,欣興元大99購01  ,0,0,0,0,0,0,0,0,0,-50000,0,0,0,0,50000,-50000,-50000
053211,漢唐凱基96購03  ,0,0,0,0,0,0,0,0,0,-50000,0,0,0,0,50000,-50000,-50000
054285,國巨元大98購02  ,0,0,0,0,0,0,0,0,0,-50000,0,0,0,0,50000,-50000,-50000
058452,義隆永豐99購02  ,0,0,0,0,0,0,0,0,0,-51000,0,0,0,35000,86000,-51000,-51000
058991,台灣50元大03購01,0,0,0,0,0,0,0,0,0,-51000,0,0,0,4000,55000,-51000,-51000
058195,鈺齊永豐99購01  ,0,0,0,0,0,0,0,0,0,-51000,0,0,0,4000,55000,-51000,-51000
057966,金融類元大98購01,0,0,0,0,0,0,0,0,0,-51000,0,0,0,0,51000,-51000,-51000
059213,國巨元大99購19  ,0,0,0,0,0,0,0,0,0,-51000,0,0,0,10000,61000,-51000,-51000
059134,臺股指群益99購09,0,0,0,0,0,0,0,0,0,-51000,0,0,0,0,51000,-51000,-51000
06955P,臻鼎元富99售01  ,0,0,0,0,0,0,0,0,0,-51000,0,0,0,30000,81000,-51000,-51000
047194,世紀鋼元大96購01,0,0,0,0,0,0,0,0,0,-51000,0,0,0,46000,97000,-51000,-51000
050946,瑞昱群益95購01  ,0,0,0,0,0,0,0,0,0,-51000,0,0,0,0,51000,-51000,-51000
052313,聯電元大98購01  ,0,0,0,0,0,0,0,0,0,-51000,0,0,0,5000,56000,-51000,-51000
05232P,緯穎群益95售01  ,0,0,0,0,0,0,0,0,0,-51000,0,0,0,0,51000,-51000,-51000
04950P,上証2X中信96售02,0,0,0,0,0,0,0,0,0,-51000,0,0,0,15000,66000,-51000,-51000
050056,國巨凱基94購04  ,0,0,0,0,0,0,0,0,0,-51000,0,0,0,0,51000,-51000,-51000
056570,旺宏元大98購07  ,0,0,0,0,0,0,0,0,0,-51000,0,0,0,0,51000,-51000,-51000
053735,矽力中信97購01  ,0,0,0,0,0,0,0,0,0,-51000,0,0,0,23000,74000,-51000,-51000
1527,鑽全            ,205000,257000,-52000,0,0,0,0,0,0,0,0,0,0,0,0,0,-52000
1315,達新            ,369000,421000,-52000,0,0,0,0,0,0,0,0,0,0,0,0,0,-52000
06651P,華新科元大99售09,0,0,0,0,0,0,0,0,0,-52000,0,0,0,66000,118000,-52000,-52000
06527P,T50正2富邦9C售01,0,0,0,0,0,0,0,0,0,-52000,0,0,0,0,52000,-52000,-52000
057836,南亞科國泰9A購01,0,0,0,0,0,0,0,0,0,-52000,0,0,0,0,52000,-52000,-52000
053861,台光電元大98購01,0,0,0,0,0,0,0,0,0,-52000,0,0,0,32000,84000,-52000,-52000
056166,微星台新97購01  ,0,0,0,0,0,0,0,0,0,-52000,0,0,0,0,52000,-52000,-52000
056403,茂林群益98購01  ,0,0,0,0,0,0,0,0,0,-52000,0,0,0,0,52000,-52000,-52000
05636P,國巨永豐96售03  ,0,0,0,0,0,0,0,0,0,-52000,0,0,0,3000,55000,-52000,-52000
052920,景碩台新96購02  ,0,0,0,0,0,0,0,0,0,-52000,0,0,0,0,52000,-52000,-52000
058176,聯發科凱基99購05,0,0,0,0,0,0,0,0,0,-53000,0,0,0,0,53000,-53000,-53000
06564P,國巨富邦9A售04  ,0,0,0,0,0,0,0,0,0,-53000,0,0,0,7000,60000,-53000,-53000
059142,道瓊指國票9B購02,0,0,0,0,0,0,0,0,0,-53000,0,0,0,0,53000,-53000,-53000
07159P,台積電永豐99售04,0,0,0,0,0,0,0,0,0,-53000,0,0,0,32000,85000,-53000,-53000
051919,台郡元大96購02  ,0,0,0,0,0,0,0,0,0,-53000,0,0,0,0,53000,-53000,-53000
056713,華擎永豐98購01  ,0,0,0,0,0,0,0,0,0,-53000,0,0,0,150000,203000,-53000,-53000
056344,嘉晶凱基98購02  ,0,0,0,0,0,0,0,0,0,-53000,0,0,0,13000,66000,-53000,-53000
05467P,聯電元大95售02  ,0,0,0,0,0,0,0,0,0,-53000,0,0,0,10000,63000,-53000,-53000
057154,易華電國泰99購01,0,0,0,0,0,0,0,0,0,-53000,0,0,0,0,53000,-53000,-53000
054822,祥碩元大97購01  ,0,0,0,0,0,0,0,0,0,-53000,0,0,0,0,53000,-53000,-53000
2539,櫻花建          ,13000,66000,-53000,0,0,0,0,0,0,0,0,0,0,0,0,0,-53000
07133P,臺股指元大9A售27,0,0,0,0,0,0,0,0,0,-54000,0,0,0,3000,57000,-54000,-54000
06850P,聯茂元大98售06  ,0,0,0,0,0,0,0,0,0,-54000,0,0,0,42000,96000,-54000,-54000
06528P,台積電富邦99售03,0,0,0,0,0,0,0,0,0,-54000,0,0,0,17000,71000,-54000,-54000
057904,矽力永豐98購01  ,0,0,0,0,0,0,0,0,0,-54000,0,0,0,0,54000,-54000,-54000
058026,上銀富邦9A購01  ,0,0,0,0,0,0,0,0,0,-54000,0,0,0,20000,74000,-54000,-54000
052317,台積電元大96購11,0,0,0,0,0,0,0,0,0,-54000,0,0,0,0,54000,-54000,-54000
057060,緯穎元大98購05  ,0,0,0,0,0,0,0,0,0,-54000,0,0,0,90000,144000,-54000,-54000
054625,旺宏凱基98購03  ,0,0,0,0,0,0,0,0,0,-54000,0,0,0,0,54000,-54000,-54000
055313,南電群益97購01  ,0,0,0,0,0,0,0,0,0,-54000,0,0,0,0,54000,-54000,-54000
054360,智邦凱基96購03  ,0,0,0,0,0,0,0,0,0,-54000,0,0,0,0,54000,-54000,-54000
058115,台光電中信99購01,0,0,0,0,0,0,0,0,0,-55000,0,0,0,131000,186000,-55000,-55000
057933,聯發科群益98購06,0,0,0,0,0,0,0,0,0,-55000,0,0,0,25000,80000,-55000,-55000
057807,友訊元大98購02  ,0,0,0,0,0,0,0,0,0,-55000,0,0,0,5000,60000,-55000,-55000
057586,台積電國票99購06,0,0,0,0,0,0,0,0,0,-55000,0,0,0,0,55000,-55000,-55000
059093,旭富元大99購01  ,0,0,0,0,0,0,0,0,0,-55000,0,0,0,5000,60000,-55000,-55000
059161,鴻海凱基9A購09  ,0,0,0,0,0,0,0,0,0,-55000,0,0,0,0,55000,-55000,-55000
07173P,臺股指國票99售10,0,0,0,0,0,0,0,0,0,-55000,0,0,0,0,55000,-55000,-55000
050595,緯穎永豐94購03  ,0,0,0,0,0,0,0,0,0,-55000,0,0,0,46000,101000,-55000,-55000
051999,勤誠元大95購01  ,0,0,0,0,0,0,0,0,0,-55000,0,0,0,5000,60000,-55000,-55000
053184,世紀鋼元富96購01,0,0,0,0,0,0,0,0,0,-55000,0,0,0,179000,234000,-55000,-55000
052799,上銀元大96購01  ,0,0,0,0,0,0,0,0,0,-55000,0,0,0,0,55000,-55000,-55000
053023,泰鼎國泰97購01  ,0,0,0,0,0,0,0,0,0,-55000,0,0,0,0,55000,-55000,-55000
056246,祥碩群益97購01  ,0,0,0,0,0,0,0,0,0,-55000,0,0,0,320000,375000,-55000,-55000
055157,晶豪科元大97購01,0,0,0,0,0,0,0,0,0,-55000,0,0,0,0,55000,-55000,-55000
057374,禾伸堂元大99購03,0,0,0,0,0,0,0,0,0,-55000,0,0,0,20000,75000,-55000,-55000
2881A,富邦特          ,0,69000,-69000,0,0,0,0,0,0,14000,14000,0,14000,0,0,0,-55000
07017P,台灣50元富9B售02,0,0,0,0,0,0,0,0,0,-56000,0,0,0,30000,86000,-56000,-56000
06211P,鴻海元大98售04  ,0,0,0,0,0,0,0,0,0,-56000,0,0,0,20000,76000,-56000,-56000
057494,玉晶光元大99購09,0,0,0,0,0,0,0,0,0,-56000,0,0,0,10000,66000,-56000,-56000
058281,奇力新中信99購01,0,0,0,0,0,0,0,0,0,-56000,0,0,0,20000,76000,-56000,-56000
051873,緯穎凱基95購02  ,0,0,0,0,0,0,0,0,0,-56000,0,0,0,33000,89000,-56000,-56000
057366,智邦元大98購08  ,0,0,0,0,0,0,0,0,0,-56000,0,0,0,89000,145000,-56000,-56000
055126,嘉澤兆豐97購01  ,0,0,0,0,0,0,0,0,0,-56000,0,0,0,0,56000,-56000,-56000
055280,智邦元大97購01  ,0,0,0,0,0,0,0,0,0,-56000,0,0,0,0,56000,-56000,-56000
057541,台灣50康和9A購04,0,0,0,0,0,0,0,0,0,-57000,0,0,0,0,57000,-57000,-57000
058931,玉晶光統一9C購01,0,0,0,0,0,0,0,0,0,-57000,0,0,0,0,57000,-57000,-57000
058662,禾伸堂兆豐99購01,0,0,0,0,0,0,0,0,0,-57000,0,0,0,191000,248000,-57000,-57000
03437B,臺股指元富9C熊01,0,0,0,0,0,0,0,0,0,-57000,0,0,0,0,57000,-57000,-57000
055715,智邦元大97購04  ,0,0,0,0,0,0,0,0,0,-57000,0,0,0,3000,60000,-57000,-57000
056645,大立光凱基98購12,0,0,0,0,0,0,0,0,0,-57000,0,0,0,0,57000,-57000,-57000
056903,大立光元大99購04,0,0,0,0,0,0,0,0,0,-57000,0,0,0,33000,90000,-57000,-57000
057305,南亞科兆豐98購02,0,0,0,0,0,0,0,0,0,-57000,0,0,0,0,57000,-57000,-57000
057221,華通國票98購03  ,0,0,0,0,0,0,0,0,0,-57000,0,0,0,0,57000,-57000,-57000
058509,聯發科元大99購12,0,0,0,0,0,0,0,0,0,-58000,0,0,0,59000,117000,-58000,-58000
058476,旺宏凱基9A購01  ,0,0,0,0,0,0,0,0,0,-58000,0,0,0,0,58000,-58000,-58000
051668,智邦元大95購02  ,0,0,0,0,0,0,0,0,0,-58000,0,0,0,201000,259000,-58000,-58000
050653,聯鈞凱基96購01  ,0,0,0,0,0,0,0,0,0,-58000,0,0,0,4000,62000,-58000,-58000
6108,競國            ,125000,185000,-60000,0,0,0,0,0,0,2000,4000,2000,2000,0,0,0,-58000
058833,台表科永豐99購01,0,0,0,0,0,0,0,0,0,-59000,0,0,0,1000,60000,-59000,-59000
057579,長榮航中信9A購01,0,0,0,0,0,0,0,0,0,-59000,0,0,0,1000,60000,-59000,-59000
052038,國巨永昌96購01  ,0,0,0,0,0,0,0,0,0,-59000,0,0,0,310000,369000,-59000,-59000
049383,健策元大95購01  ,0,0,0,0,0,0,0,0,0,-59000,0,0,0,31000,90000,-59000,-59000
049314,京鼎凱基94購01  ,0,0,0,0,0,0,0,0,0,-59000,0,0,0,45000,104000,-59000,-59000
049885,緯穎永豐94購01  ,0,0,0,0,0,0,0,0,0,-59000,0,0,0,31000,90000,-59000,-59000
050315,和碩兆豐95購01  ,0,0,0,0,0,0,0,0,0,-59000,0,0,0,1000,60000,-59000,-59000
048007,明基材元大96購01,0,0,0,0,0,0,0,0,0,-59000,0,0,0,10000,69000,-59000,-59000
048049,滬深反中信96購01,0,0,0,0,0,0,0,0,0,-59000,0,0,0,103000,162000,-59000,-59000
057278,可成元大98購06  ,0,0,0,0,0,0,0,0,0,-59000,0,0,0,11000,70000,-59000,-59000
05525P,奇力新群益96售02,0,0,0,0,0,0,0,0,0,-59000,0,0,0,0,59000,-59000,-59000
052764,景碩群益98購01  ,0,0,0,0,0,0,0,0,0,-59000,0,0,0,0,59000,-59000,-59000
5531,鄉林            ,214264,274000,-59736,0,0,0,0,0,0,0,0,0,0,0,0,0,-59736
057565,可成富邦99購01  ,0,0,0,0,0,0,0,0,0,-60000,0,0,0,60000,120000,-60000,-60000
057559,可成兆豐99購02  ,0,0,0,0,0,0,0,0,0,-60000,0,0,0,0,60000,-60000,-60000
057477,智邦元大98購09  ,0,0,0,0,0,0,0,0,0,-60000,0,0,0,0,60000,-60000,-60000
057440,台積電統一98購10,0,0,0,0,0,0,0,0,0,-60000,0,0,0,0,60000,-60000,-60000
057788,嘉聯益國票99購01,0,0,0,0,0,0,0,0,0,-60000,0,0,0,0,60000,-60000,-60000
057858,T50正2康和98購01,0,0,0,0,0,0,0,0,0,-60000,0,0,0,0,60000,-60000,-60000
057738,旺宏富邦9A購01  ,0,0,0,0,0,0,0,0,0,-60000,0,0,0,0,60000,-60000,-60000
058278,FBVIX中信03購02 ,0,0,0,0,0,0,0,0,0,-60000,0,0,0,22000,82000,-60000,-60000
058308,全新元大9B購01  ,0,0,0,0,0,0,0,0,0,-60000,0,0,0,0,60000,-60000,-60000
058181,華新科國泰9B購01,0,0,0,0,0,0,0,0,0,-60000,0,0,0,0,60000,-60000,-60000
057909,台光電兆豐98購01,0,0,0,0,0,0,0,0,0,-60000,0,0,0,40000,100000,-60000,-60000
057918,旺宏凱基99購01  ,0,0,0,0,0,0,0,0,0,-60000,0,0,0,0,60000,-60000,-60000
058089,聯發科元大98購15,0,0,0,0,0,0,0,0,0,-60000,0,0,0,170000,230000,-60000,-60000
058071,大立光凱基98購19,0,0,0,0,0,0,0,0,0,-60000,0,0,0,0,60000,-60000,-60000
058746,華通凱基9A購02  ,0,0,0,0,0,0,0,0,0,-60000,0,0,0,0,60000,-60000,-60000
058657,大立光中信99購01,0,0,0,0,0,0,0,0,0,-60000,0,0,0,0,60000,-60000,-60000
059101,康控統一9A購01  ,0,0,0,0,0,0,0,0,0,-60000,0,0,0,0,60000,-60000,-60000
04784P,超眾元富94售01  ,0,0,0,0,0,0,0,0,0,-60000,0,0,0,0,60000,-60000,-60000
045837,群創群益98購02  ,0,0,0,0,0,0,0,0,0,-60000,0,0,0,0,60000,-60000,-60000
047684,景碩國泰94購01  ,0,0,0,0,0,0,0,0,0,-60000,0,0,0,0,60000,-60000,-60000
047063,漢唐凱基95購01  ,0,0,0,0,0,0,0,0,0,-60000,0,0,0,0,60000,-60000,-60000
047004,台積電統一99購01,0,0,0,0,0,0,0,0,0,-60000,0,0,0,0,60000,-60000,-60000
048710,奇力新台新94購01,0,0,0,0,0,0,0,0,0,-60000,0,0,0,0,60000,-60000,-60000
045087,玉晶光元大95購01,0,0,0,0,0,0,0,0,0,-60000,0,0,0,10000,70000,-60000,-60000
044965,大立光中信95購01,0,0,0,0,0,0,0,0,0,-60000,0,0,0,0,60000,-60000,-60000
05027P,南電群益95售01  ,0,0,0,0,0,0,0,0,0,-60000,0,0,0,10000,70000,-60000,-60000
04735P,聯茂兆豐94售01  ,0,0,0,0,0,0,0,0,0,-60000,0,0,0,10000,70000,-60000,-60000
047571,滬深2X群益99購01,0,0,0,0,0,0,0,0,0,-60000,0,0,0,0,60000,-60000,-60000
04752P,大立光群益94售07,0,0,0,0,0,0,0,0,0,-60000,0,0,0,0,60000,-60000,-60000
047548,友達凱基99購03  ,0,0,0,0,0,0,0,0,0,-60000,0,0,0,0,60000,-60000,-60000
04175P,台積電群益94售05,0,0,0,0,0,0,0,0,0,-60000,0,0,0,0,60000,-60000,-60000
048548,緯穎永豐93購02  ,0,0,0,0,0,0,0,0,0,-60000,0,0,0,0,60000,-60000,-60000
00709,富邦歐洲        ,0,0,0,0,0,0,0,0,0,-60000,0,0,0,100000,160000,-60000,-60000
03672C,臺股指凱基9C牛05,0,0,0,0,0,0,0,0,0,-60000,0,0,0,0,60000,-60000,-60000
051063,台郡群益95購01  ,0,0,0,0,0,0,0,0,0,-60000,0,0,0,0,60000,-60000,-60000
051639,康友國票96購02  ,0,0,0,0,0,0,0,0,0,-60000,0,0,0,15000,75000,-60000,-60000
055984,大立光元富97購02,0,0,0,0,0,0,0,0,0,-60000,0,0,0,22000,82000,-60000,-60000
056004,南電永豐97購02  ,0,0,0,0,0,0,0,0,0,-60000,0,0,0,0,60000,-60000,-60000
055964,正文元大97購02  ,0,0,0,0,0,0,0,0,0,-60000,0,0,0,0,60000,-60000,-60000
055935,創意群益97購02  ,0,0,0,0,0,0,0,0,0,-60000,0,0,0,0,60000,-60000,-60000
056039,宏達電凱基97購02,0,0,0,0,0,0,0,0,0,-60000,0,0,0,0,60000,-60000,-60000
055667,致茂群益98購01  ,0,0,0,0,0,0,0,0,0,-60000,0,0,0,0,60000,-60000,-60000
055594,華新科元大98購02,0,0,0,0,0,0,0,0,0,-60000,0,0,0,40000,100000,-60000,-60000
049003,智邦中信95購01  ,0,0,0,0,0,0,0,0,0,-60000,0,0,0,0,60000,-60000,-60000
052351,中環元富95購01  ,0,0,0,0,0,0,0,0,0,-60000,0,0,0,0,60000,-60000,-60000
051421,彩晶國票95購01  ,0,0,0,0,0,0,0,0,0,-60000,0,0,0,0,60000,-60000,-60000
053228,康友台新97購01  ,0,0,0,0,0,0,0,0,0,-60000,0,0,0,0,60000,-60000,-60000
053245,全新國票97購01  ,0,0,0,0,0,0,0,0,0,-60000,0,0,0,0,60000,-60000,-60000
055352,奇力新凱基97購01,0,0,0,0,0,0,0,0,0,-60000,0,0,0,0,60000,-60000,-60000
056702,欣興國泰9A購01  ,0,0,0,0,0,0,0,0,0,-60000,0,0,0,0,60000,-60000,-60000
052860,旺宏凱基96購03  ,0,0,0,0,0,0,0,0,0,-60000,0,0,0,0,60000,-60000,-60000
053376,鴻海元大96購19  ,0,0,0,0,0,0,0,0,0,-60000,0,0,0,0,60000,-60000,-60000
054398,牧德永豐96購03  ,0,0,0,0,0,0,0,0,0,-60000,0,0,0,0,60000,-60000,-60000
056495,泰鼎國泰99購01  ,0,0,0,0,0,0,0,0,0,-60000,0,0,0,0,60000,-60000,-60000
056347,GIS凱基9A購01   ,0,0,0,0,0,0,0,0,0,-60000,0,0,0,0,60000,-60000,-60000
056423,奇鋐統一98購01  ,0,0,0,0,0,0,0,0,0,-60000,0,0,0,0,60000,-60000,-60000
056416,華新科中信98購01,0,0,0,0,0,0,0,0,0,-60000,0,0,0,0,60000,-60000,-60000
055788,緯穎凱基97購04  ,0,0,0,0,0,0,0,0,0,-60000,0,0,0,1000,61000,-60000,-60000
055234,昇陽半國票98購02,0,0,0,0,0,0,0,0,0,-60000,0,0,0,0,60000,-60000,-60000
055078,亞泥中信98購01  ,0,0,0,0,0,0,0,0,0,-60000,0,0,0,0,60000,-60000,-60000
055070,聯茂永豐97購01  ,0,0,0,0,0,0,0,0,0,-60000,0,0,0,0,60000,-60000,-60000
054843,中環兆豐97購01  ,0,0,0,0,0,0,0,0,0,-60000,0,0,0,1000,61000,-60000,-60000
057320,玉晶光凱基98購01,0,0,0,0,0,0,0,0,0,-60000,0,0,0,0,60000,-60000,-60000
057118,欣興日盛9A購01  ,0,0,0,0,0,0,0,0,0,-60000,0,0,0,0,60000,-60000,-60000
056163,嘉聯益凱基98購03,0,0,0,0,0,0,0,0,0,-60000,0,0,0,0,60000,-60000,-60000
052483,超眾群益95購03  ,0,0,0,0,0,0,0,0,0,-60000,0,0,0,0,60000,-60000,-60000
052440,上証2X元大95購02,0,0,0,0,0,0,0,0,0,-60000,0,0,0,0,60000,-60000,-60000
054673,京鼎國泰98購01  ,0,0,0,0,0,0,0,0,0,-60000,0,0,0,0,60000,-60000,-60000
053890,華新科群益98購01,0,0,0,0,0,0,0,0,0,-60000,0,0,0,0,60000,-60000,-60000
054477,聯發科中信9C購02,0,0,0,0,0,0,0,0,0,-60000,0,0,0,0,60000,-60000,-60000
055357,欣興凱基97購04  ,0,0,0,0,0,0,0,0,0,-60000,0,0,0,0,60000,-60000,-60000
05409P,京元電元富95售05,0,0,0,0,0,0,0,0,0,-60000,0,0,0,26000,86000,-60000,-60000
06930P,台積電元大98售19,0,0,0,0,0,0,0,0,0,-61000,0,0,0,226000,287000,-61000,-61000
1702,南僑            ,95000,157000,-62000,0,0,0,0,0,0,1000,2000,1000,1000,0,0,0,-61000
058015,旺宏凱基99購02  ,0,0,0,0,0,0,0,0,0,-61000,0,0,0,5000,66000,-61000,-61000
058180,華新科國泰9A購01,0,0,0,0,0,0,0,0,0,-61000,0,0,0,0,61000,-61000,-61000
058242,玉晶光元大9A購01,0,0,0,0,0,0,0,0,0,-61000,0,0,0,0,61000,-61000,-61000
046855,嘉晶元大94購01  ,0,0,0,0,0,0,0,0,0,-61000,0,0,0,10000,71000,-61000,-61000
04543P,鴻海富邦95售03  ,0,0,0,0,0,0,0,0,0,-61000,0,0,0,50000,111000,-61000,-61000
054906,神達康和97購01  ,0,0,0,0,0,0,0,0,0,-61000,0,0,0,50000,111000,-61000,-61000
053487,台泥兆豐97購01  ,0,0,0,0,0,0,0,0,0,-61000,0,0,0,0,61000,-61000,-61000
056960,光罩永豐98購01  ,0,0,0,0,0,0,0,0,0,-61000,0,0,0,10000,71000,-61000,-61000
056553,啟碁凱基98購02  ,0,0,0,0,0,0,0,0,0,-61000,0,0,0,90000,151000,-61000,-61000
058160,奇鋐元富99購01  ,0,0,0,0,0,0,0,0,0,-62000,0,0,0,20000,82000,-62000,-62000
1611,中電            ,29000,91000,-62000,0,0,0,0,0,0,0,0,0,0,0,0,0,-62000
048070,聯發科元富99購03,0,0,0,0,0,0,0,0,0,-62000,0,0,0,20000,82000,-62000,-62000
051568,智邦富邦95購01  ,0,0,0,0,0,0,0,0,0,-62000,0,0,0,0,62000,-62000,-62000
055344,國巨凱基97購04  ,0,0,0,0,0,0,0,0,0,-62000,0,0,0,0,62000,-62000,-62000
057078,國巨統一9A購02  ,0,0,0,0,0,0,0,0,0,-62000,0,0,0,0,62000,-62000,-62000
053979,健策元大98購01  ,0,0,0,0,0,0,0,0,0,-62000,0,0,0,23000,85000,-62000,-62000
06044P,同欣電永豐96售03,0,0,0,0,0,0,0,0,0,-63000,0,0,0,7000,70000,-63000,-63000
058016,智邦凱基98購06  ,0,0,0,0,0,0,0,0,0,-63000,0,0,0,1000,64000,-63000,-63000
049814,超眾元大95購04  ,0,0,0,0,0,0,0,0,0,-63000,0,0,0,0,63000,-63000,-63000
054395,華新科永豐96購03,0,0,0,0,0,0,0,0,0,-63000,0,0,0,0,63000,-63000,-63000
058184,鴻海永豐99購01  ,0,0,0,0,0,0,0,0,0,-64000,0,0,0,2000,66000,-64000,-64000
057503,世紀鋼群益98購02,0,0,0,0,0,0,0,0,0,-64000,0,0,0,0,64000,-64000,-64000
1723,中碳            ,80000,211000,-131000,0,0,0,66000,0,66000,1000,1000,0,1000,0,0,0,-64000
07171P,臺股指國票99售08,0,0,0,0,0,0,0,0,0,-64000,0,0,0,199000,263000,-64000,-64000
07061P,台積電元大99售14,0,0,0,0,0,0,0,0,0,-64000,0,0,0,120000,184000,-64000,-64000
03430B,臺股指元大9B熊01,0,0,0,0,0,0,0,0,0,-64000,0,0,0,117000,181000,-64000,-64000
052963,智邦凱基96購02  ,0,0,0,0,0,0,0,0,0,-64000,0,0,0,0,64000,-64000,-64000
056453,禾伸堂凱基99購02,0,0,0,0,0,0,0,0,0,-64000,0,0,0,0,64000,-64000,-64000
05359P,嘉澤元大95售02  ,0,0,0,0,0,0,0,0,0,-64000,0,0,0,5000,69000,-64000,-64000
059177,臺股指凱基99購28,0,0,0,0,0,0,0,0,0,-65000,0,0,0,0,65000,-65000,-65000
06653P,美食元大98售02  ,0,0,0,0,0,0,0,0,0,-65000,0,0,0,455000,520000,-65000,-65000
057994,技嘉中信98購01  ,0,0,0,0,0,0,0,0,0,-65000,0,0,0,0,65000,-65000,-65000
058761,欣興群益99購02  ,0,0,0,0,0,0,0,0,0,-65000,0,0,0,0,65000,-65000,-65000
050101,台積電永昌96購03,0,0,0,0,0,0,0,0,0,-65000,0,0,0,0,65000,-65000,-65000
051067,台積電國票96購03,0,0,0,0,0,0,0,0,0,-65000,0,0,0,10000,75000,-65000,-65000
057253,高股息中信99購02,0,0,0,0,0,0,0,0,0,-65000,0,0,0,0,65000,-65000,-65000
055209,勤誠康和97購01  ,0,0,0,0,0,0,0,0,0,-65000,0,0,0,85000,150000,-65000,-65000
056306,晶相光元大98購01,0,0,0,0,0,0,0,0,0,-65000,0,0,0,0,65000,-65000,-65000
052980,上銀元大96購03  ,0,0,0,0,0,0,0,0,0,-65000,0,0,0,0,65000,-65000,-65000
056835,聯電元富99購01  ,0,0,0,0,0,0,0,0,0,-65000,0,0,0,320000,385000,-65000,-65000
052660,京元電國票97購01,0,0,0,0,0,0,0,0,0,-65000,0,0,0,0,65000,-65000,-65000
054357,可成兆豐97購02  ,0,0,0,0,0,0,0,0,0,-65000,0,0,0,11000,76000,-65000,-65000
2459,敦吉            ,29000,94000,-65000,0,0,0,0,0,0,0,0,0,0,0,0,0,-65000
9927,泰銘            ,23000,89000,-66000,0,0,0,0,0,0,1000,1000,0,1000,0,0,0,-65000
06847P,奇力新元大98售05,0,0,0,0,0,0,0,0,0,-66000,0,0,0,50000,116000,-66000,-66000
1589,永冠-KY         ,180000,249000,-69000,0,0,0,0,0,0,3000,3000,0,3000,0,0,0,-66000
052216,康友元大96購01  ,0,0,0,0,0,0,0,0,0,-66000,0,0,0,30000,96000,-66000,-66000
00685L,群益臺灣加權正2 ,0,0,0,0,0,0,0,0,0,-66000,0,0,0,88000,154000,-66000,-66000
054370,台積電中信9A購01,0,0,0,0,0,0,0,0,0,-66000,0,0,0,0,66000,-66000,-66000
054316,矽創凱基97購01  ,0,0,0,0,0,0,0,0,0,-66000,0,0,0,0,66000,-66000,-66000
053378,台積電元大98購02,0,0,0,0,0,0,0,0,0,-66000,0,0,0,0,66000,-66000,-66000
5269,祥碩            ,420000,416000,4000,0,0,0,4000,88000,-84000,14000,16000,22000,-6000,32000,12000,20000,-66000
06684P,緯穎元大98售06  ,0,0,0,0,0,0,0,0,0,-67000,0,0,0,65000,132000,-67000,-67000
06295P,國巨元大97售14  ,0,0,0,0,0,0,0,0,0,-67000,0,0,0,437000,504000,-67000,-67000
06426P,T50正2元大9B售01,0,0,0,0,0,0,0,0,0,-67000,0,0,0,80000,147000,-67000,-67000
059015,華通元富99購02  ,0,0,0,0,0,0,0,0,0,-67000,0,0,0,0,67000,-67000,-67000
058673,華新科群益9A購02,0,0,0,0,0,0,0,0,0,-67000,0,0,0,0,67000,-67000,-67000
057538,緯穎元大98購07  ,0,0,0,0,0,0,0,0,0,-67000,0,0,0,0,67000,-67000,-67000
051904,深100元大95購01 ,0,0,0,0,0,0,0,0,0,-67000,0,0,0,10000,77000,-67000,-67000
055912,宏達電凱基98購03,0,0,0,0,0,0,0,0,0,-67000,0,0,0,0,67000,-67000,-67000
059166,友達凱基99購05  ,0,0,0,0,0,0,0,0,0,-68000,0,0,0,0,68000,-68000,-68000
051400,國巨永豐95購01  ,0,0,0,0,0,0,0,0,0,-68000,0,0,0,0,68000,-68000,-68000
05012P,台積電元大95售07,0,0,0,0,0,0,0,0,0,-68000,0,0,0,95000,163000,-68000,-68000
048282,世紀鋼永豐94購01,0,0,0,0,0,0,0,0,0,-68000,0,0,0,0,68000,-68000,-68000
055780,禾伸堂凱基99購01,0,0,0,0,0,0,0,0,0,-68000,0,0,0,0,68000,-68000,-68000
056080,世紀鋼元大97購03,0,0,0,0,0,0,0,0,0,-68000,0,0,0,11000,79000,-68000,-68000
057029,緯穎凱基98購04  ,0,0,0,0,0,0,0,0,0,-68000,0,0,0,1000,69000,-68000,-68000
2908,特力            ,36000,104000,-68000,0,0,0,0,0,0,0,0,0,0,0,0,0,-68000
057043,台積電元大99購02,0,0,0,0,0,0,0,0,0,-69000,0,0,0,7000,76000,-69000,-69000
053942,超眾國泰96購02  ,0,0,0,0,0,0,0,0,0,-69000,0,0,0,0,69000,-69000,-69000
056452,亞光凱基98購02  ,0,0,0,0,0,0,0,0,0,-69000,0,0,0,0,69000,-69000,-69000
059169,可成凱基99購04  ,0,0,0,0,0,0,0,0,0,-70000,0,0,0,0,70000,-70000,-70000
1473,台南            ,39000,109000,-70000,0,0,0,0,0,0,0,0,0,0,0,0,0,-70000
057491,美食元大98購03  ,0,0,0,0,0,0,0,0,0,-70000,0,0,0,10000,80000,-70000,-70000
057688,國巨凱基99購07  ,0,0,0,0,0,0,0,0,0,-70000,0,0,0,0,70000,-70000,-70000
057874,可成元大99購02  ,0,0,0,0,0,0,0,0,0,-70000,0,0,0,0,70000,-70000,-70000
058232,聯發科元大99購05,0,0,0,0,0,0,0,0,0,-70000,0,0,0,40000,110000,-70000,-70000
058515,健鼎元大99購01  ,0,0,0,0,0,0,0,0,0,-70000,0,0,0,0,70000,-70000,-70000
058416,鴻海麥證99購01  ,0,0,0,0,70000,-70000,0,0,0,-70000,0,0,0,0,70000,-70000,-70000
058374,玉晶光凱基9A購03,0,0,0,0,0,0,0,0,0,-70000,0,0,0,0,70000,-70000,-70000
03418B,臺股指元大95熊20,0,0,0,0,0,0,0,0,0,-70000,0,0,0,406000,476000,-70000,-70000
051826,智邦元大95購03  ,0,0,0,0,0,0,0,0,0,-70000,0,0,0,29000,99000,-70000,-70000
049436,義隆國泰96購02  ,0,0,0,0,0,0,0,0,0,-70000,0,0,0,0,70000,-70000,-70000
049600,緯穎元大95購02  ,0,0,0,0,0,0,0,0,0,-70000,0,0,0,4000,74000,-70000,-70000
051748,超眾國泰96購01  ,0,0,0,0,0,0,0,0,0,-70000,0,0,0,510000,580000,-70000,-70000
052329,台積電亞東96購01,0,0,0,0,0,0,0,0,0,-70000,0,0,0,1590000,1660000,-70000,-70000
050896,華新科元大96購02,0,0,0,0,0,0,0,0,0,-70000,0,0,0,75000,145000,-70000,-70000
055849,聯詠元大97購05  ,0,0,0,0,0,0,0,0,0,-70000,0,0,0,0,70000,-70000,-70000
055838,致茂元大97購03  ,0,0,0,0,0,0,0,0,0,-70000,0,0,0,20000,90000,-70000,-70000
056094,大立光元富97購03,0,0,0,0,0,0,0,0,0,-70000,0,0,0,0,70000,-70000,-70000
053175,矽力群益96購01  ,0,0,0,0,0,0,0,0,0,-70000,0,0,0,0,70000,-70000,-70000
055754,和大兆豐97購01  ,0,0,0,0,0,0,0,0,0,-70000,0,0,0,0,70000,-70000,-70000
054213,欣興國票97購04  ,0,0,0,0,0,0,0,0,0,-70000,0,0,0,100000,170000,-70000,-70000
053051,楠梓電國票97購01,0,0,0,0,0,0,0,0,0,-70000,0,0,0,10000,80000,-70000,-70000
052916,華新科富邦96購01,0,0,0,0,0,0,0,0,0,-70000,0,0,0,0,70000,-70000,-70000
056834,華新元富99購01  ,0,0,0,0,0,0,0,0,0,-70000,0,0,0,0,70000,-70000,-70000
056735,國巨凱基99購02  ,0,0,0,0,0,0,0,0,0,-70000,0,0,0,118000,188000,-70000,-70000
053859,台積電元大97購09,0,0,0,0,0,0,0,0,0,-70000,0,0,0,0,70000,-70000,-70000
054094,創意群益96購02  ,0,0,0,0,0,0,0,0,0,-70000,0,0,0,0,70000,-70000,-70000
052437,聯發科富邦99購02,0,0,0,0,0,0,0,0,0,-70000,0,0,0,999000,1069000,-70000,-70000
054574,美律元大99購01  ,0,0,0,0,0,0,0,0,0,-70000,0,0,0,0,70000,-70000,-70000
054720,禾伸堂永豐97購01,0,0,0,0,0,0,0,0,0,-70000,0,0,0,0,70000,-70000,-70000
055216,友達凱基98購05  ,0,0,0,0,0,0,0,0,0,-70000,0,0,0,134000,204000,-70000,-70000
057273,智邦元大98購05  ,0,0,0,0,0,0,0,0,0,-70000,0,0,0,0,70000,-70000,-70000
5515,建國            ,22000,92000,-70000,0,0,0,0,0,0,0,0,0,0,0,0,0,-70000
058973,麗豐永豐99購01  ,0,0,0,0,0,0,0,0,0,-71000,0,0,0,20000,91000,-71000,-71000
057825,和碩元大98購02  ,0,0,0,0,0,0,0,0,0,-71000,0,0,0,0,71000,-71000,-71000
059205,元石油元大99購01,0,0,0,0,0,0,0,0,0,-71000,0,0,0,0,71000,-71000,-71000
059097,世紀鋼元大99購05,1000,0,1000,0,0,0,0,0,0,-72000,0,0,0,6000,78000,-72000,-71000
055623,貿聯國泰99購01  ,0,0,0,0,0,0,0,0,0,-71000,0,0,0,0,71000,-71000,-71000
049585,旺宏元大95購02  ,0,0,0,0,0,0,0,0,0,-71000,0,0,0,0,71000,-71000,-71000
047603,瑞昱國泰94購01  ,0,0,0,0,0,0,0,0,0,-71000,0,0,0,75000,146000,-71000,-71000
00753L,中信中國50正2   ,0,0,0,0,0,0,0,0,0,-71000,0,0,0,309000,380000,-71000,-71000
053662,矽力凱基97購01  ,0,0,0,0,0,0,0,0,0,-71000,0,0,0,11000,82000,-71000,-71000
056571,燿華元大98購02  ,0,0,0,0,0,0,0,0,0,-71000,0,0,0,110000,181000,-71000,-71000
06058P,玉晶光凱基97售04,0,0,0,0,0,0,0,0,0,-72000,0,0,0,18000,90000,-72000,-72000
06618P,智邦元大98售04  ,0,0,0,0,0,0,0,0,0,-72000,0,0,0,21000,93000,-72000,-72000
057828,緯穎元大99購02  ,0,0,0,0,0,0,0,0,0,-72000,0,0,0,50000,122000,-72000,-72000
058205,神達凱基9B購01  ,0,0,0,0,0,0,0,0,0,-72000,0,0,0,0,72000,-72000,-72000
058569,健策凱基9A購01  ,0,0,0,0,0,0,0,0,0,-72000,0,0,0,6000,78000,-72000,-72000
049255,旺宏元大97購02  ,0,0,0,0,0,0,0,0,0,-72000,0,0,0,10000,82000,-72000,-72000
055565,祥碩凱基97購01  ,0,0,0,0,0,0,0,0,0,-72000,0,0,0,0,72000,-72000,-72000
056470,旺宏元大99購01  ,0,0,0,0,0,0,0,0,0,-72000,0,0,0,153000,225000,-72000,-72000
052880,台積電凱基96購06,0,0,0,0,0,0,0,0,0,-72000,0,0,0,146000,218000,-72000,-72000
055025,華新科國泰98購02,0,0,0,0,0,0,0,0,0,-72000,0,0,0,0,72000,-72000,-72000
059004,嘉晶元大99購05  ,0,0,0,0,0,0,0,0,0,-73000,0,0,0,80000,153000,-73000,-73000
06479P,聯發科中信99售02,0,0,0,0,0,0,0,0,0,-73000,0,0,0,27000,100000,-73000,-73000
050545,奇力新凱基95購01,0,0,0,0,0,0,0,0,0,-73000,0,0,0,22000,95000,-73000,-73000
045678,華新科元大95購01,0,0,0,0,0,0,0,0,0,-73000,0,0,0,12000,85000,-73000,-73000
052802,華新科元大97購02,0,0,0,0,0,0,0,0,0,-73000,0,0,0,10000,83000,-73000,-73000
053195,玉晶光元富96購02,0,0,0,0,0,0,0,0,0,-73000,0,0,0,0,73000,-73000,-73000
056438,旺宏凱基98購05  ,0,0,0,0,0,0,0,0,0,-73000,0,0,0,0,73000,-73000,-73000
4104,佳醫            ,50000,124000,-74000,0,0,0,0,0,0,1000,1000,0,1000,0,0,0,-73000
058715,鴻海台新99購02  ,0,0,0,0,0,0,0,0,0,-74000,0,0,0,1811000,1885000,-74000,-74000
058259,訊連國泰9B購01  ,0,0,0,0,0,0,0,0,0,-74000,0,0,0,262000,336000,-74000,-74000
058063,旺宏中信98購04  ,0,0,0,0,0,0,0,0,0,-74000,0,0,0,20000,94000,-74000,-74000
00728,第一金工業30    ,0,0,0,0,0,0,0,0,0,-74000,0,0,0,658000,732000,-74000,-74000
056041,禾伸堂凱基98購03,0,0,0,0,0,0,0,0,0,-74000,0,0,0,0,74000,-74000,-74000
052316,台積電元大96購10,0,0,0,0,0,0,0,0,0,-74000,0,0,0,0,74000,-74000,-74000
050836,緯穎凱基95購01  ,0,0,0,0,0,0,0,0,0,-74000,0,0,0,20000,94000,-74000,-74000
056231,嘉聯益凱基97購02,0,0,0,0,0,0,0,0,0,-74000,0,0,0,0,74000,-74000,-74000
056355,台積電元大98購08,0,0,0,0,0,0,0,0,0,-74000,0,0,0,440000,514000,-74000,-74000
056967,奇鋐永豐98購01  ,0,0,0,0,0,0,0,0,0,-74000,0,0,0,97000,171000,-74000,-74000
054710,東元元富97購01  ,0,0,0,0,0,0,0,0,0,-74000,0,0,0,178000,252000,-74000,-74000
2207,和泰車          ,841000,1002141,-161141,0,0,0,86000,0,86000,1000,1000,0,1000,0,0,0,-74141
058911,茂林元大99購04  ,0,0,0,0,0,0,0,0,0,-75000,0,0,0,60000,135000,-75000,-75000
06239P,奇力新元大97售08,0,0,0,0,0,0,0,0,0,-75000,0,0,0,5000,80000,-75000,-75000
055431,和鑫群益98購01  ,0,0,0,0,0,0,0,0,0,-75000,0,0,0,25000,100000,-75000,-75000
00645,富邦日本        ,0,0,0,0,0,0,0,0,0,-75000,0,0,0,16000,91000,-75000,-75000
054975,福懋科元大97購01,0,0,0,0,0,0,0,0,0,-75000,0,0,0,75000,150000,-75000,-75000
057306,玉晶光兆豐99購01,0,0,0,0,0,0,0,0,0,-75000,0,0,0,25000,100000,-75000,-75000
056859,台積電群益98購02,0,0,0,0,0,0,0,0,0,-75000,0,0,0,0,75000,-75000,-75000
056261,台積電統一97購07,0,0,0,0,0,0,0,0,0,-75000,0,0,0,0,75000,-75000,-75000
056428,台達電凱基99購01,0,0,0,0,0,0,0,0,0,-75000,0,0,0,55000,130000,-75000,-75000
058739,喬山中信99購01  ,0,0,0,0,0,0,0,0,0,-76000,0,0,0,0,76000,-76000,-76000
057490,可成元大98購10  ,0,0,0,0,0,0,0,0,0,-76000,0,0,0,10000,86000,-76000,-76000
056233,超眾凱基97購02  ,0,0,0,0,0,0,0,0,0,-76000,0,0,0,0,76000,-76000,-76000
8213,志超            ,364000,416000,-52000,0,0,0,0,0,0,-24000,6000,30000,-24000,0,0,0,-76000
6670,復盛應用        ,381000,460000,-79000,0,0,0,16000,0,16000,-13000,3000,16000,-13000,0,0,0,-76000
058363,全新凱基9A購02  ,0,0,0,0,0,0,0,0,0,-77000,0,0,0,8000,85000,-77000,-77000
1558,伸興            ,25000,101000,-76000,0,0,0,0,0,0,-1000,1000,2000,-1000,0,0,0,-77000
03064X,元展59          ,0,0,0,0,0,0,0,0,0,-77000,0,0,0,26000,103000,-77000,-77000
04346P,大立光兆豐95售02,0,0,0,0,0,0,0,0,0,-77000,0,0,0,3000,80000,-77000,-77000
055749,智邦永昌9C購01  ,0,0,0,0,0,0,0,0,0,-77000,0,0,0,0,77000,-77000,-77000
053193,超眾統一97購01  ,0,0,0,0,0,0,0,0,0,-77000,0,0,0,0,77000,-77000,-77000
05401P,聯茂永豐95售03  ,0,0,0,0,0,0,0,0,0,-77000,0,0,0,26000,103000,-77000,-77000
07044P,台積電元大99售13,0,0,0,0,0,0,0,0,0,-78000,0,0,0,160000,238000,-78000,-78000
059229,臺股指元大99購22,0,0,0,0,0,0,0,0,0,-78000,0,0,0,0,78000,-78000,-78000
06006P,欣興永豐96售04  ,0,0,0,0,0,0,0,0,0,-78000,0,0,0,72000,150000,-78000,-78000
058863,可成凱基99購02  ,0,0,0,0,0,0,0,0,0,-78000,0,0,0,0,78000,-78000,-78000
050261,國巨元大95購04  ,0,0,0,0,0,0,0,0,0,-78000,0,0,0,0,78000,-78000,-78000
050213,華新科台新94購03,0,0,0,0,0,0,0,0,0,-78000,0,0,0,48000,126000,-78000,-78000
055968,祥碩元大97購04  ,0,0,0,0,0,0,0,0,0,-78000,0,0,0,32000,110000,-78000,-78000
051619,智邦凱基95購07  ,0,0,0,0,0,0,0,0,0,-78000,0,0,0,20000,98000,-78000,-78000
052498,台積電永豐95購06,0,0,0,0,0,0,0,0,0,-78000,0,0,0,0,78000,-78000,-78000
05281P,南亞科元大95售03,0,0,0,0,0,0,0,0,0,-78000,0,0,0,28000,106000,-78000,-78000
056605,台積電富邦9B購02,0,0,0,0,0,0,0,0,0,-78000,0,0,0,0,78000,-78000,-78000
2642,宅配通          ,56000,134000,-78000,0,0,0,0,0,0,0,0,0,0,0,0,0,-78000
05095P,景碩元大95售01  ,0,0,0,0,0,0,0,0,0,-79000,0,0,0,103000,182000,-79000,-79000
053332,創意永豐96購03  ,0,0,0,0,0,0,0,0,0,-79000,0,0,0,27000,106000,-79000,-79000
054965,健策元大98購04  ,0,0,0,0,0,0,0,0,0,-79000,0,0,0,0,79000,-79000,-79000
5607,遠雄港          ,323000,372000,-49000,0,0,0,0,0,0,-30000,0,30000,-30000,0,0,0,-79000
9921,巨大            ,1683000,1768210,-85210,0,0,0,5000,0,5000,1000,1000,0,1000,0,0,0,-79210
059049,元油2X凱基9A購12,0,0,0,0,0,0,0,0,0,-80000,0,0,0,0,80000,-80000,-80000
058413,義隆兆豐99購01  ,0,0,0,0,0,0,0,0,0,-80000,0,0,0,80000,160000,-80000,-80000
058703,台積電元大99購16,0,0,0,0,0,0,0,0,0,-80000,0,0,0,2000,82000,-80000,-80000
057475,聯電元大9A購01  ,0,0,0,0,0,0,0,0,0,-80000,0,0,0,60000,140000,-80000,-80000
058203,信邦凱基99購01  ,0,0,0,0,0,0,0,0,0,-80000,0,0,0,0,80000,-80000,-80000
059130,台灣50群益9B購05,0,0,0,0,0,0,0,0,0,-80000,0,0,0,0,80000,-80000,-80000
1531,高林股          ,14000,94000,-80000,0,0,0,0,0,0,0,0,0,0,0,0,0,-80000
08703P,華碩凱基01售02  ,0,0,0,0,0,0,0,0,0,-80000,0,0,0,81000,161000,-80000,-80000
055435,佳世達中信99購01,0,0,0,0,0,0,0,0,0,-80000,0,0,0,20000,100000,-80000,-80000
052125,群創國票95購02  ,0,0,0,0,0,0,0,0,0,-80000,0,0,0,0,80000,-80000,-80000
052146,泰碩群益95購01  ,0,0,0,0,0,0,0,0,0,-80000,0,0,0,10000,90000,-80000,-80000
049497,茂林元大94購04  ,0,0,0,0,0,0,0,0,0,-80000,0,0,0,0,80000,-80000,-80000
04894P,世紀鋼元大94售02,0,0,0,0,0,0,0,0,0,-80000,0,0,0,60000,140000,-80000,-80000
051055,友達群益98購01  ,0,0,0,0,0,0,0,0,0,-80000,0,0,0,10000,90000,-80000,-80000
051094,健策元大96購03  ,0,0,0,0,0,0,0,0,0,-80000,0,0,0,19000,99000,-80000,-80000
051121,裕民群益97購01  ,0,0,0,0,0,0,0,0,0,-80000,0,0,0,20000,100000,-80000,-80000
046680,上証反群益95購01,0,0,0,0,0,0,0,0,0,-80000,0,0,0,20000,100000,-80000,-80000
050515,聯電元大96購01  ,0,0,0,0,0,0,0,0,0,-80000,0,0,0,10000,90000,-80000,-80000
05182P,嘉晶統一95售03  ,0,0,0,0,0,0,0,0,0,-80000,0,0,0,0,80000,-80000,-80000
046999,康控富邦99購01  ,0,0,0,0,0,0,0,0,0,-80000,0,0,0,20000,100000,-80000,-80000
04116P,京元電元大94售02,0,0,0,0,0,0,0,0,0,-80000,0,0,0,25000,105000,-80000,-80000
040381,元金2X元富95購01,0,0,0,0,0,0,0,0,0,-80000,0,0,0,0,80000,-80000,-80000
048373,A50正2元富95購01,0,0,0,0,0,0,0,0,0,-80000,0,0,0,0,80000,-80000,-80000
044717,旺宏統一94購01  ,0,0,0,0,0,0,0,0,0,-80000,0,0,0,0,80000,-80000,-80000
054976,上証2X元富9A購01,0,0,0,0,0,0,0,0,0,-80000,0,0,0,0,80000,-80000,-80000
053496,義隆兆豐96購02  ,0,0,0,0,0,0,0,0,0,-80000,0,0,0,62000,142000,-80000,-80000
056912,臺股指元大99購04,0,0,0,0,0,0,0,0,0,-80000,0,0,0,0,80000,-80000,-80000
054847,創意兆豐97購01  ,0,0,0,0,0,0,0,0,0,-80000,0,0,0,0,80000,-80000,-80000
055205,京鼎中信99購01  ,0,0,0,0,0,0,0,0,0,-80000,0,0,0,0,80000,-80000,-80000
057328,京鼎群益99購02  ,0,0,0,0,0,0,0,0,0,-80000,0,0,0,0,80000,-80000,-80000
054412,智邦元大96購03  ,0,0,0,0,0,0,0,0,0,-80000,0,0,0,90000,170000,-80000,-80000
056788,日月光群益98購01,0,0,0,0,0,0,0,0,0,-80000,0,0,0,400000,480000,-80000,-80000
056393,精元永豐98購01  ,0,0,0,0,0,0,0,0,0,-80000,0,0,0,0,80000,-80000,-80000
4414,如興            ,725000,805000,-80000,0,0,0,0,0,0,0,0,0,0,0,0,0,-80000
056524,欣興中信98購02  ,0,0,0,0,0,0,0,0,0,-81000,0,0,0,50000,131000,-81000,-81000
05713P,大立光統一96售05,0,0,0,0,0,0,0,0,0,-81000,0,0,0,0,81000,-81000,-81000
2348,海悅            ,70000,142000,-72000,0,0,0,0,0,0,-9000,1000,10000,-9000,0,0,0,-81000
06661P,玉晶光永豐98售05,0,0,0,0,0,0,0,0,0,-82000,0,0,0,0,82000,-82000,-82000
057733,嘉聯益國泰99購01,0,0,0,0,0,0,0,0,0,-82000,0,0,0,0,82000,-82000,-82000
057727,華邦電國泰9A購01,0,0,0,0,0,0,0,0,0,-82000,0,0,0,80000,162000,-82000,-82000
048460,盛群凱基94購01  ,0,0,0,0,0,0,0,0,0,-82000,0,0,0,44000,126000,-82000,-82000
052279,旺宏凱基95購07  ,0,0,0,0,0,0,0,0,0,-82000,0,0,0,0,82000,-82000,-82000
053639,禾伸堂永豐96購01,0,0,0,0,0,0,0,0,0,-82000,0,0,0,82000,164000,-82000,-82000
056434,國巨凱基98購03  ,0,0,0,0,0,0,0,0,0,-82000,0,0,0,0,82000,-82000,-82000
056448,全新凱基99購01  ,0,0,0,0,0,0,0,0,0,-82000,0,0,0,0,82000,-82000,-82000
056694,欣興群益98購04  ,0,0,0,0,0,0,0,0,0,-82000,0,0,0,90000,172000,-82000,-82000
058521,日月光元大99購01,0,0,0,0,0,0,0,0,0,-83000,0,0,0,12000,95000,-83000,-83000
058384,大成鋼中信99購01,0,0,0,0,0,0,0,0,0,-83000,0,0,0,65000,148000,-83000,-83000
048976,華擎元大94購01  ,0,0,0,0,0,0,0,0,0,-83000,0,0,0,0,83000,-83000,-83000
056044,同欣電凱基97購03,0,0,0,0,0,0,0,0,0,-83000,0,0,0,1000,84000,-83000,-83000
055877,奇鋐元富97購01  ,0,0,0,0,0,0,0,0,0,-83000,0,0,0,20000,103000,-83000,-83000
052056,緯穎凱基95購04  ,0,0,0,0,0,0,0,0,0,-83000,0,0,0,1000,84000,-83000,-83000
047196,上銀統一97購01  ,0,0,0,0,0,0,0,0,0,-83000,0,0,0,0,83000,-83000,-83000
051872,矽力凱基96購01  ,0,0,0,0,0,0,0,0,0,-83000,0,0,0,0,83000,-83000,-83000
056540,聯詠凱基98購02  ,0,0,0,0,0,0,0,0,0,-83000,0,0,0,12000,95000,-83000,-83000
056228,可成凱基97購03  ,0,0,0,0,0,0,0,0,0,-83000,0,0,0,0,83000,-83000,-83000
055416,欣興富邦98購01  ,0,0,0,0,0,0,0,0,0,-83000,0,0,0,0,83000,-83000,-83000
055029,帆宣國泰99購01  ,0,0,0,0,0,0,0,0,0,-83000,0,0,0,87000,170000,-83000,-83000
2107,厚生            ,89000,174000,-85000,0,0,0,0,0,0,2000,2000,0,2000,0,0,0,-83000
2442,新美齊          ,681000,772000,-91000,0,0,0,2000,0,2000,6000,6000,0,6000,0,0,0,-83000
8926,台汽電          ,813000,828000,-15000,0,0,0,5000,0,5000,-73000,0,73000,-73000,0,0,0,-83000
07148P,富邦金元大99售01,0,0,0,0,0,0,0,0,0,-84000,0,0,0,27000,111000,-84000,-84000
03668C,臺股指元大03牛02,0,0,0,0,0,0,0,0,0,-84000,0,0,0,24000,108000,-84000,-84000
049349,國巨康和94購01  ,0,0,0,0,0,0,0,0,0,-84000,0,0,0,0,84000,-84000,-84000
05535P,台積電元大97售06,0,0,0,0,0,0,0,0,0,-84000,0,0,0,109000,193000,-84000,-84000
056079,世紀鋼元大97購02,0,0,0,0,0,0,0,0,0,-84000,0,0,0,273000,357000,-84000,-84000
8422,可寧衛          ,55000,136000,-81000,0,0,0,0,0,0,-3000,0,0,0,0,3000,-3000,-84000
06687P,A50正2中信9A售01,0,0,0,0,0,0,0,0,0,-85000,0,0,0,10000,95000,-85000,-85000
058981,國巨凱基99購10  ,0,0,0,0,0,0,0,0,0,-85000,0,0,0,0,85000,-85000,-85000
057643,聯發科元大99購03,0,0,0,0,0,0,0,0,0,-85000,0,0,0,232000,317000,-85000,-85000
058201,華通凱基9A購01  ,0,0,0,0,0,0,0,0,0,-85000,0,0,0,0,85000,-85000,-85000
049553,鴻海國泰96購02  ,0,0,0,0,0,0,0,0,0,-85000,0,0,0,185000,270000,-85000,-85000
051776,上証2X群益99購01,0,0,0,0,0,0,0,0,0,-85000,0,0,0,77000,162000,-85000,-85000
048998,玉晶光國票95購03,0,0,0,0,0,0,0,0,0,-85000,0,0,0,125000,210000,-85000,-85000
03671C,元油2X元大03牛01,0,0,0,0,0,0,0,0,0,-85000,0,0,0,0,85000,-85000,-85000
047342,T50反1中信99購01,0,0,0,0,0,0,0,0,0,-85000,0,0,0,5000,90000,-85000,-85000
04769P,高股息元大94售01,0,0,0,0,0,0,0,0,0,-85000,0,0,0,620000,705000,-85000,-85000
054047,富邦金元大97購01,0,0,0,0,0,0,0,0,0,-85000,0,0,0,35000,120000,-85000,-85000
058683,可成凱基9A購01  ,0,0,0,0,0,0,0,0,0,-86000,0,0,0,2000,88000,-86000,-86000
00736,國泰新興市場    ,101000,0,101000,0,0,0,0,0,0,-187000,0,0,0,100000,287000,-187000,-86000
048847,A50群益98購01   ,0,0,0,0,0,0,0,0,0,-86000,0,0,0,1000,87000,-86000,-86000
058196,台塑中信99購01  ,0,0,0,0,0,0,0,0,0,-87000,0,0,0,0,87000,-87000,-87000
056222,台積電凱基9A購01,0,0,0,0,0,0,0,0,0,-87000,0,0,0,0,87000,-87000,-87000
056623,禾伸堂永豐98購01,0,0,0,0,0,0,0,0,0,-87000,0,0,0,0,87000,-87000,-87000
2356,英業達          ,4379000,6640726,-2261726,0,0,0,42000,342000,-300000,2474000,143000,516000,-373000,2874000,27000,2847000,-87726
057799,世紀鋼兆豐98購01,0,0,0,0,0,0,0,0,0,-88000,0,0,0,135000,223000,-88000,-88000
057772,台積電群益99購01,0,0,0,0,0,0,0,0,0,-88000,0,0,0,0,88000,-88000,-88000
058909,神達元大99購03  ,0,0,0,0,0,0,0,0,0,-88000,0,0,0,3000,91000,-88000,-88000
06851P,鈺齊元大98售01  ,0,0,0,0,0,0,0,0,0,-88000,0,0,0,32000,120000,-88000,-88000
048243,儒鴻兆豐94購01  ,0,0,0,0,0,0,0,0,0,-88000,0,0,0,0,88000,-88000,-88000
050553,緯穎凱基94購06  ,0,0,0,0,0,0,0,0,0,-88000,0,0,0,4000,92000,-88000,-88000
05620P,大立光富邦9B售01,0,0,0,0,0,0,0,0,0,-88000,0,0,0,30000,118000,-88000,-88000
053142,緯穎永豐96購01  ,0,0,0,0,0,0,0,0,0,-88000,0,0,0,72000,160000,-88000,-88000
054876,群電群益97購02  ,0,0,0,0,0,0,0,0,0,-88000,0,0,0,62000,150000,-88000,-88000
057225,華新凱基98購01  ,0,0,0,0,0,0,0,0,0,-88000,0,0,0,0,88000,-88000,-88000
058409,鴻海兆豐99購05  ,0,0,0,0,0,0,0,0,0,-89000,0,0,0,73000,162000,-89000,-89000
049934,緯穎元大94購08  ,0,0,0,0,0,0,0,0,0,-89000,0,0,0,23000,112000,-89000,-89000
051406,泰鼎永豐96購01  ,0,0,0,0,0,0,0,0,0,-89000,0,0,0,55000,144000,-89000,-89000
051014,智邦凱基95購01  ,0,0,0,0,0,0,0,0,0,-89000,0,0,0,99000,188000,-89000,-89000
055490,台光電元大97購01,0,0,0,0,0,0,0,0,0,-89000,0,0,0,10000,99000,-89000,-89000
05403P,台積電富邦95售08,0,0,0,0,0,0,0,0,0,-89000,0,0,0,11000,100000,-89000,-89000
055337,超眾兆豐98購01  ,0,0,0,0,0,0,0,0,0,-89000,0,0,0,30000,119000,-89000,-89000
056535,全新凱基99購02  ,0,0,0,0,0,0,0,0,0,-89000,0,0,0,0,89000,-89000,-89000
058532,禾伸堂元富99購01,0,0,0,0,0,0,0,0,0,-90000,0,0,0,0,90000,-90000,-90000
057857,牧德國票99購01  ,0,0,0,0,0,0,0,0,0,-90000,0,0,0,0,90000,-90000,-90000
057599,技嘉群益9A購01  ,0,0,0,0,0,0,0,0,0,-90000,0,0,0,10000,100000,-90000,-90000
051317,亞德客國票96購01,0,0,0,0,0,0,0,0,0,-90000,0,0,0,0,90000,-90000,-90000
051491,貿聯凱基95購01  ,0,0,0,0,0,0,0,0,0,-90000,0,0,0,0,90000,-90000,-90000
049751,牧德永豐95購01  ,0,0,0,0,0,0,0,0,0,-90000,0,0,0,10000,100000,-90000,-90000
049738,神基群益94購01  ,0,0,0,0,0,0,0,0,0,-90000,0,0,0,0,90000,-90000,-90000
051985,智邦元大95購05  ,0,0,0,0,0,0,0,0,0,-90000,0,0,0,171000,261000,-90000,-90000
048895,光罩國泰95購01  ,0,0,0,0,0,0,0,0,0,-90000,0,0,0,0,90000,-90000,-90000
051131,玉山金台新95購01,0,0,0,0,0,0,0,0,0,-90000,0,0,0,0,90000,-90000,-90000
046145,矽力元富95購01  ,0,0,0,0,0,0,0,0,0,-90000,0,0,0,0,90000,-90000,-90000
04476P,玉晶光元大94售05,0,0,0,0,0,0,0,0,0,-90000,0,0,0,70000,160000,-90000,-90000
048346,智易元大95購01  ,0,0,0,0,0,0,0,0,0,-90000,0,0,0,0,90000,-90000,-90000
048334,A50正2元大96購01,0,0,0,0,0,0,0,0,0,-90000,0,0,0,0,90000,-90000,-90000
05533P,滬深2X富邦97售01,0,0,0,0,0,0,0,0,0,-90000,0,0,0,0,90000,-90000,-90000
055381,茂林元大97購02  ,0,0,0,0,0,0,0,0,0,-90000,0,0,0,10000,100000,-90000,-90000
052700,奇鋐國票97購02  ,0,0,0,0,0,0,0,0,0,-90000,0,0,0,0,90000,-90000,-90000
054417,牧德元大96購01  ,0,0,0,0,0,0,0,0,0,-90000,0,0,0,10000,100000,-90000,-90000
054096,佳世達國票97購01,0,0,0,0,0,0,0,0,0,-90000,0,0,0,10000,100000,-90000,-90000
053584,友達元大9B購02  ,0,0,0,0,0,0,0,0,0,-90000,0,0,0,120000,210000,-90000,-90000
053500,新日興兆豐97購01,0,0,0,0,0,0,0,0,0,-90000,0,0,0,0,90000,-90000,-90000
054619,昇陽半永豐97購03,0,0,0,0,0,0,0,0,0,-90000,0,0,0,0,90000,-90000,-90000
057176,全新元大99購02  ,0,0,0,0,0,0,0,0,0,-90000,0,0,0,0,90000,-90000,-90000
054836,勤誠中信97購01  ,0,0,0,0,0,0,0,0,0,-90000,0,0,0,0,90000,-90000,-90000
059032,元石油群益9C購03,0,0,0,0,0,0,0,0,0,-91000,0,0,0,0,91000,-91000,-91000
07040P,台灣50元大9C售02,0,0,0,0,0,0,0,0,0,-91000,0,0,0,83000,174000,-91000,-91000
056724,臻鼎中信9A購01  ,0,0,0,0,0,0,0,0,0,-91000,0,0,0,0,91000,-91000,-91000
6184,大豐電          ,8000,99000,-91000,0,0,0,0,0,0,0,0,0,0,0,0,0,-91000
6202,盛群            ,804000,875000,-71000,0,0,0,0,0,0,-20000,4000,24000,-20000,0,0,0,-91000
055668,欣興群益97購01  ,0,0,0,0,0,0,0,0,0,-92000,0,0,0,0,92000,-92000,-92000
6224,聚鼎            ,110000,206000,-96000,0,0,0,0,0,0,4000,5000,1000,4000,0,0,0,-92000
2547,日勝生          ,235402,328000,-92598,0,0,0,0,0,0,0,0,0,0,0,0,0,-92598
06802P,緯穎群益98售03  ,0,0,0,0,0,0,0,0,0,-93000,0,0,0,4000,97000,-93000,-93000
047768,大立光元大95購01,0,0,0,0,0,0,0,0,0,-93000,0,0,0,2000,95000,-93000,-93000
056461,樺漢凱基98購02  ,0,0,0,0,0,0,0,0,0,-93000,0,0,0,0,93000,-93000,-93000
06175P,台積電元大97售21,0,0,0,0,0,0,0,0,0,-94000,0,0,0,35000,129000,-94000,-94000
058940,聯發科中信9A購03,0,0,0,0,0,0,0,0,0,-94000,0,0,0,0,94000,-94000,-94000
058054,台積電統一9C購01,0,0,0,0,0,0,0,0,0,-94000,0,0,0,0,94000,-94000,-94000
049439,牧德國泰96購01  ,0,0,0,0,0,0,0,0,0,-94000,0,0,0,71000,165000,-94000,-94000
056399,上証2X群益9C購01,0,0,0,0,0,0,0,0,0,-94000,0,0,0,30000,124000,-94000,-94000
057136,立積凱基98購02  ,0,0,0,0,0,0,0,0,0,-94000,0,0,0,0,94000,-94000,-94000
05456P,鴻海凱基95售19  ,0,0,0,0,0,0,0,0,0,-94000,0,0,0,18000,112000,-94000,-94000
057703,矽力群益98購01  ,0,0,0,0,0,0,0,0,0,-95000,0,0,0,0,95000,-95000,-95000
057734,訊芯國泰9A購01  ,0,0,0,0,0,0,0,0,0,-95000,0,0,0,55000,150000,-95000,-95000
053090,新唐元大96購01  ,0,0,0,0,0,0,0,0,0,-95000,0,0,0,25000,120000,-95000,-95000
2204,中華            ,122000,218000,-96000,0,0,0,1000,0,1000,0,0,0,0,0,0,0,-95000
059009,世紀鋼元大99購04,0,0,0,0,0,0,0,0,0,-96000,0,0,0,140000,236000,-96000,-96000
07128P,大毅元大99售04  ,0,0,0,0,0,0,0,0,0,-96000,0,0,0,53000,149000,-96000,-96000
050767,京元電元大96購01,0,0,0,0,0,0,0,0,0,-96000,0,0,0,29000,125000,-96000,-96000
057041,國巨元大99購04  ,0,0,0,0,0,0,0,0,0,-96000,0,0,0,10000,106000,-96000,-96000
07134P,臺股指元大9A售28,0,0,0,0,0,0,0,0,0,-97000,0,0,0,5000,102000,-97000,-97000
1519,華城            ,182000,279000,-97000,0,0,0,0,0,0,0,0,0,0,0,0,0,-97000
048576,義隆國泰95購01  ,0,0,0,0,0,0,0,0,0,-97000,0,0,0,4000,101000,-97000,-97000
054827,宏全元大9A購01  ,0,0,0,0,0,0,0,0,0,-97000,0,0,0,10000,107000,-97000,-97000
053960,晶技永豐96購02  ,0,0,0,0,0,0,0,0,0,-97000,0,0,0,23000,120000,-97000,-97000
2428,興勤            ,137000,232000,-95000,0,0,0,0,0,0,-2000,0,0,0,0,2000,-2000,-97000
2608,嘉里大榮        ,31000,129000,-98000,0,0,0,0,0,0,1000,1000,0,1000,0,0,0,-97000
059204,台灣50元大01購02,0,0,0,0,0,0,0,0,0,-98000,0,0,0,0,98000,-98000,-98000
058688,矽創凱基9A購01  ,0,0,0,0,0,0,0,0,0,-98000,0,0,0,18000,116000,-98000,-98000
04393P,牧德凱基94售06  ,0,0,0,0,0,0,0,0,0,-98000,0,0,0,0,98000,-98000,-98000
055657,超眾元富97購02  ,0,0,0,0,0,0,0,0,0,-98000,0,0,0,0,98000,-98000,-98000
055687,瀚宇博凱基97購01,0,0,0,0,0,0,0,0,0,-98000,0,0,0,11000,109000,-98000,-98000
054785,建準群益98購01  ,0,0,0,0,0,0,0,0,0,-98000,0,0,0,0,98000,-98000,-98000
05513P,玉山金台新96售01,0,0,0,0,0,0,0,0,0,-98000,0,0,0,91000,189000,-98000,-98000
5305,敦南            ,132000,237000,-105000,0,0,0,0,0,0,7000,7000,0,7000,0,0,0,-98000
057745,泰鼎永豐99購01  ,0,0,0,0,0,0,0,0,0,-99000,0,0,0,70000,169000,-99000,-99000
055921,新唐凱基98購01  ,0,0,0,0,0,0,0,0,0,-99000,0,0,0,0,99000,-99000,-99000
043735,元金2X元大94購01,0,0,0,0,0,0,0,0,0,-99000,0,0,0,600000,699000,-99000,-99000
046864,和大統一97購01  ,0,0,0,0,0,0,0,0,0,-99000,0,0,0,0,99000,-99000,-99000
057761,聯發科凱基99購04,0,0,0,0,0,0,0,0,0,-100000,0,0,0,0,100000,-100000,-100000
057702,同欣電群益99購01,0,0,0,0,0,0,0,0,0,-100000,0,0,0,0,100000,-100000,-100000
057650,力成元大98購04  ,0,0,0,0,0,0,0,0,0,-100000,0,0,0,0,100000,-100000,-100000
057636,上銀元大98購06  ,0,0,0,0,0,0,0,0,0,-100000,0,0,0,0,100000,-100000,-100000
057592,美律兆豐99購01  ,0,0,0,0,0,0,0,0,0,-100000,0,0,0,0,100000,-100000,-100000
057593,聯發科兆豐98購03,0,0,0,0,0,0,0,0,0,-100000,0,0,0,0,100000,-100000,-100000
058066,可成亞東99購01  ,0,0,0,0,0,0,0,0,0,-100000,0,0,0,50000,150000,-100000,-100000
058212,華新科群益9A購01,0,0,0,0,0,0,0,0,0,-100000,0,0,0,0,100000,-100000,-100000
058123,亞光國票9A購01  ,0,0,0,0,0,0,0,0,0,-100000,0,0,0,0,100000,-100000,-100000
05853P,欣興群益96售05  ,0,0,0,0,0,0,0,0,0,-100000,0,0,0,0,100000,-100000,-100000
058590,南電中信9A購02  ,0,0,0,0,0,0,0,0,0,-100000,0,0,0,0,100000,-100000,-100000
058493,台積電群益9A購01,0,0,0,0,0,0,0,0,0,-100000,0,0,0,0,100000,-100000,-100000
058511,華新科元大9B購01,0,0,0,0,0,0,0,0,0,-100000,0,0,0,0,100000,-100000,-100000
058928,國巨統一9C購01  ,0,0,0,0,0,0,0,0,0,-100000,0,0,0,0,100000,-100000,-100000
058747,友達凱基9A購03  ,0,0,0,0,0,0,0,0,0,-100000,0,0,0,0,100000,-100000,-100000
058773,和碩兆豐99購01  ,0,0,0,0,0,0,0,0,0,-100000,0,0,0,0,100000,-100000,-100000
06124P,超眾元大97售03  ,0,0,0,0,0,0,0,0,0,-100000,0,0,0,0,100000,-100000,-100000
1512,瑞利            ,0,100000,-100000,0,0,0,0,0,0,0,0,0,0,0,0,0,-100000
050348,鴻海群益94購06  ,0,0,0,0,0,0,0,0,0,-100000,0,0,0,300000,400000,-100000,-100000
050362,深中小元大94購04,0,0,0,0,0,0,0,0,0,-100000,0,0,0,20000,120000,-100000,-100000
048105,滬深2X群益99購02,0,0,0,0,0,0,0,0,0,-100000,0,0,0,0,100000,-100000,-100000
047123,中石化中信95購01,0,0,0,0,0,0,0,0,0,-100000,0,0,0,0,100000,-100000,-100000
042516,健策凱基93購01  ,0,0,0,0,0,0,0,0,0,-100000,0,0,0,0,100000,-100000,-100000
042542,台灣50元大93購14,0,0,0,0,0,0,0,0,0,-100000,0,0,0,0,100000,-100000,-100000
04136P,智邦元大93售09  ,0,0,0,0,0,0,0,0,0,-100000,0,0,0,0,100000,-100000,-100000
055860,啟碁元大97購04  ,0,0,0,0,0,0,0,0,0,-100000,0,0,0,0,100000,-100000,-100000
056026,智易群益97購01  ,0,0,0,0,0,0,0,0,0,-100000,0,0,0,0,100000,-100000,-100000
055481,聚陽元大97購01  ,0,0,0,0,0,0,0,0,0,-100000,0,0,0,35000,135000,-100000,-100000
055472,大立光凱基97購07,0,0,0,0,0,0,0,0,0,-100000,0,0,0,0,100000,-100000,-100000
055587,智邦元大97購02  ,0,0,0,0,0,0,0,0,0,-100000,0,0,0,2000,102000,-100000,-100000
051582,聯發科元大97購02,0,0,0,0,0,0,0,0,0,-100000,0,0,0,0,100000,-100000,-100000
05124P,華新科富邦97售02,0,0,0,0,0,0,0,0,0,-100000,0,0,0,0,100000,-100000,-100000
050867,聯鈞永豐95購01  ,0,0,0,0,0,0,0,0,0,-100000,0,0,0,0,100000,-100000,-100000
049005,可成中信95購01  ,0,0,0,0,0,0,0,0,0,-100000,0,0,0,0,100000,-100000,-100000
051012,台積電凱基95購04,0,0,0,0,0,0,0,0,0,-100000,0,0,0,0,100000,-100000,-100000
049501,台郡元大95購01  ,0,0,0,0,0,0,0,0,0,-100000,0,0,0,0,100000,-100000,-100000
052047,建準凱基96購01  ,0,0,0,0,0,0,0,0,0,-100000,0,0,0,0,100000,-100000,-100000
050779,超眾元大96購03  ,0,0,0,0,0,0,0,0,0,-100000,0,0,0,0,100000,-100000,-100000
051058,景碩群益96購01  ,0,0,0,0,0,0,0,0,0,-100000,0,0,0,0,100000,-100000,-100000
051737,瑞昱國票96購01  ,0,0,0,0,0,0,0,0,0,-100000,0,0,0,0,100000,-100000,-100000
049641,台達電凱基94購08,0,0,0,0,0,0,0,0,0,-100000,0,0,0,0,100000,-100000,-100000
04993P,上銀兆豐96售01  ,0,0,0,0,0,0,0,0,0,-100000,0,0,0,104000,204000,-100000,-100000
055148,鴻海元大98購02  ,0,0,0,0,0,0,0,0,0,-100000,0,0,0,30000,130000,-100000,-100000
055024,興勤國泰98購01  ,0,0,0,0,0,0,0,0,0,-100000,0,0,0,0,100000,-100000,-100000
054810,中橡元大9A購01  ,0,0,0,0,0,0,0,0,0,-100000,0,0,0,0,100000,-100000,-100000
056926,日月光兆豐98購01,0,0,0,0,0,0,0,0,0,-100000,0,0,0,0,100000,-100000,-100000
056916,台達電兆豐98購02,0,0,0,0,0,0,0,0,0,-100000,0,0,0,0,100000,-100000,-100000
056858,國巨群益99購03  ,0,0,0,0,0,0,0,0,0,-100000,0,0,0,0,100000,-100000,-100000
056991,牧德兆豐98購01  ,0,0,0,0,0,0,0,0,0,-100000,0,0,0,0,100000,-100000,-100000
057257,台泥兆豐99購01  ,0,0,0,0,0,0,0,0,0,-100000,0,0,0,0,100000,-100000,-100000
053957,瑞昱永豐96購01  ,0,0,0,0,0,0,0,0,0,-100000,0,0,0,0,100000,-100000,-100000
054131,南亞科元大96購04,0,0,0,0,0,0,0,0,0,-100000,0,0,0,0,100000,-100000,-100000
054100,致伸國票97購03  ,0,0,0,0,0,0,0,0,0,-100000,0,0,0,0,100000,-100000,-100000
053495,聯發科兆豐96購02,0,0,0,0,0,0,0,0,0,-100000,0,0,0,0,100000,-100000,-100000
056360,智邦元大98購01  ,0,0,0,0,0,0,0,0,0,-100000,0,0,0,38000,138000,-100000,-100000
055745,臻鼎元富97購01  ,0,0,0,0,0,0,0,0,0,-100000,0,0,0,10000,110000,-100000,-100000
055779,國泰金凱基97購02,0,0,0,0,0,0,0,0,0,-100000,0,0,0,0,100000,-100000,-100000
053145,元黃金元大96購02,0,0,0,0,0,0,0,0,0,-100000,0,0,0,0,100000,-100000,-100000
053172,瑞儀群益97購01  ,0,0,0,0,0,0,0,0,0,-100000,0,0,0,0,100000,-100000,-100000
056109,彩晶永豐98購01  ,0,0,0,0,0,0,0,0,0,-100000,0,0,0,0,100000,-100000,-100000
056115,奇力新群益97購06,0,0,0,0,0,0,0,0,0,-100000,0,0,0,0,100000,-100000,-100000
055273,華泰元大97購01  ,0,0,0,0,0,0,0,0,0,-100000,0,0,0,0,100000,-100000,-100000
056133,可成元大97購05  ,0,0,0,0,0,0,0,0,0,-100000,0,0,0,7000,107000,-100000,-100000
056134,可成元大97購06  ,0,0,0,0,0,0,0,0,0,-100000,0,0,0,70000,170000,-100000,-100000
055422,康控永豐97購01  ,0,0,0,0,0,0,0,0,0,-100000,0,0,0,0,100000,-100000,-100000
056349,道瓊銀元大9B購01,0,0,0,0,0,0,0,0,0,-100000,0,0,0,0,100000,-100000,-100000
056225,聯發科凱基97購09,0,0,0,0,0,0,0,0,0,-100000,0,0,0,0,100000,-100000,-100000
056232,瑞儀凱基98購01  ,0,0,0,0,0,0,0,0,0,-100000,0,0,0,0,100000,-100000,-100000
05534P,元油反元大96售06,0,0,0,0,0,0,0,0,0,-100000,0,0,0,0,100000,-100000,-100000
056245,嘉澤群益97購01  ,0,0,0,0,0,0,0,0,0,-100000,0,0,0,0,100000,-100000,-100000
056251,聯發科兆豐97購02,0,0,0,0,0,0,0,0,0,-100000,0,0,0,0,100000,-100000,-100000
056335,微星凱基98購01  ,0,0,0,0,0,0,0,0,0,-100000,0,0,0,41000,141000,-100000,-100000
056625,致伸永豐98購01  ,0,0,0,0,0,0,0,0,0,-100000,0,0,0,0,100000,-100000,-100000
053435,新光金日盛96購01,0,0,0,0,0,0,0,0,0,-100000,0,0,0,0,100000,-100000,-100000
053036,聯電凱基98購01  ,0,0,0,0,0,0,0,0,0,-100000,0,0,0,0,100000,-100000,-100000
052932,正文元大97購01  ,0,0,0,0,0,0,0,0,0,-100000,0,0,0,0,100000,-100000,-100000
056718,GIS永豐98購01   ,0,0,0,0,0,0,0,0,0,-100000,0,0,0,0,100000,-100000,-100000
2406,國碩            ,195000,296116,-101116,0,0,0,0,0,0,1000,1000,0,1000,0,0,0,-100116
06717P,可成元大98售09  ,0,0,0,0,0,0,0,0,0,-101000,0,0,0,0,101000,-101000,-101000
058835,元油2X中信9C購02,0,0,0,0,0,0,0,0,0,-101000,0,0,0,0,101000,-101000,-101000
058087,鴻海元大98購15  ,0,0,0,0,0,0,0,0,0,-101000,0,0,0,83000,184000,-101000,-101000
057526,智邦元大98購10  ,0,0,0,0,0,0,0,0,0,-101000,0,0,0,57000,158000,-101000,-101000
052515,矽力凱基95購02  ,0,0,0,0,0,0,0,0,0,-101000,0,0,0,0,101000,-101000,-101000
054967,神達元大97購01  ,0,0,0,0,0,0,0,0,0,-101000,0,0,0,66000,167000,-101000,-101000
05442P,鴻海元大96售13  ,0,0,0,0,0,0,0,0,0,-101000,0,0,0,194000,295000,-101000,-101000
057260,微星兆豐98購01  ,0,0,0,0,0,0,0,0,0,-101000,0,0,0,0,101000,-101000,-101000
058153,景碩統一9B購01  ,0,0,0,0,0,0,0,0,0,-102000,0,0,0,0,102000,-102000,-102000
058377,茂林凱基9A購03  ,0,0,0,0,0,0,0,0,0,-102000,0,0,0,178000,280000,-102000,-102000
058540,嘉聯益國泰9A購02,0,0,0,0,0,0,0,0,0,-102000,0,0,0,0,102000,-102000,-102000
058684,健策凱基99購02  ,0,0,0,0,0,0,0,0,0,-102000,0,0,0,0,102000,-102000,-102000
06566P,華通永豐98售03  ,0,0,0,0,0,0,0,0,0,-102000,0,0,0,61000,163000,-102000,-102000
06833P,矽力群益99售01  ,0,0,0,0,0,0,0,0,0,-102000,0,0,0,3000,105000,-102000,-102000
052020,聯茂永豐95購02  ,0,0,0,0,0,0,0,0,0,-102000,0,0,0,138000,240000,-102000,-102000
052229,奇力新凱基96購01,0,0,0,0,0,0,0,0,0,-102000,0,0,0,0,102000,-102000,-102000
050650,大立光凱基96購01,0,0,0,0,0,0,0,0,0,-102000,0,0,0,20000,122000,-102000,-102000
053186,健策中信9C購01  ,0,0,0,0,0,0,0,0,0,-102000,0,0,0,0,102000,-102000,-102000
05296P,牧德凱基96售01  ,0,0,0,0,0,0,0,0,0,-102000,0,0,0,106000,208000,-102000,-102000
6412,群電            ,324000,441000,-117000,0,0,0,4000,0,4000,11000,11000,0,11000,0,0,0,-102000
9939,宏全            ,699000,484000,215000,0,0,0,80000,0,80000,-397000,27000,430000,-403000,8000,2000,6000,-102000
059214,國巨元大99購20  ,0,0,0,0,0,0,0,0,0,-103000,0,0,0,10000,113000,-103000,-103000
051077,台郡國泰96購02  ,0,0,0,0,0,0,0,0,0,-103000,0,0,0,0,103000,-103000,-103000
056972,祥碩永豐98購02  ,0,0,0,0,0,0,0,0,0,-103000,0,0,0,147000,250000,-103000,-103000
057034,道瓊反元大9B購01,0,0,0,0,0,0,0,0,0,-103000,0,0,0,109000,212000,-103000,-103000
2606,裕民            ,322000,433000,-111000,0,0,0,9000,0,9000,-1000,0,1000,-1000,0,0,0,-103000
057578,可成中信99購01  ,0,0,0,0,0,0,0,0,0,-104000,0,0,0,0,104000,-104000,-104000
055466,台達電凱基97購03,0,0,0,0,0,0,0,0,0,-104000,0,0,0,40000,144000,-104000,-104000
047780,友達中信96購01  ,0,0,0,0,0,0,0,0,0,-104000,0,0,0,200000,304000,-104000,-104000
050327,泰鼎永豐94購03  ,0,0,0,0,0,0,0,0,0,-104000,0,0,0,0,104000,-104000,-104000
051829,玉晶光元大98購02,0,0,0,0,0,0,0,0,0,-104000,0,0,0,104000,208000,-104000,-104000
05573P,仁寶元富96售02  ,0,0,0,0,0,0,0,0,0,-104000,0,0,0,107000,211000,-104000,-104000
058100,聯茂國泰99購02  ,0,0,0,0,0,0,0,0,0,-105000,0,0,0,32000,137000,-105000,-105000
04159P,滬深2X中信95售08,0,0,0,0,0,0,0,0,0,-105000,0,0,0,104000,209000,-105000,-105000
055456,上銀富邦99購01  ,0,0,0,0,0,0,0,0,0,-105000,0,0,0,0,105000,-105000,-105000
052173,廣達元大95購02  ,0,0,0,0,0,0,0,0,0,-105000,0,0,0,45000,150000,-105000,-105000
056852,矽格元富98購01  ,0,0,0,0,0,0,0,0,0,-105000,0,0,0,57000,162000,-105000,-105000
057208,上海銀元富98購01,0,0,0,0,0,0,0,0,0,-105000,0,0,0,0,105000,-105000,-105000
054567,拓凱群益98購01  ,0,0,0,0,0,0,0,0,0,-105000,0,0,0,0,105000,-105000,-105000
1604,聲寶            ,171000,277000,-106000,0,0,0,0,0,0,0,0,0,0,0,0,0,-106000
049352,泰鼎永豐95購01  ,0,0,0,0,0,0,0,0,0,-106000,0,0,0,0,106000,-106000,-106000
05601P,鴻海元大97售04  ,0,0,0,0,0,0,0,0,0,-106000,0,0,0,410000,516000,-106000,-106000
048574,台積電國泰95購02,0,0,0,0,0,0,0,0,0,-106000,0,0,0,16000,122000,-106000,-106000
057206,立積元富98購01  ,0,0,0,0,0,0,0,0,0,-106000,0,0,0,65000,171000,-106000,-106000
055039,神達富邦99購01  ,0,0,0,0,0,0,0,0,0,-106000,0,0,0,1000,107000,-106000,-106000
057691,健策凱基99購01  ,0,0,0,0,0,0,0,0,0,-107000,0,0,0,0,107000,-107000,-107000
058770,貿聯兆豐9A購01  ,0,0,0,0,0,0,0,0,0,-107000,0,0,0,90000,197000,-107000,-107000
05169P,玉晶光元大95售03,0,0,0,0,0,0,0,0,0,-107000,0,0,0,95000,202000,-107000,-107000
057386,聯發科永豐98購04,0,0,0,0,0,0,0,0,0,-107000,0,0,0,50000,157000,-107000,-107000
051591,玉晶光元大97購01,0,0,0,0,0,0,0,0,0,-108000,0,0,0,10000,118000,-108000,-108000
03252P,台積電台新02售01,0,0,0,0,0,0,0,0,0,-108000,0,0,0,28000,136000,-108000,-108000
057207,立積元富98購02  ,0,0,0,0,0,0,0,0,0,-108000,0,0,0,10000,118000,-108000,-108000
057180,華新科元大99購08,0,0,0,0,0,0,0,0,0,-108000,0,0,0,50000,158000,-108000,-108000
053565,台光電富邦98購01,0,0,0,0,0,0,0,0,0,-108000,0,0,0,2000,110000,-108000,-108000
051563,泰鼎國泰96購01  ,0,0,0,0,0,0,0,0,0,-109000,0,0,0,0,109000,-109000,-109000
051378,奇力新群益95購01,0,0,0,0,0,0,0,0,0,-109000,0,0,0,2000,111000,-109000,-109000
053551,可成凱基96購05  ,0,0,0,0,0,0,0,0,0,-109000,0,0,0,0,109000,-109000,-109000
052759,京元電群益96購01,0,0,0,0,0,0,0,0,0,-109000,0,0,0,0,109000,-109000,-109000
2392,正崴            ,1072000,1210000,-138000,0,0,0,0,0,0,29000,58000,29000,29000,17000,17000,0,-109000
058818,南電台新99購03  ,0,0,0,0,0,0,0,0,0,-110000,0,0,0,0,110000,-110000,-110000
057884,華邦電群益98購02,0,0,0,0,0,0,0,0,0,-110000,0,0,0,10000,120000,-110000,-110000
07142P,台灣50元大01售01,0,0,0,0,0,0,0,0,0,-110000,0,0,0,0,110000,-110000,-110000
06946P,T50正2元大9C售01,0,0,0,0,0,0,0,0,0,-110000,0,0,0,90000,200000,-110000,-110000
059182,台灣50台新9B購03,0,0,0,0,0,0,0,0,0,-110000,0,0,0,0,110000,-110000,-110000
050899,旭富元大95購01  ,0,0,0,0,0,0,0,0,0,-110000,0,0,0,54000,164000,-110000,-110000
049101,聯詠國泰95購01  ,0,0,0,0,0,0,0,0,0,-110000,0,0,0,0,110000,-110000,-110000
055863,緯穎元大97購05  ,0,0,0,0,0,0,0,0,0,-110000,0,0,0,4000,114000,-110000,-110000
051695,元金2X中信98購01,0,0,0,0,0,0,0,0,0,-110000,0,0,0,0,110000,-110000,-110000
051092,禾伸堂元大95購02,0,0,0,0,0,0,0,0,0,-110000,0,0,0,0,110000,-110000,-110000
049310,台積電凱基94購15,0,0,0,0,0,0,0,0,0,-110000,0,0,0,0,110000,-110000,-110000
048652,巨大元大96購01  ,0,0,0,0,0,0,0,0,0,-110000,0,0,0,0,110000,-110000,-110000
051828,微星元大95購03  ,0,0,0,0,0,0,0,0,0,-110000,0,0,0,0,110000,-110000,-110000
047680,上証反中信96購01,0,0,0,0,0,0,0,0,0,-110000,0,0,0,1000,111000,-110000,-110000
047154,新光金國票95購01,0,0,0,0,0,0,0,0,0,-110000,0,0,0,0,110000,-110000,-110000
052941,康控兆豐97購01  ,0,0,0,0,0,0,0,0,0,-110000,0,0,0,0,110000,-110000,-110000
054366,和大中信98購01  ,0,0,0,0,0,0,0,0,0,-110000,0,0,0,0,110000,-110000,-110000
054246,國巨元大96購12  ,0,0,0,0,0,0,0,0,0,-110000,0,0,0,0,110000,-110000,-110000
056490,台積電國泰99購01,0,0,0,0,0,0,0,0,0,-110000,0,0,0,60000,170000,-110000,-110000
054701,宏全永豐97購01  ,0,0,0,0,0,0,0,0,0,-110000,0,0,0,0,110000,-110000,-110000
054846,瑞昱兆豐97購01  ,0,0,0,0,0,0,0,0,0,-110000,0,0,0,38000,148000,-110000,-110000
07114P,旺宏兆豐9A售01  ,0,0,0,0,0,0,0,0,0,-111000,0,0,0,31000,142000,-111000,-111000
050414,泰鼎永豐94購04  ,0,0,0,0,0,0,0,0,0,-111000,0,0,0,0,111000,-111000,-111000
049653,緯穎凱基94購03  ,0,0,0,0,0,0,0,0,0,-111000,0,0,0,10000,121000,-111000,-111000
056637,台光電日盛9A購01,0,0,0,0,0,0,0,0,0,-111000,0,0,0,0,111000,-111000,-111000
058774,台郡兆豐9A購01  ,0,0,0,0,0,0,0,0,0,-112000,0,0,0,0,112000,-112000,-112000
058971,台積電永豐99購03,0,0,0,0,0,0,0,0,0,-112000,0,0,0,0,112000,-112000,-112000
050219,台積電元富95購03,0,0,0,0,0,0,0,0,0,-112000,0,0,0,23000,135000,-112000,-112000
04401P,玉晶光兆豐94售01,0,0,0,0,0,0,0,0,0,-112000,0,0,0,8000,120000,-112000,-112000
055206,台虹中信97購01  ,0,0,0,0,0,0,0,0,0,-112000,0,0,0,0,112000,-112000,-112000
058401,華航元大9A購01  ,0,0,0,0,0,0,0,0,0,-113000,0,0,0,2000,115000,-113000,-113000
04727P,臺股指凱基96售03,0,0,0,0,0,0,0,0,0,-113000,0,0,0,157000,270000,-113000,-113000
049463,華新科富邦97購01,0,0,0,0,0,0,0,0,0,-113000,0,0,0,0,113000,-113000,-113000
050998,訊連元大95購01  ,0,0,0,0,0,0,0,0,0,-113000,0,0,0,37000,150000,-113000,-113000
05244P,台積電元大95售17,0,0,0,0,0,0,0,0,0,-113000,0,0,0,44000,157000,-113000,-113000
054647,禾伸堂群益99購01,0,0,0,0,0,0,0,0,0,-114000,0,0,0,180000,294000,-114000,-114000
054020,技嘉台新97購01  ,0,0,0,0,0,0,0,0,0,-114000,0,0,0,121000,235000,-114000,-114000
1734,杏輝            ,79000,194000,-115000,0,0,0,0,0,0,0,0,0,0,0,0,0,-115000
06552P,茂林元大99售02  ,0,0,0,0,0,0,0,0,0,-115000,0,0,0,90000,205000,-115000,-115000
055665,亞德客群益97購01,0,0,0,0,0,0,0,0,0,-115000,0,0,0,0,115000,-115000,-115000
047418,智邦富邦97購01  ,0,0,0,0,0,0,0,0,0,-115000,0,0,0,100000,215000,-115000,-115000
054513,元金2X元大96購01,0,0,0,0,0,0,0,0,0,-115000,0,0,0,816000,931000,-115000,-115000
054756,世紀鋼凱基99購01,0,0,0,0,0,0,0,0,0,-115000,0,0,0,111000,226000,-115000,-115000
057192,力成元大98購01  ,0,0,0,0,0,0,0,0,0,-115000,0,0,0,0,115000,-115000,-115000
056966,嘉晶永豐98購01  ,0,0,0,0,0,0,0,0,0,-115000,0,0,0,74000,189000,-115000,-115000
054300,華通凱基96購07  ,0,0,0,0,0,0,0,0,0,-115000,0,0,0,0,115000,-115000,-115000
06614P,祥碩永豐98售03  ,0,0,0,0,0,0,0,0,0,-116000,0,0,0,96000,212000,-116000,-116000
057638,上銀元大99購01  ,0,0,0,0,0,0,0,0,0,-116000,0,0,0,4000,120000,-116000,-116000
057489,奇力新元大99購06,0,0,0,0,0,0,0,0,0,-116000,0,0,0,0,116000,-116000,-116000
048867,台積電兆豐95購01,0,0,0,0,0,0,0,0,0,-116000,0,0,0,0,116000,-116000,-116000
049835,緯穎凱基94購05  ,0,0,0,0,0,0,0,0,0,-116000,0,0,0,10000,126000,-116000,-116000
052777,燿華國票98購01  ,0,0,0,0,0,0,0,0,0,-116000,0,0,0,0,116000,-116000,-116000
054405,樺漢康和96購01  ,0,0,0,0,0,0,0,0,0,-116000,0,0,0,0,116000,-116000,-116000
056532,技嘉凱基98購01  ,0,0,0,0,0,0,0,0,0,-116000,0,0,0,0,116000,-116000,-116000
054497,國巨永豐96購05  ,0,0,0,0,0,0,0,0,0,-116000,0,0,0,0,116000,-116000,-116000
047769,大立光元大96購01,0,0,0,0,0,0,0,0,0,-117000,0,0,0,33000,150000,-117000,-117000
05412P,泰碩國票95售02  ,0,0,0,0,0,0,0,0,0,-118000,0,0,0,0,118000,-118000,-118000
055759,技嘉群益98購02  ,0,0,0,0,0,0,0,0,0,-118000,0,0,0,16000,134000,-118000,-118000
056754,智易兆豐99購01  ,0,0,0,0,0,0,0,0,0,-118000,0,0,0,103000,221000,-118000,-118000
2707,晶華            ,120000,236000,-116000,0,0,0,0,0,0,-2000,0,2000,-2000,0,0,0,-118000
020000,富邦特選蘋果N   ,0,0,0,0,0,0,0,0,0,-119000,0,0,0,164000,283000,-119000,-119000
054463,瑞昱凱基97購01  ,0,0,0,0,0,0,0,0,0,-119000,0,0,0,0,119000,-119000,-119000
054693,神基永豐97購01  ,0,0,0,0,0,0,0,0,0,-119000,0,0,0,11000,130000,-119000,-119000
057488,聯發科元大99購02,0,0,0,0,0,0,0,0,0,-120000,0,0,0,230000,350000,-120000,-120000
057417,國巨凱基9A購03  ,0,0,0,0,0,0,0,0,0,-120000,0,0,0,0,120000,-120000,-120000
058417,國巨麥證99購01  ,0,0,0,20000,140000,-120000,0,0,0,-120000,0,0,0,20000,140000,-120000,-120000
058520,智易元大99購03  ,0,0,0,0,0,0,0,0,0,-120000,0,0,0,0,120000,-120000,-120000
058737,鴻海第一01購01  ,0,0,0,0,0,0,0,0,0,-120000,0,0,0,40000,160000,-120000,-120000
07125P,台積電元大99售22,0,0,0,0,0,0,0,0,0,-120000,0,0,0,60000,180000,-120000,-120000
045877,友達元富95購01  ,0,0,0,0,0,0,0,0,0,-120000,0,0,0,0,120000,-120000,-120000
050433,華新科凱基94購11,0,0,0,0,0,0,0,0,0,-120000,0,0,0,0,120000,-120000,-120000
05011P,南電國泰96售01  ,0,0,0,0,0,0,0,0,0,-120000,0,0,0,49000,169000,-120000,-120000
051769,矽力元大95購01  ,0,0,0,0,0,0,0,0,0,-120000,0,0,0,0,120000,-120000,-120000
054677,智易台新98購02  ,0,0,0,0,0,0,0,0,0,-120000,0,0,0,0,120000,-120000,-120000
054962,玉晶光元大99購02,0,0,0,0,0,0,0,0,0,-120000,0,0,0,0,120000,-120000,-120000
054581,訊芯元大97購02  ,0,0,0,0,0,0,0,0,0,-120000,0,0,0,0,120000,-120000,-120000
054065,樺漢國票97購01  ,0,0,0,0,0,0,0,0,0,-120000,0,0,0,0,120000,-120000,-120000
057173,南亞科元大98購04,0,0,0,0,0,0,0,0,0,-120000,0,0,0,0,120000,-120000,-120000
054796,康普群益98購01  ,0,0,0,0,0,0,0,0,0,-120000,0,0,0,0,120000,-120000,-120000
053054,禾伸堂國票97購01,0,0,0,0,0,0,0,0,0,-120000,0,0,0,0,120000,-120000,-120000
055348,旺宏凱基97購01  ,0,0,0,0,0,0,0,0,0,-120000,0,0,0,0,120000,-120000,-120000
056321,創意群益98購02  ,0,0,0,0,0,0,0,0,0,-120000,0,0,0,10000,130000,-120000,-120000
1521,大億            ,6000,127000,-121000,0,0,0,0,0,0,0,0,0,0,0,0,0,-121000
059186,華通富邦9A購01  ,0,0,0,0,0,0,0,0,0,-121000,0,0,0,0,121000,-121000,-121000
057889,致新群益99購01  ,0,0,0,0,0,0,0,0,0,-121000,0,0,0,0,121000,-121000,-121000
051690,超眾凱基95購03  ,0,0,0,0,0,0,0,0,0,-121000,0,0,0,0,121000,-121000,-121000
056437,台積電凱基98購11,0,0,0,0,0,0,0,0,0,-121000,0,0,0,33000,154000,-121000,-121000
052396,台積電凱基97購01,0,0,0,0,0,0,0,0,0,-121000,0,0,0,0,121000,-121000,-121000
057466,泰鼎永豐98購01  ,0,0,0,0,0,0,0,0,0,-122000,0,0,0,5000,127000,-122000,-122000
058856,新光金兆豐99購01,0,0,0,0,0,0,0,0,0,-122000,0,0,0,8000,130000,-122000,-122000
058514,潤泰全元大99購01,0,0,0,0,0,0,0,0,0,-122000,0,0,0,71000,193000,-122000,-122000
050356,緯穎群益94購05  ,0,0,0,0,0,0,0,0,0,-122000,0,0,0,10000,132000,-122000,-122000
045055,聯發科元富98購03,0,0,0,0,0,0,0,0,0,-122000,0,0,0,110000,232000,-122000,-122000
054642,訊芯中信9A購01  ,0,0,0,0,0,0,0,0,0,-122000,0,0,0,0,122000,-122000,-122000
056786,亞光群益98購03  ,0,0,0,0,0,0,0,0,0,-122000,0,0,0,0,122000,-122000,-122000
053197,超眾元富96購02  ,0,0,0,0,0,0,0,0,0,-122000,0,0,0,0,122000,-122000,-122000
2228,劍麟            ,160000,280000,-120000,0,0,0,0,2000,-2000,0,0,0,0,0,0,0,-122000
056641,華通凱基98購03  ,0,0,0,0,0,0,0,0,0,-123000,0,0,0,0,123000,-123000,-123000
056292,統一元大97購01  ,0,0,0,0,0,0,0,0,0,-123000,0,0,0,26000,149000,-123000,-123000
053627,宏碁兆豐97購01  ,0,0,0,0,0,0,0,0,0,-124000,0,0,0,0,124000,-124000,-124000
057132,華新科凱基98購05,0,0,0,0,0,0,0,0,0,-124000,0,0,0,0,124000,-124000,-124000
058469,臺股指中信9A購05,0,0,0,0,0,0,0,0,0,-125000,0,0,0,0,125000,-125000,-125000
058653,光寶科中信9A購01,0,0,0,0,0,0,0,0,0,-125000,0,0,0,53000,178000,-125000,-125000
047885,元金2X富邦99購01,0,0,0,0,0,0,0,0,0,-125000,0,0,0,0,125000,-125000,-125000
044530,台積電富邦94購01,0,0,0,0,0,0,0,0,0,-125000,0,0,0,0,125000,-125000,-125000
055907,台虹兆豐98購01  ,0,0,0,0,0,0,0,0,0,-125000,0,0,0,0,125000,-125000,-125000
057175,美律元大98購03  ,0,0,0,0,0,0,0,0,0,-125000,0,0,0,31000,156000,-125000,-125000
054676,牧德台新98購01  ,0,0,0,0,0,0,0,0,0,-125000,0,0,0,5000,130000,-125000,-125000
054925,神達凱基97購01  ,0,0,0,0,0,0,0,0,0,-125000,0,0,0,10000,135000,-125000,-125000
058427,大毅元富99購01  ,0,0,0,0,0,0,0,0,0,-126000,0,0,0,20000,146000,-126000,-126000
048263,台積電元富95購01,0,0,0,0,0,0,0,0,0,-126000,0,0,0,0,126000,-126000,-126000
03434B,臺股指元大99熊10,0,0,0,0,0,0,0,0,0,-126000,0,0,0,191000,317000,-126000,-126000
047569,世紀鋼國票94購02,0,0,0,0,0,0,0,0,0,-126000,0,0,0,0,126000,-126000,-126000
054544,統一中信97購01  ,0,0,0,0,0,0,0,0,0,-126000,0,0,0,20000,146000,-126000,-126000
057141,嘉聯益兆豐99購01,0,0,0,0,0,0,0,0,0,-126000,0,0,0,0,126000,-126000,-126000
058090,聯發科元大98購16,0,0,0,0,0,0,0,0,0,-127000,0,0,0,47000,174000,-127000,-127000
057121,立積康和98購01  ,0,0,0,0,0,0,0,0,0,-127000,0,0,0,0,127000,-127000,-127000
6285,啟碁            ,836000,974000,-138000,0,0,0,0,1000,-1000,12000,41000,15000,26000,9000,23000,-14000,-127000
058403,玉晶光元大99購12,0,0,0,0,0,0,0,0,0,-128000,0,0,0,86000,214000,-128000,-128000
1307,三芳            ,30000,148000,-118000,0,0,0,0,0,0,-10000,6000,16000,-10000,0,0,0,-128000
055938,矽力群益97購01  ,0,0,0,0,0,0,0,0,0,-128000,0,0,0,0,128000,-128000,-128000
9917,中保科          ,66000,141000,-75000,0,0,0,1000,0,1000,-54000,0,54000,-54000,0,0,0,-128000
6415,矽力-KY         ,736000,885644,-149644,0,0,0,36000,21000,15000,6000,1000,0,1000,12000,7000,5000,-128644
056206,泰鼎永豐97購01  ,0,0,0,0,0,0,0,0,0,-129000,0,0,0,31000,160000,-129000,-129000
054166,日電貿凱基98購01,0,0,0,0,0,0,0,0,0,-129000,0,0,0,11000,140000,-129000,-129000
059102,聯鈞元富99購01  ,0,0,0,0,0,0,0,0,0,-130000,0,0,0,0,130000,-130000,-130000
058606,聯發科元大99購13,0,0,0,0,0,0,0,0,0,-130000,0,0,0,309000,439000,-130000,-130000
058832,立積永豐99購01  ,0,0,0,0,0,0,0,0,0,-130000,0,0,0,0,130000,-130000,-130000
055881,康控元富97購01  ,0,0,0,0,0,0,0,0,0,-130000,0,0,0,0,130000,-130000,-130000
049174,台積電凱基94購11,0,0,0,0,0,0,0,0,0,-130000,0,0,0,0,130000,-130000,-130000
052278,國巨凱基95購06  ,0,0,0,0,0,0,0,0,0,-130000,0,0,0,0,130000,-130000,-130000
051052,台積電群益95購01,0,0,0,0,0,0,0,0,0,-130000,0,0,0,0,130000,-130000,-130000
055421,玉晶光永豐98購04,0,0,0,0,0,0,0,0,0,-130000,0,0,0,0,130000,-130000,-130000
056599,臻鼎元富98購01  ,0,0,0,0,0,0,0,0,0,-130000,0,0,0,0,130000,-130000,-130000
052592,華通群益98購01  ,0,0,0,0,0,0,0,0,0,-130000,0,0,0,0,130000,-130000,-130000
057308,同欣電兆豐99購01,0,0,0,0,0,0,0,0,0,-130000,0,0,0,10000,140000,-130000,-130000
056894,佳世達元大99購01,0,0,0,0,0,0,0,0,0,-130000,0,0,0,0,130000,-130000,-130000
053822,正文群益97購01  ,0,0,0,0,0,0,0,0,0,-130000,0,0,0,0,130000,-130000,-130000
06650P,聯發科元大98售09,0,0,0,0,0,0,0,0,0,-131000,0,0,0,75000,206000,-131000,-131000
053230,達方台新97購01  ,0,0,0,0,0,0,0,0,0,-131000,0,0,0,0,131000,-131000,-131000
056523,光寶科中信98購01,0,0,0,0,0,0,0,0,0,-132000,0,0,0,74000,206000,-132000,-132000
054211,奇鋐國票97購03  ,0,0,0,0,0,0,0,0,0,-132000,0,0,0,8000,140000,-132000,-132000
053658,亞光凱基96購01  ,0,0,0,0,0,0,0,0,0,-132000,0,0,0,0,132000,-132000,-132000
1319,東陽            ,591669,537000,54669,0,0,0,176000,372000,-196000,9000,25000,16000,9000,0,0,0,-132331
1536,和大            ,690000,567000,123000,0,0,0,0,250000,-250000,-6000,4000,11000,-7000,13000,12000,1000,-133000
049702,台表科元大95購03,0,0,0,0,0,0,0,0,0,-133000,0,0,0,10000,143000,-133000,-133000
05538P,玉晶光國票97售02,0,0,0,0,0,0,0,0,0,-133000,0,0,0,10000,143000,-133000,-133000
052789,台積電麥證96購01,0,0,0,0,183000,-183000,0,0,0,-133000,0,0,0,50000,183000,-133000,-133000
06978P,聯發科富邦9B售02,0,0,0,0,0,0,0,0,0,-134000,0,0,0,75000,209000,-134000,-134000
058888,元油2X元大99購16,0,0,0,0,0,0,0,0,0,-134000,0,0,0,0,134000,-134000,-134000
053728,茂林凱基97購01  ,0,0,0,0,0,0,0,0,0,-134000,0,0,0,2000,136000,-134000,-134000
058445,旺宏富邦9C購01  ,0,0,0,0,0,0,0,0,0,-135000,0,0,0,300000,435000,-135000,-135000
057478,智邦元大99購01  ,0,0,0,0,0,0,0,0,0,-136000,0,0,0,88000,224000,-136000,-136000
057097,致新元富98購01  ,0,0,0,0,0,0,0,0,0,-136000,0,0,0,58000,194000,-136000,-136000
1449,佳和            ,71000,208000,-137000,0,0,0,0,0,0,0,0,0,0,0,0,0,-137000
053587,京元電元大98購01,0,0,0,0,0,0,0,0,0,-138000,0,0,0,110000,248000,-138000,-138000
056144,GIS元大98購01   ,0,0,0,0,0,0,0,0,0,-138000,0,0,0,82000,220000,-138000,-138000
07124P,台積電元大99售21,0,0,0,0,0,0,0,0,0,-139000,0,0,0,114000,253000,-139000,-139000
058900,旺宏元大99購11  ,0,0,0,0,0,0,0,0,0,-139000,0,0,0,28000,167000,-139000,-139000
051800,旺宏永豐95購02  ,0,0,0,0,0,0,0,0,0,-139000,0,0,0,195000,334000,-139000,-139000
053105,鴻海兆豐97購01  ,0,0,0,0,0,0,0,0,0,-139000,0,0,0,0,139000,-139000,-139000
052874,超眾凱基96購01  ,0,0,0,0,0,0,0,0,0,-139000,0,0,0,0,139000,-139000,-139000
054550,旺宏凱基98購02  ,0,0,0,0,0,0,0,0,0,-139000,0,0,0,0,139000,-139000,-139000
058721,立積元富9C購01  ,0,0,0,0,0,0,0,0,0,-140000,0,0,0,45000,185000,-140000,-140000
058797,大毅元大99購03  ,0,0,0,0,0,0,0,0,0,-140000,0,0,0,54000,194000,-140000,-140000
057814,聯發科元大98購12,0,0,0,0,0,0,0,0,0,-140000,0,0,0,401000,541000,-140000,-140000
050347,上証2X群益98購01,0,0,0,0,0,0,0,0,0,-140000,0,0,0,0,140000,-140000,-140000
046906,新光金凱基99購02,0,0,0,0,0,0,0,0,0,-140000,0,0,0,0,140000,-140000,-140000
048269,瀚宇博國泰95購01,0,0,0,0,0,0,0,0,0,-140000,0,0,0,0,140000,-140000,-140000
055459,建準永豐97購03  ,0,0,0,0,0,0,0,0,0,-140000,0,0,0,10000,150000,-140000,-140000
053499,禾伸堂兆豐96購01,0,0,0,0,0,0,0,0,0,-140000,0,0,0,20000,160000,-140000,-140000
053632,新唐兆豐96購01  ,0,0,0,0,0,0,0,0,0,-140000,0,0,0,0,140000,-140000,-140000
052984,漢唐元大96購01  ,0,0,0,0,0,0,0,0,0,-140000,0,0,0,10000,150000,-140000,-140000
053339,友達國票97購02  ,0,0,0,0,0,0,0,0,0,-140000,0,0,0,0,140000,-140000,-140000
6206,飛捷            ,89000,182000,-93000,0,0,0,0,0,0,-47000,3000,50000,-47000,0,0,0,-140000
3008,大立光          ,418411,568740,-150329,0,0,0,12100,6000,6100,4000,10000,33000,-23000,30000,3000,27000,-140229
056002,嘉晶永豐97購01  ,0,0,0,0,0,0,0,0,0,-141000,0,0,0,124000,265000,-141000,-141000
057309,南茂兆豐99購01  ,0,0,0,0,0,0,0,0,0,-141000,0,0,0,110000,251000,-141000,-141000
05689P,滬深2X中信97售02,0,0,0,0,0,0,0,0,0,-141000,0,0,0,9000,150000,-141000,-141000
048573,世紀鋼元大93購05,0,0,0,0,0,0,0,0,0,-142000,0,0,0,35000,177000,-142000,-142000
055458,燿華永豐98購01  ,0,0,0,0,0,0,0,0,0,-143000,0,0,0,0,143000,-143000,-143000
050915,健策中信98購01  ,0,0,0,0,0,0,0,0,0,-143000,0,0,0,60000,203000,-143000,-143000
9934,成霖            ,265000,410000,-145000,0,0,0,0,0,0,2000,2000,0,2000,0,0,0,-143000
058948,道瓊銀群益9C購01,0,0,0,0,0,0,0,0,0,-144000,0,0,0,20000,164000,-144000,-144000
06855P,聯發科富邦9A售01,0,0,0,0,0,0,0,0,0,-144000,0,0,0,114000,258000,-144000,-144000
054122,康友永豐96購01  ,0,0,0,0,0,0,0,0,0,-144000,0,0,0,0,144000,-144000,-144000
054563,泰碩群益99購01  ,0,0,0,0,0,0,0,0,0,-144000,0,0,0,77000,221000,-144000,-144000
053371,滬深2X元大99購01,0,0,0,0,0,0,0,0,0,-144000,0,0,0,0,144000,-144000,-144000
07139P,元油2X群益9C售06,0,0,0,0,0,0,0,0,0,-145000,0,0,0,0,145000,-145000,-145000
052070,GIS兆豐95購03   ,0,0,0,0,0,0,0,0,0,-145000,0,0,0,0,145000,-145000,-145000
00714,群益道瓊美國地產,10000,0,10000,0,0,0,0,0,0,-155000,0,0,0,7000,162000,-155000,-145000
059029,旺宏兆豐99購01  ,0,0,0,0,0,0,0,0,0,-146000,0,0,0,998000,1144000,-146000,-146000
057135,立積凱基98購01  ,0,0,0,0,0,0,0,0,0,-146000,0,0,0,23000,169000,-146000,-146000
056469,國巨元大99購01  ,0,0,0,0,0,0,0,0,0,-147000,0,0,0,104000,251000,-147000,-147000
03810P,大立光富邦98售01,0,0,0,0,0,0,0,0,0,-148000,0,0,0,50000,198000,-148000,-148000
055150,台積電元大98購04,0,0,0,0,0,0,0,0,0,-149000,0,0,0,0,149000,-149000,-149000
058497,新日興群益9B購01,0,0,0,0,0,0,0,0,0,-150000,0,0,0,0,150000,-150000,-150000
057882,華通群益9A購03  ,0,0,0,0,0,0,0,0,0,-150000,0,0,0,0,150000,-150000,-150000
059139,全新兆豐9A購01  ,0,0,0,0,0,0,0,0,0,-150000,0,0,0,0,150000,-150000,-150000
047027,新光金元大95購01,0,0,0,0,0,0,0,0,0,-150000,0,0,0,0,150000,-150000,-150000
048172,祥碩永豐93購02  ,0,0,0,0,0,0,0,0,0,-150000,0,0,0,0,150000,-150000,-150000
051804,新光金日盛95購01,0,0,0,0,0,0,0,0,0,-150000,0,0,0,0,150000,-150000,-150000
052185,奇力新群益95購03,0,0,0,0,0,0,0,0,0,-150000,0,0,0,0,150000,-150000,-150000
048876,牧德國票95購02  ,0,0,0,0,0,0,0,0,0,-150000,0,0,0,0,150000,-150000,-150000
051464,彩晶國泰96購01  ,0,0,0,0,0,0,0,0,0,-150000,0,0,0,400000,550000,-150000,-150000
055092,開發金群益9B購01,0,0,0,0,0,0,0,0,0,-150000,0,0,0,0,150000,-150000,-150000
055036,中工富邦9B購01  ,0,0,0,0,0,0,0,0,0,-150000,0,0,0,0,150000,-150000,-150000
056881,台灣50康和9A購01,0,0,0,0,0,0,0,0,0,-150000,0,0,0,0,150000,-150000,-150000
054790,禾伸堂群益98購01,0,0,0,0,0,0,0,0,0,-150000,0,0,0,0,150000,-150000,-150000
056963,建準永豐98購01  ,0,0,0,0,0,0,0,0,0,-150000,0,0,0,0,150000,-150000,-150000
054863,億光群益97購01  ,0,0,0,0,0,0,0,0,0,-150000,0,0,0,0,150000,-150000,-150000
054912,群光凱基97購01  ,0,0,0,0,0,0,0,0,0,-150000,0,0,0,10000,160000,-150000,-150000
056361,美律元大99購02  ,0,0,0,0,0,0,0,0,0,-150000,0,0,0,0,150000,-150000,-150000
053638,信邦永豐96購01  ,0,0,0,0,0,0,0,0,0,-150000,0,0,0,0,150000,-150000,-150000
056653,元石油元大98購01,0,0,0,0,0,0,0,0,0,-150000,0,0,0,0,150000,-150000,-150000
055424,聚陽群益98購01  ,0,0,0,0,0,0,0,0,0,-150000,0,0,0,36000,186000,-150000,-150000
055290,玉晶光元大98購08,0,0,0,0,0,0,0,0,0,-150000,0,0,0,10000,160000,-150000,-150000
055281,台光電元大98購03,0,0,0,0,0,0,0,0,0,-150000,0,0,0,100000,250000,-150000,-150000
052629,訊芯中信99購01  ,0,0,0,0,0,0,0,0,0,-150000,0,0,0,0,150000,-150000,-150000
052969,建準群益97購01  ,0,0,0,0,0,0,0,0,0,-150000,0,0,0,0,150000,-150000,-150000
2059,川湖            ,69000,214000,-145000,0,0,0,0,0,0,-5000,3000,8000,-5000,0,0,0,-150000
06890P,金融類元大98售02,0,0,0,0,0,0,0,0,0,-151000,0,0,0,55000,206000,-151000,-151000
058489,台灣50群益9B購01,0,0,0,0,0,0,0,0,0,-151000,0,0,0,0,151000,-151000,-151000
055910,瑞昱凱基98購01  ,0,0,0,0,0,0,0,0,0,-151000,0,0,0,7000,158000,-151000,-151000
051602,南茂兆豐96購01  ,0,0,0,0,0,0,0,0,0,-151000,0,0,0,0,151000,-151000,-151000
054427,潤泰全富邦97購01,0,0,0,0,0,0,0,0,0,-151000,0,0,0,0,151000,-151000,-151000
053864,義隆元大96購01  ,0,0,0,0,0,0,0,0,0,-151000,0,0,0,14000,165000,-151000,-151000
057263,可成兆豐99購01  ,0,0,0,0,0,0,0,0,0,-151000,0,0,0,184000,335000,-151000,-151000
058189,嘉澤永豐99購01  ,0,0,0,0,0,0,0,0,0,-152000,0,0,0,0,152000,-152000,-152000
042929,台積電中信95購02,0,0,0,0,0,0,0,0,0,-152000,0,0,0,46000,198000,-152000,-152000
053765,智邦富邦96購01  ,0,0,0,0,0,0,0,0,0,-152000,0,0,0,88000,240000,-152000,-152000
058838,國巨中信99購03  ,0,0,0,0,0,0,0,0,0,-153000,0,0,0,0,153000,-153000,-153000
057385,光罩永豐99購01  ,0,0,0,0,0,0,0,0,0,-153000,0,0,0,0,153000,-153000,-153000
056872,旺宏凱基98購08  ,0,0,0,0,0,0,0,0,0,-153000,0,0,0,0,153000,-153000,-153000
055383,GIS元大97購02   ,0,0,0,0,0,0,0,0,0,-153000,0,0,0,0,153000,-153000,-153000
059119,華擎永豐99購02  ,0,0,0,0,0,0,0,0,0,-154000,0,0,0,0,154000,-154000,-154000
053817,華新科群益97購02,0,0,0,0,0,0,0,0,0,-154000,0,0,0,61000,215000,-154000,-154000
058634,可成兆豐99購03  ,0,0,0,0,0,0,0,0,0,-155000,0,0,0,0,155000,-155000,-155000
058116,正崴中信99購02  ,0,0,0,0,0,0,0,0,0,-155000,0,0,0,0,155000,-155000,-155000
057658,玉晶光兆豐99購02,0,0,0,0,0,0,0,0,0,-155000,0,0,0,0,155000,-155000,-155000
057721,華擎元富98購02  ,0,0,0,0,0,0,0,0,0,-155000,0,0,0,145000,300000,-155000,-155000
055562,欣興凱基97購06  ,0,0,0,0,0,0,0,0,0,-155000,0,0,0,0,155000,-155000,-155000
057202,TPK元富98購02   ,0,0,0,0,0,0,0,0,0,-155000,0,0,0,6000,161000,-155000,-155000
3030,德律            ,374000,496000,-122000,0,0,0,0,0,0,-33000,3000,36000,-33000,0,0,0,-155000
048831,玉晶光凱基95購01,0,0,0,0,0,0,0,0,0,-156000,0,0,0,79000,235000,-156000,-156000
9910,豐泰            ,1846200,2015453,-169253,0,0,0,2000,0,2000,11000,15000,4000,11000,0,0,0,-156253
058607,聯發科元大99購14,0,0,0,0,0,0,0,0,0,-157000,0,0,0,297000,454000,-157000,-157000
056194,聯發科富邦9B購01,0,0,0,0,0,0,0,0,0,-157000,0,0,0,1770000,1927000,-157000,-157000
057835,華擎元富9B購01  ,0,0,0,0,0,0,0,0,0,-158000,0,0,0,18000,176000,-158000,-158000
056715,瀚宇博永豐98購01,0,0,0,0,0,0,0,0,0,-158000,0,0,0,29000,187000,-158000,-158000
057640,台積電元大98購16,0,0,0,0,0,0,0,0,0,-159000,0,0,0,72000,231000,-159000,-159000
054961,玉晶光元大99購01,0,0,0,0,0,0,0,0,0,-159000,0,0,0,40000,199000,-159000,-159000
058136,景碩元大99購02  ,0,0,0,0,0,0,0,0,0,-160000,0,0,0,0,160000,-160000,-160000
051898,富邦金國泰97購01,0,0,0,0,0,0,0,0,0,-160000,0,0,0,100000,260000,-160000,-160000
00713,元大台灣高息低波,1000,48000,-47000,0,0,0,0,0,0,-113000,0,30000,-30000,10000,93000,-83000,-160000
050783,旺宏國泰96購02  ,0,0,0,0,0,0,0,0,0,-160000,0,0,0,10000,170000,-160000,-160000
057127,旺宏凱基98購09  ,0,0,0,0,0,0,0,0,0,-160000,0,0,0,10000,170000,-160000,-160000
056935,華新科元富98購02,0,0,0,0,0,0,0,0,0,-160000,0,0,0,0,160000,-160000,-160000
052627,中壽中信98購01  ,0,0,0,0,0,0,0,0,0,-160000,0,0,0,0,160000,-160000,-160000
056072,群創元大97購01  ,0,0,0,0,0,0,0,0,0,-160000,0,0,0,170000,330000,-160000,-160000
2421,建準            ,952000,1148000,-196000,0,0,0,0,0,0,36000,5000,0,5000,31000,0,31000,-160000
055541,聚陽凱基98購01  ,0,0,0,0,0,0,0,0,0,-161000,0,0,0,0,161000,-161000,-161000
050952,健策群益96購01  ,0,0,0,0,0,0,0,0,0,-161000,0,0,0,0,161000,-161000,-161000
055773,瑞昱凱基97購03  ,0,0,0,0,0,0,0,0,0,-161000,0,0,0,0,161000,-161000,-161000
051774,聯茂中信96購01  ,0,0,0,0,0,0,0,0,0,-162000,0,0,0,158000,320000,-162000,-162000
054444,緯穎台新97購01  ,0,0,0,0,0,0,0,0,0,-162000,0,0,0,125000,287000,-162000,-162000
053597,牧德元大99購01  ,0,0,0,0,0,0,0,0,0,-162000,0,0,0,91000,253000,-162000,-162000
058551,義隆永豐99購03  ,0,0,0,0,0,0,0,0,0,-163000,0,0,0,76000,239000,-163000,-163000
058549,藍天永豐99購01  ,0,0,0,0,0,0,0,0,0,-164000,0,0,0,17000,181000,-164000,-164000
051684,瑞昱凱基95購02  ,0,0,0,0,0,0,0,0,0,-164000,0,0,0,0,164000,-164000,-164000
055785,祥碩凱基97購02  ,0,0,0,0,0,0,0,0,0,-164000,0,0,0,300000,464000,-164000,-164000
050470,智邦台新94購01  ,0,0,0,0,0,0,0,0,0,-165000,0,0,0,0,165000,-165000,-165000
050262,台積電元大94購21,0,0,0,0,0,0,0,0,0,-165000,0,0,0,0,165000,-165000,-165000
056494,緯創國泰99購01  ,0,0,0,0,0,0,0,0,0,-165000,0,0,0,98000,263000,-165000,-165000
05677P,玉晶光群益98售03,0,0,0,0,0,0,0,0,0,-165000,0,0,0,419000,584000,-165000,-165000
053276,友達元大9C購01  ,0,0,0,0,0,0,0,0,0,-165000,0,0,0,0,165000,-165000,-165000
055106,台積電凱基98購05,0,0,0,0,0,0,0,0,0,-165000,0,0,0,0,165000,-165000,-165000
04751P,智邦兆豐95售02  ,0,0,0,0,0,0,0,0,0,-166000,0,0,0,72000,238000,-166000,-166000
054229,超眾元富96購05  ,0,0,0,0,0,0,0,0,0,-166000,0,0,0,0,166000,-166000,-166000
051449,玉晶光元大96購01,0,0,0,0,0,0,0,0,0,-167000,0,0,0,163000,330000,-167000,-167000
051049,亞德客群益95購01,0,0,0,0,0,0,0,0,0,-167000,0,0,0,0,167000,-167000,-167000
6197,佳必琪          ,118000,293000,-175000,0,0,0,0,0,0,8000,9000,1000,8000,0,0,0,-167000
04750P,臺股指元大94售26,0,0,0,0,0,0,0,0,0,-168000,0,0,0,1000,169000,-168000,-168000
055755,禾伸堂兆豐97購02,0,0,0,0,0,0,0,0,0,-168000,0,0,0,82000,250000,-168000,-168000
058717,南電台新99購02  ,0,0,0,0,0,0,0,0,0,-169000,0,0,0,236000,405000,-169000,-169000
052167,亞泥元大96購01  ,0,0,0,0,0,0,0,0,0,-169000,0,0,0,38000,207000,-169000,-169000
050760,矽力元富94購03  ,0,0,0,0,0,0,0,0,0,-170000,0,0,0,0,170000,-170000,-170000
050049,華通群益96購01  ,0,0,0,0,0,0,0,0,0,-170000,0,0,0,0,170000,-170000,-170000
05150P,玉晶光第一95售01,0,0,0,0,0,0,0,0,0,-170000,0,0,0,30000,200000,-170000,-170000
055535,緯創群益98購01  ,0,0,0,0,0,0,0,0,0,-170000,0,0,0,11000,181000,-170000,-170000
00653L,富邦印度正2     ,25000,26000,-1000,0,0,0,0,0,0,-169000,0,0,0,301000,470000,-169000,-170000
056787,健鼎群益98購01  ,0,0,0,0,0,0,0,0,0,-170000,0,0,0,0,170000,-170000,-170000
053469,光磊元大97購01  ,0,0,0,0,0,0,0,0,0,-170000,0,0,0,0,170000,-170000,-170000
058614,台郡元大9A購01  ,0,0,0,0,0,0,0,0,0,-172000,0,0,0,250000,422000,-172000,-172000
057743,華擎永豐98購03  ,0,0,0,0,0,0,0,0,0,-172000,0,0,0,0,172000,-172000,-172000
05999P,世芯元大96售01  ,0,0,0,0,0,0,0,0,0,-172000,0,0,0,332000,504000,-172000,-172000
056290,正文永豐98購01  ,0,0,0,0,0,0,0,0,0,-172000,0,0,0,10000,182000,-172000,-172000
05253P,智邦凱基95售08  ,0,0,0,0,0,0,0,0,0,-173000,0,0,0,0,173000,-173000,-173000
058733,同欣電永豐99購02,0,0,0,0,0,0,0,0,0,-174000,0,0,0,0,174000,-174000,-174000
057447,智邦元富02購01  ,0,0,0,0,0,0,0,0,0,-175000,0,0,0,56000,231000,-175000,-175000
1707,葡萄王          ,300000,568000,-268000,0,0,0,95000,0,95000,-2000,19000,12000,7000,0,9000,-9000,-175000
052983,國巨元大96購07  ,0,0,0,0,0,0,0,0,0,-175000,0,0,0,0,175000,-175000,-175000
053962,聯茂永豐96購01  ,0,0,0,0,0,0,0,0,0,-175000,0,0,0,138000,313000,-175000,-175000
5388,中磊            ,1114000,1109000,5000,0,0,0,0,1000,-1000,-179000,15000,202000,-187000,8000,0,8000,-175000
058815,華新科台新99購03,0,0,0,0,0,0,0,0,0,-176000,0,0,0,505000,681000,-176000,-176000
052209,深中小元大95購02,0,0,0,0,0,0,0,0,0,-176000,0,0,0,0,176000,-176000,-176000
056773,晶技元大99購03  ,0,0,0,0,0,0,0,0,0,-176000,0,0,0,0,176000,-176000,-176000
051911,大立光元大98購02,0,0,0,0,0,0,0,0,0,-177000,0,0,0,12000,189000,-177000,-177000
055359,超眾凱基97購01  ,0,0,0,0,0,0,0,0,0,-177000,0,0,0,0,177000,-177000,-177000
057364,國巨元大98購18  ,0,0,0,0,0,0,0,0,0,-178000,0,0,0,10000,188000,-178000,-178000
2351,順德            ,232000,178000,54000,0,0,0,0,52000,-52000,-180000,3000,183000,-180000,0,0,0,-178000
2231,為升            ,490000,684000,-194000,0,0,0,0,373,-373,16000,32000,16000,16000,2000,2000,0,-178373
058101,台積電富邦9C購01,0,0,0,0,0,0,0,0,0,-180000,0,0,0,0,180000,-180000,-180000
057950,T50正2元大9B購04,0,0,0,0,0,0,0,0,0,-180000,0,0,0,0,180000,-180000,-180000
050099,台積電永昌96購01,0,0,0,0,0,0,0,0,0,-180000,0,0,0,286000,466000,-180000,-180000
052172,致茂元大95購01  ,0,0,0,0,0,0,0,0,0,-180000,0,0,0,0,180000,-180000,-180000
052126,群創國票97購01  ,0,0,0,0,0,0,0,0,0,-180000,0,0,0,20000,200000,-180000,-180000
055566,台表科凱基97購03,0,0,0,0,0,0,0,0,0,-180000,0,0,0,0,180000,-180000,-180000
051366,康友國泰97購01  ,0,0,0,0,0,0,0,0,0,-180000,0,0,0,20000,200000,-180000,-180000
051396,健鼎兆豐95購01  ,0,0,0,0,0,0,0,0,0,-180000,0,0,0,0,180000,-180000,-180000
044049,元金2X元大94購03,0,0,0,0,0,0,0,0,0,-180000,0,0,0,0,180000,-180000,-180000
054426,國泰金富邦97購02,0,0,0,0,0,0,0,0,0,-180000,0,0,0,5000,185000,-180000,-180000
056402,智易群益98購02  ,0,0,0,0,0,0,0,0,0,-180000,0,0,0,30000,210000,-180000,-180000
8110,華東            ,458000,635000,-177000,0,0,0,0,0,0,-3000,48000,51000,-3000,0,0,0,-180000
046961,大立光中信95購02,0,0,0,0,0,0,0,0,0,-181000,0,0,0,40000,221000,-181000,-181000
053590,新光金元大9A購02,0,0,0,0,0,0,0,0,0,-181000,0,0,0,20000,201000,-181000,-181000
9924,福興            ,94000,261000,-167000,0,0,0,0,0,0,-14000,2000,16000,-14000,0,0,0,-181000
049477,泰鼎永豐94購01  ,0,0,0,0,0,0,0,0,0,-182000,0,0,0,0,182000,-182000,-182000
9103,美德醫療-DR     ,164000,344000,-180000,0,0,0,0,0,0,-2000,0,2000,-2000,0,0,0,-182000
050971,緯穎永豐95購01  ,0,0,0,0,0,0,0,0,0,-183000,0,0,0,120000,303000,-183000,-183000
050165,泰鼎國泰95購02  ,0,0,0,0,0,0,0,0,0,-183000,0,0,0,0,183000,-183000,-183000
058849,奇力新群益99購02,0,0,0,0,0,0,0,0,0,-184000,0,0,0,0,184000,-184000,-184000
046662,大立光元大93購14,0,0,0,0,0,0,0,0,0,-185000,0,0,0,40000,225000,-185000,-185000
053507,百和兆豐96購01  ,0,0,0,0,0,0,0,0,0,-186000,0,0,0,25000,211000,-186000,-186000
045736,台積電群益94購01,0,0,0,0,0,0,0,0,0,-187000,0,0,0,10000,197000,-187000,-187000
054335,緯穎永豐96購02  ,0,0,0,0,0,0,0,0,0,-187000,0,0,0,10000,197000,-187000,-187000
057709,電子類群益98購01,0,0,0,0,0,0,0,0,0,-188000,0,0,0,0,188000,-188000,-188000
051349,國巨元大95購08  ,0,0,0,0,0,0,0,0,0,-188000,0,0,0,0,188000,-188000,-188000
055334,禾伸堂兆豐97購01,0,0,0,0,0,0,0,0,0,-188000,0,0,0,54000,242000,-188000,-188000
4106,雃博            ,104000,242000,-138000,0,0,0,0,50000,-50000,0,0,0,0,0,0,0,-188000
058879,智邦富邦99購01  ,0,0,0,0,0,0,0,0,0,-189000,0,0,0,0,189000,-189000,-189000
053355,超眾兆豐97購01  ,0,0,0,0,0,0,0,0,0,-189000,0,0,0,0,189000,-189000,-189000
053562,玉晶光國泰98購02,0,0,0,0,0,0,0,0,0,-189000,0,0,0,405000,594000,-189000,-189000
2316,楠梓電          ,1225000,1313000,-88000,0,0,0,0,0,0,-101800,53000,147800,-94800,0,7000,-7000,-189800
058748,景碩凱基9A購01  ,0,0,0,0,0,0,0,0,0,-190000,0,0,0,10000,200000,-190000,-190000
058609,玉山金元大99購01,0,0,0,0,0,0,0,0,0,-190000,0,0,0,15000,205000,-190000,-190000
052441,亞泥元大95購01  ,0,0,0,0,0,0,0,0,0,-190000,0,0,0,10000,200000,-190000,-190000
054522,康友元大96購07  ,0,0,0,0,0,0,0,0,0,-190000,0,0,0,10000,200000,-190000,-190000
057302,福懋科中信98購01,0,0,0,0,0,0,0,0,0,-190000,0,0,0,10000,200000,-190000,-190000
055163,訊芯元大98購01  ,0,0,0,0,0,0,0,0,0,-190000,0,0,0,0,190000,-190000,-190000
056857,國巨群益99購02  ,0,0,0,0,0,0,0,0,0,-190000,0,0,0,120000,310000,-190000,-190000
05266P,華新科元大95售11,0,0,0,0,0,0,0,0,0,-190000,0,0,0,156000,346000,-190000,-190000
055307,瑞昱群益97購02  ,0,0,0,0,0,0,0,0,0,-190000,0,0,0,0,190000,-190000,-190000
056491,南亞科國泰99購01,0,0,0,0,0,0,0,0,0,-190000,0,0,0,50000,240000,-190000,-190000
047689,瑞昱富邦97購01  ,0,0,0,0,0,0,0,0,0,-191000,0,0,0,0,191000,-191000,-191000
06748P,智邦台新98售02  ,0,0,0,0,0,0,0,0,0,-192000,0,0,0,59000,251000,-192000,-192000
050383,超眾兆豐95購01  ,0,0,0,0,0,0,0,0,0,-192000,0,0,0,0,192000,-192000,-192000
052025,國巨群益96購01  ,0,0,0,0,0,0,0,0,0,-192000,0,0,0,0,192000,-192000,-192000
059132,臺股指群益99購07,0,0,0,0,0,0,0,0,0,-193000,0,0,0,0,193000,-193000,-193000
052045,瑞昱凱基96購01  ,0,0,0,0,0,0,0,0,0,-193000,0,0,0,0,193000,-193000,-193000
051807,瑞昱凱基95購03  ,0,0,0,0,0,0,0,0,0,-193000,0,0,0,0,193000,-193000,-193000
054356,可成兆豐97購01  ,0,0,0,0,0,0,0,0,0,-193000,0,0,0,62000,255000,-193000,-193000
054944,精元元大97購01  ,0,0,0,0,0,0,0,0,0,-193000,0,0,0,12000,205000,-193000,-193000
057557,聯茂凱基99購04  ,0,0,0,0,0,0,0,0,0,-194000,0,0,0,19000,213000,-194000,-194000
058229,為升元大99購02  ,0,0,0,0,0,0,0,0,0,-195000,0,0,0,20000,215000,-195000,-195000
053494,南亞科兆豐96購02,0,0,0,0,0,0,0,0,0,-195000,0,0,0,0,195000,-195000,-195000
053760,牧德國泰98購01  ,0,0,0,0,0,0,0,0,0,-195000,0,0,0,127000,322000,-195000,-195000
058211,國巨群益9A購02  ,0,0,0,0,0,0,0,0,0,-196000,0,0,0,0,196000,-196000,-196000
058665,台灣50群益9B購02,0,0,0,0,0,0,0,0,0,-196000,0,0,0,10000,206000,-196000,-196000
059127,國巨中信99購04  ,0,0,0,0,0,0,0,0,0,-196000,0,0,0,0,196000,-196000,-196000
052069,聯茂兆豐96購01  ,0,0,0,0,0,0,0,0,0,-196000,0,0,0,74000,270000,-196000,-196000
1902,台紙            ,178000,375000,-197000,0,0,0,0,0,0,0,0,0,0,0,0,0,-197000
055671,世紀鋼群益97購01,0,0,0,0,0,0,0,0,0,-197000,0,0,0,13000,210000,-197000,-197000
053734,友達中信98購02  ,0,0,0,0,0,0,0,0,0,-197000,0,0,0,23000,220000,-197000,-197000
053687,智邦元大96購02  ,0,0,0,0,0,0,0,0,0,-198000,0,0,0,241000,439000,-198000,-198000
056096,超眾元富9A購01  ,0,0,0,0,0,0,0,0,0,-198000,0,0,0,20000,218000,-198000,-198000
058446,新光金富邦9C購01,0,0,0,0,0,0,0,0,0,-199000,0,0,0,12000,211000,-199000,-199000
050100,台積電永昌96購02,0,0,0,0,0,0,0,0,0,-199000,0,0,0,14000,213000,-199000,-199000
050519,旺宏元大95購03  ,0,0,0,0,0,0,0,0,0,-199000,0,0,0,40000,239000,-199000,-199000
055387,世紀鋼元大97購01,0,0,0,0,0,0,0,0,0,-199000,0,0,0,61000,260000,-199000,-199000
2006,東和鋼鐵        ,153000,537000,-384000,0,0,0,178000,0,178000,7000,8000,1000,7000,0,0,0,-199000
058769,友達兆豐99購01  ,0,0,0,0,0,0,0,0,0,-200000,0,0,0,0,200000,-200000,-200000
058820,致茂國泰9B購01  ,0,0,0,0,0,0,0,0,0,-200000,0,0,0,0,200000,-200000,-200000
057627,和大永豐98購01  ,0,0,0,0,0,0,0,0,0,-200000,0,0,0,0,200000,-200000,-200000
057502,訊芯群益98購02  ,0,0,0,0,0,0,0,0,0,-200000,0,0,0,0,200000,-200000,-200000
057859,神達康和98購01  ,0,0,0,0,0,0,0,0,0,-200000,0,0,0,0,200000,-200000,-200000
07108P,FBVIX台新99售02 ,0,0,0,0,0,0,0,0,0,-200000,0,0,0,0,200000,-200000,-200000
047482,新光金凱基99購03,0,0,0,0,0,0,0,0,0,-200000,0,0,0,0,200000,-200000,-200000
050204,華新科群益94購05,0,0,0,0,0,0,0,0,0,-200000,0,0,0,0,200000,-200000,-200000
050187,群創元大94購03  ,0,0,0,0,0,0,0,0,0,-200000,0,0,0,0,200000,-200000,-200000
048819,國巨凱基94購01  ,0,0,0,0,0,0,0,0,0,-200000,0,0,0,60000,260000,-200000,-200000
051910,大立光元大97購01,0,0,0,0,0,0,0,0,0,-200000,0,0,0,0,200000,-200000,-200000
052112,滬深2X中信99購01,0,0,0,0,0,0,0,0,0,-200000,0,0,0,0,200000,-200000,-200000
051050,鴻海群益95購03  ,0,0,0,0,0,0,0,0,0,-200000,0,0,0,0,200000,-200000,-200000
051365,瀚宇博國泰97購01,0,0,0,0,0,0,0,0,0,-200000,0,0,0,0,200000,-200000,-200000
054236,貿聯群益96購01  ,0,0,0,0,0,0,0,0,0,-200000,0,0,0,0,200000,-200000,-200000
056500,大立光富邦9B購02,0,0,0,0,0,0,0,0,0,-200000,0,0,0,0,200000,-200000,-200000
056634,為升兆豐99購01  ,0,0,0,0,0,0,0,0,0,-200000,0,0,0,10000,210000,-200000,-200000
056224,聯發科凱基97購08,0,0,0,0,0,0,0,0,0,-200000,0,0,0,0,200000,-200000,-200000
053299,台泥凱基96購01  ,0,0,0,0,0,0,0,0,0,-200000,0,0,0,0,200000,-200000,-200000
056820,欣興永豐98購02  ,0,0,0,0,0,0,0,0,0,-200000,0,0,0,0,200000,-200000,-200000
054381,世芯群益98購01  ,0,0,0,0,0,0,0,0,0,-200000,0,0,0,0,200000,-200000,-200000
054143,茂林元大96購04  ,0,0,0,0,0,0,0,0,0,-200000,0,0,0,10000,210000,-200000,-200000
052386,鴻海群益96購02  ,0,0,0,0,0,0,0,0,0,-200000,0,0,0,100000,300000,-200000,-200000
03435B,臺股指凱基99熊29,0,0,0,0,0,0,0,0,0,-201000,0,0,0,0,201000,-201000,-201000
045572,元油2X元大98購01,0,0,0,0,0,0,0,0,0,-202000,0,0,0,0,202000,-202000,-202000
053402,A50正2群益9A購02,0,0,0,0,0,0,0,0,0,-202000,0,0,0,27000,229000,-202000,-202000
058504,台積電元大99購07,0,0,0,0,0,0,0,0,0,-203000,0,0,0,7000,210000,-203000,-203000
051618,智邦凱基95購06  ,0,0,0,0,0,0,0,0,0,-203000,0,0,0,79000,282000,-203000,-203000
059003,中壽元大99購01  ,0,0,0,0,0,0,0,0,0,-204000,0,0,0,10000,214000,-204000,-204000
057732,牧德國泰9A購01  ,0,0,0,0,0,0,0,0,0,-204000,0,0,0,0,204000,-204000,-204000
052742,可成元大96購01  ,0,0,0,0,0,0,0,0,0,-204000,0,0,0,11000,215000,-204000,-204000
052387,台積電群益95購08,0,0,0,0,0,0,0,0,0,-204000,0,0,0,45000,249000,-204000,-204000
053493,智邦兆豐97購02  ,0,0,0,0,0,0,0,0,0,-204000,0,0,0,0,204000,-204000,-204000
2480,敦陽科          ,222000,353000,-131000,0,0,0,0,0,0,-73000,2000,75000,-73000,0,0,0,-204000
1464,得力            ,184000,277000,-93000,0,0,0,0,0,0,-112000,0,112000,-112000,0,0,0,-205000
051451,世芯元大95購03  ,0,0,0,0,0,0,0,0,0,-205000,0,0,0,50000,255000,-205000,-205000
057266,TPK兆豐98購02   ,0,0,0,0,0,0,0,0,0,-205000,0,0,0,33000,238000,-205000,-205000
056508,揚明光永豐98購01,0,0,0,0,0,0,0,0,0,-205000,0,0,0,10000,215000,-205000,-205000
057782,台積電國票99購07,0,0,0,0,0,0,0,0,0,-206000,0,0,0,0,206000,-206000,-206000
054277,亞光群益97購01  ,0,0,0,0,0,0,0,0,0,-206000,0,0,0,94000,300000,-206000,-206000
052689,玉晶光元大98購03,0,0,0,0,0,0,0,0,0,-207000,0,0,0,10000,217000,-207000,-207000
3682,亞太電          ,905000,1118000,-213000,0,0,0,0,0,0,6000,6000,0,6000,0,0,0,-207000
05542P,滬深2X元富96售01,0,0,0,0,0,0,0,0,0,-208000,0,0,0,0,208000,-208000,-208000
054421,臺股指元大99購03,0,0,0,0,0,0,0,0,0,-208000,0,0,0,285000,493000,-208000,-208000
057288,聯茂元大98購03  ,0,0,0,0,0,0,0,0,0,-208000,0,0,0,20000,228000,-208000,-208000
057093,臻鼎元富98購02  ,0,0,0,0,0,0,0,0,0,-208000,0,0,0,329000,537000,-208000,-208000
055124,建準兆豐97購01  ,0,0,0,0,0,0,0,0,0,-208000,0,0,0,50000,258000,-208000,-208000
053445,可成凱基96購04  ,0,0,0,0,0,0,0,0,0,-208000,0,0,0,0,208000,-208000,-208000
057980,聯詠永豐98購01  ,0,0,0,0,0,0,0,0,0,-209000,0,0,0,0,209000,-209000,-209000
058664,百和兆豐99購01  ,0,0,0,0,0,0,0,0,0,-209000,0,0,0,25000,234000,-209000,-209000
059002,聯發科元大99購18,0,0,0,0,0,0,0,0,0,-210000,0,0,0,105000,315000,-210000,-210000
049140,台積電元大94購07,0,0,0,0,0,0,0,0,0,-210000,0,0,0,0,210000,-210000,-210000
056745,聯茂凱基99購03  ,0,0,0,0,0,0,0,0,0,-210000,0,0,0,3000,213000,-210000,-210000
056734,國巨凱基99購01  ,0,0,0,0,0,0,0,0,0,-210000,0,0,0,0,210000,-210000,-210000
054281,世芯群益97購01  ,0,0,0,0,0,0,0,0,0,-210000,0,0,0,0,210000,-210000,-210000
056128,和大中信99購01  ,0,0,0,0,0,0,0,0,0,-210000,0,0,0,0,210000,-210000,-210000
056487,康友元大98購01  ,0,0,0,0,0,0,0,0,0,-210000,0,0,0,10000,220000,-210000,-210000
057456,道瓊銀富邦9C購01,0,0,0,0,0,0,0,0,0,-211000,0,0,0,30000,241000,-211000,-211000
048551,鴻海元大94購02  ,0,0,0,0,0,0,0,0,0,-211000,0,0,0,31000,242000,-211000,-211000
056783,國巨群益99購01  ,0,0,0,0,0,0,0,0,0,-212000,0,0,0,0,212000,-212000,-212000
054363,世芯凱基97購01  ,0,0,0,0,0,0,0,0,0,-212000,0,0,0,107000,319000,-212000,-212000
053491,鴻海兆豐97購02  ,0,0,0,0,0,0,0,0,0,-212000,0,0,0,0,212000,-212000,-212000
057431,京鼎兆豐98購02  ,0,0,0,0,0,0,0,0,0,-213000,0,0,0,60000,273000,-213000,-213000
03635C,滬深2X元富99牛01,0,0,0,0,0,0,0,0,0,-213000,0,0,0,101000,314000,-213000,-213000
054637,智邦中信98購01  ,0,0,0,0,0,0,0,0,0,-213000,0,0,0,0,213000,-213000,-213000
058454,嘉晶永豐99購01  ,0,0,0,0,0,0,0,0,0,-215000,0,0,0,40000,255000,-215000,-215000
049004,聯發科中信96購01,0,0,0,0,0,0,0,0,0,-215000,0,0,0,0,215000,-215000,-215000
054380,世芯群益97購02  ,0,0,0,0,0,0,0,0,0,-215000,0,0,0,0,215000,-215000,-215000
049141,旺宏元大95購01  ,0,0,0,0,0,0,0,0,0,-216000,0,0,0,40000,256000,-216000,-216000
049478,祥碩永豐94購02  ,0,0,0,0,0,0,0,0,0,-217000,0,0,0,0,217000,-217000,-217000
056135,緯創元大98購01  ,0,0,0,0,0,0,0,0,0,-217000,0,0,0,10000,227000,-217000,-217000
053880,智邦中信96購01  ,0,0,0,0,0,0,0,0,0,-217000,0,0,0,10000,227000,-217000,-217000
053888,和大群益97購01  ,0,0,0,0,0,0,0,0,0,-217000,0,0,0,44000,261000,-217000,-217000
053293,聯發科中信9B購01,0,0,0,0,0,0,0,0,0,-218000,0,0,0,0,218000,-218000,-218000
6592,和潤企業        ,221000,439000,-218000,0,0,0,0,0,0,0,0,0,0,0,0,0,-218000
052965,廣宇群益97購01  ,0,0,0,0,0,0,0,0,0,-219000,0,0,0,0,219000,-219000,-219000
4119,旭富            ,466000,659000,-193000,0,0,0,13000,0,13000,-39000,20000,48000,-28000,15000,26000,-11000,-219000
051694,A50正2中信96購03,0,0,0,0,0,0,0,0,0,-220000,0,0,0,200000,420000,-220000,-220000
055523,道瓊銀群益9A購01,0,0,0,0,0,0,0,0,0,-220000,0,0,0,0,220000,-220000,-220000
052919,鈺齊富邦98購01  ,0,0,0,0,0,0,0,0,0,-220000,0,0,0,0,220000,-220000,-220000
052756,國巨群益96購02  ,0,0,0,0,0,0,0,0,0,-220000,0,0,0,0,220000,-220000,-220000
053185,友達中信99購01  ,0,0,0,0,0,0,0,0,0,-220000,0,0,0,0,220000,-220000,-220000
054248,燿華元大97購02  ,0,0,0,0,0,0,0,0,0,-220000,0,0,0,10000,230000,-220000,-220000
053677,同欣電國泰97購01,0,0,0,0,0,0,0,0,0,-220000,0,0,0,98000,318000,-220000,-220000
053503,臻鼎兆豐97購01  ,0,0,0,0,0,0,0,0,0,-220000,0,0,0,440000,660000,-220000,-220000
058824,晶技富邦9A購01  ,0,0,0,0,0,0,0,0,0,-221000,0,0,0,0,221000,-221000,-221000
050334,鴻海國泰96購07  ,0,0,0,0,0,0,0,0,0,-221000,0,0,0,480000,701000,-221000,-221000
058905,京鼎元大99購01  ,0,0,0,0,0,0,0,0,0,-222000,0,0,0,0,222000,-222000,-222000
052795,健策兆豐97購01  ,0,0,0,0,0,0,0,0,0,-222000,0,0,0,0,222000,-222000,-222000
9105,泰金寶-DR       ,535000,757000,-222000,0,0,0,0,0,0,0,0,0,0,0,0,0,-222000
2905,三商            ,220000,442229,-222229,0,0,0,0,0,0,0,0,0,0,0,0,0,-222229
051157,華新科富邦98購01,0,0,0,0,0,0,0,0,0,-223000,0,0,0,0,223000,-223000,-223000
054716,緯穎康和97購01  ,0,0,0,0,0,0,0,0,0,-223000,0,0,0,168000,391000,-223000,-223000
052418,玉晶光兆豐96購01,0,0,0,0,0,0,0,0,0,-223000,0,0,0,9000,232000,-223000,-223000
057307,瀚宇博兆豐99購01,0,0,0,0,0,0,0,0,0,-224000,0,0,0,167000,391000,-224000,-224000
059028,嘉聯益台新99購02,0,0,0,0,0,0,0,0,0,-225000,0,0,0,0,225000,-225000,-225000
058727,嘉晶富邦9A購01  ,0,0,0,0,0,0,0,0,0,-225000,0,0,0,175000,400000,-225000,-225000
057575,世紀鋼永豐98購02,0,0,0,0,0,0,0,0,0,-225000,0,0,0,0,225000,-225000,-225000
057945,京鼎國票99購03  ,0,0,0,0,0,0,0,0,0,-225000,0,0,0,0,225000,-225000,-225000
1313,聯成            ,284000,509000,-225000,0,0,0,0,0,0,0,0,0,0,0,0,0,-225000
06971P,台光電元大99售03,0,0,0,0,0,0,0,0,0,-225000,0,0,0,3000,228000,-225000,-225000
051982,深中小元大95購01,0,0,0,0,0,0,0,0,0,-225000,0,0,0,20000,245000,-225000,-225000
053041,可成凱基96購02  ,0,0,0,0,0,0,0,0,0,-225000,0,0,0,0,225000,-225000,-225000
056592,台積電元富98購01,0,0,0,0,0,0,0,0,0,-226000,0,0,0,284000,510000,-226000,-226000
3023,信邦            ,1282000,1510000,-228000,0,0,0,62000,0,62000,-60000,10000,63000,-53000,0,7000,-7000,-226000
059219,旺宏元大99購12  ,0,0,0,0,0,0,0,0,0,-227000,0,0,0,0,227000,-227000,-227000
056333,台積電日盛9B購01,0,0,0,0,0,0,0,0,0,-228000,0,0,0,160000,388000,-228000,-228000
056386,TPK國泰99購01   ,0,0,0,0,0,0,0,0,0,-228000,0,0,0,22000,250000,-228000,-228000
053353,玉晶光兆豐97購03,0,0,0,0,0,0,0,0,0,-229000,0,0,0,10000,239000,-229000,-229000
06454P,緯穎元大98售04  ,0,0,0,0,0,0,0,0,0,-230000,0,0,0,506000,736000,-230000,-230000
058086,鴻海元大98購14  ,0,0,0,0,0,0,0,0,0,-230000,0,0,0,29000,259000,-230000,-230000
03626P,可成兆豐93售03  ,0,0,0,0,0,0,0,0,0,-230000,0,0,0,0,230000,-230000,-230000
053318,全新群益99購01  ,0,0,0,0,0,0,0,0,0,-230000,0,0,0,0,230000,-230000,-230000
055294,智易元大98購01  ,0,0,0,0,0,0,0,0,0,-230000,0,0,0,0,230000,-230000,-230000
057315,台灣50康和9A購03,0,0,0,0,0,0,0,0,0,-230000,0,0,0,0,230000,-230000,-230000
057289,力成元大98購03  ,0,0,0,0,0,0,0,0,0,-230000,0,0,0,0,230000,-230000,-230000
054456,華泰群益99購01  ,0,0,0,0,0,0,0,0,0,-230000,0,0,0,0,230000,-230000,-230000
06394P,台積電元大97售28,0,0,0,0,0,0,0,0,0,-232000,0,0,0,78000,310000,-232000,-232000
053120,復盛中信9A購01  ,0,0,0,0,0,0,0,0,0,-232000,0,0,0,0,232000,-232000,-232000
056157,聯詠凱基97購03  ,0,0,0,0,0,0,0,0,0,-234000,0,0,0,0,234000,-234000,-234000
058443,T50正2富邦01購01,0,0,0,0,0,0,0,0,0,-235000,0,0,0,0,235000,-235000,-235000
056603,嘉聯益國泰9A購01,0,0,0,0,0,0,0,0,0,-236000,0,0,0,10000,246000,-236000,-236000
054371,台積電中信9C購01,0,0,0,0,0,0,0,0,0,-237000,0,0,0,0,237000,-237000,-237000
055429,華新科群益99購01,0,0,0,0,0,0,0,0,0,-238000,0,0,0,12000,250000,-238000,-238000
1218,泰山            ,182000,373000,-191000,0,0,0,0,0,0,-48000,0,48000,-48000,0,0,0,-239000
051843,聯發科富邦99購01,0,0,0,0,0,0,0,0,0,-240000,0,0,0,25000,265000,-240000,-240000
1701,中化            ,173000,385000,-212000,0,0,0,0,0,0,-29000,1000,30000,-29000,0,0,0,-241000
050057,國巨凱基94購05  ,0,0,0,0,0,0,0,0,0,-241000,0,0,0,0,241000,-241000,-241000
051576,台積電元大97購02,0,0,0,0,0,0,0,0,0,-242000,0,0,0,0,242000,-242000,-242000
050645,台積電凱基94購39,0,0,0,0,0,0,0,0,0,-244000,0,0,0,50000,294000,-244000,-244000
057798,貿聯兆豐99購01  ,0,0,0,0,0,0,0,0,0,-245000,0,0,0,0,245000,-245000,-245000
051245,南亞科元大95購01,0,0,0,0,0,0,0,0,0,-245000,0,0,0,0,245000,-245000,-245000
055376,群創元大01購01  ,0,0,0,0,0,0,0,0,0,-245000,0,0,0,61000,306000,-245000,-245000
056542,緯創凱基98購01  ,0,0,0,0,0,0,0,0,0,-245000,0,0,0,15000,260000,-245000,-245000
2607,榮運            ,105000,355000,-250000,0,0,0,0,0,0,5000,6000,1000,5000,0,0,0,-245000
1590,亞德客-KY       ,1573564,2179407,-605843,0,0,0,375000,0,375000,-15000,30000,26000,4000,14000,33000,-19000,-245843
056705,超眾國泰99購01  ,0,0,0,0,0,0,0,0,0,-246000,0,0,0,23000,269000,-246000,-246000
046937,聯電元大99購01  ,0,0,0,0,0,0,0,0,0,-247000,0,0,0,102000,349000,-247000,-247000
047521,台積電元大94購03,0,0,0,0,0,0,0,0,0,-248000,0,0,0,2000,250000,-248000,-248000
8021,尖點            ,224000,477000,-253000,0,0,0,0,0,0,4000,4000,0,4000,0,0,0,-249000
058857,元油2X日盛99購02,0,0,0,0,0,0,0,0,0,-250000,0,0,0,0,250000,-250000,-250000
051897,台光電國泰97購01,0,0,0,0,0,0,0,0,0,-250000,0,0,0,0,250000,-250000,-250000
051346,仁寶元大95購01  ,0,0,0,0,0,0,0,0,0,-250000,0,0,0,0,250000,-250000,-250000
051552,牧德永豐95購03  ,0,0,0,0,0,0,0,0,0,-250000,0,0,0,33000,283000,-250000,-250000
054644,A50正2群益9B購01,0,0,0,0,0,0,0,0,0,-250000,0,0,0,0,250000,-250000,-250000
057099,元油2X中信9B購03,0,0,0,0,0,0,0,0,0,-250000,0,0,0,0,250000,-250000,-250000
055201,興勤群益98購01  ,0,0,0,0,0,0,0,0,0,-250000,0,0,0,0,250000,-250000,-250000
059163,台積電凱基99購10,0,0,0,0,0,0,0,0,0,-251000,0,0,0,0,251000,-251000,-251000
056011,矽力中信99購01  ,0,0,0,0,0,0,0,0,0,-251000,0,0,0,94000,345000,-251000,-251000
056906,玉晶光元大9B購01,0,0,0,0,0,0,0,0,0,-251000,0,0,0,15000,266000,-251000,-251000
055804,祥碩永豐97購02  ,0,0,0,0,0,0,0,0,0,-251000,0,0,0,1000,252000,-251000,-251000
046050,臺股指元大93購20,0,0,0,0,0,0,0,0,0,-252000,0,0,0,0,252000,-252000,-252000
054921,文曄凱基97購01  ,0,0,0,0,0,0,0,0,0,-252000,0,0,0,1000,253000,-252000,-252000
2461,光群雷          ,199000,456000,-257000,0,0,0,0,0,0,4000,4000,0,4000,0,0,0,-253000
055408,力成國泰98購01  ,0,0,0,0,0,0,0,0,0,-254000,0,0,0,0,254000,-254000,-254000
058320,華新科永豐99購02,0,0,0,0,0,0,0,0,0,-255000,0,0,0,15000,270000,-255000,-255000
055923,矽力凱基98購01  ,0,0,0,0,0,0,0,0,0,-255000,0,0,0,0,255000,-255000,-255000
046942,友達元大99購01  ,0,0,0,0,0,0,0,0,0,-257000,0,0,0,140000,397000,-257000,-257000
058935,元油2X中信9C購03,0,0,0,0,0,0,0,0,0,-258000,0,0,0,5000,263000,-258000,-258000
049254,台積電元大96購02,0,0,0,0,0,0,0,0,0,-258000,0,0,0,155000,413000,-258000,-258000
057303,喬山兆豐99購01  ,0,0,0,0,0,0,0,0,0,-259000,0,0,0,104000,363000,-259000,-259000
058442,玉晶光台新99購01,0,0,0,0,0,0,0,0,0,-260000,0,0,0,0,260000,-260000,-260000
058565,鴻海凱基9A購07  ,0,0,0,0,0,0,0,0,0,-260000,0,0,0,62000,322000,-260000,-260000
07154P,台灣50群益94售01,0,0,0,0,0,0,0,0,0,-260000,0,0,0,0,260000,-260000,-260000
049946,智邦兆豐95購01  ,0,0,0,0,0,0,0,0,0,-260000,0,0,0,0,260000,-260000,-260000
057267,康控兆豐99購01  ,0,0,0,0,0,0,0,0,0,-260000,0,0,0,20000,280000,-260000,-260000
057038,元油2X元大9B購06,0,0,0,0,0,0,0,0,0,-260000,0,0,0,0,260000,-260000,-260000
055079,台光電中信97購01,0,0,0,0,0,0,0,0,0,-260000,0,0,0,0,260000,-260000,-260000
00730,富邦臺灣優質高息,5000,0,5000,0,0,0,0,0,0,-266000,0,0,0,213000,479000,-266000,-261000
04854P,鴻海國泰96售04  ,0,0,0,0,0,0,0,0,0,-262000,0,0,0,0,262000,-262000,-262000
054572,國巨元大98購03  ,0,0,0,0,0,0,0,0,0,-262000,0,0,0,0,262000,-262000,-262000
058597,瑞昱台新99購01  ,0,0,0,0,0,0,0,0,0,-263000,0,0,0,58000,321000,-263000,-263000
056318,鴻海群益98購02  ,0,0,0,0,0,0,0,0,0,-263000,0,0,0,6000,269000,-263000,-263000
053304,可成凱基96購03  ,0,0,0,0,0,0,0,0,0,-263000,0,0,0,0,263000,-263000,-263000
058861,國巨凱基9A購08  ,0,0,0,0,0,0,0,0,0,-264000,0,0,0,0,264000,-264000,-264000
058771,神達兆豐99購01  ,0,0,0,0,0,0,0,0,0,-265000,0,0,0,0,265000,-265000,-265000
058966,元油2X日盛99購03,0,0,0,0,0,0,0,0,0,-265000,0,0,0,0,265000,-265000,-265000
046949,群創元大99購01  ,0,0,0,0,0,0,0,0,0,-265000,0,0,0,400000,665000,-265000,-265000
051562,玉晶光國泰97購05,0,0,0,0,0,0,0,0,0,-265000,0,0,0,5000,270000,-265000,-265000
057562,奇鋐兆豐98購01  ,0,0,0,0,0,0,0,0,0,-266000,0,0,0,150000,416000,-266000,-266000
058303,華通元大99購03  ,0,0,0,0,0,0,0,0,0,-268000,0,0,0,79000,347000,-268000,-268000
058964,群創兆豐99購01  ,0,0,0,0,0,0,0,0,0,-268000,0,0,0,998000,1266000,-268000,-268000
052476,台光電群益98購01,0,0,0,0,0,0,0,0,0,-269000,0,0,0,12000,281000,-269000,-269000
058997,鴻海元大99購21  ,0,0,0,0,0,0,0,0,0,-270000,0,0,0,203000,473000,-270000,-270000
051011,國巨凱基95購03  ,0,0,0,0,0,0,0,0,0,-270000,0,0,0,0,270000,-270000,-270000
055970,聯茂元大97購04  ,0,0,0,0,0,0,0,0,0,-270000,0,0,0,0,270000,-270000,-270000
049909,國巨元大95購01  ,0,0,0,0,0,0,0,0,0,-270000,0,0,0,0,270000,-270000,-270000
057675,同欣電元大98購02,0,0,0,0,0,0,0,0,0,-271000,0,0,0,13000,284000,-271000,-271000
1609,大亞            ,720000,995000,-275000,0,0,0,5000,0,5000,-1000,60000,61000,-1000,0,0,0,-271000
050799,嘉聯益中信98購01,0,0,0,0,0,0,0,0,0,-271000,0,0,0,0,271000,-271000,-271000
057380,技嘉國泰9A購01  ,0,0,0,0,0,0,0,0,0,-271000,0,0,0,0,271000,-271000,-271000
053860,台積電元大98購03,0,0,0,0,0,0,0,0,0,-272000,0,0,0,0,272000,-272000,-272000
053258,上証2X群益9A購03,0,0,0,0,0,0,0,0,0,-275000,0,0,0,85000,360000,-275000,-275000
058686,祥碩凱基99購03  ,0,0,0,0,0,0,0,0,0,-277000,0,0,0,280000,557000,-277000,-277000
055583,國巨元大97購10  ,0,0,0,0,0,0,0,0,0,-277000,0,0,0,0,277000,-277000,-277000
058337,日月光元富99購01,0,0,0,0,0,0,0,0,0,-280000,0,0,0,0,280000,-280000,-280000
058094,祥碩元大98購09  ,0,0,0,0,0,0,0,0,0,-280000,0,0,0,258000,538000,-280000,-280000
051596,超眾元大95購05  ,0,0,0,0,0,0,0,0,0,-280000,0,0,0,0,280000,-280000,-280000
052546,友達中信98購01  ,0,0,0,0,0,0,0,0,0,-280000,0,0,0,40000,320000,-280000,-280000
5534,長虹            ,144098,428000,-283902,0,0,0,0,0,0,3000,36000,33000,3000,0,0,0,-280902
058518,玉晶光元大99購13,0,0,0,0,0,0,0,0,0,-281000,0,0,0,20000,301000,-281000,-281000
049659,旺宏台新95購01  ,0,0,0,0,0,0,0,0,0,-281000,0,0,0,0,281000,-281000,-281000
059062,群創凱基99購05  ,0,0,0,0,0,0,0,0,0,-282000,0,0,0,18000,300000,-282000,-282000
055411,國巨富邦9A購02  ,0,0,0,0,0,0,0,0,0,-283000,0,0,0,0,283000,-283000,-283000
058542,T50反1富邦9B購01,0,0,0,0,0,0,0,0,0,-284000,0,0,0,20000,304000,-284000,-284000
058451,智邦永豐9A購01  ,0,0,0,0,0,0,0,0,0,-284000,0,0,0,111000,395000,-284000,-284000
052750,臺股指元大96購04,0,0,0,0,0,0,0,0,0,-284000,0,0,0,0,284000,-284000,-284000
058943,元石油群益9C購01,0,0,0,0,0,0,0,0,0,-285000,0,0,0,115000,400000,-285000,-285000
058214,世芯群益9A購01  ,0,0,0,0,0,0,0,0,0,-285000,0,0,0,0,285000,-285000,-285000
048575,旺宏國泰94購04  ,0,0,0,0,0,0,0,0,0,-285000,0,0,0,0,285000,-285000,-285000
052771,GIS群益96購01   ,0,0,0,0,0,0,0,0,0,-285000,0,0,0,5000,290000,-285000,-285000
6005,群益證          ,753000,1049000,-296000,0,0,0,9000,0,9000,0,0,0,0,0,0,0,-287000
2328,廣宇            ,602000,857000,-255000,0,0,0,0,0,0,-32000,76000,108000,-32000,0,0,0,-287000
051038,健策台新95購01  ,0,0,0,0,0,0,0,0,0,-288000,0,0,0,30000,318000,-288000,-288000
058528,世紀鋼元大99購02,0,0,0,0,0,0,0,0,0,-289000,0,0,0,229000,518000,-289000,-289000
058660,樺漢中信9A購01  ,0,0,0,0,0,0,0,0,0,-289000,0,0,0,68000,357000,-289000,-289000
07074P,FBVIX凱基9A售01 ,0,0,0,0,0,0,0,0,0,-289000,0,0,0,0,289000,-289000,-289000
050398,上証2X中信97購01,0,0,0,0,0,0,0,0,0,-289000,0,0,0,0,289000,-289000,-289000
046944,奇力新元大96購01,0,0,0,0,0,0,0,0,0,-290000,0,0,0,52000,342000,-290000,-290000
049434,茂林國票95購01  ,0,0,0,0,0,0,0,0,0,-290000,0,0,0,0,290000,-290000,-290000
052524,新光金元大9B購01,0,0,0,0,0,0,0,0,0,-290000,0,0,0,0,290000,-290000,-290000
055414,奇力新富邦9B購01,0,0,0,0,0,0,0,0,0,-290000,0,0,0,20000,310000,-290000,-290000
054579,聯茂元大97購01  ,0,0,0,0,0,0,0,0,0,-290000,0,0,0,0,290000,-290000,-290000
1217,愛之味          ,147000,438000,-291000,0,0,0,0,0,0,0,0,0,0,0,0,0,-291000
058530,為升元富99購01  ,0,0,0,0,0,0,0,0,0,-291000,0,0,0,136000,427000,-291000,-291000
058505,台積電元大99購08,0,0,0,0,0,0,0,0,0,-291000,0,0,0,50000,341000,-291000,-291000
058074,欣興凱基99購01  ,0,0,0,0,0,0,0,0,0,-292000,0,0,0,0,292000,-292000,-292000
049706,世紀鋼元大95購02,0,0,0,0,0,0,0,0,0,-292000,0,0,0,346000,638000,-292000,-292000
056363,華新科元大99購04,0,0,0,0,0,0,0,0,0,-292000,0,0,0,60000,352000,-292000,-292000
058267,奇鋐永豐99購01  ,0,0,0,0,0,0,0,0,0,-296000,0,0,0,0,296000,-296000,-296000
058974,臺股指永豐99購03,0,0,0,0,0,0,0,0,0,-296000,0,0,0,0,296000,-296000,-296000
051780,矽力群益95購01  ,0,0,0,0,0,0,0,0,0,-296000,0,0,0,0,296000,-296000,-296000
046159,群創群益98購04  ,0,0,0,0,0,0,0,0,0,-296000,0,0,0,2000,298000,-296000,-296000
03669C,滬深2X元富09牛01,0,0,0,0,0,0,0,0,0,-297000,0,0,0,2000,299000,-297000,-297000
057142,力成兆豐98購01  ,0,0,0,0,0,0,0,0,0,-298000,0,0,0,0,298000,-298000,-298000
054781,台化群益99購01  ,0,0,0,0,0,0,0,0,0,-298000,0,0,0,0,298000,-298000,-298000
058878,旭富國泰9B購01  ,0,0,0,0,0,0,0,0,0,-299000,0,0,0,1000,300000,-299000,-299000
051830,健策元大97購01  ,0,0,0,0,0,0,0,0,0,-299000,0,0,0,10000,309000,-299000,-299000
050791,聯發科富邦96購01,0,0,0,0,0,0,0,0,0,-299000,0,0,0,0,299000,-299000,-299000
055925,上銀群益97購01  ,0,0,0,0,0,0,0,0,0,-299000,0,0,0,0,299000,-299000,-299000
053858,台達電元大96購05,0,0,0,0,0,0,0,0,0,-299000,0,0,0,0,299000,-299000,-299000
052732,新唐國泰97購01  ,0,0,0,0,0,0,0,0,0,-299000,0,0,0,0,299000,-299000,-299000
058853,日月光群益99購01,0,0,0,0,0,0,0,0,0,-300000,0,0,0,0,300000,-300000,-300000
058200,世芯康和99購01  ,0,0,0,0,0,0,0,0,0,-300000,0,0,0,0,300000,-300000,-300000
048178,上銀富邦95購02  ,0,0,0,0,0,0,0,0,0,-300000,0,0,0,0,300000,-300000,-300000
056372,訊芯元大98購04  ,0,0,0,0,0,0,0,0,0,-300000,0,0,0,0,300000,-300000,-300000
054291,高鐵元大97購01  ,0,0,0,0,0,0,0,0,0,-300000,0,0,0,0,300000,-300000,-300000
052626,上証2X中信9A購01,0,0,0,0,0,0,0,0,0,-300000,0,0,0,0,300000,-300000,-300000
054457,強茂群益96購01  ,0,0,0,0,0,0,0,0,0,-300000,0,0,0,0,300000,-300000,-300000
054867,華航群益99購01  ,0,0,0,0,0,0,0,0,0,-300000,0,0,0,0,300000,-300000,-300000
054819,裕民元大9A購01  ,0,0,0,0,0,0,0,0,0,-300000,0,0,0,0,300000,-300000,-300000
058938,台積電中信01購03,0,0,0,0,0,0,0,0,0,-301000,0,0,0,210000,511000,-301000,-301000
03671P,大立光凱基95售02,0,0,0,0,0,0,0,0,0,-302000,0,0,0,445000,747000,-302000,-302000
05669P,嘉晶永豐96售03  ,0,0,0,0,0,0,0,0,0,-302000,0,0,0,84000,386000,-302000,-302000
8131,福懋科          ,312000,626000,-314000,0,0,0,4000,0,4000,8000,10000,1000,9000,0,1000,-1000,-302000
2015,豐興            ,137000,439341,-302341,0,0,0,0,0,0,0,0,0,0,0,0,0,-302341
1582,信錦            ,167000,416000,-249000,0,0,0,0,0,0,-54000,3000,57000,-54000,0,0,0,-303000
059140,大立光兆豐9A購02,0,0,0,0,0,0,0,0,0,-303000,0,0,0,0,303000,-303000,-303000
057947,和碩國票99購01  ,0,0,0,0,0,0,0,0,0,-304000,0,0,0,3000,307000,-304000,-304000
046792,京元電元富96購01,0,0,0,0,0,0,0,0,0,-304000,0,0,0,114000,418000,-304000,-304000
049888,智邦國泰96購01  ,0,0,0,0,0,0,0,0,0,-304000,0,0,0,40000,344000,-304000,-304000
053176,矽力群益96購02  ,0,0,0,0,0,0,0,0,0,-305000,0,0,0,11000,316000,-305000,-305000
052738,聯電元大98購02  ,0,0,0,0,0,0,0,0,0,-305000,0,0,0,105000,410000,-305000,-305000
051158,嘉晶富邦96購01  ,0,0,0,0,0,0,0,0,0,-306000,0,0,0,132000,438000,-306000,-306000
048287,嘉晶兆豐94購01  ,0,0,0,0,0,0,0,0,0,-306000,0,0,0,44000,350000,-306000,-306000
053673,超眾元富96購03  ,0,0,0,0,0,0,0,0,0,-307000,0,0,0,159000,466000,-307000,-307000
5522,遠雄            ,293258,423000,-129742,0,0,0,0,0,0,-180000,6000,186000,-180000,0,0,0,-309742
057866,玉山金凱基98購01,0,0,0,0,0,0,0,0,0,-310000,0,0,0,0,310000,-310000,-310000
054489,牧德台新97購02  ,0,0,0,0,0,0,0,0,0,-310000,0,0,0,0,310000,-310000,-310000
053229,南電台新97購01  ,0,0,0,0,0,0,0,0,0,-310000,0,0,0,780000,1090000,-310000,-310000
056770,國產元大98購02  ,0,0,0,0,0,0,0,0,0,-310000,0,0,0,0,310000,-310000,-310000
056765,友達元大9B購05  ,0,0,0,0,0,0,0,0,0,-310000,0,0,0,0,310000,-310000,-310000
056392,玉晶光富邦9C購01,0,0,0,0,0,0,0,0,0,-310000,0,0,0,0,310000,-310000,-310000
042793,台積電台新9C購01,0,0,0,0,0,0,0,0,0,-311000,0,0,0,161000,472000,-311000,-311000
4133,亞諾法          ,123000,435000,-312000,0,0,0,0,0,0,0,0,0,0,0,0,0,-312000
054137,聯詠元大97購02  ,0,0,0,0,0,0,0,0,0,-314000,0,0,0,104000,418000,-314000,-314000
058968,T50正2永豐99購01,0,0,0,0,0,0,0,0,0,-315000,0,0,0,45000,360000,-315000,-315000
051474,智邦凱基95購04  ,0,0,0,0,0,0,0,0,0,-315000,0,0,0,100000,415000,-315000,-315000
051799,台積電永豐96購01,0,0,0,0,0,0,0,0,0,-316000,0,0,0,0,316000,-316000,-316000
058305,華邦電元大99購02,0,0,0,0,0,0,0,0,0,-318000,0,0,0,28000,346000,-318000,-318000
057467,祥碩永豐98購04  ,0,0,0,0,0,0,0,0,0,-319000,0,0,0,180000,499000,-319000,-319000
050644,國巨凱基96購01  ,0,0,0,0,0,0,0,0,0,-319000,0,0,0,5000,324000,-319000,-319000
05149P,緯穎國泰96售01  ,0,0,0,0,0,0,0,0,0,-320000,0,0,0,30000,350000,-320000,-320000
052865,大立光凱基96購11,0,0,0,0,0,0,0,0,0,-320000,0,0,0,10000,330000,-320000,-320000
058412,聯發科兆豐99購01,0,0,0,0,0,0,0,0,0,-321000,0,0,0,269000,590000,-321000,-321000
059043,聯電日盛99購01  ,0,0,0,0,0,0,0,0,0,-323000,0,0,0,0,323000,-323000,-323000
058306,聯發科元大99購07,0,0,0,0,0,0,0,0,0,-324000,0,0,0,227000,551000,-324000,-324000
058227,台灣50元大9C購01,0,0,0,0,0,0,0,0,0,-324000,0,0,0,251000,575000,-324000,-324000
056141,聯茂元大97購05  ,0,0,0,0,0,0,0,0,0,-325000,0,0,0,60000,385000,-325000,-325000
058795,可成元大99購03  ,0,0,0,0,0,0,0,0,0,-326000,0,0,0,51000,377000,-326000,-326000
00646,元大S&P500      ,415000,11000,404000,0,0,0,0,0,0,-730000,0,0,0,323000,1053000,-730000,-326000
057063,立積國泰9A購01  ,0,0,0,0,0,0,0,0,0,-326000,0,0,0,45000,371000,-326000,-326000
058134,信邦元大99購01  ,0,0,0,0,0,0,0,0,0,-327000,0,0,0,52000,379000,-327000,-327000
6269,台郡            ,2957000,3189000,-232000,0,0,0,86000,61000,25000,-120000,212000,292000,-80000,6000,46000,-40000,-327000
055495,長榮航元大97購01,0,0,0,0,0,0,0,0,0,-329000,0,0,0,1000,330000,-329000,-329000
058138,晶相光元大9C購01,0,0,0,0,0,0,0,0,0,-330000,0,0,0,0,330000,-330000,-330000
049927,健策元大94購02  ,0,0,0,0,0,0,0,0,0,-330000,0,0,0,10000,340000,-330000,-330000
036630,玉山金台新99購01,0,0,0,0,0,0,0,0,0,-330000,0,0,0,1000,331000,-330000,-330000
050166,彩晶國泰95購01  ,0,0,0,0,0,0,0,0,0,-330000,0,0,0,0,330000,-330000,-330000
057114,台虹群益98購01  ,0,0,0,0,0,0,0,0,0,-330000,0,0,0,8000,338000,-330000,-330000
054712,上証2X中信98購02,0,0,0,0,0,0,0,0,0,-330000,0,0,0,0,330000,-330000,-330000
057317,技嘉凱基98購02  ,0,0,0,0,0,0,0,0,0,-331000,0,0,0,0,331000,-331000,-331000
056537,冠德凱基98購01  ,0,0,0,0,0,0,0,0,0,-332000,0,0,0,5000,337000,-332000,-332000
057197,立積台新98購01  ,0,0,0,0,0,0,0,0,0,-333000,0,0,0,55000,388000,-333000,-333000
3048,益登            ,216000,554000,-338000,0,0,0,0,0,0,5000,5000,0,5000,0,0,0,-333000
1310,台苯            ,1011000,1341000,-330000,0,0,0,0,0,0,-4000,0,4000,-4000,0,0,0,-334000
056385,創意國泰99購01  ,0,0,0,0,0,0,0,0,0,-334000,0,0,0,231000,565000,-334000,-334000
2609,陽明            ,117000,453000,-336000,0,0,0,0,0,0,0,0,0,0,0,0,0,-336000
052832,益航群益96購01  ,0,0,0,0,0,0,0,0,0,-338000,0,0,0,2000,340000,-338000,-338000
2836,高雄銀          ,127040,474000,-346960,0,0,0,0,0,0,7000,8000,1000,7000,0,0,0,-339960
044996,嘉晶國泰95購01  ,0,0,0,0,0,0,0,0,0,-340000,0,0,0,0,340000,-340000,-340000
050134,世紀鋼凱基94購04,0,0,0,0,0,0,0,0,0,-340000,0,0,0,35000,375000,-340000,-340000
051089,旺宏元大96購04  ,0,0,0,0,0,0,0,0,0,-341000,0,0,0,10000,351000,-341000,-341000
2481,強茂            ,1846000,657000,1189000,0,0,0,0,1519000,-1519000,-11000,9000,1000,8000,6000,25000,-19000,-341000
2402,毅嘉            ,616000,664000,-48000,0,0,0,0,305000,-305000,11000,12000,1000,11000,0,0,0,-342000
057815,信邦元大98購01  ,0,0,0,0,0,0,0,0,0,-344000,0,0,0,20000,364000,-344000,-344000
056722,滬深反中信9B購01,0,0,0,0,0,0,0,0,0,-345000,0,0,0,0,345000,-345000,-345000
058058,大立光元富9B購02,0,0,0,0,0,0,0,0,0,-346000,0,0,0,16000,362000,-346000,-346000
07158P,FBVIX國泰9C售01 ,0,0,0,0,0,0,0,0,0,-346000,0,0,0,0,346000,-346000,-346000
049252,國巨元大96購01  ,0,0,0,0,0,0,0,0,0,-346000,0,0,0,10000,356000,-346000,-346000
052371,元金2X元大95購01,0,0,0,0,0,0,0,0,0,-347000,0,0,0,0,347000,-347000,-347000
6456,GIS-KY          ,1192000,1568000,-376000,0,0,0,0,0,0,29000,11000,0,11000,26000,8000,18000,-347000
054311,世芯凱基96購02  ,0,0,0,0,0,0,0,0,0,-349000,0,0,0,901000,1250000,-349000,-349000
058288,南亞科國票9A購01,0,0,0,0,0,0,0,0,0,-350000,0,0,0,0,350000,-350000,-350000
051277,聯發科中信9A購01,0,0,0,0,0,0,0,0,0,-350000,0,0,0,0,350000,-350000,-350000
00752,中信中國50      ,4000,11000,-7000,0,0,0,0,0,0,-343000,0,0,0,1305000,1648000,-343000,-350000
053813,友達群益9A購03  ,0,0,0,0,0,0,0,0,0,-350000,0,0,0,0,350000,-350000,-350000
1802,台玻            ,459000,820000,-361000,0,0,0,0,0,0,10000,12000,2000,10000,0,0,0,-351000
006208,富邦台50        ,18000,16000,2000,0,0,0,0,0,0,-353000,0,0,0,225000,578000,-353000,-351000
051298,智邦凱基95購03  ,0,0,0,0,0,0,0,0,0,-351000,0,0,0,0,351000,-351000,-351000
058343,台積電群益99購02,0,0,0,0,0,0,0,0,0,-353000,0,0,0,0,353000,-353000,-353000
056569,T50正2元大9B購02,0,0,0,0,0,0,0,0,0,-353000,0,0,0,0,353000,-353000,-353000
1227,佳格            ,1508000,1865134,-357134,0,0,0,0,0,0,4000,7000,3000,4000,0,0,0,-353134
051849,旺宏中信98購01  ,0,0,0,0,0,0,0,0,0,-355000,0,0,0,0,355000,-355000,-355000
054506,矽格永豐96購01  ,0,0,0,0,0,0,0,0,0,-355000,0,0,0,50000,405000,-355000,-355000
06059P,泰碩元大97售02  ,0,0,0,0,0,0,0,0,0,-357000,0,0,0,74000,431000,-357000,-357000
8210,勤誠            ,326000,816000,-490000,0,0,0,191000,58000,133000,-1000,9000,0,9000,9000,19000,-10000,-358000
1717,長興            ,91000,456000,-365000,0,0,0,5000,0,5000,0,0,0,0,0,0,0,-360000
047212,宏達電富邦97購01,0,0,0,0,0,0,0,0,0,-360000,0,0,0,0,360000,-360000,-360000
055055,精元永豐97購01  ,0,0,0,0,0,0,0,0,0,-360000,0,0,0,0,360000,-360000,-360000
058898,台積電元大99購20,0,0,0,0,0,0,0,0,0,-361000,0,0,0,620000,981000,-361000,-361000
051827,智邦元大95購04  ,0,0,0,0,0,0,0,0,0,-361000,0,0,0,282000,643000,-361000,-361000
5434,崇越            ,223000,587000,-364000,0,0,0,0,0,0,3000,24000,20000,4000,0,1000,-1000,-361000
00640L,富邦日本正2     ,0,0,0,0,0,0,0,0,0,-362000,0,0,0,940000,1302000,-362000,-362000
053294,聯發科中信9C購01,0,0,0,0,0,0,0,0,0,-362000,0,0,0,0,362000,-362000,-362000
058109,台灣50元富9B購01,0,0,0,0,0,0,0,0,0,-364000,0,0,0,0,364000,-364000,-364000
035277,景碩台新97購01  ,0,0,0,0,0,0,0,0,0,-365000,0,0,0,43000,408000,-365000,-365000
050512,台泥元大94購01  ,0,0,0,0,0,0,0,0,0,-365000,0,0,0,0,365000,-365000,-365000
052940,玉晶光兆豐97購01,0,0,0,0,0,0,0,0,0,-365000,0,0,0,30000,395000,-365000,-365000
055083,康友中信97購01  ,0,0,0,0,0,0,0,0,0,-365000,0,0,0,0,365000,-365000,-365000
048637,鴻海元大96購01  ,0,0,0,0,0,0,0,0,0,-366000,0,0,0,397000,763000,-366000,-366000
053900,T50反1日盛99購01,0,0,0,0,0,0,0,0,0,-366000,0,0,0,377000,743000,-366000,-366000
053027,玉晶光富邦98購01,0,0,0,0,0,0,0,0,0,-368000,0,0,0,1042000,1410000,-368000,-368000
2903,遠百            ,387000,755033,-368033,0,0,0,0,0,0,0,0,0,0,0,0,0,-368033
055516,上銀中信97購01  ,0,0,0,0,0,0,0,0,0,-369000,0,0,0,0,369000,-369000,-369000
6416,瑞祺電通        ,590000,645000,-55000,0,0,0,7000,248000,-241000,-73000,146000,219000,-73000,0,0,0,-369000
055526,台積電群益97購02,0,0,0,0,0,0,0,0,0,-370000,0,0,0,400000,770000,-370000,-370000
05210P,台積電凱基95售15,0,0,0,0,0,0,0,0,0,-370000,0,0,0,0,370000,-370000,-370000
055049,智邦永豐97購01  ,0,0,0,0,0,0,0,0,0,-370000,0,0,0,74000,444000,-370000,-370000
05192P,玉晶光台新96售02,0,0,0,0,0,0,0,0,0,-371000,0,0,0,604000,975000,-371000,-371000
2458,義隆            ,1409000,2358000,-949000,0,0,0,556000,0,556000,21000,234000,212000,22000,15000,16000,-1000,-372000
05205P,緯穎元大95售03  ,0,0,0,0,0,0,0,0,0,-373000,0,0,0,55000,428000,-373000,-373000
052811,玉晶光台新96購03,0,0,0,0,0,0,0,0,0,-373000,0,0,0,347000,720000,-373000,-373000
052809,訊芯元大97購01  ,0,0,0,0,0,0,0,0,0,-374000,0,0,0,610000,984000,-374000,-374000
051577,台積電元大97購03,0,0,0,0,0,0,0,0,0,-375000,0,0,0,90000,465000,-375000,-375000
050492,漢唐國泰96購01  ,0,0,0,0,0,0,0,0,0,-375000,0,0,0,47000,422000,-375000,-375000
052917,大立光富邦99購02,0,0,0,0,0,0,0,0,0,-376000,0,0,0,0,376000,-376000,-376000
058323,泰鼎永豐9A購01  ,0,0,0,0,0,0,0,0,0,-377000,0,0,0,20000,397000,-377000,-377000
2417,圓剛            ,410000,791000,-381000,0,0,0,0,0,0,4000,4000,0,4000,0,0,0,-377000
051087,國巨元大97購01  ,0,0,0,0,0,0,0,0,0,-379000,0,0,0,11000,390000,-379000,-379000
048262,台積電元富94購01,0,0,0,0,0,0,0,0,0,-380000,0,0,0,0,380000,-380000,-380000
052687,國泰金元大96購03,0,0,0,0,0,0,0,0,0,-380000,0,0,0,85000,465000,-380000,-380000
058285,牧德群益9A購02  ,0,0,0,0,0,0,0,0,0,-382000,0,0,0,0,382000,-382000,-382000
054072,台積電富邦98購02,0,0,0,0,0,0,0,0,0,-383000,0,0,0,0,383000,-383000,-383000
058659,力成中信99購01  ,0,0,0,0,0,0,0,0,0,-384000,0,0,0,30000,414000,-384000,-384000
2108,南帝            ,117000,501000,-384000,0,0,0,0,0,0,0,0,0,0,0,0,0,-384000
054702,智邦第一97購01  ,0,0,0,0,0,0,0,0,0,-385000,0,0,0,5000,390000,-385000,-385000
057566,欣興富邦99購01  ,0,0,0,0,0,0,0,0,0,-387000,0,0,0,0,387000,-387000,-387000
2395,研華            ,1297350,1685975,-388625,0,0,0,17000,0,17000,-16000,17000,33000,-16000,0,0,0,-387625
055501,創意元大97購01  ,0,0,0,0,0,0,0,0,0,-388000,0,0,0,3000,391000,-388000,-388000
043442,大立光台新01購01,0,0,0,0,0,0,0,0,0,-389000,0,0,0,31000,420000,-389000,-389000
055460,華擎永豐97購01  ,0,0,0,0,0,0,0,0,0,-390000,0,0,0,81000,471000,-390000,-390000
054589,聯鈞國泰99購01  ,0,0,0,0,0,0,0,0,0,-390000,0,0,0,25000,415000,-390000,-390000
052614,聯電國泰97購01  ,0,0,0,0,0,0,0,0,0,-390000,0,0,0,229000,619000,-390000,-390000
3669,圓展            ,175000,565000,-390000,0,0,0,0,0,0,0,0,0,0,0,0,0,-390000
058527,世紀鋼元大99購01,0,0,0,0,0,0,0,0,0,-392000,0,0,0,393000,785000,-392000,-392000
054241,深中小元大98購01,0,0,0,0,0,0,0,0,0,-392000,0,0,0,60000,452000,-392000,-392000
055353,華新科凱基98購03,0,0,0,0,0,0,0,0,0,-392000,0,0,0,0,392000,-392000,-392000
9944,新麗            ,34000,427000,-393000,0,0,0,0,0,0,0,0,0,0,0,0,0,-393000
056217,A50正2中信99購02,0,0,0,0,0,0,0,0,0,-395000,0,0,0,17000,412000,-395000,-395000
1513,中興電          ,221000,671000,-450000,0,0,0,0,0,0,52000,72000,20000,52000,0,0,0,-398000
058794,旺宏元大99購09  ,0,0,0,0,0,0,0,0,0,-399000,0,0,0,214000,613000,-399000,-399000
049267,瀚宇博元大95購02,0,0,0,0,0,0,0,0,0,-400000,0,0,0,0,400000,-400000,-400000
049283,滬深2X中信95購10,0,0,0,0,0,0,0,0,0,-400000,0,0,0,0,400000,-400000,-400000
056317,華通群益99購02  ,0,0,0,0,0,0,0,0,0,-400000,0,0,0,0,400000,-400000,-400000
2820,華票            ,314000,732535,-418535,0,0,0,0,0,0,18000,19000,1000,18000,0,0,0,-400535
057784,台積電國票9B購01,0,0,0,0,0,0,0,0,0,-401000,0,0,0,0,401000,-401000,-401000
05221P,玉晶光元大95售04,0,0,0,0,0,0,0,0,0,-401000,0,0,0,466000,867000,-401000,-401000
04441P,台積電台新95售01,0,0,0,0,0,0,0,0,0,-401000,0,0,0,181000,582000,-401000,-401000
056988,聚陽兆豐98購01  ,0,0,0,0,0,0,0,0,0,-404000,0,0,0,1000,405000,-404000,-404000
4942,嘉彰            ,124000,553752,-429752,0,0,0,0,0,0,23000,23000,0,23000,0,0,0,-406752
054612,慧洋永豐97購01  ,0,0,0,0,0,0,0,0,0,-408000,0,0,0,0,408000,-408000,-408000
06889P,臺股指元大98售13,0,0,0,0,0,0,0,0,0,-410000,0,0,0,86000,496000,-410000,-410000
052114,華固中信95購01  ,0,0,0,0,0,0,0,0,0,-410000,0,0,0,120000,530000,-410000,-410000
054643,上証2X群益9B購01,0,0,0,0,0,0,0,0,0,-410000,0,0,0,0,410000,-410000,-410000
055360,台表科凱基97購02,0,0,0,0,0,0,0,0,0,-411000,0,0,0,89000,500000,-411000,-411000
058891,元油2X元大9C購07,0,0,0,0,0,0,0,0,0,-412000,0,0,0,0,412000,-412000,-412000
054947,興勤元大97購01  ,0,0,0,0,0,0,0,0,0,-415000,0,0,0,0,415000,-415000,-415000
056614,智邦永豐98購01  ,0,0,0,0,0,0,0,0,0,-419000,0,0,0,0,419000,-419000,-419000
058716,華新科台新99購02,0,0,0,0,0,0,0,0,0,-420000,0,0,0,0,420000,-420000,-420000
057428,正崴兆豐98購01  ,0,0,0,0,0,0,0,0,0,-420000,0,0,0,0,420000,-420000,-420000
035275,台積電台新97購01,0,0,0,0,0,0,0,0,0,-421000,0,0,0,67000,488000,-421000,-421000
057654,A50正2中信98購01,0,0,0,0,0,0,0,0,0,-422000,0,0,0,4000,426000,-422000,-422000
03674C,臺股指元富9C牛02,0,0,0,0,0,0,0,0,0,-422000,0,0,0,0,422000,-422000,-422000
058945,S&P正2群益9C購01,0,0,0,0,0,0,0,0,0,-425000,0,0,0,170000,595000,-425000,-425000
054046,義隆元大96購02  ,0,0,0,0,0,0,0,0,0,-426000,0,0,0,87000,513000,-426000,-426000
2492,華新科          ,3347000,4123593,-776593,0,0,0,2000,241000,-239000,588000,1080000,1106000,-26000,671000,57000,614000,-427593
059005,嘉晶元大99購06  ,0,0,0,0,0,0,0,0,0,-430000,0,0,0,48000,478000,-430000,-430000
058310,大立光元大99購10,0,0,0,0,0,0,0,0,0,-430000,0,0,0,266000,696000,-430000,-430000
051381,玉晶光群益98購01,0,0,0,0,0,0,0,0,0,-430000,0,0,0,10000,440000,-430000,-430000
055159,玉晶光元大98購05,0,0,0,0,0,0,0,0,0,-430000,0,0,0,0,430000,-430000,-430000
054177,牧德台新97購01  ,0,0,0,0,0,0,0,0,0,-430000,0,0,0,73000,503000,-430000,-430000
3406,玉晶光          ,2478000,1932978,545022,0,0,0,0,788488,-788488,-191000,661000,852000,-191000,59000,59000,0,-434466
06879P,長榮航凱基98售02,0,0,0,0,0,0,0,0,0,-435000,0,0,0,106000,541000,-435000,-435000
053057,聯電國泰97購02  ,0,0,0,0,0,0,0,0,0,-435000,0,0,0,30000,465000,-435000,-435000
00717,富邦美國特別股  ,0,0,0,0,0,0,0,0,0,-436000,0,0,0,464000,900000,-436000,-436000
051254,健策元大96購04  ,0,0,0,0,0,0,0,0,0,-437000,0,0,0,43000,480000,-437000,-437000
07166P,台灣50兆豐03售01,0,0,0,0,0,0,0,0,0,-440000,0,0,0,0,440000,-440000,-440000
049579,鴻海元大94購06  ,0,0,0,0,0,0,0,0,0,-440000,0,0,0,0,440000,-440000,-440000
047421,聯茂富邦97購01  ,0,0,0,0,0,0,0,0,0,-440000,0,0,0,150000,590000,-440000,-440000
1795,美時            ,548000,214000,334000,0,0,0,0,770000,-770000,-5000,0,5000,-5000,0,0,0,-441000
2383,台光電          ,1294000,1997000,-703000,0,0,0,0,28000,-28000,290000,489000,187000,302000,8000,20000,-12000,-441000
058126,元油2X元大9C購02,0,0,0,0,0,0,0,0,0,-443000,0,0,0,0,443000,-443000,-443000
058821,泰鼎國泰9B購01  ,0,0,0,0,0,0,0,0,0,-448000,0,0,0,10000,458000,-448000,-448000
054240,訊芯群益96購03  ,0,0,0,0,0,0,0,0,0,-450000,0,0,0,0,450000,-450000,-450000
054000,訊芯群益96購02  ,0,0,0,0,0,0,0,0,0,-450000,0,0,0,0,450000,-450000,-450000
051672,玉晶光元大96購03,0,0,0,0,0,0,0,0,0,-451000,0,0,0,120000,571000,-451000,-451000
2106,建大            ,174000,619000,-445000,0,0,0,0,0,0,-7000,0,7000,-7000,0,0,0,-452000
057663,國巨元大99購08  ,0,0,0,0,0,0,0,0,0,-453000,0,0,0,0,453000,-453000,-453000
048588,世紀鋼中信94購01,0,0,0,0,0,0,0,0,0,-454000,0,0,0,133000,587000,-454000,-454000
053560,漢唐國泰98購01  ,0,0,0,0,0,0,0,0,0,-456000,0,0,0,20000,476000,-456000,-456000
2897,王道銀行        ,144000,610000,-466000,0,0,0,19000,0,19000,-12000,0,12000,-12000,0,0,0,-459000
057996,臻鼎中信98購01  ,0,0,0,0,0,0,0,0,0,-460000,0,0,0,98000,558000,-460000,-460000
055876,美食元富9A購01  ,0,0,0,0,0,0,0,0,0,-460000,0,0,0,0,460000,-460000,-460000
058457,創意永豐99購01  ,0,0,0,0,0,0,0,0,0,-462000,0,0,0,374000,836000,-462000,-462000
051461,聯詠國泰96購01  ,0,0,0,0,0,0,0,0,0,-462000,0,0,0,250000,712000,-462000,-462000
6504,南六            ,179000,645000,-466000,0,0,0,0,0,0,0,0,0,0,0,0,0,-466000
057846,神達永豐98購01  ,0,0,0,0,0,0,0,0,0,-468000,0,0,0,2000,470000,-468000,-468000
052688,新日興元大96購01,0,0,0,0,0,0,0,0,0,-469000,0,0,0,45000,514000,-469000,-469000
052790,智邦兆豐97購01  ,0,0,0,0,0,0,0,0,0,-470000,0,0,0,395000,865000,-470000,-470000
2514,龍邦            ,119000,587000,-468000,0,0,0,0,0,0,-2000,3000,5000,-2000,0,0,0,-470000
03438P,群創群益98售03  ,0,0,0,0,0,0,0,0,0,-471000,0,0,0,19000,490000,-471000,-471000
057953,聚陽元大98購01  ,0,0,0,0,0,0,0,0,0,-472000,0,0,0,162000,634000,-472000,-472000
05564P,玉晶光元大97售02,0,0,0,0,0,0,0,0,0,-473000,0,0,0,177000,650000,-473000,-473000
6213,聯茂            ,2102000,1110980,991020,0,0,0,616000,144000,472000,-1937000,133000,1993000,-1860000,29000,106000,-77000,-473980
00830,國泰費城半導體  ,128000,269000,-141000,0,0,0,0,0,0,-336000,0,0,0,199000,535000,-336000,-477000
042953,鴻海台新01購01  ,0,0,0,0,0,0,0,0,0,-478000,0,0,0,2391000,2869000,-478000,-478000
049072,台積電凱基94購08,0,0,0,0,0,0,0,0,0,-478000,0,0,0,0,478000,-478000,-478000
054534,台積電富邦98購03,0,0,0,0,0,0,0,0,0,-478000,0,0,0,0,478000,-478000,-478000
057768,華新科中信9A購01,0,0,0,0,0,0,0,0,0,-480000,0,0,0,0,480000,-480000,-480000
048898,晶相光國泰96購01,0,0,0,0,0,0,0,0,0,-481000,0,0,0,2000,483000,-481000,-481000
057829,臺股指元大98購12,0,0,0,0,0,0,0,0,0,-483000,0,0,0,0,483000,-483000,-483000
051479,兆豐金凱基95購01,0,0,0,0,0,0,0,0,0,-485000,0,0,0,0,485000,-485000,-485000
056492,全新國泰9A購01  ,0,0,0,0,0,0,0,0,0,-488000,0,0,0,0,488000,-488000,-488000
048785,台積電元大96購01,0,0,0,0,0,0,0,0,0,-489000,0,0,0,392000,881000,-489000,-489000
044963,台積電中信96購01,0,0,0,0,0,0,0,0,0,-493000,0,0,0,40000,533000,-493000,-493000
058061,貿聯元富9B購01  ,0,0,0,0,0,0,0,0,0,-494000,0,0,0,10000,504000,-494000,-494000
054546,玉晶光中信9B購01,0,0,0,0,0,0,0,0,0,-495000,0,0,0,31000,526000,-495000,-495000
9802,鈺齊-KY         ,1124000,820000,304000,0,0,0,23000,797000,-774000,-25000,0,0,0,10000,35000,-25000,-495000
056994,緯穎兆豐98購02  ,0,0,0,0,0,0,0,0,0,-497000,0,0,0,190000,687000,-497000,-497000
058726,宏達電富邦9A購01,0,0,0,0,0,0,0,0,0,-499000,0,0,0,0,499000,-499000,-499000
053408,友達兆豐98購01  ,0,0,0,0,0,0,0,0,0,-499000,0,0,0,0,499000,-499000,-499000
054320,國喬台新96購01  ,0,0,0,0,0,0,0,0,0,-499000,0,0,0,0,499000,-499000,-499000
07115P,T50反1日盛9C售02,0,0,0,0,0,0,0,0,0,-500000,0,0,0,0,500000,-500000,-500000
052755,滬深2X群益9A購01,0,0,0,0,0,0,0,0,0,-500000,0,0,0,0,500000,-500000,-500000
2722,夏都            ,0,2000,-2000,0,0,0,0,0,0,-500000,0,500000,-500000,0,0,0,-502000
056854,友達中信9A購01  ,200000,0,200000,0,0,0,0,0,0,-704000,0,0,0,55000,759000,-704000,-504000
055027,牧德國泰99購01  ,0,0,0,0,0,0,0,0,0,-505000,0,0,0,182000,687000,-505000,-505000
038455,群臺反群益94購01,0,0,0,0,0,0,0,0,0,-506000,0,0,0,0,506000,-506000,-506000
056515,燿華兆豐99購01  ,0,0,0,0,0,0,0,0,0,-511000,0,0,0,130000,641000,-511000,-511000
058950,國巨群益99購06  ,0,0,0,0,0,0,0,0,0,-512000,0,0,0,0,512000,-512000,-512000
051240,台積電元大95購12,0,0,0,0,0,0,0,0,0,-512000,0,0,0,10000,522000,-512000,-512000
057729,華新科國泰99購04,0,0,0,0,0,0,0,0,0,-514000,0,0,0,0,514000,-514000,-514000
059087,台積電元大99購26,0,0,0,0,0,0,0,0,0,-518000,0,0,0,150000,668000,-518000,-518000
059052,為升凱基99購01  ,0,0,0,0,0,0,0,0,0,-521000,0,0,0,0,521000,-521000,-521000
051266,國巨富邦99購01  ,0,0,0,0,0,0,0,0,0,-521000,0,0,0,40000,561000,-521000,-521000
055763,鎧勝群益97購01  ,0,0,0,0,0,0,0,0,0,-524000,0,0,0,0,524000,-524000,-524000
054656,深中小元大97購01,0,0,0,0,0,0,0,0,0,-525000,0,0,0,50000,575000,-525000,-525000
1304,台聚            ,153000,680000,-527000,0,0,0,0,0,0,0,0,0,0,0,0,0,-527000
00663L,國泰臺灣加權正2 ,0,0,0,0,0,0,0,0,0,-527000,0,0,0,386000,913000,-527000,-527000
056565,欣興群益98購03  ,0,0,0,0,0,0,0,0,0,-527000,0,0,0,534000,1061000,-527000,-527000
054688,兆赫永豐97購01  ,0,0,0,0,0,0,0,0,0,-531000,0,0,0,0,531000,-531000,-531000
058836,FBVIX中信03購05 ,0,0,0,0,0,0,0,0,0,-535000,0,0,0,1347000,1882000,-535000,-535000
04049P,大立光元大95售02,0,0,0,0,0,0,0,0,0,-535000,0,0,0,124000,659000,-535000,-535000
3563,牧德            ,857000,973000,-116000,0,0,0,0,420000,-420000,1000,0,0,0,21000,20000,1000,-535000
051832,復盛元大95購01  ,0,0,0,0,0,0,0,0,0,-540000,0,0,0,10000,550000,-540000,-540000
056016,鴻海群益97購06  ,0,0,0,0,0,0,0,0,0,-540000,0,0,0,110000,650000,-540000,-540000
055065,神達永豐97購01  ,0,0,0,0,0,0,0,0,0,-542000,0,0,0,11000,553000,-542000,-542000
051431,群創元富99購02  ,0,0,0,0,0,0,0,0,0,-545000,0,0,0,0,545000,-545000,-545000
058652,SGBR2X中信01購01,0,0,0,0,0,0,0,0,0,-547000,0,0,0,0,547000,-547000,-547000
03436B,臺股指元富99熊13,0,0,0,0,0,0,0,0,0,-547000,0,0,0,0,547000,-547000,-547000
06025P,臺股指元大99售02,4000,0,4000,0,0,0,0,0,0,-552000,0,0,0,294000,846000,-552000,-548000
07046P,大立光富邦9C售03,0,0,0,0,0,0,0,0,0,-549000,0,0,0,5000,554000,-549000,-549000
1409,新纖            ,397000,948000,-551000,0,0,0,0,0,0,0,0,0,0,0,0,0,-551000
6505,台塑化          ,3677000,3838972,-161972,0,0,0,272000,605000,-333000,-57000,8000,65000,-57000,0,0,0,-551972
057646,玉山金元大98購01,0,0,0,0,0,0,0,0,0,-555000,0,0,0,50000,605000,-555000,-555000
053610,矽力中信98購01  ,0,0,0,0,0,0,0,0,0,-556000,0,0,0,40000,596000,-556000,-556000
058359,瑞昱凱基99購01  ,0,0,0,0,0,0,0,0,0,-558000,0,0,0,35000,593000,-558000,-558000
055512,聯詠兆豐97購01  ,0,0,0,0,0,0,0,0,0,-558000,0,0,0,27000,585000,-558000,-558000
2535,達欣工          ,437000,941000,-504000,0,0,0,0,0,0,-57000,253000,310000,-57000,0,0,0,-561000
058855,台積電兆豐99購02,0,0,0,0,0,0,0,0,0,-569000,0,0,0,36000,605000,-569000,-569000
07015P,國巨元大99售13  ,0,0,0,0,0,0,0,0,0,-569000,0,0,0,334000,903000,-569000,-569000
056388,勤誠國泰99購01  ,0,0,0,0,0,0,0,0,0,-569000,0,0,0,0,569000,-569000,-569000
058636,亞光兆豐9A購01  ,0,0,0,0,0,0,0,0,0,-570000,0,0,0,0,570000,-570000,-570000
056993,GIS兆豐99購01   ,0,0,0,0,0,0,0,0,0,-570000,0,0,0,100000,670000,-570000,-570000
059215,台積電元大99購28,0,0,0,0,0,0,0,0,0,-573000,0,0,0,0,573000,-573000,-573000
058656,燿華中信99購01  ,0,0,0,0,0,0,0,0,0,-574000,0,0,0,200000,774000,-574000,-574000
058709,臺股指元大9A購22,0,0,0,0,0,0,0,0,0,-575000,0,0,0,174000,749000,-575000,-575000
048848,滬深2X群益98購02,0,0,0,0,0,0,0,0,0,-579000,0,0,0,0,579000,-579000,-579000
056413,上証反中信9A購01,0,0,0,0,0,0,0,0,0,-579000,0,0,0,410000,989000,-579000,-579000
053115,滬深2X中信97購01,0,0,0,0,0,0,0,0,0,-580000,0,0,0,56000,636000,-580000,-580000
053577,上証2X元大96購02,0,0,0,0,0,0,0,0,0,-581000,0,0,0,0,581000,-581000,-581000
057834,聯發科元富02購07,0,0,0,0,0,0,0,0,0,-588000,0,0,0,0,588000,-588000,-588000
058426,旺宏元富99購02  ,0,0,0,0,0,0,0,0,0,-589000,0,0,0,0,589000,-589000,-589000
049154,玉晶光元大95購02,0,0,0,0,0,0,0,0,0,-590000,0,0,0,0,590000,-590000,-590000
054860,台積電群益98購01,0,0,0,0,0,0,0,0,0,-590000,0,0,0,0,590000,-590000,-590000
056664,上証反中信9B購01,0,0,0,0,0,0,0,0,0,-590000,0,0,0,10000,600000,-590000,-590000
050014,國巨富邦98購01  ,0,0,0,0,0,0,0,0,0,-591000,0,0,0,40000,631000,-591000,-591000
057625,泰鼎國泰9A購01  ,0,0,0,0,0,0,0,0,0,-592000,0,0,0,147000,739000,-592000,-592000
2548,華固            ,266632,1121000,-854368,0,0,0,130000,0,130000,127000,109000,0,109000,23000,5000,18000,-597368
057630,茂林永豐98購01  ,0,0,0,0,0,0,0,0,0,-600000,0,0,0,0,600000,-600000,-600000
054117,宏全康和96購01  ,0,0,0,0,0,0,0,0,0,-600000,0,0,0,0,600000,-600000,-600000
047316,大立光元大94購01,0,0,0,0,0,0,0,0,0,-601000,0,0,0,700000,1301000,-601000,-601000
053891,欣興群益98購01  ,0,0,0,0,0,0,0,0,0,-601000,0,0,0,0,601000,-601000,-601000
051075,智邦國泰97購01  ,0,0,0,0,0,0,0,0,0,-605000,0,0,0,45000,650000,-605000,-605000
045189,大立光元富98購01,0,0,0,0,0,0,0,0,0,-606000,0,0,0,0,606000,-606000,-606000
058889,元油2X元大9C購05,0,0,0,0,0,0,0,0,0,-610000,0,0,0,0,610000,-610000,-610000
050399,潤泰全中信95購01,0,0,0,0,0,0,0,0,0,-610000,0,0,0,0,610000,-610000,-610000
8112,至上            ,764000,1964000,-1200000,0,0,0,540000,0,540000,46000,71000,25000,46000,0,0,0,-614000
06028P,智邦台新97售01  ,0,0,0,0,0,0,0,0,0,-617000,0,0,0,90000,707000,-617000,-617000
051888,國巨元富95購05  ,0,0,0,0,0,0,0,0,0,-617000,0,0,0,0,617000,-617000,-617000
059088,台積電元大99購27,0,0,0,0,0,0,0,0,0,-620000,0,0,0,22000,642000,-620000,-620000
054259,健策元大97購03  ,0,0,0,0,0,0,0,0,0,-625000,0,0,0,10000,635000,-625000,-625000
2332,友訊            ,1253000,1476000,-223000,0,0,0,0,0,0,-408000,21000,276000,-255000,23000,176000,-153000,-631000
020012,富邦行動通訊N   ,0,0,0,0,0,0,0,0,0,-642000,0,0,0,299000,941000,-642000,-642000
052130,國巨凱基9B購01  ,0,0,0,0,0,0,0,0,0,-643000,0,0,0,0,643000,-643000,-643000
056721,台灣50永昌9A購01,0,0,0,0,0,0,0,0,0,-644000,0,0,0,10000,654000,-644000,-644000
2723,美食-KY         ,721000,1359013,-638013,0,0,0,1000,0,1000,-9000,0,10000,-10000,9000,8000,1000,-646013
055515,聚陽中信9A購01  ,0,0,0,0,0,0,0,0,0,-647000,0,0,0,6000,653000,-647000,-647000
055022,精元國泰99購01  ,0,0,0,0,0,0,0,0,0,-647000,0,0,0,217000,864000,-647000,-647000
057069,台積電永豐98購02,0,0,0,0,0,0,0,0,0,-650000,0,0,0,0,650000,-650000,-650000
059216,台積電元大99購29,0,0,0,0,0,0,0,0,0,-654000,0,0,0,3000,657000,-654000,-654000
059074,元油2X元大9C購15,0,0,0,0,0,0,0,0,0,-655000,0,0,0,0,655000,-655000,-655000
059150,臺股指國票99購13,0,0,0,0,0,0,0,0,0,-657000,0,0,0,0,657000,-657000,-657000
03673C,臺股指元富99牛14,0,0,0,0,0,0,0,0,0,-657000,0,0,0,0,657000,-657000,-657000
053648,台積電凱基97購04,0,0,0,0,0,0,0,0,0,-666000,0,0,0,0,666000,-666000,-666000
052785,滬深2X中信99購03,0,0,0,0,0,0,0,0,0,-666000,0,0,0,130000,796000,-666000,-666000
058538,智邦台新99購02  ,0,0,0,0,0,0,0,0,0,-669000,0,0,0,296000,965000,-669000,-669000
058661,臺股指中信9C購01,0,0,0,0,0,0,0,0,0,-670000,0,0,0,0,670000,-670000,-670000
2855,統一證          ,365000,1038000,-673000,0,0,0,0,0,0,0,0,0,0,0,0,0,-673000
057795,鴻海兆豐99購02  ,0,0,0,0,0,0,0,0,0,-675000,0,0,0,10000,685000,-675000,-675000
059217,台積電元大99購30,0,0,0,0,0,0,0,0,0,-675000,0,0,0,0,675000,-675000,-675000
3014,聯陽            ,589500,1258000,-668500,0,0,0,0,0,0,-12000,8000,0,8000,8000,28000,-20000,-680500
057513,智邦台新98購01  ,0,0,0,0,0,0,0,0,0,-683000,0,0,0,184000,867000,-683000,-683000
058884,世紀鋼永豐99購02,0,0,0,0,0,0,0,0,0,-685000,0,0,0,50000,735000,-685000,-685000
07100P,華航元大99售01  ,0,0,0,0,0,0,0,0,0,-685000,0,0,0,139000,824000,-685000,-685000
06897P,FBVIX群益01售01 ,0,0,0,0,0,0,0,0,0,-685000,0,0,0,0,685000,-685000,-685000
053209,台積電凱基96購07,0,0,0,0,0,0,0,0,0,-685000,0,0,0,499000,1184000,-685000,-685000
050686,欣興兆豐96購01  ,0,0,0,0,0,0,0,0,0,-687000,0,0,0,0,687000,-687000,-687000
049890,嘉澤國泰95購01  ,0,0,0,0,0,0,0,0,0,-691000,0,0,0,0,691000,-691000,-691000
054425,聯發科富邦99購03,0,0,0,0,0,0,0,0,0,-691000,0,0,0,558000,1249000,-691000,-691000
052345,矽力凱基95購01  ,0,0,0,0,0,0,0,0,0,-697000,0,0,0,10000,707000,-697000,-697000
050694,國巨凱基96購03  ,0,0,0,0,0,0,0,0,0,-699000,0,0,0,0,699000,-699000,-699000
056244,群創群益98購09  ,0,0,0,0,0,0,0,0,0,-699000,0,0,0,0,699000,-699000,-699000
050551,大立光凱基95購05,0,0,0,0,0,0,0,0,0,-700000,0,0,0,160000,860000,-700000,-700000
054201,聯詠富邦97購02  ,0,0,0,0,0,0,0,0,0,-700000,0,0,0,10000,710000,-700000,-700000
054946,億光元大97購01  ,0,0,0,0,0,0,0,0,0,-700000,0,0,0,10000,710000,-700000,-700000
058718,台灣50元富03購01,0,0,0,0,0,0,0,0,0,-707000,0,0,0,28000,735000,-707000,-707000
1904,正隆            ,1305000,2427000,-1122000,0,0,0,500000,0,500000,-85000,49000,134000,-85000,0,0,0,-707000
057546,台積電凱基02購01,0,0,0,0,0,0,0,0,0,-708000,0,0,0,0,708000,-708000,-708000
055808,世紀鋼永豐97購01,0,0,0,0,0,0,0,0,0,-714000,0,0,0,33000,747000,-714000,-714000
1434,福懋            ,926000,1738594,-812594,0,0,0,18000,0,18000,70000,71000,1000,70000,0,0,0,-724594
048179,臻鼎富邦97購01  ,0,0,0,0,0,0,0,0,0,-725000,0,0,0,0,725000,-725000,-725000
057036,元油2X元大9B購04,0,0,0,0,0,0,0,0,0,-730000,0,0,0,0,730000,-730000,-730000
06641P,智邦兆豐99售01  ,0,0,0,0,0,0,0,0,0,-733000,0,0,0,135000,868000,-733000,-733000
052818,智邦永豐96購01  ,0,0,0,0,0,0,0,0,0,-737000,0,0,0,58000,795000,-737000,-737000
058600,國巨元大99購15  ,0,0,0,0,0,0,0,0,0,-740000,0,0,0,138000,878000,-740000,-740000
046148,友達中信94購01  ,0,0,0,0,0,0,0,0,0,-745000,0,0,0,2000,747000,-745000,-745000
059025,台灣50台新9B購02,0,0,0,0,0,0,0,0,0,-746000,0,0,0,0,746000,-746000,-746000
056612,台積電永豐98購01,0,0,0,0,0,0,0,0,0,-750000,0,0,0,0,750000,-750000,-750000
2634,漢翔            ,819000,1579000,-760000,0,0,0,8000,0,8000,0,0,0,0,0,0,0,-752000
057472,T50正2元大9B購03,0,0,0,0,0,0,0,0,0,-761000,0,0,0,0,761000,-761000,-761000
03619C,臺股指元大95牛02,0,0,0,0,0,0,0,0,0,-764000,0,0,0,264000,1028000,-764000,-764000
053458,聯詠國泰97購01  ,0,0,0,0,0,0,0,0,0,-769000,0,0,0,0,769000,-769000,-769000
2838,聯邦銀          ,294000,1078000,-784000,0,0,0,0,0,0,15000,17000,2000,15000,0,0,0,-769000
2312,金寶            ,803000,1604000,-801000,0,0,0,0,0,0,17000,30000,2000,28000,3000,14000,-11000,-784000
058603,台積電元大99購12,0,0,0,0,0,0,0,0,0,-796000,0,0,0,417000,1213000,-796000,-796000
054834,帆宣中信97購01  ,0,0,0,0,0,0,0,0,0,-799000,0,0,0,0,799000,-799000,-799000
2393,億光            ,532000,1289084,-757084,0,0,0,0,0,0,-42000,32000,64000,-32000,0,10000,-10000,-799084
058708,臺股指元大9A購21,0,0,0,0,0,0,0,0,0,-800000,0,0,0,175000,975000,-800000,-800000
054560,全新群益98購03  ,0,0,0,0,0,0,0,0,0,-800000,0,0,0,0,800000,-800000,-800000
05397P,大立光凱基96售08,0,0,0,0,0,0,0,0,0,-801000,0,0,0,47000,848000,-801000,-801000
059138,台積電兆豐99購04,0,0,0,0,0,0,0,0,0,-803000,0,0,0,0,803000,-803000,-803000
051399,玉晶光台新96購01,0,0,0,0,0,0,0,0,0,-805000,0,0,0,35000,840000,-805000,-805000
055663,崇越中信97購01  ,0,0,0,0,0,0,0,0,0,-812000,0,0,0,0,812000,-812000,-812000
052994,群創台新99購01  ,0,0,0,0,0,0,0,0,0,-820000,0,0,0,519000,1339000,-820000,-820000
054358,矽創兆豐96購01  ,0,0,0,0,0,0,0,0,0,-820000,0,0,0,0,820000,-820000,-820000
055520,矽力中信97購02  ,0,0,0,0,0,0,0,0,0,-830000,0,0,0,61000,891000,-830000,-830000
2542,興富發          ,1460424,2410522,-950098,0,0,0,0,0,0,119000,196000,77000,119000,0,0,0,-831098
3034,聯詠            ,3443051,4541326,-1098275,0,0,0,109000,26000,83000,183000,31000,80000,-49000,252000,20000,232000,-832275
2357,華碩            ,1962671,3471740,-1509069,0,0,0,456000,31000,425000,249000,15000,26000,-11000,260000,0,260000,-835069
2610,華航            ,6510000,7348338,-838338,0,0,0,56000,0,56000,-57000,5000,1000,4000,0,61000,-61000,-839338
5880,合庫金          ,23471000,24603292,-1132292,0,0,0,174000,0,174000,113000,107000,0,107000,6000,0,6000,-845292
058283,世紀鋼中信99購01,0,0,0,0,0,0,0,0,0,-847000,0,0,0,393000,1240000,-847000,-847000
057219,群創群益98購10  ,0,0,0,0,0,0,0,0,0,-862000,0,0,0,0,862000,-862000,-862000
058139,臻鼎元大99購01  ,0,0,0,0,0,0,0,0,0,-880000,0,0,0,50000,930000,-880000,-880000
058172,國巨凱基9B購02  ,0,0,0,0,0,0,0,0,0,-880000,0,0,0,0,880000,-880000,-880000
058941,華新科中信99購03,0,0,0,0,0,0,0,0,0,-882000,0,0,0,144000,1026000,-882000,-882000
054779,台塑群益98購01  ,0,0,0,0,0,0,0,0,0,-887000,0,0,0,0,887000,-887000,-887000
00670L,富邦NASDAQ正2   ,18000,19000,-1000,0,0,0,0,0,0,-887000,0,0,0,221000,1108000,-887000,-888000
053270,台塑元大96購01  ,0,0,0,0,0,0,0,0,0,-892000,0,0,0,0,892000,-892000,-892000
048124,大立光元大95購03,0,0,0,0,0,0,0,0,0,-904000,0,0,0,100000,1004000,-904000,-904000
06652P,長榮航元大98售01,0,0,0,0,0,0,0,0,0,-908000,0,0,0,401000,1309000,-908000,-908000
2633,台灣高鐵        ,6795137,7783265,-988128,0,0,0,37000,0,37000,27000,58000,3000,55000,2000,30000,-28000,-924128
052939,富邦金兆豐96購01,0,0,0,0,0,0,0,0,0,-929000,0,0,0,104000,1033000,-929000,-929000
050540,台積電凱基94購38,0,0,0,0,0,0,0,0,0,-931000,0,0,0,0,931000,-931000,-931000
058174,台積電凱基9A購05,0,0,0,0,0,0,0,0,0,-937000,0,0,0,1666000,2603000,-937000,-937000
056277,上銀富邦99購02  ,0,0,0,0,0,0,0,0,0,-937000,0,0,0,0,937000,-937000,-937000
054859,鴻海群益97購02  ,0,0,0,0,0,0,0,0,0,-937000,0,0,0,0,937000,-937000,-937000
059012,臺股指元大9A購31,0,0,0,0,0,0,0,0,0,-943000,0,0,0,251000,1194000,-943000,-943000
058814,南亞科台新99購01,0,0,0,0,0,0,0,0,0,-949000,0,0,0,3000,952000,-949000,-949000
2017,官田鋼          ,91000,41000,50000,0,0,0,0,0,0,-1001000,3000,1004000,-1001000,0,0,0,-951000
2023,燁輝            ,207000,1179000,-972000,0,0,0,0,0,0,8000,10000,2000,8000,0,0,0,-964000
056325,群創兆豐9A購01  ,0,0,0,0,0,0,0,0,0,-972000,0,0,0,0,972000,-972000,-972000
1312,國喬            ,1091000,1980000,-889000,0,0,0,0,0,0,-89000,39000,92000,-53000,10000,46000,-36000,-978000
056235,鴻海群益97購07  ,0,0,0,0,0,0,0,0,0,-979000,0,0,0,1597000,2576000,-979000,-979000
053314,A50正2群益9A購01,0,0,0,0,0,0,0,0,0,-983000,0,0,0,53000,1036000,-983000,-983000
8039,台虹            ,915000,1877000,-962000,0,0,0,0,0,0,-21000,12000,28000,-16000,18000,23000,-5000,-983000
059171,祥碩凱基99購04  ,0,0,0,0,0,0,0,0,0,-987000,0,0,0,400000,1387000,-987000,-987000
054190,矽創永豐96購01  ,0,0,0,0,0,0,0,0,0,-989000,0,0,0,0,989000,-989000,-989000
051466,玉晶光富邦97購01,0,0,0,0,0,0,0,0,0,-997000,0,0,0,1000,998000,-997000,-997000
051803,矽創永豐95購03  ,0,0,0,0,0,0,0,0,0,-1000000,0,0,0,0,1000000,-1000000,-1000000
058921,聯發科元富03購01,0,0,0,0,0,0,0,0,0,-1003000,0,0,0,56000,1059000,-1003000,-1003000
058830,健策永豐99購02  ,0,0,0,0,0,0,0,0,0,-1006000,0,0,0,0,1006000,-1006000,-1006000
055524,鴻海群益98購01  ,0,0,0,0,0,0,0,0,0,-1015000,0,0,0,50000,1065000,-1015000,-1015000
052588,玉晶光永豐98購01,0,0,0,0,0,0,0,0,0,-1021000,0,0,0,0,1021000,-1021000,-1021000
058261,大立光富邦03購01,0,0,0,0,0,0,0,0,0,-1030000,0,0,0,14000,1044000,-1030000,-1030000
050801,元金2X群益98購01,0,0,0,0,0,0,0,0,0,-1039000,0,0,0,3080000,4119000,-1039000,-1039000
058576,南亞科群益99購01,0,0,0,0,0,0,0,0,0,-1042000,0,0,0,3000,1045000,-1042000,-1042000
2103,台橡            ,503000,268000,235000,0,0,0,0,0,0,-1279000,0,1279000,-1279000,0,0,0,-1044000
2823,中壽            ,13336000,14122415,-786415,0,0,0,58000,401000,-343000,85000,45000,1000,44000,103000,62000,41000,-1044415
055428,友達群益9C購01  ,0,0,0,0,0,0,0,0,0,-1054000,0,0,0,0,1054000,-1054000,-1054000
056412,上証2X中信9A購02,0,0,0,0,0,0,0,0,0,-1066000,0,0,0,59000,1125000,-1066000,-1066000
057037,元油2X元大9B購05,0,0,0,0,0,0,0,0,0,-1069000,0,0,0,0,1069000,-1069000,-1069000
2347,聯強            ,4770000,7430834,-2660834,0,0,0,0,212000,-212000,1800000,207000,192000,15000,1785000,0,1785000,-1072834
056517,茂林兆豐99購01  ,0,0,0,0,0,0,0,0,0,-1078000,0,0,0,0,1078000,-1078000,-1078000
1907,永豐餘          ,1130000,2217000,-1087000,0,0,0,0,0,0,3000,3000,0,3000,0,0,0,-1084000
6257,矽格            ,1648000,2751000,-1103000,0,0,0,0,0,0,7410,267000,285590,-18590,39000,13000,26000,-1095590
053770,元金2X元大98購01,0,0,0,0,0,0,0,0,0,-1107000,0,0,0,20000,1127000,-1107000,-1107000
049251,國巨元大95購02  ,0,0,0,0,0,0,0,0,0,-1111000,0,0,0,10000,1121000,-1111000,-1111000
1210,大成            ,612000,1706595,-1094595,0,0,0,0,0,0,-18000,0,18000,-18000,0,0,0,-1112595
059151,臺股指國票99購14,0,0,0,0,0,0,0,0,0,-1117000,0,0,0,0,1117000,-1117000,-1117000
2520,冠德            ,1414778,1819000,-404222,0,0,0,0,588000,-588000,-152000,60000,190000,-130000,0,22000,-22000,-1144222
3045,台灣大          ,5879000,7291533,-1412533,0,0,0,360000,6000,354000,-91000,294000,385000,-91000,0,0,0,-1149533
00675L,富邦臺灣加權正2 ,1000,0,1000,0,0,0,0,0,0,-1153000,0,0,0,1125000,2278000,-1153000,-1152000
057098,新光金台新98購01,0,0,0,0,0,0,0,0,0,-1158000,0,0,0,0,1158000,-1158000,-1158000
048505,滬深2X群益99購03,0,0,0,0,0,0,0,0,0,-1187000,0,0,0,0,1187000,-1187000,-1187000
054874,帆宣群益99購02  ,0,0,0,0,0,0,0,0,0,-1200000,0,0,0,0,1200000,-1200000,-1200000
1325,恆大            ,436000,1637000,-1201000,0,0,0,0,0,0,0,0,0,0,0,0,0,-1201000
059152,臺股指國票99購15,0,0,0,0,0,0,0,0,0,-1220000,0,0,0,0,1220000,-1220000,-1220000
052325,高股息中信99購01,0,0,0,0,0,0,0,0,0,-1234000,0,0,0,1000,1235000,-1234000,-1234000
058587,台積電中信9C購03,0,0,0,0,0,0,0,0,0,-1238000,0,0,0,239000,1477000,-1238000,-1238000
055666,鴻海群益97購05  ,0,0,0,0,0,0,0,0,0,-1247000,0,0,0,0,1247000,-1247000,-1247000
058934,台灣50中信03購03,0,0,0,0,0,0,0,0,0,-1260000,0,0,0,144000,1404000,-1260000,-1260000
059149,臺股指國票99購12,0,0,0,0,0,0,0,0,0,-1261000,0,0,0,11000,1272000,-1261000,-1261000
3005,神基            ,801000,3506000,-2705000,0,0,0,0,188000,-188000,1613000,70000,0,70000,1583000,40000,1543000,-1280000
059013,臺股指元大9A購32,0,0,0,0,0,0,0,0,0,-1295000,0,0,0,5000,1300000,-1295000,-1295000
056889,元油2X元大99購07,0,0,0,0,0,0,0,0,0,-1303000,0,0,0,0,1303000,-1303000,-1303000
059000,台積電元大99購25,0,0,0,0,0,0,0,0,0,-1319000,0,0,0,198000,1517000,-1319000,-1319000
2385,群光            ,1357000,3771602,-2414602,0,0,0,456000,85000,371000,721000,17000,4000,13000,711000,3000,708000,-1322602
5876,上海商銀        ,7629000,9157350,-1528350,0,0,0,9000,0,9000,195000,223000,13000,210000,6000,21000,-15000,-1324350
2101,南港            ,346000,1633000,-1287000,0,0,0,0,0,0,-41000,0,0,0,52000,93000,-41000,-1328000
059153,臺股指國票99購16,0,0,0,0,0,0,0,0,0,-1343000,0,0,0,0,1343000,-1343000,-1343000
3044,健鼎            ,789000,2204975,-1415975,0,0,0,0,0,0,54000,68000,9000,59000,2000,7000,-5000,-1361975
2327,國巨            ,5763482,6092394,-328912,0,0,0,1000,1277000,-1276000,239000,1160000,1197000,-37000,424000,148000,276000,-1365912
1909,榮成            ,3350000,4341000,-991000,0,0,0,0,0,0,-375000,32000,407000,-375000,0,0,0,-1366000
3702,大聯大          ,3602000,6685455,-3083455,0,0,0,14000,243000,-229000,1944000,69000,153000,-84000,2041000,13000,2028000,-1368455
047652,滬深2X兆豐94購03,0,0,0,0,0,0,0,0,0,-1373000,0,0,0,50000,1423000,-1373000,-1373000
06891P,緯穎富邦99售03  ,0,0,0,0,0,0,0,0,0,-1384000,0,0,0,17000,1401000,-1384000,-1384000
057393,台積電中信02購01,0,0,0,0,0,0,0,0,0,-1390000,0,0,0,0,1390000,-1390000,-1390000
057104,康友中信99購01  ,0,0,0,0,0,0,0,0,0,-1393000,0,0,0,0,1393000,-1393000,-1393000
052828,滬深2X群益9A購02,0,0,0,0,0,0,0,0,0,-1394000,0,0,0,20000,1414000,-1394000,-1394000
2845,遠東銀          ,617000,2236000,-1619000,0,0,0,37000,0,37000,171000,177000,6000,171000,0,0,0,-1411000
04391P,玉晶光凱基95售03,0,0,0,0,0,0,0,0,0,-1427000,0,0,0,20000,1447000,-1427000,-1427000
059180,祥碩元富9A購01  ,0,0,0,0,0,0,0,0,0,-1436000,0,0,0,0,1436000,-1436000,-1436000
056977,國巨群益9A購01  ,0,0,0,0,0,0,0,0,0,-1437000,0,0,0,0,1437000,-1437000,-1437000
059218,台積電元大99購31,0,0,0,0,0,0,0,0,0,-1483000,0,0,0,5000,1488000,-1483000,-1483000
054845,智邦兆豐98購01  ,0,0,0,0,0,0,0,0,0,-1498000,0,0,0,175000,1673000,-1498000,-1498000
2324,仁寶            ,11190000,15813544,-4623544,0,0,0,54000,430000,-376000,3465000,81000,220000,-139000,3606000,2000,3604000,-1534544
2387,精元            ,1086000,2484000,-1398000,0,0,0,0,150000,-150000,12000,4000,0,4000,41000,33000,8000,-1536000
00701,國泰股利精選30  ,1000,22000,-21000,0,0,0,0,0,0,-1529000,0,0,0,1985000,3514000,-1529000,-1550000
2809,京城銀          ,1058000,1909000,-851000,0,0,0,10000,679000,-669000,-54000,25000,79000,-54000,0,0,0,-1574000
058475,台積電凱基99購06,0,0,0,0,0,0,0,0,0,-1643000,0,0,0,0,1643000,-1643000,-1643000
057697,國巨群益98購09  ,0,0,0,0,0,0,0,0,0,-1663000,0,0,0,5000,1668000,-1663000,-1663000
050235,國巨凱基94購11  ,0,0,0,0,0,0,0,0,0,-1664000,0,0,0,8000,1672000,-1664000,-1664000
6176,瑞儀            ,1201000,4054000,-2853000,0,0,0,533000,78000,455000,650000,137000,126000,11000,698000,59000,639000,-1748000
058837,SGBR2X中信9C購01,0,0,0,0,0,0,0,0,0,-1795000,0,0,0,100000,1895000,-1795000,-1795000
2454,聯發科          ,4875491,6779267,-1903776,0,0,0,83000,3000,80000,27000,467000,482000,-15000,143000,101000,42000,-1796776
058962,元油2X兆豐9A購02,0,0,0,0,0,0,0,0,0,-1816000,0,0,0,0,1816000,-1816000,-1816000
058999,台積電元大99購24,0,0,0,0,0,0,0,0,0,-1848000,0,0,0,255000,2103000,-1848000,-1848000
059011,臺股指元大9A購30,0,0,0,0,0,0,0,0,0,-1890000,0,0,0,6000,1896000,-1890000,-1890000
2105,正新            ,4130000,5933441,-1803441,0,0,0,13000,0,13000,-101000,31000,72000,-41000,0,60000,-60000,-1891441
055094,智易群益98購01  ,0,0,0,0,0,0,0,0,0,-1899000,0,0,0,0,1899000,-1899000,-1899000
1102,亞泥            ,9661000,13688814,-4027814,0,0,0,543000,209000,334000,1794000,112000,48000,64000,1763000,33000,1730000,-1899814
050786,健策國泰96購01  ,0,0,0,0,0,0,0,0,0,-1904000,0,0,0,0,1904000,-1904000,-1904000
00850,元大臺灣ESG永續 ,6000,0,6000,0,0,0,0,0,0,-1960000,0,0,0,763000,2723000,-1960000,-1954000
058848,台積電群益99購07,0,0,0,0,0,0,0,0,0,-1962000,0,0,0,209000,2171000,-1962000,-1962000
059179,祥碩元富99購01  ,0,0,0,0,0,0,0,0,0,-2006000,0,0,0,0,2006000,-2006000,-2006000
056017,台積電群益97購04,0,0,0,0,0,0,0,0,0,-2024000,0,0,0,0,2024000,-2024000,-2024000
2379,瑞昱            ,2319000,4527170,-2208170,0,0,0,0,0,0,56000,154000,119000,35000,49000,28000,21000,-2152170
4142,國光生          ,1922000,3793000,-1871000,0,0,0,0,0,0,-300000,0,300000,-300000,0,0,0,-2171000
9919,康那香          ,1133000,3359000,-2226000,0,0,0,0,0,0,0,1000,1000,0,0,0,0,-2226000
2889,國票金          ,821000,3124089,-2303089,0,0,0,0,0,0,33000,38000,5000,33000,0,0,0,-2270089
6239,力成            ,3313000,5361185,-2048185,0,0,0,26000,0,26000,-259000,213000,435000,-222000,10000,47000,-37000,-2281185
2308,台達電          ,4215000,6794194,-2579194,0,0,0,36000,25000,11000,192000,222000,38000,184000,11000,3000,8000,-2376194
2354,鴻準            ,2034000,4345516,-2311516,0,0,0,0,50000,-50000,-74000,45000,119000,-74000,0,0,0,-2435516
2408,南亞科          ,6168486,6966226,-797740,0,0,0,30000,2472000,-2442000,798000,381000,456000,-75000,928000,55000,873000,-2441740
4958,臻鼎-KY         ,4368147,6987092,-2618945,0,0,0,282000,192000,90000,18000,325000,288000,37000,11000,30000,-19000,-2510945
056914,臺股指元大99購09,0,0,0,0,0,0,0,0,0,-2563000,0,0,0,89000,2652000,-2563000,-2563000
00655L,國泰中國A50正2  ,650000,43000,607000,0,0,0,0,0,0,-3218000,0,0,0,4665000,7883000,-3218000,-2611000
1402,遠東新          ,5444000,7734061,-2290061,0,0,0,71000,274000,-203000,-153000,94000,240000,-146000,0,7000,-7000,-2646061
2605,新興            ,2130000,380000,1750000,0,0,0,0,552500,-552500,-3943360,0,3937360,-3937360,0,6000,-6000,-2745860
057917,台積電凱基98購17,0,0,0,0,0,0,0,0,0,-2828000,0,0,0,150000,2978000,-2828000,-2828000
1301,台塑            ,7596000,10441579,-2845579,0,0,0,180000,337000,-157000,12000,112000,99000,13000,0,1000,-1000,-2990579
3042,晶技            ,2273000,5216000,-2943000,0,0,0,387000,500000,-113000,-43000,114000,99000,15000,16000,74000,-58000,-3099000
058595,T50正2元富99購01,0,0,0,0,0,0,0,0,0,-3180000,0,0,0,201000,3381000,-3180000,-3180000
9904,寶成            ,6398000,9824408,-3426408,0,0,0,43000,127000,-84000,62000,124000,73000,51000,11000,0,11000,-3448408
00692,富邦公司治理    ,1000,0,1000,0,0,0,0,0,0,-3491000,0,0,0,590000,4081000,-3491000,-3490000
5871,中租-KY         ,5348160,9189145,-3840985,0,0,0,33000,76800,-43800,-40000,165000,151000,14000,2000,56000,-54000,-3924785
4938,和碩            ,3807000,8739870,-4932870,0,0,0,36000,101000,-65000,974000,193000,165000,28000,967000,21000,946000,-4023870
2344,華邦電          ,18720000,14511512,4208488,0,0,0,32000,6755000,-6723000,-1576000,1057000,2309000,-1252000,84000,408000,-324000,-4090512
1326,台化            ,5870000,11177031,-5307031,0,0,0,253000,74000,179000,639000,41000,30000,11000,628000,0,628000,-4489031
056022,新光金群益97購02,0,0,0,0,0,0,0,0,0,-4492000,0,0,0,0,4492000,-4492000,-4492000
2883,開發金          ,24620000,30304810,-5684810,0,0,0,222000,0,222000,275000,249000,6000,243000,54000,22000,32000,-5187810
2002,中鋼            ,18753000,24190995,-5437995,0,0,0,217000,0,217000,32000,48000,6000,42000,10000,20000,-10000,-5188995
2382,廣達            ,4759778,10901744,-6141966,0,0,0,98000,126000,-28000,923000,318000,374000,-56000,997000,18000,979000,-5246966
2887,台新金          ,19788000,25362868,-5574868,0,0,0,160000,0,160000,111000,21000,2000,19000,102000,10000,92000,-5303868
1504,東元            ,2288000,7741000,-5453000,0,0,0,24000,0,24000,-14000,51000,48000,3000,0,17000,-17000,-5443000
3706,神達            ,1393000,5954000,-4561000,0,0,0,0,250000,-250000,-1027000,33000,1128000,-1095000,116000,48000,68000,-5838000
2880,華南金          ,15905000,22064207,-6159207,0,0,0,165000,0,165000,42000,42000,0,42000,4000,4000,0,-5952207
056829,台積電富邦9A購01,0,0,0,0,0,0,0,0,0,-5955000,0,0,0,19000,5974000,-5955000,-5955000
053564,台積電富邦99購01,0,1000,-1000,0,0,0,0,0,0,-5961000,0,0,0,0,5961000,-5961000,-5962000
2301,光寶科          ,4455000,11880517,-7425517,0,0,0,53000,150000,-97000,1161000,200000,312000,-112000,1277000,4000,1273000,-6361517
2801,彰銀            ,9826000,14752181,-4926181,0,0,0,127000,0,127000,-1908000,112000,2015000,-1903000,0,5000,-5000,-6707181
00631L,元大台灣50正2   ,126000,126000,0,0,0,0,0,0,0,-7363000,0,0,0,5396000,12759000,-7363000,-7363000
2313,華通            ,5943000,10630000,-4687000,0,0,0,280000,2776000,-2496000,-336000,1193000,1395000,-202000,114000,248000,-134000,-7519000
3711,日月光投控      ,6400000,14776989,-8376989,0,0,0,532000,156000,376000,150000,262000,129000,133000,21000,4000,17000,-7850989
2303,聯電            ,119662622,128992696,-9330074,0,0,0,295000,0,295000,865000,1980000,1316000,664000,278000,77000,201000,-8170074
2892,第一金          ,16380000,25531322,-9151322,0,0,0,171000,0,171000,153000,110000,1000,109000,52000,8000,44000,-8827322
2888,新光金          ,20978000,31378184,-10400184,0,0,0,186000,0,186000,965000,64000,7000,57000,1136000,228000,908000,-9249184
2834,臺企銀          ,14866000,24556535,-9690535,0,0,0,75000,4150,70850,36000,70000,0,70000,134000,168000,-34000,-9583685
2882,國泰金          ,16846849,26417354,-9570505,0,0,0,167000,95000,72000,-1135000,10000,937000,-927000,98000,306000,-208000,-10633505
2337,旺宏            ,18277000,27287000,-9010000,0,0,0,150000,1245000,-1095000,-680000,1282000,1674000,-392000,430000,718000,-288000,-10785000
2890,永豐金          ,17476200,28551005,-11074805,0,0,0,168000,0,168000,121000,124000,1000,123000,8000,10000,-2000,-10785805
00633L,富邦上証正2     ,1441000,4678000,-3237000,0,0,0,0,0,0,-7581000,0,0,0,11189000,18770000,-7581000,-10818000
00672L,元大S&P原油正2  ,48000,6587000,-6539000,0,0,0,0,0,0,-6045000,0,0,0,1302000,7347000,-6045000,-12584000
3231,緯創            ,5312000,15435661,-10123661,0,0,0,166000,4192000,-4026000,1506000,83000,521000,-438000,1950000,6000,1944000,-12643661
1101,台泥            ,18741000,33577775,-14836775,0,0,0,535000,230000,305000,1695000,69000,343000,-274000,1975000,6000,1969000,-12836775
2317,鴻海            ,25566663,40008585,-14441922,0,0,0,186000,0,186000,1060000,972000,795000,177000,1439000,556000,883000,-13195922
00642U,元大S&P石油     ,70000,7985000,-7915000,0,0,0,0,0,0,-8841000,0,0,0,4726000,13567000,-8841000,-16756000
00852L,國泰美國道瓊正2 ,0,1549000,-1549000,0,0,0,0,0,0,-17709000,0,0,0,80000,17789000,-17709000,-19258000
2884,玉山金          ,26823554,45975556,-19152002,0,0,0,174000,0,174000,-709000,527000,1357000,-830000,320000,199000,121000,-19687002
2885,元大金          ,14770000,35825425,-21055425,0,0,0,176000,0,176000,-1396479,430000,1796000,-1366000,54000,84479,-30479,-22275904
3481,群創            ,39811000,55506795,-15695795,0,0,0,0,8408000,-8408000,-575000,1821000,1442000,379000,556000,1510000,-954000,-24678795
0050,元大台灣50      ,973070,35822010,-34848940,0,0,0,82000,240000,-158000,7285000,671000,715000,-44000,10226000,2897000,7329000,-27721940
2886,兆豐金          ,18149000,52920930,-34771930,0,0,0,512000,239000,273000,2566000,601000,41000,560000,2044000,38000,2006000,-31932930
00715L,街口布蘭特油正2 ,57000,6264000,-6207000,0,0,0,0,0,0,-25750000,0,0,0,10000,25760000,-25750000,-31957000
2330,台積電          ,40390766,77919225,-37528459,0,0,0,633000,175000,458000,-214000,1789000,1391000,398000,368000,980000,-612000,-37284459
2891,中信金          ,36520617,76206384,-39685767,0,0,0,291000,0,291000,69000,571000,562000,9000,84000,24000,60000,-39325767
2409,友達            ,24777000,66991413,-42214413,0,0,0,78000,5000,73000,-398000,1679000,1619000,60000,132000,590000,-458000,-42539413
00637L,元大滬深300正2  ,8715000,10013000,-1298000,0,0,0,0,0,0,-49385000,0,0,0,50934000,100319000,-49385000,-50683000
0056,元大高股息      ,48000,8000,40000,0,0,0,170000,131000,39000,-74917000,1235000,70000,1165000,4784000,80866000,-76082000,-74838000
