證券代號,證券名稱,外陸資買進股數(不含外資自營商),外陸資賣出股數(不含外資自營商),外陸資買賣超股數(不含外資自營商),外資自營商買進股數,外資自營商賣出股數,外資自營商買賣超股數,投信買進股數,投信賣出股數,投信買賣超股數,自營商買賣超股數,自營商買進股數(自行買賣),自營商賣出股數(自行買賣),自營商買賣超股數(自行買賣),自營商買進股數(避險),自營商賣出股數(避險),自營商買賣超股數(避險),三大法人買賣超股數
00637L,元大滬深300正2  ,24066000,313000,23753000,0,0,0,0,0,0,32302000,0,0,0,45671000,13369000,32302000,56055000
3481,群創            ,73976826,23738807,50238019,0,0,0,176000,0,176000,4431000,219000,134000,85000,4916000,570000,4346000,54845019
2888,新光金          ,28072161,7017772,21054389,0,0,0,34000,0,34000,373000,159000,7000,152000,771000,550000,221000,21461389
2344,華邦電          ,16059000,4564000,11495000,0,0,0,15000,0,15000,919000,922000,70000,852000,220000,153000,67000,12429000
2409,友達            ,42673000,37715000,4958000,0,0,0,790000,0,790000,6370000,1596000,186000,1410000,6282000,1322000,4960000,12118000
0056,元大高股息      ,40000,46000,-6000,0,0,0,198000,0,198000,11731000,0,25000,-25000,12321000,565000,11756000,11923000
2883,開發金          ,17165000,8042000,9123000,0,0,0,41000,0,41000,536000,150000,0,150000,386000,0,386000,9700000
2324,仁寶            ,12470000,2952822,9517178,0,0,0,66000,0,66000,-382000,33000,7000,26000,41000,449000,-408000,9201178
2882,國泰金          ,11747000,2861941,8885059,0,0,0,31000,0,31000,124000,0,0,0,126000,2000,124000,9040059
2330,台積電          ,26336226,17876675,8459551,0,0,0,156000,24000,132000,217000,158000,190000,-32000,533000,284000,249000,8808551
2887,台新金          ,13101000,4815084,8285916,0,0,0,29000,0,29000,-53000,13000,18000,-5000,0,48000,-48000,8261916
00633L,富邦上証正2     ,851000,233000,618000,0,0,0,0,0,0,7414000,0,150000,-150000,9626000,2062000,7564000,8032000
2368,金像電          ,11595000,7630000,3965000,0,0,0,1399000,0,1399000,1727000,2193000,725000,1468000,363000,104000,259000,7091000
6116,彩晶            ,8134000,2614000,5520000,0,0,0,0,0,0,1248000,377000,40000,337000,947000,36000,911000,6768000
0050,元大台灣50      ,1919089,220000,1699089,0,0,0,0,0,0,4921000,931000,0,931000,6771000,2781000,3990000,6620089
2454,聯發科          ,7936699,2054764,5881935,0,0,0,129000,9000,120000,528000,321000,65000,256000,320000,48000,272000,6529935
2408,南亞科          ,7703100,2267000,5436100,0,0,0,7000,142000,-135000,895000,427000,1000,426000,611000,142000,469000,6196100
2353,宏碁            ,7691000,1616402,6074598,0,0,0,36000,0,36000,41000,131000,156000,-25000,116000,50000,66000,6151598
1402,遠東新          ,7816000,2007985,5808015,0,0,0,13000,0,13000,-27000,22000,22000,0,14000,41000,-27000,5794015
1303,南亞            ,7271000,1867893,5403107,0,0,0,209000,0,209000,52000,57000,6000,51000,1000,0,1000,5664107
2886,兆豐金          ,12400000,5190000,7210000,0,0,0,159000,1511000,-1352000,-230000,34000,14000,20000,0,250000,-250000,5628000
3037,欣興            ,7220000,2645000,4575000,0,0,0,129000,136000,-7000,1020000,780000,30000,750000,342000,72000,270000,5588000
2881,富邦金          ,9093000,4368813,4724187,0,0,0,88000,0,88000,234000,22000,2000,20000,220000,6000,214000,5046187
2823,中壽            ,6788000,1776107,5011893,0,0,0,10000,0,10000,-119000,38000,0,38000,129000,286000,-157000,4902893
2317,鴻海            ,15904926,12591939,3312987,0,0,0,317000,0,317000,985000,256000,1000,255000,789000,59000,730000,4614987
9904,寶成            ,6676000,2252632,4423368,0,0,0,8000,0,8000,87000,90000,24000,66000,23000,2000,21000,4518368
2603,長榮            ,4701000,815000,3886000,0,0,0,511000,0,511000,7000,7000,0,7000,0,0,0,4404000
2884,玉山金          ,11656000,8017399,3638601,0,0,0,32000,0,32000,716000,569000,2000,567000,149000,0,149000,4386601
2323,中環            ,5245000,1369000,3876000,0,0,0,0,0,0,307000,140000,32000,108000,334000,135000,199000,4183000
5880,合庫金          ,9958000,5925000,4033000,0,0,0,31000,0,31000,74000,63000,0,63000,58000,47000,11000,4138000
2002,中鋼            ,11787000,7820084,3966916,0,0,0,39000,0,39000,119000,35000,12000,23000,100000,4000,96000,4124916
2890,永豐金          ,9164000,5266500,3897500,0,0,0,163000,0,163000,46000,42000,0,42000,64000,60000,4000,4106500
2027,大成鋼          ,4573000,419000,4154000,0,0,0,8000,0,8000,-73000,63000,88000,-25000,456000,504000,-48000,4089000
00655L,國泰中國A50正2  ,529000,24000,505000,0,0,0,0,0,0,3525932,0,0,0,4971000,1445068,3525932,4030932
2327,國巨            ,3968000,2377500,1590500,0,0,0,1217000,2000,1215000,966000,404000,74000,330000,779000,143000,636000,3771500
5876,上海商銀        ,5156100,1619000,3537100,0,0,0,5000,0,5000,-27118,12000,41118,-29118,2000,0,2000,3514982
2801,彰銀            ,6025000,2578000,3447000,0,0,0,23000,0,23000,33000,28000,0,28000,5000,0,5000,3503000
2885,元大金          ,14928000,12709180,2218820,0,0,0,157000,0,157000,1125000,1230000,104000,1126000,4000,5000,-1000,3500820
2313,華通            ,4677000,3409000,1268000,0,0,0,885000,0,885000,1271000,613000,241000,372000,949000,50000,899000,3424000
00861,元大全球未來通訊,2024000,100000,1924000,0,0,0,0,0,0,1388000,0,0,0,2341000,953000,1388000,3312000
1326,台化            ,5761000,2466064,3294936,0,0,0,49000,0,49000,-79000,23000,24000,-1000,0,78000,-78000,3264936
1301,台塑            ,4548000,1560142,2987858,0,0,0,108000,13000,95000,155000,140000,0,140000,17000,2000,15000,3237858
2610,華航            ,6463000,3396590,3066410,0,0,0,8000,0,8000,59000,0,7000,-7000,66000,0,66000,3133410
2105,正新            ,4309000,1354424,2954576,0,0,0,3000,0,3000,79000,114000,29000,85000,22000,28000,-6000,3036576
00852L,國泰美國道瓊正2 ,3054000,3725000,-671000,0,0,0,0,0,0,3690000,0,0,0,10807000,7117000,3690000,3019000
3576,聯合再生        ,3337000,377000,2960000,0,0,0,0,0,0,0,0,0,0,0,0,0,2960000
1314,中石化          ,5204000,2696000,2508000,0,0,0,4000,0,4000,209000,290000,44000,246000,163000,200000,-37000,2721000
2618,長榮航          ,7969000,6342472,1626528,0,0,0,6000,0,6000,1023000,433000,140000,293000,775000,45000,730000,2655528
1718,中纖            ,2842000,216000,2626000,0,0,0,0,0,0,0,2000,2000,0,0,0,0,2626000
3682,亞太電          ,2968000,352925,2615075,0,0,0,0,0,0,0,0,0,0,0,0,0,2615075
2104,國際中橡        ,2817000,483000,2334000,0,0,0,0,0,0,33334,0,666,-666,34000,0,34000,2367334
2349,錸德            ,2650000,105224,2544776,0,0,0,0,200000,-200000,0,0,0,0,0,0,0,2344776
00631L,元大台灣50正2   ,799000,438000,361000,0,0,0,0,0,0,1969000,5000,0,5000,5597000,3633000,1964000,2330000
2363,矽統            ,3471000,1170000,2301000,0,0,0,0,0,0,16000,16000,0,16000,0,0,0,2317000
2504,國產            ,1873000,338000,1535000,0,0,0,633000,0,633000,130000,0,0,0,155000,25000,130000,2298000
4938,和碩            ,5783000,3458504,2324496,0,0,0,114000,0,114000,-142000,89000,130000,-41000,30000,131000,-101000,2296496
6153,嘉聯益          ,2297000,325000,1972000,0,0,0,0,0,0,308000,77000,68000,9000,330000,31000,299000,2280000
2347,聯強            ,3147000,716000,2431000,0,0,0,19000,0,19000,-177000,56000,10000,46000,0,223000,-223000,2273000
2449,京元電子        ,6514000,3993000,2521000,0,0,0,319000,0,319000,-574000,107000,540000,-433000,212000,353000,-141000,2266000
07082P,美律元大99售06  ,0,0,0,0,0,0,0,0,0,2194000,0,0,0,2844000,650000,2194000,2194000
2412,中華電          ,3364000,1274000,2090000,0,0,0,17000,109000,-92000,7000,29000,0,29000,0,22000,-22000,2005000
00850,元大臺灣ESG永續 ,0,0,0,0,0,0,0,0,0,1962000,0,0,0,2420000,458000,1962000,1962000
2379,瑞昱            ,2704000,1210568,1493432,0,0,0,596000,72000,524000,-86000,36000,153000,-117000,47000,16000,31000,1931432
2515,中工            ,2310000,472000,1838000,0,0,0,0,0,0,49000,54000,7000,47000,2000,0,2000,1887000
2201,裕隆            ,2411000,575000,1836000,0,0,0,0,0,0,20000,6000,0,6000,14000,0,14000,1856000
2371,大同            ,3259000,1440000,1819000,0,0,0,7000,0,7000,5000,7000,2000,5000,0,0,0,1831000
00875,國泰網路資安    ,0,0,0,0,0,0,0,0,0,1812000,0,0,0,2255000,443000,1812000,1812000
1909,榮成            ,2646000,678998,1967002,0,0,0,0,0,0,-160000,32000,192000,-160000,0,0,0,1807002
3711,日月光投控      ,5505000,4568826,936174,0,0,0,522000,0,522000,343000,205000,29000,176000,178000,11000,167000,1801174
053167,欣興群益96購03  ,0,0,0,0,0,0,0,0,0,1779000,0,0,0,1779000,0,1779000,1779000
059922,大立光元大99購25,0,0,0,0,0,0,0,0,0,1776000,0,0,0,1908000,132000,1776000,1776000
2474,可成            ,2628000,1061595,1566405,0,0,0,1000,0,1000,194000,94000,0,94000,113000,13000,100000,1761405
2014,中鴻            ,2102000,364000,1738000,0,0,0,0,0,0,0,0,0,0,0,0,0,1738000
3231,緯創            ,4500000,2805536,1694464,0,0,0,13000,0,13000,23000,214000,4000,210000,89000,276000,-187000,1730464
2505,國揚            ,1752000,323000,1429000,0,0,0,0,0,0,301000,0,9000,-9000,370000,60000,310000,1730000
2609,陽明            ,1931000,203000,1728000,0,0,0,0,0,0,0,0,0,0,0,0,0,1728000
2633,台灣高鐵        ,2603000,908000,1695000,0,0,0,6000,0,6000,27000,22000,48000,-26000,65000,12000,53000,1728000
2867,三商壽          ,2140000,452000,1688000,0,0,0,0,0,0,7000,7000,0,7000,0,0,0,1695000
6278,台表科          ,2174000,1199000,975000,0,0,0,424000,0,424000,287000,320000,130000,190000,98000,1000,97000,1686000
057770,亞德客群益98購01,0,0,0,0,0,0,0,0,0,1676000,0,0,0,1754000,78000,1676000,1676000
8112,至上            ,2345000,767000,1578000,0,0,0,0,0,0,39000,39000,0,39000,0,0,0,1617000
055037,宏盛富邦99購01  ,0,0,0,0,0,0,0,0,0,1576000,0,0,0,1946000,370000,1576000,1576000
9907,統一實          ,1913000,337000,1576000,0,0,0,0,0,0,0,0,0,0,0,0,0,1576000
3023,信邦            ,1537924,280300,1257624,0,0,0,181000,0,181000,129000,103000,24000,79000,50000,0,50000,1567624
059883,T50反1國票99購02,0,0,0,0,0,0,0,0,0,1557000,0,0,0,1637000,80000,1557000,1557000
2356,英業達          ,11992000,10390624,1601376,0,0,0,49000,0,49000,-111125,191000,49125,141875,270000,523000,-253000,1539251
3673,TPK-KY          ,1781000,424000,1357000,0,0,0,0,0,0,160000,52000,8000,44000,118000,2000,116000,1517000
1714,和桐            ,1917000,406000,1511000,0,0,0,0,0,0,0,0,0,0,0,0,0,1511000
2354,鴻準            ,2072000,496376,1575624,0,0,0,10000,107000,-97000,0,14000,14000,0,0,0,0,1478624
2308,台達電          ,3815000,1789587,2025413,0,0,0,6000,500000,-494000,-66000,38000,138000,-100000,50000,16000,34000,1465413
2301,光寶科          ,2466000,1246000,1220000,0,0,0,146000,0,146000,94000,96000,1000,95000,156000,157000,-1000,1460000
2614,東森            ,2055000,650000,1405000,0,0,0,0,0,0,0,0,0,0,0,0,0,1405000
057270,遠東新元大98購01,0,0,0,0,0,0,0,0,0,1383000,0,0,0,1670000,287000,1383000,1383000
1789,神隆            ,1596000,351000,1245000,0,0,0,0,0,0,136000,60000,0,60000,110000,34000,76000,1381000
4958,臻鼎-KY         ,2707000,1321144,1385856,0,0,0,2000,0,2000,-11000,5000,11000,-6000,6000,11000,-5000,1376856
060294,嘉澤元大9A購01  ,0,0,0,0,0,0,0,0,0,1359000,0,0,0,1453000,94000,1359000,1359000
059307,T50反1元大99購06,0,0,0,0,0,0,0,0,0,1354000,0,0,0,1761000,407000,1354000,1354000
00708L,元大S&P黃金正2  ,0,0,0,0,0,0,0,0,0,1332000,0,0,0,2245000,913000,1332000,1332000
5871,中租-KY         ,1889000,666808,1222192,0,0,0,4000,0,4000,38000,18000,6000,12000,27000,1000,26000,1264192
1409,新纖            ,1664000,401000,1263000,0,0,0,0,0,0,0,0,0,0,0,0,0,1263000
3045,台灣大          ,2426000,1086000,1340000,0,0,0,26000,58000,-32000,-58000,17000,55000,-38000,0,20000,-20000,1250000
2498,宏達電          ,1723000,790000,933000,0,0,0,3000,0,3000,311000,82000,10000,72000,280000,41000,239000,1247000
9945,潤泰新          ,2415000,1205798,1209202,0,0,0,6000,0,6000,8000,32000,5000,27000,0,19000,-19000,1223202
2049,上銀            ,3028000,2022149,1005851,0,0,0,38000,0,38000,176000,59000,22000,37000,149000,10000,139000,1219851
9802,鈺齊-KY         ,1511000,214000,1297000,0,0,0,0,157000,-157000,56000,5000,1000,4000,54000,2000,52000,1196000
8046,南電            ,2743000,1932000,811000,0,0,0,284000,0,284000,95000,146000,96000,50000,119000,74000,45000,1190000
3036,文曄            ,723000,40000,683000,0,0,0,1000,0,1000,504000,491000,410000,81000,423000,0,423000,1188000
3041,揚智            ,1260000,95000,1165000,0,0,0,0,0,0,3000,3000,0,3000,0,0,0,1168000
1907,永豐餘          ,1565000,412000,1153000,0,0,0,0,0,0,0,0,0,0,0,0,0,1153000
050170,臺指反元大97購02,0,0,0,0,0,0,0,0,0,1148000,0,0,0,1744000,596000,1148000,1148000
058083,聯發科群益98購08,0,0,0,0,0,0,0,0,0,1148000,0,0,0,1148000,0,1148000,1148000
1216,統一            ,5839000,4646155,1192845,0,0,0,15000,80000,-65000,18119,28000,12881,15119,3000,0,3000,1145964
1102,亞泥            ,3064000,2292367,771633,0,0,0,583000,0,583000,-217000,17000,8000,9000,0,226000,-226000,1137633
3017,奇鋐            ,1398000,2314000,-916000,0,0,0,2076000,0,2076000,-36000,305000,165000,140000,137000,313000,-176000,1124000
2601,益航            ,1654000,628000,1026000,0,0,0,0,0,0,87000,87000,0,87000,0,0,0,1113000
3049,和鑫            ,1656000,560000,1096000,0,0,0,0,0,0,0,0,0,0,0,0,0,1096000
2845,遠東銀          ,1366000,283000,1083000,0,0,0,5000,0,5000,0,0,0,0,0,0,0,1088000
060093,友達元大03購01  ,0,0,0,0,0,0,0,0,0,1086000,0,0,0,1442000,356000,1086000,1086000
061164,燿華兆豐9B購01  ,0,0,0,0,0,0,0,0,0,1079000,0,0,0,1188000,109000,1079000,1079000
052852,國巨元富96購02  ,0,0,0,0,0,0,0,0,0,1076000,0,0,0,1076000,0,1076000,1076000
061001,智邦兆豐9B購01  ,0,0,0,0,0,0,0,0,0,1059000,0,0,0,1459000,400000,1059000,1059000
1434,福懋            ,1743000,739000,1004000,0,0,0,12000,0,12000,23000,26000,3000,23000,0,0,0,1039000
1736,喬山            ,1233000,242000,991000,0,0,0,0,0,0,48000,0,28000,-28000,81000,5000,76000,1039000
00670L,富邦NASDAQ正2   ,28000,25000,3000,0,0,0,0,0,0,1027000,0,0,0,1883000,856000,1027000,1030000
2542,興富發          ,1860000,841000,1019000,0,0,0,11000,0,11000,0,48000,86000,-38000,38000,0,38000,1030000
00830,國泰費城半導體  ,305000,1000,304000,0,0,0,0,0,0,703000,275000,0,275000,579000,151000,428000,1007000
6191,精成科          ,1111000,110000,1001000,0,0,0,0,0,0,0,0,0,0,0,0,0,1001000
058933,FBVIX台新9B購01 ,0,0,0,0,0,0,0,0,0,997000,0,0,0,998000,1000,997000,997000
047972,康控富邦95購01  ,0,0,0,0,0,0,0,0,0,994000,0,0,0,994000,0,994000,994000
6120,達運            ,1122000,129000,993000,0,0,0,0,0,0,0,0,0,0,0,0,0,993000
2492,華新科          ,2918000,3264000,-346000,0,0,0,440000,4000,436000,899000,407000,223000,184000,1024000,309000,715000,989000
2838,聯邦銀          ,1121000,136000,985000,0,0,0,0,0,0,0,0,0,0,0,0,0,985000
060698,旺宏國泰9C購01  ,0,0,0,0,0,0,0,0,0,973000,0,0,0,1283000,310000,973000,973000
00686R,群益臺灣加權反1 ,0,0,0,0,0,0,0,0,0,967000,0,0,0,1606000,639000,967000,967000
3026,禾伸堂          ,1841000,917000,924000,0,0,0,20000,30000,-10000,52000,0,0,0,151000,99000,52000,966000
3006,晶豪科          ,1010000,230000,780000,0,0,0,0,0,0,168000,68000,10000,58000,140000,30000,110000,948000
2345,智邦            ,4715000,3603944,1111056,0,0,0,2000,35000,-33000,-143000,26000,55000,-29000,19000,133000,-114000,935056
2834,臺企銀          ,7398000,6557000,841000,0,0,0,9000,0,9000,80399,71000,601,70399,12000,2000,10000,930399
057841,茂林富邦9A購02  ,0,0,0,0,0,0,0,0,0,906000,0,0,0,1085000,179000,906000,906000
2897,王道銀行        ,1124000,222000,902000,0,0,0,3000,0,3000,0,0,0,0,0,0,0,905000
2328,廣宇            ,963000,128000,835000,0,0,0,0,0,0,52000,52000,0,52000,0,0,0,887000
07292P,臺股指凱基99售44,0,0,0,0,0,0,0,0,0,883000,0,0,0,1283000,400000,883000,883000
2392,正崴            ,1132000,287000,845000,0,0,0,0,0,0,27000,30000,28000,2000,31000,6000,25000,872000
07545P,玉晶光凱基9A售07,0,0,0,0,0,0,0,0,0,863000,0,0,0,1057000,194000,863000,863000
07459P,緯穎元大9A售01  ,0,0,0,0,0,0,0,0,0,848000,0,0,0,890000,42000,848000,848000
1308,亞聚            ,1049000,203000,846000,0,0,0,0,0,0,0,0,0,0,0,0,0,846000
3019,亞光            ,997000,350000,647000,0,0,0,0,0,0,196000,138000,18000,120000,78000,2000,76000,843000
3702,大聯大          ,1710000,575000,1135000,0,0,0,23000,0,23000,-316000,0,62000,-62000,0,254000,-254000,842000
9910,豐泰            ,1350020,784411,565609,0,0,0,244000,0,244000,31000,33000,2000,31000,0,0,0,840609
9914,美利達          ,783000,724000,59000,0,0,0,723000,0,723000,56000,74000,18000,56000,0,0,0,838000
053018,旺宏元富96購02  ,0,0,0,0,0,0,0,0,0,833000,0,0,0,943000,110000,833000,833000
057539,南茂元大98購02  ,0,0,0,0,0,0,0,0,0,826000,0,0,0,1033000,207000,826000,826000
058380,臺股指凱基99購15,0,0,0,0,0,0,0,0,0,815000,0,0,0,815000,0,815000,815000
3380,明泰            ,927000,215000,712000,0,0,0,0,0,0,73000,31000,79000,-48000,175000,54000,121000,785000
061084,京元電兆豐9A購02,0,0,0,0,0,0,0,0,0,783000,0,0,0,803000,20000,783000,783000
060632,可成富邦9B購01  ,0,0,0,0,0,0,0,0,0,781000,0,0,0,1296000,515000,781000,781000
053347,茂林國票98購01  ,0,0,0,0,0,0,0,0,0,766000,0,0,0,774000,8000,766000,766000
07147P,高鐵元大99售01  ,0,0,0,0,0,0,0,0,0,758000,0,0,0,810000,52000,758000,758000
4968,立積            ,1331000,876440,454560,0,0,0,41000,0,41000,261000,160000,13000,147000,139000,25000,114000,756560
6592,和潤企業        ,603000,122000,481000,0,0,0,240000,0,240000,34000,0,0,0,43000,9000,34000,755000
00647L,元大S&P500正2   ,32000,23000,9000,0,0,0,0,0,0,737000,0,0,0,1190000,453000,737000,746000
2889,國票金          ,1002000,288390,713610,0,0,0,0,0,0,32000,32000,0,32000,0,0,0,745610
3090,日電貿          ,819000,169480,649520,0,0,0,0,0,0,83000,14000,3000,11000,79000,7000,72000,732520
1762,中化生          ,795000,434100,360900,0,0,0,296000,0,296000,74000,90000,16000,74000,0,0,0,730900
059865,國巨凱基01購01  ,0,0,0,0,0,0,0,0,0,729000,0,0,0,1344000,615000,729000,729000
1795,美時            ,835000,116000,719000,0,0,0,0,0,0,6000,9000,3000,6000,0,0,0,725000
06999P,玉晶光國票9B售01,0,0,0,0,0,0,0,0,0,714000,0,0,0,717000,3000,714000,714000
056167,力成台新97購01  ,0,0,0,0,0,0,0,0,0,707000,0,0,0,707000,0,707000,707000
053088,奇鋐元大98購01  ,0,0,0,0,0,0,0,0,0,699000,0,0,0,699000,0,699000,699000
061118,GIS富邦9A購01   ,0,0,0,0,0,0,0,0,0,695000,0,0,0,1069000,374000,695000,695000
6005,群益證          ,1473000,778000,695000,0,0,0,0,0,0,0,0,0,0,0,0,0,695000
2605,新興            ,824000,162000,662000,0,0,0,0,0,0,27000,27000,0,27000,0,0,0,689000
1513,中興電          ,737000,151000,586000,0,0,0,0,0,0,101000,9000,12000,-3000,104000,0,104000,687000
055710,亞德客元大97購03,0,0,0,0,0,0,0,0,0,683000,0,0,0,736000,53000,683000,683000
5521,工信            ,917000,234000,683000,0,0,0,0,0,0,0,0,0,0,0,0,0,683000
5388,中磊            ,735000,149000,586000,0,0,0,0,15000,-15000,110000,26000,0,26000,87000,3000,84000,681000
058153,景碩統一9B購01  ,0,0,0,0,0,0,0,0,0,680000,0,0,0,682000,2000,680000,680000
6505,台塑化          ,3086000,2645257,440743,0,0,0,209000,13000,196000,40995,66000,25005,40995,0,0,0,677738
4904,遠傳            ,2264000,1586000,678000,0,0,0,41000,46000,-5000,-4000,2000,4000,-2000,0,2000,-2000,669000
049064,T50反1凱基96購03,0,0,0,0,0,0,0,0,0,658000,0,0,0,658000,0,658000,658000
2406,國碩            ,784000,126000,658000,0,0,0,0,0,0,0,0,0,0,0,0,0,658000
9938,百和            ,1008000,459000,549000,0,0,0,446000,450000,-4000,110000,38000,25000,13000,107000,10000,97000,655000
057532,智原元大98購03  ,0,0,0,0,0,0,0,0,0,653000,0,0,0,736000,83000,653000,653000
1905,華紙            ,893000,245000,648000,0,0,0,0,0,0,0,0,0,0,0,0,0,648000
2841,台開            ,844000,230000,614000,0,0,0,0,0,0,29000,29000,0,29000,0,0,0,643000
1440,南紡            ,1135000,492052,642948,0,0,0,0,0,0,0,0,0,0,0,0,0,642948
2387,精元            ,1026000,475000,551000,0,0,0,0,0,0,88000,8000,15000,-7000,96000,1000,95000,639000
055518,華新科中信99購01,0,0,0,0,0,0,0,0,0,634000,0,0,0,634000,0,634000,634000
4943,康控-KY         ,903000,251000,652000,0,0,0,0,0,0,-18000,6000,58000,-52000,46000,12000,34000,634000
2520,冠德            ,603000,70000,533000,0,0,0,0,0,0,98000,79000,1000,78000,20000,0,20000,631000
2352,佳世達          ,2285000,1479000,806000,0,0,0,22000,400000,-378000,200000,200000,0,200000,0,0,0,628000
06652P,長榮航元大98售01,0,0,0,0,0,0,0,0,0,625000,0,0,0,625000,0,625000,625000
9935,慶豐富          ,959000,334000,625000,0,0,0,0,0,0,0,0,0,0,0,0,0,625000
1717,長興            ,475000,330000,145000,0,0,0,472000,0,472000,0,0,0,0,0,0,0,617000
1310,台苯            ,1071000,466000,605000,0,0,0,0,0,0,8000,0,0,0,8000,0,8000,613000
2375,凱美            ,949000,363000,586000,0,0,0,0,0,0,25000,0,0,0,25000,0,25000,611000
060123,光罩永豐99購02  ,0,0,0,0,0,0,0,0,0,610000,0,0,0,735000,125000,610000,610000
2031,新光鋼          ,695000,84000,611000,0,0,0,0,0,0,-4000,0,4000,-4000,0,0,0,607000
2880,華南金          ,8644000,8023110,620890,0,0,0,31000,0,31000,-45000,23000,68000,-45000,0,0,0,606890
2023,燁輝            ,871000,265000,606000,0,0,0,0,0,0,0,0,0,0,0,0,0,606000
3338,泰碩            ,604000,219000,385000,0,0,0,108000,40000,68000,152000,42000,32000,10000,152000,10000,142000,605000
2912,統一超          ,1665000,1057000,608000,0,0,0,3000,10000,-7000,3000,3000,0,3000,0,0,0,604000
1609,大亞            ,759000,158000,601000,0,0,0,1000,0,1000,0,0,0,0,0,0,0,602000
3535,晶彩科          ,651000,51000,600000,0,0,0,0,0,0,0,0,0,0,0,0,0,600000
1309,台達化          ,688000,89000,599000,0,0,0,0,0,0,0,0,0,0,0,0,0,599000
2615,萬海            ,748000,153000,595000,0,0,0,3000,0,3000,0,0,0,0,0,0,0,598000
6196,帆宣            ,564000,172000,392000,0,0,0,169000,0,169000,33000,0,0,0,33000,0,33000,594000
060957,SP黃豆凱基9A購04,0,0,0,0,0,0,0,0,0,592000,0,0,0,619000,27000,592000,592000
06879P,長榮航凱基98售02,0,0,0,0,0,0,0,0,0,590000,0,0,0,590000,0,590000,590000
00640L,富邦日本正2     ,8000,0,8000,0,0,0,0,0,0,575000,0,0,0,919000,344000,575000,583000
051888,國巨元富95購05  ,0,0,0,0,0,0,0,0,0,579000,0,0,0,579000,0,579000,579000
059127,國巨中信99購04  ,0,0,0,0,0,0,0,0,0,577000,0,0,0,611000,34000,577000,577000
8028,昇陽半導體      ,729000,174000,555000,0,0,0,0,0,0,18000,0,0,0,19000,1000,18000,573000
061262,智邦凱基9A購02  ,0,0,0,0,0,0,0,0,0,570000,0,0,0,600000,30000,570000,570000
00675L,富邦臺灣加權正2 ,0,0,0,0,0,0,0,0,0,569000,0,0,0,745000,176000,569000,569000
060539,道瓊反凱基9A購01,0,0,0,0,0,0,0,0,0,565000,0,0,0,689000,124000,565000,565000
057446,旺宏元富02購01  ,0,0,0,0,0,0,0,0,0,559000,0,0,0,622000,63000,559000,559000
2456,奇力新          ,1027000,1154000,-127000,0,0,0,328000,0,328000,348000,167000,87000,80000,308000,40000,268000,549000
2382,廣達            ,4351000,4098904,252096,0,0,0,528000,0,528000,-233000,44000,206000,-162000,56000,127000,-71000,547096
060942,智邦國票9A購02  ,0,0,0,0,0,0,0,0,0,542000,0,0,0,558000,16000,542000,542000
056121,勤誠群益97購01  ,0,0,0,0,0,0,0,0,0,542000,0,0,0,879000,337000,542000,542000
058241,景碩元大99購05  ,0,0,0,0,0,0,0,0,0,534000,0,0,0,600000,66000,534000,534000
6504,南六            ,877000,346000,531000,0,0,0,10000,0,10000,-12000,4000,33000,-29000,32000,15000,17000,529000
2455,全新            ,732000,269000,463000,0,0,0,0,0,0,65000,59000,78000,-19000,96000,12000,84000,528000
07010P,T50正2凱基9C售01,0,0,0,0,0,0,0,0,0,524000,0,0,0,550000,26000,524000,524000
055745,臻鼎元富97購01  ,0,0,0,0,0,0,0,0,0,520000,0,0,0,520000,0,520000,520000
060186,義隆元富9A購01  ,0,0,0,0,0,0,0,0,0,519000,0,0,0,735000,216000,519000,519000
053387,緯創元大97購01  ,0,0,0,0,0,0,0,0,0,515000,0,0,0,515000,0,515000,515000
06869P,金融類元大99售01,0,0,0,0,0,0,0,0,0,514000,0,0,0,515000,1000,514000,514000
07557P,玉晶光元大9A售09,0,0,0,0,0,0,0,0,0,512000,0,0,0,644000,132000,512000,512000
6443,元晶            ,555000,44000,511000,0,0,0,0,0,0,0,0,0,0,0,0,0,511000
4934,太極            ,546000,38654,507346,0,0,0,0,0,0,0,0,0,0,0,0,0,507346
05565P,鎧勝元大96售01  ,0,0,0,0,0,0,0,0,0,502000,0,0,0,507000,5000,502000,502000
4915,致伸            ,684000,215000,469000,0,0,0,0,0,0,33000,0,0,0,34000,1000,33000,502000
053917,友達國票97購03  ,0,0,0,0,0,0,0,0,0,501000,0,0,0,501000,0,501000,501000
2355,敬鵬            ,595000,125000,470000,0,0,0,0,0,0,31000,15000,8000,7000,24000,0,24000,501000
2357,華碩            ,1122000,621250,500750,0,0,0,11000,0,11000,-11000,22000,0,22000,0,33000,-33000,500750
07546P,玉晶光凱基9A售09,0,0,0,0,0,0,0,0,0,500000,0,0,0,698000,198000,500000,500000
051396,健鼎兆豐95購01  ,0,0,0,0,0,0,0,0,0,499000,0,0,0,499000,0,499000,499000
050919,台積電凱基95購03,0,0,0,0,0,0,0,0,0,499000,0,0,0,499000,0,499000,499000
055032,億光富邦99購01  ,0,0,0,0,0,0,0,0,0,497000,0,0,0,497000,0,497000,497000
050796,燿華中信95購01  ,0,0,0,0,0,0,0,0,0,495000,0,0,0,495000,0,495000,495000
049216,華邦電國票95購01,0,0,0,0,0,0,0,0,0,495000,0,0,0,495000,0,495000,495000
050656,瑞儀凱基96購01  ,0,0,0,0,0,0,0,0,0,494000,0,0,0,494000,0,494000,494000
3406,玉晶光          ,723000,586000,137000,0,0,0,0,116000,-116000,473000,326000,61000,265000,289000,81000,208000,494000
059629,友達凱基99購06  ,0,0,0,0,0,0,0,0,0,491000,0,0,0,756000,265000,491000,491000
1590,亞德客-KY       ,872800,406816,465984,0,0,0,25000,10000,15000,7000,9000,3000,6000,15000,14000,1000,487984
4414,如興            ,888000,403000,485000,0,0,0,0,0,0,0,0,0,0,0,0,0,485000
1313,聯成            ,905000,420191,484809,0,0,0,0,0,0,0,0,0,0,0,0,0,484809
1217,愛之味          ,522000,38000,484000,0,0,0,0,0,0,0,0,0,0,0,0,0,484000
1464,得力            ,580000,98000,482000,0,0,0,0,0,0,0,0,0,0,0,0,0,482000
03435B,臺股指凱基99熊29,0,0,0,0,0,0,0,0,0,480000,0,0,0,1055000,575000,480000,480000
051056,華新科群益95購03,0,0,0,0,0,0,0,0,0,477000,0,0,0,477000,0,477000,477000
07640P,國巨群益9A售07  ,0,0,0,0,0,0,0,0,0,477000,0,0,0,734000,257000,477000,477000
060218,台積電凱基9A購15,0,0,0,0,0,0,0,0,0,474000,0,0,0,502000,28000,474000,474000
06553P,訊芯元大98售05  ,0,0,0,0,0,0,0,0,0,474000,0,0,0,625000,151000,474000,474000
06535P,可成群益99售02  ,0,0,0,0,0,0,0,0,0,474000,0,0,0,504000,30000,474000,474000
057746,同欣電永豐98購02,0,0,0,0,0,0,0,0,0,473000,0,0,0,473000,0,473000,473000
2360,致茂            ,424000,169000,255000,0,0,0,0,29000,-29000,245000,181000,14000,167000,80000,2000,78000,471000
054072,台積電富邦98購02,0,0,0,0,0,0,0,0,0,470000,0,0,0,500000,30000,470000,470000
1312,國喬            ,1436000,1019000,417000,0,0,0,0,0,0,53000,53000,0,53000,0,0,0,470000
1710,東聯            ,1219000,332000,887000,0,0,0,0,0,0,-420000,0,420000,-420000,0,0,0,467000
2208,台船            ,502000,35000,467000,0,0,0,0,0,0,0,0,0,0,0,0,0,467000
3016,嘉晶            ,599000,352000,247000,0,0,0,0,0,0,219000,40000,0,40000,204000,25000,179000,466000
3706,神達            ,965000,682000,283000,0,0,0,3000,0,3000,178000,19000,0,19000,168000,9000,159000,464000
057605,旺宏統一99購03  ,0,0,0,0,0,0,0,0,0,462000,0,0,0,473000,11000,462000,462000
054400,健策永豐96購02  ,0,0,0,0,0,0,0,0,0,461000,0,0,0,461000,0,461000,461000
060046,S&P反1凱基99購02,0,0,0,0,0,0,0,0,0,460000,0,0,0,534000,74000,460000,460000
057817,景碩元大98購01  ,0,0,0,0,0,0,0,0,0,458000,0,0,0,474000,16000,458000,458000
047962,T50反1中信96購02,0,0,0,0,0,0,0,0,0,457000,0,0,0,1531000,1074000,457000,457000
057408,台郡群益98購01  ,0,0,0,0,0,0,0,0,0,454000,0,0,0,485000,31000,454000,454000
2903,遠百            ,772000,318000,454000,0,0,0,0,0,0,0,0,0,0,0,0,0,454000
1722,台肥            ,618000,199000,419000,0,0,0,8000,0,8000,25000,13000,0,13000,12000,0,12000,452000
061132,志超永豐9A購01  ,0,0,0,0,0,0,0,0,0,451000,0,0,0,471000,20000,451000,451000
00636,國泰中國A50     ,328000,0,328000,0,0,0,0,0,0,123000,0,0,0,1184000,1061000,123000,451000
8110,華東            ,813000,311000,502000,0,0,0,0,0,0,-51000,13000,64000,-51000,0,0,0,451000
054002,GIS群益96購03   ,0,0,0,0,0,0,0,0,0,448000,0,0,0,542000,94000,448000,448000
1304,台聚            ,738000,290000,448000,0,0,0,0,0,0,0,0,0,0,0,0,0,448000
5531,鄉林            ,561000,115000,446000,0,0,0,0,0,0,0,0,0,0,0,0,0,446000
4919,新唐            ,483000,65000,418000,0,0,0,0,0,0,26000,0,0,0,26000,0,26000,444000
3062,建漢            ,473000,31000,442000,0,0,0,0,0,0,0,0,0,0,0,0,0,442000
054471,T50反1中信9C購01,0,0,0,0,0,0,0,0,0,440000,0,0,0,571000,131000,440000,440000
03440B,臺股指元大9B熊02,0,0,0,0,0,0,0,0,0,440000,0,0,0,2740000,2300000,440000,440000
059898,T50反1元大99購15,0,0,0,0,0,0,0,0,0,437000,0,0,0,482000,45000,437000,437000
2836,高雄銀          ,451000,33000,418000,0,0,0,0,0,0,18000,18000,0,18000,0,0,0,436000
058383,道瓊指中信9C購02,0,0,0,0,0,0,0,0,0,433000,0,0,0,433000,0,433000,433000
060411,達新永豐9A購01  ,0,0,0,0,0,0,0,0,0,431000,0,0,0,491000,60000,431000,431000
057927,勤誠凱基98購01  ,0,0,0,0,0,0,0,0,0,430000,0,0,0,450000,20000,430000,430000
056699,光罩國泰99購01  ,0,0,0,0,0,0,0,0,0,430000,0,0,0,430000,0,430000,430000
1701,中化            ,484000,58000,426000,0,0,0,0,0,0,4000,4000,0,4000,0,0,0,430000
020012,富邦行動通訊N   ,0,0,0,0,0,0,0,0,0,428000,0,0,0,466000,38000,428000,428000
00634R,富邦上証反1     ,245000,158000,87000,0,0,0,0,0,0,340000,0,0,0,1441000,1101000,340000,427000
5519,隆大            ,495000,68000,427000,0,0,0,0,0,0,0,0,0,0,0,0,0,427000
2369,菱生            ,770000,344000,426000,0,0,0,0,0,0,0,0,0,0,0,0,0,426000
2489,瑞軒            ,537000,135000,402000,0,0,0,0,0,0,24000,24000,0,24000,0,0,0,426000
07334P,臺股指國票99售19,0,0,0,0,0,0,0,0,0,425000,0,0,0,812000,387000,425000,425000
054158,國巨日盛99購01  ,0,0,0,0,0,0,0,0,0,423000,0,0,0,429000,6000,423000,423000
056673,中石化元富9B購01,0,0,0,0,0,0,0,0,0,419000,0,0,0,981000,562000,419000,419000
6452,康友-KY         ,437000,72948,364052,0,0,0,0,0,0,52000,3000,0,3000,54000,5000,49000,416052
060172,智原台新9A購01  ,0,0,0,0,0,0,0,0,0,415000,0,0,0,415000,0,415000,415000
053864,義隆元大96購01  ,0,0,0,0,0,0,0,0,0,411000,0,0,0,604000,193000,411000,411000
00752,中信中國50      ,2000,0,2000,0,0,0,0,0,0,403991,0,0,0,563000,159009,403991,405991
2362,藍天            ,489000,86000,403000,0,0,0,0,0,0,0,0,0,0,0,0,0,403000
4725,信昌化          ,438000,36000,402000,0,0,0,0,0,0,0,0,0,0,0,0,0,402000
053959,晶豪科永豐96購02,0,0,0,0,0,0,0,0,0,401000,0,0,0,401000,0,401000,401000
056634,為升兆豐99購01  ,0,0,0,0,0,0,0,0,0,401000,0,0,0,401000,0,401000,401000
3661,世芯-KY         ,949000,1033080,-84080,0,0,0,0,0,0,485000,365000,37000,328000,179000,22000,157000,400920
053300,大成鋼凱基96購02,0,0,0,0,0,0,0,0,0,400000,0,0,0,400000,0,400000,400000
050715,台積電群益96購01,0,0,0,0,0,0,0,0,0,400000,0,0,0,400000,0,400000,400000
050169,臺指反元大97購01,0,0,0,0,0,0,0,0,0,400000,0,0,0,400000,0,400000,400000
053368,京元電富邦98購01,0,0,0,0,0,0,0,0,0,399000,0,0,0,410000,11000,399000,399000
1711,永光            ,474000,75000,399000,0,0,0,0,0,0,0,0,0,0,0,0,0,399000
5522,遠雄            ,786000,413000,373000,0,0,0,3000,0,3000,20000,20000,0,20000,0,0,0,396000
2607,榮運            ,626000,235000,391000,0,0,0,0,0,0,0,0,0,0,0,0,0,391000
2365,昆盈            ,405000,16000,389000,0,0,0,0,0,0,0,0,0,0,0,0,0,389000
059631,京元電凱基99購02,0,0,0,0,0,0,0,0,0,387000,0,0,0,493000,106000,387000,387000
03678C,臺股指凱基01牛02,0,0,0,0,0,0,0,0,0,385000,0,0,0,957000,572000,385000,385000
00678,群益NBI生技     ,123000,0,123000,0,0,0,0,0,0,261000,0,0,0,561000,300000,261000,384000
07568P,鴻海凱基9A售22  ,0,0,0,0,0,0,0,0,0,384000,0,0,0,385000,1000,384000,384000
4426,利勤            ,483000,106000,377000,0,0,0,0,0,0,7000,0,0,0,15000,8000,7000,384000
059628,智邦凱基99購04  ,0,0,0,0,0,0,0,0,0,380000,0,0,0,401000,21000,380000,380000
053183,大立光元富96購03,0,0,0,0,0,0,0,0,0,380000,0,0,0,380000,0,380000,380000
2421,建準            ,483000,225000,258000,0,0,0,0,0,0,122000,6000,2000,4000,135000,17000,118000,380000
055345,國巨凱基98購01  ,0,0,0,0,0,0,0,0,0,379000,0,0,0,389000,10000,379000,379000
5305,敦南            ,531000,154000,377000,0,0,0,0,0,0,0,0,0,0,0,0,0,377000
060337,FBVIX統一9A購01 ,0,40000,-40000,0,0,0,0,0,0,415000,0,0,0,425000,10000,415000,375000
053297,鎧勝中信98購01  ,0,0,0,0,0,0,0,0,0,375000,0,0,0,395000,20000,375000,375000
04831P,聯詠富邦96售01  ,0,0,0,0,0,0,0,0,0,374000,0,0,0,459000,85000,374000,374000
058663,瑞儀兆豐9A購01  ,0,0,0,0,0,0,0,0,0,374000,0,0,0,878000,504000,374000,374000
6282,康舒            ,470000,96000,374000,0,0,0,0,0,0,0,3000,0,3000,1000,4000,-3000,374000
058136,景碩元大99購02  ,0,0,0,0,0,0,0,0,0,373000,0,0,0,397000,24000,373000,373000
4960,誠美材          ,440000,67000,373000,0,0,0,0,0,0,0,0,0,0,0,0,0,373000
4532,瑞智            ,431000,62000,369000,0,0,0,0,0,0,0,0,0,0,0,0,0,369000
060976,SP黃豆元大9A購03,0,0,0,0,0,0,0,0,0,368000,0,0,0,418000,50000,368000,368000
2377,微星            ,769000,459792,309208,0,0,0,4000,0,4000,54000,148000,2000,146000,10000,102000,-92000,367208
2207,和泰車          ,531000,173976,357024,0,0,0,8000,0,8000,1000,1000,0,1000,0,0,0,366024
061021,聯電國泰9B購01  ,5000,10000,-5000,0,0,0,0,0,0,370000,0,0,0,519000,149000,370000,365000
1455,集盛            ,508000,143000,365000,0,0,0,0,0,0,0,0,0,0,0,0,0,365000
052712,旺宏凱基96購02  ,0,0,0,0,0,0,0,0,0,361000,0,0,0,366000,5000,361000,361000
055263,華新科富邦9A購01,0,0,0,0,0,0,0,0,0,361000,0,0,0,401000,40000,361000,361000
058146,勤誠元大99購01  ,0,0,0,0,0,0,0,0,0,360000,0,0,0,474000,114000,360000,360000
1103,嘉泥            ,406000,55000,351000,0,0,0,0,0,0,8000,8000,0,8000,0,0,0,359000
060578,臺股指中信9C購03,0,0,0,0,0,0,0,0,0,357000,0,0,0,400000,43000,357000,357000
3437,榮創            ,640000,283000,357000,0,0,0,0,0,0,0,0,0,0,0,0,0,357000
059645,祥碩凱基99購05  ,0,0,0,0,0,0,0,0,0,352000,0,0,0,386000,34000,352000,352000
059180,祥碩元富9A購01  ,0,0,0,0,0,0,0,0,0,352000,0,0,0,630000,278000,352000,352000
053056,同欣電國票97購01,0,0,0,0,0,0,0,0,0,352000,0,0,0,377000,25000,352000,352000
07714P,世紀鋼元大9A售03,0,0,0,0,0,0,0,0,0,351000,0,0,0,375000,24000,351000,351000
2723,美食-KY         ,447000,107000,340000,0,0,0,1000,0,1000,10000,0,0,0,10000,0,10000,351000
060042,台積電群益99購12,0,0,0,0,0,0,0,0,0,350000,0,0,0,352000,2000,350000,350000
00653L,富邦印度正2     ,1747000,1279000,468000,0,0,0,0,0,0,-118000,0,0,0,320000,438000,-118000,350000
054979,南港元富97購01  ,0,0,0,0,0,0,0,0,0,350000,0,0,0,350000,0,350000,350000
059914,台積電元大99購47,0,0,0,0,0,0,0,0,0,347000,0,0,0,348000,1000,347000,347000
059559,T50反1凱基99購07,0,0,0,0,0,0,0,0,0,347000,0,0,0,397000,50000,347000,347000
2855,統一證          ,564000,217000,347000,0,0,0,0,0,0,0,0,0,0,0,0,0,347000
8039,台虹            ,639000,415000,224000,0,0,0,0,0,0,122000,58000,0,58000,67000,3000,64000,346000
059695,聯鈞永豐99購02  ,0,0,0,0,0,0,0,0,0,344000,0,0,0,416000,72000,344000,344000
056047,台積電兆豐97購02,0,0,0,0,0,0,0,0,0,344000,0,0,0,444000,100000,344000,344000
3042,晶技            ,1858000,2628000,-770000,0,0,0,1439000,983000,456000,658000,648000,114000,534000,156000,32000,124000,344000
057008,華新科中信99購02,0,0,0,0,0,0,0,0,0,343000,0,0,0,499000,156000,343000,343000
060047,道瓊反凱基99購01,0,0,0,0,0,0,0,0,0,340000,0,0,0,495000,155000,340000,340000
06614P,祥碩永豐98售03  ,0,0,0,0,0,0,0,0,0,340000,0,0,0,460000,120000,340000,340000
2108,南帝            ,441000,72000,369000,0,0,0,0,0,0,-30000,0,30000,-30000,0,0,0,339000
054941,凱美元大97購01  ,0,0,0,0,0,0,0,0,0,336000,0,0,0,589000,253000,336000,336000
051902,T50反1元大97購01,0,0,0,0,0,0,0,0,0,335000,0,0,0,415000,80000,335000,335000
052237,嘉澤國票96購02  ,0,0,0,0,0,0,0,0,0,334000,0,0,0,334000,0,334000,334000
054229,超眾元富96購05  ,0,0,0,0,0,0,0,0,0,334000,0,0,0,342000,8000,334000,334000
4906,正文            ,466000,172000,294000,0,0,0,0,0,0,40000,28000,0,28000,15000,3000,12000,334000
5469,瀚宇博          ,783000,533000,250000,0,0,0,0,0,0,82000,0,0,0,138000,56000,82000,332000
059879,GIS凱基99購03   ,0,0,0,0,0,0,0,0,0,331000,0,0,0,353000,22000,331000,331000
00762,元大全球AI      ,0,0,0,0,0,0,0,0,0,330000,0,0,0,330000,0,330000,330000
055257,景碩統一97購01  ,0,0,0,0,0,0,0,0,0,330000,0,0,0,347000,17000,330000,330000
1319,東陽            ,662000,351000,311000,0,0,0,0,0,0,19000,19000,0,19000,0,0,0,330000
060780,祥碩國泰9B購01  ,0,0,0,0,0,0,0,0,0,329000,0,0,0,1113000,784000,329000,329000
053082,聯電元大98購03  ,0,0,0,0,0,0,0,0,0,329000,0,0,0,329000,0,329000,329000
07256P,臺股指凱基99售36,0,0,0,0,0,0,0,0,0,329000,0,0,0,349000,20000,329000,329000
2905,三商            ,400000,71760,328240,0,0,0,0,0,0,0,0,0,0,0,0,0,328240
052937,國巨兆豐97購01  ,0,0,0,0,0,0,0,0,0,327000,0,0,0,327000,0,327000,327000
059288,旺宏元富99購03  ,0,0,0,0,0,0,0,0,0,325000,0,0,0,330000,5000,325000,325000
057941,聯電國票99購01  ,0,0,0,0,0,0,0,0,0,325000,0,0,0,620000,295000,325000,325000
6668,中揚光          ,350000,25000,325000,0,0,0,0,0,0,0,0,0,0,0,0,0,325000
048383,元金2X國票99購01,0,0,0,0,0,0,0,0,0,324000,0,0,0,361000,37000,324000,324000
057705,臺股指群益98購05,0,0,0,0,0,0,0,0,0,324000,0,0,0,326000,2000,324000,324000
1305,華夏            ,846000,523000,323000,0,0,0,0,0,0,0,0,0,0,0,0,0,323000
059166,友達凱基99購05  ,0,0,0,0,0,0,0,0,0,321000,0,0,0,708000,387000,321000,321000
2472,立隆電          ,432000,106000,326000,0,0,0,0,0,0,-5000,0,5000,-5000,0,0,0,321000
07478P,南電康和9A售02  ,0,0,0,0,0,0,0,0,0,321000,0,0,0,662000,341000,321000,321000
05206P,南茂元大95售01  ,0,0,0,0,0,0,0,0,0,320000,0,0,0,320000,0,320000,320000
2231,為升            ,363000,46431,316569,0,0,0,0,0,0,2000,2000,0,2000,6000,6000,0,318569
05212P,台積電國票96售04,0,0,0,0,0,0,0,0,0,318000,0,0,0,582000,264000,318000,318000
2402,毅嘉            ,416000,99000,317000,0,0,0,0,0,0,0,0,0,0,0,0,0,317000
057675,同欣電元大98購02,0,0,0,0,0,0,0,0,0,315000,0,0,0,555000,240000,315000,315000
2457,飛宏            ,357000,42000,315000,0,0,0,0,0,0,0,0,0,0,0,0,0,315000
2401,凌陽            ,436000,133000,303000,0,0,0,0,0,0,10000,11000,1000,10000,0,0,0,313000
2405,浩鑫            ,320000,8000,312000,0,0,0,0,0,0,0,0,0,0,0,0,0,312000
059841,國巨富邦9C購01  ,0,0,0,0,0,0,0,0,0,311000,0,0,0,1866000,1555000,311000,311000
057573,京鼎永豐98購02  ,0,0,0,0,0,0,0,0,0,310000,0,0,0,310000,0,310000,310000
056309,合勤控元大97購01,0,0,0,0,0,0,0,0,0,309000,0,0,0,377000,68000,309000,309000
056025,嘉晶群益97購01  ,0,0,0,0,0,0,0,0,0,308000,0,0,0,308000,0,308000,308000
2501,國建            ,471000,163000,308000,0,0,0,0,0,0,0,0,0,0,0,0,0,308000
3059,華晶科          ,313000,5000,308000,0,0,0,0,0,0,0,0,0,0,0,0,0,308000
058160,奇鋐元富99購01  ,0,0,0,0,0,0,0,0,0,307000,0,0,0,394000,87000,307000,307000
2107,厚生            ,382000,78000,304000,0,0,0,0,0,0,3000,3000,0,3000,0,0,0,307000
060156,光磊永豐9A購01  ,0,0,0,0,0,0,0,0,0,306000,0,0,0,320000,14000,306000,306000
00737,國泰AI+Robo     ,0,0,0,0,0,0,0,0,0,306000,0,0,0,566000,260000,306000,306000
05476P,聯發科群益95售06,0,0,0,0,0,0,0,0,0,305000,0,0,0,305000,0,305000,305000
061274,臺股指凱基9A購24,0,0,0,0,0,0,0,0,0,304000,0,0,0,304000,0,304000,304000
1210,大成            ,605000,529405,75595,0,0,0,194000,0,194000,34000,44000,10000,34000,0,0,0,303595
07554P,玉晶光元大9A售06,0,0,0,0,0,0,0,0,0,303000,0,0,0,303000,0,303000,303000
057104,康友中信99購01  ,0,0,0,0,0,0,0,0,0,300000,0,0,0,300000,0,300000,300000
07542P,台積電凱基9A售16,0,0,0,0,0,0,0,0,0,298000,0,0,0,299000,1000,298000,298000
2547,日勝生          ,600000,302000,298000,0,0,0,0,0,0,0,0,0,0,0,0,0,298000
059709,上証2X元大9C購01,0,0,0,0,0,0,0,0,0,297000,0,0,0,318000,21000,297000,297000
4956,光鋐            ,408000,111000,297000,0,0,0,0,0,0,0,0,0,0,0,0,0,297000
054556,世芯凱基99購01  ,0,0,0,0,0,0,0,0,0,296000,0,0,0,296000,0,296000,296000
056684,旺宏統一98購02  ,0,0,0,0,0,0,0,0,0,296000,0,0,0,454000,158000,296000,296000
1709,和益            ,325000,29000,296000,0,0,0,0,0,0,0,0,0,0,0,0,0,296000
1316,上曜            ,317000,22000,295000,0,0,0,0,0,0,0,0,0,0,0,0,0,295000
07579P,聯茂元大9A售01  ,0,0,0,0,0,0,0,0,0,295000,0,0,0,413000,118000,295000,295000
07148P,富邦金元大99售01,0,0,0,0,0,0,0,0,0,295000,0,0,0,341000,46000,295000,295000
6214,精誠            ,422000,131000,291000,0,0,0,0,0,0,4000,9000,5000,4000,0,0,0,295000
8105,凌巨            ,443000,148000,295000,0,0,0,0,0,0,0,0,0,0,0,0,0,295000
2101,南港            ,512000,422776,89224,0,0,0,0,0,0,205000,58000,0,58000,156000,9000,147000,294224
044717,旺宏統一94購01  ,0,0,0,0,0,0,0,0,0,294000,0,0,0,294000,0,294000,294000
07015P,國巨元大99售13  ,0,0,0,0,0,0,0,0,0,294000,0,0,0,617000,323000,294000,294000
3708,上緯投控        ,316000,23000,293000,0,0,0,0,0,0,1000,0,0,0,1000,0,1000,294000
05118P,超眾元大96售04  ,0,0,0,0,0,0,0,0,0,292000,0,0,0,329000,37000,292000,292000
4155,訊映            ,302000,10000,292000,0,0,0,0,0,0,0,0,0,0,0,0,0,292000
060561,台積電富邦04購01,0,0,0,0,0,0,0,0,0,291000,0,0,0,438000,147000,291000,291000
056809,旺宏統一98購03  ,0,0,0,0,0,0,0,0,0,290000,0,0,0,395000,105000,290000,290000
06933P,禾伸堂元大98售03,0,0,0,0,0,0,0,0,0,287000,0,0,0,330000,43000,287000,287000
056122,勤誠群益97購02  ,0,0,0,0,0,0,0,0,0,285000,0,0,0,381000,96000,285000,285000
07129P,華新科元大99售14,0,0,0,0,0,0,0,0,0,285000,0,0,0,421000,136000,285000,285000
058838,國巨中信99購03  ,0,0,0,0,0,0,0,0,0,283000,0,0,0,283000,0,283000,283000
053057,聯電國泰97購02  ,0,0,0,0,0,0,0,0,0,282000,0,0,0,723000,441000,282000,282000
049947,S&P反1中信97購01,0,0,0,0,0,0,0,0,0,281000,0,0,0,281000,0,281000,281000
2385,群光            ,1273000,854262,418738,0,0,0,8000,57000,-49000,-89000,0,1000,-1000,1000,89000,-88000,280738
053945,國巨富邦98購02  ,0,0,0,0,0,0,0,0,0,280000,0,0,0,280000,0,280000,280000
054950,奇力新元大98購02,0,0,0,0,0,0,0,0,0,280000,0,0,0,447000,167000,280000,280000
057872,旺宏元大99購06  ,0,0,0,0,0,0,0,0,0,280000,0,0,0,462000,182000,280000,280000
3056,總太            ,401000,123000,278000,0,0,0,0,0,0,0,0,0,0,0,0,0,278000
060657,旺宏統一9B購05  ,0,0,0,0,0,0,0,0,0,277000,0,0,0,283000,6000,277000,277000
060925,華新科永豐9A購01,0,0,0,0,0,0,0,0,0,277000,0,0,0,295000,18000,277000,277000
054785,建準群益98購01  ,0,0,0,0,0,0,0,0,0,277000,0,0,0,277000,0,277000,277000
061182,南六凱基9A購01  ,0,0,0,0,0,0,0,0,0,276000,0,0,0,351000,75000,276000,276000
052818,智邦永豐96購01  ,0,0,0,0,0,0,0,0,0,276000,0,0,0,296000,20000,276000,276000
07263P,台積電元大99售37,0,0,0,0,0,0,0,0,0,275000,0,0,0,468000,193000,275000,275000
3047,訊舟            ,277000,3000,274000,0,0,0,0,0,0,0,0,0,0,0,0,0,274000
3048,益登            ,347000,74000,273000,0,0,0,0,0,0,1000,1000,0,1000,0,0,0,274000
060737,瑞儀統一9C購01  ,0,0,0,0,0,0,0,0,0,273000,0,0,0,464000,191000,273000,273000
04713P,創意元大95售01  ,0,0,0,0,0,0,0,0,0,273000,0,0,0,273000,0,273000,273000
058225,旺宏元富99購01  ,0,0,0,0,0,0,0,0,0,273000,0,0,0,273000,0,273000,273000
2367,燿華            ,3308000,2928000,380000,0,0,0,0,0,0,-107000,0,0,0,55000,162000,-107000,273000
060198,祥碩元富9A購02  ,0,0,0,0,0,0,0,0,0,272000,0,0,0,313000,41000,272000,272000
2006,東和鋼鐵        ,355000,319000,36000,0,0,0,251000,0,251000,-15000,25000,40000,-15000,0,0,0,272000
055397,超眾統一97購02  ,0,0,0,0,0,0,0,0,0,271000,0,0,0,331000,60000,271000,271000
3443,創意            ,448000,239000,209000,0,0,0,0,0,0,62000,12000,0,12000,52000,2000,50000,271000
059656,T50反1元大99購11,0,0,0,0,0,0,0,0,0,267000,0,0,0,754000,487000,267000,267000
058999,台積電元大99購24,0,0,0,0,0,0,0,0,0,267000,0,0,0,319000,52000,267000,267000
07418P,聯發科元大99售45,0,0,0,0,0,0,0,0,0,267000,0,0,0,309000,42000,267000,267000
059179,祥碩元富99購01  ,0,0,0,0,0,0,0,0,0,265000,0,0,0,474000,209000,265000,265000
056801,國巨台新98購01  ,0,0,0,0,0,0,0,0,0,265000,0,0,0,305000,40000,265000,265000
050792,可成富邦96購01  ,0,0,0,0,0,0,0,0,0,264000,0,0,0,264000,0,264000,264000
03737P,臺股指中信95售01,0,0,0,0,0,0,0,0,0,263000,0,0,0,263000,0,263000,263000
056067,智原元大97購01  ,0,0,0,0,0,0,0,0,0,262000,0,0,0,262000,0,262000,262000
5607,遠雄港          ,264000,2000,262000,0,0,0,0,0,0,0,0,0,0,0,0,0,262000
05423P,聯電亞東95售02  ,0,0,0,0,0,0,0,0,0,261000,0,0,0,261000,0,261000,261000
1592,英瑞-KY         ,280000,20000,260000,0,0,0,0,0,0,0,0,0,0,0,0,0,260000
057054,立積元大98購03  ,0,0,0,0,0,0,0,0,0,259000,0,0,0,373000,114000,259000,259000
2383,台光電          ,705000,288000,417000,0,0,0,182000,352000,-170000,12000,14000,15000,-1000,15000,2000,13000,259000
054716,緯穎康和97購01  ,0,0,0,0,0,0,0,0,0,258000,0,0,0,280000,22000,258000,258000
6139,亞翔            ,314000,56000,258000,0,0,0,0,0,0,0,0,0,0,0,0,0,258000
2395,研華            ,1259400,1038888,220512,0,0,0,3000,0,3000,33000,35000,2000,33000,0,0,0,256512
054093,智原群益97購01  ,0,0,0,0,0,0,0,0,0,256000,0,0,0,267000,11000,256000,256000
056162,祥碩凱基97購03  ,0,0,0,0,0,0,0,0,0,256000,0,0,0,266000,10000,256000,256000
1611,中電            ,323000,78000,245000,0,0,0,0,0,0,11000,11000,0,11000,0,0,0,256000
059107,南茂國泰9A購01  ,0,0,0,0,0,0,0,0,0,255000,0,0,0,551000,296000,255000,255000
060008,華邦電群益9A購01,0,0,0,0,0,0,0,0,0,255000,0,0,0,691000,436000,255000,255000
058218,緯穎群益99購01  ,0,0,0,0,0,0,0,0,0,255000,0,0,0,255000,0,255000,255000
060821,SP黃豆元大9A購02,0,0,0,0,0,0,0,0,0,254000,0,0,0,948000,694000,254000,254000
054852,奇鋐國票98購01  ,0,0,0,0,0,0,0,0,0,253000,0,0,0,253000,0,253000,253000
057149,京鼎國票99購02  ,0,0,0,0,0,0,0,0,0,253000,0,0,0,458000,205000,253000,253000
060562,旺宏富邦9C購02  ,0,0,0,0,0,0,0,0,0,250000,0,0,0,306000,56000,250000,250000
054239,台郡群益96購02  ,0,0,0,0,0,0,0,0,0,250000,0,0,0,538000,288000,250000,250000
056639,國產康和98購01  ,0,0,0,0,0,0,0,0,0,250000,0,0,0,250000,0,250000,250000
055954,南港元大97購02  ,0,0,0,0,0,0,0,0,0,250000,0,0,0,250000,0,250000,250000
2399,映泰            ,284000,34000,250000,0,0,0,0,0,0,0,0,0,0,0,0,0,250000
059503,大立光富邦9B購04,0,0,0,0,0,0,0,0,0,249000,0,0,0,377000,128000,249000,249000
04786P,鴻海永昌96售01  ,0,0,0,0,0,0,0,0,0,249000,0,0,0,249000,0,249000,249000
07634P,金像電元大9A售01,0,0,0,0,0,0,0,0,0,249000,0,0,0,427000,178000,249000,249000
060745,京元電國票9A購01,0,0,0,0,0,0,0,0,0,248000,0,0,0,408000,160000,248000,248000
1514,亞力            ,282000,34000,248000,0,0,0,0,0,0,0,0,0,0,0,0,0,248000
055492,華新科元大97購08,0,0,0,0,0,0,0,0,0,247000,0,0,0,247000,0,247000,247000
054982,國巨元富97購03  ,0,0,0,0,0,0,0,0,0,247000,0,0,0,247000,0,247000,247000
059259,FBVIX中信03購06 ,0,0,0,0,0,0,0,0,0,246000,0,0,0,468000,222000,246000,246000
057997,旺宏第一9C購01  ,0,0,0,0,0,0,0,0,0,246000,0,0,0,372000,126000,246000,246000
058846,鴻海群益99購03  ,0,0,0,0,0,0,0,0,0,246000,0,0,0,254000,8000,246000,246000
07218P,臺股指凱基99售31,0,0,0,0,0,0,0,0,0,246000,0,0,0,301000,55000,246000,246000
060392,華擎群益9C購02  ,0,0,0,0,0,0,0,0,0,245000,0,0,0,256000,11000,245000,245000
1417,嘉裕            ,302000,59232,242768,0,0,0,0,0,0,2000,2000,0,2000,0,0,0,244768
060896,晶技凱基9A購02  ,0,0,0,0,0,0,0,0,0,244000,0,0,0,404000,160000,244000,244000
006205,富邦上証        ,0,11000,-11000,0,0,0,0,0,0,254000,0,2000,-2000,1164000,908000,256000,243000
056893,智邦元大98購02  ,0,0,0,0,0,0,0,0,0,242000,0,0,0,257000,15000,242000,242000
06971P,台光電元大99售03,0,0,0,0,0,0,0,0,0,241000,0,0,0,241000,0,241000,241000
4746,台耀            ,823000,748043,74957,0,0,0,170000,0,170000,-4000,5000,9000,-4000,0,0,0,240957
055746,同欣電元富97購01,0,0,0,0,0,0,0,0,0,240000,0,0,0,400000,160000,240000,240000
055758,旺宏群益97購01  ,0,0,0,0,0,0,0,0,0,240000,0,0,0,250000,10000,240000,240000
4306,炎洲            ,436000,184000,252000,0,0,0,0,0,0,-12000,0,12000,-12000,0,0,0,240000
2809,京城銀          ,644000,406000,238000,0,0,0,1000,0,1000,1000,1000,0,1000,0,0,0,240000
058839,瑞儀中信99購02  ,0,0,0,0,0,0,0,0,0,239000,0,0,0,359000,120000,239000,239000
00641R,富邦日本反1     ,0,0,0,0,0,0,0,0,0,238000,0,0,0,537000,299000,238000,238000
2442,新美齊          ,317000,80000,237000,0,0,0,1000,0,1000,0,0,0,0,0,0,0,238000
1476,儒鴻            ,664000,453510,210490,0,0,0,0,15000,-15000,42061,39000,2939,36061,6000,0,6000,237551
1608,華榮            ,287000,50000,237000,0,0,0,0,0,0,0,0,0,0,0,0,0,237000
059168,奇力新凱基99購05,0,0,0,0,0,0,0,0,0,236000,0,0,0,490000,254000,236000,236000
051675,瑞儀元大96購02  ,0,0,0,0,0,0,0,0,0,236000,0,0,0,291000,55000,236000,236000
054550,旺宏凱基98購02  ,0,0,0,0,0,0,0,0,0,236000,0,0,0,236000,0,236000,236000
07342P,大立光凱基99售14,0,0,0,0,0,0,0,0,0,236000,0,0,0,256000,20000,236000,236000
061206,旺宏元大9A購12  ,0,0,0,0,0,0,0,0,0,235000,0,0,0,269000,34000,235000,235000
1802,台玻            ,995000,754319,240681,0,0,0,0,0,0,-7000,0,7000,-7000,0,0,0,233681
07014P,華通元大99售04  ,0,0,0,0,0,0,0,0,0,233000,0,0,0,361000,128000,233000,233000
057195,南茂元大98購01  ,0,0,0,0,0,0,0,0,0,232000,0,0,0,676000,444000,232000,232000
3008,大立光          ,471009,269091,201918,0,0,0,14000,0,14000,16000,6000,0,6000,10000,0,10000,231918
05521P,創意永豐96售01  ,0,0,0,0,0,0,0,0,0,231000,0,0,0,231000,0,231000,231000
061151,友訊群益9A購01  ,0,0,0,0,0,0,0,0,0,230000,0,0,0,230000,0,230000,230000
059468,智邦元大99購02  ,0,0,0,0,0,0,0,0,0,230000,0,0,0,242000,12000,230000,230000
052594,友訊群益98購01  ,0,0,0,0,0,0,0,0,0,230000,0,0,0,230000,0,230000,230000
2617,台航            ,294000,64000,230000,0,0,0,0,0,0,0,0,0,0,0,0,0,230000
07690P,華新科元大9A售15,0,0,0,0,0,0,0,0,0,230000,0,0,0,250000,20000,230000,230000
055584,國巨元大97購11  ,0,0,0,0,0,0,0,0,0,229000,0,0,0,232000,3000,229000,229000
8996,高力            ,785000,647000,138000,0,0,0,0,0,0,91000,91000,0,91000,0,0,0,229000
2537,聯上發          ,402000,174000,228000,0,0,0,0,0,0,0,0,0,0,0,0,0,228000
8163,達方            ,453000,251000,202000,0,0,0,0,0,0,25000,29000,6000,23000,7000,5000,2000,227000
061302,晶技永豐9A購04  ,0,0,0,0,0,0,0,0,0,225000,0,0,0,349000,124000,225000,225000
060502,國巨元大9A購07  ,0,0,0,0,0,0,0,0,0,225000,0,0,0,395000,170000,225000,225000
052851,滬深2X元富96購02,0,0,0,0,0,0,0,0,0,225000,0,0,0,225000,0,225000,225000
1227,佳格            ,658000,523000,135000,0,0,0,125000,35000,90000,0,1000,1000,0,0,0,0,225000
07373P,A50正2元大99售01,0,0,0,0,0,0,0,0,0,225000,0,0,0,250000,25000,225000,225000
054532,強茂國泰98購01  ,0,0,0,0,0,0,0,0,0,224000,0,0,0,224000,0,224000,224000
057286,群創元大9B購05  ,0,0,0,0,0,0,0,0,0,223000,0,0,0,224000,1000,223000,223000
057255,聯發科麥證98購02,0,0,0,262000,40000,222000,0,0,0,222000,0,0,0,262000,40000,222000,222000
057731,華擎國泰9A購02  ,0,0,0,0,0,0,0,0,0,222000,0,0,0,232000,10000,222000,222000
07105P,大毅元富99售02  ,0,0,0,0,0,0,0,0,0,222000,0,0,0,230000,8000,222000,222000
060423,智易永豐9A購01  ,0,0,0,0,0,0,0,0,0,221000,0,0,0,225000,4000,221000,221000
05152P,玉晶光群益96售05,0,0,0,0,0,0,0,0,0,221000,0,0,0,372000,151000,221000,221000
3704,合勤控          ,419000,203000,216000,0,0,0,0,0,0,5000,0,0,0,5000,0,5000,221000
049494,華新科元大95購05,0,0,0,0,0,0,0,0,0,220000,0,0,0,220000,0,220000,220000
054980,國巨元富97購01  ,0,0,0,0,0,0,0,0,0,219000,0,0,0,262000,43000,219000,219000
3018,同開            ,232000,13000,219000,0,0,0,0,0,0,0,0,0,0,0,0,0,219000
2478,大毅            ,1799000,1703000,96000,0,0,0,0,0,0,122250,100000,25750,74250,67000,19000,48000,218250
056599,臻鼎元富98購01  ,0,0,0,0,0,0,0,0,0,218000,0,0,0,415000,197000,218000,218000
05634P,玉晶光台新97售01,0,0,0,0,0,0,0,0,0,216000,0,0,0,552000,336000,216000,216000
3653,健策            ,421000,157000,264000,0,0,0,68000,178000,-110000,62000,7000,25000,-18000,93000,13000,80000,216000
4935,茂林-KY         ,501000,801000,-300000,0,0,0,95000,0,95000,421000,349000,25000,324000,108000,11000,97000,216000
060721,瑞儀永豐9A購01  ,0,0,0,0,0,0,0,0,0,215000,0,0,0,596000,381000,215000,215000
1444,力麗            ,517000,302000,215000,0,0,0,0,0,0,0,0,0,0,0,0,0,215000
1734,杏輝            ,245000,30000,215000,0,0,0,0,0,0,0,0,0,0,0,0,0,215000
1708,東鹼            ,245000,19000,226000,0,0,0,0,0,0,-11000,4000,15000,-11000,0,0,0,215000
060429,南六永豐9A購01  ,0,0,0,0,0,0,0,0,0,214000,0,0,0,313000,99000,214000,214000
059171,祥碩凱基99購04  ,0,0,0,0,0,0,0,0,0,214000,0,0,0,349000,135000,214000,214000
00766L,台新MSCI中國正2 ,0,0,0,0,0,0,0,0,0,214000,0,0,0,290000,76000,214000,214000
2419,仲琦            ,248000,36000,212000,0,0,0,0,0,0,2000,2000,0,2000,0,0,0,214000
057483,微星元大98購04  ,0,0,0,0,0,0,0,0,0,213000,0,0,0,355000,142000,213000,213000
055586,旺宏元大98購06  ,0,0,0,0,0,0,0,0,0,213000,0,0,0,230000,17000,213000,213000
2538,基泰            ,213000,0,213000,0,0,0,0,0,0,0,0,0,0,0,0,0,213000
059882,臺股指凱基9C購06,0,0,0,0,0,0,0,0,0,212000,0,0,0,364000,152000,212000,212000
1604,聲寶            ,272000,60000,212000,0,0,0,0,0,0,0,0,0,0,0,0,0,212000
04479P,同欣電中信96售02,0,0,0,0,0,0,0,0,0,211000,0,0,0,279000,68000,211000,211000
06843P,鴻海元大98售11  ,0,0,0,0,0,0,0,0,0,211000,0,0,0,241000,30000,211000,211000
3413,京鼎            ,400000,585000,-185000,0,0,0,217000,0,217000,179000,133000,5000,128000,93000,42000,51000,211000
00646,元大S&P500      ,84000,0,84000,0,0,0,0,0,0,126000,0,0,0,232000,106000,126000,210000
6209,今國光          ,315000,102000,213000,0,0,0,0,0,0,-3000,0,3000,-3000,0,0,0,210000
07513P,台積電元大9A售13,0,0,0,0,0,0,0,0,0,210000,0,0,0,420000,210000,210000,210000
2351,順德            ,224000,14000,210000,0,0,0,0,0,0,0,0,0,0,0,0,0,210000
050794,大立光富邦96購04,0,0,0,0,0,0,0,0,0,209000,0,0,0,209000,0,209000,209000
2913,農林            ,426000,210000,216000,0,0,0,0,0,0,-7000,1000,8000,-7000,0,0,0,209000
07363P,大立光元大99售26,0,0,0,0,0,0,0,0,0,209000,0,0,0,211000,2000,209000,209000
059200,京鼎永豐99購02  ,0,0,0,0,0,0,0,0,0,208000,0,0,0,492000,284000,208000,208000
059469,智邦元大99購03  ,0,0,0,0,0,0,0,0,0,208000,0,0,0,209000,1000,208000,208000
059560,T50反1凱基99購08,0,0,0,0,0,0,0,0,0,207000,0,0,0,997000,790000,207000,207000
057142,力成兆豐98購01  ,0,0,0,0,0,0,0,0,0,207000,0,0,0,207000,0,207000,207000
6414,樺漢            ,246000,53000,193000,0,0,0,0,0,0,14000,6000,5000,1000,13000,0,13000,207000
052041,鴻海日盛95購02  ,0,0,0,0,0,0,0,0,0,206000,0,0,0,206000,0,206000,206000
055369,友訊元大97購01  ,0,0,0,0,0,0,0,0,0,206000,0,0,0,206000,0,206000,206000
057727,華邦電國泰9A購01,0,0,0,0,0,0,0,0,0,206000,0,0,0,355000,149000,206000,206000
056996,矽力日盛99購01  ,0,0,0,0,0,0,0,0,0,206000,0,0,0,216000,10000,206000,206000
1447,力鵬            ,287000,81000,206000,0,0,0,0,0,0,0,0,0,0,0,0,0,206000
057806,國巨元大98購20  ,0,0,0,0,0,0,0,0,0,204000,0,0,0,225000,21000,204000,204000
2511,太子            ,630000,426000,204000,0,0,0,0,0,0,0,0,0,0,0,0,0,204000
061254,道瓊反凱基9A購02,0,0,0,0,0,0,0,0,0,203000,0,0,0,203000,0,203000,203000
057055,立積元大99購01  ,0,0,0,0,0,0,0,0,0,203000,0,0,0,240000,37000,203000,203000
057609,友訊元富98購01  ,0,0,0,0,0,0,0,0,0,203000,0,0,0,336000,133000,203000,203000
060350,元黃金元富9B購01,0,0,0,0,0,0,0,0,0,202000,0,0,0,229000,27000,202000,202000
053243,楠梓電國票97購02,0,0,0,0,0,0,0,0,0,202000,0,0,0,202000,0,202000,202000
050636,上証2X國票94購01,0,0,0,0,0,0,0,0,0,202000,0,0,0,202000,0,202000,202000
2228,劍麟            ,290000,92000,198000,0,0,0,0,0,0,4000,0,0,0,4000,0,4000,202000
07434P,臺股指國票9A售06,0,0,0,0,0,0,0,0,0,202000,0,0,0,260000,58000,202000,202000
058836,FBVIX中信03購05 ,0,0,0,0,0,0,0,0,0,201000,0,0,0,303000,102000,201000,201000
4564,元翎            ,254000,55000,199000,0,0,0,0,0,0,2000,0,0,0,5000,3000,2000,201000
060321,元金2X群益9B購01,0,0,0,0,0,0,0,0,0,200000,0,0,0,200000,0,200000,200000
059945,嘉澤永豐99購03  ,0,0,0,0,0,0,0,0,0,200000,0,0,0,415000,215000,200000,200000
05395P,旺宏元大96售06  ,0,0,0,0,0,0,0,0,0,200000,0,0,0,200000,0,200000,200000
054265,GIS元大96購03   ,0,0,0,0,0,0,0,0,0,200000,0,0,0,419000,219000,200000,200000
053674,臺股指元富96購01,0,0,0,0,0,0,0,0,0,200000,0,0,0,200000,0,200000,200000
057297,新日興永豐98購01,0,0,0,0,0,0,0,0,0,200000,0,0,0,200000,0,200000,200000
055024,興勤國泰98購01  ,0,0,0,0,0,0,0,0,0,200000,0,0,0,200000,0,200000,200000
07498P,台積電元大9A售09,0,0,0,0,0,0,0,0,0,200000,0,0,0,410000,210000,200000,200000
07515P,台積電元大9A售15,0,0,0,0,0,0,0,0,0,200000,0,0,0,410000,210000,200000,200000
07751P,世紀鋼凱基9A售02,0,0,0,0,0,0,0,0,0,199000,0,0,0,262000,63000,199000,199000
3038,全台            ,718000,519000,199000,0,0,0,0,0,0,0,0,0,0,0,0,0,199000
059400,滬深2X元富9C購04,0,0,0,0,0,0,0,0,0,198000,0,0,0,198000,0,198000,198000
061306,瑞祺永豐9A購02  ,0,0,0,0,0,0,0,0,0,198000,0,0,0,228000,30000,198000,198000
2485,兆赫            ,281000,72000,209000,0,0,0,0,0,0,-11000,1000,12000,-11000,0,0,0,198000
057725,台達電國泰9A購01,0,0,0,0,0,0,0,0,0,197000,0,0,0,197000,0,197000,197000
1201,味全            ,353000,114000,239000,0,0,0,0,0,0,-42000,0,0,0,0,42000,-42000,197000
07573P,國巨元大9A售11  ,0,0,0,0,0,0,0,0,0,197000,0,0,0,267000,70000,197000,197000
3669,圓展            ,473000,275000,198000,0,0,0,0,0,0,-1000,0,1000,-1000,0,0,0,197000
5264,鎧勝-KY         ,560000,455000,105000,0,0,0,0,0,0,92000,11000,0,11000,106000,25000,81000,197000
6670,復盛應用        ,266000,68000,198000,0,0,0,0,0,0,-1000,0,1000,-1000,5000,5000,0,197000
061054,台積電群益9A購04,0,0,0,0,0,0,0,0,0,196000,0,0,0,260000,64000,196000,196000
059672,滬深2X元富99購06,0,0,0,0,0,0,0,0,0,196000,0,0,0,196000,0,196000,196000
056398,南茂永豐98購01  ,0,0,0,0,0,0,0,0,0,196000,0,0,0,489000,293000,196000,196000
2514,龍邦            ,237000,41000,196000,0,0,0,0,0,0,0,0,0,0,0,0,0,196000
054425,聯發科富邦99購03,0,0,0,0,0,0,0,0,0,195000,0,0,0,475000,280000,195000,195000
9934,成霖            ,242000,47000,195000,0,0,0,0,0,0,0,0,0,0,0,0,0,195000
055354,宏達電凱基98購01,0,0,0,0,0,0,0,0,0,194000,0,0,0,246000,52000,194000,194000
059338,滬深2X凱基9C購02,0,0,0,0,0,0,0,0,0,193000,0,0,0,200000,7000,193000,193000
057930,旺宏群益99購04  ,0,0,0,0,0,0,0,0,0,193000,0,0,0,306000,113000,193000,193000
058445,旺宏富邦9C購01  ,0,0,0,0,0,0,0,0,0,193000,0,0,0,193000,0,193000,193000
07612P,國巨國泰9B售06  ,0,0,0,0,0,0,0,0,0,193000,0,0,0,426000,233000,193000,193000
07257P,臺股指凱基99售37,0,0,0,0,0,0,0,0,0,193000,0,0,0,469000,276000,193000,193000
059702,台積電凱基9A購14,0,0,0,0,0,0,0,0,0,192000,0,0,0,199000,7000,192000,192000
0061,元大寶滬深      ,81000,4000,77000,0,0,0,0,0,0,115000,10000,20000,-10000,125000,0,125000,192000
2359,所羅門          ,197000,5000,192000,0,0,0,0,0,0,0,0,0,0,0,0,0,192000
057987,大立光元富98購02,0,0,0,0,0,0,0,0,0,191000,0,0,0,253000,62000,191000,191000
059432,聯發科元大99購26,0,0,0,0,0,0,0,0,0,190000,0,0,0,190000,0,190000,190000
060982,旺宏元大9A購09  ,0,0,0,0,0,0,0,0,0,190000,0,0,0,240000,50000,190000,190000
060483,友達富邦9A購01  ,0,0,0,0,0,0,0,0,0,190000,0,0,0,330000,140000,190000,190000
053988,友達亞東96購01  ,0,0,0,0,0,0,0,0,0,190000,0,0,0,190000,0,190000,190000
053875,GIS元大97購01   ,0,0,0,0,0,0,0,0,0,190000,0,0,0,252000,62000,190000,190000
053780,南亞科元大96購03,0,0,0,0,0,0,0,0,0,190000,0,0,0,297000,107000,190000,190000
057061,華擎國泰9A購01  ,0,0,0,0,0,0,0,0,0,190000,0,0,0,240000,50000,190000,190000
057417,國巨凱基9A購03  ,0,0,0,0,0,0,0,0,0,190000,0,0,0,190000,0,190000,190000
2314,台揚            ,337000,147000,190000,0,0,0,0,0,0,0,0,0,0,0,0,0,190000
3004,豐達科          ,198000,8000,190000,0,0,0,0,0,0,0,0,0,0,0,0,0,190000
059844,大立光富邦9C購04,0,0,0,0,0,0,0,0,0,189000,0,0,0,202000,13000,189000,189000
055407,祥碩國泰98購01  ,0,0,0,0,0,0,0,0,0,189000,0,0,0,292000,103000,189000,189000
057530,奇鋐元大99購01  ,0,0,0,0,0,0,0,0,0,188000,0,0,0,223000,35000,188000,188000
053892,景碩群益96購02  ,0,0,0,0,0,0,0,0,0,188000,0,0,0,253000,65000,188000,188000
6155,鈞寶            ,240000,52000,188000,0,0,0,0,0,0,0,0,0,0,0,0,0,188000
3645,達邁            ,227000,39000,188000,0,0,0,0,0,0,0,0,0,0,0,0,0,188000
3557,嘉威            ,226000,38000,188000,0,0,0,0,0,0,0,0,0,0,0,0,0,188000
07352P,台積電國票99售11,0,0,0,0,0,0,0,0,0,187000,0,0,0,188000,1000,187000,187000
060398,立積國票9B購01  ,0,0,0,0,0,0,0,0,0,186000,0,0,0,256000,70000,186000,186000
059671,滬深2X元富99購05,0,0,0,0,0,0,0,0,0,186000,0,0,0,191000,5000,186000,186000
060699,華新科國泰9B購03,0,0,0,0,0,0,0,0,0,186000,0,0,0,322000,136000,186000,186000
061317,旺宏凱基9A購05  ,0,0,0,0,0,0,0,0,0,186000,0,0,0,260000,74000,186000,186000
8404,百和興業-KY     ,289000,103000,186000,0,0,0,0,0,0,0,0,0,0,0,0,0,186000
3665,貿聯-KY         ,399000,149268,249732,0,0,0,81000,226000,-145000,81000,60000,7000,53000,29000,1000,28000,185732
058116,正崴中信99購02  ,0,0,0,0,0,0,0,0,0,185000,0,0,0,224000,39000,185000,185000
4119,旭富            ,295000,132000,163000,0,0,0,0,0,0,22000,0,0,0,26000,4000,22000,185000
3003,健和興          ,227000,60000,167000,0,0,0,0,0,0,18000,1000,0,1000,17000,0,17000,185000
060906,旺宏元大9A購07  ,0,0,0,0,0,0,0,0,0,184000,0,0,0,252000,68000,184000,184000
059769,滬深2X群益9C購01,0,0,0,0,0,0,0,0,0,184000,0,0,0,184000,0,184000,184000
053617,宏達電群益96購02,0,0,0,0,0,0,0,0,0,184000,0,0,0,272000,88000,184000,184000
05419P,矽力永豐95售02  ,0,0,0,0,0,0,0,0,0,184000,0,0,0,184000,0,184000,184000
058068,旺宏凱基98購11  ,25000,10000,15000,0,0,0,0,0,0,169000,0,0,0,220000,51000,169000,184000
1519,華城            ,228000,43000,185000,0,0,0,0,0,0,-1000,2000,3000,-1000,0,0,0,184000
056438,旺宏凱基98購05  ,0,0,0,0,0,0,0,0,0,183000,0,0,0,186000,3000,183000,183000
1522,堤維西          ,245000,72000,173000,0,0,0,0,0,0,10000,0,0,0,10000,0,10000,183000
6669,緯穎            ,236000,135000,101000,0,0,0,86000,0,86000,-4000,12000,16000,-4000,5000,5000,0,183000
054395,華新科永豐96購03,0,0,0,0,0,0,0,0,0,182000,0,0,0,182000,0,182000,182000
05538P,玉晶光國票97售02,0,0,0,0,0,0,0,0,0,182000,0,0,0,232000,50000,182000,182000
058547,世紀鋼富邦9A購01,0,0,0,0,0,0,0,0,0,182000,0,0,0,373000,191000,182000,182000
057135,立積凱基98購01  ,0,0,0,0,0,0,0,0,0,182000,0,0,0,189000,7000,182000,182000
058283,世紀鋼中信99購01,0,0,0,0,0,0,0,0,0,182000,0,0,0,295000,113000,182000,182000
2637,慧洋-KY         ,495000,314000,181000,0,0,0,1000,0,1000,0,0,0,0,0,0,0,182000
07645P,華通元大9A售06  ,0,0,0,0,0,0,0,0,0,182000,0,0,0,182000,0,182000,182000
061214,華擎元大9A購04  ,0,0,0,0,0,0,0,0,0,181000,0,0,0,235000,54000,181000,181000
053232,友達永豐97購02  ,0,0,0,0,0,0,0,0,0,180000,0,0,0,200000,20000,180000,180000
051064,鴻海國票95購01  ,0,0,0,0,0,0,0,0,0,180000,0,0,0,180000,0,180000,180000
057398,台郡中信99購01  ,0,0,0,0,0,0,0,0,0,180000,0,0,0,220000,40000,180000,180000
061179,華擎凱基9A購01  ,0,0,0,0,0,0,0,0,0,179000,0,0,0,179000,0,179000,179000
052492,易華電國票96購02,0,0,0,0,0,0,0,0,0,179000,0,0,0,179000,0,179000,179000
00703,台新MSCI中國    ,1000,1000,0,0,0,0,0,0,0,179000,0,0,0,280000,101000,179000,179000
055555,全新凱基9A購01  ,0,0,0,0,0,0,0,0,0,179000,0,0,0,179000,0,179000,179000
058377,茂林凱基9A購03  ,0,0,0,0,0,0,0,0,0,179000,0,0,0,291000,112000,179000,179000
060640,京鼎永豐9A購01  ,0,0,0,0,0,0,0,0,0,178000,0,0,0,349000,171000,178000,178000
059369,滬深2X元富9C購01,0,0,0,0,0,0,0,0,0,178000,0,0,0,188000,10000,178000,178000
059373,滬深2X群益01購03,0,0,0,0,0,0,0,0,0,178000,0,0,0,188000,10000,178000,178000
058142,瑞儀元大99購01  ,0,0,0,0,0,0,0,0,0,178000,0,0,0,484000,306000,178000,178000
057125,國巨凱基98購12  ,0,0,0,0,0,0,0,0,0,178000,0,0,0,388000,210000,178000,178000
07641P,上銀凱基9A售05  ,0,0,0,0,0,0,0,0,0,178000,0,0,0,298000,120000,178000,178000
6416,瑞祺電通        ,210000,138000,72000,0,0,0,0,0,0,106000,58000,11000,47000,62000,3000,59000,178000
061036,晶技永豐9A購03  ,0,30000,-30000,0,0,0,0,0,0,207000,0,0,0,270000,63000,207000,177000
058662,禾伸堂兆豐99購01,0,0,0,0,0,0,0,0,0,177000,0,0,0,202000,25000,177000,177000
059616,滬深2X群益01購04,0,0,0,0,0,0,0,0,0,176000,0,0,0,176000,0,176000,176000
056028,GIS群益97購02   ,0,0,0,0,0,0,0,0,0,176000,0,0,0,333000,157000,176000,176000
058121,國巨國票9A購01  ,0,0,0,0,0,0,0,0,0,176000,0,0,0,176000,0,176000,176000
4916,事欣科          ,200000,24000,176000,0,0,0,0,0,0,0,0,0,0,0,0,0,176000
055193,世芯元富97購02  ,0,0,0,0,0,0,0,0,0,174000,0,0,0,174000,0,174000,174000
07637P,國巨國票9A售08  ,0,0,0,0,0,0,0,0,0,174000,0,0,0,234000,60000,174000,174000
051944,智邦統一95購02  ,0,0,0,0,0,0,0,0,0,173000,0,0,0,219000,46000,173000,173000
056967,奇鋐永豐98購01  ,0,0,0,0,0,0,0,0,0,173000,0,0,0,229000,56000,173000,173000
07255P,國巨凱基99售15  ,0,0,0,0,0,0,0,0,0,173000,0,0,0,246000,73000,173000,173000
3022,威強電          ,250000,68000,182000,0,0,0,0,0,0,-9000,0,9000,-9000,0,0,0,173000
056749,滬深2X兆豐99購01,0,0,0,0,0,0,0,0,0,172000,0,0,0,172000,0,172000,172000
057322,旺宏群益98購04  ,0,0,0,0,0,0,0,0,0,172000,0,0,0,182000,10000,172000,172000
07162P,臺股指群益99售13,0,0,0,0,0,0,0,0,0,172000,0,0,0,716000,544000,172000,172000
061068,祥碩凱基9B購01  ,0,0,0,0,0,0,0,0,0,171000,0,0,0,308000,137000,171000,171000
055996,矽力國泰99購01  ,0,0,0,0,0,0,0,0,0,171000,0,0,0,171000,0,171000,171000
05976P,國巨凱基96售14  ,0,0,0,0,0,0,0,0,0,170000,0,0,0,205000,35000,170000,170000
060279,SP黃豆元大9A購01,0,0,0,0,0,0,0,0,0,170000,0,0,0,785000,615000,170000,170000
00643,群益深証中小    ,328000,86000,242000,0,0,0,0,0,0,-72000,0,296000,-296000,246000,22000,224000,170000
055417,健策富邦98購02  ,0,0,0,0,0,0,0,0,0,170000,0,0,0,170000,0,170000,170000
053149,京元電元大96購02,0,0,0,0,0,0,0,0,0,170000,0,0,0,208000,38000,170000,170000
056044,同欣電凱基97購03,0,0,0,0,0,0,0,0,0,170000,0,0,0,170000,0,170000,170000
054680,華新科康和97購02,0,0,0,0,0,0,0,0,0,169000,0,0,0,201000,32000,169000,169000
052764,景碩群益98購01  ,0,0,0,0,0,0,0,0,0,169000,0,0,0,251000,82000,169000,169000
053571,奇鋐統一96購02  ,0,0,0,0,0,0,0,0,0,168000,0,0,0,168000,0,168000,168000
047408,嘉晶統一95購01  ,0,0,0,0,0,0,0,0,0,168000,0,0,0,168000,0,168000,168000
056245,嘉澤群益97購01  ,0,0,0,0,0,0,0,0,0,168000,0,0,0,178000,10000,168000,168000
057986,華新科元富99購05,0,0,0,0,0,0,0,0,0,168000,0,0,0,168000,0,168000,168000
057918,旺宏凱基99購01  ,0,0,0,0,0,0,0,0,0,168000,0,0,0,180000,12000,168000,168000
4526,東台            ,198000,31000,167000,0,0,0,0,0,0,0,0,0,0,0,0,0,167000
052527,泰鼎元大96購02  ,0,0,0,0,0,0,0,0,0,166000,0,0,0,199000,33000,166000,166000
056505,聯發科永豐98購01,0,0,0,0,0,0,0,0,0,166000,0,0,0,166000,0,166000,166000
8021,尖點            ,285000,120000,165000,0,0,0,0,0,0,1000,1000,0,1000,0,0,0,166000
4977,眾達-KY         ,297078,86000,211078,0,0,0,0,15000,-15000,-31000,10000,41000,-31000,0,0,0,165078
059580,大立光元富99購07,0,0,0,0,0,0,0,0,0,165000,0,0,0,273000,108000,165000,165000
050682,南亞科元富94購02,0,0,0,0,0,0,0,0,0,165000,0,0,0,165000,0,165000,165000
056237,智邦群益97購02  ,0,0,0,0,0,0,0,0,0,165000,0,0,0,193000,28000,165000,165000
4967,十銓            ,608000,423000,185000,0,0,0,0,0,0,-20000,0,20000,-20000,0,0,0,165000
6108,競國            ,188000,24000,164000,0,0,0,0,0,0,1000,1000,0,1000,0,0,0,165000
07709P,創意元大9A售01  ,0,0,0,0,0,0,0,0,0,165000,0,0,0,220000,55000,165000,165000
1906,寶隆            ,170000,5000,165000,0,0,0,0,0,0,0,0,0,0,0,0,0,165000
058179,國巨國泰9B購02  ,0,0,0,0,0,0,0,0,0,164000,0,0,0,174000,10000,164000,164000
057569,光磊永豐98購03  ,0,0,0,0,0,0,0,0,0,164000,0,0,0,232000,68000,164000,164000
1315,達新            ,303000,101000,202000,0,0,0,0,0,0,-38000,0,17000,-17000,0,21000,-21000,164000
07245P,台積電凱基99售16,0,0,0,0,0,0,0,0,0,164000,0,0,0,165000,1000,164000,164000
4927,泰鼎-KY         ,318000,431000,-113000,0,0,0,276000,0,276000,1000,20000,4000,16000,3000,18000,-15000,164000
060988,華新科元大9A購12,0,0,0,0,0,0,0,0,0,163000,0,0,0,221000,58000,163000,163000
060841,宏達電國票9B購01,0,0,0,0,0,0,0,0,0,163000,0,0,0,173000,10000,163000,163000
047564,滬深2X國票99購01,0,0,0,0,0,0,0,0,0,163000,0,0,0,455000,292000,163000,163000
05412P,泰碩國票95售02  ,0,0,0,0,0,0,0,0,0,163000,0,0,0,163000,0,163000,163000
053244,光磊國票97購01  ,0,0,0,0,0,0,0,0,0,163000,0,0,0,163000,0,163000,163000
061161,南六群益9A購01  ,0,0,0,0,0,0,0,0,0,162000,0,0,0,176000,14000,162000,162000
053113,瀚宇博兆豐97購01,0,0,0,0,0,0,0,0,0,162000,0,0,0,162000,0,162000,162000
07560P,台積電國泰9B售01,0,0,0,0,0,0,0,0,0,162000,0,0,0,172000,10000,162000,162000
06515P,國巨凱基98售06  ,0,0,0,0,0,0,0,0,0,161000,0,0,0,222000,61000,161000,161000
045055,聯發科元富98購03,0,0,0,0,0,0,0,0,0,161000,0,0,0,166000,5000,161000,161000
058055,華擎統一9A購01  ,0,0,0,0,0,0,0,0,0,161000,0,0,0,305000,144000,161000,161000
058413,義隆兆豐99購01  ,0,0,0,0,0,0,0,0,0,161000,0,0,0,213000,52000,161000,161000
056358,友訊元大99購01  ,0,0,0,0,0,0,0,0,0,161000,0,0,0,161000,0,161000,161000
07491P,臺股指國票9A售09,0,0,0,0,0,0,0,0,0,161000,0,0,0,163000,2000,161000,161000
07468P,聯電元大9A售02  ,0,0,0,0,0,0,0,0,0,161000,0,0,0,171000,10000,161000,161000
06142P,台虹康和97售02  ,0,0,0,0,0,0,0,0,0,160000,0,0,0,224000,64000,160000,160000
060571,京元電永豐9A購01,0,0,0,0,0,0,0,0,0,160000,0,0,0,219000,59000,160000,160000
051266,國巨富邦99購01  ,15000,0,15000,0,0,0,0,0,0,145000,0,0,0,175000,30000,145000,160000
2331,精英            ,235000,72000,163000,0,0,0,0,0,0,-3000,7000,10000,-3000,0,0,0,160000
060379,T50反1凱基9A購07,0,0,0,0,0,0,0,0,0,159000,0,0,0,240000,81000,159000,159000
053045,國巨中信97購01  ,0,0,0,0,0,0,0,0,0,159000,0,0,0,259000,100000,159000,159000
058621,華通國票9A購01  ,0,0,0,0,0,0,0,0,0,159000,0,0,0,159000,0,159000,159000
5434,崇越            ,219000,92000,127000,0,0,0,20000,0,20000,12000,5000,0,5000,7000,0,7000,159000
4739,康普            ,190000,32000,158000,0,0,0,0,0,0,0,0,0,0,0,0,0,158000
055785,祥碩凱基97購02  ,0,0,0,0,0,0,0,0,0,157000,0,0,0,168000,11000,157000,157000
059706,嘉晶凱基99購01  ,0,0,0,0,0,0,0,0,0,156000,0,0,0,196000,40000,156000,156000
05500P,臺股指中信96售04,0,0,0,0,0,0,0,0,0,156000,0,0,0,167000,11000,156000,156000
059957,中信金康和99購01,0,0,0,0,0,0,0,0,0,155000,0,0,0,276000,121000,155000,155000
06743P,創意永豐98售03  ,0,0,0,0,0,0,0,0,0,155000,0,0,0,329000,174000,155000,155000
054040,中石化元大9C購01,0,0,0,0,0,0,0,0,0,155000,0,0,0,155000,0,155000,155000
053383,京元電元大97購01,0,0,0,0,0,0,0,0,0,155000,0,0,0,155000,0,155000,155000
057136,立積凱基98購02  ,0,0,0,0,0,0,0,0,0,155000,0,0,0,165000,10000,155000,155000
058989,茂林凱基99購02  ,0,0,0,0,0,0,0,0,0,155000,0,0,0,265000,110000,155000,155000
061121,智邦永豐9A購02  ,0,0,0,0,0,0,0,0,0,154000,0,0,0,160000,6000,154000,154000
060748,臻鼎國票9A購01  ,0,0,0,0,0,0,0,0,0,154000,0,0,0,218000,64000,154000,154000
060333,金寶康和9A購01  ,0,0,0,0,0,0,0,0,0,154000,0,0,0,404000,250000,154000,154000
052279,旺宏凱基95購07  ,0,0,0,0,0,0,0,0,0,154000,0,0,0,154000,0,154000,154000
06847P,奇力新元大98售05,0,0,0,0,0,0,0,0,0,154000,0,0,0,165000,11000,154000,154000
056642,旺宏凱基98購07  ,0,0,0,0,0,0,0,0,0,153000,0,0,0,159000,6000,153000,153000
057405,麗豐群益98購01  ,0,0,0,0,0,0,0,0,0,153000,0,0,0,200000,47000,153000,153000
2062,橋椿            ,173000,20000,153000,0,0,0,0,0,0,0,0,0,0,0,0,0,153000
058085,景碩群益9A購01  ,0,0,0,0,0,0,0,0,0,152000,0,0,0,160000,8000,152000,152000
4961,天鈺            ,181000,29000,152000,0,0,0,0,0,0,0,0,0,0,0,0,0,152000
5285,界霖            ,163000,11000,152000,0,0,0,0,0,0,0,0,0,0,0,0,0,152000
3563,牧德            ,190000,108000,82000,0,0,0,0,0,0,70000,48000,3000,45000,33000,8000,25000,152000
1536,和大            ,310000,203723,106277,0,0,0,0,0,0,45000,42000,2000,40000,5000,0,5000,151277
060553,祥碩凱基9A購01  ,0,0,0,0,0,0,0,0,0,151000,0,0,0,417000,266000,151000,151000
06656P,GIS元大98售02   ,0,0,0,0,0,0,0,0,0,151000,0,0,0,203000,52000,151000,151000
049527,國巨中信95購01  ,0,0,0,0,0,0,0,0,0,151000,0,0,0,201000,50000,151000,151000
049595,麗豐元大95購01  ,0,0,0,0,0,0,0,0,0,150000,0,0,0,150000,0,150000,150000
054253,宏達電元大97購03,0,0,0,0,0,0,0,0,0,150000,0,0,0,150000,0,150000,150000
055125,智原兆豐97購01  ,0,0,0,0,0,0,0,0,0,150000,0,0,0,350000,200000,150000,150000
057887,智原群益98購04  ,0,0,0,0,0,0,0,0,0,150000,0,0,0,150000,0,150000,150000
055835,華邦電元大97購03,0,0,0,0,0,0,0,0,0,150000,0,0,0,243000,93000,150000,150000
2816,旺旺保          ,151000,1000,150000,0,0,0,0,0,0,0,0,0,0,0,0,0,150000
07453P,台積電元大9A售05,0,0,0,0,0,0,0,0,0,150000,0,0,0,360000,210000,150000,150000
9921,巨大            ,790000,1230661,-440661,0,0,0,530000,0,530000,60000,40000,6000,34000,26000,0,26000,149339
00715L,街口布蘭特油正2 ,0,0,0,0,0,0,0,0,0,149000,0,61000,-61000,280000,70000,210000,149000
058240,景碩元大99購04  ,0,0,0,0,0,0,0,0,0,149000,0,0,0,218000,69000,149000,149000
3356,奇偶            ,153000,4000,149000,0,0,0,0,0,0,0,0,0,0,0,0,0,149000
060599,國巨凱基9C購01  ,0,0,0,0,0,0,0,0,0,148000,0,0,0,463000,315000,148000,148000
060736,旺宏統一01購01  ,0,0,0,0,0,0,0,0,0,148000,0,0,0,232000,84000,148000,148000
056065,奇鋐元大97購01  ,0,0,0,0,0,0,0,0,0,147000,0,0,0,246000,99000,147000,147000
07100P,華航元大99售01  ,0,0,0,0,0,0,0,0,0,147000,0,0,0,147000,0,147000,147000
06085P,義隆台新97售01  ,0,0,0,0,0,0,0,0,0,146000,0,0,0,203000,57000,146000,146000
061114,南電元大9A購04  ,0,25000,-25000,0,0,0,0,0,0,171000,0,0,0,298000,127000,171000,146000
2634,漢翔            ,505000,392000,113000,0,0,0,2000,0,2000,31000,0,0,0,31000,0,31000,146000
052747,京鼎元大97購01  ,0,0,0,0,0,0,0,0,0,145000,0,0,0,165000,20000,145000,145000
056851,瑞儀元富98購01  ,0,0,0,0,0,0,0,0,0,145000,0,0,0,662000,517000,145000,145000
058912,祥碩元大99購01  ,0,0,0,0,0,0,0,0,0,145000,0,0,0,413000,268000,145000,145000
1902,台紙            ,143000,42000,101000,0,0,0,0,0,0,44000,44000,0,44000,0,0,0,145000
6024,群益期          ,148000,3000,145000,0,0,0,0,0,0,0,0,0,0,0,0,0,145000
059813,滬深2X凱基9B購01,0,0,0,0,0,0,0,0,0,144000,0,0,0,250000,106000,144000,144000
052885,高鐵兆豐98購01  ,0,0,0,0,0,0,0,0,0,144000,0,0,0,154000,10000,144000,144000
053400,緯穎中信9A購01  ,0,0,0,0,0,0,0,0,0,144000,0,0,0,144000,0,144000,144000
059241,旺宏凱基99購07  ,0,0,0,0,0,0,0,0,0,143000,0,0,0,153000,10000,143000,143000
060651,瑞儀中信9B購01  ,0,0,0,0,0,0,0,0,0,143000,0,0,0,509000,366000,143000,143000
060547,瑞昱凱基9A購01  ,0,0,0,0,0,0,0,0,0,143000,0,0,0,356000,213000,143000,143000
061126,京元電永豐9A購02,0,0,0,0,0,0,0,0,0,143000,0,0,0,229000,86000,143000,143000
057876,隆達元大98購01  ,0,0,0,0,0,0,0,0,0,143000,0,0,0,173000,30000,143000,143000
3545,敦泰            ,4171000,4028000,143000,0,0,0,0,0,0,0,0,0,0,0,0,0,143000
1612,宏泰            ,160000,17000,143000,0,0,0,0,0,0,0,0,0,0,0,0,0,143000
059201,祥碩永豐99購02  ,0,0,0,0,0,0,0,0,0,142000,0,0,0,287000,145000,142000,142000
059353,滬深2X富邦9A購02,0,0,0,0,0,0,0,0,0,142000,0,0,0,142000,0,142000,142000
056497,GIS國泰99購01   ,0,0,0,0,0,0,0,0,0,142000,0,0,0,142000,0,142000,142000
052888,台表科中信9A購01,0,0,0,0,0,0,0,0,0,142000,0,0,0,162000,20000,142000,142000
052388,旺宏群益96購05  ,0,0,0,0,0,0,0,0,0,142000,0,0,0,159000,17000,142000,142000
055163,訊芯元大98購01  ,0,0,0,0,0,0,0,0,0,142000,0,0,0,142000,0,142000,142000
060546,旺宏凱基9A購02  ,0,0,0,0,0,0,0,0,0,141000,0,0,0,144000,3000,141000,141000
058775,台積電國票9A購02,0,0,0,0,0,0,0,0,0,141000,0,0,0,347000,206000,141000,141000
058517,景碩元大99購06  ,0,0,0,0,0,0,0,0,0,141000,0,0,0,144000,3000,141000,141000
2850,新產            ,183000,52000,131000,0,0,0,0,0,0,10000,10000,0,10000,0,0,0,141000
4551,智伸科          ,431000,437000,-6000,0,0,0,24000,0,24000,123000,103000,6000,97000,26000,0,26000,141000
8464,億豐            ,337000,245700,91300,0,0,0,35000,5000,30000,19000,2000,2000,0,19000,0,19000,140300
06073P,健策永豐97售01  ,0,0,0,0,0,0,0,0,0,140000,0,0,0,140000,0,140000,140000
059153,臺股指國票99購16,0,0,0,0,0,0,0,0,0,140000,0,0,0,291000,151000,140000,140000
060339,國巨統一01購01  ,0,0,0,0,0,0,0,0,0,140000,0,0,0,187000,47000,140000,140000
056733,國巨凱基98購10  ,0,0,0,0,0,0,0,0,0,140000,0,0,0,140000,0,140000,140000
9958,世紀鋼          ,458000,295000,163000,0,0,0,0,70000,-70000,47000,2000,5000,-3000,98000,48000,50000,140000
07280P,FBVIX凱基99售01 ,0,0,0,0,0,0,0,0,0,140000,0,0,0,140000,0,140000,140000
061135,聯發科統一9C購03,0,0,0,0,0,0,0,0,0,139000,0,0,0,200000,61000,139000,139000
054323,旺宏台新96購02  ,0,0,0,0,0,0,0,0,0,139000,0,0,0,141000,2000,139000,139000
07128P,大毅元大99售04  ,0,0,0,0,0,0,0,0,0,139000,0,0,0,686000,547000,139000,139000
2034,允強            ,248000,109000,139000,0,0,0,0,0,0,0,0,0,0,0,0,0,139000
060512,祥碩元大9A購02  ,0,0,0,0,0,0,0,0,0,138000,0,0,0,221000,83000,138000,138000
054742,京鼎凱基99購01  ,0,0,0,0,0,0,0,0,0,138000,0,0,0,140000,2000,138000,138000
053170,茂林群益96購04  ,0,0,0,0,0,0,0,0,0,138000,0,0,0,536000,398000,138000,138000
2486,一詮            ,150000,12000,138000,0,0,0,0,0,0,0,0,0,0,0,0,0,138000
1104,環泥            ,187000,98000,89000,0,0,0,0,0,0,48000,48000,0,48000,0,0,0,137000
9940,信義            ,252000,115000,137000,0,0,0,0,0,0,0,0,0,0,0,0,0,137000
8261,富鼎            ,160000,23000,137000,0,0,0,0,0,0,0,0,0,0,0,0,0,137000
059911,國巨元大99購27  ,0,0,0,0,0,0,0,0,0,136000,0,0,0,253000,117000,136000,136000
2923,鼎固-KY         ,146000,10000,136000,0,0,0,0,0,0,0,0,0,0,0,0,0,136000
07341P,台積電凱基99售18,0,0,0,0,0,0,0,0,0,136000,0,0,0,136000,0,136000,136000
058239,景碩元大99購03  ,0,0,0,0,0,0,0,0,0,135000,0,0,0,136000,1000,135000,135000
2851,中再保          ,145000,10000,135000,0,0,0,0,0,0,0,0,0,0,0,0,0,135000
8271,宇瞻            ,466000,332000,134000,0,0,0,0,0,0,1000,1000,0,1000,0,0,0,135000
059114,華新科永豐99購05,0,0,0,0,0,0,0,0,0,134000,0,0,0,150000,16000,134000,134000
07390P,華新科康和99售02,0,0,0,0,0,0,0,0,0,134000,0,0,0,384000,250000,134000,134000
06177P,玉晶光元大98售07,0,0,0,0,0,0,0,0,0,133000,0,0,0,133000,0,133000,133000
052274,大立光群益95購03,0,0,0,0,0,0,0,0,0,133000,0,0,0,143000,10000,133000,133000
05161P,華新科國票96售01,0,0,0,0,0,0,0,0,0,133000,0,0,0,172000,39000,133000,133000
058613,茂林元大99購03  ,0,0,0,0,0,0,0,0,0,133000,0,0,0,229000,96000,133000,133000
060658,台灣50凱基01購04,0,0,0,0,0,0,0,0,0,132000,0,0,0,132000,0,132000,132000
057095,祥碩元富98購02  ,0,0,0,0,0,0,0,0,0,132000,0,0,0,132000,0,132000,132000
056464,臺股指凱基99購06,0,0,0,0,0,0,0,0,0,132000,0,0,0,132000,0,132000,132000
055121,鴻海兆豐97購03  ,0,0,0,0,0,0,0,0,0,132000,0,0,0,132000,0,132000,132000
055714,智邦元大97購03  ,0,0,0,0,0,0,0,0,0,132000,0,0,0,136000,4000,132000,132000
9933,中鼎            ,1207000,1104000,103000,0,0,0,7000,0,7000,22000,22000,0,22000,0,0,0,132000
059612,奇鋐永豐99購02  ,0,0,0,0,0,0,0,0,0,131000,0,0,0,153000,22000,131000,131000
055805,矽力永豐97購01  ,0,0,0,0,0,0,0,0,0,131000,0,0,0,141000,10000,131000,131000
056764,友達元大9A購03  ,0,0,0,0,0,0,0,0,0,131000,0,0,0,176000,45000,131000,131000
058514,潤泰全元大99購01,0,0,0,0,0,0,0,0,0,131000,0,0,0,161000,30000,131000,131000
2017,官田鋼          ,161000,30000,131000,0,0,0,0,0,0,0,0,0,0,0,0,0,131000
059255,臺股指凱基99購33,0,0,0,0,0,0,0,0,0,130000,0,0,0,200000,70000,130000,130000
059998,華航元富99購02  ,0,0,0,0,0,0,0,0,0,130000,0,0,0,180000,50000,130000,130000
051405,世芯永豐95購01  ,0,0,0,0,0,0,0,0,0,130000,0,0,0,130000,0,130000,130000
052697,滬深2X國票98購01,0,0,0,0,0,0,0,0,0,130000,0,0,0,130000,0,130000,130000
05401P,聯茂永豐95售03  ,0,0,0,0,0,0,0,0,0,130000,0,0,0,130000,0,130000,130000
055207,致新中信99購01  ,0,0,0,0,0,0,0,0,0,130000,0,0,0,130000,0,130000,130000
056734,國巨凱基99購01  ,0,0,0,0,0,0,0,0,0,130000,0,0,0,130000,0,130000,130000
057225,華新凱基98購01  ,0,0,0,0,0,0,0,0,0,130000,0,0,0,150000,20000,130000,130000
07287P,全新群益9B售01  ,0,0,0,0,0,0,0,0,0,130000,0,0,0,250000,120000,130000,130000
059551,T50正2康和99購02,0,0,0,0,0,0,0,0,0,129000,0,0,0,130000,1000,129000,129000
060509,宏達電元大9A購02,0,0,0,0,0,0,0,0,0,129000,0,0,0,237000,108000,129000,129000
054828,正崴國泰99購01  ,0,0,0,0,0,0,0,0,0,129000,0,0,0,131000,2000,129000,129000
051082,上証2X元大98購01,0,0,0,0,0,0,0,0,0,129000,0,0,0,129000,0,129000,129000
055531,華新科群益98購03,0,0,0,0,0,0,0,0,0,129000,0,0,0,219000,90000,129000,129000
07317P,T50正2凱基9B售02,0,0,0,0,0,0,0,0,0,129000,0,0,0,129000,0,129000,129000
07570P,旺宏凱基9A售04  ,0,0,0,0,0,0,0,0,0,129000,0,0,0,150000,21000,129000,129000
052298,易華電國票96購01,0,0,0,0,0,0,0,0,0,128000,0,0,0,133000,5000,128000,128000
054042,華泰元大96購01  ,0,0,0,0,0,0,0,0,0,128000,0,0,0,221000,93000,128000,128000
057388,奇鋐永豐98購02  ,0,0,0,0,0,0,0,0,0,128000,0,0,0,129000,1000,128000,128000
055657,超眾元富97購02  ,0,0,0,0,0,0,0,0,0,128000,0,0,0,422000,294000,128000,128000
058781,康友國票9A購01  ,0,0,0,0,0,0,0,0,0,128000,0,0,0,182000,54000,128000,128000
07300P,臺股指元大9A售33,0,0,0,0,0,0,0,0,0,128000,0,0,0,170000,42000,128000,128000
2849,安泰銀          ,129000,1000,128000,0,0,0,0,0,0,0,0,0,0,0,0,0,128000
6541,泰福-KY         ,286000,158000,128000,0,0,0,0,0,0,0,0,0,0,0,0,0,128000
060789,禾伸堂富邦9B購02,0,0,0,0,0,0,0,0,0,127000,0,0,0,1017000,890000,127000,127000
058267,奇鋐永豐99購01  ,0,0,0,0,0,0,0,0,0,127000,0,0,0,210000,83000,127000,127000
058408,華通兆豐99購02  ,0,0,0,0,0,0,0,0,0,127000,0,0,0,127000,0,127000,127000
3209,全科            ,142000,14000,128000,0,0,0,0,0,0,-1000,2000,3000,-1000,0,0,0,127000
07174P,臺股指國票99售11,0,0,0,0,0,0,0,0,0,127000,0,0,0,387000,260000,127000,127000
05306P,泰碩國泰97售01  ,0,0,0,0,0,0,0,0,0,126000,0,0,0,184000,58000,126000,126000
053935,華通元富96購02  ,0,0,0,0,0,0,0,0,0,126000,0,0,0,139000,13000,126000,126000
00739,元大MSCI A股    ,0,0,0,0,0,0,0,0,0,126000,0,0,0,320000,194000,126000,126000
058281,奇力新中信99購01,0,0,0,0,0,0,0,0,0,126000,0,0,0,126000,0,126000,126000
2467,志聖            ,168000,42000,126000,0,0,0,0,0,0,0,0,0,0,0,0,0,126000
1218,泰山            ,284000,161000,123000,0,0,0,0,0,0,3000,3000,0,3000,0,0,0,126000
4106,雃博            ,262000,136000,126000,0,0,0,0,0,0,0,0,0,0,0,0,0,126000
059358,旺宏永豐99購02  ,0,0,0,0,0,0,0,0,0,125000,0,0,0,129000,4000,125000,125000
060139,T50反1國票9A購04,0,0,0,0,0,0,0,0,0,125000,0,0,0,145000,20000,125000,125000
055877,奇鋐元富97購01  ,0,0,0,0,0,0,0,0,0,125000,0,0,0,312000,187000,125000,125000
3024,憶聲            ,125000,0,125000,0,0,0,0,0,0,0,0,0,0,0,0,0,125000
057151,易華電國票99購01,0,0,0,0,0,0,0,0,0,124000,0,0,0,266000,142000,124000,124000
057568,友訊永豐99購01  ,0,0,0,0,0,0,0,0,0,124000,0,0,0,124000,0,124000,124000
07462P,臺股指元大9B售05,0,0,0,0,0,0,0,0,0,124000,0,0,0,601000,477000,124000,124000
9939,宏全            ,287000,166000,121000,0,0,0,0,0,0,3000,26000,20000,6000,1000,4000,-3000,124000
057903,聯鈞永豐99購01  ,0,0,0,0,0,0,0,0,0,123000,0,0,0,138000,15000,123000,123000
058841,深中小群益01購01,0,0,0,0,0,0,0,0,0,123000,0,0,0,701000,578000,123000,123000
6706,惠特            ,127000,71000,56000,0,0,0,0,0,0,67000,67000,0,67000,0,0,0,123000
1338,廣華-KY         ,153000,30000,123000,0,0,0,0,0,0,0,0,0,0,0,0,0,123000
060506,京元電元大9A購02,0,70000,-70000,0,0,0,0,0,0,192000,0,0,0,337000,145000,192000,122000
054799,超眾群益98購01  ,0,0,0,0,0,0,0,0,0,122000,0,0,0,124000,2000,122000,122000
058265,奇力新永豐9A購01,0,0,0,0,0,0,0,0,0,122000,0,0,0,132000,10000,122000,122000
3044,健鼎            ,1360000,1236000,124000,0,0,0,0,0,0,-2000,17000,30000,-13000,13000,2000,11000,122000
059639,大立光凱基9A購06,0,0,0,0,0,0,0,0,0,121000,0,0,0,161000,40000,121000,121000
053486,T50反1兆豐96購01,0,0,0,0,0,0,0,0,0,121000,0,0,0,525000,404000,121000,121000
1457,宜進            ,129000,8000,121000,0,0,0,0,0,0,0,0,0,0,0,0,0,121000
2539,櫻花建          ,153000,28000,125000,0,0,0,0,0,0,-4000,0,4000,-4000,0,0,0,121000
059162,國巨凱基99購12  ,0,0,0,0,0,0,0,0,0,120000,0,0,0,237000,117000,120000,120000
060898,世芯凱基9A購03  ,0,0,0,0,0,0,0,0,0,120000,0,0,0,310000,190000,120000,120000
054693,神基永豐97購01  ,0,0,0,0,0,0,0,0,0,120000,0,0,0,120000,0,120000,120000
052203,T50反1中信99購03,0,0,0,0,0,0,0,0,0,120000,0,0,0,150000,30000,120000,120000
051347,國巨元大95購06  ,0,0,0,0,0,0,0,0,0,120000,0,0,0,120000,0,120000,120000
058206,祥碩凱基99購01  ,0,0,0,0,0,0,0,0,0,120000,0,0,0,633000,513000,120000,120000
057916,國巨凱基98購13  ,0,0,0,0,0,0,0,0,0,120000,0,0,0,160000,40000,120000,120000
056664,上証反中信9B購01,0,0,0,0,0,0,0,0,0,120000,0,0,0,120000,0,120000,120000
058582,禾伸堂群益99購02,0,0,0,0,0,0,0,0,0,120000,0,0,0,179000,59000,120000,120000
07506P,中租元大9A售01  ,0,0,0,0,0,0,0,0,0,120000,0,0,0,171000,51000,120000,120000
07632P,臺股指凱基9A售14,0,0,0,0,0,0,0,0,0,120000,0,0,0,150000,30000,120000,120000
07194P,聯發科元大99售25,0,0,0,0,0,0,0,0,0,120000,0,0,0,122000,2000,120000,120000
5515,建國            ,257000,137000,120000,0,0,0,0,0,0,0,0,0,0,0,0,0,120000
06436P,台光電國票98售04,0,0,0,0,0,0,0,0,0,119000,0,0,0,119000,0,119000,119000
060244,大立光元大9B購02,0,0,0,0,0,0,0,0,0,119000,0,0,0,180000,61000,119000,119000
050686,欣興兆豐96購01  ,0,0,0,0,0,0,0,0,0,119000,0,0,0,119000,0,119000,119000
053409,和碩兆豐96購02  ,0,0,0,0,0,0,0,0,0,119000,0,0,0,119000,0,119000,119000
056614,智邦永豐98購01  ,0,0,0,0,0,0,0,0,0,119000,0,0,0,154000,35000,119000,119000
05866P,致伸元大96售01  ,0,0,0,0,0,0,0,0,0,119000,0,0,0,119000,0,119000,119000
06914P,南茂元大98售03  ,0,0,0,0,0,0,0,0,0,119000,0,0,0,130000,11000,119000,119000
2480,敦陽科          ,111000,29000,82000,0,0,0,0,0,0,37000,37000,0,37000,0,0,0,119000
1473,台南            ,136000,17000,119000,0,0,0,0,0,0,0,0,0,0,0,0,0,119000
060763,聯鈞元大9A購03  ,0,0,0,0,0,0,0,0,0,118000,0,0,0,160000,42000,118000,118000
057143,台郡兆豐98購01  ,0,0,0,0,0,0,0,0,0,118000,0,0,0,118000,0,118000,118000
8926,台汽電          ,299000,223000,76000,0,0,0,1000,0,1000,41000,0,0,0,41000,0,41000,118000
06025P,臺股指元大99售02,0,0,0,0,0,0,0,0,0,117000,0,0,0,162000,45000,117000,117000
059578,智邦元富99購02  ,0,0,0,0,0,0,0,0,0,117000,0,0,0,127000,10000,117000,117000
054673,京鼎國泰98購01  ,0,0,0,0,0,0,0,0,0,117000,0,0,0,432000,315000,117000,117000
054480,和碩中信98購01  ,0,0,0,0,0,0,0,0,0,117000,0,0,0,127000,10000,117000,117000
051251,信邦元大95購01  ,0,0,0,0,0,0,0,0,0,117000,0,0,0,117000,0,117000,117000
052104,英業達兆豐96購01,0,0,0,0,0,0,0,0,0,117000,0,0,0,769000,652000,117000,117000
07445P,大立光凱基9A售08,0,0,0,0,0,0,0,0,0,117000,0,0,0,117000,0,117000,117000
07303P,臺股指元大9A售36,0,0,0,0,0,0,0,0,0,117000,0,0,0,256000,139000,117000,117000
060310,瑞昱永豐9A購01  ,0,0,0,0,0,0,0,0,0,116000,0,0,0,225000,109000,116000,116000
05628P,茂林國票97售02  ,0,0,0,0,0,0,0,0,0,116000,0,0,0,116000,0,116000,116000
05919P,京鼎元大96售03  ,0,0,0,0,0,0,0,0,0,115000,0,0,0,278000,163000,115000,115000
052715,可成凱基96購01  ,0,0,0,0,0,0,0,0,0,115000,0,0,0,115000,0,115000,115000
058719,智邦元富99購01  ,0,0,0,0,0,0,0,0,0,115000,0,0,0,115000,0,115000,115000
058452,義隆永豐99購02  ,0,0,0,0,0,0,0,0,0,115000,0,0,0,116000,1000,115000,115000
4976,佳凌            ,161000,46000,115000,0,0,0,0,0,0,0,0,0,0,0,0,0,115000
6112,聚碩            ,124000,9000,115000,0,0,0,0,0,0,0,0,0,0,0,0,0,115000
059327,南茂元大99購01  ,0,0,0,0,0,0,0,0,0,114000,0,0,0,161000,47000,114000,114000
060034,立積永豐99購04  ,0,0,0,0,0,0,0,0,0,114000,0,0,0,220000,106000,114000,114000
060908,金像電元大9A購03,70000,0,70000,0,0,0,0,0,0,44000,0,0,0,706000,662000,44000,114000
054018,華新台新96購01  ,0,0,0,0,0,0,0,0,0,114000,0,0,0,114000,0,114000,114000
051749,矽力國泰97購01  ,0,0,0,0,0,0,0,0,0,114000,0,0,0,114000,0,114000,114000
2453,凌群            ,169000,61000,108000,0,0,0,0,0,0,6000,6000,0,6000,0,0,0,114000
056473,奇力新元大99購02,0,0,0,0,0,0,0,0,0,113000,0,0,0,125000,12000,113000,113000
056882,華邦電康和98購01,0,0,0,0,0,0,0,0,0,113000,0,0,0,134000,21000,113000,113000
2022,聚亨            ,113000,0,113000,0,0,0,0,0,0,0,0,0,0,0,0,0,113000
07514P,台積電元大9A售14,0,0,0,0,0,0,0,0,0,113000,0,0,0,300000,187000,113000,113000
07555P,玉晶光元大9A售07,0,0,0,0,0,0,0,0,0,113000,0,0,0,134000,21000,113000,113000
06951P,台積電統一9B售02,0,0,0,0,0,0,0,0,0,113000,0,0,0,113000,0,113000,113000
4566,時碩工業        ,118000,0,118000,0,0,0,0,0,0,-5000,0,5000,-5000,0,0,0,113000
05921P,同欣電元大96售06,0,0,0,0,0,0,0,0,0,112000,0,0,0,119000,7000,112000,112000
03439B,臺股指元大99熊29,0,0,0,0,0,0,0,0,0,112000,0,0,0,121000,9000,112000,112000
4108,懷特            ,117000,5000,112000,0,0,0,0,0,0,0,0,0,0,0,0,0,112000
06852P,臺股指元大98售11,0,0,0,0,0,0,0,0,0,112000,0,0,0,1536000,1424000,112000,112000
1589,永冠-KY         ,164000,60000,104000,0,0,0,0,0,0,8000,17000,12000,5000,3000,0,3000,112000
051891,智邦元富95購04  ,0,0,0,0,0,0,0,0,0,111000,0,0,0,112000,1000,111000,111000
053417,上銀永豐96購02  ,0,0,0,0,0,0,0,0,0,111000,0,0,0,113000,2000,111000,111000
056534,京元電凱基98購01,0,0,0,0,0,0,0,0,0,111000,0,0,0,116000,5000,111000,111000
058686,祥碩凱基99購03  ,0,0,0,0,0,0,0,0,0,111000,0,0,0,540000,429000,111000,111000
058656,燿華中信99購01  ,0,0,0,0,0,0,0,0,0,111000,0,0,0,386000,275000,111000,111000
07416P,台積電元大99售53,0,0,0,0,0,0,0,0,0,111000,0,0,0,379000,268000,111000,111000
059553,台灣50凱基99購05,0,0,0,0,0,0,0,0,0,110000,0,0,0,110000,0,110000,110000
059650,緯穎凱基99購04  ,0,0,0,0,0,0,0,0,0,110000,0,0,0,170000,60000,110000,110000
06058P,玉晶光凱基97售04,0,0,0,0,0,0,0,0,0,110000,0,0,0,263000,153000,110000,110000
061376,瑞昱永豐9A購02  ,0,0,0,0,0,0,0,0,0,110000,0,0,0,236000,126000,110000,110000
053485,矽創國票97購04  ,0,0,0,0,0,0,0,0,0,110000,0,0,0,110000,0,110000,110000
052667,漢唐群益96購01  ,0,0,0,0,0,0,0,0,0,110000,0,0,0,110000,0,110000,110000
049437,可成國泰96購01  ,0,0,0,0,0,0,0,0,0,110000,0,0,0,110000,0,110000,110000
00650L,FH香港正2       ,16000,0,16000,0,0,0,0,0,0,94000,0,0,0,182000,88000,94000,110000
058185,國巨永豐99購01  ,0,0,0,0,0,0,0,0,0,110000,0,0,0,120000,10000,110000,110000
057566,欣興富邦99購01  ,0,0,0,0,0,0,0,0,0,110000,0,0,0,110000,0,110000,110000
07424P,大立光元大9B售01,0,0,0,0,0,0,0,0,0,110000,0,0,0,110000,0,110000,110000
07574P,國巨元大9A售12  ,0,0,0,0,0,0,0,0,0,110000,0,0,0,245000,135000,110000,110000
6177,達麗            ,135000,25000,110000,0,0,0,0,0,0,0,0,0,0,0,0,0,110000
059912,國巨元大99購28  ,0,0,0,0,0,0,0,0,0,109000,0,0,0,190000,81000,109000,109000
059978,國巨元大99購29  ,0,0,0,0,0,0,0,0,0,109000,0,0,0,109000,0,109000,109000
048049,滬深反中信96購01,0,0,0,0,0,0,0,0,0,109000,0,0,0,109000,0,109000,109000
052685,技嘉元大96購01  ,0,0,0,0,0,0,0,0,0,109000,0,0,0,126000,17000,109000,109000
057071,華擎永豐98購02  ,0,0,0,0,0,0,0,0,0,109000,0,0,0,311000,202000,109000,109000
3033,威健            ,161000,52000,109000,0,0,0,0,0,0,0,0,0,0,0,0,0,109000
07505P,台勝科元大9A售01,0,0,0,0,0,0,0,0,0,109000,0,0,0,109000,0,109000,109000
060051,台積電凱基9B購01,0,0,0,0,0,0,0,0,0,108000,0,0,0,176000,68000,108000,108000
060884,超眾中信9B購01  ,0,0,0,0,0,0,0,0,0,108000,0,0,0,110000,2000,108000,108000
052354,健策群益96購02  ,0,0,0,0,0,0,0,0,0,108000,0,0,0,108000,0,108000,108000
045836,群創群益98購01  ,0,0,0,0,0,0,0,0,0,108000,0,0,0,108000,0,108000,108000
049024,玉晶光群益97購01,0,0,0,0,0,0,0,0,0,108000,0,0,0,118000,10000,108000,108000
053570,京元電統一96購01,0,0,0,0,0,0,0,0,0,108000,0,0,0,108000,0,108000,108000
054082,楠梓電元富96購01,0,0,0,0,0,0,0,0,0,108000,0,0,0,108000,0,108000,108000
05731P,創意統一96售03  ,0,0,0,0,0,0,0,0,0,108000,0,0,0,108000,0,108000,108000
07310P,大立光凱基99售12,0,0,0,0,0,0,0,0,0,108000,0,0,0,169000,61000,108000,108000
1808,潤隆            ,179000,77000,102000,0,0,0,0,0,0,6000,6000,0,6000,0,0,0,108000
1809,中釉            ,109000,1000,108000,0,0,0,0,0,0,0,0,0,0,0,0,0,108000
1109,信大            ,124000,16000,108000,0,0,0,0,0,0,0,0,0,0,0,0,0,108000
5243,乙盛-KY         ,163000,55000,108000,0,0,0,0,0,0,0,0,0,0,0,0,0,108000
060794,景碩永豐9A購02  ,0,0,0,0,0,0,0,0,0,107000,0,0,0,138000,31000,107000,107000
061142,南電統一9A購01  ,0,0,0,0,0,0,0,0,0,107000,0,0,0,209000,102000,107000,107000
059274,國巨元大99購22  ,0,0,0,0,0,0,0,0,0,107000,0,0,0,472000,365000,107000,107000
051157,華新科富邦98購01,0,0,0,0,0,0,0,0,0,107000,0,0,0,107000,0,107000,107000
055731,美律元富97購01  ,0,0,0,0,0,0,0,0,0,107000,0,0,0,107000,0,107000,107000
2020,美亞            ,109000,2000,107000,0,0,0,0,0,0,0,0,0,0,0,0,0,107000
059159,上銀凱基99購05  ,0,0,0,0,0,0,0,0,0,106000,0,0,0,136000,30000,106000,106000
060225,S&P反1元大9A購02,0,0,0,0,0,0,0,0,0,106000,0,0,0,110000,4000,106000,106000
05240P,玉晶光永豐96售01,0,0,0,0,0,0,0,0,0,106000,0,0,0,133000,27000,106000,106000
054546,玉晶光中信9B購01,0,0,0,0,0,0,0,0,0,106000,0,0,0,736000,630000,106000,106000
055025,華新科國泰98購02,0,0,0,0,0,0,0,0,0,106000,0,0,0,327000,221000,106000,106000
057460,楠梓電永豐98購03,0,0,0,0,0,0,0,0,0,106000,0,0,0,106000,0,106000,106000
056665,上証2X國票99購02,0,0,0,0,0,0,0,0,0,106000,0,0,0,180000,74000,106000,106000
053427,鎧勝永豐96購02  ,0,0,0,0,0,0,0,0,0,105000,0,0,0,180000,75000,105000,105000
052681,T50反1元大98購02,0,0,0,0,0,0,0,0,0,105000,0,0,0,106000,1000,105000,105000
053924,京鼎國票97購01  ,0,0,0,0,0,0,0,0,0,105000,0,0,0,105000,0,105000,105000
045054,聯發科元富98購02,0,0,0,0,0,0,0,0,0,105000,0,0,0,115000,10000,105000,105000
047768,大立光元大95購01,0,0,0,0,0,0,0,0,0,105000,0,0,0,105000,0,105000,105000
057457,華邦電富邦98購01,0,0,0,0,0,0,0,0,0,105000,0,0,0,210000,105000,105000,105000
05729P,臺股指凱基97售02,0,0,0,0,0,0,0,0,0,105000,0,0,0,132000,27000,105000,105000
057178,可成元大98購03  ,0,0,0,0,0,0,0,0,0,105000,0,0,0,133000,28000,105000,105000
058135,景碩元大99購01  ,0,0,0,0,0,0,0,0,0,105000,0,0,0,173000,68000,105000,105000
6531,愛普            ,1386000,1299237,86763,0,0,0,0,0,0,18000,23000,5000,18000,0,0,0,104763
060421,華擎永豐9A購01  ,0,0,0,0,0,0,0,0,0,104000,0,0,0,105000,1000,104000,104000
06013P,世芯國泰97售03  ,0,0,0,0,0,0,0,0,0,104000,0,0,0,111000,7000,104000,104000
059313,元石油元大99購06,0,0,0,0,0,0,0,0,0,104000,0,0,0,166000,62000,104000,104000
061168,力成兆豐9A購01  ,0,0,0,0,0,0,0,0,0,104000,0,0,0,269000,165000,104000,104000
00665L,富邦恒生國企正2 ,13000,4000,9000,0,0,0,0,0,0,95000,0,0,0,96000,1000,95000,104000
053675,臺股指元富96購02,0,0,0,0,0,0,0,0,0,104000,0,0,0,104000,0,104000,104000
054455,楠梓電群益98購02,0,0,0,0,0,0,0,0,0,104000,0,0,0,104000,0,104000,104000
055216,友達凱基98購05  ,0,0,0,0,0,0,0,0,0,104000,0,0,0,479000,375000,104000,104000
055563,智易凱基97購02  ,0,0,0,0,0,0,0,0,0,104000,0,0,0,104000,0,104000,104000
06172P,台虹永豐97售02  ,0,0,0,0,0,0,0,0,0,103000,0,0,0,150000,47000,103000,103000
060932,南六永豐9A購02  ,0,0,0,0,0,0,0,0,0,103000,0,0,0,428000,325000,103000,103000
060937,T50反1國票9A購10,0,0,0,0,0,0,0,0,0,103000,0,0,0,787000,684000,103000,103000
061007,聯詠兆豐9A購01  ,0,0,0,0,0,0,0,0,0,103000,0,0,0,143000,40000,103000,103000
059283,康友永豐99購02  ,0,0,0,0,0,0,0,0,0,103000,0,0,0,291000,188000,103000,103000
059121,瑞儀永豐99購01  ,0,0,0,0,0,0,0,0,0,103000,0,0,0,264000,161000,103000,103000
054881,光罩統一97購01  ,0,0,0,0,0,0,0,0,0,103000,0,0,0,210000,107000,103000,103000
053231,奇力新康和96購01,0,0,0,0,0,0,0,0,0,103000,0,0,0,163000,60000,103000,103000
053492,華邦電兆豐97購01,0,0,0,0,0,0,0,0,0,103000,0,0,0,103000,0,103000,103000
055285,華新科元大99購03,0,0,0,0,0,0,0,0,0,103000,0,0,0,103000,0,103000,103000
056819,奇力新永豐98購01,0,0,0,0,0,0,0,0,0,103000,0,0,0,103000,0,103000,103000
058434,旺宏統一9B購01  ,0,0,0,0,0,0,0,0,0,103000,0,0,0,103000,0,103000,103000
8462,柏文            ,109000,8000,101000,0,0,0,0,0,0,2000,0,0,0,2000,0,2000,103000
3266,昇陽            ,119000,16000,103000,0,0,0,0,0,0,0,0,0,0,0,0,0,103000
1598,岱宇            ,230000,118000,112000,0,0,0,0,0,0,-9000,1000,10000,-9000,0,0,0,103000
2608,嘉里大榮        ,162000,59000,103000,0,0,0,0,0,0,0,0,0,0,0,0,0,103000
060749,祥碩國票9A購01  ,0,0,0,0,0,0,0,0,0,102000,0,0,0,210000,108000,102000,102000
06347P,祥碩元富97售02  ,0,0,0,0,0,0,0,0,0,102000,0,0,0,102000,0,102000,102000
06534P,聯發科群益98售04,0,0,0,0,0,0,0,0,0,102000,0,0,0,102000,0,102000,102000
054558,劍麟群益99購01  ,0,0,0,0,0,0,0,0,0,102000,0,0,0,200000,98000,102000,102000
052714,義隆凱基96購02  ,0,0,0,0,0,0,0,0,0,102000,0,0,0,108000,6000,102000,102000
006207,FH滬深          ,1000,82000,-81000,0,0,0,0,0,0,183000,0,30000,-30000,246000,33000,213000,102000
055693,南茂凱基97購01  ,0,0,0,0,0,0,0,0,0,102000,0,0,0,102000,0,102000,102000
2545,皇翔            ,142000,40000,102000,0,0,0,0,0,0,0,0,0,0,0,0,0,102000
2013,中鋼構          ,108000,6000,102000,0,0,0,0,0,0,0,0,0,0,0,0,0,102000
3504,揚明光          ,166000,58000,108000,0,0,0,0,0,0,-6000,1000,7000,-6000,0,0,0,102000
5234,達興材料        ,125000,22000,103000,0,0,0,0,0,0,-1000,0,1000,-1000,0,0,0,102000
059825,嘉晶凱基99購02  ,0,0,0,0,0,0,0,0,0,101000,0,0,0,191000,90000,101000,101000
059542,聯發科亞東99購01,0,0,0,0,0,0,0,0,0,101000,0,0,0,105000,4000,101000,101000
051243,微星元大95購01  ,0,0,0,0,0,0,0,0,0,101000,0,0,0,101000,0,101000,101000
053186,健策中信9C購01  ,0,0,0,0,0,0,0,0,0,101000,0,0,0,103000,2000,101000,101000
056926,日月光兆豐98購01,0,0,0,0,0,0,0,0,0,101000,0,0,0,121000,20000,101000,101000
05859P,台表科國票97售04,0,0,0,0,0,0,0,0,0,101000,0,0,0,102000,1000,101000,101000
07375P,台積電元大99售48,0,0,0,0,0,0,0,0,0,101000,0,0,0,101000,0,101000,101000
060035,臺股指永豐99購04,0,0,0,0,0,0,0,0,0,100000,0,0,0,100000,0,100000,100000
059877,康控凱基99購05  ,0,0,0,0,0,0,0,0,0,100000,0,0,0,120000,20000,100000,100000
060389,世紀鋼凱基9B購02,0,0,0,0,0,0,0,0,0,100000,0,0,0,100000,0,100000,100000
060166,佐登永豐9A購01  ,0,0,0,0,0,0,0,0,0,100000,0,0,0,100000,0,100000,100000
061212,聯鈞元大9A購04  ,0,0,0,0,0,0,0,0,0,100000,0,0,0,115000,15000,100000,100000
060829,T50反1國票9A購06,0,0,0,0,0,0,0,0,0,100000,0,0,0,140000,40000,100000,100000
054628,可成凱基98購01  ,0,0,0,0,0,0,0,0,0,100000,0,0,0,106000,6000,100000,100000
055340,華新科日盛97購01,0,0,0,0,0,0,0,0,0,100000,0,0,0,110000,10000,100000,100000
053819,大立光群益96購04,0,0,0,0,0,0,0,0,0,100000,0,0,0,100000,0,100000,100000
054780,中石化群益99購01,0,0,0,0,0,0,0,0,0,100000,0,0,0,100000,0,100000,100000
051222,世紀鋼元富95購01,0,0,0,0,0,0,0,0,0,100000,0,0,0,100000,0,100000,100000
051128,台表科群益95購02,0,0,0,0,0,0,0,0,0,100000,0,0,0,100000,0,100000,100000
052347,GIS凱基95購05   ,0,0,0,0,0,0,0,0,0,100000,0,0,0,100000,0,100000,100000
047457,旺宏群益95購01  ,0,0,0,0,0,0,0,0,0,100000,0,0,0,100000,0,100000,100000
048350,世紀鋼元大95購01,0,0,0,0,0,0,0,0,0,100000,0,0,0,100000,0,100000,100000
049488,智邦元大95購01  ,0,0,0,0,0,0,0,0,0,100000,0,0,0,100000,0,100000,100000
049372,華新科元大95購04,0,0,0,0,0,0,0,0,0,100000,0,0,0,100000,0,100000,100000
047287,貿聯統一95購01  ,0,0,0,0,0,0,0,0,0,100000,0,0,0,100000,0,100000,100000
058480,新日興凱基9A購01,0,0,0,0,0,0,0,0,0,100000,0,0,0,100000,0,100000,100000
058502,鴻海元大99購13  ,0,0,0,0,0,0,0,0,0,100000,0,0,0,115000,15000,100000,100000
056977,國巨群益9A購01  ,0,0,0,0,0,0,0,0,0,100000,0,0,0,100000,0,100000,100000
056993,GIS兆豐99購01   ,0,0,0,0,0,0,0,0,0,100000,0,0,0,100000,0,100000,100000
056204,嘉澤永豐97購01  ,0,0,0,0,0,0,0,0,0,100000,0,0,0,100000,0,100000,100000
055662,上銀中信99購01  ,0,0,0,0,0,0,0,0,0,100000,0,0,0,100000,0,100000,100000
057269,鈺齊兆豐98購01  ,0,0,0,0,0,0,0,0,0,100000,0,0,0,100000,0,100000,100000
055294,智易元大98購01  ,0,0,0,0,0,0,0,0,0,100000,0,0,0,100000,0,100000,100000
055198,奇力新第一97購01,0,0,0,0,0,0,0,0,0,100000,0,0,0,100000,0,100000,100000
05763P,致新永豐96售01  ,0,0,0,0,0,0,0,0,0,100000,0,0,0,100000,0,100000,100000
055023,億光國泰98購01  ,0,0,0,0,0,0,0,0,0,100000,0,0,0,100000,0,100000,100000
07497P,鴻海元大9A售06  ,0,0,0,0,0,0,0,0,0,100000,0,0,0,125000,25000,100000,100000
07698P,臺股指元大9A售51,0,0,0,0,0,0,0,0,0,100000,0,0,0,110000,10000,100000,100000
06890P,金融類元大98售02,0,0,0,0,0,0,0,0,0,100000,0,0,0,100000,0,100000,100000
06846P,美律元大98售05  ,0,0,0,0,0,0,0,0,0,100000,0,0,0,100000,0,100000,100000
06967P,台郡台新99售02  ,0,0,0,0,0,0,0,0,0,100000,0,0,0,100000,0,100000,100000
3030,德律            ,167000,67200,99800,0,0,0,0,0,0,0,0,0,0,0,0,0,99800
060833,道瓊反國票9A購01,0,0,0,0,0,0,0,0,0,99000,0,0,0,99000,0,99000,99000
060919,滬深2X富邦9B購01,0,0,0,0,0,0,0,0,0,99000,0,0,0,99000,0,99000,99000
060563,智邦富邦9A購01  ,0,0,0,0,0,0,0,0,0,99000,0,0,0,127000,28000,99000,99000
05115P,T50反1群益95售02,0,0,0,0,0,0,0,0,0,99000,0,0,0,99000,0,99000,99000
051160,亞德客元大95購02,0,0,0,0,0,0,0,0,0,99000,0,0,0,99000,0,99000,99000
050778,瑞儀元大96購01  ,0,0,0,0,0,0,0,0,0,99000,0,0,0,100000,1000,99000,99000
053849,聯發科元富96購04,0,0,0,0,0,0,0,0,0,99000,0,0,0,99000,0,99000,99000
057416,T50反1凱基9C購01,0,0,0,0,0,0,0,0,0,99000,0,0,0,99000,0,99000,99000
05760P,京鼎永豐96售02  ,0,0,0,0,0,0,0,0,0,99000,0,0,0,119000,20000,99000,99000
055708,茂林永豐97購02  ,0,0,0,0,0,0,0,0,0,99000,0,0,0,99000,0,99000,99000
056931,智原台新98購01  ,0,0,0,0,0,0,0,0,0,99000,0,0,0,99000,0,99000,99000
07405P,大立光凱基99售17,0,0,0,0,0,0,0,0,0,99000,0,0,0,99000,0,99000,99000
060777,茂林凱基9C購01  ,0,0,0,0,0,0,0,0,0,98000,0,0,0,160000,62000,98000,98000
054160,華泰凱基98購01  ,0,0,0,0,0,0,0,0,0,98000,0,0,0,135000,37000,98000,98000
056617,美律永豐98購01  ,0,0,0,0,0,0,0,0,0,98000,0,0,0,118000,20000,98000,98000
055432,臻鼎群益97購02  ,0,0,0,0,0,0,0,0,0,98000,0,0,0,98000,0,98000,98000
053519,力成群益96購02  ,0,0,0,0,0,0,0,0,0,98000,0,0,0,98000,0,98000,98000
053583,漢唐元大96購03  ,0,0,0,0,0,0,0,0,0,98000,0,0,0,98000,0,98000,98000
053599,崇越元大96購01  ,0,0,0,0,0,0,0,0,0,98000,0,0,0,100000,2000,98000,98000
052693,微星中信96購01  ,0,0,0,0,0,0,0,0,0,98000,0,0,0,106000,8000,98000,98000
055937,康舒群益97購01  ,0,0,0,0,0,0,0,0,0,98000,0,0,0,98000,0,98000,98000
058175,旺宏凱基99購03  ,0,0,0,0,0,0,0,0,0,98000,0,0,0,98000,0,98000,98000
07583P,台積電富邦9B售05,0,0,0,0,0,0,0,0,0,98000,0,0,0,132000,34000,98000,98000
07208P,台積電凱基99售14,0,0,0,0,0,0,0,0,0,98000,0,0,0,303000,205000,98000,98000
3321,同泰            ,112000,1628,110372,0,0,0,0,13000,-13000,0,0,0,0,0,0,0,97372
060204,矽創元富9A購01  ,0,0,0,0,0,0,0,0,0,97000,0,0,0,125000,28000,97000,97000
060060,台積電兆豐99購05,0,0,0,0,0,0,0,0,0,97000,0,0,0,132000,35000,97000,97000
00668,國泰美國道瓊    ,0,0,0,0,0,0,0,0,0,97000,0,0,0,103000,6000,97000,97000
053601,台表科元大98購01,0,0,0,0,0,0,0,0,0,97000,0,0,0,97000,0,97000,97000
07022P,嘉晶永豐99售02  ,0,0,0,0,0,0,0,0,0,97000,0,0,0,208000,111000,97000,97000
059908,元金2X元大99購01,0,0,0,0,0,0,0,0,0,96000,0,0,0,121000,25000,96000,96000
054572,國巨元大98購03  ,0,0,0,0,0,0,0,0,0,96000,0,0,0,96000,0,96000,96000
03050X,元展47          ,0,0,0,0,0,0,0,0,0,96000,0,0,0,96000,0,96000,96000
058243,華擎元大99購01  ,0,0,0,0,0,0,0,0,0,96000,0,0,0,402000,306000,96000,96000
057032,A50反1元大9B購01,0,0,0,0,0,0,0,0,0,96000,0,0,0,100000,4000,96000,96000
056084,漢唐統一97購03  ,0,0,0,0,0,0,0,0,0,96000,0,0,0,96000,0,96000,96000
3149,正達            ,96000,0,96000,0,0,0,0,0,0,0,0,0,0,0,0,0,96000
060260,京鼎凱基9C購01  ,0,0,0,0,0,0,0,0,0,95000,0,0,0,116000,21000,95000,95000
060251,易華電元大9C購01,0,0,0,0,0,0,0,0,0,95000,0,0,0,212000,117000,95000,95000
05911P,南亞科永豐96售03,0,0,0,0,0,0,0,0,0,95000,0,0,0,99000,4000,95000,95000
04462P,全新元富96售01  ,0,0,0,0,0,0,0,0,0,95000,0,0,0,126000,31000,95000,95000
07400P,國巨凱基99售20  ,0,0,0,0,0,0,0,0,0,95000,0,0,0,340000,245000,95000,95000
2612,中航            ,102000,7000,95000,0,0,0,0,0,0,0,0,0,0,0,0,0,95000
059848,智邦永豐99購01  ,0,0,0,0,0,0,0,0,0,94000,0,0,0,132000,38000,94000,94000
059942,全新永豐99購04  ,0,0,0,0,0,0,0,0,0,94000,0,0,0,95000,1000,94000,94000
060714,晶技永豐9A購02  ,0,0,0,0,0,0,0,0,0,94000,0,0,0,148000,54000,94000,94000
06765P,欣興元大98售11  ,0,0,0,0,0,0,0,0,0,94000,0,0,0,100000,6000,94000,94000
051643,瑞昱康和95購01  ,0,0,0,0,0,0,0,0,0,94000,0,0,0,94000,0,94000,94000
057730,聯鈞國泰9A購01  ,0,0,0,0,0,0,0,0,0,94000,0,0,0,547000,453000,94000,94000
056921,京元電兆豐98購01,0,0,0,0,0,0,0,0,0,94000,0,0,0,199000,105000,94000,94000
1337,再生-KY         ,128000,34000,94000,0,0,0,0,0,0,0,0,0,0,0,0,0,94000
07635P,世芯永豐9A售05  ,0,0,0,0,0,0,0,0,0,94000,0,0,0,105000,11000,94000,94000
06994P,台光電凱基99售02,0,0,0,0,0,0,0,0,0,94000,0,0,0,94000,0,94000,94000
3583,辛耘            ,121000,27000,94000,0,0,0,0,0,0,0,0,0,0,0,0,0,94000
06746P,聯發科群益99售02,0,0,0,0,0,0,0,0,0,93000,0,0,0,103000,10000,93000,93000
061000,旺宏兆豐9A購02  ,0,0,0,0,0,0,0,0,0,93000,0,0,0,94000,1000,93000,93000
053316,友達群益9A購01  ,0,0,0,0,0,0,0,0,0,93000,0,0,0,93000,0,93000,93000
058355,旺宏凱基99購04  ,0,0,0,0,0,0,0,0,0,93000,0,0,0,103000,10000,93000,93000
060109,茂林元大99購05  ,0,0,0,0,0,0,0,0,0,92000,0,0,0,148000,56000,92000,92000
052893,聯電群益98購01  ,0,0,0,0,0,0,0,0,0,92000,0,0,0,155000,63000,92000,92000
053725,晶相光凱基96購01,0,0,0,0,0,0,0,0,0,92000,0,0,0,92000,0,92000,92000
05265P,正崴元大95售03  ,0,0,0,0,0,0,0,0,0,92000,0,0,0,92000,0,92000,92000
052490,禾伸堂國票95購01,0,0,0,0,0,0,0,0,0,92000,0,0,0,92000,0,92000,92000
050307,欣興中信95購01  ,0,0,0,0,0,0,0,0,0,92000,0,0,0,92000,0,92000,92000
056669,貿聯國票99購01  ,0,0,0,0,0,0,0,0,0,92000,0,0,0,92000,0,92000,92000
055814,晶豪科國票97購02,0,0,0,0,0,0,0,0,0,92000,0,0,0,415000,323000,92000,92000
059203,勤誠永豐99購02  ,0,0,0,0,0,0,0,0,0,91000,0,0,0,124000,33000,91000,91000
060573,力成永豐9A購01  ,0,0,0,0,0,0,0,0,0,91000,0,0,0,136000,45000,91000,91000
00639,富邦深100       ,36000,22000,14000,0,0,0,0,0,0,77000,80000,80000,0,948000,871000,77000,91000
057553,景碩凱基98購03  ,0,0,0,0,0,0,0,0,0,91000,0,0,0,91000,0,91000,91000
058567,華新科凱基9A購02,0,0,0,0,0,0,0,0,0,91000,0,0,0,152000,61000,91000,91000
1526,日馳            ,111000,20000,91000,0,0,0,0,0,0,0,0,0,0,0,0,0,91000
2441,超豐            ,144000,54000,90000,0,0,0,1000,0,1000,0,0,0,0,0,0,0,91000
060634,矽創富邦9B購01  ,5000,0,5000,0,0,0,0,0,0,85000,0,0,0,145000,60000,85000,90000
060907,金像電元大9A購02,0,0,0,0,0,0,0,0,0,90000,0,0,0,494000,404000,90000,90000
052828,滬深2X群益9A購02,0,0,0,0,0,0,0,0,0,90000,0,0,0,90000,0,90000,90000
052702,群創國票97購03  ,0,0,0,0,0,0,0,0,0,90000,0,0,0,100000,10000,90000,90000
051800,旺宏永豐95購02  ,0,0,0,0,0,0,0,0,0,90000,0,0,0,132000,42000,90000,90000
056341,宏達電凱基9A購01,0,0,0,0,0,0,0,0,0,90000,0,0,0,90000,0,90000,90000
058463,宏達電兆豐99購02,0,0,0,0,0,0,0,0,0,90000,0,0,0,146000,56000,90000,90000
055803,鎧勝永豐97購01  ,0,0,0,0,0,0,0,0,0,90000,0,0,0,120000,30000,90000,90000
2727,王品            ,116000,26000,90000,0,0,0,0,0,0,0,0,0,0,0,0,0,90000
2524,京城            ,150000,60000,90000,0,0,0,0,0,0,0,0,0,0,0,0,0,90000
07219P,臺股指凱基99售32,0,0,0,0,0,0,0,0,0,90000,0,0,0,93000,3000,90000,90000
07227P,聯發科元富99售05,0,0,0,0,0,0,0,0,0,90000,0,0,0,111000,21000,90000,90000
07532P,台灣50中信01售02,0,0,0,0,0,0,0,0,0,90000,0,0,0,100000,10000,90000,90000
6197,佳必琪          ,109000,19000,90000,0,0,0,0,0,0,0,0,0,0,0,0,0,90000
053890,華新科群益98購01,0,0,0,0,0,0,0,0,0,89000,0,0,0,89000,0,89000,89000
052452,茂林元大95購03  ,0,0,0,0,0,0,0,0,0,89000,0,0,0,139000,50000,89000,89000
01003T,兆豐新光R1      ,89000,0,89000,0,0,0,0,0,0,0,0,0,0,0,0,0,89000
050306,聯發科中信97購01,0,0,0,0,0,0,0,0,0,89000,0,0,0,379000,290000,89000,89000
054250,漢唐元大96購04  ,0,0,0,0,0,0,0,0,0,89000,0,0,0,99000,10000,89000,89000
055720,宏達電元大97購05,0,0,0,0,0,0,0,0,0,89000,0,0,0,154000,65000,89000,89000
054981,國巨元富97購02  ,0,0,0,0,0,0,0,0,0,89000,0,0,0,89000,0,89000,89000
055824,臺股指國票97購11,0,0,0,0,0,0,0,0,0,89000,0,0,0,89000,0,89000,89000
057010,景碩中信98購01  ,0,0,0,0,0,0,0,0,0,89000,0,0,0,364000,275000,89000,89000
4190,佐登-KY         ,126000,14000,112000,0,0,0,0,30000,-30000,7000,0,0,0,11000,4000,7000,89000
2374,佳能            ,91000,1000,90000,0,0,0,0,0,0,-1000,0,1000,-1000,0,0,0,89000
060772,FBVIX凱基9A購03 ,0,0,0,0,0,0,0,0,0,88000,0,0,0,88000,0,88000,88000
060320,元金2X群益02購01,0,0,0,0,0,0,0,0,0,88000,0,0,0,130000,42000,88000,88000
05546P,全新元大97售01  ,0,0,0,0,0,0,0,0,0,88000,0,0,0,95000,7000,88000,88000
051736,旺宏國票96購01  ,0,0,0,0,0,0,0,0,0,88000,0,0,0,88000,0,88000,88000
3028,增你強          ,103000,15000,88000,0,0,0,0,0,0,0,0,0,0,0,0,0,88000
1731,美吾華          ,113000,25000,88000,0,0,0,0,0,0,0,0,0,0,0,0,0,88000
054163,燿華凱基97購02  ,0,0,0,0,0,0,0,0,0,87000,0,0,0,87000,0,87000,87000
058181,華新科國泰9B購01,0,0,0,0,0,0,0,0,0,87000,0,0,0,385000,298000,87000,87000
1225,福懋油          ,116000,29000,87000,0,0,0,0,0,0,0,0,0,0,0,0,0,87000
060754,華通元大9A購04  ,0,0,0,0,0,0,0,0,0,86000,0,0,0,100000,14000,86000,86000
06662P,玉晶光中信9A售01,0,0,0,0,0,0,0,0,0,86000,0,0,0,593000,507000,86000,86000
050900,台郡元大95購02  ,0,0,0,0,0,0,0,0,0,86000,0,0,0,86000,0,86000,86000
052602,聯電元大97購01  ,0,0,0,0,0,0,0,0,0,86000,0,0,0,96000,10000,86000,86000
057886,聯詠群益98購01  ,0,0,0,0,0,0,0,0,0,86000,0,0,0,86000,0,86000,86000
055603,超眾元大97購04  ,0,0,0,0,0,0,0,0,0,86000,0,0,0,87000,1000,86000,86000
055934,景碩群益98購03  ,0,0,0,0,0,0,0,0,0,86000,0,0,0,88000,2000,86000,86000
057960,聯鈞元大98購02  ,0,0,0,0,0,0,0,0,0,86000,0,0,0,154000,68000,86000,86000
057946,晶相光國票99購01,0,0,0,0,0,0,0,0,0,86000,0,0,0,86000,0,86000,86000
07627P,超眾凱基9A售02  ,0,0,0,0,0,0,0,0,0,86000,0,0,0,86000,0,86000,86000
060565,大立光富邦01購01,0,0,0,0,0,0,0,0,0,85000,0,0,0,218000,133000,85000,85000
060954,國泰金群益9A購02,0,0,0,0,0,0,0,0,0,85000,0,0,0,98000,13000,85000,85000
059637,大立光凱基01購01,0,0,0,0,0,0,0,0,0,85000,0,0,0,105000,20000,85000,85000
055527,旺宏群益99購03  ,0,0,0,0,0,0,0,0,0,85000,0,0,0,186000,101000,85000,85000
055510,GIS元大97購03   ,0,0,0,0,0,0,0,0,0,85000,0,0,0,118000,33000,85000,85000
056812,泰鼎統一98購01  ,0,0,0,0,0,0,0,0,0,85000,0,0,0,95000,10000,85000,85000
1451,年興            ,102000,17000,85000,0,0,0,0,0,0,0,0,0,0,0,0,0,85000
1532,勤美            ,166000,81000,85000,0,0,0,0,0,0,0,0,0,0,0,0,0,85000
3705,永信            ,91000,6000,85000,0,0,0,0,0,0,0,0,0,0,0,0,0,85000
4576,大銀微系統      ,115000,30000,85000,0,0,0,0,0,0,0,0,0,0,0,0,0,85000
059636,宏達電凱基99購05,0,0,0,0,0,0,0,0,0,84000,0,0,0,190000,106000,84000,84000
059509,奇力新永豐99購02,0,0,0,0,0,0,0,0,0,84000,0,0,0,86000,2000,84000,84000
060288,群光元大9C購01  ,0,0,0,0,0,0,0,0,0,84000,0,0,0,127000,43000,84000,84000
060167,禾聯碩永豐9A購01,0,0,0,0,0,0,0,0,0,84000,0,0,0,114000,30000,84000,84000
053958,京元電永豐96購01,0,0,0,0,0,0,0,0,0,84000,0,0,0,84000,0,84000,84000
056774,和鑫元大98購01  ,0,0,0,0,0,0,0,0,0,84000,0,0,0,274000,190000,84000,84000
057329,緯穎群益98購02  ,0,0,0,0,0,0,0,0,0,84000,0,0,0,87000,3000,84000,84000
057357,超眾統一98購01  ,0,0,0,0,0,0,0,0,0,84000,0,0,0,84000,0,84000,84000
056049,奇力新國票98購01,0,0,0,0,0,0,0,0,0,84000,0,0,0,181000,97000,84000,84000
8463,潤泰材          ,97000,13000,84000,0,0,0,0,0,0,0,0,0,0,0,0,0,84000
9908,大台北          ,114000,30000,84000,0,0,0,0,0,0,0,0,0,0,0,0,0,84000
1903,士紙            ,95000,11000,84000,0,0,0,0,0,0,0,0,0,0,0,0,0,84000
059608,聯發科富邦9B購04,0,0,0,0,0,0,0,0,0,83000,0,0,0,83000,0,83000,83000
051748,超眾國泰96購01  ,0,0,0,0,0,0,0,0,0,83000,0,0,0,83000,0,83000,83000
059561,滬深2X凱基9C購05,0,0,0,0,0,0,0,0,0,82000,0,0,0,82000,0,82000,82000
060824,旺宏元大9A購06  ,0,0,0,0,0,0,0,0,0,82000,0,0,0,188000,106000,82000,82000
060991,京鼎元大9A購01  ,0,0,0,0,0,0,0,0,0,82000,0,0,0,329000,247000,82000,82000
055479,GIS凱基97購04   ,0,0,0,0,0,0,0,0,0,82000,0,0,0,92000,10000,82000,82000
056586,光罩統一98購02  ,0,0,0,0,0,0,0,0,0,82000,0,0,0,371000,289000,82000,82000
053115,滬深2X中信97購01,0,0,0,0,0,0,0,0,0,82000,0,0,0,82000,0,82000,82000
056077,矽力元大97購07  ,0,0,0,0,0,0,0,0,0,82000,0,0,0,82000,0,82000,82000
058467,日月光中信9A購01,0,0,0,0,0,0,0,0,0,82000,0,0,0,82000,0,82000,82000
2704,國賓            ,91000,9000,82000,0,0,0,0,0,0,0,0,0,0,0,0,0,82000
07477P,國巨群益9A售04  ,0,0,0,0,0,0,0,0,0,82000,0,0,0,82000,0,82000,82000
8429,金麗-KY         ,89000,7000,82000,0,0,0,0,0,0,0,0,0,0,0,0,0,82000
4942,嘉彰            ,155000,73000,82000,0,0,0,0,0,0,0,0,0,0,0,0,0,82000
060533,臺股指中信9B購05,0,0,0,0,0,0,0,0,0,81000,0,0,0,156000,75000,81000,81000
059395,T50反1元富99購03,0,0,0,0,0,0,0,0,0,81000,0,0,0,1000000,919000,81000,81000
05273P,國巨群益95售02  ,0,0,0,0,0,0,0,0,0,81000,0,0,0,81000,0,81000,81000
058941,華新科中信99購03,0,0,0,0,0,0,0,0,0,81000,0,0,0,81000,0,81000,81000
059054,國巨凱基99購11  ,0,0,0,0,0,0,0,0,0,81000,0,0,0,93000,12000,81000,81000
057161,亞德客元大98購02,0,0,0,0,0,0,0,0,0,81000,0,0,0,156000,75000,81000,81000
055172,凱美統一97購02  ,0,0,0,0,0,0,0,0,0,81000,0,0,0,166000,85000,81000,81000
057873,義隆元大98購03  ,0,0,0,0,0,0,0,0,0,81000,0,0,0,286000,205000,81000,81000
058456,京鼎永豐99購01  ,0,0,0,0,0,0,0,0,0,81000,0,0,0,138000,57000,81000,81000
07623P,大立光統一9B售05,0,0,0,0,0,0,0,0,0,81000,0,0,0,205000,124000,81000,81000
1810,和成            ,121000,40000,81000,0,0,0,0,0,0,0,0,0,0,0,0,0,81000
1702,南僑            ,121000,50000,71000,0,0,0,0,0,0,10000,10000,0,10000,0,0,0,81000
059512,晶豪科永豐99購02,0,0,0,0,0,0,0,0,0,80000,0,0,0,80000,0,80000,80000
060070,國巨元富99購02  ,0,0,0,0,0,0,0,0,0,80000,0,0,0,210000,130000,80000,80000
060039,大立光國票99購04,0,0,0,0,0,0,0,0,0,80000,0,0,0,80000,0,80000,80000
060534,友達麥證9A購01  ,0,0,0,80000,0,80000,0,0,0,80000,0,0,0,80000,0,80000,80000
060662,旺宏凱基9A購03  ,0,0,0,0,0,0,0,0,0,80000,0,0,0,156000,76000,80000,80000
052733,台郡國泰97購01  ,0,0,0,0,0,0,0,0,0,80000,0,0,0,195000,115000,80000,80000
05192P,玉晶光台新96售02,0,0,0,0,0,0,0,0,0,80000,0,0,0,80000,0,80000,80000
052370,滬深2X元大95購04,0,0,0,0,0,0,0,0,0,80000,0,0,0,80000,0,80000,80000
03442B,臺股指元大9A熊48,0,0,0,0,0,0,0,0,0,80000,0,0,0,85000,5000,80000,80000
03896P,長榮航凱基95售01,0,0,0,0,0,0,0,0,0,80000,0,0,0,80000,0,80000,80000
020000,富邦特選蘋果N   ,0,0,0,0,0,0,0,0,0,80000,0,0,0,80000,0,80000,80000
04907P,超眾國票95售01  ,0,0,0,0,0,0,0,0,0,80000,0,0,0,80000,0,80000,80000
055090,國巨群益97購03  ,0,0,0,0,0,0,0,0,0,80000,0,0,0,284000,204000,80000,80000
056251,聯發科兆豐97購02,0,0,0,0,0,0,0,0,0,80000,0,0,0,81000,1000,80000,80000
057060,緯穎元大98購05  ,0,0,0,0,0,0,0,0,0,80000,0,0,0,80000,0,80000,80000
1723,中碳            ,281000,201000,80000,0,0,0,0,0,0,0,0,0,0,0,0,0,80000
2010,春源            ,138000,63000,75000,0,0,0,0,0,0,5000,5000,0,5000,0,0,0,80000
6269,台郡            ,1468000,1960000,-492000,0,0,0,160000,0,160000,412000,319000,106000,213000,205000,6000,199000,80000
4164,承業醫          ,92000,9000,83000,0,0,0,0,0,0,-3000,0,3000,-3000,0,0,0,80000
9941,裕融            ,140000,62000,78000,0,0,0,2000,0,2000,0,0,0,0,0,0,0,80000
061428,南六元大9A購01  ,0,0,0,0,0,0,0,0,0,79000,0,0,0,132000,53000,79000,79000
059273,臺指反元大9C購03,0,0,0,0,0,0,0,0,0,79000,0,0,0,80000,1000,79000,79000
00770,國泰北美科技    ,0,0,0,0,0,0,0,0,0,79000,0,0,0,80000,1000,79000,79000
00651R,FH香港反1       ,0,10000,-10000,0,0,0,0,0,0,89000,0,0,0,338000,249000,89000,79000
056423,奇鋐統一98購01  ,0,0,0,0,0,0,0,0,0,79000,0,0,0,79000,0,79000,79000
057826,祥碩元大98購08  ,0,0,0,0,0,0,0,0,0,79000,0,0,0,105000,26000,79000,79000
1442,名軒            ,83000,4000,79000,0,0,0,0,0,0,0,0,0,0,0,0,0,79000
07630P,臺股指凱基9A售11,0,0,0,0,0,0,0,0,0,79000,0,0,0,113000,34000,79000,79000
059213,國巨元大99購19  ,0,0,0,0,0,0,0,0,0,78000,0,0,0,371000,293000,78000,78000
06144P,台光電永豐97售01,0,0,0,0,0,0,0,0,0,78000,0,0,0,83000,5000,78000,78000
049463,華新科富邦97購01,0,0,0,0,0,0,0,0,0,78000,0,0,0,78000,0,78000,78000
054261,智伸科元大96購03,0,0,0,0,0,0,0,0,0,78000,0,0,0,78000,0,78000,78000
055168,光罩統一98購01  ,0,0,0,0,0,0,0,0,0,78000,0,0,0,84000,6000,78000,78000
056696,茂林群益98購02  ,0,0,0,0,0,0,0,0,0,78000,0,0,0,98000,20000,78000,78000
057374,禾伸堂元大99購03,0,0,0,0,0,0,0,0,0,78000,0,0,0,312000,234000,78000,78000
1721,三晃            ,99000,21000,78000,0,0,0,0,0,0,0,0,0,0,0,0,0,78000
2535,達欣工          ,145000,74000,71000,0,0,0,0,0,0,7000,7000,0,7000,0,0,0,78000
2908,特力            ,130000,52000,78000,0,0,0,0,0,0,0,0,0,0,0,0,0,78000
9943,好樂迪          ,186000,108000,78000,0,0,0,0,0,0,0,0,0,0,0,0,0,78000
06072P,牧德永豐97售01  ,0,0,0,0,0,0,0,0,0,77000,0,0,0,148000,71000,77000,77000
061034,晶豪科永豐9A購01,0,0,0,0,0,0,0,0,0,77000,0,0,0,156000,79000,77000,77000
059693,智原永豐99購01  ,0,0,0,0,0,0,0,0,0,77000,0,0,0,79000,2000,77000,77000
059836,大立光國泰9B購02,0,0,0,0,0,0,0,0,0,77000,0,0,0,90000,13000,77000,77000
053631,欣興兆豐97購01  ,0,0,0,0,0,0,0,0,0,77000,0,0,0,97000,20000,77000,77000
04696P,亞德客國泰95售02,0,0,0,0,0,0,0,0,0,77000,0,0,0,77000,0,77000,77000
048349,美利達元大96購02,0,0,0,0,0,0,0,0,0,77000,0,0,0,77000,0,77000,77000
05506P,茂林凱基96售03  ,0,0,0,0,0,0,0,0,0,77000,0,0,0,127000,50000,77000,77000
058435,旺宏統一9B購02  ,0,0,0,0,0,0,0,0,0,77000,0,0,0,386000,309000,77000,77000
058209,臺股指凱基01購01,0,0,0,0,0,0,0,0,0,77000,0,0,0,77000,0,77000,77000
055817,京鼎國票99購01  ,0,0,0,0,0,0,0,0,0,77000,0,0,0,82000,5000,77000,77000
2488,漢平            ,88000,11000,77000,0,0,0,0,0,0,0,0,0,0,0,0,0,77000
07071P,立積元富99售01  ,0,0,0,0,0,0,0,0,0,77000,0,0,0,90000,13000,77000,77000
060212,華航康和9A購01  ,0,0,0,0,0,0,0,0,0,76000,0,0,0,82000,6000,76000,76000
059116,晶豪科永豐99購01,0,0,0,0,0,0,0,0,0,76000,0,0,0,115000,39000,76000,76000
060870,旭富群益9A購01  ,0,0,0,0,0,0,0,0,0,76000,0,0,0,80000,4000,76000,76000
060926,宏達電永豐9A購01,0,0,0,0,0,0,0,0,0,76000,0,0,0,209000,133000,76000,76000
052677,景碩富邦97購01  ,0,0,0,0,0,0,0,0,0,76000,0,0,0,76000,0,76000,76000
054640,健策中信9B購01  ,20000,0,20000,0,0,0,0,0,0,56000,0,0,0,116000,60000,56000,76000
053998,泰鼎群益98購01  ,0,0,0,0,0,0,0,0,0,76000,0,0,0,131000,55000,76000,76000
052775,滬深2X國票99購02,0,0,0,0,0,0,0,0,0,76000,0,0,0,81000,5000,76000,76000
056723,國巨中信9A購01  ,0,0,0,0,0,0,0,0,0,76000,0,0,0,76000,0,76000,76000
07721P,台積電凱基9A售22,0,0,0,0,0,0,0,0,0,76000,0,0,0,114000,38000,76000,76000
4994,傳奇            ,124000,39000,85000,0,0,0,0,0,0,-9000,0,9000,-9000,0,0,0,76000
059442,祥碩元大99購03  ,0,0,0,0,0,0,0,0,0,75000,0,0,0,96000,21000,75000,75000
054291,高鐵元大97購01  ,0,0,0,0,0,0,0,0,0,75000,0,0,0,75000,0,75000,75000
052860,旺宏凱基96購03  ,0,0,0,0,0,0,0,0,0,75000,0,0,0,85000,10000,75000,75000
055633,牧德永豐97購02  ,0,0,0,0,0,0,0,0,0,75000,0,0,0,75000,0,75000,75000
057258,中環兆豐98購01  ,0,0,0,0,0,0,0,0,0,75000,0,0,0,362000,287000,75000,75000
1560,中砂            ,113000,38000,75000,0,0,0,0,0,0,0,0,0,0,0,0,0,75000
050966,日月光永豐95購01,0,0,0,0,0,0,0,0,0,74000,0,0,0,74000,0,74000,74000
055149,國巨元大97購06  ,0,0,0,0,0,0,0,0,0,74000,0,0,0,74000,0,74000,74000
058983,旺宏凱基99購05  ,0,0,0,0,0,0,0,0,0,74000,0,0,0,99000,25000,74000,74000
6415,矽力-KY         ,387000,118968,268032,0,0,0,0,188000,-188000,-7000,0,0,0,2000,9000,-7000,73032
060871,台灣50中信01購03,0,0,0,0,0,0,0,0,0,73000,0,0,0,114000,41000,73000,73000
060867,智伸科永豐9A購01,39000,0,39000,0,0,0,0,0,0,34000,0,0,0,118000,84000,34000,73000
050644,國巨凱基96購01  ,0,0,0,0,0,0,0,0,0,73000,0,0,0,138000,65000,73000,73000
052590,祥碩永豐96購01  ,0,0,0,0,0,0,0,0,0,73000,0,0,0,325000,252000,73000,73000
054516,國巨元大97購02  ,0,0,0,0,0,0,0,0,0,73000,0,0,0,73000,0,73000,73000
059077,FBVIX元大99購05 ,0,0,0,0,0,0,0,0,0,73000,0,0,0,73000,0,73000,73000
055916,奇鋐凱基99購01  ,0,0,0,0,0,0,0,0,0,73000,0,0,0,208000,135000,73000,73000
055755,禾伸堂兆豐97購02,0,0,0,0,0,0,0,0,0,73000,0,0,0,245000,172000,73000,73000
058194,勤誠永豐99購01  ,0,0,0,0,0,0,0,0,0,73000,0,0,0,166000,93000,73000,73000
058399,美律元大99購05  ,0,0,0,0,0,0,0,0,0,73000,0,0,0,87000,14000,73000,73000
3050,鈺德            ,73000,0,73000,0,0,0,0,0,0,0,0,0,0,0,0,0,73000
6605,帝寶            ,77000,4000,73000,0,0,0,0,0,0,0,0,0,0,0,0,0,73000
2007,燁興            ,81000,8000,73000,0,0,0,0,0,0,0,0,0,0,0,0,0,73000
07354P,臺股指國票99售22,0,0,0,0,0,0,0,0,0,73000,0,0,0,110000,37000,73000,73000
060488,台灣50群益9C購01,0,0,0,0,0,0,0,0,0,72000,0,0,0,72000,0,72000,72000
060375,葡萄王元富9A購01,0,0,0,0,0,0,0,0,0,72000,0,0,0,106000,34000,72000,72000
055264,國巨永豐98購01  ,0,0,0,0,0,0,0,0,0,72000,0,0,0,272000,200000,72000,72000
06885P,國巨國票99售06  ,0,0,0,0,0,0,0,0,0,72000,0,0,0,152000,80000,72000,72000
2739,寒舍            ,72000,0,72000,0,0,0,0,0,0,0,0,0,0,0,0,0,72000
6698,旭暉應材        ,76000,4000,72000,0,0,0,0,0,0,0,0,0,0,0,0,0,72000
060367,緯穎元富9A購02  ,0,0,0,0,0,0,0,0,0,71000,0,0,0,81000,10000,71000,71000
053539,智易永豐96購01  ,0,0,0,0,0,0,0,0,0,71000,0,0,0,71000,0,71000,71000
055352,奇力新凱基97購01,0,0,0,0,0,0,0,0,0,71000,0,0,0,71000,0,71000,71000
054052,日月光元大96購06,0,0,0,0,0,0,0,0,0,71000,0,0,0,71000,0,71000,71000
05252P,華通凱基95售01  ,0,0,0,0,0,0,0,0,0,71000,0,0,0,90000,19000,71000,71000
051319,光磊國票96購02  ,0,0,0,0,0,0,0,0,0,71000,0,0,0,74000,3000,71000,71000
049007,玉晶光中信96購01,0,0,0,0,0,0,0,0,0,71000,0,0,0,272000,201000,71000,71000
04590P,元石油元大97售01,0,0,0,0,0,0,0,0,0,71000,0,0,0,71000,0,71000,71000
058575,智邦群益99購01  ,0,0,0,0,0,0,0,0,0,71000,0,0,0,92000,21000,71000,71000
07260P,台灣50元大9A售01,0,0,0,0,0,0,0,0,0,71000,0,0,0,144000,73000,71000,71000
059931,緯穎富邦9A購01  ,0,0,0,0,0,0,0,0,0,70000,0,0,0,70000,0,70000,70000
060478,南電元大9A購01  ,0,0,0,0,0,0,0,0,0,70000,0,0,0,70000,0,70000,70000
060764,華擎元大9A購03  ,0,0,0,0,0,0,0,0,0,70000,0,0,0,378000,308000,70000,70000
06355P,聯茂永豐97售02  ,0,0,0,0,0,0,0,0,0,70000,0,0,0,92000,22000,70000,70000
049892,國巨富邦96購01  ,0,0,0,0,0,0,0,0,0,70000,0,0,0,70000,0,70000,70000
050167,T50反1富邦96購01,0,0,0,0,0,0,0,0,0,70000,0,0,0,70000,0,70000,70000
045443,群創元富98購01  ,0,0,0,0,0,0,0,0,0,70000,0,0,0,90000,20000,70000,70000
050754,元金2X元富9B購01,0,0,0,0,0,0,0,0,0,70000,0,0,0,70000,0,70000,70000
051000,台郡元大96購01  ,0,0,0,0,0,0,0,0,0,70000,0,0,0,70000,0,70000,70000
052604,建準元大97購01  ,0,0,0,0,0,0,0,0,0,70000,0,0,0,200000,130000,70000,70000
05397P,大立光凱基96售08,0,0,0,0,0,0,0,0,0,70000,0,0,0,70000,0,70000,70000
052629,訊芯中信99購01  ,0,0,0,0,0,0,0,0,0,70000,0,0,0,70000,0,70000,70000
052816,上銀永豐96購01  ,0,0,0,0,0,0,0,0,0,70000,0,0,0,120000,50000,70000,70000
054276,國巨群益96購07  ,0,0,0,0,0,0,0,0,0,70000,0,0,0,100000,30000,70000,70000
054203,滬深2X國票96購03,0,0,0,0,0,0,0,0,0,70000,0,0,0,80000,10000,70000,70000
053752,超眾永豐96購02  ,0,0,0,0,0,0,0,0,0,70000,0,0,0,80000,10000,70000,70000
053713,漢唐凱基96購04  ,0,0,0,0,0,0,0,0,0,70000,0,0,0,70000,0,70000,70000
057485,友達元大9C購04  ,0,0,0,0,0,0,0,0,0,70000,0,0,0,70000,0,70000,70000
055485,國巨元大97購09  ,0,0,0,0,0,0,0,0,0,70000,0,0,0,70000,0,70000,70000
053577,上証2X元大96購02,0,0,0,0,0,0,0,0,0,70000,0,0,0,70000,0,70000,70000
058918,SGBR2X元富99購04,0,0,0,0,0,0,0,0,0,70000,0,0,0,70000,0,70000,70000
055938,矽力群益97購01  ,0,0,0,0,0,0,0,0,0,70000,0,0,0,70000,0,70000,70000
057226,上銀凱基98購06  ,0,0,0,0,0,0,0,0,0,70000,0,0,0,70000,0,70000,70000
056732,國巨凱基98購07  ,0,0,0,0,0,0,0,0,0,70000,0,0,0,270000,200000,70000,70000
055701,亞德客富邦99購01,0,0,0,0,0,0,0,0,0,70000,0,0,0,70000,0,70000,70000
06718P,聯詠元大98售01  ,0,0,0,0,0,0,0,0,0,69000,0,0,0,72000,3000,69000,69000
05973P,聯詠元大96售06  ,0,0,0,0,0,0,0,0,0,69000,0,0,0,87000,18000,69000,69000
052986,聯發科元大97購05,0,0,0,0,0,0,0,0,0,69000,0,0,0,69000,0,69000,69000
057449,華新科元富99購02,0,0,0,0,0,0,0,0,0,69000,0,0,0,136000,67000,69000,69000
058421,國泰金麥證01購01,0,0,0,99000,30000,69000,0,0,0,69000,0,0,0,99000,30000,69000,69000
057894,華通元富02購02  ,0,0,0,0,0,0,0,0,0,69000,0,0,0,101000,32000,69000,69000
057849,南茂永豐98購02  ,0,0,0,0,0,0,0,0,0,69000,0,0,0,167000,98000,69000,69000
056416,華新科中信98購01,0,0,0,0,0,0,0,0,0,69000,0,0,0,85000,16000,69000,69000
2832,台產            ,85000,32000,53000,0,0,0,0,0,0,16000,16000,0,16000,0,0,0,69000
059967,聯發科凱基99購20,0,0,0,0,0,0,0,0,0,68000,0,0,0,101000,33000,68000,68000
060713,聯詠永豐9A購01  ,0,0,0,0,0,0,0,0,0,68000,0,0,0,91000,23000,68000,68000
060679,聯詠元大9A購04  ,0,0,0,0,0,0,0,0,0,68000,0,0,0,68000,0,68000,68000
053768,S&P反1元大99購01,0,0,0,0,0,0,0,0,0,68000,0,0,0,88000,20000,68000,68000
054041,鴻海元大96購22  ,0,0,0,0,0,0,0,0,0,68000,0,0,0,68000,0,68000,68000
053376,鴻海元大96購19  ,0,0,0,0,0,0,0,0,0,68000,0,0,0,68000,0,68000,68000
056615,燿華永豐98購02  ,0,0,0,0,0,0,0,0,0,68000,0,0,0,68000,0,68000,68000
057810,技嘉元大98購06  ,0,0,0,0,0,0,0,0,0,68000,0,0,0,68000,0,68000,68000
057904,矽力永豐98購01  ,0,0,0,0,0,0,0,0,0,68000,0,0,0,108000,40000,68000,68000
057637,上銀元大98購07  ,0,0,0,0,0,0,0,0,0,68000,0,0,0,68000,0,68000,68000
2431,聯昌            ,79000,11000,68000,0,0,0,0,0,0,0,0,0,0,0,0,0,68000
3419,譁裕            ,74000,6000,68000,0,0,0,0,0,0,0,0,0,0,0,0,0,68000
060542,上銀凱基9A購04  ,0,0,0,0,0,0,0,0,0,67000,0,0,0,171000,104000,67000,67000
060245,聯陽元大9C購01  ,0,0,0,0,0,0,0,0,0,67000,0,0,0,87000,20000,67000,67000
054442,啟碁台新96購01  ,0,0,0,0,0,0,0,0,0,67000,0,0,0,67000,0,67000,67000
00669R,國泰美國道瓊反1 ,673000,1789000,-1116000,0,0,0,0,0,0,1183000,0,0,0,2488000,1305000,1183000,67000
046813,聯電凱基96購01  ,0,0,0,0,0,0,0,0,0,67000,0,0,0,87000,20000,67000,67000
057366,智邦元大98購08  ,0,0,0,0,0,0,0,0,0,67000,0,0,0,143000,76000,67000,67000
056649,智易凱基98購01  ,0,0,0,0,0,0,0,0,0,67000,0,0,0,154000,87000,67000,67000
057874,可成元大99購02  ,0,0,0,0,0,0,0,0,0,67000,0,0,0,68000,1000,67000,67000
056960,光罩永豐98購01  ,0,0,0,0,0,0,0,0,0,67000,0,0,0,203000,136000,67000,67000
6591,動力-KY         ,109000,42000,67000,0,0,0,0,0,0,0,0,0,0,0,0,0,67000
9917,中保科          ,77000,40000,37000,0,0,0,3000,0,3000,27000,27000,0,27000,0,0,0,67000
2109,華豐            ,67000,0,67000,0,0,0,0,0,0,0,0,0,0,0,0,0,67000
060160,聯陽永豐9A購01  ,0,0,0,0,0,0,0,0,0,66000,0,0,0,82000,16000,66000,66000
060022,勤誠康和99購01  ,0,0,0,0,0,0,0,0,0,66000,0,0,0,84000,18000,66000,66000
059807,大立光元富99購09,0,0,0,0,0,0,0,0,0,66000,0,0,0,159000,93000,66000,66000
059723,美律元大9A購02  ,0,0,0,0,0,0,0,0,0,66000,0,0,0,185000,119000,66000,66000
061083,京元電兆豐9A購01,0,0,0,0,0,0,0,0,0,66000,0,0,0,256000,190000,66000,66000
046630,京元電元富95購03,0,0,0,0,0,0,0,0,0,66000,0,0,0,66000,0,66000,66000
04956P,臺股指日盛94售02,0,0,0,0,0,0,0,0,0,66000,0,0,0,66000,0,66000,66000
052426,國巨台新96購01  ,0,0,0,0,0,0,0,0,0,66000,0,0,0,86000,20000,66000,66000
053029,國巨第一96購01  ,0,0,0,0,0,0,0,0,0,66000,0,0,0,66000,0,66000,66000
057977,台光電永豐98購02,0,0,0,0,0,0,0,0,0,66000,0,0,0,66000,0,66000,66000
055682,智原凱基98購02  ,0,0,0,0,0,0,0,0,0,66000,0,0,0,76000,10000,66000,66000
06934P,聯鈞元大98售03  ,0,0,0,0,0,0,0,0,0,66000,0,0,0,66000,0,66000,66000
07525P,臺股指中信9B售07,0,0,0,0,0,0,0,0,0,66000,0,0,0,66000,0,66000,66000
3712,永崴投控        ,119000,53000,66000,0,0,0,0,0,0,0,0,0,0,0,0,0,66000
4722,國精化          ,82000,17000,65000,0,0,0,0,0,0,1000,1000,0,1000,0,0,0,66000
054285,國巨元大98購02  ,0,0,0,0,0,0,0,0,0,65000,0,0,0,65000,0,65000,65000
052587,景碩永豐97購01  ,0,0,0,0,0,0,0,0,0,65000,0,0,0,65000,0,65000,65000
050351,華新科群益95購02,0,0,0,0,0,0,0,0,0,65000,0,0,0,76000,11000,65000,65000
057282,大立光元大99購06,0,0,0,0,0,0,0,0,0,65000,0,0,0,65000,0,65000,65000
055177,宏達電統一99購01,0,0,0,0,0,0,0,0,0,65000,0,0,0,68000,3000,65000,65000
057821,晶相光元大98購03,0,0,0,0,0,0,0,0,0,65000,0,0,0,237000,172000,65000,65000
058700,鴻海元大99購15  ,0,0,0,0,0,0,0,0,0,65000,0,0,0,97000,32000,65000,65000
057737,國巨富邦99購02  ,0,0,0,0,0,0,0,0,0,65000,0,0,0,65000,0,65000,65000
056362,聯發科元大99購01,0,0,0,0,0,0,0,0,0,65000,0,0,0,65000,0,65000,65000
6165,捷泰            ,75000,10000,65000,0,0,0,0,0,0,0,0,0,0,0,0,0,65000
07535P,上銀元富9A售03  ,0,0,0,0,0,0,0,0,0,65000,0,0,0,121000,56000,65000,65000
07585P,台灣50中信03售06,0,0,0,0,0,0,0,0,0,65000,0,0,0,365000,300000,65000,65000
07359P,台積電元大99售45,0,0,0,0,0,0,0,0,0,65000,0,0,0,303000,238000,65000,65000
06068P,玉晶光康和97售01,0,0,0,0,0,0,0,0,0,64000,0,0,0,144000,80000,64000,64000
059347,京鼎凱基99購02  ,0,0,0,0,0,0,0,0,0,64000,0,0,0,105000,41000,64000,64000
059960,健策國票99購01  ,0,0,0,0,0,0,0,0,0,64000,0,0,0,74000,10000,64000,64000
03603P,群創凱基98售04  ,0,0,0,0,0,0,0,0,0,64000,0,0,0,159000,95000,64000,64000
052684,旺宏元大98購01  ,0,0,0,0,0,0,0,0,0,64000,0,0,0,64000,0,64000,64000
052738,聯電元大98購02  ,0,0,0,0,0,0,0,0,0,64000,0,0,0,94000,30000,64000,64000
054121,奇鋐永豐96購02  ,0,0,0,0,0,0,0,0,0,64000,0,0,0,111000,47000,64000,64000
057077,國巨統一98購06  ,0,0,0,0,0,0,0,0,0,64000,0,0,0,75000,11000,64000,64000
056928,旺宏台新98購01  ,0,0,0,0,0,0,0,0,0,64000,0,0,0,74000,10000,64000,64000
057934,華新科群益98購07,0,0,0,0,0,0,0,0,0,64000,0,0,0,106000,42000,64000,64000
058763,和碩群益99購01  ,0,0,0,0,0,0,0,0,0,64000,0,0,0,64000,0,64000,64000
057883,中環群益98購01  ,0,0,0,0,0,0,0,0,0,64000,0,0,0,601000,537000,64000,64000
057112,立積群益99購01  ,10000,0,10000,0,0,0,0,0,0,54000,0,0,0,946000,892000,54000,64000
07127P,精元元大99售01  ,0,0,0,0,0,0,0,0,0,64000,0,0,0,74000,10000,64000,64000
059730,晶相光元大9C購02,0,0,0,0,0,0,0,0,0,63000,0,0,0,242000,179000,63000,63000
059473,T50反1群益99購03,0,0,0,0,0,0,0,0,0,63000,0,0,0,120000,57000,63000,63000
054090,瑞昱群益97購01  ,0,0,0,0,0,0,0,0,0,63000,0,0,0,250000,187000,63000,63000
053956,旺宏永豐96購04  ,0,0,0,0,0,0,0,0,0,63000,0,0,0,63000,0,63000,63000
047418,智邦富邦97購01  ,0,0,0,0,0,0,0,0,0,63000,0,0,0,63000,0,63000,63000
057385,光罩永豐99購01  ,0,0,0,0,0,0,0,0,0,63000,0,0,0,71000,8000,63000,63000
058821,泰鼎國泰9B購01  ,0,0,0,0,0,0,0,0,0,63000,0,0,0,142000,79000,63000,63000
057945,京鼎國票99購03  ,0,0,0,0,0,0,0,0,0,63000,0,0,0,123000,60000,63000,63000
06893P,致新元富98售02  ,0,0,0,0,0,0,0,0,0,63000,0,0,0,94000,31000,63000,63000
07708P,玉晶光元大9A售13,0,0,0,0,0,0,0,0,0,63000,0,0,0,188000,125000,63000,63000
1540,喬福            ,73000,10000,63000,0,0,0,0,0,0,0,0,0,0,0,0,0,63000
2428,興勤            ,120000,60000,60000,0,0,0,0,0,0,3000,0,5000,-5000,10000,2000,8000,63000
8033,雷虎            ,64000,1000,63000,0,0,0,0,0,0,0,0,0,0,0,0,0,63000
059876,智易凱基99購02  ,0,0,0,0,0,0,0,0,0,62000,0,0,0,149000,87000,62000,62000
06067P,華新科康和97售01,0,0,0,0,0,0,0,0,0,62000,0,0,0,82000,20000,62000,62000
060556,緯穎凱基9A購04  ,0,0,0,0,0,0,0,0,0,62000,0,0,0,87000,25000,62000,62000
06673P,大立光群益98售01,0,0,0,0,0,0,0,0,0,62000,0,0,0,66000,4000,62000,62000
06173P,華通元大97售02  ,0,0,0,0,0,0,0,0,0,62000,0,0,0,62000,0,62000,62000
050587,緯穎國票94購02  ,0,0,0,0,0,0,0,0,0,62000,0,0,0,62000,0,62000,62000
054621,華新科兆豐98購01,0,0,0,0,0,0,0,0,0,62000,0,0,0,72000,10000,62000,62000
056657,華邦電元大99購01,0,0,0,0,0,0,0,0,0,62000,0,0,0,377000,315000,62000,62000
055763,鎧勝群益97購01  ,0,0,0,0,0,0,0,0,0,62000,0,0,0,375000,313000,62000,62000
6491,晶碩            ,69000,7000,62000,0,0,0,0,0,0,0,0,0,0,0,0,0,62000
2705,六福            ,71000,9000,62000,0,0,0,0,0,0,0,0,0,0,0,0,0,62000
1806,冠軍            ,102000,40000,62000,0,0,0,0,0,0,0,0,0,0,0,0,0,62000
05463P,創意國票96售04  ,0,0,0,0,0,0,0,0,0,61000,0,0,0,61000,0,61000,61000
055458,燿華永豐98購01  ,0,0,0,0,0,0,0,0,0,61000,0,0,0,61000,0,61000,61000
046793,聯發科元富99購01,0,0,0,0,0,0,0,0,0,61000,0,0,0,61000,0,61000,61000
055291,京鼎元大97購02  ,0,0,0,0,0,0,0,0,0,61000,0,0,0,422000,361000,61000,61000
056794,上銀麥證98購01  ,0,0,0,65000,4000,61000,0,0,0,61000,0,0,0,65000,4000,61000,61000
05724P,致茂永豐96售01  ,0,0,0,0,0,0,0,0,0,61000,0,0,0,61000,0,61000,61000
056319,智原群益98購02  ,0,0,0,0,0,0,0,0,0,61000,0,0,0,85000,24000,61000,61000
1441,大東            ,79000,18000,61000,0,0,0,0,0,0,0,0,0,0,0,0,0,61000
07520P,臺股指元大9B售11,0,0,0,0,0,0,0,0,0,61000,0,0,0,107000,46000,61000,61000
4104,佳醫            ,84000,16000,68000,0,0,0,0,0,0,-7000,3000,10000,-7000,0,0,0,61000
061199,道瓊反元大9A購05,0,0,0,0,0,0,0,0,0,60000,0,0,0,60000,0,60000,60000
060065,大立光兆豐9B購01,0,0,0,0,0,0,0,0,0,60000,0,0,0,62000,2000,60000,60000
06007P,世芯永豐96售01  ,0,0,0,0,0,0,0,0,0,60000,0,0,0,70000,10000,60000,60000
059748,聯發科台新99購03,0,0,0,0,0,0,0,0,0,60000,0,0,0,111000,51000,60000,60000
059805,台積電元富99購02,0,0,0,0,0,0,0,0,0,60000,0,0,0,140000,80000,60000,60000
059689,南亞科永豐99購02,0,0,0,0,0,0,0,0,0,60000,0,0,0,107000,47000,60000,60000
059377,台積電群益99購09,0,0,0,0,0,0,0,0,0,60000,0,0,0,71000,11000,60000,60000
04975P,華新科凱基96售02,0,0,0,0,0,0,0,0,0,60000,0,0,0,60000,0,60000,60000
00683L,元大美元指數正2 ,0,0,0,0,0,0,0,0,0,60000,0,0,0,66000,6000,60000,60000
048305,深100凱基96購01 ,0,0,0,0,0,0,0,0,0,60000,0,0,0,60000,0,60000,60000
05250P,臻鼎國票96售01  ,0,0,0,0,0,0,0,0,0,60000,0,0,0,60000,0,60000,60000
051951,聯發科元富95購02,0,0,0,0,0,0,0,0,0,60000,0,0,0,60000,0,60000,60000
056610,鴻海永豐98購01  ,0,0,0,0,0,0,0,0,0,60000,0,0,0,60000,0,60000,60000
053654,聯發科凱基98購01,0,0,0,0,0,0,0,0,0,60000,0,0,0,60000,0,60000,60000
054689,華新科永豐97購01,0,0,0,0,0,0,0,0,0,60000,0,0,0,60000,0,60000,60000
054731,S&P反1凱基98購01,0,0,0,0,0,0,0,0,0,60000,0,0,0,60000,0,60000,60000
054502,泰碩永豐96購01  ,0,0,0,0,0,0,0,0,0,60000,0,0,0,60000,0,60000,60000
052803,冠德元大96購01  ,0,0,0,0,0,0,0,0,0,60000,0,0,0,60000,0,60000,60000
053321,智原群益96購02  ,0,0,0,0,0,0,0,0,0,60000,0,0,0,70000,10000,60000,60000
054976,上証2X元富9A購01,0,0,0,0,0,0,0,0,0,60000,0,0,0,60000,0,60000,60000
056315,同欣電元大97購05,0,0,0,0,0,0,0,0,0,60000,0,0,0,60000,0,60000,60000
056134,可成元大97購06  ,0,0,0,0,0,0,0,0,0,60000,0,0,0,61000,1000,60000,60000
05793P,臺股指中信99售08,0,0,0,0,0,0,0,0,0,60000,0,0,0,70000,10000,60000,60000
058522,聯茂元大99購07  ,0,0,0,0,0,0,0,0,0,60000,0,0,0,73000,13000,60000,60000
058017,漢唐凱基99購01  ,0,0,0,0,0,0,0,0,0,60000,0,0,0,60000,0,60000,60000
057134,茂林凱基98購02  ,0,0,0,0,0,0,0,0,0,60000,0,0,0,141000,81000,60000,60000
058120,台灣50國票99購03,0,0,0,0,0,0,0,0,0,60000,0,0,0,60000,0,60000,60000
3052,夆典            ,70000,21000,49000,0,0,0,0,0,0,11000,11000,0,11000,0,0,0,60000
6285,啟碁            ,416000,368000,48000,0,0,0,4000,20000,-16000,28000,30000,4000,26000,10000,8000,2000,60000
07349P,大立光凱基99售16,0,0,0,0,0,0,0,0,0,60000,0,0,0,60000,0,60000,60000
07469P,台達電元大9A售01,0,0,0,0,0,0,0,0,0,60000,0,0,0,63000,3000,60000,60000
06853P,華擎元富98售03  ,0,8000,-8000,0,0,0,0,0,0,68000,0,0,0,68000,0,68000,60000
06839P,玉晶光統一9A售05,0,0,0,0,0,0,0,0,0,60000,0,0,0,150000,90000,60000,60000
07140P,台灣50日盛99售01,0,0,0,0,0,0,0,0,0,60000,0,0,0,60000,0,60000,60000
1229,聯華            ,777000,732000,45000,0,0,0,15000,0,15000,0,0,0,0,0,0,0,60000
07743P,智邦凱基9A售03  ,0,0,0,0,0,0,0,0,0,60000,0,0,0,100000,40000,60000,60000
059297,大立光元富9C購01,0,0,0,0,0,0,0,0,0,59000,0,0,0,74000,15000,59000,59000
059866,國巨凱基99購18  ,0,0,0,0,0,0,0,0,0,59000,0,0,0,59000,0,59000,59000
06023P,超眾國票96售03  ,0,0,0,0,0,0,0,0,0,59000,0,0,0,123000,64000,59000,59000
06677P,牧德國票98售02  ,0,0,0,0,0,0,0,0,0,59000,0,0,0,59000,0,59000,59000
060792,信錦永豐9A購01  ,0,0,0,0,0,0,0,0,0,59000,0,0,0,59000,0,59000,59000
051087,國巨元大97購01  ,0,0,0,0,0,0,0,0,0,59000,0,0,0,59000,0,59000,59000
052423,宏達電國票96購02,0,0,0,0,0,0,0,0,0,59000,0,0,0,197000,138000,59000,59000
051451,世芯元大95購03  ,0,0,0,0,0,0,0,0,0,59000,0,0,0,59000,0,59000,59000
03810P,大立光富邦98售01,0,0,0,0,0,0,0,0,0,59000,0,0,0,59000,0,59000,59000
058238,奇鋐元大99購02  ,0,0,0,0,0,0,0,0,0,59000,0,0,0,106000,47000,59000,59000
1203,味王            ,59000,0,59000,0,0,0,0,0,0,0,0,0,0,0,0,0,59000
2929,淘帝-KY         ,120000,61000,59000,0,0,0,0,0,0,0,0,0,0,0,0,0,59000
06921P,台光電凱基98售06,0,0,0,0,0,0,0,0,0,59000,0,0,0,59000,0,59000,59000
07502P,美食元大9A售01  ,0,0,0,0,0,0,0,0,0,59000,0,0,0,238000,179000,59000,59000
060155,友訊永豐9A購01  ,0,0,0,0,0,0,0,0,0,58000,0,0,0,58000,0,58000,58000
059485,台灣50兆豐99購02,0,0,0,0,0,0,0,0,0,58000,0,0,0,198000,140000,58000,58000
046869,聯發科統一95購01,0,0,0,0,0,0,0,0,0,58000,0,0,0,58000,0,58000,58000
04049P,大立光元大95售02,0,0,0,0,0,0,0,0,0,58000,0,0,0,58000,0,58000,58000
050687,上銀日盛94購01  ,0,0,0,0,0,0,0,0,0,58000,0,0,0,58000,0,58000,58000
052865,大立光凱基96購11,0,0,0,0,0,0,0,0,0,58000,0,0,0,58000,0,58000,58000
054861,智邦群益97購01  ,0,0,0,0,0,0,0,0,0,58000,0,0,0,60000,2000,58000,58000
055349,京元電凱基97購02,0,0,0,0,0,0,0,0,0,58000,0,0,0,58000,0,58000,58000
058990,GIS凱基99購02   ,0,0,0,0,0,0,0,0,0,58000,0,0,0,215000,157000,58000,58000
056100,楠梓電永豐97購02,0,0,0,0,0,0,0,0,0,58000,0,0,0,58000,0,58000,58000
056395,玉晶光永豐9B購01,0,0,0,0,0,0,0,0,0,58000,0,0,0,58000,0,58000,58000
2009,第一銅          ,62000,4000,58000,0,0,0,0,0,0,0,0,0,0,0,0,0,58000
059424,SGBR2X元大9A購01,0,0,0,0,0,0,0,0,0,57000,0,0,0,325000,268000,57000,57000
059219,旺宏元大99購12  ,0,0,0,0,0,0,0,0,0,57000,0,0,0,83000,26000,57000,57000
060676,京元電元大9A購03,0,0,0,0,0,0,0,0,0,57000,0,0,0,224000,167000,57000,57000
055381,茂林元大97購02  ,0,0,0,0,0,0,0,0,0,57000,0,0,0,72000,15000,57000,57000
052598,滬深2X元大96購05,0,0,0,0,0,0,0,0,0,57000,0,0,0,57000,0,57000,57000
055912,宏達電凱基98購03,0,0,0,0,0,0,0,0,0,57000,0,0,0,57000,0,57000,57000
05880P,創意康和96售01  ,0,0,0,0,0,0,0,0,0,57000,0,0,0,58000,1000,57000,57000
057969,緯穎國泰99購01  ,0,0,0,0,0,0,0,0,0,57000,0,0,0,256000,199000,57000,57000
057625,泰鼎國泰9A購01  ,0,0,0,0,0,0,0,0,0,57000,0,0,0,57000,0,57000,57000
1459,聯發            ,57000,0,57000,0,0,0,0,0,0,0,0,0,0,0,0,0,57000
2459,敦吉            ,78000,20000,58000,0,0,0,0,0,0,-1000,2000,3000,-1000,0,0,0,57000
07085P,超眾元富9C售01  ,0,0,0,0,0,0,0,0,0,57000,0,0,0,78000,21000,57000,57000
060548,友達凱基9B購03  ,0,0,0,0,0,0,0,0,0,56000,0,0,0,513000,457000,56000,56000
06641P,智邦兆豐99售01  ,0,0,0,0,0,0,0,0,0,56000,0,0,0,56000,0,56000,56000
06337P,祥碩元大97售05  ,0,0,0,0,0,0,0,0,0,56000,0,0,0,568000,512000,56000,56000
059202,禾聯碩永豐99購01,0,0,0,0,0,0,0,0,0,56000,0,0,0,60000,4000,56000,56000
059754,訊芯群益9A購01  ,0,0,0,0,0,0,0,0,0,56000,0,0,0,106000,50000,56000,56000
049909,國巨元大95購01  ,0,0,0,0,0,0,0,0,0,56000,0,0,0,56000,0,56000,56000
049260,華新科元大96購01,0,0,0,0,0,0,0,0,0,56000,0,0,0,57000,1000,56000,56000
055619,同欣電國票98購02,0,0,0,0,0,0,0,0,0,56000,0,0,0,72000,16000,56000,56000
07539P,玉山金台新9A售01,0,0,0,0,0,0,0,0,0,56000,0,0,0,80000,24000,56000,56000
1446,宏和            ,57000,1000,56000,0,0,0,0,0,0,0,0,0,0,0,0,0,56000
1786,科妍            ,70000,12000,58000,0,0,0,0,0,0,-2000,0,2000,-2000,0,0,0,56000
059173,矽力凱基99購01  ,0,0,0,0,0,0,0,0,0,55000,0,0,0,55000,0,55000,55000
060196,泰鼎元富9A購01  ,0,0,0,0,0,0,0,0,0,55000,0,0,0,55000,0,55000,55000
060296,和碩元大9A購01  ,0,0,0,0,0,0,0,0,0,55000,0,0,0,124000,69000,55000,55000
06486P,麗豐元大98售02  ,0,0,0,0,0,0,0,0,0,55000,0,0,0,55000,0,55000,55000
060500,鴻海元大9A購12  ,0,0,0,0,0,0,0,0,0,55000,0,0,0,75000,20000,55000,55000
060734,華通統一9C購01  ,0,0,0,0,0,0,0,0,0,55000,0,0,0,79000,24000,55000,55000
060873,道瓊反中信9C購01,0,0,0,0,0,0,0,0,0,55000,0,0,0,55000,0,55000,55000
03412P,滬深2X群益98售01,0,0,0,0,0,0,0,0,0,55000,0,0,0,55000,0,55000,55000
03959P,義隆元富96售01  ,0,0,0,0,0,0,0,0,0,55000,0,0,0,55000,0,55000,55000
047688,亞德客富邦95購01,0,0,0,0,0,0,0,0,0,55000,0,0,0,55000,0,55000,55000
047547,友達凱基99購02  ,0,0,0,0,0,0,0,0,0,55000,0,0,0,55000,0,55000,55000
051657,台郡元富98購01  ,0,0,0,0,0,0,0,0,0,55000,0,0,0,55000,0,55000,55000
054971,帆宣元大97購02  ,0,0,0,0,0,0,0,0,0,55000,0,0,0,55000,0,55000,55000
058263,大成鋼永豐99購01,0,0,0,0,0,0,0,0,0,55000,0,0,0,55000,0,55000,55000
058450,旺宏永豐99購01  ,0,0,0,0,0,0,0,0,0,55000,0,0,0,65000,10000,55000,55000
058503,鴻海元大99購14  ,0,0,0,0,0,0,0,0,0,55000,0,0,0,220000,165000,55000,55000
058580,華新科群益99購02,0,0,0,0,0,0,0,0,0,55000,0,0,0,120000,65000,55000,55000
058901,美律元大99購07  ,0,0,0,0,0,0,0,0,0,55000,0,0,0,113000,58000,55000,55000
056453,禾伸堂凱基99購02,0,2000,-2000,0,0,0,0,0,0,57000,0,0,0,57000,0,57000,55000
2030,彰源            ,95000,40000,55000,0,0,0,0,0,0,0,0,0,0,0,0,0,55000
1108,幸福            ,56000,1000,55000,0,0,0,0,0,0,0,0,0,0,0,0,0,55000
2464,盟立            ,99000,44000,55000,0,0,0,0,0,0,0,0,0,0,0,0,0,55000
2413,環科            ,84000,27000,57000,0,0,0,0,0,0,-2000,0,2000,-2000,0,0,0,55000
2239,英利-KY         ,55000,0,55000,0,0,0,0,0,0,0,0,0,0,0,0,0,55000
07685P,玉晶光凱基9B售03,0,0,0,0,0,0,0,0,0,55000,0,0,0,110000,55000,55000,55000
3094,聯傑            ,73000,18000,55000,0,0,0,0,0,0,0,0,0,0,0,0,0,55000
06661P,玉晶光永豐98售05,0,0,0,0,0,0,0,0,0,54000,0,0,0,155000,101000,54000,54000
059918,華新科元大99購20,0,0,0,0,0,0,0,0,0,54000,0,0,0,71000,17000,54000,54000
060025,台積電富邦9C購06,0,0,0,0,0,0,0,0,0,54000,0,0,0,86000,32000,54000,54000
00638R,元大滬深300反1  ,129000,11000,118000,0,0,0,0,0,0,-64000,0,0,0,298000,362000,-64000,54000
056230,可成凱基98購03  ,0,0,0,0,0,0,0,0,0,54000,0,0,0,54000,0,54000,54000
05889P,群創元大98售02  ,0,0,0,0,0,0,0,0,0,54000,0,0,0,61000,7000,54000,54000
059038,健策群益9A購02  ,0,0,0,0,0,0,0,0,0,54000,0,0,0,57000,3000,54000,54000
058368,奇鋐凱基9A購01  ,0,0,0,0,0,0,0,0,0,54000,0,0,0,74000,20000,54000,54000
058406,聯茂元大99購06  ,0,0,0,0,0,0,0,0,0,54000,0,0,0,99000,45000,54000,54000
058270,上緯控永豐99購01,0,0,0,0,0,0,0,0,0,54000,0,0,0,54000,0,54000,54000
058033,景碩永豐98購02  ,0,0,0,0,0,0,0,0,0,54000,0,0,0,54000,0,54000,54000
4552,力達-KY         ,70000,16000,54000,0,0,0,0,0,0,0,0,0,0,0,0,0,54000
4989,榮科            ,92000,38000,54000,0,0,0,0,0,0,0,0,0,0,0,0,0,54000
5203,訊連            ,255000,249000,6000,0,0,0,0,0,0,48000,0,10000,-10000,71000,13000,58000,54000
1517,利奇            ,54000,0,54000,0,0,0,0,0,0,0,0,0,0,0,0,0,54000
060120,聯電富邦9B購01  ,0,0,0,0,0,0,0,0,0,53000,0,0,0,182000,129000,53000,53000
059204,台灣50元大01購02,0,0,0,0,0,0,0,0,0,53000,0,0,0,53000,0,53000,53000
06728P,全新元大98售03  ,0,0,0,0,0,0,0,0,0,53000,0,0,0,59000,6000,53000,53000
061187,瀚宇博國泰9C購01,0,0,0,0,0,0,0,0,0,53000,0,0,0,104000,51000,53000,53000
060877,華邦電中信02購01,0,0,0,0,0,0,0,0,0,53000,0,0,0,80000,27000,53000,53000
060905,台積電元大9A購20,0,0,0,0,0,0,0,0,0,53000,0,0,0,56000,3000,53000,53000
060893,台灣50凱基01購07,0,0,0,0,0,0,0,0,0,53000,0,0,0,53000,0,53000,53000
00706L,元大S&P日圓正2  ,0,0,0,0,0,0,0,0,0,53000,0,0,0,54000,1000,53000,53000
049301,致新群益95購01  ,0,0,0,0,0,0,0,0,0,53000,0,0,0,53000,0,53000,53000
049972,南電國票95購02  ,0,0,0,0,0,0,0,0,0,53000,0,0,0,53000,0,53000,53000
051786,A50正2國票95購02,0,0,0,0,0,0,0,0,0,53000,0,0,0,53000,0,53000,53000
054339,聯詠統一96購02  ,0,0,0,0,0,0,0,0,0,53000,0,0,0,101000,48000,53000,53000
055715,智邦元大97購04  ,0,0,0,0,0,0,0,0,0,53000,0,0,0,59000,6000,53000,53000
07556P,玉晶光元大9A售08,0,0,0,0,0,0,0,0,0,53000,0,0,0,53000,0,53000,53000
07325P,台積電元大99售41,0,0,0,0,0,0,0,0,0,53000,0,0,0,253000,200000,53000,53000
3605,宏致            ,107000,54000,53000,0,0,0,0,0,0,0,0,0,0,0,0,0,53000
3530,晶相光          ,253000,265000,-12000,0,0,0,0,0,0,65000,0,0,0,86000,21000,65000,53000
061318,智邦凱基9B購01  ,0,0,0,0,0,0,0,0,0,52000,0,0,0,119000,67000,52000,52000
06338P,亞德客統一97售02,0,0,0,0,0,0,0,0,0,52000,0,0,0,57000,5000,52000,52000
06283P,祥碩永豐97售01  ,0,0,0,0,0,0,0,0,0,52000,0,0,0,52000,0,52000,52000
060129,祥碩永豐99購03  ,0,0,0,0,0,0,0,0,0,52000,0,0,0,150000,98000,52000,52000
052759,京元電群益96購01,0,0,0,0,0,0,0,0,0,52000,0,0,0,150000,98000,52000,52000
055414,奇力新富邦9B購01,0,0,0,0,0,0,0,0,0,52000,0,0,0,52000,0,52000,52000
053503,臻鼎兆豐97購01  ,0,0,0,0,0,0,0,0,0,52000,0,0,0,52000,0,52000,52000
055014,達興元富97購01  ,0,0,0,0,0,0,0,0,0,52000,0,0,0,52000,0,52000,52000
058570,臻鼎凱基9A購01  ,0,0,0,0,0,0,0,0,0,52000,0,0,0,52000,0,52000,52000
9944,新麗            ,123000,71000,52000,0,0,0,0,0,0,0,0,0,0,0,0,0,52000
07324P,台積電元大99售40,0,0,0,0,0,0,0,0,0,52000,0,0,0,52000,0,52000,52000
07471P,南亞科元大9A售01,0,0,0,0,0,0,0,0,0,52000,0,0,0,67000,15000,52000,52000
07504P,聯詠元大9A售02  ,0,0,0,0,0,0,0,0,0,52000,0,0,0,52000,0,52000,52000
07146P,瑞昱元大99售02  ,0,0,0,0,0,0,0,0,0,52000,0,0,0,57000,5000,52000,52000
1712,興農            ,154000,102000,52000,0,0,0,0,0,0,0,0,0,0,0,0,0,52000
1615,大山            ,65000,11000,54000,0,0,0,0,0,0,-2000,0,2000,-2000,0,0,0,52000
1321,大洋            ,110000,58000,52000,0,0,0,0,0,0,0,0,0,0,0,0,0,52000
2420,新巨            ,65000,13000,52000,0,0,0,0,0,0,0,0,0,0,0,0,0,52000
06611P,祥碩國票98售01  ,0,0,0,0,0,0,0,0,0,51000,0,0,0,149000,98000,51000,51000
061349,嘉澤元大9A購02  ,0,0,0,0,0,0,0,0,0,51000,0,0,0,63000,12000,51000,51000
053516,茂林群益96購05  ,0,0,0,0,0,0,0,0,0,51000,0,0,0,467000,416000,51000,51000
054629,華新科凱基98購01,0,0,0,0,0,0,0,0,0,51000,0,0,0,51000,0,51000,51000
054844,華邦電兆豐98購01,0,0,0,0,0,0,0,0,0,51000,0,0,0,51000,0,51000,51000
00681R,元大美債20反1   ,0,0,0,0,0,0,0,0,0,51000,0,0,0,51000,0,51000,51000
058826,台積電永豐99購02,0,0,0,0,0,0,0,0,0,51000,0,0,0,51000,0,51000,51000
058730,玉晶光永豐9A購01,0,0,0,0,0,0,0,0,0,51000,0,0,0,51000,0,51000,51000
056876,群創凱基98購11  ,0,0,0,0,0,0,0,0,0,51000,0,0,0,51000,0,51000,51000
05583P,訊芯凱基96售01  ,0,0,0,0,0,0,0,0,0,51000,0,0,0,61000,10000,51000,51000
057025,華新科凱基98購04,0,0,0,0,0,0,0,0,0,51000,0,0,0,51000,0,51000,51000
057216,聯發科群益99購01,0,0,0,0,0,0,0,0,0,51000,0,0,0,89000,38000,51000,51000
057283,欣興元大98購07  ,0,0,0,0,0,0,0,0,0,51000,0,0,0,333000,282000,51000,51000
2706,第一店          ,66000,15000,51000,0,0,0,0,0,0,0,0,0,0,0,0,0,51000
1234,黑松            ,52000,1000,51000,0,0,0,0,0,0,0,0,0,0,0,0,0,51000
1414,東和            ,51000,0,51000,0,0,0,0,0,0,0,0,0,0,0,0,0,51000
07089P,臺指2X中信01售01,0,0,0,0,0,0,0,0,0,51000,0,0,0,51000,0,51000,51000
6525,捷敏-KY         ,74000,23000,51000,0,0,0,0,0,0,0,0,0,0,0,0,0,51000
3588,通嘉            ,73000,22000,51000,0,0,0,0,0,0,0,0,0,0,0,0,0,51000
5608,四維航          ,102000,51000,51000,0,0,0,0,0,0,0,0,0,0,0,0,0,51000
06240P,奇力新元富97售03,0,0,0,0,0,0,0,0,0,50000,0,0,0,50000,0,50000,50000
060890,大立光統一01購01,0,0,0,0,0,0,0,0,0,50000,0,0,0,113000,63000,50000,50000
060876,國巨中信9A購04  ,0,0,0,0,0,0,0,0,0,50000,0,0,0,123000,73000,50000,50000
060834,道瓊反國票9C購01,0,0,0,0,0,0,0,0,0,50000,0,0,0,50000,0,50000,50000
060778,臺股指凱基9A購06,0,0,0,0,0,0,0,0,0,50000,0,0,0,238000,188000,50000,50000
060501,鴻海元大9A購13  ,0,0,0,0,0,0,0,0,0,50000,0,0,0,50000,0,50000,50000
059396,T50反1元富99購04,50000,0,50000,0,0,0,0,0,0,0,0,0,0,0,0,0,50000
059785,美律元大9A購03  ,0,0,0,0,0,0,0,0,0,50000,0,0,0,59000,9000,50000,50000
059569,旺宏凱基99購09  ,0,0,0,0,0,0,0,0,0,50000,0,0,0,50000,0,50000,50000
047680,上証反中信96購01,0,0,0,0,0,0,0,0,0,50000,0,0,0,50000,0,50000,50000
045817,滬深2X凱基95購02,0,0,0,0,0,0,0,0,0,50000,0,0,0,50000,0,50000,50000
045053,聯發科元富98購01,0,0,0,0,0,0,0,0,0,50000,0,0,0,50000,0,50000,50000
049406,T50反1日盛97購01,0,0,0,0,0,0,0,0,0,50000,0,0,0,50000,0,50000,50000
049491,聯發科元大95購01,0,0,0,0,0,0,0,0,0,50000,0,0,0,51000,1000,50000,50000
05038P,牧德元大95售03  ,0,0,0,0,0,0,0,0,0,50000,0,0,0,50000,0,50000,50000
03875P,滬深2X國票05售01,0,0,0,0,0,0,0,0,0,50000,0,0,0,50000,0,50000,50000
046020,滬深2X元大95購02,0,0,0,0,0,0,0,0,0,50000,0,0,0,50000,0,50000,50000
051813,GIS凱基96購02   ,0,0,0,0,0,0,0,0,0,50000,0,0,0,50000,0,50000,50000
051300,台光電凱基96購02,0,0,0,0,0,0,0,0,0,50000,0,0,0,50000,0,50000,50000
051311,瑞昱麥證95購01  ,0,0,0,50000,0,50000,0,0,0,50000,0,0,0,50000,0,50000,50000
052052,嘉澤凱基95購02  ,0,0,0,0,0,0,0,0,0,50000,0,0,0,60000,10000,50000,50000
05170P,世芯元大95售01  ,0,0,0,0,0,0,0,0,0,50000,0,0,0,50000,0,50000,50000
051564,和碩國泰96購01  ,0,0,0,0,0,0,0,0,0,50000,0,0,0,50000,0,50000,50000
052595,奇力新群益96購01,0,0,0,0,0,0,0,0,0,50000,0,0,0,50000,0,50000,50000
053976,亞光元大96購02  ,0,0,0,0,0,0,0,0,0,50000,0,0,0,50000,0,50000,50000
052546,友達中信98購01  ,0,0,0,0,0,0,0,0,0,50000,0,0,0,50000,0,50000,50000
053950,緯穎富邦97購02  ,0,0,0,0,0,0,0,0,0,50000,0,0,0,56000,6000,50000,50000
05386P,臺股指永豐95售05,0,0,0,0,0,0,0,0,0,50000,0,0,0,50000,0,50000,50000
054880,華泰統一97購01  ,0,0,0,0,0,0,0,0,0,50000,0,0,0,50000,0,50000,50000
052921,大成鋼永豐96購01,0,0,0,0,0,0,0,0,0,50000,0,0,0,50000,0,50000,50000
052959,聯電凱基97購01  ,0,0,0,0,0,0,0,0,0,50000,0,0,0,50000,0,50000,50000
054930,群電凱基98購01  ,0,0,0,0,0,0,0,0,0,50000,0,0,0,50000,0,50000,50000
054015,晶豪科永豐96購03,0,0,0,0,0,0,0,0,0,50000,0,0,0,50000,0,50000,50000
05434P,世紀鋼元富95售02,0,0,0,0,0,0,0,0,0,50000,0,0,0,1085000,1035000,50000,50000
054197,台積電永昌96購07,0,0,0,0,0,0,0,0,0,50000,0,0,0,50000,0,50000,50000
05470P,康控元大95售05  ,0,0,0,0,0,0,0,0,0,50000,0,0,0,50000,0,50000,50000
053185,友達中信99購01  ,0,0,0,0,0,0,0,0,0,50000,0,0,0,50000,0,50000,50000
053205,台光電麥證96購01,0,0,0,50000,0,50000,0,0,0,50000,0,0,0,50000,0,50000,50000
053553,聯詠凱基96購03  ,0,0,0,0,0,0,0,0,0,50000,0,0,0,50000,0,50000,50000
057526,智邦元大98購10  ,0,0,0,0,0,0,0,0,0,50000,0,0,0,77000,27000,50000,50000
055372,宏達電元大97購04,0,0,0,0,0,0,0,0,0,50000,0,0,0,50000,0,50000,50000
057280,大立光元大98購15,0,0,0,0,0,0,0,0,0,50000,0,0,0,50000,0,50000,50000
057260,微星兆豐98購01  ,0,0,0,0,0,0,0,0,0,50000,0,0,0,50000,0,50000,50000
057263,可成兆豐99購01  ,0,0,0,0,0,0,0,0,0,50000,0,0,0,50000,0,50000,50000
057100,國巨中信9A購02  ,0,0,0,0,0,0,0,0,0,50000,0,0,0,50000,0,50000,50000
055589,台光電元大98購04,0,0,0,0,0,0,0,0,0,50000,0,0,0,50000,0,50000,50000
055562,欣興凱基97購06  ,0,0,0,0,0,0,0,0,0,50000,0,0,0,50000,0,50000,50000
055629,華新科永豐97購04,0,0,0,0,0,0,0,0,0,50000,0,0,0,50000,0,50000,50000
058379,臺股指凱基99購14,0,0,0,0,0,0,0,0,0,50000,0,0,0,50000,0,50000,50000
057651,矽力元大98購03  ,0,0,0,0,0,0,0,0,0,50000,0,0,0,50000,0,50000,50000
055272,國巨元大98購04  ,0,0,0,0,0,0,0,0,0,50000,0,0,0,50000,0,50000,50000
055782,新日興凱基99購01,0,0,0,0,0,0,0,0,0,50000,0,0,0,50000,0,50000,50000
05841P,華通元大96售04  ,0,0,0,0,0,0,0,0,0,50000,0,0,0,50000,0,50000,50000
058297,茂林凱基9A購02  ,0,0,0,0,0,0,0,0,0,50000,0,0,0,128000,78000,50000,50000
055975,鴻海統一98購05  ,0,0,0,0,0,0,0,0,0,50000,0,0,0,50000,0,50000,50000
056983,大立光群益99購02,0,0,0,0,0,0,0,0,0,50000,0,0,0,50000,0,50000,50000
058769,友達兆豐99購01  ,0,0,0,0,0,0,0,0,0,50000,0,0,0,50000,0,50000,50000
058987,華新科凱基9B購01,10000,0,10000,0,0,0,0,0,0,40000,0,0,0,105000,65000,40000,50000
058910,泰鼎元大99購03  ,0,0,0,0,0,0,0,0,0,50000,0,0,0,96000,46000,50000,50000
058704,台積電元大99購17,0,0,0,0,0,0,0,0,0,50000,0,0,0,50000,0,50000,50000
6533,晶心科          ,92000,42000,50000,0,0,0,0,0,0,0,0,0,0,0,0,0,50000
07024P,臺股指永豐99售02,0,0,0,0,0,0,0,0,0,50000,0,0,0,90000,40000,50000,50000
06873P,嘉晶元富98售02  ,0,0,0,0,0,0,0,0,0,50000,0,0,0,50000,0,50000,50000
07692P,玉晶光元大9A售11,0,0,0,0,0,0,0,0,0,50000,0,0,0,60000,10000,50000,50000
07651P,道瓊指中信01售01,0,0,0,0,0,0,0,0,0,50000,0,0,0,50000,0,50000,50000
07337P,台灣50凱基99售09,0,0,0,0,0,0,0,0,0,50000,0,0,0,50000,0,50000,50000
1215,卜蜂            ,182000,137000,45000,0,0,0,0,0,0,5000,0,0,0,5000,0,5000,50000
1537,廣隆            ,55000,6000,49000,0,0,0,0,0,0,1000,1000,0,1000,0,0,0,50000
1474,弘裕            ,49000,1000,48000,0,0,0,0,0,0,2000,2000,0,2000,0,0,0,50000
2636,台驊投控        ,57000,7000,50000,0,0,0,0,0,0,0,0,0,0,0,0,0,50000
060381,元黃金凱基9A購01,0,0,0,0,0,0,0,0,0,49000,0,0,0,253000,204000,49000,49000
06568P,國巨永豐98售05  ,0,0,0,0,0,0,0,0,0,49000,0,0,0,148000,99000,49000,49000
051505,台積電元富95購05,0,0,0,0,0,0,0,0,0,49000,0,0,0,49000,0,49000,49000
050899,旭富元大95購01  ,0,0,0,0,0,0,0,0,0,49000,0,0,0,49000,0,49000,49000
049255,旺宏元大97購02  ,0,0,0,0,0,0,0,0,0,49000,0,0,0,192000,143000,49000,49000
00728,第一金工業30    ,0,0,0,0,0,0,0,0,0,49000,0,0,0,459000,410000,49000,49000
058476,旺宏凱基9A購01  ,0,0,0,0,0,0,0,0,0,49000,0,0,0,64000,15000,49000,49000
05782P,聯詠元富96售02  ,0,0,0,0,0,0,0,0,0,49000,0,0,0,49000,0,49000,49000
058816,祥碩台新99購02  ,0,0,0,0,0,0,0,0,0,49000,0,0,0,71000,22000,49000,49000
056953,智邦富邦98購02  ,0,0,0,0,0,0,0,0,0,49000,0,0,0,69000,20000,49000,49000
055178,晶豪科統一97購01,0,0,0,0,0,0,0,0,0,49000,0,0,0,76000,27000,49000,49000
058063,旺宏中信98購04  ,0,0,0,0,0,0,0,0,0,49000,0,0,0,49000,0,49000,49000
056726,友達日盛9A購01  ,0,0,0,0,0,0,0,0,0,49000,0,0,0,100000,51000,49000,49000
2423,固緯            ,55000,6000,49000,0,0,0,0,0,0,0,0,0,0,0,0,0,49000
07378P,大立光元大99售29,0,0,0,0,0,0,0,0,0,49000,0,0,0,50000,1000,49000,49000
07577P,華新科元大9A售09,0,0,0,0,0,0,0,0,0,49000,0,0,0,70000,21000,49000,49000
06952P,大立光統一9A售03,0,0,0,0,0,0,0,0,0,49000,0,0,0,54000,5000,49000,49000
07189P,聯發科富邦9B售03,0,0,0,0,0,0,0,0,0,49000,0,0,0,212000,163000,49000,49000
061336,國巨元大9A購20  ,0,0,0,0,0,0,0,0,0,48000,0,0,0,203000,155000,48000,48000
061105,宏達電元大9A購04,0,0,0,0,0,0,0,0,0,48000,0,0,0,143000,95000,48000,48000
060344,聯發科統一01購01,0,0,0,0,0,0,0,0,0,48000,0,0,0,154000,106000,48000,48000
059831,聯詠康和99購01  ,0,0,0,0,0,0,0,0,0,48000,0,0,0,68000,20000,48000,48000
059493,國巨國票9B購01  ,0,0,0,0,0,0,0,0,0,48000,0,0,0,277000,229000,48000,48000
00680L,元大美債20正2   ,0,0,0,0,0,0,0,0,0,48000,0,0,0,55000,7000,48000,48000
04230P,臺股指中信95售06,0,0,0,0,0,0,0,0,0,48000,0,0,0,50000,2000,48000,48000
047969,台達電富邦97購01,0,0,0,0,0,0,0,0,0,48000,0,0,0,48000,0,48000,48000
048422,瑞昱元富96購02  ,0,0,0,0,0,0,0,0,0,48000,0,0,0,225000,177000,48000,48000
054674,台光電台新97購01,0,0,0,0,0,0,0,0,0,48000,0,0,0,48000,0,48000,48000
054337,智邦統一96購01  ,0,0,0,0,0,0,0,0,0,48000,0,0,0,68000,20000,48000,48000
054025,鴻海凱基96購17  ,0,0,0,0,0,0,0,0,0,48000,0,0,0,48000,0,48000,48000
055592,奇力新元大97購07,0,0,0,0,0,0,0,0,0,48000,0,0,0,166000,118000,48000,48000
057337,聯發科國票99購02,0,0,0,0,0,0,0,0,0,48000,0,0,0,48000,0,48000,48000
057709,電子類群益98購01,0,0,0,0,0,0,0,0,0,48000,0,0,0,48000,0,48000,48000
1614,三洋電          ,49000,1000,48000,0,0,0,0,0,0,0,0,0,0,0,0,0,48000
5525,順天            ,49000,0,49000,0,0,0,0,0,0,-1000,0,1000,-1000,0,0,0,48000
059334,A50正2國票9A購02,0,0,0,0,0,0,0,0,0,47000,0,0,0,110000,63000,47000,47000
059263,瑞昱中信01購01  ,0,0,0,0,0,0,0,0,0,47000,0,0,0,97000,50000,47000,47000
060161,牧德永豐9A購02  ,0,0,0,0,0,0,0,0,0,47000,0,0,0,47000,0,47000,47000
061086,FBVIX統一01購01 ,0,0,0,0,0,0,0,0,0,47000,0,0,0,47000,0,47000,47000
060815,茂林凱基9B購01  ,0,0,0,0,0,0,0,0,0,47000,0,0,0,148000,101000,47000,47000
054462,旺宏凱基96購08  ,0,0,0,0,0,0,0,0,0,47000,0,0,0,47000,0,47000,47000
052847,漢唐統一99購01  ,0,0,0,0,0,0,0,0,0,47000,0,0,0,47000,0,47000,47000
05359P,嘉澤元大95售02  ,0,0,0,0,0,0,0,0,0,47000,0,0,0,199000,152000,47000,47000
050992,台積電元大97購01,0,0,0,0,0,0,0,0,0,47000,0,0,0,47000,0,47000,47000
057774,台光電群益99購02,0,0,0,0,0,0,0,0,0,47000,0,0,0,47000,0,47000,47000
057976,旺宏永豐98購03  ,0,0,0,0,0,0,0,0,0,47000,0,0,0,50000,3000,47000,47000
055192,世芯元富97購01  ,0,0,0,0,0,0,0,0,0,47000,0,0,0,47000,0,47000,47000
07764P,世紀鋼永豐9A售04,0,0,0,0,0,0,0,0,0,47000,0,0,0,87000,40000,47000,47000
2731,雄獅            ,71000,24000,47000,0,0,0,0,0,0,0,0,0,0,0,0,0,47000
07688P,華通元大9A售07  ,0,0,0,0,0,0,0,0,0,47000,0,0,0,57000,10000,47000,47000
061075,亞德客兆豐9A購01,0,0,0,0,0,0,0,0,0,46000,0,0,0,68000,22000,46000,46000
060641,聯鈞永豐9A購01  ,0,0,0,0,0,0,0,0,0,46000,0,0,0,48000,2000,46000,46000
06123P,玉晶光元大97售04,0,0,0,0,0,0,0,0,0,46000,0,0,0,86000,40000,46000,46000
06188P,大立光元富97售01,0,0,0,0,0,0,0,0,0,46000,0,0,0,46000,0,46000,46000
060280,元金2X元大9A購01,0,0,0,0,0,0,0,0,0,46000,0,0,0,100000,54000,46000,46000
059134,臺股指群益99購09,0,0,0,0,0,0,0,0,0,46000,0,0,0,46000,0,46000,46000
048551,鴻海元大94購02  ,0,0,0,0,0,0,0,0,0,46000,0,0,0,46000,0,46000,46000
00635U,元大S&P黃金     ,1000,0,1000,0,0,0,0,0,0,45000,110000,0,110000,254000,319000,-65000,46000
050588,矽創國票95購01  ,0,0,0,0,0,0,0,0,0,46000,0,0,0,46000,0,46000,46000
03677C,臺股指元大05牛02,0,0,0,0,0,0,0,0,0,46000,0,0,0,53000,7000,46000,46000
057499,奇鋐群益98購01  ,0,0,0,0,0,0,0,0,0,46000,0,0,0,157000,111000,46000,46000
054802,高股息元大97購01,0,0,0,0,0,0,0,0,0,46000,0,0,0,46000,0,46000,46000
056796,國巨麥證98購02  ,0,0,0,46000,0,46000,0,0,0,46000,0,0,0,46000,0,46000,46000
058178,國巨國泰9A購02  ,0,0,0,0,0,0,0,0,0,46000,0,0,0,260000,214000,46000,46000
059016,晶相光元富99購03,0,0,0,0,0,0,0,0,0,46000,0,0,0,73000,27000,46000,46000
055919,景碩凱基98購02  ,0,0,0,0,0,0,0,0,0,46000,0,0,0,76000,30000,46000,46000
060289,京元電元大9A購01,0,0,0,0,0,0,0,0,0,45000,0,0,0,70000,25000,45000,45000
061320,奇力新凱基9A購04,0,0,0,0,0,0,0,0,0,45000,0,0,0,222000,177000,45000,45000
061309,鴻海統一9C購05  ,0,0,0,0,0,0,0,0,0,45000,0,0,0,45000,0,45000,45000
052785,滬深2X中信99購03,0,0,0,0,0,0,0,0,0,45000,0,0,0,130000,85000,45000,45000
054211,奇鋐國票97購03  ,0,0,0,0,0,0,0,0,0,45000,0,0,0,45000,0,45000,45000
055380,智易元大98購02  ,0,0,0,0,0,0,0,0,0,45000,0,0,0,75000,30000,45000,45000
053467,鴻海元大96購20  ,0,0,0,0,0,0,0,0,0,45000,0,0,0,45000,0,45000,45000
050519,旺宏元大95購03  ,0,0,0,0,0,0,0,0,0,45000,0,0,0,45000,0,45000,45000
051727,S&P反1國票97購01,0,0,0,0,0,0,0,0,0,45000,0,0,0,50000,5000,45000,45000
052075,旺宏元富95購03  ,0,0,0,0,0,0,0,0,0,45000,0,0,0,45000,0,45000,45000
052190,創意群益95購03  ,0,0,0,0,0,0,0,0,0,45000,0,0,0,45000,0,45000,45000
051462,世芯國泰97購01  ,0,0,0,0,0,0,0,0,0,45000,0,0,0,45000,0,45000,45000
056418,台光電元富98購01,0,0,0,0,0,0,0,0,0,45000,0,0,0,95000,50000,45000,45000
056415,聯發科中信98購04,0,0,0,0,0,0,0,0,0,45000,0,0,0,55000,10000,45000,45000
058874,聯鈞國票9A購01  ,0,0,0,0,0,0,0,0,0,45000,0,0,0,48000,3000,45000,45000
057766,矽力凱基98購03  ,0,0,0,0,0,0,0,0,0,45000,0,0,0,45000,0,45000,45000
056157,聯詠凱基97購03  ,0,0,0,0,0,0,0,0,0,45000,0,0,0,45000,0,45000,45000
055614,華新科國票97購02,0,0,0,0,0,0,0,0,0,45000,0,0,0,45000,0,45000,45000
057383,玉晶光富邦9A購01,0,0,0,0,0,0,0,0,0,45000,0,0,0,75000,30000,45000,45000
07541P,國巨凱基9A售12  ,0,0,0,0,0,0,0,0,0,45000,0,0,0,45000,0,45000,45000
07522P,台積電中信9A售03,0,0,0,0,0,0,0,0,0,45000,0,0,0,45000,0,45000,45000
2348,海悅            ,47000,4000,43000,0,0,0,0,0,0,2000,2000,0,2000,0,0,0,45000
1618,合機            ,71000,26000,45000,0,0,0,0,0,0,0,0,0,0,0,0,0,45000
1503,士電            ,65000,20000,45000,0,0,0,0,0,0,0,0,0,0,0,0,0,45000
5283,禾聯碩          ,47000,0,47000,0,0,0,0,0,0,-2000,0,0,0,0,2000,-2000,45000
059151,臺股指國票99購14,0,0,0,0,0,0,0,0,0,44000,0,0,0,50000,6000,44000,44000
059308,T50反1元大99購07,0,0,0,0,0,0,0,0,0,44000,0,0,0,54000,10000,44000,44000
052102,台泥兆豐96購01  ,0,0,0,0,0,0,0,0,0,44000,0,0,0,94000,50000,44000,44000
055398,超眾統一97購03  ,0,0,0,0,0,0,0,0,0,44000,0,0,0,44000,0,44000,44000
055475,臻鼎凱基97購02  ,0,0,0,0,0,0,0,0,0,44000,0,0,0,44000,0,44000,44000
054118,國巨永豐96購04  ,0,0,0,0,0,0,0,0,0,44000,0,0,0,44000,0,44000,44000
052926,旺宏元大98購02  ,0,0,0,0,0,0,0,0,0,44000,0,0,0,44000,0,44000,44000
055041,致新富邦97購01  ,0,0,0,0,0,0,0,0,0,44000,0,0,0,200000,156000,44000,44000
058410,國巨兆豐99購03  ,0,0,0,0,0,0,0,0,0,44000,0,0,0,53000,9000,44000,44000
055864,臺股指元大97購01,0,0,0,0,0,0,0,0,0,44000,0,0,0,44000,0,44000,44000
059436,大立光元大99購18,0,0,0,0,0,0,0,0,0,43000,0,0,0,43000,0,43000,43000
059594,奇力新元大9B購01,0,0,0,0,0,0,0,0,0,43000,0,0,0,55000,12000,43000,43000
060887,台積電統一01購01,0,0,0,0,0,0,0,0,0,43000,0,0,0,65000,22000,43000,43000
060913,宏達電元大9A購03,0,0,0,0,0,0,0,0,0,43000,0,0,0,155000,112000,43000,43000
051829,玉晶光元大98購02,0,0,0,0,0,0,0,0,0,43000,0,0,0,43000,0,43000,43000
05642P,玉晶光兆豐97售02,0,0,0,0,0,0,0,0,0,43000,0,0,0,43000,0,43000,43000
057816,欣興元大98購13  ,0,0,0,0,0,0,0,0,0,43000,0,0,0,50000,7000,43000,43000
057820,華擎元大98購02  ,0,0,0,0,0,0,0,0,0,43000,0,0,0,293000,250000,43000,43000
057214,瑞昱群益98購01  ,0,0,0,0,0,0,0,0,0,43000,0,0,0,88000,45000,43000,43000
057284,新日興元大98購03,0,0,0,0,0,0,0,0,0,43000,0,0,0,73000,30000,43000,43000
056655,旺宏元大99購02  ,0,0,0,0,0,0,0,0,0,43000,0,0,0,79000,36000,43000,43000
05805P,義隆永豐96售02  ,0,0,0,0,0,0,0,0,0,43000,0,0,0,73000,30000,43000,43000
07272P,台灣50元大9C售05,0,0,0,0,0,0,0,0,0,43000,0,0,0,50000,7000,43000,43000
06822P,上銀富邦99售03  ,0,0,0,0,0,0,0,0,0,43000,0,0,0,258000,215000,43000,43000
060839,聯發科國票9A購02,0,0,0,0,0,0,0,0,0,42000,0,0,0,62000,20000,42000,42000
060865,創意永豐9A購01  ,0,0,0,0,0,0,0,0,0,42000,0,0,0,143000,101000,42000,42000
061301,華新科永豐9A購03,0,0,0,0,0,0,0,0,0,42000,0,0,0,75000,33000,42000,42000
061192,奇鋐永豐9A購01  ,0,0,0,0,0,0,0,0,0,42000,0,0,0,157000,115000,42000,42000
059634,可成凱基99購07  ,0,0,0,0,0,0,0,0,0,42000,0,0,0,78000,36000,42000,42000
006206,元大上證50      ,51000,2000,49000,0,0,0,0,0,0,-7000,0,0,0,86000,93000,-7000,42000
056629,昇陽半永豐98購01,0,0,0,0,0,0,0,0,0,42000,0,0,0,67000,25000,42000,42000
053506,南茂兆豐97購01  ,0,0,0,0,0,0,0,0,0,42000,0,0,0,84000,42000,42000,42000
055536,嘉聯益群益99購02,0,0,0,0,0,0,0,0,0,42000,0,0,0,68000,26000,42000,42000
05843P,台積電元大96售16,0,0,0,0,0,0,0,0,0,42000,0,0,0,42000,0,42000,42000
058326,祥碩台新99購01  ,0,0,0,0,0,0,0,0,0,42000,0,0,0,112000,70000,42000,42000
056142,超眾元大97購06  ,0,0,0,0,0,0,0,0,0,42000,0,0,0,70000,28000,42000,42000
057779,禾伸堂群益98購02,0,0,0,0,0,0,0,0,0,42000,0,0,0,306000,264000,42000,42000
058591,台灣50統一9B購02,0,0,0,0,0,0,0,0,0,42000,0,0,0,48000,6000,42000,42000
07026P,超眾凱基99售03  ,0,0,0,0,0,0,0,0,0,42000,0,0,0,42000,0,42000,42000
07636P,鴻海國票9A售05  ,0,0,0,0,0,0,0,0,0,42000,0,0,0,49000,7000,42000,42000
07435P,台積電富邦9C售07,0,0,0,0,0,0,0,0,0,42000,0,0,0,42000,0,42000,42000
1231,聯華食          ,98000,39000,59000,0,0,0,0,0,0,-17000,0,17000,-17000,0,0,0,42000
2305,全友            ,55000,12000,43000,0,0,0,0,0,0,-1000,0,1000,-1000,0,0,0,42000
6409,旭隼            ,133000,94000,39000,0,0,0,0,0,0,3000,3000,0,3000,0,0,0,42000
3058,立德            ,49000,7000,42000,0,0,0,0,0,0,0,0,0,0,0,0,0,42000
060435,鈺齊永豐9A購01  ,0,0,0,0,0,0,0,0,0,41000,0,0,0,219000,178000,41000,41000
060943,宏達電國票9B購02,0,0,0,0,0,0,0,0,0,41000,0,0,0,55000,14000,41000,41000
053484,國巨國票97購03  ,0,0,0,0,0,0,0,0,0,41000,0,0,0,41000,0,41000,41000
054271,中石化中信99購01,0,0,0,0,0,0,0,0,0,41000,0,0,0,51000,10000,41000,41000
053784,奇力新元大97購02,0,0,0,0,0,0,0,0,0,41000,0,0,0,124000,83000,41000,41000
052123,泰碩國票95購01  ,0,0,0,0,0,0,0,0,0,41000,0,0,0,41000,0,41000,41000
052079,康友元富98購01  ,0,0,0,0,0,0,0,0,0,41000,0,0,0,41000,0,41000,41000
055557,華新科凱基97購01,0,0,0,0,0,0,0,0,0,41000,0,0,0,41000,0,41000,41000
6582,申豐            ,146000,120000,26000,0,0,0,0,0,0,15000,15000,0,15000,0,0,0,41000
8341,日友            ,108000,67000,41000,0,0,0,0,0,0,0,0,0,0,0,0,0,41000
1733,五鼎            ,76000,34000,42000,0,0,0,0,0,0,-1000,2000,3000,-1000,0,0,0,41000
07569P,國巨凱基9A售13  ,0,0,0,0,0,0,0,0,0,41000,0,0,0,41000,0,41000,41000
07587P,台灣50國票9A售11,0,0,0,0,0,0,0,0,0,41000,0,0,0,44000,3000,41000,41000
06836P,玉晶光國票99售06,0,0,0,0,0,0,0,0,0,41000,0,0,0,200000,159000,41000,41000
07225P,台積電元大99售33,0,0,0,0,0,0,0,0,0,41000,0,0,0,146000,105000,41000,41000
060711,旺宏永豐9A購01  ,0,0,0,0,0,0,0,0,0,40000,0,0,0,43000,3000,40000,40000
06121P,同欣電凱基97售02,0,0,0,0,0,0,0,0,0,40000,0,0,0,40000,0,40000,40000
061283,智邦統一9A購01  ,0,0,0,0,0,0,0,0,0,40000,0,0,0,545000,505000,40000,40000
06681P,致茂元大98售02  ,0,0,0,0,0,0,0,0,0,40000,0,0,0,40000,0,40000,40000
06665P,欣興兆豐99售01  ,0,0,0,0,0,0,0,0,0,40000,0,0,0,40000,0,40000,40000
060412,儒鴻永豐9A購01  ,0,0,0,0,0,0,0,0,0,40000,0,0,0,103000,63000,40000,40000
060415,葡萄王永豐9A購01,0,0,0,0,0,0,0,0,0,40000,0,0,0,43000,3000,40000,40000
059980,台積電元大99購50,0,0,0,0,0,0,0,0,0,40000,0,0,0,60000,20000,40000,40000
060130,瀚宇博永豐99購02,0,0,0,0,0,0,0,0,0,40000,0,0,0,60000,20000,40000,40000
059618,台積電日盛99購01,0,0,0,0,0,0,0,0,0,40000,0,0,0,94000,54000,40000,40000
059713,滬深2X元大9C購04,0,0,0,0,0,0,0,0,0,40000,0,0,0,40000,0,40000,40000
052389,聯發科群益95購05,0,0,0,0,0,0,0,0,0,40000,0,0,0,40000,0,40000,40000
052463,聯電統一96購01  ,0,0,0,0,0,0,0,0,0,40000,0,0,0,172000,132000,40000,40000
052659,上証2X國票99購01,0,0,0,0,0,0,0,0,0,40000,0,0,0,60000,20000,40000,40000
052214,智伸科元大96購01,0,0,0,0,0,0,0,0,0,40000,0,0,0,40000,0,40000,40000
04617P,臺股指群益95售03,0,0,0,0,0,0,0,0,0,40000,0,0,0,43000,3000,40000,40000
03035X,元展32          ,0,0,0,0,0,0,0,0,0,40000,0,0,0,40000,0,40000,40000
03033P,微星國票03售01  ,60000,0,60000,0,0,0,0,0,0,-20000,0,0,0,0,20000,-20000,40000
054295,世芯元大96購03  ,0,0,0,0,0,0,0,0,0,40000,0,0,0,40000,0,40000,40000
054149,達方元大96購01  ,0,0,0,0,0,0,0,0,0,40000,0,0,0,100000,60000,40000,40000
052742,可成元大96購01  ,0,0,0,0,0,0,0,0,0,40000,0,0,0,55000,15000,40000,40000
053032,國巨兆豐97購02  ,0,0,0,0,0,0,0,0,0,40000,0,0,0,224000,184000,40000,40000
053441,旺宏凱基98購01  ,0,0,0,0,0,0,0,0,0,40000,0,0,0,40000,0,40000,40000
053499,禾伸堂兆豐96購01,0,0,0,0,0,0,0,0,0,40000,0,0,0,40000,0,40000,40000
05310P,智原永豐95售04  ,0,0,0,0,0,0,0,0,0,40000,0,0,0,40000,0,40000,40000
054559,台光電群益99購01,0,0,0,0,0,0,0,0,0,40000,0,0,0,50000,10000,40000,40000
055446,奇力新統一9A購01,0,0,0,0,0,0,0,0,0,40000,0,0,0,40000,0,40000,40000
057538,緯穎元大98購07  ,0,0,0,0,0,0,0,0,0,40000,0,0,0,40000,0,40000,40000
055426,旺宏群益99購02  ,0,0,0,0,0,0,0,0,0,40000,0,0,0,40000,0,40000,40000
057292,國巨國泰9B購01  ,0,0,0,0,0,0,0,0,0,40000,0,0,0,40000,0,40000,40000
058079,鴻海群益98購08  ,0,0,0,0,0,0,0,0,0,40000,0,0,0,118000,78000,40000,40000
058007,南電群益98購02  ,0,0,0,0,0,0,0,0,0,40000,0,0,0,40000,0,40000,40000
056663,臺股指元大9A購10,0,0,0,0,0,0,0,0,0,40000,0,0,0,40000,0,40000,40000
057616,聯電凱基99購01  ,0,0,0,0,0,0,0,0,0,40000,0,0,0,40000,0,40000,40000
055644,致茂元富97購01  ,0,0,0,0,0,0,0,0,0,40000,0,0,0,40000,0,40000,40000
055650,華新科元富98購01,0,0,0,0,0,0,0,0,0,40000,0,0,0,40000,0,40000,40000
057577,廣宇中信9A購01  ,0,0,0,0,0,0,0,0,0,40000,0,0,0,40000,0,40000,40000
058172,國巨凱基9B購02  ,0,0,0,0,0,0,0,0,0,40000,0,0,0,40000,0,40000,40000
058210,臺股指凱基9C購04,0,0,0,0,0,0,0,0,0,40000,0,0,0,40000,0,40000,40000
057861,台積電凱基98購16,0,0,0,0,0,0,0,0,0,40000,0,0,0,40000,0,40000,40000
058236,大立光元大99購09,0,0,0,0,0,0,0,0,0,40000,0,0,0,40000,0,40000,40000
058855,台積電兆豐99購02,0,0,0,0,0,0,0,0,0,40000,0,0,0,40000,0,40000,40000
05881P,彩晶康和96售01  ,0,0,0,0,0,0,0,0,0,40000,0,0,0,40000,0,40000,40000
056459,茂林凱基99購01  ,0,0,0,0,0,0,0,0,0,40000,0,0,0,100000,60000,40000,40000
056283,鴻海永豐97購03  ,0,0,0,0,0,0,0,0,0,40000,0,0,0,40000,0,40000,40000
055855,牧德元大99購02  ,0,0,0,0,0,0,0,0,0,40000,0,0,0,40000,0,40000,40000
057722,臺股指元富98購01,0,0,0,0,0,0,0,0,0,40000,0,0,0,40000,0,40000,40000
07241P,台灣50國票9A售05,0,0,0,0,0,0,0,0,0,40000,0,0,0,76000,36000,40000,40000
07251P,台灣50元富01售04,0,0,0,0,0,0,0,0,0,40000,0,0,0,100000,60000,40000,40000
5288,豐祥-KY         ,63000,23000,40000,0,0,0,0,0,0,0,0,0,0,0,0,0,40000
059789,貿聯元大9A購02  ,0,0,0,0,0,0,0,0,0,39000,0,0,0,100000,61000,39000,39000
059195,國巨永豐99購04  ,0,0,0,0,0,0,0,0,0,39000,0,0,0,58000,19000,39000,39000
060219,聯發科凱基9A購09,0,0,0,0,0,0,0,0,0,39000,0,0,0,39000,0,39000,39000
06631P,玉晶光群益9A售03,0,0,0,0,0,0,0,0,0,39000,0,0,0,45000,6000,39000,39000
061167,臻鼎兆豐9B購01  ,0,0,0,0,0,0,0,0,0,39000,0,0,0,83000,44000,39000,39000
060683,泰鼎元大9A購02  ,0,0,0,0,0,0,0,0,0,39000,0,0,0,49000,10000,39000,39000
060646,南電永豐9A購01  ,0,0,0,0,0,0,0,0,0,39000,0,0,0,66000,27000,39000,39000
061055,康控群益9A購01  ,0,0,0,0,0,0,0,0,0,39000,0,0,0,114000,75000,39000,39000
061013,台積電麥證9A購03,0,0,0,39000,0,39000,0,0,0,39000,0,0,0,39000,0,39000,39000
054423,華新富邦96購01  ,0,0,0,0,0,0,0,0,0,39000,0,0,0,39000,0,39000,39000
054011,旺宏永豐96購05  ,0,0,0,0,0,0,0,0,0,39000,0,0,0,39000,0,39000,39000
052194,旺宏元富95購04  ,0,0,0,0,0,0,0,0,0,39000,0,0,0,150000,111000,39000,39000
056107,智易永豐97購02  ,0,0,0,0,0,0,0,0,0,39000,0,0,0,39000,0,39000,39000
058622,國巨國票99購07  ,0,0,0,0,0,0,0,0,0,39000,0,0,0,445000,406000,39000,39000
057434,國巨國票99購03  ,0,0,0,0,0,0,0,0,0,39000,0,0,0,39000,0,39000,39000
057324,億光群益98購01  ,0,0,0,0,0,0,0,0,0,39000,0,0,0,270000,231000,39000,39000
3311,閎暉            ,52000,13000,39000,0,0,0,0,0,0,0,0,0,0,0,0,0,39000
06966P,健策台新9A售02  ,0,0,0,0,0,0,0,0,0,39000,0,0,0,39000,0,39000,39000
2015,豐興            ,106000,67000,39000,0,0,0,0,0,0,0,0,0,0,0,0,0,39000
060487,盛群富邦9B購01  ,0,0,0,0,0,0,0,0,0,38000,0,0,0,67000,29000,38000,38000
061157,聯鈞群益9A購02  ,0,0,0,0,0,0,0,0,0,38000,0,0,0,38000,0,38000,38000
060430,和潤永豐9A購01  ,0,0,0,0,0,0,0,0,0,38000,0,0,0,199000,161000,38000,38000
060336,南電康和9A購01  ,0,0,0,0,0,0,0,0,0,38000,0,0,0,45000,7000,38000,38000
060135,台灣50國票9C購02,0,0,0,0,0,0,0,0,0,38000,0,0,0,38000,0,38000,38000
059266,緯創中信01購01  ,0,0,0,0,0,0,0,0,0,38000,0,0,0,38000,0,38000,38000
059669,台灣50元富9B購05,0,0,0,0,0,0,0,0,0,38000,0,0,0,48000,10000,38000,38000
050392,群創統一96購01  ,0,0,0,0,0,0,0,0,0,38000,0,0,0,48000,10000,38000,38000
048870,義隆國票96購01  ,0,0,0,0,0,0,0,0,0,38000,0,0,0,78000,40000,38000,38000
04454P,大立光富邦98售02,0,0,0,0,0,0,0,0,0,38000,0,0,0,38000,0,38000,38000
054358,矽創兆豐96購01  ,0,0,0,0,0,0,0,0,0,38000,0,0,0,38000,0,38000,38000
054882,台光電統一97購02,0,0,0,0,0,0,0,0,0,38000,0,0,0,48000,10000,38000,38000
055442,矽創國票98購02  ,0,0,0,0,0,0,0,0,0,38000,0,0,0,38000,0,38000,38000
055404,超眾元富97購01  ,0,0,0,0,0,0,0,0,0,38000,0,0,0,160000,122000,38000,38000
057489,奇力新元大99購06,0,0,0,0,0,0,0,0,0,38000,0,0,0,65000,27000,38000,38000
057481,技嘉元大98購04  ,0,0,0,0,0,0,0,0,0,38000,0,0,0,50000,12000,38000,38000
053505,瑞儀兆豐97購01  ,0,0,0,0,0,0,0,0,0,38000,0,0,0,359000,321000,38000,38000
054758,南亞國票9A購01  ,0,0,0,0,0,0,0,0,0,38000,0,0,0,38000,0,38000,38000
057390,台表科永豐98購01,0,0,0,0,0,0,0,0,0,38000,0,0,0,38000,0,38000,38000
057173,南亞科元大98購04,0,0,0,0,0,0,0,0,0,38000,0,0,0,88000,50000,38000,38000
055705,微星永豐97購01  ,0,0,0,0,0,0,0,0,0,38000,0,0,0,38000,0,38000,38000
055777,冠德凱基97購01  ,0,0,0,0,0,0,0,0,0,38000,0,0,0,38000,0,38000,38000
058691,友訊國票9A購01  ,0,0,0,0,0,0,0,0,0,38000,0,0,0,38000,0,38000,38000
056838,旺宏元富98購01  ,0,0,0,0,0,0,0,0,0,38000,0,0,0,53000,15000,38000,38000
055992,智原台新97購02  ,0,0,0,0,0,0,0,0,0,38000,0,0,0,38000,0,38000,38000
07023P,南電永豐99售02  ,0,0,0,0,0,0,0,0,0,38000,0,0,0,38000,0,38000,38000
07482P,南亞科元富9A售04,0,0,0,0,0,0,0,0,0,38000,0,0,0,86000,48000,38000,38000
3032,偉訓            ,53000,15000,38000,0,0,0,0,0,0,0,0,0,0,0,0,0,38000
5907,大洋-KY         ,84000,54000,30000,0,0,0,0,0,0,8000,0,0,0,8000,0,8000,38000
8101,華冠            ,40000,2000,38000,0,0,0,0,0,0,0,0,0,0,0,0,0,38000
05942P,奇力新凱基96售04,0,0,0,0,0,0,0,0,0,37000,0,0,0,37000,0,37000,37000
06179P,國巨群益97售04  ,0,0,0,0,0,0,0,0,0,37000,0,0,0,77000,40000,37000,37000
06545P,致茂元大98售01  ,0,0,0,0,0,0,0,0,0,37000,0,0,0,37000,0,37000,37000
047194,世紀鋼元大96購01,0,0,0,0,0,0,0,0,0,37000,0,0,0,40000,3000,37000,37000
050853,南電國票96購01  ,0,0,0,0,0,0,0,0,0,37000,0,0,0,47000,10000,37000,37000
052378,矽力元大96購01  ,0,0,0,0,0,0,0,0,0,37000,0,0,0,37000,0,37000,37000
056872,旺宏凱基98購08  ,0,0,0,0,0,0,0,0,0,37000,0,0,0,37000,0,37000,37000
056286,奇鋐永豐97購01  ,0,0,0,0,0,0,0,0,0,37000,0,0,0,47000,10000,37000,37000
058692,華邦電國票9B購01,0,0,0,0,0,0,0,0,0,37000,0,0,0,61000,24000,37000,37000
057780,台郡群益98購02  ,0,20000,-20000,0,0,0,0,0,0,57000,0,0,0,204000,147000,57000,37000
058750,緯穎凱基9A購03  ,0,0,0,0,0,0,0,0,0,37000,0,0,0,57000,20000,37000,37000
058728,SP黃豆永豐99購01,0,0,0,0,0,0,0,0,0,37000,0,0,0,37000,0,37000,37000
05513P,玉山金台新96售01,0,0,0,0,0,0,0,0,0,37000,0,0,0,37000,0,37000,37000
9930,中聯資源        ,62000,25000,37000,0,0,0,0,0,0,0,0,0,0,0,0,0,37000
2404,漢唐            ,170000,98000,72000,0,0,0,0,0,0,-35000,15000,0,15000,4000,54000,-50000,37000
06603P,立積統一99售01  ,0,0,0,0,0,0,0,0,0,36000,0,0,0,36000,0,36000,36000
06750P,聯發科元富02售03,0,0,0,0,0,0,0,0,0,36000,0,0,0,56000,20000,36000,36000
059508,聯發科永豐99購03,0,0,0,0,0,0,0,0,0,36000,0,0,0,92000,56000,36000,36000
060299,友訊國泰9B購01  ,0,0,0,0,0,0,0,0,0,36000,0,0,0,175000,139000,36000,36000
046961,大立光中信95購02,0,0,0,0,0,0,0,0,0,36000,0,0,0,36000,0,36000,36000
054181,華新康和96購01  ,0,0,0,0,0,0,0,0,0,36000,0,0,0,36000,0,36000,36000
053761,健策國泰98購01  ,0,0,0,0,0,0,0,0,0,36000,0,0,0,36000,0,36000,36000
058357,智邦凱基99購02  ,0,0,0,0,0,0,0,0,0,36000,0,0,0,36000,0,36000,36000
058438,大立光統一9B購01,0,0,0,0,0,0,0,0,0,36000,0,0,0,116000,80000,36000,36000
057288,聯茂元大98購03  ,0,0,0,0,0,0,0,0,0,36000,0,0,0,36000,0,36000,36000
057799,世紀鋼兆豐98購01,0,0,0,0,0,0,0,0,0,36000,0,0,0,147000,111000,36000,36000
2527,宏璟            ,101000,65000,36000,0,0,0,0,0,0,0,0,0,0,0,0,0,36000
07558P,玉晶光元大9A售10,0,0,0,0,0,0,0,0,0,36000,0,0,0,42000,6000,36000,36000
07611P,大立光國票9A售05,0,0,0,0,0,0,0,0,0,36000,0,0,0,36000,0,36000,36000
07675P,全新永豐9A售02  ,0,0,0,0,0,0,0,0,0,36000,0,0,0,36000,0,36000,36000
910861,神州-DR         ,36000,0,36000,0,0,0,0,0,0,0,0,0,0,0,0,0,36000
060258,T50反1凱基9A購06,0,0,0,0,0,0,0,0,0,35000,0,0,0,40000,5000,35000,35000
060122,亞德客永豐99購02,0,0,0,0,0,0,0,0,0,35000,0,0,0,55000,20000,35000,35000
060326,群光群益9A購01  ,0,0,0,0,0,0,0,0,0,35000,0,0,0,50000,15000,35000,35000
059988,大立光元大9A購02,0,0,0,0,0,0,0,0,0,35000,0,0,0,88000,53000,35000,35000
059868,台光電凱基99購03,0,0,0,0,0,0,0,0,0,35000,0,0,0,35000,0,35000,35000
059316,國巨元大99購23  ,0,0,0,0,0,0,0,0,0,35000,0,0,0,45000,10000,35000,35000
05922P,京元電兆豐96售01,0,0,0,0,0,0,0,0,0,35000,0,0,0,40000,5000,35000,35000
06448P,華通元大99售01  ,0,0,0,0,0,0,0,0,0,35000,0,0,0,57000,22000,35000,35000
06180P,禾伸堂群益97售01,0,0,0,0,0,0,0,0,0,35000,0,0,0,60000,25000,35000,35000
053303,建準凱基96購03  ,0,0,0,0,0,0,0,0,0,35000,0,0,0,35000,0,35000,35000
054803,味全元大9A購01  ,0,0,0,0,0,0,0,0,0,35000,0,0,0,35000,0,35000,35000
053662,矽力凱基97購01  ,0,0,0,0,0,0,0,0,0,35000,0,0,0,36000,1000,35000,35000
03618C,高股息凱基95牛01,0,0,0,0,0,0,0,0,0,35000,0,0,0,35000,0,35000,35000
050374,上緯控元大95購01,0,0,0,0,0,0,0,0,0,35000,0,0,0,35000,0,35000,35000
050261,國巨元大95購04  ,0,0,0,0,0,0,0,0,0,35000,0,0,0,35000,0,35000,35000
050155,華新科群益95購01,0,0,0,0,0,0,0,0,0,35000,0,0,0,45000,10000,35000,35000
03980P,群創凱基95售02  ,0,0,0,0,0,0,0,0,0,35000,0,0,0,35000,0,35000,35000
051575,國巨元大96購03  ,0,0,0,0,0,0,0,0,0,35000,0,0,0,35000,0,35000,35000
052068,瑞儀兆豐96購01  ,0,0,0,0,0,0,0,0,0,35000,0,0,0,97000,62000,35000,35000
058965,祥碩兆豐99購02  ,0,0,0,0,0,0,0,0,0,35000,0,0,0,255000,220000,35000,35000
057006,國巨中信98購03  ,0,0,0,0,0,0,0,0,0,35000,0,0,0,35000,0,35000,35000
057293,力成國泰99購01  ,0,0,0,0,0,0,0,0,0,35000,0,0,0,35000,0,35000,35000
057271,國巨元大98購17  ,0,0,0,0,0,0,0,0,0,35000,0,0,0,35000,0,35000,35000
057253,高股息中信99購02,0,0,0,0,0,0,0,0,0,35000,0,0,0,35000,0,35000,35000
058234,華新科元大99購12,0,0,0,0,0,0,0,0,0,35000,0,0,0,95000,60000,35000,35000
3501,維熹            ,43000,8000,35000,0,0,0,0,0,0,0,0,0,0,0,0,0,35000
07439P,臺股指麥證9B售01,0,0,0,40000,5000,35000,0,0,0,35000,0,0,0,40000,5000,35000,35000
07008P,台郡中信99售02  ,0,0,0,0,0,0,0,0,0,35000,0,0,0,35000,0,35000,35000
06901P,亞德客凱基98售02,0,0,0,0,0,0,0,0,0,35000,0,0,0,35000,0,35000,35000
07266P,大立光元大99售19,0,0,0,0,0,0,0,0,0,35000,0,0,0,40000,5000,35000,35000
07069P,欣興元富99售02  ,0,0,0,0,0,0,0,0,0,35000,0,0,0,35000,0,35000,35000
061218,臺股指元大9A購55,0,0,0,0,0,0,0,0,0,34000,0,0,0,34000,0,34000,34000
060616,宏碁元大9A購02  ,0,0,0,0,0,0,0,0,0,34000,0,0,0,206000,172000,34000,34000
059494,國巨國票9C購01  ,0,0,0,0,0,0,0,0,0,34000,0,0,0,38000,4000,34000,34000
059487,聯發科兆豐99購03,0,0,0,0,0,0,0,0,0,34000,0,0,0,38000,4000,34000,34000
059529,華新科凱基9A購04,0,0,0,0,0,0,0,0,0,34000,0,0,0,48000,14000,34000,34000
059753,貿聯群益99購06  ,0,0,0,0,0,0,0,0,0,34000,0,0,0,34000,0,34000,34000
060108,泰鼎元大99購04  ,0,0,0,0,0,0,0,0,0,34000,0,0,0,50000,16000,34000,34000
05201P,玉晶光國泰97售02,0,0,0,0,0,0,0,0,0,34000,0,0,0,34000,0,34000,34000
052446,聯發科元大96購03,0,0,0,0,0,0,0,0,0,34000,0,0,0,34000,0,34000,34000
048572,美利達元大96購04,0,0,0,0,0,0,0,0,0,34000,0,0,0,39000,5000,34000,34000
053176,矽力群益96購02  ,0,0,0,0,0,0,0,0,0,34000,0,0,0,34000,0,34000,34000
05443P,宏達電元大95售05,0,0,0,0,0,0,0,0,0,34000,0,0,0,34000,0,34000,34000
054917,聯發科凱基98購05,0,0,0,0,0,0,0,0,0,34000,0,0,0,34000,0,34000,34000
054330,世芯永豐96購02  ,0,0,0,0,0,0,0,0,0,34000,0,0,0,34000,0,34000,34000
056660,臺股指元大9A購07,0,0,0,0,0,0,0,0,0,34000,0,0,0,34000,0,34000,34000
3025,星通            ,37000,3000,34000,0,0,0,0,0,0,0,0,0,0,0,0,0,34000
2233,宇隆            ,55000,21000,34000,0,0,0,0,0,0,0,0,0,0,0,0,0,34000
6715,嘉基            ,39000,5000,34000,0,0,0,0,0,0,0,0,0,0,0,0,0,34000
060211,智邦康和9A購01  ,0,0,0,0,0,0,0,0,0,33000,0,0,0,44000,11000,33000,33000
059744,禾伸堂元富99購02,0,0,0,0,0,0,0,0,0,33000,0,0,0,33000,0,33000,33000
059475,元石油群益99購02,0,0,0,0,0,0,0,0,0,33000,0,0,0,33000,0,33000,33000
060567,華擎富邦9C購01  ,0,0,0,0,0,0,0,0,0,33000,0,0,0,33000,0,33000,33000
061011,華通麥證9A購02  ,0,0,0,45000,12000,33000,0,0,0,33000,0,0,0,45000,12000,33000,33000
060895,華新科凱基9B購05,0,0,0,0,0,0,0,0,0,33000,0,0,0,65000,32000,33000,33000
06239P,奇力新元大97售08,0,0,0,0,0,0,0,0,0,33000,0,0,0,33000,0,33000,33000
054343,世紀鋼元富96購02,0,0,0,0,0,0,0,0,0,33000,0,0,0,83000,50000,33000,33000
054913,億光凱基97購01  ,0,0,0,0,0,0,0,0,0,33000,0,0,0,67000,34000,33000,33000
053621,臺股指群益96購07,0,0,0,0,0,0,0,0,0,33000,0,0,0,33000,0,33000,33000
052654,友達統一97購01  ,0,0,0,0,0,0,0,0,0,33000,0,0,0,50000,17000,33000,33000
051939,同欣電群益97購01,0,0,0,0,0,0,0,0,0,33000,0,0,0,33000,0,33000,33000
057191,祥碩元大98購05  ,0,0,0,0,0,0,0,0,0,33000,0,0,0,136000,103000,33000,33000
055764,臺股指群益97購02,0,0,0,0,0,0,0,0,0,33000,0,0,0,33000,0,33000,33000
055822,臺股指國票97購09,0,0,0,0,0,0,0,0,0,33000,0,0,0,43000,10000,33000,33000
05624P,同欣電中信98售01,0,0,0,0,0,0,0,0,0,33000,0,0,0,33000,0,33000,33000
058927,勤誠元富99購02  ,0,0,0,0,0,0,0,0,0,33000,0,0,0,147000,114000,33000,33000
057980,聯詠永豐98購01  ,0,0,0,0,0,0,0,0,0,33000,0,0,0,82000,49000,33000,33000
8131,福懋科          ,181000,150000,31000,0,0,0,1000,0,1000,1000,0,0,0,6000,5000,1000,33000
2358,廷鑫            ,44000,11000,33000,0,0,0,0,0,0,0,0,0,0,0,0,0,33000
2414,精技            ,53000,20000,33000,0,0,0,0,0,0,0,0,0,0,0,0,0,33000
2536,宏普            ,92000,43000,49000,0,0,0,0,18000,-18000,2000,2000,0,2000,0,0,0,33000
1219,福壽            ,33000,0,33000,0,0,0,0,0,0,0,0,0,0,0,0,0,33000
06626P,大立光統一9A售01,0,0,0,0,0,0,0,0,0,32000,0,0,0,32000,0,32000,32000
060602,京元電凱基9A購01,0,0,0,0,0,0,0,0,0,32000,0,0,0,32000,0,32000,32000
060217,國巨凱基9A購10  ,0,0,0,0,0,0,0,0,0,32000,0,0,0,42000,10000,32000,32000
060309,佳世達永豐9A購01,0,0,0,0,0,0,0,0,0,32000,0,0,0,58000,26000,32000,32000
052483,超眾群益95購03  ,0,0,0,0,0,0,0,0,0,32000,0,0,0,32000,0,32000,32000
052515,矽力凱基95購02  ,0,0,0,0,0,0,0,0,0,32000,0,0,0,32000,0,32000,32000
053524,聯電中信97購02  ,0,0,0,0,0,0,0,0,0,32000,0,0,0,152000,120000,32000,32000
054625,旺宏凱基98購03  ,0,0,0,0,0,0,0,0,0,32000,0,0,0,32000,0,32000,32000
054147,GIS元大96購02   ,0,0,0,0,0,0,0,0,0,32000,0,0,0,162000,130000,32000,32000
052809,訊芯元大97購01  ,0,0,0,0,0,0,0,0,0,32000,0,0,0,32000,0,32000,32000
056177,嘉澤元富97購01  ,0,0,0,0,0,0,0,0,0,32000,0,0,0,32000,0,32000,32000
056087,世芯統一97購01  ,0,0,0,0,0,0,0,0,0,32000,0,0,0,32000,0,32000,32000
057044,旺宏元大98購08  ,0,0,0,0,0,0,0,0,0,32000,0,0,0,183000,151000,32000,32000
05770P,聯發科凱基96售16,0,0,0,0,0,0,0,0,0,32000,0,0,0,35000,3000,32000,32000
058228,為升元大99購01  ,0,0,0,0,0,0,0,0,0,32000,0,0,0,32000,0,32000,32000
057273,智邦元大98購05  ,0,0,0,0,0,0,0,0,0,32000,0,0,0,55000,23000,32000,32000
057397,茂林中信9A購01  ,0,0,0,0,0,0,0,0,0,32000,0,0,0,109000,77000,32000,32000
057379,寶成元大98購02  ,0,0,0,0,0,0,0,0,0,32000,0,0,0,32000,0,32000,32000
058102,楠梓電永豐98購04,0,0,0,0,0,0,0,0,0,32000,0,0,0,42000,10000,32000,32000
055647,義隆元富97購01  ,0,0,0,0,0,0,0,0,0,32000,0,0,0,44000,12000,32000,32000
1323,永裕            ,47000,15000,32000,0,0,0,0,0,0,0,0,0,0,0,0,0,32000
1603,華電            ,38000,7000,31000,0,0,0,0,0,0,1000,1000,0,1000,0,0,0,32000
07179P,臺股指凱基99售21,0,0,0,0,0,0,0,0,0,32000,0,0,0,32000,0,32000,32000
07403P,聯發科凱基99售21,0,0,0,0,0,0,0,0,0,32000,0,0,0,35000,3000,32000,32000
3057,喬鼎            ,32000,0,32000,0,0,0,0,0,0,0,0,0,0,0,0,0,32000
3703,欣陸            ,252000,220000,32000,0,0,0,0,0,0,0,0,0,0,0,0,0,32000
060187,華新科元富9A購02,0,0,0,0,0,0,0,0,0,31000,0,0,0,232000,201000,31000,31000
060071,國巨元富99購03  ,0,0,0,0,0,0,0,0,0,31000,0,0,0,33000,2000,31000,31000
059999,緯穎元富99購01  ,0,0,0,0,0,0,0,0,0,31000,0,0,0,59000,28000,31000,31000
059246,奇力新凱基9A購02,0,0,0,0,0,0,0,0,0,31000,0,0,0,42000,11000,31000,31000
060538,S&P反1凱基9A購01,0,0,0,0,0,0,0,0,0,31000,0,0,0,31000,0,31000,31000
06566P,華通永豐98售03  ,0,0,0,0,0,0,0,0,0,31000,0,0,0,31000,0,31000,31000
061201,FBVIX元大01購03 ,0,0,0,0,0,0,0,0,0,31000,0,0,0,31000,0,31000,31000
053639,禾伸堂永豐96購01,0,0,0,0,0,0,0,0,0,31000,0,0,0,81000,50000,31000,31000
051650,矽力永豐95購01  ,0,0,0,0,0,0,0,0,0,31000,0,0,0,31000,0,31000,31000
00690,兆豐藍籌30      ,0,0,0,0,0,0,0,0,0,31000,0,0,0,182000,151000,31000,31000
05016P,臺股指元大95售07,0,0,0,0,0,0,0,0,0,31000,0,0,0,31000,0,31000,31000
057635,中鋼元大98購01  ,0,0,0,0,0,0,0,0,0,31000,0,0,0,31000,0,31000,31000
05669P,嘉晶永豐96售03  ,0,0,0,0,0,0,0,0,0,31000,0,0,0,85000,54000,31000,31000
057562,奇鋐兆豐98購01  ,0,0,0,0,0,0,0,0,0,31000,0,0,0,33000,2000,31000,31000
058230,國巨元大99購11  ,0,0,0,0,0,0,0,0,0,31000,0,0,0,83000,52000,31000,31000
058607,聯發科元大99購14,0,0,0,0,0,0,0,0,0,31000,0,0,0,31000,0,31000,31000
058551,義隆永豐99購03  ,0,0,0,0,0,0,0,0,0,31000,0,0,0,42000,11000,31000,31000
3494,誠研            ,31000,0,31000,0,0,0,0,0,0,0,0,0,0,0,0,0,31000
6142,友勁            ,30000,0,30000,0,0,0,0,0,0,1000,1000,0,1000,0,0,0,31000
8499,鼎炫-KY         ,33000,11000,22000,0,0,0,0,0,0,9000,9000,0,9000,0,0,0,31000
07319P,台積電凱基01售02,0,0,0,0,0,0,0,0,0,31000,0,0,0,46000,15000,31000,31000
06833P,矽力群益99售01  ,0,0,0,0,0,0,0,0,0,31000,0,0,0,31000,0,31000,31000
06983P,台積電國泰9A售02,0,0,0,0,0,0,0,0,0,31000,0,0,0,34000,3000,31000,31000
06271P,彩晶凱基97售01  ,0,0,0,0,0,0,0,0,0,30000,0,0,0,30000,0,30000,30000
06398P,禾伸堂凱基97售02,0,0,0,0,0,0,0,0,0,30000,0,0,0,30000,0,30000,30000
060543,鴻海凱基9B購02  ,0,0,0,0,0,0,0,0,0,30000,0,0,0,30000,0,30000,30000
060589,台灣50台新9B購06,0,0,0,0,0,0,0,0,0,30000,0,0,0,40000,10000,30000,30000
060940,國巨國票9B購03  ,0,0,0,0,0,0,0,0,0,30000,0,0,0,230000,200000,30000,30000
059287,華通元富99購03  ,0,0,0,0,0,0,0,0,0,30000,0,0,0,37000,7000,30000,30000
059337,台灣50凱基9C購05,0,0,0,0,0,0,0,0,0,30000,0,0,0,30000,0,30000,30000
059322,晶技元大99購06  ,0,0,0,0,0,0,0,0,0,30000,0,0,0,30000,0,30000,30000
059435,大立光元大99購17,0,0,0,0,0,0,0,0,0,30000,0,0,0,30000,0,30000,30000
059691,大立光永豐99購02,0,0,0,0,0,0,0,0,0,30000,0,0,0,30000,0,30000,30000
059728,聯鈞元大99購01  ,0,0,0,0,0,0,0,0,0,30000,0,0,0,30000,0,30000,30000
060041,T50反1群益99購04,0,0,0,0,0,0,0,0,0,30000,0,0,0,30000,0,30000,30000
060377,鴻海台新9A購01  ,0,0,0,0,0,0,0,0,0,30000,0,0,0,30000,0,30000,30000
049946,智邦兆豐95購01  ,0,0,0,0,0,0,0,0,0,30000,0,0,0,30000,0,30000,30000
04933P,中石化中信96售01,0,0,0,0,0,0,0,0,0,30000,0,0,0,30000,0,30000,30000
049264,奇鋐元大95購01  ,0,0,0,0,0,0,0,0,0,30000,0,0,0,30000,0,30000,30000
046703,瑞昱元富95購01  ,0,0,0,0,0,0,0,0,0,30000,0,0,0,30000,0,30000,30000
03314P,台積電元大02售16,0,0,0,0,0,0,0,0,0,30000,0,0,0,30000,0,30000,30000
042712,元石油國票95購01,0,0,0,0,0,0,0,0,0,30000,0,0,0,30000,0,30000,30000
049230,台達電富邦96購01,0,0,0,0,0,0,0,0,0,30000,0,0,0,30000,0,30000,30000
051468,智邦日盛95購01  ,0,0,0,0,0,0,0,0,0,30000,0,0,0,30000,0,30000,30000
052543,聯詠元富95購01  ,0,0,0,0,0,0,0,0,0,30000,0,0,0,30000,0,30000,30000
053891,欣興群益98購01  ,0,0,0,0,0,0,0,0,0,30000,0,0,0,30000,0,30000,30000
052618,群創國泰98購01  ,0,0,0,0,0,0,0,0,0,30000,0,0,0,30000,0,30000,30000
05261P,鴻海元大95售20  ,0,0,0,0,0,0,0,0,0,30000,0,0,0,45000,15000,30000,30000
052668,聯發科群益97購01,0,0,0,0,0,0,0,0,0,30000,0,0,0,30000,0,30000,30000
052686,華新科元大96購03,0,0,0,0,0,0,0,0,0,30000,0,0,0,30000,0,30000,30000
051988,台光電元大95購01,0,0,0,0,0,0,0,0,0,30000,0,0,0,30000,0,30000,30000
051862,旺宏凱基95購05  ,0,0,0,0,0,0,0,0,0,30000,0,0,0,30000,0,30000,30000
051677,達方元大95購01  ,0,0,0,0,0,0,0,0,0,30000,0,0,0,30000,0,30000,30000
054690,新興永豐97購01  ,0,0,0,0,0,0,0,0,0,30000,0,0,0,30000,0,30000,30000
053404,致新群益96購01  ,0,0,0,0,0,0,0,0,0,30000,0,0,0,30000,0,30000,30000
052814,上証2X永豐96購02,0,0,0,0,0,0,0,0,0,30000,0,0,0,30000,0,30000,30000
053312,緯穎凱基96購02  ,0,0,0,0,0,0,0,0,0,30000,0,0,0,30000,0,30000,30000
054428,禾伸堂富邦98購01,0,0,0,0,0,0,0,0,0,30000,0,0,0,30000,0,30000,30000
054842,台達電兆豐98購01,0,0,0,0,0,0,0,0,0,30000,0,0,0,70000,40000,30000,30000
052929,可成元大96購02  ,0,0,0,0,0,0,0,0,0,30000,0,0,0,30000,0,30000,30000
053022,欣興國泰98購01  ,0,0,0,0,0,0,0,0,0,30000,0,0,0,40000,10000,30000,30000
058612,健策元大99購02  ,0,0,0,0,0,0,0,0,0,30000,0,0,0,30000,0,30000,30000
058676,聯茂群益99購01  ,0,0,0,0,0,0,0,0,0,30000,0,0,0,30000,0,30000,30000
059011,臺股指元大9A購30,0,5000,-5000,0,0,0,0,0,0,35000,0,0,0,35000,0,35000,30000
05594P,旺宏國票96售04  ,0,0,0,0,0,0,0,0,0,30000,0,0,0,70000,40000,30000,30000
055893,大立光統一97購07,0,0,0,0,0,0,0,0,0,30000,0,0,0,30000,0,30000,30000
056968,揚明光永豐98購02,0,0,0,0,0,0,0,0,0,30000,0,0,0,30000,0,30000,30000
056186,智原統一97購01  ,0,0,0,0,0,0,0,0,0,30000,0,0,0,32000,2000,30000,30000
058384,大成鋼中信99購01,0,0,0,0,0,0,0,0,0,30000,0,0,0,30000,0,30000,30000
055283,聯發科元大97購16,0,0,0,0,0,0,0,0,0,30000,0,0,0,30000,0,30000,30000
056802,友達台新98購01  ,0,0,0,0,0,0,0,0,0,30000,0,0,0,30000,0,30000,30000
055188,亞翔統一97購01  ,0,0,0,0,0,0,0,0,0,30000,0,0,0,30000,0,30000,30000
05520P,聯詠凱基96售01  ,0,0,0,0,0,0,0,0,0,30000,0,0,0,30000,0,30000,30000
055048,台積電永豐97購04,0,0,0,0,0,0,0,0,0,30000,0,0,0,30000,0,30000,30000
055029,帆宣國泰99購01  ,0,0,0,0,0,0,0,0,0,30000,0,0,0,30000,0,30000,30000
057436,義隆國票99購02  ,0,0,0,0,0,0,0,0,0,30000,0,0,0,33000,3000,30000,30000
056697,緯穎群益98購01  ,0,0,0,0,0,0,0,0,0,30000,0,0,0,30000,0,30000,30000
056716,康舒永豐98購01  ,0,0,0,0,0,0,0,0,0,30000,0,0,0,30000,0,30000,30000
055654,景碩元富97購01  ,0,0,0,0,0,0,0,0,0,30000,0,0,0,30000,0,30000,30000
06936P,瑞儀元大98售01  ,0,0,0,0,0,0,0,0,0,30000,0,0,0,95000,65000,30000,30000
07329P,台灣50群益9A售07,0,0,0,0,0,0,0,0,0,30000,0,0,0,30000,0,30000,30000
07362P,聯發科元大99售35,0,0,0,0,0,0,0,0,0,30000,0,0,0,30000,0,30000,30000
07521P,台積電中信01售05,0,0,0,0,0,0,0,0,0,30000,0,0,0,30000,0,30000,30000
1449,佳和            ,64000,34000,30000,0,0,0,0,0,0,0,0,0,0,0,0,0,30000
1445,大宇            ,30000,0,30000,0,0,0,0,0,0,0,0,0,0,0,0,0,30000
2388,威盛            ,174000,144000,30000,0,0,0,0,0,0,0,0,0,0,0,0,0,30000
060114,緯穎元大99購10  ,0,0,0,0,0,0,0,0,0,29000,0,0,0,29000,0,29000,29000
059428,國巨元大99購25  ,0,0,0,0,0,0,0,0,0,29000,0,0,0,30000,1000,29000,29000
060576,欣興中信9B購01  ,0,0,0,0,0,0,0,0,0,29000,0,0,0,70000,41000,29000,29000
060633,玉晶光富邦02購01,0,0,0,0,0,0,0,0,0,29000,0,0,0,30000,1000,29000,29000
06653P,美食元大98售02  ,0,0,0,0,0,0,0,0,0,29000,0,0,0,180000,151000,29000,29000
06730P,祥碩元大98售07  ,0,0,0,0,0,0,0,0,0,29000,0,0,0,29000,0,29000,29000
053059,聯發科永昌99購01,0,0,0,0,0,0,0,0,0,29000,0,0,0,29000,0,29000,29000
054464,奇力新凱基98購02,0,0,0,0,0,0,0,0,0,29000,0,0,0,29000,0,29000,29000
054088,華新群益98購02  ,0,0,0,0,0,0,0,0,0,29000,0,0,0,30000,1000,29000,29000
05752P,台積電中信96售06,0,0,0,0,0,0,0,0,0,29000,0,0,0,29000,0,29000,29000
049153,大立光元大96購02,0,0,0,0,0,0,0,0,0,29000,0,0,0,29000,0,29000,29000
049141,旺宏元大95購01  ,0,0,0,0,0,0,0,0,0,29000,0,0,0,29000,0,29000,29000
020008,元大特股高息N   ,0,0,0,0,0,0,0,0,0,29000,0,0,0,37000,8000,29000,29000
058096,南電元大98購04  ,0,0,0,0,0,0,0,0,0,29000,0,0,0,29000,0,29000,29000
058048,群創元大9B購07  ,0,0,0,0,0,0,0,0,0,29000,0,0,0,57000,28000,29000,29000
056817,國巨永豐98購04  ,0,0,0,0,0,0,0,0,0,29000,0,0,0,53000,24000,29000,29000
058289,奇鋐國票9A購01  ,0,0,0,0,0,0,0,0,0,29000,0,0,0,44000,15000,29000,29000
056291,聯茂永豐97購03  ,0,0,0,0,0,0,0,0,0,29000,0,0,0,80000,51000,29000,29000
059084,鴻海元大99購24  ,0,0,0,0,0,0,0,0,0,29000,0,0,0,29000,0,29000,29000
2506,太設            ,29000,0,29000,0,0,0,0,0,0,0,0,0,0,0,0,0,29000
1423,利華            ,40000,11000,29000,0,0,0,0,0,0,0,0,0,0,0,0,0,29000
07712P,茂林元大9A售03  ,0,0,0,0,0,0,0,0,0,29000,0,0,0,37000,8000,29000,29000
1533,車王電          ,30000,1000,29000,0,0,0,0,0,0,0,0,0,0,0,0,0,29000
2028,威致            ,32000,3000,29000,0,0,0,0,0,0,0,0,0,0,0,0,0,29000
07282P,聯發科凱基99售17,0,0,0,0,0,0,0,0,0,29000,0,0,0,34000,5000,29000,29000
07074P,FBVIX凱基9A售01 ,0,0,0,0,0,0,0,0,0,29000,0,0,0,29000,0,29000,29000
8482,商億-KY         ,32000,3000,29000,0,0,0,0,0,0,0,0,0,0,0,0,0,29000
3305,昇貿            ,37000,8000,29000,0,0,0,0,0,0,0,0,0,0,0,0,0,29000
06594P,立積元大98售01  ,0,0,0,0,0,0,0,0,0,28000,0,0,0,261000,233000,28000,28000
06523P,台積電麥證98售02,0,0,0,28000,0,28000,0,0,0,28000,0,0,0,28000,0,28000,28000
0051,元大中型100     ,0,0,0,0,0,0,0,0,0,28000,0,0,0,28000,0,28000,28000
052229,奇力新凱基96購01,0,0,0,0,0,0,0,0,0,28000,0,0,0,60000,32000,28000,28000
04927P,大立光凱基95售06,0,0,0,0,0,0,0,0,0,28000,0,0,0,28000,0,28000,28000
049795,華通元大96購02  ,0,0,0,0,0,0,0,0,0,28000,0,0,0,28000,0,28000,28000
058796,可成元大99購04  ,0,0,0,0,0,0,0,0,0,28000,0,0,0,78000,50000,28000,28000
058829,華新科永豐99購04,0,0,0,0,0,0,0,0,0,28000,0,0,0,28000,0,28000,28000
057846,神達永豐98購01  ,0,0,0,0,0,0,0,0,0,28000,0,0,0,28000,0,28000,28000
057040,國巨元大98購12  ,0,0,0,0,0,0,0,0,0,28000,0,0,0,122000,94000,28000,28000
055133,致新康和97購01  ,0,0,0,0,0,0,0,0,0,28000,0,0,0,68000,40000,28000,28000
058015,旺宏凱基99購02  ,0,0,0,0,0,0,0,0,0,28000,0,0,0,28000,0,28000,28000
9925,新保            ,59000,31000,28000,0,0,0,0,0,0,0,0,0,0,0,0,0,28000
2380,虹光            ,41000,13000,28000,0,0,0,0,0,0,0,0,0,0,0,0,0,28000
2427,三商電          ,32000,7000,25000,0,0,0,0,0,0,3000,3000,0,3000,0,0,0,28000
06154P,超眾元大98售01  ,0,0,0,0,0,0,0,0,0,27000,0,0,0,27000,0,27000,27000
06600P,貿聯永豐98售01  ,0,0,0,0,0,0,0,0,0,27000,0,0,0,27000,0,27000,27000
052209,深中小元大95購02,0,0,0,0,0,0,0,0,0,27000,0,0,0,27000,0,27000,27000
053184,世紀鋼元富96購01,0,0,0,0,0,0,0,0,0,27000,0,0,0,27000,0,27000,27000
058081,技嘉群益9A購03  ,0,0,0,0,0,0,0,0,0,27000,0,0,0,57000,30000,27000,27000
056675,聯發科元富02購01,0,0,0,0,0,0,0,0,0,27000,0,0,0,27000,0,27000,27000
055687,瀚宇博凱基97購01,0,0,0,0,0,0,0,0,0,27000,0,0,0,37000,10000,27000,27000
055615,宏達電國票99購02,0,0,0,0,0,0,0,0,0,27000,0,0,0,65000,38000,27000,27000
055727,矽力元大97購02  ,0,0,0,0,0,0,0,0,0,27000,0,0,0,29000,2000,27000,27000
058192,訊芯永豐99購01  ,0,0,0,0,0,0,0,0,0,27000,0,0,0,66000,39000,27000,27000
055989,矽力元富9A購01  ,0,0,0,0,0,0,0,0,0,27000,0,0,0,27000,0,27000,27000
057740,茂林富邦9A購01  ,0,0,0,0,0,0,0,0,0,27000,0,0,0,105000,78000,27000,27000
2426,鼎元            ,194000,167000,27000,0,0,0,0,0,0,0,0,0,0,0,0,0,27000
2390,云辰            ,140000,125000,15000,0,0,0,0,0,0,12000,12000,0,12000,0,0,0,27000
2206,三陽工業        ,236000,199000,37000,0,0,0,0,0,0,-10000,0,10000,-10000,0,0,0,27000
2887E,台新戊特        ,0,0,0,0,0,0,0,0,0,27000,27000,0,27000,0,0,0,27000
07713P,台郡元大9A售03  ,0,0,0,0,0,0,0,0,0,27000,0,0,0,52000,25000,27000,27000
1110,東泥            ,28000,1000,27000,0,0,0,0,0,0,0,0,0,0,0,0,0,27000
07472P,和碩元大9A售03  ,0,0,0,0,0,0,0,0,0,27000,0,0,0,27000,0,27000,27000
8103,瀚荃            ,27000,0,27000,0,0,0,0,0,0,0,0,0,0,0,0,0,27000
1340,勝悅-KY         ,41001,15000,26001,0,0,0,0,0,0,0,0,0,0,0,0,0,26001
06622P,牧德元大98售01  ,0,0,0,0,0,0,0,0,0,26000,0,0,0,76000,50000,26000,26000
06386P,欣興永豐97售03  ,0,0,0,0,0,0,0,0,0,26000,0,0,0,26000,0,26000,26000
06461P,玉晶光國泰9A售01,0,0,0,0,0,0,0,0,0,26000,0,0,0,31000,5000,26000,26000
061205,旺宏元大9A購11  ,0,0,0,0,0,0,0,0,0,26000,0,0,0,42000,16000,26000,26000
060931,GIS永豐9A購01   ,0,0,0,0,0,0,0,0,0,26000,0,0,0,58000,32000,26000,26000
061053,國巨群益9A購08  ,0,0,0,0,0,0,0,0,0,26000,0,0,0,248000,222000,26000,26000
059591,台積電元大9A購04,0,0,0,0,0,0,0,0,0,26000,0,0,0,26000,0,26000,26000
060347,大立光統一02購01,0,0,0,0,0,0,0,0,0,26000,0,0,0,36000,10000,26000,26000
06018P,康控凱基96售03  ,0,0,0,0,0,0,0,0,0,26000,0,0,0,30000,4000,26000,26000
053120,復盛中信9A購01  ,0,0,0,0,0,0,0,0,0,26000,0,0,0,26000,0,26000,26000
053489,上銀兆豐97購01  ,0,0,0,0,0,0,0,0,0,26000,0,0,0,80000,54000,26000,26000
053709,台達電凱基96購04,0,0,0,0,0,0,0,0,0,26000,0,0,0,31000,5000,26000,26000
050142,聯發科元富9A購01,0,0,0,0,0,0,0,0,0,26000,0,0,0,26000,0,26000,26000
00713,元大台灣高息低波,43000,1000,42000,0,0,0,0,0,0,-16000,0,0,0,4000,20000,-16000,26000
051077,台郡國泰96購02  ,0,0,0,0,0,0,0,0,0,26000,0,0,0,26000,0,26000,26000
050890,南電富邦99購01  ,0,0,0,0,0,0,0,0,0,26000,0,0,0,26000,0,26000,26000
051985,智邦元大95購05  ,0,0,0,0,0,0,0,0,0,26000,0,0,0,36000,10000,26000,26000
057690,美律凱基99購03  ,0,0,0,0,0,0,0,0,0,26000,0,0,0,44000,18000,26000,26000
058508,聯發科元大99購11,0,0,0,0,0,0,0,0,0,26000,0,0,0,40000,14000,26000,26000
058748,景碩凱基9A購01  ,0,0,0,0,0,0,0,0,0,26000,0,0,0,96000,70000,26000,26000
058203,信邦凱基99購01  ,0,0,0,0,0,0,0,0,0,26000,0,0,0,61000,35000,26000,26000
058268,泰碩永豐9A購01  ,0,0,0,0,0,0,0,0,0,26000,0,0,0,30000,4000,26000,26000
057164,國巨元大98購14  ,0,0,0,0,0,0,0,0,0,26000,0,0,0,55000,29000,26000,26000
1436,華友聯          ,25000,0,25000,0,0,0,0,0,0,1000,1000,0,1000,0,0,0,26000
1452,宏益            ,63000,37000,26000,0,0,0,0,0,0,0,0,0,0,0,0,0,26000
2012,春雨            ,26000,0,26000,0,0,0,0,0,0,0,0,0,0,0,0,0,26000
2911,麗嬰房          ,28000,2000,26000,0,0,0,0,0,0,0,0,0,0,0,0,0,26000
2415,錩新            ,27000,1000,26000,0,0,0,0,0,0,0,0,0,0,0,0,0,26000
07421P,國泰金元大99售01,0,0,0,0,0,0,0,0,0,26000,0,0,0,149000,123000,26000,26000
8114,振樺電          ,36000,10000,26000,0,0,0,0,0,0,0,0,0,0,0,0,0,26000
8374,羅昇            ,26000,0,26000,0,0,0,0,0,0,0,0,0,0,0,0,0,26000
060460,鴻海元大9A購08  ,0,0,0,0,0,0,0,0,0,25000,0,0,0,60000,35000,25000,25000
060024,T50反1國泰9B購02,0,0,0,0,0,0,0,0,0,25000,0,0,0,30000,5000,25000,25000
059248,華新科凱基99購04,0,0,0,0,0,0,0,0,0,25000,0,0,0,25000,0,25000,25000
060661,台積電凱基9A購18,0,0,0,0,0,0,0,0,0,25000,0,0,0,25000,0,25000,25000
06328P,台積電中信01售02,0,0,0,0,0,0,0,0,0,25000,0,0,0,150000,125000,25000,25000
052125,群創國票95購02  ,0,0,0,0,0,0,0,0,0,25000,0,0,0,25000,0,25000,25000
051159,力山元大96購01  ,0,0,0,0,0,0,0,0,0,25000,0,0,0,26000,1000,25000,25000
052563,京元電日盛96購01,0,0,0,0,0,0,0,0,0,25000,0,0,0,25000,0,25000,25000
051524,貿聯凱基95購02  ,0,0,0,0,0,0,0,0,0,25000,0,0,0,25000,0,25000,25000
047421,聯茂富邦97購01  ,0,0,0,0,0,0,0,0,0,25000,0,0,0,49000,24000,25000,25000
00684R,元大美元指數反1 ,0,0,0,0,0,0,0,0,0,25000,0,0,0,58000,33000,25000,25000
048001,中工元大96購01  ,0,0,0,0,0,0,0,0,0,25000,0,0,0,25000,0,25000,25000
048186,元黃金元大96購01,0,0,0,0,0,0,0,0,0,25000,0,0,0,25000,0,25000,25000
050188,貿聯元大96購01  ,0,0,0,0,0,0,0,0,0,25000,0,0,0,25000,0,25000,25000
04947P,聯詠元大94售05  ,0,0,0,0,0,0,0,0,0,25000,0,0,0,25000,0,25000,25000
055348,旺宏凱基97購01  ,0,0,0,0,0,0,0,0,0,25000,0,0,0,44000,19000,25000,25000
05540P,亞德客凱基96售01,0,0,0,0,0,0,0,0,0,25000,0,0,0,25000,0,25000,25000
055416,欣興富邦98購01  ,0,0,0,0,0,0,0,0,0,25000,0,0,0,25000,0,25000,25000
053483,嘉澤第一96購01  ,0,0,0,0,0,0,0,0,0,25000,0,0,0,25000,0,25000,25000
054053,聯茂元大96購01  ,0,0,0,0,0,0,0,0,0,25000,0,0,0,75000,50000,25000,25000
052832,益航群益96購01  ,0,0,0,0,0,0,0,0,0,25000,0,0,0,25000,0,25000,25000
054484,仁寶台新96購01  ,0,0,0,0,0,0,0,0,0,25000,0,0,0,25000,0,25000,25000
052914,奇力新元富96購01,0,0,0,0,0,0,0,0,0,25000,0,0,0,25000,0,25000,25000
057477,智邦元大98購09  ,0,0,0,0,0,0,0,0,0,25000,0,0,0,29000,4000,25000,25000
057207,立積元富98購02  ,0,0,0,0,0,0,0,0,0,25000,0,0,0,901000,876000,25000,25000
055791,臺股指凱基97購14,0,0,0,0,0,0,0,0,0,25000,0,0,0,25000,0,25000,25000
058736,鈺齊永豐99購02  ,0,0,0,0,0,0,0,0,0,25000,0,0,0,30000,5000,25000,25000
058470,台灣50日盛9B購02,0,0,0,0,0,0,0,0,0,25000,0,0,0,45000,20000,25000,25000
057958,禾伸堂元大99購05,0,0,0,0,0,0,0,0,0,25000,0,0,0,337000,312000,25000,25000
055953,上銀元大97購09  ,0,0,0,0,0,0,0,0,0,25000,0,0,0,50000,25000,25000,25000
055958,台光電元大97購02,0,0,0,0,0,0,0,0,0,25000,0,0,0,25000,0,25000,25000
057057,立積元大9A購01  ,0,0,0,0,0,0,0,0,0,25000,0,0,0,41000,16000,25000,25000
6581,鋼聯            ,30000,5000,25000,0,0,0,0,0,0,0,0,0,0,0,0,0,25000
4540,全球傳動        ,180000,155000,25000,0,0,0,0,0,0,0,0,0,0,0,0,0,25000
5258,虹堡            ,33000,6000,27000,0,0,0,0,0,0,-2000,0,2000,-2000,0,0,0,25000
4766,南寶            ,20000,4000,16000,0,0,0,0,0,0,9000,0,0,0,9000,0,9000,25000
07412P,國巨元大99售32  ,0,0,0,0,0,0,0,0,0,25000,0,0,0,65000,40000,25000,25000
07413P,國巨元大99售33  ,0,0,0,0,0,0,0,0,0,25000,0,0,0,95000,70000,25000,25000
07305P,T50正2群益99售02,0,0,0,0,0,0,0,0,0,25000,0,0,0,45000,20000,25000,25000
06996P,臺股指凱基99售17,0,0,0,0,0,0,0,0,0,25000,0,0,0,35000,10000,25000,25000
3027,盛達            ,29000,4000,25000,0,0,0,0,0,0,0,0,0,0,0,0,0,25000
1783,和康生          ,89000,64000,25000,0,0,0,0,0,0,0,0,0,0,0,0,0,25000
2548,華固            ,277000,289582,-12582,0,0,0,0,0,0,37000,45000,8000,37000,0,0,0,24418
061208,聯發科元大9A購09,0,0,0,0,0,0,0,0,0,24000,0,0,0,492000,468000,24000,24000
060800,華新科第一9A購01,0,0,0,0,0,0,0,0,0,24000,0,0,0,44000,20000,24000,24000
059383,台灣50凱基99購03,0,0,0,0,0,0,0,0,0,24000,0,0,0,24000,0,24000,24000
059970,台灣50元大9B購07,0,0,0,0,0,0,0,0,0,24000,0,0,0,36000,12000,24000,24000
060188,華新科元富9A購03,0,0,0,0,0,0,0,0,0,24000,0,0,0,96000,72000,24000,24000
054104,T50反1凱基9A購02,0,0,0,0,0,0,0,0,0,24000,0,0,0,30000,6000,24000,24000
053173,矽格群益97購01  ,0,0,0,0,0,0,0,0,0,24000,0,0,0,58000,34000,24000,24000
055408,力成國泰98購01  ,0,0,0,0,0,0,0,0,0,24000,0,0,0,26000,2000,24000,24000
050252,聯發科國泰95購01,0,0,0,0,0,0,0,0,0,24000,0,0,0,24000,0,24000,24000
05145P,道瓊反元大98售01,0,0,0,0,0,0,0,0,0,24000,0,0,0,24000,0,24000,24000
055834,國巨元大97購13  ,0,0,0,0,0,0,0,0,0,24000,0,0,0,165000,141000,24000,24000
057963,緯穎元大98購08  ,0,0,0,0,0,0,0,0,0,24000,0,0,0,32000,8000,24000,24000
057819,新日興元大99購01,0,0,0,0,0,0,0,0,0,24000,0,0,0,74000,50000,24000,24000
057808,旺宏元大99購05  ,0,0,0,0,0,0,0,0,0,24000,0,0,0,94000,70000,24000,24000
058924,晶相光元富99購02,0,0,0,0,0,0,0,0,0,24000,0,0,0,184000,160000,24000,24000
057302,福懋科中信98購01,0,0,0,0,0,0,0,0,0,24000,0,0,0,24000,0,24000,24000
055559,大立光凱基97購09,0,0,0,0,0,0,0,0,0,24000,0,0,0,24000,0,24000,24000
055587,智邦元大97購02  ,0,0,0,0,0,0,0,0,0,24000,0,0,0,44000,20000,24000,24000
06850P,聯茂元大98售06  ,0,0,0,0,0,0,0,0,0,24000,0,0,0,24000,0,24000,24000
06783P,亞光元大98售03  ,0,0,0,0,0,0,0,0,0,24000,0,0,0,24000,0,24000,24000
07312P,台灣50元大99售10,0,0,0,0,0,0,0,0,0,24000,0,0,0,157000,133000,24000,24000
07680P,鴻海凱基9A售24  ,0,0,0,0,0,0,0,0,0,24000,0,0,0,24000,0,24000,24000
07695P,台郡元大9A售02  ,0,0,0,0,0,0,0,0,0,24000,0,0,0,24000,0,24000,24000
4572,駐龍            ,26000,2000,24000,0,0,0,0,0,0,0,0,0,0,0,0,0,24000
4144,康聯-KY         ,26000,2000,24000,0,0,0,0,0,0,0,0,0,0,0,0,0,24000
060463,台積電元大9A購10,0,0,0,0,0,0,0,0,0,23000,0,0,0,78000,55000,23000,23000
059256,臺股指凱基99購34,0,0,0,0,0,0,0,0,0,23000,0,0,0,68000,45000,23000,23000
059113,群光永豐99購01  ,0,0,0,0,0,0,0,0,0,23000,0,0,0,23000,0,23000,23000
059611,台積電永豐99購05,0,0,0,0,0,0,0,0,0,23000,0,0,0,23000,0,23000,23000
059517,茂林永豐99購02  ,0,0,0,0,0,0,0,0,0,23000,0,0,0,23000,0,23000,23000
060882,大立光中信9A購05,0,0,0,0,0,0,0,0,0,23000,0,0,0,30000,7000,23000,23000
06447P,上銀元大98售01  ,0,0,0,0,0,0,0,0,0,23000,0,0,0,23000,0,23000,23000
052488,旺宏國票96購03  ,0,0,0,0,0,0,0,0,0,23000,0,0,0,28000,5000,23000,23000
052586,晶豪科永豐96購01,0,0,0,0,0,0,0,0,0,23000,0,0,0,35000,12000,23000,23000
052227,瑞昱凱基95購05  ,0,0,0,0,0,0,0,0,0,23000,0,0,0,53000,30000,23000,23000
057524,旺宏元大99購04  ,0,0,0,0,0,0,0,0,0,23000,0,0,0,54000,31000,23000,23000
055319,國巨國票98購03  ,0,0,0,0,0,0,0,0,0,23000,0,0,0,43000,20000,23000,23000
055305,旺宏群益99購01  ,0,0,0,0,0,0,0,0,0,23000,0,0,0,28000,5000,23000,23000
056511,超眾永豐98購01  ,0,0,0,0,0,0,0,0,0,23000,0,0,0,23000,0,23000,23000
053134,南亞科國票97購01,0,0,0,0,0,0,0,0,0,23000,0,0,0,97000,74000,23000,23000
05471P,聯電統一95售01  ,0,0,0,0,0,0,0,0,0,23000,0,0,0,26000,3000,23000,23000
054771,茂林國票98購02  ,0,0,0,0,0,0,0,0,0,23000,0,0,0,104000,81000,23000,23000
054872,瀚宇博群益98購01,0,0,0,0,0,0,0,0,0,23000,0,0,0,67000,44000,23000,23000
054830,世芯國泰99購01  ,0,0,0,0,0,0,0,0,0,23000,0,0,0,105000,82000,23000,23000
055112,晶豪科凱基98購01,0,0,0,0,0,0,0,0,0,23000,0,0,0,89000,66000,23000,23000
057955,技嘉元大98購07  ,0,0,0,0,0,0,0,0,0,23000,0,0,0,160000,137000,23000,23000
055813,聯發科國票98購04,0,0,0,0,0,0,0,0,0,23000,0,0,0,48000,25000,23000,23000
4438,廣越            ,35000,13000,22000,0,0,0,0,0,0,1000,1000,0,1000,0,0,0,23000
3617,碩天            ,43000,20000,23000,0,0,0,0,0,0,0,0,0,0,0,0,0,23000
6128,上福            ,25000,2000,23000,0,0,0,0,0,0,0,0,0,0,0,0,0,23000
07652P,臺股指中信9A售07,0,0,0,0,0,0,0,0,0,23000,0,0,0,275000,252000,23000,23000
2852,第一保          ,50000,25000,25000,0,0,0,0,0,0,-2000,0,2000,-2000,0,0,0,23000
06726P,欣興元富98售04  ,0,0,0,0,0,0,0,0,0,22000,0,0,0,23000,1000,22000,22000
059437,京鼎元大99購02  ,0,0,0,0,0,0,0,0,0,22000,0,0,0,24000,2000,22000,22000
059323,新日興元大99購02,0,0,0,0,0,0,0,0,0,22000,0,0,0,28000,6000,22000,22000
060407,南六國泰9C購01  ,0,0,0,0,0,0,0,0,0,22000,0,0,0,22000,0,22000,22000
054831,緯穎國泰98購01  ,0,0,0,0,0,0,0,0,0,22000,0,0,0,32000,10000,22000,22000
054091,晶豪科群益96購01,0,0,0,0,0,0,0,0,0,22000,0,0,0,82000,60000,22000,22000
05452P,亞德客群益95售02,0,0,0,0,0,0,0,0,0,22000,0,0,0,22000,0,22000,22000
05121P,創意國泰96售01  ,0,0,0,0,0,0,0,0,0,22000,0,0,0,22000,0,22000,22000
05905P,晶技統一97售01  ,0,0,0,0,0,0,0,0,0,22000,0,0,0,22000,0,22000,22000
059055,旺宏凱基9B購02  ,0,0,0,0,0,0,0,0,0,22000,0,0,0,27000,5000,22000,22000
058271,訊連永豐99購01  ,0,0,0,0,0,0,0,0,0,22000,0,0,0,150000,128000,22000,22000
058027,鴻海富邦98購04  ,0,0,0,0,0,0,0,0,0,22000,0,0,0,31000,9000,22000,22000
3021,鴻名            ,22000,0,22000,0,0,0,0,0,0,0,0,0,0,0,0,0,22000
2114,鑫永銓          ,27000,5000,22000,0,0,0,0,0,0,0,0,0,0,0,0,0,22000
1626,艾美特-KY       ,57000,35000,22000,0,0,0,0,0,0,0,0,0,0,0,0,0,22000
07722P,玉晶光凱基9A售10,0,0,0,0,0,0,0,0,0,22000,0,0,0,25000,3000,22000,22000
07547P,緯穎凱基9A售05  ,0,0,0,0,0,0,0,0,0,22000,0,0,0,23000,1000,22000,22000
07561P,玉晶光永豐9A售02,0,0,0,0,0,0,0,0,0,22000,0,0,0,52000,30000,22000,22000
06928P,鴻海元大99售10  ,0,0,0,0,0,0,0,0,0,22000,0,0,0,59000,37000,22000,22000
07104P,聯發科元富99售04,0,0,0,0,0,0,0,0,0,22000,0,0,0,23000,1000,22000,22000
6206,飛捷            ,86000,64000,22000,0,0,0,0,0,0,0,0,0,0,0,0,0,22000
4536,拓凱            ,152000,30000,122000,0,0,0,0,100000,-100000,0,0,0,0,0,0,0,22000
059500,鴻海元富99購11  ,0,0,0,0,0,0,0,0,0,21000,0,0,0,35000,14000,21000,21000
059787,奇力新元大9A購02,0,0,0,0,0,0,0,0,0,21000,0,0,0,41000,20000,21000,21000
060828,高股息國票9A購01,0,0,0,0,0,0,0,0,0,21000,0,0,0,31000,10000,21000,21000
060951,元黃金群益9A購01,0,0,0,0,0,0,0,0,0,21000,0,0,0,41000,20000,21000,21000
052180,緯穎元大96購05  ,0,0,0,0,0,0,0,0,0,21000,0,0,0,52000,31000,21000,21000
051623,和碩凱基96購02  ,0,0,0,0,0,0,0,0,0,21000,0,0,0,21000,0,21000,21000
052231,景碩凱基96購01  ,0,0,0,0,0,0,0,0,0,21000,0,0,0,31000,10000,21000,21000
03033X,元展30          ,0,0,0,0,0,0,0,0,0,21000,0,0,0,23000,2000,21000,21000
053809,上銀群益96購02  ,0,0,0,0,0,0,0,0,0,21000,0,0,0,21000,0,21000,21000
057150,貿聯國票99購02  ,0,0,0,0,0,0,0,0,0,21000,0,0,0,21000,0,21000,21000
055617,TPK國票98購04   ,0,0,0,0,0,0,0,0,0,21000,0,0,0,21000,0,21000,21000
055590,聯發科元大98購02,0,0,0,0,0,0,0,0,0,21000,0,0,0,21000,0,21000,21000
058371,智原凱基9A購01  ,0,0,0,0,0,0,0,0,0,21000,0,0,0,21000,0,21000,21000
055094,智易群益98購01  ,0,0,0,0,0,0,0,0,0,21000,0,0,0,21000,0,21000,21000
058795,可成元大99購03  ,0,0,0,0,0,0,0,0,0,21000,0,0,0,21000,0,21000,21000
058571,緯穎凱基9A購02  ,0,0,0,0,0,0,0,0,0,21000,0,0,0,21000,0,21000,21000
055862,矽力元大97購04  ,0,0,0,0,0,0,0,0,0,21000,0,0,0,31000,10000,21000,21000
056195,群創富邦98購01  ,0,0,0,0,0,0,0,0,0,21000,0,0,0,21000,0,21000,21000
056392,玉晶光富邦9C購01,0,0,0,0,0,0,0,0,0,21000,0,0,0,21000,0,21000,21000
3591,艾笛森          ,21000,0,21000,0,0,0,0,0,0,0,0,0,0,0,0,0,21000
3257,虹冠電          ,22000,2000,20000,0,0,0,0,0,0,1000,1000,0,1000,0,0,0,21000
3055,蔚華科          ,21000,0,21000,0,0,0,0,0,0,0,0,0,0,0,0,0,21000
8473,山林水          ,28000,8000,20000,0,0,0,0,0,0,1000,3000,2000,1000,0,0,0,21000
9955,佳龍            ,43000,22000,21000,0,0,0,0,0,0,0,0,0,0,0,0,0,21000
07150P,和碩元大99售01  ,0,0,0,0,0,0,0,0,0,21000,0,0,0,21000,0,21000,21000
07130P,台郡元大9B售01  ,0,0,0,0,0,0,0,0,0,21000,0,0,0,101000,80000,21000,21000
07113P,台積電兆豐99售03,0,0,0,0,0,0,0,0,0,21000,0,0,0,41000,20000,21000,21000
07288P,台灣50凱基99售06,0,0,0,0,0,0,0,0,0,21000,0,0,0,27000,6000,21000,21000
07235P,T50正2元大9C售02,0,0,0,0,0,0,0,0,0,21000,0,0,0,57000,36000,21000,21000
07326P,大立光元大99售23,0,0,0,0,0,0,0,0,0,21000,0,0,0,21000,0,21000,21000
2530,華建            ,34000,13000,21000,0,0,0,0,0,0,0,0,0,0,0,0,0,21000
2702,華園            ,47000,26000,21000,0,0,0,0,0,0,0,0,0,0,0,0,0,21000
06090P,旺宏統一97售06  ,0,0,0,0,0,0,0,0,0,20000,0,0,0,20000,0,20000,20000
061095,台積電台新9B購03,0,0,0,0,0,0,0,0,0,20000,0,0,0,25000,5000,20000,20000
060521,鴻海中信01購03  ,0,0,0,0,0,0,0,0,0,20000,0,0,0,20000,0,20000,20000
06742P,可成富邦99售02  ,0,0,0,0,0,0,0,0,0,20000,0,0,0,40000,20000,20000,20000
06659P,T50正2富邦9A售01,0,0,0,0,0,0,0,0,0,20000,0,0,0,20000,0,20000,20000
06613P,華新科富邦9A售03,0,0,0,0,0,0,0,0,0,20000,0,0,0,20000,0,20000,20000
06489P,台積電元富98售06,0,0,0,0,0,0,0,0,0,20000,0,0,0,20000,0,20000,20000
06502P,A50中信98售01   ,0,0,0,0,0,0,0,0,0,20000,0,0,0,20000,0,20000,20000
06200P,聯發科元大97售18,0,0,0,0,0,0,0,0,0,20000,0,0,0,20000,0,20000,20000
061220,臺股指元大9A購57,0,0,0,0,0,0,0,0,0,20000,0,0,0,20000,0,20000,20000
06124P,超眾元大97售03  ,0,0,0,0,0,0,0,0,0,20000,0,0,0,20000,0,20000,20000
061396,台灣50台新9C購03,0,0,0,0,0,0,0,0,0,20000,0,0,0,60000,40000,20000,20000
05964P,華通凱基96售06  ,0,0,0,0,0,0,0,0,0,20000,0,0,0,20000,0,20000,20000
059486,A50正2兆豐9A購01,0,0,0,0,0,0,0,0,0,20000,0,0,0,20000,0,20000,20000
059577,旺宏元富99購04  ,0,0,0,0,0,0,0,0,0,20000,0,0,0,20000,0,20000,20000
059354,臺指反富邦9B購01,0,0,0,0,0,0,0,0,0,20000,0,0,0,20000,0,20000,20000
059384,上証2X凱基9B購01,0,0,0,0,0,0,0,0,0,20000,0,0,0,20000,0,20000,20000
059393,臺股指凱基99購39,0,0,0,0,0,0,0,0,0,20000,0,0,0,20000,0,20000,20000
059260,國巨中信99購05  ,0,0,0,0,0,0,0,0,0,20000,0,0,0,40000,20000,20000,20000
059205,元石油元大99購01,0,0,0,0,0,0,0,0,0,20000,0,0,0,20000,0,20000,20000
060427,聯茂永豐9A購01  ,0,0,0,0,0,0,0,0,0,20000,0,0,0,20000,0,20000,20000
060346,華新科統一01購01,0,0,0,0,0,0,0,0,0,20000,0,0,0,20000,0,20000,20000
060373,元金2X元富9A購01,0,0,0,0,0,0,0,0,0,20000,0,0,0,23000,3000,20000,20000
060066,欣興兆豐9B購01  ,0,0,0,0,0,0,0,0,0,20000,0,0,0,46000,26000,20000,20000
060075,台積電元富99購05,0,0,0,0,0,0,0,0,0,20000,0,0,0,20000,0,20000,20000
053799,矽創中信9A購01  ,0,0,0,0,0,0,0,0,0,20000,0,0,0,20000,0,20000,20000
053734,友達中信98購02  ,0,0,0,0,0,0,0,0,0,20000,0,0,0,20000,0,20000,20000
05320P,華通凱基96售03  ,0,0,0,0,0,0,0,0,0,20000,0,0,0,20000,0,20000,20000
053239,崇越永豐96購01  ,0,0,0,0,0,0,0,0,0,20000,0,0,0,20000,0,20000,20000
053286,臺股指元大96購14,0,0,0,0,0,0,0,0,0,20000,0,0,0,20000,0,20000,20000
054325,奇力新台新97購03,0,0,0,0,0,0,0,0,0,20000,0,0,0,20000,0,20000,20000
054268,健策第一96購01  ,0,0,0,0,0,0,0,0,0,20000,0,0,0,20000,0,20000,20000
054217,台表科國票97購05,0,0,0,0,0,0,0,0,0,20000,0,0,0,20000,0,20000,20000
054192,國巨中信98購01  ,0,0,0,0,0,0,0,0,0,20000,0,0,0,520000,500000,20000,20000
052836,旺宏國泰98購01  ,0,0,0,0,0,0,0,0,0,20000,0,0,0,34000,14000,20000,20000
052807,貿聯元大98購01  ,0,0,0,0,0,0,0,0,0,20000,0,0,0,20000,0,20000,20000
052782,超眾國票96購02  ,0,0,0,0,0,0,0,0,0,20000,0,0,0,20000,0,20000,20000
052750,臺股指元大96購04,0,0,0,0,0,0,0,0,0,20000,0,0,0,20000,0,20000,20000
054871,明泰群益98購01  ,0,0,0,0,0,0,0,0,0,20000,0,0,0,20000,0,20000,20000
052870,玉晶光凱基96購03,0,0,0,0,0,0,0,0,0,20000,0,0,0,20000,0,20000,20000
052855,群創日盛99購01  ,0,0,0,0,0,0,0,0,0,20000,0,0,0,20000,0,20000,20000
054609,正崴永豐97購01  ,0,0,0,0,0,0,0,0,0,20000,0,0,0,20000,0,20000,20000
053374,台達電元大96購03,0,0,0,0,0,0,0,0,0,20000,0,0,0,20000,0,20000,20000
055304,瑞昱第一98購01  ,0,0,0,0,0,0,0,0,0,20000,0,0,0,20000,0,20000,20000
03267P,台灣50元大02售06,0,0,0,0,0,0,0,0,0,20000,0,0,0,20000,0,20000,20000
052242,台達電台新96購01,0,0,0,0,0,0,0,0,0,20000,0,0,0,20000,0,20000,20000
049238,元油2X元富96購08,0,0,0,0,0,0,0,0,0,20000,0,0,0,20000,0,20000,20000
049842,道瓊反中信98購01,0,0,0,0,0,0,0,0,0,20000,0,0,0,20000,0,20000,20000
049843,康友中信95購01  ,0,0,0,0,0,0,0,0,0,20000,0,0,0,20000,0,20000,20000
048248,聯發科兆豐95購01,0,0,0,0,0,0,0,0,0,20000,0,0,0,20000,0,20000,20000
048798,華新科國泰95購01,0,0,0,0,0,0,0,0,0,20000,0,0,0,20000,0,20000,20000
049065,T50反1凱基96購04,0,0,0,0,0,0,0,0,0,20000,0,0,0,20000,0,20000,20000
04346P,大立光兆豐95售02,0,0,0,0,0,0,0,0,0,20000,0,0,0,20000,0,20000,20000
04578P,微星富邦96售01  ,0,0,0,0,0,0,0,0,0,20000,0,0,0,20000,0,20000,20000
052430,泰碩永豐95購02  ,0,0,0,0,0,0,0,0,0,20000,0,0,0,20000,0,20000,20000
052344,台表科凱基98購01,0,0,0,0,0,0,0,0,0,20000,0,0,0,20000,0,20000,20000
052120,友達國票96購01  ,0,0,0,0,0,0,0,0,0,20000,0,0,0,20000,0,20000,20000
051590,玉晶光元大96購02,0,0,0,0,0,0,0,0,0,20000,0,0,0,20000,0,20000,20000
051598,瑞昱兆豐95購01  ,0,0,0,0,0,0,0,0,0,20000,0,0,0,20000,0,20000,20000
052585,友達永豐97購01  ,0,0,0,0,0,0,0,0,0,20000,0,0,0,90000,70000,20000,20000
052670,茂林群益96購02  ,0,0,0,0,0,0,0,0,0,20000,0,0,0,20000,0,20000,20000
052174,聯發科元大95購13,0,0,0,0,0,0,0,0,0,20000,0,0,0,20000,0,20000,20000
052176,景碩元大96購01  ,0,0,0,0,0,0,0,0,0,20000,0,0,0,20000,0,20000,20000
052195,健策元富95購01  ,0,0,0,0,0,0,0,0,0,20000,0,0,0,20000,0,20000,20000
052069,聯茂兆豐96購01  ,0,0,0,0,0,0,0,0,0,20000,0,0,0,20000,0,20000,20000
051950,旺宏元富95購02  ,0,0,0,0,0,0,0,0,0,20000,0,0,0,20000,0,20000,20000
051947,矽力統一95購01  ,0,0,0,0,0,0,0,0,0,20000,0,0,0,20000,0,20000,20000
051011,國巨凱基95購03  ,0,0,0,0,0,0,0,0,0,20000,0,0,0,20000,0,20000,20000
050994,欣興元大96購03  ,0,0,0,0,0,0,0,0,0,20000,0,0,0,20000,0,20000,20000
050793,大立光富邦96購03,0,0,0,0,0,0,0,0,0,20000,0,0,0,20000,0,20000,20000
056399,上証2X群益9C購01,0,0,0,0,0,0,0,0,0,20000,0,0,0,20000,0,20000,20000
056374,聯發科統一9B購01,0,0,0,0,0,0,0,0,0,20000,0,0,0,20000,0,20000,20000
056354,國巨元大98購10  ,0,0,0,0,0,0,0,0,0,20000,0,0,0,136000,116000,20000,20000
056470,旺宏元大99購01  ,0,0,0,0,0,0,0,0,0,20000,0,0,0,20000,0,20000,20000
058560,T50反1凱基9A購04,0,0,0,0,0,0,0,0,0,20000,0,0,0,20000,0,20000,20000
058523,聯茂元大99購08  ,0,0,0,0,0,0,0,0,0,20000,0,0,0,20000,0,20000,20000
05851P,力山群益97售01  ,0,0,0,0,0,0,0,0,0,20000,0,0,0,20000,0,20000,20000
058669,上銀群益99購01  ,0,0,0,0,0,0,0,0,0,20000,0,0,0,50000,30000,20000,20000
057942,可成國票99購02  ,0,0,0,0,0,0,0,0,0,20000,0,0,0,40000,20000,20000,20000
057994,技嘉中信98購01  ,0,0,0,0,0,0,0,0,0,20000,0,0,0,20000,0,20000,20000
057776,京元電群益98購02,0,0,0,0,0,0,0,0,0,20000,0,0,0,21000,1000,20000,20000
058809,國巨統一9B購03  ,0,0,0,0,0,0,0,0,0,20000,0,0,0,20000,0,20000,20000
058892,元油2X元大9C購08,0,0,0,0,0,0,0,0,0,20000,0,0,0,100000,80000,20000,20000
059073,元油2X元大9C購14,0,0,0,0,0,0,0,0,0,20000,0,0,0,20000,0,20000,20000
05890P,彩晶元大99售01  ,0,0,0,0,0,0,0,0,0,20000,0,0,0,20000,0,20000,20000
058936,國喬中信99購01  ,0,0,0,0,0,0,0,0,0,20000,0,0,0,70000,50000,20000,20000
055080,正崴中信99購01  ,0,0,0,0,0,0,0,0,0,20000,0,0,0,20000,0,20000,20000
055062,文曄永豐97購01  ,0,0,0,0,0,0,0,0,0,20000,0,0,0,20000,0,20000,20000
055227,聯發科國票98購02,0,0,0,0,0,0,0,0,0,20000,0,0,0,20000,0,20000,20000
055277,旺宏元大97購04  ,0,0,0,0,0,0,0,0,0,20000,0,0,0,20000,0,20000,20000
057650,力成元大98購04  ,0,0,0,0,0,0,0,0,0,20000,0,0,0,97000,77000,20000,20000
056782,鴻海群益98購04  ,0,0,0,0,0,0,0,0,0,20000,0,0,0,20000,0,20000,20000
058338,康友元富99購01  ,0,0,0,0,0,0,0,0,0,20000,0,0,0,20000,0,20000,20000
058260,華新科富邦9C購01,0,0,0,0,0,0,0,0,0,20000,0,0,0,20000,0,20000,20000
055599,TPK元大97購01   ,0,0,0,0,0,0,0,0,0,20000,0,0,0,20000,0,20000,20000
056676,國產元富98購01  ,0,0,0,0,0,0,0,0,0,20000,0,0,0,20000,0,20000,20000
057294,台灣50永豐99購01,0,0,0,0,0,0,0,0,0,20000,0,0,0,20000,0,20000,20000
057221,華通國票98購03  ,0,0,0,0,0,0,0,0,0,20000,0,0,0,54000,34000,20000,20000
2546,根基            ,31000,12000,19000,0,0,0,0,0,0,1000,1000,0,1000,0,0,0,20000
2468,華經            ,23000,3000,20000,0,0,0,0,0,0,0,0,0,0,0,0,0,20000
2495,普安            ,29000,9000,20000,0,0,0,0,0,0,0,0,0,0,0,0,0,20000
1416,廣豐            ,24000,4000,20000,0,0,0,0,0,0,0,0,0,0,0,0,0,20000
07348P,滬深2X凱基9A售04,0,0,0,0,0,0,0,0,0,20000,0,0,0,20000,0,20000,20000
07383P,聯發科群益99售06,0,0,0,0,0,0,0,0,0,20000,0,0,0,40000,20000,20000,20000
07678P,大立光群益9A售03,0,0,0,0,0,0,0,0,0,20000,0,0,0,20000,0,20000,20000
07666P,台灣50元大9C售32,0,0,0,0,0,0,0,0,0,20000,0,0,0,20000,0,20000,20000
07221P,臺股指中信9B售04,0,0,0,0,0,0,0,0,0,20000,0,0,0,30000,10000,20000,20000
07098P,台積電元大99售18,0,0,0,0,0,0,0,0,0,20000,0,0,0,20000,0,20000,20000
07062P,台積電元大99售15,0,0,0,0,0,0,0,0,0,20000,0,0,0,20000,0,20000,20000
06813P,友訊元富98售03  ,0,0,0,0,0,0,0,0,0,20000,0,0,0,20000,0,20000,20000
8070,長華*           ,32000,14000,18000,0,0,0,0,0,0,2000,2000,0,2000,0,0,0,20000
6136,富爾特          ,20000,0,20000,0,0,0,0,0,0,0,0,0,0,0,0,0,20000
060462,鴻海元大9A購10  ,0,0,0,0,0,0,0,0,0,19000,0,0,0,49000,30000,19000,19000
059452,全新永豐99購03  ,0,0,0,0,0,0,0,0,0,19000,0,0,0,55000,36000,19000,19000
059491,國巨國票9A購05  ,0,0,0,0,0,0,0,0,0,19000,0,0,0,19000,0,19000,19000
06503P,臺股指中信9A售02,0,0,0,0,0,0,0,0,0,19000,0,0,0,19000,0,19000,19000
06753P,智邦富邦98售03  ,0,0,0,0,0,0,0,0,0,19000,0,0,0,19000,0,19000,19000
060985,聯發科元大9A購06,0,0,0,0,0,0,0,0,0,19000,0,0,0,38000,19000,19000,19000
051721,玉晶光永豐96購02,0,0,0,0,0,0,0,0,0,19000,0,0,0,91000,72000,19000,19000
051872,矽力凱基96購01  ,0,0,0,0,0,0,0,0,0,19000,0,0,0,20000,1000,19000,19000
051847,香港反中信99購01,0,0,0,0,0,0,0,0,0,19000,0,0,0,19000,0,19000,19000
052056,緯穎凱基95購04  ,0,0,0,0,0,0,0,0,0,19000,0,0,0,20000,1000,19000,19000
052611,力成元大96購02  ,0,0,0,0,0,0,0,0,0,19000,0,0,0,129000,110000,19000,19000
048902,昇陽半國泰96購01,0,0,0,0,0,0,0,0,0,19000,0,0,0,19000,0,19000,19000
048187,臺指反元大96購04,0,0,0,0,0,0,0,0,0,19000,0,0,0,19000,0,19000,19000
049252,國巨元大96購01  ,0,0,0,0,0,0,0,0,0,19000,0,0,0,115000,96000,19000,19000
050570,聯發科中信97購02,0,0,0,0,0,0,0,0,0,19000,0,0,0,20000,1000,19000,19000
047211,華新科富邦99購01,0,0,0,0,0,0,0,0,0,19000,0,0,0,24000,5000,19000,19000
05539P,鎧勝永豐96售01  ,0,0,0,0,0,0,0,0,0,19000,0,0,0,19000,0,19000,19000
055457,聚陽永豐97購01  ,0,0,0,0,0,0,0,0,0,19000,0,0,0,19000,0,19000,19000
054302,鴻海凱基96購18  ,0,0,0,0,0,0,0,0,0,19000,0,0,0,37000,18000,19000,19000
054304,台積電凱基96購23,0,0,0,0,0,0,0,0,0,19000,0,0,0,19000,0,19000,19000
058437,可成統一9B購01  ,0,0,0,0,0,0,0,0,0,19000,0,0,0,29000,10000,19000,19000
056881,台灣50康和9A購01,0,0,0,0,0,0,0,0,0,19000,0,0,0,19000,0,19000,19000
055902,同欣電中信99購01,0,0,0,0,0,0,0,0,0,19000,0,0,0,40000,21000,19000,19000
6172,互億            ,44000,25000,19000,0,0,0,0,0,0,0,0,0,0,0,0,0,19000
6184,大豐電          ,34000,15000,19000,0,0,0,0,0,0,0,0,0,0,0,0,0,19000
07059P,華通國票9A售02  ,0,0,0,0,0,0,0,0,0,19000,0,0,0,218000,199000,19000,19000
07705P,台積電元大9A售26,0,0,0,0,0,0,0,0,0,19000,0,0,0,19000,0,19000,19000
1235,興泰            ,19000,0,19000,0,0,0,0,0,0,0,0,0,0,0,0,0,19000
1727,中華化          ,19000,0,19000,0,0,0,0,0,0,0,0,0,0,0,0,0,19000
2429,銘旺科          ,24000,5000,19000,0,0,0,0,0,0,0,0,0,0,0,0,0,19000
060854,台積電富邦9C購08,0,0,0,0,0,0,0,0,0,18000,0,0,0,25000,7000,18000,18000
059541,T50正2康和99購01,0,0,0,0,0,0,0,0,0,18000,0,0,0,20000,2000,18000,18000
059388,國巨凱基99購13  ,0,0,0,0,0,0,0,0,0,18000,0,0,0,19000,1000,18000,18000
060324,台積電群益9B購02,0,0,0,0,0,0,0,0,0,18000,0,0,0,20000,2000,18000,18000
060098,華新科元大99購24,0,0,0,0,0,0,0,0,0,18000,0,0,0,18000,0,18000,18000
059829,超眾凱基99購05  ,0,0,0,0,0,0,0,0,0,18000,0,0,0,69000,51000,18000,18000
053273,國巨元大96購08  ,0,0,0,0,0,0,0,0,0,18000,0,0,0,18000,0,18000,18000
057556,智易凱基99購01  ,0,0,0,0,0,0,0,0,0,18000,0,0,0,53000,35000,18000,18000
053587,京元電元大98購01,0,0,0,0,0,0,0,0,0,18000,0,0,0,19000,1000,18000,18000
046375,友達凱基98購01  ,0,0,0,0,0,0,0,0,0,18000,0,0,0,18000,0,18000,18000
052230,大立光凱基96購09,0,0,0,0,0,0,0,0,0,18000,0,0,0,18000,0,18000,18000
049442,滬深2X統一99購01,0,0,0,0,0,0,0,0,0,18000,0,0,0,18000,0,18000,18000
00714,群益道瓊美國地產,0,150000,-150000,0,0,0,0,0,0,168000,0,0,0,192000,24000,168000,18000
00753L,中信中國50正2   ,278000,105000,173000,0,0,0,0,0,0,-155000,0,0,0,240000,395000,-155000,18000
052362,瑞昱國票96購02  ,0,0,0,0,0,0,0,0,0,18000,0,0,0,18000,0,18000,18000
055846,大立光元大97購09,0,0,0,0,0,0,0,0,0,18000,0,0,0,68000,50000,18000,18000
056892,旺宏元大9A購02  ,0,0,0,0,0,0,0,0,0,18000,0,0,0,18000,0,18000,18000
056116,義隆群益97購02  ,0,0,0,0,0,0,0,0,0,18000,0,0,0,37000,19000,18000,18000
057852,國巨國票99購05  ,0,0,0,0,0,0,0,0,0,18000,0,0,0,18000,0,18000,18000
057656,大成鋼兆豐98購01,0,0,0,0,0,0,0,0,0,18000,0,0,0,322000,304000,18000,18000
055229,大毅國票97購02  ,0,0,0,0,0,0,0,0,0,18000,0,0,0,33000,15000,18000,18000
055506,台郡元大99購02  ,0,0,0,0,0,0,0,0,0,18000,0,0,0,18000,0,18000,18000
2466,冠西電          ,18000,0,18000,0,0,0,0,0,0,0,0,0,0,0,0,0,18000
1432,大魯閣          ,22000,4000,18000,0,0,0,0,0,0,0,0,0,0,0,0,0,18000
07762P,聯發科永豐9A售03,0,0,0,0,0,0,0,0,0,18000,0,0,0,18000,0,18000,18000
07559P,祥碩元大9A售03  ,0,0,0,0,0,0,0,0,0,18000,0,0,0,58000,40000,18000,18000
07131P,緯穎元大99售06  ,0,0,0,0,0,0,0,0,0,18000,0,0,0,18000,0,18000,18000
5706,鳳凰            ,44000,26000,18000,0,0,0,0,0,0,0,0,0,0,0,0,0,18000
8104,錸寶            ,656000,638000,18000,0,0,0,0,0,0,0,0,0,0,0,0,0,18000
059901,滬深2X元大9C購07,0,0,0,0,0,0,0,0,0,17000,0,0,0,21000,4000,17000,17000
059562,上銀凱基99購09  ,0,0,0,0,0,0,0,0,0,17000,0,0,0,25000,8000,17000,17000
059626,台積電凱基01購01,0,0,0,0,0,0,0,0,0,17000,0,0,0,17000,0,17000,17000
059763,華擎永豐99購03  ,0,0,0,0,0,0,0,0,0,17000,0,0,0,32000,15000,17000,17000
061039,台表科永豐9A購03,0,0,0,0,0,0,0,0,0,17000,0,0,0,18000,1000,17000,17000
045444,群創元富98購02  ,0,0,0,0,0,0,0,0,0,17000,0,0,0,147000,130000,17000,17000
04294P,台積電元大95售01,0,0,0,0,0,0,0,0,0,17000,0,0,0,17000,0,17000,17000
04628P,欣興元大95售01  ,0,0,0,0,0,0,0,0,0,17000,0,0,0,207000,190000,17000,17000
04633P,旺宏群益96售04  ,0,0,0,0,0,0,0,0,0,17000,0,0,0,17000,0,17000,17000
053480,祥碩元大96購02  ,0,0,0,0,0,0,0,0,0,17000,0,0,0,77000,60000,17000,17000
054578,世芯元大99購01  ,0,0,0,0,0,0,0,0,0,17000,0,0,0,17000,0,17000,17000
054682,東元永豐97購01  ,0,0,0,0,0,0,0,0,0,17000,0,0,0,17000,0,17000,17000
053280,群創元大9C購01  ,0,0,0,0,0,0,0,0,0,17000,0,0,0,17000,0,17000,17000
057299,立積永豐98購02  ,0,0,0,0,0,0,0,0,0,17000,0,0,0,116000,99000,17000,17000
057118,欣興日盛9A購01  ,0,0,0,0,0,0,0,0,0,17000,0,0,0,17000,0,17000,17000
058451,智邦永豐9A購01  ,0,0,0,0,0,0,0,0,0,17000,0,0,0,17000,0,17000,17000
058462,台積電兆豐99購01,0,0,0,0,0,0,0,0,0,17000,0,0,0,289000,272000,17000,17000
056075,瀚宇博元大97購03,0,0,0,0,0,0,0,0,0,17000,0,0,0,138000,121000,17000,17000
059012,臺股指元大9A購31,0,0,0,0,0,0,0,0,0,17000,0,0,0,17000,0,17000,17000
058905,京鼎元大99購01  ,0,0,0,0,0,0,0,0,0,17000,0,0,0,17000,0,17000,17000
6477,安集            ,26000,9000,17000,0,0,0,0,0,0,0,0,0,0,0,0,0,17000
8411,福貞-KY         ,17000,0,17000,0,0,0,0,0,0,0,0,0,0,0,0,0,17000
4141,龍燈-KY         ,61000,44000,17000,0,0,0,0,0,0,0,0,0,0,0,0,0,17000
07246P,旺宏凱基99售08  ,0,0,0,0,0,0,0,0,0,17000,0,0,0,28000,11000,17000,17000
2462,良得電          ,17000,0,17000,0,0,0,0,0,0,0,0,0,0,0,0,0,17000
2597,潤弘            ,26000,9000,17000,0,0,0,0,0,0,0,0,0,0,0,0,0,17000
2611,志信            ,20000,3000,17000,0,0,0,0,0,0,0,0,0,0,0,0,0,17000
3011,今皓            ,17000,0,17000,0,0,0,0,0,0,0,0,0,0,0,0,0,17000
2904,匯僑            ,18000,1000,17000,0,0,0,0,0,0,0,0,0,0,0,0,0,17000
059596,大立光元大99購20,0,0,0,0,0,0,0,0,0,16000,0,0,0,20000,4000,16000,16000
059531,華新科凱基9B購02,0,0,0,0,0,0,0,0,0,16000,0,0,0,81000,65000,16000,16000
059467,旺宏元大99購15  ,0,0,0,0,0,0,0,0,0,16000,0,0,0,21000,5000,16000,16000
052933,祥碩元大96購01  ,0,0,0,0,0,0,0,0,0,16000,0,0,0,21000,5000,16000,16000
052221,東元凱基95購01  ,0,0,0,0,0,0,0,0,0,16000,0,0,0,16000,0,16000,16000
052223,聯電凱基96購02  ,0,0,0,0,0,0,0,0,0,16000,0,0,0,16000,0,16000,16000
04974P,聯發科凱基96售02,0,0,0,0,0,0,0,0,0,16000,0,0,0,18000,2000,16000,16000
050515,聯電元大96購01  ,0,0,0,0,0,0,0,0,0,16000,0,0,0,16000,0,16000,16000
048270,T50反1富邦99購01,0,0,0,0,0,0,0,0,0,16000,0,0,0,30000,14000,16000,16000
052519,旺宏元大95購05  ,0,0,0,0,0,0,0,0,0,16000,0,0,0,16000,0,16000,16000
052508,矽力日盛95購02  ,0,0,0,0,0,0,0,0,0,16000,0,0,0,16000,0,16000,16000
051323,康控國票96購01  ,0,0,0,0,0,0,0,0,0,16000,0,0,0,16000,0,16000,16000
052005,矽力國泰97購02  ,0,0,0,0,0,0,0,0,0,16000,0,0,0,115000,99000,16000,16000
050651,大立光凱基96購02,0,0,0,0,0,0,0,0,0,16000,0,0,0,69000,53000,16000,16000
058759,義隆群益99購01  ,0,0,0,0,0,0,0,0,0,16000,0,0,0,47000,31000,16000,16000
059021,台積電統一9B購07,0,0,0,0,0,0,0,0,0,16000,0,0,0,16000,0,16000,16000
059078,FBVIX元大99購06 ,0,0,0,0,0,0,0,0,0,16000,0,0,0,18000,2000,16000,16000
059063,康控凱基99購04  ,0,0,0,0,0,0,0,0,0,16000,0,0,0,58000,42000,16000,16000
056092,亞德客元富97購02,0,0,0,0,0,0,0,0,0,16000,0,0,0,39000,23000,16000,16000
05627P,致伸國票97售01  ,0,0,0,0,0,0,0,0,0,16000,0,0,0,16000,0,16000,16000
058223,世芯統一9B購01  ,0,0,0,0,0,0,0,0,0,16000,0,0,0,17000,1000,16000,16000
2465,麗臺            ,16000,0,16000,0,0,0,0,0,0,0,0,0,0,0,0,0,16000
1413,宏洲            ,16000,0,16000,0,0,0,0,0,0,0,0,0,0,0,0,0,16000
1437,勤益控          ,43000,49000,-6000,0,0,0,0,0,0,22000,22000,0,22000,0,0,0,16000
1463,強盛            ,27000,11000,16000,0,0,0,0,0,0,0,0,0,0,0,0,0,16000
07284P,大立光凱基99售10,0,0,0,0,0,0,0,0,0,16000,0,0,0,84000,68000,16000,16000
06825P,臺股指國票98售01,0,0,0,0,0,0,0,0,0,16000,0,0,0,18000,2000,16000,16000
06849P,欣興元大98售12  ,0,0,0,0,0,0,0,0,0,16000,0,0,0,25000,9000,16000,16000
3550,聯穎            ,15000,0,15000,0,0,0,0,0,0,1000,1000,0,1000,0,0,0,16000
3164,景岳            ,17000,1000,16000,0,0,0,0,0,0,0,0,0,0,0,0,0,16000
6281,全國電          ,19000,5000,14000,0,0,0,0,0,0,2000,2000,0,2000,0,0,0,16000
8011,台通            ,44000,28000,16000,0,0,0,0,0,0,0,0,0,0,0,0,0,16000
059552,台灣50凱基99購04,0,0,0,0,0,0,0,0,0,15000,0,0,0,17000,2000,15000,15000
059783,旺宏元大99購17  ,0,0,0,0,0,0,0,0,0,15000,0,0,0,33000,18000,15000,15000
059796,台積電國票99購10,0,0,0,0,0,0,0,0,0,15000,0,0,0,28000,13000,15000,15000
059390,華新科凱基99購05,0,0,0,0,0,0,0,0,0,15000,0,0,0,29000,14000,15000,15000
059126,臺指反中信9B購01,0,0,0,0,0,0,0,0,0,15000,0,0,0,15000,0,15000,15000
060316,福懋科永豐9A購01,0,0,0,0,0,0,0,0,0,15000,0,0,0,69000,54000,15000,15000
060670,臺指反元大01購03,0,0,0,0,0,0,0,0,0,15000,0,0,0,15000,0,15000,15000
06729P,聯詠元大98售03  ,0,0,0,0,0,0,0,0,0,15000,0,0,0,15000,0,15000,15000
06242P,大立光元富9A售02,0,0,0,0,0,0,0,0,0,15000,0,0,0,15000,0,15000,15000
061256,亞德客凱基9B購01,0,0,0,0,0,0,0,0,0,15000,0,0,0,21000,6000,15000,15000
05089P,亞德客元大95售01,0,0,0,0,0,0,0,0,0,15000,0,0,0,15000,0,15000,15000
052031,臺股指群益95購04,0,0,0,0,0,0,0,0,0,15000,0,0,0,15000,0,15000,15000
052103,台積電兆豐95購06,0,0,0,0,0,0,0,0,0,15000,0,0,0,213000,198000,15000,15000
053905,華新科凱基96購10,0,0,0,0,0,0,0,0,0,15000,0,0,0,15000,0,15000,15000
052687,國泰金元大96購03,0,0,0,0,0,0,0,0,0,15000,0,0,0,15000,0,15000,15000
05140P,台表科國票96售01,0,0,0,0,0,0,0,0,0,15000,0,0,0,15000,0,15000,15000
051471,國巨凱基97購01  ,0,0,0,0,0,0,0,0,0,15000,0,0,0,15000,0,15000,15000
00731,FH富時高息低波  ,0,3000,-3000,0,0,0,0,0,0,18000,0,0,0,160000,142000,18000,15000
049973,T50反1日盛9A購01,0,0,0,0,0,0,0,0,0,15000,0,0,0,15000,0,15000,15000
053062,緯穎富邦97購01  ,0,0,0,0,0,0,0,0,0,15000,0,0,0,24000,9000,15000,15000
053021,國巨國泰97購04  ,0,0,0,0,0,0,0,0,0,15000,0,0,0,307000,292000,15000,15000
054933,南港元大97購01  ,0,0,0,0,0,0,0,0,0,15000,0,0,0,15000,0,15000,15000
054937,國巨元大97購03  ,0,0,0,0,0,0,0,0,0,15000,0,0,0,15000,0,15000,15000
054938,國巨元大97購04  ,0,0,0,0,0,0,0,0,0,15000,0,0,0,15000,0,15000,15000
054954,華新科元大97購06,0,0,0,0,0,0,0,0,0,15000,0,0,0,15000,0,15000,15000
053356,聯發科統一96購07,0,0,0,0,0,0,0,0,0,15000,0,0,0,345000,330000,15000,15000
053745,康友國票97購01  ,0,0,0,0,0,0,0,0,0,15000,0,0,0,115000,100000,15000,15000
054282,泰鼎群益98購02  ,0,0,0,0,0,0,0,0,0,15000,0,0,0,15000,0,15000,15000
052806,玉晶光元大98購04,0,0,0,0,0,0,0,0,0,15000,0,0,0,15000,0,15000,15000
054043,漢唐元大97購01  ,0,0,0,0,0,0,0,0,0,15000,0,0,0,15000,0,15000,15000
054593,滬深2X永昌9A購01,0,0,0,0,0,0,0,0,0,15000,0,0,0,15000,0,15000,15000
05309P,康友中信95售03  ,0,0,0,0,0,0,0,0,0,15000,0,0,0,15000,0,15000,15000
053423,亞光永豐96購01  ,0,0,0,0,0,0,0,0,0,15000,0,0,0,87000,72000,15000,15000
053363,旺宏國泰98購02  ,0,0,0,0,0,0,0,0,0,15000,0,0,0,201000,186000,15000,15000
053513,義隆群益96購05  ,0,0,0,0,0,0,0,0,0,15000,0,0,0,24000,9000,15000,15000
053534,微星永豐96購02  ,0,0,0,0,0,0,0,0,0,15000,0,0,0,25000,10000,15000,15000
057552,禾伸堂凱基98購05,0,0,0,0,0,0,0,0,0,15000,0,0,0,75000,60000,15000,15000
055437,禾伸堂中信99購01,0,0,0,0,0,0,0,0,0,15000,0,0,0,143000,128000,15000,15000
055374,明泰元大97購01  ,0,0,0,0,0,0,0,0,0,15000,0,0,0,15000,0,15000,15000
057891,華新科統一9A購01,0,0,0,0,0,0,0,0,0,15000,0,0,0,15000,0,15000,15000
055240,京元電元富97購01,0,0,0,0,0,0,0,0,0,15000,0,0,0,73000,58000,15000,15000
055145,T50反1元大97購04,0,0,0,0,0,0,0,0,0,15000,0,0,0,15000,0,15000,15000
057127,旺宏凱基98購09  ,0,0,0,0,0,0,0,0,0,15000,0,0,0,15000,0,15000,15000
057604,鴻海統一9C購01  ,0,0,0,0,0,0,0,0,0,15000,0,0,0,26000,11000,15000,15000
058070,華新科凱基98購07,0,0,0,0,0,0,0,0,0,15000,0,0,0,15000,0,15000,15000
058047,可成元大98購11  ,0,0,0,0,0,0,0,0,0,15000,0,0,0,68000,53000,15000,15000
057319,奇力新凱基99購02,0,0,0,0,0,0,0,0,0,15000,0,0,0,127000,112000,15000,15000
057323,智邦群益98購01  ,0,0,0,0,0,0,0,0,0,15000,0,0,0,29000,14000,15000,15000
056271,嘉澤統一97購01  ,0,0,0,0,0,0,0,0,0,15000,0,0,0,15000,0,15000,15000
056414,國巨中信98購02  ,0,0,0,0,0,0,0,0,0,15000,0,0,0,15000,0,15000,15000
057657,國巨兆豐98購04  ,0,0,0,0,0,0,0,0,0,15000,0,0,0,35000,20000,15000,15000
055854,群創元大98購04  ,0,0,0,0,0,0,0,0,0,15000,0,0,0,15000,0,15000,15000
05704P,矽力群益96售04  ,0,0,0,0,0,0,0,0,0,15000,0,0,0,15000,0,15000,15000
058761,欣興群益99購02  ,0,0,0,0,0,0,0,0,0,15000,0,0,0,52000,37000,15000,15000
058707,泰鼎元大99購02  ,0,0,0,0,0,0,0,0,0,15000,0,0,0,65000,50000,15000,15000
058516,健鼎元大99購02  ,0,0,0,0,0,0,0,0,0,15000,0,0,0,105000,90000,15000,15000
058546,玉晶光富邦9B購01,0,0,0,0,0,0,0,0,0,15000,0,0,0,15000,0,15000,15000
6243,迅杰            ,15000,0,15000,0,0,0,0,0,0,0,0,0,0,0,0,0,15000
6168,宏齊            ,60000,45000,15000,0,0,0,0,0,0,0,0,0,0,0,0,0,15000
6133,金橋            ,15000,0,15000,0,0,0,0,0,0,0,0,0,0,0,0,0,15000
06962P,華新科永豐99售01,0,0,0,0,0,0,0,0,0,15000,0,0,0,15000,0,15000,15000
07702P,台積電中信9A售06,0,0,0,0,0,0,0,0,0,15000,0,0,0,15000,0,15000,15000
07687P,上銀元大9A售06  ,0,0,0,0,0,0,0,0,0,15000,0,0,0,15000,0,15000,15000
07659P,中租凱基9A售02  ,0,0,0,0,0,0,0,0,0,15000,0,0,0,20000,5000,15000,15000
07465P,台灣50元大9C售24,0,0,0,0,0,0,0,0,0,15000,0,0,0,15000,0,15000,15000
07467P,上銀元大9A售03  ,0,0,0,0,0,0,0,0,0,15000,0,0,0,30000,15000,15000,15000
07487P,鴻海國票9A售01  ,0,0,0,0,0,0,0,0,0,15000,0,0,0,15000,0,15000,15000
1507,永大            ,50000,35000,15000,0,0,0,0,0,0,0,0,0,0,0,0,0,15000
1713,國化            ,15000,1000,14000,0,0,0,0,0,0,1000,1000,0,1000,0,0,0,15000
2483,百容            ,15000,0,15000,0,0,0,0,0,0,0,0,0,0,0,0,0,15000
2906,高林            ,27000,12000,15000,0,0,0,0,0,0,0,0,0,0,0,0,0,15000
2540,愛山林          ,16000,1000,15000,0,0,0,0,0,0,0,0,0,0,0,0,0,15000
06387P,緯穎永豐97售02  ,0,0,0,0,0,0,0,0,0,14000,0,0,0,34000,20000,14000,14000
060933,南電永豐9A購02  ,0,0,0,0,0,0,0,0,0,14000,0,0,0,25000,11000,14000,14000
060200,同欣電元富9A購01,0,0,0,0,0,0,0,0,0,14000,0,0,0,269000,255000,14000,14000
060249,正文元大9C購01  ,0,0,0,0,0,0,0,0,0,14000,0,0,0,22000,8000,14000,14000
060231,台積電元大9A購08,0,0,0,0,0,0,0,0,0,14000,0,0,0,41000,27000,14000,14000
059823,奇力新凱基99購07,0,0,0,0,0,0,0,0,0,14000,0,0,0,14000,0,14000,14000
059717,國巨元大99購21  ,0,0,0,0,0,0,0,0,0,14000,0,0,0,179000,165000,14000,14000
059704,聯發科凱基9A購08,0,0,0,0,0,0,0,0,0,14000,0,0,0,108000,94000,14000,14000
055358,臻鼎凱基97購01  ,0,0,0,0,0,0,0,0,0,14000,0,0,0,14000,0,14000,14000
053625,國巨兆豐96購03  ,0,0,0,0,0,0,0,0,0,14000,0,0,0,54000,40000,14000,14000
054418,茂林元大97購01  ,0,0,0,0,0,0,0,0,0,14000,0,0,0,49000,35000,14000,14000
054778,世紀鋼國票99購01,0,0,0,0,0,0,0,0,0,14000,0,0,0,50000,36000,14000,14000
050315,和碩兆豐95購01  ,0,0,0,0,0,0,0,0,0,14000,0,0,0,17000,3000,14000,14000
00851,台新全球AI      ,0,0,0,0,0,0,0,0,0,14000,0,0,0,23000,9000,14000,14000
048576,義隆國泰95購01  ,0,0,0,0,0,0,0,0,0,14000,0,0,0,84000,70000,14000,14000
052073,矽力統一95購03  ,0,0,0,0,0,0,0,0,0,14000,0,0,0,14000,0,14000,14000
051283,亞德客統一95購01,0,0,0,0,0,0,0,0,0,14000,0,0,0,14000,0,14000,14000
05865P,大立光元大96售09,0,0,0,0,0,0,0,0,0,14000,0,0,0,14000,0,14000,14000
058637,晶技兆豐99購01  ,0,0,0,0,0,0,0,0,0,14000,0,0,0,19000,5000,14000,14000
057933,聯發科群益98購06,0,0,0,0,0,0,0,0,0,14000,0,0,0,18000,4000,14000,14000
05904P,大立光統一96售07,0,0,0,0,0,0,0,0,0,14000,0,0,0,14000,0,14000,14000
056055,國巨元大97購15  ,0,0,0,0,0,0,0,0,0,14000,0,0,0,24000,10000,14000,14000
056360,智邦元大98購01  ,0,0,0,0,0,0,0,0,0,14000,0,0,0,35000,21000,14000,14000
056233,超眾凱基97購02  ,0,0,0,0,0,0,0,0,0,14000,0,0,0,14000,0,14000,14000
057369,奇力新元大99購05,0,0,0,0,0,0,0,0,0,14000,0,0,0,14000,0,14000,14000
057177,奇力新元大99購04,0,0,0,0,0,0,0,0,0,14000,0,0,0,15000,1000,14000,14000
057179,可成元大98購04  ,0,0,0,0,0,0,0,0,0,14000,0,0,0,50000,36000,14000,14000
05711P,茂林國票97售03  ,0,0,0,0,0,0,0,0,0,14000,0,0,0,194000,180000,14000,14000
056828,國巨富邦9A購03  ,0,0,0,0,0,0,0,0,0,14000,0,0,0,14000,0,14000,14000
056836,國巨元富98購01  ,0,0,0,0,0,0,0,0,0,14000,0,0,0,104000,90000,14000,14000
058266,宏達電永豐99購01,0,0,0,0,0,0,0,0,0,14000,0,0,0,44000,30000,14000,14000
2707,晶華            ,134000,120000,14000,0,0,0,0,0,0,0,0,0,0,0,0,0,14000
2440,太空梭          ,15000,0,15000,0,0,0,0,0,0,-1000,0,1000,-1000,0,0,0,14000
1339,昭輝            ,99000,85000,14000,0,0,0,0,0,0,0,0,0,0,0,0,0,14000
07344P,鴻海富邦9A售03  ,0,0,0,0,0,0,0,0,0,14000,0,0,0,14000,0,14000,14000
07694P,超眾元大9A售05  ,0,0,0,0,0,0,0,0,0,14000,0,0,0,54000,40000,14000,14000
6215,和椿            ,14000,0,14000,0,0,0,0,0,0,0,0,0,0,0,0,0,14000
6216,居易            ,18000,4000,14000,0,0,0,0,0,0,0,0,0,0,0,0,0,14000
4912,聯德控股-KY     ,16000,2000,14000,0,0,0,0,0,0,0,0,0,0,0,0,0,14000
3694,海華            ,31000,17000,14000,0,0,0,0,0,0,0,0,0,0,0,0,0,14000
8367,建新國際        ,10000,0,10000,0,0,0,0,0,0,4000,4000,0,4000,0,0,0,14000
059572,華新科凱基99購08,0,0,0,0,0,0,0,0,0,13000,0,0,0,33000,20000,13000,13000
060474,中租元大9B購01  ,0,0,0,0,0,0,0,0,0,13000,0,0,0,13000,0,13000,13000
06096P,全新永豐97售02  ,0,0,0,0,0,0,0,0,0,13000,0,0,0,13000,0,13000,13000
060688,世紀鋼元大9C購01,0,0,0,0,0,0,0,0,0,13000,0,0,0,13000,0,13000,13000
060757,台積電元大9A購18,0,0,0,0,0,0,0,0,0,13000,0,0,0,43000,30000,13000,13000
061175,台積電凱基9A購19,0,0,0,0,0,0,0,0,0,13000,0,0,0,13000,0,13000,13000
04441P,台積電台新95售01,0,0,0,0,0,0,0,0,0,13000,0,0,0,13000,0,13000,13000
050522,聯發科元大95購03,0,0,0,0,0,0,0,0,0,13000,0,0,0,449000,436000,13000,13000
054151,瑞昱國泰97購01  ,0,0,0,0,0,0,0,0,0,13000,0,0,0,41000,28000,13000,13000
053542,超眾永豐96購01  ,0,0,0,0,0,0,0,0,0,13000,0,0,0,13000,0,13000,13000
056576,晶技元大99購02  ,0,0,0,0,0,0,0,0,0,13000,0,0,0,15000,2000,13000,13000
058123,亞光國票9A購01  ,0,0,0,0,0,0,0,0,0,13000,0,0,0,23000,10000,13000,13000
056798,華新科麥證98購01,0,0,0,13000,0,13000,0,0,0,13000,0,0,0,13000,0,13000,13000
055155,奇力新元大99購01,0,0,0,0,0,0,0,0,0,13000,0,0,0,13000,0,13000,13000
057316,國巨凱基99購04  ,0,0,0,0,0,0,0,0,0,13000,0,0,0,53000,40000,13000,13000
057447,智邦元富02購01  ,0,0,0,0,0,0,0,0,0,13000,0,0,0,43000,30000,13000,13000
056295,國巨元大97購16  ,0,0,0,0,0,0,0,0,0,13000,0,0,0,90000,77000,13000,13000
057034,道瓊反元大9B購01,0,0,0,0,0,0,0,0,0,13000,0,0,0,13000,0,13000,13000
05707P,中磊永豐96售01  ,0,0,0,0,0,0,0,0,0,13000,0,0,0,13000,0,13000,13000
055879,神達元富97購01  ,0,0,0,0,0,0,0,0,0,13000,0,0,0,13000,0,13000,13000
058488,華擎國票9A購01  ,0,0,0,0,0,0,0,0,0,13000,0,0,0,13000,0,13000,13000
4930,燦星網          ,19000,7000,12000,0,0,0,0,0,0,1000,1000,0,1000,0,0,0,13000
4999,鑫禾            ,24000,11000,13000,0,0,0,0,0,0,0,0,0,0,0,0,0,13000
6449,鈺邦            ,30000,16000,14000,0,0,0,0,0,0,-1000,1000,2000,-1000,0,0,0,13000
07411P,國巨元大99售31  ,0,0,0,0,0,0,0,0,0,13000,0,0,0,38000,25000,13000,13000
07415P,台積電元大99售52,0,0,0,0,0,0,0,0,0,13000,0,0,0,136000,123000,13000,13000
06918P,嘉聯益亞東99售01,0,0,0,0,0,0,0,0,0,13000,0,0,0,13000,0,13000,13000
06848P,聯詠元大98售04  ,0,0,0,0,0,0,0,0,0,13000,0,0,0,27000,14000,13000,13000
07226P,貿聯富邦9B售01  ,0,0,0,0,0,0,0,0,0,13000,0,0,0,15000,2000,13000,13000
2038,海光            ,28000,15000,13000,0,0,0,0,0,0,0,0,0,0,0,0,0,13000
2443,億麗            ,16000,3000,13000,0,0,0,0,0,0,0,0,0,0,0,0,0,13000
3013,晟銘電          ,63000,53000,10000,0,0,0,0,0,0,3000,3000,0,3000,0,0,0,13000
3002,歐格            ,12000,0,12000,0,0,0,0,0,0,1000,1000,0,1000,0,0,0,13000
061354,瑞儀元大9A購01  ,0,0,0,0,0,0,0,0,0,12000,0,0,0,372000,360000,12000,12000
061387,鴻海群益9A購05  ,0,0,0,0,0,0,0,0,0,12000,0,0,0,26000,14000,12000,12000
06437P,玉晶光國票99售01,0,0,0,0,0,0,0,0,0,12000,0,0,0,20000,8000,12000,12000
06369P,台積電凱基97售16,0,0,0,0,0,0,0,0,0,12000,0,0,0,62000,50000,12000,12000
06246P,茂林元富97售03  ,0,0,0,0,0,0,0,0,0,12000,0,0,0,95000,83000,12000,12000
06680P,智邦元大98售06  ,0,0,0,0,0,0,0,0,0,12000,0,0,0,82000,70000,12000,12000
06684P,緯穎元大98售06  ,0,0,0,0,0,0,0,0,0,12000,0,0,0,12000,0,12000,12000
060965,中租凱基9B購01  ,0,0,0,0,0,0,0,0,0,12000,0,0,0,261000,249000,12000,12000
060936,T50反1國票9A購09,0,0,0,0,0,0,0,0,0,12000,0,0,0,30000,18000,12000,12000
060860,國巨永豐9A購02  ,0,0,0,0,0,0,0,0,0,12000,0,0,0,212000,200000,12000,12000
060209,喬山康和9A購01  ,0,0,0,0,0,0,0,0,0,12000,0,0,0,54000,42000,12000,12000
05982P,漢唐國票96售03  ,0,0,0,0,0,0,0,0,0,12000,0,0,0,12000,0,12000,12000
05999P,世芯元大96售01  ,0,0,0,0,0,0,0,0,0,12000,0,0,0,12000,0,12000,12000
059614,致新永豐99購01  ,0,0,0,0,0,0,0,0,0,12000,0,0,0,112000,100000,12000,12000
059726,華新科元大99購18,0,0,0,0,0,0,0,0,0,12000,0,0,0,12000,0,12000,12000
054130,漢唐元大97購02  ,0,0,0,0,0,0,0,0,0,12000,0,0,0,25000,13000,12000,12000
052727,仁寶元富96購01  ,0,0,0,0,0,0,0,0,0,12000,0,0,0,262000,250000,12000,12000
054246,國巨元大96購12  ,0,0,0,0,0,0,0,0,0,12000,0,0,0,12000,0,12000,12000
054788,華新科群益98購02,0,0,0,0,0,0,0,0,0,12000,0,0,0,12000,0,12000,12000
054479,緯創中信98購01  ,0,0,0,0,0,0,0,0,0,12000,0,0,0,27000,15000,12000,12000
050212,瀚宇博國票95購02,0,0,0,0,0,0,0,0,0,12000,0,0,0,12000,0,12000,12000
04928P,大立光凱基95售07,0,0,0,0,0,0,0,0,0,12000,0,0,0,12000,0,12000,12000
052201,超眾統一96購01  ,0,0,0,0,0,0,0,0,0,12000,0,0,0,12000,0,12000,12000
047196,上銀統一97購01  ,0,0,0,0,0,0,0,0,0,12000,0,0,0,12000,0,12000,12000
00763U,街口道瓊銅      ,0,0,0,0,0,0,0,0,0,12000,0,0,0,75000,63000,12000,12000
052130,國巨凱基9B購01  ,0,0,0,0,0,0,0,0,0,12000,0,0,0,12000,0,12000,12000
051799,台積電永豐96購01,0,0,0,0,0,0,0,0,0,12000,0,0,0,12000,0,12000,12000
051404,牧德永豐96購01  ,0,0,0,0,0,0,0,0,0,12000,0,0,0,14000,2000,12000,12000
059029,旺宏兆豐99購01  ,0,0,0,0,0,0,0,0,0,12000,0,0,0,47000,35000,12000,12000
05908P,大立光元富96售05,0,0,0,0,0,0,0,0,0,12000,0,0,0,12000,0,12000,12000
058824,晶技富邦9A購01  ,0,0,0,0,0,0,0,0,0,12000,0,0,0,12000,0,12000,12000
057697,國巨群益98購09  ,0,0,0,0,0,0,0,0,0,12000,0,0,0,12000,0,12000,12000
055713,國巨元大98購09  ,0,0,0,0,0,0,0,0,0,12000,0,0,0,61000,49000,12000,12000
2701,萬企            ,23000,11000,12000,0,0,0,0,0,0,0,0,0,0,0,0,0,12000
2616,山隆            ,31000,19000,12000,0,0,0,0,0,0,0,0,0,0,0,0,0,12000
2397,友通            ,18000,6000,12000,0,0,0,0,0,0,0,0,0,0,0,0,0,12000
2032,新鋼            ,12000,0,12000,0,0,0,0,0,0,0,0,0,0,0,0,0,12000
1616,億泰            ,13000,1000,12000,0,0,0,0,0,0,0,0,0,0,0,0,0,12000
1524,耿鼎            ,19000,7000,12000,0,0,0,0,0,0,0,0,0,0,0,0,0,12000
07233P,台灣50元大99售04,0,0,0,0,0,0,0,0,0,12000,0,0,0,12000,0,12000,12000
06935P,神達元大98售02  ,0,0,0,0,0,0,0,0,0,12000,0,0,0,13000,1000,12000,12000
06957P,FBVIX凱基01售01 ,0,0,0,0,0,0,0,0,0,12000,0,0,0,12000,0,12000,12000
06990P,康友元富99售03  ,0,0,0,0,0,0,0,0,0,12000,0,0,0,12000,0,12000,12000
07686P,祥碩凱基9A售02  ,0,0,0,0,0,0,0,0,0,12000,0,0,0,22000,10000,12000,12000
6224,聚鼎            ,34000,35000,-1000,0,0,0,0,0,0,13000,13000,0,13000,0,0,0,12000
5007,三星            ,26000,14000,12000,0,0,0,0,0,0,0,0,0,0,0,0,0,12000
4952,凌通            ,125000,113000,12000,0,0,0,0,0,0,0,0,0,0,0,0,0,12000
4137,麗豐-KY         ,37000,31000,6000,0,0,0,0,0,0,6000,2000,0,2000,4000,0,4000,12000
8940,新天地          ,11000,0,11000,0,0,0,0,0,0,1000,1000,0,1000,0,0,0,12000
9905,大華            ,44000,32000,12000,0,0,0,0,0,0,0,0,0,0,0,0,0,12000
059368,T50正2元富99購02,0,0,0,0,0,0,0,0,0,11000,0,0,0,16000,5000,11000,11000
060131,GIS永豐99購03   ,0,0,0,0,0,0,0,0,0,11000,0,0,0,90000,79000,11000,11000
059832,超眾康和99購01  ,0,0,0,0,0,0,0,0,0,11000,0,0,0,11000,0,11000,11000
060147,臺股指國票9A購07,0,0,0,0,0,0,0,0,0,11000,0,0,0,37000,26000,11000,11000
060317,台灣50群益02購01,0,0,0,0,0,0,0,0,0,11000,0,0,0,11000,0,11000,11000
060837,上銀國票9A購04  ,0,0,0,0,0,0,0,0,0,11000,0,0,0,18000,7000,11000,11000
060964,日月光凱基9A購01,0,0,0,0,0,0,0,0,0,11000,0,0,0,46000,35000,11000,11000
06050P,玉晶光國票98售01,0,0,0,0,0,0,0,0,0,11000,0,0,0,11000,0,11000,11000
060612,世紀鋼凱基9A購01,0,0,0,0,0,0,0,0,0,11000,0,0,0,11000,0,11000,11000
061341,華新科元大9A購16,0,0,0,0,0,0,0,0,0,11000,0,0,0,11000,0,11000,11000
061275,臺股指凱基9A購25,0,0,0,0,0,0,0,0,0,11000,0,0,0,299000,288000,11000,11000
051488,健策凱基96購04  ,0,0,0,0,0,0,0,0,0,11000,0,0,0,11000,0,11000,11000
052674,智邦國泰98購01  ,0,0,0,0,0,0,0,0,0,11000,0,0,0,12000,1000,11000,11000
05396P,台郡元大95售05  ,0,0,0,0,0,0,0,0,0,11000,0,0,0,11000,0,11000,11000
044088,國巨元富95購01  ,0,0,0,0,0,0,0,0,0,11000,0,0,0,11000,0,11000,11000
046680,上証反群益95購01,0,0,0,0,0,0,0,0,0,11000,0,0,0,21000,10000,11000,11000
03422B,臺股指凱基96熊28,0,0,0,0,0,0,0,0,0,11000,0,0,0,13000,2000,11000,11000
049922,禾伸堂元大95購01,0,0,0,0,0,0,0,0,0,11000,0,0,0,11000,0,11000,11000
054951,大毅元大97購01  ,0,0,0,0,0,0,0,0,0,11000,0,0,0,11000,0,11000,11000
052987,華新科元大99購01,0,0,0,0,0,0,0,0,0,11000,0,0,0,11000,0,11000,11000
052961,國巨凱基97購02  ,0,0,0,0,0,0,0,0,0,11000,0,0,0,31000,20000,11000,11000
053074,嘉晶永豐96購02  ,0,0,0,0,0,0,0,0,0,11000,0,0,0,11000,0,11000,11000
05424P,台達電亞東96售02,0,0,0,0,0,0,0,0,0,11000,0,0,0,11000,0,11000,11000
053817,華新科群益97購02,0,0,0,0,0,0,0,0,0,11000,0,0,0,11000,0,11000,11000
052781,瀚宇博國票97購03,0,0,0,0,0,0,0,0,0,11000,0,0,0,11000,0,11000,11000
054525,奇鋐元富96購01  ,0,0,0,0,0,0,0,0,0,11000,0,0,0,112000,101000,11000,11000
05468P,鴻海元大96售14  ,0,0,0,0,0,0,0,0,0,11000,0,0,0,12000,1000,11000,11000
057646,玉山金元大98購01,0,0,0,0,0,0,0,0,0,11000,0,0,0,60000,49000,11000,11000
057296,智原永豐98購01  ,0,0,0,0,0,0,0,0,0,11000,0,0,0,12000,1000,11000,11000
057168,旺宏元大99購03  ,0,0,0,0,0,0,0,0,0,11000,0,0,0,32000,21000,11000,11000
058053,上銀統一9B購01  ,0,0,0,0,0,0,0,0,0,11000,0,0,0,11000,0,11000,11000
056995,華新科日盛99購01,0,0,0,0,0,0,0,0,0,11000,0,0,0,471000,460000,11000,11000
056095,臻鼎元富9A購01  ,0,0,0,0,0,0,0,0,0,11000,0,0,0,11000,0,11000,11000
058834,GIS永豐99購01   ,0,0,0,0,0,0,0,0,0,11000,0,0,0,11000,0,11000,11000
05882P,華新科永豐96售01,0,0,0,0,0,0,0,0,0,11000,0,0,0,11000,0,11000,11000
057938,台表科群益98購02,0,0,0,0,0,0,0,0,0,11000,0,0,0,12000,1000,11000,11000
9927,泰銘            ,27000,16000,11000,0,0,0,0,0,0,0,0,0,0,0,0,0,11000
4571,鈞興-KY         ,16000,0,16000,0,0,0,0,0,0,-5000,0,5000,-5000,0,0,0,11000
3679,新至陞          ,33000,22000,11000,0,0,0,0,0,0,0,0,0,0,0,0,0,11000
6201,亞弘電          ,17000,6000,11000,0,0,0,0,0,0,0,0,0,0,0,0,0,11000
07628P,臺股指凱基9A售09,0,0,0,0,0,0,0,0,0,11000,0,0,0,24000,13000,11000,11000
07353P,大立光國票99售02,0,0,0,0,0,0,0,0,0,11000,0,0,0,11000,0,11000,11000
06889P,臺股指元大98售13,0,0,0,0,0,0,0,0,0,11000,0,0,0,21000,10000,11000,11000
07267P,臺股指元大99售23,0,0,0,0,0,0,0,0,0,11000,0,0,0,20000,9000,11000,11000
07103P,南電元大99售04  ,0,0,0,0,0,0,0,0,0,11000,0,0,0,30000,19000,11000,11000
1535,中宇            ,11000,0,11000,0,0,0,0,0,0,0,0,0,0,0,0,0,11000
1410,南染            ,11000,0,11000,0,0,0,0,0,0,0,0,0,0,0,0,0,11000
2430,燦坤            ,18000,10000,8000,0,0,0,0,0,0,3000,3000,0,3000,0,0,0,11000
2482,連宇            ,11000,0,11000,0,0,0,0,0,0,0,0,0,0,0,0,0,11000
061285,大立光統一9A購04,0,0,0,0,0,0,0,0,0,10000,0,0,0,10000,0,10000,10000
061203,國巨元大9A購15  ,0,0,0,0,0,0,0,0,0,10000,0,0,0,40000,30000,10000,10000
06620P,聯發科元大98售07,0,0,0,0,0,0,0,0,0,10000,0,0,0,10000,0,10000,10000
06592P,欣興元大98售04  ,0,0,0,0,0,0,0,0,0,10000,0,0,0,10000,0,10000,10000
06759P,台積電元大98售17,0,0,0,0,0,0,0,0,0,10000,0,0,0,10000,0,10000,10000
06272P,台郡凱基97售04  ,0,0,0,0,0,0,0,0,0,10000,0,0,0,10000,0,10000,10000
06243P,亞光元富97售01  ,0,0,0,0,0,0,0,0,0,10000,0,0,0,10000,0,10000,10000
06229P,欣興凱基97售07  ,0,0,0,0,0,0,0,0,0,10000,0,0,0,10000,0,10000,10000
06466P,台積電統一9B售01,0,0,0,0,0,0,0,0,0,10000,0,0,0,10000,0,10000,10000
06383P,聯茂元富97售01  ,0,0,0,0,0,0,0,0,0,10000,0,0,0,509000,499000,10000,10000
06396P,新日興康和97售01,0,0,0,0,0,0,0,0,0,10000,0,0,0,25000,15000,10000,10000
06550P,健策元大99售01  ,0,0,0,0,0,0,0,0,0,10000,0,0,0,30000,20000,10000,10000
060587,牧德元富9A購01  ,0,0,0,0,0,0,0,0,0,10000,0,0,0,10000,0,10000,10000
060598,鴻海凱基9A購20  ,0,0,0,0,0,0,0,0,0,10000,0,0,0,10000,0,10000,10000
060773,FBVIX凱基9A購04 ,0,0,0,0,0,0,0,0,0,10000,0,0,0,10000,0,10000,10000
060743,鴻海國票9A購03  ,0,0,0,0,0,0,0,0,0,10000,0,0,0,10000,0,10000,10000
061101,道瓊銀元大9A購02,0,0,0,0,0,0,0,0,0,10000,0,0,0,10000,0,10000,10000
061051,臺股指中信9A購06,0,0,0,0,0,0,0,0,0,10000,0,0,0,10000,0,10000,10000
06089P,矽創永豐97售01  ,0,0,0,0,0,0,0,0,0,10000,0,0,0,10000,0,10000,10000
060455,葡萄王元大9A購02,0,0,0,0,0,0,0,0,0,10000,0,0,0,10000,0,10000,10000
060152,上証2X永豐9A購02,0,0,0,0,0,0,0,0,0,10000,0,0,0,10000,0,10000,10000
06016P,京元電凱基96售03,0,0,0,0,0,0,0,0,0,10000,0,0,0,10000,0,10000,10000
060221,大立光凱基9A購07,0,0,0,0,0,0,0,0,0,10000,0,0,0,12000,2000,10000,10000
060300,佐登國泰9B購01  ,0,0,0,0,0,0,0,0,0,10000,0,0,0,10000,0,10000,10000
060275,元黃金元大9A購01,0,0,0,0,0,0,0,0,0,10000,0,0,0,21000,11000,10000,10000
05993P,國巨元大96售13  ,0,0,0,0,0,0,0,0,0,10000,0,0,0,10000,0,10000,10000
060117,國巨國泰9B購04  ,0,0,0,0,0,0,0,0,0,10000,0,0,0,13000,3000,10000,10000
060096,聯發科元大99購43,0,0,0,0,0,0,0,0,0,10000,0,0,0,13000,3000,10000,10000
060083,和大元大99購02  ,0,0,0,0,0,0,0,0,0,10000,0,0,0,62000,52000,10000,10000
06006P,欣興永豐96售04  ,0,0,0,0,0,0,0,0,0,10000,0,0,0,10000,0,10000,10000
059997,華航元富99購01  ,0,0,0,0,0,0,0,0,0,10000,0,0,0,20000,10000,10000,10000
060054,華新科凱基9B購04,0,0,0,0,0,0,0,0,0,10000,0,0,0,10000,0,10000,10000
059379,聯電亞東99購02  ,0,0,0,0,0,0,0,0,0,10000,0,0,0,10000,0,10000,10000
059345,禾伸堂凱基99購03,0,0,0,0,0,0,0,0,0,10000,0,0,0,23000,13000,10000,10000
059346,新日興凱基99購03,0,0,0,0,0,0,0,0,0,10000,0,0,0,10000,0,10000,10000
059119,華擎永豐99購02  ,0,0,0,0,0,0,0,0,0,10000,0,0,0,10000,0,10000,10000
059140,大立光兆豐9A購02,0,0,0,0,0,0,0,0,0,10000,0,0,0,10000,0,10000,10000
059167,聯發科凱基99購11,0,0,0,0,0,0,0,0,0,10000,0,0,0,10000,0,10000,10000
059708,立積凱基9A購02  ,0,0,0,0,0,0,0,0,0,10000,0,0,0,10000,0,10000,10000
05966P,矽力凱基96售03  ,0,0,0,0,0,0,0,0,0,10000,0,0,0,10000,0,10000,10000
059692,聯詠永豐99購01  ,0,0,0,0,0,0,0,0,0,10000,0,0,0,30000,20000,10000,10000
059752,國巨群益9B購01  ,0,0,0,0,0,0,0,0,0,10000,0,0,0,10000,0,10000,10000
059632,聯發科凱基01購01,0,0,0,0,0,0,0,0,0,10000,0,0,0,10000,0,10000,10000
059481,華新科群益99購05,0,0,0,0,0,0,0,0,0,10000,0,0,0,10000,0,10000,10000
054642,訊芯中信9A購01  ,0,0,0,0,0,0,0,0,0,10000,0,0,0,10000,0,10000,10000
054649,聯茂群益97購01  ,0,0,0,0,0,0,0,0,0,10000,0,0,0,10000,0,10000,10000
053145,元黃金元大96購02,0,0,0,0,0,0,0,0,0,10000,0,0,0,10000,0,10000,10000
053175,矽力群益96購01  ,0,0,0,0,0,0,0,0,0,10000,0,0,0,10000,0,10000,10000
05459P,聯詠凱基95售03  ,0,0,0,0,0,0,0,0,0,10000,0,0,0,10000,0,10000,10000
053493,智邦兆豐97購02  ,0,0,0,0,0,0,0,0,0,10000,0,0,0,10000,0,10000,10000
053628,微星兆豐96購01  ,0,0,0,0,0,0,0,0,0,10000,0,0,0,10000,0,10000,10000
05358P,大立光元大95售09,0,0,0,0,0,0,0,0,0,10000,0,0,0,10000,0,10000,10000
053557,聯茂凱基96購04  ,0,0,0,0,0,0,0,0,0,10000,0,0,0,10000,0,10000,10000
053370,上証2X元大97購03,0,0,0,0,0,0,0,0,0,10000,0,0,0,10000,0,10000,10000
053482,矽力元大96購03  ,0,0,0,0,0,0,0,0,0,10000,0,0,0,10000,0,10000,10000
053457,旺宏國泰98購03  ,0,0,0,0,0,0,0,0,0,10000,0,0,0,10000,0,10000,10000
055469,台光電凱基97購01,0,0,0,0,0,0,0,0,0,10000,0,0,0,10000,0,10000,10000
055445,旺宏統一99購01  ,0,0,0,0,0,0,0,0,0,10000,0,0,0,10000,0,10000,10000
056608,力山永豐98購01  ,0,0,0,0,0,0,0,0,0,10000,0,0,0,10000,0,10000,10000
055429,華新科群益99購01,0,0,0,0,0,0,0,0,0,10000,0,0,0,10000,0,10000,10000
057541,台灣50康和9A購04,0,0,0,0,0,0,0,0,0,10000,0,0,0,10000,0,10000,10000
055306,燿華群益97購01  ,0,0,0,0,0,0,0,0,0,10000,0,0,0,10000,0,10000,10000
053712,台光電凱基96購04,0,0,0,0,0,0,0,0,0,10000,0,0,0,10000,0,10000,10000
053689,台光電元大96購01,0,0,0,0,0,0,0,0,0,10000,0,0,0,10000,0,10000,10000
056525,T50反1凱基99購06,0,0,0,0,0,0,0,0,0,10000,0,0,0,10000,0,10000,10000
05652P,臻鼎群益96售01  ,0,0,0,0,0,0,0,0,0,10000,0,0,0,10000,0,10000,10000
056530,旺宏凱基98購06  ,0,0,0,0,0,0,0,0,0,10000,0,0,0,10000,0,10000,10000
056561,台光電群益98購02,0,0,0,0,0,0,0,0,0,10000,0,0,0,60000,50000,10000,10000
052794,群創兆豐97購01  ,0,0,0,0,0,0,0,0,0,10000,0,0,0,10000,0,10000,10000
054111,緯穎凱基97購01  ,0,0,0,0,0,0,0,0,0,10000,0,0,0,54000,44000,10000,10000
054101,茂林國票97購04  ,0,0,0,0,0,0,0,0,0,10000,0,0,0,10000,0,10000,10000
054077,中石化中信98購01,0,0,0,0,0,0,0,0,0,10000,0,0,0,60000,50000,10000,10000
054036,T50反1元大96購08,0,0,0,0,0,0,0,0,0,10000,0,0,0,10000,0,10000,10000
053851,鴻海國泰98購03  ,0,0,0,0,0,0,0,0,0,10000,0,0,0,10000,0,10000,10000
053255,貿聯國泰97購01  ,0,0,0,0,0,0,0,0,0,10000,0,0,0,16000,6000,10000,10000
053274,旺宏元大98購03  ,0,0,0,0,0,0,0,0,0,10000,0,0,0,10000,0,10000,10000
053748,燿華永豐96購04  ,0,0,0,0,0,0,0,0,0,10000,0,0,0,10000,0,10000,10000
053735,矽力中信97購01  ,0,0,0,0,0,0,0,0,0,10000,0,0,0,30000,20000,10000,10000
054207,國巨國票98購01  ,0,0,0,0,0,0,0,0,0,10000,0,0,0,10000,0,10000,10000
054309,禾伸堂凱基98購01,0,0,0,0,0,0,0,0,0,10000,0,0,0,10000,0,10000,10000
053066,欣興群益96購02  ,0,0,0,0,0,0,0,0,0,10000,0,0,0,10000,0,10000,10000
053081,上銀元大97購02  ,0,0,0,0,0,0,0,0,0,10000,0,0,0,10000,0,10000,10000
05304P,國巨國泰97售02  ,0,0,0,0,0,0,0,0,0,10000,0,0,0,80000,70000,10000,10000
053050,華通國票97購02  ,0,0,0,0,0,0,0,0,0,10000,0,0,0,10000,0,10000,10000
053041,可成凱基96購02  ,0,0,0,0,0,0,0,0,0,10000,0,0,0,10000,0,10000,10000
052859,國巨凱基96購07  ,0,0,0,0,0,0,0,0,0,10000,0,0,0,20000,10000,10000,10000
054835,致新中信97購01  ,0,0,0,0,0,0,0,0,0,10000,0,0,0,10000,0,10000,10000
054967,神達元大97購01  ,0,0,0,0,0,0,0,0,0,10000,0,0,0,10000,0,10000,10000
054825,康友元大97購01  ,0,0,0,0,0,0,0,0,0,10000,0,0,0,10000,0,10000,10000
054396,日電貿永豐96購02,0,0,0,0,0,0,0,0,0,10000,0,0,0,10000,0,10000,10000
054398,牧德永豐96購03  ,0,0,0,0,0,0,0,0,0,10000,0,0,0,10000,0,10000,10000
054380,世芯群益97購02  ,0,0,0,0,0,0,0,0,0,10000,0,0,0,10000,0,10000,10000
049667,大立光國泰96購01,0,0,0,0,0,0,0,0,0,10000,0,0,0,10000,0,10000,10000
049668,大立光國泰96購02,0,0,0,0,0,0,0,0,0,10000,0,0,0,10000,0,10000,10000
049458,SP黃豆元富96購01,0,0,0,0,0,0,0,0,0,10000,0,0,0,50000,40000,10000,10000
049434,茂林國票95購01  ,0,0,0,0,0,0,0,0,0,10000,0,0,0,52000,42000,10000,10000
04948P,瑞儀元大94售03  ,0,0,0,0,0,0,0,0,0,10000,0,0,0,10000,0,10000,10000
04952P,台光電亞東94售01,0,0,0,0,0,0,0,0,0,10000,0,0,0,10000,0,10000,10000
050183,奇鋐元大96購01  ,0,0,0,0,0,0,0,0,0,10000,0,0,0,10000,0,10000,10000
049888,智邦國泰96購01  ,0,0,0,0,0,0,0,0,0,10000,0,0,0,10000,0,10000,10000
050135,禾伸堂兆豐95購01,0,0,0,0,0,0,0,0,0,10000,0,0,0,10000,0,10000,10000
050614,聯發科元大95購04,0,0,0,0,0,0,0,0,0,10000,0,0,0,10000,0,10000,10000
050600,瑞儀國泰95購01  ,0,0,0,0,0,0,0,0,0,10000,0,0,0,40000,30000,10000,10000
05057P,鴻海國票96售01  ,0,0,0,0,0,0,0,0,0,10000,0,0,0,10000,0,10000,10000
050491,旺宏國泰96購01  ,0,0,0,0,0,0,0,0,0,10000,0,0,0,10000,0,10000,10000
045882,滬深2X元大95購01,0,0,0,0,0,0,0,0,0,10000,0,0,0,10000,0,10000,10000
046881,智原富邦99購01  ,0,0,0,0,0,0,0,0,0,10000,0,0,0,10000,0,10000,10000
03935P,可成富邦95售01  ,0,0,0,0,0,0,0,0,0,10000,0,0,0,10000,0,10000,10000
05221P,玉晶光元大95售04,0,0,0,0,0,0,0,0,0,10000,0,0,0,10000,0,10000,10000
03676C,臺股指元大04牛03,0,0,0,0,0,0,0,0,0,10000,0,0,0,10000,0,10000,10000
03607P,滬深2X富邦95售01,0,0,0,0,0,0,0,0,0,10000,0,0,0,10000,0,10000,10000
044988,玉晶光統一95購01,0,0,0,0,0,0,0,0,0,10000,0,0,0,10000,0,10000,10000
04167P,滬深反凱基99售01,0,0,0,0,0,0,0,0,0,10000,0,0,0,10000,0,10000,10000
049004,聯發科中信96購01,0,0,0,0,0,0,0,0,0,10000,0,0,0,10000,0,10000,10000
048848,滬深2X群益98購02,0,0,0,0,0,0,0,0,0,10000,0,0,0,10000,0,10000,10000
048128,超眾元大95購01  ,0,0,0,0,0,0,0,0,0,10000,0,0,0,10000,0,10000,10000
047993,鑽全元大96購01  ,0,0,0,0,0,0,0,0,0,10000,0,0,0,10000,0,10000,10000
04768P,大立光國泰96售03,0,0,0,0,0,0,0,0,0,10000,0,0,0,29000,19000,10000,10000
02001L,富邦蘋果正二N   ,0,0,0,0,0,0,0,0,0,10000,0,0,0,12000,2000,10000,10000
053966,旺宏元大96購08  ,0,0,0,0,0,0,0,0,0,10000,0,0,0,26000,16000,10000,10000
052610,貿聯元大97購01  ,0,0,0,0,0,0,0,0,0,10000,0,0,0,10000,0,10000,10000
052663,奇鋐國票97購01  ,0,0,0,0,0,0,0,0,0,10000,0,0,0,10000,0,10000,10000
053939,台表科元富96購03,0,0,0,0,0,0,0,0,0,10000,0,0,0,10000,0,10000,10000
051412,奇力新國票96購01,0,0,0,0,0,0,0,0,0,10000,0,0,0,10000,0,10000,10000
051400,國巨永豐95購01  ,0,0,0,0,0,0,0,0,0,10000,0,0,0,10000,0,10000,10000
051394,奇鋐兆豐95購01  ,0,0,0,0,0,0,0,0,0,10000,0,0,0,10000,0,10000,10000
051562,玉晶光國泰97購05,0,0,0,0,0,0,0,0,0,10000,0,0,0,10000,0,10000,10000
051582,聯發科元大97購02,0,0,0,0,0,0,0,0,0,10000,0,0,0,10000,0,10000,10000
051569,緯創富邦95購02  ,0,0,0,0,0,0,0,0,0,10000,0,0,0,10000,0,10000,10000
05144P,美律永豐95售02  ,0,0,0,0,0,0,0,0,0,10000,0,0,0,30000,20000,10000,10000
052328,台表科中信99購01,0,0,0,0,0,0,0,0,0,10000,0,0,0,110000,100000,10000,10000
051647,華新科永豐95購02,0,0,0,0,0,0,0,0,0,10000,0,0,0,10000,0,10000,10000
051665,台積電元大96購07,0,0,0,0,0,0,0,0,0,10000,0,0,0,10000,0,10000,10000
051780,矽力群益95購01  ,0,0,0,0,0,0,0,0,0,10000,0,0,0,10000,0,10000,10000
052006,康友富邦98購01  ,0,0,0,0,0,0,0,0,0,10000,0,0,0,10000,0,10000,10000
052010,兆豐金中信95購01,0,0,0,0,0,0,0,0,0,10000,0,0,0,15000,5000,10000,10000
051941,樺漢群益95購02  ,0,0,0,0,0,0,0,0,0,10000,0,0,0,10000,0,10000,10000
051916,和碩元大95購02  ,0,0,0,0,0,0,0,0,0,10000,0,0,0,10000,0,10000,10000
051926,聯電中信97購01  ,0,0,0,0,0,0,0,0,0,10000,0,0,0,30000,20000,10000,10000
052146,泰碩群益95購01  ,0,0,0,0,0,0,0,0,0,10000,0,0,0,10000,0,10000,10000
052029,矽力群益95購02  ,0,0,0,0,0,0,0,0,0,10000,0,0,0,10000,0,10000,10000
052077,可成元富98購02  ,0,0,0,0,0,0,0,0,0,10000,0,0,0,10000,0,10000,10000
050896,華新科元大96購02,0,0,0,0,0,0,0,0,0,10000,0,0,0,10000,0,10000,10000
050941,T50反1群益95購01,0,0,0,0,0,0,0,0,0,10000,0,0,0,10000,0,10000,10000
050926,禾伸堂凱基95購01,0,0,0,0,0,0,0,0,0,10000,0,0,0,10000,0,10000,10000
050760,矽力元富94購03  ,0,0,0,0,0,0,0,0,0,10000,0,0,0,10000,0,10000,10000
051698,旺宏麥證95購01  ,0,0,0,10000,0,10000,0,0,0,10000,0,0,0,10000,0,10000,10000
051684,瑞昱凱基95購02  ,0,0,0,0,0,0,0,0,0,10000,0,0,0,10000,0,10000,10000
051694,A50正2中信96購03,0,0,0,0,0,0,0,0,0,10000,0,0,0,10000,0,10000,10000
051271,華新科群益95購04,0,0,0,0,0,0,0,0,0,10000,0,0,0,10000,0,10000,10000
051234,南電群益95購02  ,0,0,0,0,0,0,0,0,0,10000,0,0,0,10000,0,10000,10000
051058,景碩群益96購01  ,0,0,0,0,0,0,0,0,0,10000,0,0,0,10000,0,10000,10000
051089,旺宏元大96購04  ,0,0,0,0,0,0,0,0,0,10000,0,0,0,20000,10000,10000,10000
057954,宏碁元大99購01  ,0,0,0,0,0,0,0,0,0,10000,0,0,0,10000,0,10000,10000
058504,台積電元大99購07,0,0,0,0,0,0,0,0,0,10000,0,0,0,10000,0,10000,10000
058469,臺股指中信9A購05,0,0,0,0,0,0,0,0,0,10000,0,0,0,10000,0,10000,10000
057781,國巨國票99購04  ,0,0,0,0,0,0,0,0,0,10000,0,0,0,10000,0,10000,10000
057093,臻鼎元富98購02  ,0,0,0,0,0,0,0,0,0,10000,0,0,0,10000,0,10000,10000
057807,友訊元大98購02  ,0,0,0,0,0,0,0,0,0,10000,0,0,0,10000,0,10000,10000
058617,南電元大99購01  ,0,0,0,0,0,0,0,0,0,10000,0,0,0,10000,0,10000,10000
058518,玉晶光元大99購13,0,0,0,0,0,0,0,0,0,10000,0,0,0,10000,0,10000,10000
058810,國巨統一9B購04  ,0,0,0,0,0,0,0,0,0,10000,0,0,0,30000,20000,10000,10000
05903P,聯發科統一96售09,0,0,0,0,0,0,0,0,0,10000,0,0,0,10000,0,10000,10000
059002,聯發科元大99購18,0,0,0,0,0,0,0,0,0,10000,0,0,0,10000,0,10000,10000
056093,大毅元富97購01  ,0,0,0,0,0,0,0,0,0,10000,0,0,0,10000,0,10000,10000
056111,力成永豐97購01  ,0,0,0,0,0,0,0,0,0,10000,0,0,0,10000,0,10000,10000
056849,瀚宇博元富98購01,0,0,0,0,0,0,0,0,0,10000,0,0,0,60000,50000,10000,10000
056066,奇鋐元大98購02  ,0,0,0,0,0,0,0,0,0,10000,0,0,0,10000,0,10000,10000
056428,台達電凱基99購01,0,0,0,0,0,0,0,0,0,10000,0,0,0,10000,0,10000,10000
056367,祥碩元大98購01  ,0,0,0,0,0,0,0,0,0,10000,0,0,0,10000,0,10000,10000
056381,台虹元富98購01  ,0,0,0,0,0,0,0,0,0,10000,0,0,0,10000,0,10000,10000
056192,智邦富邦98購01  ,0,0,0,0,0,0,0,0,0,10000,0,0,0,11000,1000,10000,10000
056209,超眾永豐97購02  ,0,0,0,0,0,0,0,0,0,10000,0,0,0,10000,0,10000,10000
057692,臺股指凱基98購10,0,0,0,0,0,0,0,0,0,10000,0,0,0,10000,0,10000,10000
056976,喬山群益98購01  ,0,0,0,0,0,0,0,0,0,10000,0,0,0,20000,10000,10000,10000
056934,國巨元富98購04  ,0,0,0,0,0,0,0,0,0,10000,0,0,0,110000,100000,10000,10000
055880,神達元富97購02  ,0,0,0,0,0,0,0,0,0,10000,0,0,0,10000,0,10000,10000
056925,群創兆豐98購03  ,0,0,0,0,0,0,0,0,0,10000,0,0,0,20000,10000,10000,10000
055988,矽力元富97購01  ,0,0,0,0,0,0,0,0,0,10000,0,0,0,10000,0,10000,10000
057751,神達國票99購02  ,0,0,0,0,0,0,0,0,0,10000,0,0,0,10000,0,10000,10000
058077,超眾凱基98購02  ,0,0,0,0,0,0,0,0,0,10000,0,0,0,20000,10000,10000,10000
057998,玉晶光麥證9A購01,0,0,0,20000,10000,10000,0,0,0,10000,0,0,0,20000,10000,10000,10000
056722,滬深反中信9B購01,0,0,0,0,0,0,0,0,0,10000,0,0,0,10000,0,10000,10000
057166,國巨元大99購06  ,0,0,0,0,0,0,0,0,0,10000,0,0,0,10000,0,10000,10000
057575,世紀鋼永豐98購02,0,0,0,0,0,0,0,0,0,10000,0,0,0,20000,10000,10000,10000
057121,立積康和98購01  ,0,0,0,0,0,0,0,0,0,10000,0,0,0,10000,0,10000,10000
057137,鈺齊凱基98購01  ,0,0,0,0,0,0,0,0,0,10000,0,0,0,10000,0,10000,10000
057152,緯穎國票99購03  ,0,0,0,0,0,0,0,0,0,10000,0,0,0,10000,0,10000,10000
05761P,嘉澤永豐96售01  ,0,0,0,0,0,0,0,0,0,10000,0,0,0,10000,0,10000,10000
055635,緯穎永豐97購01  ,0,0,0,0,0,0,0,0,0,10000,0,0,0,10000,0,10000,10000
055500,京鼎元大97購04  ,0,0,0,0,0,0,0,0,0,10000,0,0,0,10000,0,10000,10000
057194,南電元大98購01  ,0,0,0,0,0,0,0,0,0,10000,0,0,0,20000,10000,10000,10000
057429,華新科兆豐98購03,0,0,0,0,0,0,0,0,0,10000,0,0,0,20000,10000,10000,10000
057415,和碩日盛98購01  ,0,0,0,0,0,0,0,0,0,10000,0,0,0,10000,0,10000,10000
055585,國巨元大98購08  ,0,0,0,0,0,0,0,0,0,10000,0,0,0,10000,0,10000,10000
055582,亞德客元大97購01,0,0,0,0,0,0,0,0,0,10000,0,0,0,10000,0,10000,10000
057347,國巨統一9A購03  ,0,0,0,0,0,0,0,0,0,10000,0,0,0,10000,0,10000,10000
057332,旺宏國票99購03  ,0,0,0,0,0,0,0,0,0,10000,0,0,0,15000,5000,10000,10000
055278,旺宏元大98購05  ,0,0,0,0,0,0,0,0,0,10000,0,0,0,10000,0,10000,10000
055265,玉晶光永豐98購03,0,0,0,0,0,0,0,0,0,10000,0,0,0,10000,0,10000,10000
055794,聯發科國泰99購01,0,0,0,0,0,0,0,0,0,10000,0,0,0,10000,0,10000,10000
055719,可成元大97購03  ,0,0,0,0,0,0,0,0,0,10000,0,0,0,20000,10000,10000,10000
055736,宏達電元富99購01,0,0,0,0,0,0,0,0,0,10000,0,0,0,116000,106000,10000,10000
05675P,美律群益97售01  ,0,0,0,0,0,0,0,0,0,10000,0,0,0,10000,0,10000,10000
055130,京鼎康和97購01  ,0,0,0,0,0,0,0,0,0,10000,0,0,0,10000,0,10000,10000
055244,國巨統一98購01  ,0,0,0,0,0,0,0,0,0,10000,0,0,0,50000,40000,10000,10000
055008,隆達元富97購01  ,0,0,0,0,0,0,0,0,0,10000,0,0,0,20000,10000,10000,10000
055022,精元國泰99購01  ,0,0,0,0,0,0,0,0,0,10000,0,0,0,10000,0,10000,10000
056740,大立光凱基98購13,0,0,0,0,0,0,0,0,0,10000,0,0,0,10000,0,10000,10000
05498P,友達元富95售02  ,0,0,0,0,0,0,0,0,0,10000,0,0,0,10000,0,10000,10000
058162,上銀日盛9B購01  ,0,0,0,0,0,0,0,0,0,10000,0,0,0,10000,0,10000,10000
058274,世紀鋼永豐99購01,0,0,0,0,0,0,0,0,0,10000,0,0,0,10000,0,10000,10000
057850,上銀兆豐99購02  ,0,0,0,0,0,0,0,0,0,10000,0,0,0,10000,0,10000,10000
058330,鴻海元富99購01  ,0,0,0,0,0,0,0,0,0,10000,0,0,0,10000,0,10000,10000
058419,聯發科麥證99購02,0,0,0,10000,10000,0,0,0,0,10000,0,0,0,20000,10000,10000,10000
2444,兆勁            ,114000,104000,10000,0,0,0,0,0,0,0,0,0,0,0,0,0,10000
07733P,台積電統一9B售10,0,0,0,0,0,0,0,0,0,10000,0,0,0,10000,0,10000,10000
1530,亞崴            ,10000,0,10000,0,0,0,0,0,0,0,0,0,0,0,0,0,10000
07212P,聯發科凱基99售14,0,0,0,0,0,0,0,0,0,10000,0,0,0,10000,0,10000,10000
07050P,宏達電中信9B售01,0,0,0,0,0,0,0,0,0,10000,0,0,0,21000,11000,10000,10000
07501P,華新科元大9A售07,0,0,0,0,0,0,0,0,0,10000,0,0,0,10000,0,10000,10000
07455P,聯發科元大9A售01,0,0,0,0,0,0,0,0,0,10000,0,0,0,10000,0,10000,10000
07677P,祥碩永豐9A售01  ,0,0,0,0,0,0,0,0,0,10000,0,0,0,10000,0,10000,10000
07693P,群創元大9B售10  ,0,0,0,0,0,0,0,0,0,10000,0,0,0,23000,13000,10000,10000
07543P,台積電凱基9A售17,0,0,0,0,0,0,0,0,0,10000,0,0,0,50000,40000,10000,10000
4720,德淵            ,34000,24000,10000,0,0,0,0,0,0,0,0,0,0,0,0,0,10000
3593,力銘            ,11000,1000,10000,0,0,0,0,0,0,0,0,0,0,0,0,0,10000
9902,台火            ,22000,12000,10000,0,0,0,0,0,0,0,0,0,0,0,0,0,10000
05947P,大成鋼元大96售03,0,0,0,0,0,0,0,0,0,9000,0,0,0,10000,1000,9000,9000
059568,台積電凱基9A購13,0,0,0,0,0,0,0,0,0,9000,0,0,0,10000,1000,9000,9000
059214,國巨元大99購20  ,0,0,0,0,0,0,0,0,0,9000,0,0,0,76000,67000,9000,9000
059371,聯鈞元富99購02  ,0,0,0,0,0,0,0,0,0,9000,0,0,0,20000,11000,9000,9000
059372,台灣50群益99購02,0,0,0,0,0,0,0,0,0,9000,0,0,0,9000,0,9000,9000
059952,旺宏康和99購01  ,0,0,0,0,0,0,0,0,0,9000,0,0,0,16000,7000,9000,9000
060911,大毅元大9A購01  ,0,0,0,0,0,0,0,0,0,9000,0,0,0,156000,147000,9000,9000
060831,T50反1國票9B購03,0,0,0,0,0,0,0,0,0,9000,0,0,0,10000,1000,9000,9000
060863,聯發科永豐9A購02,0,0,0,0,0,0,0,0,0,9000,0,0,0,71000,62000,9000,9000
060987,華新科元大9A購11,0,0,0,0,0,0,0,0,0,9000,0,0,0,49000,40000,9000,9000
061269,嘉澤凱基9A購01  ,0,0,0,0,0,0,0,0,0,9000,0,0,0,10000,1000,9000,9000
051101,台表科元大96購02,0,0,0,0,0,0,0,0,0,9000,0,0,0,9000,0,9000,9000
050942,S&P正2群益95購01,0,0,0,0,0,0,0,0,0,9000,0,0,0,9000,0,9000,9000
052309,健策國泰97購01  ,0,0,0,0,0,0,0,0,0,9000,0,0,0,41000,32000,9000,9000
051560,玉晶光國泰97購03,0,0,0,0,0,0,0,0,0,9000,0,0,0,142000,133000,9000,9000
052530,台郡元大96購04  ,0,0,0,0,0,0,0,0,0,9000,0,0,0,9000,0,9000,9000
00682U,元大美元指數    ,0,0,0,0,0,0,0,0,0,9000,0,0,0,60000,51000,9000,9000
03052X,元展49          ,0,0,0,0,0,0,0,0,0,9000,0,0,0,9000,0,9000,9000
04932P,香港2X中信96售01,0,0,0,0,0,0,0,0,0,9000,0,0,0,9000,0,9000,9000
052967,智邦群益96購01  ,0,0,0,0,0,0,0,0,0,9000,0,0,0,9000,0,9000,9000
05431P,台光電統一97售01,0,0,0,0,0,0,0,0,0,9000,0,0,0,9000,0,9000,9000
055357,欣興凱基97購04  ,0,0,0,0,0,0,0,0,0,9000,0,0,0,49000,40000,9000,9000
055440,矽力國票98購01  ,0,0,0,0,0,0,0,0,0,9000,0,0,0,9000,0,9000,9000
058344,旺宏群益99購05  ,0,0,0,0,0,0,0,0,0,9000,0,0,0,9000,0,9000,9000
05791P,臺股指中信99售06,0,0,0,0,0,0,0,0,0,9000,0,0,0,9000,0,9000,9000
058412,聯發科兆豐99購01,0,0,0,0,0,0,0,0,0,9000,0,0,0,31000,22000,9000,9000
057190,立積元大9A購02  ,0,0,0,0,0,0,0,0,0,9000,0,0,0,9000,0,9000,9000
056646,奇鋐凱基99購02  ,0,0,0,0,0,0,0,0,0,9000,0,0,0,9000,0,9000,9000
057587,微星國票99購01  ,0,0,0,0,0,0,0,0,0,9000,0,0,0,9000,0,9000,9000
056735,國巨凱基99購02  ,0,0,0,0,0,0,0,0,0,9000,0,0,0,209000,200000,9000,9000
056685,光罩統一98購03  ,0,0,0,0,0,0,0,0,0,9000,0,0,0,10000,1000,9000,9000
056670,樺漢國票99購01  ,0,0,0,0,0,0,0,0,0,9000,0,0,0,9000,0,9000,9000
058086,鴻海元大98購14  ,0,0,0,0,0,0,0,0,0,9000,0,0,0,28000,19000,9000,9000
058099,鴻海國泰9A購02  ,0,0,0,0,0,0,0,0,0,9000,0,0,0,9000,0,9000,9000
058050,台郡元大99購05  ,0,0,0,0,0,0,0,0,0,9000,0,0,0,766000,757000,9000,9000
057076,緯穎永豐98購01  ,0,0,0,0,0,0,0,0,0,9000,0,0,0,9000,0,9000,9000
055863,緯穎元大97購05  ,0,0,0,0,0,0,0,0,0,9000,0,0,0,9000,0,9000,9000
058513,宏達電元大99購05,0,0,0,0,0,0,0,0,0,9000,0,0,0,103000,94000,9000,9000
057802,卜蜂元大98購01  ,0,0,0,0,0,0,0,0,0,9000,0,0,0,11000,2000,9000,9000
057797,大立光兆豐99購01,0,0,0,0,0,0,0,0,0,9000,0,0,0,49000,40000,9000,9000
912000,晨訊科-DR       ,9000,0,9000,0,0,0,0,0,0,0,0,0,0,0,0,0,9000
9937,全國            ,13000,4000,9000,0,0,0,0,0,0,0,0,0,0,0,0,0,9000
6655,科定            ,12000,0,12000,0,0,0,0,0,0,-3000,0,3000,-3000,0,0,0,9000
6189,豐藝            ,50000,41000,9000,0,0,0,0,0,0,0,0,0,0,0,0,0,9000
07669P,華新科元大9A售14,0,0,0,0,0,0,0,0,0,9000,0,0,0,10000,1000,9000,9000
07606P,台灣50國票01售02,0,0,0,0,0,0,0,0,0,9000,0,0,0,9000,0,9000,9000
07045P,上銀國票9A售01  ,0,0,0,0,0,0,0,0,0,9000,0,0,0,10000,1000,9000,9000
07025P,玉晶光凱基99售01,0,0,0,0,0,0,0,0,0,9000,0,0,0,10000,1000,9000,9000
07198P,臺股指元大99售14,0,0,0,0,0,0,0,0,0,9000,0,0,0,9000,0,9000,9000
07264P,台積電元大99售38,0,0,0,0,0,0,0,0,0,9000,0,0,0,9000,0,9000,9000
07217P,大立光凱基9A售05,0,0,0,0,0,0,0,0,0,9000,0,0,0,15000,6000,9000,9000
07094P,華通國票9A售03  ,0,0,0,0,0,0,0,0,0,9000,0,0,0,73000,64000,9000,9000
1568,倉佑            ,10000,1000,9000,0,0,0,0,0,0,0,0,0,0,0,0,0,9000
1516,川飛            ,11000,0,11000,0,0,0,0,0,0,-2000,0,2000,-2000,0,0,0,9000
1776,展宇            ,8000,0,8000,0,0,0,0,0,0,1000,1000,0,1000,0,0,0,9000
2438,翔耀            ,9000,0,9000,0,0,0,0,0,0,0,0,0,0,0,0,0,9000
2516,新建            ,27000,18000,9000,0,0,0,0,0,0,0,0,0,0,0,0,0,9000
061234,國巨元大9A購18  ,0,0,0,0,0,0,0,0,0,8000,0,0,0,33000,25000,8000,8000
06514P,國巨凱基98售05  ,0,0,0,0,0,0,0,0,0,8000,0,0,0,24000,16000,8000,8000
06184P,大立光元大97售06,0,0,0,0,0,0,0,0,0,8000,0,0,0,8000,0,8000,8000
06739P,聯詠兆豐98售02  ,0,0,0,0,0,0,0,0,0,8000,0,0,0,10000,2000,8000,8000
060793,微星永豐9A購01  ,0,0,0,0,0,0,0,0,0,8000,0,0,0,8000,0,8000,8000
060590,台積電台新9C購02,0,0,0,0,0,0,0,0,0,8000,0,0,0,8000,0,8000,8000
059842,台積電富邦9C購05,0,0,0,0,0,0,0,0,0,8000,0,0,0,26000,18000,8000,8000
059855,緯穎永豐99購04  ,0,0,0,0,0,0,0,0,0,8000,0,0,0,36000,28000,8000,8000
060059,鴻海兆豐99購06  ,0,0,0,0,0,0,0,0,0,8000,0,0,0,8000,0,8000,8000
060351,滬深2X元富9A購01,0,0,0,0,0,0,0,0,0,8000,0,0,0,25000,17000,8000,8000
060363,美律元富9A購01  ,0,0,0,0,0,0,0,0,0,8000,0,0,0,166000,158000,8000,8000
059696,立積永豐99購03  ,0,0,0,0,0,0,0,0,0,8000,0,0,0,20000,12000,8000,8000
05656P,台表科統一96售01,0,0,0,0,0,0,0,0,0,8000,0,0,0,8000,0,8000,8000
056516,晶豪科兆豐98購01,0,0,0,0,0,0,0,0,0,8000,0,0,0,13000,5000,8000,8000
054273,宏達電中信98購01,0,0,0,0,0,0,0,0,0,8000,0,0,0,38000,30000,8000,8000
054115,台塑康和96購01  ,0,0,0,0,0,0,0,0,0,8000,0,0,0,8000,0,8000,8000
052753,電子類元大96購02,0,0,0,0,0,0,0,0,0,8000,0,0,0,8000,0,8000,8000
05302P,華通國泰96售01  ,0,0,0,0,0,0,0,0,0,8000,0,0,0,8000,0,8000,8000
052927,友達元大98購02  ,0,0,0,0,0,0,0,0,0,8000,0,0,0,8000,0,8000,8000
054923,晶技凱基98購01  ,0,0,0,0,0,0,0,0,0,8000,0,0,0,20000,12000,8000,8000
049272,世紀鋼元大96購02,0,0,0,0,0,0,0,0,0,8000,0,0,0,113000,105000,8000,8000
047213,新日興富邦97購01,0,0,0,0,0,0,0,0,0,8000,0,0,0,8000,0,8000,8000
039212,台達電台新9A購01,0,0,0,0,0,0,0,0,0,8000,0,0,0,9000,1000,8000,8000
053880,智邦中信96購01  ,0,0,0,0,0,0,0,0,0,8000,0,0,0,28000,20000,8000,8000
051534,景碩國票97購01  ,0,0,0,0,0,0,0,0,0,8000,0,0,0,8000,0,8000,8000
052325,高股息中信99購01,0,0,0,0,0,0,0,0,0,8000,0,0,0,9000,1000,8000,8000
052417,聯發科兆豐9B購01,0,0,0,0,0,0,0,0,0,8000,0,0,0,20000,12000,8000,8000
052418,玉晶光兆豐96購01,0,0,0,0,0,0,0,0,0,8000,0,0,0,8000,0,8000,8000
058489,台灣50群益9B購01,0,0,0,0,0,0,0,0,0,8000,0,0,0,8000,0,8000,8000
058584,百和群益9A購01  ,0,0,0,0,0,0,0,0,0,8000,0,0,0,82000,74000,8000,8000
058991,台灣50元大03購01,0,0,0,0,0,0,0,0,0,8000,0,0,0,8000,0,8000,8000
058752,鈺齊凱基9A購01  ,0,0,0,0,0,0,0,0,0,8000,0,0,0,118000,110000,8000,8000
057058,祥碩元大98購04  ,0,0,0,0,0,0,0,0,0,8000,0,0,0,8000,0,8000,8000
056369,彩晶元大01購01  ,0,0,0,0,0,0,0,0,0,8000,0,0,0,8000,0,8000,8000
056903,大立光元大99購04,0,0,0,0,0,0,0,0,0,8000,0,0,0,8000,0,8000,8000
058034,神達永豐98購02  ,0,0,0,0,0,0,0,0,0,8000,0,0,0,8000,0,8000,8000
056720,世紀鋼永豐98購01,0,0,0,0,0,0,0,0,0,8000,0,0,0,28000,20000,8000,8000
055065,神達永豐97購01  ,0,0,0,0,0,0,0,0,0,8000,0,0,0,10000,2000,8000,8000
055049,智邦永豐97購01  ,0,0,0,0,0,0,0,0,0,8000,0,0,0,8000,0,8000,8000
056789,和碩群益98購01  ,0,0,0,0,0,0,0,0,0,8000,0,0,0,8000,0,8000,8000
1541,錩泰            ,9000,1000,8000,0,0,0,0,0,0,0,0,0,0,0,0,0,8000
07723P,臺股指凱基9A售15,0,0,0,0,0,0,0,0,0,8000,0,0,0,8000,0,8000,8000
1454,台富            ,7000,0,7000,0,0,0,0,0,0,1000,1000,0,1000,0,0,0,8000
07285P,上証2X群益01售02,0,0,0,0,0,0,0,0,0,8000,0,0,0,8000,0,8000,8000
07544P,大立光凱基9A售09,0,0,0,0,0,0,0,0,0,8000,0,0,0,8000,0,8000,8000
07377P,聯發科元大99售40,0,0,0,0,0,0,0,0,0,8000,0,0,0,8000,0,8000,8000
4439,冠星-KY         ,10000,2000,8000,0,0,0,0,0,0,0,0,0,0,0,0,0,8000
4148,全宇生技-KY     ,12000,4000,8000,0,0,0,0,0,0,0,0,0,0,0,0,0,8000
3383,新世紀          ,8000,0,8000,0,0,0,0,0,0,0,0,0,0,0,0,0,8000
6671,三能-KY         ,7000,0,7000,0,0,0,0,0,0,1000,1000,0,1000,0,0,0,8000
059566,台積電凱基9A購11,0,0,0,0,0,0,0,0,0,7000,0,0,0,7000,0,7000,7000
059152,臺股指國票99購15,0,0,0,0,0,0,0,0,0,7000,0,0,0,7000,0,7000,7000
06004P,奇力新永豐96售02,0,0,0,0,0,0,0,0,0,7000,0,0,0,17000,10000,7000,7000
059853,超眾永豐99購03  ,0,0,0,0,0,0,0,0,0,7000,0,0,0,12000,5000,7000,7000
059872,華新科凱基01購01,0,0,0,0,0,0,0,0,0,7000,0,0,0,452000,445000,7000,7000
060660,國巨凱基9B購04  ,0,0,0,0,0,0,0,0,0,7000,0,0,0,207000,200000,7000,7000
061056,臺指反國票02購01,0,0,0,0,0,0,0,0,0,7000,0,0,0,9000,2000,7000,7000
061096,上証2X元大9A購06,0,0,0,0,0,0,0,0,0,7000,0,0,0,7000,0,7000,7000
06567P,鴻海永豐98售02  ,0,0,0,0,0,0,0,0,0,7000,0,0,0,7000,0,7000,7000
06205P,台積電群益97售03,0,0,0,0,0,0,0,0,0,7000,0,0,0,7000,0,7000,7000
06485P,玉晶光群益9A售02,0,0,0,0,0,0,0,0,0,7000,0,0,0,9000,2000,7000,7000
053957,瑞昱永豐96購01  ,0,0,0,0,0,0,0,0,0,7000,0,0,0,7000,0,7000,7000
052513,大立光凱基95購13,0,0,0,0,0,0,0,0,0,7000,0,0,0,82000,75000,7000,7000
052090,聯發科元大97購03,0,0,0,0,0,0,0,0,0,7000,0,0,0,7000,0,7000,7000
051329,智邦永豐95購01  ,0,0,0,0,0,0,0,0,0,7000,0,0,0,7000,0,7000,7000
03038X,元展35          ,0,0,0,0,0,0,0,0,0,7000,0,0,0,7000,0,7000,7000
050551,大立光凱基95購05,0,0,0,0,0,0,0,0,0,7000,0,0,0,56000,49000,7000,7000
050173,旺宏元大96購02  ,0,0,0,0,0,0,0,0,0,7000,0,0,0,7000,0,7000,7000
00866,新光Shiller CAPE,0,0,0,0,0,0,0,0,0,7000,0,0,0,33000,26000,7000,7000
052997,國巨康和96購01  ,0,0,0,0,0,0,0,0,0,7000,0,0,0,70000,63000,7000,7000
05303P,華通國泰97售01  ,0,0,0,0,0,0,0,0,0,7000,0,0,0,7000,0,7000,7000
052724,力成統一97購01  ,0,0,0,0,0,0,0,0,0,7000,0,0,0,7000,0,7000,7000
054345,世芯國票96購02  ,0,0,0,0,0,0,0,0,0,7000,0,0,0,7000,0,7000,7000
053219,祥碩凱基96購01  ,0,0,0,0,0,0,0,0,0,7000,0,0,0,10000,3000,7000,7000
056506,晶豪科永豐98購02,0,0,0,0,0,0,0,0,0,7000,0,0,0,31000,24000,7000,7000
053414,臻鼎國票97購01  ,0,0,0,0,0,0,0,0,0,7000,0,0,0,7000,0,7000,7000
053172,瑞儀群益97購01  ,0,0,0,0,0,0,0,0,0,7000,0,0,0,7000,0,7000,7000
056763,國巨元大99購02  ,0,0,0,0,0,0,0,0,0,7000,0,0,0,359000,352000,7000,7000
055067,禾聯碩永豐97購01,0,0,0,0,0,0,0,0,0,7000,0,0,0,10000,3000,7000,7000
057278,可成元大98購06  ,0,0,0,0,0,0,0,0,0,7000,0,0,0,96000,89000,7000,7000
056467,上証2X元大98購02,0,0,0,0,0,0,0,0,0,7000,0,0,0,7000,0,7000,7000
05646P,聯發科國票96售05,0,0,0,0,0,0,0,0,0,7000,0,0,0,7000,0,7000,7000
05873P,華通群益97售02  ,0,0,0,0,0,0,0,0,0,7000,0,0,0,7000,0,7000,7000
058997,鴻海元大99購21  ,0,0,0,0,0,0,0,0,0,7000,0,0,0,28000,21000,7000,7000
059014,SGBR2X元富03購01,0,0,0,0,0,0,0,0,0,7000,0,0,0,20000,13000,7000,7000
6666,羅麗芬-KY       ,9000,2000,7000,0,0,0,0,0,0,0,0,0,0,0,0,0,7000
6625,必應            ,7000,0,7000,0,0,0,0,0,0,0,0,0,0,0,0,0,7000
8442,威宏-KY         ,7000,0,7000,0,0,0,0,0,0,0,0,0,0,0,0,0,7000
3454,晶睿            ,125000,118000,7000,0,0,0,0,0,0,0,0,0,0,0,0,0,7000
3229,晟鈦            ,7000,0,7000,0,0,0,0,0,0,0,0,0,0,0,0,0,7000
5269,祥碩            ,215000,216000,-1000,0,0,0,12000,10000,2000,6000,25000,8000,17000,12000,23000,-11000,7000
07537P,玉晶光元富9A售04,0,0,0,0,0,0,0,0,0,7000,0,0,0,8000,1000,7000,7000
06977P,臺股指元大9A售15,0,0,0,0,0,0,0,0,0,7000,0,0,0,7000,0,7000,7000
06926P,可成群益9A售04  ,0,0,0,0,0,0,0,0,0,7000,0,0,0,7000,0,7000,7000
06855P,聯發科富邦9A售01,0,0,0,0,0,0,0,0,0,7000,0,0,0,7000,0,7000,7000
07754P,日月光元大9A售02,0,0,0,0,0,0,0,0,0,7000,0,0,0,8000,1000,7000,7000
1587,吉茂            ,5000,0,5000,0,0,0,0,0,0,2000,2000,0,2000,0,0,0,7000
2033,佳大            ,6000,0,6000,0,0,0,0,0,0,1000,1000,0,1000,0,0,0,7000
2630,亞航            ,7000,0,7000,0,0,0,0,0,0,0,0,0,0,0,0,0,7000
2433,互盛電          ,29000,22000,7000,0,0,0,0,0,0,0,0,0,0,0,0,0,7000
2460,建通            ,20000,13000,7000,0,0,0,0,0,0,0,0,0,0,0,0,0,7000
2236,百達-KY         ,9000,2000,7000,0,0,0,0,0,0,0,0,0,0,0,0,0,7000
2243,宏旭-KY         ,7000,0,7000,0,0,0,0,0,0,0,0,0,0,0,0,0,7000
06223P,漢唐元富97售02  ,0,0,0,0,0,0,0,0,0,6000,0,0,0,6000,0,6000,6000
06176P,台積電元大97售22,0,0,0,0,0,0,0,0,0,6000,0,0,0,46000,40000,6000,6000
061244,和碩兆豐9A購01  ,0,0,0,0,0,0,0,0,0,6000,0,0,0,96000,90000,6000,6000
061170,南茂兆豐9B購01  ,0,0,0,0,0,0,0,0,0,6000,0,0,0,243000,237000,6000,6000
061020,超眾國票9A購02  ,0,0,0,0,0,0,0,0,0,6000,0,0,0,6000,0,6000,6000
060827,健策元大9A購02  ,0,0,0,0,0,0,0,0,0,6000,0,0,0,85000,79000,6000,6000
060600,台積電凱基9C購01,0,0,0,0,0,0,0,0,0,6000,0,0,0,6000,0,6000,6000
060664,聯詠凱基9A購01  ,0,0,0,0,0,0,0,0,0,6000,0,0,0,6000,0,6000,6000
059833,緯穎康和99購01  ,0,0,0,0,0,0,0,0,0,6000,0,0,0,6000,0,6000,6000
059932,世紀鋼富邦9A購02,0,0,0,0,0,0,0,0,0,6000,0,0,0,10000,4000,6000,6000
060143,台積電國票9B購03,0,0,0,0,0,0,0,0,0,6000,0,0,0,8000,2000,6000,6000
059681,華新科國泰9B購02,0,0,0,0,0,0,0,0,0,6000,0,0,0,6000,0,6000,6000
059659,旺宏元大9A購03  ,0,0,0,0,0,0,0,0,0,6000,0,0,0,6000,0,6000,6000
05460P,台郡凱基95售05  ,0,0,0,0,0,0,0,0,0,6000,0,0,0,6000,0,6000,6000
053430,樺漢永豐96購01  ,0,0,0,0,0,0,0,0,0,6000,0,0,0,6000,0,6000,6000
055403,泰鼎元富97購01  ,0,0,0,0,0,0,0,0,0,6000,0,0,0,6000,0,6000,6000
055378,晶相光元大97購02,6000,0,6000,0,0,0,0,0,0,0,0,0,0,0,0,0,6000
056517,茂林兆豐99購01  ,0,0,0,0,0,0,0,0,0,6000,0,0,0,16000,10000,6000,6000
055360,台表科凱基97購02,0,0,0,0,0,0,0,0,0,6000,0,0,0,6000,0,6000,6000
053666,臺股指凱基96購29,0,0,0,0,0,0,0,0,0,6000,0,0,0,6000,0,6000,6000
055449,超眾統一9A購01  ,0,0,0,0,0,0,0,0,0,6000,0,0,0,73000,67000,6000,6000
057501,超眾群益98購04  ,0,0,0,0,0,0,0,0,0,6000,0,0,0,6000,0,6000,6000
053781,友達元大9B購03  ,0,0,0,0,0,0,0,0,0,6000,0,0,0,6000,0,6000,6000
05430P,台積電統一95售07,0,0,0,0,0,0,0,0,0,6000,0,0,0,7000,1000,6000,6000
052772,台虹群益96購01  ,0,0,0,0,0,0,0,0,0,6000,0,0,0,60000,54000,6000,6000
053080,力山元大96購02  ,0,0,0,0,0,0,0,0,0,6000,0,0,0,6000,0,6000,6000
054922,文曄凱基98購01  ,0,0,0,0,0,0,0,0,0,6000,0,0,0,6000,0,6000,6000
054959,禾伸堂元大98購01,0,0,0,0,0,0,0,0,0,6000,0,0,0,6000,0,6000,6000
054819,裕民元大9A購01  ,0,0,0,0,0,0,0,0,0,6000,0,0,0,306000,300000,6000,6000
054406,旺宏國票98購01  ,0,0,0,0,0,0,0,0,0,6000,0,0,0,11000,5000,6000,6000
0054,元大台商50      ,0,0,0,0,0,0,0,0,0,6000,0,0,0,6000,0,6000,6000
04289P,臺股指中信95售07,0,0,0,0,0,0,0,0,0,6000,0,0,0,8000,2000,6000,6000
043442,大立光台新01購01,0,0,0,0,0,0,0,0,0,6000,0,0,0,8000,2000,6000,6000
03674C,臺股指元富9C牛02,0,0,0,0,0,0,0,0,0,6000,0,0,0,7000,1000,6000,6000
03647C,T50反1元富99牛02,0,0,0,0,0,0,0,0,0,6000,0,0,0,170000,164000,6000,6000
051911,大立光元大98購02,0,0,0,0,0,0,0,0,0,6000,0,0,0,6000,0,6000,6000
050847,創意國票96購01  ,0,0,0,0,0,0,0,0,0,6000,0,0,0,26000,20000,6000,6000
05388P,南亞科元大95售04,0,0,0,0,0,0,0,0,0,6000,0,0,0,6000,0,6000,6000
059083,華通元大99購07  ,0,0,0,0,0,0,0,0,0,6000,0,0,0,28000,22000,6000,6000
058985,可成凱基99購03  ,0,0,0,0,0,0,0,0,0,6000,0,0,0,6000,0,6000,6000
058932,FBVIX台新99購01 ,0,0,0,0,0,0,0,0,0,6000,0,0,0,19000,13000,6000,6000
058920,SGBR2X元富99購06,0,0,0,0,0,0,0,0,0,6000,0,0,0,56000,50000,6000,6000
058767,亞德客兆豐99購01,0,0,0,0,0,0,0,0,0,6000,0,0,0,6000,0,6000,6000
058823,聯發科富邦9C購01,0,0,0,0,0,0,0,0,0,6000,0,0,0,11000,5000,6000,6000
05888P,友達元大97售01  ,0,0,0,0,0,0,0,0,0,6000,0,0,0,6000,0,6000,6000
058520,智易元大99購03  ,0,0,0,0,0,0,0,0,0,6000,0,0,0,25000,19000,6000,6000
057814,聯發科元大98購12,0,0,0,0,0,0,0,0,0,6000,0,0,0,6000,0,6000,6000
056469,國巨元大99購01  ,0,0,0,0,0,0,0,0,0,6000,0,0,0,6000,0,6000,6000
056110,嘉聯益永豐97購02,0,0,0,0,0,0,0,0,0,6000,0,0,0,52000,46000,6000,6000
057749,華新科國票99購01,0,0,0,0,0,0,0,0,0,6000,0,0,0,6000,0,6000,6000
057365,智邦元大98購07  ,0,0,0,0,0,0,0,0,0,6000,0,0,0,15000,9000,6000,6000
055561,奇鋐凱基97購01  ,0,0,0,0,0,0,0,0,0,6000,0,0,0,6000,0,6000,6000
055157,晶豪科元大97購01,0,0,0,0,0,0,0,0,0,6000,0,0,0,6000,0,6000,6000
058387,國巨國票9A購03  ,0,0,0,0,0,0,0,0,0,6000,0,0,0,240000,234000,6000,6000
058389,聯茂國票9A購01  ,0,0,0,0,0,0,0,0,0,6000,0,0,0,7000,1000,6000,6000
057853,旺宏國票99購05  ,0,0,0,0,0,0,0,0,0,6000,0,0,0,6000,0,6000,6000
2450,神腦            ,79000,73000,6000,0,0,0,0,0,0,0,0,0,0,0,0,0,6000
2425,承啟            ,126000,120000,6000,0,0,0,0,0,0,0,0,0,0,0,0,0,6000
1760,寶齡富錦        ,7000,0,7000,0,0,0,0,0,0,-1000,0,1000,-1000,0,0,0,6000
1529,樂士            ,7000,2000,5000,0,0,0,0,0,0,1000,1000,0,1000,0,0,0,6000
1465,偉全            ,31000,25000,6000,0,0,0,0,0,0,0,0,0,0,0,0,0,6000
07294P,滬深2X元富9C售08,0,0,0,0,0,0,0,0,0,6000,0,0,0,6000,0,6000,6000
6115,鎰勝            ,28000,21000,7000,0,0,0,0,0,0,-1000,0,1000,-1000,0,0,0,6000
6164,華興            ,12000,6000,6000,0,0,0,0,0,0,0,0,0,0,0,0,0,6000
3416,融程電          ,6000,0,6000,0,0,0,0,0,0,0,0,0,0,0,0,0,6000
4545,銘鈺            ,11000,5000,6000,0,0,0,0,0,0,0,0,0,0,0,0,0,6000
8072,陞泰            ,9000,3000,6000,0,0,0,0,0,0,0,0,0,0,0,0,0,6000
8478,東哥遊艇        ,11000,5000,6000,0,0,0,0,0,0,0,0,0,0,0,0,0,6000
059793,滬深2X國票99購03,0,0,0,0,0,0,0,0,0,5000,0,0,0,5000,0,5000,5000
059585,台灣50元大9C購10,0,0,0,0,0,0,0,0,0,5000,0,0,0,5000,0,5000,5000
059554,台灣50凱基99購08,0,0,0,0,0,0,0,0,0,5000,0,0,0,5000,0,5000,5000
059370,玉晶光元富99購02,0,0,0,0,0,0,0,0,0,5000,0,0,0,251000,246000,5000,5000
059415,台灣50元大9A購03,0,0,0,0,0,0,0,0,0,5000,0,0,0,5000,0,5000,5000
059935,國巨永豐99購07  ,0,0,0,0,0,0,0,0,0,5000,0,0,0,21000,16000,5000,5000
059974,臺指反元大9C購05,0,0,0,0,0,0,0,0,0,5000,0,0,0,5000,0,5000,5000
059976,道瓊銀元大99購01,0,0,0,0,0,0,0,0,0,5000,0,0,0,5000,0,5000,5000
060359,國巨元富9A購02  ,0,0,0,0,0,0,0,0,0,5000,0,0,0,5000,0,5000,5000
06015P,大立光富邦98售04,0,0,0,0,0,0,0,0,0,5000,0,0,0,5000,0,5000,5000
060673,旺宏元大9A購04  ,0,0,0,0,0,0,0,0,0,5000,0,0,0,35000,30000,5000,5000
060770,宏達電麥證9A購01,0,0,0,47000,42000,5000,0,0,0,5000,0,0,0,47000,42000,5000,5000
060575,大立光中信9B購02,0,0,0,0,0,0,0,0,0,5000,0,0,0,5000,0,5000,5000
060631,微星富邦9B購01  ,0,0,0,0,0,0,0,0,0,5000,0,0,0,55000,50000,5000,5000
060838,華通國票9A購05  ,0,0,0,0,0,0,0,0,0,5000,0,0,0,13000,8000,5000,5000
060941,台積電國票9B購04,0,0,0,0,0,0,0,0,0,5000,0,0,0,5000,0,5000,5000
060998,華通兆豐9A購01  ,0,0,0,0,0,0,0,0,0,5000,0,0,0,30000,25000,5000,5000
061078,台積電兆豐9A購01,0,0,0,0,0,0,0,0,0,5000,0,0,0,5000,0,5000,5000
061171,大立光麥證9A購01,0,0,0,5000,0,5000,0,0,0,5000,0,0,0,5000,0,5000,5000
061149,華通群益9A購05  ,0,0,0,0,0,0,0,0,0,5000,0,0,0,138000,133000,5000,5000
061324,華新科凱基9C購01,0,0,0,0,0,0,0,0,0,5000,0,0,0,5000,0,5000,5000
06219P,國巨元富97售05  ,0,0,0,0,0,0,0,0,0,5000,0,0,0,5000,0,5000,5000
06310P,精元元富97售02  ,0,0,0,0,0,0,0,0,0,5000,0,0,0,5000,0,5000,5000
06494P,鴻海永昌98售03  ,0,0,0,0,0,0,0,0,0,5000,0,0,0,15000,10000,5000,5000
06453P,群創元大9B售02  ,0,0,0,0,0,0,0,0,0,5000,0,0,0,5000,0,5000,5000
06564P,國巨富邦9A售04  ,0,0,0,0,0,0,0,0,0,5000,0,0,0,27000,22000,5000,5000
06706P,智原台新98售02  ,0,0,0,0,0,0,0,0,0,5000,0,0,0,5000,0,5000,5000
053887,聯茂兆豐97購02  ,0,0,0,0,0,0,0,0,0,5000,0,0,0,5000,0,5000,5000
053969,瑞昱元大97購01  ,0,0,0,0,0,0,0,0,0,5000,0,0,0,5000,0,5000,5000
053987,宏碁亞東96購01  ,0,0,0,0,0,0,0,0,0,5000,0,0,0,5000,0,5000,5000
052575,茂林凱基96購04  ,0,0,0,0,0,0,0,0,0,5000,0,0,0,5000,0,5000,5000
052352,力成元富95購01  ,0,0,0,0,0,0,0,0,0,5000,0,0,0,5000,0,5000,5000
052383,臺股指元大95購29,0,0,0,0,0,0,0,0,0,5000,0,0,0,5000,0,5000,5000
051397,聯茂兆豐95購03  ,0,0,0,0,0,0,0,0,0,5000,0,0,0,5000,0,5000,5000
051384,康友群益95購01  ,0,0,0,0,0,0,0,0,0,5000,0,0,0,5000,0,5000,5000
050996,隆達元大95購01  ,0,0,0,0,0,0,0,0,0,5000,0,0,0,5000,0,5000,5000
050773,京鼎元大94購02  ,0,0,0,0,0,0,0,0,0,5000,0,0,0,5000,0,5000,5000
050685,緯穎元富94購02  ,0,0,0,0,0,0,0,0,0,5000,0,0,0,5000,0,5000,5000
05116P,台積電群益95售03,0,0,0,0,0,0,0,0,0,5000,0,0,0,5000,0,5000,5000
051055,友達群益98購01  ,0,0,0,0,0,0,0,0,0,5000,0,0,0,10000,5000,5000,5000
05194P,玉晶光康和95售01,0,0,0,0,0,0,0,0,0,5000,0,0,0,5000,0,5000,5000
051775,旺宏亞東95購01  ,0,0,0,0,0,0,0,0,0,5000,0,0,0,5000,0,5000,5000
051850,臻鼎中信96購01  ,0,0,0,0,0,0,0,0,0,5000,0,0,0,5000,0,5000,5000
051895,聯茂元富95購02  ,0,0,0,0,0,0,0,0,0,5000,0,0,0,5000,0,5000,5000
051305,訊連凱基96購01  ,0,0,0,0,0,0,0,0,0,5000,0,0,0,5000,0,5000,5000
052089,聯發科元大96購02,0,0,0,0,0,0,0,0,0,5000,0,0,0,5000,0,5000,5000
03436B,臺股指元富99熊13,0,0,0,0,0,0,0,0,0,5000,0,0,0,5000,0,5000,5000
03428B,臺股指凱基97熊18,0,0,0,0,0,0,0,0,0,5000,0,0,0,65000,60000,5000,5000
052200,台光電統一95購02,0,0,0,0,0,0,0,0,0,5000,0,0,0,5000,0,5000,5000
03424B,臺股指元大96熊26,0,0,0,0,0,0,0,0,0,5000,0,0,0,5000,0,5000,5000
03012X,元展12          ,0,0,0,0,0,0,0,0,0,5000,0,0,0,5000,0,5000,5000
047410,上銀元富96購01  ,0,0,0,0,0,0,0,0,0,5000,0,0,0,60000,55000,5000,5000
046903,友達凱基99購01  ,0,0,0,0,0,0,0,0,0,5000,0,0,0,5000,0,5000,5000
050311,上銀兆豐95購01  ,0,0,0,0,0,0,0,0,0,5000,0,0,0,5000,0,5000,5000
050228,中磊中信96購01  ,0,0,0,0,0,0,0,0,0,5000,0,0,0,15000,10000,5000,5000
04931P,臻鼎元富94售09  ,0,0,0,0,0,0,0,0,0,5000,0,0,0,5000,0,5000,5000
049585,旺宏元大95購02  ,0,0,0,0,0,0,0,0,0,5000,0,0,0,5000,0,5000,5000
049700,瀚宇博元大97購01,0,0,0,0,0,0,0,0,0,5000,0,0,0,121000,116000,5000,5000
049017,旺宏群益96購03  ,0,0,0,0,0,0,0,0,0,5000,0,0,0,5000,0,5000,5000
047780,友達中信96購01  ,0,0,0,0,0,0,0,0,0,5000,0,0,0,5000,0,5000,5000
048070,聯發科元富99購03,0,0,0,0,0,0,0,0,0,5000,0,0,0,5000,0,5000,5000
048732,台勝科麥證95購01,0,0,0,5000,0,5000,0,0,0,5000,0,0,0,5000,0,5000,5000
0053,元大電子        ,0,0,0,0,0,0,0,0,0,5000,0,0,0,6000,1000,5000,5000
047572,深中小群益95購01,0,0,0,0,0,0,0,0,0,5000,0,0,0,5000,0,5000,5000
00865B,國泰US短期公債  ,0,0,0,0,0,0,0,0,0,5000,0,0,0,105000,100000,5000,5000
054410,國巨元大96購14  ,0,0,0,0,0,0,0,0,0,5000,0,0,0,5000,0,5000,5000
054412,智邦元大96購03  ,0,0,0,0,0,0,0,0,0,5000,0,0,0,5000,0,5000,5000
054421,臺股指元大99購03,0,0,0,0,0,0,0,0,0,5000,0,0,0,5000,0,5000,5000
053357,可成統一96購02  ,0,0,0,0,0,0,0,0,0,5000,0,0,0,5000,0,5000,5000
054961,玉晶光元大99購01,0,0,0,0,0,0,0,0,0,5000,0,0,0,10000,5000,5000,5000
052980,上銀元大96購03  ,0,0,0,0,0,0,0,0,0,5000,0,0,0,5000,0,5000,5000
052887,華通中信96購01  ,0,0,0,0,0,0,0,0,0,5000,0,0,0,5000,0,5000,5000
054886,大毅統一97購01  ,0,0,0,0,0,0,0,0,0,5000,0,0,0,27000,22000,5000,5000
052777,燿華國票98購01  ,0,0,0,0,0,0,0,0,0,5000,0,0,0,59000,54000,5000,5000
054117,宏全康和96購01  ,0,0,0,0,0,0,0,0,0,5000,0,0,0,5000,0,5000,5000
05270P,台表科元大95售05,0,0,0,0,0,0,0,0,0,5000,0,0,0,5000,0,5000,5000
054065,樺漢國票97購01  ,0,0,0,0,0,0,0,0,0,5000,0,0,0,5000,0,5000,5000
053995,奇力新群益97購02,0,0,0,0,0,0,0,0,0,5000,0,0,0,5000,0,5000,5000
054306,聯發科凱基96購23,0,0,0,0,0,0,0,0,0,5000,0,0,0,36000,31000,5000,5000
054303,國巨凱基96購15  ,0,0,0,0,0,0,0,0,0,5000,0,0,0,15000,10000,5000,5000
054254,晶豪科元大96購02,0,0,0,0,0,0,0,0,0,5000,0,0,0,50000,45000,5000,5000
053769,香港反元大99購01,0,0,0,0,0,0,0,0,0,5000,0,0,0,5000,0,5000,5000
053710,華通凱基96購05  ,0,0,0,0,0,0,0,0,0,5000,0,0,0,75000,70000,5000,5000
056484,聯茂元大98購02  ,0,0,0,0,0,0,0,0,0,5000,0,0,0,5000,0,5000,5000
053445,可成凱基96購04  ,0,0,0,0,0,0,0,0,0,5000,0,0,0,5000,0,5000,5000
053456,大立光元富96購04,0,0,0,0,0,0,0,0,0,5000,0,0,0,5000,0,5000,5000
053375,鴻海元大96購18  ,0,0,0,0,0,0,0,0,0,5000,0,0,0,5000,0,5000,5000
054504,聯鈞永豐96購01  ,0,0,0,0,0,0,0,0,0,5000,0,0,0,5000,0,5000,5000
054575,聯鈞元大97購01  ,0,0,0,0,0,0,0,0,0,5000,0,0,0,5000,0,5000,5000
053151,華新科元大96購04,0,0,0,0,0,0,0,0,0,5000,0,0,0,5000,0,5000,5000
053155,晶技元大97購02  ,0,0,0,0,0,0,0,0,0,5000,0,0,0,5000,0,5000,5000
058184,鴻海永豐99購01  ,0,0,0,0,0,0,0,0,0,5000,0,0,0,5000,0,5000,5000
057902,嘉晶永豐98購02  ,0,0,0,0,0,0,0,0,0,5000,0,0,0,10000,5000,5000,5000
057908,國泰金亞東99購01,0,0,0,0,0,0,0,0,0,5000,0,0,0,5000,0,5000,5000
058317,國巨永豐99購02  ,0,0,0,0,0,0,0,0,0,5000,0,0,0,205000,200000,5000,5000
055205,京鼎中信99購01  ,0,0,0,0,0,0,0,0,0,5000,0,0,0,5000,0,5000,5000
056757,T50反1元大98購07,0,0,0,0,0,0,0,0,0,5000,0,0,0,5000,0,5000,5000
055573,國巨統一97購06  ,0,0,0,0,0,0,0,0,0,5000,0,0,0,5000,0,5000,5000
05558P,鴻海麥證96售01  ,0,0,0,5000,0,5000,0,0,0,5000,0,0,0,5000,0,5000,5000
057421,智原凱基98購04  ,0,0,0,0,0,0,0,0,0,5000,0,0,0,15000,10000,5000,5000
05721P,全新群益98售02  ,0,0,0,0,0,0,0,0,0,5000,0,0,0,5000,0,5000,5000
05720P,可成中信98售01  ,0,0,0,0,0,0,0,0,0,5000,0,0,0,5000,0,5000,5000
057582,亞光中信9A購02  ,0,0,0,0,0,0,0,0,0,5000,0,0,0,5000,0,5000,5000
057123,上銀凱基98購05  ,0,0,0,0,0,0,0,0,0,5000,0,0,0,15000,10000,5000,5000
057628,旺宏永豐98購02  ,0,0,0,0,0,0,0,0,0,5000,0,0,0,6000,1000,5000,5000
057742,喬山永豐98購02  ,0,0,0,0,0,0,0,0,0,5000,0,0,0,5000,0,5000,5000
057056,立積元大99購02  ,0,0,0,0,0,0,0,0,0,5000,0,0,0,31000,26000,5000,5000
055875,光罩元富97購02  ,0,0,0,0,0,0,0,0,0,5000,0,0,0,95000,90000,5000,5000
057660,訊芯兆豐98購02  ,0,0,0,0,0,0,0,0,0,5000,0,0,0,5000,0,5000,5000
056427,上銀凱基98購03  ,0,0,0,0,0,0,0,0,0,5000,0,0,0,5000,0,5000,5000
056408,奇鋐國票99購01  ,0,0,0,0,0,0,0,0,0,5000,0,0,0,38000,33000,5000,5000
056310,神達元大97購02  ,0,0,0,0,0,0,0,0,0,5000,0,0,0,5000,0,5000,5000
05631P,國巨富邦9A售01  ,0,0,0,0,0,0,0,0,0,5000,0,0,0,8000,3000,5000,5000
05629P,聯發科永昌99售02,0,0,0,0,0,0,0,0,0,5000,0,0,0,5000,0,5000,5000
058600,國巨元大99購15  ,0,0,0,0,0,0,0,0,0,5000,0,0,0,5000,0,5000,5000
058633,台灣50兆豐99購01,0,0,0,0,0,0,0,0,0,5000,0,0,0,5000,0,5000,5000
058698,華通元大99購05  ,0,0,0,0,0,0,0,0,0,5000,0,0,0,10000,5000,5000,5000
058897,國巨元大99購17  ,0,0,0,0,0,0,0,0,0,5000,0,0,0,6000,1000,5000,5000
058856,新光金兆豐99購01,0,0,0,0,0,0,0,0,0,5000,0,0,0,40000,35000,5000,5000
058828,大毅永豐99購01  ,0,0,0,0,0,0,0,0,0,5000,0,0,0,20000,15000,5000,5000
058960,臺股指國票99購05,0,0,0,0,0,0,0,0,0,5000,0,0,0,8000,3000,5000,5000
059064,緯穎凱基99購02  ,0,0,0,0,0,0,0,0,0,5000,0,0,0,10000,5000,5000,5000
059069,臺指反元大9C購01,0,0,0,0,0,0,0,0,0,5000,0,0,0,45000,40000,5000,5000
059058,可成凱基9B購01  ,0,0,0,0,0,0,0,0,0,5000,0,0,0,13000,8000,5000,5000
3701,大眾控          ,7000,2000,5000,0,0,0,0,0,0,0,0,0,0,0,0,0,5000
3296,勝德            ,8000,3000,5000,0,0,0,0,0,0,0,0,0,0,0,0,0,5000
5484,慧友            ,5000,0,5000,0,0,0,0,0,0,0,0,0,0,0,0,0,5000
07474P,滬深2X群益9C售03,0,0,0,0,0,0,0,0,0,5000,0,0,0,7000,2000,5000,5000
07408P,台積電兆豐99售06,0,0,0,0,0,0,0,0,0,5000,0,0,0,50000,45000,5000,5000
07602P,台積電統一9A售07,0,0,0,0,0,0,0,0,0,5000,0,0,0,5000,0,5000,5000
07661P,台灣50兆豐9A售03,0,0,0,0,0,0,0,0,0,5000,0,0,0,5000,0,5000,5000
06887P,華新科元大98售04,0,0,0,0,0,0,0,0,0,5000,0,0,0,10000,5000,5000,5000
06911P,鴻海元大99售09  ,0,0,0,0,0,0,0,0,0,5000,0,0,0,5000,0,5000,5000
06920P,台灣50凱基9A售01,0,0,0,0,0,0,0,0,0,5000,0,0,0,5000,0,5000,5000
06984P,上銀富邦9B售01  ,0,0,0,0,0,0,0,0,0,5000,0,0,0,26000,21000,5000,5000
06992P,玉晶光日盛9B售01,0,0,0,0,0,0,0,0,0,5000,0,0,0,5000,0,5000,5000
07271P,台灣50元大9C售04,0,0,0,0,0,0,0,0,0,5000,0,0,0,5000,0,5000,5000
07265P,大立光元大99售16,0,0,0,0,0,0,0,0,0,5000,0,0,0,25000,20000,5000,5000
07199P,臺股指元大99售15,0,0,0,0,0,0,0,0,0,5000,0,0,0,5000,0,5000,5000
07086P,力成元富9C售01  ,0,0,0,0,0,0,0,0,0,5000,0,0,0,5000,0,5000,5000
07123P,鴻海元大99售23  ,0,0,0,0,0,0,0,0,0,5000,0,0,0,5000,0,5000,5000
1456,怡華            ,5000,0,5000,0,0,0,0,0,0,0,0,0,0,0,0,0,5000
07740P,臺股指永豐9A售01,0,0,0,0,0,0,0,0,0,5000,0,0,0,5000,0,5000,5000
1220,台榮            ,3000,0,3000,0,0,0,0,0,0,2000,2000,0,2000,0,0,0,5000
1527,鑽全            ,225000,220000,5000,0,0,0,0,0,0,0,0,0,0,0,0,0,5000
1539,巨庭            ,5000,0,5000,0,0,0,0,0,0,0,0,0,0,0,0,0,5000
2002A,中鋼特          ,0,0,0,0,0,0,0,0,0,5000,5000,0,5000,0,0,0,5000
2029,盛餘            ,50000,45000,5000,0,0,0,0,0,0,0,0,0,0,0,0,0,5000
2491,吉祥全          ,9000,4000,5000,0,0,0,0,0,0,0,0,0,0,0,0,0,5000
2302,麗正            ,31000,26000,5000,0,0,0,0,0,0,0,0,0,0,0,0,0,5000
2528,皇普            ,5000,0,5000,0,0,0,0,0,0,0,0,0,0,0,0,0,5000
06766P,玉晶光元大99售10,0,0,0,0,0,0,0,0,0,4000,0,0,0,67000,63000,4000,4000
06582P,可成凱基98售06  ,0,0,0,0,0,0,0,0,0,4000,0,0,0,6000,2000,4000,4000
06679P,旺宏元大98售09  ,0,0,0,0,0,0,0,0,0,4000,0,0,0,240000,236000,4000,4000
06477P,緯穎國票99售02  ,0,0,0,0,0,0,0,0,0,4000,0,0,0,104000,100000,4000,4000
06150P,奇力新元大97售06,0,0,0,0,0,0,0,0,0,4000,0,0,0,28000,24000,4000,4000
061321,華新科凱基9A購09,0,0,0,0,0,0,0,0,0,4000,0,0,0,7000,3000,4000,4000
061314,滬深2X凱基9B購06,0,0,0,0,0,0,0,0,0,4000,0,0,0,5000,1000,4000,4000
061390,大立光群益9A購04,0,0,0,0,0,0,0,0,0,4000,0,0,0,60000,56000,4000,4000
061408,華新科國票9A購06,0,0,0,0,0,0,0,0,0,4000,0,0,0,4000,0,4000,4000
061277,智邦台新9A購01  ,0,0,0,0,0,0,0,0,0,4000,0,0,0,14000,10000,4000,4000
060935,T50反1國票9A購08,0,0,0,0,0,0,0,0,0,4000,0,0,0,4000,0,4000,4000
06081P,深中小元大97售02,0,0,0,0,0,0,0,0,0,4000,0,0,0,4000,0,4000,4000
060513,緯穎元大9B購01  ,0,0,0,0,0,0,0,0,0,4000,0,0,0,5000,1000,4000,4000
060557,南電凱基9A購02  ,0,0,0,0,0,0,0,0,0,4000,0,0,0,9000,5000,4000,4000
060802,道瓊指中信9C購03,0,0,0,0,0,0,0,0,0,4000,0,0,0,4000,0,4000,4000
060232,友訊元大9C購01  ,0,0,0,0,0,0,0,0,0,4000,0,0,0,72000,68000,4000,4000
060229,楠梓電元大9C購01,0,0,0,0,0,0,0,0,0,4000,0,0,0,64000,60000,4000,4000
059973,A50正2元大99購02,0,0,0,0,0,0,0,0,0,4000,0,0,0,4000,0,4000,4000
060102,禾伸堂元大99購06,0,0,0,0,0,0,0,0,0,4000,0,0,0,16000,12000,4000,4000
059451,國巨永豐99購05  ,0,0,0,0,0,0,0,0,0,4000,0,0,0,15000,11000,4000,4000
059292,華新科元富9B購02,0,0,0,0,0,0,0,0,0,4000,0,0,0,5000,1000,4000,4000
059149,臺股指國票99購12,0,0,0,0,0,0,0,0,0,4000,0,0,0,4000,0,4000,4000
059199,欣興永豐99購02  ,0,0,0,0,0,0,0,0,0,4000,0,0,0,4000,0,4000,4000
059191,茂林富邦9B購01  ,0,0,0,0,0,0,0,0,0,4000,0,0,0,70000,66000,4000,4000
059483,臺股指群益99購17,0,0,0,0,0,0,0,0,0,4000,0,0,0,4000,0,4000,4000
059489,上証2X國票9A購01,0,0,0,0,0,0,0,0,0,4000,0,0,0,4000,0,4000,4000
059510,華新科永豐99購07,0,0,0,0,0,0,0,0,0,4000,0,0,0,4000,0,4000,4000
059617,A50正2群益01購02,0,0,0,0,0,0,0,0,0,4000,0,0,0,5000,1000,4000,4000
059647,超眾凱基99購04  ,0,0,0,0,0,0,0,0,0,4000,0,0,0,28000,24000,4000,4000
059679,國巨國泰9B購03  ,0,0,0,0,0,0,0,0,0,4000,0,0,0,4000,0,4000,4000
053209,台積電凱基96購07,0,0,0,0,0,0,0,0,0,4000,0,0,0,8000,4000,4000,4000
055351,聯發科凱基97購03,0,0,0,0,0,0,0,0,0,4000,0,0,0,18000,14000,4000,4000
055441,緯穎國票98購01  ,0,0,0,0,0,0,0,0,0,4000,0,0,0,4000,0,4000,4000
055420,欣興永豐98購01  ,0,0,0,0,0,0,0,0,0,4000,0,0,0,4000,0,4000,4000
056567,瀚宇博群益98購02,0,0,0,0,0,0,0,0,0,4000,0,0,0,55000,51000,4000,4000
053825,南電群益96購02  ,0,0,0,0,0,0,0,0,0,4000,0,0,0,4000,0,4000,4000
054297,台郡元大98購01  ,0,0,0,0,0,0,0,0,0,4000,0,0,0,4000,0,4000,4000
052729,國巨國泰97購03  ,0,0,0,0,0,0,0,0,0,4000,0,0,0,4000,0,4000,4000
052819,義隆永豐96購01  ,0,0,0,0,0,0,0,0,0,4000,0,0,0,20000,16000,4000,4000
053051,楠梓電國票97購01,0,0,0,0,0,0,0,0,0,4000,0,0,0,4000,0,4000,4000
054910,信錦凱基97購01  ,0,0,0,0,0,0,0,0,0,4000,0,0,0,4000,0,4000,4000
054822,祥碩元大97購01  ,0,0,0,0,0,0,0,0,0,4000,0,0,0,12000,8000,4000,4000
054390,智邦元富96購03  ,0,0,0,0,0,0,0,0,0,4000,0,0,0,4000,0,4000,4000
054416,禾伸堂元大97購01,0,0,0,0,0,0,0,0,0,4000,0,0,0,54000,50000,4000,4000
05439P,聯發科國票95售06,0,0,0,0,0,0,0,0,0,4000,0,0,0,95000,91000,4000,4000
00688L,國泰20年美債正2 ,0,0,0,0,0,0,0,0,0,4000,0,0,0,104000,100000,4000,4000
048651,美利達元大96購05,0,0,0,0,0,0,0,0,0,4000,0,0,0,271000,267000,4000,4000
048007,明基材元大96購01,0,0,0,0,0,0,0,0,0,4000,0,0,0,4000,0,4000,4000
049436,義隆國泰96購02  ,0,0,0,0,0,0,0,0,0,4000,0,0,0,4000,0,4000,4000
03006X,元展06          ,0,0,0,0,0,0,0,0,0,4000,0,0,0,4000,0,4000,4000
03619C,臺股指元大95牛02,0,0,0,0,0,0,0,0,0,4000,0,0,0,12000,8000,4000,4000
052084,台泥元大95購01  ,0,0,0,0,0,0,0,0,0,4000,0,0,0,98000,94000,4000,4000
052193,國巨元富95購06  ,0,0,0,0,0,0,0,0,0,4000,0,0,0,1491000,1487000,4000,4000
050806,華新科日盛95購01,0,0,0,0,0,0,0,0,0,4000,0,0,0,4000,0,4000,4000
053941,國巨國泰96購05  ,0,0,0,0,0,0,0,0,0,4000,0,0,0,14000,10000,4000,4000
052502,瀚宇博永豐95購02,0,0,0,0,0,0,0,0,0,4000,0,0,0,4000,0,4000,4000
059020,元油2X統一9B購02,0,0,0,0,0,0,0,0,0,4000,0,0,0,20000,16000,4000,4000
059090,台新金元大99購01,0,0,0,0,0,0,0,0,0,4000,0,0,0,148000,144000,4000,4000
058774,台郡兆豐9A購01  ,0,0,0,0,0,0,0,0,0,4000,0,0,0,10000,6000,4000,4000
058697,亞德客元大99購01,0,0,0,0,0,0,0,0,0,4000,0,0,0,4000,0,4000,4000
058581,大立光群益99購05,0,0,0,0,0,0,0,0,0,4000,0,0,0,4000,0,4000,4000
05630P,大立光永昌96售06,0,0,0,0,0,0,0,0,0,4000,0,0,0,4000,0,4000,4000
056363,華新科元大99購04,0,0,0,0,0,0,0,0,0,4000,0,0,0,4000,0,4000,4000
055892,國巨統一99購01  ,0,0,0,0,0,0,0,0,0,4000,0,0,0,54000,50000,4000,4000
057688,國巨凱基99購07  ,0,0,0,0,0,0,0,0,0,4000,0,0,0,4000,0,4000,4000
057634,道瓊反元大99購01,0,0,0,0,0,0,0,0,0,4000,0,0,0,4000,0,4000,4000
056700,華新科國泰99購03,0,0,0,0,0,0,0,0,0,4000,0,0,0,4000,0,4000,4000
058115,台光電中信99購01,0,0,0,0,0,0,0,0,0,4000,0,0,0,60000,56000,4000,4000
055521,S&P反1群益01購01,0,0,0,0,0,0,0,0,0,4000,0,0,0,6000,2000,4000,4000
055789,台虹凱基97購01  ,0,0,0,0,0,0,0,0,0,4000,0,0,0,4000,0,4000,4000
05764P,世紀鋼永豐96售03,0,0,0,0,0,0,0,0,0,4000,0,0,0,5000,1000,4000,4000
058411,技嘉兆豐99購01  ,0,0,0,0,0,0,0,0,0,4000,0,0,0,4000,0,4000,4000
058276,道瓊指中信9C購01,0,0,0,0,0,0,0,0,0,4000,0,0,0,4000,0,4000,4000
2936,客思達-KY       ,4000,0,4000,0,0,0,0,0,0,0,0,0,0,0,0,0,4000
2024,志聯            ,4000,0,4000,0,0,0,0,0,0,0,0,0,0,0,0,0,4000
1737,臺鹽            ,36000,32000,4000,0,0,0,0,0,0,0,0,0,0,0,0,0,4000
1525,江申            ,16000,2000,14000,0,0,0,0,10000,-10000,0,0,0,0,0,0,0,4000
07756P,台灣50國票04售01,0,0,0,0,0,0,0,0,0,4000,0,0,0,4000,0,4000,4000
07745P,華新科凱基9A售10,0,0,0,0,0,0,0,0,0,4000,0,0,0,12000,8000,4000,4000
07124P,台積電元大99售21,0,0,0,0,0,0,0,0,0,4000,0,0,0,21000,17000,4000,4000
07114P,旺宏兆豐9A售01  ,0,0,0,0,0,0,0,0,0,4000,0,0,0,4000,0,4000,4000
07070P,晶相光元富99售01,0,0,0,0,0,0,0,0,0,4000,0,0,0,4000,0,4000,4000
07655P,台灣50凱基01售09,0,0,0,0,0,0,0,0,0,4000,0,0,0,4000,0,4000,4000
07672P,南電元大9A售05  ,0,0,0,0,0,0,0,0,0,4000,0,0,0,60000,56000,4000,4000
07360P,台積電元大99售46,0,0,0,0,0,0,0,0,0,4000,0,0,0,264000,260000,4000,4000
4581,光隆精密-KY     ,4000,0,4000,0,0,0,0,0,0,0,0,0,0,0,0,0,4000
6405,悅城            ,9000,5000,4000,0,0,0,0,0,0,0,0,0,0,0,0,0,4000
3686,達能            ,31000,27000,4000,0,0,0,0,0,0,0,0,0,0,0,0,0,4000
059648,台表科凱基99購03,0,0,0,0,0,0,0,0,0,3000,0,0,0,3000,0,3000,3000
059732,超眾元大9A購01  ,0,0,0,0,0,0,0,0,0,3000,0,0,0,18000,15000,3000,3000
059621,T50正2凱基9C購04,0,0,0,0,0,0,0,0,0,3000,0,0,0,3000,0,3000,3000
059600,緯穎元大99購07  ,0,0,0,0,0,0,0,0,0,3000,0,0,0,3000,0,3000,3000
059463,台灣50元大9C購07,0,0,0,0,0,0,0,0,0,3000,0,0,0,3000,0,3000,3000
059539,緯穎凱基99購03  ,0,0,0,0,0,0,0,0,0,3000,0,0,0,3000,0,3000,3000
059194,元金2X永豐99購01,0,0,0,0,0,0,0,0,0,3000,0,0,0,7000,4000,3000,3000
059361,玉晶光永豐99購04,0,0,0,0,0,0,0,0,0,3000,0,0,0,11000,8000,3000,3000
05936P,台積電凱基96售20,0,0,0,0,0,0,0,0,0,3000,0,0,0,13000,10000,3000,3000
05937P,台積電凱基96售21,0,0,0,0,0,0,0,0,0,3000,0,0,0,3000,0,3000,3000
059386,上銀凱基99購07  ,0,0,0,0,0,0,0,0,0,3000,0,0,0,26000,23000,3000,3000
060136,T50反1國票9A購01,0,0,0,0,0,0,0,0,0,3000,0,0,0,3000,0,3000,3000
060031,旭富永豐99購02  ,0,0,0,0,0,0,0,0,0,3000,0,0,0,66000,63000,3000,3000
059979,台積電元大99購49,0,0,0,0,0,0,0,0,0,3000,0,0,0,3000,0,3000,3000
059966,台積電凱基99購19,0,0,0,0,0,0,0,0,0,3000,0,0,0,3000,0,3000,3000
060151,旺宏富邦9A購02  ,0,0,0,0,0,0,0,0,0,3000,0,0,0,39000,36000,3000,3000
060687,GIS元大9A購01   ,0,0,0,0,0,0,0,0,0,3000,0,0,0,292000,289000,3000,3000
060700,華新科國泰9C購01,0,0,0,0,0,0,0,0,0,3000,0,0,0,559000,556000,3000,3000
06057P,大立光凱基98售01,0,0,0,0,0,0,0,0,0,3000,0,0,0,3000,0,3000,3000
061061,聯發科麥證9A購02,0,0,0,3000,0,3000,0,0,0,3000,0,0,0,3000,0,3000,3000
061057,華新科國票9A購04,0,0,0,0,0,0,0,0,0,3000,0,0,0,3000,0,3000,3000
06100P,台積電日盛97售03,0,0,0,0,0,0,0,0,0,3000,0,0,0,23000,20000,3000,3000
06525P,上証2X國泰99售01,0,0,0,0,0,0,0,0,0,3000,0,0,0,10000,7000,3000,3000
06546P,聯發科元大98售05,0,0,0,0,0,0,0,0,0,3000,0,0,0,3000,0,3000,3000
06547P,大立光元大98售09,0,0,0,0,0,0,0,0,0,3000,0,0,0,3000,0,3000,3000
06373P,聯發科元大97售22,0,0,0,0,0,0,0,0,0,3000,0,0,0,94000,91000,3000,3000
06615P,鴻海元大9C售02  ,0,0,0,0,0,0,0,0,0,3000,0,0,0,3000,0,3000,3000
06751P,旺宏凱基98售10  ,0,0,0,0,0,0,0,0,0,3000,0,0,0,4000,1000,3000,3000
052658,友達元富9C購01  ,0,0,0,0,0,0,0,0,0,3000,0,0,0,3000,0,3000,3000
052369,矽力國票96購02  ,0,0,0,0,0,0,0,0,0,3000,0,0,0,3000,0,3000,3000
052276,力成群益96購01  ,0,0,0,0,0,0,0,0,0,3000,0,0,0,3000,0,3000,3000
05120P,聯發科國泰97售01,0,0,0,0,0,0,0,0,0,3000,0,0,0,3000,0,3000,3000
051167,京鼎元大95購01  ,0,0,0,0,0,0,0,0,0,3000,0,0,0,3000,0,3000,3000
051728,道瓊反國票97購01,0,0,0,0,0,0,0,0,0,3000,0,0,0,40000,37000,3000,3000
05180P,玉晶光凱基95售04,0,0,0,0,0,0,0,0,0,3000,0,0,0,3000,0,3000,3000
051957,旺宏台新95購02  ,0,0,0,0,0,0,0,0,0,3000,0,0,0,3000,0,3000,3000
03432B,臺股指凱基98熊13,0,0,0,0,0,0,0,0,0,3000,0,0,0,5000,2000,3000,3000
052251,台光電永豐95購03,0,0,0,0,0,0,0,0,0,3000,0,0,0,3000,0,3000,3000
049803,華新科元大95購07,0,0,0,0,0,0,0,0,0,3000,0,0,0,3000,0,3000,3000
05024P,華通國票96售01  ,0,0,0,0,0,0,0,0,0,3000,0,0,0,35000,32000,3000,3000
050099,台積電永昌96購01,0,0,0,0,0,0,0,0,0,3000,0,0,0,23000,20000,3000,3000
050552,禾伸堂凱基94購05,0,0,0,0,0,0,0,0,0,3000,0,0,0,3000,0,3000,3000
050579,聯發科國票95購04,0,0,0,0,0,0,0,0,0,3000,0,0,0,3000,0,3000,3000
048707,南電國票95購01  ,0,0,0,0,0,0,0,0,0,3000,0,0,0,3000,0,3000,3000
049128,滬深2X元大97購03,0,0,0,0,0,0,0,0,0,3000,0,0,0,3000,0,3000,3000
042317,台灣50永豐96購01,0,0,0,0,0,0,0,0,0,3000,0,0,0,3000,0,3000,3000
0057,富邦摩台        ,0,0,0,0,0,0,0,0,0,3000,0,0,0,28000,25000,3000,3000
054394,奇力新永豐96購03,0,0,0,0,0,0,0,0,0,3000,0,0,0,3000,0,3000,3000
053349,台郡國票97購02  ,0,40000,-40000,0,0,0,0,0,0,43000,0,0,0,43000,0,43000,3000
054916,聯發科凱基98購04,0,0,0,0,0,0,0,0,0,3000,0,0,0,3000,0,3000,3000
054120,奇力新永豐96購01,0,0,0,0,0,0,0,0,0,3000,0,0,0,3000,0,3000,3000
054294,世芯元大96購02  ,0,0,0,0,0,0,0,0,0,3000,0,0,0,3000,0,3000,3000
053810,台達電群益96購01,0,0,0,0,0,0,0,0,0,3000,0,0,0,98000,95000,3000,3000
053293,聯發科中信9B購01,0,0,0,0,0,0,0,0,0,3000,0,0,0,3000,0,3000,3000
053294,聯發科中信9C購01,0,0,0,0,0,0,0,0,0,3000,0,0,0,3000,0,3000,3000
05647P,聯發科國票97售02,0,0,0,0,0,0,0,0,0,3000,0,0,0,3000,0,3000,3000
054708,華通統一97購02  ,0,0,0,0,0,0,0,0,0,3000,0,0,0,3000,0,3000,3000
054767,日電貿國票98購01,0,0,0,0,0,0,0,0,0,3000,0,0,0,53000,50000,3000,3000
053568,智伸科富邦98購01,0,0,0,0,0,0,0,0,0,3000,0,0,0,3000,0,3000,3000
053597,牧德元大99購01  ,0,0,0,0,0,0,0,0,0,3000,0,0,0,6000,3000,3000,3000
053619,和碩群益96購01  ,0,0,0,0,0,0,0,0,0,3000,0,0,0,3000,0,3000,3000
05360P,健策元大95售03  ,0,0,0,0,0,0,0,0,0,3000,0,0,0,3000,0,3000,3000
058235,大立光元大99購08,0,0,0,0,0,0,0,0,0,3000,0,0,0,3000,0,3000,3000
058187,泰碩永豐99購01  ,0,0,0,0,0,0,0,0,0,3000,0,0,0,31000,28000,3000,3000
055729,金寶元富99購01  ,0,0,0,0,0,0,0,0,0,3000,0,0,0,3000,0,3000,3000
055811,國巨國票98購05  ,0,0,0,0,0,0,0,0,0,3000,0,0,0,3000,0,3000,3000
055064,碩天永豐97購01  ,0,0,0,0,0,0,0,0,0,3000,0,0,0,3000,0,3000,3000
055098,臺股指群益97購01,0,0,0,0,0,0,0,0,0,3000,0,0,0,3000,0,3000,3000
057303,喬山兆豐99購01  ,0,0,0,0,0,0,0,0,0,3000,0,0,0,3000,0,3000,3000
055610,光磊國票98購01  ,0,0,0,0,0,0,0,0,0,3000,0,0,0,3000,0,3000,3000
055929,聯發科群益97購05,0,0,0,0,0,0,0,0,0,3000,0,0,0,3000,0,3000,3000
055861,矽力元大97購03  ,0,0,0,0,0,0,0,0,0,3000,0,0,0,23000,20000,3000,3000
056338,聯發科凱基99購01,0,0,0,0,0,0,0,0,0,3000,0,0,0,3000,0,3000,3000
056168,鴻海元富97購07  ,0,0,0,0,0,0,0,0,0,3000,0,0,0,3000,0,3000,3000
056468,鴻海元大98購07  ,0,0,0,0,0,0,0,0,0,3000,0,0,0,3000,0,3000,3000
056074,茂林元大97購04  ,0,0,0,0,0,0,0,0,0,3000,0,0,0,3000,0,3000,3000
058573,鴻海群益9A購02  ,0,0,0,0,0,0,0,0,0,3000,0,0,0,176000,173000,3000,3000
058705,長榮航元大99購01,0,0,0,0,0,0,0,0,0,3000,0,0,0,3000,0,3000,3000
057985,華通元富02購03  ,0,0,0,0,0,0,0,0,0,3000,0,0,0,19000,16000,3000,3000
057795,鴻海兆豐99購02  ,0,0,0,0,0,0,0,0,0,3000,0,0,0,5000,2000,3000,3000
058751,南茂凱基9A購01  ,0,0,0,0,0,0,0,0,0,3000,0,0,0,121000,118000,3000,3000
05871P,全新凱基96售04  ,0,0,0,0,0,0,0,0,0,3000,0,0,0,3000,0,3000,3000
058716,華新科台新99購02,0,0,0,0,0,0,0,0,0,3000,0,0,0,3000,0,3000,3000
4557,永新-KY         ,3000,0,3000,0,0,0,0,0,0,0,0,0,0,0,0,0,3000
6166,凌華            ,57000,54000,3000,0,0,0,0,0,0,0,0,0,0,0,0,0,3000
5906,台南-KY         ,3000,0,3000,0,0,0,0,0,0,0,0,0,0,0,0,0,3000
9912,偉聯            ,3000,0,3000,0,0,0,0,0,0,0,0,0,0,0,0,0,3000
6641,基士德-KY       ,5000,2000,3000,0,0,0,0,0,0,0,0,0,0,0,0,0,3000
6573,虹揚-KY         ,5000,2000,3000,0,0,0,0,0,0,0,0,0,0,0,0,0,3000
07345P,台灣50永豐99售10,0,0,0,0,0,0,0,0,0,3000,0,0,0,3000,0,3000,3000
07484P,台灣50凱基04售02,0,0,0,0,0,0,0,0,0,3000,0,0,0,3000,0,3000,3000
07707P,玉山金元大9A售03,0,0,0,0,0,0,0,0,0,3000,0,0,0,3000,0,3000,3000
07248P,可成凱基99售06  ,0,0,0,0,0,0,0,0,0,3000,0,0,0,3000,0,3000,3000
07011P,宏達電凱基99售02,0,0,0,0,0,0,0,0,0,3000,0,0,0,3000,0,3000,3000
07027P,台積電群益99售04,0,0,0,0,0,0,0,0,0,3000,0,0,0,3000,0,3000,3000
06903P,技嘉凱基98售04  ,0,0,0,0,0,0,0,0,0,3000,0,0,0,23000,20000,3000,3000
1443,立益            ,2000,0,2000,0,0,0,0,0,0,1000,1000,0,1000,0,0,0,3000
2115,六暉-KY         ,4000,1000,3000,0,0,0,0,0,0,0,0,0,0,0,0,0,3000
2939,凱羿-KY         ,80000,77000,3000,0,0,0,0,0,0,0,0,0,0,0,0,0,3000
2496,卓越            ,5000,2000,3000,0,0,0,0,0,0,0,0,0,0,0,0,0,3000
06598P,奇力新永豐98售02,0,0,0,0,0,0,0,0,0,2000,0,0,0,2000,0,2000,2000
06392P,T50反1元大9A售01,0,0,0,0,0,0,0,0,0,2000,0,0,0,2000,0,2000,2000
06395P,台積電元大97售29,0,0,0,0,0,0,0,0,0,2000,0,0,0,2000,0,2000,2000
06454P,緯穎元大98售04  ,0,0,0,0,0,0,0,0,0,2000,0,0,0,2000,0,2000,2000
06167P,欣興國票97售05  ,0,0,0,0,0,0,0,0,0,2000,0,0,0,229000,227000,2000,2000
06127P,泰碩元富97售01  ,0,0,0,0,0,0,0,0,0,2000,0,0,0,2000,0,2000,2000
06112P,台積電兆豐97售01,0,0,0,0,0,0,0,0,0,2000,0,0,0,2000,0,2000,2000
060892,超眾統一9C購01  ,0,0,0,0,0,0,0,0,0,2000,0,0,0,2000,0,2000,2000
06074P,台積電凱基98售04,0,0,0,0,0,0,0,0,0,2000,0,0,0,2000,0,2000,2000
060247,牧德元大9A購02  ,0,0,0,0,0,0,0,0,0,2000,0,0,0,3000,1000,2000,2000
060393,泰鼎群益9A購01  ,0,0,0,0,0,0,0,0,0,2000,0,0,0,2000,0,2000,2000
059968,世紀鋼凱基99購03,0,0,0,0,0,0,0,0,0,2000,0,0,0,2000,0,2000,2000
059981,聯發科元大99購36,0,0,0,0,0,0,0,0,0,2000,0,0,0,2000,0,2000,2000
059991,超眾元大9A購02  ,0,0,0,0,0,0,0,0,0,2000,0,0,0,4000,2000,2000,2000
059923,緯穎元大99購09  ,0,0,0,0,0,0,0,0,0,2000,0,0,0,45000,43000,2000,2000
059893,台積電台新9A購02,0,0,0,0,0,0,0,0,0,2000,0,0,0,3000,1000,2000,2000
059394,臺股指凱基99購40,0,0,0,0,0,0,0,0,0,2000,0,0,0,2000,0,2000,2000
059446,臺股指元大99購27,0,0,0,0,0,0,0,0,0,2000,0,0,0,2000,0,2000,2000
059411,臺股指國票99購17,0,0,0,0,0,0,0,0,0,2000,0,0,0,2000,0,2000,2000
059212,鴻海元大99購28  ,0,0,0,0,0,0,0,0,0,2000,0,0,0,127000,125000,2000,2000
059130,台灣50群益9B購05,0,0,0,0,0,0,0,0,0,2000,0,0,0,21000,19000,2000,2000
059575,臺股指凱基99購41,0,0,0,0,0,0,0,0,0,2000,0,0,0,2000,0,2000,2000
059705,華新科凱基9A購07,0,0,0,0,0,0,0,0,0,2000,0,0,0,20000,18000,2000,2000
059660,華新科元大9A購04,0,0,0,0,0,0,0,0,0,2000,0,0,0,2000,0,2000,2000
059794,滬深2X國票99購04,0,0,0,0,0,0,0,0,0,2000,0,0,0,2000,0,2000,2000
05978P,麗豐永豐96售02  ,0,0,0,0,0,0,0,0,0,2000,0,0,0,2000,0,2000,2000
053382,友達元大9C購02  ,0,0,0,0,0,0,0,0,0,2000,0,0,0,2000,0,2000,2000
053388,群創元大9C購02  ,0,0,0,0,0,0,0,0,0,2000,0,0,0,2000,0,2000,2000
053474,聯發科元大97購06,0,0,0,0,0,0,0,0,0,2000,0,0,0,2000,0,2000,2000
053475,華新科元大96購05,0,0,0,0,0,0,0,0,0,2000,0,0,0,2000,0,2000,2000
054695,世芯永豐98購01  ,0,0,0,0,0,0,0,0,0,2000,0,0,0,2000,0,2000,2000
054573,漢唐元大98購01  ,0,0,0,0,0,0,0,0,0,2000,0,0,0,2000,0,2000,2000
053126,健策凱基97購02  ,0,0,0,0,0,0,0,0,0,2000,0,0,0,2000,0,2000,2000
056509,晶相光永豐98購01,58000,0,58000,0,0,0,0,0,0,-56000,0,0,0,72000,128000,-56000,2000
05533P,滬深2X富邦97售01,0,0,0,0,0,0,0,0,0,2000,0,0,0,2000,0,2000,2000
055486,國巨元大98購06  ,0,0,0,0,0,0,0,0,0,2000,0,0,0,2000,0,2000,2000
053786,新日興元大96購02,0,0,0,0,0,0,0,0,0,2000,0,0,0,2000,0,2000,2000
053732,S&P反1中信9C購01,0,0,0,0,0,0,0,0,0,2000,0,0,0,2000,0,2000,2000
053759,晶相光國泰98購01,50000,0,50000,0,0,0,0,0,0,-48000,0,0,0,2000,50000,-48000,2000
053737,華新科麥證96購01,0,0,0,2000,0,2000,0,0,0,2000,0,0,0,2000,0,2000,2000
054134,強茂元大96購01  ,0,0,0,0,0,0,0,0,0,2000,0,0,0,125000,123000,2000,2000
05410P,聯發科元富95售04,0,0,0,0,0,0,0,0,0,2000,0,0,0,2000,0,2000,2000
054001,康友群益96購02  ,0,0,0,0,0,0,0,0,0,2000,0,0,0,2000,0,2000,2000
05493P,華新科富邦99售02,0,0,0,0,0,0,0,0,0,2000,0,0,0,2000,0,2000,2000
053322,京鼎群益97購01  ,0,0,0,0,0,0,0,0,0,2000,0,0,0,2000,0,2000,2000
053083,中環元大99購01  ,0,0,0,0,0,0,0,0,0,2000,0,0,0,2000,0,2000,2000
05487P,台表科凱基95售02,0,0,0,0,0,0,0,0,0,2000,0,0,0,2000,0,2000,2000
052916,華新科富邦96購01,0,0,0,0,0,0,0,0,0,2000,0,0,0,2000,0,2000,2000
04914P,國巨國泰95售06  ,0,0,0,0,0,0,0,0,0,2000,0,0,0,32000,30000,2000,2000
04495P,台積電國票95售01,0,0,0,0,0,0,0,0,0,2000,0,0,0,2000,0,2000,2000
045106,玉晶光群益95購01,0,0,0,0,0,0,0,0,0,2000,0,0,0,2000,0,2000,2000
04866P,台積電統一95售02,0,0,0,0,0,0,0,0,0,2000,0,0,0,2000,0,2000,2000
048831,玉晶光凱基95購01,0,0,0,0,0,0,0,0,0,2000,0,0,0,2000,0,2000,2000
050353,華擎群益95購01  ,0,0,0,0,0,0,0,0,0,2000,0,0,0,2000,0,2000,2000
05013P,台積電元大96售05,0,0,0,0,0,0,0,0,0,2000,0,0,0,2000,0,2000,2000
050163,群創國泰95購01  ,0,0,0,0,0,0,0,0,0,2000,0,0,0,2000,0,2000,2000
050180,華新科元大95購08,0,0,0,0,0,0,0,0,0,2000,0,0,0,2000,0,2000,2000
049582,台積電元大95購03,0,0,0,0,0,0,0,0,0,2000,0,0,0,2000,0,2000,2000
036084,台灣50台新98購01,0,0,0,0,0,0,0,0,0,2000,0,0,0,282000,280000,2000,2000
03425B,臺股指元大9A熊01,0,0,0,0,0,0,0,0,0,2000,0,0,0,6000,4000,2000,2000
04682P,臺股指統一96售01,0,0,0,0,0,0,0,0,0,2000,0,0,0,2000,0,2000,2000
052020,聯茂永豐95購02  ,0,0,0,0,0,0,0,0,0,2000,0,0,0,2000,0,2000,2000
051934,緯穎國票96購01  ,0,0,0,0,0,0,0,0,0,2000,0,0,0,2000,0,2000,2000
051903,T50反1元大97購02,0,0,0,0,0,0,0,0,0,2000,0,0,0,2000,0,2000,2000
051899,欣興國泰97購01  ,0,0,0,0,0,0,0,0,0,2000,0,0,0,2000,0,2000,2000
051807,瑞昱凱基95購03  ,0,0,0,0,0,0,0,0,0,2000,0,0,0,2000,0,2000,2000
051317,亞德客國票96購01,0,0,0,0,0,0,0,0,0,2000,0,0,0,6000,4000,2000,2000
051697,康友中信95購02  ,0,0,0,0,0,0,0,0,0,2000,0,0,0,2000,0,2000,2000
051239,國巨元大96購02  ,0,0,0,0,0,0,0,0,0,2000,0,0,0,2000,0,2000,2000
051254,健策元大96購04  ,0,0,0,0,0,0,0,0,0,2000,0,0,0,2000,0,2000,2000
051267,美律富邦96購01  ,0,0,0,0,0,0,0,0,0,2000,0,0,0,2000,0,2000,2000
05119P,聯發科國泰96售02,0,0,0,0,0,0,0,0,0,2000,0,0,0,2000,0,2000,2000
051095,貿聯元大95購03  ,0,0,0,0,0,0,0,0,0,2000,0,0,0,2000,0,2000,2000
051009,緯創麥證95購01  ,0,0,0,2000,0,2000,0,0,0,2000,0,0,0,2000,0,2000,2000
050902,南電元大96購01  ,0,0,0,0,0,0,0,0,0,2000,0,0,0,15000,13000,2000,2000
052453,崇越元大95購01  ,0,0,0,0,0,0,0,0,0,2000,0,0,0,2000,0,2000,2000
051485,玉晶光凱基97購02,0,0,0,0,0,0,0,0,0,2000,0,0,0,2000,0,2000,2000
051472,台積電凱基95購09,0,0,0,0,0,0,0,0,0,2000,0,0,0,2000,0,2000,2000
052682,上銀元大97購01  ,0,0,0,0,0,0,0,0,0,2000,0,0,0,2000,0,2000,2000
052482,茂林群益95購01  ,0,0,0,0,0,0,0,0,0,2000,0,0,0,2000,0,2000,2000
058708,臺股指元大9A購21,0,0,0,0,0,0,0,0,0,2000,0,0,0,2000,0,2000,2000
058794,旺宏元大99購09  ,0,0,0,0,0,0,0,0,0,2000,0,0,0,2000,0,2000,2000
058822,樺漢國泰9B購01  ,0,0,0,0,0,0,0,0,0,2000,0,0,0,50000,48000,2000,2000
05886P,華通元富96售01  ,0,0,0,0,0,0,0,0,0,2000,0,0,0,2000,0,2000,2000
059082,華通元大99購06  ,0,0,0,0,0,0,0,0,0,2000,0,0,0,7000,5000,2000,2000
057094,祥碩元富98購01  ,0,0,0,0,0,0,0,0,0,2000,0,0,0,2000,0,2000,2000
057978,聯發科永豐98購05,0,0,0,0,0,0,0,0,0,2000,0,0,0,2000,0,2000,2000
058615,矽創元大99購01  ,0,0,0,0,0,0,0,0,0,2000,0,0,0,3000,1000,2000,2000
056054,亞德客元大97購05,0,0,0,0,0,0,0,0,0,2000,0,0,0,55000,53000,2000,2000
056445,聯發科凱基98購07,0,0,0,0,0,0,0,0,0,2000,0,0,0,12000,10000,2000,2000
056907,群創元大9C購04  ,0,0,0,0,0,0,0,0,0,2000,0,0,0,2000,0,2000,2000
05684P,臺股指元大96售09,0,0,0,0,0,0,0,0,0,2000,0,0,0,2000,0,2000,2000
056300,聯發科元大97購23,0,0,0,0,0,0,0,0,0,2000,0,0,0,2000,0,2000,2000
056301,開發金元大9A購01,0,0,0,0,0,0,0,0,0,2000,0,0,0,2000,0,2000,2000
056312,茂林元大98購01  ,0,0,0,0,0,0,0,0,0,2000,0,0,0,2000,0,2000,2000
056368,祥碩元大98購02  ,0,0,0,0,0,0,0,0,0,2000,0,0,0,2000,0,2000,2000
056911,緯穎元大99購01  ,0,0,0,0,0,0,0,0,0,2000,0,0,0,2000,0,2000,2000
055831,台達電元大97購01,0,0,0,0,0,0,0,0,0,2000,0,0,0,2000,0,2000,2000
057689,南亞科凱基99購02,0,0,0,0,0,0,0,0,0,2000,0,0,0,3000,1000,2000,2000
057001,華邦電國票99購02,0,0,0,0,0,0,0,0,0,2000,0,0,0,2000,0,2000,2000
057047,華新科元大99購07,0,0,0,0,0,0,0,0,0,2000,0,0,0,2000,0,2000,2000
055980,祥碩統一98購01  ,0,0,0,0,0,0,0,0,0,2000,0,0,0,2000,0,2000,2000
055984,大立光元富97購02,0,0,0,0,0,0,0,0,0,2000,0,0,0,3000,1000,2000,2000
056033,T50正2凱基99購02,0,0,0,0,0,0,0,0,0,2000,0,0,0,2000,0,2000,2000
057618,台光電凱基99購01,0,0,0,0,0,0,0,0,0,2000,0,0,0,2000,0,2000,2000
057116,鴻海日盛9A購01  ,0,0,0,0,0,0,0,0,0,2000,0,0,0,2000,0,2000,2000
057163,上銀元大98購04  ,0,0,0,0,0,0,0,0,0,2000,0,0,0,12000,10000,2000,2000
058089,聯發科元大98購15,0,0,0,0,0,0,0,0,0,2000,0,0,0,6000,4000,2000,2000
058040,FBVIX元大98購01 ,0,0,0,0,0,0,0,0,0,2000,0,0,0,4000,2000,2000,2000
058008,禾伸堂國票99購02,0,0,0,0,0,0,0,0,0,2000,0,0,0,125000,123000,2000,2000
057281,大立光元大98購16,0,0,0,0,0,0,0,0,0,2000,0,0,0,2000,0,2000,2000
057182,禾伸堂元大99購02,0,0,0,0,0,0,0,0,0,2000,0,0,0,10000,8000,2000,2000
055545,國巨凱基97購06  ,0,0,0,0,0,0,0,0,0,2000,0,0,0,5000,3000,2000,2000
057346,鴻海統一98購13  ,0,0,0,0,0,0,0,0,0,2000,0,0,0,2000,0,2000,2000
055106,台積電凱基98購05,0,0,0,0,0,0,0,0,0,2000,0,0,0,2000,0,2000,2000
055054,群光永豐97購01  ,0,0,0,0,0,0,0,0,0,2000,0,0,0,4000,2000,2000,2000
055039,神達富邦99購01  ,0,0,0,0,0,0,0,0,0,2000,0,0,0,2000,0,2000,2000
055137,GIS富邦98購01   ,0,0,0,0,0,0,0,0,0,2000,0,0,0,2000,0,2000,2000
055722,聯鈞元大97購03  ,0,0,0,0,0,0,0,0,0,2000,0,0,0,2000,0,2000,2000
055779,國泰金凱基97購02,0,0,0,0,0,0,0,0,0,2000,0,0,0,50000,48000,2000,2000
055743,TPK元富98購01   ,0,0,0,0,0,0,0,0,0,2000,0,0,0,2000,0,2000,2000
057901,大立光永豐98購04,0,0,0,0,0,0,0,0,0,2000,0,0,0,2000,0,2000,2000
2227,裕日車          ,22000,19000,3000,0,0,0,1000,0,1000,-2000,0,2000,-2000,0,0,0,2000
2373,震旦行          ,3000,0,3000,0,0,0,0,0,0,-1000,0,1000,-1000,0,0,0,2000
2910,統領            ,3000,1000,2000,0,0,0,0,0,0,0,0,0,0,0,0,0,2000
2069,運錩            ,16000,14000,2000,0,0,0,0,0,0,0,0,0,0,0,0,0,2000
1506,正道            ,40000,38000,2000,0,0,0,0,0,0,0,0,0,0,0,0,0,2000
1617,榮星            ,2000,0,2000,0,0,0,0,0,0,0,0,0,0,0,0,0,2000
1725,元禎            ,2000,0,2000,0,0,0,0,0,0,0,0,0,0,0,0,0,2000
1453,大將            ,2000,0,2000,0,0,0,0,0,0,0,0,0,0,0,0,0,2000
1233,天仁            ,4000,2000,2000,0,0,0,0,0,0,0,0,0,0,0,0,0,2000
07717P,臺股指群益9A售06,0,0,0,0,0,0,0,0,0,2000,0,0,0,9000,7000,2000,2000
06988P,鴻海元富99售09  ,0,0,0,0,0,0,0,0,0,2000,0,0,0,2000,0,2000,2000
06923P,鴻海群益98售09  ,0,0,0,0,0,0,0,0,0,2000,0,0,0,2000,0,2000,2000
06925P,致茂群益9A售02  ,0,0,0,0,0,0,0,0,0,2000,0,0,0,2000,0,2000,2000
07259P,滬深2X國票01售01,0,0,0,0,0,0,0,0,0,2000,0,0,0,17000,15000,2000,2000
07176P,臺股指凱基99售18,0,0,0,0,0,0,0,0,0,2000,0,0,0,2000,0,2000,2000
07137P,大立光中信9B售01,0,0,0,0,0,0,0,0,0,2000,0,0,0,2000,0,2000,2000
07530P,聯發科凱基9A售11,0,0,0,0,0,0,0,0,0,2000,0,0,0,222000,220000,2000,2000
07414P,台積電元大99售51,0,0,0,0,0,0,0,0,0,2000,0,0,0,172000,170000,2000,2000
07306P,台灣50凱基9A售09,0,0,0,0,0,0,0,0,0,2000,0,0,0,10000,8000,2000,2000
6674,鋐寶科技        ,3000,1000,2000,0,0,0,0,0,0,0,0,0,0,0,0,0,2000
9136,巨騰-DR         ,2000,0,2000,0,0,0,0,0,0,0,0,0,0,0,0,0,2000
4807,日成-KY         ,4000,2000,2000,0,0,0,0,0,0,0,0,0,0,0,0,0,2000
6205,詮欣            ,2000,0,2000,0,0,0,0,0,0,0,0,0,0,0,0,0,2000
059792,台灣50國票9A購09,0,0,0,0,0,0,0,0,0,1000,0,0,0,1000,0,1000,1000
059811,高股息凱基99購02,0,0,0,0,0,0,0,0,0,1000,0,0,0,3000,2000,1000,1000
059750,台灣50群益9A購05,0,0,0,0,0,0,0,0,0,1000,0,0,0,1000,0,1000,1000
059774,臺股指群益99購21,0,0,0,0,0,0,0,0,0,1000,0,0,0,1000,0,1000,1000
059664,立積元大9C購01  ,0,0,0,0,0,0,0,0,0,1000,0,0,0,1000,0,1000,1000
059724,聯發科元大99購30,0,0,0,0,0,0,0,0,0,1000,0,0,0,1000,0,1000,1000
059627,旺宏凱基99購10  ,0,0,0,0,0,0,0,0,0,1000,0,0,0,1000,0,1000,1000
059555,台灣50凱基9A購06,0,0,0,0,0,0,0,0,0,1000,0,0,0,1000,0,1000,1000
059471,華新科元大99購17,0,0,0,0,0,0,0,0,0,1000,0,0,0,1000,0,1000,1000
059091,中信金元大99購01,0,0,0,0,0,0,0,0,0,1000,0,0,0,1000,0,1000,1000
059150,臺股指國票99購13,0,0,0,0,0,0,0,0,0,1000,0,0,0,1000,0,1000,1000
059190,欣興富邦9A購01  ,0,0,0,0,0,0,0,0,0,1000,0,0,0,1000,0,1000,1000
059392,臺股指凱基99購38,0,0,0,0,0,0,0,0,0,1000,0,0,0,1000,0,1000,1000
059277,群創元大99購05  ,0,0,0,0,0,0,0,0,0,1000,0,0,0,1000,0,1000,1000
059906,臺指反元大9C購04,0,0,0,0,0,0,0,0,0,1000,0,0,0,1000,0,1000,1000
059838,茂林國泰9B購01  ,0,0,0,0,0,0,0,0,0,1000,0,0,0,1000,0,1000,1000
059857,台灣50群益99購06,0,0,0,0,0,0,0,0,0,1000,0,0,0,1000,0,1000,1000
059921,大立光元大99購24,0,0,0,0,0,0,0,0,0,1000,0,0,0,1000,0,1000,1000
059992,S&P正2元富9B購04,0,0,0,0,0,0,0,0,0,1000,0,0,0,2000,1000,1000,1000
06035P,同欣電凱基96售03,0,1000,-1000,0,0,0,0,0,0,2000,0,0,0,8000,6000,2000,1000
060331,台積電麥證9A購01,0,0,0,1000,0,1000,0,0,0,1000,0,0,0,1000,0,1000,1000
060408,和潤國泰9C購01  ,0,0,0,0,0,0,0,0,0,1000,0,0,0,11000,10000,1000,1000
060250,台表科元大9A購01,0,0,0,0,0,0,0,0,0,1000,0,0,0,71000,70000,1000,1000
060257,臺股指元大9B購08,0,0,0,0,0,0,0,0,0,1000,0,0,0,1000,0,1000,1000
060768,鴻海麥證9A購02  ,0,0,0,12000,11000,1000,0,0,0,1000,0,0,0,12000,11000,1000,1000
06069P,台積電永豐97售01,0,0,0,0,0,0,0,0,0,1000,0,0,0,1000,0,1000,1000
060693,台積電麥證9A購02,0,0,0,1000,0,1000,0,0,0,1000,0,0,0,1000,0,1000,1000
060606,玉晶光凱基9A購05,0,0,0,0,0,0,0,0,0,1000,0,0,0,3000,2000,1000,1000
060569,台積電永豐9A購01,0,0,0,0,0,0,0,0,0,1000,0,0,0,10000,9000,1000,1000
061014,台積電麥證9A購04,0,0,0,1000,0,1000,0,0,0,1000,0,0,0,1000,0,1000,1000
061019,大毅國票9A購01  ,0,0,0,0,0,0,0,0,0,1000,0,0,0,2000,1000,1000,1000
061128,大立光永豐9A購02,0,0,0,0,0,0,0,0,0,1000,0,0,0,1000,0,1000,1000
061143,道瓊指中信9C購04,0,0,0,0,0,0,0,0,0,1000,0,0,0,1000,0,1000,1000
061172,大立光麥證9A購02,0,0,0,1000,0,1000,0,0,0,1000,0,0,0,1000,0,1000,1000
061259,台積電凱基9A購21,0,0,0,0,0,0,0,0,0,1000,0,0,0,1000,0,1000,1000
06206P,台積電凱基97售11,0,0,0,0,0,0,0,0,0,1000,0,0,0,1000,0,1000,1000
06256P,臺股指群益97售09,0,0,0,0,0,0,0,0,0,1000,0,0,0,3000,2000,1000,1000
06475P,牧德永豐98售03  ,0,0,0,0,0,0,0,0,0,1000,0,0,0,31000,30000,1000,1000
06548P,大立光元大98售10,0,0,0,0,0,0,0,0,0,1000,0,0,0,1000,0,1000,1000
06573P,台積電永昌99售02,0,0,0,0,0,0,0,0,0,1000,0,0,0,134000,133000,1000,1000
06658P,台灣50富邦9C售01,0,0,0,0,0,0,0,0,0,1000,0,0,0,31000,30000,1000,1000
06760P,台積電元大98售18,0,0,0,0,0,0,0,0,0,1000,0,0,0,1000,0,1000,1000
06761P,台積電元大99售05,0,0,0,0,0,0,0,0,0,1000,0,0,0,1000,0,1000,1000
06744P,嘉聯益永豐98售03,0,0,0,0,0,0,0,0,0,1000,0,0,0,110000,109000,1000,1000
06755P,大立光永豐98售03,0,0,0,0,0,0,0,0,0,1000,0,0,0,1000,0,1000,1000
053876,可成永昌98購01  ,0,0,0,0,0,0,0,0,0,1000,0,0,0,1000,0,1000,1000
053979,健策元大98購01  ,0,0,0,0,0,0,0,0,0,1000,0,0,0,1000,0,1000,1000
053973,晶豪科元大96購01,0,0,0,0,0,0,0,0,0,1000,0,0,0,272000,271000,1000,1000
05257P,欣興凱基95售04  ,0,0,0,0,0,0,0,0,0,1000,0,0,0,3000,2000,1000,1000
051410,京元電國票96購01,0,0,0,0,0,0,0,0,0,1000,0,0,0,1000,0,1000,1000
051508,元黃金中信97購01,0,0,0,0,0,0,0,0,0,1000,0,0,0,1000,0,1000,1000
051578,智邦元大96購01  ,0,0,0,0,0,0,0,0,0,1000,0,0,0,1000,0,1000,1000
052456,滬深2X元富9B購03,0,0,0,0,0,0,0,0,0,1000,0,0,0,1000,0,1000,1000
052324,康友元大96購02  ,0,0,0,0,0,0,0,0,0,1000,0,0,0,4000,3000,1000,1000
052271,力成日盛95購02  ,0,0,0,0,0,0,0,0,0,1000,0,0,0,1000,0,1000,1000
05079P,可成永豐95售01  ,0,0,0,0,0,0,0,0,0,1000,0,0,0,1000,0,1000,1000
05067P,欣興兆豐96售02  ,0,0,0,0,0,0,0,0,0,1000,0,0,0,1000,0,1000,1000
051103,緯穎元大96購03  ,0,0,0,0,0,0,0,0,0,1000,0,0,0,1000,0,1000,1000
052185,奇力新群益95購03,0,0,0,0,0,0,0,0,0,1000,0,0,0,1000,0,1000,1000
052091,緯創元大95購04  ,0,0,0,0,0,0,0,0,0,1000,0,0,0,1000,0,1000,1000
052025,國巨群益96購01  ,0,0,0,0,0,0,0,0,0,1000,0,0,0,13000,12000,1000,1000
03416B,臺股指凱基95熊05,0,0,0,0,0,0,0,0,0,1000,0,0,0,1000,0,1000,1000
03022X,富展01          ,0,0,0,0,0,0,0,0,0,1000,0,0,0,1000,0,1000,1000
03662C,FBVIX凱基03牛01 ,0,0,0,0,0,0,0,0,0,1000,0,0,0,9000,8000,1000,1000
03669C,滬深2X元富09牛01,0,0,0,0,0,0,0,0,0,1000,0,0,0,101000,100000,1000,1000
049251,國巨元大95購02  ,0,0,0,0,0,0,0,0,0,1000,0,0,0,1000,0,1000,1000
03960P,新日興元富96售02,0,0,0,0,0,0,0,0,0,1000,0,0,0,1000,0,1000,1000
049600,緯穎元大95購02  ,0,0,0,0,0,0,0,0,0,1000,0,0,0,1000,0,1000,1000
04982P,臺股指中信94售03,0,0,0,0,0,0,0,0,0,1000,0,0,0,1000,0,1000,1000
04984P,臺股指康和94售04,0,0,0,0,0,0,0,0,0,1000,0,0,0,1000,0,1000,1000
050014,國巨富邦98購01  ,0,0,0,0,0,0,0,0,0,1000,0,0,0,45000,44000,1000,1000
050121,南電元大95購02  ,0,0,0,0,0,0,0,0,0,1000,0,0,0,1000,0,1000,1000
05052P,友達群益97售01  ,0,0,0,0,0,0,0,0,0,1000,0,0,0,1000,0,1000,1000
047675,群創元富96購03  ,0,0,0,0,0,0,0,0,0,1000,0,0,0,1000,0,1000,1000
045767,大立光元富95購01,0,0,0,0,0,0,0,0,0,1000,0,0,0,2000,1000,1000,1000
04411P,智易統一96售01  ,0,0,0,0,0,0,0,0,0,1000,0,0,0,1000,0,1000,1000
04433P,上証2X國票95售01,0,0,0,0,0,0,0,0,0,1000,0,0,0,1000,0,1000,1000
049108,玉晶光富邦96購02,0,0,0,0,0,0,0,0,0,1000,0,0,0,1000,0,1000,1000
049156,緯穎元大96購01  ,0,0,0,0,0,0,0,0,0,1000,0,0,0,1000,0,1000,1000
042501,台灣50凱基96購06,0,0,0,0,0,0,0,0,0,1000,0,0,0,101000,100000,1000,1000
04198P,滬深2X群益95售04,0,0,0,0,0,0,0,0,0,1000,0,0,0,1000,0,1000,1000
042692,台灣50凱基96購09,0,0,0,0,0,0,0,0,0,1000,0,0,0,761000,760000,1000,1000
00674R,元大S&P黃金反1  ,0,0,0,0,0,0,0,0,0,1000,0,0,0,64000,63000,1000,1000
00666R,富邦恒生國企反1 ,1000,3000,-2000,0,0,0,0,0,0,3000,0,0,0,83000,80000,3000,1000
020002,元富新中國N     ,0,0,0,0,0,0,0,0,0,1000,0,0,0,1000,0,1000,1000
00736,國泰新興市場    ,88000,0,88000,0,0,0,0,0,0,-87000,0,0,0,122000,209000,-87000,1000
008201,BP上證50        ,0,0,0,0,0,0,0,0,0,1000,0,0,0,1000,0,1000,1000
052920,景碩台新96購02  ,0,0,0,0,0,0,0,0,0,1000,0,0,0,1000,0,1000,1000
05289P,鴻海永豐95售05  ,0,0,0,0,0,0,0,0,0,1000,0,0,0,1000,0,1000,1000
052882,南電凱基96購02  ,0,0,0,0,0,0,0,0,0,1000,0,0,0,2000,1000,1000,1000
054834,帆宣中信97購01  ,0,0,0,0,0,0,0,0,0,1000,0,0,0,1000,0,1000,1000
054858,台肥群益97購01  ,0,0,0,0,0,0,0,0,0,1000,0,0,0,5000,4000,1000,1000
053036,聯電凱基98購01  ,0,0,0,0,0,0,0,0,0,1000,0,0,0,1000,0,1000,1000
05298P,上銀元大95售03  ,0,0,0,0,0,0,0,0,0,1000,0,0,0,1000,0,1000,1000
053012,國巨統一96購03  ,0,0,0,0,0,0,0,0,0,1000,0,0,0,1000,0,1000,1000
052963,智邦凱基96購02  ,0,0,0,0,0,0,0,0,0,1000,0,0,0,1000,0,1000,1000
053304,可成凱基96購03  ,0,0,0,0,0,0,0,0,0,1000,0,0,0,1000,0,1000,1000
05437P,聯詠永豐95售02  ,0,0,0,0,0,0,0,0,0,1000,0,0,0,1000,0,1000,1000
054926,神達凱基98購01  ,0,0,0,0,0,0,0,0,0,1000,0,0,0,1000,0,1000,1000
054905,國揚康和97購01  ,0,0,0,0,0,0,0,0,0,1000,0,0,0,11000,10000,1000,1000
054906,神達康和97購01  ,0,0,0,0,0,0,0,0,0,1000,0,0,0,1000,0,1000,1000
054808,東元元大9A購01  ,0,0,0,0,0,0,0,0,0,1000,0,0,0,1000,0,1000,1000
054964,智易元大99購01  ,0,0,0,0,0,0,0,0,0,1000,0,0,0,1000,0,1000,1000
054056,華新科國票96購02,0,0,0,0,0,0,0,0,0,1000,0,0,0,1000,0,1000,1000
054085,華新科統一96購04,0,0,0,0,0,0,0,0,0,1000,0,0,0,1000,0,1000,1000
054169,上緯控凱基98購01,0,0,0,0,0,0,0,0,0,1000,0,0,0,6000,5000,1000,1000
054113,奇力新台新97購01,0,0,0,0,0,0,0,0,0,1000,0,0,0,1000,0,1000,1000
052811,玉晶光台新96購03,0,0,0,0,0,0,0,0,0,1000,0,0,0,1000,0,1000,1000
052776,力山國票97購01  ,0,0,0,0,0,0,0,0,0,1000,0,0,0,1000,0,1000,1000
052784,緯穎國票97購02  ,0,0,0,0,0,0,0,0,0,1000,0,0,0,1000,0,1000,1000
053267,華新科群益96購02,0,0,0,0,0,0,0,0,0,1000,0,0,0,1000,0,1000,1000
053251,世紀鋼國票97購02,0,0,0,0,0,0,0,0,0,1000,0,0,0,1000,0,1000,1000
053242,聯電國票96購04  ,0,0,0,0,0,0,0,0,0,1000,0,0,0,1000,0,1000,1000
054210,台光電國票97購03,0,0,0,0,0,0,0,0,0,1000,0,0,0,1000,0,1000,1000
054196,台光電國泰97購02,0,0,0,0,0,0,0,0,0,1000,0,0,0,1000,0,1000,1000
054212,聯詠國票97購03  ,0,0,0,0,0,0,0,0,0,1000,0,0,0,1000,0,1000,1000
055456,上銀富邦99購01  ,0,0,0,0,0,0,0,0,0,1000,0,0,0,10000,9000,1000,1000
057535,泰鼎元大99購01  ,0,0,0,0,0,0,0,0,0,1000,0,0,0,1000,0,1000,1000
055327,致新國票98購01  ,0,0,0,0,0,0,0,0,0,1000,0,0,0,1000,0,1000,1000
055334,禾伸堂兆豐97購01,0,0,0,0,0,0,0,0,0,1000,0,0,0,291000,290000,1000,1000
053701,台積電兆豐96購05,0,0,0,0,0,0,0,0,0,1000,0,0,0,1000,0,1000,1000
053687,智邦元大96購02  ,0,0,0,0,0,0,0,0,0,1000,0,0,0,1000,0,1000,1000
056512,易華電永豐98購01,0,0,0,0,0,0,0,0,0,1000,0,0,0,1000,0,1000,1000
056483,TPK元大98購01   ,0,0,0,0,0,0,0,0,0,1000,0,0,0,1000,0,1000,1000
054589,聯鈞國泰99購01  ,0,0,0,0,0,0,0,0,0,1000,0,0,0,1000,0,1000,1000
054579,聯茂元大97購01  ,0,0,0,0,0,0,0,0,0,1000,0,0,0,5000,4000,1000,1000
054660,禾伸堂元大97購03,0,0,0,0,0,0,0,0,0,1000,0,0,0,15000,14000,1000,1000
054713,國巨中信9B購01  ,0,0,0,0,0,0,0,0,0,1000,0,0,0,1000,0,1000,1000
054632,緯穎凱基9A購01  ,0,0,0,0,0,0,0,0,0,1000,0,0,0,1000,0,1000,1000
053187,國巨統一96購05  ,0,0,0,0,0,0,0,0,0,1000,0,0,0,1000,0,1000,1000
053191,奇鋐統一96購01  ,0,0,0,0,0,0,0,0,0,1000,0,0,0,1000,0,1000,1000
05347P,滬深2X元富9B售02,0,0,0,0,0,0,0,0,0,1000,0,0,0,1000,0,1000,1000
053461,台郡永昌99購01  ,0,0,0,0,0,0,0,0,0,1000,0,0,0,31000,30000,1000,1000
053422,可成永豐96購01  ,0,0,0,0,0,0,0,0,0,1000,0,0,0,2000,1000,1000,1000
054770,健策國票98購01  ,0,0,0,0,0,0,0,0,0,1000,0,0,0,1000,0,1000,1000
053537,玉晶光永豐98購02,0,0,0,0,0,0,0,0,0,1000,0,0,0,1000,0,1000,1000
058407,滬深2X兆豐9A購01,0,0,0,0,0,0,0,0,0,1000,0,0,0,1000,0,1000,1000
058426,旺宏元富99購02  ,0,0,0,0,0,0,0,0,0,1000,0,0,0,1000,0,1000,1000
058340,高股息群益99購01,0,0,0,0,0,0,0,0,0,1000,0,0,0,1000,0,1000,1000
058356,華邦電凱基99購01,0,0,0,0,0,0,0,0,0,1000,0,0,0,1000,0,1000,1000
058415,祥碩兆豐99購01  ,0,0,0,0,0,0,0,0,0,1000,0,0,0,5000,4000,1000,1000
058186,聯發科永豐99購01,0,0,0,0,0,0,0,0,0,1000,0,0,0,1000,0,1000,1000
058231,技嘉元大99購02  ,0,0,0,0,0,0,0,0,0,1000,0,0,0,1000,0,1000,1000
058242,玉晶光元大9A購01,0,0,0,0,0,0,0,0,0,1000,0,0,0,1000,0,1000,1000
058278,FBVIX中信03購02 ,0,0,0,0,0,0,0,0,0,1000,0,0,0,1000,0,1000,1000
055270,上銀元大97購03  ,0,0,0,0,0,0,0,0,0,1000,0,0,0,2000,1000,1000,1000
05580P,美律凱基96售03  ,0,0,0,0,0,0,0,0,0,1000,0,0,0,11000,10000,1000,1000
056776,聯茂元大99購01  ,0,0,0,0,0,0,0,0,0,1000,0,0,0,1000,0,1000,1000
055180,文曄統一97購01  ,0,0,0,0,0,0,0,0,0,1000,0,0,0,1000,0,1000,1000
055248,可成統一97購02  ,0,0,0,0,0,0,0,0,0,1000,0,0,0,31000,30000,1000,1000
057373,大立光元大98購17,0,0,0,0,0,0,0,0,0,1000,0,0,0,1000,0,1000,1000
057402,嘉晶群益98購02  ,0,0,0,0,0,0,0,0,0,1000,0,0,0,1000,0,1000,1000
055566,台表科凱基97購03,0,0,0,0,0,0,0,0,0,1000,0,0,0,6000,5000,1000,1000
055487,國巨元大98購07  ,0,0,0,0,0,0,0,0,0,1000,0,0,0,1000,0,1000,1000
05672P,鴻海群益96售03  ,0,0,0,0,0,0,0,0,0,1000,0,0,0,1000,0,1000,1000
058052,南電元大98購02  ,0,0,0,0,0,0,0,0,0,1000,0,0,0,1000,0,1000,1000
057016,中石化凱基9B購01,0,0,0,0,0,0,0,0,0,1000,0,0,0,1000,0,1000,1000
055995,華擎國泰99購01  ,0,0,0,0,0,0,0,0,0,1000,0,0,0,1000,0,1000,1000
057043,台積電元大99購02,0,0,0,0,0,0,0,0,0,1000,0,0,0,1000,0,1000,1000
057085,立積統一9B購02  ,0,0,0,0,0,0,0,0,0,1000,0,0,0,1000,0,1000,1000
055942,臺股指群益9C購01,0,0,0,0,0,0,0,0,0,1000,0,0,0,1000,0,1000,1000
056990,聯發科兆豐98購01,0,0,0,0,0,0,0,0,0,1000,0,0,0,43000,42000,1000,1000
056991,牧德兆豐98購01  ,0,0,0,0,0,0,0,0,0,1000,0,0,0,223000,222000,1000,1000
056941,台郡元富9B購01  ,0,0,0,0,0,0,0,0,0,1000,0,0,0,1000,0,1000,1000
055820,矽力國票98購02  ,0,0,0,0,0,0,0,0,0,1000,0,0,0,1000,0,1000,1000
055873,聚陽元富97購01  ,0,0,0,0,0,0,0,0,0,1000,0,0,0,2000,1000,1000,1000
056359,旺宏元大9A購01  ,0,0,0,0,0,0,0,0,0,1000,0,0,0,1000,0,1000,1000
05687P,臺股指元大96售12,0,0,0,0,0,0,0,0,0,1000,0,0,0,1000,0,1000,1000
05686P,臺股指元大96售11,0,0,0,0,0,0,0,0,0,1000,0,0,0,1000,0,1000,1000
056890,國巨元大98購11  ,0,0,0,0,0,0,0,0,0,1000,0,0,0,58000,57000,1000,1000
056124,華通國票98購02  ,0,0,0,0,0,0,0,0,0,1000,0,0,0,20000,19000,1000,1000
056094,大立光元富97購03,0,0,0,0,0,0,0,0,0,1000,0,0,0,99000,98000,1000,1000
056444,南亞科凱基99購01,0,0,0,0,0,0,0,0,0,1000,0,0,0,1000,0,1000,1000
058608,華新科元大99購13,0,0,0,0,0,0,0,0,0,1000,0,0,0,1000,0,1000,1000
058647,華新科永豐99購03,0,0,0,0,0,0,0,0,0,1000,0,0,0,22000,21000,1000,1000
058595,T50正2元富99購01,0,0,0,0,0,0,0,0,0,1000,0,0,0,1000,0,1000,1000
058605,華邦電元大99購04,0,0,0,0,0,0,0,0,0,1000,0,0,0,202000,201000,1000,1000
057088,上銀元富98購01  ,0,0,0,0,0,0,0,0,0,1000,0,0,0,1000,0,1000,1000
058474,鴻海凱基9A購06  ,0,0,0,0,0,0,0,0,0,1000,0,0,0,1000,0,1000,1000
058483,道瓊指國票9A購01,0,0,0,0,0,0,0,0,0,1000,0,0,0,1000,0,1000,1000
059033,元油2X群益9C購05,0,0,0,0,0,0,0,0,0,1000,0,0,0,1000,0,1000,1000
059059,宏達電凱基99購03,0,0,0,0,0,0,0,0,0,1000,0,0,0,4000,3000,1000,1000
059007,南電元大99購05  ,0,0,0,0,0,0,0,0,0,1000,0,0,0,1000,0,1000,1000
058915,SGBR2X元富99購01,0,0,0,0,0,0,0,0,0,1000,0,0,0,1000,0,1000,1000
058900,旺宏元大99購11  ,0,0,0,0,0,0,0,0,0,1000,0,0,0,1000,0,1000,1000
058848,台積電群益99購07,0,0,0,0,0,0,0,0,0,1000,0,0,0,1000,0,1000,1000
058747,友達凱基9A購03  ,0,0,0,0,0,0,0,0,0,1000,0,0,0,1000,0,1000,1000
6431,光麗-KY         ,1000,0,1000,0,0,0,0,0,0,0,0,0,0,0,0,0,1000
6442,光聖            ,1000,0,1000,0,0,0,0,0,0,0,0,0,0,0,0,0,1000
4764,雙鍵            ,4000,3000,1000,0,0,0,0,0,0,0,0,0,0,0,0,0,1000
5533,皇鼎            ,7000,6000,1000,0,0,0,0,0,0,0,0,0,0,0,0,0,1000
4562,穎漢            ,1000,0,1000,0,0,0,0,0,0,0,0,0,0,0,0,0,1000
3432,台端            ,7000,6000,1000,0,0,0,0,0,0,0,0,0,0,0,0,0,1000
3040,遠見            ,17000,16000,1000,0,0,0,0,0,0,0,0,0,0,0,0,0,1000
3054,立萬利          ,1000,0,1000,0,0,0,0,0,0,0,0,0,0,0,0,0,1000
9929,秋雨            ,1000,0,1000,0,0,0,0,0,0,0,0,0,0,0,0,0,1000
9924,福興            ,58000,70000,-12000,0,0,0,0,0,0,13000,13000,0,13000,0,0,0,1000
8201,無敵            ,11000,10000,1000,0,0,0,0,0,0,0,0,0,0,0,0,0,1000
07382P,台積電群益9B售01,0,0,0,0,0,0,0,0,0,1000,0,0,0,1000,0,1000,1000
07417P,聯發科元大99售44,0,0,0,0,0,0,0,0,0,1000,0,0,0,1000,0,1000,1000
07419P,聯發科元大99售46,0,0,0,0,0,0,0,0,0,1000,0,0,0,1000,0,1000,1000
07454P,台積電元大9A售06,0,0,0,0,0,0,0,0,0,1000,0,0,0,211000,210000,1000,1000
07550P,國巨元大9A售09  ,0,0,0,0,0,0,0,0,0,1000,0,0,0,41000,40000,1000,1000
07575P,瑞昱元大9A售02  ,0,0,0,0,0,0,0,0,0,1000,0,0,0,112000,111000,1000,1000
07121P,華新科凱基99售03,0,0,0,0,0,0,0,0,0,1000,0,0,0,1000,0,1000,1000
07158P,FBVIX國泰9C售01 ,0,0,0,0,0,0,0,0,0,1000,0,0,0,1000,0,1000,1000
07075P,FBVIX凱基9C售04 ,0,0,0,0,0,0,0,0,0,1000,0,0,0,1000,0,1000,1000
06943P,致茂元富98售03  ,0,0,0,0,0,0,0,0,0,1000,0,0,0,1000,0,1000,1000
06828P,臺股指國票98售04,0,0,0,0,0,0,0,0,0,1000,0,0,0,1000,0,1000,1000
06786P,臺股指元大98售03,0,0,0,0,0,0,0,0,0,1000,0,0,0,1000,0,1000,1000
1236,宏亞            ,1000,0,1000,0,0,0,0,0,0,0,0,0,0,0,0,0,1000
1256,鮮活果汁-KY     ,3000,2000,1000,0,0,0,0,0,0,0,0,0,0,0,0,0,1000
1312A,國喬特          ,0,0,0,0,0,0,0,0,0,1000,1000,0,1000,0,0,0,1000
1817,凱撒衛          ,17000,17000,0,0,0,0,0,0,0,1000,1000,0,1000,0,0,0,1000
2881A,富邦特          ,0,1000,-1000,0,0,0,0,0,0,2000,2000,0,2000,0,0,0,1000
06767P,台積電永昌99售03,0,0,0,0,0,0,0,0,0,0,0,0,0,80000,80000,0,0
06741P,台積電富邦98售04,0,0,0,0,0,0,0,0,0,0,0,0,0,10000,10000,0,0
06707P,臺股指台新99售04,0,0,0,0,0,0,0,0,0,0,0,0,0,59000,59000,0,0
06708P,臺股指台新99售05,0,0,0,0,0,0,0,0,0,0,0,0,0,20000,20000,0,0
06709P,臺股指台新99售06,0,0,0,0,0,0,0,0,0,0,0,0,0,10000,10000,0,0
06723P,台灣50麥證99售01,0,0,0,0,20000,-20000,0,0,0,0,0,0,0,20000,20000,0,0
06712P,臺股指台新99售09,0,0,0,0,0,0,0,0,0,0,0,0,0,399000,399000,0,0
06714P,台積電元大98售15,0,0,0,0,0,0,0,0,0,0,0,0,0,10000,10000,0,0
06643P,大立光兆豐98售01,0,0,0,0,0,0,0,0,0,0,0,0,0,10000,10000,0,0
06644P,亞德客元大98售03,0,0,0,0,0,0,0,0,0,0,0,0,0,2000,2000,0,0
06647P,台積電元大98售13,0,0,0,0,0,0,0,0,0,0,0,0,0,10000,10000,0,0
06649P,聯發科元大98售08,0,0,0,0,0,0,0,0,0,0,0,0,0,1000,1000,0,0
06587P,國巨元大98售13  ,0,0,0,0,0,0,0,0,0,0,0,0,0,30000,30000,0,0
06588P,台積電元大98售11,0,0,0,0,0,0,0,0,0,0,0,0,0,10000,10000,0,0
06589P,台積電元大98售12,0,0,0,0,0,0,0,0,0,0,0,0,0,10000,10000,0,0
06543P,鴻海元大98售08  ,0,0,0,0,0,0,0,0,0,0,0,0,0,30000,30000,0,0
06572P,台積電永昌99售01,0,0,0,0,0,0,0,0,0,0,0,0,0,10000,10000,0,0
06616P,國巨元大98售15  ,0,0,0,0,0,0,0,0,0,0,0,0,0,35000,35000,0,0
06517P,國巨凱基98售09  ,0,0,0,0,0,0,0,0,0,0,0,0,0,60000,60000,0,0
06491P,台積電富邦99售02,0,0,0,0,0,0,0,0,0,0,0,0,0,8000,8000,0,0
06508P,台灣50統一98售01,0,0,0,0,0,0,0,0,0,0,0,0,0,270000,270000,0,0
06472P,道瓊銀元大98售03,0,0,0,0,0,0,0,0,0,0,0,0,0,103000,103000,0,0
06450P,聯發科元大98售03,0,0,0,0,0,0,0,0,0,0,0,0,0,81000,81000,0,0
06443P,台積電凱基99售01,0,0,0,0,0,0,0,0,0,0,0,0,0,300000,300000,0,0
06385P,聯發科永豐97售02,0,0,0,0,0,0,0,0,0,0,0,0,0,5000,5000,0,0
06427P,鴻海元大97售13  ,0,0,0,0,0,0,0,0,0,0,0,0,0,65000,65000,0,0
06399P,台表科凱基97售05,0,0,0,0,0,0,0,0,0,0,0,0,0,1000,1000,0,0
06268P,聯詠凱基97售02  ,0,0,0,0,0,0,0,0,0,0,0,0,0,10000,10000,0,0
06312P,樺漢元富97售02  ,0,0,0,0,0,0,0,0,0,0,0,0,0,40000,40000,0,0
06316P,臺股指元富97售03,0,0,0,0,0,0,0,0,0,0,0,0,0,20000,20000,0,0
06329P,大立光兆豐97售04,0,0,0,0,0,0,0,0,0,0,0,0,0,10000,10000,0,0
06299P,可成元大97售04  ,0,0,0,0,0,0,0,0,0,0,0,0,0,61000,61000,0,0
06349P,臺股指台新99售01,0,0,0,0,0,0,0,0,0,0,0,0,0,330000,330000,0,0
06350P,臺股指台新99售02,0,0,0,0,0,0,0,0,0,0,0,0,0,120000,120000,0,0
06351P,臺股指台新99售03,0,0,0,0,0,0,0,0,0,0,0,0,0,320000,320000,0,0
061512,國巨永豐9A購04  ,0,0,0,0,0,0,0,0,0,0,0,0,0,12000,12000,0,0
06201P,可成元大97售01  ,0,0,0,0,0,0,0,0,0,0,0,0,0,1000,1000,0,0
06195P,台積電元富97售06,0,0,0,0,0,0,0,0,0,0,0,0,0,50000,50000,0,0
06199P,聯發科元大97售17,0,0,0,0,0,0,0,0,0,0,0,0,0,40000,40000,0,0
061207,美律元大9A購04  ,0,0,0,0,0,0,0,0,0,0,0,0,0,17000,17000,0,0
06115P,台積電統一97售04,0,0,0,0,0,0,0,0,0,0,0,0,0,10000,10000,0,0
061414,牧德群益9B購02  ,0,0,0,0,0,0,0,0,0,0,0,0,0,1000,1000,0,0
061415,健策群益9A購04  ,0,0,0,0,0,0,0,0,0,0,0,0,0,2000,2000,0,0
061486,國巨兆豐9B購02  ,0,0,0,0,0,0,0,0,0,0,0,0,0,200000,200000,0,0
06148P,台積電元大97售17,0,0,0,0,0,0,0,0,0,0,0,0,0,20000,20000,0,0
06149P,台積電元大97售18,0,0,0,0,0,0,0,0,0,0,0,0,0,8000,8000,0,0
061291,玉晶光統一01購05,0,0,0,0,0,0,0,0,0,0,0,0,0,1000,1000,0,0
061018,台積電國票9B購05,0,0,0,0,0,0,0,0,0,0,0,0,0,7000,7000,0,0
061119,國巨永豐9A購03  ,0,0,0,0,0,0,0,0,0,0,0,0,0,11000,11000,0,0
060859,鴻海永豐9A購01  ,0,0,0,0,0,0,0,0,0,0,0,0,0,9000,9000,0,0
06086P,台積電康和97售01,0,0,0,0,0,0,0,0,0,0,0,0,0,947000,947000,0,0
060607,玉晶光凱基9A購06,0,0,0,0,0,0,0,0,0,0,0,0,0,5000,5000,0,0
060637,玉晶光永豐9A購03,0,0,0,0,0,0,0,0,0,0,0,0,0,5000,5000,0,0
060672,鴻海元大9A購14  ,0,0,0,0,0,0,0,0,0,0,0,0,0,6000,6000,0,0
060744,鴻海國票9A購04  ,0,0,0,0,0,0,0,0,0,0,0,0,0,10000,10000,0,0
060804,T50反1群益9A購02,0,0,0,0,0,0,0,0,0,0,0,0,0,101000,101000,0,0
060277,道瓊反元大9A購02,0,0,0,0,0,0,0,0,0,0,0,0,0,105000,105000,0,0
06014P,聯發科富邦97售02,0,0,0,0,0,0,0,0,0,0,0,0,0,100000,100000,0,0
060409,味全永豐9A購01  ,0,0,0,0,0,0,0,0,0,0,0,0,0,68000,68000,0,0
060467,神基元大9A購01  ,0,0,0,0,0,0,0,0,0,0,0,0,0,1000,1000,0,0
060461,鴻海元大9A購09  ,0,0,0,0,0,0,0,0,0,0,0,0,0,95000,95000,0,0
060352,滬深2X元富9A購02,0,0,0,0,0,0,0,0,0,0,0,0,0,1000,1000,0,0
060354,A50正2元富9A購02,0,0,0,0,0,0,0,0,0,0,0,0,0,1000,1000,0,0
060355,元金2X元富9C購01,0,0,0,0,0,0,0,0,0,0,0,0,0,10000,10000,0,0
060358,國巨元富9A購01  ,0,0,0,0,0,0,0,0,0,0,0,0,0,10000,10000,0,0
060370,滬深2X元富04購01,0,0,0,0,0,0,0,0,0,0,0,0,0,1000,1000,0,0
059941,聯發科永豐99購04,0,0,0,0,0,0,0,0,0,0,0,0,0,4000,4000,0,0
05984P,台積電統一98售01,0,0,0,0,0,0,0,0,0,0,0,0,0,250000,250000,0,0
059873,華新科凱基99購09,0,0,0,0,0,0,0,0,0,0,0,0,0,13000,13000,0,0
059870,全新凱基99購05  ,0,0,0,0,0,0,0,0,0,0,0,0,0,161000,161000,0,0
060000,國巨台新99購01  ,0,0,0,0,0,0,0,0,0,0,0,0,0,10000,10000,0,0
060142,臺指反國票9B購01,0,0,0,0,0,0,0,0,0,0,0,0,0,400000,400000,0,0
060118,臺指反富邦9C購01,0,0,0,0,0,0,0,0,0,0,0,0,0,40000,40000,0,0
060116,世紀鋼元大99購07,0,0,0,0,0,0,0,0,0,0,0,0,0,51000,51000,0,0
060077,台積電台新9B購01,0,0,0,0,0,0,0,0,0,0,0,0,0,6000,6000,0,0
059331,台灣50國票9A購06,0,0,0,0,0,0,0,0,0,0,0,0,0,30000,30000,0,0
059318,旺宏元大99購13  ,0,0,0,0,0,0,0,0,0,0,0,0,0,3000,3000,0,0
059315,鴻海元大99購30  ,0,0,0,0,0,0,0,0,0,0,0,0,0,69000,69000,0,0
059340,鴻海凱基9A購12  ,0,0,0,0,0,0,0,0,0,0,0,0,0,19000,19000,0,0
05935P,台積電凱基96售19,0,0,0,0,0,0,0,0,0,0,0,0,0,40000,40000,0,0
059441,祥碩元大99購02  ,0,0,0,0,0,0,0,0,0,0,0,0,0,15000,15000,0,0
059211,鴻海元大99購27  ,0,0,0,0,0,0,0,0,0,0,0,0,0,58000,58000,0,0
059237,鴻海凱基9A購10  ,0,0,0,0,0,0,0,0,0,0,0,0,0,1000,1000,0,0
05926P,智易永豐96售02  ,0,0,0,0,0,0,0,0,0,0,0,0,0,20000,20000,0,0
059102,聯鈞元富99購01  ,0,0,0,0,0,0,0,0,0,0,0,0,0,6000,6000,0,0
059537,大立光凱基99購09,0,0,0,0,0,0,0,0,0,0,0,0,0,65000,65000,0,0
059538,健策凱基99購03  ,0,0,0,0,0,0,0,0,0,0,0,0,0,2000,2000,0,0
059544,創意亞東99購01  ,0,0,0,0,0,0,0,0,0,0,0,0,0,10000,10000,0,0
059514,嘉澤永豐99購02  ,0,0,0,0,0,0,0,0,0,0,0,0,0,5000,5000,0,0
059630,美律凱基99購07  ,0,0,0,0,0,0,0,0,0,0,0,0,0,50000,50000,0,0
059642,健策凱基99購04  ,0,0,0,0,0,0,0,0,0,0,0,0,0,2000,2000,0,0
059573,健策凱基9A購02  ,0,0,0,0,0,0,0,0,0,0,0,0,0,2000,2000,0,0
059593,聯發科元大99購29,0,0,0,0,0,0,0,0,0,0,0,0,0,1000,1000,0,0
059599,健策元大9B購02  ,0,0,0,0,0,0,0,0,0,0,0,0,0,3000,3000,0,0
059721,旺宏元大99購16  ,0,0,0,0,0,0,0,0,0,0,0,0,0,3000,3000,0,0
059707,健策凱基9A購03  ,0,0,0,0,0,0,0,0,0,0,0,0,0,2000,2000,0,0
059700,鴻海凱基9A購16  ,0,0,0,0,0,0,0,0,0,0,0,0,0,2000,2000,0,0
05980P,台積電永昌96售09,0,0,0,0,0,0,0,0,0,0,0,0,0,78000,78000,0,0
053510,聯電群益97購01  ,0,0,0,0,0,0,0,0,0,0,0,0,0,500000,500000,0,0
053163,上証2X群益9A購02,0,0,0,0,0,0,0,0,0,0,0,0,0,22000,22000,0,0
054711,禾伸堂元富97購01,0,0,0,0,0,0,0,0,0,0,0,0,0,10000,10000,0,0
054519,禾伸堂元大97購02,0,0,0,0,0,0,0,0,0,0,0,0,0,10000,10000,0,0
053093,緯穎元大96購06  ,0,0,0,0,0,0,0,0,0,0,0,0,0,4000,4000,0,0
053098,國巨元富96購04  ,0,0,0,0,0,0,0,0,0,0,0,0,0,20000,20000,0,0
053130,聯發科麥證96購01,0,0,0,0,50000,-50000,0,0,0,0,0,0,0,50000,50000,0,0
056491,南亞科國泰99購01,0,0,0,0,0,0,0,0,0,0,0,0,0,10000,10000,0,0
056536,義隆凱基98購04  ,0,0,0,0,0,0,0,0,0,0,0,0,0,19000,19000,0,0
056504,國巨永豐98購02  ,0,0,0,0,0,0,0,0,0,0,0,0,0,19000,19000,0,0
056557,世紀鋼凱基98購02,0,0,0,0,0,0,0,0,0,0,0,0,0,18000,18000,0,0
055346,國巨凱基98購02  ,0,0,0,0,0,0,0,0,0,0,0,0,0,200000,200000,0,0
057525,光磊元大99購01  ,0,0,0,0,0,0,0,0,0,0,0,0,0,8000,8000,0,0
05749P,臺股指群益99售03,0,0,0,0,0,0,0,0,0,0,0,0,0,3000,3000,0,0
057506,聯鈞國票99購02  ,0,0,0,0,0,0,0,0,0,0,0,0,0,80000,80000,0,0
057487,聯發科元大98購10,0,0,0,0,0,0,0,0,0,0,0,0,0,51000,51000,0,0
055415,禾伸堂富邦9B購01,0,0,0,0,0,0,0,0,0,0,0,0,0,12000,12000,0,0
055455,健策國泰98購02  ,0,0,0,0,0,0,0,0,0,0,0,0,0,90000,90000,0,0
055448,健策統一97購02  ,0,0,0,0,0,0,0,0,0,0,0,0,0,10000,10000,0,0
056596,光磊元富98購01  ,0,0,0,0,0,0,0,0,0,0,0,0,0,20000,20000,0,0
056636,台積電日盛9A購01,0,0,0,0,0,0,0,0,0,0,0,0,0,100000,100000,0,0
054232,台積電群益96購12,0,0,0,0,0,0,0,0,0,0,0,0,0,10000,10000,0,0
05427P,聯發科凱基96售07,0,0,0,0,0,0,0,0,0,0,0,0,0,6000,6000,0,0
054346,世芯國票97購01  ,0,0,0,0,0,0,0,0,0,0,0,0,0,5000,5000,0,0
05326P,臺股指凱基95售10,0,0,0,0,0,0,0,0,0,0,0,0,0,958000,958000,0,0
053261,國巨群益96購05  ,0,0,0,0,0,0,0,0,0,0,0,0,0,10000,10000,0,0
053278,禾伸堂元大96購01,0,0,0,0,0,0,0,0,0,0,0,0,0,19000,19000,0,0
052791,友達兆豐97購01  ,0,0,0,0,0,0,0,0,0,0,0,0,0,10000,10000,0,0
05282P,可成元大95售09  ,0,0,0,0,0,0,0,0,0,0,0,0,0,1000,1000,0,0
054175,高鐵台新97購01  ,0,0,0,0,0,0,0,0,0,0,0,0,0,20000,20000,0,0
054017,茂林永豐96購02  ,0,0,0,0,0,0,0,0,0,0,0,0,0,12000,12000,0,0
054783,國巨群益98購04  ,0,0,0,0,0,0,0,0,0,0,0,0,0,20000,20000,0,0
054444,緯穎台新97購01  ,0,0,0,0,0,0,0,0,0,0,0,0,0,32000,32000,0,0
052940,玉晶光兆豐97購01,0,0,0,0,0,0,0,0,0,0,0,0,0,614000,614000,0,0
052972,義隆群益96購04  ,0,0,0,0,0,0,0,0,0,0,0,0,0,16000,16000,0,0
052994,群創台新99購01  ,0,0,0,0,0,0,0,0,0,0,0,0,0,440000,440000,0,0
053037,國巨凱基96購08  ,0,0,0,0,0,0,0,0,0,0,0,0,0,70000,70000,0,0
053049,T50反1國票98購01,0,0,0,0,0,0,0,0,0,0,0,0,0,20000,20000,0,0
053064,國巨群益96購04  ,0,0,0,0,0,0,0,0,0,0,0,0,0,42000,42000,0,0
053065,大立光群益96購01,0,0,0,0,0,0,0,0,0,0,0,0,0,100000,100000,0,0
053090,新唐元大96購01  ,0,0,0,0,0,0,0,0,0,0,0,0,0,10000,10000,0,0
054847,創意兆豐97購01  ,0,0,0,0,0,0,0,0,0,0,0,0,0,50000,50000,0,0
052897,緯創群益96購03  ,0,0,0,0,0,0,0,0,0,0,0,0,0,60000,60000,0,0
05290P,國巨永豐95售04  ,0,0,0,0,0,0,0,0,0,0,0,0,0,40000,40000,0,0
020011,統一微波高息20N ,0,0,0,0,0,0,0,0,0,0,0,0,0,1000,1000,0,0
00707R,元大S&P日圓反1  ,0,0,0,0,0,0,0,0,0,0,0,0,0,1000,1000,0,0
00774B,新光中國政金綠債,0,0,0,0,0,0,0,0,0,0,0,0,0,2000,2000,0,0
00775B,新光投等債15+   ,0,0,0,0,0,0,0,0,0,0,0,0,0,2000,2000,0,0
00776,新光ICE美國權值 ,0,0,0,0,0,0,0,0,0,0,0,0,0,100000,100000,0,0
00732,國泰RMB短期報酬 ,0,0,0,0,0,0,0,0,0,0,0,0,0,100000,100000,0,0
00742,新光內需收益    ,0,0,0,0,0,0,0,0,0,0,0,0,0,101000,101000,0,0
00668K,國泰美國道瓊+U  ,0,0,0,0,0,0,0,0,0,0,0,0,0,100,100,0,0
00657K,國泰日經225+U   ,0,0,0,0,0,0,0,0,0,0,0,0,0,100,100,0,0
006204,永豐臺灣加權    ,0,0,0,0,0,0,0,0,0,0,0,0,0,1000,1000,0,0
00636K,國泰中國A50+U   ,0,0,0,0,0,0,0,0,0,0,0,0,0,100,100,0,0
00625K,富邦上証+R      ,0,0,0,0,0,0,0,0,0,0,0,0,0,50000,50000,0,0
042556,台灣50中信96購04,0,0,0,0,0,0,0,0,0,0,0,0,0,40000,40000,0,0
049231,鴻海富邦95購02  ,0,0,0,0,0,0,0,0,0,0,0,0,0,30000,30000,0,0
04452P,超眾國泰95售01  ,0,0,0,0,0,0,0,0,0,0,0,0,0,50000,50000,0,0
04571P,華新科國泰95售03,0,0,0,0,0,0,0,0,0,0,0,0,0,59000,59000,0,0
04767P,台積電國泰95售04,0,0,0,0,0,0,0,0,0,0,0,0,0,10000,10000,0,0
048747,華通元富97購01  ,0,0,0,0,0,0,0,0,0,0,0,0,0,10000,10000,0,0
048754,瀚宇博元富97購01,0,0,0,0,0,0,0,0,0,0,0,0,0,100000,100000,0,0
04869P,鴻海元富95售02  ,0,0,0,0,0,0,0,0,0,0,0,0,0,120000,120000,0,0
05035P,聯發科元大95售06,0,0,0,0,0,0,0,0,0,0,0,0,0,43000,43000,0,0
050166,彩晶國泰95購01  ,0,0,0,0,0,0,0,0,0,0,0,0,0,100000,100000,0,0
05014P,臺股指元大95售05,0,0,0,0,0,0,0,0,0,0,0,0,0,1000,1000,0,0
04960P,大立光凱基96售04,0,0,0,0,0,0,0,0,0,0,0,0,0,10000,10000,0,0
049492,聯發科元大95購02,0,0,0,0,0,0,0,0,0,0,0,0,0,1000,1000,0,0
052234,GIS凱基97購01   ,0,0,0,0,0,0,0,0,0,0,0,0,0,8000,8000,0,0
03430B,臺股指元大9B熊01,0,0,0,0,0,0,0,0,0,0,0,0,0,5000,5000,0,0
03427B,臺股指元大9A熊02,0,0,0,0,0,0,0,0,0,0,0,0,0,4000,4000,0,0
052060,旺宏國票96購02  ,0,0,0,0,0,0,0,0,0,0,0,0,0,170000,170000,0,0
052085,聯電元大95購01  ,0,0,0,0,0,0,0,0,0,0,0,0,0,79000,79000,0,0
052151,義隆富邦96購01  ,0,0,0,0,0,0,0,0,0,0,0,0,0,1000,1000,0,0
052134,智邦凱基95購09  ,0,0,0,0,0,0,0,0,0,0,0,0,0,10000,10000,0,0
051801,牧德永豐95購04  ,0,0,0,0,0,0,0,0,0,0,0,0,0,105000,105000,0,0
05178P,大立光凱基96售05,0,0,0,0,0,0,0,0,0,0,0,0,0,10000,10000,0,0
051790,貿聯國票95購03  ,0,0,0,0,0,0,0,0,0,0,0,0,0,499000,499000,0,0
051798,國巨永豐95購03  ,0,0,0,0,0,0,0,0,0,0,0,0,0,10000,10000,0,0
051837,國巨國泰96購04  ,0,0,0,0,0,0,0,0,0,0,0,0,0,60000,60000,0,0
051879,健策台新96購01  ,0,0,0,0,0,0,0,0,0,0,0,0,0,30000,30000,0,0
051927,國巨中信96購01  ,0,0,0,0,0,0,0,0,0,0,0,0,0,230000,230000,0,0
05096P,台積電日盛95售01,0,0,0,0,0,0,0,0,0,0,0,0,0,54000,54000,0,0
05173P,臺股指元大95售17,0,0,0,0,0,0,0,0,0,0,0,0,0,1000,1000,0,0
050694,國巨凱基96購03  ,0,0,0,0,0,0,0,0,0,0,0,0,0,20000,20000,0,0
05093P,可成元大95售03  ,0,0,0,0,0,0,0,0,0,0,0,0,0,1000,1000,0,0
050893,鴻海元大96購03  ,0,0,0,0,0,0,0,0,0,0,0,0,0,49000,49000,0,0
052313,聯電元大98購01  ,0,0,0,0,0,0,0,0,0,0,0,0,0,25000,25000,0,0
051619,智邦凱基95購07  ,0,0,0,0,0,0,0,0,0,0,0,0,0,120000,120000,0,0
052342,茂林凱基96購01  ,0,0,0,0,0,0,0,0,0,0,0,0,0,40000,40000,0,0
052377,景碩元大96購02  ,0,0,0,0,0,0,0,0,0,0,0,0,0,50000,50000,0,0
051596,超眾元大95購05  ,0,0,0,0,0,0,0,0,0,0,0,0,0,50000,50000,0,0
051553,牧德永豐96購02  ,0,0,0,0,0,0,0,0,0,0,0,0,0,78000,78000,0,0
052593,台積電群益96購02,0,0,0,0,0,0,0,0,0,0,0,0,0,165000,165000,0,0
052576,聯茂凱基96購01  ,0,0,0,0,0,0,0,0,0,0,0,0,0,10000,10000,0,0
052619,茂林國泰99購01  ,0,0,0,0,0,0,0,0,0,0,0,0,0,170000,170000,0,0
052647,晶技永豐97購01  ,0,0,0,0,0,0,0,0,0,0,0,0,0,12000,12000,0,0
052559,茂林國票97購01  ,0,0,0,0,0,0,0,0,0,0,0,0,0,25000,25000,0,0
053930,S&P反1統一98購01,0,0,0,0,0,0,0,0,0,0,0,0,0,20000,20000,0,0
053922,亞光國票96購01  ,0,0,0,0,0,0,0,0,0,0,0,0,0,5000,5000,0,0
058729,國巨永豐99購03  ,0,0,0,0,0,0,0,0,0,0,0,0,0,9000,9000,0,0
058792,鴻海元大99購18  ,0,0,0,0,0,0,0,0,0,0,0,0,0,42000,42000,0,0
058898,台積電元大99購20,0,0,0,0,0,0,0,0,0,0,0,0,0,200000,200000,0,0
058895,鴻海元大99購20  ,0,0,0,0,0,0,0,0,0,0,0,0,0,21000,21000,0,0
058861,國巨凱基9A購08  ,0,0,0,0,0,0,0,0,0,0,0,0,0,200000,200000,0,0
058998,鴻海元大99購22  ,0,0,0,0,0,0,0,0,0,0,0,0,0,30000,30000,0,0
05898P,旺宏凱基96售06  ,0,0,0,0,0,0,0,0,0,0,0,0,0,10000,10000,0,0
058980,鴻海凱基99購06  ,0,0,0,0,0,0,0,0,0,0,0,0,0,59000,59000,0,0
059053,鴻海凱基99購07  ,0,0,0,0,0,0,0,0,0,0,0,0,0,1000,1000,0,0
057953,聚陽元大98購01  ,0,0,0,0,0,0,0,0,0,0,0,0,0,50000,50000,0,0
057936,健策群益99購01  ,0,0,0,0,0,0,0,0,0,0,0,0,0,2000,2000,0,0
057759,聯發科凱基98購17,0,0,0,0,0,0,0,0,0,0,0,0,0,10000,10000,0,0
057790,台積電統一99購04,0,0,0,0,0,0,0,0,0,0,0,0,0,1000,1000,0,0
057984,聯發科台新98購01,0,0,0,0,0,0,0,0,0,0,0,0,0,491000,491000,0,0
05781P,臺股指統一99售02,0,0,0,0,0,0,0,0,0,0,0,0,0,20000,20000,0,0
058601,台積電元大99購10,0,0,0,0,0,0,0,0,0,0,0,0,0,111000,111000,0,0
05850P,台積電兆豐96售06,0,0,0,0,0,0,0,0,0,0,0,0,0,80000,80000,0,0
058535,玉晶光統一9A購06,0,0,0,0,0,0,0,0,0,0,0,0,0,10000,10000,0,0
058538,智邦台新99購02  ,0,0,0,0,0,0,0,0,0,0,0,0,0,1000,1000,0,0
05868P,台積電凱基96售17,0,0,0,0,0,0,0,0,0,0,0,0,0,450000,450000,0,0
056446,聯發科凱基98購08,0,0,0,0,0,0,0,0,0,0,0,0,0,10000,10000,0,0
056429,華通凱基98購02  ,0,0,0,0,0,0,0,0,0,0,0,0,0,30000,30000,0,0
056435,台積電凱基98購09,0,0,0,0,0,0,0,0,0,0,0,0,0,1000,1000,0,0
056437,台積電凱基98購11,0,0,0,0,0,0,0,0,0,0,0,0,0,15000,15000,0,0
056430,鴻海凱基98購06  ,0,0,0,0,0,0,0,0,0,0,0,0,0,11000,11000,0,0
056057,華邦電元大97購05,0,0,0,0,0,0,0,0,0,0,0,0,0,68000,68000,0,0
05604P,聯發科元大96售10,0,0,0,0,0,0,0,0,0,0,0,0,0,34000,34000,0,0
057665,技嘉元大99購01  ,0,0,0,0,0,0,0,0,0,0,0,0,0,50000,50000,0,0
056138,群創元大9B購01  ,0,0,0,0,0,0,0,0,0,0,0,0,0,1000,1000,0,0
056867,華通麥證98購01  ,0,0,0,0,10000,-10000,0,0,0,0,0,0,0,10000,10000,0,0
056875,亞光凱基98購03  ,0,0,0,0,0,0,0,0,0,0,0,0,0,50000,50000,0,0
056858,國巨群益99購03  ,0,0,0,0,0,0,0,0,0,0,0,0,0,10000,10000,0,0
056306,晶相光元大98購01,10000,0,10000,0,0,0,0,0,0,-10000,0,0,0,0,10000,-10000,0
056405,聯茂群益98購01  ,0,0,0,0,0,0,0,0,0,0,0,0,0,2000,2000,0,0
056239,宏達電群益98購01,0,0,0,0,0,0,0,0,0,0,0,0,0,9000,9000,0,0
056169,鴻海元富97購08  ,0,0,0,0,0,0,0,0,0,0,0,0,0,150000,150000,0,0
056171,鴻海元富97購10  ,0,0,0,0,0,0,0,0,0,0,0,0,0,10000,10000,0,0
056178,嘉澤元富97購02  ,0,0,0,0,0,0,0,0,0,0,0,0,0,10000,10000,0,0
05617P,大立光統一97售02,0,0,0,0,0,0,0,0,0,0,0,0,0,10000,10000,0,0
056231,嘉聯益凱基97購02,0,0,0,0,0,0,0,0,0,0,0,0,0,2000,2000,0,0
056200,大毅永豐98購01  ,0,0,0,0,0,0,0,0,0,0,0,0,0,20000,20000,0,0
055859,啟碁元大97購03  ,0,0,0,0,0,0,0,0,0,0,0,0,0,68000,68000,0,0
055911,可成凱基98購02  ,0,0,0,0,0,0,0,0,0,0,0,0,0,2000,2000,0,0
05695P,台積電凱基96售10,0,0,0,0,0,0,0,0,0,0,0,0,0,34000,34000,0,0
056933,國巨元富98購03  ,0,0,0,0,0,0,0,0,0,0,0,0,0,160000,160000,0,0
05697P,友達凱基96售01  ,40000,0,40000,0,0,0,0,0,0,-40000,0,0,0,0,40000,-40000,0
056969,智易永豐98購01  ,0,0,0,0,0,0,0,0,0,0,0,0,0,3000,3000,0,0
05768P,台積電凱基96售15,0,0,0,0,0,0,0,0,0,0,0,0,0,10000,10000,0,0
05769P,台積電凱基96售16,0,0,0,0,0,0,0,0,0,0,0,0,0,163000,163000,0,0
055947,元油反元大98購03,0,0,0,0,0,0,0,0,0,0,0,0,0,10000,10000,0,0
055972,GIS元大97購04   ,0,0,0,0,0,0,0,0,0,0,0,0,0,17000,17000,0,0
055926,國巨群益98購06  ,0,0,0,0,0,0,0,0,0,0,0,0,0,200000,200000,0,0
05767P,國巨凱基96售11  ,0,0,0,0,0,0,0,0,0,0,0,0,0,1000,1000,0,0
057757,鴻海凱基98購13  ,0,0,0,0,0,0,0,0,0,0,0,0,0,16000,16000,0,0
057744,健策永豐98購02  ,0,0,0,0,0,0,0,0,0,0,0,0,0,29000,29000,0,0
057739,新日興富邦9B購01,0,0,0,0,0,0,0,0,0,0,0,0,0,50000,50000,0,0
05773P,臺股指凱基99售03,0,0,0,0,0,0,0,0,0,0,0,0,0,50000,50000,0,0
057066,緯穎富邦99購01  ,0,0,0,0,0,0,0,0,0,0,0,0,0,25000,25000,0,0
055997,矽創國泰99購01  ,0,0,0,0,0,0,0,0,0,0,0,0,0,20000,20000,0,0
05601P,鴻海元大97售04  ,0,0,0,0,0,0,0,0,0,0,0,0,0,2000,2000,0,0
056020,義隆群益97購01  ,0,0,0,0,0,0,0,0,0,0,0,0,0,18000,18000,0,0
05701P,彩晶凱基96售01  ,0,0,0,0,0,0,0,0,0,0,0,0,0,20000,20000,0,0
056036,鴻海凱基97購07  ,0,0,0,0,0,0,0,0,0,0,0,0,0,21000,21000,0,0
05603P,聯發科元大96售09,0,0,0,0,0,0,0,0,0,0,0,0,0,1000,1000,0,0
058044,鴻海元大99購07  ,0,0,0,0,0,0,0,0,0,0,0,0,0,45000,45000,0,0
058031,旺宏永豐98購04  ,0,0,0,0,0,0,0,0,0,0,0,0,0,3000,3000,0,0
058023,南電凱基98購02  ,0,0,0,0,0,0,0,0,0,0,0,0,0,10000,10000,0,0
058084,大立光群益98購04,0,0,0,0,0,0,0,0,0,0,0,0,0,20000,20000,0,0
058078,景碩國票99購01  ,0,0,0,0,0,0,0,0,0,0,0,0,0,34000,34000,0,0
058066,可成亞東99購01  ,0,0,0,0,0,0,0,0,0,0,0,0,0,30000,30000,0,0
058091,欣興元大99購03  ,0,0,0,0,0,0,0,0,0,0,0,0,0,2000,2000,0,0
056731,國巨凱基98購04  ,0,0,0,0,0,0,0,0,0,0,0,0,0,200000,200000,0,0
056704,健策國泰99購01  ,0,0,0,0,0,0,0,0,0,0,0,0,0,30000,30000,0,0
056737,國巨凱基9A購01  ,0,0,0,0,0,0,0,0,0,0,0,0,0,151000,151000,0,0
056693,國產群益98購01  ,0,0,0,0,0,0,0,0,0,0,0,0,0,98000,98000,0,0
056680,華通統一98購04  ,0,0,0,0,0,0,0,0,0,0,0,0,0,10000,10000,0,0
057139,華新科兆豐98購02,0,0,0,0,0,0,0,0,0,0,0,0,0,125000,125000,0,0
057146,技嘉國票98購01  ,0,0,0,0,0,0,0,0,0,0,0,0,0,5000,5000,0,0
057632,傳奇永豐98購01  ,0,0,0,0,0,0,0,0,0,0,0,0,0,75000,75000,0,0
057565,可成富邦99購01  ,0,0,0,0,0,0,0,0,0,0,0,0,0,30000,30000,0,0
055490,台光電元大97購01,0,0,0,0,0,0,0,0,0,0,0,0,0,68000,68000,0,0
05718P,國巨元大96售09  ,0,0,0,0,0,0,0,0,0,0,0,0,0,20000,20000,0,0
057218,可成群益99購03  ,0,0,0,0,0,0,0,0,0,0,0,0,0,30000,30000,0,0
05722P,玉晶光國票97售03,0,0,0,0,0,0,0,0,0,0,0,0,0,10000,10000,0,0
05556P,全新國票96售04  ,0,0,0,0,0,0,0,0,0,0,0,0,0,10000,10000,0,0
055556,奇力新凱基98購03,0,0,0,0,0,0,0,0,0,0,0,0,0,98000,98000,0,0
057427,華通兆豐99購01  ,0,0,0,0,0,0,0,0,0,0,0,0,0,5000,5000,0,0
05743P,創意元大96售01  ,0,0,0,0,0,0,0,0,0,0,0,0,0,30000,30000,0,0
057444,台泥元富98購01  ,0,0,0,0,0,0,0,0,0,0,0,0,0,9000,9000,0,0
057456,道瓊銀富邦9C購01,0,0,0,0,0,0,0,0,0,0,0,0,0,400000,400000,0,0
05739P,臺股指統一97售02,0,0,0,0,0,0,0,0,0,0,0,0,0,375000,375000,0,0
057392,福懋科永豐98購01,0,0,0,0,0,0,0,0,0,0,0,0,0,10000,10000,0,0
057376,新日興元大98購04,0,0,0,0,0,0,0,0,0,0,0,0,0,68000,68000,0,0
057349,聯發科統一98購04,0,0,0,0,0,0,0,0,0,0,0,0,0,10000,10000,0,0
057336,聯發科國票99購01,0,0,0,0,0,0,0,0,0,0,0,0,0,10000,10000,0,0
055251,華新科統一99購01,0,0,0,0,0,0,0,0,0,0,0,0,0,5000,5000,0,0
055247,聯發科統一98購01,0,0,0,0,0,0,0,0,0,0,0,0,0,10000,10000,0,0
055238,茂林台新97購01  ,0,0,0,0,0,0,0,0,0,0,0,0,0,30000,30000,0,0
055231,大毅國票98購02  ,0,0,0,0,0,0,0,0,0,0,0,0,0,10000,10000,0,0
05518P,T50反1凱基98售03,0,0,0,0,0,0,0,0,0,0,0,0,0,130000,130000,0,0
055185,晶相光統一97購01,10000,0,10000,0,0,0,0,0,0,-10000,0,0,0,0,10000,-10000,0
055122,國巨兆豐98購01  ,0,0,0,0,0,0,0,0,0,0,0,0,0,130000,130000,0,0
05504P,台積電凱基96售04,0,0,0,0,0,0,0,0,0,0,0,0,0,50000,50000,0,0
055060,聯陽永豐97購01  ,0,0,0,0,0,0,0,0,0,0,0,0,0,42000,42000,0,0
055099,可成日盛97購01  ,0,0,0,0,0,0,0,0,0,0,0,0,0,80000,80000,0,0
056745,聯茂凱基99購03  ,0,0,0,0,0,0,0,0,0,0,0,0,0,1000,1000,0,0
056752,國巨兆豐98購02  ,0,0,0,0,0,0,0,0,0,0,0,0,0,80000,80000,0,0
056816,華通永豐98購02  ,0,0,0,0,0,0,0,0,0,0,0,0,0,20000,20000,0,0
056804,T50反1統一9A購03,0,0,0,0,0,0,0,0,0,0,0,0,0,30000,30000,0,0
056837,國巨元富98購02  ,0,0,0,0,0,0,0,0,0,0,0,0,0,110000,110000,0,0
05614P,臺股指康和96售03,0,0,0,0,0,0,0,0,0,0,0,0,0,200000,200000,0,0
056156,禾伸堂凱基98購04,0,0,0,0,0,0,0,0,0,0,0,0,0,10000,10000,0,0
055271,鴻海元大98購03  ,0,0,0,0,0,0,0,0,0,0,0,0,0,26000,26000,0,0
055293,晶相光元大97購01,10000,0,10000,0,0,0,0,0,0,-10000,0,0,0,0,10000,-10000,0
055711,上銀元大97購04  ,0,0,0,0,0,0,0,0,0,0,0,0,0,60000,60000,0,0
058168,國巨凱基9A購04  ,0,0,0,0,0,0,0,0,0,0,0,0,0,200000,200000,0,0
05816P,台積電凱基97售07,0,0,0,0,0,0,0,0,0,0,0,0,0,94000,94000,0,0
058199,國巨康和99購01  ,0,0,0,0,0,0,0,0,0,0,0,0,0,200000,200000,0,0
058207,南茂凱基99購01  ,0,0,0,0,0,0,0,0,0,0,0,0,0,9000,9000,0,0
05842P,台積電元大96售15,0,0,0,0,0,0,0,0,0,0,0,0,0,70000,70000,0,0
058436,聯發科統一9B購03,0,0,0,0,0,0,0,0,0,0,0,0,0,210000,210000,0,0
058439,玉晶光統一01購02,0,0,0,0,0,0,0,0,0,0,0,0,0,1000,1000,0,0
058303,華通元大99購03  ,0,0,0,0,0,0,0,0,0,0,0,0,0,20000,20000,0,0
058345,台光電群益99購03,0,0,0,0,0,0,0,0,0,0,0,0,0,50000,50000,0,0
058347,玉晶光群益9B購01,0,0,0,0,0,0,0,0,0,0,0,0,0,20000,20000,0,0
058331,鴻海元富99購02  ,0,0,0,0,0,0,0,0,0,0,0,0,0,140000,140000,0,0
058332,鴻海元富99購03  ,0,0,0,0,0,0,0,0,0,0,0,0,0,20000,20000,0,0
058333,鴻海元富99購04  ,0,0,0,0,0,0,0,0,0,0,0,0,0,15000,15000,0,0
058427,大毅元富99購01  ,0,0,0,0,0,0,0,0,0,0,0,0,0,10000,10000,0,0
058414,大立光兆豐99購02,0,0,0,0,0,0,0,0,0,0,0,0,0,40000,40000,0,0
057910,華新科兆豐99購02,0,0,0,0,0,0,0,0,0,0,0,0,0,10000,10000,0,0
057921,可成凱基98購09  ,0,0,0,0,0,0,0,0,0,0,0,0,0,30000,30000,0,0
057919,技嘉凱基98購03  ,0,0,0,0,0,0,0,0,0,0,0,0,0,10000,10000,0,0
2901,欣欣            ,3000,3000,0,0,0,0,0,0,0,0,0,0,0,0,0,0,0
2543,皇昌            ,4000,4000,0,0,0,0,0,0,0,0,0,0,0,0,0,0,0
2613,中櫃            ,1000,1000,0,0,0,0,0,0,0,0,0,0,0,0,0,0,0
1805,寶徠            ,3000,3000,0,0,0,0,0,0,0,0,0,0,0,0,0,0,0
1726,永記            ,3000,3000,0,0,0,0,0,0,0,0,0,0,0,0,0,0,0
1583,程泰            ,1000,1000,0,0,0,0,0,0,0,0,0,0,0,0,0,0,0
07749P,台郡凱基9A售01  ,0,0,0,0,0,0,0,0,0,0,0,0,0,14000,14000,0,0
07769P,國巨國票9A售10  ,0,0,0,0,0,0,0,0,0,0,0,0,0,10000,10000,0,0
07777P,創意元大9A售03  ,0,0,0,0,0,0,0,0,0,0,0,0,0,50000,50000,0,0
08653P,台灣50凱基96售07,0,0,0,0,0,0,0,0,0,0,0,0,0,100000,100000,0,0
08674P,嘉晶元富07售02  ,0,0,0,0,0,0,0,0,0,0,0,0,0,10000,10000,0,0
06811P,聯發科統一98售06,0,0,0,0,0,0,0,0,0,0,0,0,0,10000,10000,0,0
06834P,訊芯群益99售02  ,0,0,0,0,0,0,0,0,0,0,0,0,0,110000,110000,0,0
06838P,台積電統一99售05,0,0,0,0,0,0,0,0,0,0,0,0,0,1000,1000,0,0
06861P,台積電國票99售08,0,0,0,0,0,0,0,0,0,0,0,0,0,175000,175000,0,0
06875P,台灣50永昌9A售02,0,0,0,0,0,0,0,0,0,0,0,0,0,66000,66000,0,0
06877P,台積電兆豐98售04,0,0,0,0,0,0,0,0,0,0,0,0,0,10000,10000,0,0
06931P,大立光元大98售20,0,0,0,0,0,0,0,0,0,0,0,0,0,10000,10000,0,0
06919P,臺股指日盛98售02,0,0,0,0,0,0,0,0,0,0,0,0,0,9000,9000,0,0
06960P,國巨凱基99售08  ,0,0,0,0,0,0,0,0,0,0,0,0,0,20000,20000,0,0
06970P,旺宏元大99售08  ,0,0,0,0,0,0,0,0,0,0,0,0,0,70000,70000,0,0
06978P,聯發科富邦9B售02,0,0,0,0,0,0,0,0,0,0,0,0,0,1000,1000,0,0
07001P,國巨元大99售12  ,0,0,0,0,0,0,0,0,0,0,0,0,0,730000,730000,0,0
07043P,國巨元大99售14  ,0,0,0,0,0,0,0,0,0,0,0,0,0,40000,40000,0,0
07080P,健策群益9A售01  ,0,0,0,0,0,0,0,0,0,0,0,0,0,100000,100000,0,0
07087P,聯發科台新99售02,0,0,0,0,0,0,0,0,0,0,0,0,0,130000,130000,0,0
07092P,上銀凱基99售03  ,0,0,0,0,0,0,0,0,0,0,0,0,0,70000,70000,0,0
07169P,臺股指國票99售06,0,0,0,0,0,0,0,0,0,0,0,0,0,309000,309000,0,0
07118P,台積電凱基99售09,0,0,0,0,0,0,0,0,0,0,0,0,0,400000,400000,0,0
07142P,台灣50元大01售01,0,0,0,0,0,0,0,0,0,0,0,0,0,10000,10000,0,0
07206P,鴻海凱基9A售11  ,0,0,0,0,0,0,0,0,0,0,0,0,0,10000,10000,0,0
07242P,台灣50凱基9A售03,0,0,0,0,0,0,0,0,0,0,0,0,0,3000,3000,0,0
07553P,嘉晶元大9A售02  ,0,0,0,0,0,0,0,0,0,0,0,0,0,143000,143000,0,0
07601P,國巨統一9A售05  ,0,0,0,0,0,0,0,0,0,0,0,0,0,20000,20000,0,0
07551P,國巨元大9A售10  ,0,0,0,0,0,0,0,0,0,0,0,0,0,40000,40000,0,0
07463P,台積電國票9A售05,0,0,0,0,0,0,0,0,0,0,0,0,0,30000,30000,0,0
07481P,大立光台新9A售01,0,0,0,0,0,0,0,0,0,0,0,0,0,10000,10000,0,0
07450P,鴻海元大9A售03  ,0,0,0,0,0,0,0,0,0,0,0,0,0,25000,25000,0,0
07452P,國巨元大9A售05  ,0,0,0,0,0,0,0,0,0,0,0,0,0,75000,75000,0,0
07410P,鴻海元大99售44  ,0,0,0,0,0,0,0,0,0,0,0,0,0,25000,25000,0,0
07381P,鴻海群益99售05  ,0,0,0,0,0,0,0,0,0,0,0,0,0,60000,60000,0,0
07374P,鴻海元大99售41  ,0,0,0,0,0,0,0,0,0,0,0,0,0,21000,21000,0,0
07327P,台灣50群益9A售06,0,0,0,0,0,0,0,0,0,0,0,0,0,10000,10000,0,0
8443,阿瘦            ,4000,4000,0,0,0,0,0,0,0,0,0,0,0,0,0,0,0
5284,jpp-KY          ,4000,4000,0,0,0,0,0,0,0,0,0,0,0,0,0,0,0
5225,東科-KY         ,93000,93000,0,0,0,0,0,0,0,0,0,0,0,0,0,0,0
6289,華上            ,0,500,-500,0,0,0,0,0,0,0,0,0,0,0,0,0,-500
059661,大立光元大99購22,0,0,0,0,0,0,0,0,0,-1000,0,0,0,0,1000,-1000,-1000
059605,臺股指元大9A購42,0,0,0,0,0,0,0,0,0,-1000,0,0,0,0,1000,-1000,-1000
059532,華新科凱基9B購03,0,0,0,0,0,0,0,0,0,-1000,0,0,0,2000,3000,-1000,-1000
059490,國巨國票99購09  ,0,0,0,0,0,0,0,0,0,-1000,0,0,0,0,1000,-1000,-1000
059093,旭富元大99購01  ,0,0,0,0,0,0,0,0,0,-1000,0,0,0,0,1000,-1000,-1000
059097,世紀鋼元大99購05,0,0,0,0,0,0,0,0,0,-1000,0,0,0,0,1000,-1000,-1000
05912P,和大元大96售01  ,0,0,0,0,0,0,0,0,0,-1000,0,0,0,0,1000,-1000,-1000
059135,臺股指群益99購10,0,0,0,0,0,0,0,0,0,-1000,0,0,0,15000,16000,-1000,-1000
059252,聯詠凱基99購03  ,0,0,0,0,0,0,0,0,0,-1000,0,0,0,0,1000,-1000,-1000
059239,台積電凱基99購12,0,0,0,0,0,0,0,0,0,-1000,0,0,0,0,1000,-1000,-1000
059443,嘉聯益元大9B購01,0,0,0,0,0,0,0,0,0,-1000,0,0,0,26000,27000,-1000,-1000
059427,國巨元大99購24  ,0,0,0,0,0,0,0,0,0,-1000,0,0,0,2000,3000,-1000,-1000
059431,旺宏元大99購14  ,0,0,0,0,0,0,0,0,0,-1000,0,0,0,12000,13000,-1000,-1000
059341,台積電凱基99購15,0,0,0,0,0,0,0,0,0,-1000,0,0,0,0,1000,-1000,-1000
060101,大立光元大99購31,0,0,0,0,0,0,0,0,0,-1000,0,0,0,0,1000,-1000,-1000
059899,上証2X元大9C購04,0,0,0,0,0,0,0,0,0,-1000,0,0,0,0,1000,-1000,-1000
059859,國巨群益9A購03  ,0,0,0,0,0,0,0,0,0,-1000,0,0,0,0,1000,-1000,-1000
060782,道瓊指富邦9C購01,0,0,0,0,0,0,0,0,0,-1000,0,0,0,4000,5000,-1000,-1000
060747,聯鈞國票9A購02  ,0,0,0,0,0,0,0,0,0,-1000,0,0,0,42000,43000,-1000,-1000
060864,可成永豐9A購01  ,0,0,0,0,0,0,0,0,0,-1000,0,0,0,0,1000,-1000,-1000
060848,聯茂國票9A購02  ,0,0,0,0,0,0,0,0,0,-1000,0,0,0,10000,11000,-1000,-1000
061104,華新科元大9A購13,0,0,0,0,0,0,0,0,0,-1000,0,0,0,9000,10000,-1000,-1000
061082,台光電兆豐9A購01,0,0,0,0,0,0,0,0,0,-1000,0,0,0,0,1000,-1000,-1000
061442,玉晶光永豐9A購07,0,0,0,0,0,0,0,0,0,-1000,0,0,0,0,1000,-1000,-1000
061463,智邦群益9A購02  ,0,0,0,0,0,0,0,0,0,-1000,0,0,0,2000,3000,-1000,-1000
061407,鴻海國票9A購07  ,0,0,0,0,0,0,0,0,0,-1000,0,0,0,12000,13000,-1000,-1000
061250,臺股指群益9A購01,0,0,0,0,0,0,0,0,0,-1000,0,0,0,0,1000,-1000,-1000
06212P,華新科元大97售11,0,0,0,0,0,0,0,0,0,-1000,0,0,0,5000,6000,-1000,-1000
06244P,智易元富97售02  ,0,0,0,0,0,0,0,0,0,-1000,0,0,0,0,1000,-1000,-1000
06286P,世芯國票97售02  ,0,0,0,0,0,0,0,0,0,-1000,0,0,0,5000,6000,-1000,-1000
06235P,國巨元大97售12  ,0,0,0,0,0,0,0,0,0,-1000,0,0,0,0,1000,-1000,-1000
06247P,同欣電元富97售02,0,0,0,0,0,0,0,0,0,-1000,0,0,0,1000,2000,-1000,-1000
06306P,臺股指元大97售12,0,0,0,0,0,0,0,0,0,-1000,0,0,0,0,1000,-1000,-1000
06457P,玉晶光統一98售02,0,0,0,0,0,0,0,0,0,-1000,0,0,0,12000,13000,-1000,-1000
06497P,大立光凱基98售11,0,0,0,0,0,0,0,0,0,-1000,0,0,0,0,1000,-1000,-1000
06697P,台積電國票99售05,0,0,0,0,0,0,0,0,0,-1000,0,0,0,239000,240000,-1000,-1000
06701P,臺股指統一99售06,0,0,0,0,0,0,0,0,0,-1000,0,0,0,10000,11000,-1000,-1000
06704P,玉晶光元富98售05,0,0,0,0,0,0,0,0,0,-1000,0,0,0,0,1000,-1000,-1000
051544,T50反1康和98購01,0,0,0,0,0,0,0,0,0,-1000,0,0,0,0,1000,-1000,-1000
051490,世芯凱基96購01  ,0,0,0,0,0,0,0,0,0,-1000,0,0,0,4000,5000,-1000,-1000
051602,南茂兆豐96購01  ,0,0,0,0,0,0,0,0,0,-1000,0,0,0,0,1000,-1000,-1000
051401,華新科永豐95購01,0,0,0,0,0,0,0,0,0,-1000,0,0,0,0,1000,-1000,-1000
052459,道瓊反統一95購04,0,0,0,0,0,0,0,0,0,-1000,0,0,0,0,1000,-1000,-1000
052269,T50反1日盛9B購01,0,0,0,0,0,0,0,0,0,-1000,0,0,0,0,1000,-1000,-1000
05091P,台積電元大95售11,0,0,0,0,0,0,0,0,0,-1000,0,0,0,0,1000,-1000,-1000
050905,臺股指元大95購12,0,0,0,0,0,0,0,0,0,-1000,0,0,0,0,1000,-1000,-1000
052132,旺宏凱基9B購01  ,0,0,0,0,0,0,0,0,0,-1000,0,0,0,0,1000,-1000,-1000
052178,台郡元大96購03  ,0,0,0,0,0,0,0,0,0,-1000,0,0,0,0,1000,-1000,-1000
05133P,臺股指日盛95售01,0,0,0,0,0,0,0,0,0,-1000,0,0,0,300000,301000,-1000,-1000
052022,南電永豐95購03  ,0,0,0,0,0,0,0,0,0,-1000,0,0,0,0,1000,-1000,-1000
03419B,臺股指元富99熊03,0,0,0,0,0,0,0,0,0,-1000,0,0,0,0,1000,-1000,-1000
03009X,元展09          ,0,0,0,0,0,0,0,0,0,-1000,0,0,0,0,1000,-1000,-1000
03060X,元展55          ,0,0,0,0,0,0,0,0,0,-1000,0,0,0,0,1000,-1000,-1000
047004,台積電統一99購01,0,0,0,0,0,0,0,0,0,-1000,0,0,0,0,1000,-1000,-1000
049425,喬山兆豐95購01  ,0,0,0,0,0,0,0,0,0,-1000,0,0,0,0,1000,-1000,-1000
049593,群創元大9A購01  ,0,0,0,0,0,0,0,0,0,-1000,0,0,0,0,1000,-1000,-1000
050123,群臺反凱基96購01,0,0,0,0,0,0,0,0,0,-1000,0,0,0,0,1000,-1000,-1000
05059P,大立光國票96售02,0,0,0,0,0,0,0,0,0,-1000,0,0,0,3000,4000,-1000,-1000
04505P,佳世達元富96售03,0,0,0,0,0,0,0,0,0,-1000,0,0,0,0,1000,-1000,-1000
04427P,滬深2X元大97售02,0,0,0,0,0,0,0,0,0,-1000,0,0,0,0,1000,-1000,-1000
00657,國泰日經225     ,1000,0,1000,0,0,0,0,0,0,-2000,0,0,0,100000,102000,-2000,-1000
00691R,兆豐藍籌30反1   ,0,0,0,0,0,0,0,0,0,-1000,0,0,0,0,1000,-1000,-1000
00689R,國泰20年美債反1 ,0,0,0,0,0,0,0,0,0,-1000,0,0,0,152000,153000,-1000,-1000
01004T,土銀富邦R2      ,0,1000,-1000,0,0,0,0,0,0,0,0,0,0,0,0,0,-1000
052922,國巨永豐96購01  ,0,0,0,0,0,0,0,0,0,-1000,0,0,0,0,1000,-1000,-1000
052874,超眾凱基96購01  ,0,0,0,0,0,0,0,0,0,-1000,0,0,0,0,1000,-1000,-1000
052979,上銀元大96購02  ,0,0,0,0,0,0,0,0,0,-1000,0,0,0,0,1000,-1000,-1000
054385,矽創群益98購01  ,0,0,0,0,0,0,0,0,0,-1000,0,0,0,0,1000,-1000,-1000
054361,技嘉凱基96購01  ,0,0,0,0,0,0,0,0,0,-1000,0,0,0,0,1000,-1000,-1000
054368,鴻海中信9A購02  ,0,0,0,0,0,0,0,0,0,-1000,0,0,0,0,1000,-1000,-1000
053351,A50正2兆豐97購01,0,0,0,0,0,0,0,0,0,-1000,0,0,0,0,1000,-1000,-1000
054900,金寶康和97購01  ,0,0,0,0,0,0,0,0,0,-1000,0,0,0,0,1000,-1000,-1000
054914,億光凱基98購01  ,0,0,0,0,0,0,0,0,0,-1000,0,0,0,0,1000,-1000,-1000
054962,玉晶光元大99購02,0,0,0,0,0,0,0,0,0,-1000,0,0,0,0,1000,-1000,-1000
054080,微星中信98購01  ,0,0,0,0,0,0,0,0,0,-1000,0,0,0,0,1000,-1000,-1000
052822,泰碩永豐97購01  ,0,0,0,0,0,0,0,0,0,-1000,0,0,0,25000,26000,-1000,-1000
05373P,臺股指中信95售11,0,0,0,0,0,0,0,0,0,-1000,0,0,0,0,1000,-1000,-1000
053815,聯發科群益96購01,0,0,0,0,0,0,0,0,0,-1000,0,0,0,0,1000,-1000,-1000
05650P,台積電富邦96售01,0,0,0,0,0,0,0,0,0,-1000,0,0,0,0,1000,-1000,-1000
054587,玉晶光國泰99購01,0,0,0,0,0,0,0,0,0,-1000,0,0,0,0,1000,-1000,-1000
054515,華通元大98購02  ,0,0,0,0,0,0,0,0,0,-1000,0,0,0,0,1000,-1000,-1000
054535,旺宏富邦97購02  ,0,0,0,0,0,0,0,0,0,-1000,0,0,0,0,1000,-1000,-1000
054565,玉晶光群益99購02,0,0,0,0,0,0,0,0,0,-1000,0,0,0,0,1000,-1000,-1000
054694,聯鈞永豐97購01  ,0,0,0,0,0,0,0,0,0,-1000,0,0,0,0,1000,-1000,-1000
053142,緯穎永豐96購01  ,0,0,0,0,0,0,0,0,0,-1000,0,0,0,0,1000,-1000,-1000
053504,祥碩兆豐96購01  ,0,0,0,0,0,0,0,0,0,-1000,0,0,0,0,1000,-1000,-1000
058313,台積電富邦9B購04,0,0,0,0,0,0,0,0,0,-1000,0,0,0,0,1000,-1000,-1000
058431,國巨統一9B購01  ,0,0,0,0,0,0,0,0,0,-1000,0,0,0,0,1000,-1000,-1000
057847,聯茂永豐98購01  ,0,0,0,0,0,0,0,0,0,-1000,0,0,0,10000,11000,-1000,-1000
05786P,臺股指永昌96售03,0,0,0,0,0,0,0,0,0,-1000,0,0,0,0,1000,-1000,-1000
058232,聯發科元大99購05,0,0,0,0,0,0,0,0,0,-1000,0,0,0,24000,25000,-1000,-1000
055770,欣興麥證97購01  ,0,0,0,0,1000,-1000,0,0,0,-1000,0,0,0,0,1000,-1000,-1000
055728,緯穎元大97購03  ,0,0,0,0,0,0,0,0,0,-1000,0,0,0,0,1000,-1000,-1000
05681P,大立光元大96售05,0,0,0,0,0,0,0,0,0,-1000,0,0,0,0,1000,-1000,-1000
055215,智邦凱基98購02  ,0,0,0,0,0,0,0,0,0,-1000,0,0,0,0,1000,-1000,-1000
057561,大立光兆豐98購02,0,0,0,0,0,0,0,0,0,-1000,0,0,0,9000,10000,-1000,-1000
057621,崇越凱基98購01  ,0,0,0,0,0,0,0,0,0,-1000,0,0,0,0,1000,-1000,-1000
055707,聯鈞永豐98購01  ,0,0,0,0,0,0,0,0,0,-1000,0,0,0,4000,5000,-1000,-1000
05808P,臺股指國票96售01,0,0,0,0,0,0,0,0,0,-1000,0,0,0,0,1000,-1000,-1000
057033,A50反1元大9B購02,0,0,0,0,0,0,0,0,0,-1000,0,0,0,0,1000,-1000,-1000
055952,上銀元大97購08  ,0,0,0,0,0,0,0,0,0,-1000,0,0,0,0,1000,-1000,-1000
057004,滬深反中信9A購01,0,0,0,0,0,0,0,0,0,-1000,0,0,0,0,1000,-1000,-1000
056964,聯發科永豐98購03,0,0,0,0,0,0,0,0,0,-1000,0,0,0,0,1000,-1000,-1000
055848,大立光元大97購11,0,0,0,0,0,0,0,0,0,-1000,0,0,0,0,1000,-1000,-1000
055872,亞泥元富97購01  ,0,0,0,0,0,0,0,0,0,-1000,0,0,0,10000,11000,-1000,-1000
056118,聯詠群益97購03  ,0,0,0,0,0,0,0,0,0,-1000,0,0,0,0,1000,-1000,-1000
056071,創意元大97購02  ,0,0,0,0,0,0,0,0,0,-1000,0,0,0,0,1000,-1000,-1000
058649,健策永豐99購01  ,0,0,0,0,0,0,0,0,0,-1000,0,0,0,0,1000,-1000,-1000
057785,智邦國票99購02  ,0,0,0,0,0,0,0,0,0,-1000,0,0,0,0,1000,-1000,-1000
057787,TPK國票99購01   ,0,0,0,0,0,0,0,0,0,-1000,0,0,0,5000,6000,-1000,-1000
059075,FBVIX元大99購01 ,0,0,0,0,0,0,0,0,0,-1000,0,0,0,24000,25000,-1000,-1000
058851,大立光群益99購07,0,0,0,0,0,0,0,0,0,-1000,0,0,0,0,1000,-1000,-1000
058875,台表科國票9A購02,0,0,0,0,0,0,0,0,0,-1000,0,0,0,0,1000,-1000,-1000
058876,南電國票9A購02  ,0,0,0,0,0,0,0,0,0,-1000,0,0,0,0,1000,-1000,-1000
058799,晶技元大99購04  ,0,0,0,0,0,0,0,0,0,-1000,0,0,0,0,1000,-1000,-1000
3543,州巧            ,0,1000,-1000,0,0,0,0,0,0,0,0,0,0,0,0,0,-1000
4133,亞諾法          ,679000,680000,-1000,0,0,0,0,0,0,0,0,0,0,0,0,0,-1000
3528,安馳            ,3000,5000,-2000,0,0,0,0,0,0,1000,1000,0,1000,0,0,0,-1000
6579,研揚            ,2000,0,2000,0,0,0,0,0,0,-3000,0,3000,-3000,0,0,0,-1000
6464,台數科          ,1000,2000,-1000,0,0,0,0,0,0,0,0,0,0,0,0,0,-1000
9918,欣天然          ,0,1000,-1000,0,0,0,0,0,0,0,0,0,0,0,0,0,-1000
9931,欣高            ,0,1000,-1000,0,0,0,0,0,0,0,0,0,0,0,0,0,-1000
911616,杜康-DR         ,0,1000,-1000,0,0,0,0,0,0,0,0,0,0,0,0,0,-1000
8481,政伸            ,0,1000,-1000,0,0,0,0,0,0,0,0,0,0,0,0,0,-1000
8467,波力-KY         ,0,1000,-1000,0,0,0,0,0,0,0,0,0,0,0,0,0,-1000
07429P,臺股指國票9A售01,0,0,0,0,0,0,0,0,0,-1000,0,0,0,0,1000,-1000,-1000
07540P,鴻海凱基9A售21  ,0,0,0,0,0,0,0,0,0,-1000,0,0,0,0,1000,-1000,-1000
07689P,旺宏元大9A售13  ,0,0,0,0,0,0,0,0,0,-1000,0,0,0,0,1000,-1000,-1000
07243P,台灣50凱基9A售04,0,0,0,0,0,0,0,0,0,-1000,0,0,0,2000,3000,-1000,-1000
07222P,台灣50元大01售04,0,0,0,0,0,0,0,0,0,-1000,0,0,0,0,1000,-1000,-1000
07239P,台灣50國票9A售04,0,0,0,0,0,0,0,0,0,-1000,0,0,0,0,1000,-1000,-1000
07160P,台灣50中信03售04,0,0,0,0,0,0,0,0,0,-1000,0,0,0,4000,5000,-1000,-1000
07112P,聯發科群益99售05,0,0,0,0,0,0,0,0,0,-1000,0,0,0,4000,5000,-1000,-1000
07016P,聯發科元大99售10,0,0,0,0,0,0,0,0,0,-1000,0,0,0,1000,2000,-1000,-1000
06899P,嘉澤群益98售01  ,0,0,0,0,0,0,0,0,0,-1000,0,0,0,40000,41000,-1000,-1000
06845P,億光元大98售02  ,0,0,0,0,0,0,0,0,0,-1000,0,0,0,0,1000,-1000,-1000
06790P,台積電凱基9A售04,0,0,0,0,0,0,0,0,0,-1000,0,0,0,311000,312000,-1000,-1000
06809P,電子類群益98售03,0,0,0,0,0,0,0,0,0,-1000,0,0,0,0,1000,-1000,-1000
07776P,國巨群益9B售02  ,0,0,0,0,0,0,0,0,0,-1000,0,0,0,40000,41000,-1000,-1000
1470,大統新創        ,1000,2000,-1000,0,0,0,0,0,0,0,0,0,0,0,0,0,-1000
1531,高林股          ,24000,25000,-1000,0,0,0,0,0,0,0,0,0,0,0,0,0,-1000
1720,生達            ,212000,204000,8000,0,0,0,0,0,0,-9000,5000,14000,-9000,0,0,0,-1000
2722,夏都            ,2000,3000,-1000,0,0,0,0,0,0,0,0,0,0,0,0,0,-1000
06645P,上銀元大98售05  ,0,0,0,0,0,0,0,0,0,-2000,0,0,0,0,2000,-2000,-2000
06624P,訊芯元大98售06  ,0,0,0,0,0,0,0,0,0,-2000,0,0,0,25000,27000,-2000,-2000
06529P,貿聯富邦99售03  ,0,0,0,0,0,0,0,0,0,-2000,0,0,0,60000,62000,-2000,-2000
06274P,臺股指凱基97售06,0,0,0,0,0,0,0,0,0,-2000,0,0,0,0,2000,-2000,-2000
06303P,臺股指元大97售09,0,0,0,0,0,0,0,0,0,-2000,0,0,0,2000,4000,-2000,-2000
06332P,世紀鋼群益98售01,0,0,0,0,0,0,0,0,0,-2000,0,0,0,0,2000,-2000,-2000
061252,臺股指群益9A購03,0,0,0,0,0,0,0,0,0,-2000,0,0,0,0,2000,-2000,-2000
061272,超眾凱基9A購03  ,0,0,0,0,0,0,0,0,0,-2000,0,0,0,0,2000,-2000,-2000
06139P,台積電中信99售02,0,0,0,0,0,0,0,0,0,-2000,0,0,0,0,2000,-2000,-2000
061479,泰碩元大9A購02  ,0,0,0,0,0,0,0,0,0,-2000,0,0,0,0,2000,-2000,-2000
060808,欣興群益9A購01  ,0,0,0,0,0,0,0,0,0,-2000,0,0,0,59000,61000,-2000,-2000
060545,台積電凱基9B購02,0,0,0,0,0,0,0,0,0,-2000,0,0,0,3000,5000,-2000,-2000
060524,國巨中信9A購03  ,0,0,0,0,0,0,0,0,0,-2000,0,0,0,19000,21000,-2000,-2000
059860,台積電群益9A購02,0,0,0,0,0,0,0,0,0,-2000,0,0,0,47000,49000,-2000,-2000
060023,T50反1國泰9A購03,50000,0,50000,0,0,0,0,0,0,-52000,0,0,0,10000,62000,-52000,-2000
060012,電子類群益99購02,0,0,0,0,0,0,0,0,0,-2000,0,0,0,0,2000,-2000,-2000
060174,T50反1元富04購01,0,0,0,0,0,0,0,0,0,-2000,0,0,0,0,2000,-2000,-2000
059405,台灣50國票01購01,0,0,0,0,0,0,0,0,0,-2000,0,0,0,0,2000,-2000,-2000
059137,電子類群益99購01,0,0,0,0,0,0,0,0,0,-2000,0,0,0,0,2000,-2000,-2000
059482,貿聯群益99購05  ,0,0,0,0,0,0,0,0,0,-2000,0,0,0,0,2000,-2000,-2000
059598,欣興元大99購08  ,0,0,0,0,0,0,0,0,0,-2000,0,0,0,3000,5000,-2000,-2000
059592,聯發科元大99購28,0,0,0,0,0,0,0,0,0,-2000,0,0,0,9000,11000,-2000,-2000
059583,台灣50元大01購10,0,0,0,0,0,0,0,0,0,-2000,0,0,0,0,2000,-2000,-2000
059624,鴻海凱基01購01  ,0,0,0,0,0,0,0,0,0,-2000,0,0,0,0,2000,-2000,-2000
059625,國巨凱基99購17  ,0,0,0,0,0,0,0,0,0,-2000,0,0,0,20000,22000,-2000,-2000
059804,台積電元富99購01,0,0,0,0,0,0,0,0,0,-2000,0,0,0,0,2000,-2000,-2000
054577,世芯元大98購01  ,0,0,0,0,0,0,0,0,0,-2000,0,0,0,0,2000,-2000,-2000
053104,台表科元富96購02,0,0,0,0,0,0,0,0,0,-2000,0,0,0,0,2000,-2000,-2000
05649P,矽創國票97售03  ,0,0,0,0,0,0,0,0,0,-2000,0,0,0,9000,11000,-2000,-2000
055339,緯穎兆豐98購01  ,0,0,0,0,0,0,0,0,0,-2000,0,0,0,4000,6000,-2000,-2000
055368,台積電元大97購24,0,0,0,0,0,0,0,0,0,-2000,0,0,0,0,2000,-2000,-2000
057548,微星凱基99購01  ,0,0,0,0,0,0,0,0,0,-2000,0,0,0,0,2000,-2000,-2000
057523,大成鋼元大99購01,0,0,0,0,0,0,0,0,0,-2000,0,0,0,606000,608000,-2000,-2000
053252,華邦電國泰98購01,0,0,0,0,0,0,0,0,0,-2000,0,0,0,0,2000,-2000,-2000
054949,奇力新元大98購01,0,0,0,0,0,0,0,0,0,-2000,0,0,0,0,2000,-2000,-2000
052965,廣宇群益97購01  ,0,0,0,0,0,0,0,0,0,-2000,0,0,0,0,2000,-2000,-2000
045837,群創群益98購02  ,0,0,0,0,0,0,0,0,0,-2000,0,0,0,10000,12000,-2000,-2000
04787P,台積電永昌96售04,0,0,0,0,0,0,0,0,0,-2000,0,0,0,209000,211000,-2000,-2000
047905,元油反元大96購04,0,0,0,0,0,0,0,0,0,-2000,0,0,0,0,2000,-2000,-2000
046928,奇鋐富邦97購01  ,0,0,0,0,0,0,0,0,0,-2000,0,0,0,14000,16000,-2000,-2000
03049X,元展46          ,0,0,0,0,0,0,0,0,0,-2000,0,0,0,0,2000,-2000,-2000
049759,元黃金富邦9A購01,0,0,0,0,0,0,0,0,0,-2000,0,0,0,0,2000,-2000,-2000
051756,台積電元大97購04,0,0,0,0,0,0,0,0,0,-2000,0,0,0,0,2000,-2000,-2000
050813,旺宏凱基96購01  ,0,0,0,0,0,0,0,0,0,-2000,0,0,0,0,2000,-2000,-2000
050731,昇陽半國票96購01,0,0,0,0,0,0,0,0,0,-2000,0,0,0,0,2000,-2000,-2000
05171P,臺股指元大95售15,0,0,0,0,0,0,0,0,0,-2000,0,0,0,0,2000,-2000,-2000
05102P,臺股指凱基96售09,0,0,0,0,0,0,0,0,0,-2000,0,0,0,0,2000,-2000,-2000
051495,玉晶光第一95購02,0,0,0,0,0,0,0,0,0,-2000,0,0,0,0,2000,-2000,-2000
058804,T50反1統一9B購01,0,0,0,0,0,0,0,0,0,-2000,0,0,0,0,2000,-2000,-2000
059024,大立光統一9B購04,0,0,0,0,0,0,0,0,0,-2000,0,0,0,0,2000,-2000,-2000
059003,中壽元大99購01  ,0,0,0,0,0,0,0,0,0,-2000,0,0,0,0,2000,-2000,-2000
05899P,臺股指凱基96售30,0,0,0,0,0,0,0,0,0,-2000,0,0,0,0,2000,-2000,-2000
058957,貿聯國票9A購01  ,0,0,0,0,0,0,0,0,0,-2000,0,0,0,58000,60000,-2000,-2000
058611,欣興元大99購06  ,0,0,0,0,0,0,0,0,0,-2000,0,0,0,52000,54000,-2000,-2000
056378,欣興元富98購01  ,0,0,0,0,0,0,0,0,0,-2000,0,0,0,0,2000,-2000,-2000
056910,超眾元大99購02  ,0,0,0,0,0,0,0,0,0,-2000,0,0,0,48000,50000,-2000,-2000
055943,瑞昱麥證97購01  ,0,0,0,2000,4000,-2000,0,0,0,-2000,0,0,0,2000,4000,-2000,-2000
057752,臺股指國票98購08,0,0,0,0,0,0,0,0,0,-2000,0,0,0,3000,5000,-2000,-2000
05730P,臺股指凱基97售03,0,0,0,0,0,0,0,0,0,-2000,0,0,0,0,2000,-2000,-2000
05549P,臺股指元大96售03,0,0,0,0,0,0,0,0,0,-2000,0,0,0,20000,22000,-2000,-2000
055489,瑞昱元大97購02  ,0,0,0,0,0,0,0,0,0,-2000,0,0,0,9000,11000,-2000,-2000
057275,友達元大9A購04  ,0,0,0,0,0,0,0,0,0,-2000,0,0,0,0,2000,-2000,-2000
057232,京元電凱基98購02,0,0,0,0,0,0,0,0,0,-2000,0,0,0,28000,30000,-2000,-2000
057267,康控兆豐99購01  ,0,0,0,0,0,0,0,0,0,-2000,0,0,0,0,2000,-2000,-2000
055089,金寶群益98購01  ,0,0,0,0,0,0,0,0,0,-2000,0,0,0,0,2000,-2000,-2000
055127,台虹兆豐97購01  ,0,0,0,0,0,0,0,0,0,-2000,0,0,0,0,2000,-2000,-2000
056787,健鼎群益98購01  ,0,0,0,0,0,0,0,0,0,-2000,0,0,0,0,2000,-2000,-2000
056777,矽力元大98購02  ,0,0,0,0,0,0,0,0,0,-2000,0,0,0,0,2000,-2000,-2000
058127,FBVIX元大9C購01 ,0,0,0,0,0,0,0,0,0,-2000,0,0,0,0,2000,-2000,-2000
058354,台積電凱基9A購06,0,0,0,0,0,0,0,0,0,-2000,0,0,0,593000,595000,-2000,-2000
058409,鴻海兆豐99購05  ,0,0,0,0,0,0,0,0,0,-2000,0,0,0,16000,18000,-2000,-2000
07800P,華新科國泰9B售04,0,0,0,0,0,0,0,0,0,-2000,0,0,0,0,2000,-2000,-2000
07720P,臺股指群益9A售09,0,0,0,0,0,0,0,0,0,-2000,0,0,0,8000,10000,-2000,-2000
1466,聚隆            ,3000,5000,-2000,0,0,0,0,0,0,0,0,0,0,0,0,0,-2000
06800P,台灣50群益9A售02,0,0,0,0,0,0,0,0,0,-2000,0,0,0,0,2000,-2000,-2000
06878P,台灣50日盛9B售01,0,0,0,0,0,0,0,0,0,-2000,0,0,0,0,2000,-2000,-2000
06880P,鈺齊凱基98售03  ,0,0,0,0,0,0,0,0,0,-2000,0,0,0,3000,5000,-2000,-2000
07036P,台灣50台新9C售01,0,0,0,0,0,0,0,0,0,-2000,0,0,0,440000,442000,-2000,-2000
06973P,臺股指元大9A售11,0,0,0,0,0,0,0,0,0,-2000,0,0,0,1000,3000,-2000,-2000
06975P,臺股指元大9A售13,0,0,0,0,0,0,0,0,0,-2000,0,0,0,0,2000,-2000,-2000
06959P,鴻海凱基9A售02  ,0,0,0,0,0,0,0,0,0,-2000,0,0,0,0,2000,-2000,-2000
07081P,南電群益9A售01  ,0,0,0,0,0,0,0,0,0,-2000,0,0,0,20000,22000,-2000,-2000
07171P,臺股指國票99售08,0,0,0,0,0,0,0,0,0,-2000,0,0,0,110000,112000,-2000,-2000
07183P,臺股指凱基99售25,0,0,0,0,0,0,0,0,0,-2000,0,0,0,0,2000,-2000,-2000
07190P,臺股指富邦9C售02,0,0,0,0,0,0,0,0,0,-2000,0,0,0,10000,12000,-2000,-2000
07253P,台灣50凱基9A售05,0,0,0,0,0,0,0,0,0,-2000,0,0,0,0,2000,-2000,-2000
07638P,長榮航國票9A售01,0,0,0,0,0,0,0,0,0,-2000,0,0,0,34000,36000,-2000,-2000
07615P,華通中信02售02  ,0,0,0,0,0,0,0,0,0,-2000,0,0,0,3000,5000,-2000,-2000
07564P,臺股指中信01售01,0,0,0,0,0,0,0,0,0,-2000,0,0,0,0,2000,-2000,-2000
07322P,鴻海元大99售33  ,0,0,0,0,0,0,0,0,0,-2000,0,0,0,31000,33000,-2000,-2000
911622,泰聚亨-DR       ,0,0,0,0,0,0,0,0,0,-2000,0,2000,-2000,0,0,0,-2000
9906,欣巴巴          ,0,2000,-2000,0,0,0,0,0,0,0,0,0,0,0,0,0,-2000
6672,騰輝電子-KY     ,70000,72000,-2000,0,0,0,0,0,0,0,0,0,0,0,0,0,-2000
3532,台勝科          ,209000,125000,84000,0,0,0,1000,0,1000,-87000,4000,0,4000,13000,104000,-91000,-2000
4755,三福化          ,7000,9000,-2000,0,0,0,0,0,0,0,0,0,0,0,0,0,-2000
059565,國巨凱基99購16  ,0,0,0,0,0,0,0,0,0,-3000,0,0,0,0,3000,-3000,-3000
059597,大立光元大99購21,0,0,0,0,0,0,0,0,0,-3000,0,0,0,0,3000,-3000,-3000
059587,華通元大9A購01  ,0,0,0,0,0,0,0,0,0,-3000,0,0,0,1000,4000,-3000,-3000
059466,國巨元大99購26  ,0,0,0,0,0,0,0,0,0,-3000,0,0,0,10000,13000,-3000,-3000
059231,華通國票9A購04  ,0,0,0,0,0,0,0,0,0,-3000,0,0,0,9000,12000,-3000,-3000
059216,台積電元大99購29,0,0,0,0,0,0,0,0,0,-3000,0,0,0,0,3000,-3000,-3000
059320,華新科元大99購15,0,0,0,0,0,0,0,0,0,-3000,0,0,0,0,3000,-3000,-3000
06021P,世紀鋼元富96售03,0,0,0,0,0,0,0,0,0,-3000,0,0,0,262000,265000,-3000,-3000
060368,緯穎元富9A購03  ,0,0,0,0,0,0,0,0,0,-3000,0,0,0,34000,37000,-3000,-3000
060391,華擎群益9C購01  ,0,0,0,0,0,0,0,0,0,-3000,0,0,0,140000,143000,-3000,-3000
06034P,世芯凱基96售03  ,0,0,0,0,0,0,0,0,0,-3000,0,0,0,43000,46000,-3000,-3000
060341,國巨統一9C購02  ,0,0,0,0,0,0,0,0,0,-3000,0,0,0,46000,49000,-3000,-3000
060002,T50反1群益9A購01,0,0,0,0,0,0,0,0,0,-3000,0,0,0,0,3000,-3000,-3000
059954,華新科康和99購01,0,0,0,0,0,0,0,0,0,-3000,0,0,0,0,3000,-3000,-3000
059986,宏達電元大99購08,0,0,0,0,0,0,0,0,0,-3000,0,0,0,88000,91000,-3000,-3000
060520,臺指2X中信01購02,0,0,0,0,0,0,0,0,0,-3000,0,0,0,0,3000,-3000,-3000
060798,旭富永豐9A購01  ,0,0,0,0,0,0,0,0,0,-3000,0,0,0,0,3000,-3000,-3000
060751,高股息元大9B購01,0,0,0,0,0,0,0,0,0,-3000,0,0,0,0,3000,-3000,-3000
06110P,國巨國泰98售02  ,0,0,0,0,0,0,0,0,0,-3000,0,0,0,10000,13000,-3000,-3000
061474,瑞昱元大9A購04  ,0,0,0,0,0,0,0,0,0,-3000,0,0,0,6000,9000,-3000,-3000
06140P,華新科群益97售06,0,0,0,0,0,0,0,0,0,-3000,0,0,0,0,3000,-3000,-3000
061350,牧德元大9B購03  ,0,0,0,0,0,0,0,0,0,-3000,0,0,0,107000,110000,-3000,-3000
06342P,世芯統一98售01  ,0,0,0,0,0,0,0,0,0,-3000,0,0,0,2000,5000,-3000,-3000
06234P,亞德客元大97售02,0,0,0,0,0,0,0,0,0,-3000,0,0,0,0,3000,-3000,-3000
06642P,可成兆豐98售01  ,0,0,0,0,0,0,0,0,0,-3000,0,0,0,0,3000,-3000,-3000
06696P,台灣50國票99售01,0,0,0,0,0,0,0,0,0,-3000,0,0,0,1000,4000,-3000,-3000
06711P,臺股指台新99售08,0,0,0,0,0,0,0,0,0,-3000,0,0,0,7000,10000,-3000,-3000
05148P,臻鼎元大95售01  ,0,0,0,0,0,0,0,0,0,-3000,0,0,0,0,3000,-3000,-3000
05163P,聯發科統一96售02,0,0,0,0,0,0,0,0,0,-3000,0,0,0,40000,43000,-3000,-3000
052544,牧德元富95購01  ,0,0,0,0,0,0,0,0,0,-3000,0,0,0,60000,63000,-3000,-3000
051808,美律凱基96購02  ,0,0,0,0,0,0,0,0,0,-3000,0,0,0,0,3000,-3000,-3000
05217P,鴻海統一95售08  ,0,0,0,0,0,0,0,0,0,-3000,0,0,0,3000,6000,-3000,-3000
03094X,大立光元大68展08,0,4000,-4000,0,0,0,0,0,0,1000,0,0,0,3000,2000,1000,-3000
03014X,元展14          ,0,0,0,0,0,0,0,0,0,-3000,0,0,0,0,3000,-3000,-3000
046383,群創凱基98購01  ,0,0,0,0,0,0,0,0,0,-3000,0,0,0,0,3000,-3000,-3000
049610,奇力新兆豐95購01,0,0,0,0,0,0,0,0,0,-3000,0,0,0,0,3000,-3000,-3000
048273,南電富邦97購01  ,0,0,0,0,0,0,0,0,0,-3000,0,0,0,1000,4000,-3000,-3000
049200,元黃金群益98購01,0,0,0,0,0,0,0,0,0,-3000,0,0,0,0,3000,-3000,-3000
006203,元大MSCI台灣    ,0,0,0,0,0,0,0,0,0,-3000,0,0,0,0,3000,-3000,-3000
0052,富邦科技        ,0,0,0,0,0,0,0,0,0,-3000,0,0,0,93000,96000,-3000,-3000
054895,南電統一97購01  ,0,0,0,0,0,0,0,0,0,-3000,0,0,0,0,3000,-3000,-3000
054278,晶技群益97購02  ,0,0,0,0,0,0,0,0,0,-3000,0,0,0,1000,4000,-3000,-3000
054201,聯詠富邦97購02  ,0,0,0,0,0,0,0,0,0,-3000,0,0,0,0,3000,-3000,-3000
052801,友達元大9A購01  ,0,0,0,0,0,0,0,0,0,-3000,0,0,0,0,3000,-3000,-3000
054063,聯茂國票97購02  ,0,0,0,0,0,0,0,0,0,-3000,0,0,0,0,3000,-3000,-3000
052723,新唐統一97購01  ,0,0,0,0,0,0,0,0,0,-3000,0,0,0,0,3000,-3000,-3000
054027,欣興凱基96購04  ,0,0,0,0,0,0,0,0,0,-3000,0,0,0,0,3000,-3000,-3000
057494,玉晶光元大99購09,0,0,0,0,0,0,0,0,0,-3000,0,0,0,10000,13000,-3000,-3000
055424,聚陽群益98購01  ,0,0,0,0,0,0,0,0,0,-3000,0,0,0,0,3000,-3000,-3000
056611,國巨永豐98購03  ,0,0,0,0,0,0,0,0,0,-3000,0,0,0,4000,7000,-3000,-3000
056582,易華電元大98購01,0,0,0,0,0,0,0,0,0,-3000,0,0,0,101000,104000,-3000,-3000
053496,義隆兆豐96購02  ,0,0,0,0,0,0,0,0,0,-3000,0,0,0,2000,5000,-3000,-3000
058360,台光電凱基9A購02,0,0,0,0,0,0,0,0,0,-3000,0,0,0,0,3000,-3000,-3000
05509P,智邦元富96售02  ,0,0,0,0,0,0,0,0,0,-3000,0,0,0,0,3000,-3000,-3000
057251,泰鼎統一98購02  ,0,0,0,0,0,0,0,0,0,-3000,0,0,0,4000,7000,-3000,-3000
057305,南亞科兆豐98購02,0,0,0,0,0,0,0,0,0,-3000,0,0,0,0,3000,-3000,-3000
057842,緯穎富邦99購02  ,0,0,0,0,0,0,0,0,0,-3000,0,0,0,0,3000,-3000,-3000
057413,臺股指群益9C購04,0,0,0,0,0,0,0,0,0,-3000,0,0,0,0,3000,-3000,-3000
058041,FBVIX元大98購02 ,0,0,0,0,0,0,0,0,0,-3000,0,0,0,4000,7000,-3000,-3000
056714,晶相光永豐98購02,27000,0,27000,0,0,0,0,0,0,-30000,0,0,0,55000,85000,-30000,-3000
055951,大成鋼元大97購02,0,0,0,0,0,0,0,0,0,-3000,0,0,0,200000,203000,-3000,-3000
056004,南電永豐97購02  ,0,0,0,0,0,0,0,0,0,-3000,0,0,0,1000,4000,-3000,-3000
056400,道瓊反群益9C購01,0,0,0,0,0,0,0,0,0,-3000,0,0,0,420000,423000,-3000,-3000
056103,聯發科永豐97購03,0,0,0,0,0,0,0,0,0,-3000,0,0,0,0,3000,-3000,-3000
058701,鴻海元大99購16  ,0,0,0,0,0,0,0,0,0,-3000,0,0,0,27000,30000,-3000,-3000
05849P,臺股指元大96售25,0,0,0,0,0,0,0,0,0,-3000,0,0,0,0,3000,-3000,-3000
058789,喬山元大99購02  ,0,0,0,0,0,0,0,0,0,-3000,0,0,0,0,3000,-3000,-3000
07323P,鴻海元大99售34  ,0,0,0,0,0,0,0,0,0,-3000,0,0,0,0,3000,-3000,-3000
07388P,臺股指群益9C售07,0,0,0,0,0,0,0,0,0,-3000,0,0,0,0,3000,-3000,-3000
07364P,大立光元大99售27,0,0,0,0,0,0,0,0,0,-3000,0,0,0,0,3000,-3000,-3000
07457P,宏達電元大9A售01,0,0,0,0,0,0,0,0,0,-3000,0,0,0,53000,56000,-3000,-3000
07616P,瑞昱中信02售01  ,0,0,0,0,0,0,0,0,0,-3000,0,0,0,8000,11000,-3000,-3000
07613P,國巨永豐9A售01  ,0,0,0,0,0,0,0,0,0,-3000,0,0,0,0,3000,-3000,-3000
07274P,上証2X群益01售01,0,0,0,0,0,0,0,0,0,-3000,0,0,0,0,3000,-3000,-3000
07223P,鴻海元大99售29  ,0,0,0,0,0,0,0,0,0,-3000,0,0,0,202000,205000,-3000,-3000
07170P,臺股指國票99售07,0,0,0,0,0,0,0,0,0,-3000,0,0,0,54000,57000,-3000,-3000
07107P,臺股指統一99售07,0,0,0,0,0,0,0,0,0,-3000,0,0,0,0,3000,-3000,-3000
06787P,臺股指元大98售04,0,0,0,0,0,0,0,0,0,-3000,0,0,0,0,3000,-3000,-3000
06841P,臺股指統一9A售02,0,0,0,0,0,0,0,0,0,-3000,0,0,0,1000,4000,-3000,-3000
07767P,華新科群益9A售07,0,0,0,0,0,0,0,0,0,-3000,0,0,0,0,3000,-3000,-3000
07798P,同欣電國票9A售01,0,0,0,0,0,0,0,0,0,-3000,0,0,0,0,3000,-3000,-3000
1521,大億            ,15000,18000,-3000,0,0,0,0,0,0,0,0,0,0,0,0,0,-3000
2882B,國泰金乙特      ,0,0,0,0,0,0,0,0,0,-3000,2000,5000,-3000,0,0,0,-3000
2712,遠雄來          ,0,3000,-3000,0,0,0,0,0,0,0,0,0,0,0,0,0,-3000
2497,怡利電          ,5000,8000,-3000,0,0,0,0,0,0,0,0,0,0,0,0,0,-3000
06634P,欣興國票98售02  ,0,0,0,0,0,0,0,0,0,-4000,0,0,0,2000,6000,-4000,-4000
06552P,茂林元大99售02  ,0,0,0,0,0,0,0,0,0,-4000,0,0,0,26000,30000,-4000,-4000
061456,玉晶光凱基9B購05,0,0,0,0,0,0,0,0,0,-4000,0,0,0,1000,5000,-4000,-4000
061163,台灣50兆豐9A購04,0,0,0,0,0,0,0,0,0,-4000,0,0,0,0,4000,-4000,-4000
061077,國巨兆豐9B購01  ,0,0,0,0,0,0,0,0,0,-4000,0,0,0,206000,210000,-4000,-4000
060767,世紀鋼元大9A購02,0,0,0,0,0,0,0,0,0,-4000,0,0,0,0,4000,-4000,-4000
060594,國巨麥證9A購01  ,0,0,0,0,4000,-4000,0,0,0,-4000,0,0,0,0,4000,-4000,-4000
060585,玉晶光元富9A購02,0,0,0,0,0,0,0,0,0,-4000,0,0,0,3000,7000,-4000,-4000
060040,康控國票99購04  ,0,0,0,0,0,0,0,0,0,-4000,0,0,0,0,4000,-4000,-4000
060471,台勝科元大9B購01,0,0,0,0,0,0,0,0,0,-4000,0,0,0,38000,42000,-4000,-4000
06043P,創意永豐96售06  ,0,0,0,0,0,0,0,0,0,-4000,0,0,0,35000,39000,-4000,-4000
059317,台積電元大99購34,0,0,0,0,0,0,0,0,0,-4000,0,0,0,2000,6000,-4000,-4000
05943P,欣興凱基96售03  ,0,0,0,0,0,0,0,0,0,-4000,0,0,0,32000,36000,-4000,-4000
059455,玉晶光永豐99購05,0,0,0,0,0,0,0,0,0,-4000,0,0,0,83000,87000,-4000,-4000
05924P,超眾元富96售04  ,0,0,0,0,0,0,0,0,0,-4000,0,0,0,0,4000,-4000,-4000
059563,鴻海凱基9A購14  ,0,0,0,0,0,0,0,0,0,-4000,0,0,0,16000,20000,-4000,-4000
059662,旭富元大9C購01  ,0,0,0,0,0,0,0,0,0,-4000,0,0,0,22000,26000,-4000,-4000
059685,T50正2永豐99購02,0,0,0,0,0,0,0,0,0,-4000,0,0,0,5000,9000,-4000,-4000
05454P,奇鋐群益95售04  ,0,0,0,0,0,0,0,0,0,-4000,0,0,0,0,4000,-4000,-4000
056503,楠梓電永豐98購01,0,0,0,0,0,0,0,0,0,-4000,0,0,0,0,4000,-4000,-4000
056551,台郡凱基98購04  ,0,0,0,0,0,0,0,0,0,-4000,0,0,0,0,4000,-4000,-4000
052838,新唐國泰98購01  ,0,0,0,0,0,0,0,0,0,-4000,0,0,0,0,4000,-4000,-4000
054344,景碩國票97購04  ,0,0,0,0,0,0,0,0,0,-4000,0,0,0,6000,10000,-4000,-4000
053313,世紀鋼凱基96購01,0,0,0,0,0,0,0,0,0,-4000,0,0,0,0,4000,-4000,-4000
01002T,土銀國泰R1      ,0,4000,-4000,0,0,0,0,0,0,0,0,0,0,0,0,0,-4000
048748,國巨元富96購01  ,0,0,0,0,0,0,0,0,0,-4000,0,0,0,13000,17000,-4000,-4000
049254,台積電元大96購02,0,0,0,0,0,0,0,0,0,-4000,0,0,0,1000,5000,-4000,-4000
03075X,元展70          ,0,0,0,0,0,0,0,0,0,-4000,0,0,0,0,4000,-4000,-4000
03091X,元展85          ,0,0,0,0,0,0,0,0,0,-4000,0,0,0,1000,5000,-4000,-4000
03434B,臺股指元大99熊10,0,0,0,0,0,0,0,0,0,-4000,0,0,0,5000,9000,-4000,-4000
051375,道瓊反群益9A購01,0,0,0,0,0,0,0,0,0,-4000,0,0,0,1000,5000,-4000,-4000
051906,國巨元大95購09  ,0,0,0,0,0,0,0,0,0,-4000,0,0,0,113000,117000,-4000,-4000
05226P,智邦統一95售01  ,0,0,0,0,0,0,0,0,0,-4000,0,0,0,166000,170000,-4000,-4000
052454,力成元大95購02  ,0,0,0,0,0,0,0,0,0,-4000,0,0,0,0,4000,-4000,-4000
058713,國巨統一9B購02  ,0,0,0,0,0,0,0,0,0,-4000,0,0,0,12000,16000,-4000,-4000
058967,可成麥證99購01  ,0,0,0,0,4000,-4000,0,0,0,-4000,0,0,0,0,4000,-4000,-4000
059035,旺宏群益99購06  ,0,0,0,0,0,0,0,0,0,-4000,0,0,0,5000,9000,-4000,-4000
05860P,旺宏康和96售01  ,0,0,0,0,0,0,0,0,0,-4000,0,0,0,0,4000,-4000,-4000
058630,日月光國票9A購01,0,0,0,0,0,0,0,0,0,-4000,0,0,0,27000,31000,-4000,-4000
056906,玉晶光元大9B購01,0,0,0,0,0,0,0,0,0,-4000,0,0,0,6000,10000,-4000,-4000
056471,台光電元大99購01,0,0,0,0,0,0,0,0,0,-4000,0,0,0,9000,13000,-4000,-4000
056202,國揚永豐97購01  ,0,0,0,0,0,0,0,0,0,-4000,0,0,0,139000,143000,-4000,-4000
055900,瀚宇博中信97購01,0,0,0,0,0,0,0,0,0,-4000,0,0,0,1000,5000,-4000,-4000
057165,國巨元大99購05  ,0,0,0,0,0,0,0,0,0,-4000,0,0,0,28000,32000,-4000,-4000
057295,可成永豐98購02  ,0,0,0,0,0,0,0,0,0,-4000,0,0,0,14000,18000,-4000,-4000
057320,玉晶光凱基98購01,0,0,0,0,0,0,0,0,0,-4000,0,0,0,6000,10000,-4000,-4000
055724,祥碩元大97購03  ,0,0,0,0,0,0,0,0,0,-4000,0,0,0,2000,6000,-4000,-4000
05817P,可成凱基96售07  ,0,0,0,0,0,0,0,0,0,-4000,0,0,0,6000,10000,-4000,-4000
1468,昶和            ,5000,9000,-4000,0,0,0,0,0,0,0,0,0,0,0,0,0,-4000
1435,中福            ,20000,24000,-4000,0,0,0,0,0,0,0,0,0,0,0,0,0,-4000
06872P,亞德客元富98售04,0,0,0,0,0,0,0,0,0,-4000,0,0,0,0,4000,-4000,-4000
07067P,旺宏台新99售02  ,0,0,0,0,0,0,0,0,0,-4000,0,0,0,68000,72000,-4000,-4000
07496P,鴻海元大9A售05  ,0,0,0,0,0,0,0,0,0,-4000,0,0,0,0,4000,-4000,-4000
059680,台積電國泰9A購03,0,0,0,0,0,0,0,0,0,-5000,0,0,0,338000,343000,-5000,-5000
059699,華通凱基99購04  ,0,0,0,0,0,0,0,0,0,-5000,0,0,0,0,5000,-5000,-5000
059697,上証2X凱基9A購03,0,0,0,0,0,0,0,0,0,-5000,0,0,0,0,5000,-5000,-5000
059719,台積電元大99購42,0,0,0,0,0,0,0,0,0,-5000,0,0,0,12000,17000,-5000,-5000
059782,A50正2元大9C購04,0,0,0,0,0,0,0,0,0,-5000,0,0,0,0,5000,-5000,-5000
059535,玉山金凱基99購01,0,0,0,0,0,0,0,0,0,-5000,0,0,0,31000,36000,-5000,-5000
059620,聯發科日盛99購02,0,0,0,0,0,0,0,0,0,-5000,0,0,0,0,5000,-5000,-5000
059404,鴻海台新99購03  ,0,0,0,0,0,0,0,0,0,-5000,0,0,0,79000,84000,-5000,-5000
059385,滬深2X凱基9C購03,0,0,0,0,0,0,0,0,0,-5000,0,0,0,0,5000,-5000,-5000
059342,聯發科凱基9A購05,0,0,0,0,0,0,0,0,0,-5000,0,0,0,0,5000,-5000,-5000
060440,台灣50元大9C購27,0,0,0,0,0,0,0,0,0,-5000,0,0,0,0,5000,-5000,-5000
060332,聯發科麥證9A購01,0,0,0,2000,7000,-5000,0,0,0,-5000,0,0,0,2000,7000,-5000,-5000
060384,葡萄王凱基9B購01,0,0,0,0,0,0,0,0,0,-5000,0,0,0,0,5000,-5000,-5000
060386,台勝科凱基9B購01,0,0,0,0,0,0,0,0,0,-5000,0,0,0,10000,15000,-5000,-5000
060164,合勤控永豐9A購01,0,0,0,0,0,0,0,0,0,-5000,0,0,0,49000,54000,-5000,-5000
060267,上緯控國票9C購01,0,0,0,0,0,0,0,0,0,-5000,0,0,0,67000,72000,-5000,-5000
060301,國巨富邦9C購02  ,0,0,0,0,0,0,0,0,0,-5000,0,0,0,76000,81000,-5000,-5000
06010P,國泰金元富96售01,0,0,0,0,0,0,0,0,0,-5000,0,0,0,0,5000,-5000,-5000
059989,嘉晶元大9A購01  ,0,0,0,0,0,0,0,0,0,-5000,0,0,0,55000,60000,-5000,-5000
060609,玉晶光凱基9B購01,0,0,0,0,0,0,0,0,0,-5000,0,0,0,0,5000,-5000,-5000
060482,東元富邦9A購01  ,0,0,0,0,0,0,0,0,0,-5000,0,0,0,0,5000,-5000,-5000
060930,超眾永豐9A購03  ,0,0,0,0,0,0,0,0,0,-5000,0,0,0,0,5000,-5000,-5000
061180,華擎凱基9B購01  ,0,0,0,0,0,0,0,0,0,-5000,0,0,0,0,5000,-5000,-5000
061450,嘉晶中信9A購01  ,0,0,0,0,0,0,0,0,0,-5000,0,0,0,0,5000,-5000,-5000
061484,華通兆豐9B購01  ,0,0,0,0,0,0,0,0,0,-5000,0,0,0,0,5000,-5000,-5000
061508,南六國泰9C購02  ,0,0,0,0,0,0,0,0,0,-5000,0,0,0,0,5000,-5000,-5000
061365,國巨國票9B購05  ,0,0,0,0,0,0,0,0,0,-5000,0,0,0,200000,205000,-5000,-5000
06501P,臺股指元大9A售06,0,0,0,0,0,0,0,0,0,-5000,0,0,0,1000,6000,-5000,-5000
06458P,玉晶光統一9A售02,0,0,0,0,0,0,0,0,0,-5000,0,0,0,145000,150000,-5000,-5000
06374P,台表科元大97售06,0,0,0,0,0,0,0,0,0,-5000,0,0,0,0,5000,-5000,-5000
06216P,上銀元富97售03  ,0,0,0,0,0,0,0,0,0,-5000,0,0,0,0,5000,-5000,-5000
06228P,亞德客凱基97售04,0,0,0,0,0,0,0,0,0,-5000,0,0,0,0,5000,-5000,-5000
06249P,億光統一97售02  ,0,0,0,0,0,0,0,0,0,-5000,0,0,0,0,5000,-5000,-5000
06691P,臺股指群益9C售05,0,0,0,0,0,0,0,0,0,-5000,0,0,0,0,5000,-5000,-5000
06597P,國巨富邦9A售05  ,0,0,0,0,0,0,0,0,0,-5000,0,0,0,0,5000,-5000,-5000
052288,敦南統一95購01  ,0,0,0,0,0,0,0,0,0,-5000,0,0,0,0,5000,-5000,-5000
05138P,嘉聯益凱基96售02,0,0,0,0,0,0,0,0,0,-5000,0,0,0,160000,165000,-5000,-5000
051981,南茂凱基96購01  ,0,0,0,0,0,0,0,0,0,-5000,0,0,0,0,5000,-5000,-5000
051094,健策元大96購03  ,0,0,0,0,0,0,0,0,0,-5000,0,0,0,0,5000,-5000,-5000
051193,新日興兆豐96購01,0,0,0,0,0,0,0,0,0,-5000,0,0,0,0,5000,-5000,-5000
050943,楠梓電群益96購01,0,0,0,0,0,0,0,0,0,-5000,0,0,0,0,5000,-5000,-5000
050485,國巨統一96購01  ,0,0,0,0,0,0,0,0,0,-5000,0,0,0,40000,45000,-5000,-5000
048785,台積電元大96購01,0,0,0,0,0,0,0,0,0,-5000,0,0,0,0,5000,-5000,-5000
04838P,宏達電元大95售02,0,0,0,0,0,0,0,0,0,-5000,0,0,0,0,5000,-5000,-5000
048192,華通元大96購01  ,0,0,0,0,0,0,0,0,0,-5000,0,0,0,0,5000,-5000,-5000
047674,群創元富96購02  ,0,0,0,0,0,0,0,0,0,-5000,0,0,0,0,5000,-5000,-5000
044247,道瓊反元富97購01,0,0,0,0,0,0,0,0,0,-5000,0,0,0,0,5000,-5000,-5000
0055,元大MSCI金融    ,1000,2000,-1000,0,0,0,0,0,0,-4000,0,0,0,16000,20000,-4000,-5000
00685L,群益臺灣加權正2 ,0,0,0,0,0,0,0,0,0,-5000,0,0,0,20000,25000,-5000,-5000
053079,世紀鋼永豐96購01,0,0,0,0,0,0,0,0,0,-5000,0,0,0,15000,20000,-5000,-5000
052896,宏達電群益96購01,0,0,0,0,0,0,0,0,0,-5000,0,0,0,0,5000,-5000,-5000
053855,康友國泰98購01  ,0,0,0,0,0,0,0,0,0,-5000,0,0,0,0,5000,-5000,-5000
054103,T50反1凱基99購04,0,0,0,0,0,0,0,0,0,-5000,0,0,0,0,5000,-5000,-5000
056600,聯茂元富98購01  ,0,0,0,0,0,0,0,0,0,-5000,0,0,0,0,5000,-5000,-5000
056564,亞光群益98購02  ,0,0,0,0,0,0,0,0,0,-5000,0,0,0,0,5000,-5000,-5000
055467,國巨凱基97購05  ,0,0,0,0,0,0,0,0,0,-5000,0,0,0,70000,75000,-5000,-5000
057545,國巨凱基99購05  ,0,0,0,0,0,0,0,0,0,-5000,0,0,0,5000,10000,-5000,-5000
057514,華新科元富99購03,0,0,0,0,0,0,0,0,0,-5000,0,0,0,60000,65000,-5000,-5000
053114,聯茂兆豐97購01  ,0,0,0,0,0,0,0,0,0,-5000,0,0,0,0,5000,-5000,-5000
054688,兆赫永豐97購01  ,0,0,0,0,0,0,0,0,0,-5000,0,0,0,0,5000,-5000,-5000
054738,聯發科凱基97購01,0,0,0,0,0,0,0,0,0,-5000,0,0,0,42000,47000,-5000,-5000
053517,崇越群益97購01  ,0,0,0,0,0,0,0,0,0,-5000,0,0,0,0,5000,-5000,-5000
053407,台積電兆豐96購02,0,0,0,0,0,0,0,0,0,-5000,0,0,0,0,5000,-5000,-5000
058177,華新科凱基99購02,0,0,0,0,0,0,0,0,0,-5000,0,0,0,0,5000,-5000,-5000
05830P,滬深2X元富99售03,0,0,0,0,0,0,0,0,0,-5000,0,0,0,0,5000,-5000,-5000
058308,全新元大9B購01  ,0,0,0,0,0,0,0,0,0,-5000,0,0,0,50000,55000,-5000,-5000
057917,台積電凱基98購17,0,0,0,0,0,0,0,0,0,-5000,0,0,0,0,5000,-5000,-5000
055296,康舒元大97購02  ,0,0,0,0,0,0,0,0,0,-5000,0,0,0,0,5000,-5000,-5000
056799,群創麥證98購01  ,0,0,0,0,5000,-5000,0,0,0,-5000,0,0,0,0,5000,-5000,-5000
057252,牧德元富98購01  ,0,0,0,0,0,0,0,0,0,-5000,0,0,0,10000,15000,-5000,-5000
055659,百和元富97購01  ,0,0,0,0,0,0,0,0,0,-5000,0,0,0,0,5000,-5000,-5000
058072,大立光凱基98購20,0,0,0,0,0,0,0,0,0,-5000,0,0,0,0,5000,-5000,-5000
056912,臺股指元大99購04,0,0,0,0,0,0,0,0,0,-5000,0,0,0,5000,10000,-5000,-5000
056917,國巨兆豐98購03  ,0,0,0,0,0,0,0,0,0,-5000,0,0,0,70000,75000,-5000,-5000
056972,祥碩永豐98購02  ,0,0,0,0,0,0,0,0,0,-5000,0,0,0,0,5000,-5000,-5000
056997,台灣50康和9A購02,0,0,0,0,0,0,0,0,0,-5000,0,0,0,0,5000,-5000,-5000
057028,台郡凱基99購02  ,0,0,0,0,0,0,0,0,0,-5000,0,0,0,2000,7000,-5000,-5000
057022,智邦凱基98購04  ,0,0,0,0,0,0,0,0,0,-5000,0,0,0,0,5000,-5000,-5000
057734,訊芯國泰9A購01  ,0,0,0,0,0,0,0,0,0,-5000,0,0,0,0,5000,-5000,-5000
056375,玉晶光統一01購01,0,0,0,0,0,0,0,0,0,-5000,0,0,0,0,5000,-5000,-5000
056868,奇力新麥證98購01,0,0,0,0,5000,-5000,0,0,0,-5000,0,0,0,0,5000,-5000,-5000
056139,貿聯元大97購04  ,0,0,0,0,0,0,0,0,0,-5000,0,0,0,80000,85000,-5000,-5000
058688,矽創凱基9A購01  ,0,0,0,0,0,0,0,0,0,-5000,0,0,0,5000,10000,-5000,-5000
058671,旺宏群益9A購01  ,0,0,0,0,0,0,0,0,0,-5000,0,0,0,3000,8000,-5000,-5000
058602,台積電元大99購11,0,0,0,0,0,0,0,0,0,-5000,0,0,0,0,5000,-5000,-5000
057947,和碩國票99購01  ,0,0,0,0,0,0,0,0,0,-5000,0,0,0,0,5000,-5000,-5000
058950,國巨群益99購06  ,0,0,0,0,0,0,0,0,0,-5000,0,0,0,242000,247000,-5000,-5000
07295P,滬深2X元富9C售09,0,0,0,0,0,0,0,0,0,-5000,0,0,0,0,5000,-5000,-5000
07578P,高鐵元大9A售02  ,0,0,0,0,0,0,0,0,0,-5000,0,0,0,0,5000,-5000,-5000
07053P,台灣50兆豐01售01,0,0,0,0,0,0,0,0,0,-5000,0,0,0,45000,50000,-5000,-5000
06832P,玉晶光凱基98售03,0,0,0,0,0,0,0,0,0,-5000,0,0,0,160000,165000,-5000,-5000
1307,三芳            ,37000,42000,-5000,0,0,0,0,0,0,0,0,0,0,0,0,0,-5000
07794P,智邦國票9A售03  ,0,0,0,0,0,0,0,0,0,-5000,0,0,0,0,5000,-5000,-5000
08671P,友訊國票01售01  ,0,0,0,0,0,0,0,0,0,-5000,0,0,0,0,5000,-5000,-5000
07784P,華新科富邦9B售04,0,0,0,0,0,0,0,0,0,-5000,0,0,0,0,5000,-5000,-5000
07757P,國巨國票9B售04  ,0,0,0,0,0,0,0,0,0,-5000,0,0,0,80000,85000,-5000,-5000
8466,美吉吉-KY       ,0,5000,-5000,0,0,0,0,0,0,0,0,0,0,0,0,0,-5000
06533P,上証2X中信9B售01,0,0,0,0,0,0,0,0,0,-6000,0,0,0,0,6000,-6000,-6000
061303,玉晶光永豐9B購03,0,0,0,0,0,0,0,0,0,-6000,0,0,0,1000,7000,-6000,-6000
061481,嘉澤元大9A購03  ,0,0,0,0,0,0,0,0,0,-6000,0,0,0,0,6000,-6000,-6000
061384,T50反1群益9A購04,0,0,0,0,0,0,0,0,0,-6000,0,0,0,0,6000,-6000,-6000
060849,力成國票9A購01  ,0,0,0,0,0,0,0,0,0,-6000,0,0,0,46000,52000,-6000,-6000
061088,國巨統一9C購05  ,0,0,0,0,0,0,0,0,0,-6000,0,0,0,200000,206000,-6000,-6000
061089,台積電統一9C購04,0,0,0,0,0,0,0,0,0,-6000,0,0,0,5000,11000,-6000,-6000
061063,國巨凱基9A購14  ,0,0,0,0,0,0,0,0,0,-6000,0,0,0,200000,206000,-6000,-6000
061010,上銀麥證9A購02  ,0,0,0,3000,9000,-6000,0,0,0,-6000,0,0,0,3000,9000,-6000,-6000
06060P,玉晶光元大97售03,0,0,0,0,0,0,0,0,0,-6000,0,0,0,0,6000,-6000,-6000
059917,華新科元大99購19,0,0,0,0,0,0,0,0,0,-6000,0,0,0,24000,30000,-6000,-6000
060090,台積電元大99購55,0,0,0,0,0,0,0,0,0,-6000,0,0,0,54000,60000,-6000,-6000
059408,台灣50國票9B購02,0,0,0,0,0,0,0,0,0,-6000,0,0,0,0,6000,-6000,-6000
059148,百和國票9A購01  ,0,0,0,0,0,0,0,0,0,-6000,0,0,0,0,6000,-6000,-6000
059574,台表科凱基99購02,0,0,0,0,0,0,0,0,0,-6000,0,0,0,2000,8000,-6000,-6000
059524,FBVIX凱基9A購02 ,0,0,0,0,0,0,0,0,0,-6000,0,0,0,269000,275000,-6000,-6000
059767,矽力永豐99購01  ,0,0,0,0,0,0,0,0,0,-6000,0,0,0,20000,26000,-6000,-6000
059788,華新科元大9A購05,0,0,0,0,0,0,0,0,0,-6000,0,0,0,3000,9000,-6000,-6000
059733,緯穎元大99購08  ,0,0,0,0,0,0,0,0,0,-6000,0,0,0,34000,40000,-6000,-6000
059716,鴻海元大99購35  ,0,0,0,0,0,0,0,0,0,-6000,0,0,0,29000,35000,-6000,-6000
057505,健策麥證98購01  ,0,0,0,0,16000,-16000,0,0,0,-6000,0,0,0,10000,16000,-6000,-6000
055406,大毅國泰99購01  ,0,0,0,0,0,0,0,0,0,-6000,0,0,0,0,6000,-6000,-6000
055473,禾伸堂凱基97購01,0,0,0,0,0,0,0,0,0,-6000,0,0,0,10000,16000,-6000,-6000
053729,聯茂凱基96購05  ,0,0,0,0,0,0,0,0,0,-6000,0,0,0,0,6000,-6000,-6000
054860,台積電群益98購01,0,0,0,0,0,0,0,0,0,-6000,0,0,0,0,6000,-6000,-6000
05331P,上証2X國票96售01,0,0,0,0,0,0,0,0,0,-6000,0,0,0,1000,7000,-6000,-6000
054384,瀚宇博群益96購02,0,0,0,0,0,0,0,0,0,-6000,0,0,0,125000,131000,-6000,-6000
00743,國泰中國A150    ,0,1000,-1000,0,0,0,0,0,0,-5000,0,0,0,30000,35000,-5000,-6000
048382,T50反1國票96購01,0,0,0,0,0,0,0,0,0,-6000,0,0,0,90000,96000,-6000,-6000
05087P,GIS國泰96售01   ,0,0,0,0,0,0,0,0,0,-6000,0,0,0,0,6000,-6000,-6000
052159,瑞昱永豐95購01  ,0,0,0,0,0,0,0,0,0,-6000,0,0,0,61000,67000,-6000,-6000
051486,玉晶光凱基97購03,0,0,0,0,0,0,0,0,0,-6000,0,0,0,0,6000,-6000,-6000
052566,國巨凱基96購04  ,0,0,0,0,0,0,0,0,0,-6000,0,0,0,4000,10000,-6000,-6000
053885,全新兆豐96購01  ,0,0,0,0,0,0,0,0,0,-6000,0,0,0,4000,10000,-6000,-6000
059067,上銀國票9A購02  ,0,0,0,0,0,0,0,0,0,-6000,0,0,0,0,6000,-6000,-6000
058785,臺股指國票99購04,0,0,0,0,0,0,0,0,0,-6000,0,0,0,0,6000,-6000,-6000
058879,智邦富邦99購01  ,0,0,0,0,0,0,0,0,0,-6000,0,0,0,5000,11000,-6000,-6000
058541,T50反1富邦01購01,0,0,0,0,0,0,0,0,0,-6000,0,0,0,0,6000,-6000,-6000
058631,鈺齊國票9A購01  ,0,0,0,0,0,0,0,0,0,-6000,0,0,0,5000,11000,-6000,-6000
058632,世紀鋼國票9A購01,0,0,0,0,0,0,0,0,0,-6000,0,0,0,20000,26000,-6000,-6000
056895,技嘉元大98購01  ,0,0,0,0,0,0,0,0,0,-6000,0,0,0,0,6000,-6000,-6000
056296,旺宏元大97購07  ,0,0,0,0,0,0,0,0,0,-6000,0,0,0,4000,10000,-6000,-6000
056164,聯茂凱基98購03  ,0,0,0,0,0,0,0,0,0,-6000,0,0,0,0,6000,-6000,-6000
056256,聯茂元富97購03  ,0,0,0,0,0,0,0,0,0,-6000,0,0,0,25000,31000,-6000,-6000
057023,美律凱基99購02  ,0,0,0,0,0,0,0,0,0,-6000,0,0,0,0,6000,-6000,-6000
056041,禾伸堂凱基98購03,0,0,0,0,0,0,0,0,0,-6000,0,0,0,0,6000,-6000,-6000
058036,南電永豐98購01  ,0,0,0,0,0,0,0,0,0,-6000,0,0,0,0,6000,-6000,-6000
055012,茂林元富97購01  ,0,0,0,0,0,0,0,0,0,-6000,0,0,0,0,6000,-6000,-6000
055255,欣興統一97購02  ,0,0,0,0,0,0,0,0,0,-6000,0,0,0,0,6000,-6000,-6000
9911,櫻花            ,111000,120000,-9000,0,0,0,0,0,0,3000,4000,1000,3000,0,0,0,-6000
3167,大量            ,6000,13000,-7000,0,0,0,1000,0,1000,0,0,0,0,0,0,0,-6000
2748,雲品            ,10000,11000,-1000,0,0,0,0,5000,-5000,0,0,0,0,0,0,0,-6000
06937P,GIS元大98售03   ,0,0,0,0,0,0,0,0,0,-6000,0,0,0,10000,16000,-6000,-6000
07006P,旺宏統一9B售03  ,0,0,0,0,0,0,0,0,0,-6000,0,0,0,10000,16000,-6000,-6000
06982P,義隆凱基99售02  ,0,0,0,0,0,0,0,0,0,-6000,0,0,0,59000,65000,-6000,-6000
07614P,華新科群益9A售04,0,0,0,0,0,0,0,0,0,-6000,0,0,0,0,6000,-6000,-6000
4763,材料-KY         ,18000,25000,-7000,0,0,0,0,0,0,925,3000,2075,925,0,0,0,-6075
059698,滬深2X凱基9A購02,0,0,0,0,0,0,0,0,0,-7000,0,0,0,0,7000,-7000,-7000
059145,創意國票99購02  ,0,0,0,0,0,0,0,0,0,-7000,0,0,0,8000,15000,-7000,-7000
059169,可成凱基99購04  ,0,0,0,0,0,0,0,0,0,-7000,0,0,0,0,7000,-7000,-7000
059221,聯發科元大99購21,0,0,0,0,0,0,0,0,0,-7000,0,0,0,40000,47000,-7000,-7000
059209,華通元大99購08  ,0,0,0,0,0,0,0,0,0,-7000,0,0,0,3000,10000,-7000,-7000
06008P,燿華統一96售04  ,0,0,0,0,0,0,0,0,0,-7000,0,0,0,0,7000,-7000,-7000
060449,元金2X元大9A購02,0,0,0,0,0,0,0,0,0,-7000,0,0,0,4000,11000,-7000,-7000
060469,台勝科元大9A購02,0,0,0,0,0,0,0,0,0,-7000,0,0,0,45000,52000,-7000,-7000
06109P,華新科群益97售05,0,0,0,0,0,0,0,0,0,-7000,0,0,0,0,7000,-7000,-7000
060816,世紀鋼凱基9C購02,0,0,0,0,0,0,0,0,0,-7000,0,0,0,0,7000,-7000,-7000
061457,TPK凱基9A購01   ,0,0,0,0,0,0,0,0,0,-7000,0,0,0,34000,41000,-7000,-7000
061307,和潤永豐9A購02  ,0,0,0,0,0,0,0,0,0,-7000,0,0,0,46000,53000,-7000,-7000
061366,台勝科國票9A購01,0,0,0,0,0,0,0,0,0,-7000,0,0,0,36000,43000,-7000,-7000
061356,南電元大9A購06  ,0,0,0,0,0,0,0,0,0,-7000,0,0,0,25000,32000,-7000,-7000
061197,矽創永豐9A購02  ,0,0,0,0,0,0,0,0,0,-7000,0,0,0,10000,17000,-7000,-7000
061219,臺股指元大9A購56,0,0,0,0,0,0,0,0,0,-7000,0,0,0,1000,8000,-7000,-7000
06650P,聯發科元大98售09,0,0,0,0,0,0,0,0,0,-7000,0,0,0,3000,10000,-7000,-7000
06655P,TPK元大98售02   ,0,0,0,0,0,0,0,0,0,-7000,0,0,0,42000,49000,-7000,-7000
052657,友達元富96購01  ,0,0,0,0,0,0,0,0,0,-7000,0,0,0,14000,21000,-7000,-7000
051594,和碩元大96購01  ,0,0,0,0,0,0,0,0,0,-7000,0,0,0,66000,73000,-7000,-7000
05123P,鴻海永昌96售07  ,0,0,0,0,0,0,0,0,0,-7000,0,0,0,81000,88000,-7000,-7000
050138,台表科國票95購02,0,0,0,0,0,0,0,0,0,-7000,0,0,0,40000,47000,-7000,-7000
054934,金寶元大97購01  ,0,0,0,0,0,0,0,0,0,-7000,0,0,0,0,7000,-7000,-7000
055466,台達電凱基97購03,0,0,0,0,0,0,0,0,0,-7000,0,0,0,0,7000,-7000,-7000
056598,京元電元富98購01,0,0,0,0,0,0,0,0,0,-7000,0,0,0,3000,10000,-7000,-7000
055419,國巨永豐97購03  ,0,0,0,0,0,0,0,0,0,-7000,0,0,0,1000,8000,-7000,-7000
056507,創意永豐98購02  ,0,0,0,0,0,0,0,0,0,-7000,0,0,0,10000,17000,-7000,-7000
053487,台泥兆豐97購01  ,0,0,0,0,0,0,0,0,0,-7000,0,0,0,0,7000,-7000,-7000
053181,滬深2X元富99購02,0,0,0,0,0,0,0,0,0,-7000,0,0,0,3000,10000,-7000,-7000
057641,旺宏元大98購10  ,0,0,0,0,0,0,0,0,0,-7000,0,0,0,2000,9000,-7000,-7000
057169,微星元大98購01  ,0,0,0,0,0,0,0,0,0,-7000,0,0,0,14000,21000,-7000,-7000
057563,旭富國泰9A購01  ,0,0,0,0,0,0,0,0,0,-7000,0,0,0,0,7000,-7000,-7000
057699,可成群益9A購02  ,0,0,0,0,0,0,0,0,0,-7000,0,0,0,0,7000,-7000,-7000
056979,微星群益98購01  ,0,0,0,0,0,0,0,0,0,-7000,0,0,0,15000,22000,-7000,-7000
056265,國泰金統一97購01,0,0,0,0,0,0,0,0,0,-7000,0,0,0,0,7000,-7000,-7000
056175,可成元富97購03  ,0,0,0,0,0,0,0,0,0,-7000,0,0,0,3000,10000,-7000,-7000
058654,鴻海中信03購01  ,0,0,0,0,0,0,0,0,0,-7000,0,0,0,0,7000,-7000,-7000
059085,鴻海元大99購25  ,0,0,0,0,0,0,0,0,0,-7000,0,0,0,125000,132000,-7000,-7000
058937,仁寶中信99購01  ,0,0,0,0,0,0,0,0,0,-7000,0,0,0,19000,26000,-7000,-7000
058930,華新科統一9B購01,0,0,0,0,0,0,0,0,0,-7000,0,0,0,27000,34000,-7000,-7000
058986,華新科凱基9A購03,0,0,0,0,0,0,0,0,0,-7000,0,0,0,5000,12000,-7000,-7000
4737,華廣            ,20000,30000,-10000,0,0,0,0,0,0,3000,3000,0,3000,0,0,0,-7000
6257,矽格            ,677000,1128000,-451000,0,0,0,0,0,0,444000,413000,18000,395000,73000,24000,49000,-7000
07301P,臺股指元大9A售34,0,0,0,0,0,0,0,0,0,-7000,0,0,0,16000,23000,-7000,-7000
07291P,臺股指凱基99售43,0,0,0,0,0,0,0,0,0,-7000,0,0,0,20000,27000,-7000,-7000
07370P,南亞科凱基99售08,0,0,0,0,0,0,0,0,0,-7000,0,0,0,61000,68000,-7000,-7000
07076P,鴻海凱基9A售08  ,0,0,0,0,0,0,0,0,0,-7000,0,0,0,0,7000,-7000,-7000
07090P,台灣50凱基01售01,0,0,0,0,0,0,0,0,0,-7000,0,0,0,1000,8000,-7000,-7000
07270P,台灣50元大01售09,0,0,0,0,0,0,0,0,0,-7000,0,0,0,3000,10000,-7000,-7000
061261,台積電凱基9B購03,0,0,0,0,0,0,0,0,0,-8000,0,0,0,3000,11000,-8000,-8000
060995,泰鼎元大9A購03  ,0,0,0,0,0,0,0,0,0,-8000,0,0,0,12000,20000,-8000,-8000
060400,南電國票9A購03  ,0,0,0,0,0,0,0,0,0,-8000,0,0,0,13000,21000,-8000,-8000
060342,台積電統一02購01,0,0,0,0,0,0,0,0,0,-8000,0,0,0,0,8000,-8000,-8000
060124,奇力新永豐99購03,0,0,0,0,0,0,0,0,0,-8000,0,0,0,84000,92000,-8000,-8000
059959,訊芯康和99購01  ,0,0,0,0,0,0,0,0,0,-8000,0,0,0,0,8000,-8000,-8000
059864,亞德客凱基99購01,0,0,0,0,0,0,0,0,0,-8000,0,0,0,3000,11000,-8000,-8000
059215,台積電元大99購28,0,0,0,0,0,0,0,0,0,-8000,0,0,0,12000,20000,-8000,-8000
059262,致茂中信01購01  ,0,0,0,0,0,0,0,0,0,-8000,0,0,0,12000,20000,-8000,-8000
059161,鴻海凱基9A購09  ,0,0,0,0,0,0,0,0,0,-8000,0,0,0,0,8000,-8000,-8000
059391,立積凱基9A購01  ,0,0,0,0,0,0,0,0,0,-8000,0,0,0,9000,17000,-8000,-8000
059389,國巨凱基99購14  ,0,0,0,0,0,0,0,0,0,-8000,0,0,0,2000,10000,-8000,-8000
059453,奇力新永豐99購01,0,0,0,0,0,0,0,0,0,-8000,0,0,0,45000,53000,-8000,-8000
059362,健策永豐99購03  ,0,0,0,0,0,0,0,0,0,-8000,0,0,0,2000,10000,-8000,-8000
059303,國巨兆豐99購04  ,0,0,0,0,0,0,0,0,0,-8000,0,0,0,0,8000,-8000,-8000
059687,卜蜂永豐99購01  ,0,0,0,0,0,0,0,0,0,-8000,0,0,0,20000,28000,-8000,-8000
059762,禾伸堂永豐99購02,0,0,0,0,0,0,0,0,0,-8000,0,0,0,200000,208000,-8000,-8000
054501,強茂永豐96購02  ,0,0,0,0,0,0,0,0,0,-8000,0,0,0,0,8000,-8000,-8000
056478,晶技元大99購01  ,0,0,0,0,0,0,0,0,0,-8000,0,0,0,0,8000,-8000,-8000
056550,瑞儀凱基99購01  ,0,0,0,0,0,0,0,0,0,-8000,0,0,0,190000,198000,-8000,-8000
054220,國巨統一97購02  ,0,0,0,0,0,0,0,0,0,-8000,0,0,0,335000,343000,-8000,-8000
054071,泰鼎國泰97購02  ,0,0,0,0,0,0,0,0,0,-8000,0,0,0,0,8000,-8000,-8000
050150,國巨群益95購01  ,0,0,0,0,0,0,0,0,0,-8000,0,0,0,0,8000,-8000,-8000
049894,嘉聯益富邦98購01,0,0,0,0,0,0,0,0,0,-8000,0,0,0,0,8000,-8000,-8000
04980P,臺股指凱基96售08,0,0,0,0,0,0,0,0,0,-8000,0,0,0,0,8000,-8000,-8000
035275,台積電台新97購01,0,0,0,0,0,0,0,0,0,-8000,0,0,0,0,8000,-8000,-8000
044963,台積電中信96購01,0,0,0,0,0,0,0,0,0,-8000,0,0,0,0,8000,-8000,-8000
00702,國泰標普低波高息,0,3000,-3000,0,0,0,0,0,0,-5000,0,0,0,22000,27000,-5000,-8000
00700,富邦恒生國企    ,0,0,0,0,0,0,0,0,0,-8000,0,0,0,102000,110000,-8000,-8000
00711B,FH彭博新興債    ,0,0,0,0,0,0,0,0,0,-8000,0,0,0,100000,108000,-8000,-8000
00660,元大歐洲50      ,0,0,0,0,0,0,0,0,0,-8000,0,0,0,138000,146000,-8000,-8000
051849,旺宏中信98購01  ,0,0,0,0,0,0,0,0,0,-8000,0,0,0,12000,20000,-8000,-8000
058680,國巨麥證99購02  ,0,0,0,0,8000,-8000,0,0,0,-8000,0,0,0,0,8000,-8000,-8000
057818,泰碩元大9A購01  ,0,0,0,0,0,0,0,0,0,-8000,0,0,0,0,8000,-8000,-8000
056213,建準國票98購02  ,0,0,0,0,0,0,0,0,0,-8000,0,0,0,13000,21000,-8000,-8000
056327,樺漢兆豐98購01  ,0,0,0,0,0,0,0,0,0,-8000,0,0,0,0,8000,-8000,-8000
056420,台表科元富98購01,0,0,0,0,0,0,0,0,0,-8000,0,0,0,0,8000,-8000,-8000
056930,晶豪科台新98購01,0,0,0,0,0,0,0,0,0,-8000,0,0,0,0,8000,-8000,-8000
056927,T50反1台新02購01,0,0,0,0,0,0,0,0,0,-8000,0,0,0,0,8000,-8000,-8000
055907,台虹兆豐98購01  ,0,0,0,0,0,0,0,0,0,-8000,0,0,0,0,8000,-8000,-8000
057024,義隆凱基99購01  ,0,0,0,0,0,0,0,0,0,-8000,0,0,0,20000,28000,-8000,-8000
057012,康控中信98購01  ,0,0,0,0,0,0,0,0,0,-8000,0,0,0,2000,10000,-8000,-8000
057389,玉晶光永豐98購06,0,0,0,0,0,0,0,0,0,-8000,0,0,0,5000,13000,-8000,-8000
058020,大立光凱基99購03,0,0,0,0,0,0,0,0,0,-8000,0,0,0,0,8000,-8000,-8000
058022,樺漢凱基99購02  ,0,0,0,0,0,0,0,0,0,-8000,0,0,0,2000,10000,-8000,-8000
055126,嘉澤兆豐97購01  ,0,0,0,0,0,0,0,0,0,-8000,0,0,0,0,8000,-8000,-8000
1419,新紡            ,24000,32000,-8000,0,0,0,0,0,0,0,0,0,0,0,0,0,-8000
6183,關貿            ,14000,22000,-8000,0,0,0,0,0,0,0,0,0,0,0,0,0,-8000
6152,百一            ,4000,12000,-8000,0,0,0,0,0,0,0,0,0,0,0,0,0,-8000
059746,聯鈞元富99購03  ,0,0,0,0,0,0,0,0,0,-9000,0,0,0,0,9000,-9000,-9000
059520,台表科永豐99購02,0,0,0,0,0,0,0,0,0,-9000,0,0,0,4000,13000,-9000,-9000
059646,聯茂凱基99購06  ,0,0,0,0,0,0,0,0,0,-9000,0,0,0,10000,19000,-9000,-9000
059387,華通凱基9A購03  ,0,0,0,0,0,0,0,0,0,-9000,0,0,0,4000,13000,-9000,-9000
059240,台積電凱基9A購09,0,0,0,0,0,0,0,0,0,-9000,0,0,0,44000,53000,-9000,-9000
060394,欣興麥證9A購01  ,0,0,0,46000,55000,-9000,0,0,0,-9000,0,0,0,46000,55000,-9000,-9000
060432,達方永豐9A購01  ,0,0,0,0,0,0,0,0,0,-9000,0,0,0,69000,78000,-9000,-9000
06059P,泰碩元大97售02  ,0,0,0,0,0,0,0,0,0,-9000,0,0,0,11000,20000,-9000,-9000
060592,上銀麥證9A購01  ,0,0,0,0,9000,-9000,0,0,0,-9000,0,0,0,0,9000,-9000,-9000
060593,華通麥證9A購01  ,0,0,0,9000,18000,-9000,0,0,0,-9000,0,0,0,9000,18000,-9000,-9000
061255,道瓊反凱基9C購01,0,0,0,0,0,0,0,0,0,-9000,0,0,0,2000,11000,-9000,-9000
061240,華新科兆豐9A購01,0,0,0,0,0,0,0,0,0,-9000,0,0,0,0,9000,-9000,-9000
06757P,台灣50元大9B售01,0,0,0,0,0,0,0,0,0,-9000,0,0,0,0,9000,-9000,-9000
052096,力成元大95購01  ,0,0,0,0,0,0,0,0,0,-9000,0,0,0,7000,16000,-9000,-9000
054952,大毅元大97購02  ,0,0,0,0,0,0,0,0,0,-9000,0,0,0,6000,15000,-9000,-9000
056495,泰鼎國泰99購01  ,0,0,0,0,0,0,0,0,0,-9000,0,0,0,0,9000,-9000,-9000
056480,京鼎元大98購02  ,0,0,0,0,0,0,0,0,0,-9000,0,0,0,215000,224000,-9000,-9000
055331,國巨兆豐99購01  ,0,0,0,0,0,0,0,0,0,-9000,0,0,0,0,9000,-9000,-9000
053129,緯穎凱基96購01  ,0,0,0,0,0,0,0,0,0,-9000,0,0,0,0,9000,-9000,-9000
055788,緯穎凱基97購04  ,0,0,0,0,0,0,0,0,0,-9000,0,0,0,1000,10000,-9000,-9000
058252,臺股指元大9A購16,0,0,0,0,0,0,0,0,0,-9000,0,0,0,0,9000,-9000,-9000
055594,華新科元大98購02,0,0,0,0,0,0,0,0,0,-9000,0,0,0,29000,38000,-9000,-9000
055572,鴻海統一98購04  ,0,0,0,0,0,0,0,0,0,-9000,0,0,0,0,9000,-9000,-9000
05723P,華通永豐96售03  ,0,0,0,0,0,0,0,0,0,-9000,0,0,0,0,9000,-9000,-9000
057211,鴻海群益98購05  ,0,0,0,0,0,0,0,0,0,-9000,0,0,0,223000,232000,-9000,-9000
057189,康控元大98購02  ,0,0,0,0,0,0,0,0,0,-9000,0,0,0,80000,89000,-9000,-9000
056275,國巨國泰98購04  ,0,0,0,0,0,0,0,0,0,-9000,0,0,0,71000,80000,-9000,-9000
058635,華新科兆豐99購03,0,0,0,0,0,0,0,0,0,-9000,0,0,0,1000,10000,-9000,-9000
058554,瀚宇博永豐99購01,0,0,0,0,0,0,0,0,0,-9000,0,0,0,1000,10000,-9000,-9000
058873,美律國票9A購02  ,0,0,0,0,0,0,0,0,0,-9000,0,0,0,8000,17000,-9000,-9000
058738,FBVIX中信03購04 ,0,0,0,0,0,0,0,0,0,-9000,0,0,0,2000,11000,-9000,-9000
6235,華孚            ,80000,89000,-9000,0,0,0,0,0,0,0,0,0,0,0,0,0,-9000
911868,同方友友-DR     ,0,9000,-9000,0,0,0,0,0,0,0,0,0,0,0,0,0,-9000
8222,寶一            ,10000,19000,-9000,0,0,0,0,0,0,0,0,0,0,0,0,0,-9000
07738P,玉晶光永豐9A售06,0,0,0,0,0,0,0,0,0,-9000,0,0,0,7000,16000,-9000,-9000
1558,伸興            ,12000,21000,-9000,0,0,0,0,0,0,0,0,0,0,0,0,0,-9000
07165P,臺股指群益99售16,0,0,0,0,0,0,0,0,0,-9000,0,0,0,0,9000,-9000,-9000
06980P,緯穎永豐99售02  ,0,0,0,0,0,0,0,0,0,-9000,0,0,0,6000,15000,-9000,-9000
07034P,大立光元富99售03,0,0,0,0,0,0,0,0,0,-9000,0,0,0,1000,10000,-9000,-9000
06864P,健策凱基98售01  ,0,0,0,0,0,0,0,0,0,-9000,0,0,0,23000,32000,-9000,-9000
06866P,聯發科元大98售13,0,0,0,0,0,0,0,0,0,-9000,0,0,0,11000,20000,-9000,-9000
07622P,華新科統一9B售02,0,0,0,0,0,0,0,0,0,-9000,0,0,0,4000,13000,-9000,-9000
06762P,智邦元大98售11  ,0,0,0,0,0,0,0,0,0,-10000,0,0,0,0,10000,-10000,-10000
06595P,祥碩元大98售03  ,0,0,0,0,0,0,0,0,0,-10000,0,0,0,0,10000,-10000,-10000
06270P,致伸凱基97售03  ,0,0,0,0,0,0,0,0,0,-10000,0,0,0,0,10000,-10000,-10000
06353P,電子類富邦99售02,0,0,0,0,0,0,0,0,0,-10000,0,0,0,0,10000,-10000,-10000
06320P,上銀統一97售04  ,0,0,0,0,0,0,0,0,0,-10000,0,0,0,0,10000,-10000,-10000
061235,台積電元大9A購23,0,0,0,0,0,0,0,0,0,-10000,0,0,0,10000,20000,-10000,-10000
061229,緯穎中信9B購01  ,0,0,0,0,0,0,0,0,0,-10000,0,0,0,0,10000,-10000,-10000
061286,大立光統一9A購05,0,0,0,0,0,0,0,0,0,-10000,0,0,0,0,10000,-10000,-10000
061362,台塑國票9B購01  ,0,0,0,0,0,0,0,0,0,-10000,0,0,0,30000,40000,-10000,-10000
061377,聯發科永豐9A購04,0,0,0,0,0,0,0,0,0,-10000,0,0,0,19000,29000,-10000,-10000
061310,華新科麥證9A購01,0,0,0,0,10000,-10000,0,0,0,-10000,0,0,0,0,10000,-10000,-10000
061330,T50反1元大9A購14,0,0,0,0,0,0,0,0,0,-10000,0,0,0,0,10000,-10000,-10000
061464,瑞昱群益9A購01  ,0,0,0,0,0,0,0,0,0,-10000,0,0,0,69000,79000,-10000,-10000
061454,國巨凱基9A購16  ,0,0,0,0,0,0,0,0,0,-10000,0,0,0,180000,190000,-10000,-10000
061491,嘉聯益兆豐9B購01,0,0,0,0,0,0,0,0,0,-10000,0,0,0,0,10000,-10000,-10000
061494,聯發科國票9A購04,0,0,0,0,0,0,0,0,0,-10000,0,0,0,0,10000,-10000,-10000
060532,欣興中信9A購01  ,0,0,0,0,0,0,0,0,0,-10000,0,0,0,0,10000,-10000,-10000
06053P,緯穎國票97售05  ,0,0,0,0,0,0,0,0,0,-10000,0,0,0,0,10000,-10000,-10000
060550,可成凱基9A購02  ,0,0,0,0,0,0,0,0,0,-10000,0,0,0,0,10000,-10000,-10000
06076P,大立光凱基98售03,0,0,0,0,0,0,0,0,0,-10000,0,0,0,0,10000,-10000,-10000
06077P,GIS凱基97售02   ,0,0,0,0,0,0,0,0,0,-10000,0,0,0,0,10000,-10000,-10000
061048,國巨中信9A購05  ,0,0,0,0,0,0,0,0,0,-10000,0,0,0,0,10000,-10000,-10000
060924,大毅永豐9A購03  ,0,0,0,0,0,0,0,0,0,-10000,0,0,0,7000,17000,-10000,-10000
060451,中石化元大9C購02,0,0,0,0,0,0,0,0,0,-10000,0,0,0,114000,124000,-10000,-10000
060234,凱美元大9C購01  ,0,0,0,0,0,0,0,0,0,-10000,0,0,0,192000,202000,-10000,-10000
059972,S&P正2元大99購03,0,0,0,0,0,0,0,0,0,-10000,0,0,0,0,10000,-10000,-10000
059969,台灣50元大9B購06,0,0,0,0,0,0,0,0,0,-10000,0,0,0,0,10000,-10000,-10000
060074,台積電元富99購04,0,0,0,0,0,0,0,0,0,-10000,0,0,0,20000,30000,-10000,-10000
060064,華新科兆豐99購07,0,0,0,0,0,0,0,0,0,-10000,0,0,0,0,10000,-10000,-10000
059244,聯發科凱基99購13,0,0,0,0,0,0,0,0,0,-10000,0,0,0,0,10000,-10000,-10000
059207,臺指反元大9C購02,0,0,0,0,0,0,0,0,0,-10000,0,0,0,0,10000,-10000,-10000
059304,華新科兆豐99購06,0,0,0,0,0,0,0,0,0,-10000,0,0,0,0,10000,-10000,-10000
05954P,旺宏國票97售03  ,0,0,0,0,0,0,0,0,0,-10000,0,0,0,0,10000,-10000,-10000
059492,國巨國票9A購06  ,0,0,0,0,0,0,0,0,0,-10000,0,0,0,0,10000,-10000,-10000
059505,上証2X永豐99購02,0,0,0,0,0,0,0,0,0,-10000,0,0,0,0,10000,-10000,-10000
059731,康控元大99購04  ,0,0,0,0,0,0,0,0,0,-10000,0,0,0,61000,71000,-10000,-10000
05974P,國巨富邦97售03  ,0,0,0,0,0,0,0,0,0,-10000,0,0,0,0,10000,-10000,-10000
059824,大立光凱基99購13,0,0,0,0,0,0,0,0,0,-10000,0,0,0,2000,12000,-10000,-10000
059828,健策凱基99購05  ,0,0,0,0,0,0,0,0,0,-10000,0,0,0,0,10000,-10000,-10000
059654,T50反1元大99購09,0,0,0,0,0,0,0,0,0,-10000,0,0,0,10000,20000,-10000,-10000
059655,T50反1元大99購10,0,0,0,0,0,0,0,0,0,-10000,0,0,0,0,10000,-10000,-10000
059694,創意永豐99購03  ,0,0,0,0,0,0,0,0,0,-10000,0,0,0,24000,34000,-10000,-10000
059711,滬深2X元大9C購02,0,0,0,0,0,0,0,0,0,-10000,0,0,0,20000,30000,-10000,-10000
059735,T50反1元富99購06,0,0,0,0,0,0,0,0,0,-10000,0,0,0,0,10000,-10000,-10000
053132,國巨國票97購02  ,0,0,0,0,0,0,0,0,0,-10000,0,0,0,0,10000,-10000,-10000
053105,鴻海兆豐97購01  ,0,0,0,0,0,0,0,0,0,-10000,0,0,0,0,10000,-10000,-10000
054608,致茂永豐97購01  ,0,0,0,0,0,0,0,0,0,-10000,0,0,0,0,10000,-10000,-10000
054551,聯發科凱基98購02,0,0,0,0,0,0,0,0,0,-10000,0,0,0,0,10000,-10000,-10000
053192,創意統一96購01  ,0,0,0,0,0,0,0,0,0,-10000,0,0,0,0,10000,-10000,-10000
054634,FB上証中信99購01,0,0,0,0,0,0,0,0,0,-10000,0,0,0,0,10000,-10000,-10000
053530,聯發科康和96購01,0,0,0,0,0,0,0,0,0,-10000,0,0,0,0,10000,-10000,-10000
053421,南亞科永豐96購01,0,0,0,0,0,0,0,0,0,-10000,0,0,0,0,10000,-10000,-10000
05472P,國巨統一96售02  ,0,0,0,0,0,0,0,0,0,-10000,0,0,0,0,10000,-10000,-10000
053372,元油反元大98購01,0,0,0,0,0,0,0,0,0,-10000,0,0,0,0,10000,-10000,-10000
053703,緯穎兆豐96購01  ,0,0,0,0,0,0,0,0,0,-10000,0,0,0,0,10000,-10000,-10000
056548,瀚宇博凱基98購02,0,0,0,0,0,0,0,0,0,-10000,0,0,0,0,10000,-10000,-10000
056537,冠德凱基98購01  ,0,0,0,0,0,0,0,0,0,-10000,0,0,0,0,10000,-10000,-10000
055435,佳世達中信99購01,0,0,0,0,0,0,0,0,0,-10000,0,0,0,0,10000,-10000,-10000
057508,康控國票99購03  ,0,0,0,0,0,0,0,0,0,-10000,0,0,0,0,10000,-10000,-10000
055470,南亞科凱基97購01,0,0,0,0,0,0,0,0,0,-10000,0,0,0,0,10000,-10000,-10000
054354,技嘉富邦97購01  ,0,0,0,0,0,0,0,0,0,-10000,0,0,0,0,10000,-10000,-10000
054445,技嘉兆豐96購01  ,0,0,0,0,0,0,0,0,0,-10000,0,0,0,0,10000,-10000,-10000
054420,緯穎元大96購08  ,0,0,0,0,0,0,0,0,0,-10000,0,0,0,37000,47000,-10000,-10000
054848,群創兆豐98購01  ,0,0,0,0,0,0,0,0,0,-10000,0,0,0,0,10000,-10000,-10000
054850,上海銀兆豐97購01,0,0,0,0,0,0,0,0,0,-10000,0,0,0,0,10000,-10000,-10000
054889,京鼎統一99購01  ,0,0,0,0,0,0,0,0,0,-10000,0,0,0,0,10000,-10000,-10000
052872,智易凱基96購01  ,0,0,0,0,0,0,0,0,0,-10000,0,0,0,0,10000,-10000,-10000
052939,富邦金兆豐96購01,0,0,0,0,0,0,0,0,0,-10000,0,0,0,0,10000,-10000,-10000
053076,貿聯永豐96購01  ,0,0,0,0,0,0,0,0,0,-10000,0,0,0,0,10000,-10000,-10000
053019,禾伸堂元富96購01,0,0,0,0,0,0,0,0,0,-10000,0,0,0,10000,20000,-10000,-10000
05272P,臻鼎中信97售03  ,0,0,0,0,0,0,0,0,0,-10000,0,0,0,10000,20000,-10000,-10000
054062,TPK國票96購02   ,0,0,0,0,0,0,0,0,0,-10000,0,0,0,20000,30000,-10000,-10000
054178,中磊台新97購01  ,0,0,0,0,0,0,0,0,0,-10000,0,0,0,10000,20000,-10000,-10000
054231,國巨群益98購03  ,0,0,0,0,0,0,0,0,0,-10000,0,0,0,280000,290000,-10000,-10000
052844,台積電統一96購02,0,0,0,0,0,0,0,0,0,-10000,0,0,0,0,10000,-10000,-10000
053811,國巨群益98購02  ,0,0,0,0,0,0,0,0,0,-10000,0,0,0,100000,110000,-10000,-10000
053835,南亞科永豐96購02,0,0,0,0,0,0,0,0,0,-10000,0,0,0,0,10000,-10000,-10000
052045,瑞昱凱基96購01  ,0,0,0,0,0,0,0,0,0,-10000,0,0,0,0,10000,-10000,-10000
051873,緯穎凱基95購02  ,0,0,0,0,0,0,0,0,0,-10000,0,0,0,0,10000,-10000,-10000
051781,緯穎群益96購01  ,0,0,0,0,0,0,0,0,0,-10000,0,0,0,0,10000,-10000,-10000
051967,康友永豐95購02  ,0,0,0,0,0,0,0,0,0,-10000,0,0,0,0,10000,-10000,-10000
052021,易華電永豐95購03,0,0,0,0,0,0,0,0,0,-10000,0,0,0,0,10000,-10000,-10000
051268,創意富邦97購01  ,0,0,0,0,0,0,0,0,0,-10000,0,0,0,0,10000,-10000,-10000
051187,晶相光永豐95購01,0,0,0,0,0,0,0,0,0,-10000,0,0,0,0,10000,-10000,-10000
051189,鴻海兆豐96購01  ,0,0,0,0,0,0,0,0,0,-10000,0,0,0,0,10000,-10000,-10000
050882,華泰國泰96購01  ,0,0,0,0,0,0,0,0,0,-10000,0,0,0,0,10000,-10000,-10000
050892,聯電元大96購02  ,0,0,0,0,0,0,0,0,0,-10000,0,0,0,100000,110000,-10000,-10000
051549,健鼎永豐95購01  ,0,0,0,0,0,0,0,0,0,-10000,0,0,0,0,10000,-10000,-10000
051557,昇陽半永豐96購01,0,0,0,0,0,0,0,0,0,-10000,0,0,0,0,10000,-10000,-10000
051537,牧德國票96購01  ,0,0,0,0,0,0,0,0,0,-10000,0,0,0,460000,470000,-10000,-10000
051432,群創元富99購03  ,0,0,0,0,0,0,0,0,0,-10000,0,0,0,300000,310000,-10000,-10000
051392,玉山金兆豐95購01,0,0,0,0,0,0,0,0,0,-10000,0,0,0,0,10000,-10000,-10000
051393,新光金兆豐96購01,0,0,0,0,0,0,0,0,0,-10000,0,0,0,0,10000,-10000,-10000
051406,泰鼎永豐96購01  ,0,0,0,0,0,0,0,0,0,-10000,0,0,0,0,10000,-10000,-10000
052300,力成台新95購01  ,0,0,0,0,0,0,0,0,0,-10000,0,0,0,0,10000,-10000,-10000
051651,易華電永豐95購01,0,0,0,0,0,0,0,0,0,-10000,0,0,0,0,10000,-10000,-10000
052353,高鐵群益97購01  ,0,0,0,0,0,0,0,0,0,-10000,0,0,0,0,10000,-10000,-10000
052689,玉晶光元大98購03,0,0,0,0,0,0,0,0,0,-10000,0,0,0,0,10000,-10000,-10000
053990,晶技兆豐96購01  ,0,0,0,0,0,0,0,0,0,-10000,0,0,0,10000,20000,-10000,-10000
053877,奇力新亞東96購01,0,0,0,0,0,0,0,0,0,-10000,0,0,0,0,10000,-10000,-10000
00656R,國泰中國A50反1  ,13000,0,13000,0,0,0,0,0,0,-23000,0,0,0,50000,73000,-23000,-10000
042953,鴻海台新01購01  ,0,0,0,0,0,0,0,0,0,-10000,0,0,0,0,10000,-10000,-10000
04771P,友達元大96售02  ,0,0,0,0,0,0,0,0,0,-10000,0,0,0,0,10000,-10000,-10000
048177,臺指反富邦99購01,0,0,0,0,0,0,0,0,0,-10000,0,0,0,0,10000,-10000,-10000
04881P,高股息凱基96售01,0,0,0,0,0,0,0,0,0,-10000,0,0,0,0,10000,-10000,-10000
03675C,臺股指元大04牛02,0,0,0,0,0,0,0,0,0,-10000,0,0,0,20000,30000,-10000,-10000
03763P,聯發科元富96售01,0,0,0,0,0,0,0,0,0,-10000,0,0,0,100000,110000,-10000,-10000
047420,全新富邦97購01  ,0,0,0,0,0,0,0,0,0,-10000,0,0,0,0,10000,-10000,-10000
04731P,臺股指中信96售03,0,0,0,0,0,0,0,0,0,-10000,0,0,0,0,10000,-10000,-10000
049859,味全兆豐95購01  ,0,0,0,0,0,0,0,0,0,-10000,0,0,0,0,10000,-10000,-10000
049684,彩晶統一95購01  ,0,0,0,0,0,0,0,0,0,-10000,0,0,0,0,10000,-10000,-10000
049775,旺宏統一95購02  ,0,0,0,0,0,0,0,0,0,-10000,0,0,0,163000,173000,-10000,-10000
058734,康友永豐99購01  ,0,0,0,0,0,0,0,0,0,-10000,0,0,0,0,10000,-10000,-10000
058749,康控凱基99購03  ,0,0,0,0,0,0,0,0,0,-10000,0,0,0,18000,28000,-10000,-10000
058773,和碩兆豐99購01  ,0,0,0,0,0,0,0,0,0,-10000,0,0,0,0,10000,-10000,-10000
058853,日月光群益99購01,0,0,0,0,0,0,0,0,0,-10000,0,0,0,0,10000,-10000,-10000
058883,旭富永豐99購01  ,0,0,0,0,0,0,0,0,0,-10000,0,0,0,20000,30000,-10000,-10000
058802,矽創元大99購02  ,0,0,0,0,0,0,0,0,0,-10000,0,0,0,27000,37000,-10000,-10000
058994,道瓊指元大99購01,0,0,0,0,0,0,0,0,0,-10000,0,0,0,0,10000,-10000,-10000
059042,世紀鋼群益99購02,0,0,0,0,0,0,0,0,0,-10000,0,0,0,0,10000,-10000,-10000
058539,聯發科台新99購01,0,0,0,0,0,0,0,0,0,-10000,0,0,0,2230000,2240000,-10000,-10000
058533,玉晶光元富99購01,0,0,0,0,0,0,0,0,0,-10000,0,0,0,0,10000,-10000,-10000
058618,南電元大99購02  ,0,0,0,0,0,0,0,0,0,-10000,0,0,0,0,10000,-10000,-10000
057771,鴻海群益99購01  ,0,0,0,0,0,0,0,0,0,-10000,0,0,0,0,10000,-10000,-10000
057944,新日興國票99購02,0,0,0,0,0,0,0,0,0,-10000,0,0,0,1000,11000,-10000,-10000
057950,T50正2元大9B購04,0,0,0,0,0,0,0,0,0,-10000,0,0,0,0,10000,-10000,-10000
056292,統一元大97購01  ,0,0,0,0,0,0,0,0,0,-10000,0,0,0,0,10000,-10000,-10000
056241,緯創群益97購01  ,0,0,0,0,0,0,0,0,0,-10000,0,0,0,17000,27000,-10000,-10000
056222,台積電凱基9A購01,0,0,0,0,0,0,0,0,0,-10000,0,0,0,270000,280000,-10000,-10000
056187,京鼎統一97購01  ,0,0,0,0,0,0,0,0,0,-10000,0,0,0,36000,46000,-10000,-10000
056325,群創兆豐9A購01  ,0,0,0,0,0,0,0,0,0,-10000,0,0,0,0,10000,-10000,-10000
056347,GIS凱基9A購01   ,0,0,0,0,0,0,0,0,0,-10000,0,0,0,0,10000,-10000,-10000
056402,智易群益98購02  ,0,0,0,0,0,0,0,0,0,-10000,0,0,0,0,10000,-10000,-10000
056412,上証2X中信9A購02,0,0,0,0,0,0,0,0,0,-10000,0,0,0,0,10000,-10000,-10000
056431,鴻海凱基98購07  ,0,0,0,0,0,0,0,0,0,-10000,0,0,0,0,10000,-10000,-10000
056440,智邦凱基98購03  ,0,0,0,0,0,0,0,0,0,-10000,0,0,0,0,10000,-10000,-10000
056048,同欣電兆豐97購01,0,0,0,0,0,0,0,0,0,-10000,0,0,0,0,10000,-10000,-10000
056839,台光電元富98購02,0,0,0,0,0,0,0,0,0,-10000,0,0,0,0,10000,-10000,-10000
056845,揚明光元富98購01,0,0,0,0,0,0,0,0,0,-10000,0,0,0,10000,20000,-10000,-10000
056029,國巨麥證98購01  ,0,0,0,0,210000,-210000,0,0,0,-10000,0,0,0,200000,210000,-10000,-10000
057758,鴻海凱基99購03  ,0,0,0,0,0,0,0,0,0,-10000,0,0,0,0,10000,-10000,-10000
055906,大立光兆豐97購03,0,0,0,0,0,0,0,0,0,-10000,0,0,0,0,10000,-10000,-10000
055896,南電統一97購02  ,0,0,0,0,0,0,0,0,0,-10000,0,0,0,3000,13000,-10000,-10000
055925,上銀群益97購01  ,0,0,0,0,0,0,0,0,0,-10000,0,0,0,10000,20000,-10000,-10000
056986,超眾群益98購03  ,0,0,0,0,0,0,0,0,0,-10000,0,0,0,10000,20000,-10000,-10000
057193,力成元大98購02  ,0,0,0,0,0,0,0,0,0,-10000,0,0,0,0,10000,-10000,-10000
057208,上海銀元富98購01,0,0,0,0,0,0,0,0,0,-10000,0,0,0,0,10000,-10000,-10000
056650,彩晶凱基9A購01  ,0,0,0,0,0,0,0,0,0,-10000,0,0,0,0,10000,-10000,-10000
056651,聯茂凱基98購04  ,0,0,0,0,0,0,0,0,0,-10000,0,0,0,20000,30000,-10000,-10000
057237,群創凱基9B購02  ,0,0,0,0,0,0,0,0,0,-10000,0,0,0,0,10000,-10000,-10000
057238,群創凱基9B購03  ,0,0,0,0,0,0,0,0,0,-10000,0,0,0,0,10000,-10000,-10000
057262,友達兆豐98購03  ,0,0,0,0,0,0,0,0,0,-10000,0,0,0,0,10000,-10000,-10000
057557,聯茂凱基99購04  ,0,0,0,0,0,0,0,0,0,-10000,0,0,0,0,10000,-10000,-10000
055538,鴻海日盛97購04  ,0,0,0,0,0,0,0,0,0,-10000,0,0,0,0,10000,-10000,-10000
05553P,智原群益96售01  ,0,0,0,0,0,0,0,0,0,-10000,0,0,0,0,10000,-10000,-10000
057410,南電群益98購01  ,0,0,0,0,0,0,0,0,0,-10000,0,0,0,0,10000,-10000,-10000
05744P,台表科元大96售04,0,0,0,0,0,0,0,0,0,-10000,0,0,0,0,10000,-10000,-10000
057333,智邦國票99購01  ,0,0,0,0,0,0,0,0,0,-10000,0,0,0,2000,12000,-10000,-10000
057462,光磊永豐98購02  ,0,0,0,0,0,0,0,0,0,-10000,0,0,0,48000,58000,-10000,-10000
05716P,T50反1元大98售03,0,0,0,0,0,0,0,0,0,-10000,0,0,0,0,10000,-10000,-10000
057589,超眾國票9A購01  ,0,0,0,0,0,0,0,0,0,-10000,0,0,0,4000,14000,-10000,-10000
057596,聯茂兆豐99購01  ,0,0,0,0,0,0,0,0,0,-10000,0,0,0,0,10000,-10000,-10000
057843,晶技永豐98購02  ,0,0,0,0,0,0,0,0,0,-10000,0,0,0,16000,26000,-10000,-10000
05807P,泰鼎永豐96售03  ,0,0,0,0,0,0,0,0,0,-10000,0,0,0,0,10000,-10000,-10000
057890,滬深反統一98購01,0,0,0,0,0,0,0,0,0,-10000,0,0,0,0,10000,-10000,-10000
058343,台積電群益99購02,0,0,0,0,0,0,0,0,0,-10000,0,0,0,0,10000,-10000,-10000
055795,茂林國泰98購01  ,0,0,0,0,0,0,0,0,0,-10000,0,0,0,200000,210000,-10000,-10000
055738,玉山金元富97購01,0,0,0,0,0,0,0,0,0,-10000,0,0,0,0,10000,-10000,-10000
055740,智易元富97購01  ,0,0,0,0,0,0,0,0,0,-10000,0,0,0,10000,20000,-10000,-10000
05529P,臺股指群益96售02,1000,0,1000,0,0,0,0,0,0,-11000,0,0,0,0,11000,-11000,-10000
056753,群創兆豐98購02  ,0,0,0,0,0,0,0,0,0,-10000,0,0,0,0,10000,-10000,-10000
056748,T50反1兆豐99購01,0,0,0,0,0,0,0,0,0,-10000,0,0,0,0,10000,-10000,-10000
055144,T50反1元大97購03,0,0,0,0,0,0,0,0,0,-10000,0,0,0,0,10000,-10000,-10000
055146,華通元大98購04  ,0,0,0,0,0,0,0,0,0,-10000,0,0,0,20000,30000,-10000,-10000
055015,帆宣元富97購01  ,0,0,0,0,0,0,0,0,0,-10000,0,0,0,0,10000,-10000,-10000
055033,漢唐富邦98購01  ,0,0,0,0,0,0,0,0,0,-10000,0,0,0,0,10000,-10000,-10000
055047,南港永豐97購01  ,0,0,0,0,0,0,0,0,0,-10000,0,0,0,0,10000,-10000,-10000
07673P,電子類元大9A售01,0,0,0,0,0,0,0,0,0,-10000,0,0,0,10000,20000,-10000,-10000
07576P,可成元大9A售01  ,0,0,0,0,0,0,0,0,0,-10000,0,0,0,0,10000,-10000,-10000
07318P,鴻海凱基01售02  ,0,0,0,0,0,0,0,0,0,-10000,0,0,0,5000,15000,-10000,-10000
07493P,台灣50元大9A售10,0,0,0,0,0,0,0,0,0,-10000,0,0,0,0,10000,-10000,-10000
07428P,華新科國票9A售01,0,0,0,0,0,0,0,0,0,-10000,0,0,0,0,10000,-10000,-10000
07423P,大立光元大99售33,0,0,0,0,0,0,0,0,0,-10000,0,0,0,0,10000,-10000,-10000
06876P,台灣50兆豐9B售01,0,0,0,0,0,0,0,0,0,-10000,0,0,0,21000,31000,-10000,-10000
06905P,上証2X國泰99售02,0,0,0,0,0,0,0,0,0,-10000,0,0,0,0,10000,-10000,-10000
06821P,臺股指元富98售10,0,0,0,0,0,0,0,0,0,-10000,0,0,0,0,10000,-10000,-10000
06771P,台灣50中信02售01,0,0,0,0,0,0,0,0,0,-10000,0,0,0,0,10000,-10000,-10000
06778P,台積電元大99售06,0,0,0,0,0,0,0,0,0,-10000,0,0,0,125000,135000,-10000,-10000
06779P,智邦元大98售12  ,0,0,0,0,0,0,0,0,0,-10000,0,0,0,0,10000,-10000,-10000
07041P,T50反1元大9C售01,0,0,0,0,0,0,0,0,0,-10000,0,0,0,0,10000,-10000,-10000
07051P,大立光中信99售02,0,0,0,0,0,0,0,0,0,-10000,0,0,0,0,10000,-10000,-10000
07012P,智邦群益9A售01  ,0,0,0,0,0,0,0,0,0,-10000,0,0,0,0,10000,-10000,-10000
07175P,聯詠凱基99售02  ,0,0,0,0,0,0,0,0,0,-10000,0,0,0,0,10000,-10000,-10000
07122P,欣興凱基99售05  ,0,0,0,0,0,0,0,0,0,-10000,0,0,0,0,10000,-10000,-10000
07057P,大立光康和9B售02,0,0,0,0,0,0,0,0,0,-10000,0,0,0,120000,130000,-10000,-10000
07277P,臺股指群益99售20,0,0,0,0,0,0,0,0,0,-10000,0,0,0,0,10000,-10000,-10000
07770P,台積電國票9A售07,0,0,0,0,0,0,0,0,0,-10000,0,0,0,0,10000,-10000,-10000
07778P,台灣50凱基9C售08,0,0,0,0,0,0,0,0,0,-10000,0,0,0,0,10000,-10000,-10000
07779P,鴻海凱基9B售04  ,0,0,0,0,0,0,0,0,0,-10000,0,0,0,0,10000,-10000,-10000
1232,大統益          ,12000,22000,-10000,0,0,0,0,0,0,0,0,0,0,0,0,0,-10000
059809,貿聯元富99購01  ,0,0,0,0,0,0,0,0,0,-11000,0,0,0,6000,17000,-11000,-11000
059513,揚明光永豐99購01,0,0,0,0,0,0,0,0,0,-11000,0,0,0,1000,12000,-11000,-11000
059328,台灣50國票99購08,0,0,0,0,0,0,0,0,0,-11000,0,0,0,0,11000,-11000,-11000
059228,臺股指元大99購21,0,0,0,0,0,0,0,0,0,-11000,0,0,0,0,11000,-11000,-11000
060048,元金2X凱基99購03,0,0,0,0,0,0,0,0,0,-11000,0,0,0,0,11000,-11000,-11000
060017,全新康和99購01  ,0,0,0,0,0,0,0,0,0,-11000,0,0,0,0,11000,-11000,-11000
059887,華新科國票99購02,0,0,0,0,0,0,0,0,0,-11000,0,0,0,0,11000,-11000,-11000
060266,潤泰全國票9A購01,0,0,0,0,0,0,0,0,0,-11000,0,0,0,3000,14000,-11000,-11000
060146,健策國票9A購03  ,0,0,0,0,0,0,0,0,0,-11000,0,0,0,0,11000,-11000,-11000
060349,上証2X元富9A購04,0,0,0,0,0,0,0,0,0,-11000,0,0,0,0,11000,-11000,-11000
060812,智邦凱基9A購01  ,0,0,0,0,0,0,0,0,0,-11000,0,0,0,7000,18000,-11000,-11000
060830,T50反1國票9A購07,0,0,0,0,0,0,0,0,0,-11000,0,0,0,0,11000,-11000,-11000
060996,臻鼎元大9A購01  ,0,0,0,0,0,0,0,0,0,-11000,0,0,0,13000,24000,-11000,-11000
060643,牧德永豐9A購03  ,0,0,0,0,0,0,0,0,0,-11000,0,0,0,0,11000,-11000,-11000
061483,TPK元大9A購01   ,0,0,0,0,0,0,0,0,0,-11000,0,0,0,65000,76000,-11000,-11000
061443,大立光統一9C購02,0,0,0,0,0,0,0,0,0,-11000,0,0,0,0,11000,-11000,-11000
061342,華新科元大9A購17,0,0,0,0,0,0,0,0,0,-11000,0,0,0,12000,23000,-11000,-11000
061147,上証2X群益9C購06,0,0,0,0,0,0,0,0,0,-11000,0,0,0,0,11000,-11000,-11000
06538P,國巨凱基98售11  ,0,0,0,0,0,0,0,0,0,-11000,0,0,0,0,11000,-11000,-11000
00757,統一FANG+       ,0,0,0,0,0,0,0,0,0,-11000,0,0,0,204000,215000,-11000,-11000
05063P,聯電元大96售03  ,0,0,0,0,0,0,0,0,0,-11000,0,0,0,0,11000,-11000,-11000
05124P,華新科富邦97售02,0,0,0,0,0,0,0,0,0,-11000,0,0,0,22000,33000,-11000,-11000
051945,智邦統一95購03  ,0,0,0,0,0,0,0,0,0,-11000,0,0,0,0,11000,-11000,-11000
054216,聯茂國票97購03  ,0,0,0,0,0,0,0,0,0,-11000,0,0,0,0,11000,-11000,-11000
054003,鴻海統一96購13  ,0,0,0,0,0,0,0,0,0,-11000,0,0,0,0,11000,-11000,-11000
057482,微星元大98購03  ,0,0,0,0,0,0,0,0,0,-11000,0,0,0,0,11000,-11000,-11000
053660,群創凱基98購08  ,0,0,0,0,0,0,0,0,0,-11000,0,0,0,124000,135000,-11000,-11000
053581,台積電元大96購14,0,0,0,0,0,0,0,0,0,-11000,0,0,0,0,11000,-11000,-11000
054641,祥碩中信98購01  ,0,0,0,0,0,0,0,0,0,-11000,0,0,0,0,11000,-11000,-11000
055780,禾伸堂凱基99購01,0,0,0,0,0,0,0,0,0,-11000,0,0,0,0,11000,-11000,-11000
058391,T50反1元大99購02,0,0,0,0,0,0,0,0,0,-11000,0,0,0,0,11000,-11000,-11000
056710,漢唐永豐98購01  ,0,0,0,0,0,0,0,0,0,-11000,0,0,0,100000,111000,-11000,-11000
056668,光磊國票99購01  ,0,0,0,0,0,0,0,0,0,-11000,0,0,0,73000,84000,-11000,-11000
056954,聯詠富邦9A購01  ,0,0,0,0,0,0,0,0,0,-11000,0,0,0,19000,30000,-11000,-11000
057672,茂林元大98購02  ,0,0,0,0,0,0,0,0,0,-11000,0,0,0,63000,74000,-11000,-11000
056426,上証2X凱基9A購01,0,0,0,0,0,0,0,0,0,-11000,0,0,0,2000,13000,-11000,-11000
056259,T50反1統一9A購01,0,0,0,0,0,0,0,0,0,-11000,0,0,0,0,11000,-11000,-11000
058670,鴻海群益9A購03  ,0,0,0,0,0,0,0,0,0,-11000,0,0,0,0,11000,-11000,-11000
059065,南電凱基9A購01  ,0,0,0,0,0,0,0,0,0,-11000,0,0,0,59000,70000,-11000,-11000
058777,台光電國票9A購01,0,0,0,0,0,0,0,0,0,-11000,0,0,0,1000,12000,-11000,-11000
07732P,台灣50台新9A售05,0,0,0,0,0,0,0,0,0,-11000,0,0,0,0,11000,-11000,-11000
1528,恩德            ,37000,48000,-11000,0,0,0,0,0,0,0,0,0,0,0,0,0,-11000
3010,華立            ,48000,59000,-11000,0,0,0,0,0,0,0,0,0,0,0,0,0,-11000
07508P,華新科國票9A售03,0,0,0,0,0,0,0,0,0,-11000,0,0,0,0,11000,-11000,-11000
06296P,燿華元大98售01  ,0,0,0,0,0,0,0,0,0,-12000,0,0,0,8000,20000,-12000,-12000
06593P,欣興元大98售05  ,0,0,0,0,0,0,0,0,0,-12000,0,0,0,146000,158000,-12000,-12000
061473,台積電元大9A購33,0,0,0,0,0,0,0,0,0,-12000,0,0,0,0,12000,-12000,-12000
060287,燿華元大9A購01  ,0,0,0,0,0,0,0,0,0,-12000,0,0,0,117000,129000,-12000,-12000
060264,華新科國票9A購02,0,0,0,0,0,0,0,0,0,-12000,0,0,0,40000,52000,-12000,-12000
059349,台郡凱基99購04  ,0,0,0,0,0,0,0,0,0,-12000,0,0,0,16000,28000,-12000,-12000
059289,瑞昱元富99購01  ,0,0,0,0,0,0,0,0,0,-12000,0,0,0,66000,78000,-12000,-12000
05963P,貿聯國票97售02  ,0,0,0,0,0,0,0,0,0,-12000,0,0,0,0,12000,-12000,-12000
053195,玉晶光元富96購02,0,0,0,0,0,0,0,0,0,-12000,0,0,0,1000,13000,-12000,-12000
053111,緯創兆豐97購01  ,0,0,0,0,0,0,0,0,0,-12000,0,0,0,0,12000,-12000,-12000
055394,健策統一97購01  ,0,0,0,0,0,0,0,0,0,-12000,0,0,0,254000,266000,-12000,-12000
054333,茂林永豐96購03  ,0,0,0,0,0,0,0,0,0,-12000,0,0,0,20000,32000,-12000,-12000
051970,元黃金凱基98購01,0,0,0,0,0,0,0,0,0,-12000,0,0,0,0,12000,-12000,-12000
051809,義隆凱基96購01  ,0,0,0,0,0,0,0,0,0,-12000,0,0,0,10000,22000,-12000,-12000
052294,創意國票96購03  ,0,0,0,0,0,0,0,0,0,-12000,0,0,0,0,12000,-12000,-12000
051605,奇力新群益95購02,0,0,0,0,0,0,0,0,0,-12000,0,0,0,0,12000,-12000,-12000
04763P,臺股指凱基96售05,0,0,0,0,0,0,0,0,0,-12000,0,0,0,0,12000,-12000,-12000
057760,聯發科凱基98購18,0,0,0,0,0,0,0,0,0,-12000,0,0,0,3000,15000,-12000,-12000
057989,旺宏統一99購04  ,0,0,0,0,0,0,0,0,0,-12000,0,0,0,405000,417000,-12000,-12000
057053,立積元大98購02  ,0,0,0,0,0,0,0,0,0,-12000,0,0,0,54000,66000,-12000,-12000
055695,大毅國票98購03  ,0,0,0,0,0,0,0,0,0,-12000,0,0,0,7000,19000,-12000,-12000
058098,T50反1國泰9A購02,0,0,0,0,0,0,0,0,0,-12000,0,0,0,0,12000,-12000,-12000
05803P,臺股指兆豐96售03,0,0,0,0,0,0,0,0,0,-12000,0,0,0,0,12000,-12000,-12000
057478,智邦元大99購01  ,0,0,0,0,0,0,0,0,0,-12000,0,0,0,0,12000,-12000,-12000
057377,康控元大99購02  ,0,0,0,0,0,0,0,0,0,-12000,0,0,0,379000,391000,-12000,-12000
058440,玉晶光統一99購02,0,0,0,0,0,0,0,0,0,-12000,0,0,0,33000,45000,-12000,-12000
058196,台塑中信99購01  ,0,0,0,0,0,0,0,0,0,-12000,0,0,0,0,12000,-12000,-12000
058133,華新科元大9A購02,0,0,0,0,0,0,0,0,0,-12000,0,0,0,29000,41000,-12000,-12000
057654,A50正2中信98購01,0,0,0,0,0,0,0,0,0,-12000,0,0,0,0,12000,-12000,-12000
055790,南電凱基97購01  ,0,0,0,0,0,0,0,0,0,-12000,0,0,0,0,12000,-12000,-12000
058374,玉晶光凱基9A購03,0,0,0,0,0,0,0,0,0,-12000,0,0,0,0,12000,-12000,-12000
07358P,鴻海元大99售39  ,0,0,0,0,0,0,0,0,0,-12000,0,0,0,68000,80000,-12000,-12000
1773,勝一            ,44000,56000,-12000,0,0,0,0,0,0,0,0,0,0,0,0,0,-12000
8480,泰昇-KY         ,2000,14000,-12000,0,0,0,0,0,0,0,0,0,0,0,0,0,-12000
3622,洋華            ,28000,40000,-12000,0,0,0,0,0,0,0,0,0,0,0,0,0,-12000
8422,可寧衛          ,40000,59807,-19807,0,0,0,0,0,0,7000,7000,0,7000,0,0,0,-12807
059571,奇力新凱基99購06,0,0,0,0,0,0,0,0,0,-13000,0,0,0,0,13000,-13000,-13000
059588,鴻海元大99購32  ,0,0,0,0,0,0,0,0,0,-13000,0,0,0,4000,17000,-13000,-13000
059511,宏達電永豐99購02,0,0,0,0,0,0,0,0,0,-13000,0,0,0,0,13000,-13000,-13000
059674,玉山金元富99購02,0,0,0,0,0,0,0,0,0,-13000,0,0,0,26000,39000,-13000,-13000
059177,臺股指凱基99購28,0,0,0,0,0,0,0,0,0,-13000,0,0,0,22000,35000,-13000,-13000
060404,台勝科國泰9B購01,0,0,0,0,0,0,0,0,0,-13000,0,0,0,32000,45000,-13000,-13000
059934,華通永豐99購02  ,0,0,0,0,0,0,0,0,0,-13000,0,0,0,10000,23000,-13000,-13000
060004,臺指反群益9A購01,0,0,0,0,0,0,0,0,0,-13000,0,0,0,0,13000,-13000,-13000
060029,嘉晶永豐99購03  ,0,0,0,0,0,0,0,0,0,-13000,0,0,0,0,13000,-13000,-13000
061184,大立光國泰9C購01,0,0,0,0,0,0,0,0,0,-13000,0,0,0,217000,230000,-13000,-13000
06055P,華通凱基97售04  ,0,0,0,0,0,0,0,0,0,-13000,0,0,0,9000,22000,-13000,-13000
060665,康控凱基9A購01  ,0,0,0,0,0,0,0,0,0,-13000,0,0,0,74000,87000,-13000,-13000
060963,禾伸堂凱基9A購01,0,0,0,0,0,0,0,0,0,-13000,0,0,0,151000,164000,-13000,-13000
00645,富邦日本        ,0,0,0,0,0,0,0,0,0,-13000,0,0,0,78000,91000,-13000,-13000
04794P,友達元大96售03  ,0,0,0,0,0,0,0,0,0,-13000,0,0,0,11000,24000,-13000,-13000
052429,禾伸堂永豐95購02,0,0,0,0,0,0,0,0,0,-13000,0,0,0,67000,80000,-13000,-13000
053292,美律中信98購01  ,0,0,0,0,0,0,0,0,0,-13000,0,0,0,35000,48000,-13000,-13000
054383,傳奇群益97購01  ,0,0,0,0,0,0,0,0,0,-13000,0,0,0,0,13000,-13000,-13000
055085,大毅國票97購01  ,0,0,0,0,0,0,0,0,0,-13000,0,0,0,3000,16000,-13000,-13000
056766,義隆元大98購01  ,0,2000,-2000,0,0,0,0,0,0,-11000,0,0,0,19000,30000,-11000,-13000
055280,智邦元大97購01  ,0,0,0,0,0,0,0,0,0,-13000,0,0,0,39000,52000,-13000,-13000
058290,南電國票9A購01  ,0,0,0,0,0,0,0,0,0,-13000,0,0,0,7000,20000,-13000,-13000
057882,華通群益9A購03  ,0,0,0,0,0,0,0,0,0,-13000,0,0,0,32000,45000,-13000,-13000
057431,京鼎兆豐98購02  ,0,0,0,0,0,0,0,0,0,-13000,0,0,0,17000,30000,-13000,-13000
057147,新日興國票99購01,0,0,0,0,0,0,0,0,0,-13000,0,0,0,38000,51000,-13000,-13000
056196,聯茂富邦98購02  ,0,0,0,0,0,0,0,0,0,-13000,0,0,0,212000,225000,-13000,-13000
058603,台積電元大99購12,0,0,0,0,0,0,0,0,0,-13000,0,0,0,590000,603000,-13000,-13000
058765,緯穎群益99購03  ,0,0,0,0,0,0,0,0,0,-13000,0,0,0,48000,61000,-13000,-13000
8249,菱光            ,37000,50000,-13000,0,0,0,0,0,0,0,0,0,0,0,0,0,-13000
4560,強信-KY         ,256000,269000,-13000,0,0,0,0,0,0,0,0,0,0,0,0,0,-13000
07191P,台積電元大99售32,0,0,0,0,0,0,0,0,0,-13000,0,0,0,2000,15000,-13000,-13000
06886P,旺宏元大99售07  ,0,0,0,0,0,0,0,0,0,-13000,0,0,0,2000,15000,-13000,-13000
06091P,華新科統一97售01,0,0,0,0,0,0,0,0,0,-14000,0,0,0,10000,24000,-14000,-14000
060635,義隆永豐9A購01  ,0,0,0,0,0,0,0,0,0,-14000,0,0,0,23000,37000,-14000,-14000
061462,國巨群益9A購11  ,0,0,0,0,0,0,0,0,0,-14000,0,0,0,200000,214000,-14000,-14000
06602P,國巨統一99售02  ,0,0,0,0,0,0,0,0,0,-14000,0,0,0,64000,78000,-14000,-14000
06617P,智邦元大98售03  ,0,0,0,0,0,0,0,0,0,-14000,0,0,0,66000,80000,-14000,-14000
060016,廣達康和99購01  ,0,0,0,0,0,0,0,0,0,-14000,0,0,0,14000,28000,-14000,-14000
059885,台積電國票99購12,0,0,0,0,0,0,0,0,0,-14000,0,0,0,14000,28000,-14000,-14000
060210,上銀康和9A購01  ,0,0,0,0,0,0,0,0,0,-14000,0,0,0,0,14000,-14000,-14000
059755,宏達電國泰9A購01,0,0,0,0,0,0,0,0,0,-14000,0,0,0,266000,280000,-14000,-14000
056588,聯發科統一9A購02,0,0,0,0,0,0,0,0,0,-14000,0,0,0,6000,20000,-14000,-14000
057507,貿聯國票98購02  ,0,0,0,0,0,0,0,0,0,-14000,0,0,0,25000,39000,-14000,-14000
042929,台積電中信95購02,0,0,0,0,0,0,0,0,0,-14000,0,0,0,0,14000,-14000,-14000
03686P,大立光統一98售02,0,0,0,0,0,0,0,0,0,-14000,0,0,0,0,14000,-14000,-14000
059027,神達台新99購02  ,0,0,0,0,0,0,0,0,0,-14000,0,0,0,15000,29000,-14000,-14000
058568,宏達電凱基9A購02,0,0,0,0,0,0,0,0,0,-14000,0,0,0,40000,54000,-14000,-14000
058694,鈺齊國票9A購02  ,0,0,0,0,0,0,0,0,0,-14000,0,0,0,10000,24000,-14000,-14000
058626,瑞昱國票9A購01  ,0,0,0,0,0,0,0,0,0,-14000,0,0,0,6000,20000,-14000,-14000
057948,嘉聯益國票99購02,0,0,0,0,0,0,0,0,0,-14000,0,0,0,2000,16000,-14000,-14000
057598,鴻海群益98購07  ,0,0,0,0,0,0,0,0,0,-14000,0,0,0,0,14000,-14000,-14000
058074,欣興凱基99購01  ,0,0,0,0,0,0,0,0,0,-14000,0,0,0,2000,16000,-14000,-14000
056674,華邦電元富98購01,0,0,0,0,0,0,0,0,0,-14000,0,0,0,301000,315000,-14000,-14000
057360,元油2X元大98購10,0,0,0,0,0,0,0,0,0,-14000,0,0,0,0,14000,-14000,-14000
07355P,臺股指國票99售23,0,0,0,0,0,0,0,0,0,-14000,0,0,0,36000,50000,-14000,-14000
07394P,國巨群益99售12  ,0,0,0,0,0,0,0,0,0,-14000,0,0,0,228000,242000,-14000,-14000
07765P,台積電群益9A售06,0,0,0,0,0,0,0,0,0,-14000,0,0,0,16000,30000,-14000,-14000
2642,宅配通          ,52000,66000,-14000,0,0,0,0,0,0,0,0,0,0,0,0,0,-14000
6412,群電            ,184000,210000,-26000,0,0,0,1000,0,1000,11000,4000,0,4000,7000,0,7000,-14000
059725,聯發科元大99購31,0,0,0,0,0,0,0,0,0,-15000,0,0,0,0,15000,-15000,-15000
059157,元石油凱基9C購01,0,0,0,0,0,0,0,0,0,-15000,0,0,0,0,15000,-15000,-15000
059192,臺股指富邦9C購01,0,0,0,0,0,0,0,0,0,-15000,0,0,0,0,15000,-15000,-15000
059434,全新元大99購05  ,0,0,0,0,0,0,0,0,0,-15000,0,0,0,28000,43000,-15000,-15000
060313,淘帝永豐9A購01  ,0,0,0,0,0,0,0,0,0,-15000,0,0,0,0,15000,-15000,-15000
059925,可成國泰9B購01  ,0,0,0,0,0,0,0,0,0,-15000,0,0,0,3000,18000,-15000,-15000
060089,台積電元大99購54,0,0,0,0,0,0,0,0,0,-15000,0,0,0,35000,50000,-15000,-15000
06763P,技嘉元大98售05  ,0,0,0,0,0,0,0,0,0,-15000,0,0,0,255000,270000,-15000,-15000
06717P,可成元大98售09  ,0,0,0,0,0,0,0,0,0,-15000,0,0,0,0,15000,-15000,-15000
06262P,國巨凱基97售07  ,0,0,0,0,0,0,0,0,0,-15000,0,0,0,50000,65000,-15000,-15000
06487P,聯發科統一99售02,0,0,0,0,0,0,0,0,0,-15000,0,0,0,1000,16000,-15000,-15000
061500,京鼎國票9B購01  ,0,0,0,0,0,0,0,0,0,-15000,0,0,0,10000,25000,-15000,-15000
061496,華新科國票9A購07,0,0,0,0,0,0,0,0,0,-15000,0,0,0,0,15000,-15000,-15000
061173,T50反1凱基04購01,0,0,0,0,0,0,0,0,0,-15000,0,0,0,0,15000,-15000,-15000
060980,台積電元大9A購21,0,0,0,0,0,0,0,0,0,-15000,0,0,0,15000,30000,-15000,-15000
050122,臺指反凱基96購01,0,0,0,0,0,0,0,0,0,-15000,0,0,0,0,15000,-15000,-15000
050480,健策國票95購04  ,0,0,0,0,0,0,0,0,0,-15000,0,0,0,0,15000,-15000,-15000
048483,可成國泰95購01  ,0,0,0,0,0,0,0,0,0,-15000,0,0,0,0,15000,-15000,-15000
04751P,智邦兆豐95售02  ,0,0,0,0,0,0,0,0,0,-15000,0,0,0,5000,20000,-15000,-15000
050783,旺宏國泰96購02  ,0,0,0,0,0,0,0,0,0,-15000,0,0,0,5000,20000,-15000,-15000
054751,GIS凱基98購01   ,0,0,0,0,0,0,0,0,0,-15000,0,0,0,5000,20000,-15000,-15000
053027,玉晶光富邦98購01,0,0,0,0,0,0,0,0,0,-15000,0,0,0,0,15000,-15000,-15000
053033,智易兆豐97購01  ,0,0,0,0,0,0,0,0,0,-15000,0,0,0,10000,25000,-15000,-15000
057313,聯發科麥證99購01,0,0,0,2000,17000,-15000,0,0,0,-15000,0,0,0,2000,17000,-15000,-15000
058311,緯穎元大99購05  ,0,0,0,0,0,0,0,0,0,-15000,0,0,0,3000,18000,-15000,-15000
058370,聯詠凱基99購01  ,0,0,0,0,0,0,0,0,0,-15000,0,0,0,0,15000,-15000,-15000
055170,光磊統一97購01  ,0,0,0,0,0,0,0,0,0,-15000,0,0,0,3000,18000,-15000,-15000
058628,宏達電國票9A購01,0,0,0,0,0,0,0,0,0,-15000,0,0,0,0,15000,-15000,-15000
056394,晶豪科永豐98購01,0,0,0,0,0,0,0,0,0,-15000,0,0,0,1000,16000,-15000,-15000
056897,南亞科元大98購02,0,0,0,0,0,0,0,0,0,-15000,0,0,0,35000,50000,-15000,-15000
056885,元油2X元大99購03,0,0,0,0,0,0,0,0,0,-15000,0,0,0,0,15000,-15000,-15000
055955,微星元大97購01  ,0,0,0,0,0,0,0,0,0,-15000,0,0,0,24000,39000,-15000,-15000
07747P,晶技凱基9A售04  ,0,0,0,0,0,0,0,0,0,-15000,0,0,0,28000,43000,-15000,-15000
07437P,臺股指麥證9A售04,0,0,0,10000,25000,-15000,0,0,0,-15000,0,0,0,10000,25000,-15000,-15000
07509P,牧德國票9A售03  ,0,0,0,0,0,0,0,0,0,-15000,0,0,0,10000,25000,-15000,-15000
07529P,國巨凱基9A售11  ,0,0,0,0,0,0,0,0,0,-15000,0,0,0,0,15000,-15000,-15000
07566P,台積電台新9B售02,0,0,0,0,0,0,0,0,0,-15000,0,0,0,0,15000,-15000,-15000
07667P,亞德客元大9A售05,0,0,0,0,0,0,0,0,0,-15000,0,0,0,5000,20000,-15000,-15000
07656P,國巨凱基9A售15  ,0,0,0,0,0,0,0,0,0,-15000,0,0,0,80000,95000,-15000,-15000
06993P,鴻海凱基99售05  ,0,0,0,0,0,0,0,0,0,-15000,0,0,0,0,15000,-15000,-15000
07234P,台灣50元大9B售04,0,0,0,0,0,0,0,0,0,-15000,0,0,0,0,15000,-15000,-15000
061064,可成凱基9B購02  ,0,0,0,0,0,0,0,0,0,-16000,0,0,0,0,16000,-16000,-16000
060961,台光電凱基9A購03,0,0,0,0,0,0,0,0,0,-16000,0,0,0,20000,36000,-16000,-16000
060516,臺股指元大9B購13,0,0,0,0,0,0,0,0,0,-16000,0,0,0,0,16000,-16000,-16000
06051P,嘉聯益國票97售04,0,0,0,0,0,0,0,0,0,-16000,0,0,0,0,16000,-16000,-16000
060062,聯發科兆豐99購04,0,0,0,0,0,0,0,0,0,-16000,0,0,0,0,16000,-16000,-16000
059846,力山永豐99購01  ,0,0,0,0,0,0,0,0,0,-16000,0,0,0,0,16000,-16000,-16000
059409,台灣50國票9C購01,0,0,0,0,0,0,0,0,0,-16000,0,0,0,0,16000,-16000,-16000
059330,台灣50國票99購10,0,0,0,0,0,0,0,0,0,-16000,0,0,0,0,16000,-16000,-16000
059265,美律中信01購01  ,0,0,0,0,0,0,0,0,0,-16000,0,0,0,0,16000,-16000,-16000
059165,南亞科凱基99購04,0,0,0,0,0,0,0,0,0,-16000,0,0,0,0,16000,-16000,-16000
059117,禾伸堂永豐99購01,0,0,0,0,0,0,0,0,0,-16000,0,0,0,63000,79000,-16000,-16000
059666,台表科元大9B購01,0,0,0,0,0,0,0,0,0,-16000,0,0,0,33000,49000,-16000,-16000
054935,華通元大98購03  ,0,0,0,0,0,0,0,0,0,-16000,0,0,0,52000,68000,-16000,-16000
053551,可成凱基96購05  ,0,0,0,0,0,0,0,0,0,-16000,0,0,0,0,16000,-16000,-16000
055476,台郡凱基97購02  ,0,0,0,0,0,0,0,0,0,-16000,0,0,0,0,16000,-16000,-16000
056519,創意國票99購01  ,0,0,0,0,0,0,0,0,0,-16000,0,0,0,0,16000,-16000,-16000
053932,華新科統一96購03,0,0,0,0,0,0,0,0,0,-16000,0,0,0,0,16000,-16000,-16000
00735,國泰臺韓科技    ,0,0,0,0,0,0,0,0,0,-16000,0,0,0,210000,226000,-16000,-16000
00701,國泰股利精選30  ,3000,0,3000,0,0,0,0,0,0,-19000,0,0,0,686000,705000,-19000,-16000
057671,群創元大9B購06  ,0,0,0,0,0,0,0,0,0,-16000,0,0,0,216000,232000,-16000,-16000
056214,義隆國票99購01  ,0,0,0,0,0,0,0,0,0,-16000,0,0,0,1000,17000,-16000,-16000
055776,宏達電凱基98購02,0,0,0,0,0,0,0,0,0,-16000,0,0,0,51000,67000,-16000,-16000
057856,聯鈞國票99購03  ,0,0,0,0,0,0,0,0,0,-16000,0,0,0,3000,19000,-16000,-16000
05741P,聯發科元大96售14,0,0,0,0,0,0,0,0,0,-16000,0,0,0,0,16000,-16000,-16000
07252P,台灣50凱基99售01,0,0,0,0,0,0,0,0,0,-16000,0,0,0,124000,140000,-16000,-16000
059146,貿聯國票9A購02  ,0,0,0,0,0,0,0,0,0,-17000,0,0,0,10000,27000,-17000,-17000
059456,智易永豐99購01  ,0,0,0,0,0,0,0,0,0,-17000,0,0,0,2000,19000,-17000,-17000
05990P,台積電群益96售13,0,0,0,0,0,0,0,0,0,-17000,0,0,0,20000,37000,-17000,-17000
060105,牧德元大9B購01  ,0,0,0,0,0,0,0,0,0,-17000,0,0,0,275000,292000,-17000,-17000
060007,鴻海群益99購04  ,0,0,0,0,0,0,0,0,0,-17000,0,0,0,14000,31000,-17000,-17000
060189,宏達電元富9B購03,0,0,0,0,0,0,0,0,0,-17000,0,0,0,118000,135000,-17000,-17000
060327,美律群益9A購02  ,0,0,0,0,0,0,0,0,0,-17000,0,0,0,38000,55000,-17000,-17000
060604,宏達電凱基9B購01,0,0,0,0,0,0,0,0,0,-17000,0,0,0,64000,81000,-17000,-17000
061406,華通國票9A購06  ,0,0,0,0,0,0,0,0,0,-17000,0,0,0,0,17000,-17000,-17000
061375,華通永豐9A購02  ,0,0,0,0,0,0,0,0,0,-17000,0,0,0,0,17000,-17000,-17000
057488,聯發科元大99購02,0,0,0,0,0,0,0,0,0,-17000,0,0,0,0,17000,-17000,-17000
057368,微星元大98購02  ,0,0,0,0,0,0,0,0,0,-17000,0,0,0,30000,47000,-17000,-17000
058042,鴻海元大98購12  ,0,0,0,0,0,0,0,0,0,-17000,0,0,0,14000,31000,-17000,-17000
058673,華新科群益9A購02,0,0,0,0,0,0,0,0,0,-17000,0,0,0,0,17000,-17000,-17000
07503P,禾伸堂元大9A售01,0,0,0,0,0,0,0,0,0,-17000,0,0,0,5000,22000,-17000,-17000
1460,宏遠            ,160000,177000,-17000,0,0,0,0,0,0,0,0,0,0,0,0,0,-17000
06748P,智邦台新98售02  ,0,0,0,0,0,0,0,0,0,-18000,0,0,0,0,18000,-18000,-18000
060535,群創麥證9A購01  ,0,0,0,0,18000,-18000,0,0,0,-18000,0,0,0,0,18000,-18000,-18000
060811,亞德客凱基9A購02,0,0,0,0,0,0,0,0,0,-18000,0,0,0,3000,21000,-18000,-18000
061015,旺宏麥證9A購03  ,0,0,0,6000,24000,-18000,0,0,0,-18000,0,0,0,6000,24000,-18000,-18000
060073,台積電元富99購03,0,0,0,0,0,0,0,0,0,-18000,0,0,0,0,18000,-18000,-18000
059884,鴻海國票99購09  ,0,0,0,0,0,0,0,0,0,-18000,0,0,0,2000,20000,-18000,-18000
059964,元金2X凱基99購02,0,0,0,0,0,0,0,0,0,-18000,0,0,0,0,18000,-18000,-18000
059197,可成永豐99購02  ,0,0,0,0,0,0,0,0,0,-18000,0,0,0,0,18000,-18000,-18000
059802,上証2X元富99購02,0,0,0,0,0,0,0,0,0,-18000,0,0,0,0,18000,-18000,-18000
05464P,華通康和95售02  ,0,0,0,0,0,0,0,0,0,-18000,0,0,0,10000,28000,-18000,-18000
050545,奇力新凱基95購01,0,0,0,0,0,0,0,0,0,-18000,0,0,0,2000,20000,-18000,-18000
058653,光寶科中信9A購01,0,0,0,0,0,0,0,0,0,-18000,0,0,0,24000,42000,-18000,-18000
059005,嘉晶元大99購06  ,0,0,0,0,0,0,0,0,0,-18000,0,0,0,42000,60000,-18000,-18000
058923,華新科元富99購06,0,0,0,0,0,0,0,0,0,-18000,0,0,0,26000,44000,-18000,-18000
058919,SGBR2X元富99購05,0,0,0,0,0,0,0,0,0,-18000,0,0,0,22000,40000,-18000,-18000
058938,台積電中信01購03,0,0,0,0,0,0,0,0,0,-18000,0,0,0,0,18000,-18000,-18000
057717,友訊元富98購02  ,0,0,0,0,0,0,0,0,0,-18000,0,0,0,287000,305000,-18000,-18000
055968,祥碩元大97購04  ,0,0,0,0,0,0,0,0,0,-18000,0,0,0,96000,114000,-18000,-18000
056721,台灣50永昌9A購01,0,0,0,0,0,0,0,0,0,-18000,0,0,0,0,18000,-18000,-18000
057448,致茂元富98購01  ,0,0,0,0,0,0,0,0,0,-18000,0,0,0,10000,28000,-18000,-18000
057279,國揚元大98購01  ,0,0,0,0,0,0,0,0,0,-18000,0,0,0,137000,155000,-18000,-18000
057920,奇力新凱基98購08,0,0,0,0,0,0,0,0,0,-18000,0,0,0,3000,21000,-18000,-18000
07552P,技嘉元大9A售03  ,0,0,0,0,0,0,0,0,0,-18000,0,0,0,1000,19000,-18000,-18000
06844P,智邦元大98售13  ,0,0,0,0,0,0,0,0,0,-18000,0,0,0,1000,19000,-18000,-18000
059771,台積電群益99購11,0,0,0,0,0,0,0,0,0,-19000,0,0,0,167000,186000,-19000,-19000
059739,華通元富99購04  ,0,0,0,0,0,0,0,0,0,-19000,0,0,0,0,19000,-19000,-19000
059488,大立光兆豐99購03,0,0,0,0,0,0,0,0,0,-19000,0,0,0,1000,20000,-19000,-19000
059142,道瓊指國票9B購02,0,0,0,0,0,0,0,0,0,-19000,0,0,0,1000,20000,-19000,-19000
060005,上銀群益99購03  ,0,0,0,0,0,0,0,0,0,-19000,0,0,0,258000,277000,-19000,-19000
060345,聯發科統一9B購05,0,0,0,0,0,0,0,0,0,-19000,0,0,0,2000,21000,-19000,-19000
060314,元翎永豐9A購01  ,0,0,0,0,0,0,0,0,0,-19000,0,0,0,47000,66000,-19000,-19000
061087,國巨統一01購04  ,0,0,0,0,0,0,0,0,0,-19000,0,0,0,241000,260000,-19000,-19000
060861,漢唐永豐9A購01  ,0,0,0,0,0,0,0,0,0,-19000,0,0,0,37000,56000,-19000,-19000
060656,國巨統一9C購03  ,0,0,0,0,0,0,0,0,0,-19000,0,0,0,2000,21000,-19000,-19000
06554P,臺股指元大99售06,0,0,0,0,0,0,0,0,0,-19000,0,0,0,0,19000,-19000,-19000
061480,泰碩元大9B購01  ,0,0,0,0,0,0,0,0,0,-19000,0,0,0,0,19000,-19000,-19000
00733,富邦臺灣中小    ,0,0,0,0,0,0,0,0,0,-19000,0,0,0,202000,221000,-19000,-19000
055336,茂林兆豐98購01  ,0,0,0,0,0,0,0,0,0,-19000,0,0,0,13000,32000,-19000,-19000
055176,大毅統一98購02  ,0,0,0,0,0,0,0,0,0,-19000,0,0,0,2000,21000,-19000,-19000
057341,技嘉台新98購01  ,0,0,0,0,0,0,0,0,0,-19000,0,0,0,0,19000,-19000,-19000
057612,瑞昱元富02購01  ,0,0,0,0,0,0,0,0,0,-19000,0,0,0,285000,304000,-19000,-19000
057087,台郡統一99購01  ,0,0,0,0,0,0,0,0,0,-19000,0,0,0,0,19000,-19000,-19000
05696P,南亞科凱基96售01,0,0,0,0,0,0,0,0,0,-19000,0,0,0,70000,89000,-19000,-19000
058878,旭富國泰9B購01  ,0,0,0,0,0,0,0,0,0,-19000,0,0,0,44000,63000,-19000,-19000
058485,智邦國票9A購01  ,0,0,0,0,0,0,0,0,0,-19000,0,0,0,0,19000,-19000,-19000
07715P,台灣50群益9A售14,0,0,0,0,0,0,0,0,0,-19000,0,0,0,120000,139000,-19000,-19000
1101B,台泥乙特        ,0,0,0,0,0,0,0,0,0,-19000,1000,20000,-19000,0,0,0,-19000
6192,巨路            ,47000,66000,-19000,0,0,0,0,0,0,0,0,0,0,0,0,0,-19000
061495,聯發科國票9B購01,35000,0,35000,0,0,0,0,0,0,-55000,0,0,0,0,55000,-55000,-20000
06135P,志超元富97售01  ,0,0,0,0,0,0,0,0,0,-20000,0,0,0,0,20000,-20000,-20000
061174,鴻海凱基9A購23  ,0,0,0,0,0,0,0,0,0,-20000,0,0,0,19000,39000,-20000,-20000
061248,健策群益9A購03  ,0,0,0,0,0,0,0,0,0,-20000,0,0,0,14000,34000,-20000,-20000
06479P,聯發科中信99售02,0,0,0,0,0,0,0,0,0,-20000,0,0,0,0,20000,-20000,-20000
06418P,T50反1統一9A售02,0,0,0,0,0,0,0,0,0,-20000,0,0,0,320000,340000,-20000,-20000
06474P,鴻海富邦98售03  ,0,0,0,0,0,0,0,0,0,-20000,0,0,0,0,20000,-20000,-20000
06230P,亞德客永豐97售03,0,0,0,0,0,0,0,0,0,-20000,0,0,0,0,20000,-20000,-20000
060620,玉晶光元大9A購04,0,0,0,0,0,0,0,0,0,-20000,0,0,0,0,20000,-20000,-20000
060551,大立光凱基9B購02,0,0,0,0,0,0,0,0,0,-20000,0,0,0,0,20000,-20000,-20000
060514,南電元大9A購02  ,0,0,0,0,0,0,0,0,0,-20000,0,0,0,5000,25000,-20000,-20000
060527,台積電中信9C購04,0,0,0,0,0,0,0,0,0,-20000,0,0,0,0,20000,-20000,-20000
061062,和大凱基9A購02  ,0,0,0,0,0,0,0,0,0,-20000,0,0,0,0,20000,-20000,-20000
060312,潤泰全永豐9A購01,0,0,0,0,0,0,0,0,0,-20000,0,0,0,0,20000,-20000,-20000
060162,碩天永豐9A購01  ,0,0,0,0,0,0,0,0,0,-20000,0,0,0,0,20000,-20000,-20000
060343,台積電統一9C購02,0,0,0,0,0,0,0,0,0,-20000,0,0,0,0,20000,-20000,-20000
060472,中租元大9A購02  ,0,0,0,0,0,0,0,0,0,-20000,0,0,0,30000,50000,-20000,-20000
060010,義隆群益99購02  ,0,0,0,0,0,0,0,0,0,-20000,0,0,0,17000,37000,-20000,-20000
059874,大立光凱基99購15,0,0,0,0,0,0,0,0,0,-20000,0,0,0,3000,23000,-20000,-20000
059124,台積電第一03購01,0,0,0,0,0,0,0,0,0,-20000,0,0,0,0,20000,-20000,-20000
059416,T50反1元大99購08,0,0,0,0,0,0,0,0,0,-20000,0,0,0,0,20000,-20000,-20000
059401,牧德元富99購01  ,0,0,0,0,0,0,0,0,0,-20000,0,0,0,242000,262000,-20000,-20000
059545,台灣50群益99購04,0,0,0,0,0,0,0,0,0,-20000,0,0,0,0,20000,-20000,-20000
059622,上銀凱基99購10  ,0,0,0,0,0,0,0,0,0,-20000,0,0,0,0,20000,-20000,-20000
055344,國巨凱基97購04  ,0,0,0,0,0,0,0,0,0,-20000,0,0,0,30000,50000,-20000,-20000
053688,燿華元大96購05  ,0,0,0,0,0,0,0,0,0,-20000,0,0,0,0,20000,-20000,-20000
053697,臻鼎元大96購02  ,0,0,0,0,0,0,0,0,0,-20000,0,0,0,0,20000,-20000,-20000
056546,致伸凱基98購01  ,0,0,0,0,0,0,0,0,0,-20000,0,0,0,0,20000,-20000,-20000
056500,大立光富邦9B購02,0,0,0,0,0,0,0,0,0,-20000,0,0,0,0,20000,-20000,-20000
055402,正文元富97購02  ,0,0,0,0,0,0,0,0,0,-20000,0,0,0,30000,50000,-20000,-20000
05545P,台表科國泰98售01,0,0,0,0,0,0,0,0,0,-20000,0,0,0,0,20000,-20000,-20000
054637,智邦中信98購01  ,0,0,0,0,0,0,0,0,0,-20000,0,0,0,0,20000,-20000,-20000
053136,彩晶國票97購01  ,0,0,0,0,0,0,0,0,0,-20000,0,0,0,0,20000,-20000,-20000
053123,京元電凱基96購01,0,0,0,0,0,0,0,0,0,-20000,0,0,0,0,20000,-20000,-20000
054544,統一中信97購01  ,0,0,0,0,0,0,0,0,0,-20000,0,0,0,0,20000,-20000,-20000
053609,華新中信9A購01  ,0,0,0,0,0,0,0,0,0,-20000,0,0,0,0,20000,-20000,-20000
053380,南亞科元大97購01,0,0,0,0,0,0,0,0,0,-20000,0,0,0,0,20000,-20000,-20000
053438,玉晶光麥證97購02,0,0,0,0,20000,-20000,0,0,0,-20000,0,0,0,0,20000,-20000,-20000
054915,興勤凱基97購01  ,0,0,0,0,0,0,0,0,0,-20000,0,0,0,0,20000,-20000,-20000
054403,同欣電永豐96購02,0,0,0,0,0,0,0,0,0,-20000,0,0,0,0,20000,-20000,-20000
054896,聯茂日盛97購01  ,0,0,0,0,0,0,0,0,0,-20000,0,0,0,0,20000,-20000,-20000
052968,燿華群益98購01  ,0,0,0,0,0,0,0,0,0,-20000,0,0,0,0,20000,-20000,-20000
052867,晶技凱基96購01  ,0,0,0,0,0,0,0,0,0,-20000,0,0,0,0,20000,-20000,-20000
053854,聯茂國泰97購02  ,0,0,0,0,0,0,0,0,0,-20000,0,0,0,0,20000,-20000,-20000
053836,亞光永豐96購02  ,0,0,0,0,0,0,0,0,0,-20000,0,0,0,13000,33000,-20000,-20000
053774,台達電元大96購04,0,0,0,0,0,0,0,0,0,-20000,0,0,0,0,20000,-20000,-20000
053760,牧德國泰98購01  ,0,0,0,0,0,0,0,0,0,-20000,0,0,0,0,20000,-20000,-20000
054215,創意國票97購02  ,0,0,0,0,0,0,0,0,0,-20000,0,0,0,0,20000,-20000,-20000
052717,正文凱基96購01  ,0,0,0,0,0,0,0,0,0,-20000,0,0,0,0,20000,-20000,-20000
054152,漢唐國泰98購02  ,0,0,0,0,0,0,0,0,0,-20000,0,0,0,0,20000,-20000,-20000
052825,TPK永豐96購01   ,0,0,0,0,0,0,0,0,0,-20000,0,0,0,0,20000,-20000,-20000
04436P,聯發科中信96售02,0,0,0,0,0,0,0,0,0,-20000,0,0,0,0,20000,-20000,-20000
03670C,元油2X元富99牛01,0,0,0,0,0,0,0,0,0,-20000,0,0,0,0,20000,-20000,-20000
053948,大立光富邦99購04,0,0,0,0,0,0,0,0,0,-20000,0,0,0,0,20000,-20000,-20000
052600,力山元大97購01  ,0,0,0,0,0,0,0,0,0,-20000,0,0,0,0,20000,-20000,-20000
052304,可成永豐95購03  ,0,0,0,0,0,0,0,0,0,-20000,0,0,0,0,20000,-20000,-20000
052263,聯電亞東95購01  ,0,0,0,0,0,0,0,0,0,-20000,0,0,0,0,20000,-20000,-20000
051510,新光金中信97購01,0,0,0,0,0,0,0,0,0,-20000,0,0,0,0,20000,-20000,-20000
051403,玉晶光永豐95購05,0,0,0,0,0,0,0,0,0,-20000,0,0,0,10000,30000,-20000,-20000
050867,聯鈞永豐95購01  ,0,0,0,0,0,0,0,0,0,-20000,0,0,0,0,20000,-20000,-20000
051277,聯發科中信9A購01,0,0,0,0,0,0,0,0,0,-20000,0,0,0,0,20000,-20000,-20000
052055,緯穎凱基95購03  ,0,0,0,0,0,0,0,0,0,-20000,0,0,0,0,20000,-20000,-20000
052112,滬深2X中信99購01,0,0,0,0,0,0,0,0,0,-20000,0,0,0,0,20000,-20000,-20000
052173,廣達元大95購02  ,0,0,0,0,0,0,0,0,0,-20000,0,0,0,68000,88000,-20000,-20000
051320,燿華國票96購01  ,0,0,0,0,0,0,0,0,0,-20000,0,0,0,0,20000,-20000,-20000
057996,臻鼎中信98購01  ,0,0,0,0,0,0,0,0,0,-20000,0,0,0,0,20000,-20000,-20000
057983,緯穎永豐98購03  ,0,0,0,0,0,0,0,0,0,-20000,0,0,0,0,20000,-20000,-20000
057792,群創統一99購01  ,0,0,0,0,0,0,0,0,0,-20000,0,0,0,30000,50000,-20000,-20000
058623,國巨國票99購08  ,0,0,0,0,0,0,0,0,0,-20000,0,0,0,0,20000,-20000,-20000
058780,牧德國票9A購01  ,0,0,0,0,0,0,0,0,0,-20000,0,0,0,22000,42000,-20000,-20000
058718,台灣50元富03購01,0,0,0,0,0,0,0,0,0,-20000,0,0,0,0,20000,-20000,-20000
058916,SGBR2X元富99購02,0,0,0,0,0,0,0,0,0,-20000,0,0,0,15000,35000,-20000,-20000
056981,全新群益99購03  ,0,0,0,0,0,0,0,0,0,-20000,0,0,0,138000,158000,-20000,-20000
056992,祥碩兆豐98購01  ,0,0,0,0,0,0,0,0,0,-20000,0,0,0,0,20000,-20000,-20000
057703,矽力群益98購01  ,0,0,0,0,0,0,0,0,0,-20000,0,0,0,0,20000,-20000,-20000
057078,國巨統一9A購02  ,0,0,0,0,0,0,0,0,0,-20000,0,0,0,0,20000,-20000,-20000
057068,國巨永豐98購06  ,0,0,0,0,0,0,0,0,0,-20000,0,0,0,0,20000,-20000,-20000
056166,微星台新97購01  ,0,0,0,0,0,0,0,0,0,-20000,0,0,0,0,20000,-20000,-20000
056252,聯發科兆豐97購03,0,0,0,0,0,0,0,0,0,-20000,0,0,0,0,20000,-20000,-20000
056379,玉晶光元富98購01,0,0,0,0,0,0,0,0,0,-20000,0,0,0,0,20000,-20000,-20000
056342,中工凱基98購01  ,0,0,0,0,0,0,0,0,0,-20000,0,0,0,0,20000,-20000,-20000
056317,華通群益99購02  ,0,0,0,0,0,0,0,0,0,-20000,0,0,0,0,20000,-20000,-20000
056457,嘉澤凱基98購01  ,0,0,0,0,0,0,0,0,0,-20000,0,0,0,0,20000,-20000,-20000
057659,台表科兆豐98購01,0,0,0,0,0,0,0,0,0,-20000,0,0,0,437000,457000,-20000,-20000
057342,玉晶光台新98購01,0,0,0,0,0,0,0,0,0,-20000,0,0,0,0,20000,-20000,-20000
057472,T50正2元大9B購03,0,0,0,0,0,0,0,0,0,-20000,0,0,0,0,20000,-20000,-20000
057452,新日興元富98購01,0,0,0,0,0,0,0,0,0,-20000,0,0,0,10000,30000,-20000,-20000
055548,旺宏凱基97購02  ,0,0,0,0,0,0,0,0,0,-20000,0,0,0,0,20000,-20000,-20000
055516,上銀中信97購01  ,0,0,0,0,0,0,0,0,0,-20000,0,0,0,1500000,1520000,-20000,-20000
055517,國巨中信97購03  ,0,0,0,0,0,0,0,0,0,-20000,0,0,0,0,20000,-20000,-20000
057171,台光電元大9B購01,0,0,0,0,0,0,0,0,0,-20000,0,0,0,15000,35000,-20000,-20000
054996,聯陽元富97購01  ,0,0,0,0,0,0,0,0,0,-20000,0,0,0,0,20000,-20000,-20000
055104,台達電凱基98購01,0,0,0,0,0,0,0,0,0,-20000,0,0,0,0,20000,-20000,-20000
055107,旺宏凱基98購04  ,0,0,0,0,0,0,0,0,0,-20000,0,0,0,0,20000,-20000,-20000
055797,華通富邦98購01  ,0,0,0,0,0,0,0,0,0,-20000,0,0,0,0,20000,-20000,-20000
056820,欣興永豐98購02  ,0,0,0,0,0,0,0,0,0,-20000,0,0,0,0,20000,-20000,-20000
056830,友達富邦99購01  ,0,0,0,0,0,0,0,0,0,-20000,0,0,0,0,20000,-20000,-20000
057869,大立光凱基99購01,0,0,0,0,0,0,0,0,0,-20000,0,0,0,0,20000,-20000,-20000
058157,華通台新99購01  ,0,0,0,0,0,0,0,0,0,-20000,0,0,0,730000,750000,-20000,-20000
07728P,臺股指凱基9A售20,0,0,0,0,0,0,0,0,0,-20000,0,0,0,0,20000,-20000,-20000
07761P,智邦永豐9A售03  ,0,0,0,0,0,0,0,0,0,-20000,0,0,0,15000,35000,-20000,-20000
06773P,台灣50兆豐9A售01,0,0,0,0,0,0,0,0,0,-20000,0,0,0,0,20000,-20000,-20000
06891P,緯穎富邦99售03  ,0,0,0,0,0,0,0,0,0,-20000,0,0,0,0,20000,-20000,-20000
07281P,鴻海凱基99售13  ,0,0,0,0,0,0,0,0,0,-20000,0,0,0,30000,50000,-20000,-20000
07283P,華新科凱基99售07,0,0,0,0,0,0,0,0,0,-20000,0,0,0,0,20000,-20000,-20000
07193P,聯發科元大99售24,0,0,0,0,0,0,0,0,0,-20000,0,0,0,0,20000,-20000,-20000
07055P,景碩群益9A售02  ,0,0,0,0,0,0,0,0,0,-20000,0,0,0,0,20000,-20000,-20000
07512P,國巨元大9A售08  ,0,0,0,0,0,0,0,0,0,-20000,0,0,0,40000,60000,-20000,-20000
07618P,大立光中信9A售06,0,0,0,0,0,0,0,0,0,-20000,0,0,0,30000,50000,-20000,-20000
07701P,玉晶光第一9A售02,0,0,0,0,0,0,0,0,0,-20000,0,0,0,0,20000,-20000,-20000
07335P,臺股指國票99售20,0,0,0,0,0,0,0,0,0,-20000,0,0,0,0,20000,-20000,-20000
059586,上銀元大9A購02  ,0,0,0,0,0,0,0,0,0,-21000,0,0,0,0,21000,-21000,-21000
059363,超眾永豐99購02  ,0,0,0,0,0,0,0,0,0,-21000,0,0,0,4000,25000,-21000,-21000
059222,聯發科元大99購22,0,0,0,0,0,0,0,0,0,-21000,0,0,0,315000,336000,-21000,-21000
060226,道瓊反元大9A購01,0,0,0,0,0,0,0,0,0,-21000,0,0,0,1000,22000,-21000,-21000
061058,健策國票9A購05  ,0,0,0,0,0,0,0,0,0,-21000,0,0,0,25000,46000,-21000,-21000
060881,玉山金中信02購01,0,0,0,0,0,0,0,0,0,-21000,0,0,0,29000,50000,-21000,-21000
060680,玉晶光元大9C購03,0,0,0,0,0,0,0,0,0,-21000,0,0,0,55000,76000,-21000,-21000
06468P,華新科統一98售02,0,0,0,0,0,0,0,0,0,-21000,0,0,0,0,21000,-21000,-21000
061140,華擎統一9C購01  ,0,0,0,0,0,0,0,0,0,-21000,0,0,0,1000,22000,-21000,-21000
03418B,臺股指元大95熊20,0,0,0,0,0,0,0,0,0,-21000,0,0,0,0,21000,-21000,-21000
047673,瑞昱元富96購01  ,0,0,0,0,0,0,0,0,0,-21000,0,0,0,51000,72000,-21000,-21000
00672L,元大S&P原油正2  ,0,20000,-20000,0,0,0,0,0,0,-1000,0,0,0,285000,286000,-1000,-21000
053443,智邦凱基97購01  ,0,0,0,0,0,0,0,0,0,-21000,0,0,0,0,21000,-21000,-21000
053398,和鑫中信99購01  ,0,0,0,0,0,0,0,0,0,-21000,0,0,0,0,21000,-21000,-21000
057895,全新元富9B購01  ,0,0,0,0,0,0,0,0,0,-21000,0,0,0,0,21000,-21000,-21000
055512,聯詠兆豐97購01  ,0,0,0,0,0,0,0,0,0,-21000,0,0,0,0,21000,-21000,-21000
057407,超眾群益99購01  ,0,0,0,0,0,0,0,0,0,-21000,0,0,0,11000,32000,-21000,-21000
056274,彩晶統一98購02  ,0,0,0,0,0,0,0,0,0,-21000,0,0,0,0,21000,-21000,-21000
056183,南亞科統一97購02,0,0,0,0,0,0,0,0,0,-21000,0,0,0,160000,181000,-21000,-21000
058956,健策國票9A購02  ,0,0,0,0,0,0,0,0,0,-21000,0,0,0,0,21000,-21000,-21000
058963,華新科兆豐99購05,0,0,0,0,0,0,0,0,0,-21000,0,0,0,243000,264000,-21000,-21000
059037,宏達電群益99購02,0,0,0,0,0,0,0,0,0,-21000,0,0,0,37000,58000,-21000,-21000
058579,聯發科群益99購04,0,0,0,0,0,0,0,0,0,-21000,0,0,0,0,21000,-21000,-21000
07473P,祥碩元大9A售01  ,0,0,0,0,0,0,0,0,0,-21000,0,0,0,113000,134000,-21000,-21000
07524P,臺股指中信9B售06,0,0,0,0,0,0,0,0,0,-21000,0,0,0,0,21000,-21000,-21000
07046P,大立光富邦9C售03,0,0,0,0,0,0,0,0,0,-21000,0,0,0,0,21000,-21000,-21000
06953P,景碩統一9A售01  ,0,0,0,0,0,0,0,0,0,-21000,0,0,0,0,21000,-21000,-21000
2476,鉅祥            ,20000,41000,-21000,0,0,0,0,0,0,0,0,0,0,0,0,0,-21000
2477,美隆電          ,35000,56000,-21000,0,0,0,0,0,0,0,0,0,0,0,0,0,-21000
061339,京元電元大9A購05,0,0,0,0,0,0,0,0,0,-22000,0,0,0,71000,93000,-22000,-22000
061293,聯茂統一9A購01  ,0,0,0,0,0,0,0,0,0,-22000,0,0,0,45000,67000,-22000,-22000
060694,旺宏麥證9A購02  ,0,0,0,0,22000,-22000,0,0,0,-22000,0,0,0,0,22000,-22000,-22000
060622,玉晶光元大9B購02,0,0,0,0,0,0,0,0,0,-22000,0,0,0,10000,32000,-22000,-22000
060399,康友國票9A購02  ,0,0,0,0,0,0,0,0,0,-22000,0,0,0,16000,38000,-22000,-22000
059886,可成國票99購04  ,0,0,0,0,0,0,0,0,0,-22000,0,0,0,15000,37000,-22000,-22000
060104,新日興元大99購03,0,0,0,0,0,0,0,0,0,-22000,0,0,0,2000,24000,-22000,-22000
056573,華新科元大99購06,0,0,0,0,0,0,0,0,0,-22000,0,0,0,70000,92000,-22000,-22000
053718,全新凱基97購02  ,0,0,0,0,0,0,0,0,0,-22000,0,0,0,0,22000,-22000,-22000
052990,超眾元大97購01  ,0,0,0,0,0,0,0,0,0,-22000,0,0,0,2000,24000,-22000,-22000
054792,揚明光群益97購01,0,0,0,0,0,0,0,0,0,-22000,0,0,0,98000,120000,-22000,-22000
00709,富邦歐洲        ,0,0,0,0,0,0,0,0,0,-22000,0,0,0,100000,122000,-22000,-22000
049501,台郡元大95購01  ,0,0,0,0,0,0,0,0,0,-22000,0,0,0,99000,121000,-22000,-22000
052614,聯電國泰97購01  ,0,0,0,0,0,0,0,0,0,-22000,0,0,0,30000,52000,-22000,-22000
052599,S&P反1元大96購01,0,0,0,0,0,0,0,0,0,-22000,0,0,0,3000,25000,-22000,-22000
058545,義隆富邦9C購01  ,0,0,0,0,0,0,0,0,0,-22000,0,0,0,11000,33000,-22000,-22000
058793,鴻海元大99購19  ,0,0,0,0,0,0,0,0,0,-22000,0,0,0,17000,39000,-22000,-22000
05621P,聯電中信96售01  ,0,0,0,0,0,0,0,0,0,-22000,0,0,0,0,22000,-22000,-22000
056228,可成凱基97購03  ,0,0,0,0,0,0,0,0,0,-22000,0,0,0,0,22000,-22000,-22000
056441,燿華凱基98購01  ,0,0,0,0,0,0,0,0,0,-22000,0,0,0,90000,112000,-22000,-22000
056135,緯創元大98購01  ,0,0,0,0,0,0,0,0,0,-22000,0,0,0,16000,38000,-22000,-22000
057386,聯發科永豐98購04,0,0,0,0,0,0,0,0,0,-22000,0,0,0,10000,32000,-22000,-22000
058037,台灣50元大9B購02,0,0,0,0,0,0,0,0,0,-22000,0,0,0,0,22000,-22000,-22000
058457,創意永豐99購01  ,0,0,0,0,0,0,0,0,0,-22000,0,0,0,20000,42000,-22000,-22000
058144,聯茂元大99購02  ,0,0,0,0,0,0,0,0,0,-22000,0,0,0,2000,24000,-22000,-22000
058249,緯穎元大99購04  ,0,0,0,0,0,0,0,0,0,-22000,0,0,0,3000,25000,-22000,-22000
055235,金寶台新98購01  ,0,0,0,0,0,0,0,0,0,-22000,0,0,0,328000,350000,-22000,-22000
07145P,為升元大99售03  ,0,0,0,0,0,0,0,0,0,-22000,0,0,0,0,22000,-22000,-22000
07392P,台積電國泰02售01,0,0,0,0,0,0,0,0,0,-22000,0,0,0,10000,32000,-22000,-22000
060085,華通元大99購10  ,0,0,0,0,0,0,0,0,0,-23000,0,0,0,116000,139000,-23000,-23000
059635,華新科凱基9A購06,0,0,0,0,0,0,0,0,0,-23000,0,0,0,6000,29000,-23000,-23000
060642,華擎永豐9A購02  ,0,0,0,0,0,0,0,0,0,-23000,0,0,0,247000,270000,-23000,-23000
060586,玉晶光元富9A購03,0,0,0,0,0,0,0,0,0,-23000,0,0,0,0,23000,-23000,-23000
061363,儒鴻國票9B購01  ,0,0,0,0,0,0,0,0,0,-23000,0,0,0,10000,33000,-23000,-23000
061455,京元電凱基9B購01,0,0,0,0,0,0,0,0,0,-23000,0,0,0,0,23000,-23000,-23000
06752P,訊芯凱基98售05  ,0,0,0,0,0,0,0,0,0,-23000,0,0,0,55000,78000,-23000,-23000
051286,國巨統一97購01  ,0,0,0,0,0,0,0,0,0,-23000,0,0,0,506000,529000,-23000,-23000
051717,祥碩康和95購01  ,0,0,0,0,0,0,0,0,0,-23000,0,0,0,0,23000,-23000,-23000
048627,T50反1元大96購02,0,0,0,0,0,0,0,0,0,-23000,0,0,0,0,23000,-23000,-23000
054355,上海銀富邦98購01,0,0,0,0,0,0,0,0,0,-23000,0,0,0,0,23000,-23000,-23000
053137,旺宏富邦98購01  ,0,0,0,0,0,0,0,0,0,-23000,0,0,0,0,23000,-23000,-23000
057878,台郡元大99購04  ,0,0,0,0,0,0,0,0,0,-23000,0,0,0,0,23000,-23000,-23000
056705,超眾國泰99購01  ,0,0,0,0,0,0,0,0,0,-23000,0,0,0,29000,52000,-23000,-23000
05551P,電子類元大96售01,0,0,0,0,0,0,0,0,0,-23000,0,0,0,2000,25000,-23000,-23000
056264,聯發科統一98購02,0,0,0,0,0,0,0,0,0,-23000,0,0,0,14000,37000,-23000,-23000
058981,國巨凱基99購10  ,0,0,0,0,0,0,0,0,0,-23000,0,0,0,204000,227000,-23000,-23000
058477,億光凱基9A購01  ,0,0,0,0,0,0,0,0,0,-23000,0,0,0,1000,24000,-23000,-23000
06955P,臻鼎元富99售01  ,0,0,0,0,0,0,0,0,0,-23000,0,0,0,0,23000,-23000,-23000
06908P,健策國泰99售02  ,0,0,0,0,0,0,0,0,0,-23000,0,0,0,55000,78000,-23000,-23000
06900P,FBVIX國票12售01 ,0,0,0,0,0,0,0,0,0,-23000,0,0,0,10000,33000,-23000,-23000
06686P,麗豐永豐98售02  ,0,0,0,0,0,0,0,0,0,-24000,0,0,0,0,24000,-24000,-24000
061405,亞德客國票9B購01,0,0,0,0,0,0,0,0,0,-24000,0,0,0,9000,33000,-24000,-24000
061412,儒鴻群益9A購01  ,0,0,0,0,0,0,0,0,0,-24000,0,0,0,0,24000,-24000,-24000
061425,華新科元大9A購19,0,0,0,0,0,0,0,0,0,-24000,0,0,0,3000,27000,-24000,-24000
061360,智邦兆豐9B購02  ,0,0,0,0,0,0,0,0,0,-24000,0,0,0,16000,40000,-24000,-24000
061195,健策永豐9B購02  ,0,0,0,0,0,0,0,0,0,-24000,0,0,0,3000,27000,-24000,-24000
061043,百和永豐9A購01  ,0,0,0,0,0,0,0,0,0,-24000,0,0,0,61000,85000,-24000,-24000
059633,聯發科凱基9A購07,0,0,0,0,0,0,0,0,0,-24000,0,0,0,25000,49000,-24000,-24000
059619,台積電日盛9A購04,0,0,0,0,0,0,0,0,0,-24000,0,0,0,79000,103000,-24000,-24000
059302,大立光群益99購08,0,0,0,0,0,0,0,0,0,-24000,0,0,0,10000,34000,-24000,-24000
059891,臺股指國票99購25,0,0,0,0,0,0,0,0,0,-24000,0,0,0,0,24000,-24000,-24000
060297,和碩元大9A購02  ,0,0,0,0,0,0,0,0,0,-24000,0,0,0,116000,140000,-24000,-24000
054890,聯鈞統一99購01  ,0,0,0,0,0,0,0,0,0,-24000,0,0,0,19000,43000,-24000,-24000
050894,旺宏元大96購03  ,0,0,0,0,0,0,0,0,0,-24000,0,0,0,11000,35000,-24000,-24000
053886,亞光兆豐96購01  ,0,0,0,0,0,0,0,0,0,-24000,0,0,0,31000,55000,-24000,-24000
057378,康友元大98購02  ,0,0,0,0,0,0,0,0,0,-24000,0,0,0,26000,50000,-24000,-24000
055689,台郡凱基99購01  ,0,0,0,0,0,0,0,0,0,-24000,0,0,0,0,24000,-24000,-24000
058043,鴻海元大98購13  ,0,0,0,0,0,0,0,0,0,-24000,0,0,0,48000,72000,-24000,-24000
058046,國巨元大9A購01  ,0,0,0,0,0,0,0,0,0,-24000,0,0,0,6000,30000,-24000,-24000
058455,玉晶光永豐99購03,0,0,0,0,0,0,0,0,0,-24000,0,0,0,0,24000,-24000,-24000
055073,易華電永豐97購01,0,0,0,0,0,0,0,0,0,-24000,0,0,0,0,24000,-24000,-24000
07710P,華擎元大9A售05  ,0,0,0,0,0,0,0,0,0,-24000,0,0,0,10000,34000,-24000,-24000
9942,茂順            ,22000,46000,-24000,0,0,0,0,0,0,0,0,0,0,0,0,0,-24000
060256,臺股指元大9B購07,0,0,0,0,0,0,0,0,0,-25000,0,0,0,0,25000,-25000,-25000
060195,旭富元富9A購02  ,0,0,0,0,0,0,0,0,0,-25000,0,0,0,10000,35000,-25000,-25000
059854,台表科永豐99購03,0,0,0,0,0,0,0,0,0,-25000,0,0,0,3000,28000,-25000,-25000
059950,百和永豐99購02  ,0,0,0,0,0,0,0,0,0,-25000,0,0,0,24000,49000,-25000,-25000
060087,鴻海元大99購43  ,0,0,0,0,0,0,0,0,0,-25000,0,0,0,0,25000,-25000,-25000
059276,可成元大99購06  ,0,0,0,0,0,0,0,0,0,-25000,0,0,0,82000,107000,-25000,-25000
059357,華通永豐99購01  ,0,0,0,0,0,0,0,0,0,-25000,0,0,0,3000,28000,-25000,-25000
059818,鴻海凱基99購14  ,0,0,0,0,0,0,0,0,0,-25000,0,0,0,0,25000,-25000,-25000
060758,台積電元大9A購19,0,0,0,0,0,0,0,0,0,-25000,0,0,0,43000,68000,-25000,-25000
061263,微星凱基9A購01  ,0,0,0,0,0,0,0,0,0,-25000,0,0,0,0,25000,-25000,-25000
061322,華新科凱基9A購12,0,0,0,0,0,0,0,0,0,-25000,0,0,0,61000,86000,-25000,-25000
061423,廣達元大9A購01  ,0,0,0,0,0,0,0,0,0,-25000,0,0,0,0,25000,-25000,-25000
061448,旺宏中信9A購02  ,0,0,0,0,0,0,0,0,0,-25000,0,0,0,0,25000,-25000,-25000
06668P,祥碩凱基98售02  ,0,0,0,0,0,0,0,0,0,-25000,0,0,0,16000,41000,-25000,-25000
051402,玉晶光永豐95購04,0,0,0,0,0,0,0,0,0,-25000,0,0,0,0,25000,-25000,-25000
052305,GIS永豐95購03   ,0,0,0,0,0,0,0,0,0,-25000,0,0,0,0,25000,-25000,-25000
051078,力山富邦97購01  ,0,0,0,0,0,0,0,0,0,-25000,0,0,0,1000,26000,-25000,-25000
048788,華新科元大95購02,0,0,0,0,0,0,0,0,0,-25000,0,0,0,5000,30000,-25000,-25000
02001R,富邦蘋果反一N   ,0,0,0,0,0,0,0,0,0,-25000,0,0,0,60000,85000,-25000,-25000
049335,聯電統一97購01  ,0,0,0,0,0,0,0,0,0,-25000,0,0,0,10000,35000,-25000,-25000
035277,景碩台新97購01  ,0,0,0,0,0,0,0,0,0,-25000,0,0,0,0,25000,-25000,-25000
054167,揚明光凱基98購01,0,0,0,0,0,0,0,0,0,-25000,0,0,0,20000,45000,-25000,-25000
053396,漢唐中信9A購01  ,0,0,0,0,0,0,0,0,0,-25000,0,0,0,0,25000,-25000,-25000
053728,茂林凱基97購01  ,0,0,0,0,0,0,0,0,0,-25000,0,0,0,1000,26000,-25000,-25000
057490,可成元大98購10  ,0,0,0,0,0,0,0,0,0,-25000,0,0,0,0,25000,-25000,-25000
058309,大毅元大99購02  ,0,0,0,0,0,0,0,0,0,-25000,0,0,0,78000,103000,-25000,-25000
058446,新光金富邦9C購01,0,0,0,0,0,0,0,0,0,-25000,0,0,0,0,25000,-25000,-25000
057572,明泰永豐98購01  ,0,0,0,0,0,0,0,0,0,-25000,0,0,0,50000,75000,-25000,-25000
057132,華新科凱基98購05,0,0,0,0,0,0,0,0,0,-25000,0,0,0,0,25000,-25000,-25000
058735,南茂永豐99購01  ,0,0,0,0,0,0,0,0,0,-25000,0,0,0,100000,125000,-25000,-25000
057083,立積統一98購01  ,0,0,0,0,0,0,0,0,0,-25000,0,0,0,0,25000,-25000,-25000
056922,全新兆豐99購01  ,0,0,0,0,0,0,0,0,0,-25000,0,0,0,0,25000,-25000,-25000
055842,建準元大98購01  ,0,0,0,0,0,0,0,0,0,-25000,0,0,0,30000,55000,-25000,-25000
07644P,南電凱基9A售03  ,0,0,0,0,0,0,0,0,0,-25000,0,0,0,5000,30000,-25000,-25000
07365P,超眾元大99售07  ,0,0,0,0,0,0,0,0,0,-25000,0,0,0,0,25000,-25000,-25000
06868P,電子類元大99售01,0,0,0,0,0,0,0,0,0,-25000,0,0,0,0,25000,-25000,-25000
07289P,台灣50凱基99售07,0,0,0,0,0,0,0,0,0,-25000,0,0,0,0,25000,-25000,-25000
07276P,臺股指群益99售19,0,0,0,0,0,0,0,0,0,-25000,0,0,0,54000,79000,-25000,-25000
1467,南緯            ,70000,95000,-25000,0,0,0,0,0,0,0,0,0,0,0,0,0,-25000
00771,元大US高息特別股,0,0,0,0,0,0,0,0,0,-25941,0,0,0,100059,126000,-25941,-25941
059727,大立光元大9A購01,0,0,0,0,0,0,0,0,0,-26000,0,0,0,5000,31000,-26000,-26000
059610,上銀永豐99購02  ,0,0,0,0,0,0,0,0,0,-26000,0,0,0,87000,113000,-26000,-26000
060080,台灣50元大02購01,0,0,0,0,0,0,0,0,0,-26000,0,0,0,5000,31000,-26000,-26000
060145,牧德國票9A購02  ,0,0,0,0,0,0,0,0,0,-26000,0,0,0,25000,51000,-26000,-26000
060406,瑞祺國泰9B購01  ,0,0,0,0,0,0,0,0,0,-26000,0,0,0,47000,73000,-26000,-26000
051381,玉晶光群益98購01,0,0,0,0,0,0,0,0,0,-26000,0,0,0,14000,40000,-26000,-26000
056625,致伸永豐98購01  ,0,0,0,0,0,0,0,0,0,-26000,0,0,0,20000,46000,-26000,-26000
054760,台化國票9A購01  ,0,0,0,0,0,0,0,0,0,-26000,0,0,0,0,26000,-26000,-26000
058959,南茂國票9A購01  ,0,0,0,0,0,0,0,0,0,-26000,0,0,0,44000,70000,-26000,-26000
058940,聯發科中信9A購03,0,0,0,0,0,0,0,0,0,-26000,0,0,0,0,26000,-26000,-26000
058911,茂林元大99購04  ,0,0,0,0,0,0,0,0,0,-26000,0,0,0,210000,236000,-26000,-26000
057931,正崴群益98購02  ,0,0,0,0,0,0,0,0,0,-26000,0,0,0,30000,56000,-26000,-26000
058080,台積電群益98購06,0,0,0,0,0,0,0,0,0,-26000,0,0,0,38000,64000,-26000,-26000
056736,國巨凱基99購03  ,0,0,0,0,0,0,0,0,0,-26000,0,0,0,53000,79000,-26000,-26000
07404P,華新科凱基99售10,0,0,0,0,0,0,0,0,0,-26000,0,0,0,31000,57000,-26000,-26000
060401,世紀鋼國票9B購01,0,0,0,0,0,0,0,0,0,-27000,0,0,0,12000,39000,-27000,-27000
059913,台積電元大99購44,0,0,0,0,0,0,0,0,0,-27000,0,0,0,20000,47000,-27000,-27000
059772,可成群益9A購05  ,0,0,0,0,0,0,0,0,0,-27000,0,0,0,17000,44000,-27000,-27000
059275,可成元大99購05  ,0,0,0,0,0,0,0,0,0,-27000,0,0,0,33000,60000,-27000,-27000
061162,南電群益9A購02  ,0,0,0,0,0,0,0,0,0,-27000,0,0,0,11000,38000,-27000,-27000
060769,國巨麥證9A購02  ,0,0,0,0,27000,-27000,0,0,0,-27000,0,0,0,0,27000,-27000,-27000
060675,南亞科元大9A購02,0,0,0,0,0,0,0,0,0,-27000,0,0,0,0,27000,-27000,-27000
060536,祥碩麥證9A購01  ,0,0,0,75000,102000,-27000,0,0,0,-27000,0,0,0,75000,102000,-27000,-27000
060917,台表科國泰9B購01,0,0,0,0,0,0,0,0,0,-27000,0,0,0,63000,90000,-27000,-27000
054588,玉晶光國泰99購02,0,0,0,0,0,0,0,0,0,-27000,0,0,0,0,27000,-27000,-27000
057533,晶相光元大98購02,0,0,0,0,0,0,0,0,0,-27000,0,0,0,210000,237000,-27000,-27000
051660,緯穎國泰96購02  ,0,0,0,0,0,0,0,0,0,-27000,0,0,0,0,27000,-27000,-27000
05238P,禾伸堂永豐95售01,0,0,0,0,0,0,0,0,0,-27000,0,0,0,0,27000,-27000,-27000
051531,國巨國票96購04  ,0,0,0,0,0,0,0,0,0,-27000,0,0,0,81000,108000,-27000,-27000
057363,華通元大99購02  ,0,0,0,0,0,0,0,0,0,-27000,0,0,0,33000,60000,-27000,-27000
058362,聯發科凱基99購06,0,0,0,0,0,0,0,0,0,-27000,0,0,0,10000,37000,-27000,-27000
057925,貿聯凱基99購01  ,0,0,0,0,0,0,0,0,0,-27000,0,0,0,0,27000,-27000,-27000
056330,玉晶光國票99購03,0,0,0,0,0,0,0,0,0,-27000,0,0,0,0,27000,-27000,-27000
056856,華通群益9A購01  ,0,0,0,0,0,0,0,0,0,-27000,0,0,0,35000,62000,-27000,-27000
07369P,台積電凱基99售20,0,0,0,0,0,0,0,0,0,-27000,0,0,0,0,27000,-27000,-27000
07646P,世芯元大9A售04  ,0,0,0,0,0,0,0,0,0,-27000,0,0,0,31000,58000,-27000,-27000
07648P,祥碩國票9B售01  ,0,0,0,0,0,0,0,0,0,-27000,0,0,0,3000,30000,-27000,-27000
06888P,日月光元大98售02,0,0,0,0,0,0,0,0,0,-27000,0,0,0,4000,31000,-27000,-27000
2509,全坤建          ,14000,41000,-27000,0,0,0,0,0,0,0,0,0,0,0,0,0,-27000
050786,健策國泰96購01  ,0,0,0,0,0,0,0,0,0,-28000,0,0,0,0,28000,-28000,-28000
047024,奇力新元大95購01,0,0,0,0,0,0,0,0,0,-28000,0,0,0,10000,38000,-28000,-28000
053494,南亞科兆豐96購02,0,0,0,0,0,0,0,0,0,-28000,0,0,0,8000,36000,-28000,-28000
054075,GIS富邦97購02   ,0,0,0,0,0,0,0,0,0,-28000,0,0,0,122000,150000,-28000,-28000
058555,矽創永豐9A購01  ,0,0,0,0,0,0,0,0,0,-28000,0,0,0,51000,79000,-28000,-28000
059022,聯發科統一9B購04,0,0,0,0,0,0,0,0,0,-28000,0,0,0,0,28000,-28000,-28000
058770,貿聯兆豐9A購01  ,0,0,0,0,0,0,0,0,0,-28000,0,0,0,0,28000,-28000,-28000
057888,貿聯群益98購02  ,0,0,0,0,0,0,0,0,0,-28000,0,0,0,26000,54000,-28000,-28000
058143,瑞儀元大99購02  ,0,0,0,0,0,0,0,0,0,-28000,0,0,0,146000,174000,-28000,-28000
055732,全新元富9A購01  ,0,0,0,0,0,0,0,0,0,-28000,0,0,0,0,28000,-28000,-28000
055604,訊芯元大98購02  ,0,0,0,0,0,0,0,0,0,-28000,0,0,0,68000,96000,-28000,-28000
055675,亞德客凱基97購02,0,0,0,0,0,0,0,0,0,-28000,0,0,0,41000,69000,-28000,-28000
06810P,國巨統一99售03  ,0,0,0,0,0,0,0,0,0,-28000,0,0,0,0,28000,-28000,-28000
07387P,臺股指群益99售25,0,0,0,0,0,0,0,0,0,-28000,0,0,0,0,28000,-28000,-28000
07396P,聯發科群益9B售01,0,0,0,0,0,0,0,0,0,-28000,0,0,0,24000,52000,-28000,-28000
060949,祥碩中信9A購01  ,0,0,0,0,0,0,0,0,0,-29000,0,0,0,128000,157000,-29000,-29000
061050,康友中信9A購01  ,0,0,0,0,0,0,0,0,0,-29000,0,0,0,95000,124000,-29000,-29000
060628,和大富邦9B購01  ,0,0,0,0,0,0,0,0,0,-29000,0,0,0,60000,89000,-29000,-29000
060733,和大統一9C購01  ,0,0,0,0,0,0,0,0,0,-29000,0,0,0,0,29000,-29000,-29000
06674P,祥碩群益98售02  ,0,0,0,0,0,0,0,0,0,-29000,0,0,0,15000,44000,-29000,-29000
059281,創意永豐99購02  ,0,0,0,0,0,0,0,0,0,-29000,0,0,0,51000,80000,-29000,-29000
059397,T50反1元富99購05,0,0,0,0,0,0,0,0,0,-29000,0,0,0,215000,244000,-29000,-29000
059665,嘉聯益元大99購06,0,0,0,0,0,0,0,0,0,-29000,0,0,0,26000,55000,-29000,-29000
060453,儒鴻元大9A購02  ,0,0,0,0,0,0,0,0,0,-29000,0,0,0,28000,57000,-29000,-29000
052969,建準群益97購01  ,0,0,0,0,0,0,0,0,0,-29000,0,0,0,60000,89000,-29000,-29000
057517,矽創元富98購02  ,0,0,0,0,0,0,0,0,0,-29000,0,0,0,0,29000,-29000,-29000
00692,富邦公司治理    ,0,0,0,0,0,0,0,0,0,-29000,0,0,0,1922000,1951000,-29000,-29000
057433,上銀國票98購04  ,0,0,0,0,0,0,0,0,0,-29000,0,0,0,0,29000,-29000,-29000
055726,台表科元大98購03,0,0,0,0,0,0,0,0,0,-29000,0,0,0,66000,95000,-29000,-29000
057642,南亞科元大98購07,0,0,0,0,0,0,0,0,0,-29000,0,0,0,44000,73000,-29000,-29000
058233,聯發科元大99購06,0,0,0,0,0,0,0,0,0,-29000,0,0,0,127000,156000,-29000,-29000
058339,康友元富99購02  ,0,0,0,0,0,0,0,0,0,-29000,0,0,0,11000,40000,-29000,-29000
058328,世紀鋼統一9B購01,0,0,0,0,0,0,0,0,0,-29000,0,0,0,50000,79000,-29000,-29000
059015,華通元富99購02  ,0,0,0,0,0,0,0,0,0,-29000,0,0,0,99000,128000,-29000,-29000
056963,建準永豐98購01  ,0,0,0,0,0,0,0,0,0,-29000,0,0,0,48000,77000,-29000,-29000
057086,立積統一9C購01  ,0,0,0,0,0,0,0,0,0,-29000,0,0,0,0,29000,-29000,-29000
07407P,欣興凱基99售07  ,0,0,0,0,0,0,0,0,0,-29000,0,0,0,65000,94000,-29000,-29000
06851P,鈺齊元大98售01  ,0,0,0,0,0,0,0,0,0,-29000,0,0,0,1000,30000,-29000,-29000
06946P,T50正2元大9C售01,0,0,0,0,0,0,0,0,0,-29000,0,0,0,1000,30000,-29000,-29000
07181P,臺股指凱基99售23,0,0,0,0,0,0,0,0,0,-29000,0,0,0,4000,33000,-29000,-29000
2493,揚博            ,39000,68000,-29000,0,0,0,0,0,0,0,0,0,0,0,0,0,-29000
060464,台積電元大9A購11,0,0,0,0,0,0,0,0,0,-30000,0,0,0,0,30000,-30000,-30000
059915,聯發科元大99購32,0,0,0,0,0,0,0,0,0,-30000,0,0,0,882000,912000,-30000,-30000
059863,和大凱基99購01  ,0,0,0,0,0,0,0,0,0,-30000,0,0,0,12000,42000,-30000,-30000
059881,臺股指凱基99購46,0,0,0,0,0,0,0,0,0,-30000,0,0,0,0,30000,-30000,-30000
059743,開發金元富99購01,0,0,0,0,0,0,0,0,0,-30000,0,0,0,30000,60000,-30000,-30000
05979P,華新科中信96售02,0,0,0,0,0,0,0,0,0,-30000,0,0,0,50000,80000,-30000,-30000
059430,台積電元大99購36,0,0,0,0,0,0,0,0,0,-30000,0,0,0,46000,76000,-30000,-30000
059450,和大永豐99購01  ,0,0,0,0,0,0,0,0,0,-30000,0,0,0,0,30000,-30000,-30000
059286,S&P正2元富01購03,0,0,0,0,0,0,0,0,0,-30000,0,0,0,48000,78000,-30000,-30000
059217,台積電元大99購30,0,0,0,0,0,0,0,0,0,-30000,0,0,0,0,30000,-30000,-30000
06734P,智邦凱基98售05  ,0,0,0,0,0,0,0,0,0,-30000,0,0,0,16000,46000,-30000,-30000
06444P,大立光凱基98售08,0,0,0,0,0,0,0,0,0,-30000,0,0,0,0,30000,-30000,-30000
06528P,台積電富邦99售03,0,0,0,0,0,0,0,0,0,-30000,0,0,0,150000,180000,-30000,-30000
06163P,聯詠群益97售01  ,0,0,0,0,0,0,0,0,0,-30000,0,0,0,0,30000,-30000,-30000
061476,大毅元大9A購02  ,0,0,0,0,0,0,0,0,0,-30000,0,0,0,0,30000,-30000,-30000
061420,國巨元大9A購22  ,0,0,0,0,0,0,0,0,0,-30000,0,0,0,103000,133000,-30000,-30000
060659,鴻海凱基9B購03  ,0,0,0,0,0,0,0,0,0,-30000,0,0,0,4000,34000,-30000,-30000
060608,玉晶光凱基9A購08,0,0,0,0,0,0,0,0,0,-30000,0,0,0,0,30000,-30000,-30000
060555,台表科凱基9A購03,0,0,0,0,0,0,0,0,0,-30000,0,0,0,0,30000,-30000,-30000
061069,嘉聯益凱基9A購01,0,0,0,0,0,0,0,0,0,-30000,0,0,0,53000,83000,-30000,-30000
061023,茂林國泰9B購02  ,0,0,0,0,0,0,0,0,0,-30000,0,0,0,0,30000,-30000,-30000
043513,台灣50元大96購05,0,0,0,0,0,0,0,0,0,-30000,0,0,0,0,30000,-30000,-30000
041534,T50反1凱基96購01,0,0,0,0,0,0,0,0,0,-30000,0,0,0,0,30000,-30000,-30000
049612,香港反中信96購01,0,0,0,0,0,0,0,0,0,-30000,0,0,0,0,30000,-30000,-30000
05011P,南電國泰96售01  ,0,0,0,0,0,0,0,0,0,-30000,0,0,0,0,30000,-30000,-30000
050673,旺宏富邦96購02  ,0,0,0,0,0,0,0,0,0,-30000,0,0,0,20000,50000,-30000,-30000
050690,台達電凱基96購01,0,0,0,0,0,0,0,0,0,-30000,0,0,0,0,30000,-30000,-30000
050884,聯茂國泰96購01  ,0,0,0,0,0,0,0,0,0,-30000,0,0,0,0,30000,-30000,-30000
051802,同欣電永豐95購02,0,0,0,0,0,0,0,0,0,-30000,0,0,0,0,30000,-30000,-30000
051769,矽力元大95購01  ,0,0,0,0,0,0,0,0,0,-30000,0,0,0,0,30000,-30000,-30000
052428,嘉晶永豐95購01  ,0,0,0,0,0,0,0,0,0,-30000,0,0,0,0,30000,-30000,-30000
052312,美律富邦96購02  ,0,0,0,0,0,0,0,0,0,-30000,0,0,0,0,30000,-30000,-30000
053929,正文國票97購01  ,0,0,0,0,0,0,0,0,0,-30000,0,0,0,0,30000,-30000,-30000
055377,揚明光元大98購01,0,0,0,0,0,0,0,0,0,-30000,0,0,0,0,30000,-30000,-30000
053426,創意永豐96購04  ,0,0,0,0,0,0,0,0,0,-30000,0,0,0,0,30000,-30000,-30000
054739,義隆凱基98購02  ,0,0,0,0,0,0,0,0,0,-30000,0,0,0,0,30000,-30000,-30000
054843,中環兆豐97購01  ,0,0,0,0,0,0,0,0,0,-30000,0,0,0,0,30000,-30000,-30000
054378,楠梓電群益98購01,0,0,0,0,0,0,0,0,0,-30000,0,0,0,0,30000,-30000,-30000
054180,亞泥康和96購01  ,0,0,0,0,0,0,0,0,0,-30000,0,0,0,3000,33000,-30000,-30000
054351,華新科國泰97購03,0,0,0,0,0,0,0,0,0,-30000,0,0,0,246000,276000,-30000,-30000
055962,晶豪科元大97購02,0,0,0,0,0,0,0,0,0,-30000,0,0,0,76000,106000,-30000,-30000
056940,嘉聯益元富98購01,0,0,0,0,0,0,0,0,0,-30000,0,0,0,0,30000,-30000,-30000
056988,聚陽兆豐98購01  ,0,0,0,0,0,0,0,0,0,-30000,0,0,0,0,30000,-30000,-30000
057000,亞德客國票99購01,0,0,0,0,0,0,0,0,0,-30000,0,0,0,28000,58000,-30000,-30000
056920,友達兆豐98購02  ,0,0,0,0,0,0,0,0,0,-30000,0,0,0,0,30000,-30000,-30000
055905,可成兆豐97購03  ,0,0,0,0,0,0,0,0,0,-30000,0,0,0,20000,50000,-30000,-30000
056109,彩晶永豐98購01  ,0,0,0,0,0,0,0,0,0,-30000,0,0,0,0,30000,-30000,-30000
056097,訊芯元富97購02  ,0,0,0,0,0,0,0,0,0,-30000,0,0,0,0,30000,-30000,-30000
056456,群創凱基9B購01  ,0,0,0,0,0,0,0,0,0,-30000,0,0,0,0,30000,-30000,-30000
056324,南亞科兆豐98購01,0,0,0,0,0,0,0,0,0,-30000,0,0,0,20000,50000,-30000,-30000
056223,華邦電凱基97購04,0,0,0,0,0,0,0,0,0,-30000,0,0,0,0,30000,-30000,-30000
056197,友訊永豐97購01  ,0,0,0,0,0,0,0,0,0,-30000,0,0,0,0,30000,-30000,-30000
058928,國巨統一9C購01  ,0,0,0,0,0,0,0,0,0,-30000,0,0,0,0,30000,-30000,-30000
058863,可成凱基99購02  ,0,0,0,0,0,0,0,0,0,-30000,0,0,0,0,30000,-30000,-30000
058840,T50反1群益99購02,0,0,0,0,0,0,0,0,0,-30000,0,0,0,0,30000,-30000,-30000
058519,嘉澤元大99購01  ,0,0,0,0,0,0,0,0,0,-30000,0,0,0,11000,41000,-30000,-30000
058515,健鼎元大99購01  ,0,0,0,0,0,0,0,0,0,-30000,0,0,0,0,30000,-30000,-30000
058625,旺宏國票9A購01  ,0,0,0,0,0,0,0,0,0,-30000,0,0,0,99000,129000,-30000,-30000
057959,欣興元大98購14  ,0,0,0,0,0,0,0,0,0,-30000,0,0,0,0,30000,-30000,-30000
057777,可成群益9A購03  ,0,0,0,0,0,0,0,0,0,-30000,0,0,0,0,30000,-30000,-30000
057870,大立光凱基99購02,0,0,0,0,0,0,0,0,0,-30000,0,0,0,0,30000,-30000,-30000
055230,大毅國票98購01  ,0,0,0,0,0,0,0,0,0,-30000,0,0,0,0,30000,-30000,-30000
055204,宏達電中信99購01,0,0,0,0,0,0,0,0,0,-30000,0,0,0,0,30000,-30000,-30000
056803,群創台新99購02  ,0,0,0,0,0,0,0,0,0,-30000,0,0,0,120000,150000,-30000,-30000
057469,康友永豐98購02  ,0,0,0,0,0,0,0,0,0,-30000,0,0,0,0,30000,-30000,-30000
057243,樺漢凱基99購01  ,0,0,0,0,0,0,0,0,0,-30000,0,0,0,0,30000,-30000,-30000
056707,鴻海富邦99購03  ,0,0,0,0,0,0,0,0,0,-30000,0,0,0,44000,74000,-30000,-30000
058108,台郡台新99購01  ,0,0,0,0,0,0,0,0,0,-30000,0,0,0,0,30000,-30000,-30000
07230P,滬深2X群益01售02,0,0,0,0,0,0,0,0,0,-30000,0,0,0,0,30000,-30000,-30000
06964P,臺股指凱基9B售01,0,0,0,0,0,0,0,0,0,-30000,0,0,0,221000,251000,-30000,-30000
06867P,訊芯元大98售08  ,0,0,0,0,0,0,0,0,0,-30000,0,0,0,185000,215000,-30000,-30000
07654P,台灣50凱基01售08,0,0,0,0,0,0,0,0,0,-30000,0,0,0,0,30000,-30000,-30000
07533P,臺股指中信9C售04,0,0,0,0,0,0,0,0,0,-30000,0,0,0,0,30000,-30000,-30000
3518,柏騰            ,68000,98000,-30000,0,0,0,0,0,0,0,0,0,0,0,0,0,-30000
061364,國巨國票9A購09  ,0,0,0,0,0,0,0,0,0,-31000,0,0,0,216000,247000,-31000,-31000
06608P,立積群益99售02  ,0,0,0,0,0,0,0,0,0,-31000,0,0,0,0,31000,-31000,-31000
06581P,南亞科凱基98售04,0,0,0,0,0,0,0,0,0,-31000,0,0,0,0,31000,-31000,-31000
060057,欣興凱基9B購01  ,0,0,0,0,0,0,0,0,0,-31000,0,0,0,123000,154000,-31000,-31000
060216,鴻海凱基9A購17  ,0,0,0,0,0,0,0,0,0,-31000,0,0,0,0,31000,-31000,-31000
056637,台光電日盛9A購01,0,0,0,0,0,0,0,0,0,-31000,0,0,0,0,31000,-31000,-31000
050634,華新科群益96購01,0,0,0,0,0,0,0,0,0,-31000,0,0,0,10000,41000,-31000,-31000
049602,南電元大95購01  ,0,0,0,0,0,0,0,0,0,-31000,0,0,0,1000,32000,-31000,-31000
055627,亞德客永豐97購02,0,0,0,0,0,0,0,0,0,-31000,0,0,0,2000,33000,-31000,-31000
058159,健策台新9A購01  ,0,0,0,0,0,0,0,0,0,-31000,0,0,0,234000,265000,-31000,-31000
058188,華擎永豐99購01  ,0,0,0,0,0,0,0,0,0,-31000,0,0,0,92000,123000,-31000,-31000
058359,瑞昱凱基99購01  ,0,0,0,0,0,0,0,0,0,-31000,0,0,0,12000,43000,-31000,-31000
057809,英業達元大98購01,0,0,0,0,0,0,0,0,0,-31000,0,0,0,74000,105000,-31000,-31000
058955,台積電國票9A購04,0,0,0,0,0,0,0,0,0,-31000,0,0,0,159000,190000,-31000,-31000
057084,立積統一9B購01  ,0,0,0,0,0,0,0,0,0,-31000,0,0,0,0,31000,-31000,-31000
07347P,上証2X凱基99售02,0,0,0,0,0,0,0,0,0,-31000,0,0,0,0,31000,-31000,-31000
07161P,臺股指群益99售12,0,0,0,0,0,0,0,0,0,-31000,0,0,0,10000,41000,-31000,-31000
07084P,S&P正2元富9B售02,5000,0,5000,0,0,0,0,0,0,-36000,0,0,0,0,36000,-36000,-31000
060390,聯鈞群益9A購01  ,0,0,0,0,0,0,0,0,0,-32000,0,0,0,0,32000,-32000,-32000
059875,信邦凱基99購02  ,0,0,0,0,0,0,0,0,0,-32000,0,0,0,156000,188000,-32000,-32000
059268,鎧勝中信01購01  ,0,0,0,0,0,0,0,0,0,-32000,0,0,0,20000,52000,-32000,-32000
059766,同欣電永豐99購03,0,0,0,0,0,0,0,0,0,-32000,0,0,0,51000,83000,-32000,-32000
059567,台積電凱基9A購12,0,0,0,0,0,0,0,0,0,-32000,0,0,0,0,32000,-32000,-32000
060705,台光電富邦9B購01,0,0,0,0,0,0,0,0,0,-32000,0,0,0,0,32000,-32000,-32000
04908P,南電國票95售03  ,0,0,0,0,0,0,0,0,0,-32000,0,0,0,0,32000,-32000,-32000
053742,創意國票97購01  ,0,0,0,0,0,0,0,0,0,-32000,0,0,0,0,32000,-32000,-32000
054188,欣興永豐96購03  ,0,0,0,0,0,0,0,0,0,-32000,0,0,0,5000,37000,-32000,-32000
058589,群創中信01購01  ,0,0,0,0,0,0,0,0,0,-32000,0,0,0,0,32000,-32000,-32000
055006,晶相光元富9A購01,450000,0,450000,0,0,0,0,0,0,-482000,0,0,0,3000,485000,-482000,-32000
055058,大毅永豐97購01  ,0,0,0,0,0,0,0,0,0,-32000,0,0,0,3000,35000,-32000,-32000
058006,台郡群益98購04  ,0,0,0,0,0,0,0,0,0,-32000,0,0,0,0,32000,-32000,-32000
056641,華通凱基98購03  ,0,0,0,0,0,0,0,0,0,-32000,0,0,0,0,32000,-32000,-32000
057468,台郡永豐98購01  ,0,0,0,0,0,0,0,0,0,-32000,0,0,0,10000,42000,-32000,-32000
060730,台積電群益9A購03,0,0,0,0,0,0,0,0,0,-33000,0,0,0,5000,38000,-33000,-33000
061047,大立光第一9A購01,0,0,0,0,0,0,0,0,0,-33000,0,0,0,2000,35000,-33000,-33000
061513,華新科永豐9A購04,0,0,0,0,0,0,0,0,0,-33000,0,0,0,0,33000,-33000,-33000
059515,牧德永豐99購01  ,0,0,0,0,0,0,0,0,0,-33000,0,0,0,425000,458000,-33000,-33000
059502,台灣50台新9B購04,0,0,0,0,0,0,0,0,0,-33000,0,0,0,2000,35000,-33000,-33000
059129,麗豐中信99購01  ,0,0,0,0,0,0,0,0,0,-33000,0,0,0,0,33000,-33000,-33000
054061,晶技國票97購03  ,0,25000,-25000,0,0,0,0,0,0,-8000,0,0,0,41000,49000,-8000,-33000
055459,建準永豐97購03  ,0,0,0,0,0,0,0,0,0,-33000,0,0,0,62000,95000,-33000,-33000
057301,嘉聯益永豐98購02,0,0,0,0,0,0,0,0,0,-33000,0,0,0,10000,43000,-33000,-33000
057141,嘉聯益兆豐99購01,0,0,0,0,0,0,0,0,0,-33000,0,0,0,55000,88000,-33000,-33000
05710P,禾伸堂國票97售02,0,0,0,0,0,0,0,0,0,-33000,0,0,0,18000,51000,-33000,-33000
058592,聯發科統一9C購01,0,0,0,0,0,0,0,0,0,-33000,0,0,0,2000,35000,-33000,-33000
056198,台光電永豐97購02,0,0,0,0,0,0,0,0,0,-33000,0,0,0,0,33000,-33000,-33000
3312,弘憶股          ,40000,73000,-33000,0,0,0,0,0,0,0,0,0,0,0,0,0,-33000
059312,元石油元大99購05,0,0,0,0,0,0,0,0,0,-34000,0,0,0,352000,386000,-34000,-34000
059540,新光金日盛99購01,0,0,0,0,0,0,0,0,0,-34000,0,0,0,1000,35000,-34000,-34000
059615,台灣50群益99購05,0,0,0,0,0,0,0,0,0,-34000,0,0,0,0,34000,-34000,-34000
05996P,華新科群益96售03,0,0,0,0,0,0,0,0,0,-34000,0,0,0,0,34000,-34000,-34000
060044,大立光群益99購09,0,0,0,0,0,0,0,0,0,-34000,0,0,0,0,34000,-34000,-34000
059994,國巨元富99購01  ,0,0,0,0,0,0,0,0,0,-34000,0,0,0,0,34000,-34000,-34000
06683P,訊芯元大98售07  ,0,0,0,0,0,0,0,0,0,-34000,0,0,0,75000,109000,-34000,-34000
061335,國巨元大9A購19  ,0,0,0,0,0,0,0,0,0,-34000,0,0,0,28000,62000,-34000,-34000
060923,全新永豐9A購01  ,0,0,0,0,0,0,0,0,0,-34000,0,0,0,0,34000,-34000,-34000
06087P,國巨永豐97售01  ,0,0,0,0,0,0,0,0,0,-34000,0,0,0,20000,54000,-34000,-34000
054744,晶相光凱基99購01,0,0,0,0,0,0,0,0,0,-34000,0,0,0,147000,181000,-34000,-34000
053249,致伸國票97購02  ,0,0,0,0,0,0,0,0,0,-34000,0,0,0,38000,72000,-34000,-34000
048898,晶相光國泰96購01,0,0,0,0,0,0,0,0,0,-34000,0,0,0,16000,50000,-34000,-34000
048859,玉晶光群益96購02,0,0,0,0,0,0,0,0,0,-34000,0,0,0,36000,70000,-34000,-34000
057719,欣興元富02購01  ,0,0,0,0,0,0,0,0,0,-34000,0,0,0,0,34000,-34000,-34000
058693,旭富國票9A購01  ,0,0,0,0,0,0,0,0,0,-34000,0,0,0,24000,58000,-34000,-34000
057900,南亞科永豐98購01,0,0,0,0,0,0,0,0,0,-34000,0,0,0,0,34000,-34000,-34000
058400,聯發科元大99購09,0,0,0,0,0,0,0,0,0,-34000,0,0,0,51000,85000,-34000,-34000
058176,聯發科凱基99購05,0,0,0,0,0,0,0,0,0,-34000,0,0,0,0,34000,-34000,-34000
06915P,晶技元富98售02  ,0,0,0,0,0,0,0,0,0,-34000,0,0,0,0,34000,-34000,-34000
07302P,臺股指元大9A售35,0,0,0,0,0,0,0,0,0,-34000,0,0,0,0,34000,-34000,-34000
2448,晶電            ,13646000,14146000,-500000,0,0,0,3239000,2238000,1001000,-535000,657000,888000,-231000,20000,324000,-304000,-34000
07719P,臺股指群益9A售08,0,0,0,0,0,0,0,0,0,-34000,0,0,0,52000,86000,-34000,-34000
060910,聯發科元大9A購05,0,0,0,0,0,0,0,0,0,-35000,0,0,0,50000,85000,-35000,-35000
061028,聚陽永豐9A購01  ,0,0,0,0,0,0,0,0,0,-35000,0,0,0,186000,221000,-35000,-35000
061003,南亞科兆豐9A購01,0,0,0,0,0,0,0,0,0,-35000,0,0,0,165000,200000,-35000,-35000
06054P,臺股指中信9A售01,0,0,0,0,0,0,0,0,0,-35000,0,0,0,0,35000,-35000,-35000
060655,國巨統一9B購06  ,0,0,0,0,0,0,0,0,0,-35000,0,0,0,204000,239000,-35000,-35000
061379,鈺齊永豐9A購02  ,0,0,0,0,0,0,0,0,0,-35000,0,0,0,68000,103000,-35000,-35000
061509,SP黃豆富邦9C購01,0,0,0,0,0,0,0,0,0,-35000,0,0,0,0,35000,-35000,-35000
060113,祥碩元大9B購01  ,0,0,0,0,0,0,0,0,0,-35000,0,0,0,263000,298000,-35000,-35000
059928,道瓊銀富邦03購01,0,0,0,0,0,0,0,0,0,-35000,0,0,0,0,35000,-35000,-35000
060170,世紀鋼永豐9A購01,0,0,0,0,0,0,0,0,0,-35000,0,0,0,0,35000,-35000,-35000
059300,國巨群益99購08  ,0,0,0,0,0,0,0,0,0,-35000,0,0,0,8000,43000,-35000,-35000
05925P,晶技永豐96售03  ,0,0,0,0,0,0,0,0,0,-35000,0,0,0,0,35000,-35000,-35000
051292,牧德統一97購01  ,0,0,0,0,0,0,0,0,0,-35000,0,0,0,18000,53000,-35000,-35000
053947,義隆富邦97購01  ,0,0,0,0,0,0,0,0,0,-35000,0,0,0,25000,60000,-35000,-35000
053798,台積電中信98購02,0,0,0,0,0,0,0,0,0,-35000,0,0,0,0,35000,-35000,-35000
056563,華新科群益98購04,0,0,0,0,0,0,0,0,0,-35000,0,0,0,32000,67000,-35000,-35000
053702,智易兆豐97購02  ,0,0,0,0,0,0,0,0,0,-35000,0,0,0,0,35000,-35000,-35000
057140,宏達電兆豐98購01,0,0,0,0,0,0,0,0,0,-35000,0,0,0,0,35000,-35000,-35000
058012,鈺齊國票99購01  ,0,0,0,0,0,0,0,0,0,-35000,0,0,0,0,35000,-35000,-35000
057261,瑞昱兆豐98購01  ,0,0,0,0,0,0,0,0,0,-35000,0,0,0,0,35000,-35000,-35000
055583,國巨元大97購10  ,0,0,0,0,0,0,0,0,0,-35000,0,0,0,189000,224000,-35000,-35000
05644P,大立光中信9A售03,0,0,0,0,0,0,0,0,0,-35000,0,0,0,107000,142000,-35000,-35000
2882A,國泰特          ,0,0,0,0,0,0,0,0,0,-35000,0,35000,-35000,0,0,0,-35000
07164P,臺股指群益99售15,0,0,0,0,0,0,0,0,0,-35000,0,0,0,79000,114000,-35000,-35000
059254,台表科凱基9A購02,0,0,0,0,0,0,0,0,0,-36000,0,0,0,18000,54000,-36000,-36000
059234,台灣50凱基9C購03,0,0,0,0,0,0,0,0,0,-36000,0,0,0,54000,90000,-36000,-36000
059278,群創元大9A購04  ,0,0,0,0,0,0,0,0,0,-36000,0,0,0,284000,320000,-36000,-36000
059987,大立光元大99購28,0,0,0,0,0,0,0,0,0,-36000,0,0,0,1000,37000,-36000,-36000
060043,全新群益9B購02  ,0,0,0,0,0,0,0,0,0,-36000,0,0,0,66000,102000,-36000,-36000
061178,晶技凱基9B購01  ,0,0,0,0,0,0,0,0,0,-36000,0,0,0,0,36000,-36000,-36000
061245,晶技群益9A購01  ,0,0,0,0,0,0,0,0,0,-36000,0,0,0,15000,51000,-36000,-36000
06584P,欣興凱基98售03  ,0,0,0,0,0,0,0,0,0,-36000,0,0,0,19000,55000,-36000,-36000
06232P,智易永豐97售01  ,0,0,0,0,0,0,0,0,0,-36000,0,0,0,0,36000,-36000,-36000
060582,玉晶光群益9C購01,0,0,0,0,0,0,0,0,0,-36000,0,0,0,0,36000,-36000,-36000
061059,世芯國票9B購01  ,5000,0,5000,0,0,0,0,0,0,-41000,0,0,0,1000,42000,-41000,-36000
060947,台積電統一9C購03,0,0,0,0,0,0,0,0,0,-36000,0,0,0,0,36000,-36000,-36000
056549,嘉聯益凱基98購04,0,0,0,0,0,0,0,0,0,-36000,0,0,0,4000,40000,-36000,-36000
056518,美律國票99購01  ,0,0,0,0,0,0,0,0,0,-36000,0,0,0,12000,48000,-36000,-36000
057531,禾伸堂元大99購04,0,0,0,0,0,0,0,0,0,-36000,0,0,0,133000,169000,-36000,-36000
053320,華新科群益97購01,0,0,0,0,0,0,0,0,0,-36000,0,0,0,24000,60000,-36000,-36000
052536,聯茂國泰97購01  ,0,0,0,0,0,0,0,0,0,-36000,0,0,0,4000,40000,-36000,-36000
049675,台光電國票95購01,0,0,0,0,0,0,0,0,0,-36000,0,0,0,2000,38000,-36000,-36000
050547,華新科凱基95購01,0,0,0,0,0,0,0,0,0,-36000,0,0,0,0,36000,-36000,-36000
056417,欣興中信98購01  ,0,0,0,0,0,0,0,0,0,-36000,0,0,0,0,36000,-36000,-36000
056021,興富發群益97購01,0,0,0,0,0,0,0,0,0,-36000,0,0,0,122000,158000,-36000,-36000
058536,群創統一9B購01  ,0,0,0,0,0,0,0,0,0,-36000,0,0,0,0,36000,-36000,-36000
057961,茂林元大9A購01  ,0,0,0,0,0,0,0,0,0,-36000,0,0,0,20000,56000,-36000,-36000
057268,臻鼎兆豐99購01  ,0,0,0,0,0,0,0,0,0,-36000,0,0,0,4000,40000,-36000,-36000
057201,華擎元富98購01  ,0,0,0,0,0,0,0,0,0,-36000,0,0,0,20000,56000,-36000,-36000
057558,致新凱基98購01  ,0,0,0,0,0,0,0,0,0,-36000,0,0,0,0,36000,-36000,-36000
060955,大立光群益9A購02,0,0,0,0,0,0,0,0,0,-37000,0,0,0,20000,57000,-37000,-37000
061113,南電元大9A購03  ,0,0,0,0,0,0,0,0,0,-37000,0,0,0,3000,40000,-37000,-37000
061344,禾伸堂元大9A購02,0,0,0,0,0,0,0,0,0,-37000,0,0,0,201000,238000,-37000,-37000
059916,聯發科元大99購33,0,0,0,0,0,0,0,0,0,-37000,0,0,0,251000,288000,-37000,-37000
060168,台表科永豐9A購01,0,0,0,0,0,0,0,0,0,-37000,0,0,0,1000,38000,-37000,-37000
060385,台勝科凱基9A購01,0,0,0,0,0,0,0,0,0,-37000,0,0,0,86000,123000,-37000,-37000
059295,大立光元富99購05,0,0,0,0,0,0,0,0,0,-37000,0,0,0,196000,233000,-37000,-37000
059174,訊芯凱基99購01  ,0,0,0,0,0,0,0,0,0,-37000,0,0,0,185000,222000,-37000,-37000
050854,世紀鋼國票97購01,0,0,0,0,0,0,0,0,0,-37000,0,0,0,0,37000,-37000,-37000
053658,亞光凱基96購01  ,0,0,0,0,0,0,0,0,0,-37000,0,0,0,22000,59000,-37000,-37000
053593,晶技元大98購01  ,0,0,0,0,0,0,0,0,0,-37000,0,0,0,66000,103000,-37000,-37000
057172,南亞科元大98購03,0,0,0,0,0,0,0,0,0,-37000,0,0,0,103000,140000,-37000,-37000
057470,易華電永豐98購02,0,0,0,0,0,0,0,0,0,-37000,0,0,0,95000,132000,-37000,-37000
059070,道瓊指元大99購02,0,0,0,0,0,0,0,0,0,-37000,0,0,0,70000,107000,-37000,-37000
059143,國巨國票9A購04  ,0,0,0,0,0,0,0,0,0,-38000,0,0,0,269000,307000,-38000,-38000
059118,晶技永豐9A購01  ,0,0,0,0,0,0,0,0,0,-38000,0,0,0,3000,41000,-38000,-38000
059474,元石油群益99購01,0,0,0,0,0,0,0,0,0,-38000,0,0,0,0,38000,-38000,-38000
061411,T50反1群益9A購05,0,0,0,0,0,0,0,0,0,-38000,0,0,0,0,38000,-38000,-38000
06284P,台積電國票98售03,0,0,0,0,0,0,0,0,0,-38000,0,0,0,2000,40000,-38000,-38000
060836,上銀國票9A購03  ,0,0,0,0,0,0,0,0,0,-38000,0,0,0,0,38000,-38000,-38000
060786,聯發科富邦9B購06,0,0,0,0,0,0,0,0,0,-38000,0,0,0,0,38000,-38000,-38000
054538,台光電國票98購01,0,0,0,0,0,0,0,0,0,-38000,0,0,0,0,38000,-38000,-38000
056619,強茂永豐98購01  ,0,0,0,0,0,0,0,0,0,-38000,0,0,0,22000,60000,-38000,-38000
052016,神基永豐95購01  ,0,0,0,0,0,0,0,0,0,-38000,0,0,0,0,38000,-38000,-38000
052560,康舒國票97購01  ,0,0,0,0,0,0,0,0,0,-38000,0,0,0,0,38000,-38000,-38000
053970,聯發科元大97購08,0,0,0,0,0,0,0,0,0,-38000,0,0,0,50000,88000,-38000,-38000
050385,貿聯國票95購02  ,0,0,0,0,0,0,0,0,0,-38000,0,0,0,0,38000,-38000,-38000
058947,SGBR2X群益9B購02,0,0,0,0,0,0,0,0,0,-38000,0,0,0,8000,46000,-38000,-38000
058949,上銀群益99購02  ,0,0,0,0,0,0,0,0,0,-38000,0,0,0,5000,43000,-38000,-38000
058877,T50反1國泰9B購01,0,0,0,0,0,0,0,0,0,-38000,0,0,0,20000,58000,-38000,-38000
058606,聯發科元大99購13,0,0,0,0,0,0,0,0,0,-38000,0,0,0,74000,112000,-38000,-38000
056302,大立光元大97購17,0,0,0,0,0,0,0,0,0,-38000,0,0,0,0,38000,-38000,-38000
057101,新光金中信9A購01,0,0,0,0,0,0,0,0,0,-38000,0,0,0,0,38000,-38000,-38000
058107,全新台新99購01  ,0,0,0,0,0,0,0,0,0,-38000,0,0,0,0,38000,-38000,-38000
055063,玉晶光永豐99購01,0,0,0,0,0,0,0,0,0,-38000,0,0,0,0,38000,-38000,-38000
055053,瑞昱永豐97購01  ,0,0,0,0,0,0,0,0,0,-38000,0,0,0,1000,39000,-38000,-38000
07760P,力山永豐9A售03  ,0,0,0,0,0,0,0,0,0,-38000,0,0,0,3000,41000,-38000,-38000
6283,淳安            ,122000,160000,-38000,0,0,0,0,0,0,0,0,0,0,0,0,0,-38000
061380,巨大永豐9A購02  ,0,0,0,0,0,0,0,0,0,-39000,0,0,0,128000,167000,-39000,-39000
060158,廣達永豐9A購01  ,0,0,0,0,0,0,0,0,0,-39000,0,0,0,4000,43000,-39000,-39000
060224,台灣50元大9A購09,0,0,0,0,0,0,0,0,0,-39000,0,0,0,0,39000,-39000,-39000
060099,宏達電元大99購09,0,0,0,0,0,0,0,0,0,-39000,0,0,0,86000,125000,-39000,-39000
051321,建準國票96購01  ,0,0,0,0,0,0,0,0,0,-39000,0,0,0,0,39000,-39000,-39000
052137,台表科凱基96購02,0,0,0,0,0,0,0,0,0,-39000,0,0,0,1000,40000,-39000,-39000
052076,可成元富98購01  ,0,0,0,0,0,0,0,0,0,-39000,0,0,0,31000,70000,-39000,-39000
051154,國巨國泰96購03  ,0,0,0,0,0,0,0,0,0,-39000,0,0,0,11000,50000,-39000,-39000
053405,台達電兆豐96購01,0,0,0,0,0,0,0,0,0,-39000,0,0,0,0,39000,-39000,-39000
052938,華新科兆豐96購01,0,0,0,0,0,0,0,0,0,-39000,0,0,0,0,39000,-39000,-39000
053800,華通凱基97購03  ,0,0,0,0,0,0,0,0,0,-39000,0,0,0,0,39000,-39000,-39000
056755,聯茂兆豐98購01  ,0,0,0,0,0,0,0,0,0,-39000,0,0,0,0,39000,-39000,-39000
057875,京鼎元大98購03  ,0,0,0,0,0,0,0,0,0,-39000,0,0,0,176000,215000,-39000,-39000
057306,玉晶光兆豐99購01,0,0,0,0,0,0,0,0,0,-39000,0,0,0,0,39000,-39000,-39000
058550,南亞科永豐99購01,0,0,0,0,0,0,0,0,0,-39000,0,0,0,0,39000,-39000,-39000
07106P,國巨統一9B售05  ,0,0,0,0,0,0,0,0,0,-39000,0,0,0,95000,134000,-39000,-39000
07444P,聯發科凱基9A售10,0,0,0,0,0,0,0,0,0,-39000,0,0,0,66000,105000,-39000,-39000
07590P,玉晶光國票9A售03,0,0,0,0,0,0,0,0,0,-39000,0,0,0,147000,186000,-39000,-39000
060021,立積康和99購01  ,0,0,0,0,0,0,0,0,0,-40000,0,0,0,0,40000,-40000,-40000
059947,貿聯永豐99購03  ,0,0,0,0,0,0,0,0,0,-40000,0,0,0,13000,53000,-40000,-40000
059856,昇陽半永豐99購03,0,0,0,0,0,0,0,0,0,-40000,0,0,0,13000,53000,-40000,-40000
060169,群電永豐9A購01  ,0,0,0,0,0,0,0,0,0,-40000,0,0,0,0,40000,-40000,-40000
05972P,瑞昱元大96售01  ,0,0,0,0,0,0,0,0,0,-40000,0,0,0,0,40000,-40000,-40000
059198,華新科永豐99購06,0,0,0,0,0,0,0,0,0,-40000,0,0,0,10000,50000,-40000,-40000
061288,大立光統一9C購01,0,0,0,0,0,0,0,0,0,-40000,0,0,0,0,40000,-40000,-40000
061145,臻鼎中信9A購02  ,0,0,0,0,0,0,0,0,0,-40000,0,0,0,0,40000,-40000,-40000
06682P,玉晶光元大99售08,0,0,0,0,0,0,0,0,0,-40000,0,0,0,2000,42000,-40000,-40000
060666,聯茂凱基9A購02  ,0,0,0,0,0,0,0,0,0,-40000,0,0,0,0,40000,-40000,-40000
060595,台灣50凱基04購04,0,0,0,0,0,0,0,0,0,-40000,0,0,0,22000,62000,-40000,-40000
060541,正隆凱基9A購01  ,0,0,0,0,0,0,0,0,0,-40000,0,0,0,0,40000,-40000,-40000
061080,華邦電兆豐9B購01,0,0,0,0,0,0,0,0,0,-40000,0,0,0,20000,60000,-40000,-40000
054161,友訊凱基98購01  ,0,0,0,0,0,0,0,0,0,-40000,0,0,0,0,40000,-40000,-40000
052936,華通兆豐98購01  ,0,0,0,0,0,0,0,0,0,-40000,0,0,0,121000,161000,-40000,-40000
053072,國巨台新97購01  ,0,0,0,0,0,0,0,0,0,-40000,0,0,0,217000,257000,-40000,-40000
054833,京鼎中信97購01  ,0,0,0,0,0,0,0,0,0,-40000,0,0,0,0,40000,-40000,-40000
053424,欣興永豐96購02  ,0,0,0,0,0,0,0,0,0,-40000,0,0,0,0,40000,-40000,-40000
053495,聯發科兆豐96購02,0,0,0,0,0,0,0,0,0,-40000,0,0,0,0,40000,-40000,-40000
054545,奇力新中信98購01,0,0,0,0,0,0,0,0,0,-40000,0,0,0,0,40000,-40000,-40000
053101,創意元富96購03  ,0,0,0,0,0,0,0,0,0,-40000,0,0,0,0,40000,-40000,-40000
055320,建準國票98購01  ,0,0,0,0,0,0,0,0,0,-40000,0,0,0,0,40000,-40000,-40000
051113,聯電元富95購01  ,0,0,0,0,0,0,0,0,0,-40000,0,0,0,10000,50000,-40000,-40000
051696,新日興中信96購01,0,0,0,0,0,0,0,0,0,-40000,0,0,0,0,40000,-40000,-40000
050850,訊連國票96購01  ,0,0,0,0,0,0,0,0,0,-40000,0,0,0,0,40000,-40000,-40000
050808,台達電凱基96購02,0,0,0,0,0,0,0,0,0,-40000,0,0,0,0,40000,-40000,-40000
051898,富邦金國泰97購01,0,0,0,0,0,0,0,0,0,-40000,0,0,0,47000,87000,-40000,-40000
050055,道瓊反凱基95購01,0,0,0,0,0,0,0,0,0,-40000,0,0,0,0,40000,-40000,-40000
047690,美律富邦97購01  ,0,0,0,0,0,0,0,0,0,-40000,0,0,0,0,40000,-40000,-40000
058683,可成凱基9A購01  ,0,0,0,0,0,0,0,0,0,-40000,0,0,0,0,40000,-40000,-40000
057957,嘉晶元大98購01  ,0,0,0,0,0,0,0,0,0,-40000,0,0,0,55000,95000,-40000,-40000
057949,南電國票99購01  ,0,0,0,0,0,0,0,0,0,-40000,0,0,0,11000,51000,-40000,-40000
058944,元石油群益9C購02,0,0,0,0,0,0,0,0,0,-40000,0,0,0,15000,55000,-40000,-40000
057180,華新科元大99購08,0,0,0,0,0,0,0,0,0,-40000,0,0,0,0,40000,-40000,-40000
057435,旺宏國票99購04  ,0,0,0,0,0,0,0,0,0,-40000,0,0,0,0,40000,-40000,-40000
055686,致伸凱基97購02  ,0,0,0,0,0,0,0,0,0,-40000,0,0,0,40000,80000,-40000,-40000
055623,貿聯國泰99購01  ,0,0,0,0,0,0,0,0,0,-40000,0,0,0,10000,50000,-40000,-40000
055618,麗豐國票98購01  ,0,0,0,0,0,0,0,0,0,-40000,0,0,0,0,40000,-40000,-40000
058293,光寶科凱基9A購01,0,0,0,0,0,0,0,0,0,-40000,0,0,0,212000,252000,-40000,-40000
057862,智邦凱基99購01  ,0,0,0,0,0,0,0,0,0,-40000,0,0,0,0,40000,-40000,-40000
058226,世芯元富99購01  ,0,0,0,0,0,0,0,0,0,-40000,0,0,0,0,40000,-40000,-40000
056783,國巨群益99購01  ,0,0,0,0,0,0,0,0,0,-40000,0,0,0,225000,265000,-40000,-40000
057644,奇力新元大98購04,0,0,0,0,0,0,0,0,0,-40000,0,0,0,10000,50000,-40000,-40000
054992,南亞科元富97購02,0,0,0,0,0,0,0,0,0,-40000,0,0,0,0,40000,-40000,-40000
07699P,臺股指元大9A售52,0,0,0,0,0,0,0,0,0,-40000,0,0,0,0,40000,-40000,-40000
07409P,台積電台新99售07,0,0,0,0,0,0,0,0,0,-40000,0,0,0,0,40000,-40000,-40000
061110,超眾元大9A購03  ,0,0,0,0,0,0,0,0,0,-41000,0,0,0,0,41000,-41000,-41000
061402,矽創兆豐9B購01  ,0,0,0,0,0,0,0,0,0,-41000,0,0,0,0,41000,-41000,-41000
061506,瑞祺國票9A購02  ,0,0,0,0,0,0,0,0,0,-41000,0,0,0,1000,42000,-41000,-41000
059360,全新永豐99購02  ,0,0,0,0,0,0,0,0,0,-41000,0,0,0,0,41000,-41000,-41000
060335,明泰康和9A購01  ,0,0,0,0,0,0,0,0,0,-41000,0,0,0,77000,118000,-41000,-41000
052235,聯發科國票96購02,0,0,0,0,0,0,0,0,0,-41000,0,0,0,0,41000,-41000,-41000
053635,技嘉永豐96購01  ,0,0,0,0,0,0,0,0,0,-41000,0,0,0,0,41000,-41000,-41000
056772,欣興元大99購01  ,0,0,0,0,0,0,0,0,0,-41000,0,0,0,5000,46000,-41000,-41000
057617,國巨凱基99購06  ,0,0,0,0,0,0,0,0,0,-41000,0,0,0,0,41000,-41000,-41000
056243,創意群益97購03  ,0,0,0,0,0,0,0,0,0,-41000,0,0,0,11000,52000,-41000,-41000
057712,南亞科統一9A購01,0,0,0,0,0,0,0,0,0,-41000,0,0,0,119000,160000,-41000,-41000
056998,麗豐康和98購01  ,0,0,0,0,0,0,0,0,0,-41000,0,0,0,0,41000,-41000,-41000
059850,日電貿永豐99購01,0,0,0,0,0,0,0,0,0,-42000,0,0,0,19000,61000,-42000,-42000
06327P,台積電中信01售01,0,0,0,0,0,0,0,0,0,-42000,0,0,0,200000,242000,-42000,-42000
061109,臻鼎元大9A購03  ,0,0,0,0,0,0,0,0,0,-42000,0,0,0,0,42000,-42000,-42000
060617,華新科元大9A購08,0,0,0,0,0,0,0,0,0,-42000,0,0,0,7000,49000,-42000,-42000
055382,台郡元大99購01  ,0,0,0,0,0,0,0,0,0,-42000,0,0,0,1000,43000,-42000,-42000
054925,神達凱基97購01  ,0,0,0,0,0,0,0,0,0,-42000,0,0,0,2000,44000,-42000,-42000
053216,京鼎凱基96購02  ,0,0,0,0,0,0,0,0,0,-42000,0,0,0,0,42000,-42000,-42000
054260,貿聯元大96購03  ,0,0,0,0,0,0,0,0,0,-42000,0,0,0,10000,52000,-42000,-42000
048696,台達電國票96購01,0,0,0,0,0,0,0,0,0,-42000,0,0,0,0,42000,-42000,-42000
058942,南茂中信99購01  ,0,0,0,0,0,0,0,0,0,-42000,0,0,0,30000,72000,-42000,-42000
058833,台表科永豐99購01,0,0,0,0,0,0,0,0,0,-42000,0,0,0,2000,44000,-42000,-42000
058803,世紀鋼元大99購03,0,0,0,0,0,0,0,0,0,-42000,0,0,0,25000,67000,-42000,-42000
058509,聯發科元大99購12,0,0,0,0,0,0,0,0,0,-42000,0,0,0,89000,131000,-42000,-42000
058583,臻鼎群益99購01  ,0,0,0,0,0,0,0,0,0,-42000,0,0,0,55000,97000,-42000,-42000
057571,泰碩永豐98購01  ,0,0,0,0,0,0,0,0,0,-42000,0,0,0,0,42000,-42000,-42000
057371,可成元大98購08  ,0,0,0,0,0,0,0,0,0,-42000,0,0,0,31000,73000,-42000,-42000
057240,茂林凱基9A購01  ,0,0,0,0,0,0,0,0,0,-42000,0,0,0,68000,110000,-42000,-42000
058227,台灣50元大9C購01,0,0,0,0,0,0,0,0,0,-42000,0,0,0,2000,44000,-42000,-42000
06859P,元金2X中信9C售01,0,0,0,0,0,0,0,0,0,-42000,0,0,0,24000,66000,-42000,-42000
8454,富邦媒          ,55000,99270,-44270,0,0,0,0,0,0,2000,2000,0,2000,0,0,0,-42270
060806,華新科群益9A購03,0,0,0,0,0,0,0,0,0,-43000,0,0,0,30000,73000,-43000,-43000
061066,嘉晶凱基9B購01  ,0,0,0,0,0,0,0,0,0,-43000,0,0,0,0,43000,-43000,-43000
060927,嘉晶永豐9A購01  ,0,0,0,0,0,0,0,0,0,-43000,0,0,0,0,43000,-43000,-43000
06151P,華新科元大97售07,0,0,0,0,0,0,0,0,0,-43000,0,0,0,20000,63000,-43000,-43000
06490P,鴻海富邦99售02  ,0,0,0,0,0,0,0,0,0,-43000,0,0,0,7000,50000,-43000,-43000
061233,國巨元大9A購17  ,0,0,0,0,0,0,0,0,0,-43000,0,0,0,92000,135000,-43000,-43000
060125,強茂永豐99購01  ,0,0,0,0,0,0,0,0,0,-43000,0,0,0,7000,50000,-43000,-43000
060380,T50反1凱基9A購08,0,0,0,0,0,0,0,0,0,-43000,0,0,0,112000,155000,-43000,-43000
060165,上緯控永豐9A購01,0,0,0,0,0,0,0,0,0,-43000,0,0,0,145000,188000,-43000,-43000
059299,欣興元富99購03  ,0,0,0,0,0,0,0,0,0,-43000,0,0,0,25000,68000,-43000,-43000
059740,瑞昱元富99購02  ,0,0,0,0,0,0,0,0,0,-43000,0,0,0,8000,51000,-43000,-43000
059751,華通群益9B購03  ,0,0,0,0,0,0,0,0,0,-43000,0,0,0,6000,49000,-43000,-43000
059764,健策永豐99購04  ,0,0,0,0,0,0,0,0,0,-43000,0,0,0,0,43000,-43000,-43000
059640,聯詠凱基99購04  ,0,0,0,0,0,0,0,0,0,-43000,0,0,0,60000,103000,-43000,-43000
054408,義隆國票98購01  ,0,0,0,0,0,0,0,0,0,-43000,0,0,0,0,43000,-43000,-43000
058213,欣興群益99購01  ,0,0,0,0,0,0,0,0,0,-43000,0,0,0,0,43000,-43000,-43000
057803,上銀元大98購08  ,0,0,0,0,0,0,0,0,0,-43000,0,0,0,7000,50000,-43000,-43000
058903,聯發科元大99購16,0,0,0,0,0,0,0,0,0,-43000,0,0,0,26000,69000,-43000,-43000
057003,立積國票98購01  ,0,0,0,0,0,0,0,0,0,-43000,0,0,0,2000,45000,-43000,-43000
056462,訊芯凱基98購03  ,0,0,0,0,0,0,0,0,0,-43000,0,0,0,50000,93000,-43000,-43000
059761,國巨永豐99購06  ,0,0,0,0,0,0,0,0,0,-44000,0,0,0,25000,69000,-44000,-44000
059791,超眾元大99購06  ,0,0,0,0,0,0,0,0,0,-44000,0,0,0,20000,64000,-44000,-44000
059820,南亞科凱基99購07,0,0,0,0,0,0,0,0,0,-44000,0,0,0,19000,63000,-44000,-44000
059924,世紀鋼元大99購06,0,0,0,0,0,0,0,0,0,-44000,0,0,0,8000,52000,-44000,-44000
06578P,華新科國票98售02,0,0,0,0,0,0,0,0,0,-44000,0,0,0,0,44000,-44000,-44000
060835,亞德客國票9A購01,0,0,0,0,0,0,0,0,0,-44000,0,0,0,31000,75000,-44000,-44000
061033,台光電永豐9A購01,0,0,0,0,0,0,0,0,0,-44000,0,0,0,0,44000,-44000,-44000
061012,國巨麥證9A購03  ,0,0,0,10000,254000,-244000,0,0,0,-44000,0,0,0,210000,254000,-44000,-44000
060596,元黃金凱基9A購02,0,0,0,0,0,0,0,0,0,-44000,0,0,0,64000,108000,-44000,-44000
056479,玉晶光元大99購05,0,0,0,0,0,0,0,0,0,-44000,0,0,0,6000,50000,-44000,-44000
047342,T50反1中信99購01,0,0,0,0,0,0,0,0,0,-44000,0,0,0,0,44000,-44000,-44000
056010,力成中信97購01  ,0,0,0,0,0,0,0,0,0,-44000,0,0,0,166000,210000,-44000,-44000
058587,台積電中信9C購03,0,0,0,0,0,0,0,0,0,-44000,0,0,0,0,44000,-44000,-44000
057257,台泥兆豐99購01  ,0,0,0,0,0,0,0,0,0,-44000,0,0,0,76000,120000,-44000,-44000
057370,可成元大98購07  ,0,0,0,0,0,0,0,0,0,-44000,0,0,0,38000,82000,-44000,-44000
057475,聯電元大9A購01  ,0,0,0,0,0,0,0,0,0,-44000,0,0,0,97000,141000,-44000,-44000
3014,聯陽            ,200000,263000,-63000,0,0,0,0,0,0,19000,41000,0,41000,3000,25000,-22000,-44000
060584,玉晶光元富9A購01,0,0,0,0,0,0,0,0,0,-45000,0,0,0,4000,49000,-45000,-45000
061150,國巨群益9A購09  ,0,0,0,0,0,0,0,0,0,-45000,0,0,0,277000,322000,-45000,-45000
059919,宏達電元大99購06,0,0,0,0,0,0,0,0,0,-45000,0,0,0,221000,266000,-45000,-45000
059946,健策永豐99購05  ,0,0,0,0,0,0,0,0,0,-45000,0,0,0,0,45000,-45000,-45000
060295,貿聯元大9A購03  ,0,0,0,0,0,0,0,0,0,-45000,0,0,0,0,45000,-45000,-45000
053921,嘉晶國票97購03  ,0,0,0,0,0,0,0,0,0,-45000,0,0,0,0,45000,-45000,-45000
053431,志超永豐96購01  ,0,0,0,0,0,0,0,0,0,-45000,0,0,0,70000,115000,-45000,-45000
053378,台積電元大98購02,0,0,0,0,0,0,0,0,0,-45000,0,0,0,0,45000,-45000,-45000
055138,大毅永豐97購02  ,0,0,0,0,0,0,0,0,0,-45000,0,0,0,0,45000,-45000,-45000
057788,嘉聯益國票99購01,0,0,0,0,0,0,0,0,0,-45000,0,0,0,64000,109000,-45000,-45000
058844,元油2X群益9C購03,0,0,0,0,0,0,0,0,0,-45000,0,0,0,5000,50000,-45000,-45000
058733,同欣電永豐99購02,0,0,0,0,0,0,0,0,0,-45000,0,0,0,21000,66000,-45000,-45000
056936,禾伸堂元富98購01,0,0,0,0,0,0,0,0,0,-45000,0,0,0,222000,267000,-45000,-45000
07178P,臺股指凱基99售20,0,0,0,0,0,0,0,0,0,-45000,0,0,0,6000,51000,-45000,-45000
07202P,台灣50凱基9C售04,0,0,0,0,0,0,0,0,0,-45000,0,0,0,45000,90000,-45000,-45000
07290P,台灣50凱基9A售08,0,0,0,0,0,0,0,0,0,-45000,0,0,0,305000,350000,-45000,-45000
3346,麗清            ,21000,66000,-45000,0,0,0,0,0,0,0,0,0,0,0,0,0,-45000
3031,佰鴻            ,74000,119000,-45000,0,0,0,0,0,0,0,0,0,0,0,0,0,-45000
060315,易華電永豐9A購01,0,0,0,0,0,0,0,0,0,-46000,0,0,0,40000,86000,-46000,-46000
059975,元金2X元大99購02,0,0,0,0,0,0,0,0,0,-46000,0,0,0,12000,58000,-46000,-46000
060020,康控康和99購01  ,0,0,0,0,0,0,0,0,0,-46000,0,0,0,31000,77000,-46000,-46000
059458,鎧勝永豐99購01  ,0,0,0,0,0,0,0,0,0,-46000,0,0,0,11000,57000,-46000,-46000
060591,富邦金台新9A購01,0,0,0,0,0,0,0,0,0,-46000,0,0,0,0,46000,-46000,-46000
060944,國泰金國票9A購01,0,0,0,0,0,0,0,0,0,-46000,0,0,0,38000,84000,-46000,-46000
054457,強茂群益96購01  ,0,0,0,0,0,0,0,0,0,-46000,0,0,0,0,46000,-46000,-46000
054904,興勤康和97購01  ,0,0,0,0,0,0,0,0,0,-46000,0,0,0,0,46000,-46000,-46000
048892,台郡元富97購01  ,0,0,0,0,0,0,0,0,0,-46000,0,0,0,20000,66000,-46000,-46000
05590P,臺股指中信96售05,0,0,0,0,0,0,0,0,0,-46000,0,0,0,0,46000,-46000,-46000
055844,大毅元大98購01  ,0,0,0,0,0,0,0,0,0,-46000,0,0,0,49000,95000,-46000,-46000
055815,亞光國票99購01  ,0,0,0,0,0,0,0,0,0,-46000,0,0,0,90000,136000,-46000,-46000
056475,宏達電元大99購02,0,0,0,0,0,0,0,0,0,-46000,0,0,0,0,46000,-46000,-46000
056743,貿聯凱基98購04  ,0,0,0,0,0,0,0,0,0,-46000,0,0,0,0,46000,-46000,-46000
056644,宏達電凱基98購04,0,0,0,0,0,0,0,0,0,-46000,0,0,0,86000,132000,-46000,-46000
055631,創意永豐98購01  ,0,0,0,0,0,0,0,0,0,-46000,0,0,0,27000,73000,-46000,-46000
1439,中和            ,140000,186000,-46000,0,0,0,0,0,0,0,0,0,0,0,0,0,-46000
059296,大立光元富99購06,0,0,0,0,0,0,0,0,0,-47000,0,0,0,127000,174000,-47000,-47000
059188,京元電富邦9B購01,0,0,0,0,0,0,0,0,0,-47000,0,0,0,128000,175000,-47000,-47000
059867,華邦電凱基99購02,0,0,0,0,0,0,0,0,0,-47000,0,0,0,124000,171000,-47000,-47000
060291,高鐵元大9A購01  ,0,0,0,0,0,0,0,0,0,-47000,0,0,0,49000,96000,-47000,-47000
060246,晶相光元大9C購03,0,0,0,0,0,0,0,0,0,-47000,0,0,0,157000,204000,-47000,-47000
060466,玉山金元大9A購01,0,0,0,0,0,0,0,0,0,-47000,0,0,0,116000,163000,-47000,-47000
048189,臺指反元大96購06,0,0,0,0,0,0,0,0,0,-47000,0,0,0,14000,61000,-47000,-47000
050481,泰鼎國票96購01  ,0,0,0,0,0,0,0,0,0,-47000,0,0,0,17000,64000,-47000,-47000
054058,晶豪科國票98購01,0,0,0,0,0,0,0,0,0,-47000,0,0,0,0,47000,-47000,-47000
056492,全新國泰9A購01  ,0,0,0,0,0,0,0,0,0,-47000,0,0,0,156000,203000,-47000,-47000
05524P,瀚宇博國票97售02,0,0,0,0,0,0,0,0,0,-47000,0,0,0,25000,72000,-47000,-47000
058132,義隆元大99購03  ,0,0,0,0,0,0,0,0,0,-47000,0,0,0,312000,359000,-47000,-47000
058800,健策元大99購03  ,0,0,0,0,0,0,0,0,0,-47000,0,0,0,35000,82000,-47000,-47000
059984,華新科元大99購21,0,0,0,0,0,0,0,0,0,-48000,0,0,0,6000,54000,-48000,-48000
06012P,世芯國票96售01  ,0,0,0,0,0,0,0,0,0,-48000,0,0,0,134000,182000,-48000,-48000
060127,牧德永豐99購02  ,0,0,0,0,0,0,0,0,0,-48000,0,0,0,25000,73000,-48000,-48000
061156,玉晶光群益9A購07,0,0,0,0,0,0,0,0,0,-48000,0,0,0,0,48000,-48000,-48000
061141,臻鼎統一9A購01  ,0,0,0,0,0,0,0,0,0,-48000,0,0,0,48000,96000,-48000,-48000
061424,華新科元大9A購18,0,0,0,0,0,0,0,0,0,-48000,0,0,0,9000,57000,-48000,-48000
052864,奇力新凱基96購02,0,0,0,0,0,0,0,0,0,-48000,0,0,0,0,48000,-48000,-48000
058975,台灣50凱基01購02,0,0,0,0,0,0,0,0,0,-48000,0,0,0,0,48000,-48000,-48000
058687,聯茂凱基9A購01  ,0,0,0,0,0,0,0,0,0,-48000,0,0,0,0,48000,-48000,-48000
058699,楠梓電元大99購02,0,0,0,0,0,0,0,0,0,-48000,0,0,0,20000,68000,-48000,-48000
058642,旺宏麥證9A購01  ,0,0,0,220000,268000,-48000,0,0,0,-48000,0,0,0,220000,268000,-48000,-48000
05683P,矽創元大96售01  ,0,0,0,0,0,0,0,0,0,-48000,0,0,0,2000,50000,-48000,-48000
055949,亞德客元大97購04,0,0,0,0,0,0,0,0,0,-48000,0,0,0,23000,71000,-48000,-48000
058348,台表科群益99購01,0,0,0,0,0,0,0,0,0,-48000,0,0,0,7000,55000,-48000,-48000
055653,聯詠元富01購02  ,0,0,0,0,0,0,0,0,0,-48000,0,0,0,0,48000,-48000,-48000
057174,南亞科元大98購05,0,0,0,0,0,0,0,0,0,-48000,0,0,0,102000,150000,-48000,-48000
07775P,國巨群益9A售10  ,0,0,0,0,0,0,0,0,0,-48000,0,0,0,40000,88000,-48000,-48000
08525P,台灣50凱基96售02,0,0,0,0,0,0,0,0,0,-48000,0,0,0,150000,198000,-48000,-48000
1730,花仙子          ,72000,120000,-48000,0,0,0,0,0,0,0,0,0,0,0,0,0,-48000
6230,超眾            ,114000,195000,-81000,0,0,0,36000,0,36000,-3000,0,0,0,29000,32000,-3000,-48000
061478,奇鋐元大9A購01  ,0,0,0,0,0,0,0,0,0,-49000,0,0,0,0,49000,-49000,-49000
061469,瑞祺群益9A購02  ,0,0,0,0,0,0,0,0,0,-49000,0,0,0,16000,65000,-49000,-49000
061305,帆宣永豐9A購01  ,0,0,0,0,0,0,0,0,0,-49000,0,0,0,10000,59000,-49000,-49000
060822,華通元大9A購05  ,0,0,0,0,0,0,0,0,0,-49000,0,0,0,27000,76000,-49000,-49000
060879,華新科中信9A購02,0,0,0,0,0,0,0,0,0,-49000,0,0,0,75000,124000,-49000,-49000
060755,鴻海元大9A購15  ,0,0,0,0,0,0,0,0,0,-49000,0,0,0,1000,50000,-49000,-49000
060092,瑞昱元大99購03  ,0,0,0,0,0,0,0,0,0,-49000,0,0,0,110000,159000,-49000,-49000
06000P,GIS元大96售04   ,0,0,0,0,0,0,0,0,0,-49000,0,0,0,7000,56000,-49000,-49000
059889,華新科國票99購04,0,0,0,0,0,0,0,0,0,-49000,0,0,0,6000,55000,-49000,-49000
060238,強茂元大9C購01  ,0,0,0,0,0,0,0,0,0,-49000,0,0,0,2000,51000,-49000,-49000
060213,牧德康和9A購01  ,0,0,0,0,0,0,0,0,0,-49000,0,0,0,76000,125000,-49000,-49000
060202,康友元富9A購01  ,0,0,0,0,0,0,0,0,0,-49000,0,0,0,30000,79000,-49000,-49000
053637,強茂永豐96購01  ,0,0,0,0,0,0,0,0,0,-49000,0,0,0,2000,51000,-49000,-49000
054662,同欣電元大97購02,0,0,0,0,0,0,0,0,0,-49000,0,0,0,0,49000,-49000,-49000
057835,華擎元富9B購01  ,0,0,0,0,0,0,0,0,0,-49000,0,0,0,117000,166000,-49000,-49000
055648,可成元富97購01  ,0,0,0,0,0,0,0,0,0,-49000,0,0,0,7000,56000,-49000,-49000
058322,玉晶光永豐99購02,0,0,0,0,0,0,0,0,0,-49000,0,0,0,0,49000,-49000,-49000
055136,聯發科富邦99購06,0,0,0,0,0,0,0,0,0,-49000,0,0,0,10000,59000,-49000,-49000
056352,鴻海元大99購01  ,0,0,0,0,0,0,0,0,0,-49000,0,0,0,0,49000,-49000,-49000
07134P,臺股指元大9A售28,0,0,0,0,0,0,0,0,0,-49000,0,0,0,5000,54000,-49000,-49000
06044P,同欣電永豐96售03,0,0,0,0,0,0,0,0,0,-50000,0,0,0,0,50000,-50000,-50000
060450,南亞元大9A購02  ,0,0,0,0,0,0,0,0,0,-50000,0,0,0,0,50000,-50000,-50000
059961,T50反1凱基99購09,0,0,0,0,0,0,0,0,0,-50000,0,0,0,160000,210000,-50000,-50000
059230,滬深2X國票9B購02,0,0,0,0,0,0,0,0,0,-50000,0,0,0,0,50000,-50000,-50000
059181,世紀鋼元富9C購01,0,0,0,0,0,0,0,0,0,-50000,0,0,0,0,50000,-50000,-50000
059673,玉山金元富99購01,0,0,0,0,0,0,0,0,0,-50000,0,0,0,21000,71000,-50000,-50000
060678,聯詠元大9A購03  ,0,0,0,0,0,0,0,0,0,-50000,0,0,0,18000,68000,-50000,-50000
060653,全新群益9A購02  ,0,0,0,0,0,0,0,0,0,-50000,0,0,0,36000,86000,-50000,-50000
060530,聯發科中信9C購03,0,0,0,0,0,0,0,0,0,-50000,0,0,0,11000,61000,-50000,-50000
060844,大立光國票9A購07,0,0,0,0,0,0,0,0,0,-50000,0,0,0,0,50000,-50000,-50000
061016,可成麥證9A購01  ,0,0,0,0,50000,-50000,0,0,0,-50000,0,0,0,0,50000,-50000,-50000
061368,南六國票9A購01  ,0,0,0,0,0,0,0,0,0,-50000,0,0,0,113000,163000,-50000,-50000
061194,聯鈞永豐9A購02  ,0,0,0,0,0,0,0,0,0,-50000,0,0,0,2000,52000,-50000,-50000
06710P,臺股指台新99售07,0,0,0,0,0,0,0,0,0,-50000,70000,0,70000,370000,490000,-120000,-50000
06452P,大立光元大98售08,0,0,0,0,0,0,0,0,0,-50000,0,0,0,0,50000,-50000,-50000
053124,聯發科凱基96購12,0,0,0,0,0,0,0,0,0,-50000,0,0,0,0,50000,-50000,-50000
053611,聯茂麥證96購01  ,0,0,0,0,50000,-50000,0,0,0,-50000,0,0,0,0,50000,-50000,-50000
056578,智易元大99購02  ,0,0,0,0,0,0,0,0,0,-50000,0,0,0,136000,186000,-50000,-50000
054866,宏盛群益98購01  ,0,0,0,0,0,0,0,0,0,-50000,0,0,0,0,50000,-50000,-50000
054491,瀚宇博台新96購02,0,0,0,0,0,0,0,0,0,-50000,0,0,0,0,50000,-50000,-50000
054098,嘉晶國票97購04  ,0,0,0,0,0,0,0,0,0,-50000,0,0,0,0,50000,-50000,-50000
050615,奇力新元大95購03,0,0,0,0,0,0,0,0,0,-50000,0,0,0,0,50000,-50000,-50000
050227,大立光中信96購01,0,0,0,0,0,0,0,0,0,-50000,0,0,0,10000,60000,-50000,-50000
03017X,元展17          ,0,0,0,0,0,0,0,0,0,-50000,0,0,0,0,50000,-50000,-50000
053955,華通永豐96購04  ,0,0,0,0,0,0,0,0,0,-50000,0,0,0,0,50000,-50000,-50000
053865,欣興元大97購02  ,0,0,0,0,0,0,0,0,0,-50000,0,0,0,0,50000,-50000,-50000
052511,聯發科凱基95購14,0,0,0,0,0,0,0,0,0,-50000,0,0,0,10000,60000,-50000,-50000
051570,和碩富邦97購01  ,0,0,0,0,0,0,0,0,0,-50000,0,0,0,0,50000,-50000,-50000
051236,鴻海元大96購05  ,0,0,0,0,0,0,0,0,0,-50000,0,0,0,0,50000,-50000,-50000
056366,玉晶光元大99購04,0,0,0,0,0,0,0,0,0,-50000,0,0,0,1000,51000,-50000,-50000
056104,義隆永豐97購01  ,0,0,0,0,0,0,0,0,0,-50000,0,0,0,18000,68000,-50000,-50000
056863,義隆群益98購01  ,0,0,0,0,0,0,0,0,0,-50000,0,0,0,13000,63000,-50000,-50000
056076,超眾元大97購05  ,0,0,0,0,0,0,0,0,0,-50000,0,0,0,0,50000,-50000,-50000
055841,南亞科元大97購04,0,0,0,0,0,0,0,0,0,-50000,0,0,0,0,50000,-50000,-50000
055847,大立光元大97購10,0,0,0,0,0,0,0,0,0,-50000,0,0,0,0,50000,-50000,-50000
056975,元油2X群益98購03,0,0,0,0,0,0,0,0,0,-50000,0,0,0,0,50000,-50000,-50000
058684,健策凱基99購02  ,0,0,0,0,0,0,0,0,0,-50000,0,0,0,12000,62000,-50000,-50000
058487,晶技國票9A購01  ,0,0,0,0,0,0,0,0,0,-50000,0,0,0,46000,96000,-50000,-50000
059068,台虹國票9A購01  ,0,0,0,0,0,0,0,0,0,-50000,0,0,0,0,50000,-50000,-50000
058791,鴻海元大99購17  ,0,0,0,0,0,0,0,0,0,-50000,0,0,0,17000,67000,-50000,-50000
05813P,臺股指國票96售06,0,0,0,0,0,0,0,0,0,-50000,0,0,0,0,50000,-50000,-50000
058261,大立光富邦03購01,0,0,0,0,0,0,0,0,0,-50000,0,0,0,0,50000,-50000,-50000
055681,奇鋐凱基98購03  ,0,0,0,0,0,0,0,0,0,-50000,0,0,0,0,50000,-50000,-50000
057607,旺宏台新98購02  ,0,0,0,0,0,0,0,0,0,-50000,0,0,0,30000,80000,-50000,-50000
057623,友訊國泰99購01  ,0,0,0,0,0,0,0,0,0,-50000,0,0,0,50000,100000,-50000,-50000
058009,智易國票99購01  ,0,0,0,0,0,0,0,0,0,-50000,0,0,0,3000,53000,-50000,-50000
057353,玉晶光統一99購01,0,0,0,0,0,0,0,0,0,-50000,0,0,0,0,50000,-50000,-50000
057395,旺宏中信98購03  ,0,0,0,0,0,0,0,0,0,-50000,0,0,0,260000,310000,-50000,-50000
055564,茂林凱基98購01  ,0,0,0,0,0,0,0,0,0,-50000,0,0,0,10000,60000,-50000,-50000
057198,智伸科統一9B購01,0,0,0,0,0,0,0,0,0,-50000,0,0,0,0,50000,-50000,-50000
07109P,聯發科中信9B售02,0,0,0,0,0,0,0,0,0,-50000,0,0,0,0,50000,-50000,-50000
07192P,聯發科元大99售23,0,0,0,0,0,0,0,0,0,-50000,0,0,0,0,50000,-50000,-50000
07456P,華新科元大9A售06,0,0,0,0,0,0,0,0,0,-50000,0,0,0,0,50000,-50000,-50000
07338P,滬深2X凱基99售02,0,0,0,0,0,0,0,0,0,-50000,0,0,0,0,50000,-50000,-50000
07633P,台灣50元大9A售18,0,0,0,0,0,0,0,0,0,-50000,0,0,0,0,50000,-50000,-50000
061124,微星永豐9A購02  ,0,0,0,0,0,0,0,0,0,-51000,0,0,0,0,51000,-51000,-51000
060397,群創國票9A購01  ,0,0,0,0,0,0,0,0,0,-51000,0,0,0,216000,267000,-51000,-51000
050424,鴻海凱基96購03  ,0,0,0,0,0,0,0,0,0,-51000,0,0,0,0,51000,-51000,-51000
042792,T50反1台新9C購01,0,0,0,0,0,0,0,0,0,-51000,0,0,0,0,51000,-51000,-51000
057277,可成元大98購05  ,0,0,0,0,0,0,0,0,0,-51000,0,0,0,0,51000,-51000,-51000
057401,晶豪科群益99購01,0,0,0,0,0,0,0,0,0,-51000,0,0,0,131000,182000,-51000,-51000
057647,欣興元大98購10  ,0,0,0,0,0,0,0,0,0,-51000,0,0,0,0,51000,-51000,-51000
059001,聯發科元大99購17,0,0,0,0,0,0,0,0,0,-51000,0,0,0,10000,61000,-51000,-51000
056165,矽力凱基98購02  ,0,0,0,0,0,0,0,0,0,-51000,0,0,0,0,51000,-51000,-51000
07143P,FBVIX元大99售02 ,0,0,0,0,0,0,0,0,0,-51000,0,0,0,0,51000,-51000,-51000
060395,儒鴻國票9A購01  ,0,0,0,0,0,0,0,0,0,-52000,0,0,0,24000,76000,-52000,-52000
060235,瑞昱元大9A購01  ,0,0,0,0,0,0,0,0,0,-52000,0,0,0,75000,127000,-52000,-52000
059983,聯發科元大99購38,0,0,0,0,0,0,0,0,0,-52000,0,0,0,50000,102000,-52000,-52000
060072,國巨元富99購04  ,0,0,0,0,0,0,0,0,0,-52000,0,0,0,6000,58000,-52000,-52000
059249,大立光凱基99購05,0,0,0,0,0,0,0,0,0,-52000,0,0,0,12000,64000,-52000,-52000
059440,康控元大9B購01  ,0,0,0,0,0,0,0,0,0,-52000,0,0,0,19000,71000,-52000,-52000
05060P,台達電富邦97售02,0,0,0,0,0,0,0,0,0,-52000,0,0,0,9000,61000,-52000,-52000
03658C,T50反1元大9A牛02,0,0,0,0,0,0,0,0,0,-52000,0,0,0,1000,53000,-52000,-52000
05160P,國巨國票96售03  ,0,0,0,0,0,0,0,0,0,-52000,0,0,0,112000,164000,-52000,-52000
053994,微星群益96購01  ,0,0,0,0,0,0,0,0,0,-52000,0,0,0,0,52000,-52000,-52000
053067,牧德群益96購01  ,0,0,0,0,0,0,0,0,0,-52000,0,0,0,0,52000,-52000,-52000
056307,貿聯元大97購05  ,0,0,0,0,0,0,0,0,0,-52000,0,0,0,0,52000,-52000,-52000
059061,晶技凱基9A購01  ,0,0,0,0,0,0,0,0,0,-52000,0,0,0,58000,110000,-52000,-52000
058616,台虹元大9A購01  ,0,0,0,0,0,0,0,0,0,-52000,0,0,0,3000,55000,-52000,-52000
058510,全新元大9B購02  ,0,0,0,0,0,0,0,0,0,-52000,0,0,0,0,52000,-52000,-52000
056738,國巨凱基9A購02  ,0,0,0,0,0,0,0,0,0,-52000,0,0,0,266000,318000,-52000,-52000
055597,禾伸堂元大98購02,0,0,0,0,0,0,0,0,0,-52000,0,0,0,55000,107000,-52000,-52000
07060P,台表科國票9A售01,0,0,0,0,0,0,0,0,0,-52000,0,0,0,20000,72000,-52000,-52000
07748P,茂林凱基9A售04  ,0,0,0,0,0,0,0,0,0,-52000,0,0,0,0,52000,-52000,-52000
059223,大立光元大99購14,0,0,0,0,0,0,0,0,0,-53000,0,0,0,0,53000,-53000,-53000
059170,康控凱基9B購01  ,0,0,0,0,0,0,0,0,0,-53000,0,0,0,82000,135000,-53000,-53000
059530,華新科凱基9A購05,0,0,0,0,0,0,0,0,0,-53000,0,0,0,6000,59000,-53000,-53000
061238,晶技元大9A購02  ,0,0,0,0,0,0,0,0,0,-53000,0,0,0,34000,87000,-53000,-53000
061352,茂林元大9A購04  ,0,0,0,0,0,0,0,0,0,-53000,0,0,0,53000,106000,-53000,-53000
060560,欣興國泰9C購01  ,0,0,0,0,0,0,0,0,0,-53000,0,0,0,30000,83000,-53000,-53000
054912,群光凱基97購01  ,0,0,0,0,0,0,0,0,0,-53000,0,0,0,82000,135000,-53000,-53000
053410,啟碁兆豐96購01  ,0,0,0,0,0,0,0,0,0,-53000,0,0,0,0,53000,-53000,-53000
05467P,聯電元大95售02  ,0,0,0,0,0,0,0,0,0,-53000,0,0,0,12000,65000,-53000,-53000
049820,世紀鋼元大96購03,0,0,0,0,0,0,0,0,0,-53000,0,0,0,0,53000,-53000,-53000
056767,大毅元大99購01  ,0,0,0,0,0,0,0,0,0,-53000,0,0,0,3000,56000,-53000,-53000
058534,友達統一9B購01  ,0,0,0,0,0,0,0,0,0,-53000,0,0,0,0,53000,-53000,-53000
056406,建準國票99購01  ,0,0,0,0,0,0,0,0,0,-53000,0,0,0,165000,218000,-53000,-53000
056904,大立光元大99購05,0,0,0,0,0,0,0,0,0,-53000,0,0,0,0,53000,-53000,-53000
07617P,聯發科中信9C售04,0,0,0,0,0,0,0,0,0,-53000,0,0,0,70000,123000,-53000,-53000
07671P,超眾元大9A售04  ,0,0,0,0,0,0,0,0,0,-53000,0,0,0,0,53000,-53000,-53000
07536P,華新科元富9A售04,0,0,0,0,0,0,0,0,0,-53000,0,0,0,10000,63000,-53000,-53000
060581,玉晶光群益9B購02,0,0,0,0,0,0,0,0,0,-54000,0,0,0,0,54000,-54000,-54000
061024,南電國泰9B購01  ,0,0,0,0,0,0,0,0,0,-54000,0,0,0,39000,93000,-54000,-54000
061343,大立光元大9A購04,0,0,0,0,0,0,0,0,0,-54000,0,0,0,0,54000,-54000,-54000
061325,晶技凱基9A購03  ,0,0,0,0,0,0,0,0,0,-54000,0,0,0,0,54000,-54000,-54000
059172,台郡凱基99購03  ,0,0,0,0,0,0,0,0,0,-54000,0,0,0,0,54000,-54000,-54000
059131,國巨群益99購07  ,0,0,0,0,0,0,0,0,0,-54000,0,0,0,225000,279000,-54000,-54000
059284,緯穎永豐99購03  ,0,0,0,0,0,0,0,0,0,-54000,0,0,0,23000,77000,-54000,-54000
060103,聯詠元大99購01  ,0,0,0,0,0,0,0,0,0,-54000,0,0,0,16000,70000,-54000,-54000
059861,聯發科群益9A購01,0,0,0,0,0,0,0,0,0,-54000,0,0,0,34000,88000,-54000,-54000
060306,台肥永豐9A購01  ,0,0,0,0,0,0,0,0,0,-54000,0,0,0,28000,82000,-54000,-54000
060424,中租永豐9A購01  ,0,0,0,0,0,0,0,0,0,-54000,0,0,0,0,54000,-54000,-54000
048589,國巨兆豐96購01  ,0,0,0,0,0,0,0,0,0,-54000,0,0,0,0,54000,-54000,-54000
052062,臺股指國票95購09,0,0,0,0,0,0,0,0,0,-54000,0,0,0,1000,55000,-54000,-54000
053389,彩晶元大98購01  ,0,0,0,0,0,0,0,0,0,-54000,0,0,0,0,54000,-54000,-54000
055318,華通國票98購01  ,0,0,0,0,0,0,0,0,0,-54000,0,0,0,79000,133000,-54000,-54000
052821,晶技永豐96購01  ,0,0,0,0,0,0,0,0,0,-54000,0,0,0,1000,55000,-54000,-54000
056860,正崴群益98購01  ,0,0,0,0,0,0,0,0,0,-54000,0,0,0,76000,130000,-54000,-54000
058797,大毅元大99購03  ,0,0,0,0,0,0,0,0,0,-54000,0,0,0,85000,139000,-54000,-54000
057614,華新科元富99購04,0,0,0,0,0,0,0,0,0,-54000,0,0,0,145000,199000,-54000,-54000
05564P,玉晶光元大97售02,0,0,0,0,0,0,0,0,0,-54000,0,0,0,26000,80000,-54000,-54000
07470P,國巨元大9A售06  ,0,0,0,0,0,0,0,0,0,-54000,0,0,0,86000,140000,-54000,-54000
07420P,可成元大99售07  ,0,0,0,0,0,0,0,0,0,-54000,0,0,0,16000,70000,-54000,-54000
6277,宏正            ,36000,90000,-54000,0,0,0,0,0,0,0,0,0,0,0,0,0,-54000
060252,緯穎元大9A購02  ,0,0,0,0,0,0,0,0,0,-55000,0,0,0,40000,95000,-55000,-55000
060063,可成兆豐9B購01  ,0,0,0,0,0,0,0,0,0,-55000,0,0,0,0,55000,-55000,-55000
059120,致伸永豐99購01  ,0,0,0,0,0,0,0,0,0,-55000,0,0,0,0,55000,-55000,-55000
059817,華通凱基99購05  ,0,0,0,0,0,0,0,0,0,-55000,0,0,0,19000,74000,-55000,-55000
061477,晶豪科元大9A購01,0,0,0,0,0,0,0,0,0,-55000,0,0,0,0,55000,-55000,-55000
06424P,大成鋼永豐97售01,0,0,0,0,0,0,0,0,0,-55000,0,0,0,0,55000,-55000,-55000
061510,嘉澤富邦9C購01  ,0,0,0,0,0,0,0,0,0,-55000,0,0,0,0,55000,-55000,-55000
060498,華通元大9A購03  ,0,0,0,0,0,0,0,0,0,-55000,0,0,0,5000,60000,-55000,-55000
054057,晶豪科國票97購01,0,0,0,0,0,0,0,0,0,-55000,0,0,0,45000,100000,-55000,-55000
05485P,旺宏凱基95售08  ,0,0,0,0,0,0,0,0,0,-55000,0,0,0,0,55000,-55000,-55000
054612,慧洋永豐97購01  ,0,0,0,0,0,0,0,0,0,-55000,0,0,0,0,55000,-55000,-55000
051026,健策統一96購01  ,0,0,0,0,0,0,0,0,0,-55000,0,0,0,64000,119000,-55000,-55000
052696,玉晶光麥證97購01,0,0,0,52000,124000,-72000,0,0,0,-55000,0,0,0,70000,125000,-55000,-55000
052295,揚明光國票96購03,0,0,0,0,0,0,0,0,0,-55000,0,0,0,25000,80000,-55000,-55000
045479,T50反1中信95購01,0,0,0,0,0,0,0,0,0,-55000,0,0,0,0,55000,-55000,-55000
03421B,臺股指元大99熊01,0,0,0,0,0,0,0,0,0,-55000,0,0,0,146000,201000,-55000,-55000
057148,玉晶光國票99購04,0,0,0,0,0,0,0,0,0,-55000,0,0,0,1000,56000,-55000,-55000
058295,欣興凱基99購02  ,0,0,0,0,0,0,0,0,0,-55000,0,0,0,204000,259000,-55000,-55000
058972,新日興永豐9A購01,0,0,0,0,0,0,0,0,0,-55000,0,0,0,0,55000,-55000,-55000
058964,群創兆豐99購01  ,0,0,0,0,0,0,0,0,0,-55000,0,0,0,317000,372000,-55000,-55000
056343,高鐵凱基98購02  ,0,0,0,0,0,0,0,0,0,-55000,0,0,0,0,55000,-55000,-55000
056038,可成凱基97購01  ,0,0,0,0,0,0,0,0,0,-55000,0,0,0,21000,76000,-55000,-55000
07133P,臺股指元大9A售27,0,0,0,0,0,0,0,0,0,-55000,0,0,0,0,55000,-55000,-55000
06137P,玉晶光永豐97售04,0,0,0,0,0,0,0,0,0,-56000,0,0,0,251000,307000,-56000,-56000
059910,鴻海元大99購37  ,0,0,0,0,0,0,0,0,0,-56000,0,0,0,18000,74000,-56000,-56000
051463,世芯國泰97購02  ,0,0,0,0,0,0,0,0,0,-56000,0,0,0,106000,162000,-56000,-56000
053355,超眾兆豐97購01  ,0,0,0,0,0,0,0,0,0,-56000,0,0,0,41000,97000,-56000,-56000
056380,麗豐元富98購01  ,0,0,0,0,0,0,0,0,0,-56000,0,0,0,0,56000,-56000,-56000
058479,亞光凱基9A購01  ,0,0,0,0,0,0,0,0,0,-56000,0,0,0,0,56000,-56000,-56000
058180,華新科國泰9A購01,0,0,0,0,0,0,0,0,0,-56000,0,0,0,562000,618000,-56000,-56000
055626,力山永豐97購01  ,0,0,0,0,0,0,0,0,0,-56000,0,0,0,0,56000,-56000,-56000
058054,台積電統一9C購01,0,0,0,0,0,0,0,0,0,-56000,0,0,0,0,56000,-56000,-56000
07670P,茂林元大9A售02  ,0,0,0,0,0,0,0,0,0,-56000,0,0,0,61000,117000,-56000,-56000
1732,毛寶            ,408000,464000,-56000,0,0,0,0,0,0,0,0,0,0,0,0,0,-56000
2340,光磊            ,203000,190000,13000,0,0,0,0,0,0,-69000,1000,26000,-25000,10000,54000,-44000,-56000
059990,健策元大9A購01  ,0,0,0,0,0,0,0,0,0,-57000,0,0,0,8000,65000,-57000,-57000
060203,緯穎元富9A購01  ,0,0,0,0,0,0,0,0,0,-57000,0,0,0,20000,77000,-57000,-57000
061393,緯穎群益9A購01  ,0,0,0,0,0,0,0,0,0,-57000,0,0,0,58000,115000,-57000,-57000
061134,大成鋼統一9C購01,0,0,0,0,0,0,0,0,0,-57000,0,0,0,246000,303000,-57000,-57000
052946,智原國票97購02  ,0,0,0,0,0,0,0,0,0,-57000,0,0,0,66000,123000,-57000,-57000
054252,奇力新元大96購04,0,0,0,0,0,0,0,0,0,-57000,0,0,0,11000,68000,-57000,-57000
056627,訊芯永豐98購01  ,0,0,0,0,0,0,0,0,0,-57000,0,0,0,0,57000,-57000,-57000
057579,長榮航中信9A購01,0,0,0,0,0,0,0,0,0,-57000,0,0,0,0,57000,-57000,-57000
057859,神達康和98購01  ,0,0,0,0,0,0,0,0,0,-57000,0,0,0,0,57000,-57000,-57000
055295,瀚宇博元大97購02,0,0,0,0,0,0,0,0,0,-57000,0,0,0,60000,117000,-57000,-57000
057937,神達群益98購02  ,0,0,0,0,0,0,0,0,0,-57000,0,0,0,0,57000,-57000,-57000
058743,可成康和99購01  ,0,0,0,0,0,0,0,0,0,-57000,0,0,0,6000,63000,-57000,-57000
056900,可成元大98購02  ,0,0,0,0,0,0,0,0,0,-57000,0,0,0,25000,82000,-57000,-57000
07729P,臺股指凱基9A售21,0,0,0,0,0,0,0,0,0,-57000,0,0,0,34000,91000,-57000,-57000
07588P,滬深2X國票9C售01,0,0,0,0,0,0,0,0,0,-57000,0,0,0,0,57000,-57000,-57000
061482,健策元大9C購01  ,0,0,0,0,0,0,0,0,0,-58000,0,0,0,16000,74000,-58000,-58000
06214P,國巨國票98售04  ,0,0,0,0,0,0,0,0,0,-58000,0,0,0,80000,138000,-58000,-58000
060645,台表科永豐9A購02,0,0,0,0,0,0,0,0,0,-58000,0,0,0,3000,61000,-58000,-58000
061017,國泰金麥證9A購01,0,0,0,0,58000,-58000,0,0,0,-58000,0,0,0,0,58000,-58000,-58000
059977,鴻海元大99購40  ,0,0,0,0,0,0,0,0,0,-58000,0,0,0,20000,78000,-58000,-58000
059948,正文永豐99購01  ,0,0,0,0,0,0,0,0,0,-58000,0,0,0,47000,105000,-58000,-58000
060019,彰銀康和99購01  ,0,0,0,0,0,0,0,0,0,-58000,0,0,0,0,58000,-58000,-58000
060061,旺宏兆豐99購02  ,0,0,0,0,0,0,0,0,0,-58000,0,0,0,37000,95000,-58000,-58000
059314,上銀元大99購03  ,0,0,0,0,0,0,0,0,0,-58000,0,0,0,4000,62000,-58000,-58000
053627,宏碁兆豐97購01  ,0,0,0,0,0,0,0,0,0,-58000,0,0,0,0,58000,-58000,-58000
00652,富邦印度        ,0,68000,-68000,0,0,0,0,0,0,10000,0,0,0,50000,40000,10000,-58000
058521,日月光元大99購01,0,0,0,0,0,0,0,0,0,-58000,0,0,0,50000,108000,-58000,-58000
058531,華通元富99購01  ,0,0,0,0,0,0,0,0,0,-58000,0,0,0,38000,96000,-58000,-58000
058572,百和凱基9A購01  ,0,0,0,0,0,0,0,0,0,-58000,0,0,0,0,58000,-58000,-58000
058208,百和凱基99購01  ,0,0,0,0,0,0,0,0,0,-58000,0,0,0,70000,128000,-58000,-58000
055665,亞德客群益97購01,0,0,0,0,0,0,0,0,0,-58000,0,0,0,0,58000,-58000,-58000
05555P,健策群益98售01  ,0,0,0,0,0,0,0,0,0,-58000,0,0,0,0,58000,-58000,-58000
057298,旭富永豐98購01  ,0,0,0,0,0,0,0,0,0,-58000,0,0,0,52000,110000,-58000,-58000
07466P,亞德客元大9A售02,0,0,0,0,0,0,0,0,0,-58000,0,0,0,24000,82000,-58000,-58000
059364,昇陽半永豐99購02,0,0,0,0,0,0,0,0,0,-59000,0,0,0,13000,72000,-59000,-59000
059501,可成元富99購01  ,0,0,0,0,0,0,0,0,0,-59000,0,0,0,1000,60000,-59000,-59000
060094,聯發科元大99購41,0,0,0,0,0,0,0,0,0,-59000,0,0,0,211000,270000,-59000,-59000
061154,可成群益9B購04  ,0,0,0,0,0,0,0,0,0,-59000,0,0,0,0,59000,-59000,-59000
061278,和大統一9A購01  ,0,0,0,0,0,0,0,0,0,-59000,0,0,0,0,59000,-59000,-59000
020016,統一MSCI美科技N ,0,0,0,0,0,0,0,0,0,-59000,0,0,0,26000,85000,-59000,-59000
056298,億光元大97購02  ,0,0,0,0,0,0,0,0,0,-59000,0,0,0,357000,416000,-59000,-59000
07684P,大立光凱基9A售11,0,0,0,0,0,0,0,0,0,-59000,0,0,0,11000,70000,-59000,-59000
06896P,信邦中信98售01  ,0,0,0,0,0,0,0,0,0,-59000,0,0,0,26000,85000,-59000,-59000
07032P,聯發科統一9C售02,0,0,0,0,0,0,0,0,0,-59000,0,0,0,71000,130000,-59000,-59000
061346,玉晶光元大9B購03,0,0,0,0,0,0,0,0,0,-60000,0,0,0,20000,80000,-60000,-60000
061022,健策國泰9B購03  ,0,0,0,0,0,0,0,0,0,-60000,0,0,0,124000,184000,-60000,-60000
060636,大毅永豐9A購02  ,0,0,0,0,0,0,0,0,0,-60000,0,0,0,14000,74000,-60000,-60000
060610,玉晶光凱基9B購02,0,0,0,0,0,0,0,0,0,-60000,0,0,0,2000,62000,-60000,-60000
060055,宏達電凱基99購06,0,0,0,0,0,0,0,0,0,-60000,0,0,0,5000,65000,-60000,-60000
059125,台積電第一03購02,0,0,0,0,0,0,0,0,0,-60000,0,0,0,0,60000,-60000,-60000
049799,旺宏元大96購01  ,0,0,0,0,0,0,0,0,0,-60000,0,0,0,0,60000,-60000,-60000
053919,可成國票97購02  ,0,0,0,0,0,0,0,0,0,-60000,0,0,0,8000,68000,-60000,-60000
051318,上銀國票96購01  ,0,0,0,0,0,0,0,0,0,-60000,0,0,0,0,60000,-60000,-60000
054567,拓凱群益98購01  ,0,0,0,0,0,0,0,0,0,-60000,0,0,0,0,60000,-60000,-60000
056568,台表科群益98購01,0,0,0,0,0,0,0,0,0,-60000,0,0,0,5000,65000,-60000,-60000
053721,國泰金凱基97購01,0,0,0,0,0,0,0,0,0,-60000,0,0,0,0,60000,-60000,-60000
055335,健策兆豐98購01  ,0,0,0,0,0,0,0,0,0,-60000,0,0,0,0,60000,-60000,-60000
056481,創意元大98購01  ,0,0,0,0,0,0,0,0,0,-60000,0,0,0,25000,85000,-60000,-60000
054280,牧德群益98購01  ,0,0,0,0,0,0,0,0,0,-60000,0,0,0,0,60000,-60000,-60000
052941,康控兆豐97購01  ,0,0,0,0,0,0,0,0,0,-60000,0,0,0,0,60000,-60000,-60000
057021,台積電凱基9A購02,0,0,0,0,0,0,0,0,0,-60000,0,0,0,0,60000,-60000,-60000
057007,奇力新中信98購04,0,0,0,0,0,0,0,0,0,-60000,0,0,0,70000,130000,-60000,-60000
058646,聯茂富邦9A購01  ,0,0,0,0,0,0,0,0,0,-60000,0,0,0,150000,210000,-60000,-60000
059072,元油2X元大9C購13,0,0,0,0,0,0,0,0,0,-60000,0,0,0,90000,150000,-60000,-60000
057583,啟碁中信9A購01  ,0,0,0,0,0,0,0,0,0,-60000,0,0,0,0,60000,-60000,-60000
057162,上銀元大98購03  ,0,0,0,0,0,0,0,0,0,-60000,0,0,0,35000,95000,-60000,-60000
055747,康舒元富97購01  ,0,0,0,0,0,0,0,0,0,-60000,0,0,0,0,60000,-60000,-60000
056756,T50反1元大98購06,0,0,0,0,0,0,0,0,0,-60000,0,0,0,430000,490000,-60000,-60000
054989,精元元富97購01  ,0,0,0,0,0,0,0,0,0,-60000,0,0,0,0,60000,-60000,-60000
05570P,聯發科統一96售04,0,0,0,0,0,0,0,0,0,-60000,0,0,0,0,60000,-60000,-60000
07215P,大立光凱基99售07,0,0,0,0,0,0,0,0,0,-60000,0,0,0,10000,70000,-60000,-60000
060452,儒鴻元大9A購01  ,0,0,0,0,0,0,0,0,0,-61000,0,0,0,0,61000,-61000,-61000
061381,台灣50群益9B購07,0,0,0,0,0,0,0,0,0,-61000,0,0,0,71000,132000,-61000,-61000
06720P,智邦亞東99售01  ,0,0,0,0,0,0,0,0,0,-61000,0,0,0,0,61000,-61000,-61000
06721P,臺股指中信9A售03,0,0,0,0,0,0,0,0,0,-61000,0,0,0,51000,112000,-61000,-61000
054936,鴻海元大97購10  ,0,0,0,0,0,0,0,0,0,-61000,0,0,0,7000,68000,-61000,-61000
056559,華通群益98購02  ,0,0,0,0,0,0,0,0,0,-61000,0,0,0,10000,71000,-61000,-61000
055132,台虹康和97購01  ,0,0,0,0,0,0,0,0,0,-61000,0,0,0,0,61000,-61000,-61000
055668,欣興群益97購01  ,0,0,0,0,0,0,0,0,0,-61000,0,0,0,27000,88000,-61000,-61000
059008,鈺齊元大99購03  ,0,0,0,0,0,0,0,0,0,-61000,0,0,0,100000,161000,-61000,-61000
058532,禾伸堂元富99購01,0,0,0,0,0,0,0,0,0,-61000,0,0,0,376000,437000,-61000,-61000
057943,可成國票99購03  ,0,0,0,0,0,0,0,0,0,-61000,0,0,0,23000,84000,-61000,-61000
057773,技嘉群益9A購02  ,0,0,0,0,0,0,0,0,0,-61000,0,0,0,39000,100000,-61000,-61000
06254P,臺股指群益97售07,0,0,0,0,0,0,0,0,0,-62000,0,0,0,59000,121000,-62000,-62000
061337,台積電元大9A購27,0,0,0,0,0,0,0,0,0,-62000,0,0,0,0,62000,-62000,-62000
060796,世芯永豐9A購03  ,0,0,0,0,0,0,0,0,0,-62000,0,0,0,96000,158000,-62000,-62000
061106,群創元大9B購09  ,0,0,0,0,0,0,0,0,0,-62000,0,0,0,216000,278000,-62000,-62000
060228,亞德客元大9A購01,0,0,0,0,0,0,0,0,0,-62000,0,0,0,14000,76000,-62000,-62000
059720,台積電元大99購43,0,0,0,0,0,0,0,0,0,-62000,0,0,0,250000,312000,-62000,-62000
054497,國巨永豐96購05  ,0,0,0,0,0,0,0,0,0,-62000,0,0,0,18000,80000,-62000,-62000
052691,GIS元大96購01   ,0,0,0,0,0,0,0,0,0,-62000,0,0,0,9000,71000,-62000,-62000
058952,南茂群益99購01  ,0,0,0,0,0,0,0,0,0,-62000,0,0,0,44000,106000,-62000,-62000
055197,致新元富97購02  ,0,0,0,0,0,0,0,0,0,-62000,0,0,0,50000,112000,-62000,-62000
056784,南亞科群益98購01,0,0,0,0,0,0,0,0,0,-62000,0,0,0,0,62000,-62000,-62000
07163P,臺股指群益99售14,0,0,0,0,0,0,0,0,0,-62000,0,0,0,75000,137000,-62000,-62000
060410,台苯永豐9A購01  ,0,0,0,0,0,0,0,0,0,-63000,0,0,0,0,63000,-63000,-63000
061257,上銀凱基9A購06  ,0,0,0,0,0,0,0,0,0,-63000,0,0,0,10000,73000,-63000,-63000
05169P,玉晶光元大95售03,0,0,0,0,0,0,0,0,0,-63000,0,0,0,222000,285000,-63000,-63000
050725,光磊國票96購01  ,0,0,0,0,0,0,0,0,0,-63000,0,0,0,0,63000,-63000,-63000
056571,燿華元大98購02  ,0,0,0,0,0,0,0,0,0,-63000,0,0,0,91000,154000,-63000,-63000
053719,可成凱基96購08  ,0,0,0,0,0,0,0,0,0,-63000,0,0,0,0,63000,-63000,-63000
058315,TPK富邦9C購01   ,0,0,0,0,0,0,0,0,0,-63000,0,0,0,30000,93000,-63000,-63000
056407,嘉晶國票99購01  ,0,0,0,0,0,0,0,0,0,-63000,0,0,0,7000,70000,-63000,-63000
056224,聯發科凱基97購08,0,0,0,0,0,0,0,0,0,-63000,0,0,0,5000,68000,-63000,-63000
061289,玉晶光統一01購03,0,0,0,0,0,0,0,0,0,-64000,0,0,0,1000,65000,-64000,-64000
060842,新光金國票9B購01,0,0,0,0,0,0,0,0,0,-64000,0,0,0,25000,89000,-64000,-64000
060918,康友國泰9C購01  ,0,0,0,0,0,0,0,0,0,-64000,0,0,0,332000,396000,-64000,-64000
060719,瀚宇博永豐9A購01,0,0,0,0,0,0,0,0,0,-64000,0,0,0,11000,75000,-64000,-64000
060420,神基永豐9A購01  ,0,0,0,0,0,0,0,0,0,-64000,0,0,0,0,64000,-64000,-64000
060468,聯鈞元大9A購02  ,0,0,0,0,0,0,0,0,0,-64000,0,0,0,12000,76000,-64000,-64000
059250,大立光凱基99購06,0,0,0,0,0,0,0,0,0,-64000,0,0,0,10000,74000,-64000,-64000
057667,可成元大99購01  ,0,0,0,0,0,0,0,0,0,-64000,0,0,0,25000,89000,-64000,-64000
058819,華通國泰9B購01  ,0,0,0,0,0,0,0,0,0,-64000,0,0,0,43000,107000,-64000,-64000
055175,建準統一97購01  ,0,0,0,0,0,0,0,0,0,-64000,0,0,0,144000,208000,-64000,-64000
057110,立積群益98購01  ,0,0,0,0,0,0,0,0,0,-64000,0,0,0,134000,198000,-64000,-64000
07293P,臺股指凱基99售45,0,0,0,0,0,0,0,0,0,-64000,0,0,0,293000,357000,-64000,-64000
059115,美食永豐99購01  ,0,0,0,0,0,0,0,0,0,-65000,0,0,0,0,65000,-65000,-65000
060150,華通富邦9B購01  ,0,0,0,0,0,0,0,0,0,-65000,0,0,0,90000,155000,-65000,-65000
060997,上銀兆豐9B購01  ,0,0,0,0,0,0,0,0,0,-65000,0,0,0,0,65000,-65000,-65000
061243,麗豐兆豐9A購01  ,0,0,0,0,0,0,0,0,0,-65000,0,0,0,0,65000,-65000,-65000
06702P,智邦元富98售01  ,0,0,0,0,0,0,0,0,0,-65000,0,0,0,0,65000,-65000,-65000
054506,矽格永豐96購01  ,0,0,0,0,0,0,0,0,0,-65000,0,0,0,20000,85000,-65000,-65000
053325,GIS群益96購02   ,0,0,0,0,0,0,0,0,0,-65000,0,0,0,0,65000,-65000,-65000
054021,義隆台新96購01  ,0,0,0,0,0,0,0,0,0,-65000,0,0,0,70000,135000,-65000,-65000
052239,泰鼎國票97購01  ,0,0,0,0,0,0,0,0,0,-65000,0,0,0,10000,75000,-65000,-65000
055528,華邦電群益97購01,0,0,0,0,0,0,0,0,0,-65000,0,0,0,0,65000,-65000,-65000
055809,T50反1國票98購02,0,0,0,0,0,0,0,0,0,-65000,0,0,0,0,65000,-65000,-65000
058171,國巨凱基9A購07  ,0,0,0,0,0,0,0,0,0,-65000,0,0,0,353000,418000,-65000,-65000
057794,T50反1兆豐99購02,0,0,0,0,0,0,0,0,0,-65000,0,0,0,230000,295000,-65000,-65000
056458,日月光凱基98購02,0,0,0,0,0,0,0,0,0,-65000,0,0,0,7000,72000,-65000,-65000
060722,矽格永豐9A購01  ,0,0,0,0,0,0,0,0,0,-66000,0,0,0,169000,235000,-66000,-66000
051423,GIS國票97購01   ,0,0,0,0,0,0,0,0,0,-66000,0,0,0,0,66000,-66000,-66000
054135,大立光元大97購04,0,0,0,0,0,0,0,0,0,-66000,0,0,0,2000,68000,-66000,-66000
054709,宏達電統一97購01,0,0,0,0,0,0,0,0,0,-66000,0,0,0,48000,114000,-66000,-66000
056962,技嘉永豐98購01  ,0,0,0,0,0,0,0,0,0,-66000,0,0,0,40000,106000,-66000,-66000
055936,彩晶群益98購02  ,0,0,0,0,0,0,0,0,0,-66000,0,0,0,0,66000,-66000,-66000
055703,緯穎富邦98購01  ,0,0,0,0,0,0,0,0,0,-66000,0,0,0,20000,86000,-66000,-66000
061005,可成兆豐9A購01  ,0,0,0,0,0,0,0,0,0,-67000,0,0,0,11000,78000,-67000,-67000
061209,聯發科元大9A購10,0,0,0,0,0,0,0,0,0,-67000,0,0,0,70000,137000,-67000,-67000
061441,大毅永豐9A購04  ,0,0,0,0,0,0,0,0,0,-67000,0,0,0,1000,68000,-67000,-67000
060308,劍麟永豐9A購01  ,0,0,0,0,0,0,0,0,0,-67000,0,0,0,215000,282000,-67000,-67000
060283,台肥元大9C購01  ,0,0,0,0,0,0,0,0,0,-67000,0,0,0,69000,136000,-67000,-67000
060459,鴻海元大9A購07  ,0,0,0,0,0,0,0,0,0,-67000,0,0,0,0,67000,-67000,-67000
060416,神隆永豐9A購01  ,0,0,0,0,0,0,0,0,0,-67000,0,0,0,163000,230000,-67000,-67000
059224,大立光元大99購15,0,0,0,0,0,0,0,0,0,-67000,0,0,0,26000,93000,-67000,-67000
053900,T50反1日盛99購01,0,0,0,0,0,0,0,0,0,-67000,0,0,0,0,67000,-67000,-67000
048682,奇力新富邦96購01,0,0,0,0,0,0,0,0,0,-67000,0,0,0,0,67000,-67000,-67000
057266,TPK兆豐98購02   ,0,0,0,0,0,0,0,0,0,-67000,0,0,0,5000,72000,-67000,-67000
055019,福懋科元富97購01,0,0,0,0,0,0,0,0,0,-67000,0,0,0,10000,77000,-67000,-67000
057670,欣興元大99購02  ,0,0,0,0,0,0,0,0,0,-67000,0,0,0,40000,107000,-67000,-67000
056190,昇陽半統一97購01,0,0,0,0,0,0,0,0,0,-67000,0,0,0,0,67000,-67000,-67000
056351,鴻海元大98購06  ,0,0,0,0,0,0,0,0,0,-67000,0,0,0,1000,68000,-67000,-67000
058726,宏達電富邦9A購01,0,0,0,0,0,0,0,0,0,-67000,0,0,0,0,67000,-67000,-67000
07279P,台灣50台新99售02,0,0,0,0,0,0,0,0,0,-67000,0,0,0,8000,75000,-67000,-67000
07049P,聯發科中信99售03,0,0,0,0,0,0,0,0,0,-67000,0,0,0,23000,90000,-67000,-67000
060465,聯發科元大9A購02,0,0,0,0,0,0,0,0,0,-68000,0,0,0,33000,101000,-68000,-68000
060242,潤泰全元大9C購01,0,0,0,0,0,0,0,0,0,-68000,0,0,0,0,68000,-68000,-68000
060011,臺股指群益9C購06,0,0,0,0,0,0,0,0,0,-68000,0,0,0,1000,69000,-68000,-68000
06431P,新日興元大97售05,0,0,0,0,0,0,0,0,0,-68000,0,0,0,1000,69000,-68000,-68000
060503,技嘉元大9A購01  ,0,0,0,0,0,0,0,0,0,-68000,0,0,0,0,68000,-68000,-68000
050096,國巨國泰95購05  ,0,0,0,0,0,0,0,0,0,-68000,0,0,0,15000,83000,-68000,-68000
051192,緯創兆豐96購01  ,0,0,0,0,0,0,0,0,0,-68000,0,0,0,1000,69000,-68000,-68000
057486,美律元大98購04  ,0,0,0,0,0,0,0,0,0,-68000,0,0,0,0,68000,-68000,-68000
054974,台表科元大98購02,0,0,0,0,0,0,0,0,0,-68000,0,0,0,4000,72000,-68000,-68000
058553,合勤控永豐99購01,0,0,0,0,0,0,0,0,0,-68000,0,0,0,0,68000,-68000,-68000
055147,鴻海元大97購11  ,0,0,0,0,0,0,0,0,0,-68000,0,0,0,0,68000,-68000,-68000
07391P,台灣50國泰02售01,0,0,0,0,0,0,0,0,0,-68000,0,0,0,20000,88000,-68000,-68000
07653P,華新科群益9A售05,0,0,0,0,0,0,0,0,0,-68000,0,0,0,20000,88000,-68000,-68000
07531P,大立光國泰9B售03,0,0,0,0,0,0,0,0,0,-68000,0,0,0,142000,210000,-68000,-68000
4555,氣立            ,80000,206000,-126000,0,0,0,30000,0,30000,28000,35000,7000,28000,0,0,0,-68000
060507,聯發科元大9A購03,0,0,0,0,0,0,0,0,0,-69000,0,0,0,203000,272000,-69000,-69000
060603,聯發科凱基9A購12,0,0,0,0,0,0,0,0,0,-69000,0,0,0,348000,417000,-69000,-69000
061389,華新科群益9B購01,0,0,0,0,0,0,0,0,0,-69000,0,0,0,11000,80000,-69000,-69000
061246,玉晶光群益9A購08,0,0,0,0,0,0,0,0,0,-69000,0,0,0,8000,77000,-69000,-69000
059319,台光電元大99購04,0,0,0,0,0,0,0,0,0,-69000,0,0,0,15000,84000,-69000,-69000
054466,欣興凱基97購03  ,0,0,0,0,0,0,0,0,0,-69000,0,0,0,0,69000,-69000,-69000
056616,台光電永豐98購01,0,0,0,0,0,0,0,0,0,-69000,0,0,0,38000,107000,-69000,-69000
057170,瑞昱元大98購01  ,0,0,0,0,0,0,0,0,0,-69000,0,0,0,40000,109000,-69000,-69000
058723,元石油國泰9A購01,0,0,0,0,0,0,0,0,0,-69000,0,0,0,290000,359000,-69000,-69000
056176,創意元富97購01  ,0,0,0,0,0,0,0,0,0,-69000,0,0,0,0,69000,-69000,-69000
060208,卜蜂康和9A購01  ,0,0,0,0,0,0,0,0,0,-70000,0,0,0,0,70000,-70000,-70000
061181,牧德凱基9A購01  ,0,0,0,0,0,0,0,0,0,-70000,0,0,0,101000,171000,-70000,-70000
061401,華擎兆豐9B購01  ,0,0,0,0,0,0,0,0,0,-70000,0,0,0,0,70000,-70000,-70000
061102,台積電元大9A購22,0,0,0,0,0,0,0,0,0,-70000,0,0,0,5000,75000,-70000,-70000
060823,旺宏元大9A購05  ,0,0,0,0,0,0,0,0,0,-70000,0,0,0,101000,171000,-70000,-70000
054740,強茂凱基99購01  ,0,0,0,0,0,0,0,0,0,-70000,0,0,0,0,70000,-70000,-70000
058629,嘉晶國票9A購01  ,0,0,0,0,0,0,0,0,0,-70000,0,0,0,0,70000,-70000,-70000
05848P,臺股指元大96售24,0,0,0,0,0,0,0,0,0,-70000,0,0,0,0,70000,-70000,-70000
058061,貿聯元富9B購01  ,0,0,0,0,0,0,0,0,0,-70000,0,0,0,30000,100000,-70000,-70000
057249,華邦電統一9A購01,0,0,0,0,0,0,0,0,0,-70000,0,0,0,341000,411000,-70000,-70000
055552,瑞昱凱基97購02  ,0,0,0,0,0,0,0,0,0,-70000,0,0,0,0,70000,-70000,-70000
057451,大立光元富9B購01,0,0,0,0,0,0,0,0,0,-70000,0,0,0,5000,75000,-70000,-70000
058248,聯茂元大99購05  ,0,0,0,0,0,0,0,0,0,-70000,0,0,0,0,70000,-70000,-70000
057924,健策凱基98購02  ,0,0,0,0,0,0,0,0,0,-70000,0,0,0,33000,103000,-70000,-70000
07763P,嘉澤永豐9A售02  ,0,0,0,0,0,0,0,0,0,-70000,0,0,0,0,70000,-70000,-70000
060912,華新科元大9A購10,0,0,0,0,0,0,0,0,0,-71000,0,0,0,13000,84000,-71000,-71000
061210,玉山金元大9A購02,0,0,0,0,0,0,0,0,0,-71000,0,0,0,11000,82000,-71000,-71000
060033,臻鼎永豐99購01  ,0,0,0,0,0,0,0,0,0,-71000,0,0,0,0,71000,-71000,-71000
059790,立積元大9C購02  ,0,0,0,0,0,0,0,0,0,-71000,0,0,0,4000,75000,-71000,-71000
054786,全新群益99購02  ,0,0,0,0,0,0,0,0,0,-71000,0,0,0,0,71000,-71000,-71000
054921,文曄凱基97購01  ,0,0,0,0,0,0,0,0,0,-71000,0,0,0,0,71000,-71000,-71000
053996,晶相光群益97購01,299000,0,299000,0,0,0,0,0,0,-370000,0,0,0,13000,383000,-370000,-71000
058237,嘉晶元大99購04  ,0,0,0,0,0,0,0,0,0,-71000,0,0,0,89000,160000,-71000,-71000
058201,華通凱基9A購01  ,0,0,0,0,0,0,0,0,0,-71000,0,0,0,13000,84000,-71000,-71000
056765,友達元大9B購05  ,0,0,0,0,0,0,0,0,0,-71000,0,0,0,1000,72000,-71000,-71000
057993,中環中信98購01  ,0,0,0,0,0,0,0,0,0,-71000,0,0,0,85000,156000,-71000,-71000
059089,聯發科元大99購19,0,0,0,0,0,0,0,0,0,-71000,0,0,0,1175000,1246000,-71000,-71000
055933,欣興群益98購02  ,0,0,0,0,0,0,0,0,0,-71000,0,0,0,1000,72000,-71000,-71000
07642P,華通凱基9A售05  ,0,0,0,0,0,0,0,0,0,-71000,0,0,0,24000,95000,-71000,-71000
059956,玉山金康和99購01,0,0,0,0,0,0,0,0,0,-72000,0,0,0,186000,258000,-72000,-72000
060248,日月光元大9A購01,0,0,0,0,0,0,0,0,0,-72000,0,0,0,53000,125000,-72000,-72000
055858,聯茂元大97購03  ,0,0,0,0,0,0,0,0,0,-72000,0,0,0,50000,122000,-72000,-72000
056321,創意群益98購02  ,0,0,0,0,0,0,0,0,0,-72000,0,0,0,10000,82000,-72000,-72000
05755P,臺股指中信99售04,0,0,0,0,0,0,0,0,0,-72000,0,0,0,6000,78000,-72000,-72000
07786P,南電中信9C售01  ,0,0,0,0,0,0,0,0,0,-72000,0,0,0,0,72000,-72000,-72000
5534,長虹            ,234000,318000,-84000,0,0,0,3000,0,3000,9000,10000,1000,9000,0,0,0,-72000
060261,臺股指凱基9A購04,0,0,0,0,0,0,0,0,0,-73000,0,0,0,111000,184000,-73000,-73000
060417,正隆永豐9A購01  ,0,0,0,0,0,0,0,0,0,-73000,0,0,0,58000,131000,-73000,-73000
059955,美食康和99購01  ,0,0,0,0,0,0,0,0,0,-73000,0,0,0,0,73000,-73000,-73000
059903,S&P正2元大99購02,0,0,0,0,0,0,0,0,0,-73000,0,0,0,241000,314000,-73000,-73000
061188,大成鋼富邦9B購01,0,0,0,0,0,0,0,0,0,-73000,0,0,0,927000,1000000,-73000,-73000
061439,寶成凱基9A購01  ,0,0,0,0,0,0,0,0,0,-73000,0,0,0,0,73000,-73000,-73000
061112,台表科元大9A購03,0,0,0,0,0,0,0,0,0,-73000,0,0,0,25000,98000,-73000,-73000
060621,玉晶光元大9A購05,0,0,0,0,0,0,0,0,0,-73000,0,0,0,3000,76000,-73000,-73000
020015,統一MSCI美低波N ,0,0,0,0,0,0,0,0,0,-73000,0,0,0,1000,74000,-73000,-73000
056643,奇力新凱基99購01,0,0,0,0,0,0,0,0,0,-73000,0,0,0,0,73000,-73000,-73000
058650,台虹永豐9A購01  ,0,0,0,0,0,0,0,0,0,-73000,0,0,0,0,73000,-73000,-73000
3607,谷崧            ,173000,246000,-73000,0,0,0,0,0,0,0,0,0,0,0,0,0,-73000
07386P,臺股指群益99售24,0,0,0,0,0,0,0,0,0,-73000,0,0,0,15000,88000,-73000,-73000
061044,世紀鋼永豐9A購02,0,0,0,0,0,0,0,0,0,-74000,0,0,0,0,74000,-74000,-74000
050601,台表科國泰96購01,0,0,0,0,0,0,0,0,0,-74000,0,0,0,9000,83000,-74000,-74000
051536,玉晶光國票97購01,0,0,0,0,0,0,0,0,0,-74000,0,0,0,51000,125000,-74000,-74000
054426,國泰金富邦97購02,0,0,0,0,0,0,0,0,0,-74000,0,0,0,17000,91000,-74000,-74000
054717,亞德客永豐97購01,0,0,0,0,0,0,0,0,0,-74000,0,0,0,3000,77000,-74000,-74000
054773,台郡國票98購01  ,0,0,0,0,0,0,0,0,0,-74000,0,0,0,0,74000,-74000,-74000
057491,美食元大98購03  ,0,0,0,0,0,0,0,0,0,-74000,0,0,0,26000,100000,-74000,-74000
056488,致新元大99購01  ,0,0,0,0,0,0,0,0,0,-74000,0,0,0,220000,294000,-74000,-74000
056899,可成元大98購01  ,0,0,0,0,0,0,0,0,0,-74000,0,0,0,4000,78000,-74000,-74000
058011,台虹國票99購01  ,0,0,0,0,0,0,0,0,0,-74000,0,0,0,0,74000,-74000,-74000
058212,華新科群益9A購01,0,0,0,0,0,0,0,0,0,-74000,0,0,0,18000,92000,-74000,-74000
057885,台光電群益98購04,0,0,0,0,0,0,0,0,0,-74000,0,0,0,31000,105000,-74000,-74000
061067,貿聯凱基9A購03  ,0,0,0,0,0,0,0,0,0,-75000,0,0,0,5000,80000,-75000,-75000
061085,聯茂兆豐9A購01  ,0,0,0,0,0,0,0,0,0,-75000,0,0,0,7000,82000,-75000,-75000
060869,超眾永豐9A購02  ,0,0,0,0,0,0,0,0,0,-75000,0,0,0,25000,100000,-75000,-75000
060677,京元電元大9A購04,0,0,0,0,0,0,0,0,0,-75000,0,0,0,66000,141000,-75000,-75000
060685,康友元大9A購01  ,0,0,0,0,0,0,0,0,0,-75000,0,0,0,22000,97000,-75000,-75000
060032,利勤永豐99購01  ,0,0,0,0,0,0,0,0,0,-75000,0,0,0,135000,210000,-75000,-75000
060084,聯電元大99購02  ,0,0,0,0,0,0,0,0,0,-75000,0,0,0,73000,148000,-75000,-75000
060437,宏全永豐9A購01  ,0,0,0,0,0,0,0,0,0,-75000,0,0,0,38000,113000,-75000,-75000
059282,嘉聯益永豐99購01,0,0,0,0,0,0,0,0,0,-75000,0,0,0,2000,77000,-75000,-75000
053509,華新群益98購01  ,0,0,0,0,0,0,0,0,0,-75000,0,0,0,0,75000,-75000,-75000
053302,國巨凱基96購10  ,0,0,0,0,0,0,0,0,0,-75000,0,0,0,30000,105000,-75000,-75000
053894,創意群益96購01  ,0,0,0,0,0,0,0,0,0,-75000,0,0,0,50000,125000,-75000,-75000
050788,台郡國泰96購01  ,0,0,0,0,0,0,0,0,0,-75000,0,0,0,0,75000,-75000,-75000
058220,世芯國票9A購01  ,0,0,0,0,0,0,0,0,0,-75000,0,0,0,51000,126000,-75000,-75000
056133,可成元大97購05  ,0,0,0,0,0,0,0,0,0,-75000,0,0,0,0,75000,-75000,-75000
056141,聯茂元大97購05  ,0,0,0,0,0,0,0,0,0,-75000,0,0,0,0,75000,-75000,-75000
057075,嘉聯益永豐98購01,0,0,0,0,0,0,0,0,0,-75000,0,0,0,8000,83000,-75000,-75000
07771P,義隆國票9A售01  ,0,0,0,0,0,0,0,0,0,-75000,0,0,0,0,75000,-75000,-75000
3702A,大聯大甲特      ,5000,0,5000,0,0,0,0,0,0,-80000,0,80000,-80000,0,0,0,-75000
059305,台灣50元大99購02,0,0,0,0,0,0,0,0,0,-76000,0,0,0,32000,108000,-76000,-76000
060328,可成群益9A購06  ,0,0,0,0,0,0,0,0,0,-76000,0,0,0,23000,99000,-76000,-76000
060983,南亞科元大9A購06,0,0,0,0,0,0,0,0,0,-76000,0,0,0,216000,292000,-76000,-76000
061372,世紀鋼國泰9C購01,0,0,0,0,0,0,0,0,0,-76000,0,0,0,0,76000,-76000,-76000
061130,牧德永豐9A購04  ,0,0,0,0,0,0,0,0,0,-76000,0,0,0,2000,78000,-76000,-76000
04938P,亞德客國票95售01,0,0,0,0,0,0,0,0,0,-76000,0,0,0,125000,201000,-76000,-76000
053158,茂林元大96購01  ,0,0,0,0,0,0,0,0,0,-76000,0,0,0,30000,106000,-76000,-76000
056523,光寶科中信98購01,0,0,0,0,0,0,0,0,0,-76000,0,0,0,0,76000,-76000,-76000
05861P,瀚宇博永豐96售02,0,0,0,0,0,0,0,0,0,-76000,0,0,0,0,76000,-76000,-76000
059041,南茂群益99購02  ,0,0,0,0,0,0,0,0,0,-76000,0,0,0,110000,186000,-76000,-76000
3035,智原            ,625000,659000,-34000,0,0,0,0,0,0,-42000,47000,0,47000,15000,104000,-89000,-76000
6141,柏承            ,210000,286000,-76000,0,0,0,0,0,0,0,0,0,0,0,0,0,-76000
07782P,寶成凱基9A售02  ,0,0,0,0,0,0,0,0,0,-76000,0,0,0,0,76000,-76000,-76000
06506P,台郡國票99售02  ,0,0,0,0,0,0,0,0,0,-77000,0,0,0,10000,87000,-77000,-77000
059339,上銀凱基99購06  ,0,0,0,0,0,0,0,0,0,-77000,0,0,0,0,77000,-77000,-77000
059103,旭富元富99購03  ,0,0,0,0,0,0,0,0,0,-77000,0,0,0,0,77000,-77000,-77000
051281,健策兆豐96購01  ,0,0,0,0,0,0,0,0,0,-77000,0,0,0,0,77000,-77000,-77000
052581,訊芯元富98購01  ,0,0,0,0,0,0,0,0,0,-77000,0,0,0,10000,87000,-77000,-77000
052424,泰碩國票97購01  ,0,0,0,0,0,0,0,0,0,-77000,0,0,0,0,77000,-77000,-77000
058973,麗豐永豐99購01  ,0,0,0,0,0,0,0,0,0,-77000,0,0,0,1000,78000,-77000,-77000
058808,大成鋼統一9B購01,0,0,0,0,0,0,0,0,0,-77000,0,0,0,0,77000,-77000,-77000
058565,鴻海凱基9A購07  ,0,0,0,0,0,0,0,0,0,-77000,0,0,0,0,77000,-77000,-77000
05637P,聯電元大96售04  ,0,0,0,0,0,0,0,0,0,-77000,0,0,0,0,77000,-77000,-77000
056163,嘉聯益凱基98購03,0,0,0,0,0,0,0,0,0,-77000,0,0,0,20000,97000,-77000,-77000
07458P,長榮航元大9A售01,0,0,0,0,0,0,0,0,0,-77000,0,0,0,168000,245000,-77000,-77000
5215,科嘉-KY         ,86000,163000,-77000,0,0,0,0,0,0,0,0,0,0,0,0,0,-77000
060233,宏碁元大9A購01  ,0,0,0,0,0,0,0,0,0,-78000,0,0,0,128000,206000,-78000,-78000
060738,矽格統一9C購01  ,0,0,0,0,0,0,0,0,0,-78000,0,0,0,10000,88000,-78000,-78000
060625,華擎元大9A購01  ,0,0,0,0,0,0,0,0,0,-78000,0,0,0,0,78000,-78000,-78000
053997,健策群益97購02  ,0,0,0,0,0,0,0,0,0,-78000,0,0,0,34000,112000,-78000,-78000
056846,晶相光元富98購01,0,0,0,0,0,0,0,0,0,-78000,0,0,0,149000,227000,-78000,-78000
058909,神達元大99購03  ,0,0,0,0,0,0,0,0,0,-78000,0,0,0,80000,158000,-78000,-78000
058405,訊連元大99購02  ,0,0,0,0,0,0,0,0,0,-78000,0,0,0,485000,563000,-78000,-78000
057403,亞光群益98購04  ,0,0,0,0,0,0,0,0,0,-78000,0,0,0,0,78000,-78000,-78000
061304,創意永豐9A購02  ,0,0,0,0,0,0,0,0,0,-79000,0,0,0,0,79000,-79000,-79000
055578,群創統一98購03  ,0,0,0,0,0,0,0,0,0,-79000,0,0,0,5000,84000,-79000,-79000
058402,欣興元大99購04  ,0,0,0,0,0,0,0,0,0,-79000,0,0,0,101000,180000,-79000,-79000
058122,美律國票9A購01  ,0,0,0,0,0,0,0,0,0,-79000,0,0,0,13000,92000,-79000,-79000
055730,建準元富97購02  ,0,0,0,0,0,0,0,0,0,-79000,0,0,0,21000,100000,-79000,-79000
058746,華通凱基9A購02  ,0,0,0,0,0,0,0,0,0,-79000,0,0,0,70000,149000,-79000,-79000
058495,元大金群益9B購01,0,0,0,0,0,0,0,0,0,-79000,0,0,0,0,79000,-79000,-79000
1325,恆大            ,15000,37000,-22000,0,0,0,0,0,0,-57000,0,57000,-57000,0,0,0,-79000
061280,國巨統一9C購06  ,0,0,0,0,0,0,0,0,0,-80000,0,0,0,200000,280000,-80000,-80000
060894,奇力新凱基9A購03,0,0,0,0,0,0,0,0,0,-80000,0,0,0,158000,238000,-80000,-80000
060956,超眾群益9A購01  ,0,0,0,0,0,0,0,0,0,-80000,0,0,0,0,80000,-80000,-80000
059909,鴻海元大99購36  ,0,0,0,0,0,0,0,0,0,-80000,0,0,0,0,80000,-80000,-80000
05994P,奇鋐元大96售02  ,0,0,0,0,0,0,0,0,0,-80000,0,0,0,96000,176000,-80000,-80000
059765,嘉聯益永豐99購02,0,0,0,0,0,0,0,0,0,-80000,0,0,0,26000,106000,-80000,-80000
05399P,GIS國票95售03   ,0,0,0,0,0,0,0,0,0,-80000,0,0,0,0,80000,-80000,-80000
053806,鎧勝凱基96購02  ,0,0,0,0,0,0,0,0,0,-80000,0,0,0,0,80000,-80000,-80000
054892,彩晶統一99購01  ,0,0,0,0,0,0,0,0,0,-80000,0,0,0,0,80000,-80000,-80000
055353,華新科凱基98購03,0,0,0,0,0,0,0,0,0,-80000,0,0,0,0,80000,-80000,-80000
055461,TPK永豐97購01   ,0,0,0,0,0,0,0,0,0,-80000,0,0,0,0,80000,-80000,-80000
051743,揚明光國票96購02,0,0,0,0,0,0,0,0,0,-80000,0,0,0,0,80000,-80000,-80000
04616P,臺股指群益95售02,0,0,0,0,0,0,0,0,0,-80000,0,0,0,1000,81000,-80000,-80000
057763,康控凱基99購02  ,0,0,0,0,0,0,0,0,0,-80000,0,0,0,0,80000,-80000,-80000
05855P,滬深2X中信9C售01,0,0,0,0,0,0,0,0,0,-80000,0,0,0,0,80000,-80000,-80000
056442,瑞昱凱基98購02  ,0,0,0,0,0,0,0,0,0,-80000,0,0,0,0,80000,-80000,-80000
057735,台灣50富邦9C購02,0,0,0,0,0,0,0,0,0,-80000,0,0,0,0,80000,-80000,-80000
055909,大成鋼凱基98購02,0,0,0,0,0,0,0,0,0,-80000,0,0,0,39000,119000,-80000,-80000
055297,啟碁元大97購01  ,0,0,0,0,0,0,0,0,0,-80000,0,0,0,0,80000,-80000,-80000
055092,開發金群益9B購01,0,0,0,0,0,0,0,0,0,-80000,0,0,0,0,80000,-80000,-80000
058117,元石油群益9B購02,0,0,0,0,0,0,0,0,0,-80000,0,0,0,0,80000,-80000,-80000
056694,欣興群益98購04  ,0,0,0,0,0,0,0,0,0,-80000,0,0,0,13000,93000,-80000,-80000
8081,致新            ,194000,363000,-169000,0,0,0,0,0,0,89000,47000,0,47000,58000,16000,42000,-80000
059403,T50反1台新03購03,50000,0,50000,0,0,0,0,0,0,-131000,0,0,0,68000,199000,-131000,-81000
059965,鴻海凱基99購16  ,0,0,0,0,0,0,0,0,0,-81000,0,0,0,0,81000,-81000,-81000
060857,旭富富邦9B購01  ,0,0,0,0,0,0,0,0,0,-81000,0,0,0,1000,82000,-81000,-81000
061334,華通元大9A購09  ,0,0,0,0,0,0,0,0,0,-81000,0,0,0,68000,149000,-81000,-81000
00730,富邦臺灣優質高息,0,0,0,0,0,0,0,0,0,-81000,0,0,0,324000,405000,-81000,-81000
051382,玉晶光群益98購02,0,0,0,0,0,0,0,0,0,-81000,0,0,0,83000,164000,-81000,-81000
054074,健策富邦98購01  ,0,0,0,0,0,0,0,0,0,-81000,0,0,0,20000,101000,-81000,-81000
057355,彩晶統一98購03  ,0,0,0,0,0,0,0,0,0,-81000,0,0,0,0,81000,-81000,-81000
058907,健策元大99購04  ,0,0,0,0,0,0,0,0,0,-81000,0,0,0,19000,100000,-81000,-81000
061193,玉晶光永豐9B購02,0,0,0,0,0,0,0,0,0,-82000,0,0,0,0,82000,-82000,-82000
061108,臻鼎元大9A購02  ,0,0,0,0,0,0,0,0,0,-82000,0,0,0,6000,88000,-82000,-82000
061065,神基凱基9A購01  ,0,0,0,0,0,0,0,0,0,-82000,0,0,0,0,82000,-82000,-82000
060215,柏文康和9A購01  ,0,0,0,0,0,0,0,0,0,-82000,0,0,0,5000,87000,-82000,-82000
060154,堤維西永豐9A購01,0,0,0,0,0,0,0,0,0,-82000,0,0,0,0,82000,-82000,-82000
054045,奇力新元大97購03,0,0,0,0,0,0,0,0,0,-82000,0,0,0,76000,158000,-82000,-82000
053844,GIS統一96購01   ,0,0,0,0,0,0,0,0,0,-82000,0,0,0,0,82000,-82000,-82000
056477,欣興元大98購02  ,0,0,0,0,0,0,0,0,0,-82000,0,0,0,4000,86000,-82000,-82000
053103,瀚宇博元富96購01,0,0,0,0,0,0,0,0,0,-82000,0,0,0,108000,190000,-82000,-82000
051630,力山國票96購01  ,0,0,0,0,0,0,0,0,0,-82000,0,0,0,18000,100000,-82000,-82000
059039,致伸群益99購01  ,0,0,0,0,0,0,0,0,0,-82000,0,0,0,0,82000,-82000,-82000
057729,華新科國泰99購04,0,0,0,0,0,0,0,0,0,-82000,0,0,0,187000,269000,-82000,-82000
057072,日月光永豐98購01,0,0,0,0,0,0,0,0,0,-82000,0,0,0,43000,125000,-82000,-82000
056434,國巨凱基98購03  ,0,0,0,0,0,0,0,0,0,-82000,0,0,0,5000,87000,-82000,-82000
055071,群電永豐97購01  ,0,0,0,0,0,0,0,0,0,-82000,0,0,0,0,82000,-82000,-82000
07711P,世芯元大9A售07  ,0,0,0,0,0,0,0,0,0,-82000,0,0,0,5000,87000,-82000,-82000
059722,南亞科元大99購02,0,0,0,0,0,0,0,0,0,-83000,0,0,0,16000,99000,-83000,-83000
059519,台郡永豐99購01  ,0,0,0,0,0,0,0,0,0,-83000,0,0,0,97000,180000,-83000,-83000
060707,台郡富邦9A購01  ,0,0,0,0,0,0,0,0,0,-83000,0,0,0,438000,521000,-83000,-83000
061391,晶技群益9A購02  ,0,0,0,0,0,0,0,0,0,-83000,0,0,0,0,83000,-83000,-83000
05271P,國巨富邦97售01  ,0,0,0,0,0,0,0,0,0,-83000,0,0,0,2000,85000,-83000,-83000
052796,和碩兆豐96購01  ,0,0,0,0,0,0,0,0,0,-83000,0,0,0,41000,124000,-83000,-83000
052895,台積電群益96購04,0,0,0,0,0,0,0,0,0,-83000,0,0,0,58000,141000,-83000,-83000
058014,上銀凱基99購02  ,0,0,0,0,0,0,0,0,0,-83000,0,0,0,0,83000,-83000,-83000
057113,祥碩群益98購01  ,0,0,0,0,0,0,0,0,0,-83000,0,0,0,205000,288000,-83000,-83000
056105,智原永豐97購01  ,0,0,0,0,0,0,0,0,0,-83000,0,0,0,25000,108000,-83000,-83000
061294,奇力新麥證9A購01,0,0,0,0,84000,-84000,0,0,0,-84000,0,0,0,0,84000,-84000,-84000
060874,中鋼中信02購01  ,0,0,0,0,0,0,0,0,0,-84000,0,0,0,36000,120000,-84000,-84000
060825,聯詠元大9A購05  ,10000,0,10000,0,0,0,0,0,0,-94000,0,0,0,21000,115000,-94000,-84000
060357,上銀元富9A購02  ,0,0,0,0,0,0,0,0,0,-84000,0,0,0,1000,85000,-84000,-84000
052955,國巨日盛96購01  ,0,0,0,0,0,0,0,0,0,-84000,0,0,0,0,84000,-84000,-84000
053999,台表科群益96購06,0,0,0,0,0,0,0,0,0,-84000,0,0,0,8000,92000,-84000,-84000
055359,超眾凱基97購01  ,0,0,0,0,0,0,0,0,0,-84000,0,0,0,16000,100000,-84000,-84000
055343,國巨凱基97購03  ,0,0,0,0,0,0,0,0,0,-84000,0,0,0,297000,381000,-84000,-84000
057536,康控元大99購03  ,0,0,0,0,0,0,0,0,0,-84000,0,0,0,74000,158000,-84000,-84000
052095,彩晶元大97購01  ,0,0,0,0,0,0,0,0,0,-84000,0,0,0,20000,104000,-84000,-84000
042168,台灣50凱基96購01,0,0,0,0,0,0,0,0,0,-84000,0,0,0,6000,90000,-84000,-84000
057748,華通國票98購04  ,0,0,0,0,0,0,0,0,0,-84000,0,0,0,0,84000,-84000,-84000
058850,華新科群益99購03,0,0,0,0,0,0,0,0,0,-84000,0,0,0,61000,145000,-84000,-84000
058498,世紀鋼群益99購01,0,0,0,0,0,0,0,0,0,-84000,0,0,0,5000,89000,-84000,-84000
055684,京鼎凱基97購01  ,0,0,0,0,0,0,0,0,0,-84000,0,0,0,40000,124000,-84000,-84000
058035,旭富永豐98購02  ,0,0,0,0,0,0,0,0,0,-84000,0,0,0,27000,111000,-84000,-84000
059643,日月光凱基99購02,0,0,0,0,0,0,0,0,0,-85000,0,0,0,18000,103000,-85000,-85000
059690,建準永豐99購01  ,0,0,0,0,0,0,0,0,0,-85000,0,0,0,61000,146000,-85000,-85000
061073,T50反1兆豐9A購01,0,0,0,0,0,0,0,0,0,-85000,0,0,0,0,85000,-85000,-85000
061416,聯茂群益9A購01  ,0,0,0,0,0,0,0,0,0,-85000,0,0,0,0,85000,-85000,-85000
050998,訊連元大95購01  ,0,0,0,0,0,0,0,0,0,-85000,0,0,0,0,85000,-85000,-85000
058854,樺漢群益9B購01  ,0,0,0,0,0,0,0,0,0,-85000,0,0,0,15000,100000,-85000,-85000
1515,力山            ,1121000,1520000,-399000,0,0,0,38000,0,38000,276000,52000,5000,47000,244000,15000,229000,-85000
061296,台積電國泰9C購01,0,0,0,0,0,0,0,0,0,-86000,0,0,0,7000,93000,-86000,-86000
059747,台達電台新99購01,0,0,0,0,0,0,0,0,0,-86000,0,0,0,50000,136000,-86000,-86000
059526,鴻海凱基99購12  ,0,0,0,0,0,0,0,0,0,-86000,0,0,0,0,86000,-86000,-86000
060426,盛群永豐9A購01  ,0,0,0,0,0,0,0,0,0,-86000,0,0,0,148000,234000,-86000,-86000
053332,創意永豐96購03  ,0,0,0,0,0,0,0,0,0,-86000,0,0,0,64000,150000,-86000,-86000
054363,世芯凱基97購01  ,0,0,0,0,0,0,0,0,0,-86000,0,0,0,2000,88000,-86000,-86000
058610,欣興元大99購05  ,0,0,0,0,0,0,0,0,0,-86000,0,0,0,14000,100000,-86000,-86000
05609P,國泰金凱基96售01,0,0,0,0,0,0,0,0,0,-86000,0,0,0,50000,136000,-86000,-86000
056449,義隆凱基98購03  ,0,0,0,0,0,0,0,0,0,-86000,0,0,0,46000,132000,-86000,-86000
055575,華新科統一98購01,0,0,0,0,0,0,0,0,0,-86000,0,0,0,140000,226000,-86000,-86000
061413,台勝科群益9A購01,0,0,0,0,0,0,0,0,0,-87000,0,0,0,0,87000,-87000,-87000
056623,禾伸堂永豐98購01,0,0,0,0,0,0,0,0,0,-87000,0,0,0,69000,156000,-87000,-87000
057454,上銀國泰99購02  ,0,0,0,0,0,0,0,0,0,-87000,0,0,0,30000,117000,-87000,-87000
058247,聯茂元大99購04  ,0,0,0,0,0,0,0,0,0,-87000,0,0,0,0,87000,-87000,-87000
058429,欣興元富99購01  ,0,0,0,0,0,0,0,0,0,-87000,0,0,0,45000,132000,-87000,-87000
07527P,台灣50凱基9B售02,0,0,0,0,0,0,0,0,0,-87000,0,0,0,108000,195000,-87000,-87000
07210P,智邦凱基99售03  ,0,0,0,0,0,0,0,0,0,-87000,0,0,0,4000,91000,-87000,-87000
061327,台郡凱基9A購02  ,0,0,0,0,0,0,0,0,0,-88000,0,0,0,50000,138000,-88000,-88000
060230,台積電元大9A購07,0,0,0,0,0,0,0,0,0,-88000,0,0,0,1000,89000,-88000,-88000
060001,台灣50群益9A購10,0,0,0,0,0,0,0,0,0,-88000,0,0,0,1000,89000,-88000,-88000
059454,亞光永豐99購01  ,0,0,0,0,0,0,0,0,0,-88000,0,0,0,0,88000,-88000,-88000
053642,瀚宇博永豐96購01,0,0,0,0,0,0,0,0,0,-88000,0,0,0,10000,98000,-88000,-88000
053804,富邦金凱基96購01,0,0,0,0,0,0,0,0,0,-88000,0,0,0,30000,118000,-88000,-88000
051607,緯創群益96購02  ,0,0,0,0,0,0,0,0,0,-88000,0,0,0,0,88000,-88000,-88000
057915,台泥凱基98購01  ,0,0,0,0,0,0,0,0,0,-88000,0,0,0,0,88000,-88000,-88000
055093,京鼎群益98購01  ,0,0,0,0,0,0,0,0,0,-88000,0,0,0,134000,222000,-88000,-88000
059076,FBVIX元大99購04 ,0,0,0,0,0,0,0,0,0,-88000,0,0,0,6000,94000,-88000,-88000
1582,信錦            ,54000,141000,-87000,0,0,0,0,0,0,-1000,0,1000,-1000,0,0,0,-88000
059819,台積電凱基99購17,0,0,0,0,0,0,0,0,0,-89000,0,0,0,15000,104000,-89000,-89000
056618,京元電永豐98購01,0,0,0,0,0,0,0,0,0,-89000,0,0,0,92000,181000,-89000,-89000
054747,麗豐凱基98購01  ,0,0,0,0,0,0,0,0,0,-89000,0,0,0,0,89000,-89000,-89000
058902,聯發科元大99購15,0,0,0,0,0,0,0,0,0,-89000,0,0,0,39000,128000,-89000,-89000
057327,玉晶光群益9A購04,0,0,0,0,0,0,0,0,0,-89000,0,0,0,0,89000,-89000,-89000
060006,華通群益9A購04  ,0,0,0,0,0,0,0,0,0,-90000,0,0,0,5000,95000,-90000,-90000
06042P,華新科永豐96售04,0,0,0,0,0,0,0,0,0,-90000,0,0,0,37000,127000,-90000,-90000
061358,世紀鋼元大9A購04,0,0,0,0,0,0,0,0,0,-90000,0,0,0,1000,91000,-90000,-90000
061120,台積電永豐9A購03,0,0,0,0,0,0,0,0,0,-90000,0,0,0,1000,91000,-90000,-90000
060850,康友國票9A購03  ,0,0,0,0,0,0,0,0,0,-90000,0,0,0,23000,113000,-90000,-90000
055376,群創元大01購01  ,0,0,0,0,0,0,0,0,0,-90000,0,0,0,0,90000,-90000,-90000
046628,大立光統一98購01,0,0,0,0,0,0,0,0,0,-90000,0,0,0,30000,120000,-90000,-90000
057419,奇力新凱基98購06,0,0,0,0,0,0,0,0,0,-90000,0,0,0,0,90000,-90000,-90000
057619,玉晶光凱基98購02,0,0,0,0,0,0,0,0,0,-90000,0,0,0,70000,160000,-90000,-90000
056144,GIS元大98購01   ,0,0,0,0,0,0,0,0,0,-90000,0,0,0,145000,235000,-90000,-90000
058152,聯發科統一9B購02,0,0,0,0,0,0,0,0,0,-90000,0,0,0,0,90000,-90000,-90000
058674,宏達電群益99購01,0,0,0,0,0,0,0,0,0,-90000,0,0,0,3000,93000,-90000,-90000
058496,文曄群益99購01  ,0,0,0,0,0,0,0,0,0,-90000,0,0,0,0,90000,-90000,-90000
056404,嘉聯益群益9A購01,0,0,0,0,0,0,0,0,0,-90000,0,0,0,40000,130000,-90000,-90000
057048,新日興元大98購01,0,0,0,0,0,0,0,0,0,-90000,0,0,0,0,90000,-90000,-90000
2820,華票            ,196000,314000,-118000,0,0,0,0,0,0,28000,28000,0,28000,0,0,0,-90000
07442P,華航康和9A售02  ,0,0,0,0,0,0,0,0,0,-90000,0,0,0,60000,150000,-90000,-90000
060934,台汽電永豐9A購02,0,0,0,0,0,0,0,0,0,-91000,0,0,0,10000,101000,-91000,-91000
061100,SP黃豆元大9A購04,0,0,0,0,0,0,0,0,0,-91000,0,0,0,450000,541000,-91000,-91000
060626,貿聯元大9A購04  ,0,0,0,0,0,0,0,0,0,-91000,0,0,0,0,91000,-91000,-91000
061295,台積電國泰9B購02,0,0,0,0,0,0,0,0,0,-91000,0,0,0,5000,96000,-91000,-91000
060110,茂林元大99購06  ,0,0,0,0,0,0,0,0,0,-91000,0,0,0,158000,249000,-91000,-91000
059840,鴻海富邦9A購02  ,0,0,0,0,0,0,0,0,0,-91000,0,0,0,0,91000,-91000,-91000
059786,全新元大99購06  ,0,0,0,0,0,0,0,0,0,-91000,0,0,0,6000,97000,-91000,-91000
057935,晶技群益98購02  ,0,0,0,0,0,0,0,0,0,-91000,0,0,0,4000,95000,-91000,-91000
057812,友達元大9A購05  ,0,0,0,0,0,0,0,0,0,-91000,0,0,0,228000,319000,-91000,-91000
059036,可成群益9B購03  ,0,0,0,0,0,0,0,0,0,-91000,0,0,0,91000,182000,-91000,-91000
058262,大立光富邦9C購02,0,0,0,0,0,0,0,0,0,-91000,0,0,0,10000,101000,-91000,-91000
056709,華通永豐98購01  ,0,0,0,0,0,0,0,0,0,-91000,0,0,0,0,91000,-91000,-91000
2471,資通            ,34000,125000,-91000,0,0,0,0,0,0,0,0,0,0,0,0,0,-91000
059267,群創中信01購02  ,0,0,0,0,0,0,0,0,0,-92000,0,0,0,0,92000,-92000,-92000
060107,旭富元大99購03  ,0,0,0,0,0,0,0,0,0,-92000,0,0,0,57000,149000,-92000,-92000
060559,世紀鋼凱基9C購01,0,0,0,0,0,0,0,0,0,-92000,0,0,0,0,92000,-92000,-92000
051979,群創凱基97購01  ,0,0,0,0,0,0,0,0,0,-92000,0,0,0,4000,96000,-92000,-92000
053672,嘉澤元富96購02  ,0,0,0,0,0,0,0,0,0,-92000,0,0,0,15000,107000,-92000,-92000
057529,嘉晶元大99購02  ,0,0,0,0,0,0,0,0,0,-92000,0,0,0,20000,112000,-92000,-92000
054376,聯茂中信97購01  ,0,0,0,0,0,0,0,0,0,-92000,0,0,0,1000,93000,-92000,-92000
054883,億光統一97購01  ,0,0,0,0,0,0,0,0,0,-92000,0,0,0,240000,332000,-92000,-92000
055261,帆宣統一98購01  ,0,0,0,0,0,0,0,0,0,-92000,0,0,0,0,92000,-92000,-92000
2461,光群雷          ,70000,163000,-93000,0,0,0,0,0,0,1000,1000,0,1000,0,0,0,-92000
1904,正隆            ,762000,383000,379000,0,0,0,0,500000,-500000,29000,11000,0,11000,27000,9000,18000,-92000
07647P,健策國票9A售04  ,0,0,0,0,0,0,0,0,0,-92000,0,0,0,8000,100000,-92000,-92000
3060,銘異            ,267000,359000,-92000,0,0,0,0,0,0,0,0,0,0,0,0,0,-92000
061103,聯發科元大9A購08,0,0,0,0,0,0,0,0,0,-93000,0,0,0,52000,145000,-93000,-93000
061338,台積電元大9A購28,0,0,0,0,0,0,0,0,0,-93000,0,0,0,0,93000,-93000,-93000
06657P,寶成元大98售01  ,0,0,0,0,0,0,0,0,0,-93000,0,0,0,162000,255000,-93000,-93000
054458,復盛群益96購01  ,0,0,0,0,0,0,0,0,0,-93000,0,0,0,5000,98000,-93000,-93000
054791,泰碩群益99購02  ,0,0,0,0,0,0,0,0,0,-93000,0,0,0,70000,163000,-93000,-93000
051774,聯茂中信96購01  ,0,0,0,0,0,0,0,0,0,-93000,0,0,0,17000,110000,-93000,-93000
058145,聯茂元大99購03  ,0,0,0,0,0,0,0,0,0,-93000,0,0,0,55000,148000,-93000,-93000
058327,大毅統一9B購01  ,0,0,0,0,0,0,0,0,0,-93000,0,0,0,199000,292000,-93000,-93000
059086,國巨元大99購18  ,0,0,0,0,0,0,0,0,0,-93000,0,0,0,18000,111000,-93000,-93000
058540,嘉聯益國泰9A購02,0,0,0,0,0,0,0,0,0,-93000,0,0,0,0,93000,-93000,-93000
056114,台達電群益97購02,0,0,0,0,0,0,0,0,0,-93000,0,0,0,10000,103000,-93000,-93000
07620P,國巨統一9B售07  ,0,0,0,0,0,0,0,0,0,-93000,0,0,0,63000,156000,-93000,-93000
061241,晶技兆豐9A購01  ,0,0,0,0,0,0,0,0,0,-94000,0,0,0,17000,111000,-94000,-94000
061038,TPK永豐9A購01   ,0,0,0,0,0,0,0,0,0,-94000,0,0,0,43000,137000,-94000,-94000
053867,創意元大96購04  ,0,0,0,0,0,0,0,0,0,-94000,0,0,0,209000,303000,-94000,-94000
04706P,力山元大95售01  ,0,0,0,0,0,0,0,0,0,-94000,0,0,0,0,94000,-94000,-94000
048850,聯電群益96購01  ,0,0,0,0,0,0,0,0,0,-94000,0,0,0,60000,154000,-94000,-94000
056905,欣興元大98購03  ,0,0,0,0,0,0,0,0,0,-94000,0,0,0,30000,124000,-94000,-94000
056281,深中小永豐97購01,0,0,0,0,0,0,0,0,0,-94000,0,0,0,0,94000,-94000,-94000
057107,華新科群益98購06,0,0,0,0,0,0,0,0,0,-94000,0,0,0,0,94000,-94000,-94000
057230,建準凱基98購02  ,0,0,0,0,0,0,0,0,0,-94000,0,0,0,170000,264000,-94000,-94000
9105,泰金寶-DR       ,201000,295000,-94000,0,0,0,0,0,0,0,0,0,0,0,0,0,-94000
060682,牧德元大9A購03  ,0,0,0,0,0,0,0,0,0,-95000,0,0,0,30000,125000,-95000,-95000
061125,億光永豐9A購01  ,0,0,0,0,0,0,0,0,0,-95000,0,0,0,141000,236000,-95000,-95000
059822,聯發科凱基99購19,0,0,0,0,0,0,0,0,0,-95000,0,0,0,71000,166000,-95000,-95000
059253,康控凱基9B購02  ,0,0,0,0,0,0,0,0,0,-95000,0,0,0,52000,147000,-95000,-95000
059534,國泰金凱基99購01,0,0,0,0,0,0,0,0,0,-95000,0,0,0,7000,102000,-95000,-95000
057484,南亞科元大98購06,0,0,0,0,0,0,0,0,0,-95000,0,0,0,0,95000,-95000,-95000
053488,中石化兆豐97購01,0,0,0,0,0,0,0,0,0,-95000,0,0,0,58000,153000,-95000,-95000
057103,禾伸堂中信9A購01,0,0,0,0,0,0,0,0,0,-95000,0,0,0,205000,300000,-95000,-95000
056715,瀚宇博永豐98購01,0,0,0,0,0,0,0,0,0,-95000,0,0,0,58000,153000,-95000,-95000
055287,日電貿元大97購01,0,0,0,0,0,0,0,0,0,-95000,0,0,0,4000,99000,-95000,-95000
058497,新日興群益9B購01,0,0,0,0,0,0,0,0,0,-95000,0,0,0,23000,118000,-95000,-95000
07402P,瑞昱凱基99售02  ,0,0,0,0,0,0,0,0,0,-95000,0,0,0,24000,119000,-95000,-95000
07311P,台灣50元大99售09,0,0,0,0,0,0,0,0,0,-95000,0,0,0,28000,123000,-95000,-95000
6202,盛群            ,140000,297999,-157999,0,0,0,0,0,0,62000,3000,0,3000,62000,3000,59000,-95999
060128,健策永豐99購06  ,0,0,0,0,0,0,0,0,0,-96000,0,0,0,26000,122000,-96000,-96000
060095,聯發科元大99購42,0,0,0,0,0,0,0,0,0,-96000,0,0,0,20000,116000,-96000,-96000
061398,力成中信9A購01  ,0,0,0,0,0,0,0,0,0,-96000,0,0,0,0,96000,-96000,-96000
060761,南亞科元大9A購05,0,0,0,0,0,0,0,0,0,-96000,0,0,0,524000,620000,-96000,-96000
054439,健策台新96購03  ,0,0,0,0,0,0,0,0,0,-96000,0,0,0,218000,314000,-96000,-96000
056386,TPK國泰99購01   ,0,0,0,0,0,0,0,0,0,-96000,0,0,0,30000,126000,-96000,-96000
057716,神達統一98購01  ,0,0,0,0,0,0,0,0,0,-96000,0,0,0,0,96000,-96000,-96000
055935,創意群益97購02  ,0,0,0,0,0,0,0,0,0,-96000,0,0,0,4000,100000,-96000,-96000
057649,嘉聯益元大99購04,0,0,0,0,0,0,0,0,0,-96000,0,0,0,177000,273000,-96000,-96000
055806,致新永豐97購02  ,0,0,0,0,0,0,0,0,0,-96000,0,0,0,42000,138000,-96000,-96000
055091,微星群益97購01  ,0,0,0,0,0,0,0,0,0,-96000,0,0,0,2000,98000,-96000,-96000
058010,帆宣國票98購01  ,0,0,0,0,0,0,0,0,0,-96000,0,0,0,13000,109000,-96000,-96000
055533,大立光群益97購03,0,0,0,0,0,0,0,0,0,-96000,0,0,0,0,96000,-96000,-96000
06780P,義隆元大98售02  ,0,0,0,0,0,0,0,0,0,-96000,0,0,0,272000,368000,-96000,-96000
060732,玉晶光群益9C購02,0,0,0,0,0,0,0,0,0,-97000,0,0,0,50000,147000,-97000,-97000
060050,鴻海凱基9B購01  ,0,0,0,0,0,0,0,0,0,-97000,0,0,0,28000,125000,-97000,-97000
059348,日月光凱基99購01,0,0,0,0,0,0,0,0,0,-97000,0,0,0,1000,98000,-97000,-97000
054235,欣興群益96購06  ,0,0,0,0,0,0,0,0,0,-97000,0,0,0,81000,178000,-97000,-97000
053198,亞德客日盛96購01,0,0,0,0,0,0,0,0,0,-97000,0,0,0,7000,104000,-97000,-97000
055444,致新台新97購01  ,0,0,0,0,0,0,0,0,0,-97000,0,0,0,0,97000,-97000,-97000
057636,上銀元大98購06  ,0,0,0,0,0,0,0,0,0,-97000,0,0,0,3000,100000,-97000,-97000
057747,致新永豐98購01  ,0,0,0,0,0,0,0,0,0,-97000,0,0,0,13000,110000,-97000,-97000
058831,茂林永豐99購01  ,0,0,0,0,0,0,0,0,0,-97000,0,0,0,331000,428000,-97000,-97000
07658P,國泰金凱基9A售01,0,0,0,0,0,0,0,0,0,-97000,0,0,0,48000,145000,-97000,-97000
07516P,台積電元大9A售16,0,0,0,0,0,0,0,0,0,-97000,0,0,0,0,97000,-97000,-97000
060106,旭富元大99購02  ,0,0,0,0,0,0,0,0,0,-98000,0,0,0,0,98000,-98000,-98000
060144,全新國票9B購01  ,0,0,0,0,0,0,0,0,0,-98000,0,0,0,14000,112000,-98000,-98000
060475,瑞祺元大9A購01  ,0,0,0,0,0,0,0,0,0,-98000,0,0,0,14000,112000,-98000,-98000
060374,儒鴻元富9A購01  ,0,0,0,0,0,0,0,0,0,-98000,0,0,0,84000,182000,-98000,-98000
061176,聯發科凱基9A購14,0,0,0,0,0,0,0,0,0,-98000,0,0,0,0,98000,-98000,-98000
056603,嘉聯益國泰9A購01,0,0,0,0,0,0,0,0,0,-98000,0,0,0,157000,255000,-98000,-98000
054349,同欣電國票97購02,0,0,0,0,0,0,0,0,0,-98000,0,0,0,95000,193000,-98000,-98000
053773,上銀元大96購04  ,0,0,0,0,0,0,0,0,0,-98000,0,0,0,50000,148000,-98000,-98000
052447,聯發科元大96購04,0,0,0,0,0,0,0,0,0,-98000,0,0,0,0,98000,-98000,-98000
057662,上銀元大9A購01  ,0,0,0,0,0,0,0,0,0,-98000,0,0,0,72000,170000,-98000,-98000
058082,美律群益98購05  ,0,0,0,0,0,0,0,0,0,-98000,0,0,0,20000,118000,-98000,-98000
060111,臻鼎元大99購04  ,0,0,0,0,0,0,0,0,0,-99000,0,0,0,56000,155000,-99000,-99000
052622,貿聯兆豐97購01  ,0,0,0,0,0,0,0,0,0,-99000,0,0,0,2000,101000,-99000,-99000
053632,新唐兆豐96購01  ,0,0,0,0,0,0,0,0,0,-99000,0,0,0,0,99000,-99000,-99000
055565,祥碩凱基97購01  ,0,0,0,0,0,0,0,0,0,-99000,0,0,0,0,99000,-99000,-99000
058204,世芯凱基9A購01  ,0,0,0,0,0,0,0,0,0,-99000,0,0,0,210000,309000,-99000,-99000
059009,世紀鋼元大99購04,0,0,0,0,0,0,0,0,0,-99000,0,0,0,58000,157000,-99000,-99000
058992,上証反元大99購02,0,0,0,0,0,0,0,0,0,-99000,0,0,0,1000,100000,-99000,-99000
07507P,國巨國票9B售02  ,0,0,0,0,0,0,0,0,0,-99000,0,0,0,40000,139000,-99000,-99000
060243,潤泰全元大9C購02,0,0,0,0,0,0,0,0,0,-100000,0,0,0,0,100000,-100000,-100000
061242,玉晶光兆豐9B購02,0,0,0,0,0,0,0,0,0,-100000,0,0,0,0,100000,-100000,-100000
061437,燿華凱基9A購01  ,0,0,0,0,0,0,0,0,0,-100000,0,0,0,0,100000,-100000,-100000
060900,超眾凱基9B購01  ,0,0,0,0,0,0,0,0,0,-100000,0,0,0,0,100000,-100000,-100000
060899,超眾凱基9A購01  ,0,0,0,0,0,0,0,0,0,-100000,0,0,0,10000,110000,-100000,-100000
053540,健策永豐96購01  ,0,0,0,0,0,0,0,0,0,-100000,0,0,0,0,100000,-100000,-100000
053399,創意中信96購01  ,0,0,0,0,0,0,0,0,0,-100000,0,0,0,0,100000,-100000,-100000
057543,華通凱基99購02  ,0,0,0,0,0,0,0,0,0,-100000,0,0,0,0,100000,-100000,-100000
053727,麗豐凱基97購01  ,0,0,0,0,0,0,0,0,0,-100000,0,0,0,0,100000,-100000,-100000
054223,大立光統一98購04,0,0,0,0,0,0,0,0,0,-100000,0,0,0,0,100000,-100000,-100000
054932,台肥元大97購01  ,0,0,0,0,0,0,0,0,0,-100000,0,0,0,64000,164000,-100000,-100000
054482,大成鋼台新96購01,0,0,0,0,0,0,0,0,0,-100000,0,0,0,0,100000,-100000,-100000
052529,力成元大95購03  ,0,0,0,0,0,0,0,0,0,-100000,0,0,0,0,100000,-100000,-100000
051845,世紀鋼富邦96購01,0,0,0,0,0,0,0,0,0,-100000,0,0,0,2000,102000,-100000,-100000
05213P,台積電國票96售05,0,0,0,0,0,0,0,0,0,-100000,0,0,0,65000,165000,-100000,-100000
047854,滬深2X國票96購02,0,0,0,0,0,0,0,0,0,-100000,0,0,0,0,100000,-100000,-100000
059048,元油2X凱基9A購11,0,0,0,0,0,0,0,0,0,-100000,0,0,0,0,100000,-100000,-100000
058494,可成群益9B購01  ,0,0,0,0,0,0,0,0,0,-100000,0,0,0,10000,110000,-100000,-100000
058512,宏達電元大99購04,0,0,0,0,0,0,0,0,0,-100000,0,0,0,3000,103000,-100000,-100000
056191,世紀鋼統一97購01,0,0,0,0,0,0,0,0,0,-100000,0,0,0,0,100000,-100000,-100000
056916,台達電兆豐98購02,0,0,0,0,0,0,0,0,0,-100000,0,0,0,10000,110000,-100000,-100000
056966,嘉晶永豐98購01  ,0,0,0,0,0,0,0,0,0,-100000,0,0,0,0,100000,-100000,-100000
058141,嘉聯益元大99購05,0,0,0,0,0,0,0,0,0,-100000,0,0,0,5000,105000,-100000,-100000
057217,奇力新群益99購01,0,0,0,0,0,0,0,0,0,-100000,0,0,0,20000,120000,-100000,-100000
056695,景碩群益99購01  ,0,0,0,0,0,0,0,0,0,-100000,0,0,0,0,100000,-100000,-100000
06954P,大立光元富99售01,0,0,0,0,0,0,0,0,0,-100000,0,0,0,51000,151000,-100000,-100000
060508,聯發科元大9A購04,0,0,0,0,0,0,0,0,0,-101000,0,0,0,32000,133000,-101000,-101000
060222,貿聯凱基9A購02  ,0,0,0,0,0,0,0,0,0,-101000,0,0,0,55000,156000,-101000,-101000
060030,晶相光永豐99購03,0,0,0,0,0,0,0,0,0,-101000,0,0,0,121000,222000,-101000,-101000
059816,聯電凱基99購03  ,0,0,0,0,0,0,0,0,0,-101000,0,0,0,43000,144000,-101000,-101000
059663,旭富元大9C購02  ,0,0,0,0,0,0,0,0,0,-101000,0,0,0,9000,110000,-101000,-101000
048852,旺宏群益96購02  ,0,0,0,0,0,0,0,0,0,-101000,0,0,0,0,101000,-101000,-101000
052989,麗豐元大98購01  ,0,0,0,0,0,0,0,0,0,-101000,0,0,0,0,101000,-101000,-101000
054109,南亞科凱基96購05,0,0,0,0,0,0,0,0,0,-101000,0,0,0,6000,107000,-101000,-101000
058403,玉晶光元大99購12,0,0,0,0,0,0,0,0,0,-101000,0,0,0,64000,165000,-101000,-101000
059311,元石油元大99購04,0,0,0,0,0,0,0,0,0,-102000,0,0,0,200000,302000,-102000,-102000
059937,旺宏永豐99購03  ,0,0,0,0,0,0,0,0,0,-102000,0,0,0,3000,105000,-102000,-102000
060723,致新永豐9A購01  ,0,0,0,0,0,0,0,0,0,-102000,0,0,0,40000,142000,-102000,-102000
06371P,茂林國票98售04  ,0,0,0,0,0,0,0,0,0,-102000,0,0,0,43000,145000,-102000,-102000
054164,強茂凱基98購01  ,0,0,0,0,0,0,0,0,0,-102000,0,0,0,30000,132000,-102000,-102000
054909,福懋科康和97購01,0,0,0,0,0,0,0,0,0,-102000,0,0,0,0,102000,-102000,-102000
055387,世紀鋼元大97購01,0,0,0,0,0,0,0,0,0,-102000,0,0,0,3000,105000,-102000,-102000
053112,中磊兆豐97購01  ,0,0,0,0,0,0,0,0,0,-102000,0,0,0,0,102000,-102000,-102000
055069,帆宣永豐97購01  ,0,0,0,0,0,0,0,0,0,-102000,0,0,0,0,102000,-102000,-102000
057154,易華電國泰99購01,0,0,0,0,0,0,0,0,0,-102000,0,0,0,0,102000,-102000,-102000
058790,楠梓電元大99購03,0,0,0,0,0,0,0,0,0,-102000,0,0,0,0,102000,-102000,-102000
07589P,玉晶光國票9A售02,0,0,0,0,0,0,0,0,0,-102000,0,0,0,41000,143000,-102000,-102000
060846,欣興國票9A購02  ,0,0,0,0,0,0,0,0,0,-103000,0,0,0,0,103000,-103000,-103000
059773,康控群益99購01  ,0,0,0,0,0,0,0,0,0,-103000,0,0,0,0,103000,-103000,-103000
057498,台郡元大98購04  ,0,0,0,0,0,0,0,0,0,-103000,0,0,0,0,103000,-103000,-103000
056980,建準群益98購02  ,0,0,0,0,0,0,0,0,0,-103000,0,0,0,85000,188000,-103000,-103000
056770,國產元大98購02  ,0,0,0,0,0,0,0,0,0,-103000,0,0,0,59000,162000,-103000,-103000
059579,聯發科元富99購06,0,0,0,0,0,0,0,0,0,-104000,0,0,0,3000,107000,-104000,-104000
060265,宏達電國票9A購02,0,0,0,0,0,0,0,0,0,-104000,0,0,0,9000,113000,-104000,-104000
060993,健策元大9B購03  ,0,0,0,0,0,0,0,0,0,-104000,0,0,0,309000,413000,-104000,-104000
053501,明泰兆豐96購01  ,0,0,0,0,0,0,0,0,0,-104000,0,0,0,0,104000,-104000,-104000
056791,嘉聯益群益98購01,0,0,0,0,0,0,0,0,0,-104000,0,0,0,58000,162000,-104000,-104000
058375,群創凱基9B購04  ,0,0,0,0,0,0,0,0,0,-104000,0,0,0,74000,178000,-104000,-104000
057289,力成元大98購03  ,0,0,0,0,0,0,0,0,0,-104000,0,0,0,60000,164000,-104000,-104000
056314,力成元大97購01  ,0,0,0,0,0,0,0,0,0,-104000,0,0,0,1000,105000,-104000,-104000
058666,上証反群益01購01,0,0,0,0,0,0,0,0,0,-104000,0,0,0,30000,134000,-104000,-104000
3005,神基            ,355000,262000,93000,0,0,0,5000,0,5000,-202000,1000,0,1000,17000,220000,-203000,-104000
060852,京鼎國泰9B購01  ,0,0,0,0,0,0,0,0,0,-105000,0,0,0,429000,534000,-105000,-105000
061222,台灣50中信9A購02,0,0,0,0,0,0,0,0,0,-105000,0,0,0,0,105000,-105000,-105000
060403,上銀國泰9B購01  ,0,0,0,0,0,0,0,0,0,-105000,0,0,0,141000,246000,-105000,-105000
053189,聯發科統一96購05,0,0,0,0,0,0,0,0,0,-105000,0,0,0,0,105000,-105000,-105000
054128,台積電元大97購10,0,0,0,0,0,0,0,0,0,-105000,0,0,0,0,105000,-105000,-105000
053248,智伸科國票97購01,0,0,0,0,0,0,0,0,0,-105000,0,0,0,25000,130000,-105000,-105000
058525,台虹元大99購02  ,0,0,0,0,0,0,0,0,0,-105000,0,0,0,10000,115000,-105000,-105000
057990,美律統一99購02  ,0,0,0,0,0,0,0,0,0,-105000,0,0,0,0,105000,-105000,-105000
056250,瑞昱兆豐97購02  ,0,0,0,0,0,0,0,0,0,-105000,0,0,0,16000,121000,-105000,-105000
057045,美律元大99購04  ,0,0,0,0,0,0,0,0,0,-105000,0,0,0,0,105000,-105000,-105000
057096,緯穎元富98購01  ,0,0,0,0,0,0,0,0,0,-105000,0,0,0,10000,115000,-105000,-105000
058190,貿聯永豐99購01  ,0,0,0,0,0,0,0,0,0,-105000,0,0,0,10000,115000,-105000,-105000
060241,國泰金元大9A購01,0,0,0,0,0,0,0,0,0,-106000,0,0,0,0,106000,-106000,-106000
059688,燿華永豐99購01  ,0,0,0,0,0,0,0,0,0,-106000,0,0,0,5000,111000,-106000,-106000
059160,華通凱基99購03  ,0,0,0,0,0,0,0,0,0,-106000,0,0,0,19000,125000,-106000,-106000
060742,臺指反國票9B購02,0,0,0,0,0,0,0,0,0,-106000,0,0,0,1000,107000,-106000,-106000
00654R,富邦印度反1     ,2000,21000,-19000,0,0,0,0,0,0,-87000,0,0,0,28000,115000,-87000,-106000
058372,欣興凱基99購03  ,0,0,0,0,0,0,0,0,0,-106000,0,0,0,6000,112000,-106000,-106000
060286,佳世達元大9C購01,0,0,0,0,0,0,0,0,0,-107000,0,0,0,70000,177000,-107000,-107000
060112,祥碩元大99購04  ,0,0,0,0,0,0,0,0,0,-107000,0,0,0,191000,298000,-107000,-107000
052558,新唐國票97購01  ,0,0,0,0,0,0,0,0,0,-107000,0,0,0,0,107000,-107000,-107000
051659,力山國泰97購01  ,0,0,0,0,0,0,0,0,0,-107000,0,0,0,28000,135000,-107000,-107000
056689,玉晶光統一9A購03,0,0,0,0,0,0,0,0,0,-107000,0,0,0,8000,115000,-107000,-107000
058578,聯發科群益99購03,0,0,0,0,0,0,0,0,0,-107000,0,0,0,45000,152000,-107000,-107000
2915,潤泰全          ,685000,712476,-27476,0,0,0,5000,0,5000,-85000,15000,1000,14000,30000,129000,-99000,-107476
059525,上銀凱基99購08  ,0,0,0,0,0,0,0,0,0,-108000,0,0,0,1000,109000,-108000,-108000
061076,台達電兆豐9A購01,0,0,0,0,0,0,0,0,0,-108000,0,0,0,85000,193000,-108000,-108000
06507P,台表科國票99售01,0,0,0,0,0,0,0,0,0,-108000,0,0,0,2000,110000,-108000,-108000
050955,達方群益97購01  ,0,0,0,0,0,0,0,0,0,-108000,0,0,0,50000,158000,-108000,-108000
058556,百和永豐99購01  ,0,0,0,0,0,0,0,0,0,-108000,0,0,0,33000,141000,-108000,-108000
056422,全新統一98購02  ,0,0,0,0,0,0,0,0,0,-108000,0,0,0,0,108000,-108000,-108000
057328,京鼎群益99購02  ,0,0,0,0,0,0,0,0,0,-108000,0,0,0,165000,273000,-108000,-108000
061438,牧德凱基9B購02  ,0,0,0,0,0,0,0,0,0,-109000,0,0,0,0,109000,-109000,-109000
059760,楠梓電永豐99購01,0,0,0,0,0,0,0,0,0,-109000,0,0,0,106000,215000,-109000,-109000
059343,宏達電凱基99購04,0,0,0,0,0,0,0,0,0,-109000,0,0,0,240000,349000,-109000,-109000
053453,新光金統一98購01,0,0,0,0,0,0,0,0,0,-109000,0,0,0,0,109000,-109000,-109000
056958,喬山永豐98購01  ,0,0,0,0,0,0,0,0,0,-109000,0,0,0,0,109000,-109000,-109000
058604,華邦電元大99購03,0,0,0,0,0,0,0,0,0,-109000,0,0,0,59000,168000,-109000,-109000
07304P,臺股指元大9A售37,0,0,0,0,0,0,0,0,0,-109000,0,0,0,244000,353000,-109000,-109000
060028,國揚永豐99購01  ,0,0,0,0,0,0,0,0,0,-110000,0,0,0,24000,134000,-110000,-110000
060009,南亞科群益99購03,0,0,0,0,0,0,0,0,0,-110000,0,0,0,0,110000,-110000,-110000
060239,國揚元大9C購01  ,0,0,0,0,0,0,0,0,0,-110000,0,0,0,170000,280000,-110000,-110000
060702,玉晶光國泰9C購02,0,0,0,0,0,0,0,0,0,-110000,0,0,0,22000,132000,-110000,-110000
060686,康友元大9A購02  ,0,0,0,0,0,0,0,0,0,-110000,0,0,0,0,110000,-110000,-110000
060671,亞德客元大9A購03,0,0,0,0,0,0,0,0,0,-110000,0,0,0,0,110000,-110000,-110000
053428,中磊永豐96購02  ,0,0,0,0,0,0,0,0,0,-110000,0,0,0,0,110000,-110000,-110000
053527,創意中信97購01  ,0,0,0,0,0,0,0,0,0,-110000,0,0,0,0,110000,-110000,-110000
055383,GIS元大97購02   ,0,0,0,0,0,0,0,0,0,-110000,0,0,0,0,110000,-110000,-110000
053291,旺宏中信9A購01  ,0,0,0,0,0,0,0,0,0,-110000,0,0,0,200000,310000,-110000,-110000
054943,群光元大97購01  ,0,0,0,0,0,0,0,0,0,-110000,0,0,0,128000,238000,-110000,-110000
054970,帆宣元大97購01  ,0,0,0,0,0,0,0,0,0,-110000,0,0,0,171000,281000,-110000,-110000
051541,GIS國票96購02   ,0,0,0,0,0,0,0,0,0,-110000,0,0,0,0,110000,-110000,-110000
058882,晶相光永豐99購01,80000,0,80000,0,0,0,0,0,0,-190000,0,0,0,0,190000,-190000,-110000
056235,鴻海群益97購07  ,0,0,0,0,0,0,0,0,0,-110000,0,0,0,0,110000,-110000,-110000
055670,矽創群益98購02  ,0,0,0,0,0,0,0,0,0,-110000,0,0,0,74000,184000,-110000,-110000
056143,訊芯元大97購04  ,0,0,0,0,0,0,0,0,0,-110000,0,0,0,68000,178000,-110000,-110000
07703P,玉晶光中信9B售03,0,0,0,0,0,0,0,0,0,-110000,0,0,0,20000,130000,-110000,-110000
060554,中租凱基9A購01  ,0,0,0,0,0,0,0,0,0,-111000,0,0,0,0,111000,-111000,-111000
060929,健策永豐9A購01  ,0,0,0,0,0,0,0,0,0,-111000,0,0,0,5000,116000,-111000,-111000
061166,玉晶光兆豐9B購01,0,0,0,0,0,0,0,0,0,-111000,0,0,0,1000,112000,-111000,-111000
060278,道瓊反元大9A購03,0,0,0,0,0,0,0,0,0,-111000,0,0,0,62000,173000,-111000,-111000
058958,台表科國票9A購03,0,0,0,0,0,0,0,0,0,-111000,0,0,0,11000,122000,-111000,-111000
059949,啟碁永豐99購01  ,0,0,0,0,0,0,0,0,0,-112000,0,0,0,15000,127000,-112000,-112000
059930,健策富邦9B購01  ,0,0,0,0,0,0,0,0,0,-112000,0,0,0,46000,158000,-112000,-112000
060760,南亞科元大9A購04,0,0,0,0,0,0,0,0,0,-112000,0,0,0,75000,187000,-112000,-112000
051483,玉晶光凱基96購02,0,0,0,0,0,0,0,0,0,-112000,0,0,0,0,112000,-112000,-112000
053500,新日興兆豐97購01,0,0,0,0,0,0,0,0,0,-112000,0,0,0,16000,128000,-112000,-112000
057805,華通元大98購06  ,0,0,0,0,0,0,0,0,0,-112000,0,0,0,40000,152000,-112000,-112000
058324,嘉聯益永豐9A購01,0,0,0,0,0,0,0,0,0,-112000,0,0,0,28000,140000,-112000,-112000
07494P,葡萄王元大9A售03,0,5000,-5000,0,0,0,0,0,0,-107000,0,0,0,9000,116000,-107000,-112000
060977,亞德客元大9A購04,0,0,0,0,0,0,0,0,0,-113000,0,0,0,9000,122000,-113000,-113000
061200,道瓊反元大9A購06,0,0,0,0,0,0,0,0,0,-113000,0,0,0,27000,140000,-113000,-113000
054977,SP黃豆元富9B購01,0,0,0,0,0,0,0,0,0,-113000,0,0,0,0,113000,-113000,-113000
00662,富邦NASDAQ      ,1000,1000,0,0,0,0,0,0,0,-113000,9000,0,9000,66000,188000,-122000,-113000
058342,鴻海群益9A購01  ,0,0,0,0,0,0,0,0,0,-113000,0,0,0,5000,118000,-113000,-113000
055667,致茂群益98購01  ,0,0,0,0,0,0,0,0,0,-113000,0,0,0,56000,169000,-113000,-113000
057574,中磊永豐98購01  ,0,0,0,0,0,0,0,0,0,-113000,0,0,0,0,113000,-113000,-113000
061006,新光金兆豐9A購01,0,0,0,0,0,0,0,0,0,-114000,0,0,0,0,114000,-114000,-114000
059351,台虹凱基99購01  ,0,0,0,0,0,0,0,0,0,-114000,0,0,0,0,114000,-114000,-114000
053502,智伸科兆豐97購01,0,0,0,0,0,0,0,0,0,-114000,0,0,0,10000,124000,-114000,-114000
07389P,臺股指群益9C售08,0,0,0,0,0,0,0,0,0,-115000,0,0,0,29000,144000,-115000,-115000
060697,鴻海國泰9C購01  ,0,0,0,0,0,0,0,0,0,-116000,0,0,0,27000,143000,-116000,-116000
060624,玉晶光元大9C購02,0,0,0,0,0,0,0,0,0,-116000,0,0,0,0,116000,-116000,-116000
053281,茂林元大96購02  ,0,0,0,0,0,0,0,0,0,-116000,0,0,0,161000,277000,-116000,-116000
042752,台灣50元大96購03,0,0,0,0,0,0,0,0,0,-116000,0,0,0,17000,133000,-116000,-116000
055252,新光金統一98購02,0,0,0,0,0,0,0,0,0,-116000,0,0,0,126000,242000,-116000,-116000
07172P,臺股指國票99售09,0,0,0,0,0,0,0,0,0,-116000,0,0,0,211000,327000,-116000,-116000
061052,和大群益9A購01  ,0,0,0,0,0,0,0,0,0,-117000,0,0,0,0,117000,-117000,-117000
061355,康友元大9A購03  ,0,0,0,0,0,0,0,0,0,-117000,0,0,0,2000,119000,-117000,-117000
052739,國巨元大96購04  ,0,0,0,0,0,0,0,0,0,-117000,0,0,0,0,117000,-117000,-117000
057926,帆宣凱基98購02  ,0,0,0,0,0,0,0,0,0,-117000,0,0,0,50000,167000,-117000,-117000
057831,聯發科元富02購04,0,0,0,0,0,0,0,0,0,-117000,0,0,0,11000,128000,-117000,-117000
056909,嘉聯益元大99購03,0,0,0,0,0,0,0,0,0,-117000,0,0,0,129000,246000,-117000,-117000
060958,儒鴻凱基9A購02  ,0,0,0,0,0,0,0,0,0,-118000,0,0,0,21000,139000,-118000,-118000
060194,旭富元富9A購01  ,0,0,0,0,0,0,0,0,0,-118000,0,0,0,59000,177000,-118000,-118000
054481,鎧勝中信96購01  ,0,0,0,0,0,0,0,0,0,-118000,0,0,0,16000,134000,-118000,-118000
053638,信邦永豐96購01  ,0,0,0,0,0,0,0,0,0,-118000,0,0,0,14000,132000,-118000,-118000
053171,中磊群益96購01  ,0,0,0,0,0,0,0,0,0,-118000,0,0,0,0,118000,-118000,-118000
056621,宏達電永豐98購01,0,0,0,0,0,0,0,0,0,-118000,0,0,0,0,118000,-118000,-118000
056098,矽創元富97購02  ,0,0,0,0,0,0,0,0,0,-118000,0,0,0,0,118000,-118000,-118000
056023,晶豪科群益97購01,0,0,0,0,0,0,0,0,0,-118000,0,0,0,7000,125000,-118000,-118000
055963,欣興元大97購04  ,0,0,0,0,0,0,0,0,0,-118000,0,0,0,0,118000,-118000,-118000
059996,美律元富99購01  ,0,0,0,0,0,0,0,0,0,-119000,0,0,0,133000,252000,-119000,-119000
059326,康友元大99購01  ,0,0,0,0,0,0,0,0,0,-119000,0,0,0,128000,247000,-119000,-119000
057815,信邦元大98購01  ,0,0,0,0,0,0,0,0,0,-119000,0,0,0,110000,229000,-119000,-119000
058782,臺股指國票99購01,0,0,0,0,0,0,0,0,0,-119000,0,0,0,0,119000,-119000,-119000
06949P,台表科元大99售01,0,0,0,0,0,0,0,0,0,-119000,0,0,0,5000,124000,-119000,-119000
060049,華通凱基99購06  ,0,0,0,0,0,0,0,0,0,-120000,0,0,0,51000,171000,-120000,-120000
059951,台塑康和99購01  ,0,0,0,0,0,0,0,0,0,-120000,0,0,0,73000,193000,-120000,-120000
060787,奇力新富邦9A購01,0,0,0,0,0,0,0,0,0,-120000,0,0,0,0,120000,-120000,-120000
061392,泰鼎群益9A購02  ,0,0,0,0,0,0,0,0,0,-120000,0,0,0,0,120000,-120000,-120000
06208P,台郡凱基97售03  ,0,0,0,0,0,0,0,0,0,-120000,0,0,0,0,120000,-120000,-120000
053094,聯電統一97購02  ,0,0,0,0,0,0,0,0,0,-120000,0,0,0,45000,165000,-120000,-120000
053585,友達元大9C購03  ,0,0,0,0,0,0,0,0,0,-120000,0,0,0,0,120000,-120000,-120000
00663L,國泰臺灣加權正2 ,0,0,0,0,0,0,0,0,0,-120000,0,0,0,179000,299000,-120000,-120000
050584,瑞儀國票95購01  ,0,0,0,0,0,0,0,0,0,-120000,0,0,0,0,120000,-120000,-120000
057724,亞德客國泰99購01,0,0,0,0,0,0,0,0,0,-120000,0,0,0,254000,374000,-120000,-120000
057595,健鼎兆豐98購01  ,0,0,0,0,0,0,0,0,0,-120000,0,0,0,0,120000,-120000,-120000
057837,康控國泰99購02  ,0,0,0,0,0,0,0,0,0,-120000,0,0,0,0,120000,-120000,-120000
057438,禾伸堂國票99購01,0,0,0,0,0,0,0,0,0,-120000,0,0,0,17000,137000,-120000,-120000
057236,聯詠凱基98購03  ,0,0,0,0,0,0,0,0,0,-120000,0,0,0,0,120000,-120000,-120000
3698,隆達            ,1015000,1326000,-311000,0,0,0,0,0,0,191000,212000,6000,206000,1000,16000,-15000,-120000
061111,台表科元大9A購02,0,0,0,0,0,0,0,0,0,-121000,0,0,0,11000,132000,-121000,-121000
060356,上銀元富9A購01  ,0,0,0,0,0,0,0,0,0,-121000,0,0,0,5000,126000,-121000,-121000
050460,GIS元大95購03   ,0,0,0,0,0,0,0,0,0,-121000,0,0,0,1000,122000,-121000,-121000
055333,晶豪科兆豐97購01,0,0,0,0,0,0,0,0,0,-121000,0,0,0,10000,131000,-121000,-121000
058025,聯茂國泰99購01  ,0,0,0,0,0,0,0,0,0,-121000,0,0,0,5000,126000,-121000,-121000
055183,聯鈞統一97購01  ,0,0,0,0,0,0,0,0,0,-121000,0,0,0,88000,209000,-121000,-121000
056898,全新元大98購02  ,0,0,0,0,0,0,0,0,0,-121000,0,0,0,0,121000,-121000,-121000
07309P,聯發科凱基99售18,0,0,0,0,0,0,0,0,0,-121000,0,0,0,6000,127000,-121000,-121000
061107,世芯元大9A購05  ,0,0,0,0,0,0,0,0,0,-122000,0,0,0,76000,198000,-122000,-122000
061070,超眾凱基9C購01  ,0,0,0,0,0,0,0,0,0,-122000,0,0,0,28000,150000,-122000,-122000
060708,康友富邦9B購01  ,0,0,0,0,0,0,0,0,0,-122000,0,0,0,0,122000,-122000,-122000
056535,全新凱基99購02  ,0,0,0,0,0,0,0,0,0,-122000,0,0,0,44000,166000,-122000,-122000
052374,瑞昱元大95購02  ,0,0,0,0,0,0,0,0,0,-122000,0,0,0,0,122000,-122000,-122000
057059,易華電元大99購01,0,0,0,0,0,0,0,0,0,-122000,0,0,0,43000,165000,-122000,-122000
058801,致伸元大99購01  ,0,0,0,0,0,0,0,0,0,-122000,0,0,0,155000,277000,-122000,-122000
058111,健鼎元富98購01  ,0,0,0,0,0,0,0,0,0,-122000,0,0,0,10000,132000,-122000,-122000
055519,茂林中信99購01  ,0,0,0,0,0,0,0,0,0,-122000,0,0,0,41000,163000,-122000,-122000
060756,鴻海元大9A購16  ,0,0,0,0,0,0,0,0,0,-123000,0,0,0,0,123000,-123000,-123000
060619,玉晶光元大9A購03,0,0,0,0,0,0,0,0,0,-123000,0,0,0,230000,353000,-123000,-123000
061267,玉山金凱基9B購01,0,0,0,0,0,0,0,0,0,-123000,0,0,0,81000,204000,-123000,-123000
00783,富邦中証500     ,0,234000,-234000,0,0,0,0,0,0,111000,0,0,0,1109000,998000,111000,-123000
054255,亞光元大96購05  ,0,0,0,0,0,0,0,0,0,-123000,0,0,0,0,123000,-123000,-123000
057300,訊連永豐98購01  ,0,0,0,0,0,0,0,0,0,-123000,0,0,0,102000,225000,-123000,-123000
057601,中磊群益98購01  ,0,0,0,0,0,0,0,0,0,-123000,0,0,0,0,123000,-123000,-123000
056818,正崴永豐98購01  ,0,0,0,0,0,0,0,0,0,-123000,0,0,0,13000,136000,-123000,-123000
056000,佳世達永豐97購01,0,0,0,0,0,0,0,0,0,-123000,0,0,0,0,123000,-123000,-123000
060797,世芯永豐9A購04  ,0,0,0,0,0,0,0,0,0,-124000,0,0,0,111000,235000,-124000,-124000
060191,亞光元富9A購02  ,0,0,0,0,0,0,0,0,0,-124000,0,0,0,100000,224000,-124000,-124000
054801,康友群益97購02  ,0,0,0,0,0,0,0,0,0,-124000,0,0,0,98000,222000,-124000,-124000
057733,嘉聯益國泰99購01,0,0,0,0,0,0,0,0,0,-124000,0,0,0,98000,222000,-124000,-124000
058658,瑞儀中信99購01  ,0,0,0,0,0,0,0,0,0,-124000,0,0,0,89000,213000,-124000,-124000
058137,玉晶光元大99購11,0,0,0,0,0,0,0,0,0,-124000,0,0,0,17000,141000,-124000,-124000
059480,美律群益9A購01  ,0,0,0,0,0,0,0,0,0,-125000,0,0,0,180000,305000,-125000,-125000
061002,瑞昱兆豐9B購01  ,0,0,0,0,0,0,0,0,0,-125000,0,0,0,401000,526000,-125000,-125000
061237,晶技元大9A購01  ,0,0,0,0,0,0,0,0,0,-125000,0,0,0,23000,148000,-125000,-125000
061247,玉晶光群益9A購09,0,0,0,0,0,0,0,0,0,-125000,0,0,0,2000,127000,-125000,-125000
054523,GIS元大96購05   ,0,0,0,0,0,0,0,0,0,-125000,0,0,0,0,125000,-125000,-125000
055525,國巨群益98購05  ,0,0,0,0,0,0,0,0,0,-125000,0,0,0,158000,283000,-125000,-125000
057424,訊芯凱基98購04  ,0,0,0,0,0,0,0,0,0,-125000,0,0,0,48000,173000,-125000,-125000
055874,中環元富9A購01  ,0,0,0,0,0,0,0,0,0,-125000,0,0,0,556000,681000,-125000,-125000
056385,創意國泰99購01  ,0,0,0,0,0,0,0,0,0,-125000,0,0,0,13000,138000,-125000,-125000
060499,鴻海元大9A購11  ,0,0,0,0,0,0,0,0,0,-126000,0,0,0,9000,135000,-126000,-126000
055983,全新元富9A購02  ,0,0,0,0,0,0,0,0,0,-126000,0,0,0,0,126000,-126000,-126000
057928,鈺齊凱基98購02  ,0,0,0,0,0,0,0,0,0,-126000,0,0,0,0,126000,-126000,-126000
060966,台表科凱基9B購01,0,0,0,0,0,0,0,0,0,-127000,0,0,0,10000,137000,-127000,-127000
059852,康控永豐99購02  ,0,0,0,0,0,0,0,0,0,-127000,0,0,0,173000,300000,-127000,-127000
056919,英業達兆豐98購01,0,0,0,0,0,0,0,0,0,-127000,0,0,0,100000,227000,-127000,-127000
056365,欣興元大98購01  ,0,0,0,0,0,0,0,0,0,-127000,0,0,0,21000,148000,-127000,-127000
059943,信邦永豐99購01  ,0,0,0,0,0,0,0,0,0,-128000,0,0,0,92000,220000,-128000,-128000
060292,聯詠元大9A購01  ,0,0,0,0,0,0,0,0,0,-128000,0,0,0,135000,263000,-128000,-128000
060253,昇陽半元大9C購01,0,0,0,0,0,0,0,0,0,-128000,0,0,0,0,128000,-128000,-128000
057495,牧德元大99購04  ,0,0,0,0,0,0,0,0,0,-128000,0,0,0,15000,143000,-128000,-128000
056842,全新元富98購01  ,0,0,0,0,0,0,0,0,0,-128000,0,0,0,0,128000,-128000,-128000
059080,亞泥元大99購01  ,0,0,0,0,0,0,0,0,0,-128000,0,0,0,61000,189000,-128000,-128000
055173,瑞昱統一97購01  ,0,0,0,0,0,0,0,0,0,-128000,0,0,0,9000,137000,-128000,-128000
07700P,臺股指元大9A售53,0,0,0,0,0,0,0,0,0,-128000,0,0,0,324000,452000,-128000,-128000
060159,健和興永豐9A購01,0,0,0,0,0,0,0,0,0,-129000,0,0,0,0,129000,-129000,-129000
056622,高鐵永豐98購01  ,0,0,0,0,0,0,0,0,0,-129000,0,0,0,0,129000,-129000,-129000
054898,台肥康和97購01  ,0,0,0,0,0,0,0,0,0,-129000,0,0,0,10000,139000,-129000,-129000
03433B,臺股指元大9C熊01,0,0,0,0,0,0,0,0,0,-129000,0,0,0,112000,241000,-129000,-129000
058126,元油2X元大9C購02,0,0,0,0,0,0,0,0,0,-129000,0,0,0,0,129000,-129000,-129000
060197,臻鼎元富9A購02  ,0,0,0,0,0,0,0,0,0,-130000,0,0,0,408000,538000,-130000,-130000
059570,全新凱基99購04  ,0,0,0,0,0,0,0,0,0,-130000,0,0,0,58000,188000,-130000,-130000
060667,力成凱基9A購01  ,0,0,0,0,0,0,0,0,0,-130000,0,0,0,40000,170000,-130000,-130000
051928,大立光中信96購03,0,0,0,0,0,0,0,0,0,-130000,0,0,0,0,130000,-130000,-130000
054873,帆宣群益99購01  ,0,0,0,0,0,0,0,0,0,-130000,0,0,0,0,130000,-130000,-130000
052858,華通凱基97購02  ,0,0,0,0,0,0,0,0,0,-130000,0,0,0,25000,155000,-130000,-130000
054240,訊芯群益96購03  ,0,0,0,0,0,0,0,0,0,-130000,0,0,0,98000,228000,-130000,-130000
054070,創意國泰96購02  ,0,0,0,0,0,0,0,0,0,-130000,0,0,0,0,130000,-130000,-130000
055421,玉晶光永豐98購04,0,0,0,0,0,0,0,0,0,-130000,0,0,0,0,130000,-130000,-130000
057176,全新元大99購02  ,0,0,0,0,0,0,0,0,0,-130000,0,0,0,30000,160000,-130000,-130000
07649P,金像電永豐9A售02,0,0,0,0,0,0,0,0,0,-130000,0,0,0,118000,248000,-130000,-130000
9946,三發地產        ,18000,148000,-130000,0,0,0,0,0,0,0,0,0,0,0,0,0,-130000
060915,旭富元大9A購01  ,0,0,0,0,0,0,0,0,0,-131000,0,0,0,192000,323000,-131000,-131000
06654P,欣興元大98售08  ,0,0,0,0,0,0,0,0,0,-131000,0,0,0,0,131000,-131000,-131000
059641,群創凱基99購06  ,0,0,0,0,0,0,0,0,0,-131000,0,0,0,330000,461000,-131000,-131000
053473,聯發科元大96購15,0,0,0,0,0,0,0,0,0,-131000,0,0,0,49000,180000,-131000,-131000
052153,GIS富邦96購02   ,0,0,0,0,0,0,0,0,0,-131000,0,0,0,39000,170000,-131000,-131000
052695,台表科中信98購01,0,0,0,0,0,0,0,0,0,-131000,0,0,0,0,131000,-131000,-131000
058215,貿聯群益99購02  ,0,0,0,0,0,0,0,0,0,-131000,0,0,0,0,131000,-131000,-131000
058847,國巨群益99購05  ,0,0,0,0,0,0,0,0,0,-131000,0,0,0,22000,153000,-131000,-131000
056304,創意元大97購03  ,0,0,0,0,0,0,0,0,0,-131000,0,0,0,0,131000,-131000,-131000
05971P,世紀鋼永豐96售04,0,0,0,0,0,0,0,0,0,-132000,0,0,0,20000,152000,-132000,-132000
061340,義隆元大9A購01  ,0,0,0,0,0,0,0,0,0,-132000,0,0,0,40000,172000,-132000,-132000
051503,玉晶光統一97購01,0,0,0,0,0,0,0,0,0,-132000,0,0,0,38000,170000,-132000,-132000
056686,可成統一98購01  ,0,0,0,0,0,0,0,0,0,-132000,0,0,0,1000,133000,-132000,-132000
6451,訊芯-KY         ,223000,437000,-214000,0,0,0,0,0,0,82000,6000,6000,0,83000,1000,82000,-132000
055217,緯創凱基97購02  ,0,0,0,0,0,0,0,0,0,-133000,0,0,0,0,133000,-133000,-133000
8016,矽創            ,177000,231000,-54000,0,0,0,22000,100000,-78000,-1000,0,0,0,3000,4000,-1000,-133000
060731,奇力新群益9A購01,0,0,0,0,0,0,0,0,0,-134000,0,0,0,174000,308000,-134000,-134000
059425,SGBR2X元大9A購02,0,0,0,0,0,0,0,0,0,-134000,0,0,0,234000,368000,-134000,-134000
059144,嘉晶國票9A購02  ,0,0,0,0,0,0,0,0,0,-134000,0,0,0,30000,164000,-134000,-134000
051428,玉晶光統一96購01,0,0,0,0,0,0,0,0,0,-134000,0,0,0,0,134000,-134000,-134000
058170,國巨凱基9A購06  ,0,0,0,0,0,0,0,0,0,-134000,0,0,0,245000,379000,-134000,-134000
058100,聯茂國泰99購02  ,0,0,0,0,0,0,0,0,0,-134000,0,0,0,0,134000,-134000,-134000
060422,台勝科永豐9A購01,0,0,0,0,0,0,0,0,0,-135000,0,0,0,67000,202000,-135000,-135000
06619P,聯發科元大98售06,0,0,0,0,0,0,0,0,0,-135000,0,0,0,0,135000,-135000,-135000
056558,台達電群益98購01,0,0,0,0,0,0,0,0,0,-135000,0,0,0,114000,249000,-135000,-135000
052704,TPK國票97購01   ,0,0,0,0,0,0,0,0,0,-135000,0,0,0,0,135000,-135000,-135000
057629,泰碩永豐98購02  ,0,0,0,0,0,0,0,0,0,-135000,0,0,0,0,135000,-135000,-135000
057450,國泰金元富98購01,0,0,0,0,0,0,0,0,0,-135000,0,0,0,0,135000,-135000,-135000
057833,聯發科元富02購06,0,0,0,0,0,0,0,0,0,-135000,0,0,0,17000,152000,-135000,-135000
058246,帆宣元大99購01  ,0,0,0,0,0,0,0,0,0,-135000,0,0,0,15000,150000,-135000,-135000
055206,台虹中信97購01  ,0,0,0,0,0,0,0,0,0,-135000,0,0,0,5000,140000,-135000,-135000
056455,群創凱基9A購01  ,0,0,0,0,0,0,0,0,0,-135000,0,0,0,20000,155000,-135000,-135000
060366,健策元富9A購01  ,0,0,0,0,0,0,0,0,0,-137000,0,0,0,72000,209000,-137000,-137000
060026,聯發科富邦9B購05,0,0,0,0,0,0,0,0,0,-137000,0,0,0,42000,179000,-137000,-137000
054768,泰碩國票99購02  ,0,0,0,0,0,0,0,0,0,-137000,0,0,0,20000,157000,-137000,-137000
051449,玉晶光元大96購01,0,0,0,0,0,0,0,0,0,-137000,0,0,0,13000,150000,-137000,-137000
052572,群創凱基99購01  ,0,0,0,0,0,0,0,0,0,-137000,0,0,0,0,137000,-137000,-137000
057063,立積國泰9A購01  ,0,0,0,0,0,0,0,0,0,-137000,0,0,0,0,137000,-137000,-137000
058720,旭富元富99購01  ,0,0,0,0,0,0,0,0,0,-137000,0,0,0,38000,175000,-137000,-137000
057404,貿聯群益99購01  ,0,0,0,0,0,0,0,0,0,-137000,0,0,0,0,137000,-137000,-137000
057158,義隆永豐99購01  ,0,0,0,0,0,0,0,0,0,-137000,0,0,0,152000,289000,-137000,-137000
059920,宏達電元大99購07,0,0,0,0,0,0,0,0,0,-138000,0,0,0,187000,325000,-138000,-138000
060484,聯發科富邦9C購02,0,0,0,0,0,0,0,0,0,-138000,0,0,0,181000,319000,-138000,-138000
056526,力山凱基98購01  ,0,0,0,0,0,0,0,0,0,-138000,0,0,0,129000,267000,-138000,-138000
058259,訊連國泰9B購01  ,0,0,0,0,0,0,0,0,0,-138000,0,0,0,1000,139000,-138000,-138000
058318,致茂永豐9A購01  ,0,0,0,0,0,0,0,0,0,-138000,0,0,0,29000,167000,-138000,-138000
057929,上銀群益98購02  ,0,0,0,0,0,0,0,0,0,-138000,0,0,0,183000,321000,-138000,-138000
060781,台郡國泰9B購01  ,0,0,0,0,0,0,0,0,0,-139000,0,0,0,47000,186000,-139000,-139000
061004,友達兆豐9A購01  ,0,0,0,0,0,0,0,0,0,-139000,0,0,0,175000,314000,-139000,-139000
061045,儒鴻第一9A購01  ,0,0,0,0,0,0,0,0,0,-139000,0,0,0,0,139000,-139000,-139000
061319,聯發科凱基9A購16,0,0,0,0,0,0,0,0,0,-139000,0,0,0,0,139000,-139000,-139000
054258,牧德元大97購01  ,0,0,0,0,0,0,0,0,0,-139000,0,0,0,8000,147000,-139000,-139000
046384,群創凱基98購02  ,0,0,0,0,0,0,0,0,0,-139000,0,0,0,91000,230000,-139000,-139000
061333,華通元大9A購08  ,0,0,0,0,0,0,0,0,0,-140000,0,0,0,170000,310000,-140000,-140000
052491,泰碩國票99購01  ,0,0,0,0,0,0,0,0,0,-140000,0,0,0,10000,150000,-140000,-140000
054331,世芯永豐96購03  ,0,0,0,0,0,0,0,0,0,-140000,0,0,0,26000,166000,-140000,-140000
054590,嘉聯益國泰98購01,0,0,0,0,0,0,0,0,0,-140000,0,0,0,0,140000,-140000,-140000
058865,群創凱基01購01  ,0,0,0,0,0,0,0,0,0,-140000,0,0,0,0,140000,-140000,-140000
056280,上証2X永豐98購01,0,0,0,0,0,0,0,0,0,-140000,0,0,0,10000,150000,-140000,-140000
056391,大立光富邦9C購01,0,0,0,0,0,0,0,0,0,-140000,0,0,0,0,140000,-140000,-140000
058264,瑞昱永豐99購01  ,0,0,0,0,0,0,0,0,0,-140000,0,0,0,51000,191000,-140000,-140000
058090,聯發科元大98購16,0,0,0,0,0,0,0,0,0,-140000,0,0,0,60000,200000,-140000,-140000
057325,可成群益9A購01  ,0,0,0,0,0,0,0,0,0,-140000,0,0,0,8000,148000,-140000,-140000
061378,南六永豐9A購03  ,0,0,0,0,0,0,0,0,0,-141000,0,0,0,209000,350000,-141000,-141000
060868,致伸永豐9A購01  ,0,0,0,0,0,0,0,0,0,-141000,0,0,0,0,141000,-141000,-141000
060654,大毅群益9B購01  ,0,0,0,0,0,0,0,0,0,-141000,0,0,0,55000,196000,-141000,-141000
057511,健策統一98購02  ,0,0,0,0,0,0,0,0,0,-141000,0,0,0,5000,146000,-141000,-141000
058783,臺股指國票99購02,0,0,0,0,0,0,0,0,0,-141000,0,0,0,0,141000,-141000,-141000
056486,樺漢元大98購04  ,0,0,0,0,0,0,0,0,0,-142000,0,0,0,0,142000,-142000,-142000
060909,金像電元大9B購01,0,0,0,0,0,0,0,0,0,-143000,0,0,0,119000,262000,-143000,-143000
060058,牧德凱基9B購01  ,0,0,0,0,0,0,0,0,0,-143000,0,0,0,408000,551000,-143000,-143000
060053,聯發科凱基9B購02,0,0,0,0,0,0,0,0,0,-143000,0,0,0,6000,149000,-143000,-143000
056091,百和統一97購01  ,0,0,0,0,0,0,0,0,0,-143000,0,0,0,48000,191000,-143000,-143000
058118,瑞昱群益99購01  ,0,0,0,0,0,0,0,0,0,-143000,0,0,0,62000,205000,-143000,-143000
055762,智伸科群益97購01,0,0,0,0,0,0,0,0,0,-143000,0,0,0,108000,251000,-143000,-143000
060052,宏碁凱基99購01  ,0,0,0,0,0,0,0,0,0,-144000,0,0,0,69000,213000,-144000,-144000
059123,訊芯永豐99購03  ,0,0,0,0,0,0,0,0,0,-144000,0,0,0,200000,344000,-144000,-144000
052853,友達日盛99購01  ,0,0,0,0,0,0,0,0,0,-144000,0,0,0,0,144000,-144000,-144000
058140,臻鼎元大99購02  ,0,0,0,0,0,0,0,0,0,-144000,0,0,0,0,144000,-144000,-144000
057106,美律群益98購03  ,0,0,0,0,0,0,0,0,0,-144000,0,0,0,61000,205000,-144000,-144000
060364,奇力新元富9A購01,0,0,0,0,0,0,0,0,0,-145000,0,0,0,165000,310000,-145000,-145000
060413,東元永豐9A購01  ,0,0,0,0,0,0,0,0,0,-145000,0,0,0,0,145000,-145000,-145000
060184,建準元富9A購01  ,0,0,0,0,0,0,0,0,0,-145000,0,0,0,12000,157000,-145000,-145000
060814,健策凱基9B購01  ,0,0,0,0,0,0,0,0,0,-145000,0,0,0,16000,161000,-145000,-145000
057684,聯茂日盛99購01  ,0,0,0,0,0,0,0,0,0,-145000,0,0,0,0,145000,-145000,-145000
6239,力成            ,3514856,3911000,-396144,0,0,0,240000,0,240000,11000,39000,35000,4000,23000,16000,7000,-145144
060916,金像電國泰9C購01,0,0,0,0,0,0,0,0,0,-146000,0,0,0,87000,233000,-146000,-146000
059139,全新兆豐9A購01  ,0,0,0,0,0,0,0,0,0,-146000,0,0,0,32000,178000,-146000,-146000
054279,揚明光群益98購01,0,0,0,0,0,0,0,0,0,-146000,0,0,0,50000,196000,-146000,-146000
053595,創意元大96購02  ,0,0,0,0,0,0,0,0,0,-146000,0,0,0,0,146000,-146000,-146000
00710B,FH彭博高收益債  ,2000,0,2000,0,0,0,0,0,0,-148000,0,0,0,163000,311000,-148000,-146000
057375,欣興元大98購09  ,0,0,0,0,0,0,0,0,0,-146000,0,0,0,0,146000,-146000,-146000
058224,世芯統一9B購02  ,0,0,0,0,0,0,0,0,0,-146000,0,0,0,270000,416000,-146000,-146000
061370,晶技國泰9C購01  ,0,0,0,0,0,0,0,0,0,-147000,0,0,0,135000,282000,-147000,-147000
054050,創意元大96購06  ,0,0,0,0,0,0,0,0,0,-147000,0,0,0,0,147000,-147000,-147000
054928,帆宣凱基98購01  ,0,0,0,0,0,0,0,0,0,-147000,0,0,0,49000,196000,-147000,-147000
057638,上銀元大99購01  ,0,0,0,0,0,0,0,0,0,-147000,0,0,0,3000,150000,-147000,-147000
056410,康控國票99購01  ,0,0,0,0,0,0,0,0,0,-147000,0,0,0,0,147000,-147000,-147000
059004,嘉晶元大99購05  ,0,0,0,0,0,0,0,0,0,-147000,0,0,0,73000,220000,-147000,-147000
056579,麗豐元大99購01  ,0,0,0,0,0,0,0,0,0,-148000,0,0,0,100000,248000,-148000,-148000
059742,富邦金元富99購01,0,0,0,0,0,0,0,0,0,-149000,0,0,0,27000,176000,-149000,-149000
060405,中租國泰9C購01  ,0,5000,-5000,0,0,0,0,0,0,-144000,0,0,0,14000,158000,-144000,-149000
03648C,T50反1元大96牛07,0,0,0,0,0,0,0,0,0,-149000,0,0,0,0,149000,-149000,-149000
057203,麗豐元富98購02  ,0,0,0,0,0,0,0,0,0,-149000,0,0,0,0,149000,-149000,-149000
2451,創見            ,231000,326000,-95000,0,0,0,54000,0,54000,-108000,0,0,0,0,108000,-108000,-149000
059185,臺股指台新99購12,0,0,0,0,0,0,0,0,0,-150000,0,0,0,0,150000,-150000,-150000
060992,健策元大9A購05  ,0,0,0,0,0,0,0,0,0,-150000,0,0,0,98000,248000,-150000,-150000
053984,康友元大96購05  ,0,0,0,0,0,0,0,0,0,-150000,0,0,0,0,150000,-150000,-150000
054874,帆宣群益99購02  ,0,0,0,0,0,0,0,0,0,-150000,0,0,0,100000,250000,-150000,-150000
057187,群創元大9B購04  ,0,0,0,0,0,0,0,0,0,-150000,0,0,0,0,150000,-150000,-150000
057285,群創元大98購07  ,0,0,0,0,0,0,0,0,0,-150000,0,0,0,0,150000,-150000,-150000
05758P,光罩永豐96售02  ,0,0,0,0,0,0,0,0,0,-150000,0,0,0,40000,190000,-150000,-150000
056146,台虹元大98購01  ,0,0,0,0,0,0,0,0,0,-150000,0,0,0,0,150000,-150000,-150000
057956,全新元大99購04  ,0,0,0,0,0,0,0,0,0,-150000,0,0,0,0,150000,-150000,-150000
05635P,健策台新96售02  ,0,0,0,0,0,0,0,0,0,-150000,0,0,0,0,150000,-150000,-150000
057700,新日興群益9A購01,0,0,0,0,0,0,0,0,0,-150000,0,0,0,76000,226000,-150000,-150000
054720,禾伸堂永豐97購01,0,0,0,0,0,0,0,0,0,-151000,0,0,0,17000,168000,-151000,-151000
056255,華新科元富97購05,0,0,0,0,0,0,0,0,0,-151000,0,0,0,92000,243000,-151000,-151000
055509,訊芯元大97購03  ,0,0,0,0,0,0,0,0,0,-151000,0,0,0,20000,171000,-151000,-151000
060817,華邦電台新9A購01,0,0,0,0,0,0,0,0,0,-152000,0,0,0,28000,180000,-152000,-152000
060785,國巨富邦9B購04  ,0,0,0,0,0,0,0,0,0,-152000,0,0,0,35000,187000,-152000,-152000
056496,康控國泰99購01  ,0,0,0,0,0,0,0,0,0,-152000,0,0,0,0,152000,-152000,-152000
051460,S&P反1國泰97購01,0,0,0,0,0,0,0,0,0,-152000,0,0,0,0,152000,-152000,-152000
049871,T50反1台新9A購02,0,0,0,0,0,0,0,0,0,-152000,0,0,0,235000,387000,-152000,-152000
056287,亞光永豐97購02  ,0,0,0,0,0,0,0,0,0,-152000,0,0,0,8000,160000,-152000,-152000
056058,建準元大97購02  ,0,0,0,0,0,0,0,0,0,-152000,0,0,0,0,152000,-152000,-152000
058772,茂林兆豐9A購01  ,0,0,0,0,0,0,0,0,0,-152000,0,0,0,93000,245000,-152000,-152000
060759,南亞科元大9A購03,0,0,0,0,0,0,0,0,0,-153000,0,0,0,50000,203000,-153000,-153000
057701,嘉聯益群益98購02,0,0,0,0,0,0,0,0,0,-153000,0,0,0,58000,211000,-153000,-153000
060684,同欣電元大9A購01,0,0,0,0,0,0,0,0,0,-154000,0,0,0,360000,514000,-154000,-154000
061136,可成統一9A購01  ,0,0,0,0,0,0,0,0,0,-154000,0,0,0,0,154000,-154000,-154000
060100,新光金元大9C購01,0,0,0,0,0,0,0,0,0,-154000,0,0,0,120000,274000,-154000,-154000
058216,TPK群益99購01   ,0,0,0,0,0,0,0,0,0,-154000,0,0,0,64000,218000,-154000,-154000
060729,國巨群益9A購05  ,0,0,0,0,0,0,0,0,0,-155000,0,0,0,201000,356000,-155000,-155000
053364,友達國泰98購01  ,0,0,0,0,0,0,0,0,0,-155000,0,0,0,72000,227000,-155000,-155000
057428,正崴兆豐98購01  ,0,0,0,0,0,0,0,0,0,-155000,0,0,0,78000,233000,-155000,-155000
057798,貿聯兆豐99購01  ,0,0,0,0,0,0,0,0,0,-155000,0,0,0,81000,236000,-155000,-155000
2059,川湖            ,240000,354000,-114000,0,0,0,0,61000,-61000,20000,20000,0,20000,0,0,0,-155000
060720,嘉聯益永豐9A購02,0,0,0,0,0,0,0,0,0,-156000,0,0,0,31000,187000,-156000,-156000
05525P,奇力新群益96售02,0,0,0,0,0,0,0,0,0,-156000,0,0,0,24000,180000,-156000,-156000
2332,友訊            ,327000,388000,-61000,0,0,0,0,0,0,-95000,35000,62000,-27000,13000,81000,-68000,-156000
060878,奇力新中信9C購01,0,0,0,0,0,0,0,0,0,-157000,0,0,0,180000,337000,-157000,-157000
061092,可成統一9C購02  ,0,0,0,0,0,0,0,0,0,-157000,0,0,0,6000,163000,-157000,-157000
061186,牧德國泰9C購01  ,0,0,0,0,0,0,0,0,0,-157000,0,0,0,213000,370000,-157000,-157000
061399,喬山兆豐9B購01  ,0,0,0,0,0,0,0,0,0,-157000,0,0,0,2000,159000,-157000,-157000
059849,興勤永豐99購01  ,0,0,0,0,0,0,0,0,0,-157000,0,0,0,17000,174000,-157000,-157000
058312,大毅國泰9B購01  ,0,0,0,0,0,0,0,0,0,-157000,0,0,0,186000,343000,-157000,-157000
058970,鴻海永豐99購02  ,0,0,0,0,0,0,0,0,0,-157000,0,0,0,137000,294000,-157000,-157000
061417,力成群益9A購01  ,0,0,0,0,0,0,0,0,0,-158000,0,0,0,0,158000,-158000,-158000
061071,復盛凱基9A購01  ,0,0,0,0,0,0,0,0,0,-158000,0,0,0,0,158000,-158000,-158000
054582,致新元大97購01  ,0,0,0,0,0,0,0,0,0,-158000,0,0,0,50000,208000,-158000,-158000
054298,台表科元大97購03,0,0,0,0,0,0,0,0,0,-158000,0,0,0,132000,290000,-158000,-158000
056031,勤誠康和97購02  ,0,0,0,0,0,0,0,0,0,-158000,0,0,0,0,158000,-158000,-158000
8215,明基材          ,743000,901000,-158000,0,0,0,0,0,0,0,0,0,0,0,0,0,-158000
06492P,上銀永豐98售01  ,0,0,0,0,0,0,0,0,0,-159000,0,0,0,2000,161000,-159000,-159000
059871,義隆凱基99購03  ,0,0,0,0,0,0,0,0,0,-159000,0,0,0,49000,208000,-159000,-159000
059460,GIS永豐99購02   ,0,0,0,0,0,0,0,0,0,-159000,0,0,0,101000,260000,-159000,-159000
056515,燿華兆豐99購01  ,0,0,0,0,0,0,0,0,0,-159000,0,0,0,0,159000,-159000,-159000
058727,嘉晶富邦9A購01  ,0,0,0,0,0,0,0,0,0,-159000,0,0,0,10000,169000,-159000,-159000
055196,致新元富97購01  ,0,0,0,0,0,0,0,0,0,-159000,0,0,0,76000,235000,-159000,-159000
6226,光鼎            ,122000,281000,-159000,0,0,0,0,0,0,0,0,0,0,0,0,0,-159000
07361P,聯發科元大99售34,0,0,0,0,0,0,0,0,0,-159000,0,0,0,40000,199000,-159000,-159000
060382,儒鴻凱基9A購01  ,0,0,0,0,0,0,0,0,0,-160000,0,0,0,0,160000,-160000,-160000
061504,祥碩國票9A購02  ,0,0,0,0,0,0,0,0,0,-160000,0,0,0,0,160000,-160000,-160000
061279,鴻海統一9C購04  ,0,0,0,0,0,0,0,0,0,-160000,0,0,0,0,160000,-160000,-160000
053569,漢唐統一98購01  ,0,0,0,0,0,0,0,0,0,-160000,0,0,0,48000,208000,-160000,-160000
053531,國泰金康和96購01,0,0,0,0,0,0,0,0,0,-160000,0,0,0,0,160000,-160000,-160000
052943,奇力新國票96購02,0,0,0,0,0,0,0,0,0,-160000,0,0,0,155000,315000,-160000,-160000
057824,日月光元大98購01,0,0,0,0,0,0,0,0,0,-160000,0,0,0,94000,254000,-160000,-160000
058569,健策凱基9A購01  ,0,0,0,0,0,0,0,0,0,-160000,0,0,0,9000,169000,-160000,-160000
07489P,國巨國票9A售07  ,0,0,0,0,0,0,0,0,0,-160000,0,0,0,80000,240000,-160000,-160000
07629P,臺股指凱基9A售10,0,0,0,0,0,0,0,0,0,-160000,0,0,0,5000,165000,-160000,-160000
061026,南電富邦9B購01  ,0,0,0,0,0,0,0,0,0,-161000,0,0,0,100000,261000,-161000,-161000
059154,可成日盛99購02  ,0,0,0,0,0,0,0,0,0,-161000,0,0,0,23000,184000,-161000,-161000
050363,臺指反元大98購04,0,0,0,0,0,0,0,0,0,-161000,0,0,0,0,161000,-161000,-161000
057707,臺股指群益98購07,0,0,0,0,0,0,0,0,0,-161000,0,0,0,148000,309000,-161000,-161000
057857,牧德國票99購01  ,0,0,0,0,0,0,0,0,0,-161000,0,0,0,139000,300000,-161000,-161000
059359,精元永豐99購01  ,0,0,0,0,0,0,0,0,0,-162000,0,0,0,0,162000,-162000,-162000
060323,華通群益9C購01  ,0,0,0,0,0,0,0,0,0,-162000,0,0,0,120000,282000,-162000,-162000
060458,華通元大9A購02  ,0,0,0,0,0,0,0,0,0,-162000,0,0,0,10000,172000,-162000,-162000
060979,國巨元大9A購14  ,0,0,0,0,0,0,0,0,0,-162000,0,0,0,116000,278000,-162000,-162000
060921,中橡永豐9A購02  ,0,0,0,0,0,0,0,0,0,-162000,0,0,0,2000,164000,-162000,-162000
055393,華新科統一97購03,0,0,0,0,0,0,0,0,0,-162000,0,0,0,15000,177000,-162000,-162000
056971,麗豐永豐98購01  ,0,0,0,0,0,0,0,0,0,-162000,0,0,0,0,162000,-162000,-162000
058478,聯發科凱基9A購01,0,0,0,0,0,0,0,0,0,-162000,0,0,0,0,162000,-162000,-162000
060762,長榮航元大9A購02,0,0,0,0,0,0,0,0,0,-163000,0,0,0,50000,213000,-163000,-163000
061122,敬鵬永豐9A購01  ,0,0,0,0,0,0,0,0,0,-163000,0,0,0,1000,164000,-163000,-163000
061223,T50反1中信01購01,0,0,0,0,0,0,0,0,0,-164000,0,0,0,6000,170000,-164000,-164000
060088,國巨元大99購30  ,0,0,0,0,0,0,0,0,0,-164000,0,0,0,38000,202000,-164000,-164000
059806,聯發科元富99購08,0,0,0,0,0,0,0,0,0,-164000,0,0,0,0,164000,-164000,-164000
055481,聚陽元大97購01  ,0,0,0,0,0,0,0,0,0,-164000,0,0,0,0,164000,-164000,-164000
059683,康控富邦9C購01  ,0,0,0,0,0,0,0,0,0,-165000,0,0,0,0,165000,-165000,-165000
052849,可成統一97購01  ,0,0,0,0,0,0,0,0,0,-165000,0,0,0,40000,205000,-165000,-165000
054826,復盛元大9A購01  ,0,0,0,0,0,0,0,0,0,-165000,0,0,0,0,165000,-165000,-165000
058590,南電中信9A購02  ,0,0,0,0,0,0,0,0,0,-165000,0,0,0,5000,170000,-165000,-165000
061353,康控元大9A購01  ,0,0,0,0,0,0,0,0,0,-166000,0,0,0,58000,224000,-166000,-166000
060639,玉晶光永豐9A購05,0,0,0,0,0,0,0,0,0,-167000,0,0,0,4000,171000,-167000,-167000
054059,欣興國票97購03  ,0,0,0,0,0,0,0,0,0,-167000,0,0,0,11000,178000,-167000,-167000
051722,玉晶光永豐97購01,0,0,0,0,0,0,0,0,0,-167000,0,0,0,45000,212000,-167000,-167000
060290,興富發元大9C購01,0,0,0,0,0,0,0,0,0,-168000,0,0,0,0,168000,-168000,-168000
058731,貿聯永豐99購02  ,0,0,0,0,0,0,0,0,0,-168000,0,0,0,3000,171000,-168000,-168000
056970,TPK永豐98購01   ,0,0,0,0,0,0,0,0,0,-168000,0,0,0,25000,193000,-168000,-168000
056984,嘉晶群益98購01  ,0,0,0,0,0,0,0,0,0,-168000,0,0,0,32000,200000,-168000,-168000
060190,國泰金元富9A購01,0,0,0,0,0,0,0,0,0,-169000,0,0,0,55000,224000,-169000,-169000
060214,茂林康和9A購01  ,0,0,0,0,0,0,0,0,0,-169000,0,0,0,46000,215000,-169000,-169000
059264,台光電中信99購02,0,0,0,0,0,0,0,0,0,-169000,0,0,0,59000,228000,-169000,-169000
060766,世芯元大9A購02  ,0,0,0,0,0,0,0,0,0,-169000,0,0,0,225000,394000,-169000,-169000
060978,國巨元大9A購13  ,0,0,0,0,0,0,0,0,0,-169000,0,0,0,46000,215000,-169000,-169000
054531,聯發科國泰97購02,0,0,0,0,0,0,0,0,0,-169000,0,0,0,15000,184000,-169000,-169000
056383,上銀國泰99購01  ,0,0,0,0,0,0,0,0,0,-169000,0,0,0,0,169000,-169000,-169000
056762,亞德客元大98購01,0,0,0,0,0,0,0,0,0,-169000,0,0,0,28000,197000,-169000,-169000
060989,國泰金元大9A購02,0,0,0,0,0,0,0,0,0,-170000,0,0,0,40000,210000,-170000,-170000
059516,TPK永豐99購01   ,0,0,0,0,0,0,0,0,0,-170000,0,0,0,33000,203000,-170000,-170000
060448,道瓊反元大9A購04,0,0,0,0,0,0,0,0,0,-170000,0,0,0,20000,190000,-170000,-170000
053671,可成統一96購03  ,0,0,0,0,0,0,0,0,0,-170000,0,0,0,0,170000,-170000,-170000
055131,茂林康和97購01  ,0,0,0,0,0,0,0,0,0,-170000,0,0,0,61000,231000,-170000,-170000
057832,聯發科元富02購05,0,0,0,0,0,0,0,0,0,-170000,0,0,0,33000,203000,-170000,-170000
059183,T50反1台新03購02,0,0,0,0,0,0,0,0,0,-171000,0,0,0,0,171000,-171000,-171000
053584,友達元大9B購02  ,0,0,0,0,0,0,0,0,0,-171000,0,0,0,15000,186000,-171000,-171000
059527,聯發科凱基99購16,0,0,0,0,0,0,0,0,0,-172000,0,0,0,131000,303000,-172000,-172000
060473,中租元大9A購03  ,0,0,0,0,0,0,0,0,0,-172000,0,0,0,13000,185000,-172000,-172000
060583,南亞科元富9A購05,0,0,0,0,0,0,0,0,0,-172000,0,0,0,5000,177000,-172000,-172000
052908,大成鋼統一96購01,0,0,0,0,0,0,0,0,0,-172000,0,0,0,301000,473000,-172000,-172000
056703,群創國泰9A購01  ,0,0,0,0,0,0,0,0,0,-172000,0,0,0,0,172000,-172000,-172000
061037,嘉澤永豐9A購01  ,0,0,0,0,0,0,0,0,0,-173000,0,0,0,23000,196000,-173000,-173000
061431,鈺齊元大9A購01  ,0,0,0,0,0,0,0,0,0,-173000,0,0,0,0,173000,-173000,-173000
060133,牧德群益9B購01  ,0,0,0,0,0,0,0,0,0,-173000,0,0,0,17000,190000,-173000,-173000
059944,欣興永豐99購03  ,0,0,0,0,0,0,0,0,0,-173000,0,0,0,2000,175000,-173000,-173000
059133,臺股指群益99購08,0,0,0,0,0,0,0,0,0,-173000,0,0,0,28000,201000,-173000,-173000
053127,貿聯凱基97購01  ,0,0,0,0,0,0,0,0,0,-173000,0,0,0,0,173000,-173000,-173000
05528P,臺股指群益96售01,2000,0,2000,0,0,0,0,0,0,-175000,0,0,0,230000,405000,-175000,-173000
056189,樺漢統一97購02  ,0,0,0,0,0,0,0,0,0,-173000,0,0,0,38000,211000,-173000,-173000
054467,隆達凱基97購01  ,0,0,0,0,0,0,0,0,0,-174000,0,0,0,69000,243000,-174000,-174000
060293,緯創元大9A購01  ,0,0,0,0,0,0,0,0,0,-175000,0,0,0,24000,199000,-175000,-175000
060570,南亞科永豐9A購01,0,0,0,0,0,0,0,0,0,-175000,0,0,0,15000,190000,-175000,-175000
053259,卜蜂群益97購01  ,0,0,0,0,0,0,0,0,0,-175000,0,0,0,0,175000,-175000,-175000
058596,旺宏台新99購01  ,0,0,0,0,0,0,0,0,0,-175000,0,0,0,14000,189000,-175000,-175000
059019,元石油統一9B購03,0,0,0,0,0,0,0,0,0,-175000,0,0,0,11000,186000,-175000,-175000
060611,同欣電凱基9A購02,0,0,0,0,0,0,0,0,0,-176000,0,0,0,182000,358000,-176000,-176000
060716,新唐永豐9A購01  ,0,0,0,0,0,0,0,0,0,-176000,0,0,0,0,176000,-176000,-176000
060984,南亞科元大9A購07,0,0,0,0,0,0,0,0,0,-176000,0,0,0,25000,201000,-176000,-176000
060476,瑞祺元大9A購02  ,0,0,0,0,0,0,0,0,0,-176000,0,0,0,113000,289000,-176000,-176000
059938,凱美永豐99購01  ,0,0,0,0,0,0,0,0,0,-176000,0,0,0,70000,246000,-176000,-176000
05159P,聯發科永豐95售04,0,0,0,0,0,0,0,0,0,-176000,0,0,0,4000,180000,-176000,-176000
058353,國巨凱基99購09  ,0,0,0,0,0,0,0,0,0,-176000,0,0,0,244000,420000,-176000,-176000
057606,健策統一98購03  ,0,0,0,0,0,0,0,0,0,-176000,0,0,0,0,176000,-176000,-176000
057613,瑞昱元富02購02  ,0,0,0,0,0,0,0,0,0,-176000,0,0,0,85000,261000,-176000,-176000
057181,亞光元大98購02  ,0,0,0,0,0,0,0,0,0,-176000,0,0,0,89000,265000,-176000,-176000
059175,臺股指凱基99購26,0,0,0,0,0,0,0,0,0,-177000,0,0,0,0,177000,-177000,-177000
060505,友達元大9C購05  ,0,0,0,0,0,0,0,0,0,-177000,0,0,0,107000,284000,-177000,-177000
061273,臺股指凱基9A購23,0,0,0,0,0,0,0,0,0,-177000,0,0,0,0,177000,-177000,-177000
054352,世芯國泰98購01  ,0,0,0,0,0,0,0,0,0,-177000,0,0,0,124000,301000,-177000,-177000
054527,國巨統一97購03  ,0,0,0,0,0,0,0,0,0,-177000,0,0,0,347000,524000,-177000,-177000
055818,晶相光國票97購02,99000,0,99000,0,0,0,0,0,0,-276000,0,0,0,98000,374000,-276000,-177000
07258P,台灣50台新9A售01,0,0,0,0,0,0,0,0,0,-177000,0,0,0,40000,217000,-177000,-177000
06493P,聯發科永豐98售02,0,0,0,0,0,0,0,0,0,-178000,0,0,0,82000,260000,-178000,-178000
061035,亞光永豐9A購01  ,0,0,0,0,0,0,0,0,0,-178000,0,0,0,76000,254000,-178000,-178000
061074,儒鴻兆豐9B購01  ,0,0,0,0,0,0,0,0,0,-178000,0,0,0,5000,183000,-178000,-178000
059982,聯發科元大99購37,0,0,0,0,0,0,0,0,0,-178000,0,0,0,135000,313000,-178000,-178000
060091,技嘉元大99購03  ,0,0,0,0,0,0,0,0,0,-178000,0,0,0,46000,224000,-178000,-178000
052434,茂林國泰97購01  ,0,0,0,0,0,0,0,0,0,-178000,0,0,0,56000,234000,-178000,-178000
056323,旺宏兆豐98購01  ,0,0,0,0,0,0,0,0,0,-178000,0,0,0,2000,180000,-178000,-178000
059006,樺漢元大99購01  ,0,0,0,0,0,0,0,0,0,-178000,0,0,0,39000,217000,-178000,-178000
057991,健策統一9C購01  ,0,0,0,0,0,0,0,0,0,-178000,0,0,0,10000,188000,-178000,-178000
9188,精熙-DR         ,0,178000,-178000,0,0,0,0,0,0,0,0,0,0,0,0,0,-178000
060649,國巨第一9A購01  ,0,0,0,0,0,0,0,0,0,-179000,0,0,0,302000,481000,-179000,-179000
056823,智伸科永豐98購01,0,0,0,0,0,0,0,0,0,-179000,0,0,0,17000,196000,-179000,-179000
050842,旺宏國票97購01  ,0,0,0,0,0,0,0,0,0,-180000,0,0,0,72000,252000,-180000,-180000
050171,臺指反元大97購03,0,0,0,0,0,0,0,0,0,-180000,0,0,0,30000,210000,-180000,-180000
056276,同欣電國泰98購01,0,0,0,0,0,0,0,0,0,-180000,0,0,0,0,180000,-180000,-180000
07595P,台灣50中信03售07,0,0,0,0,0,0,0,0,0,-180000,0,0,0,20000,200000,-180000,-180000
060920,超眾富邦9B購01  ,0,0,0,0,0,0,0,0,0,-181000,0,0,0,210000,391000,-181000,-181000
059290,全新元富99購01  ,0,0,0,0,0,0,0,0,0,-181000,0,0,0,122000,303000,-181000,-181000
053694,創意元大96購03  ,0,0,0,0,0,0,0,0,0,-181000,0,0,0,120000,301000,-181000,-181000
059613,泰鼎永豐99購02  ,0,0,0,0,0,0,0,0,0,-182000,0,0,0,20000,202000,-182000,-182000
060045,嘉晶群益99購02  ,0,0,0,0,0,0,0,0,0,-182000,0,0,0,0,182000,-182000,-182000
058588,致茂中信9B購01  ,0,0,0,0,0,0,0,0,0,-182000,0,0,0,3000,185000,-182000,-182000
060365,京鼎元富9A購01  ,0,0,0,0,0,0,0,0,0,-183000,0,0,0,416000,599000,-183000,-183000
05930P,景碩康和96售01  ,0,0,0,0,0,0,0,0,0,-183000,0,0,0,180000,363000,-183000,-183000
060710,上銀永豐9A購01  ,0,0,0,0,0,0,0,0,0,-184000,0,0,0,5000,189000,-184000,-184000
055433,嘉聯益群益99購01,0,0,0,0,0,0,0,0,0,-184000,0,0,0,134000,318000,-184000,-184000
049438,嘉晶國泰96購01  ,0,0,0,0,0,0,0,0,0,-184000,0,0,0,41000,225000,-184000,-184000
058929,可成統一9C購01  ,0,0,0,0,0,0,0,0,0,-184000,0,0,0,22000,206000,-184000,-184000
053915,光罩國票96購02  ,0,0,0,0,0,0,0,0,0,-185000,0,0,0,0,185000,-185000,-185000
058908,貿聯元大99購03  ,0,0,0,0,0,0,0,0,0,-185000,0,0,0,30000,215000,-185000,-185000
057877,神達元大99購01  ,0,0,0,0,0,0,0,0,0,-185000,0,0,0,11000,196000,-185000,-185000
057102,亞光中信9A購01  ,0,0,0,0,0,0,0,0,0,-185000,0,0,0,0,185000,-185000,-185000
061042,致新永豐9A購02  ,0,0,0,0,0,0,0,0,0,-186000,0,0,0,84000,270000,-186000,-186000
2376,技嘉            ,385000,560000,-175000,0,0,0,2000,0,2000,-13000,13000,0,13000,173000,199000,-26000,-186000
8210,勤誠            ,157000,337000,-180000,0,0,0,0,0,0,-6000,20000,0,20000,9000,35000,-26000,-186000
060795,世芯永豐9A購02  ,0,0,0,0,0,0,0,0,0,-187000,0,0,0,11000,198000,-187000,-187000
057111,立積群益98購02  ,0,0,0,0,0,0,0,0,0,-187000,0,0,0,46000,233000,-187000,-187000
058832,立積永豐99購01  ,0,0,0,0,0,0,0,0,0,-187000,0,0,0,27000,214000,-187000,-187000
056203,興富發永豐97購01,0,0,0,0,0,0,0,0,0,-187000,0,0,0,0,187000,-187000,-187000
056419,欣興元富98購02  ,0,0,0,0,0,0,0,0,0,-188000,0,0,0,0,188000,-188000,-188000
058559,華新科日盛99購02,0,0,0,0,0,0,0,0,0,-188000,0,0,0,44000,232000,-188000,-188000
055698,茂林國票98購03  ,0,0,0,0,0,0,0,0,0,-188000,0,0,0,110000,298000,-188000,-188000
057129,聯發科凱基99購03,0,0,0,0,0,0,0,0,0,-189000,0,0,0,0,189000,-189000,-189000
057287,彩晶元大9C購03  ,0,0,0,0,0,0,0,0,0,-189000,0,0,0,100000,289000,-189000,-189000
058363,全新凱基9A購02  ,0,0,0,0,0,0,0,0,0,-189000,0,0,0,1000,190000,-189000,-189000
058337,日月光元富99購01,0,0,0,0,0,0,0,0,0,-189000,0,0,0,281000,470000,-189000,-189000
061081,宏碁兆豐9A購01  ,0,0,0,0,0,0,0,0,0,-190000,0,0,0,95000,285000,-190000,-190000
060880,中壽中信9C購01  ,0,0,0,0,0,0,0,0,0,-190000,0,0,0,0,190000,-190000,-190000
03443B,臺股指凱基9A熊27,0,0,0,0,0,0,0,0,0,-190000,0,0,0,13000,203000,-190000,-190000
048591,台郡兆豐94購01  ,0,0,0,0,0,0,0,0,0,-190000,0,0,0,3000,193000,-190000,-190000
054863,億光群益97購01  ,0,0,0,0,0,0,0,0,0,-190000,0,0,0,306000,496000,-190000,-190000
058205,神達凱基9B購01  ,0,0,0,0,0,0,0,0,0,-190000,0,0,0,0,190000,-190000,-190000
057982,帆宣永豐98購01  ,0,0,0,0,0,0,0,0,0,-190000,0,0,0,0,190000,-190000,-190000
056211,南港國票98購01  ,0,0,0,0,0,0,0,0,0,-190000,0,0,0,130000,320000,-190000,-190000
059272,台灣50元大99購01,0,0,0,0,0,0,0,0,0,-191000,0,0,0,9000,200000,-191000,-191000
046937,聯電元大99購01  ,0,0,0,0,0,0,0,0,0,-191000,0,0,0,18000,209000,-191000,-191000
058251,百和元大99購03  ,0,0,0,0,0,0,0,0,0,-191000,0,0,0,0,191000,-191000,-191000
3015,全漢            ,201000,390000,-189000,0,0,0,0,0,0,-2000,0,2000,-2000,0,0,0,-191000
061041,南電永豐9A購03  ,0,0,0,0,0,0,0,0,0,-192000,0,0,0,10000,202000,-192000,-192000
060601,技嘉凱基9A購02  ,0,0,0,0,0,0,0,0,0,-193000,0,0,0,10000,203000,-193000,-193000
054221,華新科統一96購05,0,0,0,0,0,0,0,0,0,-193000,0,0,0,68000,261000,-193000,-193000
061138,晶技統一9C購01  ,0,0,0,0,0,0,0,0,0,-194000,0,0,0,44000,238000,-194000,-194000
060431,復盛永豐9A購01  ,0,0,0,0,0,0,0,0,0,-194000,0,0,0,0,194000,-194000,-194000
053698,中磊元大96購02  ,0,0,0,0,0,0,0,0,0,-194000,0,0,0,0,194000,-194000,-194000
051740,可成國票96購04  ,0,0,0,0,0,0,0,0,0,-194000,0,0,0,6000,200000,-194000,-194000
055301,台虹元大97購01  ,0,0,0,0,0,0,0,0,0,-194000,0,0,0,1000,195000,-194000,-194000
058672,可成群益9B購02  ,0,0,0,0,0,0,0,0,0,-194000,0,0,0,11000,205000,-194000,-194000
060866,世芯永豐9B購01  ,0,0,0,0,0,0,0,0,0,-195000,0,0,0,48000,243000,-195000,-195000
053754,英業達元富96購02,0,0,0,0,0,0,0,0,0,-195000,0,0,0,300000,495000,-195000,-195000
053337,聯電國票97購01  ,0,15000,-15000,0,0,0,0,0,0,-180000,0,0,0,90000,270000,-180000,-195000
060695,同欣電麥證9A購01,150000,0,150000,0,346000,-346000,0,0,0,-346000,0,0,0,0,346000,-346000,-196000
060018,國產康和99購01  ,0,0,0,0,0,0,0,0,0,-196000,0,0,0,100000,296000,-196000,-196000
055716,致茂元大97購01  ,0,0,0,0,0,0,0,0,0,-196000,0,0,0,0,196000,-196000,-196000
060889,國泰金統一9C購01,0,0,0,0,0,0,0,0,0,-197000,0,0,0,0,197000,-197000,-197000
061040,康友永豐9A購01  ,0,0,0,0,0,0,0,0,0,-197000,0,0,0,20000,217000,-197000,-197000
056711,亞光永豐98購01  ,0,0,0,0,0,0,0,0,0,-197000,0,0,0,0,197000,-197000,-197000
058995,台達電元大99購01,0,0,0,0,0,0,0,0,0,-197000,0,0,0,12000,209000,-197000,-197000
055887,上銀統一97購03  ,0,0,0,0,0,0,0,0,0,-197000,0,0,0,58000,255000,-197000,-197000
060285,聯電元大9C購01  ,0,0,0,0,0,0,0,0,0,-198000,0,0,0,7000,205000,-198000,-198000
059410,滬深2X國票9A購04,0,0,0,0,0,0,0,0,0,-198000,0,0,0,0,198000,-198000,-198000
053092,台表科元大97購02,0,0,0,0,0,0,0,0,0,-198000,0,0,0,1000,199000,-198000,-198000
053073,技嘉康和96購01  ,0,0,0,0,0,0,0,0,0,-198000,0,0,0,2000,200000,-198000,-198000
07605P,台灣50元大9B售10,0,0,0,0,0,0,0,0,0,-198000,0,0,0,2000,200000,-198000,-198000
06938P,南電元大98售03  ,0,0,0,0,0,0,0,0,0,-198000,0,0,0,2000,200000,-198000,-198000
05920P,力成元大96售04  ,0,0,0,0,0,0,0,0,0,-199000,0,0,0,103000,302000,-199000,-199000
061090,奇力新統一9C購01,0,0,0,0,0,0,0,0,0,-199000,0,0,0,82000,281000,-199000,-199000
060948,可成第一9A購01  ,0,0,0,0,0,0,0,0,0,-199000,0,0,0,0,199000,-199000,-199000
060692,鴻海麥證9A購01  ,0,0,0,9000,208000,-199000,0,0,0,-199000,0,0,0,9000,208000,-199000,-199000
058764,康友群益99購01  ,0,0,0,0,0,0,0,0,0,-199000,0,0,0,1000,200000,-199000,-199000
058468,聯茂中信99購02  ,0,0,0,0,0,0,0,0,0,-199000,0,0,0,1000,200000,-199000,-199000
060735,鴻海統一9C購03  ,0,0,0,0,0,0,0,0,0,-200000,0,0,0,0,200000,-200000,-200000
060818,上銀統一9C購01  ,0,0,0,0,0,0,0,0,0,-200000,0,0,0,310000,510000,-200000,-200000
060402,神隆國泰9B購01  ,0,0,0,0,0,0,0,0,0,-200000,0,0,0,77000,277000,-200000,-200000
052699,友達國票97購01  ,0,0,0,0,0,0,0,0,0,-200000,0,0,0,0,200000,-200000,-200000
045873,元油2X元富98購04,0,0,0,0,0,0,0,0,0,-200000,0,0,0,0,200000,-200000,-200000
057089,奇力新元富98購01,0,0,0,0,0,0,0,0,0,-200000,0,0,0,0,200000,-200000,-200000
058677,矽格群益99購01  ,0,0,0,0,0,0,0,0,0,-200000,0,0,0,80000,280000,-200000,-200000
055611,燿華國票98購02  ,0,0,0,0,0,0,0,0,0,-200000,0,0,0,50000,250000,-200000,-200000
055232,泰碩國票98購01  ,0,0,0,0,0,0,0,0,0,-200000,0,0,0,10000,210000,-200000,-200000
060163,健策永豐9B購01  ,0,0,0,0,0,0,0,0,0,-201000,0,0,0,15000,216000,-201000,-201000
05977P,旺宏永豐96售06  ,0,0,0,0,0,0,0,0,0,-201000,0,0,0,46000,247000,-201000,-201000
054684,裕隆永豐97購01  ,0,0,0,0,0,0,0,0,0,-201000,0,0,0,0,201000,-201000,-201000
059821,美律凱基99購08  ,0,0,0,0,0,0,0,0,0,-202000,0,0,0,10000,212000,-202000,-202000
060237,友達元大9A購06  ,0,0,0,0,0,0,0,0,0,-202000,0,0,0,213000,415000,-202000,-202000
060791,聯茂富邦9A購02  ,0,0,0,0,0,0,0,0,0,-203000,0,0,0,7000,210000,-203000,-203000
053460,緯穎國泰97購01  ,0,0,0,0,0,0,0,0,0,-203000,0,0,0,30000,233000,-203000,-203000
056719,台虹永豐98購01  ,0,0,0,0,0,0,0,0,0,-204000,0,0,0,0,204000,-204000,-204000
059030,奇力新兆豐99購03,0,0,0,0,0,0,0,0,0,-204000,0,0,0,84000,288000,-204000,-204000
060805,國巨群益9A購06  ,0,0,0,0,0,0,0,0,0,-205000,0,0,0,210000,415000,-205000,-205000
060981,旺宏元大9A購08  ,0,0,0,0,0,0,0,0,0,-205000,0,0,0,326000,531000,-205000,-205000
060282,聚陽元大9A購01  ,0,0,0,0,0,0,0,0,0,-205000,0,0,0,59000,264000,-205000,-205000
056847,佐登元富98購01  ,0,0,0,0,0,0,0,0,0,-205000,0,0,0,415000,620000,-205000,-205000
057592,美律兆豐99購01  ,0,0,0,0,0,0,0,0,0,-205000,0,0,0,0,205000,-205000,-205000
060259,潤泰全凱基9C購01,0,0,0,0,0,0,0,0,0,-206000,0,0,0,20000,226000,-206000,-206000
060396,友達國票9A購01  ,0,0,0,0,0,0,0,0,0,-206000,0,0,0,19000,225000,-206000,-206000
059189,國泰金富邦9B購01,0,0,0,0,0,0,0,0,0,-206000,0,0,0,30000,236000,-206000,-206000
055388,華通統一97購03  ,0,0,0,0,0,0,0,0,0,-206000,0,0,0,10000,216000,-206000,-206000
058222,玉晶光統一9B購01,0,0,0,0,0,0,0,0,0,-206000,0,0,0,44000,250000,-206000,-206000
060457,中橡元大9A購02  ,0,0,0,0,0,0,0,0,0,-207000,0,0,0,50000,257000,-207000,-207000
060994,世芯元大9A購03  ,0,0,0,0,0,0,0,0,0,-207000,0,0,0,29000,236000,-207000,-207000
058977,SGBR2X凱基03購01,0,0,0,0,0,0,0,0,0,-207000,0,0,0,185000,392000,-207000,-207000
052700,奇鋐國票97購02  ,0,0,0,0,0,0,0,0,0,-208000,0,0,0,263000,471000,-208000,-208000
053898,康友群益97購01  ,0,0,0,0,0,0,0,0,0,-209000,0,0,0,0,209000,-209000,-209000
05625P,國巨國票97售01  ,0,0,0,0,0,0,0,0,0,-209000,0,0,0,10000,219000,-209000,-209000
061189,可成富邦9B購02  ,0,0,0,0,0,0,0,0,0,-210000,0,0,0,0,210000,-210000,-210000
052207,台郡中信95購02  ,0,0,0,0,0,0,0,0,0,-210000,0,0,0,40000,250000,-210000,-210000
1707,葡萄王          ,64000,136000,-72000,0,0,0,0,140000,-140000,1024,2000,976,1024,0,0,0,-210976
061032,金像電永豐9A購03,0,0,0,0,0,0,0,0,0,-211000,0,0,0,69000,280000,-211000,-211000
052934,中磊元大96購01  ,0,0,0,0,0,0,0,0,0,-211000,0,0,0,0,211000,-211000,-211000
058732,矽格永豐99購01  ,0,0,0,0,0,0,0,0,0,-211000,0,0,0,175000,386000,-211000,-211000
060704,台積電富邦01購01,0,0,0,0,0,0,0,0,0,-212000,0,0,0,18000,230000,-212000,-212000
058049,帆宣元大98購01  ,0,0,0,0,0,0,0,0,0,-212000,0,0,0,100000,312000,-212000,-212000
051745,玉晶光國泰97購06,0,0,0,0,0,0,0,0,0,-213000,0,0,0,8000,221000,-213000,-213000
056085,聯發科統一97購01,0,0,0,0,0,0,0,0,0,-213000,0,0,0,0,213000,-213000,-213000
07173P,臺股指國票99售10,0,0,0,0,0,0,0,0,0,-213000,0,0,0,176000,389000,-213000,-213000
059835,聯發科國泰9B購01,0,0,0,0,0,0,0,0,0,-214000,0,0,0,39000,253000,-214000,-214000
059461,鈺齊永豐99購03  ,0,0,0,0,0,0,0,0,0,-214000,0,0,0,67000,281000,-214000,-214000
057509,聯發科統一9A購03,0,0,0,0,0,0,0,0,0,-214000,0,0,0,0,214000,-214000,-214000
059187,國巨富邦9B購02  ,0,0,0,0,0,0,0,0,0,-215000,0,0,0,18000,233000,-215000,-215000
060419,漢翔永豐9A購01  ,0,0,0,0,0,0,0,0,0,-215000,0,0,0,30000,245000,-215000,-215000
061029,力山永豐9A購01  ,0,0,0,0,0,0,0,0,0,-215000,0,0,0,20000,235000,-215000,-215000
057090,奇力新元富98購02,0,0,0,0,0,0,0,0,0,-215000,0,0,0,100000,315000,-215000,-215000
057789,上銀統一9A購01  ,0,0,0,0,0,0,0,0,0,-215000,0,0,0,0,215000,-215000,-215000
045189,大立光元富98購01,0,0,0,0,0,0,0,0,0,-219000,0,0,0,0,219000,-219000,-219000
058095,昇陽半元大98購03,0,0,0,0,0,0,0,0,0,-219000,0,0,0,0,219000,-219000,-219000
060774,南亞科凱基9A購01,0,0,0,0,0,0,0,0,0,-220000,0,0,0,32000,252000,-220000,-220000
060650,奇力新中信9A購01,0,0,0,0,0,0,0,0,0,-220000,0,0,0,118000,338000,-220000,-220000
057276,全新元大99購03  ,0,0,0,0,0,0,0,0,0,-220000,0,0,0,0,220000,-220000,-220000
057714,聯發科統一98購05,0,0,0,0,0,0,0,0,0,-220000,0,0,0,0,220000,-220000,-220000
060480,億豐元大9A購02  ,0,0,0,0,0,0,0,0,0,-221000,0,0,0,5000,226000,-221000,-221000
059459,訊芯永豐99購04  ,0,0,0,0,0,0,0,0,0,-221000,0,0,0,104000,325000,-221000,-221000
057527,億光元大98購01  ,0,0,0,0,0,0,0,0,0,-221000,0,0,0,247000,468000,-221000,-221000
058182,日電貿國泰9A購01,0,0,0,0,0,0,0,0,0,-221000,0,0,0,25000,246000,-221000,-221000
056583,昇陽半元大98購02,0,0,0,0,0,0,0,0,0,-222000,0,0,0,0,222000,-222000,-222000
046906,新光金凱基99購02,0,0,0,0,0,0,0,0,0,-222000,0,0,0,37000,259000,-222000,-222000
057691,健策凱基99購01  ,0,0,0,0,0,0,0,0,0,-222000,0,0,0,22000,244000,-222000,-222000
060566,聯詠富邦9C購01  ,0,0,0,0,0,0,0,0,0,-223000,0,0,0,43000,266000,-223000,-223000
061249,億豐群益9A購01  ,0,0,0,0,0,0,0,0,0,-223000,0,0,0,39000,262000,-223000,-223000
053750,致伸永豐96購02  ,0,0,0,0,0,0,0,0,0,-223000,0,0,0,0,223000,-223000,-223000
060856,健策富邦9B購02  ,0,0,0,0,0,0,0,0,0,-224000,0,0,0,87000,311000,-224000,-224000
060959,金像電凱基9A購01,0,0,0,0,0,0,0,0,0,-224000,0,0,0,32000,256000,-224000,-224000
060329,鎧勝群益9B購01  ,0,0,0,0,0,0,0,0,0,-224000,0,0,0,0,224000,-224000,-224000
058250,台虹元大99購01  ,0,0,0,0,0,0,0,0,0,-224000,0,0,0,0,224000,-224000,-224000
07731P,臺股指凱基9A售28,0,0,0,0,0,0,0,0,0,-224000,0,0,0,17000,241000,-224000,-224000
060434,台汽電永豐9A購01,0,0,0,0,0,0,0,0,0,-225000,0,0,0,11000,236000,-225000,-225000
060489,世紀鋼群益9A購01,0,0,0,0,0,0,0,0,0,-225000,0,0,0,0,225000,-225000,-225000
060623,玉晶光元大9C購01,0,0,0,0,0,0,0,0,0,-225000,0,0,0,40000,265000,-225000,-225000
060479,億豐元大9A購01  ,0,0,0,0,0,0,0,0,0,-226000,0,0,0,3000,229000,-226000,-226000
060776,世芯凱基9B購01  ,0,0,0,0,0,0,0,0,0,-227000,0,0,0,93000,320000,-227000,-227000
060999,國巨兆豐9A購01  ,0,0,0,0,0,0,0,0,0,-227000,0,0,0,32000,259000,-227000,-227000
058762,貿聯群益99購03  ,0,0,0,0,0,0,0,0,0,-227000,0,0,0,0,227000,-227000,-227000
6251,定穎            ,4312000,5688000,-1376000,0,0,0,0,0,0,1149000,1304000,155000,1149000,0,0,0,-227000
055288,日電貿元大97購02,0,0,0,0,0,0,0,0,0,-228000,0,0,0,50000,278000,-228000,-228000
060960,金像電凱基9B購01,0,0,0,0,0,0,0,0,0,-229000,0,0,0,80000,309000,-229000,-229000
060674,瑞昱元大9A購03  ,0,0,0,0,0,0,0,0,0,-229000,0,0,0,82000,311000,-229000,-229000
056589,康控統一98購01  ,0,0,0,0,0,0,0,0,0,-229000,0,0,0,250000,479000,-229000,-229000
061265,富邦金凱基9B購01,0,0,0,0,0,0,0,0,0,-230000,0,0,0,31000,261000,-230000,-230000
059958,鎧勝康和99購01  ,0,0,0,0,0,0,0,0,0,-230000,0,0,0,77000,307000,-230000,-230000
059729,群創元大9C購05  ,0,0,0,0,0,0,0,0,0,-231000,0,0,0,300000,531000,-231000,-231000
061430,致新元大9A購01  ,0,0,0,0,0,0,0,0,0,-231000,0,0,0,37000,268000,-231000,-231000
061427,旭富元大9A購02  ,0,0,0,0,0,0,0,0,0,-231000,0,0,0,4000,235000,-231000,-231000
054205,華新國票97購02  ,0,0,0,0,0,0,0,0,0,-231000,0,0,0,0,231000,-231000,-231000
056786,亞光群益98購03  ,0,0,0,0,0,0,0,0,0,-231000,0,0,0,78000,309000,-231000,-231000
057720,日電貿元富98購01,0,0,0,0,0,0,0,0,0,-231000,0,0,0,10000,241000,-231000,-231000
07368P,國巨凱基99售19  ,0,0,0,0,0,0,0,0,0,-231000,0,0,0,45000,276000,-231000,-231000
061231,聚陽元大9A購02  ,20000,0,20000,0,0,0,0,0,0,-252000,0,0,0,251000,503000,-252000,-232000
060201,台表科元富9A購01,0,0,0,0,0,0,0,0,0,-232000,0,0,0,12000,244000,-232000,-232000
054148,矽創元大96購03  ,0,0,0,0,0,0,0,0,0,-232000,0,0,0,168000,400000,-232000,-232000
03657C,T50反1元大99牛01,0,0,0,0,0,0,0,0,0,-232000,0,0,0,0,232000,-232000,-232000
058105,旺宏統一9A購02  ,0,0,0,0,0,0,0,0,0,-232000,0,0,0,86000,318000,-232000,-232000
054244,華新元大96購01  ,0,0,0,0,0,0,0,0,0,-233000,0,0,0,0,233000,-233000,-233000
057479,致茂元大98購03  ,0,0,0,0,0,0,0,0,0,-234000,0,0,0,0,234000,-234000,-234000
057062,立積國泰99購01  ,0,0,0,0,0,0,0,0,0,-234000,0,0,0,2000,236000,-234000,-234000
060015,國巨康和99購03  ,0,0,0,0,0,0,0,0,0,-235000,0,0,0,254000,489000,-235000,-235000
060726,聯發科第一9A購01,0,0,0,0,0,0,0,0,0,-235000,0,0,0,0,235000,-235000,-235000
053469,光磊元大97購01  ,0,0,0,0,0,0,0,0,0,-235000,0,0,0,0,235000,-235000,-235000
054807,台化元大9A購02  ,0,0,0,0,0,0,0,0,0,-235000,0,0,0,0,235000,-235000,-235000
046791,台郡統一96購01  ,0,0,0,0,0,0,0,0,0,-235000,0,0,0,119000,354000,-235000,-235000
056308,TPK元大97購02   ,0,0,0,0,0,0,0,0,0,-235000,0,0,0,35000,270000,-235000,-235000
057307,瀚宇博兆豐99購01,0,0,0,0,0,0,0,0,0,-235000,0,0,0,0,235000,-235000,-235000
060928,明泰永豐9A購01  ,0,0,0,0,0,0,0,0,0,-236000,0,0,0,50000,286000,-236000,-236000
060383,葡萄王凱基9A購01,0,0,0,0,0,0,0,0,0,-236000,0,0,0,0,236000,-236000,-236000
058507,美律元大9A購01  ,0,0,0,0,0,0,0,0,0,-236000,0,0,0,76000,312000,-236000,-236000
056529,中環凱基98購01  ,0,0,0,0,0,0,0,0,0,-237000,0,0,0,135000,372000,-237000,-237000
058682,聯發科凱基99購07,0,0,0,0,0,0,0,0,0,-237000,0,0,0,0,237000,-237000,-237000
057834,聯發科元富02購07,0,0,0,0,0,0,0,0,0,-237000,0,0,0,57000,294000,-237000,-237000
060126,創意永豐99購04  ,0,0,0,0,0,0,0,0,0,-238000,0,0,0,68000,306000,-238000,-238000
059533,富邦金凱基99購01,0,0,0,0,0,0,0,0,0,-238000,0,0,0,90000,328000,-238000,-238000
058369,亞光凱基99購02  ,0,0,0,0,0,0,0,0,0,-238000,0,0,0,0,238000,-238000,-238000
058161,T50反1日盛03購01,0,0,0,0,0,0,0,0,0,-239000,0,0,0,0,239000,-239000,-239000
056267,文曄統一97購02  ,0,0,0,0,0,0,0,0,0,-239000,0,0,0,0,239000,-239000,-239000
057738,旺宏富邦9A購01  ,0,0,0,0,0,0,0,0,0,-239000,0,0,0,30000,269000,-239000,-239000
057865,富邦金凱基98購01,0,0,0,0,0,0,0,0,0,-240000,0,0,0,0,240000,-240000,-240000
060418,中橡永豐9A購01  ,0,0,0,0,0,0,0,0,0,-241000,0,0,0,24000,265000,-241000,-241000
06046P,健策統一96售03  ,0,0,0,0,0,0,0,0,0,-241000,0,0,0,206000,447000,-241000,-241000
060753,上銀元大9A購05  ,0,0,0,0,0,0,0,0,0,-241000,0,0,0,50000,291000,-241000,-241000
056540,聯詠凱基98購02  ,0,0,0,0,0,0,0,0,0,-241000,0,0,0,0,241000,-241000,-241000
054919,興富發凱基97購01,0,0,0,0,0,0,0,0,0,-241000,0,0,0,0,241000,-241000,-241000
051818,國巨統一95購02  ,0,0,0,0,0,0,0,0,0,-241000,0,0,0,289000,530000,-241000,-241000
05626P,景碩國票97售03  ,0,0,0,0,0,0,0,0,0,-241000,0,0,0,12000,253000,-241000,-241000
059869,友達凱基99購07  ,0,0,0,0,0,0,0,0,0,-242000,0,0,0,67000,309000,-242000,-242000
058659,力成中信99購01  ,0,0,0,0,0,0,0,0,0,-242000,0,0,0,470000,712000,-242000,-242000
060990,新光金元大9B購03,0,0,0,0,0,0,0,0,0,-244000,0,0,0,100000,344000,-244000,-244000
055425,聚陽群益99購01  ,0,0,0,0,0,0,0,0,0,-244000,0,0,0,20000,264000,-244000,-244000
058576,南亞科群益99購01,0,0,0,0,0,0,0,0,0,-246000,0,0,0,0,246000,-246000,-246000
056088,台郡統一97購02  ,0,0,0,0,0,0,0,0,0,-246000,0,0,0,0,246000,-246000,-246000
057624,新日興國泰99購01,0,0,0,0,0,0,0,0,0,-246000,0,0,0,8000,254000,-246000,-246000
05910P,力山永豐96售02  ,0,0,0,0,0,0,0,0,0,-247000,0,0,0,3000,250000,-247000,-247000
051390,京元電兆豐95購01,0,0,0,0,0,0,0,0,0,-247000,0,0,0,10000,257000,-247000,-247000
2812,台中銀          ,1456000,1849000,-393000,0,0,0,0,0,0,146000,146000,0,146000,0,0,0,-247000
060298,鎧勝元大9C購01  ,0,0,0,0,0,0,0,0,0,-248000,0,0,0,0,248000,-248000,-248000
057827,康友元大98購03  ,0,0,0,0,0,0,0,0,0,-248000,0,0,0,52000,300000,-248000,-248000
059993,上銀元富99購01  ,0,0,0,0,0,0,0,0,0,-249000,0,0,0,67000,316000,-249000,-249000
061025,創意富邦9B購01  ,0,0,0,0,0,0,0,0,0,-249000,0,0,0,10000,259000,-249000,-249000
060855,華新科富邦01購01,0,0,0,0,0,0,0,0,0,-249000,0,0,0,27000,276000,-249000,-249000
058526,鈺齊元大99購02  ,0,0,0,0,0,0,0,0,0,-249000,0,0,0,100000,349000,-249000,-249000
058984,全新凱基9A購03  ,0,0,0,0,0,0,0,0,0,-249000,0,0,0,0,249000,-249000,-249000
059741,聯發科元富99購07,0,0,0,0,0,0,0,0,0,-250000,0,0,0,57000,307000,-250000,-250000
053744,台郡國票97購03  ,0,0,0,0,0,0,0,0,0,-250000,0,0,0,0,250000,-250000,-250000
058771,神達兆豐99購01  ,0,0,0,0,0,0,0,0,0,-250000,0,0,0,5000,255000,-250000,-250000
056266,開發金統一9A購01,0,0,0,0,0,0,0,0,0,-250000,0,0,0,203000,453000,-250000,-250000
055830,上銀元大97購07  ,0,0,0,0,0,0,0,0,0,-250000,0,0,0,0,250000,-250000,-250000
060376,瑞祺元富9A購01  ,0,0,0,0,0,0,0,0,0,-251000,0,0,0,129000,380000,-251000,-251000
060493,美律元富01購01  ,0,0,0,0,0,0,0,0,0,-251000,0,0,0,112000,363000,-251000,-251000
058645,康控富邦01購01  ,0,0,0,0,0,0,0,0,0,-251000,0,0,0,0,251000,-251000,-251000
054374,信邦中信96購01  ,0,0,0,0,0,0,0,0,0,-252000,0,0,0,275000,527000,-252000,-252000
060809,康友群益9A購01  ,0,0,0,0,0,0,0,0,0,-253000,0,0,0,18000,271000,-253000,-253000
060696,道瓊反國泰9C購01,0,0,0,0,0,0,0,0,0,-253000,0,0,0,67000,320000,-253000,-253000
061091,奇力新統一9C購02,0,0,0,0,0,0,0,0,0,-253000,0,0,0,0,253000,-253000,-253000
060456,正隆元大9A購01  ,0,0,0,0,0,0,0,0,0,-253000,0,0,0,0,253000,-253000,-253000
057967,聯發科國泰9A購02,0,0,0,0,0,0,0,0,0,-253000,0,0,0,368000,621000,-253000,-253000
3515,華擎            ,277000,508000,-231000,0,0,0,0,0,0,-22000,1000,0,1000,26000,49000,-23000,-253000
058282,聯茂中信99購01  ,0,0,0,0,0,0,0,0,0,-255000,0,0,0,10000,265000,-255000,-255000
058147,鈺齊元大99購01  ,0,0,0,0,0,0,0,0,0,-255000,0,0,0,98000,353000,-255000,-255000
061137,晶技統一9B購01  ,0,0,0,0,0,0,0,0,0,-256000,0,0,0,82000,338000,-256000,-256000
058852,貿聯群益99購04  ,0,0,0,0,0,0,0,0,0,-257000,0,0,0,0,257000,-257000,-257000
061216,世芯元大9A購06  ,0,0,0,0,0,0,0,0,0,-258000,0,0,0,18000,276000,-258000,-258000
061298,華新科富邦01購02,0,0,0,0,0,0,0,0,0,-258000,0,0,0,130000,388000,-258000,-258000
057092,健策元富98購01  ,0,0,0,0,0,0,0,0,0,-258000,0,0,0,32000,290000,-258000,-258000
061419,國巨元大9A購21  ,0,0,0,0,0,0,0,0,0,-259000,0,0,0,36000,295000,-259000,-259000
059851,晶相光永豐99購02,0,0,0,0,0,0,0,0,0,-259000,0,0,0,155000,414000,-259000,-259000
058200,世芯康和99購01  ,0,0,0,0,0,0,0,0,0,-259000,0,0,0,617000,876000,-259000,-259000
055978,大立光統一98購05,0,0,0,0,0,0,0,0,0,-260000,0,0,0,0,260000,-260000,-260000
058703,台積電元大99購16,0,0,0,0,0,0,0,0,0,-261000,0,0,0,22000,283000,-261000,-261000
07580P,緯穎元大9A售03  ,0,0,0,0,0,0,0,0,0,-262000,0,0,0,28000,290000,-262000,-262000
058149,百和元大99購02  ,0,0,0,0,0,0,0,0,0,-263000,0,0,0,68000,331000,-263000,-263000
057105,致茂群益9A購01  ,0,0,0,0,0,0,0,0,0,-263000,0,0,0,15000,278000,-263000,-263000
060485,華新科富邦9C購04,0,0,0,0,0,0,0,0,0,-264000,0,0,0,338000,602000,-264000,-264000
057704,台虹群益98購03  ,0,0,0,0,0,0,0,0,0,-264000,0,0,0,0,264000,-264000,-264000
053630,奇鋐兆豐97購01  ,0,0,0,0,0,0,0,0,0,-265000,0,0,0,293000,558000,-265000,-265000
058444,國巨富邦9B購01  ,0,0,0,0,0,0,0,0,0,-265000,0,0,0,250000,515000,-265000,-265000
060529,聯發科中信9A購04,0,0,0,0,0,0,0,0,0,-266000,0,0,0,140000,406000,-266000,-266000
060428,瑞祺永豐9A購01  ,0,0,0,0,0,0,0,0,0,-267000,0,0,0,235000,502000,-267000,-267000
059676,台積電台新99購05,0,0,0,0,0,0,0,0,0,-267000,0,0,0,20000,287000,-267000,-267000
060886,國巨統一01購03  ,0,0,0,0,0,0,0,0,0,-268000,0,0,0,175000,443000,-268000,-268000
055302,達方元大97購01  ,0,0,0,0,0,0,0,0,0,-268000,0,0,0,0,268000,-268000,-268000
055330,上銀兆豐98購02  ,0,0,0,0,0,0,0,0,0,-268000,0,0,0,243000,511000,-268000,-268000
2439,美律            ,435000,767000,-332000,0,0,0,0,60000,-60000,123000,82000,8000,74000,111000,62000,49000,-269000
060862,美律永豐9A購01  ,0,0,0,0,0,0,0,0,0,-271000,0,0,0,68000,339000,-271000,-271000
060799,茂林永豐9A購01  ,0,0,0,0,0,0,0,0,0,-271000,0,0,0,60000,331000,-271000,-271000
060746,玉晶光國票9B購02,0,0,0,0,0,0,0,0,0,-271000,0,0,0,0,271000,-271000,-271000
053889,致茂群益97購01  ,0,0,0,0,0,0,0,0,0,-271000,0,0,0,7000,278000,-271000,-271000
057838,台郡國泰99購01  ,0,0,0,0,0,0,0,0,0,-271000,0,0,0,0,271000,-271000,-271000
060079,台郡台新99購03  ,0,0,0,0,0,0,0,0,0,-272000,0,0,0,65000,337000,-272000,-272000
054563,泰碩群益99購01  ,0,0,0,0,0,0,0,0,0,-272000,0,0,0,0,272000,-272000,-272000
055837,致茂元大97購02  ,0,0,0,0,0,0,0,0,0,-272000,0,0,0,1000,273000,-272000,-272000
056533,友達凱基9A購02  ,0,0,0,0,0,0,0,0,0,-273000,0,0,0,119000,392000,-273000,-273000
061213,群創元大9A購05  ,0,0,0,0,0,0,0,0,0,-274000,0,0,0,234000,508000,-274000,-274000
053253,友達國泰97購02  ,0,0,0,0,0,0,0,0,0,-274000,0,0,0,0,274000,-274000,-274000
058134,信邦元大99購01  ,0,0,0,0,0,0,0,0,0,-274000,0,0,0,282000,556000,-274000,-274000
060528,友達中信9C購01  ,0,0,0,0,0,0,0,0,0,-275000,0,0,0,191000,466000,-275000,-275000
059847,喬山永豐99購01  ,0,0,0,0,0,0,0,0,0,-275000,0,0,0,0,275000,-275000,-275000
061190,力山永豐9A購02  ,0,0,0,0,0,0,0,0,0,-276000,0,0,0,0,276000,-276000,-276000
058721,立積元富9C購01  ,0,0,0,0,0,0,0,0,0,-276000,0,0,0,656000,932000,-276000,-276000
03414B,臺股指凱基99熊01,60000,70000,-10000,0,0,0,0,0,0,-267000,0,0,0,238000,505000,-267000,-277000
059023,可成統一9B購02  ,0,0,0,0,0,0,0,0,0,-277000,0,0,0,33000,310000,-277000,-277000
058385,創意中信99購01  ,0,0,0,0,0,0,0,0,0,-277000,0,0,0,88000,365000,-277000,-277000
055639,上銀元富97購02  ,0,0,0,0,0,0,0,0,0,-278000,0,0,0,125000,403000,-278000,-278000
056326,TPK兆豐98購01   ,0,0,0,0,0,0,0,0,0,-278000,0,0,0,6000,284000,-278000,-278000
056620,華新科永豐98購02,0,0,0,0,0,0,0,0,0,-279000,0,0,0,20000,299000,-279000,-279000
053536,明泰永豐96購01  ,0,0,0,0,0,0,0,0,0,-279000,0,0,0,111000,390000,-279000,-279000
057674,台郡元大99購03  ,0,0,0,0,0,0,0,0,0,-279000,0,0,0,132000,411000,-279000,-279000
049369,義隆元大95購01  ,0,0,0,0,0,0,0,0,0,-280000,0,0,0,0,280000,-280000,-280000
059057,聯發科凱基99購10,0,0,0,0,0,0,0,0,0,-280000,0,0,0,0,280000,-280000,-280000
07597P,臺股指中信01售02,0,0,0,0,0,0,0,0,0,-280000,0,0,0,358000,638000,-280000,-280000
046629,群創統一98購01  ,0,0,0,0,0,0,0,0,0,-281000,0,0,0,10000,291000,-281000,-281000
060185,聯發科元富04購01,0,0,0,0,0,0,0,0,0,-282000,0,0,0,21000,303000,-282000,-282000
061264,全新凱基9B購01  ,0,0,0,0,0,0,0,0,0,-283000,0,0,0,0,283000,-283000,-283000
060847,康控國票9A購01  ,0,0,0,0,0,0,0,0,0,-283000,0,0,0,0,283000,-283000,-283000
048628,T50反1元大96購03,0,0,0,0,0,0,0,0,0,-283000,0,0,0,0,283000,-283000,-283000
060540,南亞凱基9A購01  ,0,0,0,0,0,0,0,0,0,-284000,0,0,0,0,284000,-284000,-284000
060765,世芯元大9A購01  ,0,0,0,0,0,0,0,0,0,-285000,0,0,0,82000,367000,-285000,-285000
059815,SP黃豆凱基9A購03,0,0,0,0,0,0,0,0,0,-285000,0,0,0,11000,296000,-285000,-285000
059051,和大凱基9A購01  ,0,0,0,0,0,0,0,0,0,-285000,0,0,0,2000,287000,-285000,-285000
058398,中環元大99購02  ,0,0,0,0,0,0,0,0,0,-285000,0,0,0,16000,301000,-285000,-285000
3450,聯鈞            ,400000,847000,-447000,0,0,0,50000,0,50000,112000,123000,5000,118000,38000,44000,-6000,-285000
055142,健策永豐98購01  ,0,0,0,0,0,0,0,0,0,-287000,0,0,0,5000,292000,-287000,-287000
055829,上銀元大97購06  ,0,0,0,0,0,0,0,0,0,-287000,0,0,0,50000,337000,-287000,-287000
060783,亞德客富邦9B購01,0,0,0,0,0,0,0,0,0,-288000,0,0,0,210000,498000,-288000,-288000
061123,燿華永豐9A購01  ,0,0,0,0,0,0,0,0,0,-290000,0,0,0,10000,300000,-290000,-290000
059507,鴻海永豐99購03  ,0,0,0,0,0,0,0,0,0,-290000,0,0,0,10000,300000,-290000,-290000
050751,聯電統一94購05  ,0,0,0,0,0,0,0,0,0,-290000,0,0,0,10000,300000,-290000,-290000
055725,嘉聯益元大98購03,0,0,0,0,0,0,0,0,0,-290000,0,0,0,0,290000,-290000,-290000
050915,健策中信98購01  ,0,0,0,0,0,0,0,0,0,-291000,0,0,0,5000,296000,-291000,-291000
052094,瀚宇博元大96購02,0,0,0,0,0,0,0,0,0,-291000,0,0,0,0,291000,-291000,-291000
054710,東元元富97購01  ,0,0,0,0,0,0,0,0,0,-291000,0,0,0,96000,387000,-291000,-291000
060183,南亞科元富9A購01,0,0,0,0,0,0,0,0,0,-292000,0,0,0,75000,367000,-292000,-292000
060813,高鐵凱基9A購01  ,0,0,0,0,0,0,0,0,0,-292000,0,0,0,17000,309000,-292000,-292000
054311,世芯凱基96購02  ,0,0,0,0,0,0,0,0,0,-292000,0,0,0,31000,323000,-292000,-292000
058397,大成鋼元大99購02,0,0,0,0,0,0,0,0,0,-292000,0,0,0,329000,621000,-292000,-292000
057743,華擎永豐98購03  ,0,0,0,0,0,0,0,0,0,-292000,0,0,0,224000,516000,-292000,-292000
060788,嘉晶富邦9B購01  ,0,0,0,0,0,0,0,0,0,-293000,0,0,0,0,293000,-293000,-293000
057396,健鼎中信99購01  ,0,0,0,0,0,0,0,0,0,-293000,0,0,0,0,293000,-293000,-293000
061215,健策元大9A購06  ,0,0,0,0,0,0,0,0,0,-294000,0,0,0,194000,488000,-294000,-294000
052795,健策兆豐97購01  ,0,0,0,0,0,0,0,0,0,-295000,0,0,0,0,295000,-295000,-295000
054533,泰碩國泰98購01  ,0,0,0,0,0,0,0,0,0,-295000,0,0,0,238000,533000,-295000,-295000
061127,美食永豐9A購01  ,0,0,0,0,0,0,0,0,0,-296000,0,0,0,0,296000,-296000,-296000
060549,聯發科凱基9B購03,0,0,0,0,0,0,0,0,0,-296000,0,0,0,6000,302000,-296000,-296000
060236,精元元大9C購01  ,0,0,0,0,0,0,0,0,0,-297000,0,0,0,31000,328000,-297000,-297000
056129,義隆麥證97購01  ,0,0,0,5000,302000,-297000,0,0,0,-297000,0,0,0,5000,302000,-297000,-297000
058129,國巨元大99購10  ,0,0,0,0,0,0,0,0,0,-298000,0,0,0,56000,354000,-298000,-298000
060967,鈺齊凱基9A購02  ,0,0,0,0,0,0,0,0,0,-299000,0,0,0,40000,339000,-299000,-299000
051832,復盛元大95購01  ,0,0,0,0,0,0,0,0,0,-299000,0,0,0,200000,499000,-299000,-299000
060712,建準永豐9A購01  ,0,0,0,0,0,0,0,0,0,-300000,0,0,0,113000,413000,-300000,-300000
054427,潤泰全富邦97購01,0,0,0,0,0,0,0,0,0,-300000,0,0,0,300000,600000,-300000,-300000
058396,力山元大99購01  ,0,0,0,0,0,0,0,0,0,-300000,0,0,0,83000,383000,-300000,-300000
057467,祥碩永豐98購04  ,0,0,0,0,0,0,0,0,0,-300000,0,0,0,0,300000,-300000,-300000
07787P,國巨凱基9A售17  ,0,0,0,0,0,0,0,0,0,-300000,0,0,0,0,300000,-300000,-300000
061129,文曄永豐9A購01  ,0,0,0,0,0,0,0,0,0,-301000,0,0,0,0,301000,-301000,-301000
058191,祥碩永豐99購01  ,0,0,0,0,0,0,0,0,0,-302000,0,0,0,57000,359000,-302000,-302000
058768,南港兆豐99購01  ,0,0,0,0,0,0,0,0,0,-302000,0,0,0,26000,328000,-302000,-302000
060986,聯發科元大9A購07,0,25000,-25000,0,0,0,0,0,0,-278000,0,0,0,882000,1160000,-278000,-303000
060663,聯發科凱基9A購13,0,0,0,0,0,0,0,0,0,-305000,0,0,0,0,305000,-305000,-305000
058113,百和元富98購01  ,0,0,0,0,0,0,0,0,0,-305000,0,0,0,0,305000,-305000,-305000
060826,牧德元大9B購02  ,0,0,0,0,0,0,0,0,0,-309000,0,0,0,10000,319000,-309000,-309000
057567,嘉聯益富邦9A購01,0,0,0,0,0,0,0,0,0,-309000,0,0,0,6000,315000,-309000,-309000
060014,中鋼康和99購01  ,0,0,0,0,0,0,0,0,0,-310000,0,0,0,0,310000,-310000,-310000
054698,同欣電永豐97購01,0,0,0,0,0,0,0,0,0,-310000,0,0,0,0,310000,-310000,-310000
00671R,富邦NASDAQ反1   ,0,2000,-2000,0,0,0,0,0,0,-308000,0,0,0,1207000,1515000,-308000,-310000
056364,亞光元大99購02  ,0,0,0,0,0,0,0,0,0,-310000,0,0,0,47000,357000,-310000,-310000
057698,奇力新群益98購02,0,0,0,0,0,0,0,0,0,-310000,0,0,0,39000,349000,-310000,-310000
060558,億豐凱基9A購01  ,0,0,0,0,0,0,0,0,0,-311000,0,0,0,65000,376000,-311000,-311000
061436,上銀凱基9A購07  ,0,0,0,0,0,0,0,0,0,-311000,0,0,0,0,311000,-311000,-311000
053063,力山群益98購01  ,280000,0,280000,0,0,0,0,0,0,-591000,0,0,0,0,591000,-591000,-311000
051561,玉晶光國泰97購04,0,0,0,0,0,0,0,0,0,-312000,0,0,0,2000,314000,-312000,-312000
2417,圓剛            ,275000,586000,-311000,0,0,0,0,0,0,-1000,0,1000,-1000,0,0,0,-312000
060891,世芯統一9A購01  ,0,0,0,0,0,0,0,0,0,-314000,0,0,0,174000,488000,-314000,-314000
055471,聯發科凱基97購04,0,0,0,0,0,0,0,0,0,-314000,0,0,0,1000,315000,-314000,-314000
057762,全新凱基99購03  ,0,0,0,0,0,0,0,0,0,-314000,0,0,0,20000,334000,-314000,-314000
057199,台達電元富02購01,0,0,0,0,0,0,0,0,0,-314000,0,0,0,180000,494000,-314000,-314000
07187P,臺股指台新99售10,0,0,0,0,0,0,0,0,0,-315000,0,0,0,24000,339000,-315000,-315000
060775,世芯凱基9A購02  ,0,0,0,0,0,0,0,0,0,-316000,0,0,0,101000,417000,-316000,-316000
059830,台郡凱基99購05  ,0,0,0,0,0,0,0,0,0,-316000,0,0,0,0,316000,-316000,-316000
2204,中華            ,152000,468000,-316000,0,0,0,0,0,0,0,0,0,0,0,0,0,-316000
057228,友達凱基9B購01  ,0,0,0,0,0,0,0,0,0,-317000,0,0,0,100000,417000,-317000,-317000
057356,彩晶統一98購04  ,0,0,0,0,0,0,0,0,0,-317000,0,0,0,0,317000,-317000,-317000
060240,富邦金元大9A購01,0,0,0,0,0,0,0,0,0,-318000,0,0,0,52000,370000,-318000,-318000
060481,巨大元大9A購01  ,0,0,0,0,0,0,0,0,0,-319000,0,0,0,97000,416000,-319000,-319000
055143,臻鼎永豐97購01  ,0,0,0,0,0,0,0,0,0,-320000,0,0,0,0,320000,-320000,-320000
061395,健策統一9C購02  ,0,0,0,0,0,0,0,0,0,-321000,0,0,0,69000,390000,-321000,-321000
050774,健策元大96購02  ,0,0,0,0,0,0,0,0,0,-321000,0,0,0,0,321000,-321000,-321000
057971,華新科富邦9B購02,0,0,0,0,0,0,0,0,0,-325000,0,0,0,235000,560000,-325000,-325000
058154,泰碩統一9A購01  ,0,0,0,0,0,0,0,0,0,-327000,0,0,0,129000,456000,-327000,-327000
060922,金像電永豐9A購01,0,0,0,0,0,0,0,0,0,-331000,0,0,0,37000,368000,-331000,-331000
055885,大成鋼統一97購02,0,0,0,0,0,0,0,0,0,-332000,0,0,0,3000,335000,-332000,-332000
07593P,臺股指凱基9A售08,0,0,0,0,0,0,0,0,0,-332000,0,0,0,20000,352000,-332000,-332000
052462,上銀統一95購03  ,0,0,0,0,0,0,0,0,0,-333000,0,0,0,0,333000,-333000,-333000
2534,宏盛            ,504000,807480,-303480,0,0,0,0,0,0,-30000,11000,0,11000,16000,57000,-41000,-333480
2484,希華            ,114000,448000,-334000,0,0,0,0,0,0,0,0,0,0,0,0,0,-334000
060897,健策凱基9A購04  ,0,0,0,0,0,0,0,0,0,-335000,0,0,0,31000,366000,-335000,-335000
059155,台表科日盛99購01,0,0,0,0,0,0,0,0,0,-335000,0,0,0,186000,521000,-335000,-335000
057393,台積電中信02購01,0,0,0,0,0,0,0,0,0,-335000,0,0,0,0,335000,-335000,-335000
061227,日月光中信9B購01,0,0,0,0,0,0,0,0,0,-336000,0,0,0,139000,475000,-336000,-336000
060901,臺股指凱基9A購13,0,0,0,0,0,0,0,0,0,-337000,0,0,0,125000,462000,-337000,-337000
05759P,智邦永豐96售02  ,0,0,0,0,0,0,0,0,0,-338000,0,0,0,47000,385000,-338000,-338000
056127,致新國票98購02  ,0,0,0,0,0,0,0,0,0,-338000,0,0,0,0,338000,-338000,-338000
058739,喬山中信99購01  ,0,0,0,0,0,0,0,0,0,-338000,0,0,0,33000,371000,-338000,-338000
060888,金像電統一9C購01,0,0,0,0,0,0,0,0,0,-339000,0,0,0,40000,379000,-339000,-339000
060953,富邦金群益9A購01,0,0,0,0,0,0,0,0,0,-339000,0,0,0,37000,376000,-339000,-339000
061351,智伸科元大9A購01,0,0,0,0,0,0,0,0,0,-339000,0,0,0,10000,349000,-339000,-339000
058258,世芯國泰9A購01  ,0,0,0,0,0,0,0,0,0,-339000,0,0,0,136000,475000,-339000,-339000
059581,日月光元富99購02,0,0,0,0,0,0,0,0,0,-340000,0,0,0,104000,444000,-340000,-340000
052837,友達國泰97購01  ,0,0,0,0,0,0,0,0,0,-340000,0,0,0,0,340000,-340000,-340000
059040,訊芯群益99購03  ,0,0,0,0,0,0,0,0,0,-340000,0,0,0,85000,425000,-340000,-340000
059375,道瓊反群益9C購02,0,0,0,0,0,0,0,0,0,-341000,0,0,0,173000,514000,-341000,-341000
053893,京鼎群益97購02  ,0,0,0,0,0,0,0,0,0,-341000,0,0,0,0,341000,-341000,-341000
061049,奇力新中信9A購02,0,0,0,0,0,0,0,0,0,-342000,0,0,0,2000,344000,-342000,-342000
060303,宏達電富邦9B購01,0,0,0,0,0,0,0,0,0,-344000,0,0,0,280000,624000,-344000,-344000
060134,鈺齊群益9A購01  ,0,0,0,0,0,0,0,0,0,-344000,0,0,0,70000,414000,-344000,-344000
00738U,元大道瓊白銀    ,0,534000,-534000,0,0,0,0,0,0,190000,0,0,0,554000,364000,190000,-344000
060360,南亞科元富9A購02,0,0,0,0,0,0,0,0,0,-346000,0,0,0,425000,771000,-346000,-346000
061270,彩晶凱基9A購02  ,0,0,0,0,0,0,0,0,0,-346000,0,0,0,0,346000,-346000,-346000
059176,臺股指凱基99購27,0,0,0,0,0,0,0,0,0,-347000,0,0,0,0,347000,-347000,-347000
058896,中環元大99購03  ,0,0,0,0,0,0,0,0,0,-347000,0,0,0,84000,431000,-347000,-347000
060361,南亞科元富9A購03,0,0,0,0,0,0,0,0,0,-348000,0,0,0,62000,410000,-348000,-348000
056788,日月光群益98購01,0,0,0,0,0,0,0,0,0,-348000,0,0,0,107000,455000,-348000,-348000
059257,臺股指凱基99購35,0,0,0,0,0,0,0,0,0,-349000,0,0,0,105000,454000,-349000,-349000
061429,南六元大9A購02  ,0,0,0,0,0,0,0,0,0,-349000,0,0,0,201000,550000,-349000,-349000
060138,T50反1國票9A購03,0,0,0,0,0,0,0,0,0,-350000,0,0,0,0,350000,-350000,-350000
056562,奇力新群益98購01,0,0,0,0,0,0,0,0,0,-350000,0,0,0,1000,351000,-350000,-350000
056574,亞光元大99購03  ,0,0,0,0,0,0,0,0,0,-350000,0,0,0,88000,438000,-350000,-350000
059062,群創凱基99購05  ,0,0,0,0,0,0,0,0,0,-350000,0,0,0,221000,571000,-350000,-350000
059350,樺漢凱基9A購01  ,0,0,0,0,0,0,0,0,0,-351000,0,0,0,56000,407000,-351000,-351000
059834,友達國泰9B購01  ,0,0,0,0,0,0,0,0,0,-352000,0,0,0,222000,574000,-352000,-352000
061159,同欣電群益9A購01,0,0,0,0,0,0,0,0,0,-353000,0,0,0,392000,745000,-353000,-353000
059845,欣興富邦9A購02  ,0,0,0,0,0,0,0,0,0,-354000,0,0,0,40000,394000,-354000,-354000
2606,裕民            ,677000,1032000,-355000,0,0,0,2000,0,2000,-1000,0,0,0,0,1000,-1000,-354000
059678,鴻海國泰9A購03  ,0,0,0,0,0,0,0,0,0,-356000,0,0,0,24000,380000,-356000,-356000
055940,致新群益98購01  ,0,0,0,0,0,0,0,0,0,-356000,0,0,0,227000,583000,-356000,-356000
057603,樺漢群益98購02  ,0,0,0,0,0,0,0,0,0,-357000,0,0,0,0,357000,-357000,-357000
07316P,長榮航康和99售01,0,0,0,0,0,0,0,0,0,-359000,0,0,0,81000,440000,-359000,-359000
060199,台郡元富9A購01  ,0,0,0,0,0,0,0,0,0,-360000,0,0,0,217000,577000,-360000,-360000
055505,新唐元大97購02  ,0,0,0,0,0,0,0,0,0,-360000,0,0,0,0,360000,-360000,-360000
058244,神達元大99購02  ,0,0,0,0,0,0,0,0,0,-360000,0,0,0,169000,529000,-360000,-360000
059128,友達中信99購02  ,0,0,0,0,0,0,0,0,0,-361000,0,0,0,489000,850000,-361000,-361000
058996,台達電元大99購02,0,0,0,0,0,0,0,0,0,-362000,0,0,0,66000,428000,-362000,-362000
006208,富邦台50        ,1105,0,1105,0,0,0,0,0,0,-364000,0,0,0,409000,773000,-364000,-362895
060121,新光金富邦99購01,0,0,0,0,0,0,0,0,0,-365000,0,0,0,300000,665000,-365000,-365000
061158,世芯群益9A購02  ,0,0,0,0,0,0,0,0,0,-365000,0,0,0,124000,489000,-365000,-365000
061185,嘉晶國泰9B購01  ,0,0,0,0,0,0,0,0,0,-366000,0,0,0,0,366000,-366000,-366000
059536,新光金凱基99購05,0,0,0,0,0,0,0,0,0,-366000,0,0,0,145000,511000,-366000,-366000
052003,泰碩國泰97購02  ,0,0,0,0,0,0,0,0,0,-366000,0,0,0,32000,398000,-366000,-366000
1477,聚陽            ,706000,767690,-61690,0,0,0,0,344000,-344000,36000,5000,0,5000,31000,0,31000,-369690
061046,上銀第一9A購01  ,0,0,0,0,0,0,0,0,0,-370000,0,0,0,0,370000,-370000,-370000
058951,南電群益99購01  ,0,0,0,0,0,0,0,0,0,-370000,0,0,0,31000,401000,-370000,-370000
061367,瑞祺國票9A購01  ,0,0,0,0,0,0,0,0,0,-371000,0,0,0,30000,401000,-371000,-371000
060962,義隆凱基9B購01  ,0,0,0,0,0,0,0,0,0,-373000,0,0,0,21000,394000,-373000,-373000
060851,國巨國泰9C購01  ,0,0,0,0,0,0,0,0,0,-374000,0,0,0,483000,857000,-374000,-374000
07039P,南電台新99售01  ,0,0,0,0,0,0,0,0,0,-375000,0,0,0,5000,380000,-375000,-375000
053295,奇力新中信96購01,0,0,0,0,0,0,0,0,0,-380000,0,0,0,230000,610000,-380000,-380000
061169,GIS兆豐9A購01   ,0,0,0,0,0,0,0,0,0,-381000,0,0,0,135000,516000,-381000,-381000
058760,嘉晶群益9A購01  ,0,0,0,0,0,0,0,0,0,-384000,0,0,0,0,384000,-384000,-384000
060914,健策元大9A購03  ,0,0,0,0,0,0,0,0,0,-389000,0,0,0,211000,600000,-389000,-389000
058537,彩晶統一9B購01  ,0,0,0,0,0,0,0,0,0,-390000,0,0,0,10000,400000,-390000,-390000
056939,康控元富98購01  ,0,0,0,0,0,0,0,0,0,-390000,0,0,0,98000,488000,-390000,-390000
055030,帆宣國泰99購02  ,0,0,0,0,0,0,0,0,0,-391000,0,0,0,0,391000,-391000,-391000
052588,玉晶光永豐98購01,0,0,0,0,0,0,0,0,0,-393000,0,0,0,3000,396000,-393000,-393000
053392,致新元大96購01  ,0,0,0,0,0,0,0,0,0,-394000,0,0,0,10000,404000,-394000,-394000
061357,寶成元大9A購01  ,0,0,0,0,0,0,0,0,0,-395000,0,0,0,0,395000,-395000,-395000
061196,世芯永豐9A購06  ,0,0,0,0,0,0,0,0,0,-397000,0,0,0,50000,447000,-397000,-397000
057009,信邦中信99購01  ,0,0,0,0,0,0,0,0,0,-397000,0,0,0,158000,555000,-397000,-397000
061284,友達統一9C購01  ,0,0,0,0,0,0,0,0,0,-400000,0,0,0,561000,961000,-400000,-400000
056605,台積電富邦9B購02,0,0,0,0,0,0,0,0,0,-400000,0,0,0,0,400000,-400000,-400000
052945,嘉晶國票97購01  ,0,0,0,0,0,0,0,0,0,-400000,0,0,0,0,400000,-400000,-400000
052004,泰碩國泰97購03  ,0,0,0,0,0,0,0,0,0,-400000,0,0,0,38000,438000,-400000,-400000
059862,全新群益99購04  ,10000,0,10000,0,0,0,0,0,0,-415000,0,0,0,160000,575000,-415000,-405000
056894,佳世達元大99購01,0,0,0,0,0,0,0,0,0,-405000,0,0,0,11000,416000,-405000,-405000
057639,國巨元大99購07  ,0,0,0,0,0,0,0,0,0,-405000,0,0,0,60000,465000,-405000,-405000
6456,GIS-KY          ,1230000,1669000,-439000,0,0,0,0,8000,-8000,42000,3000,0,3000,70000,31000,39000,-405000
056397,彩晶永豐99購01  ,0,0,0,0,0,0,0,0,0,-407000,0,0,0,0,407000,-407000,-407000
061117,美律國泰9C購01  ,0,0,0,0,0,0,0,0,0,-408000,0,0,0,195000,603000,-408000,-408000
054855,得力群益98購01  ,0,0,0,0,0,0,0,0,0,-410000,0,0,0,0,410000,-410000,-410000
057912,美律日盛99購01  ,0,0,0,0,0,0,0,0,0,-410000,0,0,0,8000,418000,-410000,-410000
059926,世紀鋼國泰9B購01,0,0,0,0,0,0,0,0,0,-412000,0,0,0,0,412000,-412000,-412000
058926,勤誠元富99購01  ,0,0,0,0,0,0,0,0,0,-412000,0,0,0,328000,740000,-412000,-412000
058685,TPK凱基99購01   ,0,0,0,0,0,0,0,0,0,-413000,0,0,0,81000,494000,-413000,-413000
055733,奇力新元富97購01,0,0,0,0,0,0,0,0,0,-413000,0,0,0,362000,775000,-413000,-413000
061027,儒鴻永豐9A購02  ,0,0,0,0,0,0,0,0,0,-415000,0,0,0,0,415000,-415000,-415000
061155,華新科群益9A購06,0,0,0,0,0,0,0,0,0,-417000,0,0,0,150000,567000,-417000,-417000
061204,國巨元大9A購16  ,0,0,0,0,0,0,0,0,0,-420000,0,0,0,138000,558000,-420000,-420000
060307,南港永豐9A購01  ,0,0,0,0,0,0,0,0,0,-420000,0,0,0,0,420000,-420000,-420000
059682,可成富邦9A購01  ,0,0,0,0,0,0,0,0,0,-420000,0,0,0,2000,422000,-420000,-420000
059243,聯發科凱基99購12,0,0,0,0,0,0,0,0,0,-420000,0,0,0,0,420000,-420000,-420000
060477,和潤元大9A購01  ,0,0,0,0,0,0,0,0,0,-421000,0,0,0,115000,536000,-421000,-421000
061008,群創兆豐9A購02  ,0,0,0,0,0,0,0,0,0,-422000,0,0,0,253000,675000,-422000,-422000
057836,南亞科國泰9A購01,0,0,0,0,0,0,0,0,0,-422000,0,0,0,0,422000,-422000,-422000
058614,台郡元大9A購01  ,0,0,0,0,0,0,0,0,0,-422000,0,0,0,126000,548000,-422000,-422000
060717,康控永豐9A購01  ,0,0,0,0,0,0,0,0,0,-424000,0,0,0,18000,442000,-424000,-424000
060470,台勝科元大9A購03,0,0,0,0,0,0,0,0,0,-427000,0,0,0,50000,477000,-427000,-427000
060779,臺股指凱基9A購07,0,0,0,0,0,0,0,0,0,-428000,0,0,0,66000,494000,-428000,-428000
058702,國巨元大99購16  ,0,0,0,0,0,0,0,0,0,-428000,0,0,0,60000,488000,-428000,-428000
058664,百和兆豐99購01  ,0,0,0,0,0,0,0,0,0,-428000,0,0,0,101000,529000,-428000,-428000
051362,台郡元大95購04  ,0,0,0,0,0,0,0,0,0,-431000,0,0,0,29000,460000,-431000,-431000
057206,立積元富98購01  ,0,0,0,0,0,0,0,0,0,-432000,0,0,0,126000,558000,-432000,-432000
059878,聯茂凱基99購07  ,0,0,0,0,0,0,0,0,0,-437000,0,0,0,37000,474000,-437000,-437000
059814,SP黃豆凱基9A購02,0,0,0,0,0,0,0,0,0,-439000,0,0,0,197000,636000,-439000,-439000
060718,中磊永豐9A購01  ,0,0,0,0,0,0,0,0,0,-442000,0,0,0,5000,447000,-442000,-442000
057793,群創統一99購02  ,0,0,0,0,0,0,0,0,0,-442000,0,0,0,0,442000,-442000,-442000
060715,日電貿永豐9A購01,0,0,0,0,0,0,0,0,0,-443000,0,0,0,75000,518000,-443000,-443000
060552,群創凱基9B購05  ,0,0,0,0,0,0,0,0,0,-445000,0,0,0,128000,573000,-445000,-445000
061031,神隆永豐9A購02  ,0,0,0,0,0,0,0,0,0,-445000,0,0,0,586000,1031000,-445000,-445000
060629,鴻海富邦9B購01  ,0,0,0,0,0,0,0,0,0,-448000,0,0,0,12000,460000,-448000,-448000
05242P,群創國泰97售01  ,0,0,0,0,0,0,0,0,0,-448000,0,0,0,19000,467000,-448000,-448000
045842,T50反1台新98購01,0,0,0,0,0,0,0,0,0,-448000,0,0,0,0,448000,-448000,-448000
058148,百和元大99購01  ,0,0,0,0,0,0,0,0,0,-448000,0,0,0,0,448000,-448000,-448000
048793,超眾元大95購02  ,0,0,0,0,0,0,0,0,0,-449000,0,0,0,0,449000,-449000,-449000
055974,上銀統一97購05  ,0,0,0,0,0,0,0,0,0,-450000,0,0,0,26000,476000,-450000,-450000
2329,華泰            ,434000,892000,-458000,0,0,0,0,0,0,7000,1000,0,1000,7000,1000,6000,-451000
060340,國巨統一01購02  ,0,0,0,0,0,0,0,0,0,-454000,0,0,0,91000,545000,-454000,-454000
058725,美律富邦9A購01  ,0,0,0,0,0,0,0,0,0,-454000,0,0,0,0,454000,-454000,-454000
05440P,緯穎國票96售02  ,0,0,0,0,0,0,0,0,0,-455000,0,0,0,0,455000,-455000,-455000
053403,彩晶群益98購01  ,0,0,0,0,0,0,0,0,0,-455000,0,0,0,0,455000,-455000,-455000
3376,新日興          ,231000,795000,-564000,0,0,0,81000,9000,72000,36000,23000,0,23000,13000,0,13000,-456000
03680C,臺股指凱基9A牛26,0,0,0,0,0,0,0,0,0,-460000,0,0,0,264000,724000,-460000,-460000
060544,國巨凱基9B購03  ,0,0,0,0,0,0,0,0,0,-461000,0,0,0,210000,671000,-461000,-461000
055005,晶相光元富97購01,100000,0,100000,0,0,0,0,0,0,-561000,0,0,0,344000,905000,-561000,-461000
057713,美律統一99購01  ,0,0,0,0,0,0,0,0,0,-465000,0,0,0,26000,491000,-465000,-465000
051729,華新國票96購01  ,0,0,0,0,0,0,0,0,0,-468000,0,0,0,0,468000,-468000,-468000
060302,台積電富邦02購01,0,0,0,0,0,0,0,0,0,-472000,0,0,0,405000,877000,-472000,-472000
059675,大立光元富99購08,0,0,0,0,0,0,0,0,0,-472000,0,0,0,89000,561000,-472000,-472000
6271,同欣電          ,463000,1037000,-574000,0,0,0,68000,0,68000,33000,8000,0,8000,34000,9000,25000,-473000
058788,喬山元大99購01  ,0,0,0,0,0,0,0,0,0,-475000,0,0,0,10000,485000,-475000,-475000
060627,國巨國泰9B購05  ,0,0,0,0,0,0,0,0,0,-476000,0,0,0,118000,594000,-476000,-476000
3533,嘉澤            ,142000,314000,-172000,0,0,0,82000,358000,-276000,-28000,54000,43000,11000,2000,41000,-39000,-476000
060262,臺股指凱基9B購02,0,0,0,0,0,0,0,0,0,-477000,0,0,0,18000,495000,-477000,-477000
060706,群創富邦9A購01  ,0,0,0,0,0,0,0,0,0,-479000,0,0,0,255000,734000,-479000,-479000
058093,神達元大9A購01  ,0,0,0,0,0,0,0,0,0,-480000,0,0,0,13000,493000,-480000,-480000
058577,南亞科群益99購02,0,0,0,0,0,0,0,0,0,-486000,0,0,0,44000,530000,-486000,-486000
057721,華擎元富98購02  ,0,0,0,0,0,0,0,0,0,-487000,0,0,0,226000,713000,-487000,-487000
051257,光寶科國泰96購01,0,0,0,0,0,0,0,0,0,-490000,0,0,0,0,490000,-490000,-490000
059096,百和元大99購04  ,0,0,0,0,0,0,0,0,0,-491000,0,0,0,0,491000,-491000,-491000
059995,南亞科元富99購01,0,0,0,0,0,0,0,0,0,-496000,0,0,0,127000,623000,-496000,-496000
057502,訊芯群益98購02  ,0,0,0,0,0,0,0,0,0,-498000,0,0,0,75000,573000,-498000,-498000
056850,彩晶元富99購01  ,0,0,0,0,0,0,0,0,0,-499000,0,0,0,0,499000,-499000,-499000
07448P,台灣50元大9A售08,0,0,0,0,0,0,0,0,0,-499000,0,0,0,60000,559000,-499000,-499000
059298,大立光元富9C購02,0,0,0,0,0,0,0,0,0,-503000,0,0,0,126000,629000,-503000,-503000
3043,科風            ,0,506000,-506000,0,0,0,0,0,0,0,0,0,0,0,0,0,-506000
060752,上銀元大9A購04  ,0,0,0,0,0,0,0,0,0,-509000,0,0,0,34000,543000,-509000,-509000
055804,祥碩永豐97購02  ,0,0,0,0,0,0,0,0,0,-510000,0,0,0,277000,787000,-510000,-510000
060157,致茂永豐9A購02  ,0,0,0,0,0,0,0,0,0,-516000,0,0,0,40000,556000,-516000,-516000
8150,南茂            ,1190000,1634000,-444000,0,0,0,0,0,0,-72000,12000,0,12000,172000,256000,-84000,-516000
060511,群創元大9B購08  ,0,0,0,0,0,0,0,0,0,-523000,0,0,0,80000,603000,-523000,-523000
058931,玉晶光統一9C購01,0,0,0,0,0,0,0,0,0,-523000,0,0,0,9000,532000,-523000,-523000
061374,力山永豐9A購04  ,0,0,0,0,0,0,0,0,0,-525000,0,0,0,0,525000,-525000,-525000
2106,建大            ,455000,977000,-522000,0,0,0,0,0,0,-3000,0,3000,-3000,0,0,0,-525000
058820,致茂國泰9B購01  ,0,0,0,0,0,0,0,0,0,-526000,0,0,0,172000,698000,-526000,-526000
061347,創意元大9A購02  ,0,0,0,0,0,0,0,0,0,-529000,0,0,0,121000,650000,-529000,-529000
059355,國巨富邦9B購03  ,0,0,0,0,0,0,0,0,0,-530000,0,0,0,573000,1103000,-530000,-530000
056769,國產元大98購01  ,0,0,0,0,0,0,0,0,0,-531000,0,0,0,171000,702000,-531000,-531000
056677,智伸科元富98購01,0,0,0,0,0,0,0,0,0,-532000,0,0,0,55000,587000,-532000,-532000
059047,元油2X凱基9A購10,0,0,0,0,0,0,0,0,0,-534000,0,0,0,156000,690000,-534000,-534000
055174,精元統一97購01  ,0,0,0,0,0,0,0,0,0,-543000,0,0,0,77000,620000,-543000,-543000
059438,群創元大99購06  ,0,0,0,0,0,0,0,0,0,-546000,0,0,0,681000,1227000,-546000,-546000
060790,日月光富邦9A購01,0,0,0,0,0,0,0,0,0,-547000,0,0,0,124000,671000,-547000,-547000
061094,彩晶統一9B購02  ,0,0,0,0,0,0,0,0,0,-555000,0,0,0,0,555000,-555000,-555000
057973,神達富邦9A購01  ,0,0,0,0,0,0,0,0,0,-556000,0,0,0,165000,721000,-556000,-556000
2481,強茂            ,630000,1035047,-405047,0,0,0,0,0,0,-153000,30000,170000,-140000,24000,37000,-13000,-558047
050172,臺指反元大98購02,0,0,0,0,0,0,0,0,0,-562000,0,0,0,0,562000,-562000,-562000
059050,元油2X凱基9B購08,0,0,0,0,0,0,0,0,0,-562000,0,0,0,100000,662000,-562000,-562000
060807,新光金群益9A購01,0,0,0,0,0,0,0,0,0,-563000,0,0,0,459000,1022000,-563000,-563000
6213,聯茂            ,543000,544564,-1564,0,0,0,23000,783000,-760000,197000,208000,41000,167000,39000,9000,30000,-564564
1504,東元            ,731000,1372000,-641000,0,0,0,3000,0,3000,72000,20000,26000,-6000,78000,0,78000,-566000
060362,建準元富9A購02  ,0,0,0,0,0,0,0,0,0,-570000,0,0,0,99000,669000,-570000,-570000
056136,京鼎元大98購01  ,0,0,0,0,0,0,0,0,0,-572000,0,0,0,0,572000,-572000,-572000
057109,信邦群益98購01  ,0,0,0,0,0,0,0,0,0,-578000,0,0,0,86000,664000,-578000,-578000
058660,樺漢中信9A購01  ,0,0,0,0,0,0,0,0,0,-579000,0,0,0,35000,614000,-579000,-579000
058197,國巨中信99購02  ,0,0,0,0,0,0,0,0,0,-584000,0,0,0,0,584000,-584000,-584000
6552,易華電          ,300000,905000,-605000,0,0,0,0,0,0,21000,0,0,0,27000,6000,21000,-584000
054947,興勤元大97購01  ,0,0,0,0,0,0,0,0,0,-592000,0,0,0,8000,600000,-592000,-592000
00717,富邦美國特別股  ,0,0,0,0,0,0,0,0,0,-593038,0,0,0,475000,1068038,-593038,-593038
056083,億光統一97購03  ,0,0,0,0,0,0,0,0,0,-605000,0,0,0,216000,821000,-605000,-605000
060504,技嘉元大9A購02  ,0,0,0,0,0,0,0,0,0,-608000,0,0,0,0,608000,-608000,-608000
061030,喬山永豐9A購01  ,0,0,0,0,0,0,0,0,0,-611000,0,0,0,40000,651000,-611000,-611000
058714,美律統一9B購01  ,0,0,0,0,0,0,0,0,0,-612000,0,0,0,4000,616000,-612000,-612000
054076,義隆第一96購01  ,0,0,0,0,0,0,0,0,0,-616000,0,0,0,15000,631000,-616000,-616000
057972,群創富邦9C購01  ,0,0,0,0,0,0,0,0,0,-617000,0,0,0,245000,862000,-617000,-617000
061153,奇力新群益9A購02,0,0,0,0,0,0,0,0,0,-622000,0,0,0,0,622000,-622000,-622000
5471,松翰            ,429000,1048000,-619000,0,0,0,0,0,0,-3000,27000,30000,-3000,0,0,0,-622000
2312,金寶            ,1758000,2351000,-593000,0,0,0,0,0,0,-37000,12000,0,12000,271000,320000,-49000,-630000
8213,志超            ,174000,759000,-585000,0,0,0,0,0,0,-46000,1000,0,1000,2000,49000,-47000,-631000
035276,南亞科台新97購01,0,0,0,0,0,0,0,0,0,-636000,0,0,0,17000,653000,-636000,-636000
056572,義隆元大99購01  ,0,0,0,0,0,0,0,0,0,-637000,0,0,0,98000,735000,-637000,-637000
4142,國光生          ,1675000,2267000,-592000,0,0,0,0,0,0,-48000,0,48000,-48000,0,0,0,-640000
058722,台郡元富99購01  ,0,0,0,0,0,0,0,0,0,-642000,0,0,0,10000,652000,-642000,-642000
2342,茂矽            ,1040000,1685000,-645000,0,0,0,0,0,0,0,0,0,0,0,0,0,-645000
057351,奇力新統一98購02,0,0,0,0,0,0,0,0,0,-646000,0,0,0,177000,823000,-646000,-646000
060414,中興電永豐9A購01,0,0,0,0,0,0,0,0,0,-648000,0,0,0,22000,670000,-648000,-648000
055497,開發金元大97購01,0,0,0,0,0,0,0,0,0,-662000,0,0,0,10000,672000,-662000,-662000
060819,國巨統一9C購04  ,0,0,0,0,0,0,0,0,0,-668000,0,0,0,263000,931000,-668000,-668000
059100,元油2X統一9C購02,0,0,0,0,0,0,0,0,0,-669000,0,0,0,188000,857000,-669000,-669000
057995,華新科中信98購02,0,0,0,0,0,0,0,0,0,-678000,0,0,0,332000,1010000,-678000,-678000
060630,國巨富邦9C購03  ,0,0,0,0,0,0,0,0,0,-682000,0,0,0,597000,1279000,-682000,-682000
055123,億光兆豐97購01  ,0,0,0,0,0,0,0,0,0,-682000,0,0,0,0,682000,-682000,-682000
052067,中磊兆豐96購01  ,0,0,0,0,0,0,0,0,0,-688000,0,0,0,0,688000,-688000,-688000
038489,T50反1台新9A購01,0,0,0,0,0,0,0,0,0,-690000,0,0,0,0,690000,-690000,-690000
07068P,欣興台新99售01  ,0,0,0,0,0,0,0,0,0,-692000,0,0,0,0,692000,-692000,-692000
060436,巨大永豐9A購01  ,0,0,0,0,0,0,0,0,0,-697000,0,0,0,140000,837000,-697000,-697000
07366P,國巨康和99售02  ,0,0,0,0,0,0,0,0,0,-697000,0,0,0,565000,1262000,-697000,-697000
060193,群創元富9A購01  ,0,0,0,0,0,0,0,0,0,-699000,0,0,0,161000,860000,-699000,-699000
00673R,元大S&P原油反1  ,0,0,0,0,0,0,0,0,0,-701000,0,0,0,627000,1328000,-701000,-701000
057570,技嘉永豐98購02  ,0,0,0,0,0,0,0,0,0,-702000,0,0,0,0,702000,-702000,-702000
060284,南港元大01購01  ,0,0,0,0,0,0,0,0,0,-706000,0,0,0,0,706000,-706000,-706000
060709,緯穎富邦9B購01  ,0,0,0,0,0,0,0,0,0,-712000,0,0,0,201000,913000,-712000,-712000
060387,盛群凱基9A購01  ,0,50000,-50000,0,0,0,0,0,0,-667000,0,0,0,317000,984000,-667000,-717000
2102,泰豐            ,449000,1170000,-721000,0,0,0,0,0,0,4000,4000,0,4000,0,0,0,-717000
00712,FH富時不動產    ,0,319000,-319000,0,0,0,0,0,0,-403000,0,0,0,87000,490000,-403000,-722000
057074,立積永豐98購01  ,0,0,0,0,0,0,0,0,0,-722000,0,0,0,190000,912000,-722000,-722000
056855,祥碩中信98購02  ,0,0,0,0,0,0,0,0,0,-742000,0,0,0,194000,936000,-742000,-742000
053107,旺宏兆豐97購01  ,0,0,0,0,0,0,0,0,0,-744000,0,0,0,2000,746000,-744000,-744000
057626,技嘉富邦9A購01  ,0,0,0,0,0,0,0,0,0,-745000,0,0,0,0,745000,-745000,-745000
057775,南亞科群益98購02,0,0,0,0,0,0,0,0,0,-752000,0,0,0,0,752000,-752000,-752000
1605,華新            ,2508000,2637000,-129000,0,0,0,40000,0,40000,-669000,127000,20000,107000,50000,826000,-776000,-758000
052414,聯電麥證95購01  ,0,0,0,8000,840000,-832000,0,0,0,-762000,0,0,0,78000,840000,-762000,-762000
058849,奇力新群益99購02,0,0,0,0,0,0,0,0,0,-765000,0,0,0,7000,772000,-765000,-765000
060701,玉晶光國泰9C購01,0,0,0,0,0,0,0,0,0,-769000,0,0,0,61000,830000,-769000,-769000
054805,台苯元大9A購01  ,0,0,0,0,0,0,0,0,0,-771000,0,0,0,68000,839000,-771000,-771000
058026,上銀富邦9A購01  ,0,0,0,0,0,0,0,0,0,-772000,0,0,0,92000,864000,-772000,-772000
061160,瑞祺群益9A購01  ,0,0,0,0,0,0,0,0,0,-783000,0,0,0,97000,880000,-783000,-783000
059196,聯發科永豐99購02,0,0,0,0,0,0,0,0,0,-795000,0,0,0,140000,935000,-795000,-795000
061183,友達國泰9B購02  ,0,0,0,0,0,0,0,0,0,-816000,0,0,0,189000,1005000,-816000,-816000
053006,玉晶光永豐96購03,0,0,0,0,0,0,0,0,0,-820000,0,0,0,3000,823000,-820000,-820000
058214,世芯群益9A購01  ,0,0,0,0,0,0,0,0,0,-829000,0,0,0,121000,950000,-829000,-829000
058245,訊連元大99購01  ,0,0,0,0,0,0,0,0,0,-853000,0,0,0,384000,1237000,-853000,-853000
057202,TPK元富98購02   ,0,0,0,0,0,0,0,0,0,-865000,0,0,0,0,865000,-865000,-865000
2393,億光            ,1063000,2291000,-1228000,0,0,0,70000,0,70000,293000,48000,32000,16000,441000,164000,277000,-865000
00648R,元大S&P500反1   ,0,0,0,0,0,0,0,0,0,-872000,0,0,0,388000,1260000,-872000,-872000
057940,和大國票99購01  ,0,0,0,0,0,0,0,0,0,-909000,0,0,0,10000,919000,-909000,-909000
2436,偉詮電          ,338000,1248000,-910000,0,0,0,0,0,0,0,0,0,0,0,0,0,-910000
053361,友達元富99購01  ,0,0,0,0,0,0,0,0,0,-928000,0,0,0,179000,1107000,-928000,-928000
060119,上銀富邦9B購03  ,0,0,0,0,0,0,0,0,0,-930000,0,0,0,58000,988000,-930000,-930000
6558,興能高          ,343000,1288000,-945000,0,0,0,0,0,0,0,0,0,0,0,0,0,-945000
056320,京鼎群益99購01  ,0,0,0,0,0,0,0,0,0,-950000,0,0,0,561000,1511000,-950000,-950000
059623,聯電凱基99購02  ,0,0,0,0,0,0,0,0,0,-953000,0,0,0,120000,1073000,-953000,-953000
060784,鴻海富邦9C購01  ,0,0,0,0,0,0,0,0,0,-957000,0,0,0,347000,1304000,-957000,-957000
3029,零壹            ,378000,1349000,-971000,0,0,0,0,0,0,-3000,10000,13000,-3000,0,0,0,-974000
058156,超眾統一9A購02  ,0,0,0,0,0,0,0,0,0,-1002000,0,0,0,97000,1099000,-1002000,-1002000
046942,友達元大99購01  ,0,0,0,0,0,0,0,0,0,-1003000,0,0,0,257000,1260000,-1003000,-1003000
2103,台橡            ,1810000,2813629,-1003629,0,0,0,0,0,0,0,0,0,0,0,0,0,-1003629
058110,光寶科元富98購01,0,0,0,0,0,0,0,0,0,-1033000,0,0,0,0,1033000,-1033000,-1033000
059953,聯發科康和99購01,0,0,0,0,0,0,0,0,0,-1038000,0,0,0,29000,1067000,-1038000,-1038000
03441B,臺股指凱基9A熊05,0,0,0,0,0,0,0,0,0,-1057000,0,0,0,848000,1905000,-1057000,-1057000
059095,訊芯元大99購01  ,0,0,0,0,0,0,0,0,0,-1059000,0,0,0,332000,1391000,-1059000,-1059000
03840P,台積電統一99售02,0,0,0,0,0,0,0,0,0,-1082000,0,0,0,0,1082000,-1082000,-1082000
2316,楠梓電          ,247000,1372000,-1125000,0,0,0,0,0,0,35000,32000,0,32000,15000,12000,3000,-1090000
056403,茂林群益98購01  ,0,0,0,0,0,0,0,0,0,-1096000,0,0,0,220000,1316000,-1096000,-1096000
058131,義隆元大99購02  ,0,0,0,0,0,0,0,0,0,-1126000,0,0,0,141000,1267000,-1126000,-1126000
058766,力山兆豐99購01  ,0,0,0,0,0,0,0,0,0,-1148000,0,0,0,279000,1427000,-1148000,-1148000
3596,智易            ,189000,1332000,-1143000,0,0,0,0,0,0,-6000,4000,4000,0,10000,16000,-6000,-1149000
2338,光罩            ,924000,1863000,-939000,0,0,0,0,0,0,-224000,0,0,0,92000,316000,-224000,-1163000
9919,康那香          ,751000,1894000,-1143000,0,0,0,0,0,0,-32000,18000,50000,-32000,0,0,0,-1175000
057696,聯電群益9A購01  ,0,0,0,0,0,0,0,0,0,-1253000,0,0,0,64000,1317000,-1253000,-1253000
2458,義隆            ,1612000,2777000,-1165000,0,0,0,1000,392000,-391000,281000,291000,22000,269000,42000,30000,12000,-1275000
056946,國巨統一98購05  ,0,0,0,0,0,0,0,0,0,-1296000,0,0,0,315000,1611000,-1296000,-1296000
3034,聯詠            ,3146050,4394000,-1247950,0,0,0,33000,122000,-89000,31000,52000,16000,36000,29000,34000,-5000,-1305950
056671,台灣50元富9A購01,0,0,0,0,0,0,0,0,0,-1335000,0,0,0,0,1335000,-1335000,-1335000
6288,聯嘉            ,669000,2002000,-1333000,0,0,0,0,0,0,-4000,4000,8000,-4000,0,0,0,-1337000
055663,崇越中信97購01  ,0,0,0,0,0,0,0,0,0,-1420000,0,0,0,0,1420000,-1420000,-1420000
058005,茂林群益98購04  ,0,0,0,0,0,0,0,0,0,-1457000,0,0,0,30000,1487000,-1457000,-1457000
053564,台積電富邦99購01,50000,0,50000,0,0,0,0,0,0,-1530000,0,0,0,0,1530000,-1530000,-1480000
00676R,富邦臺灣加權反1 ,0,0,0,0,0,0,0,0,0,-1559000,0,0,0,2756000,4315000,-1559000,-1559000
052542,友達元富98購01  ,0,0,0,0,0,0,0,0,0,-1703000,0,0,0,101000,1804000,-1703000,-1703000
00664R,國泰臺灣加權反1 ,0,4000,-4000,0,0,0,0,0,0,-1726000,0,0,0,1706000,3432000,-1726000,-1730000
05375P,健策國票96售02  ,0,0,0,0,0,0,0,0,0,-1800000,0,0,0,0,1800000,-1800000,-1800000
00693U,街口S&P黃豆     ,154000,193000,-39000,0,0,0,0,0,0,-1934000,0,0,0,1947000,3881000,-1934000,-1973000
6176,瑞儀            ,3150000,4153000,-1003000,0,0,0,692000,814000,-122000,-945000,24000,853000,-829000,74000,190000,-116000,-2070000
2337,旺宏            ,9183000,10778010,-1595010,0,0,0,411000,784000,-373000,-351000,1089000,873000,216000,682000,1249000,-567000,-2319010
056829,台積電富邦9A購01,0,0,0,0,0,0,0,0,0,-2428000,0,0,0,0,2428000,-2428000,-2428000
3189,景碩            ,1069000,3033000,-1964000,0,0,0,100000,1113000,-1013000,-161000,188000,26000,162000,5000,328000,-323000,-3138000
1101,台泥            ,4958000,8983892,-4025892,0,0,0,619000,0,619000,-257000,14000,34000,-20000,23000,260000,-237000,-3663892
2892,第一金          ,9526000,9733885,-207885,0,0,0,31000,4119000,-4088000,-110000,1000,49000,-48000,6000,68000,-62000,-4405885
2891,中信金          ,21899000,29143131,-7244131,0,0,0,52000,612000,-560000,177000,279000,14000,265000,20000,108000,-88000,-7627131
00642U,元大S&P石油     ,7000,3000,4000,0,0,0,0,0,0,-10959000,0,0,0,1583000,12542000,-10959000,-10955000
2303,聯電            ,30782000,55480128,-24698128,0,0,0,568000,85000,483000,6057000,3944000,340000,3604000,2786000,333000,2453000,-18158128
00632R,元大台灣50反1   ,1648000,1683000,-35000,0,0,0,0,0,0,-41823000,1910000,2490000,-580000,37819000,79062000,-41243000,-41858000
00677U,富邦VIX         ,8806000,77049000,-68243000,0,0,0,0,0,0,-16865000,2368000,4126000,-1758000,8341000,23448000,-15107000,-85108000
