證券代號,證券名稱,外陸資買進股數(不含外資自營商),外陸資賣出股數(不含外資自營商),外陸資買賣超股數(不含外資自營商),外資自營商買進股數,外資自營商賣出股數,外資自營商買賣超股數,投信買進股數,投信賣出股數,投信買賣超股數,自營商買賣超股數,自營商買進股數(自行買賣),自營商賣出股數(自行買賣),自營商買賣超股數(自行買賣),自營商買進股數(避險),自營商賣出股數(避險),自營商買賣超股數(避險),三大法人買賣超股數
00677U,富邦VIX         ,64964000,8840000,56124000,0,0,0,0,0,0,42049000,4430000,415000,4015000,47059000,9025000,38034000,98173000
2303,聯電            ,43798745,33250063,10548682,0,0,0,0,3344000,-3344000,32000,14000,0,14000,143000,125000,18000,7236682
2888,新光金          ,52501504,46145141,6356363,0,0,0,26000,2000,24000,396000,76000,308000,-232000,785000,157000,628000,6776363
00653L,富邦印度正2     ,2317000,980000,1337000,0,0,0,0,0,0,5040000,0,0,0,7337000,2297000,5040000,6377000
00637L,元大滬深300正2  ,4506000,6408000,-1902000,0,0,0,0,0,0,7978000,0,0,0,29606000,21628000,7978000,6076000
2371,大同            ,14825150,12156444,2668706,0,0,0,0,3000,-3000,2633000,2801000,168000,2633000,0,0,0,5298706
052688,新日興元大96購01,0,0,0,0,0,0,0,0,0,4849000,0,0,0,4849000,0,4849000,4849000
4938,和碩            ,12741428,8015000,4726428,0,0,0,221000,9000,212000,-114000,6000,188000,-182000,107000,39000,68000,4824428
2458,義隆            ,4873000,1721000,3152000,0,0,0,1153000,0,1153000,379000,241000,65000,176000,318000,115000,203000,4684000
3231,緯創            ,21898253,17179417,4718836,0,0,0,0,0,0,-284000,4000,287000,-283000,89000,90000,-1000,4434836
2887,台新金          ,29783671,25436000,4347671,0,0,0,22000,1000,21000,-23000,4000,27000,-23000,0,0,0,4345671
00861,元大全球未來通訊,0,708000,-708000,0,0,0,0,0,0,4780000,0,0,0,5435000,655000,4780000,4072000
2324,仁寶            ,22353835,18149814,4204021,0,0,0,0,0,0,-199000,0,330000,-330000,131000,0,131000,4005021
3038,全台            ,4475000,312000,4163000,0,0,0,0,0,0,-205000,70000,275000,-205000,0,0,0,3958000
2892,第一金          ,49426839,46008244,3418595,0,0,0,23000,0,23000,-93000,0,93000,-93000,0,0,0,3348595
2382,廣達            ,21027585,19043520,1984065,0,0,0,1310000,140000,1170000,-108000,10000,98000,-88000,40000,60000,-20000,3046065
2353,宏碁            ,21510449,19328739,2181710,0,0,0,0,0,0,732000,592000,0,592000,175000,35000,140000,2913710
2317,鴻海            ,37271342,35092878,2178464,0,0,0,330000,17000,313000,14000,182000,83000,99000,281000,366000,-85000,2505464
2356,英業達          ,12262193,9901000,2361193,0,0,0,0,0,0,-99000,0,71000,-71000,117000,145000,-28000,2262193
6251,定穎            ,2437000,238000,2199000,0,0,0,0,0,0,0,0,0,0,0,0,0,2199000
3016,嘉晶            ,3780000,1567000,2213000,0,0,0,0,0,0,-22000,23000,18000,5000,97000,124000,-27000,2191000
6456,GIS-KY          ,1672000,1900000,-228000,0,0,0,1995000,0,1995000,321000,0,18000,-18000,367000,28000,339000,2088000
6592,和潤企業        ,3870000,1893000,1977000,0,0,0,0,0,0,84000,27000,24000,3000,81000,0,81000,2061000
2498,宏達電          ,2815000,1303598,1511402,0,0,0,0,0,0,256000,98000,51000,47000,242000,33000,209000,1767402
2505,國揚            ,1963000,829000,1134000,0,0,0,0,0,0,627000,15000,1000,14000,621000,8000,613000,1761000
8926,台汽電          ,1894000,283000,1611000,0,0,0,0,0,0,142000,0,6000,-6000,148000,0,148000,1753000
00738U,元大道瓊白銀    ,104000,4000,100000,0,0,0,0,0,0,1648000,0,0,0,1688000,40000,1648000,1748000
6269,台郡            ,1857000,408000,1449000,0,0,0,418000,0,418000,-147000,24000,204000,-180000,45000,12000,33000,1720000
00633L,富邦上証正2     ,406000,393000,13000,0,0,0,0,0,0,1657000,0,0,0,5073000,3416000,1657000,1670000
2603,長榮            ,12731250,13782651,-1051401,0,0,0,3001000,0,3001000,-338000,768000,1106000,-338000,0,0,0,1611599
1101,台泥            ,32832480,31916890,915590,0,0,0,749000,10000,739000,-65000,15000,153000,-138000,73000,0,73000,1589590
2201,裕隆            ,3195000,1483000,1712000,0,0,0,0,0,0,-134000,11000,0,11000,109000,254000,-145000,1578000
1303,南亞            ,13771236,12238625,1532611,0,0,0,0,0,0,-4000,2000,6000,-4000,0,0,0,1528611
4142,國光生          ,1311000,241000,1070000,0,0,0,0,0,0,432000,40000,0,40000,422000,30000,392000,1502000
8046,南電            ,3068000,2203000,865000,0,0,0,555000,0,555000,31000,6000,22000,-16000,142000,95000,47000,1451000
2108,南帝            ,1850000,416000,1434000,0,0,0,0,0,0,0,0,0,0,0,0,0,1434000
2886,兆豐金          ,25179159,23842996,1336163,0,0,0,26000,1000,25000,65000,0,0,0,65000,0,65000,1426163
8210,勤誠            ,1652000,295000,1357000,0,0,0,0,0,0,67000,0,24000,-24000,95000,4000,91000,1424000
2883,開發金          ,30126120,28853159,1272961,0,0,0,29000,0,29000,81000,0,14000,-14000,95000,0,95000,1382961
2385,群光            ,5265551,3920030,1345521,0,0,0,67000,0,67000,-112000,20000,202000,-182000,84000,14000,70000,1300521
3189,景碩            ,2142000,2210000,-68000,0,0,0,867000,0,867000,501000,139000,61000,78000,495000,72000,423000,1300000
060448,道瓊反元大9A購04,0,0,0,0,0,0,0,0,0,1280000,0,0,0,1280000,0,1280000,1280000
3711,日月光投控      ,26084702,25155547,929155,0,0,0,221000,22000,199000,135000,111000,6000,105000,30000,0,30000,1263155
5469,瀚宇博          ,3122100,1891000,1231100,0,0,0,0,0,0,22000,30000,64000,-34000,225000,169000,56000,1253100
06491P,台積電富邦99售02,0,0,0,0,0,0,0,0,0,1225000,0,0,0,2207000,982000,1225000,1225000
3017,奇鋐            ,3595000,1719000,1876000,0,0,0,90000,216000,-126000,-565000,0,17000,-17000,17000,565000,-548000,1185000
062896,中興電元大9B購01,0,0,0,0,0,0,0,0,0,1167000,0,0,0,1376000,209000,1167000,1167000
061372,世紀鋼國泰9C購01,0,0,0,0,0,0,0,0,0,1164000,0,0,0,1984000,820000,1164000,1164000
062819,奇鋐兆豐9B購01  ,0,0,0,0,0,0,0,0,0,1134000,0,0,0,1160000,26000,1134000,1134000
057475,聯電元大9A購01  ,0,0,0,0,0,0,0,0,0,1094000,0,0,0,1908000,814000,1094000,1094000
2342,茂矽            ,1582000,502000,1080000,0,0,0,0,0,0,0,0,0,0,0,0,0,1080000
07821P,臺股指國票9A售12,0,0,0,0,0,0,0,0,0,1065000,0,0,0,1430000,365000,1065000,1065000
2349,錸德            ,3751000,2687024,1063976,0,0,0,0,0,0,0,0,0,0,0,0,0,1063976
061685,道瓊反群益9A購03,0,0,0,0,0,0,0,0,0,1041000,0,0,0,1076000,35000,1041000,1041000
1515,力山            ,1587000,710000,877000,0,0,0,162000,0,162000,-11000,11000,67000,-56000,109000,64000,45000,1028000
1714,和桐            ,1169000,145000,1024000,0,0,0,0,0,0,0,0,0,0,0,0,0,1024000
053154,聯詠元大96購01  ,0,0,0,0,0,0,0,0,0,998000,0,0,0,998000,0,998000,998000
08031P,臺股指元大9B售38,0,0,0,0,0,0,0,0,0,998000,0,0,0,998000,0,998000,998000
062808,祥碩統一9C購01  ,0,0,0,0,0,0,0,0,0,988000,0,0,0,1657000,669000,988000,988000
07421P,國泰金元大99售01,0,0,0,0,0,0,0,0,0,969000,0,0,0,997000,28000,969000,969000
08000P,奇鋐凱基9B售03  ,0,0,0,0,0,0,0,0,0,968000,0,0,0,1016000,48000,968000,968000
07658P,國泰金凱基9A售01,0,0,0,0,0,0,0,0,0,939000,0,0,0,987000,48000,939000,939000
5521,工信            ,1111000,172000,939000,0,0,0,0,0,0,0,0,0,0,0,0,0,939000
3661,世芯-KY         ,2237000,1574000,663000,0,0,0,287000,0,287000,-28000,4000,32000,-28000,15000,15000,0,922000
1736,喬山            ,1322000,618000,704000,0,0,0,200000,0,200000,10000,0,12000,-12000,39000,17000,22000,914000
6504,南六            ,692000,341000,351000,0,0,0,295000,0,295000,250000,178000,85000,93000,168000,11000,157000,896000
4935,茂林-KY         ,1892000,957000,935000,0,0,0,0,40000,-40000,-4000,70000,108000,-38000,45000,11000,34000,891000
061589,世紀鋼富邦9B購01,0,0,0,0,0,0,0,0,0,889000,0,0,0,1542000,653000,889000,889000
062485,華通國泰01購01  ,0,0,0,0,0,0,0,0,0,877000,0,0,0,898000,21000,877000,877000
060290,興富發元大9C購01,0,0,0,0,0,0,0,0,0,867000,0,0,0,1018000,151000,867000,867000
06903P,技嘉凱基98售04  ,0,0,0,0,0,0,0,0,0,862000,0,0,0,934000,72000,862000,862000
00655L,國泰中國A50正2  ,11000,267000,-256000,0,0,0,0,0,0,1117000,0,0,0,1831000,714000,1117000,861000
2327,國巨            ,4518954,3651073,867881,0,0,0,1000,308000,-307000,291000,394000,162000,232000,102000,43000,59000,851881
056009,奇力新中信98購03,0,0,0,0,0,0,0,0,0,830000,0,0,0,900000,70000,830000,830000
062981,祥碩元富9B購01  ,0,0,0,0,0,0,0,0,0,819000,0,0,0,890000,71000,819000,819000
059623,聯電凱基99購02  ,0,0,0,0,0,0,0,0,0,807000,0,0,0,827000,20000,807000,807000
6196,帆宣            ,1682000,841000,841000,0,0,0,14000,45000,-31000,-7000,0,11000,-11000,25000,21000,4000,803000
057121,立積康和98購01  ,0,0,0,0,0,0,0,0,0,796000,0,0,0,998000,202000,796000,796000
07853P,國巨凱基9A售19  ,0,0,0,0,0,0,0,0,0,792000,0,0,0,792000,0,792000,792000
6412,群電            ,1722000,943000,779000,0,0,0,0,0,0,1000,0,1000,-1000,9000,7000,2000,780000
6112,聚碩            ,821000,41000,780000,0,0,0,0,0,0,-1000,0,1000,-1000,0,0,0,779000
062036,致新群益9B購01  ,0,0,0,0,0,0,0,0,0,757000,0,0,0,792000,35000,757000,757000
063072,裕隆永豐9B購01  ,0,0,0,0,0,0,0,0,0,752000,0,0,0,878000,126000,752000,752000
057656,大成鋼兆豐98購01,0,0,0,0,0,0,0,0,0,747000,0,0,0,882000,135000,747000,747000
08066P,南亞科凱基9B售04,0,0,0,0,0,0,0,0,0,743000,0,0,0,784000,41000,743000,743000
061361,世紀鋼兆豐9A購01,0,0,0,0,0,0,0,0,0,735000,0,0,0,832000,97000,735000,735000
5880,合庫金          ,33512894,32804334,708560,0,0,0,21000,1000,20000,0,0,0,0,0,0,0,728560
06477P,緯穎國票99售02  ,0,0,0,0,0,0,0,0,0,724000,0,0,0,880000,156000,724000,724000
063483,致新元大9B購03  ,0,0,0,0,0,0,0,0,0,720000,0,0,0,943000,223000,720000,720000
6213,聯茂            ,1450000,727070,722930,0,0,0,100000,0,100000,-106000,14000,69000,-55000,28000,79000,-51000,716930
059671,滬深2X元富99購05,0,0,0,0,0,0,0,0,0,707000,0,0,0,867000,160000,707000,707000
053385,聯詠元大96購02  ,0,0,0,0,0,0,0,0,0,698000,0,0,0,698000,0,698000,698000
060937,T50反1國票9A購10,0,0,0,0,0,0,0,0,0,698000,0,0,0,698000,0,698000,698000
061610,力成統一9C購01  ,0,0,0,0,0,0,0,0,0,690000,0,0,0,898000,208000,690000,690000
060908,金像電元大9A購03,0,0,0,0,0,0,0,0,0,685000,0,0,0,761000,76000,685000,685000
055538,鴻海日盛97購04  ,0,0,0,0,0,0,0,0,0,677000,0,0,0,677000,0,677000,677000
060467,神基元大9A購01  ,0,0,0,0,0,0,0,0,0,674000,0,0,0,684000,10000,674000,674000
059880,世紀鋼凱基99購02,0,0,0,0,0,0,0,0,0,667000,0,0,0,733000,66000,667000,667000
1218,泰山            ,2491000,1927000,564000,0,0,0,0,0,0,97000,97000,0,97000,0,0,0,661000
07457P,宏達電元大9A售01,0,0,0,0,0,0,0,0,0,655000,0,0,0,665000,10000,655000,655000
056813,聯茂統一99購01  ,0,0,0,0,0,0,0,0,0,647000,0,0,0,725000,78000,647000,647000
058547,世紀鋼富邦9A購01,0,0,0,0,0,0,0,0,0,640000,0,0,0,640000,0,640000,640000
063075,祥碩永豐9B購04  ,0,0,0,0,0,0,0,0,0,639000,0,0,0,680000,41000,639000,639000
060639,玉晶光永豐9A購05,0,0,0,0,0,0,0,0,0,637000,0,0,0,637000,0,637000,637000
054347,上緯控國票96購02,0,0,0,0,0,0,0,0,0,636000,0,0,0,636000,0,636000,636000
08088P,義隆凱基9B售03  ,0,0,0,0,0,0,0,0,0,632000,0,0,0,664000,32000,632000,632000
061944,聯電群益9B購01  ,0,0,0,0,0,0,0,0,0,631000,0,0,0,632000,1000,631000,631000
062035,瑞祺群益9B購01  ,0,0,0,0,0,0,0,0,0,630000,0,0,0,837000,207000,630000,630000
058803,世紀鋼元大99購03,0,0,0,0,0,0,0,0,0,629000,0,0,0,774000,145000,629000,629000
059181,世紀鋼元富9C購01,0,0,0,0,0,0,0,0,0,627000,0,0,0,723000,96000,627000,627000
063277,大成鋼元大9B購03,0,0,0,0,0,0,0,0,0,626000,0,0,0,747000,121000,626000,626000
2493,揚博            ,640000,16000,624000,0,0,0,0,0,0,0,0,0,0,0,0,0,624000
061134,大成鋼統一9C購01,0,0,0,0,0,0,0,0,0,622000,0,0,0,657000,35000,622000,622000
07482P,南亞科元富9A售04,0,0,0,0,0,0,0,0,0,618000,0,0,0,808000,190000,618000,618000
060437,宏全永豐9A購01  ,0,0,0,0,0,0,0,0,0,610000,0,0,0,610000,0,610000,610000
2478,大毅            ,835000,371000,464000,0,0,0,0,0,0,143000,10000,0,10000,143000,10000,133000,607000
051193,新日興兆豐96購01,0,0,0,0,0,0,0,0,0,601000,0,0,0,601000,0,601000,601000
061193,玉晶光永豐9B購02,0,0,0,0,0,0,0,0,0,597000,0,0,0,602000,5000,597000,597000
060716,新唐永豐9A購01  ,0,0,0,0,0,0,0,0,0,596000,0,0,0,636000,40000,596000,596000
1315,達新            ,594000,36000,558000,0,0,0,0,0,0,36000,0,0,0,36000,0,36000,594000
06801P,技嘉群益99售02  ,0,0,0,0,0,0,0,0,0,593000,0,0,0,640000,47000,593000,593000
058263,大成鋼永豐99購01,0,0,0,0,0,0,0,0,0,591000,0,0,0,659000,68000,591000,591000
062060,奇鋐統一9C購01  ,0,0,0,0,0,0,0,0,0,588000,0,0,0,598000,10000,588000,588000
1598,岱宇            ,676000,75000,601000,0,0,0,0,0,0,-20000,0,20000,-20000,0,0,0,581000
063274,鈺齊兆豐9B購01  ,0,0,0,0,0,0,0,0,0,575000,0,0,0,595000,20000,575000,575000
053485,矽創國票97購04  ,0,0,0,0,0,0,0,0,0,571000,0,0,0,623000,52000,571000,571000
06991P,矽創群益99售01  ,0,0,0,0,0,0,0,0,0,569000,0,0,0,569000,0,569000,569000
07071P,立積元富99售01  ,0,0,0,0,0,0,0,0,0,567000,0,0,0,608000,41000,567000,567000
2345,智邦            ,4533433,3887116,646317,0,0,0,43000,0,43000,-125000,74000,174000,-100000,40000,65000,-25000,564317
08072P,祥碩永豐9B售03  ,0,0,0,0,0,0,0,0,0,564000,0,0,0,572000,8000,564000,564000
055094,智易群益98購01  ,0,0,0,0,0,0,0,0,0,563000,0,0,0,583000,20000,563000,563000
2417,圓剛            ,573000,13000,560000,0,0,0,0,0,0,0,0,0,0,0,0,0,560000
054343,世紀鋼元富96購02,0,0,0,0,0,0,0,0,0,559000,0,0,0,666000,107000,559000,559000
08111P,臺股指中信01售06,0,0,0,0,0,0,0,0,0,557000,0,0,0,566000,9000,557000,557000
06507P,台表科國票99售01,0,0,0,0,0,0,0,0,0,555000,0,0,0,585000,30000,555000,555000
062871,大成鋼兆豐9B購01,0,0,0,0,0,0,0,0,0,555000,0,0,0,555000,0,555000,555000
2102,泰豐            ,681000,132000,549000,0,0,0,0,0,0,-1000,0,1000,-1000,0,0,0,548000
2208,台船            ,853000,307000,546000,0,0,0,0,0,0,0,0,0,0,0,0,0,546000
020012,富邦行動通訊N   ,0,0,0,0,0,0,0,0,0,544000,0,0,0,544000,0,544000,544000
1514,亞力            ,587000,45000,542000,0,0,0,0,0,0,0,0,0,0,0,0,0,542000
07366P,國巨康和99售02  ,0,0,0,0,0,0,0,0,0,538000,0,0,0,1052000,514000,538000,538000
03681C,台灣50凱基02牛02,0,0,0,0,0,0,0,0,0,537000,0,0,0,540000,3000,537000,537000
061491,嘉聯益兆豐9B購01,0,0,0,0,0,0,0,0,0,535000,0,0,0,540000,5000,535000,535000
07420P,可成元大99售07  ,0,0,0,0,0,0,0,0,0,535000,0,0,0,537000,2000,535000,535000
062748,祥碩永豐9B購02  ,0,0,0,0,0,0,0,0,0,533000,0,0,0,555000,22000,533000,533000
06503P,臺股指中信9A售02,0,0,0,0,0,0,0,0,0,531000,0,0,0,615000,84000,531000,531000
05361P,聯發科富邦97售01,0,0,0,0,0,0,0,0,0,530000,0,0,0,595000,65000,530000,530000
059938,凱美永豐99購01  ,0,0,0,0,0,0,0,0,0,530000,0,0,0,617000,87000,530000,530000
056603,嘉聯益國泰9A購01,0,0,0,0,0,0,0,0,0,529000,0,0,0,566000,37000,529000,529000
07659P,中租凱基9A售02  ,0,0,0,0,0,0,0,0,0,524000,0,0,0,574000,50000,524000,524000
059948,正文永豐99購01  ,0,0,0,0,0,0,0,0,0,523000,0,0,0,612000,89000,523000,523000
054130,漢唐元大97購02  ,0,0,0,0,0,0,0,0,0,520000,0,0,0,923000,403000,520000,520000
063006,道瓊反元大9C購01,0,0,0,0,0,0,0,0,0,519000,0,0,0,519000,0,519000,519000
058516,健鼎元大99購02  ,0,0,0,0,0,0,0,0,0,515000,0,0,0,728000,213000,515000,515000
057383,玉晶光富邦9A購01,0,0,0,0,0,0,0,0,0,513000,0,0,0,514000,1000,513000,513000
3026,禾伸堂          ,691000,195000,496000,0,0,0,0,0,0,17000,0,0,0,25000,8000,17000,513000
061004,友達兆豐9A購01  ,0,0,0,0,0,0,0,0,0,512000,0,0,0,600000,88000,512000,512000
050101,台積電永昌96購03,0,0,0,0,0,0,0,0,0,509000,0,0,0,509000,0,509000,509000
057659,台表科兆豐98購01,0,0,0,0,0,0,0,0,0,508000,0,0,0,508000,0,508000,508000
047962,T50反1中信96購02,0,0,0,0,0,0,0,0,0,507000,0,0,0,1190000,683000,507000,507000
059359,精元永豐99購01  ,0,0,0,0,0,0,0,0,0,507000,0,0,0,910000,403000,507000,507000
058854,樺漢群益9B購01  ,0,0,0,0,0,0,0,0,0,505000,0,0,0,1019000,514000,505000,505000
07818P,台積電國票9C售01,0,0,0,0,0,0,0,0,0,505000,0,0,0,505000,0,505000,505000
050846,緯創國票96購01  ,0,0,0,0,0,0,0,0,0,500000,0,0,0,500000,0,500000,500000
054178,中磊台新97購01  ,0,0,0,0,0,0,0,0,0,500000,0,0,0,500000,0,500000,500000
3056,總太            ,550000,50000,500000,0,0,0,0,0,0,0,0,0,0,0,0,0,500000
063005,道瓊反元大9B購02,0,0,0,0,0,0,0,0,0,499000,0,0,0,499000,0,499000,499000
061538,SP黃豆群益9A購03,0,0,0,0,0,0,0,0,0,499000,0,0,0,499000,0,499000,499000
057137,鈺齊凱基98購01  ,0,0,0,0,0,0,0,0,0,499000,0,0,0,499000,0,499000,499000
2436,偉詮電          ,516000,17000,499000,0,0,0,0,0,0,0,0,0,0,0,0,0,499000
052152,創意富邦98購01  ,0,0,0,0,0,0,0,0,0,497000,0,0,0,499000,2000,497000,497000
00676R,富邦臺灣加權反1 ,0,0,0,0,0,0,0,0,0,497000,0,0,0,1113000,616000,497000,497000
061197,矽創永豐9A購02  ,0,0,0,0,0,0,0,0,0,496000,0,0,0,601000,105000,496000,496000
052863,友達凱基98購02  ,0,0,0,0,0,0,0,0,0,491000,0,0,0,499000,8000,491000,491000
061464,瑞昱群益9A購01  ,0,0,0,0,0,0,0,0,0,490000,0,0,0,520000,30000,490000,490000
3376,新日興          ,1421000,1375000,46000,0,0,0,435000,216000,219000,223000,182000,64000,118000,167000,62000,105000,488000
056419,欣興元富98購02  ,0,0,0,0,0,0,0,0,0,485000,0,0,0,486000,1000,485000,485000
055433,嘉聯益群益99購01,0,0,0,0,0,0,0,0,0,483000,0,0,0,581000,98000,483000,483000
061466,創意群益9A購01  ,0,0,0,0,0,0,0,0,0,481000,0,0,0,579000,98000,481000,481000
057894,華通元富02購02  ,0,0,0,0,0,0,0,0,0,478000,0,0,0,506000,28000,478000,478000
06662P,玉晶光中信9A售01,0,0,0,0,0,0,0,0,0,475000,0,0,0,496000,21000,475000,475000
052986,聯發科元大97購05,0,0,0,0,0,0,0,0,0,474000,0,0,0,474000,0,474000,474000
2404,漢唐            ,745000,391060,353940,0,0,0,0,0,0,118000,74000,26000,48000,81000,11000,70000,471940
00643,群益深証中小    ,204000,18000,186000,0,0,0,0,0,0,285000,10000,0,10000,327000,52000,275000,471000
061783,友達群益9B購01  ,0,0,0,0,0,0,0,0,0,470000,0,0,0,470000,0,470000,470000
3665,貿聯-KY         ,536000,122000,414000,0,0,0,93000,0,93000,-37000,0,7000,-7000,30000,60000,-30000,470000
062946,祥碩國泰9C購02  ,0,0,0,0,0,0,0,0,0,467000,0,0,0,537000,70000,467000,467000
063108,世紀鋼群益9C購01,0,0,0,0,0,0,0,0,0,466000,0,0,0,471000,5000,466000,466000
06899P,嘉澤群益98售01  ,0,0,0,0,0,0,0,0,0,464000,0,0,0,474000,10000,464000,464000
07883P,可成凱基9B售03  ,0,0,0,0,0,0,0,0,0,462000,0,0,0,466000,4000,462000,462000
061248,健策群益9A購03  ,0,0,0,0,0,0,0,0,0,456000,0,0,0,620000,164000,456000,456000
062351,瑞祺群益9C購01  ,0,0,0,0,0,0,0,0,0,455000,0,0,0,697000,242000,455000,455000
056961,凱美永豐98購01  ,0,0,0,0,0,0,0,0,0,455000,0,0,0,455000,0,455000,455000
060451,中石化元大9C購02,0,0,0,0,0,0,0,0,0,455000,0,0,0,576000,121000,455000,455000
00640L,富邦日本正2     ,0,2000,-2000,0,0,0,0,0,0,455000,0,0,0,835000,380000,455000,453000
06667P,鴻海凱基98售11  ,0,0,0,0,0,0,0,0,0,452000,0,0,0,453000,1000,452000,452000
061069,嘉聯益凱基9A購01,0,0,0,0,0,0,0,0,0,452000,0,0,0,592000,140000,452000,452000
6257,矽格            ,1021000,911000,110000,0,0,0,380000,0,380000,-39000,131000,188000,-57000,18000,0,18000,451000
051115,華通麥證96購01  ,0,0,0,450000,0,450000,0,0,0,450000,0,0,0,450000,0,450000,450000
3443,創意            ,344014,102000,242014,0,0,0,0,0,0,204000,159000,0,159000,67000,22000,45000,446014
055197,致新元富97購02  ,0,0,0,0,0,0,0,0,0,444000,0,0,0,474000,30000,444000,444000
057985,華通元富02購03  ,0,0,0,0,0,0,0,0,0,444000,0,0,0,444000,0,444000,444000
08027P,嘉晶元大9B售03  ,0,0,0,0,0,0,0,0,0,444000,0,0,0,563000,119000,444000,444000
052104,英業達兆豐96購01,0,0,0,0,0,0,0,0,0,443000,0,0,0,443000,0,443000,443000
059097,世紀鋼元大99購05,0,0,0,0,0,0,0,0,0,443000,0,0,0,646000,203000,443000,443000
062984,致新元富9B購01  ,0,0,0,0,0,0,0,0,0,442000,0,0,0,555000,113000,442000,442000
061132,志超永豐9A購01  ,0,0,0,0,0,0,0,0,0,442000,0,0,0,723000,281000,442000,442000
055245,凱美統一99購01  ,0,0,0,0,0,0,0,0,0,439000,0,0,0,477000,38000,439000,439000
2480,敦陽科          ,445000,33000,412000,0,0,0,0,0,0,25000,45000,20000,25000,0,0,0,437000
07472P,和碩元大9A售03  ,0,0,0,0,0,0,0,0,0,433000,0,0,0,458000,25000,433000,433000
062087,瑞祺元大9B購02  ,0,0,0,0,0,0,0,0,0,432000,0,0,0,603000,171000,432000,432000
052738,聯電元大98購02  ,0,0,0,0,0,0,0,0,0,431000,0,0,0,451000,20000,431000,431000
060489,世紀鋼群益9A購01,0,0,0,0,0,0,0,0,0,431000,0,0,0,470000,39000,431000,431000
056404,嘉聯益群益9A購01,0,0,0,0,0,0,0,0,0,428000,0,0,0,596000,168000,428000,428000
060204,矽創元富9A購01  ,0,0,0,0,0,0,0,0,0,428000,0,0,0,458000,30000,428000,428000
062070,金寶元大9B購01  ,0,0,0,0,0,0,0,0,0,425000,0,0,0,425000,0,425000,425000
061882,矽創元大9B購01  ,0,0,0,0,0,0,0,0,0,424000,0,0,0,569000,145000,424000,424000
05977P,旺宏永豐96售06  ,0,0,0,0,0,0,0,0,0,424000,0,0,0,453000,29000,424000,424000
061293,聯茂統一9A購01  ,0,0,0,0,0,0,0,0,0,424000,0,0,0,507000,83000,424000,424000
058429,欣興元富99購01  ,0,0,0,0,0,0,0,0,0,423000,0,0,0,473000,50000,423000,423000
061723,嘉聯益永豐9A購03,0,0,0,0,0,0,0,0,0,421000,0,0,0,421000,0,421000,421000
062849,中興電永豐9B購02,0,0,0,0,0,0,0,0,0,421000,0,0,0,421000,0,421000,421000
07248P,可成凱基99售06  ,0,0,0,0,0,0,0,0,0,421000,0,0,0,421000,0,421000,421000
060719,瀚宇博永豐9A購01,0,0,0,0,0,0,0,0,0,420000,0,0,0,542000,122000,420000,420000
063292,致新元大9B購02  ,0,0,0,0,0,0,0,0,0,418000,0,0,0,468000,50000,418000,418000
058324,嘉聯益永豐9A購01,0,0,0,0,0,0,0,0,0,418000,0,0,0,425000,7000,418000,418000
058819,華通國泰9B購01  ,0,0,0,0,0,0,0,0,0,418000,0,0,0,601000,183000,418000,418000
07469P,台達電元大9A售01,0,0,0,0,0,0,0,0,0,412000,0,0,0,413000,1000,412000,412000
054109,南亞科凱基96購05,0,0,0,0,0,0,0,0,0,410000,0,0,0,410000,0,410000,410000
00639,富邦深100       ,7000,1000,6000,0,0,0,0,0,0,402552,0,0,0,1785552,1383000,402552,408552
063453,創意統一9C購01  ,0,0,0,0,0,0,0,0,0,408000,0,0,0,408000,0,408000,408000
062063,世紀鋼統一9C購01,0,0,0,0,0,0,0,0,0,406000,0,0,0,448000,42000,406000,406000
02001L,富邦蘋果正二N   ,0,0,0,0,0,0,0,0,0,403000,0,0,0,405000,2000,403000,403000
053691,聯發科元大96購16,0,0,0,0,0,0,0,0,0,403000,0,0,0,403000,0,403000,403000
06656P,GIS元大98售02   ,0,0,0,0,0,0,0,0,0,401000,0,0,0,478000,77000,401000,401000
1519,華城            ,322000,85000,237000,0,0,0,0,0,0,164000,165000,1000,164000,0,0,0,401000
052821,晶技永豐96購01  ,0,0,0,0,0,0,0,0,0,400000,0,0,0,400000,0,400000,400000
056835,聯電元富99購01  ,0,0,0,0,0,0,0,0,0,400000,0,0,0,488000,88000,400000,400000
051929,GIS中信96購01   ,0,0,0,0,0,0,0,0,0,400000,0,0,0,400000,0,400000,400000
00670L,富邦NASDAQ正2   ,9000,21000,-12000,0,0,0,0,0,0,409000,20000,0,20000,554000,165000,389000,397000
060236,精元元大9C購01  ,0,0,0,0,0,0,0,0,0,396000,0,0,0,760000,364000,396000,396000
061188,大成鋼富邦9B購01,0,0,0,0,0,0,0,0,0,395000,0,0,0,670000,275000,395000,395000
07898P,國巨國泰9C售02  ,0,0,0,0,0,0,0,0,0,395000,0,0,0,521000,126000,395000,395000
056844,欣興元富98購03  ,0,0,0,0,0,0,0,0,0,393000,0,0,0,423000,30000,393000,393000
07719P,臺股指群益9A售08,0,0,0,0,0,0,0,0,0,392000,0,0,0,399000,7000,392000,392000
062088,緯穎元大9B購04  ,0,0,0,0,0,0,0,0,0,391000,0,0,0,430000,39000,391000,391000
055873,聚陽元富97購01  ,0,0,0,0,0,0,0,0,0,390000,0,0,0,390000,0,390000,390000
063339,智邦統一01購01  ,0,0,0,0,0,0,0,0,0,388000,0,0,0,512000,124000,388000,388000
058160,奇鋐元富99購01  ,0,0,0,0,0,0,0,0,0,388000,0,0,0,470000,82000,388000,388000
063208,鈺齊統一9C購01  ,0,0,0,0,0,0,0,0,0,386000,0,0,0,434000,48000,386000,386000
057141,嘉聯益兆豐99購01,0,0,0,0,0,0,0,0,0,386000,0,0,0,386000,0,386000,386000
05431P,台光電統一97售01,0,0,0,0,0,0,0,0,0,385000,0,0,0,425000,40000,385000,385000
055670,矽創群益98購02  ,0,0,0,0,0,0,0,0,0,384000,0,0,0,495000,111000,384000,384000
06914P,南茂元大98售03  ,0,0,0,0,0,0,0,0,0,382000,0,0,0,383000,1000,382000,382000
057816,欣興元大98購13  ,0,0,0,0,0,0,0,0,0,382000,0,0,0,383000,1000,382000,382000
07917P,可成永豐9B售01  ,0,0,0,0,0,0,0,0,0,380000,0,0,0,380000,0,380000,380000
054811,裕隆元大9A購01  ,0,0,0,0,0,0,0,0,0,379000,0,0,0,380000,1000,379000,379000
051849,旺宏中信98購01  ,0,0,0,0,0,0,0,0,0,379000,0,0,0,775000,396000,379000,379000
06750P,聯發科元富02售03,0,0,0,0,0,0,0,0,0,378000,0,0,0,401000,23000,378000,378000
054726,台積電日盛97購01,0,0,0,0,0,0,0,0,0,377000,0,0,0,377000,0,377000,377000
06454P,緯穎元大98售04  ,0,0,0,0,0,0,0,0,0,376000,0,0,0,376000,0,376000,376000
058372,欣興凱基99購03  ,0,0,0,0,0,0,0,0,0,374000,0,0,0,384000,10000,374000,374000
062608,智易凱基9B購01  ,0,0,0,0,0,0,0,0,0,373000,0,0,0,459000,86000,373000,373000
05692P,聯發科中信9A售02,0,0,0,0,0,0,0,0,0,371000,0,0,0,455000,84000,371000,371000
060284,南港元大01購01  ,0,0,0,0,0,0,0,0,0,371000,0,0,0,401000,30000,371000,371000
062348,聯發科群益9B購06,0,0,0,0,0,0,0,0,0,368000,0,0,0,512000,144000,368000,368000
062052,華通統一01購01  ,0,0,0,0,0,0,0,0,0,368000,0,0,0,415000,47000,368000,368000
06436P,台光電國票98售04,0,0,0,0,0,0,0,0,0,366000,0,0,0,413000,47000,366000,366000
061042,致新永豐9A購02  ,0,0,0,0,0,0,0,0,0,366000,0,0,0,476000,110000,366000,366000
1701,中化            ,587000,222000,365000,0,0,0,0,0,0,0,0,0,0,0,0,0,365000
2484,希華            ,390000,25000,365000,0,0,0,0,0,0,0,0,0,0,0,0,0,365000
1904,正隆            ,2364000,2590713,-226713,0,0,0,500000,0,500000,91000,134000,0,134000,18000,61000,-43000,364287
051530,鴻海國票97購01  ,0,0,0,0,0,0,0,0,0,364000,0,0,0,364000,0,364000,364000
06683P,訊芯元大98售07  ,0,0,0,0,0,0,0,0,0,363000,0,0,0,363000,0,363000,363000
07303P,臺股指元大9A售36,0,0,0,0,0,0,0,0,0,360000,0,0,0,535000,175000,360000,360000
058601,台積電元大99購10,0,0,0,0,0,0,0,0,0,358000,0,0,0,361000,3000,358000,358000
3532,台勝科          ,624000,189000,435000,0,0,0,0,0,0,-77000,0,95000,-95000,28000,10000,18000,358000
062666,和碩群益9B購01  ,0,0,0,0,0,0,0,0,0,357000,0,0,0,595000,238000,357000,357000
06984P,上銀富邦9B售01  ,0,0,0,0,0,0,0,0,0,356000,0,0,0,377000,21000,356000,356000
3515,華擎            ,1290000,1151000,139000,0,0,0,194000,0,194000,23000,1000,11000,-10000,52000,19000,33000,356000
059932,世紀鋼富邦9A購02,0,0,0,0,0,0,0,0,0,354000,0,0,0,741000,387000,354000,354000
2312,金寶            ,3702000,3217000,485000,0,0,0,0,0,0,-132000,0,0,0,39000,171000,-132000,353000
056411,緯穎國票99購01  ,0,0,0,0,0,0,0,0,0,352000,0,0,0,397000,45000,352000,352000
054795,合勤控群益98購01,0,0,0,0,0,0,0,0,0,352000,0,0,0,352000,0,352000,352000
07677P,祥碩永豐9A售01  ,0,0,0,0,0,0,0,0,0,352000,0,0,0,462000,110000,352000,352000
063054,健鼎統一01購01  ,0,0,0,0,0,0,0,0,0,351000,0,0,0,993000,642000,351000,351000
060709,緯穎富邦9B購01  ,0,0,0,0,0,0,0,0,0,351000,0,0,0,762000,411000,351000,351000
063107,矽創群益9B購01  ,0,0,0,0,0,0,0,0,0,349000,0,0,0,874000,525000,349000,349000
057609,友訊元富98購01  ,0,0,0,0,0,0,0,0,0,348000,0,0,0,428000,80000,348000,348000
058876,南電國票9A購02  ,0,0,0,0,0,0,0,0,0,348000,0,0,0,348000,0,348000,348000
8464,億豐            ,787417,421380,366037,0,0,0,0,0,0,-19000,0,19000,-19000,1000,1000,0,347037
060623,玉晶光元大9C購01,0,0,0,0,0,0,0,0,0,347000,0,0,0,372000,25000,347000,347000
060915,旭富元大9A購01  ,0,0,0,0,0,0,0,0,0,345000,0,0,0,345000,0,345000,345000
057670,欣興元大99購02  ,0,0,0,0,0,0,0,0,0,344000,0,0,0,355000,11000,344000,344000
060946,世紀鋼國票9A購02,0,0,0,0,0,0,0,0,0,344000,0,0,0,560000,216000,344000,344000
053865,欣興元大97購02  ,0,0,0,0,0,0,0,0,0,342000,0,0,0,373000,31000,342000,342000
062924,世紀鋼元大9C購04,0,0,0,0,0,0,0,0,0,341000,0,0,0,455000,114000,341000,341000
062379,致新元大9B購01  ,0,0,0,0,0,0,0,0,0,341000,0,0,0,362000,21000,341000,341000
056618,京元電永豐98購01,0,0,0,0,0,0,0,0,0,341000,0,0,0,361000,20000,341000,341000
057289,力成元大98購03  ,0,0,0,0,0,0,0,0,0,341000,0,0,0,341000,0,341000,341000
053754,英業達元富96購02,0,0,0,0,0,0,0,0,0,340000,0,0,0,340000,0,340000,340000
054096,佳世達國票97購01,0,0,0,0,0,0,0,0,0,340000,0,0,0,340000,0,340000,340000
059656,T50反1元大99購11,0,0,0,0,0,0,0,0,0,340000,0,0,0,360000,20000,340000,340000
058531,華通元富99購01  ,0,0,0,0,0,0,0,0,0,339000,0,0,0,340000,1000,339000,339000
062463,世紀鋼麥證9B購01,0,0,0,338000,0,338000,0,0,0,338000,0,0,0,338000,0,338000,338000
06847P,奇力新元大98售05,0,0,0,0,0,0,0,0,0,338000,0,0,0,357000,19000,338000,338000
059274,國巨元大99購22  ,0,0,0,0,0,0,0,0,0,336000,0,0,0,336000,0,336000,336000
062062,貿聯統一01購01  ,0,0,0,0,0,0,0,0,0,335000,0,0,0,644000,309000,335000,335000
052838,新唐國泰98購01  ,0,0,0,0,0,0,0,0,0,335000,0,0,0,355000,20000,335000,335000
06939P,國巨永豐98售09  ,0,0,0,0,0,0,0,0,0,334000,0,0,0,336000,2000,334000,334000
063148,建準元富9B購01  ,0,0,0,0,0,0,0,0,0,333000,0,0,0,345000,12000,333000,333000
061484,華通兆豐9B購01  ,0,0,0,0,0,0,0,0,0,333000,0,0,0,333000,0,333000,333000
062731,力成凱基9B購02  ,0,0,0,0,0,0,0,0,0,333000,0,0,0,343000,10000,333000,333000
063227,祥碩群益9B購06  ,0,0,0,0,0,0,0,0,0,332000,0,0,0,367000,35000,332000,332000
07576P,可成元大9A售01  ,0,0,0,0,0,0,0,0,0,330000,0,0,0,330000,0,330000,330000
06240P,奇力新元富97售03,0,0,0,0,0,0,0,0,0,329000,0,0,0,336000,7000,329000,329000
08108P,聯發科元富9B售03,0,0,0,0,0,0,0,0,0,329000,0,0,0,329000,0,329000,329000
3673,TPK-KY          ,711000,427000,284000,0,0,0,0,0,0,45000,10000,24000,-14000,91000,32000,59000,329000
5305,敦南            ,2252000,1976000,276000,0,0,0,0,0,0,52000,52000,0,52000,0,0,0,328000
07392P,台積電國泰02售01,0,0,0,0,0,0,0,0,0,328000,0,0,0,328000,0,328000,328000
061658,聯茂富邦9A購03  ,0,0,0,0,0,0,0,0,0,327000,0,0,0,329000,2000,327000,327000
060816,世紀鋼凱基9C購02,0,0,0,0,0,0,0,0,0,326000,0,0,0,417000,91000,326000,326000
059560,T50反1凱基99購08,0,0,0,0,0,0,0,0,0,325000,0,0,0,325000,0,325000,325000
063151,奇鋐元富9B購01  ,0,0,0,0,0,0,0,0,0,324000,0,0,0,410000,86000,324000,324000
063348,祥碩統一01購04  ,0,0,0,0,0,0,0,0,0,323000,0,0,0,323000,0,323000,323000
2347,聯強            ,6717215,6990000,-272785,0,0,0,400000,0,400000,195000,142000,5000,137000,58000,0,58000,322215
062560,奇鋐凱基9B購02  ,0,0,0,0,0,0,0,0,0,322000,0,0,0,337000,15000,322000,322000
062647,南電國泰9C購02  ,0,0,0,0,0,0,0,0,0,321000,0,0,0,473000,152000,321000,321000
061642,創意元大9A購04  ,0,0,0,0,0,0,0,0,0,321000,0,0,0,581000,260000,321000,321000
054994,建準元富97購01  ,0,0,0,0,0,0,0,0,0,321000,0,0,0,321000,0,321000,321000
063336,大成鋼統一9C購02,0,0,0,0,0,0,0,0,0,320000,0,0,0,390000,70000,320000,320000
055730,建準元富97購02  ,0,0,0,0,0,0,0,0,0,320000,0,0,0,354000,34000,320000,320000
052061,樺漢國票96購01  ,0,0,0,0,0,0,0,0,0,320000,0,0,0,320000,0,320000,320000
048745,儒鴻元富97購02  ,0,0,0,0,0,0,0,0,0,320000,0,0,0,320000,0,320000,320000
058525,台虹元大99購02  ,0,0,0,0,0,0,0,0,0,320000,0,0,0,416000,96000,320000,320000
058270,上緯控永豐99購01,0,0,0,0,0,0,0,0,0,320000,0,0,0,375000,55000,320000,320000
063196,力成元富9B購01  ,0,0,0,0,0,0,0,0,0,319000,0,0,0,329000,10000,319000,319000
063272,GIS兆豐9C購01   ,0,0,0,0,0,0,0,0,0,317000,0,0,0,369000,52000,317000,317000
056909,嘉聯益元大99購03,0,0,0,0,0,0,0,0,0,317000,0,0,0,403000,86000,317000,317000
060513,緯穎元大9B購01  ,0,0,0,0,0,0,0,0,0,317000,0,0,0,423000,106000,317000,317000
059358,旺宏永豐99購02  ,0,0,0,0,0,0,0,0,0,317000,0,0,0,332000,15000,317000,317000
058290,南電國票9A購01  ,0,0,0,0,0,0,0,0,0,315000,0,0,0,315000,0,315000,315000
3035,智原            ,868000,637000,231000,0,0,0,0,0,0,84000,17000,2000,15000,81000,12000,69000,315000
062273,國巨群益9C購02  ,0,0,0,0,0,0,0,0,0,314000,0,0,0,314000,0,314000,314000
061044,世紀鋼永豐9A購02,0,0,0,0,0,0,0,0,0,314000,0,0,0,356000,42000,314000,314000
061168,力成兆豐9A購01  ,0,0,0,0,0,0,0,0,0,313000,0,0,0,447000,134000,313000,313000
061432,世紀鋼元大9A購05,0,0,0,0,0,0,0,0,0,312000,0,0,0,365000,53000,312000,312000
059928,道瓊銀富邦03購01,0,0,0,0,0,0,0,0,0,312000,0,0,0,312000,0,312000,312000
06626P,大立光統一9A售01,0,0,0,0,0,0,0,0,0,310000,0,0,0,310000,0,310000,310000
06010P,國泰金元富96售01,0,0,0,0,0,0,0,0,0,309000,0,0,0,350000,41000,309000,309000
061013,台積電麥證9A購03,0,0,0,309000,0,309000,0,0,0,309000,0,0,0,309000,0,309000,309000
058468,聯茂中信99購02  ,0,0,0,0,0,0,0,0,0,309000,0,0,0,309000,0,309000,309000
063176,南亞科兆豐9B購01,0,0,0,0,0,0,0,0,0,308000,0,0,0,318000,10000,308000,308000
062498,華通群益9C購04  ,0,0,0,0,0,0,0,0,0,308000,0,0,0,434000,126000,308000,308000
055798,聯茂富邦98購01  ,0,0,0,0,0,0,0,0,0,308000,0,0,0,308000,0,308000,308000
062491,矽創永豐9B購01  ,0,0,0,0,0,0,0,0,0,307000,0,0,0,307000,0,307000,307000
07536P,華新科元富9A售04,0,0,0,0,0,0,0,0,0,306000,0,0,0,306000,0,306000,306000
055877,奇鋐元富97購01  ,0,0,0,0,0,0,0,0,0,305000,0,0,0,393000,88000,305000,305000
056191,世紀鋼統一97購01,0,0,0,0,0,0,0,0,0,305000,0,0,0,305000,0,305000,305000
056121,勤誠群益97購01  ,0,0,0,0,0,0,0,0,0,303000,0,0,0,500000,197000,303000,303000
062487,中興電永豐9B購01,0,0,0,0,0,0,0,0,0,302000,0,0,0,312000,10000,302000,302000
060978,國巨元大9A購13  ,0,0,0,0,0,0,0,0,0,302000,0,0,0,303000,1000,302000,302000
062681,全新統一01購01  ,0,0,0,0,0,0,0,0,0,301000,0,0,0,301000,0,301000,301000
058344,旺宏群益99購05  ,0,0,0,0,0,0,0,0,0,301000,0,0,0,301000,0,301000,301000
060162,碩天永豐9A購01  ,0,0,0,0,0,0,0,0,0,301000,0,0,0,351000,50000,301000,301000
07864P,可成元大9B售01  ,0,0,0,0,0,0,0,0,0,301000,0,0,0,301000,0,301000,301000
057798,貿聯兆豐99購01  ,0,0,0,0,0,0,0,0,0,300000,0,0,0,425000,125000,300000,300000
060534,友達麥證9A購01  ,0,0,0,300000,0,300000,0,0,0,300000,0,0,0,300000,0,300000,300000
059385,滬深2X凱基9C購03,0,0,0,0,0,0,0,0,0,300000,0,0,0,300000,0,300000,300000
07263P,台積電元大99售37,0,0,0,0,0,0,0,0,0,300000,0,0,0,899000,599000,300000,300000
062597,世紀鋼統一01購01,0,0,0,0,0,0,0,0,0,299000,0,0,0,442000,143000,299000,299000
051730,為升國票96購02  ,0,0,0,0,0,0,0,0,0,299000,0,0,0,299000,0,299000,299000
07459P,緯穎元大9A售01  ,0,0,0,0,0,0,0,0,0,299000,0,0,0,587000,288000,299000,299000
063347,祥碩統一01購03  ,0,0,0,0,0,0,0,0,0,298000,0,0,0,298000,0,298000,298000
054567,拓凱群益98購01  ,0,0,0,0,0,0,0,0,0,298000,0,0,0,340000,42000,298000,298000
07407P,欣興凱基99售07  ,0,0,0,0,0,0,0,0,0,298000,0,0,0,818000,520000,298000,298000
060732,玉晶光群益9C購02,0,0,0,0,0,0,0,0,0,298000,0,0,0,298000,0,298000,298000
05240P,玉晶光永豐96售01,0,0,0,0,0,0,0,0,0,297000,0,0,0,297000,0,297000,297000
058328,世紀鋼統一9B購01,0,0,0,0,0,0,0,0,0,297000,0,0,0,430000,133000,297000,297000
063454,瑞儀統一9B購01  ,0,0,0,0,0,0,0,0,0,296000,0,0,0,296000,0,296000,296000
059042,世紀鋼群益99購02,0,0,0,0,0,0,0,0,0,296000,0,0,0,306000,10000,296000,296000
062908,晶豪科元大9B購03,0,0,0,0,0,0,0,0,0,293000,0,0,0,406000,113000,293000,293000
055235,金寶台新98購01  ,0,0,0,0,0,0,0,0,0,293000,0,0,0,493000,200000,293000,293000
06004P,奇力新永豐96售02,0,0,0,0,0,0,0,0,0,293000,0,0,0,301000,8000,293000,293000
06763P,技嘉元大98售05  ,0,0,0,0,0,0,0,0,0,292000,0,0,0,292000,0,292000,292000
061583,矽創元大9A購01  ,0,0,0,0,0,0,0,0,0,292000,0,0,0,449000,157000,292000,292000
057717,友訊元富98購02  ,0,0,0,0,0,0,0,0,0,292000,0,0,0,390000,98000,292000,292000
4551,智伸科          ,440000,125000,315000,0,0,0,0,25000,-25000,2000,2000,9000,-7000,14000,5000,9000,292000
062049,亞德客統一01購01,0,0,0,0,0,0,0,0,0,291000,0,0,0,913000,622000,291000,291000
9914,美利達          ,1037000,690746,346254,0,0,0,0,50000,-50000,-6000,8000,14000,-6000,0,0,0,290254
060327,美律群益9A購02  ,0,0,0,0,0,0,0,0,0,290000,0,0,0,296000,6000,290000,290000
059944,欣興永豐99購03  ,0,0,0,0,0,0,0,0,0,289000,0,0,0,302000,13000,289000,289000
062143,大成鋼國票9B購01,0,0,0,0,0,0,0,0,0,288000,0,0,0,288000,0,288000,288000
061156,玉晶光群益9A購07,0,0,0,0,0,0,0,0,0,288000,0,0,0,293000,5000,288000,288000
062266,世紀鋼元大9B購02,0,0,0,0,0,0,0,0,0,287000,0,0,0,309000,22000,287000,287000
062408,致新永豐9B購01  ,0,0,0,0,0,0,0,0,0,287000,0,0,0,300000,13000,287000,287000
060254,世紀鋼元大9A購01,0,0,0,0,0,0,0,0,0,287000,0,0,0,287000,0,287000,287000
057747,致新永豐98購01  ,0,0,0,0,0,0,0,0,0,287000,0,0,0,287000,0,287000,287000
060258,T50反1凱基9A購06,0,0,0,0,0,0,0,0,0,286000,0,0,0,286000,0,286000,286000
057197,立積台新98購01  ,0,0,0,0,0,0,0,0,0,286000,0,0,0,483000,197000,286000,286000
054835,致新中信97購01  ,0,0,0,0,0,0,0,0,0,285000,0,0,0,303000,18000,285000,285000
061899,復盛永豐9B購01  ,0,0,0,0,0,0,0,0,0,284000,0,0,0,336000,52000,284000,284000
056849,瀚宇博元富98購01,0,0,0,0,0,0,0,0,0,284000,0,0,0,464000,180000,284000,284000
056463,台虹凱基98購02  ,0,0,0,0,0,0,0,0,0,283000,0,0,0,465000,182000,283000,283000
06624P,訊芯元大98售06  ,0,0,0,0,0,0,0,0,0,282000,0,0,0,300000,18000,282000,282000
056288,健鼎永豐97購01  ,0,0,0,0,0,0,0,0,0,282000,0,0,0,282000,0,282000,282000
059924,世紀鋼元大99購06,0,0,0,0,0,0,0,0,0,282000,0,0,0,302000,20000,282000,282000
03414B,臺股指凱基99熊01,50000,50000,0,0,0,0,0,0,0,282000,0,0,0,384000,102000,282000,282000
3705,永信            ,863000,669000,194000,0,0,0,0,0,0,87000,87000,0,87000,0,0,0,281000
06594P,立積元大98售01  ,0,0,0,0,0,0,0,0,0,280000,0,0,0,280000,0,280000,280000
055736,宏達電元富99購01,0,0,0,0,0,0,0,0,0,280000,0,0,0,290000,10000,280000,280000
055196,致新元富97購01  ,0,0,0,0,0,0,0,0,0,280000,0,0,0,415000,135000,280000,280000
2707,晶華            ,361000,81000,280000,0,0,0,0,0,0,0,0,0,0,0,0,0,280000
055725,嘉聯益元大98購03,0,0,0,0,0,0,0,0,0,279000,0,0,0,279000,0,279000,279000
05923P,旺宏元富96售05  ,0,0,0,0,0,0,0,0,0,278000,0,0,0,309000,31000,278000,278000
062393,智邦富邦9B購01  ,0,0,0,0,0,0,0,0,0,275000,0,0,0,626000,351000,275000,275000
061358,世紀鋼元大9A購04,0,0,0,0,0,0,0,0,0,275000,0,0,0,400000,125000,275000,275000
6670,復盛應用        ,348000,146000,202000,0,0,0,128000,0,128000,-55000,20000,66000,-46000,1000,10000,-9000,275000
054803,味全元大9A購01  ,0,0,0,0,0,0,0,0,0,273000,0,0,0,368000,95000,273000,273000
060766,世芯元大9A購02  ,0,0,0,0,0,0,0,0,0,271000,0,0,0,279000,8000,271000,271000
6416,瑞祺電通        ,357000,72000,285000,0,0,0,0,0,0,-14000,52000,17000,35000,27000,76000,-49000,271000
07591P,台灣50元大9A售16,0,0,0,0,0,0,0,0,0,271000,0,0,0,271000,0,271000,271000
055442,矽創國票98購02  ,0,0,0,0,0,0,0,0,0,269000,0,0,0,396000,127000,269000,269000
058405,訊連元大99購02  ,0,0,0,0,0,0,0,0,0,268000,0,0,0,268000,0,268000,268000
057439,元油2X統一99購02,0,0,0,0,0,0,0,0,0,268000,0,0,0,268000,0,268000,268000
062534,力成統一01購01  ,0,0,0,0,0,0,0,0,0,266000,0,0,0,271000,5000,266000,266000
061456,玉晶光凱基9B購05,0,0,0,0,0,0,0,0,0,266000,0,0,0,271000,5000,266000,266000
055703,緯穎富邦98購01  ,0,0,0,0,0,0,0,0,0,265000,0,0,0,318000,53000,265000,265000
07976P,聯發科群益9C售02,0,0,0,0,0,0,0,0,0,265000,0,0,0,320000,55000,265000,265000
2454,聯發科          ,5971397,6131558,-160161,0,0,0,217000,6000,211000,213000,142000,52000,90000,139000,16000,123000,263839
07304P,臺股指元大9A售37,0,0,0,0,0,0,0,0,0,263000,0,0,0,463000,200000,263000,263000
3653,健策            ,1146000,952000,194000,0,0,0,42000,90000,-48000,117000,22000,34000,-12000,195000,66000,129000,263000
057119,微星康和98購01  ,0,0,0,0,0,0,0,0,0,262000,0,0,0,262000,0,262000,262000
05242P,群創國泰97售01  ,0,0,0,0,0,0,0,0,0,262000,0,0,0,263000,1000,262000,262000
061373,華通富邦9A購02  ,0,0,0,0,0,0,0,0,0,261000,0,0,0,521000,260000,261000,261000
06869P,金融類元大99售01,0,0,0,0,0,0,0,0,0,260000,0,0,0,260000,0,260000,260000
061433,華通麥證9A購03  ,0,0,0,268000,10000,258000,0,0,0,258000,0,0,0,268000,10000,258000,258000
062214,金寶統一01購01  ,0,0,0,0,0,0,0,0,0,258000,0,0,0,363000,105000,258000,258000
057445,華通元富02購01  ,0,0,0,0,0,0,0,0,0,258000,0,0,0,343000,85000,258000,258000
07506P,中租元大9A售01  ,0,0,0,0,0,0,0,0,0,257000,0,0,0,257000,0,257000,257000
062648,聯茂富邦9B購01  ,0,0,0,0,0,0,0,0,0,256000,0,0,0,320000,64000,256000,256000
07334P,臺股指國票99售19,0,0,0,0,0,0,0,0,0,256000,0,0,0,261000,5000,256000,256000
058147,鈺齊元大99購01  ,0,0,0,0,0,0,0,0,0,255000,0,0,0,265000,10000,255000,255000
00634R,富邦上証反1     ,352000,0,352000,0,0,0,0,0,0,-98000,0,0,0,312000,410000,-98000,254000
07816P,聯發科群益9A售02,0,0,0,0,0,0,0,0,0,254000,0,0,0,259000,5000,254000,254000
057719,欣興元富02購01  ,0,0,0,0,0,0,0,0,0,254000,0,0,0,318000,64000,254000,254000
061578,玉晶光元大9A購16,0,0,0,0,0,0,0,0,0,253000,0,0,0,255000,2000,253000,253000
061640,智原元大9A購01  ,0,0,0,0,0,0,0,0,0,253000,0,0,0,544000,291000,253000,253000
059461,鈺齊永豐99購03  ,0,0,0,0,0,0,0,0,0,253000,0,0,0,255000,2000,253000,253000
4133,亞諾法          ,2076000,1816000,260000,0,0,0,0,0,0,-7000,0,7000,-7000,0,0,0,253000
6230,超眾            ,467000,239000,228000,0,0,0,0,0,0,24000,0,2000,-2000,67000,41000,26000,252000
057307,瀚宇博兆豐99購01,0,0,0,0,0,0,0,0,0,251000,0,0,0,575000,324000,251000,251000
07592P,台灣50元大9A售17,0,0,0,0,0,0,0,0,0,251000,0,0,0,251000,0,251000,251000
06465P,國巨統一98售04  ,0,0,0,0,0,0,0,0,0,250000,0,0,0,488000,238000,250000,250000
056381,台虹元富98購01  ,0,0,0,0,0,0,0,0,0,250000,0,0,0,450000,200000,250000,250000
06047P,聯發科富邦99售04,0,0,0,0,0,0,0,0,0,250000,0,0,0,258000,8000,250000,250000
059375,道瓊反群益9C購02,0,0,0,0,0,0,0,0,0,250000,0,0,0,261000,11000,250000,250000
060688,世紀鋼元大9C購01,0,0,0,0,0,0,0,0,0,250000,0,0,0,276000,26000,250000,250000
8150,南茂            ,1052000,1507000,-455000,0,0,0,550000,0,550000,155000,149000,0,149000,36000,30000,6000,250000
060962,義隆凱基9B購01  ,0,0,0,0,0,0,0,0,0,250000,0,0,0,632000,382000,250000,250000
00638R,元大滬深300反1  ,0,0,0,0,0,0,0,0,0,249000,809000,0,809000,507000,1067000,-560000,249000
1439,中和            ,257000,9000,248000,0,0,0,0,0,0,0,0,0,0,0,0,0,248000
060967,鈺齊凱基9A購02  ,0,0,0,0,0,0,0,0,0,247000,0,0,0,290000,43000,247000,247000
2412,中華電          ,14420991,14131450,289541,0,0,0,0,0,0,-43000,10000,52000,-42000,0,1000,-1000,246541
061192,奇鋐永豐9A購01  ,0,0,0,0,0,0,0,0,0,246000,0,0,0,246000,0,246000,246000
3533,嘉澤            ,681330,333226,348104,0,0,0,0,121000,-121000,18000,48000,34000,14000,12000,8000,4000,245104
054471,T50反1中信9C購01,0,0,0,0,0,0,0,0,0,245000,0,0,0,250000,5000,245000,245000
08015P,可成凱基9B售05  ,0,0,0,0,0,0,0,0,0,245000,0,0,0,245000,0,245000,245000
05982P,漢唐國票96售03  ,0,0,0,0,0,0,0,0,0,244000,0,0,0,304000,60000,244000,244000
03443B,臺股指凱基9A熊27,4000,0,4000,0,0,0,0,0,0,239000,0,0,0,1731000,1492000,239000,243000
062165,聯茂國泰01購01  ,0,0,0,0,0,0,0,0,0,242000,0,0,0,697000,455000,242000,242000
059995,南亞科元富99購01,0,0,0,0,0,0,0,0,0,242000,0,0,0,274000,32000,242000,242000
07819P,旺宏國票9B售01  ,0,0,0,0,0,0,0,0,0,241000,0,0,0,365000,124000,241000,241000
058385,創意中信99購01  ,0,0,0,0,0,0,0,0,0,241000,0,0,0,276000,35000,241000,241000
058329,S&P正2元富01購01,0,0,0,0,0,0,0,0,0,241000,0,0,0,241000,0,241000,241000
061418,世紀鋼群益9A購02,0,0,0,0,0,0,0,0,0,240000,0,0,0,748000,508000,240000,240000
052750,臺股指元大96購04,0,0,0,0,0,0,0,0,0,240000,0,0,0,240000,0,240000,240000
062184,奇鋐元大9B購02  ,0,0,0,0,0,0,0,0,0,239000,0,0,0,269000,30000,239000,239000
062743,微星國泰01購01  ,0,0,0,0,0,0,0,0,0,239000,0,0,0,366000,127000,239000,239000
8011,台通            ,301000,62000,239000,0,0,0,0,0,0,0,0,0,0,0,0,0,239000
06168P,台表科國票97售06,0,0,0,0,0,0,0,0,0,238000,0,0,0,238000,0,238000,238000
061907,裕隆中信9B購01  ,0,0,0,0,0,0,0,0,0,238000,0,0,0,391000,153000,238000,238000
06619P,聯發科元大98售06,0,0,0,0,0,0,0,0,0,238000,0,0,0,793000,555000,238000,238000
00631L,元大台灣50正2   ,781000,986000,-205000,0,0,0,0,0,0,443000,275000,0,275000,802000,634000,168000,238000
056127,致新國票98購02  ,0,0,0,0,0,0,0,0,0,238000,0,0,0,361000,123000,238000,238000
056098,矽創元富97購02  ,0,0,0,0,0,0,0,0,0,238000,0,0,0,385000,147000,238000,238000
060170,世紀鋼永豐9A購01,0,0,0,0,0,0,0,0,0,237000,0,0,0,237000,0,237000,237000
062890,祥碩群益9B購04  ,0,0,0,0,0,0,0,0,0,236000,0,0,0,469000,233000,236000,236000
057647,欣興元大98購10  ,0,0,0,0,0,0,0,0,0,236000,0,0,0,282000,46000,236000,236000
07804P,美律永豐9A售02  ,0,0,0,0,0,0,0,0,0,236000,0,0,0,236000,0,236000,236000
056488,致新元大99購01  ,0,0,0,0,0,0,0,0,0,235000,0,0,0,300000,65000,235000,235000
058498,世紀鋼群益99購01,0,0,0,0,0,0,0,0,0,235000,0,0,0,242000,7000,235000,235000
058761,欣興群益99購02  ,0,0,0,0,0,0,0,0,0,235000,0,0,0,237000,2000,235000,235000
060366,健策元富9A購01  ,0,0,0,0,0,0,0,0,0,235000,0,0,0,235000,0,235000,235000
060388,世紀鋼凱基9B購01,0,0,0,0,0,0,0,0,0,235000,0,0,0,368000,133000,235000,235000
07319P,台積電凱基01售02,0,0,0,0,0,0,0,0,0,235000,0,0,0,235000,0,235000,235000
058725,美律富邦9A購01  ,0,0,0,0,0,0,0,0,0,234000,0,0,0,366000,132000,234000,234000
07130P,台郡元大9B售01  ,0,0,0,0,0,0,0,0,0,233000,0,0,0,253000,20000,233000,233000
057649,嘉聯益元大99購04,0,0,0,0,0,0,0,0,0,232000,0,0,0,302000,70000,232000,232000
07634P,金像電元大9A售01,0,0,0,0,0,0,0,0,0,232000,0,0,0,463000,231000,232000,232000
054970,帆宣元大97購01  ,0,0,0,0,0,0,0,0,0,231000,0,0,0,231000,0,231000,231000
054527,國巨統一97購03  ,0,0,0,0,0,0,0,0,0,231000,0,0,0,325000,94000,231000,231000
07535P,上銀元富9A售03  ,0,0,0,0,0,0,0,0,0,231000,0,0,0,336000,105000,231000,231000
6452,康友-KY         ,325000,101000,224000,0,0,0,0,0,0,7000,0,1000,-1000,11000,3000,8000,231000
061917,亞德客凱基9B購02,0,0,0,0,0,0,0,0,0,230000,0,0,0,395000,165000,230000,230000
05859P,台表科國票97售04,0,0,0,0,0,0,0,0,0,230000,0,0,0,273000,43000,230000,230000
057327,玉晶光群益9A購04,0,0,0,0,0,0,0,0,0,229000,0,0,0,232000,3000,229000,229000
059976,道瓊銀元大99購01,0,0,0,0,0,0,0,0,0,228000,0,0,0,245000,17000,228000,228000
8110,華東            ,288000,60000,228000,0,0,0,0,0,0,0,8000,8000,0,0,0,0,228000
06150P,奇力新元大97售06,0,0,0,0,0,0,0,0,0,227000,0,0,0,422000,195000,227000,227000
06262P,國巨凱基97售07  ,0,0,0,0,0,0,0,0,0,227000,0,0,0,238000,11000,227000,227000
07102P,南電元大99售03  ,0,0,0,0,0,0,0,0,0,227000,0,0,0,282000,55000,227000,227000
062935,華通凱基9C購02  ,0,0,0,0,0,0,0,0,0,227000,0,0,0,256000,29000,227000,227000
053630,奇鋐兆豐97購01  ,0,0,0,0,0,0,0,0,0,227000,0,0,0,292000,65000,227000,227000
00850,元大臺灣ESG永續 ,0,0,0,0,0,0,0,0,0,227000,0,0,0,928000,701000,227000,227000
4766,南寶            ,285000,57000,228000,0,0,0,0,0,0,-2000,0,2000,-2000,0,0,0,226000
07478P,南電康和9A售02  ,0,0,0,0,0,0,0,0,0,226000,0,0,0,226000,0,226000,226000
4958,臻鼎-KY         ,4426146,4470503,-44357,0,0,0,253000,0,253000,17000,65000,58000,7000,23000,13000,10000,225643
07210P,智邦凱基99售03  ,0,0,0,0,0,0,0,0,0,225000,0,0,0,245000,20000,225000,225000
062033,瀚宇博群益9B購01,0,0,0,0,0,0,0,0,0,224000,0,0,0,363000,139000,224000,224000
07774P,台灣50群益9A售16,0,0,0,0,0,0,0,0,0,224000,0,0,0,1224000,1000000,224000,224000
2467,志聖            ,980000,756000,224000,0,0,0,0,0,0,0,0,0,0,0,0,0,224000
3557,嘉威            ,613000,389000,224000,0,0,0,0,0,0,0,0,0,0,0,0,0,224000
9802,鈺齊-KY         ,1191000,787000,404000,0,0,0,0,50000,-50000,-130000,10000,51000,-41000,2000,91000,-89000,224000
03680C,臺股指凱基9A牛26,0,0,0,0,0,0,0,0,0,223000,0,0,0,502000,279000,223000,223000
054826,復盛元大9A購01  ,0,0,0,0,0,0,0,0,0,223000,0,0,0,292000,69000,223000,223000
060761,南亞科元大9A購05,0,0,0,0,0,0,0,0,0,223000,0,0,0,240000,17000,223000,223000
060733,和大統一9C購01  ,0,0,0,0,0,0,0,0,0,223000,0,0,0,223000,0,223000,223000
07906P,中租群益9B售02  ,0,0,0,0,0,0,0,0,0,223000,0,0,0,223000,0,223000,223000
062089,矽創元大9B購02  ,0,0,0,0,0,0,0,0,0,222000,0,0,0,360000,138000,222000,222000
062830,玉晶光群益01購05,0,0,0,0,0,0,0,0,0,222000,0,0,0,277000,55000,222000,222000
06921P,台光電凱基98售06,0,0,0,0,0,0,0,0,0,222000,0,0,0,222000,0,222000,222000
058664,百和兆豐99購01  ,0,0,0,0,0,0,0,0,0,222000,0,0,0,233000,11000,222000,222000
060159,健和興永豐9A購01,0,0,0,0,0,0,0,0,0,222000,0,0,0,226000,4000,222000,222000
07776P,國巨群益9B售02  ,0,0,0,0,0,0,0,0,0,221000,0,0,0,221000,0,221000,221000
1325,恆大            ,224000,7000,217000,0,0,0,10000,0,10000,-6000,2000,14000,-12000,6000,0,6000,221000
8462,柏文            ,286000,49000,237000,0,0,0,0,0,0,-16000,0,14000,-14000,0,2000,-2000,221000
061631,SP黃豆元大9A購05,0,0,0,0,0,0,0,0,0,220000,0,0,0,220000,0,220000,220000
2357,華碩            ,3171289,2946136,225153,0,0,0,0,0,0,-7000,0,15000,-15000,8000,0,8000,218153
054755,世紀鋼凱基98購01,0,0,0,0,0,0,0,0,0,218000,0,0,0,262000,44000,218000,218000
054972,聯茂元大97購02  ,0,0,0,0,0,0,0,0,0,218000,0,0,0,218000,0,218000,218000
062665,智易群益9B購01  ,0,0,0,0,0,0,0,0,0,217000,0,0,0,217000,0,217000,217000
062888,漢唐群益9B購01  ,0,0,0,0,0,0,0,0,0,217000,0,0,0,261000,44000,217000,217000
058424,滬深2X元富99購04,0,0,0,0,0,0,0,0,0,217000,0,0,0,279000,62000,217000,217000
061379,鈺齊永豐9A購02  ,0,0,0,0,0,0,0,0,0,217000,0,0,0,232000,15000,217000,217000
061195,健策永豐9B購02  ,0,0,0,0,0,0,0,0,0,216000,0,0,0,269000,53000,216000,216000
057356,彩晶統一98購04  ,0,0,0,0,0,0,0,0,0,216000,0,0,0,216000,0,216000,216000
057231,美律凱基98購05  ,0,0,0,0,0,0,0,0,0,215000,0,0,0,235000,20000,215000,215000
06338P,亞德客統一97售02,0,0,0,0,0,0,0,0,0,214000,0,0,0,577000,363000,214000,214000
056641,華通凱基98購03  ,0,0,0,0,0,0,0,0,0,214000,0,0,0,214000,0,214000,214000
6278,台表科          ,3021000,1264000,1757000,0,0,0,0,603000,-603000,-940000,253000,1181000,-928000,38000,50000,-12000,214000
2823,中壽            ,9830610,10732728,-902118,0,0,0,1306000,2000,1304000,-188000,0,0,0,0,188000,-188000,213882
07022P,嘉晶永豐99售02  ,0,0,0,0,0,0,0,0,0,213000,0,0,0,254000,41000,213000,213000
061532,和大統一9C購02  ,0,0,0,0,0,0,0,0,0,213000,0,0,0,223000,10000,213000,213000
00739,元大MSCI A股    ,1000,1000,0,0,0,0,0,0,0,213000,0,0,0,912000,699000,213000,213000
060057,欣興凱基9B購01  ,0,0,0,0,0,0,0,0,0,213000,0,0,0,219000,6000,213000,213000
061625,聯茂群益9A購02  ,0,0,0,0,0,0,0,0,0,212000,0,0,0,277000,65000,212000,212000
061592,義隆永豐9A購03  ,0,0,0,0,0,0,0,0,0,212000,0,0,0,287000,75000,212000,212000
062467,國巨凱基9B購08  ,0,0,0,0,0,0,0,0,0,212000,0,0,0,250000,38000,212000,212000
07825P,健策國泰9B售04  ,0,0,0,0,0,0,0,0,0,212000,0,0,0,217000,5000,212000,212000
07847P,國巨群益9A售13  ,0,0,0,0,0,0,0,0,0,212000,0,0,0,212000,0,212000,212000
061553,南電群益9A購03  ,0,0,0,0,0,0,0,0,0,211000,0,0,0,211000,0,211000,211000
2439,美律            ,633000,416000,217000,0,0,0,0,0,0,-6000,2000,25000,-23000,33000,16000,17000,211000
055515,聚陽中信9A購01  ,0,0,0,0,0,0,0,0,0,210000,0,0,0,210000,0,210000,210000
058838,國巨中信99購03  ,0,0,0,0,0,0,0,0,0,210000,0,0,0,380000,170000,210000,210000
05272P,臻鼎中信97售03  ,0,0,0,0,0,0,0,0,0,208000,0,0,0,210000,2000,208000,208000
061375,華通永豐9A購02  ,0,0,0,0,0,0,0,0,0,208000,0,0,0,208000,0,208000,208000
07023P,南電永豐99售02  ,0,0,0,0,0,0,0,0,0,207000,0,0,0,207000,0,207000,207000
06492P,上銀永豐98售01  ,0,0,0,0,0,0,0,0,0,207000,0,0,0,209000,2000,207000,207000
062916,智易元大9B購01  ,0,0,0,0,0,0,0,0,0,207000,0,0,0,235000,28000,207000,207000
058523,聯茂元大99購08  ,0,0,0,0,0,0,0,0,0,207000,0,0,0,304000,97000,207000,207000
059474,元石油群益99購01,0,0,0,0,0,0,0,0,0,207000,0,0,0,208000,1000,207000,207000
07060P,台表科國票9A售01,0,0,0,0,0,0,0,0,0,206000,0,0,0,300000,94000,206000,206000
053694,創意元大96購03  ,0,0,0,0,0,0,0,0,0,205000,0,0,0,205000,0,205000,205000
3450,聯鈞            ,545000,396000,149000,0,0,0,0,0,0,56000,0,0,0,79000,23000,56000,205000
4968,立積            ,1244000,1513000,-269000,0,0,0,170000,0,170000,304000,100000,5000,95000,239000,30000,209000,205000
2323,中環            ,1316000,1884851,-568851,0,0,0,0,0,0,773000,662000,3000,659000,171000,57000,114000,204149
07146P,瑞昱元大99售02  ,0,0,0,0,0,0,0,0,0,204000,0,0,0,204000,0,204000,204000
062775,大成鋼元大9B購02,0,0,0,0,0,0,0,0,0,204000,0,0,0,278000,74000,204000,204000
062503,玉晶光群益01購03,0,0,0,0,0,0,0,0,0,204000,0,0,0,209000,5000,204000,204000
062578,超眾群益9B購01  ,0,0,0,0,0,0,0,0,0,204000,0,0,0,204000,0,204000,204000
07574P,國巨元大9A售12  ,0,0,0,0,0,0,0,0,0,204000,0,0,0,208000,4000,204000,204000
062183,奇鋐元大9B購01  ,0,0,0,0,0,0,0,0,0,203000,0,0,0,203000,0,203000,203000
056791,嘉聯益群益98購01,0,0,0,0,0,0,0,0,0,202000,0,0,0,339000,137000,202000,202000
08094P,華新科元富9B售05,0,0,0,0,0,0,0,0,0,202000,0,0,0,202000,0,202000,202000
055451,台積電元富97購02,0,0,0,0,0,0,0,0,0,201000,0,0,0,201000,0,201000,201000
055648,可成元富97購01  ,0,0,0,0,0,0,0,0,0,201000,0,0,0,201000,0,201000,201000
062662,友達群益9B購02  ,0,0,0,0,0,0,0,0,0,200000,0,0,0,200000,0,200000,200000
07124P,台積電元大99售21,0,0,0,0,0,0,0,0,0,200000,0,0,0,200000,0,200000,200000
06891P,緯穎富邦99售03  ,0,0,0,0,0,0,0,0,0,200000,0,0,0,220000,20000,200000,200000
06516P,國巨凱基98售08  ,0,0,0,0,0,0,0,0,0,200000,0,0,0,200000,0,200000,200000
06389P,聯發科兆豐97售01,0,0,0,0,0,0,0,0,0,200000,0,0,0,200000,0,200000,200000
05545P,台表科國泰98售01,0,0,0,0,0,0,0,0,0,200000,0,0,0,231000,31000,200000,200000
053958,京元電永豐96購01,0,0,0,0,0,0,0,0,0,200000,0,0,0,200000,0,200000,200000
052968,燿華群益98購01  ,0,0,0,0,0,0,0,0,0,200000,0,0,0,200000,0,200000,200000
059647,超眾凱基99購04  ,0,0,0,0,0,0,0,0,0,200000,0,0,0,200000,0,200000,200000
058723,元石油國泰9A購01,0,0,0,0,0,0,0,0,0,200000,0,0,0,200000,0,200000,200000
059043,聯電日盛99購01  ,0,0,0,0,0,0,0,0,0,200000,0,0,0,200000,0,200000,200000
059039,致伸群益99購01  ,0,0,0,0,0,0,0,0,0,200000,0,0,0,288000,88000,200000,200000
07775P,國巨群益9A售10  ,0,0,0,0,0,0,0,0,0,200000,0,0,0,200000,0,200000,200000
07749P,台郡凱基9A售01  ,0,0,0,0,0,0,0,0,0,200000,0,0,0,200000,0,200000,200000
07695P,台郡元大9A售02  ,0,0,0,0,0,0,0,0,0,200000,0,0,0,300000,100000,200000,200000
07577P,華新科元大9A售09,0,0,0,0,0,0,0,0,0,200000,0,0,0,200000,0,200000,200000
07669P,華新科元大9A售14,0,0,0,0,0,0,0,0,0,200000,0,0,0,200000,0,200000,200000
07676P,華新科永豐9A售02,0,0,0,0,0,0,0,0,0,200000,0,0,0,200000,0,200000,200000
07640P,國巨群益9A售07  ,0,0,0,0,0,0,0,0,0,200000,0,0,0,200000,0,200000,200000
060878,奇力新中信9C購01,0,0,0,0,0,0,0,0,0,200000,0,0,0,200000,0,200000,200000
07026P,超眾凱基99售03  ,0,0,0,0,0,0,0,0,0,199000,0,0,0,200000,1000,199000,199000
06962P,華新科永豐99售01,0,0,0,0,0,0,0,0,0,199000,0,0,0,204000,5000,199000,199000
056669,貿聯國票99購01  ,0,0,0,0,0,0,0,0,0,199000,0,0,0,249000,50000,199000,199000
058221,上銀統一99購04  ,0,0,0,0,0,0,0,0,0,199000,0,0,0,199000,0,199000,199000
07394P,國巨群益99售12  ,0,0,0,0,0,0,0,0,0,199000,0,0,0,199000,0,199000,199000
057010,景碩中信98購01  ,0,0,0,0,0,0,0,0,0,198000,0,0,0,198000,0,198000,198000
055835,華邦電元大97購03,0,0,0,0,0,0,0,0,0,198000,0,0,0,198000,0,198000,198000
07494P,葡萄王元大9A售03,0,0,0,0,0,0,0,0,0,198000,0,0,0,268000,70000,198000,198000
2204,中華            ,397000,199000,198000,0,0,0,0,0,0,0,0,0,0,0,0,0,198000
063220,建準群益9B購01  ,0,0,0,0,0,0,0,0,0,197000,0,0,0,300000,103000,197000,197000
055806,致新永豐97購02  ,0,0,0,0,0,0,0,0,0,197000,0,0,0,197000,0,197000,197000
056588,聯發科統一9A購02,0,0,0,0,0,0,0,0,0,197000,0,0,0,247000,50000,197000,197000
07880P,可成群益9B售05  ,0,0,0,0,0,0,0,0,0,197000,0,0,0,197000,0,197000,197000
058245,訊連元大99購01  ,0,0,0,0,0,0,0,0,0,196000,0,0,0,268000,72000,196000,196000
058156,超眾統一9A購02  ,0,0,0,0,0,0,0,0,0,196000,0,0,0,480000,284000,196000,196000
2520,冠德            ,1135000,1015000,120000,0,0,0,0,0,0,76000,114000,34000,80000,0,4000,-4000,196000
061469,瑞祺群益9A購02  ,0,0,0,0,0,0,0,0,0,195000,0,0,0,605000,410000,195000,195000
08002P,大毅國票9B售03  ,0,0,0,0,0,0,0,0,0,195000,0,0,0,276000,81000,195000,195000
08035P,國巨群益9C售04  ,0,0,0,0,0,0,0,0,0,195000,0,0,0,206000,11000,195000,195000
9910,豐泰            ,2221570,2015487,206083,0,0,0,0,0,0,-12000,28000,40000,-12000,0,0,0,194083
06542P,台光電國票98售05,0,0,0,0,0,0,0,0,0,194000,0,0,0,194000,0,194000,194000
062934,大成鋼凱基9B購02,0,0,0,0,0,0,0,0,0,193000,0,0,0,193000,0,193000,193000
061517,瑞祺永豐9A購03  ,0,0,0,0,0,0,0,0,0,193000,0,0,0,361000,168000,193000,193000
062483,致新國票9B購01  ,0,0,0,0,0,0,0,0,0,193000,0,0,0,211000,18000,193000,193000
062091,世紀鋼元大9B購01,0,0,0,0,0,0,0,0,0,193000,0,0,0,431000,238000,193000,193000
062277,廣達群益9B購01  ,0,0,0,0,0,0,0,0,0,193000,0,0,0,203000,10000,193000,193000
00648R,元大S&P500反1   ,0,0,0,0,0,0,0,0,0,193000,0,0,0,396000,203000,193000,193000
051745,玉晶光國泰97購06,0,0,0,0,0,0,0,0,0,193000,0,0,0,195000,2000,193000,193000
07553P,嘉晶元大9A售02  ,0,0,0,0,0,0,0,0,0,193000,0,0,0,216000,23000,193000,193000
062660,神隆群益9B購02  ,0,0,0,0,0,0,0,0,0,192000,0,0,0,248000,56000,192000,192000
059878,聯茂凱基99購07  ,0,0,0,0,0,0,0,0,0,192000,0,0,0,192000,0,192000,192000
060552,群創凱基9B購05  ,0,0,0,0,0,0,0,0,0,192000,0,0,0,202000,10000,192000,192000
07788P,華新科群益9A售08,0,0,0,0,0,0,0,0,0,192000,0,0,0,192000,0,192000,192000
061956,和大統一01購01  ,0,0,0,0,0,0,0,0,0,191000,0,0,0,196000,5000,191000,191000
062862,瑞儀國票9B購01  ,0,0,0,0,0,0,0,0,0,191000,0,0,0,252000,61000,191000,191000
6443,元晶            ,232000,41000,191000,0,0,0,0,0,0,0,0,0,0,0,0,0,191000
061478,奇鋐元大9A購01  ,0,0,0,0,0,0,0,0,0,190000,0,0,0,234000,44000,190000,190000
056100,楠梓電永豐97購02,0,0,0,0,0,0,0,0,0,190000,0,0,0,200000,10000,190000,190000
052701,群創國票96購01  ,0,0,0,0,0,0,0,0,0,190000,0,0,0,190000,0,190000,190000
03427B,臺股指元大9A熊02,0,0,0,0,0,0,0,0,0,190000,0,0,0,240000,50000,190000,190000
061318,智邦凱基9B購01  ,0,0,0,0,0,0,0,0,0,190000,0,0,0,248000,58000,190000,190000
058047,可成元大98購11  ,0,0,0,0,0,0,0,0,0,190000,0,0,0,190000,0,190000,190000
061452,大成鋼凱基9A購01,0,0,0,0,0,0,0,0,0,189000,0,0,0,230000,41000,189000,189000
057174,南亞科元大98購05,0,0,0,0,0,0,0,0,0,189000,0,0,0,257000,68000,189000,189000
059242,南亞科凱基99購06,0,0,0,0,0,0,0,0,0,189000,0,0,0,199000,10000,189000,189000
062404,新唐永豐9B購01  ,0,0,0,0,0,0,0,0,0,188000,0,0,0,188000,0,188000,188000
062173,世紀鋼永豐9B購01,0,0,0,0,0,0,0,0,0,188000,0,0,0,288000,100000,188000,188000
06332P,世紀鋼群益98售01,0,0,0,0,0,0,0,0,0,188000,0,0,0,191000,3000,188000,188000
07088P,訊芯永豐99售02  ,0,0,0,0,0,0,0,0,0,188000,0,0,0,188000,0,188000,188000
057516,和鑫元富98購01  ,0,0,0,0,0,0,0,0,0,188000,0,0,0,422000,234000,188000,188000
060865,創意永豐9A購01  ,0,0,0,0,0,0,0,0,0,188000,0,0,0,220000,32000,188000,188000
07089P,臺指2X中信01售01,0,0,0,0,0,0,0,0,0,187000,0,0,0,414000,227000,187000,187000
063030,華通凱基9B購03  ,0,0,0,0,0,0,0,0,0,187000,0,0,0,199000,12000,187000,187000
062252,華邦電元大9C購01,0,0,0,0,0,0,0,0,0,187000,0,0,0,246000,59000,187000,187000
058526,鈺齊元大99購02  ,0,0,0,0,0,0,0,0,0,187000,0,0,0,217000,30000,187000,187000
07904P,聯發科群益9B售05,0,0,0,0,0,0,0,0,0,187000,0,0,0,250000,63000,187000,187000
062663,聯發科群益9B購07,0,0,0,0,0,0,0,0,0,185000,0,0,0,592000,407000,185000,185000
057484,南亞科元大98購06,0,0,0,0,0,0,0,0,0,185000,0,0,0,185000,0,185000,185000
05915P,聯發科元大96售19,0,0,0,0,0,0,0,0,0,185000,0,0,0,201000,16000,185000,185000
061021,聯電國泰9B購01  ,0,0,0,0,0,0,0,0,0,185000,0,0,0,789000,604000,185000,185000
062757,華通凱基9B購02  ,0,0,0,0,0,0,0,0,0,184000,0,0,0,184000,0,184000,184000
063439,正隆統一01購01  ,0,0,0,0,0,0,0,0,0,184000,0,0,0,361000,177000,184000,184000
06736P,新日興凱基98售03,0,0,0,0,0,0,0,0,0,184000,0,0,0,190000,6000,184000,184000
06582P,可成凱基98售06  ,0,0,0,0,0,0,0,0,0,184000,0,0,0,184000,0,184000,184000
06737P,台郡凱基98售07  ,0,0,0,0,0,0,0,0,0,183000,0,0,0,183000,0,183000,183000
060833,道瓊反國票9A購01,0,0,0,0,0,0,0,0,0,183000,0,0,0,198000,15000,183000,183000
4967,十銓            ,291000,107000,184000,0,0,0,0,0,0,-1000,0,1000,-1000,0,0,0,183000
055885,大成鋼統一97購02,0,0,0,0,0,0,0,0,0,182000,0,0,0,182000,0,182000,182000
061008,群創兆豐9A購02  ,0,0,0,0,0,0,0,0,0,182000,0,0,0,184000,2000,182000,182000
062707,致伸元大9B購01  ,0,0,0,0,0,0,0,0,0,181000,0,0,0,181000,0,181000,181000
060754,華通元大9A購04  ,0,0,0,0,0,0,0,0,0,181000,0,0,0,181000,0,181000,181000
06239P,奇力新元大97售08,0,0,0,0,0,0,0,0,0,180000,0,0,0,180000,0,180000,180000
061799,奇鋐永豐9B購01  ,0,0,0,0,0,0,0,0,0,180000,0,0,0,180000,0,180000,180000
06529P,貿聯富邦99售03  ,0,0,0,0,0,0,0,0,0,180000,0,0,0,180000,0,180000,180000
06515P,國巨凱基98售06  ,0,0,0,0,0,0,0,0,0,180000,0,0,0,185000,5000,180000,180000
059086,國巨元大99購18  ,0,0,0,0,0,0,0,0,0,180000,0,0,0,205000,25000,180000,180000
058699,楠梓電元大99購02,0,0,0,0,0,0,0,0,0,180000,0,0,0,180000,0,180000,180000
057623,友訊國泰99購01  ,0,0,0,0,0,0,0,0,0,180000,0,0,0,180000,0,180000,180000
060016,廣達康和99購01  ,0,0,0,0,0,0,0,0,0,180000,0,0,0,200000,20000,180000,180000
058660,樺漢中信9A購01  ,0,0,0,0,0,0,0,0,0,180000,0,0,0,300000,120000,180000,180000
063300,華通凱基9B購05  ,0,0,0,0,0,0,0,0,0,179000,0,0,0,181000,2000,179000,179000
060720,嘉聯益永豐9A購02,0,0,0,0,0,0,0,0,0,179000,0,0,0,179000,0,179000,179000
2365,昆盈            ,270000,82000,188000,0,0,0,0,0,0,-9000,0,9000,-9000,0,0,0,179000
063250,同欣電元大9B購03,0,0,0,0,0,0,0,0,0,178000,0,0,0,195000,17000,178000,178000
055940,致新群益98購01  ,0,0,0,0,0,0,0,0,0,178000,0,0,0,181000,3000,178000,178000
059695,聯鈞永豐99購02  ,0,0,0,0,0,0,0,0,0,178000,0,0,0,200000,22000,178000,178000
06535P,可成群益99售02  ,0,0,0,0,0,0,0,0,0,176000,0,0,0,176000,0,176000,176000
059009,世紀鋼元大99購04,0,0,0,0,0,0,0,0,0,176000,0,0,0,615000,439000,176000,176000
060723,致新永豐9A購01  ,0,0,0,0,0,0,0,0,0,176000,0,0,0,208000,32000,176000,176000
06693P,臺股指凱基98售01,0,0,0,0,0,0,0,0,0,175000,0,0,0,175000,0,175000,175000
07086P,力成元富9C售01  ,0,0,0,0,0,0,0,0,0,175000,0,0,0,375000,200000,175000,175000
063207,聯茂統一01購01  ,0,0,0,0,0,0,0,0,0,175000,0,0,0,256000,81000,175000,175000
061278,和大統一9A購01  ,0,0,0,0,0,0,0,0,0,174000,0,0,0,256000,82000,174000,174000
08124P,臻鼎群益9B售02  ,0,0,0,0,0,0,0,0,0,174000,0,0,0,174000,0,174000,174000
06680P,智邦元大98售06  ,0,0,0,0,0,0,0,0,0,173000,0,0,0,190000,17000,173000,173000
058104,國巨統一9A購04  ,0,0,0,0,0,0,0,0,0,173000,0,0,0,185000,12000,173000,173000
060559,世紀鋼凱基9C購01,0,0,0,0,0,0,0,0,0,173000,0,0,0,173000,0,173000,173000
06323P,台郡統一97售01  ,0,0,0,0,0,0,0,0,0,172000,0,0,0,172000,0,172000,172000
06337P,祥碩元大97售05  ,0,0,0,0,0,0,0,0,0,172000,0,0,0,220000,48000,172000,172000
053919,可成國票97購02  ,0,0,0,0,0,0,0,0,0,172000,0,0,0,180000,8000,172000,172000
058584,百和群益9A購01  ,0,0,0,0,0,0,0,0,0,172000,0,0,0,176000,4000,172000,172000
07527P,台灣50凱基9B售02,0,0,0,0,0,0,0,0,0,172000,0,0,0,209000,37000,172000,172000
07082P,美律元大99售06  ,0,0,0,0,0,0,0,0,0,170000,0,0,0,236000,66000,170000,170000
06622P,牧德元大98售01  ,0,0,0,0,0,0,0,0,0,170000,0,0,0,211000,41000,170000,170000
054812,鴻海元大97購08  ,0,0,0,0,0,0,0,0,0,170000,0,0,0,170000,0,170000,170000
054932,台肥元大97購01  ,0,0,0,0,0,0,0,0,0,170000,0,0,0,175000,5000,170000,170000
057684,聯茂日盛99購01  ,0,0,0,0,0,0,0,0,0,170000,0,0,0,170000,0,170000,170000
05851P,力山群益97售01  ,0,0,0,0,0,0,0,0,0,170000,0,0,0,206000,36000,170000,170000
058209,臺股指凱基01購01,0,0,0,0,0,0,0,0,0,170000,0,0,0,170000,0,170000,170000
058298,聯茂凱基99購05  ,0,0,0,0,0,0,0,0,0,170000,0,0,0,170000,0,170000,170000
07707P,玉山金元大9A售03,0,0,0,0,0,0,0,0,0,170000,0,0,0,170000,0,170000,170000
4104,佳醫            ,177000,7000,170000,0,0,0,0,0,0,0,0,0,0,0,0,0,170000
056829,台積電富邦9A購01,0,0,0,0,0,0,0,0,0,169000,0,0,0,249000,80000,169000,169000
07578P,高鐵元大9A售02  ,0,0,0,0,0,0,0,0,0,169000,0,0,0,291000,122000,169000,169000
06598P,奇力新永豐98售02,0,0,0,0,0,0,0,0,0,168000,0,0,0,168000,0,168000,168000
046937,聯電元大99購01  ,0,0,0,0,0,0,0,0,0,168000,0,0,0,192000,24000,168000,168000
056537,冠德凱基98購01  ,0,0,0,0,0,0,0,0,0,168000,0,0,0,172000,4000,168000,168000
057733,嘉聯益國泰99購01,0,0,0,0,0,0,0,0,0,168000,0,0,0,168000,0,168000,168000
2301,光寶科          ,7438686,8236659,-797973,0,0,0,800000,0,800000,165000,97000,2000,95000,70000,0,70000,167027
052316,台積電元大96購10,0,0,0,0,0,0,0,0,0,167000,0,0,0,167000,0,167000,167000
060612,世紀鋼凱基9A購01,0,0,0,0,0,0,0,0,0,167000,0,0,0,176000,9000,167000,167000
07552P,技嘉元大9A售03  ,0,0,0,0,0,0,0,0,0,167000,0,0,0,186000,19000,167000,167000
07957P,晶技群益9B售02  ,0,0,0,0,0,0,0,0,0,167000,0,0,0,213000,46000,167000,167000
062970,智邦元富9B購01  ,0,0,0,0,0,0,0,0,0,166000,0,0,0,370000,204000,166000,166000
054235,欣興群益96購06  ,0,0,0,0,0,0,0,0,0,166000,0,0,0,166000,0,166000,166000
054769,創意國票98購01  ,0,0,0,0,0,0,0,0,0,166000,0,0,0,166000,0,166000,166000
057173,南亞科元大98購04,0,0,0,0,0,0,0,0,0,166000,0,0,0,249000,83000,166000,166000
060628,和大富邦9B購01  ,0,0,0,0,0,0,0,0,0,166000,0,0,0,296000,130000,166000,166000
06822P,上銀富邦99售03  ,0,0,0,0,0,0,0,0,0,165000,0,0,0,186000,21000,165000,165000
054148,矽創元大96購03  ,0,0,0,0,0,0,0,0,0,165000,0,0,0,169000,4000,165000,165000
059195,國巨永豐99購04  ,0,0,0,0,0,0,0,0,0,165000,0,0,0,166000,1000,165000,165000
06046P,健策統一96售03  ,0,0,0,0,0,0,0,0,0,165000,0,0,0,250000,85000,165000,165000
058213,欣興群益99購01  ,0,0,0,0,0,0,0,0,0,164000,0,0,0,164000,0,164000,164000
057283,欣興元大98購07  ,0,0,0,0,0,0,0,0,0,164000,0,0,0,181000,17000,164000,164000
08003P,國巨國泰9B售07  ,0,0,0,0,0,0,0,0,0,164000,0,0,0,164000,0,164000,164000
054166,日電貿凱基98購01,0,0,0,0,0,0,0,0,0,163000,0,0,0,208000,45000,163000,163000
059765,嘉聯益永豐99購02,0,0,0,0,0,0,0,0,0,163000,0,0,0,191000,28000,163000,163000
060576,欣興中信9B購01  ,0,0,0,0,0,0,0,0,0,163000,0,0,0,198000,35000,163000,163000
059147,矽創國票99購01  ,0,0,0,0,0,0,0,0,0,163000,0,0,0,165000,2000,163000,163000
0061,元大寶滬深      ,191000,8000,183000,0,0,0,0,0,0,-22000,0,37000,-37000,17000,2000,15000,161000
00662,富邦NASDAQ      ,23000,0,23000,0,0,0,0,0,0,138000,30000,0,30000,191000,83000,108000,161000
056943,華通統一99購01  ,0,0,0,0,0,0,0,0,0,161000,0,0,0,261000,100000,161000,161000
059396,T50反1元富99購04,0,0,0,0,0,0,0,0,0,161000,0,0,0,567000,406000,161000,161000
08161P,台表科元富9B售02,0,0,0,0,0,0,0,0,0,161000,0,0,0,335000,174000,161000,161000
062859,玉晶光國票01購02,0,0,0,0,0,0,0,0,0,160000,0,0,0,197000,37000,160000,160000
062297,億豐永豐9B購01  ,0,0,0,0,0,0,0,0,0,160000,0,0,0,160000,0,160000,160000
062306,華通凱基9B購01  ,0,0,0,0,0,0,0,0,0,160000,0,0,0,169000,9000,160000,160000
062162,世紀鋼凱基9B購03,0,0,0,0,0,0,0,0,0,160000,0,0,0,191000,31000,160000,160000
054457,強茂群益96購01  ,0,0,0,0,0,0,0,0,0,160000,0,0,0,160000,0,160000,160000
060249,正文元大9C購01  ,0,0,0,0,0,0,0,0,0,160000,0,0,0,160000,0,160000,160000
054742,京鼎凱基99購01  ,0,0,0,0,0,0,0,0,0,160000,0,0,0,162000,2000,160000,160000
061124,微星永豐9A購02  ,0,0,0,0,0,0,0,0,0,160000,0,0,0,219000,59000,160000,160000
07865P,可成元大9B售02  ,0,0,0,0,0,0,0,0,0,160000,0,0,0,160000,0,160000,160000
8996,高力            ,376000,321000,55000,0,0,0,105000,0,105000,0,0,0,0,0,0,0,160000
8454,富邦媒          ,358219,181000,177219,0,0,0,0,28000,-28000,10000,12000,2000,10000,0,0,0,159219
07080P,健策群益9A售01  ,0,0,0,0,0,0,0,0,0,159000,0,0,0,197000,38000,159000,159000
061247,玉晶光群益9A購09,0,0,0,0,0,0,0,0,0,159000,0,0,0,181000,22000,159000,159000
07660P,聯茂凱基9A售03  ,0,0,0,0,0,0,0,0,0,159000,0,0,0,211000,52000,159000,159000
2615,萬海            ,330000,120382,209618,0,0,0,0,0,0,-51000,0,51000,-51000,0,0,0,158618
056267,文曄統一97購02  ,0,0,0,0,0,0,0,0,0,158000,0,0,0,208000,50000,158000,158000
06960P,國巨凱基99售08  ,0,0,0,0,0,0,0,0,0,157000,0,0,0,162000,5000,157000,157000
06655P,TPK元大98售02   ,0,0,0,0,0,0,0,0,0,157000,0,0,0,296000,139000,157000,157000
06370P,貿聯凱基97售03  ,0,0,0,0,0,0,0,0,0,157000,0,0,0,316000,159000,157000,157000
062606,聯電凱基9C購02  ,0,0,0,0,0,0,0,0,0,157000,0,0,0,157000,0,157000,157000
055301,台虹元大97購01  ,0,0,0,0,0,0,0,0,0,157000,0,0,0,242000,85000,157000,157000
07147P,高鐵元大99售01  ,0,0,0,0,0,0,0,0,0,157000,0,0,0,320000,163000,157000,157000
061687,大成鋼群益9A購01,0,0,0,0,0,0,0,0,0,156000,0,0,0,183000,27000,156000,156000
063055,創意統一9B購02  ,0,0,0,0,0,0,0,0,0,156000,0,0,0,838000,682000,156000,156000
00646,元大S&P500      ,191000,0,191000,0,0,0,0,0,0,-35000,0,0,0,248000,283000,-35000,156000
058841,深中小群益01購01,0,0,0,0,0,0,0,0,0,156000,0,0,0,357000,201000,156000,156000
08095P,大立光元富9B售03,0,0,0,0,0,0,0,0,0,156000,0,0,0,390000,234000,156000,156000
060831,T50反1國票9B購03,0,0,0,0,0,0,0,0,0,156000,0,0,0,190000,34000,156000,156000
05538P,玉晶光國票97售02,0,0,0,0,0,0,0,0,0,155000,0,0,0,179000,24000,155000,155000
061094,彩晶統一9B購02  ,0,0,0,0,0,0,0,0,0,155000,0,0,0,203000,48000,155000,155000
6715,嘉基            ,108000,22000,86000,0,0,0,0,0,0,69000,69000,0,69000,0,0,0,155000
07975P,國巨元大9B售15  ,0,0,0,0,0,0,0,0,0,155000,0,0,0,155000,0,155000,155000
059160,華通凱基99購03  ,0,0,0,0,0,0,0,0,0,154000,0,0,0,154000,0,154000,154000
07466P,亞德客元大9A售02,0,0,0,0,0,0,0,0,0,154000,0,0,0,305000,151000,154000,154000
2207,和泰車          ,1000220,856536,143684,0,0,0,1000,0,1000,9000,10000,1000,9000,0,0,0,153684
06505P,康控國票99售02  ,0,0,0,0,0,0,0,0,0,153000,0,0,0,153000,0,153000,153000
06583P,可成凱基98售07  ,0,0,0,0,0,0,0,0,0,153000,0,0,0,153000,0,153000,153000
060721,瑞儀永豐9A購01  ,0,0,0,0,0,0,0,0,0,153000,0,0,0,233000,80000,153000,153000
06705P,臻鼎元富98售03  ,0,0,0,0,0,0,0,0,0,152000,0,0,0,157000,5000,152000,152000
06246P,茂林元富97售03  ,0,0,0,0,0,0,0,0,0,152000,0,0,0,262000,110000,152000,152000
056524,欣興中信98購02  ,0,0,0,0,0,0,0,0,0,152000,0,0,0,202000,50000,152000,152000
057151,易華電國票99購01,0,0,0,0,0,0,0,0,0,152000,0,0,0,152000,0,152000,152000
061198,世紀鋼永豐9A購03,0,0,0,0,0,0,0,0,0,152000,0,0,0,152000,0,152000,152000
057447,智邦元富02購01  ,0,0,0,0,0,0,0,0,0,152000,0,0,0,156000,4000,152000,152000
059996,美律元富99購01  ,0,0,0,0,0,0,0,0,0,152000,0,0,0,158000,6000,152000,152000
062396,華通永豐9B購01  ,0,0,0,0,0,0,0,0,0,151000,0,0,0,151000,0,151000,151000
061749,群創統一9C購02  ,0,0,0,0,0,0,0,0,0,151000,0,0,0,151000,0,151000,151000
07800P,華新科國泰9B售04,0,0,0,0,0,0,0,0,0,151000,0,0,0,151000,0,151000,151000
060998,華通兆豐9A購01  ,0,0,0,0,0,0,0,0,0,151000,0,0,0,151000,0,151000,151000
07993P,寶成群益9B售01  ,0,0,0,0,0,0,0,0,0,151000,0,0,0,151000,0,151000,151000
062616,玉晶光元大9C購06,0,0,0,0,0,0,0,0,0,150000,0,0,0,150000,0,150000,150000
063358,華擎國泰01購01  ,0,0,0,0,0,0,0,0,0,150000,0,0,0,150000,0,150000,150000
056461,樺漢凱基98購02  ,0,0,0,0,0,0,0,0,0,150000,0,0,0,170000,20000,150000,150000
053331,玉晶光永豐97購02,0,0,0,0,0,0,0,0,0,150000,0,0,0,150000,0,150000,150000
07837P,華邦電元大9A售01,0,0,0,0,0,0,0,0,0,150000,0,0,0,324000,174000,150000,150000
060024,T50反1國泰9B購02,0,0,0,0,0,0,0,0,0,150000,0,0,0,150000,0,150000,150000
060349,上証2X元富9A購04,0,0,0,0,0,0,0,0,0,150000,0,0,0,200000,50000,150000,150000
062281,奇鋐群益9B購01  ,0,0,0,0,0,0,0,0,0,149000,0,0,0,240000,91000,149000,149000
058752,鈺齊凱基9A購01  ,0,19000,-19000,0,0,0,0,0,0,168000,0,0,0,168000,0,168000,149000
054709,宏達電統一97購01,0,0,0,0,0,0,0,0,0,148000,0,0,0,688000,540000,148000,148000
05348P,美律元富98售01  ,0,0,0,0,0,0,0,0,0,148000,0,0,0,198000,50000,148000,148000
046061,中石化凱基98購01,0,0,0,0,0,0,0,0,0,148000,0,0,0,200000,52000,148000,148000
058145,聯茂元大99購03  ,0,0,0,0,0,0,0,0,0,148000,0,0,0,216000,68000,148000,148000
1526,日馳            ,148000,0,148000,0,0,0,0,0,0,0,0,0,0,0,0,0,148000
060767,世紀鋼元大9A購02,0,0,0,0,0,0,0,0,0,148000,0,0,0,188000,40000,148000,148000
06245P,健策元富97售03  ,0,0,0,0,0,0,0,0,0,147000,0,0,0,147000,0,147000,147000
061900,志超永豐9B購01  ,0,0,0,0,0,0,0,0,0,147000,0,0,0,789000,642000,147000,147000
07014P,華通元大99售04  ,0,0,0,0,0,0,0,0,0,147000,0,0,0,172000,25000,147000,147000
058271,訊連永豐99購01  ,0,0,0,0,0,0,0,0,0,147000,0,0,0,147000,0,147000,147000
060922,金像電永豐9A購01,0,0,0,0,0,0,0,0,0,147000,0,0,0,170000,23000,147000,147000
06576P,台光電群益98售03,0,0,0,0,0,0,0,0,0,146000,0,0,0,146000,0,146000,146000
055536,嘉聯益群益99購02,0,0,0,0,0,0,0,0,0,146000,0,0,0,417000,271000,146000,146000
060521,鴻海中信01購03  ,0,0,0,0,0,0,0,0,0,146000,0,0,0,146000,0,146000,146000
058802,矽創元大99購02  ,0,0,0,0,0,0,0,0,0,146000,0,0,0,240000,94000,146000,146000
061258,華通凱基9A購06  ,0,0,0,0,0,0,0,0,0,146000,0,0,0,146000,0,146000,146000
062434,華通元大9B購04  ,0,0,0,0,0,0,0,0,0,145000,0,0,0,148000,3000,145000,145000
062119,世紀鋼中信9B購01,0,0,0,0,0,0,0,0,0,145000,0,0,0,180000,35000,145000,145000
055203,建準中信97購01  ,0,0,0,0,0,0,0,0,0,145000,0,0,0,175000,30000,145000,145000
054134,強茂元大96購01  ,0,0,0,0,0,0,0,0,0,145000,0,0,0,145000,0,145000,145000
061346,玉晶光元大9B購03,0,0,0,0,0,0,0,0,0,145000,0,0,0,145000,0,145000,145000
057499,奇鋐群益98購01  ,0,0,0,0,0,0,0,0,0,145000,0,0,0,145000,0,145000,145000
1308,亞聚            ,191000,46000,145000,0,0,0,0,0,0,0,0,0,0,0,0,0,145000
1216,統一            ,12723092,12584870,138222,0,0,0,0,0,0,6000,16000,2000,14000,0,8000,-8000,144222
062625,華通國票9B購02  ,0,0,0,0,0,0,0,0,0,144000,0,0,0,149000,5000,144000,144000
063403,鈺齊群益9B購01  ,0,0,0,0,0,0,0,0,0,144000,0,0,0,144000,0,144000,144000
059282,嘉聯益永豐99購01,0,0,0,0,0,0,0,0,0,144000,0,0,0,150000,6000,144000,144000
06779P,智邦元大98售12  ,0,0,0,0,0,0,0,0,0,143000,0,0,0,143000,0,143000,143000
054674,台光電台新97購01,0,0,0,0,0,0,0,0,0,143000,0,0,0,143000,0,143000,143000
057748,華通國票98購04  ,0,0,0,0,0,0,0,0,0,143000,0,0,0,150000,7000,143000,143000
3006,晶豪科          ,634000,323000,311000,0,0,0,0,0,0,-168000,36000,115000,-79000,9000,98000,-89000,143000
08075P,聯電群益9C售01  ,0,0,0,0,0,0,0,0,0,143000,0,0,0,143000,0,143000,143000
056507,創意永豐98購02  ,0,0,0,0,0,0,0,0,0,142000,0,0,0,230000,88000,142000,142000
060593,華通麥證9A購01  ,0,0,0,142000,0,142000,0,0,0,142000,0,0,0,142000,0,142000,142000
058251,百和元大99購03  ,0,0,0,0,0,0,0,0,0,142000,0,0,0,218000,76000,142000,142000
059080,亞泥元大99購01  ,0,0,0,0,0,0,0,0,0,142000,0,0,0,200000,58000,142000,142000
07945P,上銀國票9B售02  ,0,0,0,0,0,0,0,0,0,142000,0,0,0,152000,10000,142000,142000
3257,虹冠電          ,159000,17000,142000,0,0,0,0,0,0,0,0,0,0,0,0,0,142000
06721P,臺股指中信9A售03,0,0,0,0,0,0,0,0,0,141000,0,0,0,281000,140000,141000,141000
06243P,亞光元富97售01  ,0,0,0,0,0,0,0,0,0,141000,0,0,0,151000,10000,141000,141000
053849,聯發科元富96購04,0,0,0,0,0,0,0,0,0,141000,0,0,0,189000,48000,141000,141000
07927P,國巨統一9B售08  ,0,0,0,0,0,0,0,0,0,141000,0,0,0,141000,0,141000,141000
06752P,訊芯凱基98售05  ,0,0,0,0,0,0,0,0,0,140000,0,0,0,144000,4000,140000,140000
055792,臺股指凱基97購15,0,0,0,0,0,0,0,0,0,140000,0,0,0,140000,0,140000,140000
056933,國巨元富98購03  ,0,0,0,0,0,0,0,0,0,140000,0,0,0,140000,0,140000,140000
054188,欣興永豐96購03  ,0,0,0,0,0,0,0,0,0,140000,0,0,0,170000,30000,140000,140000
059612,奇鋐永豐99購02  ,0,0,0,0,0,0,0,0,0,140000,0,0,0,141000,1000,140000,140000
1609,大亞            ,208000,68000,140000,0,0,0,0,0,0,0,0,0,0,0,0,0,140000
5471,松翰            ,2257000,2117000,140000,0,0,0,0,0,0,0,0,0,0,0,0,0,140000
6415,矽力-KY         ,6749198,6545377,203821,0,0,0,5000,50000,-45000,-19000,1000,19000,-18000,3000,4000,-1000,139821
063210,百和統一9C購01  ,0,0,0,0,0,0,0,0,0,139000,0,0,0,164000,25000,139000,139000
057912,美律日盛99購01  ,0,0,0,0,0,0,0,0,0,139000,0,0,0,200000,61000,139000,139000
057214,瑞昱群益98購01  ,0,0,0,0,0,0,0,0,0,139000,0,0,0,267000,128000,139000,139000
08044P,臺股指富邦9B售03,0,0,0,0,0,0,0,0,0,139000,0,0,0,140000,1000,139000,139000
062919,聯茂元大9B購01  ,0,0,0,0,0,0,0,0,0,138000,0,0,0,148000,10000,138000,138000
056811,健策統一9B購01  ,0,0,0,0,0,0,0,0,0,138000,0,0,0,142000,4000,138000,138000
053337,聯電國票97購01  ,0,0,0,0,0,0,0,0,0,138000,0,0,0,139000,1000,138000,138000
056646,奇鋐凱基99購02  ,0,0,0,0,0,0,0,0,0,138000,0,0,0,138000,0,138000,138000
05987P,健策統一96售02  ,0,0,0,0,0,0,0,0,0,138000,0,0,0,138000,0,138000,138000
055221,矽創凱基97購02  ,0,0,0,0,0,0,0,0,0,138000,0,0,0,138000,0,138000,138000
060625,華擎元大9A購01  ,0,0,0,0,0,0,0,0,0,138000,0,0,0,298000,160000,138000,138000
06718P,聯詠元大98售01  ,0,0,0,0,0,0,0,0,0,137000,0,0,0,137000,0,137000,137000
062321,力成台新9B購01  ,0,0,0,0,0,0,0,0,0,137000,0,0,0,147000,10000,137000,137000
00708L,元大S&P黃金正2  ,0,5000,-5000,0,0,0,0,0,0,142000,0,0,0,1512000,1370000,142000,137000
057562,奇鋐兆豐98購01  ,0,0,0,0,0,0,0,0,0,137000,0,0,0,137000,0,137000,137000
058610,欣興元大99購05  ,0,0,0,0,0,0,0,0,0,137000,0,0,0,195000,58000,137000,137000
063361,台表科國泰01購02,0,0,0,0,0,0,0,0,0,136000,0,0,0,150000,14000,136000,136000
052047,建準凱基96購01  ,0,0,0,0,0,0,0,0,0,136000,0,0,0,137000,1000,136000,136000
056119,欣興群益97購02  ,0,0,0,0,0,0,0,0,0,136000,0,0,0,748000,612000,136000,136000
059199,欣興永豐99購02  ,0,0,0,0,0,0,0,0,0,136000,0,0,0,137000,1000,136000,136000
05905P,晶技統一97售01  ,0,0,0,0,0,0,0,0,0,136000,0,0,0,203000,67000,136000,136000
07687P,上銀元大9A售06  ,0,0,0,0,0,0,0,0,0,136000,0,0,0,136000,0,136000,136000
061114,南電元大9A購04  ,0,0,0,0,0,0,0,0,0,135000,0,0,0,140000,5000,135000,135000
061145,臻鼎中信9A購02  ,0,0,0,0,0,0,0,0,0,135000,0,0,0,175000,40000,135000,135000
057490,可成元大98購10  ,0,0,0,0,0,0,0,0,0,135000,0,0,0,135000,0,135000,135000
07471P,南亞科元大9A售01,0,0,0,0,0,0,0,0,0,135000,0,0,0,147000,12000,135000,135000
07416P,台積電元大99售53,0,0,0,0,0,0,0,0,0,135000,0,0,0,163000,28000,135000,135000
3029,零壹            ,413000,278000,135000,0,0,0,0,0,0,0,0,0,0,0,0,0,135000
059855,緯穎永豐99購04  ,0,0,0,0,0,0,0,0,0,134000,0,0,0,134000,0,134000,134000
056345,嘉聯益凱基99購01,0,0,0,0,0,0,0,0,0,134000,0,0,0,134000,0,134000,134000
060583,南亞科元富9A購05,0,0,0,0,0,0,0,0,0,134000,0,0,0,134000,0,134000,134000
057689,南亞科凱基99購02,0,0,0,0,0,0,0,0,0,134000,0,0,0,139000,5000,134000,134000
060122,亞德客永豐99購02,0,0,0,0,0,0,0,0,0,134000,0,0,0,149000,15000,134000,134000
061062,和大凱基9A購02  ,0,0,0,0,0,0,0,0,0,134000,0,0,0,134000,0,134000,134000
059207,臺指反元大9C購02,0,0,0,0,0,0,0,0,0,133000,0,0,0,133000,0,133000,133000
07694P,超眾元大9A售05  ,0,0,0,0,0,0,0,0,0,133000,0,0,0,146000,13000,133000,133000
062921,GIS元大9B購01   ,0,0,0,0,0,0,0,0,0,132000,0,0,0,620000,488000,132000,132000
061071,復盛凱基9A購01  ,0,0,0,0,0,0,0,0,0,132000,0,0,0,194000,62000,132000,132000
060476,瑞祺元大9A購02  ,0,0,0,0,0,0,0,0,0,132000,0,0,0,220000,88000,132000,132000
058722,台郡元富99購01  ,0,0,0,0,0,0,0,0,0,132000,0,0,0,231000,99000,132000,132000
058739,喬山中信99購01  ,0,0,0,0,0,0,0,0,0,132000,0,0,0,262000,130000,132000,132000
07878P,智邦群益9C售01  ,0,0,0,0,0,0,0,0,0,132000,0,0,0,142000,10000,132000,132000
062760,漢唐凱基9B購01  ,0,0,0,0,0,0,0,0,0,131000,0,0,0,230000,99000,131000,131000
06320P,上銀統一97售04  ,0,0,0,0,0,0,0,0,0,131000,0,0,0,200000,69000,131000,131000
063249,祥碩元大9B購06  ,0,0,0,0,0,0,0,0,0,131000,0,0,0,352000,221000,131000,131000
061867,旺宏元大9B購02  ,0,0,0,0,0,0,0,0,0,131000,0,0,0,143000,12000,131000,131000
00651R,FH香港反1       ,53000,53000,0,0,0,0,0,0,0,131000,0,0,0,1582000,1451000,131000,131000
058809,國巨統一9B購03  ,0,0,0,0,0,0,0,0,0,131000,0,0,0,145000,14000,131000,131000
08092P,仁寶元富9B售02  ,0,0,0,0,0,0,0,0,0,131000,0,0,0,151000,20000,131000,131000
061732,智邦中信9B購01  ,0,0,0,0,0,0,0,0,0,130000,0,0,0,130000,0,130000,130000
062925,建準國票9B購01  ,0,0,0,0,0,0,0,0,0,130000,0,0,0,130000,0,130000,130000
05414P,台表科國票96售02,0,0,0,0,0,0,0,0,0,130000,0,0,0,130000,0,130000,130000
060232,友訊元大9C購01  ,0,0,0,0,0,0,0,0,0,130000,0,0,0,136000,6000,130000,130000
057007,奇力新中信98購04,0,0,0,0,0,0,0,0,0,130000,0,0,0,160000,30000,130000,130000
059008,鈺齊元大99購03  ,0,0,0,0,0,0,0,0,0,130000,0,0,0,149000,19000,130000,130000
07699P,臺股指元大9A售52,0,0,0,0,0,0,0,0,0,130000,0,0,0,130000,0,130000,130000
07502P,美食元大9A售01  ,0,0,0,0,0,0,0,0,0,130000,0,0,0,230000,100000,130000,130000
060795,世芯永豐9A購02  ,0,0,0,0,0,0,0,0,0,130000,0,0,0,141000,11000,130000,130000
060796,世芯永豐9A購03  ,0,0,0,0,0,0,0,0,0,130000,0,0,0,318000,188000,130000,130000
063063,泰鼎元富9B購01  ,10000,0,10000,0,0,0,0,0,0,119000,0,0,0,252000,133000,119000,129000
063137,瑞昱統一01購02  ,0,0,0,0,0,0,0,0,0,129000,0,0,0,210000,81000,129000,129000
061957,上銀統一01購01  ,0,0,0,0,0,0,0,0,0,129000,0,0,0,263000,134000,129000,129000
061618,友達群益9A購04  ,0,0,0,0,0,0,0,0,0,129000,0,0,0,129000,0,129000,129000
061492,超眾兆豐9B購01  ,0,0,0,0,0,0,0,0,0,129000,0,0,0,129000,0,129000,129000
062234,廣達凱基9B購01  ,0,0,0,0,0,0,0,0,0,129000,0,0,0,152000,23000,129000,129000
07208P,台積電凱基99售14,0,0,0,0,0,0,0,0,0,129000,0,0,0,140000,11000,129000,129000
06564P,國巨富邦9A售04  ,0,0,0,0,0,0,0,0,0,128000,0,0,0,144000,16000,128000,128000
06569P,可成永豐98售01  ,0,0,0,0,0,0,0,0,0,128000,0,0,0,128000,0,128000,128000
046942,友達元大99購01  ,0,0,0,0,0,0,0,0,0,128000,0,0,0,131000,3000,128000,128000
058518,玉晶光元大99購13,0,0,0,0,0,0,0,0,0,128000,0,0,0,135000,7000,128000,128000
1215,卜蜂            ,475000,350000,125000,0,0,0,0,0,0,3000,36000,40000,-4000,15000,8000,7000,128000
06073P,健策永豐97售01  ,0,0,0,0,0,0,0,0,0,128000,0,0,0,128000,0,128000,128000
06378P,國巨統一97售08  ,0,0,0,0,0,0,0,0,0,127000,0,0,0,129000,2000,127000,127000
062642,帆宣國票9B購01  ,0,0,0,0,0,0,0,0,0,127000,0,0,0,142000,15000,127000,127000
062720,南亞科凱基9B購03,0,0,0,0,0,0,0,0,0,127000,0,0,0,128000,1000,127000,127000
061743,祥碩凱基9B購02  ,0,0,0,0,0,0,0,0,0,127000,0,0,0,218000,91000,127000,127000
06187P,國巨統一97售05  ,0,0,0,0,0,0,0,0,0,127000,0,0,0,127000,0,127000,127000
058520,智易元大99購03  ,0,0,0,0,0,0,0,0,0,127000,0,0,0,256000,129000,127000,127000
061232,和大元大9A購03  ,0,0,0,0,0,0,0,0,0,127000,0,0,0,252000,125000,127000,127000
08123P,台表科國票9C售01,0,0,0,0,0,0,0,0,0,127000,0,0,0,186000,59000,127000,127000
062744,超眾國泰9C購01  ,0,0,0,0,0,0,0,0,0,126000,0,0,0,171000,45000,126000,126000
063381,和潤永豐9B購01  ,0,0,0,0,0,0,0,0,0,126000,0,0,0,132000,6000,126000,126000
053340,建準國票97購01  ,0,0,0,0,0,0,0,0,0,126000,0,0,0,126000,0,126000,126000
061091,奇力新統一9C購02,0,0,0,0,0,0,0,0,0,126000,0,0,0,136000,10000,126000,126000
061011,華通麥證9A購02  ,0,0,0,126000,0,126000,0,0,0,126000,0,0,0,126000,0,126000,126000
08084P,台表科元大9B售06,0,0,0,0,0,0,0,0,0,126000,0,0,0,199000,73000,126000,126000
06645P,上銀元大98售05  ,0,0,0,0,0,0,0,0,0,125000,0,0,0,148000,23000,125000,125000
00701,國泰股利精選30  ,19000,0,19000,0,0,0,0,0,0,106000,0,0,0,646000,540000,106000,125000
049024,玉晶光群益97購01,0,0,0,0,0,0,0,0,0,125000,0,0,0,160000,35000,125000,125000
054291,高鐵元大97購01  ,0,0,0,0,0,0,0,0,0,125000,0,0,0,175000,50000,125000,125000
058369,亞光凱基99購02  ,0,0,0,0,0,0,0,0,0,125000,0,0,0,125000,0,125000,125000
07530P,聯發科凱基9A售11,0,0,0,0,0,0,0,0,0,125000,0,0,0,149000,24000,125000,125000
060707,台郡富邦9A購01  ,0,0,0,0,0,0,0,0,0,125000,0,0,0,185000,60000,125000,125000
057150,貿聯國票99購02  ,0,0,0,0,0,0,0,0,0,124000,0,0,0,143000,19000,124000,124000
059312,元石油元大99購05,0,0,0,0,0,0,0,0,0,124000,0,0,0,134000,10000,124000,124000
061370,晶技國泰9C購01  ,0,0,0,0,0,0,0,0,0,124000,0,0,0,172000,48000,124000,124000
062166,致新國泰01購01  ,0,0,0,0,0,0,0,0,0,123000,0,0,0,143000,20000,123000,123000
053279,景碩元大97購01  ,0,0,0,0,0,0,0,0,0,123000,0,0,0,180000,57000,123000,123000
057158,義隆永豐99購01  ,0,0,0,0,0,0,0,0,0,123000,0,0,0,615000,492000,123000,123000
057530,奇鋐元大99購01  ,0,0,0,0,0,0,0,0,0,123000,0,0,0,123000,0,123000,123000
08062P,華擎國票9B售03  ,0,0,0,0,0,0,0,0,0,123000,0,0,0,124000,1000,123000,123000
07956P,鴻海群益9B售06  ,0,0,0,0,0,0,0,0,0,123000,0,0,0,123000,0,123000,123000
054319,世紀鋼凱基96購02,0,0,0,0,0,0,0,0,0,122000,0,0,0,187000,65000,122000,122000
055667,致茂群益98購01  ,0,0,0,0,0,0,0,0,0,122000,0,0,0,122000,0,122000,122000
058738,FBVIX中信03購04 ,0,0,0,0,0,0,0,0,0,122000,0,0,0,124000,2000,122000,122000
058605,華邦電元大99購04,0,0,0,0,0,0,0,0,0,122000,0,0,0,288000,166000,122000,122000
07315P,台積電台新99售06,0,0,0,0,0,0,0,0,0,122000,0,0,0,222000,100000,122000,122000
03647C,T50反1元富99牛02,0,0,0,0,0,0,0,0,0,121000,0,0,0,121000,0,121000,121000
053957,瑞昱永豐96購01  ,0,0,0,0,0,0,0,0,0,121000,0,0,0,121000,0,121000,121000
060283,台肥元大9C購01  ,0,0,0,0,0,0,0,0,0,121000,0,0,0,138000,17000,121000,121000
057925,貿聯凱基99購01  ,0,0,0,0,0,0,0,0,0,121000,0,0,0,166000,45000,121000,121000
07850P,健策群益9A售06  ,0,0,0,0,0,0,0,0,0,121000,0,0,0,171000,50000,121000,121000
2348,海悅            ,188000,66000,122000,0,0,0,0,0,0,-1000,0,1000,-1000,0,0,0,121000
062549,中租永豐9B購01  ,0,0,0,0,0,0,0,0,0,120000,0,0,0,159000,39000,120000,120000
061927,玉晶光凱基9C購01,0,0,0,0,0,0,0,0,0,120000,0,0,0,120000,0,120000,120000
061641,玉晶光元大9A購17,0,0,0,0,0,0,0,0,0,120000,0,0,0,154000,34000,120000,120000
06568P,國巨永豐98售05  ,0,0,0,0,0,0,0,0,0,120000,0,0,0,121000,1000,120000,120000
06374P,台表科元大97售06,0,0,0,0,0,0,0,0,0,120000,0,0,0,120000,0,120000,120000
063211,道瓊銀國票9B購01,0,0,0,0,0,0,0,0,0,120000,0,0,0,120000,0,120000,120000
063064,台表科元富9B購01,0,0,0,0,0,0,0,0,0,120000,0,0,0,184000,64000,120000,120000
062810,華通兆豐9B購02  ,0,0,0,0,0,0,0,0,0,120000,0,0,0,120000,0,120000,120000
053014,旺宏統一97購02  ,0,0,0,0,0,0,0,0,0,120000,0,0,0,120000,0,120000,120000
053554,欣興凱基97購02  ,0,0,0,0,0,0,0,0,0,120000,0,0,0,120000,0,120000,120000
056023,晶豪科群益97購01,0,0,0,0,0,0,0,0,0,120000,0,0,0,120000,0,120000,120000
056213,建準國票98購02  ,0,0,0,0,0,0,0,0,0,120000,0,0,0,121000,1000,120000,120000
055259,玉晶光統一9A購01,0,0,0,0,0,0,0,0,0,120000,0,0,0,120000,0,120000,120000
056583,昇陽半元大98購02,0,0,0,0,0,0,0,0,0,120000,0,0,0,120000,0,120000,120000
060244,大立光元大9B購02,0,0,0,0,0,0,0,0,0,120000,0,0,0,121000,1000,120000,120000
060222,貿聯凱基9A購02  ,0,0,0,0,0,0,0,0,0,120000,0,0,0,155000,35000,120000,120000
058502,鴻海元大99購13  ,0,0,0,0,0,0,0,0,0,120000,0,0,0,125000,5000,120000,120000
058215,貿聯群益99購02  ,0,0,0,0,0,0,0,0,0,120000,0,0,0,130000,10000,120000,120000
060409,味全永豐9A購01  ,0,0,0,0,0,0,0,0,0,120000,0,0,0,145000,25000,120000,120000
6197,佳必琪          ,150000,30000,120000,0,0,0,0,0,0,0,0,0,0,0,0,0,120000
06783P,亞光元大98售03  ,0,0,0,0,0,0,0,0,0,119000,0,0,0,119000,0,119000,119000
062680,微星統一01購01  ,0,0,0,0,0,0,0,0,0,119000,0,0,0,164000,45000,119000,119000
08079P,宏達電國票9B售03,0,0,0,0,0,0,0,0,0,119000,0,0,0,119000,0,119000,119000
062040,玉晶光凱基01購01,0,0,0,0,0,0,0,0,0,118000,0,0,0,118000,0,118000,118000
062058,瑞昱統一01購01  ,0,0,0,0,0,0,0,0,0,118000,0,0,0,233000,115000,118000,118000
055681,奇鋐凱基98購03  ,0,0,0,0,0,0,0,0,0,118000,0,0,0,158000,40000,118000,118000
057375,欣興元大98購09  ,0,0,0,0,0,0,0,0,0,118000,0,0,0,151000,33000,118000,118000
061334,華通元大9A購09  ,0,0,0,0,0,0,0,0,0,118000,0,0,0,119000,1000,118000,118000
07950P,智邦元大9B售04  ,0,0,0,0,0,0,0,0,0,118000,0,0,0,119000,1000,118000,118000
061762,台塑元大9B購01  ,0,0,0,0,0,0,0,0,0,117000,0,0,0,217000,100000,117000,117000
06926P,可成群益9A售04  ,0,0,0,0,0,0,0,0,0,117000,0,0,0,117000,0,117000,117000
062858,微星國票9B購01  ,0,0,0,0,0,0,0,0,0,117000,0,0,0,149000,32000,117000,117000
055207,致新中信99購01  ,0,0,0,0,0,0,0,0,0,117000,0,0,0,180000,63000,117000,117000
059871,義隆凱基99購03  ,0,0,0,0,0,0,0,0,0,117000,0,0,0,207000,90000,117000,117000
07840P,康控元大9A售02  ,0,0,0,0,0,0,0,0,0,117000,0,0,0,225000,108000,117000,117000
058897,國巨元大99購17  ,0,0,0,0,0,0,0,0,0,117000,0,0,0,117000,0,117000,117000
058025,聯茂國泰99購01  ,0,0,0,0,0,0,0,0,0,117000,0,0,0,146000,29000,117000,117000
060573,力成永豐9A購01  ,0,0,0,0,0,0,0,0,0,117000,0,0,0,123000,6000,117000,117000
3094,聯傑            ,118000,1000,117000,0,0,0,0,0,0,0,0,0,0,0,0,0,117000
2233,宇隆            ,59000,52000,7000,0,0,0,80000,0,80000,30000,35000,5000,30000,0,0,0,117000
9944,新麗            ,474000,357000,117000,0,0,0,0,0,0,0,0,0,0,0,0,0,117000
056365,欣興元大98購01  ,0,0,0,0,0,0,0,0,0,116000,0,0,0,140000,24000,116000,116000
058801,致伸元大99購01  ,0,0,0,0,0,0,0,0,0,116000,0,0,0,220000,104000,116000,116000
057988,鈺齊元富98購02  ,0,0,0,0,0,0,0,0,0,116000,0,0,0,116000,0,116000,116000
063134,裕隆統一01購01  ,0,0,0,0,0,0,0,0,0,115000,0,0,0,1190000,1075000,115000,115000
063392,聯電群益9B購02  ,0,0,0,0,0,0,0,0,0,115000,0,0,0,115000,0,115000,115000
058402,欣興元大99購04  ,0,0,0,0,0,0,0,0,0,115000,0,0,0,147000,32000,115000,115000
057587,微星國票99購01  ,0,0,0,0,0,0,0,0,0,115000,0,0,0,123000,8000,115000,115000
058741,欣興日盛99購01  ,0,0,0,0,0,0,0,0,0,115000,0,0,0,115000,0,115000,115000
4552,力達-KY         ,65000,35000,30000,0,0,0,85000,0,85000,0,0,0,0,0,0,0,115000
07743P,智邦凱基9A售03  ,0,0,0,0,0,0,0,0,0,115000,0,0,0,155000,40000,115000,115000
08136P,祥碩國泰01售01  ,0,0,0,0,0,0,0,0,0,115000,0,0,0,645000,530000,115000,115000
055444,致新台新97購01  ,0,0,0,0,0,0,0,0,0,114000,0,0,0,134000,20000,114000,114000
07648P,祥碩國票9B售01  ,0,0,0,0,0,0,0,0,0,114000,0,0,0,273000,159000,114000,114000
060619,玉晶光元大9A購03,0,0,0,0,0,0,0,0,0,114000,0,0,0,141000,27000,114000,114000
062832,嘉澤群益9B購02  ,0,0,0,0,0,0,0,0,0,113000,0,0,0,113000,0,113000,113000
057949,南電國票99購01  ,0,0,0,0,0,0,0,0,0,113000,0,0,0,113000,0,113000,113000
06744P,嘉聯益永豐98售03,0,0,0,0,0,0,0,0,0,112000,0,0,0,122000,10000,112000,112000
062307,華通凱基9C購01  ,0,0,0,0,0,0,0,0,0,112000,0,0,0,114000,2000,112000,112000
055631,創意永豐98購01  ,0,0,0,0,0,0,0,0,0,112000,0,0,0,112000,0,112000,112000
056166,微星台新97購01  ,0,0,0,0,0,0,0,0,0,112000,0,0,0,112000,0,112000,112000
048651,美利達元大96購05,0,0,0,0,0,0,0,0,0,112000,0,0,0,210000,98000,112000,112000
057581,元大金中信9A購01,0,0,0,0,0,0,0,0,0,112000,0,0,0,160000,48000,112000,112000
06139P,台積電中信99售02,0,0,0,0,0,0,0,0,0,111000,0,0,0,111000,0,111000,111000
057523,大成鋼元大99購01,0,0,0,0,0,0,0,0,0,111000,0,0,0,442000,331000,111000,111000
059100,元油2X統一9C購02,0,0,0,0,0,0,0,0,0,111000,0,0,0,181000,70000,111000,111000
07834P,聯詠群益9A售03  ,0,0,0,0,0,0,0,0,0,111000,0,0,0,118000,7000,111000,111000
061872,友達元大9C購06  ,0,0,0,0,0,0,0,0,0,110000,0,0,0,110000,0,110000,110000
061830,元金2X凱基01購01,0,0,0,0,0,0,0,0,0,110000,0,0,0,120000,10000,110000,110000
062746,致伸永豐9B購01  ,0,0,0,0,0,0,0,0,0,110000,0,0,0,122000,12000,110000,110000
00770,國泰北美科技    ,0,211000,-211000,0,0,0,0,0,0,321000,0,0,0,363000,42000,321000,110000
053492,華邦電兆豐97購01,0,0,0,0,0,0,0,0,0,110000,0,0,0,135000,25000,110000,110000
053782,京元電元大98購02,0,0,0,0,0,0,0,0,0,110000,0,0,0,110000,0,110000,110000
055576,嘉晶統一98購01  ,0,0,0,0,0,0,0,0,0,110000,0,0,0,145000,35000,110000,110000
056286,奇鋐永豐97購01  ,0,0,0,0,0,0,0,0,0,110000,0,0,0,195000,85000,110000,110000
05995P,T50正2中信9C售01,0,0,0,0,0,0,0,0,0,110000,0,0,0,265000,155000,110000,110000
058864,欣興凱基99購04  ,0,0,0,0,0,0,0,0,0,110000,0,0,0,110000,0,110000,110000
061308,元金2X中信9A購01,0,0,0,0,0,0,0,0,0,110000,0,0,0,110000,0,110000,110000
07524P,臺股指中信9B售06,0,0,0,0,0,0,0,0,0,110000,0,0,0,110000,0,110000,110000
07419P,聯發科元大99售46,0,0,0,0,0,0,0,0,0,110000,0,0,0,110000,0,110000,110000
07358P,鴻海元大99售39  ,0,0,0,0,0,0,0,0,0,110000,0,0,0,125000,15000,110000,110000
08119P,南亞科統一9C售03,0,0,0,0,0,0,0,0,0,110000,0,0,0,153000,43000,110000,110000
062872,華通兆豐9C購01  ,0,0,0,0,0,0,0,0,0,109000,0,0,0,129000,20000,109000,109000
062359,旺宏元大9C購02  ,0,0,0,0,0,0,0,0,0,109000,0,0,0,124000,15000,109000,109000
056674,華邦電元富98購01,0,0,0,0,0,0,0,0,0,109000,0,0,0,305000,196000,109000,109000
055805,矽力永豐97購01  ,0,0,0,0,0,0,0,0,0,109000,0,0,0,158000,49000,109000,109000
051276,SGBR2X中信97購01,0,0,0,0,0,0,0,0,0,109000,0,0,0,109000,0,109000,109000
057320,玉晶光凱基98購01,0,0,0,0,0,0,0,0,0,109000,0,0,0,149000,40000,109000,109000
05755P,臺股指中信99售04,0,0,0,0,0,0,0,0,0,109000,0,0,0,110000,1000,109000,109000
062193,瑞昱第一9B購01  ,0,0,0,0,0,0,0,0,0,108000,0,0,0,149000,41000,108000,108000
061595,智易永豐9A購02  ,0,0,0,0,0,0,0,0,0,108000,0,0,0,108000,0,108000,108000
063238,漢唐元大9B購02  ,0,0,0,0,0,0,0,0,0,108000,0,0,0,368000,260000,108000,108000
053097,超眾統一96購03  ,0,0,0,0,0,0,0,0,0,108000,0,0,0,108000,0,108000,108000
056591,S&P正2元富9A購01,0,0,0,0,0,0,0,0,0,108000,0,0,0,108000,0,108000,108000
07981P,上銀群益9B售04  ,0,0,0,0,0,0,0,0,0,108000,0,0,0,238000,130000,108000,108000
060742,臺指反國票9B購02,0,0,0,0,0,0,0,0,0,108000,0,0,0,108000,0,108000,108000
060867,智伸科永豐9A購01,0,0,0,0,0,0,0,0,0,108000,0,0,0,299000,191000,108000,108000
059829,超眾凱基99購05  ,0,0,0,0,0,0,0,0,0,107000,0,0,0,121000,14000,107000,107000
05052P,友達群益97售01  ,0,0,0,0,0,0,0,0,0,107000,0,0,0,187000,80000,107000,107000
058200,世芯康和99購01  ,0,0,0,0,0,0,0,0,0,107000,0,0,0,342000,235000,107000,107000
057366,智邦元大98購08  ,0,0,0,0,0,0,0,0,0,107000,0,0,0,141000,34000,107000,107000
057388,奇鋐永豐98購02  ,0,0,0,0,0,0,0,0,0,107000,0,0,0,148000,41000,107000,107000
061052,和大群益9A購01  ,0,0,0,0,0,0,0,0,0,107000,0,0,0,205000,98000,107000,107000
058408,華通兆豐99購02  ,0,0,0,0,0,0,0,0,0,107000,0,0,0,107000,0,107000,107000
062898,華通元大9B購05  ,0,0,0,0,0,0,0,0,0,106000,0,0,0,130000,24000,106000,106000
06934P,聯鈞元大98售03  ,0,0,0,0,0,0,0,0,0,106000,0,0,0,106000,0,106000,106000
061524,華通凱基9A購07  ,0,0,0,0,0,0,0,0,0,106000,0,0,0,106000,0,106000,106000
061870,智邦元大9B購02  ,0,0,0,0,0,0,0,0,0,106000,0,0,0,162000,56000,106000,106000
056600,聯茂元富98購01  ,0,0,0,0,0,0,0,0,0,106000,0,0,0,106000,0,106000,106000
058074,欣興凱基99購01  ,0,0,0,0,0,0,0,0,0,106000,0,0,0,108000,2000,106000,106000
060428,瑞祺永豐9A購01  ,0,0,0,0,0,0,0,0,0,106000,0,0,0,375000,269000,106000,106000
07690P,華新科元大9A售15,0,0,0,0,0,0,0,0,0,106000,0,0,0,106000,0,106000,106000
056572,義隆元大99購01  ,0,0,0,0,0,0,0,0,0,105000,0,0,0,136000,31000,105000,105000
055562,欣興凱基97購06  ,0,0,0,0,0,0,0,0,0,105000,0,0,0,105000,0,105000,105000
058611,欣興元大99購06  ,0,0,0,0,0,0,0,0,0,105000,0,0,0,108000,3000,105000,105000
07805P,義隆永豐9A售02  ,0,0,0,0,0,0,0,0,0,105000,0,0,0,176000,71000,105000,105000
061122,敬鵬永豐9A購01  ,0,0,0,0,0,0,0,0,0,105000,0,0,0,135000,30000,105000,105000
07754P,日月光元大9A售02,0,0,0,0,0,0,0,0,0,105000,0,0,0,105000,0,105000,105000
061542,旺宏群益9A購04  ,0,0,0,0,0,0,0,0,0,104000,0,0,0,104000,0,104000,104000
06425P,TPK永豐97售02   ,0,0,0,0,0,0,0,0,0,104000,0,0,0,104000,0,104000,104000
054876,群電群益97購02  ,0,0,0,0,0,0,0,0,0,104000,0,0,0,145000,41000,104000,104000
058951,南電群益99購01  ,0,0,0,0,0,0,0,0,0,104000,0,0,0,160000,56000,104000,104000
059044,聯電日盛99購02  ,0,0,0,0,0,0,0,0,0,104000,0,0,0,200000,96000,104000,104000
057602,聯茂群益98購02  ,0,0,0,0,0,0,0,0,0,104000,0,0,0,146000,42000,104000,104000
063334,復盛國票9B購01  ,0,0,0,0,0,0,0,0,0,103000,0,0,0,137000,34000,103000,103000
055449,超眾統一9A購01  ,0,0,0,0,0,0,0,0,0,103000,0,0,0,110000,7000,103000,103000
052546,友達中信98購01  ,0,0,0,0,0,0,0,0,0,103000,0,0,0,123000,20000,103000,103000
05729P,臺股指凱基97售02,0,0,0,0,0,0,0,0,0,103000,0,0,0,129000,26000,103000,103000
058143,瑞儀元大99購02  ,0,0,0,0,0,0,0,0,0,103000,0,0,0,108000,5000,103000,103000
061085,聯茂兆豐9A購01  ,0,0,0,0,0,0,0,0,0,103000,0,0,0,113000,10000,103000,103000
07588P,滬深2X國票9C售01,0,0,0,0,0,0,0,0,0,103000,0,0,0,273000,170000,103000,103000
2474,可成            ,2873711,2981892,-108181,0,0,0,105000,16000,89000,122000,46000,14000,32000,99000,9000,90000,102819
063136,智邦統一9B購02  ,0,0,0,0,0,0,0,0,0,102000,0,0,0,355000,253000,102000,102000
062339,瑞昱麥證9C購01  ,0,0,0,127000,20000,107000,0,0,0,102000,0,0,0,147000,45000,102000,102000
00636,國泰中國A50     ,0,110000,-110000,0,0,0,0,0,0,212000,49000,0,49000,237000,74000,163000,102000
058585,S&P正2中信9B購02,0,0,0,0,0,0,0,0,0,102000,0,0,0,122000,20000,102000,102000
2537,聯上發          ,108000,6000,102000,0,0,0,0,0,0,0,0,0,0,0,0,0,102000
07410P,鴻海元大99售44  ,0,0,0,0,0,0,0,0,0,102000,0,0,0,122000,20000,102000,102000
2379,瑞昱            ,3391636,3358512,33124,0,0,0,0,0,0,68000,100000,52000,48000,78000,58000,20000,101124
062148,奇鋐國票9B購01  ,0,0,0,0,0,0,0,0,0,101000,0,0,0,101000,0,101000,101000
062086,瑞祺元大9B購01  ,0,0,0,0,0,0,0,0,0,101000,0,0,0,257000,156000,101000,101000
061586,智邦富邦9A購02  ,0,0,0,0,0,0,0,0,0,101000,0,0,0,101000,0,101000,101000
061661,京鼎永豐9A購02  ,0,0,0,0,0,0,0,0,0,101000,0,0,0,114000,13000,101000,101000
055923,矽力凱基98購01  ,0,0,0,0,0,0,0,0,0,101000,0,0,0,187000,86000,101000,101000
057240,茂林凱基9A購01  ,0,0,0,0,0,0,0,0,0,101000,0,0,0,131000,30000,101000,101000
3042,晶技            ,2884000,2665000,219000,0,0,0,4000,0,4000,-122000,71000,164000,-93000,15000,44000,-29000,101000
061709,SP黃豆凱基01購02,0,0,0,0,0,0,0,0,0,100000,0,0,0,100000,0,100000,100000
061873,友達元大9C購07  ,0,0,0,0,0,0,0,0,0,100000,0,0,0,100000,0,100000,100000
061829,T50反1凱基9C購02,0,0,0,0,0,0,0,0,0,100000,0,0,0,100000,0,100000,100000
062622,南電元大9B購03  ,0,0,0,0,0,0,0,0,0,100000,0,0,0,100000,0,100000,100000
062543,華通富邦9C購01  ,0,0,0,0,0,0,0,0,0,100000,0,0,0,647000,547000,100000,100000
06434P,超眾群益98售02  ,0,0,0,0,0,0,0,0,0,100000,0,0,0,250000,150000,100000,100000
06553P,訊芯元大98售05  ,0,0,0,0,0,0,0,0,0,100000,0,0,0,100000,0,100000,100000
06636P,可成凱基98售08  ,0,0,0,0,0,0,0,0,0,100000,0,0,0,100000,0,100000,100000
07123P,鴻海元大99售23  ,0,0,0,0,0,0,0,0,0,100000,0,0,0,100000,0,100000,100000
06706P,智原台新98售02  ,0,0,0,0,0,0,0,0,0,100000,0,0,0,100000,0,100000,100000
06848P,聯詠元大98售04  ,0,0,0,0,0,0,0,0,0,100000,0,0,0,160000,60000,100000,100000
06884P,台郡群益98售03  ,0,0,0,0,0,0,0,0,0,100000,0,0,0,100000,0,100000,100000
06867P,訊芯元大98售08  ,0,0,0,0,0,0,0,0,0,100000,0,0,0,150000,50000,100000,100000
053770,元金2X元大98購01,0,0,0,0,0,0,0,0,0,100000,0,0,0,100000,0,100000,100000
052771,GIS群益96購01   ,0,0,0,0,0,0,0,0,0,100000,0,0,0,100000,0,100000,100000
052997,國巨康和96購01  ,0,0,0,0,0,0,0,0,0,100000,0,0,0,100000,0,100000,100000
053584,友達元大9B購02  ,0,0,0,0,0,0,0,0,0,100000,0,0,0,100000,0,100000,100000
052203,T50反1中信99購03,0,0,0,0,0,0,0,0,0,100000,0,0,0,185000,85000,100000,100000
047904,臺指反元大96購01,0,0,0,0,0,0,0,0,0,100000,0,0,0,100000,0,100000,100000
054301,楠梓電凱基98購01,0,0,0,0,0,0,0,0,0,100000,0,0,0,100000,0,100000,100000
049272,世紀鋼元大96購02,0,0,0,0,0,0,0,0,0,100000,0,0,0,100000,0,100000,100000
055456,上銀富邦99購01  ,0,0,0,0,0,0,0,0,0,100000,0,0,0,100000,0,100000,100000
055397,超眾統一97購02  ,0,0,0,0,0,0,0,0,0,100000,0,0,0,100000,0,100000,100000
055373,聯詠元大97購03  ,0,0,0,0,0,0,0,0,0,100000,0,0,0,100000,0,100000,100000
05565P,鎧勝元大96售01  ,0,0,0,0,0,0,0,0,0,100000,0,0,0,100000,0,100000,100000
055611,燿華國票98購02  ,0,0,0,0,0,0,0,0,0,100000,0,0,0,100000,0,100000,100000
056231,嘉聯益凱基97購02,0,0,0,0,0,0,0,0,0,100000,0,0,0,110000,10000,100000,100000
054891,聯鈞統一99購02  ,0,0,0,0,0,0,0,0,0,100000,0,0,0,100000,0,100000,100000
056035,鴻海凱基97購06  ,0,0,0,0,0,0,0,0,0,100000,0,0,0,100000,0,100000,100000
056148,臺股指日盛97購03,0,0,0,0,0,0,0,0,0,100000,0,0,0,100000,0,100000,100000
054921,文曄凱基97購01  ,0,0,0,0,0,0,0,0,0,100000,0,0,0,100000,0,100000,100000
054961,玉晶光元大99購01,0,0,0,0,0,0,0,0,0,100000,0,0,0,100000,0,100000,100000
054947,興勤元大97購01  ,0,0,0,0,0,0,0,0,0,100000,0,0,0,100000,0,100000,100000
057422,欣興凱基98購04  ,0,0,0,0,0,0,0,0,0,100000,0,0,0,100000,0,100000,100000
057545,國巨凱基99購05  ,0,0,0,0,0,0,0,0,0,100000,0,0,0,100000,0,100000,100000
060036,上証2X國票99購03,0,0,0,0,0,0,0,0,0,100000,0,0,0,100000,0,100000,100000
058546,玉晶光富邦9B購01,0,0,0,0,0,0,0,0,0,100000,0,0,0,100000,0,100000,100000
058479,亞光凱基9A購01  ,0,0,0,0,0,0,0,0,0,100000,0,0,0,100000,0,100000,100000
058493,台積電群益9A購01,0,0,0,0,0,0,0,0,0,100000,0,0,0,100000,0,100000,100000
059034,華通群益9B購02  ,0,0,0,0,0,0,0,0,0,100000,0,0,0,100000,0,100000,100000
07417P,聯發科元大99售44,0,0,0,0,0,0,0,0,0,100000,0,0,0,100000,0,100000,100000
07402P,瑞昱凱基99售02  ,0,0,0,0,0,0,0,0,0,100000,0,0,0,100000,0,100000,100000
07368P,國巨凱基99售19  ,0,0,0,0,0,0,0,0,0,100000,0,0,0,100000,0,100000,100000
07322P,鴻海元大99售33  ,0,0,0,0,0,0,0,0,0,100000,0,0,0,100000,0,100000,100000
07632P,臺股指凱基9A售14,0,0,0,0,0,0,0,0,0,100000,0,0,0,100000,0,100000,100000
07614P,華新科群益9A售04,0,0,0,0,0,0,0,0,0,100000,0,0,0,100000,0,100000,100000
07651P,道瓊指中信01售01,0,0,0,0,0,0,0,0,0,100000,0,0,0,100000,0,100000,100000
07703P,玉晶光中信9B售03,0,0,0,0,0,0,0,0,0,100000,0,0,0,100000,0,100000,100000
07943P,瑞昱元大9B售02  ,0,0,0,0,0,0,0,0,0,100000,0,0,0,100000,0,100000,100000
07893P,臺股指國票9B售03,0,0,0,0,0,0,0,0,0,100000,0,0,0,100000,0,100000,100000
060957,SP黃豆凱基9A購04,0,0,0,0,0,0,0,0,0,100000,0,0,0,100000,0,100000,100000
07025P,玉晶光凱基99售01,0,0,0,0,0,0,0,0,0,99000,0,0,0,99000,0,99000,99000
062781,微星元大9C購01  ,0,0,0,0,0,0,0,0,0,99000,0,0,0,119000,20000,99000,99000
059876,智易凱基99購02  ,0,0,0,0,0,0,0,0,0,99000,0,0,0,105000,6000,99000,99000
054300,華通凱基96購07  ,0,0,0,0,0,0,0,0,0,99000,0,0,0,99000,0,99000,99000
054015,晶豪科永豐96購03,0,0,0,0,0,0,0,0,0,99000,0,0,0,99000,0,99000,99000
059168,奇力新凱基99購05,0,0,0,0,0,0,0,0,0,99000,0,0,0,102000,3000,99000,99000
060423,智易永豐9A購01  ,0,0,0,0,0,0,0,0,0,99000,0,0,0,106000,7000,99000,99000
060360,南亞科元富9A購02,0,0,0,0,0,0,0,0,0,99000,0,0,0,245000,146000,99000,99000
05758P,光罩永豐96售02  ,0,0,0,0,0,0,0,0,0,99000,0,0,0,228000,129000,99000,99000
07149P,健鼎元大99售03  ,0,0,0,0,0,0,0,0,0,99000,0,0,0,110000,11000,99000,99000
07174P,臺股指國票99售11,0,0,0,0,0,0,0,0,0,99000,0,0,0,481000,382000,99000,99000
2472,立隆電          ,155000,53000,102000,0,0,0,0,0,0,-3000,3000,6000,-3000,0,0,0,99000
1720,生達            ,306000,195000,111000,0,0,0,0,0,0,-12000,0,12000,-12000,0,0,0,99000
062460,京鼎群益9C購01  ,0,0,0,0,0,0,0,0,0,98000,0,0,0,118000,20000,98000,98000
062661,華通群益9B購05  ,0,0,0,0,0,0,0,0,0,98000,0,0,0,98000,0,98000,98000
062669,微星中信03購01  ,0,0,0,0,0,0,0,0,0,98000,0,0,0,231000,133000,98000,98000
062275,燿華群益9B購01  ,0,0,0,0,0,0,0,0,0,98000,0,0,0,103000,5000,98000,98000
061903,宏全永豐9B購01  ,0,0,0,0,0,0,0,0,0,98000,0,0,0,166000,68000,98000,98000
056842,全新元富98購01  ,0,0,0,0,0,0,0,0,0,98000,0,0,0,98000,0,98000,98000
054205,華新國票97購02  ,0,0,0,0,0,0,0,0,0,98000,0,0,0,98000,0,98000,98000
058250,台虹元大99購01  ,0,0,0,0,0,0,0,0,0,98000,0,0,0,273000,175000,98000,98000
2471,資通            ,124000,25000,99000,0,0,0,0,0,0,-1000,0,1000,-1000,0,0,0,98000
2905,三商            ,264000,166000,98000,0,0,0,0,0,0,0,0,0,0,0,0,0,98000
061543,南亞科群益9A購01,0,0,0,0,0,0,0,0,0,97000,0,0,0,99000,2000,97000,97000
06973P,臺股指元大9A售11,0,0,0,0,0,0,0,0,0,97000,0,0,0,100000,3000,97000,97000
060083,和大元大99購02  ,0,0,0,0,0,0,0,0,0,97000,0,0,0,122000,25000,97000,97000
059236,鴻海凱基99購09  ,0,0,0,0,0,0,0,0,0,97000,0,0,0,100000,3000,97000,97000
059121,瑞儀永豐99購01  ,0,0,0,0,0,0,0,0,0,97000,0,0,0,103000,6000,97000,97000
057181,亞光元大98購02  ,0,0,0,0,0,0,0,0,0,97000,0,0,0,165000,68000,97000,97000
3669,圓展            ,141000,44000,97000,0,0,0,0,0,0,0,0,0,0,0,0,0,97000
056092,亞德客元富97購02,0,0,0,0,0,0,0,0,0,96000,0,0,0,103000,7000,96000,96000
07793P,同欣電元大9A售02,0,0,0,0,0,0,0,0,0,96000,0,0,0,220000,124000,96000,96000
060361,南亞科元富9A購03,0,0,0,0,0,0,0,0,0,96000,0,0,0,96000,0,96000,96000
07171P,臺股指國票99售08,0,0,0,0,0,0,0,0,0,96000,0,0,0,106000,10000,96000,96000
06566P,華通永豐98售03  ,0,0,0,0,0,0,0,0,0,95000,0,0,0,105000,10000,95000,95000
06514P,國巨凱基98售05  ,0,0,0,0,0,0,0,0,0,95000,0,0,0,95000,0,95000,95000
063008,華通元大9B購06  ,0,0,0,0,0,0,0,0,0,95000,0,0,0,104000,9000,95000,95000
063228,聯茂群益9B購01  ,0,0,0,0,0,0,0,0,0,95000,0,0,0,96000,1000,95000,95000
056101,光磊永豐98購01  ,0,0,0,0,0,0,0,0,0,95000,0,0,0,163000,68000,95000,95000
060285,聯電元大9C購01  ,0,0,0,0,0,0,0,0,0,95000,0,0,0,170000,75000,95000,95000
061394,FBVIX統一9B購01 ,0,0,0,0,0,0,0,0,0,95000,0,0,0,105000,10000,95000,95000
059096,百和元大99購04  ,0,0,0,0,0,0,0,0,0,95000,0,0,0,95000,0,95000,95000
060626,貿聯元大9A購04  ,0,0,0,0,0,0,0,0,0,95000,0,0,0,205000,110000,95000,95000
063041,貿聯凱基9B購01  ,0,0,0,0,0,0,0,0,0,94000,0,0,0,173000,79000,94000,94000
061768,晶技元大9B購02  ,0,0,0,0,0,0,0,0,0,94000,0,0,0,94000,0,94000,94000
058936,國喬中信99購01  ,0,0,0,0,0,0,0,0,0,94000,0,0,0,110000,16000,94000,94000
3518,柏騰            ,152000,60000,92000,0,0,0,0,0,0,2000,2000,0,2000,0,0,0,94000
061417,力成群益9A購01  ,0,0,0,0,0,0,0,0,0,93000,0,0,0,98000,5000,93000,93000
062987,祥碩中信01購01  ,0,0,0,0,0,0,0,0,0,93000,0,0,0,93000,0,93000,93000
056124,華通國票98購02  ,0,0,0,0,0,0,0,0,0,93000,0,0,0,98000,5000,93000,93000
059926,世紀鋼國泰9B購01,0,0,0,0,0,0,0,0,0,93000,0,0,0,104000,11000,93000,93000
058078,景碩國票99購01  ,0,0,0,0,0,0,0,0,0,93000,0,0,0,93000,0,93000,93000
07173P,臺股指國票99售10,0,0,0,0,0,0,0,0,0,93000,0,0,0,272000,179000,93000,93000
062883,智易兆豐9C購01  ,0,0,0,0,0,0,0,0,0,92000,0,0,0,123000,31000,92000,92000
061660,禾伸堂永豐9A購01,0,0,0,0,0,0,0,0,0,92000,0,0,0,97000,5000,92000,92000
059950,百和永豐99購02  ,0,0,0,0,0,0,0,0,0,92000,0,0,0,92000,0,92000,92000
057102,亞光中信9A購01  ,0,0,0,0,0,0,0,0,0,92000,0,0,0,92000,0,92000,92000
055605,緯穎元大97購02  ,0,0,0,0,0,0,0,0,0,92000,0,0,0,142000,50000,92000,92000
053048,同欣電麥證96購01,0,0,0,92000,0,92000,0,0,0,92000,0,0,0,92000,0,92000,92000
060560,欣興國泰9C購01  ,0,0,0,0,0,0,0,0,0,92000,0,0,0,121000,29000,92000,92000
07999P,台達電凱基9B售02,0,0,0,0,0,0,0,0,0,92000,0,0,0,102000,10000,92000,92000
2453,凌群            ,163000,60000,103000,0,0,0,0,0,0,-11000,0,11000,-11000,0,0,0,92000
060986,聯發科元大9A購07,0,0,0,0,0,0,0,0,0,92000,0,0,0,96000,4000,92000,92000
061696,南茂群益9A購01  ,0,0,0,0,0,0,0,0,0,91000,0,0,0,219000,128000,91000,91000
062590,亞光統一9B購01  ,0,0,0,0,0,0,0,0,0,91000,0,0,0,139000,48000,91000,91000
062415,聯茂中信9C購01  ,0,0,0,0,0,0,0,0,0,91000,0,0,0,91000,0,91000,91000
063516,香港反凱基03購01,0,0,0,0,0,0,0,0,0,91000,0,0,0,1100000,1009000,91000,91000
055988,矽力元富97購01  ,0,0,0,0,0,0,0,0,0,91000,0,0,0,130000,39000,91000,91000
058637,晶技兆豐99購01  ,0,0,0,0,0,0,0,0,0,91000,0,0,0,112000,21000,91000,91000
6533,晶心科          ,104000,36000,68000,0,0,0,0,0,0,23000,23000,0,23000,0,0,0,91000
08037P,台表科群益9B售02,0,0,0,0,0,0,0,0,0,91000,0,0,0,119000,28000,91000,91000
07256P,臺股指凱基99售36,0,0,0,0,0,0,0,0,0,91000,0,0,0,91000,0,91000,91000
062910,亞光元大9B購01  ,0,0,0,0,0,0,0,0,0,90000,0,0,0,90000,0,90000,90000
062930,旺宏統一9C購02  ,0,0,0,0,0,0,0,0,0,90000,0,0,0,90000,0,90000,90000
055962,晶豪科元大97購02,0,0,0,0,0,0,0,0,0,90000,0,0,0,90000,0,90000,90000
053029,國巨第一96購01  ,0,0,0,0,0,0,0,0,0,90000,0,0,0,140000,50000,90000,90000
052983,國巨元大96購07  ,0,0,0,0,0,0,0,0,0,90000,0,0,0,90000,0,90000,90000
055098,臺股指群益97購01,0,0,0,0,0,0,0,0,0,90000,0,0,0,90000,0,90000,90000
056136,京鼎元大98購01  ,0,0,0,0,0,0,0,0,0,90000,0,0,0,156000,66000,90000,90000
056398,南茂永豐98購01  ,0,0,0,0,0,0,0,0,0,90000,0,0,0,300000,210000,90000,90000
056349,道瓊銀元大9B購01,0,0,0,0,0,0,0,0,0,90000,0,0,0,90000,0,90000,90000
061202,和大元大9A購02  ,0,0,0,0,0,0,0,0,0,90000,0,0,0,174000,84000,90000,90000
063229,台表科群益9B購04,0,0,0,0,0,0,0,0,0,89000,0,0,0,105000,16000,89000,89000
06938P,南電元大98售03  ,0,0,0,0,0,0,0,0,0,89000,0,0,0,89000,0,89000,89000
062730,致伸凱基9B購01  ,0,0,0,0,0,0,0,0,0,89000,0,0,0,99000,10000,89000,89000
061646,力成元大9A購02  ,0,0,0,0,0,0,0,0,0,89000,0,0,0,108000,19000,89000,89000
061471,台積電元大9A購31,0,0,0,0,0,0,0,0,0,89000,0,0,0,105000,16000,89000,89000
059849,興勤永豐99購01  ,5000,0,5000,0,0,0,0,0,0,84000,0,0,0,167000,83000,84000,89000
052614,聯電國泰97購01  ,0,0,0,0,0,0,0,0,0,89000,0,0,0,89000,0,89000,89000
02001R,富邦蘋果反一N   ,0,0,0,0,0,0,0,0,0,89000,0,0,0,119000,30000,89000,89000
060169,群電永豐9A購01  ,0,0,0,0,0,0,0,0,0,89000,0,0,0,92000,3000,89000,89000
07513P,台積電元大9A售13,0,0,0,0,0,0,0,0,0,89000,0,0,0,89000,0,89000,89000
07952P,富邦金元大9B售02,0,0,0,0,0,0,0,0,0,89000,0,0,0,89000,0,89000,89000
062345,和大群益9B購01  ,0,0,0,0,0,0,0,0,0,88000,0,0,0,88000,0,88000,88000
06928P,鴻海元大99售10  ,0,0,0,0,0,0,0,0,0,88000,0,0,0,120000,32000,88000,88000
062833,世芯群益9B購01  ,0,0,0,0,0,0,0,0,0,88000,0,0,0,98000,10000,88000,88000
054090,瑞昱群益97購01  ,0,0,0,0,0,0,0,0,0,88000,0,0,0,120000,32000,88000,88000
060115,南電元大99購06  ,0,0,0,0,0,0,0,0,0,88000,0,0,0,165000,77000,88000,88000
056755,聯茂兆豐98購01  ,0,0,0,0,0,0,0,0,0,88000,0,0,0,88000,0,88000,88000
055133,致新康和97購01  ,0,0,0,0,0,0,0,0,0,88000,0,0,0,88000,0,88000,88000
055388,華通統一97購03  ,0,0,0,0,0,0,0,0,0,88000,0,0,0,88000,0,88000,88000
058229,為升元大99購02  ,0,0,0,0,0,0,0,0,0,88000,0,0,0,88000,0,88000,88000
058685,TPK凱基99購01   ,0,0,0,0,0,0,0,0,0,88000,0,0,0,112000,24000,88000,88000
057886,聯詠群益98購01  ,0,0,0,0,0,0,0,0,0,88000,0,0,0,134000,46000,88000,88000
058456,京鼎永豐99購01  ,0,0,0,0,0,0,0,0,0,88000,0,0,0,101000,13000,88000,88000
058397,大成鋼元大99購02,0,0,0,0,0,0,0,0,0,88000,0,0,0,362000,274000,88000,88000
07944P,華新科元大9B售08,0,0,0,0,0,0,0,0,0,88000,0,0,0,108000,20000,88000,88000
07534P,台灣50群益9A售12,0,0,0,0,0,0,0,0,0,88000,0,0,0,100000,12000,88000,88000
1795,美時            ,282000,199000,83000,0,0,0,0,0,0,5000,5000,0,5000,0,0,0,88000
4119,旭富            ,333615,188000,145615,0,0,0,0,70000,-70000,12000,0,0,0,17000,5000,12000,87615
062917,旭富元大9C購03  ,0,0,0,0,0,0,0,0,0,87000,0,0,0,110000,23000,87000,87000
062305,遠東新凱基9B購01,0,0,0,0,0,0,0,0,0,87000,0,0,0,87000,0,87000,87000
056378,欣興元富98購01  ,0,0,0,0,0,0,0,0,0,87000,0,0,0,185000,98000,87000,87000
056477,欣興元大98購02  ,0,0,0,0,0,0,0,0,0,87000,0,0,0,99000,12000,87000,87000
059856,昇陽半永豐99購03,0,0,0,0,0,0,0,0,0,87000,0,0,0,87000,0,87000,87000
3708,上緯投控        ,158000,50000,108000,0,0,0,0,0,0,-21000,0,0,0,0,21000,-21000,87000
07647P,健策國票9A售04  ,0,0,0,0,0,0,0,0,0,87000,0,0,0,222000,135000,87000,87000
07252P,台灣50凱基99售01,0,0,0,0,0,0,0,0,0,87000,0,0,0,87000,0,87000,87000
07760P,力山永豐9A售03  ,0,0,0,0,0,0,0,0,0,87000,0,0,0,87000,0,87000,87000
061516,力成永豐9A購02  ,0,0,0,0,0,0,0,0,0,86000,0,0,0,86000,0,86000,86000
062766,台郡凱基9B購02  ,0,0,0,0,0,0,0,0,0,86000,0,0,0,196000,110000,86000,86000
06615P,鴻海元大9C售02  ,0,0,0,0,0,0,0,0,0,86000,0,0,0,96000,10000,86000,86000
055320,建準國票98購01  ,0,0,0,0,0,0,0,0,0,86000,0,0,0,86000,0,86000,86000
059640,聯詠凱基99購04  ,0,0,0,0,0,0,0,0,0,86000,0,0,0,106000,20000,86000,86000
060129,祥碩永豐99購03  ,0,0,0,0,0,0,0,0,0,86000,0,0,0,87000,1000,86000,86000
07977P,華新科群益01售01,0,0,0,0,0,0,0,0,0,86000,0,0,0,96000,10000,86000,86000
08159P,日月光元富9B售01,0,0,0,0,0,0,0,0,0,86000,0,0,0,86000,0,86000,86000
2838,聯邦銀          ,402000,316610,85390,0,0,0,0,0,0,0,0,0,0,0,0,0,85390
062868,葡萄王中信9B購01,0,0,0,0,0,0,0,0,0,85000,0,0,0,85000,0,85000,85000
062958,長榮航麥證9B購01,0,0,0,85000,0,85000,0,0,0,85000,0,0,0,85000,0,85000,85000
063356,台表科元富02購01,0,0,0,0,0,0,0,0,0,85000,0,0,0,220000,135000,85000,85000
063323,同欣電群益9B購03,0,0,0,0,0,0,0,0,0,85000,0,0,0,85000,0,85000,85000
061678,玉晶光元大9B購04,0,0,0,0,0,0,0,0,0,85000,0,0,0,85000,0,85000,85000
061826,台郡麥證9B購01  ,0,0,0,85000,0,85000,0,0,0,85000,0,0,0,85000,0,85000,85000
062276,瑞昱群益9B購01  ,0,0,0,0,0,0,0,0,0,85000,0,0,0,137000,52000,85000,85000
062399,神基永豐9B購01  ,0,0,0,0,0,0,0,0,0,85000,0,0,0,85000,0,85000,85000
03603P,群創凱基98售04  ,0,0,0,0,0,0,0,0,0,85000,0,0,0,85000,0,85000,85000
054357,可成兆豐97購02  ,0,0,0,0,0,0,0,0,0,85000,0,0,0,115000,30000,85000,85000
05131P,聯詠統一97售01  ,0,0,0,0,0,0,0,0,0,85000,0,0,0,85000,0,85000,85000
058201,華通凱基9A購01  ,0,0,0,0,0,0,0,0,0,85000,0,0,0,85000,0,85000,85000
057527,億光元大98購01  ,0,0,0,0,0,0,0,0,0,85000,0,0,0,140000,55000,85000,85000
058422,百和麥證99購01  ,0,0,0,140000,55000,85000,0,0,0,85000,0,0,0,140000,55000,85000,85000
058118,瑞昱群益99購01  ,0,0,0,0,0,0,0,0,0,85000,0,0,0,174000,89000,85000,85000
061165,美律兆豐9A購01  ,0,0,0,0,0,0,0,0,0,85000,0,0,0,100000,15000,85000,85000
07312P,台灣50元大99售10,0,0,0,0,0,0,0,0,0,85000,0,0,0,96000,11000,85000,85000
062188,貿聯元大9B購02  ,0,0,0,0,0,0,0,0,0,84000,0,0,0,105000,21000,84000,84000
059923,緯穎元大99購09  ,0,0,0,0,0,0,0,0,0,84000,0,0,0,86000,2000,84000,84000
056557,世紀鋼凱基98購02,0,0,0,0,0,0,0,0,0,84000,0,0,0,84000,0,84000,84000
057465,智易永豐98購02  ,0,0,0,0,0,0,0,0,0,84000,0,0,0,141000,57000,84000,84000
058746,華通凱基9A購02  ,0,0,0,0,0,0,0,0,0,84000,0,0,0,94000,10000,84000,84000
08112P,臺股指中信01售07,0,0,0,0,0,0,0,0,0,84000,0,0,0,84000,0,84000,84000
4927,泰鼎-KY         ,474000,368000,106000,0,0,0,0,104000,-104000,82000,30000,20000,10000,80000,8000,72000,84000
062213,和大統一9B購02  ,0,0,0,0,0,0,0,0,0,83000,0,0,0,138000,55000,83000,83000
061470,鈺齊群益9A購02  ,0,0,0,0,0,0,0,0,0,83000,0,0,0,117000,34000,83000,83000
07005P,台積電統一9B售05,0,0,0,0,0,0,0,0,0,83000,0,0,0,163000,80000,83000,83000
057105,致茂群益9A購01  ,0,0,0,0,0,0,0,0,0,83000,0,0,0,83000,0,83000,83000
056083,億光統一97購03  ,0,0,0,0,0,0,0,0,0,83000,0,0,0,131000,48000,83000,83000
058195,鈺齊永豐99購01  ,0,0,0,0,0,0,0,0,0,83000,0,0,0,83000,0,83000,83000
058149,百和元大99購02  ,0,0,0,0,0,0,0,0,0,83000,0,0,0,191000,108000,83000,83000
1730,花仙子          ,160000,77000,83000,0,0,0,0,0,0,0,0,0,0,0,0,0,83000
3545,敦泰            ,716000,633500,82500,0,0,0,0,0,0,0,0,0,0,0,0,0,82500
07129P,華新科元大99售14,0,0,0,0,0,0,0,0,0,82000,0,0,0,202000,120000,82000,82000
054260,貿聯元大96購03  ,0,0,0,0,0,0,0,0,0,82000,0,0,0,150000,68000,82000,82000
059004,嘉晶元大99購05  ,0,0,0,0,0,0,0,0,0,82000,0,0,0,140000,58000,82000,82000
058012,鈺齊國票99購01  ,0,0,0,0,0,0,0,0,0,82000,0,0,0,126000,44000,82000,82000
061270,彩晶凱基9A購02  ,0,0,0,0,0,0,0,0,0,82000,0,0,0,102000,20000,82000,82000
060528,友達中信9C購01  ,0,0,0,0,0,0,0,0,0,82000,0,0,0,137000,55000,82000,82000
060156,光磊永豐9A購01  ,0,0,0,0,0,0,0,0,0,82000,0,0,0,137000,55000,82000,82000
6582,申豐            ,86000,8000,78000,0,0,0,0,0,0,4000,11000,7000,4000,0,0,0,82000
06447P,上銀元大98售01  ,0,0,0,0,0,0,0,0,0,81000,0,0,0,149000,68000,81000,81000
062752,世芯中信9B購01  ,0,0,0,0,0,0,0,0,0,81000,0,0,0,81000,0,81000,81000
052137,台表科凱基96購02,0,0,0,0,0,0,0,0,0,81000,0,0,0,81000,0,81000,81000
056574,亞光元大99購03  ,0,0,0,0,0,0,0,0,0,81000,0,0,0,149000,68000,81000,81000
056423,奇鋐統一98購01  ,0,0,0,0,0,0,0,0,0,81000,0,0,0,91000,10000,81000,81000
060085,華通元大99購10  ,0,0,0,0,0,0,0,0,0,81000,0,0,0,82000,1000,81000,81000
060570,南亞科永豐9A購01,0,0,0,0,0,0,0,0,0,81000,0,0,0,81000,0,81000,81000
057641,旺宏元大98購10  ,0,0,0,0,0,0,0,0,0,81000,0,0,0,81000,0,81000,81000
061333,華通元大9A購08  ,0,0,0,0,0,0,0,0,0,81000,0,0,0,89000,8000,81000,81000
2013,中鋼構          ,101000,20000,81000,0,0,0,0,0,0,0,0,0,0,0,0,0,81000
08149P,祥碩群益9B售07  ,0,0,0,0,0,0,0,0,0,81000,0,0,0,111000,30000,81000,81000
062967,上銀元富9B購01  ,0,0,0,0,0,0,0,0,0,80000,0,0,0,147000,67000,80000,80000
061702,奇鋐國票9A購02  ,0,0,0,0,0,0,0,0,0,80000,0,0,0,80000,0,80000,80000
061945,華通群益9B購04  ,0,0,0,0,0,0,0,0,0,80000,0,0,0,87000,7000,80000,80000
059869,友達凱基99購07  ,0,0,0,0,0,0,0,0,0,80000,0,0,0,80000,0,80000,80000
055172,凱美統一97購02  ,0,0,0,0,0,0,0,0,0,80000,0,0,0,141000,61000,80000,80000
052069,聯茂兆豐96購01  ,0,0,0,0,0,0,0,0,0,80000,0,0,0,80000,0,80000,80000
054169,上緯控凱基98購01,0,0,0,0,0,0,0,0,0,80000,0,0,0,80000,0,80000,80000
052841,群創富邦96購02  ,0,0,0,0,0,0,0,0,0,80000,0,0,0,80000,0,80000,80000
061268,玉晶光凱基9B購04,0,0,0,0,0,0,0,0,0,80000,0,0,0,80000,0,80000,80000
05719P,可成元大96售03  ,0,0,0,0,0,0,0,0,0,80000,0,0,0,80000,0,80000,80000
058908,貿聯元大99購03  ,0,0,0,0,0,0,0,0,0,80000,0,0,0,140000,60000,80000,80000
060606,玉晶光凱基9A購05,0,0,0,0,0,0,0,0,0,80000,0,0,0,80000,0,80000,80000
060058,牧德凱基9B購01  ,0,0,0,0,0,0,0,0,0,80000,0,0,0,89000,9000,80000,80000
060311,盟立永豐9A購01  ,0,0,0,0,0,0,0,0,0,80000,0,0,0,80000,0,80000,80000
060158,廣達永豐9A購01  ,0,0,0,0,0,0,0,0,0,80000,0,0,0,129000,49000,80000,80000
07771P,義隆國票9A售01  ,0,0,0,0,0,0,0,0,0,80000,0,0,0,140000,60000,80000,80000
07746P,華新科凱基9A售11,0,0,0,0,0,0,0,0,0,80000,0,0,0,80000,0,80000,80000
07959P,健策永豐9B售05  ,0,0,0,0,0,0,0,0,0,80000,0,0,0,80000,0,80000,80000
1808,潤隆            ,309000,229000,80000,0,0,0,0,0,0,0,0,0,0,0,0,0,80000
06067P,華新科康和97售01,0,0,0,0,0,0,0,0,0,80000,0,0,0,120000,40000,80000,80000
060854,台積電富邦9C購08,0,0,0,0,0,0,0,0,0,80000,0,0,0,100000,20000,80000,80000
8482,商億-KY         ,87000,7000,80000,0,0,0,0,0,0,0,0,0,0,0,0,0,80000
06170P,禾伸堂元富97售02,0,0,0,0,0,0,0,0,0,79000,0,0,0,79000,0,79000,79000
062279,晶豪科群益9B購01,0,0,0,0,0,0,0,0,0,79000,0,0,0,98000,19000,79000,79000
06702P,智邦元富98售01  ,0,0,0,0,0,0,0,0,0,79000,0,0,0,90000,11000,79000,79000
06778P,台積電元大99售06,0,0,0,0,0,0,0,0,0,79000,0,0,0,100000,21000,79000,79000
052328,台表科中信99購01,0,0,0,0,0,0,0,0,0,79000,0,0,0,79000,0,79000,79000
061292,玉晶光統一01購06,0,0,0,0,0,0,0,0,0,79000,0,0,0,79000,0,79000,79000
059287,華通元富99購03  ,0,0,0,0,0,0,0,0,0,79000,0,0,0,79000,0,79000,79000
07121P,華新科凱基99售03,0,0,0,0,0,0,0,0,0,78000,0,0,0,78000,0,78000,78000
049255,旺宏元大97購02  ,0,0,0,0,0,0,0,0,0,78000,0,0,0,88000,10000,78000,78000
04788P,台積電永昌96售05,0,0,0,0,0,0,0,0,0,78000,0,0,0,78000,0,78000,78000
054075,GIS富邦97購02   ,0,0,0,0,0,0,0,0,0,78000,0,0,0,78000,0,78000,78000
056786,亞光群益98購03  ,0,0,0,0,0,0,0,0,0,78000,0,0,0,176000,98000,78000,78000
061289,玉晶光統一01購03,0,0,0,0,0,0,0,0,0,78000,0,0,0,109000,31000,78000,78000
058965,祥碩兆豐99購02  ,0,0,0,0,0,0,0,0,0,78000,0,0,0,78000,0,78000,78000
07845P,南亞科元大9A售08,0,0,0,0,0,0,0,0,0,78000,0,0,0,111000,33000,78000,78000
4977,眾達-KY         ,298000,212000,86000,0,0,0,0,0,0,-8000,3000,10000,-7000,0,1000,-1000,78000
061901,柏文永豐9B購01  ,0,0,0,0,0,0,0,0,0,77000,0,0,0,145000,68000,77000,77000
056787,健鼎群益98購01  ,0,0,0,0,0,0,0,0,0,77000,0,0,0,177000,100000,77000,77000
051428,玉晶光統一96購01,0,0,0,0,0,0,0,0,0,77000,0,0,0,210000,133000,77000,77000
00875,國泰網路資安    ,102000,0,102000,0,0,0,0,0,0,-25000,0,0,0,1533000,1558000,-25000,77000
056065,奇鋐元大97購01  ,0,0,0,0,0,0,0,0,0,77000,0,0,0,127000,50000,77000,77000
057781,國巨國票99購04  ,0,0,0,0,0,0,0,0,0,77000,0,0,0,77000,0,77000,77000
058651,FBVIX中信9C購01 ,0,0,0,0,0,0,0,0,0,77000,0,0,0,78000,1000,77000,77000
060744,鴻海國票9A購04  ,0,0,0,0,0,0,0,0,0,77000,0,0,0,198000,121000,77000,77000
07260P,台灣50元大9A售01,0,0,0,0,0,0,0,0,0,77000,0,0,0,77000,0,77000,77000
062385,玉晶光國泰01購01,0,0,0,0,0,0,0,0,0,76000,0,0,0,77000,1000,76000,76000
058425,S&P正2元富01購02,0,0,0,0,0,0,0,0,0,76000,0,0,0,76000,0,76000,76000
07872P,聯發科群益9B售03,0,0,0,0,0,0,0,0,0,76000,0,0,0,76000,0,76000,76000
061771,玉晶光元大9C購04,0,0,0,0,0,0,0,0,0,75000,0,0,0,75000,0,75000,75000
06959P,鴻海凱基9A售02  ,0,0,0,0,0,0,0,0,0,75000,0,0,0,75000,0,75000,75000
062969,旺宏元富9B購01  ,0,0,0,0,0,0,0,0,0,75000,0,0,0,75000,0,75000,75000
055525,國巨群益98購05  ,0,0,0,0,0,0,0,0,0,75000,0,0,0,86000,11000,75000,75000
052367,聯茂國票96購02  ,0,0,0,0,0,0,0,0,0,75000,0,0,0,75000,0,75000,75000
058577,南亞科群益99購02,0,0,0,0,0,0,0,0,0,75000,0,0,0,75000,0,75000,75000
057329,緯穎群益98購02  ,0,0,0,0,0,0,0,0,0,75000,0,0,0,402000,327000,75000,75000
057288,聯茂元大98購03  ,0,0,0,0,0,0,0,0,0,75000,0,0,0,85000,10000,75000,75000
07276P,臺股指群益99售19,0,0,0,0,0,0,0,0,0,75000,0,0,0,75000,0,75000,75000
1608,華榮            ,161000,86000,75000,0,0,0,0,0,0,0,0,0,0,0,0,0,75000
2617,台航            ,99000,24000,75000,0,0,0,0,0,0,0,0,0,0,0,0,0,75000
060981,旺宏元大9A購08  ,0,0,0,0,0,0,0,0,0,75000,0,0,0,75000,0,75000,75000
061003,南亞科兆豐9A購01,0,0,0,0,0,0,0,0,0,75000,0,0,0,75000,0,75000,75000
063028,巨大元大9B購02  ,0,0,0,0,0,0,0,0,0,74000,0,0,0,297000,223000,74000,74000
06600P,貿聯永豐98售01  ,0,0,0,0,0,0,0,0,0,74000,0,0,0,283000,209000,74000,74000
063463,瑞昱元大9B購05  ,0,0,0,0,0,0,0,0,0,74000,0,0,0,369000,295000,74000,74000
06151P,華新科元大97售07,0,0,0,0,0,0,0,0,0,74000,0,0,0,74000,0,74000,74000
062362,致茂元大9B購01  ,0,0,0,0,0,0,0,0,0,74000,0,0,0,105000,31000,74000,74000
062171,中磊永豐9B購01  ,0,0,0,0,0,0,0,0,0,74000,0,0,0,75000,1000,74000,74000
062610,啟碁凱基9B購01  ,0,0,0,0,0,0,0,0,0,74000,0,0,0,74000,0,74000,74000
00674R,元大S&P黃金反1  ,0,0,0,0,0,0,0,0,0,74000,0,0,0,104000,30000,74000,74000
055323,貿聯國票98購01  ,0,0,0,0,0,0,0,0,0,74000,0,0,0,74000,0,74000,74000
059867,華邦電凱基99購02,0,0,0,0,0,0,0,0,0,74000,0,0,0,75000,1000,74000,74000
056709,華通永豐98購01  ,0,0,0,0,0,0,0,0,0,74000,0,0,0,74000,0,74000,74000
05884P,旺宏統一96售01  ,0,0,0,0,0,0,0,0,0,74000,0,0,0,147000,73000,74000,74000
07791P,奇鋐元大9A售02  ,0,0,0,0,0,0,0,0,0,74000,0,0,0,250000,176000,74000,74000
07509P,牧德國票9A售03  ,0,0,0,0,0,0,0,0,0,74000,0,0,0,104000,30000,74000,74000
08040P,臺股指群益9B售13,0,0,0,0,0,0,0,0,0,74000,0,0,0,152000,78000,74000,74000
062856,世芯永豐9B購02  ,0,0,0,0,0,0,0,0,0,73000,0,0,0,73000,0,73000,73000
056565,欣興群益98購03  ,0,0,0,0,0,0,0,0,0,73000,0,0,0,83000,10000,73000,73000
05606P,TPK國票97售02   ,0,0,0,0,0,0,0,0,0,73000,0,0,0,73000,0,73000,73000
056996,矽力日盛99購01  ,0,0,0,0,0,0,0,0,0,73000,0,0,0,159000,86000,73000,73000
058144,聯茂元大99購02  ,0,0,0,0,0,0,0,0,0,73000,0,0,0,160000,87000,73000,73000
08058P,華新科元大9B售10,0,0,0,0,0,0,0,0,0,73000,0,0,0,73000,0,73000,73000
3530,晶相光          ,97000,38000,59000,0,0,0,0,0,0,14000,0,0,0,21000,7000,14000,73000
060640,京鼎永豐9A購01  ,0,0,0,0,0,0,0,0,0,73000,0,0,0,74000,1000,73000,73000
6214,精誠            ,772000,758000,14000,0,0,0,0,0,0,59000,60000,1000,59000,0,0,0,73000
062994,祥碩群益9B購05  ,0,0,0,0,0,0,0,0,0,72000,0,0,0,74000,2000,72000,72000
063458,正隆元大9B購01  ,0,0,0,0,0,0,0,0,0,72000,0,0,0,77000,5000,72000,72000
06654P,欣興元大98售08  ,0,0,0,0,0,0,0,0,0,72000,0,0,0,72000,0,72000,72000
062437,廣達元大9B購01  ,0,0,0,0,0,0,0,0,0,72000,0,0,0,112000,40000,72000,72000
062203,燿華國票9C購01  ,0,0,0,0,0,0,0,0,0,72000,0,0,0,92000,20000,72000,72000
062410,台積電第一9B購02,0,0,0,0,0,0,0,0,0,72000,0,0,0,72000,0,72000,72000
054400,健策永豐96購02  ,0,0,0,0,0,0,0,0,0,72000,0,0,0,112000,40000,72000,72000
061351,智伸科元大9A購01,0,0,0,0,0,0,0,0,0,72000,0,0,0,132000,60000,72000,72000
058736,鈺齊永豐99購02  ,0,0,0,0,0,0,0,0,0,72000,0,0,0,72000,0,72000,72000
060376,瑞祺元富9A購01  ,0,0,0,0,0,0,0,0,0,72000,0,0,0,337000,265000,72000,72000
6141,柏承            ,96000,24000,72000,0,0,0,0,0,0,0,0,0,0,0,0,0,72000
3504,揚明光          ,84000,24000,60000,0,0,0,0,0,0,12000,3000,0,3000,9000,0,9000,72000
060846,欣興國票9A購02  ,0,0,0,0,0,0,0,0,0,72000,0,0,0,98000,26000,72000,72000
08122P,晶技國票9C售01  ,0,0,0,0,0,0,0,0,0,72000,0,0,0,118000,46000,72000,72000
08129P,聯發科元大9B售23,0,0,0,0,0,0,0,0,0,72000,0,0,0,72000,0,72000,72000
07164P,臺股指群益99售15,0,0,0,0,0,0,0,0,0,72000,0,0,0,132000,60000,72000,72000
9921,巨大            ,3011420,2820726,190694,0,0,0,0,143000,-143000,24000,19000,12000,7000,18000,1000,17000,71694
062677,儒鴻統一01購01  ,0,0,0,0,0,0,0,0,0,71000,0,0,0,181000,110000,71000,71000
061722,健策永豐9B購03  ,0,0,0,0,0,0,0,0,0,71000,0,0,0,121000,50000,71000,71000
06185P,台表科元大97售05,0,0,0,0,0,0,0,0,0,71000,0,0,0,339000,268000,71000,71000
056196,聯茂富邦98購02  ,0,0,0,0,0,0,0,0,0,71000,0,0,0,81000,10000,71000,71000
055049,智邦永豐97購01  ,0,0,0,0,0,0,0,0,0,71000,0,0,0,93000,22000,71000,71000
058698,華通元大99購05  ,0,0,0,0,0,0,0,0,0,71000,0,0,0,96000,25000,71000,71000
057300,訊連永豐98購01  ,0,0,0,0,0,0,0,0,0,71000,0,0,0,71000,0,71000,71000
057543,華通凱基99購02  ,0,0,0,0,0,0,0,0,0,71000,0,0,0,71000,0,71000,71000
061034,晶豪科永豐9A購01,0,0,0,0,0,0,0,0,0,71000,0,0,0,71000,0,71000,71000
058403,玉晶光元大99購12,0,0,0,0,0,0,0,0,0,71000,0,0,0,245000,174000,71000,71000
062013,奇鋐富邦9B購01  ,0,0,0,0,0,0,0,0,0,70000,0,0,0,90000,20000,70000,70000
062350,台表科群益9B購01,0,15000,-15000,0,0,0,0,0,0,85000,0,0,0,152000,67000,85000,70000
06915P,晶技元富98售02  ,0,0,0,0,0,0,0,0,0,70000,0,0,0,70000,0,70000,70000
063078,元金2X凱基02購03,0,0,0,0,0,0,0,0,0,70000,0,0,0,70000,0,70000,70000
063331,瑞儀國票9C購01  ,0,0,0,0,0,0,0,0,0,70000,0,0,0,80000,10000,70000,70000
055337,超眾兆豐98購01  ,0,0,0,0,0,0,0,0,0,70000,0,0,0,70000,0,70000,70000
056744,麗豐凱基9A購01  ,0,0,0,0,0,0,0,0,0,70000,0,0,0,77000,7000,70000,70000
05631P,國巨富邦9A售01  ,0,0,0,0,0,0,0,0,0,70000,0,0,0,200000,130000,70000,70000
048848,滬深2X群益98購02,0,0,0,0,0,0,0,0,0,70000,0,0,0,70000,0,70000,70000
052885,高鐵兆豐98購01  ,0,0,0,0,0,0,0,0,0,70000,0,0,0,80000,10000,70000,70000
07844P,可成國票9A售01  ,0,0,0,0,0,0,0,0,0,70000,0,0,0,70000,0,70000,70000
058933,FBVIX台新9B購01 ,0,0,0,0,0,0,0,0,0,70000,0,0,0,134000,64000,70000,70000
058061,貿聯元富9B購01  ,0,0,0,0,0,0,0,0,0,70000,0,0,0,120000,50000,70000,70000
061200,道瓊反元大9A購06,0,0,0,0,0,0,0,0,0,70000,0,0,0,70000,0,70000,70000
058208,百和凱基99購01  ,0,0,0,0,0,0,0,0,0,70000,0,0,0,70000,0,70000,70000
060324,台積電群益9B購02,0,0,0,0,0,0,0,0,0,70000,0,0,0,71000,1000,70000,70000
057690,美律凱基99購03  ,0,0,0,0,0,0,0,0,0,70000,0,0,0,70000,0,70000,70000
060916,金像電國泰9C購01,0,0,0,0,0,0,0,0,0,70000,0,0,0,386000,316000,70000,70000
08007P,國泰金中信03售02,0,0,0,0,0,0,0,0,0,70000,0,0,0,70000,0,70000,70000
063090,道瓊反中信9C購02,0,0,0,0,0,0,0,0,0,69000,0,0,0,70000,1000,69000,69000
06296P,燿華元大98售01  ,0,0,0,0,0,0,0,0,0,69000,0,0,0,99000,30000,69000,69000
062106,華邦電國票9B購02,0,0,0,0,0,0,0,0,0,69000,0,0,0,122000,53000,69000,69000
020008,元大特股高息N   ,0,0,0,0,0,0,0,0,0,69000,0,0,0,76000,7000,69000,69000
055600,致伸元大97購02  ,0,0,0,0,0,0,0,0,0,69000,0,0,0,69000,0,69000,69000
057493,聯詠元大98購02  ,0,0,0,0,0,0,0,0,0,69000,0,0,0,174000,105000,69000,69000
08080P,祥碩國票9B售03  ,0,0,0,0,0,0,0,0,0,69000,0,0,0,220000,151000,69000,69000
07783P,聯發科富邦9C售03,0,0,0,0,0,0,0,0,0,69000,0,0,0,72000,3000,69000,69000
07228P,台灣50群益9B售06,0,0,0,0,0,0,0,0,0,69000,0,0,0,69000,0,69000,69000
06091P,華新科統一97售01,0,0,0,0,0,0,0,0,0,69000,0,0,0,69000,0,69000,69000
062313,聯詠凱基9C購01  ,0,0,0,0,0,0,0,0,0,68000,0,0,0,68000,0,68000,68000
061940,世紀鋼國票9C購01,0,0,0,0,0,0,0,0,0,68000,0,0,0,125000,57000,68000,68000
061985,富邦金元大9B購01,0,0,0,0,0,0,0,0,0,68000,0,0,0,68000,0,68000,68000
061816,長榮航群益9B購02,0,0,0,0,0,0,0,0,0,68000,0,0,0,98000,30000,68000,68000
061421,台積電元大9A購29,0,0,0,0,0,0,0,0,0,68000,0,0,0,68000,0,68000,68000
061724,訊芯永豐9A購01  ,0,0,0,0,0,0,0,0,0,68000,0,0,0,68000,0,68000,68000
061572,奇力新元大9A購04,0,0,0,0,0,0,0,0,0,68000,0,0,0,68000,0,68000,68000
062776,鴻海元大9B購03  ,0,0,0,0,0,0,0,0,0,68000,0,0,0,68000,0,68000,68000
063131,聯茂元大9B購03  ,0,0,0,0,0,0,0,0,0,68000,0,0,0,173000,105000,68000,68000
055604,訊芯元大98購02  ,0,0,0,0,0,0,0,0,0,68000,0,0,0,68000,0,68000,68000
057075,嘉聯益永豐98購01,0,0,0,0,0,0,0,0,0,68000,0,0,0,68000,0,68000,68000
056625,致伸永豐98購01  ,0,0,0,0,0,0,0,0,0,68000,0,0,0,68000,0,68000,68000
056408,奇鋐國票99購01  ,0,0,0,0,0,0,0,0,0,68000,0,0,0,93000,25000,68000,68000
059977,鴻海元大99購40  ,0,0,0,0,0,0,0,0,0,68000,0,0,0,68000,0,68000,68000
054420,緯穎元大96購08  ,0,0,0,0,0,0,0,0,0,68000,0,0,0,74000,6000,68000,68000
054252,奇力新元大96購04,0,0,0,0,0,0,0,0,0,68000,0,0,0,68000,0,68000,68000
060454,葡萄王元大9A購01,0,0,0,0,0,0,0,0,0,68000,0,0,0,68000,0,68000,68000
057277,可成元大98購05  ,0,0,0,0,0,0,0,0,0,68000,0,0,0,68000,0,68000,68000
057721,華擎元富98購02  ,0,0,0,0,0,0,0,0,0,68000,0,0,0,187000,119000,68000,68000
060418,中橡永豐9A購01  ,0,0,0,0,0,0,0,0,0,68000,0,0,0,68000,0,68000,68000
057827,康友元大98購03  ,0,0,0,0,0,0,0,0,0,68000,0,0,0,68000,0,68000,68000
058051,同欣電元大98購03,0,0,0,0,0,0,0,0,0,68000,0,0,0,68000,0,68000,68000
057195,南茂元大98購01  ,0,10000,-10000,0,0,0,0,0,0,78000,0,0,0,219000,141000,78000,68000
058852,貿聯群益99購04  ,0,0,0,0,0,0,0,0,0,68000,0,0,0,100000,32000,68000,68000
07996P,亞德客凱基9B售03,0,0,0,0,0,0,0,0,0,68000,0,0,0,511000,443000,68000,68000
020000,富邦特選蘋果N   ,0,0,0,0,0,0,0,0,0,67000,0,0,0,78000,11000,67000,67000
047213,新日興富邦97購01,0,0,0,0,0,0,0,0,0,67000,0,0,0,230000,163000,67000,67000
059261,華邦電中信01購01,0,0,0,0,0,0,0,0,0,67000,0,0,0,154000,87000,67000,67000
058925,旭富元富99購02  ,0,0,0,0,0,0,0,0,0,67000,0,0,0,133000,66000,67000,67000
07838P,泰碩元大9A售04  ,0,0,0,0,0,0,0,0,0,67000,0,0,0,106000,39000,67000,67000
058615,矽創元大99購01  ,0,0,0,0,0,0,0,0,0,67000,0,0,0,67000,0,67000,67000
059732,超眾元大9A購01  ,0,0,0,0,0,0,0,0,0,67000,0,0,0,117000,50000,67000,67000
060557,南電凱基9A購02  ,0,0,0,0,0,0,0,0,0,67000,0,0,0,77000,10000,67000,67000
07772P,華新科國票9A售05,0,0,0,0,0,0,0,0,0,67000,0,0,0,67000,0,67000,67000
06937P,GIS元大98售03   ,0,0,0,0,0,0,0,0,0,66000,0,0,0,159000,93000,66000,66000
061566,華通元大9A購10  ,0,0,0,0,0,0,0,0,0,66000,0,0,0,90000,24000,66000,66000
061795,智邦永豐9B購01  ,0,0,0,0,0,0,0,0,0,66000,0,0,0,97000,31000,66000,66000
061975,華通元大9B購01  ,0,0,0,0,0,0,0,0,0,66000,0,0,0,90000,24000,66000,66000
00665L,富邦恒生國企正2 ,0,0,0,0,0,0,0,0,0,66000,0,0,0,613000,547000,66000,66000
059598,欣興元大99購08  ,0,0,0,0,0,0,0,0,0,66000,0,0,0,71000,5000,66000,66000
059299,欣興元富99購03  ,0,0,0,0,0,0,0,0,0,66000,0,0,0,66000,0,66000,66000
058762,貿聯群益99購03  ,0,0,0,0,0,0,0,0,0,66000,0,0,0,166000,100000,66000,66000
07639P,緯穎國票9A售01  ,0,0,0,0,0,0,0,0,0,66000,0,0,0,258000,192000,66000,66000
060734,華通統一9C購01  ,0,0,0,0,0,0,0,0,0,66000,0,0,0,86000,20000,66000,66000
6168,宏齊            ,112000,46000,66000,0,0,0,0,0,0,0,0,0,0,0,0,0,66000
2542,興富發          ,9218450,9045480,172970,0,0,0,0,5000,-5000,-102000,35000,20000,15000,16000,133000,-117000,65970
061514,泰碩永豐9A購02  ,0,0,0,0,0,0,0,0,0,65000,0,0,0,75000,10000,65000,65000
062624,大成鋼國票9B購02,0,0,0,0,0,0,0,0,0,65000,0,0,0,65000,0,65000,65000
07094P,華通國票9A售03  ,0,0,0,0,0,0,0,0,0,65000,0,0,0,65000,0,65000,65000
07103P,南電元大99售04  ,0,0,0,0,0,0,0,0,0,65000,0,0,0,95000,30000,65000,65000
052884,台積電兆豐96購01,0,0,0,0,0,0,0,0,0,65000,0,0,0,564000,499000,65000,65000
052819,義隆永豐96購01  ,0,0,0,0,0,0,0,0,0,65000,0,0,0,65000,0,65000,65000
057148,玉晶光國票99購04,0,0,0,0,0,0,0,0,0,65000,0,0,0,65000,0,65000,65000
056668,光磊國票99購01  ,0,0,0,0,0,0,0,0,0,65000,0,0,0,126000,61000,65000,65000
058515,健鼎元大99購01  ,0,0,0,0,0,0,0,0,0,65000,0,0,0,110000,45000,65000,65000
060426,盛群永豐9A購01  ,0,0,0,0,0,0,0,0,0,65000,0,0,0,65000,0,65000,65000
060455,葡萄王元大9A購02,0,0,0,0,0,0,0,0,0,65000,0,0,0,68000,3000,65000,65000
07729P,臺股指凱基9A售21,0,0,0,0,0,0,0,0,0,65000,0,0,0,200000,135000,65000,65000
07085P,超眾元富9C售01  ,0,0,0,0,0,0,0,0,0,64000,0,0,0,67000,3000,64000,64000
062475,道瓊反國票9B購02,0,0,0,0,0,0,0,0,0,64000,0,0,0,64000,0,64000,64000
055333,晶豪科兆豐97購01,0,0,0,0,0,0,0,0,0,64000,0,0,0,64000,0,64000,64000
054059,欣興國票97購03  ,0,0,0,0,0,0,0,0,0,64000,0,0,0,64000,0,64000,64000
056940,嘉聯益元富98購01,0,0,0,0,0,0,0,0,0,64000,0,0,0,74000,10000,64000,64000
047673,瑞昱元富96購01  ,0,0,0,0,0,0,0,0,0,64000,0,0,0,140000,76000,64000,64000
052681,T50反1元大98購02,0,0,0,0,0,0,0,0,0,64000,0,0,0,136000,72000,64000,64000
060295,貿聯元大9A購03  ,0,0,0,0,0,0,0,0,0,64000,0,0,0,110000,46000,64000,64000
060186,義隆元富9A購01  ,0,0,0,0,0,0,0,0,0,64000,0,0,0,541000,477000,64000,64000
2331,精英            ,135000,71000,64000,0,0,0,0,0,0,0,2000,2000,0,0,0,0,64000
3090,日電貿          ,119000,49000,70000,0,0,0,0,0,0,-6000,0,0,0,19000,25000,-6000,64000
060901,臺股指凱基9A購13,0,0,0,0,0,0,0,0,0,64000,0,0,0,96000,32000,64000,64000
062466,FBVIX凱基9B購01 ,0,0,0,0,0,0,0,0,0,63000,0,0,0,90000,27000,63000,63000
062265,南茂元大9B購01  ,0,0,0,0,0,0,0,0,0,63000,0,0,0,178000,115000,63000,63000
056850,彩晶元富99購01  ,0,0,0,0,0,0,0,0,0,63000,0,0,0,63000,0,63000,63000
053631,欣興兆豐97購01  ,0,0,0,0,0,0,0,0,0,63000,0,0,0,73000,10000,63000,63000
054756,世紀鋼凱基99購01,0,0,0,0,0,0,0,0,0,63000,0,0,0,220000,157000,63000,63000
056694,欣興群益98購04  ,0,0,0,0,0,0,0,0,0,63000,0,0,0,109000,46000,63000,63000
058616,台虹元大9A購01  ,0,0,0,0,0,0,0,0,0,63000,0,0,0,89000,26000,63000,63000
059665,嘉聯益元大99購06,0,0,0,0,0,0,0,0,0,63000,0,0,0,112000,49000,63000,63000
060493,美律元富01購01  ,0,0,0,0,0,0,0,0,0,63000,0,0,0,259000,196000,63000,63000
058510,全新元大9B購02  ,0,0,0,0,0,0,0,0,0,63000,0,0,0,63000,0,63000,63000
059424,SGBR2X元大9A購01,0,0,0,0,0,0,0,0,0,63000,0,0,0,112000,49000,63000,63000
059051,和大凱基9A購01  ,0,0,0,0,0,0,0,0,0,63000,0,0,0,63000,0,63000,63000
07832P,台積電群益9A售08,0,0,0,0,0,0,0,0,0,63000,0,0,0,63000,0,63000,63000
057221,華通國票98購03  ,0,0,0,0,0,0,0,0,0,63000,0,0,0,65000,2000,63000,63000
058884,世紀鋼永豐99購02,0,0,0,0,0,0,0,0,0,63000,0,0,0,90000,27000,63000,63000
060818,上銀統一9C購01  ,0,0,0,0,0,0,0,0,0,63000,0,0,0,68000,5000,63000,63000
07715P,台灣50群益9A售14,0,0,0,0,0,0,0,0,0,63000,0,0,0,180000,117000,63000,63000
08157P,大立光元富9B售06,0,0,0,0,0,0,0,0,0,63000,0,0,0,89000,26000,63000,63000
07353P,大立光國票99售02,0,0,0,0,0,0,0,0,0,63000,0,0,0,121000,58000,63000,63000
07105P,大毅元富99售02  ,0,0,0,0,0,0,0,0,0,62000,0,0,0,82000,20000,62000,62000
06376P,上銀統一99售01  ,0,0,0,0,0,0,0,0,0,62000,0,0,0,72000,10000,62000,62000
063129,祥碩元大9C購03  ,0,0,0,0,0,0,0,0,0,62000,0,0,0,91000,29000,62000,62000
062950,貿聯富邦01購01  ,0,0,0,0,0,0,0,0,0,62000,0,0,0,888000,826000,62000,62000
054458,復盛群益96購01  ,0,0,0,0,0,0,0,0,0,62000,0,0,0,62000,0,62000,62000
057190,立積元大9A購02  ,0,0,0,0,0,0,0,0,0,62000,0,0,0,62000,0,62000,62000
057491,美食元大98購03  ,0,0,0,0,0,0,0,0,0,62000,0,0,0,63000,1000,62000,62000
07951P,智邦元大9B售05  ,0,0,0,0,0,0,0,0,0,62000,0,0,0,226000,164000,62000,62000
063460,智邦元大9B購08  ,0,0,0,0,0,0,0,0,0,61000,0,0,0,88000,27000,61000,61000
051561,玉晶光國泰97購04,0,0,0,0,0,0,0,0,0,61000,0,0,0,227000,166000,61000,61000
053255,貿聯國泰97購01  ,0,0,0,0,0,0,0,0,0,61000,0,0,0,61000,0,61000,61000
059921,大立光元大99購24,0,0,0,0,0,0,0,0,0,61000,0,0,0,68000,7000,61000,61000
056210,矽創永豐97購02  ,0,0,0,0,0,0,0,0,0,61000,0,0,0,61000,0,61000,61000
061180,華擎凱基9B購01  ,0,0,0,0,0,0,0,0,0,61000,0,0,0,61000,0,61000,61000
058457,創意永豐99購01  ,0,0,0,0,0,0,0,0,0,61000,0,0,0,195000,134000,61000,61000
058808,大成鋼統一9B購01,0,0,0,0,0,0,0,0,0,61000,0,0,0,135000,74000,61000,61000
07434P,臺股指國票9A售06,0,0,0,0,0,0,0,0,0,61000,0,0,0,100000,39000,61000,61000
063570,嘉晶元大9C購02  ,0,0,0,0,0,0,0,0,0,60000,0,0,0,80000,20000,60000,60000
06995P,臺股指凱基99售16,0,0,0,0,0,0,0,0,0,60000,0,0,0,60000,0,60000,60000
062999,聯茂國票9C購01  ,0,0,0,0,0,0,0,0,0,60000,0,0,0,120000,60000,60000,60000
062850,友訊永豐9B購01  ,0,0,0,0,0,0,0,0,0,60000,0,0,0,60000,0,60000,60000
062579,華通統一01購02  ,0,0,0,0,0,0,0,0,0,60000,0,0,0,60000,0,60000,60000
055705,微星永豐97購01  ,0,0,0,0,0,0,0,0,0,60000,0,0,0,60000,0,60000,60000
055318,華通國票98購01  ,0,0,0,0,0,0,0,0,0,60000,0,0,0,107000,47000,60000,60000
054855,得力群益98購01  ,0,0,0,0,0,0,0,0,0,60000,0,0,0,60000,0,60000,60000
054975,福懋科元大97購01,0,0,0,0,0,0,0,0,0,60000,0,0,0,60000,0,60000,60000
054916,聯發科凱基98購04,0,0,0,0,0,0,0,0,0,60000,0,0,0,137000,77000,60000,60000
056489,S&P反1國泰9A購01,0,0,0,0,0,0,0,0,0,60000,0,0,0,60000,0,60000,60000
053092,台表科元大97購02,0,0,0,0,0,0,0,0,0,60000,0,0,0,60000,0,60000,60000
056834,華新元富99購01  ,0,0,0,0,0,0,0,0,0,60000,0,0,0,65000,5000,60000,60000
053998,泰鼎群益98購01  ,0,0,0,0,0,0,0,0,0,60000,0,0,0,60000,0,60000,60000
052998,拓凱康和96購01  ,0,0,0,0,0,0,0,0,0,60000,0,0,0,60000,0,60000,60000
051979,群創凱基97購01  ,0,0,0,0,0,0,0,0,0,60000,0,0,0,60000,0,60000,60000
054239,台郡群益96購02  ,0,0,0,0,0,0,0,0,0,60000,0,0,0,60000,0,60000,60000
054427,潤泰全富邦97購01,0,0,0,0,0,0,0,0,0,60000,0,0,0,60000,0,60000,60000
050170,臺指反元大97購02,0,0,0,0,0,0,0,0,0,60000,0,0,0,220000,160000,60000,60000
057997,旺宏第一9C購01  ,0,0,0,0,0,0,0,0,0,60000,0,0,0,60000,0,60000,60000
060435,鈺齊永豐9A購01  ,0,0,0,0,0,0,0,0,0,60000,0,0,0,60000,0,60000,60000
058572,百和凱基9A購01  ,0,0,0,0,0,0,0,0,0,60000,0,0,0,70000,10000,60000,60000
057667,可成元大99購01  ,0,0,0,0,0,0,0,0,0,60000,0,0,0,60000,0,60000,60000
07559P,祥碩元大9A售03  ,0,0,0,0,0,0,0,0,0,60000,0,0,0,60000,0,60000,60000
07327P,台灣50群益9A售06,0,0,0,0,0,0,0,0,0,60000,0,0,0,60000,0,60000,60000
07258P,台灣50台新9A售01,0,0,0,0,0,0,0,0,0,60000,0,0,0,60000,0,60000,60000
07932P,國巨元大9B售04  ,0,0,0,0,0,0,0,0,0,60000,0,0,0,60000,0,60000,60000
08114P,國巨凱基9B售11  ,0,0,0,0,0,0,0,0,0,60000,0,0,0,70000,10000,60000,60000
060701,玉晶光國泰9C購01,0,0,0,0,0,0,0,0,0,60000,0,0,0,67000,7000,60000,60000
061991,牧德元大9C購01  ,0,0,0,0,0,0,0,0,0,59000,0,0,0,72000,13000,59000,59000
051728,道瓊反國票97購01,0,0,0,0,0,0,0,0,0,59000,0,0,0,84000,25000,59000,59000
053827,漢唐麥證9A購01  ,0,0,0,210000,181000,29000,0,0,0,59000,0,0,0,240000,181000,59000,59000
060252,緯穎元大9A購02  ,0,0,0,0,0,0,0,0,0,59000,0,0,0,69000,10000,59000,59000
058630,日月光國票9A購01,0,0,0,0,0,0,0,0,0,59000,0,0,0,59000,0,59000,59000
060401,世紀鋼國票9B購01,0,0,0,0,0,0,0,0,0,59000,0,0,0,59000,0,59000,59000
060457,中橡元大9A購02  ,0,0,0,0,0,0,0,0,0,59000,0,0,0,204000,145000,59000,59000
057507,貿聯國票98購02  ,0,0,0,0,0,0,0,0,0,59000,0,0,0,193000,134000,59000,59000
057568,友訊永豐99購01  ,0,0,0,0,0,0,0,0,0,59000,0,0,0,63000,4000,59000,59000
058122,美律國票9A購01  ,0,0,0,0,0,0,0,0,0,59000,0,0,0,59000,0,59000,59000
4164,承業醫          ,63000,4000,59000,0,0,0,0,0,0,0,0,0,0,0,0,0,59000
08059P,京鼎元大9B售02  ,0,0,0,0,0,0,0,0,0,59000,0,0,0,156000,97000,59000,59000
1783,和康生          ,78000,19000,59000,0,0,0,0,0,0,0,0,0,0,0,0,0,59000
061986,晶豪科元大9B購01,0,0,0,0,0,0,0,0,0,58000,0,0,0,80000,22000,58000,58000
061792,和大永豐9B購01  ,0,0,0,0,0,0,0,0,0,58000,0,0,0,58000,0,58000,58000
062158,禾伸堂凱基9B購01,0,0,0,0,0,0,0,0,0,58000,0,0,0,68000,10000,58000,58000
063074,創意永豐9B購02  ,0,0,0,0,0,0,0,0,0,58000,0,0,0,153000,95000,58000,58000
054135,大立光元大97購04,0,0,0,0,0,0,0,0,0,58000,0,0,0,68000,10000,58000,58000
054121,奇鋐永豐96購02  ,0,0,0,0,0,0,0,0,0,58000,0,0,0,76000,18000,58000,58000
058938,台積電中信01購03,0,0,0,0,0,0,0,0,0,58000,0,0,0,58000,0,58000,58000
058946,SGBR2X群益9B購01,0,0,0,0,0,0,0,0,0,58000,0,0,0,68000,10000,58000,58000
059443,嘉聯益元大9B購01,0,0,0,0,0,0,0,0,0,58000,0,0,0,62000,4000,58000,58000
060155,友訊永豐9A購01  ,0,0,0,0,0,0,0,0,0,58000,0,0,0,58000,0,58000,58000
07211P,南亞科凱基99售05,0,0,0,0,0,0,0,0,0,58000,0,0,0,59000,1000,58000,58000
07496P,鴻海元大9A售05  ,0,0,0,0,0,0,0,0,0,58000,0,0,0,58000,0,58000,58000
061002,瑞昱兆豐9B購01  ,0,0,0,0,0,0,0,0,0,58000,0,0,0,71000,13000,58000,58000
063080,裕隆凱基9B購01  ,0,0,0,0,0,0,0,0,0,57000,0,0,0,102000,45000,57000,57000
061505,力成國票9A購03  ,0,0,0,0,0,0,0,0,0,57000,0,0,0,100000,43000,57000,57000
061628,緯穎群益9A購04  ,0,0,0,0,0,0,0,0,0,57000,0,0,0,108000,51000,57000,57000
053928,智易國票97購03  ,0,0,0,0,0,0,0,0,0,57000,0,0,0,95000,38000,57000,57000
052313,聯電元大98購01  ,0,0,0,0,0,0,0,0,0,57000,0,0,0,106000,49000,57000,57000
060394,欣興麥證9A購01  ,0,0,0,57000,0,57000,0,0,0,57000,0,0,0,57000,0,57000,57000
060414,中興電永豐9A購01,0,0,0,0,0,0,0,0,0,57000,0,0,0,180000,123000,57000,57000
058613,茂林元大99購03  ,0,0,0,0,0,0,0,0,0,57000,0,0,0,105000,48000,57000,57000
057575,世紀鋼永豐98購02,0,0,0,0,0,0,0,0,0,57000,0,0,0,244000,187000,57000,57000
058068,旺宏凱基98購11  ,0,0,0,0,0,0,0,0,0,57000,0,0,0,69000,12000,57000,57000
058105,旺宏統一9A購02  ,0,0,0,0,0,0,0,0,0,57000,0,0,0,90000,33000,57000,57000
059116,晶豪科永豐99購01,0,0,0,0,0,0,0,0,0,57000,0,0,0,64000,7000,57000,57000
058770,貿聯兆豐9A購01  ,0,0,0,0,0,0,0,0,0,57000,0,0,0,190000,133000,57000,57000
07933P,大立光富邦9C售06,0,0,0,0,0,0,0,0,0,57000,0,0,0,100000,43000,57000,57000
2727,王品            ,85000,28000,57000,0,0,0,0,0,0,0,0,0,0,0,0,0,57000
062395,台表科富邦9C購01,0,0,0,0,0,0,0,0,0,56000,0,0,0,93000,37000,56000,56000
062939,奇力新凱基9B購02,0,0,0,0,0,0,0,0,0,56000,0,0,0,56000,0,56000,56000
06584P,欣興凱基98售03  ,0,0,0,0,0,0,0,0,0,56000,0,0,0,76000,20000,56000,56000
054065,樺漢國票97購01  ,0,0,0,0,0,0,0,0,0,56000,0,0,0,94000,38000,56000,56000
056821,日電貿永豐98購01,0,0,0,0,0,0,0,0,0,56000,0,0,0,73000,17000,56000,56000
059934,華通永豐99購02  ,0,0,0,0,0,0,0,0,0,56000,0,0,0,57000,1000,56000,56000
056132,台光電元大97購03,0,0,0,0,0,0,0,0,0,56000,0,0,0,69000,13000,56000,56000
055668,欣興群益97購01  ,0,0,0,0,0,0,0,0,0,56000,0,0,0,56000,0,56000,56000
059263,瑞昱中信01購01  ,0,0,0,0,0,0,0,0,0,56000,0,0,0,67000,11000,56000,56000
060506,京元電元大9A購02,0,0,0,0,0,0,0,0,0,56000,0,0,0,243000,187000,56000,56000
060309,佳世達永豐9A購01,0,0,0,0,0,0,0,0,0,56000,0,0,0,56000,0,56000,56000
2702,華園            ,125000,69000,56000,0,0,0,0,0,0,0,0,0,0,0,0,0,56000
07786P,南電中信9C售01  ,0,0,0,0,0,0,0,0,0,56000,0,0,0,57000,1000,56000,56000
08128P,聯發科元大9B售22,0,0,0,0,0,0,0,0,0,56000,0,0,0,60000,4000,56000,56000
07162P,臺股指群益99售13,0,0,0,0,0,0,0,0,0,56000,0,0,0,138000,82000,56000,56000
060930,超眾永豐9A購03  ,0,0,0,0,0,0,0,0,0,56000,0,0,0,56000,0,56000,56000
06216P,上銀元富97售03  ,0,0,0,0,0,0,0,0,0,55000,0,0,0,69000,14000,55000,55000
062151,世紀鋼國票01購01,0,0,0,0,0,0,0,0,0,55000,0,0,0,55000,0,55000,55000
062658,聯茂第一9B購01  ,0,0,0,0,0,0,0,0,0,55000,0,0,0,55000,0,55000,55000
061605,華新科凱基9A購14,0,0,0,0,0,0,0,0,0,55000,0,0,0,80000,25000,55000,55000
062057,華邦電統一01購01,0,0,0,0,0,0,0,0,0,55000,0,0,0,229000,174000,55000,55000
054941,凱美元大97購01  ,0,0,0,0,0,0,0,0,0,55000,0,0,0,55000,0,55000,55000
056578,智易元大99購02  ,0,0,0,0,0,0,0,0,0,55000,0,0,0,105000,50000,55000,55000
055804,祥碩永豐97購02  ,0,0,0,0,0,0,0,0,0,55000,0,0,0,76000,21000,55000,55000
053956,旺宏永豐96購04  ,0,0,0,0,0,0,0,0,0,55000,0,0,0,55000,0,55000,55000
052828,滬深2X群益9A購02,0,0,0,0,0,0,0,0,0,55000,0,0,0,55000,0,55000,55000
053640,上緯控永豐96購01,0,0,0,0,0,0,0,0,0,55000,0,0,0,60000,5000,55000,55000
058055,華擎統一9A購01  ,0,0,0,0,0,0,0,0,0,55000,0,0,0,157000,102000,55000,55000
8028,昇陽半導體      ,131000,82000,49000,0,0,0,0,0,0,6000,10000,0,10000,0,4000,-4000,55000
07451P,鴻海元大9B售01  ,0,0,0,0,0,0,0,0,0,55000,0,0,0,75000,20000,55000,55000
062144,華通國票9B購01  ,0,0,0,0,0,0,0,0,0,54000,0,0,0,54000,0,54000,54000
062133,大成鋼群益9B購01,0,0,0,0,0,0,0,0,0,54000,0,0,0,54000,0,54000,54000
063497,東元永豐9B購01  ,0,0,0,0,0,0,0,0,0,54000,0,0,0,54000,0,54000,54000
056107,智易永豐97購02  ,0,0,0,0,0,0,0,0,0,54000,0,0,0,54000,0,54000,54000
061304,創意永豐9A購02  ,0,0,0,0,0,0,0,0,0,54000,0,0,0,70000,16000,54000,54000
061366,台勝科國票9A購01,0,0,0,0,0,0,0,0,0,54000,0,0,0,54000,0,54000,54000
059125,台積電第一03購02,0,0,0,0,0,0,0,0,0,54000,0,0,0,60000,6000,54000,54000
057775,南亞科群益98購02,0,0,0,0,0,0,0,0,0,54000,0,0,0,54000,0,54000,54000
07214P,聯發科凱基9A售04,0,0,0,0,0,0,0,0,0,54000,0,0,0,208000,154000,54000,54000
07782P,寶成凱基9A售02  ,0,0,0,0,0,0,0,0,0,54000,0,0,0,94000,40000,54000,54000
1339,昭輝            ,70000,17000,53000,0,0,0,0,0,0,1000,1000,0,1000,0,0,0,54000
060958,儒鴻凱基9A購02  ,0,0,0,0,0,0,0,0,0,54000,0,0,0,167000,113000,54000,54000
060624,玉晶光元大9C購02,0,0,0,0,0,0,0,0,0,54000,0,0,0,55000,1000,54000,54000
063459,華通元大9B購08  ,0,0,0,0,0,0,0,0,0,53000,0,0,0,58000,5000,53000,53000
07081P,南電群益9A售01  ,0,0,0,0,0,0,0,0,0,53000,0,0,0,103000,50000,53000,53000
062784,世芯元大9B購01  ,0,0,0,0,0,0,0,0,0,53000,0,0,0,109000,56000,53000,53000
062837,復盛群益9B購01  ,0,0,0,0,0,0,0,0,0,53000,0,0,0,110000,57000,53000,53000
06230P,亞德客永豐97售03,0,0,0,0,0,0,0,0,0,53000,0,0,0,141000,88000,53000,53000
057074,立積永豐98購01  ,0,0,0,0,0,0,0,0,0,53000,0,0,0,68000,15000,53000,53000
054363,世芯凱基97購01  ,0,0,0,0,0,0,0,0,0,53000,0,0,0,58000,5000,53000,53000
048192,華通元大96購01  ,0,0,0,0,0,0,0,0,0,53000,0,0,0,63000,10000,53000,53000
048383,元金2X國票99購01,0,0,0,0,0,0,0,0,0,53000,0,0,0,102000,49000,53000,53000
051729,華新國票96購01  ,0,0,0,0,0,0,0,0,0,53000,0,0,0,95000,42000,53000,53000
059370,玉晶光元富99購02,0,0,0,0,0,0,0,0,0,53000,0,0,0,164000,111000,53000,53000
061384,T50反1群益9A購04,0,0,0,0,0,0,0,0,0,53000,0,0,0,58000,5000,53000,53000
061337,台積電元大9A購27,0,0,0,0,0,0,0,0,0,53000,0,0,0,53000,0,53000,53000
07874P,長榮航群益9B售01,0,0,0,0,0,0,0,0,0,53000,0,0,0,53000,0,53000,53000
07731P,臺股指凱基9A售28,0,0,0,0,0,0,0,0,0,53000,0,0,0,170000,117000,53000,53000
06232P,智易永豐97售01  ,0,0,0,0,0,0,0,0,0,52000,0,0,0,52000,0,52000,52000
062604,東元凱基9B購01  ,0,0,0,0,0,0,0,0,0,52000,0,0,0,56000,4000,52000,52000
062046,矽格凱基9B購01  ,0,0,0,0,0,0,0,0,0,52000,0,0,0,75000,23000,52000,52000
061742,奇鋐凱基9B購01  ,0,0,0,0,0,0,0,0,0,52000,0,0,0,88000,36000,52000,52000
063130,聯茂元大9B購02  ,0,0,0,0,0,0,0,0,0,52000,0,0,0,111000,59000,52000,52000
060243,潤泰全元大9C購02,0,0,0,0,0,0,0,0,0,52000,0,0,0,120000,68000,52000,52000
058912,祥碩元大99購01  ,0,0,0,0,0,0,0,0,0,52000,0,0,0,66000,14000,52000,52000
08139P,華新科元大9B售12,0,0,0,0,0,0,0,0,0,52000,0,0,0,52000,0,52000,52000
07192P,聯發科元大99售23,0,0,0,0,0,0,0,0,0,52000,0,0,0,72000,20000,52000,52000
2062,橋椿            ,99000,47000,52000,0,0,0,0,0,0,0,0,0,0,0,0,0,52000
2636,台驊投控        ,72000,20000,52000,0,0,0,0,0,0,0,0,0,0,0,0,0,52000
2608,嘉里大榮        ,74000,22000,52000,0,0,0,0,0,0,0,0,0,0,0,0,0,52000
060920,超眾富邦9B購01  ,0,0,0,0,0,0,0,0,0,52000,0,0,0,311000,259000,52000,52000
00783,富邦中証500     ,3000,2000,1000,0,0,0,0,0,0,50596,0,0,0,953596,903000,50596,51596
063432,金寶元富9B購01  ,0,0,0,0,0,0,0,0,0,51000,0,0,0,174000,123000,51000,51000
06811P,聯發科統一98售06,0,0,0,0,0,0,0,0,0,51000,0,0,0,86000,35000,51000,51000
062650,南電富邦01購01  ,0,0,0,0,0,0,0,0,0,51000,0,0,0,71000,20000,51000,51000
062521,玉晶光元大9C購05,0,0,0,0,0,0,0,0,0,51000,0,0,0,126000,75000,51000,51000
062071,華通元大9B購02  ,0,0,0,0,0,0,0,0,0,51000,0,0,0,57000,6000,51000,51000
060116,世紀鋼元大99購07,0,0,0,0,0,0,0,0,0,51000,0,0,0,51000,0,51000,51000
056967,奇鋐永豐98購01  ,0,0,0,0,0,0,0,0,0,51000,0,0,0,51000,0,51000,51000
06137P,玉晶光永豐97售04,0,0,0,0,0,0,0,0,0,51000,0,0,0,93000,42000,51000,51000
058140,臻鼎元大99購02  ,0,0,0,0,0,0,0,0,0,51000,0,0,0,81000,30000,51000,51000
060150,華通富邦9B購01  ,0,0,0,0,0,0,0,0,0,51000,0,0,0,51000,0,51000,51000
060479,億豐元大9A購01  ,0,0,0,0,0,0,0,0,0,51000,0,0,0,51000,0,51000,51000
07764P,世紀鋼永豐9A售04,0,0,0,0,0,0,0,0,0,51000,0,0,0,52000,1000,51000,51000
07884P,華新科凱基9B售08,0,0,0,0,0,0,0,0,0,51000,0,0,0,51000,0,51000,51000
06208P,台郡凱基97售03  ,0,0,0,0,0,0,0,0,0,50000,0,0,0,50000,0,50000,50000
06212P,華新科元大97售11,0,0,0,0,0,0,0,0,0,50000,0,0,0,50000,0,50000,50000
062411,玉晶光第一9B購01,0,0,0,0,0,0,0,0,0,50000,0,0,0,50000,0,50000,50000
062509,SP黃豆國票9B購03,0,0,0,0,0,0,0,0,0,50000,0,0,0,50000,0,50000,50000
062602,華通麥證9C購01  ,0,0,0,50000,0,50000,0,0,0,50000,0,0,0,50000,0,50000,50000
062726,華擎凱基9B購02  ,0,0,0,0,0,0,0,0,0,50000,0,0,0,60000,10000,50000,50000
061843,億豐凱基9C購01  ,0,0,0,0,0,0,0,0,0,50000,0,0,0,100000,50000,50000,50000
061600,聯電凱基9B購01  ,0,0,0,0,0,0,0,0,0,50000,0,0,0,120000,70000,50000,50000
061398,力成中信9A購01  ,0,0,0,0,0,0,0,0,0,50000,0,0,0,50000,0,50000,50000
06853P,華擎元富98售03  ,0,0,0,0,0,0,0,0,0,50000,0,0,0,140000,90000,50000,50000
06834P,訊芯群益99售02  ,0,0,0,0,0,0,0,0,0,50000,0,0,0,50000,0,50000,50000
06729P,聯詠元大98售03  ,0,0,0,0,0,0,0,0,0,50000,0,0,0,50000,0,50000,50000
063485,巨大元大9B購04  ,0,0,0,0,0,0,0,0,0,50000,0,0,0,206000,156000,50000,50000
06638P,鴻海統一99售02  ,0,0,0,0,0,0,0,0,0,50000,0,0,0,60000,10000,50000,50000
06597P,國巨富邦9A售05  ,0,0,0,0,0,0,0,0,0,50000,0,0,0,80000,30000,50000,50000
063120,台光電元大9C購01,0,0,0,0,0,0,0,0,0,50000,0,0,0,58000,8000,50000,50000
062867,東元中信9B購01  ,0,0,0,0,0,0,0,0,0,50000,0,0,0,98000,48000,50000,50000
057045,美律元大99購04  ,0,0,0,0,0,0,0,0,0,50000,0,0,0,50000,0,50000,50000
055119,力成凱基98購01  ,0,0,0,0,0,0,0,0,0,50000,0,0,0,70000,20000,50000,50000
055357,欣興凱基97購04  ,0,0,0,0,0,0,0,0,0,50000,0,0,0,50000,0,50000,50000
060101,大立光元大99購31,0,0,0,0,0,0,0,0,0,50000,0,0,0,50000,0,50000,50000
060087,鴻海元大99購43  ,0,0,0,0,0,0,0,0,0,50000,0,0,0,53000,3000,50000,50000
059743,開發金元富99購01,0,0,0,0,0,0,0,0,0,50000,0,0,0,100000,50000,50000,50000
05991P,聯茂群益96售05  ,0,0,0,0,0,0,0,0,0,50000,0,0,0,50000,0,50000,50000
056407,嘉晶國票99購01  ,0,0,0,0,0,0,0,0,0,50000,0,0,0,50000,0,50000,50000
056665,上証2X國票99購02,0,0,0,0,0,0,0,0,0,50000,0,0,0,50000,0,50000,50000
051733,中環國票96購02  ,0,0,0,0,0,0,0,0,0,50000,0,0,0,50000,0,50000,50000
051799,台積電永豐96購01,0,0,0,0,0,0,0,0,0,50000,0,0,0,60000,10000,50000,50000
052167,亞泥元大96購01  ,0,0,0,0,0,0,0,0,0,50000,0,0,0,50000,0,50000,50000
054404,新日興康和96購01,0,0,0,0,0,0,0,0,0,50000,0,0,0,90000,40000,50000,50000
054426,國泰金富邦97購02,0,0,0,0,0,0,0,0,0,50000,0,0,0,50000,0,50000,50000
054472,道瓊反中信9A購01,0,0,0,0,0,0,0,0,0,50000,0,0,0,80000,30000,50000,50000
052727,仁寶元富96購01  ,0,0,0,0,0,0,0,0,0,50000,0,0,0,50000,0,50000,50000
053502,智伸科兆豐97購01,0,0,0,0,0,0,0,0,0,50000,0,0,0,52000,2000,50000,50000
053158,茂林元大96購01  ,0,0,0,0,0,0,0,0,0,50000,0,0,0,51000,1000,50000,50000
056851,瑞儀元富98購01  ,0,0,0,0,0,0,0,0,0,50000,0,0,0,100000,50000,50000,50000
055912,宏達電凱基98購03,0,0,0,0,0,0,0,0,0,50000,0,0,0,58000,8000,50000,50000
060462,鴻海元大9A購10  ,0,0,0,0,0,0,0,0,0,50000,0,0,0,55000,5000,50000,50000
057646,玉山金元大98購01,0,0,0,0,0,0,0,0,0,50000,0,0,0,51000,1000,50000,50000
057664,台積電元大9A購03,0,0,0,0,0,0,0,0,0,50000,0,0,0,50000,0,50000,50000
058700,鴻海元大99購15  ,0,0,0,0,0,0,0,0,0,50000,0,0,0,50000,0,50000,50000
059516,TPK永豐99購01   ,0,0,0,0,0,0,0,0,0,50000,0,0,0,110000,60000,50000,50000
060187,華新科元富9A購02,0,0,0,0,0,0,0,0,0,50000,0,0,0,57000,7000,50000,50000
058642,旺宏麥證9A購01  ,0,0,0,50000,0,50000,0,0,0,50000,0,0,0,50000,0,50000,50000
059083,華通元大99購07  ,0,0,0,0,0,0,0,0,0,50000,0,0,0,50000,0,50000,50000
059209,華通元大99購08  ,0,0,0,0,0,0,0,0,0,50000,0,0,0,50000,0,50000,50000
061339,京元電元大9A購05,0,0,0,0,0,0,0,0,0,50000,0,0,0,93000,43000,50000,50000
061271,聯茂凱基9A購04  ,0,0,0,0,0,0,0,0,0,50000,0,0,0,50000,0,50000,50000
058101,台積電富邦9C購01,0,0,0,0,0,0,0,0,0,50000,0,0,0,365000,315000,50000,50000
058920,SGBR2X元富99購06,0,0,0,0,0,0,0,0,0,50000,0,0,0,50000,0,50000,50000
07894P,燿華元大9B售01  ,0,0,0,0,0,0,0,0,0,50000,0,0,0,50000,0,50000,50000
07713P,台郡元大9A售03  ,0,0,0,0,0,0,0,0,0,50000,0,0,0,50000,0,50000,50000
07225P,台積電元大99售33,0,0,0,0,0,0,0,0,0,50000,0,0,0,299000,249000,50000,50000
07279P,台灣50台新99售02,0,0,0,0,0,0,0,0,0,50000,0,0,0,100000,50000,50000,50000
060708,康友富邦9B購01  ,0,0,0,0,0,0,0,0,0,50000,0,0,0,150000,100000,50000,50000
060823,旺宏元大9A購05  ,0,0,0,0,0,0,0,0,0,50000,0,0,0,50000,0,50000,50000
062768,南電凱基9B購04  ,0,0,0,0,0,0,0,0,0,49000,0,0,0,49000,0,49000,49000
063024,祥碩元大9B購05  ,0,0,0,0,0,0,0,0,0,49000,0,0,0,197000,148000,49000,49000
06534P,聯發科群益98售04,0,0,0,0,0,0,0,0,0,49000,0,0,0,49000,0,49000,49000
061430,致新元大9A購01  ,0,0,0,0,0,0,0,0,0,49000,0,0,0,54000,5000,49000,49000
062053,華通統一9C購02  ,0,0,0,0,0,0,0,0,0,49000,0,0,0,82000,33000,49000,49000
061988,大立光元大9B購04,0,0,0,0,0,0,0,0,0,49000,0,0,0,49000,0,49000,49000
062592,牧德統一01購01  ,0,0,0,0,0,0,0,0,0,49000,0,0,0,75000,26000,49000,49000
062641,瀚宇博國票9B購01,0,0,0,0,0,0,0,0,0,49000,0,0,0,84000,35000,49000,49000
062185,禾伸堂元大9B購01,0,0,0,0,0,0,0,0,0,49000,0,0,0,59000,10000,49000,49000
055970,聯茂元大97購04  ,0,0,0,0,0,0,0,0,0,49000,0,0,0,49000,0,49000,49000
056899,可成元大98購01  ,0,0,0,0,0,0,0,0,0,49000,0,0,0,68000,19000,49000,49000
00728,第一金工業30    ,0,0,0,0,0,0,0,0,0,49000,0,0,0,268000,219000,49000,49000
056642,旺宏凱基98購07  ,0,0,0,0,0,0,0,0,0,49000,0,0,0,50000,1000,49000,49000
056480,京鼎元大98購02  ,0,0,0,0,0,0,0,0,0,49000,0,0,0,49000,0,49000,49000
055124,建準兆豐97購01  ,0,0,0,0,0,0,0,0,0,49000,0,0,0,49000,0,49000,49000
056215,華新科國票97購03,0,0,0,0,0,0,0,0,0,49000,0,0,0,55000,6000,49000,49000
059364,昇陽半永豐99購02,0,0,0,0,0,0,0,0,0,49000,0,0,0,55000,6000,49000,49000
060326,群光群益9A購01  ,0,0,0,0,0,0,0,0,0,49000,0,0,0,197000,148000,49000,49000
060392,華擎群益9C購02  ,0,0,0,0,0,0,0,0,0,49000,0,0,0,159000,110000,49000,49000
060339,國巨統一01購01  ,0,0,0,0,0,0,0,0,0,49000,0,0,0,108000,59000,49000,49000
058274,世紀鋼永豐99購01,0,0,0,0,0,0,0,0,0,49000,0,0,0,54000,5000,49000,49000
06050P,玉晶光國票98售01,0,0,0,0,0,0,0,0,0,49000,0,0,0,110000,61000,49000,49000
2314,台揚            ,138000,89000,49000,0,0,0,0,0,0,0,0,0,0,0,0,0,49000
062108,晶豪科國票9B購01,0,0,0,0,0,0,0,0,0,48000,0,0,0,58000,10000,48000,48000
061951,南電群益9B購01  ,0,0,0,0,0,0,0,0,0,48000,0,0,0,98000,50000,48000,48000
056358,友訊元大99購01  ,0,0,0,0,0,0,0,0,0,48000,0,0,0,48000,0,48000,48000
059862,全新群益99購04  ,0,0,0,0,0,0,0,0,0,48000,0,0,0,98000,50000,48000,48000
054213,欣興國票97購04  ,0,0,0,0,0,0,0,0,0,48000,0,0,0,48000,0,48000,48000
055902,同欣電中信99購01,0,0,0,0,0,0,0,0,0,48000,0,0,0,740000,692000,48000,48000
055931,冠德群益97購02  ,0,0,0,0,0,0,0,0,0,48000,0,0,0,59000,11000,48000,48000
053496,義隆兆豐96購02  ,0,0,0,0,0,0,0,0,0,48000,0,0,0,135000,87000,48000,48000
057727,華邦電國泰9A購01,0,0,0,0,0,0,0,0,0,48000,0,0,0,186000,138000,48000,48000
061138,晶技統一9C購01  ,0,0,0,0,0,0,0,0,0,48000,0,0,0,65000,17000,48000,48000
061144,玉晶光中信9B購02,0,0,0,0,0,0,0,0,0,48000,0,0,0,48000,0,48000,48000
3024,憶聲            ,90000,42000,48000,0,0,0,0,0,0,0,0,0,0,0,0,0,48000
07408P,台積電兆豐99售06,0,0,0,0,0,0,0,0,0,48000,0,0,0,50000,2000,48000,48000
07867P,晶技元大9B售01  ,0,0,0,0,0,0,0,0,0,48000,0,0,0,173000,125000,48000,48000
06090P,旺宏統一97售06  ,0,0,0,0,0,0,0,0,0,48000,0,0,0,72000,24000,48000,48000
06999P,玉晶光國票9B售01,0,0,0,0,0,0,0,0,0,47000,0,0,0,65000,18000,47000,47000
062975,京鼎元富9B購01  ,0,0,0,0,0,0,0,0,0,47000,0,0,0,166000,119000,47000,47000
063121,友達元大9C購09  ,0,0,0,0,0,0,0,0,0,47000,0,0,0,108000,61000,47000,47000
063117,聯茂麥證9B購01  ,0,0,0,55000,8000,47000,0,0,0,47000,0,0,0,55000,8000,47000,47000
053610,矽力中信98購01  ,0,0,0,0,0,0,0,0,0,47000,0,0,0,70000,23000,47000,47000
053913,華新國票97購01  ,0,0,0,0,0,0,0,0,0,47000,0,0,0,130000,83000,47000,47000
05011P,南電國泰96售01  ,0,0,0,0,0,0,0,0,0,47000,0,0,0,47000,0,47000,47000
060229,楠梓電元大9C購01,0,0,0,0,0,0,0,0,0,47000,0,0,0,47000,0,47000,47000
06005P,晶豪科永豐96售04,0,0,0,0,0,0,0,0,0,47000,0,0,0,47000,0,47000,47000
056535,全新凱基99購02  ,0,0,0,0,0,0,0,0,0,47000,0,0,0,47000,0,47000,47000
057096,緯穎元富98購01  ,0,0,0,0,0,0,0,0,0,47000,0,0,0,47000,0,47000,47000
057675,同欣電元大98購02,0,0,0,0,0,0,0,0,0,47000,0,0,0,140000,93000,47000,47000
060540,南亞凱基9A購01  ,0,0,0,0,0,0,0,0,0,47000,0,0,0,73000,26000,47000,47000
058192,訊芯永豐99購01  ,0,0,0,0,0,0,0,0,0,47000,0,0,0,47000,0,47000,47000
057260,微星兆豐98購01  ,0,0,0,0,0,0,0,0,0,47000,0,0,0,78000,31000,47000,47000
060931,GIS永豐9A購01   ,0,0,0,0,0,0,0,0,0,47000,0,0,0,47000,0,47000,47000
060960,金像電凱基9B購01,0,0,0,0,0,0,0,0,0,47000,0,0,0,61000,14000,47000,47000
06545P,致茂元大98售01  ,0,0,0,0,0,0,0,0,0,46000,0,0,0,46000,0,46000,46000
062121,奇鋐台新9B購01  ,0,0,0,0,0,0,0,0,0,46000,0,0,0,74000,28000,46000,46000
062293,麗豐永豐9B購01  ,0,0,0,0,0,0,0,0,0,46000,0,0,0,46000,0,46000,46000
06254P,臺股指群益97售07,0,0,0,0,0,0,0,0,0,46000,0,0,0,194000,148000,46000,46000
056430,鴻海凱基98購06  ,0,0,0,0,0,0,0,0,0,46000,0,0,0,93000,47000,46000,46000
056776,聯茂元大99購01  ,0,0,0,0,0,0,0,0,0,46000,0,0,0,68000,22000,46000,46000
052561,矽創國票97購01  ,0,0,0,0,0,0,0,0,0,46000,0,0,0,146000,100000,46000,46000
054697,凌華永豐97購01  ,0,0,0,0,0,0,0,0,0,46000,0,0,0,63000,17000,46000,46000
056919,英業達兆豐98購01,0,0,0,0,0,0,0,0,0,46000,0,0,0,46000,0,46000,46000
054080,微星中信98購01  ,0,0,0,0,0,0,0,0,0,46000,0,0,0,58000,12000,46000,46000
059456,智易永豐99購01  ,0,0,0,0,0,0,0,0,0,46000,0,0,0,46000,0,46000,46000
058132,義隆元大99購03  ,0,0,0,0,0,0,0,0,0,46000,0,0,0,75000,29000,46000,46000
08154P,上銀元富9B售04  ,0,0,0,0,0,0,0,0,0,46000,0,0,0,46000,0,46000,46000
08127P,聯發科元大9B售21,0,0,0,0,0,0,0,0,0,46000,0,0,0,50000,4000,46000,46000
08063P,立積國票9B售03  ,0,0,0,0,0,0,0,0,0,46000,0,0,0,54000,8000,46000,46000
07365P,超眾元大99售07  ,0,0,0,0,0,0,0,0,0,46000,0,0,0,52000,6000,46000,46000
07387P,臺股指群益99售25,0,0,0,0,0,0,0,0,0,46000,0,0,0,66000,20000,46000,46000
062710,盛群元大9B購01  ,0,0,0,0,0,0,0,0,0,45000,0,0,0,110000,65000,45000,45000
062682,全新統一9B購01  ,0,0,0,0,0,0,0,0,0,45000,0,0,0,148000,103000,45000,45000
06681P,致茂元大98售02  ,0,0,0,0,0,0,0,0,0,45000,0,0,0,45000,0,45000,45000
053612,T50反1群益96購01,0,0,0,0,0,0,0,0,0,45000,0,0,0,45000,0,45000,45000
05983P,聯詠國票96售02  ,0,0,0,0,0,0,0,0,0,45000,0,0,0,45000,0,45000,45000
055063,玉晶光永豐99購01,0,0,0,0,0,0,0,0,0,45000,0,0,0,160000,115000,45000,45000
058370,聯詠凱基99購01  ,0,0,0,0,0,0,0,0,0,45000,0,0,0,50000,5000,45000,45000
058070,華新科凱基98購07,0,0,0,0,0,0,0,0,0,45000,0,0,0,45000,0,45000,45000
060363,美律元富9A購01  ,0,0,0,0,0,0,0,0,0,45000,0,0,0,210000,165000,45000,45000
057286,群創元大9B購05  ,0,0,0,0,0,0,0,0,0,45000,0,0,0,45000,0,45000,45000
07452P,國巨元大9A售05  ,0,0,0,0,0,0,0,0,0,45000,0,0,0,55000,10000,45000,45000
07468P,聯電元大9A售02  ,0,0,0,0,0,0,0,0,0,45000,0,0,0,55000,10000,45000,45000
1435,中福            ,62000,17000,45000,0,0,0,0,0,0,0,0,0,0,0,0,0,45000
060671,亞德客元大9A購03,0,0,0,0,0,0,0,0,0,45000,0,0,0,168000,123000,45000,45000
060622,玉晶光元大9B購02,0,0,0,0,0,0,0,0,0,45000,0,0,0,150000,105000,45000,45000
063181,聚陽凱基9B購01  ,0,0,0,0,0,0,0,0,0,44000,0,0,0,80000,36000,44000,44000
062694,遠東新元大9B購01,0,0,0,0,0,0,0,0,0,44000,0,0,0,50000,6000,44000,44000
062377,力成元大9B購01  ,0,0,0,0,0,0,0,0,0,44000,0,0,0,174000,130000,44000,44000
062075,智邦元大9B購03  ,0,0,0,0,0,0,0,0,0,44000,0,0,0,89000,45000,44000,44000
061548,聯詠群益9A購02  ,0,0,0,0,0,0,0,0,0,44000,0,0,0,44000,0,44000,44000
061717,力成凱基9B購01  ,0,0,0,0,0,0,0,0,0,44000,0,0,0,61000,17000,44000,44000
057082,玉晶光統一9A購04,0,0,0,0,0,0,0,0,0,44000,0,0,0,51000,7000,44000,44000
056129,義隆麥證97購01  ,0,0,0,50000,6000,44000,0,0,0,44000,0,0,0,50000,6000,44000,44000
060073,台積電元富99購03,0,0,0,0,0,0,0,0,0,44000,0,0,0,50000,6000,44000,44000
006207,FH滬深          ,2000,3000,-1000,0,0,0,0,0,0,45000,0,90000,-90000,472000,337000,135000,44000
03648C,T50反1元大96牛07,0,0,0,0,0,0,0,0,0,44000,0,0,0,57000,13000,44000,44000
057904,矽力永豐98購01  ,0,0,0,0,0,0,0,0,0,44000,0,0,0,63000,19000,44000,44000
060610,玉晶光凱基9B購02,0,0,0,0,0,0,0,0,0,44000,0,0,0,56000,12000,44000,44000
058505,台積電元大99購08,0,0,0,0,0,0,0,0,0,44000,0,0,0,134000,90000,44000,44000
1809,中釉            ,56000,12000,44000,0,0,0,0,0,0,0,0,0,0,0,0,0,44000
07762P,聯發科永豐9A售03,0,0,0,0,0,0,0,0,0,44000,0,0,0,44000,0,44000,44000
07889P,旭富國票9B售01  ,0,0,0,0,0,0,0,0,0,44000,0,0,0,101000,57000,44000,44000
061607,台表科凱基9B購02,0,0,0,0,0,0,0,0,0,43000,0,0,0,290000,247000,43000,43000
061568,國巨元大9A購25  ,0,0,0,0,0,0,0,0,0,43000,0,0,0,43000,0,43000,43000
062090,南電元大9B購02  ,0,0,0,0,0,0,0,0,0,43000,0,0,0,43000,0,43000,43000
062180,瑞昱元大9B購03  ,0,0,0,0,0,0,0,0,0,43000,0,0,0,165000,122000,43000,43000
062974,奇力新元富9B購01,0,0,0,0,0,0,0,0,0,43000,0,0,0,98000,55000,43000,43000
062874,微星兆豐9B購01  ,0,0,0,0,0,0,0,0,0,43000,0,0,0,63000,20000,43000,43000
06691P,臺股指群益9C售05,0,0,0,0,0,0,0,0,0,43000,0,0,0,43000,0,43000,43000
03678C,臺股指凱基01牛02,0,0,0,0,0,0,0,0,0,43000,0,0,0,123000,80000,43000,43000
053875,GIS元大97購01   ,0,0,0,0,0,0,0,0,0,43000,0,0,0,43000,0,43000,43000
054912,群光凱基97購01  ,0,0,0,0,0,0,0,0,0,43000,0,0,0,110000,67000,43000,43000
05711P,茂林國票97售03  ,0,0,0,0,0,0,0,0,0,43000,0,0,0,80000,37000,43000,43000
056068,欣興元大97購05  ,0,0,0,0,0,0,0,0,0,43000,0,0,0,44000,1000,43000,43000
057191,祥碩元大98購05  ,0,0,0,0,0,0,0,0,0,43000,0,0,0,43000,0,43000,43000
061357,寶成元大9A購01  ,0,0,0,0,0,0,0,0,0,43000,0,0,0,118000,75000,43000,43000
057766,矽力凱基98購03  ,0,0,0,0,0,0,0,0,0,43000,0,0,0,43000,0,43000,43000
07514P,台積電元大9A售14,0,0,0,0,0,0,0,0,0,43000,0,0,0,43000,0,43000,43000
2227,裕日車          ,17000,9000,8000,0,0,0,25000,0,25000,10000,10000,0,10000,0,0,0,43000
06734P,智邦凱基98售05  ,0,0,0,0,0,0,0,0,0,42000,0,0,0,162000,120000,42000,42000
06621P,欣興元大98售06  ,0,0,0,0,0,0,0,0,0,42000,0,0,0,42000,0,42000,42000
062982,同欣電元富9B購01,0,0,0,0,0,0,0,0,0,42000,0,0,0,95000,53000,42000,42000
062740,致伸國票9B購01  ,0,0,0,0,0,0,0,0,0,42000,0,0,0,80000,38000,42000,42000
062496,矽創中信9B購01  ,0,0,0,0,0,0,0,0,0,42000,0,0,0,339000,297000,42000,42000
055646,漢唐元富97購01  ,0,0,0,0,0,0,0,0,0,42000,0,0,0,42000,0,42000,42000
055026,健和興國泰98購01,0,0,0,0,0,0,0,0,0,42000,0,0,0,72000,30000,42000,42000
053461,台郡永昌99購01  ,0,0,0,0,0,0,0,0,0,42000,0,0,0,42000,0,42000,42000
057809,英業達元大98購01,0,0,0,0,0,0,0,0,0,42000,0,0,0,150000,108000,42000,42000
060375,葡萄王元富9A購01,0,0,0,0,0,0,0,0,0,42000,0,0,0,142000,100000,42000,42000
060032,利勤永豐99購01  ,0,0,0,0,0,0,0,0,0,42000,0,0,0,69000,27000,42000,42000
06000P,GIS元大96售04   ,0,0,0,0,0,0,0,0,0,42000,0,0,0,42000,0,42000,42000
057705,臺股指群益98購05,0,0,0,0,0,0,0,0,0,42000,0,0,0,86000,44000,42000,42000
060505,友達元大9C購05  ,0,0,0,0,0,0,0,0,0,42000,0,0,0,110000,68000,42000,42000
06025P,臺股指元大99售02,0,0,0,0,0,0,0,0,0,42000,0,0,0,72000,30000,42000,42000
058377,茂林凱基9A購03  ,0,0,0,0,0,0,0,0,0,42000,0,0,0,50000,8000,42000,42000
058295,欣興凱基99購02  ,0,0,0,0,0,0,0,0,0,42000,0,0,0,230000,188000,42000,42000
057995,華新科中信98購02,0,0,0,0,0,0,0,0,0,42000,0,0,0,42000,0,42000,42000
2316,楠梓電          ,116000,69000,47000,0,0,0,0,0,0,-5000,0,0,0,0,5000,-5000,42000
08093P,英業達元富9B售02,0,0,0,0,0,0,0,0,0,42000,0,0,0,58000,16000,42000,42000
062367,禾伸堂元大9B購02,0,0,0,0,0,0,0,0,0,41000,0,0,0,50000,9000,41000,41000
061651,世紀鋼元大9C購02,0,0,0,0,0,0,0,0,0,41000,0,0,0,45000,4000,41000,41000
061817,高鐵群益9B購01  ,9000,0,9000,0,0,0,0,0,0,32000,0,0,0,130000,98000,32000,41000
06608P,立積群益99售02  ,0,0,0,0,0,0,0,0,0,41000,0,0,0,54000,13000,41000,41000
06861P,台積電國票99售08,0,0,0,0,0,0,0,0,0,41000,0,0,0,41000,0,41000,41000
07045P,上銀國票9A售01  ,0,0,0,0,0,0,0,0,0,41000,0,0,0,44000,3000,41000,41000
052893,聯電群益98購01  ,0,0,0,0,0,0,0,0,0,41000,0,0,0,61000,20000,41000,41000
056077,矽力元大97購07  ,0,0,0,0,0,0,0,0,0,41000,0,0,0,51000,10000,41000,41000
057948,嘉聯益國票99購02,0,0,0,0,0,0,0,0,0,41000,0,0,0,45000,4000,41000,41000
059040,訊芯群益99購03  ,0,0,0,0,0,0,0,0,0,41000,0,0,0,98000,57000,41000,41000
07799P,南電國票9A售04  ,0,0,0,0,0,0,0,0,0,41000,0,0,0,41000,0,41000,41000
07803P,南亞科永豐9A售02,0,0,0,0,0,0,0,0,0,41000,0,0,0,58000,17000,41000,41000
057888,貿聯群益98購02  ,0,0,0,0,0,0,0,0,0,41000,0,0,0,41000,0,41000,41000
058247,聯茂元大99購04  ,0,0,0,0,0,0,0,0,0,41000,0,0,0,124000,83000,41000,41000
060165,上緯控永豐9A購01,0,0,0,0,0,0,0,0,0,41000,0,0,0,41000,0,41000,41000
07931P,國巨元大9B售03  ,0,0,0,0,0,0,0,0,0,41000,0,0,0,45000,4000,41000,41000
07863P,華新科凱基9B售07,0,0,0,0,0,0,0,0,0,41000,0,0,0,45000,4000,41000,41000
1460,宏遠            ,100000,59000,41000,0,0,0,0,0,0,0,0,0,0,0,0,0,41000
3209,全科            ,42000,1000,41000,0,0,0,0,0,0,0,0,0,0,0,0,0,41000
060632,可成富邦9B購01  ,0,0,0,0,0,0,0,0,0,41000,0,0,0,57000,16000,41000,41000
5608,四維航          ,107000,66000,41000,0,0,0,0,0,0,0,0,0,0,0,0,0,41000
060942,智邦國票9A購02  ,0,0,0,0,0,0,0,0,0,41000,0,0,0,72000,31000,41000,41000
06558P,旺宏元富98售02  ,0,0,0,0,0,0,0,0,0,40000,0,0,0,40000,0,40000,40000
061853,晶技國票9B購02  ,0,0,0,0,0,0,0,0,0,40000,0,0,0,42000,2000,40000,40000
061764,旺宏元大9B購01  ,0,0,0,0,0,0,0,0,0,40000,0,0,0,40000,0,40000,40000
062076,美律元大9B購02  ,0,0,0,0,0,0,0,0,0,40000,0,0,0,40000,0,40000,40000
06169P,華新科元富97售02,0,0,0,0,0,0,0,0,0,40000,0,0,0,40000,0,40000,40000
062324,上銀統一9B購04  ,0,0,0,0,0,0,0,0,0,40000,0,0,0,40000,0,40000,40000
062325,鴻海統一9B購05  ,0,0,0,0,0,0,0,0,0,40000,0,0,0,40000,0,40000,40000
062263,康控元大9B購03  ,0,0,0,0,0,0,0,0,0,40000,0,0,0,55000,15000,40000,40000
055126,嘉澤兆豐97購01  ,0,0,0,0,0,0,0,0,0,40000,0,0,0,40000,0,40000,40000
055521,S&P反1群益01購01,0,0,0,0,0,0,0,0,0,40000,0,0,0,40000,0,40000,40000
056720,世紀鋼永豐98購01,0,0,0,0,0,0,0,0,0,40000,0,0,0,40000,0,40000,40000
056291,聯茂永豐97購03  ,0,0,0,0,0,0,0,0,0,40000,0,0,0,40000,0,40000,40000
056553,啟碁凱基98購02  ,0,0,0,0,0,0,0,0,0,40000,0,0,0,40000,0,40000,40000
053411,深中小國票9B購01,0,0,0,0,0,0,0,0,0,40000,0,0,0,40000,0,40000,40000
055909,大成鋼凱基98購02,0,0,0,0,0,0,0,0,0,40000,0,0,0,40000,0,40000,40000
055955,微星元大97購01  ,0,0,0,0,0,0,0,0,0,40000,0,0,0,40000,0,40000,40000
052694,開發金中信98購01,0,0,0,0,0,0,0,0,0,40000,0,0,0,40000,0,40000,40000
057788,嘉聯益國票99購01,0,0,0,0,0,0,0,0,0,40000,0,0,0,40000,0,40000,40000
058528,世紀鋼元大99購02,0,0,0,0,0,0,0,0,0,40000,0,0,0,40000,0,40000,40000
060123,光罩永豐99購02  ,0,0,0,0,0,0,0,0,0,40000,0,0,0,40000,0,40000,40000
057893,亞德客元富98購03,0,0,0,0,0,0,0,0,0,40000,0,0,0,40000,0,40000,40000
057844,新日興永豐99購01,0,0,0,0,0,0,0,0,0,40000,0,0,0,40000,0,40000,40000
058910,泰鼎元大99購03  ,0,0,0,0,0,0,0,0,0,40000,0,0,0,42000,2000,40000,40000
061137,晶技統一9B購01  ,0,0,0,0,0,0,0,0,0,40000,0,0,0,47000,7000,40000,40000
058148,百和元大99購01  ,0,0,0,0,0,0,0,0,0,40000,0,0,0,90000,50000,40000,40000
060856,健策富邦9B購02  ,0,0,0,0,0,0,0,0,0,40000,0,0,0,70000,30000,40000,40000
5519,隆大            ,77000,37000,40000,0,0,0,0,0,0,0,0,0,0,0,0,0,40000
5203,訊連            ,90000,61000,29000,0,0,0,0,0,0,11000,13000,0,13000,0,2000,-2000,40000
07859P,台灣50麥證9A售04,0,0,0,40000,0,40000,0,0,0,40000,0,0,0,40000,0,40000,40000
07730P,臺股指凱基9A售22,0,0,0,0,0,0,0,0,0,40000,0,0,0,45000,5000,40000,40000
08064P,上証2X凱基9C售02,0,0,0,0,0,0,0,0,0,40000,0,0,0,40000,0,40000,40000
07638P,長榮航國票9A售01,0,0,0,0,0,0,0,0,0,40000,0,0,0,40000,0,40000,40000
07350P,台灣50國票99售11,0,0,0,0,0,0,0,0,0,40000,0,0,0,140000,100000,40000,40000
061521,亞光兆豐9A購02  ,0,0,0,0,0,0,0,0,0,39000,0,0,0,50000,11000,39000,39000
06177P,玉晶光元大98售07,0,0,0,0,0,0,0,0,0,39000,0,0,0,40000,1000,39000,39000
07058P,台積電凱基9A售07,0,0,0,0,0,0,0,0,0,39000,0,0,0,89000,50000,39000,39000
063112,祥碩兆豐9B購01  ,0,0,0,0,0,0,0,0,0,39000,0,0,0,39000,0,39000,39000
063326,正隆國票9B購01  ,0,0,0,0,0,0,0,0,0,39000,0,0,0,67000,28000,39000,39000
052731,宏達電國泰98購01,0,0,0,0,0,0,0,0,0,39000,0,0,0,89000,50000,39000,39000
051047,深中小群益99購01,0,0,0,0,0,0,0,0,0,39000,0,0,0,74000,35000,39000,39000
055652,聯詠元富01購01  ,0,0,0,0,0,0,0,0,0,39000,0,0,0,80000,41000,39000,39000
057094,祥碩元富98購01  ,0,0,0,0,0,0,0,0,0,39000,0,0,0,39000,0,39000,39000
05724P,致茂永豐96售01  ,0,0,0,0,0,0,0,0,0,39000,0,0,0,61000,22000,39000,39000
060133,牧德群益9B購01  ,0,0,0,0,0,0,0,0,0,39000,0,0,0,50000,11000,39000,39000
060317,台灣50群益02購01,0,0,0,0,0,0,0,0,0,39000,0,0,0,47000,8000,39000,39000
3048,益登            ,58000,19000,39000,0,0,0,0,0,0,0,0,0,0,0,0,0,39000
1905,華紙            ,277000,246000,31000,0,0,0,0,0,0,8000,8000,0,8000,0,0,0,39000
4438,廣越            ,47000,8000,39000,0,0,0,0,0,0,0,0,0,0,0,0,0,39000
6409,旭隼            ,195000,162000,33000,0,0,0,0,0,0,6000,6000,0,6000,0,0,0,39000
063321,泰鼎群益9B購03  ,0,0,0,0,0,0,0,0,0,38000,0,0,0,38000,0,38000,38000
063118,中鋼元大9C購01  ,0,0,0,0,0,0,0,0,0,38000,0,0,0,104000,66000,38000,38000
07126P,台積電元大99售23,0,0,0,0,0,0,0,0,0,38000,0,0,0,38000,0,38000,38000
06714P,台積電元大98售15,0,0,0,0,0,0,0,0,0,38000,0,0,0,48000,10000,38000,38000
063464,廣達元大9B購02  ,0,0,0,0,0,0,0,0,0,38000,0,0,0,44000,6000,38000,38000
061754,晶技麥證9B購01  ,0,0,0,48000,10000,38000,0,0,0,38000,0,0,0,48000,10000,38000,38000
061579,京鼎元大9A購02  ,0,0,0,0,0,0,0,0,0,38000,0,0,0,39000,1000,38000,38000
062548,智易永豐9B購01  ,0,0,0,0,0,0,0,0,0,38000,0,0,0,39000,1000,38000,38000
062564,矽創凱基9B購01  ,0,0,0,0,0,0,0,0,0,38000,0,0,0,328000,290000,38000,38000
062449,臻鼎元大9B購01  ,0,0,0,0,0,0,0,0,0,38000,0,0,0,50000,12000,38000,38000
062634,玉晶光國票9B購03,0,0,0,0,0,0,0,0,0,38000,0,0,0,41000,3000,38000,38000
056905,欣興元大98購03  ,0,0,0,0,0,0,0,0,0,38000,0,0,0,71000,33000,38000,38000
053583,漢唐元大96購03  ,0,0,0,0,0,0,0,0,0,38000,0,0,0,100000,62000,38000,38000
053316,友達群益9A購01  ,0,0,0,0,0,0,0,0,0,38000,0,0,0,38000,0,38000,38000
054043,漢唐元大97購01  ,0,0,0,0,0,0,0,0,0,38000,0,0,0,67000,29000,38000,38000
060584,玉晶光元富9A購01,0,0,0,0,0,0,0,0,0,38000,0,0,0,48000,10000,38000,38000
058289,奇鋐國票9A購01  ,0,0,0,0,0,0,0,0,0,38000,0,0,0,40000,2000,38000,38000
057945,京鼎國票99購03  ,0,0,0,0,0,0,0,0,0,38000,0,0,0,49000,11000,38000,38000
058049,帆宣元大98購01  ,0,0,0,0,0,0,0,0,0,38000,0,0,0,48000,10000,38000,38000
060621,玉晶光元大9A購05,0,0,0,0,0,0,0,0,0,38000,0,0,0,43000,5000,38000,38000
3356,奇偶            ,46000,7000,39000,0,0,0,0,0,0,-1000,0,1000,-1000,0,0,0,38000
1217,愛之味          ,135000,97000,38000,0,0,0,0,0,0,0,0,0,0,0,0,0,38000
2414,精技            ,39000,1000,38000,0,0,0,0,0,0,0,0,0,0,0,0,0,38000
08155P,聯發科元富9B售05,0,0,0,0,0,0,0,0,0,38000,0,0,0,38000,0,38000,38000
063355,超眾元富9B購01  ,0,0,0,0,0,0,0,0,0,37000,0,0,0,223000,186000,37000,37000
052781,瀚宇博國票97購03,0,0,0,0,0,0,0,0,0,37000,0,0,0,38000,1000,37000,37000
053431,志超永豐96購01  ,0,0,0,0,0,0,0,0,0,37000,0,0,0,42000,5000,37000,37000
054102,百和國票97購04  ,0,0,0,0,0,0,0,0,0,37000,0,0,0,37000,0,37000,37000
056784,南亞科群益98購01,0,0,0,0,0,0,0,0,0,37000,0,0,0,37000,0,37000,37000
056963,建準永豐98購01  ,0,0,0,0,0,0,0,0,0,37000,0,0,0,83000,46000,37000,37000
061166,玉晶光兆豐9B購01,0,0,0,0,0,0,0,0,0,37000,0,0,0,37000,0,37000,37000
058998,鴻海元大99購22  ,0,0,0,0,0,0,0,0,0,37000,0,0,0,37000,0,37000,37000
058374,玉晶光凱基9A購03,0,0,0,0,0,0,0,0,0,37000,0,0,0,48000,11000,37000,37000
058238,奇鋐元大99購02  ,0,0,0,0,0,0,0,0,0,37000,0,0,0,80000,43000,37000,37000
07780P,美律凱基9A售02  ,0,0,0,0,0,0,0,0,0,37000,0,0,0,70000,33000,37000,37000
07246P,旺宏凱基99售08  ,0,0,0,0,0,0,0,0,0,37000,0,0,0,97000,60000,37000,37000
08169P,台光電群益9B售04,0,0,0,0,0,0,0,0,0,37000,0,0,0,57000,20000,37000,37000
4722,國精化          ,37000,0,37000,0,0,0,0,0,0,0,0,0,0,0,0,0,37000
063397,廣達群益9B購02  ,0,0,0,0,0,0,0,0,0,36000,0,0,0,36000,0,36000,36000
063200,瑞昱統一9C購01  ,0,0,0,0,0,0,0,0,0,36000,0,0,0,225000,189000,36000,36000
063101,華通群益9B購07  ,0,0,0,0,0,0,0,0,0,36000,0,0,0,36000,0,36000,36000
056038,可成凱基97購01  ,0,0,0,0,0,0,0,0,0,36000,0,0,0,36000,0,36000,36000
055440,矽力國票98購01  ,0,0,0,0,0,0,0,0,0,36000,0,0,0,36000,0,36000,36000
055963,欣興元大97購04  ,0,0,0,0,0,0,0,0,0,36000,0,0,0,144000,108000,36000,36000
053455,台光電元富96購02,0,0,0,0,0,0,0,0,0,36000,0,0,0,102000,66000,36000,36000
057239,貿聯凱基98購05  ,0,0,0,0,0,0,0,0,0,36000,0,0,0,36000,0,36000,36000
057739,新日興富邦9B購01,0,0,0,0,0,0,0,0,0,36000,0,0,0,579000,543000,36000,36000
059056,技嘉凱基99購02  ,0,0,0,0,0,0,0,0,0,36000,0,0,0,39000,3000,36000,36000
059343,宏達電凱基99購04,0,0,0,0,0,0,0,0,0,36000,0,0,0,250000,214000,36000,36000
061238,晶技元大9A購02  ,0,0,0,0,0,0,0,0,0,36000,0,0,0,38000,2000,36000,36000
060679,聯詠元大9A購04  ,0,0,0,0,0,0,0,0,0,36000,0,0,0,97000,61000,36000,36000
07300P,臺股指元大9A售33,0,0,0,0,0,0,0,0,0,36000,0,0,0,70000,34000,36000,36000
07728P,臺股指凱基9A售20,0,0,0,0,0,0,0,0,0,36000,0,0,0,70000,34000,36000,36000
062998,泰碩國票01購01  ,0,0,0,0,0,0,0,0,0,35000,0,0,0,35000,0,35000,35000
061869,智邦元大9B購01  ,0,0,0,0,0,0,0,0,0,35000,0,0,0,87000,52000,35000,35000
062077,聯發科元大9B購04,0,0,0,0,0,0,0,0,0,35000,0,0,0,35000,0,35000,35000
062017,京鼎永豐9B購01  ,0,0,0,0,0,0,0,0,0,35000,0,0,0,47000,12000,35000,35000
055459,建準永豐97購03  ,0,0,0,0,0,0,0,0,0,35000,0,0,0,79000,44000,35000,35000
05626P,景碩國票97售03  ,0,0,0,0,0,0,0,0,0,35000,0,0,0,35000,0,35000,35000
057073,康控永豐98購01  ,0,0,0,0,0,0,0,0,0,35000,0,0,0,47000,12000,35000,35000
056512,易華電永豐98購01,0,0,0,0,0,0,0,0,0,35000,0,0,0,35000,0,35000,35000
056743,貿聯凱基98購04  ,0,0,0,0,0,0,0,0,0,35000,0,0,0,68000,33000,35000,35000
061109,臻鼎元大9A購03  ,0,0,0,0,0,0,0,0,0,35000,0,0,0,50000,15000,35000,35000
059070,道瓊指元大99購02,0,0,0,0,0,0,0,0,0,35000,0,0,0,40000,5000,35000,35000
057745,泰鼎永豐99購01  ,0,0,0,0,0,0,0,0,0,35000,0,0,0,65000,30000,35000,35000
060572,景碩永豐9A購01  ,0,0,0,0,0,0,0,0,0,35000,0,0,0,304000,269000,35000,35000
057497,祥碩元大98購06  ,0,0,0,0,0,0,0,0,0,35000,0,0,0,40000,5000,35000,35000
057505,健策麥證98購01  ,0,0,0,35000,0,35000,0,0,0,35000,0,0,0,35000,0,35000,35000
08042P,臺股指群益9B售15,0,0,0,0,0,0,0,0,0,35000,0,0,0,40000,5000,35000,35000
2338,光罩            ,466000,490000,-24000,0,0,0,0,0,0,59000,0,0,0,95000,36000,59000,35000
2616,山隆            ,73000,38000,35000,0,0,0,0,0,0,0,0,0,0,0,0,0,35000
06282P,聯鈞永豐97售02  ,0,0,0,0,0,0,0,0,0,34000,0,0,0,34000,0,34000,34000
056582,易華電元大98購01,0,0,0,0,0,0,0,0,0,34000,0,0,0,34000,0,34000,34000
056559,華通群益98購02  ,0,0,0,0,0,0,0,0,0,34000,0,0,0,81000,47000,34000,34000
060251,易華電元大9C購01,0,0,0,0,0,0,0,0,0,34000,0,0,0,47000,13000,34000,34000
05979P,華新科中信96售02,0,0,0,0,0,0,0,0,0,34000,0,0,0,34000,0,34000,34000
059989,嘉晶元大9A購01  ,0,0,0,0,0,0,0,0,0,34000,0,0,0,34000,0,34000,34000
056969,智易永豐98購01  ,0,0,0,0,0,0,0,0,0,34000,0,0,0,56000,22000,34000,34000
055522,道瓊反群益01購01,0,0,0,0,0,0,0,0,0,34000,0,0,0,34000,0,34000,34000
055417,健策富邦98購02  ,0,0,0,0,0,0,0,0,0,34000,0,0,0,50000,16000,34000,34000
060608,玉晶光凱基9A購08,0,0,0,0,0,0,0,0,0,34000,0,0,0,34000,0,34000,34000
058727,嘉晶富邦9A購01  ,0,0,0,0,0,0,0,0,0,34000,0,0,0,38000,4000,34000,34000
058007,南電群益98購02  ,0,0,0,0,0,0,0,0,0,34000,0,0,0,81000,47000,34000,34000
07925P,台積電凱基9B售05,0,0,0,0,0,0,0,0,0,34000,0,0,0,34000,0,34000,34000
07294P,滬深2X元富9C售08,0,0,0,0,0,0,0,0,0,34000,0,0,0,34000,0,34000,34000
060812,智邦凱基9A購01  ,0,0,0,0,0,0,0,0,0,34000,0,0,0,34000,0,34000,34000
060634,矽創富邦9B購01  ,0,0,0,0,0,0,0,0,0,34000,0,0,0,176000,142000,34000,34000
063562,國巨元大9C購06  ,0,0,0,0,0,0,0,0,0,33000,0,0,0,40000,7000,33000,33000
06766P,玉晶光元大99售10,0,0,0,0,0,0,0,0,0,33000,0,0,0,70000,37000,33000,33000
061987,大立光元大9B購03,0,0,0,0,0,0,0,0,0,33000,0,0,0,33000,0,33000,33000
062361,智邦元大9B購06  ,0,0,0,0,0,0,0,0,0,33000,0,0,0,171000,138000,33000,33000
055557,華新科凱基97購01,0,0,0,0,0,0,0,0,0,33000,0,0,0,33000,0,33000,33000
053428,中磊永豐96購02  ,0,0,0,0,0,0,0,0,0,33000,0,0,0,33000,0,33000,33000
039212,台達電台新9A購01,0,0,0,0,0,0,0,0,0,33000,0,0,0,34000,1000,33000,33000
01003T,兆豐新光R1      ,33000,0,33000,0,0,0,0,0,0,0,0,0,0,0,0,0,33000
059041,南茂群益99購02  ,0,0,0,0,0,0,0,0,0,33000,0,0,0,39000,6000,33000,33000
059082,華通元大99購06  ,0,0,0,0,0,0,0,0,0,33000,0,0,0,92000,59000,33000,33000
060306,台肥永豐9A購01  ,0,0,0,0,0,0,0,0,0,33000,0,0,0,35000,2000,33000,33000
6155,鈞寶            ,55000,22000,33000,0,0,0,0,0,0,0,0,0,0,0,0,0,33000
060813,高鐵凱基9A購01  ,0,0,0,0,0,0,0,0,0,33000,0,0,0,39000,6000,33000,33000
07359P,台積電元大99售45,0,0,0,0,0,0,0,0,0,33000,0,0,0,37000,4000,33000,33000
07670P,茂林元大9A售02  ,0,0,0,0,0,0,0,0,0,33000,0,0,0,33000,0,33000,33000
08032P,台積電統一9B售16,0,0,0,0,0,0,0,0,0,33000,0,0,0,33000,0,33000,33000
2369,菱生            ,372000,338000,34000,0,0,0,0,0,0,-1000,0,1000,-1000,0,0,0,33000
08178P,南亞科元大9B售01,0,0,0,0,0,0,0,0,0,33000,0,0,0,53000,20000,33000,33000
062360,華邦電元大9B購01,0,0,0,0,0,0,0,0,0,32000,0,0,0,218000,186000,32000,32000
062355,華通元大9B購03  ,0,0,0,0,0,0,0,0,0,32000,0,0,0,86000,54000,32000,32000
061979,友達元大9C購08  ,0,0,0,0,0,0,0,0,0,32000,0,0,0,100000,68000,32000,32000
063539,世紀鋼統一9B購02,0,0,0,0,0,0,0,0,0,32000,0,0,0,42000,10000,32000,32000
06411P,晶相光永豐97售03,0,0,0,0,0,0,0,0,0,32000,0,0,0,32000,0,32000,32000
062774,儒鴻元大9C購01  ,0,0,0,0,0,0,0,0,0,32000,0,0,0,32000,0,32000,32000
051872,矽力凱基96購01  ,0,0,0,0,0,0,0,0,0,32000,0,0,0,40000,8000,32000,32000
052622,貿聯兆豐97購01  ,0,0,0,0,0,0,0,0,0,32000,0,0,0,32000,0,32000,32000
053662,矽力凱基97購01  ,0,0,0,0,0,0,0,0,0,32000,0,0,0,45000,13000,32000,32000
054641,祥碩中信98購01  ,0,0,0,0,0,0,0,0,0,32000,0,0,0,52000,20000,32000,32000
060242,潤泰全元大9C購01,0,0,0,0,0,0,0,0,0,32000,0,0,0,100000,68000,32000,32000
060333,金寶康和9A購01  ,0,0,0,0,0,0,0,0,0,32000,0,0,0,32000,0,32000,32000
057794,T50反1兆豐99購02,0,0,0,0,0,0,0,0,0,32000,0,0,0,32000,0,32000,32000
057826,祥碩元大98購08  ,0,0,0,0,0,0,0,0,0,32000,0,0,0,73000,41000,32000,32000
058707,泰鼎元大99購02  ,0,0,0,0,0,0,0,0,0,32000,0,0,0,33000,1000,32000,32000
058283,世紀鋼中信99購01,0,0,0,0,0,0,0,0,0,32000,0,0,0,32000,0,32000,32000
05911P,南亞科永豐96售03,0,0,0,0,0,0,0,0,0,32000,0,0,0,45000,13000,32000,32000
057998,玉晶光麥證9A購01,0,0,0,32000,0,32000,0,0,0,32000,0,0,0,32000,0,32000,32000
061184,大立光國泰9C購01,0,0,0,0,0,0,0,0,0,32000,0,0,0,32000,0,32000,32000
07815P,美律群益9A售04  ,0,0,0,0,0,0,0,0,0,32000,0,0,0,73000,41000,32000,32000
061054,台積電群益9A購04,0,0,0,0,0,0,0,0,0,32000,0,0,0,54000,22000,32000,32000
07991P,鴻海群益9C售02  ,0,0,0,0,0,0,0,0,0,32000,0,0,0,40000,8000,32000,32000
07998P,聯電凱基9C售01  ,0,0,0,0,0,0,0,0,0,32000,0,0,0,34000,2000,32000,32000
08004P,大毅永豐9B售02  ,0,0,0,0,0,0,0,0,0,32000,0,0,0,32000,0,32000,32000
08156P,大立光元富9B售05,0,0,0,0,0,0,0,0,0,32000,0,0,0,59000,27000,32000,32000
07259P,滬深2X國票01售01,0,0,0,0,0,0,0,0,0,32000,0,0,0,52000,20000,32000,32000
062765,祥碩凱基9B購04  ,0,0,0,0,0,0,0,0,0,31000,0,0,0,72000,41000,31000,31000
063094,玉晶光國票01購03,0,0,0,0,0,0,0,0,0,31000,0,0,0,57000,26000,31000,31000
063317,大立光群益9B購06,0,0,0,0,0,0,0,0,0,31000,0,0,0,149000,118000,31000,31000
06355P,聯茂永豐97售02  ,0,0,0,0,0,0,0,0,0,31000,0,0,0,179000,148000,31000,31000
07070P,晶相光元富99售01,0,0,0,0,0,0,0,0,0,31000,0,0,0,34000,3000,31000,31000
061793,上銀永豐9B購01  ,0,0,0,0,0,0,0,0,0,31000,0,0,0,31000,0,31000,31000
061790,中租群益9B購01  ,0,0,0,0,0,0,0,0,0,31000,0,0,0,31000,0,31000,31000
061573,義隆元大9A購02  ,0,0,0,0,0,0,0,0,0,31000,0,0,0,166000,135000,31000,31000
062135,國巨群益9B購05  ,0,0,0,0,0,0,0,0,0,31000,0,0,0,39000,8000,31000,31000
05976P,國巨凱基96售14  ,0,0,0,0,0,0,0,0,0,31000,0,0,0,31000,0,31000,31000
059914,台積電元大99購47,0,0,0,0,0,0,0,0,0,31000,0,0,0,51000,20000,31000,31000
056783,國巨群益99購01  ,0,0,0,0,0,0,0,0,0,31000,0,0,0,61000,30000,31000,31000
056972,祥碩永豐98購02  ,0,0,0,0,0,0,0,0,0,31000,0,0,0,31000,0,31000,31000
054687,建準永豐97購02  ,0,0,0,0,0,0,0,0,0,31000,0,0,0,62000,31000,31000,31000
054061,晶技國票97購03  ,0,0,0,0,0,0,0,0,0,31000,0,0,0,33000,2000,31000,31000
03434B,臺股指元大99熊10,0,0,0,0,0,0,0,0,0,31000,0,0,0,31000,0,31000,31000
048550,中鴻元大96購01  ,0,0,0,0,0,0,0,0,0,31000,0,0,0,31000,0,31000,31000
061223,T50反1中信01購01,0,0,0,0,0,0,0,0,0,31000,0,0,0,31000,0,31000,31000
061149,華通群益9A購05  ,0,0,0,0,0,0,0,0,0,31000,0,0,0,41000,10000,31000,31000
058276,道瓊指中信9C購01,0,0,0,0,0,0,0,0,0,31000,0,0,0,31000,0,31000,31000
058527,世紀鋼元大99購01,0,0,0,0,0,0,0,0,0,31000,0,0,0,31000,0,31000,31000
060134,鈺齊群益9A購01  ,0,0,0,0,0,0,0,0,0,31000,0,0,0,32000,1000,31000,31000
6215,和椿            ,31000,0,31000,0,0,0,0,0,0,0,0,0,0,0,0,0,31000
9938,百和            ,625000,143000,482000,0,0,0,0,420000,-420000,-31000,13000,16000,-3000,36000,64000,-28000,31000
06214P,國巨國票98售04  ,0,0,0,0,0,0,0,0,0,30000,0,0,0,30000,0,30000,30000
062211,玉晶光台新9B購01,0,0,0,0,0,0,0,0,0,30000,0,0,0,30000,0,30000,30000
062197,聯發科中信01購03,0,0,0,0,0,0,0,0,0,30000,0,0,0,30000,0,30000,30000
062505,祥碩群益9B購03  ,0,0,0,0,0,0,0,0,0,30000,0,0,0,31000,1000,30000,30000
061569,旺宏元大9A購14  ,0,0,0,0,0,0,0,0,0,30000,0,0,0,80000,50000,30000,30000
061486,國巨兆豐9B購02  ,0,0,0,0,0,0,0,0,0,30000,0,0,0,37000,7000,30000,30000
061481,嘉澤元大9A購03  ,0,0,0,0,0,0,0,0,0,30000,0,0,0,31000,1000,30000,30000
07015P,國巨元大99售13  ,0,0,0,0,0,0,0,0,0,30000,0,0,0,30000,0,30000,30000
06843P,鴻海元大98售11  ,0,0,0,0,0,0,0,0,0,30000,0,0,0,48000,18000,30000,30000
06911P,鴻海元大99售09  ,0,0,0,0,0,0,0,0,0,30000,0,0,0,130000,100000,30000,30000
06543P,鴻海元大98售08  ,0,0,0,0,0,0,0,0,0,30000,0,0,0,81000,51000,30000,30000
06544P,鴻海元大98售09  ,0,0,0,0,0,0,0,0,0,30000,0,0,0,30000,0,30000,30000
06336P,鴻海元大98售05  ,0,0,0,0,0,0,0,0,0,30000,0,0,0,30000,0,30000,30000
050282,T50反1凱基97購01,0,0,0,0,0,0,0,0,0,30000,0,0,0,30000,0,30000,30000
054185,喬山永豐96購02  ,0,0,0,0,0,0,0,0,0,30000,0,0,0,30000,0,30000,30000
051700,深中小群益99購04,0,0,0,0,0,0,0,0,0,30000,0,0,0,30000,0,30000,30000
052060,旺宏國票96購02  ,0,0,0,0,0,0,0,0,0,30000,0,0,0,30000,0,30000,30000
03604P,群創凱基98售05  ,0,0,0,0,0,0,0,0,0,30000,0,0,0,30000,0,30000,30000
054062,TPK國票96購02   ,0,0,0,0,0,0,0,0,0,30000,0,0,0,60000,30000,30000,30000
052746,泰碩元大97購01  ,0,0,0,0,0,0,0,0,0,30000,0,0,0,30000,0,30000,30000
05362P,可成富邦97售02  ,0,0,0,0,0,0,0,0,0,30000,0,0,0,30000,0,30000,30000
053432,世紀鋼永豐96購02,0,0,0,0,0,0,0,0,0,30000,0,0,0,30000,0,30000,30000
055894,欣興統一97購03  ,0,0,0,0,0,0,0,0,0,30000,0,0,0,50000,20000,30000,30000
055856,新唐元大97購03  ,0,0,0,0,0,0,0,0,0,30000,0,0,0,30000,0,30000,30000
056820,欣興永豐98購02  ,0,0,0,0,0,0,0,0,0,30000,0,0,0,30000,0,30000,30000
057019,台積電凱基98購14,0,0,0,0,0,0,0,0,0,30000,0,0,0,30000,0,30000,30000
057032,A50反1元大9B購01,0,0,0,0,0,0,0,0,0,30000,0,0,0,30000,0,30000,30000
054930,群電凱基98購01  ,0,0,0,0,0,0,0,0,0,30000,0,0,0,40000,10000,30000,30000
055019,福懋科元富97購01,0,0,0,0,0,0,0,0,0,30000,0,0,0,30000,0,30000,30000
055052,凱美永豐97購01  ,0,0,0,0,0,0,0,0,0,30000,0,0,0,30000,0,30000,30000
05629P,聯發科永昌99售02,0,0,0,0,0,0,0,0,0,30000,0,0,0,30000,0,30000,30000
06013P,世芯國泰97售03  ,0,0,0,0,0,0,0,0,0,30000,0,0,0,30000,0,30000,30000
057828,緯穎元大99購02  ,0,0,0,0,0,0,0,0,0,30000,0,0,0,35000,5000,30000,30000
057787,TPK國票99購01   ,0,0,0,0,0,0,0,0,0,30000,0,0,0,70000,40000,30000,30000
058623,國巨國票99購08  ,0,0,0,0,0,0,0,0,0,30000,0,0,0,30000,0,30000,30000
057916,國巨凱基98購13  ,0,0,0,0,0,0,0,0,0,30000,0,0,0,30000,0,30000,30000
057272,台積電元大98購14,0,0,0,0,0,0,0,0,0,30000,0,0,0,30000,0,30000,30000
057332,旺宏國票99購03  ,0,0,0,0,0,0,0,0,0,30000,0,0,0,30000,0,30000,30000
060522,鴻海中信9A購03  ,0,0,0,0,0,0,0,0,0,30000,0,0,0,30000,0,30000,30000
057539,南茂元大98購02  ,0,0,0,0,0,0,0,0,0,30000,0,0,0,159000,129000,30000,30000
057557,聯茂凱基99購04  ,0,0,0,0,0,0,0,0,0,30000,0,0,0,30000,0,30000,30000
057471,昇陽半永豐98購02,0,0,0,0,0,0,0,0,0,30000,0,0,0,30000,0,30000,30000
05895P,奇力新群益96售03,0,0,0,0,0,0,0,0,0,30000,0,0,0,30000,0,30000,30000
059030,奇力新兆豐99購03,0,0,0,0,0,0,0,0,0,30000,0,0,0,30000,0,30000,30000
059371,聯鈞元富99購02  ,0,0,0,0,0,0,0,0,0,30000,0,0,0,30000,0,30000,30000
059311,元石油元大99購04,0,0,0,0,0,0,0,0,0,30000,0,0,0,40000,10000,30000,30000
05926P,智易永豐96售02  ,0,0,0,0,0,0,0,0,0,30000,0,0,0,30000,0,30000,30000
059126,臺指反中信9B購01,0,0,0,0,0,0,0,0,0,30000,0,0,0,30000,0,30000,30000
058790,楠梓電元大99購03,0,0,0,0,0,0,0,0,0,30000,0,0,0,80000,50000,30000,30000
05848P,臺股指元大96售24,0,0,0,0,0,0,0,0,0,30000,0,0,0,30000,0,30000,30000
060680,玉晶光元大9C購03,0,0,0,0,0,0,0,0,0,30000,0,0,0,55000,25000,30000,30000
060667,力成凱基9A購01  ,0,0,0,0,0,0,0,0,0,30000,0,0,0,32000,2000,30000,30000
060730,台積電群益9A購03,0,0,0,0,0,0,0,0,0,30000,0,0,0,31000,1000,30000,30000
060894,奇力新凱基9A購03,0,0,0,0,0,0,0,0,0,30000,0,0,0,30000,0,30000,30000
07363P,大立光元大99售26,0,0,0,0,0,0,0,0,0,30000,0,0,0,30000,0,30000,30000
07383P,聯發科群益99售06,0,0,0,0,0,0,0,0,0,30000,0,0,0,30000,0,30000,30000
07370P,南亞科凱基99售08,0,0,0,0,0,0,0,0,0,30000,0,0,0,30000,0,30000,30000
07598P,臺股指中信01售03,0,0,0,0,0,0,0,0,0,30000,0,0,0,30000,0,30000,30000
07521P,台積電中信01售05,0,0,0,0,0,0,0,0,0,30000,0,0,0,30000,0,30000,30000
07491P,臺股指國票9A售09,0,0,0,0,0,0,0,0,0,30000,0,0,0,30000,0,30000,30000
07934P,臺股指國票9B售06,0,0,0,0,0,0,0,0,0,30000,0,0,0,30000,0,30000,30000
07704P,台積電元大9A售25,0,0,0,0,0,0,0,0,0,30000,0,0,0,30000,0,30000,30000
2351,順德            ,97000,62000,35000,0,0,0,25000,30000,-5000,0,0,0,0,0,0,0,30000
3003,健和興          ,118000,65000,53000,0,0,0,0,0,0,-23000,0,0,0,2000,25000,-23000,30000
06538P,國巨凱基98售11  ,0,0,0,0,0,0,0,0,0,29000,0,0,0,60000,31000,29000,29000
06586P,鴻海元大9C售01  ,0,0,0,0,0,0,0,0,0,29000,0,0,0,150000,121000,29000,29000
06359P,上銀群益97售03  ,0,0,0,0,0,0,0,0,0,29000,0,0,0,29000,0,29000,29000
061787,華新科群益9C購01,0,0,0,0,0,0,0,0,0,29000,0,0,0,61000,32000,29000,29000
062378,台表科元大9C購01,0,0,0,0,0,0,0,0,0,29000,0,0,0,77000,48000,29000,29000
056644,宏達電凱基98購04,0,0,0,0,0,0,0,0,0,29000,0,0,0,59000,30000,29000,29000
05658P,日月光元富96售02,0,0,0,0,0,0,0,0,0,29000,0,0,0,39000,10000,29000,29000
060119,上銀富邦9B購03  ,0,0,0,0,0,0,0,0,0,29000,0,0,0,29000,0,29000,29000
055173,瑞昱統一97購01  ,0,0,0,0,0,0,0,0,0,29000,0,0,0,108000,79000,29000,29000
055059,健和興永豐97購01,0,0,0,0,0,0,0,0,0,29000,0,0,0,30000,1000,29000,29000
060265,宏達電國票9A購02,0,0,0,0,0,0,0,0,0,29000,0,0,0,75000,46000,29000,29000
061067,貿聯凱基9A購03  ,0,0,0,0,0,0,0,0,0,29000,0,0,0,100000,71000,29000,29000
057457,華邦電富邦98購01,0,0,0,0,0,0,0,0,0,29000,0,0,0,95000,66000,29000,29000
1464,得力            ,72000,43000,29000,0,0,0,0,0,0,0,0,0,0,0,0,0,29000
08053P,臺股指國票9B售18,0,0,0,0,0,0,0,0,0,29000,0,0,0,49000,20000,29000,29000
060684,同欣電元大9A購01,15000,0,15000,0,0,0,0,0,0,14000,0,0,0,102000,88000,14000,29000
060782,道瓊指富邦9C購01,0,0,0,0,0,0,0,0,0,29000,0,0,0,29000,0,29000,29000
9943,好樂迪          ,30000,1000,29000,0,0,0,0,0,0,0,0,0,0,0,0,0,29000
06265P,美律凱基97售01  ,0,0,0,0,0,0,0,0,0,28000,0,0,0,50000,22000,28000,28000
062594,祥碩統一01購02  ,0,0,0,0,0,0,0,0,0,28000,0,0,0,38000,10000,28000,28000
063257,牧德國泰01購01  ,0,0,0,0,0,0,0,0,0,28000,0,0,0,42000,14000,28000,28000
063016,微星元大9C購02  ,0,0,0,0,0,0,0,0,0,28000,0,0,0,169000,141000,28000,28000
062915,嘉澤元大9B購03  ,0,0,0,0,0,0,0,0,0,28000,0,0,0,66000,38000,28000,28000
055635,緯穎永豐97購01  ,0,0,0,0,0,0,0,0,0,28000,0,0,0,40000,12000,28000,28000
06021P,世紀鋼元富96售03,0,0,0,0,0,0,0,0,0,28000,0,0,0,91000,63000,28000,28000
056330,玉晶光國票99購03,0,0,0,0,0,0,0,0,0,28000,0,0,0,28000,0,28000,28000
054700,致新永豐97購01  ,0,0,0,0,0,0,0,0,0,28000,0,0,0,28000,0,28000,28000
00713,元大台灣高息低波,1000,0,1000,0,0,0,0,0,0,27000,0,0,0,27000,0,27000,28000
00669R,國泰美國道瓊反1 ,16000,0,16000,0,0,0,0,0,0,12000,0,0,0,1632000,1620000,12000,28000
05757P,旺宏永豐96售03  ,0,0,0,0,0,0,0,0,0,28000,0,0,0,28000,0,28000,28000
060512,祥碩元大9A購02  ,0,0,0,0,0,0,0,0,0,28000,0,0,0,54000,26000,28000,28000
057352,大立光統一9A購02,0,0,0,0,0,0,0,0,0,28000,0,0,0,28000,0,28000,28000
060582,玉晶光群益9C購01,0,0,0,0,0,0,0,0,0,28000,0,0,0,28000,0,28000,28000
057743,華擎永豐98購03  ,0,0,0,0,0,0,0,0,0,28000,0,0,0,110000,82000,28000,28000
060033,臻鼎永豐99購01  ,0,0,0,0,0,0,0,0,0,28000,0,0,0,79000,51000,28000,28000
07851P,聯發科國票9A售05,0,0,0,0,0,0,0,0,0,28000,0,0,0,128000,100000,28000,28000
058929,可成統一9C購01  ,0,0,0,0,0,0,0,0,0,28000,0,0,0,50000,22000,28000,28000
05930P,景碩康和96售01  ,0,0,0,0,0,0,0,0,0,28000,0,0,0,28000,0,28000,28000
07886P,國巨國票9B售06  ,0,0,0,0,0,0,0,0,0,28000,0,0,0,28000,0,28000,28000
07555P,玉晶光元大9A售07,0,0,0,0,0,0,0,0,0,28000,0,0,0,46000,18000,28000,28000
07235P,T50正2元大9C售02,0,0,0,0,0,0,0,0,0,28000,0,0,0,28000,0,28000,28000
2546,根基            ,49000,21000,28000,0,0,0,0,0,0,0,0,0,0,0,0,0,28000
062971,英業達元富9B購01,0,0,0,0,0,0,0,0,0,27000,0,0,0,154000,127000,27000,27000
06679P,旺宏元大98售09  ,0,0,0,0,0,0,0,0,0,27000,0,0,0,27000,0,27000,27000
06669P,緯穎凱基98售05  ,0,0,0,0,0,0,0,0,0,27000,0,0,0,35000,8000,27000,27000
061796,興勤永豐9B購01  ,0,0,0,0,0,0,0,0,0,27000,0,0,0,115000,88000,27000,27000
06165P,臺股指凱基9A售03,0,0,0,0,0,0,0,0,0,27000,0,0,0,122000,95000,27000,27000
054151,瑞昱國泰97購01  ,0,0,0,0,0,0,0,0,0,27000,0,0,0,41000,14000,27000,27000
052696,玉晶光麥證97購01,0,0,0,48000,11000,37000,0,0,0,27000,0,0,0,59000,32000,27000,27000
059816,聯電凱基99購03  ,0,0,0,0,0,0,0,0,0,27000,0,0,0,187000,160000,27000,27000
058481,玉晶光凱基9A購04,0,0,0,0,0,0,0,0,0,27000,0,0,0,27000,0,27000,27000
060427,聯茂永豐9A購01  ,0,0,0,0,0,0,0,0,0,27000,0,0,0,27000,0,27000,27000
060130,瀚宇博永豐99購02,0,0,0,0,0,0,0,0,0,27000,0,0,0,180000,153000,27000,27000
060556,緯穎凱基9A購04  ,0,0,0,0,0,0,0,0,0,27000,0,0,0,40000,13000,27000,27000
3015,全漢            ,29000,2000,27000,0,0,0,0,0,0,0,0,0,0,0,0,0,27000
3050,鈺德            ,35000,6000,29000,0,0,0,0,0,0,-2000,0,2000,-2000,0,0,0,27000
1786,科妍            ,29000,2000,27000,0,0,0,0,0,0,0,0,0,0,0,0,0,27000
07958P,華擎群益9B售01  ,0,0,0,0,0,0,0,0,0,27000,0,0,0,30000,3000,27000,27000
08135P,玉晶光國泰01售02,0,0,0,0,0,0,0,0,0,27000,0,0,0,60000,33000,27000,27000
061005,可成兆豐9A購01  ,0,0,0,0,0,0,0,0,0,27000,0,0,0,126000,99000,27000,27000
4155,訊映            ,22000,4000,18000,0,0,0,0,0,0,9000,9000,0,9000,0,0,0,27000
4108,懷特            ,58000,31000,27000,0,0,0,0,0,0,0,0,0,0,0,0,0,27000
062618,祥碩元大9B購04  ,0,0,0,0,0,0,0,0,0,26000,0,0,0,28000,2000,26000,26000
062712,晶技麥證9B購02  ,0,0,0,26000,0,26000,0,0,0,26000,0,0,0,26000,0,26000,26000
062787,超眾元大9C購02  ,0,0,0,0,0,0,0,0,0,26000,0,0,0,76000,50000,26000,26000
059817,華通凱基99購05  ,0,0,0,0,0,0,0,0,0,26000,0,0,0,26000,0,26000,26000
055561,奇鋐凱基97購01  ,0,0,0,0,0,0,0,0,0,26000,0,0,0,86000,60000,26000,26000
055563,智易凱基97購02  ,0,0,0,0,0,0,0,0,0,26000,0,0,0,36000,10000,26000,26000
054821,貿聯元大9A購01  ,0,0,0,0,0,0,0,0,0,26000,0,0,0,26000,0,26000,26000
049795,華通元大96購02  ,0,0,0,0,0,0,0,0,0,26000,0,0,0,26000,0,26000,26000
00733,富邦臺灣中小    ,0,0,0,0,0,0,0,0,0,26000,0,0,0,226000,200000,26000,26000
059450,和大永豐99購01  ,0,0,0,0,0,0,0,0,0,26000,0,0,0,45000,19000,26000,26000
059454,亞光永豐99購01  ,0,0,0,0,0,0,0,0,0,26000,0,0,0,57000,31000,26000,26000
058588,致茂中信9B購01  ,0,0,0,0,0,0,0,0,0,26000,0,0,0,45000,19000,26000,26000
059469,智邦元大99購03  ,0,0,0,0,0,0,0,0,0,26000,0,0,0,51000,25000,26000,26000
057556,智易凱基99購01  ,0,0,0,0,0,0,0,0,0,26000,0,0,0,55000,29000,26000,26000
057376,新日興元大98購04,0,0,0,0,0,0,0,0,0,26000,0,0,0,180000,154000,26000,26000
058428,大立光元富99購02,0,0,0,0,0,0,0,0,0,26000,0,0,0,31000,5000,26000,26000
059123,訊芯永豐99購03  ,0,0,0,0,0,0,0,0,0,26000,0,0,0,94000,68000,26000,26000
059357,華通永豐99購01  ,0,0,0,0,0,0,0,0,0,26000,0,0,0,26000,0,26000,26000
059200,京鼎永豐99購02  ,0,0,0,0,0,0,0,0,0,26000,0,0,0,40000,14000,26000,26000
059256,臺股指凱基99購34,0,0,0,0,0,0,0,0,0,26000,0,0,0,37000,11000,26000,26000
059015,華通元富99購02  ,0,0,0,0,0,0,0,0,0,26000,0,0,0,26000,0,26000,26000
6431,光麗-KY         ,26000,0,26000,0,0,0,0,0,0,0,0,0,0,0,0,0,26000
8104,錸寶            ,41000,15000,26000,0,0,0,0,0,0,0,1000,1000,0,0,0,0,26000
8429,金麗-KY         ,33000,7000,26000,0,0,0,0,0,0,0,0,0,0,0,0,0,26000
08105P,景碩元大9B售01  ,0,0,0,0,0,0,0,0,0,26000,0,0,0,26000,0,26000,26000
1466,聚隆            ,26000,0,26000,0,0,0,0,0,0,0,0,0,0,0,0,0,26000
06885P,國巨國票99售06  ,0,0,0,0,0,0,0,0,0,25000,0,0,0,36000,11000,25000,25000
06925P,致茂群益9A售02  ,0,0,0,0,0,0,0,0,0,25000,0,0,0,25000,0,25000,25000
06356P,啟碁永豐97售01  ,0,0,0,0,0,0,0,0,0,25000,0,0,0,37000,12000,25000,25000
06616P,國巨元大98售15  ,0,0,0,0,0,0,0,0,0,25000,0,0,0,43000,18000,25000,25000
06599P,宏達電永豐98售02,0,0,0,0,0,0,0,0,0,25000,0,0,0,25000,0,25000,25000
062323,上銀統一9B購03  ,0,0,0,0,0,0,0,0,0,25000,0,0,0,75000,50000,25000,25000
061902,百和永豐9B購01  ,0,0,0,0,0,0,0,0,0,25000,0,0,0,25000,0,25000,25000
061990,台勝科元大9C購01,0,0,0,0,0,0,0,0,0,25000,0,0,0,75000,50000,25000,25000
03875P,滬深2X國票05售01,0,0,0,0,0,0,0,0,0,25000,0,0,0,27000,2000,25000,25000
053939,台表科元富96購03,0,0,0,0,0,0,0,0,0,25000,0,0,0,45000,20000,25000,25000
053788,泰鼎元大97購01  ,0,0,0,0,0,0,0,0,0,25000,0,0,0,25000,0,25000,25000
055838,致茂元大97購03  ,0,0,0,0,0,0,0,0,0,25000,0,0,0,25000,0,25000,25000
05706P,TPK永豐96售02   ,0,0,0,0,0,0,0,0,0,25000,0,0,0,25000,0,25000,25000
05537P,群創中信98售01  ,0,0,0,0,0,0,0,0,0,25000,0,0,0,25000,0,25000,25000
059819,台積電凱基99購17,0,0,0,0,0,0,0,0,0,25000,0,0,0,25000,0,25000,25000
059842,台積電富邦9C購05,0,0,0,0,0,0,0,0,0,25000,0,0,0,35000,10000,25000,25000
057969,緯穎國泰99購01  ,0,0,0,0,0,0,0,0,0,25000,0,0,0,44000,19000,25000,25000
059324,智易元大99購04  ,0,0,0,0,0,0,0,0,0,25000,0,0,0,25000,0,25000,25000
058139,臻鼎元大99購01  ,0,0,0,0,0,0,0,0,0,25000,0,0,0,26000,1000,25000,25000
058356,華邦電凱基99購01,0,0,0,0,0,0,0,0,0,25000,0,0,0,35000,10000,25000,25000
061201,FBVIX元大01購03 ,0,0,0,0,0,0,0,0,0,25000,0,0,0,30000,5000,25000,25000
057842,緯穎富邦99購02  ,0,0,0,0,0,0,0,0,0,25000,0,0,0,35000,10000,25000,25000
057601,中磊群益98購01  ,0,0,0,0,0,0,0,0,0,25000,0,0,0,75000,50000,25000,25000
058589,群創中信01購01  ,0,0,0,0,0,0,0,0,0,25000,0,0,0,25000,0,25000,25000
059452,全新永豐99購03  ,0,0,0,0,0,0,0,0,0,25000,0,0,0,25000,0,25000,25000
058524,超眾元大99購04  ,0,0,0,0,0,0,0,0,0,25000,0,0,0,86000,61000,25000,25000
060389,世紀鋼凱基9B購02,0,0,0,0,0,0,0,0,0,25000,0,0,0,25000,0,25000,25000
057819,新日興元大99購01,0,0,0,0,0,0,0,0,0,25000,0,0,0,169000,144000,25000,25000
057805,華通元大98購06  ,0,0,0,0,0,0,0,0,0,25000,0,0,0,32000,7000,25000,25000
07882P,台灣50凱基01售12,0,0,0,0,0,0,0,0,0,25000,0,0,0,25000,0,25000,25000
07325P,台積電元大99售41,0,0,0,0,0,0,0,0,0,25000,0,0,0,2024000,1999000,25000,25000
060794,景碩永豐9A購02  ,0,0,0,0,0,0,0,0,0,25000,0,0,0,263000,238000,25000,25000
060776,世芯凱基9B購01  ,0,0,0,0,0,0,0,0,0,25000,0,0,0,70000,45000,25000,25000
061994,瑞儀元大9B購01  ,0,0,0,0,0,0,0,0,0,24000,0,0,0,48000,24000,24000,24000
061855,台郡國票9B購01  ,0,0,0,0,0,0,0,0,0,24000,0,0,0,67000,43000,24000,24000
062738,可成國票9B購02  ,0,0,0,0,0,0,0,0,0,24000,0,0,0,27000,3000,24000,24000
06648P,華邦電元大98售03,0,0,0,0,0,0,0,0,0,24000,0,0,0,40000,16000,24000,24000
062821,華擎兆豐9C購01  ,0,0,0,0,0,0,0,0,0,24000,0,0,0,109000,85000,24000,24000
05639P,欣興統一97售01  ,0,0,0,0,0,0,0,0,0,24000,0,0,0,28000,4000,24000,24000
056651,聯茂凱基98購04  ,0,0,0,0,0,0,0,0,0,24000,0,0,0,54000,30000,24000,24000
056281,深中小永豐97購01,0,0,0,0,0,0,0,0,0,24000,0,0,0,54000,30000,24000,24000
057138,亞德客兆豐98購01,0,0,0,0,0,0,0,0,0,24000,0,0,0,29000,5000,24000,24000
054844,華邦電兆豐98購01,0,0,0,0,0,0,0,0,0,24000,0,0,0,32000,8000,24000,24000
055846,大立光元大97購09,0,0,0,0,0,0,0,0,0,24000,0,0,0,24000,0,24000,24000
053800,華通凱基97購03  ,0,0,0,0,0,0,0,0,0,24000,0,0,0,34000,10000,24000,24000
05212P,台積電國票96售04,0,0,0,0,0,0,0,0,0,24000,0,0,0,142000,118000,24000,24000
058626,瑞昱國票9A購01  ,0,0,0,0,0,0,0,0,0,24000,0,0,0,27000,3000,24000,24000
059550,台灣50日盛99購02,0,0,0,0,0,0,0,0,0,24000,0,0,0,24000,0,24000,24000
060336,南電康和9A購01  ,0,0,0,0,0,0,0,0,0,24000,0,0,0,24000,0,24000,24000
059501,可成元富99購01  ,0,0,0,0,0,0,0,0,0,24000,0,0,0,24000,0,24000,24000
057926,帆宣凱基98購02  ,0,0,0,0,0,0,0,0,0,24000,0,0,0,24000,0,24000,24000
058032,大立光永豐98購05,0,0,0,0,0,0,0,0,0,24000,0,0,0,24000,0,24000,24000
05722P,玉晶光國票97售03,0,0,0,0,0,0,0,0,0,24000,0,0,0,131000,107000,24000,24000
057163,上銀元大98購04  ,0,0,0,0,0,0,0,0,0,24000,0,0,0,118000,94000,24000,24000
058901,美律元大99購07  ,0,0,0,0,0,0,0,0,0,24000,0,0,0,110000,86000,24000,24000
059047,元油2X凱基9A購10,0,0,0,0,0,0,0,0,0,24000,0,0,0,112000,88000,24000,24000
060775,世芯凱基9A購02  ,0,0,0,0,0,0,0,0,0,24000,0,0,0,24000,0,24000,24000
4755,三福化          ,0,0,0,0,0,0,24000,0,24000,0,0,0,0,0,0,0,24000
07181P,臺股指凱基99售23,0,0,0,0,0,0,0,0,0,24000,0,0,0,30000,6000,24000,24000
07968P,國巨元大9B售09  ,0,0,0,0,0,0,0,0,0,24000,0,0,0,26000,2000,24000,24000
07871P,台積電群益9C售02,0,0,0,0,0,0,0,0,0,24000,0,0,0,52000,28000,24000,24000
08068P,宏達電國泰9C售01,0,0,0,0,0,0,0,0,0,24000,0,0,0,24000,0,24000,24000
1472,三洋紡          ,27000,3000,24000,0,0,0,0,0,0,0,0,0,0,0,0,0,24000
2419,仲琦            ,37000,13000,24000,0,0,0,0,0,0,0,0,0,0,0,0,0,24000
063166,超眾永豐9B購01  ,0,0,0,0,0,0,0,0,0,23000,0,0,0,33000,10000,23000,23000
06902P,聯電凱基98售02  ,0,0,0,0,0,0,0,0,0,23000,0,0,0,41000,18000,23000,23000
06688P,鴻海中信02售01  ,0,0,0,0,0,0,0,0,0,23000,0,0,0,24000,1000,23000,23000
062416,和大統一01購02  ,0,0,0,0,0,0,0,0,0,23000,0,0,0,25000,2000,23000,23000
062310,南亞科凱基9B購02,0,0,0,0,0,0,0,0,0,23000,0,0,0,23000,0,23000,23000
062284,華擎群益9C購03  ,0,0,0,0,0,0,0,0,0,23000,0,0,0,23000,0,23000,23000
062126,創意統一9B購01  ,0,0,0,0,0,0,0,0,0,23000,0,0,0,1089000,1066000,23000,23000
061967,旺宏統一01購04  ,0,0,0,0,0,0,0,0,0,23000,0,0,0,80000,57000,23000,23000
00714,群益道瓊美國地產,3000,0,3000,0,0,0,0,0,0,20000,0,0,0,20000,0,20000,23000
050402,緯穎中信96購01  ,0,0,0,0,0,0,0,0,0,23000,0,0,0,23000,0,23000,23000
054556,世芯凱基99購01  ,0,0,0,0,0,0,0,0,0,23000,0,0,0,23000,0,23000,23000
057028,台郡凱基99購02  ,0,0,0,0,0,0,0,0,0,23000,0,0,0,30000,7000,23000,23000
055029,帆宣國泰99購01  ,0,0,0,0,0,0,0,0,0,23000,0,0,0,28000,5000,23000,23000
059968,世紀鋼凱基99購03,0,0,0,0,0,0,0,0,0,23000,0,0,0,33000,10000,23000,23000
059007,南電元大99購05  ,0,0,0,0,0,0,0,0,0,23000,0,0,0,38000,15000,23000,23000
061236,台積電元大9A購24,0,0,0,0,0,0,0,0,0,23000,0,0,0,23000,0,23000,23000
061256,亞德客凱基9B購01,0,0,0,0,0,0,0,0,0,23000,0,0,0,29000,6000,23000,23000
061295,台積電國泰9B購02,3000,0,3000,0,0,0,0,0,0,20000,0,0,0,35000,15000,20000,23000
057401,晶豪科群益99購01,0,0,0,0,0,0,0,0,0,23000,0,0,0,41000,18000,23000,23000
057451,大立光元富9B購01,0,0,0,0,0,0,0,0,0,23000,0,0,0,30000,7000,23000,23000
060315,易華電永豐9A購01,0,0,0,0,0,0,0,0,0,23000,0,0,0,26000,3000,23000,23000
3013,晟銘電          ,23000,0,23000,0,0,0,0,0,0,0,0,0,0,0,0,0,23000
07967P,力山元大9B售03  ,0,0,0,0,0,0,0,0,0,23000,0,0,0,48000,25000,23000,23000
3686,達能            ,32000,9000,23000,0,0,0,0,0,0,0,0,0,0,0,0,0,23000
3416,融程電          ,22000,2000,20000,0,0,0,0,0,0,3000,0,0,0,3000,0,3000,23000
6558,興能高          ,65000,44000,21000,0,0,0,0,0,0,2000,2000,0,2000,0,0,0,23000
060877,華邦電中信02購01,0,0,0,0,0,0,0,0,0,23000,0,0,0,25000,2000,23000,23000
061970,大立光統一9C購03,0,0,0,0,0,0,0,0,0,22000,0,0,0,22000,0,22000,22000
061570,瑞昱元大9A購05  ,0,0,0,0,0,0,0,0,0,22000,0,0,0,102000,80000,22000,22000
062320,南電凱基9B購03  ,0,0,0,0,0,0,0,0,0,22000,0,0,0,22000,0,22000,22000
062566,嘉晶中信9C購01  ,0,0,0,0,0,0,0,0,0,22000,0,0,0,47000,25000,22000,22000
06844P,智邦元大98售13  ,0,0,0,0,0,0,0,0,0,22000,0,0,0,122000,100000,22000,22000
07016P,聯發科元大99售10,0,0,0,0,0,0,0,0,0,22000,0,0,0,33000,11000,22000,22000
062828,聯詠群益9B購02  ,0,0,0,0,0,0,0,0,0,22000,0,0,0,52000,30000,22000,22000
056444,南亞科凱基99購01,0,0,0,0,0,0,0,0,0,22000,0,0,0,22000,0,22000,22000
057071,華擎永豐98購02  ,0,0,0,0,0,0,0,0,0,22000,0,0,0,22000,0,22000,22000
057103,禾伸堂中信9A購01,0,0,0,0,0,0,0,0,0,22000,0,0,0,70000,48000,22000,22000
053867,創意元大96購04  ,0,0,0,0,0,0,0,0,0,22000,0,0,0,90000,68000,22000,22000
05596P,可成統一96售01  ,0,0,0,0,0,0,0,0,0,22000,0,0,0,22000,0,22000,22000
054330,世芯永豐96購02  ,0,0,0,0,0,0,0,0,0,22000,0,0,0,79000,57000,22000,22000
00681R,元大美債20反1   ,3000,0,3000,0,0,0,0,0,0,19000,0,0,0,19000,0,19000,22000
060308,劍麟永豐9A購01  ,0,0,0,0,0,0,0,0,0,22000,0,0,0,25000,3000,22000,22000
057369,奇力新元大99購05,0,0,0,0,0,0,0,0,0,22000,0,0,0,22000,0,22000,22000
057624,新日興國泰99購01,0,0,0,0,0,0,0,0,0,22000,0,0,0,322000,300000,22000,22000
05889P,群創元大98售02  ,0,0,0,0,0,0,0,0,0,22000,0,0,0,22000,0,22000,22000
058013,SP黃豆凱基9A購01,0,0,0,0,0,0,0,0,0,22000,0,0,0,22000,0,22000,22000
057216,聯發科群益99購01,0,0,0,0,0,0,0,0,0,22000,0,0,0,30000,8000,22000,22000
058399,美律元大99購05  ,0,0,0,0,0,0,0,0,0,22000,0,0,0,22000,0,22000,22000
4934,太極            ,110000,88000,22000,0,0,0,0,0,0,0,0,0,0,0,0,0,22000
07895P,美律元大9B售01  ,0,0,0,0,0,0,0,0,0,22000,0,0,0,22000,0,22000,22000
07709P,創意元大9A售01  ,0,0,0,0,0,0,0,0,0,22000,0,0,0,22000,0,22000,22000
2420,新巨            ,32000,10000,22000,0,0,0,0,0,0,0,0,0,0,0,0,0,22000
062914,嘉澤元大9B購02  ,0,0,0,0,0,0,0,0,0,21000,0,0,0,58000,37000,21000,21000
063042,同欣電凱基9C購01,0,0,0,0,0,0,0,0,0,21000,0,0,0,26000,5000,21000,21000
06771P,台灣50中信02售01,0,0,0,0,0,0,0,0,0,21000,0,0,0,21000,0,21000,21000
06633P,國巨國票99售01  ,0,0,0,0,0,0,0,0,0,21000,0,0,0,23000,2000,21000,21000
062627,旺宏國票9C購01  ,0,0,0,0,0,0,0,0,0,21000,0,0,0,21000,0,21000,21000
062598,華通台新9B購02  ,0,0,0,0,0,0,0,0,0,21000,0,0,0,31000,10000,21000,21000
062398,建準永豐9B購01  ,0,0,0,0,0,0,0,0,0,21000,0,0,0,69000,48000,21000,21000
061918,上銀凱基9B購02  ,0,0,0,0,0,0,0,0,0,21000,0,0,0,26000,5000,21000,21000
055938,矽力群益97購01  ,0,0,0,0,0,0,0,0,0,21000,0,0,0,27000,6000,21000,21000
055850,聯詠元大97購06  ,0,0,0,0,0,0,0,0,0,21000,0,0,0,89000,68000,21000,21000
053501,明泰兆豐96購01  ,0,0,0,0,0,0,0,0,0,21000,0,0,0,51000,30000,21000,21000
055458,燿華永豐98購01  ,0,0,0,0,0,0,0,0,0,21000,0,0,0,21000,0,21000,21000
056418,台光電元富98購01,0,0,0,0,0,0,0,0,0,21000,0,0,0,105000,84000,21000,21000
056414,國巨中信98購02  ,0,0,0,0,0,0,0,0,0,21000,0,0,0,21000,0,21000,21000
056777,矽力元大98購02  ,0,0,0,0,0,0,0,0,0,21000,0,0,0,68000,47000,21000,21000
059142,道瓊指國票9B購02,0,0,0,0,0,0,0,0,0,21000,0,0,0,21000,0,21000,21000
059289,瑞昱元富99購01  ,0,0,0,0,0,0,0,0,0,21000,0,0,0,92000,71000,21000,21000
07795P,美律國票9A售03  ,0,0,0,0,0,0,0,0,0,21000,0,0,0,21000,0,21000,21000
061186,牧德國泰9C購01  ,0,0,0,0,0,0,0,0,0,21000,0,0,0,48000,27000,21000,21000
057477,智邦元大98購09  ,0,0,0,0,0,0,0,0,0,21000,0,0,0,30000,9000,21000,21000
060586,玉晶光元富9A購03,0,0,0,0,0,0,0,0,0,21000,0,0,0,31000,10000,21000,21000
060475,瑞祺元大9A購01  ,0,0,0,0,0,0,0,0,0,21000,0,0,0,202000,181000,21000,21000
058617,南電元大99購01  ,0,0,0,0,0,0,0,0,0,21000,0,0,0,53000,32000,21000,21000
2739,寒舍            ,50000,29000,21000,0,0,0,0,0,0,0,0,0,0,0,0,0,21000
07717P,臺股指群益9A售06,0,0,0,0,0,0,0,0,0,21000,0,0,0,21000,0,21000,21000
07777P,創意元大9A售03  ,0,0,0,0,0,0,0,0,0,21000,0,0,0,21000,0,21000,21000
08083P,健策元大9C售05  ,0,0,0,0,0,0,0,0,0,21000,0,0,0,34000,13000,21000,21000
060926,宏達電永豐9A購01,0,0,0,0,0,0,0,0,0,21000,0,0,0,50000,29000,21000,21000
060791,聯茂富邦9A購02  ,0,0,0,0,0,0,0,0,0,21000,0,0,0,21000,0,21000,21000
060845,欣興國票9A購01  ,0,0,0,0,0,0,0,0,0,21000,0,0,0,31000,10000,21000,21000
061558,旺宏國票9B購02  ,0,0,0,0,0,0,0,0,0,20000,0,0,0,20000,0,20000,20000
061437,燿華凱基9A購01  ,0,0,0,0,0,0,0,0,0,20000,0,0,0,35000,15000,20000,20000
062271,華通群益9C購02  ,0,0,0,0,0,0,0,0,0,20000,0,0,0,20000,0,20000,20000
062238,臻鼎凱基9C購01  ,0,0,0,0,0,0,0,0,0,20000,0,0,0,40000,20000,20000,20000
062242,臺指反元大02購03,0,0,0,0,0,0,0,0,0,20000,0,0,0,20000,0,20000,20000
06269P,群創凱基98售10  ,0,0,0,0,0,0,0,0,0,20000,0,0,0,20000,0,20000,20000
062469,旺宏凱基9B購05  ,0,0,0,0,0,0,0,0,0,20000,0,0,0,20000,0,20000,20000
06613P,華新科富邦9A售03,0,0,0,0,0,0,0,0,0,20000,0,0,0,20000,0,20000,20000
06627P,華新科元富99售01,0,0,0,0,0,0,0,0,0,20000,0,0,0,20000,0,20000,20000
06387P,緯穎永豐97售02  ,0,0,0,0,0,0,0,0,0,20000,0,0,0,20000,0,20000,20000
06395P,台積電元大97售29,0,0,0,0,0,0,0,0,0,20000,0,0,0,20000,0,20000,20000
06739P,聯詠兆豐98售02  ,0,0,0,0,0,0,0,0,0,20000,0,0,0,20000,0,20000,20000
06866P,聯發科元大98售13,0,0,0,0,0,0,0,0,0,20000,0,0,0,20000,0,20000,20000
06929P,鴻海元大99售11  ,0,0,0,0,0,0,0,0,0,20000,0,0,0,50000,30000,20000,20000
06887P,華新科元大98售04,0,0,0,0,0,0,0,0,0,20000,0,0,0,20000,0,20000,20000
06900P,FBVIX國票12售01 ,0,0,0,0,0,0,0,0,0,20000,0,0,0,20000,0,20000,20000
07140P,台灣50日盛99售01,0,0,0,0,0,0,0,0,0,20000,0,0,0,70000,50000,20000,20000
062795,國巨統一9B購15  ,0,0,0,0,0,0,0,0,0,20000,0,0,0,20000,0,20000,20000
063390,嘉晶兆豐9B購01  ,0,0,0,0,0,0,0,0,0,20000,0,0,0,85000,65000,20000,20000
063417,金像電凱基9B購03,0,0,0,0,0,0,0,0,0,20000,0,0,0,86000,66000,20000,20000
063344,臺企銀統一9C購01,0,0,0,0,0,0,0,0,0,20000,0,0,0,20000,0,20000,20000
056324,南亞科兆豐98購01,0,0,0,0,0,0,0,0,0,20000,0,0,0,30000,10000,20000,20000
056767,大毅元大99購01  ,0,0,0,0,0,0,0,0,0,20000,0,0,0,20000,0,20000,20000
056376,玉晶光統一98購01,0,0,0,0,0,0,0,0,0,20000,0,0,0,20000,0,20000,20000
060103,聯詠元大99購01  ,0,0,0,0,0,0,0,0,0,20000,0,0,0,108000,88000,20000,20000
059782,A50正2元大9C購04,0,0,0,0,0,0,0,0,0,20000,0,0,0,30000,10000,20000,20000
055533,大立光群益97購03,0,0,0,0,0,0,0,0,0,20000,0,0,0,20000,0,20000,20000
055158,亞光元大99購01  ,0,0,0,0,0,0,0,0,0,20000,0,0,0,20000,0,20000,20000
054991,南亞科元富97購01,0,0,0,0,0,0,0,0,0,20000,0,0,0,20000,0,20000,20000
056158,新日興凱基98購02,0,0,0,0,0,0,0,0,0,20000,0,0,0,20000,0,20000,20000
05478P,智伸科國票96售02,0,0,0,0,0,0,0,0,0,20000,0,0,0,20000,0,20000,20000
054827,宏全元大9A購01  ,0,0,0,0,0,0,0,0,0,20000,0,0,0,20000,0,20000,20000
057022,智邦凱基98購04  ,0,0,0,0,0,0,0,0,0,20000,0,0,0,20000,0,20000,20000
056041,禾伸堂凱基98購03,0,0,0,0,0,0,0,0,0,20000,0,0,0,20000,0,20000,20000
053474,聯發科元大97購06,0,0,0,0,0,0,0,0,0,20000,0,0,0,20000,0,20000,20000
053407,台積電兆豐96購02,0,0,0,0,0,0,0,0,0,20000,0,0,0,785000,765000,20000,20000
053392,致新元大96購01  ,0,0,0,0,0,0,0,0,0,20000,0,0,0,20000,0,20000,20000
053586,建準元大96購01  ,0,0,0,0,0,0,0,0,0,20000,0,0,0,20000,0,20000,20000
054576,健策元大98購03  ,0,0,0,0,0,0,0,0,0,20000,0,0,0,20000,0,20000,20000
053006,玉晶光永豐96購03,0,0,0,0,0,0,0,0,0,20000,0,0,0,20000,0,20000,20000
052886,世紀鋼兆豐96購01,0,0,0,0,0,0,0,0,0,20000,0,0,0,20000,0,20000,20000
055872,亞泥元富97購01  ,0,0,0,0,0,0,0,0,0,20000,0,0,0,20000,0,20000,20000
055971,矽力元大97購05  ,0,0,0,0,0,0,0,0,0,20000,0,0,0,20000,0,20000,20000
056893,智邦元大98購02  ,0,0,0,0,0,0,0,0,0,20000,0,0,0,23000,3000,20000,20000
056847,佐登元富98購01  ,0,0,0,0,0,0,0,0,0,20000,0,0,0,40000,20000,20000,20000
056794,上銀麥證98購01  ,0,0,0,30000,10000,20000,0,0,0,20000,0,0,0,30000,10000,20000,20000
05582P,群創凱基98售06  ,0,0,0,0,0,0,0,0,0,20000,0,0,0,20000,0,20000,20000
055776,宏達電凱基98購02,0,0,0,0,0,0,0,0,0,20000,0,0,0,76000,56000,20000,20000
055748,GIS元富97購01   ,0,0,0,0,0,0,0,0,0,20000,0,0,0,30000,10000,20000,20000
051903,T50反1元大97購02,0,0,0,0,0,0,0,0,0,20000,0,0,0,20000,0,20000,20000
051912,健鼎元大96購01  ,0,0,0,0,0,0,0,0,0,20000,0,0,0,20000,0,20000,20000
051736,旺宏國票96購01  ,0,0,0,0,0,0,0,0,0,20000,0,0,0,20000,0,20000,20000
052522,聯發科元大96購05,0,0,0,0,0,0,0,0,0,20000,0,0,0,20000,0,20000,20000
050714,深中小群益98購01,0,0,0,0,0,0,0,0,0,20000,0,0,0,20000,0,20000,20000
054154,智易國泰97購01  ,0,0,0,0,0,0,0,0,0,20000,0,0,0,20000,0,20000,20000
03447B,臺股指凱基9B熊16,0,0,0,0,0,0,0,0,0,20000,0,0,0,20000,0,20000,20000
054161,友訊凱基98購01  ,0,0,0,0,0,0,0,0,0,20000,0,0,0,20000,0,20000,20000
058646,聯茂富邦9A購01  ,0,0,0,0,0,0,0,0,0,20000,0,0,0,72000,52000,20000,20000
058590,南電中信9A購02  ,0,0,0,0,0,0,0,0,0,20000,0,0,0,20000,0,20000,20000
060387,盛群凱基9A購01  ,0,0,0,0,0,0,0,0,0,20000,0,0,0,100000,80000,20000,20000
060458,華通元大9A購02  ,0,0,0,0,0,0,0,0,0,20000,0,0,0,20000,0,20000,20000
060496,滬深2X元大9A購05,0,0,0,0,0,0,0,0,0,20000,0,0,0,20000,0,20000,20000
060596,元黃金凱基9A購02,0,0,0,0,0,0,0,0,0,20000,0,0,0,20000,0,20000,20000
057462,光磊永豐98購02  ,0,0,0,0,0,0,0,0,0,20000,0,0,0,54000,34000,20000,20000
057354,聯鈞統一99購03  ,0,0,0,0,0,0,0,0,0,20000,0,0,0,35000,15000,20000,20000
057396,健鼎中信99購01  ,0,0,0,0,0,0,0,0,0,20000,0,0,0,20000,0,20000,20000
057306,玉晶光兆豐99購01,0,0,0,0,0,0,0,0,0,20000,0,0,0,20000,0,20000,20000
057928,鈺齊凱基98購02  ,0,0,0,0,0,0,0,0,0,20000,0,0,0,30000,10000,20000,20000
058703,台積電元大99購16,0,0,0,0,0,0,0,0,0,20000,0,0,0,30000,10000,20000,20000
061264,全新凱基9B購01  ,0,0,0,0,0,0,0,0,0,20000,0,0,0,20000,0,20000,20000
058048,群創元大9B購07  ,0,0,0,0,0,0,0,0,0,20000,0,0,0,20000,0,20000,20000
058931,玉晶光統一9C購01,0,0,0,0,0,0,0,0,0,20000,0,0,0,20000,0,20000,20000
059351,台虹凱基99購01  ,0,0,0,0,0,0,0,0,0,20000,0,0,0,457000,437000,20000,20000
059166,友達凱基99購05  ,0,0,0,0,0,0,0,0,0,20000,0,0,0,20000,0,20000,20000
059170,康控凱基9B購01  ,0,0,0,0,0,0,0,0,0,20000,0,0,0,25000,5000,20000,20000
060275,元黃金元大9A購01,0,0,0,0,0,0,0,0,0,20000,0,0,0,30000,10000,20000,20000
060277,道瓊反元大9A購02,0,0,0,0,0,0,0,0,0,20000,0,0,0,65000,45000,20000,20000
058774,台郡兆豐9A購01  ,0,0,0,0,0,0,0,0,0,20000,0,0,0,21000,1000,20000,20000
058347,玉晶光群益9B購01,0,0,0,0,0,0,0,0,0,20000,0,0,0,65000,45000,20000,20000
058121,國巨國票9A購01  ,0,0,0,0,0,0,0,0,0,20000,0,0,0,20000,0,20000,20000
061001,智邦兆豐9B購01  ,0,0,0,0,0,0,0,0,0,20000,0,0,0,21000,1000,20000,20000
9935,慶豐富          ,888000,868000,20000,0,0,0,0,0,0,0,0,0,0,0,0,0,20000
08017P,華新科國票9B售01,0,0,0,0,0,0,0,0,0,20000,0,0,0,20000,0,20000,20000
07988P,台積電台新9C售03,0,0,0,0,0,0,0,0,0,20000,0,0,0,30000,10000,20000,20000
07720P,臺股指群益9A售09,0,0,0,0,0,0,0,0,0,20000,0,0,0,20000,0,20000,20000
07724P,臺股指凱基9A售16,0,0,0,0,0,0,0,0,0,20000,0,0,0,20000,0,20000,20000
07732P,台灣50台新9A售05,0,0,0,0,0,0,0,0,0,20000,0,0,0,20000,0,20000,20000
07890P,南電國票9B售01  ,0,0,0,0,0,0,0,0,0,20000,0,0,0,20000,0,20000,20000
07974P,上証2X元大9B售02,0,0,0,0,0,0,0,0,0,20000,0,0,0,20000,0,20000,20000
07244P,鴻海凱基9A售13  ,0,0,0,0,0,0,0,0,0,20000,0,0,0,20000,0,20000,20000
07355P,臺股指國票99售23,0,0,0,0,0,0,0,0,0,20000,0,0,0,20000,0,20000,20000
07463P,台積電國票9A售05,0,0,0,0,0,0,0,0,0,20000,0,0,0,20000,0,20000,20000
07460P,臺股指元大9B售03,0,0,0,0,0,0,0,0,0,20000,0,0,0,20000,0,20000,20000
07683P,宏達電凱基9A售03,0,0,0,0,0,0,0,0,0,20000,0,0,0,20000,0,20000,20000
2465,麗臺            ,40000,20000,20000,0,0,0,0,0,0,0,0,0,0,0,0,0,20000
08184P,可成永豐9B售03  ,0,0,0,0,0,0,0,0,0,20000,0,0,0,20000,0,20000,20000
3702,大聯大          ,7352889,7352720,169,0,0,0,3000,0,3000,16000,10000,60000,-50000,66000,0,66000,19169
062902,智邦元大9B購07  ,0,0,0,0,0,0,0,0,0,19000,0,0,0,54000,35000,19000,19000
06789P,鴻海凱基98售12  ,0,0,0,0,0,0,0,0,0,19000,0,0,0,19000,0,19000,19000
06767P,台積電永昌99售03,0,0,0,0,0,0,0,0,0,19000,0,0,0,19000,0,19000,19000
06271P,彩晶凱基97售01  ,0,0,0,0,0,0,0,0,0,19000,0,0,0,20000,1000,19000,19000
062248,國巨元大9B購08  ,0,0,0,0,0,0,0,0,0,19000,0,0,0,29000,10000,19000,19000
06209P,旺宏統一97售07  ,0,0,0,0,0,0,0,0,0,19000,0,0,0,29000,10000,19000,19000
061763,聯電元大9C購02  ,0,0,0,0,0,0,0,0,0,19000,0,0,0,87000,68000,19000,19000
061752,瑞昱台新9B購01  ,0,0,0,0,0,0,0,0,0,19000,0,0,0,116000,97000,19000,19000
054311,世芯凱基96購02  ,0,0,0,0,0,0,0,0,0,19000,0,0,0,29000,10000,19000,19000
054274,智易中信96購02  ,0,0,0,0,0,0,0,0,0,19000,0,0,0,19000,0,19000,19000
053033,智易兆豐97購01  ,0,0,0,0,0,0,0,0,0,19000,0,0,0,326000,307000,19000,19000
052847,漢唐統一99購01  ,0,0,0,0,0,0,0,0,0,19000,0,0,0,19000,0,19000,19000
059771,台積電群益99購11,0,0,0,0,0,0,0,0,0,19000,0,0,0,78000,59000,19000,19000
060092,瑞昱元大99購03  ,0,0,0,0,0,0,0,0,0,19000,0,0,0,223000,204000,19000,19000
056308,TPK元大97購02   ,0,0,0,0,0,0,0,0,0,19000,0,0,0,23000,4000,19000,19000
059363,超眾永豐99購02  ,0,0,0,0,0,0,0,0,0,19000,0,0,0,56000,37000,19000,19000
058077,超眾凱基98購02  ,0,0,0,0,0,0,0,0,0,19000,0,0,0,71000,52000,19000,19000
058895,鴻海元大99購20  ,0,0,0,0,0,0,0,0,0,19000,0,0,0,43000,24000,19000,19000
061274,臺股指凱基9A購24,0,0,0,0,0,0,0,0,0,19000,0,0,0,70000,51000,19000,19000
061103,聯發科元大9A購08,0,0,0,0,0,0,0,0,0,19000,0,0,0,19000,0,19000,19000
058693,旭富國票9A購01  ,0,0,0,0,0,0,0,0,0,19000,0,0,0,53000,34000,19000,19000
057467,祥碩永豐98購04  ,0,0,0,0,0,0,0,0,0,19000,0,0,0,29000,10000,19000,19000
057558,致新凱基98購01  ,0,0,0,0,0,0,0,0,0,19000,0,0,0,19000,0,19000,19000
060536,祥碩麥證9A購01  ,0,0,0,19000,0,19000,0,0,0,19000,0,0,0,19000,0,19000,19000
060469,台勝科元大9A購02,0,0,0,0,0,0,0,0,0,19000,0,0,0,37000,18000,19000,19000
060909,金像電元大9B購01,0,0,0,0,0,0,0,0,0,19000,0,0,0,19000,0,19000,19000
1733,五鼎            ,40000,20000,20000,0,0,0,0,0,0,-1000,1000,2000,-1000,0,0,0,19000
07389P,臺股指群益9C售08,0,0,0,0,0,0,0,0,0,19000,0,0,0,23000,4000,19000,19000
061446,鴻海中信04購01  ,0,0,0,0,0,0,0,0,0,18000,0,0,0,32000,14000,18000,18000
061403,滬深2X國票9A購06,0,0,0,0,0,0,0,0,0,18000,0,0,0,22000,4000,18000,18000
061412,儒鴻群益9A購01  ,0,0,0,0,0,0,0,0,0,18000,0,0,0,20000,2000,18000,18000
062208,旭富國票9C購01  ,0,0,0,0,0,0,0,0,0,18000,0,0,0,30000,12000,18000,18000
062733,巨大凱基9B購01  ,0,0,0,0,0,0,0,0,0,18000,0,0,0,55000,37000,18000,18000
062477,聯詠國票9B購01  ,0,0,0,0,0,0,0,0,0,18000,0,0,0,37000,19000,18000,18000
06865P,亞德客元大98售04,0,0,0,0,0,0,0,0,0,18000,0,0,0,137000,119000,18000,18000
06883P,聯茂群益98售03  ,0,0,0,0,0,0,0,0,0,18000,0,0,0,28000,10000,18000,18000
06971P,台光電元大99售03,0,0,0,0,0,0,0,0,0,18000,0,0,0,20000,2000,18000,18000
063086,祥碩凱基9C購01  ,0,0,0,0,0,0,0,0,0,18000,0,0,0,19000,1000,18000,18000
063328,京元電國票9C購02,0,0,0,0,0,0,0,0,0,18000,0,0,0,18000,0,18000,18000
056549,嘉聯益凱基98購04,0,0,0,0,0,0,0,0,0,18000,0,0,0,20000,2000,18000,18000
056534,京元電凱基98購01,0,0,0,0,0,0,0,0,0,18000,0,0,0,43000,25000,18000,18000
060227,和大元大9A購01  ,0,0,0,0,0,0,0,0,0,18000,0,0,0,26000,8000,18000,18000
059872,華新科凱基01購01,0,0,0,0,0,0,0,0,0,18000,0,0,0,35000,17000,18000,18000
054874,帆宣群益99購02  ,0,0,0,0,0,0,0,0,0,18000,0,0,0,30000,12000,18000,18000
056135,緯創元大98購01  ,0,0,0,0,0,0,0,0,0,18000,0,0,0,28000,10000,18000,18000
056193,聯發科富邦99購08,0,0,0,0,0,0,0,0,0,18000,0,0,0,18000,0,18000,18000
052888,台表科中信9A購01,0,0,0,0,0,0,0,0,0,18000,0,0,0,18000,0,18000,18000
053050,華通國票97購02  ,0,0,0,0,0,0,0,0,0,18000,0,0,0,38000,20000,18000,18000
056855,祥碩中信98購02  ,0,0,0,0,0,0,0,0,0,18000,0,0,0,107000,89000,18000,18000
054160,華泰凱基98購01  ,0,0,0,0,0,0,0,0,0,18000,0,0,0,50000,32000,18000,18000
054215,創意國票97購02  ,0,0,0,0,0,0,0,0,0,18000,0,0,0,18000,0,18000,18000
00851,台新全球AI      ,0,0,0,0,0,0,0,0,0,18000,0,0,0,44000,26000,18000,18000
060532,欣興中信9A購01  ,0,0,0,0,0,0,0,0,0,18000,0,0,0,50000,32000,18000,18000
057537,聯茂元大98購04  ,0,0,0,0,0,0,0,0,0,18000,0,0,0,69000,51000,18000,18000
057498,台郡元大98購04  ,0,0,0,0,0,0,0,0,0,18000,0,0,0,68000,50000,18000,18000
057363,華通元大99購02  ,0,0,0,0,0,0,0,0,0,18000,0,0,0,30000,12000,18000,18000
057862,智邦凱基99購01  ,0,0,0,0,0,0,0,0,0,18000,0,0,0,28000,10000,18000,18000
058091,欣興元大99購03  ,0,0,0,0,0,0,0,0,0,18000,0,0,0,53000,35000,18000,18000
059403,T50反1台新03購03,0,0,0,0,0,0,0,0,0,18000,0,0,0,24000,6000,18000,18000
07369P,台積電凱基99售20,0,0,0,0,0,0,0,0,0,18000,0,0,0,20000,2000,18000,18000
07195P,大立光元大99售12,0,0,0,0,0,0,0,0,0,18000,0,0,0,18000,0,18000,18000
07203P,T50正2凱基9C售02,0,0,0,0,0,0,0,0,0,18000,0,0,0,18000,0,18000,18000
08086P,燿華凱基9B售03  ,0,0,0,0,0,0,0,0,0,18000,0,0,0,18000,0,18000,18000
1338,廣華-KY         ,77000,59000,18000,0,0,0,0,0,0,0,0,0,0,0,0,0,18000
060712,建準永豐9A購01  ,0,3000,-3000,0,0,0,0,0,0,21000,0,0,0,28000,7000,21000,18000
060641,聯鈞永豐9A購01  ,0,0,0,0,0,0,0,0,0,18000,0,0,0,18000,0,18000,18000
063393,華通群益9C購05  ,0,0,0,0,0,0,0,0,0,17000,0,0,0,32000,15000,17000,17000
062945,世芯國泰01購01  ,0,0,0,0,0,0,0,0,0,17000,0,0,0,22000,5000,17000,17000
062836,同欣電群益9B購02,0,0,0,0,0,0,0,0,0,17000,0,0,0,22000,5000,17000,17000
07043P,國巨元大99售14  ,0,0,0,0,0,0,0,0,0,17000,0,0,0,17000,0,17000,17000
07100P,華航元大99售01  ,0,0,0,0,0,0,0,0,0,17000,0,0,0,17000,0,17000,17000
06757P,台灣50元大9B售01,0,0,0,0,0,0,0,0,0,17000,0,0,0,17000,0,17000,17000
06475P,牧德永豐98售03  ,0,0,0,0,0,0,0,0,0,17000,0,0,0,17000,0,17000,17000
062593,健策統一9B購03  ,0,0,0,0,0,0,0,0,0,17000,0,0,0,81000,64000,17000,17000
061436,上銀凱基9A購07  ,0,0,0,0,0,0,0,0,0,17000,0,0,0,20000,3000,17000,17000
061489,高鐵兆豐9A購01  ,0,0,0,0,0,0,0,0,0,17000,0,0,0,39000,22000,17000,17000
061571,奇力新元大9A購03,0,0,0,0,0,0,0,0,0,17000,0,0,0,51000,34000,17000,17000
061937,聯發科國票9B購02,0,0,0,0,0,0,0,0,0,17000,0,0,0,17000,0,17000,17000
062021,康控永豐9B購01  ,0,0,0,0,0,0,0,0,0,17000,0,0,0,85000,68000,17000,17000
01002T,土銀國泰R1      ,17000,0,17000,0,0,0,0,0,0,0,0,0,0,0,0,0,17000
049820,世紀鋼元大96購03,0,0,0,0,0,0,0,0,0,17000,0,0,0,20000,3000,17000,17000
053043,嘉晶凱基96購01  ,0,0,0,0,0,0,0,0,0,17000,0,0,0,17000,0,17000,17000
056162,祥碩凱基97購03  ,0,0,0,0,0,0,0,0,0,17000,0,0,0,24000,7000,17000,17000
059836,大立光國泰9B購02,0,0,0,0,0,0,0,0,0,17000,0,0,0,18000,1000,17000,17000
060241,國泰金元大9A購01,0,0,0,0,0,0,0,0,0,17000,0,0,0,43000,26000,17000,17000
056302,大立光元大97購17,0,0,0,0,0,0,0,0,0,17000,0,0,0,27000,10000,17000,17000
056614,智邦永豐98購01  ,0,0,0,0,0,0,0,0,0,17000,0,0,0,25000,8000,17000,17000
059155,台表科日盛99購01,0,0,0,0,0,0,0,0,0,17000,0,0,0,79000,62000,17000,17000
05908P,大立光元富96售05,0,0,0,0,0,0,0,0,0,17000,0,0,0,17000,0,17000,17000
058957,貿聯國票9A購01  ,0,0,0,0,0,0,0,0,0,17000,0,0,0,51000,34000,17000,17000
057651,矽力元大98購03  ,0,0,0,0,0,0,0,0,0,17000,0,0,0,45000,28000,17000,17000
058731,貿聯永豐99購02  ,0,0,0,0,0,0,0,0,0,17000,0,0,0,33000,16000,17000,17000
057596,聯茂兆豐99購01  ,0,0,0,0,0,0,0,0,0,17000,0,0,0,17000,0,17000,17000
060530,聯發科中信9C購03,0,0,0,0,0,0,0,0,0,17000,0,0,0,18000,1000,17000,17000
060385,台勝科凱基9A購01,0,0,0,0,0,0,0,0,0,17000,0,0,0,57000,40000,17000,17000
060415,葡萄王永豐9A購01,0,0,0,0,0,0,0,0,0,17000,0,0,0,85000,68000,17000,17000
059534,國泰金凱基99購01,0,0,0,0,0,0,0,0,0,17000,0,0,0,20000,3000,17000,17000
060620,玉晶光元大9A購04,0,0,0,0,0,0,0,0,0,17000,0,0,0,34000,17000,17000,17000
5515,建國            ,29000,12000,17000,0,0,0,0,0,0,0,0,0,0,0,0,0,17000
3605,宏致            ,78000,61000,17000,0,0,0,0,0,0,0,0,0,0,0,0,0,17000
8463,潤泰材          ,31000,14000,17000,0,0,0,0,0,0,0,0,0,0,0,0,0,17000
1506,正道            ,24000,7000,17000,0,0,0,0,0,0,0,0,0,0,0,0,0,17000
1582,信錦            ,116000,99000,17000,0,0,0,0,0,0,0,0,0,0,0,0,0,17000
08132P,南六元大9B售05  ,0,0,0,0,0,0,0,0,0,17000,0,0,0,417000,400000,17000,17000
07781P,高鐵凱基9A售02  ,0,0,0,0,0,0,0,0,0,17000,0,0,0,17000,0,17000,17000
07198P,臺股指元大99售14,0,0,0,0,0,0,0,0,0,17000,0,0,0,17000,0,17000,17000
07500P,微星元大9A售01  ,0,0,0,0,0,0,0,0,0,17000,0,0,0,30000,13000,17000,17000
061463,智邦群益9A購02  ,0,0,0,0,0,0,0,0,0,16000,0,0,0,66000,50000,16000,16000
062179,旺宏元大9B購05  ,0,0,0,0,0,0,0,0,0,16000,0,0,0,16000,0,16000,16000
06603P,立積統一99售01  ,0,0,0,0,0,0,0,0,0,16000,0,0,0,16000,0,16000,16000
07127P,精元元大99售01  ,0,0,0,0,0,0,0,0,0,16000,0,0,0,17000,1000,16000,16000
06339P,上銀統一97售06  ,0,0,0,0,0,0,0,0,0,16000,0,0,0,16000,0,16000,16000
056705,超眾國泰99購01  ,0,0,0,0,0,0,0,0,0,16000,0,0,0,203000,187000,16000,16000
059940,微星永豐99購01  ,0,0,0,0,0,0,0,0,0,16000,0,0,0,16000,0,16000,16000
054935,華通元大98購03  ,0,0,0,0,0,0,0,0,0,16000,0,0,0,84000,68000,16000,16000
05708P,奇力新國票97售04,0,0,0,0,0,0,0,0,0,16000,0,0,0,197000,181000,16000,16000
054738,聯發科凱基97購01,0,0,0,0,0,0,0,0,0,16000,0,0,0,16000,0,16000,16000
055989,矽力元富9A購01  ,0,0,0,0,0,0,0,0,0,16000,0,0,0,67000,51000,16000,16000
053677,同欣電國泰97購01,0,0,0,0,0,0,0,0,0,16000,0,0,0,25000,9000,16000,16000
051078,力山富邦97購01  ,0,0,0,0,0,0,0,0,0,16000,0,0,0,31000,15000,16000,16000
054316,矽創凱基97購01  ,0,0,0,0,0,0,0,0,0,16000,0,0,0,56000,40000,16000,16000
059699,華通凱基99購04  ,0,0,0,0,0,0,0,0,0,16000,0,0,0,16000,0,16000,16000
057802,卜蜂元大98購01  ,0,0,0,0,0,0,0,0,0,16000,0,0,0,19000,3000,16000,16000
058970,鴻海永豐99購02  ,0,0,0,0,0,0,0,0,0,16000,0,0,0,50000,34000,16000,16000
061352,茂林元大9A購04  ,0,0,0,0,0,0,0,0,0,16000,0,0,0,48000,32000,16000,16000
059067,上銀國票9A購02  ,0,0,0,0,0,0,0,0,0,16000,0,0,0,19000,3000,16000,16000
058439,玉晶光統一01購02,0,0,0,0,0,0,0,0,0,16000,0,0,0,106000,90000,16000,16000
058441,T50反1台新03購01,0,0,0,0,0,0,0,0,0,16000,0,0,0,16000,0,16000,16000
07212P,聯發科凱基99售14,0,0,0,0,0,0,0,0,0,16000,0,0,0,16000,0,16000,16000
07287P,全新群益9B售01  ,0,0,0,0,0,0,0,0,0,16000,0,0,0,50000,34000,16000,16000
1449,佳和            ,298000,282000,16000,0,0,0,0,0,0,0,0,0,0,0,0,0,16000
060706,群創富邦9A購01  ,0,0,0,0,0,0,0,0,0,16000,0,0,0,16000,0,16000,16000
060703,T50反1富邦9C購01,0,0,0,0,0,0,0,0,0,16000,0,0,0,16000,0,16000,16000
063359,泰鼎國泰01購01  ,0,0,0,0,0,0,0,0,0,15000,0,0,0,70000,55000,15000,15000
063155,緯穎元富9B購03  ,0,0,0,0,0,0,0,0,0,15000,0,0,0,15000,0,15000,15000
063233,國巨元大9B購19  ,0,0,0,0,0,0,0,0,0,15000,0,0,0,22000,7000,15000,15000
062822,力成兆豐9B購01  ,0,0,0,0,0,0,0,0,0,15000,0,0,0,20000,5000,15000,15000
063053,聯發科統一01購04,0,0,0,0,0,0,0,0,0,15000,0,0,0,20000,5000,15000,15000
07139P,元油2X群益9C售06,0,0,0,0,0,0,0,0,0,15000,0,0,0,15000,0,15000,15000
06889P,臺股指元大98售13,0,0,0,0,0,0,0,0,0,15000,0,0,0,15000,0,15000,15000
06912P,台光電元大99售02,0,0,0,0,0,0,0,0,0,15000,0,0,0,15000,0,15000,15000
06835P,台灣50國票9A售01,0,0,0,0,0,0,0,0,0,15000,0,0,0,15000,0,15000,15000
06595P,祥碩元大98售03  ,0,0,0,0,0,0,0,0,0,15000,0,0,0,15000,0,15000,15000
06399P,台表科凱基97售05,0,0,0,0,0,0,0,0,0,15000,0,0,0,15000,0,15000,15000
062209,台積電台新9B購05,0,0,0,0,0,0,0,0,0,15000,0,0,0,20000,5000,15000,15000
062082,嘉晶元大9B購01  ,0,0,0,0,0,0,0,0,0,15000,0,0,0,30000,15000,15000,15000
062136,南亞科群益9B購01,0,0,0,0,0,0,0,0,0,15000,0,0,0,15000,0,15000,15000
062675,台積電台新9B購06,0,0,0,0,0,0,0,0,0,15000,0,0,0,20000,5000,15000,15000
062520,晶豪科元大9B購02,0,0,0,0,0,0,0,0,0,15000,0,0,0,76000,61000,15000,15000
061688,華通群益9A購07  ,0,0,0,0,0,0,0,0,0,15000,0,0,0,20000,5000,15000,15000
061993,祥碩元大9C購01  ,0,0,0,0,0,0,0,0,0,15000,0,0,0,15000,0,15000,15000
061740,華新科凱基03購01,0,0,0,0,0,0,0,0,0,15000,0,0,0,20000,5000,15000,15000
061800,泰鼎永豐9B購01  ,0,0,0,0,0,0,0,0,0,15000,0,0,0,25000,10000,15000,15000
051087,國巨元大97購01  ,0,0,0,0,0,0,0,0,0,15000,0,0,0,15000,0,15000,15000
050854,世紀鋼國票97購01,0,0,0,0,0,0,0,0,0,15000,0,0,0,95000,80000,15000,15000
048757,美利達元富96購01,0,0,0,0,0,0,0,0,0,15000,0,0,0,15000,0,15000,15000
00663L,國泰臺灣加權正2 ,16000,5000,11000,0,0,0,0,0,0,4000,0,0,0,19000,15000,4000,15000
051902,T50反1元大97購01,0,0,0,0,0,0,0,0,0,15000,0,0,0,15000,0,15000,15000
03662C,FBVIX凱基03牛01 ,0,0,0,0,0,0,0,0,0,15000,0,0,0,97000,82000,15000,15000
053302,國巨凱基96購10  ,0,0,0,0,0,0,0,0,0,15000,0,0,0,15000,0,15000,15000
053291,旺宏中信9A購01  ,100000,10000,90000,0,0,0,0,0,0,-75000,0,0,0,0,75000,-75000,15000
055820,矽力國票98購02  ,0,0,0,0,0,0,0,0,0,15000,0,0,0,172000,157000,15000,15000
056809,旺宏統一98購03  ,0,0,0,0,0,0,0,0,0,15000,0,0,0,15000,0,15000,15000
056160,智易凱基97購03  ,0,0,0,0,0,0,0,0,0,15000,0,0,0,15000,0,15000,15000
055489,瑞昱元大97購02  ,0,0,0,0,0,0,0,0,0,15000,0,0,0,15000,0,15000,15000
055414,奇力新富邦9B購01,0,0,0,0,0,0,0,0,0,15000,0,0,0,15000,0,15000,15000
055351,聯發科凱基97購03,0,0,0,0,0,0,0,0,0,15000,0,0,0,15000,0,15000,15000
055270,上銀元大97購03  ,0,0,0,0,0,0,0,0,0,15000,0,0,0,15000,0,15000,15000
059936,台積電永豐99購06,0,0,0,0,0,0,0,0,0,15000,0,0,0,15000,0,15000,15000
05661P,聯發科統一96售06,0,0,0,0,0,0,0,0,0,15000,0,0,0,15000,0,15000,15000
057149,京鼎國票99購02  ,0,0,0,0,0,0,0,0,0,15000,0,0,0,15000,0,15000,15000
056287,亞光永豐97購02  ,0,0,0,0,0,0,0,0,0,15000,0,0,0,15000,0,15000,15000
058308,全新元大9B購01  ,0,0,0,0,0,0,0,0,0,15000,0,0,0,25000,10000,15000,15000
058396,力山元大99購01  ,0,0,0,0,0,0,0,0,0,15000,0,0,0,65000,50000,15000,15000
058182,日電貿國泰9A購01,0,0,0,0,0,0,0,0,0,15000,0,0,0,35000,20000,15000,15000
059146,貿聯國票9A購02  ,0,0,0,0,0,0,0,0,0,15000,0,0,0,33000,18000,15000,15000
05922P,京元電兆豐96售01,0,0,0,0,0,0,0,0,0,15000,0,0,0,20000,5000,15000,15000
059031,元石油中信03購01,0,0,0,0,0,0,0,0,0,15000,0,0,0,15000,0,15000,15000
058010,帆宣國票98購01  ,0,0,0,0,0,0,0,0,0,15000,0,0,0,15000,0,15000,15000
061311,元黃金凱基9A購03,0,0,0,0,0,0,0,0,0,15000,0,0,0,15000,0,15000,15000
061046,上銀第一9A購01  ,0,0,0,0,0,0,0,0,0,15000,0,0,0,15000,0,15000,15000
057813,京元電元大98購03,0,0,0,0,0,0,0,0,0,15000,0,0,0,37000,22000,15000,15000
060171,宏達電台新9A購01,0,0,0,0,0,0,0,0,0,15000,0,0,0,15000,0,15000,15000
060183,南亞科元富9A購01,0,0,0,0,0,0,0,0,0,15000,0,0,0,92000,77000,15000,15000
060352,滬深2X元富9A購02,0,0,0,0,0,0,0,0,0,15000,0,0,0,15000,0,15000,15000
060370,滬深2X元富04購01,0,0,0,0,0,0,0,0,0,15000,0,0,0,15000,0,15000,15000
060131,GIS永豐99購03   ,0,0,0,0,0,0,0,0,0,15000,0,0,0,15000,0,15000,15000
059489,上証2X國票9A購01,0,0,0,0,0,0,0,0,0,15000,0,0,0,15000,0,15000,15000
057413,臺股指群益9C購04,0,0,0,0,0,0,0,0,0,15000,0,0,0,15000,0,15000,15000
058256,臺股指元大9A購20,0,0,0,0,0,0,0,0,0,15000,0,0,0,15000,0,15000,15000
057658,玉晶光兆豐99購02,0,0,0,0,0,0,0,0,0,15000,0,0,0,15000,0,15000,15000
057848,台表科永豐98購02,0,0,0,0,0,0,0,0,0,15000,0,0,0,15000,0,15000,15000
057903,聯鈞永豐99購01  ,0,0,0,0,0,0,0,0,0,15000,0,0,0,15000,0,15000,15000
060718,中磊永豐9A購01  ,0,0,0,0,0,0,0,0,0,15000,0,0,0,80000,65000,15000,15000
060774,南亞科凱基9A購01,0,0,0,0,0,0,0,0,0,15000,0,0,0,20000,5000,15000,15000
060896,晶技凱基9A購02  ,0,0,0,0,0,0,0,0,0,15000,0,0,0,175000,160000,15000,15000
8367,建新國際        ,16000,1000,15000,0,0,0,0,0,0,0,0,0,0,0,0,0,15000
6591,動力-KY         ,30000,15000,15000,0,0,0,0,0,0,0,2000,2000,0,0,0,0,15000
1323,永裕            ,16000,1000,15000,0,0,0,0,0,0,0,0,0,0,0,0,0,15000
1232,大統益          ,20000,5000,15000,0,0,0,0,0,0,0,0,0,0,0,0,0,15000
2887E,台新戊特        ,0,0,0,0,0,0,0,0,0,15000,15000,0,15000,0,0,0,15000
3060,銘異            ,33000,18000,15000,0,0,0,0,0,0,0,0,0,0,0,0,0,15000
07306P,台灣50凱基9A售09,0,0,0,0,0,0,0,0,0,15000,0,0,0,15000,0,15000,15000
07390P,華新科康和99售02,0,0,0,0,0,0,0,0,0,15000,0,0,0,25000,10000,15000,15000
07413P,國巨元大99售33  ,0,0,0,0,0,0,0,0,0,15000,0,0,0,25000,10000,15000,15000
07204P,鴻海凱基99售10  ,0,0,0,0,0,0,0,0,0,15000,0,0,0,15000,0,15000,15000
07664P,台灣50元大9C售30,0,0,0,0,0,0,0,0,0,15000,0,0,0,15000,0,15000,15000
07706P,長榮航元大9A售03,0,0,0,0,0,0,0,0,0,15000,0,0,0,15000,0,15000,15000
07698P,臺股指元大9A售51,0,0,0,0,0,0,0,0,0,15000,0,0,0,15000,0,15000,15000
08130P,義隆元大9B售05  ,0,0,0,0,0,0,0,0,0,15000,0,0,0,15000,0,15000,15000
08150P,立積國票9C售01  ,0,0,0,0,0,0,0,0,0,15000,0,0,0,25000,10000,15000,15000
08001P,台灣50元大9B售17,0,0,0,0,0,0,0,0,0,15000,0,0,0,15000,0,15000,15000
08060P,嘉澤元大9B售01  ,0,0,0,0,0,0,0,0,0,15000,0,0,0,72000,57000,15000,15000
061857,康友國票9B購01  ,0,0,0,0,0,0,0,0,0,14000,0,0,0,69000,55000,14000,14000
06182P,群創兆豐97售03  ,0,0,0,0,0,0,0,0,0,14000,0,0,0,20000,6000,14000,14000
061995,超眾元大01購01  ,0,0,0,0,0,0,0,0,0,14000,0,0,0,70000,56000,14000,14000
061697,世紀鋼群益9A購03,0,0,0,0,0,0,0,0,0,14000,0,0,0,20000,6000,14000,14000
061477,晶豪科元大9A購01,0,0,0,0,0,0,0,0,0,14000,0,0,0,50000,36000,14000,14000
061497,大立光國票9A購09,0,0,0,0,0,0,0,0,0,14000,0,0,0,14000,0,14000,14000
062526,友達統一01購01  ,0,0,0,0,0,0,0,0,0,14000,0,0,0,14000,0,14000,14000
06592P,欣興元大98售04  ,0,0,0,0,0,0,0,0,0,14000,0,0,0,14000,0,14000,14000
06644P,亞德客元大98售03,0,0,0,0,0,0,0,0,0,14000,0,0,0,40000,26000,14000,14000
063568,高鐵元大9B購01  ,0,0,0,0,0,0,0,0,0,14000,0,0,0,33000,19000,14000,14000
063503,香港反中信9C購01,0,0,0,0,0,0,0,0,0,14000,0,0,0,90000,76000,14000,14000
07098P,台積電元大99售18,0,0,0,0,0,0,0,0,0,14000,0,0,0,18000,4000,14000,14000
063422,奇鋐凱基9B購04  ,0,0,0,0,0,0,0,0,0,14000,0,0,0,15000,1000,14000,14000
056772,欣興元大99購01  ,0,0,0,0,0,0,0,0,0,14000,0,0,0,26000,12000,14000,14000
056747,致新凱基99購01  ,0,0,0,0,0,0,0,0,0,14000,0,0,0,64000,50000,14000,14000
060218,台積電凱基9A購15,0,0,0,0,0,0,0,0,0,14000,0,0,0,24000,10000,14000,14000
055071,群電永豐97購01  ,0,0,0,0,0,0,0,0,0,14000,0,0,0,69000,55000,14000,14000
055108,智邦凱基98購01  ,0,0,0,0,0,0,0,0,0,14000,0,0,0,15000,1000,14000,14000
055714,智邦元大97購03  ,0,0,0,0,0,0,0,0,0,14000,0,0,0,15000,1000,14000,14000
049108,玉晶光富邦96購02,0,0,0,0,0,0,0,0,0,14000,0,0,0,14000,0,14000,14000
054298,台表科元大97購03,0,0,0,0,0,0,0,0,0,14000,0,0,0,24000,10000,14000,14000
057495,牧德元大99購04  ,0,0,0,0,0,0,0,0,0,14000,0,0,0,25000,11000,14000,14000
060039,大立光國票99購04,0,0,0,0,0,0,0,0,0,14000,0,0,0,14000,0,14000,14000
061296,台積電國泰9C購01,0,0,0,0,0,0,0,0,0,14000,0,0,0,59000,45000,14000,14000
057963,緯穎元大98購08  ,0,0,0,0,0,0,0,0,0,14000,0,0,0,14000,0,14000,14000
059190,欣興富邦9A購01  ,0,0,0,0,0,0,0,0,0,14000,0,0,0,15000,1000,14000,14000
059306,台灣50元大99購03,0,0,0,0,0,0,0,0,0,14000,0,0,0,14000,0,14000,14000
058151,台積電統一9A購04,0,0,0,0,0,0,0,0,0,14000,0,0,0,15000,1000,14000,14000
08055P,臺股指國票9B售20,0,0,0,0,0,0,0,0,0,14000,0,0,0,19000,5000,14000,14000
08034P,台積電兆豐9B售02,0,0,0,0,0,0,0,0,0,14000,0,0,0,28000,14000,14000,14000
07708P,玉晶光元大9A售13,0,0,0,0,0,0,0,0,0,14000,0,0,0,14000,0,14000,14000
07470P,國巨元大9A售06  ,0,0,0,0,0,0,0,0,0,14000,0,0,0,15000,1000,14000,14000
07561P,玉晶光永豐9A售02,0,0,0,0,0,0,0,0,0,14000,0,0,0,14000,0,14000,14000
2415,錩新            ,51000,37000,14000,0,0,0,0,0,0,0,0,0,0,0,0,0,14000
6283,淳安            ,17000,3000,14000,0,0,0,0,0,0,0,0,0,0,0,0,0,14000
062869,帆宣中信9B購01  ,0,0,0,0,0,0,0,0,0,13000,0,0,0,62000,49000,13000,13000
07021P,台積電富邦9C售02,0,0,0,0,0,0,0,0,0,13000,0,0,0,23000,10000,13000,13000
06952P,大立光統一9A售03,0,0,0,0,0,0,0,0,0,13000,0,0,0,26000,13000,13000,13000
06837P,上銀統一9A售02  ,0,0,0,0,0,0,0,0,0,13000,0,0,0,13000,0,13000,13000
06676P,華新科國票98售03,0,0,0,0,0,0,0,0,0,13000,0,0,0,13000,0,13000,13000
062212,臻鼎台新9B購01  ,0,0,0,0,0,0,0,0,0,13000,0,0,0,17000,4000,13000,13000
053313,世紀鋼凱基96購01,0,0,0,0,0,0,0,0,0,13000,0,0,0,13000,0,13000,13000
054632,緯穎凱基9A購01  ,0,0,0,0,0,0,0,0,0,13000,0,0,0,20000,7000,13000,13000
053593,晶技元大98購01  ,0,0,0,0,0,0,0,0,0,13000,0,0,0,171000,158000,13000,13000
055476,台郡凱基97購02  ,0,0,0,0,0,0,0,0,0,13000,0,0,0,13000,0,13000,13000
056204,嘉澤永豐97購01  ,0,0,0,0,0,0,0,0,0,13000,0,0,0,13000,0,13000,13000
060245,聯陽元大9C購01  ,0,0,0,0,0,0,0,0,0,13000,0,0,0,13000,0,13000,13000
059848,智邦永豐99購01  ,0,0,0,0,0,0,0,0,0,13000,0,0,0,13000,0,13000,13000
056347,GIS凱基9A購01   ,0,0,0,0,0,0,0,0,0,13000,0,0,0,23000,10000,13000,13000
058849,奇力新群益99購02,0,0,0,0,0,0,0,0,0,13000,0,0,0,13000,0,13000,13000
061043,百和永豐9A購01  ,0,0,0,0,0,0,0,0,0,13000,0,0,0,13000,0,13000,13000
06100P,台積電日盛97售03,0,0,0,0,0,0,0,0,0,13000,0,0,0,73000,60000,13000,13000
07796P,聯發科國票9A售03,0,0,0,0,0,0,0,0,0,13000,0,0,0,13000,0,13000,13000
059740,瑞昱元富99購02  ,0,0,0,0,0,0,0,0,0,13000,0,0,0,13000,0,13000,13000
059723,美律元大9A購02  ,0,0,0,0,0,0,0,0,0,13000,0,0,0,78000,65000,13000,13000
059626,台積電凱基01購01,0,0,0,0,0,0,0,0,0,13000,0,0,0,16000,3000,13000,13000
060160,聯陽永豐9A購01  ,0,0,0,0,0,0,0,0,0,13000,0,0,0,13000,0,13000,13000
057486,美律元大98購04  ,0,0,0,0,0,0,0,0,0,13000,0,0,0,81000,68000,13000,13000
057365,智邦元大98購07  ,0,0,0,0,0,0,0,0,0,13000,0,0,0,33000,20000,13000,13000
058686,祥碩凱基99購03  ,0,0,0,0,0,0,0,0,0,13000,0,0,0,19000,6000,13000,13000
060682,牧德元大9A購03  ,0,0,0,0,0,0,0,0,0,13000,0,0,0,33000,20000,13000,13000
3437,榮創            ,107000,94000,13000,0,0,0,0,0,0,0,0,0,0,0,0,0,13000
4426,利勤            ,37000,21000,16000,0,0,0,0,0,0,-3000,0,0,0,0,3000,-3000,13000
060949,祥碩中信9A購01  ,0,0,0,0,0,0,0,0,0,13000,0,0,0,23000,10000,13000,13000
2936,客思達-KY       ,14000,1000,13000,0,0,0,0,0,0,0,0,0,0,0,0,0,13000
08180P,聯發科國泰01售05,0,0,0,0,0,0,0,0,0,13000,0,0,0,13000,0,13000,13000
07428P,華新科國票9A售01,0,0,0,0,0,0,0,0,0,13000,0,0,0,13000,0,13000,13000
07674P,金融類元大9A售01,0,0,0,0,0,0,0,0,0,13000,0,0,0,18000,5000,13000,13000
07202P,台灣50凱基9C售04,0,0,0,0,0,0,0,0,0,13000,0,0,0,13000,0,13000,13000
07765P,台積電群益9A售06,0,0,0,0,0,0,0,0,0,13000,0,0,0,20000,7000,13000,13000
08142P,國巨凱基9B售13  ,0,0,0,0,0,0,0,0,0,13000,0,0,0,13000,0,13000,13000
062176,元金2X元大9B購01,0,0,0,0,0,0,0,0,0,12000,0,0,0,12000,0,12000,12000
062261,嘉晶元大9B購02  ,0,0,0,0,0,0,0,0,0,12000,0,0,0,51000,39000,12000,12000
062559,嘉晶凱基9B購02  ,0,0,0,0,0,0,0,0,0,12000,0,0,0,12000,0,12000,12000
062414,臻鼎中信01購01  ,0,0,0,0,0,0,0,0,0,12000,0,0,0,27000,15000,12000,12000
061476,大毅元大9A購02  ,0,0,0,0,0,0,0,0,0,12000,0,0,0,52000,40000,12000,12000
06145P,華新科永豐97售02,0,0,0,0,0,0,0,0,0,12000,0,0,0,12000,0,12000,12000
061674,聯發科元大9A購12,0,0,0,0,0,0,0,0,0,12000,0,0,0,12000,0,12000,12000
06179P,國巨群益97售04  ,0,0,0,0,0,0,0,0,0,12000,0,0,0,12000,0,12000,12000
07065P,臺股指元大9A售26,0,0,0,0,0,0,0,0,0,12000,0,0,0,12000,0,12000,12000
06593P,欣興元大98售05  ,0,0,0,0,0,0,0,0,0,12000,0,0,0,172000,160000,12000,12000
062831,嘉澤群益9B購01  ,0,0,0,0,0,0,0,0,0,12000,0,0,0,12000,0,12000,12000
062790,臺股指元大9B購33,0,0,0,0,0,0,0,0,0,12000,0,0,0,12000,0,12000,12000
056576,晶技元大99購02  ,0,0,0,0,0,0,0,0,0,12000,0,0,0,12000,0,12000,12000
056577,玉晶光元大99購06,0,0,0,0,0,0,0,0,0,12000,0,0,0,12000,0,12000,12000
056173,廣達元富97購01  ,0,0,0,0,0,0,0,0,0,12000,0,0,0,12000,0,12000,12000
056141,聯茂元大97購05  ,0,0,0,0,0,0,0,0,0,12000,0,0,0,111000,99000,12000,12000
054785,建準群益98購01  ,0,0,0,0,0,0,0,0,0,12000,0,0,0,44000,32000,12000,12000
055112,晶豪科凱基98購01,0,0,0,0,0,0,0,0,0,12000,0,0,0,12000,0,12000,12000
055060,聯陽永豐97購01  ,0,0,0,0,0,0,0,0,0,12000,0,0,0,13000,1000,12000,12000
055647,義隆元富97購01  ,0,0,0,0,0,0,0,0,0,12000,0,0,0,140000,128000,12000,12000
054532,強茂國泰98購01  ,0,0,0,0,0,0,0,0,0,12000,0,0,0,13000,1000,12000,12000
053325,GIS群益96購02   ,0,0,0,0,0,0,0,0,0,12000,0,0,0,12000,0,12000,12000
055726,台表科元大98購03,0,0,0,0,0,0,0,0,0,12000,0,0,0,15000,3000,12000,12000
054358,矽創兆豐96購01  ,0,0,0,0,0,0,0,0,0,12000,0,0,0,12000,0,12000,12000
052476,台光電群益98購01,0,0,0,0,0,0,0,0,0,12000,0,0,0,12000,0,12000,12000
054477,聯發科中信9C購02,0,0,0,0,0,0,0,0,0,12000,0,0,0,12000,0,12000,12000
03437B,臺股指元富9C熊01,0,0,0,0,0,0,0,0,0,12000,0,0,0,12000,0,12000,12000
052025,國巨群益96購01  ,0,0,0,0,0,0,0,0,0,12000,0,0,0,55000,43000,12000,12000
051578,智邦元大96購01  ,0,0,0,0,0,0,0,0,0,12000,0,0,0,12000,0,12000,12000
0051,元大中型100     ,0,0,0,0,0,0,0,0,0,12000,0,0,0,87000,75000,12000,12000
058258,世芯國泰9A購01  ,0,0,0,0,0,0,0,0,0,12000,0,0,0,15000,3000,12000,12000
057882,華通群益9A購03  ,0,0,0,0,0,0,0,0,0,12000,0,0,0,20000,8000,12000,12000
057877,神達元大99購01  ,0,0,0,0,0,0,0,0,0,12000,0,0,0,49000,37000,12000,12000
057625,泰鼎國泰9A購01  ,0,0,0,0,0,0,0,0,0,12000,0,0,0,15000,3000,12000,12000
057517,矽創元富98購02  ,0,0,0,0,0,0,0,0,0,12000,0,0,0,459000,447000,12000,12000
060548,友達凱基9B購03  ,0,0,0,0,0,0,0,0,0,12000,0,0,0,12000,0,12000,12000
057831,聯發科元富02購04,0,0,0,0,0,0,0,0,0,12000,0,0,0,46000,34000,12000,12000
058085,景碩群益9A購01  ,0,0,0,0,0,0,0,0,0,12000,0,0,0,203000,191000,12000,12000
061288,大立光統一9C購01,0,0,0,0,0,0,0,0,0,12000,0,0,0,12000,0,12000,12000
061356,南電元大9A購06  ,0,0,0,0,0,0,0,0,0,12000,0,0,0,32000,20000,12000,12000
061343,大立光元大9A購04,0,0,0,0,0,0,0,0,0,12000,0,0,0,22000,10000,12000,12000
058312,大毅國泰9B購01  ,0,0,0,0,0,0,0,0,0,12000,0,0,0,33000,21000,12000,12000
1614,三洋電          ,16000,4000,12000,0,0,0,0,0,0,0,0,0,0,0,0,0,12000
2030,彰源            ,21000,9000,12000,0,0,0,0,0,0,0,0,0,0,0,0,0,12000
3057,喬鼎            ,15000,3000,12000,0,0,0,0,0,0,0,0,0,0,0,0,0,12000
2891B,中信金乙特      ,0,0,0,0,0,0,0,0,0,12000,12000,0,12000,0,0,0,12000
060836,上銀國票9A購03  ,0,0,0,0,0,0,0,0,0,12000,0,0,0,15000,3000,12000,12000
060838,華通國票9A購05  ,0,0,0,0,0,0,0,0,0,12000,0,0,0,19000,7000,12000,12000
060811,亞德客凱基9A購02,0,0,0,0,0,0,0,0,0,12000,0,0,0,41000,29000,12000,12000
4763,材料-KY         ,16000,6000,10000,0,0,0,0,0,0,2000,3000,1000,2000,0,0,0,12000
5288,豐祥-KY         ,27000,15000,12000,0,0,0,0,0,0,0,0,0,0,0,0,0,12000
6139,亞翔            ,26000,14000,12000,0,0,0,0,0,0,0,0,0,0,0,0,0,12000
06483P,聯發科凱基98售10,0,0,0,0,0,0,0,0,0,11000,0,0,0,16000,5000,11000,11000
07039P,南電台新99售01  ,0,0,0,0,0,0,0,0,0,11000,0,0,0,11000,0,11000,11000
06735P,奇力新凱基98售07,0,0,0,0,0,0,0,0,0,11000,0,0,0,29000,18000,11000,11000
06809P,電子類群益98售03,0,0,0,0,0,0,0,0,0,11000,0,0,0,11000,0,11000,11000
061567,華通元大9A購11  ,0,0,0,0,0,0,0,0,0,11000,0,0,0,65000,54000,11000,11000
062527,美律統一01購01  ,0,0,0,0,0,0,0,0,0,11000,0,0,0,100000,89000,11000,11000
062538,台積電國泰9C購02,0,0,0,0,0,0,0,0,0,11000,0,0,0,23000,12000,11000,11000
062709,帆宣元大9B購01  ,0,0,0,0,0,0,0,0,0,11000,0,0,0,112000,101000,11000,11000
062201,臺指反國票9B購05,0,0,0,0,0,0,0,0,0,11000,0,0,0,11000,0,11000,11000
048572,美利達元大96購04,0,0,0,0,0,0,0,0,0,11000,0,0,0,11000,0,11000,11000
055727,矽力元大97購02  ,0,0,0,0,0,0,0,0,0,11000,0,0,0,11000,0,11000,11000
056234,GIS麥證97購01   ,0,0,0,11000,0,11000,0,0,0,11000,0,0,0,11000,0,11000,11000
055341,台達電凱基97購02,0,0,0,0,0,0,0,0,0,11000,0,0,0,11000,0,11000,11000
057052,華擎元大98購01  ,0,0,0,0,0,0,0,0,0,11000,0,0,0,11000,0,11000,11000
059959,訊芯康和99購01  ,0,0,0,0,0,0,0,0,0,11000,0,0,0,11000,0,11000,11000
058339,康友元富99購02  ,0,0,0,0,0,0,0,0,0,11000,0,0,0,12000,1000,11000,11000
058459,南電永豐99購01  ,0,0,0,0,0,0,0,0,0,11000,0,0,0,23000,12000,11000,11000
059292,華新科元富9B購02,0,0,0,0,0,0,0,0,0,11000,0,0,0,11000,0,11000,11000
057170,瑞昱元大98購01  ,0,0,0,0,0,0,0,0,0,11000,0,0,0,187000,176000,11000,11000
057621,崇越凱基98購01  ,0,0,0,0,0,0,0,0,0,11000,0,0,0,11000,0,11000,11000
057303,喬山兆豐99購01  ,0,0,0,0,0,0,0,0,0,11000,0,0,0,21000,10000,11000,11000
058692,華邦電國票9B購01,0,0,0,0,0,0,0,0,0,11000,0,0,0,145000,134000,11000,11000
058706,聯鈞元大9C購01  ,0,0,0,0,0,0,0,0,0,11000,0,0,0,11000,0,11000,11000
058730,玉晶光永豐9A購01,0,0,0,0,0,0,0,0,0,11000,0,0,0,90000,79000,11000,11000
6189,豐藝            ,41000,30000,11000,0,0,0,0,0,0,0,0,0,0,0,0,0,11000
060666,聯茂凱基9A購02  ,0,0,0,0,0,0,0,0,0,11000,0,0,0,11000,0,11000,11000
060762,長榮航元大9A購02,0,0,0,0,0,0,0,0,0,11000,0,0,0,61000,50000,11000,11000
060746,玉晶光國票9B購02,0,0,0,0,0,0,0,0,0,11000,0,0,0,67000,56000,11000,11000
060702,玉晶光國泰9C購02,0,0,0,0,0,0,0,0,0,11000,0,0,0,16000,5000,11000,11000
8103,瀚荃            ,11000,0,11000,0,0,0,0,0,0,0,0,0,0,0,0,0,11000
8039,台虹            ,219000,199000,20000,0,0,0,0,0,0,-9000,0,0,0,12000,21000,-9000,11000
8499,鼎炫-KY         ,11000,0,11000,0,0,0,0,0,0,0,0,0,0,0,0,0,11000
2468,華經            ,12000,1000,11000,0,0,0,0,0,0,0,0,0,0,0,0,0,11000
2597,潤弘            ,14000,3000,11000,0,0,0,0,0,0,0,0,0,0,0,0,0,11000
08087P,聯發科凱基9B售12,0,0,0,0,0,0,0,0,0,11000,0,0,0,11000,0,11000,11000
07997P,上銀凱基9B售04  ,0,0,0,0,0,0,0,0,0,11000,0,0,0,26000,15000,11000,11000
07940P,國巨群益9B售06  ,0,0,0,0,0,0,0,0,0,11000,0,0,0,21000,10000,11000,11000
07190P,臺股指富邦9C售02,0,0,0,0,0,0,0,0,0,11000,0,0,0,14000,3000,11000,11000
07342P,大立光凱基99售14,0,0,0,0,0,0,0,0,0,11000,0,0,0,31000,20000,11000,11000
062196,聯發科中信01購02,0,0,0,0,0,0,0,0,0,10000,0,0,0,10000,0,10000,10000
062204,京元電國票9C購01,0,0,0,0,0,0,0,0,0,10000,0,0,0,49000,39000,10000,10000
062178,上銀元大9B購03  ,0,0,0,0,0,0,0,0,0,10000,0,0,0,15000,5000,10000,10000
062116,元金2X第一9B購01,0,0,0,0,0,0,0,0,0,10000,0,0,0,10000,0,10000,10000
062314,玉晶光凱基9B購06,0,0,0,0,0,0,0,0,0,10000,0,0,0,18000,8000,10000,10000
06272P,台郡凱基97售04  ,0,0,0,0,0,0,0,0,0,10000,0,0,0,10000,0,10000,10000
06266P,大立光凱基97售11,0,0,0,0,0,0,0,0,0,10000,0,0,0,10000,0,10000,10000
062691,T50反1元大9B購04,0,0,0,0,0,0,0,0,0,10000,0,0,0,10000,0,10000,10000
062657,華新科第一9B購01,0,0,0,0,0,0,0,0,0,10000,0,0,0,10000,0,10000,10000
061509,SP黃豆富邦9C購01,0,0,0,0,0,0,0,0,0,10000,0,0,0,10000,0,10000,10000
06173P,華通元大97售02  ,0,0,0,0,0,0,0,0,0,10000,0,0,0,10000,0,10000,10000
061737,南亞科凱基9B購01,0,0,0,0,0,0,0,0,0,10000,0,0,0,10000,0,10000,10000
061846,元金2X國票9C購01,0,0,0,0,0,0,0,0,0,10000,0,0,0,10000,0,10000,10000
06207P,聯發科凱基97售07,0,0,0,0,0,0,0,0,0,10000,0,0,0,10000,0,10000,10000
062042,台勝科凱基9C購01,0,0,0,0,0,0,0,0,0,10000,0,0,0,10000,0,10000,10000
061938,大立光國票9B購03,0,0,0,0,0,0,0,0,0,10000,0,0,0,20000,10000,10000,10000
06841P,臺股指統一9A售02,0,0,0,0,0,0,0,0,0,10000,0,0,0,10000,0,10000,10000
06905P,上証2X國泰99售02,0,0,0,0,0,0,0,0,0,10000,0,0,0,10000,0,10000,10000
06877P,台積電兆豐98售04,0,0,0,0,0,0,0,0,0,10000,0,0,0,23000,13000,10000,10000
06717P,可成元大98售09  ,0,0,0,0,0,0,0,0,0,10000,0,0,0,10000,0,10000,10000
06994P,台光電凱基99售02,0,0,0,0,0,0,0,0,0,10000,0,0,0,10000,0,10000,10000
07063P,臺股指元大9A售24,0,0,0,0,0,0,0,0,0,10000,0,0,0,10000,0,10000,10000
07091P,SGBR2X凱基9A售02,0,0,0,0,0,0,0,0,0,10000,0,0,0,10000,0,10000,10000
06471P,臺股指凱基99售11,0,0,0,0,0,0,0,0,0,10000,0,0,0,10000,0,10000,10000
06501P,臺股指元大9A售06,0,0,0,0,0,0,0,0,0,10000,0,0,0,10000,0,10000,10000
063469,牧德元大9C購02  ,0,0,0,0,0,0,0,0,0,10000,0,0,0,10000,0,10000,10000
062827,神基群益9B購01  ,0,0,0,0,0,0,0,0,0,10000,0,0,0,10000,0,10000,10000
062918,祥碩元大9C購02  ,0,0,0,0,0,0,0,0,0,10000,0,0,0,18000,8000,10000,10000
063034,致茂凱基9B購01  ,0,0,0,0,0,0,0,0,0,10000,0,0,0,10000,0,10000,10000
063067,緯穎麥證9B購01  ,0,0,0,10000,0,10000,0,0,0,10000,0,0,0,10000,0,10000,10000
06295P,國巨元大97售14  ,0,0,0,0,0,0,0,0,0,10000,0,0,0,10000,0,10000,10000
062923,緯穎元大9B購06  ,0,0,0,0,0,0,0,0,0,10000,0,0,0,10000,0,10000,10000
06330P,南亞科群益97售03,0,0,0,0,0,0,0,0,0,10000,0,0,0,10000,0,10000,10000
063161,祥碩富邦9B購02  ,0,0,0,0,0,0,0,0,0,10000,0,0,0,10000,0,10000,10000
059973,A50正2元大99購02,0,0,0,0,0,0,0,0,0,10000,0,0,0,20000,10000,10000,10000
05985P,燿華統一96售03  ,0,0,0,0,0,0,0,0,0,10000,0,0,0,10000,0,10000,10000
059863,和大凱基99購01  ,0,0,0,0,0,0,0,0,0,10000,0,0,0,30000,20000,10000,10000
059742,富邦金元富99購01,0,0,0,0,0,0,0,0,0,10000,0,0,0,60000,50000,10000,10000
060079,台郡台新99購03  ,0,0,0,0,0,0,0,0,0,10000,0,0,0,10000,0,10000,10000
056280,上証2X永豐98購01,0,0,0,0,0,0,0,0,0,10000,0,0,0,10000,0,10000,10000
056415,聯發科中信98購04,0,0,0,0,0,0,0,0,0,10000,0,0,0,10000,0,10000,10000
056431,鴻海凱基98購07  ,0,0,0,0,0,0,0,0,0,10000,0,0,0,10000,0,10000,10000
056425,聯發科日盛9A購01,0,0,0,0,0,0,0,0,0,10000,0,0,0,10000,0,10000,10000
056462,訊芯凱基98購03  ,0,0,0,0,0,0,0,0,0,10000,0,0,0,59000,49000,10000,10000
056649,智易凱基98購01  ,0,0,0,0,0,0,0,0,0,10000,0,0,0,59000,49000,10000,10000
056712,京鼎永豐98購01  ,0,0,0,0,0,0,0,0,0,10000,0,0,0,10000,0,10000,10000
054928,帆宣凱基98購01  ,0,0,0,0,0,0,0,0,0,10000,0,0,0,10000,0,10000,10000
055005,晶相光元富97購01,0,0,0,0,0,0,0,0,0,10000,0,0,0,10000,0,10000,10000
056987,南茂群益98購01  ,0,0,0,0,0,0,0,0,0,10000,0,0,0,10000,0,10000,10000
056994,緯穎兆豐98購02  ,0,0,0,0,0,0,0,0,0,10000,0,0,0,10000,0,10000,10000
055582,亞德客元大97購01,0,0,0,0,0,0,0,0,0,10000,0,0,0,10000,0,10000,10000
055408,力成國泰98購01  ,0,0,0,0,0,0,0,0,0,10000,0,0,0,10000,0,10000,10000
056222,台積電凱基9A購01,0,0,0,0,0,0,0,0,0,10000,0,0,0,10000,0,10000,10000
056223,華邦電凱基97購04,0,0,0,0,0,0,0,0,0,10000,0,0,0,10000,0,10000,10000
056252,聯發科兆豐97購03,0,0,0,0,0,0,0,0,0,10000,0,0,0,10000,0,10000,10000
055164,矽創元大98購01  ,0,0,0,0,0,0,0,0,0,10000,0,0,0,10000,0,10000,10000
055709,深中小元大97購03,0,0,0,0,0,0,0,0,0,10000,0,0,0,10000,0,10000,10000
055692,緯穎凱基97購03  ,0,0,0,0,0,0,0,0,0,10000,0,0,0,10000,0,10000,10000
055747,康舒元富97購01  ,0,0,0,0,0,0,0,0,0,10000,0,0,0,10000,0,10000,10000
053031,華新科第一96購01,0,0,0,0,0,0,0,0,0,10000,0,0,0,10000,0,10000,10000
054076,義隆第一96購01  ,0,0,0,0,0,0,0,0,0,10000,0,0,0,10000,0,10000,10000
053246,聯詠國票97購02  ,0,0,0,0,0,0,0,0,0,10000,0,0,0,10000,0,10000,10000
053104,台表科元富96購02,0,0,0,0,0,0,0,0,0,10000,0,0,0,10000,0,10000,10000
053072,國巨台新97購01  ,0,0,0,0,0,0,0,0,0,10000,0,0,0,79000,69000,10000,10000
053082,聯電元大98購03  ,0,0,0,0,0,0,0,0,0,10000,0,0,0,20000,10000,10000,10000
053083,中環元大99購01  ,0,0,0,0,0,0,0,0,0,10000,0,0,0,10000,0,10000,10000
056011,矽力中信99購01  ,0,0,0,0,0,0,0,0,0,10000,0,0,0,18000,8000,10000,10000
055862,矽力元大97購04  ,0,0,0,0,0,0,0,0,0,10000,0,0,0,10000,0,10000,10000
056856,華通群益9A購01  ,0,0,0,0,0,0,0,0,0,10000,0,0,0,29000,19000,10000,10000
054707,聯茂亞東97購01  ,0,0,0,0,0,0,0,0,0,10000,0,0,0,10000,0,10000,10000
054710,東元元富97購01  ,0,0,0,0,0,0,0,0,0,10000,0,0,0,212000,202000,10000,10000
054681,味全永豐97購01  ,0,0,0,0,0,0,0,0,0,10000,0,0,0,10000,0,10000,10000
052724,力成統一97購01  ,0,0,0,0,0,0,0,0,0,10000,0,0,0,10000,0,10000,10000
053355,超眾兆豐97購01  ,0,0,0,0,0,0,0,0,0,10000,0,0,0,20000,10000,10000,10000
053404,致新群益96購01  ,0,0,0,0,0,0,0,0,0,10000,0,0,0,10000,0,10000,10000
053454,創意統一96購02  ,0,0,0,0,0,0,0,0,0,10000,0,0,0,10000,0,10000,10000
052904,冠德國票97購01  ,0,0,0,0,0,0,0,0,0,10000,0,0,0,10000,0,10000,10000
054063,聯茂國票97購02  ,0,0,0,0,0,0,0,0,0,10000,0,0,0,16000,6000,10000,10000
054018,華新台新96購01  ,0,0,0,0,0,0,0,0,0,10000,0,0,0,10000,0,10000,10000
054021,義隆台新96購01  ,0,0,0,0,0,0,0,0,0,10000,0,0,0,19000,9000,10000,10000
054031,中鋼中信98購01  ,0,0,0,0,0,0,0,0,0,10000,0,0,0,10000,0,10000,10000
054036,T50反1元大96購08,0,0,0,0,0,0,0,0,0,10000,0,0,0,10000,0,10000,10000
053805,奇鋐凱基98購02  ,0,0,0,0,0,0,0,0,0,10000,0,0,0,30000,20000,10000,10000
053855,康友國泰98購01  ,0,0,0,0,0,0,0,0,0,10000,0,0,0,10000,0,10000,10000
049254,台積電元大96購02,0,0,0,0,0,0,0,0,0,10000,0,0,0,10000,0,10000,10000
050895,聯發科元大97購01,0,0,0,0,0,0,0,0,0,10000,0,0,0,10000,0,10000,10000
051375,道瓊反群益9A購01,0,0,0,0,0,0,0,0,0,10000,0,0,0,10000,0,10000,10000
052437,聯發科富邦99購02,0,0,0,0,0,0,0,0,0,10000,0,0,0,10000,0,10000,10000
052362,瑞昱國票96購02  ,0,0,0,0,0,0,0,0,0,10000,0,0,0,61000,51000,10000,10000
054333,茂林永豐96購03  ,0,0,0,0,0,0,0,0,0,10000,0,0,0,10000,0,10000,10000
054378,楠梓電群益98購01,0,0,0,0,0,0,0,0,0,10000,0,0,0,90000,80000,10000,10000
052299,T50反1台新05購03,0,0,0,0,0,0,0,0,0,10000,0,0,0,10000,0,10000,10000
00731,FH富時高息低波  ,1000,1000,0,0,0,0,0,0,0,10000,0,0,0,26000,16000,10000,10000
00732,國泰RMB短期報酬 ,0,0,0,0,0,0,0,0,0,10000,0,0,0,110000,100000,10000,10000
05160P,國巨國票96售03  ,0,0,0,0,0,0,0,0,0,10000,0,0,0,10000,0,10000,10000
051570,和碩富邦97購01  ,0,0,0,0,0,0,0,0,0,10000,0,0,0,10000,0,10000,10000
051732,華通國票97購01  ,0,0,0,0,0,0,0,0,0,10000,0,0,0,406000,396000,10000,10000
051879,健策台新96購01  ,0,0,0,0,0,0,0,0,0,10000,0,0,0,10000,0,10000,10000
052077,可成元富98購02  ,0,0,0,0,0,0,0,0,0,10000,0,0,0,10000,0,10000,10000
052220,T50反1凱基98購01,0,0,0,0,0,0,0,0,0,10000,0,0,0,10000,0,10000,10000
04006P,滬深2X國票9B售01,0,0,0,0,0,0,0,0,0,10000,0,0,0,10000,0,10000,10000
03566P,臺股指日盛03售01,0,0,0,0,0,0,0,0,0,10000,0,0,0,10000,0,10000,10000
045054,聯發科元富98購02,0,0,0,0,0,0,0,0,0,10000,0,0,0,10000,0,10000,10000
045055,聯發科元富98購03,0,0,0,0,0,0,0,0,0,10000,0,0,0,10000,0,10000,10000
058259,訊連國泰9B購01  ,0,0,0,0,0,0,0,0,0,10000,0,0,0,10000,0,10000,10000
058246,帆宣元大99購01  ,0,0,0,0,0,0,0,0,0,10000,0,0,0,15000,5000,10000,10000
058243,華擎元大99購01  ,0,0,0,0,0,0,0,0,0,10000,0,0,0,242000,232000,10000,10000
058255,臺股指元大9A購19,0,0,0,0,0,0,0,0,0,10000,0,0,0,10000,0,10000,10000
058193,緯穎永豐99購01  ,0,0,0,0,0,0,0,0,0,10000,0,0,0,10000,0,10000,10000
058206,祥碩凱基99購01  ,0,0,0,0,0,0,0,0,0,10000,0,0,0,10000,0,10000,10000
058234,華新科元大99購12,0,0,0,0,0,0,0,0,0,10000,0,0,0,10000,0,10000,10000
057863,美律凱基9A購01  ,0,0,0,0,0,0,0,0,0,10000,0,0,0,10000,0,10000,10000
060260,京鼎凱基9C購01  ,0,0,0,0,0,0,0,0,0,10000,0,0,0,10000,0,10000,10000
057252,牧德元富98購01  ,0,0,0,0,0,0,0,0,0,10000,0,0,0,10000,0,10000,10000
06054P,臺股指中信9A售01,0,0,0,0,0,0,0,0,0,10000,0,0,0,10000,0,10000,10000
060553,祥碩凱基9A購01  ,0,0,0,0,0,0,0,0,0,10000,0,0,0,10000,0,10000,10000
060585,玉晶光元富9A購02,0,0,0,0,0,0,0,0,0,10000,0,0,0,10000,0,10000,10000
060597,華通凱基9A購04  ,0,0,0,0,0,0,0,0,0,10000,0,0,0,10000,0,10000,10000
060527,台積電中信9C購04,0,0,0,0,0,0,0,0,0,10000,0,0,0,13000,3000,10000,10000
060167,禾聯碩永豐9A購01,0,0,0,0,0,0,0,0,0,10000,0,0,0,10000,0,10000,10000
06017P,亞光凱基96售04  ,0,0,0,0,0,0,0,0,0,10000,0,0,0,20000,10000,10000,10000
059567,台積電凱基9A購12,0,0,0,0,0,0,0,0,0,10000,0,0,0,10000,0,10000,10000
058596,旺宏台新99購01  ,0,0,0,0,0,0,0,0,0,10000,0,0,0,30000,20000,10000,10000
059628,智邦凱基99購04  ,0,0,0,0,0,0,0,0,0,10000,0,0,0,10000,0,10000,10000
060312,潤泰全永豐9A購01,0,0,0,0,0,0,0,0,0,10000,0,0,0,10000,0,10000,10000
060399,康友國票9A購02  ,0,0,0,0,0,0,0,0,0,10000,0,0,0,25000,15000,10000,10000
059650,緯穎凱基99購04  ,0,0,0,0,0,0,0,0,0,10000,0,0,0,10000,0,10000,10000
059532,華新科凱基9B購03,0,0,0,0,0,0,0,0,0,10000,0,0,0,10000,0,10000,10000
059521,南電永豐99購03  ,0,0,0,0,0,0,0,0,0,10000,0,0,0,10000,0,10000,10000
057681,T50反1日盛9C購01,0,0,0,0,0,0,0,0,0,10000,0,0,0,10000,0,10000,10000
058533,玉晶光元富99購01,0,0,0,0,0,0,0,0,0,10000,0,0,0,10000,0,10000,10000
058554,瀚宇博永豐99購01,0,0,0,0,0,0,0,0,0,10000,0,0,0,10000,0,10000,10000
058535,玉晶光統一9A購06,0,0,0,0,0,0,0,0,0,10000,0,0,0,10000,0,10000,10000
060049,華通凱基99購06  ,0,0,0,0,0,0,0,0,0,10000,0,0,0,10000,0,10000,10000
057196,茂林台新98購01  ,0,0,0,0,0,0,0,0,0,10000,0,0,0,10000,0,10000,10000
058031,旺宏永豐98購04  ,0,0,0,0,0,0,0,0,0,10000,0,0,0,10000,0,10000,10000
058977,SGBR2X凱基03購01,0,0,0,0,0,0,0,0,0,10000,0,0,0,23000,13000,10000,10000
061026,南電富邦9B購01  ,0,0,0,0,0,0,0,0,0,10000,0,0,0,10000,0,10000,10000
061068,祥碩凱基9B購01  ,0,0,0,0,0,0,0,0,0,10000,0,0,0,20000,10000,10000,10000
061065,神基凱基9A購01  ,0,0,0,0,0,0,0,0,0,10000,0,0,0,10000,0,10000,10000
061284,友達統一9C購01  ,0,0,0,0,0,0,0,0,0,10000,0,0,0,10000,0,10000,10000
06129P,玉晶光元富97售06,0,0,0,0,0,0,0,0,0,10000,0,0,0,10000,0,10000,10000
061245,晶技群益9A購01  ,0,0,0,0,0,0,0,0,0,10000,0,0,0,10000,0,10000,10000
061241,晶技兆豐9A購01  ,0,0,0,0,0,0,0,0,0,10000,0,0,0,40000,30000,10000,10000
059387,華通凱基9A購03  ,0,0,0,0,0,0,0,0,0,10000,0,0,0,10000,0,10000,10000
059197,可成永豐99購02  ,0,0,0,0,0,0,0,0,0,10000,0,0,0,10000,0,10000,10000
059262,致茂中信01購01  ,0,0,0,0,0,0,0,0,0,10000,0,0,0,29000,19000,10000,10000
059239,台積電凱基99購12,0,0,0,0,0,0,0,0,0,10000,0,0,0,30000,20000,10000,10000
058834,GIS永豐99購01   ,0,0,0,0,0,0,0,0,0,10000,0,0,0,52000,42000,10000,10000
057953,聚陽元大98購01  ,0,0,0,0,0,0,0,0,0,10000,0,0,0,10000,0,10000,10000
060282,聚陽元大9A購01  ,0,0,0,0,0,0,0,0,0,10000,0,0,0,10000,0,10000,10000
060267,上緯控國票9C購01,0,0,0,0,0,0,0,0,0,10000,0,0,0,10000,0,10000,10000
058482,祥碩凱基99購02  ,0,0,0,0,0,0,0,0,0,10000,0,0,0,10000,0,10000,10000
058485,智邦國票9A購01  ,0,0,0,0,0,0,0,0,0,10000,0,0,0,10000,0,10000,10000
058111,健鼎元富98購01  ,0,0,0,0,0,0,0,0,0,10000,0,0,0,10000,0,10000,10000
058501,S&P正2元大99購01,0,0,0,0,0,0,0,0,0,10000,0,0,0,10000,0,10000,10000
058310,大立光元大99購10,0,0,0,0,0,0,0,0,0,10000,0,0,0,10000,0,10000,10000
058357,智邦凱基99購02  ,0,0,0,0,0,0,0,0,0,10000,0,0,0,10000,0,10000,10000
058361,美律凱基99購06  ,0,0,0,0,0,0,0,0,0,10000,0,0,0,10000,0,10000,10000
058175,旺宏凱基99購03  ,0,0,0,0,0,0,0,0,0,10000,0,0,0,10000,0,10000,10000
058130,瑞昱元大99購01  ,0,0,0,0,0,0,0,0,0,10000,0,0,0,10000,0,10000,10000
07337P,台灣50凱基99售09,0,0,0,0,0,0,0,0,0,10000,0,0,0,10000,0,10000,10000
07281P,鴻海凱基99售13  ,0,0,0,0,0,0,0,0,0,10000,0,0,0,10000,0,10000,10000
07381P,鴻海群益99售05  ,0,0,0,0,0,0,0,0,0,10000,0,0,0,20000,10000,10000,10000
07194P,聯發科元大99售25,0,0,0,0,0,0,0,0,0,10000,0,0,0,10000,0,10000,10000
07188P,臺股指台新99售11,0,0,0,0,0,0,0,0,0,10000,0,0,0,10000,0,10000,10000
07196P,大立光元大99售13,0,0,0,0,0,0,0,0,0,10000,0,0,0,10000,0,10000,10000
07236P,台灣50國票99售05,0,0,0,0,0,0,0,0,0,10000,0,0,0,10000,0,10000,10000
07620P,國巨統一9B售07  ,0,0,0,0,0,0,0,0,0,10000,0,0,0,10000,0,10000,10000
07628P,臺股指凱基9A售09,0,0,0,0,0,0,0,0,0,10000,0,0,0,10000,0,10000,10000
07493P,台灣50元大9A售10,0,0,0,0,0,0,0,0,0,10000,0,0,0,10000,0,10000,10000
07531P,大立光國泰9B售03,0,0,0,0,0,0,0,0,0,10000,0,0,0,24000,14000,10000,10000
07966P,瑞祺群益9B售02  ,0,0,0,0,0,0,0,0,0,10000,0,0,0,20000,10000,10000,10000
07881P,台灣50凱基01售11,0,0,0,0,0,0,0,0,0,10000,0,0,0,10000,0,10000,10000
07900P,臺股指凱基9B售03,0,0,0,0,0,0,0,0,0,10000,0,0,0,18000,8000,10000,10000
07756P,台灣50國票04售01,0,0,0,0,0,0,0,0,0,10000,0,0,0,10000,0,10000,10000
07691P,宏達電元大9A售05,0,0,0,0,0,0,0,0,0,10000,0,0,0,25000,15000,10000,10000
07692P,玉晶光元大9A售11,0,0,0,0,0,0,0,0,0,10000,0,0,0,10000,0,10000,10000
07741P,滬深2X凱基9B售04,0,0,0,0,0,0,0,0,0,10000,0,0,0,20000,10000,10000,10000
07983P,茂林群益9B售03  ,0,0,0,0,0,0,0,0,0,10000,0,0,0,20000,10000,10000,10000
08090P,嘉澤統一9B售01  ,0,0,0,0,0,0,0,0,0,10000,0,0,0,20000,10000,10000,10000
08147P,聯發科群益9B售10,0,0,0,0,0,0,0,0,0,10000,0,0,0,70000,60000,10000,10000
2483,百容            ,11000,1000,10000,0,0,0,0,0,0,0,0,0,0,0,0,0,10000
3032,偉訓            ,28000,18000,10000,0,0,0,0,0,0,0,0,0,0,0,0,0,10000
3027,盛達            ,15000,5000,10000,0,0,0,0,0,0,0,0,0,0,0,0,0,10000
1903,士紙            ,17000,7000,10000,0,0,0,0,0,0,0,0,0,0,0,0,0,10000
2002A,中鋼特          ,0,0,0,0,0,0,0,0,0,10000,10000,0,10000,0,0,0,10000
060984,南亞科元大9A購07,0,0,0,0,0,0,0,0,0,10000,0,0,0,16000,6000,10000,10000
060895,華新科凱基9B購05,0,0,0,0,0,0,0,0,0,10000,0,0,0,10000,0,10000,10000
060710,上銀永豐9A購01  ,0,0,0,0,0,0,0,0,0,10000,0,0,0,10000,0,10000,10000
060655,國巨統一9B購06  ,0,0,0,0,0,0,0,0,0,10000,0,0,0,10000,0,10000,10000
063158,瑞昱台新9B購02  ,0,0,0,0,0,0,0,0,0,9000,0,0,0,118000,109000,9000,9000
062911,聯詠元大9B購03  ,0,0,0,0,0,0,0,0,0,9000,0,0,0,111000,102000,9000,9000
062803,嘉晶統一9B購02  ,0,0,0,0,0,0,0,0,0,9000,0,0,0,11000,2000,9000,9000
062759,旺宏凱基9B購07  ,0,0,0,0,0,0,0,0,0,9000,0,0,0,15000,6000,9000,9000
06532P,友達元富98售04  ,0,0,0,0,0,0,0,0,0,9000,0,0,0,9000,0,9000,9000
06965P,台積電台新99售02,0,0,0,0,0,0,0,0,0,9000,0,0,0,209000,200000,9000,9000
06677P,牧德國票98售02  ,0,0,0,0,0,0,0,0,0,9000,0,0,0,11000,2000,9000,9000
061871,瑞昱元大9B購01  ,0,0,0,0,0,0,0,0,0,9000,0,0,0,140000,131000,9000,9000
061513,華新科永豐9A購04,0,0,0,0,0,0,0,0,0,9000,0,0,0,9000,0,9000,9000
061541,旺宏群益9A購03  ,0,0,0,0,0,0,0,0,0,9000,0,0,0,16000,7000,9000,9000
062400,晶豪科永豐9B購02,0,0,0,0,0,0,0,0,0,9000,0,0,0,77000,68000,9000,9000
062191,台郡元大9B購05  ,0,0,0,0,0,0,0,0,0,9000,0,0,0,84000,75000,9000,9000
049842,道瓊反中信98購01,0,0,0,0,0,0,0,0,0,9000,0,0,0,49000,40000,9000,9000
053712,台光電凱基96購04,0,0,0,0,0,0,0,0,0,9000,0,0,0,10000,1000,9000,9000
053637,強茂永豐96購01  ,0,0,0,0,0,0,0,0,0,9000,0,0,0,9000,0,9000,9000
053353,玉晶光兆豐97購03,0,0,0,0,0,0,0,0,0,9000,0,0,0,9000,0,9000,9000
053320,華新科群益97購01,0,0,0,0,0,0,0,0,0,9000,0,0,0,9000,0,9000,9000
05600P,玉晶光台新96售04,0,0,0,0,0,0,0,0,0,9000,0,0,0,9000,0,9000,9000
055746,同欣電元富97購01,0,0,0,0,0,0,0,0,0,9000,0,0,0,16000,7000,9000,9000
055334,禾伸堂兆豐97購01,0,0,0,0,0,0,0,0,0,9000,0,0,0,9000,0,9000,9000
056151,建準凱基97購01  ,0,0,0,0,0,0,0,0,0,9000,0,0,0,30000,21000,9000,9000
057106,美律群益98購03  ,0,0,0,0,0,0,0,0,0,9000,0,0,0,10000,1000,9000,9000
056484,聯茂元大98購02  ,0,0,0,0,0,0,0,0,0,9000,0,0,0,13000,4000,9000,9000
060237,友達元大9A購06  ,0,0,0,0,0,0,0,0,0,9000,0,0,0,52000,43000,9000,9000
059061,晶技凱基9A購01  ,0,0,0,0,0,0,0,0,0,9000,0,0,0,35000,26000,9000,9000
059120,致伸永豐99購01  ,0,0,0,0,0,0,0,0,0,9000,0,0,0,9000,0,9000,9000
058358,技嘉凱基9A購01  ,0,0,0,0,0,0,0,0,0,9000,0,0,0,22000,13000,9000,9000
058389,聯茂國票9A購01  ,0,0,0,0,0,0,0,0,0,9000,0,0,0,35000,26000,9000,9000
059204,台灣50元大01購02,0,0,0,0,0,0,0,0,0,9000,0,0,0,9000,0,9000,9000
061234,國巨元大9A購18  ,0,0,0,0,0,0,0,0,0,9000,0,0,0,19000,10000,9000,9000
061072,南電凱基9B購01  ,0,0,0,0,0,0,0,0,0,9000,0,0,0,9000,0,9000,9000
058632,世紀鋼國票9A購01,0,0,0,0,0,0,0,0,0,9000,0,0,0,46000,37000,9000,9000
6277,宏正            ,82000,77000,5000,0,0,0,0,0,0,4000,4000,0,4000,0,0,0,9000
4190,佐登-KY         ,20000,8000,12000,0,0,0,0,0,0,-3000,0,0,0,0,3000,-3000,9000
060815,茂林凱基9B購01  ,0,0,0,0,0,0,0,0,0,9000,0,0,0,11000,2000,9000,9000
060779,臺股指凱基9A購07,0,0,0,0,0,0,0,0,0,9000,0,0,0,15000,6000,9000,9000
060875,華通中信02購01  ,0,0,0,0,0,0,0,0,0,9000,0,0,0,10000,1000,9000,9000
060966,台表科凱基9B購01,0,0,0,0,0,0,0,0,0,9000,0,0,0,63000,54000,9000,9000
8105,凌巨            ,79000,70000,9000,0,0,0,0,0,0,0,0,0,0,0,0,0,9000
08018P,牧德國票9B售04  ,0,0,0,0,0,0,0,0,0,9000,0,0,0,9000,0,9000,9000
07946P,華通統一9B售02  ,0,0,0,0,0,0,0,0,0,9000,0,0,0,11000,2000,9000,9000
07520P,臺股指元大9B售11,0,0,0,0,0,0,0,0,0,9000,0,0,0,10000,1000,9000,9000
07630P,臺股指凱基9A售11,0,0,0,0,0,0,0,0,0,9000,0,0,0,106000,97000,9000,9000
07570P,旺宏凱基9A售04  ,0,0,0,0,0,0,0,0,0,9000,0,0,0,10000,1000,9000,9000
07284P,大立光凱基99售10,0,0,0,0,0,0,0,0,0,9000,0,0,0,9000,0,9000,9000
006205,富邦上証        ,9000,10000,-1000,0,0,0,0,0,0,9051,0,0,0,1115051,1106000,9051,8051
062589,友達統一9C購03  ,0,0,0,0,0,0,0,0,0,8000,0,0,0,8000,0,8000,8000
062719,微星凱基9B購01  ,0,0,0,0,0,0,0,0,0,8000,0,0,0,8000,0,8000,8000
061533,友達統一9C購02  ,0,0,0,0,0,0,0,0,0,8000,0,0,0,10000,2000,8000,8000
061409,力成國票9A購02  ,0,0,0,0,0,0,0,0,0,8000,0,0,0,8000,0,8000,8000
061406,華通國票9A購06  ,0,0,0,0,0,0,0,0,0,8000,0,0,0,8000,0,8000,8000
07135P,臺股指元大9A售29,0,0,0,0,0,0,0,0,0,8000,0,0,0,8000,0,8000,8000
063236,旺宏元大9B購07  ,0,0,0,0,0,0,0,0,0,8000,0,0,0,20000,12000,8000,8000
06322P,超眾統一97售04  ,0,0,0,0,0,0,0,0,0,8000,0,0,0,19000,11000,8000,8000
063400,華擎群益9B購03  ,0,0,0,0,0,0,0,0,0,8000,0,0,0,60000,52000,8000,8000
00709,富邦歐洲        ,0,0,0,0,0,0,0,230000,-230000,238000,0,0,0,365000,127000,238000,8000
04137P,元油反國票97售01,0,0,0,0,0,0,0,0,0,8000,0,0,0,8000,0,8000,8000
050256,臺指反元大98購03,0,0,0,0,0,0,0,0,0,8000,0,0,0,8000,0,8000,8000
03433B,臺股指元大9C熊01,0,0,0,0,0,0,0,0,0,8000,0,0,0,8000,0,8000,8000
054470,緯穎國票97購04  ,0,0,0,0,0,0,0,0,0,8000,0,0,0,8000,0,8000,8000
055837,致茂元大97購02  ,0,0,0,0,0,0,0,0,0,8000,0,0,0,8000,0,8000,8000
055953,上銀元大97購09  ,0,0,0,0,0,0,0,0,0,8000,0,0,0,8000,0,8000,8000
053995,奇力新群益97購02,0,0,0,0,0,0,0,0,0,8000,0,0,0,13000,5000,8000,8000
052799,上銀元大96購01  ,0,0,0,0,0,0,0,0,0,8000,0,0,0,8000,0,8000,8000
059899,上証2X元大9C購04,0,0,0,0,0,0,0,0,0,8000,0,0,0,8000,0,8000,8000
056658,美食元大98購01  ,0,0,0,0,0,0,0,0,0,8000,0,0,0,8000,0,8000,8000
056307,貿聯元大97購05  ,0,0,0,0,0,0,0,0,0,8000,0,0,0,68000,60000,8000,8000
057076,緯穎永豐98購01  ,0,0,0,0,0,0,0,0,0,8000,0,0,0,8000,0,8000,8000
056120,聯茂群益97購02  ,0,0,0,0,0,0,0,0,0,8000,0,0,0,8000,0,8000,8000
055304,瑞昱第一98購01  ,0,0,0,0,0,0,0,0,0,8000,0,0,0,8000,0,8000,8000
05551P,電子類元大96售01,0,0,0,0,0,0,0,0,0,8000,0,0,0,8000,0,8000,8000
057789,上銀統一9A購01  ,0,0,0,0,0,0,0,0,0,8000,0,0,0,8000,0,8000,8000
060299,友訊國泰9B購01  ,0,0,0,0,0,0,0,0,0,8000,0,0,0,98000,90000,8000,8000
05954P,旺宏國票97售03  ,0,0,0,0,0,0,0,0,0,8000,0,0,0,22000,14000,8000,8000
060015,國巨康和99購03  ,0,0,0,0,0,0,0,0,0,8000,0,0,0,17000,9000,8000,8000
059519,台郡永豐99購01  ,0,0,0,0,0,0,0,0,0,8000,0,0,0,172000,164000,8000,8000
059709,上証2X元大9C購01,0,0,0,0,0,0,0,0,0,8000,0,0,0,8000,0,8000,8000
058220,世芯國票9A購01  ,0,0,0,0,0,0,0,0,0,8000,0,0,0,12000,4000,8000,8000
058204,世芯凱基9A購01  ,0,0,0,0,0,0,0,0,0,8000,0,0,0,18000,10000,8000,8000
057162,上銀元大98購03  ,0,0,0,0,0,0,0,0,0,8000,0,0,0,8000,0,8000,8000
058015,旺宏凱基99購02  ,0,0,0,0,0,0,0,0,0,8000,0,0,0,8000,0,8000,8000
061242,玉晶光兆豐9B購02,0,0,0,0,0,0,0,0,0,8000,0,0,0,8000,0,8000,8000
061129,文曄永豐9A購01  ,0,0,0,0,0,0,0,0,0,8000,0,0,0,8000,0,8000,8000
058305,華邦電元大99購02,0,0,0,0,0,0,0,0,0,8000,0,0,0,8000,0,8000,8000
058464,矽創兆豐9A購01  ,0,0,0,0,0,0,0,0,0,8000,0,0,0,64000,56000,8000,8000
07424P,大立光元大9B售01,0,0,0,0,0,0,0,0,0,8000,0,0,0,8000,0,8000,8000
07861P,台灣50中信03售08,0,0,0,0,0,0,0,0,0,8000,0,0,0,20000,12000,8000,8000
08117P,聯發科元富9B售04,0,0,0,0,0,0,0,0,0,8000,0,0,0,8000,0,8000,8000
1731,美吾華          ,10000,2000,8000,0,0,0,0,0,0,0,0,0,0,0,0,0,8000
1465,偉全            ,8000,0,8000,0,0,0,0,0,0,0,0,0,0,0,0,0,8000
2706,第一店          ,22000,14000,8000,0,0,0,0,0,0,0,0,0,0,0,0,0,8000
4739,康普            ,24000,14000,10000,0,0,0,0,0,0,-2000,0,0,0,0,2000,-2000,8000
4989,榮科            ,10000,2000,8000,0,0,0,0,0,0,0,0,0,0,0,0,0,8000
063405,聯發科國票9C購03,15000,0,15000,0,0,0,0,0,0,-8000,0,0,0,7000,15000,-8000,7000
063224,泰鼎群益9B購02  ,0,0,0,0,0,0,0,0,0,7000,0,0,0,17000,10000,7000,7000
062767,GIS凱基9B購02   ,0,0,0,0,0,0,0,0,0,7000,0,0,0,12000,5000,7000,7000
07099P,台積電元大99售19,0,0,0,0,0,0,0,0,0,7000,0,0,0,7000,0,7000,7000
06983P,台積電國泰9A售02,0,0,0,0,0,0,0,0,0,7000,0,0,0,68000,61000,7000,7000
06625P,華新科統一98售03,0,0,0,0,0,0,0,0,0,7000,0,0,0,7000,0,7000,7000
061445,道瓊指中信9A購01,0,0,0,0,0,0,0,0,0,7000,0,0,0,7000,0,7000,7000
06147P,國巨元大97售05  ,0,0,0,0,0,0,0,0,0,7000,0,0,0,7000,0,7000,7000
061654,旺宏國票9A購02  ,0,0,0,0,0,0,0,0,0,7000,0,0,0,7000,0,7000,7000
062479,TPK國票9B購01   ,0,0,0,0,0,0,0,0,0,7000,0,0,0,25000,18000,7000,7000
062470,智邦凱基9C購01  ,0,0,0,0,0,0,0,0,0,7000,0,0,0,33000,26000,7000,7000
062107,台光電國票9B購01,0,0,0,0,0,0,0,0,0,7000,0,0,0,52000,45000,7000,7000
062155,國巨凱基9C購03  ,0,0,0,0,0,0,0,0,0,7000,0,0,0,37000,30000,7000,7000
060246,晶相光元大9C購03,0,0,0,0,0,0,0,0,0,7000,0,0,0,17000,10000,7000,7000
052768,泰鼎群益96購01  ,0,0,0,0,0,0,0,0,0,7000,0,0,0,7000,0,7000,7000
055777,冠德凱基97購01  ,0,0,0,0,0,0,0,0,0,7000,0,0,0,59000,52000,7000,7000
054229,超眾元富96購05  ,0,0,0,0,0,0,0,0,0,7000,0,0,0,210000,203000,7000,7000
049004,聯發科中信96購01,0,0,0,0,0,0,0,0,0,7000,0,0,0,7000,0,7000,7000
00700,富邦恒生國企    ,0,0,0,0,0,0,0,0,0,7000,0,0,0,112000,105000,7000,7000
051484,玉晶光凱基97購01,0,0,0,0,0,0,0,0,0,7000,0,0,0,8000,1000,7000,7000
006206,元大上證50      ,1000,207000,-206000,0,0,0,0,0,0,213000,0,0,0,502000,289000,213000,7000
058334,鴻海元富99購05  ,0,0,0,0,0,0,0,0,0,7000,0,0,0,7000,0,7000,7000
059322,晶技元大99購06  ,0,0,0,0,0,0,0,0,0,7000,0,0,0,10000,3000,7000,7000
058932,FBVIX台新99購01 ,0,0,0,0,0,0,0,0,0,7000,0,0,0,10000,3000,7000,7000
058252,臺股指元大9A購16,0,0,0,0,0,0,0,0,0,7000,0,0,0,7000,0,7000,7000
057633,緯穎永豐98購02  ,0,0,0,0,0,0,0,0,0,7000,0,0,0,50000,43000,7000,7000
057611,技嘉元富98購02  ,0,0,0,0,0,0,0,0,0,7000,0,0,0,15000,8000,7000,7000
059728,聯鈞元大99購01  ,0,0,0,0,0,0,0,0,0,7000,0,0,0,61000,54000,7000,7000
059488,大立光兆豐99購03,0,0,0,0,0,0,0,0,0,7000,0,0,0,7000,0,7000,7000
060017,全新康和99購01  ,0,0,0,0,0,0,0,0,0,7000,0,0,0,14000,7000,7000,7000
058555,矽創永豐9A購01  ,0,0,0,0,0,0,0,0,0,7000,0,0,0,208000,201000,7000,7000
059595,華新科元大9A購03,0,0,0,0,0,0,0,0,0,7000,0,0,0,12000,5000,7000,7000
059646,聯茂凱基99購06  ,0,0,0,0,0,0,0,0,0,7000,0,0,0,92000,85000,7000,7000
059544,創意亞東99購01  ,0,0,0,0,0,0,0,0,0,7000,0,0,0,10000,3000,7000,7000
3454,晶睿            ,15000,8000,7000,0,0,0,0,0,0,0,0,0,0,0,0,0,7000
060683,泰鼎元大9A購02  ,0,0,0,0,0,0,0,0,0,7000,0,0,0,7000,0,7000,7000
6464,台數科          ,7000,0,7000,0,0,0,0,0,0,0,0,0,0,0,0,0,7000
06087P,國巨永豐97售01  ,0,0,0,0,0,0,0,0,0,7000,0,0,0,40000,33000,7000,7000
060849,力成國票9A購01  ,0,0,0,0,0,0,0,0,0,7000,0,0,0,7000,0,7000,7000
2705,六福            ,55000,48000,7000,0,0,0,0,0,0,0,0,0,0,0,0,0,7000
2634,漢翔            ,178000,196000,-18000,0,0,0,0,0,0,25000,0,0,0,37000,12000,25000,7000
2488,漢平            ,12000,5000,7000,0,0,0,0,0,0,0,0,0,0,0,0,0,7000
1256,鮮活果汁-KY     ,9000,2000,7000,0,0,0,0,0,0,0,0,0,0,0,0,0,7000
1541,錩泰            ,15000,9000,6000,0,0,0,0,0,0,1000,1000,0,1000,0,0,0,7000
08104P,晶技元大9B售06  ,0,0,0,0,0,0,0,0,0,7000,0,0,0,57000,50000,7000,7000
07537P,玉晶光元富9A售04,0,0,0,0,0,0,0,0,0,7000,0,0,0,7000,0,7000,7000
062153,智邦麥證9B購01  ,0,0,0,23000,37000,-14000,0,0,0,6000,0,0,0,43000,37000,6000,6000
062112,祥碩國票9C購01  ,0,0,0,0,0,0,0,0,0,6000,0,0,0,24000,18000,6000,6000
062303,台表科中信01購01,0,0,0,0,0,0,0,0,0,6000,0,0,0,20000,14000,6000,6000
062270,上銀群益9B購03  ,0,0,0,0,0,0,0,0,0,6000,0,0,0,6000,0,6000,6000
061884,臺股指元大9B購18,0,0,0,0,0,0,0,0,0,6000,0,0,0,10000,4000,6000,6000
06571P,欣興永豐98售03  ,0,0,0,0,0,0,0,0,0,6000,0,0,0,25000,19000,6000,6000
06578P,華新科國票98售02,0,0,0,0,0,0,0,0,0,6000,0,0,0,6000,0,6000,6000
06497P,大立光凱基98售11,0,0,0,0,0,0,0,0,0,6000,0,0,0,6000,0,6000,6000
063507,奇鋐群益9B購02  ,0,0,0,0,0,0,0,0,0,6000,0,0,0,17000,11000,6000,6000
07120P,聯發科凱基99售09,0,0,0,0,0,0,0,0,0,6000,0,0,0,6000,0,6000,6000
07075P,FBVIX凱基9C售04 ,0,0,0,0,0,0,0,0,0,6000,0,0,0,6000,0,6000,6000
06849P,欣興元大98售12  ,0,0,0,0,0,0,0,0,0,6000,0,0,0,14000,8000,6000,6000
063387,台積電兆豐9B購03,0,0,0,0,0,0,0,0,0,6000,0,0,0,57000,51000,6000,6000
00678,群益NBI生技     ,6000,0,6000,0,0,0,0,0,0,0,0,0,0,300000,300000,0,6000
042752,台灣50元大96購03,0,0,0,0,0,0,0,0,0,6000,0,0,0,16000,10000,6000,6000
048273,南電富邦97購01  ,0,0,0,0,0,0,0,0,0,6000,0,0,0,36000,30000,6000,6000
03446B,臺股指元大9B熊26,35000,0,35000,0,0,0,0,0,0,-29000,0,0,0,19000,48000,-29000,6000
03049X,元展46          ,0,0,0,0,0,0,0,0,0,6000,0,0,0,6000,0,6000,6000
052588,玉晶光永豐98購01,0,0,0,0,0,0,0,0,0,6000,0,0,0,6000,0,6000,6000
055814,晶豪科國票97購02,0,0,0,0,0,0,0,0,0,6000,0,0,0,82000,76000,6000,6000
055996,矽力國泰99購01  ,0,0,0,0,0,0,0,0,0,6000,0,0,0,23000,17000,6000,6000
055863,緯穎元大97購05  ,0,0,0,0,0,0,0,0,0,6000,0,0,0,26000,20000,6000,6000
055887,上銀統一97購03  ,0,0,0,0,0,0,0,0,0,6000,0,0,0,180000,174000,6000,6000
055933,欣興群益98購02  ,0,0,0,0,0,0,0,0,0,6000,0,0,0,13000,7000,6000,6000
053994,微星群益96購01  ,0,0,0,0,0,0,0,0,0,6000,0,0,0,6000,0,6000,6000
059873,華新科凱基99購09,0,0,0,0,0,0,0,0,0,6000,0,0,0,6000,0,6000,6000
059980,台積電元大99購50,0,0,0,0,0,0,0,0,0,6000,0,0,0,6000,0,6000,6000
056332,台郡國票99購01  ,0,0,0,0,0,0,0,0,0,6000,0,0,0,16000,10000,6000,6000
055327,致新國票98購01  ,0,0,0,0,0,0,0,0,0,6000,0,0,0,75000,69000,6000,6000
055363,緯穎凱基98購03  ,0,0,0,0,0,0,0,0,0,6000,0,0,0,6000,0,6000,6000
055626,力山永豐97購01  ,0,0,0,0,0,0,0,0,0,6000,0,0,0,310000,304000,6000,6000
056256,聯茂元富97購03  ,0,0,0,0,0,0,0,0,0,6000,0,0,0,6000,0,6000,6000
054974,台表科元大98購02,0,0,0,0,0,0,0,0,0,6000,0,0,0,6000,0,6000,6000
056078,勤誠元大97購01  ,0,0,0,0,0,0,0,0,0,6000,0,0,0,6000,0,6000,6000
05860P,旺宏康和96售01  ,0,0,0,0,0,0,0,0,0,6000,0,0,0,18000,12000,6000,6000
059616,滬深2X群益01購04,0,0,0,0,0,0,0,0,0,6000,0,0,0,6000,0,6000,6000
06038P,國泰金台新96售01,0,0,0,0,0,0,0,0,0,6000,0,0,0,6000,0,6000,6000
060038,台積電國票99購13,0,0,0,0,0,0,0,0,0,6000,0,0,0,7000,1000,6000,6000
058267,奇鋐永豐99購01  ,0,0,0,0,0,0,0,0,0,6000,0,0,0,37000,31000,6000,6000
058282,聯茂中信99購01  ,0,0,0,0,0,0,0,0,0,6000,0,0,0,6000,0,6000,6000
058226,世芯元富99購01  ,0,0,0,0,0,0,0,0,0,6000,0,0,0,6000,0,6000,6000
061045,儒鴻第一9A購01  ,0,0,0,0,0,0,0,0,0,6000,0,0,0,7000,1000,6000,6000
061228,聯茂中信9A購01  ,0,0,0,0,0,0,0,0,0,6000,0,0,0,6000,0,6000,6000
061371,嘉澤國泰9C購01  ,0,0,0,0,0,0,0,0,0,6000,0,0,0,6000,0,6000,6000
059360,全新永豐99購02  ,0,0,0,0,0,0,0,0,0,6000,0,0,0,11000,5000,6000,6000
07238P,台灣50國票99售07,0,0,0,0,0,0,0,0,0,6000,0,0,0,6000,0,6000,6000
07183P,臺股指凱基99售25,0,0,0,0,0,0,0,0,0,6000,0,0,0,6000,0,6000,6000
07710P,華擎元大9A售05  ,0,0,0,0,0,0,0,0,0,6000,0,0,0,6000,0,6000,6000
060840,可成國票9B購01  ,0,0,0,0,0,0,0,0,0,6000,0,0,0,13000,7000,6000,6000
060699,華新科國泰9B購03,0,0,0,0,0,0,0,0,0,6000,0,0,0,31000,25000,6000,6000
060991,京鼎元大9A購01  ,0,0,0,0,0,0,0,0,0,6000,0,0,0,8000,2000,6000,6000
6449,鈺邦            ,2000,0,2000,0,0,0,0,0,0,4000,5000,1000,4000,0,0,0,6000
9136,巨騰-DR         ,152000,146000,6000,0,0,0,0,0,0,0,0,0,0,0,0,0,6000
063411,和潤國票9C購01  ,0,0,0,0,0,0,0,0,0,5000,0,0,0,53000,48000,5000,5000
063263,高鐵永豐9B購01  ,0,0,0,0,0,0,0,0,0,5000,0,0,0,10000,5000,5000,5000
06878P,台灣50日盛9B售01,0,0,0,0,0,0,0,0,0,5000,0,0,0,80000,75000,5000,5000
06924P,台積電群益98售07,0,0,0,0,0,0,0,0,0,5000,0,0,0,5000,0,5000,5000
07083P,台積電統一9A售06,0,0,0,0,0,0,0,0,0,5000,0,0,0,5000,0,5000,5000
07104P,聯發科元富99售04,0,0,0,0,0,0,0,0,0,5000,0,0,0,5000,0,5000,5000
07133P,臺股指元大9A售27,0,0,0,0,0,0,0,0,0,5000,0,0,0,15000,10000,5000,5000
07142P,台灣50元大01售01,0,0,0,0,0,0,0,0,0,5000,0,0,0,5000,0,5000,5000
07009P,臺股指中信9B售01,0,0,0,0,0,0,0,0,0,5000,0,0,0,25000,20000,5000,5000
07048P,台積電中信03售01,0,0,0,0,0,0,0,0,0,5000,0,0,0,15000,10000,5000,5000
06986P,台積電台新9A售01,0,0,0,0,0,0,0,0,0,5000,0,0,0,15000,10000,5000,5000
06941P,國巨統一98售07  ,0,0,0,0,0,0,0,0,0,5000,0,0,0,5000,0,5000,5000
063504,國巨群益9C購06  ,0,0,0,0,0,0,0,0,0,5000,0,0,0,5000,0,5000,5000
06428P,國巨元大97售17  ,0,0,0,0,0,0,0,0,0,5000,0,0,0,5000,0,5000,5000
06549P,大立光元大98售11,0,0,0,0,0,0,0,0,0,5000,0,0,0,20000,15000,5000,5000
06630P,國巨群益98售08  ,0,0,0,0,0,0,0,0,0,5000,0,0,0,5000,0,5000,5000
061930,臺股指凱基9B購05,0,0,0,0,0,0,0,0,0,5000,0,0,0,10000,5000,5000,5000
061923,友達凱基9B購04  ,0,0,0,0,0,0,0,0,0,5000,0,0,0,143000,138000,5000,5000
062069,喬山元大9B購01  ,0,0,0,0,0,0,0,0,0,5000,0,0,0,115000,110000,5000,5000
062005,旺宏國泰01購01  ,0,0,0,0,0,0,0,0,0,5000,0,0,0,5000,0,5000,5000
06162P,大立光群益97售02,0,0,0,0,0,0,0,0,0,5000,0,0,0,75000,70000,5000,5000
062100,矽格永豐9B購01  ,0,0,0,0,0,0,0,0,0,5000,0,0,0,5000,0,5000,5000
062145,億光國票9B購01  ,0,0,0,0,0,0,0,0,0,5000,0,0,0,15000,10000,5000,5000
062147,大毅國票9B購02  ,0,0,0,0,0,0,0,0,0,5000,0,0,0,16000,11000,5000,5000
062452,A50正2群益01購04,0,0,0,0,0,0,0,0,0,5000,0,0,0,15000,10000,5000,5000
062600,可成台新9B購01  ,0,0,0,0,0,0,0,0,0,5000,0,0,0,5000,0,5000,5000
062632,嘉晶國票9B購01  ,0,0,0,0,0,0,0,0,0,5000,0,0,0,6000,1000,5000,5000
054893,帆宣統一99購01  ,0,0,0,0,0,0,0,0,0,5000,0,0,0,40000,35000,5000,5000
055144,T50反1元大97購03,0,0,0,0,0,0,0,0,0,5000,0,0,0,5000,0,5000,5000
055209,勤誠康和97購01  ,0,0,0,0,0,0,0,0,0,5000,0,0,0,5000,0,5000,5000
055387,世紀鋼元大97購01,0,0,0,0,0,0,0,0,0,5000,0,0,0,5000,0,5000,5000
056309,合勤控元大97購01,0,0,0,0,0,0,0,0,0,5000,0,0,0,228000,223000,5000,5000
05677P,玉晶光群益98售03,0,0,0,0,0,0,0,0,0,5000,0,0,0,6000,1000,5000,5000
059964,元金2X凱基99購02,0,0,0,0,0,0,0,0,0,5000,0,0,0,5000,0,5000,5000
060095,聯發科元大99購42,0,0,0,0,0,0,0,0,0,5000,0,0,0,5000,0,5000,5000
056395,玉晶光永豐9B購01,0,0,0,0,0,0,0,0,0,5000,0,0,0,5000,0,5000,5000
053671,可成統一96購03  ,0,0,0,0,0,0,0,0,0,5000,0,0,0,5000,0,5000,5000
053472,漢唐元大96購02  ,0,0,0,0,0,0,0,0,0,5000,0,0,0,5000,0,5000,5000
056901,華新科元大98購03,0,0,0,0,0,0,0,0,0,5000,0,0,0,5000,0,5000,5000
056915,上銀兆豐99購01  ,0,0,0,0,0,0,0,0,0,5000,0,0,0,5000,0,5000,5000
056930,晶豪科台新98購01,0,0,0,0,0,0,0,0,0,5000,0,0,0,21000,16000,5000,5000
055788,緯穎凱基97購04  ,0,0,0,0,0,0,0,0,0,5000,0,0,0,53000,48000,5000,5000
053176,矽力群益96購02  ,0,0,0,0,0,0,0,0,0,5000,0,0,0,5000,0,5000,5000
052670,茂林群益96購02  ,0,0,0,0,0,0,0,0,0,5000,0,0,0,5000,0,5000,5000
05271P,國巨富邦97售01  ,0,0,0,0,0,0,0,0,0,5000,0,0,0,5000,0,5000,5000
052417,聯發科兆豐9B購01,0,0,0,0,0,0,0,0,0,5000,0,0,0,5000,0,5000,5000
054211,奇鋐國票97購03  ,0,0,0,0,0,0,0,0,0,5000,0,0,0,43000,38000,5000,5000
048189,臺指反元大96購06,0,0,0,0,0,0,0,0,0,5000,0,0,0,5000,0,5000,5000
04980P,臺股指凱基96售08,0,0,0,0,0,0,0,0,0,5000,0,0,0,5000,0,5000,5000
049670,鈺齊國泰96購01  ,0,0,0,0,0,0,0,0,0,5000,0,0,0,5000,0,5000,5000
04286P,滬深2X中信96售01,0,0,0,0,0,0,0,0,0,5000,0,0,0,5000,0,5000,5000
052049,緯創凱基97購01  ,0,0,0,0,0,0,0,0,0,5000,0,0,0,5000,0,5000,5000
051813,GIS凱基96購02   ,0,0,0,0,0,0,0,0,0,5000,0,0,0,5000,0,5000,5000
051737,瑞昱國票96購01  ,0,0,0,0,0,0,0,0,0,5000,0,0,0,5000,0,5000,5000
051488,健策凱基96購04  ,0,0,0,0,0,0,0,0,0,5000,0,0,0,5000,0,5000,5000
051659,力山國泰97購01  ,0,0,0,0,0,0,0,0,0,5000,0,0,0,5000,0,5000,5000
051449,玉晶光元大96購01,0,0,0,0,0,0,0,0,0,5000,0,0,0,5000,0,5000,5000
00743,國泰中國A150    ,2000,0,2000,0,0,0,0,0,0,3000,0,0,0,6000,3000,3000,5000
059145,創意國票99購02  ,0,0,0,0,0,0,0,0,0,5000,0,0,0,10000,5000,5000,5000
059019,元石油統一9B購03,0,0,0,0,0,0,0,0,0,5000,0,0,0,5000,0,5000,5000
057954,宏碁元大99購01  ,0,0,0,0,0,0,0,0,0,5000,0,0,0,5000,0,5000,5000
058345,台光電群益99購03,0,0,0,0,0,0,0,0,0,5000,0,0,0,15000,10000,5000,5000
058115,台光電中信99購01,0,0,0,0,0,0,0,0,0,5000,0,0,0,5000,0,5000,5000
059129,麗豐中信99購01  ,0,0,0,0,0,0,0,0,0,5000,0,0,0,25000,20000,5000,5000
058795,可成元大99購03  ,0,0,0,0,0,0,0,0,0,5000,0,0,0,5000,0,5000,5000
061262,智邦凱基9A購02  ,0,0,0,0,0,0,0,0,0,5000,0,0,0,30000,25000,5000,5000
061118,GIS富邦9A購01   ,0,0,0,0,0,0,0,0,0,5000,0,0,0,5000,0,5000,5000
058984,全新凱基9A購03  ,0,0,0,0,0,0,0,0,0,5000,0,0,0,20000,15000,5000,5000
07806P,健策永豐9A售02  ,0,0,0,0,0,0,0,0,0,5000,0,0,0,5000,0,5000,5000
058098,T50反1國泰9A購02,0,0,0,0,0,0,0,0,0,5000,0,0,0,5000,0,5000,5000
058217,新唐群益99購01  ,0,0,0,0,0,0,0,0,0,5000,0,0,0,15000,10000,5000,5000
058269,世芯永豐9A購01  ,0,0,0,0,0,0,0,0,0,5000,0,0,0,18000,13000,5000,5000
058702,國巨元大99購16  ,0,0,0,0,0,0,0,0,0,5000,0,0,0,15000,10000,5000,5000
057241,超眾凱基99購02  ,0,0,0,0,0,0,0,0,0,5000,0,0,0,30000,25000,5000,5000
060498,華通元大9A購03  ,0,0,0,0,0,0,0,0,0,5000,0,0,0,35000,30000,5000,5000
060040,康控國票99購04  ,0,0,0,0,0,0,0,0,0,5000,0,0,0,22000,17000,5000,5000
05951P,台積電國票97售05,0,0,0,0,0,0,0,0,0,5000,0,0,0,13000,8000,5000,5000
059455,玉晶光永豐99購05,0,0,0,0,0,0,0,0,0,5000,0,0,0,7000,2000,5000,5000
05778P,台積電統一96售05,0,0,0,0,0,0,0,0,0,5000,0,0,0,5000,0,5000,5000
057795,鴻海兆豐99購02  ,0,0,0,0,0,0,0,0,0,5000,0,0,0,5000,0,5000,5000
060174,T50反1元富04購01,0,0,0,0,0,0,0,0,0,5000,0,0,0,5000,0,5000,5000
6451,訊芯-KY         ,89000,81000,8000,0,0,0,0,0,0,-3000,1000,1000,0,3000,6000,-3000,5000
060663,聯發科凱基9A購13,0,0,0,0,0,0,0,0,0,5000,0,0,0,10000,5000,5000,5000
3346,麗清            ,11000,6000,5000,0,0,0,0,0,0,0,0,0,0,0,0,0,5000
3694,海華            ,9000,4000,5000,0,0,0,0,0,0,0,0,0,0,0,0,0,5000
3701,大眾控          ,7000,2000,5000,0,0,0,0,0,0,0,0,0,0,0,0,0,5000
060885,世紀鋼中信9A購01,0,0,0,0,0,0,0,0,0,5000,0,0,0,20000,15000,5000,5000
060904,臺指反元大9C購07,0,0,0,0,0,0,0,0,0,5000,0,0,0,5000,0,5000,5000
060724,台灣50第一9A購02,0,0,0,0,0,0,0,0,0,5000,0,0,0,5000,0,5000,5000
060765,世芯元大9A購01  ,0,0,0,0,0,0,0,0,0,5000,0,0,0,5000,0,5000,5000
060825,聯詠元大9A購05  ,0,0,0,0,0,0,0,0,0,5000,0,0,0,105000,100000,5000,5000
06078P,臺股指凱基9A售01,0,0,0,0,0,0,0,0,0,5000,0,0,0,5000,0,5000,5000
07712P,茂林元大9A售03  ,0,0,0,0,0,0,0,0,0,5000,0,0,0,5000,0,5000,5000
07901P,臺股指凱基9B售04,0,0,0,0,0,0,0,0,0,5000,0,0,0,155000,150000,5000,5000
07921P,鴻海群益9B售04  ,0,0,0,0,0,0,0,0,0,5000,0,0,0,5000,0,5000,5000
08078P,聯發科國票9B售04,0,0,0,0,0,0,0,0,0,5000,0,0,0,5000,0,5000,5000
07995P,臺股指麥證9C售01,0,0,0,6000,1000,5000,0,0,0,5000,0,0,0,6000,1000,5000,5000
07201P,臺股指元大99售17,0,0,0,0,0,0,0,0,0,5000,0,0,0,18000,13000,5000,5000
07226P,貿聯富邦9B售01  ,0,0,0,0,0,0,0,0,0,5000,0,0,0,5000,0,5000,5000
07247P,聯發科凱基9A售06,0,0,0,0,0,0,0,0,0,5000,0,0,0,231000,226000,5000,5000
07275P,FBVIX群益99售02 ,0,0,0,0,0,0,0,0,0,5000,0,0,0,5000,0,5000,5000
07386P,臺股指群益99售24,0,0,0,0,0,0,0,0,0,5000,0,0,0,5000,0,5000,5000
07433P,臺股指國票9A售05,0,0,0,0,0,0,0,0,0,5000,0,0,0,5000,0,5000,5000
07668P,旺宏元大9A售10  ,0,0,0,0,0,0,0,0,0,5000,0,0,0,25000,20000,5000,5000
07641P,上銀凱基9A售05  ,0,0,0,0,0,0,0,0,0,5000,0,0,0,15000,10000,5000,5000
07642P,華通凱基9A售05  ,0,0,0,0,0,0,0,0,0,5000,0,0,0,5000,0,5000,5000
2038,海光            ,0,5000,-5000,0,0,0,0,0,0,10000,10000,0,10000,0,0,0,5000
2486,一詮            ,8000,3000,5000,0,0,0,0,0,0,0,0,0,0,0,0,0,5000
2897A,王道銀甲特      ,0,0,0,0,0,0,0,0,0,5000,5000,0,5000,0,0,0,5000
062637,智易國票9B購01  ,0,0,0,0,0,0,0,0,0,4000,0,0,0,42000,38000,4000,4000
062695,華通元大9C購01  ,0,0,0,0,0,0,0,0,0,4000,0,0,0,75000,71000,4000,4000
062186,晶技元大9B購05  ,0,0,0,0,0,0,0,0,0,4000,0,0,0,46000,42000,4000,4000
062283,玉晶光群益01購01,0,0,0,0,0,0,0,0,0,4000,0,0,0,8000,4000,4000,4000
062375,祥碩元大9B購03  ,0,0,0,0,0,0,0,0,0,4000,0,0,0,15000,11000,4000,4000
061624,中租群益9A購01  ,0,0,0,0,0,0,0,0,0,4000,0,0,0,27000,23000,4000,4000
061716,瑞儀凱基9B購01  ,0,0,0,0,0,0,0,0,0,4000,0,0,0,34000,30000,4000,4000
061889,祥碩富邦9B購01  ,0,0,0,0,0,0,0,0,0,4000,0,0,0,5000,1000,4000,4000
061858,南電國票9B購02  ,0,0,0,0,0,0,0,0,0,4000,0,0,0,4000,0,4000,4000
06631P,玉晶光群益9A售03,0,0,0,0,0,0,0,0,0,4000,0,0,0,8000,4000,4000,4000
06617P,智邦元大98售03  ,0,0,0,0,0,0,0,0,0,4000,0,0,0,4000,0,4000,4000
06546P,聯發科元大98售05,0,0,0,0,0,0,0,0,0,4000,0,0,0,4000,0,4000,4000
06589P,台積電元大98售12,0,0,0,0,0,0,0,0,0,4000,0,0,0,4000,0,4000,4000
07049P,聯發科中信99售03,0,0,0,0,0,0,0,0,0,4000,0,0,0,5000,1000,4000,4000
07044P,台積電元大99售13,0,0,0,0,0,0,0,0,0,4000,0,0,0,4000,0,4000,4000
06327P,台積電中信01售01,0,0,0,0,0,0,0,0,0,4000,0,0,0,1112000,1108000,4000,4000
062779,台積電元大9B購03,0,0,0,0,0,0,0,0,0,4000,0,0,0,19000,15000,4000,4000
06277P,臺股指凱基97售09,0,0,0,0,0,0,0,0,0,4000,0,0,0,6000,2000,4000,4000
062842,臺股指群益9B購09,0,0,0,0,0,0,0,0,0,4000,0,0,0,20000,16000,4000,4000
062860,華擎國票9B購02  ,0,0,0,0,0,0,0,0,0,4000,0,0,0,11000,7000,4000,4000
051382,玉晶光群益98購02,0,0,0,0,0,0,0,0,0,4000,0,0,0,4000,0,4000,4000
00690,兆豐藍籌30      ,0,0,0,0,0,0,0,0,0,4000,0,0,0,183000,179000,4000,4000
00661,元大日經225     ,0,0,0,0,0,0,0,0,0,4000,0,0,0,4000,0,4000,4000
047418,智邦富邦97購01  ,0,0,0,0,0,0,0,0,0,4000,0,0,0,4000,0,4000,4000
052378,矽力元大96購01  ,0,0,0,0,0,0,0,0,0,4000,0,0,0,4000,0,4000,4000
056927,T50反1台新02購01,0,0,0,0,0,0,0,0,0,4000,0,0,0,4000,0,4000,4000
05588P,群創兆豐97售02  ,0,0,0,0,0,0,0,0,0,4000,0,0,0,10000,6000,4000,4000
052920,景碩台新96購02  ,0,0,0,0,0,0,0,0,0,4000,0,0,0,4000,0,4000,4000
059783,旺宏元大99購17  ,0,0,0,0,0,0,0,0,0,4000,0,0,0,5000,1000,4000,4000
05993P,國巨元大96售13  ,0,0,0,0,0,0,0,0,0,4000,0,0,0,4000,0,4000,4000
056473,奇力新元大99購02,0,0,0,0,0,0,0,0,0,4000,0,0,0,4000,0,4000,4000
056555,矽創凱基98購01  ,0,0,0,0,0,0,0,0,0,4000,0,0,0,10000,6000,4000,4000
055380,智易元大98購02  ,0,0,0,0,0,0,0,0,0,4000,0,0,0,72000,68000,4000,4000
05502P,台表科國票97售01,0,0,0,0,0,0,0,0,0,4000,0,0,0,4000,0,4000,4000
056986,超眾群益98購03  ,0,0,0,0,0,0,0,0,0,4000,0,0,0,68000,64000,4000,4000
057804,為升元大98購01  ,0,0,0,0,0,0,0,0,0,4000,0,0,0,169000,165000,4000,4000
057835,華擎元富9B購01  ,0,0,0,0,0,0,0,0,0,4000,0,0,0,132000,128000,4000,4000
059540,新光金日盛99購01,0,0,0,0,0,0,0,0,0,4000,0,0,0,4000,0,4000,4000
059672,滬深2X元富99購06,0,0,0,0,0,0,0,0,0,4000,0,0,0,4000,0,4000,4000
057478,智邦元大99購01  ,0,0,0,0,0,0,0,0,0,4000,0,0,0,4000,0,4000,4000
057618,台光電凱基99購01,0,0,0,0,0,0,0,0,0,4000,0,0,0,4000,0,4000,4000
057648,和碩元大98購01  ,0,0,0,0,0,0,0,0,0,4000,0,0,0,4000,0,4000,4000
057908,國泰金亞東99購01,0,0,0,0,0,0,0,0,0,4000,0,0,0,4000,0,4000,4000
057298,旭富永豐98購01  ,0,0,0,0,0,0,0,0,0,4000,0,0,0,144000,140000,4000,4000
05790P,臺股指永昌96售07,0,0,0,0,0,0,0,0,0,4000,0,0,0,14000,10000,4000,4000
058232,聯發科元大99購05,0,0,0,0,0,0,0,0,0,4000,0,0,0,4000,0,4000,4000
058080,台積電群益98購06,0,0,0,0,0,0,0,0,0,4000,0,0,0,13000,9000,4000,4000
058053,上銀統一9B購01  ,0,0,0,0,0,0,0,0,0,4000,0,0,0,55000,51000,4000,4000
07830P,牧德凱基9A售03  ,0,0,0,0,0,0,0,0,0,4000,0,0,0,4000,0,4000,4000
061243,麗豐兆豐9A購01  ,0,0,0,0,0,0,0,0,0,4000,0,0,0,7000,3000,4000,4000
06119P,大立光凱基98售04,0,0,0,0,0,0,0,0,0,4000,0,0,0,4000,0,4000,4000
061345,玉晶光元大9A購14,0,0,0,0,0,0,0,0,0,4000,0,0,0,9000,5000,4000,4000
2302,麗正            ,4000,0,4000,0,0,0,0,0,0,0,0,0,0,0,0,0,4000
07612P,國巨國泰9B售06  ,0,0,0,0,0,0,0,0,0,4000,0,0,0,14000,10000,4000,4000
07213P,聯發科凱基99售15,0,0,0,0,0,0,0,0,0,4000,0,0,0,4000,0,4000,4000
07172P,臺股指國票99售09,0,0,0,0,0,0,0,0,0,4000,0,0,0,81000,77000,4000,4000
060828,高股息國票9A購01,0,0,0,0,0,0,0,0,0,4000,0,0,0,4000,0,4000,4000
060886,國巨統一01購03  ,0,0,0,0,0,0,0,0,0,4000,0,0,0,15000,11000,4000,4000
8411,福貞-KY         ,0,0,0,0,0,0,0,0,0,4000,4000,0,4000,0,0,0,4000
4764,雙鍵            ,5000,1000,4000,0,0,0,0,0,0,0,0,0,0,0,0,0,4000
6142,友勁            ,7000,10000,-3000,0,0,0,0,0,0,7000,7000,0,7000,0,0,0,4000
9105,泰金寶-DR       ,9000,5000,4000,0,0,0,0,0,0,0,0,0,0,0,0,0,4000
063081,技嘉凱基9B購02  ,0,0,0,0,0,0,0,0,0,3000,0,0,0,3000,0,3000,3000
063036,聯發科凱基9B購11,0,0,0,0,0,0,0,0,0,3000,0,0,0,3000,0,3000,3000
063293,億豐元大9B購01  ,0,0,0,0,0,0,0,0,0,3000,0,0,0,3000,0,3000,3000
063429,南電凱基01購01  ,0,0,0,0,0,0,0,0,0,3000,0,0,0,3000,0,3000,3000
063371,南亞科永豐9B購01,0,0,0,0,0,0,0,0,0,3000,0,0,0,3000,0,3000,3000
063367,GIS富邦9B購01   ,0,0,0,0,0,0,0,0,0,3000,0,0,0,91000,88000,3000,3000
063232,裕隆元大9B購01  ,0,0,0,0,0,0,0,0,0,3000,0,0,0,63000,60000,3000,3000
063152,健策元富9C購01  ,0,0,0,0,0,0,0,0,0,3000,0,0,0,107000,104000,3000,3000
06824P,台灣50國票99售02,0,0,0,0,0,0,0,0,0,3000,0,0,0,24000,21000,3000,3000
06753P,智邦富邦98售03  ,0,0,0,0,0,0,0,0,0,3000,0,0,0,3000,0,3000,3000
06657P,寶成元大98售01  ,0,0,0,0,0,0,0,0,0,3000,0,0,0,12000,9000,3000,3000
06431P,新日興元大97售05,0,0,0,0,0,0,0,0,0,3000,0,0,0,60000,57000,3000,3000
06449P,台積電元大98售09,0,0,0,0,0,0,0,0,0,3000,0,0,0,3000,0,3000,3000
061454,國巨凱基9A購16  ,0,0,0,0,0,0,0,0,0,3000,0,0,0,3000,0,3000,3000
062370,華擎元大9B購01  ,0,0,0,0,0,0,0,0,0,3000,0,0,0,3000,0,3000,3000
062291,力成富邦9B購01  ,0,0,0,0,0,0,0,0,0,3000,0,0,0,3000,0,3000,3000
062272,鴻海群益9B購05  ,0,0,0,0,0,0,0,0,0,3000,0,0,0,13000,10000,3000,3000
062621,緯穎元大9B購05  ,0,0,0,0,0,0,0,0,0,3000,0,0,0,3000,0,3000,3000
054923,晶技凱基98購01  ,0,0,0,0,0,0,0,0,0,3000,0,0,0,3000,0,3000,3000
056447,聯發科凱基98購09,0,0,0,0,0,0,0,0,0,3000,0,0,0,3000,0,3000,3000
056296,旺宏元大97購07  ,0,0,0,0,0,0,0,0,0,3000,0,0,0,68000,65000,3000,3000
056312,茂林元大98購01  ,0,0,0,0,0,0,0,0,0,3000,0,0,0,3000,0,3000,3000
05990P,台積電群益96售13,0,0,0,0,0,0,0,0,0,3000,0,0,0,252000,249000,3000,3000
059766,同欣電永豐99購03,0,0,0,0,0,0,0,0,0,3000,0,0,0,37000,34000,3000,3000
053661,嘉澤凱基97購01  ,0,0,0,0,0,0,0,0,0,3000,0,0,0,3000,0,3000,3000
053893,京鼎群益97購02  ,0,0,0,0,0,0,0,0,0,3000,0,0,0,3000,0,3000,3000
053942,超眾國泰96購02  ,0,0,0,0,0,0,0,0,0,3000,0,0,0,3000,0,3000,3000
052782,超眾國票96購02  ,0,0,0,0,0,0,0,0,0,3000,0,0,0,3000,0,3000,3000
054589,聯鈞國泰99購01  ,0,0,0,0,0,0,0,0,0,3000,0,0,0,3000,0,3000,3000
054638,國泰金中信99購01,0,0,0,0,0,0,0,0,0,3000,0,0,0,3000,0,3000,3000
05585P,臺股指凱基96售14,0,0,0,0,0,0,0,0,0,3000,0,0,0,3000,0,3000,3000
053064,國巨群益96購04  ,0,0,0,0,0,0,0,0,0,3000,0,0,0,3000,0,3000,3000
054308,嘉晶凱基98購01  ,0,0,0,0,0,0,0,0,0,3000,0,0,0,5000,2000,3000,3000
052353,高鐵群益97購01  ,0,0,0,0,0,0,0,0,0,3000,0,0,0,4000,1000,3000,3000
054268,健策第一96購01  ,0,0,0,0,0,0,0,0,0,3000,0,0,0,3000,0,3000,3000
054361,技嘉凱基96購01  ,0,0,0,0,0,0,0,0,0,3000,0,0,0,6000,3000,3000,3000
051101,台表科元大96購02,0,0,0,0,0,0,0,0,0,3000,0,0,0,3000,0,3000,3000
047689,瑞昱富邦97購01  ,0,0,0,0,0,0,0,0,0,3000,0,0,0,3000,0,3000,3000
047196,上銀統一97購01  ,0,0,0,0,0,0,0,0,0,3000,0,0,0,10000,7000,3000,3000
006203,元大MSCI台灣    ,2000,0,2000,0,0,0,0,0,0,1000,0,0,0,8000,7000,1000,3000
006204,永豐臺灣加權    ,0,0,0,0,0,0,0,0,0,3000,0,0,0,25000,22000,3000,3000
00736,國泰新興市場    ,0,17000,-17000,0,0,0,0,0,0,20000,0,0,0,194000,174000,20000,3000
061255,道瓊反凱基9C購01,0,0,0,0,0,0,0,0,0,3000,0,0,0,5000,2000,3000,3000
061115,電子類元大9A購02,0,0,0,0,0,0,0,0,0,3000,0,0,0,3000,0,3000,3000
061095,台積電台新9B購03,0,0,0,0,0,0,0,0,0,3000,0,0,0,140000,137000,3000,3000
061024,南電國泰9B購01  ,0,0,0,0,0,0,0,0,0,3000,0,0,0,21000,18000,3000,3000
07852P,臺股指國票9A售13,0,0,0,0,0,0,0,0,0,3000,0,0,0,6000,3000,3000,3000
07846P,台灣50群益9A售17,0,0,0,0,0,0,0,0,0,3000,0,0,0,3000,0,3000,3000
058014,上銀凱基99購02  ,0,0,0,0,0,0,0,0,0,3000,0,0,0,3000,0,3000,3000
057178,可成元大98購03  ,0,0,0,0,0,0,0,0,0,3000,0,0,0,3000,0,3000,3000
058433,台積電統一9B購04,0,0,0,0,0,0,0,0,0,3000,0,0,0,3000,0,3000,3000
05842P,台積電元大96售15,0,0,0,0,0,0,0,0,0,3000,0,0,0,3000,0,3000,3000
057964,緯穎元大99購03  ,0,0,0,0,0,0,0,0,0,3000,0,0,0,8000,5000,3000,3000
058836,FBVIX中信03購05 ,0,0,0,0,0,0,0,0,0,3000,0,0,0,56000,53000,3000,3000
05899P,臺股指凱基96售30,0,0,0,0,0,0,0,0,0,3000,0,0,0,5000,2000,3000,3000
058997,鴻海元大99購21  ,0,0,0,0,0,0,0,0,0,3000,0,0,0,13000,10000,3000,3000
059308,T50反1元大99購07,0,0,0,0,0,0,0,0,0,3000,0,0,0,10000,7000,3000,3000
057923,晶豪科凱基98購02,0,0,0,0,0,0,0,0,0,3000,0,0,0,23000,20000,3000,3000
060482,東元富邦9A購01  ,0,0,0,0,0,0,0,0,0,3000,0,0,0,3000,0,3000,3000
060551,大立光凱基9B購02,0,0,0,0,0,0,0,0,0,3000,0,0,0,7000,4000,3000,3000
05862P,大立光國泰98售01,0,0,0,0,0,0,0,0,0,3000,0,0,0,3000,0,3000,3000
9926,新海            ,3000,0,3000,0,0,0,0,0,0,0,0,0,0,0,0,0,3000
6405,悅城            ,2000,0,2000,0,0,0,0,0,0,1000,1000,0,1000,0,0,0,3000
6183,關貿            ,5000,2000,3000,0,0,0,0,0,0,0,0,0,0,0,0,0,3000
5258,虹堡            ,2000,3000,-1000,0,0,0,0,0,0,4000,4000,0,4000,0,0,0,3000
4144,康聯-KY         ,10000,32000,-22000,0,0,0,0,0,0,25000,25000,0,25000,0,0,0,3000
3622,洋華            ,20000,17000,3000,0,0,0,0,0,0,0,0,0,0,0,0,0,3000
07264P,台積電元大99售38,0,0,0,0,0,0,0,0,0,3000,0,0,0,102000,99000,3000,3000
07986P,大成鋼統一9B售02,0,0,0,0,0,0,0,0,0,3000,0,0,0,3000,0,3000,3000
1540,喬福            ,3000,0,3000,0,0,0,0,0,0,0,0,0,0,0,0,0,3000
1615,大山            ,7000,4000,3000,0,0,0,0,0,0,0,0,0,0,0,0,0,3000
1312A,國喬特          ,0,0,0,0,0,0,0,0,0,3000,3000,0,3000,0,0,0,3000
1446,宏和            ,5000,2000,3000,0,0,0,0,0,0,0,0,0,0,0,0,0,3000
3055,蔚華科          ,5000,2000,3000,0,0,0,0,0,0,0,0,0,0,0,0,0,3000
062659,台灣50群益9B購10,0,0,0,0,0,0,0,0,0,2000,0,0,0,2000,0,2000,2000
062673,台新金中信03購01,0,0,0,0,0,0,0,0,0,2000,0,0,0,52000,50000,2000,2000
062363,燿華元大9B購03  ,0,0,0,0,0,0,0,0,0,2000,0,0,0,5000,3000,2000,2000
062128,祥碩統一01購01  ,0,0,0,0,0,0,0,0,0,2000,0,0,0,35000,33000,2000,2000
06167P,欣興國票97售05  ,0,0,0,0,0,0,0,0,0,2000,0,0,0,2000,0,2000,2000
061833,華新科凱基02購01,0,0,0,0,0,0,0,0,0,2000,0,0,0,2000,0,2000,2000
061730,旺宏統一01購02  ,0,0,0,0,0,0,0,0,0,2000,0,0,0,2000,0,2000,2000
06175P,台積電元大97售21,0,0,0,0,0,0,0,0,0,2000,0,0,0,2000,0,2000,2000
061801,祥碩永豐9B購01  ,0,0,0,0,0,0,0,0,0,2000,0,0,0,14000,12000,2000,2000
062022,緯穎永豐9B購01  ,0,0,0,0,0,0,0,0,0,2000,0,0,0,2000,0,2000,2000
06408P,聯茂元富97售02  ,0,0,0,0,0,0,0,0,0,2000,0,0,0,2000,0,2000,2000
063581,同欣電國泰9C購01,0,0,0,0,0,0,0,0,0,2000,0,0,0,42000,40000,2000,2000
06970P,旺宏元大99售08  ,0,0,0,0,0,0,0,0,0,2000,0,0,0,2000,0,2000,2000
063141,聯發科統一9C購10,0,0,0,0,0,0,0,0,0,2000,0,0,0,2000,0,2000,2000
063290,GIS元大9B購02   ,0,0,0,0,0,0,0,0,0,2000,0,0,0,240000,238000,2000,2000
06307P,聚陽元富97售02  ,0,0,0,0,0,0,0,0,0,2000,0,0,0,2000,0,2000,2000
063017,台光電元大9B購07,0,0,0,0,0,0,0,0,0,2000,0,0,0,2000,0,2000,2000
062988,儒鴻群益9B購01  ,0,0,0,0,0,0,0,0,0,2000,0,0,0,23000,21000,2000,2000
00866,新光Shiller CAPE,0,0,0,0,0,0,0,0,0,2000,0,0,0,31000,29000,2000,2000
0055,元大MSCI金融    ,0,0,0,0,0,0,0,0,0,2000,0,0,0,2000,0,2000,2000
00680L,元大美債20正2   ,20000,7000,13000,0,0,0,0,0,0,-11000,0,0,0,0,11000,-11000,2000
04427P,滬深2X元大97售02,0,0,0,0,0,0,0,0,0,2000,0,0,0,2000,0,2000,2000
052135,聯發科凱基9B購01,0,0,0,0,0,0,0,0,0,2000,0,0,0,2000,0,2000,2000
051749,矽力國泰97購01  ,0,0,0,0,0,0,0,0,0,2000,0,0,0,2000,0,2000,2000
051946,健策統一98購01  ,0,0,0,0,0,0,0,0,0,2000,0,0,0,4000,2000,2000,2000
054210,台光電國票97購03,0,0,0,0,0,0,0,0,0,2000,0,0,0,2000,0,2000,2000
050797,聯發科中信99購01,0,0,0,0,0,0,0,0,0,2000,0,0,0,2000,0,2000,2000
050813,旺宏凱基96購01  ,0,0,0,0,0,0,0,0,0,2000,0,0,0,2000,0,2000,2000
049947,S&P反1中信97購01,0,0,0,0,0,0,0,0,0,2000,0,0,0,2000,0,2000,2000
052342,茂林凱基96購01  ,0,0,0,0,0,0,0,0,0,2000,0,0,0,2000,0,2000,2000
053073,技嘉康和96購01  ,0,0,0,0,0,0,0,0,0,2000,0,0,0,2000,0,2000,2000
053126,健策凱基97購02  ,0,0,0,0,0,0,0,0,0,2000,0,0,0,2000,0,2000,2000
055861,矽力元大97購03  ,0,0,0,0,0,0,0,0,0,2000,0,0,0,2000,0,2000,2000
055997,矽創國泰99購01  ,0,0,0,0,0,0,0,0,0,2000,0,0,0,2000,0,2000,2000
054577,世芯元大98購01  ,0,0,0,0,0,0,0,0,0,2000,0,0,0,2000,0,2000,2000
053356,聯發科統一96購07,0,0,0,0,0,0,0,0,0,2000,0,0,0,2000,0,2000,2000
053708,道瓊反凱基98購01,0,0,0,0,0,0,0,0,0,2000,0,0,0,2000,0,2000,2000
052923,台積電永豐96購02,0,0,0,0,0,0,0,0,0,2000,0,0,0,2000,0,2000,2000
059803,S&P正2元富9B購03,0,0,0,0,0,0,0,0,0,2000,0,0,0,3000,1000,2000,2000
056745,聯茂凱基99購03  ,0,0,0,0,0,0,0,0,0,2000,0,0,0,2000,0,2000,2000
056323,旺宏兆豐98購01  ,0,0,0,0,0,0,0,0,0,2000,0,0,0,22000,20000,2000,2000
056343,高鐵凱基98購02  ,0,0,0,0,0,0,0,0,0,2000,0,0,0,28000,26000,2000,2000
05638P,國巨統一96售04  ,0,0,0,0,0,0,0,0,0,2000,0,0,0,2000,0,2000,2000
056704,健策國泰99購01  ,0,0,0,0,0,0,0,0,0,2000,0,0,0,2000,0,2000,2000
056412,上証2X中信9A購02,0,0,0,0,0,0,0,0,0,2000,0,0,0,2000,0,2000,2000
054950,奇力新元大98購02,0,0,0,0,0,0,0,0,0,2000,0,0,0,2000,0,2000,2000
056169,鴻海元富97購08  ,0,0,0,0,0,0,0,0,0,2000,0,0,0,2000,0,2000,2000
056176,創意元富97購01  ,0,0,0,0,0,0,0,0,0,2000,0,0,0,2000,0,2000,2000
056950,亞光統一99購01  ,0,0,0,0,0,0,0,0,0,2000,0,0,0,2000,0,2000,2000
054901,群光康和97購01  ,0,0,0,0,0,0,0,0,0,2000,0,0,0,2000,0,2000,2000
05625P,國巨國票97售01  ,0,0,0,0,0,0,0,0,0,2000,0,0,0,10000,8000,2000,2000
05557P,S&P500中信96售02,0,0,0,0,0,0,0,0,0,2000,0,0,0,2000,0,2000,2000
057823,神達元大98購01  ,0,0,0,0,0,0,0,0,0,2000,0,0,0,2000,0,2000,2000
060163,健策永豐9B購01  ,0,0,0,0,0,0,0,0,0,2000,0,0,0,5000,3000,2000,2000
060189,宏達電元富9B購03,0,0,0,0,0,0,0,0,0,2000,0,0,0,85000,83000,2000,2000
060351,滬深2X元富9A購01,0,0,0,0,0,0,0,0,0,2000,0,0,0,10000,8000,2000,2000
059706,嘉晶凱基99購01  ,0,0,0,0,0,0,0,0,0,2000,0,0,0,2000,0,2000,2000
059717,國巨元大99購21  ,0,0,0,0,0,0,0,0,0,2000,0,0,0,6000,4000,2000,2000
058551,義隆永豐99購03  ,0,0,0,0,0,0,0,0,0,2000,0,0,0,193000,191000,2000,2000
057735,台灣50富邦9C購02,0,0,0,0,0,0,0,0,0,2000,0,0,0,2000,0,2000,2000
060539,道瓊反凱基9A購01,0,0,0,0,0,0,0,0,0,2000,0,0,0,2000,0,2000,2000
060520,臺指2X中信01購02,0,0,0,0,0,0,0,0,0,2000,0,0,0,2000,0,2000,2000
057589,超眾國票9A購01  ,0,0,0,0,0,0,0,0,0,2000,0,0,0,7000,5000,2000,2000
058185,國巨永豐99購01  ,0,0,0,0,0,0,0,0,0,2000,0,0,0,2000,0,2000,2000
058214,世芯群益9A購01  ,0,0,0,0,0,0,0,0,0,2000,0,0,0,2000,0,2000,2000
05726P,易華電永豐96售02,0,0,0,0,0,0,0,0,0,2000,0,0,0,2000,0,2000,2000
057280,大立光元大98購15,0,0,0,0,0,0,0,0,0,2000,0,0,0,2000,0,2000,2000
057312,美律麥證98購01  ,0,0,0,2000,0,2000,0,0,0,2000,0,0,0,2000,0,2000,2000
057901,大立光永豐98購04,0,0,0,0,0,0,0,0,0,2000,0,0,0,2000,0,2000,2000
059317,台積電元大99購34,0,0,0,0,0,0,0,0,0,2000,0,0,0,5000,3000,2000,2000
05935P,台積電凱基96售19,0,0,0,0,0,0,0,0,0,2000,0,0,0,12000,10000,2000,2000
05812P,臺股指國票96售05,0,0,0,0,0,0,0,0,0,2000,0,0,0,2000,0,2000,2000
058184,鴻海永豐99購01  ,0,0,0,0,0,0,0,0,0,2000,0,0,0,2000,0,2000,2000
05912P,和大元大96售01  ,0,0,0,0,0,0,0,0,0,2000,0,0,0,2000,0,2000,2000
059066,道瓊指國票04購01,0,0,0,0,0,0,0,0,0,2000,0,0,0,2000,0,2000,2000
059077,FBVIX元大99購05 ,0,0,0,0,0,0,0,0,0,2000,0,0,0,4000,2000,2000,2000
058016,智邦凱基98購06  ,0,0,0,0,0,0,0,0,0,2000,0,0,0,2000,0,2000,2000
058041,FBVIX元大98購02 ,0,0,0,0,0,0,0,0,0,2000,0,0,0,2000,0,2000,2000
058930,華新科統一9B購01,0,0,0,0,0,0,0,0,0,2000,0,0,0,127000,125000,2000,2000
061022,健策國泰9B購03  ,0,0,0,0,0,0,0,0,0,2000,0,0,0,32000,30000,2000,2000
07831P,大立光統一9B售07,0,0,0,0,0,0,0,0,0,2000,0,0,0,2000,0,2000,2000
061161,南六群益9A購01  ,0,0,0,0,0,0,0,0,0,2000,0,0,0,4000,2000,2000,2000
3031,佰鴻            ,9000,7000,2000,0,0,0,0,0,0,0,0,0,0,0,0,0,2000
2891C,中信金丙特      ,0,0,0,0,0,0,0,0,0,2000,2000,0,2000,0,0,0,2000
2838A,聯邦銀甲特      ,0,0,0,0,0,0,0,0,0,2000,2000,0,2000,0,0,0,2000
2450,神腦            ,31000,29000,2000,0,0,0,0,0,0,0,0,0,0,0,0,0,2000
2427,三商電          ,2000,0,2000,0,0,0,0,0,0,0,0,0,0,0,0,0,2000
1340,勝悅-KY         ,7000,5000,2000,0,0,0,0,0,0,0,0,0,0,0,0,0,2000
1101B,台泥乙特        ,0,0,0,0,0,0,0,0,0,2000,2000,0,2000,0,0,0,2000
1529,樂士            ,0,0,0,0,0,0,0,0,0,2000,2000,0,2000,0,0,0,2000
08036P,嘉澤群益9B售03  ,0,0,0,0,0,0,0,0,0,2000,0,0,0,170000,168000,2000,2000
07929P,旺宏統一9B售07  ,0,0,0,0,0,0,0,0,0,2000,0,0,0,13000,11000,2000,2000
07711P,世芯元大9A售07  ,0,0,0,0,0,0,0,0,0,2000,0,0,0,13000,11000,2000,2000
07219P,臺股指凱基99售32,0,0,0,0,0,0,0,0,0,2000,0,0,0,2000,0,2000,2000
07161P,臺股指群益99售12,0,0,0,0,0,0,0,0,0,2000,0,0,0,2000,0,2000,2000
07176P,臺股指凱基99售18,0,0,0,0,0,0,0,0,0,2000,0,0,0,2000,0,2000,2000
07317P,T50正2凱基9B售02,0,0,0,0,0,0,0,0,0,2000,0,0,0,2000,0,2000,2000
3312,弘憶股          ,35000,33000,2000,0,0,0,0,0,0,0,0,0,0,0,0,0,2000
6243,迅杰            ,2000,0,2000,0,0,0,0,0,0,0,0,0,0,0,0,0,2000
060793,微星永豐9A購01  ,0,0,0,0,0,0,0,0,0,2000,0,0,0,38000,36000,2000,2000
9918,欣天然          ,2000,0,2000,0,0,0,0,0,0,0,0,0,0,0,0,0,2000
9941A,裕融甲特        ,0,0,0,0,0,0,0,0,0,2000,2000,0,2000,0,0,0,2000
910322,康師傅-DR       ,2000,0,2000,0,0,0,0,0,0,0,0,0,0,0,0,0,2000
9908,大台北          ,2000,0,2000,0,0,0,0,0,0,0,0,0,0,0,0,0,2000
06303P,臺股指元大97售09,0,0,0,0,0,0,0,0,0,1000,0,0,0,1000,0,1000,1000
063254,臺股指元大9B購41,0,0,0,0,0,0,0,0,0,1000,0,0,0,1000,0,1000,1000
063267,台表科中信01購02,0,0,0,0,0,0,0,0,0,1000,0,0,0,1000,0,1000,1000
07040P,台灣50元大9C售02,0,0,0,0,0,0,0,0,0,1000,0,0,0,2000,1000,1000,1000
07033P,大立光統一9B售03,0,0,0,0,0,0,0,0,0,1000,0,0,0,21000,20000,1000,1000
06749P,技嘉元富98售03  ,0,0,0,0,0,0,0,0,0,1000,0,0,0,1000,0,1000,1000
06673P,大立光群益98售01,0,0,0,0,0,0,0,0,0,1000,0,0,0,1000,0,1000,1000
06931P,大立光元大98售20,0,0,0,0,0,0,0,0,0,1000,0,0,0,1000,0,1000,1000
06469P,臺股指凱基99售09,0,0,0,0,0,0,0,0,0,1000,0,0,0,1000,0,1000,1000
06620P,聯發科元大98售07,0,0,0,0,0,0,0,0,0,1000,0,0,0,10000,9000,1000,1000
06206P,台積電凱基97售11,0,0,0,0,0,0,0,0,0,1000,0,0,0,1000,0,1000,1000
061926,晶技凱基9B購02  ,0,0,0,0,0,0,0,0,0,1000,0,0,0,2000,1000,1000,1000
061968,聯發科統一01購03,0,0,0,0,0,0,0,0,0,1000,0,0,0,1000,0,1000,1000
061955,FANG+統一9B購01 ,0,0,0,0,0,0,0,0,0,1000,0,0,0,1000,0,1000,1000
061784,聯發科群益9B購02,0,0,0,0,0,0,0,0,0,1000,0,0,0,6000,5000,1000,1000
061769,晶技元大9B購03  ,0,0,0,0,0,0,0,0,0,1000,0,0,0,106000,105000,1000,1000
061840,長榮航凱基9C購01,0,0,0,0,0,0,0,0,0,1000,0,0,0,1000,0,1000,1000
061699,燿華國票9A購01  ,0,0,0,0,0,0,0,0,0,1000,0,0,0,1000,0,1000,1000
06148P,台積電元大97售17,0,0,0,0,0,0,0,0,0,1000,0,0,0,1000,0,1000,1000
062125,嘉晶統一9B購01  ,0,2000,-2000,0,0,0,0,0,0,3000,0,0,0,3000,0,3000,1000
062317,祥碩凱基9B購03  ,0,0,0,0,0,0,0,0,0,1000,0,0,0,23000,22000,1000,1000
062438,台光電元大9B購04,0,0,0,0,0,0,0,0,0,1000,0,0,0,15000,14000,1000,1000
062476,神隆國票9B購01  ,0,0,0,0,0,0,0,0,0,1000,0,0,0,1000,0,1000,1000
06257P,臺股指群益97售10,0,0,0,0,0,0,0,0,0,1000,0,0,0,1000,0,1000,1000
055566,台表科凱基97購03,0,0,0,0,0,0,0,0,0,1000,0,0,0,1000,0,1000,1000
055468,智邦凱基97購04  ,0,0,0,0,0,0,0,0,0,1000,0,0,0,1000,0,1000,1000
055432,臻鼎群益97購02  ,0,0,0,0,0,0,0,0,0,1000,0,0,0,1000,0,1000,1000
055300,緯穎元大98購01  ,0,0,0,0,0,0,0,0,0,1000,0,0,0,1000,0,1000,1000
055280,智邦元大97購01  ,0,0,0,0,0,0,0,0,0,1000,0,0,0,1000,0,1000,1000
055671,世紀鋼群益97購01,0,0,0,0,0,0,0,0,0,1000,0,0,0,1000,0,1000,1000
054905,國揚康和97購01  ,0,0,0,0,0,0,0,0,0,1000,0,0,0,1000,0,1000,1000
056983,大立光群益99購02,0,0,0,0,0,0,0,0,0,1000,0,0,0,1000,0,1000,1000
056174,億光元富97購01  ,0,0,0,0,0,0,0,0,0,1000,0,0,0,1000,0,1000,1000
056202,國揚永豐97購01  ,0,0,0,0,0,0,0,0,0,1000,0,0,0,1000,0,1000,1000
057107,華新科群益98購06,0,0,0,0,0,0,0,0,0,1000,0,0,0,1000,0,1000,1000
056157,聯詠凱基97購03  ,0,0,0,0,0,0,0,0,0,1000,0,0,0,1000,0,1000,1000
056434,國巨凱基98購03  ,0,0,0,0,0,0,0,0,0,1000,0,0,0,20000,19000,1000,1000
056530,旺宏凱基98購06  ,0,0,0,0,0,0,0,0,0,1000,0,0,0,1000,0,1000,1000
056675,聯發科元富02購01,0,0,0,0,0,0,0,0,0,1000,0,0,0,1000,0,1000,1000
056386,TPK國泰99購01   ,0,0,0,0,0,0,0,0,0,1000,0,0,0,1000,0,1000,1000
05675P,美律群益97售01  ,0,0,0,0,0,0,0,0,0,1000,0,0,0,1000,0,1000,1000
059822,聯發科凱基99購19,0,0,0,0,0,0,0,0,0,1000,0,0,0,1000,0,1000,1000
060215,柏文康和9A購01  ,0,0,0,0,0,0,0,0,0,1000,0,0,0,1000,0,1000,1000
059885,台積電國票99購12,0,0,0,0,0,0,0,0,0,1000,0,0,0,2000,1000,1000,1000
052790,智邦兆豐97購01  ,0,0,0,0,0,0,0,0,0,1000,0,0,0,1000,0,1000,1000
053990,晶技兆豐96購01  ,0,0,0,0,0,0,0,0,0,1000,0,0,0,1000,0,1000,1000
053921,嘉晶國票97購03  ,0,0,0,0,0,0,0,0,0,1000,0,0,0,1000,0,1000,1000
053881,南亞科中信97購01,0,0,0,0,0,0,0,0,0,1000,0,0,0,1000,0,1000,1000
053744,台郡國票97購03  ,0,0,0,0,0,0,0,0,0,1000,0,0,0,1000,0,1000,1000
053761,健策國泰98購01  ,0,0,0,0,0,0,0,0,0,1000,0,0,0,3000,2000,1000,1000
053599,崇越元大96購01  ,0,0,0,0,0,0,0,0,0,1000,0,0,0,1000,0,1000,1000
053363,旺宏國泰98購02  ,0,0,0,0,0,0,0,0,0,1000,0,0,0,1000,0,1000,1000
053443,智邦凱基97購01  ,0,0,0,0,0,0,0,0,0,1000,0,0,0,1000,0,1000,1000
05331P,上証2X國票96售01,0,0,0,0,0,0,0,0,0,1000,0,0,0,1000,0,1000,1000
055994,聯發科國泰99購02,0,0,0,0,0,0,0,0,0,1000,0,0,0,1000,0,1000,1000
056941,台郡元富9B購01  ,0,0,0,0,0,0,0,0,0,1000,0,0,0,1000,0,1000,1000
056863,義隆群益98購01  ,0,0,0,0,0,0,0,0,0,1000,0,0,0,32000,31000,1000,1000
053129,緯穎凱基96購01  ,0,0,0,0,0,0,0,0,0,1000,0,0,0,1000,0,1000,1000
053063,力山群益98購01  ,0,0,0,0,0,0,0,0,0,1000,0,0,0,85000,84000,1000,1000
055728,緯穎元大97購03  ,0,0,0,0,0,0,0,0,0,1000,0,0,0,1000,0,1000,1000
054289,聯發科元大97購11,0,0,0,0,0,0,0,0,0,1000,0,0,0,1000,0,1000,1000
052402,健策凱基97購01  ,0,0,0,0,0,0,0,0,0,1000,0,0,0,1000,0,1000,1000
049065,T50反1凱基96購04,0,0,0,0,0,0,0,0,0,1000,0,0,0,1000,0,1000,1000
051939,同欣電群益97購01,0,0,0,0,0,0,0,0,0,1000,0,0,0,1000,0,1000,1000
052202,矽力統一96購01  ,0,0,0,0,0,0,0,0,0,1000,0,0,0,1000,0,1000,1000
052232,貿聯凱基96購02  ,0,0,0,0,0,0,0,0,0,1000,0,0,0,1000,0,1000,1000
03679C,臺股指元大04牛04,0,0,0,0,0,0,0,0,0,1000,0,0,0,1000,0,1000,1000
03670C,元油2X元富99牛01,0,0,0,0,0,0,0,0,0,1000,0,0,0,1000,0,1000,1000
03676C,臺股指元大04牛03,0,0,0,0,0,0,0,0,0,1000,0,0,0,1000,0,1000,1000
045053,聯發科元富98購01,0,0,0,0,0,0,0,0,0,1000,0,0,0,1000,0,1000,1000
0054,元大台商50      ,0,0,0,0,0,0,0,0,0,1000,0,0,0,5000,4000,1000,1000
03033X,元展30          ,0,0,0,0,0,0,0,0,0,1000,0,0,0,2000,1000,1000,1000
00702,國泰標普低波高息,0,0,0,0,0,0,0,0,0,1000,0,0,0,3000,2000,1000,1000
061181,牧德凱基9A購01  ,0,0,0,0,0,0,0,0,0,1000,0,0,0,1000,0,1000,1000
061392,泰鼎群益9A購02  ,0,0,0,0,0,0,0,0,0,1000,0,0,0,1000,0,1000,1000
07823P,國巨元大9A售23  ,0,0,0,0,0,0,0,0,0,1000,0,0,0,11000,10000,1000,1000
057230,建準凱基98購02  ,0,0,0,0,0,0,0,0,0,1000,0,0,0,11000,10000,1000,1000
057203,麗豐元富98購02  ,0,0,0,0,0,0,0,0,0,1000,0,0,0,101000,100000,1000,1000
057194,南電元大98購01  ,0,0,0,0,0,0,0,0,0,1000,0,0,0,2000,1000,1000,1000
058826,台積電永豐99購02,0,0,0,0,0,0,0,0,0,1000,0,0,0,1000,0,1000,1000
058824,晶技富邦9A購01  ,0,0,0,0,0,0,0,0,0,1000,0,0,0,1000,0,1000,1000
058163,道瓊反凱基9B購01,0,0,0,0,0,0,0,0,0,1000,0,0,0,1000,0,1000,1000
058793,鴻海元大99購19  ,0,0,0,0,0,0,0,0,0,1000,0,0,0,14000,13000,1000,1000
058440,玉晶光統一99購02,0,0,0,0,0,0,0,0,0,1000,0,0,0,1000,0,1000,1000
059180,祥碩元富9A購01  ,0,0,0,0,0,0,0,0,0,1000,0,0,0,1000,0,1000,1000
059173,矽力凱基99購01  ,0,0,0,0,0,0,0,0,0,1000,0,0,0,26000,25000,1000,1000
05919P,京鼎元大96售03  ,0,0,0,0,0,0,0,0,0,1000,0,0,0,242000,241000,1000,1000
05937P,台積電凱基96售21,0,0,0,0,0,0,0,0,0,1000,0,0,0,1000,0,1000,1000
059014,SGBR2X元富03購01,0,0,0,0,0,0,0,0,0,1000,0,0,0,1000,0,1000,1000
057989,旺宏統一99購04  ,0,0,0,0,0,0,0,0,0,1000,0,0,0,1000,0,1000,1000
05788P,臺股指永昌96售05,0,0,0,0,0,0,0,0,0,1000,0,0,0,11000,10000,1000,1000
057875,京鼎元大98購03  ,0,0,0,0,0,0,0,0,0,1000,0,0,0,101000,100000,1000,1000
057637,上銀元大98購07  ,0,0,0,0,0,0,0,0,0,1000,0,0,0,24000,23000,1000,1000
058701,鴻海元大99購16  ,0,0,0,0,0,0,0,0,0,1000,0,0,0,1000,0,1000,1000
057526,智邦元大98購10  ,0,0,0,0,0,0,0,0,0,1000,0,0,0,17000,16000,1000,1000
057503,世紀鋼群益98購02,0,0,0,0,0,0,0,0,0,1000,0,0,0,1000,0,1000,1000
057500,神達群益98購01  ,0,0,0,0,0,0,0,0,0,1000,0,0,0,1000,0,1000,1000
057435,旺宏國票99購04  ,0,0,0,0,0,0,0,0,0,1000,0,0,0,1000,0,1000,1000
05736P,臺股指統一96售06,0,0,0,0,0,0,0,0,0,1000,0,0,0,1000,0,1000,1000
059992,S&P正2元富9B購04,0,0,0,0,0,0,0,0,0,1000,0,0,0,1000,0,1000,1000
059676,台積電台新99購05,0,0,0,0,0,0,0,0,0,1000,0,0,0,1000,0,1000,1000
058579,聯發科群益99購04,0,0,0,0,0,0,0,0,0,1000,0,0,0,1000,0,1000,1000
060350,元黃金元富9B購01,0,0,0,0,0,0,0,0,0,1000,0,0,0,2000,1000,1000,1000
057814,聯發科元大98購12,0,0,0,0,0,0,0,0,0,1000,0,0,0,1000,0,1000,1000
058631,鈺齊國票9A購01  ,0,0,0,0,0,0,0,0,0,1000,0,0,0,2000,1000,1000,1000
059555,台灣50凱基9A購06,0,0,0,0,0,0,0,0,0,1000,0,0,0,2000,1000,1000,1000
060698,旺宏國泰9C購01  ,0,0,0,0,0,0,0,0,0,1000,0,0,0,62000,61000,1000,1000
061000,旺宏兆豐9A購02  ,0,0,0,0,0,0,0,0,0,1000,0,0,0,1000,0,1000,1000
5533,皇鼎            ,7000,6000,1000,0,0,0,0,0,0,0,0,0,0,0,0,0,1000
060643,牧德永豐9A購03  ,0,0,0,0,0,0,0,0,0,1000,0,0,0,1000,0,1000,1000
6625,必應            ,1000,0,1000,0,0,0,0,0,0,0,0,0,0,0,0,0,1000
3305,昇貿            ,2000,1000,1000,0,0,0,0,0,0,0,0,0,0,0,0,0,1000
4141,龍燈-KY         ,0,8000,-8000,0,0,0,0,0,0,9000,9000,0,9000,0,0,0,1000
4999,鑫禾            ,1000,0,1000,0,0,0,0,0,0,0,0,0,0,0,0,0,1000
4807,日成-KY         ,1000,0,1000,0,0,0,0,0,0,0,0,0,0,0,0,0,1000
07415P,台積電元大99售52,0,0,0,0,0,0,0,0,0,1000,0,0,0,1000,0,1000,1000
07150P,和碩元大99售01  ,0,0,0,0,0,0,0,0,0,1000,0,0,0,1000,0,1000,1000
07197P,臺股指元大99售13,0,0,0,0,0,0,0,0,0,1000,0,0,0,1000,0,1000,1000
07206P,鴻海凱基9A售11  ,0,0,0,0,0,0,0,0,0,1000,0,0,0,3000,2000,1000,1000
07245P,台積電凱基99售16,0,0,0,0,0,0,0,0,0,1000,0,0,0,2000,1000,1000,1000
07602P,台積電統一9A售07,0,0,0,0,0,0,0,0,0,1000,0,0,0,1000,0,1000,1000
07608P,台灣50國票9C售03,0,0,0,0,0,0,0,0,0,1000,0,0,0,1000,0,1000,1000
07633P,台灣50元大9A售18,0,0,0,0,0,0,0,0,0,1000,0,0,0,1000,0,1000,1000
07462P,臺股指元大9B售05,0,0,0,0,0,0,0,0,0,1000,0,0,0,15000,14000,1000,1000
07558P,玉晶光元大9A售10,0,0,0,0,0,0,0,0,0,1000,0,0,0,11000,10000,1000,1000
07752P,台灣50元大9C售33,0,0,0,0,0,0,0,0,0,1000,0,0,0,1000,0,1000,1000
07759P,臺股指富邦9A售04,0,0,0,0,0,0,0,0,0,1000,0,0,0,1000,0,1000,1000
07972P,大立光統一9C售05,0,0,0,0,0,0,0,0,0,1000,0,0,0,1000,0,1000,1000
07926P,上銀統一9B售02  ,0,0,0,0,0,0,0,0,0,1000,0,0,0,1000,0,1000,1000
1626,艾美特-KY       ,8000,7000,1000,0,0,0,0,0,0,0,0,0,0,0,0,0,1000
1737,臺鹽            ,4000,3000,1000,0,0,0,0,0,0,0,0,0,0,0,0,0,1000
1457,宜進            ,1000,0,1000,0,0,0,0,0,0,0,0,0,0,0,0,0,1000
1525,江申            ,1000,0,1000,0,0,0,0,0,0,0,0,0,0,0,0,0,1000
2397,友通            ,1000,0,1000,0,0,0,0,0,0,0,0,0,0,0,0,0,1000
2495,普安            ,3000,2000,1000,0,0,0,0,0,0,0,0,0,0,0,0,0,1000
2535,達欣工          ,2000,36000,-34000,0,0,0,0,0,0,35000,35000,0,35000,0,0,0,1000
2881A,富邦特          ,0,1000,-1000,0,0,0,0,0,0,2000,2000,0,2000,0,0,0,1000
2881B,富邦金乙特      ,0,0,0,0,0,0,0,0,0,1000,1000,0,1000,0,0,0,1000
2722,夏都            ,16000,15000,1000,0,0,0,0,0,0,0,0,0,0,0,0,0,1000
008201,BP上證50        ,0,0,0,0,0,0,0,0,0,400,0,0,0,400,0,400,400
06255P,臺股指群益97售08,0,7000,-7000,0,0,0,0,0,0,7000,0,0,0,7000,0,7000,0
06248P,國巨統一97售07  ,0,0,0,0,0,0,0,0,0,0,0,0,0,50000,50000,0,0
062499,鴻海群益01購01  ,0,0,0,0,0,0,0,0,0,0,0,0,0,8000,8000,0,0
062481,同欣電國票9B購01,0,0,0,0,0,0,0,0,0,0,0,0,0,50000,50000,0,0
062419,台積電統一9B購15,0,0,0,0,0,0,0,0,0,0,0,0,0,4000,4000,0,0
062674,百和中信03購01  ,0,0,0,0,0,0,0,0,0,0,0,0,0,2000,2000,0,0
062693,中石化元大02購01,0,0,0,0,0,0,0,0,0,0,0,0,0,95000,95000,0,0
062734,臺指反國票9C購03,0,0,0,0,0,0,0,0,0,0,0,0,0,15000,15000,0,0
062601,富邦金台新9B購01,0,0,0,0,0,0,0,0,0,0,0,0,0,10000,10000,0,0
062335,茂林統一01購01  ,0,0,0,0,0,0,0,0,0,0,0,0,0,9000,9000,0,0
062289,緯穎群益9B購01  ,0,0,0,0,0,0,0,0,0,0,0,0,0,10000,10000,0,0
062146,大毅國票9B購01  ,0,0,0,0,0,0,0,0,0,0,0,0,0,1000,1000,0,0
062140,元金2X國票9B購03,0,0,0,0,0,0,0,0,0,0,0,0,0,10000,10000,0,0
062237,緯創凱基9B購01  ,0,0,0,0,0,0,0,0,0,0,0,0,0,10000,10000,0,0
061499,嘉晶國票9A購03  ,0,0,0,0,0,0,0,0,0,0,0,0,0,1000,1000,0,0
06149P,台積電元大97售18,0,0,0,0,0,0,0,0,0,0,0,0,0,99000,99000,0,0
061447,鴻海中信04購02  ,0,0,0,0,0,0,0,0,0,0,0,0,0,2000,2000,0,0
061677,泰碩元大9A購05  ,0,0,0,0,0,0,0,0,0,0,0,0,0,25000,25000,0,0
061622,臻鼎群益9A購01  ,0,0,0,0,0,0,0,0,0,0,0,0,0,5000,5000,0,0
061602,旺宏凱基9A購06  ,0,0,0,0,0,0,0,0,0,0,0,0,0,10000,10000,0,0
06155P,智邦統一97售02  ,0,0,0,0,0,0,0,0,0,0,0,0,0,40000,40000,0,0
061820,康控群益9B購02  ,0,0,0,0,0,0,0,0,0,0,0,0,0,6000,6000,0,0
061893,鴻海永豐9B購01  ,0,0,0,0,0,0,0,0,0,0,0,0,0,1000,1000,0,0
061782,智邦群益9B購01  ,0,0,0,0,0,0,0,0,0,0,0,0,0,94000,94000,0,0
061798,晶豪科永豐9B購01,0,0,0,0,0,0,0,0,0,0,0,0,0,249000,249000,0,0
061984,華新科元大9B購05,0,0,0,0,0,0,0,0,0,0,0,0,0,5000,5000,0,0
061911,台積電中信05購04,0,0,0,0,0,0,0,0,0,0,0,0,0,3000,3000,0,0
061946,鴻海群益9B購03  ,0,0,0,0,0,0,0,0,0,0,0,0,0,3000,3000,0,0
06637P,大立光凱基98售15,0,0,0,0,0,0,0,0,0,0,0,0,0,150000,150000,0,0
06473P,鴻海元大99售03  ,0,0,0,0,0,0,0,0,0,0,0,0,0,54000,54000,0,0
06488P,台積電元富98售05,0,0,0,0,0,0,0,0,0,0,0,0,0,300000,300000,0,0
06448P,華通元大99售01  ,0,0,0,0,0,0,0,0,0,0,0,0,0,3000,3000,0,0
06393P,台積電元大97售27,0,0,0,0,0,0,0,0,0,0,0,0,0,30000,30000,0,0
06371P,茂林國票98售04  ,0,0,0,0,0,0,0,0,0,0,0,0,0,10000,10000,0,0
063576,台表科元大9B購08,0,0,0,0,0,0,0,0,0,0,0,0,0,7000,7000,0,0
063606,TPK凱基9C購01   ,0,0,0,0,0,0,0,0,0,0,0,0,0,13000,13000,0,0
063634,台光電元大9B購09,0,0,0,0,0,0,0,0,0,0,0,0,0,2000,2000,0,0
063636,聯發科元大9B購26,0,0,0,0,0,0,0,0,0,0,0,0,0,58000,58000,0,0
063638,華新科元大9B購14,0,0,0,0,0,0,0,0,0,0,0,0,0,2000,2000,0,0
063648,台表科元大9C購05,0,0,0,0,0,0,0,0,0,0,0,0,0,1000,1000,0,0
063654,上銀元富9B購05  ,0,0,0,0,0,0,0,0,0,0,0,0,0,2000,2000,0,0
06367P,台積電凱基97售14,0,0,0,0,0,0,0,0,0,0,0,0,0,11000,11000,0,0
063685,鴻海永豐9B購03  ,0,0,0,0,0,0,0,0,0,0,0,0,0,1000,1000,0,0
063694,貿聯永豐9B購01  ,0,0,0,0,0,0,0,0,0,0,0,0,0,10000,10000,0,0
063508,緯創群益9B購01  ,0,0,0,0,0,0,0,0,0,0,0,0,0,3000,3000,0,0
063480,南六元大9C購01  ,0,0,0,0,0,0,0,0,0,0,0,0,0,54000,54000,0,0
063530,同欣電凱基9C購02,0,0,0,0,0,0,0,0,0,0,0,0,0,3000,3000,0,0
063534,鴻海統一9B購07  ,0,0,0,0,0,0,0,0,0,0,0,0,0,5000,5000,0,0
063484,達方元大9B購01  ,0,0,0,0,0,0,0,0,0,0,0,0,0,49000,49000,0,0
06919P,臺股指日盛98售02,0,0,0,0,0,0,0,0,0,0,0,0,0,30000,30000,0,0
06908P,健策國泰99售02  ,0,0,0,0,0,0,0,0,0,0,0,0,0,178000,178000,0,0
06804P,臺股指群益98售10,0,0,0,0,0,0,0,0,0,0,0,0,0,1000,1000,0,0
06850P,聯茂元大98售06  ,0,0,0,0,0,0,0,0,0,0,0,0,0,15000,15000,0,0
06857P,超眾永豐98售02  ,0,0,0,0,0,0,0,0,0,0,0,0,0,30000,30000,0,0
06666P,台積電日盛9A售02,0,0,0,0,0,0,0,0,0,0,0,0,0,601000,601000,0,0
06709P,臺股指台新99售06,0,0,0,0,0,0,0,0,0,0,0,0,0,9000,9000,0,0
06710P,臺股指台新99售07,0,0,0,0,0,0,0,0,0,0,120000,0,120000,10000,130000,-120000,0
06761P,台積電元大99售05,0,0,0,0,0,0,0,0,0,0,0,0,0,71000,71000,0,0
07031P,台灣50中信03售02,0,0,0,0,0,0,0,0,0,0,0,0,0,50000,50000,0,0
06988P,鴻海元富99售09  ,0,0,0,0,0,0,0,0,0,0,0,0,0,3000,3000,0,0
06981P,台灣50麥證99售02,0,0,0,10000,10000,0,0,0,0,0,0,0,0,10000,10000,0,0
07092P,上銀凱基99售03  ,0,0,0,0,0,0,0,0,0,0,0,0,0,10000,10000,0,0
07076P,鴻海凱基9A售08  ,0,0,0,0,0,0,0,0,0,0,0,0,0,3000,3000,0,0
07056P,臺股指麥證99售02,0,0,0,1000,1000,0,0,0,0,0,0,0,0,1000,1000,0,0
063258,緯穎國泰9C購01  ,0,0,0,0,0,0,0,0,0,0,0,0,0,22000,22000,0,0
063278,國巨元大9C購04  ,0,0,0,0,0,0,0,0,0,0,0,0,0,27000,27000,0,0
063279,國巨元大9C購05  ,0,0,0,0,0,0,0,0,0,0,0,0,0,13000,13000,0,0
063327,燿華國票9C購02  ,0,0,0,0,0,0,0,0,0,0,0,0,0,40000,40000,0,0
063373,晶技永豐9B購02  ,0,0,0,0,0,0,0,0,0,0,0,0,0,40000,40000,0,0
063435,儒鴻統一01購02  ,0,0,0,0,0,0,0,0,0,0,0,0,0,65000,65000,0,0
063436,儒鴻統一01購03  ,0,0,0,0,0,0,0,0,0,0,0,0,0,20000,20000,0,0
063428,矽創凱基9B購02  ,0,0,0,0,0,0,0,0,0,0,0,0,0,15000,15000,0,0
063413,台積電麥證01購01,0,0,0,0,1000,-1000,0,0,0,0,0,0,0,1000,1000,0,0
063416,台積電凱基9B購10,0,0,0,0,0,0,0,0,0,0,0,0,0,1000,1000,0,0
063040,聯詠凱基9B購03  ,0,0,0,0,0,0,0,0,0,0,0,0,0,3000,3000,0,0
063035,燿華凱基9B購02  ,0,0,0,0,0,0,0,0,0,0,0,0,0,18000,18000,0,0
063020,奇力新元大9B購04,0,0,0,0,0,0,0,0,0,0,0,0,0,68000,68000,0,0
062928,富邦金台新9B購02,0,0,0,0,0,0,0,0,0,0,0,0,0,29000,29000,0,0
062944,茂林凱基9B購02  ,0,0,0,0,0,0,0,0,0,0,0,0,0,10000,10000,0,0
062855,嘉澤永豐9B購02  ,0,0,0,0,0,0,0,0,0,0,0,0,0,14000,14000,0,0
00774B,新光中國政金綠債,0,0,0,0,0,0,0,0,0,0,0,0,0,2000,2000,0,0
00775B,新光投等債15+   ,0,0,0,0,0,0,0,0,0,0,0,0,0,3000,3000,0,0
00865B,國泰US短期公債  ,0,0,0,0,0,0,0,0,0,0,0,0,0,100000,100000,0,0
051461,聯詠國泰96購01  ,0,0,0,0,0,0,0,0,0,0,0,0,0,39000,39000,0,0
051531,國巨國票96購04  ,0,0,0,0,0,0,0,0,0,0,0,0,0,3000,3000,0,0
0057,富邦摩台        ,2000,0,2000,0,0,0,0,0,0,-2000,0,0,0,219000,221000,-2000,0
00636K,國泰中國A50+U   ,0,0,0,0,0,0,0,0,0,0,0,0,0,100,100,0,0
00625K,富邦上証+R      ,0,0,0,0,0,0,0,0,0,0,0,0,0,50000,50000,0,0
00645,富邦日本        ,0,0,0,0,0,0,0,0,0,0,0,0,0,86000,86000,0,0
00691R,兆豐藍籌30反1   ,0,0,0,0,0,0,0,0,0,0,0,0,0,1000,1000,0,0
00689R,國泰20年美債反1 ,0,0,0,0,0,0,0,0,0,0,0,0,0,100000,100000,0,0
00668K,國泰美國道瓊+U  ,0,0,0,0,0,0,0,0,0,0,0,0,0,100,100,0,0
00657,國泰日經225     ,0,0,0,0,0,0,0,0,0,0,0,0,0,104000,104000,0,0
00657K,國泰日經225+U   ,0,0,0,0,0,0,0,0,0,0,0,0,0,100,100,0,0
04787P,台積電永昌96售04,0,0,0,0,0,0,0,0,0,0,0,0,0,44000,44000,0,0
03674C,臺股指元富9C牛02,0,0,0,0,0,0,0,0,0,0,0,0,0,6000,6000,0,0
042168,台灣50凱基96購01,0,0,0,0,0,0,0,0,0,0,0,0,0,10000,10000,0,0
051973,華新科凱基96購04,0,0,0,0,0,0,0,0,0,0,0,0,0,40000,40000,0,0
051755,台積電元大96購08,0,0,0,0,0,0,0,0,0,0,0,0,0,75000,75000,0,0
051688,大立光凱基97購02,0,0,0,0,0,0,0,0,0,0,0,0,0,45000,45000,0,0
051582,聯發科元大97購02,0,0,0,0,0,0,0,0,0,0,0,0,0,1000,1000,0,0
049252,國巨元大96購01  ,0,0,0,0,0,0,0,0,0,0,0,0,0,3000,3000,0,0
049584,台積電元大96購04,0,0,0,0,0,0,0,0,0,0,0,0,0,90000,90000,0,0
049973,T50反1日盛9A購01,0,0,0,0,0,0,0,0,0,0,0,0,0,1000,1000,0,0
050137,臺指反國票96購01,0,0,0,0,0,0,0,0,0,0,0,0,0,1000,1000,0,0
05013P,台積電元大96售05,0,0,0,0,0,0,0,0,0,0,0,0,0,8000,8000,0,0
050100,台積電永昌96購02,0,0,0,0,0,0,0,0,0,0,0,0,0,144000,144000,0,0
054194,國巨麥證96購02  ,0,0,0,10000,0,10000,0,0,0,0,0,0,0,10000,10000,0,0
054197,台積電永昌96購07,0,0,0,0,0,0,0,0,0,0,0,0,0,415000,415000,0,0
054231,國巨群益98購03  ,0,0,0,0,0,0,0,0,0,0,0,0,0,9000,9000,0,0
051259,鴻海永昌96購03  ,0,0,0,0,0,0,0,0,0,0,0,0,0,655000,655000,0,0
051154,國巨國泰96購03  ,0,0,0,0,0,0,0,0,0,0,0,0,0,25000,25000,0,0
052619,茂林國泰99購01  ,0,0,0,0,0,0,0,0,0,0,0,0,0,15000,15000,0,0
052633,國巨凱基96購05  ,0,0,0,0,0,0,0,0,0,0,0,0,0,240000,240000,0,0
052659,上証2X國票99購01,0,0,0,0,0,0,0,0,0,0,0,0,0,5000,5000,0,0
05241P,鴻海國泰97售04  ,0,0,0,0,0,0,0,0,0,0,0,0,0,45000,45000,0,0
052413,上証反中信97購01,0,0,0,0,0,0,0,0,0,0,0,0,0,44000,44000,0,0
052531,台積電國泰96購06,0,0,0,0,0,0,0,0,0,0,0,0,0,705000,705000,0,0
052532,台積電國泰96購07,0,0,0,0,0,0,0,0,0,0,0,0,0,499000,499000,0,0
054241,深中小元大98購01,0,0,0,0,0,0,0,0,0,0,0,0,0,20000,20000,0,0
054246,國巨元大96購12  ,0,0,0,0,0,0,0,0,0,0,0,0,0,30000,30000,0,0
052317,台積電元大96購11,0,0,0,0,0,0,0,0,0,0,0,0,0,2000,2000,0,0
052325,高股息中信99購01,0,0,0,0,0,0,0,0,0,0,0,0,0,113000,113000,0,0
052255,T50反1國泰96購01,0,0,0,0,0,0,0,0,0,0,0,0,0,1000,1000,0,0
05442P,鴻海元大96售13  ,0,0,0,0,0,0,0,0,0,0,0,0,0,50000,50000,0,0
053258,上証2X群益9A購03,0,0,0,0,0,0,0,0,0,0,0,0,0,188000,188000,0,0
055795,茂林國泰98購01  ,0,0,0,0,0,0,0,0,0,0,0,0,0,20000,20000,0,0
05305P,華新科國泰97售01,0,0,0,0,0,0,0,0,0,0,0,0,0,10000,10000,0,0
05315P,鴻海永昌96售08  ,0,0,0,0,0,0,0,0,0,0,0,0,0,70000,70000,0,0
05316P,台積電永昌96售06,0,0,0,0,0,0,0,0,0,0,0,0,0,325000,325000,0,0
053205,台光電麥證96購01,0,0,0,40000,0,40000,0,0,0,0,0,0,0,40000,40000,0,0
053226,國巨台新97購02  ,0,0,0,0,0,0,0,0,0,0,0,0,0,10000,10000,0,0
053032,國巨兆豐97購02  ,0,0,0,0,0,0,0,0,0,0,0,0,0,39000,39000,0,0
054128,台積電元大97購10,0,0,0,0,0,0,0,0,0,0,0,0,0,10000,10000,0,0
054138,晶技元大98購02  ,0,0,0,0,0,0,0,0,0,0,0,0,0,4000,4000,0,0
054112,台積電麥證96購02,0,0,0,100000,0,100000,0,0,0,0,0,0,0,100000,100000,0,0
053037,國巨凱基96購08  ,0,0,0,0,0,0,0,0,0,0,0,0,0,40000,40000,0,0
056867,華通麥證98購01  ,0,0,0,360000,0,360000,0,0,0,0,0,0,0,360000,360000,0,0
056888,元油2X元大99購06,0,0,0,0,0,0,0,0,0,0,0,0,0,10000,10000,0,0
056858,國巨群益99購03  ,0,0,0,0,0,0,0,0,0,0,0,0,0,20000,20000,0,0
056836,國巨元富98購01  ,0,0,0,0,0,0,0,0,0,0,0,0,0,10000,10000,0,0
056934,國巨元富98購04  ,0,0,0,0,0,0,0,0,0,0,0,0,0,1000,1000,0,0
055849,聯詠元大97購05  ,0,0,0,0,0,0,0,0,0,0,0,0,0,68000,68000,0,0
056917,國巨兆豐98購03  ,0,0,0,0,0,0,0,0,0,0,0,0,0,5000,5000,0,0
056910,超眾元大99購02  ,0,0,0,0,0,0,0,0,0,0,0,0,0,88000,88000,0,0
054677,智易台新98購02  ,0,0,0,0,0,0,0,0,0,0,0,0,0,80000,80000,0,0
054679,台積電康和99購01,0,0,0,0,0,0,0,0,0,0,0,0,0,3000,3000,0,0
054643,上証2X群益9B購01,0,0,0,0,0,0,0,0,0,0,0,0,0,55000,55000,0,0
054656,深中小元大97購01,0,0,0,0,0,0,0,0,0,0,0,0,0,170000,170000,0,0
054547,鴻海凱基98購02  ,0,0,0,0,0,0,0,0,0,0,0,0,0,1000,1000,0,0
053494,南亞科兆豐96購02,0,0,0,0,0,0,0,0,0,0,0,0,0,80000,80000,0,0
053559,台積電國泰98購01,0,0,0,0,0,0,0,0,0,0,0,0,0,132000,132000,0,0
053560,漢唐國泰98購01  ,0,0,0,0,0,0,0,0,0,0,0,0,0,20000,20000,0,0
053686,台積電元大97購08,0,0,0,0,0,0,0,0,0,0,0,0,0,13000,13000,0,0
053621,臺股指群益96購07,0,0,0,0,0,0,0,0,0,0,0,0,0,1000,1000,0,0
053759,晶相光國泰98購01,0,0,0,0,0,0,0,0,0,0,0,0,0,100000,100000,0,0
053811,國巨群益98購02  ,0,0,0,0,0,0,0,0,0,0,0,0,0,10000,10000,0,0
053842,聯發科統一96購08,0,0,0,0,0,0,0,0,0,0,0,0,0,600000,600000,0,0
052789,台積電麥證96購01,0,0,0,230000,0,230000,0,0,0,0,0,0,0,530000,530000,0,0
054725,國巨日盛97購01  ,0,0,0,0,0,0,0,0,0,0,0,0,0,20000,20000,0,0
053021,國巨國泰97購04  ,0,0,0,0,0,0,0,0,0,0,0,0,0,30000,30000,0,0
054017,茂林永豐96購02  ,0,0,0,0,0,0,0,0,0,0,0,0,0,2000,2000,0,0
052937,國巨兆豐97購01  ,0,0,0,0,0,0,0,0,0,0,0,0,0,10000,10000,0,0
059893,台積電台新9A購02,0,0,0,0,0,0,0,0,0,0,0,0,0,3000,3000,0,0
059907,道瓊指元大99購03,0,0,0,0,0,0,0,0,0,0,0,0,0,20000,20000,0,0
059908,元金2X元大99購01,0,0,0,0,0,0,0,0,0,0,0,0,0,30000,30000,0,0
059833,緯穎康和99購01  ,0,0,0,0,0,0,0,0,0,0,0,0,0,8000,8000,0,0
059956,玉山金康和99購01,0,0,0,0,0,0,0,0,0,0,0,0,0,17000,17000,0,0
060216,鴻海凱基9A購17  ,0,0,0,0,0,0,0,0,0,0,0,0,0,2000,2000,0,0
060113,祥碩元大9B購01  ,0,0,0,0,0,0,0,0,0,0,0,0,0,11000,11000,0,0
059427,國巨元大99購24  ,0,0,0,0,0,0,0,0,0,0,0,0,0,1000,1000,0,0
056402,智易群益98購02  ,0,0,0,0,0,0,0,0,0,0,0,0,0,15000,15000,0,0
05980P,台積電永昌96售09,0,0,0,0,0,0,0,0,0,0,0,0,0,1998000,1998000,0,0
059811,高股息凱基99購02,0,0,0,0,0,0,0,0,0,0,0,0,0,10000,10000,0,0
059745,欣興元富99購04  ,0,0,0,0,0,0,0,0,0,0,0,0,0,1000,1000,0,0
06023P,超眾國票96售03  ,0,0,0,0,0,0,0,0,0,0,0,0,0,4000,4000,0,0
060240,富邦金元大9A購01,0,0,0,0,0,0,0,0,0,0,0,0,0,68000,68000,0,0
056757,T50反1元大98購07,0,0,0,0,0,0,0,0,0,0,0,0,0,5000,5000,0,0
056771,嘉晶元大99購01  ,0,0,0,0,0,0,0,0,0,0,0,0,0,10000,10000,0,0
056379,玉晶光元富98購01,0,0,0,0,0,0,0,0,0,0,0,0,0,10000,10000,0,0
056333,台積電日盛9B購01,0,0,0,0,0,0,0,0,0,0,0,0,0,100000,100000,0,0
056700,華新科國泰99購03,0,0,0,0,0,0,0,0,0,0,0,0,0,50000,50000,0,0
056719,台虹永豐98購01  ,0,0,0,0,0,0,0,0,0,0,0,0,0,10000,10000,0,0
056655,旺宏元大99購02  ,0,0,0,0,0,0,0,0,0,0,0,0,0,68000,68000,0,0
056636,台積電日盛9A購01,0,0,0,0,0,0,0,0,0,0,0,0,0,501000,501000,0,0
056593,台積電元富98購02,0,0,0,0,0,0,0,0,0,0,0,0,0,20000,20000,0,0
056594,台積電元富98購03,0,0,0,0,0,0,0,0,0,0,0,0,0,66000,66000,0,0
056595,台積電元富98購04,0,0,0,0,0,0,0,0,0,0,0,0,0,10000,10000,0,0
056517,茂林兆豐99購01  ,0,0,0,0,0,0,0,0,0,0,0,0,0,25000,25000,0,0
056490,台積電國泰99購01,0,0,0,0,0,0,0,0,0,0,0,0,0,10000,10000,0,0
056540,聯詠凱基98購02  ,0,0,0,0,0,0,0,0,0,0,0,0,0,3000,3000,0,0
056435,台積電凱基98購09,0,0,0,0,0,0,0,0,0,0,0,0,0,2000,2000,0,0
056426,上証2X凱基9A購01,0,0,0,0,0,0,0,0,0,0,0,0,0,1000,1000,0,0
05643P,大立光中信98售01,0,0,0,0,0,0,0,0,0,0,0,0,0,70000,70000,0,0
056146,台虹元大98購01  ,0,0,0,0,0,0,0,0,0,0,0,0,0,19000,19000,0,0
054939,台積電元大97購15,0,0,0,0,0,0,0,0,0,0,0,0,0,30000,30000,0,0
054940,台積電元大97購16,0,0,0,0,0,0,0,0,0,0,0,0,0,40000,40000,0,0
05694P,台積電凱基96售09,0,0,0,0,0,0,0,0,0,0,0,0,0,118000,118000,0,0
056088,台郡統一97購02  ,0,0,0,0,0,0,0,0,0,0,0,0,0,48000,48000,0,0
056017,台積電群益97購04,0,0,0,0,0,0,0,0,0,0,0,0,0,1100000,1100000,0,0
055586,旺宏元大98購06  ,0,0,0,0,0,0,0,0,0,0,0,0,0,68000,68000,0,0
05568P,台積電統一96售03,0,0,0,0,0,0,0,0,0,0,0,0,0,50000,50000,0,0
055684,京鼎凱基97購01  ,0,0,0,0,0,0,0,0,0,0,0,0,0,70000,70000,0,0
056227,奇力新凱基98購04,0,0,0,0,0,0,0,0,0,0,0,0,0,99000,99000,0,0
056239,宏達電群益98購01,0,0,0,0,0,0,0,0,0,0,0,0,0,7000,7000,0,0
055155,奇力新元大99購01,0,0,0,0,0,0,0,0,0,0,0,0,0,10000,10000,0,0
055157,晶豪科元大97購01,0,0,0,0,0,0,0,0,0,0,0,0,0,5000,5000,0,0
055093,京鼎群益98購01  ,0,0,0,0,0,0,0,0,0,0,0,0,0,2000,2000,0,0
055106,台積電凱基98購05,0,0,0,0,0,0,0,0,0,0,0,0,0,40000,40000,0,0
055285,華新科元大99購03,0,0,0,0,0,0,0,0,0,0,0,0,0,21000,21000,0,0
055275,台積電元大97購19,0,0,0,0,0,0,0,0,0,0,0,0,0,37000,37000,0,0
055229,大毅國票97購02  ,0,0,0,0,0,0,0,0,0,0,0,0,0,5000,5000,0,0
055331,國巨兆豐99購01  ,0,0,0,0,0,0,0,0,0,0,0,0,0,15000,15000,0,0
055343,國巨凱基97購03  ,0,0,0,0,0,0,0,0,0,0,0,0,0,100000,100000,0,0
055377,揚明光元大98購01,0,0,0,0,0,0,0,0,0,0,0,0,0,50000,50000,0,0
055356,大立光凱基97購06,0,0,0,0,0,0,0,0,0,0,0,0,0,60000,60000,0,0
055353,華新科凱基98購03,0,0,0,0,0,0,0,0,0,0,0,0,0,2000,2000,0,0
055345,國巨凱基98購01  ,0,0,0,0,0,0,0,0,0,0,0,0,0,1000,1000,0,0
055346,國巨凱基98購02  ,0,0,0,0,0,0,0,0,0,0,0,0,0,1000,1000,0,0
055350,聯發科凱基97購02,0,0,0,0,0,0,0,0,0,0,0,0,0,28000,28000,0,0
055450,台積電元富97購01,0,0,0,0,0,0,0,0,0,0,0,0,0,30000,30000,0,0
055452,台積電元富97購03,0,0,0,0,0,0,0,0,0,0,0,0,0,178000,178000,0,0
055568,緯穎凱基97購02  ,0,0,0,0,0,0,0,0,0,0,0,0,0,30000,30000,0,0
055580,南茂統一97購01  ,0,0,0,0,0,0,0,0,0,0,0,0,0,3000,3000,0,0
055505,新唐元大97購02  ,0,0,0,0,0,0,0,0,0,0,0,0,0,30000,30000,0,0
055526,台積電群益97購02,0,0,0,0,0,0,0,0,0,0,0,0,0,10000,10000,0,0
059563,鴻海凱基9A購14  ,0,0,0,0,0,0,0,0,0,0,0,0,0,2000,2000,0,0
059564,鴻海凱基9A購15  ,0,0,0,0,0,0,0,0,0,0,0,0,0,2000,2000,0,0
058654,鴻海中信03購01  ,0,0,0,0,0,0,0,0,0,0,0,0,0,13000,13000,0,0
058650,台虹永豐9A購01  ,0,0,0,0,0,0,0,0,0,0,0,0,0,58000,58000,0,0
058621,華通國票9A購01  ,0,0,0,0,0,0,0,0,0,0,0,0,0,8000,8000,0,0
057812,友達元大9A購05  ,0,0,0,0,0,0,0,0,0,0,0,0,0,100000,100000,0,0
05781P,臺股指統一99售02,0,0,0,0,0,0,0,0,0,0,0,0,0,10000,10000,0,0
057790,台積電統一99購04,0,0,0,0,0,0,0,0,0,0,0,0,0,4000,4000,0,0
057769,T50反1群益98購02,0,0,0,0,0,0,0,0,0,0,0,0,0,1000,1000,0,0
057770,亞德客群益98購01,0,0,0,0,0,0,0,0,0,0,0,0,0,4000,4000,0,0
060185,聯發科元富04購01,0,0,0,0,0,0,0,0,0,0,0,0,0,3000,3000,0,0
060405,中租國泰9C購01  ,0,0,0,0,0,0,0,0,0,0,0,0,0,9000,9000,0,0
059610,上銀永豐99購02  ,0,0,0,0,0,0,0,0,0,0,0,0,0,5000,5000,0,0
059611,台積電永豐99購05,0,0,0,0,0,0,0,0,0,0,0,0,0,20000,20000,0,0
059590,台積電元大99購39,0,0,0,0,0,0,0,0,0,0,0,0,0,1000,1000,0,0
059591,台積電元大9A購04,0,0,0,0,0,0,0,0,0,0,0,0,0,1000,1000,0,0
059641,群創凱基99購06  ,0,0,0,0,0,0,0,0,0,0,0,0,0,40000,40000,0,0
059645,祥碩凱基99購05  ,0,0,0,0,0,0,0,0,0,0,0,0,0,20000,20000,0,0
058575,智邦群益99購01  ,0,0,0,0,0,0,0,0,0,0,0,0,0,17000,17000,0,0
059429,台積電元大99購35,0,0,0,0,0,0,0,0,0,0,0,0,0,1000,1000,0,0
059430,台積電元大99購36,0,0,0,0,0,0,0,0,0,0,0,0,0,1000,1000,0,0
059431,旺宏元大99購14  ,0,0,0,0,0,0,0,0,0,0,0,0,0,18000,18000,0,0
059468,智邦元大99購02  ,0,0,0,0,0,0,0,0,0,0,0,0,0,6000,6000,0,0
059507,鴻海永豐99購03  ,0,0,0,0,0,0,0,0,0,0,0,0,0,22000,22000,0,0
059681,華新科國泰9B購02,0,0,0,0,0,0,0,0,0,0,0,0,0,1000,1000,0,0
05969P,台積電台新96售04,0,0,0,0,0,0,0,0,0,0,0,0,0,10000,10000,0,0
059721,旺宏元大99購16  ,0,0,0,0,0,0,0,0,0,0,0,0,0,1000,1000,0,0
059716,鴻海元大99購35  ,0,0,0,0,0,0,0,0,0,0,0,0,0,5000,5000,0,0
059731,康控元大99購04  ,0,0,0,0,0,0,0,0,0,0,0,0,0,36000,36000,0,0
059538,健策凱基99購03  ,0,0,0,0,0,0,0,0,0,0,0,0,0,10000,10000,0,0
060037,鴻海國票99購10  ,0,0,0,0,0,0,0,0,0,0,0,0,0,6000,6000,0,0
057738,旺宏富邦9A購01  ,0,0,0,0,0,0,0,0,0,0,0,0,0,30000,30000,0,0
057440,台積電統一98購10,0,0,0,0,0,0,0,0,0,0,0,0,0,30000,30000,0,0
057448,致茂元富98購01  ,0,0,0,0,0,0,0,0,0,0,0,0,0,120000,120000,0,0
057463,華邦電永豐98購01,0,0,0,0,0,0,0,0,0,0,0,0,0,10000,10000,0,0
057538,緯穎元大98購07  ,0,0,0,0,0,0,0,0,0,0,0,0,0,1000,1000,0,0
060463,台積電元大9A購10,0,0,0,0,0,0,0,0,0,0,0,0,0,1000,1000,0,0
060464,台積電元大9A購11,0,0,0,0,0,0,0,0,0,0,0,0,0,1000,1000,0,0
060550,可成凱基9A購02  ,0,0,0,0,0,0,0,0,0,0,0,0,0,1000,1000,0,0
060545,台積電凱基9B購02,0,0,0,0,0,0,0,0,0,0,0,0,0,63000,63000,0,0
057353,玉晶光統一99購01,0,0,0,0,0,0,0,0,0,0,0,0,0,1000,1000,0,0
057328,京鼎群益99購02  ,0,0,0,0,0,0,0,0,0,0,0,0,0,2000,2000,0,0
058705,長榮航元大99購01,0,0,0,0,0,0,0,0,0,0,0,0,0,68000,68000,0,0
058742,鴻海康和99購01  ,0,0,0,0,0,0,0,0,0,0,0,0,0,3000,3000,0,0
058743,可成康和99購01  ,0,0,0,0,0,0,0,0,0,0,0,0,0,3000,3000,0,0
058713,國巨統一9B購02  ,0,0,0,0,0,0,0,0,0,0,0,0,0,53000,53000,0,0
058219,台灣50國票9A購02,0,0,0,0,0,0,0,0,0,0,0,0,0,1000,1000,0,0
058222,玉晶光統一9B購01,0,0,0,0,0,0,0,0,0,0,0,0,0,10000,10000,0,0
058249,緯穎元大99購04  ,0,0,0,0,0,0,0,0,0,0,0,0,0,2000,2000,0,0
057604,鴻海統一9C購01  ,0,0,0,0,0,0,0,0,0,0,0,0,0,2000,2000,0,0
057248,台積電統一98購08,0,0,0,0,0,0,0,0,0,0,0,0,0,40000,40000,0,0
057253,高股息中信99購02,0,0,0,0,0,0,0,0,0,0,0,0,0,192000,192000,0,0
057255,聯發科麥證98購02,0,0,0,54000,0,54000,0,0,0,0,0,0,0,54000,54000,0,0
057265,聯詠兆豐98購01  ,0,0,0,0,0,0,0,0,0,0,0,0,0,167000,167000,0,0
057236,聯詠凱基98購03  ,0,0,0,0,0,0,0,0,0,0,0,0,0,49000,49000,0,0
057650,力成元大98購04  ,0,0,0,0,0,0,0,0,0,0,0,0,0,68000,68000,0,0
057861,台積電凱基98購16,0,0,0,0,0,0,0,0,0,0,0,0,0,6000,6000,0,0
05787P,臺股指永昌96售04,0,0,0,0,0,0,0,0,0,0,0,0,0,11000,11000,0,0
05789P,臺股指永昌96售06,0,0,0,0,0,0,0,0,0,0,0,0,0,10000,10000,0,0
057281,大立光元大98購16,0,0,0,0,0,0,0,0,0,0,0,0,0,68000,68000,0,0
057950,T50正2元大9B購04,0,0,0,0,0,0,0,0,0,0,0,0,0,40000,40000,0,0
057983,緯穎永豐98購03  ,0,0,0,0,0,0,0,0,0,0,0,0,0,6000,6000,0,0
05800P,台積電兆豐96售04,0,0,0,0,0,0,0,0,0,0,0,0,0,81000,81000,0,0
059020,元油2X統一9B購02,0,0,0,0,0,0,0,0,0,0,0,0,0,10000,10000,0,0
060266,潤泰全國票9A購01,0,0,0,0,0,0,0,0,0,0,0,0,0,10000,10000,0,0
060273,T50反1元大9A購03,0,0,0,0,0,0,0,0,0,0,0,0,0,25000,25000,0,0
058986,華新科凱基9A購03,0,0,0,0,0,0,0,0,0,0,0,0,0,1000,1000,0,0
057943,可成國票99購03  ,0,0,0,0,0,0,0,0,0,0,0,0,0,23000,23000,0,0
059058,可成凱基9B購01  ,0,0,0,0,0,0,0,0,0,0,0,0,0,1000,1000,0,0
059059,宏達電凱基99購03,0,0,0,0,0,0,0,0,0,0,0,0,0,8000,8000,0,0
059050,元油2X凱基9B購08,0,0,0,0,0,0,0,0,0,0,0,0,0,80000,80000,0,0
059037,宏達電群益99購02,0,0,0,0,0,0,0,0,0,0,0,0,0,28000,28000,0,0
059216,台積電元大99購29,0,0,0,0,0,0,0,0,0,0,0,0,0,1000,1000,0,0
059217,台積電元大99購30,0,0,0,0,0,0,0,0,0,0,0,0,0,2000,2000,0,0
059219,旺宏元大99購12  ,0,0,0,0,0,0,0,0,0,0,0,0,0,3000,3000,0,0
059257,臺股指凱基99購35,0,0,0,0,0,0,0,0,0,0,0,0,0,1000,1000,0,0
059264,台光電中信99購02,0,0,0,0,0,0,0,0,0,0,0,0,0,20000,20000,0,0
059171,祥碩凱基99購04  ,0,0,0,0,0,0,0,0,0,0,0,0,0,4000,4000,0,0
059344,長榮航凱基99購01,0,0,0,0,0,0,0,0,0,0,0,0,0,20000,20000,0,0
059369,滬深2X元富9C購01,0,0,0,0,0,0,0,0,0,0,0,0,0,1000,1000,0,0
059398,滬深2X元富9C購02,0,0,0,0,0,0,0,0,0,0,0,0,0,1000,1000,0,0
059284,緯穎永豐99購03  ,0,0,0,0,0,0,0,0,0,0,0,0,0,10000,10000,0,0
058455,玉晶光永豐99購03,0,0,0,0,0,0,0,0,0,0,0,0,0,1000,1000,0,0
058499,滬深2X元大9C購01,0,0,0,0,0,0,0,0,0,0,0,0,0,5000,5000,0,0
058514,潤泰全元大99購01,0,0,0,0,0,0,0,0,0,0,0,0,0,40000,40000,0,0
058319,大毅永豐9A購01  ,0,0,0,0,0,0,0,0,0,0,0,0,0,11000,11000,0,0
058320,華新科永豐99購02,0,0,0,0,0,0,0,0,0,0,0,0,0,60000,60000,0,0
058313,台積電富邦9B購04,0,0,0,0,0,0,0,0,0,0,0,0,0,10000,10000,0,0
058375,群創凱基9B購04  ,0,0,0,0,0,0,0,0,0,0,0,0,0,40000,40000,0,0
058418,台積電麥證99購01,0,0,0,499000,0,499000,0,0,0,0,0,0,0,499000,499000,0,0
058420,聯發科麥證99購03,0,0,0,1000,0,1000,0,0,0,0,0,0,0,1000,1000,0,0
05815P,台積電凱基97售06,0,0,0,0,0,0,0,0,0,0,0,0,0,200000,200000,0,0
058815,華新科台新99購03,0,0,0,0,0,0,0,0,0,0,0,0,0,1000,1000,0,0
058812,台積電統一9B購06,0,0,0,0,0,0,0,0,0,0,0,0,0,3000,3000,0,0
058810,國巨統一9B購04  ,0,0,0,0,0,0,0,0,0,0,0,0,0,20000,20000,0,0
059068,台虹國票9A購01  ,0,0,0,0,0,0,0,0,0,0,0,0,0,30000,30000,0,0
059063,康控凱基99購04  ,0,0,0,0,0,0,0,0,0,0,0,0,0,5000,5000,0,0
059088,台積電元大99購27,0,0,0,0,0,0,0,0,0,0,0,0,0,1000,1000,0,0
057171,台光電元大9B購01,0,0,0,0,0,0,0,0,0,0,0,0,0,2000,2000,0,0
057222,鴻海國票99購04  ,0,0,0,0,0,0,0,0,0,0,0,0,0,1000,1000,0,0
05717P,鴻海元大97售07  ,0,0,0,0,0,0,0,0,0,0,0,0,0,20000,20000,0,0
057164,國巨元大98購14  ,0,0,0,0,0,0,0,0,0,0,0,0,0,1000,1000,0,0
058898,台積電元大99購20,0,0,0,0,0,0,0,0,0,0,0,0,0,150000,150000,0,0
058059,晶技元富98購01  ,0,0,0,0,0,0,0,0,0,0,0,0,0,24000,24000,0,0
05805P,義隆永豐96售02  ,0,0,0,0,0,0,0,0,0,0,0,0,0,30000,30000,0,0
058079,鴻海群益98購08  ,0,0,0,0,0,0,0,0,0,0,0,0,0,2000,2000,0,0
058983,旺宏凱基99購05  ,6000,0,6000,0,0,0,0,0,0,-6000,0,0,0,0,6000,-6000,0
058980,鴻海凱基99購06  ,0,0,0,0,0,0,0,0,0,0,0,0,0,1000,1000,0,0
058981,國巨凱基99購10  ,0,0,0,0,0,0,0,0,0,0,0,0,0,50000,50000,0,0
061018,台積電國票9B購05,0,0,0,0,0,0,0,0,0,0,0,0,0,1000,1000,0,0
061058,健策國票9A購05  ,0,0,0,0,0,0,0,0,0,0,0,0,0,5000,5000,0,0
06134P,緯穎元富97售03  ,0,0,0,0,0,0,0,0,0,0,0,0,0,100000,100000,0,0
061344,禾伸堂元大9A購02,0,0,0,0,0,0,0,0,0,0,0,0,0,55000,55000,0,0
061317,旺宏凱基9A購05  ,0,0,0,0,0,0,0,0,0,0,0,0,0,10000,10000,0,0
061259,台積電凱基9A購21,0,0,0,0,0,0,0,0,0,0,0,0,0,1000,1000,0,0
061306,瑞祺永豐9A購02  ,0,0,0,0,0,0,0,0,0,0,0,0,0,1000,1000,0,0
061233,國巨元大9A購17  ,0,0,0,0,0,0,0,0,0,0,0,0,0,10000,10000,0,0
061210,玉山金元大9A購02,0,0,0,0,0,0,0,0,0,0,0,0,0,3000,3000,0,0
061101,道瓊銀元大9A購02,0,0,0,0,0,0,0,0,0,0,0,0,0,95000,95000,0,0
061107,世芯元大9A購05  ,0,0,0,0,0,0,0,0,0,0,0,0,0,7000,7000,0,0
2852,第一保          ,3000,3000,0,0,0,0,0,0,0,0,0,0,0,0,0,0,0
2910,統領            ,1000,1000,0,0,0,0,0,0,0,0,0,0,0,0,0,0,0
2939,凱羿-KY         ,7000,7000,0,0,0,0,0,0,0,0,0,0,0,0,0,0,0
3164,景岳            ,4000,3000,1000,0,0,0,0,0,0,-1000,0,1000,-1000,0,0,0,0
1524,耿鼎            ,7000,7000,0,0,0,0,0,0,0,0,0,0,0,0,0,0,0
1454,台富            ,2000,2000,0,0,0,0,0,0,0,0,0,0,0,0,0,0,0
08167P,台積電兆豐9B售04,0,0,0,0,0,0,0,0,0,0,0,0,0,18000,18000,0,0
07888P,大立光國票9B售01,0,0,0,0,0,0,0,0,0,0,0,0,0,7000,7000,0,0
07763P,嘉澤永豐9A售02  ,0,0,0,0,0,0,0,0,0,0,0,0,0,58000,58000,0,0
07750P,台表科凱基9A售04,0,0,0,0,0,0,0,0,0,0,0,0,0,20000,20000,0,0
07766P,美律群益9A售03  ,0,0,0,0,0,0,0,0,0,0,0,0,0,33000,33000,0,0
08099P,聯發科中信9B售04,0,0,0,0,0,0,0,0,0,0,0,0,0,100000,100000,0,0
07489P,國巨國票9A售07  ,0,0,0,0,0,0,0,0,0,0,0,0,0,10000,10000,0,0
07611P,大立光國票9A售05,0,0,0,0,0,0,0,0,0,0,0,0,0,3000,3000,0,0
07682P,聯發科凱基9A售15,0,0,0,0,0,0,0,0,0,0,0,0,0,10000,10000,0,0
07217P,大立光凱基9A售05,0,0,0,0,0,0,0,0,0,0,0,0,0,10000,10000,0,0
07205P,鴻海凱基99售11  ,0,0,0,0,0,0,0,0,0,0,0,0,0,10000,10000,0,0
07395P,台積電群益99售13,0,0,0,0,0,0,0,0,0,0,0,0,0,10000,10000,0,0
07324P,台積電元大99售40,0,0,0,0,0,0,0,0,0,0,0,0,0,250000,250000,0,0
07352P,台積電國票99售11,0,0,0,0,0,0,0,0,0,0,0,0,0,20000,20000,0,0
4737,華廣            ,1000,1000,0,0,0,0,0,0,0,0,0,0,0,0,0,0,0
4545,銘鈺            ,3000,5000,-2000,0,0,0,0,0,0,2000,2000,0,2000,0,0,0,0
4930,燦星網          ,0,2000,-2000,0,0,0,0,0,0,2000,2000,0,2000,0,0,0,0
6491,晶碩            ,3000,3000,0,0,0,0,0,0,0,0,0,0,0,0,0,0,0
6581,鋼聯            ,1000,1000,0,0,0,0,0,0,0,0,0,0,0,0,0,0,0
6541,泰福-KY         ,186000,214000,-28000,0,0,0,0,0,0,28000,28000,0,28000,0,0,0,0
060638,玉晶光永豐9A購04,0,0,0,0,0,0,0,0,0,0,0,0,0,1000,1000,0,0
060651,瑞儀中信9B購01  ,0,0,0,0,0,0,0,0,0,0,0,0,0,100000,100000,0,0
060678,聯詠元大9A購03  ,0,0,0,0,0,0,0,0,0,0,0,0,0,50000,50000,0,0
8201,無敵            ,0,0,0,0,0,0,0,0,0,0,1000,1000,0,0,0,0,0
8114,振樺電          ,2000,2000,0,0,0,0,0,0,0,0,0,0,0,0,0,0,0
6674,鋐寶科技        ,1000,1000,0,0,0,0,0,0,0,0,0,0,0,0,0,0,0
060881,玉山金中信02購01,0,0,0,0,0,0,0,0,0,0,0,0,0,14000,14000,0,0
060756,鴻海元大9A購16  ,0,0,0,0,0,0,0,0,0,0,0,0,0,1000,1000,0,0
06076P,大立光凱基98售03,0,0,0,0,0,0,0,0,0,0,0,0,0,84000,84000,0,0
060808,欣興群益9A購01  ,0,0,0,0,0,0,0,0,0,0,0,0,0,1000,1000,0,0
060822,華通元大9A購05  ,0,0,0,0,0,0,0,0,0,0,0,0,0,14000,14000,0,0
060789,禾伸堂富邦9B購02,0,0,0,0,0,0,0,0,0,0,0,0,0,3000,3000,0,0
06083P,華通統一98售02  ,0,0,0,0,0,0,0,0,0,0,0,0,0,2000,2000,0,0
060859,鴻海永豐9A購01  ,0,0,0,0,0,0,0,0,0,0,0,0,0,1000,1000,0,0
06085P,義隆台新97售01  ,0,0,0,0,0,0,0,0,0,0,0,0,0,30000,30000,0,0
060866,世芯永豐9B購01  ,0,0,0,0,0,0,0,0,0,0,0,0,0,9000,9000,0,0
8940,新天地          ,6000,6000,0,0,0,0,0,0,0,0,0,0,0,0,0,0,0
8480,泰昇-KY         ,2000,2000,0,0,0,0,0,0,0,0,0,0,0,0,0,0,0
8443,阿瘦            ,1000,1000,0,0,0,0,0,0,0,0,0,0,0,0,0,0,0
2888A,新光金甲特      ,0,0,0,0,0,0,0,0,0,-184,0,184,-184,0,0,0,-184
1475,本盟            ,0,191,-191,0,0,0,0,0,0,0,0,0,0,0,0,0,-191
3023,信邦            ,575182,691000,-115818,0,0,0,0,24000,-24000,139000,79000,27000,52000,95000,8000,87000,-818
062780,旺宏元大01購01  ,0,0,0,0,0,0,0,0,0,-1000,0,0,0,7000,8000,-1000,-1000
062770,臺股指凱基9B購14,0,0,0,0,0,0,0,0,0,-1000,0,0,0,1000,2000,-1000,-1000
062764,世芯凱基9B購02  ,0,0,0,0,0,0,0,0,0,-1000,0,0,0,119000,120000,-1000,-1000
062937,旺宏凱基9B購08  ,0,0,0,0,0,0,0,0,0,-1000,0,0,0,7000,8000,-1000,-1000
063426,茂林凱基9B購03  ,0,0,0,0,0,0,0,0,0,-1000,0,0,0,0,1000,-1000,-1000
063440,上銀統一01購02  ,0,0,0,0,0,0,0,0,0,-1000,0,0,0,15000,16000,-1000,-1000
063441,台達電統一9C購01,0,0,0,0,0,0,0,0,0,-1000,0,0,0,22000,23000,-1000,-1000
063369,聚陽永豐9B購01  ,0,0,0,0,0,0,0,0,0,-1000,0,0,0,0,1000,-1000,-1000
063316,聯發科群益9C購03,0,0,0,0,0,0,0,0,0,-1000,0,0,0,56000,57000,-1000,-1000
063304,大立光凱基01購02,0,0,0,0,0,0,0,0,0,-1000,0,0,0,0,1000,-1000,-1000
063333,同欣電國票9C購01,0,0,0,0,0,0,0,0,0,-1000,0,0,0,10000,11000,-1000,-1000
063213,智伸科國票9C購01,0,0,0,0,0,0,0,0,0,-1000,0,0,0,7000,8000,-1000,-1000
063214,康控國票9C購01  ,0,0,0,0,0,0,0,0,0,-1000,0,0,0,10000,11000,-1000,-1000
063139,聯發科統一9B購07,0,0,0,0,0,0,0,0,0,-1000,0,0,0,0,1000,-1000,-1000
07113P,台積電兆豐99售03,0,0,0,0,0,0,0,0,0,-1000,0,0,0,0,1000,-1000,-1000
06955P,臻鼎元富99售01  ,0,0,0,0,0,0,0,0,0,-1000,0,0,0,0,1000,-1000,-1000
07050P,宏達電中信9B售01,0,0,0,0,0,0,0,0,0,-1000,0,0,0,0,1000,-1000,-1000
06746P,聯發科群益99售02,0,0,0,0,0,0,0,0,0,-1000,0,0,0,0,1000,-1000,-1000
06859P,元金2X中信9C售01,0,0,0,0,0,0,0,0,0,-1000,0,0,0,3000,4000,-1000,-1000
06369P,台積電凱基97售16,0,0,0,0,0,0,0,0,0,-1000,0,0,0,0,1000,-1000,-1000
063627,上銀元大9B購09  ,0,0,0,0,0,0,0,0,0,-1000,0,0,0,0,1000,-1000,-1000
063628,華通元大9B購09  ,0,0,0,0,0,0,0,0,0,-1000,0,0,0,0,1000,-1000,-1000
063565,旺宏元大9B購08  ,0,0,0,0,0,0,0,0,0,-1000,0,0,0,0,1000,-1000,-1000
063533,緯穎凱基9B購06  ,0,0,0,0,0,0,0,0,0,-1000,0,0,0,0,1000,-1000,-1000
06634P,欣興國票98售02  ,0,0,0,0,0,0,0,0,0,-1000,0,0,0,7000,8000,-1000,-1000
06650P,聯發科元大98售09,0,0,0,0,0,0,0,0,0,-1000,0,0,0,0,1000,-1000,-1000
06527P,T50正2富邦9C售01,0,0,0,0,0,0,0,0,0,-1000,0,0,0,5000,6000,-1000,-1000
061922,瑞昱凱基9B購01  ,0,0,0,0,0,0,0,0,0,-1000,0,0,0,50000,51000,-1000,-1000
062031,臻鼎群益9B購01  ,0,0,0,0,0,0,0,0,0,-1000,0,0,0,110000,111000,-1000,-1000
062007,台光電國泰9C購01,0,0,0,0,0,0,0,0,0,-1000,0,0,0,47000,48000,-1000,-1000
06176P,台積電元大97售22,0,0,0,0,0,0,0,0,0,-1000,0,0,0,0,1000,-1000,-1000
06184P,大立光元大97售06,0,0,0,0,0,0,0,0,0,-1000,0,0,0,0,1000,-1000,-1000
061616,鴻海群益9A購07  ,0,0,0,0,0,0,0,0,0,-1000,0,0,0,1000,2000,-1000,-1000
061655,微星國票9A購01  ,0,0,0,0,0,0,0,0,0,-1000,0,0,0,7000,8000,-1000,-1000
061448,旺宏中信9A購02  ,0,0,0,0,0,0,0,0,0,-1000,0,0,0,0,1000,-1000,-1000
061401,華擎兆豐9B購01  ,0,0,0,0,0,0,0,0,0,-1000,0,0,0,0,1000,-1000,-1000
061434,國巨麥證9A購04  ,0,0,0,0,1000,-1000,0,0,0,-1000,0,0,0,0,1000,-1000,-1000
061498,大立光國票9A購10,0,0,0,0,0,0,0,0,0,-1000,0,0,0,0,1000,-1000,-1000
061539,國巨群益9B購03  ,0,0,0,0,0,0,0,0,0,-1000,0,0,0,0,1000,-1000,-1000
062187,台勝科元大9B購02,0,0,0,0,0,0,0,0,0,-1000,0,0,0,0,1000,-1000,-1000
062111,台勝科國票9B購01,0,0,0,0,0,0,0,0,0,-1000,0,0,0,9000,10000,-1000,-1000
062117,燿華中信9B購01  ,0,0,0,0,0,0,0,0,0,-1000,0,0,0,0,1000,-1000,-1000
062097,台光電永豐9B購01,0,0,0,0,0,0,0,0,0,-1000,0,0,0,13000,14000,-1000,-1000
062330,可成統一9B購03  ,0,0,0,0,0,0,0,0,0,-1000,0,0,0,0,1000,-1000,-1000
062364,瑞昱元大9B購04  ,0,0,0,0,0,0,0,0,0,-1000,0,0,0,342000,343000,-1000,-1000
06244P,智易元富97售02  ,0,0,0,0,0,0,0,0,0,-1000,0,0,0,0,1000,-1000,-1000
062482,台表科國票9B購01,0,0,0,0,0,0,0,0,0,-1000,0,0,0,6000,7000,-1000,-1000
057142,力成兆豐98購01  ,0,0,0,0,0,0,0,0,0,-1000,0,0,0,0,1000,-1000,-1000
056617,美律永豐98購01  ,0,0,0,0,0,0,0,0,0,-1000,0,0,0,0,1000,-1000,-1000
056610,鴻海永豐98購01  ,0,0,0,0,0,0,0,0,0,-1000,0,0,0,13000,14000,-1000,-1000
059957,中信金康和99購01,0,0,0,0,0,0,0,0,0,-1000,0,0,0,0,1000,-1000,-1000
059941,聯發科永豐99購04,0,0,0,0,0,0,0,0,0,-1000,0,0,0,0,1000,-1000,-1000
059860,台積電群益9A購02,7000,0,7000,0,0,0,0,0,0,-8000,0,0,0,71000,79000,-8000,-1000
059937,旺宏永豐99購03  ,0,0,0,0,0,0,0,0,0,-1000,0,0,0,0,1000,-1000,-1000
052890,FB上証群益9B購01,0,0,0,0,0,0,0,0,0,-1000,0,0,0,0,1000,-1000,-1000
053902,S&P反1凱基97購01,0,0,0,0,0,0,0,0,0,-1000,0,0,0,0,1000,-1000,-1000
053809,上銀群益96購02  ,0,0,0,0,0,0,0,0,0,-1000,0,0,0,0,1000,-1000,-1000
053732,S&P反1中信9C購01,0,0,0,0,0,0,0,0,0,-1000,0,0,0,0,1000,-1000,-1000
05693P,滬深2X凱基98售02,0,0,0,0,0,0,0,0,0,-1000,0,0,0,0,1000,-1000,-1000
056843,冠德元富98購01  ,0,0,0,0,0,0,0,0,0,-1000,0,0,0,2000,3000,-1000,-1000
05684P,臺股指元大96售09,0,0,0,0,0,0,0,0,0,-1000,0,0,0,0,1000,-1000,-1000
055886,上銀統一97購02  ,0,0,0,0,0,0,0,0,0,-1000,0,0,0,0,1000,-1000,-1000
053184,世紀鋼元富96購01,0,0,0,0,0,0,0,0,0,-1000,0,0,0,0,1000,-1000,-1000
053111,緯創兆豐97購01  ,0,0,0,0,0,0,0,0,0,-1000,0,0,0,0,1000,-1000,-1000
055720,宏達電元大97購05,0,0,0,0,0,0,0,0,0,-1000,0,0,0,0,1000,-1000,-1000
052463,聯電統一96購01  ,0,0,0,0,0,0,0,0,0,-1000,0,0,0,0,1000,-1000,-1000
052514,嘉澤凱基96購01  ,0,0,0,0,0,0,0,0,0,-1000,0,0,0,0,1000,-1000,-1000
052578,大立光統一97購01,0,0,0,0,0,0,0,0,0,-1000,0,0,0,0,1000,-1000,-1000
051218,聯發科元富9B購02,0,0,0,0,0,0,0,0,0,-1000,0,0,0,0,1000,-1000,-1000
03424B,臺股指元大96熊26,0,0,0,0,0,0,0,0,0,-1000,0,0,0,0,1000,-1000,-1000
054237,茂林群益97購01  ,0,0,0,0,0,0,0,0,0,-1000,0,0,0,50000,51000,-1000,-1000
050754,元金2X元富9B購01,0,0,0,0,0,0,0,0,0,-1000,0,0,0,0,1000,-1000,-1000
050515,聯電元大96購01  ,0,0,0,0,0,0,0,0,0,-1000,0,0,0,90000,91000,-1000,-1000
048785,台積電元大96購01,0,0,0,0,0,0,0,0,0,-1000,0,0,0,5000,6000,-1000,-1000
051739,奇力新國票97購01,0,0,0,0,0,0,0,0,0,-1000,0,0,0,0,1000,-1000,-1000
046949,群創元大99購01  ,0,0,0,0,0,0,0,0,0,-1000,0,0,0,0,1000,-1000,-1000
0053,元大電子        ,0,0,0,0,0,0,0,0,0,-1000,0,0,0,7000,8000,-1000,-1000
051536,玉晶光國票97購01,0,0,0,0,0,0,0,0,0,-1000,0,0,0,12000,13000,-1000,-1000
061088,國巨統一9C購05  ,0,0,0,0,0,0,0,0,0,-1000,0,0,0,0,1000,-1000,-1000
061146,台表科中信9A購02,0,0,0,0,0,0,0,0,0,-1000,0,0,0,20000,21000,-1000,-1000
061152,微星群益9A購01  ,0,0,0,0,0,0,0,0,0,-1000,0,0,0,2000,3000,-1000,-1000
06117P,臺股指日盛97售02,0,0,0,0,0,0,0,0,0,-1000,0,0,0,0,1000,-1000,-1000
061194,聯鈞永豐9A購02  ,0,0,0,0,0,0,0,0,0,-1000,0,0,0,0,1000,-1000,-1000
061310,華新科麥證9A購01,0,0,0,0,1000,-1000,0,0,0,-1000,0,0,0,0,1000,-1000,-1000
061019,大毅國票9A購01  ,0,0,0,0,0,0,0,0,0,-1000,0,0,0,1000,2000,-1000,-1000
058967,可成麥證99購01  ,0,0,0,8000,9000,-1000,0,0,0,-1000,0,0,0,8000,9000,-1000,-1000
057168,旺宏元大99購03  ,0,0,0,0,0,0,0,0,0,-1000,0,0,0,3000,4000,-1000,-1000
05814P,臺股指國票96售07,0,0,0,0,0,0,0,0,0,-1000,0,0,0,0,1000,-1000,-1000
059268,鎧勝中信01購01  ,0,0,0,0,0,0,0,0,0,-1000,0,0,0,0,1000,-1000,-1000
059374,A50正2群益01購01,0,0,0,0,0,0,0,0,0,-1000,0,0,0,0,1000,-1000,-1000
059159,上銀凱基99購05  ,0,0,0,0,0,0,0,0,0,-1000,0,0,0,0,1000,-1000,-1000
05916P,聯發科元大96售20,0,0,0,0,0,0,0,0,0,-1000,0,0,0,0,1000,-1000,-1000
059049,元油2X凱基9A購12,0,0,0,0,0,0,0,0,0,-1000,0,0,0,0,1000,-1000,-1000
059425,SGBR2X元大9A購02,0,0,0,0,0,0,0,0,0,-1000,0,0,0,136000,137000,-1000,-1000
057975,台積電永豐98購05,0,0,0,0,0,0,0,0,0,-1000,0,0,0,1000,2000,-1000,-1000
05786P,臺股指永昌96售03,0,0,0,0,0,0,0,0,0,-1000,0,0,0,10000,11000,-1000,-1000
057639,國巨元大99購07  ,0,0,0,0,0,0,0,0,0,-1000,0,0,0,0,1000,-1000,-1000
058691,友訊國票9A購01  ,0,0,0,0,0,0,0,0,0,-1000,0,0,0,14000,15000,-1000,-1000
05732P,臺股指統一96售02,0,0,0,0,0,0,0,0,0,-1000,0,0,0,0,1000,-1000,-1000
060541,正隆凱基9A購01  ,0,0,0,0,0,0,0,0,0,-1000,0,0,0,43000,44000,-1000,-1000
060519,S&P500中信01購01,0,0,0,0,0,0,0,0,0,-1000,0,0,0,0,1000,-1000,-1000
060508,聯發科元大9A購04,0,0,0,0,0,0,0,0,0,-1000,0,0,0,0,1000,-1000,-1000
057542,上銀凱基99購01  ,0,0,0,0,0,0,0,0,0,-1000,0,0,0,0,1000,-1000,-1000
057504,技嘉麥證98購01  ,0,0,0,0,1000,-1000,0,0,0,-1000,0,0,0,0,1000,-1000,-1000
057386,聯發科永豐98購04,0,0,0,0,0,0,0,0,0,-1000,0,0,0,0,1000,-1000,-1000
057756,瑞昱日盛99購01  ,0,0,0,0,0,0,0,0,0,-1000,0,0,0,0,1000,-1000,-1000
06003P,亞光康和96售02  ,0,0,0,0,0,0,0,0,0,-1000,0,0,0,0,1000,-1000,-1000
060011,臺股指群益9C購06,0,0,0,0,0,0,0,0,0,-1000,0,0,0,2000,3000,-1000,-1000
060012,電子類群益99購02,0,0,0,0,0,0,0,0,0,-1000,0,0,0,0,1000,-1000,-1000
05766P,A50正2凱基99售01,0,0,0,0,0,0,0,0,0,-1000,0,0,0,0,1000,-1000,-1000
060127,牧德永豐99購02  ,0,0,0,0,0,0,0,0,0,-1000,0,0,0,0,1000,-1000,-1000
060143,台積電國票9B購03,0,0,0,0,0,0,0,0,0,-1000,0,0,0,1000,2000,-1000,-1000
059722,南亞科元大99購02,0,0,0,0,0,0,0,0,0,-1000,0,0,0,9000,10000,-1000,-1000
059663,旭富元大9C購02  ,0,0,0,0,0,0,0,0,0,-1000,0,0,0,1000,2000,-1000,-1000
059580,大立光元富99購07,0,0,0,0,0,0,0,0,0,-1000,0,0,0,5000,6000,-1000,-1000
059617,A50正2群益01購02,0,0,0,0,0,0,0,0,0,-1000,0,0,0,0,1000,-1000,-1000
060313,淘帝永豐9A購01  ,0,0,0,0,0,0,0,0,0,-1000,0,0,0,15000,16000,-1000,-1000
060294,嘉澤元大9A購01  ,0,0,0,0,0,0,0,0,0,-1000,0,0,0,4000,5000,-1000,-1000
058659,力成中信99購01  ,0,0,0,0,0,0,0,0,0,-1000,0,0,0,0,1000,-1000,-1000
3011,今皓            ,0,1000,-1000,0,0,0,0,0,0,0,0,0,0,0,0,0,-1000
2882B,國泰金乙特      ,0,0,0,0,0,0,0,0,0,-1000,2000,3000,-1000,0,0,0,-1000
2611,志信            ,3000,4000,-1000,0,0,0,0,0,0,0,0,0,0,0,0,0,-1000
2440,太空梭          ,0,1000,-1000,0,0,0,0,0,0,0,0,0,0,0,0,0,-1000
2477,美隆電          ,0,1000,-1000,0,0,0,0,0,0,0,0,0,0,0,0,0,-1000
2423,固緯            ,2000,3000,-1000,0,0,0,0,0,0,0,0,0,0,0,0,0,-1000
1470,大統新創        ,0,1000,-1000,0,0,0,0,0,0,0,0,0,0,0,0,0,-1000
1471,首利            ,0,1000,-1000,0,0,0,0,0,0,0,0,0,0,0,0,0,-1000
1453,大將            ,0,1000,-1000,0,0,0,0,0,0,0,0,0,0,0,0,0,-1000
1516,川飛            ,0,1000,-1000,0,0,0,0,0,0,0,0,0,0,0,0,0,-1000
08205P,智邦凱基9B售03  ,0,0,0,0,0,0,0,0,0,-1000,0,0,0,0,1000,-1000,-1000
1233,天仁            ,0,1000,-1000,0,0,0,0,0,0,0,0,0,0,0,0,0,-1000
1735,日勝化          ,0,1000,-1000,0,0,0,0,0,0,0,0,0,0,0,0,0,-1000
1726,永記            ,0,1000,-1000,0,0,0,0,0,0,0,0,0,0,0,0,0,-1000
1618,合機            ,2000,3000,-1000,0,0,0,0,0,0,0,0,0,0,0,0,0,-1000
1583,程泰            ,0,1000,-1000,0,0,0,0,0,0,0,0,0,0,0,0,0,-1000
2243,宏旭-KY         ,0,0,0,0,0,0,0,0,0,-1000,0,1000,-1000,0,0,0,-1000
2024,志聯            ,1000,1000,0,0,0,0,0,0,0,-1000,0,1000,-1000,0,0,0,-1000
2028,威致            ,0,1000,-1000,0,0,0,0,0,0,0,0,0,0,0,0,0,-1000
2008,高興昌          ,0,1000,-1000,0,0,0,0,0,0,0,0,0,0,0,0,0,-1000
2009,第一銅          ,0,1000,-1000,0,0,0,0,0,0,0,0,0,0,0,0,0,-1000
1817,凱撒衛          ,0,1000,-1000,0,0,0,0,0,0,0,0,0,0,0,0,0,-1000
07293P,臺股指凱基99售45,0,0,0,0,0,0,0,0,0,-1000,0,0,0,0,1000,-1000,-1000
07178P,臺股指凱基99售20,0,0,0,0,0,0,0,0,0,-1000,0,0,0,0,1000,-1000,-1000
07673P,電子類元大9A售01,0,0,0,0,0,0,0,0,0,-1000,0,0,0,3000,4000,-1000,-1000
07444P,聯發科凱基9A售10,0,0,0,0,0,0,0,0,0,-1000,0,0,0,0,1000,-1000,-1000
07564P,臺股指中信01售01,0,0,0,0,0,0,0,0,0,-1000,0,0,0,0,1000,-1000,-1000
07787P,國巨凱基9A售17  ,0,0,0,0,0,0,0,0,0,-1000,0,0,0,0,1000,-1000,-1000
07747P,晶技凱基9A售04  ,0,0,0,0,0,0,0,0,0,-1000,0,0,0,9000,10000,-1000,-1000
07903P,台積電群益9B售03,0,0,0,0,0,0,0,0,0,-1000,0,0,0,0,1000,-1000,-1000
07949P,滬深2X元大9B售04,0,0,0,0,0,0,0,0,0,-1000,0,0,0,0,1000,-1000,-1000
8466,美吉吉-KY       ,0,1000,-1000,0,0,0,0,0,0,0,0,0,0,0,0,0,-1000
9906,欣巴巴          ,0,1000,-1000,0,0,0,0,0,0,0,0,0,0,0,0,0,-1000
9931,欣高            ,0,1000,-1000,0,0,0,0,0,0,0,0,0,0,0,0,0,-1000
060891,世芯統一9A購01  ,0,0,0,0,0,0,0,0,0,-1000,0,0,0,0,1000,-1000,-1000
060898,世芯凱基9A購03  ,0,0,0,0,0,0,0,0,0,-1000,0,0,0,0,1000,-1000,-1000
6655,科定            ,0,1000,-1000,0,0,0,0,0,0,0,0,0,0,0,0,0,-1000
060676,京元電元大9A購03,0,0,0,0,0,0,0,0,0,-1000,0,0,0,68000,69000,-1000,-1000
6192,巨路            ,8000,9000,-1000,0,0,0,0,0,0,0,0,0,0,0,0,0,-1000
6209,今國光          ,25000,26000,-1000,0,0,0,0,0,0,0,0,0,0,0,0,0,-1000
5283,禾聯碩          ,0,0,0,0,0,0,0,0,0,-1000,0,0,0,0,1000,-1000,-1000
5284,jpp-KY          ,2000,3000,-1000,0,0,0,0,0,0,0,0,0,0,0,0,0,-1000
4137,麗豐-KY         ,101000,78000,23000,0,0,0,0,0,0,-24000,0,25000,-25000,3000,2000,1000,-1000
3311,閎暉            ,9000,10000,-1000,0,0,0,0,0,0,0,0,0,0,0,0,0,-1000
3494,誠研            ,0,1000,-1000,0,0,0,0,0,0,0,0,0,0,0,0,0,-1000
062502,旺宏群益9C購01  ,0,0,0,0,0,0,0,0,0,-2000,0,0,0,0,2000,-2000,-2000
062386,京鼎國泰9C購01  ,0,0,0,0,0,0,0,0,0,-2000,0,0,0,0,2000,-2000,-2000
062195,聚陽中信9C購01  ,0,0,0,0,0,0,0,0,0,-2000,0,0,0,20000,22000,-2000,-2000
061530,智邦台新9A購02  ,0,0,0,0,0,0,0,0,0,-2000,0,0,0,8000,10000,-2000,-2000
061504,祥碩國票9A購02  ,0,0,0,0,0,0,0,0,0,-2000,0,0,0,0,2000,-2000,-2000
061443,大立光統一9C購02,0,0,0,0,0,0,0,0,0,-2000,0,0,0,0,2000,-2000,-2000
061719,緯穎凱基9A購06  ,0,0,0,0,0,0,0,0,0,-2000,0,0,0,2000,4000,-2000,-2000
061633,統一元大9A購01  ,0,0,0,0,0,0,0,0,0,-2000,0,0,0,75000,77000,-2000,-2000
061894,台積電永豐9B購01,0,0,0,0,0,0,0,0,0,-2000,0,0,0,0,2000,-2000,-2000
062024,臺股指中信9C購05,0,0,0,0,0,0,0,0,0,-2000,0,0,0,0,2000,-2000,-2000
062000,臺股指元大9B購24,0,0,0,0,0,0,0,0,0,-2000,0,0,0,2000,4000,-2000,-2000
062037,華新凱基9B購01  ,0,0,0,0,0,0,0,0,0,-2000,0,0,0,10000,12000,-2000,-2000
061943,上銀群益9B購02  ,0,0,0,0,0,0,0,0,0,-2000,0,0,0,0,2000,-2000,-2000
06551P,貿聯元大98售05  ,0,0,0,0,0,0,0,0,0,-2000,0,0,0,48000,50000,-2000,-2000
06451P,聯發科元大98售04,0,0,0,0,0,0,0,0,0,-2000,0,0,0,0,2000,-2000,-2000
063642,茂林元大9B購08  ,0,0,0,0,0,0,0,0,0,-2000,0,0,0,0,2000,-2000,-2000
063646,帆宣元大9B購02  ,0,0,0,0,0,0,0,0,0,-2000,0,0,0,0,2000,-2000,-2000
063472,茂林元大9B購04  ,0,0,0,0,0,0,0,0,0,-2000,0,0,0,39000,41000,-2000,-2000
063531,台表科凱基9B購04,0,0,0,0,0,0,0,0,0,-2000,0,0,0,0,2000,-2000,-2000
06747P,大立光群益99售04,0,0,0,0,0,0,0,0,0,-2000,0,0,0,0,2000,-2000,-2000
07067P,旺宏台新99售02  ,0,0,0,0,0,0,0,0,0,-2000,0,0,0,77000,79000,-2000,-2000
07084P,S&P正2元富9B售02,0,0,0,0,0,0,0,0,0,-2000,0,0,0,0,2000,-2000,-2000
063273,緯穎兆豐9C購01  ,0,0,0,0,0,0,0,0,0,-2000,0,0,0,0,2000,-2000,-2000
063353,上銀元富9B購03  ,0,0,0,0,0,0,0,0,0,-2000,0,0,0,2000,4000,-2000,-2000
063291,緯穎元大01購01  ,0,0,0,0,0,0,0,0,0,-2000,0,0,0,0,2000,-2000,-2000
063366,台表科富邦9C購02,0,0,0,0,0,0,0,0,0,-2000,0,0,0,0,2000,-2000,-2000
06294P,臺股指國票97售08,0,0,0,0,0,0,0,0,0,-2000,0,0,0,0,2000,-2000,-2000
062737,聯發科國票9B購03,0,0,0,0,0,0,0,0,0,-2000,0,0,0,5000,7000,-2000,-2000
062771,臺股指凱基9B購15,0,0,0,0,0,0,0,0,0,-2000,0,0,0,0,2000,-2000,-2000
062895,道瓊銀元大9C購01,0,0,0,0,0,0,0,0,0,-2000,0,0,0,11000,13000,-2000,-2000
020004,兆豐電菁英30N   ,0,0,0,0,0,0,0,0,0,-2000,0,0,0,0,2000,-2000,-2000
00735,國泰臺韓科技    ,0,31000,-31000,0,0,0,0,0,0,29000,0,0,0,230000,201000,29000,-2000
03675C,臺股指元大04牛02,0,0,0,0,0,0,0,0,0,-2000,0,0,0,1000,3000,-2000,-2000
03052X,元展49          ,0,0,0,0,0,0,0,0,0,-2000,0,0,0,0,2000,-2000,-2000
03444B,臺股指元大9C熊02,0,0,0,0,0,0,0,0,0,-2000,0,0,0,0,2000,-2000,-2000
05263P,台積電元大96售09,0,0,0,0,0,0,0,0,0,-2000,0,0,0,0,2000,-2000,-2000
052388,旺宏群益96購05  ,0,0,0,0,0,0,0,0,0,-2000,0,0,0,0,2000,-2000,-2000
054388,漢唐統一97購02  ,0,0,0,0,0,0,0,0,0,-2000,0,0,0,0,2000,-2000,-2000
054332,世芯永豐97購01  ,0,0,0,0,0,0,0,0,0,-2000,0,0,0,121000,123000,-2000,-2000
055973,亞德客統一97購01,0,0,0,0,0,0,0,0,0,-2000,0,0,0,0,2000,-2000,-2000
053729,聯茂凱基96購05  ,0,0,0,0,0,0,0,0,0,-2000,0,0,0,10000,12000,-2000,-2000
05347P,滬深2X元富9B售02,0,0,0,0,0,0,0,0,0,-2000,0,0,0,0,2000,-2000,-2000
054569,GIS群益98購01   ,0,0,0,0,0,0,0,0,0,-2000,0,0,0,0,2000,-2000,-2000
060221,大立光凱基9A購07,0,0,0,0,0,0,0,0,0,-2000,0,0,0,0,2000,-2000,-2000
056439,華邦電凱基98購02,0,0,0,0,0,0,0,0,0,-2000,0,0,0,0,2000,-2000,-2000
055251,華新科統一99購01,0,0,0,0,0,0,0,0,0,-2000,0,0,0,0,2000,-2000,-2000
056207,茂林永豐97購03  ,0,0,0,0,0,0,0,0,0,-2000,0,0,0,5000,7000,-2000,-2000
055584,國巨元大97購11  ,0,0,0,0,0,0,0,0,0,-2000,0,0,0,47000,49000,-2000,-2000
054831,緯穎國泰98購01  ,0,0,0,0,0,0,0,0,0,-2000,0,0,0,0,2000,-2000,-2000
054841,亞德客兆豐97購01,0,0,0,0,0,0,0,0,0,-2000,0,0,0,0,2000,-2000,-2000
055021,亞德客國泰98購01,0,0,0,0,0,0,0,0,0,-2000,0,0,0,0,2000,-2000,-2000
059541,T50正2康和99購01,0,0,0,0,0,0,0,0,0,-2000,0,0,0,0,2000,-2000,-2000
059594,奇力新元大9B購01,0,0,0,0,0,0,0,0,0,-2000,0,0,0,0,2000,-2000,-2000
059662,旭富元大9C購01  ,0,0,0,0,0,0,0,0,0,-2000,0,0,0,29000,31000,-2000,-2000
059674,玉山金元富99購02,0,0,0,0,0,0,0,0,0,-2000,0,0,0,0,2000,-2000,-2000
05970P,超眾永豐96售03  ,0,0,0,0,0,0,0,0,0,-2000,0,0,0,4000,6000,-2000,-2000
059733,緯穎元大99購08  ,0,0,0,0,0,0,0,0,0,-2000,0,0,0,0,2000,-2000,-2000
060124,奇力新永豐99購03,0,0,0,0,0,0,0,0,0,-2000,0,0,0,0,2000,-2000,-2000
058576,南亞科群益99購01,0,0,0,0,0,0,0,0,0,-2000,0,0,0,10000,12000,-2000,-2000
057563,旭富國泰9A購01  ,0,0,0,0,0,0,0,0,0,-2000,0,0,0,0,2000,-2000,-2000
060478,南電元大9A購01  ,0,0,0,0,0,0,0,0,0,-2000,0,0,0,12000,14000,-2000,-2000
060442,滬深2X元大9A購02,0,0,0,0,0,0,0,0,0,-2000,0,0,0,0,2000,-2000,-2000
060537,台灣50凱基9B購01,0,0,0,0,0,0,0,0,0,-2000,0,0,0,0,2000,-2000,-2000
058284,滬深反群益01購01,0,0,0,0,0,0,0,0,0,-2000,0,0,0,0,2000,-2000,-2000
058671,旺宏群益9A購01  ,0,0,0,0,0,0,0,0,0,-2000,0,0,0,0,2000,-2000,-2000
05730P,臺股指凱基97售03,0,0,0,0,0,0,0,0,0,-2000,0,0,0,0,2000,-2000,-2000
057991,健策統一9C購01  ,0,0,0,0,0,0,0,0,0,-2000,0,0,0,28000,30000,-2000,-2000
057946,晶相光國票99購01,0,0,0,0,0,0,0,0,0,-2000,0,0,0,0,2000,-2000,-2000
05793P,臺股指中信99售08,0,0,0,0,0,0,0,0,0,-2000,0,0,0,5000,7000,-2000,-2000
059368,T50正2元富99購02,0,0,0,0,0,0,0,0,0,-2000,0,0,0,0,2000,-2000,-2000
058781,康友國票9A購01  ,0,0,0,0,0,0,0,0,0,-2000,0,0,0,0,2000,-2000,-2000
058784,臺股指國票99購03,0,0,0,0,0,0,0,0,0,-2000,0,0,0,4000,6000,-2000,-2000
059075,FBVIX元大99購01 ,0,0,0,0,0,0,0,0,0,-2000,0,0,0,6000,8000,-2000,-2000
058486,大立光國票9A購01,0,0,0,0,0,0,0,0,0,-2000,0,0,0,0,2000,-2000,-2000
058037,台灣50元大9B購02,0,0,0,0,0,0,0,0,0,-2000,0,0,0,0,2000,-2000,-2000
058086,鴻海元大98購14  ,0,0,0,0,0,0,0,0,0,-2000,0,0,0,0,2000,-2000,-2000
058971,台積電永豐99購03,0,0,0,0,0,0,0,0,0,-2000,0,0,0,0,2000,-2000,-2000
061020,超眾國票9A購02  ,0,0,0,0,0,0,0,0,0,-2000,0,0,0,36000,38000,-2000,-2000
061009,台灣50麥證02購02,0,0,0,0,2000,-2000,0,0,0,-2000,0,0,0,0,2000,-2000,-2000
061313,滬深2X凱基9B購05,0,0,0,0,0,0,0,0,0,-2000,0,0,0,0,2000,-2000,-2000
061338,台積電元大9A購28,0,0,0,0,0,0,0,0,0,-2000,0,0,0,5000,7000,-2000,-2000
061265,富邦金凱基9B購01,0,0,0,0,0,0,0,0,0,-2000,0,0,0,0,2000,-2000,-2000
061376,瑞昱永豐9A購02  ,0,0,0,0,0,0,0,0,0,-2000,0,0,0,0,2000,-2000,-2000
061148,道瓊反群益9A購02,0,0,0,0,0,0,0,0,0,-2000,0,0,0,0,2000,-2000,-2000
061089,台積電統一9C購04,0,0,0,0,0,0,0,0,0,-2000,0,0,0,0,2000,-2000,-2000
5525,順天            ,0,2000,-2000,0,0,0,0,0,0,0,0,0,0,0,0,0,-2000
5907,大洋-KY         ,25000,27000,-2000,0,0,0,0,0,0,0,0,0,0,0,0,0,-2000
060627,國巨國泰9B購05  ,0,0,0,0,0,0,0,0,0,-2000,0,0,0,0,2000,-2000,-2000
060970,T50反1元大9A購08,0,0,0,0,0,0,0,0,0,-2000,0,0,0,0,2000,-2000,-2000
8070,長華*           ,0,2000,-2000,0,0,0,0,0,0,0,0,0,0,0,0,0,-2000
060839,聯發科國票9A購02,0,0,0,0,0,0,0,0,0,-2000,0,0,0,0,2000,-2000,-2000
060731,奇力新群益9A購01,0,0,0,0,0,0,0,0,0,-2000,0,0,0,4000,6000,-2000,-2000
9937,全國            ,0,2000,-2000,0,0,0,0,0,0,0,0,0,0,0,0,0,-2000
8481,政伸            ,0,2000,-2000,0,0,0,0,0,0,0,0,0,0,0,0,0,-2000
8478,東哥遊艇        ,1000,3000,-2000,0,0,0,0,0,0,0,0,0,0,0,0,0,-2000
07913P,友達元大01售01  ,0,0,0,0,0,0,0,0,0,-2000,0,0,0,74000,76000,-2000,-2000
07892P,臺股指國票9B售02,0,0,0,0,0,0,0,0,0,-2000,0,0,0,0,2000,-2000,-2000
07877P,晶技永豐9B售01  ,0,0,0,0,0,0,0,0,0,-2000,0,0,0,0,2000,-2000,-2000
08071P,臺股指富邦9B售04,0,0,0,0,0,0,0,0,0,-2000,0,0,0,0,2000,-2000,-2000
07980P,臺股指凱基02售01,0,0,0,0,0,0,0,0,0,-2000,0,0,0,0,2000,-2000,-2000
07644P,南電凱基9A售03  ,0,0,0,0,0,0,0,0,0,-2000,0,0,0,8000,10000,-2000,-2000
07590P,玉晶光國票9A售03,0,0,0,0,0,0,0,0,0,-2000,0,0,0,0,2000,-2000,-2000
07348P,滬深2X凱基9A售04,0,0,0,0,0,0,0,0,0,-2000,0,0,0,0,2000,-2000,-2000
07388P,臺股指群益9C售07,0,0,0,0,0,0,0,0,0,-2000,0,0,0,0,2000,-2000,-2000
2114,鑫永銓          ,0,2000,-2000,0,0,0,0,0,0,0,0,0,0,0,0,0,-2000
1568,倉佑            ,0,1000,-1000,0,0,0,0,0,0,-1000,0,1000,-1000,0,0,0,-2000
1535,中宇            ,0,2000,-2000,0,0,0,0,0,0,0,0,0,0,0,0,0,-2000
1539,巨庭            ,4000,6000,-2000,0,0,0,0,0,0,0,0,0,0,0,0,0,-2000
1727,中華化          ,0,2000,-2000,0,0,0,0,0,0,0,0,0,0,0,0,0,-2000
1805,寶徠            ,0,2000,-2000,0,0,0,0,0,0,0,0,0,0,0,0,0,-2000
1235,興泰            ,0,2000,-2000,0,0,0,0,0,0,0,0,0,0,0,0,0,-2000
08182P,金像電永豐9B售01,0,0,0,0,0,0,0,0,0,-2000,0,0,0,0,2000,-2000,-2000
08196P,上銀元大9B售07  ,0,0,0,0,0,0,0,0,0,-2000,0,0,0,0,2000,-2000,-2000
1528,恩德            ,0,2000,-2000,0,0,0,0,0,0,0,0,0,0,0,0,0,-2000
1456,怡華            ,0,0,0,0,0,0,0,0,0,-2000,0,2000,-2000,0,0,0,-2000
1441,大東            ,0,2000,-2000,0,0,0,0,0,0,0,0,0,0,0,0,0,-2000
1416,廣豐            ,0,2000,-2000,0,0,0,0,0,0,0,0,0,0,0,0,0,-2000
1419,新紡            ,2000,4000,-2000,0,0,0,0,0,0,0,0,0,0,0,0,0,-2000
2358,廷鑫            ,3000,5000,-2000,0,0,0,0,0,0,0,0,0,0,0,0,0,-2000
2443,億麗            ,1000,3000,-2000,0,0,0,0,0,0,0,0,0,0,0,0,0,-2000
2543,皇昌            ,0,2000,-2000,0,0,0,0,0,0,0,0,0,0,0,0,0,-2000
2539,櫻花建          ,20000,22000,-2000,0,0,0,0,0,0,0,0,0,0,0,0,0,-2000
2491,吉祥全          ,0,0,0,0,0,0,0,0,0,-2000,0,2000,-2000,0,0,0,-2000
2748,雲品            ,13000,15000,-2000,0,0,0,0,0,0,0,0,0,0,0,0,0,-2000
3041,揚智            ,119000,121000,-2000,0,0,0,0,0,0,0,0,0,0,0,0,0,-2000
6666,羅麗芬-KY       ,3000,5000,-2000,0,0,0,0,0,0,-396,0,0,0,0,396,-396,-2396
062993,華新科群益9B購05,0,0,0,0,0,0,0,0,0,-3000,0,0,0,4000,7000,-3000,-3000
063318,京鼎群益9C購02  ,0,0,0,0,0,0,0,0,0,-3000,0,0,0,102000,105000,-3000,-3000
07069P,欣興元富99售02  ,0,0,0,0,0,0,0,0,0,-3000,0,0,0,1000,4000,-3000,-3000
07134P,臺股指元大9A售28,0,0,0,0,0,0,0,0,0,-3000,0,0,0,30000,33000,-3000,-3000
06990P,康友元富99售03  ,0,0,0,0,0,0,0,0,0,-3000,0,0,0,0,3000,-3000,-3000
06730P,祥碩元大98售07  ,0,0,0,0,0,0,0,0,0,-3000,0,0,0,0,3000,-3000,-3000
063527,美食凱基01購01  ,0,0,0,0,0,0,0,0,0,-3000,0,0,0,0,3000,-3000,-3000
063496,儒鴻永豐9B購01  ,0,0,0,0,0,0,0,0,0,-3000,0,0,0,30000,33000,-3000,-3000
063487,國巨國泰01購02  ,0,0,0,0,0,0,0,0,0,-3000,0,0,0,18000,21000,-3000,-3000
063658,瑞祺元富9B購01  ,0,0,0,0,0,0,0,0,0,-3000,0,0,0,0,3000,-3000,-3000
06417P,台積電兆豐97售03,0,0,0,0,0,0,0,0,0,-3000,0,0,0,4000,7000,-3000,-3000
06485P,玉晶光群益9A售02,0,0,0,0,0,0,0,0,0,-3000,0,0,0,4000,7000,-3000,-3000
061909,台積電中信05購02,0,0,0,0,0,0,0,0,0,-3000,0,0,0,0,3000,-3000,-3000
062041,華擎凱基9C購01  ,0,0,0,0,0,0,0,0,0,-3000,0,0,0,0,3000,-3000,-3000
061837,華新科凱基05購02,0,0,0,0,0,0,0,0,0,-3000,0,0,0,0,3000,-3000,-3000
061753,南亞科台新9B購01,0,0,0,0,0,0,0,0,0,-3000,0,0,0,10000,13000,-3000,-3000
061779,上銀群益9B購01  ,0,0,0,0,0,0,0,0,0,-3000,0,0,0,0,3000,-3000,-3000
061556,台積電國票9A購08,0,0,0,0,0,0,0,0,0,-3000,0,0,0,19000,22000,-3000,-3000
061657,智原國票9A購01  ,0,0,0,0,0,0,0,0,0,-3000,0,0,0,47000,50000,-3000,-3000
061510,嘉澤富邦9C購01  ,0,0,0,0,0,0,0,0,0,-3000,0,0,0,22000,25000,-3000,-3000
062407,同欣電永豐9B購01,0,0,0,0,0,0,0,0,0,-3000,0,0,0,10000,13000,-3000,-3000
062353,亞德客元大9B購01,0,0,0,0,0,0,0,0,0,-3000,0,0,0,131000,134000,-3000,-3000
062436,國巨元大9B購14  ,0,0,0,0,0,0,0,0,0,-3000,0,0,0,0,3000,-3000,-3000
062421,台積電統一9C購09,0,0,0,0,0,0,0,0,0,-3000,0,0,0,0,3000,-3000,-3000
062739,嘉晶國票9B購02  ,0,0,0,0,0,0,0,0,0,-3000,0,0,0,22000,25000,-3000,-3000
054967,神達元大97購01  ,0,0,0,0,0,0,0,0,0,-3000,0,0,0,0,3000,-3000,-3000
054882,台光電統一97購02,0,0,0,0,0,0,0,0,0,-3000,0,0,0,0,3000,-3000,-3000
056014,上銀群益97購02  ,0,0,0,0,0,0,0,0,0,-3000,0,0,0,0,3000,-3000,-3000
055645,技嘉元富97購01  ,0,0,0,0,0,0,0,0,0,-3000,0,0,0,3000,6000,-3000,-3000
055075,南電永豐97購01  ,0,0,0,0,0,0,0,0,0,-3000,0,0,0,25000,28000,-3000,-3000
056212,台光電國票98購03,0,0,0,0,0,0,0,0,0,-3000,0,0,0,0,3000,-3000,-3000
055344,國巨凱基97購04  ,0,0,0,0,0,0,0,0,0,-3000,0,0,0,0,3000,-3000,-3000
055569,聚陽統一98購01  ,0,0,0,0,0,0,0,0,0,-3000,0,0,0,0,3000,-3000,-3000
055409,元黃金富邦01購01,0,0,0,0,0,0,0,0,0,-3000,0,0,0,0,3000,-3000,-3000
056506,晶豪科永豐98購02,0,0,0,0,0,0,0,0,0,-3000,0,0,0,17000,20000,-3000,-3000
056608,力山永豐98購01  ,0,0,0,0,0,0,0,0,0,-3000,0,0,0,20000,23000,-3000,-3000
056314,力成元大97購01  ,0,0,0,0,0,0,0,0,0,-3000,0,0,0,68000,71000,-3000,-3000
059789,貿聯元大9A購02  ,0,0,0,0,0,0,0,0,0,-3000,0,0,0,0,3000,-3000,-3000
059870,全新凱基99購05  ,0,0,0,0,0,0,0,0,0,-3000,0,0,0,0,3000,-3000,-3000
053540,健策永豐96購01  ,0,0,0,0,0,0,0,0,0,-3000,0,0,0,0,3000,-3000,-3000
053773,上銀元大96購04  ,0,0,0,0,0,0,0,0,0,-3000,0,0,0,0,3000,-3000,-3000
055718,可成元大97購02  ,0,0,0,0,0,0,0,0,0,-3000,0,0,0,0,3000,-3000,-3000
053256,上銀富邦98購01  ,0,0,0,0,0,0,0,0,0,-3000,0,0,0,0,3000,-3000,-3000
052326,滬深反中信99購01,0,0,0,0,0,0,0,0,0,-3000,0,0,0,0,3000,-3000,-3000
05124P,華新科富邦97售02,0,0,0,0,0,0,0,0,0,-3000,0,0,0,0,3000,-3000,-3000
048179,臻鼎富邦97購01  ,0,0,0,0,0,0,0,0,0,-3000,0,0,0,0,3000,-3000,-3000
052132,旺宏凱基9B購01  ,0,0,0,0,0,0,0,0,0,-3000,0,0,0,0,3000,-3000,-3000
00763U,街口道瓊銅      ,0,0,0,0,0,0,0,0,0,-3000,0,0,0,7000,10000,-3000,-3000
03012X,元展12          ,0,0,0,0,0,0,0,0,0,-3000,0,0,0,0,3000,-3000,-3000
0052,富邦科技        ,0,0,0,0,0,0,0,0,0,-3000,0,0,0,100000,103000,-3000,-3000
00682U,元大美元指數    ,0,0,0,0,0,0,0,0,0,-3000,0,0,0,1000,4000,-3000,-3000
061077,國巨兆豐9B購01  ,0,0,0,0,0,0,0,0,0,-3000,0,0,0,17000,20000,-3000,-3000
061110,超眾元大9A購03  ,0,0,0,0,0,0,0,0,0,-3000,0,0,0,114000,117000,-3000,-3000
061112,台表科元大9A購03,0,0,0,0,0,0,0,0,0,-3000,0,0,0,29000,32000,-3000,-3000
061226,台積電中信9A購05,0,0,0,0,0,0,0,0,0,-3000,0,0,0,0,3000,-3000,-3000
061251,臺股指群益9A購02,0,0,0,0,0,0,0,0,0,-3000,0,0,0,2000,5000,-3000,-3000
061365,國巨國票9B購05  ,0,0,0,0,0,0,0,0,0,-3000,0,0,0,7000,10000,-3000,-3000
061282,台積電統一9C購06,0,0,0,0,0,0,0,0,0,-3000,0,0,0,0,3000,-3000,-3000
061316,台積電凱基9A購24,0,0,0,0,0,0,0,0,0,-3000,0,0,0,3000,6000,-3000,-3000
058022,樺漢凱基99購02  ,0,0,0,0,0,0,0,0,0,-3000,0,0,0,37000,40000,-3000,-3000
060262,臺股指凱基9B購02,0,0,0,0,0,0,0,0,0,-3000,0,0,0,2000,5000,-3000,-3000
059143,國巨國票9A購04  ,0,0,0,0,0,0,0,0,0,-3000,0,0,0,6000,9000,-3000,-3000
059339,上銀凱基99購06  ,0,0,0,0,0,0,0,0,0,-3000,0,0,0,0,3000,-3000,-3000
059313,元石油元大99購06,0,0,0,0,0,0,0,0,0,-3000,0,0,0,0,3000,-3000,-3000
059128,友達中信99購02  ,0,0,0,0,0,0,0,0,0,-3000,0,0,0,63000,66000,-3000,-3000
059152,臺股指國票99購15,0,0,0,0,0,0,0,0,0,-3000,0,0,0,3000,6000,-3000,-3000
059265,美律中信01購01  ,0,0,0,0,0,0,0,0,0,-3000,0,0,0,4000,7000,-3000,-3000
059038,健策群益9A購02  ,0,0,0,0,0,0,0,0,0,-3000,0,0,0,56000,59000,-3000,-3000
059023,可成統一9B購02  ,0,0,0,0,0,0,0,0,0,-3000,0,0,0,18000,21000,-3000,-3000
059415,台灣50元大9A購03,0,0,0,0,0,0,0,0,0,-3000,0,0,0,2000,5000,-3000,-3000
057896,嘉晶元富98購01  ,0,0,0,0,0,0,0,0,0,-3000,0,0,0,0,3000,-3000,-3000
057323,智邦群益98購01  ,0,0,0,0,0,0,0,0,0,-3000,0,0,0,2000,5000,-3000,-3000
060456,正隆元大9A購01  ,0,0,0,0,0,0,0,0,0,-3000,0,0,0,110000,113000,-3000,-3000
059446,臺股指元大99購27,0,0,0,0,0,0,0,0,0,-3000,0,0,0,0,3000,-3000,-3000
058586,鴻海中信01購02  ,0,0,0,0,0,0,0,0,0,-3000,0,0,0,121000,124000,-3000,-3000
059473,T50反1群益99購03,0,0,0,0,0,0,0,0,0,-3000,0,0,0,0,3000,-3000,-3000
059713,滬深2X元大9C購04,0,0,0,0,0,0,0,0,0,-3000,0,0,0,0,3000,-3000,-3000
059993,上銀元富99購01  ,0,0,0,0,0,0,0,0,0,-3000,0,0,0,0,3000,-3000,-3000
05958P,聯發科國票97售04,0,0,0,0,0,0,0,0,0,-3000,0,0,0,3000,6000,-3000,-3000
060291,高鐵元大9A購01  ,0,0,0,0,0,0,0,0,0,-3000,0,0,0,7000,10000,-3000,-3000
059570,全新凱基99購04  ,0,0,0,0,0,0,0,0,0,-3000,0,0,0,7000,10000,-3000,-3000
6668,中揚光          ,21000,25000,-4000,0,0,0,0,0,0,1000,1000,0,1000,0,0,0,-3000
060977,亞德客元大9A購04,0,0,0,0,0,0,0,0,0,-3000,0,0,0,84000,87000,-3000,-3000
8101,華冠            ,0,3000,-3000,0,0,0,0,0,0,0,0,0,0,0,0,0,-3000
8374,羅昇            ,0,4000,-4000,0,0,0,0,0,0,1000,1000,0,1000,0,0,0,-3000
060871,台灣50中信01購03,0,0,0,0,0,0,0,0,0,-3000,0,0,0,0,3000,-3000,-3000
060753,上銀元大9A購05  ,0,0,0,0,0,0,0,0,0,-3000,0,0,0,0,3000,-3000,-3000
5538,東明-KY         ,0,2000,-2000,0,0,0,0,1000,-1000,0,0,0,0,0,0,0,-3000
4148,全宇生技-KY     ,9000,10000,-1000,0,0,0,0,0,0,-2000,0,2000,-2000,0,0,0,-3000
3593,力銘            ,0,3000,-3000,0,0,0,0,0,0,0,0,0,0,0,0,0,-3000
4952,凌通            ,1000,4000,-3000,0,0,0,0,0,0,0,0,0,0,0,0,0,-3000
8442,威宏-KY         ,0,0,0,0,0,0,0,0,0,-3000,0,3000,-3000,0,0,0,-3000
2630,亞航            ,0,3000,-3000,0,0,0,0,0,0,0,0,0,0,0,0,0,-3000
1413,宏洲            ,0,3000,-3000,0,0,0,0,0,0,0,0,0,0,0,0,0,-3000
1414,東和            ,0,3000,-3000,0,0,0,0,0,0,0,0,0,0,0,0,0,-3000
1438,裕豐            ,0,3000,-3000,0,0,0,0,0,0,0,0,0,0,0,0,0,-3000
1443,立益            ,0,3000,-3000,0,0,0,0,0,0,0,0,0,0,0,0,0,-3000
1522,堤維西          ,55000,58000,-3000,0,0,0,0,0,0,0,0,0,0,0,0,0,-3000
1517,利奇            ,0,3000,-3000,0,0,0,0,0,0,0,0,0,0,0,0,0,-3000
08653P,台灣50凱基96售07,0,0,0,0,0,0,0,0,0,-3000,0,0,0,0,3000,-3000,-3000
1220,台榮            ,0,3000,-3000,0,0,0,0,0,0,0,0,0,0,0,0,0,-3000
1906,寶隆            ,8000,11000,-3000,0,0,0,0,0,0,0,0,0,0,0,0,0,-3000
07166P,台灣50兆豐03售01,0,0,0,0,0,0,0,0,0,-3000,0,0,0,0,3000,-3000,-3000
08013P,台灣50凱基9C售09,0,0,0,0,0,0,0,0,0,-3000,0,0,0,1000,4000,-3000,-3000
08038P,臺股指群益9B售11,0,0,0,0,0,0,0,0,0,-3000,0,0,0,5000,8000,-3000,-3000
08115P,聯發科凱基9B售13,0,0,0,0,0,0,0,0,0,-3000,0,0,0,37000,40000,-3000,-3000
062471,國泰金凱基9B購02,0,0,0,0,0,0,0,0,0,-4000,0,0,0,0,4000,-4000,-4000
062222,華新科統一9B購04,0,0,0,0,0,0,0,0,0,-4000,0,0,0,0,4000,-4000,-4000
061444,聯發科台新9A購01,0,0,0,0,0,0,0,0,0,-4000,0,0,0,0,4000,-4000,-4000
061413,台勝科群益9A購01,0,0,0,0,0,0,0,0,0,-4000,0,0,0,0,4000,-4000,-4000
061648,緯穎元大9A購04  ,0,0,0,0,0,0,0,0,0,-4000,0,0,0,4000,8000,-4000,-4000
061585,台積電富邦9B購06,0,0,0,0,0,0,0,0,0,-4000,0,0,0,0,4000,-4000,-4000
061785,奇力新群益9B購01,0,0,0,0,0,0,0,0,0,-4000,0,0,0,0,4000,-4000,-4000
061989,晶技元大9B購04  ,0,0,0,0,0,0,0,0,0,-4000,0,0,0,47000,51000,-4000,-4000
06581P,南亞科凱基98售04,0,0,0,0,0,0,0,0,0,-4000,0,0,0,9000,13000,-4000,-4000
063619,聯發科兆豐01購01,0,0,0,0,0,0,0,0,0,-4000,0,0,0,0,4000,-4000,-4000
06725P,聯電元富98售01  ,0,0,0,0,0,0,0,0,0,-4000,0,0,0,0,4000,-4000,-4000
06685P,鴻海國泰9A售01  ,0,0,0,0,0,0,0,0,0,-4000,0,0,0,8000,12000,-4000,-4000
06901P,亞德客凱基98售02,0,0,0,0,0,0,0,0,0,-4000,0,0,0,6000,10000,-4000,-4000
06993P,鴻海凱基99售05  ,0,0,0,0,0,0,0,0,0,-4000,0,0,0,0,4000,-4000,-4000
07128P,大毅元大99售04  ,0,0,0,0,0,0,0,0,0,-4000,0,0,0,1000,5000,-4000,-4000
063287,嘉澤元大9B購05  ,0,0,0,0,0,0,0,0,0,-4000,0,0,0,17000,21000,-4000,-4000
06328P,台積電中信01售02,0,0,0,0,0,0,0,0,0,-4000,0,0,0,11000,15000,-4000,-4000
063330,神達國票9C購01  ,0,0,0,0,0,0,0,0,0,-4000,0,0,0,0,4000,-4000,-4000
063159,嘉澤國泰01購01  ,0,0,0,0,0,0,0,0,0,-4000,0,0,0,9000,13000,-4000,-4000
062893,元金2X元大9C購01,0,0,0,0,0,0,0,0,0,-4000,0,0,0,0,4000,-4000,-4000
00688L,國泰20年美債正2 ,0,0,0,0,0,0,0,0,0,-4000,0,0,0,100000,104000,-4000,-4000
020011,統一微波高息20N ,0,0,0,0,0,0,0,0,0,-4000,0,0,0,0,4000,-4000,-4000
05213P,台積電國票96售05,0,0,0,0,0,0,0,0,0,-4000,0,0,0,1000,5000,-4000,-4000
047212,宏達電富邦97購01,0,0,0,0,0,0,0,0,0,-4000,0,0,0,0,4000,-4000,-4000
04731P,臺股指中信96售03,0,0,0,0,0,0,0,0,0,-4000,0,0,0,86000,90000,-4000,-4000
042793,台積電台新9C購01,0,0,0,0,0,0,0,0,0,-4000,0,0,0,0,4000,-4000,-4000
050915,健策中信98購01  ,0,0,0,0,0,0,0,0,0,-4000,0,0,0,68000,72000,-4000,-4000
054016,嘉晶永豐96購04  ,0,0,0,0,0,0,0,0,0,-4000,0,0,0,0,4000,-4000,-4000
054593,滬深2X永昌9A購01,0,0,0,0,0,0,0,0,0,-4000,0,0,0,0,4000,-4000,-4000
060066,欣興兆豐9B購01  ,0,0,0,0,0,0,0,0,0,-4000,0,0,0,0,4000,-4000,-4000
060105,牧德元大9B購01  ,0,0,0,0,0,0,0,0,0,-4000,0,0,0,0,4000,-4000,-4000
056383,上銀國泰99購01  ,0,0,0,0,0,0,0,0,0,-4000,0,0,0,0,4000,-4000,-4000
056478,晶技元大99購01  ,0,0,0,0,0,0,0,0,0,-4000,0,0,0,0,4000,-4000,-4000
056465,臺股指凱基99購07,0,0,0,0,0,0,0,0,0,-4000,0,0,0,0,4000,-4000,-4000
056079,世紀鋼元大97購02,0,0,0,0,0,0,0,0,0,-4000,0,0,0,0,4000,-4000,-4000
056020,義隆群益97購01  ,0,0,0,0,0,0,0,0,0,-4000,0,0,0,105000,109000,-4000,-4000
056036,鴻海凱基97購07  ,0,0,0,0,0,0,0,0,0,-4000,0,0,0,0,4000,-4000,-4000
057017,和大凱基98購01  ,0,0,0,0,0,0,0,0,0,-4000,0,0,0,0,4000,-4000,-4000
054845,智邦兆豐98購01  ,0,0,0,0,0,0,0,0,0,-4000,0,0,0,0,4000,-4000,-4000
054989,精元元富97購01  ,0,0,0,0,0,0,0,0,0,-4000,0,0,0,70000,74000,-4000,-4000
059571,奇力新凱基99購06,0,0,0,0,0,0,0,0,0,-4000,0,0,0,0,4000,-4000,-4000
057767,緯穎凱基98購06  ,0,0,0,0,0,0,0,0,0,-4000,0,0,0,1000,5000,-4000,-4000
059637,大立光凱基01購01,0,0,0,0,0,0,0,0,0,-4000,0,0,0,0,4000,-4000,-4000
060365,京鼎元富9A購01  ,0,0,0,0,0,0,0,0,0,-4000,0,0,0,0,4000,-4000,-4000
060368,緯穎元富9A購03  ,0,0,0,0,0,0,0,0,0,-4000,0,0,0,0,4000,-4000,-4000
058519,嘉澤元大99購01  ,0,0,0,0,0,0,0,0,0,-4000,0,0,0,5000,9000,-4000,-4000
060450,南亞元大9A購02  ,0,0,0,0,0,0,0,0,0,-4000,0,0,0,0,4000,-4000,-4000
060501,鴻海元大9A購13  ,0,0,0,0,0,0,0,0,0,-4000,0,0,0,2000,6000,-4000,-4000
057381,微星國泰9A購01  ,0,0,0,0,0,0,0,0,0,-4000,0,0,0,6000,10000,-4000,-4000
057919,技嘉凱基98購03  ,0,0,0,0,0,0,0,0,0,-4000,0,0,0,0,4000,-4000,-4000
05873P,華通群益97售02  ,0,0,0,0,0,0,0,0,0,-4000,0,0,0,0,4000,-4000,-4000
059025,台灣50台新9B購02,0,0,0,0,0,0,0,0,0,-4000,0,0,0,0,4000,-4000,-4000
059187,國巨富邦9B購02  ,0,0,0,0,0,0,0,0,0,-4000,0,0,0,0,4000,-4000,-4000
059327,南茂元大99購01  ,0,0,0,0,0,0,0,0,0,-4000,0,0,0,0,4000,-4000,-4000
058777,台光電國票9A購01,0,0,0,0,0,0,0,0,0,-4000,0,0,0,1000,5000,-4000,-4000
058513,宏達電元大99購05,0,0,0,0,0,0,0,0,0,-4000,0,0,0,80000,84000,-4000,-4000
058067,台積電第一9C購01,0,0,0,0,0,0,0,0,0,-4000,0,0,0,0,4000,-4000,-4000
057217,奇力新群益99購01,0,0,0,0,0,0,0,0,0,-4000,0,0,0,0,4000,-4000,-4000
061033,台光電永豐9A購01,0,0,0,0,0,0,0,0,0,-4000,0,0,0,49000,53000,-4000,-4000
061336,國巨元大9A購20  ,0,0,0,0,0,0,0,0,0,-4000,0,0,0,0,4000,-4000,-4000
061286,大立光統一9A購05,0,0,0,0,0,0,0,0,0,-4000,0,0,0,13000,17000,-4000,-4000
061246,玉晶光群益9A購08,0,0,0,0,0,0,0,0,0,-4000,0,0,0,19000,23000,-4000,-4000
061151,友訊群益9A購01  ,0,0,0,0,0,0,0,0,0,-4000,0,0,0,81000,85000,-4000,-4000
061135,聯發科統一9C購03,0,0,0,0,0,0,0,0,0,-4000,0,0,0,0,4000,-4000,-4000
07923P,元金2X凱基02售02,0,0,0,0,0,0,0,0,0,-4000,0,0,0,0,4000,-4000,-4000
07554P,玉晶光元大9A售06,0,0,0,0,0,0,0,0,0,-4000,0,0,0,10000,14000,-4000,-4000
1234,黑松            ,0,4000,-4000,0,0,0,0,0,0,0,0,0,0,0,0,0,-4000
1236,宏亞            ,0,4000,-4000,0,0,0,0,0,0,0,0,0,0,0,0,0,-4000
1436,華友聯          ,0,4000,-4000,0,0,0,0,0,0,0,0,0,0,0,0,0,-4000
1437,勤益控          ,3000,7000,-4000,0,0,0,0,0,0,0,0,0,0,0,0,0,-4000
2832,台產            ,32000,36000,-4000,0,0,0,0,0,0,0,0,0,0,0,0,0,-4000
3167,大量            ,0,4000,-4000,0,0,0,0,0,0,0,0,0,0,0,0,0,-4000
3028,增你強          ,20000,24000,-4000,0,0,0,0,0,0,0,0,0,0,0,0,0,-4000
2911,麗嬰房          ,1000,5000,-4000,0,0,0,0,0,0,0,0,0,0,0,0,0,-4000
2509,全坤建          ,0,4000,-4000,0,0,0,0,0,0,0,0,0,0,0,0,0,-4000
2540,愛山林          ,0,4000,-4000,0,0,0,0,0,0,0,0,0,0,0,0,0,-4000
3296,勝德            ,0,0,0,0,0,0,0,0,0,-4000,0,4000,-4000,0,0,0,-4000
060848,聯茂國票9A購02  ,0,0,0,0,0,0,0,0,0,-4000,0,0,0,11000,15000,-4000,-4000
06284P,台積電國票98售03,0,0,0,0,0,0,0,0,0,-5000,0,0,0,3000,8000,-5000,-5000
062806,世芯統一02購01  ,0,0,0,0,0,0,0,0,0,-5000,0,0,0,387000,392000,-5000,-5000
062799,聯發科統一9C購09,0,0,0,0,0,0,0,0,0,-5000,0,0,0,0,5000,-5000,-5000
063052,國巨統一9C購10  ,0,0,0,0,0,0,0,0,0,-5000,0,0,0,0,5000,-5000,-5000
063230,緯穎群益9B購02  ,0,0,0,0,0,0,0,0,0,-5000,0,0,0,10000,15000,-5000,-5000
063312,台積電群益9B購07,0,0,0,0,0,0,0,0,0,-5000,0,0,0,54000,59000,-5000,-5000
063384,巨大永豐9B購04  ,0,0,0,0,0,0,0,0,0,-5000,0,0,0,15000,20000,-5000,-5000
063394,金像電群益9B購01,0,0,0,0,0,0,0,0,0,-5000,0,0,0,0,5000,-5000,-5000
07106P,國巨統一9B售05  ,0,0,0,0,0,0,0,0,0,-5000,0,0,0,15000,20000,-5000,-5000
06927P,台灣50元大9B售03,0,0,0,0,0,0,0,0,0,-5000,0,0,0,0,5000,-5000,-5000
07010P,T50正2凱基9C售01,0,0,0,0,0,0,0,0,0,-5000,0,0,0,0,5000,-5000,-5000
06726P,欣興元富98售04  ,0,0,0,0,0,0,0,0,0,-5000,0,0,0,5000,10000,-5000,-5000
063579,GIS元大9C購01   ,0,0,0,0,0,0,0,0,0,-5000,0,0,0,54000,59000,-5000,-5000
063515,香港2X凱基01購01,0,0,0,0,0,0,0,0,0,-5000,0,0,0,0,5000,-5000,-5000
06635P,聯發科凱基98售15,0,0,0,0,0,0,0,0,0,-5000,0,0,0,0,5000,-5000,-5000
06487P,聯發科統一99售02,0,0,0,0,0,0,0,0,0,-5000,0,0,0,0,5000,-5000,-5000
06496P,台灣50日盛98售01,0,0,0,0,0,0,0,0,0,-5000,0,0,0,1000,6000,-5000,-5000
061992,祥碩元大9B購02  ,0,0,0,0,0,0,0,0,0,-5000,0,0,0,28000,33000,-5000,-5000
062034,同欣電群益9B購01,0,0,0,0,0,0,0,0,0,-5000,0,0,0,83000,88000,-5000,-5000
061952,臺股指群益9B購01,0,0,0,0,0,0,0,0,0,-5000,0,0,0,5000,10000,-5000,-5000
061841,晶技凱基9C購01  ,0,0,0,0,0,0,0,0,0,-5000,0,0,0,25000,30000,-5000,-5000
061650,南電元大9A購07  ,0,0,0,0,0,0,0,0,0,-5000,0,0,0,10000,15000,-5000,-5000
061664,上銀中信9A購01  ,0,0,0,0,0,0,0,0,0,-5000,0,0,0,0,5000,-5000,-5000
061708,同欣電國票9A購02,0,0,0,0,0,0,0,0,0,-5000,0,0,0,0,5000,-5000,-5000
061399,喬山兆豐9B購01  ,0,0,0,0,0,0,0,0,0,-5000,0,0,0,0,5000,-5000,-5000
061426,玉晶光元大9A購15,0,0,0,0,0,0,0,0,0,-5000,0,0,0,10000,15000,-5000,-5000
062232,聯詠麥證9C購01  ,0,0,0,0,5000,-5000,0,0,0,-5000,0,0,0,0,5000,-5000,-5000
062127,台勝科統一01購02,0,0,0,0,0,0,0,0,0,-5000,0,0,0,0,5000,-5000,-5000
06234P,亞德客元大97售02,0,0,0,0,0,0,0,0,0,-5000,0,0,0,5000,10000,-5000,-5000
062405,泰鼎永豐9B購02  ,0,0,0,0,0,0,0,0,0,-5000,0,0,0,0,5000,-5000,-5000
062331,大立光統一9B購10,0,0,0,0,0,0,0,0,0,-5000,0,0,0,0,5000,-5000,-5000
062532,聯詠統一9C購01  ,0,0,0,0,0,0,0,0,0,-5000,0,0,0,0,5000,-5000,-5000
062551,緯穎永豐9B購02  ,0,0,0,0,0,0,0,0,0,-5000,0,0,0,0,5000,-5000,-5000
062553,台積電凱基9B購07,0,0,0,0,0,0,0,0,0,-5000,0,0,0,1000,6000,-5000,-5000
062670,瑞昱中信03購01  ,0,0,0,0,0,0,0,0,0,-5000,0,0,0,151000,156000,-5000,-5000
054965,健策元大98購04  ,0,0,0,0,0,0,0,0,0,-5000,0,0,0,0,5000,-5000,-5000
056177,嘉澤元富97購01  ,0,0,0,0,0,0,0,0,0,-5000,0,0,0,0,5000,-5000,-5000
054830,世芯國泰99購01  ,0,0,0,0,0,0,0,0,0,-5000,0,0,0,0,5000,-5000,-5000
057033,A50反1元大9B購02,0,0,0,0,0,0,0,0,0,-5000,0,0,0,0,5000,-5000,-5000
055426,旺宏群益99購02  ,0,0,0,0,0,0,0,0,0,-5000,0,0,0,0,5000,-5000,-5000
055437,禾伸堂中信99購01,0,0,0,0,0,0,0,0,0,-5000,0,0,0,100000,105000,-5000,-5000
055470,南亞科凱基97購01,0,0,0,0,0,0,0,0,0,-5000,0,0,0,0,5000,-5000,-5000
056550,瑞儀凱基99購01  ,0,0,0,0,0,0,0,0,0,-5000,0,0,0,0,5000,-5000,-5000
060214,茂林康和9A購01  ,0,0,0,0,0,0,0,0,0,-5000,0,0,0,0,5000,-5000,-5000
060071,國巨元富99購03  ,0,0,0,0,0,0,0,0,0,-5000,0,0,0,0,5000,-5000,-5000
056401,國巨群益98購07  ,0,0,0,0,0,0,0,0,0,-5000,0,0,0,0,5000,-5000,-5000
059820,南亞科凱基99購07,0,0,0,0,0,0,0,0,0,-5000,0,0,0,5000,10000,-5000,-5000
053632,新唐兆豐96購01  ,0,0,0,0,0,0,0,0,0,-5000,0,0,0,55000,60000,-5000,-5000
054060,晶技國票97購02  ,0,0,0,0,0,0,0,0,0,-5000,0,0,0,0,5000,-5000,-5000
052926,旺宏元大98購02  ,0,0,0,0,0,0,0,0,0,-5000,0,0,0,0,5000,-5000,-5000
052936,華通兆豐98購01  ,0,0,0,0,0,0,0,0,0,-5000,0,0,0,0,5000,-5000,-5000
052969,建準群益97購01  ,0,0,0,0,0,0,0,0,0,-5000,0,0,0,0,5000,-5000,-5000
053834,卜蜂永豐96購01  ,0,0,0,0,0,0,0,0,0,-5000,0,0,0,47000,52000,-5000,-5000
055745,臻鼎元富97購01  ,0,0,0,0,0,0,0,0,0,-5000,0,0,0,0,5000,-5000,-5000
054111,緯穎凱基97購01  ,0,0,0,0,0,0,0,0,0,-5000,0,0,0,5000,10000,-5000,-5000
055892,國巨統一99購01  ,0,0,0,0,0,0,0,0,0,-5000,0,0,0,20000,25000,-5000,-5000
056866,矽創群益98購03  ,0,0,0,0,0,0,0,0,0,-5000,0,0,0,0,5000,-5000,-5000
056907,群創元大9C購04  ,0,0,0,0,0,0,0,0,0,-5000,0,0,0,0,5000,-5000,-5000
048070,聯發科元富99購03,0,0,0,0,0,0,0,0,0,-5000,0,0,0,9000,14000,-5000,-5000
052700,奇鋐國票97購02  ,0,0,0,0,0,0,0,0,0,-5000,0,0,0,99000,104000,-5000,-5000
046881,智原富邦99購01  ,0,0,0,0,0,0,0,0,0,-5000,0,0,0,20000,25000,-5000,-5000
03857P,聯發科元富99售02,0,0,0,0,0,0,0,0,0,-5000,0,0,0,0,5000,-5000,-5000
051907,台積電元大97購05,0,0,0,0,0,0,0,0,0,-5000,0,0,0,32000,37000,-5000,-5000
00737,國泰AI+Robo     ,0,1000,-1000,0,0,0,0,0,0,-4000,0,0,0,115000,119000,-4000,-5000
061224,道瓊反中信01購01,0,0,0,0,0,0,0,0,0,-5000,0,0,0,10000,15000,-5000,-5000
061209,聯發科元大9A購10,0,0,0,0,0,0,0,0,0,-5000,0,0,0,0,5000,-5000,-5000
06133P,帆宣元富97售02  ,0,0,0,0,0,0,0,0,0,-5000,0,0,0,0,5000,-5000,-5000
058958,台表科國票9A購03,0,0,0,0,0,0,0,0,0,-5000,0,0,0,0,5000,-5000,-5000
058952,南茂群益99購01  ,0,0,0,0,0,0,0,0,0,-5000,0,0,0,0,5000,-5000,-5000
07820P,臺股指國票9A售11,0,0,0,0,0,0,0,0,0,-5000,0,0,0,20000,25000,-5000,-5000
058907,健策元大99購04  ,0,0,0,0,0,0,0,0,0,-5000,0,0,0,14000,19000,-5000,-5000
058873,美律國票9A購02  ,0,0,0,0,0,0,0,0,0,-5000,0,0,0,0,5000,-5000,-5000
058094,祥碩元大98購09  ,0,0,0,0,0,0,0,0,0,-5000,0,0,0,0,5000,-5000,-5000
060261,臺股指凱基9A購04,0,0,0,0,0,0,0,0,0,-5000,0,0,0,0,5000,-5000,-5000
058414,大立光兆豐99購02,0,0,0,0,0,0,0,0,0,-5000,0,0,0,0,5000,-5000,-5000
058362,聯發科凱基99購06,0,0,0,0,0,0,0,0,0,-5000,0,0,0,0,5000,-5000,-5000
058304,鴻海元大99購12  ,0,0,0,0,0,0,0,0,0,-5000,0,0,0,0,5000,-5000,-5000
058346,嘉晶群益99購01  ,0,0,0,0,0,0,0,0,0,-5000,0,0,0,0,5000,-5000,-5000
059095,訊芯元大99購01  ,0,0,0,0,0,0,0,0,0,-5000,0,0,0,159000,164000,-5000,-5000
05880P,創意康和96售01  ,0,0,0,0,0,0,0,0,0,-5000,0,0,0,0,5000,-5000,-5000
059334,A50正2國票9A購02,0,0,0,0,0,0,0,0,0,-5000,0,0,0,0,5000,-5000,-5000
059400,滬深2X元富9C購04,0,0,0,0,0,0,0,0,0,-5000,0,0,0,0,5000,-5000,-5000
059192,臺股指富邦9C購01,0,0,0,0,0,0,0,0,0,-5000,0,0,0,0,5000,-5000,-5000
059153,臺股指國票99購16,0,0,0,0,0,0,0,0,0,-5000,0,0,0,13000,18000,-5000,-5000
059021,台積電統一9B購07,0,0,0,0,0,0,0,0,0,-5000,0,0,0,0,5000,-5000,-5000
058846,鴻海群益99購03  ,0,0,0,0,0,0,0,0,0,-5000,0,0,0,0,5000,-5000,-5000
058190,貿聯永豐99購01  ,0,0,0,0,0,0,0,0,0,-5000,0,0,0,46000,51000,-5000,-5000
05870P,聯發科凱基96售19,0,0,0,0,0,0,0,0,0,-5000,0,0,0,0,5000,-5000,-5000
058718,台灣50元富03購01,0,0,0,0,0,0,0,0,0,-5000,0,0,0,0,5000,-5000,-5000
057883,中環群益98購01  ,0,0,0,0,0,0,0,0,0,-5000,0,0,0,0,5000,-5000,-5000
057857,牧德國票99購01  ,0,0,0,0,0,0,0,0,0,-5000,0,0,0,0,5000,-5000,-5000
05748P,臺股指群益99售02,0,0,0,0,0,0,0,0,0,-5000,0,0,0,0,5000,-5000,-5000
060502,國巨元大9A購07  ,0,0,0,0,0,0,0,0,0,-5000,0,0,0,5000,10000,-5000,-5000
060524,國巨中信9A購03  ,0,0,0,0,0,0,0,0,0,-5000,0,0,0,0,5000,-5000,-5000
060599,國巨凱基9C購01  ,0,0,0,0,0,0,0,0,0,-5000,0,0,0,35000,40000,-5000,-5000
060594,國巨麥證9A購01  ,0,0,0,0,5000,-5000,0,0,0,-5000,0,0,0,0,5000,-5000,-5000
060571,京元電永豐9A購01,0,0,0,0,0,0,0,0,0,-5000,0,0,0,112000,117000,-5000,-5000
060051,台積電凱基9B購01,0,0,0,0,0,0,0,0,0,-5000,0,0,0,10000,15000,-5000,-5000
060151,旺宏富邦9A購02  ,0,0,0,0,0,0,0,0,0,-5000,0,0,0,10000,15000,-5000,-5000
060154,堤維西永豐9A購01,0,0,0,0,0,0,0,0,0,-5000,0,0,0,0,5000,-5000,-5000
059515,牧德永豐99購01  ,0,0,0,0,0,0,0,0,0,-5000,0,0,0,0,5000,-5000,-5000
060422,台勝科永豐9A購01,0,0,0,0,0,0,0,0,0,-5000,0,0,0,0,5000,-5000,-5000
059624,鴻海凱基01購01  ,0,0,0,0,0,0,0,0,0,-5000,0,0,0,2000,7000,-5000,-5000
060301,國巨富邦9C購02  ,0,0,0,0,0,0,0,0,0,-5000,0,0,0,8000,13000,-5000,-5000
058591,台灣50統一9B購02,0,0,0,0,0,0,0,0,0,-5000,0,0,0,0,5000,-5000,-5000
060917,台表科國泰9B購01,0,0,0,0,0,0,0,0,0,-5000,0,0,0,0,5000,-5000,-5000
6698,旭暉應材        ,3000,8000,-5000,0,0,0,0,0,0,0,0,0,0,0,0,0,-5000
6641,基士德-KY       ,0,5000,-5000,0,0,0,0,0,0,0,0,0,0,0,0,0,-5000
3583,辛耘            ,15000,21000,-6000,0,0,0,0,0,0,1000,1000,0,1000,0,0,0,-5000
3591,艾笛森          ,0,4000,-4000,0,0,0,0,0,0,-1000,0,1000,-1000,0,0,0,-5000
060649,國巨第一9A購01  ,0,0,0,0,0,0,0,0,0,-5000,0,0,0,0,5000,-5000,-5000
911868,同方友友-DR     ,0,5000,-5000,0,0,0,0,0,0,0,0,0,0,0,0,0,-5000
2516,新建            ,0,5000,-5000,0,0,0,0,0,0,0,0,0,0,0,0,0,-5000
2462,良得電          ,1000,6000,-5000,0,0,0,0,0,0,0,0,0,0,0,0,0,-5000
2428,興勤            ,69000,84000,-15000,0,0,0,0,0,0,10000,17000,0,17000,4000,11000,-7000,-5000
1442,名軒            ,1000,6000,-5000,0,0,0,0,0,0,0,0,0,0,0,0,0,-5000
1432,大魯閣          ,0,5000,-5000,0,0,0,0,0,0,0,0,0,0,0,0,0,-5000
1468,昶和            ,0,5000,-5000,0,0,0,0,0,0,0,0,0,0,0,0,0,-5000
08209P,上銀元富9B售06  ,0,0,0,0,0,0,0,0,0,-5000,0,0,0,0,5000,-5000,-5000
1721,三晃            ,0,5000,-5000,0,0,0,0,0,0,0,0,0,0,0,0,0,-5000
1589,永冠-KY         ,93000,92000,1000,0,0,0,0,0,0,-6000,0,6000,-6000,0,0,0,-5000
1616,億泰            ,0,5000,-5000,0,0,0,0,0,0,0,0,0,0,0,0,0,-5000
1617,榮星            ,0,5000,-5000,0,0,0,0,0,0,0,0,0,0,0,0,0,-5000
07543P,台積電凱基9A售17,0,0,0,0,0,0,0,0,0,-5000,0,0,0,0,5000,-5000,-5000
07525P,臺股指中信9B售07,0,0,0,0,0,0,0,0,0,-5000,0,0,0,0,5000,-5000,-5000
07517P,台積電元大9A售17,0,0,0,0,0,0,0,0,0,-5000,0,0,0,5000,10000,-5000,-5000
07504P,聯詠元大9A售02  ,0,0,0,0,0,0,0,0,0,-5000,0,0,0,0,5000,-5000,-5000
07596P,上証2X中信01售01,0,0,0,0,0,0,0,0,0,-5000,0,0,0,0,5000,-5000,-5000
07593P,臺股指凱基9A售08,0,0,0,0,0,0,0,0,0,-5000,0,0,0,65000,70000,-5000,-5000
07665P,台灣50元大9C售31,0,0,0,0,0,0,0,0,0,-5000,0,0,0,0,5000,-5000,-5000
07273P,台灣50群益99售03,0,0,0,0,0,0,0,0,0,-5000,0,0,0,0,5000,-5000,-5000
07274P,上証2X群益01售01,0,0,0,0,0,0,0,0,0,-5000,0,0,0,0,5000,-5000,-5000
07326P,大立光元大99售23,0,0,0,0,0,0,0,0,0,-5000,0,0,0,20000,25000,-5000,-5000
07887P,台積電國票9C售03,0,0,0,0,0,0,0,0,0,-5000,0,0,0,0,5000,-5000,-5000
07930P,聯發科統一9B售06,0,0,0,0,0,0,0,0,0,-5000,0,0,0,0,5000,-5000,-5000
08141P,鴻海凱基9B售09  ,0,0,0,0,0,0,0,0,0,-5000,0,0,0,0,5000,-5000,-5000
07990P,緯穎凱基9B售02  ,0,0,0,0,0,0,0,0,0,-5000,0,0,0,746000,751000,-5000,-5000
08005P,台積電群益9C售04,0,0,0,0,0,0,0,0,0,-5000,0,0,0,5000,10000,-5000,-5000
062554,台積電凱基9B購08,0,0,0,0,0,0,0,0,0,-6000,0,0,0,1000,7000,-6000,-6000
062274,台積電群益9B購04,0,0,0,0,0,0,0,0,0,-6000,0,0,0,0,6000,-6000,-6000
062347,台光電群益9B購02,0,0,0,0,0,0,0,0,0,-6000,0,0,0,0,6000,-6000,-6000
062218,燿華統一01購01  ,0,0,0,0,0,0,0,0,0,-6000,0,0,0,0,6000,-6000,-6000
062182,華新科元大9B購07,0,0,0,0,0,0,0,0,0,-6000,0,0,0,0,6000,-6000,-6000
061475,漢唐元大9A購01  ,0,0,0,0,0,0,0,0,0,-6000,0,0,0,25000,31000,-6000,-6000
061479,泰碩元大9A購02  ,0,0,0,0,0,0,0,0,0,-6000,0,0,0,70000,76000,-6000,-6000
06161P,聯發科群益97售03,0,0,0,0,0,0,0,0,0,-6000,0,0,0,35000,41000,-6000,-6000
061876,明泰元大9B購01  ,0,0,0,0,0,0,0,0,0,-6000,0,0,0,1000,7000,-6000,-6000
061998,緯穎元大9B購03  ,0,0,0,0,0,0,0,0,0,-6000,0,0,0,7000,13000,-6000,-6000
063532,GIS凱基9B購03   ,0,0,0,0,0,0,0,0,0,-6000,0,0,0,1000,7000,-6000,-6000
063609,南電凱基9B購05  ,0,0,0,0,0,0,0,0,0,-6000,0,0,0,0,6000,-6000,-6000
06368P,台積電凱基97售15,0,0,0,0,0,0,0,0,0,-6000,0,0,0,0,6000,-6000,-6000
06674P,祥碩群益98售02  ,0,0,0,0,0,0,0,0,0,-6000,0,0,0,190000,196000,-6000,-6000
06697P,台積電國票99售05,0,0,0,0,0,0,0,0,0,-6000,0,0,0,0,6000,-6000,-6000
06832P,玉晶光凱基98售03,0,0,0,0,0,0,0,0,0,-6000,0,0,0,0,6000,-6000,-6000
07013P,玉晶光群益9A售06,0,0,0,0,0,0,0,0,0,-6000,0,0,0,0,6000,-6000,-6000
07109P,聯發科中信9B售02,0,0,0,0,0,0,0,0,0,-6000,0,0,0,0,6000,-6000,-6000
063423,聯詠凱基9C購02  ,0,0,0,0,0,0,0,0,0,-6000,0,0,0,0,6000,-6000,-6000
063033,台積電凱基9B購09,0,0,0,0,0,0,0,0,0,-6000,0,0,0,2000,8000,-6000,-6000
062996,致茂國票9C購01  ,0,0,0,0,0,0,0,0,0,-6000,0,0,0,11000,17000,-6000,-6000
063000,緯穎國票9B購03  ,0,0,0,0,0,0,0,0,0,-6000,0,0,0,0,6000,-6000,-6000
062861,世芯國票9C購01  ,0,0,0,0,0,0,0,0,0,-6000,0,0,0,9000,15000,-6000,-6000
00742,新光內需收益    ,0,0,0,0,0,0,0,0,0,-6000,0,0,0,152000,158000,-6000,-6000
00706L,元大S&P日圓正2  ,0,0,0,0,0,0,0,0,0,-6000,0,0,0,1000,7000,-6000,-6000
054158,國巨日盛99購01  ,0,0,0,0,0,0,0,0,0,-6000,0,0,0,0,6000,-6000,-6000
055957,瑞昱元大97購06  ,0,0,0,0,0,0,0,0,0,-6000,0,0,0,0,6000,-6000,-6000
053628,微星兆豐96購01  ,0,0,0,0,0,0,0,0,0,-6000,0,0,0,0,6000,-6000,-6000
059887,華新科國票99購02,0,0,0,0,0,0,0,0,0,-6000,0,0,0,0,6000,-6000,-6000
056340,可成凱基98購04  ,0,0,0,0,0,0,0,0,0,-6000,0,0,0,0,6000,-6000,-6000
056733,國巨凱基98購10  ,0,0,0,0,0,0,0,0,0,-6000,0,0,0,28000,34000,-6000,-6000
057008,華新科中信99購02,0,0,0,0,0,0,0,0,0,-6000,0,0,0,0,6000,-6000,-6000
057016,中石化凱基9B購01,0,0,0,0,0,0,0,0,0,-6000,0,0,0,0,6000,-6000,-6000
056021,興富發群益97購01,0,0,0,0,0,0,0,0,0,-6000,0,0,0,92000,98000,-6000,-6000
058606,聯發科元大99購13,0,0,0,0,0,0,0,0,0,-6000,0,0,0,0,6000,-6000,-6000
059539,緯穎凱基99購03  ,0,0,0,0,0,0,0,0,0,-6000,0,0,0,0,6000,-6000,-6000
05998P,台積電元大97售12,0,0,0,0,0,0,0,0,0,-6000,0,0,0,6000,12000,-6000,-6000
060460,鴻海元大9A購08  ,0,0,0,0,0,0,0,0,0,-6000,0,0,0,0,6000,-6000,-6000
057480,技嘉元大98購03  ,0,0,0,0,0,0,0,0,0,-6000,0,0,0,0,6000,-6000,-6000
057314,全新麥證98購01  ,0,0,0,0,6000,-6000,0,0,0,-6000,0,0,0,0,6000,-6000,-6000
05731P,創意統一96售03  ,0,0,0,0,0,0,0,0,0,-6000,0,0,0,101000,107000,-6000,-6000
058990,GIS凱基99購02   ,0,0,0,0,0,0,0,0,0,-6000,0,0,0,0,6000,-6000,-6000
059151,臺股指國票99購14,0,0,0,0,0,0,0,0,0,-6000,0,0,0,14000,20000,-6000,-6000
059293,宏達電元富9B購01,0,0,0,0,0,0,0,0,0,-6000,0,0,0,89000,95000,-6000,-6000
058780,牧德國票9A購01  ,0,0,0,0,0,0,0,0,0,-6000,0,0,0,0,6000,-6000,-6000
058314,欣興富邦9B購01  ,0,0,0,0,0,0,0,0,0,-6000,0,0,0,0,6000,-6000,-6000
061015,旺宏麥證9A購03  ,0,0,0,0,6000,-6000,0,0,0,-6000,0,0,0,0,6000,-6000,-6000
061348,聯鈞元大9A購05  ,0,0,0,0,0,0,0,0,0,-6000,0,0,0,94000,100000,-6000,-6000
061389,華新科群益9B購01,0,0,0,0,0,0,0,0,0,-6000,0,0,0,0,6000,-6000,-6000
061160,瑞祺群益9A購01  ,0,0,0,0,0,0,0,0,0,-6000,0,0,0,116000,122000,-6000,-6000
07255P,國巨凱基99售15  ,0,0,0,0,0,0,0,0,0,-6000,0,0,0,28000,34000,-6000,-6000
07227P,聯發科元富99售05,0,0,0,0,0,0,0,0,0,-6000,0,0,0,290000,296000,-6000,-6000
1603,華電            ,0,6000,-6000,0,0,0,0,0,0,0,0,0,0,0,0,0,-6000
1558,伸興            ,0,6000,-6000,0,0,0,0,0,0,0,0,0,0,0,0,0,-6000
08187P,大毅群益9B售04  ,0,0,0,0,0,0,0,0,0,-6000,0,0,0,0,6000,-6000,-6000
1316,上曜            ,0,6000,-6000,0,0,0,0,0,0,0,0,0,0,0,0,0,-6000
1203,味王            ,0,6000,-6000,0,0,0,0,0,0,0,0,0,0,0,0,0,-6000
2438,翔耀            ,5000,11000,-6000,0,0,0,0,0,0,0,0,0,0,0,0,0,-6000
2701,萬企            ,0,6000,-6000,0,0,0,0,0,0,0,0,0,0,0,0,0,-6000
9930,中聯資源        ,3000,9000,-6000,0,0,0,0,0,0,0,0,0,0,0,0,0,-6000
6136,富爾特          ,0,6000,-6000,0,0,0,0,0,0,0,0,0,0,0,0,0,-6000
6281,全國電          ,0,6000,-6000,0,0,0,0,0,0,0,0,0,0,0,0,0,-6000
3679,新至陞          ,5000,11000,-6000,0,0,0,0,0,0,0,0,0,0,0,0,0,-6000
4306,炎洲            ,0,6000,-6000,0,0,0,0,0,0,0,0,0,0,0,0,0,-6000
060715,日電貿永豐9A購01,0,0,0,0,0,0,0,0,0,-6000,0,0,0,57000,63000,-6000,-6000
062755,茂林麥證9B購01  ,0,0,0,53000,60000,-7000,0,0,0,-7000,0,0,0,53000,60000,-7000,-7000
063212,聯發科國票9C購02,0,0,0,0,0,0,0,0,0,-7000,0,0,0,10000,17000,-7000,-7000
06879P,長榮航凱基98售02,0,0,0,0,0,0,0,0,0,-7000,0,0,0,3000,10000,-7000,-7000
063574,茂林元大9B購07  ,0,0,0,0,0,0,0,0,0,-7000,0,0,0,0,7000,-7000,-7000
063557,聚陽元大9B購01  ,0,0,0,0,0,0,0,0,0,-7000,0,0,0,0,7000,-7000,-7000
063549,國巨國票9C購05  ,0,0,0,0,0,0,0,0,0,-7000,0,0,0,0,7000,-7000,-7000
06386P,欣興永豐97售03  ,0,0,0,0,0,0,0,0,0,-7000,0,0,0,6000,13000,-7000,-7000
062068,滬深2X元大9B購02,0,0,0,0,0,0,0,0,0,-7000,0,0,0,0,7000,-7000,-7000
061959,鴻海統一9B購04  ,0,0,0,0,0,0,0,0,0,-7000,0,0,0,10000,17000,-7000,-7000
061947,旺宏群益9B購02  ,0,0,0,0,0,0,0,0,0,-7000,0,0,0,20000,27000,-7000,-7000
061781,台積電群益9C購01,0,0,0,0,0,0,0,0,0,-7000,0,0,0,2000,9000,-7000,-7000
061649,緯穎元大9A購06  ,0,0,0,0,0,0,0,0,0,-7000,0,0,0,0,7000,-7000,-7000
061488,奇力新兆豐9A購01,0,0,0,0,0,0,0,0,0,-7000,0,0,0,7000,14000,-7000,-7000
062157,聯發科凱基9B購08,0,0,0,0,0,0,0,0,0,-7000,0,0,0,0,7000,-7000,-7000
062328,南亞科統一9C購01,0,0,0,0,0,0,0,0,0,-7000,0,0,0,73000,80000,-7000,-7000
062545,嘉晶永豐9B購01  ,0,0,0,0,0,0,0,0,0,-7000,0,0,0,0,7000,-7000,-7000
06256P,臺股指群益97售09,0,0,0,0,0,0,0,0,0,-7000,0,0,0,8000,15000,-7000,-7000
062512,美食國票9B購01  ,0,0,0,0,0,0,0,0,0,-7000,0,0,0,0,7000,-7000,-7000
062468,台積電凱基9B購06,0,0,0,0,0,0,0,0,0,-7000,0,0,0,1000,8000,-7000,-7000
062478,牧德國票9B購03  ,0,0,0,0,0,0,0,0,0,-7000,0,0,0,0,7000,-7000,-7000
062664,群創群益9B購02  ,0,0,0,0,0,0,0,0,0,-7000,0,0,0,72000,79000,-7000,-7000
057009,信邦中信99購01  ,0,0,0,0,0,0,0,0,0,-7000,0,0,0,234000,241000,-7000,-7000
054808,東元元大9A購01  ,0,0,0,0,0,0,0,0,0,-7000,0,0,0,0,7000,-7000,-7000
054778,世紀鋼國票99購01,0,0,0,0,0,0,0,0,0,-7000,0,0,0,5000,12000,-7000,-7000
055294,智易元大98購01  ,0,0,0,0,0,0,0,0,0,-7000,0,0,0,0,7000,-7000,-7000
055657,超眾元富97購02  ,0,0,0,0,0,0,0,0,0,-7000,0,0,0,191000,198000,-7000,-7000
05563P,台積電元大97售07,0,0,0,0,0,0,0,0,0,-7000,0,0,0,0,7000,-7000,-7000
056526,力山凱基98購01  ,0,0,0,0,0,0,0,0,0,-7000,0,0,0,13000,20000,-7000,-7000
057154,易華電國泰99購01,0,0,0,0,0,0,0,0,0,-7000,0,0,0,3000,10000,-7000,-7000
059868,台光電凱基99購03,0,0,0,0,0,0,0,0,0,-7000,0,0,0,0,7000,-7000,-7000
059832,超眾康和99購01  ,0,0,0,0,0,0,0,0,0,-7000,0,0,0,0,7000,-7000,-7000
054050,創意元大96購06  ,0,0,0,0,0,0,0,0,0,-7000,0,0,0,68000,75000,-7000,-7000
055808,世紀鋼永豐97購01,0,0,0,0,0,0,0,0,0,-7000,0,0,0,26000,33000,-7000,-7000
051381,玉晶光群益98購01,0,0,0,0,0,0,0,0,0,-7000,0,0,0,42000,49000,-7000,-7000
00685L,群益臺灣加權正2 ,0,0,0,0,0,0,0,0,0,-7000,0,0,0,2000,9000,-7000,-7000
03677C,臺股指元大05牛02,0,0,0,0,0,0,0,0,0,-7000,0,0,0,1000,8000,-7000,-7000
04462P,全新元富96售01  ,0,0,0,0,0,0,0,0,0,-7000,0,0,0,0,7000,-7000,-7000
061059,世芯國票9B購01  ,0,0,0,0,0,0,0,0,0,-7000,0,0,0,15000,22000,-7000,-7000
058427,大毅元富99購01  ,0,0,0,0,0,0,0,0,0,-7000,0,0,0,0,7000,-7000,-7000
059118,晶技永豐9A購01  ,0,0,0,0,0,0,0,0,0,-7000,0,0,0,1000,8000,-7000,-7000
05902P,華通國票96售02  ,0,0,0,0,0,0,0,0,0,-7000,0,0,0,2000,9000,-7000,-7000
058833,台表科永豐99購01,0,0,0,0,0,0,0,0,0,-7000,0,0,0,5000,12000,-7000,-7000
057599,技嘉群益9A購01  ,0,0,0,0,0,0,0,0,0,-7000,0,0,0,22000,29000,-7000,-7000
057930,旺宏群益99購04  ,0,0,0,0,0,0,0,0,0,-7000,0,0,0,16000,23000,-7000,-7000
057931,正崴群益98購02  ,0,0,0,0,0,0,0,0,0,-7000,0,0,0,98000,105000,-7000,-7000
058697,亞德客元大99購01,0,0,0,0,0,0,0,0,0,-7000,0,0,0,1000,8000,-7000,-7000
058262,大立光富邦9C購02,0,0,0,0,0,0,0,0,0,-7000,0,0,0,8000,15000,-7000,-7000
057548,微星凱基99購01  ,0,0,0,0,0,0,0,0,0,-7000,0,0,0,33000,40000,-7000,-7000
057341,技嘉台新98購01  ,0,0,0,0,0,0,0,0,0,-7000,0,0,0,0,7000,-7000,-7000
059682,可成富邦9A購01  ,0,0,0,0,0,0,0,0,0,-7000,0,0,0,0,7000,-7000,-7000
060346,華新科統一01購01,0,0,0,0,0,0,0,0,0,-7000,0,0,0,10000,17000,-7000,-7000
6672,騰輝電子-KY     ,55000,62000,-7000,0,0,0,0,0,0,0,0,0,0,0,0,0,-7000
8033,雷虎            ,0,7000,-7000,0,0,0,0,0,0,0,0,0,0,0,0,0,-7000
6152,百一            ,0,7000,-7000,0,0,0,0,0,0,0,0,0,0,0,0,0,-7000
3018,同開            ,6000,12000,-6000,0,0,0,0,0,0,-1000,0,1000,-1000,0,0,0,-7000
3266,昇陽            ,0,7000,-7000,0,0,0,0,0,0,0,0,0,0,0,0,0,-7000
3058,立德            ,4000,11000,-7000,0,0,0,0,0,0,0,0,0,0,0,0,0,-7000
2413,環科            ,13000,23000,-10000,0,0,0,0,0,0,3000,3000,0,3000,0,0,0,-7000
2069,運錩            ,0,7000,-7000,0,0,0,0,0,0,0,0,0,0,0,0,0,-7000
07645P,華通元大9A售06  ,0,0,0,0,0,0,0,0,0,-7000,0,0,0,13000,20000,-7000,-7000
07547P,緯穎凱基9A售05  ,0,0,0,0,0,0,0,0,0,-7000,0,0,0,0,7000,-7000,-7000
07992P,玉晶光群益01售04,0,0,0,0,0,0,0,0,0,-7000,0,0,0,0,7000,-7000,-7000
062735,和大國票9B購01  ,0,0,0,0,0,0,0,0,0,-8000,0,0,0,30000,38000,-8000,-8000
062109,聯詠國票9C購01  ,0,0,0,0,0,0,0,0,0,-8000,0,0,0,22000,30000,-8000,-8000
062085,同欣電元大9B購01,0,0,0,0,0,0,0,0,0,-8000,0,0,0,116000,124000,-8000,-8000
062189,康控元大9B購02  ,0,0,0,0,0,0,0,0,0,-8000,0,0,0,82000,90000,-8000,-8000
06604P,聯發科元富02售02,0,0,0,0,0,0,0,0,0,-8000,0,0,0,448000,456000,-8000,-8000
06518P,奇力新兆豐99售01,0,0,0,0,0,0,0,0,0,-8000,0,0,0,0,8000,-8000,-8000
063543,技嘉台新9B購02  ,0,0,0,0,0,0,0,0,0,-8000,0,0,0,0,8000,-8000,-8000
062954,世芯永豐9B購03  ,0,0,0,0,0,0,0,0,0,-8000,0,0,0,27000,35000,-8000,-8000
052191,超眾群益96購01  ,0,0,0,0,0,0,0,0,0,-8000,0,0,0,0,8000,-8000,-8000
054444,緯穎台新97購01  ,0,0,0,0,0,0,0,0,0,-8000,0,0,0,0,8000,-8000,-8000
054381,世芯群益98購01  ,0,0,0,0,0,0,0,0,0,-8000,0,0,0,71000,79000,-8000,-8000
055796,南電國泰98購01  ,0,0,0,0,0,0,0,0,0,-8000,0,0,0,74000,82000,-8000,-8000
054098,嘉晶國票97購04  ,0,0,0,0,0,0,0,0,0,-8000,0,0,0,4000,12000,-8000,-8000
053095,台光電統一98購01,0,0,0,0,0,0,0,0,0,-8000,0,0,0,16000,24000,-8000,-8000
056921,京元電兆豐98購01,0,0,0,0,0,0,0,0,0,-8000,0,0,0,25000,33000,-8000,-8000
052766,玉晶光群益9A購01,0,0,0,0,0,0,0,0,0,-8000,0,0,0,25000,33000,-8000,-8000
059828,健策凱基99購05  ,0,0,0,0,0,0,0,0,0,-8000,0,0,0,0,8000,-8000,-8000
059756,奇力新富邦9C購01,0,0,0,0,0,0,0,0,0,-8000,0,0,0,0,8000,-8000,-8000
060212,華航康和9A購01  ,0,0,0,0,0,0,0,0,0,-8000,0,0,0,5000,13000,-8000,-8000
055288,日電貿元大97購02,0,0,0,0,0,0,0,0,0,-8000,0,0,0,5000,13000,-8000,-8000
055271,鴻海元大98購03  ,0,0,0,0,0,0,0,0,0,-8000,0,0,0,2000,10000,-8000,-8000
059568,台積電凱基9A購13,0,0,0,0,0,0,0,0,0,-8000,0,0,0,4000,12000,-8000,-8000
059493,國巨國票9B購01  ,0,0,0,0,0,0,0,0,0,-8000,0,0,0,5000,13000,-8000,-8000
060020,康控康和99購01  ,0,0,0,0,0,0,0,0,0,-8000,0,0,0,117000,125000,-8000,-8000
057703,矽力群益98購01  ,0,0,0,0,0,0,0,0,0,-8000,0,0,0,4000,12000,-8000,-8000
060591,富邦金台新9A購01,0,0,0,0,0,0,0,0,0,-8000,0,0,0,0,8000,-8000,-8000
057540,緯穎日盛99購01  ,0,0,0,0,0,0,0,0,0,-8000,0,0,0,0,8000,-8000,-8000
057509,聯發科統一9A購03,0,0,0,0,0,0,0,0,0,-8000,0,0,0,6000,14000,-8000,-8000
057374,禾伸堂元大99購03,0,0,0,0,0,0,0,0,0,-8000,0,0,0,0,8000,-8000,-8000
059006,樺漢元大99購01  ,0,0,0,0,0,0,0,0,0,-8000,0,0,0,62000,70000,-8000,-8000
058749,康控凱基99購03  ,0,0,0,0,0,0,0,0,0,-8000,0,0,0,34000,42000,-8000,-8000
060264,華新科國票9A購02,0,0,0,0,0,0,0,0,0,-8000,0,0,0,3000,11000,-8000,-8000
07824P,國巨元大9A售24  ,0,0,0,0,0,0,0,0,0,-8000,0,0,0,0,8000,-8000,-8000
07814P,華通群益9A售06  ,0,0,0,0,0,0,0,0,0,-8000,0,0,0,0,8000,-8000,-8000
058904,晶技元大99購05  ,0,0,0,0,0,0,0,0,0,-8000,0,0,0,0,8000,-8000,-8000
061175,台積電凱基9A購19,0,0,0,0,0,0,0,0,0,-8000,0,0,0,1000,9000,-8000,-8000
061396,台灣50台新9C購03,0,0,0,0,0,0,0,0,0,-8000,0,0,0,2000,10000,-8000,-8000
08051P,臺股指國票9B售16,0,0,0,0,0,0,0,0,0,-8000,0,0,0,0,8000,-8000,-8000
07609P,台灣50國票9C售04,0,0,0,0,0,0,0,0,0,-8000,0,0,0,12000,20000,-8000,-8000
1219,福壽            ,0,8000,-8000,0,0,0,0,0,0,0,0,0,0,0,0,0,-8000
2433,互盛電          ,1000,9000,-8000,0,0,0,0,0,0,0,0,0,0,0,0,0,-8000
2506,太設            ,0,8000,-8000,0,0,0,0,0,0,0,0,0,0,0,0,0,-8000
2906,高林            ,16000,24000,-8000,0,0,0,0,0,0,0,0,0,0,0,0,0,-8000
2923,鼎固-KY         ,5000,13000,-8000,0,0,0,0,0,0,0,0,0,0,0,0,0,-8000
2816,旺旺保          ,9000,17000,-8000,0,0,0,0,0,0,0,0,0,0,0,0,0,-8000
6477,安集            ,2000,9000,-7000,0,0,0,0,0,0,-1000,0,1000,-1000,0,0,0,-8000
3419,譁裕            ,11000,19000,-8000,0,0,0,0,0,0,0,0,0,0,0,0,0,-8000
8261,富鼎            ,14000,22000,-8000,0,0,0,0,0,0,0,0,0,0,0,0,0,-8000
060918,康友國泰9C購01  ,0,0,0,0,0,0,0,0,0,-8000,0,0,0,17000,25000,-8000,-8000
060705,台光電富邦9B購01,0,0,0,0,0,0,0,0,0,-8000,0,0,0,0,8000,-8000,-8000
062809,同欣電統一9C購01,0,0,0,0,0,0,0,0,0,-9000,0,0,0,150000,159000,-9000,-9000
063569,美食元大9B購03  ,0,0,0,0,0,0,0,0,0,-9000,0,0,0,0,9000,-9000,-9000
062511,台光電國票9B購02,0,0,0,0,0,0,0,0,0,-9000,0,0,0,7000,16000,-9000,-9000
061474,瑞昱元大9A購04  ,0,0,0,0,0,0,0,0,0,-9000,0,0,0,154000,163000,-9000,-9000
061427,旭富元大9A購02  ,0,0,0,0,0,0,0,0,0,-9000,0,0,0,19000,28000,-9000,-9000
061601,台積電凱基9A購26,0,0,0,0,0,0,0,0,0,-9000,0,0,0,0,9000,-9000,-9000
055695,大毅國票98購03  ,0,0,0,0,0,0,0,0,0,-9000,0,0,0,0,9000,-9000,-9000
055710,亞德客元大97購03,0,0,0,0,0,0,0,0,0,-9000,0,0,0,2000,11000,-9000,-9000
055138,大毅永豐97購02  ,0,0,0,0,0,0,0,0,0,-9000,0,0,0,23000,32000,-9000,-9000
054759,台化國票98購01  ,0,0,0,0,0,0,0,0,0,-9000,0,0,0,0,9000,-9000,-9000
056993,GIS兆豐99購01   ,0,0,0,0,0,0,0,0,0,-9000,0,0,0,17000,26000,-9000,-9000
056951,牧德統一99購01  ,0,0,0,0,0,0,0,0,0,-9000,0,0,0,1000,10000,-9000,-9000
054917,聯發科凱基98購05,0,0,0,0,0,0,0,0,0,-9000,0,0,0,0,9000,-9000,-9000
060194,旭富元富9A購01  ,0,0,0,0,0,0,0,0,0,-9000,0,0,0,80000,89000,-9000,-9000
056325,群創兆豐9A購01  ,0,0,0,0,0,0,0,0,0,-9000,0,0,0,0,9000,-9000,-9000
055900,瀚宇博中信97購01,0,0,0,0,0,0,0,0,0,-9000,0,0,0,0,9000,-9000,-9000
054066,緯穎國票97購03  ,0,0,0,0,0,0,0,0,0,-9000,0,0,0,10000,19000,-9000,-9000
055813,聯發科國票98購04,0,0,0,0,0,0,0,0,0,-9000,0,0,0,1000,10000,-9000,-9000
054526,道瓊反統一98購01,0,0,0,0,0,0,0,0,0,-9000,0,0,0,0,9000,-9000,-9000
051094,健策元大96購03  ,0,0,0,0,0,0,0,0,0,-9000,0,0,0,0,9000,-9000,-9000
050496,鴻海富邦96購01  ,0,0,0,0,0,0,0,0,0,-9000,0,0,0,0,9000,-9000,-9000
052235,聯發科國票96購02,0,0,0,0,0,0,0,0,0,-9000,0,0,0,17000,26000,-9000,-9000
00666R,富邦恒生國企反1 ,0,0,0,0,0,0,0,0,0,-9000,0,0,0,101000,110000,-9000,-9000
061179,華擎凱基9A購01  ,0,0,0,0,0,0,0,0,0,-9000,0,0,0,1000,10000,-9000,-9000
061108,臻鼎元大9A購02  ,0,0,0,0,0,0,0,0,0,-9000,0,0,0,1000,10000,-9000,-9000
06110P,國巨國泰98售02  ,0,0,0,0,0,0,0,0,0,-9000,0,0,0,1000,10000,-9000,-9000
05886P,華通元富96售01  ,0,0,0,0,0,0,0,0,0,-9000,0,0,0,0,9000,-9000,-9000
058095,昇陽半元大98購03,0,0,0,0,0,0,0,0,0,-9000,0,0,0,108000,117000,-9000,-9000
058359,瑞昱凱基99購01  ,0,0,0,0,0,0,0,0,0,-9000,0,0,0,40000,49000,-9000,-9000
059136,臺股指群益99購11,0,0,0,0,0,0,0,0,0,-9000,0,0,0,1000,10000,-9000,-9000
058835,元油2X中信9C購02,0,0,0,0,0,0,0,0,0,-9000,0,0,0,0,9000,-9000,-9000
059296,大立光元富99購06,0,0,0,0,0,0,0,0,0,-9000,0,0,0,0,9000,-9000,-9000
059214,國巨元大99購20  ,0,0,0,0,0,0,0,0,0,-9000,0,0,0,0,9000,-9000,-9000
060526,台積電中信9A購02,0,0,0,0,0,0,0,0,0,-9000,0,0,0,3000,12000,-9000,-9000
057878,台郡元大99購04  ,0,0,0,0,0,0,0,0,0,-9000,0,0,0,60000,69000,-9000,-9000
059692,聯詠永豐99購01  ,0,0,0,0,0,0,0,0,0,-9000,0,0,0,20000,29000,-9000,-9000
060704,台積電富邦01購01,0,0,0,0,0,0,0,0,0,-9000,0,0,0,0,9000,-9000,-9000
060850,康友國票9A購03  ,0,0,0,0,0,0,0,0,0,-9000,0,0,0,35000,44000,-9000,-9000
060868,致伸永豐9A購01  ,0,0,0,0,0,0,0,0,0,-9000,0,0,0,49000,58000,-9000,-9000
6184,大豐電          ,1000,10000,-9000,0,0,0,0,0,0,0,0,0,0,0,0,0,-9000
9188,精熙-DR         ,0,9000,-9000,0,0,0,0,0,0,0,0,0,0,0,0,0,-9000
9905,大華            ,0,9000,-9000,0,0,0,0,0,0,0,0,0,0,0,0,0,-9000
8473,山林水          ,0,9000,-9000,0,0,0,0,0,0,0,0,0,0,0,0,0,-9000
2712,遠雄來          ,3000,13000,-10000,0,0,0,0,0,0,1000,1000,0,1000,0,0,0,-9000
2464,盟立            ,36000,36000,0,0,0,0,0,0,0,-9000,0,0,0,0,9000,-9000,-9000
2429,銘旺科          ,34000,43000,-9000,0,0,0,0,0,0,0,0,0,0,0,0,0,-9000
1592,英瑞-KY         ,39000,48000,-9000,0,0,0,0,0,0,0,0,0,0,0,0,0,-9000
1531,高林股          ,1000,11000,-10000,0,0,0,0,0,0,1000,1000,0,1000,0,0,0,-9000
08014P,微星凱基9B售02  ,0,0,0,0,0,0,0,0,0,-9000,0,0,0,16000,25000,-9000,-9000
061609,華新科統一9C購01,0,0,0,0,0,0,0,0,0,-10000,0,0,0,100000,110000,-10000,-10000
061615,鴻海群益9A購06  ,0,0,0,0,0,0,0,0,0,-10000,0,0,0,3000,13000,-10000,-10000
061701,友達國票9B購02  ,0,0,0,0,0,0,0,0,0,-10000,0,0,0,0,10000,-10000,-10000
061680,崇越元大9A購01  ,0,0,0,0,0,0,0,0,0,-10000,0,0,0,0,10000,-10000,-10000
061681,南電元大9A購08  ,0,0,0,0,0,0,0,0,0,-10000,0,0,0,0,10000,-10000,-10000
061407,鴻海國票9A購07  ,0,0,0,0,0,0,0,0,0,-10000,0,0,0,40000,50000,-10000,-10000
061860,臺股指國票9B購04,0,0,0,0,0,0,0,0,0,-10000,0,0,0,5000,15000,-10000,-10000
061852,大立光國票9B購02,0,0,0,0,0,0,0,0,0,-10000,0,0,0,0,10000,-10000,-10000
061839,華新科凱基05購04,0,0,0,0,0,0,0,0,0,-10000,0,0,0,0,10000,-10000,-10000
061814,聯發科群益9B購04,0,0,0,0,0,0,0,0,0,-10000,0,0,0,71000,81000,-10000,-10000
061929,嘉澤凱基9B購01  ,0,0,0,0,0,0,0,0,0,-10000,0,0,0,0,10000,-10000,-10000
061914,台光電中信9B購01,0,0,0,0,0,0,0,0,0,-10000,0,0,0,0,10000,-10000,-10000
061962,台積電統一01購03,0,0,0,0,0,0,0,0,0,-10000,0,0,0,4000,14000,-10000,-10000
062504,旭富群益9B購02  ,0,0,0,0,0,0,0,0,0,-10000,0,0,0,125000,135000,-10000,-10000
062580,華通統一9C購03  ,0,0,0,0,0,0,0,0,0,-10000,0,0,0,0,10000,-10000,-10000
062557,台光電凱基9B購02,0,0,0,0,0,0,0,0,0,-10000,0,0,0,30000,40000,-10000,-10000
062723,聯發科凱基9B購09,0,0,0,0,0,0,0,0,0,-10000,0,0,0,48000,58000,-10000,-10000
062706,大立光元大9B購06,0,0,0,0,0,0,0,0,0,-10000,0,0,0,0,10000,-10000,-10000
062697,國巨元大9C購01  ,0,0,0,0,0,0,0,0,0,-10000,0,0,0,0,10000,-10000,-10000
062309,燿華凱基9B購01  ,0,0,0,0,0,0,0,0,0,-10000,0,0,0,0,10000,-10000,-10000
063551,美食國票9B購02  ,0,0,0,0,0,0,0,0,0,-10000,0,0,0,0,10000,-10000,-10000
063598,國巨凱基9B購14  ,0,0,0,0,0,0,0,0,0,-10000,0,0,0,0,10000,-10000,-10000
063471,泰鼎元大9C購01  ,0,0,0,0,0,0,0,0,0,-10000,0,0,0,0,10000,-10000,-10000
06510P,燿華永豐98售03  ,0,0,0,0,0,0,0,0,0,-10000,0,0,0,0,10000,-10000,-10000
06872P,亞德客元富98售04,0,0,0,0,0,0,0,0,0,-10000,0,0,0,0,10000,-10000,-10000
06896P,信邦中信98售01  ,0,0,0,0,0,0,0,0,0,-10000,0,0,0,0,10000,-10000,-10000
06802P,緯穎群益98售03  ,0,0,0,0,0,0,0,0,0,-10000,0,0,0,0,10000,-10000,-10000
06671P,台積電群益98售04,0,0,0,0,0,0,0,0,0,-10000,0,0,0,0,10000,-10000,-10000
06732P,台灣50日盛9A售01,0,0,0,0,0,0,0,0,0,-10000,0,0,0,0,10000,-10000,-10000
06745P,台積電群益98售05,0,0,0,0,0,0,0,0,0,-10000,0,0,0,0,10000,-10000,-10000
07046P,大立光富邦9C售03,0,0,0,0,0,0,0,0,0,-10000,0,0,0,0,10000,-10000,-10000
07002P,鴻海兆豐99售04  ,0,0,0,0,0,0,0,0,0,-10000,0,0,0,0,10000,-10000,-10000
07027P,台積電群益99售04,0,0,0,0,0,0,0,0,0,-10000,0,0,0,2000,12000,-10000,-10000
062783,大立光元大9C購03,0,0,0,0,0,0,0,0,0,-10000,0,0,0,0,10000,-10000,-10000
062762,聯詠凱基9B購02  ,0,0,0,0,0,0,0,0,0,-10000,0,0,0,0,10000,-10000,-10000
062870,亞德客兆豐9C購01,0,0,0,0,0,0,0,0,0,-10000,0,0,0,95000,105000,-10000,-10000
06293P,臺股指國票97售07,0,0,0,0,0,0,0,0,0,-10000,0,0,0,0,10000,-10000,-10000
062978,世芯元富9B購01  ,0,0,0,0,0,0,0,0,0,-10000,0,0,0,0,10000,-10000,-10000
063021,大立光元大9C購05,0,0,0,0,0,0,0,0,0,-10000,0,0,0,0,10000,-10000,-10000
063264,健策永豐9B購07  ,0,0,0,0,0,0,0,0,0,-10000,0,0,0,8000,18000,-10000,-10000
063160,牧德富邦9C購02  ,0,0,0,0,0,0,0,0,0,-10000,0,0,0,0,10000,-10000,-10000
063178,聯發科兆豐9B購04,0,0,0,0,0,0,0,0,0,-10000,0,0,0,0,10000,-10000,-10000
063395,金像電群益9B購02,0,0,0,0,0,0,0,0,0,-10000,0,0,0,40000,50000,-10000,-10000
045444,群創元富98購02  ,0,0,0,0,0,0,0,0,0,-10000,0,0,0,0,10000,-10000,-10000
052201,超眾統一96購01  ,0,0,0,0,0,0,0,0,0,-10000,0,0,0,0,10000,-10000,-10000
051490,世芯凱基96購01  ,0,0,0,0,0,0,0,0,0,-10000,0,0,0,0,10000,-10000,-10000
050603,致新國泰96購01  ,0,0,0,0,0,0,0,0,0,-10000,0,0,0,0,10000,-10000,-10000
050099,台積電永昌96購01,0,0,0,0,0,0,0,0,0,-10000,0,0,0,405000,415000,-10000,-10000
050485,國巨統一96購01  ,0,0,0,0,0,0,0,0,0,-10000,0,0,0,150000,160000,-10000,-10000
04874P,高股息中信97售01,0,0,0,0,0,0,0,0,0,-10000,0,0,0,0,10000,-10000,-10000
051369,新光金富邦9A購01,0,0,0,0,0,0,0,0,0,-10000,0,0,0,0,10000,-10000,-10000
03094X,大立光元大68展08,0,0,0,0,0,0,0,0,0,-10000,0,0,0,0,10000,-10000,-10000
054167,揚明光凱基98購01,0,0,0,0,0,0,0,0,0,-10000,0,0,0,0,10000,-10000,-10000
054170,泰鼎凱基98購01  ,0,0,0,0,0,0,0,0,0,-10000,0,0,0,0,10000,-10000,-10000
052684,旺宏元大98購01  ,0,0,0,0,0,0,0,0,0,-10000,0,0,0,0,10000,-10000,-10000
054445,技嘉兆豐96購01  ,0,0,0,0,0,0,0,0,0,-10000,0,0,0,0,10000,-10000,-10000
054248,燿華元大97購02  ,0,0,0,0,0,0,0,0,0,-10000,0,0,0,0,10000,-10000,-10000
054261,智伸科元大96購03,0,0,0,0,0,0,0,0,0,-10000,0,0,0,0,10000,-10000,-10000
054280,牧德群益98購01  ,0,0,0,0,0,0,0,0,0,-10000,0,0,0,0,10000,-10000,-10000
054266,緯穎元大96購07  ,0,0,0,0,0,0,0,0,0,-10000,0,0,0,0,10000,-10000,-10000
055809,T50反1國票98購02,0,0,0,0,0,0,0,0,0,-10000,0,0,0,0,10000,-10000,-10000
053162,緯穎元大97購01  ,0,0,0,0,0,0,0,0,0,-10000,0,0,0,0,10000,-10000,-10000
055930,可成群益98購01  ,0,0,0,0,0,0,0,0,0,-10000,0,0,0,0,10000,-10000,-10000
055960,義隆元大97購01  ,0,0,0,0,0,0,0,0,0,-10000,0,0,0,10000,20000,-10000,-10000
056923,奇力新兆豐99購02,0,0,0,0,0,0,0,0,0,-10000,0,0,0,0,10000,-10000,-10000
056925,群創兆豐98購03  ,0,0,0,0,0,0,0,0,0,-10000,0,0,0,0,10000,-10000,-10000
056892,旺宏元大9A購02  ,0,0,0,0,0,0,0,0,0,-10000,0,0,0,0,10000,-10000,-10000
053945,國巨富邦98購02  ,0,0,0,0,0,0,0,0,0,-10000,0,0,0,0,10000,-10000,-10000
053869,嘉澤元大96購02  ,0,0,0,0,0,0,0,0,0,-10000,0,0,0,0,10000,-10000,-10000
053797,台積電中信98購01,0,0,0,0,0,0,0,0,0,-10000,0,0,0,0,10000,-10000,-10000
053027,玉晶光富邦98購01,0,0,0,0,0,0,0,0,0,-10000,0,0,0,0,10000,-10000,-10000
054716,緯穎康和97購01  ,0,0,0,0,0,0,0,0,0,-10000,0,0,0,0,10000,-10000,-10000
053005,微星永豐96購01  ,0,0,0,0,0,0,0,0,0,-10000,0,0,0,0,10000,-10000,-10000
053960,晶技永豐96購02  ,0,0,0,0,0,0,0,0,0,-10000,0,0,0,2000,12000,-10000,-10000
052858,華通凱基97購02  ,0,0,0,0,0,0,0,0,0,-10000,0,0,0,0,10000,-10000,-10000
052961,國巨凱基97購02  ,0,0,0,0,0,0,0,0,0,-10000,0,0,0,0,10000,-10000,-10000
052827,昇陽半永豐97購01,0,0,0,0,0,0,0,0,0,-10000,0,0,0,0,10000,-10000,-10000
052837,友達國泰97購01  ,0,0,0,0,0,0,0,0,0,-10000,0,0,0,0,10000,-10000,-10000
053627,宏碁兆豐97購01  ,0,0,0,0,0,0,0,0,0,-10000,0,0,0,0,10000,-10000,-10000
053587,京元電元大98購01,0,0,0,0,0,0,0,0,0,-10000,0,0,0,0,10000,-10000,-10000
053527,創意中信97購01  ,0,0,0,0,0,0,0,0,0,-10000,0,0,0,0,10000,-10000,-10000
053497,新光金兆豐97購01,0,0,0,0,0,0,0,0,0,-10000,0,0,0,0,10000,-10000,-10000
053377,台積電元大98購01,0,0,0,0,0,0,0,0,0,-10000,0,0,0,0,10000,-10000,-10000
053399,創意中信96購01  ,0,0,0,0,0,0,0,0,0,-10000,0,0,0,0,10000,-10000,-10000
054621,華新科兆豐98購01,0,0,0,0,0,0,0,0,0,-10000,0,0,0,0,10000,-10000,-10000
054578,世芯元大99購01  ,0,0,0,0,0,0,0,0,0,-10000,0,0,0,0,10000,-10000,-10000
054662,同欣電元大97購02,0,0,0,0,0,0,0,0,0,-10000,0,0,0,40000,50000,-10000,-10000
053274,旺宏元大98購03  ,0,0,0,0,0,0,0,0,0,-10000,0,0,0,0,10000,-10000,-10000
053332,創意永豐96購03  ,0,0,0,0,0,0,0,0,0,-10000,0,0,0,10000,20000,-10000,-10000
056782,鴻海群益98購04  ,0,0,0,0,0,0,0,0,0,-10000,0,0,0,0,10000,-10000,-10000
056753,群創兆豐98購02  ,0,0,0,0,0,0,0,0,0,-10000,0,0,0,0,10000,-10000,-10000
056344,嘉晶凱基98購02  ,0,0,0,0,0,0,0,0,0,-10000,0,0,0,0,10000,-10000,-10000
056634,為升兆豐99購01  ,0,0,0,0,0,0,0,0,0,-10000,0,0,0,0,10000,-10000,-10000
056623,禾伸堂永豐98購01,0,0,0,0,0,0,0,0,0,-10000,0,0,0,10000,20000,-10000,-10000
056405,聯茂群益98購01  ,0,0,0,0,0,0,0,0,0,-10000,0,0,0,0,10000,-10000,-10000
056464,臺股指凱基99購06,0,0,0,0,0,0,0,0,0,-10000,0,0,0,0,10000,-10000,-10000
056457,嘉澤凱基98購01  ,0,0,0,0,0,0,0,0,0,-10000,0,0,0,0,10000,-10000,-10000
056441,燿華凱基98購01  ,0,0,0,0,0,0,0,0,0,-10000,0,0,0,0,10000,-10000,-10000
05649P,矽創國票97售03  ,0,0,0,0,0,0,0,0,0,-10000,0,0,0,0,10000,-10000,-10000
056551,台郡凱基98購04  ,0,0,0,0,0,0,0,0,0,-10000,0,0,0,10000,20000,-10000,-10000
06018P,康控凱基96售03  ,0,0,0,0,0,0,0,0,0,-10000,0,0,0,0,10000,-10000,-10000
060109,茂林元大99購05  ,0,0,0,0,0,0,0,0,0,-10000,0,0,0,9000,19000,-10000,-10000
060220,華新科凱基9A購08,0,0,0,0,0,0,0,0,0,-10000,0,0,0,0,10000,-10000,-10000
059874,大立光凱基99購15,0,0,0,0,0,0,0,0,0,-10000,0,0,0,0,10000,-10000,-10000
059877,康控凱基99購05  ,0,0,0,0,0,0,0,0,0,-10000,0,0,0,0,10000,-10000,-10000
059861,聯發科群益9A購01,0,0,0,0,0,0,0,0,0,-10000,0,0,0,0,10000,-10000,-10000
059853,超眾永豐99購03  ,0,0,0,0,0,0,0,0,0,-10000,0,0,0,0,10000,-10000,-10000
059909,鴻海元大99購36  ,0,0,0,0,0,0,0,0,0,-10000,0,0,0,53000,63000,-10000,-10000
059975,元金2X元大99購02,0,0,0,0,0,0,0,0,0,-10000,0,0,0,12000,22000,-10000,-10000
054913,億光凱基97購01  ,0,0,0,0,0,0,0,0,0,-10000,0,0,0,0,10000,-10000,-10000
054982,國巨元富97購03  ,0,0,0,0,0,0,0,0,0,-10000,0,0,0,0,10000,-10000,-10000
056155,嘉晶凱基97購01  ,0,0,0,0,0,0,0,0,0,-10000,0,0,0,0,10000,-10000,-10000
056139,貿聯元大97購04  ,0,0,0,0,0,0,0,0,0,-10000,0,0,0,0,10000,-10000,-10000
057061,華擎國泰9A購01  ,0,0,0,0,0,0,0,0,0,-10000,0,0,0,0,10000,-10000,-10000
057088,上銀元富98購01  ,0,0,0,0,0,0,0,0,0,-10000,0,0,0,16000,26000,-10000,-10000
056976,喬山群益98購01  ,0,0,0,0,0,0,0,0,0,-10000,0,0,0,0,10000,-10000,-10000
057031,滬深反元大9B購02,0,0,0,0,0,0,0,0,0,-10000,0,0,0,0,10000,-10000,-10000
054859,鴻海群益97購02  ,0,0,0,0,0,0,0,0,0,-10000,0,0,0,0,10000,-10000,-10000
054848,群創兆豐98購01  ,0,0,0,0,0,0,0,0,0,-10000,0,0,0,0,10000,-10000,-10000
054850,上海銀兆豐97購01,0,0,0,0,0,0,0,0,0,-10000,0,0,0,0,10000,-10000,-10000
05569P,漢唐統一97售01  ,0,0,0,0,0,0,0,0,0,-10000,0,0,0,60000,70000,-10000,-10000
055675,亞德客凱基97購02,0,0,0,0,0,0,0,0,0,-10000,0,0,0,4000,14000,-10000,-10000
055627,亞德客永豐97購02,0,0,0,0,0,0,0,0,0,-10000,0,0,0,7000,17000,-10000,-10000
055330,上銀兆豐98購02  ,0,0,0,0,0,0,0,0,0,-10000,0,0,0,0,10000,-10000,-10000
055354,宏達電凱基98購01,0,0,0,0,0,0,0,0,0,-10000,0,0,0,0,10000,-10000,-10000
055382,台郡元大99購01  ,0,0,0,0,0,0,0,0,0,-10000,0,0,0,0,10000,-10000,-10000
055531,華新科群益98購03,0,0,0,0,0,0,0,0,0,-10000,0,0,0,0,10000,-10000,-10000
05555P,健策群益98售01  ,0,0,0,0,0,0,0,0,0,-10000,0,0,0,0,10000,-10000,-10000
055435,佳世達中信99購01,0,0,0,0,0,0,0,0,0,-10000,0,0,0,0,10000,-10000,-10000
059705,華新科凱基9A購07,0,0,0,0,0,0,0,0,0,-10000,0,0,0,0,10000,-10000,-10000
059687,卜蜂永豐99購01  ,0,0,0,0,0,0,0,0,0,-10000,0,0,0,0,10000,-10000,-10000
059719,台積電元大99購42,0,0,0,0,0,0,0,0,0,-10000,0,0,0,1000,11000,-10000,-10000
059485,台灣50兆豐99購02,0,0,0,0,0,0,0,0,0,-10000,0,0,0,0,10000,-10000,-10000
059476,道瓊指群益9C購01,0,0,0,0,0,0,0,0,0,-10000,0,0,0,0,10000,-10000,-10000
059529,華新科凱基9A購04,0,0,0,0,0,0,0,0,0,-10000,0,0,0,0,10000,-10000,-10000
058573,鴻海群益9A購02  ,0,0,0,0,0,0,0,0,0,-10000,0,0,0,10000,20000,-10000,-10000
059435,大立光元大99購17,0,0,0,0,0,0,0,0,0,-10000,0,0,0,0,10000,-10000,-10000
060059,鴻海兆豐99購06  ,0,0,0,0,0,0,0,0,0,-10000,0,0,0,0,10000,-10000,-10000
057678,臺股指元大98購08,0,0,0,0,0,0,0,0,0,-10000,0,0,0,0,10000,-10000,-10000
059572,華新科凱基99購08,0,0,0,0,0,0,0,0,0,-10000,0,0,0,0,10000,-10000,-10000
057841,茂林富邦9A購02  ,0,0,0,0,0,0,0,0,0,-10000,0,0,0,0,10000,-10000,-10000
058635,華新科兆豐99購03,0,0,0,0,0,0,0,0,0,-10000,0,0,0,31000,41000,-10000,-10000
057792,群創統一99購01  ,0,0,0,0,0,0,0,0,0,-10000,0,0,0,0,10000,-10000,-10000
060379,T50反1凱基9A購07,0,0,0,0,0,0,0,0,0,-10000,0,0,0,0,10000,-10000,-10000
060382,儒鴻凱基9A購01  ,0,0,0,0,0,0,0,0,0,-10000,0,0,0,0,10000,-10000,-10000
057305,南亞科兆豐98購02,0,0,0,0,0,0,0,0,0,-10000,0,0,0,0,10000,-10000,-10000
057273,智邦元大98購05  ,0,0,0,0,0,0,0,0,0,-10000,0,0,0,7000,17000,-10000,-10000
057600,大立光群益99購03,0,0,0,0,0,0,0,0,0,-10000,0,0,0,0,10000,-10000,-10000
057657,國巨兆豐98購04  ,0,0,0,0,0,0,0,0,0,-10000,0,0,0,0,10000,-10000,-10000
057243,樺漢凱基99購01  ,0,0,0,0,0,0,0,0,0,-10000,0,0,0,0,10000,-10000,-10000
058286,道瓊指國票9B購01,0,0,0,0,0,0,0,0,0,-10000,0,0,0,0,10000,-10000,-10000
058280,SGBR2X中信99購01,0,0,0,0,0,0,0,0,0,-10000,0,0,0,0,10000,-10000,-10000
058205,神達凱基9B購01  ,0,0,0,0,0,0,0,0,0,-10000,0,0,0,10000,20000,-10000,-10000
05871P,全新凱基96售04  ,0,0,0,0,0,0,0,0,0,-10000,0,0,0,0,10000,-10000,-10000
058735,南茂永豐99購01  ,0,0,0,0,0,0,0,0,0,-10000,0,0,0,0,10000,-10000,-10000
060525,台積電中信01購04,0,0,0,0,0,0,0,0,0,-10000,0,0,0,3000,13000,-10000,-10000
060604,宏達電凱基9B購01,0,0,0,0,0,0,0,0,0,-10000,0,0,0,8000,18000,-10000,-10000
060581,玉晶光群益9B購02,0,0,0,0,0,0,0,0,0,-10000,0,0,0,5000,15000,-10000,-10000
057379,寶成元大98購02  ,0,0,0,0,0,0,0,0,0,-10000,0,0,0,0,10000,-10000,-10000
057393,台積電中信02購01,0,0,0,0,0,0,0,0,0,-10000,0,0,0,0,10000,-10000,-10000
057410,南電群益98購01  ,0,0,0,0,0,0,0,0,0,-10000,0,0,0,0,10000,-10000,-10000
057489,奇力新元大99購06,0,0,0,0,0,0,0,0,0,-10000,0,0,0,0,10000,-10000,-10000
057524,旺宏元大99購04  ,0,0,0,0,0,0,0,0,0,-10000,0,0,0,0,10000,-10000,-10000
057531,禾伸堂元大99購04,0,0,0,0,0,0,0,0,0,-10000,0,0,0,50000,60000,-10000,-10000
059223,大立光元大99購14,0,0,0,0,0,0,0,0,0,-10000,0,0,0,0,10000,-10000,-10000
059238,台積電凱基99購11,0,0,0,0,0,0,0,0,0,-10000,0,0,0,1000,11000,-10000,-10000
059250,大立光凱基99購06,0,0,0,0,0,0,0,0,0,-10000,0,0,0,10000,20000,-10000,-10000
059304,華新科兆豐99購06,0,0,0,0,0,0,0,0,0,-10000,0,0,0,0,10000,-10000,-10000
059318,旺宏元大99購13  ,0,0,0,0,0,0,0,0,0,-10000,0,0,0,0,10000,-10000,-10000
059291,華新科元富9B購01,0,0,0,0,0,0,0,0,0,-10000,0,0,0,0,10000,-10000,-10000
058855,台積電兆豐99購02,0,0,0,0,0,0,0,0,0,-10000,0,0,0,85000,95000,-10000,-10000
058848,台積電群益99購07,0,0,0,0,0,0,0,0,0,-10000,0,0,0,5000,15000,-10000,-10000
060280,元金2X元大9A購01,0,0,0,0,0,0,0,0,0,-10000,0,0,0,0,10000,-10000,-10000
059124,台積電第一03購01,0,0,0,0,0,0,0,0,0,-10000,0,0,0,12000,22000,-10000,-10000
05910P,力山永豐96售02  ,0,0,0,0,0,0,0,0,0,-10000,0,0,0,20000,30000,-10000,-10000
059072,元油2X元大9C購13,0,0,0,0,0,0,0,0,0,-10000,0,0,0,0,10000,-10000,-10000
058363,全新凱基9A購02  ,0,0,0,0,0,0,0,0,0,-10000,0,0,0,10000,20000,-10000,-10000
058401,華航元大9A購01  ,0,0,0,0,0,0,0,0,0,-10000,0,0,0,0,10000,-10000,-10000
058297,茂林凱基9A購02  ,0,0,0,0,0,0,0,0,0,-10000,0,0,0,0,10000,-10000,-10000
058354,台積電凱基9A購06,0,0,0,0,0,0,0,0,0,-10000,0,0,0,0,10000,-10000,-10000
058116,正崴中信99購02  ,0,0,0,0,0,0,0,0,0,-10000,0,0,0,48000,58000,-10000,-10000
058112,神達元富98購01  ,0,0,0,0,0,0,0,0,0,-10000,0,0,0,0,10000,-10000,-10000
058123,亞光國票9A購01  ,0,0,0,0,0,0,0,0,0,-10000,0,0,0,0,10000,-10000,-10000
058497,新日興群益9B購01,0,0,0,0,0,0,0,0,0,-10000,0,0,0,414000,424000,-10000,-10000
058443,T50正2富邦01購01,0,0,0,0,0,0,0,0,0,-10000,0,0,0,0,10000,-10000,-10000
058882,晶相光永豐99購01,0,0,0,0,0,0,0,0,0,-10000,0,0,0,0,10000,-10000,-10000
07802P,瑞昱永豐9A售03  ,0,0,0,0,0,0,0,0,0,-10000,0,0,0,10000,20000,-10000,-10000
058948,道瓊銀群益9C購01,0,0,0,0,0,0,0,0,0,-10000,0,0,0,0,10000,-10000,-10000
058964,群創兆豐99購01  ,0,0,0,0,0,0,0,0,0,-10000,0,0,0,0,10000,-10000,-10000
061053,國巨群益9A購08  ,0,0,0,0,0,0,0,0,0,-10000,0,0,0,0,10000,-10000,-10000
07854P,台積電凱基9A售28,0,0,0,0,0,0,0,0,0,-10000,0,0,0,0,10000,-10000,-10000
061150,國巨群益9A購09  ,0,0,0,0,0,0,0,0,0,-10000,0,0,0,0,10000,-10000,-10000
061380,巨大永豐9A購02  ,0,0,0,0,0,0,0,0,0,-10000,0,0,0,0,10000,-10000,-10000
061294,奇力新麥證9A購01,0,0,0,0,10000,-10000,0,0,0,-10000,0,0,0,0,10000,-10000,-10000
08011P,玉晶光元大9B售05,0,0,0,0,0,0,0,0,0,-10000,0,0,0,10000,20000,-10000,-10000
08091P,A50正2元富9B售02,0,0,0,0,0,0,0,0,0,-10000,0,0,0,0,10000,-10000,-10000
08116P,臺股指凱基9B售17,0,0,0,0,0,0,0,0,0,-10000,0,0,0,0,10000,-10000,-10000
08107P,聯發科統一9B售10,0,0,0,0,0,0,0,0,0,-10000,0,0,0,0,10000,-10000,-10000
07617P,聯發科中信9C售04,0,0,0,0,0,0,0,0,0,-10000,0,0,0,0,10000,-10000,-10000
07672P,南電元大9A售05  ,0,0,0,0,0,0,0,0,0,-10000,0,0,0,65000,75000,-10000,-10000
07689P,旺宏元大9A售13  ,0,0,0,0,0,0,0,0,0,-10000,0,0,0,74000,84000,-10000,-10000
07189P,聯發科富邦9B售03,0,0,0,0,0,0,0,0,0,-10000,0,0,0,20000,30000,-10000,-10000
07193P,聯發科元大99售24,0,0,0,0,0,0,0,0,0,-10000,0,0,0,0,10000,-10000,-10000
07344P,鴻海富邦9A售03  ,0,0,0,0,0,0,0,0,0,-10000,0,0,0,17000,27000,-10000,-10000
07288P,台灣50凱基99售06,0,0,0,0,0,0,0,0,0,-10000,0,0,0,10000,20000,-10000,-10000
07305P,T50正2群益99售02,0,0,0,0,0,0,0,0,0,-10000,0,0,0,25000,35000,-10000,-10000
2115,六暉-KY         ,0,10000,-10000,0,0,0,0,0,0,0,0,0,0,0,0,0,-10000
2228,劍麟            ,22000,32000,-10000,0,0,0,0,0,0,0,0,0,0,0,0,0,-10000
2373,震旦行          ,0,10000,-10000,0,0,0,0,0,0,0,0,0,0,0,0,0,-10000
060923,全新永豐9A購01  ,0,0,0,0,0,0,0,0,0,-10000,0,0,0,0,10000,-10000,-10000
060829,T50反1國票9A購06,0,0,0,0,0,0,0,0,0,-10000,0,0,0,60000,70000,-10000,-10000
060758,台積電元大9A購19,0,0,0,0,0,0,0,0,0,-10000,0,0,0,145000,155000,-10000,-10000
2496,卓越            ,1875,12287,-10412,0,0,0,0,0,0,0,0,0,0,0,0,0,-10412
9946,三發地產        ,6000,16756,-10756,0,0,0,0,0,0,0,0,0,0,0,0,0,-10756
063286,嘉澤元大9B購04  ,0,0,0,0,0,0,0,0,0,-11000,0,0,0,5000,16000,-11000,-11000
063362,台表科國泰01購03,0,0,0,0,0,0,0,0,0,-11000,0,0,0,0,11000,-11000,-11000
063190,聯茂凱基9B購01  ,0,0,0,0,0,0,0,0,0,-11000,0,0,0,19000,30000,-11000,-11000
063106,台表科群益9B購03,0,0,0,0,0,0,0,0,0,-11000,0,0,0,0,11000,-11000,-11000
06286P,世芯國票97售02  ,0,0,0,0,0,0,0,0,0,-11000,0,0,0,0,11000,-11000,-11000
062863,聯茂國票9B購01  ,0,0,0,0,0,0,0,0,0,-11000,0,0,0,26000,37000,-11000,-11000
062906,全新元大9B購03  ,0,0,0,0,0,0,0,0,0,-11000,0,0,0,0,11000,-11000,-11000
07114P,旺宏兆豐9A售01  ,0,0,0,0,0,0,0,0,0,-11000,0,0,0,0,11000,-11000,-11000
063674,力山國泰01購02  ,0,0,0,0,0,0,0,0,0,-11000,0,0,0,0,11000,-11000,-11000
062177,上銀元大9B購02  ,0,0,0,0,0,0,0,0,0,-11000,0,0,0,0,11000,-11000,-11000
062636,聯鈞國票9B購01  ,0,0,0,0,0,0,0,0,0,-11000,0,0,0,0,11000,-11000,-11000
062626,台積電國票9C購04,0,0,0,0,0,0,0,0,0,-11000,0,0,0,1000,12000,-11000,-11000
062456,台積電群益9B購05,0,0,0,0,0,0,0,0,0,-11000,0,0,0,1000,12000,-11000,-11000
061932,上銀國票9B購01  ,0,0,0,0,0,0,0,0,0,-11000,0,0,0,0,11000,-11000,-11000
061582,麗豐元大9A購01  ,0,0,0,0,0,0,0,0,0,-11000,0,0,0,38000,49000,-11000,-11000
061596,健策永豐9A購03  ,0,0,0,0,0,0,0,0,0,-11000,0,0,0,21000,32000,-11000,-11000
055589,台光電元大98購04,0,0,0,0,0,0,0,0,0,-11000,0,0,0,0,11000,-11000,-11000
060114,緯穎元大99購10  ,0,0,0,0,0,0,0,0,0,-11000,0,0,0,4000,15000,-11000,-11000
060088,國巨元大99購30  ,0,0,0,0,0,0,0,0,0,-11000,0,0,0,2000,13000,-11000,-11000
059796,台積電國票99購10,0,0,0,0,0,0,0,0,0,-11000,0,0,0,1000,12000,-11000,-11000
056680,華通統一98購04  ,0,0,0,0,0,0,0,0,0,-11000,0,0,0,602000,613000,-11000,-11000
056025,嘉晶群益97購01  ,80000,80000,0,0,0,0,0,0,0,-11000,0,0,0,131000,142000,-11000,-11000
055929,聯發科群益97購05,0,0,0,0,0,0,0,0,0,-11000,0,0,0,150000,161000,-11000,-11000
05590P,臺股指中信96售05,0,0,0,0,0,0,0,0,0,-11000,0,0,0,95000,106000,-11000,-11000
052434,茂林國泰97購01  ,0,0,0,0,0,0,0,0,0,-11000,0,0,0,20000,31000,-11000,-11000
03425B,臺股指元大9A熊01,0,0,0,0,0,0,0,0,0,-11000,0,0,0,0,11000,-11000,-11000
048270,T50反1富邦99購01,0,0,0,0,0,0,0,0,0,-11000,0,0,0,2000,13000,-11000,-11000
05088P,大立光富邦99售01,0,0,0,0,0,0,0,0,0,-11000,0,0,0,2000,13000,-11000,-11000
051614,元金2X凱基97購01,0,0,0,0,0,0,0,0,0,-11000,0,0,0,0,11000,-11000,-11000
051830,健策元大97購01  ,0,0,0,0,0,0,0,0,0,-11000,0,0,0,1000,12000,-11000,-11000
00707R,元大S&P日圓反1  ,0,0,0,0,0,0,0,0,0,-11000,0,0,0,1000,12000,-11000,-11000
00762,元大全球AI      ,0,0,0,0,0,0,0,0,0,-11000,0,0,0,44000,55000,-11000,-11000
061111,台表科元大9A購02,0,0,0,0,0,0,0,0,0,-11000,0,0,0,69000,80000,-11000,-11000
061100,SP黃豆元大9A購04,0,0,0,0,0,0,0,0,0,-11000,0,0,0,0,11000,-11000,-11000
061212,聯鈞元大9A購04  ,0,0,0,0,0,0,0,0,0,-11000,0,0,0,89000,100000,-11000,-11000
061036,晶技永豐9A購03  ,0,0,0,0,0,0,0,0,0,-11000,0,0,0,3000,14000,-11000,-11000
058973,麗豐永豐99購01  ,0,0,0,0,0,0,0,0,0,-11000,0,0,0,14000,25000,-11000,-11000
07797P,大立光國票9A售08,0,0,0,0,0,0,0,0,0,-11000,0,0,0,7000,18000,-11000,-11000
058900,旺宏元大99購11  ,0,0,0,0,0,0,0,0,0,-11000,0,0,0,17000,28000,-11000,-11000
059649,矽力凱基99購02  ,0,0,0,0,0,0,0,0,0,-11000,0,0,0,12000,23000,-11000,-11000
058026,上銀富邦9A購01  ,0,0,0,0,0,0,0,0,0,-11000,0,0,0,49000,60000,-11000,-11000
059027,神達台新99購02  ,0,0,0,0,0,0,0,0,0,-11000,0,0,0,1000,12000,-11000,-11000
059224,大立光元大99購15,0,0,0,0,0,0,0,0,0,-11000,0,0,0,0,11000,-11000,-11000
059163,台積電凱基99購10,0,0,0,0,0,0,0,0,0,-11000,0,0,0,2000,13000,-11000,-11000
059165,南亞科凱基99購04,0,0,0,0,0,0,0,0,0,-11000,0,0,0,19000,30000,-11000,-11000
057304,為升兆豐99購02  ,0,0,0,0,0,0,0,0,0,-11000,0,0,0,0,11000,-11000,-11000
057843,晶技永豐98購02  ,0,0,0,0,0,0,0,0,0,-11000,0,0,0,0,11000,-11000,-11000
057909,台光電兆豐98購01,0,0,0,0,0,0,0,0,0,-11000,0,0,0,8000,19000,-11000,-11000
059642,健策凱基99購04  ,0,0,0,0,0,0,0,0,0,-11000,0,0,0,0,11000,-11000,-11000
057774,台光電群益99購02,0,0,0,0,0,0,0,0,0,-11000,0,0,0,0,11000,-11000,-11000
057752,臺股指國票98購08,0,0,0,0,0,0,0,0,0,-11000,0,0,0,15000,26000,-11000,-11000
9942,茂順            ,9000,20000,-11000,0,0,0,0,0,0,0,0,0,0,0,0,0,-11000
9924,福興            ,0,11000,-11000,0,0,0,0,0,0,0,0,0,0,0,0,0,-11000
060940,國巨國票9B購03  ,0,0,0,0,0,0,0,0,0,-11000,0,0,0,1000,12000,-11000,-11000
060656,國巨統一9C購03  ,0,0,0,0,0,0,0,0,0,-11000,0,0,0,0,11000,-11000,-11000
4912,聯德控股-KY     ,1000,12000,-11000,0,0,0,0,0,0,0,0,0,0,0,0,0,-11000
2545,皇翔            ,19000,30000,-11000,0,0,0,0,0,0,0,0,0,0,0,0,0,-11000
2359,所羅門          ,9000,20000,-11000,0,0,0,0,0,0,0,0,0,0,0,0,0,-11000
3043,科風            ,0,11000,-11000,0,0,0,0,0,0,0,0,0,0,0,0,0,-11000
2109,華豐            ,6000,15000,-9000,0,0,0,0,0,0,-2000,0,2000,-2000,0,0,0,-11000
2007,燁興            ,0,11000,-11000,0,0,0,0,0,0,0,0,0,0,0,0,0,-11000
1773,勝一            ,23000,37000,-14000,0,0,0,0,0,0,3000,3000,0,3000,0,0,0,-11000
1231,聯華食          ,2000,13000,-11000,0,0,0,0,0,0,0,0,0,0,0,0,0,-11000
1225,福懋油          ,5000,16000,-11000,0,0,0,0,0,0,0,0,0,0,0,0,0,-11000
07341P,台積電凱基99售18,0,0,0,0,0,0,0,0,0,-11000,0,0,0,0,11000,-11000,-11000
07508P,華新科國票9A售03,0,0,0,0,0,0,0,0,0,-11000,0,0,0,9000,20000,-11000,-11000
07879P,瑞昱群益9C售01  ,0,0,0,0,0,0,0,0,0,-11000,0,0,0,0,11000,-11000,-11000
062450,臻鼎元大9B購02  ,0,0,0,0,0,0,0,0,0,-12000,0,0,0,56000,68000,-12000,-12000
062685,華新科統一9C購03,0,0,0,0,0,0,0,0,0,-12000,0,0,0,0,12000,-12000,-12000
062231,台光電麥證9C購01,0,0,0,3000,15000,-12000,0,0,0,-12000,0,0,0,3000,15000,-12000,-12000
062322,元金2X統一01購01,0,0,0,0,0,0,0,0,0,-12000,0,0,0,0,12000,-12000,-12000
062368,聯詠元大9B購01  ,0,0,0,0,0,0,0,0,0,-12000,0,0,0,5000,17000,-12000,-12000
062391,台達電富邦9C購01,0,0,0,0,0,0,0,0,0,-12000,0,0,0,0,12000,-12000,-12000
063589,美食永豐9B購02  ,0,0,0,0,0,0,0,0,0,-12000,0,0,0,0,12000,-12000,-12000
063470,泰鼎元大9B購03  ,0,0,0,0,0,0,0,0,0,-12000,0,0,0,0,12000,-12000,-12000
06412P,南亞科日盛97售01,0,0,0,0,0,0,0,0,0,-12000,0,0,0,0,12000,-12000,-12000
07055P,景碩群益9A售02  ,0,0,0,0,0,0,0,0,0,-12000,0,0,0,18000,30000,-12000,-12000
063050,葡萄王統一01購01,0,0,0,0,0,0,0,0,0,-12000,0,0,0,0,12000,-12000,-12000
062947,國巨富邦01購01  ,0,0,0,0,0,0,0,0,0,-12000,0,0,0,16000,28000,-12000,-12000
063170,智邦第一9B購01  ,0,0,0,0,0,0,0,0,0,-12000,0,0,0,58000,70000,-12000,-12000
063345,嘉晶統一9C購02  ,0,0,0,0,0,0,0,0,0,-12000,0,0,0,12000,24000,-12000,-12000
063280,燿華元大9B購05  ,0,0,0,0,0,0,0,0,0,-12000,0,0,0,0,12000,-12000,-12000
063315,京元電群益9B購03,0,0,0,0,0,0,0,0,0,-12000,0,0,0,0,12000,-12000,-12000
03432B,臺股指凱基98熊13,0,0,0,0,0,0,0,0,0,-12000,0,0,0,0,12000,-12000,-12000
055782,新日興凱基99購01,0,0,0,0,0,0,0,0,0,-12000,0,0,0,138000,150000,-12000,-12000
054626,建準凱基98購01  ,0,0,0,0,0,0,0,0,0,-12000,0,0,0,0,12000,-12000,-12000
053760,牧德國泰98購01  ,0,0,0,0,0,0,0,0,0,-12000,0,0,0,0,12000,-12000,-12000
056619,強茂永豐98購01  ,0,0,0,0,0,0,0,0,0,-12000,0,0,0,0,12000,-12000,-12000
056356,台積電元大99購01,0,0,0,0,0,0,0,0,0,-12000,0,0,0,0,12000,-12000,-12000
059954,華新科康和99購01,0,0,0,0,0,0,0,0,0,-12000,0,0,0,17000,29000,-12000,-12000
055096,緯穎群益97購01  ,0,0,0,0,0,0,0,0,0,-12000,0,0,0,0,12000,-12000,-12000
056264,聯發科統一98購02,0,0,0,0,0,0,0,0,0,-12000,0,0,0,0,12000,-12000,-12000
055482,聚陽元大97購02  ,0,0,0,0,0,0,0,0,0,-12000,0,0,0,0,12000,-12000,-12000
054846,瑞昱兆豐97購01  ,0,0,0,0,0,0,0,0,0,-12000,0,0,0,9000,21000,-12000,-12000
054751,GIS凱基98購01   ,0,0,0,0,0,0,0,0,0,-12000,0,0,0,8000,20000,-12000,-12000
060029,嘉晶永豐99購03  ,0,0,0,0,0,0,0,0,0,-12000,0,0,0,0,12000,-12000,-12000
059475,元石油群益99購02,0,0,0,0,0,0,0,0,0,-12000,0,0,0,0,12000,-12000,-12000
059708,立積凱基9A購02  ,0,0,0,0,0,0,0,0,0,-12000,0,0,0,0,12000,-12000,-12000
060164,合勤控永豐9A購01,0,0,0,0,0,0,0,0,0,-12000,0,0,0,22000,34000,-12000,-12000
057452,新日興元富98購01,0,0,0,0,0,0,0,0,0,-12000,0,0,0,10000,22000,-12000,-12000
060562,旺宏富邦9C購02  ,0,0,0,0,0,0,0,0,0,-12000,0,0,0,0,12000,-12000,-12000
060499,鴻海元大9A購11  ,0,0,0,0,0,0,0,0,0,-12000,0,0,0,0,12000,-12000,-12000
059302,大立光群益99購08,0,0,0,0,0,0,0,0,0,-12000,0,0,0,0,12000,-12000,-12000
058348,台表科群益99購01,0,0,0,0,0,0,0,0,0,-12000,0,0,0,4000,16000,-12000,-12000
058322,玉晶光永豐99購02,0,0,0,0,0,0,0,0,0,-12000,0,0,0,91000,103000,-12000,-12000
058765,緯穎群益99購03  ,0,0,0,0,0,0,0,0,0,-12000,0,0,0,0,12000,-12000,-12000
058969,亞德客永豐99購01,0,0,0,0,0,0,0,0,0,-12000,0,0,0,22000,34000,-12000,-12000
061364,國巨國票9A購09  ,0,0,0,0,0,0,0,0,0,-12000,0,0,0,1000,13000,-12000,-12000
08106P,聯發科統一9B售09,0,0,0,0,0,0,0,0,0,-12000,0,0,0,0,12000,-12000,-12000
08056P,華通群益9B售06  ,0,0,0,0,0,0,0,0,0,-12000,0,0,0,0,12000,-12000,-12000
1521,大億            ,0,12000,-12000,0,0,0,0,0,0,0,0,0,0,0,0,0,-12000
1459,聯發            ,1000,13000,-12000,0,0,0,0,0,0,0,0,0,0,0,0,0,-12000
2849,安泰銀          ,4000,16000,-12000,0,0,0,0,0,0,0,0,0,0,0,0,0,-12000
3607,谷崧            ,1000,13000,-12000,0,0,0,0,0,0,0,0,0,0,0,0,0,-12000
6115,鎰勝            ,0,12000,-12000,0,0,0,0,0,0,0,0,0,0,0,0,0,-12000
063296,可成麥證9B購01  ,0,0,0,0,13000,-13000,0,0,0,-13000,0,0,0,0,13000,-13000,-13000
063368,遠東新永豐9B購01,0,0,0,0,0,0,0,0,0,-13000,0,0,0,0,13000,-13000,-13000
062926,嘉澤國票9B購01  ,0,0,0,0,0,0,0,0,0,-13000,0,0,0,0,13000,-13000,-13000
062814,台光電兆豐9B購01,0,0,0,0,0,0,0,0,0,-13000,0,0,0,10000,23000,-13000,-13000
06825P,臺股指國票98售01,0,0,0,0,0,0,0,0,0,-13000,0,0,0,22000,35000,-13000,-13000
06517P,國巨凱基98售09  ,0,0,0,0,0,0,0,0,0,-13000,0,0,0,17000,30000,-13000,-13000
063553,同欣電國票9B購03,0,0,0,0,0,0,0,0,0,-13000,0,0,0,0,13000,-13000,-13000
062389,台表科國泰01購01,0,0,0,0,0,0,0,0,0,-13000,0,0,0,7000,20000,-13000,-13000
062267,滬深2X群益01購05,0,0,0,0,0,0,0,0,0,-13000,0,0,0,0,13000,-13000,-13000
061503,臻鼎國票9B購01  ,0,0,0,0,0,0,0,0,0,-13000,0,0,0,18000,31000,-13000,-13000
061933,光寶科國票9B購01,0,0,0,0,0,0,0,0,0,-13000,0,0,0,33000,46000,-13000,-13000
061832,聯發科凱基9B購06,0,0,0,0,0,0,0,0,0,-13000,0,0,0,3000,16000,-13000,-13000
056200,大毅永豐98購01  ,0,0,0,0,0,0,0,0,0,-13000,0,0,0,5000,18000,-13000,-13000
056548,瀚宇博凱基98購02,0,0,0,0,0,0,0,0,0,-13000,0,0,0,101000,114000,-13000,-13000
054582,致新元大97購01  ,0,0,0,0,0,0,0,0,0,-13000,0,0,0,2000,15000,-13000,-13000
056895,技嘉元大98購01  ,0,0,0,0,0,0,0,0,0,-13000,0,0,0,22000,35000,-13000,-13000
061362,台塑國票9B購01  ,0,0,0,0,0,0,0,0,0,-13000,0,0,0,0,13000,-13000,-13000
058791,鴻海元大99購17  ,0,0,0,0,0,0,0,0,0,-13000,0,0,0,40000,53000,-13000,-13000
060529,聯發科中信9A購04,0,0,0,0,0,0,0,0,0,-13000,0,0,0,28000,41000,-13000,-13000
060578,臺股指中信9C購03,0,0,0,0,0,0,0,0,0,-13000,0,0,0,0,13000,-13000,-13000
060533,臺股指中信9B購05,0,0,0,0,0,0,0,0,0,-13000,0,0,0,20000,33000,-13000,-13000
057438,禾伸堂國票99購01,0,0,0,0,0,0,0,0,0,-13000,0,0,0,0,13000,-13000,-13000
057529,嘉晶元大99購02  ,0,0,0,0,0,0,0,0,0,-13000,0,0,0,35000,48000,-13000,-13000
057494,玉晶光元大99購09,0,0,0,0,0,0,0,0,0,-13000,0,0,0,3000,16000,-13000,-13000
06016P,京元電凱基96售03,0,0,0,0,0,0,0,0,0,-13000,0,0,0,43000,56000,-13000,-13000
058544,FBVIX富邦9B購01 ,0,0,0,0,0,0,0,0,0,-13000,0,0,0,46000,59000,-13000,-13000
3501,維熹            ,0,13000,-13000,0,0,0,0,0,0,0,0,0,0,0,0,0,-13000
5484,慧友            ,0,13000,-13000,0,0,0,0,0,0,0,0,0,0,0,0,0,-13000
060921,中橡永豐9A購02  ,0,0,0,0,0,0,0,0,0,-13000,0,0,0,133000,146000,-13000,-13000
2426,鼎元            ,26000,39000,-13000,0,0,0,0,0,0,0,0,0,0,0,0,0,-13000
061473,台積電元大9A購33,0,0,0,0,0,0,0,0,0,-14000,0,0,0,1000,15000,-14000,-14000
061455,京元電凱基9B購01,0,0,0,0,0,0,0,0,0,-14000,0,0,0,38000,52000,-14000,-14000
061599,元金反中信9C購01,0,0,0,0,0,0,0,0,0,-14000,0,0,0,0,14000,-14000,-14000
062745,聯詠永豐9B購01  ,0,0,0,0,0,0,0,0,0,-14000,0,0,0,18000,32000,-14000,-14000
062454,華通群益9C購03  ,0,0,0,0,0,0,0,0,0,-14000,0,0,0,0,14000,-14000,-14000
063466,美食元大9B購02  ,0,0,0,0,0,0,0,0,0,-14000,0,0,0,0,14000,-14000,-14000
06466P,台積電統一9B售01,0,0,0,0,0,0,0,0,0,-14000,0,0,0,16000,30000,-14000,-14000
063173,矽格中信9B購01  ,0,0,0,0,0,0,0,0,0,-14000,0,0,0,0,14000,-14000,-14000
056001,美食永豐97購01  ,0,0,0,0,0,0,0,0,0,-14000,0,0,0,72000,86000,-14000,-14000
056796,國巨麥證98購02  ,0,0,0,10000,24000,-14000,0,0,0,-14000,0,0,0,10000,24000,-14000,-14000
053400,緯穎中信9A購01  ,0,0,0,0,0,0,0,0,0,-14000,0,0,0,17000,31000,-14000,-14000
053741,漢唐國票97購03  ,0,0,0,0,0,0,0,0,0,-14000,0,0,0,0,14000,-14000,-14000
03445B,臺股指元大02熊01,0,0,0,0,0,0,0,0,0,-14000,0,0,0,28000,42000,-14000,-14000
052624,微星亞東97購01  ,0,0,0,0,0,0,0,0,0,-14000,0,0,0,6000,20000,-14000,-14000
054296,世芯元大97購01  ,0,0,0,0,0,0,0,0,0,-14000,0,0,0,0,14000,-14000,-14000
056585,台積電統一9A購01,0,0,0,0,0,0,0,0,0,-14000,0,0,0,0,14000,-14000,-14000
056126,台郡國票98購02  ,0,0,0,0,0,0,0,0,0,-14000,0,0,0,11000,25000,-14000,-14000
055287,日電貿元大97購01,0,0,0,0,0,0,0,0,0,-14000,0,0,0,0,14000,-14000,-14000
056241,緯創群益97購01  ,0,0,0,0,0,0,0,0,0,-14000,0,0,0,69000,83000,-14000,-14000
055665,亞德客群益97購01,0,0,0,0,0,0,0,0,0,-14000,0,0,0,19000,33000,-14000,-14000
059720,台積電元大99購43,0,0,0,0,0,0,0,0,0,-14000,0,0,0,16000,30000,-14000,-14000
057282,大立光元大99購06,0,0,0,0,0,0,0,0,0,-14000,0,0,0,0,14000,-14000,-14000
058507,美律元大9A購01  ,0,0,0,0,0,0,0,0,0,-14000,0,0,0,218000,232000,-14000,-14000
059196,聯發科永豐99購02,0,0,0,0,0,0,0,0,0,-14000,0,0,0,0,14000,-14000,-14000
058850,華新科群益99購03,0,0,0,0,0,0,0,0,0,-14000,0,0,0,11000,25000,-14000,-14000
061164,燿華兆豐9B購01  ,0,0,0,0,0,0,0,0,0,-14000,0,0,0,140000,154000,-14000,-14000
061136,可成統一9A購01  ,0,0,0,0,0,0,0,0,0,-14000,0,0,0,0,14000,-14000,-14000
061139,玉晶光統一9C購02,0,0,0,0,0,0,0,0,0,-14000,0,0,0,2000,16000,-14000,-14000
058982,台積電凱基99購08,0,0,0,0,0,0,0,0,0,-14000,0,0,0,1000,15000,-14000,-14000
061035,亞光永豐9A購01  ,0,0,0,0,0,0,0,0,0,-14000,0,0,0,0,14000,-14000,-14000
061038,TPK永豐9A購01   ,0,0,0,0,0,0,0,0,0,-14000,0,0,0,77000,91000,-14000,-14000
061028,聚陽永豐9A購01  ,0,0,0,0,0,0,0,0,0,-14000,0,0,0,28000,42000,-14000,-14000
057165,國巨元大99購05  ,0,0,0,0,0,0,0,0,0,-14000,0,0,0,0,14000,-14000,-14000
08028P,臺股指元大9B售30,0,0,0,0,0,0,0,0,0,-14000,0,0,0,6000,20000,-14000,-14000
08047P,臺股指國票9B售12,0,0,0,0,0,0,0,0,0,-14000,0,0,0,4000,18000,-14000,-14000
8131,福懋科          ,58000,73000,-15000,0,0,0,0,0,0,1000,0,0,0,2000,1000,1000,-14000
3380,明泰            ,359000,284000,75000,0,0,0,0,0,0,-89000,30000,100000,-70000,22000,41000,-19000,-14000
5706,鳳凰            ,19000,33000,-14000,0,0,0,0,0,0,0,0,0,0,0,0,0,-14000
06326P,鴻海中信01售01  ,0,0,0,0,0,0,0,0,0,-15000,0,0,0,0,15000,-15000,-15000
063010,國巨元大9C購02  ,0,0,0,0,0,0,0,0,0,-15000,0,0,0,0,15000,-15000,-15000
06539P,聯發科凱基98售12,0,0,0,0,0,0,0,0,0,-15000,0,0,0,0,15000,-15000,-15000
063489,新日興國泰01購01,0,0,0,0,0,0,0,0,0,-15000,0,0,0,40000,55000,-15000,-15000
063545,華通兆豐9B購03  ,0,0,0,0,0,0,0,0,0,-15000,0,0,0,0,15000,-15000,-15000
062500,國巨群益01購01  ,0,0,0,0,0,0,0,0,0,-15000,0,0,0,4000,19000,-15000,-15000
062226,臻鼎統一9B購01  ,0,0,0,0,0,0,0,0,0,-15000,0,0,0,0,15000,-15000,-15000
061526,宏達電凱基9A購04,0,0,0,0,0,0,0,0,0,-15000,0,0,0,31000,46000,-15000,-15000
061978,旺宏元大9C購01  ,0,0,0,0,0,0,0,0,0,-15000,0,0,0,7000,22000,-15000,-15000
055032,億光富邦99購01  ,0,0,0,0,0,0,0,0,0,-15000,0,0,0,0,15000,-15000,-15000
055594,華新科元大98購02,0,0,0,0,0,0,0,0,0,-15000,0,0,0,33000,48000,-15000,-15000
055065,神達永豐97購01  ,0,0,0,0,0,0,0,0,0,-15000,0,0,0,5000,20000,-15000,-15000
055399,超眾統一99購01  ,0,0,0,0,0,0,0,0,0,-15000,0,0,0,5000,20000,-15000,-15000
056556,南電凱基98購01  ,0,0,0,0,0,0,0,0,0,-15000,0,0,0,0,15000,-15000,-15000
056511,超眾永豐98購01  ,0,0,0,0,0,0,0,0,0,-15000,0,0,0,20000,35000,-15000,-15000
056300,聯發科元大97購23,0,0,0,0,0,0,0,0,0,-15000,0,0,0,27000,42000,-15000,-15000
056774,和鑫元大98購01  ,0,0,0,0,0,0,0,0,0,-15000,0,0,0,5000,20000,-15000,-15000
059947,貿聯永豐99購03  ,0,0,0,0,0,0,0,0,0,-15000,0,0,0,65000,80000,-15000,-15000
060098,華新科元大99購24,0,0,0,0,0,0,0,0,0,-15000,0,0,0,10000,25000,-15000,-15000
056396,祥碩永豐98購01  ,0,0,0,0,0,0,0,0,0,-15000,0,0,0,12000,27000,-15000,-15000
057665,技嘉元大99購01  ,0,0,0,0,0,0,0,0,0,-15000,0,0,0,54000,69000,-15000,-15000
052729,國巨國泰97購03  ,0,0,0,0,0,0,0,0,0,-15000,0,0,0,0,15000,-15000,-15000
00757,統一FANG+       ,0,0,0,0,0,0,0,0,0,-15000,0,0,0,200000,215000,-15000,-15000
052775,滬深2X國票99購02,0,0,0,0,0,0,0,0,0,-15000,0,0,0,16000,31000,-15000,-15000
053528,南電中信9A購01  ,0,0,0,0,0,0,0,0,0,-15000,0,0,0,5000,20000,-15000,-15000
055775,友達凱基9A購01  ,0,0,0,0,0,0,0,0,0,-15000,0,0,0,0,15000,-15000,-15000
055974,上銀統一97購05  ,0,0,0,0,0,0,0,0,0,-15000,0,0,0,35000,50000,-15000,-15000
056839,台光電元富98購02,0,0,0,0,0,0,0,0,0,-15000,0,0,0,0,15000,-15000,-15000
058940,聯發科中信9A購03,0,0,0,0,0,0,0,0,0,-15000,0,0,0,0,15000,-15000,-15000
061076,台達電兆豐9A購01,0,0,0,0,0,0,0,0,0,-15000,0,0,0,20000,35000,-15000,-15000
061216,世芯元大9A購06  ,0,0,0,0,0,0,0,0,0,-15000,0,0,0,50000,65000,-15000,-15000
058993,滬深反元大9C購01,0,0,0,0,0,0,0,0,0,-15000,0,0,0,0,15000,-15000,-15000
059253,康控凱基9B購02  ,0,0,0,0,0,0,0,0,0,-15000,0,0,0,20000,35000,-15000,-15000
059346,新日興凱基99購03,0,0,0,0,0,0,0,0,0,-15000,0,0,0,55000,70000,-15000,-15000
058333,鴻海元富99購04  ,0,0,0,0,0,0,0,0,0,-15000,0,0,0,7000,22000,-15000,-15000
058198,瑞昱亞東99購01  ,0,0,0,0,0,0,0,0,0,-15000,0,0,0,10000,25000,-15000,-15000
057385,光罩永豐99購01  ,0,0,0,0,0,0,0,0,0,-15000,0,0,0,45000,60000,-15000,-15000
060547,瑞昱凱基9A購01  ,0,0,0,0,0,0,0,0,0,-15000,0,0,0,91000,106000,-15000,-15000
060492,元黃金元富9A購01,0,0,0,0,0,0,0,0,0,-15000,0,0,0,0,15000,-15000,-15000
059707,健策凱基9A購03  ,0,0,0,0,0,0,0,0,0,-15000,0,0,0,5000,20000,-15000,-15000
059990,健策元大9A購01  ,0,0,0,0,0,0,0,0,0,-15000,0,0,0,6000,21000,-15000,-15000
057682,台積電日盛9A購03,0,0,0,0,0,0,0,0,0,-15000,0,0,0,346000,361000,-15000,-15000
058603,台積電元大99購12,0,0,0,0,0,0,0,0,0,-15000,0,0,0,0,15000,-15000,-15000
06041P,全新永豐96售03  ,0,0,0,0,0,0,0,0,0,-15000,0,0,0,0,15000,-15000,-15000
5546,永固-KY         ,0,15000,-15000,0,0,0,0,0,0,0,0,0,0,0,0,0,-15000
8222,寶一            ,8000,23000,-15000,0,0,0,0,0,0,0,0,0,0,0,0,0,-15000
8021,尖點            ,41000,56000,-15000,0,0,0,0,0,0,0,0,0,0,0,0,0,-15000
060714,晶技永豐9A購02  ,0,0,0,0,0,0,0,0,0,-15000,0,0,0,10000,25000,-15000,-15000
07560P,台積電國泰9B售01,0,0,0,0,0,0,0,0,0,-15000,0,0,0,118000,133000,-15000,-15000
2882A,國泰特          ,0,0,0,0,0,0,0,0,0,-15000,3000,18000,-15000,0,0,0,-15000
2731,雄獅            ,24000,39000,-15000,0,0,0,0,0,0,0,0,0,0,0,0,0,-15000
061726,台積電麥證9A購05,0,0,0,0,17000,-17000,0,0,0,-16000,0,0,0,1000,17000,-16000,-16000
062202,國巨國票9C購04  ,0,0,0,0,0,0,0,0,0,-16000,0,0,0,0,16000,-16000,-16000
062401,信邦永豐9B購01  ,0,0,0,0,0,0,0,0,0,-16000,0,0,0,82000,98000,-16000,-16000
06377P,華通統一97售04  ,0,0,0,0,0,0,0,0,0,-16000,0,0,0,0,16000,-16000,-16000
06827P,臺股指國票98售03,0,0,0,0,0,0,0,0,0,-16000,0,0,0,21000,37000,-16000,-16000
06699P,台積電統一98售11,0,0,0,0,0,0,0,0,0,-16000,0,0,0,0,16000,-16000,-16000
06689P,鴻海中信9C售02  ,0,0,0,0,0,0,0,0,0,-16000,0,0,0,0,16000,-16000,-16000
06720P,智邦亞東99售01  ,0,0,0,0,0,0,0,0,0,-16000,0,0,0,0,16000,-16000,-16000
055934,景碩群益98購03  ,0,0,0,0,0,0,0,0,0,-16000,0,0,0,241000,257000,-16000,-16000
053500,新日興兆豐97購01,0,0,0,0,0,0,0,0,0,-16000,0,0,0,0,16000,-16000,-16000
052984,漢唐元大96購01  ,0,0,0,0,0,0,0,0,0,-16000,0,0,0,4000,20000,-16000,-16000
035277,景碩台新97購01  ,0,0,0,0,0,0,0,0,0,-16000,0,0,0,0,16000,-16000,-16000
052468,超眾統一96購02  ,0,0,0,0,0,0,0,0,0,-16000,0,0,0,108000,124000,-16000,-16000
054406,旺宏國票98購01  ,0,0,0,0,0,0,0,0,0,-16000,0,0,0,0,16000,-16000,-16000
056366,玉晶光元大99購04,0,0,0,0,0,0,0,0,0,-16000,0,0,0,31000,47000,-16000,-16000
055690,矽力凱基97購02  ,0,0,0,0,0,0,0,0,0,-16000,0,0,0,10000,26000,-16000,-16000
057791,可成統一99購01  ,0,0,0,0,0,0,0,0,0,-16000,0,0,0,5000,21000,-16000,-16000
057483,微星元大98購04  ,0,0,0,0,0,0,0,0,0,-16000,0,0,0,0,16000,-16000,-16000
057547,技嘉凱基99購01  ,0,0,0,0,0,0,0,0,0,-16000,0,0,0,0,16000,-16000,-16000
058353,國巨凱基99購09  ,0,0,0,0,0,0,0,0,0,-16000,0,0,0,0,16000,-16000,-16000
1503,士電            ,10000,26000,-16000,0,0,0,0,0,0,0,0,0,0,0,0,0,-16000
07655P,台灣50凱基01售09,0,0,0,0,0,0,0,0,0,-16000,0,0,0,2000,18000,-16000,-16000
08045P,健策國票9B售01  ,0,0,0,0,0,0,0,0,0,-16000,0,0,0,46000,62000,-16000,-16000
08085P,華通凱基9B售04  ,0,0,0,0,0,0,0,0,0,-16000,0,0,0,0,16000,-16000,-16000
060770,宏達電麥證9A購01,0,0,0,0,16000,-16000,0,0,0,-16000,0,0,0,0,16000,-16000,-16000
060843,大立光國票9A購06,0,0,0,0,0,0,0,0,0,-16000,0,0,0,0,16000,-16000,-16000
6108,競國            ,41000,57000,-16000,0,0,0,0,0,0,0,0,0,0,0,0,0,-16000
3543,州巧            ,0,16000,-16000,0,0,0,0,0,0,0,0,0,0,0,0,0,-16000
5285,界霖            ,2000,21000,-19000,0,0,0,0,0,0,3000,3000,0,3000,0,0,0,-16000
06698P,玉晶光國票99售05,0,0,0,0,0,0,0,0,0,-17000,0,0,0,5000,22000,-17000,-17000
063550,可成國票9C購01  ,0,0,0,0,0,0,0,0,0,-17000,0,0,0,4000,21000,-17000,-17000
063450,華新科統一02購01,0,0,0,0,0,0,0,0,0,-17000,0,0,0,0,17000,-17000,-17000
062392,國巨富邦02購01  ,0,0,0,0,0,0,0,0,0,-17000,0,0,0,60000,77000,-17000,-17000
062690,華擎統一9B購01  ,0,0,0,0,0,0,0,0,0,-17000,0,0,0,3000,20000,-17000,-17000
061593,智原永豐9A購01  ,0,0,0,0,0,0,0,0,0,-17000,0,0,0,0,17000,-17000,-17000
061408,華新科國票9A購06,0,0,0,0,0,0,0,0,0,-17000,0,0,0,0,17000,-17000,-17000
061402,矽創兆豐9B購01  ,0,0,0,0,0,0,0,0,0,-17000,0,0,0,33000,50000,-17000,-17000
061875,華新科元大9B購03,0,0,0,0,0,0,0,0,0,-17000,0,0,0,0,17000,-17000,-17000
061774,T50反1國票9B購06,0,0,0,0,0,0,0,0,0,-17000,0,0,0,43000,60000,-17000,-17000
055687,瀚宇博凱基97購01,0,0,0,0,0,0,0,0,0,-17000,0,0,0,60000,77000,-17000,-17000
055276,台積電元大97購20,0,0,0,0,0,0,0,0,0,-17000,0,0,0,0,17000,-17000,-17000
056144,GIS元大98購01   ,0,0,0,0,0,0,0,0,0,-17000,0,0,0,347000,364000,-17000,-17000
054817,聯發科元大97購13,0,0,0,0,0,0,0,0,0,-17000,0,0,0,0,17000,-17000,-17000
057000,亞德客國票99購01,0,0,0,0,0,0,0,0,0,-17000,0,0,0,26000,43000,-17000,-17000
056696,茂林群益98購02  ,0,0,0,0,0,0,0,0,0,-17000,0,0,0,0,17000,-17000,-17000
056716,康舒永豐98購01  ,0,0,0,0,0,0,0,0,0,-17000,0,0,0,37000,54000,-17000,-17000
05627P,致伸國票97售01  ,0,0,0,0,0,0,0,0,0,-17000,0,0,0,0,17000,-17000,-17000
056519,創意國票99購01  ,0,0,0,0,0,0,0,0,0,-17000,0,0,0,10000,27000,-17000,-17000
060090,台積電元大99購55,0,0,0,0,0,0,0,0,0,-17000,0,0,0,0,17000,-17000,-17000
060065,大立光兆豐9B購01,0,0,0,0,0,0,0,0,0,-17000,0,0,0,9000,26000,-17000,-17000
059945,嘉澤永豐99購03  ,0,0,0,0,0,0,0,0,0,-17000,0,0,0,0,17000,-17000,-17000
059850,日電貿永豐99購01,0,0,0,0,0,0,0,0,0,-17000,0,0,0,0,17000,-17000,-17000
054346,世芯國票97購01  ,0,0,0,0,0,0,0,0,0,-17000,0,0,0,15000,32000,-17000,-17000
051911,大立光元大98購02,0,0,0,0,0,0,0,0,0,-17000,0,0,0,0,17000,-17000,-17000
056897,南亞科元大98購02,0,0,0,0,0,0,0,0,0,-17000,0,0,0,51000,68000,-17000,-17000
055741,健策元富97購01  ,0,0,0,0,0,0,0,0,0,-17000,0,0,0,157000,174000,-17000,-17000
058800,健策元大99購03  ,0,0,0,0,0,0,0,0,0,-17000,0,0,0,5000,22000,-17000,-17000
059240,台積電凱基9A購09,0,0,0,0,0,0,0,0,0,-17000,0,0,0,13000,30000,-17000,-17000
059213,國巨元大99購19  ,0,0,0,0,0,0,0,0,0,-17000,0,0,0,43000,60000,-17000,-17000
061082,台光電兆豐9A購01,0,0,0,0,0,0,0,0,0,-17000,0,0,0,0,17000,-17000,-17000
057233,聯發科凱基98購14,0,0,0,0,0,0,0,0,0,-17000,0,0,0,0,17000,-17000,-17000
061037,嘉澤永豐9A購01  ,0,0,0,0,0,0,0,0,0,-17000,0,0,0,15000,32000,-17000,-17000
05869P,旺宏凱基96售05  ,0,0,0,0,0,0,0,0,0,-17000,0,0,0,3000,20000,-17000,-17000
057856,聯鈞國票99購03  ,0,0,0,0,0,0,0,0,0,-17000,0,0,0,0,17000,-17000,-17000
060166,佐登永豐9A購01  ,0,0,0,0,0,0,0,0,0,-17000,0,0,0,0,17000,-17000,-17000
058537,彩晶統一9B購01  ,0,0,0,0,0,0,0,0,0,-17000,0,0,0,133000,150000,-17000,-17000
059509,奇力新永豐99購02,0,0,0,0,0,0,0,0,0,-17000,0,0,0,10000,27000,-17000,-17000
060844,大立光國票9A購07,0,0,0,0,0,0,0,0,0,-17000,0,0,0,0,17000,-17000,-17000
060695,同欣電麥證9A購01,0,0,0,7000,24000,-17000,0,0,0,-17000,0,0,0,7000,24000,-17000,-17000
060995,泰鼎元大9A購03  ,0,0,0,0,0,0,0,0,0,-17000,0,0,0,13000,30000,-17000,-17000
060943,宏達電國票9B購02,0,0,0,0,0,0,0,0,0,-17000,0,0,0,11000,28000,-17000,-17000
08120P,南亞科國票9C售01,0,0,0,0,0,0,0,0,0,-17000,0,0,0,1000,18000,-17000,-17000
08026P,臺股指凱基9B售12,0,0,0,0,0,0,0,0,0,-17000,0,0,0,193000,210000,-17000,-17000
07546P,玉晶光凱基9A售09,0,0,0,0,0,0,0,0,0,-17000,0,0,0,899000,916000,-17000,-17000
07422P,大立光元大99售32,0,0,0,0,0,0,0,0,0,-17000,0,0,0,8000,25000,-17000,-17000
2850,新產            ,33000,61000,-28000,0,0,0,0,0,0,11000,11000,0,11000,0,0,0,-17000
061961,台積電統一01購02,0,0,0,0,0,0,0,0,0,-18000,0,0,0,2000,20000,-18000,-18000
061501,嘉澤國票9A購01  ,0,0,0,0,0,0,0,0,0,-18000,0,0,0,22000,40000,-18000,-18000
061494,聯發科國票9A購04,0,0,0,0,0,0,0,0,0,-18000,0,0,0,3000,21000,-18000,-18000
061668,信邦中信9B購01  ,0,0,0,0,0,0,0,0,0,-18000,0,0,0,283000,301000,-18000,-18000
062420,台積電統一9C購08,0,0,0,0,0,0,0,0,0,-18000,0,0,0,14000,32000,-18000,-18000
063509,超眾群益9B購03  ,0,0,0,0,0,0,0,0,0,-18000,0,0,0,7000,25000,-18000,-18000
06461P,玉晶光國泰9A售01,0,0,0,0,0,0,0,0,0,-18000,0,0,0,9000,27000,-18000,-18000
053871,臻鼎元大96購03  ,0,0,0,0,0,0,0,0,0,-18000,0,0,0,99000,117000,-18000,-18000
059730,晶相光元大9C購02,0,0,0,0,0,0,0,0,0,-18000,0,0,0,73000,91000,-18000,-18000
058273,同欣電永豐99購01,0,0,0,0,0,0,0,0,0,-18000,0,0,0,0,18000,-18000,-18000
060459,鴻海元大9A購07  ,0,0,0,0,0,0,0,0,0,-18000,0,0,0,0,18000,-18000,-18000
061074,儒鴻兆豐9B購01  ,0,0,0,0,0,0,0,0,0,-18000,0,0,0,75000,93000,-18000,-18000
058961,台灣50兆豐9C購01,0,0,0,0,0,0,0,0,0,-18000,0,0,0,12000,30000,-18000,-18000
057172,南亞科元大98購03,0,0,0,0,0,0,0,0,0,-18000,0,0,0,50000,68000,-18000,-18000
057176,全新元大99購02  ,0,0,0,0,0,0,0,0,0,-18000,0,0,0,0,18000,-18000,-18000
058035,旭富永豐98購02  ,0,0,0,0,0,0,0,0,0,-18000,0,0,0,5000,23000,-18000,-18000
059283,康友永豐99購02  ,0,0,0,0,0,0,0,0,0,-18000,0,0,0,0,18000,-18000,-18000
2612,中航            ,7000,25000,-18000,0,0,0,0,0,0,0,0,0,0,0,0,0,-18000
2514,龍邦            ,27000,45000,-18000,0,0,0,0,0,0,0,0,0,0,0,0,0,-18000
1533,車王電          ,1000,19000,-18000,0,0,0,0,0,0,0,0,0,0,0,0,0,-18000
2022,聚亨            ,2000,13000,-11000,0,0,0,0,0,0,-7000,0,7000,-7000,0,0,0,-18000
07902P,玉晶光國票01售01,0,0,0,0,0,0,0,0,0,-18000,0,0,0,0,18000,-18000,-18000
3535,晶彩科          ,52000,70000,-18000,0,0,0,0,0,0,0,0,0,0,0,0,0,-18000
3712,永崴投控        ,3000,21000,-18000,0,0,0,0,0,0,0,0,0,0,0,0,0,-18000
6165,捷泰            ,58000,76000,-18000,0,0,0,0,0,0,0,0,0,0,0,0,0,-18000
6235,華孚            ,62000,71000,-9000,0,0,0,0,0,0,-9000,0,9000,-9000,0,0,0,-18000
060642,華擎永豐9A購02  ,0,0,0,0,0,0,0,0,0,-18000,0,0,0,2000,20000,-18000,-18000
07035P,大立光元富99售04,0,0,0,0,0,0,0,0,0,-19000,0,0,0,97000,116000,-19000,-19000
062904,台光電元大9B購06,0,0,0,0,0,0,0,0,0,-19000,0,0,0,147000,166000,-19000,-19000
063256,鴻海國泰01購02  ,0,0,0,0,0,0,0,0,0,-19000,0,0,0,34000,53000,-19000,-19000
063215,台表科國票9C購02,0,0,0,0,0,0,0,0,0,-19000,0,0,0,7000,26000,-19000,-19000
063115,台積電麥證9B購02,0,0,0,0,19000,-19000,0,0,0,-19000,0,0,0,0,19000,-19000,-19000
062638,茂林國票9C購01  ,0,0,0,0,0,0,0,0,0,-19000,0,0,0,0,19000,-19000,-19000
061682,南電元大9B購01  ,0,0,0,0,0,0,0,0,0,-19000,0,0,0,0,19000,-19000,-19000
061635,台積電元大9A購34,0,0,0,0,0,0,0,0,0,-19000,0,0,0,69000,88000,-19000,-19000
061404,臺指反國票04購01,0,0,0,0,0,0,0,0,0,-19000,0,0,0,0,19000,-19000,-19000
061423,廣達元大9A購01  ,0,0,0,0,0,0,0,0,0,-19000,0,0,0,182000,201000,-19000,-19000
062006,瑞昱國泰9C購01  ,0,0,0,0,0,0,0,0,0,-19000,0,0,0,36000,55000,-19000,-19000
054634,FB上証中信99購01,0,0,0,0,0,0,0,0,0,-19000,0,0,0,0,19000,-19000,-19000
050014,國巨富邦98購01  ,0,0,0,0,0,0,0,0,0,-19000,0,0,0,13000,32000,-19000,-19000
059785,美律元大9A購03  ,0,0,0,0,0,0,0,0,0,-19000,0,0,0,31000,50000,-19000,-19000
060238,強茂元大9C購01  ,0,0,0,0,0,0,0,0,0,-19000,0,0,0,0,19000,-19000,-19000
056746,超眾凱基99購01  ,0,0,0,0,0,0,0,0,0,-19000,0,0,0,131000,150000,-19000,-19000
054799,超眾群益98購01  ,0,0,0,0,0,0,0,0,0,-19000,0,0,0,79000,98000,-19000,-19000
054925,神達凱基97購01  ,0,0,0,0,0,0,0,0,0,-19000,0,0,0,69000,88000,-19000,-19000
058488,華擎國票9A購01  ,0,0,0,0,0,0,0,0,0,-19000,0,0,0,500000,519000,-19000,-19000
061350,牧德元大9B購03  ,0,0,0,0,0,0,0,0,0,-19000,0,0,0,4000,23000,-19000,-19000
057492,大立光元大98購18,0,0,0,0,0,0,0,0,0,-19000,0,0,0,0,19000,-19000,-19000
057436,義隆國票99購02  ,0,0,0,0,0,0,0,0,0,-19000,0,0,0,9000,28000,-19000,-19000
057872,旺宏元大99購06  ,0,0,0,0,0,0,0,0,0,-19000,0,0,0,0,19000,-19000,-19000
057266,TPK兆豐98購02   ,0,0,0,0,0,0,0,0,0,-19000,0,0,0,136000,155000,-19000,-19000
058550,南亞科永豐99購01,0,0,0,0,0,0,0,0,0,-19000,0,0,0,25000,44000,-19000,-19000
059994,國巨元富99購01  ,0,0,0,0,0,0,0,0,0,-19000,0,0,0,9000,28000,-19000,-19000
5234,達興材料        ,22000,24000,-2000,0,0,0,0,20000,-20000,3000,3000,0,3000,0,0,0,-19000
060835,亞德客國票9A購01,0,0,0,0,0,0,0,0,0,-19000,0,0,0,6000,25000,-19000,-19000
910861,神州-DR         ,0,19000,-19000,0,0,0,0,0,0,0,0,0,0,0,0,0,-19000
07758P,台積電國票9A售06,0,0,0,0,0,0,0,0,0,-19000,0,0,0,0,19000,-19000,-19000
07685P,玉晶光凱基9B售03,0,0,0,0,0,0,0,0,0,-19000,0,0,0,20000,39000,-19000,-19000
1708,東鹼            ,27000,46000,-19000,0,0,0,0,0,0,0,0,0,0,0,0,0,-19000
1201,味全            ,76000,85000,-9000,0,0,0,0,0,0,-10000,0,0,0,0,10000,-10000,-19000
062047,緯穎凱基9B購01  ,0,0,0,0,0,0,0,0,0,-20000,0,0,0,16000,36000,-20000,-20000
061949,大立光群益9B購03,0,0,0,0,0,0,0,0,0,-20000,0,0,0,49000,69000,-20000,-20000
061935,台積電國票9B購07,0,0,0,0,0,0,0,0,0,-20000,0,0,0,0,20000,-20000,-20000
061910,台積電中信05購03,0,0,0,0,0,0,0,0,0,-20000,0,0,0,3000,23000,-20000,-20000
061750,台達電台新9B購01,0,0,0,0,0,0,0,0,0,-20000,0,0,0,0,20000,-20000,-20000
061734,全新中信9B購02  ,0,0,0,0,0,0,0,0,0,-20000,0,0,0,0,20000,-20000,-20000
061877,貿聯元大9B購01  ,0,0,0,0,0,0,0,0,0,-20000,0,0,0,101000,121000,-20000,-20000
061397,上銀台新9A購01  ,0,0,0,0,0,0,0,0,0,-20000,0,0,0,0,20000,-20000,-20000
06153P,健策元大97售04  ,0,0,0,0,0,0,0,0,0,-20000,0,0,0,3000,23000,-20000,-20000
061614,亞德客群益9A購01,0,0,0,0,0,0,0,0,0,-20000,0,0,0,0,20000,-20000,-20000
061712,旺宏凱基9A購08  ,0,0,0,0,0,0,0,0,0,-20000,0,0,0,0,20000,-20000,-20000
062619,台表科元大9B購03,0,0,0,0,0,0,0,0,0,-20000,0,0,0,51000,71000,-20000,-20000
062381,上銀國泰9C購01  ,0,0,0,0,0,0,0,0,0,-20000,0,0,0,0,20000,-20000,-20000
062316,康控凱基9B購03  ,0,0,0,0,0,0,0,0,0,-20000,0,0,0,6000,26000,-20000,-20000
062159,聯詠凱基9B購01  ,0,0,0,0,0,0,0,0,0,-20000,0,0,0,0,20000,-20000,-20000
063383,億豐永豐9B購02  ,0,0,0,0,0,0,0,0,0,-20000,0,0,0,0,20000,-20000,-20000
063342,台光電統一9B購02,0,0,0,0,0,0,0,0,0,-20000,0,0,0,20000,40000,-20000,-20000
062931,上証2X凱基01購01,0,0,0,0,0,0,0,0,0,-20000,0,0,0,0,20000,-20000,-20000
063038,富邦金凱基9B購02,0,0,0,0,0,0,0,0,0,-20000,0,0,0,0,20000,-20000,-20000
07030P,鈺齊群益99售01  ,0,0,0,0,0,0,0,0,0,-20000,0,0,0,3000,23000,-20000,-20000
06961P,台積電凱基99售05,0,0,0,0,0,0,0,0,0,-20000,0,0,0,10000,30000,-20000,-20000
07079P,台積電群益99售06,0,0,0,0,0,0,0,0,0,-20000,0,0,0,0,20000,-20000,-20000
06481P,台積電凱基98售12,0,0,0,0,0,0,0,0,0,-20000,0,0,0,0,20000,-20000,-20000
06502P,A50中信98售01   ,0,0,0,0,0,0,0,0,0,-20000,0,0,0,0,20000,-20000,-20000
06375P,矽力元大97售06  ,0,0,0,0,0,0,0,0,0,-20000,0,0,0,0,20000,-20000,-20000
06455P,上銀統一99售03  ,0,0,0,0,0,0,0,0,0,-20000,0,0,0,0,20000,-20000,-20000
063495,台光電富邦9C購01,0,0,0,0,0,0,0,0,0,-20000,0,0,0,0,20000,-20000,-20000
054929,群電凱基97購01  ,0,0,0,0,0,0,0,0,0,-20000,0,0,0,36000,56000,-20000,-20000
056113,新日興兆豐98購01,0,0,0,0,0,0,0,0,0,-20000,0,0,0,0,20000,-20000,-20000
056128,和大中信99購01  ,0,0,0,0,0,0,0,0,0,-20000,0,0,0,0,20000,-20000,-20000
057078,國巨統一9A購02  ,0,0,0,0,0,0,0,0,0,-20000,0,0,0,10000,30000,-20000,-20000
057081,大立光統一98購07,0,0,0,0,0,0,0,0,0,-20000,0,0,0,0,20000,-20000,-20000
057066,緯穎富邦99購01  ,0,0,0,0,0,0,0,0,0,-20000,0,0,0,0,20000,-20000,-20000
057097,致新元富98購01  ,0,0,0,0,0,0,0,0,0,-20000,0,0,0,0,20000,-20000,-20000
054763,宏達電國票99購01,0,0,0,0,0,0,0,0,0,-20000,0,0,0,0,20000,-20000,-20000
054749,聯茂凱基98購01  ,0,0,0,0,0,0,0,0,0,-20000,0,0,0,0,20000,-20000,-20000
054750,聯茂凱基98購02  ,0,0,0,0,0,0,0,0,0,-20000,0,0,0,0,20000,-20000,-20000
054728,聯發科日盛97購01,0,0,0,0,0,0,0,0,0,-20000,0,0,0,0,20000,-20000,-20000
057046,奇力新元大99購03,0,0,0,0,0,0,0,0,0,-20000,0,0,0,0,20000,-20000,-20000
056049,奇力新國票98購01,0,0,0,0,0,0,0,0,0,-20000,0,0,0,0,20000,-20000,-20000
055402,正文元富97購02  ,0,0,0,0,0,0,0,0,0,-20000,0,0,0,50000,70000,-20000,-20000
055386,致新元大97購02  ,0,0,0,0,0,0,0,0,0,-20000,0,0,0,0,20000,-20000,-20000
055518,華新科中信99購01,0,0,0,0,0,0,0,0,0,-20000,0,0,0,0,20000,-20000,-20000
055519,茂林中信99購01  ,0,0,0,0,0,0,0,0,0,-20000,0,0,0,0,20000,-20000,-20000
055034,建準富邦99購01  ,0,0,0,0,0,0,0,0,0,-20000,0,0,0,10000,30000,-20000,-20000
055036,中工富邦9B購01  ,0,0,0,0,0,0,0,0,0,-20000,0,0,0,20000,40000,-20000,-20000
055080,正崴中信99購01  ,0,0,0,0,0,0,0,0,0,-20000,0,0,0,0,20000,-20000,-20000
055150,台積電元大98購04,0,0,0,0,0,0,0,0,0,-20000,0,0,0,0,20000,-20000,-20000
056219,T50反1日盛02購01,0,0,0,0,0,0,0,0,0,-20000,0,0,0,0,20000,-20000,-20000
056271,嘉澤統一97購01  ,0,0,0,0,0,0,0,0,0,-20000,0,0,0,5000,25000,-20000,-20000
056380,麗豐元富98購01  ,0,0,0,0,0,0,0,0,0,-20000,0,0,0,0,20000,-20000,-20000
056390,台積電富邦9B購01,0,0,0,0,0,0,0,0,0,-20000,0,0,0,0,20000,-20000,-20000
056592,台積電元富98購01,0,0,0,0,0,0,0,0,0,-20000,0,0,0,0,20000,-20000,-20000
056498,A50正2富邦9B購01,0,0,0,0,0,0,0,0,0,-20000,0,0,0,0,20000,-20000,-20000
056450,可成凱基98購05  ,0,0,0,0,0,0,0,0,0,-20000,0,0,0,0,20000,-20000,-20000
056416,華新科中信98購01,0,0,0,0,0,0,0,0,0,-20000,0,0,0,0,20000,-20000,-20000
059883,T50反1國票99購02,0,0,0,0,0,0,0,0,0,-20000,0,0,0,0,20000,-20000,-20000
050227,大立光中信96購01,0,0,0,0,0,0,0,0,0,-20000,0,0,0,0,20000,-20000,-20000
049007,玉晶光中信96購01,0,0,0,0,0,0,0,0,0,-20000,0,0,0,0,20000,-20000,-20000
054309,禾伸堂凱基98購01,0,0,0,0,0,0,0,0,0,-20000,0,0,0,0,20000,-20000,-20000
052112,滬深2X中信99購01,0,0,0,0,0,0,0,0,0,-20000,0,0,0,0,20000,-20000,-20000
051838,國巨國泰97購01  ,0,0,0,0,0,0,0,0,0,-20000,0,0,0,0,20000,-20000,-20000
051603,深中小群益99購03,0,0,0,0,0,0,0,0,0,-20000,0,0,0,0,20000,-20000,-20000
051510,新光金中信97購01,0,0,0,0,0,0,0,0,0,-20000,0,0,0,0,20000,-20000,-20000
051727,S&P反1國票97購01,0,0,0,0,0,0,0,0,0,-20000,0,0,0,15000,35000,-20000,-20000
054554,大立光凱基98購02,0,0,0,0,0,0,0,0,0,-20000,0,0,0,0,20000,-20000,-20000
053297,鎧勝中信98購01  ,0,0,0,0,0,0,0,0,0,-20000,0,0,0,110000,130000,-20000,-20000
054696,嘉聯益永豐97購01,0,0,0,0,0,0,0,0,0,-20000,0,0,0,0,20000,-20000,-20000
053609,華新中信9A購01  ,0,0,0,0,0,0,0,0,0,-20000,0,0,0,0,20000,-20000,-20000
053723,奇鋐凱基98購01  ,0,0,0,0,0,0,0,0,0,-20000,0,0,0,0,20000,-20000,-20000
053713,漢唐凱基96購04  ,0,0,0,0,0,0,0,0,0,-20000,0,0,0,0,20000,-20000,-20000
053930,S&P反1統一98購01,0,0,0,0,0,0,0,0,0,-20000,0,0,0,0,20000,-20000,-20000
053894,創意群益96購01  ,0,0,0,0,0,0,0,0,0,-20000,0,0,0,0,20000,-20000,-20000
052823,創意永豐96購02  ,0,0,0,0,0,0,0,0,0,-20000,0,0,0,0,20000,-20000,-20000
05579P,友達凱基98售03  ,0,0,0,0,0,0,0,0,0,-20000,0,0,0,37000,57000,-20000,-20000
053135,信邦國票96購01  ,0,0,0,0,0,0,0,0,0,-20000,0,0,0,0,20000,-20000,-20000
055845,大立光元大97購08,0,0,0,0,0,0,0,0,0,-20000,0,0,0,0,20000,-20000,-20000
055893,大立光統一97購07,0,0,0,0,0,0,0,0,0,-20000,0,0,0,0,20000,-20000,-20000
056012,勤誠中信99購01  ,0,0,0,0,0,0,0,0,0,-20000,0,0,0,30000,50000,-20000,-20000
058568,宏達電凱基9A購02,0,0,0,0,0,0,0,0,0,-20000,0,0,0,5000,25000,-20000,-20000
059528,華新科凱基99購06,0,0,0,0,0,0,0,0,0,-20000,0,0,0,0,20000,-20000,-20000
05856P,A50正2中信99售01,0,0,0,0,0,0,0,0,0,-20000,0,0,0,0,20000,-20000,-20000
060172,智原台新9A購01  ,0,0,0,0,0,0,0,0,0,-20000,0,0,0,34000,54000,-20000,-20000
058592,聯發科統一9C購01,0,0,0,0,0,0,0,0,0,-20000,0,0,0,0,20000,-20000,-20000
058622,國巨國票99購07  ,0,0,0,0,0,0,0,0,0,-20000,0,0,0,41000,61000,-20000,-20000
059573,健策凱基9A購02  ,0,0,0,0,0,0,0,0,0,-20000,0,0,0,10000,30000,-20000,-20000
060383,葡萄王凱基9A購01,0,0,0,0,0,0,0,0,0,-20000,0,0,0,0,20000,-20000,-20000
057261,瑞昱兆豐98購01  ,0,0,0,0,0,0,0,0,0,-20000,0,0,0,10000,30000,-20000,-20000
058264,瑞昱永豐99購01  ,0,0,0,0,0,0,0,0,0,-20000,0,0,0,10000,30000,-20000,-20000
057506,聯鈞國票99購02  ,0,0,0,0,0,0,0,0,0,-20000,0,0,0,0,20000,-20000,-20000
057501,超眾群益98購04  ,0,0,0,0,0,0,0,0,0,-20000,0,0,0,0,20000,-20000,-20000
06057P,大立光凱基98售01,0,0,0,0,0,0,0,0,0,-20000,0,0,0,14000,34000,-20000,-20000
061127,美食永豐9A購01  ,0,0,0,0,0,0,0,0,0,-20000,0,0,0,10000,30000,-20000,-20000
05721P,全新群益98售02  ,0,0,0,0,0,0,0,0,0,-20000,0,0,0,0,20000,-20000,-20000
058069,美律凱基99購05  ,0,0,0,0,0,0,0,0,0,-20000,0,0,0,0,20000,-20000,-20000
057179,可成元大98購04  ,0,0,0,0,0,0,0,0,0,-20000,0,0,0,80000,100000,-20000,-20000
058887,元石油元大9C購04,0,0,0,0,0,0,0,0,0,-20000,0,0,0,0,20000,-20000,-20000
05887P,友達元富99售03  ,0,0,0,0,0,0,0,0,0,-20000,0,0,0,6000,26000,-20000,-20000
061017,國泰金麥證9A購01,0,0,0,0,20000,-20000,0,0,0,-20000,0,0,0,0,20000,-20000,-20000
058473,上銀凱基9A購03  ,0,0,0,0,0,0,0,0,0,-20000,0,0,0,0,20000,-20000,-20000
058338,康友元富99購01  ,0,0,0,0,0,0,0,0,0,-20000,0,0,0,20000,40000,-20000,-20000
058398,中環元大99購02  ,0,0,0,0,0,0,0,0,0,-20000,0,0,0,0,20000,-20000,-20000
058137,玉晶光元大99購11,0,0,0,0,0,0,0,0,0,-20000,0,0,0,40000,60000,-20000,-20000
058825,同欣電富邦9A購01,0,0,0,0,0,0,0,0,0,-20000,0,0,0,0,20000,-20000,-20000
059093,旭富元大99購01  ,0,0,0,0,0,0,0,0,0,-20000,0,0,0,23000,43000,-20000,-20000
059260,國巨中信99購05  ,0,0,0,0,0,0,0,0,0,-20000,0,0,0,0,20000,-20000,-20000
059149,臺股指國票99購12,0,0,0,0,0,0,0,0,0,-20000,0,0,0,0,20000,-20000,-20000
057994,技嘉中信98購01  ,0,0,0,0,0,0,0,0,0,-20000,0,0,0,0,20000,-20000,-20000
057981,臻鼎永豐98購01  ,0,0,0,0,0,0,0,0,0,-20000,0,0,0,0,20000,-20000,-20000
1321,大洋            ,4000,24000,-20000,0,0,0,0,0,0,0,0,0,0,0,0,0,-20000
07686P,祥碩凱基9A售02  ,0,0,0,0,0,0,0,0,0,-20000,0,0,0,0,20000,-20000,-20000
07519P,臺股指元大9B售10,0,0,0,0,0,0,0,0,0,-20000,0,0,0,0,20000,-20000,-20000
07442P,華航康和9A售02  ,0,0,0,0,0,0,0,0,0,-20000,0,0,0,0,20000,-20000,-20000
07919P,創意永豐9B售01  ,0,0,0,0,0,0,0,0,0,-20000,0,0,0,0,20000,-20000,-20000
07953P,健策元大9B售07  ,0,0,0,0,0,0,0,0,0,-20000,0,0,0,10000,30000,-20000,-20000
08054P,臺股指國票9B售19,0,0,0,0,0,0,0,0,0,-20000,0,0,0,3000,23000,-20000,-20000
9911,櫻花            ,1000,21000,-20000,0,0,0,0,0,0,0,0,0,0,0,0,0,-20000
060947,台積電統一9C購03,0,0,0,0,0,0,0,0,0,-20000,0,0,0,3000,23000,-20000,-20000
060892,超眾統一9C購01  ,0,0,0,0,0,0,0,0,0,-20000,0,0,0,0,20000,-20000,-20000
4566,時碩工業        ,4000,24000,-20000,0,0,0,0,0,0,0,0,0,0,0,0,0,-20000
063635,漢唐元大9B購04  ,0,0,0,0,0,0,0,0,0,-21000,0,0,0,0,21000,-21000,-21000
06523P,台積電麥證98售02,0,0,0,0,21000,-21000,0,0,0,-21000,0,0,0,0,21000,-21000,-21000
06946P,T50正2元大9C售01,0,0,0,0,0,0,0,0,0,-21000,0,0,0,0,21000,-21000,-21000
063239,建準元大9B購01  ,0,0,0,0,0,0,0,0,0,-21000,0,0,0,281000,302000,-21000,-21000
063242,聯發科元大9B購19,0,0,0,0,0,0,0,0,0,-21000,0,0,0,0,21000,-21000,-21000
062141,遠東新國票9B購01,0,0,0,0,0,0,0,0,0,-21000,0,0,0,0,21000,-21000,-21000
062510,台積電國票01購01,0,0,0,0,0,0,0,0,0,-21000,0,0,0,22000,43000,-21000,-21000
061518,達方永豐9A購02  ,0,0,0,0,0,0,0,0,0,-21000,0,0,0,0,21000,-21000,-21000
061411,T50反1群益9A購05,0,0,0,0,0,0,0,0,0,-21000,0,0,0,103000,124000,-21000,-21000
055731,美律元富97購01  ,0,0,0,0,0,0,0,0,0,-21000,0,0,0,77000,98000,-21000,-21000
052045,瑞昱凱基96購01  ,0,0,0,0,0,0,0,0,0,-21000,0,0,0,10000,31000,-21000,-21000
051422,超眾國票96購01  ,0,0,0,0,0,0,0,0,0,-21000,0,0,0,26000,47000,-21000,-21000
054335,緯穎永豐96購02  ,0,0,0,0,0,0,0,0,0,-21000,0,0,0,20000,41000,-21000,-21000
050992,台積電元大97購01,0,0,0,0,0,0,0,0,0,-21000,0,0,0,0,21000,-21000,-21000
035276,南亞科台新97購01,0,0,0,0,0,0,0,0,0,-21000,0,0,0,0,21000,-21000,-21000
059917,華新科元大99購19,0,0,0,0,0,0,0,0,0,-21000,0,0,0,43000,64000,-21000,-21000
059946,健策永豐99購05  ,0,0,0,0,0,0,0,0,0,-21000,0,0,0,3000,24000,-21000,-21000
056337,聯發科凱基98購06,0,0,0,0,0,0,0,0,0,-21000,0,0,0,0,21000,-21000,-21000
056740,大立光凱基98購13,0,0,0,0,0,0,0,0,0,-21000,0,0,0,0,21000,-21000,-21000
056980,建準群益98購02  ,0,0,0,0,0,0,0,0,0,-21000,0,0,0,1000,22000,-21000,-21000
059107,南茂國泰9A購01  ,0,0,0,0,0,0,0,0,0,-21000,0,0,0,5000,26000,-21000,-21000
058042,鴻海元大98購12  ,0,0,0,0,0,0,0,0,0,-21000,0,0,0,1000,22000,-21000,-21000
058923,華新科元富99購06,0,0,0,0,0,0,0,0,0,-21000,0,0,0,7000,28000,-21000,-21000
061133,玉晶光第一9A購01,0,0,0,0,0,0,0,0,0,-21000,0,0,0,10000,31000,-21000,-21000
060022,勤誠康和99購01  ,0,0,0,0,0,0,0,0,0,-21000,0,0,0,13000,34000,-21000,-21000
3702A,大聯大甲特      ,0,0,0,0,0,0,0,0,0,-21000,0,21000,-21000,0,0,0,-21000
6552,易華電          ,51000,72000,-21000,0,0,0,0,0,0,0,3000,0,3000,0,3000,-3000,-21000
6525,捷敏-KY         ,2000,23000,-21000,0,0,0,0,0,0,0,0,0,0,0,0,0,-21000
6224,聚鼎            ,22000,43000,-21000,0,0,0,0,0,0,0,0,0,0,0,0,0,-21000
060768,鴻海麥證9A購02  ,0,0,0,0,22000,-22000,0,0,0,-21000,0,0,0,1000,22000,-21000,-21000
2476,鉅祥            ,1000,22000,-21000,0,0,0,0,0,0,0,0,0,0,0,0,0,-21000
061506,瑞祺國票9A購02  ,0,0,0,0,0,0,0,0,0,-22000,0,0,0,4000,26000,-22000,-22000
061559,南亞科國票9A購02,0,0,0,0,0,0,0,0,0,-22000,0,0,0,26000,48000,-22000,-22000
061973,上銀元大9B購01  ,0,0,0,0,0,0,0,0,0,-22000,0,0,0,0,22000,-22000,-22000
062629,聯發科國票9C購01,0,0,0,0,0,0,0,0,0,-22000,0,0,0,0,22000,-22000,-22000
062686,群創統一9C購03  ,0,0,0,0,0,0,0,0,0,-22000,0,0,0,124000,146000,-22000,-22000
062705,美食元大9B購01  ,0,0,0,0,0,0,0,0,0,-22000,0,0,0,37000,59000,-22000,-22000
063187,全新凱基9B購02  ,0,0,0,0,0,0,0,0,0,-22000,0,0,0,0,22000,-22000,-22000
063412,寶成國票9C購01  ,0,0,0,0,0,0,0,0,0,-22000,0,0,0,9000,31000,-22000,-22000
063407,泰鼎國票9C購01  ,0,0,0,0,0,0,0,0,0,-22000,0,0,0,0,22000,-22000,-22000
062823,台表科兆豐9B購01,0,0,0,0,0,0,0,0,0,-22000,0,0,0,81000,103000,-22000,-22000
06668P,祥碩凱基98售02  ,0,0,0,0,0,0,0,0,0,-22000,0,0,0,103000,125000,-22000,-22000
06459P,亞德客元富98售01,0,0,0,0,0,0,0,0,0,-22000,0,0,0,0,22000,-22000,-22000
063664,漢唐統一9C購01  ,0,0,0,0,0,0,0,0,0,-22000,0,0,0,0,22000,-22000,-22000
063590,華擎永豐9B購01  ,0,0,0,0,0,0,0,0,0,-22000,0,0,0,0,22000,-22000,-22000
056085,聯發科統一97購01,0,0,0,0,0,0,0,0,0,-22000,0,0,0,6000,28000,-22000,-22000
055381,茂林元大97購02  ,0,0,0,0,0,0,0,0,0,-22000,0,0,0,0,22000,-22000,-22000
056681,鴻海統一98購09  ,0,0,0,0,0,0,0,0,0,-22000,0,0,0,9000,31000,-22000,-22000
059767,矽力永豐99購01  ,0,0,0,0,0,0,0,0,0,-22000,0,0,0,2000,24000,-22000,-22000
060072,國巨元富99購04  ,0,0,0,0,0,0,0,0,0,-22000,0,0,0,0,22000,-22000,-22000
054152,漢唐國泰98購02  ,0,0,0,0,0,0,0,0,0,-22000,0,0,0,7000,29000,-22000,-22000
054318,台虹凱基98購01  ,0,0,0,0,0,0,0,0,0,-22000,0,0,0,240000,262000,-22000,-22000
00766L,台新MSCI中國正2 ,0,0,0,0,0,0,0,0,0,-22000,0,0,0,222000,244000,-22000,-22000
00711B,FH彭博新興債    ,85000,0,85000,0,0,0,0,0,0,-107000,0,0,0,105000,212000,-107000,-22000
057772,台積電群益99購01,0,0,0,0,0,0,0,0,0,-22000,0,0,0,2000,24000,-22000,-22000
057605,旺宏統一99購03  ,0,0,0,0,0,0,0,0,0,-22000,0,0,0,0,22000,-22000,-22000
061092,可成統一9C購02  ,0,0,0,0,0,0,0,0,0,-22000,0,0,0,22000,44000,-22000,-22000
057161,亞德客元大98購02,0,0,0,0,0,0,0,0,0,-22000,0,0,0,89000,111000,-22000,-22000
057225,華新凱基98購01  ,0,0,0,0,0,0,0,0,0,-22000,0,0,0,3000,25000,-22000,-22000
058837,SGBR2X中信9C購01,0,0,0,0,0,0,0,0,0,-22000,0,0,0,0,22000,-22000,-22000
059320,華新科元大99購15,0,0,0,0,0,0,0,0,0,-22000,0,0,0,20000,42000,-22000,-22000
2459,敦吉            ,0,22000,-22000,0,0,0,0,0,0,0,0,0,0,0,0,0,-22000
1337,再生-KY         ,19000,41000,-22000,0,0,0,0,0,0,0,0,0,0,0,0,0,-22000
060798,旭富永豐9A購01  ,0,0,0,0,0,0,0,0,0,-22000,0,0,0,4000,26000,-22000,-22000
9927,泰銘            ,0,22000,-22000,0,0,0,0,0,0,0,0,0,0,0,0,0,-22000
063561,上銀元大9B購08  ,0,0,0,0,0,0,0,0,0,-23000,0,0,0,10000,33000,-23000,-23000
063593,GIS永豐9B購01   ,0,0,0,0,0,0,0,0,0,-23000,0,0,0,0,23000,-23000,-23000
063498,金像電永豐9B購02,0,0,0,0,0,0,0,0,0,-23000,0,0,0,0,23000,-23000,-23000
063468,聯詠元大9B購04  ,0,0,0,0,0,0,0,0,0,-23000,0,0,0,30000,53000,-23000,-23000
063682,達新永豐9B購01  ,0,0,0,0,0,0,0,0,0,-23000,0,0,0,0,23000,-23000,-23000
063191,台表科凱基9B購03,0,0,0,0,0,0,0,0,0,-23000,0,0,0,0,23000,-23000,-23000
062268,力山群益9B購01  ,0,0,0,0,0,0,0,0,0,-23000,0,0,0,42000,65000,-23000,-23000
052907,嘉澤國票97購01  ,0,0,0,0,0,0,0,0,0,-23000,0,0,0,0,23000,-23000,-23000
060060,台積電兆豐99購05,0,0,0,0,0,0,0,0,0,-23000,0,0,0,25000,48000,-23000,-23000
056621,宏達電永豐98購01,0,0,0,0,0,0,0,0,0,-23000,0,0,0,0,23000,-23000,-23000
056354,國巨元大98購10  ,0,0,0,0,0,0,0,0,0,-23000,0,0,0,11000,34000,-23000,-23000
059281,創意永豐99購02  ,0,0,0,0,0,0,0,0,0,-23000,0,0,0,83000,106000,-23000,-23000
058773,和碩兆豐99購01  ,0,0,0,0,0,0,0,0,0,-23000,0,0,0,36000,59000,-23000,-23000
061353,康控元大9A購01  ,0,0,0,0,0,0,0,0,0,-23000,0,0,0,11000,34000,-23000,-23000
057390,台表科永豐98購01,0,0,0,0,0,0,0,0,0,-23000,0,0,0,10000,33000,-23000,-23000
060334,群光康和9A購01  ,0,0,0,0,0,0,0,0,0,-23000,0,0,0,7000,30000,-23000,-23000
057758,鴻海凱基99購03  ,0,0,0,0,0,0,0,0,0,-23000,0,0,0,9000,32000,-23000,-23000
059694,創意永豐99購03  ,0,0,0,0,0,0,0,0,0,-23000,0,0,0,17000,40000,-23000,-23000
059673,玉山金元富99購01,0,0,0,0,0,0,0,0,0,-23000,0,0,0,0,23000,-23000,-23000
060964,日月光凱基9A購01,0,0,0,0,0,0,0,0,0,-23000,0,0,0,0,23000,-23000,-23000
060635,義隆永豐9A購01  ,0,0,0,0,0,0,0,0,0,-23000,0,0,0,239000,262000,-23000,-23000
2010,春源            ,21000,44000,-23000,0,0,0,0,0,0,0,0,0,0,0,0,0,-23000
07994P,臺股指群益9B售04,0,0,0,0,0,0,0,0,0,-23000,0,0,0,7000,30000,-23000,-23000
062688,華擎統一01購03  ,0,0,0,0,0,0,0,0,0,-24000,0,0,0,36000,60000,-24000,-24000
063192,技嘉台新9B購01  ,0,0,0,0,0,0,0,0,0,-24000,0,0,0,53000,77000,-24000,-24000
063206,貿聯統一9C購02  ,0,0,0,0,0,0,0,0,0,-24000,0,0,0,435000,459000,-24000,-24000
063251,同欣電元大9B購04,0,0,0,0,0,0,0,0,0,-24000,0,0,0,0,24000,-24000,-24000
063329,健策國票9C購01  ,0,0,0,0,0,0,0,0,0,-24000,0,0,0,5000,29000,-24000,-24000
063332,矽格國票9B購01  ,0,0,0,0,0,0,0,0,0,-24000,0,0,0,0,24000,-24000,-24000
063298,統一凱基9B購01  ,0,0,0,0,0,0,0,0,0,-24000,0,0,0,0,24000,-24000,-24000
062864,臺股指國票9B購21,0,0,0,0,0,0,0,0,0,-24000,0,0,0,6000,30000,-24000,-24000
063007,儒鴻元大9B購01  ,0,0,0,0,0,0,0,0,0,-24000,0,0,0,1000,25000,-24000,-24000
056335,微星凱基98購01  ,0,0,0,0,0,0,0,0,0,-24000,0,0,0,56000,80000,-24000,-24000
056581,超眾元大99購01  ,0,0,0,0,0,0,0,0,0,-24000,0,0,0,12000,36000,-24000,-24000
059912,國巨元大99購28  ,0,0,0,0,0,0,0,0,0,-24000,0,0,0,9000,33000,-24000,-24000
055615,宏達電國票99購02,0,0,0,0,0,0,0,0,0,-24000,0,0,0,0,24000,-24000,-24000
053901,T50反1凱基99購03,0,0,0,0,0,0,0,0,0,-24000,0,0,0,13000,37000,-24000,-24000
058593,大立光統一9B購02,0,0,0,0,0,0,0,0,0,-24000,0,0,0,0,24000,-24000,-24000
061283,智邦統一9A購01  ,0,0,0,0,0,0,0,0,0,-24000,0,0,0,645000,669000,-24000,-24000
058512,宏達電元大99購04,0,0,0,0,0,0,0,0,0,-24000,0,0,0,74000,98000,-24000,-24000
059228,臺股指元大99購21,0,0,0,0,0,0,0,0,0,-24000,0,0,0,0,24000,-24000,-24000
07657P,技嘉凱基9A售03  ,0,0,0,0,0,0,0,0,0,-24000,0,0,0,6000,30000,-24000,-24000
2524,京城            ,1000,25000,-24000,0,0,0,0,0,0,0,0,0,0,0,0,0,-24000
3149,正達            ,3000,27000,-24000,0,0,0,0,0,0,0,0,0,0,0,0,0,-24000
062753,台積電麥證9B購01,0,0,0,0,25000,-25000,0,0,0,-25000,0,0,0,0,25000,-25000,-25000
063430,台積電台新9B購07,0,0,0,0,0,0,0,0,0,-25000,0,0,0,0,25000,-25000,-25000
06424P,大成鋼永豐97售01,0,0,0,0,0,0,0,0,0,-25000,0,0,0,0,25000,-25000,-25000
06653P,美食元大98售02  ,0,0,0,0,0,0,0,0,0,-25000,0,0,0,105000,130000,-25000,-25000
07059P,華通國票9A售02  ,0,0,0,0,0,0,0,0,0,-25000,0,0,0,15000,40000,-25000,-25000
062653,正隆永豐9B購01  ,0,0,0,0,0,0,0,0,0,-25000,0,0,0,138000,163000,-25000,-25000
062562,瑞儀凱基9B購02  ,0,0,0,0,0,0,0,0,0,-25000,0,0,0,0,25000,-25000,-25000
062403,健策永豐9B購06  ,0,0,0,0,0,0,0,0,0,-25000,0,0,0,30000,55000,-25000,-25000
061996,矽格元大9B購01  ,0,0,0,0,0,0,0,0,0,-25000,0,0,0,0,25000,-25000,-25000
061809,聯發科統一9C購05,0,0,0,0,0,0,0,0,0,-25000,0,0,0,0,25000,-25000,-25000
053530,聯發科康和96購01,0,0,0,0,0,0,0,0,0,-25000,0,0,0,0,25000,-25000,-25000
054579,聯茂元大97購01  ,0,0,0,0,0,0,0,0,0,-25000,0,0,0,0,25000,-25000,-25000
056004,南電永豐97購02  ,0,0,0,0,0,0,0,0,0,-25000,0,0,0,0,25000,-25000,-25000
054250,漢唐元大96購04  ,0,0,0,0,0,0,0,0,0,-25000,0,0,0,45000,70000,-25000,-25000
055291,京鼎元大97購02  ,0,0,0,0,0,0,0,0,0,-25000,0,0,0,42000,67000,-25000,-25000
056076,超眾元大97購05  ,0,0,0,0,0,0,0,0,0,-25000,0,0,0,2000,27000,-25000,-25000
059922,大立光元大99購25,0,0,0,0,0,0,0,0,0,-25000,0,0,0,5000,30000,-25000,-25000
056449,義隆凱基98購03  ,0,0,0,0,0,0,0,0,0,-25000,0,0,0,56000,81000,-25000,-25000
058847,國巨群益99購05  ,0,0,0,0,0,0,0,0,0,-25000,0,0,0,0,25000,-25000,-25000
057941,聯電國票99購01  ,0,0,0,0,0,0,0,0,0,-25000,0,0,0,0,25000,-25000,-25000
058989,茂林凱基99購02  ,0,0,0,0,0,0,0,0,0,-25000,0,0,0,20000,45000,-25000,-25000
058106,神達統一98購02  ,0,0,0,0,0,0,0,0,0,-25000,0,0,0,5000,30000,-25000,-25000
058335,鴻海元富99購06  ,0,0,0,0,0,0,0,0,0,-25000,0,0,0,8000,33000,-25000,-25000
061305,帆宣永豐9A購01  ,0,0,0,0,0,0,0,0,0,-25000,0,0,0,0,25000,-25000,-25000
061388,台積電群益9A購05,0,0,0,0,0,0,0,0,0,-25000,0,0,0,1000,26000,-25000,-25000
061253,臺股指群益9A購04,0,0,0,0,0,0,0,0,0,-25000,0,0,0,44000,69000,-25000,-25000
061189,可成富邦9B購02  ,0,0,0,0,0,0,0,0,0,-25000,0,0,0,0,25000,-25000,-25000
058888,元油2X元大99購16,0,0,0,0,0,0,0,0,0,-25000,0,0,0,0,25000,-25000,-25000
061030,喬山永豐9A購01  ,0,0,0,0,0,0,0,0,0,-25000,0,0,0,10000,35000,-25000,-25000
058612,健策元大99購02  ,0,0,0,0,0,0,0,0,0,-25000,0,0,0,6000,31000,-25000,-25000
060320,元金2X群益02購01,0,0,0,0,0,0,0,0,0,-25000,0,0,0,0,25000,-25000,-25000
060052,宏碁凱基99購01  ,0,0,0,0,0,0,0,0,0,-25000,0,0,0,5000,30000,-25000,-25000
057569,光磊永豐98購03  ,0,0,0,0,0,0,0,0,0,-25000,0,0,0,47000,72000,-25000,-25000
060589,台灣50台新9B購06,0,0,0,0,0,0,0,0,0,-25000,0,0,0,0,25000,-25000,-25000
060511,群創元大9B購08  ,0,0,0,0,0,0,0,0,0,-25000,0,0,0,75000,100000,-25000,-25000
05760P,京鼎永豐96售02  ,0,0,0,0,0,0,0,0,0,-25000,0,0,0,0,25000,-25000,-25000
057890,滬深反統一98購01,0,0,0,0,0,0,0,0,0,-25000,0,0,0,0,25000,-25000,-25000
2034,允強            ,159000,184000,-25000,0,0,0,0,0,0,0,0,0,0,0,0,0,-25000
08160P,茂林元富9B售03  ,0,0,0,0,0,0,0,0,0,-25000,0,0,0,46000,71000,-25000,-25000
08213P,台光電統一9B售03,0,0,0,0,0,0,0,0,0,-25000,0,0,0,0,25000,-25000,-25000
07610P,大立光國票9A售04,0,0,0,0,0,0,0,0,0,-25000,0,0,0,0,25000,-25000,-25000
07378P,大立光元大99售29,0,0,0,0,0,0,0,0,0,-25000,0,0,0,0,25000,-25000,-25000
08010P,大成鋼元大9B售01,0,0,0,0,0,0,0,0,0,-25000,0,0,0,60000,85000,-25000,-25000
08134P,臺股指元大9B售40,0,0,0,0,0,0,0,0,0,-25000,0,0,0,15000,40000,-25000,-25000
060661,台積電凱基9A購18,0,0,0,0,0,0,0,0,0,-25000,0,0,0,0,25000,-25000,-25000
060994,世芯元大9A購03  ,0,0,0,0,0,0,0,0,0,-25000,0,0,0,8000,33000,-25000,-25000
061897,泰碩永豐9B購01  ,0,0,0,0,0,0,0,0,0,-26000,0,0,0,0,26000,-26000,-26000
062522,同欣電元大9B購02,0,0,0,0,0,0,0,0,0,-26000,0,0,0,8000,34000,-26000,-26000
062539,可成國泰01購01  ,2000,0,2000,0,0,0,0,0,0,-28000,0,0,0,165000,193000,-28000,-26000
063605,健策凱基9C購02  ,0,0,0,0,0,0,0,0,0,-26000,0,0,0,14000,40000,-26000,-26000
063376,神達永豐9B購01  ,0,0,0,0,0,0,0,0,0,-26000,0,0,0,0,26000,-26000,-26000
063288,泰鼎元大9B購02  ,0,0,0,0,0,0,0,0,0,-26000,0,0,0,9000,35000,-26000,-26000
063352,上銀元富9B購02  ,0,0,0,0,0,0,0,0,0,-26000,0,0,0,2000,28000,-26000,-26000
056599,臻鼎元富98購01  ,0,0,0,0,0,0,0,0,0,-26000,0,0,0,0,26000,-26000,-26000
059762,禾伸堂永豐99購02,0,0,0,0,0,0,0,0,0,-26000,0,0,0,60000,86000,-26000,-26000
056170,鴻海元富97購09  ,0,0,0,0,0,0,0,0,0,-26000,0,0,0,0,26000,-26000,-26000
054418,茂林元大97購01  ,0,0,0,0,0,0,0,0,0,-26000,0,0,0,0,26000,-26000,-26000
054479,緯創中信98購01  ,0,0,0,0,0,0,0,0,0,-26000,0,0,0,22000,48000,-26000,-26000
052491,泰碩國票99購01  ,0,0,0,0,0,0,0,0,0,-26000,0,0,0,10000,36000,-26000,-26000
054528,台光電統一96購02,0,0,0,0,0,0,0,0,0,-26000,0,0,0,35000,61000,-26000,-26000
053783,聯發科元大96購17,0,0,0,0,0,0,0,0,0,-26000,0,0,0,21000,47000,-26000,-26000
058272,超眾永豐9A購01  ,0,0,0,0,0,0,0,0,0,-26000,0,0,0,0,26000,-26000,-26000
058207,南茂凱基99購01  ,0,0,0,0,0,0,0,0,0,-26000,0,0,0,0,26000,-26000,-26000
058694,鈺齊國票9A購02  ,0,0,0,0,0,0,0,0,0,-26000,0,0,0,12000,38000,-26000,-26000
058733,同欣電永豐99購02,0,0,0,0,0,0,0,0,0,-26000,0,0,0,34000,60000,-26000,-26000
058875,台表科國票9A購02,0,0,0,0,0,0,0,0,0,-26000,0,0,0,5000,31000,-26000,-26000
061205,旺宏元大9A購11  ,0,0,0,0,0,0,0,0,0,-26000,0,0,0,50000,76000,-26000,-26000
061252,臺股指群益9A購03,0,0,0,0,0,0,0,0,0,-26000,0,0,0,0,26000,-26000,-26000
061121,智邦永豐9A購02  ,0,0,0,0,0,0,0,0,0,-26000,0,0,0,88000,114000,-26000,-26000
061125,億光永豐9A購01  ,0,0,0,0,0,0,0,0,0,-26000,0,0,0,24000,50000,-26000,-26000
058434,旺宏統一9B購01  ,0,0,0,0,0,0,0,0,0,-26000,0,0,0,0,26000,-26000,-26000
058760,嘉晶群益9A購01  ,0,0,0,0,0,0,0,0,0,-26000,0,0,0,4000,30000,-26000,-26000
058799,晶技元大99購04  ,0,0,0,0,0,0,0,0,0,-26000,0,0,0,0,26000,-26000,-26000
058750,緯穎凱基9A購03  ,0,0,0,0,0,0,0,0,0,-26000,0,0,0,9000,35000,-26000,-26000
057962,超眾元大99購03  ,0,0,0,0,0,0,0,0,0,-26000,0,0,0,9000,35000,-26000,-26000
058851,大立光群益99購07,0,0,0,0,0,0,0,0,0,-26000,0,0,0,29000,55000,-26000,-26000
059275,可成元大99購05  ,0,0,0,0,0,0,0,0,0,-26000,0,0,0,2000,28000,-26000,-26000
060888,金像電統一9C購01,0,0,0,0,0,0,0,0,0,-26000,0,0,0,169000,195000,-26000,-26000
2887F,台新戊特二      ,0,0,0,0,0,0,0,0,0,-26000,0,26000,-26000,0,0,0,-26000
6024,群益期          ,11000,37237,-26237,0,0,0,0,0,0,0,0,0,0,0,0,0,-26237
063354,茂林元富9B購02  ,0,0,0,0,0,0,0,0,0,-27000,0,0,0,0,27000,-27000,-27000
063378,茂林永豐9B購02  ,0,0,0,0,0,0,0,0,0,-27000,0,0,0,86000,113000,-27000,-27000
062844,T50反1國泰9C購01,0,0,0,0,0,0,0,0,0,-27000,0,0,0,0,27000,-27000,-27000
063037,聯發科凱基9C購02,0,0,0,0,0,0,0,0,0,-27000,0,0,0,3000,30000,-27000,-27000
063571,TPK元大9B購03   ,0,0,0,0,0,0,0,0,0,-27000,0,0,0,0,27000,-27000,-27000
062302,聯詠中信05購02  ,0,0,0,0,0,0,0,0,0,-27000,0,0,0,11000,38000,-27000,-27000
061731,旺宏統一9B購06  ,0,0,0,0,0,0,0,0,0,-27000,0,0,0,3000,30000,-27000,-27000
061733,聯發科中信01購01,0,0,0,0,0,0,0,0,0,-27000,0,0,0,5000,32000,-27000,-27000
061913,宏碁中信9B購01  ,0,0,0,0,0,0,0,0,0,-27000,0,0,0,0,27000,-27000,-27000
055773,瑞昱凱基97購03  ,0,0,0,0,0,0,0,0,0,-27000,0,0,0,0,27000,-27000,-27000
055297,啟碁元大97購01  ,0,0,0,0,0,0,0,0,0,-27000,0,0,0,68000,95000,-27000,-27000
059137,電子類群益99購01,0,0,0,0,0,0,0,0,0,-27000,0,0,0,0,27000,-27000,-27000
061196,世芯永豐9A購06  ,0,0,0,0,0,0,0,0,0,-27000,0,0,0,55000,82000,-27000,-27000
061055,康控群益9A購01  ,0,0,0,0,0,0,0,0,0,-27000,0,0,0,6000,33000,-27000,-27000
058191,祥碩永豐99購01  ,0,0,0,0,0,0,0,0,0,-27000,0,0,0,15000,42000,-27000,-27000
057380,技嘉國泰9A購01  ,0,0,0,0,0,0,0,0,0,-27000,0,0,0,0,27000,-27000,-27000
058574,台積電群益99購03,0,0,0,0,0,0,0,0,0,-27000,0,0,0,3000,30000,-27000,-27000
059500,鴻海元富99購11  ,0,0,0,0,0,0,0,0,0,-27000,0,0,0,49000,76000,-27000,-27000
060864,可成永豐9A購01  ,0,0,0,0,0,0,0,0,0,-27000,0,0,0,0,27000,-27000,-27000
2538,基泰            ,6000,33000,-27000,0,0,0,0,0,0,0,0,0,0,0,0,0,-27000
2466,冠西電          ,2000,29000,-27000,0,0,0,0,0,0,0,0,0,0,0,0,0,-27000
08211P,台表科元富9B售03,0,0,0,0,0,0,0,0,0,-27000,0,0,0,0,27000,-27000,-27000
07688P,華通元大9A售07  ,0,0,0,0,0,0,0,0,0,-27000,0,0,0,0,27000,-27000,-27000
2395,研華            ,857430,880807,-23377,0,0,0,0,0,0,-4000,0,4000,-4000,0,0,0,-27377
062170,健策永豐9B購04  ,0,0,0,0,0,0,0,0,0,-28000,0,0,0,71000,99000,-28000,-28000
062490,聯茂永豐9B購01  ,0,0,0,0,0,0,0,0,0,-28000,0,0,0,2000,30000,-28000,-28000
062995,聚陽國票9C購01  ,0,0,0,0,0,0,0,0,0,-28000,0,0,0,38000,66000,-28000,-28000
062785,世芯元大9C購01  ,0,0,0,0,0,0,0,0,0,-28000,0,0,0,97000,125000,-28000,-28000
063111,TPK兆豐9B購01   ,0,0,0,0,0,0,0,0,0,-28000,0,0,0,50000,78000,-28000,-28000
063128,智伸科元大9B購01,0,0,0,0,0,0,0,0,0,-28000,0,0,0,0,28000,-28000,-28000
055256,日電貿統一99購01,0,0,0,0,0,0,0,0,0,-28000,0,0,0,8000,36000,-28000,-28000
056168,鴻海元富97購07  ,0,0,0,0,0,0,0,0,0,-28000,0,0,0,0,28000,-28000,-28000
057100,國巨中信9A購02  ,0,0,0,0,0,0,0,0,0,-28000,0,0,0,0,28000,-28000,-28000
057040,國巨元大98購12  ,0,0,0,0,0,0,0,0,0,-28000,0,0,0,0,28000,-28000,-28000
059949,啟碁永豐99購01  ,0,0,0,0,0,0,0,0,0,-28000,0,0,0,62000,90000,-28000,-28000
056394,晶豪科永豐98購01,0,0,0,0,0,0,0,0,0,-28000,0,0,0,12000,40000,-28000,-28000
056860,正崴群益98購01  ,0,0,0,0,0,0,0,0,0,-28000,0,0,0,97000,125000,-28000,-28000
056911,緯穎元大99購01  ,0,0,0,0,0,0,0,0,0,-28000,0,0,0,3000,31000,-28000,-28000
053804,富邦金凱基96購01,0,0,0,0,0,0,0,0,0,-28000,0,0,0,20000,48000,-28000,-28000
054695,世芯永豐98購01  ,0,0,0,0,0,0,0,0,0,-28000,0,0,0,57000,85000,-28000,-28000
052447,聯發科元大96購04,0,0,0,0,0,0,0,0,0,-28000,0,0,0,22000,50000,-28000,-28000
059729,群創元大9C購05  ,0,0,0,0,0,0,0,0,0,-28000,0,0,0,122000,150000,-28000,-28000
060417,正隆永豐9A購01  ,0,0,0,0,0,0,0,0,0,-28000,0,0,0,67000,95000,-28000,-28000
060400,南電國票9A購03  ,0,0,0,0,0,0,0,0,0,-28000,0,0,0,11000,39000,-28000,-28000
057525,光磊元大99購01  ,0,0,0,0,0,0,0,0,0,-28000,0,0,0,31000,59000,-28000,-28000
058751,南茂凱基9A購01  ,0,0,0,0,0,0,0,0,0,-28000,0,0,0,45000,73000,-28000,-28000
057980,聯詠永豐98購01  ,0,0,0,0,0,0,0,0,0,-28000,0,0,0,11000,39000,-28000,-28000
057935,晶技群益98購02  ,0,0,0,0,0,0,0,0,0,-28000,0,0,0,0,28000,-28000,-28000
1109,信大            ,0,28000,-28000,0,0,0,0,0,0,0,0,0,0,0,0,0,-28000
1732,毛寶            ,183000,200000,-17000,0,0,0,0,0,0,-11000,1000,12000,-11000,0,0,0,-28000
063396,金像電群益9C購01,0,0,0,0,0,0,0,0,0,-29000,0,0,0,35000,64000,-29000,-29000
062817,富邦金兆豐9B購01,0,0,0,0,0,0,0,0,0,-29000,0,0,0,38000,67000,-29000,-29000
063573,茂林元大9B購06  ,0,0,0,0,0,0,0,0,0,-29000,0,0,0,14000,43000,-29000,-29000
062428,超眾統一9B購01  ,0,0,0,0,0,0,0,0,0,-29000,0,0,0,76000,105000,-29000,-29000
062163,大毅國泰01購01  ,0,0,0,0,0,0,0,0,0,-29000,0,0,0,87000,116000,-29000,-29000
062333,嘉晶統一9C購01  ,0,0,0,0,0,0,0,0,0,-29000,0,0,0,43000,72000,-29000,-29000
062026,華邦電群益9B購01,0,0,0,0,0,0,0,0,0,-29000,0,0,0,96000,125000,-29000,-29000
062016,美食永豐9B購01  ,0,0,0,0,0,0,0,0,0,-29000,0,0,0,29000,58000,-29000,-29000
061786,義隆群益9B購01  ,0,0,0,0,0,0,0,0,0,-29000,0,0,0,83000,112000,-29000,-29000
061619,大立光群益9B購01,0,0,0,0,0,0,0,0,0,-29000,0,0,0,0,29000,-29000,-29000
061700,瑞昱國票9A購02  ,0,0,0,0,0,0,0,0,0,-29000,0,0,0,79000,108000,-29000,-29000
061496,華新科國票9A購07,0,0,0,0,0,0,0,0,0,-29000,0,0,0,1000,30000,-29000,-29000
056883,美食康和98購01  ,0,0,0,0,0,0,0,0,0,-29000,0,0,0,0,29000,-29000,-29000
055972,GIS元大97購04   ,0,0,0,0,0,0,0,0,0,-29000,0,0,0,117000,146000,-29000,-29000
057027,祥碩凱基98購01  ,0,0,0,0,0,0,0,0,0,-29000,0,0,0,20000,49000,-29000,-29000
058830,健策永豐99購02  ,0,0,0,0,0,0,0,0,0,-29000,0,0,0,8000,37000,-29000,-29000
058452,義隆永豐99購02  ,0,0,0,0,0,0,0,0,0,-29000,0,0,0,105000,134000,-29000,-29000
058107,全新台新99購01  ,0,0,0,0,0,0,0,0,0,-29000,0,0,0,20000,49000,-29000,-29000
057416,T50反1凱基9C購01,0,0,0,0,0,0,0,0,0,-29000,0,0,0,56000,85000,-29000,-29000
057449,華新科元富99購02,0,0,0,0,0,0,0,0,0,-29000,0,0,0,0,29000,-29000,-29000
057859,神達康和98購01  ,0,0,0,0,0,0,0,0,0,-29000,0,0,0,0,29000,-29000,-29000
060413,東元永豐9A購01  ,0,0,0,0,0,0,0,0,0,-29000,0,0,0,8000,37000,-29000,-29000
1417,嘉裕            ,1000,30000,-29000,0,0,0,0,0,0,0,0,0,0,0,0,0,-29000
08097P,嘉澤永豐9B售03  ,0,0,0,0,0,0,0,0,0,-29000,0,0,0,0,29000,-29000,-29000
8215,明基材          ,61000,90000,-29000,0,0,0,0,0,0,0,0,0,0,0,0,0,-29000
8341,日友            ,88000,131000,-43000,0,0,0,0,0,0,14000,14000,0,14000,0,0,0,-29000
061590,金寶永豐9A購01  ,0,0,0,0,0,0,0,0,0,-30000,0,0,0,80000,110000,-30000,-30000
061881,緯穎元大9B購02  ,0,0,0,0,0,0,0,0,0,-30000,0,0,0,7000,37000,-30000,-30000
062318,台郡凱基9B購01  ,0,0,0,0,0,0,0,0,0,-30000,0,0,0,0,30000,-30000,-30000
062225,華擎統一01購01  ,0,0,0,0,0,0,0,0,0,-30000,0,0,0,13000,43000,-30000,-30000
062255,聯發科元大9B購07,0,0,0,0,0,0,0,0,0,-30000,0,0,0,6000,36000,-30000,-30000
062444,大立光元大9C購01,0,0,0,0,0,0,0,0,0,-30000,0,0,0,0,30000,-30000,-30000
062473,同欣電凱基9B購01,0,0,0,0,0,0,0,0,0,-30000,0,0,0,0,30000,-30000,-30000
062721,美律凱基9B購02  ,0,0,0,0,0,0,0,0,0,-30000,0,0,0,0,30000,-30000,-30000
063546,國巨兆豐9C購03  ,0,0,0,0,0,0,0,0,0,-30000,0,0,0,0,30000,-30000,-30000
063528,元大金凱基9B購01,0,0,0,0,0,0,0,0,0,-30000,0,0,0,0,30000,-30000,-30000
06590P,大立光元大98售13,0,0,0,0,0,0,0,0,0,-30000,0,0,0,0,30000,-30000,-30000
06591P,大立光元大98售14,0,0,0,0,0,0,0,0,0,-30000,0,0,0,0,30000,-30000,-30000
06405P,億光元富97售02  ,0,0,0,0,0,0,0,0,0,-30000,0,0,0,20000,50000,-30000,-30000
06479P,聯發科中信99售02,0,0,0,0,0,0,0,0,0,-30000,0,0,0,0,30000,-30000,-30000
06504P,麗豐國票99售02  ,0,0,0,0,0,0,0,0,0,-30000,0,0,0,55000,85000,-30000,-30000
062772,T50反1元大9B購06,0,0,0,0,0,0,0,0,0,-30000,0,0,0,0,30000,-30000,-30000
062905,聯發科元大9B購13,0,0,0,0,0,0,0,0,0,-30000,0,0,0,36000,66000,-30000,-30000
062991,台光電群益9B購03,0,0,0,0,0,0,0,0,0,-30000,0,0,0,0,30000,-30000,-30000
063039,大立光凱基9C購02,0,0,0,0,0,0,0,0,0,-30000,0,0,0,2000,32000,-30000,-30000
063408,茂林國票9C購02  ,0,0,0,0,0,0,0,0,0,-30000,0,0,0,19000,49000,-30000,-30000
063185,聯發科凱基9C購03,0,0,0,0,0,0,0,0,0,-30000,0,0,0,0,30000,-30000,-30000
063186,聯發科凱基9C購04,0,0,0,0,0,0,0,0,0,-30000,0,0,0,0,30000,-30000,-30000
063237,微星元大9B購02  ,0,0,0,0,0,0,0,0,0,-30000,0,0,0,0,30000,-30000,-30000
057104,康友中信99購01  ,0,0,0,0,0,0,0,0,0,-30000,0,0,0,0,30000,-30000,-30000
056197,友訊永豐97購01  ,0,0,0,0,0,0,0,0,0,-30000,0,0,0,0,30000,-30000,-30000
056145,緯穎元大98購03  ,0,0,0,0,0,0,0,0,0,-30000,0,0,0,0,30000,-30000,-30000
054919,興富發凱基97購01,0,0,0,0,0,0,0,0,0,-30000,0,0,0,0,30000,-30000,-30000
055384,緯穎元大98購02  ,0,0,0,0,0,0,0,0,0,-30000,0,0,0,0,30000,-30000,-30000
055572,鴻海統一98購04  ,0,0,0,0,0,0,0,0,0,-30000,0,0,0,9000,39000,-30000,-30000
055446,奇力新統一9A購01,0,0,0,0,0,0,0,0,0,-30000,0,0,0,0,30000,-30000,-30000
055689,台郡凱基99購01  ,0,0,0,0,0,0,0,0,0,-30000,0,0,0,0,30000,-30000,-30000
056392,玉晶光富邦9C購01,0,0,0,0,0,0,0,0,0,-30000,0,0,0,0,30000,-30000,-30000
056596,光磊元富98購01  ,0,0,0,0,0,0,0,0,0,-30000,0,0,0,60000,90000,-30000,-30000
056685,光罩統一98購03  ,0,0,0,0,0,0,0,0,0,-30000,0,0,0,0,30000,-30000,-30000
056290,正文永豐98購01  ,0,0,0,0,0,0,0,0,0,-30000,0,0,0,0,30000,-30000,-30000
056532,技嘉凱基98購01  ,0,0,0,0,0,0,0,0,0,-30000,0,0,0,0,30000,-30000,-30000
056880,緯穎國票98購02  ,0,0,0,0,0,0,0,0,0,-30000,0,0,0,0,30000,-30000,-30000
055802,新日興永豐97購01,0,0,0,0,0,0,0,0,0,-30000,0,0,0,0,30000,-30000,-30000
053122,美律凱基98購01  ,0,0,0,0,0,0,0,0,0,-30000,0,0,0,0,30000,-30000,-30000
053117,大立光中信9A購02,0,0,0,0,0,0,0,0,0,-30000,0,0,0,0,30000,-30000,-30000
054523,GIS元大96購05   ,0,0,0,0,0,0,0,0,0,-30000,0,0,0,68000,98000,-30000,-30000
054387,台積電統一98購02,0,0,0,0,0,0,0,0,0,-30000,0,0,0,0,30000,-30000,-30000
051317,亞德客國票96購01,0,0,0,0,0,0,0,0,0,-30000,0,0,0,10000,40000,-30000,-30000
050673,旺宏富邦96購02  ,0,0,0,0,0,0,0,0,0,-30000,0,0,0,0,30000,-30000,-30000
050842,旺宏國票97購01  ,0,0,0,0,0,0,0,0,0,-30000,0,0,0,0,30000,-30000,-30000
060412,儒鴻永豐9A購01  ,0,0,0,0,0,0,0,0,0,-30000,0,0,0,50000,80000,-30000,-30000
057836,南亞科國泰9A購01,0,0,0,0,0,0,0,0,0,-30000,0,0,0,0,30000,-30000,-30000
058661,臺股指中信9C購01,0,0,0,0,0,0,0,0,0,-30000,0,0,0,0,30000,-30000,-30000
060554,中租凱基9A購01  ,0,0,0,0,0,0,0,0,0,-30000,0,0,0,0,30000,-30000,-30000
059691,大立光永豐99購02,0,0,0,0,0,0,0,0,0,-30000,0,0,0,10000,40000,-30000,-30000
05947P,大成鋼元大96售03,0,0,0,0,0,0,0,0,0,-30000,0,0,0,30000,60000,-30000,-30000
059470,華新科元大99購16,0,0,0,0,0,0,0,0,0,-30000,0,0,0,0,30000,-30000,-30000
057708,臺股指群益98購08,0,0,0,0,0,0,0,0,0,-30000,0,0,0,0,30000,-30000,-30000
057714,聯發科統一98購05,0,0,0,0,0,0,0,0,0,-30000,0,0,0,0,30000,-30000,-30000
057902,嘉晶永豐98購02  ,0,0,0,0,0,0,0,0,0,-30000,0,0,0,58000,88000,-30000,-30000
057655,奇力新中信98購05,0,0,0,0,0,0,0,0,0,-30000,0,0,0,0,30000,-30000,-30000
057915,台泥凱基98購01  ,0,0,0,0,0,0,0,0,0,-30000,0,0,0,0,30000,-30000,-30000
057355,彩晶統一98購03  ,0,0,0,0,0,0,0,0,0,-30000,0,0,0,0,30000,-30000,-30000
057408,台郡群益98購01  ,0,0,0,0,0,0,0,0,0,-30000,0,0,0,0,30000,-30000,-30000
057399,滬深反群益9C購01,0,0,0,0,0,0,0,0,0,-30000,0,0,0,0,30000,-30000,-30000
060472,中租元大9A購02  ,0,0,0,0,0,0,0,0,0,-30000,0,0,0,11000,41000,-30000,-30000
058466,SGBR2X中信99購02,0,0,0,0,0,0,0,0,0,-30000,0,0,0,0,30000,-30000,-30000
058387,國巨國票9A購03  ,0,0,0,0,0,0,0,0,0,-30000,0,0,0,3000,33000,-30000,-30000
058782,臺股指國票99購01,0,0,0,0,0,0,0,0,0,-30000,0,0,0,0,30000,-30000,-30000
059032,元石油群益9C購03,0,0,0,0,0,0,0,0,0,-30000,0,0,0,0,30000,-30000,-30000
059172,台郡凱基99購03  ,0,0,0,0,0,0,0,0,0,-30000,0,0,0,0,30000,-30000,-30000
058877,T50反1國泰9B購01,0,0,0,0,0,0,0,0,0,-30000,0,0,0,350000,380000,-30000,-30000
057211,鴻海群益98購05  ,0,0,0,0,0,0,0,0,0,-30000,0,0,0,3000,33000,-30000,-30000
058937,仁寶中信99購01  ,0,0,0,0,0,0,0,0,0,-30000,0,0,0,30000,60000,-30000,-30000
061203,國巨元大9A購15  ,0,0,0,0,0,0,0,0,0,-30000,0,0,0,0,30000,-30000,-30000
061225,台積電中信9A購04,0,0,0,0,0,0,0,0,0,-30000,0,0,0,0,30000,-30000,-30000
060819,國巨統一9C購04  ,0,0,0,0,0,0,0,0,0,-30000,0,0,0,100000,130000,-30000,-30000
060713,聯詠永豐9A購01  ,0,0,0,0,0,0,0,0,0,-30000,0,0,0,127000,157000,-30000,-30000
07615P,華通中信02售02  ,0,0,0,0,0,0,0,0,0,-30000,0,0,0,0,30000,-30000,-30000
07230P,滬深2X群益01售02,0,0,0,0,0,0,0,0,0,-30000,0,0,0,0,30000,-30000,-30000
07257P,臺股指凱基99售37,0,0,0,0,0,0,0,0,0,-30000,0,0,0,0,30000,-30000,-30000
1451,年興            ,0,30000,-30000,0,0,0,0,0,0,0,0,0,0,0,0,0,-30000
2374,佳能            ,5000,33000,-28000,0,0,0,0,0,0,-2000,0,2000,-2000,0,0,0,-30000
06803P,臺股指群益98售09,0,0,0,0,0,0,0,0,0,-31000,0,0,0,24000,55000,-31000,-31000
062700,台光電元大9B購05,0,0,0,0,0,0,0,0,0,-31000,0,0,0,34000,65000,-31000,-31000
062639,臻鼎國票9C購01  ,0,0,0,0,0,0,0,0,0,-31000,0,0,0,16000,47000,-31000,-31000
061644,健策元大9C購02  ,0,0,0,0,0,0,0,0,0,-31000,0,0,0,21000,52000,-31000,-31000
061485,鴻海兆豐9A購01  ,0,0,0,0,0,0,0,0,0,-31000,0,0,0,12000,43000,-31000,-31000
055744,茂林元富97購02  ,0,0,0,0,0,0,0,0,0,-31000,0,0,0,278000,309000,-31000,-31000
055821,勤誠國票98購01  ,0,0,0,0,0,0,0,0,0,-31000,0,0,0,0,31000,-31000,-31000
056894,佳世達元大99購01,0,0,0,0,0,0,0,0,0,-31000,0,0,0,20000,51000,-31000,-31000
053643,漢唐國票97購02  ,0,0,0,0,0,0,0,0,0,-31000,0,0,0,3000,34000,-31000,-31000
053487,台泥兆豐97購01  ,0,0,0,0,0,0,0,0,0,-31000,0,0,0,0,31000,-31000,-31000
056360,智邦元大98購01  ,0,0,0,0,0,0,0,0,0,-31000,0,0,0,6000,37000,-31000,-31000
059790,立積元大9C購02  ,0,0,0,0,0,0,0,0,0,-31000,0,0,0,283000,314000,-31000,-31000
055230,大毅國票98購01  ,0,0,0,0,0,0,0,0,0,-31000,0,0,0,1000,32000,-31000,-31000
061140,華擎統一9C購01  ,0,0,0,0,0,0,0,0,0,-31000,0,0,0,0,31000,-31000,-31000
059426,鴻海元大99購31  ,0,0,0,0,0,0,0,0,0,-31000,0,0,0,6000,37000,-31000,-31000
058141,嘉聯益元大99購05,0,0,0,0,0,0,0,0,0,-31000,0,0,0,0,31000,-31000,-31000
058483,道瓊指國票9A購01,0,0,0,0,0,0,0,0,0,-31000,0,0,0,20000,51000,-31000,-31000
058237,嘉晶元大99購04  ,0,0,0,0,0,0,0,0,0,-31000,0,0,0,0,31000,-31000,-31000
058253,臺股指元大9A購17,0,0,0,0,0,0,0,0,0,-31000,0,0,0,0,31000,-31000,-31000
1473,台南            ,1000,32000,-31000,0,0,0,0,0,0,0,0,0,0,0,0,0,-31000
060778,臺股指凱基9A購06,0,0,0,0,0,0,0,0,0,-31000,0,0,0,0,31000,-31000,-31000
060961,台光電凱基9A購03,0,0,0,0,0,0,0,0,0,-31000,0,0,0,1000,32000,-31000,-31000
061502,嘉澤國票9A購02  ,0,0,0,0,0,0,0,0,0,-32000,0,0,0,3000,35000,-32000,-32000
061808,聯發科統一01購02,0,0,0,0,0,0,0,0,0,-32000,0,0,0,132000,164000,-32000,-32000
062464,T50反1凱基9C購03,0,0,0,0,0,0,0,0,0,-32000,0,0,0,0,32000,-32000,-32000
062200,臺指反國票03購01,0,0,0,0,0,0,0,0,0,-32000,0,0,0,18000,50000,-32000,-32000
063167,同欣電永豐9B購03,0,0,0,0,0,0,0,0,0,-32000,0,0,0,20000,52000,-32000,-32000
062942,嘉澤凱基9B購02  ,0,0,0,0,0,0,0,0,0,-32000,0,0,0,0,32000,-32000,-32000
055545,國巨凱基97購06  ,0,0,0,0,0,0,0,0,0,-32000,0,0,0,10000,42000,-32000,-32000
055058,大毅永豐97購01  ,0,0,0,0,0,0,0,0,0,-32000,0,0,0,30000,62000,-32000,-32000
056165,矽力凱基98購02  ,0,0,0,0,0,0,0,0,0,-32000,0,0,0,18000,50000,-32000,-32000
056970,TPK永豐98購01   ,0,0,0,0,0,0,0,0,0,-32000,0,0,0,50000,82000,-32000,-32000
060209,喬山康和9A購01  ,0,0,0,0,0,0,0,0,0,-32000,0,0,0,0,32000,-32000,-32000
059910,鴻海元大99購37  ,0,0,0,0,0,0,0,0,0,-32000,0,0,0,3000,35000,-32000,-32000
056026,智易群益97購01  ,0,0,0,0,0,0,0,0,0,-32000,0,0,0,18000,50000,-32000,-32000
055834,國巨元大97購13  ,0,0,0,0,0,0,0,0,0,-32000,0,0,0,15000,47000,-32000,-32000
050078,臺指反統一97購01,0,0,0,0,0,0,0,0,0,-32000,0,0,0,0,32000,-32000,-32000
035275,台積電台新97購01,0,0,0,0,0,0,0,0,0,-32000,0,0,0,1000,33000,-32000,-32000
057718,旺宏元富02購02  ,0,0,0,0,0,0,0,0,0,-32000,0,0,0,20000,52000,-32000,-32000
059664,立積元大9C購01  ,0,0,0,0,0,0,0,0,0,-32000,0,0,0,22000,54000,-32000,-32000
058783,臺股指國票99購02,0,0,0,0,0,0,0,0,0,-32000,0,0,0,8000,40000,-32000,-32000
058813,旺宏統一9B購04  ,0,0,0,0,0,0,0,0,0,-32000,0,0,0,0,32000,-32000,-32000
058004,大立光群益98購03,0,0,0,0,0,0,0,0,0,-32000,0,0,0,0,32000,-32000,-32000
057996,臻鼎中信98購01  ,0,0,0,0,0,0,0,0,0,-32000,0,0,0,15000,47000,-32000,-32000
057960,聯鈞元大98購02  ,0,0,0,0,0,0,0,0,0,-32000,0,0,0,68000,100000,-32000,-32000
060953,富邦金群益9A購01,0,0,0,0,0,0,0,0,0,-32000,0,0,0,43000,75000,-32000,-32000
1463,強盛            ,2000,34000,-32000,0,0,0,0,0,0,0,0,0,0,0,0,0,-32000
2485,兆赫            ,35000,77000,-42000,0,0,0,0,0,0,10000,12000,2000,10000,0,0,0,-32000
2444,兆勁            ,22000,54000,-32000,0,0,0,0,0,0,0,0,0,0,0,0,0,-32000
063314,美律群益9B購01  ,0,0,0,0,0,0,0,0,0,-33000,0,0,0,6000,39000,-33000,-33000
063486,聚陽國泰9C購01  ,0,0,0,0,0,0,0,0,0,-33000,0,0,0,0,33000,-33000,-33000
062080,奇力新元大9B購02,0,0,0,0,0,0,0,0,0,-33000,0,0,0,32000,65000,-33000,-33000
061656,華新科國票9A購08,0,0,0,0,0,0,0,0,0,-33000,0,0,0,0,33000,-33000,-33000
049485,台積電元大96購03,0,0,0,0,0,0,0,0,0,-33000,0,0,0,30000,63000,-33000,-33000
020015,統一MSCI美低波N ,0,0,0,0,0,0,0,0,0,-33000,0,0,0,50000,83000,-33000,-33000
052076,可成元富98購01  ,0,0,0,0,0,0,0,0,0,-33000,0,0,0,0,33000,-33000,-33000
056828,國巨富邦9A購03  ,0,0,0,0,0,0,0,0,0,-33000,0,0,0,0,33000,-33000,-33000
055859,啟碁元大97購03  ,0,0,0,0,0,0,0,0,0,-33000,0,0,0,0,33000,-33000,-33000
060096,聯發科元大99購43,0,0,0,0,0,0,0,0,0,-33000,0,0,0,6000,39000,-33000,-33000
054951,大毅元大97購01  ,0,0,0,0,0,0,0,0,0,-33000,0,0,0,0,33000,-33000,-33000
056203,興富發永豐97購01,0,0,0,0,0,0,0,0,0,-33000,0,0,0,35000,68000,-33000,-33000
061263,微星凱基9A購01  ,0,0,0,0,0,0,0,0,0,-33000,0,0,0,0,33000,-33000,-33000
059661,大立光元大99購22,0,0,0,0,0,0,0,0,0,-33000,0,0,0,0,33000,-33000,-33000
057803,上銀元大98購08  ,0,0,0,0,0,0,0,0,0,-33000,0,0,0,55000,88000,-33000,-33000
060287,燿華元大9A購01  ,0,0,0,0,0,0,0,0,0,-33000,0,0,0,42000,75000,-33000,-33000
057269,鈺齊兆豐98購01  ,0,0,0,0,0,0,0,0,0,-33000,0,0,0,50000,83000,-33000,-33000
060468,聯鈞元大9A購02  ,0,0,0,0,0,0,0,0,0,-33000,0,0,0,135000,168000,-33000,-33000
1104,環泥            ,15000,48000,-33000,0,0,0,0,0,0,0,0,0,0,0,0,0,-33000
08019P,緯穎國票9B售02  ,0,0,0,0,0,0,0,0,0,-33000,0,0,0,103000,136000,-33000,-33000
08070P,晶技國泰9C售02  ,0,0,0,0,0,0,0,0,0,-33000,0,0,0,3000,36000,-33000,-33000
060910,聯發科元大9A購05,0,0,0,0,0,0,0,0,0,-33000,0,0,0,25000,58000,-33000,-33000
061705,健策國票9A購06  ,0,0,0,0,0,0,0,0,0,-34000,0,0,0,3000,37000,-34000,-34000
061460,FBVIX群益9A購02 ,0,0,0,0,0,0,0,0,0,-34000,0,0,0,3000,37000,-34000,-34000
061879,超眾元大9C購01  ,0,0,0,0,0,0,0,0,0,-34000,0,0,0,304000,338000,-34000,-34000
063265,瑞祺永豐9B購01  ,0,0,0,0,0,0,0,0,0,-34000,0,0,0,130000,164000,-34000,-34000
055039,神達富邦99購01  ,0,0,0,0,0,0,0,0,0,-34000,0,0,0,0,34000,-34000,-34000
059864,亞德客凱基99購01,0,0,0,0,0,0,0,0,0,-34000,0,0,0,3000,37000,-34000,-34000
056560,旺宏群益98購03  ,0,0,0,0,0,0,0,0,0,-34000,0,0,0,155000,189000,-34000,-34000
00683L,元大美元指數正2 ,0,0,0,0,0,0,0,0,0,-34000,0,0,0,1000,35000,-34000,-34000
058645,康控富邦01購01  ,0,0,0,0,0,0,0,0,0,-34000,0,0,0,0,34000,-34000,-34000
058556,百和永豐99購01  ,0,0,0,0,0,0,0,0,0,-34000,0,0,0,33000,67000,-34000,-34000
059177,臺股指凱基99購28,0,0,0,0,0,0,0,0,0,-34000,0,0,0,22000,56000,-34000,-34000
060959,金像電凱基9A購01,0,0,0,0,0,0,0,0,0,-34000,0,0,0,61000,95000,-34000,-34000
1810,和成            ,32000,66000,-34000,0,0,0,0,0,0,0,0,0,0,0,0,0,-34000
1537,廣隆            ,0,34000,-34000,0,0,0,0,0,0,0,0,0,0,0,0,0,-34000
063168,台表科永豐9B購01,0,0,0,0,0,0,0,0,0,-35000,0,0,0,0,35000,-35000,-35000
063324,道瓊反國票9B購03,0,0,0,0,0,0,0,0,0,-35000,0,0,0,0,35000,-35000,-35000
062986,T50反1中信02購01,0,0,0,0,0,0,0,0,0,-35000,0,0,0,10000,45000,-35000,-35000
063661,聚陽統一9C購02  ,0,0,0,0,0,0,0,0,0,-35000,0,0,0,0,35000,-35000,-35000
06886P,旺宏元大99售07  ,0,0,0,0,0,0,0,0,0,-35000,0,0,0,44000,79000,-35000,-35000
06936P,瑞儀元大98售01  ,0,0,0,0,0,0,0,0,0,-35000,0,0,0,15000,50000,-35000,-35000
062051,上銀統一9C購02  ,0,0,0,0,0,0,0,0,0,-35000,0,0,0,0,35000,-35000,-35000
061528,超眾凱基9A購04  ,0,0,0,0,0,0,0,0,0,-35000,0,0,0,0,35000,-35000,-35000
061544,大毅群益9B購02  ,0,0,0,0,0,0,0,0,0,-35000,0,0,0,0,35000,-35000,-35000
062160,南六凱基9B購01  ,0,0,0,0,0,0,0,0,0,-35000,0,0,0,79000,114000,-35000,-35000
062418,台積電統一01購06,0,0,0,0,0,0,0,0,0,-35000,0,0,0,25000,60000,-35000,-35000
062607,美食凱基9B購01  ,0,0,0,0,0,0,0,0,0,-35000,0,0,0,0,35000,-35000,-35000
055860,啟碁元大97購04  ,0,0,0,0,0,0,0,0,0,-35000,0,0,0,0,35000,-35000,-35000
056945,鴻海統一98購12  ,0,0,0,0,0,0,0,0,0,-35000,0,0,0,15000,50000,-35000,-35000
053294,聯發科中信9C購01,0,0,0,0,0,0,0,0,0,-35000,0,0,0,79000,114000,-35000,-35000
060075,台積電元富99購05,0,0,0,0,0,0,0,0,0,-35000,0,0,0,0,35000,-35000,-35000
055421,玉晶光永豐98購04,0,0,0,0,0,0,0,0,0,-35000,0,0,0,0,35000,-35000,-35000
054895,南電統一97購01  ,0,0,0,0,0,0,0,0,0,-35000,0,0,0,0,35000,-35000,-35000
059397,T50反1元富99購05,0,0,0,0,0,0,0,0,0,-35000,0,0,0,11000,46000,-35000,-35000
058390,樺漢國票9A購01  ,0,0,0,0,0,0,0,0,0,-35000,0,0,0,40000,75000,-35000,-35000
058421,國泰金麥證01購01,0,0,0,0,35000,-35000,0,0,0,-35000,0,0,0,0,35000,-35000,-35000
061057,華新科國票9A購04,0,0,0,0,0,0,0,0,0,-35000,0,0,0,0,35000,-35000,-35000
058545,義隆富邦9C購01  ,0,0,0,0,0,0,0,0,0,-35000,0,0,0,76000,111000,-35000,-35000
060126,創意永豐99購04  ,0,0,0,0,0,0,0,0,0,-35000,0,0,0,76000,111000,-35000,-35000
060374,儒鴻元富9A購01  ,0,0,0,0,0,0,0,0,0,-35000,0,0,0,20000,55000,-35000,-35000
057570,技嘉永豐98購02  ,0,0,0,0,0,0,0,0,0,-35000,0,0,0,0,35000,-35000,-35000
058244,神達元大99購02  ,0,0,0,0,0,0,0,0,0,-35000,0,0,0,88000,123000,-35000,-35000
2530,華建            ,42000,77000,-35000,0,0,0,0,0,0,0,0,0,0,0,0,0,-35000
060630,國巨富邦9C購03  ,0,0,0,0,0,0,0,0,0,-35000,0,0,0,5000,40000,-35000,-35000
4720,德淵            ,139000,174000,-35000,0,0,0,0,0,0,0,0,0,0,0,0,0,-35000
4976,佳凌            ,65000,100000,-35000,0,0,0,0,0,0,0,0,0,0,0,0,0,-35000
062253,燿華元大9B購02  ,0,0,0,0,0,0,0,0,0,-36000,0,0,0,47000,83000,-36000,-36000
062254,台光電元大9B購02,0,0,0,0,0,0,0,0,0,-36000,0,0,0,30000,66000,-36000,-36000
061546,大立光群益9A購05,0,0,0,0,0,0,0,0,0,-36000,0,0,0,5000,41000,-36000,-36000
061603,瑞昱凱基9A購02  ,0,0,0,0,0,0,0,0,0,-36000,0,0,0,13000,49000,-36000,-36000
062019,嘉澤永豐9B購01  ,0,0,0,0,0,0,0,0,0,-36000,0,0,0,9000,45000,-36000,-36000
053970,聯發科元大97購08,0,0,0,0,0,0,0,0,0,-36000,0,0,0,0,36000,-36000,-36000
058236,大立光元大99購09,0,0,0,0,0,0,0,0,0,-36000,0,0,0,0,36000,-36000,-36000
058216,TPK群益99購01   ,0,0,0,0,0,0,0,0,0,-36000,0,0,0,1000,37000,-36000,-36000
057847,聯茂永豐98購01  ,0,0,0,0,0,0,0,0,0,-36000,0,0,0,10000,46000,-36000,-36000
057742,喬山永豐98購02  ,0,0,0,0,0,0,0,0,0,-36000,0,0,0,0,36000,-36000,-36000
058438,大立光統一9B購01,0,0,0,0,0,0,0,0,0,-36000,0,0,0,14000,50000,-36000,-36000
5007,三星            ,5000,41000,-36000,0,0,0,0,0,0,0,0,0,0,0,0,0,-36000
060677,京元電元大9A購04,0,0,0,0,0,0,0,0,0,-36000,0,0,0,202000,238000,-36000,-36000
3033,威健            ,1000,37000,-36000,0,0,0,0,0,0,0,0,0,0,0,0,0,-36000
07292P,臺股指凱基99售44,0,0,0,0,0,0,0,0,0,-36000,0,0,0,120000,156000,-36000,-36000
061939,中租國票9B購01  ,0,0,0,0,0,0,0,0,0,-37000,0,0,0,105000,142000,-37000,-37000
061977,國巨元大9B購02  ,0,0,0,0,0,0,0,0,0,-37000,0,0,0,0,37000,-37000,-37000
061562,群創國票9B購01  ,0,0,0,0,0,0,0,0,0,-37000,0,0,0,9000,46000,-37000,-37000
062676,南六台新9B購01  ,0,0,0,0,0,0,0,0,0,-37000,0,0,0,38000,75000,-37000,-37000
063147,東元元富9B購01  ,0,0,0,0,0,0,0,0,0,-37000,0,0,0,111000,148000,-37000,-37000
05624P,同欣電中信98售01,0,0,0,0,0,0,0,0,0,-37000,0,0,0,10000,47000,-37000,-37000
060226,道瓊反元大9A購01,0,0,0,0,0,0,0,0,0,-37000,0,0,0,17000,54000,-37000,-37000
058096,南電元大98購04  ,0,0,0,0,0,0,0,0,0,-37000,0,0,0,50000,87000,-37000,-37000
058618,南電元大99購02  ,0,0,0,0,0,0,0,0,0,-37000,0,0,0,3000,40000,-37000,-37000
06044P,同欣電永豐96售03,0,0,0,0,0,0,0,0,0,-37000,0,0,0,34000,71000,-37000,-37000
3047,訊舟            ,17000,54000,-37000,0,0,0,0,0,0,0,0,0,0,0,0,0,-37000
4560,強信-KY         ,92000,129000,-37000,0,0,0,0,0,0,0,0,0,0,0,0,0,-37000
062722,京元電凱基9B購02,0,0,0,0,0,0,0,0,0,-38000,0,0,0,131000,169000,-38000,-38000
062631,奇力新國票9B購01,0,0,0,0,0,0,0,0,0,-38000,0,0,0,0,38000,-38000,-38000
062206,緯創國票9B購01  ,0,0,0,0,0,0,0,0,0,-38000,0,0,0,0,38000,-38000,-38000
062301,聯詠中信05購01  ,0,0,0,0,0,0,0,0,0,-38000,0,0,0,0,38000,-38000,-38000
061560,友達國票9B購01  ,0,0,0,0,0,0,0,0,0,-38000,0,0,0,0,38000,-38000,-38000
056536,義隆凱基98購04  ,0,0,0,0,0,0,0,0,0,-38000,0,0,0,109000,147000,-38000,-38000
056198,台光電永豐97購02,0,0,0,0,0,0,0,0,0,-38000,0,0,0,12000,50000,-38000,-38000
057059,易華電元大99購01,0,0,0,0,0,0,0,0,0,-38000,0,0,0,0,38000,-38000,-38000
053900,T50反1日盛99購01,0,0,0,0,0,0,0,0,0,-38000,0,0,0,0,38000,-38000,-38000
053916,漢唐國票97購04  ,0,0,0,0,0,0,0,0,0,-38000,0,0,0,2000,40000,-38000,-38000
053293,聯發科中信9B購01,0,0,0,0,0,0,0,0,0,-38000,0,0,0,34000,72000,-38000,-38000
054649,聯茂群益97購01  ,0,0,0,0,0,0,0,0,0,-38000,0,0,0,12000,50000,-38000,-38000
056879,旺宏國票99購02  ,0,0,0,0,0,0,0,0,0,-38000,0,0,0,0,38000,-38000,-38000
051486,玉晶光凱基97購03,0,0,0,0,0,0,0,0,0,-38000,0,0,0,30000,68000,-38000,-38000
054517,高鐵元大96購01  ,0,0,0,0,0,0,0,0,0,-38000,0,0,0,145000,183000,-38000,-38000
058649,健策永豐99購01  ,0,0,0,0,0,0,0,0,0,-38000,0,0,0,4000,42000,-38000,-38000
060314,元翎永豐9A購01  ,0,0,0,0,0,0,0,0,0,-38000,0,0,0,0,38000,-38000,-38000
058939,台積電中信9B購01,0,0,0,0,0,0,0,0,0,-38000,0,0,0,0,38000,-38000,-38000
058905,京鼎元大99購01  ,0,0,0,0,0,0,0,0,0,-38000,0,0,0,52000,90000,-38000,-38000
061170,南茂兆豐9B購01  ,0,0,0,0,0,0,0,0,0,-38000,0,0,0,25000,63000,-38000,-38000
060982,旺宏元大9A購09  ,0,0,0,0,0,0,0,0,0,-38000,0,0,0,0,38000,-38000,-38000
060788,嘉晶富邦9B購01  ,0,0,0,0,0,0,0,0,0,-38000,0,0,0,0,38000,-38000,-38000
06081P,深中小元大97售02,0,0,0,0,0,0,0,0,0,-38000,0,0,0,50000,88000,-38000,-38000
060842,新光金國票9B購01,0,0,0,0,0,0,0,0,0,-38000,0,0,0,0,38000,-38000,-38000
2527,宏璟            ,23000,61000,-38000,0,0,0,0,0,0,0,0,0,0,0,0,0,-38000
1560,中砂            ,1000,39000,-38000,0,0,0,0,0,0,0,0,0,0,0,0,0,-38000
061483,TPK元大9A購01   ,0,0,0,0,0,0,0,0,0,-39000,0,0,0,128000,167000,-39000,-39000
061931,力山國票9B購02  ,0,0,0,0,0,0,0,0,0,-39000,0,0,0,2000,41000,-39000,-39000
061818,富邦金群益9C購01,0,0,0,0,0,0,0,0,0,-39000,0,0,0,85000,124000,-39000,-39000
062142,喬山國票9B購01  ,0,0,0,0,0,0,0,0,0,-39000,0,0,0,60000,99000,-39000,-39000
062615,亞德客元大9B購02,0,0,0,0,0,0,0,0,0,-39000,0,0,0,8000,47000,-39000,-39000
063306,聯茂凱基9C購01  ,0,0,0,0,0,0,0,0,0,-39000,0,0,0,54000,93000,-39000,-39000
062976,嘉澤元富9B購01  ,0,0,0,0,0,0,0,0,0,-39000,0,0,0,57000,96000,-39000,-39000
063100,聚陽群益9C購02  ,0,0,0,0,0,0,0,0,0,-39000,0,0,0,73000,112000,-39000,-39000
062913,創意元大9B購02  ,0,0,0,0,0,0,0,0,0,-39000,0,0,0,180000,219000,-39000,-39000
062794,鴻海統一9C購15  ,0,0,0,0,0,0,0,0,0,-39000,0,0,0,0,39000,-39000,-39000
055926,國巨群益98購06  ,0,0,0,0,0,0,0,0,0,-39000,0,0,0,0,39000,-39000,-39000
056002,嘉晶永豐97購01  ,0,0,0,0,0,0,0,0,0,-39000,0,0,0,26000,65000,-39000,-39000
055014,達興元富97購01  ,0,0,0,0,0,0,0,0,0,-39000,0,0,0,11000,50000,-39000,-39000
057038,元油2X元大9B購06,0,0,0,0,0,0,0,0,0,-39000,0,0,0,0,39000,-39000,-39000
055178,晶豪科統一97購01,0,0,0,0,0,0,0,0,0,-39000,0,0,0,0,39000,-39000,-39000
057169,微星元大98購01  ,0,0,0,0,0,0,0,0,0,-39000,0,0,0,18000,57000,-39000,-39000
058018,南亞科凱基99購03,0,0,0,0,0,0,0,0,0,-39000,0,0,0,1000,40000,-39000,-39000
059377,台積電群益99購09,0,0,0,0,0,0,0,0,0,-39000,0,0,0,21000,60000,-39000,-39000
057947,和碩國票99購01  ,0,0,0,0,0,0,0,0,0,-39000,0,0,0,0,39000,-39000,-39000
058996,台達電元大99購02,0,0,0,0,0,0,0,0,0,-39000,0,0,0,100000,139000,-39000,-39000
057444,台泥元富98購01  ,0,0,0,0,0,0,0,0,0,-39000,0,0,0,92000,131000,-39000,-39000
07373P,A50正2元大99售01,0,0,0,0,0,0,0,0,0,-39000,0,0,0,1000,40000,-39000,-39000
060755,鴻海元大9A購15  ,0,0,0,0,0,0,0,0,0,-39000,0,0,0,11000,50000,-39000,-39000
063029,喬山凱基9B購01  ,0,0,0,0,0,0,0,0,0,-40000,0,0,0,10000,50000,-40000,-40000
063351,億豐統一9B購01  ,0,0,0,0,0,0,0,0,0,-40000,0,0,0,0,40000,-40000,-40000
063171,光寶科中信9B購01,0,0,0,0,0,0,0,0,0,-40000,0,0,0,0,40000,-40000,-40000
063231,台泥元大9B購01  ,0,0,0,0,0,0,0,0,0,-40000,0,0,0,131000,171000,-40000,-40000
06728P,全新元大98售03  ,0,0,0,0,0,0,0,0,0,-40000,0,0,0,60000,100000,-40000,-40000
063641,泰鼎元大9B購04  ,0,0,0,0,0,0,0,0,0,-40000,0,0,0,0,40000,-40000,-40000
063488,金像電國泰01購01,0,0,0,0,0,0,0,0,0,-40000,0,0,0,20000,60000,-40000,-40000
062118,華新科中信9B購02,0,0,0,0,0,0,0,0,0,-40000,0,0,0,0,40000,-40000,-40000
061928,群創凱基9B購06  ,0,0,0,0,0,0,0,0,0,-40000,0,0,0,0,40000,-40000,-40000
061964,台積電統一01購05,0,0,0,0,0,0,0,0,0,-40000,0,0,0,4000,44000,-40000,-40000
062039,聯發科凱基9B購07,0,0,0,0,0,0,0,0,0,-40000,0,0,0,10000,50000,-40000,-40000
061458,臻鼎凱基9A購02  ,0,0,0,0,0,0,0,0,0,-40000,0,0,0,11000,51000,-40000,-40000
061643,嘉澤元大9A購05  ,0,0,0,0,0,0,0,0,0,-40000,0,0,0,10000,50000,-40000,-40000
055025,華新科國泰98購02,0,0,0,0,0,0,0,0,0,-40000,0,0,0,48000,88000,-40000,-40000
055713,國巨元大98購09  ,0,0,0,0,0,0,0,0,0,-40000,0,0,0,24000,64000,-40000,-40000
054753,復盛凱基98購01  ,0,0,0,0,0,0,0,0,0,-40000,0,0,0,33000,73000,-40000,-40000
060202,康友元富9A購01  ,0,0,0,0,0,0,0,0,0,-40000,0,0,0,0,40000,-40000,-40000
060064,華新科兆豐99購07,0,0,0,0,0,0,0,0,0,-40000,0,0,0,0,40000,-40000,-40000
060235,瑞昱元大9A購01  ,0,0,0,0,0,0,0,0,0,-40000,0,0,0,153000,193000,-40000,-40000
056928,旺宏台新98購01  ,0,0,0,0,0,0,0,0,0,-40000,0,0,0,0,40000,-40000,-40000
053259,卜蜂群益97購01  ,0,0,0,0,0,0,0,0,0,-40000,0,0,0,0,40000,-40000,-40000
053568,智伸科富邦98購01,0,0,0,0,0,0,0,0,0,-40000,0,0,0,0,40000,-40000,-40000
054351,華新科國泰97購03,0,0,0,0,0,0,0,0,0,-40000,0,0,0,12000,52000,-40000,-40000
050283,T50反1凱基9A購01,0,0,0,0,0,0,0,0,0,-40000,0,0,0,0,40000,-40000,-40000
00753L,中信中國50正2   ,344000,179000,165000,0,0,0,0,0,0,-205000,0,0,0,694000,899000,-205000,-40000
057419,奇力新凱基98購06,0,0,0,0,0,0,0,0,0,-40000,0,0,0,0,40000,-40000,-40000
057395,旺宏中信98購03  ,0,0,0,0,0,0,0,0,0,-40000,0,0,0,100000,140000,-40000,-40000
057508,康控國票99購03  ,0,0,0,0,0,0,0,0,0,-40000,0,0,0,0,40000,-40000,-40000
060161,牧德永豐9A購02  ,0,0,0,0,0,0,0,0,0,-40000,0,0,0,10000,50000,-40000,-40000
058557,健策第一01購01  ,0,0,0,0,0,0,0,0,0,-40000,0,0,0,0,40000,-40000,-40000
060055,宏達電凱基99購06,0,0,0,0,0,0,0,0,0,-40000,0,0,0,8000,48000,-40000,-40000
059689,南亞科永豐99購02,0,0,0,0,0,0,0,0,0,-40000,0,0,0,0,40000,-40000,-40000
059702,台積電凱基9A購14,0,0,0,0,0,0,0,0,0,-40000,0,0,0,11000,51000,-40000,-40000
059524,FBVIX凱基9A購02 ,0,0,0,0,0,0,0,0,0,-40000,0,0,0,20000,60000,-40000,-40000
057944,新日興國票99購02,0,0,0,0,0,0,0,0,0,-40000,0,0,0,0,40000,-40000,-40000
059064,緯穎凱基99購02  ,0,0,0,0,0,0,0,0,0,-40000,0,0,0,38000,78000,-40000,-40000
059062,群創凱基99購05  ,0,0,0,0,0,0,0,0,0,-40000,0,0,0,0,40000,-40000,-40000
059115,美食永豐99購01  ,0,0,0,0,0,0,0,0,0,-40000,0,0,0,10000,50000,-40000,-40000
058173,台積電凱基99購04,0,0,0,0,0,0,0,0,0,-40000,0,0,0,0,40000,-40000,-40000
058019,美律凱基99購04  ,0,0,0,0,0,0,0,0,0,-40000,0,0,0,10000,50000,-40000,-40000
061070,超眾凱基9C購01  ,0,0,0,0,0,0,0,0,0,-40000,0,0,0,78000,118000,-40000,-40000
061023,茂林國泰9B購02  ,0,0,0,0,0,0,0,0,0,-40000,0,0,0,4000,44000,-40000,-40000
061254,道瓊反凱基9A購02,0,0,0,0,0,0,0,0,0,-40000,0,0,0,0,40000,-40000,-40000
060847,康控國票9A購01  ,0,0,0,0,0,0,0,0,0,-40000,0,0,0,9000,49000,-40000,-40000
060814,健策凱基9B購01  ,0,0,0,0,0,0,0,0,0,-40000,0,0,0,6000,46000,-40000,-40000
060979,國巨元大9A購14  ,0,0,0,0,0,0,0,0,0,-40000,0,0,0,10000,50000,-40000,-40000
4572,駐龍            ,12000,52000,-40000,0,0,0,0,0,0,0,0,0,0,0,0,0,-40000
4994,傳奇            ,9000,51000,-42000,0,0,0,0,0,0,2000,0,0,0,2000,0,2000,-40000
07309P,聯發科凱基99售18,0,0,0,0,0,0,0,0,0,-40000,0,0,0,0,40000,-40000,-40000
08006P,長榮航中信03售01,0,0,0,0,0,0,0,0,0,-40000,0,0,0,60000,100000,-40000,-40000
08109P,台灣50台新9C售04,0,0,0,0,0,0,0,0,0,-40000,0,0,0,10000,50000,-40000,-40000
07740P,臺股指永豐9A售01,0,0,0,0,0,0,0,0,0,-40000,0,0,0,0,40000,-40000,-40000
08165P,台表科永豐9B售02,0,0,0,0,0,0,0,0,0,-40000,0,0,0,0,40000,-40000,-40000
062332,大立光統一9B購11,0,0,0,0,0,0,0,0,0,-41000,0,0,0,202000,243000,-41000,-41000
062633,亞光國票9B購01  ,0,0,0,0,0,0,0,0,0,-41000,0,0,0,0,41000,-41000,-41000
06270P,致伸凱基97售03  ,0,0,0,0,0,0,0,0,0,-41000,0,0,0,0,41000,-41000,-41000
063499,金像電永豐9B購03,0,0,0,0,0,0,0,0,0,-41000,0,0,0,0,41000,-41000,-41000
06862P,大立光凱基98售16,0,0,0,0,0,0,0,0,0,-41000,0,0,0,8000,49000,-41000,-41000
063126,TPK元大9B購01   ,0,0,0,0,0,0,0,0,0,-41000,0,0,0,8000,49000,-41000,-41000
054370,台積電中信9A購01,0,0,0,0,0,0,0,0,0,-41000,0,0,0,0,41000,-41000,-41000
054463,瑞昱凱基97購01  ,0,0,0,0,0,0,0,0,0,-41000,0,0,0,0,41000,-41000,-41000
055839,瑞昱元大97購04  ,0,0,0,0,0,0,0,0,0,-41000,0,0,0,15000,56000,-41000,-41000
056677,智伸科元富98購01,0,0,0,0,0,0,0,0,0,-41000,0,0,0,135000,176000,-41000,-41000
054807,台化元大9A購02  ,0,0,0,0,0,0,0,0,0,-41000,0,0,0,0,41000,-41000,-41000
055701,亞德客富邦99購01,0,0,0,0,0,0,0,0,0,-41000,0,0,0,2000,43000,-41000,-41000
059113,群光永豐99購01  ,0,0,0,0,0,0,0,0,0,-41000,0,0,0,22000,63000,-41000,-41000
057712,南亞科統一9A購01,0,0,0,0,0,0,0,0,0,-41000,0,0,0,38000,79000,-41000,-41000
060408,和潤國泰9C購01  ,0,0,0,0,0,0,0,0,0,-41000,0,0,0,28000,69000,-41000,-41000
057267,康控兆豐99購01  ,0,0,0,0,0,0,0,0,0,-41000,0,0,0,0,41000,-41000,-41000
058720,旭富元富99購01  ,0,0,0,0,0,0,0,0,0,-41000,0,0,0,0,41000,-41000,-41000
08145P,台灣50群益9B售11,0,0,0,0,0,0,0,0,0,-41000,0,0,0,1000,42000,-41000,-41000
060983,南亞科元大9A購06,0,0,0,0,0,0,0,0,0,-41000,0,0,0,46000,87000,-41000,-41000
8404,百和興業-KY     ,75000,116000,-41000,0,0,0,0,0,0,0,0,0,0,0,0,0,-41000
060906,旺宏元大9A購07  ,0,0,0,0,0,0,0,0,0,-41000,0,0,0,21000,62000,-41000,-41000
063202,南亞科統一9C購02,0,0,0,0,0,0,0,0,0,-42000,0,0,0,0,42000,-42000,-42000
06864P,健策凱基98售01  ,0,0,0,0,0,0,0,0,0,-42000,0,0,0,58000,100000,-42000,-42000
07011P,宏達電凱基99售02,0,0,0,0,0,0,0,0,0,-42000,0,0,0,82000,124000,-42000,-42000
063491,國巨富邦02購02  ,0,0,0,0,0,0,0,0,0,-42000,0,0,0,0,42000,-42000,-42000
061561,義隆國票9A購02  ,0,0,0,0,0,0,0,0,0,-42000,0,0,0,39000,81000,-42000,-42000
061457,TPK凱基9A購01   ,0,0,0,0,0,0,0,0,0,-42000,0,0,0,64000,106000,-42000,-42000
061435,元金2X凱基9C購03,0,0,0,0,0,0,0,0,0,-42000,0,0,0,8000,50000,-42000,-42000
061482,健策元大9C購01  ,0,0,0,0,0,0,0,0,0,-42000,0,0,0,12000,54000,-42000,-42000
062056,國巨統一9C購08  ,0,0,0,0,0,0,0,0,0,-42000,0,0,0,0,42000,-42000,-42000
061972,華新元大9B購01  ,0,0,0,0,0,0,0,0,0,-42000,0,0,0,61000,103000,-42000,-42000
057053,立積元大98購02  ,0,0,0,0,0,0,0,0,0,-42000,0,0,0,68000,110000,-42000,-42000
056775,康控元大99購01  ,0,0,0,0,0,0,0,0,0,-42000,0,0,0,0,42000,-42000,-42000
056523,光寶科中信98購01,0,0,0,0,0,0,0,0,0,-42000,0,0,0,73000,115000,-42000,-42000
056496,康控國泰99購01  ,0,0,0,0,0,0,0,0,0,-42000,0,0,0,0,42000,-42000,-42000
055858,聯茂元大97購03  ,0,0,0,0,0,0,0,0,0,-42000,0,0,0,84000,126000,-42000,-42000
054411,光磊元大97購02  ,0,0,0,0,0,0,0,0,0,-42000,0,0,0,126000,168000,-42000,-42000
054258,牧德元大97購01  ,0,0,0,0,0,0,0,0,0,-42000,0,0,0,15000,57000,-42000,-42000
057364,國巨元大98購18  ,0,0,0,0,0,0,0,0,0,-42000,0,0,0,0,42000,-42000,-42000
057957,嘉晶元大98購01  ,0,0,0,0,0,0,0,0,0,-42000,0,0,0,10000,52000,-42000,-42000
059297,大立光元富9C購01,0,0,0,0,0,0,0,0,0,-42000,0,0,0,529000,571000,-42000,-42000
061010,上銀麥證9A購02  ,0,0,0,0,42000,-42000,0,0,0,-42000,0,0,0,0,42000,-42000,-42000
07739P,緯穎永豐9A售01  ,0,0,0,0,0,0,0,0,0,-42000,0,0,0,28000,70000,-42000,-42000
07414P,台積電元大99售51,0,0,0,0,0,0,0,0,0,-42000,0,0,0,0,42000,-42000,-42000
07184P,台灣50元富01售01,0,0,0,0,0,0,0,0,0,-42000,0,0,0,0,42000,-42000,-42000
061908,台積電中信05購01,0,0,0,0,0,0,0,0,0,-43000,0,0,0,78000,121000,-43000,-43000
061405,亞德客國票9B購01,0,0,0,0,0,0,0,0,0,-43000,0,0,0,1000,44000,-43000,-43000
062446,聯詠元大9B購02  ,0,0,0,0,0,0,0,0,0,-43000,0,0,0,35000,78000,-43000,-43000
062387,健策國泰01購01  ,0,0,0,0,0,0,0,0,0,-43000,0,0,0,48000,91000,-43000,-43000
063624,GIS兆豐9B購01   ,0,0,0,0,0,0,0,0,0,-43000,0,0,0,0,43000,-43000,-43000
063057,祥碩統一03購01  ,0,0,0,0,0,0,0,0,0,-43000,0,0,0,33000,76000,-43000,-43000
062800,奇力新統一01購02,0,0,0,0,0,0,0,0,0,-43000,0,0,0,2000,45000,-43000,-43000
054408,義隆國票98購01  ,0,0,0,0,0,0,0,0,0,-43000,0,0,0,49000,92000,-43000,-43000
054717,亞德客永豐97購01,0,0,0,0,0,0,0,0,0,-43000,0,0,0,10000,53000,-43000,-43000
059831,聯詠康和99購01  ,0,0,0,0,0,0,0,0,0,-43000,0,0,0,0,43000,-43000,-43000
060281,卜蜂元大9C購01  ,0,0,0,0,0,0,0,0,0,-43000,0,0,0,8000,51000,-43000,-43000
057367,技嘉元大98購02  ,0,0,0,0,0,0,0,0,0,-43000,0,0,0,4000,47000,-43000,-43000
060543,鴻海凱基9B購02  ,0,0,0,0,0,0,0,0,0,-43000,0,0,0,0,43000,-43000,-43000
057876,隆達元大98購01  ,0,0,0,0,0,0,0,0,0,-43000,0,0,0,10000,53000,-43000,-43000
059991,超眾元大9A購02  ,0,0,0,0,0,0,0,0,0,-43000,0,0,0,57000,100000,-43000,-43000
059510,華新科永豐99購07,0,0,0,0,0,0,0,0,0,-43000,0,0,0,9000,52000,-43000,-43000
05943P,欣興凱基96售03  ,0,0,0,0,0,0,0,0,0,-43000,0,0,0,0,43000,-43000,-43000
1612,宏泰            ,0,43000,-43000,0,0,0,0,0,0,0,0,0,0,0,0,0,-43000
060956,超眾群益9A購01  ,0,0,0,0,0,0,0,0,0,-43000,0,0,0,3000,46000,-43000,-43000
060760,南亞科元大9A購04,0,0,0,0,0,0,0,0,0,-43000,0,0,0,25000,68000,-43000,-43000
6226,光鼎            ,61000,104000,-43000,0,0,0,0,0,0,0,0,0,0,0,0,0,-43000
062936,鴻海凱基9B購07  ,0,0,0,0,0,0,0,0,0,-44000,0,0,0,0,44000,-44000,-44000
063295,京元電麥證9B購01,0,0,0,0,44000,-44000,0,0,0,-44000,0,0,0,0,44000,-44000,-44000
063556,儒鴻元大9B購02  ,0,0,0,0,0,0,0,0,0,-44000,0,0,0,22000,66000,-44000,-44000
062568,緯穎中信9C購01  ,0,0,0,0,0,0,0,0,0,-44000,0,0,0,95000,139000,-44000,-44000
061704,景碩國票9A購01  ,0,0,0,0,0,0,0,0,0,-44000,0,0,0,0,44000,-44000,-44000
061694,玉山金群益9A購01,0,0,0,0,0,0,0,0,0,-44000,0,0,0,54000,98000,-44000,-44000
060091,技嘉元大99購03  ,0,0,0,0,0,0,0,0,0,-44000,0,0,0,20000,64000,-44000,-44000
059939,技嘉永豐99購01  ,0,0,0,0,0,0,0,0,0,-44000,0,0,0,0,44000,-44000,-44000
056566,臻鼎群益98購01  ,0,0,0,0,0,0,0,0,0,-44000,0,0,0,0,44000,-44000,-44000
054053,聯茂元大96購01  ,0,0,0,0,0,0,0,0,0,-44000,0,0,0,6000,50000,-44000,-44000
053350,台表科國票97購02,0,0,0,0,0,0,0,0,0,-44000,0,0,0,0,44000,-44000,-44000
056947,國巨統一9A購01  ,0,0,0,0,0,0,0,0,0,-44000,0,0,0,0,44000,-44000,-44000
056818,正崴永豐98購01  ,0,0,0,0,0,0,0,0,0,-44000,0,0,0,0,44000,-44000,-44000
059511,宏達電永豐99購02,0,0,0,0,0,0,0,0,0,-44000,0,0,0,7000,51000,-44000,-44000
059999,緯穎元富99購01  ,0,0,0,0,0,0,0,0,0,-44000,0,0,0,30000,74000,-44000,-44000
058187,泰碩永豐99購01  ,0,0,0,0,0,0,0,0,0,-44000,0,0,0,0,44000,-44000,-44000
057407,超眾群益99購01  ,0,0,0,0,0,0,0,0,0,-44000,0,0,0,96000,140000,-44000,-44000
058293,光寶科凱基9A購01,0,0,0,0,0,0,0,0,0,-44000,0,0,0,18000,62000,-44000,-44000
060644,泰鼎永豐9A購02  ,0,0,0,0,0,0,0,0,0,-44000,0,0,0,26000,70000,-44000,-44000
6605,帝寶            ,2000,46000,-44000,0,0,0,0,0,0,0,0,0,0,0,0,0,-44000
060824,旺宏元大9A購06  ,0,0,0,0,0,0,0,0,0,-44000,0,0,0,56000,100000,-44000,-44000
1452,宏益            ,0,44000,-44000,0,0,0,0,0,0,0,0,0,0,0,0,0,-44000
062050,亞德客統一9C購01,0,0,0,0,0,0,0,0,0,-45000,0,0,0,195000,240000,-45000,-45000
062015,喬山永豐9B購01  ,0,0,0,0,0,0,0,0,0,-45000,0,0,0,0,45000,-45000,-45000
06445P,大立光凱基98售09,0,0,0,0,0,0,0,0,0,-45000,0,0,0,5000,50000,-45000,-45000
063437,聚陽統一01購01  ,0,0,0,0,0,0,0,0,0,-45000,0,0,0,25000,70000,-45000,-45000
063066,同欣電麥證9B購01,0,0,0,40000,85000,-45000,0,0,0,-45000,0,0,0,40000,85000,-45000,-45000
053254,群創國泰98購02  ,0,0,0,0,0,0,0,0,0,-45000,0,0,0,0,45000,-45000,-45000
053506,南茂兆豐97購01  ,0,0,0,0,0,0,0,0,0,-45000,0,0,0,0,45000,-45000,-45000
054439,健策台新96購03  ,0,0,0,0,0,0,0,0,0,-45000,0,0,0,8000,53000,-45000,-45000
00717,富邦美國特別股  ,0,0,0,0,0,0,0,0,0,-45000,0,0,0,483000,528000,-45000,-45000
056689,玉晶光統一9A購03,0,0,0,0,0,0,0,0,0,-45000,0,0,0,1000,46000,-45000,-45000
054758,南亞國票9A購01  ,0,0,0,0,0,0,0,0,0,-45000,0,0,0,20000,65000,-45000,-45000
056962,技嘉永豐98購01  ,0,0,0,0,0,0,0,0,0,-45000,0,0,0,5000,50000,-45000,-45000
058462,台積電兆豐99購01,0,0,0,0,0,0,0,0,0,-45000,0,0,0,100000,145000,-45000,-45000
058839,瑞儀中信99購02  ,0,0,0,0,0,0,0,0,0,-45000,0,0,0,10000,55000,-45000,-45000
059349,台郡凱基99購04  ,0,0,0,0,0,0,0,0,0,-45000,0,0,0,10000,55000,-45000,-45000
057218,可成群益99購03  ,0,0,0,0,0,0,0,0,0,-45000,0,0,0,0,45000,-45000,-45000
060286,佳世達元大9C購01,0,0,0,0,0,0,0,0,0,-45000,0,0,0,5000,50000,-45000,-45000
07265P,大立光元大99售16,0,0,0,0,0,0,0,0,0,-45000,0,0,0,5000,50000,-45000,-45000
07667P,亞德客元大9A售05,0,0,0,0,0,0,0,0,0,-45000,0,0,0,310000,355000,-45000,-45000
07875P,祥碩群益9B售01  ,0,0,0,0,0,0,0,0,0,-45000,0,0,0,5000,50000,-45000,-45000
08061P,大毅國票9B售04  ,0,0,0,0,0,0,0,0,0,-45000,0,0,0,23000,68000,-45000,-45000
060737,瑞儀統一9C購01  ,0,0,0,0,0,0,0,0,0,-45000,0,0,0,18000,63000,-45000,-45000
6206,飛捷            ,10000,55000,-45000,0,0,0,0,0,0,0,0,0,0,0,0,0,-45000
062796,技嘉統一9C購01  ,0,0,0,0,0,0,0,0,0,-46000,0,0,0,2000,48000,-46000,-46000
062458,全新群益9B購03  ,0,0,0,0,0,0,0,0,0,-46000,0,0,0,0,46000,-46000,-46000
062406,臻鼎永豐9B購01  ,0,0,0,0,0,0,0,0,0,-46000,0,0,0,64000,110000,-46000,-46000
062227,南六統一01購02  ,0,0,0,0,0,0,0,0,0,-46000,0,0,0,1000,47000,-46000,-46000
055618,麗豐國票98購01  ,0,0,0,0,0,0,0,0,0,-46000,0,0,0,28000,74000,-46000,-46000
056228,可成凱基97購03  ,0,0,0,0,0,0,0,0,0,-46000,0,0,0,2000,48000,-46000,-46000
047410,上銀元富96購01  ,0,0,0,0,0,0,0,0,0,-46000,0,0,0,24000,70000,-46000,-46000
05466P,旺宏富邦97售01  ,0,0,0,0,0,0,0,0,0,-46000,0,0,0,14000,60000,-46000,-46000
055848,大立光元大97購11,0,0,0,0,0,0,0,0,0,-46000,0,0,0,0,46000,-46000,-46000
060480,億豐元大9A購02  ,0,0,0,0,0,0,0,0,0,-46000,0,0,0,0,46000,-46000,-46000
060484,聯發科富邦9C購02,0,0,0,0,0,0,0,0,0,-46000,0,0,0,1000,47000,-46000,-46000
061204,國巨元大9A購16  ,0,0,0,0,0,0,0,0,0,-46000,0,0,0,4000,50000,-46000,-46000
059341,台積電凱基99購15,0,0,0,0,0,0,0,0,0,-46000,0,0,0,39000,85000,-46000,-46000
058294,華新科凱基9A購01,0,0,0,0,0,0,0,0,0,-46000,0,0,0,34000,80000,-46000,-46000
4942,嘉彰            ,27000,73000,-46000,0,0,0,0,0,0,0,0,0,0,0,0,0,-46000
4555,氣立            ,33000,35000,-2000,0,0,0,0,0,0,-44000,14000,58000,-44000,0,0,0,-46000
08089P,嘉澤凱基9B售03  ,0,0,0,0,0,0,0,0,0,-46000,0,0,0,153000,199000,-46000,-46000
062540,茂林國泰9C購01  ,0,0,0,0,0,0,0,0,0,-47000,0,0,0,216000,263000,-47000,-47000
061465,聯詠群益9A購01  ,0,0,0,0,0,0,0,0,0,-47000,0,0,0,22000,69000,-47000,-47000
056635,亞德客日盛99購01,0,0,0,0,0,0,0,0,0,-47000,0,0,0,10000,57000,-47000,-47000
056410,康控國票99購01  ,0,0,0,0,0,0,0,0,0,-47000,0,0,0,38000,85000,-47000,-47000
059003,中壽元大99購01  ,0,0,0,0,0,0,0,0,0,-47000,0,0,0,22000,69000,-47000,-47000
06120P,大立光凱基98售05,0,0,0,0,0,0,0,0,0,-47000,0,0,0,0,47000,-47000,-47000
057482,微星元大98購03  ,0,0,0,0,0,0,0,0,0,-47000,0,0,0,0,47000,-47000,-47000
057744,健策永豐98購02  ,0,0,0,0,0,0,0,0,0,-47000,0,0,0,3000,50000,-47000,-47000
061966,旺宏統一01購03  ,0,0,0,0,0,0,0,0,0,-48000,0,0,0,0,48000,-48000,-48000
061849,國巨國票9B購08  ,0,0,0,0,0,0,0,0,0,-48000,0,0,0,0,48000,-48000,-48000
062820,禾伸堂兆豐9B購01,0,0,0,0,0,0,0,0,0,-48000,0,0,0,122000,170000,-48000,-48000
059886,可成國票99購04  ,0,0,0,0,0,0,0,0,0,-48000,0,0,0,3000,51000,-48000,-48000
056091,百和統一97購01  ,0,0,0,0,0,0,0,0,0,-48000,0,0,0,0,48000,-48000,-48000
054880,華泰統一97購01  ,0,0,0,0,0,0,0,0,0,-48000,0,0,0,0,48000,-48000,-48000
053056,同欣電國票97購01,0,0,0,0,0,0,0,0,0,-48000,0,0,0,30000,78000,-48000,-48000
053453,新光金統一98購01,0,0,0,0,0,0,0,0,0,-48000,0,0,0,0,48000,-48000,-48000
052795,健策兆豐97購01  ,0,0,0,0,0,0,0,0,0,-48000,0,0,0,10000,58000,-48000,-48000
058571,緯穎凱基9A購02  ,0,0,0,0,0,0,0,0,0,-48000,0,0,0,10000,58000,-48000,-48000
060395,儒鴻國票9A購01  ,0,0,0,0,0,0,0,0,0,-48000,0,0,0,0,48000,-48000,-48000
057404,貿聯群益99購01  ,0,0,0,0,0,0,0,0,0,-48000,0,0,0,280000,328000,-48000,-48000
061281,台積電統一9C購05,0,0,0,0,0,0,0,0,0,-48000,0,0,0,0,48000,-48000,-48000
061347,創意元大9A購02  ,0,0,0,0,0,0,0,0,0,-48000,0,0,0,295000,343000,-48000,-48000
061048,國巨中信9A購05  ,0,0,0,0,0,0,0,0,0,-48000,0,0,0,0,48000,-48000,-48000
057232,京元電凱基98購02,0,0,0,0,0,0,0,0,0,-48000,0,0,0,0,48000,-48000,-48000
058008,禾伸堂國票99購02,0,0,0,0,0,0,0,0,0,-48000,0,0,0,10000,58000,-48000,-48000
058811,台積電統一9A購05,0,0,0,0,0,0,0,0,0,-48000,0,0,0,0,48000,-48000,-48000
058792,鴻海元大99購18  ,0,0,0,0,0,0,0,0,0,-48000,0,0,0,2000,50000,-48000,-48000
1702,南僑            ,20000,68000,-48000,0,0,0,0,0,0,0,0,0,0,0,0,0,-48000
060738,矽格統一9C購01  ,0,0,0,0,0,0,0,0,0,-48000,0,0,0,0,48000,-48000,-48000
063365,義隆富邦01購01  ,0,0,0,0,0,0,0,0,0,-49000,0,0,0,0,49000,-49000,-49000
062635,創意國票9B購01  ,0,0,0,0,0,0,0,0,0,-49000,0,0,0,64000,113000,-49000,-49000
062603,台化凱基9B購01  ,0,0,0,0,0,0,0,0,0,-49000,0,0,0,0,49000,-49000,-49000
062110,華擎國票9B購01  ,0,0,0,0,0,0,0,0,0,-49000,0,0,0,8000,57000,-49000,-49000
062074,旺宏元大9B購04  ,0,0,0,0,0,0,0,0,0,-49000,0,0,0,1000,50000,-49000,-49000
054673,京鼎國泰98購01  ,0,0,0,0,0,0,0,0,0,-49000,0,0,0,0,49000,-49000,-49000
051630,力山國票96購01  ,0,0,0,0,0,0,0,0,0,-49000,0,0,0,0,49000,-49000,-49000
00647L,元大S&P500正2   ,24000,24000,0,0,0,0,0,0,0,-49000,0,0,0,143000,192000,-49000,-49000
057120,茂林康和98購01  ,0,0,0,0,0,0,0,0,0,-49000,0,0,0,94000,143000,-49000,-49000
055398,超眾統一97購03  ,0,0,0,0,0,0,0,0,0,-49000,0,0,0,43000,92000,-49000,-49000
055383,GIS元大97購02   ,0,0,0,0,0,0,0,0,0,-49000,0,0,0,0,49000,-49000,-49000
056584,鴻海統一9B購01  ,0,0,0,0,0,0,0,0,0,-49000,0,0,0,869000,918000,-49000,-49000
057959,欣興元大98購14  ,0,0,0,0,0,0,0,0,0,-49000,0,0,0,23000,72000,-49000,-49000
059272,台灣50元大99購01,0,0,0,0,0,0,0,0,0,-49000,0,0,0,0,49000,-49000,-49000
061207,美律元大9A購04  ,0,0,0,0,0,0,0,0,0,-49000,0,0,0,19000,68000,-49000,-49000
057837,康控國泰99購02  ,0,0,0,0,0,0,0,0,0,-49000,0,0,0,0,49000,-49000,-49000
059480,美律群益9A購01  ,0,0,0,0,0,0,0,0,0,-49000,0,0,0,6000,55000,-49000,-49000
060841,宏達電國票9B購01,0,0,0,0,0,0,0,0,0,-49000,0,0,0,140000,189000,-49000,-49000
2380,虹光            ,1000,50000,-49000,0,0,0,0,0,0,0,0,0,0,0,0,0,-49000
07575P,瑞昱元大9A售02  ,0,0,0,0,0,0,0,0,0,-49000,0,0,0,6000,55000,-49000,-49000
062124,大立光統一9B購09,0,0,0,0,0,0,0,0,0,-50000,0,0,0,0,50000,-50000,-50000
062372,旭富元大9B購01  ,0,0,0,0,0,0,0,0,0,-50000,0,0,0,0,50000,-50000,-50000
062262,茂林元大9B購02  ,0,0,0,0,0,0,0,0,0,-50000,0,0,0,15000,65000,-50000,-50000
062445,大立光元大9C購02,0,0,0,0,0,0,0,0,0,-50000,0,0,0,0,50000,-50000,-50000
061850,國巨國票9C購02  ,0,0,0,0,0,0,0,0,0,-50000,0,0,0,0,50000,-50000,-50000
06189P,華新科永豐97售03,0,0,0,0,0,0,0,0,0,-50000,0,0,0,0,50000,-50000,-50000
061805,華新科中信9B購01,0,0,0,0,0,0,0,0,0,-50000,0,0,0,0,50000,-50000,-50000
061766,華新科元大9B購02,0,0,0,0,0,0,0,0,0,-50000,0,0,0,0,50000,-50000,-50000
062011,上銀富邦9C購01  ,0,0,0,0,0,0,0,0,0,-50000,0,0,0,10000,60000,-50000,-50000
061425,華新科元大9A購19,0,0,0,0,0,0,0,0,0,-50000,0,0,0,0,50000,-50000,-50000
061576,華新科元大9A購21,0,0,0,0,0,0,0,0,0,-50000,0,0,0,0,50000,-50000,-50000
061580,華擎元大9A購06  ,0,0,0,0,0,0,0,0,0,-50000,0,0,0,50000,100000,-50000,-50000
063431,神隆元富9B購01  ,0,0,0,0,0,0,0,0,0,-50000,0,0,0,0,50000,-50000,-50000
063240,聯發科元大9B購17,0,0,0,0,0,0,0,0,0,-50000,0,0,0,2000,52000,-50000,-50000
062901,台積電元大9B購05,0,0,0,0,0,0,0,0,0,-50000,0,0,0,0,50000,-50000,-50000
062899,鴻海元大9C購04  ,0,0,0,0,0,0,0,0,0,-50000,0,0,0,0,50000,-50000,-50000
063083,聯發科凱基01購02,0,0,0,0,0,0,0,0,0,-50000,0,0,0,0,50000,-50000,-50000
063088,緯穎凱基9B購04  ,0,0,0,0,0,0,0,0,0,-50000,0,0,0,72000,122000,-50000,-50000
063514,南電麥證9C購01  ,0,0,0,0,50000,-50000,0,0,0,-50000,0,0,0,0,50000,-50000,-50000
056567,瀚宇博群益98購02,0,0,0,0,0,0,0,0,0,-50000,0,0,0,94000,144000,-50000,-50000
056686,可成統一98購01  ,0,0,0,0,0,0,0,0,0,-50000,0,0,0,50000,100000,-50000,-50000
056738,國巨凱基9A購02  ,0,0,0,0,0,0,0,0,0,-50000,0,0,0,11000,61000,-50000,-50000
056713,華擎永豐98購01  ,0,0,0,0,0,0,0,0,0,-50000,0,0,0,0,50000,-50000,-50000
059778,上証2X元大9C購03,0,0,0,0,0,0,0,0,0,-50000,0,0,0,0,50000,-50000,-50000
055243,國巨統一97購04  ,0,0,0,0,0,0,0,0,0,-50000,0,0,0,1046000,1096000,-50000,-50000
05519P,上証2X凱基98售01,0,0,0,0,0,0,0,0,0,-50000,0,0,0,0,50000,-50000,-50000
055466,台達電凱基97購03,0,0,0,0,0,0,0,0,0,-50000,0,0,0,0,50000,-50000,-50000
055583,國巨元大97購10  ,0,0,0,0,0,0,0,0,0,-50000,0,0,0,75000,125000,-50000,-50000
055490,台光電元大97購01,0,0,0,0,0,0,0,0,0,-50000,0,0,0,0,50000,-50000,-50000
055597,禾伸堂元大98購02,0,0,0,0,0,0,0,0,0,-50000,0,0,0,0,50000,-50000,-50000
057130,全新凱基98購03  ,0,0,0,0,0,0,0,0,0,-50000,0,0,0,0,50000,-50000,-50000
056182,台光電統一97購03,0,0,0,0,0,0,0,0,0,-50000,0,0,0,0,50000,-50000,-50000
054768,泰碩國票99購02  ,0,0,0,0,0,0,0,0,0,-50000,0,0,0,20000,70000,-50000,-50000
056958,喬山永豐98購01  ,0,0,0,0,0,0,0,0,0,-50000,0,0,0,0,50000,-50000,-50000
056984,嘉晶群益98購01  ,0,0,0,0,0,0,0,0,0,-50000,0,0,0,0,50000,-50000,-50000
056988,聚陽兆豐98購01  ,0,0,0,0,0,0,0,0,0,-50000,0,0,0,10000,60000,-50000,-50000
00686R,群益臺灣加權反1 ,0,0,0,0,0,0,0,0,0,-50000,0,0,0,32000,82000,-50000,-50000
00672L,元大S&P原油正2  ,0,0,0,0,0,0,0,0,0,-50000,0,0,0,50000,100000,-50000,-50000
00771,元大US高息特別股,0,0,0,0,0,0,0,0,0,-50000,0,0,0,12000,62000,-50000,-50000
052095,彩晶元大97購01  ,0,0,0,0,0,0,0,0,0,-50000,0,0,0,1000,51000,-50000,-50000
052133,華邦電凱基9B購01,0,0,0,0,0,0,0,0,0,-50000,0,0,0,0,50000,-50000,-50000
046384,群創凱基98購02  ,0,0,0,0,0,0,0,0,0,-50000,0,0,0,0,50000,-50000,-50000
04437P,滬深2X群益98售03,0,0,0,0,0,0,0,0,0,-50000,0,0,0,0,50000,-50000,-50000
054437,欣興台新97購02  ,0,0,0,0,0,0,0,0,0,-50000,0,0,0,0,50000,-50000,-50000
050894,旺宏元大96購03  ,0,0,0,0,0,0,0,0,0,-50000,0,0,0,0,50000,-50000,-50000
049335,聯電統一97購01  ,0,0,0,0,0,0,0,0,0,-50000,0,0,0,0,50000,-50000,-50000
052945,嘉晶國票97購01  ,0,0,0,0,0,0,0,0,0,-50000,0,0,0,0,50000,-50000,-50000
053721,國泰金凱基97購01,0,0,0,0,0,0,0,0,0,-50000,0,0,0,0,50000,-50000,-50000
053751,康控永豐96購02  ,0,0,0,0,0,0,0,0,0,-50000,0,0,0,0,50000,-50000,-50000
053132,國巨國票97購02  ,0,0,0,0,0,0,0,0,0,-50000,0,0,0,0,50000,-50000,-50000
055844,大毅元大98購01  ,0,0,0,0,0,0,0,0,0,-50000,0,0,0,0,50000,-50000,-50000
055822,臺股指國票97購09,0,0,0,0,0,0,0,0,0,-50000,0,0,0,2000,52000,-50000,-50000
055763,鎧勝群益97購01  ,0,0,0,0,0,0,0,0,0,-50000,0,0,0,0,50000,-50000,-50000
059471,華新科元大99購17,0,0,0,0,0,0,0,0,0,-50000,0,0,0,1000,51000,-50000,-50000
059440,康控元大9B購01  ,0,0,0,0,0,0,0,0,0,-50000,0,0,0,45000,95000,-50000,-50000
058598,T50反1元大99購04,0,0,0,0,0,0,0,0,0,-50000,0,0,0,0,50000,-50000,-50000
05861P,瀚宇博永豐96售02,0,0,0,0,0,0,0,0,0,-50000,0,0,0,0,50000,-50000,-50000
058634,可成兆豐99購03  ,0,0,0,0,0,0,0,0,0,-50000,0,0,0,0,50000,-50000,-50000
060341,國巨統一9C購02  ,0,0,0,0,0,0,0,0,0,-50000,0,0,0,0,50000,-50000,-50000
060461,鴻海元大9A購09  ,0,0,0,0,0,0,0,0,0,-50000,0,0,0,0,50000,-50000,-50000
06055P,華通凱基97售04  ,0,0,0,0,0,0,0,0,0,-50000,0,0,0,0,50000,-50000,-50000
057259,台積電兆豐98購03,0,0,0,0,0,0,0,0,0,-50000,0,0,0,189000,239000,-50000,-50000
061167,臻鼎兆豐9B購01  ,0,0,0,0,0,0,0,0,0,-50000,0,0,0,1000,51000,-50000,-50000
061349,嘉澤元大9A購02  ,0,0,0,0,0,0,0,0,0,-50000,0,0,0,4000,54000,-50000,-50000
07798P,同欣電國票9A售01,0,0,0,0,0,0,0,0,0,-50000,0,0,0,0,50000,-50000,-50000
058040,FBVIX元大98購01 ,0,0,0,0,0,0,0,0,0,-50000,0,0,0,0,50000,-50000,-50000
058911,茂林元大99購04  ,0,0,0,0,0,0,0,0,0,-50000,0,0,0,20000,70000,-50000,-50000
059354,臺指反富邦9B購01,0,0,0,0,0,0,0,0,0,-50000,0,0,0,0,50000,-50000,-50000
057958,禾伸堂元大99購05,0,0,0,0,0,0,0,0,0,-50000,0,0,0,0,50000,-50000,-50000
058174,台積電凱基9A購05,0,0,0,0,0,0,0,0,0,-50000,0,0,0,0,50000,-50000,-50000
059085,鴻海元大99購25  ,0,0,0,0,0,0,0,0,0,-50000,0,0,0,4000,54000,-50000,-50000
058342,鴻海群益9A購01  ,0,0,0,0,0,0,0,0,0,-50000,0,0,0,2000,52000,-50000,-50000
07539P,玉山金台新9A售01,0,0,0,0,0,0,0,0,0,-50000,0,0,0,0,50000,-50000,-50000
07169P,臺股指國票99售06,0,0,0,0,0,0,0,0,0,-50000,0,0,0,0,50000,-50000,-50000
07180P,臺股指凱基99售22,0,0,0,0,0,0,0,0,0,-50000,0,0,0,0,50000,-50000,-50000
07356P,臺股指國票99售24,0,0,0,0,0,0,0,0,0,-50000,0,0,0,0,50000,-50000,-50000
08140P,祥碩元大9B售07  ,0,0,0,0,0,0,0,0,0,-50000,0,0,0,0,50000,-50000,-50000
08152P,祥碩統一9B售02  ,0,0,0,0,0,0,0,0,0,-50000,0,0,0,0,50000,-50000,-50000
1108,幸福            ,0,50000,-50000,0,0,0,0,0,0,0,0,0,0,0,0,0,-50000
08663P,台灣50元大96售01,0,0,0,0,0,0,0,0,0,-50000,0,0,0,0,50000,-50000,-50000
08200P,祥碩元大9B售08  ,0,0,0,0,0,0,0,0,0,-50000,0,0,0,0,50000,-50000,-50000
060980,台積電元大9A購21,0,0,0,0,0,0,0,0,0,-50000,0,0,0,1000,51000,-50000,-50000
060988,華新科元大9A購12,0,0,0,0,0,0,0,0,0,-50000,0,0,0,0,50000,-50000,-50000
060617,華新科元大9A購08,0,0,0,0,0,0,0,0,0,-50000,0,0,0,0,50000,-50000,-50000
063500,嘉晶永豐9B購02  ,0,0,0,0,0,0,0,0,0,-51000,0,0,0,0,51000,-51000,-51000
063180,台塑凱基9B購01  ,0,0,0,0,0,0,0,0,0,-51000,0,0,0,0,51000,-51000,-51000
061718,GIS凱基9B購01   ,0,0,0,0,0,0,0,0,0,-51000,0,0,0,621000,672000,-51000,-51000
062630,全新國票9B購02  ,0,0,0,0,0,0,0,0,0,-51000,0,0,0,0,51000,-51000,-51000
055619,同欣電國票98購02,0,0,0,0,0,0,0,0,0,-51000,0,0,0,20000,71000,-51000,-51000
060228,亞德客元大9A購01,0,0,0,0,0,0,0,0,0,-51000,0,0,0,30000,81000,-51000,-51000
058763,和碩群益99購01  ,0,0,0,0,0,0,0,0,0,-51000,0,0,0,299000,350000,-51000,-51000
059685,T50正2永豐99購02,0,0,0,0,0,0,0,0,0,-51000,0,0,0,0,51000,-51000,-51000
057672,茂林元大98購02  ,0,0,0,0,0,0,0,0,0,-51000,0,0,0,0,51000,-51000,-51000
060777,茂林凱基9C購01  ,0,0,0,0,0,0,0,0,0,-51000,0,0,0,19000,70000,-51000,-51000
08177P,金像電元大9B售02,0,0,0,0,0,0,0,0,0,-51000,0,0,0,51000,102000,-51000,-51000
062459,聯詠群益9B購01  ,0,0,0,0,0,0,0,0,0,-52000,0,0,0,0,52000,-52000,-52000
062023,寶成永豐9B購01  ,0,0,0,0,0,0,0,0,0,-52000,0,0,0,22000,74000,-52000,-52000
063103,技嘉群益9B購01  ,0,0,0,0,0,0,0,0,0,-52000,0,0,0,1000,53000,-52000,-52000
062912,新日興元大9B購01,0,0,0,0,0,0,0,0,0,-52000,0,0,0,256000,308000,-52000,-52000
06954P,大立光元富99售01,0,0,0,0,0,0,0,0,0,-52000,0,0,0,93000,145000,-52000,-52000
06701P,臺股指統一99售06,0,0,0,0,0,0,0,0,0,-52000,0,0,0,341000,393000,-52000,-52000
056352,鴻海元大99購01  ,0,0,0,0,0,0,0,0,0,-52000,0,0,0,10000,62000,-52000,-52000
055949,亞德客元大97購04,0,0,0,0,0,0,0,0,0,-52000,0,0,0,1000,53000,-52000,-52000
060404,台勝科國泰9B購01,0,0,0,0,0,0,0,0,0,-52000,0,0,0,30000,82000,-52000,-52000
061269,嘉澤凱基9A購01  ,0,0,0,0,0,0,0,0,0,-52000,0,0,0,12000,64000,-52000,-52000
061244,和碩兆豐9A購01  ,0,0,0,0,0,0,0,0,0,-52000,0,0,0,158000,210000,-52000,-52000
06836P,玉晶光國票99售06,0,0,0,0,0,0,0,0,0,-53000,0,0,0,165000,218000,-53000,-53000
061997,台郡元大9B購03  ,0,0,0,0,0,0,0,0,0,-53000,0,0,0,120000,173000,-53000,-53000
061960,國巨統一01購05  ,0,0,0,0,0,0,0,0,0,-53000,0,0,0,1000,54000,-53000,-53000
062376,中租元大9B購02  ,0,0,0,0,0,0,0,0,0,-53000,0,0,0,46000,99000,-53000,-53000
054201,聯詠富邦97購02  ,0,0,0,0,0,0,0,0,0,-53000,0,0,0,0,53000,-53000,-53000
060084,聯電元大99購02  ,0,0,0,0,0,0,0,0,0,-53000,0,0,0,47000,100000,-53000,-53000
059889,華新科國票99購04,0,0,0,0,0,0,0,0,0,-53000,0,0,0,4000,57000,-53000,-53000
054760,台化國票9A購01  ,0,0,0,0,0,0,0,0,0,-53000,0,0,0,0,53000,-53000,-53000
061341,華新科元大9A購16,0,0,0,0,0,0,0,0,0,-53000,0,0,0,0,53000,-53000,-53000
057202,TPK元富98購02   ,0,0,0,0,0,0,0,0,0,-53000,0,0,0,60000,113000,-53000,-53000
058142,瑞儀元大99購01  ,0,0,0,0,0,0,0,0,0,-53000,0,0,0,28000,81000,-53000,-53000
059215,台積電元大99購28,0,0,0,0,0,0,0,0,0,-53000,0,0,0,0,53000,-53000,-53000
057720,日電貿元富98購01,0,0,0,0,0,0,0,0,0,-53000,0,0,0,98000,151000,-53000,-53000
059536,新光金凱基99購05,0,0,0,0,0,0,0,0,0,-53000,0,0,0,83000,136000,-53000,-53000
057512,華邦電台新98購01,0,0,0,0,0,0,0,0,0,-53000,0,0,0,12000,65000,-53000,-53000
1802,台玻            ,319000,403000,-84000,0,0,0,0,0,0,31000,31000,0,31000,0,0,0,-53000
08118P,嘉澤元富9B售02  ,0,0,0,0,0,0,0,0,0,-53000,0,0,0,204000,257000,-53000,-53000
062043,牧德凱基9B購04  ,0,0,0,0,0,0,0,0,0,-54000,0,0,0,0,54000,-54000,-54000
061634,遠東新元大9A購01,0,0,0,0,0,0,0,0,0,-54000,0,0,0,157000,211000,-54000,-54000
059844,大立光富邦9C購04,0,0,0,0,0,0,0,0,0,-54000,0,0,0,0,54000,-54000,-54000
058581,大立光群益99購05,0,0,0,0,0,0,0,0,0,-54000,0,0,0,0,54000,-54000,-54000
058766,力山兆豐99購01  ,0,0,0,0,0,0,0,0,0,-54000,0,0,0,110000,164000,-54000,-54000
058878,旭富國泰9B購01  ,0,0,0,0,0,0,0,0,0,-54000,0,0,0,10000,64000,-54000,-54000
061387,鴻海群益9A購05  ,0,0,0,0,0,0,0,0,0,-54000,0,0,0,3000,57000,-54000,-54000
061104,華新科元大9A購13,0,0,0,0,0,0,0,0,0,-54000,0,0,0,10000,64000,-54000,-54000
062441,華新科元大9C購01,0,0,0,0,0,0,0,0,0,-55000,0,0,0,0,55000,-55000,-55000
062422,億光統一01購01  ,0,0,0,0,0,0,0,0,0,-55000,0,0,0,25000,80000,-55000,-55000
06876P,台灣50兆豐9B售01,0,0,0,0,0,0,0,0,0,-55000,0,0,0,0,55000,-55000,-55000
059755,宏達電國泰9A購01,0,0,0,0,0,0,0,0,0,-55000,0,0,0,3000,58000,-55000,-55000
054886,大毅統一97購01  ,0,0,0,0,0,0,0,0,0,-55000,0,0,0,0,55000,-55000,-55000
056103,聯發科永豐97購03,0,0,0,0,0,0,0,0,0,-55000,0,0,0,0,55000,-55000,-55000
055336,茂林兆豐98購01  ,0,0,0,0,0,0,0,0,0,-55000,0,0,0,10000,65000,-55000,-55000
055779,國泰金凱基97購02,0,0,0,0,0,0,0,0,0,-55000,0,0,0,34000,89000,-55000,-55000
055816,新日興國票98購01,0,0,0,0,0,0,0,0,0,-55000,0,0,0,53000,108000,-55000,-55000
053959,晶豪科永豐96購02,0,0,0,0,0,0,0,0,0,-55000,0,0,0,0,55000,-55000,-55000
053648,台積電凱基97購04,0,0,0,0,0,0,0,0,0,-55000,0,0,0,0,55000,-55000,-55000
061126,京元電永豐9A購02,0,0,0,0,0,0,0,0,0,-55000,0,0,0,0,55000,-55000,-55000
061191,可成永豐9A購02  ,0,0,0,0,0,0,0,0,0,-55000,0,0,0,10000,65000,-55000,-55000
058081,技嘉群益9A購03  ,0,0,0,0,0,0,0,0,0,-55000,0,0,0,30000,85000,-55000,-55000
059139,全新兆豐9A購01  ,0,0,0,0,0,0,0,0,0,-55000,0,0,0,50000,105000,-55000,-55000
059065,南電凱基9A購01  ,0,0,0,0,0,0,0,0,0,-55000,0,0,0,35000,90000,-55000,-55000
059259,FBVIX中信03購06 ,5000,0,5000,0,0,0,0,0,0,-60000,0,0,0,60000,120000,-60000,-55000
06042P,華新科永豐96售04,0,0,0,0,0,0,0,0,0,-55000,0,0,0,60000,115000,-55000,-55000
057481,技嘉元大98購04  ,0,0,0,0,0,0,0,0,0,-55000,0,0,0,1000,56000,-55000,-55000
05725P,嘉聯益永豐96售02,0,0,0,0,0,0,0,0,0,-55000,0,0,0,0,55000,-55000,-55000
08198P,聯發科元大9B售25,0,0,0,0,0,0,0,0,0,-55000,0,0,0,20000,75000,-55000,-55000
060827,健策元大9A購02  ,0,0,0,0,0,0,0,0,0,-55000,0,0,0,6000,61000,-55000,-55000
06933P,禾伸堂元大98售03,0,0,0,0,0,0,0,0,0,-56000,0,0,0,41000,97000,-56000,-56000
07006P,旺宏統一9B售03  ,0,0,0,0,0,0,0,0,0,-56000,0,0,0,22000,78000,-56000,-56000
062574,美食群益9B購02  ,0,0,0,0,0,0,0,0,0,-56000,0,0,0,0,56000,-56000,-56000
062640,訊連國票9C購01  ,0,0,0,0,0,0,0,0,0,-56000,0,0,0,0,56000,-56000,-56000
062374,茂林元大9B購03  ,0,0,0,0,0,0,0,0,0,-56000,0,0,0,17000,73000,-56000,-56000
060191,亞光元富9A購02  ,0,0,0,0,0,0,0,0,0,-56000,0,0,0,18000,74000,-56000,-56000
059911,國巨元大99購27  ,0,0,0,0,0,0,0,0,0,-56000,0,0,0,4000,60000,-56000,-56000
056683,台積電統一98購05,0,0,0,0,0,0,0,0,0,-56000,0,0,0,200000,256000,-56000,-56000
056422,全新統一98購02  ,0,0,0,0,0,0,0,0,0,-56000,0,0,0,0,56000,-56000,-56000
060188,華新科元富9A購03,0,0,0,0,0,0,0,0,0,-56000,0,0,0,8000,64000,-56000,-56000
059459,訊芯永豐99購04  ,0,0,0,0,0,0,0,0,0,-56000,0,0,0,130000,186000,-56000,-56000
059688,燿華永豐99購01  ,0,0,0,0,0,0,0,0,0,-56000,0,0,0,0,56000,-56000,-56000
058797,大毅元大99購03  ,0,0,0,0,0,0,0,0,0,-56000,0,0,0,0,56000,-56000,-56000
058093,神達元大9A購01  ,0,0,0,0,0,0,0,0,0,-56000,0,0,0,50000,106000,-56000,-56000
060965,中租凱基9B購01  ,0,0,0,0,0,0,0,0,0,-56000,0,0,0,34000,90000,-56000,-56000
4916,事欣科          ,21000,77000,-56000,0,0,0,0,0,0,0,0,0,0,0,0,0,-56000
2360,致茂            ,628000,698000,-70000,0,0,0,0,0,0,14000,8000,0,8000,7000,1000,6000,-56000
2836,高雄銀          ,51000,107000,-56000,0,0,0,0,0,0,0,0,0,0,0,0,0,-56000
07965P,玉晶光群益01售02,0,0,0,0,0,0,0,0,0,-56000,0,0,0,3000,59000,-56000,-56000
061620,禾伸堂群益9A購02,0,0,0,0,0,0,0,0,0,-57000,0,0,0,42000,99000,-57000,-57000
061693,華新科群益9B購02,0,0,0,0,0,0,0,0,0,-57000,0,0,0,0,57000,-57000,-57000
061639,晶豪科元大9A購02,0,0,0,0,0,0,0,0,0,-57000,0,0,0,50000,107000,-57000,-57000
061507,南電國票9A購05  ,0,0,0,0,0,0,0,0,0,-57000,0,0,0,28000,85000,-57000,-57000
061980,聯發科元大9B購01,0,0,0,0,0,0,0,0,0,-57000,0,0,0,57000,114000,-57000,-57000
061770,泰碩元大9B購02  ,0,0,0,0,0,0,0,0,0,-57000,0,0,0,77000,134000,-57000,-57000
059913,台積電元大99購44,0,0,0,0,0,0,0,0,0,-57000,0,0,0,0,57000,-57000,-57000
060231,台積電元大9A購08,0,0,0,0,0,0,0,0,0,-57000,0,0,0,10000,67000,-57000,-57000
055496,高鐵元大97購02  ,0,0,0,0,0,0,0,0,0,-57000,0,0,0,75000,132000,-57000,-57000
057101,新光金中信9A購01,0,0,0,0,0,0,0,0,0,-57000,0,0,0,0,57000,-57000,-57000
053638,信邦永豐96購01  ,0,0,0,0,0,0,0,0,0,-57000,0,0,0,0,57000,-57000,-57000
050758,聯發科元富9B購01,0,0,0,0,0,0,0,0,0,-57000,0,0,0,3000,60000,-57000,-57000
060145,牧德國票9A購02  ,0,0,0,0,0,0,0,0,0,-57000,0,0,0,0,57000,-57000,-57000
058608,華新科元大99購13,0,0,0,0,0,0,0,0,0,-57000,0,0,0,0,57000,-57000,-57000
058656,燿華中信99購01  ,0,0,0,0,0,0,0,0,0,-57000,0,0,0,0,57000,-57000,-57000
059588,鴻海元大99購32  ,0,0,0,0,0,0,0,0,0,-57000,0,0,0,18000,75000,-57000,-57000
058212,華新科群益9A購01,0,0,0,0,0,0,0,0,0,-57000,0,0,0,0,57000,-57000,-57000
057335,技嘉國票99購01  ,0,0,0,0,0,0,0,0,0,-57000,0,0,0,65000,122000,-57000,-57000
07751P,世紀鋼凱基9A售02,100000,0,100000,0,0,0,0,0,0,-157000,0,0,0,190000,347000,-157000,-57000
4961,天鈺            ,25000,82000,-57000,0,0,0,0,0,0,0,0,0,0,0,0,0,-57000
062251,旺宏元大9B購06  ,0,0,0,0,0,0,0,0,0,-58000,0,0,0,0,58000,-58000,-58000
063560,力山元大9B購05  ,0,0,0,0,0,0,0,0,0,-58000,0,0,0,0,58000,-58000,-58000
063046,聯發科兆豐9C購01,0,0,0,0,0,0,0,0,0,-58000,0,0,0,0,58000,-58000,-58000
063001,巨大國票9B購01  ,0,0,0,0,0,0,0,0,0,-58000,0,0,0,4000,62000,-58000,-58000
054220,國巨統一97購02  ,0,0,0,0,0,0,0,0,0,-58000,0,0,0,0,58000,-58000,-58000
03442B,臺股指元大9A熊48,0,0,0,0,0,0,0,0,0,-58000,0,0,0,75000,133000,-58000,-58000
052764,景碩群益98購01  ,0,0,0,0,0,0,0,0,0,-58000,0,0,0,138000,196000,-58000,-58000
056936,禾伸堂元富98購01,0,0,0,0,0,0,0,0,0,-58000,0,0,0,0,58000,-58000,-58000
054735,漢唐凱基98購01  ,0,0,0,0,0,0,0,0,0,-58000,0,0,0,0,58000,-58000,-58000
056479,玉晶光元大99購05,0,0,0,0,0,0,0,0,0,-58000,0,0,0,10000,68000,-58000,-58000
057466,泰鼎永豐98購01  ,0,0,0,0,0,0,0,0,0,-58000,0,0,0,32000,90000,-58000,-58000
057629,泰碩永豐98購02  ,0,0,0,0,0,0,0,0,0,-58000,0,0,0,0,58000,-58000,-58000
057284,新日興元大98購03,0,0,0,0,0,0,0,0,0,-58000,0,0,0,51000,109000,-58000,-58000
060342,台積電統一02購01,0,0,0,0,0,0,0,0,0,-58000,0,0,0,30000,88000,-58000,-58000
058670,鴻海群益9A購03  ,0,0,0,0,0,0,0,0,0,-58000,0,0,0,0,58000,-58000,-58000
07839P,嘉澤元大9A售04  ,0,0,0,0,0,0,0,0,0,-58000,0,0,0,170000,228000,-58000,-58000
061087,國巨統一01購04  ,0,0,0,0,0,0,0,0,0,-58000,0,0,0,30000,88000,-58000,-58000
058822,樺漢國泰9B購01  ,0,0,0,0,0,0,0,0,0,-58000,0,0,0,607000,665000,-58000,-58000
1527,鑽全            ,73000,131000,-58000,0,0,0,0,0,0,0,0,0,0,0,0,0,-58000
063372,漢翔永豐9B購01  ,0,0,0,0,0,0,0,0,0,-59000,0,0,0,0,59000,-59000,-59000
062167,燿華永豐9B購01  ,0,0,0,0,0,0,0,0,0,-59000,0,0,0,0,59000,-59000,-59000
062736,漢唐國票9B購01  ,0,0,0,0,0,0,0,0,0,-59000,0,0,0,0,59000,-59000,-59000
062497,遠東新群益9B購01,0,0,0,0,0,0,0,0,0,-59000,0,0,0,108000,167000,-59000,-59000
061948,美食群益9B購01  ,0,0,0,0,0,0,0,0,0,-59000,0,0,0,0,59000,-59000,-59000
056571,燿華元大98購02  ,0,0,0,0,0,0,0,0,0,-59000,0,0,0,79000,138000,-59000,-59000
060253,昇陽半元大9C購01,0,0,0,0,0,0,0,0,0,-59000,0,0,0,110000,169000,-59000,-59000
059985,華新科元大99購22,0,0,0,0,0,0,0,0,0,-59000,0,0,0,20000,79000,-59000,-59000
055439,台表科國票98購02,0,0,0,0,0,0,0,0,0,-59000,0,0,0,23000,82000,-59000,-59000
051266,國巨富邦99購01  ,0,0,0,0,0,0,0,0,0,-59000,0,0,0,10000,69000,-59000,-59000
060402,神隆國泰9B購01  ,0,0,0,0,0,0,0,0,0,-59000,0,0,0,157000,216000,-59000,-59000
2405,浩鑫            ,32000,91000,-59000,0,0,0,0,0,0,0,0,0,0,0,0,0,-59000
3617,碩天            ,21000,75000,-54000,0,0,0,0,0,0,-5000,0,0,0,0,5000,-5000,-59000
060929,健策永豐9A購01  ,0,0,0,0,0,0,0,0,0,-59000,0,0,0,2000,61000,-59000,-59000
061848,國巨國票9B購07  ,0,0,0,0,0,0,0,0,0,-60000,0,0,0,0,60000,-60000,-60000
061831,智邦凱基9B購02  ,0,0,0,0,0,0,0,0,0,-60000,0,0,0,10000,70000,-60000,-60000
061645,超眾元大9A購06  ,0,0,0,0,0,0,0,0,0,-60000,0,0,0,12000,72000,-60000,-60000
062433,上銀元大9B購05  ,0,0,0,0,0,0,0,0,0,-60000,0,0,0,0,60000,-60000,-60000
062247,國巨元大9B購07  ,0,0,0,0,0,0,0,0,0,-60000,0,0,0,0,60000,-60000,-60000
062259,可成元大9B購03  ,0,0,0,0,0,0,0,0,0,-60000,0,0,0,0,60000,-60000,-60000
063307,同欣電凱基9B購02,0,0,0,0,0,0,0,0,0,-60000,0,0,0,0,60000,-60000,-60000
063122,聯發科元大9B購15,0,0,0,0,0,0,0,0,0,-60000,0,0,0,4000,64000,-60000,-60000
063123,聯發科元大9B購16,0,0,0,0,0,0,0,0,0,-60000,0,0,0,5000,65000,-60000,-60000
063124,奇力新元大9B購05,0,0,0,0,0,0,0,0,0,-60000,0,0,0,0,60000,-60000,-60000
062948,台積電富邦01購02,0,0,0,0,0,0,0,0,0,-60000,0,0,0,1000,61000,-60000,-60000
062887,台積電群益9C購05,0,0,0,0,0,0,0,0,0,-60000,0,0,0,0,60000,-60000,-60000
063558,聚陽元大9B購02  ,0,0,0,0,0,0,0,0,0,-60000,0,0,0,0,60000,-60000,-60000
063567,漢唐元大9B購03  ,0,0,0,0,0,0,0,0,0,-60000,0,0,0,50000,110000,-60000,-60000
052617,景碩國泰98購01  ,0,0,0,0,0,0,0,0,0,-60000,0,0,0,0,60000,-60000,-60000
052234,GIS凱基97購01   ,0,0,0,0,0,0,0,0,0,-60000,0,0,0,0,60000,-60000,-60000
055983,全新元富9A購02  ,0,0,0,0,0,0,0,0,0,-60000,0,0,0,0,60000,-60000,-60000
053173,矽格群益97購01  ,0,0,0,0,0,0,0,0,0,-60000,0,0,0,5000,65000,-60000,-60000
053107,旺宏兆豐97購01  ,0,0,0,0,0,0,0,0,0,-60000,0,0,0,0,60000,-60000,-60000
053996,晶相光群益97購01,0,0,0,0,0,0,0,0,0,-60000,0,0,0,0,60000,-60000,-60000
055365,華通元大97購03  ,0,0,0,0,0,0,0,0,0,-60000,0,0,0,0,60000,-60000,-60000
055252,新光金統一98購02,0,0,0,0,0,0,0,0,0,-60000,0,0,0,0,60000,-60000,-60000
056995,華新科日盛99購01,0,0,0,0,0,0,0,0,0,-60000,0,0,0,100000,160000,-60000,-60000
055181,日電貿統一97購01,0,0,0,0,0,0,0,0,0,-60000,0,0,0,0,60000,-60000,-60000
057060,緯穎元大98購05  ,0,0,0,0,0,0,0,0,0,-60000,0,0,0,0,60000,-60000,-60000
056122,勤誠群益97購02  ,0,0,0,0,0,0,0,0,0,-60000,0,0,0,102000,162000,-60000,-60000
059763,華擎永豐99購03  ,0,0,0,0,0,0,0,0,0,-60000,0,0,0,0,60000,-60000,-60000
060077,台積電台新9B購01,0,0,0,0,0,0,0,0,0,-60000,0,0,0,0,60000,-60000,-60000
056486,樺漢元大98購04  ,0,0,0,0,0,0,0,0,0,-60000,0,0,0,53000,113000,-60000,-60000
056509,晶相光永豐98購01,0,0,0,0,0,0,0,0,0,-60000,0,0,0,0,60000,-60000,-60000
059619,台積電日盛9A購04,0,0,0,0,0,0,0,0,0,-60000,0,0,0,101000,161000,-60000,-60000
059629,友達凱基99購06  ,0,0,0,0,0,0,0,0,0,-60000,0,0,0,140000,200000,-60000,-60000
058639,南電兆豐99購01  ,0,0,0,0,0,0,0,0,0,-60000,0,0,0,40000,100000,-60000,-60000
057776,京元電群益98購02,0,0,0,0,0,0,0,0,0,-60000,0,0,0,0,60000,-60000,-60000
057318,台光電凱基9A購01,0,0,0,0,0,0,0,0,0,-60000,0,0,0,0,60000,-60000,-60000
057437,可成國票99購01  ,0,0,0,0,0,0,0,0,0,-60000,0,0,0,0,60000,-60000,-60000
057368,微星元大98購02  ,0,0,0,0,0,0,0,0,0,-60000,0,0,0,0,60000,-60000,-60000
057578,可成中信99購01  ,0,0,0,0,0,0,0,0,0,-60000,0,0,0,160000,220000,-60000,-60000
060601,技嘉凱基9A購02  ,0,0,0,0,0,0,0,0,0,-60000,0,0,0,82000,142000,-60000,-60000
06051P,嘉聯益國票97售04,0,0,0,0,0,0,0,0,0,-60000,0,0,0,0,60000,-60000,-60000
058463,宏達電兆豐99購02,0,0,0,0,0,0,0,0,0,-60000,0,0,0,0,60000,-60000,-60000
059016,晶相光元富99購03,0,0,0,0,0,0,0,0,0,-60000,0,0,0,0,60000,-60000,-60000
061081,宏碁兆豐9A購01  ,0,0,0,0,0,0,0,0,0,-60000,0,0,0,168000,228000,-60000,-60000
061142,南電統一9A購01  ,0,0,0,0,0,0,0,0,0,-60000,0,0,0,0,60000,-60000,-60000
061291,玉晶光統一01購05,0,0,0,0,0,0,0,0,0,-60000,0,0,0,0,60000,-60000,-60000
061025,創意富邦9B購01  ,0,0,0,0,0,0,0,0,0,-60000,0,0,0,40000,100000,-60000,-60000
058924,晶相光元富99購02,0,0,0,0,0,0,0,0,0,-60000,0,0,0,0,60000,-60000,-60000
058894,元油2X元大9C購11,0,0,0,0,0,0,0,0,0,-60000,0,0,0,0,60000,-60000,-60000
060905,台積電元大9A購20,0,0,0,0,0,0,0,0,0,-60000,0,0,0,42000,102000,-60000,-60000
060685,康友元大9A購01  ,0,0,0,0,0,0,0,0,0,-60000,0,0,0,0,60000,-60000,-60000
4564,元翎            ,51000,111000,-60000,0,0,0,0,0,0,0,0,0,0,0,0,0,-60000
2402,毅嘉            ,192000,265000,-73000,0,0,0,0,0,0,13000,13000,0,13000,0,0,0,-60000
08210P,健策元富9B售02  ,0,0,0,0,0,0,0,0,0,-60000,0,0,0,0,60000,-60000,-60000
07354P,臺股指國票99售22,0,0,0,0,0,0,0,0,0,-60000,0,0,0,0,60000,-60000,-60000
063022,嘉晶元大9B購04  ,0,0,0,0,0,0,0,0,0,-61000,0,0,0,139000,200000,-61000,-61000
063443,金像電統一01購02,15000,0,15000,0,0,0,0,0,0,-76000,0,0,0,20000,96000,-76000,-61000
062083,健策元大9C購03  ,0,0,0,0,0,0,0,0,0,-61000,0,0,0,128000,189000,-61000,-61000
061767,信邦元大9B購01  ,0,0,0,0,0,0,0,0,0,-61000,0,0,0,235000,296000,-61000,-61000
061982,聯發科元大9B購03,0,0,0,0,0,0,0,0,0,-61000,0,0,0,6000,67000,-61000,-61000
056385,創意國泰99購01  ,0,0,0,0,0,0,0,0,0,-61000,0,0,0,163000,224000,-61000,-61000
057057,立積元大9A購01  ,0,0,0,0,0,0,0,0,0,-61000,0,0,0,50000,111000,-61000,-61000
056209,超眾永豐97購02  ,0,0,0,0,0,0,0,0,0,-61000,0,0,0,52000,113000,-61000,-61000
053113,瀚宇博兆豐97購01,0,0,0,0,0,0,0,0,0,-61000,0,0,0,0,61000,-61000,-61000
061155,華新科群益9A購06,0,0,0,0,0,0,0,0,0,-61000,0,0,0,10000,71000,-61000,-61000
059276,可成元大99購06  ,0,0,0,0,0,0,0,0,0,-61000,0,0,0,5000,66000,-61000,-61000
07545P,玉晶光凱基9A售07,0,0,0,0,0,0,0,0,0,-61000,0,0,0,0,61000,-61000,-61000
2332,友訊            ,124000,146000,-22000,0,0,0,0,0,0,-39000,10000,0,10000,0,49000,-49000,-61000
3052,夆典            ,0,61000,-61000,0,0,0,0,0,0,0,0,0,0,0,0,0,-61000
2929,淘帝-KY         ,48000,109000,-61000,0,0,0,0,0,0,0,0,0,0,0,0,0,-61000
6414,樺漢            ,129000,154000,-25000,0,0,0,0,0,0,-36000,2000,44000,-42000,13000,7000,6000,-61000
060809,康友群益9A購01  ,0,0,0,0,0,0,0,0,0,-61000,0,0,0,158000,219000,-61000,-61000
062983,緯穎元富9B購01  ,0,0,0,0,0,0,0,0,0,-62000,0,0,0,15000,77000,-62000,-62000
062897,上銀元大9B購06  ,0,0,0,0,0,0,0,0,0,-62000,0,0,0,0,62000,-62000,-62000
062920,康友元大9B購01  ,0,0,0,0,0,0,0,0,0,-62000,0,0,0,2000,64000,-62000,-62000
062777,鴻海元大9C購03  ,0,0,0,0,0,0,0,0,0,-62000,0,0,0,0,62000,-62000,-62000
062761,嘉晶凱基9C購01  ,0,0,0,0,0,0,0,0,0,-62000,0,0,0,45000,107000,-62000,-62000
06457P,玉晶光統一98售02,0,0,0,0,0,0,0,0,0,-62000,0,0,0,29000,91000,-62000,-62000
056321,創意群益98購02  ,0,0,0,0,0,0,0,0,0,-62000,0,0,0,92000,154000,-62000,-62000
060203,緯穎元富9A購01  ,0,0,0,0,0,0,0,0,0,-62000,0,0,0,39000,101000,-62000,-62000
059851,晶相光永豐99購02,0,0,0,0,0,0,0,0,0,-62000,0,0,0,0,62000,-62000,-62000
059198,華新科永豐99購06,0,0,0,0,0,0,0,0,0,-62000,0,0,0,12000,74000,-62000,-62000
060293,緯創元大9A購01  ,0,0,0,0,0,0,0,0,0,-62000,0,0,0,38000,100000,-62000,-62000
059660,華新科元大9A購04,0,0,0,0,0,0,0,0,0,-62000,0,0,0,0,62000,-62000,-62000
07891P,臺股指國票9B售01,0,0,0,0,0,0,0,0,0,-62000,0,0,0,6000,68000,-62000,-62000
063563,國巨元大9C購07  ,0,0,0,0,0,0,0,0,0,-63000,0,0,0,0,63000,-63000,-63000
063537,華擎統一9C購03  ,0,0,0,0,0,0,0,0,0,-63000,0,0,0,0,63000,-63000,-63000
062854,日電貿永豐9B購01,0,0,0,0,0,0,0,0,0,-63000,0,0,0,0,63000,-63000,-63000
061976,國巨元大9B購01  ,0,0,0,0,0,0,0,0,0,-63000,0,0,0,0,63000,-63000,-63000
061880,台郡元大9B購02  ,0,0,0,0,0,0,0,0,0,-63000,0,0,0,72000,135000,-63000,-63000
062094,台積電富邦9C購12,0,0,0,0,0,0,0,0,0,-63000,0,0,0,4000,67000,-63000,-63000
062480,茂林國票9B購01  ,0,0,0,0,0,0,0,0,0,-63000,0,0,0,10000,73000,-63000,-63000
055603,超眾元大97購04  ,0,0,0,0,0,0,0,0,0,-63000,0,0,0,5000,68000,-63000,-63000
054957,興富發元大97購01,0,0,0,0,0,0,0,0,0,-63000,0,0,0,64000,127000,-63000,-63000
056054,亞德客元大97購05,0,0,0,0,0,0,0,0,0,-63000,0,0,0,18000,81000,-63000,-63000
057044,旺宏元大98購08  ,0,0,0,0,0,0,0,0,0,-63000,0,0,0,0,63000,-63000,-63000
052990,超眾元大97購01  ,0,0,0,0,0,0,0,0,0,-63000,0,0,0,4000,67000,-63000,-63000
03682C,臺股指凱基9C牛07,0,0,0,0,0,0,0,0,0,-63000,0,0,0,15000,78000,-63000,-63000
057815,信邦元大98購01  ,0,0,0,0,0,0,0,0,0,-63000,0,0,0,138000,201000,-63000,-63000
057533,晶相光元大98購02,0,0,0,0,0,0,0,0,0,-63000,0,0,0,0,63000,-63000,-63000
057974,上銀永豐98購02  ,0,0,0,0,0,0,0,0,0,-63000,0,0,0,0,63000,-63000,-63000
057982,帆宣永豐98購01  ,0,0,0,0,0,0,0,0,0,-63000,0,0,0,3000,66000,-63000,-63000
058136,景碩元大99購02  ,0,0,0,0,0,0,0,0,0,-63000,0,0,0,168000,231000,-63000,-63000
08158P,嘉澤元富9B售03  ,0,0,0,0,0,0,0,0,0,-63000,0,0,0,180000,243000,-63000,-63000
2231,為升            ,71000,133000,-62000,0,0,0,0,0,0,-1000,0,0,0,1000,2000,-1000,-63000
9934,成霖            ,15000,78000,-63000,0,0,0,0,0,0,0,0,0,0,0,0,0,-63000
062506,巨大群益9C購01  ,0,0,0,0,0,0,0,0,0,-64000,0,0,0,46000,110000,-64000,-64000
062282,禾伸堂群益9B購01,0,0,0,0,0,0,0,0,0,-64000,0,0,0,0,64000,-64000,-64000
062972,京元電元富9B購01,0,0,0,0,0,0,0,0,0,-64000,0,0,0,0,64000,-64000,-64000
063374,嘉澤永豐9B購04  ,0,0,0,0,0,0,0,0,0,-64000,0,0,0,16000,80000,-64000,-64000
057063,立積國泰9A購01  ,0,0,0,0,0,0,0,0,0,-64000,0,0,0,1000,65000,-64000,-64000
058874,聯鈞國票9A購01  ,0,0,0,0,0,0,0,0,0,-64000,0,0,0,35000,99000,-64000,-64000
06096P,全新永豐97售02  ,0,0,0,0,0,0,0,0,0,-64000,0,0,0,0,64000,-64000,-64000
063535,聯發科統一9B購13,0,0,0,0,0,0,0,0,0,-65000,0,0,0,5000,70000,-65000,-65000
062105,國巨國票9C購03  ,0,0,0,0,0,0,0,0,0,-65000,0,0,0,5000,70000,-65000,-65000
062260,華新科元大9B購09,0,0,0,0,0,0,0,0,0,-65000,0,0,0,0,65000,-65000,-65000
062544,信錦永豐9B購01  ,0,0,0,0,0,0,0,0,0,-65000,0,0,0,0,65000,-65000,-65000
062461,智伸科群益9B購01,0,0,0,0,0,0,0,0,0,-65000,0,0,0,41000,106000,-65000,-65000
062651,世紀鋼富邦9C購01,0,0,0,0,0,0,0,0,0,-65000,0,0,0,58000,123000,-65000,-65000
062620,台表科元大9B購04,0,0,0,0,0,0,0,0,0,-65000,0,0,0,42000,107000,-65000,-65000
061969,大立光統一01購02,0,0,0,0,0,0,0,0,0,-65000,0,0,0,0,65000,-65000,-65000
055620,樺漢國票98購01  ,0,0,0,0,0,0,0,0,0,-65000,0,0,0,64000,129000,-65000,-65000
056269,新日興統一98購01,0,0,0,0,0,0,0,0,0,-65000,0,0,0,0,65000,-65000,-65000
056922,全新兆豐99購01  ,0,0,0,0,0,0,0,0,0,-65000,0,0,0,20000,85000,-65000,-65000
058886,元石油元大9C購03,0,0,0,0,0,0,0,0,0,-65000,0,0,0,0,65000,-65000,-65000
058033,景碩永豐98購02  ,0,0,0,0,0,0,0,0,0,-65000,0,0,0,36000,101000,-65000,-65000
058758,台積電群益99購05,0,0,0,0,0,0,0,0,0,-65000,0,0,0,14000,79000,-65000,-65000
057936,健策群益99購01  ,0,0,0,0,0,0,0,0,0,-65000,0,0,0,37000,102000,-65000,-65000
057455,景碩國泰99購01  ,0,0,0,0,0,0,0,0,0,-65000,0,0,0,197000,262000,-65000,-65000
057636,上銀元大98購06  ,0,0,0,0,0,0,0,0,0,-65000,0,0,0,5000,70000,-65000,-65000
057257,台泥兆豐99購01  ,0,0,0,0,0,0,0,0,0,-65000,0,0,0,3000,68000,-65000,-65000
058628,宏達電國票9A購01,0,0,0,0,0,0,0,0,0,-65000,0,0,0,0,65000,-65000,-65000
060989,國泰金元大9A購02,0,0,0,0,0,0,0,0,0,-65000,0,0,0,24000,89000,-65000,-65000
6706,惠特            ,88000,105000,-17000,0,0,0,0,0,0,-48000,16000,64000,-48000,0,0,0,-65000
060687,GIS元大9A購01   ,0,0,0,0,0,0,0,0,0,-65000,0,0,0,5000,70000,-65000,-65000
060674,瑞昱元大9A購03  ,0,20000,-20000,0,0,0,0,0,0,-45000,0,0,0,163000,208000,-45000,-65000
07702P,台積電中信9A售06,0,0,0,0,0,0,0,0,0,-65000,0,0,0,0,65000,-65000,-65000
3008,大立光          ,435188,481535,-46347,0,0,0,0,17000,-17000,-2000,1000,2000,-1000,0,1000,-1000,-65347
062573,大毅群益9B購03  ,0,0,0,0,0,0,0,0,0,-66000,0,0,0,131000,197000,-66000,-66000
063506,嘉晶群益9B購01  ,0,0,0,0,0,0,0,0,0,-66000,0,0,0,0,66000,-66000,-66000
063165,泰碩永豐9B購02  ,0,0,0,0,0,0,0,0,0,-66000,0,0,0,0,66000,-66000,-66000
056946,國巨統一98購05  ,0,0,0,0,0,0,0,0,0,-66000,0,0,0,44000,110000,-66000,-66000
056715,瀚宇博永豐98購01,0,0,0,0,0,0,0,0,0,-66000,0,0,0,65000,131000,-66000,-66000
056178,嘉澤元富97購02  ,0,0,0,0,0,0,0,0,0,-66000,0,0,0,0,66000,-66000,-66000
054943,群光元大97購01  ,0,0,0,0,0,0,0,0,0,-66000,0,0,0,220000,286000,-66000,-66000
059613,泰鼎永豐99購02  ,0,0,0,0,0,0,0,0,0,-66000,0,0,0,1000,67000,-66000,-66000
057713,美律統一99購01  ,0,0,0,0,0,0,0,0,0,-66000,0,0,0,0,66000,-66000,-66000
057662,上銀元大9A購01  ,0,0,0,0,0,0,0,0,0,-66000,0,0,0,2000,68000,-66000,-66000
057967,聯發科國泰9A購02,0,0,0,0,0,0,0,0,0,-66000,0,0,0,0,66000,-66000,-66000
059248,華新科凱基99購04,0,0,0,0,0,0,0,0,0,-66000,0,0,0,4000,70000,-66000,-66000
058956,健策國票9A購02  ,0,0,0,0,0,0,0,0,0,-66000,0,0,0,93000,159000,-66000,-66000
2851,中再保          ,15000,81000,-66000,0,0,0,0,0,0,0,0,0,0,0,0,0,-66000
08171P,嘉澤國票9C售01  ,0,0,0,0,0,0,0,0,0,-66000,0,0,0,25000,91000,-66000,-66000
3321,同泰            ,0,66000,-66000,0,0,0,0,0,0,0,0,0,0,0,0,0,-66000
060996,臻鼎元大9A購01  ,0,0,0,0,0,0,0,0,0,-66000,0,0,0,0,66000,-66000,-66000
063197,遠東新統一9C購01,0,0,0,0,0,0,0,0,0,-67000,0,0,0,0,67000,-67000,-67000
062235,億光凱基9B購01  ,0,0,0,0,0,0,0,0,0,-67000,0,0,0,36000,103000,-67000,-67000
062172,南六永豐9B購01  ,0,0,0,0,0,0,0,0,0,-67000,0,0,0,1000,68000,-67000,-67000
059882,臺股指凱基9C購06,0,0,0,0,0,0,0,0,0,-67000,0,0,0,308000,375000,-67000,-67000
057737,國巨富邦99購02  ,0,0,0,0,0,0,0,0,0,-67000,0,0,0,0,67000,-67000,-67000
058583,臻鼎群益99購01  ,0,0,0,0,0,0,0,0,0,-67000,0,0,0,15000,82000,-67000,-67000
058587,台積電中信9C購03,0,0,0,0,0,0,0,0,0,-67000,0,0,0,15000,82000,-67000,-67000
2461,光群雷          ,25000,92000,-67000,0,0,0,0,0,0,0,0,0,0,0,0,0,-67000
062030,旭富群益9B購01  ,0,0,0,0,0,0,0,0,0,-68000,0,0,0,0,68000,-68000,-68000
062018,台勝科永豐9B購01,0,0,0,0,0,0,0,0,0,-68000,0,0,0,0,68000,-68000,-68000
061842,牧德凱基9C購01  ,0,0,0,0,0,0,0,0,0,-68000,0,0,0,0,68000,-68000,-68000
061706,旭富國票9A購02  ,0,0,0,0,0,0,0,0,0,-68000,0,0,0,0,68000,-68000,-68000
063145,台表科統一02購01,0,0,0,0,0,0,0,0,0,-68000,0,0,0,135000,203000,-68000,-68000
062956,同欣電永豐9B購02,0,0,0,0,0,0,0,0,0,-68000,0,0,0,0,68000,-68000,-68000
062951,鴻海永豐9B購02  ,0,0,0,0,0,0,0,0,0,-68000,0,0,0,0,68000,-68000,-68000
059987,大立光元大99購28,0,0,0,0,0,0,0,0,0,-68000,0,0,0,0,68000,-68000,-68000
059958,鎧勝康和99購01  ,0,0,0,0,0,0,0,0,0,-68000,0,0,0,40000,108000,-68000,-68000
056351,鴻海元大98購06  ,0,0,0,0,0,0,0,0,0,-68000,0,0,0,0,68000,-68000,-68000
056563,華新科群益98購04,0,0,0,0,0,0,0,0,0,-68000,0,0,0,20000,88000,-68000,-68000
056130,新日興麥證97購01,0,0,0,0,68000,-68000,0,0,0,-68000,0,0,0,0,68000,-68000,-68000
055661,亞德客中信98購01,0,0,0,0,0,0,0,0,0,-68000,0,0,0,52000,120000,-68000,-68000
055716,致茂元大97購01  ,0,0,0,0,0,0,0,0,0,-68000,0,0,0,0,68000,-68000,-68000
060128,健策永豐99購06  ,0,0,0,0,0,0,0,0,0,-68000,0,0,0,38000,106000,-68000,-68000
057773,技嘉群益9A購02  ,0,0,0,0,0,0,0,0,0,-68000,0,0,0,2000,70000,-68000,-68000
057638,上銀元大99購01  ,0,0,0,0,0,0,0,0,0,-68000,0,0,0,3000,71000,-68000,-68000
057849,南茂永豐98購02  ,0,0,0,0,0,0,0,0,0,-68000,0,0,0,0,68000,-68000,-68000
060466,玉山金元大9A購01,0,0,0,0,0,0,0,0,0,-68000,0,0,0,55000,123000,-68000,-68000
058985,可成凱基99購03  ,0,0,0,0,0,0,0,0,0,-68000,0,0,0,0,68000,-68000,-68000
07843P,緯穎元大9A售05  ,0,0,0,0,0,0,0,0,0,-68000,0,0,0,142000,210000,-68000,-68000
061040,康友永豐9A購01  ,0,0,0,0,0,0,0,0,0,-68000,0,0,0,0,68000,-68000,-68000
058036,南電永豐98購01  ,0,0,0,0,0,0,0,0,0,-68000,0,0,0,0,68000,-68000,-68000
058995,台達電元大99購01,0,0,0,0,0,0,0,0,0,-68000,0,0,0,0,68000,-68000,-68000
058788,喬山元大99購01  ,0,0,0,0,0,0,0,0,0,-68000,0,0,0,197000,265000,-68000,-68000
061424,華新科元大9A購18,0,0,0,0,0,0,0,0,0,-69000,0,0,0,0,69000,-69000,-69000
062645,國巨國泰9B購08  ,0,0,0,0,0,0,0,0,0,-69000,0,0,0,64000,133000,-69000,-69000
00660,元大歐洲50      ,0,0,0,0,0,0,0,0,0,-69000,0,0,0,4000,73000,-69000,-69000
054217,台表科國票97購05,0,0,0,0,0,0,0,0,0,-69000,0,0,0,10000,79000,-69000,-69000
054212,聯詠國票97購03  ,0,0,0,0,0,0,0,0,0,-69000,0,0,0,0,69000,-69000,-69000
056277,上銀富邦99購02  ,0,0,0,0,0,0,0,0,0,-69000,0,0,0,5000,74000,-69000,-69000
058125,元油2X元大9C購01,0,0,0,0,0,0,0,0,0,-69000,0,0,0,0,69000,-69000,-69000
059338,滬深2X凱基9C購02,0,0,0,0,0,0,0,0,0,-69000,0,0,0,0,69000,-69000,-69000
061237,晶技元大9A購01  ,0,0,0,0,0,0,0,0,0,-69000,0,0,0,0,69000,-69000,-69000
057514,華新科元富99購03,0,0,0,0,0,0,0,0,0,-69000,0,0,0,0,69000,-69000,-69000
08201P,祥碩元大9B售09  ,0,0,0,0,0,0,0,0,0,-69000,0,0,0,16000,85000,-69000,-69000
9925,新保            ,0,79000,-79000,0,0,0,0,0,0,10000,10000,0,10000,0,0,0,-69000
062717,華邦電凱基9C購01,0,0,0,0,0,0,0,0,0,-70000,0,0,0,20000,90000,-70000,-70000
062150,南六國票9B購01  ,0,0,0,0,0,0,0,0,0,-70000,0,0,0,12000,82000,-70000,-70000
062413,台光電中信9B購02,0,0,0,0,0,0,0,0,0,-70000,0,0,0,0,70000,-70000,-70000
062358,國巨元大9B購12  ,0,0,0,0,0,0,0,0,0,-70000,0,0,0,0,70000,-70000,-70000
061420,國巨元大9A購22  ,0,0,0,0,0,0,0,0,0,-70000,0,0,0,0,70000,-70000,-70000
061953,台積電台新9B購04,0,0,0,0,0,0,0,0,0,-70000,0,0,0,50000,120000,-70000,-70000
063199,台積電統一01購07,0,0,0,0,0,0,0,0,0,-70000,0,0,0,4000,74000,-70000,-70000
055265,玉晶光永豐98購03,0,0,0,0,0,0,0,0,0,-70000,0,0,0,40000,110000,-70000,-70000
054789,高鐵群益98購01  ,0,0,0,0,0,0,0,0,0,-70000,0,0,0,75000,145000,-70000,-70000
056552,台表科凱基99購01,0,0,0,0,0,0,0,0,0,-70000,0,0,0,65000,135000,-70000,-70000
056766,義隆元大98購01  ,0,0,0,0,0,0,0,0,0,-70000,0,0,0,11000,81000,-70000,-70000
060097,華新科元大99購23,0,0,0,0,0,0,0,0,0,-70000,0,0,0,0,70000,-70000,-70000
059805,台積電元富99購02,0,0,0,0,0,0,0,0,0,-70000,0,0,0,65000,135000,-70000,-70000
00715L,街口布蘭特油正2 ,0,0,0,0,0,0,0,0,0,-70000,0,0,0,0,70000,-70000,-70000
060419,漢翔永豐9A購01  ,0,0,0,0,0,0,0,0,0,-70000,0,0,0,0,70000,-70000,-70000
058580,華新科群益99購02,0,0,0,0,0,0,0,0,0,-70000,0,0,0,0,70000,-70000,-70000
059530,華新科凱基9A購05,0,0,0,0,0,0,0,0,0,-70000,0,0,0,10000,80000,-70000,-70000
059513,揚明光永豐99購01,0,0,0,0,0,0,0,0,0,-70000,0,0,0,10000,80000,-70000,-70000
060014,中鋼康和99購01  ,0,0,0,0,0,0,0,0,0,-70000,0,0,0,0,70000,-70000,-70000
061086,FBVIX統一01購01 ,0,0,0,0,0,0,0,0,0,-70000,0,0,0,0,70000,-70000,-70000
057937,神達群益98購02  ,0,0,0,0,0,0,0,0,0,-70000,0,0,0,0,70000,-70000,-70000
059029,旺宏兆豐99購01  ,0,0,0,0,0,0,0,0,0,-70000,0,0,0,0,70000,-70000,-70000
059084,鴻海元大99購24  ,0,0,0,0,0,0,0,0,0,-70000,0,0,0,0,70000,-70000,-70000
060887,台積電統一01購01,0,0,0,0,0,0,0,0,0,-70000,0,0,0,3000,73000,-70000,-70000
1604,聲寶            ,37000,107000,-70000,0,0,0,0,0,0,0,0,0,0,0,0,0,-70000
07473P,祥碩元大9A售01  ,0,0,0,0,0,0,0,0,0,-70000,0,0,0,10000,80000,-70000,-70000
063209,巨大統一01購01  ,0,0,0,0,0,0,0,0,0,-71000,0,0,0,161000,232000,-71000,-71000
062008,南亞科國泰9C購01,0,0,0,0,0,0,0,0,0,-71000,0,0,0,281000,352000,-71000,-71000
061868,旺宏元大9B購03  ,0,0,0,0,0,0,0,0,0,-71000,0,0,0,0,71000,-71000,-71000
062295,康友永豐9B購01  ,0,0,0,0,0,0,0,0,0,-71000,0,0,0,39000,110000,-71000,-71000
05830P,滬深2X元富99售03,0,0,0,0,0,0,0,0,0,-71000,0,0,0,59000,130000,-71000,-71000
060664,聯詠凱基9A購01  ,0,0,0,0,0,0,0,0,0,-71000,0,0,0,0,71000,-71000,-71000
063311,喬山群益9B購01  ,0,0,0,0,0,0,0,0,0,-72000,0,0,0,85000,157000,-72000,-72000
062815,聯發科兆豐9B購03,0,0,0,0,0,0,0,0,0,-72000,0,0,0,0,72000,-72000,-72000
06880P,鈺齊凱基98售03  ,0,0,0,0,0,0,0,0,0,-72000,0,0,0,0,72000,-72000,-72000
00730,富邦臺灣優質高息,0,0,0,0,0,0,0,0,0,-72000,0,0,0,349000,421000,-72000,-72000
060063,可成兆豐9B購01  ,0,0,0,0,0,0,0,0,0,-72000,0,0,0,7000,79000,-72000,-72000
059114,華新科永豐99購05,0,0,0,0,0,0,0,0,0,-72000,0,0,0,10000,82000,-72000,-72000
059024,大立光統一9B購04,0,0,0,0,0,0,0,0,0,-72000,0,0,0,0,72000,-72000,-72000
060806,華新科群益9A購03,0,0,0,0,0,0,0,0,0,-72000,0,0,0,0,72000,-72000,-72000
1467,南緯            ,253000,325000,-72000,0,0,0,0,0,0,0,0,0,0,0,0,0,-72000
063389,大立光兆豐9C購02,0,0,0,0,0,0,0,0,0,-73000,0,0,0,12000,85000,-73000,-73000
063410,南六國票9C購01  ,0,0,0,0,0,0,0,0,0,-73000,0,0,0,107000,180000,-73000,-73000
061472,台積電元大9A購32,0,0,0,0,0,0,0,0,0,-73000,0,0,0,0,73000,-73000,-73000
060107,旭富元大99購03  ,0,0,0,0,0,0,0,0,0,-73000,0,0,0,0,73000,-73000,-73000
056298,億光元大97購02  ,0,0,0,0,0,0,0,0,0,-73000,0,0,0,68000,141000,-73000,-73000
046628,大立光統一98購01,0,0,0,0,0,0,0,0,0,-73000,0,0,0,113000,186000,-73000,-73000
057780,台郡群益98購02  ,0,0,0,0,0,0,0,0,0,-73000,0,0,0,0,73000,-73000,-73000
060611,同欣電凱基9A購02,0,0,0,0,0,0,0,0,0,-73000,0,0,0,25000,98000,-73000,-73000
060600,台積電凱基9C購01,0,0,0,0,0,0,0,0,0,-73000,0,0,0,0,73000,-73000,-73000
060857,旭富富邦9B購01  ,0,0,0,0,0,0,0,0,0,-73000,0,0,0,21000,94000,-73000,-73000
061422,台積電元大9A購30,0,0,0,0,0,0,0,0,0,-74000,0,0,0,0,74000,-74000,-74000
062488,台光電永豐9B購02,0,0,0,0,0,0,0,0,0,-74000,0,0,0,16000,90000,-74000,-74000
06743P,創意永豐98售03  ,0,0,0,0,0,0,0,0,0,-74000,0,0,0,10000,84000,-74000,-74000
063448,聯發科統一9C購11,0,0,0,0,0,0,0,0,0,-74000,0,0,0,83000,157000,-74000,-74000
060474,中租元大9B購01  ,0,0,0,0,0,0,0,0,0,-74000,0,0,0,37000,111000,-74000,-74000
061183,友達國泰9B購02  ,0,0,0,0,0,0,0,0,0,-74000,0,0,0,24000,98000,-74000,-74000
060697,鴻海國泰9C購01  ,0,0,0,0,0,0,0,0,0,-74000,0,0,0,6000,80000,-74000,-74000
060944,國泰金國票9A購01,0,0,0,0,0,0,0,0,0,-74000,0,0,0,41000,115000,-74000,-74000
2534,宏盛            ,76000,150000,-74000,0,0,0,0,0,0,0,0,0,0,0,0,0,-74000
063587,漢唐永豐9B購02  ,0,0,0,0,0,0,0,0,0,-75000,0,0,0,0,75000,-75000,-75000
063340,英業達統一9B購01,0,0,0,0,0,0,0,0,0,-75000,0,0,0,12000,87000,-75000,-75000
063119,華通元大9B購07  ,0,0,0,0,0,0,0,0,0,-75000,0,0,0,135000,210000,-75000,-75000
062829,泰碩群益9B購01  ,0,0,0,0,0,0,0,0,0,-75000,0,0,0,0,75000,-75000,-75000
062432,上銀元大9B購04  ,0,0,0,0,0,0,0,0,0,-75000,0,0,0,8000,83000,-75000,-75000
062371,健策元大9B購08  ,0,0,0,0,0,0,0,0,0,-75000,0,0,0,14000,89000,-75000,-75000
062154,國巨凱基9C購02  ,0,0,0,0,0,0,0,0,0,-75000,0,0,0,0,75000,-75000,-75000
051539,瀚宇博國票97購01,0,0,0,0,0,0,0,0,0,-75000,0,0,0,0,75000,-75000,-75000
054265,GIS元大96購03   ,0,0,0,0,0,0,0,0,0,-75000,0,0,0,50000,125000,-75000,-75000
061141,臻鼎統一9A購01  ,0,0,0,0,0,0,0,0,0,-75000,0,0,0,70000,145000,-75000,-75000
058410,國巨兆豐99購03  ,0,0,0,0,0,0,0,0,0,-75000,0,0,0,9000,84000,-75000,-75000
057846,神達永豐98購01  ,0,0,0,0,0,0,0,0,0,-75000,0,0,0,0,75000,-75000,-75000
060008,華邦電群益9A購01,0,0,0,0,0,0,0,0,0,-75000,0,0,0,108000,183000,-75000,-75000
057729,華新科國泰99購04,0,0,0,0,0,0,0,0,0,-75000,0,0,0,2000,77000,-75000,-75000
2059,川湖            ,268000,351000,-83000,0,0,0,0,0,0,8000,9000,0,9000,0,1000,-1000,-75000
062246,力山元大9B購02  ,0,0,0,0,0,0,0,0,0,-76000,0,0,0,258000,334000,-76000,-76000
062365,台光電元大9B購03,0,0,0,0,0,0,0,0,0,-76000,0,0,0,2000,78000,-76000,-76000
061626,超眾群益9A購02  ,0,0,0,0,0,0,0,0,0,-76000,0,0,0,0,76000,-76000,-76000
063424,新日興凱基01購01,0,0,0,0,0,0,0,0,0,-76000,0,0,0,5000,81000,-76000,-76000
060421,華擎永豐9A購01  ,0,0,0,0,0,0,0,0,0,-76000,0,0,0,0,76000,-76000,-76000
058188,華擎永豐99購01  ,0,0,0,0,0,0,0,0,0,-76000,0,0,0,69000,145000,-76000,-76000
061117,美律國泰9C購01  ,0,0,0,0,0,0,0,0,0,-76000,0,0,0,46000,122000,-76000,-76000
4576,大銀微系統      ,52000,128000,-76000,0,0,0,0,0,0,0,0,0,0,0,0,0,-76000
1476,儒鴻            ,1004080,1079440,-75360,0,0,0,0,0,0,-1000,37000,63000,-26000,25000,0,25000,-76360
062903,燿華元大9B購04  ,0,0,0,0,0,0,0,0,0,-77000,0,0,0,0,77000,-77000,-77000
061707,超眾國票9B購01  ,0,0,0,0,0,0,0,0,0,-77000,0,0,0,109000,186000,-77000,-77000
062513,玉晶光國票9C購01,0,0,0,0,0,0,0,0,0,-77000,0,0,0,25000,102000,-77000,-77000
056724,臻鼎中信9A購01  ,0,0,0,0,0,0,0,0,0,-77000,0,0,0,190000,267000,-77000,-77000
058050,台郡元大99購05  ,0,0,0,0,0,0,0,0,0,-77000,0,0,0,57000,134000,-77000,-77000
07835P,台表科群益9A售02,0,0,0,0,0,0,0,0,0,-77000,0,0,0,259000,336000,-77000,-77000
058218,緯穎群益99購01  ,0,0,0,0,0,0,0,0,0,-77000,0,0,0,1000,78000,-77000,-77000
057860,金寶凱基98購01  ,0,0,0,0,0,0,0,0,0,-77000,0,0,0,23000,100000,-77000,-77000
060633,玉晶光富邦02購01,0,0,0,0,0,0,0,0,0,-77000,0,0,0,1811000,1888000,-77000,-77000
060900,超眾凱基9B購01  ,0,0,0,0,0,0,0,0,0,-77000,0,0,0,0,77000,-77000,-77000
062556,瑞昱凱基9B購02  ,0,0,0,0,0,0,0,0,0,-78000,0,0,0,80000,158000,-78000,-78000
062729,神達凱基9B購02  ,0,0,0,0,0,0,0,0,0,-78000,0,0,0,34000,112000,-78000,-78000
062672,兆豐金中信03購01,0,0,0,0,0,0,0,0,0,-78000,0,0,0,0,78000,-78000,-78000
062617,京鼎元大9B購01  ,0,0,0,0,0,0,0,0,0,-78000,0,0,0,104000,182000,-78000,-78000
063578,瑞祺元大9B購03  ,0,0,0,0,0,0,0,0,0,-78000,0,0,0,24000,102000,-78000,-78000
063445,金像電統一9B購01,0,15000,-15000,0,0,0,0,0,0,-63000,0,0,0,74000,137000,-63000,-78000
056353,鴻海元大99購02  ,0,0,0,0,0,0,0,0,0,-78000,0,0,0,0,78000,-78000,-78000
059847,喬山永豐99購01  ,0,0,0,0,0,0,0,0,0,-78000,0,0,0,0,78000,-78000,-78000
00675L,富邦臺灣加權正2 ,13000,45000,-32000,0,0,0,0,0,0,-46000,0,0,0,86000,132000,-46000,-78000
052004,泰碩國泰97購03  ,0,0,0,0,0,0,0,0,0,-78000,0,0,0,0,78000,-78000,-78000
058100,聯茂國泰99購02  ,0,0,0,0,0,0,0,0,0,-78000,0,0,0,104000,182000,-78000,-78000
061206,旺宏元大9A購12  ,0,0,0,0,0,0,0,0,0,-78000,0,0,0,20000,98000,-78000,-78000
058465,元石油中信01購01,0,0,0,0,0,0,0,0,0,-78000,0,0,0,0,78000,-78000,-78000
060897,健策凱基9A購04  ,0,0,0,0,0,0,0,0,0,-78000,0,0,0,2000,80000,-78000,-78000
07163P,臺股指群益99售14,0,0,0,0,0,0,0,0,0,-78000,0,0,0,45000,123000,-78000,-78000
06458P,玉晶光統一9A售02,0,0,0,0,0,0,0,0,0,-79000,0,0,0,0,79000,-79000,-79000
06953P,景碩統一9A售01  ,0,0,0,0,0,0,0,0,0,-79000,0,0,0,21000,100000,-79000,-79000
063163,京元電永豐9B購01,0,0,0,0,0,0,0,0,0,-79000,0,0,0,58000,137000,-79000,-79000
062356,國巨元大9B購10  ,0,0,0,0,0,0,0,0,0,-79000,0,0,0,0,79000,-79000,-79000
056589,康控統一98購01  ,0,0,0,0,0,0,0,0,0,-79000,0,0,0,0,79000,-79000,-79000
054909,福懋科康和97購01,0,0,0,0,0,0,0,0,0,-79000,0,0,0,0,79000,-79000,-79000
061266,國泰金凱基9B購01,0,0,0,0,0,0,0,0,0,-79000,0,0,0,0,79000,-79000,-79000
061354,瑞儀元大9A購01  ,0,0,0,0,0,0,0,0,0,-79000,0,0,0,22000,101000,-79000,-79000
058248,聯茂元大99購05  ,0,0,0,0,0,0,0,0,0,-79000,0,0,0,0,79000,-79000,-79000
057421,智原凱基98購04  ,0,0,0,0,0,0,0,0,0,-79000,0,0,0,0,79000,-79000,-79000
060396,友達國票9A購01  ,0,0,0,0,0,0,0,0,0,-79000,0,0,0,0,79000,-79000,-79000
060747,聯鈞國票9A購02  ,0,0,0,0,0,0,0,0,0,-79000,0,0,0,60000,139000,-79000,-79000
4943,康控-KY         ,251091,344000,-92909,0,0,0,0,0,0,13000,0,0,0,26000,13000,13000,-79909
062383,大立光國泰01購01,0,0,0,0,0,0,0,0,0,-80000,0,0,0,20000,100000,-80000,-80000
062194,遠東新中信9C購01,0,0,0,0,0,0,0,0,0,-80000,0,0,0,27000,107000,-80000,-80000
062741,立積國票9B購02  ,0,0,0,0,0,0,0,0,0,-80000,0,0,0,0,80000,-80000,-80000
063289,台表科元大9B購07,0,0,0,0,0,0,0,0,0,-80000,0,0,0,20000,100000,-80000,-80000
062940,華新科凱基9C購02,0,0,0,0,0,0,0,0,0,-80000,0,0,0,0,80000,-80000,-80000
063019,聯發科元大9C購01,0,0,0,0,0,0,0,0,0,-80000,0,0,0,14000,94000,-80000,-80000
06935P,神達元大98售02  ,0,0,0,0,0,0,0,0,0,-80000,0,0,0,20000,100000,-80000,-80000
06692P,瑞昱凱基98售03  ,0,0,0,0,0,0,0,0,0,-80000,0,0,0,0,80000,-80000,-80000
063585,台積電永豐9B購03,0,0,0,0,0,0,0,0,0,-80000,0,0,0,0,80000,-80000,-80000
054788,華新科群益98購02,0,0,0,0,0,0,0,0,0,-80000,0,0,0,0,80000,-80000,-80000
057011,日月光中信99購01,0,0,0,0,0,0,0,0,0,-80000,0,0,0,0,80000,-80000,-80000
057147,新日興國票99購01,0,0,0,0,0,0,0,0,0,-80000,0,0,0,24000,104000,-80000,-80000
056417,欣興中信98購01  ,0,0,0,0,0,0,0,0,0,-80000,0,0,0,20000,100000,-80000,-80000
045842,T50反1台新98購01,0,0,0,0,0,0,0,0,0,-80000,0,0,0,0,80000,-80000,-80000
052665,緯穎國票96購03  ,0,0,0,0,0,0,0,0,0,-80000,0,0,0,0,80000,-80000,-80000
035274,華新台新97購01  ,0,0,0,0,0,0,0,0,0,-80000,0,0,0,0,80000,-80000,-80000
03047X,元展44          ,0,0,0,0,0,0,0,0,0,-80000,0,0,0,0,80000,-80000,-80000
053035,台表科兆豐97購01,0,0,0,0,0,0,0,0,0,-80000,0,0,0,8000,88000,-80000,-80000
052849,可成統一97購01  ,0,0,0,0,0,0,0,0,0,-80000,0,0,0,0,80000,-80000,-80000
05463P,創意國票96售04  ,0,0,0,0,0,0,0,0,0,-80000,0,0,0,0,80000,-80000,-80000
059635,華新科凱基9A購06,0,0,0,0,0,0,0,0,0,-80000,0,0,0,20000,100000,-80000,-80000
060044,大立光群益99購09,0,0,0,0,0,0,0,0,0,-80000,0,0,0,0,80000,-80000,-80000
059531,華新科凱基9B購02,0,0,0,0,0,0,0,0,0,-80000,0,0,0,1000,81000,-80000,-80000
060432,達方永豐9A購01  ,0,0,0,0,0,0,0,0,0,-80000,0,0,0,114000,194000,-80000,-80000
057242,台郡凱基98購05  ,0,0,0,0,0,0,0,0,0,-80000,0,0,0,30000,110000,-80000,-80000
057979,華新科永豐98購03,0,0,0,0,0,0,0,0,0,-80000,0,0,0,0,80000,-80000,-80000
060665,康控凱基9A購01  ,0,0,0,0,0,0,0,0,0,-80000,0,0,0,5000,85000,-80000,-80000
06089P,矽創永豐97售01  ,0,0,0,0,0,0,0,0,0,-80000,0,0,0,2000,82000,-80000,-80000
07165P,臺股指群益99售16,0,0,0,0,0,0,0,0,0,-80000,0,0,0,0,80000,-80000,-80000
2029,盛餘            ,0,80000,-80000,0,0,0,0,0,0,0,0,0,0,0,0,0,-80000
063536,美食統一01購01  ,0,0,0,0,0,0,0,0,0,-81000,0,0,0,0,81000,-81000,-81000
06982P,義隆凱基99售02  ,0,0,0,0,0,0,0,0,0,-81000,0,0,0,65000,146000,-81000,-81000
062440,聯發科元大9B購11,0,0,0,0,0,0,0,0,0,-81000,0,0,0,22000,103000,-81000,-81000
062285,台勝科群益9B購01,0,0,0,0,0,0,0,0,0,-81000,0,0,0,0,81000,-81000,-81000
061450,嘉晶中信9A購01  ,0,0,0,0,0,0,0,0,0,-81000,0,0,0,30000,111000,-81000,-81000
056458,日月光凱基98購02,0,0,0,0,0,0,0,0,0,-81000,0,0,0,49000,130000,-81000,-81000
056714,晶相光永豐98購02,0,0,0,0,0,0,0,0,0,-81000,0,0,0,0,81000,-81000,-81000
056657,華邦電元大99購01,0,0,0,0,0,0,0,0,0,-81000,0,0,0,30000,111000,-81000,-81000
059112,上銀永豐99購01  ,0,0,0,0,0,0,0,0,0,-81000,0,0,0,21000,102000,-81000,-81000
059109,台積電富邦9C購03,0,0,0,0,0,0,0,0,0,-81000,0,0,0,360000,441000,-81000,-81000
058966,元油2X日盛99購03,0,0,0,0,0,0,0,0,0,-81000,0,0,0,0,81000,-81000,-81000
057820,華擎元大98購02  ,0,0,0,0,0,0,0,0,0,-81000,0,0,0,11000,92000,-81000,-81000
058658,瑞儀中信99購01  ,0,0,0,0,0,0,0,0,0,-81000,0,0,0,65000,146000,-81000,-81000
2107,厚生            ,25000,106000,-81000,0,0,0,0,0,0,0,0,0,0,0,0,0,-81000
1477,聚陽            ,1478000,1553000,-75000,0,0,0,0,0,0,-6000,43000,59000,-16000,12000,2000,10000,-81000
060653,全新群益9A購02  ,0,0,0,0,0,0,0,0,0,-81000,0,0,0,0,81000,-81000,-81000
062025,台達電群益9B購01,0,0,0,0,0,0,0,0,0,-82000,0,0,0,0,82000,-82000,-82000
062388,旭富國泰01購01  ,0,0,0,0,0,0,0,0,0,-82000,0,0,0,111000,193000,-82000,-82000
062129,世紀鋼統一02購01,0,0,0,0,0,0,0,0,0,-82000,0,0,0,15000,97000,-82000,-82000
063132,台表科元大9C購02,0,0,0,0,0,0,0,0,0,-82000,0,0,0,4000,86000,-82000,-82000
056481,創意元大98購01  ,0,0,0,0,0,0,0,0,0,-82000,0,0,0,91000,173000,-82000,-82000
059920,宏達電元大99購07,0,0,0,0,0,0,0,0,0,-82000,0,0,0,153000,235000,-82000,-82000
057086,立積統一9C購01  ,0,0,0,0,0,0,0,0,0,-82000,0,0,0,1000,83000,-82000,-82000
055295,瀚宇博元大97購02,0,0,0,0,0,0,0,0,0,-82000,0,0,0,52000,134000,-82000,-82000
053569,漢唐統一98購01  ,0,0,0,0,0,0,0,0,0,-82000,0,0,0,0,82000,-82000,-82000
054101,茂林國票97購04  ,0,0,0,0,0,0,0,0,0,-82000,0,0,0,20000,102000,-82000,-82000
051722,玉晶光永豐97購01,0,0,0,0,0,0,0,0,0,-82000,0,0,0,128000,210000,-82000,-82000
00752,中信中國50      ,0,0,0,0,0,0,0,0,0,-82000,0,0,0,898000,980000,-82000,-82000
060296,和碩元大9A購01  ,0,0,0,0,0,0,0,0,0,-82000,0,0,0,180000,262000,-82000,-82000
060509,宏達電元大9A購02,0,0,0,0,0,0,0,0,0,-82000,0,0,0,79000,161000,-82000,-82000
062084,台郡元大9B購04  ,0,0,0,0,0,0,0,0,0,-83000,0,0,0,93000,176000,-83000,-83000
00710B,FH彭博高收益債  ,0,0,0,0,0,0,0,0,0,-83000,0,0,0,110000,193000,-83000,-83000
059791,超眾元大99購06  ,0,0,0,0,0,0,0,0,0,-83000,0,0,0,3000,86000,-83000,-83000
056508,揚明光永豐98購01,0,0,0,0,0,0,0,0,0,-83000,0,0,0,0,83000,-83000,-83000
060503,技嘉元大9A購01  ,0,0,0,0,0,0,0,0,0,-83000,0,0,0,10000,93000,-83000,-83000
059693,智原永豐99購01  ,0,0,0,0,0,0,0,0,0,-83000,0,0,0,0,83000,-83000,-83000
057234,宏達電凱基98購05,0,0,0,0,0,0,0,0,0,-83000,0,0,0,8000,91000,-83000,-83000
060884,超眾中信9B購01  ,0,0,0,0,0,0,0,0,0,-83000,0,0,0,22000,105000,-83000,-83000
060890,大立光統一01購01,0,0,0,0,0,0,0,0,0,-83000,0,0,0,70000,153000,-83000,-83000
2017,官田鋼          ,12000,93000,-81000,0,0,0,0,0,0,-2000,0,2000,-2000,0,0,0,-83000
2388,威盛            ,72000,155000,-83000,0,0,0,0,0,0,0,0,0,0,0,0,0,-83000
07360P,台積電元大99售46,0,0,0,0,0,0,0,0,0,-83000,0,0,0,0,83000,-83000,-83000
063341,燿華統一9C購01  ,0,0,0,0,0,0,0,0,0,-84000,0,0,0,34000,118000,-84000,-84000
063391,南電兆豐9C購01  ,0,0,0,0,0,0,0,0,0,-84000,0,0,0,10000,94000,-84000,-84000
063538,神達統一9C購01  ,0,0,0,0,0,0,0,0,0,-84000,0,0,0,0,84000,-84000,-84000
056297,台光電元大97購04,0,0,0,0,0,0,0,0,0,-84000,0,0,0,0,84000,-84000,-84000
059821,美律凱基99購08  ,0,0,0,0,0,0,0,0,0,-84000,0,0,0,0,84000,-84000,-84000
056094,大立光元富97購03,0,0,0,0,0,0,0,0,0,-84000,0,0,0,92000,176000,-84000,-84000
059266,緯創中信01購01  ,0,0,0,0,0,0,0,0,0,-84000,0,0,0,10000,94000,-84000,-84000
060010,義隆群益99購02  ,0,0,0,0,0,0,0,0,0,-84000,0,0,0,140000,224000,-84000,-84000
063510,台表科群益9C購01,0,0,0,0,0,0,0,0,0,-85000,0,0,0,0,85000,-85000,-85000
063380,台表科永豐9B購03,0,0,0,0,0,0,0,0,0,-85000,0,0,0,0,85000,-85000,-85000
063252,緯穎元大9B購07  ,0,0,0,0,0,0,0,0,0,-85000,0,0,0,132000,217000,-85000,-85000
063044,滬深2X兆豐9C購01,0,0,0,0,0,0,0,0,0,-85000,0,0,0,0,85000,-85000,-85000
062816,華新科兆豐9B購01,0,0,0,0,0,0,0,0,0,-85000,0,0,0,0,85000,-85000,-85000
062812,國巨兆豐9B購03  ,0,0,0,0,0,0,0,0,0,-85000,0,0,0,0,85000,-85000,-85000
062558,義隆凱基9B購02  ,0,0,0,0,0,0,0,0,0,-85000,0,0,0,65000,150000,-85000,-85000
061416,聯茂群益9A購01  ,0,0,0,0,0,0,0,0,0,-85000,0,0,0,210000,295000,-85000,-85000
061547,禾伸堂群益9A購01,0,0,0,0,0,0,0,0,0,-85000,0,0,0,0,85000,-85000,-85000
056470,旺宏元大99購01  ,0,0,0,0,0,0,0,0,0,-85000,0,0,0,3000,88000,-85000,-85000
060146,健策國票9A購03  ,0,0,0,0,0,0,0,0,0,-85000,0,0,0,28000,113000,-85000,-85000
057567,嘉聯益富邦9A購01,0,0,0,0,0,0,0,0,0,-85000,0,0,0,434000,519000,-85000,-85000
058196,台塑中信99購01  ,0,0,0,0,0,0,0,0,0,-85000,0,0,0,0,85000,-85000,-85000
058734,康友永豐99購01  ,0,0,0,0,0,0,0,0,0,-85000,0,0,0,65000,150000,-85000,-85000
061190,力山永豐9A購02  ,0,0,0,0,0,0,0,0,0,-85000,0,0,0,20000,105000,-85000,-85000
07391P,台灣50國泰02售01,0,0,0,0,0,0,0,0,0,-85000,0,0,0,5000,90000,-85000,-85000
2431,聯昌            ,76000,161000,-85000,0,0,0,0,0,0,0,0,0,0,0,0,0,-85000
060722,矽格永豐9A購01  ,0,0,0,0,0,0,0,0,0,-85000,0,0,0,20000,105000,-85000,-85000
061971,力山元大9C購02  ,0,0,0,0,0,0,0,0,0,-86000,0,0,0,104000,190000,-86000,-86000
062596,緯穎統一01購02  ,0,0,0,0,0,0,0,0,0,-86000,0,0,0,24000,110000,-86000,-86000
062851,建準永豐9B購02  ,0,0,0,0,0,0,0,0,0,-86000,0,0,0,92000,178000,-86000,-86000
063385,可成中信9C購01  ,0,0,0,0,0,0,0,0,0,-86000,0,0,0,16000,102000,-86000,-86000
06949P,台表科元大99售01,0,0,0,0,0,0,0,0,0,-86000,0,0,0,189000,275000,-86000,-86000
06855P,聯發科富邦9A售01,0,0,0,0,0,0,0,0,0,-86000,0,0,0,114000,200000,-86000,-86000
060199,台郡元富9A購01  ,0,0,0,0,0,0,0,0,0,-86000,0,0,0,0,86000,-86000,-86000
056255,華新科元富97購05,0,0,0,0,0,0,0,0,0,-86000,0,0,0,1000,87000,-86000,-86000
053118,大立光中信9C購01,0,0,0,0,0,0,0,0,0,-86000,0,0,0,495000,581000,-86000,-86000
061173,T50反1凱基04購01,0,0,0,0,0,0,0,0,0,-86000,0,0,0,0,86000,-86000,-86000
061105,宏達電元大9A購04,0,0,0,0,0,0,0,0,0,-86000,0,0,0,81000,167000,-86000,-86000
4536,拓凱            ,22000,23000,-1000,0,0,0,20000,91000,-71000,-14000,0,0,0,0,14000,-14000,-86000
4725,信昌化          ,0,86000,-86000,0,0,0,0,0,0,0,0,0,0,0,0,0,-86000
3645,達邁            ,12000,98000,-86000,0,0,0,0,0,0,0,0,0,0,0,0,0,-86000
9940,信義            ,30000,108000,-78000,0,0,0,0,0,0,-8000,0,8000,-8000,0,0,0,-86000
2442,新美齊          ,33000,119000,-86000,0,0,0,0,0,0,0,0,0,0,0,0,0,-86000
1455,集盛            ,22000,108000,-86000,0,0,0,0,0,0,0,0,0,0,0,0,0,-86000
5269,祥碩            ,129131,189000,-59869,0,0,0,20000,41000,-21000,-6000,26000,24000,2000,4000,12000,-8000,-86869
063474,康控元大9B購04  ,0,0,0,0,0,0,0,0,0,-87000,0,0,0,5000,92000,-87000,-87000
063113,聯茂兆豐9B購01  ,0,0,0,0,0,0,0,0,0,-87000,0,0,0,122000,209000,-87000,-87000
062002,鴻海國泰01購01  ,0,0,0,0,0,0,0,0,0,-87000,0,0,0,17000,104000,-87000,-87000
056214,義隆國票99購01  ,0,0,0,0,0,0,0,0,0,-87000,0,0,0,5000,92000,-87000,-87000
055114,新日興凱基98購01,0,0,0,0,0,0,0,0,0,-87000,0,0,0,93000,180000,-87000,-87000
058775,台積電國票9A購02,0,0,0,0,0,0,0,0,0,-87000,0,0,0,5000,92000,-87000,-87000
058159,健策台新9A購01  ,0,0,0,0,0,0,0,0,0,-87000,0,0,0,5000,92000,-87000,-87000
07733P,台積電統一9B售10,0,0,0,0,0,0,0,0,0,-87000,0,0,0,0,87000,-87000,-87000
061490,茂林兆豐9B購01  ,0,0,0,0,0,0,0,0,0,-88000,0,0,0,0,88000,-88000,-88000
062442,華新科元大9C購02,0,0,0,0,0,0,0,0,0,-88000,0,0,0,80000,168000,-88000,-88000
063011,台積電元大9C購01,0,0,0,0,0,0,0,0,0,-88000,0,0,0,22000,110000,-88000,-88000
063462,金像電元大9C購01,0,0,0,0,0,0,0,0,0,-88000,0,0,0,17000,105000,-88000,-88000
059852,康控永豐99購02  ,0,0,0,0,0,0,0,0,0,-88000,0,0,0,51000,139000,-88000,-88000
053292,美律中信98購01  ,0,0,0,0,0,0,0,0,0,-88000,0,0,0,0,88000,-88000,-88000
058431,國巨統一9B購01  ,0,0,0,0,0,0,0,0,0,-88000,0,0,0,53000,141000,-88000,-88000
058885,元石油元大9C購02,0,0,0,0,0,0,0,0,0,-88000,0,0,0,0,88000,-88000,-88000
057580,玉山金中信9A購01,0,0,0,0,0,0,0,0,0,-88000,0,0,0,140000,228000,-88000,-88000
07505P,台勝科元大9A售01,0,0,0,0,0,0,0,0,0,-88000,0,0,0,44000,132000,-88000,-88000
063077,巨大永豐9B購03  ,0,0,0,0,0,0,0,0,0,-89000,0,0,0,8000,97000,-89000,-89000
061540,台積電群益9A購07,0,0,0,0,0,0,0,0,0,-89000,0,0,0,41000,130000,-89000,-89000
061695,群創群益9A購01  ,0,0,0,0,0,0,0,0,0,-89000,0,0,0,91000,180000,-89000,-89000
061912,台積電中信05購05,0,0,0,0,0,0,0,0,0,-89000,0,0,0,17000,106000,-89000,-89000
061891,力山永豐9B購01  ,0,0,0,0,0,0,0,0,0,-89000,0,0,0,89000,178000,-89000,-89000
061856,台郡國票9B購02  ,0,0,0,0,0,0,0,0,0,-89000,0,0,0,127000,216000,-89000,-89000
056723,國巨中信9A購01  ,0,0,0,0,0,0,0,0,0,-89000,0,0,0,0,89000,-89000,-89000
061374,力山永豐9A購04  ,0,0,0,0,0,0,0,0,0,-89000,0,0,0,76000,165000,-89000,-89000
059194,元金2X永豐99購01,0,0,0,0,0,0,0,0,0,-89000,0,0,0,11000,100000,-89000,-89000
061981,聯發科元大9B購02,0,0,0,0,0,0,0,0,0,-90000,0,0,0,30000,120000,-90000,-90000
062704,大毅元大9C購01  ,0,0,0,0,0,0,0,0,0,-90000,0,0,0,80000,170000,-90000,-90000
062689,華擎統一02購01  ,0,0,0,0,0,0,0,0,0,-90000,0,0,0,15000,105000,-90000,-90000
062257,聯發科元大9B購09,0,0,0,0,0,0,0,0,0,-90000,0,0,0,6000,96000,-90000,-90000
063184,台光電凱基9B購03,0,0,0,0,0,0,0,0,0,-90000,0,0,0,0,90000,-90000,-90000
056393,精元永豐98購01  ,0,0,0,0,0,0,0,0,0,-90000,0,0,0,0,90000,-90000,-90000
056981,全新群益99購03  ,0,0,0,0,0,0,0,0,0,-90000,0,0,0,0,90000,-90000,-90000
00712,FH富時不動產    ,52000,85000,-33000,0,0,0,0,0,0,-57000,0,0,0,66000,123000,-57000,-90000
057961,茂林元大9A購01  ,0,0,0,0,0,0,0,0,0,-90000,0,0,0,2000,92000,-90000,-90000
059074,元油2X元大9C購15,0,0,0,0,0,0,0,0,0,-90000,0,0,0,0,90000,-90000,-90000
058017,漢唐凱基99購01  ,0,0,0,0,0,0,0,0,0,-90000,0,0,0,5000,95000,-90000,-90000
057598,鴻海群益98購07  ,0,0,0,0,0,0,0,0,0,-90000,0,0,0,110000,200000,-90000,-90000
057799,世紀鋼兆豐98購01,0,0,0,0,0,0,0,0,0,-90000,0,0,0,3000,93000,-90000,-90000
07409P,台積電台新99售07,0,0,0,0,0,0,0,0,0,-90000,0,0,0,10000,100000,-90000,-90000
2329,華泰            ,563000,652000,-89000,0,0,0,0,0,0,-1000,0,1000,-1000,0,0,0,-90000
062344,力山群益9B購02  ,0,0,0,0,0,0,0,0,0,-91000,0,0,0,100000,191000,-91000,-91000
054540,泰鼎國票99購01  ,0,0,0,0,0,0,0,0,0,-91000,0,0,0,6000,97000,-91000,-91000
056688,聯詠統一98購01  ,0,0,0,0,0,0,0,0,0,-91000,0,0,0,0,91000,-91000,-91000
056304,創意元大97購03  ,0,0,0,0,0,0,0,0,0,-91000,0,0,0,0,91000,-91000,-91000
060431,復盛永豐9A購01  ,0,0,0,0,0,0,0,0,0,-91000,0,0,0,30000,121000,-91000,-91000
058532,禾伸堂元富99購01,0,0,0,0,0,0,0,0,0,-91000,0,0,0,4000,95000,-91000,-91000
057296,智原永豐98購01  ,0,0,0,0,0,0,0,0,0,-91000,0,0,0,0,91000,-91000,-91000
061391,晶技群益9A購02  ,0,0,0,0,0,0,0,0,0,-91000,0,0,0,0,91000,-91000,-91000
058831,茂林永豐99購01  ,0,0,0,0,0,0,0,0,0,-91000,0,0,0,20000,111000,-91000,-91000
3019,亞光            ,337000,431000,-94000,0,0,0,0,0,0,3000,28000,18000,10000,5000,12000,-7000,-91000
062373,泰鼎元大9B購01  ,0,0,0,0,0,0,0,0,0,-92000,0,0,0,49000,141000,-92000,-92000
062093,台積電富邦9C購11,0,0,0,0,0,0,0,0,0,-92000,0,0,0,40000,132000,-92000,-92000
062701,漢唐元大9B購01  ,0,0,0,0,0,0,0,0,0,-92000,0,0,0,154000,246000,-92000,-92000
061684,T50反1群益9A購06,0,0,0,0,0,0,0,0,0,-92000,0,0,0,12000,104000,-92000,-92000
061577,泰碩元大9A購03  ,0,0,0,0,0,0,0,0,0,-92000,0,0,0,23000,115000,-92000,-92000
057136,立積凱基98購02  ,0,0,0,0,0,0,0,0,0,-92000,0,0,0,22000,114000,-92000,-92000
061102,台積電元大9A購22,0,0,0,0,0,0,0,0,0,-92000,0,0,0,0,92000,-92000,-92000
058540,嘉聯益國泰9A購02,0,0,0,0,0,0,0,0,0,-92000,0,0,0,22000,114000,-92000,-92000
006208,富邦台50        ,3103,1000,2103,0,0,0,0,0,0,-95000,0,0,0,694000,789000,-95000,-92897
061617,微星群益9A購02  ,0,0,0,0,0,0,0,0,0,-93000,0,0,0,5000,98000,-93000,-93000
063442,金像電統一01購01,0,0,0,0,0,0,0,0,0,-93000,0,0,0,20000,113000,-93000,-93000
062886,中興電群益9B購01,0,0,0,0,0,0,0,0,0,-93000,0,0,0,0,93000,-93000,-93000
063461,金像電元大9B購03,0,0,0,0,0,0,0,0,0,-93000,0,0,0,2000,95000,-93000,-93000
054531,聯發科國泰97購02,0,0,0,0,0,0,0,0,0,-93000,0,0,0,0,93000,-93000,-93000
054908,群電康和97購01  ,0,0,0,0,0,0,0,0,0,-93000,0,0,0,1000,94000,-93000,-93000
057397,茂林中信9A購01  ,0,0,0,0,0,0,0,0,0,-93000,0,0,0,27000,120000,-93000,-93000
4540,全球傳動        ,100000,193000,-93000,0,0,0,0,0,0,0,0,0,0,0,0,0,-93000
056403,茂林群益98購01  ,0,0,0,0,0,0,0,0,0,-94000,0,0,0,0,94000,-94000,-94000
054627,義隆凱基98購01  ,0,0,0,0,0,0,0,0,0,-94000,0,0,0,213000,307000,-94000,-94000
060050,鴻海凱基9B購01  ,0,0,0,0,0,0,0,0,0,-94000,0,0,0,1000,95000,-94000,-94000
058604,華邦電元大99購03,0,0,0,0,0,0,0,0,0,-94000,0,0,0,165000,259000,-94000,-94000
3030,德律            ,176000,325000,-149000,0,0,0,0,0,0,55000,57000,2000,55000,0,0,0,-94000
063089,巨大凱基9C購01  ,0,0,0,0,0,0,0,0,0,-95000,0,0,0,159000,254000,-95000,-95000
063051,仁寶統一01購01  ,0,0,0,0,0,0,0,0,0,-95000,0,0,0,0,95000,-95000,-95000
061958,鴻海統一01購01  ,0,0,0,0,0,0,0,0,0,-95000,0,0,0,5000,100000,-95000,-95000
061878,茂林元大9B購01  ,0,0,0,0,0,0,0,0,0,-95000,0,0,0,5000,100000,-95000,-95000
00656R,國泰中國A50反1  ,0,0,0,0,0,0,0,0,0,-95000,0,0,0,37000,132000,-95000,-95000
047004,台積電統一99購01,0,0,0,0,0,0,0,0,0,-95000,0,0,0,0,95000,-95000,-95000
060310,瑞昱永豐9A購01  ,0,0,0,0,0,0,0,0,0,-95000,0,0,0,30000,125000,-95000,-95000
060026,聯發科富邦9B購05,0,0,0,0,0,0,0,0,0,-95000,0,0,0,5000,100000,-95000,-95000
060504,技嘉元大9A購02  ,0,0,0,0,0,0,0,0,0,-95000,0,0,0,46000,141000,-95000,-95000
060636,大毅永豐9A購02  ,0,0,0,0,0,0,0,0,0,-95000,0,0,0,0,95000,-95000,-95000
060912,華新科元大9A購10,0,0,0,0,0,0,0,0,0,-95000,0,0,0,10000,105000,-95000,-95000
061865,力山元大9B購01  ,0,0,0,0,0,0,0,0,0,-96000,0,0,0,121000,217000,-96000,-96000
062528,全新統一9C購01  ,0,0,0,0,0,0,0,0,0,-96000,0,0,0,0,96000,-96000,-96000
063096,勤誠國票9B購02  ,0,0,0,0,0,0,0,0,0,-96000,0,0,0,6000,102000,-96000,-96000
063175,燿華兆豐9C購01  ,0,0,0,0,0,0,0,0,0,-96000,0,0,0,0,96000,-96000,-96000
056978,技嘉群益99購01  ,0,0,0,0,0,0,0,0,0,-96000,0,0,0,9000,105000,-96000,-96000
061075,亞德客兆豐9A購01,0,0,0,0,0,0,0,0,0,-96000,0,0,0,20000,116000,-96000,-96000
063082,瑞昱凱基9B購04  ,0,0,0,0,0,0,0,0,0,-97000,0,0,0,90000,187000,-97000,-97000
062292,旭富永豐9B購01  ,0,0,0,0,0,0,0,0,0,-97000,0,0,0,0,97000,-97000,-97000
055142,健策永豐98購01  ,0,0,0,0,0,0,0,0,0,-97000,0,0,0,0,97000,-97000,-97000
055639,上銀元富97購02  ,0,0,0,0,0,0,0,0,0,-97000,0,0,0,527000,624000,-97000,-97000
056579,麗豐元大99購01  ,0,0,0,0,0,0,0,0,0,-97000,0,0,0,84000,181000,-97000,-97000
059203,勤誠永豐99購02  ,0,0,0,0,0,0,0,0,0,-97000,0,0,0,0,97000,-97000,-97000
058309,大毅元大99購02  ,0,0,0,0,0,0,0,0,0,-97000,0,0,0,43000,140000,-97000,-97000
057603,樺漢群益98購02  ,0,0,0,0,0,0,0,0,0,-97000,0,0,0,103000,200000,-97000,-97000
2425,承啟            ,27000,124000,-97000,0,0,0,0,0,0,0,0,0,0,0,0,0,-97000
07503P,禾伸堂元大9A售01,0,0,0,0,0,0,0,0,0,-97000,0,0,0,3000,100000,-97000,-97000
062541,臻鼎國泰01購01  ,0,0,0,0,0,0,0,0,0,-98000,0,0,0,56000,154000,-98000,-98000
061847,力山國票9B購01  ,0,0,0,0,0,0,0,0,0,-98000,0,0,0,59000,157000,-98000,-98000
062029,牧德群益9B購03  ,0,0,0,0,0,0,0,0,0,-98000,0,0,0,0,98000,-98000,-98000
061689,國巨群益9A購12  ,0,0,0,0,0,0,0,0,0,-98000,0,0,0,4000,102000,-98000,-98000
063027,台汽電元大9B購01,0,0,0,0,0,0,0,0,0,-98000,0,0,0,281000,379000,-98000,-98000
063201,廣達統一01購01  ,0,0,0,0,0,0,0,0,0,-98000,0,0,0,112000,210000,-98000,-98000
063615,瑞祺群益9B購03  ,0,0,0,0,0,0,0,0,0,-98000,0,0,0,4000,102000,-98000,-98000
057146,技嘉國票98購01  ,0,0,0,0,0,0,0,0,0,-98000,0,0,0,0,98000,-98000,-98000
05644P,大立光中信9A售03,0,0,0,0,0,0,0,0,0,-98000,0,0,0,60000,158000,-98000,-98000
060104,新日興元大99購03,0,0,0,0,0,0,0,0,0,-98000,0,0,0,163000,261000,-98000,-98000
059875,信邦凱基99購02  ,0,0,0,0,0,0,0,0,0,-98000,0,0,0,55000,153000,-98000,-98000
054771,茂林國票98購02  ,0,0,0,0,0,0,0,0,0,-98000,0,0,0,20000,118000,-98000,-98000
055841,南亞科元大97購04,0,0,0,0,0,0,0,0,0,-98000,0,0,0,50000,148000,-98000,-98000
058674,宏達電群益99購01,0,0,0,0,0,0,0,0,0,-98000,0,0,0,7000,105000,-98000,-98000
057579,長榮航中信9A購01,0,0,0,0,0,0,0,0,0,-98000,0,0,0,21000,119000,-98000,-98000
057502,訊芯群益98購02  ,0,0,0,0,0,0,0,0,0,-98000,0,0,0,0,98000,-98000,-98000
060364,奇力新元富9A購01,0,0,0,0,0,0,0,0,0,-98000,0,0,0,20000,118000,-98000,-98000
058759,義隆群益99購01  ,0,0,0,0,0,0,0,0,0,-98000,0,0,0,149000,247000,-98000,-98000
058082,美律群益98購05  ,0,0,0,0,0,0,0,0,0,-98000,0,0,0,0,98000,-98000,-98000
1734,杏輝            ,45000,143000,-98000,0,0,0,0,0,0,0,0,0,0,0,0,0,-98000
060675,南亞科元大9A購02,0,0,0,0,0,0,0,0,0,-98000,0,0,0,0,98000,-98000,-98000
3563,牧德            ,67000,176000,-109000,0,0,0,3000,0,3000,8000,4000,0,4000,13000,9000,4000,-98000
063188,TPK凱基9B購01   ,0,0,0,0,0,0,0,0,0,-99000,0,0,0,16000,115000,-99000,-99000
063434,和潤元富9B購01  ,0,0,0,0,0,0,0,0,0,-99000,0,0,0,83000,182000,-99000,-99000
063043,台灣50兆豐9B購02,0,0,0,0,0,0,0,0,0,-99000,0,0,0,0,99000,-99000,-99000
061549,泰碩群益9A購01  ,0,0,0,0,0,0,0,0,0,-99000,0,0,0,72000,171000,-99000,-99000
054221,華新科統一96購05,0,0,0,0,0,0,0,0,0,-99000,0,0,0,0,99000,-99000,-99000
055232,泰碩國票98購01  ,0,0,0,0,0,0,0,0,0,-99000,0,0,0,55000,154000,-99000,-99000
061368,南六國票9A購01  ,0,0,0,0,0,0,0,0,0,-99000,0,0,0,43000,142000,-99000,-99000
057808,旺宏元大99購05  ,0,0,0,0,0,0,0,0,0,-99000,0,0,0,1000,100000,-99000,-99000
060631,微星富邦9B購01  ,0,0,0,0,0,0,0,0,0,-99000,0,0,0,26000,125000,-99000,-99000
6177,達麗            ,61000,160000,-99000,0,0,0,0,0,0,0,0,0,0,0,0,0,-99000
061480,泰碩元大9B購01  ,0,0,0,0,0,0,0,0,0,-100000,0,0,0,18000,118000,-100000,-100000
061653,上証2X國票9A購02,0,0,0,0,0,0,0,0,0,-100000,0,0,0,0,100000,-100000,-100000
062009,聯發科國泰01購01,0,0,0,0,0,0,0,0,0,-100000,0,0,0,0,100000,-100000,-100000
061983,華新科元大9B購04,0,0,0,0,0,0,0,0,0,-100000,0,0,0,0,100000,-100000,-100000
061745,南電凱基9B購02  ,0,0,0,0,0,0,0,0,0,-100000,0,0,0,0,100000,-100000,-100000
06180P,禾伸堂群益97售01,0,0,0,0,0,0,0,0,0,-100000,0,0,0,0,100000,-100000,-100000
061791,康友群益9B購01  ,0,0,0,0,0,0,0,0,0,-100000,0,0,0,0,100000,-100000,-100000
062287,康友群益9B購02  ,0,0,0,0,0,0,0,0,0,-100000,0,0,0,0,100000,-100000,-100000
062269,葡萄王群益9B購01,0,0,0,0,0,0,0,0,0,-100000,0,0,0,0,100000,-100000,-100000
063018,聯發科元大9B購14,0,0,0,0,0,0,0,0,0,-100000,0,0,0,2000,102000,-100000,-100000
063243,聯發科元大9B購20,0,0,0,0,0,0,0,0,0,-100000,0,0,0,4000,104000,-100000,-100000
063244,華新科元大9B購11,0,0,0,0,0,0,0,0,0,-100000,0,0,0,5000,105000,-100000,-100000
05546P,全新元大97售01  ,0,0,0,0,0,0,0,0,0,-100000,0,0,0,0,100000,-100000,-100000
055610,光磊國票98購01  ,0,0,0,0,0,0,0,0,0,-100000,0,0,0,0,100000,-100000,-100000
054792,揚明光群益97購01,0,0,0,0,0,0,0,0,0,-100000,0,0,0,0,100000,-100000,-100000
057039,元油2X元大9B購07,0,0,0,0,0,0,0,0,0,-100000,0,0,0,0,100000,-100000,-100000
057114,台虹群益98購01  ,0,0,0,0,0,0,0,0,0,-100000,0,0,0,0,100000,-100000,-100000
056133,可成元大97購05  ,0,0,0,0,0,0,0,0,0,-100000,0,0,0,0,100000,-100000,-100000
059918,華新科元大99購20,0,0,0,0,0,0,0,0,0,-100000,0,0,0,0,100000,-100000,-100000
060190,國泰金元富9A購01,0,0,0,0,0,0,0,0,0,-100000,0,0,0,0,100000,-100000,-100000
059815,SP黃豆凱基9A購03,0,0,0,0,0,0,0,0,0,-100000,0,0,0,0,100000,-100000,-100000
056251,聯發科兆豐97購02,0,0,0,0,0,0,0,0,0,-100000,0,0,0,0,100000,-100000,-100000
056573,華新科元大99購06,0,0,0,0,0,0,0,0,0,-100000,0,0,0,0,100000,-100000,-100000
056731,國巨凱基98購04  ,0,0,0,0,0,0,0,0,0,-100000,0,0,0,0,100000,-100000,-100000
056770,國產元大98購02  ,0,0,0,0,0,0,0,0,0,-100000,0,0,0,41000,141000,-100000,-100000
054279,揚明光群益98購01,0,0,0,0,0,0,0,0,0,-100000,0,0,0,0,100000,-100000,-100000
054317,昇陽半凱基98購01,0,0,0,0,0,0,0,0,0,-100000,0,0,0,0,100000,-100000,-100000
052223,聯電凱基96購02  ,0,0,0,0,0,0,0,0,0,-100000,0,0,0,0,100000,-100000,-100000
054147,GIS元大96購02   ,0,0,0,0,0,0,0,0,0,-100000,0,0,0,0,100000,-100000,-100000
055979,聯鈞統一97購03  ,0,0,0,0,0,0,0,0,0,-100000,0,0,0,0,100000,-100000,-100000
053490,為升兆豐97購01  ,0,0,0,0,0,0,0,0,0,-100000,0,0,0,0,100000,-100000,-100000
053904,漢唐凱基97購01  ,0,0,0,0,0,0,0,0,0,-100000,0,0,0,65000,165000,-100000,-100000
057582,亞光中信9A購02  ,0,0,0,0,0,0,0,0,0,-100000,0,0,0,0,100000,-100000,-100000
060500,鴻海元大9A購12  ,0,0,0,0,0,0,0,0,0,-100000,0,0,0,0,100000,-100000,-100000
060566,聯詠富邦9C購01  ,0,0,0,0,0,0,0,0,0,-100000,0,0,0,100000,200000,-100000,-100000
061213,群創元大9A購05  ,0,0,0,0,0,0,0,0,0,-100000,0,0,0,0,100000,-100000,-100000
061056,臺指反國票02購01,0,0,0,0,0,0,0,0,0,-100000,0,0,0,100000,200000,-100000,-100000
059247,可成凱基99購05  ,0,0,0,0,0,0,0,0,0,-100000,0,0,0,1000,101000,-100000,-100000
6191,精成科          ,598000,695000,-97000,0,0,0,0,0,0,-3000,0,3000,-3000,0,0,0,-100000
060745,京元電國票9A購01,0,0,0,0,0,0,0,0,0,-100000,0,0,0,0,100000,-100000,-100000
1709,和益            ,188000,288000,-100000,0,0,0,0,0,0,0,0,0,0,0,0,0,-100000
07941P,國巨凱基9B售07  ,0,0,0,0,0,0,0,0,0,-100000,0,0,0,0,100000,-100000,-100000
062878,宏達電兆豐9B購01,0,0,0,0,0,0,0,0,0,-101000,0,0,0,86000,187000,-101000,-101000
063592,瑞祺永豐9B購02  ,0,0,0,0,0,0,0,0,0,-101000,0,0,0,0,101000,-101000,-101000
062081,華新科元大9B購06,0,0,0,0,0,0,0,0,0,-101000,0,0,0,0,101000,-101000,-101000
059807,大立光元富99購09,0,0,0,0,0,0,0,0,0,-101000,0,0,0,2000,103000,-101000,-101000
059981,聯發科元大99購36,0,0,0,0,0,0,0,0,0,-101000,0,0,0,50000,151000,-101000,-101000
057832,聯發科元富02購05,0,0,0,0,0,0,0,0,0,-101000,0,0,0,26000,127000,-101000,-101000
060681,華擎元大9A購02  ,0,0,0,0,0,0,0,0,0,-101000,0,0,0,0,101000,-101000,-101000
062346,智邦群益9B購02  ,0,0,0,0,0,0,0,0,0,-102000,0,0,0,1000,103000,-102000,-102000
062684,華新科統一01購02,0,0,0,0,0,0,0,0,0,-102000,0,0,0,0,102000,-102000,-102000
056762,亞德客元大98購01,0,0,0,0,0,0,0,0,0,-102000,0,0,0,2000,104000,-102000,-102000
056295,國巨元大97購16  ,0,0,0,0,0,0,0,0,0,-102000,0,0,0,0,102000,-102000,-102000
058648,聯陽永豐99購01  ,0,0,0,0,0,0,0,0,0,-102000,0,0,0,1000,103000,-102000,-102000
059700,鴻海凱基9A購16  ,0,0,0,0,0,0,0,0,0,-102000,0,0,0,4000,106000,-102000,-102000
060514,南電元大9A購02  ,0,0,0,0,0,0,0,0,0,-102000,0,0,0,76000,178000,-102000,-102000
058796,可成元大99購04  ,0,0,0,0,0,0,0,0,0,-102000,0,0,0,0,102000,-102000,-102000
062577,泰鼎群益9B購01  ,0,0,0,0,0,0,0,0,0,-103000,0,0,0,311000,414000,-103000,-103000
062369,創意元大9B購01  ,0,0,0,0,0,0,0,0,0,-103000,0,0,0,54000,157000,-103000,-103000
063127,TPK元大9B購02   ,0,0,0,0,0,0,0,0,0,-103000,0,0,0,58000,161000,-103000,-103000
057134,茂林凱基98購02  ,0,0,0,0,0,0,0,0,0,-103000,0,0,0,44000,147000,-103000,-103000
053932,華新科統一96購03,0,0,0,0,0,0,0,0,0,-103000,0,0,0,0,103000,-103000,-103000
00654R,富邦印度反1     ,0,120000,-120000,0,0,0,0,0,0,17000,0,0,0,22000,5000,17000,-103000
07807P,聯茂永豐9A售02  ,0,0,0,0,0,0,0,0,0,-103000,0,0,0,127000,230000,-103000,-103000
058909,神達元大99購03  ,35000,0,35000,0,0,0,0,0,0,-138000,0,0,0,317000,455000,-138000,-103000
060907,金像電元大9A購02,0,0,0,0,0,0,0,0,0,-103000,0,0,0,84000,187000,-103000,-103000
2607,榮運            ,22000,125000,-103000,0,0,0,0,0,0,0,0,0,0,0,0,0,-103000
063490,儒鴻富邦9C購01  ,0,0,0,0,0,0,0,0,0,-104000,0,0,0,140000,244000,-104000,-104000
051055,友達群益98購01  ,0,0,0,0,0,0,0,0,0,-104000,0,0,0,15000,119000,-104000,-104000
055916,奇鋐凱基99購01  ,0,0,0,0,0,0,0,0,0,-104000,0,0,0,50000,154000,-104000,-104000
061231,聚陽元大9A購02  ,0,0,0,0,0,0,0,0,0,-104000,0,0,0,46000,150000,-104000,-104000
057554,新日興凱基99購02,0,0,0,0,0,0,0,0,0,-104000,0,0,0,39000,143000,-104000,-104000
5225,東科-KY         ,39000,145000,-106000,0,0,0,0,0,0,2000,2000,0,2000,0,0,0,-104000
063630,智邦元大9B購09  ,0,0,0,0,0,0,0,0,0,-105000,0,0,0,4000,109000,-105000,-105000
062835,瑞儀群益9B購01  ,0,0,0,0,0,0,0,0,0,-105000,0,0,0,177000,282000,-105000,-105000
063023,華擎元大9B購02  ,0,0,0,0,0,0,0,0,0,-105000,0,0,0,20000,125000,-105000,-105000
056492,全新國泰9A購01  ,0,0,0,0,0,0,0,0,0,-105000,0,0,0,0,105000,-105000,-105000
056693,國產群益98購01  ,0,0,0,0,0,0,0,0,0,-105000,0,0,0,180000,285000,-105000,-105000
057406,茂林群益98購03  ,0,0,0,0,0,0,0,0,0,-105000,0,0,0,13000,118000,-105000,-105000
060030,晶相光永豐99購03,0,0,0,0,0,0,0,0,0,-105000,0,0,0,0,105000,-105000,-105000
060045,嘉晶群益99購02  ,0,0,0,0,0,0,0,0,0,-105000,0,0,0,0,105000,-105000,-105000
057987,大立光元富98購02,0,0,0,0,0,0,0,0,0,-105000,0,0,0,57000,162000,-105000,-105000
07649P,金像電永豐9A售02,0,0,0,0,0,0,0,0,0,-105000,0,0,0,45000,150000,-105000,-105000
06780P,義隆元大98售02  ,0,0,0,0,0,0,0,0,0,-106000,0,0,0,46000,152000,-106000,-106000
08125P,聯茂群益9B售02  ,0,0,0,0,0,0,0,0,0,-106000,0,0,0,74000,180000,-106000,-106000
4526,東台            ,0,108000,-108000,0,0,0,0,0,0,2000,2000,0,2000,0,0,0,-106000
063649,南六元大9C購02  ,0,0,0,0,0,0,0,0,0,-107000,0,0,0,7000,114000,-107000,-107000
060248,日月光元大9A購01,0,0,0,0,0,0,0,0,0,-107000,0,0,0,91000,198000,-107000,-107000
056184,南亞科統一97購03,0,0,0,0,0,0,0,0,0,-107000,0,0,0,0,107000,-107000,-107000
054550,旺宏凱基98購02  ,0,0,0,0,0,0,0,0,0,-107000,0,0,0,0,107000,-107000,-107000
058768,南港兆豐99購01  ,0,0,0,0,0,0,0,0,0,-107000,0,0,0,44000,151000,-107000,-107000
057725,台達電國泰9A購01,0,0,0,0,0,0,0,0,0,-107000,0,0,0,1000,108000,-107000,-107000
058732,矽格永豐99購01  ,0,0,0,0,0,0,0,0,0,-107000,0,0,0,15000,122000,-107000,-107000
057321,台泥群益98購01  ,0,0,0,0,0,0,0,0,0,-107000,0,0,0,74000,181000,-107000,-107000
060799,茂林永豐9A購01  ,0,0,0,0,0,0,0,0,0,-107000,0,0,0,3000,110000,-107000,-107000
053997,健策群益97購02  ,0,0,0,0,0,0,0,0,0,-108000,0,0,0,45000,153000,-108000,-108000
053055,聯詠國票97購01  ,0,0,0,0,0,0,0,0,0,-108000,0,0,0,0,108000,-108000,-108000
055824,臺股指國票97購11,0,0,0,0,0,0,0,0,0,-108000,0,0,0,0,108000,-108000,-108000
057249,華邦電統一9A購01,0,0,0,0,0,0,0,0,0,-108000,0,0,0,0,108000,-108000,-108000
058522,聯茂元大99購07  ,0,0,0,0,0,0,0,0,0,-108000,0,0,0,80000,188000,-108000,-108000
060629,鴻海富邦9B購01  ,0,0,0,0,0,0,0,0,0,-108000,0,0,0,0,108000,-108000,-108000
063226,康控群益9B購03  ,0,0,0,0,0,0,0,0,0,-109000,0,0,0,6000,115000,-109000,-109000
2605,新興            ,90000,199000,-109000,0,0,0,0,0,0,0,0,0,0,0,0,0,-109000
3059,華晶科          ,164000,273000,-109000,0,0,0,0,0,0,0,0,0,0,0,0,0,-109000
1806,冠軍            ,4000,113000,-109000,0,0,0,0,0,0,0,0,0,0,0,0,0,-109000
061906,統一中信9B購01  ,0,0,0,0,0,0,0,0,0,-110000,0,0,0,60000,170000,-110000,-110000
061515,泰碩永豐9A購03  ,0,0,0,0,0,0,0,0,0,-110000,0,0,0,0,110000,-110000,-110000
055987,台表科元富97購01,0,0,0,0,0,0,0,0,0,-110000,0,0,0,10000,120000,-110000,-110000
052066,華邦電兆豐96購01,0,0,0,0,0,0,0,0,0,-110000,0,0,0,0,110000,-110000,-110000
057056,立積元大99購02  ,0,0,0,0,0,0,0,0,0,-110000,0,0,0,0,110000,-110000,-110000
057111,立積群益98購02  ,0,0,0,0,0,0,0,0,0,-110000,0,0,0,0,110000,-110000,-110000
056243,創意群益97購03  ,0,0,0,0,0,0,0,0,0,-110000,0,0,0,0,110000,-110000,-110000
055335,健策兆豐98購01  ,0,0,0,0,0,0,0,0,0,-110000,0,0,0,0,110000,-110000,-110000
059533,富邦金凱基99購01,0,0,0,0,0,0,0,0,0,-110000,0,0,0,5000,115000,-110000,-110000
060565,大立光富邦01購01,0,0,0,0,0,0,0,0,0,-110000,0,0,0,0,110000,-110000,-110000
08214P,南六統一9B售03  ,0,0,0,0,0,0,0,0,0,-110000,0,0,0,0,110000,-110000,-110000
08173P,金像電凱基9B售02,0,0,0,0,0,0,0,0,0,-110000,0,0,0,20000,130000,-110000,-110000
062113,瑞祺國票9B購01  ,0,0,0,0,0,0,0,0,0,-111000,0,0,0,13000,124000,-111000,-111000
063541,華擎元富9B購02  ,0,0,0,0,0,0,0,0,0,-111000,0,0,0,0,111000,-111000,-111000
06904P,TPK凱基98售03   ,0,0,0,0,0,0,0,0,0,-111000,0,0,0,0,111000,-111000,-111000
056279,新日興富邦99購01,0,0,0,0,0,0,0,0,0,-111000,0,0,0,80000,191000,-111000,-111000
059566,台積電凱基9A購11,0,0,0,0,0,0,0,0,0,-111000,0,0,0,0,111000,-111000,-111000
060355,元金2X元富9C購01,0,0,0,0,0,0,0,0,0,-111000,0,0,0,6000,117000,-111000,-111000
058134,信邦元大99購01  ,0,15000,-15000,0,0,0,0,0,0,-96000,0,0,0,200000,296000,-96000,-111000
063343,美律統一9C購01  ,0,0,0,0,0,0,0,0,0,-112000,0,0,0,341000,453000,-112000,-112000
055244,國巨統一98購01  ,0,0,0,0,0,0,0,0,0,-112000,0,0,0,0,112000,-112000,-112000
058687,聯茂凱基9A購01  ,0,0,0,0,0,0,0,0,0,-112000,0,0,0,9000,121000,-112000,-112000
3022,威強電          ,83000,225000,-142000,0,0,0,0,0,0,30000,30000,0,30000,0,0,0,-112000
062990,台積電群益9B購06,0,0,0,0,0,0,0,0,0,-113000,0,0,0,109000,222000,-113000,-113000
063478,GIS元大9B購03   ,0,0,0,0,0,0,0,0,0,-113000,0,0,0,10000,123000,-113000,-113000
062233,神隆凱基9B購01  ,0,0,0,0,0,0,0,0,0,-113000,0,0,0,117000,230000,-113000,-113000
062223,大立光統一9C購04,0,0,0,0,0,0,0,0,0,-113000,0,0,0,0,113000,-113000,-113000
059906,臺指反元大9C購04,0,0,0,0,0,0,0,0,0,-113000,0,0,0,2000,115000,-113000,-113000
056451,可成凱基99購01  ,0,0,0,0,0,0,0,0,0,-113000,0,0,0,0,113000,-113000,-113000
054467,隆達凱基97購01  ,0,0,0,0,0,0,0,0,0,-113000,0,0,0,70000,183000,-113000,-113000
07595P,台灣50中信03售07,0,0,0,0,0,0,0,0,0,-113000,0,0,0,0,113000,-113000,-113000
06661P,玉晶光永豐98售05,0,0,0,0,0,0,0,0,0,-114000,0,0,0,25000,139000,-114000,-114000
063049,上海銀兆豐9B購01,0,0,0,0,0,0,0,0,0,-114000,0,0,0,8000,122000,-114000,-114000
059931,緯穎富邦9A購01  ,0,0,0,0,0,0,0,0,0,-114000,0,0,0,270000,384000,-114000,-114000
054791,泰碩群益99購02  ,0,0,0,0,0,0,0,0,0,-114000,0,0,0,76000,190000,-114000,-114000
1710,東聯            ,196000,310000,-114000,0,0,0,0,0,0,0,0,0,0,0,0,0,-114000
054828,正崴國泰99購01  ,0,0,0,0,0,0,0,0,0,-115000,0,0,0,0,115000,-115000,-115000
00641R,富邦日本反1     ,0,21000,-21000,0,0,0,0,0,0,-94000,0,0,0,135000,229000,-94000,-115000
060602,京元電凱基9A購01,0,0,0,0,0,0,0,0,0,-115000,0,0,0,0,115000,-115000,-115000
063379,帆宣永豐9B購01  ,0,0,0,0,0,0,0,0,0,-116000,0,0,0,0,116000,-116000,-116000
054307,高鐵凱基98購01  ,0,0,0,0,0,0,0,0,0,-116000,0,0,0,0,116000,-116000,-116000
055874,中環元富9A購01  ,0,0,0,0,0,0,0,0,0,-116000,0,0,0,0,116000,-116000,-116000
060453,儒鴻元大9A購02  ,0,0,0,0,0,0,0,0,0,-116000,0,0,0,32000,148000,-116000,-116000
057479,致茂元大98購03  ,0,0,0,0,0,0,0,0,0,-116000,0,0,0,0,116000,-116000,-116000
057834,聯發科元富02購07,0,0,0,0,0,0,0,0,0,-116000,0,0,0,16000,132000,-116000,-116000
07836P,大成鋼元大9A售01,0,0,0,0,0,0,0,0,0,-116000,0,0,0,30000,146000,-116000,-116000
1722,台肥            ,485000,1007000,-522000,0,0,0,369000,0,369000,37000,42000,0,42000,0,5000,-5000,-116000
060646,南電永豐9A購01  ,0,0,0,0,0,0,0,0,0,-116000,0,0,0,0,116000,-116000,-116000
063203,華新科統一9C購04,0,0,0,0,0,0,0,0,0,-117000,0,0,0,0,117000,-117000,-117000
063125,華擎元大9C購02  ,0,0,0,0,0,0,0,0,0,-117000,0,0,0,0,117000,-117000,-117000
06940P,旺宏永豐98售05  ,0,0,0,0,0,0,0,0,0,-117000,0,0,0,7000,124000,-117000,-117000
061665,旺宏中信9C購01  ,0,0,0,0,0,0,0,0,0,-117000,0,0,0,0,117000,-117000,-117000
06188P,大立光元富97售01,0,0,0,0,0,0,0,0,0,-117000,0,0,0,56000,173000,-117000,-117000
056939,康控元富98購01  ,0,0,0,0,0,0,0,0,0,-117000,0,0,0,19000,136000,-117000,-117000
00664R,國泰臺灣加權反1 ,0,0,0,0,0,0,0,0,0,-117000,0,0,0,720000,837000,-117000,-117000
060208,卜蜂康和9A購01  ,0,0,0,0,0,0,0,0,0,-117000,0,0,0,5000,122000,-117000,-117000
058828,大毅永豐99購01  ,0,0,0,0,0,0,0,0,0,-117000,0,0,0,0,117000,-117000,-117000
060452,儒鴻元大9A購01  ,0,0,0,0,0,0,0,0,0,-117000,0,0,0,3000,120000,-117000,-117000
062687,華擎統一01購02  ,0,0,0,0,0,0,0,0,0,-118000,0,0,0,35000,153000,-118000,-118000
063582,瑞祺國泰9C購01  ,0,0,0,0,0,0,0,0,0,-118000,0,0,0,42000,160000,-118000,-118000
063281,京元電元大9B購01,0,0,0,0,0,0,0,0,0,-118000,0,0,0,10000,128000,-118000,-118000
059951,台塑康和99購01  ,0,0,0,0,0,0,0,0,0,-118000,0,0,0,0,118000,-118000,-118000
059984,華新科元大99購21,0,0,0,0,0,0,0,0,0,-118000,0,0,0,0,118000,-118000,-118000
059919,宏達電元大99購06,0,0,0,0,0,0,0,0,0,-118000,0,0,0,52000,170000,-118000,-118000
055022,精元國泰99購01  ,0,0,0,0,0,0,0,0,0,-118000,0,0,0,0,118000,-118000,-118000
5243,乙盛-KY         ,76000,194000,-118000,0,0,0,0,0,0,0,0,0,0,0,0,0,-118000
07170P,臺股指國票99售07,0,0,0,0,0,0,0,0,0,-118000,0,0,0,264000,382000,-118000,-118000
062979,茂林元富9B購01  ,0,0,0,0,0,0,0,0,0,-119000,0,0,0,64000,183000,-119000,-119000
062977,健策元富9B購01  ,0,0,0,0,0,0,0,0,0,-119000,0,0,0,22000,141000,-119000,-119000
062567,祥碩中信9C購01  ,0,0,0,0,0,0,0,0,0,-119000,0,0,0,66000,185000,-119000,-119000
059830,台郡凱基99購05  ,0,0,0,0,0,0,0,0,0,-119000,0,0,0,130000,249000,-119000,-119000
048422,瑞昱元富96購02  ,0,0,0,0,0,0,0,0,0,-119000,0,0,0,0,119000,-119000,-119000
057606,健策統一98購03  ,0,0,0,0,0,0,0,0,0,-119000,0,0,0,35000,154000,-119000,-119000
059618,台積電日盛99購01,0,0,0,0,0,0,0,0,0,-119000,0,0,0,20000,139000,-119000,-119000
059458,鎧勝永豐99購01  ,0,0,0,0,0,0,0,0,0,-119000,0,0,0,0,119000,-119000,-119000
060913,宏達電元大9A購03,0,0,0,0,0,0,0,0,0,-119000,0,0,0,79000,198000,-119000,-119000
063681,深中小永豐9B購01,0,0,0,0,0,0,0,0,0,-120000,0,0,0,0,120000,-120000,-120000
059915,聯發科元大99購32,0,0,0,0,0,0,0,0,0,-120000,0,0,0,97000,217000,-120000,-120000
059675,大立光元富99購08,0,0,0,0,0,0,0,0,0,-120000,0,0,0,36000,156000,-120000,-120000
060048,元金2X凱基99購03,0,0,0,0,0,0,0,0,0,-120000,0,0,0,0,120000,-120000,-120000
059636,宏達電凱基99購05,0,0,0,0,0,0,0,0,0,-120000,0,0,0,8000,128000,-120000,-120000
057423,台郡凱基98購06  ,0,0,0,0,0,0,0,0,0,-120000,0,0,0,0,120000,-120000,-120000
057583,啟碁中信9A購01  ,0,0,0,0,0,0,0,0,0,-120000,0,0,0,0,120000,-120000,-120000
059348,日月光凱基99購01,0,0,0,0,0,0,0,0,0,-120000,0,0,0,0,120000,-120000,-120000
058445,旺宏富邦9C購01  ,0,0,0,0,0,0,0,0,0,-120000,0,0,0,147000,267000,-120000,-120000
061892,亞德客永豐9B購01,0,0,0,0,0,0,0,0,0,-121000,0,0,0,14000,135000,-121000,-121000
061182,南六凱基9A購01  ,0,0,0,0,0,0,0,0,0,-121000,0,0,0,18000,139000,-121000,-121000
060757,台積電元大9A購18,0,0,0,0,0,0,0,0,0,-121000,0,0,0,1000,122000,-121000,-121000
08065P,瑞昱凱基9B售03  ,0,0,0,0,0,0,0,0,0,-121000,0,0,0,0,121000,-121000,-121000
061802,勤誠永豐9B購01  ,0,0,0,0,0,0,0,0,0,-122000,0,0,0,3000,125000,-122000,-122000
056639,國產康和98購01  ,0,0,0,0,0,0,0,0,0,-122000,0,0,0,0,122000,-122000,-122000
061662,瑞儀永豐9A購02  ,0,0,0,0,0,0,0,0,0,-123000,0,0,0,43000,166000,-123000,-123000
061675,華新科元大9A購23,0,0,0,0,0,0,0,0,0,-123000,0,0,0,0,123000,-123000,-123000
063446,台光電統一01購02,0,0,0,0,0,0,0,0,0,-123000,0,0,0,10000,133000,-123000,-123000
063069,道瓊銀富邦05購01,0,0,0,0,0,0,0,0,0,-123000,0,0,0,0,123000,-123000,-123000
055085,大毅國票97購01  ,0,0,0,0,0,0,0,0,0,-123000,0,0,0,0,123000,-123000,-123000
060021,立積康和99購01  ,0,0,0,0,0,0,0,0,0,-123000,0,0,0,0,123000,-123000,-123000
08096P,大立光元富9B售04,0,0,0,0,0,0,0,0,0,-123000,0,0,0,107000,230000,-123000,-123000
08202P,台表科國泰01售04,0,0,0,0,0,0,0,0,0,-123000,0,0,0,0,123000,-123000,-123000
060654,大毅群益9B購01  ,0,0,0,0,0,0,0,0,0,-123000,0,0,0,4000,127000,-123000,-123000
060763,聯鈞元大9A購03  ,0,0,0,0,0,0,0,0,0,-123000,0,0,0,124000,247000,-123000,-123000
062341,台表科麥證9C購01,0,0,0,0,124000,-124000,0,0,0,-124000,0,0,0,0,124000,-124000,-124000
051503,玉晶光統一97購01,0,0,0,0,0,0,0,0,0,-124000,0,0,0,41000,165000,-124000,-124000
057760,聯發科凱基98購18,0,0,0,0,0,0,0,0,0,-124000,0,0,0,0,124000,-124000,-124000
058110,光寶科元富98購01,0,0,0,0,0,0,0,0,0,-124000,0,0,0,0,124000,-124000,-124000
4106,雃博            ,841000,960000,-119000,0,0,0,0,0,0,-5000,0,5000,-5000,0,0,0,-124000
062587,國巨統一9B購13  ,0,0,0,0,0,0,0,0,0,-125000,0,0,0,0,125000,-125000,-125000
062044,健策凱基9B購02  ,0,0,0,0,0,0,0,0,0,-125000,0,0,0,24000,149000,-125000,-125000
062853,大毅永豐9B購03  ,0,0,0,0,0,0,0,0,0,-125000,0,0,0,2000,127000,-125000,-125000
063671,GIS統一01購01   ,0,0,0,0,0,0,0,0,0,-125000,0,0,0,0,125000,-125000,-125000
051898,富邦金國泰97購01,0,0,0,0,0,0,0,0,0,-125000,0,0,0,0,125000,-125000,-125000
00650L,FH香港正2       ,0,13000,-13000,0,0,0,0,0,0,-112000,0,0,0,1010000,1122000,-112000,-125000
058676,聯茂群益99購01  ,0,0,0,0,0,0,0,0,0,-125000,0,0,0,225000,350000,-125000,-125000
050890,南電富邦99購01  ,0,0,0,0,0,0,0,0,0,-126000,0,0,0,0,126000,-126000,-126000
055183,聯鈞統一97購01  ,0,0,0,0,0,0,0,0,0,-126000,0,0,0,0,126000,-126000,-126000
059986,宏達電元大99購08,0,0,0,0,0,0,0,0,0,-126000,0,0,0,57000,183000,-126000,-126000
063479,南六元大9B購06  ,0,0,0,0,0,0,0,0,0,-127000,0,0,0,47000,174000,-127000,-127000
062907,可成元大9C購03  ,0,0,0,0,0,0,0,0,0,-127000,0,0,0,35000,162000,-127000,-127000
063350,台表科統一02購02,0,0,0,0,0,0,0,0,0,-127000,0,0,0,0,127000,-127000,-127000
00668,國泰美國道瓊    ,104000,0,104000,0,0,0,0,0,0,-231000,0,0,0,42000,273000,-231000,-127000
057199,台達電元富02購01,0,0,0,0,0,0,0,0,0,-127000,0,0,0,86000,213000,-127000,-127000
5388,中磊            ,110000,247000,-137000,0,0,0,0,0,0,10000,34000,0,34000,0,24000,-24000,-127000
055261,帆宣統一98購01  ,0,0,0,0,0,0,0,0,0,-128000,0,0,0,49000,177000,-128000,-128000
057428,正崴兆豐98購01  ,0,0,0,0,0,0,0,0,0,-128000,0,0,0,19000,147000,-128000,-128000
063363,鴻海富邦9B購02  ,0,0,0,0,0,0,0,0,0,-129000,0,0,0,0,129000,-129000,-129000
063575,矽格元大9B購02  ,0,0,0,0,0,0,0,0,0,-129000,0,0,0,3000,132000,-129000,-129000
055704,亞德客永豐97購04,0,0,0,0,0,0,0,0,0,-129000,0,0,0,0,129000,-129000,-129000
060031,旭富永豐99購02  ,0,0,0,0,0,0,0,0,0,-129000,0,0,0,15000,144000,-129000,-129000
062569,南電中信01購01  ,0,0,0,0,0,0,0,0,0,-130000,0,0,0,20000,150000,-130000,-130000
060099,宏達電元大99購09,0,0,0,0,0,0,0,0,0,-130000,0,0,0,78000,208000,-130000,-130000
061342,華新科元大9A購17,0,0,0,0,0,0,0,0,0,-130000,0,0,0,0,130000,-130000,-130000
058444,國巨富邦9B購01  ,0,0,0,0,0,0,0,0,0,-130000,0,0,0,0,130000,-130000,-130000
059140,大立光兆豐9A購02,0,0,0,0,0,0,0,0,0,-130000,0,0,0,0,130000,-130000,-130000
059326,康友元大99購01  ,0,0,0,0,0,0,0,0,0,-130000,0,0,0,5000,135000,-130000,-130000
060748,臻鼎國票9A購01  ,0,0,0,0,0,0,0,0,0,-130000,0,0,0,104000,234000,-130000,-130000
060817,華邦電台新9A購01,0,0,0,0,0,0,0,0,0,-130000,0,0,0,37000,167000,-130000,-130000
062426,大立光統一02購02,0,0,0,0,0,0,0,0,0,-131000,0,0,0,0,131000,-131000,-131000
062192,南六元大9B購01  ,0,0,0,0,0,0,0,0,0,-131000,0,0,0,35000,166000,-131000,-131000
062004,國巨國泰9C購03  ,0,0,0,0,0,0,0,0,0,-131000,0,0,0,18000,149000,-131000,-131000
063444,金像電統一03購01,0,0,0,0,0,0,0,0,0,-131000,0,0,0,110000,241000,-131000,-131000
057003,立積國票98購01  ,0,0,0,0,0,0,0,0,0,-131000,0,0,0,0,131000,-131000,-131000
060425,凌華永豐9A購01  ,0,0,0,0,0,0,0,0,0,-131000,0,0,0,296000,427000,-131000,-131000
060785,國巨富邦9B購04  ,0,0,0,0,0,0,0,0,0,-131000,0,0,0,37000,168000,-131000,-131000
063253,巨大元大9B購03  ,0,0,0,0,0,0,0,0,0,-132000,0,0,0,94000,226000,-132000,-132000
057532,智原元大98購03  ,0,0,0,0,0,0,0,0,0,-132000,0,0,0,38000,170000,-132000,-132000
060870,旭富群益9A購01  ,0,0,0,0,0,0,0,0,0,-132000,0,0,0,0,132000,-132000,-132000
07131P,緯穎元大99售06  ,0,0,0,0,0,0,0,0,0,-133000,0,0,0,209000,342000,-133000,-133000
062190,瀚宇博元大9B購01,0,0,0,0,0,0,0,0,0,-133000,0,0,0,78000,211000,-133000,-133000
054819,裕民元大9A購01  ,0,0,0,0,0,0,0,0,0,-133000,0,0,0,385000,518000,-133000,-133000
057833,聯發科元富02購06,0,0,0,0,0,0,0,0,0,-133000,0,0,0,28000,161000,-133000,-133000
062296,南六永豐9B購02  ,0,0,0,0,0,0,0,0,0,-134000,0,0,0,6000,140000,-134000,-134000
063583,GIS國泰01購01   ,0,0,0,0,0,0,0,0,0,-134000,0,0,0,0,134000,-134000,-134000
055254,聯詠統一97購03  ,0,0,0,0,0,0,0,0,0,-134000,0,0,0,0,134000,-134000,-134000
056682,鴻海統一98購10  ,0,0,0,0,0,0,0,0,0,-134000,0,0,0,5000,139000,-134000,-134000
060784,鴻海富邦9C購01  ,0,0,0,0,0,0,0,0,0,-134000,0,0,0,30000,164000,-134000,-134000
08153P,台表科統一9B售01,0,0,0,0,0,0,0,0,0,-134000,0,0,0,110000,244000,-134000,-134000
062728,健策凱基9B購04  ,0,0,0,0,0,0,0,0,0,-135000,0,0,0,25000,160000,-135000,-135000
061638,國泰金元大9A購03,0,0,0,0,0,0,0,0,0,-135000,0,0,0,0,135000,-135000,-135000
061545,華新科群益9A購09,0,0,0,0,0,0,0,0,0,-135000,0,0,0,0,135000,-135000,-135000
056189,樺漢統一97購02  ,0,0,0,0,0,0,0,0,0,-135000,0,0,0,0,135000,-135000,-135000
08009P,華擎統一9B售02  ,0,0,0,0,0,0,0,0,0,-135000,0,0,0,5000,140000,-135000,-135000
060924,大毅永豐9A購03  ,0,0,0,0,0,0,0,0,0,-135000,0,0,0,0,135000,-135000,-135000
062280,大立光群益9C購01,0,0,0,0,0,0,0,0,0,-136000,0,0,0,64000,200000,-136000,-136000
062927,同欣電國票9B購02,0,0,0,0,0,0,0,0,0,-136000,0,0,0,34000,170000,-136000,-136000
063093,國產國票9B購01  ,0,0,0,0,0,0,0,0,0,-136000,0,0,0,19000,155000,-136000,-136000
055919,景碩凱基98購02  ,0,0,0,0,0,0,0,0,0,-136000,0,0,0,10000,146000,-136000,-136000
054642,訊芯中信9A購01  ,0,0,0,0,0,0,0,0,0,-136000,0,0,0,0,136000,-136000,-136000
07922P,大立光群益9B售05,0,0,0,0,0,0,0,0,0,-136000,0,0,0,38000,174000,-136000,-136000
1532,勤美            ,110000,246000,-136000,0,0,0,0,0,0,0,0,0,0,0,0,0,-136000
063399,智原群益9B購01  ,0,0,0,0,0,0,0,0,0,-137000,0,0,0,15000,152000,-137000,-137000
062546,新日興永豐9B購01,0,0,0,0,0,0,0,0,0,-137000,0,0,0,75000,212000,-137000,-137000
055617,TPK國票98購04   ,0,0,0,0,0,0,0,0,0,-137000,0,0,0,91000,228000,-137000,-137000
057279,國揚元大98購01  ,0,0,0,0,0,0,0,0,0,-137000,0,0,0,62000,199000,-137000,-137000
061066,嘉晶凱基9B購01  ,0,0,0,0,0,0,0,0,0,-137000,0,0,0,32000,169000,-137000,-137000
6285,啟碁            ,380000,550000,-170000,0,0,0,0,0,0,33000,28000,0,28000,6000,1000,5000,-137000
062439,聯發科元大9B購10,0,0,0,0,0,0,0,0,0,-138000,0,0,0,16000,154000,-138000,-138000
00703,台新MSCI中國    ,3000,2000,1000,0,0,0,0,0,0,-139000,0,0,0,120000,259000,-139000,-138000
054349,同欣電國票97購02,0,0,0,0,0,0,0,0,0,-138000,0,0,0,90000,228000,-138000,-138000
061327,台郡凱基9A購02  ,0,0,0,0,0,0,0,0,0,-138000,0,0,0,0,138000,-138000,-138000
059255,臺股指凱基99購33,0,0,0,0,0,0,0,0,0,-138000,0,0,0,4000,142000,-138000,-138000
058663,瑞儀兆豐9A購01  ,0,0,0,0,0,0,0,0,0,-138000,0,0,0,97000,235000,-138000,-138000
07744P,奇力新凱基9A售05,0,0,0,0,0,0,0,0,0,-138000,0,0,0,40000,178000,-138000,-138000
061720,智邦國泰9C購01  ,0,0,0,0,0,0,0,0,0,-139000,0,0,0,140000,279000,-139000,-139000
063433,臻鼎元富9B購01  ,0,0,0,0,0,0,0,0,0,-139000,0,0,0,119000,258000,-139000,-139000
062751,華擎中信9C購01  ,0,0,0,0,0,0,0,0,0,-139000,0,0,0,16000,155000,-139000,-139000
054533,泰碩國泰98購01  ,0,0,0,0,0,0,0,0,0,-139000,0,0,0,127000,266000,-139000,-139000
060416,神隆永豐9A購01  ,0,0,0,0,0,0,0,0,0,-139000,0,0,0,0,139000,-139000,-139000
059350,樺漢凱基9A購01  ,0,0,0,0,0,0,0,0,0,-139000,0,0,0,218000,357000,-139000,-139000
058108,台郡台新99購01  ,0,0,0,0,0,0,0,0,0,-139000,0,0,0,9000,148000,-139000,-139000
061355,康友元大9A購03  ,0,0,0,0,0,0,0,0,0,-139000,0,0,0,0,139000,-139000,-139000
9919,康那香          ,4000,46000,-42000,0,0,0,0,0,0,-97000,25000,25000,0,0,97000,-97000,-139000
5871,中租-KY         ,3329604,3505052,-175448,0,0,0,25000,0,25000,11000,12000,8000,4000,7000,0,7000,-139448
062447,華擎元大9C購01  ,0,0,0,0,0,0,0,0,0,-140000,0,0,0,1000,141000,-140000,-140000
03669C,滬深2X元富09牛01,0,0,0,0,0,0,0,0,0,-140000,0,0,0,10000,150000,-140000,-140000
056104,義隆永豐97購01  ,0,0,0,0,0,0,0,0,0,-140000,0,0,0,2000,142000,-140000,-140000
061032,金像電永豐9A購03,0,0,0,0,0,0,0,0,0,-140000,0,0,0,216000,356000,-140000,-140000
060322,卜蜂群益9A購01  ,0,0,0,0,0,0,0,0,0,-140000,0,0,0,0,140000,-140000,-140000
057810,技嘉元大98購06  ,0,0,0,0,0,0,0,0,0,-140000,0,0,0,6000,146000,-140000,-140000
062384,聯詠國泰9C購01  ,0,0,0,0,0,0,0,0,0,-141000,0,0,0,73000,214000,-141000,-141000
061581,貿聯元大9A購05  ,0,0,0,0,0,0,0,0,0,-141000,0,0,0,115000,256000,-141000,-141000
061803,巨大永豐9B購01  ,0,0,0,0,0,0,0,0,0,-141000,0,0,0,2000,143000,-141000,-141000
060298,鎧勝元大9C購01  ,0,15000,-15000,0,0,0,0,0,0,-126000,0,0,0,75000,201000,-126000,-141000
061007,聯詠兆豐9A購01  ,0,0,0,0,0,0,0,0,0,-141000,0,0,0,15000,156000,-141000,-141000
1474,弘裕            ,203000,345000,-142000,0,0,0,0,0,0,0,0,0,0,0,0,0,-142000
058955,台積電國票9A購04,0,0,0,0,0,0,0,0,0,-144000,0,0,0,90000,234000,-144000,-144000
057553,景碩凱基98購03  ,0,0,0,0,0,0,0,0,0,-144000,0,0,0,0,144000,-144000,-144000
062876,全新兆豐9B購01  ,0,0,0,0,0,0,0,0,0,-145000,0,0,0,0,145000,-145000,-145000
063025,超眾元大9B購01  ,0,0,0,0,0,0,0,0,0,-145000,0,0,0,169000,314000,-145000,-145000
07034P,大立光元富99售03,0,0,0,0,0,0,0,0,0,-145000,0,0,0,3000,148000,-145000,-145000
052003,泰碩國泰97購02  ,0,0,0,0,0,0,0,0,0,-145000,0,0,0,0,145000,-145000,-145000
061898,茂林永豐9B購01  ,0,0,0,0,0,0,0,0,0,-146000,0,0,0,0,146000,-146000,-146000
056699,光罩國泰99購01  ,0,0,0,0,0,0,0,0,0,-146000,0,0,0,25000,171000,-146000,-146000
060328,可成群益9A購06  ,0,0,0,0,0,0,0,0,0,-146000,0,0,0,25000,171000,-146000,-146000
05875P,旺宏群益98售01  ,0,0,0,0,0,0,0,0,0,-146000,0,0,0,60000,206000,-146000,-146000
5215,科嘉-KY         ,408000,356000,52000,0,0,0,0,200000,-200000,2000,2000,0,2000,0,0,0,-146000
061703,信邦國票9A購01  ,0,0,0,0,0,0,0,0,0,-147000,0,0,0,40000,187000,-147000,-147000
08144P,臺股指凱基02售03,0,0,0,0,0,0,0,0,0,-147000,0,0,0,0,147000,-147000,-147000
06839P,玉晶光統一9A售05,0,0,0,0,0,0,0,0,0,-148000,0,0,0,27000,175000,-148000,-148000
054446,美食兆豐97購01  ,0,0,0,0,0,0,0,0,0,-148000,0,0,0,215000,363000,-148000,-148000
058947,SGBR2X群益9B購02,0,0,0,0,0,0,0,0,0,-148000,0,0,0,47000,195000,-148000,-148000
059639,大立光凱基9A購06,0,0,0,0,0,0,0,0,0,-148000,0,0,0,0,148000,-148000,-148000
1434,福懋            ,6198040,6400303,-202263,0,0,0,0,3000,-3000,57000,57000,0,57000,0,0,0,-148263
056937,智原元富98購01  ,0,0,0,0,0,0,0,0,0,-149000,0,0,0,88000,237000,-149000,-149000
060429,南六永豐9A購01  ,0,0,0,0,0,0,0,0,0,-149000,0,0,0,13000,162000,-149000,-149000
061162,南電群益9A購02  ,0,0,0,0,0,0,0,0,0,-149000,0,0,0,0,149000,-149000,-149000
063420,奇力新凱基9B購03,0,0,0,0,0,0,0,0,0,-150000,0,0,0,0,150000,-150000,-150000
062435,國巨元大9B購13  ,0,0,0,0,0,0,0,0,0,-150000,0,0,0,0,150000,-150000,-150000
055891,鴻海統一9A購01  ,0,0,0,0,0,0,0,0,0,-150000,0,0,0,0,150000,-150000,-150000
053458,聯詠國泰97購01  ,0,0,0,0,0,0,0,0,0,-150000,0,0,0,0,150000,-150000,-150000
052542,友達元富98購01  ,0,0,0,0,0,0,0,0,0,-150000,0,0,0,0,150000,-150000,-150000
057024,義隆凱基99購01  ,0,0,0,0,0,0,0,0,0,-150000,0,0,0,24000,174000,-150000,-150000
056991,牧德兆豐98購01  ,0,0,0,0,0,0,0,0,0,-150000,0,0,0,300000,450000,-150000,-150000
057696,聯電群益9A購01  ,0,0,0,0,0,0,0,0,0,-150000,0,0,0,0,150000,-150000,-150000
060025,台積電富邦9C購06,0,0,0,0,0,0,0,0,0,-150000,0,0,0,0,150000,-150000,-150000
060736,旺宏統一01購01  ,0,0,0,0,0,0,0,0,0,-150000,0,0,0,16000,166000,-150000,-150000
9955,佳龍            ,105000,246000,-141000,0,0,0,0,0,0,-9000,0,9000,-9000,0,0,0,-150000
061866,力山元大9C購01  ,0,0,0,0,0,0,0,0,0,-151000,0,0,0,149000,300000,-151000,-151000
059643,日月光凱基99購02,0,0,0,0,0,0,0,0,0,-151000,0,0,0,31000,182000,-151000,-151000
058135,景碩元大99購01  ,0,0,0,0,0,0,0,0,0,-151000,0,0,0,146000,297000,-151000,-151000
2451,創見            ,244000,546502,-302502,0,0,0,85000,0,85000,66000,39000,0,39000,27000,0,27000,-151502
058820,致茂國泰9B購01  ,0,0,0,0,0,0,0,0,0,-152000,0,0,0,30000,182000,-152000,-152000
057511,健策統一98購02  ,0,0,0,0,0,0,0,0,0,-152000,0,0,0,62000,214000,-152000,-152000
062380,巨大元大9B購01  ,0,0,0,0,0,0,0,0,0,-153000,0,0,0,46000,199000,-153000,-153000
062542,南電國泰9C購01  ,0,0,0,0,0,0,0,0,0,-154000,0,0,0,17000,171000,-154000,-154000
062649,緯穎富邦9B購03  ,0,0,0,0,0,0,0,0,0,-154000,0,0,0,0,154000,-154000,-154000
063174,臺股指中信01購04,0,0,0,0,0,0,0,0,0,-154000,0,0,0,50000,204000,-154000,-154000
057109,信邦群益98購01  ,0,0,0,0,0,0,0,0,0,-154000,0,0,0,76000,230000,-154000,-154000
059841,國巨富邦9C購01  ,0,0,0,0,0,0,0,0,0,-154000,0,0,0,504000,658000,-154000,-154000
049700,瀚宇博元大97購01,0,0,0,0,0,0,0,0,0,-154000,0,0,0,134000,288000,-154000,-154000
056846,晶相光元富98購01,0,0,0,0,0,0,0,0,0,-154000,0,0,0,24000,178000,-154000,-154000
060424,中租永豐9A購01  ,0,0,0,0,0,0,0,0,0,-155000,0,0,0,86000,241000,-155000,-155000
060914,健策元大9A購03  ,0,0,0,0,0,0,0,0,0,-155000,0,0,0,2000,157000,-155000,-155000
062875,瑞昱兆豐9C購01  ,0,0,0,0,0,0,0,0,0,-156000,0,0,0,194000,350000,-156000,-156000
062881,緯創兆豐9C購01  ,0,0,0,0,0,0,0,0,0,-156000,0,0,0,95000,251000,-156000,-156000
03050X,元展47          ,0,0,0,0,0,0,0,0,0,-156000,0,0,0,6000,162000,-156000,-156000
059786,全新元大99購06  ,0,0,0,0,0,0,0,0,0,-156000,0,0,0,13000,169000,-156000,-156000
062315,健策凱基9C購01  ,0,0,0,0,0,0,0,0,0,-157000,0,0,0,43000,200000,-157000,-157000
057536,康控元大99購03  ,0,0,0,0,0,0,0,0,0,-157000,0,0,0,5000,162000,-157000,-157000
057874,可成元大99購02  ,0,0,0,0,0,0,0,0,0,-157000,0,0,0,43000,200000,-157000,-157000
058413,義隆兆豐99購01  ,0,0,0,0,0,0,0,0,0,-157000,0,0,0,258000,415000,-157000,-157000
061214,華擎元大9A購04  ,0,0,0,0,0,0,0,0,0,-157000,0,0,0,4000,161000,-157000,-157000
061738,聯發科凱基9B購04,0,0,0,0,0,0,0,0,0,-158000,0,0,0,0,158000,-158000,-158000
056206,泰鼎永豐97購01  ,0,0,0,0,0,0,0,0,0,-158000,0,0,0,2000,160000,-158000,-158000
057055,立積元大99購01  ,0,0,0,0,0,0,0,0,0,-158000,0,0,0,16000,174000,-158000,-158000
054088,華新群益98購02  ,0,0,0,0,0,0,0,0,0,-158000,0,0,0,281000,439000,-158000,-158000
057278,可成元大98購06  ,0,0,0,0,0,0,0,0,0,-158000,0,0,0,17000,175000,-158000,-158000
058240,景碩元大99購04  ,0,0,0,0,0,0,0,0,0,-158000,0,0,0,84000,242000,-158000,-158000
060347,大立光統一02購01,0,0,0,0,0,0,0,0,0,-158000,0,0,0,20000,178000,-158000,-158000
1712,興農            ,4000,162000,-158000,0,0,0,0,0,0,0,0,0,0,0,0,0,-158000
062708,立積元大9B購01  ,0,0,0,0,0,0,0,0,0,-159000,0,0,0,0,159000,-159000,-159000
062798,台光電統一9B購01,0,0,0,0,0,0,0,0,0,-159000,0,0,0,18000,177000,-159000,-159000
063195,訊連元富9B購01  ,0,0,0,0,0,0,0,0,0,-159000,0,0,0,7000,166000,-159000,-159000
055958,台光電元大97購02,0,0,0,0,0,0,0,0,0,-159000,0,0,0,0,159000,-159000,-159000
00693U,街口S&P黃豆     ,57000,0,57000,0,0,0,0,0,0,-216000,0,0,0,0,216000,-216000,-159000
2239,英利-KY         ,278000,437850,-159850,0,0,0,0,0,0,0,0,0,0,0,0,0,-159850
062327,燿華統一9B購02  ,0,0,0,0,0,0,0,0,0,-160000,0,0,0,0,160000,-160000,-160000
061963,台積電統一01購04,0,0,0,0,0,0,0,0,0,-160000,0,0,0,5000,165000,-160000,-160000
057072,日月光永豐98購01,0,0,0,0,0,0,0,0,0,-160000,0,0,0,37000,197000,-160000,-160000
057135,立積凱基98購01  ,0,0,0,0,0,0,0,0,0,-160000,0,0,0,0,160000,-160000,-160000
060420,神基永豐9A購01  ,0,0,0,0,0,0,0,0,0,-160000,0,0,0,0,160000,-160000,-160000
059054,國巨凱基99購11  ,0,0,0,0,0,0,0,0,0,-160000,0,0,0,0,160000,-160000,-160000
062003,國巨國泰01購01  ,0,0,0,0,0,0,0,0,0,-161000,0,0,0,58000,219000,-161000,-161000
055653,聯詠元富01購02  ,0,0,0,0,0,0,0,0,0,-161000,0,0,0,19000,180000,-161000,-161000
059005,嘉晶元大99購06  ,0,0,0,0,0,0,0,0,0,-161000,0,0,0,414000,575000,-161000,-161000
057346,鴻海統一98購13  ,0,0,0,0,0,0,0,0,0,-161000,0,0,0,0,161000,-161000,-161000
07430P,臺股指國票9A售02,0,0,0,0,0,0,0,0,0,-161000,0,0,0,0,161000,-161000,-161000
07432P,臺股指國票9A售04,0,0,0,0,0,0,0,0,0,-161000,0,0,0,0,161000,-161000,-161000
059631,京元電凱基99購02,0,0,0,0,0,0,0,0,0,-162000,0,0,0,3000,165000,-162000,-162000
058517,景碩元大99購06  ,0,0,0,0,0,0,0,0,0,-162000,0,0,0,54000,216000,-162000,-162000
9103,美德醫療-DR     ,5000,167000,-162000,0,0,0,0,0,0,0,0,0,0,0,0,0,-162000
06398P,禾伸堂凱基97售02,0,0,0,0,0,0,0,0,0,-163000,0,0,0,0,163000,-163000,-163000
056232,瑞儀凱基98購01  ,0,0,0,0,0,0,0,0,0,-163000,0,0,0,0,163000,-163000,-163000
056935,華新科元富98購02,0,0,0,0,0,0,0,0,0,-163000,0,0,0,0,163000,-163000,-163000
060874,中鋼中信02購01  ,0,0,0,0,0,0,0,0,0,-164000,0,0,0,10000,174000,-164000,-164000
061974,光寶科元大9B購01,0,0,0,0,0,0,0,0,0,-165000,0,0,0,89000,254000,-165000,-165000
062711,台表科元大9B購05,0,0,0,0,0,0,0,0,0,-165000,0,0,0,31000,196000,-165000,-165000
057887,智原群益98購04  ,0,0,0,0,0,0,0,0,0,-165000,0,0,0,80000,245000,-165000,-165000
060992,健策元大9A購05  ,0,0,0,0,0,0,0,0,0,-166000,0,0,0,9000,175000,-166000,-166000
06570P,大立光永豐98售01,0,0,0,0,0,0,0,0,0,-167000,0,0,0,11000,178000,-167000,-167000
063364,聯發科富邦01購02,0,0,0,0,0,0,0,0,0,-167000,0,0,0,1000,168000,-167000,-167000
055389,國巨統一98購02  ,0,0,0,0,0,0,0,0,0,-167000,0,0,0,0,167000,-167000,-167000
057370,可成元大98購07  ,0,0,0,0,0,0,0,0,0,-167000,0,0,0,1000,168000,-167000,-167000
060367,緯穎元富9A購02  ,0,0,0,0,0,0,0,0,0,-167000,0,0,0,37000,204000,-167000,-167000
4960,誠美材          ,87000,254000,-167000,0,0,0,0,0,0,0,0,0,0,0,0,0,-167000
07467P,上銀元大9A售03  ,0,0,0,0,0,0,0,0,0,-167000,0,0,0,28000,195000,-167000,-167000
07678P,大立光群益9A售03,0,0,0,0,0,0,0,0,0,-167000,0,0,0,8000,175000,-167000,-167000
062457,京元電群益9B購01,0,0,0,0,0,0,0,0,0,-168000,0,0,0,10000,178000,-168000,-168000
062366,義隆元大9B購04  ,0,0,0,0,0,0,0,0,0,-168000,0,0,0,96000,264000,-168000,-168000
061637,華新科元大9A購22,0,0,0,0,0,0,0,0,0,-168000,0,0,0,0,168000,-168000,-168000
00673R,元大S&P原油反1  ,0,0,0,0,0,0,0,0,0,-169000,0,0,0,46000,215000,-169000,-169000
061395,健策統一9C購02  ,0,0,0,0,0,0,0,0,0,-169000,0,0,0,115000,284000,-169000,-169000
061415,健策群益9A購04  ,0,0,0,0,0,0,0,0,0,-170000,0,0,0,4000,174000,-170000,-170000
061775,臺指反國票9B購04,0,0,0,0,0,0,0,0,0,-170000,0,0,0,230000,400000,-170000,-170000
062561,瀚宇博凱基9B購01,0,0,0,0,0,0,0,0,0,-170000,0,0,0,44000,214000,-170000,-170000
063259,廣達富邦9C購01  ,0,0,0,0,0,0,0,0,0,-170000,0,0,0,10000,180000,-170000,-170000
052424,泰碩國票97購01  ,0,0,0,0,0,0,0,0,0,-170000,0,0,0,0,170000,-170000,-170000
054137,聯詠元大97購02  ,0,0,0,0,0,0,0,0,0,-170000,0,0,0,20000,190000,-170000,-170000
060089,台積電元大99購54,0,0,0,0,0,0,0,0,0,-170000,0,0,0,0,170000,-170000,-170000
060111,臻鼎元大99購04  ,0,0,0,0,0,0,0,0,0,-170000,0,0,0,6000,176000,-170000,-170000
07842P,力成元大9A售01  ,0,0,0,0,0,0,0,0,0,-170000,0,0,0,97000,267000,-170000,-170000
059307,T50反1元大99購06,0,0,0,0,0,0,0,0,0,-170000,0,0,0,101000,271000,-170000,-170000
057334,技嘉國票98購02  ,0,0,0,0,0,0,0,0,0,-170000,0,0,0,0,170000,-170000,-170000
07643P,禾伸堂凱基9A售02,0,0,0,0,0,0,0,0,0,-170000,0,0,0,30000,200000,-170000,-170000
07635P,世芯永豐9A售05  ,0,0,0,0,0,0,0,0,0,-170000,0,0,0,60000,230000,-170000,-170000
4906,正文            ,142000,234000,-92000,0,0,0,0,0,0,-78000,7000,7000,0,3000,81000,-78000,-170000
055176,大毅統一98購02  ,0,0,0,0,0,0,0,0,0,-171000,0,0,0,12000,183000,-171000,-171000
060157,致茂永豐9A購02  ,0,0,0,0,0,0,0,0,0,-171000,0,0,0,13000,184000,-171000,-171000
07794P,智邦國票9A售03  ,0,0,0,0,0,0,0,0,0,-171000,0,0,0,20000,191000,-171000,-171000
057054,立積元大98購03  ,0,0,0,0,0,0,0,0,0,-172000,0,0,0,98000,270000,-172000,-172000
059298,大立光元富9C購02,0,0,0,0,0,0,0,0,0,-172000,0,0,0,51000,223000,-172000,-172000
058829,華新科永豐99購04,0,0,0,0,0,0,0,0,0,-172000,0,0,0,130000,302000,-172000,-172000
057674,台郡元大99購03  ,0,0,0,0,0,0,0,0,0,-172000,0,0,0,72000,244000,-172000,-172000
062992,聯發科群益9B購09,0,0,0,0,0,0,0,0,0,-173000,0,0,0,0,173000,-173000,-173000
062671,國泰金中信03購01,0,0,0,0,0,0,0,0,0,-173000,0,0,0,0,173000,-173000,-173000
054890,聯鈞統一99購01  ,0,0,0,0,0,0,0,0,0,-173000,0,0,0,0,173000,-173000,-173000
056538,國泰金凱基98購01,0,0,0,0,0,0,0,0,0,-173000,0,0,0,0,173000,-173000,-173000
058534,友達統一9B購01  ,0,0,0,0,0,0,0,0,0,-173000,0,0,0,0,173000,-173000,-173000
061159,同欣電群益9A購01,0,0,0,0,0,0,0,0,0,-173000,0,0,0,37000,210000,-173000,-173000
062448,健策元大9C購04  ,0,0,0,0,0,0,0,0,0,-174000,0,0,0,146000,320000,-174000,-174000
045189,大立光元富98購01,0,0,0,0,0,0,0,0,0,-174000,0,0,0,0,174000,-174000,-174000
062501,台積電群益9C購03,0,0,0,0,0,0,0,0,0,-175000,0,0,0,130000,305000,-175000,-175000
061597,南六永豐9A購04  ,0,0,0,0,0,0,0,0,0,-175000,0,0,0,16000,191000,-175000,-175000
056515,燿華兆豐99購01  ,0,0,0,0,0,0,0,0,0,-175000,0,0,0,0,175000,-175000,-175000
059127,國巨中信99購04  ,0,0,0,0,0,0,0,0,0,-175000,0,0,0,4000,179000,-175000,-175000
061340,義隆元大9A購01  ,0,0,0,0,0,0,0,0,0,-176000,0,0,0,42000,218000,-176000,-176000
060686,康友元大9A購02  ,0,0,0,0,0,0,0,0,0,-176000,0,0,0,0,176000,-176000,-176000
063494,金像電富邦9B購01,0,0,0,0,0,0,0,0,0,-177000,0,0,0,22000,199000,-177000,-177000
055030,帆宣國泰99購02  ,0,0,0,0,0,0,0,0,0,-177000,0,0,0,54000,231000,-177000,-177000
08077P,亞德客國票9B售02,0,0,0,0,0,0,0,0,0,-177000,0,0,0,190000,367000,-177000,-177000
063247,信邦元大9B購02  ,0,0,0,0,0,0,0,0,0,-178000,0,0,0,153000,331000,-178000,-178000
063427,南六凱基9B購04  ,0,0,0,0,0,0,0,0,0,-178000,0,0,0,7000,185000,-178000,-178000
061676,新光金元大9A購03,0,0,0,0,0,0,0,0,0,-178000,0,0,0,0,178000,-178000,-178000
062718,技嘉凱基9B購01  ,0,0,0,0,0,0,0,0,0,-178000,0,0,0,5000,183000,-178000,-178000
062702,可成元大9C購01  ,0,0,0,0,0,0,0,0,0,-179000,0,0,0,8000,187000,-179000,-179000
062427,嘉澤統一01購01  ,0,0,0,0,0,0,0,0,0,-179000,0,0,0,4000,183000,-179000,-179000
062423,聯發科統一9C購07,0,0,0,0,0,0,0,0,0,-179000,0,0,0,107000,286000,-179000,-179000
061844,T50反1國票9C購02,0,0,0,0,0,0,0,0,0,-179000,0,0,0,533000,712000,-179000,-179000
063048,聯詠兆豐9B購01  ,0,0,0,0,0,0,0,0,0,-179000,0,0,0,28000,207000,-179000,-179000
056845,揚明光元富98購01,0,0,0,0,0,0,0,0,0,-179000,0,0,0,84000,263000,-179000,-179000
063014,技嘉元大9B購03  ,0,0,0,0,0,0,0,0,0,-180000,0,0,0,25000,205000,-180000,-180000
061874,義隆元大9B購02  ,0,0,0,0,0,0,0,0,0,-180000,0,0,0,63000,243000,-180000,-180000
061773,和潤元大9B購01  ,0,0,0,0,0,0,0,0,0,-180000,0,0,0,358000,538000,-180000,-180000
061915,T50反1凱基02購02,0,0,0,0,0,0,0,0,0,-180000,0,0,0,275000,455000,-180000,-180000
054592,美律永昌9A購01  ,0,0,0,0,0,0,0,0,0,-180000,0,0,0,0,180000,-180000,-180000
060406,瑞祺國泰9B購01  ,0,0,0,0,0,0,0,0,0,-180000,0,0,0,305000,485000,-180000,-180000
060297,和碩元大9A購02  ,0,0,0,0,0,0,0,0,0,-180000,0,0,0,181000,361000,-180000,-180000
3014,聯陽            ,185000,383000,-198000,0,0,0,0,0,0,18000,4000,0,4000,14000,0,14000,-180000
063673,GIS統一9C購02   ,0,0,0,0,0,0,0,0,0,-181000,0,0,0,0,181000,-181000,-181000
057730,聯鈞國泰9A購01  ,0,0,0,0,0,0,0,0,0,-181000,0,0,0,190000,371000,-181000,-181000
057691,健策凱基99購01  ,0,0,0,0,0,0,0,0,0,-181000,0,0,0,3000,184000,-181000,-181000
058963,華新科兆豐99購05,0,0,0,0,0,0,0,0,0,-181000,0,0,0,10000,191000,-181000,-181000
07335P,臺股指國票99售20,0,0,0,0,0,0,0,0,0,-181000,0,0,0,5000,186000,-181000,-181000
061588,聯發科富邦9B購07,0,0,0,0,0,0,0,0,0,-182000,0,0,0,0,182000,-182000,-182000
056229,可成凱基97購04  ,0,0,0,0,0,0,0,0,0,-182000,0,0,0,0,182000,-182000,-182000
060197,臻鼎元富9A購02  ,0,0,0,0,0,0,0,0,0,-182000,0,0,0,160000,342000,-182000,-182000
056247,台郡群益97購01  ,0,0,0,0,0,0,0,0,0,-183000,0,0,0,0,183000,-183000,-183000
07963P,智邦統一9B售01  ,0,0,0,0,0,0,0,0,0,-183000,0,0,0,175000,358000,-183000,-183000
060764,華擎元大9A購03  ,0,0,0,0,0,0,0,0,0,-183000,0,0,0,2000,185000,-183000,-183000
3596,智易            ,293000,443000,-150000,0,0,0,0,0,0,-33000,12000,3000,9000,28000,70000,-42000,-183000
061520,健策中信9A購01  ,0,0,0,0,0,0,0,0,0,-184000,0,0,0,3000,187000,-184000,-184000
062900,台積電元大9B購04,0,0,0,0,0,0,0,0,0,-184000,0,0,0,1000,185000,-184000,-184000
063162,國喬永豐9B購01  ,0,0,0,0,0,0,0,0,0,-184000,0,0,0,30000,214000,-184000,-184000
058076,神達凱基98購02  ,0,0,0,0,0,0,0,0,0,-184000,0,0,0,0,184000,-184000,-184000
061157,聯鈞群益9A購02  ,0,0,0,0,0,0,0,0,0,-184000,0,0,0,16000,200000,-184000,-184000
057616,聯電凱基99購01  ,0,0,0,0,0,0,0,0,0,-184000,0,0,0,0,184000,-184000,-184000
058203,信邦凱基99購01  ,0,0,0,0,0,0,0,0,0,-184000,0,0,0,86000,270000,-184000,-184000
060987,華新科元大9A購11,0,0,0,0,0,0,0,0,0,-184000,0,0,0,24000,208000,-184000,-184000
062027,國泰金群益9B購01,0,0,0,0,0,0,0,0,0,-185000,0,0,0,98000,283000,-185000,-185000
05691P,聯發科中信98售01,0,0,0,0,0,0,0,0,0,-185000,0,0,0,50000,235000,-185000,-185000
063584,南六國泰01購01  ,0,0,0,0,0,0,0,0,0,-186000,0,0,0,93000,279000,-186000,-186000
057873,義隆元大98購03  ,30000,0,30000,0,0,0,0,0,0,-216000,0,0,0,119000,335000,-216000,-186000
058521,日月光元大99購01,0,0,0,0,0,0,0,0,0,-186000,0,0,0,0,186000,-186000,-186000
058950,國巨群益99購06  ,0,0,0,0,0,0,0,0,0,-186000,0,0,0,0,186000,-186000,-186000
061027,儒鴻永豐9A購02  ,0,0,0,0,0,0,0,0,0,-186000,0,0,0,45000,231000,-186000,-186000
060790,日月光富邦9A購01,0,0,0,0,0,0,0,0,0,-186000,0,0,0,40000,226000,-186000,-186000
063559,力山元大9B購04  ,0,0,0,0,0,0,0,0,0,-187000,0,0,0,0,187000,-187000,-187000
00635U,元大S&P黃金     ,0,26000,-26000,0,0,0,0,0,0,-161000,0,400000,-400000,472000,233000,239000,-187000
2456,奇力新          ,748000,441000,307000,0,0,0,0,509000,-509000,15000,12000,5000,7000,25000,17000,8000,-187000
059176,臺股指凱基99購27,0,0,0,0,0,0,0,0,0,-188000,0,0,0,284000,472000,-188000,-188000
058194,勤誠永豐99購01  ,0,0,0,0,0,0,0,0,0,-188000,0,0,0,0,188000,-188000,-188000
4746,台耀            ,284000,604000,-320000,0,0,0,0,0,0,132000,85000,3000,82000,50000,0,50000,-188000
063452,創意統一01購01  ,0,0,0,0,0,0,0,0,0,-189000,0,0,0,125000,314000,-189000,-189000
063235,台積電元大9B購06,0,0,0,0,0,0,0,0,0,-189000,0,0,0,1000,190000,-189000,-189000
062884,康控兆豐9C購01  ,0,0,0,0,0,0,0,0,0,-189000,0,0,0,11000,200000,-189000,-189000
062565,漢唐中信9C購01  ,0,0,0,0,0,0,0,0,0,-189000,0,0,0,219000,408000,-189000,-189000
08170P,緯穎群益9B售03  ,0,0,0,0,0,0,0,0,0,-189000,0,0,0,119000,308000,-189000,-189000
05306P,泰碩國泰97售01  ,0,0,0,0,0,0,0,0,0,-190000,0,0,0,70000,260000,-190000,-190000
053947,義隆富邦97購01  ,0,0,0,0,0,0,0,0,0,-190000,0,0,0,254000,444000,-190000,-190000
059967,聯發科凱基99購20,0,0,0,0,0,0,0,0,0,-190000,0,0,0,10000,200000,-190000,-190000
056320,京鼎群益99購01  ,0,0,0,0,0,0,0,0,0,-190000,0,0,0,19000,209000,-190000,-190000
061227,日月光中信9B購01,0,0,0,0,0,0,0,0,0,-190000,0,0,0,0,190000,-190000,-190000
07954P,台表科元大9B售02,0,0,0,0,0,0,0,0,0,-190000,0,0,0,33000,223000,-190000,-190000
055153,台光電元大98購02,0,0,0,0,0,0,0,0,0,-191000,0,0,0,56000,247000,-191000,-191000
061367,瑞祺國票9A購01  ,0,0,0,0,0,0,0,0,0,-191000,0,0,0,158000,349000,-191000,-191000
061789,群創群益9B購01  ,0,0,0,0,0,0,0,0,0,-192000,0,0,0,100000,292000,-192000,-192000
00692,富邦公司治理    ,2000,2000,0,0,0,0,0,0,0,-192000,0,0,0,1318000,1510000,-192000,-192000
058494,可成群益9B購01  ,0,0,0,0,0,0,0,0,0,-192000,0,0,0,35000,227000,-192000,-192000
058266,宏達電永豐99購01,0,0,0,0,0,0,0,0,0,-192000,0,0,0,11000,203000,-192000,-192000
058711,鴻海統一9A購02  ,0,0,0,0,0,0,0,0,0,-192000,0,0,0,0,192000,-192000,-192000
062576,華擎群益9B購02  ,0,0,0,0,0,0,0,0,0,-193000,0,0,0,67000,260000,-193000,-193000
060717,康控永豐9A購01  ,0,0,0,0,0,0,0,0,0,-193000,0,0,0,5000,198000,-193000,-193000
9907,統一實          ,84000,289000,-205000,0,0,0,0,0,0,12000,12000,0,12000,0,0,0,-193000
055136,聯發科富邦99購06,0,0,0,0,0,0,0,0,0,-194000,0,0,0,1000,195000,-194000,-194000
062286,台郡群益9B購01  ,0,0,0,0,0,0,0,0,0,-195000,0,0,0,0,195000,-195000,-195000
062782,聯發科元大9B購12,0,0,0,0,0,0,0,0,0,-195000,0,0,0,16000,211000,-195000,-195000
062968,仁寶元富9B購01  ,0,0,0,0,0,0,0,0,0,-195000,0,0,0,0,195000,-195000,-195000
054339,聯詠統一96購02  ,0,0,0,0,0,0,0,0,0,-195000,0,0,0,4000,199000,-195000,-195000
2606,裕民            ,509000,697000,-188000,0,0,0,0,0,0,-7000,11000,18000,-7000,0,0,0,-195000
063084,可成凱基9C購01  ,0,0,0,0,0,0,0,0,0,-196000,0,0,0,25000,221000,-196000,-196000
062679,技嘉統一01購01  ,0,0,0,0,0,0,0,0,0,-196000,0,0,0,80000,276000,-196000,-196000
058712,鴻海統一9B購03  ,0,0,0,0,0,0,0,0,0,-196000,0,0,0,0,196000,-196000,-196000
062161,南六凱基9C購01  ,0,0,0,0,0,0,0,0,0,-197000,0,0,0,4000,201000,-197000,-197000
061574,大毅元大9B購01  ,0,0,0,0,0,0,0,0,0,-197000,0,0,0,48000,245000,-197000,-197000
061673,仁寶元大9B購01  ,0,0,0,0,0,0,0,0,0,-197000,0,0,0,78000,275000,-197000,-197000
063079,儒鴻凱基9B購01  ,0,0,0,0,0,0,0,0,0,-197000,0,0,0,93000,290000,-197000,-197000
055338,GIS兆豐97購01   ,0,0,0,0,0,0,0,0,0,-197000,0,0,0,45000,242000,-197000,-197000
056673,中石化元富9B購01,0,0,0,0,0,0,0,0,0,-197000,0,0,0,203000,400000,-197000,-197000
060616,宏碁元大9A購02  ,0,0,0,0,0,0,0,0,0,-197000,0,0,0,20000,217000,-197000,-197000
3406,玉晶光          ,479800,563000,-83200,0,0,0,0,4000,-4000,-110000,132000,247000,-115000,84000,79000,5000,-197200
6669,緯穎            ,1364567,1112150,252417,0,0,0,0,336000,-336000,-114000,30000,113000,-83000,4000,35000,-31000,-197583
056266,開發金統一9A購01,0,0,0,0,0,0,0,0,0,-198000,0,0,0,92000,290000,-198000,-198000
058239,景碩元大99購03  ,0,0,0,0,0,0,0,0,0,-198000,0,0,0,88000,286000,-198000,-198000
059295,大立光元富99購05,0,0,0,0,0,0,0,0,0,-198000,0,0,0,13000,211000,-198000,-198000
3062,建漢            ,37000,235000,-198000,0,0,0,0,0,0,0,0,0,0,0,0,0,-198000
054883,億光統一97購01  ,0,0,0,0,0,0,0,0,0,-199000,0,0,0,0,199000,-199000,-199000
057924,健策凱基98購02  ,0,0,0,0,0,0,0,0,0,-199000,0,0,0,7000,206000,-199000,-199000
060434,台汽電永豐9A購01,0,0,0,0,0,0,0,0,0,-199000,0,0,0,2000,201000,-199000,-199000
060288,群光元大9C購01  ,0,0,0,0,0,0,0,0,0,-199000,0,0,0,190000,389000,-199000,-199000
1307,三芳            ,74000,273000,-199000,0,0,0,0,0,0,0,0,0,0,0,0,0,-199000
4532,瑞智            ,0,199000,-199000,0,0,0,0,0,0,0,0,0,0,0,0,0,-199000
063650,矽創元大9B購03  ,0,0,0,0,0,0,0,0,0,-200000,0,0,0,71000,271000,-200000,-200000
057012,康控中信98購01  ,0,0,0,0,0,0,0,0,0,-200000,0,0,0,0,200000,-200000,-200000
05978P,麗豐永豐96售02  ,0,0,0,0,0,0,0,0,0,-200000,0,0,0,0,200000,-200000,-200000
9941,裕融            ,41000,286000,-245000,0,0,0,0,0,0,45000,45000,0,45000,0,0,0,-200000
063637,聯發科元大9C購02,0,0,0,0,0,0,0,0,0,-201000,0,0,0,0,201000,-201000,-201000
061621,健策群益9A購05  ,0,0,0,0,0,0,0,0,0,-201000,0,0,0,17000,218000,-201000,-201000
061765,義隆元大9B購01  ,0,0,0,0,0,0,0,0,0,-201000,0,0,0,89000,290000,-201000,-201000
054374,信邦中信96購01  ,0,0,0,0,0,0,0,0,0,-201000,0,0,0,10000,211000,-201000,-201000
2421,建準            ,2099000,2120000,-21000,0,0,0,0,0,0,-180000,45000,61000,-16000,32000,196000,-164000,-201000
062609,帆宣凱基9B購01  ,0,0,0,0,0,0,0,0,0,-202000,0,0,0,68000,270000,-202000,-202000
059632,聯發科凱基01購01,0,0,0,0,0,0,0,0,0,-202000,0,0,0,1000,203000,-202000,-202000
061298,華新科富邦01購02,0,0,0,0,0,0,0,0,0,-202000,0,0,0,0,202000,-202000,-202000
1210,大成            ,1106000,1401000,-295000,0,0,0,0,0,0,93000,111000,18000,93000,0,0,0,-202000
060990,新光金元大9B購03,0,0,0,0,0,0,0,0,0,-202000,0,0,0,0,202000,-202000,-202000
062451,瀚宇博元大9B購02,0,0,0,0,0,0,0,0,0,-203000,0,0,0,242000,445000,-203000,-203000
063554,GIS國票9C購03   ,0,0,0,0,0,0,0,0,0,-203000,0,0,0,0,203000,-203000,-203000
06852P,臺股指元大98售11,0,0,0,0,0,0,0,0,0,-203000,0,0,0,299000,502000,-203000,-203000
061942,亞德客群益9B購01,0,0,0,0,0,0,0,0,0,-204000,0,0,0,81000,285000,-204000,-204000
061555,聯電國票9B購01  ,0,0,0,0,0,0,0,0,0,-204000,0,0,0,155000,359000,-204000,-204000
056624,景碩永豐98購01  ,0,0,0,0,0,0,0,0,0,-204000,0,0,0,83000,287000,-204000,-204000
061828,T50反1凱基02購01,0,0,0,0,0,0,0,0,0,-205000,0,0,0,0,205000,-205000,-205000
057746,同欣電永豐98購02,0,0,0,0,0,0,0,0,0,-205000,0,0,0,5000,210000,-205000,-205000
060932,南六永豐9A購02  ,0,0,0,0,0,0,0,0,0,-206000,0,0,0,56000,262000,-206000,-206000
07955P,大成鋼群益9B售02,0,0,0,0,0,0,0,0,0,-206000,0,0,0,0,206000,-206000,-206000
062164,禾伸堂國泰01購01,0,0,0,0,0,0,0,0,0,-207000,0,0,0,123000,330000,-207000,-207000
063270,喬山兆豐9C購01  ,0,0,0,0,0,0,0,0,0,-207000,0,0,0,0,207000,-207000,-207000
057595,健鼎兆豐98購01  ,0,0,0,0,0,0,0,0,0,-207000,0,0,0,84000,291000,-207000,-207000
061819,茂林群益9B購01  ,0,0,0,0,0,0,0,0,0,-208000,0,0,0,53000,261000,-208000,-208000
07714P,世紀鋼元大9A售03,0,0,0,0,0,0,0,0,0,-208000,0,0,0,10000,218000,-208000,-208000
07435P,台積電富邦9C售07,0,0,0,0,0,0,0,0,0,-208000,0,0,0,0,208000,-208000,-208000
055943,瑞昱麥證97購01  ,0,0,0,0,209000,-209000,0,0,0,-209000,0,0,0,0,209000,-209000,-209000
057632,傳奇永豐98購01  ,0,0,0,0,0,0,0,0,0,-209000,0,0,0,0,209000,-209000,-209000
07849P,大立光群益9A售06,0,0,0,0,0,0,0,0,0,-209000,0,0,0,17000,226000,-209000,-209000
058129,國巨元大99購10  ,0,0,0,0,0,0,0,0,0,-209000,0,0,0,20000,229000,-209000,-209000
1507,永大            ,266000,484000,-218000,0,0,0,0,0,0,9000,13000,4000,9000,0,0,0,-209000
3588,通嘉            ,64000,352000,-288000,0,0,0,79000,0,79000,0,0,0,0,0,0,0,-209000
062747,立積永豐9B購01  ,0,0,0,0,0,0,0,0,0,-210000,0,0,0,0,210000,-210000,-210000
056028,GIS群益97購02   ,0,0,0,0,0,0,0,0,0,-210000,0,0,0,0,210000,-210000,-210000
055935,創意群益97購02  ,0,0,0,0,0,0,0,0,0,-210000,0,0,0,0,210000,-210000,-210000
061229,緯穎中信9B購01  ,0,0,0,0,0,0,0,0,0,-210000,0,0,0,0,210000,-210000,-210000
060954,國泰金群益9A購02,0,0,0,0,0,0,0,0,0,-210000,0,0,0,0,210000,-210000,-210000
043442,大立光台新01購01,0,0,0,0,0,0,0,0,0,-211000,0,0,0,5000,216000,-211000,-211000
056586,光罩統一98購02  ,0,0,0,0,0,0,0,0,0,-211000,0,0,0,60000,271000,-211000,-211000
07856P,力成凱基9A售02  ,0,0,0,0,0,0,0,0,0,-211000,0,0,0,462000,673000,-211000,-211000
2015,豐興            ,151000,417000,-266000,0,0,0,0,0,0,55000,55000,0,55000,0,0,0,-211000
07646P,世芯元大9A售04  ,0,0,0,0,0,0,0,0,0,-211000,0,0,0,29000,240000,-211000,-211000
063269,儒鴻兆豐9C購01  ,0,0,0,0,0,0,0,0,0,-212000,0,0,0,0,212000,-212000,-212000
062169,禾伸堂永豐9B購01,0,0,0,0,0,0,0,0,0,-212000,0,0,0,0,212000,-212000,-212000
057092,健策元富98購01  ,0,0,0,0,0,0,0,0,0,-212000,0,0,0,21000,233000,-212000,-212000
07939P,台積電統一9B售14,0,0,0,0,0,0,0,0,0,-212000,0,0,0,0,212000,-212000,-212000
062012,燿華富邦9C購01  ,0,0,0,0,0,0,0,0,0,-213000,0,0,0,0,213000,-213000,-213000
056954,聯詠富邦9A購01  ,0,0,0,0,0,0,0,0,0,-213000,0,0,0,0,213000,-213000,-213000
059078,FBVIX元大99購06 ,0,0,0,0,0,0,0,0,0,-213000,0,0,0,0,213000,-213000,-213000
063149,聯發科元富05購02,0,0,0,0,0,0,0,0,0,-214000,0,0,0,30000,244000,-214000,-214000
057972,群創富邦9C購01  ,0,0,0,0,0,0,0,0,0,-214000,0,0,0,12000,226000,-214000,-214000
2704,國賓            ,31000,245000,-214000,0,0,0,0,0,0,0,0,0,0,0,0,0,-214000
063198,仁寶統一01購02  ,0,0,0,0,0,0,0,0,0,-215000,0,0,0,0,215000,-215000,-215000
061508,南六國泰9C購02  ,0,0,0,0,0,0,0,0,0,-215000,0,0,0,163000,378000,-215000,-215000
056301,開發金元大9A購01,0,0,0,0,0,0,0,0,0,-215000,0,0,0,0,215000,-215000,-215000
053396,漢唐中信9A購01  ,0,0,0,0,0,0,0,0,0,-215000,0,0,0,0,215000,-215000,-215000
061172,大立光麥證9A購02,0,0,0,0,215000,-215000,0,0,0,-215000,0,0,0,0,215000,-215000,-215000
061319,聯發科凱基9A購16,0,0,0,0,0,0,0,0,0,-215000,0,0,0,15000,230000,-215000,-215000
057817,景碩元大98購01  ,0,0,0,0,0,0,0,0,0,-215000,0,0,0,171000,386000,-215000,-215000
059000,台積電元大99購25,0,0,0,0,0,0,0,0,0,-216000,0,0,0,10000,226000,-216000,-216000
058406,聯茂元大99購06  ,0,0,0,0,0,0,0,0,0,-216000,0,0,0,164000,380000,-216000,-216000
061679,健策元大9B購04  ,0,0,0,0,0,0,0,0,0,-217000,0,0,0,31000,248000,-217000,-217000
1447,力鵬            ,39000,256000,-217000,0,0,0,0,0,0,0,0,0,0,0,0,0,-217000
07218P,臺股指凱基99售31,0,0,0,0,0,0,0,0,0,-217000,0,0,0,120000,337000,-217000,-217000
057377,康控元大99購02  ,0,0,0,0,0,0,0,0,0,-218000,0,0,0,5000,223000,-218000,-218000
07385P,緯穎群益99售04  ,0,0,0,0,0,0,0,0,0,-218000,0,0,0,56000,274000,-218000,-218000
07579P,聯茂元大9A售01  ,0,0,0,0,0,0,0,0,0,-218000,0,0,0,282000,500000,-218000,-218000
063564,台積電元大9B購07,0,0,0,0,0,0,0,0,0,-219000,0,0,0,1000,220000,-219000,-219000
060430,和潤永豐9A購01  ,0,0,0,0,0,0,0,0,0,-219000,0,0,0,5000,224000,-219000,-219000
058371,智原凱基9A購01  ,0,0,0,0,0,0,0,0,0,-219000,0,0,0,35000,254000,-219000,-219000
06467P,旺宏統一98售01  ,0,0,0,0,0,0,0,0,0,-220000,0,0,0,119000,339000,-220000,-220000
06845P,億光元大98售02  ,0,0,0,0,0,0,0,0,0,-220000,0,0,0,55000,275000,-220000,-220000
054713,國巨中信9B購01  ,0,0,0,0,0,0,0,0,0,-220000,0,0,0,0,220000,-220000,-220000
054872,瀚宇博群益98購01,0,0,0,0,0,0,0,0,0,-220000,0,0,0,38000,258000,-220000,-220000
058131,義隆元大99購02  ,0,0,0,0,0,0,0,0,0,-220000,0,0,0,120000,340000,-220000,-220000
060477,和潤元大9A購01  ,0,0,0,0,0,0,0,0,0,-220000,0,0,0,126000,346000,-220000,-220000
058684,健策凱基99購02  ,0,0,0,0,0,0,0,0,0,-220000,0,0,0,14000,234000,-220000,-220000
058197,國巨中信99購02  ,0,0,0,0,0,0,0,0,0,-220000,0,0,0,0,220000,-220000,-220000
063105,健策群益9C購01  ,0,0,0,0,0,0,0,0,0,-221000,0,0,0,127000,348000,-221000,-221000
062703,可成元大9C購02  ,0,0,0,0,0,0,0,0,0,-221000,0,0,0,0,221000,-221000,-221000
051292,牧德統一97購01  ,0,0,0,0,0,0,0,0,0,-221000,0,0,0,31000,252000,-221000,-221000
07580P,緯穎元大9A售03  ,0,0,0,0,0,0,0,0,0,-221000,0,0,0,150000,371000,-221000,-221000
059395,T50反1元富99購03,0,0,0,0,0,0,0,0,0,-222000,0,0,0,0,222000,-222000,-222000
062336,茂林統一01購02  ,0,0,0,0,0,0,0,0,0,-223000,0,0,0,0,223000,-223000,-223000
063451,漢翔統一9C購01  ,0,0,0,0,0,0,0,0,0,-223000,0,0,0,124000,347000,-223000,-223000
059278,群創元大9A購04  ,0,0,0,0,0,0,0,0,0,-223000,0,0,0,0,223000,-223000,-223000
2362,藍天            ,160000,409000,-249000,0,0,0,0,0,0,25000,25000,0,25000,0,0,0,-224000
059865,國巨凱基01購01  ,0,0,0,0,0,0,0,0,0,-225000,0,0,0,34000,259000,-225000,-225000
058863,可成凱基99購02  ,0,0,0,0,0,0,0,0,0,-225000,0,0,0,5000,230000,-225000,-225000
5607,遠雄港          ,135000,359000,-224000,0,0,0,0,0,0,-1000,0,1000,-1000,0,0,0,-225000
06765P,欣興元大98售11  ,0,0,0,0,0,0,0,0,0,-226000,0,0,0,12000,238000,-226000,-226000
063246,嘉晶元大9C購01  ,0,0,0,0,0,0,0,0,0,-226000,0,0,0,63000,289000,-226000,-226000
063087,南六凱基9C購02  ,0,0,0,0,0,0,0,0,0,-226000,0,0,0,4000,230000,-226000,-226000
062409,巨大永豐9B購02  ,0,0,0,0,0,0,0,0,0,-226000,0,0,0,121000,347000,-226000,-226000
062134,國巨群益9B購04  ,0,0,0,0,0,0,0,0,0,-226000,0,0,0,70000,296000,-226000,-226000
5434,崇越            ,113000,305000,-192000,0,0,0,0,24000,-24000,-10000,28000,38000,-10000,0,0,0,-226000
061273,臺股指凱基9A購23,0,0,0,0,0,0,0,0,0,-227000,0,0,0,0,227000,-227000,-227000
061378,南六永豐9A購03  ,0,0,0,0,0,0,0,0,0,-227000,0,0,0,107000,334000,-227000,-227000
8271,宇瞻            ,192000,417000,-225000,0,0,0,0,0,0,-2000,0,2000,-2000,0,0,0,-227000
063248,創意元大9C購01  ,0,0,0,0,0,0,0,0,0,-228000,0,0,0,10000,238000,-228000,-228000
2377,微星            ,3387176,3925088,-537912,0,0,0,310000,24000,286000,22000,12000,0,12000,42000,32000,10000,-229912
061550,聯鈞群益9A購03  ,0,0,0,0,0,0,0,0,0,-230000,0,0,0,248000,478000,-230000,-230000
060337,FBVIX統一9A購01 ,0,0,0,0,0,0,0,0,0,-230000,0,0,0,20000,250000,-230000,-230000
061428,南六元大9A購01  ,0,0,0,0,0,0,0,0,0,-231000,0,0,0,100000,331000,-231000,-231000
063116,大立光麥證9C購01,0,0,0,0,231000,-231000,0,0,0,-231000,0,0,0,0,231000,-231000,-231000
059772,可成群益9A購05  ,0,0,0,0,0,0,0,0,0,-231000,0,0,0,48000,279000,-231000,-231000
2723,美食-KY         ,148000,403000,-255000,0,0,0,0,0,0,24000,13000,0,13000,17000,6000,11000,-231000
061429,南六元大9A購02  ,0,0,0,0,0,0,0,0,0,-232000,0,0,0,136000,368000,-232000,-232000
062654,技嘉永豐9B購01  ,0,0,0,0,0,0,0,0,0,-232000,0,0,0,45000,277000,-232000,-232000
061106,群創元大9B購09  ,0,0,0,0,0,0,0,0,0,-232000,0,0,0,68000,300000,-232000,-232000
062250,台積電元大9B購02,0,0,0,0,0,0,0,0,0,-234000,0,0,0,46000,280000,-234000,-234000
03657C,T50反1元大99牛01,0,0,0,0,0,0,0,0,0,-234000,0,0,0,123000,357000,-234000,-234000
056944,鴻海統一98購11  ,0,0,0,0,0,0,0,0,0,-234000,0,0,0,0,234000,-234000,-234000
07948P,大成鋼凱基9B售01,0,0,0,0,0,0,0,0,0,-234000,0,0,0,0,234000,-234000,-234000
062337,台表科統一01購01,0,0,0,0,0,0,0,0,0,-235000,0,0,0,67000,302000,-235000,-235000
063346,TPK統一9C購01   ,0,0,0,0,0,0,0,0,0,-236000,0,0,0,19000,255000,-236000,-236000
06486P,麗豐元大98售02  ,0,0,0,0,0,0,0,0,0,-236000,0,0,0,760000,996000,-236000,-236000
061169,GIS兆豐9A購01   ,0,0,0,0,0,0,0,0,0,-236000,0,0,0,57000,293000,-236000,-236000
058714,美律統一9B購01  ,0,0,0,0,0,0,0,0,0,-236000,0,0,0,365000,601000,-236000,-236000
062048,義隆台新9B購01  ,0,0,0,0,0,0,0,0,0,-237000,0,0,0,20000,257000,-237000,-237000
057048,新日興元大98購01,0,0,0,0,0,0,0,0,0,-237000,0,0,0,37000,274000,-237000,-237000
062236,信邦凱基9B購01  ,0,0,0,0,0,0,0,0,0,-238000,0,0,0,194000,432000,-238000,-238000
062462,GIS群益9B購01   ,0,0,0,0,0,0,0,0,0,-238000,0,0,0,146000,384000,-238000,-238000
057927,勤誠凱基98購01  ,0,0,0,0,0,0,0,0,0,-238000,0,0,0,5000,243000,-238000,-238000
059696,立積永豐99購03  ,0,0,0,0,0,0,0,0,0,-238000,0,0,0,7000,245000,-238000,-238000
059036,可成群益9B購03  ,0,0,0,0,0,0,0,0,0,-238000,0,0,0,1000,239000,-238000,-238000
08067P,大立光凱基9B售08,0,0,0,0,0,0,0,0,0,-238000,0,0,0,15000,253000,-238000,-238000
061647,南六元大9A購03  ,0,0,0,0,0,0,0,0,0,-239000,0,0,0,110000,349000,-239000,-239000
055120,南港兆豐97購01  ,0,0,0,0,0,0,0,0,0,-239000,0,0,0,0,239000,-239000,-239000
056420,台表科元富98購01,0,0,0,0,0,0,0,0,0,-239000,0,0,0,44000,283000,-239000,-239000
06748P,智邦台新98售02  ,0,0,0,0,0,0,0,0,0,-240000,0,0,0,10000,250000,-240000,-240000
053186,健策中信9C購01  ,0,0,0,0,0,0,0,0,0,-240000,0,0,0,33000,273000,-240000,-240000
061275,臺股指凱基9A購25,0,0,0,0,0,0,0,0,0,-240000,0,0,0,33000,273000,-240000,-240000
058241,景碩元大99購05  ,0,0,0,0,0,0,0,0,0,-240000,0,0,0,168000,408000,-240000,-240000
07905P,大立光群益9B售04,0,0,0,0,0,0,0,0,0,-240000,0,0,0,18000,258000,-240000,-240000
062288,南六群益9B購01  ,0,0,0,0,0,0,0,0,0,-241000,0,0,0,4000,245000,-241000,-241000
058569,健策凱基9A購01  ,0,0,0,0,0,0,0,0,0,-241000,0,0,0,13000,254000,-241000,-241000
061468,神達群益9A購01  ,0,0,0,0,0,0,0,0,0,-242000,0,0,0,213000,455000,-242000,-242000
063056,嘉澤統一9C購02  ,0,0,0,0,0,0,0,0,0,-242000,0,0,0,25000,267000,-242000,-242000
062949,聯發科富邦01購01,0,0,0,0,0,0,0,0,0,-242000,0,0,0,20000,262000,-242000,-242000
1305,華夏            ,1036000,1220000,-184000,0,0,0,0,120000,-120000,62000,63000,1000,62000,0,0,0,-242000
063026,南六元大9B購04  ,0,0,0,0,0,0,0,0,0,-244000,0,0,0,24000,268000,-244000,-244000
062424,聯發科統一9C購08,0,0,0,0,0,0,0,0,0,-244000,0,0,0,19000,263000,-244000,-244000
2609,陽明            ,376000,620000,-244000,0,0,0,0,0,0,0,0,0,0,0,0,0,-244000
062973,聯發科元富05購01,0,0,0,0,0,0,0,0,0,-245000,0,0,0,50000,295000,-245000,-245000
055896,南電統一97購02  ,0,0,0,0,0,0,0,0,0,-245000,0,0,0,271000,516000,-245000,-245000
054565,玉晶光群益99購02,0,0,0,0,0,0,0,0,0,-245000,0,0,0,0,245000,-245000,-245000
057707,臺股指群益98購07,0,0,0,0,0,0,0,0,0,-245000,0,0,0,35000,280000,-245000,-245000
057699,可成群益9A購02  ,0,0,0,0,0,0,0,0,0,-245000,0,0,0,12000,257000,-245000,-245000
058683,可成凱基9A購01  ,0,0,0,0,0,0,0,0,0,-245000,0,0,0,0,245000,-245000,-245000
061031,神隆永豐9A購02  ,0,0,0,0,0,0,0,0,0,-245000,0,0,0,0,245000,-245000,-245000
058154,泰碩統一9A購01  ,0,0,0,0,0,0,0,0,0,-245000,0,0,0,179000,424000,-245000,-245000
2601,益航            ,134000,374000,-240000,0,0,0,0,0,0,-5000,0,0,0,0,5000,-5000,-245000
060911,大毅元大9A購01  ,0,0,0,0,0,0,0,0,0,-246000,0,0,0,43000,289000,-246000,-246000
061154,可成群益9B購04  ,0,0,0,0,0,0,0,0,0,-247000,0,0,0,0,247000,-247000,-247000
060880,中壽中信9C購01  ,0,0,0,0,0,0,0,0,0,-247000,0,0,0,23000,270000,-247000,-247000
1402,遠東新          ,27346150,28456821,-1110671,0,0,0,669000,11000,658000,205000,342000,146000,196000,9000,0,9000,-247671
063438,聚陽統一9C購01  ,0,0,0,0,0,0,0,0,0,-248000,0,0,0,21000,269000,-248000,-248000
063493,金像電富邦01購01,0,0,0,0,0,0,0,0,0,-248000,0,0,0,20000,268000,-248000,-248000
058337,日月光元富99購01,0,0,0,0,0,0,0,0,0,-248000,0,0,0,67000,315000,-248000,-248000
062667,立積群益9B購01  ,0,0,0,0,0,0,0,0,0,-249000,0,0,0,98000,347000,-249000,-249000
062352,南六群益9B購02  ,0,0,0,0,0,0,0,0,0,-249000,0,0,0,7000,256000,-249000,-249000
061924,聯發科凱基9C購01,0,0,0,0,0,0,0,0,0,-249000,0,0,0,1000,250000,-249000,-249000
061859,勤誠國票9B購01  ,0,0,0,0,0,0,0,0,0,-249000,0,0,0,0,249000,-249000,-249000
061084,京元電兆豐9A購02,0,0,0,0,0,0,0,0,0,-249000,0,0,0,0,249000,-249000,-249000
8422,可寧衛          ,41000,299000,-258000,0,0,0,0,0,0,9000,9000,0,9000,0,0,0,-249000
053131,華通國票97購03  ,0,0,0,0,0,0,0,0,0,-250000,0,0,0,23000,273000,-250000,-250000
056044,同欣電凱基97購03,0,0,0,0,0,0,0,0,0,-250000,0,0,0,235000,485000,-250000,-250000
07597P,臺股指中信01售02,0,0,0,0,0,0,0,0,0,-250000,0,0,0,590000,840000,-250000,-250000
07652P,臺股指中信9A售07,0,0,0,0,0,0,0,0,0,-250000,0,0,0,61000,311000,-250000,-250000
062550,啟碁永豐9B購01  ,0,0,0,0,0,0,0,0,0,-252000,0,0,0,0,252000,-252000,-252000
063133,喬山統一01購01  ,0,0,0,0,0,0,0,0,0,-252000,0,0,0,29000,281000,-252000,-252000
056075,瀚宇博元大97購03,0,0,0,0,0,0,0,0,0,-252000,0,0,0,94000,346000,-252000,-252000
046191,新光金凱基98購01,0,0,0,0,0,0,0,0,0,-252000,0,0,0,68000,320000,-252000,-252000
062802,宏達電統一9B購01,0,0,0,0,0,0,0,0,0,-253000,0,0,0,0,253000,-253000,-253000
061552,南六群益9A購02  ,0,0,0,0,0,0,0,0,0,-253000,0,0,0,35000,288000,-253000,-253000
051423,GIS國票97購01   ,0,0,0,0,0,0,0,0,0,-253000,0,0,0,19000,272000,-253000,-253000
053114,聯茂兆豐97購01  ,0,0,0,0,0,0,0,0,0,-253000,0,0,0,121000,374000,-253000,-253000
062249,台積電元大9B購01,0,0,0,0,0,0,0,0,0,-254000,0,0,0,46000,300000,-254000,-254000
062834,立積群益9B購02  ,0,0,0,0,0,0,0,0,0,-254000,0,0,0,0,254000,-254000,-254000
058495,元大金群益9B購01,0,0,0,0,0,0,0,0,0,-254000,0,0,0,98000,352000,-254000,-254000
058672,可成群益9B購02  ,0,0,0,0,0,0,0,0,0,-254000,0,0,0,0,254000,-254000,-254000
057740,茂林富邦9A購01  ,0,0,0,0,0,0,0,0,0,-254000,0,0,0,11000,265000,-254000,-254000
062889,可成群益9C購01  ,0,0,0,0,0,0,0,0,0,-255000,0,0,0,1000,256000,-255000,-255000
062486,瑞昱富邦9B購01  ,0,0,0,0,0,0,0,0,0,-255000,0,0,0,958000,1213000,-255000,-255000
046906,新光金凱基99購02,0,0,0,0,0,0,0,0,0,-255000,0,0,0,0,255000,-255000,-255000
058480,新日興凱基9A購01,0,0,0,0,0,0,0,0,0,-255000,0,0,0,10000,265000,-255000,-255000
055497,開發金元大97購01,0,0,0,0,0,0,0,0,0,-257000,0,0,0,143000,400000,-257000,-257000
063357,聯發科國泰01購04,0,0,0,0,0,0,0,0,0,-258000,0,0,0,0,258000,-258000,-258000
054640,健策中信9B購01  ,0,0,0,0,0,0,0,0,0,-258000,0,0,0,64000,322000,-258000,-258000
057614,華新科元富99購04,0,0,0,0,0,0,0,0,0,-258000,0,0,0,194000,452000,-258000,-258000
052602,聯電元大97購01  ,0,0,0,0,0,0,0,0,0,-259000,0,0,0,61000,320000,-259000,-259000
07855P,旺宏凱基9A售09  ,0,0,0,0,0,0,0,0,0,-259000,0,0,0,51000,310000,-259000,-259000
047564,滬深2X國票99購01,0,0,0,0,0,0,0,0,0,-260000,0,0,0,0,260000,-260000,-260000
055206,台虹中信97購01  ,0,0,0,0,0,0,0,0,0,-260000,0,0,0,0,260000,-260000,-260000
060043,全新群益9B購02  ,0,0,0,0,0,0,0,0,0,-260000,0,0,0,50000,310000,-260000,-260000
07215P,大立光凱基99售07,0,0,0,0,0,0,0,0,0,-260000,0,0,0,0,260000,-260000,-260000
060233,宏碁元大9A購01  ,0,0,0,0,0,0,0,0,0,-262000,0,0,0,10000,272000,-262000,-262000
057777,可成群益9A購03  ,0,0,0,0,0,0,0,0,0,-262000,0,0,0,40000,302000,-262000,-262000
062786,立積元大9C購03  ,0,0,0,0,0,0,0,0,0,-263000,0,0,0,10000,273000,-263000,-263000
062644,中環國泰9C購01  ,0,0,0,0,0,0,0,0,0,-263000,0,0,0,65000,328000,-263000,-263000
057087,台郡統一99購01  ,0,0,0,0,0,0,0,0,0,-263000,0,0,0,111000,374000,-263000,-263000
057325,可成群益9A購01  ,0,0,0,0,0,0,0,0,0,-263000,0,0,0,38000,301000,-263000,-263000
058914,元油2X元富01購02,0,0,0,0,0,0,0,0,0,-263000,0,0,0,0,263000,-263000,-263000
062382,燿華國泰9C購01  ,0,0,0,0,0,0,0,0,0,-264000,0,0,0,46000,310000,-264000,-264000
00652,富邦印度        ,72000,3000,69000,0,0,0,0,0,0,-333000,0,0,0,94000,427000,-333000,-264000
062239,台汽電凱基9B購01,0,0,0,0,0,0,0,0,0,-265000,0,0,0,60000,325000,-265000,-265000
2020,美亞            ,45000,310000,-265000,0,0,0,0,0,0,0,0,0,0,0,0,0,-265000
2492,華新科          ,2494510,3065441,-570931,0,0,0,0,15000,-15000,320000,104000,26000,78000,278000,36000,242000,-265931
058999,台積電元大99購24,0,0,0,0,0,0,0,0,0,-267000,0,0,0,5000,272000,-267000,-267000
062797,瑞昱統一9B購01  ,0,0,0,0,0,0,0,0,0,-268000,0,0,0,471000,739000,-268000,-268000
055698,茂林國票98購03  ,0,0,0,0,0,0,0,0,0,-268000,0,0,0,32000,300000,-268000,-268000
2536,宏普            ,14000,282000,-268000,0,0,0,0,0,0,0,0,0,0,0,0,0,-268000
2401,凌陽            ,84000,343000,-259000,0,0,0,0,0,0,-10000,2000,12000,-10000,0,0,0,-269000
055054,群光永豐97購01  ,0,0,0,0,0,0,0,0,0,-270000,0,0,0,0,270000,-270000,-270000
058771,神達兆豐99購01  ,0,0,0,0,0,0,0,0,0,-270000,0,0,0,10000,280000,-270000,-270000
1707,葡萄王          ,44000,220000,-176000,0,0,0,0,93000,-93000,-1000,0,0,0,0,1000,-1000,-270000
08168P,金像電群益9B售03,0,0,0,0,0,0,0,0,0,-270000,0,0,0,10000,280000,-270000,-270000
063377,泰鼎永豐9B購03  ,0,0,0,0,0,0,0,0,0,-271000,0,0,0,0,271000,-271000,-271000
058034,神達永豐98購02  ,0,0,0,0,0,0,0,0,0,-272000,0,0,0,50000,322000,-272000,-272000
07216P,大立光凱基99售08,0,0,0,0,0,0,0,0,0,-272000,0,0,0,0,272000,-272000,-272000
057450,國泰金元富98購01,0,0,0,0,0,0,0,0,0,-273000,0,0,0,34000,307000,-273000,-273000
056949,義隆統一98購01  ,0,0,0,0,0,0,0,0,0,-274000,0,0,0,90000,364000,-274000,-274000
061279,鴻海統一9C購04  ,0,0,0,0,0,0,0,0,0,-274000,0,0,0,0,274000,-274000,-274000
062922,南六元大9B購03  ,0,0,0,0,0,0,0,0,0,-275000,0,0,0,88000,363000,-275000,-275000
062334,健策統一9B購02  ,0,0,0,0,0,0,0,0,0,-275000,0,0,0,32000,307000,-275000,-275000
054244,華新元大96購01  ,0,0,0,0,0,0,0,0,0,-275000,0,0,0,68000,343000,-275000,-275000
054563,泰碩群益99購01  ,0,0,0,0,0,0,0,0,0,-275000,0,0,0,0,275000,-275000,-275000
059090,台新金元大99購01,0,0,0,0,0,0,0,0,0,-275000,0,0,0,77000,352000,-275000,-275000
1611,中電            ,258000,533000,-275000,0,0,0,0,0,0,0,0,0,0,0,0,0,-275000
3413,京鼎            ,368000,230000,138000,0,0,0,0,416000,-416000,3000,6000,3000,3000,6000,6000,0,-275000
063150,聯發科元富05購03,0,0,0,0,0,0,0,0,0,-276000,0,0,0,3000,279000,-276000,-276000
060561,台積電富邦04購01,0,0,0,0,0,0,0,0,0,-276000,0,0,0,115000,391000,-276000,-276000
062349,新日興群益9B購02,0,0,0,0,0,0,0,0,0,-277000,0,0,0,122000,399000,-277000,-277000
060042,台積電群益99購12,0,0,0,0,0,0,0,0,0,-277000,0,0,0,13000,290000,-277000,-277000
063143,嘉澤統一9B購02  ,0,0,0,0,0,0,0,0,0,-278000,0,0,0,1000,279000,-278000,-278000
053887,聯茂兆豐97購02  ,0,0,0,0,0,0,0,0,0,-278000,0,0,0,80000,358000,-278000,-278000
057357,超眾統一98購01  ,0,0,0,0,0,0,0,0,0,-278000,0,0,0,206000,484000,-278000,-278000
061064,可成凱基9B購02  ,0,0,0,0,0,0,0,0,0,-278000,0,0,0,1000,279000,-278000,-278000
056116,義隆群益97購02  ,0,0,0,0,0,0,0,0,0,-279000,0,0,0,61000,340000,-279000,-279000
058261,大立光富邦03購01,0,0,0,0,0,0,0,0,0,-279000,0,0,0,0,279000,-279000,-279000
063476,台表科元大9C購03,0,0,0,0,0,0,0,0,0,-280000,0,0,0,28000,308000,-280000,-280000
063672,GIS統一9C購01   ,0,0,0,0,0,0,0,0,0,-280000,0,0,0,0,280000,-280000,-280000
06893P,致新元富98售02  ,0,0,0,0,0,0,0,0,0,-280000,0,0,0,10000,290000,-280000,-280000
062732,南六凱基9B購03  ,0,0,0,0,0,0,0,0,0,-280000,0,0,0,33000,313000,-280000,-280000
2387,精元            ,832000,1339000,-507000,0,0,0,0,0,0,227000,300000,7000,293000,167000,233000,-66000,-280000
08098P,大立光凱基9B售09,0,0,0,0,0,0,0,0,0,-280000,0,0,0,10000,290000,-280000,-280000
062020,智伸科永豐9B購01,0,0,0,0,0,0,0,0,0,-281000,0,0,0,0,281000,-281000,-281000
060289,京元電元大9A購01,0,0,0,0,0,0,0,0,0,-281000,0,0,0,135000,416000,-281000,-281000
061741,新光金凱基9B購01,0,0,0,0,0,0,0,0,0,-282000,0,0,0,7000,289000,-282000,-282000
9917,中保科          ,1116000,1433000,-317000,0,0,0,0,0,0,34000,34000,0,34000,0,0,0,-283000
061772,健策元大9B購06  ,0,0,0,0,0,0,0,0,0,-284000,0,0,0,112000,396000,-284000,-284000
06980P,緯穎永豐99售02  ,0,0,0,0,0,0,0,0,0,-284000,0,0,0,137000,421000,-284000,-284000
063419,聯發科凱基03購01,0,0,0,0,0,0,0,0,0,-284000,0,0,0,0,284000,-284000,-284000
059979,台積電元大99購49,0,0,0,0,0,0,0,0,0,-284000,0,0,0,36000,320000,-284000,-284000
4414,如興            ,248000,576000,-328000,0,0,0,0,0,0,44000,44000,0,44000,0,0,0,-284000
063398,信邦群益9B購02  ,0,0,0,0,0,0,0,0,0,-285000,0,0,0,27000,312000,-285000,-285000
062523,世紀鋼元大9C購03,0,0,0,0,0,0,0,0,0,-285000,0,0,0,299000,584000,-285000,-285000
060329,鎧勝群益9B購01  ,0,0,0,0,0,0,0,0,0,-285000,0,0,0,55000,340000,-285000,-285000
4956,光鋐            ,241000,526000,-285000,0,0,0,0,0,0,0,1000,1000,0,0,0,0,-285000
060855,華新科富邦01購01,0,0,0,0,0,0,0,0,0,-285000,0,0,0,0,285000,-285000,-285000
057083,立積統一98購01  ,0,0,0,0,0,0,0,0,0,-286000,0,0,0,0,286000,-286000,-286000
057347,國巨統一9A購03  ,0,0,0,0,0,0,0,0,0,-286000,0,0,0,274000,560000,-286000,-286000
6282,康舒            ,222000,513000,-291000,0,0,0,0,0,0,4000,0,0,0,4000,0,4000,-287000
5264,鎧勝-KY         ,428000,756000,-328000,0,0,0,0,0,0,40000,0,1000,-1000,47000,6000,41000,-288000
062742,技嘉國泰01購01  ,0,0,0,0,0,0,0,0,0,-289000,0,0,0,0,289000,-289000,-289000
062264,南六元大9B購02  ,0,0,0,0,0,0,0,0,0,-290000,0,0,0,75000,365000,-290000,-290000
060100,新光金元大9C購01,0,0,0,0,0,0,0,0,0,-292000,0,0,0,68000,360000,-292000,-292000
2383,台光電          ,520000,545000,-25000,0,0,0,0,291000,-291000,24000,30000,43000,-13000,55000,18000,37000,-292000
051847,香港反中信99購01,0,0,0,0,0,0,0,0,0,-293000,0,0,0,150000,443000,-293000,-293000
063104,大立光群益9C購02,0,0,0,0,0,0,0,0,0,-294000,0,0,0,0,294000,-294000,-294000
2355,敬鵬            ,208000,540000,-332000,0,0,0,0,0,0,38000,53000,2000,51000,0,13000,-13000,-294000
060093,友達元大03購01  ,0,0,0,0,0,0,0,0,0,-295000,0,0,0,177000,472000,-295000,-295000
056331,聯鈞國票99購01  ,0,0,0,0,0,0,0,0,0,-295000,0,0,0,3000,298000,-295000,-295000
055311,健策群益98購02  ,0,0,0,0,0,0,0,0,0,-295000,0,0,0,5000,300000,-295000,-295000
059581,日月光元富99購02,0,0,0,0,0,0,0,0,0,-295000,0,0,0,66000,361000,-295000,-295000
6166,凌華            ,1151000,1446000,-295000,0,0,0,0,0,0,-1000,2000,0,2000,3000,6000,-3000,-296000
053814,美律群益97購02  ,0,0,0,0,0,0,0,0,0,-299000,0,0,0,0,299000,-299000,-299000
1319,東陽            ,256377,676000,-419623,0,0,0,72000,0,72000,48000,48000,0,48000,0,0,0,-299623
063261,康控富邦03購01  ,0,0,0,0,0,0,0,0,0,-300000,0,0,0,5000,305000,-300000,-300000
07989P,玉晶光凱基9B售07,0,0,0,0,0,0,0,0,0,-300000,0,0,0,10000,310000,-300000,-300000
062132,神隆群益9B購01  ,0,0,0,0,0,0,0,0,0,-301000,0,0,0,93000,394000,-301000,-301000
052113,漢唐中信98購01  ,0,0,0,0,0,0,0,0,0,-302000,0,0,0,40000,342000,-302000,-302000
057704,台虹群益98購03  ,0,0,0,0,0,0,0,0,0,-302000,0,0,0,134000,436000,-302000,-302000
062319,南六凱基9B購02  ,0,0,0,0,0,0,0,0,0,-303000,0,0,0,68000,371000,-303000,-303000
057613,瑞昱元富02購02  ,0,0,0,0,0,0,0,0,0,-304000,0,0,0,205000,509000,-304000,-304000
056769,國產元大98購01  ,0,0,0,0,0,0,0,0,0,-305000,0,0,0,169000,474000,-305000,-305000
060230,台積電元大9A購07,0,0,0,0,0,0,0,0,0,-305000,0,0,0,26000,331000,-305000,-305000
059189,國泰金富邦9B購01,0,0,0,0,0,0,0,0,0,-305000,0,0,0,0,305000,-305000,-305000
058896,中環元大99購03  ,0,0,0,0,0,0,0,0,0,-306000,0,0,0,0,306000,-306000,-306000
08074P,緯穎元富9B售02  ,0,0,0,0,0,0,0,0,0,-306000,0,0,0,103000,409000,-306000,-306000
2406,國碩            ,41000,348000,-307000,0,0,0,0,0,0,1000,1000,0,1000,0,0,0,-306000
060993,健策元大9B購03  ,1000,0,1000,0,0,0,0,0,0,-307000,0,0,0,9000,316000,-307000,-306000
063322,台郡群益9B購02  ,0,0,0,0,0,0,0,0,0,-307000,0,0,0,13000,320000,-307000,-307000
058127,FBVIX元大9C購01 ,0,0,0,0,0,0,0,0,0,-310000,0,0,0,0,310000,-310000,-310000
057724,亞德客國泰99購01,0,0,0,0,0,0,0,0,0,-314000,0,0,0,85000,399000,-314000,-314000
3034,聯詠            ,2244560,2990730,-746170,0,0,0,228000,0,228000,204000,210000,36000,174000,42000,12000,30000,-314170
061431,鈺齊元大9A購01  ,0,0,0,0,0,0,0,0,0,-315000,0,0,0,100000,415000,-315000,-315000
020016,統一MSCI美科技N ,0,0,0,0,0,0,0,0,0,-316000,0,0,0,27000,343000,-316000,-316000
061215,健策元大9A購06  ,0,0,0,0,0,0,0,0,0,-317000,0,0,0,62000,379000,-317000,-317000
061822,和潤群益9B購01  ,0,0,0,0,0,0,0,0,0,-318000,0,0,0,127000,445000,-318000,-318000
062537,聯電國泰9C購01  ,0,0,0,0,0,0,0,0,0,-319000,0,0,0,0,319000,-319000,-319000
06228P,亞德客凱基97售04,0,0,0,0,0,0,0,0,0,-320000,0,0,0,0,320000,-320000,-320000
056852,矽格元富98購01  ,0,0,0,0,0,0,0,0,0,-320000,0,0,0,195000,515000,-320000,-320000
055214,聯電凱基97購02  ,0,0,0,0,0,0,0,0,0,-320000,0,0,0,10000,330000,-320000,-320000
058536,群創統一9B購01  ,0,0,0,0,0,0,0,0,0,-320000,0,0,0,0,320000,-320000,-320000
062646,聯發科國泰01購02,0,0,0,0,0,0,0,0,0,-321000,0,0,0,9000,330000,-321000,-321000
058688,矽創凱基9A購01  ,0,0,0,0,0,0,0,0,0,-321000,0,0,0,159000,480000,-321000,-321000
07982P,全新群益9B售04  ,0,0,0,0,0,0,0,0,0,-321000,0,0,0,0,321000,-321000,-321000
060786,聯發科富邦9B購06,0,0,0,0,0,0,0,0,0,-321000,0,0,0,1000,322000,-321000,-321000
052489,義隆國票96購02  ,0,0,0,0,0,0,0,0,0,-323000,0,0,0,0,323000,-323000,-323000
057110,立積群益98購01  ,0,0,0,0,0,0,0,0,0,-325000,0,0,0,0,325000,-325000,-325000
057763,康控凱基99購02  ,0,0,0,0,0,0,0,0,0,-325000,0,0,0,0,325000,-325000,-325000
057955,技嘉元大98購07  ,0,0,0,0,0,0,0,0,0,-326000,0,0,0,95000,421000,-326000,-326000
063091,聯電中信9B購01  ,0,0,0,0,0,0,0,0,0,-327000,0,0,0,158000,485000,-327000,-327000
07858P,旺宏永豐9A售03  ,0,0,0,0,0,0,0,0,0,-327000,0,0,0,0,327000,-327000,-327000
058889,元油2X元大9C購05,0,0,0,0,0,0,0,0,0,-329000,0,0,0,0,329000,-329000,-329000
061950,日月光群益9B購01,0,0,0,0,0,0,0,0,0,-330000,0,0,0,36000,366000,-330000,-330000
061301,華新科永豐9A購03,0,0,0,0,0,0,0,0,0,-333000,0,0,0,0,333000,-333000,-333000
063012,技嘉元大9B購01  ,0,0,0,0,0,0,0,0,0,-335000,0,0,0,20000,355000,-335000,-335000
061746,國巨統一9C購07  ,0,0,0,0,0,0,0,0,0,-337000,0,0,0,0,337000,-337000,-337000
060121,新光金富邦99購01,0,0,0,0,0,0,0,0,0,-337000,0,0,0,49000,386000,-337000,-337000
061439,寶成凱基9A購01  ,0,0,0,0,0,0,0,0,0,-338000,0,0,0,168000,506000,-338000,-338000
053573,臺股指統一99購01,0,0,0,0,0,0,0,0,0,-338000,0,0,0,103000,441000,-338000,-338000
3005,神基            ,315000,798000,-483000,0,0,0,0,0,0,145000,141000,0,141000,55000,51000,4000,-338000
062221,奇力新統一01購01,0,0,0,0,0,0,0,0,0,-339000,0,0,0,0,339000,-339000,-339000
057001,華邦電國票99購02,0,0,0,0,0,0,0,0,0,-339000,0,0,0,160000,499000,-339000,-339000
062877,可成兆豐9C購01  ,0,0,0,0,0,0,0,0,0,-340000,0,0,0,26000,366000,-340000,-340000
2392,正崴            ,188000,635000,-447000,0,0,0,0,0,0,107000,83000,0,83000,24000,0,24000,-340000
063349,台郡統一9C購01  ,0,0,0,0,0,0,0,0,0,-342000,0,0,0,125000,467000,-342000,-342000
07768P,緯穎群益9A售02  ,0,0,0,0,0,0,0,0,0,-342000,0,0,0,69000,411000,-342000,-342000
2642,宅配通          ,135000,230000,-95000,0,0,0,0,248000,-248000,0,0,0,0,0,0,0,-343000
4919,新唐            ,116000,374000,-258000,0,0,0,0,0,0,-86000,0,0,0,2000,88000,-86000,-344000
055579,健策統一9A購01  ,0,0,0,0,0,0,0,0,0,-345000,0,0,0,608000,953000,-345000,-345000
3704,合勤控          ,79000,424000,-345000,0,0,0,0,0,0,0,0,0,0,0,0,0,-345000
061747,南亞科統一01購01,0,0,0,0,0,0,0,0,0,-346000,0,0,0,21000,367000,-346000,-346000
060028,國揚永豐99購01  ,0,0,0,0,0,0,0,0,0,-348000,0,0,0,121000,469000,-348000,-348000
058748,景碩凱基9A購01  ,0,0,0,0,0,0,0,0,0,-349000,0,0,0,116000,465000,-349000,-349000
8213,志超            ,587000,864000,-277000,0,0,0,0,0,0,-72000,0,0,0,42000,114000,-72000,-349000
057062,立積國泰99購01  ,0,0,0,0,0,0,0,0,0,-350000,0,0,0,20000,370000,-350000,-350000
060302,台積電富邦02購01,0,0,0,0,0,0,0,0,0,-350000,0,0,0,37000,387000,-350000,-350000
061377,聯發科永豐9A購04,0,0,0,0,0,0,0,0,0,-350000,0,0,0,6000,356000,-350000,-350000
06421P,嘉澤統一97售02  ,0,0,0,0,0,0,0,0,0,-352000,0,0,0,412000,764000,-352000,-352000
6120,達運            ,131000,487000,-356000,0,0,0,0,0,0,3000,3000,0,3000,0,0,0,-353000
058315,TPK富邦9C購01   ,0,0,0,0,0,0,0,0,0,-355000,0,0,0,87000,442000,-355000,-355000
062643,緯穎國票9B購01  ,0,0,0,0,0,0,0,0,0,-359000,0,0,0,0,359000,-359000,-359000
061535,群創統一9C購01  ,0,0,0,0,0,0,0,0,0,-361000,0,0,0,119000,480000,-361000,-361000
5876,上海商銀        ,7818775,8075585,-256810,0,0,0,8000,1000,7000,-114000,0,113000,-113000,0,1000,-1000,-363810
061823,勤誠群益9B購01  ,0,0,0,0,0,0,0,0,0,-364000,0,0,0,100000,464000,-364000,-364000
061360,智邦兆豐9B購02  ,0,0,0,0,0,0,0,0,0,-364000,0,0,0,30000,394000,-364000,-364000
061613,南六統一9C購01  ,0,0,0,0,0,0,0,0,0,-366000,0,0,0,64000,430000,-366000,-366000
056676,國產元富98購01  ,0,0,0,0,0,0,0,0,0,-366000,0,0,0,271000,637000,-366000,-366000
1723,中碳            ,44000,419000,-375000,0,0,0,0,0,0,8000,8000,0,8000,0,0,0,-367000
057612,瑞昱元富02購01  ,0,0,0,0,0,0,0,0,0,-370000,0,0,0,260000,630000,-370000,-370000
058559,華新科日盛99購02,0,0,0,0,0,0,0,0,0,-371000,0,0,0,0,371000,-371000,-371000
2390,云辰            ,432000,821000,-389000,0,0,0,0,0,0,18000,19000,1000,18000,0,0,0,-371000
060862,美律永豐9A購01  ,0,0,0,0,0,0,0,0,0,-373000,0,0,0,166000,539000,-373000,-373000
060047,道瓊反凱基99購01,0,0,0,0,0,0,0,0,0,-375000,0,0,0,0,375000,-375000,-375000
3040,遠見            ,96000,472102,-376102,0,0,0,0,0,0,0,0,0,0,0,0,0,-376102
3010,華立            ,130000,572000,-442000,0,0,0,0,0,0,64000,64000,0,64000,0,0,0,-378000
3698,隆達            ,747000,1136000,-389000,0,0,0,0,0,0,11000,22000,14000,8000,3000,0,3000,-378000
058764,康友群益99購01  ,0,0,0,0,0,0,0,0,0,-380000,0,0,0,0,380000,-380000,-380000
063447,聯發科統一9B購12,0,0,0,0,0,0,0,0,0,-381000,0,0,0,0,381000,-381000,-381000
059188,京元電富邦9B購01,0,0,0,0,0,0,0,0,0,-381000,0,0,0,490000,871000,-381000,-381000
062181,義隆元大9B購03  ,0,0,0,0,0,0,0,0,0,-383000,0,0,0,53000,436000,-383000,-383000
056057,華邦電元大97購05,0,0,0,0,0,0,0,0,0,-385000,0,0,0,0,385000,-385000,-385000
8163,達方            ,67000,475000,-408000,0,0,0,0,0,0,20000,16000,2000,14000,9000,3000,6000,-388000
056710,漢唐永豐98購01  ,0,0,0,0,0,0,0,0,0,-389000,0,0,0,51000,440000,-389000,-389000
058181,華新科國泰9B購01,0,0,0,0,0,0,0,0,0,-390000,0,0,0,10000,400000,-390000,-390000
07817P,同欣電群益9A售02,0,0,0,0,0,0,0,0,0,-393000,0,0,0,218000,611000,-393000,-393000
062278,聯發科群益9C購01,0,0,0,0,0,0,0,0,0,-395000,0,0,0,181000,576000,-395000,-395000
062219,燿華統一9B購01  ,0,0,0,0,0,0,0,0,0,-396000,0,0,0,0,396000,-396000,-396000
063144,超眾統一9C購02  ,0,0,0,0,0,0,0,0,0,-397000,0,0,0,226000,623000,-397000,-397000
057716,神達統一98購01  ,0,0,0,0,0,0,0,0,0,-398000,0,0,0,50000,448000,-398000,-398000
063068,聯發科國泰01購03,0,0,0,0,0,0,0,0,0,-399000,0,0,0,0,399000,-399000,-399000
07074P,FBVIX凱基9A售01 ,0,0,0,0,0,0,0,0,0,-399000,0,0,0,1000,400000,-399000,-399000
056250,瑞昱兆豐97購02  ,0,0,0,0,0,0,0,0,0,-399000,0,0,0,120000,519000,-399000,-399000
063060,華新科元富9B購03,0,0,0,0,0,0,0,0,0,-400000,0,0,0,0,400000,-400000,-400000
063061,華新科元富9B購04,0,0,0,0,0,0,0,0,0,-400000,0,0,0,0,400000,-400000,-400000
059929,華新科富邦9C購03,0,0,0,0,0,0,0,0,0,-400000,0,0,0,0,400000,-400000,-400000
055137,GIS富邦98購01   ,0,0,0,0,0,0,0,0,0,-401000,0,0,0,364000,765000,-401000,-401000
062220,台光電統一01購01,0,0,0,0,0,0,0,0,0,-402000,0,0,0,38000,440000,-402000,-402000
3682,亞太電          ,304000,706000,-402000,0,0,0,0,0,0,0,0,0,0,0,0,0,-402000
2104,國際中橡        ,1201000,1711000,-510000,0,0,0,0,0,0,107000,107000,0,107000,0,0,0,-403000
5534,長虹            ,162000,596000,-434000,0,0,0,0,0,0,28000,28000,0,28000,0,0,0,-406000
060851,國巨國泰9C購01  ,0,0,0,0,0,0,0,0,0,-407000,0,0,0,369000,776000,-407000,-407000
2106,建大            ,181000,1023000,-842000,0,0,0,333000,0,333000,102000,102000,0,102000,0,0,0,-407000
056497,GIS國泰99購01   ,0,0,0,0,0,0,0,0,0,-408000,0,0,0,16000,424000,-408000,-408000
057626,技嘉富邦9A購01  ,0,0,0,0,0,0,0,0,0,-408000,0,0,0,16000,424000,-408000,-408000
057973,神達富邦9A購01  ,0,0,0,0,0,0,0,0,0,-410000,0,0,0,77000,487000,-410000,-410000
061612,南六統一9A購01  ,0,0,0,0,0,0,0,0,0,-414000,0,0,0,207000,621000,-414000,-414000
058210,臺股指凱基9C購04,0,0,0,0,0,0,0,0,0,-415000,0,0,0,201000,616000,-415000,-415000
1440,南紡            ,458000,890000,-432000,0,0,0,0,0,0,12000,12000,0,12000,0,0,0,-420000
07789P,緯穎群益9A售03  ,0,0,0,0,0,0,0,0,0,-421000,0,0,0,124000,545000,-421000,-421000
063073,瑞昱永豐9B購01  ,0,0,0,0,0,0,0,0,0,-422000,0,0,0,40000,462000,-422000,-422000
053864,義隆元大96購01  ,0,0,0,0,0,0,0,0,0,-423000,0,0,0,88000,511000,-423000,-423000
060390,聯鈞群益9A購01  ,0,0,0,0,0,0,0,0,0,-423000,0,0,0,104000,527000,-423000,-423000
060398,立積國票9B購01  ,0,0,0,0,0,0,0,0,0,-425000,0,0,0,16000,441000,-425000,-425000
059607,台積電富邦9C購04,0,0,0,0,0,0,0,0,0,-426000,0,0,0,34000,460000,-426000,-426000
061078,台積電兆豐9A購01,0,0,0,0,0,0,0,0,0,-426000,0,0,0,5000,431000,-426000,-426000
06456P,聯發科統一98售03,0,0,0,0,0,0,0,0,0,-427000,0,0,0,452000,879000,-427000,-427000
06751P,旺宏凱基98售10  ,0,0,0,0,0,0,0,0,0,-428000,0,0,0,18000,446000,-428000,-428000
055348,旺宏凱基97購01  ,0,0,0,0,0,0,0,0,0,-430000,0,0,0,125000,555000,-430000,-430000
9945,潤泰新          ,2436620,2883704,-447084,0,0,0,0,0,0,17000,12000,13000,-1000,18000,0,18000,-430084
062290,聯發科富邦9C購04,0,0,0,0,0,0,0,0,0,-433000,0,0,0,0,433000,-433000,-433000
061611,南六統一01購01  ,0,0,0,0,0,0,0,0,0,-434000,0,0,0,1000,435000,-434000,-434000
3049,和鑫            ,164000,544000,-380000,0,0,0,0,0,0,-55000,0,0,0,51000,106000,-55000,-435000
063205,貿聯統一9C購01  ,0,0,0,0,0,0,0,0,0,-436000,0,0,0,395000,831000,-436000,-436000
060861,漢唐永豐9A購01  ,0,0,0,0,0,0,0,0,0,-437000,0,0,0,53000,490000,-437000,-437000
062229,南六統一9B購01  ,0,0,0,0,0,0,0,0,0,-438000,0,0,0,0,438000,-438000,-438000
062575,景碩群益9B購01  ,0,0,0,0,0,0,0,0,0,-438000,0,0,0,797000,1235000,-438000,-438000
057084,立積統一9B購01  ,0,0,0,0,0,0,0,0,0,-438000,0,0,0,1000,439000,-438000,-438000
060485,華新科富邦9C購04,0,0,0,0,0,0,0,0,0,-440000,0,0,0,0,440000,-440000,-440000
058379,臺股指凱基99購14,0,0,0,0,0,0,0,0,0,-441000,0,0,0,100000,541000,-441000,-441000
6202,盛群            ,239000,697000,-458000,0,0,0,0,0,0,17000,10000,0,10000,10000,3000,7000,-441000
062228,南六統一02購01  ,0,0,0,0,0,0,0,0,0,-443000,0,0,0,44000,487000,-443000,-443000
062980,康控元富9B購01  ,0,0,0,0,0,0,0,0,0,-444000,0,0,0,99000,543000,-444000,-444000
062882,新日興兆豐9C購01,0,0,0,0,0,0,0,0,0,-447000,0,0,0,533000,980000,-447000,-447000
051809,義隆凱基96購01  ,0,0,0,0,0,0,0,0,0,-450000,0,0,0,0,450000,-450000,-450000
058927,勤誠元富99購02  ,0,0,0,0,0,0,0,0,0,-451000,0,0,0,0,451000,-451000,-451000
5531,鄉林            ,290000,741000,-451000,0,0,0,0,0,0,0,0,0,0,0,0,0,-451000
060234,凱美元大9C購01  ,0,0,0,0,0,0,0,0,0,-452000,0,0,0,367000,819000,-452000,-452000
060934,台汽電永豐9A購02,0,0,0,0,0,0,0,0,0,-452000,0,0,0,0,452000,-452000,-452000
060259,潤泰全凱基9C購01,0,0,0,0,0,0,0,0,0,-453000,0,0,0,0,453000,-453000,-453000
2489,瑞軒            ,128000,696000,-568000,0,0,0,0,0,0,113000,113000,0,113000,0,0,0,-455000
062885,臻鼎兆豐9C購01  ,0,0,0,0,0,0,0,0,0,-460000,0,0,0,143000,603000,-460000,-460000
058832,立積永豐99購01  ,0,0,0,0,0,0,0,0,0,-460000,0,0,0,0,460000,-460000,-460000
061326,新日興凱基9B購01,0,0,0,0,0,0,0,0,0,-461000,0,0,0,132000,593000,-461000,-461000
061080,華邦電兆豐9B購01,0,0,0,0,0,0,0,0,0,-462000,0,0,0,159000,621000,-462000,-462000
059680,台積電國泰9A購03,0,0,0,0,0,0,0,0,0,-462000,0,0,0,464000,926000,-462000,-462000
2367,燿華            ,1258000,1807000,-549000,0,0,0,0,0,0,86000,6000,0,6000,164000,84000,80000,-463000
061797,聯發科永豐9B購01,0,0,0,0,0,0,0,0,0,-464000,0,0,0,0,464000,-464000,-464000
055227,聯發科國票98購02,0,0,0,0,0,0,0,0,0,-464000,0,0,0,10000,474000,-464000,-464000
055092,開發金群益9B購01,0,0,0,0,0,0,0,0,0,-464000,0,0,0,7000,471000,-464000,-464000
061663,南六永豐9A購05  ,0,0,0,0,0,0,0,0,0,-466000,0,0,0,30000,496000,-466000,-466000
063580,立積國泰9C購01  ,0,0,0,0,0,0,0,0,0,-466000,0,0,0,0,466000,-466000,-466000
058327,大毅統一9B購01  ,0,0,0,0,0,0,0,0,0,-468000,0,0,0,241000,709000,-468000,-468000
056084,漢唐統一97購03  ,0,0,0,0,0,0,0,0,0,-470000,0,0,0,12000,482000,-470000,-470000
062425,可成統一01購01  ,0,0,0,0,0,0,0,0,0,-475000,0,0,0,20000,495000,-475000,-475000
2897,王道銀行        ,229000,750000,-521000,0,0,0,0,0,0,46000,46000,0,46000,0,0,0,-475000
057299,立積永豐98購02  ,0,0,0,0,0,0,0,0,0,-476000,0,0,0,4000,480000,-476000,-476000
2399,映泰            ,213000,688000,-475000,0,0,0,0,0,0,-3000,0,3000,-3000,0,0,0,-478000
07234P,台灣50元大9B售04,0,0,0,0,0,0,0,0,0,-480000,0,0,0,90000,570000,-480000,-480000
059101,康控統一9A購01  ,0,0,0,0,0,0,0,0,0,-484000,0,0,0,0,484000,-484000,-484000
061584,勤誠元大9A購01  ,0,0,0,0,0,0,0,0,0,-488000,0,0,0,355000,843000,-488000,-488000
061363,儒鴻國票9B購01  ,0,0,0,0,0,0,0,0,0,-488000,0,0,0,2000,490000,-488000,-488000
060193,群創元富9A購01  ,0,0,0,0,0,0,0,0,0,-489000,0,0,0,78000,567000,-489000,-489000
061536,華擎統一9C購02  ,0,0,0,0,0,0,0,0,0,-491000,0,0,0,121000,612000,-491000,-491000
062852,聯發科永豐9B購02,0,0,0,0,0,0,0,0,0,-492000,0,0,0,28000,520000,-492000,-492000
062801,宏達電統一01購01,0,0,0,0,0,0,0,0,0,-492000,0,0,0,10000,502000,-492000,-492000
063154,南六元富9B購02  ,0,0,0,0,0,0,0,0,0,-492000,0,0,0,84000,576000,-492000,-492000
056268,新日興統一97購01,0,0,0,0,0,0,0,0,0,-492000,0,0,0,386000,878000,-492000,-492000
058721,立積元富9C購01  ,0,0,0,0,0,0,0,0,0,-493000,0,0,0,308000,801000,-493000,-493000
061307,和潤永豐9A購02  ,0,0,0,0,0,0,0,0,0,-494000,0,0,0,90000,584000,-494000,-494000
2308,台達電          ,5067879,5572580,-504701,0,0,0,0,40000,-40000,47000,42000,0,42000,10000,5000,5000,-497701
063071,華新科富邦02購01,0,0,0,0,0,0,0,0,0,-500000,0,0,0,0,500000,-500000,-500000
06686P,麗豐永豐98售02  ,0,0,0,0,0,0,0,0,0,-500000,0,0,0,0,500000,-500000,-500000
060380,T50反1凱基9A購08,0,0,0,0,0,0,0,0,0,-500000,0,0,0,0,500000,-500000,-500000
063360,茂林國泰9C購02  ,0,0,0,0,0,0,0,0,0,-501000,0,0,0,102000,603000,-501000,-501000
08057P,京鼎群益9B售01  ,0,0,0,0,0,0,0,0,0,-502000,0,0,0,31000,533000,-502000,-502000
062655,漢唐永豐9B購01  ,0,0,0,0,0,0,0,0,0,-504000,0,0,0,0,504000,-504000,-504000
055257,景碩統一97購01  ,0,0,0,0,0,0,0,0,0,-504000,0,0,0,311000,815000,-504000,-504000
057940,和大國票99購01  ,0,0,0,0,0,0,0,0,0,-505000,0,0,0,43000,548000,-505000,-505000
060700,華新科國泰9C購01,0,0,0,0,0,0,0,0,0,-507000,0,0,0,74000,581000,-507000,-507000
061451,南電中信9A購03  ,0,0,0,0,0,0,0,0,0,-508000,0,0,0,0,508000,-508000,-508000
063138,聯發科統一01購05,0,0,0,0,0,0,0,0,0,-509000,0,0,0,8000,517000,-509000,-509000
057085,立積統一9B購02  ,0,0,0,0,0,0,0,0,0,-514000,0,0,0,252000,766000,-514000,-514000
2515,中工            ,462000,981000,-519000,0,0,0,0,0,0,3000,0,0,0,10000,7000,3000,-516000
057824,日月光元大98購01,0,0,0,0,0,0,0,0,0,-517000,0,0,0,2000,519000,-517000,-517000
2441,超豐            ,100000,640000,-540000,0,0,0,0,0,0,21000,28000,7000,21000,0,0,0,-519000
063268,GIS中信9B購01   ,0,0,0,0,0,0,0,0,0,-520000,0,0,0,121000,641000,-520000,-520000
062698,台積電元大01購01,0,0,0,0,0,0,0,0,0,-520000,0,0,0,100000,620000,-520000,-520000
3004,豐達科          ,58000,690000,-632000,0,0,0,80000,0,80000,28000,1000,0,1000,35000,8000,27000,-524000
058647,華新科永豐99購03,0,0,0,0,0,0,0,0,0,-526000,0,0,0,0,526000,-526000,-526000
1102,亞泥            ,5350429,6653000,-1302571,0,0,0,700000,0,700000,72000,34000,0,34000,56000,18000,38000,-530571
058180,華新科國泰9A購01,0,0,0,0,0,0,0,0,0,-538000,0,0,0,46000,584000,-538000,-538000
058928,國巨統一9C購01  ,0,0,0,0,0,0,0,0,0,-539000,0,0,0,0,539000,-539000,-539000
057700,新日興群益9A購01,0,0,0,0,0,0,0,0,0,-547000,0,0,0,119000,666000,-547000,-547000
063013,技嘉元大9B購02  ,0,0,0,0,0,0,0,0,0,-552000,0,0,0,178000,730000,-552000,-552000
061511,緯穎富邦9B購02  ,0,0,0,0,0,0,0,0,0,-556000,0,0,0,0,556000,-556000,-556000
063260,信邦富邦9B購01  ,0,0,0,0,0,0,0,0,0,-558000,0,0,0,50000,608000,-558000,-558000
062215,華通統一9B購01  ,0,0,0,0,0,0,0,0,0,-559000,0,0,0,123000,682000,-559000,-559000
057112,立積群益99購01  ,0,0,0,0,0,0,0,0,0,-562000,0,0,0,36000,598000,-562000,-562000
060781,台郡國泰9B購01  ,0,0,0,0,0,0,0,0,0,-562000,0,0,0,105000,667000,-562000,-562000
061788,信邦群益9B購01  ,0,0,0,0,0,0,0,0,0,-563000,0,0,0,0,563000,-563000,-563000
06525P,上証2X國泰99售01,0,0,0,0,0,0,0,0,0,-565000,0,0,0,35000,600000,-565000,-565000
00830,國泰費城半導體  ,6000,368000,-362000,0,0,0,0,0,0,-204000,0,0,0,203000,407000,-204000,-566000
052704,TPK國票97購01   ,0,0,0,0,0,0,0,0,0,-567000,0,0,0,0,567000,-567000,-567000
060034,立積永豐99購04  ,0,0,0,0,0,0,0,0,0,-569000,0,0,0,20000,589000,-569000,-569000
061493,T50反1國票9B購04,0,0,0,0,0,0,0,0,0,-570000,0,0,0,20000,590000,-570000,-570000
055174,精元統一97購01  ,0,0,0,0,0,0,0,0,0,-571000,0,0,0,384000,955000,-571000,-571000
063409,GIS國票9C購02   ,10000,0,10000,0,0,0,0,0,0,-589000,0,0,0,27000,616000,-589000,-579000
063153,南六元富9B購01  ,0,0,0,0,0,0,0,0,0,-582000,0,0,0,128000,710000,-582000,-582000
056459,茂林凱基99購01  ,0,0,0,0,0,0,0,0,0,-585000,0,0,0,55000,640000,-585000,-585000
061187,瀚宇博國泰9C購01,0,0,0,0,0,0,0,0,0,-589000,0,0,0,422000,1011000,-589000,-589000
2031,新光鋼          ,160000,794000,-634000,0,0,0,0,0,0,44000,44000,0,44000,0,0,0,-590000
9939,宏全            ,180000,753000,-573000,0,0,0,0,0,0,-18000,15000,0,15000,0,33000,-33000,-591000
2105,正新            ,14301570,15013023,-711453,0,0,0,0,5000,-5000,125000,131000,10000,121000,4000,0,4000,-591453
063135,國巨統一9B購16  ,0,0,0,0,0,0,0,0,0,-596000,0,0,0,10000,606000,-596000,-596000
1227,佳格            ,1539929,2277144,-737215,0,0,0,54000,0,54000,87000,87000,0,87000,0,0,0,-596215
054727,台積電日盛97購02,0,0,0,0,0,0,0,0,0,-598000,0,0,0,1750000,2348000,-598000,-598000
058972,新日興永豐9A購01,0,0,0,0,0,0,0,0,0,-598000,0,0,0,65000,663000,-598000,-598000
2006,東和鋼鐵        ,673000,1265000,-592000,0,0,0,0,0,0,-6000,24000,30000,-6000,0,0,0,-598000
058913,元油2X元富01購01,0,0,0,0,0,0,0,0,0,-600000,0,0,0,0,600000,-600000,-600000
058380,臺股指凱基99購15,0,0,0,0,0,0,0,0,0,-600000,0,0,0,10000,610000,-600000,-600000
051544,T50反1康和98購01,0,0,0,0,0,0,0,0,0,-607000,0,0,0,8000,615000,-607000,-607000
058146,勤誠元大99購01  ,0,0,0,0,0,0,0,0,0,-608000,0,0,0,170000,778000,-608000,-608000
060411,達新永豐9A購01  ,2000,0,2000,0,0,0,0,0,0,-612000,0,0,0,83000,695000,-612000,-610000
3576,聯合再生        ,660000,1270000,-610000,0,0,0,0,0,0,0,0,0,0,0,0,0,-610000
2354,鴻準            ,2761169,3380758,-619589,0,0,0,0,0,0,7000,8000,1000,7000,0,0,0,-612589
056638,臺股指日盛98購01,0,0,0,0,0,0,0,0,0,-618000,0,0,0,412000,1030000,-618000,-618000
055225,華邦電國票99購01,0,0,0,0,0,0,0,0,0,-619000,0,0,0,0,619000,-619000,-619000
061171,大立光麥證9A購01,0,0,0,0,619000,-619000,0,0,0,-619000,0,0,0,0,619000,-619000,-619000
061886,力山國泰01購01  ,0,0,0,0,0,0,0,0,0,-621000,0,0,0,219000,840000,-621000,-621000
2614,東森            ,609000,1244000,-635000,0,0,0,0,0,0,0,0,0,0,0,0,0,-635000
063402,GIS群益9B購02   ,0,0,0,0,0,0,0,0,0,-637000,0,0,0,100000,737000,-637000,-637000
038489,T50反1台新9A購01,0,0,0,0,0,0,0,0,0,-640000,0,0,0,0,640000,-640000,-640000
057206,立積元富98購01  ,0,0,0,0,0,0,0,0,0,-642000,0,0,0,177000,819000,-642000,-642000
1314,中石化          ,1109000,1563000,-454000,0,0,0,0,0,0,-189000,28000,2000,26000,47000,262000,-215000,-643000
062955,立積永豐9B購02  ,0,0,0,0,0,0,0,0,0,-649000,0,0,0,85000,734000,-649000,-649000
058843,元油2X群益9C購02,0,0,0,0,0,0,0,0,0,-650000,0,0,0,0,650000,-650000,-650000
058054,台積電統一9C購01,0,0,0,0,0,0,0,0,0,-651000,0,0,0,789000,1440000,-651000,-651000
063169,台汽電永豐9B購01,0,0,0,0,0,0,0,0,0,-658000,0,0,0,0,658000,-658000,-658000
1760,寶齡富錦        ,862000,1193000,-331000,0,0,0,0,328000,-328000,0,0,0,0,0,0,0,-659000
1718,中纖            ,297000,957768,-660768,0,0,0,0,0,0,0,4000,4000,0,0,0,0,-660768
2547,日勝生          ,176000,958000,-782000,0,0,0,0,0,0,120000,120000,0,120000,0,0,0,-662000
061606,景碩凱基9A購02  ,0,0,0,0,0,0,0,0,0,-667000,0,0,0,95000,762000,-667000,-667000
06833P,矽力群益99售01  ,0,0,0,0,0,0,0,0,0,-670000,0,0,0,0,670000,-670000,-670000
058842,元油2X群益9C購01,0,0,0,0,0,0,0,0,0,-670000,0,0,0,0,670000,-670000,-670000
060239,國揚元大9C購01  ,0,0,0,0,0,0,0,0,0,-671000,0,0,0,191000,862000,-671000,-671000
2548,華固            ,330000,1082000,-752000,0,0,0,55000,0,55000,23000,23000,0,23000,0,0,0,-674000
2912,統一超          ,2911894,3455536,-543642,0,0,0,0,189000,-189000,54000,55000,0,55000,0,1000,-1000,-678642
2352,佳世達          ,807000,1538000,-731000,0,0,0,0,0,0,51000,51000,0,51000,0,0,0,-680000
07899P,和大凱基9B售01  ,0,0,0,0,0,0,0,0,0,-680000,0,0,0,89000,769000,-680000,-680000
6288,聯嘉            ,118000,806000,-688000,0,0,0,0,0,0,4000,6000,2000,4000,0,0,0,-684000
3044,健鼎            ,427000,1380500,-953500,0,0,0,183000,0,183000,68000,120000,40000,80000,9000,21000,-12000,-702500
1229,聯華            ,1025000,1819915,-794915,0,0,0,0,0,0,77000,77000,0,77000,0,0,0,-717915
063262,南六富邦9C購01  ,0,0,0,0,0,0,0,0,0,-724000,0,0,0,0,724000,-724000,-724000
2908,特力            ,109000,867000,-758000,0,0,0,0,0,0,34000,34000,0,34000,0,0,0,-724000
2511,太子            ,316000,1194000,-878000,0,0,0,0,0,0,154000,154000,0,154000,0,0,0,-724000
058926,勤誠元富99購01  ,0,0,0,0,0,0,0,0,0,-730000,0,0,0,135000,865000,-730000,-730000
062807,和碩統一9B購01  ,0,0,0,0,0,0,0,0,0,-731000,0,0,0,36000,767000,-731000,-731000
6505,台塑化          ,10052440,10742756,-690316,0,0,0,0,43000,-43000,-14000,16000,30000,-14000,0,0,0,-747316
0050,元大台灣50      ,0,709000,-709000,0,0,0,46000,0,46000,-87000,0,157000,-157000,1837000,1767000,70000,-750000
2340,光磊            ,211000,951000,-740000,0,0,0,0,0,0,-12000,0,4000,-4000,9000,17000,-8000,-752000
8016,矽創            ,339000,1015000,-676000,0,0,0,0,0,0,-78000,2000,8000,-6000,19000,91000,-72000,-754000
3037,欣興            ,3559000,4628897,-1069897,0,0,0,1326000,90000,1236000,-927000,283000,737000,-454000,91000,564000,-473000,-760897
054546,玉晶光中信9B購01,0,0,0,0,0,0,0,0,0,-768000,0,0,0,725000,1493000,-768000,-768000
1711,永光            ,273000,1114000,-841000,0,0,0,0,0,0,70000,70000,0,70000,0,0,0,-771000
062699,台積電元大01購02,0,0,0,0,0,0,0,0,0,-780000,0,0,0,15000,795000,-780000,-780000
1103,嘉泥            ,103000,897000,-794000,0,0,0,0,0,0,0,0,0,0,0,0,0,-794000
2501,國建            ,93000,989000,-896000,0,0,0,0,0,0,102000,102000,0,102000,0,0,0,-794000
1312,國喬            ,994000,1907000,-913000,0,0,0,0,0,0,116000,86000,0,86000,33000,3000,30000,-797000
2328,廣宇            ,298000,1265000,-967000,0,0,0,0,0,0,170000,170000,0,170000,0,0,0,-797000
1310,台苯            ,51000,853000,-802000,0,0,0,0,0,0,0,0,0,0,0,0,0,-802000
3703,欣陸            ,172000,1103000,-931000,0,0,0,0,0,0,124000,124000,0,124000,0,0,0,-807000
6531,愛普            ,85000,913000,-828000,0,0,0,0,0,0,20000,20000,0,20000,0,0,0,-808000
2481,強茂            ,348000,1310000,-962000,0,0,0,0,0,0,150000,152000,0,152000,0,2000,-2000,-812000
3338,泰碩            ,297000,372000,-75000,0,0,0,0,729000,-729000,-10000,2000,44000,-42000,52000,20000,32000,-814000
060303,宏達電富邦9B購01,0,0,0,0,0,0,0,0,0,-819000,0,0,0,13000,832000,-819000,-819000
2375,凱美            ,301000,1036000,-735000,0,0,0,0,0,0,-87000,0,0,0,102000,189000,-87000,-822000
062891,台汽電群益9B購01,0,0,0,0,0,0,0,0,0,-832000,0,0,0,71000,903000,-832000,-832000
07032P,聯發科統一9C售02,0,0,0,0,0,0,0,0,0,-842000,0,0,0,159000,1001000,-842000,-842000
2023,燁輝            ,157000,1156000,-999000,0,0,0,0,0,0,155000,155000,0,155000,0,0,0,-844000
057207,立積元富98購02  ,0,0,0,0,0,0,0,0,0,-849000,0,0,0,2000,851000,-849000,-849000
063146,南六統一9B購02  ,0,0,0,0,0,0,0,0,0,-857000,0,0,0,140000,997000,-857000,-857000
1789,神隆            ,916000,1858000,-942000,0,0,0,0,0,0,74000,61000,0,61000,25000,12000,13000,-868000
057971,華新科富邦9B購02,0,0,0,0,0,0,0,0,0,-870000,0,0,0,0,870000,-870000,-870000
061006,新光金兆豐9A購01,0,0,0,0,0,0,0,0,0,-888000,0,0,0,100000,988000,-888000,-888000
2504,國產            ,1479000,2780000,-1301000,0,0,0,0,0,0,401000,190000,0,190000,237000,26000,211000,-900000
00671R,富邦NASDAQ反1   ,42000,30000,12000,0,0,0,0,0,0,-919000,0,0,0,239000,1158000,-919000,-907000
6005,群益證          ,1860000,2779000,-919000,0,0,0,0,0,0,0,0,0,0,0,0,0,-919000
054369,鴻海中信9C購01  ,0,0,0,0,0,0,0,0,0,-932000,0,0,0,0,932000,-932000,-932000
058153,景碩統一9B購01  ,0,0,0,0,0,0,0,0,0,-933000,0,0,0,185000,1118000,-933000,-933000
2101,南港            ,1013000,2016000,-1003000,0,0,0,0,0,0,59000,91000,24000,67000,27000,35000,-8000,-944000
6153,嘉聯益          ,806000,1273000,-467000,0,0,0,0,0,0,-486000,4000,46000,-42000,21000,465000,-444000,-953000
3045,台灣大          ,6805789,7991707,-1185918,0,0,0,0,0,0,228000,240000,12000,228000,0,0,0,-957918
2363,矽統            ,811000,1773000,-962000,0,0,0,0,0,0,0,0,0,0,0,0,0,-962000
1304,台聚            ,1586000,2692202,-1106202,0,0,0,0,0,0,128000,128000,0,128000,0,0,0,-978202
1313,聯成            ,142000,1226974,-1084974,0,0,0,0,0,0,106000,106000,0,106000,0,0,0,-978974
062846,國泰金富邦9C購01,0,0,0,0,0,0,0,0,0,-985000,0,0,0,2000,987000,-985000,-985000
1762,中化生          ,526000,1515000,-989000,0,0,0,0,0,0,4000,4000,0,4000,0,0,0,-985000
2637,慧洋-KY         ,336000,689687,-353687,0,0,0,0,0,0,-650000,0,0,0,0,650000,-650000,-1003687
063204,高鐵統一9C購01  ,0,0,0,0,0,0,0,0,0,-1038000,0,0,0,119000,1157000,-1038000,-1038000
061659,信邦永豐9A購01  ,0,0,0,0,0,0,0,0,0,-1039000,0,0,0,169000,1208000,-1039000,-1039000
2457,飛宏            ,41000,1096000,-1055000,0,0,0,0,0,0,13000,13000,0,13000,0,0,0,-1042000
6271,同欣電          ,464000,1522000,-1058000,0,0,0,209000,145000,64000,-55000,71000,118000,-47000,4000,12000,-8000,-1049000
1536,和大            ,390000,1457000,-1067000,0,0,0,100000,20000,80000,-63000,0,0,0,3000,66000,-63000,-1050000
1326,台化            ,9002930,10038498,-1035568,0,0,0,0,0,0,-20000,10000,50000,-40000,20000,0,20000,-1055568
062230,緯穎統一01購01  ,0,0,0,0,0,0,0,0,0,-1082000,0,0,0,101000,1183000,-1082000,-1082000
2855,統一證          ,259000,1365000,-1106000,0,0,0,0,0,0,0,0,0,0,0,0,0,-1106000
2820,華票            ,1701000,2860000,-1159000,0,0,0,0,0,0,29000,29000,0,29000,0,0,0,-1130000
059943,信邦永豐99購01  ,0,0,0,0,0,0,0,0,0,-1131000,0,0,0,328000,1459000,-1131000,-1131000
060783,亞德客富邦9B購01,0,0,0,0,0,0,0,0,0,-1149000,0,0,0,163000,1312000,-1149000,-1149000
2002,中鋼            ,28232870,29400032,-1167162,0,0,0,0,5000,-5000,10000,10000,0,10000,0,0,0,-1162162
1309,台達化          ,583000,1839000,-1256000,0,0,0,0,0,0,69000,221000,152000,69000,0,0,0,-1187000
6176,瑞儀            ,678000,2120000,-1442000,0,0,0,292000,50000,242000,13000,24000,8000,16000,31000,34000,-3000,-1187000
2913,農林            ,1395000,2595000,-1200000,0,0,0,0,0,0,12000,38000,26000,12000,0,0,0,-1188000
2376,技嘉            ,2648000,4716000,-2068000,0,0,0,523000,80000,443000,435000,225000,107000,118000,321000,4000,317000,-1190000
053844,GIS統一96購01   ,0,0,0,0,0,0,0,0,0,-1202000,0,0,0,0,1202000,-1202000,-1202000
060889,國泰金統一9C購01,0,0,0,0,0,0,0,0,0,-1208000,0,0,0,0,1208000,-1208000,-1208000
9933,中鼎            ,497000,1781000,-1284000,0,0,0,0,0,0,65000,65000,0,65000,0,0,0,-1219000
2903,遠百            ,86000,1449000,-1363000,0,0,0,0,0,0,89000,89000,0,89000,0,0,0,-1274000
3036,文曄            ,411000,1861000,-1450000,0,0,0,0,0,0,149000,196000,17000,179000,0,30000,-30000,-1301000
4915,致伸            ,552000,1853000,-1301000,0,0,0,0,0,0,-13000,27000,0,27000,3000,43000,-40000,-1314000
8081,致新            ,776604,1917000,-1140396,0,0,0,116000,217000,-101000,-78000,88000,10000,78000,27000,183000,-156000,-1319396
060807,新光金群益9A購01,0,0,0,0,0,0,0,0,0,-1320000,0,0,0,0,1320000,-1320000,-1320000
2206,三陽工業        ,364000,1755000,-1391000,0,0,0,0,0,0,58000,58000,0,58000,0,0,0,-1333000
2455,全新            ,334000,1692000,-1358000,0,0,0,0,0,0,23000,69000,40000,29000,29000,35000,-6000,-1335000
060023,T50反1國泰9A購03,0,0,0,0,0,0,0,0,0,-1345000,0,0,0,146000,1491000,-1345000,-1345000
00642U,元大S&P石油     ,29000,1000,28000,0,0,0,0,0,0,-1381000,0,0,0,0,1381000,-1381000,-1353000
062591,新日興統一9C購01,0,0,0,0,0,0,0,0,0,-1376000,0,0,0,197000,1573000,-1376000,-1376000
2841,台開            ,47000,349000,-302000,0,0,0,0,0,0,-1082781,0,1082781,-1082781,0,0,0,-1384781
4904,遠傳            ,4753510,6308800,-1555290,0,0,0,0,0,0,147000,148000,0,148000,0,1000,-1000,-1408290
2049,上銀            ,2054638,3620240,-1565602,0,0,0,0,50000,-50000,206000,260000,64000,196000,18000,8000,10000,-1409602
2448,晶電            ,4455000,5501000,-1046000,0,0,0,0,930000,-930000,552000,657000,175000,482000,70000,0,70000,-1424000
2880,華南金          ,20907313,22428907,-1521594,0,0,0,18000,1000,17000,6000,6000,0,6000,0,0,0,-1498594
2014,中鴻            ,234000,1749000,-1515000,0,0,0,0,0,0,13000,13000,0,13000,0,0,0,-1502000
2867,三商壽          ,685000,2403000,-1718000,0,0,0,0,0,0,182000,182000,0,182000,0,0,0,-1536000
053799,矽創中信9A購01  ,0,0,0,0,0,0,0,0,0,-1570000,0,0,0,264000,1834000,-1570000,-1570000
6116,彩晶            ,1187000,2684000,-1497000,0,0,0,0,0,0,-110000,46000,82000,-36000,55000,129000,-74000,-1607000
1513,中興電          ,413000,1827000,-1414000,0,0,0,0,0,0,-196000,138000,45000,93000,6000,295000,-289000,-1610000
9904,寶成            ,12842320,14377814,-1535494,0,0,0,6000,0,6000,-103000,0,137000,-137000,54000,20000,34000,-1632494
6239,力成            ,5703433,7684000,-1980567,0,0,0,417000,98000,319000,-28000,24000,16000,8000,3000,39000,-36000,-1689567
2368,金像電          ,13521000,14804000,-1283000,0,0,0,0,100000,-100000,-319000,503000,885000,-382000,160000,97000,63000,-1702000
5522,遠雄            ,657000,2544000,-1887000,0,0,0,0,0,0,175000,175000,0,175000,0,0,0,-1712000
1444,力麗            ,86000,1826000,-1740000,0,0,0,0,0,0,2000,2000,0,2000,0,0,0,-1738000
2103,台橡            ,611000,2445000,-1834000,0,0,0,0,0,0,95000,95000,0,95000,0,0,0,-1739000
1409,新纖            ,364000,2313000,-1949000,0,0,0,0,0,0,117000,117000,0,117000,0,0,0,-1832000
1909,榮成            ,1460000,3185980,-1725980,0,0,0,0,0,0,-118000,2000,120000,-118000,0,0,0,-1843980
2027,大成鋼          ,960000,2113000,-1153000,0,0,0,0,0,0,-714000,24000,55000,-31000,138000,821000,-683000,-1867000
1605,華新            ,2647000,4727000,-2080000,0,0,0,0,0,0,164000,15000,156000,-141000,307000,2000,305000,-1916000
1907,永豐餘          ,731000,2967000,-2236000,0,0,0,0,0,0,290000,290000,0,290000,0,0,0,-1946000
1590,亞德客-KY       ,1093568,2898574,-1805006,0,0,0,0,143000,-143000,-26000,21000,45000,-24000,18000,20000,-2000,-1974006
3706,神達            ,1252000,3630300,-2378300,0,0,0,0,0,0,402000,130000,2000,128000,298000,24000,274000,-1976300
059503,大立光富邦9B購04,0,0,0,0,0,0,0,0,0,-1986000,0,0,0,0,1986000,-1986000,-1986000
8112,至上            ,495230,2506000,-2010770,0,0,0,0,0,0,0,0,0,0,0,0,0,-2010770
2881,富邦金          ,19397912,21437568,-2039656,0,0,0,16000,0,16000,8000,38000,39000,-1000,13000,4000,9000,-2015656
9958,世紀鋼          ,1779000,2997000,-1218000,0,0,0,75000,89000,-14000,-828000,155000,120000,35000,111000,974000,-863000,-2060000
054894,GIS統一97購01   ,0,0,0,0,0,0,0,0,0,-2094000,0,0,0,437000,2531000,-2094000,-2094000
2890,永豐金          ,56519220,58677699,-2158479,0,0,0,0,104000,-104000,0,0,0,0,0,0,0,-2262479
2809,京城銀          ,414000,2831000,-2417000,0,0,0,0,0,0,92000,92000,0,92000,0,0,0,-2325000
1717,長興            ,1450000,4277000,-2827000,0,0,0,880000,0,880000,-492000,149000,641000,-492000,0,0,0,-2439000
2845,遠東銀          ,307000,2816092,-2509092,0,0,0,0,0,0,12000,12000,0,12000,0,0,0,-2497092
2393,億光            ,639000,3166000,-2527000,0,0,0,0,0,0,1000,15000,46000,-31000,38000,6000,32000,-2526000
2882,國泰金          ,21257077,24125682,-2868605,0,0,0,42000,0,42000,297000,0,92000,-92000,410000,21000,389000,-2529605
2633,台灣高鐵        ,7482630,11411561,-3928931,0,0,0,1000000,0,1000000,120000,61000,50000,11000,140000,31000,109000,-2808931
0056,元大高股息      ,37000,39000,-2000,0,0,0,0,0,0,-2846000,200000,0,200000,0,3046000,-3046000,-2848000
2801,彰銀            ,43216819,46175330,-2958511,0,0,0,0,103000,-103000,94000,102000,8000,94000,0,0,0,-2967511
2408,南亞科          ,7585940,11618984,-4033044,0,0,0,0,0,0,109000,296000,207000,89000,54000,34000,20000,-3924044
2812,台中銀          ,768080,4823000,-4054920,0,0,0,0,0,0,92000,92000,0,92000,0,0,0,-3962920
2409,友達            ,51430968,55639000,-4208032,0,0,0,0,2000,-2000,-22000,491000,24000,467000,82000,571000,-489000,-4232032
00852L,國泰美國道瓊正2 ,0,2399000,-2399000,0,0,0,0,0,0,-2227000,0,0,0,2347000,4574000,-2227000,-4626000
1504,東元            ,2597000,7350000,-4753000,0,0,0,0,0,0,0,0,0,0,0,0,0,-4753000
2889,國票金          ,1323000,8000000,-6677000,0,0,0,0,0,0,431000,431000,0,431000,0,0,0,-6246000
2313,華通            ,1587000,7182000,-5595000,0,0,0,25000,360000,-335000,-503000,739000,672000,67000,277000,847000,-570000,-6433000
00632R,元大台灣50反1   ,3607000,1100000,2507000,0,0,0,0,0,0,-10247000,2664000,1237000,1427000,11939000,23613000,-11674000,-7740000
2344,華邦電          ,11120360,19599099,-8478739,0,0,0,0,310000,-310000,311000,597000,268000,329000,255000,273000,-18000,-8477739
1301,台塑            ,57200220,66757859,-9557639,0,0,0,767000,23000,744000,258000,286000,30000,256000,7000,5000,2000,-8555639
2915,潤泰全          ,29470819,38600660,-9129841,0,0,0,0,11984,-11984,169000,169000,0,169000,34000,34000,0,-8972825
2610,華航            ,8259970,17024284,-8764314,0,0,0,0,250000,-250000,-30000,0,0,0,0,30000,-30000,-9044314
2449,京元電子        ,1934000,12089000,-10155000,0,0,0,0,450000,-450000,147000,30000,0,30000,145000,28000,117000,-10458000
2834,臺企銀          ,19627340,31771772,-12144432,0,0,0,12000,0,12000,0,0,0,0,0,0,0,-12132432
2337,旺宏            ,6116000,16650000,-10534000,0,0,0,0,1479000,-1479000,-564000,456000,520000,-64000,155000,655000,-500000,-12577000
2884,玉山金          ,66627926,79368028,-12740102,0,0,0,24000,1000,23000,16000,77000,16000,61000,6000,51000,-45000,-12701102
2891,中信金          ,120913668,134972605,-14058937,0,0,0,0,183000,-183000,-147000,0,147000,-147000,0,0,0,-14388937
2618,長榮航          ,19204040,34245839,-15041799,0,0,0,0,200000,-200000,123000,289000,6000,283000,20000,180000,-160000,-15118799
3481,群創            ,27175300,45251667,-18076367,0,0,0,0,0,0,-325000,171000,72000,99000,176000,600000,-424000,-18401367
2330,台積電          ,70486018,91644971,-21158953,0,0,0,125000,379000,-254000,1685000,598000,108000,490000,1370000,175000,1195000,-19727953
2885,元大金          ,58999675,87357910,-28358235,0,0,0,0,111000,-111000,240000,240000,0,240000,0,0,0,-28229235
