證券代號,證券名稱,外陸資買進股數(不含外資自營商),外陸資賣出股數(不含外資自營商),外陸資買賣超股數(不含外資自營商),外資自營商買進股數,外資自營商賣出股數,外資自營商買賣超股數,投信買進股數,投信賣出股數,投信買賣超股數,自營商買賣超股數,自營商買進股數(自行買賣),自營商賣出股數(自行買賣),自營商買賣超股數(自行買賣),自營商買進股數(避險),自營商賣出股數(避險),自營商買賣超股數(避險),三大法人買賣超股數
00677U,富邦VIX         ,165605000,12448000,153157000,0,0,0,0,0,0,28432000,4513000,968000,3545000,32317000,7430000,24887000,181589000
2337,旺宏            ,21666000,18457451,3208549,0,0,0,2786000,96000,2690000,481000,671000,866000,-195000,1006000,330000,676000,6379549
00669R,國泰美國道瓊反1 ,1279000,0,1279000,0,0,0,0,0,0,3382000,0,0,0,4522000,1140000,3382000,4661000
055663,崇越中信97購01  ,0,0,0,0,0,0,0,0,0,4001000,0,0,0,4028000,27000,4001000,4001000
00648R,元大S&P500反1   ,234000,0,234000,0,0,0,0,0,0,2094000,0,0,0,2373000,279000,2094000,2328000
00671R,富邦NASDAQ反1   ,296000,6000,290000,0,0,0,0,0,0,1951000,0,0,0,2405000,454000,1951000,2241000
07292P,臺股指凱基99售44,0,0,0,0,0,0,0,0,0,2176000,0,0,0,2458000,282000,2176000,2176000
061464,瑞昱群益9A購01  ,0,0,0,0,0,0,0,0,0,2149000,0,0,0,2338000,189000,2149000,2149000
0056,元大高股息      ,31000,22000,9000,0,0,0,0,35000,-35000,1907000,330000,40000,290000,3975000,2358000,1617000,1881000
2492,華新科          ,3413300,1646000,1767300,0,0,0,665000,472000,193000,-274000,217000,416000,-199000,77000,152000,-75000,1686300
3006,晶豪科          ,1463000,490000,973000,0,0,0,293000,0,293000,360000,223000,24000,199000,256000,95000,161000,1626000
1760,寶齡富錦        ,1939000,484000,1455000,0,0,0,100000,0,100000,10000,10000,0,10000,0,0,0,1565000
047962,T50反1中信96購02,0,0,0,0,0,0,0,0,0,1547000,0,0,0,2346000,799000,1547000,1547000
4148,全宇生技-KY     ,1551000,36000,1515000,0,0,0,0,0,0,0,0,0,0,0,0,0,1515000
07700P,臺股指元大9A售53,0,0,0,0,0,0,0,0,0,1461000,0,0,0,1510000,49000,1461000,1461000
07597P,臺股指中信01售02,0,0,0,0,0,0,0,0,0,1401000,0,0,0,1959000,558000,1401000,1401000
2383,台光電          ,2665100,1448000,1217100,0,0,0,81000,0,81000,101000,386000,165000,221000,62000,182000,-120000,1399100
1701,中化            ,2008000,652000,1356000,0,0,0,0,0,0,0,0,0,0,0,0,0,1356000
058714,美律統一9B購01  ,0,0,0,0,0,0,0,0,0,1308000,0,0,0,1330000,22000,1308000,1308000
00634R,富邦上証反1     ,542000,33000,509000,0,0,0,0,0,0,731000,0,0,0,846000,115000,731000,1240000
060705,台光電富邦9B購01,0,0,0,0,0,0,0,0,0,1181000,0,0,0,1512000,331000,1181000,1181000
3042,晶技            ,2884236,1155000,1729236,0,0,0,0,606000,-606000,48000,323000,140000,183000,50000,185000,-135000,1171236
3026,禾伸堂          ,1414000,349000,1065000,0,0,0,0,0,0,72000,5000,11000,-6000,108000,30000,78000,1137000
058725,美律富邦9A購01  ,0,0,0,0,0,0,0,0,0,1131000,0,0,0,1252000,121000,1131000,1131000
2367,燿華            ,3457000,2292000,1165000,0,0,0,0,0,0,-50000,1000,6000,-5000,65000,110000,-45000,1115000
07407P,欣興凱基99售07  ,0,0,0,0,0,0,0,0,0,1108000,0,0,0,1746000,638000,1108000,1108000
07478P,南電康和9A售02  ,0,0,0,0,0,0,0,0,0,1077000,0,0,0,1367000,290000,1077000,1077000
060628,和大富邦9B購01  ,0,0,0,0,0,0,0,0,0,1032000,0,0,0,1279000,247000,1032000,1032000
053172,瑞儀群益97購01  ,0,0,0,0,0,0,0,0,0,1028000,0,0,0,1028000,0,1028000,1028000
9921,巨大            ,3097100,2213851,883249,0,0,0,121000,0,121000,-4000,17000,4000,13000,6000,23000,-17000,1000249
060788,嘉晶富邦9B購01  ,0,0,0,0,0,0,0,0,0,971000,0,0,0,976000,5000,971000,971000
060422,台勝科永豐9A購01,0,0,0,0,0,0,0,0,0,966000,0,0,0,1077000,111000,966000,966000
056617,美律永豐98購01  ,0,0,0,0,0,0,0,0,0,954000,0,0,0,954000,0,954000,954000
056601,鈺齊元富98購01  ,0,0,0,0,0,0,0,0,0,950000,0,0,0,950000,0,950000,950000
057592,美律兆豐99購01  ,0,0,0,0,0,0,0,0,0,928000,0,0,0,930000,2000,928000,928000
00638R,元大滬深300反1  ,440000,0,440000,0,0,0,0,0,0,472000,0,0,0,614000,142000,472000,912000
051258,鈺齊國泰97購01  ,0,0,0,0,0,0,0,0,0,900000,0,0,0,900000,0,900000,900000
055129,鈺齊兆豐97購01  ,0,0,0,0,0,0,0,0,0,890000,0,0,0,900000,10000,890000,890000
3017,奇鋐            ,2644000,2786000,-142000,0,0,0,552000,0,552000,466000,60000,238000,-178000,753000,109000,644000,876000
056243,創意群益97購03  ,0,0,0,0,0,0,0,0,0,860000,0,0,0,860000,0,860000,860000
06337P,祥碩元大97售05  ,0,0,0,0,0,0,0,0,0,847000,0,0,0,1540000,693000,847000,847000
059907,道瓊指元大99購03,0,0,0,0,0,0,0,0,0,838000,0,0,0,888000,50000,838000,838000
053672,嘉澤元富96購02  ,0,0,0,0,0,0,0,0,0,823000,0,0,0,838000,15000,823000,823000
056701,國產國泰9A購01  ,0,0,0,0,0,0,0,0,0,810000,0,0,0,810000,0,810000,810000
061371,嘉澤國泰9C購01  ,0,0,0,0,0,0,0,0,0,805000,0,0,0,831000,26000,805000,805000
2393,億光            ,1058000,1317000,-259000,0,0,0,510000,0,510000,549000,93000,4000,89000,488000,28000,460000,800000
2363,矽統            ,2307000,1505000,802000,0,0,0,0,0,0,-5000,0,5000,-5000,0,0,0,797000
07366P,國巨康和99售02  ,0,0,0,0,0,0,0,0,0,793000,0,0,0,2109000,1316000,793000,793000
058026,上銀富邦9A購01  ,0,0,0,0,0,0,0,0,0,785000,0,0,0,901000,116000,785000,785000
06680P,智邦元大98售06  ,0,0,0,0,0,0,0,0,0,783000,0,0,0,954000,171000,783000,783000
2316,楠梓電          ,1141000,336000,805000,0,0,0,0,0,0,-22000,10000,1000,9000,12000,43000,-31000,783000
2614,東森            ,1461000,697000,764000,0,0,0,0,0,0,0,0,0,0,0,0,0,764000
060259,潤泰全凱基9C購01,0,0,0,0,0,0,0,0,0,759000,0,0,0,759000,0,759000,759000
047410,上銀元富96購01  ,0,0,0,0,0,0,0,0,0,743000,0,0,0,970000,227000,743000,743000
060937,T50反1國票9A購10,0,0,0,0,0,0,0,0,0,741000,0,0,0,925000,184000,741000,741000
060918,康友國泰9C購01  ,0,0,0,0,0,0,0,0,0,730000,0,0,0,755000,25000,730000,730000
3532,台勝科          ,1535000,766000,769000,0,0,0,0,0,0,-45500,27000,6500,20500,79000,145000,-66000,723500
07731P,臺股指凱基9A售28,0,0,0,0,0,0,0,0,0,705000,0,0,0,767000,62000,705000,705000
061030,喬山永豐9A購01  ,0,0,0,0,0,0,0,0,0,698000,0,0,0,718000,20000,698000,698000
061587,美律富邦9A購02  ,0,0,0,0,0,0,0,0,0,682000,0,0,0,682000,0,682000,682000
06779P,智邦元大98售12  ,0,0,0,0,0,0,0,0,0,672000,0,0,0,797000,125000,672000,672000
051360,緯創元大95購03  ,0,0,0,0,0,0,0,0,0,670000,0,0,0,670000,0,670000,670000
060733,和大統一9C購01  ,0,0,0,0,0,0,0,0,0,666000,0,0,0,784000,118000,666000,666000
057798,貿聯兆豐99購01  ,0,0,0,0,0,0,0,0,0,659000,0,0,0,732000,73000,659000,659000
058153,景碩統一9B購01  ,0,0,0,0,0,0,0,0,0,655000,0,0,0,709000,54000,655000,655000
056177,嘉澤元富97購01  ,0,0,0,0,0,0,0,0,0,649000,0,0,0,738000,89000,649000,649000
057307,瀚宇博兆豐99購01,0,0,0,0,0,0,0,0,0,649000,0,0,0,1149000,500000,649000,649000
056418,台光電元富98購01,0,0,0,0,0,0,0,0,0,641000,0,0,0,841000,200000,641000,641000
058495,元大金群益9B購01,0,0,0,0,0,0,0,0,0,636000,0,0,0,636000,0,636000,636000
06852P,臺股指元大98售11,0,0,0,0,0,0,0,0,0,624000,0,0,0,1770000,1146000,624000,624000
050934,喬山國票96購01  ,0,0,0,0,0,0,0,0,0,619000,0,0,0,619000,0,619000,619000
057249,華邦電統一9A購01,0,0,0,0,0,0,0,0,0,609000,0,0,0,713000,104000,609000,609000
059296,大立光元富99購06,0,0,0,0,0,0,0,0,0,606000,0,0,0,641000,35000,606000,606000
055639,上銀元富97購02  ,0,0,0,0,0,0,0,0,0,603000,0,0,0,802000,199000,603000,603000
00641R,富邦日本反1     ,283000,64000,219000,0,0,0,0,0,0,381998,0,0,0,517000,135002,381998,600998
056480,京鼎元大98購02  ,0,0,0,0,0,0,0,0,0,599000,0,0,0,639000,40000,599000,599000
058345,台光電群益99購03,0,0,0,0,0,0,0,0,0,595000,0,0,0,717000,122000,595000,595000
06608P,立積群益99售02  ,0,0,0,0,0,0,0,0,0,593000,0,0,0,600000,7000,593000,593000
061269,嘉澤凱基9A購01  ,0,0,0,0,0,0,0,0,0,587000,0,0,0,587000,0,587000,587000
4956,光鋐            ,602000,14000,588000,0,0,0,0,0,0,-1000,0,1000,-1000,0,0,0,587000
059278,群創元大9A購04  ,0,0,0,0,0,0,0,0,0,581000,0,0,0,712000,131000,581000,581000
059051,和大凱基9A購01  ,0,0,0,0,0,0,0,0,0,572000,0,0,0,572000,0,572000,572000
058762,貿聯群益99購03  ,0,0,0,0,0,0,0,0,0,569000,0,0,0,589000,20000,569000,569000
061391,晶技群益9A購02  ,0,0,0,0,0,0,0,0,0,559000,0,0,0,559000,0,559000,559000
059176,臺股指凱基99購27,0,0,0,0,0,0,0,0,0,557000,0,0,0,715000,158000,557000,557000
056178,嘉澤元富97購02  ,0,0,0,0,0,0,0,0,0,554000,0,0,0,735000,181000,554000,554000
05464P,華通康和95售02  ,0,0,0,0,0,0,0,0,0,548000,0,0,0,550000,2000,548000,548000
056186,智原統一97購01  ,0,0,0,0,0,0,0,0,0,543000,0,0,0,543000,0,543000,543000
057912,美律日盛99購01  ,0,0,0,0,0,0,0,0,0,543000,0,0,0,983000,440000,543000,543000
060953,富邦金群益9A購01,0,0,0,0,0,0,0,0,0,540000,0,0,0,580000,40000,540000,540000
4119,旭富            ,668386,478000,190386,0,0,0,0,0,0,345000,25000,0,25000,328000,8000,320000,535386
3023,信邦            ,752512,294428,458084,0,0,0,100000,0,100000,-28000,0,2000,-2000,0,26000,-26000,530084
059425,SGBR2X元大9A購02,0,0,0,0,0,0,0,0,0,529000,0,0,0,687000,158000,529000,529000
5521,工信            ,842000,315000,527000,0,0,0,0,0,0,0,0,0,0,0,0,0,527000
060200,同欣電元富9A購01,0,0,0,0,0,0,0,0,0,524000,0,0,0,690000,166000,524000,524000
058912,祥碩元大99購01  ,0,0,0,0,0,0,0,0,0,521000,0,0,0,643000,122000,521000,521000
060436,巨大永豐9A購01  ,0,0,0,0,0,0,0,0,0,519000,0,0,0,661000,142000,519000,519000
06025P,臺股指元大99售02,0,0,0,0,0,0,0,0,0,518000,0,0,0,523000,5000,518000,518000
060142,臺指反國票9B購01,0,0,0,0,0,0,0,0,0,515000,0,0,0,515000,0,515000,515000
059030,奇力新兆豐99購03,0,0,0,0,0,0,0,0,0,515000,0,0,0,601000,86000,515000,515000
06748P,智邦台新98售02  ,0,0,0,0,0,0,0,0,0,510000,0,0,0,520000,10000,510000,510000
059100,元油2X統一9C購02,0,0,0,0,0,0,0,0,0,505000,0,0,0,1110000,605000,505000,505000
059388,國巨凱基99購13  ,0,0,0,0,0,0,0,0,0,499000,0,0,0,499000,0,499000,499000
058910,泰鼎元大99購03  ,0,0,0,0,0,0,0,0,0,498000,0,0,0,623000,125000,498000,498000
3029,零壹            ,597000,103000,494000,0,0,0,0,0,0,1000,2000,1000,1000,0,0,0,495000
061511,緯穎富邦9B購02  ,0,0,0,0,0,0,0,0,0,491000,0,0,0,798000,307000,491000,491000
059953,聯發科康和99購01,0,0,0,0,0,0,0,0,0,489000,0,0,0,519000,30000,489000,489000
052542,友達元富98購01  ,0,0,0,0,0,0,0,0,0,480000,0,0,0,500000,20000,480000,480000
3545,敦泰            ,1926000,1446000,480000,0,0,0,0,0,0,0,0,0,0,0,0,0,480000
061284,友達統一9C購01  ,0,0,0,0,0,0,0,0,0,479000,0,0,0,479000,0,479000,479000
058908,貿聯元大99購03  ,0,0,0,0,0,0,0,0,0,478000,0,0,0,608000,130000,478000,478000
057883,中環群益98購01  ,0,0,0,0,0,0,0,0,0,474000,0,0,0,588000,114000,474000,474000
061423,廣達元大9A購01  ,0,0,0,0,0,0,0,0,0,472000,0,0,0,683000,211000,472000,472000
061186,牧德國泰9C購01  ,0,0,0,0,0,0,0,0,0,471000,0,0,0,676000,205000,471000,471000
060862,美律永豐9A購01  ,0,0,0,0,0,0,0,0,0,466000,0,0,0,466000,0,466000,466000
059767,矽力永豐99購01  ,0,0,0,0,0,0,0,0,0,464000,0,0,0,493000,29000,464000,464000
060783,亞德客富邦9B購01,0,0,0,0,0,0,0,0,0,462000,0,0,0,599000,137000,462000,462000
053915,光罩國票96購02  ,0,0,0,0,0,0,0,0,0,462000,0,0,0,496000,34000,462000,462000
058849,奇力新群益99購02,0,0,0,0,0,0,0,0,0,462000,0,0,0,612000,150000,462000,462000
057517,矽創元富98購02  ,0,0,0,0,0,0,0,0,0,461000,0,0,0,594000,133000,461000,461000
054426,國泰金富邦97購02,0,0,0,0,0,0,0,0,0,460000,0,0,0,470000,10000,460000,460000
6456,GIS-KY          ,1005000,582000,423000,0,0,0,40000,0,40000,-4000,5000,2000,3000,28000,35000,-7000,459000
06503P,臺股指中信9A售02,0,0,0,0,0,0,0,0,0,458000,0,0,0,458000,0,458000,458000
052462,上銀統一95購03  ,0,0,0,0,0,0,0,0,0,457000,0,0,0,459000,2000,457000,457000
060008,華邦電群益9A購01,0,0,0,0,0,0,0,0,0,456000,0,0,0,782000,326000,456000,456000
061603,瑞昱凱基9A購02  ,0,0,0,0,0,0,0,0,0,454000,0,0,0,476000,22000,454000,454000
059080,亞泥元大99購01  ,0,0,0,0,0,0,0,0,0,454000,0,0,0,505000,51000,454000,454000
056104,義隆永豐97購01  ,0,0,0,0,0,0,0,0,0,454000,0,0,0,464000,10000,454000,454000
051414,新光金國票95購04,0,0,0,0,0,0,0,0,0,451000,0,0,0,451000,0,451000,451000
058760,嘉晶群益9A購01  ,0,0,0,0,0,0,0,0,0,451000,0,0,0,473000,22000,451000,451000
060634,矽創富邦9B購01  ,0,0,0,0,0,0,0,0,0,450000,0,0,0,784000,334000,450000,450000
055261,帆宣統一98購01  ,0,0,0,0,0,0,0,0,0,450000,0,0,0,574000,124000,450000,450000
3041,揚智            ,554000,109000,445000,0,0,0,0,0,0,-2000,0,2000,-2000,0,0,0,443000
060242,潤泰全元大9C購01,0,0,0,0,0,0,0,0,0,440000,0,0,0,440000,0,440000,440000
047673,瑞昱元富96購01  ,0,0,0,0,0,0,0,0,0,439000,0,0,0,476000,37000,439000,439000
06674P,祥碩群益98售02  ,0,0,0,0,0,0,0,0,0,438000,0,0,0,533000,95000,438000,438000
050319,康控國票95購04  ,0,0,0,0,0,0,0,0,0,438000,0,0,0,438000,0,438000,438000
058215,貿聯群益99購02  ,0,0,0,0,0,0,0,0,0,438000,0,0,0,438000,0,438000,438000
060122,亞德客永豐99購02,0,0,0,0,0,0,0,0,0,436000,0,0,0,447000,11000,436000,436000
050794,大立光富邦96購04,0,0,0,0,0,0,0,0,0,435000,0,0,0,435000,0,435000,435000
050170,臺指反元大97購02,0,0,0,0,0,0,0,0,0,434000,0,0,0,637000,203000,434000,434000
057793,群創統一99購02  ,0,0,0,0,0,0,0,0,0,432000,0,0,0,432000,0,432000,432000
060818,上銀統一9C購01  ,0,0,0,0,0,0,0,0,0,431000,0,0,0,560000,129000,431000,431000
058514,潤泰全元大99購01,0,0,0,0,0,0,0,0,0,428000,0,0,0,428000,0,428000,428000
2342,茂矽            ,673000,244000,429000,0,0,0,0,0,0,-1000,0,1000,-1000,0,0,0,428000
8271,宇瞻            ,522000,95000,427000,0,0,0,0,0,0,0,1000,1000,0,0,0,0,427000
059040,訊芯群益99購03  ,0,0,0,0,0,0,0,0,0,426000,0,0,0,555000,129000,426000,426000
057612,瑞昱元富02購01  ,0,0,0,0,0,0,0,0,0,423000,0,0,0,532000,109000,423000,423000
2458,義隆            ,2221000,1997000,224000,0,0,0,318000,0,318000,-124000,193000,98000,95000,12000,231000,-219000,418000
061046,上銀第一9A購01  ,0,0,0,0,0,0,0,0,0,417000,0,0,0,546000,129000,417000,417000
053062,緯穎富邦97購01  ,0,0,0,0,0,0,0,0,0,416000,0,0,0,416000,0,416000,416000
056288,健鼎永豐97購01  ,0,0,0,0,0,0,0,0,0,415000,0,0,0,415000,0,415000,415000
060626,貿聯元大9A購04  ,0,0,0,0,0,0,0,0,0,414000,0,0,0,414000,0,414000,414000
05755P,臺股指中信99售04,0,0,0,0,0,0,0,0,0,413000,0,0,0,433000,20000,413000,413000
060327,美律群益9A購02  ,0,0,0,0,0,0,0,0,0,411000,0,0,0,456000,45000,411000,411000
061181,牧德凱基9A購01  ,0,0,0,0,0,0,0,0,0,411000,0,0,0,557000,146000,411000,411000
060821,SP黃豆元大9A購02,0,0,0,0,0,0,0,0,0,410000,0,0,0,574000,164000,410000,410000
060308,劍麟永豐9A購01  ,0,0,0,0,0,0,0,0,0,409000,0,0,0,409000,0,409000,409000
059559,T50反1凱基99購07,50000,0,50000,0,0,0,0,0,0,356000,0,0,0,366000,10000,356000,406000
059475,元石油群益99購02,0,0,0,0,0,0,0,0,0,406000,0,0,0,406000,0,406000,406000
056823,智伸科永豐98購01,0,0,0,0,0,0,0,0,0,405000,0,0,0,405000,0,405000,405000
051722,玉晶光永豐97購01,0,0,0,0,0,0,0,0,0,405000,0,0,0,457000,52000,405000,405000
057257,台泥兆豐99購01  ,0,0,0,0,0,0,0,0,0,405000,0,0,0,417000,12000,405000,405000
050915,健策中信98購01  ,0,0,0,0,0,0,0,0,0,404000,0,0,0,427000,23000,404000,404000
058905,京鼎元大99購01  ,0,0,0,0,0,0,0,0,0,403000,0,0,0,435000,32000,403000,403000
060138,T50反1國票9A購03,0,0,0,0,0,0,0,0,0,400000,0,0,0,400000,0,400000,400000
049598,超眾元大95購03  ,0,0,0,0,0,0,0,0,0,400000,0,0,0,400000,0,400000,400000
053947,義隆富邦97購01  ,0,0,0,0,0,0,0,0,0,399000,0,0,0,679000,280000,399000,399000
056685,光罩統一98購03  ,0,0,0,0,0,0,0,0,0,399000,0,0,0,529000,130000,399000,399000
057258,中環兆豐98購01  ,0,0,0,0,0,0,0,0,0,397000,0,0,0,409000,12000,397000,397000
049924,欣興元大95購04  ,0,0,0,0,0,0,0,0,0,396000,0,0,0,396000,0,396000,396000
053864,義隆元大96購01  ,0,0,0,0,0,0,0,0,0,393000,0,0,0,466000,73000,393000,393000
05440P,緯穎國票96售02  ,0,0,0,0,0,0,0,0,0,392000,0,0,0,425000,33000,392000,392000
05759P,智邦永豐96售02  ,0,0,0,0,0,0,0,0,0,392000,0,0,0,392000,0,392000,392000
056271,嘉澤統一97購01  ,0,0,0,0,0,0,0,0,0,392000,0,0,0,392000,0,392000,392000
056961,凱美永豐98購01  ,0,0,0,0,0,0,0,0,0,392000,0,0,0,392000,0,392000,392000
060424,中租永豐9A購01  ,0,0,0,0,0,0,0,0,0,390000,0,0,0,400000,10000,390000,390000
061414,牧德群益9B購02  ,0,0,0,0,0,0,0,0,0,390000,0,0,0,486000,96000,390000,390000
058733,同欣電永豐99購02,0,0,0,0,0,0,0,0,0,387000,0,0,0,460000,73000,387000,387000
020012,富邦行動通訊N   ,0,0,0,0,0,0,0,0,0,386000,0,0,0,401000,15000,386000,386000
3437,榮創            ,578000,193000,385000,0,0,0,0,0,0,0,0,0,0,0,0,0,385000
06411P,晶相光永豐97售03,0,0,0,0,0,0,0,0,0,383000,0,0,0,383000,0,383000,383000
061187,瀚宇博國泰9C購01,0,0,0,0,0,0,0,0,0,382000,0,0,0,417000,35000,382000,382000
2329,華泰            ,812000,418000,394000,0,0,0,0,0,0,-12000,0,5000,-5000,0,7000,-7000,382000
061305,帆宣永豐9A購01  ,0,0,0,0,0,0,0,0,0,381000,0,0,0,381000,0,381000,381000
2484,希華            ,518000,135000,383000,0,0,0,0,0,0,-2000,0,2000,-2000,0,0,0,381000
05301P,矽力元大95售02  ,0,0,0,0,0,0,0,0,0,380000,0,0,0,380000,0,380000,380000
055974,上銀統一97購05  ,0,0,0,0,0,0,0,0,0,380000,0,0,0,384000,4000,380000,380000
053984,康友元大96購05  ,0,0,0,0,0,0,0,0,0,377000,0,0,0,477000,100000,377000,377000
05212P,台積電國票96售04,0,0,0,0,0,0,0,0,0,377000,0,0,0,422000,45000,377000,377000
060197,臻鼎元富9A購02  ,0,0,0,0,0,0,0,0,0,376000,0,0,0,1053000,677000,376000,376000
055619,同欣電國票98購02,0,0,0,0,0,0,0,0,0,373000,0,0,0,399000,26000,373000,373000
053198,亞德客日盛96購01,0,0,0,0,0,0,0,0,0,371000,0,0,0,395000,24000,371000,371000
051428,玉晶光統一96購01,0,0,0,0,0,0,0,0,0,368000,0,0,0,483000,115000,368000,368000
056958,喬山永豐98購01  ,0,0,0,0,0,0,0,0,0,368000,0,0,0,423000,55000,368000,368000
058312,大毅國泰9B購01  ,0,0,0,0,0,0,0,0,0,366000,0,0,0,435000,69000,366000,366000
052611,力成元大96購02  ,0,0,0,0,0,0,0,0,0,365000,0,0,0,368000,3000,365000,365000
05711P,茂林國票97售03  ,0,0,0,0,0,0,0,0,0,365000,0,0,0,365000,0,365000,365000
060385,台勝科凱基9A購01,0,0,0,0,0,0,0,0,0,360000,0,0,0,475000,115000,360000,360000
3515,華擎            ,542000,287000,255000,0,0,0,0,0,0,105000,32000,1000,31000,90000,16000,74000,360000
061544,大毅群益9B購02  ,0,0,0,0,0,0,0,0,0,359000,0,0,0,413000,54000,359000,359000
056589,康控統一98購01  ,0,0,0,0,0,0,0,0,0,359000,0,0,0,507000,148000,359000,359000
059766,同欣電永豐99購03,0,0,0,0,0,0,0,0,0,358000,0,0,0,408000,50000,358000,358000
060190,國泰金元富9A購01,0,0,0,0,0,0,0,0,0,356000,0,0,0,458000,102000,356000,356000
051745,玉晶光國泰97購06,0,0,0,0,0,0,0,0,0,354000,0,0,0,372000,18000,354000,354000
057450,國泰金元富98購01,0,0,0,0,0,0,0,0,0,354000,0,0,0,408000,54000,354000,354000
054819,裕民元大9A購01  ,0,0,0,0,0,0,0,0,0,352000,0,0,0,543000,191000,352000,352000
2345,智邦            ,3591220,3345493,245727,0,0,0,0,32000,-32000,138000,119000,42000,77000,76000,15000,61000,351727
061265,富邦金凱基9B購01,0,0,0,0,0,0,0,0,0,351000,0,0,0,375000,24000,351000,351000
060363,美律元富9A購01  ,0,0,0,0,0,0,0,0,0,348000,0,0,0,446000,98000,348000,348000
058721,立積元富9C購01  ,0,0,0,0,0,0,0,0,0,348000,0,0,0,851000,503000,348000,348000
052816,上銀永豐96購01  ,0,0,0,0,0,0,0,0,0,345000,0,0,0,470000,125000,345000,345000
057045,美律元大99購04  ,0,0,0,0,0,0,0,0,0,345000,0,0,0,356000,11000,345000,345000
07282P,聯發科凱基99售17,0,0,0,0,0,0,0,0,0,345000,0,0,0,345000,0,345000,345000
061159,同欣電群益9A購01,0,0,0,0,0,0,0,0,0,344000,0,0,0,850000,506000,344000,344000
054717,亞德客永豐97購01,0,0,0,0,0,0,0,0,0,344000,0,0,0,432000,88000,344000,344000
058061,貿聯元富9B購01  ,0,0,0,0,0,0,0,0,0,343000,0,0,0,353000,10000,343000,343000
059095,訊芯元大99購01  ,0,0,0,0,0,0,0,0,0,342000,0,0,0,530000,188000,342000,342000
056850,彩晶元富99購01  ,0,0,0,0,0,0,0,0,0,341000,0,0,0,341000,0,341000,341000
056092,亞德客元富97購02,0,0,0,0,0,0,0,0,0,340000,0,0,0,379000,39000,340000,340000
051561,玉晶光國泰97購04,0,0,0,0,0,0,0,0,0,339000,0,0,0,417000,78000,339000,339000
057725,台達電國泰9A購01,0,0,0,0,0,0,0,0,0,339000,0,0,0,349000,10000,339000,339000
8213,志超            ,589000,443000,146000,0,0,0,0,0,0,193000,30000,3000,27000,166000,0,166000,339000
056911,緯穎元大99購01  ,0,0,0,0,0,0,0,0,0,337000,0,0,0,398000,61000,337000,337000
057199,台達電元富02購01,0,0,0,0,0,0,0,0,0,337000,0,0,0,775000,438000,337000,337000
060312,潤泰全永豐9A購01,0,0,0,0,0,0,0,0,0,334000,0,0,0,354000,20000,334000,334000
059945,嘉澤永豐99購03  ,0,0,0,0,0,0,0,0,0,334000,0,0,0,509000,175000,334000,334000
057742,喬山永豐98購02  ,0,0,0,0,0,0,0,0,0,334000,0,0,0,334000,0,334000,334000
059424,SGBR2X元大9A購01,0,0,0,0,0,0,0,0,0,333000,0,0,0,669000,336000,333000,333000
057088,上銀元富98購01  ,0,0,0,0,0,0,0,0,0,333000,0,0,0,422000,89000,333000,333000
059223,大立光元大99購14,0,0,0,0,0,0,0,0,0,330000,0,0,0,352000,22000,330000,330000
060128,健策永豐99購06  ,0,0,0,0,0,0,0,0,0,329000,0,0,0,349000,20000,329000,329000
06780P,義隆元大98售02  ,0,0,0,0,0,0,0,0,0,329000,0,0,0,385000,56000,329000,329000
058836,FBVIX中信03購05 ,0,0,0,0,0,0,0,0,0,329000,0,0,0,342000,13000,329000,329000
060629,鴻海富邦9B購01  ,0,0,0,0,0,0,0,0,0,328000,0,0,0,371000,43000,328000,328000
060368,緯穎元富9A購03  ,0,0,0,0,0,0,0,0,0,327000,0,0,0,540000,213000,327000,327000
050484,世紀鋼國票95購02,0,0,0,0,0,0,0,0,0,327000,0,0,0,327000,0,327000,327000
055984,大立光元富97購02,0,0,0,0,0,0,0,0,0,327000,0,0,0,464000,137000,327000,327000
054980,國巨元富97購01  ,0,0,0,0,0,0,0,0,0,326000,0,0,0,326000,0,326000,326000
061278,和大統一9A購01  ,0,0,0,0,0,0,0,0,0,324000,0,0,0,550000,226000,324000,324000
1515,力山            ,841000,716000,125000,0,0,0,64000,0,64000,135000,0,10000,-10000,167000,22000,145000,324000
2360,致茂            ,685000,339000,346000,0,0,0,0,0,0,-22000,0,12000,-12000,0,10000,-10000,324000
058273,同欣電永豐99購01,0,0,0,0,0,0,0,0,0,322000,0,0,0,322000,0,322000,322000
055174,精元統一97購01  ,0,0,0,0,0,0,0,0,0,321000,0,0,0,325000,4000,321000,321000
053571,奇鋐統一96購02  ,0,0,0,0,0,0,0,0,0,321000,0,0,0,322000,1000,321000,321000
054807,台化元大9A購02  ,0,0,0,0,0,0,0,0,0,321000,0,0,0,491000,170000,321000,321000
6531,愛普            ,1591000,1269000,322000,0,0,0,0,0,0,-1000,15000,16000,-1000,0,0,0,321000
053638,信邦永豐96購01  ,0,0,0,0,0,0,0,0,0,320000,0,0,0,360000,40000,320000,320000
058936,國喬中信99購01  ,0,0,0,0,0,0,0,0,0,320000,0,0,0,513000,193000,320000,320000
057467,祥碩永豐98購04  ,0,0,0,0,0,0,0,0,0,320000,0,0,0,570000,250000,320000,320000
053485,矽創國票97購04  ,0,0,0,0,0,0,0,0,0,318000,0,0,0,321000,3000,318000,318000
056674,華邦電元富98購01,0,0,0,0,0,0,0,0,0,318000,0,0,0,318000,0,318000,318000
057865,富邦金凱基98購01,0,0,0,0,0,0,0,0,0,317000,0,0,0,323000,6000,317000,317000
058803,世紀鋼元大99購03,0,0,0,0,0,0,0,0,0,315000,0,0,0,404000,89000,315000,315000
057982,帆宣永豐98購01  ,0,0,0,0,0,0,0,0,0,314000,0,0,0,314000,0,314000,314000
057012,康控中信98購01  ,0,0,0,0,0,0,0,0,0,314000,0,0,0,324000,10000,314000,314000
055030,帆宣國泰99購02  ,0,0,0,0,0,0,0,0,0,313000,0,0,0,335000,22000,313000,313000
056057,華邦電元大97購05,0,0,0,0,0,0,0,0,0,313000,0,0,0,343000,30000,313000,313000
059189,國泰金富邦9B購01,0,0,0,0,0,0,0,0,0,313000,0,0,0,363000,50000,313000,313000
058053,上銀統一9B購01  ,0,0,0,0,0,0,0,0,0,311000,0,0,0,445000,134000,311000,311000
060196,泰鼎元富9A購01  ,0,0,0,0,0,0,0,0,0,310000,0,0,0,423000,113000,310000,310000
06614P,祥碩永豐98售03  ,0,0,0,0,0,0,0,0,0,309000,0,0,0,322000,13000,309000,309000
055257,景碩統一97購01  ,0,0,0,0,0,0,0,0,0,309000,0,0,0,310000,1000,309000,309000
060484,聯發科富邦9C購02,0,0,0,0,0,0,0,0,0,308000,0,0,0,369000,61000,308000,308000
055746,同欣電元富97購01,0,0,0,0,0,0,0,0,0,308000,0,0,0,476000,168000,308000,308000
057203,麗豐元富98購02  ,0,0,0,0,0,0,0,0,0,307000,0,0,0,448000,141000,307000,307000
058262,大立光富邦9C購02,0,0,0,0,0,0,0,0,0,306000,0,0,0,306000,0,306000,306000
053376,鴻海元大96購19  ,0,0,0,0,0,0,0,0,0,306000,0,0,0,316000,10000,306000,306000
07355P,臺股指國票99售23,0,0,0,0,0,0,0,0,0,306000,0,0,0,306000,0,306000,306000
061055,康控群益9A購01  ,0,0,0,0,0,0,0,0,0,305000,0,0,0,445000,140000,305000,305000
058346,嘉晶群益99購01  ,0,0,0,0,0,0,0,0,0,305000,0,0,0,365000,60000,305000,305000
057727,華邦電國泰9A購01,0,0,0,0,0,0,0,0,0,305000,0,0,0,626000,321000,305000,305000
058896,中環元大99購03  ,0,0,0,0,0,0,0,0,0,305000,0,0,0,410000,105000,305000,305000
07187P,臺股指台新99售10,0,0,0,0,0,0,0,0,0,305000,0,0,0,305000,0,305000,305000
058428,大立光元富99購02,0,0,0,0,0,0,0,0,0,304000,0,0,0,308000,4000,304000,304000
060083,和大元大99購02  ,0,0,0,0,0,0,0,0,0,303000,0,0,0,335000,32000,303000,303000
060294,嘉澤元大9A購01  ,0,0,0,0,0,0,0,0,0,302000,0,0,0,375000,73000,302000,302000
057969,緯穎國泰99購01  ,0,0,0,0,0,0,0,0,0,302000,0,0,0,562000,260000,302000,302000
060492,元黃金元富9A購01,0,0,0,0,0,0,0,0,0,300000,0,0,0,302000,2000,300000,300000
060784,鴻海富邦9C購01  ,0,0,0,0,0,0,0,0,0,300000,0,0,0,1325000,1025000,300000,300000
06102P,智邦凱基97售03  ,0,0,0,0,0,0,0,0,0,300000,0,0,0,300000,0,300000,300000
061292,玉晶光統一01購06,0,0,0,0,0,0,0,0,0,300000,0,0,0,301000,1000,300000,300000
054089,台積電群益96購11,0,0,0,0,0,0,0,0,0,300000,0,0,0,300000,0,300000,300000
05407P,超眾凱基95售04  ,0,0,0,0,0,0,0,0,0,300000,0,0,0,300000,0,300000,300000
050282,T50反1凱基97購01,0,0,0,0,0,0,0,0,0,300000,0,0,0,300000,0,300000,300000
051346,仁寶元大95購01  ,0,0,0,0,0,0,0,0,0,300000,0,0,0,300000,0,300000,300000
051113,聯電元富95購01  ,0,0,0,0,0,0,0,0,0,300000,0,0,0,300000,0,300000,300000
07164P,臺股指群益99售15,0,0,0,0,0,0,0,0,0,300000,0,0,0,315000,15000,300000,300000
061642,創意元大9A購04  ,0,0,0,0,0,0,0,0,0,296000,0,0,0,464000,168000,296000,296000
048422,瑞昱元富96購02  ,0,0,0,0,0,0,0,0,0,296000,0,0,0,328000,32000,296000,296000
056558,台達電群益98購01,0,0,0,0,0,0,0,0,0,296000,0,0,0,426000,130000,296000,296000
060374,儒鴻元富9A購01  ,0,0,0,0,0,0,0,0,0,295000,0,0,0,322000,27000,295000,295000
057789,上銀統一9A購01  ,0,0,0,0,0,0,0,0,0,295000,0,0,0,295000,0,295000,295000
058660,樺漢中信9A購01  ,0,0,0,0,0,0,0,0,0,295000,0,0,0,448000,153000,295000,295000
060701,玉晶光國泰9C購01,0,0,0,0,0,0,0,0,0,293000,0,0,0,298000,5000,293000,293000
00673R,元大S&P原油反1  ,1000,3000,-2000,0,0,0,0,0,0,295000,0,0,0,732000,437000,295000,293000
057403,亞光群益98購04  ,0,0,0,0,0,0,0,0,0,293000,0,0,0,300000,7000,293000,293000
057857,牧德國票99購01  ,0,0,0,0,0,0,0,0,0,293000,0,0,0,343000,50000,293000,293000
060469,台勝科元大9A購02,0,0,0,0,0,0,0,0,0,292000,0,0,0,343000,51000,292000,292000
061049,奇力新中信9A購02,0,0,0,0,0,0,0,0,0,291000,0,0,0,301000,10000,291000,291000
054349,同欣電國票97購02,0,0,0,0,0,0,0,0,0,291000,0,0,0,366000,75000,291000,291000
056265,國泰金統一97購01,0,0,0,0,0,0,0,0,0,291000,0,0,0,291000,0,291000,291000
061283,智邦統一9A購01  ,0,2000,-2000,0,0,0,0,0,0,292000,0,0,0,372000,80000,292000,290000
057803,上銀元大98購08  ,0,0,0,0,0,0,0,0,0,290000,0,0,0,309000,19000,290000,290000
056657,華邦電元大99購01,0,0,0,0,0,0,0,0,0,290000,0,0,0,290000,0,290000,290000
058819,華通國泰9B購01  ,0,0,0,0,0,0,0,0,0,289000,0,0,0,412000,123000,289000,289000
056616,台光電永豐98購01,0,0,0,0,0,0,0,0,0,286000,0,0,0,532000,246000,286000,286000
061399,喬山兆豐9B購01  ,0,0,0,0,0,0,0,0,0,285000,0,0,0,315000,30000,285000,285000
00674R,元大S&P黃金反1  ,0,50000,-50000,0,0,0,0,0,0,334000,0,0,0,495000,161000,334000,284000
061168,力成兆豐9A購01  ,0,0,0,0,0,0,0,0,0,283000,0,0,0,316000,33000,283000,283000
060867,智伸科永豐9A購01,0,0,0,0,0,0,0,0,0,282000,0,0,0,322000,40000,282000,282000
054052,日月光元大96購06,0,0,0,0,0,0,0,0,0,282000,0,0,0,282000,0,282000,282000
053921,嘉晶國票97購03  ,0,0,0,0,0,0,0,0,0,282000,0,0,0,321000,39000,282000,282000
060573,力成永豐9A購01  ,0,0,0,0,0,0,0,0,0,281000,0,0,0,289000,8000,281000,281000
061231,聚陽元大9A購02  ,10000,0,10000,0,0,0,0,0,0,271000,0,0,0,331000,60000,271000,281000
00654R,富邦印度反1     ,95000,192000,-97000,0,0,0,0,0,0,378000,0,0,0,409000,31000,378000,281000
058479,亞光凱基9A購01  ,0,0,0,0,0,0,0,0,0,280000,0,0,0,280000,0,280000,280000
061581,貿聯元大9A購05  ,0,0,0,0,0,0,0,0,0,279000,0,0,0,318000,39000,279000,279000
060636,大毅永豐9A購02  ,0,0,0,0,0,0,0,0,0,279000,0,0,0,283000,4000,279000,279000
054716,緯穎康和97購01  ,0,0,0,0,0,0,0,0,0,279000,0,0,0,359000,80000,279000,279000
058221,上銀統一99購04  ,0,0,0,0,0,0,0,0,0,279000,0,0,0,279000,0,279000,279000
07361P,聯發科元大99售34,0,0,0,0,0,0,0,0,0,279000,0,0,0,302000,23000,279000,279000
059004,嘉晶元大99購05  ,0,0,0,0,0,0,0,0,0,278000,0,0,0,278000,0,278000,278000
060437,宏全永豐9A購01  ,0,0,0,0,0,0,0,0,0,277000,0,0,0,632000,355000,277000,277000
06662P,玉晶光中信9A售01,0,0,0,0,0,0,0,0,0,277000,0,0,0,367000,90000,277000,277000
056200,大毅永豐98購01  ,0,0,0,0,0,0,0,0,0,277000,0,0,0,281000,4000,277000,277000
061532,和大統一9C購02  ,0,0,0,0,0,0,0,0,0,276000,0,0,0,300000,24000,276000,276000
059926,世紀鋼國泰9B購01,0,0,0,0,0,0,0,0,0,276000,0,0,0,286000,10000,276000,276000
05764P,世紀鋼永豐96售03,0,0,0,0,0,0,0,0,0,276000,0,0,0,326000,50000,276000,276000
057089,奇力新元富98購01,0,0,0,0,0,0,0,0,0,276000,0,0,0,276000,0,276000,276000
3014,聯陽            ,501000,217000,284000,0,0,0,0,0,0,-8000,40000,22000,18000,0,26000,-26000,276000
052560,康舒國票97購01  ,0,0,0,0,0,0,0,0,0,275000,0,0,0,275000,0,275000,275000
061091,奇力新統一9C購02,0,0,0,0,0,0,0,0,0,274000,0,0,0,450000,176000,274000,274000
059264,台光電中信99購02,0,0,0,0,0,0,0,0,0,274000,0,0,0,375000,101000,274000,274000
053405,台達電兆豐96購01,0,0,0,0,0,0,0,0,0,273000,0,0,0,283000,10000,273000,273000
060958,儒鴻凱基9A購02  ,0,0,0,0,0,0,0,0,0,272000,0,0,0,437000,165000,272000,272000
058507,美律元大9A購01  ,0,0,0,0,0,0,0,0,0,272000,0,0,0,320000,48000,272000,272000
061130,牧德永豐9A購04  ,0,0,0,0,0,0,0,0,0,271000,0,0,0,276000,5000,271000,271000
060026,聯發科富邦9B購05,0,0,0,0,0,0,0,0,0,271000,0,0,0,322000,51000,271000,271000
058731,貿聯永豐99購02  ,0,0,0,0,0,0,0,0,0,271000,0,0,0,281000,10000,271000,271000
057420,美食凱基98購01  ,0,0,0,0,0,0,0,0,0,271000,0,0,0,281000,10000,271000,271000
07276P,臺股指群益99售19,0,0,0,0,0,0,0,0,0,271000,0,0,0,442000,171000,271000,271000
060547,瑞昱凱基9A購01  ,0,0,0,0,0,0,0,0,0,270000,0,0,0,355000,85000,270000,270000
04938P,亞德客國票95售01,0,0,0,0,0,0,0,0,0,270000,0,0,0,270000,0,270000,270000
059993,上銀元富99購01  ,0,0,0,0,0,0,0,0,0,269000,0,0,0,277000,8000,269000,269000
059996,美律元富99購01  ,0,0,0,0,0,0,0,0,0,269000,0,0,0,377000,108000,269000,269000
07392P,台積電國泰02售01,0,0,0,0,0,0,0,0,0,269000,0,0,0,455000,186000,269000,269000
060795,世芯永豐9A購02  ,0,0,0,0,0,0,0,0,0,267000,0,0,0,283000,16000,267000,267000
058328,世紀鋼統一9B購01,0,0,0,0,0,0,0,0,0,267000,0,0,0,319000,52000,267000,267000
060404,台勝科國泰9B購01,0,0,0,0,0,0,0,0,0,266000,0,0,0,1019000,753000,266000,266000
060158,廣達永豐9A購01  ,0,0,0,0,0,0,0,0,0,266000,0,0,0,330000,64000,266000,266000
058258,世芯國泰9A購01  ,0,0,0,0,0,0,0,0,0,266000,0,0,0,266000,0,266000,266000
060209,喬山康和9A購01  ,0,0,0,0,0,0,0,0,0,265000,0,0,0,379000,114000,265000,265000
058327,大毅統一9B購01  ,20000,0,20000,0,0,0,0,0,0,245000,0,0,0,806000,561000,245000,265000
060880,中壽中信9C購01  ,0,0,0,0,0,0,0,0,0,264000,0,0,0,389000,125000,264000,264000
058147,鈺齊元大99購01  ,0,0,0,0,0,0,0,0,0,264000,0,0,0,285000,21000,264000,264000
07383P,聯發科群益99售06,0,0,0,0,0,0,0,0,0,263000,0,0,0,298000,35000,263000,263000
060451,中石化元大9C購02,0,0,0,0,0,0,0,0,0,262000,0,0,0,423000,161000,262000,262000
061395,健策統一9C購02  ,0,0,0,0,0,0,0,0,0,262000,0,0,0,556000,294000,262000,262000
055887,上銀統一97購03  ,0,0,0,0,0,0,0,0,0,262000,0,0,0,390000,128000,262000,262000
058222,玉晶光統一9B購01,0,0,0,0,0,0,0,0,0,262000,0,0,0,671000,409000,262000,262000
058182,日電貿國泰9A購01,0,0,0,0,0,0,0,0,0,262000,0,0,0,271000,9000,262000,262000
061184,大立光國泰9C購01,0,0,0,0,0,0,0,0,0,261000,0,0,0,296000,35000,261000,261000
052102,台泥兆豐96購01  ,0,0,0,0,0,0,0,0,0,261000,0,0,0,511000,250000,261000,261000
046628,大立光統一98購01,0,0,0,0,0,0,0,0,0,261000,0,0,0,558000,297000,261000,261000
060233,宏碁元大9A購01  ,0,0,0,0,0,0,0,0,0,260000,0,0,0,280000,20000,260000,260000
059580,大立光元富99購07,0,0,0,0,0,0,0,0,0,260000,0,0,0,291000,31000,260000,260000
05180P,玉晶光凱基95售04,0,0,0,0,0,0,0,0,0,260000,0,0,0,260000,0,260000,260000
057491,美食元大98購03  ,0,0,0,0,0,0,0,0,0,260000,0,0,0,378000,118000,260000,260000
059286,S&P正2元富01購03,0,0,0,0,0,0,0,0,0,260000,0,0,0,400000,140000,260000,260000
059326,康友元大99購01  ,0,0,0,0,0,0,0,0,0,260000,0,0,0,343000,83000,260000,260000
060058,牧德凱基9B購01  ,0,0,0,0,0,0,0,0,0,258000,0,0,0,260000,2000,258000,258000
055136,聯發科富邦99購06,0,0,0,0,0,0,0,0,0,257000,0,0,0,258000,1000,257000,257000
057873,義隆元大98購03  ,0,0,0,0,0,0,0,0,0,256000,0,0,0,439000,183000,256000,256000
057740,茂林富邦9A購01  ,0,0,0,0,0,0,0,0,0,256000,0,0,0,276000,20000,256000,256000
060448,道瓊反元大9A購04,0,0,0,0,0,0,0,0,0,254000,0,0,0,304000,50000,254000,254000
061243,麗豐兆豐9A購01  ,0,0,0,0,0,0,0,0,0,254000,0,0,0,365000,111000,254000,254000
056762,亞德客元大98購01,0,0,0,0,0,0,0,0,0,254000,0,0,0,360000,106000,254000,254000
05096P,台積電日盛95售01,0,0,0,0,0,0,0,0,0,254000,0,0,0,3314000,3060000,254000,254000
060865,創意永豐9A購01  ,0,0,0,0,0,0,0,0,0,253000,0,0,0,253000,0,253000,253000
056121,勤誠群益97購01  ,0,0,0,0,0,0,0,0,0,252000,0,0,0,277000,25000,252000,252000
057904,矽力永豐98購01  ,0,0,0,0,0,0,0,0,0,252000,0,0,0,256000,4000,252000,252000
059932,世紀鋼富邦9A購02,0,0,0,0,0,0,0,0,0,251000,0,0,0,462000,211000,251000,251000
060119,上銀富邦9B購03  ,0,0,0,0,0,0,0,0,0,251000,0,0,0,253000,2000,251000,251000
058605,華邦電元大99購04,0,0,0,0,0,0,0,0,0,251000,0,0,0,251000,0,251000,251000
058873,美律國票9A購02  ,0,0,0,0,0,0,0,0,0,251000,0,0,0,266000,15000,251000,251000
07334P,臺股指國票99售19,0,0,0,0,0,0,0,0,0,251000,0,0,0,590000,339000,251000,251000
07617P,聯發科中信9C售04,0,0,0,0,0,0,0,0,0,251000,0,0,0,351000,100000,251000,251000
058406,聯茂元大99購06  ,0,0,0,0,0,0,0,0,0,250000,0,0,0,250000,0,250000,250000
07605P,台灣50元大9B售10,0,0,0,0,0,0,0,0,0,250000,0,0,0,400000,150000,250000,250000
060643,牧德永豐9A購03  ,0,0,0,0,0,0,0,0,0,249000,0,0,0,255000,6000,249000,249000
060493,美律元富01購01  ,0,0,0,0,0,0,0,0,0,249000,0,0,0,397000,148000,249000,249000
07667P,亞德客元大9A售05,0,0,0,0,0,0,0,0,0,249000,0,0,0,259000,10000,249000,249000
059938,凱美永豐99購01  ,0,0,0,0,0,0,0,0,0,248000,0,0,0,248000,0,248000,248000
061347,創意元大9A購02  ,0,0,0,0,0,0,0,0,0,248000,0,0,0,460000,212000,248000,248000
061138,晶技統一9C購01  ,0,0,0,0,0,0,0,0,0,248000,0,0,0,248000,0,248000,248000
054559,台光電群益99購01,0,0,0,0,0,0,0,0,0,248000,0,0,0,300000,52000,248000,248000
059173,矽力凱基99購01  ,0,0,0,0,0,0,0,0,0,248000,0,0,0,304000,56000,248000,248000
060804,T50反1群益9A購02,0,0,0,0,0,0,0,0,0,247000,0,0,0,338000,91000,247000,247000
060992,健策元大9A購05  ,0,0,0,0,0,0,0,0,0,246000,0,0,0,266000,20000,246000,246000
4746,台耀            ,654000,414000,240000,0,0,0,0,0,0,5000,11000,6000,5000,0,0,0,245000
061584,勤誠元大9A購01  ,0,0,0,0,0,0,0,0,0,244000,0,0,0,346000,102000,244000,244000
06332P,世紀鋼群益98售01,0,0,0,0,0,0,0,0,0,244000,0,0,0,246000,2000,244000,244000
057110,立積群益98購01  ,0,0,0,0,0,0,0,0,0,244000,0,0,0,291000,47000,244000,244000
056683,台積電統一98購05,0,0,0,0,0,0,0,0,0,243000,0,0,0,243000,0,243000,243000
061340,義隆元大9A購01  ,0,0,0,0,0,0,0,0,0,242000,0,0,0,300000,58000,242000,242000
060310,瑞昱永豐9A購01  ,0,0,0,0,0,0,0,0,0,242000,0,0,0,362000,120000,242000,242000
055847,大立光元大97購10,0,0,0,0,0,0,0,0,0,242000,0,0,0,242000,0,242000,242000
07416P,台積電元大99售53,0,0,0,0,0,0,0,0,0,242000,0,0,0,392000,150000,242000,242000
054947,興勤元大97購01  ,0,0,0,0,0,0,0,0,0,241000,0,0,0,241000,0,241000,241000
048576,義隆國泰95購01  ,0,0,0,0,0,0,0,0,0,241000,0,0,0,256000,15000,241000,241000
060034,立積永豐99購04  ,0,0,0,0,0,0,0,0,0,240000,0,0,0,264000,24000,240000,240000
060253,昇陽半元大9C購01,0,0,0,0,0,0,0,0,0,240000,0,0,0,260000,20000,240000,240000
05485P,旺宏凱基95售08  ,0,0,0,0,0,0,0,0,0,240000,0,0,0,340000,100000,240000,240000
054088,華新群益98購02  ,0,0,0,0,0,0,0,0,0,240000,0,0,0,240000,0,240000,240000
058234,華新科元大99購12,0,0,0,0,0,0,0,0,0,240000,0,0,0,240000,0,240000,240000
056677,智伸科元富98購01,0,0,0,0,0,0,0,0,0,240000,0,0,0,240000,0,240000,240000
060877,華邦電中信02購01,0,0,0,0,0,0,0,0,0,239000,0,0,0,289000,50000,239000,239000
057483,微星元大98購04  ,0,0,0,0,0,0,0,0,0,239000,0,0,0,326000,87000,239000,239000
059259,FBVIX中信03購06 ,0,0,0,0,0,0,0,0,0,239000,0,0,0,247000,8000,239000,239000
060752,上銀元大9A購04  ,0,0,0,0,0,0,0,0,0,238000,0,0,0,288000,50000,238000,238000
060682,牧德元大9A購03  ,0,0,0,0,0,0,0,0,0,237000,0,0,0,268000,31000,237000,237000
060650,奇力新中信9A購01,0,0,0,0,0,0,0,0,0,237000,0,0,0,344000,107000,237000,237000
054805,台苯元大9A購01  ,0,0,0,0,0,0,0,0,0,237000,0,0,0,322000,85000,237000,237000
057817,景碩元大98購01  ,0,0,0,0,0,0,0,0,0,237000,0,0,0,256000,19000,237000,237000
058145,聯茂元大99購03  ,0,0,0,0,0,0,0,0,0,237000,0,0,0,277000,40000,237000,237000
07257P,臺股指凱基99售37,0,0,0,0,0,0,0,0,0,237000,0,0,0,242000,5000,237000,237000
060079,台郡台新99購03  ,0,0,0,0,0,0,0,0,0,236000,0,0,0,257000,21000,236000,236000
061527,牧德凱基9A購02  ,0,0,0,0,0,0,0,0,0,236000,0,0,0,248000,12000,236000,236000
060710,上銀永豐9A購01  ,0,0,0,0,0,0,0,0,0,234000,0,0,0,234000,0,234000,234000
059257,臺股指凱基99購35,0,0,0,0,0,0,0,0,0,234000,0,0,0,244000,10000,234000,234000
058764,康友群益99購01  ,0,0,0,0,0,0,0,0,0,233000,0,0,0,241000,8000,233000,233000
060959,金像電凱基9A購01,20000,0,20000,0,0,0,0,0,0,212000,0,0,0,307000,95000,212000,232000
061022,健策國泰9B購03  ,0,0,0,0,0,0,0,0,0,232000,0,0,0,327000,95000,232000,232000
053398,和鑫中信99購01  ,0,0,0,0,0,0,0,0,0,232000,0,0,0,335000,103000,232000,232000
058752,鈺齊凱基9A購01  ,0,0,0,0,0,0,0,0,0,232000,0,0,0,237000,5000,232000,232000
05724P,致茂永豐96售01  ,0,0,0,0,0,0,0,0,0,232000,0,0,0,232000,0,232000,232000
056397,彩晶永豐99購01  ,0,0,0,0,0,0,0,0,0,232000,0,0,0,232000,0,232000,232000
07162P,臺股指群益99售13,0,0,0,0,0,0,0,0,0,232000,0,0,0,908000,676000,232000,232000
060186,義隆元富9A購01  ,0,0,0,0,0,0,0,0,0,231000,0,0,0,240000,9000,231000,231000
058748,景碩凱基9A購01  ,0,0,0,0,0,0,0,0,0,231000,0,0,0,254000,23000,231000,231000
058326,祥碩台新99購01  ,0,0,0,0,0,0,0,0,0,230000,0,0,0,259000,29000,230000,230000
059683,康控富邦9C購01  ,0,0,0,0,0,0,0,0,0,229000,0,0,0,249000,20000,229000,229000
061302,晶技永豐9A購04  ,0,0,0,0,0,0,0,0,0,229000,0,0,0,229000,0,229000,229000
055458,燿華永豐98購01  ,0,0,0,0,0,0,0,0,0,228000,0,0,0,228000,0,228000,228000
056136,京鼎元大98購01  ,0,0,0,0,0,0,0,0,0,228000,0,0,0,228000,0,228000,228000
056549,嘉聯益凱基98購04,0,0,0,0,0,0,0,0,0,227000,0,0,0,227000,0,227000,227000
061100,SP黃豆元大9A購04,0,0,0,0,0,0,0,0,0,225000,0,0,0,240000,15000,225000,225000
057507,貿聯國票98購02  ,0,0,0,0,0,0,0,0,0,225000,0,0,0,322000,97000,225000,225000
058399,美律元大99購05  ,0,0,0,0,0,0,0,0,0,225000,0,0,0,295000,70000,225000,225000
060850,康友國票9A購03  ,0,0,0,0,0,0,0,0,0,224000,0,0,0,241000,17000,224000,224000
053142,緯穎永豐96購01  ,0,0,0,0,0,0,0,0,0,223000,0,0,0,223000,0,223000,223000
061567,華通元大9A購11  ,0,0,0,0,0,0,0,0,0,222000,0,0,0,339000,117000,222000,222000
060108,泰鼎元大99購04  ,0,0,0,0,0,0,0,0,0,220000,0,0,0,273000,53000,220000,220000
059047,元油2X凱基9A購10,0,0,0,0,0,0,0,0,0,220000,0,0,0,479000,259000,220000,220000
059289,瑞昱元富99購01  ,0,0,0,0,0,0,0,0,0,220000,0,0,0,243000,23000,220000,220000
061244,和碩兆豐9A購01  ,0,0,0,0,0,0,0,0,0,219000,0,0,0,334000,115000,219000,219000
058241,景碩元大99購05  ,0,0,0,0,0,0,0,0,0,219000,0,0,0,269000,50000,219000,219000
056582,易華電元大98購01,0,0,0,0,0,0,0,0,0,219000,0,0,0,225000,6000,219000,219000
055936,彩晶群益98購02  ,0,0,0,0,0,0,0,0,0,219000,0,0,0,219000,0,219000,219000
057770,亞德客群益98購01,0,0,0,0,0,0,0,0,0,219000,0,0,0,372000,153000,219000,219000
08653P,台灣50凱基96售07,0,0,0,0,0,0,0,0,0,219000,0,0,0,219000,0,219000,219000
061379,鈺齊永豐9A購02  ,0,0,0,0,0,0,0,0,0,218000,0,0,0,426000,208000,218000,218000
056803,群創台新99購02  ,0,0,0,0,0,0,0,0,0,218000,0,0,0,218000,0,218000,218000
052819,義隆永豐96購01  ,0,0,0,0,0,0,0,0,0,217000,0,0,0,237000,20000,217000,217000
058110,光寶科元富98購01,0,0,0,0,0,0,0,0,0,217000,0,0,0,282000,65000,217000,217000
059050,元油2X凱基9B購08,0,0,0,0,0,0,0,0,0,217000,0,0,0,922000,705000,217000,217000
07311P,台灣50元大99售09,0,0,0,0,0,0,0,0,0,216000,0,0,0,216000,0,216000,216000
060736,旺宏統一01購01  ,0,0,0,0,0,0,0,0,0,215000,0,0,0,381000,166000,215000,215000
055731,美律元富97購01  ,0,0,0,0,0,0,0,0,0,215000,0,0,0,323000,108000,215000,215000
060807,新光金群益9A購01,0,0,0,0,0,0,0,0,0,214000,0,0,0,312000,98000,214000,214000
060435,鈺齊永豐9A購01  ,0,0,0,0,0,0,0,0,0,214000,0,0,0,260000,46000,214000,214000
060234,凱美元大9C購01  ,0,0,0,0,0,0,0,0,0,214000,0,0,0,244000,30000,214000,214000
061027,儒鴻永豐9A購02  ,0,0,0,0,0,0,0,0,0,213000,0,0,0,249000,36000,213000,213000
054038,T50反1元大98購04,0,0,0,0,0,0,0,0,0,213000,0,0,0,398000,185000,213000,213000
058152,聯發科統一9B購02,0,0,0,0,0,0,0,0,0,213000,0,0,0,213000,0,213000,213000
061108,臻鼎元大9A購02  ,0,0,0,0,0,0,0,0,0,212000,0,0,0,259000,47000,212000,212000
058916,SGBR2X元富99購02,0,0,0,0,0,0,0,0,0,211000,0,0,0,211000,0,211000,211000
058604,華邦電元大99購03,0,0,0,0,0,0,0,0,0,211000,0,0,0,211000,0,211000,211000
059350,樺漢凱基9A購01  ,0,0,0,0,0,0,0,0,0,211000,0,0,0,253000,42000,211000,211000
06896P,信邦中信98售01  ,0,0,0,0,0,0,0,0,0,210000,0,0,0,210000,0,210000,210000
053871,臻鼎元大96購03  ,0,0,0,0,0,0,0,0,0,209000,0,0,0,238000,29000,209000,209000
056189,樺漢統一97購02  ,0,0,0,0,0,0,0,0,0,209000,0,0,0,219000,10000,209000,209000
058568,宏達電凱基9A購02,0,0,0,0,0,0,0,0,0,209000,0,0,0,254000,45000,209000,209000
2455,全新            ,1008000,591000,417000,0,0,0,100000,413000,-313000,105000,144000,84000,60000,68000,23000,45000,209000
061202,和大元大9A購02  ,0,0,0,0,0,0,0,0,0,208000,0,0,0,233000,25000,208000,208000
053189,聯發科統一96購05,0,0,0,0,0,0,0,0,0,208000,0,0,0,208000,0,208000,208000
054425,聯發科富邦99購03,0,0,0,0,0,0,0,0,0,208000,0,0,0,218000,10000,208000,208000
054758,南亞國票9A購01  ,0,0,0,0,0,0,0,0,0,208000,0,0,0,212000,4000,208000,208000
049700,瀚宇博元大97購01,0,0,0,0,0,0,0,0,0,207000,0,0,0,237000,30000,207000,207000
058144,聯茂元大99購02  ,0,0,0,0,0,0,0,0,0,207000,0,0,0,230000,23000,207000,207000
060329,鎧勝群益9B購01  ,0,0,0,0,0,0,0,0,0,206000,0,0,0,211000,5000,206000,206000
03678C,臺股指凱基01牛02,0,0,0,0,0,0,0,0,0,206000,0,0,0,458000,252000,206000,206000
05160P,國巨國票96售03  ,0,0,0,0,0,0,0,0,0,206000,0,0,0,206000,0,206000,206000
058337,日月光元富99購01,0,0,0,0,0,0,0,0,0,206000,0,0,0,485000,279000,206000,206000
058051,同欣電元大98購03,0,0,0,0,0,0,0,0,0,206000,0,0,0,232000,26000,206000,206000
056075,瀚宇博元大97購03,0,0,0,0,0,0,0,0,0,206000,0,0,0,224000,18000,206000,206000
057181,亞光元大98購02  ,0,0,0,0,0,0,0,0,0,206000,0,0,0,227000,21000,206000,206000
059836,大立光國泰9B購02,0,0,0,0,0,0,0,0,0,205000,0,0,0,329000,124000,205000,205000
056266,開發金統一9A購01,0,0,0,0,0,0,0,0,0,205000,0,0,0,556000,351000,205000,205000
059742,富邦金元富99購01,0,0,0,0,0,0,0,0,0,204000,0,0,0,204000,0,204000,204000
060737,瑞儀統一9C購01  ,0,0,0,0,0,0,0,0,0,202000,0,0,0,216000,14000,202000,202000
061200,道瓊反元大9A購06,0,0,0,0,0,0,0,0,0,202000,0,0,0,202000,0,202000,202000
056562,奇力新群益98購01,0,0,0,0,0,0,0,0,0,202000,0,0,0,227000,25000,202000,202000
060989,國泰金元大9A購02,0,0,0,0,0,0,0,0,0,201000,0,0,0,201000,0,201000,201000
055142,健策永豐98購01  ,0,0,0,0,0,0,0,0,0,201000,0,0,0,208000,7000,201000,201000
057059,易華電元大99購01,0,0,0,0,0,0,0,0,0,201000,0,0,0,201000,0,201000,201000
055576,嘉晶統一98購01  ,0,0,0,0,0,0,0,0,0,201000,0,0,0,201000,0,201000,201000
059650,緯穎凱基99購04  ,0,0,0,0,0,0,0,0,0,200000,0,0,0,212000,12000,200000,200000
053960,晶技永豐96購02  ,0,0,0,0,0,0,0,0,0,200000,0,0,0,200000,0,200000,200000
053381,友達元大9A購02  ,0,0,0,0,0,0,0,0,0,200000,0,0,0,200000,0,200000,200000
051405,世芯永豐95購01  ,0,0,0,0,0,0,0,0,0,200000,0,0,0,200000,0,200000,200000
052041,鴻海日盛95購02  ,0,0,0,0,0,0,0,0,0,200000,0,0,0,200000,0,200000,200000
052685,技嘉元大96購01  ,0,0,0,0,0,0,0,0,0,200000,0,0,0,200000,0,200000,200000
048059,欣興國泰95購01  ,0,0,0,0,0,0,0,0,0,200000,0,0,0,200000,0,200000,200000
049972,南電國票95購02  ,0,0,0,0,0,0,0,0,0,200000,0,0,0,200000,0,200000,200000
056196,聯茂富邦98購02  ,0,0,0,0,0,0,0,0,0,200000,0,0,0,200000,0,200000,200000
058156,超眾統一9A購02  ,0,0,0,0,0,0,0,0,0,200000,0,0,0,223000,23000,200000,200000
056748,T50反1兆豐99購01,0,0,0,0,0,0,0,0,0,200000,0,0,0,200000,0,200000,200000
060241,國泰金元大9A購01,0,0,0,0,0,0,0,0,0,199000,0,0,0,199000,0,199000,199000
060753,上銀元大9A購05  ,0,0,0,0,0,0,0,0,0,199000,0,0,0,214000,15000,199000,199000
052739,國巨元大96購04  ,0,0,0,0,0,0,0,0,0,199000,0,0,0,199000,0,199000,199000
055291,京鼎元大97購02  ,0,0,0,0,0,0,0,0,0,199000,0,0,0,441000,242000,199000,199000
059194,元金2X永豐99購01,0,0,0,0,0,0,0,0,0,199000,0,0,0,213000,14000,199000,199000
061152,微星群益9A購01  ,0,0,0,0,0,0,0,0,0,198000,0,0,0,199000,1000,198000,198000
06578P,華新科國票98售02,0,0,0,0,0,0,0,0,0,198000,0,0,0,208000,10000,198000,198000
052084,台泥元大95購01  ,0,0,0,0,0,0,0,0,0,198000,0,0,0,200000,2000,198000,198000
059008,鈺齊元大99購03  ,0,0,0,0,0,0,0,0,0,198000,0,0,0,210000,12000,198000,198000
061510,嘉澤富邦9C購01  ,0,0,0,0,0,0,0,0,0,196000,0,0,0,196000,0,196000,196000
055252,新光金統一98購02,0,0,0,0,0,0,0,0,0,196000,0,0,0,196000,0,196000,196000
060796,世芯永豐9A購03  ,0,0,0,0,0,0,0,0,0,195000,0,0,0,221000,26000,195000,195000
054459,鈺齊群益96購01  ,0,0,0,0,0,0,0,0,0,195000,0,0,0,195000,0,195000,195000
057495,牧德元大99購04  ,0,0,0,0,0,0,0,0,0,195000,0,0,0,214000,19000,195000,195000
058822,樺漢國泰9B購01  ,0,0,0,0,0,0,0,0,0,195000,0,0,0,220000,25000,195000,195000
055653,聯詠元富01購02  ,0,0,0,0,0,0,0,0,0,195000,0,0,0,229000,34000,195000,195000
07444P,聯發科凱基9A售10,0,0,0,0,0,0,0,0,0,195000,0,0,0,195000,0,195000,195000
06995P,臺股指凱基99售16,0,0,0,0,0,0,0,0,0,195000,0,0,0,205000,10000,195000,195000
060386,台勝科凱基9B購01,0,0,0,0,0,0,0,0,0,194000,0,0,0,240000,46000,194000,194000
061566,華通元大9A購10  ,0,0,0,0,0,0,0,0,0,194000,0,0,0,234000,40000,194000,194000
056839,台光電元富98購02,0,0,0,0,0,0,0,0,0,194000,0,0,0,325000,131000,194000,194000
058398,中環元大99購02  ,0,0,0,0,0,0,0,0,0,194000,0,0,0,241000,47000,194000,194000
061117,美律國泰9C購01  ,0,0,0,0,0,0,0,0,0,193000,0,0,0,193000,0,193000,193000
061227,日月光中信9B購01,0,0,0,0,0,0,0,0,0,193000,0,0,0,539000,346000,193000,193000
052945,嘉晶國票97購01  ,0,0,0,0,0,0,0,0,0,193000,0,0,0,241000,48000,193000,193000
053403,彩晶群益98購01  ,0,0,0,0,0,0,0,0,0,193000,0,0,0,290000,97000,193000,193000
051607,緯創群益96購02  ,0,0,0,0,0,0,0,0,0,193000,0,0,0,283000,90000,193000,193000
07583P,台積電富邦9B售05,0,0,0,0,0,0,0,0,0,193000,0,0,0,231000,38000,193000,193000
061185,嘉晶國泰9B購01  ,0,0,0,0,0,0,0,0,0,192000,0,0,0,207000,15000,192000,192000
048350,世紀鋼元大95購01,0,0,0,0,0,0,0,0,0,192000,0,0,0,192000,0,192000,192000
060204,矽創元富9A購01  ,0,0,0,0,0,0,0,0,0,191000,0,0,0,351000,160000,191000,191000
059368,T50正2元富99購02,0,0,0,0,0,0,0,0,0,191000,0,0,0,205000,14000,191000,191000
059450,和大永豐99購01  ,0,0,0,0,0,0,0,0,0,191000,0,0,0,191000,0,191000,191000
060366,健策元富9A購01  ,0,0,0,0,0,0,0,0,0,190000,0,0,0,190000,0,190000,190000
061361,世紀鋼兆豐9A購01,0,0,0,0,0,0,0,0,0,190000,0,0,0,317000,127000,190000,190000
061286,大立光統一9A購05,0,0,0,0,0,0,0,0,0,190000,0,0,0,194000,4000,190000,190000
056572,義隆元大99購01  ,0,0,0,0,0,0,0,0,0,190000,0,0,0,252000,62000,190000,190000
056098,矽創元富97購02  ,0,0,0,0,0,0,0,0,0,190000,0,0,0,298000,108000,190000,190000
07754P,日月光元大9A售02,0,0,0,0,0,0,0,0,0,190000,0,0,0,210000,20000,190000,190000
6142,友勁            ,29000,114000,-85000,0,0,0,0,0,0,275000,275000,0,275000,0,0,0,190000
060191,亞光元富9A購02  ,0,0,0,0,0,0,0,0,0,189000,0,0,0,281000,92000,189000,189000
059747,台達電台新99購01,0,0,0,0,0,0,0,0,0,189000,0,0,0,216000,27000,189000,189000
056398,南茂永豐98購01  ,0,0,0,0,0,0,0,0,0,189000,0,0,0,317000,128000,189000,189000
07575P,瑞昱元大9A售02  ,0,0,0,0,0,0,0,0,0,189000,0,0,0,209000,20000,189000,189000
060706,群創富邦9A購01  ,0,0,0,0,0,0,0,0,0,188000,0,0,0,188000,0,188000,188000
061114,南電元大9A購04  ,0,0,0,0,0,0,0,0,0,188000,0,0,0,210000,22000,188000,188000
051888,國巨元富95購05  ,0,0,0,0,0,0,0,0,0,188000,0,0,0,188000,0,188000,188000
054890,聯鈞統一99購01  ,0,0,0,0,0,0,0,0,0,188000,0,0,0,200000,12000,188000,188000
060252,緯穎元大9A購02  ,0,0,0,0,0,0,0,0,0,187000,0,0,0,211000,24000,187000,187000
056583,昇陽半元大98購02,0,0,0,0,0,0,0,0,0,187000,0,0,0,187000,0,187000,187000
058797,大毅元大99購03  ,0,0,0,0,0,0,0,0,0,186000,0,0,0,209000,23000,186000,186000
056143,訊芯元大97購04  ,0,0,0,0,0,0,0,0,0,186000,0,0,0,186000,0,186000,186000
055733,奇力新元富97購01,0,0,0,0,0,0,0,0,0,186000,0,0,0,286000,100000,186000,186000
060742,臺指反國票9B購02,0,0,0,0,0,0,0,0,0,185000,0,0,0,205000,20000,185000,185000
060624,玉晶光元大9C購02,0,0,0,0,0,0,0,0,0,185000,0,0,0,188000,3000,185000,185000
058770,貿聯兆豐9A購01  ,0,0,0,0,0,0,0,0,0,185000,0,0,0,195000,10000,185000,185000
060045,嘉晶群益99購02  ,0,0,0,0,0,0,0,0,0,184000,0,0,0,208000,24000,184000,184000
060954,國泰金群益9A購02,0,0,0,0,0,0,0,0,0,184000,0,0,0,184000,0,184000,184000
05213P,台積電國票96售05,0,0,0,0,0,0,0,0,0,184000,0,0,0,236000,52000,184000,184000
055183,聯鈞統一97購01  ,0,0,0,0,0,0,0,0,0,184000,0,0,0,212000,28000,184000,184000
056611,國巨永豐98購03  ,0,0,0,0,0,0,0,0,0,184000,0,0,0,568000,384000,184000,184000
055818,晶相光國票97購02,0,0,0,0,0,0,0,0,0,182000,0,0,0,182000,0,182000,182000
07210P,智邦凱基99售03  ,0,0,0,0,0,0,0,0,0,182000,0,0,0,236000,54000,182000,182000
061062,和大凱基9A購02  ,0,0,0,0,0,0,0,0,0,181000,0,0,0,181000,0,181000,181000
06447P,上銀元大98售01  ,0,0,0,0,0,0,0,0,0,181000,0,0,0,198000,17000,181000,181000
052781,瀚宇博國票97購03,0,0,0,0,0,0,0,0,0,181000,0,0,0,181000,0,181000,181000
053599,崇越元大96購01  ,0,0,0,0,0,0,0,0,0,181000,0,0,0,181000,0,181000,181000
057842,緯穎富邦99購02  ,0,0,0,0,0,0,0,0,0,181000,0,0,0,182000,1000,181000,181000
056212,台光電國票98購03,0,0,0,0,0,0,0,0,0,181000,0,0,0,181000,0,181000,181000
057928,鈺齊凱基98購02  ,0,0,0,0,0,0,0,0,0,181000,0,0,0,184000,3000,181000,181000
07560P,台積電國泰9B售01,0,0,0,0,0,0,0,0,0,181000,0,0,0,201000,20000,181000,181000
5203,訊連            ,181000,41000,140000,0,0,0,0,0,0,41000,38000,0,38000,3000,0,3000,181000
4106,雃博            ,315000,134000,181000,0,0,0,0,0,0,0,0,0,0,0,0,0,181000
059999,緯穎元富99購01  ,0,0,0,0,0,0,0,0,0,180000,0,0,0,240000,60000,180000,180000
051329,智邦永豐95購01  ,0,0,0,0,0,0,0,0,0,180000,0,0,0,180000,0,180000,180000
053115,滬深2X中信97購01,0,0,0,0,0,0,0,0,0,180000,0,0,0,200000,20000,180000,180000
053292,美律中信98購01  ,0,0,0,0,0,0,0,0,0,179000,0,0,0,189000,10000,179000,179000
055041,致新富邦97購01  ,0,0,0,0,0,0,0,0,0,179000,0,0,0,425000,246000,179000,179000
055432,臻鼎群益97購02  ,0,0,0,0,0,0,0,0,0,179000,0,0,0,410000,231000,179000,179000
054842,台達電兆豐98購01,0,0,0,0,0,0,0,0,0,179000,0,0,0,217000,38000,179000,179000
055955,微星元大97購01  ,0,0,0,0,0,0,0,0,0,179000,0,0,0,236000,57000,179000,179000
059160,華通凱基99購03  ,0,0,0,0,0,0,0,0,0,179000,0,0,0,194000,15000,179000,179000
07263P,台積電元大99售37,0,0,0,0,0,0,0,0,0,179000,0,0,0,291000,112000,179000,179000
059685,T50正2永豐99購02,0,0,0,0,0,0,0,0,0,178000,0,0,0,259000,81000,178000,178000
07258P,台灣50台新9A售01,0,0,0,0,0,0,0,0,0,178000,0,0,0,283000,105000,178000,178000
060240,富邦金元大9A購01,0,0,0,0,0,0,0,0,0,177000,0,0,0,221000,44000,177000,177000
059005,嘉晶元大99購06  ,0,0,0,0,0,0,0,0,0,177000,0,0,0,357000,180000,177000,177000
060683,泰鼎元大9A購02  ,0,0,0,0,0,0,0,0,0,176000,0,0,0,213000,37000,176000,176000
054932,台肥元大97購01  ,0,0,0,0,0,0,0,0,0,176000,0,0,0,178000,2000,176000,176000
053950,緯穎富邦97購02  ,0,0,0,0,0,0,0,0,0,176000,0,0,0,177000,1000,176000,176000
2642,宅配通          ,166000,25000,141000,0,0,0,0,0,0,35000,35000,0,35000,0,0,0,176000
060889,國泰金統一9C購01,0,0,0,0,0,0,0,0,0,174000,0,0,0,174000,0,174000,174000
059957,中信金康和99購01,0,0,0,0,0,0,0,0,0,174000,0,0,0,174000,0,174000,174000
061197,矽創永豐9A購02  ,0,0,0,0,0,0,0,0,0,174000,0,0,0,292000,118000,174000,174000
050854,世紀鋼國票97購01,0,0,0,0,0,0,0,0,0,174000,0,0,0,174000,0,174000,174000
059297,大立光元富9C購01,0,0,0,0,0,0,0,0,0,174000,0,0,0,247000,73000,174000,174000
056970,TPK永豐98購01   ,0,0,0,0,0,0,0,0,0,174000,0,0,0,199000,25000,174000,174000
061257,上銀凱基9A購06  ,0,0,0,0,0,0,0,0,0,173000,0,0,0,173000,0,173000,173000
058204,世芯凱基9A購01  ,0,0,0,0,0,0,0,0,0,173000,0,0,0,230000,57000,173000,173000
057875,京鼎元大98購03  ,0,0,0,0,0,0,0,0,0,173000,0,0,0,214000,41000,173000,173000
1902,台紙            ,335000,162000,173000,0,0,0,0,0,0,0,0,0,0,0,0,0,173000
8996,高力            ,322000,149000,173000,0,0,0,0,0,0,0,0,0,0,0,0,0,173000
061109,臻鼎元大9A購03  ,0,0,0,0,0,0,0,0,0,172000,0,0,0,177000,5000,172000,172000
06836P,玉晶光國票99售06,0,0,0,0,0,0,0,0,0,172000,0,0,0,282000,110000,172000,172000
060702,玉晶光國泰9C購02,0,0,0,0,0,0,0,0,0,172000,0,0,0,183000,11000,172000,172000
056909,嘉聯益元大99購03,0,0,0,0,0,0,0,0,0,172000,0,0,0,186000,14000,172000,172000
057502,訊芯群益98購02  ,0,0,0,0,0,0,0,0,0,172000,0,0,0,270000,98000,172000,172000
060577,玉晶光中信9A購02,0,0,0,0,0,0,0,0,0,171000,0,0,0,171000,0,171000,171000
047680,上証反中信96購01,0,0,0,0,0,0,0,0,0,171000,0,0,0,211000,40000,171000,171000
054311,世芯凱基96購02  ,0,0,0,0,0,0,0,0,0,171000,0,0,0,216000,45000,171000,171000
056383,上銀國泰99購01  ,0,0,0,0,0,0,0,0,0,171000,0,0,0,176000,5000,171000,171000
058653,光寶科中信9A購01,0,0,0,0,0,0,0,0,0,171000,0,0,0,261000,90000,171000,171000
060674,瑞昱元大9A購03  ,0,0,0,0,0,0,0,0,0,170000,0,0,0,308000,138000,170000,170000
060126,創意永豐99購04  ,0,0,0,0,0,0,0,0,0,170000,0,0,0,175000,5000,170000,170000
060924,大毅永豐9A購03  ,0,0,0,0,0,0,0,0,0,170000,0,0,0,210000,40000,170000,170000
050792,可成富邦96購01  ,0,0,0,0,0,0,0,0,0,170000,0,0,0,170000,0,170000,170000
05699P,茂林凱基96售05  ,0,0,0,0,0,0,0,0,0,170000,0,0,0,170000,0,170000,170000
061210,玉山金元大9A購02,0,0,0,0,0,0,0,0,0,169000,0,0,0,258000,89000,169000,169000
06550P,健策元大99售01  ,0,0,0,0,0,0,0,0,0,169000,0,0,0,169000,0,169000,169000
061661,京鼎永豐9A購02  ,0,0,0,0,0,0,0,0,0,169000,0,0,0,171000,2000,169000,169000
059924,世紀鋼元大99購06,0,0,0,0,0,0,0,0,0,169000,0,0,0,212000,43000,169000,169000
056849,瀚宇博元富98購01,0,0,0,0,0,0,0,0,0,169000,0,0,0,219000,50000,169000,169000
055949,亞德客元大97購04,0,0,0,0,0,0,0,0,0,169000,0,0,0,213000,44000,169000,169000
058136,景碩元大99購02  ,0,0,0,0,0,0,0,0,0,169000,0,0,0,207000,38000,169000,169000
056641,華通凱基98購03  ,0,0,0,0,0,0,0,0,0,169000,0,0,0,175000,6000,169000,169000
060162,碩天永豐9A購01  ,0,0,0,0,0,0,0,0,0,168000,0,0,0,168000,0,168000,168000
060450,南亞元大9A購02  ,0,0,0,0,0,0,0,0,0,168000,0,0,0,173000,5000,168000,168000
054531,聯發科國泰97購02,0,0,0,0,0,0,0,0,0,168000,0,0,0,198000,30000,168000,168000
056629,昇陽半永豐98購01,0,0,0,0,0,0,0,0,0,168000,0,0,0,198000,30000,168000,168000
059133,臺股指群益99購08,0,0,0,0,0,0,0,0,0,167000,0,0,0,191000,24000,167000,167000
058852,貿聯群益99購04  ,0,0,0,0,0,0,0,0,0,167000,0,0,0,263000,96000,167000,167000
060511,群創元大9B購08  ,0,0,0,0,0,0,0,0,0,166000,0,0,0,166000,0,166000,166000
061412,儒鴻群益9A購01  ,0,0,0,0,0,0,0,0,0,166000,0,0,0,176000,10000,166000,166000
055403,泰鼎元富97購01  ,0,0,0,0,0,0,0,0,0,166000,0,0,0,176000,10000,166000,166000
060790,日月光富邦9A購01,0,0,0,0,0,0,0,0,0,165000,0,0,0,306000,141000,165000,165000
055153,台光電元大98購02,0,0,0,0,0,0,0,0,0,165000,0,0,0,241000,76000,165000,165000
051891,智邦元富95購04  ,0,0,0,0,0,0,0,0,0,165000,0,0,0,165000,0,165000,165000
051292,牧德統一97購01  ,0,0,0,0,0,0,0,0,0,165000,0,0,0,175000,10000,165000,165000
061450,嘉晶中信9A購01  ,0,0,0,0,0,0,0,0,0,164000,0,0,0,174000,10000,164000,164000
053095,台光電統一98購01,0,0,0,0,0,0,0,0,0,164000,0,0,0,202000,38000,164000,164000
07070P,晶相光元富99售01,0,0,0,0,0,0,0,0,0,164000,0,0,0,182000,18000,164000,164000
052908,大成鋼統一96購01,0,0,0,0,0,0,0,0,0,163000,0,0,0,267000,104000,163000,163000
058265,奇力新永豐9A購01,0,0,0,0,0,0,0,0,0,163000,0,0,0,183000,20000,163000,163000
058531,華通元富99購01  ,0,0,0,0,0,0,0,0,0,163000,0,0,0,165000,2000,163000,163000
057329,緯穎群益98購02  ,0,0,0,0,0,0,0,0,0,163000,0,0,0,163000,0,163000,163000
053112,中磊兆豐97購01  ,0,0,0,0,0,0,0,0,0,162000,0,0,0,200000,38000,162000,162000
056396,祥碩永豐98購01  ,0,0,0,0,0,0,0,0,0,162000,0,0,0,162000,0,162000,162000
061106,群創元大9B購09  ,0,0,0,0,0,0,0,0,0,161000,0,0,0,171000,10000,161000,161000
061037,嘉澤永豐9A購01  ,0,0,0,0,0,0,0,0,0,161000,0,0,0,324000,163000,161000,161000
06493P,聯發科永豐98售02,0,0,0,0,0,0,0,0,0,161000,0,0,0,171000,10000,161000,161000
06750P,聯發科元富02售03,0,0,0,0,0,0,0,0,0,161000,0,0,0,219000,58000,161000,161000
060367,緯穎元富9A購02  ,0,0,0,0,0,0,0,0,0,161000,0,0,0,427000,266000,161000,161000
057824,日月光元大98購01,0,0,0,0,0,0,0,0,0,161000,0,0,0,171000,10000,161000,161000
061592,義隆永豐9A購03  ,0,0,0,0,0,0,0,0,0,160000,0,0,0,168000,8000,160000,160000
055353,華新科凱基98購03,0,0,0,0,0,0,0,0,0,160000,0,0,0,160000,0,160000,160000
052544,牧德元富95購01  ,0,0,0,0,0,0,0,0,0,160000,0,0,0,160000,0,160000,160000
059284,緯穎永豐99購03  ,0,0,0,0,0,0,0,0,0,160000,0,0,0,176000,16000,160000,160000
07281P,鴻海凱基99售13  ,0,0,0,0,0,0,0,0,0,160000,0,0,0,160000,0,160000,160000
6592,和潤企業        ,413000,338000,75000,0,0,0,65000,0,65000,20000,2000,7000,-5000,25000,0,25000,160000
056410,康控國票99購01  ,0,0,0,0,0,0,0,0,0,159000,0,0,0,183000,24000,159000,159000
055953,上銀元大97購09  ,0,0,0,0,0,0,0,0,0,159000,0,0,0,159000,0,159000,159000
05609P,國泰金凱基96售01,0,0,0,0,0,0,0,0,0,159000,0,0,0,346000,187000,159000,159000
056067,智原元大97購01  ,0,0,0,0,0,0,0,0,0,159000,0,0,0,179000,20000,159000,159000
061438,牧德凱基9B購02  ,0,0,0,0,0,0,0,0,0,158000,0,0,0,231000,73000,158000,158000
052529,力成元大95購03  ,0,0,0,0,0,0,0,0,0,158000,0,0,0,158000,0,158000,158000
05140P,台表科國票96售01,0,0,0,0,0,0,0,0,0,158000,0,0,0,158000,0,158000,158000
05546P,全新元大97售01  ,0,0,0,0,0,0,0,0,0,158000,0,0,0,212000,54000,158000,158000
059474,元石油群益99購01,0,0,0,0,0,0,0,0,0,158000,0,0,0,159000,1000,158000,158000
061367,瑞祺國票9A購01  ,0,0,0,0,0,0,0,0,0,157000,0,0,0,482000,325000,157000,157000
061145,臻鼎中信9A購02  ,0,0,0,0,0,0,0,0,0,157000,0,0,0,300000,143000,157000,157000
060251,易華電元大9C購01,0,0,0,0,0,0,0,0,0,157000,0,0,0,169000,12000,157000,157000
057662,上銀元大9A購01  ,0,0,0,0,0,0,0,0,0,157000,0,0,0,221000,64000,157000,157000
060813,高鐵凱基9A購01  ,0,0,0,0,0,0,0,0,0,156000,0,0,0,156000,0,156000,156000
061052,和大群益9A購01  ,0,0,0,0,0,0,0,0,0,156000,0,0,0,214000,58000,156000,156000
05590P,臺股指中信96售05,0,0,0,0,0,0,0,0,0,156000,0,0,0,172000,16000,156000,156000
058522,聯茂元大99購07  ,0,0,0,0,0,0,0,0,0,156000,0,0,0,198000,42000,156000,156000
058114,台積電第一01購01,0,0,0,0,0,0,0,0,0,156000,0,0,0,156000,0,156000,156000
057820,華擎元大98購02  ,0,0,0,0,0,0,0,0,0,156000,0,0,0,240000,84000,156000,156000
057404,貿聯群益99購01  ,0,0,0,0,0,0,0,0,0,156000,0,0,0,187000,31000,156000,156000
6669,緯穎            ,664138,529000,135138,0,0,0,83000,5000,78000,-58000,9000,13000,-4000,12000,66000,-54000,155138
060686,康友元大9A購02  ,0,0,0,0,0,0,0,0,0,155000,0,0,0,194000,39000,155000,155000
060298,鎧勝元大9C購01  ,0,0,0,0,0,0,0,0,0,155000,0,0,0,190000,35000,155000,155000
060474,中租元大9B購01  ,0,0,0,0,0,0,0,0,0,155000,0,0,0,162000,7000,155000,155000
05282P,可成元大95售09  ,0,0,0,0,0,0,0,0,0,155000,0,0,0,155000,0,155000,155000
057724,亞德客國泰99購01,0,0,0,0,0,0,0,0,0,155000,0,0,0,692000,537000,155000,155000
055287,日電貿元大97購01,0,0,0,0,0,0,0,0,0,154000,0,0,0,154000,0,154000,154000
054058,晶豪科國票98購01,0,0,0,0,0,0,0,0,0,154000,0,0,0,168000,14000,154000,154000
055627,亞德客永豐97購02,0,0,0,0,0,0,0,0,0,154000,0,0,0,222000,68000,154000,154000
061589,世紀鋼富邦9B購01,0,0,0,0,0,0,0,0,0,153000,0,0,0,158000,5000,153000,153000
057885,台光電群益98購04,0,0,0,0,0,0,0,0,0,153000,0,0,0,173000,20000,153000,153000
057606,健策統一98購03  ,0,0,0,0,0,0,0,0,0,153000,0,0,0,203000,50000,153000,153000
060452,儒鴻元大9A購01  ,0,0,0,0,0,0,0,0,0,152000,0,0,0,176000,24000,152000,152000
060282,聚陽元大9A購01  ,0,0,0,0,0,0,0,0,0,152000,0,0,0,155000,3000,152000,152000
052897,緯創群益96購03  ,0,0,0,0,0,0,0,0,0,152000,0,0,0,222000,70000,152000,152000
058237,嘉晶元大99購04  ,0,0,0,0,0,0,0,0,0,152000,0,0,0,152000,0,152000,152000
040760,T50反1凱基95購01,0,0,0,0,0,0,0,0,0,152000,0,0,0,152000,0,152000,152000
056538,國泰金凱基98購01,0,0,0,0,0,0,0,0,0,152000,0,0,0,154000,2000,152000,152000
07685P,玉晶光凱基9B售03,0,0,0,0,0,0,0,0,0,152000,0,0,0,189000,37000,152000,152000
060543,鴻海凱基9B購02  ,0,0,0,0,0,0,0,0,0,151000,0,0,0,151000,0,151000,151000
060726,聯發科第一9A購01,0,0,0,0,0,0,0,0,0,151000,0,0,0,151000,0,151000,151000
060635,義隆永豐9A購01  ,0,0,0,0,0,0,0,0,0,151000,0,0,0,174000,23000,151000,151000
059128,友達中信99購02  ,0,0,0,0,0,0,0,0,0,151000,0,0,0,1133000,982000,151000,151000
058515,健鼎元大99購01  ,0,0,0,0,0,0,0,0,0,151000,0,0,0,151000,0,151000,151000
06465P,國巨統一98售04  ,0,0,0,0,0,0,0,0,0,150000,0,0,0,155000,5000,150000,150000
061296,台積電國泰9C購01,0,0,0,0,0,0,0,0,0,150000,0,0,0,170000,20000,150000,150000
061481,嘉澤元大9A購03  ,0,0,0,0,0,0,0,0,0,150000,0,0,0,197000,47000,150000,150000
047287,貿聯統一95購01  ,0,0,0,0,0,0,0,0,0,150000,0,0,0,150000,0,150000,150000
047628,新光金國票95購02,0,0,0,0,0,0,0,0,0,150000,0,0,0,150000,0,150000,150000
05094P,大立光元大95售07,0,0,0,0,0,0,0,0,0,150000,0,0,0,150000,0,150000,150000
053660,群創凱基98購08  ,0,0,0,0,0,0,0,0,0,150000,0,0,0,150000,0,150000,150000
058229,為升元大99購02  ,0,0,0,0,0,0,0,0,0,150000,0,0,0,150000,0,150000,150000
055858,聯茂元大97購03  ,0,0,0,0,0,0,0,0,0,150000,0,0,0,153000,3000,150000,150000
05434P,世紀鋼元富95售02,0,0,0,0,0,0,0,0,0,150000,0,0,0,150000,0,150000,150000
055172,凱美統一97購02  ,0,0,0,0,0,0,0,0,0,150000,0,0,0,150000,0,150000,150000
058919,SGBR2X元富99購05,0,0,0,0,0,0,0,0,0,150000,0,0,0,150000,0,150000,150000
058141,嘉聯益元大99購05,0,0,0,0,0,0,0,0,0,150000,0,0,0,150000,0,150000,150000
057529,嘉晶元大99購02  ,0,0,0,0,0,0,0,0,0,150000,0,0,0,160000,10000,150000,150000
053145,元黃金元大96購02,0,0,0,0,0,0,0,0,0,149000,0,0,0,150000,1000,149000,149000
03662C,FBVIX凱基03牛01 ,0,0,0,0,0,0,0,0,0,149000,0,0,0,159000,10000,149000,149000
057070,美律永豐98購02  ,0,0,0,0,0,0,0,0,0,149000,0,0,0,149000,0,149000,149000
056496,康控國泰99購01  ,0,0,0,0,0,0,0,0,0,149000,0,0,0,173000,24000,149000,149000
057016,中石化凱基9B購01,0,0,0,0,0,0,0,0,0,149000,0,0,0,209000,60000,149000,149000
060927,嘉晶永豐9A購01  ,0,0,0,0,0,0,0,0,0,148000,0,0,0,232000,84000,148000,148000
060809,康友群益9A購01  ,0,0,0,0,0,0,0,0,0,148000,0,0,0,184000,36000,148000,148000
053453,新光金統一98購01,0,0,0,0,0,0,0,0,0,148000,0,0,0,158000,10000,148000,148000
058926,勤誠元富99購01  ,0,0,0,0,0,0,0,0,0,148000,0,0,0,198000,50000,148000,148000
061075,亞德客兆豐9A購01,0,0,0,0,0,0,0,0,0,147000,0,0,0,201000,54000,147000,147000
061183,友達國泰9B購02  ,0,0,0,0,0,0,0,0,0,147000,0,0,0,147000,0,147000,147000
054221,華新科統一96購05,0,0,0,0,0,0,0,0,0,147000,0,0,0,152000,5000,147000,147000
03647C,T50反1元富99牛02,0,0,0,0,0,0,0,0,0,147000,0,0,0,177000,30000,147000,147000
055604,訊芯元大98購02  ,0,0,0,0,0,0,0,0,0,147000,0,0,0,205000,58000,147000,147000
057470,易華電永豐98購02,0,0,0,0,0,0,0,0,0,147000,0,0,0,147000,0,147000,147000
059070,道瓊指元大99購02,0,0,0,0,0,0,0,0,0,147000,0,0,0,210000,63000,147000,147000
061325,晶技凱基9A購03  ,0,0,0,0,0,0,0,0,0,146000,0,0,0,151000,5000,146000,146000
060453,儒鴻元大9A購02  ,0,0,0,0,0,0,0,0,0,146000,0,0,0,220000,74000,146000,146000
054258,牧德元大97購01  ,0,20000,-20000,0,0,0,0,0,0,166000,0,0,0,199000,33000,166000,146000
060814,健策凱基9B購01  ,0,0,0,0,0,0,0,0,0,145000,0,0,0,176000,31000,145000,145000
050321,GIS國票95購02   ,0,0,0,0,0,0,0,0,0,145000,0,0,0,145000,0,145000,145000
059166,友達凱基99購05  ,0,0,0,0,0,0,0,0,0,145000,0,0,0,185000,40000,145000,145000
057651,矽力元大98購03  ,0,0,0,0,0,0,0,0,0,145000,0,0,0,190000,45000,145000,145000
060314,元翎永豐9A購01  ,0,0,0,0,0,0,0,0,0,144000,0,0,0,144000,0,144000,144000
061045,儒鴻第一9A購01  ,0,0,0,0,0,0,0,0,0,144000,0,0,0,216000,72000,144000,144000
055466,台達電凱基97購03,0,0,0,0,0,0,0,0,0,144000,0,0,0,194000,50000,144000,144000
055659,百和元富97購01  ,0,0,0,0,0,0,0,0,0,144000,0,0,0,144000,0,144000,144000
056561,台光電群益98購02,0,0,0,0,0,0,0,0,0,144000,0,0,0,298000,154000,144000,144000
054455,楠梓電群益98購02,0,0,0,0,0,0,0,0,0,143000,0,0,0,204000,61000,143000,143000
059159,上銀凱基99購05  ,0,0,0,0,0,0,0,0,0,143000,0,0,0,148000,5000,143000,143000
053067,牧德群益96購01  ,0,0,0,0,0,0,0,0,0,142000,0,0,0,142000,0,142000,142000
052489,義隆國票96購02  ,0,0,0,0,0,0,0,0,0,142000,0,0,0,151000,9000,142000,142000
057454,上銀國泰99購02  ,0,0,0,0,0,0,0,0,0,142000,0,0,0,178000,36000,142000,142000
057774,台光電群益99購02,0,0,0,0,0,0,0,0,0,142000,0,0,0,227000,85000,142000,142000
061457,TPK凱基9A購01   ,0,0,0,0,0,0,0,0,0,141000,0,0,0,194000,53000,141000,141000
058949,上銀群益99購02  ,0,0,0,0,0,0,0,0,0,141000,0,0,0,202000,61000,141000,141000
059403,T50反1台新03購03,10000,0,10000,0,0,0,0,0,0,131000,0,0,0,192000,61000,131000,141000
061008,群創兆豐9A購02  ,0,0,0,0,0,0,0,0,0,140000,0,0,0,182000,42000,140000,140000
061156,玉晶光群益9A購07,0,0,0,0,0,0,0,0,0,140000,0,0,0,146000,6000,140000,140000
059789,貿聯元大9A購02  ,0,0,0,0,0,0,0,0,0,140000,0,0,0,140000,0,140000,140000
053768,S&P反1元大99購01,0,0,0,0,0,0,0,0,0,140000,0,0,0,180000,40000,140000,140000
052682,上銀元大97購01  ,0,0,0,0,0,0,0,0,0,140000,0,0,0,140000,0,140000,140000
059123,訊芯永豐99購03  ,0,0,0,0,0,0,0,0,0,140000,0,0,0,335000,195000,140000,140000
057405,麗豐群益98購01  ,0,0,0,0,0,0,0,0,0,140000,0,0,0,140000,0,140000,140000
056658,美食元大98購01  ,0,0,0,0,0,0,0,0,0,140000,0,0,0,140000,0,140000,140000
058115,台光電中信99購01,0,0,0,0,0,0,0,0,0,140000,0,0,0,226000,86000,140000,140000
07545P,玉晶光凱基9A售07,0,0,0,0,0,0,0,0,0,140000,0,0,0,140000,0,140000,140000
054874,帆宣群益99購02  ,0,0,0,0,0,0,0,0,0,139000,0,0,0,139000,0,139000,139000
055935,創意群益97購02  ,0,0,0,0,0,0,0,0,0,139000,0,0,0,139000,0,139000,139000
057837,康控國泰99購02  ,0,0,0,0,0,0,0,0,0,139000,0,0,0,144000,5000,139000,139000
056287,亞光永豐97購02  ,0,0,0,0,0,0,0,0,0,139000,0,0,0,145000,6000,139000,139000
07552P,技嘉元大9A售03  ,0,0,0,0,0,0,0,0,0,139000,0,0,0,150000,11000,139000,139000
2387,精元            ,645000,383000,262000,0,0,0,0,0,0,-123000,6000,55000,-49000,1000,75000,-74000,139000
060163,健策永豐9B購01  ,0,0,0,0,0,0,0,0,0,138000,0,0,0,150000,12000,138000,138000
060380,T50反1凱基9A購08,100000,0,100000,0,0,0,0,0,0,38000,0,0,0,158000,120000,38000,138000
060572,景碩永豐9A購01  ,0,0,0,0,0,0,0,0,0,138000,0,0,0,153000,15000,138000,138000
061248,健策群益9A購03  ,0,0,0,0,0,0,0,0,0,138000,0,0,0,167000,29000,138000,138000
054935,華通元大98購03  ,0,0,0,0,0,0,0,0,0,138000,0,0,0,138000,0,138000,138000
057312,美律麥證98購01  ,0,0,0,138000,0,138000,0,0,0,138000,0,0,0,138000,0,138000,138000
056378,欣興元富98購01  ,0,0,0,0,0,0,0,0,0,138000,0,0,0,152000,14000,138000,138000
8110,華東            ,401000,258000,143000,0,0,0,0,0,0,-5000,0,5000,-5000,0,0,0,138000
061137,晶技統一9B購01  ,0,0,0,0,0,0,0,0,0,137000,0,0,0,214000,77000,137000,137000
060911,大毅元大9A購01  ,0,0,0,0,0,0,0,0,0,137000,0,0,0,141000,4000,137000,137000
053255,貿聯國泰97購01  ,0,0,0,0,0,0,0,0,0,137000,0,0,0,157000,20000,137000,137000
055092,開發金群益9B購01,0,0,0,0,0,0,0,0,0,137000,0,0,0,137000,0,137000,137000
052200,台光電統一95購02,0,0,0,0,0,0,0,0,0,137000,0,0,0,314000,177000,137000,137000
056943,華通統一99購01  ,0,0,0,0,0,0,0,0,0,137000,0,0,0,247000,110000,137000,137000
061578,玉晶光元大9A購16,0,0,0,0,0,0,0,0,0,136000,0,0,0,137000,1000,136000,136000
054244,華新元大96購01  ,0,0,0,0,0,0,0,0,0,136000,0,0,0,172000,36000,136000,136000
056855,祥碩中信98購02  ,0,0,0,0,0,0,0,0,0,136000,0,0,0,1093000,957000,136000,136000
058526,鈺齊元大99購02  ,0,0,0,0,0,0,0,0,0,136000,0,0,0,144000,8000,136000,136000
058656,燿華中信99購01  ,0,0,0,0,0,0,0,0,0,136000,0,0,0,369000,233000,136000,136000
060995,泰鼎元大9A購03  ,0,0,0,0,0,0,0,0,0,135000,0,0,0,236000,101000,135000,135000
055323,貿聯國票98購01  ,0,0,0,0,0,0,0,0,0,135000,0,0,0,135000,0,135000,135000
053569,漢唐統一98購01  ,0,0,0,0,0,0,0,0,0,135000,0,0,0,135000,0,135000,135000
05060P,台達電富邦97售02,0,0,0,0,0,0,0,0,0,135000,0,0,0,135000,0,135000,135000
050853,南電國票96購01  ,0,0,0,0,0,0,0,0,0,135000,0,0,0,141000,6000,135000,135000
055710,亞德客元大97購03,0,0,0,0,0,0,0,0,0,135000,0,0,0,181000,46000,135000,135000
056949,義隆統一98購01  ,0,0,0,0,0,0,0,0,0,135000,0,0,0,135000,0,135000,135000
056419,欣興元富98購02  ,0,0,0,0,0,0,0,0,0,135000,0,0,0,146000,11000,135000,135000
07761P,智邦永豐9A售03  ,0,0,0,0,0,0,0,0,0,135000,0,0,0,150000,15000,135000,135000
061043,百和永豐9A購01  ,0,0,0,0,0,0,0,0,0,134000,0,0,0,144000,10000,134000,134000
060715,日電貿永豐9A購01,0,0,0,0,0,0,0,0,0,134000,0,0,0,134000,0,134000,134000
060165,上緯控永豐9A購01,0,0,0,0,0,0,0,0,0,134000,0,0,0,137000,3000,134000,134000
060111,臻鼎元大99購04  ,0,0,0,0,0,0,0,0,0,134000,0,0,0,134000,0,134000,134000
059940,微星永豐99購01  ,0,0,0,0,0,0,0,0,0,134000,0,0,0,134000,0,134000,134000
050306,聯發科中信97購01,0,0,0,0,0,0,0,0,0,134000,0,0,0,134000,0,134000,134000
052538,和大統一95購02  ,0,0,0,0,0,0,0,0,0,134000,0,0,0,134000,0,134000,134000
058487,晶技國票9A購01  ,0,0,0,0,0,0,0,0,0,134000,0,0,0,138000,4000,134000,134000
058369,亞光凱基99購02  ,0,0,0,0,0,0,0,0,0,134000,0,0,0,144000,10000,134000,134000
07473P,祥碩元大9A售01  ,0,0,0,0,0,0,0,0,0,134000,0,0,0,439000,305000,134000,134000
060861,漢唐永豐9A購01  ,0,0,0,0,0,0,0,0,0,133000,0,0,0,143000,10000,133000,133000
058293,光寶科凱基9A購01,0,0,0,0,0,0,0,0,0,133000,0,0,0,466000,333000,133000,133000
058759,義隆群益99購01  ,0,0,0,0,0,0,0,0,0,133000,0,0,0,151000,18000,133000,133000
060708,康友富邦9B購01  ,0,0,0,0,0,0,0,0,0,132000,0,0,0,202000,70000,132000,132000
060651,瑞儀中信9B購01  ,0,0,0,0,0,0,0,0,0,132000,0,0,0,198000,66000,132000,132000
061035,亞光永豐9A購01  ,0,0,0,0,0,0,0,0,0,132000,0,0,0,154000,22000,132000,132000
061521,亞光兆豐9A購02  ,0,0,0,0,0,0,0,0,0,132000,0,0,0,132000,0,132000,132000
052777,燿華國票98購01  ,0,0,0,0,0,0,0,0,0,132000,0,0,0,132000,0,132000,132000
051317,亞德客國票96購01,0,0,0,0,0,0,0,0,0,132000,0,0,0,132000,0,132000,132000
056304,創意元大97購03  ,0,0,0,0,0,0,0,0,0,132000,0,0,0,132000,0,132000,132000
059807,大立光元富99購09,0,0,0,0,0,0,0,0,0,131000,0,0,0,233000,102000,131000,131000
059567,台積電凱基9A購12,0,0,0,0,0,0,0,0,0,131000,0,0,0,132000,1000,131000,131000
059610,上銀永豐99購02  ,0,0,0,0,0,0,0,0,0,131000,0,0,0,131000,0,131000,131000
057113,祥碩群益98購01  ,0,0,0,0,0,0,0,0,0,131000,0,0,0,166000,35000,131000,131000
056529,中環凱基98購01  ,0,0,0,0,0,0,0,0,0,131000,0,0,0,131000,0,131000,131000
05650P,台積電富邦96售01,0,0,0,0,0,0,0,0,0,131000,0,0,0,131000,0,131000,131000
9914,美利達          ,1042000,1021000,21000,0,0,0,103000,0,103000,7000,15000,8000,7000,0,0,0,131000
060201,台表科元富9A購01,0,0,0,0,0,0,0,0,0,130000,0,0,0,130000,0,130000,130000
061484,華通兆豐9B購01  ,0,0,0,0,0,0,0,0,0,130000,0,0,0,136000,6000,130000,130000
061622,臻鼎群益9A購01  ,0,0,0,0,0,0,0,0,0,130000,0,0,0,269000,139000,130000,130000
053677,同欣電國泰97購01,0,0,0,0,0,0,0,0,0,130000,0,0,0,130000,0,130000,130000
054334,超眾永豐96購04  ,0,0,0,0,0,0,0,0,0,130000,0,0,0,161000,31000,130000,130000
058122,美律國票9A購01  ,0,0,0,0,0,0,0,0,0,130000,0,0,0,140000,10000,130000,130000
057075,嘉聯益永豐98購01,0,0,0,0,0,0,0,0,0,130000,0,0,0,130000,0,130000,130000
057395,旺宏中信98購03  ,0,0,0,0,0,0,0,0,0,130000,0,0,0,130000,0,130000,130000
06888P,日月光元大98售02,0,0,0,0,0,0,0,0,0,129000,0,0,0,129000,0,129000,129000
060155,友訊永豐9A購01  ,0,0,0,0,0,0,0,0,0,129000,0,0,0,139000,10000,129000,129000
059947,貿聯永豐99購03  ,0,0,0,0,0,0,0,0,0,129000,0,0,0,181000,52000,129000,129000
060388,世紀鋼凱基9B購01,0,0,0,0,0,0,0,0,0,129000,0,0,0,206000,77000,129000,129000
056767,大毅元大99購01  ,0,0,0,0,0,0,0,0,0,129000,0,0,0,171000,42000,129000,129000
055071,群電永豐97購01  ,0,0,0,0,0,0,0,0,0,129000,0,0,0,227000,98000,129000,129000
060847,康控國票9A購01  ,0,0,0,0,0,0,0,0,0,128000,0,0,0,128000,0,128000,128000
059691,大立光永豐99購02,0,0,0,0,0,0,0,0,0,128000,0,0,0,163000,35000,128000,128000
055830,上銀元大97購07  ,0,0,0,0,0,0,0,0,0,128000,0,0,0,133000,5000,128000,128000
055846,大立光元大97購09,0,0,0,0,0,0,0,0,0,128000,0,0,0,128000,0,128000,128000
054680,華新科康和97購02,0,0,0,0,0,0,0,0,0,128000,0,0,0,149000,21000,128000,128000
054772,康控國票98購02  ,0,0,0,0,0,0,0,0,0,128000,0,0,0,128000,0,128000,128000
057171,台光電元大9B購01,0,0,0,0,0,0,0,0,0,128000,0,0,0,260000,132000,128000,128000
058555,矽創永豐9A購01  ,0,0,0,0,0,0,0,0,0,128000,0,0,0,178000,50000,128000,128000
060217,國巨凱基9A購10  ,0,0,0,0,0,0,0,0,0,127000,0,0,0,127000,0,127000,127000
052428,嘉晶永豐95購01  ,0,0,0,0,0,0,0,0,0,127000,0,0,0,127000,0,127000,127000
057446,旺宏元富02購01  ,0,0,0,0,0,0,0,0,0,127000,0,0,0,156000,29000,127000,127000
057090,奇力新元富98購02,0,0,0,0,0,0,0,0,0,127000,0,0,0,132000,5000,127000,127000
07303P,臺股指元大9A售36,0,0,0,0,0,0,0,0,0,127000,0,0,0,246000,119000,127000,127000
060364,奇力新元富9A購01,0,0,0,0,0,0,0,0,0,126000,0,0,0,176000,50000,126000,126000
06232P,智易永豐97售01  ,0,0,0,0,0,0,0,0,0,126000,0,0,0,126000,0,126000,126000
051540,力成國票95購01  ,0,0,0,0,0,0,0,0,0,126000,0,0,0,126000,0,126000,126000
057511,健策統一98購02  ,0,0,0,0,0,0,0,0,0,126000,0,0,0,254000,128000,126000,126000
058614,台郡元大9A購01  ,0,0,0,0,0,0,0,0,0,126000,0,0,0,126000,0,126000,126000
07219P,臺股指凱基99售32,0,0,0,0,0,0,0,0,0,126000,0,0,0,146000,20000,126000,126000
07713P,台郡元大9A售03  ,0,0,0,0,0,0,0,0,0,126000,0,0,0,131000,5000,126000,126000
061447,鴻海中信04購02  ,0,0,0,0,0,0,0,0,0,125000,0,0,0,135000,10000,125000,125000
060295,貿聯元大9A購03  ,0,0,0,0,0,0,0,0,0,125000,0,0,0,134000,9000,125000,125000
060908,金像電元大9A購03,2000,0,2000,0,0,0,0,0,0,123000,0,0,0,413000,290000,123000,125000
053586,建準元大96購01  ,0,0,0,0,0,0,0,0,0,125000,0,0,0,125000,0,125000,125000
04628P,欣興元大95售01  ,0,0,0,0,0,0,0,0,0,125000,0,0,0,125000,0,125000,125000
07593P,臺股指凱基9A售08,0,0,0,0,0,0,0,0,0,125000,0,0,0,245000,120000,125000,125000
07379P,大立光元大99售30,0,0,0,0,0,0,0,0,0,125000,0,0,0,125000,0,125000,125000
060888,金像電統一9C購01,0,0,0,0,0,0,0,0,0,124000,0,0,0,475000,351000,124000,124000
060835,亞德客國票9A購01,0,0,0,0,0,0,0,0,0,124000,0,0,0,183000,59000,124000,124000
061195,健策永豐9B購02  ,0,0,0,0,0,0,0,0,0,124000,0,0,0,124000,0,124000,124000
053694,創意元大96購03  ,0,0,0,0,0,0,0,0,0,124000,0,0,0,268000,144000,124000,124000
054590,嘉聯益國泰98購01,0,0,0,0,0,0,0,0,0,124000,0,0,0,124000,0,124000,124000
056769,國產元大98購01  ,0,0,0,0,0,0,0,0,0,124000,0,0,0,277000,153000,124000,124000
058658,瑞儀中信99購01  ,0,0,0,0,0,0,0,0,0,124000,0,0,0,185000,61000,124000,124000
058832,立積永豐99購01  ,0,0,0,0,0,0,0,0,0,124000,0,0,0,144000,20000,124000,124000
058707,泰鼎元大99購02  ,0,0,0,0,0,0,0,0,0,124000,0,0,0,164000,40000,124000,124000
058920,SGBR2X元富99購06,0,0,0,0,0,0,0,0,0,124000,0,0,0,125000,1000,124000,124000
061281,台積電統一9C購05,0,0,0,0,0,0,0,0,0,123000,0,0,0,154000,31000,123000,123000
060559,世紀鋼凱基9C購01,0,0,0,0,0,0,0,0,0,123000,0,0,0,150000,27000,123000,123000
059678,鴻海國泰9A購03  ,0,0,0,0,0,0,0,0,0,123000,0,0,0,145000,22000,123000,123000
059829,超眾凱基99購05  ,0,0,0,0,0,0,0,0,0,123000,0,0,0,163000,40000,123000,123000
056142,超眾元大97購06  ,0,0,0,0,0,0,0,0,0,123000,0,0,0,123000,0,123000,123000
057486,美律元大98購04  ,0,0,0,0,0,0,0,0,0,123000,0,0,0,193000,70000,123000,123000
057804,為升元大98購01  ,0,0,0,0,0,0,0,0,0,123000,0,0,0,183000,60000,123000,123000
056462,訊芯凱基98購03  ,0,0,0,0,0,0,0,0,0,123000,0,0,0,123000,0,123000,123000
057162,上銀元大98購03  ,0,0,0,0,0,0,0,0,0,123000,0,0,0,123000,0,123000,123000
2340,光磊            ,243000,113000,130000,0,0,0,0,0,0,-7000,4000,6000,-2000,0,5000,-5000,123000
060621,玉晶光元大9A購05,0,0,0,0,0,0,0,0,0,122000,0,0,0,157000,35000,122000,122000
05910P,力山永豐96售02  ,0,0,0,0,0,0,0,0,0,122000,0,0,0,192000,70000,122000,122000
059364,昇陽半永豐99購02,0,0,0,0,0,0,0,0,0,122000,0,0,0,146000,24000,122000,122000
059480,美律群益9A購01  ,0,0,0,0,0,0,0,0,0,122000,0,0,0,162000,40000,122000,122000
056574,亞光元大99購03  ,0,0,0,0,0,0,0,0,0,122000,0,0,0,125000,3000,122000,122000
057356,彩晶統一98購04  ,0,0,0,0,0,0,0,0,0,122000,0,0,0,122000,0,122000,122000
1611,中電            ,380000,258000,122000,0,0,0,0,0,0,0,0,0,0,0,0,0,122000
059647,超眾凱基99購04  ,0,0,0,0,0,0,0,0,0,121000,0,0,0,155000,34000,121000,121000
060215,柏文康和9A購01  ,0,0,0,0,0,0,0,0,0,121000,0,0,0,310000,189000,121000,121000
054439,健策台新96購03  ,0,0,0,0,0,0,0,0,0,121000,0,0,0,215000,94000,121000,121000
055173,瑞昱統一97購01  ,0,0,0,0,0,0,0,0,0,121000,0,0,0,121000,0,121000,121000
05483P,國巨凱基95售07  ,0,0,0,0,0,0,0,0,0,121000,0,0,0,121000,0,121000,121000
05729P,臺股指凱基97售02,0,0,0,0,0,0,0,0,0,121000,0,0,0,195000,74000,121000,121000
055925,上銀群益97購01  ,0,0,0,0,0,0,0,0,0,121000,0,0,0,121000,0,121000,121000
07085P,超眾元富9C售01  ,0,0,0,0,0,0,0,0,0,121000,0,0,0,123000,2000,121000,121000
060024,T50反1國泰9B購02,0,0,0,0,0,0,0,0,0,120000,0,0,0,150000,30000,120000,120000
052095,彩晶元大97購01  ,0,0,0,0,0,0,0,0,0,120000,0,0,0,120000,0,120000,120000
053083,中環元大99購01  ,0,0,0,0,0,0,0,0,0,120000,0,0,0,125000,5000,120000,120000
056851,瑞儀元富98購01  ,0,0,0,0,0,0,0,0,0,120000,0,0,0,261000,141000,120000,120000
058356,華邦電凱基99購01,0,0,0,0,0,0,0,0,0,120000,0,0,0,140000,20000,120000,120000
058521,日月光元大99購01,0,0,0,0,0,0,0,0,0,120000,0,0,0,130000,10000,120000,120000
056882,華邦電康和98購01,0,0,0,0,0,0,0,0,0,120000,0,0,0,120000,0,120000,120000
057737,國巨富邦99購02  ,0,0,0,0,0,0,0,0,0,120000,0,0,0,120000,0,120000,120000
058439,玉晶光統一01購02,0,0,0,0,0,0,0,0,0,120000,0,0,0,190000,70000,120000,120000
057053,立積元大98購02  ,0,0,0,0,0,0,0,0,0,120000,0,0,0,156000,36000,120000,120000
057603,樺漢群益98購02  ,0,0,0,0,0,0,0,0,0,120000,0,0,0,233000,113000,120000,120000
060029,嘉晶永豐99購03  ,0,0,0,0,0,0,0,0,0,119000,0,0,0,131000,12000,119000,119000
060016,廣達康和99購01  ,0,0,0,0,0,0,0,0,0,119000,0,0,0,269000,150000,119000,119000
060827,健策元大9A購02  ,0,0,0,0,0,0,0,0,0,119000,0,0,0,119000,0,119000,119000
060406,瑞祺國泰9B購01  ,0,0,0,0,0,0,0,0,0,119000,0,0,0,295000,176000,119000,119000
056599,臻鼎元富98購01  ,0,0,0,0,0,0,0,0,0,119000,0,0,0,223000,104000,119000,119000
056209,超眾永豐97購02  ,0,0,0,0,0,0,0,0,0,119000,0,0,0,194000,75000,119000,119000
056085,聯發科統一97購01,0,0,0,0,0,0,0,0,0,119000,0,0,0,139000,20000,119000,119000
07415P,台積電元大99售52,0,0,0,0,0,0,0,0,0,119000,0,0,0,139000,20000,119000,119000
061065,神基凱基9A購01  ,0,0,0,0,0,0,0,0,0,118000,0,0,0,118000,0,118000,118000
05304P,國巨國泰97售02  ,0,0,0,0,0,0,0,0,0,118000,0,0,0,128000,10000,118000,118000
052527,泰鼎元大96購02  ,0,0,0,0,0,0,0,0,0,118000,0,0,0,125000,7000,118000,118000
058429,欣興元富99購01  ,0,0,0,0,0,0,0,0,0,118000,0,0,0,130000,12000,118000,118000
057287,彩晶元大9C購03  ,0,0,0,0,0,0,0,0,0,118000,0,0,0,118000,0,118000,118000
056267,文曄統一97購02  ,0,0,0,0,0,0,0,0,0,118000,0,0,0,118000,0,118000,118000
061579,京鼎元大9A購02  ,0,0,0,0,0,0,0,0,0,117000,0,0,0,194000,77000,117000,117000
053619,和碩群益96購01  ,0,0,0,0,0,0,0,0,0,117000,0,0,0,117000,0,117000,117000
053399,創意中信96購01  ,0,0,0,0,0,0,0,0,0,117000,0,0,0,117000,0,117000,117000
053400,緯穎中信9A購01  ,0,0,0,0,0,0,0,0,0,117000,0,0,0,264000,147000,117000,117000
057957,嘉晶元大98購01  ,0,0,0,0,0,0,0,0,0,117000,0,0,0,121000,4000,117000,117000
055670,矽創群益98購02  ,0,0,0,0,0,0,0,0,0,117000,0,0,0,242000,125000,117000,117000
06743P,創意永豐98售03  ,0,0,0,0,0,0,0,0,0,116000,0,0,0,155000,39000,116000,116000
061476,大毅元大9A購02  ,0,0,0,0,0,0,0,0,0,116000,0,0,0,117000,1000,116000,116000
059923,緯穎元大99購09  ,0,0,0,0,0,0,0,0,0,116000,0,0,0,144000,28000,116000,116000
053773,上銀元大96購04  ,0,0,0,0,0,0,0,0,0,116000,0,0,0,116000,0,116000,116000
056191,世紀鋼統一97購01,0,0,0,0,0,0,0,0,0,116000,0,0,0,116000,0,116000,116000
056975,元油2X群益98購03,198000,82000,116000,0,0,0,0,0,0,0,0,0,0,0,0,0,116000
056296,旺宏元大97購07  ,0,0,0,0,0,0,0,0,0,116000,0,0,0,226000,110000,116000,116000
057170,瑞昱元大98購01  ,0,0,0,0,0,0,0,0,0,116000,0,0,0,196000,80000,116000,116000
056689,玉晶光統一9A購03,0,0,0,0,0,0,0,0,0,116000,0,0,0,120000,4000,116000,116000
057407,超眾群益99購01  ,0,0,0,0,0,0,0,0,0,116000,0,0,0,126000,10000,116000,116000
060296,和碩元大9A購01  ,0,0,0,0,0,0,0,0,0,115000,0,0,0,115000,0,115000,115000
060285,聯電元大9C購01  ,0,0,0,0,0,0,0,0,0,115000,0,0,0,152000,37000,115000,115000
060991,京鼎元大9A購01  ,0,0,0,0,0,0,0,0,0,115000,0,0,0,173000,58000,115000,115000
052441,亞泥元大95購01  ,0,0,0,0,0,0,0,0,0,115000,0,0,0,115000,0,115000,115000
059006,樺漢元大99購01  ,0,0,0,0,0,0,0,0,0,115000,0,0,0,181000,66000,115000,115000
056307,貿聯元大97購05  ,0,0,0,0,0,0,0,0,0,115000,0,0,0,115000,0,115000,115000
061467,嘉澤群益9A購01  ,0,0,0,0,0,0,0,0,0,114000,0,0,0,184000,70000,114000,114000
06728P,全新元大98售03  ,0,0,0,0,0,0,0,0,0,114000,0,0,0,172000,58000,114000,114000
059533,富邦金凱基99購01,0,0,0,0,0,0,0,0,0,114000,0,0,0,185000,71000,114000,114000
052096,力成元大95購01  ,0,0,0,0,0,0,0,0,0,114000,0,0,0,115000,1000,114000,114000
057964,緯穎元大99購03  ,0,0,0,0,0,0,0,0,0,114000,0,0,0,129000,15000,114000,114000
055197,致新元富97購02  ,0,0,0,0,0,0,0,0,0,114000,0,0,0,579000,465000,114000,114000
054162,光罩凱基98購01  ,0,0,0,0,0,0,0,0,0,114000,0,0,0,126000,12000,114000,114000
053924,京鼎國票97購01  ,0,0,0,0,0,0,0,0,0,114000,0,0,0,114000,0,114000,114000
07039P,南電台新99售01  ,0,0,0,0,0,0,0,0,0,114000,0,0,0,114000,0,114000,114000
07130P,台郡元大9B售01  ,0,0,0,0,0,0,0,0,0,114000,0,0,0,120000,6000,114000,114000
07482P,南亞科元富9A售04,0,0,0,0,0,0,0,0,0,114000,0,0,0,114000,0,114000,114000
060382,儒鴻凱基9A購01  ,0,0,0,0,0,0,0,0,0,113000,0,0,0,140000,27000,113000,113000
060542,上銀凱基9A購04  ,0,0,0,0,0,0,0,0,0,113000,0,0,0,113000,0,113000,113000
060640,京鼎永豐9A購01  ,0,0,0,0,0,0,0,0,0,113000,0,0,0,216000,103000,113000,113000
061500,京鼎國票9B購01  ,0,0,0,0,0,0,0,0,0,113000,0,0,0,113000,0,113000,113000
051747,貿聯國泰96購01  ,0,0,0,0,0,0,0,0,0,113000,0,0,0,113000,0,113000,113000
057720,日電貿元富98購01,0,0,0,0,0,0,0,0,0,113000,0,0,0,113000,0,113000,113000
057631,康控永豐98購02  ,0,0,0,0,0,0,0,0,0,113000,0,0,0,113000,0,113000,113000
07178P,臺股指凱基99售20,0,0,0,0,0,0,0,0,0,113000,0,0,0,124000,11000,113000,113000
060897,健策凱基9A購04  ,0,0,0,0,0,0,0,0,0,112000,0,0,0,127000,15000,112000,112000
060127,牧德永豐99購02  ,0,0,0,0,0,0,0,0,0,112000,0,0,0,112000,0,112000,112000
054831,緯穎國泰98購01  ,0,0,0,0,0,0,0,0,0,112000,0,0,0,112000,0,112000,112000
054835,致新中信97購01  ,0,0,0,0,0,0,0,0,0,112000,0,0,0,170000,58000,112000,112000
048653,巨大元大96購02  ,0,0,0,0,0,0,0,0,0,112000,0,0,0,112000,0,112000,112000
057988,鈺齊元富98購02  ,0,0,0,0,0,0,0,0,0,112000,0,0,0,116000,4000,112000,112000
057674,台郡元大99購03  ,0,0,0,0,0,0,0,0,0,112000,0,0,0,270000,158000,112000,112000
058516,健鼎元大99購02  ,0,0,0,0,0,0,0,0,0,112000,0,0,0,128000,16000,112000,112000
058041,FBVIX元大98購02 ,0,0,0,0,0,0,0,0,0,112000,0,0,0,112000,0,112000,112000
056408,奇鋐國票99購01  ,0,0,0,0,0,0,0,0,0,112000,0,0,0,135000,23000,112000,112000
060909,金像電元大9B購01,0,0,0,0,0,0,0,0,0,111000,0,0,0,156000,45000,111000,111000
053595,創意元大96購02  ,0,0,0,0,0,0,0,0,0,111000,0,0,0,111000,0,111000,111000
058537,彩晶統一9B購01  ,0,0,0,0,0,0,0,0,0,111000,0,0,0,136000,25000,111000,111000
06059P,泰碩元大97售02  ,0,0,0,0,0,0,0,0,0,110000,0,0,0,110000,0,110000,110000
061066,嘉晶凱基9B購01  ,0,0,0,0,0,0,0,0,0,110000,0,0,0,151000,41000,110000,110000
053553,聯詠凱基96購03  ,0,0,0,0,0,0,0,0,0,110000,0,0,0,110000,0,110000,110000
053774,台達電元大96購04,0,0,0,0,0,0,0,0,0,110000,0,0,0,120000,10000,110000,110000
049585,旺宏元大95購02  ,0,0,0,0,0,0,0,0,0,110000,0,0,0,110000,0,110000,110000
056774,和鑫元大98購01  ,0,0,0,0,0,0,0,0,0,110000,0,0,0,110000,0,110000,110000
054352,世芯國泰98購01  ,0,0,0,0,0,0,0,0,0,110000,0,0,0,119000,9000,110000,110000
05498P,友達元富95售02  ,0,0,0,0,0,0,0,0,0,110000,0,0,0,110000,0,110000,110000
053177,華邦電統一96購01,0,0,0,0,0,0,0,0,0,110000,0,0,0,120000,10000,110000,110000
058473,上銀凱基9A購03  ,0,0,0,0,0,0,0,0,0,110000,0,0,0,110000,0,110000,110000
05900P,臺股指凱基99售05,0,0,0,0,0,0,0,0,0,110000,0,0,0,110000,0,110000,110000
057074,立積永豐98購01  ,0,0,0,0,0,0,0,0,0,110000,0,0,0,490000,380000,110000,110000
07245P,台積電凱基99售16,0,0,0,0,0,0,0,0,0,110000,0,0,0,178000,68000,110000,110000
061350,牧德元大9B購03  ,0,0,0,0,0,0,0,0,0,109000,0,0,0,356000,247000,109000,109000
06584P,欣興凱基98售03  ,0,0,0,0,0,0,0,0,0,109000,0,0,0,109000,0,109000,109000
053171,中磊群益96購01  ,0,0,0,0,0,0,0,0,0,109000,0,0,0,109000,0,109000,109000
053996,晶相光群益97購01,0,0,0,0,0,0,0,0,0,109000,0,0,0,114000,5000,109000,109000
052771,GIS群益96購01   ,0,0,0,0,0,0,0,0,0,109000,0,0,0,109000,0,109000,109000
057809,英業達元大98購01,0,0,0,0,0,0,0,0,0,109000,0,0,0,259000,150000,109000,109000
057214,瑞昱群益98購01  ,0,0,0,0,0,0,0,0,0,109000,0,0,0,227000,118000,109000,109000
058686,祥碩凱基99購03  ,0,0,0,0,0,0,0,0,0,109000,0,0,0,246000,137000,109000,109000
058839,瑞儀中信99購02  ,0,0,0,0,0,0,0,0,0,109000,0,0,0,120000,11000,109000,109000
056906,玉晶光元大9B購01,0,0,0,0,0,0,0,0,0,109000,0,0,0,109000,0,109000,109000
06506P,台郡國票99售02  ,0,0,0,0,0,0,0,0,0,108000,0,0,0,108000,0,108000,108000
06396P,新日興康和97售01,0,0,0,0,0,0,0,0,0,108000,0,0,0,136000,28000,108000,108000
061355,康友元大9A購03  ,0,0,0,0,0,0,0,0,0,108000,0,0,0,138000,30000,108000,108000
052702,群創國票97購03  ,0,0,0,0,0,0,0,0,0,108000,0,0,0,217000,109000,108000,108000
00656R,國泰中國A50反1  ,52000,0,52000,0,0,0,0,0,0,56000,0,0,0,131000,75000,56000,108000
04250P,嘉晶統一95售02  ,0,0,0,0,0,0,0,0,0,108000,0,0,0,108000,0,108000,108000
052463,聯電統一96購01  ,0,0,0,0,0,0,0,0,0,108000,0,0,0,108000,0,108000,108000
07578P,高鐵元大9A售02  ,0,0,0,0,0,0,0,0,0,108000,0,0,0,108000,0,108000,108000
060365,京鼎元富9A購01  ,0,0,0,0,0,0,0,0,0,107000,0,0,0,135000,28000,107000,107000
058085,景碩群益9A購01  ,0,0,0,0,0,0,0,0,0,107000,0,0,0,111000,4000,107000,107000
055762,智伸科群益97購01,0,0,0,0,0,0,0,0,0,107000,0,0,0,108000,1000,107000,107000
056211,南港國票98購01  ,0,0,0,0,0,0,0,0,0,107000,0,0,0,282000,175000,107000,107000
058765,緯穎群益99購03  ,0,0,0,0,0,0,0,0,0,107000,0,0,0,141000,34000,107000,107000
059977,鴻海元大99購40  ,0,0,0,0,0,0,0,0,0,106000,0,0,0,116000,10000,106000,106000
061213,群創元大9A購05  ,0,0,0,0,0,0,0,0,0,106000,0,0,0,106000,0,106000,106000
057389,玉晶光永豐98購06,0,0,0,0,0,0,0,0,0,106000,0,0,0,166000,60000,106000,106000
057102,亞光中信9A購01  ,0,0,0,0,0,0,0,0,0,106000,0,0,0,106000,0,106000,106000
057161,亞德客元大98購02,0,0,0,0,0,0,0,0,0,106000,0,0,0,131000,25000,106000,106000
058159,健策台新9A購01  ,0,0,0,0,0,0,0,0,0,106000,0,0,0,170000,64000,106000,106000
058129,國巨元大99購10  ,0,0,0,0,0,0,0,0,0,106000,0,0,0,192000,86000,106000,106000
056939,康控元富98購01  ,0,0,0,0,0,0,0,0,0,106000,0,0,0,280000,174000,106000,106000
061344,禾伸堂元大9A購02,0,0,0,0,0,0,0,0,0,105000,0,0,0,107000,2000,105000,105000
060787,奇力新富邦9A購01,0,0,0,0,0,0,0,0,0,105000,0,0,0,105000,0,105000,105000
053632,新唐兆豐96購01  ,0,0,0,0,0,0,0,0,0,105000,0,0,0,105000,0,105000,105000
056787,健鼎群益98購01  ,0,0,0,0,0,0,0,0,0,105000,0,0,0,115000,10000,105000,105000
057632,傳奇永豐98購01  ,0,0,0,0,0,0,0,0,0,105000,0,0,0,105000,0,105000,105000
07757P,國巨國票9B售04  ,0,0,0,0,0,0,0,0,0,105000,0,0,0,324000,219000,105000,105000
2480,敦陽科          ,220000,114000,106000,0,0,0,0,0,0,-1000,0,1000,-1000,0,0,0,105000
060553,祥碩凱基9A購01  ,0,0,0,0,0,0,0,0,0,104000,0,0,0,164000,60000,104000,104000
060558,億豐凱基9A購01  ,0,0,0,0,0,0,0,0,0,104000,0,0,0,109000,5000,104000,104000
060103,聯詠元大99購01  ,0,0,0,0,0,0,0,0,0,104000,0,0,0,296000,192000,104000,104000
061144,玉晶光中信9B購02,0,0,0,0,0,0,0,0,0,104000,0,0,0,119000,15000,104000,104000
057744,健策永豐98購02  ,0,0,0,0,0,0,0,0,0,104000,0,0,0,104000,0,104000,104000
058699,楠梓電元大99購02,0,0,0,0,0,0,0,0,0,104000,0,0,0,194000,90000,104000,104000
055618,麗豐國票98購01  ,0,0,0,0,0,0,0,0,0,104000,0,0,0,104000,0,104000,104000
057225,華新凱基98購01  ,0,0,0,0,0,0,0,0,0,104000,0,0,0,104000,0,104000,104000
057340,玉晶光元富98購04,0,0,0,0,0,0,0,0,0,104000,0,0,0,199000,95000,104000,104000
061354,瑞儀元大9A購01  ,15000,0,15000,0,0,0,0,0,0,88000,0,0,0,265000,177000,88000,103000
06479P,聯發科中信99售02,0,0,0,0,0,0,0,0,0,103000,0,0,0,273000,170000,103000,103000
058596,旺宏台新99購01  ,0,0,0,0,0,0,0,0,0,103000,0,0,0,106000,3000,103000,103000
056358,友訊元大99購01  ,0,0,0,0,0,0,0,0,0,103000,0,0,0,122000,19000,103000,103000
056199,美律永豐97購01  ,0,0,0,0,0,0,0,0,0,103000,0,0,0,124000,21000,103000,103000
061267,玉山金凱基9B購01,0,0,0,0,0,0,0,0,0,102000,0,0,0,104000,2000,102000,102000
061067,貿聯凱基9A購03  ,0,0,0,0,0,0,0,0,0,102000,0,0,0,119000,17000,102000,102000
060094,聯發科元大99購41,0,0,0,0,0,0,0,0,0,102000,0,0,0,102000,0,102000,102000
058322,玉晶光永豐99購02,10000,0,10000,0,0,0,0,0,0,92000,0,0,0,154000,62000,92000,102000
053005,微星永豐96購01  ,0,0,0,0,0,0,0,0,0,102000,0,0,0,102000,0,102000,102000
05033P,T50反1元大98售01,0,0,0,0,0,0,0,0,0,102000,0,0,0,102000,0,102000,102000
048859,玉晶光群益96購02,0,0,0,0,0,0,0,0,0,102000,0,0,0,127000,25000,102000,102000
055471,聯發科凱基97購04,0,0,0,0,0,0,0,0,0,102000,0,0,0,102000,0,102000,102000
057617,國巨凱基99購06  ,0,0,0,0,0,0,0,0,0,102000,0,0,0,102000,0,102000,102000
057055,立積元大99購01  ,0,0,0,0,0,0,0,0,0,102000,0,0,0,199000,97000,102000,102000
059378,台光電群益9B購01,0,0,0,0,0,0,0,0,0,102000,0,0,0,119000,17000,102000,102000
07420P,可成元大99售07  ,0,0,0,0,0,0,0,0,0,102000,0,0,0,128000,26000,102000,102000
06721P,臺股指中信9A售03,0,0,0,0,0,0,0,0,0,101000,0,0,0,123000,22000,101000,101000
06387P,緯穎永豐97售02  ,0,0,0,0,0,0,0,0,0,101000,0,0,0,600000,499000,101000,101000
050690,台達電凱基96購01,0,0,0,0,0,0,0,0,0,101000,0,0,0,101000,0,101000,101000
055397,超眾統一97購02  ,0,0,0,0,0,0,0,0,0,101000,0,0,0,133000,32000,101000,101000
058546,玉晶光富邦9B購01,0,0,0,0,0,0,0,0,0,101000,0,0,0,101000,0,101000,101000
056971,麗豐永豐98購01  ,0,0,0,0,0,0,0,0,0,101000,0,0,0,101000,0,101000,101000
061607,台表科凱基9B購02,0,0,0,0,0,0,0,0,0,100000,0,0,0,100000,0,100000,100000
060999,國巨兆豐9A購01  ,0,0,0,0,0,0,0,0,0,100000,0,0,0,101000,1000,100000,100000
061194,聯鈞永豐9A購02  ,0,0,0,0,0,0,0,0,0,100000,0,0,0,100000,0,100000,100000
061279,鴻海統一9C購04  ,0,0,0,0,0,0,0,0,0,100000,0,0,0,153000,53000,100000,100000
052909,上銀統一96購01  ,0,0,0,0,0,0,0,0,0,100000,0,0,0,100000,0,100000,100000
057953,聚陽元大98購01  ,0,0,0,0,0,0,0,0,0,100000,0,0,0,100000,0,100000,100000
055265,玉晶光永豐98購03,0,0,0,0,0,0,0,0,0,100000,0,0,0,100000,0,100000,100000
054134,強茂元大96購01  ,0,0,0,0,0,0,0,0,0,100000,0,0,0,158000,58000,100000,100000
054662,同欣電元大97購02,0,0,0,0,0,0,0,0,0,100000,0,0,0,100000,0,100000,100000
051832,復盛元大95購01  ,0,0,0,0,0,0,0,0,0,100000,0,0,0,100000,0,100000,100000
051869,康控凱基96購01  ,0,0,0,0,0,0,0,0,0,100000,0,0,0,100000,0,100000,100000
052714,義隆凱基96購02  ,0,0,0,0,0,0,0,0,0,100000,0,0,0,100000,0,100000,100000
053583,漢唐元大96購03  ,0,0,0,0,0,0,0,0,0,100000,0,0,0,100000,0,100000,100000
054698,同欣電永豐97購01,0,0,0,0,0,0,0,0,0,100000,0,0,0,100000,0,100000,100000
053699,臺股指元大96購22,0,0,0,0,0,0,0,0,0,100000,0,0,0,100000,0,100000,100000
054753,復盛凱基98購01  ,0,0,0,0,0,0,0,0,0,100000,0,0,0,100000,0,100000,100000
054867,華航群益99購01  ,0,0,0,0,0,0,0,0,0,100000,0,0,0,100000,0,100000,100000
04842P,群創元大96售02  ,0,0,0,0,0,0,0,0,0,100000,0,0,0,100000,0,100000,100000
052641,聯詠台新96購01  ,0,0,0,0,0,0,0,0,0,100000,0,0,0,100000,0,100000,100000
052088,漢唐元大95購02  ,0,0,0,0,0,0,0,0,0,100000,0,0,0,100000,0,100000,100000
056955,台灣50永豐98購01,0,0,0,0,0,0,0,0,0,100000,0,0,0,100000,0,100000,100000
057776,京元電群益98購02,0,0,0,0,0,0,0,0,0,100000,0,0,0,103000,3000,100000,100000
056044,同欣電凱基97購03,0,0,0,0,0,0,0,0,0,100000,0,0,0,100000,0,100000,100000
055951,大成鋼元大97購02,8000,0,8000,0,0,0,0,0,0,92000,0,0,0,100000,8000,92000,100000
056920,友達兆豐98購02  ,0,0,0,0,0,0,0,0,0,100000,0,0,0,300000,200000,100000,100000
057671,群創元大9B購06  ,0,0,0,0,0,0,0,0,0,100000,0,0,0,100000,0,100000,100000
059075,FBVIX元大99購01 ,0,0,0,0,0,0,0,0,0,100000,0,0,0,115000,15000,100000,100000
059064,緯穎凱基99購02  ,0,0,0,0,0,0,0,0,0,100000,0,0,0,100000,0,100000,100000
056726,友達日盛9A購01  ,0,0,0,0,0,0,0,0,0,100000,0,0,0,100000,0,100000,100000
057378,康友元大98購02  ,0,0,0,0,0,0,0,0,0,100000,0,0,0,100000,0,100000,100000
057368,微星元大98購02  ,0,0,0,0,0,0,0,0,0,100000,0,0,0,149000,49000,100000,100000
3661,世芯-KY         ,1641000,942000,699000,0,0,0,20000,489000,-469000,-130000,18000,75000,-57000,4000,77000,-73000,100000
061643,嘉澤元大9A購05  ,0,0,0,0,0,0,0,0,0,99000,0,0,0,168000,69000,99000,99000
049488,智邦元大95購01  ,0,0,0,0,0,0,0,0,0,99000,0,0,0,100000,1000,99000,99000
054447,國泰金兆豐96購01,0,0,0,0,0,0,0,0,0,99000,0,0,0,99000,0,99000,99000
055272,國巨元大98購04  ,0,0,0,0,0,0,0,0,0,99000,0,0,0,100000,1000,99000,99000
055884,臺股指元富97購01,0,0,0,0,0,0,0,0,0,99000,0,0,0,99000,0,99000,99000
058240,景碩元大99購04  ,0,0,0,0,0,0,0,0,0,99000,0,0,0,131000,32000,99000,99000
056380,麗豐元富98購01  ,0,0,0,0,0,0,0,0,0,99000,0,0,0,227000,128000,99000,99000
060236,精元元大9C購01  ,0,0,0,0,0,0,0,0,0,98000,0,0,0,123000,25000,98000,98000
060535,群創麥證9A購01  ,0,0,0,98000,0,98000,0,0,0,98000,0,0,0,98000,0,98000,98000
060638,玉晶光永豐9A購04,0,0,0,0,0,0,0,0,0,98000,0,0,0,100000,2000,98000,98000
054147,GIS元大96購02   ,0,0,0,0,0,0,0,0,0,98000,0,0,0,98000,0,98000,98000
054974,台表科元大98購02,0,0,0,0,0,0,0,0,0,98000,0,0,0,102000,4000,98000,98000
053810,台達電群益96購01,0,40000,-40000,0,0,0,0,0,0,138000,0,0,0,140000,2000,138000,98000
055146,華通元大98購04  ,0,0,0,0,0,0,0,0,0,98000,0,0,0,98000,0,98000,98000
055091,微星群益97購01  ,0,0,0,0,0,0,0,0,0,98000,0,0,0,98000,0,98000,98000
054792,揚明光群益97購01,0,0,0,0,0,0,0,0,0,98000,0,0,0,98000,0,98000,98000
053519,力成群益96購02  ,0,0,0,0,0,0,0,0,0,98000,0,0,0,98000,0,98000,98000
058911,茂林元大99購04  ,0,0,0,0,0,0,0,0,0,98000,0,0,0,106000,8000,98000,98000
058123,亞光國票9A購01  ,0,0,0,0,0,0,0,0,0,98000,0,0,0,98000,0,98000,98000
057387,奇力新永豐98購03,0,0,0,0,0,0,0,0,0,98000,0,0,0,134000,36000,98000,98000
059127,國巨中信99購04  ,0,0,0,0,0,0,0,0,0,98000,0,0,0,143000,45000,98000,98000
3557,嘉威            ,254000,158000,96000,0,0,0,0,0,0,2000,4000,2000,2000,0,0,0,98000
060714,晶技永豐9A購02  ,0,0,0,0,0,0,0,0,0,97000,0,0,0,109000,12000,97000,97000
060315,易華電永豐9A購01,0,0,0,0,0,0,0,0,0,97000,0,0,0,122000,25000,97000,97000
046881,智原富邦99購01  ,0,0,0,0,0,0,0,0,0,97000,0,0,0,137000,40000,97000,97000
053281,茂林元大96購02  ,0,0,0,0,0,0,0,0,0,97000,0,0,0,97000,0,97000,97000
059209,華通元大99購08  ,0,0,0,0,0,0,0,0,0,97000,0,0,0,103000,6000,97000,97000
059115,美食永豐99購01  ,0,0,0,0,0,0,0,0,0,97000,0,0,0,102000,5000,97000,97000
059009,世紀鋼元大99購04,0,0,0,0,0,0,0,0,0,97000,0,0,0,191000,94000,97000,97000
056250,瑞昱兆豐97購02  ,0,0,0,0,0,0,0,0,0,97000,0,0,0,167000,70000,97000,97000
07208P,台積電凱基99售14,0,0,0,0,0,0,0,0,0,97000,0,0,0,109000,12000,97000,97000
07637P,國巨國票9A售08  ,0,0,0,0,0,0,0,0,0,97000,0,0,0,302000,205000,97000,97000
060528,友達中信9C購01  ,0,0,0,0,0,0,0,0,0,96000,0,0,0,236000,140000,96000,96000
060471,台勝科元大9B購01,0,0,0,0,0,0,0,0,0,96000,0,0,0,165000,69000,96000,96000
061270,彩晶凱基9A購02  ,0,0,0,0,0,0,0,0,0,96000,0,0,0,96000,0,96000,96000
061439,寶成凱基9A購01  ,0,0,0,0,0,0,0,0,0,96000,0,0,0,202000,106000,96000,96000
060934,台汽電永豐9A購02,0,0,0,0,0,0,0,0,0,96000,0,0,0,96000,0,96000,96000
053331,玉晶光永豐97購02,0,0,0,0,0,0,0,0,0,96000,0,0,0,199000,103000,96000,96000
055175,建準統一97購01  ,0,0,0,0,0,0,0,0,0,96000,0,0,0,96000,0,96000,96000
054778,世紀鋼國票99購01,0,0,0,0,0,0,0,0,0,96000,0,0,0,106000,10000,96000,96000
051791,智伸科國票96購01,0,0,0,0,0,0,0,0,0,96000,0,0,0,96000,0,96000,96000
057216,聯發科群益99購01,0,0,0,0,0,0,0,0,0,96000,0,0,0,97000,1000,96000,96000
059507,鴻海永豐99購03  ,0,0,0,0,0,0,0,0,0,96000,0,0,0,96000,0,96000,96000
056559,華通群益98購02  ,0,0,0,0,0,0,0,0,0,96000,0,0,0,464000,368000,96000,96000
058095,昇陽半元大98購03,0,0,0,0,0,0,0,0,0,96000,0,0,0,190000,94000,96000,96000
056980,建準群益98購02  ,0,0,0,0,0,0,0,0,0,96000,0,0,0,98000,2000,96000,96000
07729P,臺股指凱基9A售21,0,0,0,0,0,0,0,0,0,96000,0,0,0,124000,28000,96000,96000
060297,和碩元大9A購02  ,0,0,0,0,0,0,0,0,0,95000,0,0,0,108000,13000,95000,95000
059539,緯穎凱基99購03  ,0,0,0,0,0,0,0,0,0,95000,0,0,0,104000,9000,95000,95000
059706,嘉晶凱基99購01  ,0,0,0,0,0,0,0,0,0,95000,0,0,0,173000,78000,95000,95000
04462P,全新元富96售01  ,0,0,0,0,0,0,0,0,0,95000,0,0,0,172000,77000,95000,95000
00717,富邦美國特別股  ,0,0,0,0,0,0,0,0,0,95000,0,0,0,588000,493000,95000,95000
054151,瑞昱國泰97購01  ,0,0,0,0,0,0,0,0,0,95000,0,0,0,175000,80000,95000,95000
058808,大成鋼統一9B購01,0,0,0,0,0,0,0,0,0,95000,0,0,0,324000,229000,95000,95000
056548,瀚宇博凱基98購02,0,0,0,0,0,0,0,0,0,95000,0,0,0,95000,0,95000,95000
056655,旺宏元大99購02  ,0,0,0,0,0,0,0,0,0,95000,0,0,0,169000,74000,95000,95000
07470P,國巨元大9A售06  ,0,0,0,0,0,0,0,0,0,95000,0,0,0,295000,200000,95000,95000
060395,儒鴻國票9A購01  ,0,0,0,0,0,0,0,0,0,94000,0,0,0,94000,0,94000,94000
061050,康友中信9A購01  ,0,0,0,0,0,0,0,0,0,94000,0,0,0,94000,0,94000,94000
061245,晶技群益9A購01  ,0,0,0,0,0,0,0,0,0,94000,0,0,0,192000,98000,94000,94000
058353,國巨凱基99購09  ,0,0,0,0,0,0,0,0,0,94000,0,0,0,104000,10000,94000,94000
056766,義隆元大98購01  ,0,0,0,0,0,0,0,0,0,94000,0,0,0,113000,19000,94000,94000
053149,京元電元大96購02,0,0,0,0,0,0,0,0,0,94000,0,0,0,192000,98000,94000,94000
054941,凱美元大97購01  ,0,0,0,0,0,0,0,0,0,94000,0,0,0,94000,0,94000,94000
03648C,T50反1元大96牛07,0,0,0,0,0,0,0,0,0,94000,0,0,0,94000,0,94000,94000
05919P,京鼎元大96售03  ,0,0,0,0,0,0,0,0,0,94000,0,0,0,229000,135000,94000,94000
058218,緯穎群益99購01  ,0,0,0,0,0,0,0,0,0,94000,0,0,0,108000,14000,94000,94000
058584,百和群益9A購01  ,0,0,0,0,0,0,0,0,0,94000,0,0,0,149000,55000,94000,94000
059989,嘉晶元大9A購01  ,0,0,0,0,0,0,0,0,0,93000,0,0,0,96000,3000,93000,93000
054928,帆宣凱基98購01  ,0,0,0,0,0,0,0,0,0,93000,0,0,0,279000,186000,93000,93000
058901,美律元大99購07  ,0,0,0,0,0,0,0,0,0,93000,0,0,0,182000,89000,93000,93000
056458,日月光凱基98購02,0,0,0,0,0,0,0,0,0,93000,0,0,0,93000,0,93000,93000
060124,奇力新永豐99購03,0,0,0,0,0,0,0,0,0,92000,0,0,0,210000,118000,92000,92000
061228,聯茂中信9A購01  ,0,0,0,0,0,0,0,0,0,92000,0,0,0,92000,0,92000,92000
061641,玉晶光元大9A購17,0,0,0,0,0,0,0,0,0,92000,0,0,0,92000,0,92000,92000
058247,聯茂元大99購04  ,0,0,0,0,0,0,0,0,0,92000,0,0,0,137000,45000,92000,92000
056951,牧德統一99購01  ,0,0,0,0,0,0,0,0,0,92000,0,0,0,92000,0,92000,92000
055662,上銀中信99購01  ,0,0,0,0,0,0,0,0,0,92000,0,0,0,125000,33000,92000,92000
059849,興勤永豐99購01  ,0,0,0,0,0,0,0,0,0,91000,0,0,0,91000,0,91000,91000
054538,台光電國票98購01,0,0,0,0,0,0,0,0,0,91000,0,0,0,91000,0,91000,91000
00684R,元大美元指數反1 ,0,0,0,0,0,0,0,0,0,91000,0,0,0,126000,35000,91000,91000
054882,台光電統一97購02,0,0,0,0,0,0,0,0,0,91000,0,0,0,228000,137000,91000,91000
053744,台郡國票97購03  ,0,0,0,0,0,0,0,0,0,91000,0,0,0,126000,35000,91000,91000
056205,貿聯永豐97購01  ,0,0,0,0,0,0,0,0,0,91000,0,0,0,168000,77000,91000,91000
058569,健策凱基9A購01  ,0,0,0,0,0,0,0,0,0,91000,0,0,0,130000,39000,91000,91000
057402,嘉晶群益98購02  ,0,0,0,0,0,0,0,0,0,91000,0,0,0,167000,76000,91000,91000
059298,大立光元富9C購02,0,0,0,0,0,0,0,0,0,91000,0,0,0,261000,170000,91000,91000
060150,華通富邦9B購01  ,0,0,0,0,0,0,0,0,0,90000,0,0,0,100000,10000,90000,90000
060414,中興電永豐9A購01,0,0,0,0,0,0,0,0,0,90000,0,0,0,110000,20000,90000,90000
061633,統一元大9A購01  ,0,0,0,0,0,0,0,0,0,90000,0,0,0,109000,19000,90000,90000
061588,聯發科富邦9B購07,0,0,0,0,0,0,0,0,0,90000,0,0,0,111000,21000,90000,90000
053488,中石化兆豐97購01,0,0,0,0,0,0,0,0,0,90000,0,0,0,130000,40000,90000,90000
035274,華新台新97購01  ,0,0,0,0,0,0,0,0,0,90000,0,0,0,90000,0,90000,90000
04768P,大立光國泰96售03,0,0,0,0,0,0,0,0,0,90000,0,0,0,90000,0,90000,90000
054457,強茂群益96購01  ,0,0,0,0,0,0,0,0,0,90000,0,0,0,215000,125000,90000,90000
054373,富邦金中信97購01,0,0,0,0,0,0,0,0,0,90000,0,0,0,90000,0,90000,90000
055294,智易元大98購01  ,0,0,0,0,0,0,0,0,0,90000,0,0,0,90000,0,90000,90000
057439,元油2X統一99購02,0,0,0,0,0,0,0,0,0,90000,0,0,0,100000,10000,90000,90000
057936,健策群益99購01  ,0,0,0,0,0,0,0,0,0,90000,0,0,0,90000,0,90000,90000
058140,臻鼎元大99購02  ,0,0,0,0,0,0,0,0,0,90000,0,0,0,191000,101000,90000,90000
058659,力成中信99購01  ,0,0,0,0,0,0,0,0,0,90000,0,0,0,558000,468000,90000,90000
07081P,南電群益9A售01  ,0,0,0,0,0,0,0,0,0,90000,0,0,0,281000,191000,90000,90000
061135,聯發科統一9C購03,0,0,0,0,0,0,0,0,0,89000,0,0,0,119000,30000,89000,89000
061441,大毅永豐9A購04  ,0,0,0,0,0,0,0,0,0,89000,0,0,0,111000,22000,89000,89000
060260,京鼎凱基9C購01  ,0,0,0,0,0,0,0,0,0,89000,0,0,0,99000,10000,89000,89000
060014,中鋼康和99購01  ,0,0,0,0,0,0,0,0,0,89000,0,0,0,89000,0,89000,89000
048001,中工元大96購01  ,0,0,0,0,0,0,0,0,0,89000,0,0,0,189000,100000,89000,89000
046061,中石化凱基98購01,0,0,0,0,0,0,0,0,0,89000,0,0,0,103000,14000,89000,89000
057066,緯穎富邦99購01  ,0,0,0,0,0,0,0,0,0,89000,0,0,0,89000,0,89000,89000
3596,智易            ,323000,220000,103000,0,0,0,0,21000,-21000,7000,2000,4000,-2000,32000,23000,9000,89000
059675,大立光元富99購08,0,0,0,0,0,0,0,0,0,88000,0,0,0,237000,149000,88000,88000
059534,國泰金凱基99購01,0,0,0,0,0,0,0,0,0,88000,0,0,0,88000,0,88000,88000
060499,鴻海元大9A購11  ,0,0,0,0,0,0,0,0,0,88000,0,0,0,88000,0,88000,88000
053780,南亞科元大96購03,0,0,0,0,0,0,0,0,0,88000,0,0,0,88000,0,88000,88000
051753,華通元大96購03  ,0,0,0,0,0,0,0,0,0,88000,0,0,0,88000,0,88000,88000
050955,達方群益97購01  ,0,0,0,0,0,0,0,0,0,88000,0,0,0,88000,0,88000,88000
055837,致茂元大97購02  ,0,0,0,0,0,0,0,0,0,88000,0,0,0,88000,0,88000,88000
058256,臺股指元大9A購20,0,0,0,0,0,0,0,0,0,88000,0,0,0,90000,2000,88000,88000
058629,嘉晶國票9A購01  ,0,0,0,0,0,0,0,0,0,88000,0,0,0,88000,0,88000,88000
055747,康舒元富97購01  ,0,0,0,0,0,0,0,0,0,88000,0,0,0,138000,50000,88000,88000
07664P,台灣50元大9C售30,0,0,0,0,0,0,0,0,0,88000,0,0,0,88000,0,88000,88000
060619,玉晶光元大9A購03,0,0,0,0,0,0,0,0,0,87000,0,0,0,90000,3000,87000,87000
061193,玉晶光永豐9B購02,0,0,0,0,0,0,0,0,0,87000,0,0,0,93000,6000,87000,87000
061621,健策群益9A購05  ,0,0,0,0,0,0,0,0,0,87000,0,0,0,89000,2000,87000,87000
053473,聯發科元大96購15,0,0,0,0,0,0,0,0,0,87000,0,0,0,92000,5000,87000,87000
056407,嘉晶國票99購01  ,0,0,0,0,0,0,0,0,0,87000,0,0,0,87000,0,87000,87000
058216,TPK群益99購01   ,0,0,0,0,0,0,0,0,0,87000,0,0,0,163000,76000,87000,87000
057878,台郡元大99購04  ,0,0,0,0,0,0,0,0,0,87000,0,0,0,153000,66000,87000,87000
056264,聯發科統一98購02,0,0,0,0,0,0,0,0,0,87000,0,0,0,87000,0,87000,87000
2481,強茂            ,825000,706000,119000,0,0,0,0,0,0,-32000,0,4000,-4000,4000,32000,-28000,87000
6558,興能高          ,265000,178000,87000,0,0,0,0,0,0,0,0,0,0,0,0,0,87000
5288,豐祥-KY         ,34000,66000,-32000,0,0,0,119000,0,119000,0,0,0,0,0,0,0,87000
061004,友達兆豐9A購01  ,0,0,0,0,0,0,0,0,0,86000,0,0,0,86000,0,86000,86000
060556,緯穎凱基9A購04  ,0,0,0,0,0,0,0,0,0,86000,0,0,0,216000,130000,86000,86000
059751,華通群益9B購03  ,0,0,0,0,0,0,0,0,0,86000,0,0,0,102000,16000,86000,86000
053006,玉晶光永豐96購03,0,0,0,0,0,0,0,0,0,86000,0,0,0,103000,17000,86000,86000
057278,可成元大98購06  ,0,0,0,0,0,0,0,0,0,86000,0,0,0,104000,18000,86000,86000
058995,台達電元大99購01,0,0,0,0,0,0,0,0,0,86000,0,0,0,130000,44000,86000,86000
055509,訊芯元大97購03  ,0,0,0,0,0,0,0,0,0,86000,0,0,0,211000,125000,86000,86000
05565P,鎧勝元大96售01  ,0,0,0,0,0,0,0,0,0,86000,0,0,0,99000,13000,86000,86000
07163P,臺股指群益99售14,0,0,0,0,0,0,0,0,0,86000,0,0,0,149000,63000,86000,86000
07341P,台積電凱基99售18,0,0,0,0,0,0,0,0,0,86000,0,0,0,86000,0,86000,86000
060719,瀚宇博永豐9A購01,0,0,0,0,0,0,0,0,0,85000,0,0,0,87000,2000,85000,85000
060803,台灣50群益9A購13,0,0,0,0,0,0,0,0,0,85000,0,0,0,97000,12000,85000,85000
061249,億豐群益9A購01  ,0,0,0,0,0,0,0,0,0,85000,0,0,0,107000,22000,85000,85000
053955,華通永豐96購04  ,0,0,0,0,0,0,0,0,0,85000,0,0,0,95000,10000,85000,85000
055234,昇陽半國票98購02,0,0,0,0,0,0,0,0,0,85000,0,0,0,85000,0,85000,85000
051843,聯發科富邦99購01,0,0,0,0,0,0,0,0,0,85000,0,0,0,85000,0,85000,85000
051594,和碩元大96購01  ,0,0,0,0,0,0,0,0,0,85000,0,0,0,85000,0,85000,85000
054822,祥碩元大97購01  ,0,0,0,0,0,0,0,0,0,85000,0,0,0,85000,0,85000,85000
058131,義隆元大99購02  ,10000,0,10000,0,0,0,0,0,0,75000,0,0,0,241000,166000,75000,85000
058161,T50反1日盛03購01,0,0,0,0,0,0,0,0,0,85000,0,0,0,145000,60000,85000,85000
057193,力成元大98購02  ,0,0,0,0,0,0,0,0,0,85000,0,0,0,85000,0,85000,85000
059044,聯電日盛99購02  ,0,0,0,0,0,0,0,0,0,85000,0,0,0,85000,0,85000,85000
061349,嘉澤元大9A購02  ,0,0,0,0,0,0,0,0,0,84000,0,0,0,112000,28000,84000,84000
061636,聯發科元大9A購11,0,0,0,0,0,0,0,0,0,84000,0,0,0,100000,16000,84000,84000
060212,華航康和9A購01  ,0,20000,-20000,0,0,0,0,0,0,104000,0,0,0,202000,98000,104000,84000
053754,英業達元富96購02,0,0,0,0,0,0,0,0,0,84000,0,0,0,231000,147000,84000,84000
051635,大立光國票96購04,0,0,0,0,0,0,0,0,0,84000,0,0,0,84000,0,84000,84000
052423,宏達電國票96購02,0,0,0,0,0,0,0,0,0,84000,0,0,0,84000,0,84000,84000
052298,易華電國票96購01,0,0,0,0,0,0,0,0,0,84000,0,0,0,84000,0,84000,84000
057084,立積統一9B購01  ,0,0,0,0,0,0,0,0,0,84000,0,0,0,326000,242000,84000,84000
058547,世紀鋼富邦9A購01,0,0,0,0,0,0,0,0,0,84000,0,0,0,104000,20000,84000,84000
058931,玉晶光統一9C購01,0,0,0,0,0,0,0,0,0,84000,0,0,0,316000,232000,84000,84000
060794,景碩永豐9A購02  ,0,0,0,0,0,0,0,0,0,83000,0,0,0,87000,4000,83000,83000
060721,瑞儀永豐9A購01  ,0,0,0,0,0,0,0,0,0,83000,0,0,0,189000,106000,83000,83000
060331,台積電麥證9A購01,0,0,0,98000,15000,83000,0,0,0,83000,0,0,0,98000,15000,83000,83000
06515P,國巨凱基98售06  ,0,0,0,0,0,0,0,0,0,83000,0,0,0,83000,0,83000,83000
052124,京鼎國票95購01  ,0,0,0,0,0,0,0,0,0,83000,0,0,0,83000,0,83000,83000
049272,世紀鋼元大96購02,0,0,0,0,0,0,0,0,0,83000,0,0,0,121000,38000,83000,83000
054506,矽格永豐96購01  ,0,0,0,0,0,0,0,0,0,83000,0,0,0,188000,105000,83000,83000
055457,聚陽永豐97購01  ,0,0,0,0,0,0,0,0,0,83000,0,0,0,83000,0,83000,83000
058957,貿聯國票9A購01  ,0,0,0,0,0,0,0,0,0,83000,0,0,0,83000,0,83000,83000
057833,聯發科元富02購06,0,0,0,0,0,0,0,0,0,83000,0,0,0,86000,3000,83000,83000
059174,訊芯凱基99購01  ,0,0,0,0,0,0,0,0,0,83000,0,0,0,139000,56000,83000,83000
07402P,瑞昱凱基99售02  ,0,0,0,0,0,0,0,0,0,83000,0,0,0,83000,0,83000,83000
07171P,臺股指國票99售08,0,0,0,0,0,0,0,0,0,83000,0,0,0,148000,65000,83000,83000
07086P,力成元富9C售01  ,0,0,0,0,0,0,0,0,0,83000,0,0,0,83000,0,83000,83000
060248,日月光元大9A購01,0,0,0,0,0,0,0,0,0,82000,0,0,0,103000,21000,82000,82000
053896,麗豐群益97購01  ,0,0,0,0,0,0,0,0,0,82000,0,0,0,149000,67000,82000,82000
052703,貿聯國票97購01  ,0,0,0,0,0,0,0,0,0,82000,0,0,0,82000,0,82000,82000
056314,力成元大97購01  ,0,0,0,0,0,0,0,0,0,82000,0,0,0,124000,42000,82000,82000
1732,毛寶            ,265000,181000,84000,0,0,0,0,0,0,-2000,0,2000,-2000,0,0,0,82000
060010,義隆群益99購02  ,0,0,0,0,0,0,0,0,0,81000,0,0,0,113000,32000,81000,81000
059850,日電貿永豐99購01,0,0,0,0,0,0,0,0,0,81000,0,0,0,81000,0,81000,81000
06036P,台表科凱基96售04,0,0,0,0,0,0,0,0,0,81000,0,0,0,81000,0,81000,81000
061398,力成中信9A購01  ,0,0,0,0,0,0,0,0,0,81000,0,0,0,146000,65000,81000,81000
061416,聯茂群益9A購01  ,0,0,0,0,0,0,0,0,0,81000,0,0,0,270000,189000,81000,81000
061105,宏達電元大9A購04,0,0,0,0,0,0,0,0,0,81000,0,0,0,81000,0,81000,81000
051318,上銀國票96購01  ,0,0,0,0,0,0,0,0,0,81000,0,0,0,81000,0,81000,81000
056709,華通永豐98購01  ,0,0,0,0,0,0,0,0,0,81000,0,0,0,81000,0,81000,81000
3588,通嘉            ,99000,18000,81000,0,0,0,0,0,0,0,0,0,0,0,0,0,81000
060508,聯發科元大9A購04,0,0,0,0,0,0,0,0,0,80000,0,0,0,85000,5000,80000,80000
06044P,同欣電永豐96售03,0,0,0,0,0,0,0,0,0,80000,0,0,0,80000,0,80000,80000
060811,亞德客凱基9A購02,0,0,0,0,0,0,0,0,0,80000,0,0,0,94000,14000,80000,80000
05980P,台積電永昌96售09,0,0,0,0,0,0,0,0,0,80000,0,0,0,190000,110000,80000,80000
060133,牧德群益9B購01  ,0,0,0,0,0,0,0,0,0,80000,0,0,0,86000,6000,80000,80000
053510,聯電群益97購01  ,0,0,0,0,0,0,0,0,0,80000,0,0,0,80000,0,80000,80000
049217,智邦國票95購01  ,0,0,0,0,0,0,0,0,0,80000,0,0,0,80000,0,80000,80000
055289,泰碩元大98購01  ,0,0,0,0,0,0,0,0,0,80000,0,0,0,80000,0,80000,80000
053434,國泰金日盛96購01,0,0,0,0,0,0,0,0,0,80000,0,0,0,80000,0,80000,80000
055069,帆宣永豐97購01  ,0,0,0,0,0,0,0,0,0,80000,0,0,0,80000,0,80000,80000
053271,喬山元大97購01  ,0,0,0,0,0,0,0,0,0,80000,0,0,0,80000,0,80000,80000
054394,奇力新永豐96購03,0,0,0,0,0,0,0,0,0,80000,0,0,0,80000,0,80000,80000
054124,達方永豐96購02  ,0,0,0,0,0,0,0,0,0,80000,0,0,0,80000,0,80000,80000
058244,神達元大99購02  ,0,0,0,0,0,0,0,0,0,80000,0,0,0,185000,105000,80000,80000
055829,上銀元大97購06  ,0,0,0,0,0,0,0,0,0,80000,0,0,0,80000,0,80000,80000
057355,彩晶統一98購03  ,0,0,0,0,0,0,0,0,0,80000,0,0,0,80000,0,80000,80000
059014,SGBR2X元富03購01,0,0,0,0,0,0,0,0,0,80000,0,0,0,80000,0,80000,80000
059198,華新科永豐99購06,0,0,0,0,0,0,0,0,0,80000,0,0,0,80000,0,80000,80000
058702,國巨元大99購16  ,0,0,0,0,0,0,0,0,0,80000,0,0,0,190000,110000,80000,80000
055704,亞德客永豐97購04,0,0,0,0,0,0,0,0,0,80000,0,0,0,126000,46000,80000,80000
058648,聯陽永豐99購01  ,0,0,0,0,0,0,0,0,0,80000,0,0,0,80000,0,80000,80000
07159P,台積電永豐99售04,0,0,0,0,0,0,0,0,0,80000,0,0,0,80000,0,80000,80000
060247,牧德元大9A購02  ,0,0,0,0,0,0,0,0,0,79000,0,0,0,79000,0,79000,79000
060193,群創元富9A購01  ,0,0,0,0,0,0,0,0,0,79000,0,0,0,227000,148000,79000,79000
060387,盛群凱基9A購01  ,0,0,0,0,0,0,0,0,0,79000,0,0,0,139000,60000,79000,79000
055217,緯創凱基97購02  ,0,0,0,0,0,0,0,0,0,79000,0,0,0,109000,30000,79000,79000
058973,麗豐永豐99購01  ,0,0,0,0,0,0,0,0,0,79000,0,0,0,84000,5000,79000,79000
060759,南亞科元大9A購03,0,0,0,0,0,0,0,0,0,78000,0,0,0,79000,1000,78000,78000
060639,玉晶光永豐9A購05,0,0,0,0,0,0,0,0,0,78000,0,0,0,84000,6000,78000,78000
060086,鴻海元大99購42  ,0,0,0,0,0,0,0,0,0,78000,0,0,0,78000,0,78000,78000
061333,華通元大9A購08  ,0,0,0,0,0,0,0,0,0,78000,0,0,0,154000,76000,78000,78000
061648,緯穎元大9A購04  ,0,0,0,0,0,0,0,0,0,78000,0,0,0,87000,9000,78000,78000
054250,漢唐元大96購04  ,0,0,0,0,0,0,0,0,0,78000,0,0,0,78000,0,78000,78000
055861,矽力元大97購03  ,0,0,0,0,0,0,0,0,0,78000,0,0,0,90000,12000,78000,78000
054950,奇力新元大98購02,0,0,0,0,0,0,0,0,0,78000,0,0,0,78000,0,78000,78000
054852,奇鋐國票98購01  ,0,0,0,0,0,0,0,0,0,78000,0,0,0,78000,0,78000,78000
054709,宏達電統一97購01,0,0,0,0,0,0,0,0,0,78000,0,0,0,78000,0,78000,78000
057321,台泥群益98購01  ,0,0,0,0,0,0,0,0,0,78000,0,0,0,80000,2000,78000,78000
056697,緯穎群益98購01  ,0,0,0,0,0,0,0,0,0,78000,0,0,0,88000,10000,78000,78000
05866P,致伸元大96售01  ,0,0,0,0,0,0,0,0,0,78000,0,0,0,78000,0,78000,78000
055572,鴻海統一98購04  ,0,0,0,0,0,0,0,0,0,78000,0,0,0,78000,0,78000,78000
056351,鴻海元大98購06  ,0,0,0,0,0,0,0,0,0,78000,0,0,0,178000,100000,78000,78000
061651,世紀鋼元大9C購02,0,0,0,0,0,0,0,0,0,77000,0,0,0,152000,75000,77000,77000
061266,國泰金凱基9B購01,0,0,0,0,0,0,0,0,0,77000,0,0,0,79000,2000,77000,77000
061456,玉晶光凱基9B購05,0,10000,-10000,0,0,0,0,0,0,87000,0,0,0,166000,79000,87000,77000
061242,玉晶光兆豐9B購02,0,0,0,0,0,0,0,0,0,77000,0,0,0,127000,50000,77000,77000
060899,超眾凱基9A購01  ,0,0,0,0,0,0,0,0,0,77000,0,0,0,93000,16000,77000,77000
054747,麗豐凱基98購01  ,0,0,0,0,0,0,0,0,0,77000,0,0,0,77000,0,77000,77000
053804,富邦金凱基96購01,0,0,0,0,0,0,0,0,0,77000,0,0,0,129000,52000,77000,77000
053294,聯發科中信9C購01,0,0,0,0,0,0,0,0,0,77000,0,0,0,77000,0,77000,77000
056157,聯詠凱基97購03  ,0,0,0,0,0,0,0,0,0,77000,0,0,0,77000,0,77000,77000
057649,嘉聯益元大99購04,0,0,0,0,0,0,0,0,0,77000,0,0,0,97000,20000,77000,77000
057532,智原元大98購03  ,0,0,0,0,0,0,0,0,0,77000,0,0,0,77000,0,77000,77000
059205,元石油元大99購01,0,0,0,0,0,0,0,0,0,77000,0,0,0,101000,24000,77000,77000
07242P,台灣50凱基9A售03,0,0,0,0,0,0,0,0,0,77000,0,0,0,82000,5000,77000,77000
07524P,臺股指中信9B售06,0,0,0,0,0,0,0,0,0,77000,0,0,0,172000,95000,77000,77000
4934,太極            ,214000,137000,77000,0,0,0,0,0,0,0,0,0,0,0,0,0,77000
060786,聯發科富邦9B購06,0,0,0,0,0,0,0,0,0,76000,0,0,0,116000,40000,76000,76000
060766,世芯元大9A購02  ,0,0,0,0,0,0,0,0,0,76000,0,0,0,114000,38000,76000,76000
060685,康友元大9A購01  ,0,0,0,0,0,0,0,0,0,76000,0,0,0,100000,24000,76000,76000
060235,瑞昱元大9A購01  ,0,0,0,0,0,0,0,0,0,76000,0,0,0,152000,76000,76000,76000
059662,旭富元大9C購01  ,0,0,0,0,0,0,0,0,0,76000,0,0,0,210000,134000,76000,76000
061207,美律元大9A購04  ,0,0,0,0,0,0,0,0,0,76000,0,0,0,94000,18000,76000,76000
061304,創意永豐9A購02  ,0,0,0,0,0,0,0,0,0,76000,0,0,0,76000,0,76000,76000
061392,泰鼎群益9A購02  ,0,0,0,0,0,0,0,0,0,76000,0,0,0,186000,110000,76000,76000
061624,中租群益9A購01  ,0,0,0,0,0,0,0,0,0,76000,0,0,0,77000,1000,76000,76000
052903,致茂國票97購01  ,0,0,0,0,0,0,0,0,0,76000,0,0,0,76000,0,76000,76000
058309,大毅元大99購02  ,0,0,0,0,0,0,0,0,0,76000,0,0,0,83000,7000,76000,76000
051460,S&P反1國泰97購01,0,0,0,0,0,0,0,0,0,76000,0,0,0,76000,0,76000,76000
05270P,台表科元大95售05,0,0,0,0,0,0,0,0,0,76000,0,0,0,80000,4000,76000,76000
058403,玉晶光元大99購12,0,0,0,0,0,0,0,0,0,76000,0,0,0,225000,149000,76000,76000
058773,和碩兆豐99購01  ,0,0,0,0,0,0,0,0,0,76000,0,0,0,86000,10000,76000,76000
058780,牧德國票9A購01  ,0,0,0,0,0,0,0,0,0,76000,0,0,0,76000,0,76000,76000
057073,康控永豐98購01  ,0,0,0,0,0,0,0,0,0,76000,0,0,0,76000,0,76000,76000
058907,健策元大99購04  ,0,0,0,0,0,0,0,0,0,76000,0,0,0,104000,28000,76000,76000
058534,友達統一9B購01  ,0,0,0,0,0,0,0,0,0,76000,0,0,0,76000,0,76000,76000
058154,泰碩統一9A購01  ,0,0,0,0,0,0,0,0,0,76000,0,0,0,76000,0,76000,76000
3669,圓展            ,265000,185000,80000,0,0,0,0,0,0,-4000,0,4000,-4000,0,0,0,76000
8081,致新            ,396000,329000,67000,0,0,0,40000,0,40000,-31000,0,56000,-56000,103000,78000,25000,76000
07049P,聯發科中信99售03,0,0,0,0,0,0,0,0,0,76000,0,0,0,300000,224000,76000,76000
060996,臻鼎元大9A購01  ,0,0,0,0,0,0,0,0,0,75000,0,0,0,90000,15000,75000,75000
061069,嘉聯益凱基9A購01,0,0,0,0,0,0,0,0,0,75000,0,0,0,115000,40000,75000,75000
059821,美律凱基99購08  ,0,0,0,0,0,0,0,0,0,75000,0,0,0,85000,10000,75000,75000
060856,健策富邦9B購02  ,0,0,0,0,0,0,0,0,0,75000,0,0,0,296000,221000,75000,75000
058279,FBVIX中信03購03 ,0,0,0,0,0,0,0,0,0,75000,0,0,0,75000,0,75000,75000
055222,臺股指凱基97購05,0,0,0,0,0,0,0,0,0,75000,0,0,0,75000,0,75000,75000
058113,百和元富98購01  ,0,0,0,0,0,0,0,0,0,75000,0,0,0,174000,99000,75000,75000
057941,聯電國票99購01  ,0,0,0,0,0,0,0,0,0,75000,0,0,0,100000,25000,75000,75000
057624,新日興國泰99購01,0,0,0,0,0,0,0,0,0,75000,0,0,0,75000,0,75000,75000
057017,和大凱基98購01  ,0,0,0,0,0,0,0,0,0,75000,0,0,0,120000,45000,75000,75000
057078,國巨統一9A購02  ,0,0,0,0,0,0,0,0,0,75000,0,0,0,75000,0,75000,75000
058790,楠梓電元大99購03,0,0,0,0,0,0,0,0,0,75000,0,0,0,113000,38000,75000,75000
059181,世紀鋼元富9C購01,0,0,0,0,0,0,0,0,0,75000,0,0,0,358000,283000,75000,75000
07646P,世芯元大9A售04  ,0,0,0,0,0,0,0,0,0,75000,0,0,0,157000,82000,75000,75000
060601,技嘉凱基9A購02  ,0,0,0,0,0,0,0,0,0,74000,0,0,0,100000,26000,74000,74000
059791,超眾元大99購06  ,0,0,0,0,0,0,0,0,0,74000,0,0,0,78000,4000,74000,74000
059690,建準永豐99購01  ,0,0,0,0,0,0,0,0,0,74000,0,0,0,74000,0,74000,74000
060202,康友元富9A購01  ,0,0,0,0,0,0,0,0,0,74000,0,0,0,85000,11000,74000,74000
060033,臻鼎永豐99購01  ,0,0,0,0,0,0,0,0,0,74000,0,0,0,288000,214000,74000,74000
061074,儒鴻兆豐9B購01  ,0,0,0,0,0,0,0,0,0,74000,0,0,0,245000,171000,74000,74000
061517,瑞祺永豐9A購03  ,0,0,0,0,0,0,0,0,0,74000,0,0,0,163000,89000,74000,74000
06592P,欣興元大98售04  ,0,0,0,0,0,0,0,0,0,74000,0,0,0,75000,1000,74000,74000
06933P,禾伸堂元大98售03,0,0,0,0,0,0,0,0,0,74000,0,0,0,95000,21000,74000,74000
053806,鎧勝凱基96購02  ,0,0,0,0,0,0,0,0,0,74000,0,0,0,80000,6000,74000,74000
057007,奇力新中信98購04,0,0,0,0,0,0,0,0,0,74000,0,0,0,151000,77000,74000,74000
058877,T50反1國泰9B購01,0,0,0,0,0,0,0,0,0,74000,0,0,0,104000,30000,74000,74000
07089P,臺指2X中信01售01,0,0,0,0,0,0,0,0,0,74000,0,0,0,86000,12000,74000,74000
2453,凌群            ,112000,37000,75000,0,0,0,0,0,0,-1000,0,1000,-1000,0,0,0,74000
06622P,牧德元大98售01  ,0,0,0,0,0,0,0,0,0,73000,0,0,0,123000,50000,73000,73000
061644,健策元大9C購02  ,0,0,0,0,0,0,0,0,0,73000,0,0,0,76000,3000,73000,73000
060072,國巨元富99購04  ,0,0,0,0,0,0,0,0,0,73000,0,0,0,187000,114000,73000,73000
060506,京元電元大9A購02,0,0,0,0,0,0,0,0,0,73000,0,0,0,80000,7000,73000,73000
060578,臺股指中信9C購03,0,0,0,0,0,0,0,0,0,73000,0,0,0,75000,2000,73000,73000
055844,大毅元大98購01  ,0,0,0,0,0,0,0,0,0,73000,0,0,0,73000,0,73000,73000
056308,TPK元大97購02   ,0,0,0,0,0,0,0,0,0,73000,0,0,0,105000,32000,73000,73000
07226P,貿聯富邦9B售01  ,0,0,0,0,0,0,0,0,0,73000,0,0,0,73000,0,73000,73000
060413,東元永豐9A購01  ,0,0,0,0,0,0,0,0,0,72000,0,0,0,99000,27000,72000,72000
060914,健策元大9A購03  ,0,0,0,0,0,0,0,0,0,72000,0,0,0,127000,55000,72000,72000
06653P,美食元大98售02  ,0,0,0,0,0,0,0,0,0,72000,0,0,0,76000,4000,72000,72000
060961,台光電凱基9A購03,0,0,0,0,0,0,0,0,0,72000,0,0,0,117000,45000,72000,72000
054921,文曄凱基97購01  ,0,0,0,0,0,0,0,0,0,72000,0,0,0,72000,0,72000,72000
050892,聯電元大96購02  ,0,0,0,0,0,0,0,0,0,72000,0,0,0,108000,36000,72000,72000
052795,健策兆豐97購01  ,0,0,0,0,0,0,0,0,0,72000,0,0,0,72000,0,72000,72000
057202,TPK元富98購02   ,0,0,0,0,0,0,0,0,0,72000,0,0,0,100000,28000,72000,72000
059514,嘉澤永豐99購02  ,0,0,0,0,0,0,0,0,0,72000,0,0,0,91000,19000,72000,72000
05817P,可成凱基96售07  ,0,0,0,0,0,0,0,0,0,72000,0,0,0,72000,0,72000,72000
061498,大立光國票9A購10,0,0,0,0,0,0,0,0,0,71000,0,0,0,152000,81000,71000,71000
061247,玉晶光群益9A購09,0,0,0,0,0,0,0,0,0,71000,0,0,0,107000,36000,71000,71000
06167P,欣興國票97售05  ,0,0,0,0,0,0,0,0,0,71000,0,0,0,83000,12000,71000,71000
060625,華擎元大9A購01  ,0,0,0,0,0,0,0,0,0,71000,0,0,0,71000,0,71000,71000
055335,健策兆豐98購01  ,0,0,0,0,0,0,0,0,0,71000,0,0,0,71000,0,71000,71000
056786,亞光群益98購03  ,0,0,0,0,0,0,0,0,0,71000,0,0,0,156000,85000,71000,71000
059015,華通元富99購02  ,0,0,0,0,0,0,0,0,0,71000,0,0,0,72000,1000,71000,71000
057141,嘉聯益兆豐99購01,0,0,0,0,0,0,0,0,0,71000,0,0,0,71000,0,71000,71000
057471,昇陽半永豐98購02,0,0,0,0,0,0,0,0,0,71000,0,0,0,71000,0,71000,71000
059998,華航元富99購02  ,0,0,0,0,0,0,0,0,0,70000,0,0,0,70000,0,70000,70000
06185P,台表科元大97售05,0,0,0,0,0,0,0,0,0,70000,0,0,0,70000,0,70000,70000
061518,達方永豐9A購02  ,0,0,0,0,0,0,0,0,0,70000,0,0,0,90000,20000,70000,70000
054189,貿聯永豐96購03  ,0,0,0,0,0,0,0,0,0,70000,0,0,0,70000,0,70000,70000
054339,聯詠統一96購02  ,0,0,0,0,0,0,0,0,0,70000,0,0,0,70000,0,70000,70000
055442,矽創國票98購02  ,0,0,0,0,0,0,0,0,0,70000,0,0,0,70000,0,70000,70000
055400,緯穎統一97購01  ,0,0,0,0,0,0,0,0,0,70000,0,0,0,70000,0,70000,70000
053892,景碩群益96購02  ,0,0,0,0,0,0,0,0,0,70000,0,0,0,164000,94000,70000,70000
055015,帆宣元富97購01  ,0,0,0,0,0,0,0,0,0,70000,0,0,0,80000,10000,70000,70000
052865,大立光凱基96購11,0,0,0,0,0,0,0,0,0,70000,0,0,0,70000,0,70000,70000
052699,友達國票97購01  ,0,0,0,0,0,0,0,0,0,70000,0,0,0,70000,0,70000,70000
051406,泰鼎永豐96購01  ,0,0,0,0,0,0,0,0,0,70000,0,0,0,70000,0,70000,70000
052581,訊芯元富98購01  ,0,0,0,0,0,0,0,0,0,70000,0,0,0,80000,10000,70000,70000
04706P,力山元大95售01  ,0,0,0,0,0,0,0,0,0,70000,0,0,0,70000,0,70000,70000
057451,大立光元富9B購01,0,0,0,0,0,0,0,0,0,70000,0,0,0,212000,142000,70000,70000
057423,台郡凱基98購06  ,0,0,0,0,0,0,0,0,0,70000,0,0,0,90000,20000,70000,70000
057183,玉晶光元大99購07,0,0,0,0,0,0,0,0,0,70000,0,0,0,70000,0,70000,70000
05924P,超眾元富96售04  ,0,0,0,0,0,0,0,0,0,70000,0,0,0,70000,0,70000,70000
058146,勤誠元大99購01  ,0,0,0,0,0,0,0,0,0,70000,0,0,0,120000,50000,70000,70000
055934,景碩群益98購03  ,0,0,0,0,0,0,0,0,0,70000,0,0,0,72000,2000,70000,70000
058033,景碩永豐98購02  ,0,0,0,0,0,0,0,0,0,70000,0,0,0,120000,50000,70000,70000
058676,聯茂群益99購01  ,0,0,0,0,0,0,0,0,0,70000,0,0,0,70000,0,70000,70000
057731,華擎國泰9A購02  ,0,0,0,0,0,0,0,0,0,70000,0,0,0,225000,155000,70000,70000
07468P,聯電元大9A售02  ,0,0,0,0,0,0,0,0,0,70000,0,0,0,70000,0,70000,70000
061110,超眾元大9A購03  ,0,0,0,0,0,0,0,0,0,69000,0,0,0,82000,13000,69000,69000
060203,緯穎元富9A購01  ,0,0,0,0,0,0,0,0,0,69000,0,0,0,432000,363000,69000,69000
060876,國巨中信9A購04  ,0,0,0,0,0,0,0,0,0,69000,0,0,0,79000,10000,69000,69000
03658C,T50反1元大9A牛02,0,0,0,0,0,0,0,0,0,69000,0,0,0,69000,0,69000,69000
052837,友達國泰97購01  ,0,0,0,0,0,0,0,0,0,69000,0,0,0,69000,0,69000,69000
057987,大立光元富98購02,0,0,0,0,0,0,0,0,0,69000,0,0,0,744000,675000,69000,69000
055785,祥碩凱基97購02  ,0,0,0,0,0,0,0,0,0,69000,0,0,0,109000,40000,69000,69000
055992,智原台新97購02  ,0,0,0,0,0,0,0,0,0,69000,0,0,0,69000,0,69000,69000
057915,台泥凱基98購01  ,0,0,0,0,0,0,0,0,0,69000,0,0,0,84000,15000,69000,69000
059469,智邦元大99購03  ,0,0,0,0,0,0,0,0,0,69000,0,0,0,103000,34000,69000,69000
057543,華通凱基99購02  ,0,0,0,0,0,0,0,0,0,69000,0,0,0,69000,0,69000,69000
07531P,大立光國泰9B售03,0,0,0,0,0,0,0,0,0,69000,0,0,0,329000,260000,69000,69000
060598,鴻海凱基9A購20  ,0,0,0,0,0,0,0,0,0,68000,0,0,0,68000,0,68000,68000
060307,南港永豐9A購01  ,0,0,0,0,0,0,0,0,0,68000,0,0,0,299000,231000,68000,68000
061083,京元電兆豐9A購01,0,0,0,0,0,0,0,0,0,68000,0,0,0,68000,0,68000,68000
061131,崇越永豐9A購01  ,0,0,0,0,0,0,0,0,0,68000,0,0,0,68000,0,68000,68000
061337,台積電元大9A購27,0,0,0,0,0,0,0,0,0,68000,0,0,0,68000,0,68000,68000
054245,鴻海元大96購23  ,0,0,0,0,0,0,0,0,0,68000,0,0,0,68000,0,68000,68000
054261,智伸科元大96購03,0,0,0,0,0,0,0,0,0,68000,0,0,0,68000,0,68000,68000
054523,GIS元大96購05   ,0,0,0,0,0,0,0,0,0,68000,0,0,0,68000,0,68000,68000
053836,亞光永豐96購02  ,0,0,0,0,0,0,0,0,0,68000,0,0,0,68000,0,68000,68000
055288,日電貿元大97購02,0,0,0,0,0,0,0,0,0,68000,0,0,0,83000,15000,68000,68000
055297,啟碁元大97購01  ,0,0,0,0,0,0,0,0,0,68000,0,0,0,68000,0,68000,68000
00706L,元大S&P日圓正2  ,0,0,0,0,0,0,0,0,0,68000,0,0,0,169000,101000,68000,68000
05267P,欣興元大95售08  ,0,0,0,0,0,0,0,0,0,68000,0,0,0,68000,0,68000,68000
053598,日月光元大96購04,0,0,0,0,0,0,0,0,0,68000,0,0,0,68000,0,68000,68000
054844,華邦電兆豐98購01,0,0,0,0,0,0,0,0,0,68000,0,0,0,68000,0,68000,68000
057484,南亞科元大98購06,0,0,0,0,0,0,0,0,0,68000,0,0,0,68000,0,68000,68000
059458,鎧勝永豐99購01  ,0,0,0,0,0,0,0,0,0,68000,0,0,0,68000,0,68000,68000
059287,華通元富99購03  ,0,0,0,0,0,0,0,0,0,68000,0,0,0,73000,5000,68000,68000
059121,瑞儀永豐99購01  ,0,0,0,0,0,0,0,0,0,68000,0,0,0,95000,27000,68000,68000
057642,南亞科元大98購07,0,0,0,0,0,0,0,0,0,68000,0,0,0,68000,0,68000,68000
058512,宏達電元大99購04,0,0,0,0,0,0,0,0,0,68000,0,0,0,68000,0,68000,68000
058111,健鼎元富98購01  ,0,0,0,0,0,0,0,0,0,68000,0,0,0,118000,50000,68000,68000
058592,聯發科統一9C購01,0,0,0,0,0,0,0,0,0,68000,0,0,0,68000,0,68000,68000
057698,奇力新群益98購02,0,0,0,0,0,0,0,0,0,68000,0,0,0,180000,112000,68000,68000
055795,茂林國泰98購01  ,0,0,0,0,0,0,0,0,0,68000,0,0,0,78000,10000,68000,68000
08525P,台灣50凱基96售02,0,0,0,0,0,0,0,0,0,68000,0,0,0,68000,0,68000,68000
061443,大立光統一9C購02,0,0,0,0,0,0,0,0,0,67000,0,0,0,80000,13000,67000,67000
061017,國泰金麥證9A購01,0,0,0,67000,0,67000,0,0,0,67000,0,0,0,67000,0,67000,67000
060420,神基永豐9A購01  ,0,0,0,0,0,0,0,0,0,67000,0,0,0,77000,10000,67000,67000
052447,聯發科元大96購04,0,0,0,0,0,0,0,0,0,67000,0,0,0,75000,8000,67000,67000
052230,大立光凱基96購09,0,0,0,0,0,0,0,0,0,67000,0,0,0,75000,8000,67000,67000
053426,創意永豐96購04  ,0,0,0,0,0,0,0,0,0,67000,0,0,0,67000,0,67000,67000
053460,緯穎國泰97購01  ,0,0,0,0,0,0,0,0,0,67000,0,0,0,67000,0,67000,67000
054300,華通凱基96購07  ,0,0,0,0,0,0,0,0,0,67000,0,0,0,77000,10000,67000,67000
055490,台光電元大97購01,0,0,0,0,0,0,0,0,0,67000,0,0,0,67000,0,67000,67000
055533,大立光群益97購03,0,0,0,0,0,0,0,0,0,67000,0,0,0,67000,0,67000,67000
058682,聯發科凱基99購07,0,0,0,0,0,0,0,0,0,67000,0,0,0,67000,0,67000,67000
059397,T50反1元富99購05,50000,0,50000,0,0,0,0,0,0,17000,0,0,0,77000,60000,17000,67000
057509,聯發科統一9A購03,0,0,0,0,0,0,0,0,0,67000,0,0,0,67000,0,67000,67000
08714P,華碩元富01售03  ,0,0,0,0,0,0,0,0,0,67000,0,0,0,67000,0,67000,67000
4935,茂林-KY         ,244754,181000,63754,0,0,0,30000,2000,28000,-25000,42000,10000,32000,3000,60000,-57000,66754
061040,康友永豐9A購01  ,0,0,0,0,0,0,0,0,0,66000,0,0,0,66000,0,66000,66000
061033,台光電永豐9A購01,0,0,0,0,0,0,0,0,0,66000,0,0,0,285000,219000,66000,66000
060956,超眾群益9A購01  ,0,0,0,0,0,0,0,0,0,66000,0,0,0,66000,0,66000,66000
061188,大成鋼富邦9B購01,0,0,0,0,0,0,0,0,0,66000,0,0,0,1173000,1107000,66000,66000
061370,晶技國泰9C購01  ,0,0,0,0,0,0,0,0,0,66000,0,0,0,182000,116000,66000,66000
061263,微星凱基9A購01  ,0,0,0,0,0,0,0,0,0,66000,0,0,0,66000,0,66000,66000
052362,瑞昱國票96購02  ,0,0,0,0,0,0,0,0,0,66000,0,0,0,66000,0,66000,66000
057697,國巨群益98購09  ,0,0,0,0,0,0,0,0,0,66000,0,0,0,66000,0,66000,66000
07197P,臺股指元大99售13,0,0,0,0,0,0,0,0,0,66000,0,0,0,66000,0,66000,66000
061534,聯發科統一9C購04,0,0,0,0,0,0,0,0,0,65000,0,0,0,72000,7000,65000,65000
061036,晶技永豐9A購03  ,0,0,0,0,0,0,0,0,0,65000,0,0,0,81000,16000,65000,65000
060472,中租元大9A購02  ,0,0,0,0,0,0,0,0,0,65000,0,0,0,100000,35000,65000,65000
049439,牧德國泰96購01  ,0,0,0,0,0,0,0,0,0,65000,0,0,0,75000,10000,65000,65000
050515,聯電元大96購01  ,0,0,0,0,0,0,0,0,0,65000,0,0,0,65000,0,65000,65000
051089,旺宏元大96購04  ,0,0,0,0,0,0,0,0,0,65000,0,0,0,71000,6000,65000,65000
050651,大立光凱基96購02,0,0,0,0,0,0,0,0,0,65000,0,0,0,65000,0,65000,65000
055693,南茂凱基97購01  ,0,0,0,0,0,0,0,0,0,65000,0,0,0,100000,35000,65000,65000
060243,潤泰全元大9C購02,0,0,0,0,0,0,0,0,0,64000,0,0,0,307000,243000,64000,64000
061178,晶技凱基9B購01  ,0,0,0,0,0,0,0,0,0,64000,0,0,0,74000,10000,64000,64000
052742,可成元大96購01  ,0,0,0,0,0,0,0,0,0,64000,0,0,0,69000,5000,64000,64000
051382,玉晶光群益98購02,0,0,0,0,0,0,0,0,0,64000,0,0,0,153000,89000,64000,64000
052452,茂林元大95購03  ,0,0,0,0,0,0,0,0,0,64000,0,0,0,64000,0,64000,64000
057954,宏碁元大99購01  ,0,0,0,0,0,0,0,0,0,64000,0,0,0,101000,37000,64000,64000
058027,鴻海富邦98購04  ,0,0,0,0,0,0,0,0,0,64000,0,0,0,64000,0,64000,64000
058135,景碩元大99購01  ,0,0,0,0,0,0,0,0,0,64000,0,0,0,97000,33000,64000,64000
058750,緯穎凱基9A購03  ,0,0,0,0,0,0,0,0,0,64000,0,0,0,69000,5000,64000,64000
059288,旺宏元富99購03  ,0,0,0,0,0,0,0,0,0,64000,0,0,0,96000,32000,64000,64000
056319,智原群益98購02  ,0,0,0,0,0,0,0,0,0,64000,0,0,0,64000,0,64000,64000
07100P,華航元大99售01  ,0,0,0,0,0,0,0,0,0,64000,0,0,0,85000,21000,64000,64000
07106P,國巨統一9B售05  ,0,0,0,0,0,0,0,0,0,64000,0,0,0,107000,43000,64000,64000
061232,和大元大9A購03  ,0,0,0,0,0,0,0,0,0,63000,0,0,0,163000,100000,63000,63000
06230P,亞德客永豐97售03,0,0,0,0,0,0,0,0,0,63000,0,0,0,73000,10000,63000,63000
061638,國泰金元大9A購03,0,0,0,0,0,0,0,0,0,63000,0,0,0,63000,0,63000,63000
05994P,奇鋐元大96售02  ,0,0,0,0,0,0,0,0,0,63000,0,0,0,158000,95000,63000,63000
060866,世芯永豐9B購01  ,0,0,0,0,0,0,0,0,0,63000,0,0,0,63000,0,63000,63000
054148,矽創元大96購03  ,0,0,0,0,0,0,0,0,0,63000,0,0,0,163000,100000,63000,63000
054682,東元永豐97購01  ,0,0,0,0,0,0,0,0,0,63000,0,0,0,63000,0,63000,63000
054634,FB上証中信99購01,0,0,0,0,0,0,0,0,0,63000,0,0,0,86000,23000,63000,63000
053913,華新國票97購01  ,0,0,0,0,0,0,0,0,0,63000,0,0,0,63000,0,63000,63000
052069,聯茂兆豐96購01  ,0,0,0,0,0,0,0,0,0,63000,0,0,0,94000,31000,63000,63000
051979,群創凱基97購01  ,0,0,0,0,0,0,0,0,0,63000,0,0,0,63000,0,63000,63000
050392,群創統一96購01  ,0,0,0,0,0,0,0,0,0,63000,0,0,0,63000,0,63000,63000
059101,康控統一9A購01  ,0,0,0,0,0,0,0,0,0,63000,0,0,0,433000,370000,63000,63000
05719P,可成元大96售03  ,0,0,0,0,0,0,0,0,0,63000,0,0,0,63000,0,63000,63000
059516,TPK永豐99購01   ,0,0,0,0,0,0,0,0,0,63000,0,0,0,101000,38000,63000,63000
057569,光磊永豐98購03  ,0,0,0,0,0,0,0,0,0,63000,0,0,0,68000,5000,63000,63000
057109,信邦群益98購01  ,0,0,0,0,0,0,0,0,0,63000,0,0,0,100000,37000,63000,63000
056084,漢唐統一97購03  ,0,0,0,0,0,0,0,0,0,63000,0,0,0,63000,0,63000,63000
058523,聯茂元大99購08  ,0,0,0,0,0,0,0,0,0,63000,0,0,0,68000,5000,63000,63000
055536,嘉聯益群益99購02,0,0,0,0,0,0,0,0,0,63000,0,0,0,64000,1000,63000,63000
07455P,聯發科元大9A售01,0,0,0,0,0,0,0,0,0,63000,0,0,0,69000,6000,63000,63000
07799P,南電國票9A售04  ,0,0,0,0,0,0,0,0,0,63000,0,0,0,63000,0,63000,63000
08674P,嘉晶元富07售02  ,0,0,0,0,0,0,0,0,0,63000,0,0,0,63000,0,63000,63000
6416,瑞祺電通        ,146000,93000,53000,0,0,0,0,0,0,10000,69000,54000,15000,18000,23000,-5000,63000
060245,聯陽元大9C購01  ,0,0,0,0,0,0,0,0,0,62000,0,0,0,62000,0,62000,62000
060156,光磊永豐9A購01  ,0,0,0,0,0,0,0,0,0,62000,0,0,0,70000,8000,62000,62000
06632P,創意群益98售03  ,0,0,0,0,0,0,0,0,0,62000,0,0,0,100000,38000,62000,62000
060967,鈺齊凱基9A購02  ,0,0,0,0,0,0,0,0,0,62000,0,0,0,127000,65000,62000,62000
061453,台達電凱基9B購01,0,0,0,0,0,0,0,0,0,62000,0,0,0,107000,45000,62000,62000
053568,智伸科富邦98購01,0,0,0,0,0,0,0,0,0,62000,0,0,0,62000,0,62000,62000
03657C,T50反1元大99牛01,0,0,0,0,0,0,0,0,0,62000,0,0,0,158000,96000,62000,62000
046937,聯電元大99購01  ,0,0,0,0,0,0,0,0,0,62000,0,0,0,80000,18000,62000,62000
055623,貿聯國泰99購01  ,0,0,0,0,0,0,0,0,0,62000,0,0,0,107000,45000,62000,62000
2471,資通            ,175000,113000,62000,0,0,0,0,0,0,0,0,0,0,0,0,0,62000
07060P,台表科國票9A售01,0,0,0,0,0,0,0,0,0,62000,0,0,0,127000,65000,62000,62000
061415,健策群益9A購04  ,0,0,0,0,0,0,0,0,0,61000,0,0,0,61000,0,61000,61000
061533,友達統一9C購02  ,0,0,0,0,0,0,0,0,0,61000,0,0,0,93000,32000,61000,61000
061626,超眾群益9A購02  ,0,0,0,0,0,0,0,0,0,61000,0,0,0,79000,18000,61000,61000
061583,矽創元大9A購01  ,0,0,0,0,0,0,0,0,0,61000,0,0,0,191000,130000,61000,61000
061573,義隆元大9A購02  ,0,0,0,0,0,0,0,0,0,61000,0,0,0,78000,17000,61000,61000
059673,玉山金元富99購01,0,0,0,0,0,0,0,0,0,61000,0,0,0,73000,12000,61000,61000
059537,大立光凱基99購09,0,0,0,0,0,0,0,0,0,61000,0,0,0,105000,44000,61000,61000
059825,嘉晶凱基99購02  ,0,0,0,0,0,0,0,0,0,61000,0,0,0,71000,10000,61000,61000
060620,玉晶光元大9A購04,0,0,0,0,0,0,0,0,0,61000,0,0,0,69000,8000,61000,61000
060476,瑞祺元大9A購02  ,0,0,0,0,0,0,0,0,0,61000,0,0,0,131000,70000,61000,61000
053219,祥碩凱基96購01  ,0,0,0,0,0,0,0,0,0,61000,0,0,0,65000,4000,61000,61000
054530,台光電國泰97購03,0,0,0,0,0,0,0,0,0,61000,0,0,0,61000,0,61000,61000
058427,大毅元富99購01  ,0,0,0,0,0,0,0,0,0,61000,0,0,0,71000,10000,61000,61000
059454,亞光永豐99購01  ,0,0,0,0,0,0,0,0,0,61000,0,0,0,61000,0,61000,61000
059361,玉晶光永豐99購04,0,0,0,0,0,0,0,0,0,61000,0,0,0,62000,1000,61000,61000
059283,康友永豐99購02  ,0,0,0,0,0,0,0,0,0,61000,0,0,0,66000,5000,61000,61000
07212P,聯發科凱基99售14,0,0,0,0,0,0,0,0,0,61000,0,0,0,61000,0,61000,61000
3705,永信            ,159000,98000,61000,0,0,0,0,0,0,0,0,0,0,0,0,0,61000
060279,SP黃豆元大9A購01,0,0,0,0,0,0,0,0,0,60000,0,0,0,70000,10000,60000,60000
060863,聯發科永豐9A購02,0,0,0,0,0,0,0,0,0,60000,0,0,0,74000,14000,60000,60000
060184,建準元富9A購01  ,0,0,0,0,0,0,0,0,0,60000,0,0,0,60000,0,60000,60000
06270P,致伸凱基97售03  ,0,0,0,0,0,0,0,0,0,60000,0,0,0,60000,0,60000,60000
06668P,祥碩凱基98售02  ,0,0,0,0,0,0,0,0,0,60000,0,0,0,132000,72000,60000,60000
060930,超眾永豐9A購03  ,0,0,0,0,0,0,0,0,0,60000,0,0,0,60000,0,60000,60000
061047,大立光第一9A購01,0,0,0,0,0,0,0,0,0,60000,0,0,0,60000,0,60000,60000
061146,台表科中信9A購02,0,0,0,0,0,0,0,0,0,60000,0,0,0,60000,0,60000,60000
056834,華新元富99購01  ,0,0,0,0,0,0,0,0,0,60000,0,0,0,60000,0,60000,60000
055835,華邦電元大97購03,0,0,0,0,0,0,0,0,0,60000,0,0,0,60000,0,60000,60000
053159,同欣電元大96購02,0,0,0,0,0,0,0,0,0,60000,0,0,0,60000,0,60000,60000
053186,健策中信9C購01  ,0,0,0,0,0,0,0,0,0,60000,0,0,0,94000,34000,60000,60000
053889,致茂群益97購01  ,0,0,0,0,0,0,0,0,0,60000,0,0,0,60000,0,60000,60000
046630,京元電元富95購03,0,0,0,0,0,0,0,0,0,60000,0,0,0,100000,40000,60000,60000
048682,奇力新富邦96購01,0,0,0,0,0,0,0,0,0,60000,0,0,0,60000,0,60000,60000
050551,大立光凱基95購05,0,0,0,0,0,0,0,0,0,60000,0,0,0,60000,0,60000,60000
051643,瑞昱康和95購01  ,0,0,0,0,0,0,0,0,0,60000,0,0,0,60000,0,60000,60000
056983,大立光群益99購02,0,0,0,0,0,0,0,0,0,60000,0,0,0,60000,0,60000,60000
057704,台虹群益98購03  ,0,0,0,0,0,0,0,0,0,60000,0,0,0,270000,210000,60000,60000
056996,矽力日盛99購01  ,0,0,0,0,0,0,0,0,0,60000,0,0,0,408000,348000,60000,60000
058570,臻鼎凱基9A購01  ,0,0,0,0,0,0,0,0,0,60000,0,0,0,60000,0,60000,60000
057894,華通元富02購02  ,0,0,0,0,0,0,0,0,0,60000,0,0,0,128000,68000,60000,60000
056948,旺宏統一9A購01  ,0,0,0,0,0,0,0,0,0,60000,0,0,0,60000,0,60000,60000
056003,智伸科永豐97購02,0,0,0,0,0,0,0,0,0,60000,0,0,0,60000,0,60000,60000
058549,藍天永豐99購01  ,0,0,0,0,0,0,0,0,0,60000,0,0,0,70000,10000,60000,60000
07490P,大立光國票9A售03,0,0,0,0,0,0,0,0,0,60000,0,0,0,60000,0,60000,60000
061237,晶技元大9A購01  ,0,0,0,0,0,0,0,0,0,59000,0,0,0,69000,10000,59000,59000
061024,南電國泰9B購01  ,0,0,0,0,0,0,0,0,0,59000,0,0,0,95000,36000,59000,59000
061520,健策中信9A購01  ,0,0,0,0,0,0,0,0,0,59000,0,0,0,69000,10000,59000,59000
061640,智原元大9A購01  ,0,0,0,0,0,0,0,0,0,59000,0,0,0,78000,19000,59000,59000
060095,聯發科元大99購42,0,0,0,0,0,0,0,0,0,59000,0,0,0,61000,2000,59000,59000
059930,健策富邦9B購01  ,0,0,0,0,0,0,0,0,0,59000,0,0,0,59000,0,59000,59000
059863,和大凱基99購01  ,0,0,0,0,0,0,0,0,0,59000,0,0,0,59000,0,59000,59000
059525,上銀凱基99購08  ,0,0,0,0,0,0,0,0,0,59000,0,0,0,59000,0,59000,59000
060581,玉晶光群益9B購02,0,0,0,0,0,0,0,0,0,59000,0,0,0,76000,17000,59000,59000
051503,玉晶光統一97購01,0,0,0,0,0,0,0,0,0,59000,0,0,0,91000,32000,59000,59000
051319,光磊國票96購02  ,0,0,0,0,0,0,0,0,0,59000,0,0,0,108000,49000,59000,59000
05206P,南茂元大95售01  ,0,0,0,0,0,0,0,0,0,59000,0,0,0,59000,0,59000,59000
052602,聯電元大97購01  ,0,0,0,0,0,0,0,0,0,59000,0,0,0,59000,0,59000,59000
053958,京元電永豐96購01,0,0,0,0,0,0,0,0,0,59000,0,0,0,59000,0,59000,59000
057893,亞德客元富98購03,0,0,0,0,0,0,0,0,0,59000,0,0,0,59000,0,59000,59000
056214,義隆國票99購01  ,0,0,0,0,0,0,0,0,0,59000,0,0,0,124000,65000,59000,59000
059022,聯發科統一9B購04,0,0,0,0,0,0,0,0,0,59000,0,0,0,59000,0,59000,59000
058768,南港兆豐99購01  ,0,0,0,0,0,0,0,0,0,59000,0,0,0,134000,75000,59000,59000
07200P,臺股指元大99售16,0,0,0,0,0,0,0,0,0,59000,0,0,0,60000,1000,59000,59000
07134P,臺股指元大9A售28,0,0,0,0,0,0,0,0,0,59000,0,0,0,69000,10000,59000,59000
3003,健和興          ,215000,153000,62000,0,0,0,0,0,0,-3000,0,2000,-2000,0,1000,-1000,59000
060489,世紀鋼群益9A購01,0,0,0,0,0,0,0,0,0,58000,0,0,0,59000,1000,58000,58000
060610,玉晶光凱基9B購02,0,0,0,0,0,0,0,0,0,58000,0,0,0,87000,29000,58000,58000
060676,京元電元大9A購03,0,0,0,0,0,0,0,0,0,58000,0,0,0,68000,10000,58000,58000
06938P,南電元大98售03  ,0,0,0,0,0,0,0,0,0,58000,0,0,0,70000,12000,58000,58000
061437,燿華凱基9A購01  ,0,0,0,0,0,0,0,0,0,58000,0,0,0,137000,79000,58000,58000
061289,玉晶光統一01購03,0,0,0,0,0,0,0,0,0,58000,0,0,0,63000,5000,58000,58000
06135P,志超元富97售01  ,0,0,0,0,0,0,0,0,0,58000,0,0,0,68000,10000,58000,58000
054003,鴻海統一96購13  ,0,0,0,0,0,0,0,0,0,58000,0,0,0,58000,0,58000,58000
05310P,智原永豐95售04  ,0,0,0,0,0,0,0,0,0,58000,0,0,0,58000,0,58000,58000
054111,緯穎凱基97購01  ,0,0,0,0,0,0,0,0,0,58000,0,0,0,58000,0,58000,58000
054316,矽創凱基97購01  ,0,0,0,0,0,0,0,0,0,58000,0,0,0,108000,50000,58000,58000
052654,友達統一97購01  ,0,0,0,0,0,0,0,0,0,58000,0,0,0,58000,0,58000,58000
057081,大立光統一98購07,0,0,0,0,0,0,0,0,0,58000,0,0,0,58000,0,58000,58000
056652,上証反元大9B購01,0,0,0,0,0,0,0,0,0,58000,0,0,0,58000,0,58000,58000
059515,牧德永豐99購01  ,0,0,0,0,0,0,0,0,0,58000,0,0,0,62000,4000,58000,58000
07796P,聯發科國票9A售03,0,0,0,0,0,0,0,0,0,58000,0,0,0,58000,0,58000,58000
061482,健策元大9C購01  ,0,0,0,0,0,0,0,0,0,57000,0,0,0,62000,5000,57000,57000
060944,國泰金國票9A購01,0,0,0,0,0,0,0,0,0,57000,0,0,0,120000,63000,57000,57000
06890P,金融類元大98售02,0,0,0,0,0,0,0,0,0,57000,0,0,0,69000,12000,57000,57000
060826,牧德元大9B購02  ,0,0,0,0,0,0,0,0,0,57000,0,0,0,200000,143000,57000,57000
060305,得力永豐9A購01  ,0,0,0,0,0,0,0,0,0,57000,0,0,0,60000,3000,57000,57000
059655,T50反1元大99購10,0,0,0,0,0,0,0,0,0,57000,0,0,0,57000,0,57000,57000
060238,強茂元大9C購01  ,0,0,0,0,0,0,0,0,0,57000,0,0,0,95000,38000,57000,57000
053537,玉晶光永豐98購02,0,0,0,0,0,0,0,0,0,57000,0,0,0,57000,0,57000,57000
054843,中環兆豐97購01  ,0,0,0,0,0,0,0,0,0,57000,0,0,0,99000,42000,57000,57000
054540,泰鼎國票99購01  ,0,0,0,0,0,0,0,0,0,57000,0,0,0,77000,20000,57000,57000
054477,聯發科中信9C購02,0,0,0,0,0,0,0,0,0,57000,0,0,0,57000,0,57000,57000
056821,日電貿永豐98購01,0,0,0,0,0,0,0,0,0,57000,0,0,0,67000,10000,57000,57000
059319,台光電元大99購04,0,0,0,0,0,0,0,0,0,57000,0,0,0,80000,23000,57000,57000
057150,貿聯國票99購02  ,0,0,0,0,0,0,0,0,0,57000,0,0,0,139000,82000,57000,57000
056274,彩晶統一98購02  ,0,0,0,0,0,0,0,0,0,57000,0,0,0,57000,0,57000,57000
056614,智邦永豐98購01  ,0,0,0,0,0,0,0,0,0,57000,0,0,0,58000,1000,57000,57000
058688,矽創凱基9A購01  ,0,0,0,0,0,0,0,0,0,57000,0,0,0,82000,25000,57000,57000
07014P,華通元大99售04  ,0,0,0,0,0,0,0,0,0,57000,0,0,0,69000,12000,57000,57000
07418P,聯發科元大99售45,0,0,0,0,0,0,0,0,0,57000,0,0,0,57000,0,57000,57000
07305P,T50正2群益99售02,0,0,0,0,0,0,0,0,0,57000,0,0,0,60000,3000,57000,57000
3530,晶相光          ,315000,217000,98000,0,0,0,0,0,0,-41000,0,40000,-40000,9000,10000,-1000,57000
059688,燿華永豐99購01  ,0,0,0,0,0,0,0,0,0,56000,0,0,0,75000,19000,56000,56000
060627,國巨國泰9B購05  ,0,0,0,0,0,0,0,0,0,56000,0,0,0,60000,4000,56000,56000
061596,健策永豐9A購03  ,0,0,0,0,0,0,0,0,0,56000,0,0,0,58000,2000,56000,56000
06434P,超眾群益98售02  ,0,0,0,0,0,0,0,0,0,56000,0,0,0,90000,34000,56000,56000
061431,鈺齊元大9A購01  ,0,0,0,0,0,0,0,0,0,56000,0,0,0,81000,25000,56000,56000
054007,貿聯統一96購01  ,0,0,0,0,0,0,0,0,0,56000,0,0,0,56000,0,56000,56000
050385,貿聯國票95購02  ,0,0,0,0,0,0,0,0,0,56000,0,0,0,56000,0,56000,56000
058704,台積電元大99購17,0,0,0,0,0,0,0,0,0,56000,0,0,0,72000,16000,56000,56000
058438,大立光統一9B購01,0,0,0,0,0,0,0,0,0,56000,0,0,0,56000,0,56000,56000
058409,鴻海兆豐99購05  ,0,0,0,0,0,0,0,0,0,56000,0,0,0,73000,17000,56000,56000
057736,鴻海富邦99購04  ,0,0,0,0,0,0,0,0,0,56000,0,0,0,56000,0,56000,56000
058692,華邦電國票9B購01,0,0,0,0,0,0,0,0,0,56000,0,0,0,305000,249000,56000,56000
5305,敦南            ,123000,63000,60000,0,0,0,0,0,0,-4000,0,4000,-4000,0,0,0,56000
07670P,茂林元大9A售02  ,0,0,0,0,0,0,0,0,0,56000,0,0,0,100000,44000,56000,56000
07509P,牧德國票9A售03  ,0,0,0,0,0,0,0,0,0,56000,0,0,0,56000,0,56000,56000
060994,世芯元大9A購03  ,0,0,0,0,0,0,0,0,0,55000,0,0,0,68000,13000,55000,55000
060913,宏達電元大9A購03,0,0,0,0,0,0,0,0,0,55000,0,0,0,55000,0,55000,55000
06081P,深中小元大97售02,0,0,0,0,0,0,0,0,0,55000,0,0,0,130000,75000,55000,55000
060257,臺股指元大9B購08,0,0,0,0,0,0,0,0,0,55000,0,0,0,55000,0,55000,55000
060486,中租富邦9A購01  ,0,0,0,0,0,0,0,0,0,55000,0,0,0,55000,0,55000,55000
060459,鴻海元大9A購07  ,0,0,0,0,0,0,0,0,0,55000,0,0,0,61000,6000,55000,55000
060460,鴻海元大9A購08  ,0,0,0,0,0,0,0,0,0,55000,0,0,0,55000,0,55000,55000
060125,強茂永豐99購01  ,0,0,0,0,0,0,0,0,0,55000,0,0,0,102000,47000,55000,55000
059984,華新科元大99購21,0,0,0,0,0,0,0,0,0,55000,0,0,0,70000,15000,55000,55000
052014,光罩永豐95購01  ,0,0,0,0,0,0,0,0,0,55000,0,0,0,65000,10000,55000,55000
052747,京鼎元大97購01  ,0,0,0,0,0,0,0,0,0,55000,0,0,0,55000,0,55000,55000
046906,新光金凱基99購02,0,0,0,0,0,0,0,0,0,55000,0,0,0,55000,0,55000,55000
03434B,臺股指元大99熊10,0,0,0,0,0,0,0,0,0,55000,0,0,0,60000,5000,55000,55000
053481,同欣電元大97購01,0,0,0,0,0,0,0,0,0,55000,0,0,0,55000,0,55000,55000
054951,大毅元大97購01  ,0,0,0,0,0,0,0,0,0,55000,0,0,0,57000,2000,55000,55000
055893,大立光統一97購07,0,0,0,0,0,0,0,0,0,55000,0,0,0,145000,90000,55000,55000
054205,華新國票97購02  ,0,0,0,0,0,0,0,0,0,55000,0,0,0,60000,5000,55000,55000
056570,旺宏元大98購07  ,0,0,0,0,0,0,0,0,0,55000,0,0,0,55000,0,55000,55000
056486,樺漢元大98購04  ,0,0,0,0,0,0,0,0,0,55000,0,0,0,102000,47000,55000,55000
057430,富邦金兆豐98購01,0,0,0,0,0,0,0,0,0,55000,0,0,0,80000,25000,55000,55000
2548,華固            ,447000,423000,24000,0,0,0,1000,0,1000,30000,36000,6000,30000,0,0,0,55000
6112,聚碩            ,118000,63000,55000,0,0,0,0,0,0,0,0,0,0,0,0,0,55000
6165,捷泰            ,133000,78000,55000,0,0,0,0,0,0,0,0,0,0,0,0,0,55000
060394,欣興麥證9A購01  ,0,0,0,108000,54000,54000,0,0,0,54000,0,0,0,108000,54000,54000,54000
060717,康控永豐9A購01  ,0,0,0,0,0,0,0,0,0,54000,0,0,0,57000,3000,54000,54000
060957,SP黃豆凱基9A購04,0,0,0,0,0,0,0,0,0,54000,0,0,0,60000,6000,54000,54000
060993,健策元大9B購03  ,0,0,0,0,0,0,0,0,0,54000,0,0,0,92000,38000,54000,54000
054573,漢唐元大98購01  ,0,0,0,0,0,0,0,0,0,54000,0,0,0,54000,0,54000,54000
055193,世芯元富97購02  ,0,0,0,0,0,0,0,0,0,54000,0,0,0,54000,0,54000,54000
058249,緯穎元大99購04  ,0,0,0,0,0,0,0,0,0,54000,0,0,0,94000,40000,54000,54000
055131,茂林康和97購01  ,0,0,0,0,0,0,0,0,0,54000,0,0,0,404000,350000,54000,54000
052417,聯發科兆豐9B購01,0,0,0,0,0,0,0,0,0,54000,0,0,0,153000,99000,54000,54000
05154P,台積電兆豐95售05,0,0,0,0,0,0,0,0,0,54000,0,0,0,54000,0,54000,54000
053731,矽創凱基96購03  ,0,0,0,0,0,0,0,0,0,54000,0,0,0,60000,6000,54000,54000
056731,國巨凱基98購04  ,0,0,0,0,0,0,0,0,0,54000,0,0,0,54000,0,54000,54000
059248,華新科凱基99購04,0,0,0,0,0,0,0,0,0,54000,0,0,0,54000,0,54000,54000
059155,台表科日盛99購01,0,0,0,0,0,0,0,0,0,54000,0,0,0,147000,93000,54000,54000
055497,開發金元大97購01,0,0,0,0,0,0,0,0,0,54000,0,0,0,286000,232000,54000,54000
058833,台表科永豐99購01,0,0,0,0,0,0,0,0,0,54000,0,0,0,58000,4000,54000,54000
058588,致茂中信9B購01  ,0,0,0,0,0,0,0,0,0,54000,0,0,0,111000,57000,54000,54000
07517P,台積電元大9A售17,0,0,0,0,0,0,0,0,0,54000,0,0,0,60000,6000,54000,54000
061501,嘉澤國票9A購01  ,0,0,0,0,0,0,0,0,0,53000,0,0,0,64000,11000,53000,53000
061295,台積電國泰9B購02,0,0,0,0,0,0,0,0,0,53000,0,0,0,107000,54000,53000,53000
060288,群光元大9C購01  ,0,0,0,0,0,0,0,0,0,53000,0,0,0,99000,46000,53000,53000
059991,超眾元大9A購02  ,0,0,0,0,0,0,0,0,0,53000,0,0,0,59000,6000,53000,53000
059760,楠梓電永豐99購01,0,0,0,0,0,0,0,0,0,53000,0,0,0,78000,25000,53000,53000
05192P,玉晶光台新96售02,0,0,0,0,0,0,0,0,0,53000,0,0,0,53000,0,53000,53000
051055,友達群益98購01  ,0,0,0,0,0,0,0,0,0,53000,0,0,0,53000,0,53000,53000
053230,達方台新97購01  ,0,0,0,0,0,0,0,0,0,53000,0,0,0,53000,0,53000,53000
055318,華通國票98購01  ,0,0,0,0,0,0,0,0,0,53000,0,0,0,218000,165000,53000,53000
054196,台光電國泰97購02,0,0,0,0,0,0,0,0,0,53000,0,0,0,64000,11000,53000,53000
057000,亞德客國票99購01,0,0,0,0,0,0,0,0,0,53000,0,0,0,53000,0,53000,53000
07103P,南電元大99售04  ,0,0,0,0,0,0,0,0,0,53000,0,0,0,75000,22000,53000,53000
059955,美食康和99購01  ,0,0,0,0,0,0,0,0,0,52000,0,0,0,92000,40000,52000,52000
060732,玉晶光群益9C購02,0,0,0,0,0,0,0,0,0,52000,0,0,0,52000,0,52000,52000
061256,亞德客凱基9B購01,0,0,0,0,0,0,0,0,0,52000,0,0,0,57000,5000,52000,52000
061351,智伸科元大9A購01,0,0,0,0,0,0,0,0,0,52000,0,0,0,62000,10000,52000,52000
060936,T50反1國票9A購09,0,0,0,0,0,0,0,0,0,52000,0,0,0,52000,0,52000,52000
061076,台達電兆豐9A購01,0,0,0,0,0,0,0,0,0,52000,0,0,0,197000,145000,52000,52000
054215,創意國票97購02  ,0,0,0,0,0,0,0,0,0,52000,0,0,0,52000,0,52000,52000
053352,義隆兆豐96購01  ,0,0,0,0,0,0,0,0,0,52000,0,0,0,82000,30000,52000,52000
051572,上銀元大95購01  ,0,0,0,0,0,0,0,0,0,52000,0,0,0,52000,0,52000,52000
04617P,臺股指群益95售03,0,0,0,0,0,0,0,0,0,52000,0,0,0,53000,1000,52000,52000
055590,聯發科元大98購02,0,0,0,0,0,0,0,0,0,52000,0,0,0,547000,495000,52000,52000
058848,台積電群益99購07,0,0,0,0,0,0,0,0,0,52000,0,0,0,52000,0,52000,52000
058457,創意永豐99購01  ,0,0,0,0,0,0,0,0,0,52000,0,0,0,52000,0,52000,52000
058956,健策國票9A購02  ,0,0,0,0,0,0,0,0,0,52000,0,0,0,77000,25000,52000,52000
058509,聯發科元大99購12,0,0,0,0,0,0,0,0,0,52000,0,0,0,52000,0,52000,52000
057226,上銀凱基98購06  ,0,0,0,0,0,0,0,0,0,52000,0,0,0,52000,0,52000,52000
07844P,可成國票9A售01  ,0,0,0,0,0,0,0,0,0,52000,0,0,0,52000,0,52000,52000
061593,智原永豐9A購01  ,0,0,0,0,0,0,0,0,0,51000,0,0,0,51000,0,51000,51000
061700,瑞昱國票9A購02  ,0,0,0,0,0,0,0,0,0,51000,0,0,0,56000,5000,51000,51000
06886P,旺宏元大99售07  ,0,0,0,0,0,0,0,0,0,51000,0,0,0,53000,2000,51000,51000
060609,玉晶光凱基9B購01,0,0,0,0,0,0,0,0,0,51000,0,0,0,51000,0,51000,51000
060603,聯發科凱基9A購12,0,0,0,0,0,0,0,0,0,51000,0,0,0,61000,10000,51000,51000
049230,台達電富邦96購01,0,0,0,0,0,0,0,0,0,51000,0,0,0,51000,0,51000,51000
05152P,玉晶光群益96售05,0,0,0,0,0,0,0,0,0,51000,0,0,0,61000,10000,51000,51000
051281,健策兆豐96購01  ,0,0,0,0,0,0,0,0,0,51000,0,0,0,61000,10000,51000,51000
054021,義隆台新96購01  ,0,0,0,0,0,0,0,0,0,51000,0,0,0,51000,0,51000,51000
055301,台虹元大97購01  ,0,0,0,0,0,0,0,0,0,51000,0,0,0,51000,0,51000,51000
054649,聯茂群益97購01  ,0,0,0,0,0,0,0,0,0,51000,0,0,0,51000,0,51000,51000
056811,健策統一9B購01  ,0,0,0,0,0,0,0,0,0,51000,0,0,0,51000,0,51000,51000
057191,祥碩元大98購05  ,0,0,0,0,0,0,0,0,0,51000,0,0,0,51000,0,51000,51000
059511,宏達電永豐99購02,0,0,0,0,0,0,0,0,0,51000,0,0,0,51000,0,51000,51000
056743,貿聯凱基98購04  ,0,0,0,0,0,0,0,0,0,51000,0,0,0,51000,0,51000,51000
058540,嘉聯益國泰9A購02,0,0,0,0,0,0,0,0,0,51000,0,0,0,51000,0,51000,51000
07620P,國巨統一9B售07  ,0,0,0,0,0,0,0,0,0,51000,0,0,0,293000,242000,51000,51000
6230,超眾            ,140000,86000,54000,0,0,0,38000,25000,13000,-16000,0,4000,-4000,26000,38000,-12000,51000
060663,聯發科凱基9A購13,0,0,0,0,0,0,0,0,0,50000,0,0,0,55000,5000,50000,50000
060664,聯詠凱基9A購01  ,0,0,0,0,0,0,0,0,0,50000,0,0,0,50000,0,50000,50000
060756,鴻海元大9A購16  ,0,0,0,0,0,0,0,0,0,50000,0,0,0,50000,0,50000,50000
060339,國巨統一01購01  ,0,0,0,0,0,0,0,0,0,50000,0,0,0,100000,50000,50000,50000
060412,儒鴻永豐9A購01  ,0,0,0,0,0,0,0,0,0,50000,0,0,0,316000,266000,50000,50000
060407,南六國泰9C購01  ,0,0,0,0,0,0,0,0,0,50000,0,0,0,50000,0,50000,50000
060375,葡萄王元富9A購01,0,0,0,0,0,0,0,0,0,50000,0,0,0,138000,88000,50000,50000
060362,建準元富9A購02  ,0,0,0,0,0,0,0,0,0,50000,0,0,0,50000,0,50000,50000
060496,滬深2X元大9A購05,0,0,0,0,0,0,0,0,0,50000,0,0,0,52000,2000,50000,50000
060002,T50反1群益9A購01,0,0,0,0,0,0,0,0,0,50000,0,0,0,250000,200000,50000,50000
060116,世紀鋼元大99購07,0,0,0,0,0,0,0,0,0,50000,0,0,0,55000,5000,50000,50000
059880,世紀鋼凱基99購02,0,0,0,0,0,0,0,0,0,50000,0,0,0,60000,10000,50000,50000
059897,T50反1元大99購14,0,0,0,0,0,0,0,0,0,50000,0,0,0,50000,0,50000,50000
059543,可成亞東99購02  ,0,0,0,0,0,0,0,0,0,50000,0,0,0,50000,0,50000,50000
06908P,健策國泰99售02  ,0,0,0,0,0,0,0,0,0,50000,0,0,0,50000,0,50000,50000
06948P,FBVIX元大01售02 ,0,0,0,0,0,0,0,0,0,50000,0,0,0,50000,0,50000,50000
06624P,訊芯元大98售06  ,0,0,0,0,0,0,0,0,0,50000,0,0,0,50000,0,50000,50000
061014,台積電麥證9A購04,0,0,0,50000,0,50000,0,0,0,50000,0,0,0,50000,0,50000,50000
061020,超眾國票9A購02  ,0,0,0,0,0,0,0,0,0,50000,0,0,0,52000,2000,50000,50000
061421,台積電元大9A購29,0,0,0,0,0,0,0,0,0,50000,0,0,0,50000,0,50000,50000
055912,宏達電凱基98購03,0,0,0,0,0,0,0,0,0,50000,0,0,0,50000,0,50000,50000
054674,台光電台新97購01,0,0,0,0,0,0,0,0,0,50000,0,0,0,50000,0,50000,50000
054666,強茂元富97購01  ,0,0,0,0,0,0,0,0,0,50000,0,0,0,50000,0,50000,50000
054655,貿聯麥證98購01  ,0,0,0,50000,0,50000,0,0,0,50000,0,0,0,50000,0,50000,50000
055248,可成統一97購02  ,0,0,0,0,0,0,0,0,0,50000,0,0,0,50000,0,50000,50000
054491,瀚宇博台新96購02,0,0,0,0,0,0,0,0,0,50000,0,0,0,50000,0,50000,50000
054418,茂林元大97購01  ,0,0,0,0,0,0,0,0,0,50000,0,0,0,50000,0,50000,50000
053867,創意元大96購04  ,0,0,0,0,0,0,0,0,0,50000,0,0,0,86000,36000,50000,50000
053931,楠梓電統一96購01,0,0,0,0,0,0,0,0,0,50000,0,0,0,50000,0,50000,50000
054026,台積電凱基97購08,0,0,0,0,0,0,0,0,0,50000,0,0,0,50000,0,50000,50000
055108,智邦凱基98購01  ,0,0,0,0,0,0,0,0,0,50000,0,0,0,50000,0,50000,50000
053374,台達電元大96購03,0,0,0,0,0,0,0,0,0,50000,0,0,0,50000,0,50000,50000
051300,台光電凱基96購02,0,0,0,0,0,0,0,0,0,50000,0,0,0,50000,0,50000,50000
051170,南電元大95購03  ,0,0,0,0,0,0,0,0,0,50000,0,0,0,50000,0,50000,50000
051375,道瓊反群益9A購01,0,0,0,0,0,0,0,0,0,50000,0,0,0,50000,0,50000,50000
051559,宏達電國泰96購01,0,0,0,0,0,0,0,0,0,50000,0,0,0,50000,0,50000,50000
050758,聯發科元富9B購01,0,0,0,0,0,0,0,0,0,50000,0,0,0,50000,0,50000,50000
052017,奇鋐永豐95購01  ,0,0,0,0,0,0,0,0,0,50000,0,0,0,50000,0,50000,50000
054855,得力群益98購01  ,0,0,0,0,0,0,0,0,0,50000,0,0,0,50000,0,50000,50000
053611,聯茂麥證96購01  ,0,0,0,50000,0,50000,0,0,0,50000,0,0,0,50000,0,50000,50000
053564,台積電富邦99購01,100000,50000,50000,0,0,0,0,0,0,0,0,0,0,0,0,0,50000
048999,康普國票95購01  ,0,0,0,0,0,0,0,0,0,50000,0,0,0,50000,0,50000,50000
048509,上証反凱基99購02,0,0,0,0,0,0,0,0,0,50000,0,0,0,50000,0,50000,50000
052572,群創凱基99購01  ,0,0,0,0,0,0,0,0,0,50000,0,0,0,50000,0,50000,50000
04794P,友達元大96售03  ,0,0,0,0,0,0,0,0,0,50000,0,0,0,50000,0,50000,50000
057644,奇力新元大98購04,0,0,0,0,0,0,0,0,0,50000,0,0,0,50000,0,50000,50000
057672,茂林元大98購02  ,0,0,0,0,0,0,0,0,0,50000,0,0,0,50000,0,50000,50000
057621,崇越凱基98購01  ,0,0,0,0,0,0,0,0,0,50000,0,0,0,50000,0,50000,50000
058844,元油2X群益9C購03,0,0,0,0,0,0,0,0,0,50000,0,0,0,50000,0,50000,50000
055725,嘉聯益元大98購03,0,0,0,0,0,0,0,0,0,50000,0,0,0,86000,36000,50000,50000
055518,華新科中信99購01,0,0,0,0,0,0,0,0,0,50000,0,0,0,50000,0,50000,50000
057026,長榮航凱基98購01,0,0,0,0,0,0,0,0,0,50000,0,0,0,50000,0,50000,50000
056723,國巨中信9A購01  ,0,0,0,0,0,0,0,0,0,50000,0,0,0,50000,0,50000,50000
056452,亞光凱基98購02  ,0,0,0,0,0,0,0,0,0,50000,0,0,0,50000,0,50000,50000
05744P,台表科元大96售04,0,0,0,0,0,0,0,0,0,50000,0,0,0,50000,0,50000,50000
057374,禾伸堂元大99購03,0,0,0,0,0,0,0,0,0,50000,0,0,0,119000,69000,50000,50000
057376,新日興元大98購04,0,0,0,0,0,0,0,0,0,50000,0,0,0,50000,0,50000,50000
057482,微星元大98購03  ,0,0,0,0,0,0,0,0,0,50000,0,0,0,50000,0,50000,50000
057348,台積電統一98購09,0,0,0,0,0,0,0,0,0,50000,0,0,0,50000,0,50000,50000
057169,微星元大98購01  ,0,0,0,0,0,0,0,0,0,50000,0,0,0,50000,0,50000,50000
059069,臺指反元大9C購01,0,0,0,0,0,0,0,0,0,50000,0,0,0,50000,0,50000,50000
057139,華新科兆豐98購02,0,0,0,0,0,0,0,0,0,50000,0,0,0,50000,0,50000,50000
057874,可成元大99購02  ,0,0,0,0,0,0,0,0,0,50000,0,0,0,50000,0,50000,50000
07541P,國巨凱基9A售12  ,0,0,0,0,0,0,0,0,0,50000,0,0,0,50000,0,50000,50000
07783P,聯發科富邦9C售03,0,0,0,0,0,0,0,0,0,50000,0,0,0,50000,0,50000,50000
07732P,台灣50台新9A售05,0,0,0,0,0,0,0,0,0,50000,0,0,0,50000,0,50000,50000
06144P,台光電永豐97售01,0,0,0,0,0,0,0,0,0,49000,0,0,0,49000,0,49000,49000
06507P,台表科國票99售01,0,0,0,0,0,0,0,0,0,49000,0,0,0,51000,2000,49000,49000
061617,微星群益9A購02  ,0,0,0,0,0,0,0,0,0,49000,0,0,0,49000,0,49000,49000
059630,美律凱基99購07  ,0,0,0,0,0,0,0,0,0,49000,0,0,0,51000,2000,49000,49000
060301,國巨富邦9C購02  ,0,0,0,0,0,0,0,0,0,49000,0,0,0,49000,0,49000,49000
054872,瀚宇博群益98購01,0,0,0,0,0,0,0,0,0,49000,0,0,0,49000,0,49000,49000
055104,台達電凱基98購01,0,0,0,0,0,0,0,0,0,49000,0,0,0,69000,20000,49000,49000
054001,康友群益96購02  ,0,0,0,0,0,0,0,0,0,49000,0,0,0,49000,0,49000,49000
053997,健策群益97購02  ,0,0,0,0,0,0,0,0,0,49000,0,0,0,49000,0,49000,49000
057230,建準凱基98購02  ,0,0,0,0,0,0,0,0,0,49000,0,0,0,51000,2000,49000,49000
05925P,晶技永豐96售03  ,0,0,0,0,0,0,0,0,0,49000,0,0,0,53000,4000,49000,49000
056449,義隆凱基98購03  ,0,0,0,0,0,0,0,0,0,49000,0,0,0,178000,129000,49000,49000
057701,嘉聯益群益98購02,0,0,0,0,0,0,0,0,0,49000,0,0,0,49000,0,49000,49000
055559,大立光凱基97購09,0,0,0,0,0,0,0,0,0,49000,0,0,0,49000,0,49000,49000
055728,緯穎元大97購03  ,0,0,0,0,0,0,0,0,0,49000,0,0,0,49000,0,49000,49000
056863,義隆群益98購01  ,0,0,0,0,0,0,0,0,0,49000,0,0,0,65000,16000,49000,49000
058573,鴻海群益9A購02  ,0,0,0,0,0,0,0,0,0,49000,0,0,0,57000,8000,49000,49000
07807P,聯茂永豐9A售02  ,0,0,0,0,0,0,0,0,0,49000,0,0,0,49000,0,49000,49000
07504P,聯詠元大9A售02  ,0,0,0,0,0,0,0,0,0,49000,0,0,0,50000,1000,49000,49000
07010P,T50正2凱基9C售01,0,0,0,0,0,0,0,0,0,49000,0,0,0,50000,1000,49000,49000
060401,世紀鋼國票9B購01,0,0,0,0,0,0,0,0,0,48000,0,0,0,48000,0,48000,48000
060092,瑞昱元大99購03  ,0,0,0,0,0,0,0,0,0,48000,0,0,0,154000,106000,48000,48000
061627,台表科群益9A購01,0,0,0,0,0,0,0,0,0,48000,0,0,0,49000,1000,48000,48000
06751P,旺宏凱基98售10  ,0,0,0,0,0,0,0,0,0,48000,0,0,0,58000,10000,48000,48000
060935,T50反1國票9A購08,0,0,0,0,0,0,0,0,0,48000,0,0,0,548000,500000,48000,48000
055170,光磊統一97購01  ,0,0,0,0,0,0,0,0,0,48000,0,0,0,48000,0,48000,48000
055171,凱美統一97購01  ,0,0,0,0,0,0,0,0,0,48000,0,0,0,48000,0,48000,48000
053363,旺宏國泰98購02  ,0,0,0,0,0,0,0,0,0,48000,0,0,0,48000,0,48000,48000
053092,台表科元大97購02,0,0,0,0,0,0,0,0,0,48000,0,0,0,70000,22000,48000,48000
056810,群創統一9A購01  ,0,0,0,0,0,0,0,0,0,48000,0,0,0,48000,0,48000,48000
058311,緯穎元大99購05  ,0,0,0,0,0,0,0,0,0,48000,0,0,0,53000,5000,48000,48000
054880,華泰統一97購01  ,0,0,0,0,0,0,0,0,0,48000,0,0,0,48000,0,48000,48000
054731,S&P反1凱基98購01,0,0,0,0,0,0,0,0,0,48000,0,0,0,60000,12000,48000,48000
050846,緯創國票96購01  ,0,0,0,0,0,0,0,0,0,48000,0,0,0,48000,0,48000,48000
051575,國巨元大96購03  ,0,0,0,0,0,0,0,0,0,48000,0,0,0,48000,0,48000,48000
05761P,嘉澤永豐96售01  ,0,0,0,0,0,0,0,0,0,48000,0,0,0,48000,0,48000,48000
057890,滬深反統一98購01,0,0,0,0,0,0,0,0,0,48000,0,0,0,70000,22000,48000,48000
057887,智原群益98購04  ,0,0,0,0,0,0,0,0,0,48000,0,0,0,48000,0,48000,48000
056054,亞德客元大97購05,0,0,0,0,0,0,0,0,0,48000,0,0,0,123000,75000,48000,48000
058128,FBVIX元大9C購02 ,0,0,0,0,0,0,0,0,0,48000,0,0,0,48000,0,48000,48000
055726,台表科元大98購03,0,0,0,0,0,0,0,0,0,48000,0,0,0,72000,24000,48000,48000
058681,大立光康和9B購01,0,0,0,0,0,0,0,0,0,48000,0,0,0,48000,0,48000,48000
055603,超眾元大97購04  ,0,0,0,0,0,0,0,0,0,48000,0,0,0,49000,1000,48000,48000
056619,強茂永豐98購01  ,0,0,0,0,0,0,0,0,0,48000,0,0,0,80000,32000,48000,48000
056239,宏達電群益98購01,0,0,0,0,0,0,0,0,0,48000,0,0,0,98000,50000,48000,48000
061000,旺宏兆豐9A購02  ,0,0,0,0,0,0,0,0,0,47000,0,0,0,55000,8000,47000,47000
060965,中租凱基9B購01  ,0,0,0,0,0,0,0,0,0,47000,0,0,0,108000,61000,47000,47000
060130,瀚宇博永豐99購02,0,0,0,0,0,0,0,0,0,47000,0,0,0,48000,1000,47000,47000
060846,欣興國票9A購02  ,0,0,0,0,0,0,0,0,0,47000,0,0,0,69000,22000,47000,47000
054740,強茂凱基99購01  ,0,0,0,0,0,0,0,0,0,47000,0,0,0,47000,0,47000,47000
045054,聯發科元富98購02,0,0,0,0,0,0,0,0,0,47000,0,0,0,64000,17000,47000,47000
056818,正崴永豐98購01  ,0,0,0,0,0,0,0,0,0,47000,0,0,0,50000,3000,47000,47000
057277,可成元大98購05  ,0,0,0,0,0,0,0,0,0,47000,0,0,0,58000,11000,47000,47000
056673,中石化元富9B購01,0,0,0,0,0,0,0,0,0,47000,0,0,0,462000,415000,47000,47000
057808,旺宏元大99購05  ,0,0,0,0,0,0,0,0,0,47000,0,0,0,47000,0,47000,47000
055589,台光電元大98購04,0,0,0,0,0,0,0,0,0,47000,0,0,0,47000,0,47000,47000
057739,新日興富邦9B購01,0,0,0,0,0,0,0,0,0,47000,0,0,0,187000,140000,47000,47000
058800,健策元大99購03  ,0,0,0,0,0,0,0,0,0,47000,0,0,0,68000,21000,47000,47000
058077,超眾凱基98購02  ,0,0,0,0,0,0,0,0,0,47000,0,0,0,47000,0,47000,47000
058188,華擎永豐99購01  ,0,0,0,0,0,0,0,0,0,47000,0,0,0,176000,129000,47000,47000
057638,上銀元大99購01  ,0,0,0,0,0,0,0,0,0,47000,0,0,0,49000,2000,47000,47000
058927,勤誠元富99購02  ,0,0,0,0,0,0,0,0,0,47000,0,0,0,47000,0,47000,47000
07404P,華新科凱基99售10,0,0,0,0,0,0,0,0,0,47000,0,0,0,47000,0,47000,47000
05973P,聯詠元大96售06  ,0,0,0,0,0,0,0,0,0,46000,0,0,0,51000,5000,46000,46000
059823,奇力新凱基99購07,0,0,0,0,0,0,0,0,0,46000,0,0,0,46000,0,46000,46000
061474,瑞昱元大9A購04  ,0,0,0,0,0,0,0,0,0,46000,0,0,0,155000,109000,46000,46000
061491,嘉聯益兆豐9B購01,0,0,0,0,0,0,0,0,0,46000,0,0,0,54000,8000,46000,46000
061535,群創統一9C購01  ,0,0,0,0,0,0,0,0,0,46000,0,0,0,48000,2000,46000,46000
061246,玉晶光群益9A購08,0,0,0,0,0,0,0,0,0,46000,0,0,0,93000,47000,46000,46000
06879P,長榮航凱基98售02,0,0,0,0,0,0,0,0,0,46000,0,0,0,46000,0,46000,46000
061662,瑞儀永豐9A購02  ,0,0,0,0,0,0,0,0,0,46000,0,0,0,59000,13000,46000,46000
06246P,茂林元富97售03  ,0,0,0,0,0,0,0,0,0,46000,0,0,0,241000,195000,46000,46000
056809,旺宏統一98購03  ,0,0,0,0,0,0,0,0,0,46000,0,0,0,69000,23000,46000,46000
055295,瀚宇博元大97購02,0,0,0,0,0,0,0,0,0,46000,0,0,0,228000,182000,46000,46000
055344,國巨凱基97購04  ,0,0,0,0,0,0,0,0,0,46000,0,0,0,49000,3000,46000,46000
054826,復盛元大9A購01  ,0,0,0,0,0,0,0,0,0,46000,0,0,0,47000,1000,46000,46000
058536,群創統一9B購01  ,0,0,0,0,0,0,0,0,0,46000,0,0,0,46000,0,46000,46000
058132,義隆元大99購03  ,0,0,0,0,0,0,0,0,0,46000,0,0,0,130000,84000,46000,46000
056395,玉晶光永豐9B購01,0,0,0,0,0,0,0,0,0,46000,0,0,0,59000,13000,46000,46000
056995,華新科日盛99購01,0,0,0,0,0,0,0,0,0,46000,0,0,0,50000,4000,46000,46000
056434,國巨凱基98購03  ,0,0,0,0,0,0,0,0,0,46000,0,0,0,62000,16000,46000,46000
057438,禾伸堂國票99購01,0,0,0,0,0,0,0,0,0,46000,0,0,0,49000,3000,46000,46000
057268,臻鼎兆豐99購01  ,0,0,0,0,0,0,0,0,0,46000,0,0,0,46000,0,46000,46000
059061,晶技凱基9A購01  ,0,15000,-15000,0,0,0,0,0,0,61000,0,0,0,68000,7000,61000,46000
07539P,玉山金台新9A售01,0,0,0,0,0,0,0,0,0,46000,0,0,0,76000,30000,46000,46000
3031,佰鴻            ,131000,85000,46000,0,0,0,0,0,0,0,0,0,0,0,0,0,46000
1589,永冠-KY         ,117000,75000,42000,0,0,0,0,0,0,4000,0,0,0,4000,0,4000,46000
06611P,祥碩國票98售01  ,0,0,0,0,0,0,0,0,0,45000,0,0,0,45000,0,45000,45000
060929,健策永豐9A購01  ,0,0,0,0,0,0,0,0,0,45000,0,0,0,47000,2000,45000,45000
059740,瑞昱元富99購02  ,0,0,0,0,0,0,0,0,0,45000,0,0,0,47000,2000,45000,45000
059871,義隆凱基99購03  ,0,0,0,0,0,0,0,0,0,45000,0,0,0,197000,152000,45000,45000
060025,台積電富邦9C購06,0,0,0,0,0,0,0,0,0,45000,0,0,0,70000,25000,45000,45000
051677,達方元大95購01  ,0,0,0,0,0,0,0,0,0,45000,0,0,0,45000,0,45000,45000
047457,旺宏群益95購01  ,0,0,0,0,0,0,0,0,0,45000,0,0,0,45000,0,45000,45000
052215,樺漢元大96購02  ,0,0,0,0,0,0,0,0,0,45000,0,0,0,45000,0,45000,45000
056776,聯茂元大99購01  ,0,0,0,0,0,0,0,0,0,45000,0,0,0,45000,0,45000,45000
055881,康控元富97購01  ,0,0,0,0,0,0,0,0,0,45000,0,0,0,45000,0,45000,45000
059357,華通永豐99購01  ,0,0,0,0,0,0,0,0,0,45000,0,0,0,45000,0,45000,45000
057492,大立光元大98購18,0,0,0,0,0,0,0,0,0,45000,0,0,0,45000,0,45000,45000
057320,玉晶光凱基98購01,0,0,0,0,0,0,0,0,0,45000,0,0,0,59000,14000,45000,45000
058746,華通凱基9A購02  ,0,0,0,0,0,0,0,0,0,45000,0,0,0,51000,6000,45000,45000
056670,樺漢國票99購01  ,0,0,0,0,0,0,0,0,0,45000,0,0,0,45000,0,45000,45000
055720,宏達電元大97購05,0,0,0,0,0,0,0,0,0,45000,0,0,0,45000,0,45000,45000
058043,鴻海元大98購13  ,0,0,0,0,0,0,0,0,0,45000,0,0,0,45000,0,45000,45000
058519,嘉澤元大99購01  ,0,0,0,0,0,0,0,0,0,45000,0,0,0,51000,6000,45000,45000
057877,神達元大99購01  ,0,0,0,0,0,0,0,0,0,45000,0,0,0,58000,13000,45000,45000
07471P,南亞科元大9A售01,0,0,0,0,0,0,0,0,0,45000,0,0,0,45000,0,45000,45000
07769P,國巨國票9A售10  ,0,0,0,0,0,0,0,0,0,45000,0,0,0,245000,200000,45000,45000
059988,大立光元大9A購02,0,0,0,0,0,0,0,0,0,44000,0,0,0,44000,0,44000,44000
061011,華通麥證9A購02  ,0,0,0,44000,0,44000,0,0,0,44000,0,0,0,44000,0,44000,44000
061649,緯穎元大9A購06  ,0,0,0,0,0,0,0,0,0,44000,0,0,0,44000,0,44000,44000
058239,景碩元大99購03  ,0,0,0,0,0,0,0,0,0,44000,0,0,0,85000,41000,44000,44000
054319,世紀鋼凱基96購02,0,0,0,0,0,0,0,0,0,44000,0,0,0,69000,25000,44000,44000
054102,百和國票97購04  ,0,0,0,0,0,0,0,0,0,44000,0,0,0,82000,38000,44000,44000
054504,聯鈞永豐96購01  ,0,0,0,0,0,0,0,0,0,44000,0,0,0,44000,0,44000,44000
055330,上銀兆豐98購02  ,0,0,0,0,0,0,0,0,0,44000,0,0,0,129000,85000,44000,44000
053819,大立光群益96購04,0,0,0,0,0,0,0,0,0,44000,0,0,0,44000,0,44000,44000
052946,智原國票97購02  ,0,0,0,0,0,0,0,0,0,44000,0,0,0,44000,0,44000,44000
053364,友達國泰98購01  ,0,0,0,0,0,0,0,0,0,44000,0,0,0,59000,15000,44000,44000
053355,超眾兆豐97購01  ,0,0,0,0,0,0,0,0,0,44000,0,0,0,186000,142000,44000,44000
053710,華通凱基96購05  ,0,0,0,0,0,0,0,0,0,44000,0,0,0,49000,5000,44000,44000
054766,智原國票98購01  ,0,0,0,0,0,0,0,0,0,44000,0,0,0,44000,0,44000,44000
057636,上銀元大98購06  ,0,0,0,0,0,0,0,0,0,44000,0,0,0,44000,0,44000,44000
056114,台達電群益97購02,0,0,0,0,0,0,0,0,0,44000,0,0,0,142000,98000,44000,44000
055665,亞德客群益97購01,0,0,0,0,0,0,0,0,0,44000,0,0,0,80000,36000,44000,44000
07184P,台灣50元富01售01,0,0,0,0,0,0,0,0,0,44000,0,0,0,44000,0,44000,44000
061542,旺宏群益9A購04  ,0,0,0,0,0,0,0,0,0,43000,0,0,0,163000,120000,43000,43000
059856,昇陽半永豐99購03,0,0,0,0,0,0,0,0,0,43000,0,0,0,56000,13000,43000,43000
059827,晶技凱基99購03  ,0,0,0,0,0,0,0,0,0,43000,0,0,0,43000,0,43000,43000
060507,聯發科元大9A購03,0,0,0,0,0,0,0,0,0,43000,0,0,0,128000,85000,43000,43000
054738,聯發科凱基97購01,0,0,0,0,0,0,0,0,0,43000,0,0,0,43000,0,43000,43000
052492,易華電國票96購02,0,0,0,0,0,0,0,0,0,43000,0,0,0,43000,0,43000,43000
05830P,滬深2X元富99售03,0,0,0,0,0,0,0,0,0,43000,0,0,0,55000,12000,43000,43000
058576,南亞科群益99購01,0,0,0,0,0,0,0,0,0,43000,0,0,0,103000,60000,43000,43000
056511,超眾永豐98購01  ,0,0,0,0,0,0,0,0,0,43000,0,0,0,43000,0,43000,43000
056140,康控元大98購01  ,0,0,0,0,0,0,0,0,0,43000,0,0,0,43000,0,43000,43000
056132,台光電元大97購03,0,0,0,0,0,0,0,0,0,43000,0,0,0,46000,3000,43000,43000
058090,聯發科元大98購16,0,0,0,0,0,0,0,0,0,43000,0,0,0,99000,56000,43000,43000
057929,上銀群益98購02  ,0,0,0,0,0,0,0,0,0,43000,0,0,0,73000,30000,43000,43000
05850P,台積電兆豐96售06,0,0,0,0,0,0,0,0,0,43000,0,0,0,84000,41000,43000,43000
057076,緯穎永豐98購01  ,0,0,0,0,0,0,0,0,0,43000,0,0,0,43000,0,43000,43000
057301,嘉聯益永豐98購02,0,0,0,0,0,0,0,0,0,43000,0,0,0,111000,68000,43000,43000
059493,國巨國票9B購01  ,0,0,0,0,0,0,0,0,0,43000,0,0,0,45000,2000,43000,43000
07148P,富邦金元大99售01,0,0,0,0,0,0,0,0,0,43000,0,0,0,144000,101000,43000,43000
07466P,亞德客元大9A售02,0,0,0,0,0,0,0,0,0,43000,0,0,0,147000,104000,43000,43000
2472,立隆電          ,240000,196000,44000,0,0,0,0,0,0,-1000,0,1000,-1000,0,0,0,43000
060461,鴻海元大9A購09  ,0,0,0,0,0,0,0,0,0,42000,0,0,0,86000,44000,42000,42000
060409,味全永豐9A購01  ,0,0,0,0,0,0,0,0,0,42000,0,0,0,114000,72000,42000,42000
060765,世芯元大9A購01  ,0,0,0,0,0,0,0,0,0,42000,0,0,0,46000,4000,42000,42000
060762,長榮航元大9A購02,0,0,0,0,0,0,0,0,0,42000,0,0,0,83000,41000,42000,42000
06625P,華新科統一98售03,0,0,0,0,0,0,0,0,0,42000,0,0,0,42000,0,42000,42000
06633P,國巨國票99售01  ,0,0,0,0,0,0,0,0,0,42000,0,0,0,152000,110000,42000,42000
06865P,亞德客元大98售04,0,0,0,0,0,0,0,0,0,42000,0,0,0,42000,0,42000,42000
06893P,致新元富98售02  ,0,0,0,0,0,0,0,0,0,42000,0,0,0,61000,19000,42000,42000
058283,世紀鋼中信99購01,0,0,0,0,0,0,0,0,0,42000,0,0,0,294000,252000,42000,42000
055859,啟碁元大97購03  ,0,0,0,0,0,0,0,0,0,42000,0,0,0,68000,26000,42000,42000
054065,樺漢國票97購01  ,0,0,0,0,0,0,0,0,0,42000,0,0,0,42000,0,42000,42000
049335,聯電統一97購01  ,0,0,0,0,0,0,0,0,0,42000,0,0,0,42000,0,42000,42000
051721,玉晶光永豐96購02,0,0,0,0,0,0,0,0,0,42000,0,0,0,168000,126000,42000,42000
059363,超眾永豐99購02  ,0,0,0,0,0,0,0,0,0,42000,0,0,0,43000,1000,42000,42000
056256,聯茂元富97購03  ,0,0,0,0,0,0,0,0,0,42000,0,0,0,42000,0,42000,42000
056415,聯發科中信98購04,0,0,0,0,0,0,0,0,0,42000,0,0,0,127000,85000,42000,42000
056567,瀚宇博群益98購02,0,0,0,0,0,0,0,0,0,42000,0,0,0,46000,4000,42000,42000
05600P,玉晶光台新96售04,0,0,0,0,0,0,0,0,0,42000,0,0,0,43000,1000,42000,42000
056364,亞光元大99購02  ,0,0,0,0,0,0,0,0,0,42000,0,0,0,52000,10000,42000,42000
055691,訊芯凱基97購02  ,0,0,0,0,0,0,0,0,0,42000,0,0,0,42000,0,42000,42000
060480,億豐元大9A購02  ,0,0,0,0,0,0,0,0,0,41000,0,0,0,62000,21000,41000,41000
051934,緯穎國票96購01  ,0,0,0,0,0,0,0,0,0,41000,0,0,0,41000,0,41000,41000
054873,帆宣群益99購01  ,0,0,0,0,0,0,0,0,0,41000,0,0,0,110000,69000,41000,41000
054859,鴻海群益97購02  ,0,0,0,0,0,0,0,0,0,41000,0,0,0,41000,0,41000,41000
03094X,大立光元大68展08,0,0,0,0,0,0,0,0,0,41000,0,0,0,41000,0,41000,41000
053103,瀚宇博元富96購01,0,0,0,0,0,0,0,0,0,41000,0,0,0,141000,100000,41000,41000
055005,晶相光元富97購01,0,0,0,0,0,0,0,0,0,41000,0,0,0,43000,2000,41000,41000
053821,群創群益98購08  ,0,0,0,0,0,0,0,0,0,41000,0,0,0,41000,0,41000,41000
055848,大立光元大97購11,0,0,0,0,0,0,0,0,0,41000,0,0,0,92000,51000,41000,41000
057963,緯穎元大98購08  ,0,0,0,0,0,0,0,0,0,41000,0,0,0,85000,44000,41000,41000
058102,楠梓電永豐98購04,0,0,0,0,0,0,0,0,0,41000,0,0,0,92000,51000,41000,41000
058831,茂林永豐99購01  ,0,0,0,0,0,0,0,0,0,41000,0,0,0,110000,69000,41000,41000
057927,勤誠凱基98購01  ,0,0,0,0,0,0,0,0,0,41000,0,0,0,41000,0,41000,41000
058214,世芯群益9A購01  ,0,0,0,0,0,0,0,0,0,41000,0,0,0,62000,21000,41000,41000
058969,亞德客永豐99購01,0,0,0,0,0,0,0,0,0,41000,0,0,0,93000,52000,41000,41000
057536,康控元大99購03  ,0,0,0,0,0,0,0,0,0,41000,0,0,0,41000,0,41000,41000
057424,訊芯凱基98購04  ,0,0,0,0,0,0,0,0,0,41000,0,0,0,51000,10000,41000,41000
2390,云辰            ,154000,113000,41000,0,0,0,0,0,0,0,0,0,0,0,0,0,41000
07588P,滬深2X國票9C售01,0,0,0,0,0,0,0,0,0,41000,0,0,0,41000,0,41000,41000
07694P,超眾元大9A售05  ,0,0,0,0,0,0,0,0,0,41000,0,0,0,41000,0,41000,41000
07344P,鴻海富邦9A售03  ,0,0,0,0,0,0,0,0,0,41000,0,0,0,50000,9000,41000,41000
3583,辛耘            ,91000,50000,41000,0,0,0,0,0,0,0,0,0,0,0,0,0,41000
060548,友達凱基9B購03  ,0,0,0,0,0,0,0,0,0,40000,0,0,0,40000,0,40000,40000
060622,玉晶光元大9B購02,0,0,0,0,0,0,0,0,0,40000,0,0,0,60000,20000,40000,40000
060773,FBVIX凱基9A購04 ,0,0,0,0,0,0,0,0,0,40000,0,0,0,45000,5000,40000,40000
059867,華邦電凱基99購02,0,0,0,0,0,0,0,0,0,40000,0,0,0,55000,15000,40000,40000
059898,T50反1元大99購15,0,0,0,0,0,0,0,0,0,40000,0,0,0,40000,0,40000,40000
059919,宏達電元大99購06,0,0,0,0,0,0,0,0,0,40000,0,0,0,40000,0,40000,40000
05970P,超眾永豐96售03  ,0,0,0,0,0,0,0,0,0,40000,0,0,0,40000,0,40000,40000
059713,滬深2X元大9C購04,0,0,0,0,0,0,0,0,0,40000,0,0,0,80000,40000,40000,40000
059552,台灣50凱基99購04,0,0,0,0,0,0,0,0,0,40000,0,0,0,40000,0,40000,40000
05955P,台光電國票97售02,0,0,0,0,0,0,0,0,0,40000,0,0,0,40000,0,40000,40000
060114,緯穎元大99購10  ,0,0,0,0,0,0,0,0,0,40000,0,0,0,45000,5000,40000,40000
060139,T50反1國票9A購04,0,0,0,0,0,0,0,0,0,40000,0,0,0,50000,10000,40000,40000
06495P,華新科亞東9A售01,0,0,0,0,0,0,0,0,0,40000,0,0,0,40000,0,40000,40000
061561,義隆國票9A購02  ,0,0,0,0,0,0,0,0,0,40000,0,0,0,107000,67000,40000,40000
06100P,台積電日盛97售03,0,0,0,0,0,0,0,0,0,40000,0,0,0,40000,0,40000,40000
061048,國巨中信9A購05  ,0,0,0,0,0,0,0,0,0,40000,0,0,0,40000,0,40000,40000
060920,超眾富邦9B購01  ,0,0,0,0,0,0,0,0,0,40000,0,0,0,500000,460000,40000,40000
061239,聯發科兆豐9A購01,0,0,0,0,0,0,0,0,0,40000,0,0,0,40000,0,40000,40000
055889,鴻海統一97購05  ,0,0,0,0,0,0,0,0,0,40000,0,0,0,40000,0,40000,40000
056784,南亞科群益98購01,0,0,0,0,0,0,0,0,0,40000,0,0,0,40000,0,40000,40000
054240,訊芯群益96購03  ,0,0,0,0,0,0,0,0,0,40000,0,0,0,125000,85000,40000,40000
054393,漢唐永豐96購01  ,0,0,0,0,0,0,0,0,0,40000,0,0,0,40000,0,40000,40000
055348,旺宏凱基97購01  ,0,0,0,0,0,0,0,0,0,40000,0,0,0,60000,20000,40000,40000
054989,精元元富97購01  ,0,0,0,0,0,0,0,0,0,40000,0,0,0,50000,10000,40000,40000
053954,貿聯康和96購01  ,0,0,0,0,0,0,0,0,0,40000,0,0,0,134000,94000,40000,40000
054919,興富發凱基97購01,0,0,0,0,0,0,0,0,0,40000,0,0,0,50000,10000,40000,40000
054938,國巨元大97購04  ,0,0,0,0,0,0,0,0,0,40000,0,0,0,40000,0,40000,40000
053205,台光電麥證96購01,0,0,0,105000,65000,40000,0,0,0,40000,0,0,0,105000,65000,40000,40000
054045,奇力新元大97購03,0,0,0,0,0,0,0,0,0,40000,0,0,0,40000,0,40000,40000
053446,欣興凱基96購02  ,0,0,0,0,0,0,0,0,0,40000,0,0,0,40000,0,40000,40000
046011,欣興元富95購01  ,0,0,0,0,0,0,0,0,0,40000,0,0,0,40000,0,40000,40000
052177,京鼎元大95購02  ,0,0,0,0,0,0,0,0,0,40000,0,0,0,40000,0,40000,40000
04817P,創意國票95售02  ,0,0,0,0,0,0,0,0,0,40000,0,0,0,40000,0,40000,40000
054809,大成鋼元大97購01,0,0,0,0,0,0,0,0,0,40000,0,0,0,40000,0,40000,40000
053558,訊芯凱基96購02  ,0,0,0,0,0,0,0,0,0,40000,0,0,0,40000,0,40000,40000
050168,緯創富邦95購01  ,0,0,0,0,0,0,0,0,0,40000,0,0,0,40000,0,40000,40000
052663,奇鋐國票97購01  ,0,0,0,0,0,0,0,0,0,40000,0,0,0,40000,0,40000,40000
051734,台積電國票95購04,0,0,0,0,0,0,0,0,0,40000,0,0,0,40000,0,40000,40000
051790,貿聯國票95購03  ,0,0,0,0,0,0,0,0,0,40000,0,0,0,40000,0,40000,40000
051544,T50反1康和98購01,0,0,0,0,0,0,0,0,0,40000,0,0,0,40000,0,40000,40000
057579,長榮航中信9A購01,0,0,0,0,0,0,0,0,0,40000,0,0,0,40000,0,40000,40000
058754,元油2X群益99購02,40000,0,40000,0,0,0,0,0,0,0,0,0,0,0,0,0,40000
056557,世紀鋼凱基98購02,0,0,0,0,0,0,0,0,0,40000,0,0,0,65000,25000,40000,40000
056734,國巨凱基99購01  ,0,0,0,0,0,0,0,0,0,40000,0,0,0,45000,5000,40000,40000
056716,康舒永豐98購01  ,0,0,0,0,0,0,0,0,0,40000,0,0,0,42000,2000,40000,40000
057143,台郡兆豐98購01  ,0,0,0,0,0,0,0,0,0,40000,0,0,0,40000,0,40000,40000
056921,京元電兆豐98購01,0,0,0,0,0,0,0,0,0,40000,0,0,0,70000,30000,40000,40000
057669,嘉晶元大99購03  ,0,0,0,0,0,0,0,0,0,40000,0,0,0,40000,0,40000,40000
058934,台灣50中信03購03,0,0,0,0,0,0,0,0,0,40000,0,0,0,40000,0,40000,40000
05805P,義隆永豐96售02  ,0,0,0,0,0,0,0,0,0,40000,0,0,0,140000,100000,40000,40000
058014,上銀凱基99購02  ,0,0,0,0,0,0,0,0,0,40000,0,0,0,40000,0,40000,40000
055968,祥碩元大97購04  ,0,0,0,0,0,0,0,0,0,40000,0,0,0,40000,0,40000,40000
056097,訊芯元富97購02  ,0,0,0,0,0,0,0,0,0,40000,0,0,0,50000,10000,40000,40000
055654,景碩元富97購01  ,0,0,0,0,0,0,0,0,0,40000,0,0,0,40000,0,40000,40000
058669,上銀群益99購01  ,0,0,0,0,0,0,0,0,0,40000,0,0,0,40000,0,40000,40000
058455,玉晶光永豐99購03,0,0,0,0,0,0,0,0,0,40000,0,0,0,43000,3000,40000,40000
056335,微星凱基98購01  ,0,0,0,0,0,0,0,0,0,40000,0,0,0,40000,0,40000,40000
4536,拓凱            ,96000,258000,-162000,0,0,0,202000,0,202000,0,50000,50000,0,0,0,0,40000
07376P,聯發科元大99售39,0,0,0,0,0,0,0,0,0,40000,0,0,0,40000,0,40000,40000
07781P,高鐵凱基9A售02  ,0,0,0,0,0,0,0,0,0,40000,0,0,0,50000,10000,40000,40000
07499P,台積電元大9A售12,0,0,0,0,0,0,0,0,0,40000,0,0,0,40000,0,40000,40000
1795,美時            ,608000,568000,40000,0,0,0,0,0,0,0,0,0,0,0,0,0,40000
06569P,可成永豐98售01  ,0,0,0,0,0,0,0,0,0,39000,0,0,0,49000,10000,39000,39000
06801P,技嘉群益99售02  ,0,0,0,0,0,0,0,0,0,39000,0,0,0,39000,0,39000,39000
060549,聯發科凱基9B購03,0,0,0,0,0,0,0,0,0,39000,0,0,0,44000,5000,39000,39000
060287,燿華元大9A購01  ,0,0,0,0,0,0,0,0,0,39000,0,0,0,229000,190000,39000,39000
053195,玉晶光元富96購02,0,0,0,0,0,0,0,0,0,39000,0,0,0,40000,1000,39000,39000
054378,楠梓電群益98購01,0,0,0,0,0,0,0,0,0,39000,0,0,0,119000,80000,39000,39000
055631,創意永豐98購01  ,0,0,0,0,0,0,0,0,0,39000,0,0,0,39000,0,39000,39000
055958,台光電元大97購02,0,0,0,0,0,0,0,0,0,39000,0,0,0,99000,60000,39000,39000
056928,旺宏台新98購01  ,0,0,0,0,0,0,0,0,0,39000,0,0,0,69000,30000,39000,39000
057151,易華電國票99購01,0,0,0,0,0,0,0,0,0,39000,0,0,0,59000,20000,39000,39000
059180,祥碩元富9A購01  ,0,0,0,0,0,0,0,0,0,39000,0,0,0,136000,97000,39000,39000
07181P,臺股指凱基99售23,0,0,0,0,0,0,0,0,0,39000,0,0,0,74000,35000,39000,39000
4137,麗豐-KY         ,109000,56000,53000,0,0,0,0,0,0,-14000,0,0,0,0,14000,-14000,39000
3266,昇陽            ,82000,43000,39000,0,0,0,0,0,0,0,0,0,0,0,0,0,39000
060910,聯發科元大9A購05,0,0,0,0,0,0,0,0,0,38000,0,0,0,40000,2000,38000,38000
060680,玉晶光元大9C購03,0,0,0,0,0,0,0,0,0,38000,0,0,0,66000,28000,38000,38000
059785,美律元大9A購03  ,0,0,0,0,0,0,0,0,0,38000,0,0,0,66000,28000,38000,38000
06868P,電子類元大99售01,0,0,0,0,0,0,0,0,0,38000,0,0,0,45000,7000,38000,38000
061679,健策元大9B購04  ,0,0,0,0,0,0,0,0,0,38000,0,0,0,127000,89000,38000,38000
054331,世芯永豐96購03  ,0,0,0,0,0,0,0,0,0,38000,0,0,0,43000,5000,38000,38000
052953,百和國票97購01  ,0,0,0,0,0,0,0,0,0,38000,0,0,0,38000,0,38000,38000
053893,京鼎群益97購02  ,0,0,0,0,0,0,0,0,0,38000,0,0,0,116000,78000,38000,38000
051623,和碩凱基96購02  ,0,0,0,0,0,0,0,0,0,38000,0,0,0,38000,0,38000,38000
051729,華新國票96購01  ,0,0,0,0,0,0,0,0,0,38000,0,0,0,38000,0,38000,38000
050675,奇鋐富邦96購01  ,0,0,0,0,0,0,0,0,0,38000,0,0,0,38000,0,38000,38000
053487,台泥兆豐97購01  ,0,0,0,0,0,0,0,0,0,38000,0,0,0,149000,111000,38000,38000
052561,矽創國票97購01  ,0,0,0,0,0,0,0,0,0,38000,0,0,0,38000,0,38000,38000
059488,大立光兆豐99購03,0,0,0,0,0,0,0,0,0,38000,0,0,0,38000,0,38000,38000
059453,奇力新永豐99購01,0,0,0,0,0,0,0,0,0,38000,0,0,0,58000,20000,38000,38000
059508,聯發科永豐99購03,0,0,0,0,0,0,0,0,0,38000,0,0,0,38000,0,38000,38000
057146,技嘉國票98購01  ,0,0,0,0,0,0,0,0,0,38000,0,0,0,40000,2000,38000,38000
057862,智邦凱基99購01  ,0,0,0,0,0,0,0,0,0,38000,0,0,0,38000,0,38000,38000
05758P,光罩永豐96售02  ,0,0,0,0,0,0,0,0,0,38000,0,0,0,38000,0,38000,38000
057944,新日興國票99購02,0,0,0,0,0,0,0,0,0,38000,0,0,0,38000,0,38000,38000
055700,緯穎國泰98購02  ,0,0,0,0,0,0,0,0,0,38000,0,0,0,38000,0,38000,38000
056969,智易永豐98購01  ,0,0,0,0,0,0,0,0,0,38000,0,0,0,38000,0,38000,38000
07126P,台積電元大99售23,0,0,0,0,0,0,0,0,0,38000,0,0,0,38000,0,38000,38000
061574,大毅元大9B購01  ,0,0,0,0,0,0,0,0,0,37000,0,0,0,46000,9000,37000,37000
06458P,玉晶光統一9A售02,0,0,0,0,0,0,0,0,0,37000,0,0,0,184000,147000,37000,37000
061455,京元電凱基9B購01,0,0,0,0,0,0,0,0,0,37000,0,0,0,37000,0,37000,37000
059835,聯發科國泰9B購01,0,0,0,0,0,0,0,0,0,37000,0,0,0,37000,0,37000,37000
060166,佐登永豐9A購01  ,0,0,0,0,0,0,0,0,0,37000,0,0,0,37000,0,37000,37000
060105,牧德元大9B購01  ,0,0,0,0,0,0,0,0,0,37000,0,0,0,45000,8000,37000,37000
059967,聯發科凱基99購20,0,0,0,0,0,0,0,0,0,37000,0,0,0,38000,1000,37000,37000
060746,玉晶光國票9B購02,0,0,0,0,0,0,0,0,0,37000,0,0,0,43000,6000,37000,37000
060637,玉晶光永豐9A購03,0,0,0,0,0,0,0,0,0,37000,0,0,0,38000,1000,37000,37000
050491,旺宏國泰96購01  ,0,0,0,0,0,0,0,0,0,37000,0,0,0,45000,8000,37000,37000
055449,超眾統一9A購01  ,0,0,0,0,0,0,0,0,0,37000,0,0,0,52000,15000,37000,37000
054098,嘉晶國票97購04  ,0,0,0,0,0,0,0,0,0,37000,0,0,0,37000,0,37000,37000
057778,大立光群益98購02,0,0,0,0,0,0,0,0,0,37000,0,0,0,47000,10000,37000,37000
056119,欣興群益97購02  ,0,0,0,0,0,0,0,0,0,37000,0,0,0,69000,32000,37000,37000
057553,景碩凱基98購03  ,0,0,0,0,0,0,0,0,0,37000,0,0,0,37000,0,37000,37000
057303,喬山兆豐99購01  ,0,0,0,0,0,0,0,0,0,37000,0,0,0,65000,28000,37000,37000
056536,義隆凱基98購04  ,0,0,0,0,0,0,0,0,0,37000,0,0,0,144000,107000,37000,37000
056481,創意元大98購01  ,0,0,0,0,0,0,0,0,0,37000,0,0,0,37000,0,37000,37000
056255,華新科元富97購05,0,0,0,0,0,0,0,0,0,37000,0,0,0,127000,90000,37000,37000
059116,晶豪科永豐99購01,0,0,0,0,0,0,0,0,0,37000,0,0,0,37000,0,37000,37000
07648P,祥碩國票9B售01  ,0,0,0,0,0,0,0,0,0,37000,0,0,0,37000,0,37000,37000
060591,富邦金台新9A購01,0,0,0,0,0,0,0,0,0,36000,0,0,0,36000,0,36000,36000
061092,可成統一9C購02  ,0,0,0,0,0,0,0,0,0,36000,0,0,0,79000,43000,36000,36000
055404,超眾元富97購01  ,0,0,0,0,0,0,0,0,0,36000,0,0,0,132000,96000,36000,36000
05528P,臺股指群益96售01,0,0,0,0,0,0,0,0,0,36000,0,0,0,157000,121000,36000,36000
053202,聯發科日盛96購02,0,0,0,0,0,0,0,0,0,36000,0,0,0,36000,0,36000,36000
053441,旺宏凱基98購01  ,0,0,0,0,0,0,0,0,0,36000,0,0,0,36000,0,36000,36000
051639,康友國票96購02  ,0,0,0,0,0,0,0,0,0,36000,0,0,0,36000,0,36000,36000
04854P,鴻海國泰96售04  ,0,0,0,0,0,0,0,0,0,36000,0,0,0,36000,0,36000,36000
05905P,晶技統一97售01  ,0,0,0,0,0,0,0,0,0,36000,0,0,0,40000,4000,36000,36000
057189,康控元大98購02  ,0,0,0,0,0,0,0,0,0,36000,0,0,0,50000,14000,36000,36000
059386,上銀凱基99購07  ,0,0,0,0,0,0,0,0,0,36000,0,0,0,36000,0,36000,36000
057049,新日興元大98購02,0,0,0,0,0,0,0,0,0,36000,0,0,0,36000,0,36000,36000
056669,貿聯國票99購01  ,0,0,0,0,0,0,0,0,0,36000,0,0,0,74000,38000,36000,36000
057480,技嘉元大98購03  ,0,0,0,0,0,0,0,0,0,36000,0,0,0,52000,16000,36000,36000
057436,義隆國票99購02  ,0,0,0,0,0,0,0,0,0,36000,0,0,0,38000,2000,36000,36000
057461,國巨永豐98購07  ,0,0,0,0,0,0,0,0,0,36000,0,0,0,36000,0,36000,36000
056103,聯發科永豐97購03,0,0,0,0,0,0,0,0,0,36000,0,0,0,36000,0,36000,36000
058517,景碩元大99購06  ,0,0,0,0,0,0,0,0,0,36000,0,0,0,74000,38000,36000,36000
056343,高鐵凱基98購02  ,0,0,0,0,0,0,0,0,0,36000,0,0,0,78000,42000,36000,36000
056146,台虹元大98購01  ,0,0,0,0,0,0,0,0,0,36000,0,0,0,236000,200000,36000,36000
055779,國泰金凱基97購02,0,0,0,0,0,0,0,0,0,36000,0,0,0,36000,0,36000,36000
07406P,大立光凱基99售18,0,0,0,0,0,0,0,0,0,36000,0,0,0,36000,0,36000,36000
4540,全球傳動        ,97000,61000,36000,0,0,0,0,0,0,0,0,0,0,0,0,0,36000
061169,GIS兆豐9A購01   ,0,0,0,0,0,0,0,0,0,35000,0,0,0,110000,75000,35000,35000
061173,T50反1凱基04購01,0,0,0,0,0,0,0,0,0,35000,0,0,0,40000,5000,35000,35000
061025,創意富邦9B購01  ,0,0,0,0,0,0,0,0,0,35000,0,0,0,368000,333000,35000,35000
061470,鈺齊群益9A購02  ,0,0,0,0,0,0,0,0,0,35000,0,0,0,71000,36000,35000,35000
061487,聯發科兆豐9B購02,0,0,0,0,0,0,0,0,0,35000,0,0,0,37000,2000,35000,35000
06173P,華通元大97售02  ,0,0,0,0,0,0,0,0,0,35000,0,0,0,35000,0,35000,35000
060670,臺指反元大01購03,0,0,0,0,0,0,0,0,0,35000,0,0,0,35000,0,35000,35000
06088P,建準永豐97售01  ,0,0,0,0,0,0,0,0,0,35000,0,0,0,35000,0,35000,35000
059956,玉山金康和99購01,0,0,0,0,0,0,0,0,0,35000,0,0,0,77000,42000,35000,35000
059840,鴻海富邦9A購02  ,0,0,0,0,0,0,0,0,0,35000,0,0,0,35000,0,35000,35000
059608,聯發科富邦9B購04,0,0,0,0,0,0,0,0,0,35000,0,0,0,35000,0,35000,35000
059665,嘉聯益元大99購06,0,0,0,0,0,0,0,0,0,35000,0,0,0,46000,11000,35000,35000
045053,聯發科元富98購01,0,0,0,0,0,0,0,0,0,35000,0,0,0,75000,40000,35000,35000
052094,瀚宇博元大96購02,0,0,0,0,0,0,0,0,0,35000,0,0,0,55000,20000,35000,35000
051536,玉晶光國票97購01,0,0,0,0,0,0,0,0,0,35000,0,0,0,213000,178000,35000,35000
051381,玉晶光群益98購01,0,0,0,0,0,0,0,0,0,35000,0,0,0,193000,158000,35000,35000
050537,鴻海凱基95購05  ,0,0,0,0,0,0,0,0,0,35000,0,0,0,40000,5000,35000,35000
053601,台表科元大98購01,0,0,0,0,0,0,0,0,0,35000,0,0,0,35000,0,35000,35000
053463,可成富邦98購01  ,0,0,0,0,0,0,0,0,0,35000,0,0,0,35000,0,35000,35000
055060,聯陽永豐97購01  ,0,0,0,0,0,0,0,0,0,35000,0,0,0,35000,0,35000,35000
053244,光磊國票97購01  ,0,0,0,0,0,0,0,0,0,35000,0,0,0,35000,0,35000,35000
057985,華通元富02購03  ,0,0,0,0,0,0,0,0,0,35000,0,0,0,120000,85000,35000,35000
055620,樺漢國票98購01  ,0,0,0,0,0,0,0,0,0,35000,0,0,0,50000,15000,35000,35000
058440,玉晶光統一99購02,0,0,0,0,0,0,0,0,0,35000,0,0,0,39000,4000,35000,35000
058828,大毅永豐99購01  ,0,0,0,0,0,0,0,0,0,35000,0,0,0,38000,3000,35000,35000
058802,矽創元大99購02  ,0,0,0,0,0,0,0,0,0,35000,0,0,0,146000,111000,35000,35000
058374,玉晶光凱基9A購03,0,0,0,0,0,0,0,0,0,35000,0,0,0,83000,48000,35000,35000
058093,神達元大9A購01  ,0,0,0,0,0,0,0,0,0,35000,0,0,0,50000,15000,35000,35000
056646,奇鋐凱基99購02  ,0,0,0,0,0,0,0,0,0,35000,0,0,0,35000,0,35000,35000
059229,臺股指元大99購22,0,0,0,0,0,0,0,0,0,35000,0,0,0,50000,15000,35000,35000
05628P,茂林國票97售02  ,0,0,0,0,0,0,0,0,0,35000,0,0,0,35000,0,35000,35000
07122P,欣興凱基99售05  ,0,0,0,0,0,0,0,0,0,35000,0,0,0,110000,75000,35000,35000
07641P,上銀凱基9A售05  ,0,0,0,0,0,0,0,0,0,35000,0,0,0,35000,0,35000,35000
07722P,玉晶光凱基9A售10,0,0,0,0,0,0,0,0,0,35000,0,0,0,55000,20000,35000,35000
059669,台灣50元富9B購05,0,0,0,0,0,0,0,0,0,34000,0,0,0,35000,1000,34000,34000
06012P,世芯國票96售01  ,0,0,0,0,0,0,0,0,0,34000,0,0,0,100000,66000,34000,34000
060828,高股息國票9A購01,0,0,0,0,0,0,0,0,0,34000,0,0,0,38000,4000,34000,34000
061614,亞德客群益9A購01,0,0,0,0,0,0,0,0,0,34000,0,0,0,44000,10000,34000,34000
061436,上銀凱基9A購07  ,0,0,0,0,0,0,0,0,0,34000,0,0,0,70000,36000,34000,34000
061433,華通麥證9A購03  ,0,0,0,44000,10000,34000,0,0,0,34000,0,0,0,44000,10000,34000,34000
060945,緯穎國票9A購02  ,0,0,0,0,0,0,0,0,0,34000,0,0,0,97000,63000,34000,34000
061122,敬鵬永豐9A購01  ,0,0,0,0,0,0,0,0,0,34000,0,0,0,34000,0,34000,34000
053113,瀚宇博兆豐97購01,0,0,0,0,0,0,0,0,0,34000,0,0,0,139000,105000,34000,34000
055058,大毅永豐97購01  ,0,0,0,0,0,0,0,0,0,34000,0,0,0,54000,20000,34000,34000
054015,晶豪科永豐96購03,0,0,0,0,0,0,0,0,0,34000,0,0,0,189000,155000,34000,34000
054915,興勤凱基97購01  ,0,0,0,0,0,0,0,0,0,34000,0,0,0,54000,20000,34000,34000
051985,智邦元大95購05  ,0,0,0,0,0,0,0,0,0,34000,0,0,0,50000,16000,34000,34000
052045,瑞昱凱基96購01  ,0,0,0,0,0,0,0,0,0,34000,0,0,0,45000,11000,34000,34000
056668,光磊國票99購01  ,0,0,0,0,0,0,0,0,0,34000,0,0,0,34000,0,34000,34000
056578,智易元大99購02  ,0,0,0,0,0,0,0,0,0,34000,0,0,0,50000,16000,34000,34000
057828,緯穎元大99購02  ,0,0,0,0,0,0,0,0,0,34000,0,0,0,34000,0,34000,34000
057805,華通元大98購06  ,0,0,0,0,0,0,0,0,0,34000,0,0,0,163000,129000,34000,34000
058100,聯茂國泰99購02  ,0,0,0,0,0,0,0,0,0,34000,0,0,0,37000,3000,34000,34000
058932,FBVIX台新99購01 ,0,0,0,0,0,0,0,0,0,34000,0,0,0,34000,0,34000,34000
056900,可成元大98購02  ,0,0,0,0,0,0,0,0,0,34000,0,0,0,59000,25000,34000,34000
055475,臻鼎凱基97購02  ,0,0,0,0,0,0,0,0,0,34000,0,0,0,44000,10000,34000,34000
057024,義隆凱基99購01  ,0,0,0,0,0,0,0,0,0,34000,0,0,0,70000,36000,34000,34000
07463P,台積電國票9A售05,0,0,0,0,0,0,0,0,0,34000,0,0,0,34000,0,34000,34000
4141,龍燈-KY         ,80000,37000,43000,0,0,0,0,0,0,-9000,0,9000,-9000,0,0,0,34000
061563,群創國票9B購02  ,0,0,0,0,0,0,0,0,0,33000,0,0,0,33000,0,33000,33000
060612,世紀鋼凱基9A購01,0,0,0,0,0,0,0,0,0,33000,0,0,0,65000,32000,33000,33000
060332,聯發科麥證9A購01,0,0,0,33000,0,33000,0,0,0,33000,0,0,0,33000,0,33000,33000
052681,T50反1元大98購02,0,0,0,0,0,0,0,0,0,33000,0,0,0,54000,21000,33000,33000
053548,旺宏凱基96購04  ,0,0,0,0,0,0,0,0,0,33000,0,0,0,33000,0,33000,33000
053784,奇力新元大97購02,0,0,0,0,0,0,0,0,0,33000,0,0,0,85000,52000,33000,33000
046385,群創凱基98購03  ,0,0,0,0,0,0,0,0,0,33000,0,0,0,37000,4000,33000,33000
055393,華新科統一97購03,0,0,0,0,0,0,0,0,0,33000,0,0,0,76000,43000,33000,33000
053111,緯創兆豐97購01  ,0,0,0,0,0,0,0,0,0,33000,0,0,0,172000,139000,33000,33000
057971,華新科富邦9B購02,0,0,0,0,0,0,0,0,0,33000,0,0,0,35000,2000,33000,33000
057714,聯發科統一98購05,0,0,0,0,0,0,0,0,0,33000,0,0,0,33000,0,33000,33000
057691,健策凱基99購01  ,0,0,0,0,0,0,0,0,0,33000,0,0,0,33000,0,33000,33000
058846,鴻海群益99購03  ,0,0,0,0,0,0,0,0,0,33000,0,0,0,67000,34000,33000,33000
058630,日月光國票9A購01,0,0,0,0,0,0,0,0,0,33000,0,0,0,60000,27000,33000,33000
057882,華通群益9A購03  ,0,0,0,0,0,0,0,0,0,33000,0,0,0,107000,74000,33000,33000
058933,FBVIX台新9B購01 ,0,0,0,0,0,0,0,0,0,33000,0,0,0,33000,0,33000,33000
05596P,可成統一96售01  ,0,0,0,0,0,0,0,0,0,33000,0,0,0,33000,0,33000,33000
057072,日月光永豐98購01,0,0,0,0,0,0,0,0,0,33000,0,0,0,79000,46000,33000,33000
057494,玉晶光元大99購09,0,0,0,0,0,0,0,0,0,33000,0,0,0,47000,14000,33000,33000
057327,玉晶光群益9A購04,0,0,0,0,0,0,0,0,0,33000,0,0,0,81000,48000,33000,33000
060498,華通元大9A購03  ,0,0,0,0,0,0,0,0,0,32000,0,0,0,32000,0,32000,32000
060428,瑞祺永豐9A購01  ,0,0,0,0,0,0,0,0,0,32000,0,0,0,278000,246000,32000,32000
060433,億豐永豐9A購01  ,0,0,0,0,0,0,0,0,0,32000,0,0,0,32000,0,32000,32000
060087,鴻海元大99購43  ,0,0,0,0,0,0,0,0,0,32000,0,0,0,44000,12000,32000,32000
059696,立積永豐99購03  ,0,0,0,0,0,0,0,0,0,32000,0,0,0,40000,8000,32000,32000
059861,聯發科群益9A購01,0,0,0,0,0,0,0,0,0,32000,0,0,0,34000,2000,32000,32000
06593P,欣興元大98售05  ,0,0,0,0,0,0,0,0,0,32000,0,0,0,81000,49000,32000,32000
060966,台表科凱基9B購01,0,0,0,0,0,0,0,0,0,32000,0,0,0,44000,12000,32000,32000
055278,旺宏元大98購05  ,0,0,0,0,0,0,0,0,0,32000,0,0,0,32000,0,32000,32000
052943,奇力新國票96購02,0,0,0,0,0,0,0,0,0,32000,0,0,0,152000,120000,32000,32000
054898,台肥康和97購01  ,0,0,0,0,0,0,0,0,0,32000,0,0,0,32000,0,32000,32000
050322,世紀鋼國票95購01,0,0,0,0,0,0,0,0,0,32000,0,0,0,32000,0,32000,32000
058982,台積電凱基99購08,0,0,0,0,0,0,0,0,0,32000,0,0,0,32000,0,32000,32000
057498,台郡元大98購04  ,0,0,0,0,0,0,0,0,0,32000,0,0,0,32000,0,32000,32000
057575,世紀鋼永豐98購02,0,0,0,0,0,0,0,0,0,32000,0,0,0,97000,65000,32000,32000
057787,TPK國票99購01   ,0,0,0,0,0,0,0,0,0,32000,0,0,0,32000,0,32000,32000
059320,華新科元大99購15,0,0,0,0,0,0,0,0,0,32000,0,0,0,32000,0,32000,32000
058190,貿聯永豐99購01  ,0,0,0,0,0,0,0,0,0,32000,0,0,0,52000,20000,32000,32000
056905,欣興元大98購03  ,0,0,0,0,0,0,0,0,0,32000,0,0,0,40000,8000,32000,32000
05762P,昇陽半永豐96售04,0,0,0,0,0,0,0,0,0,32000,0,0,0,42000,10000,32000,32000
07573P,國巨元大9A售11  ,0,0,0,0,0,0,0,0,0,32000,0,0,0,202000,170000,32000,32000
07671P,超眾元大9A售04  ,0,0,0,0,0,0,0,0,0,32000,0,0,0,32000,0,32000,32000
061343,大立光元大9A購04,0,0,0,0,0,0,0,0,0,31000,0,0,0,31000,0,31000,31000
061628,緯穎群益9A購04  ,0,0,0,0,0,0,0,0,0,31000,0,0,0,31000,0,31000,31000
059784,台光電元大9A購01,0,0,0,0,0,0,0,0,0,31000,0,0,0,76000,45000,31000,31000
060300,佐登國泰9B購01  ,0,0,0,0,0,0,0,0,0,31000,0,0,0,69000,38000,31000,31000
060605,大立光凱基9C購01,0,0,0,0,0,0,0,0,0,31000,0,0,0,31000,0,31000,31000
052990,超眾元大97購01  ,0,0,0,0,0,0,0,0,0,31000,0,0,0,31000,0,31000,31000
053320,華新科群益97購01,0,0,0,0,0,0,0,0,0,31000,0,0,0,38000,7000,31000,31000
054471,T50反1中信9C購01,0,0,0,0,0,0,0,0,0,31000,0,0,0,213000,182000,31000,31000
056066,奇鋐元大98購02  ,0,0,0,0,0,0,0,0,0,31000,0,0,0,31000,0,31000,31000
058050,台郡元大99購05  ,0,0,0,0,0,0,0,0,0,31000,0,0,0,81000,50000,31000,31000
058722,台郡元富99購01  ,0,0,0,0,0,0,0,0,0,31000,0,0,0,218000,187000,31000,31000
059428,國巨元大99購25  ,0,0,0,0,0,0,0,0,0,31000,0,0,0,31000,0,31000,31000
059146,貿聯國票9A購02  ,0,0,0,0,0,0,0,0,0,31000,0,0,0,38000,7000,31000,31000
07437P,臺股指麥證9A售04,0,0,0,61000,30000,31000,0,0,0,31000,0,0,0,61000,30000,31000,31000
060415,葡萄王永豐9A購01,0,0,0,0,0,0,0,0,0,30000,0,0,0,40000,10000,30000,30000
06038P,國泰金台新96售01,0,0,0,0,0,0,0,0,0,30000,0,0,0,40000,10000,30000,30000
06034P,世芯凱基96售03  ,0,0,0,0,0,0,0,0,0,30000,0,0,0,30000,0,30000,30000
060588,台灣50台新9A購03,0,0,0,0,0,0,0,0,0,30000,0,0,0,30000,0,30000,30000
060582,玉晶光群益9C購01,0,0,0,0,0,0,0,0,0,30000,0,0,0,33000,3000,30000,30000
059660,華新科元大9A購04,0,0,0,0,0,0,0,0,0,30000,0,0,0,32000,2000,30000,30000
059981,聯發科元大99購36,0,0,0,0,0,0,0,0,0,30000,0,0,0,61000,31000,30000,30000
06327P,台積電中信01售01,0,0,0,0,0,0,0,0,0,30000,0,0,0,30000,0,30000,30000
06729P,聯詠元大98售03  ,0,0,0,0,0,0,0,0,0,30000,0,0,0,30000,0,30000,30000
06925P,致茂群益9A售02  ,0,0,0,0,0,0,0,0,0,30000,0,0,0,130000,100000,30000,30000
061274,臺股指凱基9A購24,0,0,0,0,0,0,0,0,0,30000,0,0,0,97000,67000,30000,30000
061276,T50反1台新9A購03,0,0,0,0,0,0,0,0,0,30000,0,0,0,30000,0,30000,30000
054442,啟碁台新96購01  ,0,0,0,0,0,0,0,0,0,30000,0,0,0,30000,0,30000,30000
054160,華泰凱基98購01  ,0,0,0,0,0,0,0,0,0,30000,0,0,0,32000,2000,30000,30000
058358,技嘉凱基9A購01  ,0,0,0,0,0,0,0,0,0,30000,0,0,0,31000,1000,30000,30000
056771,嘉晶元大99購01  ,0,0,0,0,0,0,0,0,0,30000,0,0,0,30000,0,30000,30000
056801,國巨台新98購01  ,0,0,0,0,0,0,0,0,0,30000,0,0,0,50000,20000,30000,30000
055815,亞光國票99購01  ,0,0,0,0,0,0,0,0,0,30000,0,0,0,40000,10000,30000,30000
053356,聯發科統一96購07,0,0,0,0,0,0,0,0,0,30000,0,0,0,30000,0,30000,30000
053327,彩晶台新97購01  ,0,0,0,0,0,0,0,0,0,30000,0,0,0,30000,0,30000,30000
053304,可成凱基96購03  ,0,0,0,0,0,0,0,0,0,30000,0,0,0,30000,0,30000,30000
053284,樺漢元大97購01  ,0,0,0,0,0,0,0,0,0,30000,0,0,0,30000,0,30000,30000
053162,緯穎元大97購01  ,0,0,0,0,0,0,0,0,0,30000,0,0,0,30000,0,30000,30000
054047,富邦金元大97購01,0,0,0,0,0,0,0,0,0,30000,0,0,0,30000,0,30000,30000
053999,台表科群益96購06,0,0,0,0,0,0,0,0,0,30000,0,0,0,30000,0,30000,30000
054075,GIS富邦97購02   ,0,0,0,0,0,0,0,0,0,30000,0,0,0,30000,0,30000,30000
05300P,健策元大95售02  ,0,0,0,0,0,0,0,0,0,30000,0,0,0,30000,0,30000,30000
052831,華固群益96購01  ,0,0,0,0,0,0,0,0,0,30000,0,0,0,30000,0,30000,30000
05288P,寶成元富95售02  ,0,0,0,0,0,0,0,0,0,30000,0,0,0,30000,0,30000,30000
052764,景碩群益98購01  ,0,0,0,0,0,0,0,0,0,30000,0,0,0,114000,84000,30000,30000
05062P,大立光富邦98售03,0,0,0,0,0,0,0,0,0,30000,0,0,0,30000,0,30000,30000
053531,國泰金康和96購01,0,0,0,0,0,0,0,0,0,30000,0,0,0,30000,0,30000,30000
053709,台達電凱基96購04,0,0,0,0,0,0,0,0,0,30000,0,0,0,30000,0,30000,30000
054751,GIS凱基98購01   ,0,0,0,0,0,0,0,0,0,30000,0,0,0,30000,0,30000,30000
053658,亞光凱基96購01  ,0,0,0,0,0,0,0,0,0,30000,0,0,0,30000,0,30000,30000
052011,欣興中信96購01  ,0,0,0,0,0,0,0,0,0,30000,0,0,0,70000,40000,30000,30000
051918,聯茂元大95購01  ,0,0,0,0,0,0,0,0,0,30000,0,0,0,113000,83000,30000,30000
050808,台達電凱基96購02,0,0,0,0,0,0,0,0,0,30000,0,0,0,50000,20000,30000,30000
050894,旺宏元大96購03  ,0,0,0,0,0,0,0,0,0,30000,0,0,0,36000,6000,30000,30000
050902,南電元大96購01  ,0,0,0,0,0,0,0,0,0,30000,0,0,0,30000,0,30000,30000
051404,牧德永豐96購01  ,0,0,0,0,0,0,0,0,0,30000,0,0,0,30000,0,30000,30000
051422,超眾國票96購01  ,0,0,0,0,0,0,0,0,0,30000,0,0,0,31000,1000,30000,30000
05124P,華新科富邦97售02,0,0,0,0,0,0,0,0,0,30000,0,0,0,30000,0,30000,30000
051553,牧德永豐96購02  ,0,0,0,0,0,0,0,0,0,30000,0,0,0,30000,0,30000,30000
051670,欣興元大95購06  ,0,0,0,0,0,0,0,0,0,30000,0,0,0,30000,0,30000,30000
046791,台郡統一96購01  ,0,0,0,0,0,0,0,0,0,30000,0,0,0,30000,0,30000,30000
052568,漢唐凱基96購02  ,0,0,0,0,0,0,0,0,0,30000,0,0,0,30000,0,30000,30000
052180,緯穎元大96購05  ,0,0,0,0,0,0,0,0,0,30000,0,0,0,30000,0,30000,30000
049659,旺宏台新95購01  ,0,0,0,0,0,0,0,0,0,30000,0,0,0,30000,0,30000,30000
049199,茂林永豐95購01  ,0,0,0,0,0,0,0,0,0,30000,0,0,0,30000,0,30000,30000
059188,京元電富邦9B購01,0,0,0,0,0,0,0,0,0,30000,0,0,0,82000,52000,30000,30000
059375,道瓊反群益9C購02,0,0,0,0,0,0,0,0,0,30000,0,0,0,30000,0,30000,30000
059401,牧德元富99購01  ,0,0,0,0,0,0,0,0,0,30000,0,0,0,30000,0,30000,30000
057134,茂林凱基98購02  ,0,0,0,0,0,0,0,0,0,30000,0,0,0,30000,0,30000,30000
056231,嘉聯益凱基97購02,0,0,0,0,0,0,0,0,0,30000,0,0,0,50000,20000,30000,30000
059126,臺指反中信9B購01,0,0,0,0,0,0,0,0,0,30000,0,0,0,30000,0,30000,30000
057068,國巨永豐98購06  ,0,0,0,0,0,0,0,0,0,30000,0,0,0,30000,0,30000,30000
056430,鴻海凱基98購06  ,0,0,0,0,0,0,0,0,0,30000,0,0,0,30000,0,30000,30000
057505,健策麥證98購01  ,0,0,0,30000,0,30000,0,0,0,30000,0,0,0,30000,0,30000,30000
057397,茂林中信9A購01  ,0,0,0,0,0,0,0,0,0,30000,0,0,0,30000,0,30000,30000
055476,台郡凱基97購02  ,0,0,0,0,0,0,0,0,0,30000,0,0,0,30000,0,30000,30000
056223,華邦電凱基97購04,0,0,0,0,0,0,0,0,0,30000,0,0,0,30000,0,30000,30000
056166,微星台新97購01  ,0,0,0,0,0,0,0,0,0,30000,0,0,0,30000,0,30000,30000
057741,超眾富邦98購01  ,0,0,0,0,0,0,0,0,0,30000,0,0,0,30000,0,30000,30000
058021,牧德凱基98購02  ,0,0,0,0,0,0,0,0,0,30000,0,0,0,30000,0,30000,30000
056079,世紀鋼元大97購02,0,0,0,0,0,0,0,0,0,30000,0,0,0,30000,0,30000,30000
058197,國巨中信99購02  ,0,0,0,0,0,0,0,0,0,30000,0,0,0,30000,0,30000,30000
056931,智原台新98購01  ,0,0,0,0,0,0,0,0,0,30000,0,0,0,30000,0,30000,30000
057924,健策凱基98購02  ,0,0,0,0,0,0,0,0,0,30000,0,0,0,30000,0,30000,30000
058561,T50反1凱基9A購05,0,0,0,0,0,0,0,0,0,30000,0,0,0,30000,0,30000,30000
07409P,台積電台新99售07,0,0,0,0,0,0,0,0,0,30000,0,0,0,30000,0,30000,30000
07336P,台灣50台新99售05,0,0,0,0,0,0,0,0,0,30000,0,0,0,30000,0,30000,30000
07289P,台灣50凱基99售07,0,0,0,0,0,0,0,0,0,30000,0,0,0,30000,0,30000,30000
07108P,FBVIX台新99售02 ,0,0,0,0,0,0,0,0,0,30000,0,0,0,30000,0,30000,30000
07215P,大立光凱基99售07,0,0,0,0,0,0,0,0,0,30000,0,0,0,30000,0,30000,30000
07619P,鴻海統一9A售03  ,0,0,0,0,0,0,0,0,0,30000,0,0,0,30000,0,30000,30000
07624P,台灣50台新9B售07,0,0,0,0,0,0,0,0,0,30000,0,0,0,30000,0,30000,30000
07644P,南電凱基9A售03  ,0,0,0,0,0,0,0,0,0,30000,0,0,0,30000,0,30000,30000
07493P,台灣50元大9A售10,0,0,0,0,0,0,0,0,0,30000,0,0,0,30000,0,30000,30000
07565P,台灣50台新9C售02,0,0,0,0,0,0,0,0,0,30000,0,0,0,30000,0,30000,30000
061285,大立光統一9A購04,0,0,0,0,0,0,0,0,0,29000,0,0,0,29000,0,29000,29000
061342,華新科元大9A購17,0,0,0,0,0,0,0,0,0,29000,0,0,0,44000,15000,29000,29000
061165,美律兆豐9A購01  ,0,0,0,0,0,0,0,0,0,29000,0,0,0,29000,0,29000,29000
06848P,聯詠元大98售04  ,0,0,0,0,0,0,0,0,0,29000,0,0,0,30000,1000,29000,29000
06718P,聯詠元大98售01  ,0,0,0,0,0,0,0,0,0,29000,0,0,0,30000,1000,29000,29000
054799,超眾群益98購01  ,0,0,0,0,0,0,0,0,0,29000,0,0,0,49000,20000,29000,29000
054742,京鼎凱基99購01  ,0,0,0,0,0,0,0,0,0,29000,0,0,0,93000,64000,29000,29000
054904,興勤康和97購01  ,0,0,0,0,0,0,0,0,0,29000,0,0,0,29000,0,29000,29000
054025,鴻海凱基96購17  ,0,0,0,0,0,0,0,0,0,29000,0,0,0,79000,50000,29000,29000
058348,台表科群益99購01,0,0,0,0,0,0,0,0,0,29000,0,0,0,31000,2000,29000,29000
058006,台郡群益98購04  ,0,0,0,0,0,0,0,0,0,29000,0,0,0,29000,0,29000,29000
054260,貿聯元大96購03  ,0,0,0,0,0,0,0,0,0,29000,0,0,0,29000,0,29000,29000
057925,貿聯凱基99購01  ,0,0,0,0,0,0,0,0,0,29000,0,0,0,29000,0,29000,29000
058118,瑞昱群益99購01  ,0,0,0,0,0,0,0,0,0,29000,0,0,0,99000,70000,29000,29000
056379,玉晶光元富98購01,0,0,0,0,0,0,0,0,0,29000,0,0,0,29000,0,29000,29000
058684,健策凱基99購02  ,0,0,0,0,0,0,0,0,0,29000,0,0,0,48000,19000,29000,29000
057542,上銀凱基99購01  ,0,0,0,0,0,0,0,0,0,29000,0,0,0,48000,19000,29000,29000
058763,和碩群益99購01  ,0,0,0,0,0,0,0,0,0,29000,0,0,0,93000,64000,29000,29000
058745,元金2X凱基9C購02,0,0,0,0,0,0,0,0,0,29000,0,0,0,29000,0,29000,29000
059129,麗豐中信99購01  ,0,0,0,0,0,0,0,0,0,29000,0,0,0,49000,20000,29000,29000
057129,聯發科凱基99購03,0,0,0,0,0,0,0,0,0,29000,0,0,0,29000,0,29000,29000
059348,日月光凱基99購01,0,0,0,0,0,0,0,0,0,29000,0,0,0,103000,74000,29000,29000
07293P,臺股指凱基99售45,0,0,0,0,0,0,0,0,0,29000,0,0,0,55000,26000,29000,29000
2428,興勤            ,150000,105000,45000,0,0,0,0,0,0,-16000,0,1000,-1000,1000,16000,-15000,29000
4155,訊映            ,95000,66000,29000,0,0,0,0,0,0,0,0,0,0,0,0,0,29000
061616,鴻海群益9A購07  ,0,0,0,0,0,0,0,0,0,28000,0,0,0,28000,0,28000,28000
061094,彩晶統一9B購02  ,0,0,0,0,0,0,0,0,0,28000,0,0,0,30000,2000,28000,28000
060921,中橡永豐9A購02  ,0,0,0,0,0,0,0,0,0,28000,0,0,0,58000,30000,28000,28000
061275,臺股指凱基9A購25,0,0,0,0,0,0,0,0,0,28000,0,0,0,77000,49000,28000,28000
060250,台表科元大9A購01,0,0,0,0,0,0,0,0,0,28000,0,0,0,34000,6000,28000,28000
060592,上銀麥證9A購01  ,0,0,0,28000,0,28000,0,0,0,28000,0,0,0,28000,0,28000,28000
060837,上銀國票9A購04  ,0,0,0,0,0,0,0,0,0,28000,0,0,0,43000,15000,28000,28000
06085P,義隆台新97售01  ,0,0,0,0,0,0,0,0,0,28000,0,0,0,29000,1000,28000,28000
05520P,聯詠凱基96售01  ,0,0,0,0,0,0,0,0,0,28000,0,0,0,28000,0,28000,28000
055360,台表科凱基97購02,0,0,0,0,0,0,0,0,0,28000,0,0,0,48000,20000,28000,28000
053849,聯發科元富96購04,0,0,0,0,0,0,0,0,0,28000,0,0,0,38000,10000,28000,28000
020000,富邦特選蘋果N   ,0,0,0,0,0,0,0,0,0,28000,0,0,0,32000,4000,28000,28000
052239,泰鼎國票97購01  ,0,0,0,0,0,0,0,0,0,28000,0,0,0,28000,0,28000,28000
059490,國巨國票99購09  ,0,0,0,0,0,0,0,0,0,28000,0,0,0,28000,0,28000,28000
059295,大立光元富99購05,0,0,0,0,0,0,0,0,0,28000,0,0,0,550000,522000,28000,28000
057136,立積凱基98購02  ,0,0,0,0,0,0,0,0,0,28000,0,0,0,47000,19000,28000,28000
05656P,台表科統一96售01,0,0,0,0,0,0,0,0,0,28000,0,0,0,28000,0,28000,28000
058610,欣興元大99購05  ,0,0,0,0,0,0,0,0,0,28000,0,0,0,31000,3000,28000,28000
056409,麗豐國票99購01  ,0,0,0,0,0,0,0,0,0,28000,0,0,0,68000,40000,28000,28000
05639P,欣興統一97售01  ,0,0,0,0,0,0,0,0,0,28000,0,0,0,30000,2000,28000,28000
055597,禾伸堂元大98購02,0,0,0,0,0,0,0,0,0,28000,0,0,0,30000,2000,28000,28000
058191,祥碩永豐99購01  ,0,0,0,0,0,0,0,0,0,28000,0,0,0,72000,44000,28000,28000
058181,華新科國泰9B購01,0,0,0,0,0,0,0,0,0,28000,0,0,0,103000,75000,28000,28000
057690,美律凱基99購03  ,0,0,0,0,0,0,0,0,0,28000,0,0,0,28000,0,28000,28000
8341,日友            ,57000,52000,5000,0,0,0,20000,0,20000,3000,3000,0,3000,0,0,0,28000
07188P,臺股指台新99售11,0,0,0,0,0,0,0,0,0,28000,0,0,0,30000,2000,28000,28000
060780,祥碩國泰9B購01  ,0,0,0,0,0,0,0,0,0,27000,0,0,0,164000,137000,27000,27000
060593,華通麥證9A購01  ,0,0,0,38000,11000,27000,0,0,0,27000,0,0,0,38000,11000,27000,27000
060505,友達元大9C購05  ,0,0,0,0,0,0,0,0,0,27000,0,0,0,32000,5000,27000,27000
06041P,全新永豐96售03  ,0,0,0,0,0,0,0,0,0,27000,0,0,0,27000,0,27000,27000
059723,美律元大9A購02  ,0,0,0,0,0,0,0,0,0,27000,0,0,0,81000,54000,27000,27000
059851,晶相光永豐99購02,0,0,0,0,0,0,0,0,0,27000,0,0,0,38000,11000,27000,27000
061290,玉晶光統一01購04,0,0,0,0,0,0,0,0,0,27000,0,0,0,31000,4000,27000,27000
061320,奇力新凱基9A購04,0,0,0,0,0,0,0,0,0,27000,0,0,0,27000,0,27000,27000
061389,華新科群益9B購01,0,0,0,0,0,0,0,0,0,27000,0,0,0,28000,1000,27000,27000
060983,南亞科元大9A購06,0,0,0,0,0,0,0,0,0,27000,0,0,0,27000,0,27000,27000
06371P,茂林國票98售04  ,0,0,0,0,0,0,0,0,0,27000,0,0,0,38000,11000,27000,27000
06177P,玉晶光元大98售07,0,0,0,0,0,0,0,0,0,27000,0,0,0,27000,0,27000,27000
06677P,牧德國票98售02  ,0,0,0,0,0,0,0,0,0,27000,0,0,0,27000,0,27000,27000
06845P,億光元大98售02  ,0,0,0,0,0,0,0,0,0,27000,0,0,0,60000,33000,27000,27000
06833P,矽力群益99售01  ,0,0,0,0,0,0,0,0,0,27000,0,0,0,27000,0,27000,27000
06763P,技嘉元大98售05  ,0,0,0,0,0,0,0,0,0,27000,0,0,0,38000,11000,27000,27000
06926P,可成群益9A售04  ,0,0,0,0,0,0,0,0,0,27000,0,0,0,29000,2000,27000,27000
03433B,臺股指元大9C熊01,0,0,0,0,0,0,0,0,0,27000,0,0,0,150000,123000,27000,27000
049684,彩晶統一95購01  ,0,0,0,0,0,0,0,0,0,27000,0,0,0,37000,10000,27000,27000
054897,信錦康和97購01  ,0,0,0,0,0,0,0,0,0,27000,0,0,0,27000,0,27000,27000
054597,南亞台新97購01  ,0,0,0,0,0,0,0,0,0,27000,0,0,0,27000,0,27000,27000
058250,台虹元大99購01  ,0,0,0,0,0,0,0,0,0,27000,0,0,0,77000,50000,27000,27000
057637,上銀元大98購07  ,0,0,0,0,0,0,0,0,0,27000,0,0,0,52000,25000,27000,27000
05848P,臺股指元大96售24,0,0,0,0,0,0,0,0,0,27000,0,0,0,30000,3000,27000,27000
056135,緯創元大98購01  ,0,0,0,0,0,0,0,0,0,27000,0,0,0,73000,46000,27000,27000
056524,欣興中信98購02  ,0,0,0,0,0,0,0,0,0,27000,0,0,0,79000,52000,27000,27000
058583,臻鼎群益99購01  ,0,0,0,0,0,0,0,0,0,27000,0,0,0,166000,139000,27000,27000
058413,義隆兆豐99購01  ,0,0,0,0,0,0,0,0,0,27000,0,0,0,41000,14000,27000,27000
055803,鎧勝永豐97購01  ,0,0,0,0,0,0,0,0,0,27000,0,0,0,27000,0,27000,27000
059438,群創元大99購06  ,0,0,0,0,0,0,0,0,0,27000,0,0,0,275000,248000,27000,27000
07127P,精元元大99售01  ,0,0,0,0,0,0,0,0,0,27000,0,0,0,27000,0,27000,27000
07080P,健策群益9A售01  ,0,0,0,0,0,0,0,0,0,27000,0,0,0,27000,0,27000,27000
07248P,可成凱基99售06  ,0,0,0,0,0,0,0,0,0,27000,0,0,0,27000,0,27000,27000
07659P,中租凱基9A售02  ,0,0,0,0,0,0,0,0,0,27000,0,0,0,27000,0,27000,27000
07606P,台灣50國票01售02,0,0,0,0,0,0,0,0,0,27000,0,0,0,35000,8000,27000,27000
3563,牧德            ,208000,102000,106000,0,0,0,92000,124000,-32000,-47000,3000,15000,-12000,1000,36000,-35000,27000
06096P,全新永豐97售02  ,0,0,0,0,0,0,0,0,0,26000,0,0,0,39000,13000,26000,26000
061111,台表科元大9A購02,0,0,0,0,0,0,0,0,0,26000,0,0,0,29000,3000,26000,26000
059878,聯茂凱基99購07  ,0,0,0,0,0,0,0,0,0,26000,0,0,0,31000,5000,26000,26000
060891,世芯統一9A購01  ,0,0,0,0,0,0,0,0,0,26000,0,0,0,26000,0,26000,26000
060576,欣興中信9B購01  ,0,0,0,0,0,0,0,0,0,26000,0,0,0,73000,47000,26000,26000
060677,京元電元大9A購04,0,0,0,0,0,0,0,0,0,26000,0,0,0,64000,38000,26000,26000
058318,致茂永豐9A購01  ,0,0,0,0,0,0,0,0,0,26000,0,0,0,26000,0,26000,26000
054335,緯穎永豐96購02  ,0,0,0,0,0,0,0,0,0,26000,0,0,0,46000,20000,26000,26000
055351,聯發科凱基97購03,0,0,0,0,0,0,0,0,0,26000,0,0,0,26000,0,26000,26000
053721,國泰金凱基97購01,0,0,0,0,0,0,0,0,0,26000,0,0,0,26000,0,26000,26000
051641,矽創國票96購01  ,0,0,0,0,0,0,0,0,0,26000,0,0,0,26000,0,26000,26000
051903,T50反1元大97購02,0,0,0,0,0,0,0,0,0,26000,0,0,0,26000,0,26000,26000
052672,世紀鋼群益96購02,0,0,0,0,0,0,0,0,0,26000,0,0,0,26000,0,26000,26000
03418B,臺股指元大95熊20,0,0,0,0,0,0,0,0,0,26000,0,0,0,28000,2000,26000,26000
049156,緯穎元大96購01  ,0,0,0,0,0,0,0,0,0,26000,0,0,0,26000,0,26000,26000
05915P,聯發科元大96售19,0,0,0,0,0,0,0,0,0,26000,0,0,0,30000,4000,26000,26000
057152,緯穎國票99購03  ,0,0,0,0,0,0,0,0,0,26000,0,0,0,33000,7000,26000,26000
057353,玉晶光統一99購01,0,0,0,0,0,0,0,0,0,26000,0,0,0,44000,18000,26000,26000
057421,智原凱基98購04  ,0,0,0,0,0,0,0,0,0,26000,0,0,0,26000,0,26000,26000
056387,智伸科國泰99購01,0,0,0,0,0,0,0,0,0,26000,0,0,0,26000,0,26000,26000
057773,技嘉群益9A購02  ,0,0,0,0,0,0,0,0,0,26000,0,0,0,100000,74000,26000,26000
057031,滬深反元大9B購02,0,0,0,0,0,0,0,0,0,26000,0,0,0,30000,4000,26000,26000
058930,華新科統一9B購01,0,0,0,0,0,0,0,0,0,26000,0,0,0,31000,5000,26000,26000
058503,鴻海元大99購14  ,0,0,0,0,0,0,0,0,0,26000,0,0,0,102000,76000,26000,26000
07365P,超眾元大99售07  ,0,0,0,0,0,0,0,0,0,26000,0,0,0,26000,0,26000,26000
08100P,台灣50元富95售01,0,0,0,0,0,0,0,0,0,26000,0,0,0,26000,0,26000,26000
1439,中和            ,149000,123000,26000,0,0,0,0,0,0,0,0,0,0,0,0,0,26000
060830,T50反1國票9A購07,0,0,0,0,0,0,0,0,0,25000,0,0,0,25000,0,25000,25000
060586,玉晶光元富9A購03,0,0,0,0,0,0,0,0,0,25000,0,0,0,25000,0,25000,25000
060278,道瓊反元大9A購03,0,0,0,0,0,0,0,0,0,25000,0,0,0,135000,110000,25000,25000
059968,世紀鋼凱基99購03,0,0,0,0,0,0,0,0,0,25000,0,0,0,25000,0,25000,25000
047213,新日興富邦97購01,0,0,0,0,0,0,0,0,0,25000,0,0,0,25000,0,25000,25000
052748,群創元大9A購02  ,0,0,0,0,0,0,0,0,0,25000,0,0,0,25000,0,25000,25000
050842,旺宏國票97購01  ,0,0,0,0,0,0,0,0,0,25000,0,0,0,135000,110000,25000,25000
051552,牧德永豐95購03  ,0,0,0,0,0,0,0,0,0,25000,0,0,0,25000,0,25000,25000
054828,正崴國泰99購01  ,0,0,0,0,0,0,0,0,0,25000,0,0,0,36000,11000,25000,25000
053642,瀚宇博永豐96購01,0,0,0,0,0,0,0,0,0,25000,0,0,0,25000,0,25000,25000
053894,創意群益96購01  ,0,0,0,0,0,0,0,0,0,25000,0,0,0,25000,0,25000,25000
052920,景碩台新96購02  ,0,0,0,0,0,0,0,0,0,25000,0,0,0,25000,0,25000,25000
054066,緯穎國票97購03  ,0,0,0,0,0,0,0,0,0,25000,0,0,0,25000,0,25000,25000
055121,鴻海兆豐97購03  ,0,0,0,0,0,0,0,0,0,25000,0,0,0,45000,20000,25000,25000
053313,世紀鋼凱基96購01,0,0,0,0,0,0,0,0,0,25000,0,0,0,49000,24000,25000,25000
054218,S&P反1統一98購02,0,0,0,0,0,0,0,0,0,25000,0,0,0,25000,0,25000,25000
05412P,泰碩國票95售02  ,0,0,0,0,0,0,0,0,0,25000,0,0,0,40000,15000,25000,25000
058816,祥碩台新99購02  ,0,0,0,0,0,0,0,0,0,25000,0,0,0,25000,0,25000,25000
057917,台積電凱基98購17,0,0,0,0,0,0,0,0,0,25000,0,0,0,25000,0,25000,25000
055719,可成元大97購03  ,0,0,0,0,0,0,0,0,0,25000,0,0,0,25000,0,25000,25000
058723,元石油國泰9A購01,0,0,0,0,0,0,0,0,0,25000,0,0,0,25000,0,25000,25000
055667,致茂群益98購01  ,0,0,0,0,0,0,0,0,0,25000,0,0,0,25000,0,25000,25000
057589,超眾國票9A購01  ,0,0,0,0,0,0,0,0,0,25000,0,0,0,26000,1000,25000,25000
05875P,旺宏群益98售01  ,0,0,0,0,0,0,0,0,0,25000,0,0,0,31000,6000,25000,25000
056441,燿華凱基98購01  ,0,0,0,0,0,0,0,0,0,25000,0,0,0,30000,5000,25000,25000
056479,玉晶光元大99購05,0,0,0,0,0,0,0,0,0,25000,0,0,0,33000,8000,25000,25000
056247,台郡群益97購01  ,0,0,0,0,0,0,0,0,0,25000,0,0,0,25000,0,25000,25000
057599,技嘉群益9A購01  ,0,0,0,0,0,0,0,0,0,25000,0,0,0,50000,25000,25000,25000
057296,智原永豐98購01  ,0,0,0,0,0,0,0,0,0,25000,0,0,0,35000,10000,25000,25000
059308,T50反1元大99購07,50000,0,50000,0,0,0,0,0,0,-25000,0,0,0,30000,55000,-25000,25000
05938P,旺宏凱基96售07  ,0,0,0,0,0,0,0,0,0,25000,0,0,0,25000,0,25000,25000
07317P,T50正2凱基9B售02,0,0,0,0,0,0,0,0,0,25000,0,0,0,27000,2000,25000,25000
07140P,台灣50日盛99售01,0,0,0,0,0,0,0,0,0,25000,0,0,0,25000,0,25000,25000
07535P,上銀元富9A售03  ,0,0,0,0,0,0,0,0,0,25000,0,0,0,103000,78000,25000,25000
07706P,長榮航元大9A售03,0,0,0,0,0,0,0,0,0,25000,0,0,0,25000,0,25000,25000
2474,可成            ,2578000,2547504,30496,0,0,0,3000,0,3000,-9000,35000,125000,-90000,104000,23000,81000,24496
059946,健策永豐99購05  ,0,0,0,0,0,0,0,0,0,24000,0,0,0,24000,0,24000,24000
060057,欣興凱基9B購01  ,0,0,0,0,0,0,0,0,0,24000,0,0,0,34000,10000,24000,24000
060616,宏碁元大9A購02  ,0,0,0,0,0,0,0,0,0,24000,0,0,0,99000,75000,24000,24000
061112,台表科元大9A購03,0,0,0,0,0,0,0,0,0,24000,0,0,0,54000,30000,24000,24000
060964,日月光凱基9A購01,0,0,0,0,0,0,0,0,0,24000,0,0,0,24000,0,24000,24000
061070,超眾凱基9C購01  ,0,0,0,0,0,0,0,0,0,24000,0,0,0,35000,11000,24000,24000
061397,上銀台新9A購01  ,0,0,0,0,0,0,0,0,0,24000,0,0,0,24000,0,24000,24000
061339,京元電元大9A購05,0,0,0,0,0,0,0,0,0,24000,0,0,0,70000,46000,24000,24000
061509,SP黃豆富邦9C購01,0,0,0,0,0,0,0,0,0,24000,0,0,0,28000,4000,24000,24000
06496P,台灣50日盛98售01,0,0,0,0,0,0,0,0,0,24000,0,0,0,24000,0,24000,24000
06172P,台虹永豐97售02  ,0,0,0,0,0,0,0,0,0,24000,0,0,0,24000,0,24000,24000
054164,強茂凱基98購01  ,0,0,0,0,0,0,0,0,0,24000,0,0,0,208000,184000,24000,24000
054596,聯發科麥證97購01,0,0,0,24000,0,24000,0,0,0,24000,0,0,0,24000,0,24000,24000
054556,世芯凱基99購01  ,0,0,0,0,0,0,0,0,0,24000,0,0,0,26000,2000,24000,24000
054480,和碩中信98購01  ,0,0,0,0,0,0,0,0,0,24000,0,0,0,54000,30000,24000,24000
055256,日電貿統一99購01,0,0,0,0,0,0,0,0,0,24000,0,0,0,124000,100000,24000,24000
052867,晶技凱基96購01  ,0,0,0,0,0,0,0,0,0,24000,0,0,0,24000,0,24000,24000
052821,晶技永豐96購01  ,0,0,0,0,0,0,0,0,0,24000,0,0,0,26000,2000,24000,24000
055282,聯發科元大97購15,0,0,0,0,0,0,0,0,0,24000,0,0,0,24000,0,24000,24000
055311,健策群益98購02  ,0,0,0,0,0,0,0,0,0,24000,0,0,0,24000,0,24000,24000
05011P,南電國泰96售01  ,0,0,0,0,0,0,0,0,0,24000,0,0,0,30000,6000,24000,24000
048747,華通元富97購01  ,0,0,0,0,0,0,0,0,0,24000,0,0,0,24000,0,24000,24000
057843,晶技永豐98購02  ,0,0,0,0,0,0,0,0,0,24000,0,0,0,49000,25000,24000,24000
057583,啟碁中信9A購01  ,0,0,0,0,0,0,0,0,0,24000,0,0,0,56000,32000,24000,24000
057531,禾伸堂元大99購04,0,0,0,0,0,0,0,0,0,24000,0,0,0,25000,1000,24000,24000
058478,聯發科凱基9A購01,0,0,0,0,0,0,0,0,0,24000,0,0,0,24000,0,24000,24000
058621,華通國票9A購01  ,0,0,0,0,0,0,0,0,0,24000,0,0,0,27000,3000,24000,24000
056356,台積電元大99購01,0,0,0,0,0,0,0,0,0,24000,0,0,0,24000,0,24000,24000
056936,禾伸堂元富98購01,0,0,0,0,0,0,0,0,0,24000,0,0,0,84000,60000,24000,24000
056872,旺宏凱基98購08  ,0,0,0,0,0,0,0,0,0,24000,0,0,0,24000,0,24000,24000
058821,泰鼎國泰9B購01  ,0,0,0,0,0,0,0,0,0,24000,0,0,0,90000,66000,24000,24000
057946,晶相光國票99購01,0,0,0,0,0,0,0,0,0,24000,0,0,0,24000,0,24000,24000
058032,大立光永豐98購05,0,0,0,0,0,0,0,0,0,24000,0,0,0,24000,0,24000,24000
07752P,台灣50元大9C售33,0,0,0,0,0,0,0,0,0,24000,0,0,0,35000,11000,24000,24000
07032P,聯發科統一9C售02,0,0,0,0,0,0,0,0,0,24000,0,0,0,24000,0,24000,24000
06738P,瑞昱兆豐98售02  ,0,0,0,0,0,0,0,0,0,23000,0,0,0,23000,0,23000,23000
061446,鴻海中信04購01  ,0,0,0,0,0,0,0,0,0,23000,0,0,0,25000,2000,23000,23000
060425,凌華永豐9A購01  ,0,0,0,0,0,0,0,0,0,23000,0,0,0,75000,52000,23000,23000
060221,大立光凱基9A購07,0,0,0,0,0,0,0,0,0,23000,0,0,0,35000,12000,23000,23000
050519,旺宏元大95購03  ,0,0,0,0,0,0,0,0,0,23000,0,0,0,23000,0,23000,23000
054728,聯發科日盛97購01,0,0,0,0,0,0,0,0,0,23000,0,0,0,33000,10000,23000,23000
055402,正文元富97購02  ,0,0,0,0,0,0,0,0,0,23000,0,0,0,98000,75000,23000,23000
055036,中工富邦9B購01  ,0,0,0,0,0,0,0,0,0,23000,0,0,0,90000,67000,23000,23000
055054,群光永豐97購01  ,0,0,0,0,0,0,0,0,0,23000,0,0,0,23000,0,23000,23000
057926,帆宣凱基98購02  ,0,0,0,0,0,0,0,0,0,23000,0,0,0,289000,266000,23000,23000
058854,樺漢群益9B購01  ,0,0,0,0,0,0,0,0,0,23000,0,0,0,176000,153000,23000,23000
055773,瑞昱凱基97購03  ,0,0,0,0,0,0,0,0,0,23000,0,0,0,23000,0,23000,23000
057280,大立光元大98購15,0,0,0,0,0,0,0,0,0,23000,0,0,0,23000,0,23000,23000
07434P,臺股指國票9A售06,0,0,0,0,0,0,0,0,0,23000,0,0,0,119000,96000,23000,23000
2739,寒舍            ,36000,13000,23000,0,0,0,0,0,0,0,0,0,0,0,0,0,23000
1449,佳和            ,170000,147000,23000,0,0,0,0,0,0,0,0,0,0,0,0,0,23000
060403,上銀國泰9B購01  ,0,0,0,0,0,0,0,0,0,22000,0,0,0,22000,0,22000,22000
060281,卜蜂元大9C購01  ,0,0,0,0,0,0,0,0,0,22000,0,0,0,80000,58000,22000,22000
060716,新唐永豐9A購01  ,0,0,0,0,0,0,0,0,0,22000,0,0,0,22000,0,22000,22000
061335,國巨元大9A購19  ,0,0,0,0,0,0,0,0,0,22000,0,0,0,22000,0,22000,22000
061358,世紀鋼元大9A購04,0,0,0,0,0,0,0,0,0,22000,0,0,0,86000,64000,22000,22000
06903P,技嘉凱基98售04  ,0,0,0,0,0,0,0,0,0,22000,0,0,0,98000,76000,22000,22000
06744P,嘉聯益永豐98售03,0,0,0,0,0,0,0,0,0,22000,0,0,0,22000,0,22000,22000
06431P,新日興元大97售05,0,0,0,0,0,0,0,0,0,22000,0,0,0,88000,66000,22000,22000
061560,友達國票9B購01  ,0,0,0,0,0,0,0,0,0,22000,0,0,0,37000,15000,22000,22000
052979,上銀元大96購02  ,0,0,0,0,0,0,0,0,0,22000,0,0,0,22000,0,22000,22000
053898,康友群益97購01  ,0,0,0,0,0,0,0,0,0,22000,0,0,0,22000,0,22000,22000
057613,瑞昱元富02購02  ,0,0,0,0,0,0,0,0,0,22000,0,0,0,117000,95000,22000,22000
058274,世紀鋼永豐99購01,0,0,0,0,0,0,0,0,0,22000,0,0,0,62000,40000,22000,22000
058010,帆宣國票98購01  ,0,0,0,0,0,0,0,0,0,22000,0,0,0,107000,85000,22000,22000
054569,GIS群益98購01   ,0,0,0,0,0,0,0,0,0,22000,0,0,0,22000,0,22000,22000
053522,臺股指群益99購01,0,0,0,0,0,0,0,0,0,22000,0,0,0,22000,0,22000,22000
05138P,嘉聯益凱基96售02,0,0,0,0,0,0,0,0,0,22000,0,0,0,26000,4000,22000,22000
051961,泰碩永豐95購01  ,0,0,0,0,0,0,0,0,0,22000,0,0,0,22000,0,22000,22000
052067,中磊兆豐96購01  ,0,0,0,0,0,0,0,0,0,22000,0,0,0,32000,10000,22000,22000
048383,元金2X國票99購01,0,0,0,0,0,0,0,0,0,22000,0,0,0,49000,27000,22000,22000
059114,華新科永豐99購05,0,0,0,0,0,0,0,0,0,22000,0,0,0,22000,0,22000,22000
059491,國巨國票9A購05  ,0,0,0,0,0,0,0,0,0,22000,0,0,0,22000,0,22000,22000
05947P,大成鋼元大96售03,0,0,0,0,0,0,0,0,0,22000,0,0,0,35000,13000,22000,22000
059473,T50反1群益99購03,0,0,0,0,0,0,0,0,0,22000,0,0,0,22000,0,22000,22000
059185,臺股指台新99購12,0,0,0,0,0,0,0,0,0,22000,0,0,0,22000,0,22000,22000
057346,鴻海統一98購13  ,0,0,0,0,0,0,0,0,0,22000,0,0,0,22000,0,22000,22000
05774P,臺股指凱基99售04,0,0,0,0,0,0,0,0,0,22000,0,0,0,22000,0,22000,22000
058557,健策第一01購01  ,0,0,0,0,0,0,0,0,0,22000,0,0,0,22000,0,22000,22000
057001,華邦電國票99購02,0,0,0,0,0,0,0,0,0,22000,0,0,0,169000,147000,22000,22000
058072,大立光凱基98購20,0,0,0,0,0,0,0,0,0,22000,0,0,0,22000,0,22000,22000
058192,訊芯永豐99購01  ,0,0,0,0,0,0,0,0,0,22000,0,0,0,57000,35000,22000,22000
07788P,華新科群益9A售08,0,0,0,0,0,0,0,0,0,22000,0,0,0,22000,0,22000,22000
07792P,牧德元大9A售04  ,0,0,0,0,0,0,0,0,0,22000,0,0,0,27000,5000,22000,22000
5534,長虹            ,154000,132429,21571,0,0,0,0,0,0,0,0,0,0,0,0,0,21571
06621P,欣興元大98售06  ,0,0,0,0,0,0,0,0,0,21000,0,0,0,25000,4000,21000,21000
061059,世芯國票9B購01  ,0,0,0,0,0,0,0,0,0,21000,0,0,0,27000,6000,21000,21000
061236,台積電元大9A購24,0,0,0,0,0,0,0,0,0,21000,0,0,0,41000,20000,21000,21000
060707,台郡富邦9A購01  ,0,0,0,0,0,0,0,0,0,21000,0,0,0,206000,185000,21000,21000
060841,宏達電國票9B購01,0,0,0,0,0,0,0,0,0,21000,0,0,0,24000,3000,21000,21000
060340,國巨統一01購02  ,0,0,0,0,0,0,0,0,0,21000,0,0,0,40000,19000,21000,21000
060167,禾聯碩永豐9A購01,0,0,0,0,0,0,0,0,0,21000,0,0,0,21000,0,21000,21000
060113,祥碩元大9B購01  ,0,0,0,0,0,0,0,0,0,21000,0,0,0,100000,79000,21000,21000
059765,嘉聯益永豐99購02,0,0,0,0,0,0,0,0,0,21000,0,0,0,85000,64000,21000,21000
059571,奇力新凱基99購06,0,0,0,0,0,0,0,0,0,21000,0,0,0,21000,0,21000,21000
049492,聯發科元大95購02,0,0,0,0,0,0,0,0,0,21000,0,0,0,21000,0,21000,21000
051970,元黃金凱基98購01,0,0,0,0,0,0,0,0,0,21000,0,0,0,21000,0,21000,21000
05268P,玉晶光元大98售01,0,0,0,0,0,0,0,0,0,21000,0,0,0,21000,0,21000,21000
050778,瑞儀元大96購01  ,0,0,0,0,0,0,0,0,0,21000,0,0,0,21000,0,21000,21000
051854,鴻海麥證95購04  ,0,0,0,21000,0,21000,0,0,0,21000,0,0,0,21000,0,21000,21000
055834,國巨元大97購13  ,0,0,0,0,0,0,0,0,0,21000,0,0,0,58000,37000,21000,21000
055017,緯穎元富97購01  ,0,0,0,0,0,0,0,0,0,21000,0,0,0,21000,0,21000,21000
053392,致新元大96購01  ,0,0,0,0,0,0,0,0,0,21000,0,0,0,73000,52000,21000,21000
056116,義隆群益97購02  ,0,0,0,0,0,0,0,0,0,21000,0,0,0,226000,205000,21000,21000
058042,鴻海元大98購12  ,0,0,0,0,0,0,0,0,0,21000,0,0,0,21000,0,21000,21000
056362,聯發科元大99購01,0,0,0,0,0,0,0,0,0,21000,0,0,0,21000,0,21000,21000
05637P,聯電元大96售04  ,0,0,0,0,0,0,0,0,0,21000,0,0,0,21000,0,21000,21000
058970,鴻海永豐99購02  ,0,0,0,0,0,0,0,0,0,21000,0,0,0,279000,258000,21000,21000
056568,台表科群益98購01,0,0,0,0,0,0,0,0,0,21000,0,0,0,26000,5000,21000,21000
059501,可成元富99購01  ,0,0,0,0,0,0,0,0,0,21000,0,0,0,45000,24000,21000,21000
059332,台灣50國票9A購07,0,0,0,0,0,0,0,0,0,21000,0,0,0,21000,0,21000,21000
058402,欣興元大99購04  ,0,0,0,0,0,0,0,0,0,21000,0,0,0,51000,30000,21000,21000
07653P,華新科群益9A售05,0,0,0,0,0,0,0,0,0,21000,0,0,0,21000,0,21000,21000
07160P,台灣50中信03售04,0,0,0,0,0,0,0,0,0,21000,0,0,0,21000,0,21000,21000
059621,T50正2凱基9C購04,0,0,0,0,0,0,0,0,0,20000,0,0,0,20000,0,20000,20000
059693,智原永豐99購01  ,0,0,0,0,0,0,0,0,0,20000,0,0,0,20000,0,20000,20000
05974P,國巨富邦97售03  ,0,0,0,0,0,0,0,0,0,20000,0,0,0,20000,0,20000,20000
059805,台積電元富99購02,0,0,0,0,0,0,0,0,0,20000,0,0,0,100000,80000,20000,20000
059859,國巨群益9A購03  ,0,0,0,0,0,0,0,0,0,20000,0,0,0,20000,0,20000,20000
060062,聯發科兆豐99購04,0,0,0,0,0,0,0,0,0,20000,0,0,0,20000,0,20000,20000
060836,上銀國票9A購03  ,0,0,0,0,0,0,0,0,0,20000,0,0,0,23000,3000,20000,20000
060806,華新科群益9A購03,0,0,0,0,0,0,0,0,0,20000,0,0,0,20000,0,20000,20000
060776,世芯凱基9B購01  ,0,1000,-1000,0,0,0,0,0,0,21000,0,0,0,125000,104000,21000,20000
06077P,GIS凱基97售02   ,0,0,0,0,0,0,0,0,0,20000,0,0,0,20000,0,20000,20000
060695,同欣電麥證9A購01,0,0,0,20000,0,20000,0,0,0,20000,0,0,0,20000,0,20000,20000
060678,聯詠元大9A購03  ,0,0,0,0,0,0,0,0,0,20000,0,0,0,81000,61000,20000,20000
060754,華通元大9A購04  ,0,0,0,0,0,0,0,0,0,20000,0,0,0,85000,65000,20000,20000
061223,T50反1中信01購01,0,0,0,0,0,0,0,0,0,20000,0,0,0,20000,0,20000,20000
060978,國巨元大9A購13  ,0,0,0,0,0,0,0,0,0,20000,0,0,0,43000,23000,20000,20000
06094P,台達電中信97售01,0,0,0,0,0,0,0,0,0,20000,0,0,0,20000,0,20000,20000
061404,臺指反國票04購01,0,0,0,0,0,0,0,0,0,20000,0,0,0,20000,0,20000,20000
061280,國巨統一9C購06  ,0,0,0,0,0,0,0,0,0,20000,0,0,0,20000,0,20000,20000
061424,華新科元大9A購18,0,0,0,0,0,0,0,0,0,20000,0,0,0,20000,0,20000,20000
06720P,智邦亞東99售01  ,0,0,0,0,0,0,0,0,0,20000,0,0,0,20000,0,20000,20000
06545P,致茂元大98售01  ,0,0,0,0,0,0,0,0,0,20000,0,0,0,60000,40000,20000,20000
06737P,台郡凱基98售07  ,0,0,0,0,0,0,0,0,0,20000,0,0,0,70000,50000,20000,20000
06828P,臺股指國票98售04,0,0,0,0,0,0,0,0,0,20000,0,0,0,20000,0,20000,20000
06437P,玉晶光國票99售01,0,0,0,0,0,0,0,0,0,20000,0,0,0,20000,0,20000,20000
06374P,台表科元大97售06,0,0,0,0,0,0,0,0,0,20000,0,0,0,20000,0,20000,20000
053480,祥碩元大96購02  ,0,0,0,0,0,0,0,0,0,20000,0,0,0,40000,20000,20000,20000
054018,華新台新96購01  ,0,0,0,0,0,0,0,0,0,20000,0,0,0,20000,0,20000,20000
05399P,GIS國票95售03   ,0,0,0,0,0,0,0,0,0,20000,0,0,0,20000,0,20000,20000
053155,晶技元大97購02  ,0,0,0,0,0,0,0,0,0,20000,0,0,0,20000,0,20000,20000
054999,玉晶光元富97購03,0,0,0,0,0,0,0,0,0,20000,0,0,0,20000,0,20000,20000
052916,華新科富邦96購01,0,0,0,0,0,0,0,0,0,20000,0,0,0,20000,0,20000,20000
053837,貿聯永豐96購02  ,0,0,0,0,0,0,0,0,0,20000,0,0,0,20000,0,20000,20000
055470,南亞科凱基97購01,0,0,0,0,0,0,0,0,0,20000,0,0,0,20000,0,20000,20000
053800,華通凱基97購03  ,0,0,0,0,0,0,0,0,0,20000,0,0,0,27000,7000,20000,20000
055299,康友元大97購02  ,0,0,0,0,0,0,0,0,0,20000,0,0,0,20000,0,20000,20000
055281,台光電元大98購03,0,0,0,0,0,0,0,0,0,20000,0,0,0,20000,0,20000,20000
055343,國巨凱基97購03  ,0,0,0,0,0,0,0,0,0,20000,0,0,0,20000,0,20000,20000
055394,健策統一97購01  ,0,0,0,0,0,0,0,0,0,20000,0,0,0,20000,0,20000,20000
055824,臺股指國票97購11,0,0,0,0,0,0,0,0,0,20000,0,0,0,100000,80000,20000,20000
055826,中石化元大97購01,0,0,0,0,0,0,0,0,0,20000,0,0,0,20000,0,20000,20000
055838,致茂元大97購03  ,0,0,0,0,0,0,0,0,0,20000,0,0,0,20000,0,20000,20000
057961,茂林元大9A購01  ,0,0,0,0,0,0,0,0,0,20000,0,0,0,20000,0,20000,20000
057993,中環中信98購01  ,0,0,0,0,0,0,0,0,0,20000,0,0,0,20000,0,20000,20000
058292,上銀凱基9A購01  ,0,0,0,0,0,0,0,0,0,20000,0,0,0,20000,0,20000,20000
058334,鴻海元富99購05  ,0,0,0,0,0,0,0,0,0,20000,0,0,0,20000,0,20000,20000
058335,鴻海元富99購06  ,0,0,0,0,0,0,0,0,0,20000,0,0,0,20000,0,20000,20000
058342,鴻海群益9A購01  ,0,0,0,0,0,0,0,0,0,20000,0,0,0,20000,0,20000,20000
054683,川湖永豐97購01  ,0,0,0,0,0,0,0,0,0,20000,0,0,0,20000,0,20000,20000
055188,亞翔統一97購01  ,0,0,0,0,0,0,0,0,0,20000,0,0,0,20000,0,20000,20000
055192,世芯元富97購01  ,0,0,0,0,0,0,0,0,0,20000,0,0,0,20000,0,20000,20000
05452P,亞德客群益95售02,0,0,0,0,0,0,0,0,0,20000,0,0,0,20000,0,20000,20000
054161,友訊凱基98購01  ,0,0,0,0,0,0,0,0,0,20000,0,0,0,20000,0,20000,20000
054256,創意元大96購07  ,0,0,0,0,0,0,0,0,0,20000,0,0,0,20000,0,20000,20000
054337,智邦統一96購01  ,0,0,0,0,0,0,0,0,0,20000,0,0,0,20000,0,20000,20000
051026,健策統一96購01  ,0,0,0,0,0,0,0,0,0,20000,0,0,0,20000,0,20000,20000
050847,創意國票96購01  ,0,0,0,0,0,0,0,0,0,20000,0,0,0,20000,0,20000,20000
050786,健策國泰96購01  ,0,0,0,0,0,0,0,0,0,20000,0,0,0,20000,0,20000,20000
051808,美律凱基96購02  ,0,0,0,0,0,0,0,0,0,20000,0,0,0,20000,0,20000,20000
052705,超眾國票97購01  ,0,0,0,0,0,0,0,0,0,20000,0,0,0,20000,0,20000,20000
051602,南茂兆豐96購01  ,0,0,0,0,0,0,0,0,0,20000,0,0,0,20000,0,20000,20000
053551,可成凱基96購05  ,0,0,0,0,0,0,0,0,0,20000,0,0,0,20000,0,20000,20000
053545,上銀凱基96購03  ,0,0,0,0,0,0,0,0,0,20000,0,0,0,20000,0,20000,20000
053593,晶技元大98購01  ,0,0,0,0,0,0,0,0,0,20000,0,0,0,72000,52000,20000,20000
050480,健策國票95購04  ,0,0,0,0,0,0,0,0,0,20000,0,0,0,20000,0,20000,20000
050545,奇力新凱基95購01,0,0,0,0,0,0,0,0,0,20000,0,0,0,20000,0,20000,20000
054761,台光電國票98購02,0,0,0,0,0,0,0,0,0,20000,0,0,0,33000,13000,20000,20000
054795,合勤控群益98購01,0,0,0,0,0,0,0,0,0,20000,0,0,0,20000,0,20000,20000
054801,康友群益97購02  ,0,0,0,0,0,0,0,0,0,20000,0,0,0,20000,0,20000,20000
053627,宏碁兆豐97購01  ,0,0,0,0,0,0,0,0,0,20000,0,0,0,20000,0,20000,20000
053727,麗豐凱基97購01  ,0,0,0,0,0,0,0,0,0,20000,0,0,0,20000,0,20000,20000
053761,健策國泰98購01  ,0,0,0,0,0,0,0,0,0,20000,0,0,0,30000,10000,20000,20000
054886,大毅統一97購01  ,0,0,0,0,0,0,0,0,0,20000,0,0,0,22000,2000,20000,20000
054888,泰碩統一97購01  ,0,0,0,0,0,0,0,0,0,20000,0,0,0,20000,0,20000,20000
049264,奇鋐元大95購01  ,0,0,0,0,0,0,0,0,0,20000,0,0,0,20000,0,20000,20000
04935P,鴻海中信96售01  ,0,0,0,0,0,0,0,0,0,20000,0,0,0,20000,0,20000,20000
045600,道瓊指國票95購01,0,0,0,0,0,0,0,0,0,20000,0,0,0,20000,0,20000,20000
047995,台達電元大96購01,0,0,0,0,0,0,0,0,0,20000,0,0,0,20000,0,20000,20000
048070,聯發科元富99購03,0,0,0,0,0,0,0,0,0,20000,0,0,0,20000,0,20000,20000
048122,台達電元大96購02,0,0,0,0,0,0,0,0,0,20000,0,0,0,20000,0,20000,20000
047194,世紀鋼元大96購01,0,0,0,0,0,0,0,0,0,20000,0,0,0,20000,0,20000,20000
03618C,高股息凱基95牛01,0,0,0,0,0,0,0,0,0,20000,0,0,0,20000,0,20000,20000
052221,東元凱基95購01  ,0,0,0,0,0,0,0,0,0,20000,0,0,0,20000,0,20000,20000
052374,瑞昱元大95購02  ,0,0,0,0,0,0,0,0,0,20000,0,0,0,29000,9000,20000,20000
052300,力成台新95購01  ,0,0,0,0,0,0,0,0,0,20000,0,0,0,20000,0,20000,20000
052523,奇力新元大97購01,0,0,0,0,0,0,0,0,0,20000,0,0,0,20000,0,20000,20000
057263,可成兆豐99購01  ,0,0,0,0,0,0,0,0,0,20000,0,0,0,20000,0,20000,20000
057273,智邦元大98購05  ,0,0,0,0,0,0,0,0,0,20000,0,0,0,20000,0,20000,20000
056259,T50反1統一9A購01,0,0,0,0,0,0,0,0,0,20000,0,0,0,31000,11000,20000,20000
056305,群創元大9A購03  ,0,0,0,0,0,0,0,0,0,20000,0,0,0,20000,0,20000,20000
059054,國巨凱基99購11  ,0,0,0,0,0,0,0,0,0,20000,0,0,0,20000,0,20000,20000
059081,和大元大99購01  ,0,0,0,0,0,0,0,0,0,20000,0,0,0,20000,0,20000,20000
056328,訊芯兆豐98購01  ,0,0,0,0,0,0,0,0,0,20000,0,0,0,20000,0,20000,20000
059202,禾聯碩永豐99購01,0,0,0,0,0,0,0,0,0,20000,0,0,0,20000,0,20000,20000
059175,臺股指凱基99購26,0,0,0,0,0,0,0,0,0,20000,0,0,0,20000,0,20000,20000
059316,國巨元大99購23  ,0,0,0,0,0,0,0,0,0,20000,0,0,0,20000,0,20000,20000
059304,華新科兆豐99購06,0,0,0,0,0,0,0,0,0,20000,0,0,0,20000,0,20000,20000
056600,聯茂元富98購01  ,0,0,0,0,0,0,0,0,0,20000,0,0,0,20000,0,20000,20000
056592,台積電元富98購01,0,0,0,0,0,0,0,0,0,20000,0,0,0,20000,0,20000,20000
05667P,旺宏台新96售01  ,0,0,0,0,0,0,0,0,0,20000,0,0,0,20000,0,20000,20000
056721,台灣50永昌9A購01,0,0,0,0,0,0,0,0,0,20000,0,0,0,20000,0,20000,20000
056478,晶技元大99購01  ,0,0,0,0,0,0,0,0,0,20000,0,0,0,20000,0,20000,20000
056428,台達電凱基99購01,0,0,0,0,0,0,0,0,0,20000,0,0,0,20000,0,20000,20000
057827,康友元大98購03  ,0,0,0,0,0,0,0,0,0,20000,0,0,0,20000,0,20000,20000
057108,潤泰全群益98購01,0,0,0,0,0,0,0,0,0,20000,0,0,0,20000,0,20000,20000
058781,康友國票9A購01  ,0,0,0,0,0,0,0,0,0,20000,0,0,0,134000,114000,20000,20000
057309,南茂兆豐99購01  ,0,0,0,0,0,0,0,0,0,20000,0,0,0,40000,20000,20000,20000
057549,台光電凱基98購05,0,0,0,0,0,0,0,0,0,20000,0,0,0,30000,10000,20000,20000
057577,廣宇中信9A購01  ,0,0,0,0,0,0,0,0,0,20000,0,0,0,30000,10000,20000,20000
057748,華通國票98購04  ,0,0,0,0,0,0,0,0,0,20000,0,0,0,25000,5000,20000,20000
056168,鴻海元富97購07  ,0,0,0,0,0,0,0,0,0,20000,0,0,0,20000,0,20000,20000
056181,百和元富97購02  ,0,0,0,0,0,0,0,0,0,20000,0,0,0,20000,0,20000,20000
055537,康友群益97購03  ,0,0,0,0,0,0,0,0,0,20000,0,0,0,20000,0,20000,20000
055705,微星永豐97購01  ,0,0,0,0,0,0,0,0,0,20000,0,0,0,40000,20000,20000,20000
058675,康控群益9B購01  ,0,0,0,0,0,0,0,0,0,20000,0,0,0,20000,0,20000,20000
058108,台郡台新99購01  ,0,0,0,0,0,0,0,0,0,20000,0,0,0,20000,0,20000,20000
058551,義隆永豐99購03  ,0,0,0,0,0,0,0,0,0,20000,0,0,0,20000,0,20000,20000
056139,貿聯元大97購04  ,0,0,0,0,0,0,0,0,0,20000,0,0,0,104000,84000,20000,20000
057920,奇力新凱基98購08,0,0,0,0,0,0,0,0,0,20000,0,0,0,20000,0,20000,20000
05763P,致新永豐96售01  ,0,0,0,0,0,0,0,0,0,20000,0,0,0,20000,0,20000,20000
056898,全新元大98購02  ,0,0,0,0,0,0,0,0,0,20000,0,0,0,20000,0,20000,20000
058940,聯發科中信9A購03,0,0,0,0,0,0,0,0,0,20000,0,0,0,20000,0,20000,20000
058918,SGBR2X元富99購04,0,0,0,0,0,0,0,0,0,20000,0,0,0,20000,0,20000,20000
058811,台積電統一9A購05,0,0,0,0,0,0,0,0,0,20000,0,0,0,20000,0,20000,20000
07141P,台灣50國票9A售03,0,0,0,0,0,0,0,0,0,20000,0,0,0,20000,0,20000,20000
07227P,聯發科元富99售05,0,0,0,0,0,0,0,0,0,20000,0,0,0,20000,0,20000,20000
07005P,台積電統一9B售05,0,0,0,0,0,0,0,0,0,20000,0,0,0,140000,120000,20000,20000
07395P,台積電群益99售13,0,0,0,0,0,0,0,0,0,20000,0,0,0,40000,20000,20000,20000
07369P,台積電凱基99售20,0,0,0,0,0,0,0,0,0,20000,0,0,0,20000,0,20000,20000
07337P,台灣50凱基99售09,0,0,0,0,0,0,0,0,0,20000,0,0,0,20000,0,20000,20000
07314P,T50正2元大9C售03,0,0,0,0,0,0,0,0,0,20000,0,0,0,20000,0,20000,20000
07272P,台灣50元大9C售05,0,0,0,0,0,0,0,0,0,20000,0,0,0,20000,0,20000,20000
07623P,大立光統一9B售05,0,0,0,0,0,0,0,0,0,20000,0,0,0,40000,20000,20000,20000
07574P,國巨元大9A售12  ,0,0,0,0,0,0,0,0,0,20000,0,0,0,170000,150000,20000,20000
07522P,台積電中信9A售03,0,0,0,0,0,0,0,0,0,20000,0,0,0,20000,0,20000,20000
07794P,智邦國票9A售03  ,0,0,0,0,0,0,0,0,0,20000,0,0,0,99000,79000,20000,20000
07779P,鴻海凱基9B售04  ,0,0,0,0,0,0,0,0,0,20000,0,0,0,20000,0,20000,20000
1786,科妍            ,49000,29000,20000,0,0,0,0,0,0,0,1000,1000,0,0,0,0,20000
2887E,台新戊特        ,0,0,0,0,0,0,0,0,0,20000,20000,0,20000,0,0,0,20000
3022,威強電          ,116000,96000,20000,0,0,0,0,0,0,0,0,0,0,0,0,0,20000
2059,川湖            ,124375,105000,19375,0,0,0,0,0,0,0,0,0,0,0,0,0,19375
06535P,可成群益99售02  ,0,0,0,0,0,0,0,0,0,19000,0,0,0,19000,0,19000,19000
06681P,致茂元大98售02  ,0,0,0,0,0,0,0,0,0,19000,0,0,0,19000,0,19000,19000
06137P,玉晶光永豐97售04,0,0,0,0,0,0,0,0,0,19000,0,0,0,120000,101000,19000,19000
060755,鴻海元大9A購15  ,0,0,0,0,0,0,0,0,0,19000,0,0,0,69000,50000,19000,19000
060337,FBVIX統一9A購01 ,0,0,0,0,0,0,0,0,0,19000,0,0,0,107000,88000,19000,19000
060560,欣興國泰9C購01  ,0,0,0,0,0,0,0,0,0,19000,0,0,0,25000,6000,19000,19000
060554,中租凱基9A購01  ,0,0,0,0,0,0,0,0,0,19000,0,0,0,67000,48000,19000,19000
06006P,欣興永豐96售04  ,0,0,0,0,0,0,0,0,0,19000,0,0,0,19000,0,19000,19000
060131,GIS永豐99購03   ,0,0,0,0,0,0,0,0,0,19000,0,0,0,32000,13000,19000,19000
059853,超眾永豐99購03  ,0,0,0,0,0,0,0,0,0,19000,0,0,0,29000,10000,19000,19000
059634,可成凱基99購07  ,0,0,0,0,0,0,0,0,0,19000,0,0,0,25000,6000,19000,19000
00733,富邦臺灣中小    ,0,0,0,0,0,0,0,0,0,19000,0,0,0,223000,204000,19000,19000
00666R,富邦恒生國企反1 ,0,0,0,0,0,0,0,0,0,19000,0,0,0,99000,80000,19000,19000
054767,日電貿國票98購01,0,0,0,0,0,0,0,0,0,19000,0,0,0,39000,20000,19000,19000
051795,T50反1台新05購02,0,0,0,0,0,0,0,0,0,19000,0,0,0,29000,10000,19000,19000
051487,健策凱基96購03  ,0,0,0,0,0,0,0,0,0,19000,0,0,0,19000,0,19000,19000
051941,樺漢群益95購02  ,0,0,0,0,0,0,0,0,0,19000,0,0,0,19000,0,19000,19000
055230,大毅國票98購01  ,0,0,0,0,0,0,0,0,0,19000,0,0,0,32000,13000,19000,19000
054554,大立光凱基98購02,0,0,0,0,0,0,0,0,0,19000,0,0,0,24000,5000,19000,19000
058226,世芯元富99購01  ,0,0,0,0,0,0,0,0,0,19000,0,0,0,45000,26000,19000,19000
057619,玉晶光凱基98購02,0,0,0,0,0,0,0,0,0,19000,0,0,0,47000,28000,19000,19000
057901,大立光永豐98購04,0,0,0,0,0,0,0,0,0,19000,0,0,0,19000,0,19000,19000
058703,台積電元大99購16,0,0,0,0,0,0,0,0,0,19000,0,0,0,55000,36000,19000,19000
058424,滬深2X元富99購04,0,0,0,0,0,0,0,0,0,19000,0,0,0,40000,21000,19000,19000
056176,創意元富97購01  ,0,0,0,0,0,0,0,0,0,19000,0,0,0,30000,11000,19000,19000
057313,聯發科麥證99購01,0,0,0,19000,0,19000,0,0,0,19000,0,0,0,19000,0,19000,19000
057799,世紀鋼兆豐98購01,0,0,0,0,0,0,0,0,0,19000,0,0,0,19000,0,19000,19000
05649P,矽創國票97售03  ,0,0,0,0,0,0,0,0,0,19000,0,0,0,19000,0,19000,19000
059231,華通國票9A購04  ,0,0,0,0,0,0,0,0,0,19000,0,0,0,24000,5000,19000,19000
059347,京鼎凱基99購02  ,0,0,0,0,0,0,0,0,0,19000,0,0,0,29000,10000,19000,19000
07408P,台積電兆豐99售06,0,0,0,0,0,0,0,0,0,19000,0,0,0,71000,52000,19000,19000
07015P,國巨元大99售13  ,0,0,0,0,0,0,0,0,0,19000,0,0,0,19000,0,19000,19000
6277,宏正            ,63000,43000,20000,0,0,0,0,0,0,-1000,0,1000,-1000,0,0,0,19000
059614,致新永豐99購01  ,0,0,0,0,0,0,0,0,0,18000,0,0,0,154000,136000,18000,18000
060028,國揚永豐99購01  ,0,0,0,0,0,0,0,0,0,18000,0,0,0,32000,14000,18000,18000
060473,中租元大9A購03  ,0,0,0,0,0,0,0,0,0,18000,0,0,0,55000,37000,18000,18000
060267,上緯控國票9C購01,0,0,0,0,0,0,0,0,0,18000,0,0,0,56000,38000,18000,18000
061209,聯發科元大9A購10,0,0,0,0,0,0,0,0,0,18000,0,0,0,38000,20000,18000,18000
061562,群創國票9B購01  ,0,0,0,0,0,0,0,0,0,18000,0,0,0,26000,8000,18000,18000
058232,聯發科元大99購05,0,0,0,0,0,0,0,0,0,18000,0,0,0,18000,0,18000,18000
057960,聯鈞元大98購02  ,0,0,0,0,0,0,0,0,0,18000,0,0,0,68000,50000,18000,18000
054195,亞泥國泰98購01  ,0,0,0,0,0,0,0,0,0,18000,0,0,0,18000,0,18000,18000
055382,台郡元大99購01  ,0,0,0,0,0,0,0,0,0,18000,0,0,0,18000,0,18000,18000
054907,帆宣康和97購01  ,0,0,0,0,0,0,0,0,0,18000,0,0,0,58000,40000,18000,18000
052882,南電凱基96購02  ,0,0,0,0,0,0,0,0,0,18000,0,0,0,18000,0,18000,18000
053134,南亞科國票97購01,0,0,0,0,0,0,0,0,0,18000,0,0,0,50000,32000,18000,18000
054710,東元元富97購01  ,0,0,0,0,0,0,0,0,0,18000,0,0,0,229000,211000,18000,18000
053502,智伸科兆豐97購01,0,0,0,0,0,0,0,0,0,18000,0,0,0,18000,0,18000,18000
059435,大立光元大99購17,0,0,0,0,0,0,0,0,0,18000,0,0,0,18000,0,18000,18000
057239,貿聯凱基98購05  ,0,0,0,0,0,0,0,0,0,18000,0,0,0,28000,10000,18000,18000
057056,立積元大99購02  ,0,0,0,0,0,0,0,0,0,18000,0,0,0,91000,73000,18000,18000
057369,奇力新元大99購05,0,0,0,0,0,0,0,0,0,18000,0,0,0,18000,0,18000,18000
05551P,電子類元大96售01,0,0,0,0,0,0,0,0,0,18000,0,0,0,26000,8000,18000,18000
058719,智邦元富99購01  ,0,0,0,0,0,0,0,0,0,18000,0,0,0,18000,0,18000,18000
07830P,牧德凱基9A售03  ,0,0,0,0,0,0,0,0,0,18000,0,0,0,38000,20000,18000,18000
06712P,臺股指台新99售09,0,0,0,0,0,0,0,0,0,17000,0,0,0,22000,5000,17000,17000
061238,晶技元大9A購02  ,0,0,0,0,0,0,0,0,0,17000,0,0,0,117000,100000,17000,17000
061380,巨大永豐9A購02  ,0,0,0,0,0,0,0,0,0,17000,0,0,0,616000,599000,17000,17000
061432,世紀鋼元大9A購05,0,0,0,0,0,0,0,0,0,17000,0,0,0,82000,65000,17000,17000
061458,臻鼎凱基9A購02  ,0,0,0,0,0,0,0,0,0,17000,0,0,0,39000,22000,17000,17000
059974,臺指反元大9C購05,0,0,0,0,0,0,0,0,0,17000,0,0,0,17000,0,17000,17000
060211,智邦康和9A購01  ,0,0,0,0,0,0,0,0,0,17000,0,0,0,17000,0,17000,17000
059581,日月光元富99購02,0,0,0,0,0,0,0,0,0,17000,0,0,0,471000,454000,17000,17000
054695,世芯永豐98購01  ,0,0,0,0,0,0,0,0,0,17000,0,0,0,27000,10000,17000,17000
054825,康友元大97購01  ,0,0,0,0,0,0,0,0,0,17000,0,0,0,17000,0,17000,17000
051490,世芯凱基96購01  ,0,0,0,0,0,0,0,0,0,17000,0,0,0,23000,6000,17000,17000
051450,世芯元大95購02  ,0,0,0,0,0,0,0,0,0,17000,0,0,0,17000,0,17000,17000
051789,嘉澤國票96購01  ,0,0,0,0,0,0,0,0,0,17000,0,0,0,17000,0,17000,17000
053438,玉晶光麥證97購02,0,0,0,18000,1000,17000,0,0,0,17000,0,0,0,18000,1000,17000,17000
055079,台光電中信97購01,0,0,0,0,0,0,0,0,0,17000,0,0,0,17000,0,17000,17000
054363,世芯凱基97購01  ,0,0,0,0,0,0,0,0,0,17000,0,0,0,17000,0,17000,17000
057958,禾伸堂元大99購05,0,0,0,0,0,0,0,0,0,17000,0,0,0,100000,83000,17000,17000
056794,上銀麥證98購01  ,0,0,0,30000,13000,17000,0,0,0,17000,0,0,0,30000,13000,17000,17000
055909,大成鋼凱基98購02,0,0,0,0,0,0,0,0,0,17000,0,0,0,63000,46000,17000,17000
055716,致茂元大97購01  ,0,0,0,0,0,0,0,0,0,17000,0,0,0,19000,2000,17000,17000
058622,國巨國票99購07  ,0,0,0,0,0,0,0,0,0,17000,0,0,0,263000,246000,17000,17000
056190,昇陽半統一97購01,0,0,0,0,0,0,0,0,0,17000,0,0,0,68000,51000,17000,17000
058015,旺宏凱基99購02  ,0,0,0,0,0,0,0,0,0,17000,0,0,0,22000,5000,17000,17000
05923P,旺宏元富96售05  ,0,0,0,0,0,0,0,0,0,17000,0,0,0,17000,0,17000,17000
059216,台積電元大99購29,0,0,0,0,0,0,0,0,0,17000,0,0,0,17000,0,17000,17000
07306P,台灣50凱基9A售09,0,0,0,0,0,0,0,0,0,17000,0,0,0,17000,0,17000,17000
9912,偉聯            ,17000,0,17000,0,0,0,0,0,0,0,0,0,0,0,0,0,17000
059754,訊芯群益9A購01  ,0,0,0,0,0,0,0,0,0,16000,0,0,0,24000,8000,16000,16000
060824,旺宏元大9A購06  ,0,0,0,0,0,0,0,0,0,16000,0,0,0,101000,85000,16000,16000
061277,智邦台新9A購01  ,0,0,0,0,0,0,0,0,0,16000,0,0,0,45000,29000,16000,16000
061103,聯發科元大9A購08,0,0,0,0,0,0,0,0,0,16000,0,0,0,31000,15000,16000,16000
06660P,大立光富邦9B售03,0,0,0,0,0,0,0,0,0,16000,0,0,0,16000,0,16000,16000
056791,嘉聯益群益98購01,0,0,0,0,0,0,0,0,0,16000,0,0,0,139000,123000,16000,16000
056770,國產元大98購02  ,0,0,0,0,0,0,0,0,0,16000,0,0,0,18000,2000,16000,16000
057990,美律統一99購02  ,0,0,0,0,0,0,0,0,0,16000,0,0,0,16000,0,16000,16000
057975,台積電永豐98購05,0,0,0,0,0,0,0,0,0,16000,0,0,0,18000,2000,16000,16000
054420,緯穎元大96購08  ,0,0,0,0,0,0,0,0,0,16000,0,0,0,46000,30000,16000,16000
05331P,上証2X國票96售01,0,0,0,0,0,0,0,0,0,16000,0,0,0,16000,0,16000,16000
053935,華通元富96購02  ,0,0,0,0,0,0,0,0,0,16000,0,0,0,17000,1000,16000,16000
05161P,華新科國票96售01,0,0,0,0,0,0,0,0,0,16000,0,0,0,52000,36000,16000,16000
051323,康控國票96購01  ,0,0,0,0,0,0,0,0,0,16000,0,0,0,36000,20000,16000,16000
05059P,大立光國票96售02,0,0,0,0,0,0,0,0,0,16000,0,0,0,20000,4000,16000,16000
050256,臺指反元大98購03,0,0,0,0,0,0,0,0,0,16000,0,0,0,16000,0,16000,16000
046629,群創統一98購01  ,0,0,0,0,0,0,0,0,0,16000,0,0,0,46000,30000,16000,16000
058385,創意中信99購01  ,0,0,0,0,0,0,0,0,0,16000,0,0,0,46000,30000,16000,16000
056703,群創國泰9A購01  ,0,0,0,0,0,0,0,0,0,16000,0,0,0,16000,0,16000,16000
058895,鴻海元大99購20  ,0,0,0,0,0,0,0,0,0,16000,0,0,0,16000,0,16000,16000
07396P,聯發科群益9B售01,0,0,0,0,0,0,0,0,0,16000,0,0,0,20000,4000,16000,16000
07146P,瑞昱元大99售02  ,0,0,0,0,0,0,0,0,0,16000,0,0,0,16000,0,16000,16000
06581P,南亞科凱基98售04,0,0,0,0,0,0,0,0,0,15000,0,0,0,15000,0,15000,15000
061143,道瓊指中信9C購04,0,0,0,0,0,0,0,0,0,15000,0,0,0,15000,0,15000,15000
061176,聯發科凱基9A購14,0,0,0,0,0,0,0,0,0,15000,0,0,0,15000,0,15000,15000
060984,南亞科元大9A購07,0,0,0,0,0,0,0,0,0,15000,0,0,0,28000,13000,15000,15000
061006,新光金兆豐9A購01,0,0,0,0,0,0,0,0,0,15000,0,0,0,15000,0,15000,15000
061288,大立光統一9C購01,0,0,0,0,0,0,0,0,0,15000,0,0,0,15000,0,15000,15000
060894,奇力新凱基9A購03,0,0,0,0,0,0,0,0,0,15000,0,0,0,15000,0,15000,15000
060306,台肥永豐9A購01  ,0,0,0,0,0,0,0,0,0,15000,0,0,0,100000,85000,15000,15000
060309,佳世達永豐9A購01,0,0,0,0,0,0,0,0,0,15000,0,0,0,15000,0,15000,15000
060399,康友國票9A購02  ,0,0,0,0,0,0,0,0,0,15000,0,0,0,28000,13000,15000,15000
05983P,聯詠國票96售02  ,0,0,0,0,0,0,0,0,0,15000,0,0,0,25000,10000,15000,15000
059873,華新科凱基99購09,0,0,0,0,0,0,0,0,0,15000,0,0,0,20000,5000,15000,15000
059661,大立光元大99購22,0,0,0,0,0,0,0,0,0,15000,0,0,0,15000,0,15000,15000
060101,大立光元大99購31,0,0,0,0,0,0,0,0,0,15000,0,0,0,20000,5000,15000,15000
059986,宏達電元大99購08,0,0,0,0,0,0,0,0,0,15000,0,0,0,15000,0,15000,15000
03686P,大立光統一98售02,0,0,0,0,0,0,0,0,0,15000,0,0,0,15000,0,15000,15000
050049,華通群益96購01  ,0,0,0,0,0,0,0,0,0,15000,0,0,0,15000,0,15000,15000
053507,百和兆豐96購01  ,0,0,0,0,0,0,0,0,0,15000,0,0,0,60000,45000,15000,15000
054830,世芯國泰99購01  ,0,0,0,0,0,0,0,0,0,15000,0,0,0,16000,1000,15000,15000
05479P,華新科台新96售01,0,0,0,0,0,0,0,0,0,15000,0,0,0,15000,0,15000,15000
053689,台光電元大96購01,0,0,0,0,0,0,0,0,0,15000,0,0,0,15000,0,15000,15000
051413,富邦金國票96購02,0,0,0,0,0,0,0,0,0,15000,0,0,0,15000,0,15000,15000
052647,晶技永豐97購01  ,0,0,0,0,0,0,0,0,0,15000,0,0,0,15000,0,15000,15000
050791,聯發科富邦96購01,0,0,0,0,0,0,0,0,0,15000,0,0,0,15000,0,15000,15000
055019,福懋科元富97購01,0,0,0,0,0,0,0,0,0,15000,0,0,0,20000,5000,15000,15000
055387,世紀鋼元大97購01,0,0,0,0,0,0,0,0,0,15000,0,0,0,30000,15000,15000,15000
055239,帆宣台新97購01  ,0,0,0,0,0,0,0,0,0,15000,0,0,0,15000,0,15000,15000
054516,國巨元大97購02  ,0,0,0,0,0,0,0,0,0,15000,0,0,0,15000,0,15000,15000
058003,FBVIX群益9C購02 ,0,0,0,0,0,0,0,0,0,15000,0,0,0,15000,0,15000,15000
058277,FBVIX中信03購01 ,0,0,0,0,0,0,0,0,0,15000,0,0,0,15000,0,15000,15000
056813,聯茂統一99購01  ,0,0,0,0,0,0,0,0,0,15000,0,0,0,15000,0,15000,15000
055701,亞德客富邦99購01,0,0,0,0,0,0,0,0,0,15000,0,0,0,90000,75000,15000,15000
055793,臺股指凱基97購16,0,0,0,0,0,0,0,0,0,15000,0,0,0,15000,0,15000,15000
056512,易華電永豐98購01,0,0,0,0,0,0,0,0,0,15000,0,0,0,20000,5000,15000,15000
058040,FBVIX元大98購01 ,0,0,0,0,0,0,0,0,0,15000,0,0,0,15000,0,15000,15000
058165,FBVIX凱基9C購01 ,0,0,0,0,0,0,0,0,0,15000,0,0,0,15000,0,15000,15000
056105,智原永豐97購01  ,0,0,0,0,0,0,0,0,0,15000,0,0,0,15000,0,15000,15000
05757P,旺宏永豐96售03  ,0,0,0,0,0,0,0,0,0,15000,0,0,0,15000,0,15000,15000
058793,鴻海元大99購19  ,0,0,0,0,0,0,0,0,0,15000,0,0,0,15000,0,15000,15000
057211,鴻海群益98購05  ,0,0,0,0,0,0,0,0,0,15000,0,0,0,149000,134000,15000,15000
05901P,臺股指凱基9C售01,0,0,0,0,0,0,0,0,0,15000,0,0,0,15000,0,15000,15000
059020,元油2X統一9B購02,0,0,0,0,0,0,0,0,0,15000,0,0,0,32000,17000,15000,15000
059085,鴻海元大99購25  ,0,0,0,0,0,0,0,0,0,15000,0,0,0,52000,37000,15000,15000
05911P,南亞科永豐96售03,0,0,0,0,0,0,0,0,0,15000,0,0,0,15000,0,15000,15000
05921P,同欣電元大96售06,0,0,0,0,0,0,0,0,0,15000,0,0,0,15000,0,15000,15000
059273,臺指反元大9C購03,0,0,0,0,0,0,0,0,0,15000,0,0,0,15000,0,15000,15000
059339,上銀凱基99購06  ,0,0,0,0,0,0,0,0,0,15000,0,0,0,20000,5000,15000,15000
059509,奇力新永豐99購02,0,0,0,0,0,0,0,0,0,15000,0,0,0,21000,6000,15000,15000
07371P,滬深2X元大99售07,0,0,0,0,0,0,0,0,0,15000,0,0,0,25000,10000,15000,15000
07260P,台灣50元大9A售01,0,0,0,0,0,0,0,0,0,15000,0,0,0,20000,5000,15000,15000
07751P,世紀鋼凱基9A售02,0,0,0,0,0,0,0,0,0,15000,0,0,0,20000,5000,15000,15000
07686P,祥碩凱基9A售02  ,0,0,0,0,0,0,0,0,0,15000,0,0,0,30000,15000,15000,15000
07587P,台灣50國票9A售11,0,0,0,0,0,0,0,0,0,15000,0,0,0,15000,0,15000,15000
07626P,台灣50凱基04售07,0,0,0,0,0,0,0,0,0,15000,0,0,0,18000,3000,15000,15000
4552,力達-KY         ,77000,62000,15000,0,0,0,0,0,0,0,0,0,0,0,0,0,15000
00662,富邦NASDAQ      ,2088,1000,1088,0,0,0,0,0,0,13000,0,0,0,316000,303000,13000,14088
060164,合勤控永豐9A購01,0,0,0,0,0,0,0,0,0,14000,0,0,0,14000,0,14000,14000
059694,創意永豐99購03  ,0,0,0,0,0,0,0,0,0,14000,0,0,0,15000,1000,14000,14000
059705,華新科凱基9A購07,0,0,0,0,0,0,0,0,0,14000,0,0,0,16000,2000,14000,14000
060293,緯創元大9A購01  ,0,0,0,0,0,0,0,0,0,14000,0,0,0,142000,128000,14000,14000
060584,玉晶光元富9A購01,0,0,0,0,0,0,0,0,0,14000,0,0,0,21000,7000,14000,14000
060853,健策國泰9B購02  ,0,0,0,0,0,0,0,0,0,14000,0,0,0,14000,0,14000,14000
061224,道瓊反中信01購01,0,0,0,0,0,0,0,0,0,14000,0,0,0,22000,8000,14000,14000
061713,華邦電凱基9A購01,0,0,0,0,0,0,0,0,0,14000,0,0,0,14000,0,14000,14000
03896P,長榮航凱基95售01,0,0,0,0,0,0,0,0,0,14000,0,0,0,14000,0,14000,14000
035277,景碩台新97購01  ,0,0,0,0,0,0,0,0,0,14000,0,0,0,14000,0,14000,14000
05118P,超眾元大96售04  ,0,0,0,0,0,0,0,0,0,14000,0,0,0,14000,0,14000,14000
055460,華擎永豐97購01  ,0,0,0,0,0,0,0,0,0,14000,0,0,0,44000,30000,14000,14000
052823,創意永豐96購02  ,0,0,0,0,0,0,0,0,0,14000,0,0,0,86000,72000,14000,14000
055038,華航富邦99購01  ,0,0,0,0,0,0,0,0,0,14000,0,0,0,14000,0,14000,14000
054918,華新科凱基98購02,0,0,0,0,0,0,0,0,0,14000,0,0,0,14000,0,14000,14000
055114,新日興凱基98購01,0,0,0,0,0,0,0,0,0,14000,0,0,0,14000,0,14000,14000
059254,台表科凱基9A購02,0,0,0,0,0,0,0,0,0,14000,0,0,0,14000,0,14000,14000
057163,上銀元大98購04  ,0,0,0,0,0,0,0,0,0,14000,0,0,0,42000,28000,14000,14000
058738,FBVIX中信03購04 ,0,0,0,0,0,0,0,0,0,14000,0,0,0,18000,4000,14000,14000
058739,喬山中信99購01  ,0,0,0,0,0,0,0,0,0,14000,0,0,0,386000,372000,14000,14000
057363,華通元大99購02  ,0,0,0,0,0,0,0,0,0,14000,0,0,0,14000,0,14000,14000
056581,超眾元大99購01  ,0,0,0,0,0,0,0,0,0,14000,0,0,0,14000,0,14000,14000
056471,台光電元大99購01,0,0,0,0,0,0,0,0,0,14000,0,0,0,28000,14000,14000,14000
055963,欣興元大97購04  ,0,0,0,0,0,0,0,0,0,14000,0,0,0,14000,0,14000,14000
058157,華通台新99購01  ,0,0,0,0,0,0,0,0,0,14000,0,0,0,14000,0,14000,14000
055933,欣興群益98購02  ,0,0,0,0,0,0,0,0,0,14000,0,0,0,16000,2000,14000,14000
058944,元石油群益9C購02,0,0,0,0,0,0,0,0,0,14000,0,0,0,56000,42000,14000,14000
056967,奇鋐永豐98購01  ,0,0,0,0,0,0,0,0,0,14000,0,0,0,14000,0,14000,14000
055506,台郡元大99購02  ,0,0,0,0,0,0,0,0,0,14000,0,0,0,14000,0,14000,14000
055798,聯茂富邦98購01  ,0,0,0,0,0,0,0,0,0,14000,0,0,0,15000,1000,14000,14000
055695,大毅國票98購03  ,0,0,0,0,0,0,0,0,0,14000,0,0,0,15000,1000,14000,14000
058700,鴻海元大99購15  ,0,0,0,0,0,0,0,0,0,14000,0,0,0,34000,20000,14000,14000
4739,康普            ,89000,131000,-42000,0,0,0,63000,0,63000,-7000,0,0,0,0,7000,-7000,14000
07622P,華新科統一9B售02,0,0,0,0,0,0,0,0,0,14000,0,0,0,24000,10000,14000,14000
07689P,旺宏元大9A售13  ,0,0,0,0,0,0,0,0,0,14000,0,0,0,14000,0,14000,14000
07270P,台灣50元大01售09,0,0,0,0,0,0,0,0,0,14000,0,0,0,19000,5000,14000,14000
07170P,臺股指國票99售07,0,0,0,0,0,0,0,0,0,14000,0,0,0,137000,123000,14000,14000
2731,雄獅            ,76000,62000,14000,0,0,0,0,0,0,0,0,0,0,0,0,0,14000
2816,旺旺保          ,87000,73000,14000,0,0,0,0,0,0,0,0,0,0,0,0,0,14000
4763,材料-KY         ,32000,21000,11000,0,0,0,0,0,0,2575,3000,425,2575,0,0,0,13575
06375P,矽力元大97售06  ,0,0,0,0,0,0,0,0,0,13000,0,0,0,13000,0,13000,13000
06691P,臺股指群益9C售05,0,0,0,0,0,0,0,0,0,13000,0,0,0,17000,4000,13000,13000
061082,台光電兆豐9A購01,0,0,0,0,0,0,0,0,0,13000,0,0,0,46000,33000,13000,13000
061502,嘉澤國票9A購02  ,0,0,0,0,0,0,0,0,0,13000,0,0,0,38000,25000,13000,13000
061524,華通凱基9A購07  ,0,0,0,0,0,0,0,0,0,13000,0,0,0,22000,9000,13000,13000
060262,臺股指凱基9B購02,0,0,0,0,0,0,0,0,0,13000,0,0,0,51000,38000,13000,13000
060398,立積國票9B購01  ,0,0,0,0,0,0,0,0,0,13000,0,0,0,16000,3000,13000,13000
059978,國巨元大99購29  ,0,0,0,0,0,0,0,0,0,13000,0,0,0,13000,0,13000,13000
057972,群創富邦9C購01  ,0,0,0,0,0,0,0,0,0,13000,0,0,0,13000,0,13000,13000
054479,緯創中信98購01  ,0,0,0,0,0,0,0,0,0,13000,0,0,0,100000,87000,13000,13000
054117,宏全康和96購01  ,0,0,0,0,0,0,0,0,0,13000,0,0,0,13000,0,13000,13000
051309,卜蜂麥證95購01  ,0,0,0,13000,0,13000,0,0,0,13000,0,0,0,13000,0,13000,13000
052491,泰碩國票99購01  ,0,0,0,0,0,0,0,0,0,13000,0,0,0,33000,20000,13000,13000
00710B,FH彭博高收益債  ,0,0,0,0,0,0,0,0,0,13000,0,0,0,130000,117000,13000,13000
058581,大立光群益99購05,0,0,0,0,0,0,0,0,0,13000,0,0,0,21000,8000,13000,13000
057028,台郡凱基99購02  ,0,0,0,0,0,0,0,0,0,13000,0,0,0,15000,2000,13000,13000
056457,嘉澤凱基98購01  ,0,0,0,0,0,0,0,0,0,13000,0,0,0,13000,0,13000,13000
057299,立積永豐98購02  ,0,0,0,0,0,0,0,0,0,13000,0,0,0,84000,71000,13000,13000
057489,奇力新元大99購06,0,0,0,0,0,0,0,0,0,13000,0,0,0,13000,0,13000,13000
056309,合勤控元大97購01,0,0,0,0,0,0,0,0,0,13000,0,0,0,13000,0,13000,13000
059199,欣興永豐99購02  ,0,0,0,0,0,0,0,0,0,13000,0,0,0,18000,5000,13000,13000
059143,國巨國票9A購04  ,0,0,0,0,0,0,0,0,0,13000,0,0,0,74000,61000,13000,13000
07387P,臺股指群益99售25,0,0,0,0,0,0,0,0,0,13000,0,0,0,60000,47000,13000,13000
07767P,華新科群益9A售07,0,0,0,0,0,0,0,0,0,13000,0,0,0,13000,0,13000,13000
07618P,大立光中信9A售06,0,0,0,0,0,0,0,0,0,13000,0,0,0,37000,24000,13000,13000
07508P,華新科國票9A售03,0,0,0,0,0,0,0,0,0,13000,0,0,0,13000,0,13000,13000
059921,大立光元大99購24,0,0,0,0,0,0,0,0,0,12000,0,0,0,39000,27000,12000,12000
060056,大立光凱基9B購01,0,0,0,0,0,0,0,0,0,12000,0,0,0,12000,0,12000,12000
060157,致茂永豐9A購02  ,0,0,0,0,0,0,0,0,0,12000,0,0,0,113000,101000,12000,12000
060093,友達元大03購01  ,0,0,0,0,0,0,0,0,0,12000,0,0,0,32000,20000,12000,12000
059864,亞德客凱基99購01,0,0,0,0,0,0,0,0,0,12000,0,0,0,35000,23000,12000,12000
060283,台肥元大9C購01  ,0,0,0,0,0,0,0,0,0,12000,0,0,0,105000,93000,12000,12000
060465,聯發科元大9A購02,0,0,0,0,0,0,0,0,0,12000,0,0,0,12000,0,12000,12000
060694,旺宏麥證9A購02  ,0,0,0,31000,19000,12000,0,0,0,12000,0,0,0,31000,19000,12000,12000
060597,華通凱基9A購04  ,0,0,0,0,0,0,0,0,0,12000,0,0,0,17000,5000,12000,12000
061303,玉晶光永豐9B購03,0,0,0,0,0,0,0,0,0,12000,0,0,0,13000,1000,12000,12000
061402,矽創兆豐9B購01  ,0,0,0,0,0,0,0,0,0,12000,0,0,0,12000,0,12000,12000
061124,微星永豐9A購02  ,0,0,0,0,0,0,0,0,0,12000,0,0,0,22000,10000,12000,12000
061216,世芯元大9A購06  ,0,0,0,0,0,0,0,0,0,12000,0,0,0,56000,44000,12000,12000
061061,聯發科麥證9A購02,0,0,0,15000,3000,12000,0,0,0,12000,0,0,0,15000,3000,12000,12000
06637P,大立光凱基98售15,0,0,0,0,0,0,0,0,0,12000,0,0,0,87000,75000,12000,12000
06560P,台積電統一98售07,0,0,0,0,0,0,0,0,0,12000,0,0,0,12000,0,12000,12000
020008,元大特股高息N   ,0,0,0,0,0,0,0,0,0,12000,0,0,0,15000,3000,12000,12000
01003T,兆豐新光R1      ,73000,61000,12000,0,0,0,0,0,0,0,0,0,0,0,0,0,12000
049892,國巨富邦96購01  ,0,0,0,0,0,0,0,0,0,12000,0,0,0,22000,10000,12000,12000
048696,台達電國票96購01,0,0,0,0,0,0,0,0,0,12000,0,0,0,87000,75000,12000,12000
052418,玉晶光兆豐96購01,0,0,0,0,0,0,0,0,0,12000,0,0,0,12000,0,12000,12000
058266,宏達電永豐99購01,0,0,0,0,0,0,0,0,0,12000,0,0,0,12000,0,12000,12000
058331,鴻海元富99購02  ,0,0,0,0,0,0,0,0,0,12000,0,0,0,12000,0,12000,12000
056812,泰鼎統一98購01  ,0,0,0,0,0,0,0,0,0,12000,0,0,0,26000,14000,12000,12000
053074,嘉晶永豐96購02  ,0,0,0,0,0,0,0,0,0,12000,0,0,0,12000,0,12000,12000
054923,晶技凱基98購01  ,0,0,0,0,0,0,0,0,0,12000,0,0,0,12000,0,12000,12000
059211,鴻海元大99購27  ,0,0,0,0,0,0,0,0,0,12000,0,0,0,75000,63000,12000,12000
059315,鴻海元大99購30  ,0,0,0,0,0,0,0,0,0,12000,0,0,0,53000,41000,12000,12000
057153,祥碩國泰99購01  ,0,0,0,0,0,0,0,0,0,12000,0,0,0,60000,48000,12000,12000
058979,上銀凱基99購04  ,0,0,0,0,0,0,0,0,0,12000,0,0,0,12000,0,12000,12000
058390,樺漢國票9A購01  ,0,0,0,0,0,0,0,0,0,12000,0,0,0,12000,0,12000,12000
056534,京元電凱基98購01,0,0,0,0,0,0,0,0,0,12000,0,0,0,12000,0,12000,12000
057044,旺宏元大98購08  ,0,0,0,0,0,0,0,0,0,12000,0,0,0,65000,53000,12000,12000
056680,華通統一98購04  ,0,0,0,0,0,0,0,0,0,12000,0,0,0,12000,0,12000,12000
05634P,玉晶光台新97售01,0,0,0,0,0,0,0,0,0,12000,0,0,0,12000,0,12000,12000
058431,國巨統一9B購01  ,0,0,0,0,0,0,0,0,0,12000,0,0,0,248000,236000,12000,12000
058070,華新科凱基98購07,0,0,0,0,0,0,0,0,0,12000,0,0,0,17000,5000,12000,12000
07477P,國巨群益9A售04  ,0,0,0,0,0,0,0,0,0,12000,0,0,0,12000,0,12000,12000
07772P,華新科國票9A售05,0,0,0,0,0,0,0,0,0,12000,0,0,0,12000,0,12000,12000
8454,富邦媒          ,58465,53000,5465,0,0,0,21000,0,21000,-15000,0,15000,-15000,0,0,0,11465
06644P,亞德客元大98售03,0,0,0,0,0,0,0,0,0,11000,0,0,0,11000,0,11000,11000
06937P,GIS元大98售03   ,0,0,0,0,0,0,0,0,0,11000,0,0,0,16000,5000,11000,11000
061058,健策國票9A購05  ,0,0,0,0,0,0,0,0,0,11000,0,0,0,11000,0,11000,11000
060869,超眾永豐9A購02  ,0,0,0,0,0,0,0,0,0,11000,0,0,0,11000,0,11000,11000
060879,華新科中信9A購02,0,0,0,0,0,0,0,0,0,11000,0,0,0,11000,0,11000,11000
060768,鴻海麥證9A購02  ,0,0,0,11000,0,11000,0,0,0,11000,0,0,0,11000,0,11000,11000
060090,台積電元大99購55,0,0,0,0,0,0,0,0,0,11000,0,0,0,50000,39000,11000,11000
060160,聯陽永豐9A購01  ,0,0,0,0,0,0,0,0,0,11000,0,0,0,11000,0,11000,11000
06005P,晶豪科永豐96售04,0,0,0,0,0,0,0,0,0,11000,0,0,0,25000,14000,11000,11000
060049,華通凱基99購06  ,0,0,0,0,0,0,0,0,0,11000,0,0,0,11000,0,11000,11000
060071,國巨元富99購03  ,0,0,0,0,0,0,0,0,0,11000,0,0,0,11000,0,11000,11000
059982,聯發科元大99購37,0,0,0,0,0,0,0,0,0,11000,0,0,0,11000,0,11000,11000
05297P,臻鼎凱基95售04  ,0,0,0,0,0,0,0,0,0,11000,0,0,0,11000,0,11000,11000
053027,玉晶光富邦98購01,0,0,0,0,0,0,0,0,0,11000,0,0,0,11000,0,11000,11000
055280,智邦元大97購01  ,0,0,0,0,0,0,0,0,0,11000,0,0,0,11000,0,11000,11000
058319,大毅永豐9A購01  ,0,0,0,0,0,0,0,0,0,11000,0,0,0,35000,24000,11000,11000
054177,牧德台新97購01  ,0,0,0,0,0,0,0,0,0,11000,0,0,0,11000,0,11000,11000
052222,力山凱基95購02  ,0,0,0,0,0,0,0,0,0,11000,0,0,0,11000,0,11000,11000
04049P,大立光元大95售02,0,0,0,0,0,0,0,0,0,11000,0,0,0,11000,0,11000,11000
047969,台達電富邦97購01,0,0,0,0,0,0,0,0,0,11000,0,0,0,11000,0,11000,11000
044105,聯詠中信95購01  ,0,0,0,0,0,0,0,0,0,11000,0,0,0,11000,0,11000,11000
051233,力成群益97購01  ,0,0,0,0,0,0,0,0,0,11000,0,0,0,11000,0,11000,11000
056133,可成元大97購05  ,0,0,0,0,0,0,0,0,0,11000,0,0,0,11000,0,11000,11000
056359,旺宏元大9A購01  ,0,0,0,0,0,0,0,0,0,11000,0,0,0,11000,0,11000,11000
055489,瑞昱元大97購02  ,0,0,0,0,0,0,0,0,0,11000,0,0,0,47000,36000,11000,11000
056962,技嘉永豐98購01  ,0,0,0,0,0,0,0,0,0,11000,0,0,0,11000,0,11000,11000
057812,友達元大9A購05  ,0,0,0,0,0,0,0,0,0,11000,0,0,0,311000,300000,11000,11000
057867,大立光凱基98購17,0,0,0,0,0,0,0,0,0,11000,0,0,0,11000,0,11000,11000
059371,聯鈞元富99購02  ,0,0,0,0,0,0,0,0,0,11000,0,0,0,13000,2000,11000,11000
059513,揚明光永豐99購01,0,0,0,0,0,0,0,0,0,11000,0,0,0,11000,0,11000,11000
059153,臺股指國票99購16,0,0,0,0,0,0,0,0,0,11000,0,0,0,211000,200000,11000,11000
059250,大立光凱基99購06,0,0,0,0,0,0,0,0,0,11000,0,0,0,11000,0,11000,11000
07823P,國巨元大9A售23  ,0,0,0,0,0,0,0,0,0,11000,0,0,0,81000,70000,11000,11000
07832P,台積電群益9A售08,0,0,0,0,0,0,0,0,0,11000,0,0,0,31000,20000,11000,11000
07758P,台積電國票9A售06,0,0,0,0,0,0,0,0,0,11000,0,0,0,32000,21000,11000,11000
07333P,台灣50國票9B售03,0,0,0,0,0,0,0,0,0,11000,0,0,0,11000,0,11000,11000
07288P,台灣50凱基99售06,0,0,0,0,0,0,0,0,0,11000,0,0,0,11000,0,11000,11000
07233P,台灣50元大99售04,0,0,0,0,0,0,0,0,0,11000,0,0,0,34000,23000,11000,11000
1474,弘裕            ,135000,124000,11000,0,0,0,0,0,0,0,0,0,0,0,0,0,11000
059990,健策元大9A購01  ,0,0,0,0,0,0,0,0,0,10000,0,0,0,28000,18000,10000,10000
060070,國巨元富99購02  ,0,0,0,0,0,0,0,0,0,10000,0,0,0,10000,0,10000,10000
060030,晶相光永豐99購03,0,0,0,0,0,0,0,0,0,10000,0,0,0,16000,6000,10000,10000
06000P,GIS元大96售04   ,0,0,0,0,0,0,0,0,0,10000,0,0,0,10000,0,10000,10000
060151,旺宏富邦9A購02  ,0,0,0,0,0,0,0,0,0,10000,0,0,0,10000,0,10000,10000
060136,T50反1國票9A購01,0,0,0,0,0,0,0,0,0,10000,0,0,0,10000,0,10000,10000
060096,聯發科元大99購43,0,0,0,0,0,0,0,0,0,10000,0,0,0,11000,1000,10000,10000
060220,華新科凱基9A購08,0,0,0,0,0,0,0,0,0,10000,0,0,0,10000,0,10000,10000
059845,欣興富邦9A購02  ,0,0,0,0,0,0,0,0,0,10000,0,0,0,10000,0,10000,10000
059887,華新科國票99購02,0,0,0,0,0,0,0,0,0,10000,0,0,0,10000,0,10000,10000
059877,康控凱基99購05  ,0,0,0,0,0,0,0,0,0,10000,0,0,0,10000,0,10000,10000
059753,貿聯群益99購06  ,0,0,0,0,0,0,0,0,0,10000,0,0,0,10000,0,10000,10000
059735,T50反1元富99購06,0,0,0,0,0,0,0,0,0,10000,0,0,0,10000,0,10000,10000
059762,禾伸堂永豐99購02,0,0,0,0,0,0,0,0,0,10000,0,0,0,10000,0,10000,10000
059795,鴻海國票99購07  ,0,0,0,0,0,0,0,0,0,10000,0,0,0,11000,1000,10000,10000
059817,華通凱基99購05  ,0,0,0,0,0,0,0,0,0,10000,0,0,0,10000,0,10000,10000
059654,T50反1元大99購09,0,0,0,0,0,0,0,0,0,10000,0,0,0,10000,0,10000,10000
059645,祥碩凱基99購05  ,0,0,0,0,0,0,0,0,0,10000,0,0,0,68000,58000,10000,10000
059594,奇力新元大9B購01,0,0,0,0,0,0,0,0,0,10000,0,0,0,10000,0,10000,10000
059623,聯電凱基99購02  ,0,0,0,0,0,0,0,0,0,10000,0,0,0,138000,128000,10000,10000
060875,華通中信02購01  ,0,0,0,0,0,0,0,0,0,10000,0,0,0,10000,0,10000,10000
060904,臺指反元大9C購07,0,0,0,0,0,0,0,0,0,10000,0,0,0,12000,2000,10000,10000
060662,旺宏凱基9A購03  ,0,0,0,0,0,0,0,0,0,10000,0,0,0,15000,5000,10000,10000
060743,鴻海國票9A購03  ,0,0,0,0,0,0,0,0,0,10000,0,0,0,10000,0,10000,10000
060479,億豐元大9A購01  ,0,0,0,0,0,0,0,0,0,10000,0,0,0,10000,0,10000,10000
060456,正隆元大9A購01  ,0,0,0,0,0,0,0,0,0,10000,0,0,0,10000,0,10000,10000
060464,台積電元大9A購11,0,0,0,0,0,0,0,0,0,10000,0,0,0,30000,20000,10000,10000
060587,牧德元富9A購01  ,0,0,0,0,0,0,0,0,0,10000,0,0,0,10000,0,10000,10000
060541,正隆凱基9A購01  ,0,0,0,0,0,0,0,0,0,10000,0,0,0,10000,0,10000,10000
060510,大立光元大9A購03,0,0,0,0,0,0,0,0,0,10000,0,0,0,20000,10000,10000,10000
06027P,鴻海台新96售04  ,0,0,0,0,0,0,0,0,0,10000,0,0,0,10000,0,10000,10000
061023,茂林國泰9B購02  ,0,0,0,0,0,0,0,0,0,10000,0,0,0,10000,0,10000,10000
060939,鴻海國票9A購06  ,0,0,0,0,0,0,0,0,0,10000,0,0,0,10000,0,10000,10000
061233,國巨元大9A購17  ,0,0,0,0,0,0,0,0,0,10000,0,0,0,24000,14000,10000,10000
061174,鴻海凱基9A購23  ,0,0,0,0,0,0,0,0,0,10000,0,0,0,10000,0,10000,10000
061120,台積電永豐9A購03,0,0,0,0,0,0,0,0,0,10000,0,0,0,10000,0,10000,10000
061330,T50反1元大9A購14,0,0,0,0,0,0,0,0,0,10000,0,0,0,10000,0,10000,10000
061298,華新科富邦01購02,0,0,0,0,0,0,0,0,0,10000,0,0,0,10000,0,10000,10000
061294,奇力新麥證9A購01,0,0,0,10000,0,10000,0,0,0,10000,0,0,0,10000,0,10000,10000
061545,華新科群益9A購09,0,0,0,0,0,0,0,0,0,10000,0,0,0,19000,9000,10000,10000
061497,大立光國票9A購09,0,0,0,0,0,0,0,0,0,10000,0,0,0,26000,16000,10000,10000
061445,道瓊指中信9A購01,0,0,0,0,0,0,0,0,0,10000,0,0,0,20000,10000,10000,10000
06946P,T50正2元大9C售01,0,0,0,0,0,0,0,0,0,10000,0,0,0,30000,20000,10000,10000
06955P,臻鼎元富99售01  ,0,0,0,0,0,0,0,0,0,10000,0,0,0,10000,0,10000,10000
06810P,國巨統一99售03  ,0,0,0,0,0,0,0,0,0,10000,0,0,0,10000,0,10000,10000
06773P,台灣50兆豐9A售01,0,0,0,0,0,0,0,0,0,10000,0,0,0,10000,0,10000,10000
06847P,奇力新元大98售05,0,0,0,0,0,0,0,0,0,10000,0,0,0,10000,0,10000,10000
06854P,鴻海富邦99售05  ,0,0,0,0,0,0,0,0,0,10000,0,0,0,10000,0,10000,10000
06654P,欣興元大98售08  ,0,0,0,0,0,0,0,0,0,10000,0,0,0,200000,190000,10000,10000
06538P,國巨凱基98售11  ,0,0,0,0,0,0,0,0,0,10000,0,0,0,10000,0,10000,10000
06594P,立積元大98售01  ,0,0,0,0,0,0,0,0,0,10000,0,0,0,40000,30000,10000,10000
06268P,聯詠凱基97售02  ,0,0,0,0,0,0,0,0,0,10000,0,0,0,10000,0,10000,10000
06398P,禾伸堂凱基97售02,0,0,0,0,0,0,0,0,0,10000,0,0,0,10000,0,10000,10000
06399P,台表科凱基97售05,0,0,0,0,0,0,0,0,0,10000,0,0,0,10000,0,10000,10000
061657,智原國票9A購01  ,0,0,0,0,0,0,0,0,0,10000,0,0,0,10000,0,10000,10000
061645,超眾元大9A購06  ,0,0,0,0,0,0,0,0,0,10000,0,0,0,45000,35000,10000,10000
061572,奇力新元大9A購04,0,0,0,0,0,0,0,0,0,10000,0,0,0,18000,8000,10000,10000
051368,國泰金富邦97購01,0,0,0,0,0,0,0,0,0,10000,0,0,0,10000,0,10000,10000
051537,牧德國票96購01  ,0,0,0,0,0,0,0,0,0,10000,0,0,0,10000,0,10000,10000
05155P,聯發科兆豐95售03,0,0,0,0,0,0,0,0,0,10000,0,0,0,10000,0,10000,10000
051775,旺宏亞東95購01  ,0,0,0,0,0,0,0,0,0,10000,0,0,0,10000,0,10000,10000
051688,大立光凱基97購02,0,0,0,0,0,0,0,0,0,10000,0,0,0,18000,8000,10000,10000
051701,華通群益97購01  ,0,0,0,0,0,0,0,0,0,10000,0,0,0,10000,0,10000,10000
051807,瑞昱凱基95購03  ,0,0,0,0,0,0,0,0,0,10000,0,0,0,10000,0,10000,10000
051841,南茂國泰96購01  ,0,0,0,0,0,0,0,0,0,10000,0,0,0,10000,0,10000,10000
051094,健策元大96購03  ,0,0,0,0,0,0,0,0,0,10000,0,0,0,10000,0,10000,10000
052715,可成凱基96購01  ,0,0,0,0,0,0,0,0,0,10000,0,0,0,10000,0,10000,10000
053693,欣興元大96購05  ,0,0,0,0,0,0,0,0,0,10000,0,0,0,10000,0,10000,10000
053675,臺股指元富96購02,0,0,0,0,0,0,0,0,0,10000,0,0,0,10000,0,10000,10000
053713,漢唐凱基96購04  ,0,0,0,0,0,0,0,0,0,10000,0,0,0,10000,0,10000,10000
050614,聯發科元大95購04,0,0,0,0,0,0,0,0,0,10000,0,0,0,10000,0,10000,10000
05359P,嘉澤元大95售02  ,0,0,0,0,0,0,0,0,0,10000,0,0,0,290000,280000,10000,10000
050547,華新科凱基95購01,0,0,0,0,0,0,0,0,0,10000,0,0,0,10000,0,10000,10000
050155,華新科群益95購01,0,0,0,0,0,0,0,0,0,10000,0,0,0,10000,0,10000,10000
052733,台郡國泰97購01  ,0,0,0,0,0,0,0,0,0,10000,0,0,0,10000,0,10000,10000
04479P,同欣電中信96售02,0,0,0,0,0,0,0,0,0,10000,0,0,0,10000,0,10000,10000
04289P,臺股指中信95售07,0,0,0,0,0,0,0,0,0,10000,0,0,0,10000,0,10000,10000
04543P,鴻海富邦95售03  ,0,0,0,0,0,0,0,0,0,10000,0,0,0,10000,0,10000,10000
04517P,宏達電群益95售01,0,0,0,0,0,0,0,0,0,10000,0,0,0,10000,0,10000,10000
048850,聯電群益96購01  ,0,0,0,0,0,0,0,0,0,10000,0,0,0,10000,0,10000,10000
048852,旺宏群益96購02  ,0,0,0,0,0,0,0,0,0,10000,0,0,0,10000,0,10000,10000
049341,旺宏統一95購01  ,0,0,0,0,0,0,0,0,0,10000,0,0,0,100000,90000,10000,10000
049501,台郡元大95購01  ,0,0,0,0,0,0,0,0,0,10000,0,0,0,10000,0,10000,10000
049593,群創元大9A購01  ,0,0,0,0,0,0,0,0,0,10000,0,0,0,10000,0,10000,10000
047298,聯茂元富96購01  ,0,0,0,0,0,0,0,0,0,10000,0,0,0,10000,0,10000,10000
036628,統一台新99購01  ,0,0,0,0,0,0,0,0,0,10000,0,0,0,10000,0,10000,10000
03670C,元油2X元富99牛01,0,0,0,0,0,0,0,0,0,10000,0,0,0,20000,10000,10000,10000
052185,奇力新群益95購03,0,0,0,0,0,0,0,0,0,10000,0,0,0,20000,10000,10000,10000
052399,台光電凱基95購03,0,0,0,0,0,0,0,0,0,10000,0,0,0,20000,10000,10000,10000
052237,嘉澤國票96購02  ,0,0,0,0,0,0,0,0,0,10000,0,0,0,22000,12000,10000,10000
052510,聯發科凱基95購13,0,0,0,0,0,0,0,0,0,10000,0,0,0,10000,0,10000,10000
052511,聯發科凱基95購14,0,0,0,0,0,0,0,0,0,10000,0,0,0,20000,10000,10000,10000
052513,大立光凱基95購13,0,0,0,0,0,0,0,0,0,10000,0,0,0,10000,0,10000,10000
052476,台光電群益98購01,0,0,0,0,0,0,0,0,0,10000,0,0,0,10000,0,10000,10000
054178,中磊台新97購01  ,0,0,0,0,0,0,0,0,0,10000,0,0,0,10000,0,10000,10000
054135,大立光元大97購04,0,0,0,0,0,0,0,0,0,10000,0,0,0,10000,0,10000,10000
054128,台積電元大97購10,0,0,0,0,0,0,0,0,0,10000,0,0,0,80000,70000,10000,10000
054175,高鐵台新97購01  ,0,0,0,0,0,0,0,0,0,10000,0,0,0,10000,0,10000,10000
054424,大成鋼富邦97購02,0,0,0,0,0,0,0,0,0,10000,0,0,0,10000,0,10000,10000
05441P,華通元大95售09  ,0,0,0,0,0,0,0,0,0,10000,0,0,0,10000,0,10000,10000
054377,臺股指中信99購09,10000,0,10000,0,0,0,0,0,0,0,0,0,0,0,0,0,10000
054294,世芯元大96購02  ,0,0,0,0,0,0,0,0,0,10000,0,0,0,10000,0,10000,10000
054321,上銀台新96購01  ,0,0,0,0,0,0,0,0,0,10000,0,0,0,10000,0,10000,10000
054326,宏達電台新97購02,0,0,0,0,0,0,0,0,0,10000,0,0,0,10000,0,10000,10000
054327,亞光台新96購02  ,0,0,0,0,0,0,0,0,0,10000,0,0,0,10000,0,10000,10000
054330,世芯永豐96購02  ,0,0,0,0,0,0,0,0,0,10000,0,0,0,10000,0,10000,10000
054483,聯電台新96購01  ,0,0,0,0,0,0,0,0,0,10000,0,0,0,10000,0,10000,10000
054677,智易台新98購02  ,0,0,0,0,0,0,0,0,0,10000,0,0,0,10000,0,10000,10000
054678,麗豐台新98購02  ,0,0,0,0,0,0,0,0,0,10000,0,0,0,10000,0,10000,10000
054443,樺漢台新96購02  ,0,0,0,0,0,0,0,0,0,10000,0,0,0,10000,0,10000,10000
054638,國泰金中信99購01,0,0,0,0,0,0,0,0,0,10000,0,0,0,10000,0,10000,10000
054441,力成台新96購01  ,0,0,0,0,0,0,0,0,0,10000,0,0,0,10000,0,10000,10000
054430,上銀台新96購02  ,0,0,0,0,0,0,0,0,0,10000,0,0,0,10000,0,10000,10000
054436,高鐵台新97購02  ,0,0,0,0,0,0,0,0,0,10000,0,0,0,10000,0,10000,10000
05459P,聯詠凱基95售03  ,0,0,0,0,0,0,0,0,0,10000,0,0,0,10000,0,10000,10000
054603,智易台新98購01  ,0,0,0,0,0,0,0,0,0,10000,0,0,0,10000,0,10000,10000
054604,麗豐台新98購01  ,0,0,0,0,0,0,0,0,0,10000,0,0,0,10000,0,10000,10000
054492,嘉聯益台新96購01,0,0,0,0,0,0,0,0,0,10000,0,0,0,10000,0,10000,10000
054494,訊芯台新96購01  ,0,0,0,0,0,0,0,0,0,10000,0,0,0,10000,0,10000,10000
054486,漢唐台新96購01  ,0,0,0,0,0,0,0,0,0,10000,0,0,0,10000,0,10000,10000
054487,京元電台新97購01,0,0,0,0,0,0,0,0,0,10000,0,0,0,10000,0,10000,10000
054488,禾伸堂台新96購01,0,0,0,0,0,0,0,0,0,10000,0,0,0,10000,0,10000,10000
054489,牧德台新97購02  ,0,0,0,0,0,0,0,0,0,10000,0,0,0,10000,0,10000,10000
055227,聯發科國票98購02,0,0,0,0,0,0,0,0,0,10000,0,0,0,49000,39000,10000,10000
055236,建準台新98購01  ,0,0,0,0,0,0,0,0,0,10000,0,0,0,10000,0,10000,10000
055221,矽創凱基97購02  ,0,0,0,0,0,0,0,0,0,10000,0,0,0,10000,0,10000,10000
055218,彩晶凱基99購01  ,0,0,0,0,0,0,0,0,0,10000,0,0,0,10000,0,10000,10000
058338,康友元富99購01  ,0,0,0,0,0,0,0,0,0,10000,0,0,0,10000,0,10000,10000
057978,聯發科永豐98購05,0,0,0,0,0,0,0,0,0,10000,0,0,0,10000,0,10000,10000
055882,嘉聯益元富97購01,0,0,0,0,0,0,0,0,0,10000,0,0,0,10000,0,10000,10000
055870,智原台新97購01  ,0,0,0,0,0,0,0,0,0,10000,0,0,0,10000,0,10000,10000
055363,緯穎凱基98購03  ,0,0,0,0,0,0,0,0,0,10000,0,0,0,26000,16000,10000,10000
055357,欣興凱基97購04  ,0,0,0,0,0,0,0,0,0,10000,0,0,0,10000,0,10000,10000
053858,台達電元大96購05,0,0,0,0,0,0,0,0,0,10000,0,0,0,10000,0,10000,10000
055469,台光電凱基97購01,0,0,0,0,0,0,0,0,0,10000,0,0,0,10000,0,10000,10000
055445,旺宏統一99購01  ,0,0,0,0,0,0,0,0,0,10000,0,0,0,10000,0,10000,10000
055439,台表科國票98購02,0,0,0,0,0,0,0,0,0,10000,0,0,0,10000,0,10000,10000
053024,國巨富邦97購02  ,0,0,0,0,0,0,0,0,0,10000,0,0,0,10000,0,10000,10000
052993,欣興台新97購01  ,0,0,0,0,0,0,0,0,0,10000,0,0,0,10000,0,10000,10000
052994,群創台新99購01  ,0,0,0,0,0,0,0,0,0,10000,0,0,0,10000,0,10000,10000
052942,聯發科中信97購04,0,0,0,0,0,0,0,0,0,10000,0,0,0,10000,0,10000,10000
052915,創意元富96購01  ,0,0,0,0,0,0,0,0,0,10000,0,0,0,10000,0,10000,10000
052893,聯電群益98購01  ,0,0,0,0,0,0,0,0,0,10000,0,0,0,10000,0,10000,10000
052934,中磊元大96購01  ,0,0,0,0,0,0,0,0,0,10000,0,0,0,10000,0,10000,10000
05283P,健鼎元大95售04  ,0,0,0,0,0,0,0,0,0,10000,0,0,0,10000,0,10000,10000
053939,台表科元富96購03,0,0,0,0,0,0,0,0,0,10000,0,0,0,10000,0,10000,10000
055026,健和興國泰98購01,0,0,0,0,0,0,0,0,0,10000,0,0,0,10000,0,10000,10000
052811,玉晶光台新96購03,0,0,0,0,0,0,0,0,0,10000,0,0,0,10000,0,10000,10000
054993,南亞科元富97購03,0,0,0,0,0,0,0,0,0,10000,0,0,0,10000,0,10000,10000
053101,創意元富96購03  ,0,0,0,0,0,0,0,0,0,10000,0,0,0,10000,0,10000,10000
053057,聯電國泰97購02  ,0,0,0,0,0,0,0,0,0,10000,0,0,0,10000,0,10000,10000
053309,泰鼎凱基96購03  ,0,0,0,0,0,0,0,0,0,10000,0,0,0,10000,0,10000,10000
053337,聯電國票97購01  ,0,0,0,0,0,0,0,0,0,10000,0,0,0,10000,0,10000,10000
053357,可成統一96購02  ,0,0,0,0,0,0,0,0,0,10000,0,0,0,10000,0,10000,10000
05328P,臺股指凱基95售12,0,0,0,0,0,0,0,0,0,10000,0,0,0,10000,0,10000,10000
053253,友達國泰97購02  ,0,0,0,0,0,0,0,0,0,10000,0,0,0,10000,0,10000,10000
053216,京鼎凱基96購02  ,0,0,0,0,0,0,0,0,0,10000,0,0,0,40000,30000,10000,10000
055137,GIS富邦98購01   ,0,0,0,0,0,0,0,0,0,10000,0,0,0,10000,0,10000,10000
05513P,玉山金台新96售01,0,0,0,0,0,0,0,0,0,10000,0,0,0,10000,0,10000,10000
055144,T50反1元大97購03,0,0,0,0,0,0,0,0,0,10000,0,0,0,10000,0,10000,10000
055145,T50反1元大97購04,0,0,0,0,0,0,0,0,0,10000,0,0,0,10000,0,10000,10000
053416,光磊台新97購01  ,0,0,0,0,0,0,0,0,0,10000,0,0,0,10000,0,10000,10000
053990,晶技兆豐96購01  ,0,0,0,0,0,0,0,0,0,10000,0,0,0,10000,0,10000,10000
054020,技嘉台新97購01  ,0,0,0,0,0,0,0,0,0,10000,0,0,0,10000,0,10000,10000
059137,電子類群益99購01,0,0,0,0,0,0,0,0,0,10000,0,0,0,10000,0,10000,10000
059207,臺指反元大9C購02,0,0,0,0,0,0,0,0,0,10000,0,0,0,10000,0,10000,10000
059172,台郡凱基99購03  ,0,0,0,0,0,0,0,0,0,10000,0,0,0,10000,0,10000,10000
059365,T50反1台新99購01,0,0,0,0,0,0,0,0,0,10000,0,0,0,10000,0,10000,10000
059362,健策永豐99購03  ,0,0,0,0,0,0,0,0,0,10000,0,0,0,10000,0,10000,10000
059427,國巨元大99購24  ,0,0,0,0,0,0,0,0,0,10000,0,0,0,11000,1000,10000,10000
05624P,同欣電中信98售01,0,0,0,0,0,0,0,0,0,10000,0,0,0,10000,0,10000,10000
056272,嘉澤統一99購01  ,0,0,0,0,0,0,0,0,0,10000,0,0,0,10000,0,10000,10000
056310,神達元大97購02  ,0,0,0,0,0,0,0,0,0,10000,0,0,0,10000,0,10000,10000
057218,可成群益99購03  ,0,0,0,0,0,0,0,0,0,10000,0,0,0,10000,0,10000,10000
057234,宏達電凱基98購05,0,0,0,0,0,0,0,0,0,10000,0,0,0,20000,10000,10000,10000
057266,TPK兆豐98購02   ,0,0,0,0,0,0,0,0,0,10000,0,0,0,10000,0,10000,10000
057132,華新科凱基98購05,0,0,0,0,0,0,0,0,0,10000,0,0,0,10000,0,10000,10000
059025,台灣50台新9B購02,0,0,0,0,0,0,0,0,0,10000,0,0,0,10000,0,10000,10000
059028,嘉聯益台新99購02,0,0,0,0,0,0,0,0,0,10000,0,0,0,210000,200000,10000,10000
059099,元油2X統一9C購01,0,0,0,0,0,0,0,0,0,10000,0,0,0,10000,0,10000,10000
059059,宏達電凱基99購03,0,0,0,0,0,0,0,0,0,10000,0,0,0,10000,0,10000,10000
057087,台郡統一99購01  ,0,0,0,0,0,0,0,0,0,10000,0,0,0,10000,0,10000,10000
057106,美律群益98購03  ,0,0,0,0,0,0,0,0,0,10000,0,0,0,20000,10000,10000,10000
057083,立積統一98購01  ,0,0,0,0,0,0,0,0,0,10000,0,0,0,10000,0,10000,10000
056459,茂林凱基99購01  ,0,0,0,0,0,0,0,0,0,10000,0,0,0,10000,0,10000,10000
056442,瑞昱凱基98購02  ,0,0,0,0,0,0,0,0,0,10000,0,0,0,10000,0,10000,10000
056483,TPK元大98購01   ,0,0,0,0,0,0,0,0,0,10000,0,0,0,10000,0,10000,10000
056627,訊芯永豐98購01  ,0,0,0,0,0,0,0,0,0,10000,0,0,0,10000,0,10000,10000
056637,台光電日盛9A購01,0,0,0,0,0,0,0,0,0,10000,0,0,0,22000,12000,10000,10000
056744,麗豐凱基9A購01  ,0,0,0,0,0,0,0,0,0,10000,0,0,0,10000,0,10000,10000
056702,欣興國泰9A購01  ,0,0,0,0,0,0,0,0,0,10000,0,0,0,10000,0,10000,10000
056544,貿聯凱基98購03  ,0,0,0,0,0,0,0,0,0,10000,0,0,0,10000,0,10000,10000
056571,燿華元大98購02  ,0,0,0,0,0,0,0,0,0,10000,0,0,0,149000,139000,10000,10000
056596,光磊元富98購01  ,0,0,0,0,0,0,0,0,0,10000,0,0,0,20000,10000,10000,10000
058998,鴻海元大99購22  ,0,0,0,0,0,0,0,0,0,10000,0,0,0,25000,15000,10000,10000
057341,技嘉台新98購01  ,0,0,0,0,0,0,0,0,0,10000,0,0,0,10000,0,10000,10000
057342,玉晶光台新98購01,0,0,0,0,0,0,0,0,0,10000,0,0,0,10000,0,10000,10000
057351,奇力新統一98購02,0,0,0,0,0,0,0,0,0,10000,0,0,0,10000,0,10000,10000
057512,華邦電台新98購01,0,0,0,0,0,0,0,0,0,10000,0,0,0,10000,0,10000,10000
05751P,台積電中信96售05,0,0,0,0,0,0,0,0,0,10000,0,0,0,10000,0,10000,10000
057377,康控元大99購02  ,0,0,0,0,0,0,0,0,0,10000,0,0,0,270000,260000,10000,10000
057390,台表科永豐98購01,0,0,0,0,0,0,0,0,0,10000,0,0,0,120000,110000,10000,10000
057433,上銀國票98購04  ,0,0,0,0,0,0,0,0,0,10000,0,0,0,10000,0,10000,10000
056988,聚陽兆豐98購01  ,0,0,0,0,0,0,0,0,0,10000,0,0,0,10000,0,10000,10000
056167,力成台新97購01  ,0,0,0,0,0,0,0,0,0,10000,0,0,0,10000,0,10000,10000
056169,鴻海元富97購08  ,0,0,0,0,0,0,0,0,0,10000,0,0,0,10000,0,10000,10000
056170,鴻海元富97購09  ,0,0,0,0,0,0,0,0,0,10000,0,0,0,20000,10000,10000,10000
056180,南茂元富97購01  ,0,0,0,0,0,0,0,0,0,10000,0,0,0,10000,0,10000,10000
055502,群創元大9C購03  ,0,0,0,0,0,0,0,0,0,10000,0,0,0,10000,0,10000,10000
055539,億光台新97購01  ,0,0,0,0,0,0,0,0,0,10000,0,0,0,10000,0,10000,10000
056164,聯茂凱基98購03  ,0,0,0,0,0,0,0,0,0,10000,0,0,0,10000,0,10000,10000
057766,矽力凱基98購03  ,0,0,0,0,0,0,0,0,0,10000,0,0,0,12000,2000,10000,10000
056386,TPK國泰99購01   ,0,0,0,0,0,0,0,0,0,10000,0,0,0,30000,20000,10000,10000
058423,臺股指麥證99購01,0,0,0,10000,0,10000,0,0,0,10000,0,0,0,10000,0,10000,10000
058635,華新科兆豐99購03,0,0,0,0,0,0,0,0,0,10000,0,0,0,10000,0,10000,10000
058657,大立光中信99購01,0,0,0,0,0,0,0,0,0,10000,0,0,0,10000,0,10000,10000
055707,聯鈞永豐98購01  ,0,0,0,0,0,0,0,0,0,10000,0,0,0,10000,0,10000,10000
055777,冠德凱基97購01  ,0,0,0,0,0,0,0,0,0,10000,0,0,0,15000,5000,10000,10000
05574P,英業達元富96售01,0,0,0,0,0,0,0,0,0,10000,0,0,0,10000,0,10000,10000
05573P,仁寶元富96售02  ,0,0,0,0,0,0,0,0,0,10000,0,0,0,12000,2000,10000,10000
058176,聯發科凱基99購05,0,0,0,0,0,0,0,0,0,10000,0,0,0,10000,0,10000,10000
056074,茂林元大97購04  ,0,0,0,0,0,0,0,0,0,10000,0,0,0,10000,0,10000,10000
056082,旺宏統一99購02  ,0,0,0,0,0,0,0,0,0,10000,0,0,0,10000,0,10000,10000
056061,國泰金元大97購02,0,0,0,0,0,0,0,0,0,10000,0,0,0,10000,0,10000,10000
058069,美律凱基99購05  ,0,0,0,0,0,0,0,0,0,10000,0,0,0,10000,0,10000,10000
058109,台灣50元富9B購01,0,0,0,0,0,0,0,0,0,10000,0,0,0,10000,0,10000,10000
055920,智伸科凱基97購02,0,0,0,0,0,0,0,0,0,10000,0,0,0,10000,0,10000,10000
055972,GIS元大97購04   ,0,0,0,0,0,0,0,0,0,10000,0,0,0,10000,0,10000,10000
058915,SGBR2X元富99購01,0,0,0,0,0,0,0,0,0,10000,0,0,0,10000,0,10000,10000
058817,嘉聯益台新99購01,0,0,0,0,0,0,0,0,0,10000,0,0,0,410000,400000,10000,10000
057627,和大永豐98購01  ,0,0,0,0,0,0,0,0,0,10000,0,0,0,10000,0,10000,10000
057633,緯穎永豐98購02  ,0,0,0,0,0,0,0,0,0,10000,0,0,0,10000,0,10000,10000
056929,華新科台新98購01,0,0,0,0,0,0,0,0,0,10000,0,0,0,10000,0,10000,10000
1783,和康生          ,231000,221000,10000,0,0,0,0,0,0,0,0,0,0,0,0,0,10000
06993P,鴻海凱基99售05  ,0,0,0,0,0,0,0,0,0,10000,0,0,0,10000,0,10000,10000
07063P,臺股指元大9A售24,0,0,0,0,0,0,0,0,0,10000,0,0,0,10000,0,10000,10000
07055P,景碩群益9A售02  ,0,0,0,0,0,0,0,0,0,10000,0,0,0,12000,2000,10000,10000
07066P,台灣50台新9B售01,0,0,0,0,0,0,0,0,0,10000,0,0,0,10000,0,10000,10000
07118P,台積電凱基99售09,0,0,0,0,0,0,0,0,0,10000,0,0,0,10000,0,10000,10000
07329P,台灣50群益9A售07,0,0,0,0,0,0,0,0,0,10000,0,0,0,10000,0,10000,10000
07247P,聯發科凱基9A售06,0,0,0,0,0,0,0,0,0,10000,0,0,0,40000,30000,10000,10000
07377P,聯發科元大99售40,0,0,0,0,0,0,0,0,0,10000,0,0,0,10000,0,10000,10000
07417P,聯發科元大99售44,0,0,0,0,0,0,0,0,0,10000,0,0,0,20000,10000,10000,10000
07435P,台積電富邦9C售07,0,0,0,0,0,0,0,0,0,10000,0,0,0,10000,0,10000,10000
07424P,大立光元大9B售01,0,0,0,0,0,0,0,0,0,10000,0,0,0,10000,0,10000,10000
07445P,大立光凱基9A售08,0,0,0,0,0,0,0,0,0,10000,0,0,0,10000,0,10000,10000
07744P,奇力新凱基9A售05,0,0,0,0,0,0,0,0,0,10000,0,0,0,10000,0,10000,10000
07705P,台積電元大9A售26,0,0,0,0,0,0,0,0,0,10000,0,0,0,30000,20000,10000,10000
07778P,台灣50凱基9C售08,0,0,0,0,0,0,0,0,0,10000,0,0,0,10000,0,10000,10000
07428P,華新科國票9A售01,0,0,0,0,0,0,0,0,0,10000,0,0,0,10000,0,10000,10000
07494P,葡萄王元大9A售03,0,0,0,0,0,0,0,0,0,10000,0,0,0,10000,0,10000,10000
07526P,臺股指中信9B售08,0,0,0,0,0,0,0,0,0,10000,0,0,0,10000,0,10000,10000
07601P,國巨統一9A售05  ,0,0,0,0,0,0,0,0,0,10000,0,0,0,20000,10000,10000,10000
07586P,FBVIX台新9A售01 ,0,0,0,0,0,0,0,0,0,10000,0,0,0,10000,0,10000,10000
07572P,台灣50元大9A售15,0,0,0,0,0,0,0,0,0,10000,0,0,0,10000,0,10000,10000
07627P,超眾凱基9A售02  ,0,0,0,0,0,0,0,0,0,10000,0,0,0,10000,0,10000,10000
07635P,世芯永豐9A售05  ,0,0,0,0,0,0,0,0,0,10000,0,0,0,20000,10000,10000,10000
07660P,聯茂凱基9A售03  ,0,0,0,0,0,0,0,0,0,10000,0,0,0,23000,13000,10000,10000
07645P,華通元大9A售06  ,0,0,0,0,0,0,0,0,0,10000,0,0,0,10000,0,10000,10000
6715,嘉基            ,22000,12000,10000,0,0,0,0,0,0,0,0,0,0,0,0,0,10000
06466P,台積電統一9B售01,0,0,0,0,0,0,0,0,0,9000,0,0,0,30000,21000,9000,9000
06457P,玉晶光統一98售02,0,0,0,0,0,0,0,0,0,9000,0,0,0,110000,101000,9000,9000
06328P,台積電中信01售02,0,0,0,0,0,0,0,0,0,9000,0,0,0,9000,0,9000,9000
06386P,欣興永豐97售03  ,0,0,0,0,0,0,0,0,0,9000,0,0,0,9000,0,9000,9000
06655P,TPK元大98售02   ,0,0,0,0,0,0,0,0,0,9000,0,0,0,235000,226000,9000,9000
06884P,台郡群益98售03  ,0,0,0,0,0,0,0,0,0,9000,0,0,0,17000,8000,9000,9000
06767P,台積電永昌99售03,0,0,0,0,0,0,0,0,0,9000,0,0,0,50000,41000,9000,9000
061406,華通國票9A購06  ,0,0,0,0,0,0,0,0,0,9000,0,0,0,12000,3000,9000,9000
061317,旺宏凱基9A購05  ,0,0,0,0,0,0,0,0,0,9000,0,0,0,42000,33000,9000,9000
061327,台郡凱基9A購02  ,0,0,0,0,0,0,0,0,0,9000,0,0,0,20000,11000,9000,9000
061229,緯穎中信9B購01  ,0,0,0,0,0,0,0,0,0,9000,0,0,0,39000,30000,9000,9000
061072,南電凱基9B購01  ,0,0,0,0,0,0,0,0,0,9000,0,0,0,9000,0,9000,9000
060697,鴻海國泰9C購01  ,0,0,0,0,0,0,0,0,0,9000,0,0,0,49000,40000,9000,9000
060912,華新科元大9A購10,0,0,0,0,0,0,0,0,0,9000,0,0,0,9000,0,9000,9000
059578,智邦元富99購02  ,0,0,0,0,0,0,0,0,0,9000,0,0,0,9000,0,9000,9000
059562,上銀凱基99購09  ,0,0,0,0,0,0,0,0,0,9000,0,0,0,9000,0,9000,9000
05982P,漢唐國票96售03  ,0,0,0,0,0,0,0,0,0,9000,0,0,0,17000,8000,9000,9000
06016P,京元電凱基96售03,0,0,0,0,0,0,0,0,0,9000,0,0,0,9000,0,9000,9000
053427,鎧勝永豐96購02  ,0,0,0,0,0,0,0,0,0,9000,0,0,0,10000,1000,9000,9000
053094,聯電統一97購02  ,0,0,0,0,0,0,0,0,0,9000,0,0,0,9000,0,9000,9000
055872,亞泥元富97購01  ,0,0,0,0,0,0,0,0,0,9000,0,0,0,70000,61000,9000,9000
055277,旺宏元大97購04  ,0,0,0,0,0,0,0,0,0,9000,0,0,0,9000,0,9000,9000
058325,昇陽半永豐99購01,0,0,0,0,0,0,0,0,0,9000,0,0,0,42000,33000,9000,9000
058252,臺股指元大9A購16,0,0,0,0,0,0,0,0,0,9000,0,0,0,9000,0,9000,9000
049600,緯穎元大95購02  ,0,0,0,0,0,0,0,0,0,9000,0,0,0,10000,1000,9000,9000
045055,聯發科元富98購03,0,0,0,0,0,0,0,0,0,9000,0,0,0,11000,2000,9000,9000
054841,亞德客兆豐97購01,0,0,0,0,0,0,0,0,0,9000,0,0,0,13000,4000,9000,9000
050686,欣興兆豐96購01  ,0,0,0,0,0,0,0,0,0,9000,0,0,0,9000,0,9000,9000
050644,國巨凱基96購01  ,0,0,0,0,0,0,0,0,0,9000,0,0,0,10000,1000,9000,9000
051286,國巨統一97購01  ,0,0,0,0,0,0,0,0,0,9000,0,0,0,9000,0,9000,9000
051463,世芯國泰97購02  ,0,0,0,0,0,0,0,0,0,9000,0,0,0,14000,5000,9000,9000
056899,可成元大98購01  ,0,0,0,0,0,0,0,0,0,9000,0,0,0,73000,64000,9000,9000
057660,訊芯兆豐98購02  ,0,0,0,0,0,0,0,0,0,9000,0,0,0,39000,30000,9000,9000
058022,樺漢凱基99購02  ,0,0,0,0,0,0,0,0,0,9000,0,0,0,21000,12000,9000,9000
058224,世芯統一9B購02  ,0,0,0,0,0,0,0,0,0,9000,0,0,0,19000,10000,9000,9000
058632,世紀鋼國票9A購01,0,0,0,0,0,0,0,0,0,9000,0,0,0,14000,5000,9000,9000
057712,南亞科統一9A購01,0,0,0,0,0,0,0,0,0,9000,0,0,0,9000,0,9000,9000
056203,興富發永豐97購01,0,0,0,0,0,0,0,0,0,9000,0,0,0,9000,0,9000,9000
057386,聯發科永豐98購04,0,0,0,0,0,0,0,0,0,9000,0,0,0,25000,16000,9000,9000
057501,超眾群益98購04  ,0,0,0,0,0,0,0,0,0,9000,0,0,0,10000,1000,9000,9000
056537,冠德凱基98購01  ,0,0,0,0,0,0,0,0,0,9000,0,0,0,15000,6000,9000,9000
056463,台虹凱基98購02  ,0,0,0,0,0,0,0,0,0,9000,0,0,0,9000,0,9000,9000
056315,同欣電元大97購05,0,0,0,0,0,0,0,0,0,9000,0,0,0,9000,0,9000,9000
059466,國巨元大99購26  ,0,0,0,0,0,0,0,0,0,9000,0,0,0,40000,31000,9000,9000
6216,居易            ,27000,18000,9000,0,0,0,0,0,0,0,0,0,0,0,0,0,9000
4725,信昌化          ,111000,102000,9000,0,0,0,0,0,0,0,0,0,0,0,0,0,9000
07812P,大立光統一9A售06,0,0,0,0,0,0,0,0,0,9000,0,0,0,20000,11000,9000,9000
07094P,華通國票9A售03  ,0,0,0,0,0,0,0,0,0,9000,0,0,0,24000,15000,9000,9000
07057P,大立光康和9B售02,0,0,0,0,0,0,0,0,0,9000,0,0,0,9000,0,9000,9000
07009P,臺股指中信9B售01,0,0,0,0,0,0,0,0,0,9000,0,0,0,9000,0,9000,9000
08663P,台灣50元大96售01,0,0,0,0,0,0,0,0,0,9000,0,0,0,9000,0,9000,9000
060143,台積電國票9B購03,0,0,0,0,0,0,0,0,0,8000,0,0,0,17000,9000,8000,8000
060187,華新科元富9A購02,0,0,0,0,0,0,0,0,0,8000,0,0,0,10000,2000,8000,8000
060210,上銀康和9A購01  ,0,0,0,0,0,0,0,0,0,8000,0,0,0,8000,0,8000,8000
059828,健策凱基99購05  ,0,0,0,0,0,0,0,0,0,8000,0,0,0,8000,0,8000,8000
05976P,國巨凱基96售14  ,0,0,0,0,0,0,0,0,0,8000,0,0,0,8000,0,8000,8000
060692,鴻海麥證9A購01  ,0,0,0,8000,0,8000,0,0,0,8000,0,0,0,8000,0,8000,8000
060693,台積電麥證9A購02,0,0,0,10000,2000,8000,0,0,0,8000,0,0,0,10000,2000,8000,8000
060303,宏達電富邦9B購01,0,0,0,0,0,0,0,0,0,8000,0,0,0,14000,6000,8000,8000
061078,台積電兆豐9A購01,0,0,0,0,0,0,0,0,0,8000,0,0,0,10000,2000,8000,8000
061219,臺股指元大9A購56,0,0,0,0,0,0,0,0,0,8000,0,0,0,8000,0,8000,8000
061141,臻鼎統一9A購01  ,0,0,0,0,0,0,0,0,0,8000,0,0,0,49000,41000,8000,8000
061495,聯發科國票9B購01,0,0,0,0,0,0,0,0,0,8000,0,0,0,8000,0,8000,8000
06151P,華新科元大97售07,0,0,0,0,0,0,0,0,0,8000,0,0,0,8000,0,8000,8000
06966P,健策台新9A售02  ,0,0,0,0,0,0,0,0,0,8000,0,0,0,8000,0,8000,8000
06649P,聯發科元大98售08,0,0,0,0,0,0,0,0,0,8000,0,0,0,8000,0,8000,8000
06498P,臺股指元大9A售03,0,0,0,0,0,0,0,0,0,8000,0,0,0,8000,0,8000,8000
061594,玉晶光永豐9A購08,0,0,0,0,0,0,0,0,0,8000,0,0,0,11000,3000,8000,8000
051488,健策凱基96購04  ,0,0,0,0,0,0,0,0,0,8000,0,0,0,8000,0,8000,8000
05174P,元金2X富邦9B售01,0,0,0,0,0,0,0,0,0,8000,0,0,0,8000,0,8000,8000
051804,新光金日盛95購01,0,0,0,0,0,0,0,0,0,8000,0,0,0,8000,0,8000,8000
051879,健策台新96購01  ,0,0,0,0,0,0,0,0,0,8000,0,0,0,8000,0,8000,8000
050890,南電富邦99購01  ,0,0,0,0,0,0,0,0,0,8000,0,0,0,8000,0,8000,8000
051902,T50反1元大97購01,0,0,0,0,0,0,0,0,0,8000,0,0,0,38000,30000,8000,8000
049221,健策國票95購02  ,0,0,0,0,0,0,0,0,0,8000,0,0,0,8000,0,8000,8000
048432,全新國票95購01  ,0,0,0,0,0,0,0,0,0,8000,0,0,0,8000,0,8000,8000
052231,景碩凱基96購01  ,0,0,0,0,0,0,0,0,0,8000,0,0,0,8000,0,8000,8000
03650C,T50反1元大98牛05,0,0,0,0,0,0,0,0,0,8000,0,0,0,21000,13000,8000,8000
057955,技嘉元大98購07  ,0,0,0,0,0,0,0,0,0,8000,0,0,0,18000,10000,8000,8000
056772,欣興元大99購01  ,0,0,0,0,0,0,0,0,0,8000,0,0,0,9000,1000,8000,8000
055177,宏達電統一99購01,0,0,0,0,0,0,0,0,0,8000,0,0,0,8000,0,8000,8000
054632,緯穎凱基9A購01  ,0,0,0,0,0,0,0,0,0,8000,0,0,0,10000,2000,8000,8000
053315,漢唐群益96購02  ,0,0,0,0,0,0,0,0,0,8000,0,0,0,75000,67000,8000,8000
053459,康控國泰97購01  ,0,0,0,0,0,0,0,0,0,8000,0,0,0,8000,0,8000,8000
055085,大毅國票97購01  ,0,0,0,0,0,0,0,0,0,8000,0,0,0,10000,2000,8000,8000
054930,群電凱基98購01  ,0,0,0,0,0,0,0,0,0,8000,0,0,0,38000,30000,8000,8000
055456,上銀富邦99購01  ,0,0,0,0,0,0,0,0,0,8000,0,0,0,19000,11000,8000,8000
059455,玉晶光永豐99購05,0,0,0,0,0,0,0,0,0,8000,0,0,0,8000,0,8000,8000
059387,華通凱基9A購03  ,0,0,0,0,0,0,0,0,0,8000,0,0,0,10000,2000,8000,8000
059382,台灣50凱基99購02,0,0,0,0,0,0,0,0,0,8000,0,0,0,8000,0,8000,8000
059078,FBVIX元大99購06 ,0,0,0,0,0,0,0,0,0,8000,0,0,0,8000,0,8000,8000
056720,世紀鋼永豐98購01,0,0,0,0,0,0,0,0,0,8000,0,0,0,35000,27000,8000,8000
057452,新日興元富98購01,0,0,0,0,0,0,0,0,0,8000,0,0,0,38000,30000,8000,8000
057447,智邦元富02購01  ,0,0,0,0,0,0,0,0,0,8000,0,0,0,30000,22000,8000,8000
056959,鴻海永豐98購03  ,0,0,0,0,0,0,0,0,0,8000,0,0,0,8000,0,8000,8000
058416,鴻海麥證99購01  ,0,0,0,8000,0,8000,0,0,0,8000,0,0,0,8000,0,8000,8000
058799,晶技元大99購04  ,0,0,0,0,0,0,0,0,0,8000,0,0,0,8000,0,8000,8000
058206,祥碩凱基99購01  ,0,0,0,0,0,0,0,0,0,8000,0,0,0,83000,75000,8000,8000
058036,南電永豐98購01  ,0,0,0,0,0,0,0,0,0,8000,0,0,0,9000,1000,8000,8000
056903,大立光元大99購04,0,0,0,0,0,0,0,0,0,8000,0,0,0,10000,2000,8000,8000
07236P,台灣50國票99售05,0,0,0,0,0,0,0,0,0,8000,0,0,0,8000,0,8000,8000
07697P,臺股指元大9A售50,0,0,0,0,0,0,0,0,0,8000,0,0,0,8000,0,8000,8000
07547P,緯穎凱基9A售05  ,0,0,0,0,0,0,0,0,0,8000,0,0,0,19000,11000,8000,8000
06355P,聯茂永豐97售02  ,0,0,0,0,0,0,0,0,0,7000,0,0,0,22000,15000,7000,7000
06638P,鴻海統一99售02  ,0,0,0,0,0,0,0,0,0,7000,0,0,0,25000,18000,7000,7000
06736P,新日興凱基98售03,0,0,0,0,0,0,0,0,0,7000,0,0,0,30000,23000,7000,7000
06800P,台灣50群益9A售02,0,0,0,0,0,0,0,0,0,7000,0,0,0,7000,0,7000,7000
061442,玉晶光永豐9A購07,0,0,0,0,0,0,0,0,0,7000,0,0,0,8000,1000,7000,7000
061363,儒鴻國票9B購01  ,0,0,0,0,0,0,0,0,0,7000,0,0,0,56000,49000,7000,7000
061310,華新科麥證9A購01,0,0,0,7000,0,7000,0,0,0,7000,0,0,0,7000,0,7000,7000
061013,台積電麥證9A購03,0,0,0,7000,0,7000,0,0,0,7000,0,0,0,7000,0,7000,7000
06051P,嘉聯益國票97售04,0,0,0,0,0,0,0,0,0,7000,0,0,0,7000,0,7000,7000
060570,南亞科永豐9A購01,0,0,0,0,0,0,0,0,0,7000,0,0,0,12000,5000,7000,7000
060501,鴻海元大9A購13  ,0,0,0,0,0,0,0,0,0,7000,0,0,0,17000,10000,7000,7000
059858,台灣50群益9A購09,0,0,0,0,0,0,0,0,0,7000,0,0,0,7000,0,7000,7000
060198,祥碩元富9A購02  ,0,0,0,0,0,0,0,0,0,7000,0,0,0,7000,0,7000,7000
060046,S&P反1凱基99購02,0,0,0,0,0,0,0,0,0,7000,0,0,0,27000,20000,7000,7000
052832,益航群益96購01  ,0,0,0,0,0,0,0,0,0,7000,0,0,0,7000,0,7000,7000
053388,群創元大9C購02  ,0,0,0,0,0,0,0,0,0,7000,0,0,0,7000,0,7000,7000
053158,茂林元大96購01  ,0,0,0,0,0,0,0,0,0,7000,0,0,0,7000,0,7000,7000
055178,晶豪科統一97購01,0,0,0,0,0,0,0,0,0,7000,0,0,0,65000,58000,7000,7000
057959,欣興元大98購14  ,0,0,0,0,0,0,0,0,0,7000,0,0,0,49000,42000,7000,7000
035276,南亞科台新97購01,0,0,0,0,0,0,0,0,0,7000,0,0,0,7000,0,7000,7000
049252,國巨元大96購01  ,0,0,0,0,0,0,0,0,0,7000,0,0,0,10000,3000,7000,7000
049430,國巨國票95購02  ,0,0,0,0,0,0,0,0,0,7000,0,0,0,7000,0,7000,7000
049759,元黃金富邦9A購01,0,0,0,0,0,0,0,0,0,7000,0,0,0,10000,3000,7000,7000
05169P,玉晶光元大95售03,0,0,0,0,0,0,0,0,0,7000,0,0,0,7000,0,7000,7000
050188,貿聯元大96購01  ,0,0,0,0,0,0,0,0,0,7000,0,0,0,7000,0,7000,7000
05024P,華通國票96售01  ,0,0,0,0,0,0,0,0,0,7000,0,0,0,7000,0,7000,7000
058488,華擎國票9A購01  ,0,0,0,0,0,0,0,0,0,7000,0,0,0,26000,19000,7000,7000
058801,致伸元大99購01  ,0,0,0,0,0,0,0,0,0,7000,0,0,0,69000,62000,7000,7000
05801P,正崴兆豐96售01  ,0,0,0,0,0,0,0,0,0,7000,0,0,0,7000,0,7000,7000
056124,華通國票98購02  ,0,0,0,0,0,0,0,0,0,7000,0,0,0,29000,22000,7000,7000
055730,建準元富97購02  ,0,0,0,0,0,0,0,0,0,7000,0,0,0,7000,0,7000,7000
056224,聯發科凱基97購08,0,0,0,0,0,0,0,0,0,7000,0,0,0,7000,0,7000,7000
057716,神達統一98購01  ,0,0,0,0,0,0,0,0,0,7000,0,0,0,7000,0,7000,7000
057832,聯發科元富02購05,0,0,0,0,0,0,0,0,0,7000,0,0,0,35000,28000,7000,7000
056682,鴻海統一98購10  ,0,0,0,0,0,0,0,0,0,7000,0,0,0,7000,0,7000,7000
05658P,日月光元富96售02,0,0,0,0,0,0,0,0,0,7000,0,0,0,7000,0,7000,7000
056602,嘉澤國泰99購01  ,0,0,0,0,0,0,0,0,0,7000,0,0,0,7000,0,7000,7000
056477,欣興元大98購02  ,0,0,0,0,0,0,0,0,0,7000,0,0,0,12000,5000,7000,7000
057057,立積元大9A購01  ,0,0,0,0,0,0,0,0,0,7000,0,0,0,28000,21000,7000,7000
059118,晶技永豐9A購01  ,0,0,0,0,0,0,0,0,0,7000,0,0,0,8000,1000,7000,7000
057251,泰鼎統一98購02  ,0,0,0,0,0,0,0,0,0,7000,0,0,0,14000,7000,7000,7000
05760P,京鼎永豐96售02  ,0,0,0,0,0,0,0,0,0,7000,0,0,0,40000,33000,7000,7000
07840P,康控元大9A售02  ,0,0,0,0,0,0,0,0,0,7000,0,0,0,7000,0,7000,7000
07235P,T50正2元大9C售02,0,0,0,0,0,0,0,0,0,7000,0,0,0,7000,0,7000,7000
07065P,臺股指元大9A售26,0,0,0,0,0,0,0,0,0,7000,0,0,0,7000,0,7000,7000
07370P,南亞科凱基99售08,0,0,0,0,0,0,0,0,0,7000,0,0,0,19000,12000,7000,7000
4108,懷特            ,79000,72000,7000,0,0,0,0,0,0,0,0,0,0,0,0,0,7000
8480,泰昇-KY         ,16000,9000,7000,0,0,0,0,0,0,0,0,0,0,0,0,0,7000
060074,台積電元富99購04,0,0,0,0,0,0,0,0,0,6000,0,0,0,10000,4000,6000,6000
059925,可成國泰9B購01  ,0,0,0,0,0,0,0,0,0,6000,0,0,0,17000,11000,6000,6000
059934,華通永豐99購02  ,0,0,0,0,0,0,0,0,0,6000,0,0,0,19000,13000,6000,6000
060213,牧德康和9A購01  ,0,0,0,0,0,0,0,0,0,6000,0,0,0,6000,0,6000,6000
060146,健策國票9A購03  ,0,0,0,0,0,0,0,0,0,6000,0,0,0,6000,0,6000,6000
059915,聯發科元大99購32,0,0,0,0,0,0,0,0,0,6000,0,0,0,19000,13000,6000,6000
059566,台積電凱基9A購11,0,0,0,0,0,0,0,0,0,6000,0,0,0,9000,3000,6000,6000
059732,超眾元大9A購01  ,0,0,0,0,0,0,0,0,0,6000,0,0,0,55000,49000,6000,6000
060585,玉晶光元富9A購02,0,0,0,0,0,0,0,0,0,6000,0,0,0,7000,1000,6000,6000
060727,高股息中信9C購02,0,0,0,0,0,0,0,0,0,6000,0,0,0,6000,0,6000,6000
061021,聯電國泰9B購01  ,0,0,0,0,0,0,0,0,0,6000,0,0,0,6000,0,6000,6000
061253,臺股指群益9A購04,0,0,0,0,0,0,0,0,0,6000,0,0,0,8000,2000,6000,6000
061430,致新元大9A購01  ,0,0,0,0,0,0,0,0,0,6000,0,0,0,547000,541000,6000,6000
06860P,台灣50兆豐98售01,0,0,0,0,0,0,0,0,0,6000,0,0,0,177000,171000,6000,6000
06959P,鴻海凱基9A售02  ,0,0,0,0,0,0,0,0,0,6000,0,0,0,6000,0,6000,6000
06676P,華新科國票98售03,0,0,0,0,0,0,0,0,0,6000,0,0,0,16000,10000,6000,6000
06451P,聯發科元大98售04,0,0,0,0,0,0,0,0,0,6000,0,0,0,6000,0,6000,6000
061618,友達群益9A購04  ,0,0,0,0,0,0,0,0,0,6000,0,0,0,6000,0,6000,6000
061575,華新科元大9A購20,0,0,0,0,0,0,0,0,0,6000,0,0,0,6000,0,6000,6000
061576,華新科元大9A購21,0,0,0,0,0,0,0,0,0,6000,0,0,0,6000,0,6000,6000
061719,緯穎凱基9A購06  ,0,0,0,0,0,0,0,0,0,6000,0,0,0,6000,0,6000,6000
061678,玉晶光元大9B購04,0,0,0,0,0,0,0,0,0,6000,0,0,0,15000,9000,6000,6000
054846,瑞昱兆豐97購01  ,0,0,0,0,0,0,0,0,0,6000,0,0,0,6000,0,6000,6000
051412,奇力新國票96購01,0,0,0,0,0,0,0,0,0,6000,0,0,0,6000,0,6000,6000
00865B,國泰US短期公債  ,0,0,0,0,0,0,0,0,0,6000,0,0,0,107000,101000,6000,6000
03437B,臺股指元富9C熊01,0,0,0,0,0,0,0,0,0,6000,0,0,0,8000,2000,6000,6000
047675,群創元富96購03  ,0,0,0,0,0,0,0,0,0,6000,0,0,0,6000,0,6000,6000
052191,超眾群益96購01  ,0,0,0,0,0,0,0,0,0,6000,0,0,0,6000,0,6000,6000
052388,旺宏群益96購05  ,0,0,0,0,0,0,0,0,0,6000,0,0,0,7000,1000,6000,6000
052633,國巨凱基96購05  ,0,0,0,0,0,0,0,0,0,6000,0,0,0,36000,30000,6000,6000
058259,訊連國泰9B購01  ,0,0,0,0,0,0,0,0,0,6000,0,0,0,6000,0,6000,6000
058333,鴻海元富99購04  ,0,0,0,0,0,0,0,0,0,6000,0,0,0,6000,0,6000,6000
058233,聯發科元大99購06,0,0,0,0,0,0,0,0,0,6000,0,0,0,16000,10000,6000,6000
055910,瑞昱凱基98購01  ,0,0,0,0,0,0,0,0,0,6000,0,0,0,6000,0,6000,6000
055245,凱美統一99購01  ,0,0,0,0,0,0,0,0,0,6000,0,0,0,31000,25000,6000,6000
054384,瀚宇博群益96購02,0,0,0,0,0,0,0,0,0,6000,0,0,0,8000,2000,6000,6000
054104,T50反1凱基9A購02,0,0,0,0,0,0,0,0,0,6000,0,0,0,6000,0,6000,6000
053073,技嘉康和96購01  ,0,0,0,0,0,0,0,0,0,6000,0,0,0,6000,0,6000,6000
055407,祥碩國泰98購01  ,0,0,0,0,0,0,0,0,0,6000,0,0,0,20000,14000,6000,6000
055352,奇力新凱基97購01,0,0,0,0,0,0,0,0,0,6000,0,0,0,6000,0,6000,6000
057245,福懋科台新98購01,0,0,0,0,0,0,0,0,0,6000,0,0,0,6000,0,6000,6000
056324,南亞科兆豐98購01,0,0,0,0,0,0,0,0,0,6000,0,0,0,40000,34000,6000,6000
057198,智伸科統一9B購01,0,0,0,0,0,0,0,0,0,6000,0,0,0,6000,0,6000,6000
059235,鴻海凱基99購08  ,0,0,0,0,0,0,0,0,0,6000,0,0,0,6000,0,6000,6000
059276,可成元大99購06  ,0,0,0,0,0,0,0,0,0,6000,0,0,0,10000,4000,6000,6000
059292,華新科元富9B購02,0,0,0,0,0,0,0,0,0,6000,0,0,0,6000,0,6000,6000
056625,致伸永豐98購01  ,0,0,0,0,0,0,0,0,0,6000,0,0,0,16000,10000,6000,6000
056681,鴻海統一98購09  ,0,0,0,0,0,0,0,0,0,6000,0,0,0,6000,0,6000,6000
058997,鴻海元大99購21  ,0,0,0,0,0,0,0,0,0,6000,0,0,0,27000,21000,6000,6000
057456,道瓊銀富邦9C購01,0,0,0,0,0,0,0,0,0,6000,0,0,0,6000,0,6000,6000
05741P,聯發科元大96售14,0,0,0,0,0,0,0,0,0,6000,0,0,0,6000,0,6000,6000
056507,創意永豐98購02  ,0,0,0,0,0,0,0,0,0,6000,0,0,0,6000,0,6000,6000
056972,祥碩永豐98購02  ,0,0,0,0,0,0,0,0,0,6000,0,0,0,6000,0,6000,6000
05620P,大立光富邦9B售01,0,0,0,0,0,0,0,0,0,6000,0,0,0,6000,0,6000,6000
055582,亞德客元大97購01,0,0,0,0,0,0,0,0,0,6000,0,0,0,6000,0,6000,6000
056141,聯茂元大97購05  ,0,0,0,0,0,0,0,0,0,6000,0,0,0,6000,0,6000,6000
058166,鴻海凱基9A購01  ,0,0,0,0,0,0,0,0,0,6000,0,0,0,6000,0,6000,6000
058175,旺宏凱基99購03  ,0,0,0,0,0,0,0,0,0,6000,0,0,0,10000,4000,6000,6000
058127,FBVIX元大9C購01 ,0,0,0,0,0,0,0,0,0,6000,0,0,0,6000,0,6000,6000
058528,世紀鋼元大99購02,0,0,0,0,0,0,0,0,0,6000,0,0,0,6000,0,6000,6000
056902,大立光元大98購12,0,0,0,0,0,0,0,0,0,6000,0,0,0,6000,0,6000,6000
05692P,聯發科中信9A售02,0,0,0,0,0,0,0,0,0,6000,0,0,0,6000,0,6000,6000
8499,鼎炫-KY         ,31000,25000,6000,0,0,0,0,0,0,0,0,0,0,0,0,0,6000
4551,智伸科          ,91000,71000,20000,0,0,0,0,0,0,-14000,0,3000,-3000,0,11000,-11000,6000
07322P,鴻海元大99售33  ,0,0,0,0,0,0,0,0,0,6000,0,0,0,6000,0,6000,6000
07075P,FBVIX凱基9C售04 ,0,0,0,0,0,0,0,0,0,6000,0,0,0,6000,0,6000,6000
2543,皇昌            ,8000,2000,6000,0,0,0,0,0,0,0,0,0,0,0,0,0,6000
2429,銘旺科          ,18000,12000,6000,0,0,0,0,0,0,0,0,0,0,0,0,0,6000
061697,世紀鋼群益9A購03,0,0,0,0,0,0,0,0,0,5000,0,0,0,15000,10000,5000,5000
06414P,矽力凱基97售03  ,0,0,0,0,0,0,0,0,0,5000,0,0,0,5000,0,5000,5000
06634P,欣興國票98售02  ,0,0,0,0,0,0,0,0,0,5000,0,0,0,5000,0,5000,5000
06940P,旺宏永豐98售05  ,0,0,0,0,0,0,0,0,0,5000,0,0,0,5000,0,5000,5000
06929P,鴻海元大99售11  ,0,0,0,0,0,0,0,0,0,5000,0,0,0,5000,0,5000,5000
06905P,上証2X國泰99售02,0,0,0,0,0,0,0,0,0,5000,0,0,0,5000,0,5000,5000
06148P,台積電元大97售17,0,0,0,0,0,0,0,0,0,5000,0,0,0,5000,0,5000,5000
061128,大立光永豐9A購02,0,0,0,0,0,0,0,0,0,5000,0,0,0,5000,0,5000,5000
061153,奇力新群益9A購02,0,0,0,0,0,0,0,0,0,5000,0,0,0,160000,155000,5000,5000
061088,國巨統一9C購05  ,0,0,0,0,0,0,0,0,0,5000,0,0,0,215000,210000,5000,5000
06123P,玉晶光元大97售04,0,0,0,0,0,0,0,0,0,5000,0,0,0,35000,30000,5000,5000
060611,同欣電凱基9A購02,0,0,0,0,0,0,0,0,0,5000,0,0,0,182000,177000,5000,5000
060852,京鼎國泰9B購01  ,0,0,0,0,0,0,0,0,0,5000,0,0,0,30000,25000,5000,5000
060791,聯茂富邦9A購02  ,0,0,0,0,0,0,0,0,0,5000,0,0,0,5000,0,5000,5000
060842,新光金國票9B購01,0,0,0,0,0,0,0,0,0,5000,0,0,0,5000,0,5000,5000
060346,華新科統一01購01,0,0,0,0,0,0,0,0,0,5000,0,0,0,5000,0,5000,5000
059572,華新科凱基99購08,0,0,0,0,0,0,0,0,0,5000,0,0,0,5000,0,5000,5000
059528,華新科凱基99購06,0,0,0,0,0,0,0,0,0,5000,0,0,0,5000,0,5000,5000
059530,華新科凱基9A購05,0,0,0,0,0,0,0,0,0,5000,0,0,0,5000,0,5000,5000
059918,華新科元大99購20,0,0,0,0,0,0,0,0,0,5000,0,0,0,5000,0,5000,5000
059910,鴻海元大99購37  ,0,0,0,0,0,0,0,0,0,5000,0,0,0,6000,1000,5000,5000
059889,華新科國票99購04,0,0,0,0,0,0,0,0,0,5000,0,0,0,5000,0,5000,5000
059885,台積電國票99購12,0,0,0,0,0,0,0,0,0,5000,0,0,0,20000,15000,5000,5000
059869,友達凱基99購07  ,0,0,0,0,0,0,0,0,0,5000,0,0,0,10000,5000,5000,5000
059820,南亞科凱基99購07,0,0,0,0,0,0,0,0,0,5000,0,0,0,5000,0,5000,5000
059793,滬深2X國票99購03,0,0,0,0,0,0,0,0,0,5000,0,0,0,5000,0,5000,5000
060038,台積電國票99購13,0,0,0,0,0,0,0,0,0,5000,0,0,0,59000,54000,5000,5000
055346,國巨凱基98購02  ,0,0,0,0,0,0,0,0,0,5000,0,0,0,5000,0,5000,5000
055443,台虹國票98購01  ,0,0,0,0,0,0,0,0,0,5000,0,0,0,5000,0,5000,5000
052985,美律元大96購02  ,0,0,0,0,0,0,0,0,0,5000,0,0,0,5000,0,5000,5000
052986,聯發科元大97購05,0,0,0,0,0,0,0,0,0,5000,0,0,0,5000,0,5000,5000
053949,康控富邦9A購01  ,0,0,0,0,0,0,0,0,0,5000,0,0,0,5000,0,5000,5000
053063,力山群益98購01  ,0,0,0,0,0,0,0,0,0,5000,0,0,0,75000,70000,5000,5000
053079,世紀鋼永豐96購01,0,0,0,0,0,0,0,0,0,5000,0,0,0,15000,10000,5000,5000
053483,嘉澤第一96購01  ,0,0,0,0,0,0,0,0,0,5000,0,0,0,5000,0,5000,5000
055125,智原兆豐97購01  ,0,0,0,0,0,0,0,0,0,5000,0,0,0,5000,0,5000,5000
054427,潤泰全富邦97購01,0,0,0,0,0,0,0,0,0,5000,0,0,0,15000,10000,5000,5000
055176,大毅統一98購02  ,0,0,0,0,0,0,0,0,0,5000,0,0,0,5000,0,5000,5000
054452,華通亞東96購01  ,0,0,0,0,0,0,0,0,0,5000,0,0,0,5000,0,5000,5000
055852,聯鈞元大98購01  ,0,0,0,0,0,0,0,0,0,5000,0,0,0,5000,0,5000,5000
056757,T50反1元大98購07,0,0,0,0,0,0,0,0,0,5000,0,0,0,5000,0,5000,5000
05796P,臺股指群益96售10,0,0,0,0,0,0,0,0,0,5000,0,0,0,5000,0,5000,5000
05252P,華通凱基95售01  ,0,0,0,0,0,0,0,0,0,5000,0,0,0,5000,0,5000,5000
052167,亞泥元大96購01  ,0,0,0,0,0,0,0,0,0,5000,0,0,0,5000,0,5000,5000
052146,泰碩群益95購01  ,0,0,0,0,0,0,0,0,0,5000,0,0,0,5000,0,5000,5000
052216,康友元大96購01  ,0,0,0,0,0,0,0,0,0,5000,0,0,0,5000,0,5000,5000
047681,滬深反中信95購01,0,0,0,0,0,0,0,0,0,5000,0,0,0,5000,0,5000,5000
04713P,創意元大95售01  ,0,0,0,0,0,0,0,0,0,5000,0,0,0,15000,10000,5000,5000
03674C,臺股指元富9C牛02,0,0,0,0,0,0,0,0,0,5000,0,0,0,7000,2000,5000,5000
049922,禾伸堂元大95購01,0,0,0,0,0,0,0,0,0,5000,0,0,0,5000,0,5000,5000
04979P,臺股指凱基96售07,0,0,0,0,0,0,0,0,0,5000,0,0,0,5000,0,5000,5000
04616P,臺股指群益95售02,0,0,0,0,0,0,0,0,0,5000,0,0,0,10000,5000,5000,5000
04327P,台積電國泰95售01,0,0,0,0,0,0,0,0,0,5000,0,0,0,5000,0,5000,5000
049491,聯發科元大95購01,0,0,0,0,0,0,0,0,0,5000,0,0,0,5000,0,5000,5000
04926P,聯發科凱基95售03,0,0,0,0,0,0,0,0,0,5000,0,0,0,5000,0,5000,5000
049670,鈺齊國泰96購01  ,0,0,0,0,0,0,0,0,0,5000,0,0,0,5000,0,5000,5000
049064,T50反1凱基96購03,0,0,0,0,0,0,0,0,0,5000,0,0,0,5000,0,5000,5000
048870,義隆國票96購01  ,0,0,0,0,0,0,0,0,0,5000,0,0,0,35000,30000,5000,5000
051416,創意國票96購02  ,0,0,0,0,0,0,0,0,0,5000,0,0,0,5000,0,5000,5000
051380,禾伸堂群益95購01,0,0,0,0,0,0,0,0,0,5000,0,0,0,5000,0,5000,5000
051472,台積電凱基95購09,0,0,0,0,0,0,0,0,0,5000,0,0,0,5000,0,5000,5000
051424,緯穎國票97購01  ,0,0,0,0,0,0,0,0,0,5000,0,0,0,11000,6000,5000,5000
051283,亞德客統一95購01,0,0,0,0,0,0,0,0,0,5000,0,0,0,5000,0,5000,5000
05163P,聯發科統一96售02,0,0,0,0,0,0,0,0,0,5000,0,0,0,5000,0,5000,5000
051991,泰碩元大95購02  ,0,0,0,0,0,0,0,0,0,5000,0,0,0,5000,0,5000,5000
051944,智邦統一95購02  ,0,0,0,0,0,0,0,0,0,5000,0,0,0,5000,0,5000,5000
052707,景碩台新96購01  ,0,0,0,0,0,0,0,0,0,5000,0,0,0,5000,0,5000,5000
052712,旺宏凱基96購02  ,0,0,0,0,0,0,0,0,0,5000,0,0,0,5000,0,5000,5000
050943,楠梓電群益96購01,0,0,0,0,0,0,0,0,0,5000,0,0,0,5000,0,5000,5000
054833,京鼎中信97購01  ,0,0,0,0,0,0,0,0,0,5000,0,0,0,5000,0,5000,5000
054703,聯發科第一97購01,0,0,0,0,0,0,0,0,0,5000,0,0,0,5000,0,5000,5000
050522,聯發科元大95購03,0,0,0,0,0,0,0,0,0,5000,0,0,0,15000,10000,5000,5000
057667,可成元大99購01  ,0,0,0,0,0,0,0,0,0,5000,0,0,0,29000,24000,5000,5000
05849P,臺股指元大96售25,0,0,0,0,0,0,0,0,0,5000,0,0,0,5000,0,5000,5000
058564,元金2X凱基9C購01,0,0,0,0,0,0,0,0,0,5000,0,0,0,5000,0,5000,5000
05793P,臺股指中信99售08,0,0,0,0,0,0,0,0,0,5000,0,0,0,10000,5000,5000,5000
058946,SGBR2X群益9B購01,0,0,0,0,0,0,0,0,0,5000,0,0,0,5000,0,5000,5000
05895P,奇力新群益96售03,0,0,0,0,0,0,0,0,0,5000,0,0,0,5000,0,5000,5000
058553,合勤控永豐99購01,0,0,0,0,0,0,0,0,0,5000,0,0,0,5000,0,5000,5000
058220,世芯國票9A購01  ,0,0,0,0,0,0,0,0,0,5000,0,0,0,15000,10000,5000,5000
056516,晶豪科兆豐98購01,0,0,0,0,0,0,0,0,0,5000,0,0,0,9000,4000,5000,5000
056385,創意國泰99購01  ,0,0,0,0,0,0,0,0,0,5000,0,0,0,5000,0,5000,5000
05635P,健策台新96售02  ,0,0,0,0,0,0,0,0,0,5000,0,0,0,5000,0,5000,5000
057746,同欣電永豐98購02,0,0,0,0,0,0,0,0,0,5000,0,0,0,5000,0,5000,5000
058673,華新科群益9A購02,0,0,0,0,0,0,0,0,0,5000,0,0,0,10000,5000,5000,5000
058835,元油2X中信9C購02,0,0,0,0,0,0,0,0,0,5000,0,0,0,10000,5000,5000,5000
058415,祥碩兆豐99購01  ,0,0,0,0,0,0,0,0,0,5000,0,0,0,5000,0,5000,5000
058651,FBVIX中信9C購01 ,0,0,0,0,0,0,0,0,0,5000,0,0,0,5000,0,5000,5000
058666,上証反群益01購01,0,0,0,0,0,0,0,0,0,5000,0,0,0,5000,0,5000,5000
058602,台積電元大99購11,0,0,0,0,0,0,0,0,0,5000,0,0,0,5000,0,5000,5000
057427,華通兆豐99購01  ,0,0,0,0,0,0,0,0,0,5000,0,0,0,25000,20000,5000,5000
057372,華新科元大99購10,0,0,0,0,0,0,0,0,0,5000,0,0,0,5000,0,5000,5000
057582,亞光中信9A購02  ,0,0,0,0,0,0,0,0,0,5000,0,0,0,5000,0,5000,5000
056732,國巨凱基98購07  ,0,0,0,0,0,0,0,0,0,5000,0,0,0,5000,0,5000,5000
056475,宏達電元大99購02,0,0,0,0,0,0,0,0,0,5000,0,0,0,5000,0,5000,5000
05710P,禾伸堂國票97售02,0,0,0,0,0,0,0,0,0,5000,0,0,0,130000,125000,5000,5000
057807,友訊元大98購02  ,0,0,0,0,0,0,0,0,0,5000,0,0,0,10000,5000,5000,5000
05922P,京元電兆豐96售01,0,0,0,0,0,0,0,0,0,5000,0,0,0,5000,0,5000,5000
059191,茂林富邦9B購01  ,0,0,0,0,0,0,0,0,0,5000,0,0,0,5000,0,5000,5000
059218,台積電元大99購31,0,0,0,0,0,0,0,0,0,5000,0,0,0,5000,0,5000,5000
059390,華新科凱基99購05,0,0,0,0,0,0,0,0,0,5000,0,0,0,5000,0,5000,5000
059431,旺宏元大99購14  ,0,0,0,0,0,0,0,0,0,5000,0,0,0,5000,0,5000,5000
056321,創意群益98購02  ,0,0,0,0,0,0,0,0,0,5000,0,0,0,129000,124000,5000,5000
057281,大立光元大98購16,0,0,0,0,0,0,0,0,0,5000,0,0,0,5000,0,5000,5000
057604,鴻海統一9C購01  ,0,0,0,0,0,0,0,0,0,5000,0,0,0,5000,0,5000,5000
057870,大立光凱基99購02,0,0,0,0,0,0,0,0,0,5000,0,0,0,5000,0,5000,5000
3025,星通            ,10000,5000,5000,0,0,0,0,0,0,0,0,0,0,0,0,0,5000
1773,勝一            ,39000,34000,5000,0,0,0,0,0,0,0,0,0,0,0,0,0,5000
07053P,台灣50兆豐01售01,0,0,0,0,0,0,0,0,0,5000,0,0,0,48000,43000,5000,5000
07206P,鴻海凱基9A售11  ,0,0,0,0,0,0,0,0,0,5000,0,0,0,5000,0,5000,5000
07315P,台積電台新99售06,0,0,0,0,0,0,0,0,0,5000,0,0,0,35000,30000,5000,5000
07246P,旺宏凱基99售08  ,0,0,0,0,0,0,0,0,0,5000,0,0,0,35000,30000,5000,5000
07405P,大立光凱基99售17,0,0,0,0,0,0,0,0,0,5000,0,0,0,5000,0,5000,5000
07717P,臺股指群益9A售06,0,0,0,0,0,0,0,0,0,5000,0,0,0,23000,18000,5000,5000
07734P,台積電富邦9C售10,0,0,0,0,0,0,0,0,0,5000,0,0,0,5000,0,5000,5000
07543P,台積電凱基9A售17,0,0,0,0,0,0,0,0,0,5000,0,0,0,5000,0,5000,5000
07628P,臺股指凱基9A售09,0,0,0,0,0,0,0,0,0,5000,0,0,0,15000,10000,5000,5000
6533,晶心科          ,117000,112000,5000,0,0,0,0,0,0,0,0,0,0,0,0,0,5000
5234,達興材料        ,52000,47000,5000,0,0,0,0,0,0,0,0,0,0,0,0,0,5000
059811,高股息凱基99購02,0,0,0,0,0,0,0,0,0,4000,0,0,0,5000,1000,4000,4000
059901,滬深2X元大9C購07,0,0,0,0,0,0,0,0,0,4000,0,0,0,90000,86000,4000,4000
059535,玉山金凱基99購01,0,0,0,0,0,0,0,0,0,4000,0,0,0,60000,56000,4000,4000
059545,台灣50群益99購04,0,0,0,0,0,0,0,0,0,4000,0,0,0,4000,0,4000,4000
059586,上銀元大9A購02  ,0,0,0,0,0,0,0,0,0,4000,0,0,0,4000,0,4000,4000
060594,國巨麥證9A購01  ,0,0,0,9000,5000,4000,0,0,0,4000,0,0,0,9000,5000,4000,4000
060533,臺股指中信9B購05,0,0,0,0,0,0,0,0,0,4000,0,0,0,5000,1000,4000,4000
061104,華新科元大9A購13,0,0,0,0,0,0,0,0,0,4000,0,0,0,4000,0,4000,4000
06899P,嘉澤群益98售01  ,0,0,0,0,0,0,0,0,0,4000,0,0,0,4000,0,4000,4000
06799P,臺股指凱基98售09,0,0,0,0,0,0,0,0,0,4000,0,0,0,4000,0,4000,4000
06766P,玉晶光元大99售10,0,0,0,0,0,0,0,0,0,4000,0,0,0,63000,59000,4000,4000
06613P,華新科富邦9A售03,0,0,0,0,0,0,0,0,0,4000,0,0,0,4000,0,4000,4000
06505P,康控國票99售02  ,0,0,0,0,0,0,0,0,0,4000,0,0,0,11000,7000,4000,4000
06378P,國巨統一97售08  ,0,0,0,0,0,0,0,0,0,4000,0,0,0,24000,20000,4000,4000
06306P,臺股指元大97售12,0,0,0,0,0,0,0,0,0,4000,0,0,0,4000,0,4000,4000
06184P,大立光元大97售06,0,0,0,0,0,0,0,0,0,4000,0,0,0,4000,0,4000,4000
050660,欣興元大96購02  ,0,0,0,0,0,0,0,0,0,4000,0,0,0,4000,0,4000,4000
051211,道瓊反統一95購01,0,0,0,0,0,0,0,0,0,4000,0,0,0,4000,0,4000,4000
048652,巨大元大96購01  ,0,0,0,0,0,0,0,0,0,4000,0,0,0,4000,0,4000,4000
01007T,兆豐國泰R2      ,4000,0,4000,0,0,0,0,0,0,0,0,0,0,0,0,0,4000
03427B,臺股指元大9A熊02,0,0,0,0,0,0,0,0,0,4000,0,0,0,4000,0,4000,4000
047420,全新富邦97購01  ,0,0,0,0,0,0,0,0,0,4000,0,0,0,4000,0,4000,4000
058267,奇鋐永豐99購01  ,0,0,0,0,0,0,0,0,0,4000,0,0,0,31000,27000,4000,4000
054481,鎧勝中信96購01  ,0,0,0,0,0,0,0,0,0,4000,0,0,0,156000,152000,4000,4000
054076,義隆第一96購01  ,0,0,0,0,0,0,0,0,0,4000,0,0,0,4000,0,4000,4000
054061,晶技國票97購03  ,0,28000,-28000,0,0,0,0,0,0,32000,0,0,0,60000,28000,32000,4000
053170,茂林群益96購04  ,0,0,0,0,0,0,0,0,0,4000,0,0,0,4000,0,4000,4000
052863,友達凱基98購02  ,0,0,0,0,0,0,0,0,0,4000,0,0,0,4000,0,4000,4000
052887,華通中信96購01  ,0,0,0,0,0,0,0,0,0,4000,0,0,0,10000,6000,4000,4000
053818,富邦金群益98購01,0,0,0,0,0,0,0,0,0,4000,0,0,0,5000,1000,4000,4000
054908,群電康和97購01  ,0,0,0,0,0,0,0,0,0,4000,0,0,0,34000,30000,4000,4000
055322,欣興國票97購06  ,0,0,0,0,0,0,0,0,0,4000,0,0,0,5000,1000,4000,4000
057121,立積康和98購01  ,0,0,0,0,0,0,0,0,0,4000,0,0,0,32000,28000,4000,4000
057228,友達凱基9B購01  ,0,0,0,0,0,0,0,0,0,4000,0,0,0,4000,0,4000,4000
059113,群光永豐99購01  ,0,0,0,0,0,0,0,0,0,4000,0,0,0,6000,2000,4000,4000
059089,聯發科元大99購19,0,0,0,0,0,0,0,0,0,4000,0,0,0,720000,716000,4000,4000
05780P,台積電統一96售07,0,0,0,0,0,0,0,0,0,4000,0,0,0,5000,1000,4000,4000
056476,智原元大98購02  ,0,0,0,0,0,0,0,0,0,4000,0,0,0,4000,0,4000,4000
056451,可成凱基99購01  ,0,0,0,0,0,0,0,0,0,4000,0,0,0,10000,6000,4000,4000
056535,全新凱基99購02  ,0,0,0,0,0,0,0,0,0,4000,0,0,0,4000,0,4000,4000
056530,旺宏凱基98購06  ,0,0,0,0,0,0,0,0,0,4000,0,0,0,5000,1000,4000,4000
057852,國巨國票99購05  ,0,0,0,0,0,0,0,0,0,4000,0,0,0,4000,0,4000,4000
058480,新日興凱基9A購01,0,0,0,0,0,0,0,0,0,4000,0,0,0,4000,0,4000,4000
058631,鈺齊國票9A購01  ,0,0,0,0,0,0,0,0,0,4000,0,0,0,12000,8000,4000,4000
058456,京鼎永豐99購01  ,0,0,0,0,0,0,0,0,0,4000,0,0,0,17000,13000,4000,4000
055472,大立光凱基97購07,0,0,0,0,0,0,0,0,0,4000,0,0,0,4000,0,4000,4000
055804,祥碩永豐97購02  ,0,0,0,0,0,0,0,0,0,4000,0,0,0,144000,140000,4000,4000
05568P,台積電統一96售03,0,0,0,0,0,0,0,0,0,4000,0,0,0,4000,0,4000,4000
056365,欣興元大98購01  ,0,0,0,0,0,0,0,0,0,4000,0,0,0,94000,90000,4000,4000
056017,台積電群益97購04,0,0,0,0,0,0,0,0,0,4000,0,0,0,4000,0,4000,4000
055994,聯發科國泰99購02,0,0,0,0,0,0,0,0,0,4000,0,0,0,14000,10000,4000,4000
058941,華新科中信99購03,0,0,0,0,0,0,0,0,0,4000,0,0,0,4000,0,4000,4000
057931,正崴群益98購02  ,0,0,0,0,0,0,0,0,0,4000,0,0,0,82000,78000,4000,4000
05853P,欣興群益96售05  ,0,0,0,0,0,0,0,0,0,4000,0,0,0,4000,0,4000,4000
05791P,臺股指中信99售06,0,0,0,0,0,0,0,0,0,4000,0,0,0,4000,0,4000,4000
056927,T50反1台新02購01,0,0,0,0,0,0,0,0,0,4000,0,0,0,4000,0,4000,4000
4104,佳醫            ,43000,39000,4000,0,0,0,0,0,0,0,0,0,0,0,0,0,4000
9919,康那香          ,4000,0,4000,0,0,0,0,0,0,0,0,0,0,0,0,0,4000
07585P,台灣50中信03售06,0,0,0,0,0,0,0,0,0,4000,0,0,0,9000,5000,4000,4000
07743P,智邦凱基9A售03  ,0,0,0,0,0,0,0,0,0,4000,0,0,0,32000,28000,4000,4000
07687P,上銀元大9A售06  ,0,0,0,0,0,0,0,0,0,4000,0,0,0,4000,0,4000,4000
07770P,台積電國票9A售07,0,0,0,0,0,0,0,0,0,4000,0,0,0,24000,20000,4000,4000
07805P,義隆永豐9A售02  ,0,0,0,0,0,0,0,0,0,4000,0,0,0,6000,2000,4000,4000
07815P,美律群益9A售04  ,0,0,0,0,0,0,0,0,0,4000,0,0,0,4000,0,4000,4000
2882A,國泰特          ,3000,14000,-11000,0,0,0,0,0,0,15000,50000,35000,15000,0,0,0,4000
06201P,可成元大97售01  ,0,0,0,0,0,0,0,0,0,3000,0,0,0,3000,0,3000,3000
06234P,亞德客元大97售02,0,0,0,0,0,0,0,0,0,3000,0,0,0,4000,1000,3000,3000
06407P,創意元富97售02  ,0,0,0,0,0,0,0,0,0,3000,0,0,0,3000,0,3000,3000
061705,健策國票9A購06  ,0,0,0,0,0,0,0,0,0,3000,0,0,0,3000,0,3000,3000
06878P,台灣50日盛9B售01,0,0,0,0,0,0,0,0,0,3000,0,0,0,3000,0,3000,3000
061529,國巨台新9A購02  ,0,0,0,0,0,0,0,0,0,3000,0,0,0,20000,17000,3000,3000
061352,茂林元大9A購04  ,0,0,0,0,0,0,0,0,0,3000,0,0,0,3000,0,3000,3000
061377,聯發科永豐9A購04,0,0,0,0,0,0,0,0,0,3000,0,0,0,13000,10000,3000,3000
060534,友達麥證9A購01  ,0,0,0,3000,0,3000,0,0,0,3000,0,0,0,3000,0,3000,3000
060544,國巨凱基9B購03  ,0,0,0,0,0,0,0,0,0,3000,0,0,0,23000,20000,3000,3000
06054P,臺股指中信9A售01,0,0,0,0,0,0,0,0,0,3000,0,0,0,3000,0,3000,3000
060266,潤泰全國票9A購01,0,0,0,0,0,0,0,0,0,3000,0,0,0,41000,38000,3000,3000
059536,新光金凱基99購05,0,0,0,0,0,0,0,0,0,3000,0,0,0,29000,26000,3000,3000
059902,滬深2X元大9C購08,0,0,0,0,0,0,0,0,0,3000,0,0,0,3000,0,3000,3000
059905,A50正2元大9C購06,0,0,0,0,0,0,0,0,0,3000,0,0,0,3000,0,3000,3000
059756,奇力新富邦9C購01,0,0,0,0,0,0,0,0,0,3000,0,0,0,3000,0,3000,3000
055339,緯穎兆豐98購01  ,0,0,0,0,0,0,0,0,0,3000,0,0,0,3000,0,3000,3000
053022,欣興國泰98購01  ,0,0,0,0,0,0,0,0,0,3000,0,0,0,3000,0,3000,3000
053141,景碩永豐96購02  ,0,0,0,0,0,0,0,0,0,3000,0,0,0,3000,0,3000,3000
053307,泰碩凱基97購01  ,0,0,0,0,0,0,0,0,0,3000,0,0,0,3000,0,3000,3000
054064,台郡國票97購04  ,0,0,0,0,0,0,0,0,0,3000,0,0,0,40000,37000,3000,3000
05400P,台積電永豐95售05,0,0,0,0,0,0,0,0,0,3000,0,0,0,3000,0,3000,3000
054466,欣興凱基97購03  ,0,0,0,0,0,0,0,0,0,3000,0,0,0,13000,10000,3000,3000
054501,強茂永豐96購02  ,0,0,0,0,0,0,0,0,0,3000,0,0,0,3000,0,3000,3000
056822,佐登永豐98購01  ,0,0,0,0,0,0,0,0,0,3000,0,0,0,3000,0,3000,3000
047630,元油反元大96購02,0,0,0,0,0,0,0,0,0,3000,0,0,0,3000,0,3000,3000
047689,瑞昱富邦97購01  ,0,0,0,0,0,0,0,0,0,3000,0,0,0,3000,0,3000,3000
05250P,臻鼎國票96售01  ,0,0,0,0,0,0,0,0,0,3000,0,0,0,3000,0,3000,3000
052451,旭富元大95購02  ,0,0,0,0,0,0,0,0,0,3000,0,0,0,3000,0,3000,3000
00711B,FH彭博新興債    ,39000,0,39000,0,0,0,0,0,0,-36000,0,0,0,2000,38000,-36000,3000
049669,訊芯國泰95購01  ,0,0,0,0,0,0,0,0,0,3000,0,0,0,3000,0,3000,3000
045767,大立光元富95購01,0,0,0,0,0,0,0,0,0,3000,0,0,0,4000,1000,3000,3000
050694,國巨凱基96購03  ,0,0,0,0,0,0,0,0,0,3000,0,0,0,22000,19000,3000,3000
051075,智邦國泰97購01  ,0,0,0,0,0,0,0,0,0,3000,0,0,0,3000,0,3000,3000
05265P,正崴元大95售03  ,0,0,0,0,0,0,0,0,0,3000,0,0,0,3000,0,3000,3000
050481,泰鼎國票96購01  ,0,0,0,0,0,0,0,0,0,3000,0,0,0,8000,5000,3000,3000
054744,晶相光凱基99購01,0,0,0,0,0,0,0,0,0,3000,0,0,0,3000,0,3000,3000
054756,世紀鋼凱基99購01,0,0,0,0,0,0,0,0,0,3000,0,0,0,3000,0,3000,3000
057934,華新科群益98購07,0,0,0,0,0,0,0,0,0,3000,0,0,0,10000,7000,3000,3000
058923,華新科元富99購06,0,0,0,0,0,0,0,0,0,3000,0,0,0,3000,0,3000,3000
058148,百和元大99購01  ,0,0,0,0,0,0,0,0,0,3000,0,0,0,52000,49000,3000,3000
055519,茂林中信99購01  ,0,0,0,0,0,0,0,0,0,3000,0,0,0,23000,20000,3000,3000
056193,聯發科富邦99購08,0,0,0,0,0,0,0,0,0,3000,0,0,0,3000,0,3000,3000
055717,聯發科元大97購19,0,0,0,0,0,0,0,0,0,3000,0,0,0,3000,0,3000,3000
057322,旺宏群益98購04  ,0,0,0,0,0,0,0,0,0,3000,0,0,0,3000,0,3000,3000
056747,致新凱基99購01  ,0,0,0,0,0,0,0,0,0,3000,0,0,0,3000,0,3000,3000
05708P,奇力新國票97售04,0,0,0,0,0,0,0,0,0,3000,0,0,0,3000,0,3000,3000
059093,旭富元大99購01  ,0,0,0,0,0,0,0,0,0,3000,0,0,0,3000,0,3000,3000
057128,台光電凱基98購03,0,0,0,0,0,0,0,0,0,3000,0,0,0,43000,40000,3000,3000
059145,創意國票99購02  ,0,0,0,0,0,0,0,0,0,3000,0,0,0,7000,4000,3000,3000
059161,鴻海凱基9A購09  ,0,0,0,0,0,0,0,0,0,3000,0,0,0,3000,0,3000,3000
059246,奇力新凱基9A購02,0,0,0,0,0,0,0,0,0,3000,0,0,0,6000,3000,3000,3000
07771P,義隆國票9A售01  ,0,0,0,0,0,0,0,0,0,3000,0,0,0,3000,0,3000,3000
07688P,華通元大9A售07  ,0,0,0,0,0,0,0,0,0,3000,0,0,0,3000,0,3000,3000
07654P,台灣50凱基01售08,0,0,0,0,0,0,0,0,0,3000,0,0,0,3000,0,3000,3000
07349P,大立光凱基99售16,0,0,0,0,0,0,0,0,0,3000,0,0,0,3000,0,3000,3000
07378P,大立光元大99售29,0,0,0,0,0,0,0,0,0,3000,0,0,0,3000,0,3000,3000
07256P,臺股指凱基99售36,0,0,0,0,0,0,0,0,0,3000,0,0,0,51000,48000,3000,3000
07243P,台灣50凱基9A售04,0,0,0,0,0,0,0,0,0,3000,0,0,0,5000,2000,3000,3000
07031P,台灣50中信03售02,0,0,0,0,0,0,0,0,0,3000,0,0,0,3000,0,3000,3000
9941A,裕融甲特        ,0,0,0,0,0,0,0,0,0,3000,3000,0,3000,0,0,0,3000
05990P,台積電群益96售13,0,0,0,0,0,0,0,0,0,2000,0,0,0,47000,45000,2000,2000
059891,臺股指國票99購25,0,0,0,0,0,0,0,0,0,2000,0,0,0,2000,0,2000,2000
05954P,旺宏國票97售03  ,0,0,0,0,0,0,0,0,0,2000,0,0,0,2000,0,2000,2000
059544,創意亞東99購01  ,0,0,0,0,0,0,0,0,0,2000,0,0,0,2000,0,2000,2000
059532,華新科凱基9B購03,0,0,0,0,0,0,0,0,0,2000,0,0,0,4000,2000,2000,2000
060018,國產康和99購01  ,0,0,0,0,0,0,0,0,0,2000,0,0,0,2000,0,2000,2000
05996P,華新科群益96售03,0,0,0,0,0,0,0,0,0,2000,0,0,0,2000,0,2000,2000
05995P,T50正2中信9C售01,0,0,0,0,0,0,0,0,0,2000,0,0,0,2000,0,2000,2000
06008P,燿華統一96售04  ,0,0,0,0,0,0,0,0,0,2000,0,0,0,2000,0,2000,2000
060264,華新科國票9A購02,0,0,0,0,0,0,0,0,0,2000,0,0,0,4000,2000,2000,2000
060356,上銀元富9A購01  ,0,0,0,0,0,0,0,0,0,2000,0,0,0,2000,0,2000,2000
060405,中租國泰9C購01  ,0,0,0,0,0,0,0,0,0,2000,0,0,0,8000,6000,2000,2000
060458,華通元大9A購02  ,0,0,0,0,0,0,0,0,0,2000,0,0,0,122000,120000,2000,2000
060812,智邦凱基9A購01  ,0,0,0,0,0,0,0,0,0,2000,0,0,0,19000,17000,2000,2000
060839,聯發科國票9A購02,0,0,0,0,0,0,0,0,0,2000,0,0,0,5000,3000,2000,2000
060659,鴻海凱基9B購03  ,0,0,0,0,0,0,0,0,0,2000,0,0,0,2000,0,2000,2000
060760,南亞科元大9A購04,0,0,0,0,0,0,0,0,0,2000,0,0,0,5000,3000,2000,2000
061331,T50反1元大9A購15,0,0,0,0,0,0,0,0,0,2000,0,0,0,2000,0,2000,2000
061321,華新科凱基9A購09,0,0,0,0,0,0,0,0,0,2000,0,0,0,2000,0,2000,2000
061505,力成國票9A購03  ,0,0,0,0,0,0,0,0,0,2000,0,0,0,12000,10000,2000,2000
061107,世芯元大9A購05  ,0,0,0,0,0,0,0,0,0,2000,0,0,0,45000,43000,2000,2000
061090,奇力新統一9C購01,0,0,0,0,0,0,0,0,0,2000,0,0,0,2000,0,2000,2000
061142,南電統一9A購01  ,0,25000,-25000,0,0,0,0,0,0,27000,0,0,0,35000,8000,27000,2000
061179,華擎凱基9A購01  ,0,0,0,0,0,0,0,0,0,2000,0,0,0,30000,28000,2000,2000
060975,滬深2X元大01購02,0,0,0,0,0,0,0,0,0,2000,0,0,0,4000,2000,2000,2000
06782P,大立光元大99售07,0,0,0,0,0,0,0,0,0,2000,0,0,0,2000,0,2000,2000
06985P,華新科富邦9C售02,0,0,0,0,0,0,0,0,0,2000,0,0,0,2000,0,2000,2000
06521P,矽力元大98售01  ,0,0,0,0,0,0,0,0,0,2000,0,0,0,2000,0,2000,2000
06525P,上証2X國泰99售01,0,0,0,0,0,0,0,0,0,2000,0,0,0,3000,1000,2000,2000
06534P,聯發科群益98售04,0,0,0,0,0,0,0,0,0,2000,0,0,0,2000,0,2000,2000
06485P,玉晶光群益9A售02,0,0,0,0,0,0,0,0,0,2000,0,0,0,2000,0,2000,2000
06740P,台灣50國泰9A售02,0,0,0,0,0,0,0,0,0,2000,0,0,0,2000,0,2000,2000
06723P,台灣50麥證99售01,0,0,0,2000,20000,-18000,0,0,0,2000,0,0,0,22000,20000,2000,2000
06726P,欣興元富98售04  ,0,0,0,0,0,0,0,0,0,2000,0,0,0,3000,1000,2000,2000
06439P,上銀凱基98售02  ,0,0,0,0,0,0,0,0,0,2000,0,0,0,2000,0,2000,2000
06461P,玉晶光國泰9A售01,0,0,0,0,0,0,0,0,0,2000,0,0,0,2000,0,2000,2000
06380P,臺股指統一98售02,0,0,0,0,0,0,0,0,0,2000,0,0,0,2000,0,2000,2000
06203P,奇力新中信98售02,0,0,0,0,0,0,0,0,0,2000,0,0,0,2000,0,2000,2000
06211P,鴻海元大98售04  ,0,0,0,0,0,0,0,0,0,2000,0,0,0,2000,0,2000,2000
054784,順德群益9A購01  ,0,0,0,0,0,0,0,0,0,2000,0,0,0,2000,0,2000,2000
05377P,鴻海凱基95售18  ,0,0,0,0,0,0,0,0,0,2000,0,0,0,2000,0,2000,2000
052782,超眾國票96購02  ,0,0,0,0,0,0,0,0,0,2000,0,0,0,2000,0,2000,2000
05101P,大立光凱基95售11,0,0,0,0,0,0,0,0,0,2000,0,0,0,2000,0,2000,2000
050705,南電凱基96購01  ,0,0,0,0,0,0,0,0,0,2000,0,0,0,2000,0,2000,2000
051534,景碩國票97購01  ,0,0,0,0,0,0,0,0,0,2000,0,0,0,2000,0,2000,2000
045872,元油2X元富98購03,2000,0,2000,0,0,0,0,0,0,0,0,0,0,0,0,0,2000
03416B,臺股指凱基95熊05,0,0,0,0,0,0,0,0,0,2000,0,0,0,2000,0,2000,2000
03422B,臺股指凱基96熊28,0,0,0,0,0,0,0,0,0,2000,0,0,0,2000,0,2000,2000
049527,國巨中信95購01  ,0,0,0,0,0,0,0,0,0,2000,0,0,0,2000,0,2000,2000
049369,義隆元大95購01  ,0,0,0,0,0,0,0,0,0,2000,0,0,0,2000,0,2000,2000
04874P,高股息中信97售01,0,0,0,0,0,0,0,0,0,2000,0,0,0,2000,0,2000,2000
04906P,欣興國票95售01  ,0,0,0,0,0,0,0,0,0,2000,0,0,0,5000,3000,2000,2000
049130,臺指反元大98購01,0,0,0,0,0,0,0,0,0,2000,0,0,0,2000,0,2000,2000
04898P,瑞儀中信95售01  ,0,0,0,0,0,0,0,0,0,2000,0,0,0,2000,0,2000,2000
00651R,FH香港反1       ,0,0,0,0,0,0,0,0,0,2000,0,0,0,494000,492000,2000,2000
006204,永豐臺灣加權    ,0,0,0,0,0,0,0,0,0,2000,0,0,0,7000,5000,2000,2000
052068,瑞儀兆豐96購01  ,0,0,0,0,0,0,0,0,0,2000,0,0,0,2000,0,2000,2000
03430B,臺股指元大9B熊01,0,0,0,0,0,0,0,0,0,2000,0,0,0,2000,0,2000,2000
04703P,樺漢統一95售01  ,0,0,0,0,0,0,0,0,0,2000,0,0,0,2000,0,2000,2000
05829P,臺股指統一96售08,0,0,0,0,0,0,0,0,0,2000,0,0,0,22000,20000,2000,2000
058315,TPK富邦9C購01   ,0,0,0,0,0,0,0,0,0,2000,0,0,0,15000,13000,2000,2000
05451P,臺股指元大95售28,0,0,0,0,0,0,0,0,0,2000,0,0,0,2000,0,2000,2000
054210,台光電國票97購03,0,0,0,0,0,0,0,0,0,2000,0,0,0,5000,3000,2000,2000
053316,友達群益9A購01  ,0,0,0,0,0,0,0,0,0,2000,0,0,0,2000,0,2000,2000
053167,欣興群益96購03  ,0,0,0,0,0,0,0,0,0,2000,0,0,0,2000,0,2000,2000
053164,台光電群益96購02,0,0,0,0,0,0,0,0,0,2000,0,0,0,2000,0,2000,2000
053041,可成凱基96購02  ,0,0,0,0,0,0,0,0,0,2000,0,0,0,2000,0,2000,2000
054952,大毅元大97購02  ,0,0,0,0,0,0,0,0,0,2000,0,0,0,2000,0,2000,2000
055029,帆宣國泰99購01  ,0,0,0,0,0,0,0,0,0,2000,0,0,0,25000,23000,2000,2000
05533P,滬深2X富邦97售01,0,0,0,0,0,0,0,0,0,2000,0,0,0,2000,0,2000,2000
053865,欣興元大97購02  ,0,0,0,0,0,0,0,0,0,2000,0,0,0,2000,0,2000,2000
053922,亞光國票96購01  ,0,0,0,0,0,0,0,0,0,2000,0,0,0,2000,0,2000,2000
053875,GIS元大97購01   ,0,0,0,0,0,0,0,0,0,2000,0,0,0,42000,40000,2000,2000
05545P,台表科國泰98售01,0,0,0,0,0,0,0,0,0,2000,0,0,0,22000,20000,2000,2000
059266,緯創中信01購01  ,0,0,0,0,0,0,0,0,0,2000,0,0,0,30000,28000,2000,2000
059299,欣興元富99購03  ,0,0,0,0,0,0,0,0,0,2000,0,0,0,2000,0,2000,2000
059409,台灣50國票9C購01,0,0,0,0,0,0,0,0,0,2000,0,0,0,2000,0,2000,2000
059379,聯電亞東99購02  ,0,0,0,0,0,0,0,0,0,2000,0,0,0,2000,0,2000,2000
059096,百和元大99購04  ,0,0,0,0,0,0,0,0,0,2000,0,0,0,42000,40000,2000,2000
057815,信邦元大98購01  ,0,0,0,0,0,0,0,0,0,2000,0,0,0,2000,0,2000,2000
05646P,聯發科國票96售05,0,0,0,0,0,0,0,0,0,2000,0,0,0,26000,24000,2000,2000
056724,臻鼎中信9A購01  ,0,0,0,0,0,0,0,0,0,2000,0,0,0,22000,20000,2000,2000
05669P,嘉晶永豐96售03  ,0,0,0,0,0,0,0,0,0,2000,0,0,0,2000,0,2000,2000
057499,奇鋐群益98購01  ,0,0,0,0,0,0,0,0,0,2000,0,0,0,85000,83000,2000,2000
055805,矽力永豐97購01  ,0,0,0,0,0,0,0,0,0,2000,0,0,0,10000,8000,2000,2000
058461,滬深2X永昌9C購01,0,0,0,0,0,0,0,0,0,2000,0,0,0,2000,0,2000,2000
058412,聯發科兆豐99購01,0,0,0,0,0,0,0,0,0,2000,0,0,0,2000,0,2000,2000
058426,旺宏元富99購02  ,0,0,0,0,0,0,0,0,0,2000,0,0,0,2000,0,2000,2000
05886P,華通元富96售01  ,0,0,0,0,0,0,0,0,0,2000,0,0,0,2000,0,2000,2000
058579,聯發科群益99購04,0,0,0,0,0,0,0,0,0,2000,0,0,0,2000,0,2000,2000
055501,創意元大97購01  ,0,0,0,0,0,0,0,0,0,2000,0,0,0,2000,0,2000,2000
055796,南電國泰98購01  ,0,0,0,0,0,0,0,0,0,2000,0,0,0,2000,0,2000,2000
055609,旺宏國票99購01  ,0,0,0,0,0,0,0,0,0,2000,0,0,0,2000,0,2000,2000
057695,S&P反1群益9B購01,0,0,0,0,0,0,0,0,0,2000,0,0,0,2000,0,2000,2000
056130,新日興麥證97購01,0,0,0,12000,10000,2000,0,0,0,2000,0,0,0,12000,10000,2000,2000
058917,SGBR2X元富99購03,0,0,0,0,0,0,0,0,0,2000,0,0,0,2000,0,2000,2000
056912,臺股指元大99購04,0,0,0,0,0,0,0,0,0,2000,0,0,0,2000,0,2000,2000
3593,力銘            ,3000,1000,2000,0,0,0,0,0,0,0,0,0,0,0,0,0,2000
07050P,宏達電中信9B售01,0,0,0,0,0,0,0,0,0,2000,0,0,0,2000,0,2000,2000
07024P,臺股指永豐99售02,0,0,0,0,0,0,0,0,0,2000,0,0,0,2000,0,2000,2000
07069P,欣興元富99售02  ,0,0,0,0,0,0,0,0,0,2000,0,0,0,12000,10000,2000,2000
07220P,台灣50中信03售05,0,0,0,0,0,0,0,0,0,2000,0,0,0,2000,0,2000,2000
07166P,台灣50兆豐03售01,0,0,0,0,0,0,0,0,0,2000,0,0,0,24000,22000,2000,2000
07274P,上証2X群益01售01,0,0,0,0,0,0,0,0,0,2000,0,0,0,2000,0,2000,2000
07313P,台灣50元大99售11,0,0,0,0,0,0,0,0,0,2000,0,0,0,2000,0,2000,2000
07423P,大立光元大99售33,0,0,0,0,0,0,0,0,0,2000,0,0,0,10000,8000,2000,2000
07566P,台積電台新9B售02,0,0,0,0,0,0,0,0,0,2000,0,0,0,24000,22000,2000,2000
07474P,滬深2X群益9C售03,0,0,0,0,0,0,0,0,0,2000,0,0,0,3000,1000,2000,2000
2891C,中信金丙特      ,0,0,0,0,0,0,0,0,0,2000,2000,0,2000,0,0,0,2000
3043,科風            ,2000,0,2000,0,0,0,0,0,0,0,0,0,0,0,0,0,2000
08679P,台灣50元大01售15,0,0,0,0,0,0,0,0,0,2000,0,0,0,2000,0,2000,2000
08218P,滬深2X凱基96售01,0,0,0,0,0,0,0,0,0,2000,0,0,0,2000,0,2000,2000
06198P,台積電元大98售06,0,0,0,0,0,0,0,0,0,1000,0,0,0,1000,0,1000,1000
06228P,亞德客凱基97售04,0,0,0,0,0,0,0,0,0,1000,0,0,0,1000,0,1000,1000
06353P,電子類富邦99售02,0,0,0,0,0,0,0,0,0,1000,0,0,0,1000,0,1000,1000
06338P,亞德客統一97售02,0,0,0,0,0,0,0,0,0,1000,0,0,0,2000,1000,1000,1000
06284P,台積電國票98售03,0,0,0,0,0,0,0,0,0,1000,0,0,0,1000,0,1000,1000
06459P,亞德客元富98售01,0,0,0,0,0,0,0,0,0,1000,0,0,0,1000,0,1000,1000
06441P,台積電凱基98售08,0,0,0,0,0,0,0,0,0,1000,0,0,0,1000,0,1000,1000
061598,南電永豐9A購04  ,0,0,0,0,0,0,0,0,0,1000,0,0,0,1000,0,1000,1000
06690P,玉晶光群益9A售05,0,0,0,0,0,0,0,0,0,1000,0,0,0,1000,0,1000,1000
06706P,智原台新98售02  ,0,0,0,0,0,0,0,0,0,1000,0,0,0,1000,0,1000,1000
06711P,臺股指台新99售08,0,0,0,0,0,0,0,0,0,1000,0,0,0,1000,0,1000,1000
06482P,台積電凱基98售13,0,0,0,0,0,0,0,0,0,1000,0,0,0,1000,0,1000,1000
06514P,國巨凱基98售05  ,0,0,0,0,0,0,0,0,0,1000,0,0,0,1000,0,1000,1000
06615P,鴻海元大9C售02  ,0,0,0,0,0,0,0,0,0,1000,0,0,0,1000,0,1000,1000
06549P,大立光元大98售11,0,0,0,0,0,0,0,0,0,1000,0,0,0,1000,0,1000,1000
06974P,臺股指元大9A售12,0,0,0,0,0,0,0,0,0,1000,0,0,0,1000,0,1000,1000
06951P,台積電統一9B售02,0,0,0,0,0,0,0,0,0,1000,0,0,0,1000,0,1000,1000
06753P,智邦富邦98售03  ,0,0,0,0,0,0,0,0,0,1000,0,0,0,1000,0,1000,1000
06855P,聯發科富邦9A售01,0,0,0,0,0,0,0,0,0,1000,0,0,0,1000,0,1000,1000
06856P,台灣50永豐99售03,0,0,0,0,0,0,0,0,0,1000,0,0,0,1000,0,1000,1000
06838P,台積電統一99售05,0,0,0,0,0,0,0,0,0,1000,0,0,0,21000,20000,1000,1000
061063,國巨凱基9A購14  ,0,0,0,0,0,0,0,0,0,1000,0,0,0,4000,3000,1000,1000
06120P,大立光凱基98售05,0,0,0,0,0,0,0,0,0,1000,0,0,0,2000,1000,1000,1000
061127,美食永豐9A購01  ,0,0,0,0,0,0,0,0,0,1000,0,0,0,196000,195000,1000,1000
061435,元金2X凱基9C購03,0,0,0,0,0,0,0,0,0,1000,0,0,0,1000,0,1000,1000
061322,華新科凱基9A購12,0,0,0,0,0,0,0,0,0,1000,0,0,0,1000,0,1000,1000
061250,臺股指群益9A購01,0,0,0,0,0,0,0,0,0,1000,0,0,0,1000,0,1000,1000
060900,超眾凱基9B購01  ,0,0,0,0,0,0,0,0,0,1000,0,0,0,51000,50000,1000,1000
060497,臺指反元大01購02,0,0,0,0,0,0,0,0,0,1000,0,0,0,1000,0,1000,1000
060481,巨大元大9A購01  ,0,0,0,0,0,0,0,0,0,1000,0,0,0,93000,92000,1000,1000
060174,T50反1元富04購01,0,0,0,0,0,0,0,0,0,1000,0,0,0,1000,0,1000,1000
060061,旺宏兆豐99購02  ,0,0,0,0,0,0,0,0,0,1000,0,0,0,1000,0,1000,1000
059587,華通元大9A購01  ,0,0,0,0,0,0,0,0,0,1000,0,0,0,1000,0,1000,1000
059569,旺宏凱基99購09  ,0,0,0,0,0,0,0,0,0,1000,0,0,0,1000,0,1000,1000
059733,緯穎元大99購08  ,0,0,0,0,0,0,0,0,0,1000,0,0,0,21000,20000,1000,1000
059722,南亞科元大99購02,0,0,0,0,0,0,0,0,0,1000,0,0,0,1000,0,1000,1000
059620,聯發科日盛99購02,0,0,0,0,0,0,0,0,0,1000,0,0,0,1000,0,1000,1000
059679,國巨國泰9B購03  ,0,0,0,0,0,0,0,0,0,1000,0,0,0,1000,0,1000,1000
059818,鴻海凱基99購14  ,0,0,0,0,0,0,0,0,0,1000,0,0,0,1000,0,1000,1000
053809,上銀群益96購02  ,0,0,0,0,0,0,0,0,0,1000,0,0,0,1000,0,1000,1000
05382P,電子類群益95售02,0,0,0,0,0,0,0,0,0,1000,0,0,0,1000,0,1000,1000
053932,華新科統一96購03,0,0,0,0,0,0,0,0,0,1000,0,0,0,1000,0,1000,1000
053066,欣興群益96購02  ,0,0,0,0,0,0,0,0,0,1000,0,0,0,2000,1000,1000,1000
05337P,臺股指國票95售06,0,0,0,0,0,0,0,0,0,1000,0,0,0,1000,0,1000,1000
054041,鴻海元大96購22  ,0,0,0,0,0,0,0,0,0,1000,0,0,0,1000,0,1000,1000
055089,金寶群益98購01  ,0,0,0,0,0,0,0,0,0,1000,0,0,0,1000,0,1000,1000
05515P,台積電群益96售03,0,0,0,0,0,0,0,0,0,1000,0,0,0,1000,0,1000,1000
05411P,台積電國票96售08,0,0,0,0,0,0,0,0,0,1000,0,0,0,1000,0,1000,1000
054281,世芯群益97購01  ,0,0,0,0,0,0,0,0,0,1000,0,0,0,1000,0,1000,1000
054515,華通元大98購02  ,0,0,0,0,0,0,0,0,0,1000,0,0,0,1000,0,1000,1000
055231,大毅國票98購02  ,0,0,0,0,0,0,0,0,0,1000,0,0,0,1000,0,1000,1000
05681P,大立光元大96售05,0,0,0,0,0,0,0,0,0,1000,0,0,0,11000,10000,1000,1000
055831,台達電元大97購01,0,0,0,0,0,0,0,0,0,1000,0,0,0,11000,10000,1000,1000
046944,奇力新元大96購01,0,0,0,0,0,0,0,0,0,1000,0,0,0,1000,0,1000,1000
03497P,金像電凱基02售06,0,0,0,0,0,0,0,0,0,1000,0,0,0,1000,0,1000,1000
03995P,滬深2X國泰95售01,0,0,0,0,0,0,0,0,0,1000,0,0,0,1000,0,1000,1000
048190,道瓊反元大96購02,0,0,0,0,0,0,0,0,0,1000,0,0,0,1000,0,1000,1000
04771P,友達元大96售02  ,0,0,0,0,0,0,0,0,0,1000,0,0,0,1000,0,1000,1000
04731P,臺股指中信96售03,0,0,0,0,0,0,0,0,0,1000,0,0,0,67000,66000,1000,1000
052490,禾伸堂國票95購01,0,0,0,0,0,0,0,0,0,1000,0,0,0,1000,0,1000,1000
052272,T50反1群益95購03,0,0,0,0,0,0,0,0,0,1000,0,0,0,1000,0,1000,1000
052194,旺宏元富95購04  ,0,0,0,0,0,0,0,0,0,1000,0,0,0,1000,0,1000,1000
052201,超眾統一96購01  ,0,0,0,0,0,0,0,0,0,1000,0,0,0,1000,0,1000,1000
052371,元金2X元大95購01,0,0,0,0,0,0,0,0,0,1000,0,0,0,1000,0,1000,1000
052297,旭富國票96購01  ,0,0,0,0,0,0,0,0,0,1000,0,0,0,1000,0,1000,1000
020006,永昌中小300N    ,0,0,0,0,0,0,0,0,0,1000,0,0,0,1000,0,1000,1000
049024,玉晶光群益97購01,0,0,0,0,0,0,0,0,0,1000,0,0,0,125000,124000,1000,1000
04869P,鴻海元富95售02  ,0,0,0,0,0,0,0,0,0,1000,0,0,0,106000,105000,1000,1000
04896P,上証2X中信95售01,0,0,0,0,0,0,0,0,0,1000,0,0,0,1000,0,1000,1000
049554,禾伸堂富邦96購01,0,0,0,0,0,0,0,0,0,1000,0,0,0,1000,0,1000,1000
03009X,元展09          ,0,0,0,0,0,0,0,0,0,1000,0,0,0,1000,0,1000,1000
03010X,元展10          ,0,0,0,0,0,0,0,0,0,1000,0,0,0,1000,0,1000,1000
04293P,滬深2X元大96售02,0,0,0,0,0,0,0,0,0,1000,0,0,0,1000,0,1000,1000
04294P,台積電元大95售01,0,0,0,0,0,0,0,0,0,1000,0,0,0,1000,0,1000,1000
04373P,滬深2X元大97售01,0,0,0,0,0,0,0,0,0,1000,0,0,0,1000,0,1000,1000
04433P,上証2X國票95售01,0,0,0,0,0,0,0,0,0,1000,0,0,0,1000,0,1000,1000
05173P,臺股指元大95售17,0,0,0,0,0,0,0,0,0,1000,0,0,0,1000,0,1000,1000
05148P,臻鼎元大95售01  ,0,0,0,0,0,0,0,0,0,1000,0,0,0,1000,0,1000,1000
050783,旺宏國泰96購02  ,0,0,0,0,0,0,0,0,0,1000,0,0,0,1000,0,1000,1000
051950,旺宏元富95購02  ,0,0,0,0,0,0,0,0,0,1000,0,0,0,1000,0,1000,1000
050315,和碩兆豐95購01  ,0,0,0,0,0,0,0,0,0,1000,0,0,0,11000,10000,1000,1000
053597,牧德元大99購01  ,0,0,0,0,0,0,0,0,0,1000,0,0,0,1000,0,1000,1000
053605,臺股指永昌96購01,0,0,0,0,0,0,0,0,0,1000,0,0,0,1000,0,1000,1000
054840,T50反1兆豐98購01,0,0,0,0,0,0,0,0,0,1000,0,0,0,1000,0,1000,1000
054861,智邦群益97購01  ,0,0,0,0,0,0,0,0,0,1000,0,0,0,2000,1000,1000,1000
056915,上銀兆豐99購01  ,0,0,0,0,0,0,0,0,0,1000,0,0,0,1000,0,1000,1000
057625,泰鼎國泰9A購01  ,0,0,0,0,0,0,0,0,0,1000,0,0,0,1000,0,1000,1000
057681,T50反1日盛9C購01,0,0,0,0,0,0,0,0,0,1000,0,0,0,1000,0,1000,1000
057876,隆達元大98購01  ,0,0,0,0,0,0,0,0,0,1000,0,0,0,2000,1000,1000,1000
058953,S&P反1國票03購01,0,0,0,0,0,0,0,0,0,1000,0,0,0,1000,0,1000,1000
05880P,創意康和96售01  ,0,0,0,0,0,0,0,0,0,1000,0,0,0,1000,0,1000,1000
058371,智原凱基9A購01  ,0,0,0,0,0,0,0,0,0,1000,0,0,0,1000,0,1000,1000
05605P,嘉聯益元大97售02,0,0,0,0,0,0,0,0,0,1000,0,0,0,1000,0,1000,1000
05812P,臺股指國票96售05,0,0,0,0,0,0,0,0,0,1000,0,0,0,1000,0,1000,1000
058130,瑞昱元大99購01  ,0,0,0,0,0,0,0,0,0,1000,0,0,0,1000,0,1000,1000
056230,可成凱基98購03  ,0,0,0,0,0,0,0,0,0,1000,0,0,0,1000,0,1000,1000
05840P,臺股指富邦96售07,0,0,0,0,0,0,0,0,0,1000,0,0,0,1000,0,1000,1000
058441,T50反1台新03購01,0,0,0,0,0,0,0,0,0,1000,0,0,0,1000,0,1000,1000
05748P,臺股指群益99售02,0,0,0,0,0,0,0,0,0,1000,0,0,0,1000,0,1000,1000
05756P,臺股指中信99售05,0,0,0,0,0,0,0,0,0,1000,0,0,0,1000,0,1000,1000
057550,聯發科凱基02購01,0,0,0,0,0,0,0,0,0,1000,0,0,0,1000,0,1000,1000
05753P,臺股指中信99售02,0,0,0,0,0,0,0,0,0,1000,0,0,0,1000,0,1000,1000
059003,中壽元大99購01  ,0,0,0,0,0,0,0,0,0,1000,0,0,0,14000,13000,1000,1000
057365,智邦元大98購07  ,0,0,0,0,0,0,0,0,0,1000,0,0,0,1000,0,1000,1000
057366,智邦元大98購08  ,0,0,0,0,0,0,0,0,0,1000,0,0,0,1000,0,1000,1000
058993,滬深反元大9C購01,0,0,0,0,0,0,0,0,0,1000,0,0,0,1000,0,1000,1000
058744,FBVIX凱基9C購03 ,0,0,0,0,0,0,0,0,0,1000,0,0,0,1000,0,1000,1000
058795,可成元大99購03  ,0,0,0,0,0,0,0,0,0,1000,0,0,0,1000,0,1000,1000
058972,新日興永豐9A購01,0,0,0,0,0,0,0,0,0,1000,0,0,0,1000,0,1000,1000
056584,鴻海統一9B購01  ,0,0,0,0,0,0,0,0,0,1000,0,0,0,11000,10000,1000,1000
059077,FBVIX元大99購05 ,0,0,0,0,0,0,0,0,0,1000,0,0,0,3000,2000,1000,1000
059007,南電元大99購05  ,0,0,0,0,0,0,0,0,0,1000,0,0,0,1000,0,1000,1000
05902P,華通國票96售02  ,0,0,0,0,0,0,0,0,0,1000,0,0,0,1000,0,1000,1000
059021,台積電統一9B購07,0,0,0,0,0,0,0,0,0,1000,0,0,0,1000,0,1000,1000
059389,國巨凱基99購14  ,0,0,0,0,0,0,0,0,0,1000,0,0,0,1000,0,1000,1000
05936P,台積電凱基96售20,0,0,0,0,0,0,0,0,0,1000,0,0,0,1000,0,1000,1000
059457,立積永豐99購02  ,0,0,0,0,0,0,0,0,0,1000,0,0,0,1000,0,1000,1000
05945P,聯詠中信96售01  ,0,0,0,0,0,0,0,0,0,1000,0,0,0,1000,0,1000,1000
059310,元石油元大99購03,0,0,0,0,0,0,0,0,0,1000,0,0,0,1000,0,1000,1000
059241,旺宏凱基99購07  ,0,0,0,0,0,0,0,0,0,1000,0,0,0,1000,0,1000,1000
059144,嘉晶國票9A購02  ,0,0,0,0,0,0,0,0,0,1000,0,0,0,11000,10000,1000,1000
1101B,台泥乙特        ,0,0,0,0,0,0,0,0,0,1000,1000,0,1000,0,0,0,1000
1410,南染            ,2000,1000,1000,0,0,0,0,0,0,0,0,0,0,0,0,0,1000
1539,巨庭            ,3000,2000,1000,0,0,0,0,0,0,0,0,0,0,0,0,0,1000
1541,錩泰            ,5000,5000,0,0,0,0,0,0,0,1000,1000,0,1000,0,0,0,1000
1725,元禎            ,1000,0,1000,0,0,0,0,0,0,0,0,0,0,0,0,0,1000
3040,遠見            ,23000,22000,1000,0,0,0,0,0,0,0,0,0,0,0,0,0,1000
2936,客思達-KY       ,15000,14000,1000,0,0,0,0,0,0,0,0,0,0,0,0,0,1000
2891B,中信金乙特      ,0,0,0,0,0,0,0,0,0,1000,1000,0,1000,0,0,0,1000
2849,安泰銀          ,22000,21000,1000,0,0,0,0,0,0,0,0,0,0,0,0,0,1000
2460,建通            ,7000,4000,3000,0,0,0,0,0,0,-2000,0,2000,-2000,0,0,0,1000
07519P,臺股指元大9B售10,0,0,0,0,0,0,0,0,0,1000,0,0,0,1000,0,1000,1000
07559P,祥碩元大9A售03  ,0,0,0,0,0,0,0,0,0,1000,0,0,0,6000,5000,1000,1000
07533P,臺股指中信9C售04,0,0,0,0,0,0,0,0,0,1000,0,0,0,1000,0,1000,1000
07540P,鴻海凱基9A售21  ,0,0,0,0,0,0,0,0,0,1000,0,0,0,1000,0,1000,1000
07625P,台灣50凱基01售06,0,0,0,0,0,0,0,0,0,1000,0,0,0,1000,0,1000,1000
07642P,華通凱基9A售05  ,0,0,0,0,0,0,0,0,0,1000,0,0,0,1000,0,1000,1000
07570P,旺宏凱基9A售04  ,0,0,0,0,0,0,0,0,0,1000,0,0,0,1000,0,1000,1000
07614P,華新科群益9A售04,0,0,0,0,0,0,0,0,0,1000,0,0,0,4000,3000,1000,1000
07810P,台積電統一9A售08,0,0,0,0,0,0,0,0,0,1000,0,0,0,1000,0,1000,1000
07848P,旺宏群益9B售01  ,0,0,0,0,0,0,0,0,0,1000,0,0,0,1000,0,1000,1000
07441P,臺股指麥證9B售03,0,0,0,1000,0,1000,0,0,0,1000,0,0,0,1000,0,1000,1000
07414P,台積電元大99售51,0,0,0,0,0,0,0,0,0,1000,0,0,0,21000,20000,1000,1000
07382P,台積電群益9B售01,0,0,0,0,0,0,0,0,0,1000,0,0,0,1000,0,1000,1000
07142P,台灣50元大01售01,0,0,0,0,0,0,0,0,0,1000,0,0,0,1000,0,1000,1000
07129P,華新科元大99售14,0,0,0,0,0,0,0,0,0,1000,0,0,0,222000,221000,1000,1000
07222P,台灣50元大01售04,0,0,0,0,0,0,0,0,0,1000,0,0,0,1000,0,1000,1000
07214P,聯發科凱基9A售04,0,0,0,0,0,0,0,0,0,1000,0,0,0,1000,0,1000,1000
07205P,鴻海凱基99售11  ,0,0,0,0,0,0,0,0,0,1000,0,0,0,1000,0,1000,1000
07114P,旺宏兆豐9A售01  ,0,0,0,0,0,0,0,0,0,1000,0,0,0,1000,0,1000,1000
3543,州巧            ,1000,0,1000,0,0,0,0,0,0,0,0,0,0,0,0,0,1000
4562,穎漢            ,6000,5000,1000,0,0,0,0,0,0,0,0,0,0,0,0,0,1000
4581,光隆精密-KY     ,1000,0,1000,0,0,0,0,0,0,0,0,0,0,0,0,0,1000
6671,三能-KY         ,1000,0,1000,0,0,0,0,0,0,0,0,0,0,0,0,0,1000
9103,美德醫療-DR     ,0,0,0,0,0,0,0,0,0,1000,1000,0,1000,0,0,0,1000
059846,力山永豐99購01  ,0,0,0,0,0,0,0,0,0,0,0,0,0,1000,1000,0,0
059666,台表科元大9B購01,0,0,0,0,0,0,0,0,0,0,0,0,0,3000,3000,0,0
059712,滬深2X元大9C購03,0,0,0,0,0,0,0,0,0,0,0,0,0,2000,2000,0,0
059716,鴻海元大99購35  ,0,0,0,0,0,0,0,0,0,0,0,0,0,2000,2000,0,0
059717,國巨元大99購21  ,0,0,0,0,0,0,0,0,0,0,0,0,0,30000,30000,0,0
05953P,台積電國票98售02,0,0,0,0,0,0,0,0,0,0,0,0,0,20000,20000,0,0
05951P,台積電國票97售05,0,0,0,0,0,0,0,0,0,0,0,0,0,20000,20000,0,0
060037,鴻海國票99購10  ,0,0,0,0,0,0,0,0,0,0,0,0,0,2000,2000,0,0
060009,南亞科群益99購03,0,0,0,0,0,0,0,0,0,0,0,0,0,3000,3000,0,0
060039,大立光國票99購04,0,0,0,0,0,0,0,0,0,0,0,0,0,1000,1000,0,0
059935,國巨永豐99購07  ,0,0,0,0,0,0,0,0,0,0,0,0,0,10000,10000,0,0
05992P,華通元大96售05  ,0,0,0,0,0,0,0,0,0,0,0,0,0,10000,10000,0,0
059950,百和永豐99購02  ,0,0,0,0,0,0,0,0,0,0,0,0,0,41000,41000,0,0
06043P,創意永豐96售06  ,0,0,0,0,0,0,0,0,0,0,0,0,0,46000,46000,0,0
060845,欣興國票9A購01  ,0,0,0,0,0,0,0,0,0,0,0,0,0,2000,2000,0,0
060860,國巨永豐9A購02  ,0,0,0,0,0,0,0,0,0,0,0,0,0,200000,200000,0,0
060805,國巨群益9A購06  ,0,0,0,0,0,0,0,0,0,0,0,0,0,53000,53000,0,0
060808,欣興群益9A購01  ,0,0,0,0,0,0,0,0,0,0,0,0,0,1000,1000,0,0
06079P,燿華群益98售02  ,0,0,0,0,0,0,0,0,0,0,0,0,0,56000,56000,0,0
06076P,大立光凱基98售03,0,0,0,0,0,0,0,0,0,0,0,0,0,60000,60000,0,0
060655,國巨統一9B購06  ,0,0,0,0,0,0,0,0,0,0,0,0,0,200000,200000,0,0
060656,國巨統一9C購03  ,0,0,0,0,0,0,0,0,0,0,0,0,0,200000,200000,0,0
060645,台表科永豐9A購02,0,0,0,0,0,0,0,0,0,0,0,0,0,12000,12000,0,0
060608,玉晶光凱基9A購08,0,0,0,0,0,0,0,0,0,0,0,0,0,20000,20000,0,0
060617,華新科元大9A購08,0,0,0,0,0,0,0,0,0,0,0,0,0,10000,10000,0,0
061258,華通凱基9A購06  ,0,0,0,0,0,0,0,0,0,0,0,0,0,13000,13000,0,0
061324,華新科凱基9C購01,0,0,0,0,0,0,0,0,0,0,0,0,0,80000,80000,0,0
061309,鴻海統一9C購05  ,0,0,0,0,0,0,0,0,0,0,0,0,0,20000,20000,0,0
061291,玉晶光統一01購05,0,0,0,0,0,0,0,0,0,0,0,0,0,1000,1000,0,0
061338,台積電元大9A購28,0,0,0,0,0,0,0,0,0,0,0,0,0,3000,3000,0,0
061362,台塑國票9B購01  ,0,0,0,0,0,0,0,0,0,0,0,0,0,39000,39000,0,0
06142P,台虹康和97售02  ,0,0,0,0,0,0,0,0,0,0,0,0,0,10000,10000,0,0
06150P,奇力新元大97售06,0,0,0,0,0,0,0,0,0,0,0,0,0,8000,8000,0,0
061490,茂林兆豐9B購01  ,0,0,0,0,0,0,0,0,0,0,0,0,0,20000,20000,0,0
061483,TPK元大9A購01   ,0,0,0,0,0,0,0,0,0,0,0,0,0,57000,57000,0,0
061539,國巨群益9B購03  ,0,0,0,0,0,0,0,0,0,0,0,0,0,30000,30000,0,0
061140,華擎統一9C購01  ,0,0,0,0,0,0,0,0,0,0,0,0,0,16000,16000,0,0
061161,南六群益9A購01  ,0,0,0,0,0,0,0,0,0,0,0,0,0,2000,2000,0,0
061018,台積電國票9B購05,0,0,0,0,0,0,0,0,0,0,0,0,0,2000,2000,0,0
061015,旺宏麥證9A購03  ,0,0,0,15000,15000,0,0,0,0,0,0,0,0,15000,15000,0,0
061012,國巨麥證9A購03  ,0,0,0,0,10000,-10000,0,0,0,0,0,0,0,10000,10000,0,0
061039,台表科永豐9A購03,0,0,0,0,0,0,0,0,0,0,0,0,0,1000,1000,0,0
060923,全新永豐9A購01  ,0,0,0,0,0,0,0,0,0,0,0,0,0,1000,1000,0,0
06840P,臺股指統一98售04,0,0,0,0,0,0,0,0,0,0,0,0,0,10000,10000,0,0
06843P,鴻海元大98售11  ,0,0,0,0,0,0,0,0,0,0,0,0,0,45000,45000,0,0
06867P,訊芯元大98售08  ,0,0,0,0,0,0,0,0,0,0,0,0,0,50000,50000,0,0
06861P,台積電國票99售08,0,0,0,0,0,0,0,0,0,0,0,0,0,20000,20000,0,0
06874P,台積電台新98售02,0,0,0,0,0,0,0,0,0,0,0,0,0,10000,10000,0,0
06876P,台灣50兆豐9B售01,0,0,0,0,0,0,0,0,0,0,0,1000,-1000,1000,0,1000,0
06754P,台積電永豐98售03,0,0,0,0,0,0,0,0,0,0,0,0,0,16000,16000,0,0
06758P,鴻海元大98售10  ,0,0,0,0,0,0,0,0,0,0,0,0,0,60000,60000,0,0
06761P,台積電元大99售05,0,0,0,0,0,0,0,0,0,0,0,0,0,55000,55000,0,0
06834P,訊芯群益99售02  ,0,0,0,0,0,0,0,0,0,0,0,0,0,100000,100000,0,0
06928P,鴻海元大99售10  ,0,0,0,0,0,0,0,0,0,0,0,0,0,16000,16000,0,0
06895P,台灣50統一9A售01,0,0,0,0,0,0,0,0,0,0,0,0,0,20000,20000,0,0
06986P,台積電台新9A售01,0,0,0,0,0,0,0,0,0,0,0,0,0,10000,10000,0,0
06969P,上銀元大99售02  ,0,0,0,0,0,0,0,0,0,0,0,0,0,10000,10000,0,0
06567P,鴻海永豐98售02  ,0,0,0,0,0,0,0,0,0,0,0,0,0,20000,20000,0,0
06568P,國巨永豐98售05  ,0,0,0,0,0,0,0,0,0,0,0,0,0,15000,15000,0,0
06553P,訊芯元大98售05  ,0,0,0,0,0,0,0,0,0,0,0,0,0,50000,50000,0,0
06616P,國巨元大98售15  ,0,0,0,0,0,0,0,0,0,0,0,0,0,30000,30000,0,0
06510P,燿華永豐98售03  ,0,0,0,0,0,0,0,0,0,0,0,0,0,42000,42000,0,0
06513P,鴻海凱基98售10  ,0,0,0,0,0,0,0,0,0,0,0,0,0,5000,5000,0,0
06533P,上証2X中信9B售01,0,0,0,0,0,0,0,0,0,0,0,0,0,10000,10000,0,0
06528P,台積電富邦99售03,0,0,0,0,0,0,0,0,0,0,0,0,0,200000,200000,0,0
06516P,國巨凱基98售08  ,0,0,0,0,0,0,0,0,0,0,0,0,0,40000,40000,0,0
06741P,台積電富邦98售04,0,0,0,0,0,0,0,0,0,0,0,0,0,10000,10000,0,0
06697P,台積電國票99售05,0,0,0,0,0,0,0,0,0,0,0,0,0,20000,20000,0,0
06685P,鴻海國泰9A售01  ,0,0,0,0,0,0,0,0,0,0,0,0,0,30000,30000,0,0
06630P,國巨群益98售08  ,0,0,0,0,0,0,0,0,0,0,0,0,0,100000,100000,0,0
06656P,GIS元大98售02   ,0,0,0,0,0,0,0,0,0,0,0,0,0,80000,80000,0,0
06646P,國巨元大98售16  ,0,0,0,0,0,0,0,0,0,0,0,0,0,52000,52000,0,0
061623,祥碩群益9A購01  ,0,0,0,0,0,0,0,0,0,0,0,0,0,38000,38000,0,0
061712,旺宏凱基9A購08  ,0,0,0,0,0,0,0,0,0,0,0,0,0,7000,7000,0,0
06427P,鴻海元大97售13  ,0,0,0,0,0,0,0,0,0,0,0,0,0,60000,60000,0,0
06417P,台積電兆豐97售03,0,0,0,0,0,0,0,0,0,0,0,0,0,20000,20000,0,0
06473P,鴻海元大99售03  ,0,0,0,0,0,0,0,0,0,0,0,0,0,30000,30000,0,0
06298P,聯發科元大97售20,0,0,0,0,0,0,0,0,0,0,0,0,0,10000,10000,0,0
06236P,台積電元大97售25,0,0,0,0,0,0,0,0,0,0,0,0,0,20000,20000,0,0
06248P,國巨統一97售07  ,0,0,0,0,0,0,0,0,0,0,0,0,0,290000,290000,0,0
061802,勤誠永豐9B購01  ,0,0,0,0,0,0,0,0,0,0,0,0,0,50000,50000,0,0
061716,瑞儀凱基9B購01  ,0,0,0,0,0,0,0,0,0,0,0,0,0,53000,53000,0,0
061780,國巨群益9C購01  ,0,0,0,0,0,0,0,0,0,0,0,0,0,200000,200000,0,0
061772,健策元大9B購06  ,0,0,0,0,0,0,0,0,0,0,0,0,0,4000,4000,0,0
061786,義隆群益9B購01  ,0,0,0,0,0,0,0,0,0,0,0,0,0,13000,13000,0,0
061791,康友群益9B購01  ,0,0,0,0,0,0,0,0,0,0,0,0,0,1000,1000,0,0
06179P,國巨群益97售04  ,0,0,0,0,0,0,0,0,0,0,0,0,0,200000,200000,0,0
053735,矽力中信97購01  ,0,0,0,0,0,0,0,0,0,0,0,0,0,20000,20000,0,0
053745,康友國票97購01  ,0,0,0,0,0,0,0,0,0,0,0,0,0,20000,20000,0,0
054749,聯茂凱基98購01  ,0,0,0,0,0,0,0,0,0,0,0,0,0,1000,1000,0,0
053628,微星兆豐96購01  ,0,0,0,0,0,0,0,0,0,0,0,0,0,20000,20000,0,0
053496,義隆兆豐96購02  ,0,0,0,0,0,0,0,0,0,0,0,0,0,106000,106000,0,0
050495,大立光永昌96購01,0,0,0,0,0,0,0,0,0,0,0,0,0,1000,1000,0,0
052790,智邦兆豐97購01  ,0,0,0,0,0,0,0,0,0,0,0,0,0,20000,20000,0,0
050121,南電元大95購02  ,0,0,0,0,0,0,0,0,0,0,0,0,0,5000,5000,0,0
051957,旺宏台新95購02  ,0,0,0,0,0,0,0,0,0,0,0,0,0,60000,60000,0,0
051906,國巨元大95購09  ,0,0,0,0,0,0,0,0,0,0,0,0,0,3000,3000,0,0
051988,台光電元大95購01,0,0,0,0,0,0,0,0,0,0,0,0,0,26000,26000,0,0
050782,台積電國泰96購03,0,0,0,0,0,0,0,0,0,0,0,0,0,10000,10000,0,0
05073P,臺股指中信95售09,0,0,0,0,0,0,0,0,0,0,0,0,0,40000,40000,0,0
050774,健策元大96購02  ,0,0,0,0,0,0,0,0,0,0,0,0,0,10000,10000,0,0
051394,奇鋐兆豐95購01  ,0,0,0,0,0,0,0,0,0,0,0,0,0,26000,26000,0,0
05122P,鴻海永昌96售06  ,0,0,0,0,0,0,0,0,0,0,0,0,0,75000,75000,0,0
051154,國巨國泰96購03  ,0,0,0,0,0,0,0,0,0,0,0,0,0,1000,1000,0,0
051254,健策元大96購04  ,0,0,0,0,0,0,0,0,0,0,0,0,0,10000,10000,0,0
051266,國巨富邦99購01  ,0,0,0,0,0,0,0,0,0,0,0,0,0,82000,82000,0,0
051290,大立光統一96購02,0,0,0,0,0,0,0,0,0,0,0,0,0,161000,161000,0,0
051756,台積電元大97購04,0,0,0,0,0,0,0,0,0,0,0,0,0,220000,220000,0,0
051653,南電永豐95購02  ,0,0,0,0,0,0,0,0,0,0,0,0,0,10000,10000,0,0
04495P,台積電國票95售01,0,0,0,0,0,0,0,0,0,0,0,0,0,269000,269000,0,0
049761,亞德客國泰95購03,0,0,0,0,0,0,0,0,0,0,0,0,0,10000,10000,0,0
049775,旺宏統一95購02  ,0,0,0,0,0,0,0,0,0,0,0,0,0,7000,7000,0,0
04974P,聯發科凱基96售02,0,0,0,0,0,0,0,0,0,0,0,0,0,4000,4000,0,0
04957P,上証2X凱基96售02,0,0,0,0,0,0,0,0,0,0,0,0,0,1000,1000,0,0
04950P,上証2X中信96售02,0,0,0,0,0,0,0,0,0,0,0,0,0,20000,20000,0,0
04881P,高股息凱基96售01,0,0,0,0,0,0,0,0,0,0,0,0,0,10000,10000,0,0
049004,聯發科中信96購01,0,0,0,0,0,0,0,0,0,0,0,0,0,30000,30000,0,0
048484,大立光國泰95購02,0,0,0,0,0,0,0,0,0,0,0,0,0,8000,8000,0,0
00774B,新光中國政金綠債,0,0,0,0,0,0,0,0,0,0,0,0,0,2000,2000,0,0
00775B,新光投等債15+   ,0,0,0,0,0,0,0,0,0,0,0,0,0,2000,2000,0,0
00776,新光ICE美國權值 ,0,0,0,0,0,0,0,0,0,0,0,0,0,100000,100000,0,0
00707R,元大S&P日圓反1  ,0,0,0,0,0,0,0,0,0,0,0,0,0,1000,1000,0,0
00691R,兆豐藍籌30反1   ,0,0,0,0,0,0,0,0,0,0,0,0,0,1000,1000,0,0
00732,國泰RMB短期報酬 ,0,0,0,0,0,0,0,0,0,0,0,0,0,120000,120000,0,0
00625K,富邦上証+R      ,0,0,0,0,0,0,0,0,0,0,0,0,0,56000,56000,0,0
00636K,國泰中國A50+U   ,0,0,0,0,0,0,0,0,0,0,0,0,0,100,100,0,0
00657K,國泰日經225+U   ,0,0,0,0,0,0,0,0,0,0,0,0,0,100,100,0,0
00668K,國泰美國道瓊+U  ,0,0,0,0,0,0,0,0,0,0,0,0,0,100,100,0,0
00682U,元大美元指數    ,0,0,0,0,0,0,0,0,0,0,0,0,0,1000,1000,0,0
00686R,群益臺灣加權反1 ,0,0,0,0,0,0,0,0,0,0,0,0,0,346000,346000,0,0
00689R,國泰20年美債反1 ,0,0,0,0,0,0,0,0,0,0,0,0,0,100000,100000,0,0
052332,美律亞東96購01  ,0,0,0,0,0,0,0,0,0,0,0,0,0,20000,20000,0,0
052308,大立光國泰97購02,0,0,0,0,0,0,0,0,0,0,0,0,0,2000,2000,0,0
052409,國巨亞東95購01  ,0,0,0,0,0,0,0,0,0,0,0,0,0,40000,40000,0,0
052159,瑞昱永豐95購01  ,0,0,0,0,0,0,0,0,0,0,0,0,0,13000,13000,0,0
052252,大立光永豐95購03,0,0,0,0,0,0,0,0,0,0,0,0,0,3000,3000,0,0
052516,臺股指凱基95購20,0,20000,-20000,0,0,0,0,0,0,20000,0,0,0,20000,0,20000,0
050100,台積電永昌96購02,0,0,0,0,0,0,0,0,0,0,0,0,0,190000,190000,0,0
052537,力成富邦95購01  ,0,0,0,0,0,0,0,0,0,0,0,0,0,10000,10000,0,0
052541,大立光統一95購06,0,0,0,0,0,0,0,0,0,0,0,0,0,5000,5000,0,0
052607,大立光元大96購03,0,0,0,0,0,0,0,0,0,0,0,0,0,1000,1000,0,0
052594,友訊群益98購01  ,0,0,0,0,0,0,0,0,0,0,0,0,0,1000,1000,0,0
048058,大立光國泰95購01,0,0,0,0,0,0,0,0,0,0,0,0,0,4000,4000,0,0
048177,臺指反富邦99購01,0,0,0,0,0,0,0,0,0,0,0,0,0,190000,190000,0,0
052089,聯發科元大96購02,0,0,0,0,0,0,0,0,0,0,0,0,0,10000,10000,0,0
052078,大立光元富95購10,0,0,0,0,0,0,0,0,0,0,0,0,0,6000,6000,0,0
042556,台灣50中信96購04,0,0,0,0,0,0,0,0,0,0,0,0,0,140000,140000,0,0
055270,上銀元大97購03  ,0,0,0,0,0,0,0,0,0,0,0,0,0,10000,10000,0,0
055271,鴻海元大98購03  ,0,0,0,0,0,0,0,0,0,0,0,0,0,1000,1000,0,0
055264,國巨永豐98購01  ,0,0,0,0,0,0,0,0,0,0,0,0,0,1000,1000,0,0
058251,百和元大99購03  ,0,0,0,0,0,0,0,0,0,0,0,0,0,48000,48000,0,0
058228,為升元大99購01  ,0,0,0,0,0,0,0,0,0,0,0,0,0,2000,2000,0,0
058317,國巨永豐99購02  ,0,0,0,0,0,0,0,0,0,0,0,0,0,183000,183000,0,0
058321,大立光永豐99購01,0,0,0,0,0,0,0,0,0,0,0,0,0,112000,112000,0,0
058339,康友元富99購02  ,0,0,0,0,0,0,0,0,0,0,0,0,0,10000,10000,0,0
058347,玉晶光群益9B購01,0,0,0,0,0,0,0,0,0,0,0,0,0,93000,93000,0,0
057984,聯發科台新98購01,0,0,0,0,0,0,0,0,0,0,0,0,0,110000,110000,0,0
057992,大立光日盛98購01,0,0,0,0,0,0,0,0,0,0,0,0,0,50000,50000,0,0
057989,旺宏統一99購04  ,0,0,0,0,0,0,0,0,0,0,0,0,0,102000,102000,0,0
057996,臻鼎中信98購01  ,0,0,0,0,0,0,0,0,0,0,0,0,0,20000,20000,0,0
05800P,台積電兆豐96售04,0,0,0,0,0,0,0,0,0,0,0,0,0,50000,50000,0,0
055238,茂林台新97購01  ,0,0,0,0,0,0,0,0,0,0,0,0,0,10000,10000,0,0
055205,京鼎中信99購01  ,0,0,0,0,0,0,0,0,0,0,0,0,0,10000,10000,0,0
054526,道瓊反統一98購01,0,0,0,0,0,0,0,0,0,0,0,0,0,10000,10000,0,0
05449P,臺股指元大95售26,0,0,0,0,0,0,0,0,0,0,0,0,0,9000,9000,0,0
054446,美食兆豐97購01  ,0,0,0,0,0,0,0,0,0,0,0,0,0,5000,5000,0,0
054609,正崴永豐97購01  ,0,0,0,0,0,0,0,0,0,0,0,0,0,10000,10000,0,0
054621,華新科兆豐98購01,0,0,0,0,0,0,0,0,0,0,0,0,0,10000,10000,0,0
054440,TPK台新98購01   ,0,0,0,0,0,0,0,0,0,0,0,0,0,10000,10000,0,0
05456P,鴻海凱基95售19  ,0,0,0,0,0,0,0,0,0,0,0,0,0,20000,20000,0,0
05427P,聯發科凱基96售07,0,0,0,0,0,0,0,0,0,0,0,0,0,8000,8000,0,0
054265,GIS元大96購03   ,0,0,0,0,0,0,0,0,0,0,0,0,0,109000,109000,0,0
054336,台積電統一96購11,0,0,0,0,0,0,0,0,0,0,0,0,0,110000,110000,0,0
05439P,聯發科國票95售06,0,0,0,0,0,0,0,0,0,0,0,0,0,50000,50000,0,0
054360,智邦凱基96購03  ,0,0,0,0,0,0,0,0,0,0,0,0,0,1000,1000,0,0
054090,瑞昱群益97購01  ,0,0,0,0,0,0,0,0,0,0,0,0,0,8000,8000,0,0
054212,聯詠國票97購03  ,0,0,0,0,0,0,0,0,0,0,0,0,0,100000,100000,0,0
05413P,台郡國票96售02  ,0,0,0,0,0,0,0,0,0,0,0,0,0,10000,10000,0,0
054174,宏達電台新97購01,0,0,0,0,0,0,0,0,0,0,0,0,0,10000,10000,0,0
054085,華新科統一96購04,0,0,0,0,0,0,0,0,0,0,0,0,0,100000,100000,0,0
055097,福懋科群益97購01,0,0,0,0,0,0,0,0,0,0,0,0,0,63000,63000,0,0
055053,瑞昱永豐97購01  ,0,0,0,0,0,0,0,0,0,0,0,0,0,67000,67000,0,0
053451,致新凱基96購02  ,0,0,0,0,0,0,0,0,0,0,0,0,0,20000,20000,0,0
053423,亞光永豐96購01  ,0,0,0,0,0,0,0,0,0,0,0,0,0,41000,41000,0,0
053439,台積電凱基96購11,0,0,0,0,0,0,0,0,0,0,0,0,0,20000,20000,0,0
053226,國巨台新97購02  ,0,0,0,0,0,0,0,0,0,0,0,0,0,10000,10000,0,0
05318P,臺股指永昌95售03,0,0,0,0,0,0,0,0,0,0,0,10000,-10000,10000,0,10000,0
053163,上証2X群益9A購02,0,0,0,0,0,0,0,0,0,0,0,0,0,40000,40000,0,0
05315P,鴻海永昌96售08  ,0,0,0,0,0,0,0,0,0,0,0,0,0,109000,109000,0,0
055049,智邦永豐97購01  ,0,0,0,0,0,0,0,0,0,0,0,0,0,18000,18000,0,0
055021,亞德客國泰98購01,0,0,0,0,0,0,0,0,0,0,0,0,0,20000,20000,0,0
053012,國巨統一96購03  ,0,0,0,0,0,0,0,0,0,0,0,0,0,80000,80000,0,0
052884,台積電兆豐96購01,0,0,0,0,0,0,0,0,0,0,0,0,0,10000,10000,0,0
052879,滬深2X凱基97購02,0,0,0,0,0,0,0,0,0,0,0,0,0,10000,10000,0,0
052835,滬深2X國泰98購01,0,0,0,0,0,0,0,0,0,0,0,0,0,10000,10000,0,0
053811,國巨群益98購02  ,0,0,0,0,0,0,0,0,0,0,0,0,0,10000,10000,0,0
055408,力成國泰98購01  ,0,0,0,0,0,0,0,0,0,0,0,0,0,1000,1000,0,0
055350,聯發科凱基97購02,0,0,0,0,0,0,0,0,0,0,0,0,0,5000,5000,0,0
055300,緯穎元大98購01  ,0,0,0,0,0,0,0,0,0,0,0,0,0,5000,5000,0,0
059136,臺股指群益99購11,0,0,0,0,0,0,0,0,0,0,0,0,0,1000,1000,0,0
059169,可成凱基99購04  ,0,0,0,0,0,0,0,0,0,0,0,0,0,10000,10000,0,0
059179,祥碩元富99購01  ,0,0,0,0,0,0,0,0,0,0,0,0,0,92000,92000,0,0
059236,鴻海凱基99購09  ,0,0,0,0,0,0,0,0,0,0,0,0,0,23000,23000,0,0
059237,鴻海凱基9A購10  ,0,0,0,0,0,0,0,0,0,0,0,0,0,1000,1000,0,0
059220,聯發科元大99購20,0,0,0,0,0,0,0,0,0,0,0,0,0,110000,110000,0,0
059255,臺股指凱基99購33,0,0,0,0,0,0,0,0,0,0,0,0,0,44000,44000,0,0
059253,康控凱基9B購02  ,0,0,0,0,0,0,0,0,0,0,0,0,0,14000,14000,0,0
059451,國巨永豐99購05  ,0,0,0,0,0,0,0,0,0,0,0,0,0,183000,183000,0,0
059442,祥碩元大99購03  ,0,0,0,0,0,0,0,0,0,0,0,0,0,3000,3000,0,0
059443,嘉聯益元大9B購01,0,0,0,0,0,0,0,0,0,0,0,0,0,2000,2000,0,0
059486,A50正2兆豐9A購01,0,0,0,0,0,0,0,0,0,0,0,0,0,10000,10000,0,0
059359,精元永豐99購01  ,0,0,0,0,0,0,0,0,0,0,0,0,0,60000,60000,0,0
059436,大立光元大99購18,0,0,0,0,0,0,0,0,0,0,0,0,0,15000,15000,0,0
059039,致伸群益99購01  ,0,0,0,0,0,0,0,0,0,0,0,0,0,5000,5000,0,0
059056,技嘉凱基99購02  ,0,0,0,0,0,0,0,0,0,0,0,0,0,3000,3000,0,0
05912P,和大元大96售01  ,0,0,0,0,0,0,0,0,0,0,0,0,0,15000,15000,0,0
056295,國巨元大97購16  ,0,0,0,0,0,0,0,0,0,0,0,0,0,1000,1000,0,0
056262,台積電統一98購04,0,0,0,0,0,0,0,0,0,0,0,0,0,200000,200000,0,0
05723P,華通永豐96售03  ,0,0,0,0,0,0,0,0,0,0,0,0,0,40000,40000,0,0
056635,亞德客日盛99購01,0,0,0,0,0,0,0,0,0,0,0,0,0,5000,5000,0,0
057821,晶相光元大98購03,0,0,0,0,0,0,0,0,0,0,0,0,0,9000,9000,0,0
057825,和碩元大98購02  ,0,0,0,0,0,0,0,0,0,0,0,0,0,12000,12000,0,0
05779P,台積電統一96售06,0,0,0,0,0,0,0,0,0,0,0,0,0,90000,90000,0,0
058743,可成康和99購01  ,0,0,0,0,0,0,0,0,0,0,0,0,0,8000,8000,0,0
058735,南茂永豐99購01  ,0,8000,-8000,0,0,0,0,0,0,8000,0,0,0,28000,20000,8000,0
058980,鴻海凱基99購06  ,0,0,0,0,0,0,0,0,0,0,0,0,0,3000,3000,0,0
05752P,台積電中信96售06,0,0,0,0,0,0,0,0,0,0,0,0,0,20000,20000,0,0
057380,技嘉國泰9A購01  ,0,0,0,0,0,0,0,0,0,0,0,0,0,30000,30000,0,0
057360,元油2X元大98購10,0,0,0,0,0,0,0,0,0,0,0,0,0,9000,9000,0,0
057429,華新科兆豐98購03,0,0,0,0,0,0,0,0,0,0,0,0,0,10000,10000,0,0
057462,光磊永豐98購02  ,0,0,0,0,0,0,0,0,0,0,0,0,0,27000,27000,0,0
05746P,台積電群益96售07,0,0,0,0,0,0,0,0,0,0,0,0,0,90000,90000,0,0
058445,旺宏富邦9C購01  ,0,0,0,0,0,0,0,0,0,0,0,0,0,10000,10000,0,0
05843P,台積電元大96售16,0,0,0,0,0,0,0,0,0,0,0,0,0,20000,20000,0,0
058432,台積電統一9B購03,0,0,0,0,0,0,0,0,0,0,0,0,0,200000,200000,0,0
058414,大立光兆豐99購02,0,0,0,0,0,0,0,0,0,0,0,0,0,136000,136000,0,0
05862P,大立光國泰98售01,0,0,0,0,0,0,0,0,0,0,0,0,0,220000,220000,0,0
058619,台灣50國票99購04,0,0,0,0,0,0,0,0,0,0,0,0,0,100000,100000,0,0
055735,宏達電元富98購01,0,0,0,0,0,0,0,0,0,0,0,0,0,30000,30000,0,0
05575P,玉晶光元富96售01,0,0,0,0,0,0,0,0,0,0,0,0,0,331000,331000,0,0
058671,旺宏群益9A購01  ,0,0,0,0,0,0,0,0,0,0,0,0,0,1000,1000,0,0
05617P,大立光統一97售02,0,0,0,0,0,0,0,0,0,0,0,0,0,10000,10000,0,0
055579,健策統一9A購01  ,0,0,0,0,0,0,0,0,0,0,0,0,0,145000,145000,0,0
055588,瑞昱元大97購03  ,0,0,0,0,0,0,0,0,0,0,0,0,0,4000,4000,0,0
055565,祥碩凱基97購01  ,0,0,0,0,0,0,0,0,0,0,0,0,0,1000,1000,0,0
055503,健策元大98購05  ,0,0,0,0,0,0,0,0,0,0,0,0,0,98000,98000,0,0
055545,國巨凱基97購06  ,0,0,0,0,0,0,0,0,0,0,0,0,0,23000,23000,0,0
057757,鴻海凱基98購13  ,0,0,0,0,0,0,0,0,0,0,0,0,0,1000,1000,0,0
057763,康控凱基99購02  ,0,0,0,0,0,0,0,0,0,0,0,0,0,70000,70000,0,0
056376,玉晶光統一98購01,0,0,0,0,0,0,0,0,0,0,0,0,0,20000,20000,0,0
056355,台積電元大98購08,0,0,0,0,0,0,0,0,0,0,0,0,0,10000,10000,0,0
056509,晶相光永豐98購01,0,0,0,0,0,0,0,0,0,0,0,0,0,8000,8000,0,0
056526,力山凱基98購01  ,0,0,0,0,0,0,0,0,0,0,0,0,0,89000,89000,0,0
058086,鴻海元大98購14  ,0,0,0,0,0,0,0,0,0,0,0,0,0,24000,24000,0,0
058080,台積電群益98購06,0,0,0,0,0,0,0,0,0,0,0,0,0,16000,16000,0,0
056093,大毅元富97購01  ,0,0,0,0,0,0,0,0,0,0,0,0,0,10000,10000,0,0
05610P,國巨群益98售01  ,0,0,0,0,0,0,0,0,0,0,0,0,0,10000,10000,0,0
058367,大立光凱基9A購01,0,0,0,0,0,0,0,0,0,0,0,0,0,6000,6000,0,0
058572,百和凱基9A購01  ,0,0,0,0,0,0,0,0,0,0,0,0,0,3000,3000,0,0
058830,健策永豐99購02  ,0,0,0,0,0,0,0,0,0,0,0,0,0,13000,13000,0,0
058535,玉晶光統一9A購06,0,0,0,0,0,0,0,0,0,0,0,0,0,3000,3000,0,0
058502,鴻海元大99購13  ,0,0,0,0,0,0,0,0,0,0,0,0,0,46000,46000,0,0
058505,台積電元大99購08,0,0,0,0,0,0,0,0,0,0,0,0,0,14000,14000,0,0
057665,技嘉元大99購01  ,0,0,0,0,0,0,0,0,0,0,0,0,0,1000,1000,0,0
057658,玉晶光兆豐99購02,0,0,0,0,0,0,0,0,0,0,0,0,0,10000,10000,0,0
05790P,臺股指永昌96售07,0,0,0,0,0,0,0,0,0,0,0,0,0,3000,3000,0,0
057910,華新科兆豐99購02,0,0,0,0,0,0,0,0,0,0,0,0,0,10000,10000,0,0
05792P,臺股指中信99售07,0,0,0,0,0,0,0,0,0,0,0,0,0,40000,40000,0,0
4571,鈞興-KY         ,1000,1000,0,0,0,0,0,0,0,0,0,0,0,0,0,0,0
07125P,台積電元大99售22,0,0,0,0,0,0,0,0,0,0,0,0,0,20000,20000,0,0
07098P,台積電元大99售18,0,0,0,0,0,0,0,0,0,0,0,0,0,2000,2000,0,0
07077P,緯穎凱基99售01  ,0,0,0,0,0,0,0,0,0,0,0,0,0,229000,229000,0,0
07079P,台積電群益99售06,0,0,0,0,0,0,0,0,0,0,0,0,0,20000,20000,0,0
07013P,玉晶光群益9A售06,0,0,0,0,0,0,0,0,0,0,0,0,0,1000,1000,0,0
07207P,台積電凱基99售13,0,0,0,0,0,0,0,0,0,0,0,0,0,20000,20000,0,0
07198P,臺股指元大99售14,0,0,0,0,0,0,0,0,0,0,0,0,0,9000,9000,0,0
07133P,臺股指元大9A售27,0,0,0,0,0,0,0,0,0,0,0,0,0,10000,10000,0,0
07427P,台積電國票9B售02,0,0,0,0,0,0,0,0,0,0,0,0,0,20000,20000,0,0
07324P,台積電元大99售40,0,0,0,0,0,0,0,0,0,0,0,0,0,20000,20000,0,0
07291P,臺股指凱基99售43,0,0,0,0,0,0,0,0,0,0,0,0,0,50000,50000,0,0
07850P,健策群益9A售06  ,0,0,0,0,0,0,0,0,0,0,0,0,0,154000,154000,0,0
07853P,國巨凱基9A售19  ,0,0,0,0,0,0,0,0,0,0,0,0,0,200000,200000,0,0
07854P,台積電凱基9A售28,0,0,0,0,0,0,0,0,0,0,0,0,0,20000,20000,0,0
07871P,台積電群益9C售02,0,0,0,0,0,0,0,0,0,0,0,0,0,20000,20000,0,0
07814P,華通群益9A售06  ,0,0,0,0,0,0,0,0,0,0,0,0,0,2000,2000,0,0
07824P,國巨元大9A售24  ,0,0,0,0,0,0,0,0,0,0,0,0,0,70000,70000,0,0
07816P,聯發科群益9A售02,0,0,0,0,0,0,0,0,0,0,0,0,0,179000,179000,0,0
07695P,台郡元大9A售02  ,0,0,0,0,0,0,0,0,0,0,0,0,0,19000,19000,0,0
07704P,台積電元大9A售25,0,0,0,0,0,0,0,0,0,0,0,0,0,20000,20000,0,0
07721P,台積電凱基9A售22,0,0,0,0,0,0,0,0,0,0,0,0,0,20000,20000,0,0
07589P,玉晶光國票9A售02,0,0,0,0,0,0,0,0,0,0,0,0,0,20000,20000,0,0
07564P,臺股指中信01售01,0,0,0,0,0,0,0,0,0,0,0,0,0,12000,12000,0,0
07662P,台積電兆豐9A售03,0,0,0,0,0,0,0,0,0,0,0,0,0,10000,10000,0,0
07551P,國巨元大9A售10  ,0,0,0,0,0,0,0,0,0,0,0,0,0,150000,150000,0,0
07513P,台積電元大9A售13,0,0,0,0,0,0,0,0,0,0,0,0,0,20000,20000,0,0
07507P,國巨國票9B售02  ,0,0,0,0,0,0,0,0,0,0,0,0,0,200000,200000,0,0
07498P,台積電元大9A售09,0,0,0,0,0,0,0,0,0,0,0,0,0,20000,20000,0,0
07489P,國巨國票9A售07  ,0,0,0,0,0,0,0,0,0,0,0,0,0,240000,240000,0,0
1615,大山            ,33000,33000,0,0,0,0,0,0,0,0,0,0,0,0,0,0,0
061740,華新科凱基03購01,0,0,0,0,0,0,0,0,0,-1000,0,0,0,0,1000,-1000,-1000
06213P,大立光元大98售07,0,0,0,0,0,0,0,0,0,-1000,0,0,0,10000,11000,-1000,-1000
06229P,欣興凱基97售07  ,0,0,0,0,0,0,0,0,0,-1000,0,0,0,0,1000,-1000,-1000
06295P,國巨元大97售14  ,0,0,0,0,0,0,0,0,0,-1000,0,0,0,0,1000,-1000,-1000
06271P,彩晶凱基97售01  ,0,0,0,0,0,0,0,0,0,-1000,0,0,0,0,1000,-1000,-1000
06266P,大立光凱基97售11,0,0,0,0,0,0,0,0,0,-1000,0,0,0,0,1000,-1000,-1000
06373P,聯發科元大97售22,0,0,0,0,0,0,0,0,0,-1000,0,0,0,40000,41000,-1000,-1000
06435P,臺股指群益98售02,0,0,0,0,0,0,0,0,0,-1000,0,0,0,0,1000,-1000,-1000
061714,華新科凱基9A購15,0,0,0,0,0,0,0,0,0,-1000,0,0,0,0,1000,-1000,-1000
061710,國巨凱基9A購18  ,0,0,0,0,0,0,0,0,0,-1000,0,0,0,20000,21000,-1000,-1000
06645P,上銀元大98售05  ,0,0,0,0,0,0,0,0,0,-1000,0,0,0,13000,14000,-1000,-1000
06658P,台灣50富邦9C售01,0,0,0,0,0,0,0,0,0,-1000,0,0,0,10000,11000,-1000,-1000
06722P,臺股指中信9A售04,0,0,0,0,0,0,0,0,0,-1000,0,0,0,80000,81000,-1000,-1000
06477P,緯穎國票99售02  ,0,0,0,0,0,0,0,0,0,-1000,0,0,0,0,1000,-1000,-1000
06972P,聯發科元大99售04,0,0,0,0,0,0,0,0,0,-1000,0,0,0,0,1000,-1000,-1000
06794P,臺股指凱基98售04,0,0,0,0,0,0,0,0,0,-1000,0,0,0,0,1000,-1000,-1000
06790P,台積電凱基9A售04,0,0,0,0,0,0,0,0,0,-1000,0,0,0,0,1000,-1000,-1000
06764P,聯發科元大98售11,0,0,0,0,0,0,0,0,0,-1000,0,0,0,1000,2000,-1000,-1000
06765P,欣興元大98售11  ,0,0,0,0,0,0,0,0,0,-1000,0,0,0,24000,25000,-1000,-1000
061499,嘉晶國票9A購03  ,0,0,0,0,0,0,0,0,0,-1000,0,0,0,40000,41000,-1000,-1000
061409,力成國票9A購02  ,0,0,0,0,0,0,0,0,0,-1000,0,0,0,6000,7000,-1000,-1000
061323,華新科凱基9B購06,0,0,0,0,0,0,0,0,0,-1000,0,0,0,0,1000,-1000,-1000
060838,華通國票9A購05  ,0,0,0,0,0,0,0,0,0,-1000,0,0,0,0,1000,-1000,-1000
06087P,國巨永豐97售01  ,0,0,0,0,0,0,0,0,0,-1000,0,0,0,20000,21000,-1000,-1000
060449,元金2X元大9A購02,0,0,0,0,0,0,0,0,0,-1000,0,0,0,10000,11000,-1000,-1000
060466,玉山金元大9A購01,0,0,0,0,0,0,0,0,0,-1000,0,0,0,63000,64000,-1000,-1000
060567,華擎富邦9C購01  ,0,0,0,0,0,0,0,0,0,-1000,0,0,0,0,1000,-1000,-1000
060411,達新永豐9A購01  ,0,0,0,0,0,0,0,0,0,-1000,0,0,0,10000,11000,-1000,-1000
060291,高鐵元大9A購01  ,0,0,0,0,0,0,0,0,0,-1000,0,0,0,10000,11000,-1000,-1000
059959,訊芯康和99購01  ,0,0,0,0,0,0,0,0,0,-1000,0,0,0,16000,17000,-1000,-1000
059983,聯發科元大99購38,0,0,0,0,0,0,0,0,0,-1000,0,0,0,0,1000,-1000,-1000
060022,勤誠康和99購01  ,0,0,0,0,0,0,0,0,0,-1000,0,0,0,0,1000,-1000,-1000
06018P,康控凱基96售03  ,0,0,0,0,0,0,0,0,0,-1000,0,0,0,0,1000,-1000,-1000
060147,臺股指國票9A購07,0,0,0,0,0,0,0,0,0,-1000,0,0,0,27000,28000,-1000,-1000
059527,聯發科凱基99購16,0,0,0,0,0,0,0,0,0,-1000,0,0,0,0,1000,-1000,-1000
059542,聯發科亞東99購01,0,0,0,0,0,0,0,0,0,-1000,0,0,0,0,1000,-1000,-1000
059555,台灣50凱基9A購06,0,0,0,0,0,0,0,0,0,-1000,0,0,0,0,1000,-1000,-1000
059769,滬深2X群益9C購01,0,0,0,0,0,0,0,0,0,-1000,0,0,0,0,1000,-1000,-1000
05529P,臺股指群益96售02,0,0,0,0,0,0,0,0,0,-1000,0,0,0,2000,3000,-1000,-1000
055303,鈺齊元大97購01  ,0,0,0,0,0,0,0,0,0,-1000,0,0,0,0,1000,-1000,-1000
053817,華新科群益97購02,0,0,0,0,0,0,0,0,0,-1000,0,0,0,0,1000,-1000,-1000
05388P,南亞科元大95售04,0,0,0,0,0,0,0,0,0,-1000,0,0,0,0,1000,-1000,-1000
052846,智邦統一97購01  ,0,0,0,0,0,0,0,0,0,-1000,0,0,0,0,1000,-1000,-1000
052937,國巨兆豐97購01  ,0,0,0,0,0,0,0,0,0,-1000,0,0,0,4000,5000,-1000,-1000
05289P,鴻海永豐95售05  ,0,0,0,0,0,0,0,0,0,-1000,0,0,0,0,1000,-1000,-1000
054964,智易元大99購01  ,0,0,0,0,0,0,0,0,0,-1000,0,0,0,0,1000,-1000,-1000
053373,台泥元大96購01  ,0,0,0,0,0,0,0,0,0,-1000,0,0,0,0,1000,-1000,-1000
05403P,台積電富邦95售08,0,0,0,0,0,0,0,0,0,-1000,0,0,0,0,1000,-1000,-1000
055096,緯穎群益97購01  ,0,0,0,0,0,0,0,0,0,-1000,0,0,0,0,1000,-1000,-1000
054080,微星中信98購01  ,0,0,0,0,0,0,0,0,0,-1000,0,0,0,0,1000,-1000,-1000
054239,台郡群益96購02  ,0,0,0,0,0,0,0,0,0,-1000,0,0,0,179000,180000,-1000,-1000
05437P,聯詠永豐95售02  ,0,0,0,0,0,0,0,0,0,-1000,0,0,0,0,1000,-1000,-1000
05430P,台積電統一95售07,0,0,0,0,0,0,0,0,0,-1000,0,0,0,0,1000,-1000,-1000
054295,世芯元大96購03  ,0,0,0,0,0,0,0,0,0,-1000,0,0,0,0,1000,-1000,-1000
058332,鴻海元富99購03  ,0,0,0,0,0,0,0,0,0,-1000,0,0,0,0,1000,-1000,-1000
03619C,臺股指元大95牛02,0,0,0,0,0,0,0,0,0,-1000,0,0,0,0,1000,-1000,-1000
047571,滬深2X群益99購01,0,0,0,0,0,0,0,0,0,-1000,0,0,0,0,1000,-1000,-1000
052565,上銀凱基96購01  ,0,0,0,0,0,0,0,0,0,-1000,0,0,0,0,1000,-1000,-1000
052454,力成元大95購02  ,0,0,0,0,0,0,0,0,0,-1000,0,0,0,3000,4000,-1000,-1000
052204,台泥中信96購01  ,0,0,0,0,0,0,0,0,0,-1000,0,0,0,0,1000,-1000,-1000
05239P,欣興永豐95售03  ,0,0,0,0,0,0,0,0,0,-1000,0,0,0,0,1000,-1000,-1000
052410,智邦亞東96購01  ,0,0,0,0,0,0,0,0,0,-1000,0,0,0,1000,2000,-1000,-1000
05227P,大立光統一95售04,0,0,0,0,0,0,0,0,0,-1000,0,0,0,0,1000,-1000,-1000
049117,矽格統一96購01  ,0,0,0,0,0,0,0,0,0,-1000,0,0,0,100000,101000,-1000,-1000
04866P,台積電統一95售02,0,0,0,0,0,0,0,0,0,-1000,0,0,0,0,1000,-1000,-1000
03012X,元展12          ,0,0,0,0,0,0,0,0,0,-1000,0,0,0,3000,4000,-1000,-1000
03014X,元展14          ,0,0,0,0,0,0,0,0,0,-1000,0,0,0,0,1000,-1000,-1000
03025X,元展22          ,0,0,0,0,0,0,0,0,0,-1000,0,0,0,0,1000,-1000,-1000
03035X,元展32          ,0,0,0,0,0,0,0,0,0,-1000,0,0,0,0,1000,-1000,-1000
051624,智邦麥證95購02  ,0,0,0,0,1000,-1000,0,0,0,-1000,0,0,0,0,1000,-1000,-1000
051461,聯詠國泰96購01  ,0,0,0,0,0,0,0,0,0,-1000,0,0,0,0,1000,-1000,-1000
050658,台郡麥證96購01  ,0,0,0,0,1000,-1000,0,0,0,-1000,0,0,0,0,1000,-1000,-1000
052713,智邦凱基96購01  ,0,0,0,0,0,0,0,0,0,-1000,0,0,0,0,1000,-1000,-1000
052788,開發金中信98購02,0,0,0,0,0,0,0,0,0,-1000,0,0,0,0,1000,-1000,-1000
052768,泰鼎群益96購01  ,0,0,0,0,0,0,0,0,0,-1000,0,0,0,0,1000,-1000,-1000
050543,聯發科凱基95購01,0,0,0,0,0,0,0,0,0,-1000,0,0,0,0,1000,-1000,-1000
050351,華新科群益95購02,0,0,0,0,0,0,0,0,0,-1000,0,0,0,22000,23000,-1000,-1000
054788,華新科群益98購02,0,0,0,0,0,0,0,0,0,-1000,0,0,0,0,1000,-1000,-1000
053648,台積電凱基97購04,0,0,0,0,0,0,0,0,0,-1000,0,0,0,4000,5000,-1000,-1000
053732,S&P反1中信9C購01,0,0,0,0,0,0,0,0,0,-1000,0,0,0,0,1000,-1000,-1000
054820,新日興元大97購01,0,0,0,0,0,0,0,0,0,-1000,0,0,0,0,1000,-1000,-1000
056940,嘉聯益元富98購01,0,0,0,0,0,0,0,0,0,-1000,0,0,0,9000,10000,-1000,-1000
05688P,臺股指元大96售13,0,0,0,0,0,0,0,0,0,-1000,0,0,0,0,1000,-1000,-1000
05856P,A50正2中信99售01,0,0,0,0,0,0,0,0,0,-1000,0,0,0,0,1000,-1000,-1000
058922,聯發科元富03購02,0,0,0,0,0,0,0,0,0,-1000,0,0,0,0,1000,-1000,-1000
05604P,聯發科元大96售10,0,0,0,0,0,0,0,0,0,-1000,0,0,0,0,1000,-1000,-1000
056059,美律元大98購02  ,0,5000,-5000,0,0,0,0,0,0,4000,0,0,0,5000,1000,4000,-1000
056071,創意元大97購02  ,0,0,0,0,0,0,0,0,0,-1000,0,0,0,0,1000,-1000,-1000
056138,群創元大9B購01  ,0,0,0,0,0,0,0,0,0,-1000,0,0,0,192000,193000,-1000,-1000
056126,台郡國票98購02  ,0,0,0,0,0,0,0,0,0,-1000,0,0,0,8000,9000,-1000,-1000
058217,新唐群益99購01  ,0,0,0,0,0,0,0,0,0,-1000,0,0,0,0,1000,-1000,-1000
058078,景碩國票99購01  ,0,0,0,0,0,0,0,0,0,-1000,0,0,0,32000,33000,-1000,-1000
058058,大立光元富9B購02,0,0,0,0,0,0,0,0,0,-1000,0,0,0,0,1000,-1000,-1000
056357,台積電元大9A購01,0,0,0,0,0,0,0,0,0,-1000,0,0,0,0,1000,-1000,-1000
056349,道瓊銀元大9B購01,0,0,0,0,0,0,0,0,0,-1000,0,0,0,0,1000,-1000,-1000
057030,滬深反元大9B購01,0,0,0,0,0,0,0,0,0,-1000,0,0,0,0,1000,-1000,-1000
05549P,臺股指元大96售03,0,0,0,0,0,0,0,0,0,-1000,0,0,0,957000,958000,-1000,-1000
056165,矽力凱基98購02  ,0,0,0,0,0,0,0,0,0,-1000,0,0,0,60000,61000,-1000,-1000
056225,聯發科凱基97購09,0,0,0,0,0,0,0,0,0,-1000,0,0,0,0,1000,-1000,-1000
05872P,大立光凱基96售15,0,0,0,0,0,0,0,0,0,-1000,0,0,0,0,1000,-1000,-1000
055806,致新永豐97購02  ,0,0,0,0,0,0,0,0,0,-1000,0,0,0,35000,36000,-1000,-1000
055782,新日興凱基99購01,0,0,0,0,0,0,0,0,0,-1000,0,0,0,5000,6000,-1000,-1000
05577P,上銀凱基96售02  ,0,0,0,0,0,0,0,0,0,-1000,0,0,0,0,1000,-1000,-1000
058625,旺宏國票9A購01  ,0,0,0,0,0,0,0,0,0,-1000,0,0,0,43000,44000,-1000,-1000
05845P,大立光元大96售06,0,0,0,0,0,0,0,0,0,-1000,0,0,0,0,1000,-1000,-1000
058407,滬深2X兆豐9A購01,0,0,0,0,0,0,0,0,0,-1000,0,0,0,0,1000,-1000,-1000
058861,國巨凱基9A購08  ,0,0,0,0,0,0,0,0,0,-1000,0,0,0,0,1000,-1000,-1000
057477,智邦元大98購09  ,0,0,0,0,0,0,0,0,0,-1000,0,0,0,0,1000,-1000,-1000
057544,鴻海凱基02購01  ,0,0,0,0,0,0,0,0,0,-1000,0,0,0,0,1000,-1000,-1000
058981,國巨凱基99購10  ,0,0,0,0,0,0,0,0,0,-1000,0,0,0,0,1000,-1000,-1000
058792,鴻海元大99購18  ,0,0,0,0,0,0,0,0,0,-1000,0,0,0,35000,36000,-1000,-1000
058991,台灣50元大03購01,0,0,0,0,0,0,0,0,0,-1000,0,0,0,0,1000,-1000,-1000
059002,聯發科元大99購18,0,0,0,0,0,0,0,0,0,-1000,0,0,0,0,1000,-1000,-1000
058730,玉晶光永豐9A購01,0,0,0,0,0,0,0,0,0,-1000,0,0,0,28000,29000,-1000,-1000
058777,台光電國票9A購01,0,0,0,0,0,0,0,0,0,-1000,0,0,0,1000,2000,-1000,-1000
057794,T50反1兆豐99購02,0,0,0,0,0,0,0,0,0,-1000,0,0,0,14000,15000,-1000,-1000
056444,南亞科凱基99購01,0,0,0,0,0,0,0,0,0,-1000,0,0,0,0,1000,-1000,-1000
056445,聯發科凱基98購07,0,0,0,0,0,0,0,0,0,-1000,0,0,0,10000,11000,-1000,-1000
058391,T50反1元大99購02,0,0,0,0,0,0,0,0,0,-1000,0,0,0,1000,2000,-1000,-1000
057597,華通群益9A購02  ,0,0,0,0,0,0,0,0,0,-1000,0,0,0,0,1000,-1000,-1000
05630P,大立光永昌96售06,0,0,0,0,0,0,0,0,0,-1000,0,0,0,20000,21000,-1000,-1000
059122,超眾永豐99購01  ,0,0,0,0,0,0,0,0,0,-1000,0,0,0,0,1000,-1000,-1000
059091,中信金元大99購01,0,0,0,0,0,0,0,0,0,-1000,0,0,0,0,1000,-1000,-1000
057180,華新科元大99購08,0,0,0,0,0,0,0,0,0,-1000,0,0,0,0,1000,-1000,-1000
057164,國巨元大98購14  ,0,0,0,0,0,0,0,0,0,-1000,0,0,0,10000,11000,-1000,-1000
059325,超眾元大99購05  ,0,0,0,0,0,0,0,0,0,-1000,0,0,0,0,1000,-1000,-1000
05931P,鴻海凱基96售15  ,0,0,0,0,0,0,0,0,0,-1000,0,0,0,0,1000,-1000,-1000
059470,華新科元大99購16,0,0,0,0,0,0,0,0,0,-1000,0,0,0,0,1000,-1000,-1000
059234,台灣50凱基9C購03,0,0,0,0,0,0,0,0,0,-1000,0,0,0,0,1000,-1000,-1000
059242,南亞科凱基99購06,0,0,0,0,0,0,0,0,0,-1000,0,0,0,0,1000,-1000,-1000
059196,聯發科永豐99購02,0,0,0,0,0,0,0,0,0,-1000,0,0,0,84000,85000,-1000,-1000
059148,百和國票9A購01  ,0,0,0,0,0,0,0,0,0,-1000,0,0,0,3000,4000,-1000,-1000
2115,六暉-KY         ,0,1000,-1000,0,0,0,0,0,0,0,0,0,0,0,0,0,-1000
1583,程泰            ,0,1000,-1000,0,0,0,0,0,0,0,0,0,0,0,0,0,-1000
1324,地球            ,0,1000,-1000,0,0,0,0,0,0,0,0,0,0,0,0,0,-1000
1341,富林-KY         ,0,1000,-1000,0,0,0,0,0,0,0,0,0,0,0,0,0,-1000
2495,普安            ,71000,72000,-1000,0,0,0,0,0,0,0,0,0,0,0,0,0,-1000
2424,隴華            ,0,1000,-1000,0,0,0,0,0,0,0,0,0,0,0,0,0,-1000
2901,欣欣            ,1000,2000,-1000,0,0,0,0,0,0,0,0,0,0,0,0,0,-1000
3054,立萬利          ,0,1000,-1000,0,0,0,0,0,0,0,0,0,0,0,0,0,-1000
07472P,和碩元大9A售03  ,0,50000,-50000,0,0,0,0,0,0,49000,0,0,0,50000,1000,49000,-1000
07582P,臺股指元大9A售45,0,0,0,0,0,0,0,0,0,-1000,0,0,0,0,1000,-1000,-1000
07738P,玉晶光永豐9A售06,0,0,0,0,0,0,0,0,0,-1000,0,0,0,0,1000,-1000,-1000
07679P,台灣50凱基01售10,0,0,0,0,0,0,0,0,0,-1000,0,0,0,0,1000,-1000,-1000
07682P,聯發科凱基9A售15,0,0,0,0,0,0,0,0,0,-1000,0,0,0,0,1000,-1000,-1000
07307P,上証2X凱基9A售02,0,0,0,0,0,0,0,0,0,-1000,0,0,0,0,1000,-1000,-1000
07278P,台灣50元富9C售03,0,0,0,0,0,0,0,0,0,-1000,0,0,0,0,1000,-1000,-1000
07262P,台灣50元大9B售05,0,0,0,0,0,0,0,0,0,-1000,0,0,0,0,1000,-1000,-1000
07179P,臺股指凱基99售21,0,0,0,0,0,0,0,0,0,-1000,0,0,0,0,1000,-1000,-1000
07221P,臺股指中信9B售04,0,0,0,0,0,0,0,0,0,-1000,0,0,0,0,1000,-1000,-1000
07034P,大立光元富99售03,0,0,0,0,0,0,0,0,0,-1000,0,0,0,0,1000,-1000,-1000
07058P,台積電凱基9A售07,0,0,0,0,0,0,0,0,0,-1000,0,0,0,0,1000,-1000,-1000
4764,雙鍵            ,0,1000,-1000,0,0,0,0,0,0,0,0,0,0,0,0,0,-1000
4807,日成-KY         ,0,1000,-1000,0,0,0,0,0,0,0,0,0,0,0,0,0,-1000
6641,基士德-KY       ,0,1000,-1000,0,0,0,0,0,0,0,0,0,0,0,0,0,-1000
8443,阿瘦            ,0,1000,-1000,0,0,0,0,0,0,0,0,0,0,0,0,0,-1000
8466,美吉吉-KY       ,0,1000,-1000,0,0,0,0,0,0,0,0,0,0,0,0,0,-1000
00743,國泰中國A150    ,0,0,0,0,0,0,0,0,0,-1442,0,0,0,3000,4442,-1442,-1442
059783,旺宏元大99購17  ,0,0,0,0,0,0,0,0,0,-2000,0,0,0,0,2000,-2000,-2000
059788,華新科元大9A購05,0,0,0,0,0,0,0,0,0,-2000,0,0,0,0,2000,-2000,-2000
059854,台表科永豐99購03,0,0,0,0,0,0,0,0,0,-2000,0,0,0,5000,7000,-2000,-2000
059596,大立光元大99購20,0,0,0,0,0,0,0,0,0,-2000,0,0,0,0,2000,-2000,-2000
059734,T50正2元富99購05,0,0,0,0,0,0,0,0,0,-2000,0,0,0,0,2000,-2000,-2000
060129,祥碩永豐99購03  ,0,0,0,0,0,0,0,0,0,-2000,0,0,0,0,2000,-2000,-2000
060040,康控國票99購04  ,0,0,0,0,0,0,0,0,0,-2000,0,0,0,12000,14000,-2000,-2000
060052,宏碁凱基99購01  ,0,0,0,0,0,0,0,0,0,-2000,0,0,0,18000,20000,-2000,-2000
059949,啟碁永豐99購01  ,0,0,0,0,0,0,0,0,0,-2000,0,0,0,10000,12000,-2000,-2000
060268,台灣50元大9C購20,0,0,0,0,0,0,0,0,0,-2000,0,0,0,0,2000,-2000,-2000
060345,聯發科統一9B購05,0,0,0,0,0,0,0,0,0,-2000,0,0,0,0,2000,-2000,-2000
060595,台灣50凱基04購04,0,0,0,0,0,0,0,0,0,-2000,0,0,0,0,2000,-2000,-2000
060520,臺指2X中信01購02,0,0,0,0,0,0,0,0,0,-2000,0,0,0,2000,4000,-2000,-2000
060895,華新科凱基9B購05,0,0,0,0,0,0,0,0,0,-2000,0,0,0,0,2000,-2000,-2000
060669,上証2X元大9A購03,0,0,0,0,0,0,0,0,0,-2000,0,0,0,0,2000,-2000,-2000
060738,矽格統一9C購01  ,0,0,0,0,0,0,0,0,0,-2000,0,0,0,0,2000,-2000,-2000
061282,台積電統一9C購06,0,0,0,0,0,0,0,0,0,-2000,0,0,0,0,2000,-2000,-2000
061468,神達群益9A購01  ,0,0,0,0,0,0,0,0,0,-2000,0,0,0,0,2000,-2000,-2000
061512,國巨永豐9A購04  ,0,0,0,0,0,0,0,0,0,-2000,0,0,0,159000,161000,-2000,-2000
060985,聯發科元大9A購06,0,0,0,0,0,0,0,0,0,-2000,0,0,0,8000,10000,-2000,-2000
060987,華新科元大9A購11,0,0,0,0,0,0,0,0,0,-2000,0,0,0,53000,55000,-2000,-2000
061149,華通群益9A購05  ,0,0,0,0,0,0,0,0,0,-2000,0,0,0,130000,132000,-2000,-2000
061115,電子類元大9A購02,0,0,0,0,0,0,0,0,0,-2000,0,0,0,0,2000,-2000,-2000
06745P,台積電群益98售05,0,0,0,0,0,0,0,0,0,-2000,0,0,0,0,2000,-2000,-2000
06869P,金融類元大99售01,0,0,0,0,0,0,0,0,0,-2000,0,0,0,0,2000,-2000,-2000
06950P,鴻海統一9B售02  ,0,0,0,0,0,0,0,0,0,-2000,0,0,0,8000,10000,-2000,-2000
06543P,鴻海元大98售08  ,0,0,0,0,0,0,0,0,0,-2000,0,0,0,75000,77000,-2000,-2000
06687P,A50正2中信9A售01,0,0,0,0,0,0,0,0,0,-2000,0,0,0,0,2000,-2000,-2000
06635P,聯發科凱基98售15,0,0,0,0,0,0,0,0,0,-2000,0,0,0,0,2000,-2000,-2000
061720,智邦國泰9C購01  ,0,0,0,0,0,0,0,0,0,-2000,0,0,0,0,2000,-2000,-2000
06446P,大立光凱基98售10,0,0,0,0,0,0,0,0,0,-2000,0,0,0,0,2000,-2000,-2000
06428P,國巨元大97售17  ,0,0,0,0,0,0,0,0,0,-2000,0,0,0,345000,347000,-2000,-2000
06244P,智易元富97售02  ,0,0,0,0,0,0,0,0,0,-2000,0,0,0,0,2000,-2000,-2000
061724,訊芯永豐9A購01  ,0,0,0,0,0,0,0,0,0,-2000,0,0,0,0,2000,-2000,-2000
061773,和潤元大9B購01  ,0,0,0,0,0,0,0,0,0,-2000,0,0,0,0,2000,-2000,-2000
00742,新光內需收益    ,0,0,0,0,0,0,0,0,0,-2000,0,0,0,101000,103000,-2000,-2000
020004,兆豐電菁英30N   ,0,0,0,0,0,0,0,0,0,-2000,0,0,0,0,2000,-2000,-2000
03049X,元展46          ,0,0,0,0,0,0,0,0,0,-2000,0,0,0,0,2000,-2000,-2000
049251,國巨元大95購02  ,0,0,0,0,0,0,0,0,0,-2000,0,0,0,5000,7000,-2000,-2000
049200,元黃金群益98購01,0,0,0,0,0,0,0,0,0,-2000,0,0,0,0,2000,-2000,-2000
049636,上証反凱基9A購01,0,0,0,0,0,0,0,0,0,-2000,0,0,0,0,2000,-2000,-2000
049706,世紀鋼元大95購02,0,0,0,0,0,0,0,0,0,-2000,0,0,0,0,2000,-2000,-2000
052578,大立光統一97購01,0,0,0,0,0,0,0,0,0,-2000,0,0,0,0,2000,-2000,-2000
052072,健策統一95購02  ,0,0,0,0,0,0,0,0,0,-2000,0,0,0,0,2000,-2000,-2000
05487P,台表科凱基95售02,0,0,0,0,0,0,0,0,0,-2000,0,0,0,0,2000,-2000,-2000
050252,聯發科國泰95購01,0,0,0,0,0,0,0,0,0,-2000,0,0,0,0,2000,-2000,-2000
052696,玉晶光麥證97購01,0,0,0,11000,7000,4000,0,0,0,-2000,0,0,0,16000,18000,-2000,-2000
05272P,臻鼎中信97售03  ,0,0,0,0,0,0,0,0,0,-2000,0,0,0,20000,22000,-2000,-2000
052676,聯發科永昌98購01,0,0,0,0,0,0,0,0,0,-2000,0,0,0,0,2000,-2000,-2000
052025,國巨群益96購01  ,0,0,0,0,0,0,0,0,0,-2000,0,0,0,27000,29000,-2000,-2000
051846,S&P反1中信96購02,0,0,0,0,0,0,0,0,0,-2000,0,0,0,0,2000,-2000,-2000
05102P,臺股指凱基96售09,0,0,0,0,0,0,0,0,0,-2000,0,0,0,0,2000,-2000,-2000
051508,元黃金中信97購01,0,0,0,0,0,0,0,0,0,-2000,0,0,0,0,2000,-2000,-2000
051560,玉晶光國泰97購03,0,0,0,0,0,0,0,0,0,-2000,0,0,0,2000,4000,-2000,-2000
051727,S&P反1國票97購01,0,0,0,0,0,0,0,0,0,-2000,0,0,0,8000,10000,-2000,-2000
05172P,臺股指元大95售16,0,0,0,0,0,0,0,0,0,-2000,0,0,0,0,2000,-2000,-2000
056796,國巨麥證98購02  ,0,0,0,7000,9000,-2000,0,0,0,-2000,0,0,0,7000,9000,-2000,-2000
05676P,欣興群益96售04  ,0,0,0,0,0,0,0,0,0,-2000,0,0,0,0,2000,-2000,-2000
054292,欣興元大96購06  ,0,0,0,0,0,0,0,0,0,-2000,0,0,0,0,2000,-2000,-2000
054169,上緯控凱基98購01,0,0,0,0,0,0,0,0,0,-2000,0,0,0,0,2000,-2000,-2000
054563,泰碩群益99購01  ,0,0,0,0,0,0,0,0,0,-2000,0,0,0,11000,13000,-2000,-2000
054509,上証反元大99購01,0,0,0,0,0,0,0,0,0,-2000,0,0,0,0,2000,-2000,-2000
054511,香港反元大98購01,0,0,0,0,0,0,0,0,0,-2000,0,0,0,0,2000,-2000,-2000
055157,晶豪科元大97購01,0,0,0,0,0,0,0,0,0,-2000,0,0,0,0,2000,-2000,-2000
055133,致新康和97購01  ,0,0,0,0,0,0,0,0,0,-2000,0,0,0,0,2000,-2000,-2000
055103,南港凱基97購01  ,0,0,0,0,0,0,0,0,0,-2000,0,0,0,0,2000,-2000,-2000
054017,茂林永豐96購02  ,0,0,0,0,0,0,0,0,0,-2000,0,0,0,0,2000,-2000,-2000
053979,健策元大98購01  ,0,0,0,0,0,0,0,0,0,-2000,0,0,0,3000,5000,-2000,-2000
053458,聯詠國泰97購01  ,0,0,0,0,0,0,0,0,0,-2000,0,0,0,0,2000,-2000,-2000
05305P,華新科國泰97售01,0,0,0,0,0,0,0,0,0,-2000,0,0,0,0,2000,-2000,-2000
053049,T50反1國票98購01,0,0,0,0,0,0,0,0,0,-2000,0,0,0,0,2000,-2000,-2000
053929,正文國票97購01  ,0,0,0,0,0,0,0,0,0,-2000,0,0,0,58000,60000,-2000,-2000
052980,上銀元大96購03  ,0,0,0,0,0,0,0,0,0,-2000,0,0,0,13000,15000,-2000,-2000
053891,欣興群益98購01  ,0,0,0,0,0,0,0,0,0,-2000,0,0,0,2000,4000,-2000,-2000
059138,台積電兆豐99購04,0,0,0,0,0,0,0,0,0,-2000,0,0,0,0,2000,-2000,-2000
059140,大立光兆豐9A購02,0,0,0,0,0,0,0,0,0,-2000,0,0,0,0,2000,-2000,-2000
059482,貿聯群益99購05  ,0,0,0,0,0,0,0,0,0,-2000,0,0,0,0,2000,-2000,-2000
059342,聯發科凱基9A購05,0,0,0,0,0,0,0,0,0,-2000,0,0,0,0,2000,-2000,-2000
059413,台灣50元大99購05,0,0,0,0,0,0,0,0,0,-2000,0,0,0,0,2000,-2000,-2000
057174,南亞科元大98購05,0,0,0,0,0,0,0,0,0,-2000,0,0,0,0,2000,-2000,-2000
056261,台積電統一97購07,0,0,0,0,0,0,0,0,0,-2000,0,0,0,0,2000,-2000,-2000
057601,中磊群益98購01  ,0,0,0,0,0,0,0,0,0,-2000,0,0,0,98000,100000,-2000,-2000
056435,台積電凱基98購09,0,0,0,0,0,0,0,0,0,-2000,0,0,0,0,2000,-2000,-2000
056495,泰鼎國泰99購01  ,0,0,0,0,0,0,0,0,0,-2000,0,0,0,0,2000,-2000,-2000
057097,致新元富98購01  ,0,0,0,0,0,0,0,0,0,-2000,0,0,0,0,2000,-2000,-2000
056597,宏碁元富98購01  ,0,0,0,0,0,0,0,0,0,-2000,0,0,0,0,2000,-2000,-2000
058747,友達凱基9A購03  ,0,0,0,0,0,0,0,0,0,-2000,0,0,0,0,2000,-2000,-2000
058985,可成凱基99購03  ,0,0,0,0,0,0,0,0,0,-2000,0,0,0,10000,12000,-2000,-2000
057315,台灣50康和9A購03,0,0,0,0,0,0,0,0,0,-2000,0,0,0,0,2000,-2000,-2000
057504,技嘉麥證98購01  ,0,0,0,1000,3000,-2000,0,0,0,-2000,0,0,0,1000,3000,-2000,-2000
057371,可成元大98購08  ,0,0,0,0,0,0,0,0,0,-2000,0,0,0,10000,12000,-2000,-2000
058578,聯發科群益99購03,0,0,0,0,0,0,0,0,0,-2000,0,0,0,8000,10000,-2000,-2000
058591,台灣50統一9B購02,0,0,0,0,0,0,0,0,0,-2000,0,0,0,48000,50000,-2000,-2000
055738,玉山金元富97購01,0,0,0,0,0,0,0,0,0,-2000,0,0,0,0,2000,-2000,-2000
055729,金寶元富99購01  ,0,0,0,0,0,0,0,0,0,-2000,0,0,0,0,2000,-2000,-2000
056162,祥碩凱基97購03  ,0,0,0,0,0,0,0,0,0,-2000,0,0,0,0,2000,-2000,-2000
055584,國巨元大97購11  ,0,0,0,0,0,0,0,0,0,-2000,0,0,0,2000,4000,-2000,-2000
057042,台積電元大98購10,0,0,0,0,0,0,0,0,0,-2000,0,0,0,0,2000,-2000,-2000
056413,上証反中信9A購01,0,0,0,0,0,0,0,0,0,-2000,0,0,0,0,2000,-2000,-2000
058016,智邦凱基98購06  ,0,0,0,0,0,0,0,0,0,-2000,0,0,0,0,2000,-2000,-2000
05814P,臺股指國票96售07,0,0,0,0,0,0,0,0,0,-2000,0,0,0,3000,5000,-2000,-2000
055996,矽力國泰99購01  ,0,0,0,0,0,0,0,0,0,-2000,0,0,0,0,2000,-2000,-2000
058545,義隆富邦9C購01  ,0,0,0,0,0,0,0,0,0,-2000,0,0,0,6000,8000,-2000,-2000
056876,群創凱基98購11  ,0,0,0,0,0,0,0,0,0,-2000,0,0,0,0,2000,-2000,-2000
05766P,A50正2凱基99售01,0,0,0,0,0,0,0,0,0,-2000,0,0,0,0,2000,-2000,-2000
8222,寶一            ,9000,11000,-2000,0,0,0,0,0,0,0,0,0,0,0,0,0,-2000
910322,康師傅-DR       ,0,2000,-2000,0,0,0,0,0,0,0,0,0,0,0,0,0,-2000
9929,秋雨            ,0,2000,-2000,0,0,0,0,0,0,0,0,0,0,0,0,0,-2000
5484,慧友            ,0,1000,-1000,0,0,0,0,0,0,-1000,0,1000,-1000,0,0,0,-2000
5906,台南-KY         ,2000,4000,-2000,0,0,0,0,0,0,0,0,0,0,0,0,0,-2000
6133,金橋            ,0,2000,-2000,0,0,0,0,0,0,0,0,0,0,0,0,0,-2000
4977,眾達-KY         ,425000,307000,118000,0,0,0,188000,326000,-138000,18000,20000,1000,19000,0,1000,-1000,-2000
3296,勝德            ,0,2000,-2000,0,0,0,0,0,0,0,0,0,0,0,0,0,-2000
07120P,聯發科凱基99售09,0,0,0,0,0,0,0,0,0,-2000,0,0,0,0,2000,-2000,-2000
07213P,聯發科凱基99售15,0,0,0,0,0,0,0,0,0,-2000,0,0,0,0,2000,-2000,-2000
07135P,臺股指元大9A售29,0,0,0,0,0,0,0,0,0,-2000,0,0,0,0,2000,-2000,-2000
07136P,T50反1台新01售01,0,0,0,0,0,0,0,0,0,-2000,0,0,0,0,2000,-2000,-2000
07145P,為升元大99售03  ,0,0,0,0,0,0,0,0,0,-2000,0,0,0,0,2000,-2000,-2000
07264P,台積電元大99售38,0,0,0,0,0,0,0,0,0,-2000,0,0,0,6000,8000,-2000,-2000
07394P,國巨群益99售12  ,0,0,0,0,0,0,0,0,0,-2000,0,0,0,208000,210000,-2000,-2000
2722,夏都            ,0,2000,-2000,0,0,0,0,0,0,0,0,0,0,0,0,0,-2000
2438,翔耀            ,0,2000,-2000,0,0,0,0,0,0,0,0,0,0,0,0,0,-2000
2440,太空梭          ,0,2000,-2000,0,0,0,0,0,0,0,0,0,0,0,0,0,-2000
2509,全坤建          ,0,2000,-2000,0,0,0,0,0,0,0,0,0,0,0,0,0,-2000
1456,怡華            ,0,2000,-2000,0,0,0,0,0,0,0,0,0,0,0,0,0,-2000
2024,志聯            ,0,2000,-2000,0,0,0,0,0,0,0,0,0,0,0,0,0,-2000
1617,榮星            ,0,2000,-2000,0,0,0,0,0,0,0,0,0,0,0,0,0,-2000
1724,台硝            ,0,1000,-1000,0,0,0,0,0,0,-1000,0,1000,-1000,0,0,0,-2000
1776,展宇            ,0,2000,-2000,0,0,0,0,0,0,0,0,0,0,0,0,0,-2000
1734,杏輝            ,144000,146000,-2000,0,0,0,0,0,0,0,0,0,0,0,0,0,-2000
061745,南電凱基9B購02  ,0,0,0,0,0,0,0,0,0,-3000,0,0,0,0,3000,-3000,-3000
06214P,國巨國票98售04  ,0,0,0,0,0,0,0,0,0,-3000,0,0,0,220000,223000,-3000,-3000
06469P,臺股指凱基99售09,0,0,0,0,0,0,0,0,0,-3000,0,0,0,0,3000,-3000,-3000
061690,旺宏群益9A購05  ,0,0,0,0,0,0,0,0,0,-3000,0,0,0,15000,18000,-3000,-3000
06696P,台灣50國票99售01,0,0,0,0,0,0,0,0,0,-3000,0,0,0,0,3000,-3000,-3000
06487P,聯發科統一99售02,0,0,0,0,0,0,0,0,0,-3000,0,0,0,100000,103000,-3000,-3000
061466,創意群益9A購01  ,0,0,0,0,0,0,0,0,0,-3000,0,0,0,133000,136000,-3000,-3000
061461,元金2X群益9A購01,0,0,0,0,0,0,0,0,0,-3000,0,0,0,0,3000,-3000,-3000
060514,南電元大9A購02  ,0,0,0,0,0,0,0,0,0,-3000,0,0,0,1000,4000,-3000,-3000
060408,和潤國泰9C購01  ,0,0,0,0,0,0,0,0,0,-3000,0,0,0,6000,9000,-3000,-3000
060289,京元電元大9A購01,0,0,0,0,0,0,0,0,0,-3000,0,0,0,0,3000,-3000,-3000
060054,華新科凱基9B購04,0,0,0,0,0,0,0,0,0,-3000,0,0,0,0,3000,-3000,-3000
060036,上証2X國票99購03,0,0,0,0,0,0,0,0,0,-3000,0,0,0,0,3000,-3000,-3000
060012,電子類群益99購02,0,0,0,0,0,0,0,0,0,-3000,0,0,0,1000,4000,-3000,-3000
060148,臺股指國票9A購08,0,0,0,0,0,0,0,0,0,-3000,0,0,0,0,3000,-3000,-3000
059709,上証2X元大9C購01,0,0,0,0,0,0,0,0,0,-3000,0,0,0,0,3000,-3000,-3000
059657,華通元大99購09  ,0,0,0,0,0,0,0,0,0,-3000,0,0,0,3000,6000,-3000,-3000
059561,滬深2X凱基9C購05,0,0,0,0,0,0,0,0,0,-3000,0,0,0,0,3000,-3000,-3000
054925,神達凱基97購01  ,0,0,0,0,0,0,0,0,0,-3000,0,0,0,0,3000,-3000,-3000
054936,鴻海元大97購10  ,0,0,0,0,0,0,0,0,0,-3000,0,0,0,0,3000,-3000,-3000
055130,京鼎康和97購01  ,0,0,0,0,0,0,0,0,0,-3000,0,0,0,0,3000,-3000,-3000
054532,強茂國泰98購01  ,0,0,0,0,0,0,0,0,0,-3000,0,0,0,0,3000,-3000,-3000
054575,聯鈞元大97購01  ,0,0,0,0,0,0,0,0,0,-3000,0,0,0,0,3000,-3000,-3000
054130,漢唐元大97購02  ,0,0,0,0,0,0,0,0,0,-3000,0,0,0,0,3000,-3000,-3000
05171P,臺股指元大95售15,0,0,0,0,0,0,0,0,0,-3000,0,0,0,0,3000,-3000,-3000
051849,旺宏中信98購01  ,0,0,0,0,0,0,0,0,0,-3000,0,0,0,17000,20000,-3000,-3000
051999,勤誠元大95購01  ,0,0,0,0,0,0,0,0,0,-3000,0,0,0,0,3000,-3000,-3000
050232,奇鋐麥證95購01  ,0,0,0,80000,83000,-3000,0,0,0,-3000,0,0,0,80000,83000,-3000,-3000
050634,華新科群益96購01,0,0,0,0,0,0,0,0,0,-3000,0,0,0,0,3000,-3000,-3000
054697,凌華永豐97購01  ,0,0,0,0,0,0,0,0,0,-3000,0,0,0,0,3000,-3000,-3000
053645,臺股指國票96購08,0,0,0,0,0,0,0,0,0,-3000,0,0,0,0,3000,-3000,-3000
053664,臺股指凱基96購25,0,0,0,0,0,0,0,0,0,-3000,0,0,0,0,3000,-3000,-3000
036084,台灣50台新98購01,0,0,0,0,0,0,0,0,0,-3000,0,0,0,290000,293000,-3000,-3000
03810P,大立光富邦98售01,0,0,0,0,0,0,0,0,0,-3000,0,0,0,0,3000,-3000,-3000
058368,奇鋐凱基9A購01  ,0,0,0,0,0,0,0,0,0,-3000,0,0,0,6000,9000,-3000,-3000
05606P,TPK國票97售02   ,0,0,0,0,0,0,0,0,0,-3000,0,0,0,8000,11000,-3000,-3000
058116,正崴中信99購02  ,0,0,0,0,0,0,0,0,0,-3000,0,0,0,17000,20000,-3000,-3000
058162,上銀日盛9B購01  ,0,0,0,0,0,0,0,0,0,-3000,0,0,0,0,3000,-3000,-3000
055558,大立光凱基97購08,0,0,0,0,0,0,0,0,0,-3000,0,0,0,0,3000,-3000,-3000
058718,台灣50元富03購01,0,0,0,0,0,0,0,0,0,-3000,0,0,0,34000,37000,-3000,-3000
05860P,旺宏康和96售01  ,0,0,0,0,0,0,0,0,0,-3000,0,0,0,0,3000,-3000,-3000
057563,旭富國泰9A購01  ,0,0,0,0,0,0,0,0,0,-3000,0,0,0,9000,12000,-3000,-3000
057558,致新凱基98購01  ,0,0,0,0,0,0,0,0,0,-3000,0,0,0,51000,54000,-3000,-3000
057331,台積電國票99購04,0,0,0,0,0,0,0,0,0,-3000,0,0,0,0,3000,-3000,-3000
057349,聯發科統一98購04,0,0,0,0,0,0,0,0,0,-3000,0,0,0,0,3000,-3000,-3000
058988,大立光凱基9A購02,0,0,0,0,0,0,0,0,0,-3000,0,0,0,37000,40000,-3000,-3000
058990,GIS凱基99購02   ,0,0,0,0,0,0,0,0,0,-3000,0,0,0,41000,44000,-3000,-3000
056632,鴻海永昌98購01  ,0,0,0,0,0,0,0,0,0,-3000,0,0,0,0,3000,-3000,-3000
057222,鴻海國票99購04  ,0,0,0,0,0,0,0,0,0,-3000,0,0,0,48000,51000,-3000,-3000
056277,上銀富邦99購02  ,0,0,0,0,0,0,0,0,0,-3000,0,0,0,33000,36000,-3000,-3000
059082,華通元大99購06  ,0,0,0,0,0,0,0,0,0,-3000,0,0,0,5000,8000,-3000,-3000
059405,台灣50國票01購01,0,0,0,0,0,0,0,0,0,-3000,0,0,0,0,3000,-3000,-3000
059340,鴻海凱基9A購12  ,0,0,0,0,0,0,0,0,0,-3000,0,0,0,0,3000,-3000,-3000
059500,鴻海元富99購11  ,0,0,0,0,0,0,0,0,0,-3000,0,0,0,0,3000,-3000,-3000
2236,百達-KY         ,0,3000,-3000,0,0,0,0,0,0,0,0,0,0,0,0,0,-3000
1453,大將            ,3000,6000,-3000,0,0,0,0,0,0,0,0,0,0,0,0,0,-3000
1454,台富            ,2000,4000,-2000,0,0,0,0,0,0,-1000,0,1000,-1000,0,0,0,-3000
1535,中宇            ,1000,4000,-3000,0,0,0,0,0,0,0,0,0,0,0,0,0,-3000
1110,東泥            ,0,3000,-3000,0,0,0,0,0,0,0,0,0,0,0,0,0,-3000
1219,福壽            ,0,3000,-3000,0,0,0,0,0,0,0,0,0,0,0,0,0,-3000
1233,天仁            ,1000,4000,-3000,0,0,0,0,0,0,0,0,0,0,0,0,0,-3000
2611,志信            ,0,3000,-3000,0,0,0,0,0,0,0,0,0,0,0,0,0,-3000
07239P,台灣50國票9A售04,0,0,0,0,0,0,0,0,0,-3000,0,0,0,1000,4000,-3000,-3000
07765P,台積電群益9A售06,0,0,0,0,0,0,0,0,0,-3000,0,0,0,21000,24000,-3000,-3000
07503P,禾伸堂元大9A售01,0,0,0,0,0,0,0,0,0,-3000,0,0,0,0,3000,-3000,-3000
3432,台端            ,0,2000,-2000,0,0,0,0,0,0,-1000,0,1000,-1000,0,0,0,-3000
3416,融程電          ,1000,4000,-3000,0,0,0,0,0,0,0,0,0,0,0,0,0,-3000
6464,台數科          ,0,3000,-3000,0,0,0,0,0,0,0,0,0,0,0,0,0,-3000
9906,欣巴巴          ,0,3000,-3000,0,0,0,0,0,0,0,0,0,0,0,0,0,-3000
8104,錸寶            ,22000,24000,-2000,0,0,0,0,0,0,-1000,0,1000,-1000,0,0,0,-3000
8411,福貞-KY         ,0,0,0,0,0,0,0,0,0,-3000,0,3000,-3000,0,0,0,-3000
8374,羅昇            ,3000,6000,-3000,0,0,0,0,0,0,0,0,0,0,0,0,0,-3000
059554,台灣50凱基99購08,0,0,0,0,0,0,0,0,0,-4000,0,0,0,0,4000,-4000,-4000
059874,大立光凱基99購15,0,0,0,0,0,0,0,0,0,-4000,0,0,0,0,4000,-4000,-4000
059881,臺股指凱基99購46,0,0,0,0,0,0,0,0,0,-4000,0,0,0,0,4000,-4000,-4000
059761,國巨永豐99購06  ,0,0,0,0,0,0,0,0,0,-4000,0,0,0,213000,217000,-4000,-4000
060292,聯詠元大9A購01  ,0,0,0,0,0,0,0,0,0,-4000,0,0,0,143000,147000,-4000,-4000
060351,滬深2X元富9A購01,0,0,0,0,0,0,0,0,0,-4000,0,0,0,40000,44000,-4000,-4000
060552,群創凱基9B購05  ,0,0,0,0,0,0,0,0,0,-4000,0,0,0,0,4000,-4000,-4000
060898,世芯凱基9A購03  ,0,0,0,0,0,0,0,0,0,-4000,0,0,0,6000,10000,-4000,-4000
060769,國巨麥證9A購02  ,0,0,0,4000,8000,-4000,0,0,0,-4000,0,0,0,4000,8000,-4000,-4000
061026,南電富邦9B購01  ,0,0,0,0,0,0,0,0,0,-4000,0,0,0,22000,26000,-4000,-4000
06684P,緯穎元大98售06  ,0,0,0,0,0,0,0,0,0,-4000,0,0,0,0,4000,-4000,-4000
06746P,聯發科群益99售02,0,0,0,0,0,0,0,0,0,-4000,0,0,0,0,4000,-4000,-4000
061694,玉山金群益9A購01,0,0,0,0,0,0,0,0,0,-4000,0,0,0,21000,25000,-4000,-4000
061688,華通群益9A購07  ,0,0,0,0,0,0,0,0,0,-4000,0,0,0,3000,7000,-4000,-4000
061668,信邦中信9B購01  ,0,0,0,0,0,0,0,0,0,-4000,0,0,0,0,4000,-4000,-4000
061582,麗豐元大9A購01  ,0,0,0,0,0,0,0,0,0,-4000,0,0,0,164000,168000,-4000,-4000
06394P,台積電元大97售28,0,0,0,0,0,0,0,0,0,-4000,0,0,0,0,4000,-4000,-4000
052475,滬深2X群益99購06,0,0,0,0,0,0,0,0,0,-4000,0,0,0,0,4000,-4000,-4000
052220,T50反1凱基98購01,0,0,0,0,0,0,0,0,0,-4000,0,0,0,5000,9000,-4000,-4000
052173,廣達元大95購02  ,0,0,0,0,0,0,0,0,0,-4000,0,0,0,22000,26000,-4000,-4000
03052X,元展49          ,0,0,0,0,0,0,0,0,0,-4000,0,0,0,2000,6000,-4000,-4000
00680L,元大美債20正2   ,0,0,0,0,0,0,0,0,0,-4000,0,0,0,5000,9000,-4000,-4000
006203,元大MSCI台灣    ,0,0,0,0,0,0,0,0,0,-4000,0,0,0,2000,6000,-4000,-4000
0054,元大台商50      ,0,0,0,0,0,0,0,0,0,-4000,0,0,0,3000,7000,-4000,-4000
054771,茂林國票98購02  ,0,0,0,0,0,0,0,0,0,-4000,0,0,0,16000,20000,-4000,-4000
053565,台光電富邦98購01,0,0,0,0,0,0,0,0,0,-4000,0,0,0,0,4000,-4000,-4000
052807,貿聯元大98購01  ,0,0,0,0,0,0,0,0,0,-4000,0,0,0,0,4000,-4000,-4000
051911,大立光元大98購02,0,0,0,0,0,0,0,0,0,-4000,0,0,0,15000,19000,-4000,-4000
052060,旺宏國票96購02  ,0,0,0,0,0,0,0,0,0,-4000,0,0,0,0,4000,-4000,-4000
051495,玉晶光第一95購02,0,0,0,0,0,0,0,0,0,-4000,0,0,0,0,4000,-4000,-4000
054201,聯詠富邦97購02  ,0,0,0,0,0,0,0,0,0,-4000,0,0,0,10000,14000,-4000,-4000
054417,牧德元大96購01  ,0,0,0,0,0,0,0,0,0,-4000,0,0,0,0,4000,-4000,-4000
056843,冠德元富98購01  ,0,0,0,0,0,0,0,0,0,-4000,0,0,0,0,4000,-4000,-4000
058360,台光電凱基9A購02,0,0,0,0,0,0,0,0,0,-4000,0,0,0,18000,22000,-4000,-4000
057949,南電國票99購01  ,0,0,0,0,0,0,0,0,0,-4000,0,0,0,18000,22000,-4000,-4000
055304,瑞昱第一98購01  ,0,0,0,0,0,0,0,0,0,-4000,0,0,0,2000,6000,-4000,-4000
059370,玉晶光元富99購02,0,0,0,0,0,0,0,0,0,-4000,0,0,0,194000,198000,-4000,-4000
059167,聯發科凱基99購11,0,0,0,0,0,0,0,0,0,-4000,0,0,0,0,4000,-4000,-4000
059152,臺股指國票99購15,0,0,0,0,0,0,0,0,0,-4000,0,0,0,0,4000,-4000,-4000
058965,祥碩兆豐99購02  ,0,0,0,0,0,0,0,0,0,-4000,0,0,0,0,4000,-4000,-4000
057419,奇力新凱基98購06,0,0,0,0,0,0,0,0,0,-4000,0,0,0,6000,10000,-4000,-4000
058458,牧德永豐9A購01  ,0,0,0,0,0,0,0,0,0,-4000,0,0,0,0,4000,-4000,-4000
058727,嘉晶富邦9A購01  ,0,0,0,0,0,0,0,0,0,-4000,0,0,0,0,4000,-4000,-4000
055679,華通凱基99購01  ,0,0,0,0,0,0,0,0,0,-4000,0,0,0,0,4000,-4000,-4000
055600,致伸元大97購02  ,0,0,0,0,0,0,0,0,0,-4000,0,0,0,0,4000,-4000,-4000
056978,技嘉群益99購01  ,0,0,0,0,0,0,0,0,0,-4000,0,0,0,100000,104000,-4000,-4000
056187,京鼎統一97購01  ,0,0,0,0,0,0,0,0,0,-4000,0,0,0,154000,158000,-4000,-4000
058046,國巨元大9A購01  ,0,0,0,0,0,0,0,0,0,-4000,0,0,0,0,4000,-4000,-4000
058089,聯發科元大98購15,0,0,0,0,0,0,0,0,0,-4000,0,0,0,0,4000,-4000,-4000
057902,嘉晶永豐98購02  ,0,0,0,0,0,0,0,0,0,-4000,0,0,0,1000,5000,-4000,-4000
056892,旺宏元大9A購02  ,0,0,0,0,0,0,0,0,0,-4000,0,0,0,1000,5000,-4000,-4000
6442,光聖            ,0,3000,-3000,0,0,0,0,0,0,-1000,0,1000,-1000,0,0,0,-4000
6201,亞弘電          ,1000,5000,-4000,0,0,0,0,0,0,0,0,0,0,0,0,0,-4000
3257,虹冠電          ,11000,14000,-3000,0,0,0,0,0,0,-1000,0,1000,-1000,0,0,0,-4000
4439,冠星-KY         ,0,4000,-4000,0,0,0,0,0,0,0,0,0,0,0,0,0,-4000
07542P,台積電凱基9A售16,0,0,0,0,0,0,0,0,0,-4000,0,0,0,1000,5000,-4000,-4000
07720P,臺股指群益9A售09,0,0,0,0,0,0,0,0,0,-4000,0,0,0,37000,41000,-4000,-4000
07353P,大立光國票99售02,0,0,0,0,0,0,0,0,0,-4000,0,0,0,0,4000,-4000,-4000
07448P,台灣50元大9A售08,0,0,0,0,0,0,0,0,0,-4000,0,0,0,1000,5000,-4000,-4000
07175P,聯詠凱基99售02  ,0,0,0,0,0,0,0,0,0,-4000,0,0,0,0,4000,-4000,-4000
07169P,臺股指國票99售06,0,0,0,0,0,0,0,0,0,-4000,0,0,0,0,4000,-4000,-4000
07025P,玉晶光凱基99售01,0,0,0,0,0,0,0,0,0,-4000,0,0,0,155000,159000,-4000,-4000
3011,今皓            ,0,4000,-4000,0,0,0,0,0,0,0,0,0,0,0,0,0,-4000
1231,聯華食          ,42000,55000,-13000,0,0,0,0,0,0,9000,9000,0,9000,0,0,0,-4000
1466,聚隆            ,7000,11000,-4000,0,0,0,0,0,0,0,0,0,0,0,0,0,-4000
2101,南港            ,591000,589000,2000,0,0,0,0,0,0,-6000,0,0,0,64000,70000,-6000,-4000
06358P,力成中信97售02  ,0,0,0,0,0,0,0,0,0,-5000,0,0,0,0,5000,-5000,-5000
06245P,健策元富97售03  ,0,0,0,0,0,0,0,0,0,-5000,0,0,0,0,5000,-5000,-5000
061749,群創統一9C購02  ,0,0,0,0,0,0,0,0,0,-5000,0,0,0,0,5000,-5000,-5000
061599,元金反中信9C購01,0,0,0,0,0,0,0,0,0,-5000,0,0,0,0,5000,-5000,-5000
061634,遠東新元大9A購01,0,0,0,0,0,0,0,0,0,-5000,0,0,0,0,5000,-5000,-5000
06793P,臺股指凱基98售03,0,0,0,0,0,0,0,0,0,-5000,0,0,0,0,5000,-5000,-5000
06771P,台灣50中信02售01,0,0,0,0,0,0,0,0,0,-5000,0,0,0,25000,30000,-5000,-5000
06880P,鈺齊凱基98售03  ,0,0,0,0,0,0,0,0,0,-5000,0,0,0,20000,25000,-5000,-5000
06846P,美律元大98售05  ,0,0,0,0,0,0,0,0,0,-5000,0,0,0,0,5000,-5000,-5000
06641P,智邦兆豐99售01  ,0,0,0,0,0,0,0,0,0,-5000,0,0,0,0,5000,-5000,-5000
06497P,大立光凱基98售11,0,0,0,0,0,0,0,0,0,-5000,0,0,0,0,5000,-5000,-5000
06548P,大立光元大98售10,0,0,0,0,0,0,0,0,0,-5000,0,0,0,0,5000,-5000,-5000
060947,台積電統一9C購03,0,0,0,0,0,0,0,0,0,-5000,0,0,0,0,5000,-5000,-5000
061139,玉晶光統一9C購02,0,0,0,0,0,0,0,0,0,-5000,0,0,0,1000,6000,-5000,-5000
061313,滬深2X凱基9B購05,0,0,0,0,0,0,0,0,0,-5000,0,0,0,0,5000,-5000,-5000
061341,華新科元大9A購16,0,0,0,0,0,0,0,0,0,-5000,0,0,0,6000,11000,-5000,-5000
060892,超眾統一9C購01  ,0,0,0,0,0,0,0,0,0,-5000,0,0,0,0,5000,-5000,-5000
060529,聯發科中信9A購04,0,0,0,0,0,0,0,0,0,-5000,0,0,0,84000,89000,-5000,-5000
060517,臺股指元大9B購14,0,0,0,0,0,0,0,0,0,-5000,0,0,0,0,5000,-5000,-5000
060487,盛群富邦9B購01  ,0,0,0,0,0,0,0,0,0,-5000,0,0,0,5000,10000,-5000,-5000
060462,鴻海元大9A購10  ,0,0,0,0,0,0,0,0,0,-5000,0,0,0,0,5000,-5000,-5000
060396,友達國票9A購01  ,0,0,0,0,0,0,0,0,0,-5000,0,0,0,0,5000,-5000,-5000
059920,宏達電元大99購07,0,0,0,0,0,0,0,0,0,-5000,0,0,0,30000,35000,-5000,-5000
059698,滬深2X凱基9A購02,0,0,0,0,0,0,0,0,0,-5000,0,0,0,0,5000,-5000,-5000
060112,祥碩元大99購04  ,0,0,0,0,0,0,0,0,0,-5000,0,0,0,252000,257000,-5000,-5000
059966,台積電凱基99購19,0,0,0,0,0,0,0,0,0,-5000,0,0,0,0,5000,-5000,-5000
055365,華通元大97購03  ,0,0,0,0,0,0,0,0,0,-5000,0,0,0,0,5000,-5000,-5000
055032,億光富邦99購01  ,0,0,0,0,0,0,0,0,0,-5000,0,0,0,8000,13000,-5000,-5000
052839,上海銀國泰97購01,0,0,0,0,0,0,0,0,0,-5000,0,0,0,0,5000,-5000,-5000
053456,大立光元富96購04,0,0,0,0,0,0,0,0,0,-5000,0,0,0,8000,13000,-5000,-5000
054057,晶豪科國票97購01,0,0,0,0,0,0,0,0,0,-5000,0,0,0,31000,36000,-5000,-5000
058310,大立光元大99購10,0,0,0,0,0,0,0,0,0,-5000,0,0,0,5000,10000,-5000,-5000
056752,國巨兆豐98購02  ,0,0,0,0,0,0,0,0,0,-5000,0,0,0,0,5000,-5000,-5000
054296,世芯元大97購01  ,0,0,0,0,0,0,0,0,0,-5000,0,0,0,0,5000,-5000,-5000
054139,揚明光元大96購01,0,0,0,0,0,0,0,0,0,-5000,0,0,0,0,5000,-5000,-5000
052754,上証2X群益9A購01,0,0,0,0,0,0,0,0,0,-5000,0,0,0,30000,35000,-5000,-5000
05088P,大立光富邦99售01,0,0,0,0,0,0,0,0,0,-5000,0,0,0,0,5000,-5000,-5000
050161,鴻海國泰96購03  ,0,0,0,0,0,0,0,0,0,-5000,0,0,0,0,5000,-5000,-5000
05358P,大立光元大95售09,0,0,0,0,0,0,0,0,0,-5000,0,0,0,1000,6000,-5000,-5000
053525,台積電中信96購04,0,0,0,0,0,0,0,0,0,-5000,0,0,0,0,5000,-5000,-5000
05378P,台積電凱基96售02,0,0,0,0,0,0,0,0,0,-5000,0,0,0,0,5000,-5000,-5000
053757,聯發科國泰96購04,0,0,0,0,0,0,0,0,0,-5000,0,0,0,0,5000,-5000,-5000
0057,富邦摩台        ,2000,0,2000,0,0,0,0,0,0,-7000,0,0,0,20000,27000,-7000,-5000
00866,新光Shiller CAPE,0,0,0,0,0,0,0,0,0,-5000,0,0,0,31000,36000,-5000,-5000
00735,國泰臺韓科技    ,0,109000,-109000,0,0,0,0,0,0,104000,0,0,0,105000,1000,104000,-5000
00767,FH美國金融股    ,0,0,0,0,0,0,0,0,0,-5000,0,0,0,0,5000,-5000,-5000
03075X,元展70          ,0,0,0,0,0,0,0,0,0,-5000,0,0,0,0,5000,-5000,-5000
03421B,臺股指元大99熊01,0,0,0,0,0,0,0,0,0,-5000,0,0,0,100000,105000,-5000,-5000
04454P,大立光富邦98售02,0,0,0,0,0,0,0,0,0,-5000,0,0,0,0,5000,-5000,-5000
04287P,A50正2中信96售01,0,0,0,0,0,0,0,0,0,-5000,0,0,0,0,5000,-5000,-5000
049726,道瓊反中信96購01,0,0,0,0,0,0,0,0,0,-5000,0,0,0,8000,13000,-5000,-5000
048892,台郡元富97購01  ,0,0,0,0,0,0,0,0,0,-5000,0,0,0,0,5000,-5000,-5000
052293,泰碩國票95購03  ,0,0,0,0,0,0,0,0,0,-5000,0,0,0,0,5000,-5000,-5000
052299,T50反1台新05購03,0,0,0,0,0,0,0,0,0,-5000,0,0,0,0,5000,-5000,-5000
052383,臺股指元大95購29,0,0,0,0,0,0,0,0,0,-5000,0,0,0,0,5000,-5000,-5000
052446,聯發科元大96購03,0,0,0,0,0,0,0,0,0,-5000,0,0,0,0,5000,-5000,-5000
052519,旺宏元大95購05  ,0,0,0,0,0,0,0,0,0,-5000,0,0,0,0,5000,-5000,-5000
052437,聯發科富邦99購02,0,0,0,0,0,0,0,0,0,-5000,0,0,0,5000,10000,-5000,-5000
052624,微星亞東97購01  ,0,0,0,0,0,0,0,0,0,-5000,0,0,0,0,5000,-5000,-5000
052076,可成元富98購01  ,0,0,0,0,0,0,0,0,0,-5000,0,0,0,10000,15000,-5000,-5000
056918,台積電兆豐98購01,0,0,0,0,0,0,0,0,0,-5000,0,0,0,0,5000,-5000,-5000
057918,旺宏凱基99購01  ,0,0,0,0,0,0,0,0,0,-5000,0,0,0,0,5000,-5000,-5000
057647,欣興元大98購10  ,0,0,0,0,0,0,0,0,0,-5000,0,0,0,93000,98000,-5000,-5000
058840,T50反1群益99購02,0,0,0,0,0,0,0,0,0,-5000,0,0,0,0,5000,-5000,-5000
058510,全新元大9B購02  ,0,0,0,0,0,0,0,0,0,-5000,0,0,0,0,5000,-5000,-5000
058938,台積電中信01購03,0,0,0,0,0,0,0,0,0,-5000,0,0,0,0,5000,-5000,-5000
058490,元黃金群益9B購01,0,0,0,0,0,0,0,0,0,-5000,0,0,0,0,5000,-5000,-5000
058099,鴻海國泰9A購02  ,0,0,0,0,0,0,0,0,0,-5000,0,0,0,0,5000,-5000,-5000
058384,大成鋼中信99購01,0,0,0,0,0,0,0,0,0,-5000,0,0,0,0,5000,-5000,-5000
056049,奇力新國票98購01,0,0,0,0,0,0,0,0,0,-5000,0,0,0,151000,156000,-5000,-5000
056987,南茂群益98購01  ,0,0,0,0,0,0,0,0,0,-5000,0,0,0,288000,293000,-5000,-5000
05614P,臺股指康和96售03,0,0,0,0,0,0,0,0,0,-5000,0,0,0,0,5000,-5000,-5000
057760,聯發科凱基98購18,0,0,0,0,0,0,0,0,0,-5000,0,0,0,0,5000,-5000,-5000
055808,世紀鋼永豐97購01,0,0,0,0,0,0,0,0,0,-5000,0,0,0,0,5000,-5000,-5000
055645,技嘉元富97購01  ,0,0,0,0,0,0,0,0,0,-5000,0,0,0,0,5000,-5000,-5000
057414,華新科日盛9A購01,0,0,0,0,0,0,0,0,0,-5000,0,0,0,0,5000,-5000,-5000
05742P,可成元大96售04  ,0,0,0,0,0,0,0,0,0,-5000,0,0,0,0,5000,-5000,-5000
058975,台灣50凱基01購02,0,0,0,0,0,0,0,0,0,-5000,0,0,0,74000,79000,-5000,-5000
056725,鴻海國票99購03  ,0,0,0,0,0,0,0,0,0,-5000,0,0,0,0,5000,-5000,-5000
057792,群創統一99購01  ,0,0,0,0,0,0,0,0,0,-5000,0,0,0,0,5000,-5000,-5000
057816,欣興元大98購13  ,0,0,0,0,0,0,0,0,0,-5000,0,0,0,0,5000,-5000,-5000
057048,新日興元大98購01,0,0,0,0,0,0,0,0,0,-5000,0,0,0,0,5000,-5000,-5000
057062,立積國泰99購01  ,0,0,0,0,0,0,0,0,0,-5000,0,0,0,40000,45000,-5000,-5000
059212,鴻海元大99購28  ,0,0,0,0,0,0,0,0,0,-5000,0,0,0,71000,76000,-5000,-5000
059317,台積電元大99購34,0,0,0,0,0,0,0,0,0,-5000,0,0,0,0,5000,-5000,-5000
059305,台灣50元大99購02,0,0,0,0,0,0,0,0,0,-5000,0,0,0,0,5000,-5000,-5000
059385,滬深2X凱基9C購03,0,0,0,0,0,0,0,0,0,-5000,0,0,0,0,5000,-5000,-5000
059380,鴻海亞東99購01  ,0,0,0,0,0,0,0,0,0,-5000,0,0,0,0,5000,-5000,-5000
059383,台灣50凱基99購03,0,0,0,0,0,0,0,0,0,-5000,0,0,0,0,5000,-5000,-5000
059463,台灣50元大9C購07,0,0,0,0,0,0,0,0,0,-5000,0,0,0,0,5000,-5000,-5000
059476,道瓊指群益9C購01,0,0,0,0,0,0,0,0,0,-5000,0,0,0,0,5000,-5000,-5000
059503,大立光富邦9B購04,0,0,0,0,0,0,0,0,0,-5000,0,0,0,474000,479000,-5000,-5000
05631P,國巨富邦9A售01  ,0,0,0,0,0,0,0,0,0,-5000,0,0,0,5000,10000,-5000,-5000
058401,華航元大9A購01  ,0,0,0,0,0,0,0,0,0,-5000,0,0,0,0,5000,-5000,-5000
2033,佳大            ,1000,6000,-5000,0,0,0,0,0,0,0,1000,1000,0,0,0,0,-5000
1727,中華化          ,0,5000,-5000,0,0,0,0,0,0,0,0,0,0,0,0,0,-5000
1616,億泰            ,0,5000,-5000,0,0,0,0,0,0,0,0,0,0,0,0,0,-5000
1443,立益            ,0,5000,-5000,0,0,0,0,0,0,0,0,0,0,0,0,0,-5000
1587,吉茂            ,0,4000,-4000,0,0,0,0,0,0,-1000,0,1000,-1000,0,0,0,-5000
1419,新紡            ,2000,5000,-3000,0,0,0,0,0,0,-2000,0,2000,-2000,0,0,0,-5000
1256,鮮活果汁-KY     ,8000,13000,-5000,0,0,0,0,0,0,0,0,0,0,0,0,0,-5000
3021,鴻名            ,3000,7000,-4000,0,0,0,0,0,0,-1000,0,1000,-1000,0,0,0,-5000
2906,高林            ,0,5000,-5000,0,0,0,0,0,0,0,0,0,0,0,0,0,-5000
2462,良得電          ,0,5000,-5000,0,0,0,0,0,0,0,1000,1000,0,0,0,0,-5000
2465,麗臺            ,0,5000,-5000,0,0,0,0,0,0,0,0,0,0,0,0,0,-5000
2426,鼎元            ,220000,222000,-2000,0,0,0,0,0,0,-3000,0,3000,-3000,0,0,0,-5000
07023P,南電永豐99售02  ,0,0,0,0,0,0,0,0,0,-5000,0,0,0,0,5000,-5000,-5000
07016P,聯發科元大99售10,0,0,0,0,0,0,0,0,0,-5000,0,0,0,0,5000,-5000,-5000
06988P,鴻海元富99售09  ,0,0,0,0,0,0,0,0,0,-5000,0,0,0,0,5000,-5000,-5000
07259P,滬深2X國票01售01,0,0,0,0,0,0,0,0,0,-5000,0,0,0,10000,15000,-5000,-5000
07304P,臺股指元大9A售37,0,0,0,0,0,0,0,0,0,-5000,0,0,0,132000,137000,-5000,-5000
07756P,台灣50國票04售01,0,0,0,0,0,0,0,0,0,-5000,0,0,0,0,5000,-5000,-5000
07820P,臺股指國票9A售11,0,0,0,0,0,0,0,0,0,-5000,0,0,0,0,5000,-5000,-5000
07764P,世紀鋼永豐9A售04,0,0,0,0,0,0,0,0,0,-5000,0,0,0,0,5000,-5000,-5000
07877P,晶技永豐9B售01  ,0,0,0,0,0,0,0,0,0,-5000,0,0,0,0,5000,-5000,-5000
07550P,國巨元大9A售09  ,0,0,0,0,0,0,0,0,0,-5000,0,0,0,150000,155000,-5000,-5000
07569P,國巨凱基9A售13  ,0,0,0,0,0,0,0,0,0,-5000,0,0,0,0,5000,-5000,-5000
07600P,台灣50凱基04售06,0,0,0,0,0,0,0,0,0,-5000,0,0,0,0,5000,-5000,-5000
07629P,臺股指凱基9A售10,0,0,0,0,0,0,0,0,0,-5000,0,0,0,5000,10000,-5000,-5000
4755,三福化          ,0,5000,-5000,0,0,0,0,0,0,0,0,0,0,0,0,0,-5000
3164,景岳            ,17000,22000,-5000,0,0,0,0,0,0,0,0,0,0,0,0,0,-5000
5533,皇鼎            ,0,5000,-5000,0,0,0,0,0,0,0,0,0,0,0,0,0,-5000
5283,禾聯碩          ,17000,21000,-4000,0,0,0,0,0,0,-1000,0,0,0,0,1000,-1000,-5000
6283,淳安            ,34000,38000,-4000,0,0,0,0,0,0,-1000,0,1000,-1000,0,0,0,-5000
6405,悅城            ,3000,8000,-5000,0,0,0,0,0,0,0,0,0,0,0,0,0,-5000
6579,研揚            ,0,4000,-4000,0,0,0,0,0,0,-1000,0,1000,-1000,0,0,0,-5000
9926,新海            ,1000,6000,-5000,0,0,0,0,0,0,0,0,0,0,0,0,0,-5000
060075,台積電元富99購05,0,0,0,0,0,0,0,0,0,-6000,0,0,0,5000,11000,-6000,-6000
059591,台積電元大9A購04,0,0,0,0,0,0,0,0,0,-6000,0,0,0,0,6000,-6000,-6000
060334,群光康和9A購01  ,0,0,0,0,0,0,0,0,0,-6000,0,0,0,0,6000,-6000,-6000
061319,聯發科凱基9A購16,0,0,0,0,0,0,0,0,0,-6000,0,0,0,0,6000,-6000,-6000
061264,全新凱基9B購01  ,0,0,0,0,0,0,0,0,0,-6000,0,0,0,20000,26000,-6000,-6000
061551,GIS群益9A購01   ,0,0,0,0,0,0,0,0,0,-6000,0,0,0,26000,32000,-6000,-6000
061522,元黃金凱基01購01,0,0,0,0,0,0,0,0,0,-6000,0,0,0,0,6000,-6000,-6000
061220,臺股指元大9A購57,0,0,0,0,0,0,0,0,0,-6000,0,0,0,0,6000,-6000,-6000
061215,健策元大9A購06  ,0,0,0,0,0,0,0,0,0,-6000,0,0,0,58000,64000,-6000,-6000
060941,台積電國票9B購04,0,0,0,0,0,0,0,0,0,-6000,0,0,0,0,6000,-6000,-6000
06104P,大立光凱基97售04,0,0,0,0,0,0,0,0,0,-6000,0,0,0,0,6000,-6000,-6000
06713P,臺股指富邦99售04,0,0,0,0,0,0,0,0,0,-6000,0,0,0,0,6000,-6000,-6000
061721,道瓊反富邦9B購01,0,0,0,0,0,0,0,0,0,-6000,0,0,0,0,6000,-6000,-6000
061711,台積電凱基9A購27,0,0,0,0,0,0,0,0,0,-6000,0,0,0,0,6000,-6000,-6000
061768,晶技元大9B購02  ,0,0,0,0,0,0,0,0,0,-6000,0,0,0,0,6000,-6000,-6000
06212P,華新科元大97售11,0,0,0,0,0,0,0,0,0,-6000,0,0,0,45000,51000,-6000,-6000
06359P,上銀群益97售03  ,0,0,0,0,0,0,0,0,0,-6000,0,0,0,1000,7000,-6000,-6000
035275,台積電台新97購01,0,0,0,0,0,0,0,0,0,-6000,0,0,0,0,6000,-6000,-6000
044963,台積電中信96購01,0,0,0,0,0,0,0,0,0,-6000,0,0,0,0,6000,-6000,-6000
053639,禾伸堂永豐96購01,0,0,0,0,0,0,0,0,0,-6000,0,0,0,0,6000,-6000,-6000
053489,上銀兆豐97購01  ,0,0,0,0,0,0,0,0,0,-6000,0,0,0,44000,50000,-6000,-6000
054702,智邦第一97購01  ,0,0,0,0,0,0,0,0,0,-6000,0,0,0,0,6000,-6000,-6000
051898,富邦金國泰97購01,0,0,0,0,0,0,0,0,0,-6000,0,0,0,1000,7000,-6000,-6000
054216,聯茂國票97購03  ,0,0,0,0,0,0,0,0,0,-6000,0,0,0,25000,31000,-6000,-6000
055211,A50反1凱基9A購01,0,0,0,0,0,0,0,0,0,-6000,0,0,0,0,6000,-6000,-6000
057962,超眾元大99購03  ,0,0,0,0,0,0,0,0,0,-6000,0,0,0,0,6000,-6000,-6000
055090,國巨群益97購03  ,0,0,0,0,0,0,0,0,0,-6000,0,0,0,53000,59000,-6000,-6000
053250,百和國票97購02  ,0,0,0,0,0,0,0,0,0,-6000,0,0,0,17000,23000,-6000,-6000
055008,隆達元富97購01  ,0,0,0,0,0,0,0,0,0,-6000,0,0,0,5000,11000,-6000,-6000
054990,凌陽元富97購01  ,0,0,0,0,0,0,0,0,0,-6000,0,0,0,0,6000,-6000,-6000
059461,鈺齊永豐99購03  ,0,0,0,0,0,0,0,0,0,-6000,0,0,0,56000,62000,-6000,-6000
059415,台灣50元大9A購03,0,0,0,0,0,0,0,0,0,-6000,0,0,0,0,6000,-6000,-6000
059441,祥碩元大99購02  ,0,0,0,0,0,0,0,0,0,-6000,0,0,0,28000,34000,-6000,-6000
057795,鴻海兆豐99購02  ,0,0,0,0,0,0,0,0,0,-6000,0,0,0,0,6000,-6000,-6000
058785,臺股指國票99購04,0,0,0,0,0,0,0,0,0,-6000,0,0,0,5000,11000,-6000,-6000
058590,南電中信9A購02  ,0,0,0,0,0,0,0,0,0,-6000,0,0,0,10000,16000,-6000,-6000
056401,國巨群益98購07  ,0,0,0,0,0,0,0,0,0,-6000,0,0,0,0,6000,-6000,-6000
058012,鈺齊國票99購01  ,0,0,0,0,0,0,0,0,0,-6000,0,0,0,87000,93000,-6000,-6000
058909,神達元大99購03  ,0,0,0,0,0,0,0,0,0,-6000,0,0,0,8000,14000,-6000,-6000
057689,南亞科凱基99購02,0,0,0,0,0,0,0,0,0,-6000,0,0,0,0,6000,-6000,-6000
6573,虹揚-KY         ,0,5000,-5000,0,0,0,0,0,0,-1000,0,1000,-1000,0,0,0,-6000
6674,鋐寶科技        ,0,6000,-6000,0,0,0,0,0,0,0,0,0,0,0,0,0,-6000
6477,安集            ,15000,21000,-6000,0,0,0,0,0,0,0,0,0,0,0,0,0,-6000
6215,和椿            ,0,6000,-6000,0,0,0,0,0,0,0,0,0,0,0,0,0,-6000
4916,事欣科          ,27000,33000,-6000,0,0,0,0,0,0,0,0,0,0,0,0,0,-6000
4930,燦星網          ,0,6000,-6000,0,0,0,0,0,0,0,0,0,0,0,0,0,-6000
4557,永新-KY         ,0,6000,-6000,0,0,0,0,0,0,0,0,0,0,0,0,0,-6000
07775P,國巨群益9A售10  ,0,0,0,0,0,0,0,0,0,-6000,0,0,0,204000,210000,-6000,-6000
07683P,宏達電凱基9A售03,0,0,0,0,0,0,0,0,0,-6000,0,0,0,0,6000,-6000,-6000
07684P,大立光凱基9A售11,0,0,0,0,0,0,0,0,0,-6000,0,0,0,0,6000,-6000,-6000
07673P,電子類元大9A售01,0,0,0,0,0,0,0,0,0,-6000,0,0,0,634000,640000,-6000,-6000
07708P,玉晶光元大9A售13,0,0,0,0,0,0,0,0,0,-6000,0,0,0,0,6000,-6000,-6000
07319P,台積電凱基01售02,0,0,0,0,0,0,0,0,0,-6000,0,0,0,56000,62000,-6000,-6000
07218P,臺股指凱基99售31,0,0,0,0,0,0,0,0,0,-6000,0,0,0,216000,222000,-6000,-6000
2496,卓越            ,5000,11000,-6000,0,0,0,0,0,0,0,0,0,0,0,0,0,-6000
2540,愛山林          ,2000,8000,-6000,0,0,0,0,0,0,0,0,0,0,0,0,0,-6000
2613,中櫃            ,0,6000,-6000,0,0,0,0,0,0,0,0,0,0,0,0,0,-6000
2630,亞航            ,3000,9000,-6000,0,0,0,0,0,0,0,0,0,0,0,0,0,-6000
1472,三洋紡          ,15000,21000,-6000,0,0,0,0,0,0,0,0,0,0,0,0,0,-6000
2348,海悅            ,28000,30000,-2000,0,0,0,0,0,0,-4000,0,4000,-4000,0,0,0,-6000
06301P,臺股指元大97售04,0,0,0,0,0,0,0,0,0,-7000,0,0,0,0,7000,-7000,-7000
061615,鴻海群益9A購06  ,0,0,0,0,0,0,0,0,0,-7000,0,0,0,36000,43000,-7000,-7000
06783P,亞光元大98售03  ,0,0,0,0,0,0,0,0,0,-7000,0,0,0,23000,30000,-7000,-7000
061057,華新科國票9A購04,0,0,0,0,0,0,0,0,0,-7000,0,0,0,0,7000,-7000,-7000
061214,華擎元大9A購04  ,0,0,0,0,0,0,0,0,0,-7000,0,0,0,175000,182000,-7000,-7000
061119,國巨永豐9A購03  ,0,0,0,0,0,0,0,0,0,-7000,0,0,0,1000,8000,-7000,-7000
060369,滬深2X元富01購01,0,0,0,0,0,0,0,0,0,-7000,0,0,0,15000,22000,-7000,-7000
060457,中橡元大9A購02  ,0,0,0,0,0,0,0,0,0,-7000,0,0,0,45000,52000,-7000,-7000
060563,智邦富邦9A購01  ,0,0,0,0,0,0,0,0,0,-7000,0,0,0,0,7000,-7000,-7000
060648,鴻海第一9A購01  ,0,0,0,0,0,0,0,0,0,-7000,0,0,0,0,7000,-7000,-7000
059855,緯穎永豐99購04  ,0,0,0,0,0,0,0,0,0,-7000,0,0,0,27000,34000,-7000,-7000
060044,大立光群益99購09,0,0,0,0,0,0,0,0,0,-7000,0,0,0,0,7000,-7000,-7000
060229,楠梓電元大9C購01,0,0,0,0,0,0,0,0,0,-7000,0,0,0,41000,48000,-7000,-7000
060230,台積電元大9A購07,0,0,0,0,0,0,0,0,0,-7000,0,0,0,0,7000,-7000,-7000
053424,欣興永豐96購02  ,0,0,0,0,0,0,0,0,0,-7000,0,0,0,13000,20000,-7000,-7000
058227,台灣50元大9C購01,0,0,0,0,0,0,0,0,0,-7000,0,0,0,0,7000,-7000,-7000
055249,大毅統一99購01  ,0,0,0,0,0,0,0,0,0,-7000,0,0,0,0,7000,-7000,-7000
05087P,GIS國泰96售01   ,0,0,0,0,0,0,0,0,0,-7000,0,0,0,0,7000,-7000,-7000
050754,元金2X元富9B購01,0,0,0,0,0,0,0,0,0,-7000,0,0,0,0,7000,-7000,-7000
052693,微星中信96購01  ,0,0,0,0,0,0,0,0,0,-7000,0,0,0,0,7000,-7000,-7000
051403,玉晶光永豐95購05,0,0,0,0,0,0,0,0,0,-7000,0,0,0,5000,12000,-7000,-7000
051577,台積電元大97購03,0,0,0,0,0,0,0,0,0,-7000,0,0,0,0,7000,-7000,-7000
045189,大立光元富98購01,0,0,0,0,0,0,0,0,0,-7000,0,0,0,3000,10000,-7000,-7000
00731,FH富時高息低波  ,1000,1000,0,0,0,0,0,0,0,-7000,0,0,0,78000,85000,-7000,-7000
03857P,聯發科元富99售02,0,0,0,0,0,0,0,0,0,-7000,0,0,0,0,7000,-7000,-7000
05207P,高股息中信97售03,0,0,0,0,0,0,0,0,0,-7000,0,0,0,0,7000,-7000,-7000
057930,旺宏群益99購04  ,0,0,0,0,0,0,0,0,0,-7000,0,0,0,1000,8000,-7000,-7000
056856,華通群益9A購01  ,0,0,0,0,0,0,0,0,0,-7000,0,0,0,48000,55000,-7000,-7000
058020,大立光凱基99購03,0,0,0,0,0,0,0,0,0,-7000,0,0,0,0,7000,-7000,-7000
058201,華通凱基9A購01  ,0,0,0,0,0,0,0,0,0,-7000,0,0,0,0,7000,-7000,-7000
05818P,大立光凱基96售14,0,0,0,0,0,0,0,0,0,-7000,0,0,0,0,7000,-7000,-7000
056368,祥碩元大98購02  ,0,0,0,0,0,0,0,0,0,-7000,0,0,0,0,7000,-7000,-7000
057735,台灣50富邦9C購02,0,0,0,0,0,0,0,0,0,-7000,0,0,0,0,7000,-7000,-7000
058711,鴻海統一9A購02  ,0,0,0,0,0,0,0,0,0,-7000,0,0,0,0,7000,-7000,-7000
057587,微星國票99購01  ,0,0,0,0,0,0,0,0,0,-7000,0,0,0,0,7000,-7000,-7000
05920P,力成元大96售04  ,0,0,0,0,0,0,0,0,0,-7000,0,0,0,33000,40000,-7000,-7000
059147,矽創國票99購01  ,0,0,0,0,0,0,0,0,0,-7000,0,0,0,51000,58000,-7000,-7000
057605,旺宏統一99購03  ,0,0,0,0,0,0,0,0,0,-7000,0,0,0,15000,22000,-7000,-7000
05722P,玉晶光國票97售03,0,0,0,0,0,0,0,0,0,-7000,0,0,0,1355000,1362000,-7000,-7000
059042,世紀鋼群益99購02,0,0,0,0,0,0,0,0,0,-7000,0,0,0,164000,171000,-7000,-7000
059062,群創凱基99購05  ,0,0,0,0,0,0,0,0,0,-7000,0,0,0,0,7000,-7000,-7000
059027,神達台新99購02  ,0,0,0,0,0,0,0,0,0,-7000,0,0,0,10000,17000,-7000,-7000
2028,威致            ,0,7000,-7000,0,0,0,0,0,0,0,0,0,0,0,0,0,-7000
1558,伸興            ,0,7000,-7000,0,0,0,0,0,0,0,0,0,0,0,0,0,-7000
1423,利華            ,0,7000,-7000,0,0,0,0,0,0,0,0,0,0,0,0,0,-7000
1432,大魯閣          ,0,7000,-7000,0,0,0,0,0,0,0,0,0,0,0,0,0,-7000
2483,百容            ,2000,9000,-7000,0,0,0,0,0,0,0,0,0,0,0,0,0,-7000
07389P,臺股指群益9C售08,0,0,0,0,0,0,0,0,0,-7000,0,0,0,53000,60000,-7000,-7000
07373P,A50正2元大99售01,0,0,0,0,0,0,0,0,0,-7000,0,0,0,16000,23000,-7000,-7000
07719P,臺股指群益9A售08,0,0,0,0,0,0,0,0,0,-7000,0,0,0,117000,124000,-7000,-7000
3528,安馳            ,1000,8000,-7000,0,0,0,0,0,0,0,0,0,0,0,0,0,-7000
8367,建新國際        ,5000,12000,-7000,0,0,0,0,0,0,0,0,0,0,0,0,0,-7000
2888A,新光金甲特      ,0,7869,-7869,0,0,0,0,0,0,0,0,0,0,0,0,0,-7869
059870,全新凱基99購05  ,0,0,0,0,0,0,0,0,0,-8000,0,0,0,2000,10000,-8000,-8000
059588,鴻海元大99購32  ,0,0,0,0,0,0,0,0,0,-8000,0,0,0,2000,10000,-8000,-8000
059728,聯鈞元大99購01  ,0,0,0,0,0,0,0,0,0,-8000,0,0,0,0,8000,-8000,-8000
059632,聯發科凱基01購01,0,0,0,0,0,0,0,0,0,-8000,0,0,0,5000,13000,-8000,-8000
06080P,景碩群益98售02  ,0,0,0,0,0,0,0,0,0,-8000,0,0,0,0,8000,-8000,-8000
060336,南電康和9A購01  ,0,0,0,0,0,0,0,0,0,-8000,0,0,0,0,8000,-8000,-8000
061364,國巨國票9A購09  ,0,0,0,0,0,0,0,0,0,-8000,0,0,0,203000,211000,-8000,-8000
06923P,鴻海群益98售09  ,0,0,0,0,0,0,0,0,0,-8000,0,0,0,0,8000,-8000,-8000
061708,同欣電國票9A購02,0,0,0,0,0,0,0,0,0,-8000,0,0,0,29000,37000,-8000,-8000
061670,台灣50元大9A購20,0,0,0,0,0,0,0,0,0,-8000,0,0,0,0,8000,-8000,-8000
047211,華新科富邦99購01,0,0,0,0,0,0,0,0,0,-8000,0,0,0,4000,12000,-8000,-8000
039212,台達電台新9A購01,0,0,0,0,0,0,0,0,0,-8000,0,0,0,12000,20000,-8000,-8000
052229,奇力新凱基96購01,0,0,0,0,0,0,0,0,0,-8000,0,0,0,40000,48000,-8000,-8000
00728,第一金工業30    ,0,0,0,0,0,0,0,0,0,-8000,0,0,0,335000,343000,-8000,-8000
0055,元大MSCI金融    ,0,0,0,0,0,0,0,0,0,-8000,0,0,0,3000,11000,-8000,-8000
00661,元大日經225     ,0,0,0,0,0,0,0,0,0,-8000,0,0,0,0,8000,-8000,-8000
049946,智邦兆豐95購01  ,0,0,0,0,0,0,0,0,0,-8000,0,0,0,22000,30000,-8000,-8000
04928P,大立光凱基95售07,0,0,0,0,0,0,0,0,0,-8000,0,0,0,0,8000,-8000,-8000
051471,國巨凱基97購01  ,0,0,0,0,0,0,0,0,0,-8000,0,0,0,10000,18000,-8000,-8000
05145P,道瓊反元大98售01,0,0,0,0,0,0,0,0,0,-8000,0,0,0,0,8000,-8000,-8000
05524P,瀚宇博國票97售02,0,0,0,0,0,0,0,0,0,-8000,0,0,0,10000,18000,-8000,-8000
055229,大毅國票97購02  ,0,0,0,0,0,0,0,0,0,-8000,0,0,0,6000,14000,-8000,-8000
054180,亞泥康和96購01  ,0,0,0,0,0,0,0,0,0,-8000,0,0,0,63000,71000,-8000,-8000
054416,禾伸堂元大97購01,0,0,0,0,0,0,0,0,0,-8000,0,0,0,0,8000,-8000,-8000
055911,可成凱基98購02  ,0,0,0,0,0,0,0,0,0,-8000,0,0,0,2000,10000,-8000,-8000
058343,台積電群益99購02,0,0,0,0,0,0,0,0,0,-8000,0,0,0,2000,10000,-8000,-8000
053178,南亞科統一98購01,0,0,0,0,0,0,0,0,0,-8000,0,0,0,0,8000,-8000,-8000
052866,大立光凱基96購12,0,0,0,0,0,0,0,0,0,-8000,0,0,0,0,8000,-8000,-8000
052939,富邦金兆豐96購01,0,0,0,0,0,0,0,0,0,-8000,0,0,0,12000,20000,-8000,-8000
056292,統一元大97購01  ,0,0,0,0,0,0,0,0,0,-8000,0,0,0,0,8000,-8000,-8000
059249,大立光凱基99購05,0,0,0,0,0,0,0,0,0,-8000,0,0,0,0,8000,-8000,-8000
05950P,台積電國票97售04,0,0,0,0,0,0,0,0,0,-8000,0,0,0,20000,28000,-8000,-8000
057530,奇鋐元大99購01  ,0,0,0,0,0,0,0,0,0,-8000,0,0,0,38000,46000,-8000,-8000
057853,旺宏國票99購05  ,0,0,0,0,0,0,0,0,0,-8000,0,0,0,0,8000,-8000,-8000
057111,立積群益98購02  ,0,0,0,0,0,0,0,0,0,-8000,0,0,0,6000,14000,-8000,-8000
057092,健策元富98購01  ,0,0,0,0,0,0,0,0,0,-8000,0,0,0,90000,98000,-8000,-8000
056586,光罩統一98購02  ,0,0,0,0,0,0,0,0,0,-8000,0,0,0,653000,661000,-8000,-8000
055772,致茂凱基97購01  ,0,0,0,0,0,0,0,0,0,-8000,0,0,0,0,8000,-8000,-8000
058642,旺宏麥證9A購01  ,0,0,0,22000,30000,-8000,0,0,0,-8000,0,0,0,22000,30000,-8000,-8000
058892,元油2X元大9C購08,0,0,0,0,0,0,0,0,0,-8000,0,0,0,12000,20000,-8000,-8000
057032,A50反1元大9B購01,0,0,0,0,0,0,0,0,0,-8000,0,0,0,7000,15000,-8000,-8000
056354,國巨元大98購10  ,0,0,0,0,0,0,0,0,0,-8000,0,0,0,17000,25000,-8000,-8000
056197,友訊永豐97購01  ,0,0,0,0,0,0,0,0,0,-8000,0,0,0,0,8000,-8000,-8000
056023,晶豪科群益97購01,0,0,0,0,0,0,0,0,0,-8000,0,0,0,98000,106000,-8000,-8000
2528,皇普            ,7000,16000,-9000,0,0,0,0,0,0,1000,2000,1000,1000,0,0,0,-8000
2443,億麗            ,0,8000,-8000,0,0,0,0,0,0,0,0,0,0,0,0,0,-8000
2397,友通            ,12000,19000,-7000,0,0,0,0,0,0,-1000,1000,2000,-1000,0,0,0,-8000
1413,宏洲            ,0,8000,-8000,0,0,0,0,0,0,0,0,0,0,0,0,0,-8000
1533,車王電          ,1000,9000,-8000,0,0,0,0,0,0,0,0,0,0,0,0,0,-8000
1516,川飛            ,3000,11000,-8000,0,0,0,0,0,0,0,0,0,0,0,0,0,-8000
1906,寶隆            ,74000,82000,-8000,0,0,0,0,0,0,0,0,0,0,0,0,0,-8000
07826P,台積電富邦9B售07,0,0,0,0,0,0,0,0,0,-8000,0,0,0,60000,68000,-8000,-8000
07598P,臺股指中信01售03,0,0,0,0,0,0,0,0,0,-8000,0,0,0,0,8000,-8000,-8000
07385P,緯穎群益99售04  ,0,0,0,0,0,0,0,0,0,-8000,0,0,0,0,8000,-8000,-8000
07309P,聯發科凱基99售18,0,0,0,0,0,0,0,0,0,-8000,0,0,0,0,8000,-8000,-8000
07310P,大立光凱基99售12,0,0,0,0,0,0,0,0,0,-8000,0,0,0,12000,20000,-8000,-8000
07290P,台灣50凱基9A售08,0,0,0,0,0,0,0,0,0,-8000,0,0,0,17000,25000,-8000,-8000
07158P,FBVIX國泰9C售01 ,0,0,0,0,0,0,0,0,0,-8000,0,0,0,0,8000,-8000,-8000
07011P,宏達電凱基99售02,0,0,0,0,0,0,0,0,0,-8000,0,0,0,4000,12000,-8000,-8000
07028P,大立光群益99售06,0,0,0,0,0,0,0,0,0,-8000,0,0,0,0,8000,-8000,-8000
07083P,台積電統一9A售06,0,0,0,0,0,0,0,0,0,-8000,0,0,0,272000,280000,-8000,-8000
8482,商億-KY         ,2000,10000,-8000,0,0,0,0,0,0,0,0,0,0,0,0,0,-8000
8070,長華*           ,19000,27000,-8000,0,0,0,0,0,0,0,1000,1000,0,0,0,0,-8000
9937,全國            ,0,8000,-8000,0,0,0,0,0,0,0,0,0,0,0,0,0,-8000
3321,同泰            ,21000,29000,-8000,0,0,0,0,0,0,0,0,0,0,0,0,0,-8000
4766,南寶            ,39000,56000,-17000,0,0,0,0,0,0,9000,0,0,0,9000,0,9000,-8000
4976,佳凌            ,36000,44000,-8000,0,0,0,0,0,0,0,0,0,0,0,0,0,-8000
061776,晶技國票9B購01  ,0,0,0,0,0,0,0,0,0,-9000,0,0,0,0,9000,-9000,-9000
06803P,臺股指群益98售09,0,0,0,0,0,0,0,0,0,-9000,0,0,0,0,9000,-9000,-9000
06885P,國巨國票99售06  ,0,0,0,0,0,0,0,0,0,-9000,0,0,0,61000,70000,-9000,-9000
06591P,大立光元大98售14,0,0,0,0,0,0,0,0,0,-9000,0,0,0,0,9000,-9000,-9000
061218,臺股指元大9A購55,0,0,0,0,0,0,0,0,0,-9000,0,0,0,20000,29000,-9000,-9000
061080,華邦電兆豐9B購01,0,0,0,0,0,0,0,0,0,-9000,0,0,0,31000,40000,-9000,-9000
060442,滬深2X元大9A購02,0,0,0,0,0,0,0,0,0,-9000,0,0,0,0,9000,-9000,-9000
060843,大立光國票9A購06,0,0,0,0,0,0,0,0,0,-9000,0,0,0,1000,10000,-9000,-9000
060646,南電永豐9A購01  ,0,0,0,0,0,0,0,0,0,-9000,0,0,0,2000,11000,-9000,-9000
059624,鴻海凱基01購01  ,0,0,0,0,0,0,0,0,0,-9000,0,0,0,0,9000,-9000,-9000
059815,SP黃豆凱基9A購03,0,0,0,0,0,0,0,0,0,-9000,0,0,0,1000,10000,-9000,-9000
059973,A50正2元大99購02,0,0,0,0,0,0,0,0,0,-9000,0,0,0,0,9000,-9000,-9000
055444,致新台新97購01  ,0,0,0,0,0,0,0,0,0,-9000,0,0,0,176000,185000,-9000,-9000
056833,和大元富9B購01  ,0,0,0,0,0,0,0,0,0,-9000,0,0,0,0,9000,-9000,-9000
051531,國巨國票96購04  ,0,0,0,0,0,0,0,0,0,-9000,0,0,0,1000,10000,-9000,-9000
053516,茂林群益96購05  ,0,0,0,0,0,0,0,0,0,-9000,0,0,0,6000,15000,-9000,-9000
03033X,元展30          ,0,0,0,0,0,0,0,0,0,-9000,0,0,0,2000,11000,-9000,-9000
055973,亞德客統一97購01,0,0,0,0,0,0,0,0,0,-9000,0,0,0,1000,10000,-9000,-9000
058556,百和永豐99購01  ,0,0,0,0,0,0,0,0,0,-9000,0,0,0,40000,49000,-9000,-9000
058612,健策元大99購02  ,0,0,0,0,0,0,0,0,0,-9000,0,0,0,15000,24000,-9000,-9000
058672,可成群益9B購02  ,0,0,0,0,0,0,0,0,0,-9000,0,0,0,103000,112000,-9000,-9000
058677,矽格群益99購01  ,0,0,0,0,0,0,0,0,0,-9000,0,0,0,1000,10000,-9000,-9000
05666P,聯發科凱基96售14,0,0,0,0,0,0,0,0,0,-9000,0,0,0,0,9000,-9000,-9000
057859,神達康和98購01  ,0,0,0,0,0,0,0,0,0,-9000,0,0,0,13000,22000,-9000,-9000
058749,康控凱基99購03  ,0,0,0,0,0,0,0,0,0,-9000,0,0,0,0,9000,-9000,-9000
059512,晶豪科永豐99購02,0,0,0,0,0,0,0,0,0,-9000,0,0,0,0,9000,-9000,-9000
059327,南茂元大99購01  ,0,0,0,0,0,0,0,0,0,-9000,0,0,0,143000,152000,-9000,-9000
059168,奇力新凱基99購05,0,0,0,0,0,0,0,0,0,-9000,0,0,0,31000,40000,-9000,-9000
05629P,聯發科永昌99售02,0,0,0,0,0,0,0,0,0,-9000,0,0,0,1000,10000,-9000,-9000
056284,台積電永豐97購06,0,0,0,0,0,0,0,0,0,-9000,0,0,0,0,9000,-9000,-9000
059036,可成群益9B購03  ,0,0,0,0,0,0,0,0,0,-9000,0,0,0,17000,26000,-9000,-9000
059068,台虹國票9A購01  ,0,0,0,0,0,0,0,0,0,-9000,0,0,0,0,9000,-9000,-9000
059058,可成凱基9B購01  ,0,0,0,0,0,0,0,0,0,-9000,0,0,0,1000,10000,-9000,-9000
4555,氣立            ,44000,57000,-13000,0,0,0,0,0,0,4000,15000,11000,4000,0,0,0,-9000
9931,欣高            ,0,9000,-9000,0,0,0,0,0,0,0,0,0,0,0,0,0,-9000
07046P,大立光富邦9C售03,0,0,0,0,0,0,0,0,0,-9000,0,0,0,3000,12000,-9000,-9000
2032,新鋼            ,10000,19000,-9000,0,0,0,0,0,0,0,0,0,0,0,0,0,-9000
2069,運錩            ,0,9000,-9000,0,0,0,0,0,0,0,0,0,0,0,0,0,-9000
1529,樂士            ,4000,19000,-15000,0,0,0,0,0,0,6000,6000,0,6000,0,0,0,-9000
1203,味王            ,0,9000,-9000,0,0,0,0,0,0,0,0,0,0,0,0,0,-9000
2380,虹光            ,0,9000,-9000,0,0,0,0,0,0,0,0,0,0,0,0,0,-9000
2468,華經            ,0,9000,-9000,0,0,0,0,0,0,0,0,0,0,0,0,0,-9000
059997,華航元富99購01  ,0,0,0,0,0,0,0,0,0,-10000,0,0,0,10000,20000,-10000,-10000
060222,貿聯凱基9A購02  ,0,0,0,0,0,0,0,0,0,-10000,0,0,0,57000,67000,-10000,-10000
060216,鴻海凱基9A購17  ,0,0,0,0,0,0,0,0,0,-10000,0,0,0,0,10000,-10000,-10000
060161,牧德永豐9A購02  ,0,0,0,0,0,0,0,0,0,-10000,0,0,0,10000,20000,-10000,-10000
05975P,國巨日盛99售02  ,0,0,0,0,0,0,0,0,0,-10000,0,0,0,0,10000,-10000,-10000
059611,台積電永豐99購05,0,0,0,0,0,0,0,0,0,-10000,0,0,0,5000,15000,-10000,-10000
059584,台灣50元大01購11,0,0,0,0,0,0,0,0,0,-10000,0,0,0,0,10000,-10000,-10000
059570,全新凱基99購04  ,0,0,0,0,0,0,0,0,0,-10000,0,0,0,0,10000,-10000,-10000
059563,鴻海凱基9A購14  ,0,0,0,0,0,0,0,0,0,-10000,0,0,0,0,10000,-10000,-10000
05963P,貿聯國票97售02  ,0,0,0,0,0,0,0,0,0,-10000,0,0,0,0,10000,-10000,-10000
059719,台積電元大99購42,0,0,0,0,0,0,0,0,0,-10000,0,0,0,1000,11000,-10000,-10000
059695,聯鈞永豐99購02  ,0,0,0,0,0,0,0,0,0,-10000,0,0,0,68000,78000,-10000,-10000
060757,台積電元大9A購18,0,0,0,0,0,0,0,0,0,-10000,0,0,0,0,10000,-10000,-10000
060884,超眾中信9B購01  ,0,0,0,0,0,0,0,0,0,-10000,0,0,0,5000,15000,-10000,-10000
060906,旺宏元大9A購07  ,0,0,0,0,0,0,0,0,0,-10000,0,0,0,4000,14000,-10000,-10000
060455,葡萄王元大9A購02,0,0,0,0,0,0,0,0,0,-10000,0,0,0,0,10000,-10000,-10000
06047P,聯發科富邦99售04,0,0,0,0,0,0,0,0,0,-10000,0,0,0,0,10000,-10000,-10000
060532,欣興中信9A購01  ,0,0,0,0,0,0,0,0,0,-10000,0,0,0,23000,33000,-10000,-10000
060354,A50正2元富9A購02,0,0,0,0,0,0,0,0,0,-10000,0,0,0,0,10000,-10000,-10000
061051,臺股指中信9A購06,0,0,0,0,0,0,0,0,0,-10000,0,0,0,0,10000,-10000,-10000
060919,滬深2X富邦9B購01,0,0,0,0,0,0,0,0,0,-10000,0,0,0,0,10000,-10000,-10000
061198,世紀鋼永豐9A購03,0,0,0,0,0,0,0,0,0,-10000,0,0,0,10000,20000,-10000,-10000
061405,亞德客國票9B購01,0,0,0,0,0,0,0,0,0,-10000,0,0,0,19000,29000,-10000,-10000
061300,臺股指富邦9A購02,0,0,0,0,0,0,0,0,0,-10000,0,0,0,0,10000,-10000,-10000
061519,T50反1中信03購01,0,0,0,0,0,0,0,0,0,-10000,0,0,0,0,10000,-10000,-10000
061434,國巨麥證9A購04  ,0,0,0,0,10000,-10000,0,0,0,-10000,0,0,0,0,10000,-10000,-10000
06603P,立積統一99售01  ,0,0,0,0,0,0,0,0,0,-10000,0,0,0,0,10000,-10000,-10000
06587P,國巨元大98售13  ,0,0,0,0,0,0,0,0,0,-10000,0,0,0,130000,140000,-10000,-10000
06556P,臺股指元大99售08,0,0,0,0,0,0,0,0,0,-10000,0,0,0,0,10000,-10000,-10000
06502P,A50中信98售01   ,0,0,0,0,0,0,0,0,0,-10000,0,0,0,0,10000,-10000,-10000
06717P,可成元大98售09  ,0,0,0,0,0,0,0,0,0,-10000,0,0,0,8000,18000,-10000,-10000
06686P,麗豐永豐98售02  ,0,0,0,0,0,0,0,0,0,-10000,0,0,0,0,10000,-10000,-10000
06939P,國巨永豐98售09  ,0,0,0,0,0,0,0,0,0,-10000,0,0,0,10000,20000,-10000,-10000
06912P,台光電元大99售02,0,0,0,0,0,0,0,0,0,-10000,0,0,0,0,10000,-10000,-10000
06187P,國巨統一97售05  ,0,0,0,0,0,0,0,0,0,-10000,0,0,0,200000,210000,-10000,-10000
06190P,玉晶光永豐97售05,0,0,0,0,0,0,0,0,0,-10000,0,0,0,0,10000,-10000,-10000
06196P,元上證元大97售01,0,0,0,0,0,0,0,0,0,-10000,0,0,0,0,10000,-10000,-10000
06249P,億光統一97售02  ,0,0,0,0,0,0,0,0,0,-10000,0,0,0,0,10000,-10000,-10000
06233P,訊芯永豐97售03  ,0,0,0,0,0,0,0,0,0,-10000,0,0,0,0,10000,-10000,-10000
061762,台塑元大9B購01  ,0,0,0,0,0,0,0,0,0,-10000,0,0,0,0,10000,-10000,-10000
061800,泰鼎永豐9B購01  ,0,0,0,0,0,0,0,0,0,-10000,0,0,0,1000,11000,-10000,-10000
061798,晶豪科永豐9B購01,0,0,0,0,0,0,0,0,0,-10000,0,0,0,0,10000,-10000,-10000
061741,新光金凱基9B購01,0,0,0,0,0,0,0,0,0,-10000,0,0,0,0,10000,-10000,-10000
06382P,大毅元富97售02  ,0,0,0,0,0,0,0,0,0,-10000,0,0,0,0,10000,-10000,-10000
06454P,緯穎元大98售04  ,0,0,0,0,0,0,0,0,0,-10000,0,0,0,0,10000,-10000,-10000
06455P,上銀統一99售03  ,0,0,0,0,0,0,0,0,0,-10000,0,0,0,0,10000,-10000,-10000
06445P,大立光凱基98售09,0,0,0,0,0,0,0,0,0,-10000,0,0,0,0,10000,-10000,-10000
061660,禾伸堂永豐9A購01,0,0,0,0,0,0,0,0,0,-10000,0,0,0,0,10000,-10000,-10000
061655,微星國票9A購01  ,0,0,0,0,0,0,0,0,0,-10000,0,0,0,0,10000,-10000,-10000
061715,牧德凱基9B購03  ,0,0,0,0,0,0,0,0,0,-10000,0,0,0,0,10000,-10000,-10000
061707,超眾國票9B購01  ,0,0,0,0,0,0,0,0,0,-10000,0,0,0,0,10000,-10000,-10000
061665,旺宏中信9C購01  ,0,0,0,0,0,0,0,0,0,-10000,0,0,0,9000,19000,-10000,-10000
049947,S&P反1中信97購01,0,0,0,0,0,0,0,0,0,-10000,0,0,0,10000,20000,-10000,-10000
044247,道瓊反元富97購01,0,0,0,0,0,0,0,0,0,-10000,0,0,0,0,10000,-10000,-10000
043442,大立光台新01購01,0,0,0,0,0,0,0,0,0,-10000,0,0,0,21000,31000,-10000,-10000
048848,滬深2X群益98購02,0,0,0,0,0,0,0,0,0,-10000,0,0,0,0,10000,-10000,-10000
052274,大立光群益95購03,0,0,0,0,0,0,0,0,0,-10000,0,0,0,0,10000,-10000,-10000
052151,義隆富邦96購01  ,0,0,0,0,0,0,0,0,0,-10000,0,0,0,0,10000,-10000,-10000
052187,奇鋐群益95購03  ,0,0,0,0,0,0,0,0,0,-10000,0,0,0,0,10000,-10000,-10000
052406,力成凱基95購03  ,0,0,0,0,0,0,0,0,0,-10000,0,0,0,0,10000,-10000,-10000
052420,道瓊反國票9B購01,0,0,0,0,0,0,0,0,0,-10000,0,0,0,0,10000,-10000,-10000
052324,康友元大96購02  ,0,0,0,0,0,0,0,0,0,-10000,0,0,0,0,10000,-10000,-10000
05261P,鴻海元大95售20  ,0,0,0,0,0,0,0,0,0,-10000,0,0,0,0,10000,-10000,-10000
052588,玉晶光永豐98購01,0,0,0,0,0,0,0,0,0,-10000,0,0,0,30000,40000,-10000,-10000
052612,康舒元大97購01  ,0,0,0,0,0,0,0,0,0,-10000,0,0,0,0,10000,-10000,-10000
052615,鴻海國泰98購01  ,0,0,0,0,0,0,0,0,0,-10000,0,0,0,0,10000,-10000,-10000
052616,鴻海國泰98購02  ,0,0,0,0,0,0,0,0,0,-10000,0,0,0,0,10000,-10000,-10000
052582,喬山台新96購01  ,0,0,0,0,0,0,0,0,0,-10000,0,0,0,0,10000,-10000,-10000
052485,深中小國票96購01,0,0,0,0,0,0,0,0,0,-10000,0,0,0,0,10000,-10000,-10000
052515,矽力凱基95購02  ,0,0,0,0,0,0,0,0,0,-10000,0,0,0,0,10000,-10000,-10000
049973,T50反1日盛9A購01,0,0,0,0,0,0,0,0,0,-10000,0,0,0,0,10000,-10000,-10000
04273P,上証反凱基99售01,0,0,0,0,0,0,0,0,0,-10000,0,0,0,0,10000,-10000,-10000
041527,T50反1中信96購01,0,0,0,0,0,0,0,0,0,-10000,0,0,0,0,10000,-10000,-10000
047342,T50反1中信99購01,0,0,0,0,0,0,0,0,0,-10000,0,0,0,0,10000,-10000,-10000
048049,滬深反中信96購01,0,0,0,0,0,0,0,0,0,-10000,0,0,0,0,10000,-10000,-10000
047687,元金2X富邦96購01,0,0,0,0,0,0,0,0,0,-10000,0,0,0,0,10000,-10000,-10000
052090,聯發科元大97購03,0,0,0,0,0,0,0,0,0,-10000,0,0,0,0,10000,-10000,-10000
052132,旺宏凱基9B購01  ,0,0,0,0,0,0,0,0,0,-10000,0,0,0,0,10000,-10000,-10000
048273,南電富邦97購01  ,0,0,0,0,0,0,0,0,0,-10000,0,0,0,0,10000,-10000,-10000
054694,聯鈞永豐97購01  ,0,0,0,0,0,0,0,0,0,-10000,0,0,0,0,10000,-10000,-10000
050169,臺指反元大97購01,0,0,0,0,0,0,0,0,0,-10000,0,0,0,0,10000,-10000,-10000
050219,台積電元富95購03,0,0,0,0,0,0,0,0,0,-10000,0,0,0,0,10000,-10000,-10000
050220,台積電元富96購01,0,0,0,0,0,0,0,0,0,-10000,0,0,0,0,10000,-10000,-10000
052766,玉晶光群益9A購01,0,0,0,0,0,0,0,0,0,-10000,0,0,0,10000,20000,-10000,-10000
052785,滬深2X中信99購03,0,0,0,0,0,0,0,0,0,-10000,0,0,0,10000,20000,-10000,-10000
050353,華擎群益95購01  ,0,0,0,0,0,0,0,0,0,-10000,0,0,0,0,10000,-10000,-10000
050420,鴻海凱基95購03  ,0,0,0,0,0,0,0,0,0,-10000,0,0,0,0,10000,-10000,-10000
050261,國巨元大95購04  ,0,0,0,0,0,0,0,0,0,-10000,0,0,0,0,10000,-10000,-10000
05476P,聯發科群益95售06,0,0,0,0,0,0,0,0,0,-10000,0,0,0,0,10000,-10000,-10000
054733,鴻海凱基98購04  ,0,0,0,0,0,0,0,0,0,-10000,0,0,0,0,10000,-10000,-10000
053728,茂林凱基97購01  ,0,0,0,0,0,0,0,0,0,-10000,0,0,0,0,10000,-10000,-10000
051651,易華電永豐95購01,0,0,0,0,0,0,0,0,0,-10000,0,0,0,0,10000,-10000,-10000
051591,玉晶光元大97購01,0,0,0,0,0,0,0,0,0,-10000,0,0,0,0,10000,-10000,-10000
051666,旺宏元大96購05  ,0,0,0,0,0,0,0,0,0,-10000,0,0,0,0,10000,-10000,-10000
051736,旺宏國票96購01  ,0,0,0,0,0,0,0,0,0,-10000,0,0,0,10000,20000,-10000,-10000
051799,台積電永豐96購01,0,0,0,0,0,0,0,0,0,-10000,0,0,0,0,10000,-10000,-10000
051257,光寶科國泰96購01,0,0,0,0,0,0,0,0,0,-10000,0,0,0,0,10000,-10000,-10000
05123P,鴻海永昌96售07  ,0,0,0,0,0,0,0,0,0,-10000,0,0,0,0,10000,-10000,-10000
051152,鴻海國泰97購01  ,0,0,0,0,0,0,0,0,0,-10000,0,0,0,0,10000,-10000,-10000
051153,鴻海國泰97購02  ,0,0,0,0,0,0,0,0,0,-10000,0,0,0,0,10000,-10000,-10000
05271P,國巨富邦97售01  ,0,0,0,0,0,0,0,0,0,-10000,0,0,0,0,10000,-10000,-10000
052049,緯創凱基97購01  ,0,0,0,0,0,0,0,0,0,-10000,0,0,0,30000,40000,-10000,-10000
052643,華通永豐96購02  ,0,0,0,0,0,0,0,0,0,-10000,0,0,0,0,10000,-10000,-10000
05076P,深中小群益99售02,0,0,0,0,0,0,0,0,0,-10000,0,0,0,0,10000,-10000,-10000
051872,矽力凱基96購01  ,0,0,0,0,0,0,0,0,0,-10000,0,0,0,0,10000,-10000,-10000
055906,大立光兆豐97購03,0,0,0,0,0,0,0,0,0,-10000,0,0,0,0,10000,-10000,-10000
058297,茂林凱基9A購02  ,0,0,0,0,0,0,0,0,0,-10000,0,0,0,0,10000,-10000,-10000
058305,華邦電元大99購02,0,0,0,0,0,0,0,0,0,-10000,0,0,0,0,10000,-10000,-10000
058290,南電國票9A購01  ,0,0,0,0,0,0,0,0,0,-10000,0,0,0,12000,22000,-10000,-10000
058268,泰碩永豐9A購01  ,0,0,0,0,0,0,0,0,0,-10000,0,0,0,0,10000,-10000,-10000
058269,世芯永豐9A購01  ,0,0,0,0,0,0,0,0,0,-10000,0,0,0,0,10000,-10000,-10000
057994,技嘉中信98購01  ,0,0,0,0,0,0,0,0,0,-10000,0,0,0,11000,21000,-10000,-10000
054396,日電貿永豐96購02,0,0,0,0,0,0,0,0,0,-10000,0,0,0,0,10000,-10000,-10000
054398,牧德永豐96購03  ,0,0,0,0,0,0,0,0,0,-10000,0,0,0,0,10000,-10000,-10000
05442P,鴻海元大96售13  ,0,0,0,0,0,0,0,0,0,-10000,0,0,0,0,10000,-10000,-10000
054381,世芯群益98購01  ,0,0,0,0,0,0,0,0,0,-10000,0,0,0,31000,41000,-10000,-10000
054271,中石化中信99購01,0,0,0,0,0,0,0,0,0,-10000,0,0,0,0,10000,-10000,-10000
054203,滬深2X國票96購03,0,0,0,0,0,0,0,0,0,-10000,0,0,0,0,10000,-10000,-10000
055215,智邦凱基98購02  ,0,0,0,0,0,0,0,0,0,-10000,0,0,0,0,10000,-10000,-10000
054624,台積電凱基98購03,0,0,0,0,0,0,0,0,0,-10000,0,0,0,0,10000,-10000,-10000
054636,華通中信97購01  ,0,0,0,0,0,0,0,0,0,-10000,0,0,0,0,10000,-10000,-10000
054642,訊芯中信9A購01  ,0,0,0,0,0,0,0,0,0,-10000,0,0,0,0,10000,-10000,-10000
055412,旺宏富邦99購01  ,0,0,0,0,0,0,0,0,0,-10000,0,0,0,0,10000,-10000,-10000
053815,聯發科群益96購01,0,0,0,0,0,0,0,0,0,-10000,0,0,0,0,10000,-10000,-10000
053851,鴻海國泰98購03  ,0,0,0,0,0,0,0,0,0,-10000,0,0,0,0,10000,-10000,-10000
055369,友訊元大97購01  ,0,0,0,0,0,0,0,0,0,-10000,0,0,0,0,10000,-10000,-10000
055358,臻鼎凱基97購01  ,0,0,0,0,0,0,0,0,0,-10000,0,0,0,0,10000,-10000,-10000
055327,致新國票98購01  ,0,0,0,0,0,0,0,0,0,-10000,0,0,0,43000,53000,-10000,-10000
055302,達方元大97購01  ,0,0,0,0,0,0,0,0,0,-10000,0,0,0,20000,30000,-10000,-10000
055292,聯鈞元大97購02  ,0,0,0,0,0,0,0,0,0,-10000,0,0,0,0,10000,-10000,-10000
053036,聯電凱基98購01  ,0,0,0,0,0,0,0,0,0,-10000,0,0,0,0,10000,-10000,-10000
054944,精元元大97購01  ,0,0,0,0,0,0,0,0,0,-10000,0,0,0,0,10000,-10000,-10000
054996,聯陽元富97購01  ,0,0,0,0,0,0,0,0,0,-10000,0,0,0,0,10000,-10000,-10000
053181,滬深2X元富99購02,0,0,0,0,0,0,0,0,0,-10000,0,0,0,0,10000,-10000,-10000
053165,大立光群益96購03,0,0,0,0,0,0,0,0,0,-10000,0,0,0,0,10000,-10000,-10000
053090,新唐元大96購01  ,0,0,0,0,0,0,0,0,0,-10000,0,0,0,30000,40000,-10000,-10000
053052,旺宏國票97購02  ,0,0,0,0,0,0,0,0,0,-10000,0,0,0,0,10000,-10000,-10000
053223,台郡凱基96購02  ,0,0,0,0,0,0,0,0,0,-10000,0,0,0,0,10000,-10000,-10000
053383,京元電元大97購01,0,0,0,0,0,0,0,0,0,-10000,0,0,0,0,10000,-10000,-10000
053970,聯發科元大97購08,0,0,0,0,0,0,0,0,0,-10000,0,0,0,0,10000,-10000,-10000
054079,鴻海中信98購02  ,0,0,0,0,0,0,0,0,0,-10000,0,0,0,0,10000,-10000,-10000
055128,致新兆豐97購01  ,0,0,0,0,0,0,0,0,0,-10000,0,0,0,0,10000,-10000,-10000
059011,臺股指元大9A購30,0,0,0,0,0,0,0,0,0,-10000,0,0,0,0,10000,-10000,-10000
05720P,可成中信98售01  ,0,0,0,0,0,0,0,0,0,-10000,0,0,0,0,10000,-10000,-10000
057154,易華電國泰99購01,0,0,0,0,0,0,0,0,0,-10000,0,0,0,0,10000,-10000,-10000
057123,上銀凱基98購05  ,0,0,0,0,0,0,0,0,0,-10000,0,0,0,0,10000,-10000,-10000
05712P,友達統一97售03  ,0,0,0,0,0,0,0,0,0,-10000,0,0,0,0,10000,-10000,-10000
057140,宏達電兆豐98購01,0,0,0,0,0,0,0,0,0,-10000,0,0,0,0,10000,-10000,-10000
056240,嘉晶群益97購02  ,0,0,0,0,0,0,0,0,0,-10000,0,0,0,10000,20000,-10000,-10000
058386,A50正2國票9B購01,0,0,0,0,0,0,0,0,0,-10000,0,0,0,0,10000,-10000,-10000
057235,亞光凱基98購04  ,0,0,0,0,0,0,0,0,0,-10000,0,0,0,0,10000,-10000,-10000
057223,富邦金日盛99購01,0,0,0,0,0,0,0,0,0,-10000,0,0,0,0,10000,-10000,-10000
057607,旺宏台新98購02  ,0,0,0,0,0,0,0,0,0,-10000,0,0,0,0,10000,-10000,-10000
057243,樺漢凱基99購01  ,0,0,0,0,0,0,0,0,0,-10000,0,0,0,0,10000,-10000,-10000
057252,牧德元富98購01  ,0,0,0,0,0,0,0,0,0,-10000,0,0,0,0,10000,-10000,-10000
059214,國巨元大99購20  ,0,0,0,0,0,0,0,0,0,-10000,0,0,0,11000,21000,-10000,-10000
059203,勤誠永豐99購02  ,0,0,0,0,0,0,0,0,0,-10000,0,0,0,10000,20000,-10000,-10000
059262,致茂中信01購01  ,0,0,0,0,0,0,0,0,0,-10000,0,0,0,10000,20000,-10000,-10000
059275,可成元大99購05  ,0,0,0,0,0,0,0,0,0,-10000,0,0,0,10000,20000,-10000,-10000
059429,台積電元大99購35,0,0,0,0,0,0,0,0,0,-10000,0,0,0,0,10000,-10000,-10000
059506,滬深2X永豐99購04,0,0,0,0,0,0,0,0,0,-10000,0,0,0,0,10000,-10000,-10000
057861,台積電凱基98購16,0,0,0,0,0,0,0,0,0,-10000,0,0,0,0,10000,-10000,-10000
057834,聯發科元富02購07,0,0,0,0,0,0,0,0,0,-10000,0,0,0,10000,20000,-10000,-10000
057846,神達永豐98購01  ,0,0,0,0,0,0,0,0,0,-10000,0,0,0,0,10000,-10000,-10000
057354,聯鈞統一99購03  ,0,0,0,0,0,0,0,0,0,-10000,0,0,0,0,10000,-10000,-10000
057556,智易凱基99購01  ,0,0,0,0,0,0,0,0,0,-10000,0,0,0,0,10000,-10000,-10000
057468,台郡永豐98購01  ,0,0,0,0,0,0,0,0,0,-10000,0,0,0,0,10000,-10000,-10000
057472,T50正2元大9B購03,0,0,0,0,0,0,0,0,0,-10000,0,0,0,0,10000,-10000,-10000
056687,元大金統一98購01,0,0,0,0,0,0,0,0,0,-10000,0,0,0,0,10000,-10000,-10000
056727,滬深反凱基9B購01,0,0,0,0,0,0,0,0,0,-10000,0,0,0,0,10000,-10000,-10000
056735,國巨凱基99購02  ,0,0,0,0,0,0,0,0,0,-10000,0,0,0,0,10000,-10000,-10000
056694,欣興群益98購04  ,0,0,0,0,0,0,0,0,0,-10000,0,0,0,57000,67000,-10000,-10000
056714,晶相光永豐98購02,0,0,0,0,0,0,0,0,0,-10000,0,0,0,8000,18000,-10000,-10000
056598,京元電元富98購01,0,0,0,0,0,0,0,0,0,-10000,0,0,0,10000,20000,-10000,-10000
056555,矽創凱基98購01  ,0,0,0,0,0,0,0,0,0,-10000,0,0,0,0,10000,-10000,-10000
056563,華新科群益98購04,0,0,0,0,0,0,0,0,0,-10000,0,0,0,0,10000,-10000,-10000
057101,新光金中信9A購01,0,0,0,0,0,0,0,0,0,-10000,0,0,0,0,10000,-10000,-10000
057107,華新科群益98購06,0,0,0,0,0,0,0,0,0,-10000,0,0,0,0,10000,-10000,-10000
057103,禾伸堂中信9A購01,0,0,0,0,0,0,0,0,0,-10000,0,0,0,50000,60000,-10000,-10000
057810,技嘉元大98購06  ,0,0,0,0,0,0,0,0,0,-10000,0,0,0,0,10000,-10000,-10000
057813,京元電元大98購03,0,0,0,0,0,0,0,0,0,-10000,0,0,0,0,10000,-10000,-10000
057829,臺股指元大98購12,0,0,0,0,0,0,0,0,0,-10000,0,0,0,0,10000,-10000,-10000
05647P,聯發科國票97售02,0,0,0,0,0,0,0,0,0,-10000,0,0,0,0,10000,-10000,-10000
05642P,玉晶光兆豐97售02,0,0,0,0,0,0,0,0,0,-10000,0,0,0,0,10000,-10000,-10000
056424,泰碩統一98購01  ,0,0,0,0,0,0,0,0,0,-10000,0,0,0,0,10000,-10000,-10000
058712,鴻海統一9B購03  ,0,0,0,0,0,0,0,0,0,-10000,0,0,0,0,10000,-10000,-10000
055474,欣興凱基97購05  ,0,0,0,0,0,0,0,0,0,-10000,0,0,0,10000,20000,-10000,-10000
055622,群創國泰99購01  ,0,0,0,0,0,0,0,0,0,-10000,0,0,0,0,10000,-10000,-10000
055748,GIS元富97購01   ,0,0,0,0,0,0,0,0,0,-10000,0,0,0,0,10000,-10000,-10000
055689,台郡凱基99購01  ,0,0,0,0,0,0,0,0,0,-10000,0,0,0,10000,20000,-10000,-10000
055676,亞德客凱基97購03,0,0,0,0,0,0,0,0,0,-10000,0,0,0,0,10000,-10000,-10000
058475,台積電凱基99購06,0,0,0,0,0,0,0,0,0,-10000,0,0,0,0,10000,-10000,-10000
058647,華新科永豐99購03,0,0,0,0,0,0,0,0,0,-10000,0,0,0,0,10000,-10000,-10000
058628,宏達電國票9A購01,0,0,0,0,0,0,0,0,0,-10000,0,0,0,0,10000,-10000,-10000
058633,台灣50兆豐99購01,0,0,0,0,0,0,0,0,0,-10000,0,0,0,0,10000,-10000,-10000
05884P,旺宏統一96售01  ,0,0,0,0,0,0,0,0,0,-10000,0,0,0,0,10000,-10000,-10000
058422,百和麥證99購01  ,0,0,0,40000,50000,-10000,0,0,0,-10000,0,0,0,40000,50000,-10000,-10000
056953,智邦富邦98購02  ,0,0,0,0,0,0,0,0,0,-10000,0,0,0,0,10000,-10000,-10000
055486,國巨元大98購06  ,0,0,0,0,0,0,0,0,0,-10000,0,0,0,10000,20000,-10000,-10000
05855P,滬深2X中信9C售01,0,0,0,0,0,0,0,0,0,-10000,0,0,0,0,10000,-10000,-10000
055585,國巨元大98購08  ,0,0,0,0,0,0,0,0,0,-10000,0,0,0,10000,20000,-10000,-10000
055560,大立光凱基97購10,0,0,0,0,0,0,0,0,0,-10000,0,0,0,10000,20000,-10000,-10000
056171,鴻海元富97購10  ,0,0,0,0,0,0,0,0,0,-10000,0,0,0,0,10000,-10000,-10000
056173,廣達元富97購01  ,0,0,0,0,0,0,0,0,0,-10000,0,0,0,0,10000,-10000,-10000
056993,GIS兆豐99購01   ,0,0,0,0,0,0,0,0,0,-10000,0,0,0,0,10000,-10000,-10000
056331,聯鈞國票99購01  ,0,0,0,0,0,0,0,0,0,-10000,0,0,0,0,10000,-10000,-10000
057777,可成群益9A購03  ,0,0,0,0,0,0,0,0,0,-10000,0,0,0,66000,76000,-10000,-10000
056382,道瓊反國泰9A購01,0,0,0,0,0,0,0,0,0,-10000,0,0,0,0,10000,-10000,-10000
056399,上証2X群益9C購01,0,0,0,0,0,0,0,0,0,-10000,0,0,0,80000,90000,-10000,-10000
056414,國巨中信98購02  ,0,0,0,0,0,0,0,0,0,-10000,0,0,0,0,10000,-10000,-10000
057728,瑞昱國泰99購01  ,0,0,0,0,0,0,0,0,0,-10000,0,0,0,0,10000,-10000,-10000
058150,中502X統一9B購01,0,0,0,0,0,0,0,0,0,-10000,0,0,0,0,10000,-10000,-10000
058023,南電凱基98購02  ,0,0,0,0,0,0,0,0,0,-10000,0,0,0,3000,13000,-10000,-10000
058045,鴻海元大99購08  ,0,0,0,0,0,0,0,0,0,-10000,0,0,0,0,10000,-10000,-10000
056036,鴻海凱基97購07  ,0,0,0,0,0,0,0,0,0,-10000,0,0,0,10000,20000,-10000,-10000
05601P,鴻海元大97售04  ,0,0,0,0,0,0,0,0,0,-10000,0,0,0,0,10000,-10000,-10000
055989,矽力元富9A購01  ,0,0,0,0,0,0,0,0,0,-10000,0,0,0,66000,76000,-10000,-10000
056047,台積電兆豐97購02,0,0,0,0,0,0,0,0,0,-10000,0,0,0,10000,20000,-10000,-10000
058366,元大金凱基99購01,0,0,0,0,0,0,0,0,0,-10000,0,0,0,0,10000,-10000,-10000
058195,鈺齊永豐99購01  ,0,0,0,0,0,0,0,0,0,-10000,0,0,0,0,10000,-10000,-10000
056109,彩晶永豐98購01  ,0,0,0,0,0,0,0,0,0,-10000,0,0,0,0,10000,-10000,-10000
058171,國巨凱基9A購07  ,0,0,0,0,0,0,0,0,0,-10000,0,0,0,0,10000,-10000,-10000
058185,國巨永豐99購01  ,0,0,0,0,0,0,0,0,0,-10000,0,0,0,0,10000,-10000,-10000
056861,美律群益99購01  ,0,0,0,0,0,0,0,0,0,-10000,0,0,0,0,10000,-10000,-10000
056869,國巨日盛99購03  ,0,0,0,0,0,0,0,0,0,-10000,0,0,0,0,10000,-10000,-10000
056935,華新科元富98購02,0,0,0,0,0,0,0,0,0,-10000,0,0,0,0,10000,-10000,-10000
057899,台積電永豐98購04,0,0,0,0,0,0,0,0,0,-10000,0,0,0,0,10000,-10000,-10000
057677,臺股指元大98購07,0,0,0,0,0,0,0,0,0,-10000,0,0,0,0,10000,-10000,-10000
058898,台積電元大99購20,0,0,0,0,0,0,0,0,0,-10000,0,0,0,0,10000,-10000,-10000
058807,和大統一9B購01  ,0,0,0,0,0,0,0,0,0,-10000,0,0,0,0,10000,-10000,-10000
3002,歐格            ,0,10000,-10000,0,0,0,0,0,0,0,0,0,0,0,0,0,-10000
2007,燁興            ,3000,13000,-10000,0,0,0,0,0,0,0,0,0,0,0,0,0,-10000
1733,五鼎            ,60000,68000,-8000,0,0,0,0,0,0,-2000,1000,3000,-2000,0,0,0,-10000
07051P,大立光中信99售02,0,0,0,0,0,0,0,0,0,-10000,0,0,0,0,10000,-10000,-10000
07225P,台積電元大99售33,0,0,0,0,0,0,0,0,0,-10000,0,0,0,20000,30000,-10000,-10000
07284P,大立光凱基99售10,0,0,0,0,0,0,0,0,0,-10000,0,0,0,1000,11000,-10000,-10000
07250P,台灣50永豐99售07,0,0,0,0,0,0,0,0,0,-10000,0,0,0,0,10000,-10000,-10000
07302P,臺股指元大9A售35,0,0,0,0,0,0,0,0,0,-10000,0,0,0,9000,19000,-10000,-10000
07328P,FBVIX國泰9B售01 ,0,0,0,0,0,0,0,0,0,-10000,0,0,0,10000,20000,-10000,-10000
07342P,大立光凱基99售14,0,0,0,0,0,0,0,0,0,-10000,0,0,0,6000,16000,-10000,-10000
07354P,臺股指國票99售22,0,0,0,0,0,0,0,0,0,-10000,0,0,0,130000,140000,-10000,-10000
07348P,滬深2X凱基9A售04,0,0,0,0,0,0,0,0,0,-10000,0,0,0,0,10000,-10000,-10000
07359P,台積電元大99售45,0,0,0,0,0,0,0,0,0,-10000,0,0,0,30000,40000,-10000,-10000
07631P,臺股指凱基9A售12,0,0,0,0,0,0,0,0,0,-10000,0,0,0,0,10000,-10000,-10000
07656P,國巨凱基9A售15  ,0,0,0,0,0,0,0,0,0,-10000,0,0,0,0,10000,-10000,-10000
07554P,玉晶光元大9A售06,0,0,0,0,0,0,0,0,0,-10000,0,0,0,0,10000,-10000,-10000
07866P,上証2X國票97售01,0,0,0,0,0,0,0,0,0,-10000,0,0,0,0,10000,-10000,-10000
07857P,國巨永豐9A售05  ,0,0,0,0,0,0,0,0,0,-10000,0,0,0,20000,30000,-10000,-10000
07859P,台灣50麥證9A售04,0,0,0,0,10000,-10000,0,0,0,-10000,0,0,0,0,10000,-10000,-10000
07846P,台灣50群益9A售17,0,0,0,0,0,0,0,0,0,-10000,0,0,0,0,10000,-10000,-10000
07747P,晶技凱基9A售04  ,0,70000,-70000,0,0,0,0,0,0,60000,0,0,0,78000,18000,60000,-10000
07748P,茂林凱基9A售04  ,0,0,0,0,0,0,0,0,0,-10000,0,0,0,0,10000,-10000,-10000
07701P,玉晶光第一9A售02,0,0,0,0,0,0,0,0,0,-10000,0,0,0,0,10000,-10000,-10000
07674P,金融類元大9A售01,0,0,0,0,0,0,0,0,0,-10000,0,0,0,15000,25000,-10000,-10000
4737,華廣            ,15000,25000,-10000,0,0,0,0,0,0,0,0,0,0,0,0,0,-10000
06453P,群創元大9B售02  ,0,0,0,0,0,0,0,0,0,-11000,0,0,0,5000,16000,-11000,-11000
06618P,智邦元大98售04  ,0,0,0,0,0,0,0,0,0,-11000,0,0,0,0,11000,-11000,-11000
06667P,鴻海凱基98售11  ,0,0,0,0,0,0,0,0,0,-11000,0,0,0,0,11000,-11000,-11000
06492P,上銀永豐98售01  ,0,0,0,0,0,0,0,0,0,-11000,0,0,0,7000,18000,-11000,-11000
061401,華擎兆豐9B購01  ,0,0,0,0,0,0,0,0,0,-11000,0,0,0,23000,34000,-11000,-11000
061473,台積電元大9A購33,0,0,0,0,0,0,0,0,0,-11000,0,0,0,58000,69000,-11000,-11000
06119P,大立光凱基98售04,0,0,0,0,0,0,0,0,0,-11000,0,0,0,0,11000,-11000,-11000
060530,聯發科中信9C購03,0,0,0,0,0,0,0,0,0,-11000,0,0,0,10000,21000,-11000,-11000
060219,聯發科凱基9A購09,0,0,0,0,0,0,0,0,0,-11000,0,0,0,0,11000,-11000,-11000
053378,台積電元大98購02,0,0,0,0,0,0,0,0,0,-11000,0,0,0,0,11000,-11000,-11000
054544,統一中信97購01  ,0,0,0,0,0,0,0,0,0,-11000,0,0,0,0,11000,-11000,-11000
05580P,美律凱基96售03  ,0,0,0,0,0,0,0,0,0,-11000,0,0,0,0,11000,-11000,-11000
056777,矽力元大98購02  ,0,0,0,0,0,0,0,0,0,-11000,0,0,0,0,11000,-11000,-11000
054708,華通統一97購02  ,0,0,0,0,0,0,0,0,0,-11000,0,0,0,0,11000,-11000,-11000
053635,技嘉永豐96購01  ,0,0,0,0,0,0,0,0,0,-11000,0,0,0,0,11000,-11000,-11000
053521,緯穎群益96購02  ,0,0,0,0,0,0,0,0,0,-11000,0,0,0,22000,33000,-11000,-11000
048192,華通元大96購01  ,0,0,0,0,0,0,0,0,0,-11000,0,0,0,21000,32000,-11000,-11000
052227,瑞昱凱基95購05  ,0,0,0,0,0,0,0,0,0,-11000,0,0,0,49000,60000,-11000,-11000
0053,元大電子        ,0,0,0,0,0,0,0,0,0,-11000,0,0,0,3000,14000,-11000,-11000
058194,勤誠永豐99購01  ,0,0,0,0,0,0,0,0,0,-11000,0,0,0,22000,33000,-11000,-11000
058372,欣興凱基99購03  ,0,0,0,0,0,0,0,0,0,-11000,0,0,0,7000,18000,-11000,-11000
058063,旺宏中信98購04  ,0,0,0,0,0,0,0,0,0,-11000,0,0,0,18000,29000,-11000,-11000
056360,智邦元大98購01  ,0,0,0,0,0,0,0,0,0,-11000,0,0,0,0,11000,-11000,-11000
056194,聯發科富邦9B購01,0,0,0,0,0,0,0,0,0,-11000,0,0,0,0,11000,-11000,-11000
056144,GIS元大98購01   ,0,0,0,0,0,0,0,0,0,-11000,0,0,0,0,11000,-11000,-11000
058586,鴻海中信01購02  ,0,0,0,0,0,0,0,0,0,-11000,0,0,0,0,11000,-11000,-11000
058606,聯發科元大99購13,0,0,0,0,0,0,0,0,0,-11000,0,0,0,0,11000,-11000,-11000
056423,奇鋐統一98購01  ,0,0,0,0,0,0,0,0,0,-11000,0,0,0,19000,30000,-11000,-11000
057538,緯穎元大98購07  ,0,0,0,0,0,0,0,0,0,-11000,0,0,0,0,11000,-11000,-11000
057130,全新凱基98購03  ,0,0,0,0,0,0,0,0,0,-11000,0,0,0,0,11000,-11000,-11000
6152,百一            ,6000,17000,-11000,0,0,0,0,0,0,0,0,0,0,0,0,0,-11000
6491,晶碩            ,20000,31000,-11000,0,0,0,0,0,0,0,0,0,0,0,0,0,-11000
07180P,臺股指凱基99售22,0,0,0,0,0,0,0,0,0,-11000,0,0,0,12000,23000,-11000,-11000
1236,宏亞            ,0,9000,-9000,0,0,0,0,0,0,-2000,0,2000,-2000,0,0,0,-11000
3050,鈺德            ,11000,22000,-11000,0,0,0,0,0,0,0,0,0,0,0,0,0,-11000
2881A,富邦特          ,0,11000,-11000,0,0,0,0,0,0,0,0,0,0,0,0,0,-11000
2482,連宇            ,0,10000,-10000,0,0,0,0,0,0,-1000,0,1000,-1000,0,0,0,-11000
060188,華新科元富9A購03,0,0,0,0,0,0,0,0,0,-12000,0,0,0,8000,20000,-12000,-12000
060032,利勤永豐99購01  ,0,0,0,0,0,0,0,0,0,-12000,0,0,0,0,12000,-12000,-12000
059628,智邦凱基99購04  ,0,0,0,0,0,0,0,0,0,-12000,0,0,0,0,12000,-12000,-12000
059557,台灣50凱基9C購07,0,0,0,0,0,0,0,0,0,-12000,0,0,0,0,12000,-12000,-12000
059876,智易凱基99購02  ,0,0,0,0,0,0,0,0,0,-12000,0,0,0,22000,34000,-12000,-12000
060525,台積電中信01購04,0,0,0,0,0,0,0,0,0,-12000,0,0,0,0,12000,-12000,-12000
060734,華通統一9C購01  ,0,0,0,0,0,0,0,0,0,-12000,0,0,0,137000,149000,-12000,-12000
060665,康控凱基9A購01  ,0,0,0,0,0,0,0,0,0,-12000,0,0,0,10000,22000,-12000,-12000
060666,聯茂凱基9A購02  ,0,0,0,0,0,0,0,0,0,-12000,0,0,0,0,12000,-12000,-12000
061079,台積電兆豐9A購02,0,0,0,0,0,0,0,0,0,-12000,0,0,0,0,12000,-12000,-12000
061531,奇鋐台新9A購01  ,0,0,0,0,0,0,0,0,0,-12000,0,0,0,25000,37000,-12000,-12000
061543,南亞科群益9A購01,0,0,0,0,0,0,0,0,0,-12000,0,0,0,3000,15000,-12000,-12000
061254,道瓊反凱基9A購02,0,0,0,0,0,0,0,0,0,-12000,0,0,0,0,12000,-12000,-12000
061262,智邦凱基9A購02  ,0,0,0,0,0,0,0,0,0,-12000,0,0,0,16000,28000,-12000,-12000
061272,超眾凱基9A購03  ,0,0,0,0,0,0,0,0,0,-12000,0,0,0,0,12000,-12000,-12000
061373,華通富邦9A購02  ,0,0,0,0,0,0,0,0,0,-12000,0,0,0,15000,27000,-12000,-12000
06670P,鴻海群益98售06  ,0,0,0,0,0,0,0,0,0,-12000,0,0,0,0,12000,-12000,-12000
061699,燿華國票9A購01  ,0,0,0,0,0,0,0,0,0,-12000,0,0,0,0,12000,-12000,-12000
061650,南電元大9A購07  ,0,0,0,0,0,0,0,0,0,-12000,0,0,0,0,12000,-12000,-12000
03020X,元展20          ,0,0,0,0,0,0,0,0,0,-12000,0,0,0,0,12000,-12000,-12000
058238,奇鋐元大99購02  ,0,0,0,0,0,0,0,0,0,-12000,0,0,0,5000,17000,-12000,-12000
054229,超眾元富96購05  ,0,0,0,0,0,0,0,0,0,-12000,0,0,0,78000,90000,-12000,-12000
054332,世芯永豐97購01  ,0,0,0,0,0,0,0,0,0,-12000,0,0,0,10000,22000,-12000,-12000
053064,國巨群益96購04  ,0,0,0,0,0,0,0,0,0,-12000,0,0,0,22000,34000,-12000,-12000
053138,華邦電富邦96購01,0,0,0,0,0,0,0,0,0,-12000,0,0,0,0,12000,-12000,-12000
059410,滬深2X國票9A購04,0,0,0,0,0,0,0,0,0,-12000,0,0,0,0,12000,-12000,-12000
059265,美律中信01購01  ,0,0,0,0,0,0,0,0,0,-12000,0,0,0,11000,23000,-12000,-12000
059247,可成凱基99購05  ,0,0,0,0,0,0,0,0,0,-12000,0,0,0,10000,22000,-12000,-12000
059240,台積電凱基9A購09,0,0,0,0,0,0,0,0,0,-12000,0,0,0,13000,25000,-12000,-12000
057323,智邦群益98購01  ,0,0,0,0,0,0,0,0,0,-12000,0,0,0,0,12000,-12000,-12000
057847,聯茂永豐98購01  ,0,0,0,0,0,0,0,0,0,-12000,0,0,0,0,12000,-12000,-12000
056684,旺宏統一98購02  ,0,0,0,0,0,0,0,0,0,-12000,0,0,0,0,12000,-12000,-12000
058883,旭富永豐99購01  ,0,0,0,0,0,0,0,0,0,-12000,0,0,0,89000,101000,-12000,-12000
056339,聯發科凱基99購02,0,0,0,0,0,0,0,0,0,-12000,0,0,0,0,12000,-12000,-12000
058520,智易元大99購03  ,0,0,0,0,0,0,0,0,0,-12000,0,0,0,11000,23000,-12000,-12000
05889P,群創元大98售02  ,0,0,0,0,0,0,0,0,0,-12000,0,0,0,0,12000,-12000,-12000
2881B,富邦金乙特      ,0,13000,-13000,0,0,0,0,0,0,1000,1000,0,1000,0,0,0,-12000
2701,萬企            ,0,10000,-10000,0,0,0,0,0,0,-2000,0,2000,-2000,0,0,0,-12000
3048,益登            ,127000,137000,-10000,0,0,0,0,0,0,-2000,0,2000,-2000,0,0,0,-12000
2038,海光            ,0,12000,-12000,0,0,0,0,0,0,0,0,0,0,0,0,0,-12000
07076P,鴻海凱基9A售08  ,0,0,0,0,0,0,0,0,0,-12000,0,0,0,0,12000,-12000,-12000
07326P,大立光元大99售23,0,0,0,0,0,0,0,0,0,-12000,0,0,0,0,12000,-12000,-12000
07800P,華新科國泰9B售04,0,0,0,0,0,0,0,0,0,-12000,0,0,0,0,12000,-12000,-12000
5284,jpp-KY          ,0,12000,-12000,0,0,0,0,0,0,0,0,0,0,0,0,0,-12000
4722,國精化          ,9000,21000,-12000,0,0,0,0,0,0,0,0,0,0,0,0,0,-12000
3383,新世紀          ,0,12000,-12000,0,0,0,0,0,0,0,0,0,0,0,0,0,-12000
06475P,牧德永豐98售03  ,0,0,0,0,0,0,0,0,0,-13000,0,0,0,0,13000,-13000,-13000
06468P,華新科統一98售02,0,0,0,0,0,0,0,0,0,-13000,0,0,0,0,13000,-13000,-13000
06283P,祥碩永豐97售01  ,0,0,0,0,0,0,0,0,0,-13000,0,0,0,0,13000,-13000,-13000
061717,力成凱基9B購01  ,0,0,0,0,0,0,0,0,0,-13000,0,0,0,0,13000,-13000,-13000
061726,台積電麥證9A購05,0,0,0,0,13000,-13000,0,0,0,-13000,0,0,0,0,13000,-13000,-13000
061390,大立光群益9A購04,0,0,0,0,0,0,0,0,0,-13000,0,0,0,28000,41000,-13000,-13000
061081,宏碁兆豐9A購01  ,0,0,0,0,0,0,0,0,0,-13000,0,0,0,331000,344000,-13000,-13000
060504,技嘉元大9A購02  ,0,0,0,0,0,0,0,0,0,-13000,0,0,0,0,13000,-13000,-13000
05956P,漢唐國票96售02  ,0,0,0,0,0,0,0,0,0,-13000,0,0,0,0,13000,-13000,-13000
059976,道瓊銀元大99購01,0,0,0,0,0,0,0,0,0,-13000,0,0,0,4000,17000,-13000,-13000
054376,聯茂中信97購01  ,0,0,0,0,0,0,0,0,0,-13000,0,0,0,10000,23000,-13000,-13000
056844,欣興元富98購03  ,0,0,0,0,0,0,0,0,0,-13000,0,0,0,50000,63000,-13000,-13000
055820,矽力國票98購02  ,0,0,0,0,0,0,0,0,0,-13000,0,0,0,25000,38000,-13000,-13000
00683L,元大美元指數正2 ,0,0,0,0,0,0,0,0,0,-13000,0,0,0,3000,16000,-13000,-13000
052590,祥碩永豐96購01  ,0,0,0,0,0,0,0,0,0,-13000,0,0,0,56000,69000,-13000,-13000
03432B,臺股指凱基98熊13,0,0,0,0,0,0,0,0,0,-13000,0,0,0,1000,14000,-13000,-13000
053542,超眾永豐96購01  ,0,0,0,0,0,0,0,0,0,-13000,0,0,0,0,13000,-13000,-13000
054743,聯鈞凱基99購01  ,0,0,0,0,0,0,0,0,0,-13000,0,0,0,0,13000,-13000,-13000
050673,旺宏富邦96購02  ,0,0,0,0,0,0,0,0,0,-13000,0,0,0,0,13000,-13000,-13000
058079,鴻海群益98購08  ,0,0,0,0,0,0,0,0,0,-13000,0,0,0,41000,54000,-13000,-13000
058149,百和元大99購02  ,0,0,0,0,0,0,0,0,0,-13000,0,0,0,54000,67000,-13000,-13000
055986,祥碩元富97購01  ,0,0,0,0,0,0,0,0,0,-13000,0,0,0,0,13000,-13000,-13000
055943,瑞昱麥證97購01  ,0,0,0,0,13000,-13000,0,0,0,-13000,0,0,0,0,13000,-13000,-13000
058187,泰碩永豐99購01  ,0,0,0,0,0,0,0,0,0,-13000,0,0,0,0,13000,-13000,-13000
056366,玉晶光元大99購04,0,0,0,0,0,0,0,0,0,-13000,0,0,0,59000,72000,-13000,-13000
057010,景碩中信98購01  ,0,0,0,0,0,0,0,0,0,-13000,0,0,0,51000,64000,-13000,-13000
057093,臻鼎元富98購02  ,0,0,0,0,0,0,0,0,0,-13000,0,0,0,0,13000,-13000,-13000
057524,旺宏元大99購04  ,0,0,0,0,0,0,0,0,0,-13000,0,0,0,45000,58000,-13000,-13000
059344,長榮航凱基99購01,0,0,0,0,0,0,0,0,0,-13000,0,0,0,10000,23000,-13000,-13000
056245,嘉澤群益97購01  ,0,0,0,0,0,0,0,0,0,-13000,0,0,0,98000,111000,-13000,-13000
059060,大立光凱基9A購03,0,0,0,0,0,0,0,0,0,-13000,0,0,0,0,13000,-13000,-13000
3550,聯穎            ,0,13000,-13000,0,0,0,0,0,0,0,0,0,0,0,0,0,-13000
3702A,大聯大甲特      ,0,13000,-13000,0,0,0,0,0,0,0,0,0,0,0,0,0,-13000
6172,互億            ,9000,22000,-13000,0,0,0,0,0,0,0,0,0,0,0,0,0,-13000
6243,迅杰            ,0,13000,-13000,0,0,0,0,0,0,0,0,0,0,0,0,0,-13000
07795P,美律國票9A售03  ,0,0,0,0,0,0,0,0,0,-13000,0,0,0,0,13000,-13000,-13000
07672P,南電元大9A售05  ,0,0,0,0,0,0,0,0,0,-13000,0,0,0,25000,38000,-13000,-13000
1817,凱撒衛          ,0,13000,-13000,0,0,0,0,0,0,0,0,0,0,0,0,0,-13000
060199,台郡元富9A購01  ,0,0,0,0,0,0,0,0,0,-14000,0,0,0,121000,135000,-14000,-14000
059526,鴻海凱基99購12  ,0,0,0,0,0,0,0,0,0,-14000,0,0,0,0,14000,-14000,-14000
059914,台積電元大99購47,0,0,0,0,0,0,0,0,0,-14000,0,0,0,53000,67000,-14000,-14000
059879,GIS凱基99購03   ,0,0,0,0,0,0,0,0,0,-14000,0,0,0,0,14000,-14000,-14000
060432,達方永豐9A購01  ,0,0,0,0,0,0,0,0,0,-14000,0,0,0,140000,154000,-14000,-14000
060512,祥碩元大9A購02  ,0,0,0,0,0,0,0,0,0,-14000,0,0,0,126000,140000,-14000,-14000
060844,大立光國票9A購07,0,0,0,0,0,0,0,0,0,-14000,0,0,0,1000,15000,-14000,-14000
061356,南電元大9A購06  ,0,2000,-2000,0,0,0,0,0,0,-12000,0,0,0,2000,14000,-12000,-14000
061273,臺股指凱基9A購23,0,0,0,0,0,0,0,0,0,-14000,0,0,0,5000,19000,-14000,-14000
06673P,大立光群益98售01,0,0,0,0,0,0,0,0,0,-14000,0,0,0,0,14000,-14000,-14000
06971P,台光電元大99售03,0,0,0,0,0,0,0,0,0,-14000,0,0,0,30000,44000,-14000,-14000
06967P,台郡台新99售02  ,0,0,0,0,0,0,0,0,0,-14000,0,0,0,0,14000,-14000,-14000
053534,微星永豐96購02  ,0,0,0,0,0,0,0,0,0,-14000,0,0,0,47000,61000,-14000,-14000
050254,大立光富邦96購02,0,0,0,0,0,0,0,0,0,-14000,0,0,0,6000,20000,-14000,-14000
048785,台積電元大96購01,0,0,0,0,0,0,0,0,0,-14000,0,0,0,0,14000,-14000,-14000
05584P,臺股指凱基96售13,0,0,0,0,0,0,0,0,0,-14000,0,0,0,1000,15000,-14000,-14000
055381,茂林元大97購02  ,0,0,0,0,0,0,0,0,0,-14000,0,0,0,11000,25000,-14000,-14000
057179,可成元大98購04  ,0,0,0,0,0,0,0,0,0,-14000,0,0,0,12000,26000,-14000,-14000
057284,新日興元大98購03,0,0,0,0,0,0,0,0,0,-14000,0,0,0,0,14000,-14000,-14000
059260,國巨中信99購05  ,0,0,0,0,0,0,0,0,0,-14000,0,0,0,20000,34000,-14000,-14000
059282,嘉聯益永豐99購01,0,0,0,0,0,0,0,0,0,-14000,0,0,0,44000,58000,-14000,-14000
058967,可成麥證99購01  ,0,0,0,0,14000,-14000,0,0,0,-14000,0,0,0,0,14000,-14000,-14000
057357,超眾統一98購01  ,0,0,0,0,0,0,0,0,0,-14000,0,0,0,40000,54000,-14000,-14000
056588,聯發科統一9A購02,0,0,0,0,0,0,0,0,0,-14000,0,0,0,616000,630000,-14000,-14000
058454,嘉晶永豐99購01  ,0,0,0,0,0,0,0,0,0,-14000,0,0,0,30000,44000,-14000,-14000
058626,瑞昱國票9A購01  ,0,0,0,0,0,0,0,0,0,-14000,0,0,0,57000,71000,-14000,-14000
058948,道瓊銀群益9C購01,0,0,0,0,0,0,0,0,0,-14000,0,0,0,0,14000,-14000,-14000
1316,上曜            ,85000,99000,-14000,0,0,0,0,0,0,0,0,0,0,0,0,0,-14000
1465,偉全            ,27000,41000,-14000,0,0,0,0,0,0,0,0,0,0,0,0,0,-14000
07768P,緯穎群益9A售02  ,0,0,0,0,0,0,0,0,0,-14000,0,0,0,0,14000,-14000,-14000
07657P,技嘉凱基9A售03  ,0,0,0,0,0,0,0,0,0,-14000,0,0,0,0,14000,-14000,-14000
07381P,鴻海群益99售05  ,0,0,0,0,0,0,0,0,0,-14000,0,0,0,0,14000,-14000,-14000
07189P,聯發科富邦9B售03,0,0,0,0,0,0,0,0,0,-14000,0,0,0,20000,34000,-14000,-14000
3494,誠研            ,0,14000,-14000,0,0,0,0,0,0,0,0,0,0,0,0,0,-14000
4545,銘鈺            ,6000,20000,-14000,0,0,0,0,0,0,0,0,0,0,0,0,0,-14000
8478,東哥遊艇        ,3000,17000,-14000,0,0,0,0,0,0,0,0,0,0,0,0,0,-14000
06683P,訊芯元大98售07  ,0,0,0,0,0,0,0,0,0,-15000,0,0,0,100000,115000,-15000,-15000
06672P,聯發科群益98售05,0,0,0,0,0,0,0,0,0,-15000,0,0,0,0,15000,-15000,-15000
06494P,鴻海永昌98售03  ,0,0,0,0,0,0,0,0,0,-15000,0,0,0,6000,21000,-15000,-15000
06189P,華新科永豐97售03,0,0,0,0,0,0,0,0,0,-15000,0,0,0,400000,415000,-15000,-15000
061652,T50反1國票9C購01,0,0,0,0,0,0,0,0,0,-15000,0,0,0,0,15000,-15000,-15000
06161P,聯發科群益97售03,0,0,0,0,0,0,0,0,0,-15000,0,0,0,0,15000,-15000,-15000
061629,FBVIX元大9A購01 ,0,0,0,0,0,0,0,0,0,-15000,0,0,0,0,15000,-15000,-15000
061553,南電群益9A購03  ,0,0,0,0,0,0,0,0,0,-15000,0,0,0,0,15000,-15000,-15000
061494,聯發科國票9A購04,0,0,0,0,0,0,0,0,0,-15000,0,0,0,14000,29000,-15000,-15000
061451,南電中信9A購03  ,0,0,0,0,0,0,0,0,0,-15000,0,0,0,10000,25000,-15000,-15000
061102,台積電元大9A購22,0,0,0,0,0,0,0,0,0,-15000,0,0,0,35000,50000,-15000,-15000
060729,國巨群益9A購05  ,0,0,0,0,0,0,0,0,0,-15000,0,0,0,200000,215000,-15000,-15000
059824,大立光凱基99購13,0,0,0,0,0,0,0,0,0,-15000,0,0,0,0,15000,-15000,-15000
059616,滬深2X群益01購04,0,0,0,0,0,0,0,0,0,-15000,0,0,0,0,15000,-15000,-15000
06023P,超眾國票96售03  ,0,0,0,0,0,0,0,0,0,-15000,0,0,0,10000,25000,-15000,-15000
060246,晶相光元大9C購03,0,0,0,0,0,0,0,0,0,-15000,0,0,0,18000,33000,-15000,-15000
060100,新光金元大9C購01,0,0,0,0,0,0,0,0,0,-15000,0,0,0,0,15000,-15000,-15000
053827,漢唐麥證9A購01  ,0,0,0,0,15000,-15000,0,0,0,-15000,0,0,0,0,15000,-15000,-15000
055420,欣興永豐98購01  ,0,0,0,0,0,0,0,0,0,-15000,0,0,0,5000,20000,-15000,-15000
053948,大立光富邦99購04,0,0,0,0,0,0,0,0,0,-15000,0,0,0,0,15000,-15000,-15000
053017,世紀鋼統一96購02,0,0,0,0,0,0,0,0,0,-15000,0,0,0,0,15000,-15000,-15000
053153,大立光元大99購02,0,0,0,0,0,0,0,0,0,-15000,0,0,0,0,15000,-15000,-15000
053368,京元電富邦98購01,0,0,0,0,0,0,0,0,0,-15000,0,0,0,30000,45000,-15000,-15000
053258,上証2X群益9A購03,0,0,0,0,0,0,0,0,0,-15000,0,0,0,70000,85000,-15000,-15000
055813,聯發科國票98購04,0,0,0,0,0,0,0,0,0,-15000,0,0,0,12000,27000,-15000,-15000
056838,旺宏元富98購01  ,0,0,0,0,0,0,0,0,0,-15000,0,0,0,11000,26000,-15000,-15000
057976,旺宏永豐98購03  ,0,0,0,0,0,0,0,0,0,-15000,0,0,0,1000,16000,-15000,-15000
058304,鴻海元大99購12  ,0,0,0,0,0,0,0,0,0,-15000,0,0,0,0,15000,-15000,-15000
054383,傳奇群益97購01  ,0,0,0,0,0,0,0,0,0,-15000,0,0,0,0,15000,-15000,-15000
054302,鴻海凱基96購18  ,0,0,0,0,0,0,0,0,0,-15000,0,0,0,35000,50000,-15000,-15000
04916P,大立光永昌96售02,0,0,0,0,0,0,0,0,0,-15000,0,0,0,0,15000,-15000,-15000
04960P,大立光凱基96售04,0,0,0,0,0,0,0,0,0,-15000,0,0,0,2000,17000,-15000,-15000
00700,富邦恒生國企    ,0,0,0,0,0,0,0,0,0,-15000,0,0,0,101000,116000,-15000,-15000
00851,台新全球AI      ,0,0,0,0,0,0,0,0,0,-15000,0,0,0,10000,25000,-15000,-15000
05248P,矽創群益96售01  ,0,0,0,0,0,0,0,0,0,-15000,0,0,0,0,15000,-15000,-15000
052234,GIS凱基97購01   ,0,0,0,0,0,0,0,0,0,-15000,0,0,0,40000,55000,-15000,-15000
053705,滬深2X凱基99購01,0,0,0,0,0,0,0,0,0,-15000,0,0,0,0,15000,-15000,-15000
051259,鴻海永昌96購03  ,0,0,0,0,0,0,0,0,0,-15000,0,0,0,0,15000,-15000,-15000
057945,京鼎國票99購03  ,0,0,0,0,0,0,0,0,0,-15000,0,0,0,28000,43000,-15000,-15000
056879,旺宏國票99購02  ,0,0,0,0,0,0,0,0,0,-15000,0,0,0,0,15000,-15000,-15000
056127,致新國票98購02  ,0,0,0,0,0,0,0,0,0,-15000,0,0,0,372000,387000,-15000,-15000
058383,道瓊指中信9C購02,0,0,0,0,0,0,0,0,0,-15000,0,0,0,0,15000,-15000,-15000
056080,世紀鋼元大97購03,0,0,0,0,0,0,0,0,0,-15000,0,0,0,0,15000,-15000,-15000
058011,台虹國票99購01  ,0,0,0,0,0,0,0,0,0,-15000,0,0,0,0,15000,-15000,-15000
05697P,友達凱基96售01  ,0,0,0,0,0,0,0,0,0,-15000,0,0,0,5000,20000,-15000,-15000
056605,台積電富邦9B購02,0,0,0,0,0,0,0,0,0,-15000,0,0,0,0,15000,-15000,-15000
057819,新日興元大99購01,0,0,0,0,0,0,0,0,0,-15000,0,0,0,0,15000,-15000,-15000
057490,可成元大98購10  ,0,0,0,0,0,0,0,0,0,-15000,0,0,0,33000,48000,-15000,-15000
059088,台積電元大99購27,0,0,0,0,0,0,0,0,0,-15000,0,0,0,0,15000,-15000,-15000
8072,陞泰            ,0,14000,-14000,0,0,0,0,0,0,-1000,0,1000,-1000,0,0,0,-15000
07230P,滬深2X群益01售02,0,0,0,0,0,0,0,0,0,-15000,0,0,0,35000,50000,-15000,-15000
07283P,華新科凱基99售07,0,0,0,0,0,0,0,0,0,-15000,0,0,0,0,15000,-15000,-15000
07847P,國巨群益9A售13  ,0,0,0,0,0,0,0,0,0,-15000,0,0,0,200000,215000,-15000,-15000
1235,興泰            ,0,15000,-15000,0,0,0,0,0,0,0,0,0,0,0,0,0,-15000
1323,永裕            ,0,15000,-15000,0,0,0,0,0,0,0,0,0,0,0,0,0,-15000
1721,三晃            ,0,15000,-15000,0,0,0,0,0,0,0,0,0,0,0,0,0,-15000
2444,兆勁            ,57000,72000,-15000,0,0,0,0,0,0,0,0,0,0,0,0,0,-15000
2431,聯昌            ,31000,46000,-15000,0,0,0,0,0,0,0,0,0,0,0,0,0,-15000
06015P,大立光富邦98售04,0,0,0,0,0,0,0,0,0,-16000,0,0,0,0,16000,-16000,-16000
060168,台表科永豐9A購01,0,0,0,0,0,0,0,0,0,-16000,0,0,0,3000,19000,-16000,-16000
059663,旭富元大9C購02  ,0,0,0,0,0,0,0,0,0,-16000,0,0,0,121000,137000,-16000,-16000
060779,臺股指凱基9A購07,0,0,0,0,0,0,0,0,0,-16000,0,0,0,1000,17000,-16000,-16000
060801,滬深2X中信01購01,0,0,0,0,0,0,0,0,0,-16000,0,0,0,85000,101000,-16000,-16000
06057P,大立光凱基98售01,0,0,0,0,0,0,0,0,0,-16000,0,0,0,0,16000,-16000,-16000
060261,臺股指凱基9A購04,0,0,0,0,0,0,0,0,0,-16000,0,0,0,0,16000,-16000,-16000
061196,世芯永豐9A購06  ,0,0,0,0,0,0,0,0,0,-16000,0,0,0,148000,164000,-16000,-16000
061191,可成永豐9A購02  ,0,0,0,0,0,0,0,0,0,-16000,0,0,0,0,16000,-16000,-16000
061558,旺宏國票9B購02  ,0,0,0,0,0,0,0,0,0,-16000,0,0,0,48000,64000,-16000,-16000
06256P,臺股指群益97售09,0,0,0,0,0,0,0,0,0,-16000,0,0,0,2000,18000,-16000,-16000
061735,上銀凱基9B購01  ,0,0,0,0,0,0,0,0,0,-16000,0,0,0,0,16000,-16000,-16000
06980P,緯穎永豐99售02  ,0,0,0,0,0,0,0,0,0,-16000,0,0,0,36000,52000,-16000,-16000
053612,T50反1群益96購01,0,0,0,0,0,0,0,0,0,-16000,0,0,0,1000,17000,-16000,-16000
054881,光罩統一97購01  ,0,0,0,0,0,0,0,0,0,-16000,0,0,0,175000,191000,-16000,-16000
050464,華通國泰95購01  ,0,0,0,0,0,0,0,0,0,-16000,0,0,0,0,16000,-16000,-16000
00681R,元大美債20反1   ,0,0,0,0,0,0,0,0,0,-16000,0,0,0,0,16000,-16000,-16000
058271,訊連永豐99購01  ,0,0,0,0,0,0,0,0,0,-16000,0,0,0,0,16000,-16000,-16000
057974,上銀永豐98購02  ,0,0,0,0,0,0,0,0,0,-16000,0,0,0,0,16000,-16000,-16000
055905,可成兆豐97購03  ,0,0,0,0,0,0,0,0,0,-16000,0,0,0,0,16000,-16000,-16000
054929,群電凱基97購01  ,0,0,0,0,0,0,0,0,0,-16000,0,0,0,34000,50000,-16000,-16000
059094,臻鼎元大99購03  ,0,0,0,0,0,0,0,0,0,-16000,0,0,0,0,16000,-16000,-16000
059109,台積電富邦9C購03,0,0,0,0,0,0,0,0,0,-16000,0,0,0,102000,118000,-16000,-16000
057488,聯發科元大99購02,0,0,0,0,0,0,0,0,0,-16000,0,0,0,0,16000,-16000,-16000
057422,欣興凱基98購04  ,0,0,0,0,0,0,0,0,0,-16000,0,0,0,0,16000,-16000,-16000
05730P,臺股指凱基97售03,0,0,0,0,0,0,0,0,0,-16000,0,0,0,0,16000,-16000,-16000
05670P,台積電國票98售01,0,0,0,0,0,0,0,0,0,-16000,0,0,0,14000,30000,-16000,-16000
058450,旺宏永豐99購01  ,0,0,0,0,0,0,0,0,0,-16000,0,0,0,0,16000,-16000,-16000
058019,美律凱基99購04  ,0,0,0,0,0,0,0,0,0,-16000,0,0,0,32000,48000,-16000,-16000
056106,晶相光永豐97購02,0,0,0,0,0,0,0,0,0,-16000,0,0,0,0,16000,-16000,-16000
056094,大立光元富97購03,0,0,0,0,0,0,0,0,0,-16000,0,0,0,15000,31000,-16000,-16000
056041,禾伸堂凱基98購03,0,0,0,0,0,0,0,0,0,-16000,0,0,0,0,16000,-16000,-16000
058196,台塑中信99購01  ,0,0,0,0,0,0,0,0,0,-16000,0,0,0,20000,36000,-16000,-16000
056937,智原元富98購01  ,0,0,0,0,0,0,0,0,0,-16000,0,0,0,32000,48000,-16000,-16000
05881P,彩晶康和96售01  ,0,0,0,0,0,0,0,0,0,-16000,0,0,0,0,16000,-16000,-16000
2427,三商電          ,0,14000,-14000,0,0,0,0,0,0,-2000,0,2000,-2000,0,0,0,-16000
1232,大統益          ,9000,23000,-14000,0,0,0,0,0,0,-2000,0,2000,-2000,0,0,0,-16000
1521,大億            ,1000,17000,-16000,0,0,0,0,0,0,0,0,0,0,0,0,0,-16000
07462P,臺股指元大9B售05,0,0,0,0,0,0,0,0,0,-16000,0,0,0,15000,31000,-16000,-16000
6164,華興            ,2000,15000,-13000,0,0,0,0,0,0,-3000,0,3000,-3000,0,0,0,-16000
061463,智邦群益9A購02  ,0,0,0,0,0,0,0,0,0,-17000,0,0,0,40000,57000,-17000,-17000
061400,可成兆豐9B購02  ,0,0,0,0,0,0,0,0,0,-17000,0,0,0,0,17000,-17000,-17000
061381,台灣50群益9B購07,0,0,0,0,0,0,0,0,0,-17000,0,0,0,86000,103000,-17000,-17000
060747,聯鈞國票9A購02  ,0,0,0,0,0,0,0,0,0,-17000,0,0,0,6000,23000,-17000,-17000
060089,台積電元大99購54,0,0,0,0,0,0,0,0,0,-17000,0,0,0,1000,18000,-17000,-17000
056020,義隆群益97購01  ,0,0,0,0,0,0,0,0,0,-17000,0,0,0,52000,69000,-17000,-17000
056038,可成凱基97購01  ,0,0,0,0,0,0,0,0,0,-17000,0,0,0,3000,20000,-17000,-17000
056404,嘉聯益群益9A購01,0,0,0,0,0,0,0,0,0,-17000,0,0,0,224000,241000,-17000,-17000
058791,鴻海元大99購17  ,0,0,0,0,0,0,0,0,0,-17000,0,0,0,0,17000,-17000,-17000
059038,健策群益9A購02  ,0,0,0,0,0,0,0,0,0,-17000,0,0,0,20000,37000,-17000,-17000
059195,國巨永豐99購04  ,0,0,0,0,0,0,0,0,0,-17000,0,0,0,0,17000,-17000,-17000
059165,南亞科凱基99購04,0,0,0,0,0,0,0,0,0,-17000,0,0,0,0,17000,-17000,-17000
8039,台虹            ,312000,335000,-23000,0,0,0,0,0,0,6000,10000,0,10000,33000,37000,-4000,-17000
4912,聯德控股-KY     ,1000,18000,-17000,0,0,0,0,0,0,0,0,0,0,0,0,0,-17000
8940,新天地          ,1000,18000,-17000,0,0,0,0,0,0,0,0,0,0,0,0,0,-17000
07422P,大立光元大99售32,0,0,0,0,0,0,0,0,0,-17000,0,0,0,0,17000,-17000,-17000
07413P,國巨元大99售33  ,0,0,0,0,0,0,0,0,0,-17000,0,0,0,150000,167000,-17000,-17000
07059P,華通國票9A售02  ,0,0,0,0,0,0,0,0,0,-17000,0,0,0,13000,30000,-17000,-17000
2359,所羅門          ,55000,70000,-15000,0,0,0,0,0,0,-2000,0,2000,-2000,0,0,0,-17000
2514,龍邦            ,76000,93000,-17000,0,0,0,0,0,0,0,0,0,0,0,0,0,-17000
2727,王品            ,61000,78000,-17000,0,0,0,0,0,0,0,0,0,0,0,0,0,-17000
5269,祥碩            ,192816,172000,20816,0,0,0,0,15000,-15000,-23000,5000,21000,-16000,2000,9000,-7000,-17184
06060P,玉晶光元大97售03,0,0,0,0,0,0,0,0,0,-18000,0,0,0,0,18000,-18000,-18000
061513,華新科永豐9A購04,0,0,0,0,0,0,0,0,0,-18000,0,0,0,8000,26000,-18000,-18000
061546,大立光群益9A購05,0,0,0,0,0,0,0,0,0,-18000,0,0,0,41000,59000,-18000,-18000
061121,智邦永豐9A購02  ,0,0,0,0,0,0,0,0,0,-18000,0,0,0,2000,20000,-18000,-18000
06385P,聯發科永豐97售02,0,0,0,0,0,0,0,0,0,-18000,0,0,0,139000,157000,-18000,-18000
055123,億光兆豐97購01  ,0,0,0,0,0,0,0,0,0,-18000,0,0,0,50000,68000,-18000,-18000
055862,矽力元大97購04  ,0,0,0,0,0,0,0,0,0,-18000,0,0,0,0,18000,-18000,-18000
057221,華通國票98購03  ,0,0,0,0,0,0,0,0,0,-18000,0,0,0,29000,47000,-18000,-18000
056551,台郡凱基98購04  ,0,0,0,0,0,0,0,0,0,-18000,0,0,0,0,18000,-18000,-18000
057791,可成統一99購01  ,0,0,0,0,0,0,0,0,0,-18000,0,0,0,2000,20000,-18000,-18000
056467,上証2X元大98購02,0,0,0,0,0,0,0,0,0,-18000,0,0,0,2000,20000,-18000,-18000
057747,致新永豐98購01  ,0,0,0,0,0,0,0,0,0,-18000,0,0,0,246000,264000,-18000,-18000
056213,建準國票98購02  ,0,0,0,0,0,0,0,0,0,-18000,0,0,0,4000,22000,-18000,-18000
055703,緯穎富邦98購01  ,0,0,0,0,0,0,0,0,0,-18000,0,0,0,23000,41000,-18000,-18000
9902,台火            ,17000,35000,-18000,0,0,0,0,0,0,0,0,0,0,0,0,0,-18000
2838A,聯邦銀甲特      ,0,18000,-18000,0,0,0,0,0,0,0,0,0,0,0,0,0,-18000
1726,永記            ,1000,19000,-18000,0,0,0,0,0,0,0,0,0,0,0,0,0,-18000
07044P,台積電元大99售13,0,0,0,0,0,0,0,0,0,-18000,0,0,0,0,18000,-18000,-18000
07067P,旺宏台新99售02  ,0,0,0,0,0,0,0,0,0,-18000,0,0,0,0,18000,-18000,-18000
07505P,台勝科元大9A售01,0,0,0,0,0,0,0,0,0,-18000,0,0,0,0,18000,-18000,-18000
061703,信邦國票9A購01  ,0,0,0,0,0,0,0,0,0,-19000,0,0,0,0,19000,-19000,-19000
060418,中橡永豐9A購01  ,0,0,0,0,0,0,0,0,0,-19000,0,0,0,61000,80000,-19000,-19000
059731,康控元大99購04  ,0,0,0,0,0,0,0,0,0,-19000,0,0,0,19000,38000,-19000,-19000
058359,瑞昱凱基99購01  ,0,0,0,0,0,0,0,0,0,-19000,0,0,0,17000,36000,-19000,-19000
05426P,聯發科凱基95售12,0,0,0,0,0,0,0,0,0,-19000,0,0,0,1000,20000,-19000,-19000
05463P,創意國票96售04  ,0,0,0,0,0,0,0,0,0,-19000,0,0,0,0,19000,-19000,-19000
00672L,元大S&P原油正2  ,0,219000,-219000,0,0,0,0,0,0,200000,0,0,0,400000,200000,200000,-19000
046813,聯電凱基96購01  ,0,0,0,0,0,0,0,0,0,-19000,0,0,0,0,19000,-19000,-19000
052130,國巨凱基9B購01  ,0,0,0,0,0,0,0,0,0,-19000,0,0,0,23000,42000,-19000,-19000
055668,欣興群益97購01  ,0,0,0,0,0,0,0,0,0,-19000,0,0,0,1000,20000,-19000,-19000
058430,滬深2X統一99購02,0,0,0,0,0,0,0,0,0,-19000,0,0,0,0,19000,-19000,-19000
056984,嘉晶群益98購01  ,0,0,0,0,0,0,0,0,0,-19000,0,0,0,95000,114000,-19000,-19000
058189,嘉澤永豐99購01  ,0,0,0,0,0,0,0,0,0,-19000,0,0,0,1000,20000,-19000,-19000
055919,景碩凱基98購02  ,0,0,0,0,0,0,0,0,0,-19000,0,0,0,21000,40000,-19000,-19000
058820,致茂國泰9B購01  ,0,0,0,0,0,0,0,0,0,-19000,0,0,0,5000,24000,-19000,-19000
057646,玉山金元大98購01,0,0,0,0,0,0,0,0,0,-19000,0,0,0,76000,95000,-19000,-19000
057863,美律凱基9A購01  ,0,0,0,0,0,0,0,0,0,-19000,0,0,0,46000,65000,-19000,-19000
059084,鴻海元大99購24  ,0,0,0,0,0,0,0,0,0,-19000,0,0,0,0,19000,-19000,-19000
059224,大立光元大99購15,0,0,0,0,0,0,0,0,0,-19000,0,0,0,61000,80000,-19000,-19000
07786P,南電中信9C售01  ,0,0,0,0,0,0,0,0,0,-19000,0,0,0,16000,35000,-19000,-19000
07041P,T50反1元大9C售01,0,0,0,0,0,0,0,0,0,-19000,0,0,0,0,19000,-19000,-19000
07190P,臺股指富邦9C售02,0,0,0,0,0,0,0,0,0,-19000,0,0,0,11000,30000,-19000,-19000
07452P,國巨元大9A售05  ,0,0,0,0,0,0,0,0,0,-19000,0,0,0,86000,105000,-19000,-19000
07267P,臺股指元大99售23,0,0,0,0,0,0,0,0,0,-19000,0,0,0,4000,23000,-19000,-19000
1707,葡萄王          ,92000,112000,-20000,0,0,0,0,0,0,1000,2000,0,2000,0,1000,-1000,-19000
2302,麗正            ,0,19000,-19000,0,0,0,0,0,0,0,0,0,0,0,0,0,-19000
1436,華友聯          ,12000,31000,-19000,0,0,0,0,0,0,0,0,0,0,0,0,0,-19000
3094,聯傑            ,31000,50000,-19000,0,0,0,0,0,0,0,0,0,0,0,0,0,-19000
05978P,麗豐永豐96售02  ,0,0,0,0,0,0,0,0,0,-20000,0,0,0,0,20000,-20000,-20000
059697,上証2X凱基9A購03,0,0,0,0,0,0,0,0,0,-20000,0,0,0,0,20000,-20000,-20000
059519,台郡永豐99購01  ,0,0,0,0,0,0,0,0,0,-20000,0,0,0,0,20000,-20000,-20000
060035,臺股指永豐99購04,0,0,0,0,0,0,0,0,0,-20000,0,0,0,0,20000,-20000,-20000
060538,S&P反1凱基9A購01,0,0,0,0,0,0,0,0,0,-20000,0,0,0,10000,30000,-20000,-20000
060644,泰鼎永豐9A購02  ,0,0,0,0,0,0,0,0,0,-20000,0,0,0,53000,73000,-20000,-20000
060872,高股息中信02購01,0,0,0,0,0,0,0,0,0,-20000,0,0,0,0,20000,-20000,-20000
06376P,上銀統一99售01  ,0,0,0,0,0,0,0,0,0,-20000,0,0,0,0,20000,-20000,-20000
061746,國巨統一9C購07  ,0,0,0,0,0,0,0,0,0,-20000,0,0,0,0,20000,-20000,-20000
061718,GIS凱基9B購01   ,0,0,0,0,0,0,0,0,0,-20000,0,0,0,0,20000,-20000,-20000
06247P,同欣電元富97售02,0,0,0,0,0,0,0,0,0,-20000,0,0,0,0,20000,-20000,-20000
06901P,亞德客凱基98售02,0,0,0,0,0,0,0,0,0,-20000,0,0,0,0,20000,-20000,-20000
06857P,超眾永豐98售02  ,0,0,0,0,0,0,0,0,0,-20000,0,0,0,0,20000,-20000,-20000
06802P,緯穎群益98售03  ,0,0,0,0,0,0,0,0,0,-20000,0,0,0,0,20000,-20000,-20000
06489P,台積電元富98售06,0,0,0,0,0,0,0,0,0,-20000,0,0,0,0,20000,-20000,-20000
06566P,華通永豐98售03  ,0,0,0,0,0,0,0,0,0,-20000,0,0,0,40000,60000,-20000,-20000
06652P,長榮航元大98售01,0,0,0,0,0,0,0,0,0,-20000,0,0,0,10000,30000,-20000,-20000
06682P,玉晶光元大99售08,0,0,0,0,0,0,0,0,0,-20000,0,0,0,1420000,1440000,-20000,-20000
06114P,台積電統一97售03,0,0,0,0,0,0,0,0,0,-20000,0,0,0,20000,40000,-20000,-20000
061212,聯鈞元大9A購04  ,0,0,0,0,0,0,0,0,0,-20000,0,0,0,10000,30000,-20000,-20000
061226,台積電中信9A購05,0,0,0,0,0,0,0,0,0,-20000,0,0,0,0,20000,-20000,-20000
061208,聯發科元大9A購09,0,0,0,0,0,0,0,0,0,-20000,0,0,0,88000,108000,-20000,-20000
061016,可成麥證9A購01  ,0,0,0,0,20000,-20000,0,0,0,-20000,0,0,0,0,20000,-20000,-20000
060979,國巨元大9A購14  ,2000,0,2000,0,0,0,0,0,0,-22000,0,0,0,65000,87000,-22000,-20000
061348,聯鈞元大9A購05  ,0,0,0,0,0,0,0,0,0,-20000,0,0,0,0,20000,-20000,-20000
061261,台積電凱基9B購03,0,0,0,0,0,0,0,0,0,-20000,0,0,0,10000,30000,-20000,-20000
061315,滬深2X凱基9C購06,0,0,0,0,0,0,0,0,0,-20000,0,0,0,0,20000,-20000,-20000
052326,滬深反中信99購01,0,0,0,0,0,0,0,0,0,-20000,0,0,0,85000,105000,-20000,-20000
052413,上証反中信97購01,0,0,0,0,0,0,0,0,0,-20000,0,0,0,0,20000,-20000,-20000
052429,禾伸堂永豐95購02,0,0,0,0,0,0,0,0,0,-20000,0,0,0,0,20000,-20000,-20000
050099,台積電永昌96購01,0,0,0,0,0,0,0,0,0,-20000,0,0,0,100000,120000,-20000,-20000
00688L,國泰20年美債正2 ,0,0,0,0,0,0,0,0,0,-20000,0,0,0,100000,120000,-20000,-20000
049255,旺宏元大97購02  ,0,0,0,0,0,0,0,0,0,-20000,0,0,0,99000,119000,-20000,-20000
048801,漢唐富邦96購02  ,0,0,0,0,0,0,0,0,0,-20000,0,0,0,0,20000,-20000,-20000
048681,漢唐富邦96購01  ,0,0,0,0,0,0,0,0,0,-20000,0,0,0,0,20000,-20000,-20000
03033P,微星國票03售01  ,0,20000,-20000,0,0,0,0,0,0,0,0,0,0,0,0,0,-20000
03017X,元展17          ,0,0,0,0,0,0,0,0,0,-20000,0,0,0,0,20000,-20000,-20000
045836,群創群益98購01  ,0,0,0,0,0,0,0,0,0,-20000,0,0,0,0,20000,-20000,-20000
05063P,聯電元大96售03  ,0,0,0,0,0,0,0,0,0,-20000,0,0,0,0,20000,-20000,-20000
050406,台積電台新95購02,0,0,0,0,0,0,0,0,0,-20000,0,0,0,200000,220000,-20000,-20000
054837,欣興第一97購01  ,0,0,0,0,0,0,0,0,0,-20000,0,0,0,0,20000,-20000,-20000
053760,牧德國泰98購01  ,0,0,0,0,0,0,0,0,0,-20000,0,0,0,0,20000,-20000,-20000
054804,南亞元大9A購01  ,0,0,0,0,0,0,0,0,0,-20000,0,0,0,0,20000,-20000,-20000
054745,智易凱基97購01  ,0,0,0,0,0,0,0,0,0,-20000,0,0,0,0,20000,-20000,-20000
051510,新光金中信97購01,0,0,0,0,0,0,0,0,0,-20000,0,0,0,0,20000,-20000,-20000
051483,玉晶光凱基96購02,0,0,0,0,0,0,0,0,0,-20000,0,0,0,5000,25000,-20000,-20000
051390,京元電兆豐95購01,0,0,0,0,0,0,0,0,0,-20000,0,0,0,0,20000,-20000,-20000
051758,瑞昱元大95購01  ,0,0,0,0,0,0,0,0,0,-20000,0,0,0,0,20000,-20000,-20000
051694,A50正2中信96購03,0,0,0,0,0,0,0,0,0,-20000,0,0,0,0,20000,-20000,-20000
05201P,玉晶光國泰97售02,0,0,0,0,0,0,0,0,0,-20000,0,0,0,801000,821000,-20000,-20000
051926,聯電中信97購01  ,0,0,0,0,0,0,0,0,0,-20000,0,0,0,0,20000,-20000,-20000
052708,楠梓電永豐97購01,0,0,0,0,0,0,0,0,0,-20000,0,0,0,0,20000,-20000,-20000
052759,京元電群益96購01,0,0,0,0,0,0,0,0,0,-20000,0,0,0,49000,69000,-20000,-20000
052695,台表科中信98購01,0,0,0,0,0,0,0,0,0,-20000,0,0,0,0,20000,-20000,-20000
052692,滬深2X中信99購02,0,0,0,0,0,0,0,0,0,-20000,0,0,0,0,20000,-20000,-20000
054641,祥碩中信98購01  ,0,0,0,0,0,0,0,0,0,-20000,0,0,0,0,20000,-20000,-20000
054463,瑞昱凱基97購01  ,0,0,0,0,0,0,0,0,0,-20000,0,0,0,0,20000,-20000,-20000
054608,致茂永豐97購01  ,0,0,0,0,0,0,0,0,0,-20000,0,0,0,0,20000,-20000,-20000
054545,奇力新中信98購01,0,0,0,0,0,0,0,0,0,-20000,0,0,0,0,20000,-20000,-20000
055244,國巨統一98購01  ,0,0,0,0,0,0,0,0,0,-20000,0,0,0,0,20000,-20000,-20000
054280,牧德群益98購01  ,0,0,0,0,0,0,0,0,0,-20000,0,0,0,0,20000,-20000,-20000
054213,欣興國票97購04  ,0,0,0,0,0,0,0,0,0,-20000,0,0,0,3000,23000,-20000,-20000
058295,欣興凱基99購02  ,0,0,0,0,0,0,0,0,0,-20000,0,0,0,144000,164000,-20000,-20000
057981,臻鼎永豐98購01  ,0,0,0,0,0,0,0,0,0,-20000,0,0,0,0,20000,-20000,-20000
055842,建準元大98購01  ,0,0,0,0,0,0,0,0,0,-20000,0,0,0,0,20000,-20000,-20000
056829,台積電富邦9A購01,0,0,0,0,0,0,0,0,0,-20000,0,0,0,0,20000,-20000,-20000
054077,中石化中信98購01,0,0,0,0,0,0,0,0,0,-20000,0,0,0,0,20000,-20000,-20000
05509P,智邦元富96售02  ,0,0,0,0,0,0,0,0,0,-20000,0,0,0,10000,30000,-20000,-20000
053422,可成永豐96購01  ,0,0,0,0,0,0,0,0,0,-20000,0,0,0,0,20000,-20000,-20000
053259,卜蜂群益97購01  ,0,0,0,0,0,0,0,0,0,-20000,0,0,0,10000,30000,-20000,-20000
053369,T50反1元大96購06,0,0,0,0,0,0,0,0,0,-20000,0,0,0,0,20000,-20000,-20000
053354,康控兆豐97購02  ,0,0,0,0,0,0,0,0,0,-20000,0,0,0,0,20000,-20000,-20000
053051,楠梓電國票97購01,0,0,0,0,0,0,0,0,0,-20000,0,0,0,0,20000,-20000,-20000
054926,神達凱基98購01  ,0,0,0,0,0,0,0,0,0,-20000,0,0,0,0,20000,-20000,-20000
053023,泰鼎國泰97購01  ,0,0,0,0,0,0,0,0,0,-20000,0,0,0,0,20000,-20000,-20000
052969,建準群益97購01  ,0,0,0,0,0,0,0,0,0,-20000,0,0,0,0,20000,-20000,-20000
055425,聚陽群益99購01  ,0,0,0,0,0,0,0,0,0,-20000,0,0,0,10000,30000,-20000,-20000
055435,佳世達中信99購01,0,0,0,0,0,0,0,0,0,-20000,0,0,0,0,20000,-20000,-20000
053799,矽創中信9A購01  ,0,0,0,0,0,0,0,0,0,-20000,0,0,0,0,20000,-20000,-20000
059150,臺股指國票99購13,0,0,0,0,0,0,0,0,0,-20000,0,0,0,2000,22000,-20000,-20000
059142,道瓊指國票9B購02,0,0,0,0,0,0,0,0,0,-20000,0,0,0,4000,24000,-20000,-20000
059135,臺股指群益99購10,0,0,0,0,0,0,0,0,0,-20000,0,0,0,0,20000,-20000,-20000
059346,新日興凱基99購03,0,0,0,0,0,0,0,0,0,-20000,0,0,0,0,20000,-20000,-20000
059502,台灣50台新9B購04,0,0,0,0,0,0,0,0,0,-20000,0,0,0,0,20000,-20000,-20000
059489,上証2X國票9A購01,0,0,0,0,0,0,0,0,0,-20000,0,0,0,0,20000,-20000,-20000
059125,台積電第一03購02,0,0,0,0,0,0,0,0,0,-20000,0,0,0,0,20000,-20000,-20000
057145,上銀國票98購03  ,0,0,0,0,0,0,0,0,0,-20000,0,0,0,0,20000,-20000,-20000
056280,上証2X永豐98購01,0,0,0,0,0,0,0,0,0,-20000,0,0,0,0,20000,-20000,-20000
056460,同欣電凱基99購01,0,0,0,0,0,0,0,0,0,-20000,0,0,0,0,20000,-20000,-20000
056472,美律元大99購03  ,0,0,0,0,0,0,0,0,0,-20000,0,0,0,0,20000,-20000,-20000
056610,鴻海永豐98購01  ,0,0,0,0,0,0,0,0,0,-20000,0,0,0,0,20000,-20000,-20000
058986,華新科凱基9A購03,0,0,0,0,0,0,0,0,0,-20000,0,0,0,2000,22000,-20000,-20000
058983,旺宏凱基99購05  ,0,0,0,0,0,0,0,0,0,-20000,0,0,0,6000,26000,-20000,-20000
058984,全新凱基9A購03  ,0,0,0,0,0,0,0,0,0,-20000,0,0,0,4000,24000,-20000,-20000
057396,健鼎中信99購01  ,0,0,0,0,0,0,0,0,0,-20000,0,0,0,0,20000,-20000,-20000
057534,旭富元大98購01  ,0,0,0,0,0,0,0,0,0,-20000,0,0,0,0,20000,-20000,-20000
057889,致新群益99購01  ,0,0,0,0,0,0,0,0,0,-20000,0,0,0,0,20000,-20000,-20000
056890,國巨元大98購11  ,0,0,0,0,0,0,0,0,0,-20000,0,0,0,60000,80000,-20000,-20000
056914,臺股指元大99購09,0,0,0,0,0,0,0,0,0,-20000,0,0,0,0,20000,-20000,-20000
056885,元油2X元大99購03,0,0,0,0,0,0,0,0,0,-20000,0,0,0,20000,40000,-20000,-20000
058511,華新科元大9B購01,0,0,0,0,0,0,0,0,0,-20000,0,0,0,0,20000,-20000,-20000
058499,滬深2X元大9C購01,0,0,0,0,0,0,0,0,0,-20000,0,0,0,0,20000,-20000,-20000
058048,群創元大9B購07  ,0,0,0,0,0,0,0,0,0,-20000,0,0,0,0,20000,-20000,-20000
05807P,泰鼎永豐96售03  ,0,0,0,0,0,0,0,0,0,-20000,0,0,0,0,20000,-20000,-20000
056000,佳世達永豐97購01,0,0,0,0,0,0,0,0,0,-20000,0,0,0,0,20000,-20000,-20000
056966,嘉晶永豐98購01  ,0,0,0,0,0,0,0,0,0,-20000,0,0,0,63000,83000,-20000,-20000
055586,旺宏元大98購06  ,0,0,0,0,0,0,0,0,0,-20000,0,0,0,15000,35000,-20000,-20000
055479,GIS凱基97購04   ,0,0,0,0,0,0,0,0,0,-20000,0,0,0,0,20000,-20000,-20000
055505,新唐元大97購02  ,0,0,0,0,0,0,0,0,0,-20000,0,0,0,0,20000,-20000,-20000
057758,鴻海凱基99購03  ,0,0,0,0,0,0,0,0,0,-20000,0,0,0,0,20000,-20000,-20000
057750,神達國票99購01  ,0,0,0,0,0,0,0,0,0,-20000,0,0,0,0,20000,-20000,-20000
056412,上証2X中信9A購02,0,0,0,0,0,0,0,0,0,-20000,0,0,0,0,20000,-20000,-20000
058623,國巨國票99購08  ,0,0,0,0,0,0,0,0,0,-20000,0,0,0,0,20000,-20000,-20000
055473,禾伸堂凱基97購01,0,0,0,0,0,0,0,0,0,-20000,0,0,0,0,20000,-20000,-20000
2904,匯僑            ,0,20000,-20000,0,0,0,0,0,0,0,0,0,0,0,0,0,-20000
3018,同開            ,35000,55000,-20000,0,0,0,0,0,0,0,0,0,0,0,0,0,-20000
2467,志聖            ,96000,115000,-19000,0,0,0,0,0,0,-1000,1000,2000,-1000,0,0,0,-20000
1441,大東            ,0,20000,-20000,0,0,0,0,0,0,0,0,0,0,0,0,0,-20000
1903,士紙            ,0,20000,-20000,0,0,0,0,0,0,0,0,0,0,0,0,0,-20000
07360P,台積電元大99售46,0,0,0,0,0,0,0,0,0,-20000,0,0,0,20000,40000,-20000,-20000
07362P,聯發科元大99售35,0,0,0,0,0,0,0,0,0,-20000,0,0,0,0,20000,-20000,-20000
07021P,台積電富邦9C售02,0,0,0,0,0,0,0,0,0,-20000,0,0,0,0,20000,-20000,-20000
07699P,臺股指元大9A售52,0,0,0,0,0,0,0,0,0,-20000,0,0,0,0,20000,-20000,-20000
07703P,玉晶光中信9B售03,0,0,0,0,0,0,0,0,0,-20000,0,0,0,0,20000,-20000,-20000
07460P,臺股指元大9B售03,0,0,0,0,0,0,0,0,0,-20000,0,0,0,0,20000,-20000,-20000
07525P,臺股指中信9B售07,0,0,0,0,0,0,0,0,0,-20000,0,0,0,0,20000,-20000,-20000
07661P,台灣50兆豐9A售03,0,0,0,0,0,0,0,0,0,-20000,0,0,0,0,20000,-20000,-20000
07577P,華新科元大9A售09,0,0,0,0,0,0,0,0,0,-20000,0,0,0,25000,45000,-20000,-20000
3694,海華            ,0,18000,-18000,0,0,0,0,0,0,-2000,0,2000,-2000,0,0,0,-20000
061580,華擎元大9A購06  ,0,0,0,0,0,0,0,0,0,-21000,0,0,0,0,21000,-21000,-21000
060730,台積電群益9A購03,0,0,0,0,0,0,0,0,0,-21000,0,0,0,19000,40000,-21000,-21000
060355,元金2X元富9C購01,0,0,0,0,0,0,0,0,0,-21000,0,0,0,0,21000,-21000,-21000
059954,華新科康和99購01,0,0,0,0,0,0,0,0,0,-21000,0,0,0,0,21000,-21000,-21000
060185,聯發科元富04購01,0,0,0,0,0,0,0,0,0,-21000,0,0,0,22000,43000,-21000,-21000
050424,鴻海凱基96購03  ,0,0,0,0,0,0,0,0,0,-21000,0,0,0,0,21000,-21000,-21000
00657,國泰日經225     ,0,49000,-49000,0,0,0,0,0,0,28000,0,0,0,162000,134000,28000,-21000
00736,國泰新興市場    ,0,126000,-126000,0,0,0,0,0,0,105000,0,0,0,130000,25000,105000,-21000
055780,禾伸堂凱基99購01,0,0,0,0,0,0,0,0,0,-21000,0,0,0,0,21000,-21000,-21000
055781,聯詠凱基98購01  ,0,0,0,0,0,0,0,0,0,-21000,0,0,0,0,21000,-21000,-21000
055515,聚陽中信9A購01  ,0,0,0,0,0,0,0,0,0,-21000,0,0,0,0,21000,-21000,-21000
056076,超眾元大97購05  ,0,0,0,0,0,0,0,0,0,-21000,0,0,0,42000,63000,-21000,-21000
05813P,臺股指國票96售06,0,0,0,0,0,0,0,0,0,-21000,0,0,0,0,21000,-21000,-21000
058498,世紀鋼群益99購01,0,0,0,0,0,0,0,0,0,-21000,0,0,0,132000,153000,-21000,-21000
057903,聯鈞永豐99購01  ,0,0,0,0,0,0,0,0,0,-21000,0,0,0,0,21000,-21000,-21000
057308,同欣電兆豐99購01,0,0,0,0,0,0,0,0,0,-21000,0,0,0,12000,33000,-21000,-21000
056473,奇力新元大99購02,0,0,0,0,0,0,0,0,0,-21000,0,0,0,89000,110000,-21000,-21000
057148,玉晶光國票99購04,0,0,0,0,0,0,0,0,0,-21000,0,0,0,72000,93000,-21000,-21000
4144,康聯-KY         ,33000,54000,-21000,0,0,0,0,0,0,0,0,0,0,0,0,0,-21000
6655,科定            ,3000,24000,-21000,0,0,0,0,0,0,0,0,0,0,0,0,0,-21000
6224,聚鼎            ,42000,63000,-21000,0,0,0,0,0,0,0,2000,2000,0,0,0,0,-21000
3027,盛達            ,5000,25000,-20000,0,0,0,0,0,0,-1000,0,1000,-1000,0,0,0,-21000
060145,牧德國票9A購02  ,0,0,0,0,0,0,0,0,0,-22000,0,0,0,42000,64000,-22000,-22000
059979,台積電元大99購49,0,0,0,0,0,0,0,0,0,-22000,0,0,0,0,22000,-22000,-22000
060007,鴻海群益99購04  ,0,0,0,0,0,0,0,0,0,-22000,0,0,0,76000,98000,-22000,-22000
060085,華通元大99購10  ,0,0,0,0,0,0,0,0,0,-22000,0,0,0,52000,74000,-22000,-22000
060524,國巨中信9A購03  ,0,0,0,0,0,0,0,0,0,-22000,0,0,0,20000,42000,-22000,-22000
060575,大立光中信9B購02,0,0,0,0,0,0,0,0,0,-22000,0,0,0,10000,32000,-22000,-22000
060775,世芯凱基9A購02  ,0,0,0,0,0,0,0,0,0,-22000,0,0,0,21000,43000,-22000,-22000
061602,旺宏凱基9A購06  ,0,0,0,0,0,0,0,0,0,-22000,0,0,0,7000,29000,-22000,-22000
061056,臺指反國票02購01,0,0,0,0,0,0,0,0,0,-22000,0,0,0,18000,40000,-22000,-22000
061211,玉晶光元大9A購12,0,0,0,0,0,0,0,0,0,-22000,0,0,0,0,22000,-22000,-22000
052784,緯穎國票97購02  ,0,0,0,0,0,0,0,0,0,-22000,0,0,0,0,22000,-22000,-22000
053570,京元電統一96購01,0,0,0,0,0,0,0,0,0,-22000,0,0,0,48000,70000,-22000,-22000
058005,茂林群益98購04  ,0,0,0,0,0,0,0,0,0,-22000,0,0,0,10000,32000,-22000,-22000
058389,聯茂國票9A購01  ,0,0,0,0,0,0,0,0,0,-22000,0,0,0,1000,23000,-22000,-22000
057548,微星凱基99購01  ,0,0,0,0,0,0,0,0,0,-22000,0,0,0,14000,36000,-22000,-22000
057591,鴻海兆豐99購01  ,0,0,0,0,0,0,0,0,0,-22000,0,0,0,0,22000,-22000,-22000
056860,正崴群益98購01  ,0,0,0,0,0,0,0,0,0,-22000,0,0,0,62000,84000,-22000,-22000
056122,勤誠群益97購02  ,0,0,0,0,0,0,0,0,0,-22000,0,0,0,158000,180000,-22000,-22000
058881,全新永豐99購01  ,0,0,0,0,0,0,0,0,0,-22000,0,0,0,0,22000,-22000,-22000
2491,吉祥全          ,0,22000,-22000,0,0,0,0,0,0,0,0,0,0,0,0,0,-22000
2506,太設            ,0,22000,-22000,0,0,0,0,0,0,0,0,0,0,0,0,0,-22000
2436,偉詮電          ,285000,306000,-21000,0,0,0,0,0,0,-1000,0,1000,-1000,0,0,0,-22000
07071P,立積元富99售01  ,0,0,0,0,0,0,0,0,0,-22000,0,0,0,65000,87000,-22000,-22000
07192P,聯發科元大99售23,0,0,0,0,0,0,0,0,0,-22000,0,0,0,9000,31000,-22000,-22000
6698,旭暉應材        ,17000,59000,-42000,0,0,0,0,0,0,20000,20000,0,20000,0,0,0,-22000
6128,上福            ,0,22000,-22000,0,0,0,0,0,0,0,0,0,0,0,0,0,-22000
6706,惠特            ,98000,97912,88,0,0,0,0,0,0,-23000,0,23000,-23000,0,0,0,-22912
061570,瑞昱元大9A購05  ,0,0,0,0,0,0,0,0,0,-23000,0,0,0,360000,383000,-23000,-23000
059646,聯茂凱基99購06  ,0,0,0,0,0,0,0,0,0,-23000,0,0,0,47000,70000,-23000,-23000
059812,上証2X凱基9A購04,0,0,0,0,0,0,0,0,0,-23000,0,0,0,0,23000,-23000,-23000
054121,奇鋐永豐96購02  ,0,0,0,0,0,0,0,0,0,-23000,0,0,0,160000,183000,-23000,-23000
055380,智易元大98購02  ,0,0,0,0,0,0,0,0,0,-23000,0,0,0,0,23000,-23000,-23000
054883,億光統一97購01  ,0,0,0,0,0,0,0,0,0,-23000,0,0,0,94000,117000,-23000,-23000
03669C,滬深2X元富09牛01,0,0,0,0,0,0,0,0,0,-23000,0,0,0,30000,53000,-23000,-23000
058611,欣興元大99購06  ,0,0,0,0,0,0,0,0,0,-23000,0,0,0,10000,33000,-23000,-23000
058477,億光凱基9A購01  ,0,0,0,0,0,0,0,0,0,-23000,0,0,0,0,23000,-23000,-23000
057707,臺股指群益98購07,0,0,0,0,0,0,0,0,0,-23000,0,0,0,149000,172000,-23000,-23000
058174,台積電凱基9A購05,0,0,0,0,0,0,0,0,0,-23000,0,0,0,1000,24000,-23000,-23000
057935,晶技群益98購02  ,0,0,0,0,0,0,0,0,0,-23000,0,0,0,7000,30000,-23000,-23000
056634,為升兆豐99購01  ,0,0,0,0,0,0,0,0,0,-23000,0,0,0,0,23000,-23000,-23000
059151,臺股指國票99購14,0,0,0,0,0,0,0,0,0,-23000,0,0,0,6000,29000,-23000,-23000
3167,大量            ,3000,26000,-23000,0,0,0,0,0,0,0,0,0,0,0,0,0,-23000
07194P,聯發科元大99售25,0,0,0,0,0,0,0,0,0,-23000,0,0,0,2000,25000,-23000,-23000
07678P,大立光群益9A售03,0,0,0,0,0,0,0,0,0,-23000,0,0,0,0,23000,-23000,-23000
07856P,力成凱基9A售02  ,0,0,0,0,0,0,0,0,0,-23000,0,0,0,0,23000,-23000,-23000
07873P,華新科群益9B售03,0,0,0,0,0,0,0,0,0,-23000,0,0,0,0,23000,-23000,-23000
1445,大宇            ,0,23000,-23000,0,0,0,0,0,0,0,0,0,0,0,0,0,-23000
1526,日馳            ,57000,80000,-23000,0,0,0,0,0,0,0,0,0,0,0,0,0,-23000
1325,恆大            ,29000,8000,21000,0,0,0,0,0,0,-44000,0,0,0,11000,55000,-44000,-23000
061605,華新科凱基9A購14,0,0,0,0,0,0,0,0,0,-24000,0,0,0,0,24000,-24000,-24000
061653,上証2X國票9A購02,0,0,0,0,0,0,0,0,0,-24000,0,0,0,1000,25000,-24000,-24000
061654,旺宏國票9A購02  ,0,0,0,0,0,0,0,0,0,-24000,0,0,0,0,24000,-24000,-24000
06657P,寶成元大98售01  ,0,0,0,0,0,0,0,0,0,-24000,0,0,0,208000,232000,-24000,-24000
06490P,鴻海富邦99售02  ,0,0,0,0,0,0,0,0,0,-24000,0,0,0,2000,26000,-24000,-24000
06889P,臺股指元大98售13,0,0,0,0,0,0,0,0,0,-24000,0,0,0,36000,60000,-24000,-24000
061365,國巨國票9B購05  ,0,0,0,0,0,0,0,0,0,-24000,0,0,0,203000,227000,-24000,-24000
061508,南六國泰9C購02  ,0,0,0,0,0,0,0,0,0,-24000,0,0,0,0,24000,-24000,-24000
03677C,臺股指元大05牛02,0,0,0,0,0,0,0,0,0,-24000,0,0,0,0,24000,-24000,-24000
00685L,群益臺灣加權正2 ,0,0,0,0,0,0,0,0,0,-24000,0,0,0,1000,25000,-24000,-24000
0061,元大寶滬深      ,8000,41000,-33000,0,0,0,0,0,0,9000,50000,40000,10000,21000,22000,-1000,-24000
054806,台化元大9A購01  ,0,0,0,0,0,0,0,0,0,-24000,0,0,0,0,24000,-24000,-24000
053209,台積電凱基96購07,0,0,0,0,0,0,0,0,0,-24000,0,0,0,0,24000,-24000,-24000
054309,禾伸堂凱基98購01,0,0,0,0,0,0,0,0,0,-24000,0,0,0,0,24000,-24000,-24000
056320,京鼎群益99購01  ,0,0,0,0,0,0,0,0,0,-24000,0,0,0,167000,191000,-24000,-24000
057255,聯發科麥證98購02,0,0,0,28000,52000,-24000,0,0,0,-24000,0,0,0,28000,52000,-24000,-24000
058977,SGBR2X凱基03購01,0,0,0,0,0,0,0,0,0,-24000,0,0,0,549000,573000,-24000,-24000
058361,美律凱基99購06  ,0,0,0,0,0,0,0,0,0,-24000,0,0,0,65000,89000,-24000,-24000
057043,台積電元大99購02,0,0,0,0,0,0,0,0,0,-24000,0,0,0,0,24000,-24000,-24000
058408,華通兆豐99購02  ,0,0,0,0,0,0,0,0,0,-24000,0,0,0,4000,28000,-24000,-24000
055657,超眾元富97購02  ,0,0,0,0,0,0,0,0,0,-24000,0,0,0,523000,547000,-24000,-24000
1537,廣隆            ,10000,34000,-24000,0,0,0,0,0,0,0,0,0,0,0,0,0,-24000
2597,潤弘            ,0,21000,-21000,0,0,0,0,0,0,-3000,0,3000,-3000,0,0,0,-24000
07109P,聯發科中信9B售02,0,0,0,0,0,0,0,0,0,-24000,0,0,0,10000,34000,-24000,-24000
3701,大眾控          ,4000,28000,-24000,0,0,0,0,0,0,0,0,0,0,0,0,0,-24000
8473,山林水          ,3000,27000,-24000,0,0,0,0,0,0,0,0,0,0,0,0,0,-24000
06145P,華新科永豐97售02,0,0,0,0,0,0,0,0,0,-25000,0,0,0,0,25000,-25000,-25000
061376,瑞昱永豐9A購02  ,0,0,0,0,0,0,0,0,0,-25000,0,0,0,30000,55000,-25000,-25000
061701,友達國票9B購02  ,0,0,0,0,0,0,0,0,0,-25000,0,0,0,0,25000,-25000,-25000
061550,聯鈞群益9A購03  ,0,0,0,0,0,0,0,0,0,-25000,0,0,0,10000,35000,-25000,-25000
059987,大立光元大99購28,0,0,0,0,0,0,0,0,0,-25000,0,0,0,25000,50000,-25000,-25000
060320,元金2X群益02購01,0,0,0,0,0,0,0,0,0,-25000,0,0,0,0,25000,-25000,-25000
054235,欣興群益96購06  ,0,0,0,0,0,0,0,0,0,-25000,0,0,0,1000,26000,-25000,-25000
058270,上緯控永豐99購01,0,0,0,0,0,0,0,0,0,-25000,0,0,0,0,25000,-25000,-25000
055863,緯穎元大97購05  ,0,0,0,0,0,0,0,0,0,-25000,0,0,0,5000,30000,-25000,-25000
053232,友達永豐97購02  ,0,0,0,0,0,0,0,0,0,-25000,0,0,0,0,25000,-25000,-25000
053332,創意永豐96購03  ,0,0,0,0,0,0,0,0,0,-25000,0,0,0,49000,74000,-25000,-25000
053432,世紀鋼永豐96購02,0,0,0,0,0,0,0,0,0,-25000,0,0,0,10000,35000,-25000,-25000
053962,聯茂永豐96購01  ,0,0,0,0,0,0,0,0,0,-25000,0,0,0,0,25000,-25000,-25000
053969,瑞昱元大97購01  ,0,0,0,0,0,0,0,0,0,-25000,0,0,0,5000,30000,-25000,-25000
054027,欣興凱基96購04  ,0,0,0,0,0,0,0,0,0,-25000,0,0,0,0,25000,-25000,-25000
054967,神達元大97購01  ,0,0,0,0,0,0,0,0,0,-25000,0,0,0,0,25000,-25000,-25000
052062,臺股指國票95購09,0,0,0,0,0,0,0,0,0,-25000,0,0,0,21000,46000,-25000,-25000
050992,台積電元大97購01,0,0,0,0,0,0,0,0,0,-25000,0,0,0,0,25000,-25000,-25000
01002T,土銀國泰R1      ,0,25000,-25000,0,0,0,0,0,0,0,0,0,0,0,0,0,-25000
045444,群創元富98購02  ,0,0,0,0,0,0,0,0,0,-25000,0,0,0,0,25000,-25000,-25000
055647,義隆元富97購01  ,0,0,0,0,0,0,0,0,0,-25000,0,0,0,69000,94000,-25000,-25000
058851,大立光群益99購07,0,0,0,0,0,0,0,0,0,-25000,0,0,0,32000,57000,-25000,-25000
058593,大立光統一9B購02,0,0,0,0,0,0,0,0,0,-25000,0,0,0,0,25000,-25000,-25000
056065,奇鋐元大97購01  ,0,0,0,0,0,0,0,0,0,-25000,0,0,0,193000,218000,-25000,-25000
058782,臺股指國票99購01,0,0,0,0,0,0,0,0,0,-25000,0,0,0,0,25000,-25000,-25000
057533,晶相光元大98購02,0,0,0,0,0,0,0,0,0,-25000,0,0,0,11000,36000,-25000,-25000
057460,楠梓電永豐98購03,0,0,0,0,0,0,0,0,0,-25000,0,0,0,0,25000,-25000,-25000
056622,高鐵永豐98購01  ,0,0,0,0,0,0,0,0,0,-25000,0,0,0,0,25000,-25000,-25000
056613,旺宏永豐98購01  ,0,0,0,0,0,0,0,0,0,-25000,0,0,0,0,25000,-25000,-25000
056718,GIS永豐98購01   ,0,0,0,0,0,0,0,0,0,-25000,0,0,0,0,25000,-25000,-25000
057265,聯詠兆豐98購01  ,0,0,0,0,0,0,0,0,0,-25000,0,0,0,0,25000,-25000,-25000
057288,聯茂元大98購03  ,0,0,0,0,0,0,0,0,0,-25000,0,0,0,75000,100000,-25000,-25000
059243,聯發科凱基99購12,0,0,0,0,0,0,0,0,0,-25000,0,0,0,0,25000,-25000,-25000
059270,台灣50元大01購03,0,0,0,0,0,0,0,0,0,-25000,0,0,0,0,25000,-25000,-25000
059459,訊芯永豐99購04  ,0,0,0,0,0,0,0,0,0,-25000,0,0,0,120000,145000,-25000,-25000
3346,麗清            ,13000,38000,-25000,0,0,0,0,0,0,0,0,0,0,0,0,0,-25000
4566,時碩工業        ,20000,45000,-25000,0,0,0,0,0,0,0,0,0,0,0,0,0,-25000
6205,詮欣            ,0,25000,-25000,0,0,0,0,0,0,0,0,0,0,0,0,0,-25000
4999,鑫禾            ,1000,25000,-24000,0,0,0,0,0,0,-1000,0,1000,-1000,0,0,0,-25000
2546,根基            ,9000,34000,-25000,0,0,0,0,0,0,0,0,0,0,0,0,0,-25000
1530,亞崴            ,0,25000,-25000,0,0,0,0,0,0,0,0,0,0,0,0,0,-25000
2012,春雨            ,0,20000,-20000,0,0,0,0,0,0,-5000,0,5000,-5000,0,0,0,-25000
2314,台揚            ,414000,438000,-24000,0,0,0,0,0,0,-1000,1000,2000,-1000,0,0,0,-25000
060545,台積電凱基9B購02,0,0,0,0,0,0,0,0,0,-26000,0,0,0,0,26000,-26000,-26000
060777,茂林凱基9C購01  ,0,0,0,0,0,0,0,0,0,-26000,0,0,0,6000,32000,-26000,-26000
060099,宏達電元大99購09,0,0,0,0,0,0,0,0,0,-26000,0,0,0,39000,65000,-26000,-26000
060121,新光金富邦99購01,0,0,0,0,0,0,0,0,0,-26000,0,0,0,4000,30000,-26000,-26000
06243P,亞光元富97售01  ,0,0,0,0,0,0,0,0,0,-26000,0,0,0,16000,42000,-26000,-26000
061393,緯穎群益9A購01  ,0,0,0,0,0,0,0,0,0,-26000,0,0,0,19000,45000,-26000,-26000
00771,元大US高息特別股,0,0,0,0,0,0,0,0,0,-26000,0,0,0,16000,42000,-26000,-26000
051700,深中小群益99購04,0,0,0,0,0,0,0,0,0,-26000,0,0,0,0,26000,-26000,-26000
053513,義隆群益96購05  ,0,0,0,0,0,0,0,0,0,-26000,0,0,0,43000,69000,-26000,-26000
052895,台積電群益96購04,0,0,0,0,0,0,0,0,0,-26000,0,0,0,67000,93000,-26000,-26000
055391,光罩統一97購02  ,0,0,0,0,0,0,0,0,0,-26000,0,0,0,0,26000,-26000,-26000
053274,旺宏元大98購03  ,0,0,0,0,0,0,0,0,0,-26000,0,0,0,0,26000,-26000,-26000
053300,大成鋼凱基96購02,0,0,0,0,0,0,0,0,0,-26000,0,0,0,0,26000,-26000,-26000
053176,矽力群益96購02  ,0,0,0,0,0,0,0,0,0,-26000,0,0,0,0,26000,-26000,-26000
056763,國巨元大99購02  ,0,0,0,0,0,0,0,0,0,-26000,0,0,0,36000,62000,-26000,-26000
059197,可成永豐99購02  ,0,0,0,0,0,0,0,0,0,-26000,0,0,0,6000,32000,-26000,-26000
057943,可成國票99購03  ,0,0,0,0,0,0,0,0,0,-26000,0,0,0,18000,44000,-26000,-26000
058961,台灣50兆豐9C購01,0,0,0,0,0,0,0,0,0,-26000,0,0,0,0,26000,-26000,-26000
2456,奇力新          ,1103000,734000,369000,0,0,0,0,179000,-179000,-216000,30000,120000,-90000,7000,133000,-126000,-26000
2882B,國泰金乙特      ,0,0,0,0,0,0,0,0,0,-26000,0,26000,-26000,0,0,0,-26000
07279P,台灣50台新99售02,0,0,0,0,0,0,0,0,0,-26000,0,0,0,0,26000,-26000,-26000
061408,華新科國票9A購06,0,0,0,0,0,0,0,0,0,-27000,0,0,0,16000,43000,-27000,-27000
061425,華新科元大9A購19,0,0,0,0,0,0,0,0,0,-27000,0,0,0,0,27000,-27000,-27000
06261P,上銀凱基97售03  ,0,0,0,0,0,0,0,0,0,-27000,0,0,0,0,27000,-27000,-27000
061606,景碩凱基9A購02  ,0,0,0,0,0,0,0,0,0,-27000,0,0,0,166000,193000,-27000,-27000
06631P,玉晶光群益9A售03,0,0,0,0,0,0,0,0,0,-27000,0,0,0,0,27000,-27000,-27000
060015,國巨康和99購03  ,0,0,0,0,0,0,0,0,0,-27000,0,0,0,105000,132000,-27000,-27000
059917,華新科元大99購19,0,0,0,0,0,0,0,0,0,-27000,0,0,0,0,27000,-27000,-27000
059842,台積電富邦9C購05,0,0,0,0,0,0,0,0,0,-27000,0,0,0,0,27000,-27000,-27000
060379,T50反1凱基9A購07,0,0,0,0,0,0,0,0,0,-27000,0,0,0,15000,42000,-27000,-27000
054185,喬山永豐96購02  ,0,0,0,0,0,0,0,0,0,-27000,0,0,0,97000,124000,-27000,-27000
051539,瀚宇博國票97購01,0,0,0,0,0,0,0,0,0,-27000,0,0,0,41000,68000,-27000,-27000
03047X,元展44          ,0,0,0,0,0,0,0,0,0,-27000,0,0,0,0,27000,-27000,-27000
058937,仁寶中信99購01  ,0,0,0,0,0,0,0,0,0,-27000,0,0,0,10000,37000,-27000,-27000
058481,玉晶光凱基9A購04,0,0,0,0,0,0,0,0,0,-27000,0,0,0,26000,53000,-27000,-27000
058884,世紀鋼永豐99購02,0,0,0,0,0,0,0,0,0,-27000,0,0,0,10000,37000,-27000,-27000
055687,瀚宇博凱基97購01,0,0,0,0,0,0,0,0,0,-27000,0,0,0,22000,49000,-27000,-27000
059215,台積電元大99購28,0,0,0,0,0,0,0,0,0,-27000,0,0,0,50000,77000,-27000,-27000
05908P,大立光元富96售05,0,0,0,0,0,0,0,0,0,-27000,0,0,0,0,27000,-27000,-27000
058387,國巨國票9A購03  ,0,0,0,0,0,0,0,0,0,-27000,0,0,0,203000,230000,-27000,-27000
056665,上証2X國票99購02,0,0,0,0,0,0,0,0,0,-27000,0,0,0,0,27000,-27000,-27000
2373,震旦行          ,8000,35000,-27000,0,0,0,0,0,0,0,0,0,0,0,0,0,-27000
060864,可成永豐9A購01  ,0,0,0,0,0,0,0,0,0,-28000,0,0,0,2000,30000,-28000,-28000
060849,力成國票9A購01  ,0,0,0,0,0,0,0,0,0,-28000,0,0,0,0,28000,-28000,-28000
059689,南亞科永豐99購02,0,0,0,0,0,0,0,0,0,-28000,0,0,0,12000,40000,-28000,-28000
059928,道瓊銀富邦03購01,0,0,0,0,0,0,0,0,0,-28000,0,0,0,0,28000,-28000,-28000
06617P,智邦元大98售03  ,0,0,0,0,0,0,0,0,0,-28000,0,0,0,539000,567000,-28000,-28000
061559,南亞科國票9A購02,0,0,0,0,0,0,0,0,0,-28000,0,0,0,40000,68000,-28000,-28000
049584,台積電元大96購04,0,0,0,0,0,0,0,0,0,-28000,0,0,0,0,28000,-28000,-28000
052586,晶豪科永豐96購01,0,0,0,0,0,0,0,0,0,-28000,0,0,0,73000,101000,-28000,-28000
054577,世芯元大98購01  ,0,0,0,0,0,0,0,0,0,-28000,0,0,0,3000,31000,-28000,-28000
054484,仁寶台新96購01  ,0,0,0,0,0,0,0,0,0,-28000,0,0,0,10000,38000,-28000,-28000
058261,大立光富邦03購01,0,0,0,0,0,0,0,0,0,-28000,0,0,0,0,28000,-28000,-28000
053881,南亞科中信97購01,0,0,0,0,0,0,0,0,0,-28000,0,0,0,0,28000,-28000,-28000
059177,臺股指凱基99購28,0,0,0,0,0,0,0,0,0,-28000,0,0,0,10000,38000,-28000,-28000
056523,光寶科中信98購01,0,0,0,0,0,0,0,0,0,-28000,0,0,0,27000,55000,-28000,-28000
058951,南電群益99購01  ,0,0,0,0,0,0,0,0,0,-28000,0,0,0,2000,30000,-28000,-28000
057888,貿聯群益98購02  ,0,0,0,0,0,0,0,0,0,-28000,0,0,0,99000,127000,-28000,-28000
058203,信邦凱基99購01  ,0,0,0,0,0,0,0,0,0,-28000,0,0,0,0,28000,-28000,-28000
05594P,旺宏國票96售04  ,0,0,0,0,0,0,0,0,0,-28000,0,0,0,17000,45000,-28000,-28000
2414,精技            ,13000,41000,-28000,0,0,0,0,0,0,0,0,0,0,0,0,0,-28000
07139P,元油2X群益9C售06,0,0,0,0,0,0,0,0,0,-28000,0,0,0,0,28000,-28000,-28000
6666,羅麗芬-KY       ,17000,45000,-28000,0,0,0,0,0,0,0,0,0,0,0,0,0,-28000
6668,中揚光          ,97000,123000,-26000,0,0,0,0,0,0,-2000,0,2000,-2000,0,0,0,-28000
3686,達能            ,6000,34000,-28000,0,0,0,0,0,0,0,0,0,0,0,0,0,-28000
3679,新至陞          ,12000,40000,-28000,0,0,0,0,0,0,0,0,0,0,0,0,0,-28000
061182,南六凱基9A購01  ,0,0,0,0,0,0,0,0,0,-29000,0,0,0,62000,91000,-29000,-29000
060134,鈺齊群益9A購01  ,0,0,0,0,0,0,0,0,0,-29000,0,0,0,25000,54000,-29000,-29000
060170,世紀鋼永豐9A購01,0,0,0,0,0,0,0,0,0,-29000,0,0,0,44000,73000,-29000,-29000
060623,玉晶光元大9C購01,0,0,0,0,0,0,0,0,0,-29000,0,0,0,6000,35000,-29000,-29000
057948,嘉聯益國票99購02,0,0,0,0,0,0,0,0,0,-29000,0,0,0,9000,38000,-29000,-29000
055208,京鼎康和97購02  ,0,0,0,0,0,0,0,0,0,-29000,0,0,0,39000,68000,-29000,-29000
054109,南亞科凱基96購05,0,0,0,0,0,0,0,0,0,-29000,0,0,0,1000,30000,-29000,-29000
054298,台表科元大97購03,0,0,0,0,0,0,0,0,0,-29000,0,0,0,8000,37000,-29000,-29000
052325,高股息中信99購01,0,0,0,0,0,0,0,0,0,-29000,0,0,0,1000,30000,-29000,-29000
058363,全新凱基9A購02  ,0,0,0,0,0,0,0,0,0,-29000,0,0,0,0,29000,-29000,-29000
057733,嘉聯益國泰99購01,0,0,0,0,0,0,0,0,0,-29000,0,0,0,102000,131000,-29000,-29000
057270,遠東新元大98購01,0,0,0,0,0,0,0,0,0,-29000,0,0,0,133000,162000,-29000,-29000
056740,大立光凱基98購13,0,0,0,0,0,0,0,0,0,-29000,0,0,0,11000,40000,-29000,-29000
056497,GIS國泰99購01   ,0,0,0,0,0,0,0,0,0,-29000,0,0,0,0,29000,-29000,-29000
057401,晶豪科群益99購01,0,0,0,0,0,0,0,0,0,-29000,0,0,0,6000,35000,-29000,-29000
3504,揚明光          ,97000,125000,-28000,0,0,0,0,0,0,-1000,0,1000,-1000,0,0,0,-29000
4572,駐龍            ,7000,36000,-29000,0,0,0,0,0,0,0,0,0,0,0,0,0,-29000
6581,鋼聯            ,0,29000,-29000,0,0,0,0,0,0,0,0,0,0,0,0,0,-29000
07217P,大立光凱基9A售05,0,0,0,0,0,0,0,0,0,-29000,0,0,0,5000,34000,-29000,-29000
1568,倉佑            ,0,29000,-29000,0,0,0,0,0,0,0,0,0,0,0,0,0,-29000
1220,台榮            ,0,29000,-29000,0,0,0,0,0,0,0,0,0,0,0,0,0,-29000
6415,矽力-KY         ,250687,183592,67095,0,0,0,0,94000,-94000,-3000,0,1000,-1000,3000,5000,-2000,-29905
060675,南亞科元大9A購02,0,0,0,0,0,0,0,0,0,-30000,0,0,0,0,30000,-30000,-30000
060350,元黃金元富9B購01,0,0,0,0,0,0,0,0,0,-30000,0,0,0,15000,45000,-30000,-30000
060393,泰鼎群益9A購01  ,0,0,0,0,0,0,0,0,0,-30000,0,0,0,112000,142000,-30000,-30000
060258,T50反1凱基9A購06,0,0,0,0,0,0,0,0,0,-30000,0,0,0,0,30000,-30000,-30000
060091,技嘉元大99購03  ,0,0,0,0,0,0,0,0,0,-30000,0,0,0,0,30000,-30000,-30000
06017P,亞光凱基96售04  ,0,0,0,0,0,0,0,0,0,-30000,0,0,0,10000,40000,-30000,-30000
060232,友訊元大9C購01  ,0,0,0,0,0,0,0,0,0,-30000,0,0,0,54000,84000,-30000,-30000
059711,滬深2X元大9C購02,0,0,0,0,0,0,0,0,0,-30000,0,0,0,0,30000,-30000,-30000
059883,T50反1國票99購02,0,0,0,0,0,0,0,0,0,-30000,0,0,0,200000,230000,-30000,-30000
06122P,亞光元大98售01  ,0,0,0,0,0,0,0,0,0,-30000,0,0,0,0,30000,-30000,-30000
06109P,華新科群益97售05,0,0,0,0,0,0,0,0,0,-30000,0,0,0,0,30000,-30000,-30000
061010,上銀麥證9A購02  ,0,0,0,24000,54000,-30000,0,0,0,-30000,0,0,0,24000,54000,-30000,-30000
061407,鴻海國票9A購07  ,0,0,0,0,0,0,0,0,0,-30000,0,0,0,0,30000,-30000,-30000
061287,大立光統一9B購06,0,0,0,0,0,0,0,0,0,-30000,0,0,0,0,30000,-30000,-30000
061671,台灣50元大9A購21,0,0,0,0,0,0,0,0,0,-30000,0,0,0,0,30000,-30000,-30000
061672,臺指反元大01購05,0,0,0,0,0,0,0,0,0,-30000,0,0,0,20000,50000,-30000,-30000
061739,奇力新凱基9C購01,0,0,0,0,0,0,0,0,0,-30000,0,0,0,0,30000,-30000,-30000
06424P,大成鋼永豐97售01,0,0,0,0,0,0,0,0,0,-30000,0,0,0,10000,40000,-30000,-30000
06600P,貿聯永豐98售01  ,0,0,0,0,0,0,0,0,0,-30000,0,0,0,0,30000,-30000,-30000
046680,上証反群益95購01,0,0,0,0,0,0,0,0,0,-30000,0,0,0,0,30000,-30000,-30000
04927P,大立光凱基95售06,0,0,0,0,0,0,0,0,0,-30000,0,0,0,0,30000,-30000,-30000
04908P,南電國票95售03  ,0,0,0,0,0,0,0,0,0,-30000,0,0,0,40000,70000,-30000,-30000
042792,T50反1台新9C購01,0,0,0,0,0,0,0,0,0,-30000,0,0,0,0,30000,-30000,-30000
0051,元大中型100     ,0,0,0,0,0,0,0,0,0,-30000,0,0,0,2000,32000,-30000,-30000
051570,和碩富邦97購01  ,0,0,0,0,0,0,0,0,0,-30000,0,0,0,20000,50000,-30000,-30000
051696,新日興中信96購01,0,0,0,0,0,0,0,0,0,-30000,0,0,0,0,30000,-30000,-30000
051159,力山元大96購01  ,0,0,0,0,0,0,0,0,0,-30000,0,0,0,0,30000,-30000,-30000
051928,大立光中信96購03,0,0,0,0,0,0,0,0,0,-30000,0,0,0,0,30000,-30000,-30000
054263,聯茂元大96購02  ,0,0,0,0,0,0,0,0,0,-30000,0,0,0,0,30000,-30000,-30000
05418P,瑞昱永豐95售02  ,0,0,0,0,0,0,0,0,0,-30000,0,0,0,0,30000,-30000,-30000
055251,華新科統一99購01,0,0,0,0,0,0,0,0,0,-30000,0,0,0,0,30000,-30000,-30000
058313,台積電富邦9B購04,0,0,0,0,0,0,0,0,0,-30000,0,0,0,860000,890000,-30000,-30000
058264,瑞昱永豐99購01  ,0,0,0,0,0,0,0,0,0,-30000,0,0,0,108000,138000,-30000,-30000
055849,聯詠元大97購05  ,0,0,0,0,0,0,0,0,0,-30000,0,0,0,170000,200000,-30000,-30000
055398,超眾統一97購03  ,0,0,0,0,0,0,0,0,0,-30000,0,0,0,0,30000,-30000,-30000
052955,國巨日盛96購01  ,0,0,0,0,0,0,0,0,0,-30000,0,0,0,0,30000,-30000,-30000
055022,精元國泰99購01  ,0,0,0,0,0,0,0,0,0,-30000,0,0,0,0,30000,-30000,-30000
057571,泰碩永豐98購01  ,0,0,0,0,0,0,0,0,0,-30000,0,0,0,5000,35000,-30000,-30000
057831,聯發科元富02購04,0,0,0,0,0,0,0,0,0,-30000,0,0,0,40000,70000,-30000,-30000
057232,京元電凱基98購02,0,0,0,0,0,0,0,0,0,-30000,0,0,0,0,30000,-30000,-30000
059293,宏達電元富9B購01,0,0,0,0,0,0,0,0,0,-30000,0,0,0,0,30000,-30000,-30000
059267,群創中信01購02  ,0,0,0,0,0,0,0,0,0,-30000,0,0,0,0,30000,-30000,-30000
059430,台積電元大99購36,0,0,0,0,0,0,0,0,0,-30000,0,0,0,23000,53000,-30000,-30000
056515,燿華兆豐99購01  ,0,0,0,0,0,0,0,0,0,-30000,0,0,0,0,30000,-30000,-30000
055549,旺宏凱基97購03  ,0,0,0,0,0,0,0,0,0,-30000,0,0,0,0,30000,-30000,-30000
055702,美律富邦98購01  ,0,0,0,0,0,0,0,0,0,-30000,0,0,0,0,30000,-30000,-30000
058687,聯茂凱基9A購01  ,0,0,0,0,0,0,0,0,0,-30000,0,0,0,0,30000,-30000,-30000
058533,玉晶光元富99購01,0,0,0,0,0,0,0,0,0,-30000,0,0,0,0,30000,-30000,-30000
1337,再生-KY         ,16000,46000,-30000,0,0,0,0,0,0,0,0,0,0,0,0,0,-30000
07241P,台灣50國票9A售05,0,0,0,0,0,0,0,0,0,-30000,0,0,0,0,30000,-30000,-30000
07855P,旺宏凱基9A售09  ,0,0,0,0,0,0,0,0,0,-30000,0,0,0,0,30000,-30000,-30000
07658P,國泰金凱基9A售01,0,0,0,0,0,0,0,0,0,-30000,0,0,0,0,30000,-30000,-30000
07651P,道瓊指中信01售01,0,0,0,0,0,0,0,0,0,-30000,0,0,0,0,30000,-30000,-30000
07516P,台積電元大9A售16,0,0,0,0,0,0,0,0,0,-30000,0,0,0,0,30000,-30000,-30000
06822P,上銀富邦99售03  ,0,0,0,0,0,0,0,0,0,-31000,0,0,0,9000,40000,-31000,-31000
06282P,聯鈞永豐97售02  ,0,0,0,0,0,0,0,0,0,-31000,0,0,0,257000,288000,-31000,-31000
061595,智易永豐9A購02  ,0,0,0,0,0,0,0,0,0,-31000,0,0,0,0,31000,-31000,-31000
061471,台積電元大9A購31,0,0,0,0,0,0,0,0,0,-31000,0,0,0,2000,33000,-31000,-31000
061540,台積電群益9A購07,0,0,0,0,0,0,0,0,0,-31000,0,0,0,20000,51000,-31000,-31000
061504,祥碩國票9A購02  ,0,0,0,0,0,0,0,0,0,-31000,0,0,0,15000,46000,-31000,-31000
061041,南電永豐9A購03  ,0,0,0,0,0,0,0,0,0,-31000,0,0,0,0,31000,-31000,-31000
060982,旺宏元大9A購09  ,0,0,0,0,0,0,0,0,0,-31000,0,0,0,6000,37000,-31000,-31000
059822,聯發科凱基99購19,0,0,0,0,0,0,0,0,0,-31000,0,0,0,26000,57000,-31000,-31000
060011,臺股指群益9C購06,0,0,0,0,0,0,0,0,0,-31000,0,0,0,0,31000,-31000,-31000
060286,佳世達元大9C購01,0,0,0,0,0,0,0,0,0,-31000,0,0,0,69000,100000,-31000,-31000
06046P,健策統一96售03  ,0,0,0,0,0,0,0,0,0,-31000,0,0,0,122000,153000,-31000,-31000
060606,玉晶光凱基9A購05,0,0,0,0,0,0,0,0,0,-31000,0,0,0,70000,101000,-31000,-31000
053340,建準國票97購01  ,0,0,0,0,0,0,0,0,0,-31000,0,0,0,0,31000,-31000,-31000
058324,嘉聯益永豐9A購01,0,0,0,0,0,0,0,0,0,-31000,0,0,0,45000,76000,-31000,-31000
051818,國巨統一95購02  ,0,0,0,0,0,0,0,0,0,-31000,0,0,0,8000,39000,-31000,-31000
00690,兆豐藍籌30      ,0,0,0,0,0,0,0,0,0,-31000,0,0,0,162000,193000,-31000,-31000
046942,友達元大99購01  ,0,0,0,0,0,0,0,0,0,-31000,0,0,0,21000,52000,-31000,-31000
058200,世芯康和99購01  ,0,0,0,0,0,0,0,0,0,-31000,0,0,0,569000,600000,-31000,-31000
05804P,美律永豐96售01  ,0,0,0,0,0,0,0,0,0,-31000,0,0,0,0,31000,-31000,-31000
055692,緯穎凱基97購03  ,0,0,0,0,0,0,0,0,0,-31000,0,0,0,29000,60000,-31000,-31000
057142,力成兆豐98購01  ,0,0,0,0,0,0,0,0,0,-31000,0,0,0,11000,42000,-31000,-31000
057514,華新科元富99購03,0,0,0,0,0,0,0,0,0,-31000,0,0,0,40000,71000,-31000,-31000
07335P,臺股指國票99售20,0,0,0,0,0,0,0,0,0,-31000,0,0,0,4000,35000,-31000,-31000
2636,台驊投控        ,22000,53000,-31000,0,0,0,0,0,0,0,0,0,0,0,0,0,-31000
060539,道瓊反凱基9A購01,0,0,0,0,0,0,0,0,0,-32000,0,0,0,61000,93000,-32000,-32000
060515,臺股指元大9B購12,0,0,0,0,0,0,0,0,0,-32000,0,0,0,0,32000,-32000,-32000
059743,開發金元富99購01,0,0,0,0,0,0,0,0,0,-32000,0,0,0,98000,130000,-32000,-32000
061086,FBVIX統一01購01 ,0,0,0,0,0,0,0,0,0,-32000,0,0,0,18000,50000,-32000,-32000
00645,富邦日本        ,0,0,0,0,0,0,0,0,0,-32000,0,0,0,108000,140000,-32000,-32000
00770,國泰北美科技    ,0,0,0,0,0,0,0,0,0,-32000,0,0,0,0,32000,-32000,-32000
042752,台灣50元大96購03,0,0,0,0,0,0,0,0,0,-32000,0,0,0,19000,51000,-32000,-32000
053584,友達元大9B購02  ,0,0,0,0,0,0,0,0,0,-32000,0,0,0,0,32000,-32000,-32000
054482,大成鋼台新96購01,0,0,0,0,0,0,0,0,0,-32000,0,0,0,45000,77000,-32000,-32000
053956,旺宏永豐96購04  ,0,0,0,0,0,0,0,0,0,-32000,0,0,0,0,32000,-32000,-32000
052818,智邦永豐96購01  ,0,0,0,0,0,0,0,0,0,-32000,0,0,0,3000,35000,-32000,-32000
057334,技嘉國票98購02  ,0,0,0,0,0,0,0,0,0,-32000,0,0,0,18000,50000,-32000,-32000
057261,瑞昱兆豐98購01  ,0,0,0,0,0,0,0,0,0,-32000,0,0,0,29000,61000,-32000,-32000
056350,上銀元大98購02  ,0,0,0,0,0,0,0,0,0,-32000,0,0,0,16000,48000,-32000,-32000
1540,喬福            ,0,32000,-32000,0,0,0,0,0,0,0,0,0,0,0,0,0,-32000
2227,裕日車          ,10000,42000,-32000,0,0,0,0,0,0,0,0,0,0,0,0,0,-32000
07791P,奇鋐元大9A售02  ,0,0,0,0,0,0,0,0,0,-32000,0,0,0,5000,37000,-32000,-32000
6155,鈞寶            ,72000,104000,-32000,0,0,0,0,0,0,0,0,0,0,0,0,0,-32000
3312,弘憶股          ,38000,69000,-31000,0,0,0,0,0,0,-1000,0,1000,-1000,0,0,0,-32000
061038,TPK永豐9A購01   ,0,0,0,0,0,0,0,0,0,-33000,0,0,0,48000,81000,-33000,-33000
06849P,欣興元大98售12  ,0,0,0,0,0,0,0,0,0,-33000,0,0,0,37000,70000,-33000,-33000
06911P,鴻海元大99售09  ,0,0,0,0,0,0,0,0,0,-33000,0,0,0,45000,78000,-33000,-33000
059951,台塑康和99購01  ,0,0,0,0,0,0,0,0,0,-33000,0,0,0,136000,169000,-33000,-33000
060463,台積電元大9A購10,0,0,0,0,0,0,0,0,0,-33000,0,0,0,57000,90000,-33000,-33000
060774,南亞科凱基9A購01,0,0,0,0,0,0,0,0,0,-33000,0,0,0,30000,63000,-33000,-33000
054977,SP黃豆元富9B購01,0,0,0,0,0,0,0,0,0,-33000,0,0,0,0,33000,-33000,-33000
052972,義隆群益96購04  ,0,0,0,0,0,0,0,0,0,-33000,0,0,0,32000,65000,-33000,-33000
052997,國巨康和96購01  ,0,0,0,0,0,0,0,0,0,-33000,0,0,0,50000,83000,-33000,-33000
053285,臺股指元大96購08,0,0,0,0,0,0,0,0,0,-33000,0,0,0,3000,36000,-33000,-33000
054306,聯發科凱基96購23,0,0,0,0,0,0,0,0,0,-33000,0,0,0,17000,50000,-33000,-33000
056819,奇力新永豐98購01,0,0,0,0,0,0,0,0,0,-33000,0,0,0,8000,41000,-33000,-33000
051847,香港反中信99購01,0,0,0,0,0,0,0,0,0,-33000,0,0,0,18000,51000,-33000,-33000
03679C,臺股指元大04牛04,0,0,0,0,0,0,0,0,0,-33000,0,0,0,0,33000,-33000,-33000
058661,臺股指中信9C購01,0,0,0,0,0,0,0,0,0,-33000,0,0,0,0,33000,-33000,-33000
059117,禾伸堂永豐99購01,0,0,0,0,0,0,0,0,0,-33000,0,0,0,110000,143000,-33000,-33000
059170,康控凱基9B購01  ,0,0,0,0,0,0,0,0,0,-33000,0,0,0,0,33000,-33000,-33000
057802,卜蜂元大98購01  ,0,0,0,0,0,0,0,0,0,-33000,0,0,0,4000,37000,-33000,-33000
4952,凌通            ,15000,47000,-32000,0,0,0,0,0,0,-1000,0,1000,-1000,0,0,0,-33000
2029,盛餘            ,1000,33000,-32000,0,0,0,0,0,0,-1000,0,1000,-1000,0,0,0,-33000
1730,花仙子          ,75000,108000,-33000,0,0,0,0,0,0,0,0,0,0,0,0,0,-33000
1524,耿鼎            ,7000,40000,-33000,0,0,0,0,0,0,0,0,0,0,0,0,0,-33000
060916,金像電國泰9C購01,0,0,0,0,0,0,0,0,0,-34000,0,0,0,290000,324000,-34000,-34000
060633,玉晶光富邦02購01,0,0,0,0,0,0,0,0,0,-34000,0,0,0,289000,323000,-34000,-34000
060687,GIS元大9A購01   ,0,0,0,0,0,0,0,0,0,-34000,0,0,0,2000,36000,-34000,-34000
060699,華新科國泰9B購03,0,0,0,0,0,0,0,0,0,-34000,0,0,0,31000,65000,-34000,-34000
06050P,玉晶光國票98售01,0,0,0,0,0,0,0,0,0,-34000,0,0,0,0,34000,-34000,-34000
059612,奇鋐永豐99購02  ,0,0,0,0,0,0,0,0,0,-34000,0,0,0,5000,39000,-34000,-34000
06859P,元金2X中信9C售01,0,0,0,0,0,0,0,0,0,-34000,0,0,0,18000,52000,-34000,-34000
06491P,台積電富邦99售02,0,0,0,0,0,0,0,0,0,-34000,0,0,0,20000,54000,-34000,-34000
061410,緯穎國票9A購03  ,0,0,0,0,0,0,0,0,0,-34000,0,0,0,18000,52000,-34000,-34000
061326,新日興凱基9B購01,0,0,0,0,0,0,0,0,0,-34000,0,0,0,30000,64000,-34000,-34000
052020,聯茂永豐95購02  ,0,0,0,0,0,0,0,0,0,-34000,0,0,0,0,34000,-34000,-34000
054445,技嘉兆豐96購01  ,0,0,0,0,0,0,0,0,0,-34000,0,0,0,0,34000,-34000,-34000
057431,京鼎兆豐98購02  ,0,0,0,0,0,0,0,0,0,-34000,0,0,0,11000,45000,-34000,-34000
059149,臺股指國票99購12,0,0,0,0,0,0,0,0,0,-34000,0,0,0,0,34000,-34000,-34000
059263,瑞昱中信01購01  ,0,0,0,0,0,0,0,0,0,-34000,0,0,0,64000,98000,-34000,-34000
058567,華新科凱基9A購02,0,0,0,0,0,0,0,0,0,-34000,0,0,0,5000,39000,-34000,-34000
056941,台郡元富9B購01  ,0,0,0,0,0,0,0,0,0,-34000,0,0,0,0,34000,-34000,-34000
3055,蔚華科          ,2000,36000,-34000,0,0,0,0,0,0,0,0,0,0,0,0,0,-34000
07161P,臺股指群益99售12,0,0,0,0,0,0,0,0,0,-34000,0,0,0,40000,74000,-34000,-34000
6136,富爾特          ,2000,36000,-34000,0,0,0,0,0,0,0,0,0,0,0,0,0,-34000
9942,茂順            ,1000,35000,-34000,0,0,0,0,0,0,0,0,0,0,0,0,0,-34000
2233,宇隆            ,39000,157045,-118045,0,0,0,60000,0,60000,24000,24000,0,24000,0,0,0,-34045
6409,旭隼            ,35000,69200,-34200,0,0,0,0,0,0,0,0,0,0,0,0,0,-34200
4994,傳奇            ,30562,65000,-34438,0,0,0,0,0,0,0,1000,1000,0,0,0,0,-34438
3311,閎暉            ,136000,169639,-33639,0,0,0,0,0,0,-1000,0,1000,-1000,0,0,0,-34639
1234,黑松            ,15093,50000,-34907,0,0,0,0,0,0,0,0,0,0,0,0,0,-34907
06573P,台積電永昌99售02,0,0,0,0,0,0,0,0,0,-35000,0,0,0,0,35000,-35000,-35000
059619,台積電日盛9A購04,0,0,0,0,0,0,0,0,0,-35000,0,0,0,126000,161000,-35000,-35000
059833,緯穎康和99購01  ,0,0,0,0,0,0,0,0,0,-35000,0,0,0,5000,40000,-35000,-35000
059886,可成國票99購04  ,0,0,0,0,0,0,0,0,0,-35000,0,0,0,2000,37000,-35000,-35000
059860,台積電群益9A購02,0,0,0,0,0,0,0,0,0,-35000,0,0,0,13000,48000,-35000,-35000
059862,全新群益99購04  ,0,0,0,0,0,0,0,0,0,-35000,0,0,0,0,35000,-35000,-35000
060454,葡萄王元大9A購01,0,0,0,0,0,0,0,0,0,-35000,0,0,0,0,35000,-35000,-35000
060882,大立光中信9A購05,0,0,0,0,0,0,0,0,0,-35000,0,0,0,0,35000,-35000,-35000
060781,台郡國泰9B購01  ,0,0,0,0,0,0,0,0,0,-35000,0,0,0,16000,51000,-35000,-35000
057973,神達富邦9A購01  ,0,0,0,0,0,0,0,0,0,-35000,0,0,0,0,35000,-35000,-35000
052836,旺宏國泰98購01  ,0,0,0,0,0,0,0,0,0,-35000,0,0,0,0,35000,-35000,-35000
050601,台表科國泰96購01,0,0,0,0,0,0,0,0,0,-35000,0,0,0,5000,40000,-35000,-35000
054821,貿聯元大9A購01  ,0,0,0,0,0,0,0,0,0,-35000,0,0,0,0,35000,-35000,-35000
04230P,臺股指中信95售06,0,0,0,0,0,0,0,0,0,-35000,0,0,0,5000,40000,-35000,-35000
048572,美利達元大96購04,0,0,0,0,0,0,0,0,0,-35000,0,0,0,0,35000,-35000,-35000
058074,欣興凱基99購01  ,0,0,0,0,0,0,0,0,0,-35000,0,0,0,1000,36000,-35000,-35000
056077,矽力元大97購07  ,0,0,0,0,0,0,0,0,0,-35000,0,0,0,47000,82000,-35000,-35000
058683,可成凱基9A購01  ,0,0,0,0,0,0,0,0,0,-35000,0,0,0,10000,45000,-35000,-35000
056506,晶豪科永豐98購02,0,0,0,0,0,0,0,0,0,-35000,0,0,0,0,35000,-35000,-35000
07325P,台積電元大99售41,0,0,0,0,0,0,0,0,0,-35000,0,0,0,20000,55000,-35000,-35000
3419,譁裕            ,76000,109000,-33000,0,0,0,0,0,0,-2000,0,2000,-2000,0,0,0,-35000
060878,奇力新中信9C購01,0,0,0,0,0,0,0,0,0,-36000,0,0,0,162000,198000,-36000,-36000
060550,可成凱基9A購02  ,0,0,0,0,0,0,0,0,0,-36000,0,0,0,0,36000,-36000,-36000
060048,元金2X凱基99購03,0,0,0,0,0,0,0,0,0,-36000,0,0,0,0,36000,-36000,-36000
06983P,台積電國泰9A售02,0,0,0,0,0,0,0,0,0,-36000,0,0,0,84000,120000,-36000,-36000
06342P,世芯統一98售01  ,0,0,0,0,0,0,0,0,0,-36000,0,0,0,9000,45000,-36000,-36000
05240P,玉晶光永豐96售01,0,0,0,0,0,0,0,0,0,-36000,0,0,0,110000,146000,-36000,-36000
053500,新日興兆豐97購01,0,0,0,0,0,0,0,0,0,-36000,0,0,0,35000,71000,-36000,-36000
052005,矽力國泰97購02  ,0,0,0,0,0,0,0,0,0,-36000,0,0,0,0,36000,-36000,-36000
055421,玉晶光永豐98購04,0,0,0,0,0,0,0,0,0,-36000,0,0,0,0,36000,-36000,-36000
053957,瑞昱永豐96購01  ,0,0,0,0,0,0,0,0,0,-36000,0,0,0,69000,105000,-36000,-36000
054231,國巨群益98購03  ,0,0,0,0,0,0,0,0,0,-36000,0,0,0,70000,106000,-36000,-36000
056405,聯茂群益98購01  ,0,0,0,0,0,0,0,0,0,-36000,0,0,0,1000,37000,-36000,-36000
055555,全新凱基9A購01  ,0,0,0,0,0,0,0,0,0,-36000,0,0,0,6000,42000,-36000,-36000
056129,義隆麥證97購01  ,0,0,0,0,36000,-36000,0,0,0,-36000,0,0,0,0,36000,-36000,-36000
059358,旺宏永豐99購02  ,0,0,0,0,0,0,0,0,0,-36000,0,0,0,0,36000,-36000,-36000
6281,全國電          ,4000,40000,-36000,0,0,0,0,0,0,0,0,0,0,0,0,0,-36000
061568,國巨元大9A購25  ,0,0,0,0,0,0,0,0,0,-37000,0,0,0,101000,138000,-37000,-37000
06934P,聯鈞元大98售03  ,0,0,0,0,0,0,0,0,0,-37000,0,0,0,386000,423000,-37000,-37000
061089,台積電統一9C購04,0,0,0,0,0,0,0,0,0,-37000,0,0,0,0,37000,-37000,-37000
061113,南電元大9A購03  ,0,0,0,0,0,0,0,0,0,-37000,0,0,0,1000,38000,-37000,-37000
061150,國巨群益9A購09  ,0,0,0,0,0,0,0,0,0,-37000,0,0,0,15000,52000,-37000,-37000
061166,玉晶光兆豐9B購01,0,0,0,0,0,0,0,0,0,-37000,0,0,0,77000,114000,-37000,-37000
061155,華新科群益9A購06,0,0,0,0,0,0,0,0,0,-37000,0,0,0,18000,55000,-37000,-37000
060019,彰銀康和99購01  ,0,0,0,0,0,0,0,0,0,-37000,0,0,0,0,37000,-37000,-37000
059944,欣興永豐99購03  ,0,0,0,0,0,0,0,0,0,-37000,0,0,0,74000,111000,-37000,-37000
059931,緯穎富邦9A購01  ,0,0,0,0,0,0,0,0,0,-37000,0,0,0,13000,50000,-37000,-37000
054211,奇鋐國票97購03  ,0,0,0,0,0,0,0,0,0,-37000,0,0,0,10000,47000,-37000,-37000
053973,晶豪科元大96購01,0,0,0,0,0,0,0,0,0,-37000,0,0,0,93000,130000,-37000,-37000
053124,聯發科凱基96購12,0,0,0,0,0,0,0,0,0,-37000,0,0,0,23000,60000,-37000,-37000
053032,國巨兆豐97購02  ,0,0,0,0,0,0,0,0,0,-37000,0,0,0,0,37000,-37000,-37000
053486,T50反1兆豐96購01,0,0,0,0,0,0,0,0,0,-37000,0,0,0,68000,105000,-37000,-37000
0052,富邦科技        ,2000,0,2000,0,0,0,0,0,0,-39000,0,0,0,201000,240000,-39000,-37000
059016,晶相光元富99購03,0,0,0,0,0,0,0,0,0,-37000,0,0,0,21000,58000,-37000,-37000
058550,南亞科永豐99購01,0,0,0,0,0,0,0,0,0,-37000,0,0,0,0,37000,-37000,-37000
055594,華新科元大98購02,0,0,0,0,0,0,0,0,0,-37000,0,0,0,0,37000,-37000,-37000
056202,國揚永豐97購01  ,0,0,0,0,0,0,0,0,0,-37000,0,0,0,54000,91000,-37000,-37000
056175,可成元富97購03  ,0,0,0,0,0,0,0,0,0,-37000,0,0,0,0,37000,-37000,-37000
057003,立積國票98購01  ,0,0,0,0,0,0,0,0,0,-37000,0,0,0,104000,141000,-37000,-37000
058637,晶技兆豐99購01  ,0,0,0,0,0,0,0,0,0,-37000,0,0,0,23000,60000,-37000,-37000
4164,承業醫          ,22000,57000,-35000,0,0,0,0,0,0,-2000,0,2000,-2000,0,0,0,-37000
8249,菱光            ,4000,40000,-36000,0,0,0,0,0,0,-1000,0,1000,-1000,0,0,0,-37000
07780P,美律凱基9A售02  ,0,0,0,0,0,0,0,0,0,-37000,0,0,0,0,37000,-37000,-37000
07491P,臺股指國票9A售09,0,0,0,0,0,0,0,0,0,-37000,0,0,0,3000,40000,-37000,-37000
2228,劍麟            ,53000,126000,-73000,0,0,0,50000,0,50000,-14000,0,0,0,0,14000,-14000,-37000
059667,矽力元大99購01  ,0,0,0,0,0,0,0,0,0,-38000,0,0,0,12000,50000,-38000,-38000
059720,台積電元大99購43,0,0,0,0,0,0,0,0,0,-38000,0,0,0,0,38000,-38000,-38000
059597,大立光元大99購21,0,0,0,0,0,0,0,0,0,-38000,0,0,0,27000,65000,-38000,-38000
060430,和潤永豐9A購01  ,0,0,0,0,0,0,0,0,0,-38000,0,0,0,42000,80000,-38000,-38000
06602P,國巨統一99售02  ,0,0,0,0,0,0,0,0,0,-38000,0,0,0,202000,240000,-38000,-38000
061591,旺宏永豐9A購02  ,0,0,0,0,0,0,0,0,0,-38000,0,0,0,0,38000,-38000,-38000
061684,T50反1群益9A購06,100000,0,100000,0,0,0,0,0,0,-138000,0,0,0,20000,158000,-138000,-38000
053503,臻鼎兆豐97購01  ,0,0,0,0,0,0,0,0,0,-38000,0,0,0,0,38000,-38000,-38000
052659,上証2X國票99購01,0,0,0,0,0,0,0,0,0,-38000,0,0,0,0,38000,-38000,-38000
053886,亞光兆豐96購01  ,0,0,0,0,0,0,0,0,0,-38000,0,0,0,0,38000,-38000,-38000
055332,奇力新兆豐98購01,0,0,0,0,0,0,0,0,0,-38000,0,0,0,0,38000,-38000,-38000
056783,國巨群益99購01  ,0,0,0,0,0,0,0,0,0,-38000,0,0,0,199000,237000,-38000,-38000
058663,瑞儀兆豐9A購01  ,0,0,0,0,0,0,0,0,0,-38000,0,0,0,186000,224000,-38000,-38000
058453,可成永豐99購01  ,0,0,0,0,0,0,0,0,0,-38000,0,0,0,1000,39000,-38000,-38000
058464,矽創兆豐9A購01  ,0,0,0,0,0,0,0,0,0,-38000,0,0,0,1000,39000,-38000,-38000
058705,長榮航元大99購01,0,0,0,0,0,0,0,0,0,-38000,0,0,0,7000,45000,-38000,-38000
055661,亞德客中信98購01,0,0,0,0,0,0,0,0,0,-38000,0,0,0,43000,81000,-38000,-38000
056156,禾伸堂凱基98購04,0,0,0,0,0,0,0,0,0,-38000,0,0,0,10000,48000,-38000,-38000
056894,佳世達元大99購01,0,0,0,0,0,0,0,0,0,-38000,0,0,0,92000,130000,-38000,-38000
2493,揚博            ,35000,73000,-38000,0,0,0,0,0,0,0,0,0,0,0,0,0,-38000
2488,漢平            ,34000,71000,-37000,0,0,0,0,0,0,-1000,0,1000,-1000,0,0,0,-38000
2497,怡利電          ,5000,43000,-38000,0,0,0,0,0,0,0,0,0,0,0,0,0,-38000
4133,亞諾法          ,620000,658000,-38000,0,0,0,0,0,0,0,0,0,0,0,0,0,-38000
061503,臻鼎國票9B購01  ,0,0,0,0,0,0,0,0,0,-39000,0,0,0,56000,95000,-39000,-39000
060109,茂林元大99購05  ,0,0,0,0,0,0,0,0,0,-39000,0,0,0,31000,70000,-39000,-39000
058308,全新元大9B購01  ,10000,0,10000,0,0,0,0,0,0,-49000,0,0,0,36000,85000,-49000,-39000
058289,奇鋐國票9A購01  ,0,0,0,0,0,0,0,0,0,-39000,0,0,0,35000,74000,-39000,-39000
054627,義隆凱基98購01  ,0,0,0,0,0,0,0,0,0,-39000,0,0,0,76000,115000,-39000,-39000
05454P,奇鋐群益95售04  ,0,0,0,0,0,0,0,0,0,-39000,0,0,0,12000,51000,-39000,-39000
051774,聯茂中信96購01  ,0,0,0,0,0,0,0,0,0,-39000,0,0,0,31000,70000,-39000,-39000
055556,奇力新凱基98購03,0,0,0,0,0,0,0,0,0,-39000,0,0,0,10000,49000,-39000,-39000
055809,T50反1國票98購02,0,0,0,0,0,0,0,0,0,-39000,0,0,0,0,39000,-39000,-39000
059162,國巨凱基99購12  ,0,0,0,0,0,0,0,0,0,-39000,0,0,0,22000,61000,-39000,-39000
2459,敦吉            ,0,38000,-38000,0,0,0,0,0,0,-1000,1000,2000,-1000,0,0,0,-39000
2419,仲琦            ,263000,301000,-38000,0,0,0,0,0,0,-1000,0,1000,-1000,0,0,0,-39000
2013,中鋼構          ,12000,51000,-39000,0,0,0,0,0,0,0,0,0,0,0,0,0,-39000
1612,宏泰            ,15000,54000,-39000,0,0,0,0,0,0,0,0,0,0,0,0,0,-39000
1528,恩德            ,24000,63000,-39000,0,0,0,0,0,0,0,0,0,0,0,0,0,-39000
07500P,微星元大9A售01  ,0,0,0,0,0,0,0,0,0,-39000,0,0,0,0,39000,-39000,-39000
059964,元金2X凱基99購02,0,0,0,0,0,0,0,0,0,-40000,0,0,0,0,40000,-40000,-40000
059531,華新科凱基9B購02,0,0,0,0,0,0,0,0,0,-40000,0,0,0,0,40000,-40000,-40000
059899,上証2X元大9C購04,0,0,0,0,0,0,0,0,0,-40000,0,0,0,0,40000,-40000,-40000
059830,台郡凱基99購05  ,0,0,0,0,0,0,0,0,0,-40000,0,0,0,155000,195000,-40000,-40000
060333,金寶康和9A購01  ,0,0,0,0,0,0,0,0,0,-40000,0,0,0,10000,50000,-40000,-40000
060389,世紀鋼凱基9B購02,0,0,0,0,0,0,0,0,0,-40000,0,0,0,0,40000,-40000,-40000
060881,玉山金中信02購01,0,0,0,0,0,0,0,0,0,-40000,0,0,0,42000,82000,-40000,-40000
060711,旺宏永豐9A購01  ,0,0,0,0,0,0,0,0,0,-40000,0,0,0,0,40000,-40000,-40000
061530,智邦台新9A購02  ,0,0,0,0,0,0,0,0,0,-40000,0,0,0,0,40000,-40000,-40000
061180,華擎凱基9B購01  ,0,0,0,0,0,0,0,0,0,-40000,0,0,0,0,40000,-40000,-40000
060946,世紀鋼國票9A購02,0,0,0,0,0,0,0,0,0,-40000,0,0,0,0,40000,-40000,-40000
061674,聯發科元大9A購12,0,0,0,0,0,0,0,0,0,-40000,0,0,0,17000,57000,-40000,-40000
053609,華新中信9A購01  ,0,0,0,0,0,0,0,0,0,-40000,0,0,0,0,40000,-40000,-40000
054905,國揚康和97購01  ,0,0,0,0,0,0,0,0,0,-40000,0,0,0,2000,42000,-40000,-40000
054862,群光群益97購01  ,0,0,0,0,0,0,0,0,0,-40000,0,0,0,40000,80000,-40000,-40000
050117,麗豐元大96購02  ,0,0,0,0,0,0,0,0,0,-40000,0,0,0,0,40000,-40000,-40000
054266,緯穎元大96購07  ,0,0,0,0,0,0,0,0,0,-40000,0,0,0,0,40000,-40000,-40000
054370,台積電中信9A購01,0,0,0,0,0,0,0,0,0,-40000,0,0,0,210000,250000,-40000,-40000
052860,旺宏凱基96購03  ,0,0,0,0,0,0,0,0,0,-40000,0,0,0,0,40000,-40000,-40000
059311,元石油元大99購04,0,0,0,0,0,0,0,0,0,-40000,0,0,0,110000,150000,-40000,-40000
059073,元油2X元大9C購14,0,0,0,0,0,0,0,0,0,-40000,0,0,0,40000,80000,-40000,-40000
057596,聯茂兆豐99購01  ,0,0,0,0,0,0,0,0,0,-40000,0,0,0,0,40000,-40000,-40000
057481,技嘉元大98購04  ,0,0,0,0,0,0,0,0,0,-40000,0,0,0,0,40000,-40000,-40000
057077,國巨統一98購06  ,0,0,0,0,0,0,0,0,0,-40000,0,0,0,88000,128000,-40000,-40000
056416,華新科中信98購01,0,0,0,0,0,0,0,0,0,-40000,0,0,0,0,40000,-40000,-40000
058845,元油2X群益9C購04,0,0,0,0,0,0,0,0,0,-40000,0,0,0,0,40000,-40000,-40000
05865P,大立光元大96售09,0,0,0,0,0,0,0,0,0,-40000,0,0,0,0,40000,-40000,-40000
055797,華通富邦98購01  ,0,0,0,0,0,0,0,0,0,-40000,0,0,0,0,40000,-40000,-40000
056986,超眾群益98購03  ,0,0,0,0,0,0,0,0,0,-40000,0,0,0,0,40000,-40000,-40000
057683,技嘉日盛98購01  ,0,0,0,0,0,0,0,0,0,-40000,0,0,0,1000,41000,-40000,-40000
058168,國巨凱基9A購04  ,0,0,0,0,0,0,0,0,0,-40000,0,0,0,0,40000,-40000,-40000
07469P,台達電元大9A售01,0,0,0,0,0,0,0,0,0,-40000,0,0,0,20000,60000,-40000,-40000
07785P,鴻海中信04售03  ,0,0,0,0,0,0,0,0,0,-40000,0,0,0,0,40000,-40000,-40000
07776P,國巨群益9B售02  ,0,0,0,0,0,0,0,0,0,-40000,0,0,0,210000,250000,-40000,-40000
07750P,台表科凱基9A售04,0,0,0,0,0,0,0,0,0,-40000,0,0,0,30000,70000,-40000,-40000
07068P,欣興台新99售01  ,0,0,0,0,0,0,0,0,0,-40000,0,0,0,0,40000,-40000,-40000
06991P,矽創群益99售01  ,0,0,0,0,0,0,0,0,0,-40000,0,0,0,0,40000,-40000,-40000
1452,宏益            ,0,40000,-40000,0,0,0,0,0,0,0,0,0,0,0,0,0,-40000
6235,華孚            ,54000,91000,-37000,0,0,0,0,0,0,-3000,0,3000,-3000,0,0,0,-40000
9946,三發地產        ,0,40000,-40000,0,0,0,0,0,0,0,0,0,0,0,0,0,-40000
06254P,臺股指群益97售07,0,0,0,0,0,0,0,0,0,-41000,0,0,0,110000,151000,-41000,-41000
06866P,聯發科元大98售13,0,0,0,0,0,0,0,0,0,-41000,0,0,0,19000,60000,-41000,-41000
060284,南港元大01購01  ,0,0,0,0,0,0,0,0,0,-41000,0,0,0,75000,116000,-41000,-41000
060017,全新康和99購01  ,0,0,0,0,0,0,0,0,0,-41000,0,0,0,0,41000,-41000,-41000
053234,奇鋐永豐96購01  ,0,0,0,0,0,0,0,0,0,-41000,0,0,0,0,41000,-41000,-41000
058355,旺宏凱基99購04  ,0,0,0,0,0,0,0,0,0,-41000,0,0,0,1000,42000,-41000,-41000
05683P,矽創元大96售01  ,0,0,0,0,0,0,0,0,0,-41000,0,0,0,10000,51000,-41000,-41000
057629,泰碩永豐98購02  ,0,0,0,0,0,0,0,0,0,-41000,0,0,0,0,41000,-41000,-41000
057009,信邦中信99購01  ,0,0,0,0,0,0,0,0,0,-41000,0,0,0,6000,47000,-41000,-41000
057054,立積元大98購03  ,2000,0,2000,0,0,0,0,0,0,-43000,0,0,0,47000,90000,-43000,-41000
056713,華擎永豐98購01  ,0,0,0,0,0,0,0,0,0,-41000,0,0,0,40000,81000,-41000,-41000
057283,欣興元大98購07  ,0,0,0,0,0,0,0,0,0,-41000,0,0,0,64000,105000,-41000,-41000
05627P,致伸國票97售01  ,0,0,0,0,0,0,0,0,0,-41000,0,0,0,24000,65000,-41000,-41000
056330,玉晶光國票99購03,0,0,0,0,0,0,0,0,0,-41000,0,0,0,16000,57000,-41000,-41000
8114,振樺電          ,6000,47000,-41000,0,0,0,0,0,0,0,0,0,0,0,0,0,-41000
6183,關貿            ,12000,52000,-40000,0,0,0,0,0,0,-1000,0,1000,-1000,0,0,0,-41000
2704,國賓            ,52000,93000,-41000,0,0,0,0,0,0,0,0,0,0,0,0,0,-41000
07849P,大立光群益9A售06,0,0,0,0,0,0,0,0,0,-41000,0,0,0,15000,56000,-41000,-41000
07558P,玉晶光元大9A售10,0,0,0,0,0,0,0,0,0,-41000,0,0,0,0,41000,-41000,-41000
059965,鴻海凱基99購16  ,0,0,0,0,0,0,0,0,0,-42000,0,0,0,10000,52000,-42000,-42000
059995,南亞科元富99購01,0,0,0,0,0,0,0,0,0,-42000,0,0,0,82000,124000,-42000,-42000
059768,上証2X群益9C購02,0,0,0,0,0,0,0,0,0,-42000,0,0,0,0,42000,-42000,-42000
060384,葡萄王凱基9B購01,0,0,0,0,0,0,0,0,0,-42000,0,0,0,0,42000,-42000,-42000
060681,華擎元大9A購02  ,0,0,0,0,0,0,0,0,0,-42000,0,0,0,0,42000,-42000,-42000
060631,微星富邦9B購01  ,0,0,0,0,0,0,0,0,0,-42000,0,0,0,78000,120000,-42000,-42000
060905,台積電元大9A購20,0,0,0,0,0,0,0,0,0,-42000,0,0,0,28000,70000,-42000,-42000
061610,力成統一9C購01  ,0,0,0,0,0,0,0,0,0,-42000,0,0,0,25000,67000,-42000,-42000
057995,華新科中信98購02,0,0,0,0,0,0,0,0,0,-42000,0,0,0,176000,218000,-42000,-42000
05500P,臺股指中信96售04,0,0,0,0,0,0,0,0,0,-42000,0,0,0,28000,70000,-42000,-42000
047196,上銀統一97購01  ,0,0,0,0,0,0,0,0,0,-42000,0,0,0,47000,89000,-42000,-42000
059341,台積電凱基99購15,0,0,0,0,0,0,0,0,0,-42000,0,0,0,0,42000,-42000,-42000
059452,全新永豐99購03  ,0,0,0,0,0,0,0,0,0,-42000,0,0,0,11000,53000,-42000,-42000
056643,奇力新凱基99購01,0,0,0,0,0,0,0,0,0,-42000,0,0,0,10000,52000,-42000,-42000
057413,臺股指群益9C購04,0,0,0,0,0,0,0,0,0,-42000,0,0,0,0,42000,-42000,-42000
058603,台積電元大99購12,0,0,0,0,0,0,0,0,0,-42000,0,0,0,0,42000,-42000,-42000
057628,旺宏永豐98購02  ,0,0,0,0,0,0,0,0,0,-42000,0,0,0,1000,43000,-42000,-42000
058525,台虹元大99購02  ,0,0,0,0,0,0,0,0,0,-42000,0,0,0,78000,120000,-42000,-42000
07677P,祥碩永豐9A售01  ,0,0,0,0,0,0,0,0,0,-42000,0,0,0,0,42000,-42000,-42000
07400P,國巨凱基99售20  ,0,0,0,0,0,0,0,0,0,-42000,0,0,0,5000,47000,-42000,-42000
1527,鑽全            ,127000,169000,-42000,0,0,0,0,0,0,0,0,0,0,0,0,0,-42000
060893,台灣50凱基01購07,0,0,0,0,0,0,0,0,0,-43000,0,0,0,0,43000,-43000,-43000
060237,友達元大9A購06  ,0,0,0,0,0,0,0,0,0,-43000,0,0,0,0,43000,-43000,-43000
054834,帆宣中信97購01  ,0,0,0,0,0,0,0,0,0,-43000,0,0,0,0,43000,-43000,-43000
052038,國巨永昌96購01  ,0,0,0,0,0,0,0,0,0,-43000,0,0,0,20000,63000,-43000,-43000
055336,茂林兆豐98購01  ,0,0,0,0,0,0,0,0,0,-43000,0,0,0,9000,52000,-43000,-43000
053860,台積電元大98購03,0,0,0,0,0,0,0,0,0,-43000,0,0,0,0,43000,-43000,-43000
056842,全新元富98購01  ,0,0,0,0,0,0,0,0,0,-43000,0,0,0,0,43000,-43000,-43000
058947,SGBR2X群益9B購02,0,0,0,0,0,0,0,0,0,-43000,0,0,0,165000,208000,-43000,-43000
057895,全新元富9B購01  ,0,0,0,0,0,0,0,0,0,-43000,0,0,0,0,43000,-43000,-43000
058451,智邦永豐9A購01  ,0,0,0,0,0,0,0,0,0,-43000,0,0,0,10000,53000,-43000,-43000
056394,晶豪科永豐98購01,0,0,0,0,0,0,0,0,0,-43000,0,0,0,31000,74000,-43000,-43000
057325,可成群益9A購01  ,0,0,0,0,0,0,0,0,0,-43000,0,0,0,110000,153000,-43000,-43000
07647P,健策國票9A售04  ,0,0,0,0,0,0,0,0,0,-43000,0,0,0,18000,61000,-43000,-43000
8101,華冠            ,4000,47000,-43000,0,0,0,0,0,0,0,0,0,0,0,0,0,-43000
059852,康控永豐99購02  ,0,0,0,0,0,0,0,0,0,-44000,0,0,0,118000,162000,-44000,-44000
059702,台積電凱基9A購14,0,0,0,0,0,0,0,0,0,-44000,0,0,0,4000,48000,-44000,-44000
06599P,宏達電永豐98售02,0,0,0,0,0,0,0,0,0,-44000,0,0,0,0,44000,-44000,-44000
057096,緯穎元富98購01  ,0,0,0,0,0,0,0,0,0,-44000,0,0,0,240000,284000,-44000,-44000
059219,旺宏元大99購12  ,0,0,0,0,0,0,0,0,0,-44000,0,0,0,42000,86000,-44000,-44000
055626,力山永豐97購01  ,0,0,0,0,0,0,0,0,0,-44000,0,0,0,40000,84000,-44000,-44000
4989,榮科            ,30000,74000,-44000,0,0,0,0,0,0,0,0,0,0,0,0,0,-44000
3356,奇偶            ,9000,52000,-43000,0,0,0,0,0,0,-1000,0,1000,-1000,0,0,0,-44000
07022P,嘉晶永豐99售02  ,0,0,0,0,0,0,0,0,0,-44000,0,0,0,0,44000,-44000,-44000
061556,台積電國票9A購08,0,0,0,0,0,0,0,0,0,-45000,0,0,0,9000,54000,-45000,-45000
059729,群創元大9C購05  ,0,0,0,0,0,0,0,0,0,-45000,0,0,0,0,45000,-45000,-45000
059787,奇力新元大9A購02,0,0,0,0,0,0,0,0,0,-45000,0,0,0,18000,63000,-45000,-45000
058245,訊連元大99購01  ,0,0,0,0,0,0,0,0,0,-45000,0,0,0,412000,457000,-45000,-45000
054408,義隆國票98購01  ,0,0,0,0,0,0,0,0,0,-45000,0,0,0,42000,87000,-45000,-45000
053527,創意中信97購01  ,0,0,0,0,0,0,0,0,0,-45000,0,0,0,0,45000,-45000,-45000
052806,玉晶光元大98購04,0,0,0,0,0,0,0,0,0,-45000,0,0,0,0,45000,-45000,-45000
058874,聯鈞國票9A購01  ,0,0,0,0,0,0,0,0,0,-45000,0,0,0,5000,50000,-45000,-45000
058585,S&P正2中信9B購02,0,0,0,0,0,0,0,0,0,-45000,0,0,0,0,45000,-45000,-45000
057916,國巨凱基98購13  ,0,0,0,0,0,0,0,0,0,-45000,0,0,0,5000,50000,-45000,-45000
058060,貿聯元富98購01  ,0,0,0,0,0,0,0,0,0,-45000,0,0,0,0,45000,-45000,-45000
059228,臺股指元大99購21,0,0,0,0,0,0,0,0,0,-45000,0,0,0,0,45000,-45000,-45000
059377,台積電群益99購09,0,0,0,0,0,0,0,0,0,-45000,0,0,0,10000,55000,-45000,-45000
056639,國產康和98購01  ,0,0,0,0,0,0,0,0,0,-45000,0,0,0,0,45000,-45000,-45000
07386P,臺股指群益99售24,0,0,0,0,0,0,0,0,0,-45000,0,0,0,0,45000,-45000,-45000
2114,鑫永銓          ,2000,47000,-45000,0,0,0,0,0,0,0,0,0,0,0,0,0,-45000
2415,錩新            ,18000,62000,-44000,0,0,0,0,0,0,-1000,0,1000,-1000,0,0,0,-45000
2516,新建            ,0,45000,-45000,0,0,0,0,0,0,0,0,0,0,0,0,0,-45000
9188,精熙-DR         ,0,45000,-45000,0,0,0,0,0,0,0,0,0,0,0,0,0,-45000
059730,晶相光元大9C購02,0,0,0,0,0,0,0,0,0,-46000,0,0,0,9000,55000,-46000,-46000
059568,台積電凱基9A購13,0,0,0,0,0,0,0,0,0,-46000,0,0,0,9000,55000,-46000,-46000
060661,台積電凱基9A購18,0,0,0,0,0,0,0,0,0,-46000,0,0,0,0,46000,-46000,-46000
060485,華新科富邦9C購04,0,0,0,0,0,0,0,0,0,-46000,0,0,0,0,46000,-46000,-46000
060513,緯穎元大9B購01  ,0,0,0,0,0,0,0,0,0,-46000,0,0,0,90000,136000,-46000,-46000
060527,台積電中信9C購04,0,0,0,0,0,0,0,0,0,-46000,0,0,0,4000,50000,-46000,-46000
060566,聯詠富邦9C購01  ,0,0,0,0,0,0,0,0,0,-46000,0,0,0,590000,636000,-46000,-46000
061571,奇力新元大9A購03,0,0,0,0,0,0,0,0,0,-46000,0,0,0,51000,97000,-46000,-46000
061613,南六統一9C購01  ,0,0,0,0,0,0,0,0,0,-46000,0,0,0,0,46000,-46000,-46000
061770,泰碩元大9B購02  ,0,0,0,0,0,0,0,0,0,-46000,0,0,0,0,46000,-46000,-46000
06904P,TPK凱基98售03   ,0,0,0,0,0,0,0,0,0,-46000,0,0,0,261000,307000,-46000,-46000
054737,京元電凱基99購01,0,0,0,0,0,0,0,0,0,-46000,0,0,0,0,46000,-46000,-46000
052456,滬深2X元富9B購03,0,0,0,0,0,0,0,0,0,-46000,0,0,0,0,46000,-46000,-46000
00713,元大台灣高息低波,1000,1000,0,0,0,0,0,0,0,-46000,0,0,0,1000,47000,-46000,-46000
055147,鴻海元大97購11  ,0,0,0,0,0,0,0,0,0,-46000,0,0,0,2000,48000,-46000,-46000
05731P,創意統一96售03  ,0,0,0,0,0,0,0,0,0,-46000,0,0,0,0,46000,-46000,-46000
058649,健策永豐99購01  ,0,0,0,0,0,0,0,0,0,-46000,0,0,0,22000,68000,-46000,-46000
5525,順天            ,3000,49000,-46000,0,0,0,0,0,0,0,0,0,0,0,0,0,-46000
8033,雷虎            ,0,46000,-46000,0,0,0,0,0,0,0,0,0,0,0,0,0,-46000
2423,固緯            ,48000,93000,-45000,0,0,0,0,0,0,-1000,0,1000,-1000,0,0,0,-46000
2911,麗嬰房          ,0,46000,-46000,0,0,0,0,0,0,0,0,0,0,0,0,0,-46000
060981,旺宏元大9A購08  ,0,0,0,0,0,0,0,0,0,-47000,0,0,0,12000,59000,-47000,-47000
059626,台積電凱基01購01,0,0,0,0,0,0,0,0,0,-47000,0,0,0,38000,85000,-47000,-47000
059796,台積電國票99購10,0,0,0,0,0,0,0,0,0,-47000,0,0,0,7000,54000,-47000,-47000
059786,全新元大99購06  ,0,0,0,0,0,0,0,0,0,-47000,0,0,0,4000,51000,-47000,-47000
059903,S&P正2元大99購02,0,0,0,0,0,0,0,0,0,-47000,0,0,0,3000,50000,-47000,-47000
054406,旺宏國票98購01  ,0,0,0,0,0,0,0,0,0,-47000,0,0,0,0,47000,-47000,-47000
054550,旺宏凱基98購02  ,0,0,0,0,0,0,0,0,0,-47000,0,0,0,28000,75000,-47000,-47000
056817,國巨永豐98購04  ,0,0,0,0,0,0,0,0,0,-47000,0,0,0,0,47000,-47000,-47000
052004,泰碩國泰97購03  ,0,0,0,0,0,0,0,0,0,-47000,0,0,0,102000,149000,-47000,-47000
058924,晶相光元富99購02,0,0,0,0,0,0,0,0,0,-47000,0,0,0,3000,50000,-47000,-47000
059001,聯發科元大99購17,0,0,0,0,0,0,0,0,0,-47000,0,0,0,1000,48000,-47000,-47000
056564,亞光群益98購02  ,0,0,0,0,0,0,0,0,0,-47000,0,0,0,151000,198000,-47000,-47000
056580,泰鼎元大9A購01  ,0,0,0,0,0,0,0,0,0,-47000,0,0,0,0,47000,-47000,-47000
057201,華擎元富98購01  ,0,0,0,0,0,0,0,0,0,-47000,0,0,0,11000,58000,-47000,-47000
056237,智邦群益97購02  ,0,0,0,0,0,0,0,0,0,-47000,0,0,0,17000,64000,-47000,-47000
05626P,景碩國票97售03  ,0,0,0,0,0,0,0,0,0,-47000,0,0,0,6000,53000,-47000,-47000
2923,鼎固-KY         ,6000,53000,-47000,0,0,0,0,0,0,0,0,0,0,0,0,0,-47000
2705,六福            ,4000,51000,-47000,0,0,0,0,0,0,0,0,0,0,0,0,0,-47000
2608,嘉里大榮        ,103000,150000,-47000,0,0,0,0,0,0,0,0,0,0,0,0,0,-47000
07831P,大立光統一9B售07,0,0,0,0,0,0,0,0,0,-47000,0,0,0,0,47000,-47000,-47000
07833P,大立光群益9B售02,0,0,0,0,0,0,0,0,0,-47000,0,0,0,0,47000,-47000,-47000
8261,富鼎            ,79000,126000,-47000,0,0,0,0,0,0,0,0,0,0,0,0,0,-47000
05979P,華新科中信96售02,0,0,0,0,0,0,0,0,0,-48000,0,0,0,30000,78000,-48000,-48000
060565,大立光富邦01購01,0,0,0,0,0,0,0,0,0,-48000,0,0,0,20000,68000,-48000,-48000
060417,正隆永豐9A購01  ,0,0,0,0,0,0,0,0,0,-48000,0,0,0,38000,86000,-48000,-48000
060304,大立光富邦9C購05,0,0,0,0,0,0,0,0,0,-48000,0,0,0,2000,50000,-48000,-48000
060793,微星永豐9A購01  ,0,0,0,0,0,0,0,0,0,-48000,0,0,0,20000,68000,-48000,-48000
06839P,玉晶光統一9A售05,0,0,0,0,0,0,0,0,0,-48000,0,0,0,95000,143000,-48000,-48000
02001L,富邦蘋果正二N   ,0,0,0,0,0,0,0,0,0,-48000,0,0,0,0,48000,-48000,-48000
059200,京鼎永豐99購02  ,0,0,0,0,0,0,0,0,0,-48000,0,0,0,124000,172000,-48000,-48000
056904,大立光元大99購05,0,0,0,0,0,0,0,0,0,-48000,0,0,0,0,48000,-48000,-48000
058864,欣興凱基99購04  ,0,0,0,0,0,0,0,0,0,-48000,0,0,0,0,48000,-48000,-48000
056192,智邦富邦98購01  ,0,0,0,0,0,0,0,0,0,-48000,0,0,0,6000,54000,-48000,-48000
3607,谷崧            ,14000,61000,-47000,0,0,0,0,0,0,-1000,0,1000,-1000,0,0,0,-48000
07784P,華新科富邦9B售04,0,0,0,0,0,0,0,0,0,-48000,0,0,0,0,48000,-48000,-48000
07223P,鴻海元大99售29  ,0,0,0,0,0,0,0,0,0,-48000,0,0,0,41000,89000,-48000,-48000
2477,美隆電          ,3000,50000,-47000,0,0,0,0,0,0,-1000,0,1000,-1000,0,0,0,-48000
1315,達新            ,72000,120000,-48000,0,0,0,0,0,0,0,0,0,0,0,0,0,-48000
06551P,貿聯元大98售05  ,0,0,0,0,0,0,0,0,0,-49000,0,0,0,50000,99000,-49000,-49000
061569,旺宏元大9A購14  ,0,0,0,0,0,0,0,0,0,-49000,0,0,0,24000,73000,-49000,-49000
061658,聯茂富邦9A購03  ,0,0,0,0,0,0,0,0,0,-49000,0,0,0,21000,70000,-49000,-49000
061515,泰碩永豐9A購03  ,0,0,0,0,0,0,0,0,0,-49000,0,0,0,0,49000,-49000,-49000
060834,道瓊反國票9C購01,0,0,0,0,0,0,0,0,0,-49000,0,0,0,1000,50000,-49000,-49000
060848,聯茂國票9A購02  ,0,0,0,0,0,0,0,0,0,-49000,0,0,0,8000,57000,-49000,-49000
059848,智邦永豐99購01  ,0,0,0,0,0,0,0,0,0,-49000,0,0,0,22000,71000,-49000,-49000
059613,泰鼎永豐99購02  ,0,0,0,0,0,0,0,0,0,-49000,0,0,0,50000,99000,-49000,-49000
050135,禾伸堂兆豐95購01,0,0,0,0,0,0,0,0,0,-49000,0,0,0,0,49000,-49000,-49000
055776,宏達電凱基98購02,0,0,0,0,0,0,0,0,0,-49000,0,0,0,0,49000,-49000,-49000
059460,GIS永豐99購02   ,0,0,0,0,0,0,0,0,0,-49000,0,0,0,71000,120000,-49000,-49000
059131,國巨群益99購07  ,0,0,0,0,0,0,0,0,0,-49000,0,0,0,11000,60000,-49000,-49000
057567,嘉聯益富邦9A購01,0,0,0,0,0,0,0,0,0,-49000,0,0,0,200000,249000,-49000,-49000
07131P,緯穎元大99售06  ,0,0,0,0,0,0,0,0,0,-49000,0,0,0,1000,50000,-49000,-49000
07728P,臺股指凱基9A售20,0,0,0,0,0,0,0,0,0,-49000,0,0,0,7000,56000,-49000,-49000
1590,亞德客-KY       ,1751888,1755932,-4044,0,0,0,11000,8000,3000,-48000,12000,2000,10000,15000,73000,-58000,-49044
059692,聯詠永豐99購01  ,0,0,0,0,0,0,0,0,0,-50000,0,0,0,70000,120000,-50000,-50000
060189,宏達電元富9B購03,0,0,0,0,0,0,0,0,0,-50000,0,0,0,0,50000,-50000,-50000
060171,宏達電台新9A購01,0,0,0,0,0,0,0,0,0,-50000,0,0,0,0,50000,-50000,-50000
059972,S&P正2元大99購03,0,0,0,0,0,0,0,0,0,-50000,0,0,0,12000,62000,-50000,-50000
059936,台積電永豐99購06,0,0,0,0,0,0,0,0,0,-50000,0,0,0,0,50000,-50000,-50000
061449,大立光中信9C購02,0,0,0,0,0,0,0,0,0,-50000,0,0,0,0,50000,-50000,-50000
061664,上銀中信9A購01  ,0,0,0,0,0,0,0,0,0,-50000,0,0,0,0,50000,-50000,-50000
06199P,聯發科元大97售17,0,0,0,0,0,0,0,0,0,-50000,0,0,0,20000,70000,-50000,-50000
06395P,台積電元大97售29,0,0,0,0,0,0,0,0,0,-50000,0,0,0,10000,60000,-50000,-50000
06832P,玉晶光凱基98售03,0,0,0,0,0,0,0,0,0,-50000,0,0,0,250000,300000,-50000,-50000
052680,T50反1元大96購04,0,0,0,0,0,0,0,0,0,-50000,0,0,0,0,50000,-50000,-50000
051239,國巨元大96購02  ,0,0,0,0,0,0,0,0,0,-50000,0,0,0,0,50000,-50000,-50000
052304,可成永豐95購03  ,0,0,0,0,0,0,0,0,0,-50000,0,0,0,0,50000,-50000,-50000
047418,智邦富邦97購01  ,0,0,0,0,0,0,0,0,0,-50000,0,0,0,0,50000,-50000,-50000
054617,超眾永豐97購01  ,0,0,0,0,0,0,0,0,0,-50000,0,0,0,0,50000,-50000,-50000
054237,茂林群益97購01  ,0,0,0,0,0,0,0,0,0,-50000,0,0,0,0,50000,-50000,-50000
054120,奇力新永豐96購01,0,0,0,0,0,0,0,0,0,-50000,0,0,0,0,50000,-50000,-50000
054163,燿華凱基97購02  ,0,0,0,0,0,0,0,0,0,-50000,0,0,0,40000,90000,-50000,-50000
055064,碩天永豐97購01  ,0,0,0,0,0,0,0,0,0,-50000,0,0,0,0,50000,-50000,-50000
054062,TPK國票96購02   ,0,0,0,0,0,0,0,0,0,-50000,0,0,0,40000,90000,-50000,-50000
053994,微星群益96購01  ,0,0,0,0,0,0,0,0,0,-50000,0,0,0,0,50000,-50000,-50000
053123,京元電凱基96購01,0,0,0,0,0,0,0,0,0,-50000,0,0,0,0,50000,-50000,-50000
052888,台表科中信9A購01,0,0,0,0,0,0,0,0,0,-50000,0,0,0,0,50000,-50000,-50000
052857,大成鋼凱基96購01,0,0,0,0,0,0,0,0,0,-50000,0,0,0,15000,65000,-50000,-50000
057406,茂林群益98購03  ,0,0,0,0,0,0,0,0,0,-50000,0,0,0,0,50000,-50000,-50000
056696,茂林群益98購02  ,0,0,0,0,0,0,0,0,0,-50000,0,0,0,0,50000,-50000,-50000
056431,鴻海凱基98購07  ,0,0,0,0,0,0,0,0,0,-50000,0,0,0,0,50000,-50000,-50000
057172,南亞科元大98購03,0,0,0,0,0,0,0,0,0,-50000,0,0,0,0,50000,-50000,-50000
059183,T50反1台新03購02,0,0,0,0,0,0,0,0,0,-50000,0,0,0,0,50000,-50000,-50000
056979,微星群益98購01  ,0,0,0,0,0,0,0,0,0,-50000,0,0,0,141000,191000,-50000,-50000
05851P,力山群益97售01  ,0,0,0,0,0,0,0,0,0,-50000,0,0,0,50000,100000,-50000,-50000
056025,嘉晶群益97購01  ,0,0,0,0,0,0,0,0,0,-50000,0,0,0,0,50000,-50000,-50000
1463,強盛            ,4000,54000,-50000,0,0,0,0,0,0,0,0,0,0,0,0,0,-50000
2466,冠西電          ,1000,49000,-48000,0,0,0,0,0,0,-2000,0,2000,-2000,0,0,0,-50000
3013,晟銘電          ,0,48000,-48000,0,0,0,0,0,0,-2000,0,2000,-2000,0,0,0,-50000
07742P,台積電凱基9A售25,0,0,0,0,0,0,0,0,0,-50000,0,0,0,20000,70000,-50000,-50000
07690P,華新科元大9A售15,0,0,0,0,0,0,0,0,0,-50000,0,0,0,0,50000,-50000,-50000
07702P,台積電中信9A售06,0,0,0,0,0,0,0,0,0,-50000,0,0,0,20000,70000,-50000,-50000
07514P,台積電元大9A售14,0,0,0,0,0,0,0,0,0,-50000,0,0,0,0,50000,-50000,-50000
07191P,台積電元大99售32,0,0,0,0,0,0,0,0,0,-50000,0,0,0,20000,70000,-50000,-50000
07411P,國巨元大99售31  ,0,0,0,0,0,0,0,0,0,-50000,0,0,0,150000,200000,-50000,-50000
5243,乙盛-KY         ,105000,153000,-48000,0,0,0,0,0,0,-2000,0,2000,-2000,0,0,0,-50000
9924,福興            ,12000,68000,-56000,0,0,0,0,0,0,6000,6000,0,6000,0,0,0,-50000
9955,佳龍            ,20000,70000,-50000,0,0,0,0,0,0,0,0,0,0,0,0,0,-50000
061549,泰碩群益9A購01  ,0,0,0,0,0,0,0,0,0,-51000,0,0,0,0,51000,-51000,-51000
060713,聯詠永豐9A購01  ,0,0,0,0,0,0,0,0,0,-51000,0,0,0,137000,188000,-51000,-51000
060328,可成群益9A購06  ,0,0,0,0,0,0,0,0,0,-51000,0,0,0,4000,55000,-51000,-51000
054558,劍麟群益99購01  ,0,0,0,0,0,0,0,0,0,-51000,0,0,0,0,51000,-51000,-51000
057614,華新科元富99購04,0,0,0,0,0,0,0,0,0,-51000,0,0,0,0,51000,-51000,-51000
055527,旺宏群益99購03  ,0,0,0,0,0,0,0,0,0,-51000,0,0,0,4000,55000,-51000,-51000
058701,鴻海元大99購16  ,0,0,0,0,0,0,0,0,0,-51000,0,0,0,0,51000,-51000,-51000
8422,可寧衛          ,12000,63000,-51000,0,0,0,0,0,0,0,0,0,0,0,0,0,-51000
3305,昇貿            ,0,48000,-48000,0,0,0,0,0,0,-3000,0,3000,-3000,0,0,0,-51000
1414,東和            ,0,51000,-51000,0,0,0,0,0,0,0,0,0,0,0,0,0,-51000
060688,世紀鋼元大9C購01,0,0,0,0,0,0,0,0,0,-52000,0,0,0,11000,63000,-52000,-52000
06010P,國泰金元富96售01,0,0,0,0,0,0,0,0,0,-52000,0,0,0,9000,61000,-52000,-52000
060986,聯發科元大9A購07,0,0,0,0,0,0,0,0,0,-52000,0,0,0,192000,244000,-52000,-52000
061160,瑞祺群益9A購01  ,0,0,0,0,0,0,0,0,0,-52000,0,0,0,81000,133000,-52000,-52000
054091,晶豪科群益96購01,0,0,0,0,0,0,0,0,0,-52000,0,0,0,111000,163000,-52000,-52000
054217,台表科國票97購05,0,0,0,0,0,0,0,0,0,-52000,0,0,0,0,52000,-52000,-52000
055440,矽力國票98購01  ,0,0,0,0,0,0,0,0,0,-52000,0,0,0,3000,55000,-52000,-52000
053442,光罩凱基96購01  ,0,0,0,0,0,0,0,0,0,-52000,0,0,0,0,52000,-52000,-52000
058850,華新科群益99購03,0,0,0,0,0,0,0,0,0,-52000,0,0,0,0,52000,-52000,-52000
058037,台灣50元大9B購02,0,0,0,0,0,0,0,0,0,-52000,0,0,0,0,52000,-52000,-52000
059201,祥碩永豐99購02  ,0,0,0,0,0,0,0,0,0,-52000,0,0,0,10000,62000,-52000,-52000
057598,鴻海群益98購07  ,0,0,0,0,0,0,0,0,0,-52000,0,0,0,0,52000,-52000,-52000
057375,欣興元大98購09  ,0,0,0,0,0,0,0,0,0,-52000,0,0,0,1000,53000,-52000,-52000
057479,致茂元大98購03  ,0,0,0,0,0,0,0,0,0,-52000,0,0,0,0,52000,-52000,-52000
1737,臺鹽            ,38000,90000,-52000,0,0,0,0,0,0,0,0,0,0,0,0,0,-52000
6168,宏齊            ,69000,121000,-52000,0,0,0,0,0,0,0,1000,1000,0,0,0,0,-52000
8462,柏文            ,66000,111000,-45000,0,0,0,0,0,0,-7000,0,0,0,6000,13000,-7000,-52000
8021,尖點            ,211000,262800,-51800,0,0,0,0,0,0,-1000,1000,2000,-1000,0,0,0,-52800
061029,力山永豐9A購01  ,0,0,0,0,0,0,0,0,0,-53000,0,0,0,83000,136000,-53000,-53000
061454,國巨凱基9A購16  ,0,0,0,0,0,0,0,0,0,-53000,0,0,0,36000,89000,-53000,-53000
059522,上証2X凱基9B購02,0,0,0,0,0,0,0,0,0,-53000,0,0,0,0,53000,-53000,-53000
059912,國巨元大99購28  ,0,0,0,0,0,0,0,0,0,-53000,0,0,0,0,53000,-53000,-53000
06055P,華通凱基97售04  ,0,0,0,0,0,0,0,0,0,-53000,0,0,0,5000,58000,-53000,-53000
053430,樺漢永豐96購01  ,0,0,0,0,0,0,0,0,0,-53000,0,0,0,23000,76000,-53000,-53000
03603P,群創凱基98售04  ,0,0,0,0,0,0,0,0,0,-53000,0,0,0,8000,61000,-53000,-53000
049842,道瓊反中信98購01,0,0,0,0,0,0,0,0,0,-53000,0,0,0,0,53000,-53000,-53000
051728,道瓊反國票97購01,0,0,0,0,0,0,0,0,0,-53000,0,0,0,13000,66000,-53000,-53000
059485,台灣50兆豐99購02,0,0,0,0,0,0,0,0,0,-53000,0,0,0,0,53000,-53000,-53000
055648,可成元富97購01  ,0,0,0,0,0,0,0,0,0,-53000,0,0,0,10000,63000,-53000,-53000
055732,全新元富9A購01  ,0,0,0,0,0,0,0,0,0,-53000,0,0,0,0,53000,-53000,-53000
056403,茂林群益98購01  ,0,0,0,0,0,0,0,0,0,-53000,0,0,0,6000,59000,-53000,-53000
6115,鎰勝            ,10000,63000,-53000,0,0,0,0,0,0,0,0,0,0,0,0,0,-53000
3591,艾笛森          ,1000,54000,-53000,0,0,0,0,0,0,0,0,0,0,0,0,0,-53000
07555P,玉晶光元大9A售07,0,0,0,0,0,0,0,0,0,-53000,0,0,0,0,53000,-53000,-53000
060671,亞德客元大9A購03,0,1000,-1000,0,0,0,0,0,0,-53000,0,0,0,236000,289000,-53000,-54000
06021P,世紀鋼元富96售03,0,0,0,0,0,0,0,0,0,-54000,0,0,0,0,54000,-54000,-54000
061054,台積電群益9A購04,0,0,0,0,0,0,0,0,0,-54000,0,0,0,99000,153000,-54000,-54000
058047,可成元大98購11  ,0,0,0,0,0,0,0,0,0,-54000,0,0,0,18000,72000,-54000,-54000
059399,滬深2X元富9C購03,0,0,0,0,0,0,0,0,0,-54000,0,0,0,0,54000,-54000,-54000
07228P,台灣50群益9B售06,0,0,0,0,0,0,0,0,0,-54000,0,0,0,64000,118000,-54000,-54000
4560,強信-KY         ,144000,198000,-54000,0,0,0,0,0,0,0,0,0,0,0,0,0,-54000
060926,宏達電永豐9A購01,0,0,0,0,0,0,0,0,0,-55000,0,0,0,0,55000,-55000,-55000
06962P,華新科永豐99售01,0,0,0,0,0,0,0,0,0,-55000,0,0,0,20000,75000,-55000,-55000
06572P,台積電永昌99售01,0,0,0,0,0,0,0,0,0,-55000,0,0,0,182000,237000,-55000,-55000
06734P,智邦凱基98售05  ,0,0,0,0,0,0,0,0,0,-55000,0,0,0,25000,80000,-55000,-55000
061765,義隆元大9B購01  ,0,0,0,0,0,0,0,0,0,-55000,0,0,0,0,55000,-55000,-55000
060658,台灣50凱基01購04,0,0,0,0,0,0,0,0,0,-55000,0,0,0,17000,72000,-55000,-55000
060887,台積電統一01購01,0,0,0,0,0,0,0,0,0,-55000,0,0,0,0,55000,-55000,-55000
060280,元金2X元大9A購01,0,0,0,0,0,0,0,0,0,-55000,0,0,0,0,55000,-55000,-55000
060371,A50正2元富01購01,0,0,0,0,0,0,0,0,0,-55000,0,0,0,0,55000,-55000,-55000
060352,滬深2X元富9A購02,0,0,0,0,0,0,0,0,0,-55000,0,0,0,19000,74000,-55000,-55000
054304,台積電凱基96購23,0,0,0,0,0,0,0,0,0,-55000,0,0,0,1000,56000,-55000,-55000
059468,智邦元大99購02  ,0,0,0,0,0,0,0,0,0,-55000,0,0,0,20000,75000,-55000,-55000
059313,元石油元大99購06,0,0,0,0,0,0,0,0,0,-55000,0,0,0,160000,215000,-55000,-55000
056615,燿華永豐98購02  ,0,0,0,0,0,0,0,0,0,-55000,0,0,0,1000,56000,-55000,-55000
057670,欣興元大99購02  ,0,0,0,0,0,0,0,0,0,-55000,0,0,0,1000,56000,-55000,-55000
6541,泰福-KY         ,53000,108000,-55000,0,0,0,0,0,0,0,0,0,0,0,0,0,-55000
8103,瀚荃            ,2000,57000,-55000,0,0,0,0,0,0,0,1000,1000,0,0,0,0,-55000
07147P,高鐵元大99售01  ,0,0,0,0,0,0,0,0,0,-55000,0,0,0,145000,200000,-55000,-55000
07084P,S&P正2元富9B售02,20000,0,20000,0,0,0,0,0,0,-75000,0,0,0,0,75000,-75000,-55000
07603P,台積電統一9B售08,0,0,0,0,0,0,0,0,0,-55000,0,0,0,25000,80000,-55000,-55000
1525,江申            ,1000,24000,-23000,0,0,0,0,30000,-30000,-2000,0,2000,-2000,0,0,0,-55000
1531,高林股          ,0,55000,-55000,0,0,0,0,0,0,0,0,0,0,0,0,0,-55000
059844,大立光富邦9C購04,0,0,0,0,0,0,0,0,0,-56000,0,0,0,52000,108000,-56000,-56000
059700,鴻海凱基9A購16  ,0,0,0,0,0,0,0,0,0,-56000,0,0,0,0,56000,-56000,-56000
054582,致新元大97購01  ,0,0,0,0,0,0,0,0,0,-56000,0,0,0,114000,170000,-56000,-56000
058236,大立光元大99購09,0,0,0,0,0,0,0,0,0,-56000,0,0,0,4000,60000,-56000,-56000
058532,禾伸堂元富99購01,0,0,0,0,0,0,0,0,0,-56000,0,0,0,16000,72000,-56000,-56000
058963,華新科兆豐99購05,0,0,0,0,0,0,0,0,0,-56000,0,0,0,170000,226000,-56000,-56000
1435,中福            ,0,56000,-56000,0,0,0,0,0,0,0,0,0,0,0,0,0,-56000
2358,廷鑫            ,3000,59000,-56000,0,0,0,0,0,0,0,0,0,0,0,0,0,-56000
9905,大華            ,2000,58000,-56000,0,0,0,0,0,0,0,0,0,0,0,0,0,-56000
060343,台積電統一9C購02,0,0,0,0,0,0,0,0,0,-57000,0,0,0,8000,65000,-57000,-57000
060521,鴻海中信01購03  ,0,0,0,0,0,0,0,0,0,-57000,0,0,0,0,57000,-57000,-57000
060940,國巨國票9B購03  ,0,0,0,0,0,0,0,0,0,-57000,0,0,0,10000,67000,-57000,-57000
061019,大毅國票9A購01  ,0,0,0,0,0,0,0,0,0,-57000,0,0,0,21000,78000,-57000,-57000
052459,道瓊反統一95購04,0,0,0,0,0,0,0,0,0,-57000,0,0,0,1000,58000,-57000,-57000
058960,臺股指國票99購05,0,0,0,0,0,0,0,0,0,-57000,0,0,0,0,57000,-57000,-57000
059063,康控凱基99購04  ,0,0,0,0,0,0,0,0,0,-57000,0,0,0,0,57000,-57000,-57000
6184,大豐電          ,4000,61000,-57000,0,0,0,0,0,0,0,0,0,0,0,0,0,-57000
6189,豐藝            ,17000,72000,-55000,0,0,0,0,0,0,-2000,1000,3000,-2000,0,0,0,-57000
2485,兆赫            ,103000,160000,-57000,0,0,0,0,0,0,0,4000,4000,0,0,0,0,-57000
1446,宏和            ,10000,67000,-57000,0,0,0,0,0,0,0,0,0,0,0,0,0,-57000
061234,國巨元大9A購18  ,0,0,0,0,0,0,0,0,0,-58000,0,0,0,22000,80000,-58000,-58000
059687,卜蜂永豐99購01  ,0,0,0,0,0,0,0,0,0,-58000,0,0,0,20000,78000,-58000,-58000
059868,台光電凱基99購03,0,0,0,0,0,0,0,0,0,-58000,0,0,0,42000,100000,-58000,-58000
058354,台積電凱基9A購06,0,0,0,0,0,0,0,0,0,-58000,0,0,0,0,58000,-58000,-58000
057167,台積電元大99購03,0,0,0,0,0,0,0,0,0,-58000,0,0,0,0,58000,-58000,-58000
059029,旺宏兆豐99購01  ,0,0,0,0,0,0,0,0,0,-58000,0,0,0,0,58000,-58000,-58000
059334,A50正2國票9A購02,0,0,0,0,0,0,0,0,0,-58000,0,0,0,12000,70000,-58000,-58000
056981,全新群益99購03  ,0,0,0,0,0,0,0,0,0,-58000,0,0,0,0,58000,-58000,-58000
07553P,嘉晶元大9A售02  ,0,0,0,0,0,0,0,0,0,-58000,0,0,0,95000,153000,-58000,-58000
07121P,華新科凱基99售03,0,0,0,0,0,0,0,0,0,-58000,0,0,0,2000,60000,-58000,-58000
061123,燿華永豐9A購01  ,0,0,0,0,0,0,0,0,0,-59000,0,0,0,21000,80000,-59000,-59000
060960,金像電凱基9B購01,0,0,0,0,0,0,0,0,0,-59000,0,0,0,166000,225000,-59000,-59000
061485,鴻海兆豐9A購01  ,0,0,0,0,0,0,0,0,0,-59000,0,0,0,11000,70000,-59000,-59000
061308,元金2X中信9A購01,0,0,0,0,0,0,0,0,0,-59000,0,0,0,0,59000,-59000,-59000
061764,旺宏元大9B購01  ,0,0,0,0,0,0,0,0,0,-59000,0,0,0,5000,64000,-59000,-59000
055349,京元電凱基97購02,0,0,0,0,0,0,0,0,0,-59000,0,0,0,30000,89000,-59000,-59000
051078,力山富邦97購01  ,0,0,0,0,0,0,0,0,0,-59000,0,0,0,51000,110000,-59000,-59000
056110,嘉聯益永豐97購02,0,0,0,0,0,0,0,0,0,-59000,0,0,0,21000,80000,-59000,-59000
1416,廣豐            ,0,59000,-59000,0,0,0,0,0,0,0,0,0,0,0,0,0,-59000
1708,東鹼            ,17000,76000,-59000,0,0,0,0,0,0,0,0,0,0,0,0,0,-59000
2239,英利-KY         ,8000,67000,-59000,0,0,0,0,0,0,0,0,0,0,0,0,0,-59000
2545,皇翔            ,73000,132000,-59000,0,0,0,0,0,0,0,0,0,0,0,0,0,-59000
6192,巨路            ,19000,77000,-58000,0,0,0,0,0,0,-1000,0,1000,-1000,0,0,0,-59000
5258,虹堡            ,7000,69000,-62000,0,0,0,0,0,0,3000,5000,2000,3000,0,0,0,-59000
3673,TPK-KY          ,556000,596000,-40000,0,0,0,1000,0,1000,-20000,54000,56000,-2000,13000,31000,-18000,-59000
3501,維熹            ,10000,69000,-59000,0,0,0,0,0,0,0,0,0,0,0,0,0,-59000
061635,台積電元大9A購34,0,0,0,0,0,0,0,0,0,-60000,0,0,0,0,60000,-60000,-60000
06902P,聯電凱基98售02  ,0,0,0,0,0,0,0,0,0,-60000,0,0,0,0,60000,-60000,-60000
061486,國巨兆豐9B購02  ,0,0,0,0,0,0,0,0,0,-60000,0,0,0,100000,160000,-60000,-60000
061005,可成兆豐9A購01  ,0,0,0,0,0,0,0,0,0,-60000,0,0,0,24000,84000,-60000,-60000
059904,A50正2元大9C購05,0,0,0,0,0,0,0,0,0,-60000,0,0,0,0,60000,-60000,-60000
060110,茂林元大99購06  ,0,0,0,0,0,0,0,0,0,-60000,0,0,0,15000,75000,-60000,-60000
06007P,世芯永豐96售01  ,0,0,0,0,0,0,0,0,0,-60000,0,0,0,0,60000,-60000,-60000
060431,復盛永豐9A購01  ,0,0,0,0,0,0,0,0,0,-60000,0,0,0,35000,95000,-60000,-60000
06072P,牧德永豐97售01  ,0,0,0,0,0,0,0,0,0,-60000,0,0,0,0,60000,-60000,-60000
052667,漢唐群益96購01  ,0,0,0,0,0,0,0,0,0,-60000,0,0,0,0,60000,-60000,-60000
051582,聯發科元大97購02,0,0,0,0,0,0,0,0,0,-60000,0,0,0,0,60000,-60000,-60000
052153,GIS富邦96購02   ,0,0,0,0,0,0,0,0,0,-60000,0,0,0,0,60000,-60000,-60000
052112,滬深2X中信99購01,0,0,0,0,0,0,0,0,0,-60000,0,0,0,0,60000,-60000,-60000
055359,超眾凱基97購01  ,0,0,0,0,0,0,0,0,0,-60000,0,0,0,15000,75000,-60000,-60000
055024,興勤國泰98購01  ,0,0,0,0,0,0,0,0,0,-60000,0,0,0,0,60000,-60000,-60000
053401,臺股指中信99購01,0,0,0,0,0,0,0,0,0,-60000,0,0,0,0,60000,-60000,-60000
054253,宏達電元大97購03,0,0,0,0,0,0,0,0,0,-60000,0,0,0,0,60000,-60000,-60000
058597,瑞昱台新99購01  ,0,0,0,0,0,0,0,0,0,-60000,0,0,0,0,60000,-60000,-60000
5608,四維航          ,12000,72000,-60000,0,0,0,0,0,0,0,0,0,0,0,0,0,-60000
6525,捷敏-KY         ,15000,75000,-60000,0,0,0,0,0,0,0,0,0,0,0,0,0,-60000
2706,第一店          ,14000,74000,-60000,0,0,0,0,0,0,0,0,0,0,0,0,0,-60000
08637P,台灣50中信96售03,0,0,0,0,0,0,0,0,0,-60000,0,0,0,0,60000,-60000,-60000
07412P,國巨元大99售32  ,0,0,0,0,0,0,0,0,0,-60000,0,0,0,150000,210000,-60000,-60000
07561P,玉晶光永豐9A售02,0,0,0,0,0,0,0,0,0,-60000,0,0,0,60000,120000,-60000,-60000
059524,FBVIX凱基9A購02 ,0,0,0,0,0,0,0,0,0,-61000,0,0,0,226000,287000,-61000,-61000
06626P,大立光統一9A售01,0,0,0,0,0,0,0,0,0,-61000,0,0,0,12000,73000,-61000,-61000
06661P,玉晶光永豐98售05,0,0,0,0,0,0,0,0,0,-61000,0,0,0,120000,181000,-61000,-61000
03442B,臺股指元大9A熊48,0,0,0,0,0,0,0,0,0,-61000,0,0,0,166000,227000,-61000,-61000
058091,欣興元大99購03  ,0,0,0,0,0,0,0,0,0,-61000,0,0,0,1000,62000,-61000,-61000
07709P,創意元大9A售01  ,0,0,0,0,0,0,0,0,0,-61000,0,0,0,14000,75000,-61000,-61000
07280P,FBVIX凱基99售01 ,0,0,0,0,0,0,0,0,0,-61000,0,0,0,0,61000,-61000,-61000
1614,三洋電          ,0,61000,-61000,0,0,0,0,0,0,0,0,0,0,0,0,0,-61000
5007,三星            ,1000,62000,-61000,0,0,0,0,0,0,0,0,0,0,0,0,0,-61000
06952P,大立光統一9A售03,0,0,0,0,0,0,0,0,0,-62000,0,0,0,0,62000,-62000,-62000
061723,嘉聯益永豐9A購03,0,0,0,0,0,0,0,0,0,-62000,0,0,0,0,62000,-62000,-62000
059908,元金2X元大99購01,0,0,0,0,0,0,0,0,0,-62000,0,0,0,8000,70000,-62000,-62000
060653,全新群益9A購02  ,0,0,0,0,0,0,0,0,0,-62000,0,0,0,98000,160000,-62000,-62000
03675C,臺股指元大04牛02,0,0,0,0,0,0,0,0,0,-62000,0,0,0,4000,66000,-62000,-62000
054214,京鼎國票97購02  ,0,0,0,0,0,0,0,0,0,-62000,0,0,0,0,62000,-62000,-62000
058231,技嘉元大99購02  ,0,0,0,0,0,0,0,0,0,-62000,0,0,0,50000,112000,-62000,-62000
055168,光罩統一98購01  ,0,0,0,0,0,0,0,0,0,-62000,0,0,0,392000,454000,-62000,-62000
058796,可成元大99購04  ,0,0,0,0,0,0,0,0,0,-62000,0,0,0,68000,130000,-62000,-62000
6605,帝寶            ,9000,71000,-62000,0,0,0,0,0,0,0,0,0,0,0,0,0,-62000
2433,互盛電          ,8000,70000,-62000,0,0,0,0,0,0,0,0,0,0,0,0,0,-62000
060537,台灣50凱基9B購01,0,0,0,0,0,0,0,0,0,-63000,0,0,0,0,63000,-63000,-63000
06960P,國巨凱基99售08  ,0,0,0,0,0,0,0,0,0,-63000,0,0,0,67000,130000,-63000,-63000
05410P,聯發科元富95售04,0,0,0,0,0,0,0,0,0,-63000,0,0,0,0,63000,-63000,-63000
006206,元大上證50      ,66000,531000,-465000,0,0,0,0,0,0,402000,40000,85000,-45000,517000,70000,447000,-63000
054773,台郡國票98購01  ,0,0,0,0,0,0,0,0,0,-63000,0,0,0,0,63000,-63000,-63000
059400,滬深2X元富9C購04,0,0,0,0,0,0,0,0,0,-63000,0,0,0,0,63000,-63000,-63000
059072,元油2X元大9C購13,0,0,0,0,0,0,0,0,0,-63000,0,0,0,220000,283000,-63000,-63000
058137,玉晶光元大99購11,0,0,0,0,0,0,0,0,0,-63000,0,0,0,15000,78000,-63000,-63000
058685,TPK凱基99購01   ,0,0,0,0,0,0,0,0,0,-63000,0,0,0,28000,91000,-63000,-63000
1517,利奇            ,0,63000,-63000,0,0,0,0,0,0,0,0,0,0,0,0,0,-63000
1506,正道            ,31000,91000,-60000,0,0,0,0,0,0,-3000,0,3000,-3000,0,0,0,-63000
6449,鈺邦            ,12000,79000,-67000,0,0,0,0,0,0,4000,5000,1000,4000,0,0,0,-63000
3653,健策            ,343677,269000,74677,0,0,0,0,10000,-10000,-128000,2000,1000,1000,15000,144000,-129000,-63323
06936P,瑞儀元大98售01  ,0,0,0,0,0,0,0,0,0,-64000,0,0,0,8000,72000,-64000,-64000
060326,群光群益9A購01  ,20000,0,20000,0,0,0,0,0,0,-84000,0,0,0,7000,91000,-84000,-64000
060763,聯鈞元大9A購03  ,0,0,0,0,0,0,0,0,0,-64000,0,0,0,12000,76000,-64000,-64000
060709,緯穎富邦9B購01  ,0,0,0,0,0,0,0,0,0,-64000,0,0,0,18000,82000,-64000,-64000
00714,群益道瓊美國地產,0,0,0,0,0,0,0,0,0,-64000,0,0,0,0,64000,-64000,-64000
052075,旺宏元富95購03  ,0,0,0,0,0,0,0,0,0,-64000,0,0,0,44000,108000,-64000,-64000
057282,大立光元大99購06,0,0,0,0,0,0,0,0,0,-64000,0,0,0,12000,76000,-64000,-64000
059354,臺指反富邦9B購01,0,0,0,0,0,0,0,0,0,-64000,0,0,0,0,64000,-64000,-64000
2450,神腦            ,9000,73000,-64000,0,0,0,0,0,0,0,0,0,0,0,0,0,-64000
060600,台積電凱基9C購01,0,0,0,0,0,0,0,0,0,-65000,0,0,0,3000,68000,-65000,-65000
049966,旺宏國票95購02  ,0,0,0,0,0,0,0,0,0,-65000,0,0,0,0,65000,-65000,-65000
057178,可成元大98購03  ,0,0,0,0,0,0,0,0,0,-65000,0,0,0,0,65000,-65000,-65000
056010,力成中信97購01  ,0,0,0,0,0,0,0,0,0,-65000,0,0,0,0,65000,-65000,-65000
2616,山隆            ,7000,72000,-65000,0,0,0,0,0,0,0,0,0,0,0,0,0,-65000
1321,大洋            ,44000,109000,-65000,0,0,0,0,0,0,0,0,0,0,0,0,0,-65000
07301P,臺股指元大9A售34,0,0,0,0,0,0,0,0,0,-65000,0,0,0,0,65000,-65000,-65000
060475,瑞祺元大9A購01  ,0,0,0,0,0,0,0,0,0,-66000,0,0,0,25000,91000,-66000,-66000
059884,鴻海國票99購09  ,0,0,0,0,0,0,0,0,0,-66000,0,0,0,0,66000,-66000,-66000
061028,聚陽永豐9A購01  ,0,0,0,0,0,0,0,0,0,-66000,0,0,0,53000,119000,-66000,-66000
061053,國巨群益9A購08  ,0,0,0,0,0,0,0,0,0,-66000,0,0,0,199000,265000,-66000,-66000
061203,國巨元大9A購15  ,0,0,0,0,0,0,0,0,0,-66000,0,0,0,60000,126000,-66000,-66000
061488,奇力新兆豐9A購01,0,0,0,0,0,0,0,0,0,-66000,0,0,0,8000,74000,-66000,-66000
061541,旺宏群益9A購03  ,0,0,0,0,0,0,0,0,0,-66000,0,0,0,0,66000,-66000,-66000
053621,臺股指群益96購07,0,0,0,0,0,0,0,0,0,-66000,0,0,0,0,66000,-66000,-66000
056788,日月光群益98購01,0,0,0,0,0,0,0,0,0,-66000,0,0,0,142000,208000,-66000,-66000
053347,茂林國票98購01  ,0,0,0,0,0,0,0,0,0,-66000,0,0,0,15000,81000,-66000,-66000
052822,泰碩永豐97購01  ,0,0,0,0,0,0,0,0,0,-66000,0,0,0,25000,91000,-66000,-66000
07851P,聯發科國票9A售05,0,0,0,0,0,0,0,0,0,-66000,0,0,0,0,66000,-66000,-66000
1442,名軒            ,6000,72000,-66000,0,0,0,0,0,0,0,0,0,0,0,0,0,-66000
2413,環科            ,11000,76000,-65000,0,0,0,0,0,0,-1000,0,1000,-1000,0,0,0,-66000
9943,好樂迪          ,17000,83000,-66000,0,0,0,0,0,0,0,0,0,0,0,0,0,-66000
061071,復盛凱基9A購01  ,0,0,0,0,0,0,0,0,0,-67000,0,0,0,0,67000,-67000,-67000
060084,聯電元大99購02  ,0,0,0,0,0,0,0,0,0,-67000,0,0,0,50000,117000,-67000,-67000
059942,全新永豐99購04  ,0,0,0,0,0,0,0,0,0,-67000,0,0,0,0,67000,-67000,-67000
060244,大立光元大9B購02,0,0,0,0,0,0,0,0,0,-67000,0,0,0,16000,83000,-67000,-67000
060630,國巨富邦9C購03  ,0,0,0,0,0,0,0,0,0,-67000,0,0,0,0,67000,-67000,-67000
060723,致新永豐9A購01  ,0,0,0,0,0,0,0,0,0,-67000,0,0,0,342000,409000,-67000,-67000
060799,茂林永豐9A購01  ,0,0,0,0,0,0,0,0,0,-67000,0,0,0,1000,68000,-67000,-67000
053349,台郡國票97購02  ,0,0,0,0,0,0,0,0,0,-67000,0,0,0,44000,111000,-67000,-67000
058213,欣興群益99購01  ,0,0,0,0,0,0,0,0,0,-67000,0,0,0,57000,124000,-67000,-67000
057195,南茂元大98購01  ,10000,0,10000,0,0,0,0,0,0,-77000,0,0,0,519000,596000,-77000,-67000
057206,立積元富98購01  ,0,0,0,0,0,0,0,0,0,-67000,0,0,0,643000,710000,-67000,-67000
058751,南茂凱基9A購01  ,0,0,0,0,0,0,0,0,0,-67000,0,0,0,40000,107000,-67000,-67000
07789P,緯穎群益9A售03  ,0,0,0,0,0,0,0,0,0,-67000,0,0,0,0,67000,-67000,-67000
060410,台苯永豐9A購01  ,0,0,0,0,0,0,0,0,0,-68000,0,0,0,0,68000,-68000,-68000
055207,致新中信99購01  ,0,0,0,0,0,0,0,0,0,-68000,0,0,0,267000,335000,-68000,-68000
052779,欣興國票97購01  ,0,0,0,0,0,0,0,0,0,-68000,0,0,0,38000,106000,-68000,-68000
058996,台達電元大99購02,0,0,0,0,0,0,0,0,0,-68000,0,0,0,200000,268000,-68000,-68000
058031,旺宏永豐98購04  ,0,0,0,0,0,0,0,0,0,-68000,0,0,0,0,68000,-68000,-68000
058959,南茂國票9A購01  ,0,0,0,0,0,0,0,0,0,-68000,0,0,0,28000,96000,-68000,-68000
058826,台積電永豐99購02,0,0,0,0,0,0,0,0,0,-68000,0,0,0,0,68000,-68000,-68000
057886,聯詠群益98購01  ,0,0,0,0,0,0,0,0,0,-68000,0,0,0,339000,407000,-68000,-68000
058693,旭富國票9A購01  ,0,0,0,0,0,0,0,0,0,-68000,0,0,0,51000,119000,-68000,-68000
07459P,緯穎元大9A售01  ,0,0,0,0,0,0,0,0,0,-68000,0,0,0,150000,218000,-68000,-68000
060429,南六永豐9A購01  ,0,0,0,0,0,0,0,0,0,-69000,0,0,0,64000,133000,-69000,-69000
060823,旺宏元大9A購05  ,0,0,0,0,0,0,0,0,0,-69000,0,0,0,69000,138000,-69000,-69000
060208,卜蜂康和9A購01  ,0,0,0,0,0,0,0,0,0,-69000,0,0,0,0,69000,-69000,-69000
061479,泰碩元大9A購02  ,0,0,0,0,0,0,0,0,0,-69000,0,0,0,14000,83000,-69000,-69000
06421P,嘉澤統一97售02  ,0,0,0,0,0,0,0,0,0,-69000,0,0,0,9000,78000,-69000,-69000
055875,光罩元富97購02  ,0,0,0,0,0,0,0,0,0,-69000,0,0,0,65000,134000,-69000,-69000
055531,華新科群益98購03,0,0,0,0,0,0,0,0,0,-69000,0,0,0,101000,170000,-69000,-69000
058142,瑞儀元大99購01  ,0,0,0,0,0,0,0,0,0,-69000,0,0,0,114000,183000,-69000,-69000
059213,國巨元大99購19  ,0,0,0,0,0,0,0,0,0,-69000,0,0,0,51000,120000,-69000,-69000
07530P,聯發科凱基9A售11,0,0,0,0,0,0,0,0,0,-69000,0,0,0,271000,340000,-69000,-69000
1618,合機            ,0,69000,-69000,0,0,0,0,0,0,0,0,0,0,0,0,0,-69000
4961,天鈺            ,60000,124000,-64000,0,0,0,0,0,0,-5000,0,5000,-5000,0,0,0,-69000
6197,佳必琪          ,75000,142000,-67000,0,0,0,0,0,0,-2000,1000,3000,-2000,0,0,0,-69000
061784,聯發科群益9B購02,0,0,0,0,0,0,0,0,0,-70000,0,0,0,0,70000,-70000,-70000
061736,國巨凱基9B購05  ,0,0,0,0,0,0,0,0,0,-70000,0,0,0,0,70000,-70000,-70000
061353,康控元大9A購01  ,0,0,0,0,0,0,0,0,0,-70000,0,0,0,88000,158000,-70000,-70000
060073,台積電元富99購03,0,0,0,0,0,0,0,0,0,-70000,0,0,0,12000,82000,-70000,-70000
059916,聯發科元大99購33,0,0,0,0,0,0,0,0,0,-70000,0,0,0,38000,108000,-70000,-70000
059816,聯電凱基99購03  ,0,0,0,0,0,0,0,0,0,-70000,0,0,0,126000,196000,-70000,-70000
060800,華新科第一9A購01,0,0,0,0,0,0,0,0,0,-70000,0,0,0,0,70000,-70000,-70000
060778,臺股指凱基9A購06,0,0,0,0,0,0,0,0,0,-70000,0,0,0,2000,72000,-70000,-70000
060277,道瓊反元大9A購02,0,0,0,0,0,0,0,0,0,-70000,0,0,0,35000,105000,-70000,-70000
053188,旺宏統一97購03  ,0,0,0,0,0,0,0,0,0,-70000,0,0,0,0,70000,-70000,-70000
054032,上銀中信96購01  ,0,0,0,0,0,0,0,0,0,-70000,0,0,0,0,70000,-70000,-70000
054971,帆宣元大97購02  ,0,0,0,0,0,0,0,0,0,-70000,0,0,0,0,70000,-70000,-70000
055437,禾伸堂中信99購01,0,0,0,0,0,0,0,0,0,-70000,0,0,0,136000,206000,-70000,-70000
050568,為升中信97購01  ,0,0,0,0,0,0,0,0,0,-70000,0,0,0,0,70000,-70000,-70000
051003,中環中信97購01  ,0,0,0,0,0,0,0,0,0,-70000,0,0,0,0,70000,-70000,-70000
052203,T50反1中信99購03,0,0,0,0,0,0,0,0,0,-70000,0,0,0,110000,180000,-70000,-70000
057475,聯電元大9A購01  ,0,0,0,0,0,0,0,0,0,-70000,0,0,0,215000,285000,-70000,-70000
055962,晶豪科元大97購02,0,0,0,0,0,0,0,0,0,-70000,0,0,0,0,70000,-70000,-70000
057634,道瓊反元大99購01,0,0,0,0,0,0,0,0,0,-70000,0,0,0,0,70000,-70000,-70000
057635,中鋼元大98購01  ,0,0,0,0,0,0,0,0,0,-70000,0,0,0,0,70000,-70000,-70000
057040,國巨元大98購12  ,0,0,0,0,0,0,0,0,0,-70000,0,0,0,42000,112000,-70000,-70000
055763,鎧勝群益97購01  ,0,0,0,0,0,0,0,0,0,-70000,0,0,0,17000,87000,-70000,-70000
3617,碩天            ,11000,74000,-63000,0,0,0,0,0,0,-7000,0,1000,-1000,0,6000,-6000,-70000
2338,光罩            ,1188000,1397000,-209000,0,0,0,0,0,0,139000,1000,3000,-2000,391000,250000,141000,-70000
07712P,茂林元大9A售03  ,0,0,0,0,0,0,0,0,0,-70000,0,0,0,20000,90000,-70000,-70000
07760P,力山永豐9A售03  ,0,0,0,0,0,0,0,0,0,-70000,0,0,0,21000,91000,-70000,-70000
07456P,華新科元大9A售06,0,0,0,0,0,0,0,0,0,-70000,0,0,0,81000,151000,-70000,-70000
07352P,台積電國票99售11,0,0,0,0,0,0,0,0,0,-70000,0,0,0,20000,90000,-70000,-70000
060434,台汽電永豐9A購01,0,0,0,0,0,0,0,0,0,-71000,0,0,0,92000,163000,-71000,-71000
061422,台積電元大9A購30,0,0,0,0,0,0,0,0,0,-71000,0,0,0,0,71000,-71000,-71000
061201,FBVIX元大01購03 ,0,0,0,0,0,0,0,0,0,-71000,0,0,0,1000,72000,-71000,-71000
052772,台虹群益96購01  ,0,0,0,0,0,0,0,0,0,-71000,0,0,0,11000,82000,-71000,-71000
053050,華通國票97購02  ,0,0,0,0,0,0,0,0,0,-71000,0,0,0,8000,79000,-71000,-71000
055901,超眾中信97購01  ,0,0,0,0,0,0,0,0,0,-71000,0,0,0,10000,81000,-71000,-71000
058771,神達兆豐99購01  ,0,0,0,0,0,0,0,0,0,-71000,0,0,0,0,71000,-71000,-71000
056488,致新元大99購01  ,0,0,0,0,0,0,0,0,0,-71000,0,0,0,390000,461000,-71000,-71000
059119,華擎永豐99購02  ,0,0,0,0,0,0,0,0,0,-71000,0,0,0,15000,86000,-71000,-71000
1459,聯發            ,0,71000,-71000,0,0,0,0,0,0,0,0,0,0,0,0,0,-71000
3209,全科            ,31000,100000,-69000,0,0,0,0,0,0,-2000,0,2000,-2000,0,0,0,-71000
9927,泰銘            ,13000,82000,-69000,0,0,0,0,0,0,-2000,0,2000,-2000,0,0,0,-71000
061682,南電元大9B購01  ,0,0,0,0,0,0,0,0,0,-72000,0,0,0,0,72000,-72000,-72000
059771,台積電群益99購11,0,0,0,0,0,0,0,0,0,-72000,0,0,0,95000,167000,-72000,-72000
060144,全新國票9B購01  ,0,0,0,0,0,0,0,0,0,-72000,0,0,0,3000,75000,-72000,-72000
055112,晶豪科凱基98購01,0,0,0,0,0,0,0,0,0,-72000,0,0,0,57000,129000,-72000,-72000
03425B,臺股指元大9A熊01,0,0,0,0,0,0,0,0,0,-72000,0,0,0,0,72000,-72000,-72000
058741,欣興日盛99購01  ,0,0,0,0,0,0,0,0,0,-72000,0,0,0,7000,79000,-72000,-72000
4426,利勤            ,99000,171000,-72000,0,0,0,0,0,0,0,0,0,0,0,0,0,-72000
2109,華豐            ,6000,78000,-72000,0,0,0,0,0,0,0,0,0,0,0,0,0,-72000
2374,佳能            ,3000,71000,-68000,0,0,0,0,0,0,-4000,0,4000,-4000,0,0,0,-72000
07105P,大毅元富99售02  ,0,0,0,0,0,0,0,0,0,-72000,0,0,0,2000,74000,-72000,-72000
06058P,玉晶光凱基97售04,0,0,0,0,0,0,0,0,0,-73000,0,0,0,42000,115000,-73000,-73000
06155P,智邦統一97售02  ,0,0,0,0,0,0,0,0,0,-73000,0,0,0,0,73000,-73000,-73000
06486P,麗豐元大98售02  ,0,0,0,0,0,0,0,0,0,-73000,0,0,0,39000,112000,-73000,-73000
054760,台化國票9A購01  ,0,0,0,0,0,0,0,0,0,-73000,0,0,0,22000,95000,-73000,-73000
055891,鴻海統一9A購01  ,0,0,0,0,0,0,0,0,0,-73000,0,0,0,0,73000,-73000,-73000
056626,同欣電永豐98購01,0,0,0,0,0,0,0,0,0,-73000,0,0,0,28000,101000,-73000,-73000
058434,旺宏統一9B購01  ,0,0,0,0,0,0,0,0,0,-73000,0,0,0,20000,93000,-73000,-73000
058068,旺宏凱基98購11  ,0,0,0,0,0,0,0,0,0,-73000,0,0,0,38000,111000,-73000,-73000
07576P,可成元大9A售01  ,0,0,0,0,0,0,0,0,0,-73000,0,0,0,77000,150000,-73000,-73000
3622,洋華            ,7000,80000,-73000,0,0,0,0,0,0,0,0,0,0,0,0,0,-73000
6451,訊芯-KY         ,148000,186000,-38000,0,0,0,0,0,0,-35000,0,2000,-2000,3000,36000,-33000,-73000
6257,矽格            ,883000,803000,80000,0,0,0,0,0,0,-153000,59000,296000,-237000,119000,35000,84000,-73000
06825P,臺股指國票98售01,0,0,0,0,0,0,0,0,0,-74000,0,0,0,1000,75000,-74000,-74000
059637,大立光凱基01購01,0,0,0,0,0,0,0,0,0,-74000,0,0,0,33000,107000,-74000,-74000
055874,中環元富9A購01  ,0,0,0,0,0,0,0,0,0,-74000,0,0,0,427000,501000,-74000,-74000
054405,樺漢康和96購01  ,0,0,0,0,0,0,0,0,0,-74000,0,0,0,0,74000,-74000,-74000
04838P,宏達電元大95售02,0,0,0,0,0,0,0,0,0,-74000,0,0,0,0,74000,-74000,-74000
058476,旺宏凱基9A購01  ,0,0,0,0,0,0,0,0,0,-74000,0,0,0,3000,77000,-74000,-74000
057388,奇鋐永豐98購02  ,0,0,0,0,0,0,0,0,0,-74000,0,0,0,10000,84000,-74000,-74000
5285,界霖            ,12000,86000,-74000,0,0,0,0,0,0,0,0,0,0,0,0,0,-74000
3712,永崴投控        ,32000,106000,-74000,0,0,0,0,0,0,0,0,0,0,0,0,0,-74000
07536P,華新科元富9A售04,0,0,0,0,0,0,0,0,0,-74000,0,0,0,1000,75000,-74000,-74000
059609,A50正2永豐99購01,0,0,0,0,0,0,0,0,0,-75000,0,0,0,0,75000,-75000,-75000
059782,A50正2元大9C購04,0,0,0,0,0,0,0,0,0,-75000,0,0,0,20000,95000,-75000,-75000
060589,台灣50台新9B購06,0,0,0,0,0,0,0,0,0,-75000,0,0,0,0,75000,-75000,-75000
060963,禾伸堂凱基9A購01,0,0,0,0,0,0,0,0,0,-75000,0,0,0,38000,113000,-75000,-75000
061469,瑞祺群益9A購02  ,0,0,0,0,0,0,0,0,0,-75000,0,0,0,34000,109000,-75000,-75000
061403,滬深2X國票9A購06,0,0,0,0,0,0,0,0,0,-75000,0,0,0,0,75000,-75000,-75000
052367,聯茂國票96購02  ,0,0,0,0,0,0,0,0,0,-75000,0,0,0,0,75000,-75000,-75000
050142,聯發科元富9A購01,0,0,0,0,0,0,0,0,0,-75000,0,0,0,8000,83000,-75000,-75000
055276,台積電元大97購20,0,0,0,0,0,0,0,0,0,-75000,0,0,0,0,75000,-75000,-75000
056620,華新科永豐98購02,0,0,0,0,0,0,0,0,0,-75000,0,0,0,5000,80000,-75000,-75000
07544P,大立光凱基9A售09,0,0,0,0,0,0,0,0,0,-75000,0,0,0,0,75000,-75000,-75000
07777P,創意元大9A售03  ,0,0,0,0,0,0,0,0,0,-75000,0,0,0,0,75000,-75000,-75000
3060,銘異            ,62000,136000,-74000,0,0,0,0,0,0,-1000,0,1000,-1000,0,0,0,-75000
3028,增你強          ,4000,79000,-75000,0,0,0,0,0,0,0,0,0,0,0,0,0,-75000
1340,勝悅-KY         ,10000,85000,-75000,0,0,0,0,0,0,0,0,0,0,0,0,0,-75000
061604,台光電凱基9B購01,0,0,0,0,0,0,0,0,0,-76000,0,0,0,14000,90000,-76000,-76000
060419,漢翔永豐9A購01  ,0,0,0,0,0,0,0,0,0,-76000,0,0,0,24000,100000,-76000,-76000
058160,奇鋐元富99購01  ,0,0,0,0,0,0,0,0,0,-76000,0,0,0,48000,124000,-76000,-76000
055938,矽力群益97購01  ,0,0,0,0,0,0,0,0,0,-76000,0,0,0,6000,82000,-76000,-76000
9908,大台北          ,15000,91000,-76000,0,0,0,0,0,0,0,0,0,0,0,0,0,-76000
059847,喬山永豐99購01  ,0,0,0,0,0,0,0,0,0,-77000,0,0,0,236000,313000,-77000,-77000
061426,玉晶光元大9A購15,0,0,0,0,0,0,0,0,0,-77000,0,0,0,40000,117000,-77000,-77000
058124,玉晶光國票9A購01,0,0,0,0,0,0,0,0,0,-77000,0,0,0,2000,79000,-77000,-77000
056895,技嘉元大98購01  ,0,0,0,0,0,0,0,0,0,-77000,0,0,0,3000,80000,-77000,-77000
056719,台虹永豐98購01  ,0,0,0,0,0,0,0,0,0,-77000,0,0,0,60000,137000,-77000,-77000
2030,彰源            ,3000,80000,-77000,0,0,0,0,0,0,0,0,0,0,0,0,0,-77000
1626,艾美特-KY       ,20000,97000,-77000,0,0,0,0,0,0,0,0,0,0,0,0,0,-77000
3058,立德            ,5000,82000,-77000,0,0,0,0,0,0,0,0,0,0,0,0,0,-77000
2486,一詮            ,29000,104000,-75000,0,0,0,0,0,0,-2000,0,2000,-2000,0,0,0,-77000
061742,奇鋐凱基9B購01  ,0,0,0,0,0,0,0,0,0,-78000,0,0,0,0,78000,-78000,-78000
060064,華新科兆豐99購07,0,0,0,0,0,0,0,0,0,-78000,0,0,0,10000,88000,-78000,-78000
055377,揚明光元大98購01,0,0,0,0,0,0,0,0,0,-78000,0,0,0,12000,90000,-78000,-78000
07251P,台灣50元富01售04,0,0,0,0,0,0,0,0,0,-78000,0,0,0,0,78000,-78000,-78000
060470,台勝科元大9A購03,0,0,0,0,0,0,0,0,0,-79000,0,0,0,275000,354000,-79000,-79000
061659,信邦永豐9A購01  ,0,0,0,0,0,0,0,0,0,-79000,0,0,0,0,79000,-79000,-79000
061357,寶成元大9A購01  ,0,0,0,0,0,0,0,0,0,-79000,0,0,0,50000,129000,-79000,-79000
061064,可成凱基9B購02  ,0,0,0,0,0,0,0,0,0,-79000,0,0,0,10000,89000,-79000,-79000
052968,燿華群益98購01  ,0,0,0,0,0,0,0,0,0,-79000,0,0,0,123000,202000,-79000,-79000
058662,禾伸堂兆豐99購01,0,0,0,0,0,0,0,0,0,-79000,0,0,0,0,79000,-79000,-79000
1810,和成            ,10000,89000,-79000,0,0,0,0,0,0,0,0,0,0,0,0,0,-79000
4438,廣越            ,20000,99000,-79000,0,0,0,0,0,0,0,0,0,0,0,0,0,-79000
5706,鳳凰            ,7000,86000,-79000,0,0,0,0,0,0,0,0,0,0,0,0,0,-79000
061235,台積電元大9A購23,0,0,0,0,0,0,0,0,0,-80000,0,0,0,0,80000,-80000,-80000
060673,旺宏元大9A購04  ,0,0,0,0,0,0,0,0,0,-80000,0,0,0,40000,120000,-80000,-80000
060748,臻鼎國票9A購01  ,0,0,0,0,0,0,0,0,0,-80000,0,0,0,30000,110000,-80000,-80000
054699,復盛永豐97購01  ,0,0,0,0,0,0,0,0,0,-80000,0,0,0,0,80000,-80000,-80000
052518,道瓊反元大95購02,0,0,0,0,0,0,0,0,0,-80000,0,0,0,0,80000,-80000,-80000
048651,美利達元大96購05,0,0,0,0,0,0,0,0,0,-80000,0,0,0,192000,272000,-80000,-80000
057719,欣興元富02購01  ,0,0,0,0,0,0,0,0,0,-80000,0,0,0,6000,86000,-80000,-80000
057908,國泰金亞東99購01,0,0,0,0,0,0,0,0,0,-80000,0,0,0,0,80000,-80000,-80000
057654,A50正2中信98購01,0,0,0,0,0,0,0,0,0,-80000,0,0,0,20000,100000,-80000,-80000
056645,大立光凱基98購12,0,0,0,0,0,0,0,0,0,-80000,0,0,0,11000,91000,-80000,-80000
056417,欣興中信98購01  ,0,0,0,0,0,0,0,0,0,-80000,0,0,0,12000,92000,-80000,-80000
059369,滬深2X元富9C購01,0,0,0,0,0,0,0,0,0,-80000,0,0,0,0,80000,-80000,-80000
6582,申豐            ,28000,115000,-87000,0,0,0,0,0,0,7000,7000,0,7000,0,0,0,-80000
2017,官田鋼          ,4000,84000,-80000,0,0,0,0,0,0,0,1000,1000,0,0,0,0,-80000
2365,昆盈            ,87000,163000,-76000,0,0,0,0,0,0,-4000,0,4000,-4000,0,0,0,-80000
3032,偉訓            ,1000,81000,-80000,0,0,0,0,0,0,0,0,0,0,0,0,0,-80000
2748,雲品            ,2000,32000,-30000,0,0,0,0,50000,-50000,0,0,0,0,0,0,0,-80000
07287P,全新群益9B售01  ,0,0,0,0,0,0,0,0,0,-80000,0,0,0,0,80000,-80000,-80000
07090P,台灣50凱基01售01,0,0,0,0,0,0,0,0,0,-80000,0,0,0,1000,81000,-80000,-80000
07467P,上銀元大9A售03  ,0,0,0,0,0,0,0,0,0,-80000,0,0,0,20000,100000,-80000,-80000
060764,華擎元大9A購03  ,0,0,0,0,0,0,0,0,0,-81000,0,0,0,25000,106000,-81000,-81000
059772,可成群益9A購05  ,0,0,0,0,0,0,0,0,0,-81000,0,0,0,30000,111000,-81000,-81000
061725,國巨麥證9A購05  ,0,0,0,0,81000,-81000,0,0,0,-81000,0,0,0,0,81000,-81000,-81000
057428,正崴兆豐98購01  ,0,0,0,0,0,0,0,0,0,-81000,0,0,0,42000,123000,-81000,-81000
057004,滬深反中信9A購01,0,0,0,0,0,0,0,0,0,-81000,0,0,0,4000,85000,-81000,-81000
2539,櫻花建          ,12000,93000,-81000,0,0,0,0,0,0,0,0,0,0,0,0,0,-81000
2305,全友            ,0,78000,-78000,0,0,0,0,0,0,-3000,0,3000,-3000,0,0,0,-81000
6177,達麗            ,36000,117000,-81000,0,0,0,0,0,0,0,0,0,0,0,0,0,-81000
055628,旺宏永豐97購01  ,0,0,0,0,0,0,0,0,0,-82000,0,0,0,0,82000,-82000,-82000
056699,光罩國泰99購01  ,0,0,0,0,0,0,0,0,0,-82000,0,0,0,30000,112000,-82000,-82000
056618,京元電永豐98購01,0,0,0,0,0,0,0,0,0,-82000,0,0,0,49000,131000,-82000,-82000
6552,易華電          ,92000,154000,-62000,0,0,0,0,0,0,-20000,0,1000,-1000,0,19000,-19000,-82000
4942,嘉彰            ,56000,136000,-80000,0,0,0,0,0,0,-2000,0,2000,-2000,0,0,0,-82000
1503,士電            ,7000,89000,-82000,0,0,0,0,0,0,0,0,0,0,0,0,0,-82000
2612,中航            ,16000,98000,-82000,0,0,0,0,0,0,0,0,0,0,0,0,0,-82000
3033,威健            ,69000,148000,-79000,0,0,0,0,0,0,-3000,0,3000,-3000,0,0,0,-82000
07643P,禾伸堂凱基9A售02,0,0,0,0,0,0,0,0,0,-82000,0,0,0,10000,92000,-82000,-82000
060998,華通兆豐9A購01  ,0,0,0,0,0,0,0,0,0,-83000,0,0,0,56000,139000,-83000,-83000
059540,新光金日盛99購01,0,0,0,0,0,0,0,0,0,-83000,0,0,0,0,83000,-83000,-83000
060183,南亞科元富9A購01,0,0,0,0,0,0,0,0,0,-83000,0,0,0,26000,109000,-83000,-83000
060731,奇力新群益9A購01,0,0,0,0,0,0,0,0,0,-83000,0,0,0,100000,183000,-83000,-83000
057595,健鼎兆豐98購01  ,0,0,0,0,0,0,0,0,0,-83000,0,0,0,52000,135000,-83000,-83000
2702,華園            ,37000,120000,-83000,0,0,0,0,0,0,0,0,0,0,0,0,0,-83000
1603,華電            ,26000,109000,-83000,0,0,0,0,0,0,0,0,0,0,0,0,0,-83000
6108,競國            ,10000,91000,-81000,0,0,0,0,0,0,-2000,0,2000,-2000,0,0,0,-83000
060871,台灣50中信01購03,0,0,0,0,0,0,0,0,0,-84000,0,0,0,62000,146000,-84000,-84000
060571,京元電永豐9A購01,0,0,0,0,0,0,0,0,0,-84000,0,0,0,220000,304000,-84000,-84000
059748,聯發科台新99購03,0,0,0,0,0,0,0,0,0,-84000,0,0,0,75000,159000,-84000,-84000
053723,奇鋐凱基98購01  ,0,0,0,0,0,0,0,0,0,-84000,0,0,0,0,84000,-84000,-84000
2832,台產            ,0,84000,-84000,0,0,0,0,0,0,0,0,0,0,0,0,0,-84000
07252P,台灣50凱基99售01,0,0,0,0,0,0,0,0,0,-84000,0,0,0,65000,149000,-84000,-84000
060027,元金2X永豐99購02,0,0,0,0,0,0,0,0,0,-85000,0,0,0,0,85000,-85000,-85000
060825,聯詠元大9A購05  ,0,0,0,0,0,0,0,0,0,-85000,0,0,0,259000,344000,-85000,-85000
061417,力成群益9A購01  ,0,0,0,0,0,0,0,0,0,-85000,0,0,0,5000,90000,-85000,-85000
061669,崇越中信9A購01  ,0,0,0,0,0,0,0,0,0,-85000,0,0,0,0,85000,-85000,-85000
06163P,聯詠群益97售01  ,0,0,0,0,0,0,0,0,0,-85000,0,0,0,0,85000,-85000,-85000
051047,深中小群益99購01,0,0,0,0,0,0,0,0,0,-85000,0,0,0,0,85000,-85000,-85000
047629,深中小元大96購01,0,0,0,0,0,0,0,0,0,-85000,0,0,0,0,85000,-85000,-85000
058284,滬深反群益01購01,0,0,0,0,0,0,0,0,0,-85000,0,0,0,0,85000,-85000,-85000
054656,深中小元大97購01,0,0,0,0,0,0,0,0,0,-85000,0,0,0,0,85000,-85000,-85000
056749,滬深2X兆豐99購01,0,0,0,0,0,0,0,0,0,-85000,0,0,0,0,85000,-85000,-85000
059384,上証2X凱基9B購01,0,0,0,0,0,0,0,0,0,-85000,0,0,0,0,85000,-85000,-85000
3518,柏騰            ,89000,173000,-84000,0,0,0,0,0,0,-1000,0,1000,-1000,0,0,0,-85000
061301,華新科永豐9A購03,0,0,0,0,0,0,0,0,0,-86000,0,0,0,31000,117000,-86000,-86000
061204,國巨元大9A購16  ,0,0,0,0,0,0,0,0,0,-86000,0,0,0,56000,142000,-86000,-86000
053127,貿聯凱基97購01  ,0,0,0,0,0,0,0,0,0,-86000,0,0,0,10000,96000,-86000,-86000
057788,嘉聯益國票99購01,0,0,0,0,0,0,0,0,0,-86000,0,0,0,35000,121000,-86000,-86000
9911,櫻花            ,34000,121000,-87000,0,0,0,0,0,0,1000,1000,0,1000,0,0,0,-86000
061068,祥碩凱基9B購01  ,0,0,0,0,0,0,0,0,0,-87000,0,0,0,103000,190000,-87000,-87000
061619,大立光群益9B購01,0,0,0,0,0,0,0,0,0,-87000,0,0,0,0,87000,-87000,-87000
06073P,健策永豐97售01  ,0,0,0,0,0,0,0,0,0,-87000,0,0,0,52000,139000,-87000,-87000
060342,台積電統一02購01,0,0,0,0,0,0,0,0,0,-87000,0,0,0,0,87000,-87000,-87000
059541,T50正2康和99購01,0,0,0,0,0,0,0,0,0,-87000,0,0,0,2000,89000,-87000,-87000
053056,同欣電國票97購01,0,0,0,0,0,0,0,0,0,-87000,0,0,0,169000,256000,-87000,-87000
03604P,群創凱基98售05  ,0,0,0,0,0,0,0,0,0,-87000,0,0,0,83000,170000,-87000,-87000
052279,旺宏凱基95購07  ,0,0,0,0,0,0,0,0,0,-87000,0,0,0,10000,97000,-87000,-87000
059274,國巨元大99購22  ,0,0,0,0,0,0,0,0,0,-87000,0,0,0,117000,204000,-87000,-87000
057008,華新科中信99購02,0,0,0,0,0,0,0,0,0,-87000,0,0,0,0,87000,-87000,-87000
1225,福懋油          ,32000,119000,-87000,0,0,0,0,0,0,0,0,0,0,0,0,0,-87000
3035,智原            ,199000,222671,-23671,0,0,0,0,0,0,-64000,2000,15000,-13000,5000,56000,-51000,-87671
059617,A50正2群益01購02,0,0,0,0,0,0,0,0,0,-88000,0,0,0,0,88000,-88000,-88000
060817,華邦電台新9A購01,0,0,0,0,0,0,0,0,0,-88000,0,0,0,52000,140000,-88000,-88000
058243,華擎元大99購01  ,0,0,0,0,0,0,0,0,0,-88000,0,0,0,432000,520000,-88000,-88000
057775,南亞科群益98購02,0,0,0,0,0,0,0,0,0,-88000,0,0,0,12000,100000,-88000,-88000
056960,光罩永豐98購01  ,0,0,0,0,0,0,0,0,0,-88000,0,0,0,178000,266000,-88000,-88000
057295,可成永豐98購02  ,0,0,0,0,0,0,0,0,0,-88000,0,0,0,0,88000,-88000,-88000
057836,南亞科國泰9A購01,0,0,0,0,0,0,0,0,0,-88000,0,0,0,0,88000,-88000,-88000
6226,光鼎            ,277000,364000,-87000,0,0,0,0,0,0,-1000,0,1000,-1000,0,0,0,-88000
055209,勤誠康和97購01  ,0,0,0,0,0,0,0,0,0,-89000,0,0,0,0,89000,-89000,-89000
057367,技嘉元大98購02  ,0,0,0,0,0,0,0,0,0,-89000,0,0,0,1000,90000,-89000,-89000
07202P,台灣50凱基9C售04,0,0,0,0,0,0,0,0,0,-89000,0,0,0,14000,103000,-89000,-89000
060468,聯鈞元大9A購02  ,0,0,0,0,0,0,0,0,0,-90000,0,0,0,50000,140000,-90000,-90000
059656,T50反1元大99購11,0,0,0,0,0,0,0,0,0,-90000,0,0,0,115000,205000,-90000,-90000
061733,聯發科中信01購01,0,0,0,0,0,0,0,0,0,-90000,0,0,0,0,90000,-90000,-90000
06917P,聯電亞東99售01  ,0,0,0,0,0,0,0,0,0,-90000,0,0,0,0,90000,-90000,-90000
061205,旺宏元大9A購11  ,0,0,0,0,0,0,0,0,0,-90000,0,0,0,25000,115000,-90000,-90000
056846,晶相光元富98購01,0,0,0,0,0,0,0,0,0,-90000,0,0,0,50000,140000,-90000,-90000
056804,T50反1統一9A購03,0,0,0,0,0,0,0,0,0,-90000,0,0,0,0,90000,-90000,-90000
050014,國巨富邦98購01  ,0,0,0,0,0,0,0,0,0,-90000,0,0,0,0,90000,-90000,-90000
056438,旺宏凱基98購05  ,0,0,0,0,0,0,0,0,0,-90000,0,0,0,0,90000,-90000,-90000
057289,力成元大98購03  ,0,0,0,0,0,0,0,0,0,-90000,0,0,0,61000,151000,-90000,-90000
057034,道瓊反元大9B購01,0,0,0,0,0,0,0,0,0,-90000,0,0,0,17000,107000,-90000,-90000
07419P,聯發科元大99售46,0,0,0,0,0,0,0,0,0,-90000,0,0,0,0,90000,-90000,-90000
07580P,緯穎元大9A售03  ,0,0,0,0,0,0,0,0,0,-90000,0,0,0,12000,102000,-90000,-90000
061555,聯電國票9B購01  ,0,0,0,0,0,0,0,0,0,-91000,0,0,0,21000,112000,-91000,-91000
055684,京鼎凱基97購01  ,0,0,0,0,0,0,0,0,0,-91000,0,0,0,40000,131000,-91000,-91000
1536,和大            ,848000,784000,64000,0,0,0,0,0,0,-155000,18000,18000,0,15000,170000,-155000,-91000
3454,晶睿            ,50000,141000,-91000,0,0,0,0,0,0,0,0,0,0,0,0,0,-91000
061385,上証2X群益9C購07,0,0,0,0,0,0,0,0,0,-92000,0,0,0,0,92000,-92000,-92000
054343,世紀鋼元富96購02,0,0,0,0,0,0,0,0,0,-92000,0,0,0,157000,249000,-92000,-92000
1592,英瑞-KY         ,16000,108000,-92000,0,0,0,0,0,0,0,0,0,0,0,0,0,-92000
07837P,華邦電元大9A售01,0,0,0,0,0,0,0,0,0,-92000,0,0,0,1000,93000,-92000,-92000
03566P,臺股指日盛03售01,0,0,0,0,0,0,0,0,0,-93000,0,0,0,0,93000,-93000,-93000
058863,可成凱基99購02  ,0,0,0,0,0,0,0,0,0,-93000,0,0,0,10000,103000,-93000,-93000
056426,上証2X凱基9A購01,0,0,0,0,0,0,0,0,0,-93000,0,0,0,0,93000,-93000,-93000
6670,復盛應用        ,39000,98000,-59000,0,0,0,0,0,0,-34000,1000,31000,-30000,0,4000,-4000,-93000
061387,鴻海群益9A購05  ,0,0,0,0,0,0,0,0,0,-94000,0,0,0,4000,98000,-94000,-94000
061586,智邦富邦9A購02  ,0,0,0,0,0,0,0,0,0,-94000,0,0,0,0,94000,-94000,-94000
020015,統一MSCI美低波N ,0,0,0,0,0,0,0,0,0,-94000,0,0,0,10000,104000,-94000,-94000
051600,新日興兆豐96購02,0,0,0,0,0,0,0,0,0,-94000,0,0,0,0,94000,-94000,-94000
056755,聯茂兆豐98購01  ,0,0,0,0,0,0,0,0,0,-94000,0,0,0,0,94000,-94000,-94000
056664,上証反中信9B購01,0,0,0,0,0,0,0,0,0,-94000,0,0,0,6000,100000,-94000,-94000
057316,國巨凱基99購04  ,0,0,0,0,0,0,0,0,0,-94000,0,0,0,11000,105000,-94000,-94000
058580,華新科群益99購02,0,0,0,0,0,0,0,0,0,-94000,0,0,0,1000,95000,-94000,-94000
056919,英業達兆豐98購01,0,0,0,0,0,0,0,0,0,-94000,0,0,0,30000,124000,-94000,-94000
07834P,聯詠群益9A售03  ,0,0,0,0,0,0,0,0,0,-94000,0,0,0,6000,100000,-94000,-94000
07698P,臺股指元大9A售51,0,0,0,0,0,0,0,0,0,-94000,0,0,0,16000,110000,-94000,-94000
060065,大立光兆豐9B購01,0,0,0,0,0,0,0,0,0,-95000,0,0,0,0,95000,-95000,-95000
059958,鎧勝康和99購01  ,0,0,0,0,0,0,0,0,0,-95000,0,0,0,96000,191000,-95000,-95000
053752,超眾永豐96購02  ,0,0,0,0,0,0,0,0,0,-95000,0,0,0,1000,96000,-95000,-95000
058497,新日興群益9B購01,0,0,0,0,0,0,0,0,0,-95000,0,0,0,110000,205000,-95000,-95000
05878P,創意群益98售01  ,0,0,0,0,0,0,0,0,0,-95000,0,0,0,0,95000,-95000,-95000
056566,臻鼎群益98購01  ,0,0,0,0,0,0,0,0,0,-95000,0,0,0,0,95000,-95000,-95000
059076,FBVIX元大99購04 ,0,0,0,0,0,0,0,0,0,-95000,0,0,0,5000,100000,-95000,-95000
057173,南亞科元大98購04,0,0,0,0,0,0,0,0,0,-95000,0,0,0,72000,167000,-95000,-95000
07579P,聯茂元大9A售01  ,0,0,0,0,0,0,0,0,0,-95000,0,0,0,88000,183000,-95000,-95000
2009,第一銅          ,0,95000,-95000,0,0,0,0,0,0,0,0,0,0,0,0,0,-95000
061704,景碩國票9A購01  ,0,0,0,0,0,0,0,0,0,-96000,0,0,0,17000,113000,-96000,-96000
06701P,臺股指統一99售06,0,0,0,0,0,0,0,0,0,-96000,0,0,0,36000,132000,-96000,-96000
061240,華新科兆豐9A購01,0,0,0,0,0,0,0,0,0,-96000,0,0,0,6000,102000,-96000,-96000
052775,滬深2X國票99購02,0,0,0,0,0,0,0,0,0,-96000,0,0,0,4000,100000,-96000,-96000
052938,華新科兆豐96購01,0,0,0,0,0,0,0,0,0,-96000,0,0,0,0,96000,-96000,-96000
056091,百和統一97購01  ,0,0,0,0,0,0,0,0,0,-96000,0,0,0,48000,144000,-96000,-96000
3024,憶聲            ,2000,98000,-96000,0,0,0,0,0,0,0,0,0,0,0,0,0,-96000
9136,巨騰-DR         ,0,96000,-96000,0,0,0,0,0,0,0,0,0,0,0,0,0,-96000
061306,瑞祺永豐9A購02  ,0,0,0,0,0,0,0,0,0,-97000,0,0,0,116000,213000,-97000,-97000
061577,泰碩元大9A購03  ,0,0,0,0,0,0,0,0,0,-97000,0,0,0,27000,124000,-97000,-97000
060383,葡萄王凱基9A購01,0,0,0,0,0,0,0,0,0,-97000,0,0,0,250000,347000,-97000,-97000
051277,聯發科中信9A購01,3000,100000,-97000,0,0,0,0,0,0,0,0,0,0,0,0,0,-97000
057938,台表科群益98購02,0,0,0,0,0,0,0,0,0,-97000,0,0,0,2000,99000,-97000,-97000
057061,華擎國泰9A購01  ,0,0,0,0,0,0,0,0,0,-97000,0,0,0,50000,147000,-97000,-97000
2939,凱羿-KY         ,48000,145000,-97000,0,0,0,0,0,0,0,0,0,0,0,0,0,-97000
060772,FBVIX凱基9A購03 ,0,0,0,0,0,0,0,0,0,-98000,0,0,0,14000,112000,-98000,-98000
061420,國巨元大9A購22  ,0,0,0,0,0,0,0,0,0,-98000,0,0,0,0,98000,-98000,-98000
059312,元石油元大99購05,0,0,0,0,0,0,0,0,0,-98000,0,0,0,574000,672000,-98000,-98000
057937,神達群益98購02  ,0,0,0,0,0,0,0,0,0,-98000,0,0,0,0,98000,-98000,-98000
1808,潤隆            ,20000,118000,-98000,0,0,0,0,0,0,0,0,0,0,0,0,0,-98000
07340P,鴻海凱基99售15  ,0,0,0,0,0,0,0,0,0,-98000,0,0,0,2000,100000,-98000,-98000
6214,精誠            ,76000,174000,-98000,0,0,0,0,0,0,0,0,0,0,0,0,0,-98000
4576,大銀微系統      ,17000,115000,-98000,0,0,0,0,0,0,0,0,0,0,0,0,0,-98000
061255,道瓊反凱基9C購01,0,0,0,0,0,0,0,0,0,-99000,0,0,0,1000,100000,-99000,-99000
054082,楠梓電元富96購01,0,0,0,0,0,0,0,0,0,-99000,0,0,0,0,99000,-99000,-99000
058518,玉晶光元大99購13,0,0,0,0,0,0,0,0,0,-99000,0,0,0,110000,209000,-99000,-99000
056291,聯茂永豐97購03  ,0,0,0,0,0,0,0,0,0,-99000,0,0,0,1000,100000,-99000,-99000
07532P,台灣50中信01售02,0,0,0,0,0,0,0,0,0,-99000,0,0,0,1000,100000,-99000,-99000
061537,SP黃豆群益9A購02,0,0,0,0,0,0,0,0,0,-100000,0,0,0,0,100000,-100000,-100000
060858,T50反1永豐9A購01,0,0,0,0,0,0,0,0,0,-100000,0,0,0,0,100000,-100000,-100000
060901,臺股指凱基9A購13,0,0,0,0,0,0,0,0,0,-100000,0,0,0,10000,110000,-100000,-100000
059639,大立光凱基9A購06,0,0,0,0,0,0,0,0,0,-100000,0,0,0,10000,110000,-100000,-100000
055055,精元永豐97購01  ,0,0,0,0,0,0,0,0,0,-100000,0,0,0,0,100000,-100000,-100000
053086,宏達電元大97購01,0,0,0,0,0,0,0,0,0,-100000,0,0,0,0,100000,-100000,-100000
052885,高鐵兆豐98購01  ,0,0,0,0,0,0,0,0,0,-100000,0,0,0,0,100000,-100000,-100000
052864,奇力新凱基96購02,0,0,0,0,0,0,0,0,0,-100000,0,0,0,0,100000,-100000,-100000
054922,文曄凱基98購01  ,0,0,0,0,0,0,0,0,0,-100000,0,0,0,0,100000,-100000,-100000
05527P,聯茂群益96售01  ,0,0,0,0,0,0,0,0,0,-100000,0,0,0,0,100000,-100000,-100000
054223,大立光統一98購04,0,0,0,0,0,0,0,0,0,-100000,0,0,0,0,100000,-100000,-100000
050911,光磊中信98購01  ,0,0,0,0,0,0,0,0,0,-100000,0,0,0,0,100000,-100000,-100000
052704,TPK國票97購01   ,0,0,0,0,0,0,0,0,0,-100000,0,0,0,0,100000,-100000,-100000
050641,上証反凱基96購01,0,0,0,0,0,0,0,0,0,-100000,0,0,0,0,100000,-100000,-100000
053667,鴻海統一96購12  ,0,0,0,0,0,0,0,0,0,-100000,0,0,0,0,100000,-100000,-100000
052083,S&P反1元大97購02,0,0,0,0,0,0,0,0,0,-100000,0,0,0,0,100000,-100000,-100000
052328,台表科中信99購01,0,0,0,0,0,0,0,0,0,-100000,0,0,0,0,100000,-100000,-100000
056235,鴻海群益97購07  ,0,0,0,0,0,0,0,0,0,-100000,0,0,0,0,100000,-100000,-100000
059019,元石油統一9B購03,0,0,0,0,0,0,0,0,0,-100000,0,0,0,326000,426000,-100000,-100000
057085,立積統一9B購02  ,0,0,0,0,0,0,0,0,0,-100000,0,0,0,587000,687000,-100000,-100000
057104,康友中信99購01  ,0,0,0,0,0,0,0,0,0,-100000,0,0,0,0,100000,-100000,-100000
058184,鴻海永豐99購01  ,0,0,0,0,0,0,0,0,0,-100000,0,0,0,2000,102000,-100000,-100000
057002,友達國票98購01  ,0,0,0,0,0,0,0,0,0,-100000,0,0,0,0,100000,-100000,-100000
055566,台表科凱基97購03,0,0,0,0,0,0,0,0,0,-100000,0,0,0,10000,110000,-100000,-100000
056152,可成凱基97購02  ,0,0,0,0,0,0,0,0,0,-100000,0,0,0,0,100000,-100000,-100000
07714P,世紀鋼元大9A售03,0,0,0,0,0,0,0,0,0,-100000,0,0,0,8000,108000,-100000,-100000
07358P,鴻海元大99售39  ,0,0,0,0,0,0,0,0,0,-100000,0,0,0,70000,170000,-100000,-100000
3057,喬鼎            ,26000,126000,-100000,0,0,0,0,0,0,0,0,0,0,0,0,0,-100000
053524,聯電中信97購02  ,0,0,0,0,0,0,0,0,0,-101000,0,0,0,40000,141000,-101000,-101000
056573,華新科元大99購06,0,0,0,0,0,0,0,0,0,-101000,0,0,0,1000,102000,-101000,-101000
2530,華建            ,18000,119000,-101000,0,0,0,0,0,0,0,0,0,0,0,0,0,-101000
5907,大洋-KY         ,57000,158000,-101000,0,0,0,0,0,0,0,0,0,0,0,0,0,-101000
06052P,台郡國票97售06  ,0,0,0,0,0,0,0,0,0,-102000,0,0,0,7000,109000,-102000,-102000
052424,泰碩國票97購01  ,0,0,0,0,0,0,0,0,0,-102000,0,0,0,18000,120000,-102000,-102000
2476,鉅祥            ,8000,110000,-102000,0,0,0,0,0,0,0,0,0,0,0,0,0,-102000
2022,聚亨            ,0,102000,-102000,0,0,0,0,0,0,0,0,0,0,0,0,0,-102000
2106,建大            ,68000,869000,-801000,0,0,0,700000,0,700000,-1000,0,1000,-1000,0,0,0,-102000
07173P,臺股指國票99售10,0,0,0,0,0,0,0,0,0,-102000,0,0,0,393000,495000,-102000,-102000
061334,華通元大9A購09  ,0,0,0,0,0,0,0,0,0,-103000,0,0,0,58000,161000,-103000,-103000
061167,臻鼎兆豐9B購01  ,0,0,0,0,0,0,0,0,0,-103000,0,0,0,88000,191000,-103000,-103000
06478P,臺股指日盛9A售01,0,0,0,0,0,0,0,0,0,-103000,0,0,0,8000,111000,-103000,-103000
051423,GIS國票97購01   ,0,0,0,0,0,0,0,0,0,-103000,0,0,0,0,103000,-103000,-103000
054527,國巨統一97購03  ,0,0,0,0,0,0,0,0,0,-103000,0,0,0,201000,304000,-103000,-103000
055138,大毅永豐97購02  ,0,0,0,0,0,0,0,0,0,-103000,0,0,0,67000,170000,-103000,-103000
059268,鎧勝中信01購01  ,0,0,0,0,0,0,0,0,0,-103000,0,0,0,10000,113000,-103000,-103000
055745,臻鼎元富97購01  ,0,0,0,0,0,0,0,0,0,-103000,0,0,0,13000,116000,-103000,-103000
00709,富邦歐洲        ,0,0,0,0,0,0,0,0,0,-104000,0,0,0,100000,204000,-104000,-104000
057675,同欣電元大98購02,0,0,0,0,0,0,0,0,0,-104000,0,0,0,167000,271000,-104000,-104000
07825P,健策國泰9B售04  ,0,0,0,0,0,0,0,0,0,-104000,0,0,0,205000,309000,-104000,-104000
2852,第一保          ,0,104000,-104000,0,0,0,0,0,0,0,0,0,0,0,0,0,-104000
00739,元大MSCI A股    ,9000,205000,-196000,0,0,0,0,0,0,91344,0,0,0,376000,284656,91344,-104656
06702P,智邦元富98售01  ,0,0,0,0,0,0,0,0,0,-105000,0,0,0,165000,270000,-105000,-105000
061803,巨大永豐9B購01  ,0,0,0,0,0,0,0,0,0,-105000,0,0,0,0,105000,-105000,-105000
060376,瑞祺元富9A購01  ,0,0,0,0,0,0,0,0,0,-105000,0,0,0,147000,252000,-105000,-105000
060896,晶技凱基9A購02  ,0,0,0,0,0,0,0,0,0,-105000,0,0,0,115000,220000,-105000,-105000
057269,鈺齊兆豐98購01  ,0,0,0,0,0,0,0,0,0,-105000,0,0,0,0,105000,-105000,-105000
1109,信大            ,15000,120000,-105000,0,0,0,0,0,0,0,0,0,0,0,0,0,-105000
060602,京元電凱基9A購01,0,0,0,0,0,0,0,0,0,-106000,0,0,0,11000,117000,-106000,-106000
060228,亞德客元大9A購01,0,0,0,0,0,0,0,0,0,-106000,0,0,0,227000,333000,-106000,-106000
1108,幸福            ,0,106000,-106000,0,0,0,0,0,0,0,0,0,0,0,0,0,-106000
07711P,世芯元大9A售07  ,0,0,0,0,0,0,0,0,0,-106000,0,0,0,76000,182000,-106000,-106000
061346,玉晶光元大9B購03,0,0,0,0,0,0,0,0,0,-107000,0,0,0,104000,211000,-107000,-107000
056579,麗豐元大99購01  ,0,0,0,0,0,0,0,0,0,-107000,0,0,0,281000,388000,-107000,-107000
057449,華新科元富99購02,0,0,0,0,0,0,0,0,0,-107000,0,0,0,1000,108000,-107000,-107000
061516,力成永豐9A購02  ,0,0,0,0,0,0,0,0,0,-108000,0,0,0,106000,214000,-108000,-108000
061206,旺宏元大9A購12  ,0,0,0,0,0,0,0,0,0,-108000,0,0,0,44000,152000,-108000,-108000
060931,GIS永豐9A購01   ,0,0,0,0,0,0,0,0,0,-108000,0,0,0,74000,182000,-108000,-108000
052599,S&P反1元大96購01,0,0,0,0,0,0,0,0,0,-108000,0,0,0,0,108000,-108000,-108000
057967,聯發科國泰9A購02,0,0,0,0,0,0,0,0,0,-108000,0,0,0,152000,260000,-108000,-108000
057319,奇力新凱基99購02,0,0,0,0,0,0,0,0,0,-108000,0,0,0,0,108000,-108000,-108000
057279,國揚元大98購01  ,0,0,0,0,0,0,0,0,0,-108000,0,0,0,2000,110000,-108000,-108000
059351,台虹凱基99購01  ,0,0,0,0,0,0,0,0,0,-108000,0,0,0,100000,208000,-108000,-108000
1451,年興            ,14000,122000,-108000,0,0,0,0,0,0,0,0,0,0,0,0,0,-108000
06240P,奇力新元富97售03,0,0,0,0,0,0,0,0,0,-109000,0,0,0,0,109000,-109000,-109000
059631,京元電凱基99購02,0,0,0,0,0,0,0,0,0,-109000,0,0,0,51000,160000,-109000,-109000
059755,宏達電國泰9A購01,0,0,0,0,0,0,0,0,0,-109000,0,0,0,33000,142000,-109000,-109000
060785,國巨富邦9B購04  ,0,0,0,0,0,0,0,0,0,-109000,0,0,0,30000,139000,-109000,-109000
060360,南亞科元富9A購02,0,0,0,0,0,0,0,0,0,-109000,0,0,0,16000,125000,-109000,-109000
054525,奇鋐元富96購01  ,0,0,0,0,0,0,0,0,0,-109000,0,0,0,140000,249000,-109000,-109000
050227,大立光中信96購01,0,0,0,0,0,0,0,0,0,-109000,0,0,0,0,109000,-109000,-109000
058212,華新科群益9A購01,0,0,0,0,0,0,0,0,0,-109000,0,0,0,0,109000,-109000,-109000
2723,美食-KY         ,513000,527000,-14000,0,0,0,253000,323000,-70000,-25000,3000,10000,-7000,3000,21000,-18000,-109000
9925,新保            ,32000,141000,-109000,0,0,0,0,0,0,0,0,0,0,0,0,0,-109000
060427,聯茂永豐9A購01  ,0,0,0,0,0,0,0,0,0,-110000,0,0,0,19000,129000,-110000,-110000
060767,世紀鋼元大9A購02,0,0,0,0,0,0,0,0,0,-110000,0,0,0,30000,140000,-110000,-110000
06891P,緯穎富邦99售03  ,0,0,0,0,0,0,0,0,0,-110000,0,0,0,20000,130000,-110000,-110000
058008,禾伸堂國票99購02,0,0,0,0,0,0,0,0,0,-110000,0,0,0,8000,118000,-110000,-110000
054969,亞翔元大97購01  ,0,0,0,0,0,0,0,0,0,-110000,0,0,0,0,110000,-110000,-110000
058049,帆宣元大98購01  ,0,0,0,0,0,0,0,0,0,-110000,0,0,0,224000,334000,-110000,-110000
056883,美食康和98購01  ,0,0,0,0,0,0,0,0,0,-110000,0,0,0,0,110000,-110000,-110000
058994,道瓊指元大99購01,0,0,0,0,0,0,0,0,0,-111000,0,0,0,0,111000,-111000,-111000
056540,聯詠凱基98購02  ,0,0,0,0,0,0,0,0,0,-111000,0,0,0,169000,280000,-111000,-111000
061747,南亞科統一01購01,0,0,0,0,0,0,0,0,0,-112000,0,0,0,0,112000,-112000,-112000
060654,大毅群益9B購01  ,0,0,0,0,0,0,0,0,0,-112000,0,0,0,238000,350000,-112000,-112000
00763U,街口道瓊銅      ,0,0,0,0,0,0,0,0,0,-112000,0,0,0,21000,133000,-112000,-112000
056603,嘉聯益國泰9A購01,0,0,0,0,0,0,0,0,0,-112000,0,0,0,18000,130000,-112000,-112000
056642,旺宏凱基98購07  ,0,0,0,0,0,0,0,0,0,-112000,0,0,0,4000,116000,-112000,-112000
057872,旺宏元大99購06  ,0,0,0,0,0,0,0,0,0,-112000,0,0,0,36000,148000,-112000,-112000
055926,國巨群益98購06  ,0,0,0,0,0,0,0,0,0,-112000,0,0,0,0,112000,-112000,-112000
1582,信錦            ,47000,158000,-111000,0,0,0,0,0,0,-1000,0,1000,-1000,0,0,0,-112000
061162,南電群益9A購02  ,0,0,0,0,0,0,0,0,0,-113000,0,0,0,1000,114000,-113000,-113000
061372,世紀鋼國泰9C購01,0,0,0,0,0,0,0,0,0,-113000,0,0,0,699000,812000,-113000,-113000
03765P,大立光元富96售01,0,0,0,0,0,0,0,0,0,-113000,0,0,0,0,113000,-113000,-113000
054499,台光電永豐96購02,0,0,0,0,0,0,0,0,0,-113000,0,0,0,0,113000,-113000,-113000
058062,上銀中信98購01  ,0,0,0,0,0,0,0,0,0,-113000,0,0,0,105000,218000,-113000,-113000
2406,國碩            ,184000,295000,-111000,0,0,0,0,0,0,-2000,0,2000,-2000,0,0,0,-113000
061514,泰碩永豐9A購02  ,0,0,0,0,0,0,0,0,0,-114000,0,0,0,10000,124000,-114000,-114000
061002,瑞昱兆豐9B購01  ,0,0,0,0,0,0,0,0,0,-114000,0,0,0,79000,193000,-114000,-114000
059607,台積電富邦9C購04,0,0,0,0,0,0,0,0,0,-114000,0,0,0,0,114000,-114000,-114000
059980,台積電元大99購50,0,0,0,0,0,0,0,0,0,-114000,0,0,0,0,114000,-114000,-114000
057980,聯詠永豐98購01  ,0,0,0,0,0,0,0,0,0,-114000,0,0,0,76000,190000,-114000,-114000
057639,國巨元大99購07  ,0,0,0,0,0,0,0,0,0,-114000,0,0,0,1000,115000,-114000,-114000
058942,南茂中信99購01  ,0,0,0,0,0,0,0,0,0,-114000,0,0,0,23000,137000,-114000,-114000
059023,可成統一9B購02  ,0,0,0,0,0,0,0,0,0,-114000,0,0,0,95000,209000,-114000,-114000
059834,友達國泰9B購01  ,0,0,0,0,0,0,0,0,0,-115000,0,0,0,30000,145000,-115000,-115000
061411,T50反1群益9A購05,0,0,0,0,0,0,0,0,0,-115000,0,0,0,198000,313000,-115000,-115000
052256,台泥國泰96購01  ,0,0,0,0,0,0,0,0,0,-115000,0,0,0,0,115000,-115000,-115000
057408,台郡群益98購01  ,0,0,0,0,0,0,0,0,0,-115000,0,0,0,63000,178000,-115000,-115000
057659,台表科兆豐98購01,0,0,0,0,0,0,0,0,0,-115000,0,0,0,0,115000,-115000,-115000
058670,鴻海群益9A購03  ,0,0,0,0,0,0,0,0,0,-115000,0,0,0,0,115000,-115000,-115000
2851,中再保          ,52000,167000,-115000,0,0,0,0,0,0,0,0,0,0,0,0,0,-115000
07745P,華新科凱基9A售10,0,0,0,0,0,0,0,0,0,-115000,0,0,0,0,115000,-115000,-115000
6591,動力-KY         ,149000,262000,-113000,0,0,0,0,0,0,-2000,0,2000,-2000,0,0,0,-115000
2404,漢唐            ,102568,176000,-73432,0,0,0,0,0,0,-42000,8000,6000,2000,7000,51000,-44000,-115432
061419,國巨元大9A購21  ,0,0,0,0,0,0,0,0,0,-116000,0,0,0,90000,206000,-116000,-116000
006207,FH滬深          ,5000,1004000,-999000,0,0,0,0,0,0,883000,0,30000,-30000,960000,47000,913000,-116000
054374,信邦中信96購01  ,0,0,0,0,0,0,0,0,0,-116000,0,0,0,0,116000,-116000,-116000
054912,群光凱基97購01  ,0,0,0,0,0,0,0,0,0,-116000,0,0,0,6000,122000,-116000,-116000
3036,文曄            ,310000,444000,-134000,0,0,0,0,0,0,18000,27000,73000,-46000,115000,51000,64000,-116000
9930,中聯資源        ,0,116000,-116000,0,0,0,0,0,0,0,0,0,0,0,0,0,-116000
060599,國巨凱基9C購01  ,0,0,0,0,0,0,0,0,0,-117000,0,0,0,1000,118000,-117000,-117000
060502,國巨元大9A購07  ,0,0,0,0,0,0,0,0,0,-117000,0,0,0,4000,121000,-117000,-117000
00663L,國泰臺灣加權正2 ,0,0,0,0,0,0,0,0,0,-117000,0,0,0,236000,353000,-117000,-117000
056688,聯詠統一98購01  ,0,0,0,0,0,0,0,0,0,-117000,0,0,0,286000,403000,-117000,-117000
061480,泰碩元大9B購01  ,0,0,0,0,0,0,0,0,0,-118000,0,0,0,60000,178000,-118000,-118000
06188P,大立光元富97售01,0,0,0,0,0,0,0,0,0,-118000,0,0,0,0,118000,-118000,-118000
055056,億光永豐97購01  ,0,0,0,0,0,0,0,0,0,-118000,0,0,0,8000,126000,-118000,-118000
055817,京鼎國票99購01  ,0,0,0,0,0,0,0,0,0,-118000,0,0,0,25000,143000,-118000,-118000
056686,可成統一98購01  ,0,0,0,0,0,0,0,0,0,-118000,0,0,0,78000,196000,-118000,-118000
058468,聯茂中信99購02  ,0,0,0,0,0,0,0,0,0,-118000,0,0,0,0,118000,-118000,-118000
9941,裕融            ,80000,198000,-118000,0,0,0,0,0,0,0,0,0,0,0,0,0,-118000
060583,南亞科元富9A購05,0,0,0,0,0,0,0,0,0,-119000,0,0,0,2000,121000,-119000,-119000
060050,鴻海凱基9B購01  ,0,0,0,0,0,0,0,0,0,-119000,0,0,0,2000,121000,-119000,-119000
060169,群電永豐9A購01  ,20000,0,20000,0,0,0,0,0,0,-139000,0,0,0,90000,229000,-139000,-119000
053055,聯詠國票97購01  ,0,0,0,0,0,0,0,0,0,-119000,0,0,0,391000,510000,-119000,-119000
058664,百和兆豐99購01  ,0,0,0,0,0,0,0,0,0,-119000,0,0,0,8000,127000,-119000,-119000
05861P,瀚宇博永豐96售02,0,0,0,0,0,0,0,0,0,-119000,0,0,0,35000,154000,-119000,-119000
057841,茂林富邦9A購02  ,0,0,0,0,0,0,0,0,0,-119000,0,0,0,0,119000,-119000,-119000
1473,台南            ,41000,160000,-119000,0,0,0,0,0,0,0,0,0,0,0,0,0,-119000
060976,SP黃豆元大9A購03,0,0,0,0,0,0,0,0,0,-120000,0,0,0,0,120000,-120000,-120000
056326,TPK兆豐98購01   ,0,0,0,0,0,0,0,0,0,-120000,0,0,0,0,120000,-120000,-120000
057743,華擎永豐98購03  ,0,0,0,0,0,0,0,0,0,-120000,0,0,0,0,120000,-120000,-120000
057616,聯電凱基99購01  ,0,0,0,0,0,0,0,0,0,-120000,0,0,0,166000,286000,-120000,-120000
07843P,緯穎元大9A售05  ,0,0,0,0,0,0,0,0,0,-120000,0,0,0,127000,247000,-120000,-120000
07347P,上証2X凱基99售02,0,0,0,0,0,0,0,0,0,-120000,0,0,0,0,120000,-120000,-120000
8210,勤誠            ,99000,177000,-78000,0,0,0,0,0,0,-42000,8000,16000,-8000,5000,39000,-34000,-120000
060322,卜蜂群益9A購01  ,0,0,0,0,0,0,0,0,0,-121000,0,0,0,0,121000,-121000,-121000
060700,華新科國泰9C購01,0,0,0,0,0,0,0,0,0,-121000,0,0,0,45000,166000,-121000,-121000
058952,南茂群益99購01  ,0,0,0,0,0,0,0,0,0,-121000,0,0,0,286000,407000,-121000,-121000
07104P,聯發科元富99售04,0,0,0,0,0,0,0,0,0,-121000,0,0,0,1000,122000,-121000,-121000
07691P,宏達電元大9A售05,0,0,0,0,0,0,0,0,0,-121000,0,0,0,0,121000,-121000,-121000
060782,道瓊指富邦9C購01,0,0,0,0,0,0,0,0,0,-122000,0,0,0,15000,137000,-122000,-122000
06900P,FBVIX國票12售01 ,0,0,0,0,0,0,0,0,0,-122000,0,0,0,5000,127000,-122000,-122000
055093,京鼎群益98購01  ,0,0,0,0,0,0,0,0,0,-122000,0,0,0,255000,377000,-122000,-122000
054786,全新群益99購02  ,0,0,0,0,0,0,0,0,0,-122000,0,0,0,0,122000,-122000,-122000
058494,可成群益9B購01  ,0,0,0,0,0,0,0,0,0,-122000,0,0,0,74000,196000,-122000,-122000
058646,聯茂富邦9A購01  ,0,0,0,0,0,0,0,0,0,-122000,0,0,0,80000,202000,-122000,-122000
07842P,力成元大9A售01  ,0,0,0,0,0,0,0,0,0,-122000,0,0,0,0,122000,-122000,-122000
6504,南六            ,281000,512000,-231000,0,0,0,120000,50000,70000,39000,23000,37000,-14000,59000,6000,53000,-122000
3698,隆達            ,919000,975000,-56000,0,0,0,0,0,0,-66000,137000,165000,-28000,0,38000,-38000,-122000
061702,奇鋐國票9A購02  ,0,0,0,0,0,0,0,0,0,-123000,0,0,0,0,123000,-123000,-123000
9917,中保科          ,329000,364000,-35000,0,0,0,0,88000,-88000,0,0,0,0,0,0,0,-123000
3015,全漢            ,88000,209000,-121000,0,0,0,0,0,0,-2000,0,2000,-2000,0,0,0,-123000
060063,可成兆豐9B購01  ,0,0,0,0,0,0,0,0,0,-124000,0,0,0,0,124000,-124000,-124000
03050X,元展47          ,0,0,0,0,0,0,0,0,0,-124000,0,0,0,1000,125000,-124000,-124000
055025,華新科國泰98購02,0,0,0,0,0,0,0,0,0,-124000,0,0,0,15000,139000,-124000,-124000
058435,旺宏統一9B購02  ,0,0,0,0,0,0,0,0,0,-124000,0,0,0,40000,164000,-124000,-124000
057849,南茂永豐98購02  ,0,0,0,0,0,0,0,0,0,-124000,0,0,0,61000,185000,-124000,-124000
1215,卜蜂            ,186000,332000,-146000,0,0,0,0,0,0,22000,18000,0,18000,5000,1000,4000,-124000
06619P,聯發科元大98售06,0,0,0,0,0,0,0,0,0,-125000,0,0,0,0,125000,-125000,-125000
060933,南電永豐9A購02  ,0,0,0,0,0,0,0,0,0,-125000,0,0,0,7000,132000,-125000,-125000
061374,力山永豐9A購04  ,0,0,0,0,0,0,0,0,0,-125000,0,0,0,129000,254000,-125000,-125000
052959,聯電凱基97購01  ,0,0,0,0,0,0,0,0,0,-125000,0,0,0,30000,155000,-125000,-125000
05530P,臺股指群益96售03,0,0,0,0,0,0,0,0,0,-125000,0,0,0,0,125000,-125000,-125000
053998,泰鼎群益98購01  ,0,0,0,0,0,0,0,0,0,-125000,0,0,0,161000,286000,-125000,-125000
5607,遠雄港          ,143000,268000,-125000,0,0,0,0,0,0,0,0,0,0,0,0,0,-125000
06949P,台表科元大99售01,0,0,0,0,0,0,0,0,0,-126000,0,0,0,24000,150000,-126000,-126000
05306P,泰碩國泰97售01  ,0,0,0,0,0,0,0,0,0,-126000,0,0,0,48000,174000,-126000,-126000
052619,茂林國泰99購01  ,0,0,0,0,0,0,0,0,0,-126000,0,0,0,53000,179000,-126000,-126000
057158,義隆永豐99購01  ,0,0,0,0,0,0,0,0,0,-126000,0,0,0,28000,154000,-126000,-126000
057236,聯詠凱基98購03  ,0,0,0,0,0,0,0,0,0,-126000,0,0,0,0,126000,-126000,-126000
8028,昇陽半導體      ,371000,439000,-68000,0,0,0,0,0,0,-58000,0,2000,-2000,0,56000,-56000,-126000
06068P,玉晶光康和97售01,0,0,0,0,0,0,0,0,0,-127000,0,0,0,3537000,3664000,-127000,-127000
055713,國巨元大98購09  ,0,0,0,0,0,0,0,0,0,-127000,0,0,0,27000,154000,-127000,-127000
00703,台新MSCI中國    ,0,0,0,0,0,0,0,0,0,-128000,0,0,0,33000,161000,-128000,-128000
057149,京鼎國票99購02  ,0,0,0,0,0,0,0,0,0,-128000,0,0,0,455000,583000,-128000,-128000
057568,友訊永豐99購01  ,0,0,0,0,0,0,0,0,0,-128000,0,0,0,0,128000,-128000,-128000
6672,騰輝電子-KY     ,71000,198000,-127000,0,0,0,0,0,0,-1000,0,1000,-1000,0,0,0,-128000
1218,泰山            ,176000,314000,-138000,0,0,0,0,0,0,10000,10000,0,10000,0,0,0,-128000
1457,宜進            ,4000,132000,-128000,0,0,0,0,0,0,0,0,0,0,0,0,0,-128000
059704,聯發科凱基9A購08,0,0,0,0,0,0,0,0,0,-129000,0,0,0,1000,130000,-129000,-129000
056332,台郡國票99購01  ,0,0,0,0,0,0,0,0,0,-129000,0,0,0,8000,137000,-129000,-129000
057623,友訊國泰99購01  ,0,0,0,0,0,0,0,0,0,-129000,0,0,0,45000,174000,-129000,-129000
059763,華擎永豐99購03  ,0,0,0,0,0,0,0,0,0,-130000,0,0,0,0,130000,-130000,-130000
060231,台積電元大9A購08,0,0,0,0,0,0,0,0,0,-130000,0,0,0,0,130000,-130000,-130000
060679,聯詠元大9A購04  ,0,0,0,0,0,0,0,0,0,-130000,0,0,0,138000,268000,-130000,-130000
053243,楠梓電國票97購02,0,0,0,0,0,0,0,0,0,-130000,0,0,0,0,130000,-130000,-130000
053887,聯茂兆豐97購02  ,0,0,0,0,0,0,0,0,0,-130000,0,0,0,0,130000,-130000,-130000
056012,勤誠中信99購01  ,0,0,0,0,0,0,0,0,0,-130000,0,0,0,0,130000,-130000,-130000
059187,國巨富邦9B購02  ,0,0,0,0,0,0,0,0,0,-130000,0,0,0,650000,780000,-130000,-130000
07632P,臺股指凱基9A售14,0,0,0,0,0,0,0,0,0,-130000,0,0,0,130000,260000,-130000,-130000
07457P,宏達電元大9A售01,0,0,0,0,0,0,0,0,0,-130000,0,0,0,5000,135000,-130000,-130000
060060,台積電兆豐99購05,0,0,0,0,0,0,0,0,0,-131000,0,0,0,0,131000,-131000,-131000
061506,瑞祺國票9A購02  ,0,0,0,0,0,0,0,0,0,-131000,0,0,0,49000,180000,-131000,-131000
055305,旺宏群益99購01  ,0,0,0,0,0,0,0,0,0,-131000,0,0,0,20000,151000,-131000,-131000
05443P,宏達電元大95售05,0,0,0,0,0,0,0,0,0,-131000,0,0,0,20000,151000,-131000,-131000
049007,玉晶光中信96購01,0,0,0,0,0,0,0,0,0,-131000,0,0,0,127000,258000,-131000,-131000
056281,深中小永豐97購01,0,0,0,0,0,0,0,0,0,-131000,0,0,0,5000,136000,-131000,-131000
058081,技嘉群益9A購03  ,0,0,0,0,0,0,0,0,0,-131000,0,0,0,50000,181000,-131000,-131000
6288,聯嘉            ,361000,489000,-128000,0,0,0,0,0,0,-3000,0,3000,-3000,0,0,0,-131000
059911,國巨元大99購27  ,0,0,0,0,0,0,0,0,0,-132000,0,0,0,77000,209000,-132000,-132000
055232,泰碩國票98購01  ,0,0,0,0,0,0,0,0,0,-132000,0,0,0,15000,147000,-132000,-132000
058847,國巨群益99購05  ,0,0,0,0,0,0,0,0,0,-132000,0,0,0,200000,332000,-132000,-132000
060023,T50反1國泰9A購03,0,0,0,0,0,0,0,0,0,-133000,0,0,0,10000,143000,-133000,-133000
061564,華擎國票9A購02  ,0,0,0,0,0,0,0,0,0,-133000,0,0,0,26000,159000,-133000,-133000
057385,光罩永豐99購01  ,0,0,0,0,0,0,0,0,0,-133000,0,0,0,19000,152000,-133000,-133000
3708,上緯投控        ,43000,165000,-122000,0,0,0,0,0,0,-11000,0,0,0,0,11000,-11000,-133000
3090,日電貿          ,219000,286000,-67000,0,0,0,0,0,0,-66000,0,1000,-1000,8000,73000,-65000,-133000
6414,樺漢            ,124000,255125,-131125,0,0,0,0,0,0,-2000,16000,15000,1000,3000,6000,-3000,-133125
055987,台表科元富97購01,0,0,0,0,0,0,0,0,0,-134000,0,0,0,0,134000,-134000,-134000
052890,FB上証群益9B購01,0,0,0,0,0,0,0,0,0,-135000,0,0,0,0,135000,-135000,-135000
053072,國巨台新97購01  ,0,0,0,0,0,0,0,0,0,-135000,0,0,0,445000,580000,-135000,-135000
055109,正崴凱基98購01  ,0,0,0,0,0,0,0,0,0,-135000,0,0,0,20000,155000,-135000,-135000
058698,華通元大99購05  ,0,0,0,0,0,0,0,0,0,-135000,0,0,0,0,135000,-135000,-135000
055611,燿華國票98購02  ,0,0,0,0,0,0,0,0,0,-135000,0,0,0,0,135000,-135000,-135000
057399,滬深反群益9C購01,0,0,0,0,0,0,0,0,0,-135000,0,0,0,25000,160000,-135000,-135000
056263,友訊統一99購01  ,0,0,0,0,0,0,0,0,0,-135000,0,0,0,21000,156000,-135000,-135000
058405,訊連元大99購02  ,0,0,0,0,0,0,0,0,0,-136000,0,0,0,205000,341000,-136000,-136000
055894,欣興統一97購03  ,0,0,0,0,0,0,0,0,0,-137000,0,0,0,46000,183000,-137000,-137000
051630,力山國票96購01  ,0,0,0,0,0,0,0,0,0,-137000,0,0,0,80000,217000,-137000,-137000
07839P,嘉澤元大9A售04  ,0,0,0,0,0,0,0,0,0,-137000,0,0,0,0,137000,-137000,-137000
053492,華邦電兆豐97購01,0,0,0,0,0,0,0,0,0,-138000,0,0,0,0,138000,-138000,-138000
054502,泰碩永豐96購01  ,0,0,0,0,0,0,0,0,0,-138000,0,0,0,10000,148000,-138000,-138000
059355,國巨富邦9B購03  ,0,0,0,0,0,0,0,0,0,-138000,0,0,0,344000,482000,-138000,-138000
057060,緯穎元大98購05  ,0,0,0,0,0,0,0,0,0,-138000,0,0,0,6000,144000,-138000,-138000
07128P,大毅元大99售04  ,0,0,0,0,0,0,0,0,0,-138000,0,0,0,209000,347000,-138000,-138000
1560,中砂            ,15000,193000,-178000,0,0,0,0,0,0,40000,40000,0,40000,0,0,0,-138000
060104,新日興元大99購03,0,0,0,0,0,0,0,0,0,-139000,0,0,0,3000,142000,-139000,-139000
05571P,大立光統一96售03,0,0,0,0,0,0,0,0,0,-139000,0,0,0,79000,218000,-139000,-139000
1809,中釉            ,49000,188000,-139000,0,0,0,0,0,0,0,0,0,0,0,0,0,-139000
060684,同欣電元大9A購01,0,0,0,0,0,0,0,0,0,-140000,0,0,0,133000,273000,-140000,-140000
057738,旺宏富邦9A購01  ,0,0,0,0,0,0,0,0,0,-140000,0,0,0,0,140000,-140000,-140000
1598,岱宇            ,98000,244000,-146000,0,0,0,0,0,0,6000,6000,0,6000,0,0,0,-140000
1417,嘉裕            ,23000,163000,-140000,0,0,0,0,0,0,0,0,0,0,0,0,0,-140000
07640P,國巨群益9A售07  ,0,0,0,0,0,0,0,0,0,-140000,0,0,0,229000,369000,-140000,-140000
6206,飛捷            ,13000,152000,-139000,0,0,0,0,0,0,-1000,0,1000,-1000,0,0,0,-140000
061677,泰碩元大9A購05  ,0,0,0,0,0,0,0,0,0,-141000,0,0,0,0,141000,-141000,-141000
051659,力山國泰97購01  ,0,0,0,0,0,0,0,0,0,-141000,0,0,0,160000,301000,-141000,-141000
2464,盟立            ,35000,174000,-139000,0,0,0,0,0,0,-2000,0,2000,-2000,0,0,0,-141000
061383,高股息群益9A購01,0,0,0,0,0,0,0,0,0,-142000,0,0,0,0,142000,-142000,-142000
06090P,旺宏統一97售06  ,0,0,0,0,0,0,0,0,0,-142000,0,0,0,8000,150000,-142000,-142000
053844,GIS統一96購01   ,0,0,0,0,0,0,0,0,0,-142000,0,0,0,0,142000,-142000,-142000
07763P,嘉澤永豐9A售02  ,0,0,0,0,0,0,0,0,0,-142000,0,0,0,0,142000,-142000,-142000
060874,中鋼中信02購01  ,0,0,0,0,0,0,0,0,0,-143000,0,0,0,103000,246000,-143000,-143000
059643,日月光凱基99購02,0,0,0,0,0,0,0,0,0,-143000,0,0,0,1000,144000,-143000,-143000
4190,佐登-KY         ,59000,97000,-38000,0,0,0,0,100000,-100000,-5000,0,0,0,0,5000,-5000,-143000
060596,元黃金凱基9A購02,0,0,0,0,0,0,0,0,0,-144000,0,0,0,0,144000,-144000,-144000
055127,台虹兆豐97購01  ,0,0,0,0,0,0,0,0,0,-144000,0,0,0,9000,153000,-144000,-144000
07710P,華擎元大9A售05  ,0,0,0,0,0,0,0,0,0,-144000,0,0,0,227000,371000,-144000,-144000
07612P,國巨國泰9B售06  ,0,0,0,0,0,0,0,0,0,-144000,0,0,0,56000,200000,-144000,-144000
058134,信邦元大99購01  ,0,0,0,0,0,0,0,0,0,-145000,0,0,0,7000,152000,-145000,-145000
6209,今國光          ,57000,200000,-143000,0,0,0,0,0,0,-2000,0,2000,-2000,0,0,0,-145000
6452,康友-KY         ,99000,181000,-82000,0,0,0,0,0,0,-63000,0,0,0,0,63000,-63000,-145000
060218,台積電凱基9A購15,0,0,0,0,0,0,0,0,0,-146000,0,0,0,0,146000,-146000,-146000
061154,可成群益9B購04  ,0,0,0,0,0,0,0,0,0,-146000,0,0,0,0,146000,-146000,-146000
061646,力成元大9A購02  ,0,0,0,0,0,0,0,0,0,-146000,0,0,0,174000,320000,-146000,-146000
2929,淘帝-KY         ,122000,277320,-155320,0,0,0,0,0,0,9000,0,0,0,13000,4000,9000,-146320
059922,大立光元大99購25,0,0,0,0,0,0,0,0,0,-147000,0,0,0,118000,265000,-147000,-147000
059872,華新科凱基01購01,0,0,0,0,0,0,0,0,0,-147000,0,0,0,91000,238000,-147000,-147000
047004,台積電統一99購01,0,0,0,0,0,0,0,0,0,-147000,0,0,0,5000,152000,-147000,-147000
2707,晶華            ,17000,364000,-347000,0,0,0,200000,0,200000,0,0,0,0,0,0,0,-147000
058783,臺股指國票99購02,0,0,0,0,0,0,0,0,0,-148000,0,0,0,52000,200000,-148000,-148000
2527,宏璟            ,6000,154000,-148000,0,0,0,0,0,0,0,0,0,0,0,0,0,-148000
060718,中磊永豐9A購01  ,0,0,0,0,0,0,0,0,0,-149000,0,0,0,1000,150000,-149000,-149000
052104,英業達兆豐96購01,0,0,0,0,0,0,0,0,0,-149000,0,0,0,5000,154000,-149000,-149000
054757,南亞國票98購01  ,0,0,0,0,0,0,0,0,0,-149000,0,0,0,16000,165000,-149000,-149000
055902,同欣電中信99購01,0,0,0,0,0,0,0,0,0,-149000,0,0,0,138000,287000,-149000,-149000
2535,達欣工          ,1000,166000,-165000,0,0,0,0,0,0,16000,16000,0,16000,0,0,0,-149000
3533,嘉澤            ,252297,156000,96297,0,0,0,0,48000,-48000,-198000,17000,150000,-133000,15000,80000,-65000,-149703
060275,元黃金元大9A購01,0,0,0,0,0,0,0,0,0,-150000,0,0,0,0,150000,-150000,-150000
060031,旭富永豐99購02  ,0,0,0,0,0,0,0,0,0,-150000,0,0,0,30000,180000,-150000,-150000
057207,立積元富98購02  ,0,0,0,0,0,0,0,0,0,-150000,0,0,0,370000,520000,-150000,-150000
5519,隆大            ,41000,191000,-150000,0,0,0,0,0,0,0,0,0,0,0,0,0,-150000
060077,台積電台新9B購01,0,0,0,0,0,0,0,0,0,-151000,0,0,0,0,151000,-151000,-151000
059814,SP黃豆凱基9A購02,0,0,0,0,0,0,0,0,0,-151000,0,0,0,2000,153000,-151000,-151000
060397,群創國票9A購01  ,0,0,0,0,0,0,0,0,0,-151000,0,0,0,69000,220000,-151000,-151000
055182,京鼎統一98購01  ,0,0,0,0,0,0,0,0,0,-151000,0,0,0,0,151000,-151000,-151000
047690,美律富邦97購01  ,0,0,0,0,0,0,0,0,0,-151000,0,0,0,0,151000,-151000,-151000
8429,金麗-KY         ,5000,156000,-151000,0,0,0,0,0,0,0,0,0,0,0,0,0,-151000
060949,祥碩中信9A購01  ,0,0,0,0,0,0,0,0,0,-152000,0,0,0,51000,203000,-152000,-152000
061003,南亞科兆豐9A購01,0,0,0,0,0,0,0,0,0,-152000,0,0,0,6000,158000,-152000,-152000
054768,泰碩國票99購02  ,0,0,0,0,0,0,0,0,0,-152000,0,0,0,11000,163000,-152000,-152000
057286,群創元大9B購05  ,0,0,0,0,0,0,0,0,0,-152000,0,0,0,0,152000,-152000,-152000
056352,鴻海元大99購01  ,0,0,0,0,0,0,0,0,0,-152000,0,0,0,68000,220000,-152000,-152000
1217,愛之味          ,162000,314000,-152000,0,0,0,0,0,0,0,0,0,0,0,0,0,-152000
2231,為升            ,84000,232000,-148000,0,0,0,0,0,0,-5000,0,0,0,2000,7000,-5000,-153000
061307,和潤永豐9A購02  ,0,0,0,0,0,0,0,0,0,-154000,0,0,0,17000,171000,-154000,-154000
058263,大成鋼永豐99購01,0,0,0,0,0,0,0,0,0,-154000,0,0,0,0,154000,-154000,-154000
05570P,聯發科統一96售04,0,0,0,0,0,0,0,0,0,-154000,0,0,0,0,154000,-154000,-154000
058929,可成統一9C購01  ,0,0,0,0,0,0,0,0,0,-154000,0,0,0,57000,211000,-154000,-154000
3059,華晶科          ,67000,219000,-152000,0,0,0,0,0,0,-2000,0,2000,-2000,0,0,0,-154000
054720,禾伸堂永豐97購01,0,0,0,0,0,0,0,0,0,-155000,0,0,0,3000,158000,-155000,-155000
057717,友訊元富98購02  ,0,0,0,0,0,0,0,0,0,-155000,0,0,0,432000,587000,-155000,-155000
05930P,景碩康和96售01  ,0,0,0,0,0,0,0,0,0,-155000,0,0,0,185000,340000,-155000,-155000
2388,威盛            ,331000,486000,-155000,0,0,0,0,0,0,0,0,0,0,0,0,0,-155000
3605,宏致            ,145000,299000,-154000,0,0,0,0,0,0,-1000,0,1000,-1000,0,0,0,-155000
061609,華新科統一9C購01,0,0,0,0,0,0,0,0,0,-156000,0,0,0,4000,160000,-156000,-156000
00757,統一FANG+       ,0,0,0,0,0,0,0,0,0,-156000,0,0,0,200000,356000,-156000,-156000
059256,臺股指凱基99購34,0,0,0,0,0,0,0,0,0,-156000,0,0,0,200000,356000,-156000,-156000
1339,昭輝            ,6000,162000,-156000,0,0,0,0,0,0,0,0,0,0,0,0,0,-156000
1437,勤益控          ,4000,160000,-156000,0,0,0,0,0,0,0,0,0,0,0,0,0,-156000
060942,智邦國票9A購02  ,0,0,0,0,0,0,0,0,0,-157000,0,0,0,0,157000,-157000,-157000
056705,超眾國泰99購01  ,0,0,0,0,0,0,0,0,0,-157000,0,0,0,68000,225000,-157000,-157000
056183,南亞科統一97購02,0,0,0,0,0,0,0,0,0,-157000,0,0,0,27000,184000,-157000,-157000
058958,台表科國票9A購03,0,0,0,0,0,0,0,0,0,-157000,0,0,0,36000,193000,-157000,-157000
058170,國巨凱基9A購06  ,0,0,0,0,0,0,0,0,0,-157000,0,0,0,35000,192000,-157000,-157000
07174P,臺股指國票99售11,0,0,0,0,0,0,0,0,0,-157000,0,0,0,438000,595000,-157000,-157000
4142,國光生          ,1696000,1888000,-192000,0,0,0,0,0,0,35000,35000,0,35000,0,0,0,-157000
061318,智邦凱基9B購01  ,0,0,0,0,0,0,0,0,0,-159000,0,0,0,0,159000,-159000,-159000
05521P,創意永豐96售01  ,0,0,0,0,0,0,0,0,0,-159000,0,0,0,0,159000,-159000,-159000
057780,台郡群益98購02  ,0,0,0,0,0,0,0,0,0,-159000,0,0,0,276000,435000,-159000,-159000
059290,全新元富99購01  ,0,0,0,0,0,0,0,0,0,-159000,0,0,0,5000,164000,-159000,-159000
061750,台達電台新9B購01,0,0,0,0,0,0,0,0,0,-160000,0,0,0,0,160000,-160000,-160000
060088,國巨元大99購30  ,0,0,0,0,0,0,0,0,0,-160000,0,0,0,0,160000,-160000,-160000
00678,群益NBI生技     ,0,0,0,0,0,0,0,0,0,-160000,0,0,0,300000,460000,-160000,-160000
047769,大立光元大96購01,0,0,0,0,0,0,0,0,0,-160000,0,0,0,0,160000,-160000,-160000
055961,國泰金元大97購01,0,0,0,0,0,0,0,0,0,-160000,0,0,0,0,160000,-160000,-160000
055709,深中小元大97購03,0,0,0,0,0,0,0,0,0,-160000,0,0,0,0,160000,-160000,-160000
6139,亞翔            ,10000,168000,-158000,0,0,0,0,0,0,-2000,0,2000,-2000,0,0,0,-160000
059819,台積電凱基99購17,0,0,0,0,0,0,0,0,0,-161000,0,0,0,0,161000,-161000,-161000
061429,南六元大9A購02  ,0,0,0,0,0,0,0,0,0,-161000,0,0,0,106000,267000,-161000,-161000
055916,奇鋐凱基99購01  ,0,0,0,0,0,0,0,0,0,-161000,0,0,0,181000,342000,-161000,-161000
2020,美亞            ,162000,323000,-161000,0,0,0,0,0,0,0,0,0,0,0,0,0,-161000
1723,中碳            ,20000,178000,-158000,0,0,0,0,0,0,-3000,0,3000,-3000,0,0,0,-161000
1104,環泥            ,5000,161000,-156000,0,0,0,0,0,0,-6000,0,6000,-6000,0,0,0,-162000
07557P,玉晶光元大9A售09,0,0,0,0,0,0,0,0,0,-162000,0,0,0,14000,176000,-162000,-162000
061368,南六國票9A購01  ,0,0,0,0,0,0,0,0,0,-163000,0,0,0,11000,174000,-163000,-163000
060361,南亞科元富9A購03,0,0,0,0,0,0,0,0,0,-163000,0,0,0,10000,173000,-163000,-163000
051193,新日興兆豐96購01,0,0,0,0,0,0,0,0,0,-163000,0,0,0,0,163000,-163000,-163000
056228,可成凱基97購03  ,0,0,0,0,0,0,0,0,0,-163000,0,0,0,10000,173000,-163000,-163000
055675,亞德客凱基97購02,0,0,0,0,0,0,0,0,0,-164000,0,0,0,43000,207000,-164000,-164000
1309,台達化          ,234000,398000,-164000,0,0,0,0,0,0,0,0,0,0,0,0,0,-164000
059841,國巨富邦9C購01  ,0,0,0,0,0,0,0,0,0,-165000,0,0,0,264000,429000,-165000,-165000
058178,國巨國泰9A購02  ,0,0,0,0,0,0,0,0,0,-165000,0,0,0,195000,360000,-165000,-165000
06844P,智邦元大98售13  ,0,0,0,0,0,0,0,0,0,-166000,0,0,0,144000,310000,-166000,-166000
057977,台光電永豐98購02,0,0,0,0,0,0,0,0,0,-166000,0,0,0,29000,195000,-166000,-166000
057063,立積國泰9A購01  ,0,0,0,0,0,0,0,0,0,-166000,0,0,0,11000,177000,-166000,-166000
061731,旺宏統一9B購06  ,0,0,0,0,0,0,0,0,0,-167000,0,0,0,0,167000,-167000,-167000
055525,國巨群益98購05  ,0,0,0,0,0,0,0,0,0,-167000,0,0,0,34000,201000,-167000,-167000
061689,國巨群益9A購12  ,0,0,0,0,0,0,0,0,0,-168000,0,0,0,104000,272000,-168000,-168000
057626,技嘉富邦9A購01  ,0,0,0,0,0,0,0,0,0,-168000,0,0,0,11000,179000,-168000,-168000
2031,新光鋼          ,64000,233000,-169000,0,0,0,0,0,0,0,0,0,0,0,0,0,-169000
061465,聯詠群益9A購01  ,0,0,0,0,0,0,0,0,0,-170000,0,0,0,144000,314000,-170000,-170000
055433,嘉聯益群益99購01,0,0,0,0,0,0,0,0,0,-170000,0,0,0,36000,206000,-170000,-170000
05348P,美律元富98售01  ,0,0,0,0,0,0,0,0,0,-170000,0,0,0,0,170000,-170000,-170000
056102,億光永豐97購02  ,0,0,0,0,0,0,0,0,0,-170000,0,0,0,0,170000,-170000,-170000
056420,台表科元富98購01,0,0,0,0,0,0,0,0,0,-170000,0,0,0,30000,200000,-170000,-170000
058734,康友永豐99購01  ,0,0,0,0,0,0,0,0,0,-170000,0,0,0,0,170000,-170000,-170000
2062,橋椿            ,2000,172000,-170000,0,0,0,0,0,0,0,0,0,0,0,0,0,-170000
2908,特力            ,7000,177000,-170000,0,0,0,0,0,0,0,0,0,0,0,0,0,-170000
07300P,臺股指元大9A售33,0,0,0,0,0,0,0,0,0,-170000,0,0,0,47000,217000,-170000,-170000
059640,聯詠凱基99購04  ,0,0,0,0,0,0,0,0,0,-171000,0,0,0,10000,181000,-171000,-171000
060477,和潤元大9A購01  ,0,0,0,0,0,0,0,0,0,-171000,0,0,0,56000,227000,-171000,-171000
054759,台化國票98購01  ,0,0,0,0,0,0,0,0,0,-171000,0,0,0,264000,435000,-171000,-171000
058786,元黃金元大99購01,0,0,0,0,0,0,0,0,0,-171000,0,0,0,0,171000,-171000,-171000
058411,技嘉兆豐99購01  ,0,0,0,0,0,0,0,0,0,-171000,0,0,0,11000,182000,-171000,-171000
058421,國泰金麥證01購01,0,0,0,89000,260000,-171000,0,0,0,-171000,0,0,0,89000,260000,-171000,-171000
1307,三芳            ,93000,250000,-157000,0,0,0,0,0,0,-14000,0,14000,-14000,0,0,0,-171000
3645,達邁            ,63000,232000,-169000,0,0,0,0,0,0,-2000,0,2000,-2000,0,0,0,-171000
060569,台積電永豐9A購01,0,0,0,0,0,0,0,0,0,-172000,0,0,0,0,172000,-172000,-172000
059913,台積電元大99購44,0,0,0,0,0,0,0,0,0,-172000,0,0,0,15000,187000,-172000,-172000
053505,瑞儀兆豐97購01  ,0,0,0,0,0,0,0,0,0,-172000,0,0,0,51000,223000,-172000,-172000
057700,新日興群益9A購01,0,0,0,0,0,0,0,0,0,-173000,0,0,0,10000,183000,-173000,-173000
00783,富邦中証500     ,8000,422000,-414000,0,0,0,0,0,0,240800,0,0,0,1051000,810200,240800,-173200
060467,神基元大9A購01  ,0,0,0,0,0,0,0,0,0,-174000,0,0,0,76000,250000,-174000,-174000
06456P,聯發科統一98售03,0,0,0,0,0,0,0,0,0,-174000,0,0,0,30000,204000,-174000,-174000
056492,全新國泰9A購01  ,0,0,0,0,0,0,0,0,0,-174000,0,0,0,10000,184000,-174000,-174000
1467,南緯            ,40000,214000,-174000,0,0,0,0,0,0,0,0,0,0,0,0,0,-174000
053173,矽格群益97購01  ,0,0,0,0,0,0,0,0,0,-175000,0,0,0,20000,195000,-175000,-175000
055254,聯詠統一97購03  ,0,0,0,0,0,0,0,0,0,-175000,0,0,0,51000,226000,-175000,-175000
056198,台光電永豐97購02,0,0,0,0,0,0,0,0,0,-175000,0,0,0,233000,408000,-175000,-175000
059831,聯詠康和99購01  ,0,0,0,0,0,0,0,0,0,-176000,0,0,0,30000,206000,-176000,-176000
05052P,友達群益97售01  ,0,0,0,0,0,0,0,0,0,-176000,0,0,0,21000,197000,-176000,-176000
00702,國泰標普低波高息,0,0,0,0,0,0,0,0,0,-177000,0,0,0,19000,196000,-177000,-177000
054673,京鼎國泰98購01  ,0,0,0,0,0,0,0,0,0,-177000,0,0,0,52000,229000,-177000,-177000
059107,南茂國泰9A購01  ,0,0,0,0,0,0,0,0,0,-177000,0,0,0,249000,426000,-177000,-177000
060917,台表科國泰9B購01,0,0,0,0,0,0,0,0,0,-178000,0,0,0,33000,211000,-178000,-178000
06853P,華擎元富98售03  ,0,0,0,0,0,0,0,0,0,-178000,0,0,0,129000,307000,-178000,-178000
057779,禾伸堂群益98購02,0,0,0,0,0,0,0,0,0,-178000,0,0,0,0,178000,-178000,-178000
1308,亞聚            ,265000,423000,-158000,0,0,0,0,0,0,-20000,0,20000,-20000,0,0,0,-178000
1338,廣華-KY         ,36000,214000,-178000,0,0,0,0,0,0,0,0,0,0,0,0,0,-178000
2108,南帝            ,30000,209000,-179000,0,0,0,0,0,0,0,0,0,0,0,0,0,-179000
055235,金寶台新98購01  ,0,0,0,0,0,0,0,0,0,-180000,0,0,0,20000,200000,-180000,-180000
056422,全新統一98購02  ,0,0,0,0,0,0,0,0,0,-180000,0,0,0,79000,259000,-180000,-180000
061492,超眾兆豐9B購01  ,0,0,0,0,0,0,0,0,0,-181000,0,0,0,118000,299000,-181000,-181000
00652,富邦印度        ,12000,309000,-297000,0,0,0,0,0,0,116000,0,0,0,245000,129000,116000,-181000
059083,華通元大99購07  ,0,0,0,0,0,0,0,0,0,-181000,0,0,0,12000,193000,-181000,-181000
059154,可成日盛99購02  ,0,0,0,0,0,0,0,0,0,-181000,0,0,0,20000,201000,-181000,-181000
2425,承啟            ,33000,197000,-164000,0,0,0,0,0,0,-17000,0,17000,-17000,0,0,0,-181000
4526,東台            ,20000,201000,-181000,0,0,0,0,0,0,0,0,0,0,0,0,0,-181000
060226,道瓊反元大9A購01,0,0,0,0,0,0,0,0,0,-182000,0,0,0,96000,278000,-182000,-182000
059086,國巨元大99購18  ,0,0,0,0,0,0,0,0,0,-182000,0,0,0,67000,249000,-182000,-182000
058761,欣興群益99購02  ,0,0,0,0,0,0,0,0,0,-182000,0,0,0,2000,184000,-182000,-182000
2524,京城            ,5000,187000,-182000,0,0,0,0,0,0,0,0,0,0,0,0,0,-182000
2461,光群雷          ,105000,286000,-181000,0,0,0,0,0,0,-2000,0,2000,-2000,0,0,0,-183000
07630P,臺股指凱基9A售11,0,0,0,0,0,0,0,0,0,-183000,0,0,0,274000,457000,-183000,-183000
060323,華通群益9C購01  ,0,0,0,0,0,0,0,0,0,-184000,0,0,0,258000,442000,-184000,-184000
058396,力山元大99購01  ,0,0,0,0,0,0,0,0,0,-184000,0,0,0,67000,251000,-184000,-184000
056946,國巨統一98購05  ,0,0,0,0,0,0,0,0,0,-184000,0,0,0,200000,384000,-184000,-184000
059671,滬深2X元富99購05,0,0,0,0,0,0,0,0,0,-185000,0,0,0,0,185000,-185000,-185000
061448,旺宏中信9A購02  ,0,0,0,0,0,0,0,0,0,-185000,0,0,0,61000,246000,-185000,-185000
055240,京元電元富97購01,0,0,0,0,0,0,0,0,0,-185000,0,0,0,43000,228000,-185000,-185000
053959,晶豪科永豐96購02,0,0,0,0,0,0,0,0,0,-185000,0,0,0,0,185000,-185000,-185000
057539,南茂元大98購02  ,0,0,0,0,0,0,0,0,0,-185000,0,0,0,539000,724000,-185000,-185000
059252,聯詠凱基99購03  ,0,0,0,0,0,0,0,0,0,-185000,0,0,0,34000,219000,-185000,-185000
2457,飛宏            ,128000,311000,-183000,0,0,0,0,0,0,-2000,0,2000,-2000,0,0,0,-185000
2430,燦坤            ,0,183000,-183000,0,0,0,0,0,0,-2000,0,2000,-2000,0,0,0,-185000
060227,和大元大9A購01  ,0,0,0,0,0,0,0,0,0,-187000,0,0,0,117000,304000,-187000,-187000
00660,元大歐洲50      ,0,0,0,0,0,0,0,0,0,-187000,0,0,0,69000,256000,-187000,-187000
1604,聲寶            ,61000,248000,-187000,0,0,0,0,0,0,0,0,0,0,0,0,0,-187000
056715,瀚宇博永豐98購01,0,0,0,0,0,0,0,0,0,-188000,0,0,0,134000,322000,-188000,-188000
056916,台達電兆豐98購02,0,0,0,0,0,0,0,0,0,-188000,0,0,0,32000,220000,-188000,-188000
2107,厚生            ,0,188000,-188000,0,0,0,0,0,0,0,0,0,0,0,0,0,-188000
060657,旺宏統一9B購05  ,0,0,0,0,0,0,0,0,0,-189000,0,0,0,22000,211000,-189000,-189000
060667,力成凱基9A購01  ,0,0,0,0,0,0,0,0,0,-189000,0,0,0,201000,390000,-189000,-189000
052587,景碩永豐97購01  ,0,0,0,0,0,0,0,0,0,-189000,0,0,0,52000,241000,-189000,-189000
060313,淘帝永豐9A購01  ,0,0,0,0,0,0,0,0,0,-190000,0,0,0,120000,310000,-190000,-190000
051897,台光電國泰97購01,0,0,0,0,0,0,0,0,0,-190000,0,0,0,60000,250000,-190000,-190000
057508,康控國票99購03  ,0,0,0,0,0,0,0,0,0,-190000,0,0,0,262000,452000,-190000,-190000
07442P,華航康和9A售02  ,0,0,0,0,0,0,0,0,0,-190000,0,0,0,30000,220000,-190000,-190000
061190,力山永豐9A購02  ,0,0,0,0,0,0,0,0,0,-191000,0,0,0,16000,207000,-191000,-191000
052796,和碩兆豐96購01  ,0,0,0,0,0,0,0,0,0,-191000,0,0,0,3000,194000,-191000,-191000
054354,技嘉富邦97購01  ,0,0,0,0,0,0,0,0,0,-191000,0,0,0,125000,316000,-191000,-191000
3149,正達            ,33000,224000,-191000,0,0,0,0,0,0,0,0,0,0,0,0,0,-191000
061696,南茂群益9A購01  ,0,0,0,0,0,0,0,0,0,-192000,0,0,0,0,192000,-192000,-192000
060704,台積電富邦01購01,0,0,0,0,0,0,0,0,0,-192000,0,0,0,98000,290000,-192000,-192000
053631,欣興兆豐97購01  ,0,0,0,0,0,0,0,0,0,-192000,0,0,0,2000,194000,-192000,-192000
054863,億光群益97購01  ,0,0,0,0,0,0,0,0,0,-192000,0,0,0,79000,271000,-192000,-192000
2328,廣宇            ,141000,333000,-192000,0,0,0,0,0,0,0,0,0,0,0,0,0,-192000
1702,南僑            ,18000,210000,-192000,0,0,0,0,0,0,0,0,0,0,0,0,0,-192000
061336,國巨元大9A購20  ,0,0,0,0,0,0,0,0,0,-193000,0,0,0,22000,215000,-193000,-193000
060696,道瓊反國泰9C購01,0,0,0,0,0,0,0,0,0,-194000,0,0,0,110000,304000,-194000,-194000
055954,南港元大97購02  ,0,0,0,0,0,0,0,0,0,-194000,0,0,0,0,194000,-194000,-194000
1522,堤維西          ,48000,242000,-194000,0,0,0,0,0,0,0,0,0,0,0,0,0,-194000
3062,建漢            ,160000,350000,-190000,0,0,0,0,0,0,-4000,0,4000,-4000,0,0,0,-194000
07506P,中租元大9A售01  ,0,0,0,0,0,0,0,0,0,-194000,0,0,0,16000,210000,-194000,-194000
061042,致新永豐9A購02  ,0,0,0,0,0,0,0,0,0,-195000,0,0,0,110000,305000,-195000,-195000
1507,永大            ,5000,199000,-194000,0,0,0,0,0,0,-1000,0,1000,-1000,0,0,0,-195000
056738,國巨凱基9A購02  ,0,0,0,0,0,0,0,0,0,-196000,0,0,0,10000,206000,-196000,-196000
4532,瑞智            ,21000,217000,-196000,0,0,0,0,0,0,0,0,0,0,0,0,0,-196000
051603,深中小群益99購03,0,0,0,0,0,0,0,0,0,-197000,0,0,0,0,197000,-197000,-197000
055333,晶豪科兆豐97購01,0,0,0,0,0,0,0,0,0,-197000,0,0,0,37000,234000,-197000,-197000
055940,致新群益98購01  ,0,0,0,0,0,0,0,0,0,-197000,0,0,0,356000,553000,-197000,-197000
05859P,台表科國票97售04,0,0,0,0,0,0,0,0,0,-197000,0,0,0,3000,200000,-197000,-197000
4968,立積            ,486000,673000,-187000,0,0,0,0,0,0,-10000,42000,47000,-5000,65000,70000,-5000,-197000
3052,夆典            ,84000,281000,-197000,0,0,0,0,0,0,0,0,0,0,0,0,0,-197000
060347,大立光統一02購01,0,0,0,0,0,0,0,0,0,-198000,0,0,0,59000,257000,-198000,-198000
054371,台積電中信9C購01,0,0,0,0,0,0,0,0,0,-198000,0,0,0,400000,598000,-198000,-198000
054875,群電群益97購01  ,0,0,0,0,0,0,0,0,0,-198000,0,0,0,98000,296000,-198000,-198000
2015,豐興            ,35000,233000,-198000,0,0,0,0,0,0,0,0,0,0,0,0,0,-198000
07368P,國巨凱基99售19  ,0,0,0,0,0,0,0,0,0,-198000,0,0,0,2000,200000,-198000,-198000
060239,國揚元大9C購01  ,0,0,0,0,0,0,0,0,0,-199000,0,0,0,3000,202000,-199000,-199000
061118,GIS富邦9A購01   ,0,0,0,0,0,0,0,0,0,-199000,0,0,0,92000,291000,-199000,-199000
05538P,玉晶光國票97售02,0,0,0,0,0,0,0,0,0,-199000,0,0,0,65000,264000,-199000,-199000
07546P,玉晶光凱基9A售09,0,0,0,0,0,0,0,0,0,-199000,0,0,0,21000,220000,-199000,-199000
061460,FBVIX群益9A購02 ,0,0,0,0,0,0,0,0,0,-200000,0,0,0,0,200000,-200000,-200000
061774,T50反1國票9B購06,0,0,0,0,0,0,0,0,0,-200000,0,0,0,0,200000,-200000,-200000
060735,鴻海統一9C購03  ,0,0,0,0,0,0,0,0,0,-200000,0,0,0,10000,210000,-200000,-200000
060632,可成富邦9B購01  ,0,0,0,0,0,0,0,0,0,-200000,0,0,0,315000,515000,-200000,-200000
054040,中石化元大9C購01,0,0,0,0,0,0,0,0,0,-200000,0,0,0,0,200000,-200000,-200000
053361,友達元富99購01  ,0,0,0,0,0,0,0,0,0,-200000,0,0,0,0,200000,-200000,-200000
054690,新興永豐97購01  ,0,0,0,0,0,0,0,0,0,-200000,0,0,0,0,200000,-200000,-200000
052366,聯詠國票96購01  ,0,0,0,0,0,0,0,0,0,-200000,0,0,0,0,200000,-200000,-200000
020016,統一MSCI美科技N ,0,0,0,0,0,0,0,0,0,-200000,0,0,0,1000,201000,-200000,-200000
04630P,嘉聯益元大95售02,0,0,0,0,0,0,0,0,0,-200000,0,0,0,0,200000,-200000,-200000
05882P,華新科永豐96售01,0,0,0,0,0,0,0,0,0,-200000,0,0,0,0,200000,-200000,-200000
056297,台光電元大97購04,0,0,0,0,0,0,0,0,0,-200000,0,0,0,120000,320000,-200000,-200000
07391P,台灣50國泰02售01,0,0,0,0,0,0,0,0,0,-201000,0,0,0,40000,241000,-201000,-201000
061001,智邦兆豐9B購01  ,0,0,0,0,0,0,0,0,0,-202000,0,0,0,199000,401000,-202000,-202000
057267,康控兆豐99購01  ,0,0,0,0,0,0,0,0,0,-202000,0,0,0,128000,330000,-202000,-202000
055723,康控元大97購04  ,0,0,0,0,0,0,0,0,0,-203000,0,0,0,68000,271000,-203000,-203000
060392,華擎群益9C購02  ,0,0,0,0,0,0,0,0,0,-204000,0,0,0,500000,704000,-204000,-204000
054693,神基永豐97購01  ,0,0,0,0,0,0,0,0,0,-204000,0,0,0,0,204000,-204000,-204000
057437,可成國票99購01  ,0,0,0,0,0,0,0,0,0,-204000,0,0,0,0,204000,-204000,-204000
060649,國巨第一9A購01  ,0,0,0,0,0,0,0,0,0,-205000,0,0,0,204000,409000,-205000,-205000
059943,信邦永豐99購01  ,0,0,0,0,0,0,0,0,0,-205000,0,0,0,0,205000,-205000,-205000
054970,帆宣元大97購01  ,0,0,0,0,0,0,0,0,0,-205000,0,0,0,114000,319000,-205000,-205000
052269,T50反1日盛9B購01,0,0,0,0,0,0,0,0,0,-206000,0,0,0,5000,211000,-206000,-206000
2913,農林            ,25000,231000,-206000,0,0,0,0,0,0,0,0,0,0,0,0,0,-206000
2417,圓剛            ,258000,462000,-204000,0,0,0,0,0,0,-2000,0,2000,-2000,0,0,0,-206000
061241,晶技兆豐9A購01  ,0,0,0,0,0,0,0,0,0,-207000,0,0,0,15000,222000,-207000,-207000
05242P,群創國泰97售01  ,0,0,0,0,0,0,0,0,0,-207000,0,0,0,5000,212000,-207000,-207000
1709,和益            ,49000,256000,-207000,0,0,0,0,0,0,0,0,0,0,0,0,0,-207000
07255P,國巨凱基99售15  ,0,0,0,0,0,0,0,0,0,-207000,0,0,0,141000,348000,-207000,-207000
060907,金像電元大9A購02,0,0,0,0,0,0,0,0,0,-208000,0,0,0,248000,456000,-208000,-208000
07421P,國泰金元大99售01,0,0,0,0,0,0,0,0,0,-208000,0,0,0,3000,211000,-208000,-208000
05977P,旺宏永豐96售06  ,0,0,0,0,0,0,0,0,0,-209000,0,0,0,26000,235000,-209000,-209000
054059,欣興國票97購03  ,0,0,0,0,0,0,0,0,0,-209000,0,0,0,159000,368000,-209000,-209000
05625P,國巨國票97售01  ,0,0,0,0,0,0,0,0,0,-209000,0,0,0,220000,429000,-209000,-209000
061297,台積電富邦9C購09,0,0,0,0,0,0,0,0,0,-210000,0,0,0,27000,237000,-210000,-210000
054033,欣興中信96購02  ,0,0,0,0,0,0,0,0,0,-210000,0,0,0,10000,220000,-210000,-210000
060988,華新科元大9A購12,0,0,0,0,0,0,0,0,0,-211000,0,0,0,50000,261000,-211000,-211000
1712,興農            ,33000,244000,-211000,0,0,0,0,0,0,0,0,0,0,0,0,0,-211000
061625,聯茂群益9A購02  ,0,0,0,0,0,0,0,0,0,-212000,0,0,0,143000,355000,-212000,-212000
061360,智邦兆豐9B購02  ,0,0,0,0,0,0,0,0,0,-213000,0,0,0,22000,235000,-213000,-213000
3413,京鼎            ,509000,549000,-40000,0,0,0,0,0,0,-173000,0,135000,-135000,38000,76000,-38000,-213000
053107,旺宏兆豐97購01  ,0,0,0,0,0,0,0,0,0,-214000,0,0,0,10000,224000,-214000,-214000
061366,台勝科國票9A購01,0,0,0,0,0,0,0,0,0,-215000,0,0,0,553000,768000,-215000,-215000
061085,聯茂兆豐9A購01  ,0,0,0,0,0,0,0,0,0,-215000,0,0,0,87000,302000,-215000,-215000
054097,淘帝國票97購01  ,0,0,0,0,0,0,0,0,0,-215000,0,0,0,0,215000,-215000,-215000
056991,牧德兆豐98購01  ,0,0,0,0,0,0,0,0,0,-215000,0,0,0,48000,263000,-215000,-215000
1806,冠軍            ,5000,220000,-215000,0,0,0,0,0,0,0,0,0,0,0,0,0,-215000
3004,豐達科          ,36000,251000,-215000,0,0,0,0,0,0,0,0,0,0,0,0,0,-215000
3443,創意            ,169000,325000,-156000,0,0,0,0,0,0,-60000,8000,20000,-12000,2000,50000,-48000,-216000
059618,台積電日盛99購01,0,0,0,0,0,0,0,0,0,-217000,0,0,0,132000,349000,-217000,-217000
2395,研華            ,537500,731777,-194277,0,0,0,2000,20000,-18000,-5000,0,5000,-5000,0,0,0,-217277
061687,大成鋼群益9A購01,0,0,0,0,0,0,0,0,0,-218000,0,0,0,0,218000,-218000,-218000
057609,友訊元富98購01  ,0,0,0,0,0,0,0,0,0,-218000,0,0,0,560000,778000,-218000,-218000
05707P,中磊永豐96售01  ,0,0,0,0,0,0,0,0,0,-218000,0,0,0,55000,273000,-218000,-218000
2401,凌陽            ,98000,336000,-238000,0,0,0,0,0,0,20000,30000,10000,20000,0,0,0,-218000
3704,合勤控          ,171000,360000,-189000,0,0,0,0,0,0,-29000,0,4000,-4000,0,25000,-25000,-218000
061462,國巨群益9A購11  ,0,0,0,0,0,0,0,0,0,-219000,0,0,0,439000,658000,-219000,-219000
053409,和碩兆豐96購02  ,0,0,0,0,0,0,0,0,0,-219000,0,0,0,19000,238000,-219000,-219000
056241,緯創群益97購01  ,0,0,0,0,0,0,0,0,0,-219000,0,0,0,130000,349000,-219000,-219000
055744,茂林元富97購02  ,0,0,0,0,0,0,0,0,0,-220000,0,0,0,50000,270000,-220000,-220000
058225,旺宏元富99購01  ,0,0,0,0,0,0,0,0,0,-221000,0,0,0,24000,245000,-221000,-221000
6120,達運            ,119000,334000,-215000,0,0,0,0,0,0,-6000,0,6000,-6000,0,0,0,-221000
057718,旺宏元富02購02  ,0,0,0,0,0,0,0,0,0,-222000,0,0,0,8000,230000,-222000,-222000
1762,中化生          ,230000,443000,-213000,0,0,0,0,0,0,-9000,0,9000,-9000,0,0,0,-222000
1514,亞力            ,82000,304000,-222000,0,0,0,0,0,0,0,0,0,0,0,0,0,-222000
07006P,旺宏統一9B售03  ,0,0,0,0,0,0,0,0,0,-223000,0,0,0,100000,323000,-223000,-223000
07520P,臺股指元大9B售11,0,0,0,0,0,0,0,0,0,-223000,0,0,0,153000,376000,-223000,-223000
060698,旺宏國泰9C購01  ,0,0,0,0,0,0,0,0,0,-224000,0,0,0,241000,465000,-224000,-224000
055334,禾伸堂兆豐97購01,0,0,0,0,0,0,0,0,0,-224000,0,0,0,1000,225000,-224000,-224000
6285,啟碁            ,96000,329000,-233000,0,0,0,0,0,0,9000,24000,10000,14000,0,5000,-5000,-224000
06042P,華新科永豐96售04,0,0,0,0,0,0,0,0,0,-225000,0,0,0,110000,335000,-225000,-225000
8463,潤泰材          ,29000,255000,-226000,0,0,0,0,0,0,0,0,0,0,0,0,0,-226000
060977,亞德客元大9A購04,0,0,0,0,0,0,0,0,0,-227000,0,0,0,143000,370000,-227000,-227000
053919,可成國票97購02  ,0,0,0,0,0,0,0,0,0,-227000,0,0,0,0,227000,-227000,-227000
5434,崇越            ,97952,310000,-212048,0,0,0,1000,0,1000,-16000,5000,0,5000,0,21000,-21000,-227048
061428,南六元大9A購01  ,0,0,0,0,0,0,0,0,0,-228000,0,0,0,9000,237000,-228000,-228000
056847,佐登元富98購01  ,0,0,0,0,0,0,0,0,0,-228000,0,0,0,50000,278000,-228000,-228000
058380,臺股指凱基99購15,0,0,0,0,0,0,0,0,0,-228000,0,0,0,0,228000,-228000,-228000
060789,禾伸堂富邦9B購02,0,0,0,0,0,0,0,0,0,-229000,0,0,0,5000,234000,-229000,-229000
059882,臺股指凱基9C購06,0,0,0,0,0,0,0,0,0,-229000,0,0,0,195000,424000,-229000,-229000
059097,世紀鋼元大99購05,0,0,0,0,0,0,0,0,0,-229000,0,0,0,109000,338000,-229000,-229000
057573,京鼎永豐98購02  ,0,0,0,0,0,0,0,0,0,-229000,0,0,0,65000,294000,-229000,-229000
4967,十銓            ,346000,574000,-228000,0,0,0,0,0,0,-1000,0,1000,-1000,0,0,0,-229000
060885,世紀鋼中信9A購01,0,0,0,0,0,0,0,0,0,-230000,0,0,0,0,230000,-230000,-230000
061378,南六永豐9A購03  ,0,0,0,0,0,0,0,0,0,-230000,0,0,0,271000,501000,-230000,-230000
052626,上証2X中信9A購01,0,0,0,0,0,0,0,0,0,-230000,0,0,0,0,230000,-230000,-230000
056926,日月光兆豐98購01,0,0,0,0,0,0,0,0,0,-230000,0,0,0,10000,240000,-230000,-230000
07595P,台灣50中信03售07,0,0,0,0,0,0,0,0,0,-230000,0,0,0,0,230000,-230000,-230000
058207,南茂凱基99購01  ,0,0,0,0,0,0,0,0,0,-231000,0,0,0,30000,261000,-231000,-231000
1519,華城            ,32000,265000,-233000,0,0,0,0,0,0,1000,1000,0,1000,0,0,0,-232000
061164,燿華兆豐9B購01  ,0,0,0,0,0,0,0,0,0,-233000,0,0,0,202000,435000,-233000,-233000
061656,華新科國票9A購08,0,0,0,0,0,0,0,0,0,-233000,0,0,0,5000,238000,-233000,-233000
060886,國巨統一01購03  ,0,0,0,0,0,0,0,0,0,-233000,0,0,0,2000,235000,-233000,-233000
057650,力成元大98購04  ,0,0,0,0,0,0,0,0,0,-233000,0,0,0,0,233000,-233000,-233000
4306,炎洲            ,51000,285000,-234000,0,0,0,0,0,0,1000,8000,7000,1000,0,0,0,-233000
6024,群益期          ,28000,262000,-234000,0,0,0,0,0,0,0,0,0,0,0,0,0,-234000
056286,奇鋐永豐97購01  ,0,0,0,0,0,0,0,0,0,-235000,0,0,0,79000,314000,-235000,-235000
2010,春源            ,18000,253000,-235000,0,0,0,0,0,0,0,0,0,0,0,0,0,-235000
07730P,臺股指凱基9A售22,0,0,0,0,0,0,0,0,0,-235000,0,0,0,19000,254000,-235000,-235000
06529P,貿聯富邦99售03  ,0,0,0,0,0,0,0,0,0,-236000,0,0,0,0,236000,-236000,-236000
054913,億光凱基97購01  ,0,0,0,0,0,0,0,0,0,-238000,0,0,0,0,238000,-238000,-238000
2850,新產            ,8000,347000,-339000,0,0,0,0,0,0,100000,100000,0,100000,0,0,0,-239000
4720,德淵            ,75000,314000,-239000,0,0,0,0,0,0,0,0,0,0,0,0,0,-239000
056083,億光統一97購03  ,0,0,0,0,0,0,0,0,0,-240000,0,0,0,133000,373000,-240000,-240000
057729,華新科國泰99購04,0,0,0,0,0,0,0,0,0,-240000,0,0,0,10000,250000,-240000,-240000
8131,福懋科          ,27000,264000,-237000,0,0,0,0,0,0,-3000,0,3000,-3000,0,0,0,-240000
058736,鈺齊永豐99購02  ,0,0,0,0,0,0,0,0,0,-241000,0,0,0,0,241000,-241000,-241000
1736,喬山            ,634000,853000,-219000,0,0,0,40000,0,40000,-62000,20000,3000,17000,119000,198000,-79000,-241000
2208,台船            ,205000,446000,-241000,0,0,0,0,0,0,0,0,0,0,0,0,0,-241000
06954P,大立光元富99售01,0,0,0,0,0,0,0,0,0,-242000,0,0,0,155000,397000,-242000,-242000
056391,大立光富邦9C購01,0,0,0,0,0,0,0,0,0,-242000,0,0,0,0,242000,-242000,-242000
061647,南六元大9A購03  ,0,0,0,0,0,0,0,0,0,-243000,0,0,0,0,243000,-243000,-243000
060370,滬深2X元富04購01,0,0,0,0,0,0,0,0,0,-243000,0,0,0,0,243000,-243000,-243000
060381,元黃金凱基9A購01,0,0,0,0,0,0,0,0,0,-243000,0,0,0,37000,280000,-243000,-243000
6141,柏承            ,329000,568000,-239000,0,0,0,0,0,0,-4000,0,4000,-4000,0,0,0,-243000
6166,凌華            ,28000,266000,-238000,0,0,0,0,0,0,-5000,0,0,0,0,5000,-5000,-243000
3019,亞光            ,405000,600000,-195000,0,0,0,0,0,0,-49000,56000,59000,-3000,1000,47000,-46000,-244000
2441,超豐            ,51000,298000,-247000,0,0,0,0,0,0,3000,7000,4000,3000,0,0,0,-244000
052727,仁寶元富96購01  ,0,0,0,0,0,0,0,0,0,-245000,0,0,0,164000,409000,-245000,-245000
057940,和大國票99購01  ,0,0,0,0,0,0,0,0,0,-245000,0,0,0,80000,325000,-245000,-245000
055814,晶豪科國票97購02,0,0,0,0,0,0,0,0,0,-246000,0,0,0,85000,331000,-246000,-246000
061087,國巨統一01購04  ,0,0,0,0,0,0,0,0,0,-247000,0,0,0,230000,477000,-247000,-247000
057705,臺股指群益98購05,0,0,0,0,0,0,0,0,0,-248000,0,0,0,26000,274000,-248000,-248000
055561,奇鋐凱基97購01  ,0,0,0,0,0,0,0,0,0,-248000,0,0,0,80000,328000,-248000,-248000
057332,旺宏國票99購03  ,0,0,0,0,0,0,0,0,0,-248000,0,0,0,50000,298000,-248000,-248000
057260,微星兆豐98購01  ,0,0,0,0,0,0,0,0,0,-248000,0,0,0,2000,250000,-248000,-248000
2369,菱生            ,276000,521000,-245000,0,0,0,0,0,0,-3000,0,3000,-3000,0,0,0,-248000
3535,晶彩科          ,83000,331000,-248000,0,0,0,0,0,0,0,1000,1000,0,0,0,0,-248000
061489,高鐵兆豐9A購01  ,0,0,0,0,0,0,0,0,0,-250000,0,0,0,0,250000,-250000,-250000
060761,南亞科元大9A購05,0,0,0,0,0,0,0,0,0,-250000,0,0,0,5000,255000,-250000,-250000
055296,康舒元大97購02  ,0,0,0,0,0,0,0,0,0,-250000,0,0,0,0,250000,-250000,-250000
058126,元油2X元大9C購02,0,0,0,0,0,0,0,0,0,-250000,0,0,0,50000,300000,-250000,-250000
6443,元晶            ,31000,281000,-250000,0,0,0,0,0,0,0,0,0,0,0,0,0,-250000
2520,冠德            ,197000,733000,-536000,0,0,0,0,0,0,286000,287000,1000,286000,0,0,0,-250000
05535P,台積電元大97售06,0,0,0,0,0,0,0,0,0,-252000,0,0,0,0,252000,-252000,-252000
07652P,臺股指中信9A售07,0,0,0,0,0,0,0,0,0,-252000,0,0,0,100000,352000,-252000,-252000
061192,奇鋐永豐9A購01  ,0,0,0,0,0,0,0,0,0,-253000,0,0,0,41000,294000,-253000,-253000
061032,金像電永豐9A購03,0,0,0,0,0,0,0,0,0,-253000,0,0,0,182000,435000,-253000,-253000
058139,臻鼎元大99購01  ,0,0,0,0,0,0,0,0,0,-253000,0,0,0,85000,338000,-253000,-253000
057730,聯鈞國泰9A購01  ,0,0,0,0,0,0,0,0,0,-253000,0,0,0,120000,373000,-253000,-253000
8163,達方            ,229000,449000,-220000,0,0,0,0,0,0,-33000,8000,4000,4000,3000,40000,-37000,-253000
00693U,街口S&P黃豆     ,80000,8000,72000,0,0,0,0,0,0,-326000,0,0,0,212000,538000,-326000,-254000
061151,友訊群益9A購01  ,0,0,0,0,0,0,0,0,0,-255000,0,0,0,206000,461000,-255000,-255000
057997,旺宏第一9C購01  ,0,0,0,0,0,0,0,0,0,-256000,0,0,0,73000,329000,-256000,-256000
061552,南六群益9A購02  ,0,0,0,0,0,0,0,0,0,-258000,0,0,0,5000,263000,-258000,-258000
060855,華新科富邦01購01,0,0,0,0,0,0,0,0,0,-258000,0,0,0,0,258000,-258000,-258000
055755,禾伸堂兆豐97購02,0,0,0,0,0,0,0,0,0,-258000,0,0,0,0,258000,-258000,-258000
057038,元油2X元大9B購06,0,0,0,0,0,0,0,0,0,-259000,0,0,0,0,259000,-259000,-259000
061477,晶豪科元大9A購01,0,0,0,0,0,0,0,0,0,-260000,0,0,0,261000,521000,-260000,-260000
2442,新美齊          ,76000,333000,-257000,0,0,0,0,0,0,-3000,0,3000,-3000,0,0,0,-260000
2420,新巨            ,40000,299000,-259000,0,0,0,0,0,0,-1000,0,1000,-1000,0,0,0,-260000
058282,聯茂中信99購01  ,0,0,0,0,0,0,0,0,0,-263000,0,0,0,0,263000,-263000,-263000
8105,凌巨            ,83000,347000,-264000,0,0,0,0,0,0,0,0,0,0,0,0,0,-264000
053297,鎧勝中信98購01  ,0,0,0,0,0,0,0,0,0,-265000,0,0,0,20000,285000,-265000,-265000
1532,勤美            ,8000,273000,-265000,0,0,0,0,0,0,0,0,0,0,0,0,0,-265000
054358,矽創兆豐96購01  ,0,0,0,0,0,0,0,0,0,-267000,0,0,0,29000,296000,-267000,-267000
4919,新唐            ,162000,400000,-238000,0,0,0,0,0,0,-29000,0,2000,-2000,0,27000,-27000,-267000
060744,鴻海國票9A購04  ,0,0,0,0,0,0,0,0,0,-268000,0,0,0,36000,304000,-268000,-268000
2034,允強            ,3000,272000,-269000,0,0,0,0,0,0,0,0,0,0,0,0,0,-269000
052941,康控兆豐97購01  ,0,0,0,0,0,0,0,0,0,-270000,0,0,0,0,270000,-270000,-270000
057071,華擎永豐98購02  ,0,0,0,0,0,0,0,0,0,-270000,0,0,0,34000,304000,-270000,-270000
059875,信邦凱基99購02  ,0,0,0,0,0,0,0,0,0,-272000,0,0,0,18000,290000,-272000,-272000
051842,大成鋼富邦97購01,0,0,0,0,0,0,0,0,0,-272000,0,0,0,0,272000,-272000,-272000
052135,聯發科凱基9B購01,0,0,0,0,0,0,0,0,0,-275000,0,0,0,0,275000,-275000,-275000
060391,華擎群益9C購01  ,0,0,0,0,0,0,0,0,0,-276000,0,0,0,0,276000,-276000,-276000
07634P,金像電元大9A售01,0,0,0,0,0,0,0,0,0,-276000,0,0,0,150000,426000,-276000,-276000
8011,台通            ,251000,526000,-275000,0,0,0,0,0,0,-1000,0,1000,-1000,0,0,0,-276000
2351,順德            ,39000,315000,-276000,0,0,0,0,0,0,-1000,0,1000,-1000,0,0,0,-277000
057328,京鼎群益99購02  ,0,0,0,0,0,0,0,0,0,-278000,0,0,0,199000,477000,-278000,-278000
1608,華榮            ,4000,282000,-278000,0,0,0,0,0,0,0,0,0,0,0,0,0,-278000
060299,友訊國泰9B購01  ,0,0,0,0,0,0,0,0,0,-280000,0,0,0,490000,770000,-280000,-280000
056638,臺股指日盛98購01,0,0,0,0,0,0,0,0,0,-280000,0,0,0,1000,281000,-280000,-280000
8215,明基材          ,110000,387000,-277000,0,0,0,0,0,0,-3000,0,3000,-3000,0,0,0,-280000
061611,南六統一01購01  ,0,0,0,0,0,0,0,0,0,-281000,0,0,0,3000,284000,-281000,-281000
2331,精英            ,19000,306000,-287000,0,0,0,0,0,0,6000,10000,4000,6000,0,0,0,-281000
059281,創意永豐99購02  ,0,0,0,0,0,0,0,0,0,-282000,0,0,0,70000,352000,-282000,-282000
4564,元翎            ,47000,318000,-271000,0,0,0,0,0,0,-11000,0,0,0,0,11000,-11000,-282000
059139,全新兆豐9A購01  ,0,0,0,0,0,0,0,0,0,-283000,0,0,0,0,283000,-283000,-283000
058645,康控富邦01購01  ,0,0,0,0,0,0,0,0,0,-284000,0,0,0,368000,652000,-284000,-284000
9934,成霖            ,0,284000,-284000,0,0,0,0,0,0,-1000,0,1000,-1000,0,0,0,-285000
061134,大成鋼統一9C購01,0,0,0,0,0,0,0,0,0,-287000,0,0,0,0,287000,-287000,-287000
061681,南電元大9A購08  ,0,0,0,0,0,0,0,0,0,-289000,0,0,0,0,289000,-289000,-289000
9944,新麗            ,594000,883000,-289000,0,0,0,0,0,0,0,0,0,0,0,0,0,-289000
060962,義隆凱基9B購01  ,0,0,0,0,0,0,0,0,0,-291000,0,0,0,149000,440000,-291000,-291000
1513,中興電          ,28000,319000,-291000,0,0,0,0,0,0,0,0,0,0,0,0,0,-291000
00665L,富邦恒生國企正2 ,0,0,0,0,0,0,0,0,0,-293000,0,0,0,112000,405000,-293000,-293000
1731,美吾華          ,172000,466000,-294000,0,0,0,0,0,0,0,0,0,0,0,0,0,-294000
3338,泰碩            ,372000,503000,-131000,0,0,0,0,175000,-175000,12000,2000,62000,-60000,81000,9000,72000,-294000
060819,國巨統一9C購04  ,0,0,0,0,0,0,0,0,0,-295000,0,0,0,228000,523000,-295000,-295000
07863P,華新科凱基9B售07,0,0,0,0,0,0,0,0,0,-295000,0,0,0,0,295000,-295000,-295000
058143,瑞儀元大99購02  ,0,0,0,0,0,0,0,0,0,-296000,0,0,0,208000,504000,-296000,-296000
2617,台航            ,32000,329000,-297000,0,0,0,0,0,0,0,0,0,0,0,0,0,-297000
03875P,滬深2X國票05售01,0,0,0,0,0,0,0,0,0,-299000,0,0,0,0,299000,-299000,-299000
060564,南亞科富邦9C購01,0,0,0,0,0,0,0,0,0,-300000,0,0,0,0,300000,-300000,-300000
059676,台積電台新99購05,0,0,0,0,0,0,0,0,0,-300000,0,0,0,0,300000,-300000,-300000
061590,金寶永豐9A購01  ,0,0,0,0,0,0,0,0,0,-300000,0,0,0,247000,547000,-300000,-300000
05926P,智易永豐96售02  ,0,0,0,0,0,0,0,0,0,-300000,0,0,0,0,300000,-300000,-300000
057835,華擎元富9B購01  ,0,0,0,0,0,0,0,0,0,-300000,0,0,0,184000,484000,-300000,-300000
057393,台積電中信02購01,0,0,0,0,0,0,0,0,0,-300000,0,0,0,0,300000,-300000,-300000
2402,毅嘉            ,116000,412000,-296000,0,0,0,0,0,0,-4000,0,4000,-4000,0,0,0,-300000
00675L,富邦臺灣加權正2 ,0,0,0,0,0,0,0,0,0,-302000,0,0,0,199000,501000,-302000,-302000
061452,大成鋼凱基9A購01,0,0,0,0,0,0,0,0,0,-303000,0,0,0,132000,435000,-303000,-303000
00668,國泰美國道瓊    ,5000,31000,-26000,0,0,0,0,0,0,-277000,0,0,0,25000,302000,-277000,-303000
07782P,寶成凱基9A售02  ,0,0,0,0,0,0,0,0,0,-304000,0,0,0,10000,314000,-304000,-304000
054351,華新科國泰97購03,0,0,0,0,0,0,0,0,0,-305000,0,0,0,3000,308000,-305000,-305000
057112,立積群益99購01  ,0,0,0,0,0,0,0,0,0,-305000,0,0,0,246000,551000,-305000,-305000
054546,玉晶光中信9B購01,0,0,0,0,0,0,0,0,0,-308000,0,0,0,576000,884000,-308000,-308000
2405,浩鑫            ,14000,323000,-309000,0,0,0,0,0,0,0,0,0,0,0,0,0,-309000
3047,訊舟            ,77000,386000,-309000,0,0,0,0,0,0,-1000,1000,2000,-1000,0,0,0,-310000
07563P,台灣50中信04售01,0,0,0,0,0,0,0,0,0,-311000,0,0,0,0,311000,-311000,-311000
061639,晶豪科元大9A購02,0,0,0,0,0,0,0,0,0,-312000,0,0,0,77000,389000,-312000,-312000
059992,S&P正2元富9B購04,0,0,0,0,0,0,0,0,0,-312000,0,0,0,0,312000,-312000,-312000
058379,臺股指凱基99購14,0,0,0,0,0,0,0,0,0,-313000,0,0,0,0,313000,-313000,-313000
061585,台積電富邦9B購06,0,0,0,0,0,0,0,0,0,-314000,0,0,0,0,314000,-314000,-314000
054567,拓凱群益98購01  ,0,0,0,0,0,0,0,0,0,-314000,0,0,0,585000,899000,-314000,-314000
058559,華新科日盛99購02,0,0,0,0,0,0,0,0,0,-314000,0,0,0,7000,321000,-314000,-314000
058613,茂林元大99購03  ,0,0,0,0,0,0,0,0,0,-318000,0,0,0,47000,365000,-318000,-318000
055775,友達凱基9A購01  ,0,0,0,0,0,0,0,0,0,-318000,0,0,0,7000,325000,-318000,-318000
059937,旺宏永豐99購03  ,0,0,0,0,0,0,0,0,0,-319000,0,0,0,102000,421000,-319000,-319000
1227,佳格            ,671000,1002000,-331000,0,0,0,0,8000,-8000,20000,22000,2000,20000,0,0,0,-319000
057324,億光群益98購01  ,0,0,0,0,0,0,0,0,0,-321000,0,0,0,67000,388000,-321000,-321000
5388,中磊            ,261000,327000,-66000,0,0,0,0,0,0,-255000,3000,241000,-238000,10000,27000,-17000,-321000
055583,國巨元大97購10  ,0,0,0,0,0,0,0,0,0,-322000,0,0,0,32000,354000,-322000,-322000
2392,正崴            ,432000,659000,-227000,0,0,0,0,0,0,-96000,4000,106000,-102000,13000,7000,6000,-323000
060106,旭富元大99購02  ,0,0,0,0,0,0,0,0,0,-324000,0,0,0,41000,365000,-324000,-324000
3056,總太            ,61000,385000,-324000,0,0,0,0,0,0,0,0,0,0,0,0,0,-324000
059961,T50反1凱基99購09,0,0,0,0,0,0,0,0,0,-325000,0,0,0,650000,975000,-325000,-325000
055063,玉晶光永豐99購01,0,0,0,0,0,0,0,0,0,-326000,0,0,0,320000,646000,-326000,-326000
07172P,臺股指國票99售09,0,0,0,0,0,0,0,0,0,-326000,0,0,0,261000,587000,-326000,-326000
061683,台灣50群益9B購09,0,0,0,0,0,0,0,0,0,-327000,0,0,0,0,327000,-327000,-327000
053671,可成統一96購03  ,0,0,0,0,0,0,0,0,0,-327000,0,0,0,0,327000,-327000,-327000
050183,奇鋐元大96購01  ,0,0,0,0,0,0,0,0,0,-330000,0,0,0,250000,580000,-330000,-330000
058732,矽格永豐99購01  ,0,0,0,0,0,0,0,0,0,-331000,0,0,0,91000,422000,-331000,-331000
07649P,金像電永豐9A售02,0,0,0,0,0,0,0,0,0,-332000,0,0,0,24000,356000,-332000,-332000
060254,世紀鋼元大9A購01,0,0,0,0,0,0,0,0,0,-334000,0,0,0,66000,400000,-334000,-334000
1229,聯華            ,472000,944000,-472000,0,0,0,0,0,0,138000,138000,0,138000,0,0,0,-334000
5471,松翰            ,296000,754000,-458000,0,0,0,0,0,0,124000,125000,1000,124000,0,0,0,-334000
054356,可成兆豐97購01  ,0,0,0,0,0,0,0,0,0,-335000,0,0,0,0,335000,-335000,-335000
058180,華新科國泰9A購01,0,0,0,0,0,0,0,0,0,-335000,0,0,0,197000,532000,-335000,-335000
07715P,台灣50群益9A售14,0,0,0,0,0,0,0,0,0,-335000,0,0,0,79000,414000,-335000,-335000
058950,國巨群益99購06  ,0,0,0,0,0,0,0,0,0,-336000,0,0,0,75000,411000,-336000,-336000
053183,大立光元富96購03,0,0,0,0,0,0,0,0,0,-337000,0,0,0,0,337000,-337000,-337000
059000,台積電元大99購25,0,0,0,0,0,0,0,0,0,-339000,0,0,0,2000,341000,-339000,-339000
060117,國巨國泰9B購04  ,0,0,0,0,0,0,0,0,0,-340000,0,0,0,150000,490000,-340000,-340000
057699,可成群益9A購02  ,0,0,0,0,0,0,0,0,0,-342000,0,0,0,13000,355000,-342000,-342000
053506,南茂兆豐97購01  ,0,0,0,0,0,0,0,0,0,-344000,0,0,0,61000,405000,-344000,-344000
060540,南亞凱基9A購01  ,0,0,0,0,0,0,0,0,0,-345000,0,0,0,43000,388000,-345000,-345000
057300,訊連永豐98購01  ,0,0,0,0,0,0,0,0,0,-345000,0,0,0,5000,350000,-345000,-345000
2538,基泰            ,3000,348000,-345000,0,0,0,0,0,0,0,0,0,0,0,0,0,-345000
061384,T50反1群益9A購04,0,0,0,0,0,0,0,0,0,-349000,0,0,0,215000,564000,-349000,-349000
03414B,臺股指凱基99熊01,30000,0,30000,0,0,0,0,0,0,-379000,0,0,0,612000,991000,-379000,-349000
060123,光罩永豐99購02  ,0,0,0,0,0,0,0,0,0,-351000,0,0,0,167000,518000,-351000,-351000
07838P,泰碩元大9A售04  ,0,0,0,0,0,0,0,0,0,-353000,0,0,0,0,353000,-353000,-353000
3016,嘉晶            ,237000,349000,-112000,0,0,0,0,0,0,-242000,0,2000,-2000,34000,274000,-240000,-354000
1720,生達            ,475000,804000,-329000,0,0,0,0,0,0,-25000,15000,40000,-25000,0,0,0,-354000
1447,力鵬            ,6000,360245,-354245,0,0,0,0,0,0,0,0,0,0,0,0,0,-354245
055196,致新元富97購01  ,0,0,0,0,0,0,0,0,0,-355000,0,0,0,476000,831000,-355000,-355000
057391,樺漢永豐98購01  ,0,0,0,0,0,0,0,0,0,-355000,0,0,0,5000,360000,-355000,-355000
058955,台積電國票9A購04,0,0,0,0,0,0,0,0,0,-356000,0,0,0,39000,395000,-356000,-356000
053325,GIS群益96購02   ,0,0,0,0,0,0,0,0,0,-357000,0,0,0,0,357000,-357000,-357000
058775,台積電國票9A購02,0,0,0,0,0,0,0,0,0,-357000,0,0,0,113000,470000,-357000,-357000
056604,鴻海富邦9A購01  ,0,0,0,0,0,0,0,0,0,-360000,0,0,0,0,360000,-360000,-360000
060816,世紀鋼凱基9C購02,0,0,0,0,0,0,0,0,0,-361000,0,0,0,25000,386000,-361000,-361000
059948,正文永豐99購01  ,0,0,0,0,0,0,0,0,0,-362000,0,0,0,63000,425000,-362000,-362000
051192,緯創兆豐96購01  ,0,0,0,0,0,0,0,0,0,-362000,0,0,0,233000,595000,-362000,-362000
055652,聯詠元富01購01  ,0,0,0,0,0,0,0,0,0,-362000,0,0,0,5000,367000,-362000,-362000
059090,台新金元大99購01,0,0,0,0,0,0,0,0,0,-365000,0,0,0,335000,700000,-365000,-365000
047421,聯茂富邦97購01  ,0,0,0,0,0,0,0,0,0,-370000,0,0,0,0,370000,-370000,-370000
00650L,FH香港正2       ,0,1000,-1000,0,0,0,0,0,0,-370000,0,0,0,222000,592000,-370000,-371000
055426,旺宏群益99購02  ,0,0,0,0,0,0,0,0,0,-371000,0,0,0,38000,409000,-371000,-371000
056910,超眾元大99購02  ,0,0,0,0,0,0,0,0,0,-371000,0,0,0,100000,471000,-371000,-371000
2536,宏普            ,10000,381000,-371000,0,0,0,0,0,0,0,0,0,0,0,0,0,-371000
8016,矽創            ,148000,495000,-347000,0,0,0,6000,0,6000,-30000,0,1000,-1000,6000,35000,-29000,-371000
058766,力山兆豐99購01  ,0,0,0,0,0,0,0,0,0,-372000,0,0,0,25000,397000,-372000,-372000
2375,凱美            ,213000,513000,-300000,0,0,0,0,0,0,-74000,0,2000,-2000,2000,74000,-72000,-374000
060922,金像電永豐9A購01,0,17000,-17000,0,0,0,0,0,0,-358000,0,0,0,57000,415000,-358000,-375000
5225,東科-KY         ,40000,417000,-377000,0,0,0,0,0,0,0,0,0,0,0,0,0,-377000
058788,喬山元大99購01  ,0,0,0,0,0,0,0,0,0,-379000,0,0,0,884000,1263000,-379000,-379000
059103,旭富元富99購03  ,0,0,0,0,0,0,0,0,0,-379000,0,0,0,50000,429000,-379000,-379000
1201,味全            ,158000,536000,-378000,0,0,0,0,0,0,-1000,0,0,0,6000,7000,-1000,-379000
061418,世紀鋼群益9A購02,0,0,0,0,0,0,0,0,0,-381000,0,0,0,479000,860000,-381000,-381000
07774P,台灣50群益9A售16,0,0,0,0,0,0,0,0,0,-382000,0,0,0,68000,450000,-382000,-382000
8926,台汽電          ,30000,433000,-403000,0,0,0,0,0,0,13000,15000,0,15000,11000,13000,-2000,-390000
8404,百和興業-KY     ,19000,409000,-390000,0,0,0,0,0,0,0,0,0,0,0,0,0,-390000
061663,南六永豐9A購05  ,0,0,0,0,0,0,0,0,0,-391000,0,0,0,0,391000,-391000,-391000
2634,漢翔            ,99000,498000,-399000,0,0,0,0,0,0,6000,0,0,0,6000,0,6000,-393000
061031,神隆永豐9A購02  ,0,0,0,0,0,0,0,0,0,-395000,0,0,0,2000,397000,-395000,-395000
06067P,華新科康和97售01,0,0,0,0,0,0,0,0,0,-395000,0,0,0,15000,410000,-395000,-395000
058209,臺股指凱基01購01,0,0,0,0,0,0,0,0,0,-396000,0,0,0,15000,411000,-396000,-396000
057721,華擎元富98購02  ,0,0,0,0,0,0,0,0,0,-398000,0,0,0,311000,709000,-398000,-398000
2607,榮運            ,52000,450000,-398000,0,0,0,0,0,0,0,0,0,0,0,0,0,-398000
07238P,台灣50國票99售07,0,0,0,0,0,0,0,0,0,-400000,0,0,0,0,400000,-400000,-400000
056954,聯詠富邦9A購01  ,0,0,0,0,0,0,0,0,0,-401000,0,0,0,39000,440000,-401000,-401000
5215,科嘉-KY         ,148000,171000,-23000,0,0,0,0,362000,-362000,-16000,5000,21000,-16000,0,0,0,-401000
056519,創意國票99購01  ,0,0,0,0,0,0,0,0,0,-402000,0,0,0,50000,452000,-402000,-402000
02001R,富邦蘋果反一N   ,0,0,0,0,0,0,0,0,0,-403000,0,0,0,50000,453000,-403000,-403000
2006,東和鋼鐵        ,216000,623000,-407000,0,0,0,0,0,0,0,0,0,0,0,0,0,-407000
054241,深中小元大98購01,0,0,0,0,0,0,0,0,0,-408000,0,0,0,0,408000,-408000,-408000
00730,富邦臺灣優質高息,0,0,0,0,0,0,0,0,0,-411000,0,0,0,394000,805000,-411000,-411000
3376,新日興          ,192000,366000,-174000,0,0,0,0,248000,-248000,11000,34000,1000,33000,9000,31000,-22000,-411000
2905,三商            ,17000,430000,-413000,0,0,0,0,0,0,0,0,0,0,0,0,0,-413000
055419,國巨永豐97購03  ,0,0,0,0,0,0,0,0,0,-414000,0,0,0,200000,614000,-414000,-414000
055885,大成鋼統一97購02,0,0,0,0,0,0,0,0,0,-419000,0,0,0,183000,602000,-419000,-419000
2537,聯上發          ,226000,647000,-421000,0,0,0,0,0,0,0,0,0,0,0,0,0,-421000
6116,彩晶            ,4240000,4098000,142000,0,0,0,0,0,0,-563000,32000,208000,-176000,22000,409000,-387000,-421000
054188,欣興永豐96購03  ,0,0,0,0,0,0,0,0,0,-422000,0,0,0,48000,470000,-422000,-422000
2912,統一超          ,1450700,1873116,-422416,0,0,0,1000,0,1000,-1000,0,1000,-1000,0,0,0,-422416
059865,國巨凱基01購01  ,0,0,0,0,0,0,0,0,0,-423000,0,0,0,256000,679000,-423000,-423000
051809,義隆凱基96購01  ,0,0,0,0,0,0,0,0,0,-423000,0,0,0,7000,430000,-423000,-423000
06392P,T50反1元大9A售01,0,0,0,0,0,0,0,0,0,-424000,0,0,0,0,424000,-424000,-424000
061413,台勝科群益9A購01,0,0,0,0,0,0,0,0,0,-425000,0,0,0,544000,969000,-425000,-425000
058105,旺宏統一9A購02  ,0,0,0,0,0,0,0,0,0,-425000,0,0,0,163000,588000,-425000,-425000
1460,宏遠            ,31000,457000,-426000,0,0,0,0,0,0,0,0,0,0,0,0,0,-426000
055822,臺股指國票97購09,0,0,0,0,0,0,0,0,0,-427000,0,0,0,2000,429000,-427000,-427000
07806P,健策永豐9A售02  ,0,0,0,0,0,0,0,0,0,-430000,0,0,0,0,430000,-430000,-430000
051325,台光電台新96購01,0,0,0,0,0,0,0,0,0,-431000,0,0,0,69000,500000,-431000,-431000
6202,盛群            ,82000,340000,-258000,0,0,0,0,172000,-172000,-1000,0,2000,-2000,1000,0,1000,-431000
2204,中華            ,24000,477800,-453800,0,0,0,0,0,0,20000,20000,0,20000,0,0,0,-433800
3703,欣陸            ,16000,450000,-434000,0,0,0,0,0,0,0,0,0,0,0,0,0,-434000
07527P,台灣50凱基9B售02,0,0,0,0,0,0,0,0,0,-437000,0,0,0,269000,706000,-437000,-437000
052003,泰碩國泰97購02  ,0,0,0,0,0,0,0,0,0,-440000,0,0,0,114000,554000,-440000,-440000
3005,神基            ,328000,672000,-344000,0,0,0,0,0,0,-97000,0,4000,-4000,21000,114000,-93000,-441000
2451,創見            ,213000,605000,-392000,0,0,0,0,0,0,-49000,0,3000,-3000,17000,63000,-46000,-441000
5522,遠雄            ,70000,511000,-441000,0,0,0,0,0,0,0,0,0,0,0,0,0,-441000
061095,台積電台新9B購03,0,0,0,0,0,0,0,0,0,-445000,0,0,0,10000,455000,-445000,-445000
057909,台光電兆豐98購01,0,0,0,0,0,0,0,0,0,-445000,0,0,0,0,445000,-445000,-445000
058246,帆宣元大99購01  ,0,0,0,0,0,0,0,0,0,-446000,0,0,0,467000,913000,-446000,-446000
9938,百和            ,232000,741000,-509000,0,0,0,84000,0,84000,-21000,30000,20000,10000,16000,47000,-31000,-446000
6278,台表科          ,914510,1037000,-122490,0,0,0,0,223000,-223000,-103000,53000,132000,-79000,9000,33000,-24000,-448490
9940,信義            ,7000,456000,-449000,0,0,0,0,0,0,0,0,0,0,0,0,0,-449000
060948,可成第一9A購01  ,0,0,0,0,0,0,0,0,0,-450000,0,0,0,0,450000,-450000,-450000
054533,泰碩國泰98購01  ,0,0,0,0,0,0,0,0,0,-450000,0,0,0,69000,519000,-450000,-450000
061620,禾伸堂群益9A購02,0,0,0,0,0,0,0,0,0,-451000,0,0,0,0,451000,-451000,-451000
06864P,健策凱基98售01  ,0,0,0,0,0,0,0,0,0,-451000,0,0,0,132000,583000,-451000,-451000
058210,臺股指凱基9C購04,0,0,0,0,0,0,0,0,0,-453000,0,0,0,0,453000,-453000,-453000
07669P,華新科元大9A售14,0,0,0,0,0,0,0,0,0,-453000,0,0,0,75000,528000,-453000,-453000
054943,群光元大97購01  ,0,0,0,0,0,0,0,0,0,-454000,0,0,0,5000,459000,-454000,-454000
059041,南茂群益99購02  ,0,0,0,0,0,0,0,0,0,-454000,0,0,0,195000,649000,-454000,-454000
07821P,臺股指國票9A售12,0,0,0,0,0,0,0,0,0,-457000,0,0,0,76000,533000,-457000,-457000
1722,台肥            ,138000,594000,-456000,0,0,0,0,0,0,-2000,0,1000,-1000,1000,2000,-1000,-458000
06019P,緯穎凱基96售03  ,0,0,0,0,0,0,0,0,0,-460000,0,0,0,0,460000,-460000,-460000
03680C,臺股指凱基9A牛26,0,0,0,0,0,0,0,0,0,-461000,0,0,0,375000,836000,-461000,-461000
1717,長興            ,160000,622000,-462000,0,0,0,1000,0,1000,0,0,0,0,0,0,0,-461000
061034,晶豪科永豐9A購01,0,0,0,0,0,0,0,0,0,-462000,0,0,0,80000,542000,-462000,-462000
3010,華立            ,9000,473000,-464000,0,0,0,0,0,0,-1000,0,1000,-1000,0,0,0,-465000
1464,得力            ,71000,527000,-456000,0,0,0,0,0,0,-13000,0,0,0,0,13000,-13000,-469000
2478,大毅            ,895000,1135000,-240000,0,0,0,20000,0,20000,-250000,0,81000,-81000,28000,197000,-169000,-470000
052858,華通凱基97購02  ,0,0,0,0,0,0,0,0,0,-471000,0,0,0,89000,560000,-471000,-471000
058999,台積電元大99購24,0,0,0,0,0,0,0,0,0,-471000,0,0,0,8000,479000,-471000,-471000
1103,嘉泥            ,12000,482000,-470000,0,0,0,0,0,0,-1000,0,1000,-1000,0,0,0,-471000
052235,聯發科國票96購02,0,0,0,0,0,0,0,0,0,-473000,0,0,0,8000,481000,-473000,-473000
2421,建準            ,432000,283000,149000,0,0,0,0,511000,-511000,-114000,2000,22000,-20000,0,94000,-94000,-476000
058691,友訊國票9A購01  ,0,0,0,0,0,0,0,0,0,-478000,0,0,0,51000,529000,-478000,-478000
5531,鄉林            ,196000,674267,-478267,0,0,0,0,0,0,0,0,0,0,0,0,0,-478267
07312P,台灣50元大99售10,0,0,0,0,0,0,0,0,0,-481000,0,0,0,30000,511000,-481000,-481000
060249,正文元大9C購01  ,0,0,0,0,0,0,0,0,0,-486000,0,0,0,53000,539000,-486000,-486000
1210,大成            ,292359,967000,-674641,0,0,0,158000,0,158000,30000,37000,7000,30000,0,0,0,-486641
8112,至上            ,1211200,1328000,-116800,0,0,0,3000,370000,-367000,-3000,0,3000,-3000,0,0,0,-486800
060107,旭富元大99購03  ,0,0,0,0,0,0,0,0,0,-488000,0,0,0,84000,572000,-488000,-488000
056693,國產群益98購01  ,0,0,0,0,0,0,0,0,0,-488000,0,0,0,174000,662000,-488000,-488000
1455,集盛            ,147000,635000,-488000,0,0,0,0,0,0,0,0,0,0,0,0,0,-488000
061547,禾伸堂群益9A購01,0,0,0,0,0,0,0,0,0,-489000,0,0,0,85000,574000,-489000,-489000
058035,旭富永豐98購02  ,0,0,0,0,0,0,0,0,0,-490000,0,0,0,133000,623000,-490000,-490000
07082P,美律元大99售06  ,0,0,0,0,0,0,0,0,0,-490000,0,0,0,3000,493000,-490000,-490000
1711,永光            ,189000,680000,-491000,0,0,0,0,0,0,0,0,0,0,0,0,0,-491000
060194,旭富元富9A購01  ,0,0,0,0,0,0,0,0,0,-492000,0,0,0,0,492000,-492000,-492000
061548,聯詠群益9A購02  ,0,0,0,0,0,0,0,0,0,-493000,0,0,0,32000,525000,-493000,-493000
3030,德律            ,14000,508000,-494000,0,0,0,0,0,0,0,0,0,0,0,0,0,-494000
00639,富邦深100       ,19000,1461000,-1442000,0,0,0,0,0,0,946947,0,0,0,1546000,599053,946947,-495053
00753L,中信中國50正2   ,0,390000,-390000,0,0,0,0,0,0,-106000,0,0,0,343000,449000,-106000,-496000
06527P,T50正2富邦9C售01,0,0,0,0,0,0,0,0,0,-498000,0,0,0,2000,500000,-498000,-498000
3044,健鼎            ,167000,700869,-533869,0,0,0,0,0,0,35000,37000,0,37000,4000,6000,-2000,-498869
059230,滬深2X國票9B購02,0,0,0,0,0,0,0,0,0,-499000,0,0,0,0,499000,-499000,-499000
058054,台積電統一9C購01,0,0,0,0,0,0,0,0,0,-504000,0,0,0,0,504000,-504000,-504000
9939,宏全            ,100000,597000,-497000,0,0,0,40000,0,40000,-47000,26000,50000,-24000,4000,27000,-23000,-504000
06851P,鈺齊元大98售01  ,0,0,0,0,0,0,0,0,0,-505000,0,0,0,40000,545000,-505000,-505000
060642,華擎永豐9A購02  ,0,0,0,0,0,0,0,0,0,-509000,0,0,0,0,509000,-509000,-509000
058720,旭富元富99購01  ,0,0,0,0,0,0,0,0,0,-509000,0,0,0,62000,571000,-509000,-509000
053494,南亞科兆豐96購02,0,0,0,0,0,0,0,0,0,-510000,0,0,0,81000,591000,-510000,-510000
061170,南茂兆豐9B購01  ,0,0,0,0,0,0,0,0,0,-511000,0,0,0,161000,672000,-511000,-511000
060722,矽格永豐9A購01  ,0,0,0,0,0,0,0,0,0,-512000,0,0,0,94000,606000,-512000,-512000
060932,南六永豐9A購02  ,0,0,0,0,0,0,0,0,0,-514000,0,0,0,33000,547000,-514000,-514000
058713,國巨統一9B購02  ,0,0,0,0,0,0,0,0,0,-515000,0,0,0,0,515000,-515000,-515000
060561,台積電富邦04購01,0,0,0,0,0,0,0,0,0,-521000,0,0,0,448000,969000,-521000,-521000
060373,元金2X元富9A購01,0,0,0,0,0,0,0,0,0,-521000,0,0,0,1000,522000,-521000,-521000
058774,台郡兆豐9A購01  ,0,0,0,0,0,0,0,0,0,-522000,0,0,0,0,522000,-522000,-522000
1905,華紙            ,258000,780000,-522000,0,0,0,0,0,0,0,0,0,0,0,0,0,-522000
2206,三陽工業        ,11000,535000,-524000,0,0,0,0,0,0,0,0,0,0,0,0,0,-524000
2355,敬鵬            ,94000,599000,-505000,0,0,0,0,0,0,-19000,0,18000,-18000,0,1000,-1000,-524000
2609,陽明            ,261000,786000,-525000,0,0,0,0,0,0,0,0,0,0,0,0,0,-525000
2836,高雄銀          ,7000,533000,-526000,0,0,0,0,0,0,0,0,0,0,0,0,0,-526000
055924,深中小群益9B購01,0,0,0,0,0,0,0,0,0,-535000,0,0,0,0,535000,-535000,-535000
6153,嘉聯益          ,722000,1056000,-334000,0,0,0,0,0,0,-204000,44000,121000,-77000,48000,175000,-127000,-538000
6282,康舒            ,73000,600000,-527000,0,0,0,0,0,0,-12000,0,0,0,1000,13000,-12000,-539000
061612,南六統一9A購01  ,0,0,0,0,0,0,0,0,0,-541000,0,0,0,0,541000,-541000,-541000
2332,友訊            ,848000,1902000,-1054000,0,0,0,0,0,0,513000,219000,92000,127000,531000,145000,386000,-541000
055575,華新科統一98購01,0,0,0,0,0,0,0,0,0,-542000,0,0,0,93000,635000,-542000,-542000
061388,台積電群益9A購05,0,0,0,0,0,0,0,0,0,-544000,0,0,0,0,544000,-544000,-544000
060344,聯發科統一01購01,0,0,0,0,0,0,0,0,0,-544000,0,0,0,93000,637000,-544000,-544000
056298,億光元大97購02  ,0,0,0,0,0,0,0,0,0,-546000,0,0,0,200000,746000,-546000,-546000
2505,國揚            ,754000,1476000,-722000,0,0,0,0,0,0,173000,0,0,0,173000,0,173000,-549000
03840P,台積電統一99售02,0,0,0,0,0,0,0,0,0,-550000,0,0,0,0,550000,-550000,-550000
060421,華擎永豐9A購01  ,0,0,0,0,0,0,0,0,0,-555000,0,0,0,0,555000,-555000,-555000
00643,群益深証中小    ,5000,743000,-738000,0,0,0,0,0,0,182000,0,0,0,299000,117000,182000,-556000
3008,大立光          ,168345,710038,-541693,0,0,0,10000,0,10000,-29000,0,11000,-11000,0,18000,-18000,-560693
054323,旺宏台新96購02  ,0,0,0,0,0,0,0,0,0,-561000,0,0,0,121000,682000,-561000,-561000
9910,豐泰            ,619000,1156745,-537745,0,0,0,91000,0,91000,-119000,18000,137000,-119000,0,0,0,-565745
00766L,台新MSCI中國正2 ,0,0,0,0,0,0,0,0,0,-566000,0,0,0,86000,652000,-566000,-566000
05644P,大立光中信9A售03,0,0,0,0,0,0,0,0,0,-571000,0,0,0,140000,711000,-571000,-571000
057523,大成鋼元大99購01,0,0,0,0,0,0,0,0,0,-573000,0,0,0,234000,807000,-573000,-573000
060857,旭富富邦9B購01  ,0,0,0,0,0,0,0,0,0,-574000,0,0,0,0,574000,-574000,-574000
2605,新興            ,231000,745000,-514000,0,0,0,0,0,0,-61000,0,68000,-68000,7000,0,7000,-575000
059975,元金2X元大99購02,0,0,0,0,0,0,0,0,0,-577000,0,0,0,35000,612000,-577000,-577000
053187,國巨統一96購05  ,0,0,0,0,0,0,0,0,0,-579000,0,0,0,0,579000,-579000,-579000
060051,台積電凱基9B購01,0,0,0,0,0,0,0,0,0,-580000,0,0,0,101000,681000,-580000,-580000
07638P,長榮航國票9A售01,0,0,0,0,0,0,0,0,0,-584000,0,0,0,238000,822000,-584000,-584000
07836P,大成鋼元大9A售01,0,0,0,0,0,0,0,0,0,-585000,0,0,0,15000,600000,-585000,-585000
058925,旭富元富99購02  ,140000,0,140000,0,0,0,0,0,0,-728000,0,0,0,20000,748000,-728000,-588000
2838,聯邦銀          ,122000,710000,-588000,0,0,0,0,0,0,0,0,0,0,0,0,0,-588000
1710,東聯            ,250000,840000,-590000,0,0,0,1000,0,1000,0,0,0,0,0,0,0,-589000
2207,和泰車          ,208000,790100,-582100,0,0,0,1000,13000,-12000,4000,4000,0,4000,0,0,0,-590100
2820,華票            ,33000,624000,-591000,0,0,0,0,0,0,0,0,0,0,0,0,0,-591000
8046,南電            ,1915539,2541000,-625461,0,0,0,263000,100000,163000,-136000,76000,203000,-127000,31000,40000,-9000,-598461
4960,誠美材          ,144000,739000,-595000,0,0,0,0,0,0,-5000,0,5000,-5000,0,0,0,-600000
5515,建國            ,70000,671000,-601000,0,0,0,0,0,0,0,0,0,0,0,0,0,-601000
4906,正文            ,592000,1252000,-660000,0,0,0,0,0,0,58000,12000,35000,-23000,91000,10000,81000,-602000
061597,南六永豐9A購04  ,0,0,0,0,0,0,0,0,0,-607000,0,0,0,7000,614000,-607000,-607000
3038,全台            ,188000,796000,-608000,0,0,0,0,0,0,-1000,0,1000,-1000,0,0,0,-609000
00640L,富邦日本正2     ,5000,17000,-12000,0,0,0,0,0,0,-598000,0,0,0,300000,898000,-598000,-610000
07766P,美律群益9A售03  ,0,0,0,0,0,0,0,0,0,-610000,0,0,0,0,610000,-610000,-610000
059307,T50反1元大99購06,0,0,0,0,0,0,0,0,0,-613000,0,0,0,243000,856000,-613000,-613000
060758,台積電元大9A購19,0,0,0,0,0,0,0,0,0,-617000,0,0,0,15000,632000,-617000,-617000
060402,神隆國泰9B購01  ,1000,0,1000,0,0,0,0,0,0,-619000,0,0,0,51000,670000,-619000,-618000
060870,旭富群益9A購01  ,0,0,0,0,0,0,0,0,0,-619000,0,0,0,62000,681000,-619000,-619000
054684,裕隆永豐97購01  ,0,0,0,0,0,0,0,0,0,-619000,0,0,0,0,619000,-619000,-619000
046928,奇鋐富邦97購01  ,0,0,0,0,0,0,0,0,0,-622000,0,0,0,69000,691000,-622000,-622000
2534,宏盛            ,312000,934000,-622000,0,0,0,0,0,0,-2000,0,2000,-2000,0,0,0,-624000
054879,大成鋼統一97購01,0,0,0,0,0,0,0,0,0,-639000,0,0,0,0,639000,-639000,-639000
2362,藍天            ,54000,673000,-619000,0,0,0,0,0,0,-20000,0,5000,-5000,0,15000,-15000,-639000
8464,億豐            ,407000,1046000,-639000,0,0,0,0,0,0,-1000,0,0,0,0,1000,-1000,-640000
2377,微星            ,1132547,1601000,-468453,0,0,0,0,0,0,-176000,0,98000,-98000,33000,111000,-78000,-644453
1609,大亞            ,57000,705000,-648000,0,0,0,0,0,0,0,0,0,0,0,0,0,-648000
048270,T50反1富邦99購01,0,0,0,0,0,0,0,0,0,-654000,0,0,0,10000,664000,-654000,-654000
038489,T50反1台新9A購01,0,0,0,0,0,0,0,0,0,-660000,0,0,0,0,660000,-660000,-660000
00762,元大全球AI      ,0,0,0,0,0,0,0,0,0,-661000,0,0,0,0,661000,-661000,-661000
2542,興富發          ,929000,1569000,-640000,0,0,0,0,0,0,-26000,5000,10000,-5000,0,21000,-21000,-666000
055388,華通統一97購03  ,0,0,0,0,0,0,0,0,0,-668000,0,0,0,65000,733000,-668000,-668000
061478,奇鋐元大9A購01  ,0,0,0,0,0,0,0,0,0,-670000,0,0,0,445000,1115000,-670000,-670000
2385,群光            ,1795000,2406234,-611234,0,0,0,0,0,0,-62000,0,8000,-8000,29000,83000,-54000,-673234
2855,統一證          ,48000,734000,-686000,0,0,0,0,0,0,0,0,0,0,0,0,0,-686000
061007,聯詠兆豐9A購01  ,0,0,0,0,0,0,0,0,0,-688000,0,0,0,436000,1124000,-688000,-688000
058101,台積電富邦9C購01,0,0,0,0,0,0,0,0,0,-702000,0,0,0,800000,1502000,-702000,-702000
9935,慶豐富          ,360000,1064000,-704000,0,0,0,0,0,0,0,0,0,0,0,0,0,-704000
2897,王道銀行        ,234000,900000,-666000,0,0,0,0,0,0,-39000,0,39000,-39000,0,0,0,-705000
061536,華擎統一9C購02  ,0,0,0,0,0,0,0,0,0,-710000,0,0,0,20000,730000,-710000,-710000
061132,志超永豐9A購01  ,0,0,0,0,0,0,0,0,0,-716000,0,0,0,23000,739000,-716000,-716000
00635U,元大S&P黃金     ,6000,5000,1000,0,0,0,0,0,0,-717000,0,0,0,167000,884000,-717000,-716000
053630,奇鋐兆豐97購01  ,0,0,0,0,0,0,0,0,0,-716000,0,0,0,247000,963000,-716000,-716000
061189,可成富邦9B購02  ,0,0,0,0,0,0,0,0,0,-721000,0,0,0,76000,797000,-721000,-721000
055877,奇鋐元富97購01  ,0,0,0,0,0,0,0,0,0,-722000,0,0,0,300000,1022000,-722000,-722000
052849,可成統一97購01  ,0,0,0,0,0,0,0,0,0,-723000,0,0,0,0,723000,-723000,-723000
060798,旭富永豐9A購01  ,0,0,0,0,0,0,0,0,0,-727000,0,0,0,10000,737000,-727000,-727000
061706,旭富國票9A購02  ,0,0,0,0,0,0,0,0,0,-734000,0,0,0,3000,737000,-734000,-734000
050171,臺指反元大97購03,0,0,0,0,0,0,0,0,0,-735000,0,0,0,263000,998000,-735000,-735000
060047,道瓊反凱基99購01,0,0,0,0,0,0,0,0,0,-736000,0,0,0,52000,788000,-736000,-736000
060195,旭富元富9A購02  ,0,0,0,0,0,0,0,0,0,-742000,0,0,0,112000,854000,-742000,-742000
4943,康控-KY         ,364000,1080000,-716000,0,0,0,0,0,0,-27000,0,2000,-2000,35000,60000,-25000,-743000
6196,帆宣            ,318000,990000,-672000,0,0,0,0,0,0,-71000,0,21000,-21000,30000,80000,-50000,-743000
058055,華擎統一9A購01  ,0,0,0,0,0,0,0,0,0,-744000,0,0,0,93000,837000,-744000,-744000
059680,台積電國泰9A購03,0,0,0,0,0,0,0,0,0,-748000,0,0,0,213000,961000,-748000,-748000
060890,大立光統一01購01,0,0,0,0,0,0,0,0,0,-758000,0,0,0,8000,766000,-758000,-758000
061084,京元電兆豐9A購02,0,0,0,0,0,0,0,0,0,-760000,0,0,0,65000,825000,-760000,-760000
2501,國建            ,17000,774000,-757000,0,0,0,0,0,0,-9000,0,9000,-9000,0,0,0,-766000
2399,映泰            ,154000,919000,-765000,0,0,0,0,0,0,-2000,0,2000,-2000,0,0,0,-767000
6191,精成科          ,71000,833000,-762000,0,0,0,0,0,0,-5000,0,5000,-5000,0,0,0,-767000
3380,明泰            ,0,767000,-767000,0,0,0,0,0,0,0,0,0,0,0,0,0,-767000
3406,玉晶光          ,365000,871000,-506000,0,0,0,0,28000,-28000,-238000,132000,281000,-149000,15000,104000,-89000,-772000
057656,大成鋼兆豐98購01,0,0,0,0,0,0,0,0,0,-773000,0,0,0,270000,1043000,-773000,-773000
2489,瑞軒            ,151000,929000,-778000,0,0,0,0,0,0,2000,2000,0,2000,0,0,0,-776000
2049,上銀            ,1261000,1782692,-521692,0,0,0,2000,0,2000,-257000,4000,82000,-78000,5000,184000,-179000,-776692
03443B,臺股指凱基9A熊27,0,0,0,0,0,0,0,0,0,-780000,0,0,0,320000,1100000,-780000,-780000
061077,國巨兆豐9B購01  ,0,0,0,0,0,0,0,0,0,-788000,0,0,0,90000,878000,-788000,-788000
059098,元油2X統一9B購03,0,0,0,0,0,0,0,0,0,-797000,0,0,0,5000,802000,-797000,-797000
2376,技嘉            ,863000,1441000,-578000,0,0,0,100000,272000,-172000,-65000,0,2000,-2000,66000,129000,-63000,-815000
07458P,長榮航元大9A售01,0,0,0,0,0,0,0,0,0,-819000,0,0,0,356000,1175000,-819000,-819000
00715L,街口布蘭特油正2 ,0,100000,-100000,0,0,0,0,0,0,-720000,0,0,0,0,720000,-720000,-820000
9958,世紀鋼          ,345000,1132000,-787000,0,0,0,0,0,0,-37000,203000,154000,49000,71000,157000,-86000,-824000
053431,志超永豐96購01  ,0,0,0,0,0,0,0,0,0,-826000,0,0,0,0,826000,-826000,-826000
2498,宏達電          ,679000,1431000,-752000,0,0,0,0,0,0,-77000,38000,44000,-6000,43000,114000,-71000,-829000
9802,鈺齊-KY         ,398000,1225000,-827000,0,0,0,57000,0,57000,-66000,0,7000,-7000,5000,64000,-59000,-836000
1477,聚陽            ,188000,950000,-762000,0,0,0,0,0,0,-84000,0,54000,-54000,2000,32000,-30000,-846000
1319,東陽            ,264000,1122000,-858000,0,0,0,0,0,0,-1000,12000,13000,-1000,0,0,0,-859000
3665,貿聯-KY         ,157000,733000,-576000,0,0,0,0,193000,-193000,-110000,5000,6000,-1000,1000,110000,-109000,-879000
052700,奇鋐國票97購02  ,0,0,0,0,0,0,0,0,0,-883000,0,0,0,70000,953000,-883000,-883000
058444,國巨富邦9B購01  ,0,0,0,0,0,0,0,0,0,-896000,0,0,0,186000,1082000,-896000,-896000
2615,萬海            ,239000,1143000,-904000,0,0,0,0,0,0,0,0,0,0,0,0,0,-904000
057347,國巨統一9A購03  ,0,0,0,0,0,0,0,0,0,-907000,0,0,0,95000,1002000,-907000,-907000
053018,旺宏元富96購02  ,0,0,0,0,0,0,0,0,0,-910000,0,0,0,19000,929000,-910000,-910000
4927,泰鼎-KY         ,360000,1034000,-674000,0,0,0,300000,454000,-154000,-82000,55000,10000,45000,11000,138000,-127000,-910000
07042P,T50反1元大9C售02,0,0,0,0,0,0,0,0,0,-919000,0,0,0,0,919000,-919000,-919000
058878,旭富國泰9B購01  ,0,0,0,0,0,0,0,0,0,-920000,0,0,0,23000,943000,-920000,-920000
00636,國泰中國A50     ,80000,1596000,-1516000,0,0,0,0,0,0,587488,225000,210000,15000,1038000,465512,572488,-928512
060915,旭富元大9A購01  ,0,0,0,0,0,0,0,0,0,-934000,0,0,0,78000,1012000,-934000,-934000
058397,大成鋼元大99購02,0,0,0,0,0,0,0,0,0,-937000,0,0,0,265000,1202000,-937000,-937000
1304,台聚            ,313000,1239000,-926000,0,0,0,0,0,0,-15000,0,15000,-15000,0,0,0,-941000
058813,旺宏統一9B購04  ,0,0,0,0,0,0,0,0,0,-946000,0,0,0,0,946000,-946000,-946000
6412,群電            ,179000,1129000,-950000,0,0,0,0,0,0,2000,0,0,0,9000,7000,2000,-948000
9945,潤泰新          ,264000,1200000,-936000,0,0,0,0,0,0,-13000,0,6000,-6000,0,7000,-7000,-949000
1789,神隆            ,454000,1671000,-1217000,0,0,0,0,0,0,262960,0,1040,-1040,267000,3000,264000,-954040
006208,富邦台50        ,3000,1000,2000,0,0,0,0,0,0,-957000,0,0,0,799000,1756000,-957000,-955000
2547,日勝生          ,43000,1007000,-964000,0,0,0,0,0,0,0,0,0,0,0,0,0,-964000
053080,力山元大96購02  ,2000,180000,-178000,0,0,0,0,0,0,-787000,0,0,0,320000,1107000,-787000,-965000
2349,錸德            ,121000,1088000,-967000,0,0,0,0,0,0,0,0,0,0,0,0,0,-967000
053118,大立光中信9C購01,0,0,0,0,0,0,0,0,0,-971000,0,0,0,0,971000,-971000,-971000
6271,同欣電          ,150000,1278000,-1128000,0,0,0,320000,108000,212000,-55000,31000,33000,-2000,14000,67000,-53000,-971000
00737,國泰AI+Robo     ,1000,1055000,-1054000,0,0,0,0,0,0,71000,0,0,0,179000,108000,71000,-983000
061125,億光永豐9A購01  ,0,0,0,0,0,0,0,0,0,-989000,0,0,0,130000,1119000,-989000,-989000
057298,旭富永豐98購01  ,0,0,0,0,0,0,0,0,0,-996000,0,0,0,120000,1116000,-996000,-996000
05375P,健策國票96售02  ,0,0,0,0,0,0,0,0,0,-998000,0,0,0,0,998000,-998000,-998000
2511,太子            ,110000,1118000,-1008000,0,0,0,0,0,0,0,0,0,0,0,0,0,-1008000
058841,深中小群益01購01,0,0,0,0,0,0,0,0,0,-1014000,0,0,0,101000,1115000,-1014000,-1014000
2903,遠百            ,84000,1120000,-1036000,0,0,0,0,0,0,7000,7000,0,7000,0,0,0,-1029000
3045,台灣大          ,2355737,3352600,-996863,0,0,0,5000,20000,-15000,-19000,8000,27000,-19000,0,0,0,-1030863
006205,富邦上証        ,81000,1879000,-1798000,0,0,0,0,0,0,760893,191000,261000,-70000,1639000,808107,830893,-1037107
3189,景碩            ,802000,1015000,-213000,0,0,0,0,460000,-460000,-368000,96000,140000,-44000,19000,343000,-324000,-1041000
2637,慧洋-KY         ,8000,1063000,-1055000,0,0,0,0,0,0,0,0,0,0,0,0,0,-1055000
00752,中信中國50      ,537000,223000,314000,0,0,0,0,0,0,-1375039,0,0,0,659000,2034039,-1375039,-1061039
4915,致伸            ,356000,1241000,-885000,0,0,0,0,183000,-183000,-8000,0,3000,-3000,0,5000,-5000,-1076000
2103,台橡            ,104000,1210000,-1106000,0,0,0,0,0,0,0,0,0,0,0,0,0,-1106000
1504,東元            ,393000,1502000,-1109000,0,0,0,0,0,0,-14000,0,0,0,0,14000,-14000,-1123000
1907,永豐餘          ,179000,1309000,-1130000,0,0,0,0,0,0,0,0,0,0,0,0,0,-1130000
2841,台開            ,60000,1205000,-1145000,0,0,0,0,0,0,0,0,0,0,0,0,0,-1145000
1714,和桐            ,197000,1351000,-1154000,0,0,0,0,0,0,0,0,0,0,0,0,0,-1154000
1444,力麗            ,67000,1239406,-1172406,0,0,0,0,0,0,0,0,0,0,0,0,0,-1172406
3682,亞太電          ,143000,1327000,-1184000,0,0,0,0,0,0,0,0,0,0,0,0,0,-1184000
061427,旭富元大9A購02  ,0,0,0,0,0,0,0,0,0,-1193000,0,0,0,132000,1325000,-1193000,-1193000
060851,國巨國泰9C購01  ,0,0,0,0,0,0,0,0,0,-1193000,0,0,0,565000,1758000,-1193000,-1193000
07316P,長榮航康和99售01,0,0,0,0,0,0,0,0,0,-1197000,0,0,0,1000,1198000,-1197000,-1197000
1305,華夏            ,137000,1394200,-1257200,0,0,0,0,0,0,60000,60000,0,60000,0,0,0,-1197200
4414,如興            ,99000,1295000,-1196000,0,0,0,0,0,0,-7000,0,7000,-7000,0,0,0,-1203000
8150,南茂            ,910000,2658000,-1748000,0,0,0,0,0,0,539000,0,6000,-6000,937000,392000,545000,-1209000
058104,國巨統一9A購04  ,0,0,0,0,0,0,0,0,0,-1211000,0,0,0,0,1211000,-1211000,-1211000
1434,福懋            ,310000,1560000,-1250000,0,0,0,1000,0,1000,30000,30000,0,30000,0,0,0,-1219000
1313,聯成            ,104000,1329000,-1225000,0,0,0,0,0,0,0,0,0,0,0,0,0,-1225000
2104,國際中橡        ,361000,1593000,-1232000,0,0,0,0,0,0,-7000,0,0,0,0,7000,-7000,-1239000
1476,儒鴻            ,131000,1361260,-1230260,0,0,0,0,0,0,-9000,5000,0,5000,3000,17000,-14000,-1239260
2601,益航            ,266000,1512000,-1246000,0,0,0,0,0,0,0,0,0,0,0,0,0,-1246000
9907,統一實          ,69000,1320000,-1251000,0,0,0,0,0,0,0,0,0,0,0,0,0,-1251000
2023,燁輝            ,101000,1401000,-1300000,0,0,0,0,0,0,18000,18000,0,18000,0,0,0,-1282000
060416,神隆永豐9A購01  ,0,0,0,0,0,0,0,0,0,-1308000,0,0,0,0,1308000,-1308000,-1308000
2357,華碩            ,989892,2302800,-1312908,0,0,0,3000,0,3000,-7000,26000,16000,10000,4000,21000,-17000,-1316908
057527,億光元大98購01  ,0,0,0,0,0,0,0,0,0,-1318000,0,0,0,69000,1387000,-1318000,-1318000
3034,聯詠            ,1435000,2789000,-1354000,0,0,0,1000,10000,-9000,44000,109000,97000,12000,68000,36000,32000,-1319000
2889,國票金          ,412000,1735000,-1323000,0,0,0,0,0,0,0,0,0,0,0,0,0,-1323000
1904,正隆            ,146000,1462000,-1316000,0,0,0,0,0,0,-10000,0,0,0,9000,19000,-10000,-1326000
6269,台郡            ,780000,1340852,-560852,0,0,0,163000,835000,-672000,-136000,19000,128000,-109000,9000,36000,-27000,-1368852
2454,聯發科          ,4214534,5406630,-1192096,0,0,0,35000,100000,-65000,-126000,66000,68000,-2000,25000,149000,-124000,-1383096
1409,新纖            ,147000,1546000,-1399000,0,0,0,0,0,0,0,0,0,0,0,0,0,-1399000
2027,大成鋼          ,1002000,2921000,-1919000,0,0,0,0,0,0,514000,102000,29000,73000,912000,471000,441000,-1405000
1310,台苯            ,0,1414000,-1414000,0,0,0,3000,0,3000,-14000,0,1000,-1000,9000,22000,-13000,-1425000
059560,T50反1凱基99購08,0,0,0,0,0,0,0,0,0,-1431000,0,0,0,1333000,2764000,-1431000,-1431000
00712,FH富時不動產    ,5000,1490000,-1485000,0,0,0,0,0,0,51000,0,0,0,84000,33000,51000,-1434000
2915,潤泰全          ,361000,1585000,-1224000,0,0,0,0,0,0,-217000,2000,58000,-56000,53000,214000,-161000,-1441000
2102,泰豐            ,767000,2217000,-1450000,0,0,0,0,0,0,0,0,0,0,0,0,0,-1450000
6176,瑞儀            ,398000,1748400,-1350400,0,0,0,0,50000,-50000,-62000,0,0,0,24000,86000,-62000,-1462400
2867,三商壽          ,740000,2168000,-1428000,0,0,0,0,0,0,-35000,0,35000,-35000,0,0,0,-1463000
4904,遠傳            ,1360901,2780150,-1419249,0,0,0,5000,0,5000,-49000,2000,47000,-45000,0,4000,-4000,-1463249
6213,聯茂            ,301000,1499321,-1198321,0,0,0,2000,200000,-198000,-86000,119000,204000,-85000,22000,23000,-1000,-1482321
5264,鎧勝-KY         ,194000,1645000,-1451000,0,0,0,0,0,0,-40000,0,22000,-22000,16000,34000,-18000,-1491000
2347,聯強            ,980000,2419000,-1439000,0,0,0,0,0,0,-123000,18000,25000,-7000,24000,140000,-116000,-1562000
2809,京城銀          ,80000,1689000,-1609000,0,0,0,0,0,0,0,0,0,0,0,0,0,-1609000
6239,力成            ,2737647,4213800,-1476153,0,0,0,8000,68000,-60000,-102000,8000,49000,-41000,29000,90000,-61000,-1638153
00646,元大S&P500      ,9114,6000,3114,0,0,0,0,0,0,-1649000,0,0,0,282000,1931000,-1649000,-1645886
1802,台玻            ,132000,1779000,-1647000,0,0,0,0,0,0,0,0,0,0,0,0,0,-1647000
3049,和鑫            ,469000,2067000,-1598000,0,0,0,0,0,0,-51000,0,7000,-7000,0,44000,-44000,-1649000
6005,群益證          ,200000,1860000,-1660000,0,0,0,1000,0,1000,0,0,0,0,0,0,0,-1659000
2845,遠東銀          ,31000,1695000,-1664000,0,0,0,0,0,0,0,0,0,0,0,0,0,-1664000
2606,裕民            ,111000,1820000,-1709000,0,0,0,0,0,0,42000,55000,6000,49000,0,7000,-7000,-1667000
3706,神達            ,741000,1584000,-843000,0,0,0,0,815000,-815000,-11000,0,8000,-8000,8000,11000,-3000,-1669000
2439,美律            ,59000,1450000,-1391000,0,0,0,0,0,0,-301000,11000,15000,-4000,26000,323000,-297000,-1692000
1440,南紡            ,315000,2027000,-1712000,0,0,0,0,0,0,0,0,0,0,0,0,0,-1712000
047564,滬深2X國票99購01,0,0,0,0,0,0,0,0,0,-1716000,0,0,0,10000,1726000,-1716000,-1716000
00692,富邦公司治理    ,7000,5000,2000,0,0,0,0,0,0,-1763000,0,0,0,1257000,3020000,-1763000,-1761000
9933,中鼎            ,44000,1816000,-1772000,0,0,0,0,0,0,0,0,0,0,0,0,0,-1772000
00738U,元大道瓊白銀    ,8000,8000,0,0,0,0,0,0,0,-1777000,0,0,0,363000,2140000,-1777000,-1777000
1312,國喬            ,245000,2021000,-1776000,0,0,0,0,0,0,-65000,0,26000,-26000,0,39000,-39000,-1841000
5469,瀚宇博          ,284000,1979000,-1695000,0,0,0,0,0,0,-225000,0,4000,-4000,68000,289000,-221000,-1920000
4938,和碩            ,3760000,5654000,-1894000,0,0,0,6000,0,6000,-69000,60000,26000,34000,55000,158000,-103000,-1957000
6251,定穎            ,2623000,3610000,-987000,0,0,0,150000,0,150000,-1152000,50000,1202000,-1152000,0,0,0,-1989000
1718,中纖            ,80000,2117000,-2037000,0,0,0,0,0,0,-1000,0,1000,-1000,0,0,0,-2038000
2379,瑞昱            ,3979332,4774061,-794729,0,0,0,5000,552000,-547000,-711000,19000,577000,-558000,11000,164000,-153000,-2052729
2448,晶電            ,6268000,7678000,-1410000,0,0,0,38000,773000,-735000,24000,771000,745000,26000,20000,22000,-2000,-2121000
00850,元大臺灣ESG永續 ,0,0,0,0,0,0,0,0,0,-2122000,0,0,0,260000,2382000,-2122000,-2122000
4958,臻鼎-KY         ,2454000,6019782,-3565782,0,0,0,1553000,0,1553000,-113000,4000,47000,-43000,36000,106000,-70000,-2125782
2301,光寶科          ,5640500,7775000,-2134500,0,0,0,46000,0,46000,-62000,176000,133000,43000,25000,130000,-105000,-2150500
2633,台灣高鐵        ,1071331,3250850,-2179519,0,0,0,7000,0,7000,-2000,0,18000,-18000,37000,21000,16000,-2174519
2105,正新            ,1606000,4327400,-2721400,0,0,0,506000,0,506000,-42000,36000,70000,-34000,24000,32000,-8000,-2257400
3702,大聯大          ,365000,2537520,-2172520,0,0,0,0,0,0,-120000,18000,4000,14000,27000,161000,-134000,-2292520
2327,國巨            ,1850000,4965402,-3115402,0,0,0,391000,41000,350000,437000,209000,143000,66000,604000,233000,371000,-2328402
2014,中鴻            ,291000,2726000,-2435000,0,0,0,0,0,0,0,0,0,0,0,0,0,-2435000
2515,中工            ,521000,2791000,-2270000,0,0,0,0,0,0,-169000,48000,199000,-151000,8000,26000,-18000,-2439000
00670L,富邦NASDAQ正2   ,72000,47000,25000,0,0,0,0,0,0,-2474000,0,0,0,203000,2677000,-2474000,-2449000
2354,鴻準            ,737000,3187036,-2450036,0,0,0,0,0,0,-38000,30000,68000,-38000,0,0,0,-2488036
00708L,元大S&P黃金正2  ,0,1000,-1000,0,0,0,0,0,0,-2494000,0,0,0,1328000,3822000,-2494000,-2495000
2201,裕隆            ,484000,3008000,-2524000,0,0,0,0,0,0,16000,18000,17000,1000,28000,13000,15000,-2508000
00647L,元大S&P500正2   ,36000,36000,0,0,0,0,0,0,0,-2547000,0,0,0,818000,3365000,-2547000,-2547000
060302,台積電富邦02購01,0,0,0,0,0,0,0,0,0,-2573000,0,0,0,241000,2814000,-2573000,-2573000
1909,榮成            ,458000,3042000,-2584000,0,0,0,0,0,0,-57000,22000,79000,-57000,0,0,0,-2641000
3450,聯鈞            ,1268000,859000,409000,0,0,0,0,3000000,-3000000,-57000,21000,8000,13000,16000,86000,-70000,-2648000
2308,台達電          ,3716000,6942000,-3226000,0,0,0,281000,0,281000,191000,316000,5000,311000,22000,142000,-120000,-2754000
00631L,元大台灣50正2   ,389000,384000,5000,0,0,0,0,0,0,-2809000,0,0,0,3476000,6285000,-2809000,-2804000
2371,大同            ,2455000,5255000,-2800000,0,0,0,0,0,0,-18000,0,14000,-14000,0,4000,-4000,-2818000
2356,英業達          ,4057100,6659000,-2601900,0,0,0,2000,0,2000,-224440,2000,54440,-52440,111000,283000,-172000,-2824340
059395,T50反1元富99購03,0,0,0,0,0,0,0,0,0,-2862000,0,0,0,161000,3023000,-2862000,-2862000
1102,亞泥            ,2242000,4993350,-2751350,0,0,0,27000,0,27000,-176000,92000,56000,36000,59000,271000,-212000,-2900350
2812,台中銀          ,39000,2957368,-2918368,0,0,0,18000,0,18000,0,0,0,0,0,0,0,-2900368
2368,金像電          ,6683000,9826000,-3143000,0,0,0,210000,0,210000,-26000,729000,812000,-83000,211000,154000,57000,-2959000
1216,統一            ,4174947,7479980,-3305033,0,0,0,50000,22000,28000,33000,61000,28000,33000,0,0,0,-3244033
2504,國產            ,1368000,4531000,-3163000,0,0,0,0,0,0,-172000,145000,4000,141000,13000,326000,-313000,-3335000
1314,中石化          ,1010000,4447000,-3437000,0,0,0,0,0,0,77000,48000,14000,34000,97000,54000,43000,-3360000
00830,國泰費城半導體  ,34000,2136000,-2102000,0,0,0,0,0,0,-1328000,0,0,0,274000,1602000,-1328000,-3430000
2412,中華電          ,1646967,5051712,-3404745,0,0,0,47000,134300,-87300,8000,10000,1000,9000,0,1000,-1000,-3484045
048189,臺指反元大96購06,0,0,0,0,0,0,0,0,0,-3543000,0,0,0,30000,3573000,-3543000,-3543000
00701,國泰股利精選30  ,1000,121000,-120000,0,0,0,0,0,0,-3436000,0,0,0,311000,3747000,-3436000,-3556000
6505,台塑化          ,1211000,5210000,-3999000,0,0,0,319000,0,319000,35000,39000,4000,35000,0,0,0,-3645000
2313,華通            ,1529000,6562000,-5033000,0,0,0,1029000,0,1029000,355000,849000,584000,265000,380000,290000,90000,-3649000
2352,佳世達          ,306000,3353000,-3047000,0,0,0,0,486000,-486000,-160000,10000,170000,-160000,0,0,0,-3693000
2312,金寶            ,721000,4535000,-3814000,0,0,0,0,0,0,111000,0,1000,-1000,143000,31000,112000,-3703000
3576,聯合再生        ,286000,4078966,-3792966,0,0,0,0,0,0,0,0,0,0,0,0,0,-3792966
00875,國泰網路資安    ,0,2412000,-2412000,0,0,0,0,0,0,-1436000,0,0,0,131000,1567000,-1436000,-3848000
1605,華新            ,894000,4369000,-3475000,0,0,0,0,0,0,-518000,54000,103000,-49000,86000,555000,-469000,-3993000
048187,臺指反元大96購04,0,0,0,0,0,0,0,0,0,-4080000,0,0,0,0,4080000,-4080000,-4080000
9904,寶成            ,1910000,6316000,-4406000,0,0,0,27000,0,27000,42000,80000,50000,30000,20000,8000,12000,-4337000
5876,上海商銀        ,1174000,5694749,-4520749,0,0,0,9000,0,9000,-6000,1000,1000,0,0,6000,-6000,-4517749
2618,長榮航          ,4659949,9187900,-4527951,0,0,0,22000,0,22000,-200000,591000,210000,381000,138000,719000,-581000,-4705951
2449,京元電子        ,1223000,5762000,-4539000,0,0,0,0,298000,-298000,-16000,143000,22000,121000,193000,330000,-137000,-4853000
3037,欣興            ,3344000,8768000,-5424000,0,0,0,710000,0,710000,-177000,456000,548000,-92000,204000,289000,-85000,-4891000
2323,中環            ,255000,4470000,-4215000,0,0,0,0,0,0,-701000,26000,152000,-126000,6000,581000,-575000,-4916000
2610,華航            ,3529000,8303000,-4774000,0,0,0,2000,0,2000,-175000,0,20000,-20000,0,155000,-155000,-4947000
2408,南亞科          ,3301600,8169334,-4867734,0,0,0,3000,0,3000,-170000,110000,340000,-230000,224000,164000,60000,-5034734
5871,中租-KY         ,1162025,5888709,-4726684,0,0,0,35000,320000,-285000,-63000,0,28000,-28000,8000,43000,-35000,-5074684
00655L,國泰中國A50正2  ,39000,597000,-558000,0,0,0,0,0,0,-4626100,0,0,0,1065000,5691100,-4626100,-5184100
2823,中壽            ,1162000,7140685,-5978685,0,0,0,10000,0,10000,352000,0,0,0,357000,5000,352000,-5616685
2382,廣達            ,1466000,6629734,-5163734,0,0,0,28000,212000,-184000,-331000,50000,210000,-160000,27000,198000,-171000,-5678734
00861,元大全球未來通訊,1000,0,1000,0,0,0,0,0,0,-5822000,0,0,0,112000,5934000,-5822000,-5821000
1301,台塑            ,2762000,9021450,-6259450,0,0,0,55000,0,55000,24000,45000,20000,25000,5000,6000,-1000,-6180450
00653L,富邦印度正2     ,14000,0,14000,0,0,0,0,0,0,-6255000,0,0,0,504000,6759000,-6255000,-6241000
00642U,元大S&P石油     ,44000,6000,38000,0,0,0,0,0,0,-6296000,0,0,0,1151000,7447000,-6296000,-6258000
2603,長榮            ,790000,7126000,-6336000,0,0,0,2000,0,2000,-158000,0,158000,-158000,0,0,0,-6492000
2303,聯電            ,20278000,26559466,-6281466,0,0,0,36000,0,36000,-291000,160000,29000,131000,118000,540000,-422000,-6536466
3231,緯創            ,1145000,7592523,-6447523,0,0,0,2000,0,2000,-107000,152000,6000,146000,187000,440000,-253000,-6552523
1402,遠東新          ,781000,7500650,-6719650,0,0,0,40000,0,40000,-14000,10000,24000,-14000,0,0,0,-6693650
2353,宏碁            ,1768888,8151991,-6383103,0,0,0,2000,0,2000,-618000,48000,404000,-356000,71000,333000,-262000,-6999103
2324,仁寶            ,3956000,10856288,-6900288,0,0,0,32000,0,32000,-296000,12000,32000,-20000,48000,324000,-276000,-7164288
1303,南亞            ,2809000,10687150,-7878150,0,0,0,345000,0,345000,-16000,20000,26000,-6000,4000,14000,-10000,-7549150
0050,元大台灣50      ,203124,6522000,-6318876,0,0,0,38000,0,38000,-1739000,0,171000,-171000,1518000,3086000,-1568000,-8019876
1326,台化            ,896000,9353000,-8457000,0,0,0,186000,0,186000,-39000,14000,26000,-12000,19000,46000,-27000,-8310000
2881,富邦金          ,9407000,17868903,-8461903,0,0,0,76000,0,76000,-265000,6000,72000,-66000,52000,251000,-199000,-8650903
00676R,富邦臺灣加權反1 ,0,0,0,0,0,0,0,0,0,-8914000,0,0,0,3248000,12162000,-8914000,-8914000
3711,日月光投控      ,2760752,11954142,-9193390,0,0,0,11000,0,11000,168000,287000,81000,206000,9000,47000,-38000,-9014390
2883,開發金          ,11931000,22878000,-10947000,0,0,0,1693000,0,1693000,-362000,19000,142000,-123000,72000,311000,-239000,-9616000
1101,台泥            ,4126000,14008132,-9882132,0,0,0,49000,0,49000,-197000,96000,76000,20000,125000,342000,-217000,-10030132
2880,華南金          ,2005895,12256377,-10250482,0,0,0,94000,0,94000,74000,83000,9000,74000,0,0,0,-10082482
2801,彰銀            ,1085000,11974906,-10889906,0,0,0,64000,0,64000,13000,13000,4000,9000,12000,8000,4000,-10812906
00633L,富邦上証正2     ,728000,6681000,-5953000,0,0,0,0,0,0,-5169000,0,110000,-110000,842000,5901000,-5059000,-11122000
2834,臺企銀          ,1284297,13119651,-11835354,0,0,0,40000,0,40000,-7000,2000,9000,-7000,0,0,0,-11802354
2892,第一金          ,5561714,18692036,-13130322,0,0,0,104000,0,104000,44000,76000,6000,70000,6000,32000,-26000,-12982322
5880,合庫金          ,3886782,17278741,-13391959,0,0,0,95000,0,95000,-67000,0,0,0,0,67000,-67000,-13363959
2884,玉山金          ,5621631,20214999,-14593368,0,0,0,114000,0,114000,-53000,53000,3000,50000,0,103000,-103000,-14532368
2882,國泰金          ,6443783,22456941,-16013158,0,0,0,86000,0,86000,-351000,0,0,0,139000,490000,-351000,-16278158
2886,兆豐金          ,5114000,21630250,-16516250,0,0,0,110000,300000,-190000,-180000,12000,74000,-62000,27000,145000,-118000,-16886250
00664R,國泰臺灣加權反1 ,0,0,0,0,0,0,0,0,0,-17781000,0,0,0,3991000,21772000,-17781000,-17781000
2002,中鋼            ,3707000,20757421,-17050421,0,0,0,126000,0,126000,-1019000,4000,1003000,-999000,0,20000,-20000,-17943421
2890,永豐金          ,1054095,19861955,-18807860,0,0,0,109000,0,109000,-22000,6000,10000,-4000,4000,22000,-18000,-18720860
2344,華邦電          ,2828000,20903151,-18075151,0,0,0,0,0,0,-883000,252000,592000,-340000,112000,655000,-543000,-18958151
00852L,國泰美國道瓊正2 ,853000,435000,418000,0,0,0,0,0,0,-19747000,0,0,0,1629000,21376000,-19747000,-19329000
2885,元大金          ,5192000,27615000,-22423000,0,0,0,108000,0,108000,-24000,201000,77000,124000,0,148000,-148000,-22339000
2891,中信金          ,13328160,36266047,-22937887,0,0,0,194000,300000,-106000,-120000,4000,25000,-21000,0,99000,-99000,-23163887
2887,台新金          ,2990000,26631687,-23641687,0,0,0,104000,0,104000,108000,4000,2000,2000,118000,12000,106000,-23429687
2888,新光金          ,8037464,33276782,-25239318,0,0,0,94000,0,94000,47000,159000,126000,33000,291000,277000,14000,-25098318
2317,鴻海            ,12540050,39247564,-26707514,0,0,0,38000,174000,-136000,-847000,92000,180000,-88000,514000,1273000,-759000,-27690514
2330,台積電          ,23242052,61234617,-37992565,0,0,0,473000,20000,453000,-744000,254000,316000,-62000,35000,717000,-682000,-38283565
3481,群創            ,11654235,49829137,-38174902,0,0,0,0,0,0,-1820000,30000,370000,-340000,3000,1483000,-1480000,-39994902
2409,友達            ,7820000,55589000,-47769000,0,0,0,3000000,0,3000000,-1853000,214000,454000,-240000,241000,1854000,-1613000,-46622000
00637L,元大滬深300正2  ,1998000,48139000,-46141000,0,0,0,0,0,0,-38391000,0,0,0,4049000,42440000,-38391000,-84532000
00632R,元大台灣50反1   ,5905000,11880000,-5975000,0,0,0,0,0,0,-226092000,3210000,4070000,-860000,43851000,269083000,-225232000,-232067000
