證券代號,證券名稱,外陸資買進股數(不含外資自營商),外陸資賣出股數(不含外資自營商),外陸資買賣超股數(不含外資自營商),外資自營商買進股數,外資自營商賣出股數,外資自營商買賣超股數,投信買進股數,投信賣出股數,投信買賣超股數,自營商買賣超股數,自營商買進股數(自行買賣),自營商賣出股數(自行買賣),自營商買賣超股數(自行買賣),自營商買進股數(避險),自營商賣出股數(避險),自營商買賣超股數(避險),三大法人買賣超股數
2891,中信金          ,20312000,18227360,2084640,0,0,0,4364000,43645,4320355,-181000,56000,156000,-100000,11000,92000,-81000,6223995
8046,南電            ,2663000,2709405,-46405,0,0,0,3809000,1436,3807564,456000,35000,35000,0,641000,185000,456000,4217159
2303,聯電            ,30037100,33553025,-3515925,0,0,0,3945000,130673,3814327,3502000,1711000,587000,1124000,2856000,478000,2378000,3800402
5264,鎧勝-KY         ,1738000,1712000,26000,0,0,0,2599000,3965,2595035,-16000,127000,45000,82000,63000,161000,-98000,2605035
00852L,國泰美國道瓊正2 ,603000,2782000,-2179000,0,0,0,0,0,0,4578000,0,0,0,7936000,3358000,4578000,2399000
2448,晶電            ,4184000,1776950,2407050,0,0,0,0,2214,-2214,-148000,152000,280000,-128000,0,20000,-20000,2256836
2324,仁寶            ,4085000,1804510,2280490,0,0,0,0,17659,-17659,-79000,49000,175000,-126000,47000,0,47000,2183831
059886,可成國票99購04  ,0,0,0,0,0,0,0,0,0,2053000,0,0,0,2387000,334000,2053000,2053000
059811,高股息凱基99購02,0,0,0,0,0,0,0,0,0,1602000,0,0,0,1602000,0,1602000,1602000
08447P,緯穎永豐9C售02  ,0,0,0,0,0,0,0,0,0,1564000,0,0,0,1564000,0,1564000,1564000
2345,智邦            ,2638000,1152460,1485540,0,0,0,0,15060,-15060,-14000,76000,34000,42000,26000,82000,-56000,1456480
2356,英業達          ,4045000,2222610,1822390,0,0,0,0,8566,-8566,-367000,78000,482000,-404000,37000,0,37000,1446824
6213,聯茂            ,573000,448075,124925,0,0,0,1191000,915,1190085,30000,104000,126000,-22000,82000,30000,52000,1345010
07400P,國巨凱基99售20  ,0,0,0,0,0,0,0,0,0,1249000,0,0,0,1682000,433000,1249000,1249000
6278,台表科          ,2523000,2840295,-317295,0,0,0,1360000,15658,1344342,211000,80000,98000,-18000,233000,4000,229000,1238047
4927,泰鼎-KY         ,2171000,1424000,747000,0,0,0,0,0,0,457000,340000,6000,334000,158000,35000,123000,1204000
5471,松翰            ,2375000,1220000,1155000,0,0,0,0,0,0,31000,31000,0,31000,0,0,0,1186000
056769,國產元大98購01  ,0,0,0,0,0,0,0,0,0,1143000,0,0,0,1171000,28000,1143000,1143000
3042,晶技            ,1506000,1349370,156630,0,0,0,1400000,46000,1354000,-375000,80000,761000,-681000,446000,140000,306000,1135630
3231,緯創            ,3343000,2211870,1131130,0,0,0,0,13051,-13051,9000,64000,147000,-83000,92000,0,92000,1127079
059645,祥碩凱基99購05  ,0,0,0,0,0,0,0,0,0,1113000,0,0,0,1306000,193000,1113000,1113000
052775,滬深2X國票99購02,0,0,0,0,0,0,0,0,0,1103000,0,0,0,1181000,78000,1103000,1103000
8112,至上            ,2190000,1103210,1086790,0,0,0,0,0,0,-10000,0,10000,-10000,0,0,0,1076790
06477P,緯穎國票99售02  ,0,0,0,0,0,0,0,0,0,1068000,0,0,0,1068000,0,1068000,1068000
2201,裕隆            ,3052000,1918990,1133010,0,0,0,0,14021,-14021,-79000,0,79000,-79000,0,0,0,1039989
3545,敦泰            ,1918000,892865,1025135,0,0,0,0,0,0,0,0,0,0,0,0,0,1025135
2367,燿華            ,2465000,1454225,1010775,0,0,0,0,2920,-2920,-12000,0,51000,-51000,39000,0,39000,995855
045700,道瓊指中信94購01,0,0,0,0,0,0,0,0,0,995000,0,0,0,995000,0,995000,995000
059370,玉晶光元富99購02,0,0,0,0,0,0,0,0,0,979000,0,0,0,1090000,111000,979000,979000
054426,國泰金富邦97購02,0,0,0,0,0,0,0,0,0,961000,0,0,0,961000,0,961000,961000
059925,可成國泰9B購01  ,0,0,0,0,0,0,0,0,0,944000,0,0,0,1022000,78000,944000,944000
060303,宏達電富邦9B購01,0,0,0,0,0,0,0,0,0,926000,0,0,0,955000,29000,926000,926000
2603,長榮            ,910000,2911785,-2001785,0,0,0,2656000,8674,2647326,262000,396000,134000,262000,0,0,0,907541
052085,聯電元大95購01  ,0,0,0,0,0,0,0,0,0,906000,0,0,0,926000,20000,906000,906000
058049,帆宣元大98購01  ,0,0,0,0,0,0,0,0,0,892000,0,0,0,957000,65000,892000,892000
006205,富邦上証        ,0,84000,-84000,0,0,0,0,0,0,974000,20000,0,20000,1971000,1017000,954000,890000
044717,旺宏統一94購01  ,0,0,0,0,0,0,0,0,0,880000,0,0,0,880000,0,880000,880000
056211,南港國票98購01  ,0,0,0,0,0,0,0,0,0,873000,0,0,0,873000,0,873000,873000
07545P,玉晶光凱基9A售07,0,0,0,0,0,0,0,0,0,857000,0,0,0,1046000,189000,857000,857000
060241,國泰金元大9A購01,0,0,0,0,0,0,0,0,0,836000,0,0,0,840000,4000,836000,836000
4746,台耀            ,726000,636000,90000,0,0,0,749000,0,749000,-5000,2000,7000,-5000,0,0,0,834000
1325,恆大            ,1127000,316000,811000,0,0,0,0,0,0,13000,13000,0,13000,0,0,0,824000
06684P,緯穎元大98售06  ,0,0,0,0,0,0,0,0,0,801000,0,0,0,821000,20000,801000,801000
052711,滬深2X凱基97購01,0,0,0,0,0,0,0,0,0,790000,0,0,0,790000,0,790000,790000
054499,台光電永豐96購02,0,0,0,0,0,0,0,0,0,778000,0,0,0,798000,20000,778000,778000
07405P,大立光凱基99售17,0,0,0,0,0,0,0,0,0,775000,0,0,0,837000,62000,775000,775000
2456,奇力新          ,1297000,664390,632610,0,0,0,233000,684,232316,-111000,6000,17000,-11000,10000,110000,-100000,753926
020012,富邦行動通訊N   ,0,0,0,0,0,0,0,0,0,747000,0,0,0,779000,32000,747000,747000
2449,京元電子        ,1755000,1260645,494355,0,0,0,0,4821,-4821,257000,321000,63000,258000,110000,111000,-1000,746534
060189,宏達電元富9B購03,0,0,0,0,0,0,0,0,0,731000,0,0,0,944000,213000,731000,731000
00647L,元大S&P500正2   ,11000,11000,0,0,0,0,0,0,0,729000,0,0,0,1363000,634000,729000,729000
2349,錸德            ,838000,110000,728000,0,0,0,0,0,0,0,0,0,0,0,0,0,728000
07284P,大立光凱基99售10,0,0,0,0,0,0,0,0,0,724000,0,0,0,899000,175000,724000,724000
00672L,元大S&P原油正2  ,59000,58000,1000,0,0,0,0,0,0,706525,0,0,0,1227000,520475,706525,707525
049656,臺股指凱基94購17,0,0,0,0,0,0,0,0,0,699000,0,0,0,699000,0,699000,699000
6142,友勁            ,8002,75000,-66998,0,0,0,0,0,0,764000,764000,0,764000,0,0,0,697002
049272,世紀鋼元大96購02,0,0,0,0,0,0,0,0,0,682000,0,0,0,937000,255000,682000,682000
059441,祥碩元大99購02  ,0,0,0,0,0,0,0,0,0,676000,0,0,0,699000,23000,676000,676000
060121,新光金富邦99購01,0,0,0,0,0,0,0,0,0,672000,0,0,0,1063000,391000,672000,672000
051371,超眾富邦95購01  ,0,0,0,0,0,0,0,0,0,671000,0,0,0,702000,31000,671000,671000
3706,神達            ,1611150,889770,721380,0,0,0,30000,6537,23463,-74000,0,115000,-115000,59000,18000,41000,670843
057206,立積元富98購01  ,0,0,0,0,0,0,0,0,0,667000,0,0,0,992000,325000,667000,667000
059442,祥碩元大99購03  ,0,0,0,0,0,0,0,0,0,664000,0,0,0,686000,22000,664000,664000
6230,超眾            ,643000,559975,83025,0,0,0,439000,0,439000,139000,84000,21000,63000,259000,183000,76000,661025
2353,宏碁            ,2735000,1920000,815000,0,0,0,0,6557,-6557,-155000,116000,229000,-113000,0,42000,-42000,653443
060366,健策元富9A購01  ,0,0,0,0,0,0,0,0,0,636000,0,0,0,765000,129000,636000,636000
049501,台郡元大95購01  ,0,0,0,0,0,0,0,0,0,635000,0,0,0,790000,155000,635000,635000
2382,廣達            ,1503000,1648810,-145810,0,0,0,861000,10256,850744,-72000,219000,272000,-53000,13000,32000,-19000,632934
057562,奇鋐兆豐98購01  ,0,0,0,0,0,0,0,0,0,631000,0,0,0,641000,10000,631000,631000
057092,健策元富98購01  ,0,0,0,0,0,0,0,0,0,629000,0,0,0,1125000,496000,629000,629000
051107,鴻海統一95購05  ,0,0,0,0,0,0,0,0,0,624000,0,0,0,624000,0,624000,624000
2867,三商壽          ,1708000,867770,840230,0,0,0,0,15351,-15351,-202000,43000,245000,-202000,0,0,0,622879
060299,友訊國泰9B購01  ,0,0,0,0,0,0,0,0,0,621000,0,0,0,621000,0,621000,621000
048350,世紀鋼元大95購01,0,0,0,0,0,0,0,0,0,617000,0,0,0,695000,78000,617000,617000
05170P,世芯元大95售01  ,0,0,0,0,0,0,0,0,0,608000,0,0,0,1195000,587000,608000,608000
054533,泰碩國泰98購01  ,0,0,0,0,0,0,0,0,0,602000,0,0,0,1871000,1269000,602000,602000
041991,元油2X國票98購01,0,0,0,0,0,0,0,0,0,600000,0,0,0,600000,0,600000,600000
050259,鴻海元大94購14  ,0,0,0,0,0,0,0,0,0,600000,0,0,0,600000,0,600000,600000
055329,百和國票98購01  ,0,0,0,0,0,0,0,0,0,600000,0,0,0,600000,0,600000,600000
059189,國泰金富邦9B購01,0,0,0,0,0,0,0,0,0,597000,0,0,0,624000,27000,597000,597000
06836P,玉晶光國票99售06,0,0,0,0,0,0,0,0,0,589000,0,0,0,828000,239000,589000,589000
060228,亞德客元大9A購01,0,0,0,0,0,0,0,0,0,588000,0,0,0,702000,114000,588000,588000
058383,道瓊指中信9C購02,0,0,0,0,0,0,0,0,0,586000,0,0,0,586000,0,586000,586000
08749P,鴻海台新01售02  ,0,0,0,0,0,0,0,0,0,585000,0,0,0,590000,5000,585000,585000
3049,和鑫            ,1076000,419000,657000,0,0,0,0,0,0,-77000,0,4000,-4000,0,73000,-73000,580000
060099,宏達電元大99購09,0,0,0,0,0,0,0,0,0,578000,0,0,0,602000,24000,578000,578000
059932,世紀鋼富邦9A購02,0,0,0,0,0,0,0,0,0,577000,0,0,0,775000,198000,577000,577000
058421,國泰金麥證01購01,0,0,0,570000,3000,567000,0,0,0,567000,0,0,0,570000,3000,567000,567000
057105,致茂群益9A購01  ,0,0,0,0,0,0,0,0,0,565000,0,0,0,565000,0,565000,565000
9938,百和            ,612000,288860,323140,0,0,0,256000,809,255191,-15000,20000,28000,-8000,3000,10000,-7000,563331
054577,世芯元大98購01  ,0,0,0,0,0,0,0,0,0,560000,0,0,0,560000,0,560000,560000
2387,精元            ,716000,203000,513000,0,0,0,0,0,0,46000,0,0,0,47000,1000,46000,559000
07470P,國巨元大9A售06  ,0,0,0,0,0,0,0,0,0,557000,0,0,0,652000,95000,557000,557000
058510,全新元大9B購02  ,0,0,0,0,0,0,0,0,0,555000,0,0,0,555000,0,555000,555000
07349P,大立光凱基99售16,0,0,0,0,0,0,0,0,0,550000,0,0,0,598000,48000,550000,550000
8271,宇瞻            ,681000,130000,551000,0,0,0,0,0,0,-4000,0,4000,-4000,0,0,0,547000
059956,玉山金康和99購01,0,0,0,0,0,0,0,0,0,544000,0,0,0,556000,12000,544000,544000
6288,聯嘉            ,806000,262000,544000,0,0,0,0,0,0,-1000,2000,3000,-1000,0,0,0,543000
2454,聯發科          ,4054000,3556710,497290,0,0,0,26000,45838,-19838,61000,117000,82000,35000,37000,11000,26000,538452
058803,世紀鋼元大99購03,0,0,0,0,0,0,0,0,0,534000,0,0,0,578000,44000,534000,534000
059978,國巨元大99購29  ,0,0,0,0,0,0,0,0,0,534000,0,0,0,752000,218000,534000,534000
056473,奇力新元大99購02,0,0,0,0,0,0,0,0,0,530000,0,0,0,561000,31000,530000,530000
6176,瑞儀            ,371000,634235,-263235,0,0,0,827000,1800,825200,-36000,31000,68000,-37000,21000,20000,1000,525965
058754,元油2X群益99購02,80000,60000,20000,0,0,0,0,0,0,500000,0,0,0,500000,0,500000,520000
060307,南港永豐9A購01  ,0,0,0,0,0,0,0,0,0,520000,0,0,0,546000,26000,520000,520000
054960,新日興元大97購02,0,0,0,0,0,0,0,0,0,518000,0,0,0,518000,0,518000,518000
059180,祥碩元富9A購01  ,0,0,0,0,0,0,0,0,0,516000,0,0,0,642000,126000,516000,516000
053097,超眾統一96購03  ,0,0,0,0,0,0,0,0,0,516000,0,0,0,671000,155000,516000,516000
055261,帆宣統一98購01  ,0,0,0,0,0,0,0,0,0,516000,0,0,0,606000,90000,516000,516000
058483,道瓊指國票9A購01,0,0,0,0,0,0,0,0,0,511000,0,0,0,511000,0,511000,511000
2458,義隆            ,469000,375430,93570,0,0,0,396000,3048,392952,20000,15000,34000,-19000,47000,8000,39000,506522
2393,億光            ,1116000,588590,527410,0,0,0,0,0,0,-23000,0,22000,-22000,1000,2000,-1000,504410
056705,超眾國泰99購01  ,0,0,0,0,0,0,0,0,0,504000,0,0,0,966000,462000,504000,504000
06454P,緯穎元大98售04  ,0,0,0,0,0,0,0,0,0,501000,0,0,0,501000,0,501000,501000
6239,力成            ,764000,469450,294550,0,0,0,250000,2136,247864,-42000,27000,48000,-21000,3000,24000,-21000,500414
048527,鴻海國票94購02  ,0,0,0,0,0,0,0,0,0,499000,0,0,0,499000,0,499000,499000
057749,華新科國票99購01,0,0,0,0,0,0,0,0,0,498000,0,0,0,498000,0,498000,498000
055319,國巨國票98購03  ,0,0,0,0,0,0,0,0,0,498000,0,0,0,498000,0,498000,498000
06999P,玉晶光國票9B售01,0,0,0,0,0,0,0,0,0,498000,0,0,0,499000,1000,498000,498000
00861,元大全球未來通訊,304000,1000,303000,0,0,0,0,0,0,194000,0,0,0,602000,408000,194000,497000
060014,中鋼康和99購01  ,0,0,0,0,0,0,0,0,0,492000,0,0,0,502000,10000,492000,492000
054952,大毅元大97購02  ,0,0,0,0,0,0,0,0,0,483000,0,0,0,522000,39000,483000,483000
059975,元金2X元大99購02,0,0,0,0,0,0,0,0,0,480000,0,0,0,638000,158000,480000,480000
2371,大同            ,1658000,1536400,121600,0,0,0,0,9696,-9696,368000,402000,34000,368000,0,0,0,479904
052943,奇力新國票96購02,0,0,0,0,0,0,0,0,0,478000,0,0,0,478000,0,478000,478000
052028,健策群益95購02  ,0,0,0,0,0,0,0,0,0,477000,0,0,0,491000,14000,477000,477000
060509,宏達電元大9A購02,0,0,0,0,0,0,0,0,0,475000,0,0,0,504000,29000,475000,475000
052611,力成元大96購02  ,0,0,0,0,0,0,0,0,0,474000,0,0,0,621000,147000,474000,474000
06506P,台郡國票99售02  ,0,0,0,0,0,0,0,0,0,473000,0,0,0,576000,103000,473000,473000
2338,光罩            ,790000,323000,467000,0,0,0,0,0,0,4000,0,0,0,5000,1000,4000,471000
3034,聯詠            ,1199000,876720,322280,0,0,0,259000,80090,178910,-31000,55000,80000,-25000,5000,11000,-6000,470190
060486,中租富邦9A購01  ,0,0,0,0,0,0,0,0,0,469000,0,0,0,483000,14000,469000,469000
056761,元油2X元大98購07,269000,0,269000,0,0,0,0,0,0,200000,0,0,0,200000,0,200000,469000
052738,聯電元大98購02  ,0,0,0,0,0,0,0,0,0,465000,0,0,0,662000,197000,465000,465000
058312,大毅國泰9B購01  ,0,0,0,0,0,0,0,0,0,462000,0,0,0,988000,526000,462000,462000
2455,全新            ,658000,244840,413160,0,0,0,0,2049,-2049,49000,92000,68000,24000,32000,7000,25000,460111
059201,祥碩永豐99購02  ,0,0,0,0,0,0,0,0,0,451000,0,0,0,575000,124000,451000,451000
058125,元油2X元大9C購01,0,0,0,0,0,0,0,0,0,450000,0,0,0,450000,0,450000,450000
054950,奇力新元大98購02,0,0,0,0,0,0,0,0,0,450000,0,0,0,455000,5000,450000,450000
07291P,臺股指凱基99售43,0,0,0,0,0,0,0,0,0,447000,0,0,0,460000,13000,447000,447000
059395,T50反1元富99購03,0,0,0,0,0,0,0,0,0,444000,0,0,0,544000,100000,444000,444000
1513,中興電          ,561000,366000,195000,0,0,0,0,0,0,247000,300000,50000,250000,0,3000,-3000,442000
060055,宏達電凱基99購06,0,0,0,0,0,0,0,0,0,439000,0,0,0,469000,30000,439000,439000
00670L,富邦NASDAQ正2   ,16000,67000,-51000,0,0,0,0,0,0,489000,0,0,0,1185000,696000,489000,438000
060284,南港元大01購01  ,0,0,0,0,0,0,0,0,0,438000,0,0,0,490000,52000,438000,438000
049967,華新科國票94購07,0,0,0,0,0,0,0,0,0,434000,0,0,0,434000,0,434000,434000
05264P,微星元大95售02  ,0,0,0,0,0,0,0,0,0,433000,0,0,0,538000,105000,433000,433000
2379,瑞昱            ,861000,430580,430420,0,0,0,279000,305056,-26056,28000,50000,35000,15000,16000,3000,13000,432364
060482,東元富邦9A購01  ,0,0,0,0,0,0,0,0,0,432000,0,0,0,432000,0,432000,432000
052430,泰碩永豐95購02  ,0,0,0,0,0,0,0,0,0,432000,0,0,0,500000,68000,432000,432000
056406,建準國票99購01  ,0,0,0,0,0,0,0,0,0,431000,0,0,0,639000,208000,431000,431000
060254,世紀鋼元大9A購01,0,0,0,0,0,0,0,0,0,429000,0,0,0,436000,7000,429000,429000
058907,健策元大99購04  ,0,0,0,0,0,0,0,0,0,427000,0,0,0,791000,364000,427000,427000
2323,中環            ,2360000,2030000,330000,0,0,0,0,0,0,97000,151000,289000,-138000,465000,230000,235000,427000
052779,欣興國票97購01  ,0,0,0,0,0,0,0,0,0,426000,0,0,0,426000,0,426000,426000
057940,和大國票99購01  ,0,0,0,0,0,0,0,0,0,419000,0,0,0,539000,120000,419000,419000
1789,神隆            ,602000,168000,434000,0,0,0,0,0,0,-17000,0,0,0,8000,25000,-17000,417000
052575,茂林凱基96購04  ,0,0,0,0,0,0,0,0,0,413000,0,0,0,414000,1000,413000,413000
056673,中石化元富9B購01,0,0,0,0,0,0,0,0,0,411000,0,0,0,411000,0,411000,411000
060283,台肥元大9C購01  ,0,0,0,0,0,0,0,0,0,411000,0,0,0,595000,184000,411000,411000
00668,國泰美國道瓊    ,0,0,0,0,0,0,0,0,0,410800,0,0,0,512000,101200,410800,410800
060451,中石化元大9C購02,0,0,0,0,0,0,0,0,0,410000,0,0,0,615000,205000,410000,410000
058392,元油2X元大99購12,0,0,0,0,0,0,0,0,0,410000,0,0,0,410000,0,410000,410000
055344,國巨凱基97購04  ,0,0,0,0,0,0,0,0,0,407000,0,0,0,449000,42000,407000,407000
060052,宏碁凱基99購01  ,0,0,0,0,0,0,0,0,0,406000,0,0,0,411000,5000,406000,406000
051818,國巨統一95購02  ,0,100000,-100000,0,0,0,0,0,0,504000,0,0,0,530000,26000,504000,404000
060410,台苯永豐9A購01  ,0,0,0,0,0,0,0,0,0,403000,0,0,0,403000,0,403000,403000
054899,南港康和97購01  ,0,0,0,0,0,0,0,0,0,401000,0,0,0,401000,0,401000,401000
054966,貿聯元大98購02  ,0,0,0,0,0,0,0,0,0,400000,0,0,0,400000,0,400000,400000
055624,聯發科富邦99購07,0,0,0,0,0,0,0,0,0,400000,0,0,0,400000,0,400000,400000
049524,可成兆豐95購02  ,0,0,0,0,0,0,0,0,0,400000,0,0,0,400000,0,400000,400000
051589,健鼎元大95購02  ,0,0,0,0,0,0,0,0,0,400000,0,0,0,400000,0,400000,400000
060340,國巨統一01購02  ,0,0,0,0,0,0,0,0,0,399000,0,0,0,809000,410000,399000,399000
044429,元金2X元大94購04,0,0,0,0,0,0,0,0,0,399000,0,0,0,399000,0,399000,399000
059958,鎧勝康和99購01  ,1000,0,1000,0,0,0,0,0,0,396000,0,0,0,674000,278000,396000,397000
053465,聯電元大96購05  ,0,0,0,0,0,0,0,0,0,395000,0,0,0,395000,0,395000,395000
2601,益航            ,766000,374000,392000,0,0,0,0,0,0,0,0,0,0,0,0,0,392000
052818,智邦永豐96購01  ,0,0,0,0,0,0,0,0,0,391000,0,0,0,504000,113000,391000,391000
3014,聯陽            ,449000,174000,275000,0,0,0,0,0,0,113000,110000,7000,103000,10000,0,10000,388000
05807P,泰鼎永豐96售03  ,0,0,0,0,0,0,0,0,0,386000,0,0,0,391000,5000,386000,386000
057725,台達電國泰9A購01,0,0,0,0,0,0,0,0,0,382000,0,0,0,469000,87000,382000,382000
060107,旭富元大99購03  ,0,0,0,0,0,0,0,0,0,381000,0,0,0,452000,71000,381000,381000
04636P,臺股指群益94售11,0,0,0,0,0,0,0,0,0,380000,0,0,0,380000,0,380000,380000
053630,奇鋐兆豐97購01  ,0,0,0,0,0,0,0,0,0,376000,0,0,0,380000,4000,376000,376000
053036,聯電凱基98購01  ,0,0,0,0,0,0,0,0,0,376000,0,0,0,398000,22000,376000,376000
052674,智邦國泰98購01  ,0,0,0,0,0,0,0,0,0,375000,0,0,0,552000,177000,375000,375000
057090,奇力新元富98購02,0,0,0,0,0,0,0,0,0,373000,0,0,0,373000,0,373000,373000
059920,宏達電元大99購07,0,0,0,0,0,0,0,0,0,365000,0,0,0,558000,193000,365000,365000
057693,臺股指凱基98購11,0,0,0,0,0,0,0,0,0,365000,0,0,0,365000,0,365000,365000
060190,國泰金元富9A購01,0,0,0,0,0,0,0,0,0,364000,0,0,0,494000,130000,364000,364000
05359P,嘉澤元大95售02  ,0,0,0,0,0,0,0,0,0,364000,0,0,0,479000,115000,364000,364000
6251,定穎            ,1401000,1282000,119000,0,0,0,0,0,0,242000,245000,3000,242000,0,0,0,361000
2363,矽統            ,665000,256000,409000,0,0,0,0,0,0,-48000,0,48000,-48000,0,0,0,361000
059503,大立光富邦9B購04,0,0,0,0,0,0,0,0,0,360000,0,0,0,545000,185000,360000,360000
07406P,大立光凱基99售18,0,0,0,0,0,0,0,0,0,359000,0,0,0,401000,42000,359000,359000
06154P,超眾元大98售01  ,0,0,0,0,0,0,0,0,0,358000,0,0,0,358000,0,358000,358000
051160,亞德客元大95購02,0,0,0,0,0,0,0,0,0,357000,0,0,0,414000,57000,357000,357000
8081,致新            ,109000,136000,-27000,0,0,0,352000,0,352000,30000,0,20000,-20000,62000,12000,50000,355000
3017,奇鋐            ,714000,441775,272225,0,0,0,0,0,0,80000,171000,16000,155000,61000,136000,-75000,352225
052538,和大統一95購02  ,0,0,0,0,0,0,0,0,0,352000,0,0,0,352000,0,352000,352000
055291,京鼎元大97購02  ,0,0,0,0,0,0,0,0,0,352000,0,0,0,357000,5000,352000,352000
058911,茂林元大99購04  ,0,0,0,0,0,0,0,0,0,351000,0,0,0,412000,61000,351000,351000
058516,健鼎元大99購02  ,0,0,0,0,0,0,0,0,0,350000,0,0,0,358000,8000,350000,350000
054970,帆宣元大97購01  ,0,0,0,0,0,0,0,0,0,350000,0,0,0,385000,35000,350000,350000
058329,S&P正2元富01購01,0,0,0,0,0,0,0,0,0,349000,0,0,0,349000,0,349000,349000
059809,貿聯元富99購01  ,0,0,0,0,0,0,0,0,0,346000,0,0,0,418000,72000,346000,346000
054427,潤泰全富邦97購01,0,0,0,0,0,0,0,0,0,345000,0,0,0,495000,150000,345000,345000
053488,中石化兆豐97購01,0,0,0,0,0,0,0,0,0,344000,0,0,0,349000,5000,344000,344000
058912,祥碩元大99購01  ,0,0,0,0,0,0,0,0,0,342000,0,0,0,400000,58000,342000,342000
058132,義隆元大99購03  ,0,0,0,0,0,0,0,0,0,339000,0,0,0,489000,150000,339000,339000
059647,超眾凱基99購04  ,0,0,0,0,0,0,0,0,0,338000,0,0,0,397000,59000,338000,338000
056404,嘉聯益群益9A購01,0,0,0,0,0,0,0,0,0,338000,0,0,0,338000,0,338000,338000
3653,健策            ,477000,334430,142570,0,0,0,318000,0,318000,-128000,16000,44000,-28000,48000,148000,-100000,332570
046942,友達元大99購01  ,0,0,0,0,0,0,0,0,0,332000,0,0,0,332000,0,332000,332000
07366P,國巨康和99售02  ,0,0,0,0,0,0,0,0,0,332000,0,0,0,900000,568000,332000,332000
056579,麗豐元大99購01  ,0,0,0,0,0,0,0,0,0,331000,0,0,0,341000,10000,331000,331000
6504,南六            ,319000,69000,250000,0,0,0,0,0,0,81000,27000,10000,17000,67000,3000,64000,331000
057875,京鼎元大98購03  ,0,0,0,0,0,0,0,0,0,327000,0,0,0,339000,12000,327000,327000
08865P,欣興元大01售02  ,324000,0,324000,0,0,0,0,0,0,0,0,0,0,0,0,0,324000
059747,台達電台新99購01,0,0,0,0,0,0,0,0,0,321000,0,0,0,340000,19000,321000,321000
057039,元油2X元大9B購07,0,0,0,0,0,0,0,0,0,320000,0,0,0,320000,0,320000,320000
07071P,立積元富99售01  ,0,0,0,0,0,0,0,0,0,319000,0,0,0,341000,22000,319000,319000
3443,創意            ,594000,219580,374420,0,0,0,0,963,-963,-56000,10000,58000,-48000,4000,12000,-8000,317457
059009,世紀鋼元大99購04,0,0,0,0,0,0,0,0,0,316000,0,0,0,865000,549000,316000,316000
047505,元金2X國票9B購01,0,0,0,0,0,0,0,0,0,316000,0,0,0,316000,0,316000,316000
059534,國泰金凱基99購01,0,0,0,0,0,0,0,0,0,315000,0,0,0,326000,11000,315000,315000
057278,可成元大98購06  ,0,0,0,0,0,0,0,0,0,313000,0,0,0,684000,371000,313000,313000
060329,鎧勝群益9B購01  ,0,0,0,0,0,0,0,0,0,311000,0,0,0,354000,43000,311000,311000
058513,宏達電元大99購05,0,0,0,0,0,0,0,0,0,307000,0,0,0,318000,11000,307000,307000
057724,亞德客國泰99購01,10000,5000,5000,0,0,0,0,0,0,300000,0,0,0,458000,158000,300000,305000
059919,宏達電元大99購06,0,0,0,0,0,0,0,0,0,305000,0,0,0,464000,159000,305000,305000
059656,T50反1元大99購11,0,0,0,0,0,0,0,0,0,304000,0,0,0,470000,166000,304000,304000
050481,泰鼎國票96購01  ,0,0,0,0,0,0,0,0,0,304000,0,0,0,304000,0,304000,304000
058721,立積元富9C購01  ,0,0,0,0,0,0,0,0,0,303000,0,0,0,762000,459000,303000,303000
056210,矽創永豐97購02  ,0,0,0,0,0,0,0,0,0,300000,0,0,0,300000,0,300000,300000
051206,大立光麥證95購02,0,0,0,300000,0,300000,0,0,0,300000,0,0,0,300000,0,300000,300000
04947P,聯詠元大94售05  ,0,0,0,0,0,0,0,0,0,300000,0,0,0,300000,0,300000,300000
058667,元油2X群益99購01,0,0,0,0,0,0,0,0,0,300000,0,0,0,300000,0,300000,300000
053736,友達麥證96購01  ,0,0,0,299000,0,299000,0,0,0,299000,0,0,0,299000,0,299000,299000
07402P,瑞昱凱基99售02  ,0,0,0,0,0,0,0,0,0,297000,0,0,0,302000,5000,297000,297000
056850,彩晶元富99購01  ,0,0,0,0,0,0,0,0,0,296000,0,0,0,322000,26000,296000,296000
060130,瀚宇博永豐99購02,0,0,0,0,0,0,0,0,0,295000,0,0,0,342000,47000,295000,295000
055881,康控元富97購01  ,0,0,0,0,0,0,0,0,0,294000,0,0,0,294000,0,294000,294000
060186,義隆元富9A購01  ,0,0,0,0,0,0,0,0,0,287000,0,0,0,290000,3000,287000,287000
060034,立積永豐99購04  ,0,0,0,0,0,0,0,0,0,287000,0,0,0,434000,147000,287000,287000
1308,亞聚            ,446000,148000,298000,0,0,0,0,0,0,-14000,0,14000,-14000,0,0,0,284000
059181,世紀鋼元富9C購01,0,0,0,0,0,0,0,0,0,279000,0,0,0,681000,402000,279000,279000
3376,新日興          ,339000,589000,-250000,0,0,0,554000,966,553034,-25000,26000,85000,-59000,38000,4000,34000,278034
054717,亞德客永豐97購01,0,0,0,0,0,0,0,0,0,278000,0,0,0,280000,2000,278000,278000
04590P,元石油元大97售01,0,0,0,0,0,0,0,0,0,278000,0,0,0,278000,0,278000,278000
07172P,臺股指國票99售09,0,0,0,0,0,0,0,0,0,278000,0,0,0,529000,251000,278000,278000
060388,世紀鋼凱基9B購01,0,0,0,0,0,0,0,0,0,277000,0,0,0,348000,71000,277000,277000
4906,正文            ,608000,335000,273000,0,0,0,0,0,0,4000,8000,127000,-119000,153000,30000,123000,277000
051675,瑞儀元大96購02  ,0,0,0,0,0,0,0,0,0,275000,0,0,0,400000,125000,275000,275000
052475,滬深2X群益99購06,0,0,0,0,0,0,0,0,0,275000,0,0,0,275000,0,275000,275000
058908,貿聯元大99購03  ,0,0,0,0,0,0,0,0,0,274000,0,0,0,285000,11000,274000,274000
059200,京鼎永豐99購02  ,0,0,0,0,0,0,0,0,0,274000,0,0,0,432000,158000,274000,274000
057383,玉晶光富邦9A購01,0,0,0,0,0,0,0,0,0,273000,0,0,0,311000,38000,273000,273000
059926,世紀鋼國泰9B購01,0,0,0,0,0,0,0,0,0,273000,0,0,0,495000,222000,273000,273000
060027,元金2X永豐99購02,0,0,0,0,0,0,0,0,0,271000,0,0,0,350000,79000,271000,271000
059626,台積電凱基01購01,0,0,0,0,0,0,0,0,0,271000,0,0,0,503000,232000,271000,271000
051761,富邦金元大96購01,0,0,0,0,0,0,0,0,0,270000,0,0,0,270000,0,270000,270000
057054,立積元大98購03  ,0,0,0,0,0,0,0,0,0,268000,0,0,0,345000,77000,268000,268000
053784,奇力新元大97購02,0,0,0,0,0,0,0,0,0,268000,0,0,0,377000,109000,268000,268000
058569,健策凱基9A購01  ,0,0,0,0,0,0,0,0,0,265000,0,0,0,302000,37000,265000,265000
060016,廣達康和99購01  ,0,0,0,0,0,0,0,0,0,264000,0,0,0,297000,33000,264000,264000
056480,京鼎元大98購02  ,0,0,0,0,0,0,0,0,0,263000,0,0,0,297000,34000,263000,263000
058959,南茂國票9A購01  ,0,0,0,0,0,0,0,0,0,260000,0,0,0,424000,164000,260000,260000
058035,旭富永豐98購02  ,0,0,0,0,0,0,0,0,0,260000,0,0,0,615000,355000,260000,260000
056765,友達元大9B購05  ,0,0,0,0,0,0,0,0,0,260000,0,0,0,260000,0,260000,260000
054886,大毅統一97購01  ,0,0,0,0,0,0,0,0,0,260000,0,0,0,306000,46000,260000,260000
051945,智邦統一95購03  ,0,0,0,0,0,0,0,0,0,260000,0,0,0,260000,0,260000,260000
059097,世紀鋼元大99購05,0,0,0,0,0,0,0,0,0,259000,0,0,0,283000,24000,259000,259000
053510,聯電群益97購01  ,0,0,0,0,0,0,0,0,0,259000,0,0,0,298000,39000,259000,259000
07134P,臺股指元大9A售28,0,0,0,0,0,0,0,0,0,259000,0,0,0,315000,56000,259000,259000
060405,中租國泰9C購01  ,5000,0,5000,0,0,0,0,0,0,253000,0,0,0,365000,112000,253000,258000
06434P,超眾群益98售02  ,0,0,0,0,0,0,0,0,0,258000,0,0,0,258000,0,258000,258000
060018,國產康和99購01  ,0,0,0,0,0,0,0,0,0,257000,0,0,0,325000,68000,257000,257000
055849,聯詠元大97購05  ,0,0,0,0,0,0,0,0,0,256000,0,0,0,256000,0,256000,256000
051512,超眾麥證95購01  ,0,0,0,256000,0,256000,0,0,0,256000,0,0,0,256000,0,256000,256000
056193,聯發科富邦99購08,0,0,0,0,0,0,0,0,0,255000,0,0,0,255000,0,255000,255000
056770,國產元大98購02  ,0,0,0,0,0,0,0,0,0,254000,0,0,0,255000,1000,254000,254000
055592,奇力新元大97購07,0,0,0,0,0,0,0,0,0,254000,0,0,0,494000,240000,254000,254000
2723,美食-KY         ,369000,106000,263000,0,0,0,0,1899,-1899,-8000,0,7000,-7000,0,1000,-1000,253101
3450,聯鈞            ,657000,1061000,-404000,0,0,0,573000,0,573000,83000,0,233000,-233000,355000,39000,316000,252000
051404,牧德永豐96購01  ,0,0,0,0,0,0,0,0,0,251000,0,0,0,400000,149000,251000,251000
056693,國產群益98購01  ,0,0,0,0,0,0,0,0,0,250000,0,0,0,348000,98000,250000,250000
04878P,國巨康和94售02  ,0,0,0,0,0,0,0,0,0,250000,0,0,0,250000,0,250000,250000
053073,技嘉康和96購01  ,300000,0,300000,0,0,0,0,0,0,-50000,0,0,0,270000,320000,-50000,250000
059957,中信金康和99購01,0,0,0,0,0,0,0,0,0,250000,0,0,0,510000,260000,250000,250000
4967,十銓            ,448000,198000,250000,0,0,0,0,0,0,0,0,0,0,0,0,0,250000
052990,超眾元大97購01  ,0,0,0,0,0,0,0,0,0,249000,0,0,0,432000,183000,249000,249000
058595,T50正2元富99購01,0,0,0,0,0,0,0,0,0,248000,0,0,0,248000,0,248000,248000
055232,泰碩國票98購01  ,3000,0,3000,0,0,0,0,0,0,243000,0,0,0,1017000,774000,243000,246000
059578,智邦元富99購02  ,0,0,0,0,0,0,0,0,0,245000,0,0,0,321000,76000,245000,245000
04391P,玉晶光凱基95售03,0,0,0,0,0,0,0,0,0,245000,0,0,0,245000,0,245000,245000
5305,敦南            ,308000,61000,247000,0,0,0,0,0,0,-2000,0,2000,-2000,0,0,0,245000
056762,亞德客元大98購01,0,0,0,0,0,0,0,0,0,244000,0,0,0,287000,43000,244000,244000
053131,華通國票97購03  ,0,0,0,0,0,0,0,0,0,243000,0,0,0,243000,0,243000,243000
055448,健策統一97購02  ,0,0,0,0,0,0,0,0,0,240000,0,0,0,240000,0,240000,240000
1762,中化生          ,463000,292000,171000,0,0,0,90000,0,90000,-23000,2000,25000,-23000,0,0,0,238000
057258,中環兆豐98購01  ,0,0,0,0,0,0,0,0,0,235000,0,0,0,371000,136000,235000,235000
057835,華擎元富9B購01  ,0,0,0,0,0,0,0,0,0,235000,0,0,0,597000,362000,235000,235000
053983,樺漢元大97購02  ,0,0,0,0,0,0,0,0,0,235000,0,0,0,235000,0,235000,235000
053453,新光金統一98購01,0,0,0,0,0,0,0,0,0,234000,0,0,0,285000,51000,234000,234000
04479P,同欣電中信96售02,0,0,0,0,0,0,0,0,0,234000,0,0,0,250000,16000,234000,234000
2340,光磊            ,456000,222000,234000,0,0,0,0,0,0,0,0,12000,-12000,12000,0,12000,234000
059343,宏達電凱基99購04,0,0,0,0,0,0,0,0,0,232000,0,0,0,395000,163000,232000,232000
058768,南港兆豐99購01  ,0,0,0,0,0,0,0,0,0,231000,0,0,0,323000,92000,231000,231000
4106,雃博            ,298000,69000,229000,0,0,0,0,0,0,0,0,0,0,0,0,0,229000
060234,凱美元大9C購01  ,0,0,0,0,0,0,0,0,0,225000,0,0,0,299000,74000,225000,225000
057615,元油2X凱基98購02,225000,0,225000,0,0,0,0,0,0,0,0,0,0,0,0,0,225000
059179,祥碩元富99購01  ,0,0,0,0,0,0,0,0,0,224000,0,0,0,427000,203000,224000,224000
05059P,大立光國票96售02,0,0,0,0,0,0,0,0,0,224000,0,0,0,438000,214000,224000,224000
056558,台達電群益98購01,0,0,0,0,0,0,0,0,0,222000,0,0,0,222000,0,222000,222000
057323,智邦群益98購01  ,0,0,0,0,0,0,0,0,0,221000,0,0,0,237000,16000,221000,221000
059990,健策元大9A購01  ,0,0,0,0,0,0,0,0,0,221000,0,0,0,339000,118000,221000,221000
1229,聯華            ,1068000,776340,291660,0,0,0,0,6114,-6114,-65000,6000,71000,-65000,0,0,0,220546
059986,宏達電元大99購08,0,0,0,0,0,0,0,0,0,220000,0,0,0,269000,49000,220000,220000
051579,宏碁元大95購01  ,0,0,0,0,0,0,0,0,0,220000,0,0,0,220000,0,220000,220000
6269,台郡            ,351000,410270,-59270,0,0,0,250000,1172,248828,30000,62000,32000,30000,6000,6000,0,219558
059536,新光金凱基99購05,0,0,0,0,0,0,0,0,0,219000,0,0,0,222000,3000,219000,219000
060232,友訊元大9C購01  ,0,0,0,0,0,0,0,0,0,219000,0,0,0,287000,68000,219000,219000
051323,康控國票96購01  ,0,0,0,0,0,0,0,0,0,217000,0,0,0,217000,0,217000,217000
054710,東元元富97購01  ,0,0,0,0,0,0,0,0,0,217000,0,0,0,519000,302000,217000,217000
060483,友達富邦9A購01  ,0,0,0,0,0,0,0,0,0,215000,0,0,0,241000,26000,215000,215000
051266,國巨富邦99購01  ,0,0,0,0,0,0,0,0,0,215000,0,0,0,215000,0,215000,215000
07368P,國巨凱基99售19  ,0,0,0,0,0,0,0,0,0,215000,0,0,0,266000,51000,215000,215000
057086,立積統一9C購01  ,0,0,0,0,0,0,0,0,0,214000,0,0,0,219000,5000,214000,214000
056780,元油2X群益9A購03,150000,0,150000,0,0,0,0,0,0,64000,0,0,0,64000,0,64000,214000
07146P,瑞昱元大99售02  ,0,0,0,0,0,0,0,0,0,213000,0,0,0,213000,0,213000,213000
060117,國巨國泰9B購04  ,0,0,0,0,0,0,0,0,0,212000,0,0,0,640000,428000,212000,212000
058528,世紀鋼元大99購02,0,0,0,0,0,0,0,0,0,210000,0,0,0,210000,0,210000,210000
052229,奇力新凱基96購01,0,0,0,0,0,0,0,0,0,210000,0,0,0,212000,2000,210000,210000
058604,華邦電元大99購03,0,0,0,0,0,0,0,0,0,210000,0,0,0,278000,68000,210000,210000
07130P,台郡元大9B售01  ,0,0,0,0,0,0,0,0,0,210000,0,0,0,224000,14000,210000,210000
07289P,台灣50凱基99售07,0,0,0,0,0,0,0,0,0,210000,0,0,0,230000,20000,210000,210000
059274,國巨元大99購22  ,0,0,0,0,0,0,0,0,0,209000,0,0,0,452000,243000,209000,209000
055639,上銀元富97購02  ,0,0,0,0,0,0,0,0,0,209000,0,0,0,897000,688000,209000,209000
058353,國巨凱基99購09  ,0,0,0,0,0,0,0,0,0,208000,0,0,0,344000,136000,208000,208000
057119,微星康和98購01  ,0,0,0,0,0,0,0,0,0,207000,0,0,0,207000,0,207000,207000
060424,中租永豐9A購01  ,0,0,0,0,0,0,0,0,0,207000,0,0,0,210000,3000,207000,207000
05680P,聯發科元大96售12,0,0,0,0,0,0,0,0,0,207000,0,0,0,207000,0,207000,207000
054908,群電康和97購01  ,0,0,0,0,0,0,0,0,0,207000,0,0,0,207000,0,207000,207000
060306,台肥永豐9A購01  ,0,0,0,0,0,0,0,0,0,206000,0,0,0,406000,200000,206000,206000
04663P,臺股指國票94售02,0,0,0,0,0,0,0,0,0,206000,0,0,0,336000,130000,206000,206000
059838,茂林國泰9B購01  ,0,0,0,0,0,0,0,0,0,205000,0,0,0,421000,216000,205000,205000
057511,健策統一98購02  ,0,0,0,0,0,0,0,0,0,205000,0,0,0,223000,18000,205000,205000
056851,瑞儀元富98購01  ,0,0,0,0,0,0,0,0,0,204000,0,0,0,358000,154000,204000,204000
054439,健策台新96購03  ,0,0,0,0,0,0,0,0,0,204000,0,0,0,278000,74000,204000,204000
2108,南帝            ,262000,59000,203000,0,0,0,0,0,0,0,0,0,0,0,0,0,203000
057433,上銀國票98購04  ,0,0,0,0,0,0,0,0,0,202000,0,0,0,210000,8000,202000,202000
056691,元油2X群益9B購01,0,0,0,0,0,0,0,0,0,201000,0,0,0,201000,0,201000,201000
056975,元油2X群益98購03,201000,0,201000,0,0,0,0,0,0,0,0,0,0,0,0,0,201000
057614,華新科元富99購04,0,0,0,0,0,0,0,0,0,201000,0,0,0,257000,56000,201000,201000
058914,元油2X元富01購02,0,50000,-50000,0,0,0,0,0,0,250000,0,0,0,250000,0,250000,200000
056801,國巨台新98購01  ,3000,5000,-2000,0,0,0,0,0,0,202000,0,0,0,210000,8000,202000,200000
057038,元油2X元大9B購06,0,0,0,0,0,0,0,0,0,200000,0,0,0,200000,0,200000,200000
059008,鈺齊元大99購03  ,0,0,0,0,0,0,0,0,0,200000,0,0,0,200000,0,200000,200000
058702,國巨元大99購16  ,0,0,0,0,0,0,0,0,0,200000,0,0,0,300000,100000,200000,200000
058380,臺股指凱基99購15,0,0,0,0,0,0,0,0,0,200000,0,0,0,200000,0,200000,200000
058393,元油2X元大99購13,0,0,0,0,0,0,0,0,0,200000,0,0,0,200000,0,200000,200000
054467,隆達凱基97購01  ,0,0,0,0,0,0,0,0,0,200000,0,0,0,200000,0,200000,200000
051825,中環元大95購01  ,0,0,0,0,0,0,0,0,0,200000,0,0,0,200000,0,200000,200000
048698,宏達電國票95購01,0,0,0,0,0,0,0,0,0,200000,0,0,0,200000,0,200000,200000
03425B,臺股指元大9A熊01,0,0,0,0,0,0,0,0,0,200000,0,0,0,200000,0,200000,200000
00875,國泰網路資安    ,8000,0,8000,0,0,0,0,0,0,192000,0,0,0,222000,30000,192000,200000
051390,京元電兆豐95購01,0,0,0,0,0,0,0,0,0,200000,0,0,0,200000,0,200000,200000
1701,中化            ,249000,45000,204000,0,0,0,0,0,0,-4000,0,4000,-4000,0,0,0,200000
059533,富邦金凱基99購01,0,0,0,0,0,0,0,0,0,199000,0,0,0,333000,134000,199000,199000
048633,台達電元大94購02,0,0,0,0,0,0,0,0,0,198000,0,0,0,198000,0,198000,198000
058203,信邦凱基99購01  ,0,0,0,0,0,0,0,0,0,197000,0,0,0,233000,36000,197000,197000
060128,健策永豐99購06  ,0,0,0,0,0,0,0,0,0,197000,0,0,0,322000,125000,197000,197000
058557,健策第一01購01  ,0,0,0,0,0,0,0,0,0,196000,0,0,0,196000,0,196000,196000
054910,信錦凱基97購01  ,0,0,0,0,0,0,0,0,0,195000,0,0,0,200000,5000,195000,195000
1515,力山            ,464000,262255,201745,0,0,0,0,0,0,-7000,0,9000,-9000,11000,9000,2000,194745
059884,鴻海國票99購09  ,0,0,0,0,0,0,0,0,0,194000,0,0,0,429000,235000,194000,194000
06172P,台虹永豐97售02  ,0,0,0,0,0,0,0,0,0,193000,0,0,0,193000,0,193000,193000
058006,台郡群益98購04  ,0,0,0,0,0,0,0,0,0,192000,0,0,0,201000,9000,192000,192000
059952,旺宏康和99購01  ,0,0,0,0,0,0,0,0,0,192000,0,0,0,202000,10000,192000,192000
05920P,力成元大96售04  ,0,0,0,0,0,0,0,0,0,192000,0,0,0,197000,5000,192000,192000
055720,宏達電元大97購05,0,0,0,0,0,0,0,0,0,192000,0,0,0,247000,55000,192000,192000
053297,鎧勝中信98購01  ,0,0,0,0,0,0,0,0,0,191000,0,0,0,191000,0,191000,191000
056072,群創元大97購01  ,0,0,0,0,0,0,0,0,0,190000,0,0,0,190000,0,190000,190000
059965,鴻海凱基99購16  ,0,0,0,0,0,0,0,0,0,190000,0,0,0,210000,20000,190000,190000
051131,玉山金台新95購01,0,0,0,0,0,0,0,0,0,190000,0,0,0,190000,0,190000,190000
050687,上銀日盛94購01  ,0,0,0,0,0,0,0,0,0,190000,0,0,0,190000,0,190000,190000
051243,微星元大95購01  ,0,0,0,0,0,0,0,0,0,189000,0,0,0,189000,0,189000,189000
9914,美利達          ,303000,213230,89770,0,0,0,120000,636,119364,-21000,0,21000,-21000,0,0,0,188134
058512,宏達電元大99購04,0,0,0,0,0,0,0,0,0,188000,0,0,0,199000,11000,188000,188000
058282,聯茂中信99購01  ,0,0,0,0,0,0,0,0,0,187000,0,0,0,607000,420000,187000,187000
059772,可成群益9A購05  ,0,0,0,0,0,0,0,0,0,187000,0,0,0,196000,9000,187000,187000
059979,台積電元大99購49,0,0,0,0,0,0,0,0,0,186000,0,0,0,236000,50000,186000,186000
056084,漢唐統一97購03  ,0,0,0,0,0,0,0,0,0,186000,0,0,0,220000,34000,186000,186000
060398,立積國票9B購01  ,0,0,0,0,0,0,0,0,0,186000,0,0,0,281000,95000,186000,186000
059535,玉山金凱基99購01,0,0,0,0,0,0,0,0,0,185000,0,0,0,206000,21000,185000,185000
051845,世紀鋼富邦96購01,0,0,0,0,0,0,0,0,0,185000,0,0,0,190000,5000,185000,185000
057291,國巨國泰9A購01  ,0,0,0,0,0,0,0,0,0,184000,0,0,0,184000,0,184000,184000
053503,臻鼎兆豐97購01  ,0,0,0,0,0,0,0,0,0,183000,0,0,0,213000,30000,183000,183000
059607,台積電富邦9C購04,0,0,0,0,0,0,0,0,0,182000,0,0,0,202000,20000,182000,182000
050383,超眾兆豐95購01  ,0,0,0,0,0,0,0,0,0,182000,0,0,0,190000,8000,182000,182000
057479,致茂元大98購03  ,0,0,0,0,0,0,0,0,0,181000,0,0,0,208000,27000,181000,181000
057944,新日興國票99購02,0,0,0,0,0,0,0,0,0,181000,0,0,0,230000,49000,181000,181000
060116,世紀鋼元大99購07,0,0,0,0,0,0,0,0,0,181000,0,0,0,317000,136000,181000,181000
4958,臻鼎-KY         ,1199000,823290,375710,0,0,0,0,2963,-2963,-192000,27000,101000,-74000,12000,130000,-118000,180747
054737,京元電凱基99購01,0,0,0,0,0,0,0,0,0,180000,0,0,0,180000,0,180000,180000
058540,嘉聯益國泰9A購02,0,0,0,0,0,0,0,0,0,179000,0,0,0,179000,0,179000,179000
058831,茂林永豐99購01  ,0,0,0,0,0,0,0,0,0,177000,0,0,0,235000,58000,177000,177000
049007,玉晶光中信96購01,0,0,0,0,0,0,0,0,0,177000,0,0,0,177000,0,177000,177000
06085P,義隆台新97售01  ,0,0,0,0,0,0,0,0,0,176000,0,0,0,187000,11000,176000,176000
057426,元油2X兆豐9B購01,175000,0,175000,0,0,0,0,0,0,0,0,0,0,0,0,0,175000
060365,京鼎元富9A購01  ,0,0,0,0,0,0,0,0,0,175000,0,0,0,336000,161000,175000,175000
055631,創意永豐98購01  ,0,0,0,0,0,0,0,0,0,175000,0,0,0,185000,10000,175000,175000
060474,中租元大9B購01  ,0,0,0,0,0,0,0,0,0,174000,0,0,0,222000,48000,174000,174000
057179,可成元大98購04  ,0,0,0,0,0,0,0,0,0,174000,0,0,0,208000,34000,174000,174000
054928,帆宣凱基98購01  ,0,0,0,0,0,0,0,0,0,174000,0,0,0,245000,71000,174000,174000
054412,智邦元大96購03  ,0,0,0,0,0,0,0,0,0,174000,0,0,0,260000,86000,174000,174000
046906,新光金凱基99購02,0,0,0,0,0,0,0,0,0,173000,0,0,0,173000,0,173000,173000
05591P,義隆群益96售03  ,0,0,0,0,0,0,0,0,0,172000,0,0,0,172000,0,172000,172000
07014P,華通元大99售04  ,0,0,0,0,0,0,0,0,0,172000,0,0,0,172000,0,172000,172000
057639,國巨元大99購07  ,0,0,0,0,0,0,0,0,0,171000,0,0,0,191000,20000,171000,171000
053341,聯發科國票97購03,0,0,0,0,0,0,0,0,0,171000,0,0,0,171000,0,171000,171000
07131P,緯穎元大99售06  ,0,0,0,0,0,0,0,0,0,171000,0,0,0,329000,158000,171000,171000
3090,日電貿          ,356000,148540,207460,0,0,0,0,0,0,-37000,0,15000,-15000,6000,28000,-22000,170460
060431,復盛永豐9A購01  ,0,0,0,0,0,0,0,0,0,170000,0,0,0,170000,0,170000,170000
054018,華新台新96購01  ,0,0,0,0,0,0,0,0,0,170000,0,0,0,400000,230000,170000,170000
051311,瑞昱麥證95購01  ,0,0,0,170000,0,170000,0,0,0,170000,0,0,0,170000,0,170000,170000
07479P,A50正2元富9A售03,0,0,0,0,0,0,0,0,0,170000,0,0,0,200000,30000,170000,170000
1439,中和            ,230000,60000,170000,0,0,0,0,0,0,0,0,0,0,0,0,0,170000
051447,新光金元大97購01,0,0,0,0,0,0,0,0,0,169000,0,0,0,236000,67000,169000,169000
055177,宏達電統一99購01,0,0,0,0,0,0,0,0,0,168000,0,0,0,168000,0,168000,168000
057785,智邦國票99購02  ,0,0,0,0,0,0,0,0,0,167000,0,0,0,167000,0,167000,167000
07481P,大立光台新9A售01,0,0,0,0,0,0,0,0,0,167000,0,0,0,167000,0,167000,167000
2369,菱生            ,246000,63000,183000,0,0,0,0,0,0,-16000,0,16000,-16000,0,0,0,167000
6456,GIS-KY          ,490000,384880,105120,0,0,0,0,1422,-1422,63000,17000,18000,-1000,74000,10000,64000,166698
058246,帆宣元大99購01  ,0,0,0,0,0,0,0,0,0,166000,0,0,0,191000,25000,166000,166000
058800,健策元大99購03  ,0,0,0,0,0,0,0,0,0,166000,0,0,0,518000,352000,166000,166000
059694,創意永豐99購03  ,0,0,0,0,0,0,0,0,0,166000,0,0,0,178000,12000,166000,166000
03435B,臺股指凱基99熊29,0,0,0,0,0,0,0,0,0,165000,0,0,0,308000,143000,165000,165000
2421,建準            ,473000,358000,115000,0,0,0,70000,0,70000,-20000,0,25000,-25000,23000,18000,5000,165000
060278,道瓊反元大9A購03,0,0,0,0,0,0,0,0,0,165000,0,0,0,202000,37000,165000,165000
06347P,祥碩元富97售02  ,0,0,0,0,0,0,0,0,0,165000,0,0,0,165000,0,165000,165000
057121,立積康和98購01  ,0,0,0,0,0,0,0,0,0,163000,0,0,0,163000,0,163000,163000
058247,聯茂元大99購04  ,0,0,0,0,0,0,0,0,0,162000,0,0,0,292000,130000,162000,162000
059213,國巨元大99購19  ,0,0,0,0,0,0,0,0,0,162000,0,0,0,359000,197000,162000,162000
059826,欣興凱基99購06  ,0,0,0,0,0,0,0,0,0,162000,0,0,0,199000,37000,162000,162000
056209,超眾永豐97購02  ,0,0,0,0,0,0,0,0,0,162000,0,0,0,162000,0,162000,162000
054343,世紀鋼元富96購02,0,0,0,0,0,0,0,0,0,161000,0,0,0,277000,116000,161000,161000
053415,聯茂國票97購01  ,0,0,0,0,0,0,0,0,0,161000,0,0,0,161000,0,161000,161000
057954,宏碁元大99購01  ,0,0,0,0,0,0,0,0,0,160000,0,0,0,160000,0,160000,160000
058308,全新元大9B購01  ,0,0,0,0,0,0,0,0,0,160000,0,0,0,265000,105000,160000,160000
057820,華擎元大98購02  ,0,0,0,0,0,0,0,0,0,160000,0,0,0,481000,321000,160000,160000
054094,創意群益96購02  ,0,0,0,0,0,0,0,0,0,160000,0,0,0,160000,0,160000,160000
051109,美律統一95購02  ,0,0,0,0,0,0,0,0,0,160000,0,0,0,160000,0,160000,160000
059103,旭富元富99購03  ,0,0,0,0,0,0,0,0,0,159000,0,0,0,266000,107000,159000,159000
052822,泰碩永豐97購01  ,0,0,0,0,0,0,0,0,0,159000,0,0,0,197000,38000,159000,159000
07280P,FBVIX凱基99售01 ,0,0,0,0,0,0,0,0,0,158000,0,0,0,159000,1000,158000,158000
053083,中環元大99購01  ,0,0,0,0,0,0,0,0,0,155000,0,0,0,220000,65000,155000,155000
054898,台肥康和97購01  ,0,0,0,0,0,0,0,0,0,155000,0,0,0,277000,122000,155000,155000
046630,京元電元富95購03,0,0,0,0,0,0,0,0,0,155000,0,0,0,159000,4000,155000,155000
2485,兆赫            ,228000,64000,164000,0,0,0,0,0,0,-10000,6000,6000,0,0,10000,-10000,154000
059848,智邦永豐99購01  ,0,0,0,0,0,0,0,0,0,153000,0,0,0,202000,49000,153000,153000
057056,立積元大99購02  ,0,0,0,0,0,0,0,0,0,152000,0,0,0,176000,24000,152000,152000
047194,世紀鋼元大96購01,0,0,0,0,0,0,0,0,0,152000,0,0,0,213000,61000,152000,152000
052693,微星中信96購01  ,0,0,0,0,0,0,0,0,0,152000,0,0,0,152000,0,152000,152000
8215,明基材          ,330000,178000,152000,0,0,0,0,0,0,0,0,0,0,0,0,0,152000
059864,亞德客凱基99購01,0,0,0,0,0,0,0,0,0,151000,0,0,0,280000,129000,151000,151000
056672,元油2X元富98購10,0,50000,-50000,0,0,0,0,0,0,200000,0,0,0,200000,0,200000,150000
056791,嘉聯益群益98購01,0,0,0,0,0,0,0,0,0,150000,0,0,0,150000,0,150000,150000
057962,超眾元大99購03  ,0,0,0,0,0,0,0,0,0,150000,0,0,0,151000,1000,150000,150000
057199,台達電元富02購01,0,0,0,0,0,0,0,0,0,150000,0,0,0,150000,0,150000,150000
054661,嘉聯益元大97購03,0,0,0,0,0,0,0,0,0,150000,0,0,0,160000,10000,150000,150000
049799,旺宏元大96購01  ,0,0,0,0,0,0,0,0,0,150000,0,0,0,150000,0,150000,150000
8210,勤誠            ,502000,157000,345000,0,0,0,0,105000,-105000,-90000,1000,85000,-84000,13000,19000,-6000,150000
00636,國泰中國A50     ,0,0,0,0,0,0,0,0,0,149005,10000,10000,0,660000,510995,149005,149005
059853,超眾永豐99購03  ,0,0,0,0,0,0,0,0,0,149000,0,0,0,346000,197000,149000,149000
058674,宏達電群益99購01,0,0,0,0,0,0,0,0,0,149000,0,0,0,166000,17000,149000,149000
07306P,台灣50凱基9A售09,0,0,0,0,0,0,0,0,0,149000,0,0,0,150000,1000,149000,149000
060472,中租元大9A購02  ,0,0,0,0,0,0,0,0,0,148000,0,0,0,149000,1000,148000,148000
058733,同欣電永豐99購02,0,0,0,0,0,0,0,0,0,148000,0,0,0,153000,5000,148000,148000
053997,健策群益97購02  ,0,0,0,0,0,0,0,0,0,148000,0,0,0,192000,44000,148000,148000
051026,健策統一96購01  ,0,0,0,0,0,0,0,0,0,148000,0,0,0,199000,51000,148000,148000
059612,奇鋐永豐99購02  ,0,0,0,0,0,0,0,0,0,147000,0,0,0,227000,80000,147000,147000
057998,玉晶光麥證9A購01,0,0,0,160000,13000,147000,0,0,0,147000,0,0,0,160000,13000,147000,147000
053427,鎧勝永豐96購02  ,0,0,0,0,0,0,0,0,0,147000,0,0,0,147000,0,147000,147000
07445P,大立光凱基9A售08,0,0,0,0,0,0,0,0,0,147000,0,0,0,263000,116000,147000,147000
059151,臺股指國票99購14,0,0,0,0,0,0,0,0,0,146000,0,0,0,272000,126000,146000,146000
057203,麗豐元富98購02  ,0,0,0,0,0,0,0,0,0,146000,0,0,0,146000,0,146000,146000
3533,嘉澤            ,144000,63520,80480,0,0,0,37000,188,36812,28000,23000,15000,8000,21000,1000,20000,145292
056093,大毅元富97購01  ,0,0,0,0,0,0,0,0,0,145000,0,0,0,235000,90000,145000,145000
051731,聯電國票96購02  ,0,0,0,0,0,0,0,0,0,145000,0,0,0,303000,158000,145000,145000
057733,嘉聯益國泰99購01,0,0,0,0,0,0,0,0,0,144000,0,0,0,225000,81000,144000,144000
056319,智原群益98購02  ,0,0,0,0,0,0,0,0,0,144000,0,0,0,144000,0,144000,144000
052759,京元電群益96購01,0,0,0,0,0,0,0,0,0,144000,0,0,0,144000,0,144000,144000
06332P,世紀鋼群益98售01,0,0,0,0,0,0,0,0,0,144000,0,0,0,147000,3000,144000,144000
060083,和大元大99購02  ,0,0,0,0,0,0,0,0,0,143000,0,0,0,153000,10000,143000,143000
06410P,祥碩統一97售01  ,0,0,0,0,0,0,0,0,0,143000,0,0,0,143000,0,143000,143000
060237,友達元大9A購06  ,0,0,0,0,0,0,0,0,0,142000,0,0,0,174000,32000,142000,142000
057533,晶相光元大98購02,0,0,0,0,0,0,0,0,0,142000,0,0,0,143000,1000,142000,142000
00783,富邦中証500     ,0,91000,-91000,0,0,0,0,0,0,232978,0,0,0,1004000,771022,232978,141978
057207,立積元富98購02  ,0,0,0,0,0,0,0,0,0,141000,0,0,0,574000,433000,141000,141000
057429,華新科兆豐98購03,0,0,0,0,0,0,0,0,0,140000,0,0,0,150000,10000,140000,140000
060360,南亞科元富9A購02,0,0,0,0,0,0,0,0,0,140000,0,0,0,200000,60000,140000,140000
07404P,華新科凱基99售10,0,0,0,0,0,0,0,0,0,140000,0,0,0,140000,0,140000,140000
060295,貿聯元大9A購03  ,0,0,0,0,0,0,0,0,0,139000,0,0,0,139000,0,139000,139000
059742,富邦金元富99購01,0,0,0,0,0,0,0,0,0,139000,0,0,0,199000,60000,139000,139000
051944,智邦統一95購02  ,0,0,0,0,0,0,0,0,0,139000,0,0,0,164000,25000,139000,139000
05546P,全新元大97售01  ,0,0,0,0,0,0,0,0,0,139000,0,0,0,260000,121000,139000,139000
2444,兆勁            ,231000,92000,139000,0,0,0,0,0,0,0,0,0,0,0,0,0,139000
060489,世紀鋼群益9A購01,0,0,0,0,0,0,0,0,0,138000,0,0,0,138000,0,138000,138000
057972,群創富邦9C購01  ,0,0,0,0,0,0,0,0,0,138000,0,0,0,201000,63000,138000,138000
059500,鴻海元富99購11  ,0,0,0,0,0,0,0,0,0,138000,0,0,0,152000,14000,138000,138000
055827,中石化元大98購01,0,0,0,0,0,0,0,0,0,138000,0,0,0,157000,19000,138000,138000
057091,華新科元富9A購01,0,0,0,0,0,0,0,0,0,137000,0,0,0,137000,0,137000,137000
052847,漢唐統一99購01  ,0,0,0,0,0,0,0,0,0,137000,0,0,0,200000,63000,137000,137000
057053,立積元大98購02  ,0,0,0,0,0,0,0,0,0,136000,0,0,0,158000,22000,136000,136000
060389,世紀鋼凱基9B購02,0,0,0,0,0,0,0,0,0,136000,0,0,0,145000,9000,136000,136000
060408,和潤國泰9C購01  ,0,0,0,0,0,0,0,0,0,136000,0,0,0,152000,16000,136000,136000
058324,嘉聯益永豐9A購01,0,0,0,0,0,0,0,0,0,135000,0,0,0,169000,34000,135000,135000
054425,聯發科富邦99購03,0,0,0,0,0,0,0,0,0,135000,0,0,0,135000,0,135000,135000
056511,超眾永豐98購01  ,0,0,0,0,0,0,0,0,0,135000,0,0,0,190000,55000,135000,135000
059458,鎧勝永豐99購01  ,0,0,0,0,0,0,0,0,0,134000,0,0,0,232000,98000,134000,134000
3708,上緯投控        ,182000,40000,142000,0,0,0,0,0,0,-8000,0,7000,-7000,0,1000,-1000,134000
058684,健策凱基99購02  ,0,0,0,0,0,0,0,0,0,133000,0,0,0,183000,50000,133000,133000
047123,中石化中信95購01,0,0,0,0,0,0,0,0,0,133000,0,0,0,133000,0,133000,133000
06038P,國泰金台新96售01,0,0,0,0,0,0,0,0,0,132000,0,0,0,137000,5000,132000,132000
057012,康控中信98購01  ,0,0,0,0,0,0,0,0,0,132000,0,0,0,230000,98000,132000,132000
056503,楠梓電永豐98購01,0,0,0,0,0,0,0,0,0,132000,0,0,0,132000,0,132000,132000
052874,超眾凱基96購01  ,0,0,0,0,0,0,0,0,0,132000,0,0,0,152000,20000,132000,132000
059096,百和元大99購04  ,0,0,0,0,0,0,0,0,0,131000,0,0,0,145000,14000,131000,131000
055856,新唐元大97購03  ,0,0,0,0,0,0,0,0,0,131000,0,0,0,301000,170000,131000,131000
052178,台郡元大96購03  ,0,0,0,0,0,0,0,0,0,131000,0,0,0,131000,0,131000,131000
3029,零壹            ,253000,107000,146000,0,0,0,0,0,0,-15000,0,15000,-15000,0,0,0,131000
059188,京元電富邦9B購01,0,0,0,0,0,0,0,0,0,130000,0,0,0,180000,50000,130000,130000
057430,富邦金兆豐98購01,0,0,0,0,0,0,0,0,0,130000,0,0,0,132000,2000,130000,130000
051010,美律日盛95購01  ,0,0,0,0,0,0,0,0,0,130000,0,0,0,130000,0,130000,130000
051704,智邦群益95購02  ,0,0,0,0,0,0,0,0,0,130000,0,0,0,130000,0,130000,130000
058663,瑞儀兆豐9A購01  ,0,0,0,0,0,0,0,0,0,130000,0,0,0,274000,144000,130000,130000
054043,漢唐元大97購01  ,0,0,0,0,0,0,0,0,0,130000,0,0,0,143000,13000,130000,130000
06897P,FBVIX群益01售01 ,0,0,0,0,0,0,0,0,0,130000,0,0,0,130000,0,130000,130000
058996,台達電元大99購02,0,0,0,0,0,0,0,0,0,129000,0,0,0,250000,121000,129000,129000
052052,嘉澤凱基95購02  ,0,0,0,0,0,0,0,0,0,129000,0,0,0,149000,20000,129000,129000
059041,南茂群益99購02  ,0,0,0,0,0,0,0,0,0,128000,0,0,0,128000,0,128000,128000
060157,致茂永豐9A購02  ,0,0,0,0,0,0,0,0,0,128000,0,0,0,200000,72000,128000,128000
060473,中租元大9A購03  ,0,0,0,0,0,0,0,0,0,128000,0,0,0,188000,60000,128000,128000
05402P,台郡永豐95售02  ,0,0,0,0,0,0,0,0,0,128000,0,0,0,130000,2000,128000,128000
06545P,致茂元大98售01  ,0,0,0,0,0,0,0,0,0,128000,0,0,0,158000,30000,128000,128000
6197,佳必琪          ,155000,27742,127258,0,0,0,0,0,0,0,0,0,0,0,0,0,127258
059841,國巨富邦9C購01  ,0,0,0,0,0,0,0,0,0,127000,0,0,0,796000,669000,127000,127000
057483,微星元大98購04  ,0,0,0,0,0,0,0,0,0,127000,0,0,0,238000,111000,127000,127000
059540,新光金日盛99購01,0,0,0,0,0,0,0,0,0,127000,0,0,0,141000,14000,127000,127000
07363P,大立光元大99售26,0,0,0,0,0,0,0,0,0,127000,0,0,0,170000,43000,127000,127000
07364P,大立光元大99售27,0,0,0,0,0,0,0,0,0,127000,0,0,0,135000,8000,127000,127000
059214,國巨元大99購20  ,0,0,0,0,0,0,0,0,0,126000,0,0,0,485000,359000,126000,126000
057055,立積元大99購01  ,0,0,0,0,0,0,0,0,0,126000,0,0,0,233000,107000,126000,126000
04452P,超眾國泰95售01  ,0,0,0,0,0,0,0,0,0,126000,0,0,0,260000,134000,126000,126000
053627,宏碁兆豐97購01  ,0,0,0,0,0,0,0,0,0,126000,0,0,0,136000,10000,126000,126000
5388,中磊            ,217000,93610,123390,0,0,0,0,893,-893,3000,19000,25000,-6000,15000,6000,9000,125497
2059,川湖            ,156000,35000,121000,0,0,0,0,657,-657,5000,7000,4000,3000,2000,0,2000,125343
04792P,智邦元大94售06  ,0,0,0,0,0,0,0,0,0,125000,0,0,0,125000,0,125000,125000
049064,T50反1凱基96購03,0,0,0,0,0,0,0,0,0,125000,0,0,0,163000,38000,125000,125000
056191,世紀鋼統一97購01,0,0,0,0,0,0,0,0,0,123000,0,0,0,172000,49000,123000,123000
059127,國巨中信99購04  ,0,0,0,0,0,0,0,0,0,123000,0,0,0,192000,69000,123000,123000
058727,嘉晶富邦9A購01  ,0,0,0,0,0,0,0,0,0,122000,0,0,0,122000,0,122000,122000
020008,元大特股高息N   ,0,0,0,0,0,0,0,0,0,122000,0,0,0,134000,12000,122000,122000
051531,國巨國票96購04  ,0,0,0,0,0,0,0,0,0,122000,0,0,0,265000,143000,122000,122000
052705,超眾國票97購01  ,0,0,0,0,0,0,0,0,0,122000,0,0,0,122000,0,122000,122000
6141,柏承            ,221000,99000,122000,0,0,0,0,0,0,0,0,0,0,0,0,0,122000
057829,臺股指元大98購12,0,0,0,0,0,0,0,0,0,121000,0,0,0,121000,0,121000,121000
058276,道瓊指中信9C購01,0,0,0,0,0,0,0,0,0,121000,0,0,0,121000,0,121000,121000
05292P,台積電凱基95售16,0,0,0,0,0,0,0,0,0,121000,0,0,0,121000,0,121000,121000
057865,富邦金凱基98購01,0,0,0,0,0,0,0,0,0,120000,0,0,0,120000,0,120000,120000
060031,旭富永豐99購02  ,0,0,0,0,0,0,0,0,0,120000,0,0,0,308000,188000,120000,120000
056181,百和元富97購02  ,0,0,0,0,0,0,0,0,0,120000,0,0,0,120000,0,120000,120000
056898,全新元大98購02  ,0,0,0,0,0,0,0,0,0,120000,0,0,0,220000,100000,120000,120000
057077,國巨統一98購06  ,0,0,0,0,0,0,0,0,0,120000,0,0,0,147000,27000,120000,120000
055830,上銀元大97購07  ,0,0,0,0,0,0,0,0,0,120000,0,0,0,180000,60000,120000,120000
052371,元金2X元大95購01,0,0,0,0,0,0,0,0,0,120000,0,0,0,120000,0,120000,120000
2642,宅配通          ,150000,42000,108000,0,0,0,0,0,0,12000,15000,3000,12000,0,0,0,120000
059834,友達國泰9B購01  ,0,0,0,0,0,0,0,0,0,119000,0,0,0,178000,59000,119000,119000
058763,和碩群益99購01  ,0,0,0,0,0,0,0,0,0,119000,0,0,0,135000,16000,119000,119000
006206,元大上證50      ,1000,67000,-66000,0,0,0,0,0,0,185000,0,0,0,187000,2000,185000,119000
5288,豐祥-KY         ,167000,48000,119000,0,0,0,0,0,0,0,0,0,0,0,0,0,119000
2426,鼎元            ,189000,58000,131000,0,0,0,0,0,0,-12000,0,12000,-12000,0,0,0,119000
07456P,華新科元大9A售06,0,0,0,0,0,0,0,0,0,119000,0,0,0,139000,20000,119000,119000
058021,牧德凱基98購02  ,0,0,0,0,0,0,0,0,0,118000,0,0,0,118000,0,118000,118000
052937,國巨兆豐97購01  ,0,0,0,0,0,0,0,0,0,118000,0,0,0,128000,10000,118000,118000
06603P,立積統一99售01  ,0,0,0,0,0,0,0,0,0,118000,0,0,0,123000,5000,118000,118000
060505,友達元大9C購05  ,0,0,0,0,0,0,0,0,0,117000,0,0,0,117000,0,117000,117000
059121,瑞儀永豐99購01  ,0,0,0,0,0,0,0,0,0,117000,0,0,0,168000,51000,117000,117000
07246P,旺宏凱基99售08  ,0,0,0,0,0,0,0,0,0,117000,0,0,0,127000,10000,117000,117000
058007,南電群益98購02  ,0,0,0,0,0,0,0,0,0,116000,0,0,0,121000,5000,116000,116000
08637P,台灣50中信96售03,0,0,0,0,0,0,0,0,0,116000,0,0,0,116000,0,116000,116000
2419,仲琦            ,178000,62000,116000,0,0,0,0,0,0,0,0,0,0,0,0,0,116000
6443,元晶            ,149000,33000,116000,0,0,0,0,0,0,0,0,0,0,0,0,0,116000
056581,超眾元大99購01  ,0,0,0,0,0,0,0,0,0,115000,0,0,0,275000,160000,115000,115000
052832,益航群益96購01  ,0,0,0,0,0,0,0,0,0,115000,0,0,0,115000,0,115000,115000
055852,聯鈞元大98購01  ,0,0,0,0,0,0,0,0,0,115000,0,0,0,115000,0,115000,115000
6531,愛普            ,352000,222000,130000,0,0,0,0,0,0,-15000,0,15000,-15000,0,0,0,115000
058411,技嘉兆豐99購01  ,0,0,0,0,0,0,0,0,0,114000,0,0,0,206000,92000,114000,114000
059146,貿聯國票9A購02  ,0,0,0,0,0,0,0,0,0,114000,0,0,0,127000,13000,114000,114000
058190,貿聯永豐99購01  ,0,0,0,0,0,0,0,0,0,114000,0,0,0,114000,0,114000,114000
04966P,台表科元大94售04,0,0,0,0,0,0,0,0,0,114000,0,0,0,130000,16000,114000,114000
056710,漢唐永豐98購01  ,0,0,0,0,0,0,0,0,0,113000,0,0,0,200000,87000,113000,113000
048793,超眾元大95購02  ,0,0,0,0,0,0,0,0,0,113000,0,0,0,333000,220000,113000,113000
055142,健策永豐98購01  ,0,0,0,0,0,0,0,0,0,113000,0,0,0,252000,139000,113000,113000
2480,敦陽科          ,150000,65000,85000,0,0,0,0,0,0,28000,32000,4000,28000,0,0,0,113000
059202,禾聯碩永豐99購01,0,0,0,0,0,0,0,0,0,112000,0,0,0,112000,0,112000,112000
055954,南港元大97購02  ,0,0,0,0,0,0,0,0,0,112000,0,0,0,342000,230000,112000,112000
053170,茂林群益96購04  ,0,0,0,0,0,0,0,0,0,112000,0,0,0,114000,2000,112000,112000
1476,儒鴻            ,541000,422060,118940,0,0,0,0,624,-624,-7000,10000,18000,-8000,1000,0,1000,111316
058243,華擎元大99購01  ,0,0,0,0,0,0,0,0,0,111000,0,0,0,208000,97000,111000,111000
050870,旭富永豐95購01  ,0,0,0,0,0,0,0,0,0,111000,0,0,0,113000,2000,111000,111000
1227,佳格            ,222000,144800,77200,0,0,0,71000,1733,69267,-36000,0,36000,-36000,0,0,0,110467
057275,友達元大9A購04  ,0,0,0,0,0,0,0,0,0,110000,0,0,0,110000,0,110000,110000
056364,亞光元大99購02  ,0,0,0,0,0,0,0,0,0,110000,0,0,0,310000,200000,110000,110000
060126,創意永豐99購04  ,0,0,0,0,0,0,0,0,0,110000,0,0,0,270000,160000,110000,110000
060093,友達元大03購01  ,0,0,0,0,0,0,0,0,0,110000,0,0,0,215000,105000,110000,110000
05145P,道瓊反元大98售01,0,0,0,0,0,0,0,0,0,110000,0,0,0,110000,0,110000,110000
050307,欣興中信95購01  ,0,0,0,0,0,0,0,0,0,110000,0,0,0,110000,0,110000,110000
04949P,致新元大94售04  ,0,0,0,0,0,0,0,0,0,110000,0,0,0,110000,0,110000,110000
053346,群創國票97購04  ,0,0,0,0,0,0,0,0,0,110000,0,0,0,110000,0,110000,110000
054075,GIS富邦97購02   ,0,0,0,0,0,0,0,0,0,110000,0,0,0,110000,0,110000,110000
06891P,緯穎富邦99售03  ,0,0,0,0,0,0,0,0,0,110000,0,0,0,110000,0,110000,110000
056938,泰碩元富98購01  ,0,0,0,0,0,0,0,0,0,109000,0,0,0,119000,10000,109000,109000
058575,智邦群益99購01  ,0,0,0,0,0,0,0,0,0,109000,0,0,0,163000,54000,109000,109000
055280,智邦元大97購01  ,0,0,0,0,0,0,0,0,0,109000,0,0,0,139000,30000,109000,109000
00639,富邦深100       ,50000,0,50000,0,0,0,0,0,0,58777,0,0,0,876000,817223,58777,108777
2492,華新科          ,1060000,854055,205945,0,0,0,0,13691,-13691,-84000,51000,137000,-86000,153000,151000,2000,108254
058036,南電永豐98購01  ,0,0,0,0,0,0,0,0,0,108000,0,0,0,108000,0,108000,108000
059931,緯穎富邦9A購01  ,0,0,0,0,0,0,0,0,0,108000,0,0,0,173000,65000,108000,108000
06151P,華新科元大97售07,0,0,0,0,0,0,0,0,0,108000,0,0,0,122000,14000,108000,108000
07293P,臺股指凱基99售45,0,0,0,0,0,0,0,0,0,107000,0,0,0,142000,35000,107000,107000
056936,禾伸堂元富98購01,0,0,0,0,0,0,0,0,0,106000,0,0,0,106000,0,106000,106000
056331,聯鈞國票99購01  ,0,0,0,0,0,0,0,0,0,106000,0,0,0,106000,0,106000,106000
057366,智邦元大98購08  ,0,0,0,0,0,0,0,0,0,106000,0,0,0,136000,30000,106000,106000
052488,旺宏國票96購03  ,0,0,0,0,0,0,0,0,0,106000,0,0,0,160000,54000,106000,106000
07531P,大立光國泰9B售03,0,0,0,0,0,0,0,0,0,106000,0,0,0,578000,472000,106000,106000
059091,中信金元大99購01,0,0,0,0,0,0,0,0,0,105000,0,0,0,105000,0,105000,105000
059863,和大凱基99購01  ,0,0,0,0,0,0,0,0,0,105000,0,0,0,114000,9000,105000,105000
053570,京元電統一96購01,0,0,0,0,0,0,0,0,0,105000,0,0,0,134000,29000,105000,105000
051880,健策康和95購01  ,0,0,0,0,0,0,0,0,0,105000,0,0,0,105000,0,105000,105000
055526,台積電群益97購02,0,0,0,0,0,0,0,0,0,105000,0,0,0,105000,0,105000,105000
054891,聯鈞統一99購02  ,0,0,0,0,0,0,0,0,0,105000,0,0,0,105000,0,105000,105000
06780P,義隆元大98售02  ,0,0,0,0,0,0,0,0,0,105000,0,0,0,168000,63000,105000,105000
06847P,奇力新元大98售05,0,0,0,0,0,0,0,0,0,104000,0,0,0,212000,108000,104000,104000
056807,元油2X統一9B購01,103000,0,103000,0,0,0,0,0,0,0,0,0,0,0,0,0,103000
057982,帆宣永豐98購01  ,0,0,0,0,0,0,0,0,0,103000,0,0,0,175000,72000,103000,103000
054682,東元永豐97購01  ,0,0,0,0,0,0,0,0,0,103000,0,0,0,176000,73000,103000,103000
5515,建國            ,127000,24000,103000,0,0,0,0,0,0,0,0,0,0,0,0,0,103000
057287,彩晶元大9C購03  ,0,0,0,0,0,0,0,0,0,102000,0,0,0,202000,100000,102000,102000
06889P,臺股指元大98售13,0,0,0,0,0,0,0,0,0,102000,0,0,0,102000,0,102000,102000
07025P,玉晶光凱基99售01,0,0,0,0,0,0,0,0,0,102000,0,0,0,103000,1000,102000,102000
2357,華碩            ,440000,328407,111593,0,0,0,0,2357,-2357,-8000,0,12000,-12000,4000,0,4000,101236
055713,國巨元大98購09  ,0,0,0,0,0,0,0,0,0,101000,0,0,0,139000,38000,101000,101000
1720,生達            ,287000,212000,75000,0,0,0,0,0,0,26000,26000,0,26000,0,0,0,101000
6451,訊芯-KY         ,232000,122000,110000,0,0,0,0,0,0,-9000,3000,7000,-4000,0,5000,-5000,101000
057333,智邦國票99購01  ,0,0,0,0,0,0,0,0,0,100000,0,0,0,100000,0,100000,100000
057308,同欣電兆豐99購01,0,0,0,0,0,0,0,0,0,100000,0,0,0,100000,0,100000,100000
058251,百和元大99購03  ,0,0,0,0,0,0,0,0,0,100000,0,0,0,139000,39000,100000,100000
058204,世芯凱基9A購01  ,0,0,0,0,0,0,0,0,0,100000,0,0,0,235000,135000,100000,100000
058215,貿聯群益99購02  ,0,0,0,0,0,0,0,0,0,100000,0,0,0,100000,0,100000,100000
059383,台灣50凱基99購03,0,0,0,0,0,0,0,0,0,100000,0,0,0,100000,0,100000,100000
058492,華通群益9B購01  ,0,0,0,0,0,0,0,0,0,100000,0,0,0,100000,0,100000,100000
056301,開發金元大9A購01,0,0,0,0,0,0,0,0,0,100000,0,0,0,100000,0,100000,100000
058920,SGBR2X元富99購06,0,0,0,0,0,0,0,0,0,100000,0,0,0,106000,6000,100000,100000
058923,華新科元富99購06,0,0,0,0,0,0,0,0,0,100000,0,0,0,100000,0,100000,100000
058962,元油2X兆豐9A購02,0,0,0,0,0,0,0,0,0,100000,0,0,0,100000,0,100000,100000
057883,中環群益98購01  ,0,0,0,0,0,0,0,0,0,100000,0,0,0,100000,0,100000,100000
056643,奇力新凱基99購01,0,0,0,0,0,0,0,0,0,100000,0,0,0,101000,1000,100000,100000
059021,台積電統一9B購07,0,0,0,0,0,0,0,0,0,100000,0,0,0,100000,0,100000,100000
057103,禾伸堂中信9A購01,0,0,0,0,0,0,0,0,0,100000,0,0,0,100000,0,100000,100000
060460,鴻海元大9A購08  ,0,0,0,0,0,0,0,0,0,100000,0,0,0,150000,50000,100000,100000
054089,台積電群益96購11,0,0,0,0,0,0,0,0,0,100000,0,0,0,100000,0,100000,100000
055653,聯詠元富01購02  ,0,0,0,0,0,0,0,0,0,100000,0,0,0,200000,100000,100000,100000
054857,信錦群益97購01  ,0,0,0,0,0,0,0,0,0,100000,0,0,0,100000,0,100000,100000
054419,嘉聯益元大98購02,0,0,0,0,0,0,0,0,0,100000,0,0,0,100000,0,100000,100000
053172,瑞儀群益97購01  ,0,0,0,0,0,0,0,0,0,100000,0,0,0,100000,0,100000,100000
052851,滬深2X元富96購02,0,0,0,0,0,0,0,0,0,100000,0,0,0,100000,0,100000,100000
052752,臺股指元大96購06,0,0,0,0,0,0,0,0,0,100000,0,0,0,100000,0,100000,100000
052714,義隆凱基96購02  ,0,0,0,0,0,0,0,0,0,100000,0,0,0,114000,14000,100000,100000
052054,台表科凱基96購01,0,0,0,0,0,0,0,0,0,100000,0,0,0,100000,0,100000,100000
051930,國泰金兆豐97購01,0,0,0,0,0,0,0,0,0,100000,0,0,0,100000,0,100000,100000
049630,臺股指群益94購03,0,0,0,0,0,0,0,0,0,100000,0,0,0,100000,0,100000,100000
047212,宏達電富邦97購01,0,0,0,0,0,0,0,0,0,100000,0,0,0,100000,0,100000,100000
046949,群創元大99購01  ,0,0,0,0,0,0,0,0,0,100000,0,0,0,100000,0,100000,100000
048010,嘉聯益富邦97購01,0,0,0,0,0,0,0,0,0,100000,0,0,0,100000,0,100000,100000
00762,元大全球AI      ,0,0,0,0,0,0,0,0,0,100000,0,0,0,140000,40000,100000,100000
048186,元黃金元大96購01,0,0,0,0,0,0,0,0,0,100000,0,0,0,100000,0,100000,100000
053531,國泰金康和96購01,0,0,0,0,0,0,0,0,0,100000,0,0,0,100000,0,100000,100000
053675,臺股指元富96購02,0,0,0,0,0,0,0,0,0,100000,0,0,0,100000,0,100000,100000
052563,京元電日盛96購01,0,0,0,0,0,0,0,0,0,100000,0,0,0,100000,0,100000,100000
053832,聯發科台新96購01,0,0,0,0,0,0,0,0,0,100000,0,0,0,100000,0,100000,100000
053889,致茂群益97購01  ,0,0,0,0,0,0,0,0,0,100000,0,0,0,100000,0,100000,100000
050162,中環國泰95購01  ,0,0,0,0,0,0,0,0,0,100000,0,0,0,100000,0,100000,100000
050408,臻鼎台新94購02  ,0,0,0,0,0,0,0,0,0,100000,0,0,0,100000,0,100000,100000
050493,聯發科永昌96購01,0,0,0,0,0,0,0,0,0,100000,0,0,0,100000,0,100000,100000
050480,健策國票95購04  ,0,0,0,0,0,0,0,0,0,100000,0,0,0,193000,93000,100000,100000
051101,台表科元大96購02,0,0,0,0,0,0,0,0,0,100000,0,0,0,100000,0,100000,100000
051072,強茂國票95購02  ,0,0,0,0,0,0,0,0,0,100000,0,0,0,100000,0,100000,100000
07158P,FBVIX國泰9C售01 ,0,0,0,0,0,0,0,0,0,100000,0,0,0,100000,0,100000,100000
060305,得力永豐9A購01  ,0,0,0,0,0,0,0,0,0,99000,0,0,0,99000,0,99000,99000
059951,台塑康和99購01  ,0,0,0,0,0,0,0,0,0,99000,0,0,0,382000,283000,99000,99000
060138,T50反1國票9A購03,0,0,0,0,0,0,0,0,0,99000,0,0,0,99000,0,99000,99000
058182,日電貿國泰9A購01,0,0,0,0,0,0,0,0,0,99000,0,0,0,100000,1000,99000,99000
053842,聯發科統一96購08,0,0,0,0,0,0,0,0,0,99000,0,0,0,99000,0,99000,99000
051614,元金2X凱基97購01,0,0,0,0,0,0,0,0,0,99000,0,0,0,99000,0,99000,99000
03648C,T50反1元大96牛07,0,0,0,0,0,0,0,0,0,99000,0,0,0,100000,1000,99000,99000
055643,宏碁元富97購01  ,0,0,0,0,0,0,0,0,0,99000,0,0,0,99000,0,99000,99000
06853P,華擎元富98售03  ,0,0,0,0,0,0,0,0,0,99000,0,0,0,121000,22000,99000,99000
6582,申豐            ,85000,7000,78000,0,0,0,0,0,0,21000,21000,0,21000,0,0,0,99000
3705,永信            ,128000,46000,82000,0,0,0,0,0,0,17000,21000,4000,17000,0,0,0,99000
1722,台肥            ,348000,310900,37100,0,0,0,100000,2561,97439,-36000,31000,43000,-12000,11000,35000,-24000,98539
058427,大毅元富99購01  ,0,0,0,0,0,0,0,0,0,98000,0,0,0,114000,16000,98000,98000
058924,晶相光元富99購02,0,0,0,0,0,0,0,0,0,98000,0,0,0,100000,2000,98000,98000
056255,華新科元富97購05,0,0,0,0,0,0,0,0,0,98000,0,0,0,98000,0,98000,98000
053810,台達電群益96購01,0,0,0,0,0,0,0,0,0,98000,0,0,0,98000,0,98000,98000
1712,興農            ,262000,102000,160000,0,0,0,0,0,0,-62000,0,62000,-62000,0,0,0,98000
5521,工信            ,236000,138000,98000,0,0,0,0,0,0,0,0,0,0,0,0,0,98000
059650,緯穎凱基99購04  ,0,0,0,0,0,0,0,0,0,97000,0,0,0,117000,20000,97000,97000
056842,全新元富98購01  ,0,0,0,0,0,0,0,0,0,97000,0,0,0,108000,11000,97000,97000
051809,義隆凱基96購01  ,0,0,0,0,0,0,0,0,0,97000,0,0,0,105000,8000,97000,97000
07255P,國巨凱基99售15  ,0,0,0,0,0,0,0,0,0,97000,0,0,0,189000,92000,97000,97000
060211,智邦康和9A購01  ,0,0,0,0,0,0,0,0,0,96000,0,0,0,164000,68000,96000,96000
057356,彩晶統一98購04  ,0,0,0,0,0,0,0,0,0,96000,0,0,0,101000,5000,96000,96000
051690,超眾凱基95購03  ,0,0,0,0,0,0,0,0,0,96000,0,0,0,96000,0,96000,96000
058309,大毅元大99購02  ,0,0,0,0,0,0,0,0,0,95000,0,0,0,178000,83000,95000,95000
059070,道瓊指元大99購02,0,0,0,0,0,0,0,0,0,95000,0,0,0,95000,0,95000,95000
058031,旺宏永豐98購04  ,0,0,0,0,0,0,0,0,0,95000,0,0,0,95000,0,95000,95000
054299,南電元大96購03  ,0,0,0,0,0,0,0,0,0,95000,0,0,0,99000,4000,95000,95000
07478P,南電康和9A售02  ,0,0,0,0,0,0,0,0,0,95000,0,0,0,390000,295000,95000,95000
056358,友訊元大99購01  ,0,0,0,0,0,0,0,0,0,94000,0,0,0,94000,0,94000,94000
060125,強茂永豐99購01  ,0,0,0,0,0,0,0,0,0,94000,0,0,0,94000,0,94000,94000
058995,台達電元大99購01,0,0,0,0,0,0,0,0,0,94000,0,0,0,119000,25000,94000,94000
059194,元金2X永豐99購01,0,0,0,0,0,0,0,0,0,94000,0,0,0,94000,0,94000,94000
053337,聯電國票97購01  ,0,0,0,0,0,0,0,0,0,94000,0,0,0,132000,38000,94000,94000
059293,宏達電元富9B購01,0,0,0,0,0,0,0,0,0,93000,0,0,0,93000,0,93000,93000
058440,玉晶光統一99購02,0,0,0,0,0,0,0,0,0,93000,0,0,0,100000,7000,93000,93000
057150,貿聯國票99購02  ,0,0,0,0,0,0,0,0,0,93000,0,0,0,93000,0,93000,93000
059494,國巨國票9C購01  ,0,0,0,0,0,0,0,0,0,93000,0,0,0,200000,107000,93000,93000
057675,同欣電元大98購02,0,0,0,0,0,0,0,0,0,93000,0,0,0,129000,36000,93000,93000
059880,世紀鋼凱基99購02,0,0,0,0,0,0,0,0,0,93000,0,0,0,154000,61000,93000,93000
047885,元金2X富邦99購01,0,0,0,0,0,0,0,0,0,93000,0,0,0,93000,0,93000,93000
053725,晶相光凱基96購01,0,0,0,0,0,0,0,0,0,93000,0,0,0,93000,0,93000,93000
056239,宏達電群益98購01,0,0,0,0,0,0,0,0,0,92000,0,0,0,110000,18000,92000,92000
060337,FBVIX統一9A購01 ,0,0,0,0,0,0,0,0,0,92000,0,0,0,100000,8000,92000,92000
055936,彩晶群益98購02  ,0,0,0,0,0,0,0,0,0,92000,0,0,0,153000,61000,92000,92000
1760,寶齡富錦        ,170000,176000,-6000,0,0,0,100000,0,100000,-2000,0,2000,-2000,0,0,0,92000
060409,味全永豐9A購01  ,0,0,0,0,0,0,0,0,0,92000,0,0,0,92000,0,92000,92000
060324,台積電群益9B購02,0,0,0,0,0,0,0,0,0,91000,0,0,0,101000,10000,91000,91000
060238,強茂元大9C購01  ,0,0,0,0,0,0,0,0,0,91000,0,0,0,91000,0,91000,91000
058010,帆宣國票98購01  ,0,0,0,0,0,0,0,0,0,91000,0,0,0,188000,97000,91000,91000
057531,禾伸堂元大99購04,0,0,0,0,0,0,0,0,0,91000,0,0,0,91000,0,91000,91000
059439,健策元大9B購01  ,0,0,0,0,0,0,0,0,0,91000,0,0,0,169000,78000,91000,91000
060413,東元永豐9A購01  ,0,0,0,0,0,0,0,0,0,91000,0,0,0,91000,0,91000,91000
1734,杏輝            ,107000,15000,92000,0,0,0,0,0,0,-1000,0,1000,-1000,0,0,0,91000
07501P,華新科元大9A售07,0,0,0,0,0,0,0,0,0,91000,0,0,0,143000,52000,91000,91000
2539,櫻花建          ,35000,67000,-32000,0,0,0,0,0,0,123000,3000,0,3000,120000,0,120000,91000
057311,玉晶光日盛9A購01,0,0,0,0,0,0,0,0,0,90000,0,0,0,90000,0,90000,90000
056916,台達電兆豐98購02,0,0,0,0,0,0,0,0,0,90000,0,0,0,240000,150000,90000,90000
056735,國巨凱基99購02  ,0,0,0,0,0,0,0,0,0,90000,0,0,0,170000,80000,90000,90000
056749,滬深2X兆豐99購01,0,0,0,0,0,0,0,0,0,90000,0,0,0,100000,10000,90000,90000
059993,上銀元富99購01  ,0,0,0,0,0,0,0,0,0,90000,0,0,0,249000,159000,90000,90000
05271P,國巨富邦97售01  ,0,0,0,0,0,0,0,0,0,90000,0,0,0,90000,0,90000,90000
052701,群創國票96購01  ,0,0,0,0,0,0,0,0,0,90000,0,0,0,90000,0,90000,90000
05104P,智邦台新95售02  ,0,0,0,0,0,0,0,0,0,90000,0,0,0,90000,0,90000,90000
050759,貿聯元富94購02  ,0,0,0,0,0,0,0,0,0,90000,0,0,0,90000,0,90000,90000
050545,奇力新凱基95購01,0,0,0,0,0,0,0,0,0,90000,0,0,0,92000,2000,90000,90000
060006,華通群益9A購04  ,0,0,0,0,0,0,0,0,0,89000,0,0,0,98000,9000,89000,89000
051225,台積電群益95購02,0,0,0,0,0,0,0,0,0,89000,0,0,0,111000,22000,89000,89000
055359,超眾凱基97購01  ,0,0,0,0,0,0,0,0,0,89000,0,0,0,89000,0,89000,89000
054088,華新群益98購02  ,0,0,0,0,0,0,0,0,0,89000,0,0,0,89000,0,89000,89000
059191,茂林富邦9B購01  ,0,0,0,0,0,0,0,0,0,88000,0,0,0,100000,12000,88000,88000
060361,南亞科元富9A購03,0,0,0,0,0,0,0,0,0,88000,0,0,0,107000,19000,88000,88000
060170,世紀鋼永豐9A購01,0,0,0,0,0,0,0,0,0,87000,0,0,0,87000,0,87000,87000
055736,宏達電元富99購01,0,0,0,0,0,0,0,0,0,87000,0,0,0,205000,118000,87000,87000
07353P,大立光國票99售02,0,0,0,0,0,0,0,0,0,87000,0,0,0,200000,113000,87000,87000
07379P,大立光元大99售30,0,0,0,0,0,0,0,0,0,87000,0,0,0,104000,17000,87000,87000
060414,中興電永豐9A購01,0,0,0,0,0,0,0,0,0,87000,0,0,0,87000,0,87000,87000
06296P,燿華元大98售01  ,0,0,0,0,0,0,0,0,0,87000,0,0,0,164000,77000,87000,87000
060158,廣達永豐9A購01  ,0,0,0,0,0,0,0,0,0,86000,0,0,0,86000,0,86000,86000
060259,潤泰全凱基9C購01,0,0,0,0,0,0,0,0,0,86000,0,0,0,136000,50000,86000,86000
059682,可成富邦9A購01  ,0,0,0,0,0,0,0,0,0,86000,0,0,0,222000,136000,86000,86000
057720,日電貿元富98購01,0,0,0,0,0,0,0,0,0,86000,0,0,0,125000,39000,86000,86000
056105,智原永豐97購01  ,0,0,0,0,0,0,0,0,0,86000,0,0,0,86000,0,86000,86000
050831,超眾凱基95購01  ,0,0,0,0,0,0,0,0,0,86000,0,0,0,106000,20000,86000,86000
07128P,大毅元大99售04  ,0,0,0,0,0,0,0,0,0,86000,0,0,0,234000,148000,86000,86000
059296,大立光元富99購06,0,0,0,0,0,0,0,0,0,85000,0,0,0,162000,77000,85000,85000
060050,鴻海凱基9B購01  ,0,0,0,0,0,0,0,0,0,85000,0,0,0,110000,25000,85000,85000
059909,鴻海元大99購36  ,0,0,0,0,0,0,0,0,0,85000,0,0,0,135000,50000,85000,85000
05038P,牧德元大95售03  ,0,0,0,0,0,0,0,0,0,85000,0,0,0,135000,50000,85000,85000
05860P,旺宏康和96售01  ,0,0,0,0,0,0,0,0,0,85000,0,0,0,92000,7000,85000,85000
054029,瀚宇博凱基96購02,0,0,0,0,0,0,0,0,0,85000,0,0,0,125000,40000,85000,85000
059294,宏達電元富9B購02,0,0,0,0,0,0,0,0,0,84000,0,0,0,84000,0,84000,84000
044364,超眾中信94購01  ,0,0,0,0,0,0,0,0,0,84000,0,0,0,84000,0,84000,84000
03980P,群創凱基95售02  ,0,0,0,0,0,0,0,0,0,84000,0,0,0,122000,38000,84000,84000
048059,欣興國泰95購01  ,0,0,0,0,0,0,0,0,0,84000,0,0,0,84000,0,84000,84000
6558,興能高          ,226000,138000,88000,0,0,0,0,0,0,-4000,0,4000,-4000,0,0,0,84000
05982P,漢唐國票96售03  ,0,0,0,0,0,0,0,0,0,83000,0,0,0,83000,0,83000,83000
059860,台積電群益9A購02,0,0,0,0,0,0,0,0,0,83000,0,0,0,112000,29000,83000,83000
052096,力成元大95購01  ,0,0,0,0,0,0,0,0,0,83000,0,0,0,83000,0,83000,83000
3312,弘憶股          ,127000,44000,83000,0,0,0,0,0,0,0,0,0,0,0,0,0,83000
06456P,聯發科統一98售03,0,0,0,0,0,0,0,0,0,83000,0,0,0,83000,0,83000,83000
052687,國泰金元大96購03,0,0,0,0,0,0,0,0,0,82000,0,0,0,82000,0,82000,82000
058337,日月光元富99購01,0,0,0,0,0,0,0,0,0,81000,0,0,0,204000,123000,81000,81000
057365,智邦元大98購07  ,0,0,0,0,0,0,0,0,0,81000,0,0,0,112000,31000,81000,81000
053386,聯詠元大96購03  ,0,0,0,0,0,0,0,0,0,81000,0,0,0,81000,0,81000,81000
050468,矽格中信94購01  ,0,0,0,0,0,0,0,0,0,81000,0,0,0,81000,0,81000,81000
055175,建準統一97購01  ,0,0,0,0,0,0,0,0,0,81000,0,0,0,145000,64000,81000,81000
059319,台光電元大99購04,0,0,0,0,0,0,0,0,0,80000,0,0,0,122000,42000,80000,80000
052364,全新國票95購02  ,0,0,0,0,0,0,0,0,0,80000,0,0,0,80000,0,80000,80000
052174,聯發科元大95購13,0,0,0,0,0,0,0,0,0,80000,0,0,0,100000,20000,80000,80000
050854,世紀鋼國票97購01,0,0,0,0,0,0,0,0,0,80000,0,0,0,80000,0,80000,80000
051677,達方元大95購01  ,0,0,0,0,0,0,0,0,0,80000,0,0,0,80000,0,80000,80000
053305,聯詠凱基96購02  ,0,0,0,0,0,0,0,0,0,80000,0,0,0,80000,0,80000,80000
054198,台積電永昌96購08,0,0,0,0,0,0,0,0,0,80000,0,0,0,80000,0,80000,80000
06124P,超眾元大97售03  ,0,0,0,0,0,0,0,0,0,80000,0,0,0,80000,0,80000,80000
06902P,聯電凱基98售02  ,0,0,0,0,0,0,0,0,0,80000,0,0,0,80000,0,80000,80000
1338,廣華-KY         ,180000,100000,80000,0,0,0,0,0,0,0,0,0,0,0,0,0,80000
4137,麗豐-KY         ,117000,32000,85000,0,0,0,0,0,0,-5000,0,4000,-4000,0,1000,-1000,80000
6202,盛群            ,196000,143000,53000,0,0,0,0,0,0,27000,3000,13000,-10000,41000,4000,37000,80000
2392,正崴            ,519000,361460,157540,0,0,0,0,5563,-5563,-72000,32000,91000,-59000,4000,17000,-13000,79977
059744,禾伸堂元富99購02,0,0,0,0,0,0,0,0,0,79000,0,0,0,89000,10000,79000,79000
059042,世紀鋼群益99購02,0,0,0,0,0,0,0,0,0,79000,0,0,0,146000,67000,79000,79000
052995,上銀康和96購01  ,0,0,0,0,0,0,0,0,0,79000,0,0,0,79000,0,79000,79000
6672,騰輝電子-KY     ,107000,28000,79000,0,0,0,0,0,0,0,0,0,0,0,0,0,79000
058913,元油2X元富01購01,0,0,0,0,0,0,0,0,0,78000,0,0,0,78000,0,78000,78000
053403,彩晶群益98購01  ,0,0,0,0,0,0,0,0,0,78000,0,0,0,132000,54000,78000,78000
056023,晶豪科群益97購01,0,0,0,0,0,0,0,0,0,78000,0,0,0,78000,0,78000,78000
059961,T50反1凱基99購09,0,0,0,0,0,0,0,0,0,78000,0,0,0,102000,24000,78000,78000
051127,同欣電群益95購01,0,0,0,0,0,0,0,0,0,78000,0,0,0,78000,0,78000,78000
053593,晶技元大98購01  ,0,0,0,0,0,0,0,0,0,78000,0,0,0,359000,281000,78000,78000
060402,神隆國泰9B購01  ,0,0,0,0,0,0,0,0,0,78000,0,0,0,244000,166000,78000,78000
06188P,大立光元富97售01,0,0,0,0,0,0,0,0,0,78000,0,0,0,82000,4000,78000,78000
05731P,創意統一96售03  ,0,0,0,0,0,0,0,0,0,77000,0,0,0,100000,23000,77000,77000
060021,立積康和99購01  ,0,0,0,0,0,0,0,0,0,77000,0,0,0,195000,118000,77000,77000
055714,智邦元大97購03  ,0,0,0,0,0,0,0,0,0,77000,0,0,0,83000,6000,77000,77000
055874,中環元富9A購01  ,0,0,0,0,0,0,0,0,0,77000,0,0,0,629000,552000,77000,77000
053347,茂林國票98購01  ,0,0,0,0,0,0,0,0,0,77000,0,0,0,225000,148000,77000,77000
054243,國喬元大96購01  ,0,0,0,0,0,0,0,0,0,77000,0,0,0,77000,0,77000,77000
057101,新光金中信9A購01,0,0,0,0,0,0,0,0,0,76000,0,0,0,76000,0,76000,76000
054300,華通凱基96購07  ,0,0,0,0,0,0,0,0,0,76000,0,0,0,76000,0,76000,76000
055647,義隆元富97購01  ,0,0,0,0,0,0,0,0,0,76000,0,0,0,76000,0,76000,76000
056519,創意國票99購01  ,0,0,0,0,0,0,0,0,0,76000,0,0,0,76000,0,76000,76000
050588,矽創國票95購01  ,0,0,0,0,0,0,0,0,0,76000,0,0,0,76000,0,76000,76000
052325,高股息中信99購01,0,0,0,0,0,0,0,0,0,76000,0,0,0,76000,0,76000,76000
3437,榮創            ,253000,177000,76000,0,0,0,0,0,0,0,0,0,0,0,0,0,76000
056281,深中小永豐97購01,0,0,0,0,0,0,0,0,0,75000,0,0,0,90000,15000,75000,75000
056187,京鼎統一97購01  ,0,0,0,0,0,0,0,0,0,75000,0,0,0,96000,21000,75000,75000
059858,台灣50群益9A購09,0,0,0,0,0,0,0,0,0,75000,0,0,0,75000,0,75000,75000
060001,台灣50群益9A購10,0,0,0,0,0,0,0,0,0,75000,0,0,0,125000,50000,75000,75000
058160,奇鋐元富99購01  ,0,0,0,0,0,0,0,0,0,75000,0,0,0,282000,207000,75000,75000
058456,京鼎永豐99購01  ,0,0,0,0,0,0,0,0,0,75000,0,0,0,155000,80000,75000,75000
051451,世芯元大95購03  ,0,0,0,0,0,0,0,0,0,75000,0,0,0,75000,0,75000,75000
03669C,滬深2X元富09牛01,0,0,0,0,0,0,0,0,0,75000,0,0,0,75000,0,75000,75000
048572,美利達元大96購04,0,0,0,0,0,0,0,0,0,75000,0,0,0,75000,0,75000,75000
060548,友達凱基9B購03  ,0,0,0,0,0,0,0,0,0,75000,0,0,0,95000,20000,75000,75000
059286,S&P正2元富01購03,0,0,0,0,0,0,0,0,0,74000,0,0,0,92000,18000,74000,74000
057566,欣興富邦99購01  ,0,0,0,0,0,0,0,0,0,74000,0,0,0,74000,0,74000,74000
057587,微星國票99購01  ,0,0,0,0,0,0,0,0,0,74000,0,0,0,74000,0,74000,74000
055049,智邦永豐97購01  ,0,0,0,0,0,0,0,0,0,74000,0,0,0,105000,31000,74000,74000
059080,亞泥元大99購01  ,0,0,0,0,0,0,0,0,0,73000,0,0,0,250000,177000,73000,73000
059090,台新金元大99購01,0,0,0,0,0,0,0,0,0,73000,0,0,0,73000,0,73000,73000
057821,晶相光元大98購03,0,0,0,0,0,0,0,0,0,73000,0,0,0,73000,0,73000,73000
049909,國巨元大95購01  ,0,0,0,0,0,0,0,0,0,73000,0,0,0,73000,0,73000,73000
053754,英業達元富96購02,0,0,0,0,0,0,0,0,0,73000,0,0,0,73000,0,73000,73000
058812,台積電統一9B購06,0,0,0,0,0,0,0,0,0,72000,0,0,0,124000,52000,72000,72000
052406,力成凱基95購03  ,0,0,0,0,0,0,0,0,0,72000,0,0,0,74000,2000,72000,72000
059461,鈺齊永豐99購03  ,0,0,0,0,0,0,0,0,0,72000,0,0,0,77000,5000,72000,72000
054907,帆宣康和97購01  ,0,0,0,0,0,0,0,0,0,72000,0,0,0,138000,66000,72000,72000
07490P,大立光國票9A售03,0,0,0,0,0,0,0,0,0,72000,0,0,0,77000,5000,72000,72000
058146,勤誠元大99購01  ,0,0,0,0,0,0,0,0,0,71000,0,0,0,80000,9000,71000,71000
059823,奇力新凱基99購07,0,0,0,0,0,0,0,0,0,71000,0,0,0,75000,4000,71000,71000
054951,大毅元大97購01  ,0,0,0,0,0,0,0,0,0,71000,0,0,0,115000,44000,71000,71000
054609,正崴永豐97購01  ,0,0,0,0,0,0,0,0,0,71000,0,0,0,78000,7000,71000,71000
055470,南亞科凱基97購01,0,0,0,0,0,0,0,0,0,71000,0,0,0,210000,139000,71000,71000
059437,京鼎元大99購02  ,0,0,0,0,0,0,0,0,0,71000,0,0,0,92000,21000,71000,71000
059827,晶技凱基99購03  ,0,0,0,0,0,0,0,0,0,70000,0,0,0,503000,433000,70000,70000
056343,高鐵凱基98購02  ,0,0,0,0,0,0,0,0,0,70000,0,0,0,110000,40000,70000,70000
058751,南茂凱基9A購01  ,0,0,0,0,0,0,0,0,0,70000,0,0,0,70000,0,70000,70000
057172,南亞科元大98購03,0,0,0,0,0,0,0,0,0,70000,0,0,0,70000,0,70000,70000
058403,玉晶光元大99購12,0,0,0,0,0,0,0,0,0,70000,0,0,0,203000,133000,70000,70000
058501,S&P正2元大99購01,0,0,0,0,0,0,0,0,0,70000,0,0,0,70000,0,70000,70000
058532,禾伸堂元富99購01,0,0,0,0,0,0,0,0,0,70000,0,0,0,85000,15000,70000,70000
053584,友達元大9B購02  ,0,0,0,0,0,0,0,0,0,70000,0,0,0,100000,30000,70000,70000
053693,欣興元大96購05  ,0,0,0,0,0,0,0,0,0,70000,0,0,0,70000,0,70000,70000
055295,瀚宇博元大97購02,0,0,0,0,0,0,0,0,0,70000,0,0,0,130000,60000,70000,70000
045444,群創元富98購02  ,0,0,0,0,0,0,0,0,0,70000,0,0,0,70000,0,70000,70000
043513,台灣50元大96購05,0,0,0,0,0,0,0,0,0,70000,0,0,0,70000,0,70000,70000
07407P,欣興凱基99售07  ,0,0,0,0,0,0,0,0,0,70000,0,0,0,142000,72000,70000,70000
07257P,臺股指凱基99售37,0,0,0,0,0,0,0,0,0,70000,0,0,0,90000,20000,70000,70000
3060,銘異            ,128000,58000,70000,0,0,0,0,0,0,0,0,0,0,0,0,0,70000
058753,元石油群益9B購03,0,0,0,0,0,0,0,0,0,69000,0,0,0,69000,0,69000,69000
060020,康控康和99購01  ,0,0,0,0,0,0,0,0,0,69000,0,0,0,129000,60000,69000,69000
059037,宏達電群益99購02,0,0,0,0,0,0,0,0,0,69000,0,0,0,87000,18000,69000,69000
055407,祥碩國泰98購01  ,0,0,0,0,0,0,0,0,0,69000,0,0,0,154000,85000,69000,69000
9955,佳龍            ,102000,33000,69000,0,0,0,0,0,0,0,0,0,0,0,0,0,69000
060432,達方永豐9A購01  ,0,0,0,0,0,0,0,0,0,68000,0,0,0,68000,0,68000,68000
059831,聯詠康和99購01  ,0,0,0,0,0,0,0,0,0,68000,0,0,0,68000,0,68000,68000
059322,晶技元大99購06  ,0,0,0,0,0,0,0,0,0,68000,0,0,0,663000,595000,68000,68000
054399,智易永豐96購03  ,0,0,0,0,0,0,0,0,0,68000,0,0,0,69000,1000,68000,68000
07300P,臺股指元大9A售33,0,0,0,0,0,0,0,0,0,68000,0,0,0,222000,154000,68000,68000
06934P,聯鈞元大98售03  ,0,0,0,0,0,0,0,0,0,68000,0,0,0,68000,0,68000,68000
06504P,麗豐國票99售02  ,0,0,0,0,0,0,0,0,0,68000,0,0,0,95000,27000,68000,68000
07467P,上銀元大9A售03  ,0,0,0,0,0,0,0,0,0,68000,0,0,0,168000,100000,68000,68000
2399,映泰            ,101000,32000,69000,0,0,0,0,0,0,-1000,0,1000,-1000,0,0,0,68000
2453,凌群            ,85000,17000,68000,0,0,0,0,0,0,0,0,0,0,0,0,0,68000
059282,嘉聯益永豐99購01,0,0,0,0,0,0,0,0,0,67000,0,0,0,90000,23000,67000,67000
059636,宏達電凱基99購05,0,0,0,0,0,0,0,0,0,67000,0,0,0,94000,27000,67000,67000
057286,群創元大9B購05  ,0,0,0,0,0,0,0,0,0,67000,0,0,0,330000,263000,67000,67000
055255,欣興統一97購02  ,0,0,0,0,0,0,0,0,0,67000,0,0,0,67000,0,67000,67000
052223,聯電凱基96購02  ,0,0,0,0,0,0,0,0,0,67000,0,0,0,187000,120000,67000,67000
06584P,欣興凱基98售03  ,0,0,0,0,0,0,0,0,0,67000,0,0,0,69000,2000,67000,67000
06142P,台虹康和97售02  ,0,0,0,0,0,0,0,0,0,67000,0,0,0,86000,19000,67000,67000
4164,承業醫          ,110000,43000,67000,0,0,0,0,0,0,0,1000,1000,0,0,0,0,67000
059281,創意永豐99購02  ,0,0,0,0,0,0,0,0,0,66000,0,0,0,96000,30000,66000,66000
050322,世紀鋼國票95購01,0,0,0,0,0,0,0,0,0,66000,0,0,0,69000,3000,66000,66000
049010,台表科麥證95購01,0,0,0,66000,0,66000,0,0,0,66000,0,0,0,66000,0,66000,66000
057849,南茂永豐98購02  ,0,0,0,0,0,0,0,0,0,65000,0,0,0,160000,95000,65000,65000
057924,健策凱基98購02  ,0,0,0,0,0,0,0,0,0,65000,0,0,0,120000,55000,65000,65000
056314,力成元大97購01  ,0,0,0,0,0,0,0,0,0,65000,0,0,0,143000,78000,65000,65000
056398,南茂永豐98購01  ,0,0,0,0,0,0,0,0,0,65000,0,0,0,153000,88000,65000,65000
060466,玉山金元大9A購01,0,0,0,0,0,0,0,0,0,65000,0,0,0,83000,18000,65000,65000
059704,聯發科凱基9A購08,0,0,0,0,0,0,0,0,0,65000,0,0,0,100000,35000,65000,65000
052135,聯發科凱基9B購01,0,0,0,0,0,0,0,0,0,65000,0,0,0,65000,0,65000,65000
050686,欣興兆豐96購01  ,0,0,0,0,0,0,0,0,0,65000,0,0,0,65000,0,65000,65000
4564,元翎            ,143000,78000,65000,0,0,0,0,0,0,0,0,0,0,0,0,0,65000
4915,致伸            ,307000,205990,101010,0,0,0,0,1250,-1250,-35000,0,16000,-16000,0,19000,-19000,64760
2412,中華電          ,1220000,839250,380750,0,0,0,0,14275,-14275,-302000,192000,491000,-299000,0,3000,-3000,64475
056342,中工凱基98購01  ,0,0,0,0,0,0,0,0,0,64000,0,0,0,136000,72000,64000,64000
056909,嘉聯益元大99購03,0,0,0,0,0,0,0,0,0,64000,0,0,0,73000,9000,64000,64000
059615,台灣50群益99購05,0,0,0,0,0,0,0,0,0,64000,0,0,0,64000,0,64000,64000
05529P,臺股指群益96售02,0,0,0,0,0,0,0,0,0,64000,0,0,0,113000,49000,64000,64000
054892,彩晶統一99購01  ,0,0,0,0,0,0,0,0,0,64000,0,0,0,73000,9000,64000,64000
055092,開發金群益9B購01,0,0,0,0,0,0,0,0,0,64000,0,0,0,144000,80000,64000,64000
055808,世紀鋼永豐97購01,0,0,0,0,0,0,0,0,0,64000,0,0,0,67000,3000,64000,64000
055730,建準元富97購02  ,0,0,0,0,0,0,0,0,0,64000,0,0,0,64000,0,64000,64000
1231,聯華食          ,84000,17000,67000,0,0,0,0,0,0,-3000,0,3000,-3000,0,0,0,64000
057788,嘉聯益國票99購01,0,0,0,0,0,0,0,0,0,63000,0,0,0,64000,1000,63000,63000
057482,微星元大98購03  ,0,0,0,0,0,0,0,0,0,63000,0,0,0,63000,0,63000,63000
059998,華航元富99購02  ,0,0,0,0,0,0,0,0,0,63000,0,0,0,103000,40000,63000,63000
056818,正崴永豐98購01  ,0,0,0,0,0,0,0,0,0,63000,0,0,0,131000,68000,63000,63000
05297P,臻鼎凱基95售04  ,0,0,0,0,0,0,0,0,0,63000,0,0,0,73000,10000,63000,63000
1519,華城            ,96000,37000,59000,0,0,0,0,0,0,4000,4000,0,4000,0,0,0,63000
059728,聯鈞元大99購01  ,0,0,0,0,0,0,0,0,0,62000,0,0,0,115000,53000,62000,62000
057284,新日興元大98購03,0,0,0,0,0,0,0,0,0,62000,0,0,0,62000,0,62000,62000
058117,元石油群益9B購02,0,0,0,0,0,0,0,0,0,62000,0,0,0,62000,0,62000,62000
053399,創意中信96購01  ,0,0,0,0,0,0,0,0,0,62000,0,0,0,63000,1000,62000,62000
056410,康控國票99購01  ,0,0,0,0,0,0,0,0,0,62000,0,0,0,106000,44000,62000,62000
00686R,群益臺灣加權反1 ,0,0,0,0,0,0,0,0,0,62000,0,0,0,138000,76000,62000,62000
06848P,聯詠元大98售04  ,0,0,0,0,0,0,0,0,0,62000,0,0,0,65000,3000,62000,62000
2498,宏達電          ,1506001,1088920,417081,0,0,0,0,3924,-3924,-352000,4000,29000,-25000,27000,354000,-327000,61157
058228,為升元大99購01  ,0,0,0,0,0,0,0,0,0,61000,0,0,0,61000,0,61000,61000
058498,世紀鋼群益99購01,0,0,0,0,0,0,0,0,0,61000,0,0,0,61000,0,61000,61000
056151,建準凱基97購01  ,0,0,0,0,0,0,0,0,0,61000,0,0,0,81000,20000,61000,61000
07311P,台灣50元大99售09,0,0,0,0,0,0,0,0,0,61000,0,0,0,61000,0,61000,61000
2471,資通            ,134000,74000,60000,0,0,0,0,0,0,1000,1000,0,1000,0,0,0,61000
059150,臺股指國票99購13,0,0,0,0,0,0,0,0,0,60000,0,0,0,60000,0,60000,60000
060385,台勝科凱基9A購01,0,0,0,0,0,0,0,0,0,60000,0,0,0,119000,59000,60000,60000
056764,友達元大9A購03  ,0,0,0,0,0,0,0,0,0,60000,0,0,0,60000,0,60000,60000
056506,晶豪科永豐98購02,0,0,0,0,0,0,0,0,0,60000,0,0,0,90000,30000,60000,60000
057569,光磊永豐98購03  ,0,0,0,0,0,0,0,0,0,60000,0,0,0,60000,0,60000,60000
055702,美律富邦98購01  ,0,0,0,0,0,0,0,0,0,60000,0,0,0,60000,0,60000,60000
046645,技嘉國泰94購01  ,0,0,0,0,0,0,0,0,0,60000,0,0,0,60000,0,60000,60000
052560,康舒國票97購01  ,0,0,0,0,0,0,0,0,0,60000,0,0,0,153000,93000,60000,60000
051384,康友群益95購01  ,0,0,0,0,0,0,0,0,0,60000,0,0,0,60000,0,60000,60000
052363,廣達國票96購01  ,0,0,0,0,0,0,0,0,0,60000,0,0,0,60000,0,60000,60000
050369,台積電元大94購23,0,0,0,0,0,0,0,0,0,60000,0,0,0,60000,0,60000,60000
050458,台郡元大94購03  ,0,0,0,0,0,0,0,0,0,60000,0,0,0,61000,1000,60000,60000
4977,眾達-KY         ,189000,126000,63000,0,0,0,0,0,0,-3000,0,0,0,0,3000,-3000,60000
059696,立積永豐99購03  ,0,0,0,0,0,0,0,0,0,59000,0,0,0,93000,34000,59000,59000
046344,超眾國票94購01  ,0,0,0,0,0,0,0,0,0,59000,0,0,0,239000,180000,59000,59000
00650L,FH香港正2       ,4000,10000,-6000,0,0,0,0,0,0,65000,0,0,0,79000,14000,65000,59000
059968,世紀鋼凱基99購03,0,0,0,0,0,0,0,0,0,59000,0,0,0,100000,41000,59000,59000
6452,康友-KY         ,175000,101000,74000,0,0,0,0,0,0,-15000,0,18000,-18000,8000,5000,3000,59000
07516P,台積電元大9A售16,0,0,0,0,0,0,0,0,0,59000,0,0,0,59000,0,59000,59000
07208P,台積電凱基99售14,0,0,0,0,0,0,0,0,0,59000,0,0,0,59000,0,59000,59000
06437P,玉晶光國票99售01,0,0,0,0,0,0,0,0,0,59000,0,0,0,70000,11000,59000,59000
059606,上銀富邦9B購02  ,0,0,0,0,0,0,0,0,0,58000,0,0,0,58000,0,58000,58000
056091,百和統一97購01  ,0,0,0,0,0,0,0,0,0,58000,0,0,0,84000,26000,58000,58000
055893,大立光統一97購07,0,0,0,0,0,0,0,0,0,58000,0,0,0,168000,110000,58000,58000
053542,超眾永豐96購01  ,0,0,0,0,0,0,0,0,0,58000,0,0,0,133000,75000,58000,58000
060559,世紀鋼凱基9C購01,0,0,0,0,0,0,0,0,0,58000,0,0,0,86000,28000,58000,58000
4133,亞諾法          ,112000,54000,58000,0,0,0,0,0,0,0,0,0,0,0,0,0,58000
059325,超眾元大99購05  ,0,0,0,0,0,0,0,0,0,57000,0,0,0,57000,0,57000,57000
057048,新日興元大98購01,0,0,0,0,0,0,0,0,0,57000,0,0,0,106000,49000,57000,57000
060422,台勝科永豐9A購01,0,0,0,0,0,0,0,0,0,57000,0,0,0,82000,25000,57000,57000
051281,健策兆豐96購01  ,0,0,0,0,0,0,0,0,0,57000,0,0,0,106000,49000,57000,57000
050536,亞泥凱基95購01  ,0,0,0,0,0,0,0,0,0,57000,0,0,0,82000,25000,57000,57000
054261,智伸科元大96購03,0,0,0,0,0,0,0,0,0,57000,0,0,0,60000,3000,57000,57000
059051,和大凱基9A購01  ,0,0,0,0,0,0,0,0,0,56000,0,0,0,108000,52000,56000,56000
057793,群創統一99購02  ,0,0,0,0,0,0,0,0,0,56000,0,0,0,56000,0,56000,56000
054919,興富發凱基97購01,0,0,0,0,0,0,0,0,0,56000,0,0,0,56000,0,56000,56000
020000,富邦特選蘋果N   ,0,0,0,0,0,0,0,0,0,56000,0,0,0,62000,6000,56000,56000
6533,晶心科          ,107000,49000,58000,0,0,0,0,0,0,-2000,0,2000,-2000,0,0,0,56000
06681P,致茂元大98售02  ,0,0,0,0,0,0,0,0,0,56000,0,0,0,56000,0,56000,56000
060015,國巨康和99購03  ,0,0,0,0,0,0,0,0,0,55000,0,0,0,410000,355000,55000,55000
058397,大成鋼元大99購02,0,0,0,0,0,0,0,0,0,55000,0,0,0,55000,0,55000,55000
058400,聯發科元大99購09,0,0,0,0,0,0,0,0,0,55000,0,0,0,70000,15000,55000,55000
057096,緯穎元富98購01  ,0,0,0,0,0,0,0,0,0,55000,0,0,0,58000,3000,55000,55000
060164,合勤控永豐9A購01,0,0,0,0,0,0,0,0,0,55000,0,0,0,55000,0,55000,55000
060445,S&P反1元大9A購04,0,0,0,0,0,0,0,0,0,55000,0,0,0,55000,0,55000,55000
057916,國巨凱基98購13  ,0,0,0,0,0,0,0,0,0,55000,0,0,0,100000,45000,55000,55000
047541,深中小凱基94購01,0,0,0,0,0,0,0,0,0,55000,0,0,0,55000,0,55000,55000
050780,台表科元大96購01,0,0,0,0,0,0,0,0,0,55000,0,0,0,55000,0,55000,55000
051416,創意國票96購02  ,0,0,0,0,0,0,0,0,0,55000,0,0,0,55000,0,55000,55000
052282,宏達電凱基95購05,0,0,0,0,0,0,0,0,0,55000,0,0,0,55000,0,55000,55000
054525,奇鋐元富96購01  ,0,0,0,0,0,0,0,0,0,55000,0,0,0,56000,1000,55000,55000
053064,國巨群益96購04  ,0,0,0,0,0,0,0,0,0,55000,0,0,0,55000,0,55000,55000
055387,世紀鋼元大97購01,0,0,0,0,0,0,0,0,0,55000,0,0,0,157000,102000,55000,55000
055082,台郡中信97購01  ,0,0,0,0,0,0,0,0,0,55000,0,0,0,55000,0,55000,55000
06748P,智邦台新98售02  ,0,0,0,0,0,0,0,0,0,55000,0,0,0,60000,5000,55000,55000
058555,矽創永豐9A購01  ,0,0,0,0,0,0,0,0,0,54000,0,0,0,179000,125000,54000,54000
058797,大毅元大99購03  ,0,0,0,0,0,0,0,0,0,54000,0,0,0,135000,81000,54000,54000
056616,台光電永豐98購01,0,0,0,0,0,0,0,0,0,54000,0,0,0,142000,88000,54000,54000
057241,超眾凱基99購02  ,0,0,0,0,0,0,0,0,0,54000,0,0,0,70000,16000,54000,54000
056549,嘉聯益凱基98購04,0,0,0,0,0,0,0,0,0,53000,0,0,0,53000,0,53000,53000
059064,緯穎凱基99購02  ,0,0,0,0,0,0,0,0,0,53000,0,0,0,59000,6000,53000,53000
056657,華邦電元大99購01,0,0,0,0,0,0,0,0,0,53000,0,0,0,68000,15000,53000,53000
060124,奇力新永豐99購03,0,0,0,0,0,0,0,0,0,53000,0,0,0,75000,22000,53000,53000
059912,國巨元大99購28  ,0,0,0,0,0,0,0,0,0,53000,0,0,0,228000,175000,53000,53000
05331P,上証2X國票96售01,0,0,0,0,0,0,0,0,0,53000,0,0,0,55000,2000,53000,53000
057104,康友中信99購01  ,0,0,0,0,0,0,0,0,0,52000,0,0,0,52000,0,52000,52000
059821,美律凱基99購08  ,0,0,0,0,0,0,0,0,0,52000,0,0,0,52000,0,52000,52000
058016,智邦凱基98購06  ,0,0,0,0,0,0,0,0,0,52000,0,0,0,62000,10000,52000,52000
056267,文曄統一97購02  ,0,0,0,0,0,0,0,0,0,52000,0,0,0,52000,0,52000,52000
059438,群創元大99購06  ,0,0,0,0,0,0,0,0,0,52000,0,0,0,52000,0,52000,52000
07355P,臺股指國票99售23,0,0,0,0,0,0,0,0,0,52000,0,0,0,61000,9000,52000,52000
1522,堤維西          ,117000,62000,55000,0,0,0,0,0,0,-3000,0,3000,-3000,0,0,0,52000
060066,欣興兆豐9B購01  ,0,0,0,0,0,0,0,0,0,51000,0,0,0,110000,59000,51000,51000
05921P,同欣電元大96售06,0,0,0,0,0,0,0,0,0,51000,0,0,0,56000,5000,51000,51000
057650,力成元大98購04  ,0,0,0,0,0,0,0,0,0,51000,0,0,0,60000,9000,51000,51000
057746,同欣電永豐98購02,0,0,0,0,0,0,0,0,0,51000,0,0,0,51000,0,51000,51000
056075,瀚宇博元大97購03,0,0,0,0,0,0,0,0,0,51000,0,0,0,234000,183000,51000,51000
055989,矽力元富9A購01  ,0,0,0,0,0,0,0,0,0,51000,0,0,0,241000,190000,51000,51000
055556,奇力新凱基98購03,0,0,0,0,0,0,0,0,0,51000,0,0,0,91000,40000,51000,51000
058690,元油2X國票9A購03,0,0,0,0,0,0,0,0,0,50000,0,0,0,50000,0,50000,50000
059486,A50正2兆豐9A購01,0,0,0,0,0,0,0,0,0,50000,0,0,0,50000,0,50000,50000
057799,世紀鋼兆豐98購01,0,0,0,0,0,0,0,0,0,50000,0,0,0,70000,20000,50000,50000
057419,奇力新凱基98購06,0,0,0,0,0,0,0,0,0,50000,0,0,0,50000,0,50000,50000
059161,鴻海凱基9A購09  ,0,0,0,0,0,0,0,0,0,50000,0,0,0,50000,0,50000,50000
059558,T50正2凱基9C購03,0,0,0,0,0,0,0,0,0,50000,0,0,0,50000,0,50000,50000
060151,旺宏富邦9A購02  ,0,0,0,0,0,0,0,0,0,50000,0,0,0,70000,20000,50000,50000
060359,國巨元富9A購02  ,0,0,0,0,0,0,0,0,0,50000,0,0,0,72000,22000,50000,50000
056642,旺宏凱基98購07  ,0,0,0,0,0,0,0,0,0,50000,0,0,0,50000,0,50000,50000
054313,麗豐凱基96購02  ,0,0,0,0,0,0,0,0,0,50000,0,0,0,50000,0,50000,50000
054567,拓凱群益98購01  ,0,0,0,0,0,0,0,0,0,50000,0,0,0,50000,0,50000,50000
054657,道瓊銀元大97購01,0,0,0,0,0,0,0,0,0,50000,0,0,0,50000,0,50000,50000
053422,可成永豐96購01  ,0,0,0,0,0,0,0,0,0,50000,0,0,0,50000,0,50000,50000
053020,貿聯元富96購01  ,0,0,0,0,0,0,0,0,0,50000,0,0,0,50000,0,50000,50000
053022,欣興國泰98購01  ,0,0,0,0,0,0,0,0,0,50000,0,0,0,50000,0,50000,50000
055779,國泰金凱基97購02,0,0,0,0,0,0,0,0,0,50000,0,0,0,50000,0,50000,50000
055015,帆宣元富97購01  ,0,0,0,0,0,0,0,0,0,50000,0,0,0,90000,40000,50000,50000
055027,牧德國泰99購01  ,0,0,0,0,0,0,0,0,0,50000,0,0,0,50000,0,50000,50000
05423P,聯電亞東95售02  ,0,0,0,0,0,0,0,0,0,50000,0,0,0,50000,0,50000,50000
057573,京鼎永豐98購02  ,0,0,0,0,0,0,0,0,0,50000,0,0,0,208000,158000,50000,50000
052372,台泥元大95購02  ,0,0,0,0,0,0,0,0,0,50000,0,0,0,50000,0,50000,50000
052167,亞泥元大96購01  ,0,0,0,0,0,0,0,0,0,50000,0,0,0,50000,0,50000,50000
049864,聯發科兆豐94購01,0,0,0,0,0,0,0,0,0,50000,0,0,0,50000,0,50000,50000
050495,大立光永昌96購01,0,0,0,0,0,0,0,0,0,50000,0,0,0,50000,0,50000,50000
051365,瀚宇博國泰97購01,0,0,0,0,0,0,0,0,0,50000,0,0,0,50000,0,50000,50000
051271,華新科群益95購04,0,0,0,0,0,0,0,0,0,50000,0,0,0,50000,0,50000,50000
051113,聯電元富95購01  ,0,0,0,0,0,0,0,0,0,50000,0,0,0,50000,0,50000,50000
050899,旭富元大95購01  ,0,0,0,0,0,0,0,0,0,50000,0,0,0,50000,0,50000,50000
050710,元黃金中信96購01,0,0,0,0,0,0,0,0,0,50000,0,0,0,50000,0,50000,50000
053519,力成群益96購02  ,0,0,0,0,0,0,0,0,0,50000,0,0,0,50000,0,50000,50000
053667,鴻海統一96購12  ,0,0,0,0,0,0,0,0,0,50000,0,0,0,50000,0,50000,50000
052456,滬深2X元富9B購03,0,0,0,0,0,0,0,0,0,50000,0,0,0,50000,0,50000,50000
05246P,南電元大95售04  ,0,0,0,0,0,0,0,0,0,50000,0,0,0,50000,0,50000,50000
055162,新唐元大97購01  ,0,0,0,0,0,0,0,0,0,50000,0,0,0,100000,50000,50000,50000
055171,凱美統一97購01  ,0,0,0,0,0,0,0,0,0,50000,0,0,0,50000,0,50000,50000
047697,台郡國票94購02  ,0,0,0,0,0,0,0,0,0,50000,0,0,0,50000,0,50000,50000
04649P,臺股指凱基94售08,0,0,0,0,0,0,0,0,0,50000,0,0,0,445000,395000,50000,50000
046391,上海銀統一94購01,0,0,0,0,0,0,0,0,0,50000,0,0,0,50000,0,50000,50000
07341P,台積電凱基99售18,0,0,0,0,0,0,0,0,0,50000,0,0,0,265000,215000,50000,50000
07413P,國巨元大99售33  ,0,0,0,0,0,0,0,0,0,50000,0,0,0,118000,68000,50000,50000
5531,鄉林            ,220000,176000,44000,0,0,0,0,0,0,6000,14000,8000,6000,0,0,0,50000
060240,富邦金元大9A購01,0,0,0,0,0,0,0,0,0,49000,0,0,0,341000,292000,49000,49000
060144,全新國票9B購01  ,0,0,0,0,0,0,0,0,0,49000,0,0,0,87000,38000,49000,49000
057093,臻鼎元富98購02  ,0,0,0,0,0,0,0,0,0,49000,0,0,0,50000,1000,49000,49000
056586,光罩統一98購02  ,0,0,0,0,0,0,0,0,0,49000,0,0,0,68000,19000,49000,49000
05947P,大成鋼元大96售03,0,0,0,0,0,0,0,0,0,49000,0,0,0,110000,61000,49000,49000
058686,祥碩凱基99購03  ,0,0,0,0,0,0,0,0,0,49000,0,0,0,276000,227000,49000,49000
058744,FBVIX凱基9C購03 ,0,0,0,0,0,0,0,0,0,49000,0,0,0,50000,1000,49000,49000
058704,台積電元大99購17,0,0,0,0,0,0,0,0,0,49000,0,0,0,52000,3000,49000,49000
060024,T50反1國泰9B購02,0,0,0,0,0,0,0,0,0,49000,0,0,0,50000,1000,49000,49000
049156,緯穎元大96購01  ,0,0,0,0,0,0,0,0,0,49000,0,0,0,55000,6000,49000,49000
03035X,元展32          ,0,0,0,0,0,0,0,0,0,49000,0,0,0,50000,1000,49000,49000
051392,玉山金兆豐95購01,0,0,0,0,0,0,0,0,0,49000,0,0,0,49000,0,49000,49000
05148P,臻鼎元大95售01  ,0,0,0,0,0,0,0,0,0,49000,0,0,0,49000,0,49000,49000
052295,揚明光國票96購03,0,0,0,0,0,0,0,0,0,49000,0,0,0,49000,0,49000,49000
056426,上証2X凱基9A購01,0,0,0,0,0,0,0,0,0,49000,0,0,0,50000,1000,49000,49000
2636,台驊投控        ,29000,42000,-13000,0,0,0,0,0,0,62000,63000,1000,62000,0,0,0,49000
060554,中租凱基9A購01  ,0,0,0,0,0,0,0,0,0,49000,0,0,0,49000,0,49000,49000
057319,奇力新凱基99購02,0,0,0,0,0,0,0,0,0,48000,0,0,0,49000,1000,48000,48000
056614,智邦永豐98購01  ,0,0,0,0,0,0,0,0,0,48000,0,0,0,48000,0,48000,48000
059101,康控統一9A購01  ,0,0,0,0,0,0,0,0,0,48000,0,0,0,48000,0,48000,48000
059907,道瓊指元大99購03,0,0,0,0,0,0,0,0,0,48000,0,0,0,53000,5000,48000,48000
058989,茂林凱基99購02  ,0,0,0,0,0,0,0,0,0,48000,0,0,0,68000,20000,48000,48000
056263,友訊統一99購01  ,0,0,0,0,0,0,0,0,0,48000,0,0,0,132000,84000,48000,48000
058975,台灣50凱基01購02,0,0,0,0,0,0,0,0,0,48000,0,0,0,49000,1000,48000,48000
059469,智邦元大99購03  ,0,0,0,0,0,0,0,0,0,48000,0,0,0,165000,117000,48000,48000
053355,超眾兆豐97購01  ,0,0,0,0,0,0,0,0,0,48000,0,0,0,149000,101000,48000,48000
054045,奇力新元大97購03,0,0,0,0,0,0,0,0,0,48000,0,0,0,122000,74000,48000,48000
06272P,台郡凱基97售04  ,0,0,0,0,0,0,0,0,0,48000,0,0,0,50000,2000,48000,48000
07500P,微星元大9A售01  ,0,0,0,0,0,0,0,0,0,48000,0,0,0,48000,0,48000,48000
1472,三洋紡          ,51000,3000,48000,0,0,0,0,0,0,0,0,0,0,0,0,0,48000
056277,上銀富邦99購02  ,0,0,0,0,0,0,0,0,0,47000,0,0,0,47000,0,47000,47000
058915,SGBR2X元富99購01,0,0,0,0,0,0,0,0,0,47000,0,0,0,54000,7000,47000,47000
059697,上証2X凱基9A購03,0,0,0,0,0,0,0,0,0,47000,0,0,0,51000,4000,47000,47000
058568,宏達電凱基9A購02,0,0,0,0,0,0,0,0,0,47000,0,0,0,82000,35000,47000,47000
057457,華邦電富邦98購01,0,0,0,0,0,0,0,0,0,47000,0,0,0,212000,165000,47000,47000
052696,玉晶光麥證97購01,0,0,0,60000,18000,42000,0,0,0,47000,0,0,0,74000,27000,47000,47000
059401,牧德元富99購01  ,0,0,0,0,0,0,0,0,0,47000,0,0,0,158000,111000,47000,47000
055231,大毅國票98購02  ,0,0,0,0,0,0,0,0,0,47000,0,0,0,69000,22000,47000,47000
055354,宏達電凱基98購01,0,0,0,0,0,0,0,0,0,47000,0,0,0,57000,10000,47000,47000
00681R,元大美債20反1   ,0,0,0,0,0,0,0,0,0,47000,0,0,0,52000,5000,47000,47000
045054,聯發科元富98購02,0,0,0,0,0,0,0,0,0,47000,0,0,0,47000,0,47000,47000
060406,瑞祺國泰9B購01  ,0,0,0,0,0,0,0,0,0,47000,0,0,0,154000,107000,47000,47000
059511,宏達電永豐99購02,0,0,0,0,0,0,0,0,0,46000,0,0,0,58000,12000,46000,46000
060437,宏全永豐9A購01  ,0,0,0,0,0,0,0,0,0,46000,0,0,0,46000,0,46000,46000
060463,台積電元大9A購10,0,0,0,0,0,0,0,0,0,46000,0,0,0,46000,0,46000,46000
058930,華新科統一9B購01,0,0,0,0,0,0,0,0,0,46000,0,0,0,46000,0,46000,46000
056202,國揚永豐97購01  ,0,0,0,0,0,0,0,0,0,46000,0,0,0,47000,1000,46000,46000
058077,超眾凱基98購02  ,0,0,0,0,0,0,0,0,0,46000,0,0,0,86000,40000,46000,46000
049820,世紀鋼元大96購03,0,0,0,0,0,0,0,0,0,46000,0,0,0,377000,331000,46000,46000
049167,元油2X凱基97購03,46000,0,46000,0,0,0,0,0,0,0,0,0,0,0,0,0,46000
055216,友達凱基98購05  ,0,0,0,0,0,0,0,0,0,46000,0,0,0,62000,16000,46000,46000
055716,致茂元大97購01  ,0,0,0,0,0,0,0,0,0,46000,0,0,0,72000,26000,46000,46000
2939,凱羿-KY         ,91000,45000,46000,0,0,0,0,0,0,0,0,0,0,0,0,0,46000
3588,通嘉            ,125000,79000,46000,0,0,0,0,0,0,0,0,0,0,0,0,0,46000
059733,緯穎元大99購08  ,0,0,0,0,0,0,0,0,0,45000,0,0,0,73000,28000,45000,45000
057656,大成鋼兆豐98購01,0,0,0,0,0,0,0,0,0,45000,0,0,0,55000,10000,45000,45000
057764,台表科凱基9A購01,0,0,0,0,0,0,0,0,0,45000,0,0,0,45000,0,45000,45000
057374,禾伸堂元大99購03,0,0,0,0,0,0,0,0,0,45000,0,0,0,45000,0,45000,45000
058333,鴻海元富99購04  ,0,0,0,0,0,0,0,0,0,45000,0,0,0,100000,55000,45000,45000
059628,智邦凱基99購04  ,0,0,0,0,0,0,0,0,0,45000,0,0,0,127000,82000,45000,45000
054148,矽創元大96購03  ,0,0,0,0,0,0,0,0,0,45000,0,0,0,45000,0,45000,45000
054197,台積電永昌96購07,0,0,0,0,0,0,0,0,0,45000,0,0,0,45000,0,45000,45000
056508,揚明光永豐98購01,0,0,0,0,0,0,0,0,0,45000,0,0,0,45000,0,45000,45000
052882,南電凱基96購02  ,0,0,0,0,0,0,0,0,0,45000,0,0,0,45000,0,45000,45000
053992,中環群益96購01  ,0,0,0,0,0,0,0,0,0,45000,0,0,0,45000,0,45000,45000
054785,建準群益98購01  ,0,0,0,0,0,0,0,0,0,45000,0,0,0,45000,0,45000,45000
055343,國巨凱基97購03  ,0,0,0,0,0,0,0,0,0,45000,0,0,0,48000,3000,45000,45000
050847,創意國票96購01  ,0,0,0,0,0,0,0,0,0,45000,0,0,0,60000,15000,45000,45000
03413B,臺股指凱基94熊19,0,0,0,0,0,0,0,0,0,45000,0,0,0,45000,0,45000,45000
03638C,T50反1元大94牛03,0,0,0,0,0,0,0,0,0,45000,0,0,0,210000,165000,45000,45000
051961,泰碩永豐95購01  ,0,0,0,0,0,0,0,0,0,45000,0,0,0,70000,25000,45000,45000
045055,聯發科元富98購03,0,0,0,0,0,0,0,0,0,45000,0,0,0,45000,0,45000,45000
051670,欣興元大95購06  ,0,0,0,0,0,0,0,0,0,45000,0,0,0,45000,0,45000,45000
8454,富邦媒          ,80000,27000,53000,0,0,0,0,481,-481,-8000,2000,10000,-8000,0,0,0,44519
00717,富邦美國特別股  ,0,0,0,0,0,0,0,0,0,44162,0,0,0,536000,491838,44162,44162
057230,建準凱基98購02  ,0,0,0,0,0,0,0,0,0,44000,0,0,0,122000,78000,44000,44000
058026,上銀富邦9A購01  ,0,0,0,0,0,0,0,0,0,44000,0,0,0,45000,1000,44000,44000
054579,聯茂元大97購01  ,0,0,0,0,0,0,0,0,0,44000,0,0,0,87000,43000,44000,44000
055536,嘉聯益群益99購02,0,0,0,0,0,0,0,0,0,44000,0,0,0,138000,94000,44000,44000
056116,義隆群益97購02  ,0,0,0,0,0,0,0,0,0,44000,0,0,0,59000,15000,44000,44000
058605,華邦電元大99購04,0,0,0,0,0,0,0,0,0,44000,0,0,0,68000,24000,44000,44000
06983P,台積電國泰9A售02,0,0,0,0,0,0,0,0,0,44000,0,0,0,44000,0,44000,44000
1733,五鼎            ,61000,14000,47000,0,0,0,0,0,0,-3000,1000,4000,-3000,0,0,0,44000
00743,國泰中國A150    ,0,0,0,0,0,0,0,0,0,43356,0,0,0,80000,36644,43356,43356
058973,麗豐永豐99購01  ,0,0,0,0,0,0,0,0,0,43000,0,0,0,43000,0,43000,43000
056721,台灣50永昌9A購01,0,0,0,0,0,0,0,0,0,43000,0,0,0,43000,0,43000,43000
056733,國巨凱基98購10  ,0,0,0,0,0,0,0,0,0,43000,0,0,0,53000,10000,43000,43000
060115,南電元大99購06  ,0,0,0,0,0,0,0,0,0,43000,0,0,0,259000,216000,43000,43000
060198,祥碩元富9A購02  ,0,0,0,0,0,0,0,0,0,43000,0,0,0,87000,44000,43000,43000
059122,超眾永豐99購01  ,0,0,0,0,0,0,0,0,0,43000,0,0,0,160000,117000,43000,43000
055337,超眾兆豐98購01  ,0,0,0,0,0,0,0,0,0,43000,0,0,0,43000,0,43000,43000
052529,力成元大95購03  ,0,0,0,0,0,0,0,0,0,43000,0,0,0,70000,27000,43000,43000
05759P,智邦永豐96售02  ,0,0,0,0,0,0,0,0,0,43000,0,0,0,65000,22000,43000,43000
054416,禾伸堂元大97購01,0,0,0,0,0,0,0,0,0,43000,0,0,0,45000,2000,43000,43000
054744,晶相光凱基99購01,0,0,0,0,0,0,0,0,0,43000,0,0,0,43000,0,43000,43000
06212P,華新科元大97售11,0,0,0,0,0,0,0,0,0,43000,0,0,0,51000,8000,43000,43000
060626,貿聯元大9A購04  ,0,0,0,0,0,0,0,0,0,43000,0,0,0,72000,29000,43000,43000
060019,彰銀康和99購01  ,0,0,0,0,0,0,0,0,0,42000,0,0,0,116000,74000,42000,42000
057514,華新科元富99購03,0,0,0,0,0,0,0,0,0,42000,0,0,0,164000,122000,42000,42000
060217,國巨凱基9A購10  ,0,0,0,0,0,0,0,0,0,42000,0,0,0,69000,27000,42000,42000
057057,立積元大9A購01  ,0,0,0,0,0,0,0,0,0,42000,0,0,0,135000,93000,42000,42000
054716,緯穎康和97購01  ,0,0,0,0,0,0,0,0,0,42000,0,0,0,100000,58000,42000,42000
056124,華通國票98購02  ,0,0,0,0,0,0,0,0,0,42000,0,0,0,64000,22000,42000,42000
055069,帆宣永豐97購01  ,0,0,0,0,0,0,0,0,0,42000,0,0,0,196000,154000,42000,42000
055732,全新元富9A購01  ,0,0,0,0,0,0,0,0,0,42000,0,0,0,47000,5000,42000,42000
056051,T50反1元大97購05,0,0,0,0,0,0,0,0,0,42000,0,0,0,242000,200000,42000,42000
6715,嘉基            ,48000,6000,42000,0,0,0,0,0,0,0,0,0,0,0,0,0,42000
2377,微星            ,363000,357800,5200,0,0,0,0,3061,-3061,39000,42000,3000,39000,10000,10000,0,41139
00737,國泰AI+Robo     ,701000,5000,696000,0,0,0,0,0,0,-654998,0,0,0,20000,674998,-654998,41002
059043,聯電日盛99購01  ,0,0,0,0,0,0,0,0,0,41000,0,0,0,99000,58000,41000,41000
060227,和大元大9A購01  ,0,0,0,0,0,0,0,0,0,41000,0,0,0,101000,60000,41000,41000
059889,華新科國票99購04,0,0,0,0,0,0,0,0,0,41000,0,0,0,342000,301000,41000,41000
051014,智邦凱基95購01  ,0,0,0,0,0,0,0,0,0,41000,0,0,0,52000,11000,41000,41000
055844,大毅元大98購01  ,0,0,0,0,0,0,0,0,0,41000,0,0,0,218000,177000,41000,41000
053101,創意元富96購03  ,0,0,0,0,0,0,0,0,0,41000,0,0,0,56000,15000,41000,41000
06971P,台光電元大99售03,0,0,0,0,0,0,0,0,0,41000,0,0,0,60000,19000,41000,41000
2493,揚博            ,62000,21000,41000,0,0,0,0,0,0,0,0,0,0,0,0,0,41000
2439,美律            ,274500,250330,24170,0,0,0,0,1222,-1222,18000,10000,29000,-19000,52000,15000,37000,40948
056748,T50反1兆豐99購01,0,0,0,0,0,0,0,0,0,40000,0,0,0,40000,0,40000,40000
058937,仁寶中信99購01  ,0,0,0,0,0,0,0,0,0,40000,0,0,0,40000,0,40000,40000
057920,奇力新凱基98購08,0,0,0,0,0,0,0,0,0,40000,0,0,0,41000,1000,40000,40000
060502,國巨元大9A購07  ,0,0,0,0,0,0,0,0,0,40000,0,0,0,146000,106000,40000,40000
060442,滬深2X元大9A購02,0,0,0,0,0,0,0,0,0,40000,0,0,0,40000,0,40000,40000
060375,葡萄王元富9A購01,0,0,0,0,0,0,0,0,0,40000,0,0,0,40000,0,40000,40000
06035P,同欣電凱基96售03,0,0,0,0,0,0,0,0,0,40000,0,0,0,40000,0,40000,40000
059046,滬深2X凱基9C購01,0,0,0,0,0,0,0,0,0,40000,0,0,0,40000,0,40000,40000
059715,A50正2元大9C購02,0,0,0,0,0,0,0,0,0,40000,0,0,0,40000,0,40000,40000
059710,上証2X元大9C購02,0,0,0,0,0,0,0,0,0,40000,0,0,0,40000,0,40000,40000
059713,滬深2X元大9C購04,0,0,0,0,0,0,0,0,0,40000,0,0,0,40000,0,40000,40000
059899,上証2X元大9C購04,0,0,0,0,0,0,0,0,0,40000,0,0,0,40000,0,40000,40000
059930,健策富邦9B購01  ,0,0,0,0,0,0,0,0,0,40000,0,0,0,82000,42000,40000,40000
057031,滬深反元大9B購02,0,0,0,0,0,0,0,0,0,40000,0,0,0,40000,0,40000,40000
057805,華通元大98購06  ,0,0,0,0,0,0,0,0,0,40000,0,0,0,90000,50000,40000,40000
057792,群創統一99購01  ,0,0,0,0,0,0,0,0,0,40000,0,0,0,50000,10000,40000,40000
058131,義隆元大99購02  ,0,0,0,0,0,0,0,0,0,40000,0,0,0,76000,36000,40000,40000
057175,美律元大98購03  ,0,0,0,0,0,0,0,0,0,40000,0,0,0,40000,0,40000,40000
059178,臺股指凱基99購30,0,0,0,0,0,0,0,0,0,40000,0,0,0,40000,0,40000,40000
059384,上証2X凱基9B購01,0,0,0,0,0,0,0,0,0,40000,0,0,0,40000,0,40000,40000
059385,滬深2X凱基9C購03,0,0,0,0,0,0,0,0,0,40000,0,0,0,40000,0,40000,40000
059386,上銀凱基99購07  ,0,0,0,0,0,0,0,0,0,40000,0,0,0,40000,0,40000,40000
059301,華新科群益99購04,0,0,0,0,0,0,0,0,0,40000,0,0,0,50000,10000,40000,40000
058470,台灣50日盛9B購02,0,0,0,0,0,0,0,0,0,40000,0,0,0,40000,0,40000,40000
058867,元油2X國票99購05,0,0,0,0,0,0,0,0,0,40000,0,0,0,40000,0,40000,40000
058868,元油2X國票99購06,0,0,0,0,0,0,0,0,0,40000,0,0,0,60000,20000,40000,40000
058889,元油2X元大9C購05,0,0,0,0,0,0,0,0,0,40000,0,0,0,40000,0,40000,40000
053045,國巨中信97購01  ,0,0,0,0,0,0,0,0,0,40000,0,0,0,40000,0,40000,40000
054709,宏達電統一97購01,0,0,0,0,0,0,0,0,0,40000,0,0,0,40000,0,40000,40000
054493,同欣電台新96購01,0,0,0,0,0,0,0,0,0,40000,0,0,0,40000,0,40000,40000
054870,新日興群益98購01,0,0,0,0,0,0,0,0,0,40000,0,0,0,40000,0,40000,40000
055468,智邦凱基97購04  ,0,0,0,0,0,0,0,0,0,40000,0,0,0,50000,10000,40000,40000
056039,宏達電凱基97購02,0,0,0,0,0,0,0,0,0,40000,0,0,0,49000,9000,40000,40000
055047,南港永豐97購01  ,0,0,0,0,0,0,0,0,0,40000,0,0,0,40000,0,40000,40000
05407P,超眾凱基95售04  ,0,0,0,0,0,0,0,0,0,40000,0,0,0,50000,10000,40000,40000
056492,全新國泰9A購01  ,0,0,0,0,0,0,0,0,0,40000,0,0,0,40000,0,40000,40000
050548,華固凱基95購01  ,0,0,0,0,0,0,0,0,0,40000,0,0,0,40000,0,40000,40000
055357,欣興凱基97購04  ,0,0,0,0,0,0,0,0,0,40000,0,0,0,40000,0,40000,40000
055369,友訊元大97購01  ,0,0,0,0,0,0,0,0,0,40000,0,0,0,40000,0,40000,40000
055164,矽創元大98購01  ,0,0,0,0,0,0,0,0,0,40000,0,0,0,40000,0,40000,40000
055178,晶豪科統一97購01,0,0,0,0,0,0,0,0,0,40000,0,0,0,70000,30000,40000,40000
04400P,台積電兆豐95售02,0,0,0,0,0,0,0,0,0,40000,0,0,0,40000,0,40000,40000
051729,華新國票96購01  ,0,0,0,0,0,0,0,0,0,40000,0,0,0,40000,0,40000,40000
2406,國碩            ,184000,144000,40000,0,0,0,0,0,0,0,0,0,0,0,0,0,40000
060265,宏達電國票9A購02,0,0,0,0,0,0,0,0,0,40000,0,0,0,40000,0,40000,40000
06589P,台積電元大98售12,0,0,0,0,0,0,0,0,0,40000,0,0,0,40000,0,40000,40000
06424P,大成鋼永豐97售01,0,0,0,0,0,0,0,0,0,40000,0,0,0,40000,0,40000,40000
3406,玉晶光          ,397000,310980,86020,0,0,0,23000,50457,-27457,-19000,27000,19000,8000,24000,51000,-27000,39563
059995,南亞科元富99購01,0,0,0,0,0,0,0,0,0,39000,0,0,0,240000,201000,39000,39000
058293,光寶科凱基9A購01,0,0,0,0,0,0,0,0,0,39000,0,0,0,59000,20000,39000,39000
058984,全新凱基9A購03  ,0,0,0,0,0,0,0,0,0,39000,0,0,0,39000,0,39000,39000
053642,瀚宇博永豐96購01,0,0,0,0,0,0,0,0,0,39000,0,0,0,76000,37000,39000,39000
054081,聯電元富96購01  ,0,0,0,0,0,0,0,0,0,39000,0,0,0,40000,1000,39000,39000
055962,晶豪科元大97購02,0,0,0,0,0,0,0,0,0,39000,0,0,0,41000,2000,39000,39000
054861,智邦群益97購01  ,0,0,0,0,0,0,0,0,0,39000,0,0,0,81000,42000,39000,39000
054822,祥碩元大97購01  ,0,0,0,0,0,0,0,0,0,39000,0,0,0,39000,0,39000,39000
052831,華固群益96購01  ,0,0,0,0,0,0,0,0,0,39000,0,0,0,80000,41000,39000,39000
3062,建漢            ,202000,160000,42000,0,0,0,0,0,0,-3000,0,3000,-3000,0,0,0,39000
2546,根基            ,48000,16000,32000,0,0,0,0,0,0,7000,8000,1000,7000,0,0,0,39000
1730,花仙子          ,80000,41000,39000,0,0,0,0,0,0,0,0,0,0,0,0,0,39000
2360,致茂            ,391000,342020,48980,0,0,0,89000,78048,10952,-21000,2000,7000,-5000,3000,19000,-16000,38932
3596,智易            ,275000,240660,34340,0,0,0,0,0,0,4000,4000,4000,0,8000,4000,4000,38340
058969,亞德客永豐99購01,0,0,0,0,0,0,0,0,0,38000,0,0,0,44000,6000,38000,38000
057952,元油2X元大98購21,0,0,0,0,0,0,0,0,0,38000,0,0,0,38000,0,38000,38000
059681,華新科國泰9B購02,0,0,0,0,0,0,0,0,0,38000,0,0,0,68000,30000,38000,38000
060162,碩天永豐9A購01  ,0,0,0,0,0,0,0,0,0,38000,0,0,0,70000,32000,38000,38000
057870,大立光凱基99購02,0,0,0,0,0,0,0,0,0,38000,0,0,0,40000,2000,38000,38000
057532,智原元大98購03  ,0,0,0,0,0,0,0,0,0,38000,0,0,0,40000,2000,38000,38000
060017,全新康和99購01  ,0,0,0,0,0,0,0,0,0,38000,0,0,0,38000,0,38000,38000
05771P,大立光凱基96售13,0,0,0,0,0,0,0,0,0,38000,0,0,0,38000,0,38000,38000
056597,宏碁元富98購01  ,0,0,0,0,0,0,0,0,0,38000,0,0,0,38000,0,38000,38000
059323,新日興元大99購02,0,0,0,0,0,0,0,0,0,38000,0,0,0,39000,1000,38000,38000
059338,滬深2X凱基9C購02,0,0,0,0,0,0,0,0,0,38000,0,0,0,40000,2000,38000,38000
053958,京元電永豐96購01,0,0,0,0,0,0,0,0,0,38000,0,0,0,73000,35000,38000,38000
055010,佐登元富97購01  ,0,0,0,0,0,0,0,0,0,38000,0,0,0,38000,0,38000,38000
059450,和大永豐99購01  ,0,0,0,0,0,0,0,0,0,38000,0,0,0,39000,1000,38000,38000
051637,嘉聯益國票96購01,0,0,0,0,0,0,0,0,0,38000,0,0,0,38000,0,38000,38000
053732,S&P反1中信9C購01,0,0,0,0,0,0,0,0,0,38000,0,0,0,40000,2000,38000,38000
055318,華通國票98購01  ,0,0,0,0,0,0,0,0,0,38000,0,0,0,76000,38000,38000,38000
051744,嘉聯益國票97購01,0,0,0,0,0,0,0,0,0,38000,0,0,0,38000,0,38000,38000
1611,中電            ,389000,343000,46000,0,0,0,0,0,0,-8000,0,8000,-8000,0,0,0,38000
06594P,立積元大98售01  ,0,0,0,0,0,0,0,0,0,38000,0,0,0,178000,140000,38000,38000
06888P,日月光元大98售02,0,0,0,0,0,0,0,0,0,38000,0,0,0,43000,5000,38000,38000
060036,上証2X國票99購03,0,0,0,0,0,0,0,0,0,37000,0,0,0,39000,2000,37000,37000
060355,元金2X元富9C購01,0,0,0,0,0,0,0,0,0,37000,0,0,0,104000,67000,37000,37000
060376,瑞祺元富9A購01  ,0,0,0,0,0,0,0,0,0,37000,0,0,0,97000,60000,37000,37000
059664,立積元大9C購01  ,0,0,0,0,0,0,0,0,0,37000,0,0,0,39000,2000,37000,37000
046629,群創統一98購01  ,0,0,0,0,0,0,0,0,0,37000,0,0,0,90000,53000,37000,37000
053773,上銀元大96購04  ,0,0,0,0,0,0,0,0,0,37000,0,0,0,63000,26000,37000,37000
054319,世紀鋼凱基96購02,0,0,0,0,0,0,0,0,0,37000,0,0,0,37000,0,37000,37000
06955P,臻鼎元富99售01  ,0,0,0,0,0,0,0,0,0,37000,0,0,0,37000,0,37000,37000
07129P,華新科元大99售14,0,0,0,0,0,0,0,0,0,37000,0,0,0,117000,80000,37000,37000
6541,泰福-KY         ,109000,72000,37000,0,0,0,0,0,0,0,0,0,0,0,0,0,37000
057991,健策統一9C購01  ,0,0,0,0,0,0,0,0,0,36000,0,0,0,110000,74000,36000,36000
059171,祥碩凱基99購04  ,0,0,0,0,0,0,0,0,0,36000,0,0,0,76000,40000,36000,36000
056535,全新凱基99購02  ,0,0,0,0,0,0,0,0,0,36000,0,0,0,50000,14000,36000,36000
056533,友達凱基9A購02  ,0,0,0,0,0,0,0,0,0,36000,0,0,0,50000,14000,36000,36000
055597,禾伸堂元大98購02,0,0,0,0,0,0,0,0,0,36000,0,0,0,48000,12000,36000,36000
054080,微星中信98購01  ,0,0,0,0,0,0,0,0,0,36000,0,0,0,38000,2000,36000,36000
055683,晶技凱基99購01  ,0,0,0,0,0,0,0,0,0,36000,0,0,0,36000,0,36000,36000
006207,FH滬深          ,17000,56000,-39000,0,0,0,0,0,0,75000,0,0,0,121000,46000,75000,36000
4142,國光生          ,273000,237000,36000,0,0,0,0,0,0,0,0,0,0,0,0,0,36000
06439P,上銀凱基98售02  ,0,0,0,0,0,0,0,0,0,36000,0,0,0,40000,4000,36000,36000
07418P,聯發科元大99售45,0,0,0,0,0,0,0,0,0,36000,0,0,0,56000,20000,36000,36000
07383P,聯發科群益99售06,0,0,0,0,0,0,0,0,0,36000,0,0,0,45000,9000,36000,36000
07362P,聯發科元大99售35,0,0,0,0,0,0,0,0,0,36000,0,0,0,96000,60000,36000,36000
2404,漢唐            ,144000,88510,55490,0,0,0,0,1165,-1165,-19000,0,18000,-18000,9000,10000,-1000,35325
059093,旭富元大99購01  ,0,0,0,0,0,0,0,0,0,35000,0,0,0,35000,0,35000,35000
058928,國巨統一9C購01  ,0,0,0,0,0,0,0,0,0,35000,0,0,0,35000,0,35000,35000
058964,群創兆豐99購01  ,0,0,0,0,0,0,0,0,0,35000,0,0,0,35000,0,35000,35000
059805,台積電元富99購02,0,0,0,0,0,0,0,0,0,35000,0,0,0,150000,115000,35000,35000
060315,易華電永豐9A購01,0,0,0,0,0,0,0,0,0,35000,0,0,0,35000,0,35000,35000
060167,禾聯碩永豐9A購01,0,0,0,0,0,0,0,0,0,35000,0,0,0,35000,0,35000,35000
059936,台積電永豐99購06,0,0,0,0,0,0,0,0,0,35000,0,0,0,35000,0,35000,35000
059732,超眾元大9A購01  ,0,0,0,0,0,0,0,0,0,35000,0,0,0,271000,236000,35000,35000
053867,創意元大96購04  ,0,0,0,0,0,0,0,0,0,35000,0,0,0,63000,28000,35000,35000
053735,矽力中信97購01  ,0,0,0,0,0,0,0,0,0,35000,0,0,0,55000,20000,35000,35000
052557,群創國票97購02  ,0,0,0,0,0,0,0,0,0,35000,0,0,0,35000,0,35000,35000
052216,康友元大96購01  ,0,0,0,0,0,0,0,0,0,35000,0,0,0,35000,0,35000,35000
055648,可成元富97購01  ,0,0,0,0,0,0,0,0,0,35000,0,0,0,200000,165000,35000,35000
054204,元金2X國票9B購02,0,0,0,0,0,0,0,0,0,35000,0,0,0,35000,0,35000,35000
056038,可成凱基97購01  ,0,0,0,0,0,0,0,0,0,35000,0,0,0,35000,0,35000,35000
056466,臺股指凱基99購08,0,0,0,0,0,0,0,0,0,35000,0,0,0,35000,0,35000,35000
054843,中環兆豐97購01  ,0,0,0,0,0,0,0,0,0,35000,0,0,0,35000,0,35000,35000
054929,群電凱基97購01  ,0,0,0,0,0,0,0,0,0,35000,0,0,0,65000,30000,35000,35000
053168,晶技群益98購01  ,0,0,0,0,0,0,0,0,0,35000,0,0,0,35000,0,35000,35000
053072,國巨台新97購01  ,0,0,0,0,0,0,0,0,0,35000,0,0,0,140000,105000,35000,35000
052787,國巨中信96購02  ,0,0,0,0,0,0,0,0,0,35000,0,0,0,35000,0,35000,35000
06548P,大立光元大98售10,0,0,0,0,0,0,0,0,0,35000,0,0,0,37000,2000,35000,35000
06704P,玉晶光元富98售05,0,0,0,0,0,0,0,0,0,35000,0,0,0,35000,0,35000,35000
057052,華擎元大98購01  ,0,0,0,0,0,0,0,0,0,34000,0,0,0,34000,0,34000,34000
056796,國巨麥證98購02  ,0,0,0,35000,106000,-71000,0,0,0,34000,0,0,0,140000,106000,34000,34000
057298,旭富永豐98購01  ,0,0,0,0,0,0,0,0,0,34000,0,0,0,115000,81000,34000,34000
053502,智伸科兆豐97購01,0,0,0,0,0,0,0,0,0,34000,0,0,0,34000,0,34000,34000
059443,嘉聯益元大9B購01,0,0,0,0,0,0,0,0,0,34000,0,0,0,38000,4000,34000,34000
055790,南電凱基97購01  ,0,0,0,0,0,0,0,0,0,34000,0,0,0,34000,0,34000,34000
054215,創意國票97購02  ,0,0,0,0,0,0,0,0,0,34000,0,0,0,38000,4000,34000,34000
055627,亞德客永豐97購02,0,0,0,0,0,0,0,0,0,34000,0,0,0,35000,1000,34000,34000
052418,玉晶光兆豐96購01,0,0,0,0,0,0,0,0,0,34000,0,0,0,34000,0,34000,34000
060404,台勝科國泰9B購01,0,0,0,0,0,0,0,0,0,34000,0,0,0,72000,38000,34000,34000
07174P,臺股指國票99售11,0,0,0,0,0,0,0,0,0,34000,0,0,0,51000,17000,34000,34000
07266P,大立光元大99售19,0,0,0,0,0,0,0,0,0,34000,0,0,0,81000,47000,34000,34000
07220P,台灣50中信03售05,0,0,0,0,0,0,0,0,0,34000,0,0,0,35000,1000,34000,34000
07392P,台積電國泰02售01,0,0,0,0,0,0,0,0,0,34000,0,0,0,51000,17000,34000,34000
00739,元大MSCI A股    ,2000,2000,0,0,0,0,0,0,0,33640,0,0,0,136000,102360,33640,33640
057803,上銀元大98購08  ,0,0,0,0,0,0,0,0,0,33000,0,0,0,103000,70000,33000,33000
057741,超眾富邦98購01  ,0,0,0,0,0,0,0,0,0,33000,0,0,0,33000,0,33000,33000
058535,玉晶光統一9A購06,0,0,0,0,0,0,0,0,0,33000,0,0,0,109000,76000,33000,33000
058774,台郡兆豐9A購01  ,0,0,0,0,0,0,0,0,0,33000,0,0,0,100000,67000,33000,33000
059665,嘉聯益元大99購06,0,0,0,0,0,0,0,0,0,33000,0,0,0,48000,15000,33000,33000
056321,創意群益98購02  ,0,0,0,0,0,0,0,0,0,33000,0,0,0,68000,35000,33000,33000
060088,國巨元大99購30  ,0,0,0,0,0,0,0,0,0,33000,0,0,0,158000,125000,33000,33000
060478,南電元大9A購01  ,0,0,0,0,0,0,0,0,0,33000,0,0,0,83000,50000,33000,33000
05517P,臻鼎元大96售01  ,0,0,0,0,0,0,0,0,0,33000,0,0,0,33000,0,33000,33000
052206,燿華中信95購02  ,0,0,0,0,0,0,0,0,0,33000,0,0,0,33000,0,33000,33000
056505,聯發科永豐98購01,0,0,0,0,0,0,0,0,0,33000,0,0,0,69000,36000,33000,33000
06801P,技嘉群益99售02  ,0,0,0,0,0,0,0,0,0,33000,0,0,0,33000,0,33000,33000
06185P,台表科元大97售05,0,0,0,0,0,0,0,0,0,33000,0,0,0,98000,65000,33000,33000
056571,燿華元大98購02  ,0,0,0,0,0,0,0,0,0,32000,0,0,0,32000,0,32000,32000
057228,友達凱基9B購01  ,0,0,0,0,0,0,0,0,0,32000,0,0,0,57000,25000,32000,32000
057828,緯穎元大99購02  ,0,0,0,0,0,0,0,0,0,32000,0,0,0,34000,2000,32000,32000
058297,茂林凱基9A購02  ,0,0,0,0,0,0,0,0,0,32000,0,0,0,38000,6000,32000,32000
058233,聯發科元大99購06,0,0,0,0,0,0,0,0,0,32000,0,0,0,46000,14000,32000,32000
059424,SGBR2X元大9A購01,0,0,0,0,0,0,0,0,0,32000,0,0,0,455000,423000,32000,32000
053003,國巨永豐96購02  ,0,0,0,0,0,0,0,0,0,32000,0,0,0,32000,0,32000,32000
053066,欣興群益96購02  ,0,0,0,0,0,0,0,0,0,32000,0,0,0,82000,50000,32000,32000
054250,漢唐元大96購04  ,0,0,0,0,0,0,0,0,0,32000,0,0,0,32000,0,32000,32000
04628P,欣興元大95售01  ,0,0,0,0,0,0,0,0,0,32000,0,0,0,102000,70000,32000,32000
04289P,臺股指中信95售07,0,0,0,0,0,0,0,0,0,32000,0,0,0,32000,0,32000,32000
045795,瀚宇博兆豐94購01,0,0,0,0,0,0,0,0,0,32000,0,0,0,32000,0,32000,32000
049269,超眾元大96購02  ,0,0,0,0,0,0,0,0,0,32000,0,0,0,32000,0,32000,32000
049688,台光電元大94購04,0,0,0,0,0,0,0,0,0,32000,0,0,0,32000,0,32000,32000
07118P,台積電凱基99售09,0,0,0,0,0,0,0,0,0,32000,0,0,0,32000,0,32000,32000
2929,淘帝-KY         ,111000,79000,32000,0,0,0,0,0,0,0,0,0,0,0,0,0,32000
6216,居易            ,38000,6000,32000,0,0,0,0,0,0,0,0,0,0,0,0,0,32000
057428,正崴兆豐98購01  ,0,0,0,0,0,0,0,0,0,31000,0,0,0,32000,1000,31000,31000
059521,南電永豐99購03  ,0,0,0,0,0,0,0,0,0,31000,0,0,0,71000,40000,31000,31000
056611,國巨永豐98購03  ,0,0,0,0,0,0,0,0,0,31000,0,0,0,89000,58000,31000,31000
059119,華擎永豐99購02  ,0,0,0,0,0,0,0,0,0,31000,0,0,0,125000,94000,31000,31000
060453,儒鴻元大9A購02  ,0,0,0,0,0,0,0,0,0,31000,0,0,0,52000,21000,31000,31000
060114,緯穎元大99購10  ,0,0,0,0,0,0,0,0,0,31000,0,0,0,109000,78000,31000,31000
058053,上銀統一9B購01  ,0,0,0,0,0,0,0,0,0,31000,0,0,0,31000,0,31000,31000
056206,泰鼎永豐97購01  ,0,0,0,0,0,0,0,0,0,31000,0,0,0,31000,0,31000,31000
047773,超眾元大96購01  ,0,0,0,0,0,0,0,0,0,31000,0,0,0,31000,0,31000,31000
05445P,聯詠元大95售05  ,0,0,0,0,0,0,0,0,0,31000,0,0,0,31000,0,31000,31000
055558,大立光凱基97購08,0,0,0,0,0,0,0,0,0,31000,0,0,0,31000,0,31000,31000
052921,大成鋼永豐96購01,0,0,0,0,0,0,0,0,0,31000,0,0,0,51000,20000,31000,31000
059972,S&P正2元大99購03,0,0,0,0,0,0,0,0,0,31000,0,0,0,31000,0,31000,31000
055763,鎧勝群益97購01  ,0,0,0,0,0,0,0,0,0,31000,0,0,0,31000,0,31000,31000
6112,聚碩            ,81000,49000,32000,0,0,0,0,0,0,-1000,0,1000,-1000,0,0,0,31000
07414P,台積電元大99售51,0,0,0,0,0,0,0,0,0,31000,0,0,0,31000,0,31000,31000
056203,興富發永豐97購01,0,0,0,0,0,0,0,0,0,30000,0,0,0,30000,0,30000,30000
056172,鴻海元富97購11  ,0,0,0,0,0,0,0,0,0,30000,0,0,0,30000,0,30000,30000
056176,創意元富97購01  ,0,0,0,0,0,0,0,0,0,30000,0,0,0,30000,0,30000,30000
056986,超眾群益98購03  ,0,0,0,0,0,0,0,0,0,30000,0,0,0,30000,0,30000,30000
059675,大立光元富99購08,0,0,0,0,0,0,0,0,0,30000,0,0,0,202000,172000,30000,30000
059795,鴻海國票99購07  ,0,0,0,0,0,0,0,0,0,30000,0,0,0,69000,39000,30000,30000
059818,鴻海凱基99購14  ,0,0,0,0,0,0,0,0,0,30000,0,0,0,30000,0,30000,30000
059876,智易凱基99購02  ,0,0,0,0,0,0,0,0,0,30000,0,0,0,75000,45000,30000,30000
057914,日月光日盛9A購01,0,0,0,0,0,0,0,0,0,30000,0,0,0,30000,0,30000,30000
06017P,亞光凱基96售04  ,0,0,0,0,0,0,0,0,0,30000,0,0,0,30000,0,30000,30000
05991P,聯茂群益96售05  ,0,0,0,0,0,0,0,0,0,30000,0,0,0,30000,0,30000,30000
060371,A50正2元富01購01,0,0,0,0,0,0,0,0,0,30000,0,0,0,40000,10000,30000,30000
056618,京元電永豐98購01,0,0,0,0,0,0,0,0,0,30000,0,0,0,30000,0,30000,30000
058469,臺股指中信9A購05,0,0,0,0,0,0,0,0,0,30000,0,0,0,30000,0,30000,30000
058375,群創凱基9B購04  ,0,0,0,0,0,0,0,0,0,30000,0,0,0,30000,0,30000,30000
057326,景碩群益99購02  ,0,0,0,0,0,0,0,0,0,30000,0,0,0,30000,0,30000,30000
057804,為升元大98購01  ,0,0,0,0,0,0,0,0,0,30000,0,0,0,30000,0,30000,30000
058188,華擎永豐99購01  ,0,0,0,0,0,0,0,0,0,30000,0,0,0,183000,153000,30000,30000
057855,晶技國票99購01  ,0,0,0,0,0,0,0,0,0,30000,0,0,0,30000,0,30000,30000
055935,創意群益97購02  ,0,0,0,0,0,0,0,0,0,30000,0,0,0,30000,0,30000,30000
052805,晶技元大97購01  ,0,0,0,0,0,0,0,0,0,30000,0,0,0,30000,0,30000,30000
053965,聯電元大98購04  ,0,0,0,0,0,0,0,0,0,30000,0,0,0,30000,0,30000,30000
053487,台泥兆豐97購01  ,0,0,0,0,0,0,0,0,0,30000,0,0,0,42000,12000,30000,30000
053154,聯詠元大96購01  ,0,0,0,0,0,0,0,0,0,30000,0,0,0,30000,0,30000,30000
055566,台表科凱基97購03,0,0,0,0,0,0,0,0,0,30000,0,0,0,120000,90000,30000,30000
055585,國巨元大98購08  ,0,0,0,0,0,0,0,0,0,30000,0,0,0,30000,0,30000,30000
054050,創意元大96購06  ,0,0,0,0,0,0,0,0,0,30000,0,0,0,51000,21000,30000,30000
054836,勤誠中信97購01  ,0,0,0,0,0,0,0,0,0,30000,0,0,0,30000,0,30000,30000
054803,味全元大9A購01  ,0,0,0,0,0,0,0,0,0,30000,0,0,0,30000,0,30000,30000
05452P,亞德客群益95售02,0,0,0,0,0,0,0,0,0,30000,0,0,0,30000,0,30000,30000
054504,聯鈞永豐96購01  ,0,0,0,0,0,0,0,0,0,30000,0,0,0,30000,0,30000,30000
054581,訊芯元大97購02  ,0,0,0,0,0,0,0,0,0,30000,0,0,0,30000,0,30000,30000
047421,聯茂富邦97購01  ,0,0,0,0,0,0,0,0,0,30000,0,0,0,30000,0,30000,30000
045053,聯發科元富98購01,0,0,0,0,0,0,0,0,0,30000,0,0,0,30000,0,30000,30000
042556,台灣50中信96購04,0,0,0,0,0,0,0,0,0,30000,0,0,0,30000,0,30000,30000
04961P,貿聯凱基94售03  ,0,0,0,0,0,0,0,0,0,30000,0,0,0,30000,0,30000,30000
04978P,台表科凱基94售02,0,0,0,0,0,0,0,0,0,30000,0,0,0,30000,0,30000,30000
051948,滬深2X元富9B購01,0,0,0,0,0,0,0,0,0,30000,0,0,0,30000,0,30000,30000
049200,元黃金群益98購01,0,0,0,0,0,0,0,0,0,30000,0,0,0,30000,0,30000,30000
048636,鴻海元大94購05  ,0,0,0,0,0,0,0,0,0,30000,0,0,0,30000,0,30000,30000
048427,百和元富95購01  ,0,0,0,0,0,0,0,0,0,30000,0,0,0,30000,0,30000,30000
052197,台郡元富95購03  ,0,0,0,0,0,0,0,0,0,30000,0,0,0,30000,0,30000,30000
049854,超眾群益94購02  ,0,0,0,0,0,0,0,0,0,30000,0,0,0,30000,0,30000,30000
050942,S&P正2群益95購01,0,0,0,0,0,0,0,0,0,30000,0,0,0,30000,0,30000,30000
050797,聯發科中信99購01,0,0,0,0,0,0,0,0,0,30000,0,0,0,30000,0,30000,30000
050682,南亞科元富94購02,0,0,0,0,0,0,0,0,0,30000,0,0,0,30000,0,30000,30000
053804,富邦金凱基96購01,0,0,0,0,0,0,0,0,0,30000,0,0,0,48000,18000,30000,30000
052436,正崴富邦95購01  ,0,0,0,0,0,0,0,0,0,30000,0,0,0,30000,0,30000,30000
053565,台光電富邦98購01,0,0,0,0,0,0,0,0,0,30000,0,0,0,30000,0,30000,30000
053694,創意元大96購03  ,0,0,0,0,0,0,0,0,0,30000,0,0,0,109000,79000,30000,30000
052606,聯發科元大97購04,0,0,0,0,0,0,0,0,0,30000,0,0,0,30000,0,30000,30000
07347P,上証2X凱基99售02,0,0,0,0,0,0,0,0,0,30000,0,0,0,30000,0,30000,30000
07214P,聯發科凱基9A售04,0,0,0,0,0,0,0,0,0,30000,0,0,0,30000,0,30000,30000
06214P,國巨國票98售04  ,0,0,0,0,0,0,0,0,0,30000,0,0,0,41000,11000,30000,30000
06686P,麗豐永豐98售02  ,0,0,0,0,0,0,0,0,0,30000,0,0,0,41000,11000,30000,30000
060571,京元電永豐9A購01,0,0,0,0,0,0,0,0,0,30000,0,0,0,71000,41000,30000,30000
060583,南亞科元富9A購05,0,0,0,0,0,0,0,0,0,30000,0,0,0,30000,0,30000,30000
3026,禾伸堂          ,490000,449760,40240,0,0,0,0,0,0,-11000,0,6000,-6000,6000,11000,-5000,29240
059538,健策凱基99購03  ,0,0,0,0,0,0,0,0,0,29000,0,0,0,52000,23000,29000,29000
057223,富邦金日盛99購01,0,0,0,0,0,0,0,0,0,29000,0,0,0,29000,0,29000,29000
056567,瀚宇博群益98購02,0,0,0,0,0,0,0,0,0,29000,0,0,0,38000,9000,29000,29000
059300,國巨群益99購08  ,0,0,0,0,0,0,0,0,0,29000,0,0,0,80000,51000,29000,29000
060042,台積電群益99購12,0,0,0,0,0,0,0,0,0,29000,0,0,0,39000,10000,29000,29000
057936,健策群益99購01  ,0,0,0,0,0,0,0,0,0,29000,0,0,0,52000,23000,29000,29000
058952,南茂群益99購01  ,0,0,0,0,0,0,0,0,0,29000,0,0,0,30000,1000,29000,29000
053534,微星永豐96購02  ,0,0,0,0,0,0,0,0,0,29000,0,0,0,30000,1000,29000,29000
053891,欣興群益98購01  ,0,0,0,0,0,0,0,0,0,29000,0,0,0,29000,0,29000,29000
04819P,嘉澤永豐94售01  ,0,0,0,0,0,0,0,0,0,29000,0,0,0,29000,0,29000,29000
049527,國巨中信95購01  ,0,0,0,0,0,0,0,0,0,29000,0,0,0,29000,0,29000,29000
054690,新興永豐97購01  ,0,0,0,0,0,0,0,0,0,29000,0,0,0,29000,0,29000,29000
053158,茂林元大96購01  ,0,0,0,0,0,0,0,0,0,29000,0,0,0,30000,1000,29000,29000
052933,祥碩元大96購01  ,0,0,0,0,0,0,0,0,0,29000,0,0,0,63000,34000,29000,29000
056963,建準永豐98購01  ,0,0,0,0,0,0,0,0,0,28000,0,0,0,46000,18000,28000,28000
057926,帆宣凱基98購02  ,0,0,0,0,0,0,0,0,0,28000,0,0,0,136000,108000,28000,28000
059881,臺股指凱基99購46,0,0,0,0,0,0,0,0,0,28000,0,0,0,28000,0,28000,28000
060470,台勝科元大9A購03,0,0,0,0,0,0,0,0,0,28000,0,0,0,36000,8000,28000,28000
059950,百和永豐99購02  ,0,0,0,0,0,0,0,0,0,28000,0,0,0,92000,64000,28000,28000
059280,台灣50永豐99購06,0,0,0,0,0,0,0,0,0,28000,0,0,0,28000,0,28000,28000
056621,宏達電永豐98購01,0,0,0,0,0,0,0,0,0,28000,0,0,0,58000,30000,28000,28000
057779,禾伸堂群益98購02,0,0,0,0,0,0,0,0,0,28000,0,0,0,28000,0,28000,28000
057354,聯鈞統一99購03  ,0,0,0,0,0,0,0,0,0,28000,0,0,0,28000,0,28000,28000
052940,玉晶光兆豐97購01,0,0,0,0,0,0,0,0,0,28000,0,0,0,28000,0,28000,28000
056076,超眾元大97購05  ,0,0,0,0,0,0,0,0,0,28000,0,0,0,95000,67000,28000,28000
053597,牧德元大99購01  ,0,0,0,0,0,0,0,0,0,28000,0,0,0,28000,0,28000,28000
051619,智邦凱基95購07  ,0,0,0,0,0,0,0,0,0,28000,0,0,0,28000,0,28000,28000
3504,揚明光          ,106000,71000,35000,0,0,0,0,0,0,-7000,0,6000,-6000,0,1000,-1000,28000
6525,捷敏-KY         ,66000,51000,15000,0,0,0,0,0,0,13000,13000,0,13000,0,0,0,28000
058208,百和凱基99購01  ,0,0,0,0,0,0,0,0,0,27000,0,0,0,30000,3000,27000,27000
057260,微星兆豐98購01  ,0,0,0,0,0,0,0,0,0,27000,0,0,0,27000,0,27000,27000
056967,奇鋐永豐98購01  ,0,0,0,0,0,0,0,0,0,27000,0,0,0,113000,86000,27000,27000
050615,奇力新元大95購03,0,0,0,0,0,0,0,0,0,27000,0,0,0,35000,8000,27000,27000
049947,S&P反1中信97購01,0,0,0,0,0,0,0,0,0,27000,0,0,0,40000,13000,27000,27000
055829,上銀元大97購06  ,0,0,0,0,0,0,0,0,0,27000,0,0,0,49000,22000,27000,27000
055071,群電永豐97購01  ,0,0,0,0,0,0,0,0,0,27000,0,0,0,27000,0,27000,27000
056509,晶相光永豐98購01,0,0,0,0,0,0,0,0,0,27000,0,0,0,27000,0,27000,27000
056141,聯茂元大97購05  ,0,0,0,0,0,0,0,0,0,27000,0,0,0,105000,78000,27000,27000
054718,可成永豐97購01  ,0,0,0,0,0,0,0,0,0,27000,0,0,0,27000,0,27000,27000
3015,全漢            ,32000,4263,27737,0,0,0,0,0,0,-1000,0,1000,-1000,0,0,0,26737
059883,T50反1國票99購02,0,0,0,0,0,0,0,0,0,26000,0,0,0,31000,5000,26000,26000
060104,新日興元大99購03,0,0,0,0,0,0,0,0,0,26000,0,0,0,62000,36000,26000,26000
060364,奇力新元富9A購01,0,0,0,0,0,0,0,0,0,26000,0,0,0,68000,42000,26000,26000
060368,緯穎元富9A購03  ,0,0,0,0,0,0,0,0,0,26000,0,0,0,50000,24000,26000,26000
060039,大立光國票99購04,0,0,0,0,0,0,0,0,0,26000,0,0,0,30000,4000,26000,26000
057232,京元電凱基98購02,0,0,0,0,0,0,0,0,0,26000,0,0,0,36000,10000,26000,26000
056570,旺宏元大98購07  ,0,0,0,0,0,0,0,0,0,26000,0,0,0,26000,0,26000,26000
054887,大毅統一98購01  ,0,0,0,0,0,0,0,0,0,26000,0,0,0,26000,0,26000,26000
054304,台積電凱基96購23,0,0,0,0,0,0,0,0,0,26000,0,0,0,47000,21000,26000,26000
055399,超眾統一99購01  ,0,0,0,0,0,0,0,0,0,26000,0,0,0,26000,0,26000,26000
056459,茂林凱基99購01  ,0,0,0,0,0,0,0,0,0,26000,0,0,0,50000,24000,26000,26000
052231,景碩凱基96購01  ,0,0,0,0,0,0,0,0,0,26000,0,0,0,26000,0,26000,26000
052220,T50反1凱基98購01,0,0,0,0,0,0,0,0,0,26000,0,0,0,50000,24000,26000,26000
050384,嘉澤國票94購02  ,0,0,0,0,0,0,0,0,0,26000,0,0,0,26000,0,26000,26000
8103,瀚荃            ,31000,5000,26000,0,0,0,0,0,0,0,0,0,0,0,0,0,26000
07529P,國巨凱基9A售11  ,0,0,0,0,0,0,0,0,0,26000,0,0,0,46000,20000,26000,26000
8341,日友            ,59000,32000,27000,0,0,0,8000,332,7668,-9000,0,9000,-9000,0,0,0,25668
059339,上銀凱基99購06  ,0,0,0,0,0,0,0,0,0,25000,0,0,0,45000,20000,25000,25000
057212,台積電群益98購03,0,0,0,0,0,0,0,0,0,25000,0,0,0,25000,0,25000,25000
057120,茂林康和98購01  ,0,0,0,0,0,0,0,0,0,25000,0,0,0,98000,73000,25000,25000
059512,晶豪科永豐99購02,0,0,0,0,0,0,0,0,0,25000,0,0,0,30000,5000,25000,25000
058694,鈺齊國票9A購02  ,0,0,0,0,0,0,0,0,0,25000,0,0,0,25000,0,25000,25000
057539,南茂元大98購02  ,0,0,0,0,0,0,0,0,0,25000,0,0,0,112000,87000,25000,25000
060192,欣興元富9A購01  ,0,0,0,0,0,0,0,0,0,25000,0,0,0,25000,0,25000,25000
059940,微星永豐99購01  ,0,0,0,0,0,0,0,0,0,25000,0,0,0,26000,1000,25000,25000
056713,華擎永豐98購01  ,0,0,0,0,0,0,0,0,0,25000,0,0,0,25000,0,25000,25000
058061,貿聯元富9B購01  ,0,0,0,0,0,0,0,0,0,25000,0,0,0,65000,40000,25000,25000
058934,台灣50中信03購03,0,0,0,0,0,0,0,0,0,25000,0,0,0,25000,0,25000,25000
056233,超眾凱基97購02  ,0,0,0,0,0,0,0,0,0,25000,0,0,0,42000,17000,25000,25000
050496,鴻海富邦96購01  ,0,0,0,0,0,0,0,0,0,25000,0,0,0,520000,495000,25000,25000
04989P,國巨元大94售15  ,0,0,0,0,0,0,0,0,0,25000,0,0,0,25000,0,25000,25000
052126,群創國票97購01  ,0,0,0,0,0,0,0,0,0,25000,0,0,0,25000,0,25000,25000
043784,鴻海凱基94購01  ,0,0,0,0,0,0,0,0,0,25000,0,0,0,35000,10000,25000,25000
051732,華通國票97購01  ,0,0,0,0,0,0,0,0,0,25000,0,0,0,25000,0,25000,25000
05171P,臺股指元大95售15,0,0,0,0,0,0,0,0,0,25000,0,0,0,25000,0,25000,25000
048429,旺宏國票94購02  ,0,0,0,0,0,0,0,0,0,25000,0,0,0,25000,0,25000,25000
055617,TPK國票98購04   ,0,0,0,0,0,0,0,0,0,25000,0,0,0,25000,0,25000,25000
052707,景碩台新96購01  ,0,0,0,0,0,0,0,0,0,25000,0,0,0,25000,0,25000,25000
052993,欣興台新97購01  ,0,0,0,0,0,0,0,0,0,25000,0,0,0,25000,0,25000,25000
054838,京鼎第一97購01  ,0,0,0,0,0,0,0,0,0,25000,0,0,0,25000,0,25000,25000
4999,鑫禾            ,39000,9000,30000,0,0,0,0,0,0,-5000,0,5000,-5000,0,0,0,25000
1460,宏遠            ,55000,30000,25000,0,0,0,0,0,0,0,0,0,0,0,0,0,25000
07472P,和碩元大9A售03  ,0,0,0,0,0,0,0,0,0,25000,0,0,0,50000,25000,25000,25000
07140P,台灣50日盛99售01,0,0,0,0,0,0,0,0,0,25000,0,0,0,45000,20000,25000,25000
5522,遠雄            ,347000,182450,164550,0,0,0,0,6918,-6918,-133000,5000,138000,-133000,0,0,0,24632
056274,彩晶統一98購02  ,0,0,0,0,0,0,0,0,0,24000,0,0,0,24000,0,24000,24000
057946,晶相光國票99購01,0,0,0,0,0,0,0,0,0,24000,0,0,0,25000,1000,24000,24000
056846,晶相光元富98購01,0,0,0,0,0,0,0,0,0,24000,0,0,0,25000,1000,24000,24000
060172,智原台新9A購01  ,0,0,0,0,0,0,0,0,0,24000,0,0,0,24000,0,24000,24000
052864,奇力新凱基96購02,0,0,0,0,0,0,0,0,0,24000,0,0,0,24000,0,24000,24000
055637,亞德客元富97購01,0,0,0,0,0,0,0,0,0,24000,0,0,0,25000,1000,24000,24000
00771,元大US高息特別股,0,0,0,0,0,0,0,0,0,24000,0,0,0,24000,0,24000,24000
051797,卜蜂永豐95購01  ,0,0,0,0,0,0,0,0,0,24000,0,0,0,24000,0,24000,24000
050904,臺股指元大95購11,0,0,0,0,0,0,0,0,0,24000,0,0,0,25000,1000,24000,24000
055172,凱美統一97購02  ,0,0,0,0,0,0,0,0,0,24000,0,0,0,420000,396000,24000,24000
060401,世紀鋼國票9B購01,0,0,0,0,0,0,0,0,0,24000,0,0,0,34000,10000,24000,24000
07390P,華新科康和99售02,0,0,0,0,0,0,0,0,0,24000,0,0,0,24000,0,24000,24000
059700,鴻海凱基9A購16  ,0,0,0,0,0,0,0,0,0,23000,0,0,0,28000,5000,23000,23000
059789,貿聯元大9A購02  ,0,0,0,0,0,0,0,0,0,23000,0,0,0,118000,95000,23000,23000
058752,鈺齊凱基9A購01  ,0,0,0,0,0,0,0,0,0,23000,0,0,0,25000,2000,23000,23000
05908P,大立光元富96售05,0,0,0,0,0,0,0,0,0,23000,0,0,0,26000,3000,23000,23000
058523,聯茂元大99購08  ,0,0,0,0,0,0,0,0,0,23000,0,0,0,52000,29000,23000,23000
051843,聯發科富邦99購01,0,0,0,0,0,0,0,0,0,23000,0,0,0,23000,0,23000,23000
056004,南電永豐97購02  ,0,0,0,0,0,0,0,0,0,23000,0,0,0,105000,82000,23000,23000
058582,禾伸堂群益99購02,0,0,0,0,0,0,0,0,0,23000,0,0,0,23000,0,23000,23000
053947,義隆富邦97購01  ,0,0,0,0,0,0,0,0,0,23000,0,0,0,66000,43000,23000,23000
07419P,聯發科元大99售46,0,0,0,0,0,0,0,0,0,23000,0,0,0,23000,0,23000,23000
06067P,華新科康和97售01,0,0,0,0,0,0,0,0,0,23000,0,0,0,23000,0,23000,23000
5234,達興材料        ,12000,31000,-19000,0,0,0,45000,0,45000,-3000,0,3000,-3000,0,0,0,23000
4552,力達-KY         ,63000,39000,24000,0,0,0,0,0,0,-1000,0,1000,-1000,0,0,0,23000
4943,康控-KY         ,389000,278000,111000,0,0,0,0,1318,-1318,-87000,1000,81000,-80000,13000,20000,-7000,22682
059579,聯發科元富99購06,0,0,0,0,0,0,0,0,0,22000,0,0,0,30000,8000,22000,22000
059257,臺股指凱基99購35,0,0,0,0,0,0,0,0,0,22000,0,0,0,22000,0,22000,22000
057134,茂林凱基98購02  ,0,0,0,0,0,0,0,0,0,22000,0,0,0,22000,0,22000,22000
057388,奇鋐永豐98購02  ,0,0,0,0,0,0,0,0,0,22000,0,0,0,90000,68000,22000,22000
058187,泰碩永豐99購01  ,0,0,0,0,0,0,0,0,0,22000,0,0,0,194000,172000,22000,22000
059717,國巨元大99購21  ,0,0,0,0,0,0,0,0,0,22000,0,0,0,62000,40000,22000,22000
059938,凱美永豐99購01  ,0,0,0,0,0,0,0,0,0,22000,0,0,0,22000,0,22000,22000
059929,華新科富邦9C購03,0,0,0,0,0,0,0,0,0,22000,0,0,0,33000,11000,22000,22000
057000,亞德客國票99購01,0,0,0,0,0,0,0,0,0,22000,0,0,0,28000,6000,22000,22000
053973,晶豪科元大96購01,0,0,0,0,0,0,0,0,0,22000,0,0,0,155000,133000,22000,22000
054921,文曄凱基97購01  ,0,0,0,0,0,0,0,0,0,22000,0,0,0,22000,0,22000,22000
054638,國泰金中信99購01,0,0,0,0,0,0,0,0,0,22000,0,0,0,58000,36000,22000,22000
051699,世紀鋼麥證95購01,0,0,0,22000,0,22000,0,0,0,22000,0,0,0,22000,0,22000,22000
047990,臺指反元大96購02,0,0,0,0,0,0,0,0,0,22000,0,0,0,22000,0,22000,22000
03674C,臺股指元富9C牛02,0,0,0,0,0,0,0,0,0,22000,0,0,0,22000,0,22000,22000
050484,世紀鋼國票95購02,0,0,0,0,0,0,0,0,0,22000,0,0,0,22000,0,22000,22000
6592,和潤企業        ,144000,132000,12000,0,0,0,20000,0,20000,-10000,0,0,0,0,10000,-10000,22000
06954P,大立光元富99售01,0,0,0,0,0,0,0,0,0,22000,0,0,0,116000,94000,22000,22000
2464,盟立            ,56000,32000,24000,0,0,0,0,0,0,-2000,0,2000,-2000,0,0,0,22000
060356,上銀元富9A購01  ,0,0,0,0,0,0,0,0,0,21000,0,0,0,71000,50000,21000,21000
056379,玉晶光元富98購01,0,0,0,0,0,0,0,0,0,21000,0,0,0,21000,0,21000,21000
058142,瑞儀元大99購01  ,0,0,0,0,0,0,0,0,0,21000,0,0,0,687000,666000,21000,21000
057466,泰鼎永豐98購01  ,0,0,0,0,0,0,0,0,0,21000,0,0,0,21000,0,21000,21000
059627,旺宏凱基99購10  ,0,0,0,0,0,0,0,0,0,21000,0,0,0,21000,0,21000,21000
03252P,台積電台新02售01,0,0,0,0,0,0,0,0,0,21000,0,0,0,21000,0,21000,21000
047483,新光金凱基99購04,0,0,0,0,0,0,0,0,0,21000,0,0,0,21000,0,21000,21000
049267,瀚宇博元大95購02,0,0,0,0,0,0,0,0,0,21000,0,0,0,21000,0,21000,21000
055587,智邦元大97購02  ,0,0,0,0,0,0,0,0,0,21000,0,0,0,25000,4000,21000,21000
055563,智易凱基97購02  ,0,0,0,0,0,0,0,0,0,21000,0,0,0,71000,50000,21000,21000
054235,欣興群益96購06  ,0,0,0,0,0,0,0,0,0,21000,0,0,0,50000,29000,21000,21000
054166,日電貿凱基98購01,0,0,0,0,0,0,0,0,0,21000,0,0,0,21000,0,21000,21000
07029P,緯穎群益99售02  ,0,0,0,0,0,0,0,0,0,21000,0,0,0,21000,0,21000,21000
06060P,玉晶光元大97售03,0,0,0,0,0,0,0,0,0,21000,0,0,0,21000,0,21000,21000
06614P,祥碩永豐98售03  ,0,0,0,0,0,0,0,0,0,21000,0,0,0,113000,92000,21000,21000
06104P,大立光凱基97售04,0,0,0,0,0,0,0,0,0,21000,0,0,0,25000,4000,21000,21000
059079,SGBR2X元大99購01,0,0,0,0,0,0,0,0,0,20000,0,0,0,20000,0,20000,20000
059278,群創元大9A購04  ,0,0,0,0,0,0,0,0,0,20000,0,0,0,111000,91000,20000,20000
059308,T50反1元大99購07,0,0,0,0,0,0,0,0,0,20000,0,0,0,30000,10000,20000,20000
059587,華通元大9A購01  ,0,0,0,0,0,0,0,0,0,20000,0,0,0,20000,0,20000,20000
058863,可成凱基99購02  ,0,0,0,0,0,0,0,0,0,20000,0,0,0,20000,0,20000,20000
058365,奇力新凱基9A購01,0,0,0,0,0,0,0,0,0,20000,0,0,0,20000,0,20000,20000
057476,國巨元大98購19  ,0,0,0,0,0,0,0,0,0,20000,0,0,0,20000,0,20000,20000
058165,FBVIX凱基9C購01 ,0,0,0,0,0,0,0,0,0,20000,0,0,0,20000,0,20000,20000
058124,玉晶光國票9A購01,0,0,0,0,0,0,0,0,0,20000,0,0,0,20000,0,20000,20000
058088,鴻海元大9A購01  ,0,0,0,0,0,0,0,0,0,20000,0,0,0,20000,0,20000,20000
058172,國巨凱基9B購02  ,0,0,0,0,0,0,0,0,0,20000,0,0,0,20000,0,20000,20000
057252,牧德元富98購01  ,0,0,0,0,0,0,0,0,0,20000,0,0,0,100000,80000,20000,20000
057208,上海銀元富98購01,0,0,0,0,0,0,0,0,0,20000,0,0,0,20000,0,20000,20000
057191,祥碩元大98購05  ,0,0,0,0,0,0,0,0,0,20000,0,0,0,50000,30000,20000,20000
058897,國巨元大99購17  ,0,0,0,0,0,0,0,0,0,20000,0,0,0,20000,0,20000,20000
059673,玉山金元富99購01,0,0,0,0,0,0,0,0,0,20000,0,0,0,30000,10000,20000,20000
057873,義隆元大98購03  ,0,0,0,0,0,0,0,0,0,20000,0,0,0,44000,24000,20000,20000
057953,聚陽元大98購01  ,0,0,0,0,0,0,0,0,0,20000,0,0,0,20000,0,20000,20000
057893,亞德客元富98購03,0,0,0,0,0,0,0,0,0,20000,0,0,0,20000,0,20000,20000
056724,臻鼎中信9A購01  ,0,0,0,0,0,0,0,0,0,20000,0,0,0,20000,0,20000,20000
056731,國巨凱基98購04  ,0,0,0,0,0,0,0,0,0,20000,0,0,0,20000,0,20000,20000
056755,聯茂兆豐98購01  ,0,0,0,0,0,0,0,0,0,20000,0,0,0,20000,0,20000,20000
056742,玉晶光凱基9A購01,0,0,0,0,0,0,0,0,0,20000,0,0,0,20000,0,20000,20000
060334,群光康和9A購01  ,0,0,0,0,0,0,0,0,0,20000,0,0,0,20000,0,20000,20000
055696,華新科國票98購01,0,0,0,0,0,0,0,0,0,20000,0,0,0,20000,0,20000,20000
056050,晶技國票98購01  ,0,0,0,0,0,0,0,0,0,20000,0,0,0,20000,0,20000,20000
055912,宏達電凱基98購03,0,0,0,0,0,0,0,0,0,20000,0,0,0,37000,17000,20000,20000
055951,大成鋼元大97購02,0,0,0,0,0,0,0,0,0,20000,0,0,0,25000,5000,20000,20000
055953,上銀元大97購09  ,0,0,0,0,0,0,0,0,0,20000,0,0,0,32000,12000,20000,20000
055814,晶豪科國票97購02,0,0,0,0,0,0,0,0,0,20000,0,0,0,20000,0,20000,20000
055794,聯發科國泰99購01,0,0,0,0,0,0,0,0,0,20000,0,0,0,20000,0,20000,20000
056464,臺股指凱基99購06,0,0,0,0,0,0,0,0,0,20000,0,0,0,20000,0,20000,20000
058599,T50反1元大99購05,0,0,0,0,0,0,0,0,0,20000,0,0,0,20000,0,20000,20000
057596,聯茂兆豐99購01  ,0,0,0,0,0,0,0,0,0,20000,0,0,0,20000,0,20000,20000
05757P,旺宏永豐96售03  ,0,0,0,0,0,0,0,0,0,20000,0,0,0,20000,0,20000,20000
059994,國巨元富99購01  ,0,0,0,0,0,0,0,0,0,20000,0,0,0,20000,0,20000,20000
054252,奇力新元大96購04,0,0,0,0,0,0,0,0,0,20000,0,0,0,24000,4000,20000,20000
054641,祥碩中信98購01  ,0,0,0,0,0,0,0,0,0,20000,0,0,0,20000,0,20000,20000
05446P,緯穎元大95售04  ,0,0,0,0,0,0,0,0,0,20000,0,0,0,35000,15000,20000,20000
054934,金寶元大97購01  ,0,0,0,0,0,0,0,0,0,20000,0,0,0,20000,0,20000,20000
054964,智易元大99購01  ,0,0,0,0,0,0,0,0,0,20000,0,0,0,20000,0,20000,20000
054859,鴻海群益97購02  ,0,0,0,0,0,0,0,0,0,20000,0,0,0,20000,0,20000,20000
053441,旺宏凱基98購01  ,0,0,0,0,0,0,0,0,0,20000,0,0,0,20000,0,20000,20000
053259,卜蜂群益97購01  ,0,0,0,0,0,0,0,0,0,20000,0,0,0,20000,0,20000,20000
053312,緯穎凱基96購02  ,0,0,0,0,0,0,0,0,0,20000,0,0,0,31000,11000,20000,20000
052857,大成鋼凱基96購01,0,0,0,0,0,0,0,0,0,20000,0,0,0,20000,0,20000,20000
052950,超眾國票98購01  ,0,0,0,0,0,0,0,0,0,20000,0,0,0,20000,0,20000,20000
052908,大成鋼統一96購01,0,0,0,0,0,0,0,0,0,20000,0,0,0,49000,29000,20000,20000
052913,鴻海元富96購05  ,0,0,0,0,0,0,0,0,0,20000,0,0,0,20000,0,20000,20000
052915,創意元富96購01  ,0,0,0,0,0,0,0,0,0,20000,0,0,0,20000,0,20000,20000
053051,楠梓電國票97購01,0,0,0,0,0,0,0,0,0,20000,0,0,0,20000,0,20000,20000
051833,昇陽半元大96購01,0,0,0,0,0,0,0,0,0,20000,0,0,0,20000,0,20000,20000
051906,國巨元大95購09  ,0,0,0,0,0,0,0,0,0,20000,0,0,0,26000,6000,20000,20000
052010,兆豐金中信95購01,0,0,0,0,0,0,0,0,0,20000,0,0,0,32000,12000,20000,20000
047584,元金2X永豐95購01,0,0,0,0,0,0,0,0,0,20000,0,0,0,20000,0,20000,20000
051740,可成國票96購04  ,0,0,0,0,0,0,0,0,0,20000,0,0,0,20000,0,20000,20000
042501,台灣50凱基96購06,0,0,0,0,0,0,0,0,0,20000,0,0,0,20000,0,20000,20000
049230,台達電富邦96購01,0,0,0,0,0,0,0,0,0,20000,0,0,0,20000,0,20000,20000
04041P,大立光統一94售03,0,0,0,0,0,0,0,0,0,20000,0,0,0,20000,0,20000,20000
03647C,T50反1元富99牛02,0,0,0,0,0,0,0,0,0,20000,0,0,0,120000,100000,20000,20000
04907P,超眾國票95售01  ,0,0,0,0,0,0,0,0,0,20000,0,0,0,20000,0,20000,20000
048895,光罩國泰95購01  ,0,0,0,0,0,0,0,0,0,20000,0,0,0,20000,0,20000,20000
048653,巨大元大96購02  ,0,0,0,0,0,0,0,0,0,20000,0,0,0,20000,0,20000,20000
00683L,元大美元指數正2 ,0,0,0,0,0,0,0,0,0,20000,0,0,0,20000,0,20000,20000
050399,潤泰全中信95購01,0,0,0,0,0,0,0,0,0,20000,0,0,0,20000,0,20000,20000
05036P,義隆元大95售03  ,0,0,0,0,0,0,0,0,0,20000,0,0,0,20000,0,20000,20000
049904,矽力元富94購01  ,0,0,0,0,0,0,0,0,0,20000,0,0,0,21000,1000,20000,20000
052200,台光電統一95購02,0,0,0,0,0,0,0,0,0,20000,0,0,0,50000,30000,20000,20000
050968,超眾永豐95購01  ,0,0,0,0,0,0,0,0,0,20000,0,0,0,53000,33000,20000,20000
050645,台積電凱基94購39,0,0,0,0,0,0,0,0,0,20000,0,0,0,20000,0,20000,20000
051300,台光電凱基96購02,0,0,0,0,0,0,0,0,0,20000,0,0,0,20000,0,20000,20000
051236,鴻海元大96購05  ,0,0,0,0,0,0,0,0,0,20000,0,0,0,20000,0,20000,20000
051347,國巨元大95購06  ,0,0,0,0,0,0,0,0,0,20000,0,0,0,20000,0,20000,20000
055215,智邦凱基98購02  ,0,0,0,0,0,0,0,0,0,20000,0,0,0,30000,10000,20000,20000
055386,致新元大97購02  ,0,0,0,0,0,0,0,0,0,20000,0,0,0,20000,0,20000,20000
055346,國巨凱基98購02  ,0,0,0,0,0,0,0,0,0,20000,0,0,0,20000,0,20000,20000
051618,智邦凱基95購06  ,0,0,0,0,0,0,0,0,0,20000,0,0,0,20000,0,20000,20000
055125,智原兆豐97購01  ,0,0,0,0,0,0,0,0,0,20000,0,0,0,20000,0,20000,20000
053654,聯發科凱基98購01,0,0,0,0,0,0,0,0,0,20000,0,0,0,20000,0,20000,20000
06120P,大立光凱基98售05,0,0,0,0,0,0,0,0,0,20000,0,0,0,20000,0,20000,20000
06086P,台積電康和97售01,0,0,0,0,0,0,0,0,0,20000,0,0,0,20000,0,20000,20000
060623,玉晶光元大9C購01,0,0,0,0,0,0,0,0,0,20000,0,0,0,20000,0,20000,20000
07034P,大立光元富99售03,0,0,0,0,0,0,0,0,0,20000,0,0,0,20000,0,20000,20000
07122P,欣興凱基99售05  ,0,0,0,0,0,0,0,0,0,20000,0,0,0,20000,0,20000,20000
07455P,聯發科元大9A售01,0,0,0,0,0,0,0,0,0,20000,0,0,0,20000,0,20000,20000
07536P,華新科元富9A售04,0,0,0,0,0,0,0,0,0,20000,0,0,0,20000,0,20000,20000
3094,聯傑            ,36000,16000,20000,0,0,0,0,0,0,0,0,0,0,0,0,0,20000
060382,儒鴻凱基9A購01  ,0,0,0,0,0,0,0,0,0,19000,0,0,0,20000,1000,19000,19000
060430,和潤永豐9A購01  ,0,0,0,0,0,0,0,0,0,19000,0,0,0,45000,26000,19000,19000
060452,儒鴻元大9A購01  ,0,0,0,0,0,0,0,0,0,19000,0,0,0,67000,48000,19000,19000
060397,群創國票9A購01  ,0,0,0,0,0,0,0,0,0,19000,0,0,0,20000,1000,19000,19000
059763,華擎永豐99購03  ,0,0,0,0,0,0,0,0,0,19000,0,0,0,116000,97000,19000,19000
05983P,聯詠國票96售02  ,0,0,0,0,0,0,0,0,0,19000,0,0,0,113000,94000,19000,19000
056212,台光電國票98購03,0,0,0,0,0,0,0,0,0,19000,0,0,0,34000,15000,19000,19000
058262,大立光富邦9C購02,0,0,0,0,0,0,0,0,0,19000,0,0,0,84000,65000,19000,19000
059114,華新科永豐99購05,0,0,0,0,0,0,0,0,0,19000,0,0,0,30000,11000,19000,19000
059116,晶豪科永豐99購01,0,0,0,0,0,0,0,0,0,19000,0,0,0,19000,0,19000,19000
059224,大立光元大99購15,0,0,0,0,0,0,0,0,0,19000,0,0,0,22000,3000,19000,19000
055315,晶技麥證97購01  ,0,0,0,9000,0,9000,0,0,0,19000,0,0,0,19000,0,19000,19000
050694,國巨凱基96購03  ,0,0,0,0,0,0,0,0,0,19000,0,0,0,58000,39000,19000,19000
04971P,矽力元富94售02  ,0,0,0,0,0,0,0,0,0,19000,0,0,0,19000,0,19000,19000
3050,鈺德            ,28000,9000,19000,0,0,0,0,0,0,0,0,0,0,0,0,0,19000
07514P,台積電元大9A售14,0,0,0,0,0,0,0,0,0,19000,0,0,0,40000,21000,19000,19000
060261,臺股指凱基9A購04,0,0,0,0,0,0,0,0,0,19000,0,0,0,20000,1000,19000,19000
06725P,聯電元富98售01  ,0,0,0,0,0,0,0,0,0,19000,0,0,0,19000,0,19000,19000
06735P,奇力新凱基98售07,0,0,0,0,0,0,0,0,0,19000,0,0,0,19000,0,19000,19000
059390,華新科凱基99購05,0,0,0,0,0,0,0,0,0,18000,0,0,0,38000,20000,18000,18000
056578,智易元大99購02  ,0,0,0,0,0,0,0,0,0,18000,0,0,0,57000,39000,18000,18000
05875P,旺宏群益98售01  ,0,0,0,0,0,0,0,0,0,18000,0,0,0,22000,4000,18000,18000
05872P,大立光凱基96售15,0,0,0,0,0,0,0,0,0,18000,0,0,0,18000,0,18000,18000
058687,聯茂凱基9A購01  ,0,0,0,0,0,0,0,0,0,18000,0,0,0,38000,20000,18000,18000
060028,國揚永豐99購01  ,0,0,0,0,0,0,0,0,0,18000,0,0,0,30000,12000,18000,18000
056237,智邦群益97購02  ,0,0,0,0,0,0,0,0,0,18000,0,0,0,30000,12000,18000,18000
058945,S&P正2群益9C購01,0,0,0,0,0,0,0,0,0,18000,0,0,0,18000,0,18000,18000
057987,大立光元富98購02,0,0,0,0,0,0,0,0,0,18000,0,0,0,315000,297000,18000,18000
057008,華新科中信99購02,0,0,0,0,0,0,0,0,0,18000,0,0,0,20000,2000,18000,18000
060245,聯陽元大9C購01  ,0,0,0,0,0,0,0,0,0,18000,0,0,0,160000,142000,18000,18000
051876,宏達電國票96購01,0,0,0,0,0,0,0,0,0,18000,0,0,0,18000,0,18000,18000
05180P,玉晶光凱基95售04,0,0,0,0,0,0,0,0,0,18000,0,0,0,18000,0,18000,18000
04514P,元石油中信97售01,0,0,0,0,0,0,0,0,0,18000,0,0,0,18000,0,18000,18000
049252,國巨元大96購01  ,0,0,0,0,0,0,0,0,0,18000,0,0,0,69000,51000,18000,18000
052224,楠梓電凱基97購01,0,0,0,0,0,0,0,0,0,18000,0,0,0,18000,0,18000,18000
053494,南亞科兆豐96購02,0,0,0,0,0,0,0,0,0,18000,0,0,0,20000,2000,18000,18000
054418,茂林元大97購01  ,0,0,0,0,0,0,0,0,0,18000,0,0,0,18000,0,18000,18000
057616,聯電凱基99購01  ,0,0,0,0,0,0,0,0,0,18000,0,0,0,83000,65000,18000,18000
054231,國巨群益98購03  ,0,0,0,0,0,0,0,0,0,18000,0,0,0,199000,181000,18000,18000
06859P,元金2X中信9C售01,0,0,0,0,0,0,0,0,0,18000,0,0,0,60000,42000,18000,18000
060262,臺股指凱基9B購02,0,0,0,0,0,0,0,0,0,18000,0,0,0,18000,0,18000,18000
07435P,台積電富邦9C售07,0,0,0,0,0,0,0,0,0,18000,0,0,0,18000,0,18000,18000
07541P,國巨凱基9A售12  ,0,0,0,0,0,0,0,0,0,18000,0,0,0,20000,2000,18000,18000
1441,大東            ,81000,63000,18000,0,0,0,0,0,0,0,0,0,0,0,0,0,18000
2597,潤弘            ,24000,5000,19000,0,0,0,0,0,0,-1000,0,1000,-1000,0,0,0,18000
2727,王品            ,30000,11000,19000,0,0,0,0,0,0,-1000,0,1000,-1000,0,0,0,18000
6183,關貿            ,42001,25000,17001,0,0,0,0,0,0,0,0,0,0,0,0,0,17001
060450,南亞元大9A購02  ,0,0,0,0,0,0,0,0,0,17000,0,0,0,37000,20000,17000,17000
057021,台積電凱基9A購02,0,0,0,0,0,0,0,0,0,17000,0,0,0,17000,0,17000,17000
059924,世紀鋼元大99購06,0,0,0,0,0,0,0,0,0,17000,0,0,0,309000,292000,17000,17000
058029,台灣50永豐9A購01,0,0,0,0,0,0,0,0,0,17000,0,0,0,17000,0,17000,17000
056773,晶技元大99購03  ,0,0,0,0,0,0,0,0,0,17000,0,0,0,17000,0,17000,17000
060000,國巨台新99購01  ,0,0,0,0,0,0,0,0,0,17000,0,0,0,17000,0,17000,17000
057672,茂林元大98購02  ,0,0,0,0,0,0,0,0,0,17000,0,0,0,17000,0,17000,17000
057194,南電元大98購01  ,0,0,0,0,0,0,0,0,0,17000,0,0,0,27000,10000,17000,17000
057169,微星元大98購01  ,0,0,0,0,0,0,0,0,0,17000,0,0,0,22000,5000,17000,17000
059580,大立光元富99購07,0,0,0,0,0,0,0,0,0,17000,0,0,0,90000,73000,17000,17000
059389,國巨凱基99購14  ,0,0,0,0,0,0,0,0,0,17000,0,0,0,39000,22000,17000,17000
059067,上銀國票9A購02  ,0,0,0,0,0,0,0,0,0,17000,0,0,0,17000,0,17000,17000
056107,智易永豐97購02  ,0,0,0,0,0,0,0,0,0,17000,0,0,0,27000,10000,17000,17000
055686,致伸凱基97購02  ,0,0,0,0,0,0,0,0,0,17000,0,0,0,100000,83000,17000,17000
052188,欣興群益95購03  ,0,0,0,0,0,0,0,0,0,17000,0,0,0,17000,0,17000,17000
052502,瀚宇博永豐95購02,0,0,0,0,0,0,0,0,0,17000,0,0,0,44000,27000,17000,17000
052062,臺股指國票95購09,0,0,0,0,0,0,0,0,0,17000,0,0,0,50000,33000,17000,17000
2530,華建            ,24000,7000,17000,0,0,0,0,0,0,0,0,0,0,0,0,0,17000
2506,太設            ,17000,0,17000,0,0,0,0,0,0,0,0,0,0,0,0,0,17000
07523P,台積電中信9C售05,0,0,0,0,0,0,0,0,0,17000,0,0,0,17000,0,17000,17000
060618,玉晶光元大9A購02,0,0,0,0,0,0,0,0,0,17000,0,0,0,17000,0,17000,17000
059619,台積電日盛9A購04,0,0,0,0,0,0,0,0,0,16000,0,0,0,297000,281000,16000,16000
059209,華通元大99購08  ,0,0,0,0,0,0,0,0,0,16000,0,0,0,16000,0,16000,16000
059599,健策元大9B購02  ,0,0,0,0,0,0,0,0,0,16000,0,0,0,69000,53000,16000,16000
059492,國巨國票9A購06  ,0,0,0,0,0,0,0,0,0,16000,0,0,0,26000,10000,16000,16000
057368,微星元大98購02  ,0,0,0,0,0,0,0,0,0,16000,0,0,0,16000,0,16000,16000
057369,奇力新元大99購05,0,0,0,0,0,0,0,0,0,16000,0,0,0,23000,7000,16000,16000
058918,SGBR2X元富99購04,0,0,0,0,0,0,0,0,0,16000,0,0,0,250000,234000,16000,16000
058957,貿聯國票9A購01  ,0,0,0,0,0,0,0,0,0,16000,0,0,0,86000,70000,16000,16000
051727,S&P反1國票97購01,0,0,0,0,0,0,0,0,0,16000,0,0,0,30000,14000,16000,16000
03675C,臺股指元大04牛02,0,0,0,0,0,0,0,0,0,16000,0,0,0,16000,0,16000,16000
052191,超眾群益96購01  ,0,0,0,0,0,0,0,0,0,16000,0,0,0,42000,26000,16000,16000
05060P,台達電富邦97售02,0,0,0,0,0,0,0,0,0,16000,0,0,0,20000,4000,16000,16000
050867,聯鈞永豐95購01  ,0,0,0,0,0,0,0,0,0,16000,0,0,0,61000,45000,16000,16000
055735,宏達電元富98購01,0,0,0,0,0,0,0,0,0,16000,0,0,0,16000,0,16000,16000
055837,致茂元大97購02  ,0,0,0,0,0,0,0,0,0,16000,0,0,0,68000,52000,16000,16000
054497,國巨永豐96購05  ,0,0,0,0,0,0,0,0,0,16000,0,0,0,16000,0,16000,16000
052916,華新科富邦96購01,0,0,0,0,0,0,0,0,0,16000,0,0,0,16000,0,16000,16000
052963,智邦凱基96購02  ,0,0,0,0,0,0,0,0,0,16000,0,0,0,56000,40000,16000,16000
060640,京鼎永豐9A購01  ,0,0,0,0,0,0,0,0,0,16000,0,0,0,29000,13000,16000,16000
06051P,嘉聯益國票97售04,0,0,0,0,0,0,0,0,0,16000,0,0,0,24000,8000,16000,16000
06301P,臺股指元大97售04,0,0,0,0,0,0,0,0,0,16000,0,0,0,19000,3000,16000,16000
06486P,麗豐元大98售02  ,0,0,0,0,0,0,0,0,0,16000,0,0,0,43000,27000,16000,16000
1474,弘裕            ,44000,28000,16000,0,0,0,0,0,0,0,0,0,0,0,0,0,16000
3583,辛耘            ,62000,46000,16000,0,0,0,0,0,0,0,0,0,0,0,0,0,16000
4540,全球傳動        ,46000,30000,16000,0,0,0,0,0,0,0,0,0,0,0,0,0,16000
056198,台光電永豐97購02,0,0,0,0,0,0,0,0,0,15000,0,0,0,83000,68000,15000,15000
056392,玉晶光富邦9C購01,0,0,0,0,0,0,0,0,0,15000,0,0,0,15000,0,15000,15000
056720,世紀鋼永豐98購01,0,0,0,0,0,0,0,0,0,15000,0,0,0,57000,42000,15000,15000
057915,台泥凱基98購01  ,0,0,0,0,0,0,0,0,0,15000,0,0,0,15000,0,15000,15000
05683P,矽創元大96售01  ,0,0,0,0,0,0,0,0,0,15000,0,0,0,65000,50000,15000,15000
060072,國巨元富99購04  ,0,0,0,0,0,0,0,0,0,15000,0,0,0,35000,20000,15000,15000
060480,億豐元大9A購02  ,0,0,0,0,0,0,0,0,0,15000,0,0,0,15000,0,15000,15000
060428,瑞祺永豐9A購01  ,0,0,0,0,0,0,0,0,0,15000,0,0,0,15000,0,15000,15000
060188,華新科元富9A購03,0,0,0,0,0,0,0,0,0,15000,0,0,0,514000,499000,15000,15000
060129,祥碩永豐99購03  ,0,0,0,0,0,0,0,0,0,15000,0,0,0,44000,29000,15000,15000
057450,國泰金元富98購01,0,0,0,0,0,0,0,0,0,15000,0,0,0,15000,0,15000,15000
057819,新日興元大99購01,0,0,0,0,0,0,0,0,0,15000,0,0,0,65000,50000,15000,15000
05710P,禾伸堂國票97售02,0,0,0,0,0,0,0,0,0,15000,0,0,0,15000,0,15000,15000
059527,聯發科凱基99購16,0,0,0,0,0,0,0,0,0,15000,0,0,0,65000,50000,15000,15000
059565,國巨凱基99購16  ,0,0,0,0,0,0,0,0,0,15000,0,0,0,75000,60000,15000,15000
058526,鈺齊元大99購02  ,0,0,0,0,0,0,0,0,0,15000,0,0,0,15000,0,15000,15000
059136,臺股指群益99購11,0,0,0,0,0,0,0,0,0,15000,0,0,0,22000,7000,15000,15000
059633,聯發科凱基9A購07,0,0,0,0,0,0,0,0,0,15000,0,0,0,50000,35000,15000,15000
059304,華新科兆豐99購06,0,0,0,0,0,0,0,0,0,15000,0,0,0,15000,0,15000,15000
059320,華新科元大99購15,0,0,0,0,0,0,0,0,0,15000,0,0,0,27000,12000,15000,15000
05295P,緯創凱基95售01  ,0,0,0,0,0,0,0,0,0,15000,0,0,0,15000,0,15000,15000
055459,建準永豐97購03  ,0,0,0,0,0,0,0,0,0,15000,0,0,0,24000,9000,15000,15000
055707,聯鈞永豐98購01  ,0,0,0,0,0,0,0,0,0,15000,0,0,0,30000,15000,15000,15000
054201,聯詠富邦97購02  ,0,0,0,0,0,0,0,0,0,15000,0,0,0,15000,0,15000,15000
054157,國巨亞東96購01  ,0,0,0,0,0,0,0,0,0,15000,0,0,0,25000,10000,15000,15000
056481,創意元大98購01  ,0,0,0,0,0,0,0,0,0,15000,0,0,0,25000,10000,15000,15000
057638,上銀元大99購01  ,0,0,0,0,0,0,0,0,0,15000,0,0,0,15000,0,15000,15000
057567,嘉聯益富邦9A購01,0,0,0,0,0,0,0,0,0,15000,0,0,0,35000,20000,15000,15000
058647,華新科永豐99購03,0,0,0,0,0,0,0,0,0,15000,0,0,0,45000,30000,15000,15000
051049,亞德客群益95購01,0,0,0,0,0,0,0,0,0,15000,0,0,0,15000,0,15000,15000
051388,大立光麥證95購03,0,0,0,15000,0,15000,0,0,0,15000,0,0,0,15000,0,15000,15000
052227,瑞昱凱基95購05  ,0,0,0,0,0,0,0,0,0,15000,0,0,0,15000,0,15000,15000
050451,嘉晶元大95購01  ,0,0,0,0,0,0,0,0,0,15000,0,0,0,15000,0,15000,15000
04854P,鴻海國泰96售04  ,0,0,0,0,0,0,0,0,0,15000,0,0,0,15000,0,15000,15000
00665L,富邦恒生國企正2 ,11000,0,11000,0,0,0,0,0,0,4000,0,0,0,4000,0,4000,15000
04382P,美律國泰95售01  ,0,0,0,0,0,0,0,0,0,15000,0,0,0,15000,0,15000,15000
049582,台積電元大95購03,0,0,0,0,0,0,0,0,0,15000,0,0,0,15000,0,15000,15000
051969,世紀鋼永豐95購01,0,0,0,0,0,0,0,0,0,15000,0,0,0,15000,0,15000,15000
5258,虹堡            ,71000,63000,8000,0,0,0,0,0,0,7000,7000,0,7000,0,0,0,15000
6591,動力-KY         ,101000,85000,16000,0,0,0,0,0,0,-1000,1000,2000,-1000,0,0,0,15000
06239P,奇力新元大97售08,0,0,0,0,0,0,0,0,0,15000,0,0,0,37000,22000,15000,15000
060545,台積電凱基9B購02,0,0,0,0,0,0,0,0,0,15000,0,0,0,22000,7000,15000,15000
059332,台灣50國票9A購07,0,0,0,0,0,0,0,0,0,14000,0,0,0,25000,11000,14000,14000
059569,旺宏凱基99購09  ,0,0,0,0,0,0,0,0,0,14000,0,0,0,15000,1000,14000,14000
058818,南電台新99購03  ,0,0,0,0,0,0,0,0,0,14000,0,0,0,14000,0,14000,14000
057279,國揚元大98購01  ,0,0,0,0,0,0,0,0,0,14000,0,0,0,14000,0,14000,14000
057850,上銀兆豐99購02  ,0,0,0,0,0,0,0,0,0,14000,0,0,0,20000,6000,14000,14000
060214,茂林康和9A購01  ,0,0,0,0,0,0,0,0,0,14000,0,0,0,14000,0,14000,14000
060448,道瓊反元大9A購04,0,0,0,0,0,0,0,0,0,14000,0,0,0,14000,0,14000,14000
059016,晶相光元富99購03,0,0,0,0,0,0,0,0,0,14000,0,0,0,15000,1000,14000,14000
056876,群創凱基98購11  ,0,0,0,0,0,0,0,0,0,14000,0,0,0,14000,0,14000,14000
051828,微星元大95購03  ,0,0,0,0,0,0,0,0,0,14000,0,0,0,64000,50000,14000,14000
054053,聯茂元大96購01  ,0,0,0,0,0,0,0,0,0,14000,0,0,0,106000,92000,14000,14000
054702,智邦第一97購01  ,0,0,0,0,0,0,0,0,0,14000,0,0,0,14000,0,14000,14000
05268P,玉晶光元大98售01,0,0,0,0,0,0,0,0,0,14000,0,0,0,14000,0,14000,14000
053490,為升兆豐97購01  ,0,0,0,0,0,0,0,0,0,14000,0,0,0,24000,10000,14000,14000
053970,聯發科元大97購08,0,0,0,0,0,0,0,0,0,14000,0,0,0,15000,1000,14000,14000
060540,南亞凱基9A購01  ,0,0,0,0,0,0,0,0,0,14000,0,0,0,56000,42000,14000,14000
06925P,致茂群益9A售02  ,0,0,0,0,0,0,0,0,0,14000,0,0,0,14000,0,14000,14000
06674P,祥碩群益98售02  ,0,0,0,0,0,0,0,0,0,14000,0,0,0,35000,21000,14000,14000
07324P,台積電元大99售40,0,0,0,0,0,0,0,0,0,14000,0,0,0,79000,65000,14000,14000
2365,昆盈            ,179000,163000,16000,0,0,0,0,0,0,-2000,0,2000,-2000,0,0,0,14000
058978,SGBR2X凱基9A購03,0,0,0,0,0,0,0,0,0,13000,0,0,0,13000,0,13000,13000
060221,大立光凱基9A購07,0,0,0,0,0,0,0,0,0,13000,0,0,0,29000,16000,13000,13000
060291,高鐵元大9A購01  ,0,0,0,0,0,0,0,0,0,13000,0,0,0,13000,0,13000,13000
058238,奇鋐元大99購02  ,0,0,0,0,0,0,0,0,0,13000,0,0,0,85000,72000,13000,13000
057358,元油2X元大98購08,0,0,0,0,0,0,0,0,0,13000,0,0,0,13000,0,13000,13000
058819,華通國泰9B購01  ,0,0,0,0,0,0,0,0,0,13000,0,0,0,95000,82000,13000,13000
059115,美食永豐99購01  ,0,0,0,0,0,0,0,0,0,13000,0,0,0,25000,12000,13000,13000
053151,華新科元大96購04,0,0,0,0,0,0,0,0,0,13000,0,0,0,73000,60000,13000,13000
054625,旺宏凱基98購03  ,0,0,0,0,0,0,0,0,0,13000,0,0,0,13000,0,13000,13000
052003,泰碩國泰97購02  ,0,0,0,0,0,0,0,0,0,13000,0,0,0,13000,0,13000,13000
049815,緯穎元大94購06  ,0,0,0,0,0,0,0,0,0,13000,0,0,0,13000,0,13000,13000
052650,台郡永豐96購01  ,0,0,0,0,0,0,0,0,0,13000,0,0,0,13000,0,13000,13000
00660,元大歐洲50      ,0,0,0,0,0,0,0,0,0,13000,0,0,0,14000,1000,13000,13000
048385,亞德客國票94購01,0,0,0,0,0,0,0,0,0,13000,0,0,0,13000,0,13000,13000
03416B,臺股指凱基95熊05,0,0,0,0,0,0,0,0,0,13000,0,0,0,15000,2000,13000,13000
07423P,大立光元大99售33,0,0,0,0,0,0,0,0,0,13000,0,0,0,38000,25000,13000,13000
2731,雄獅            ,28000,15000,13000,0,0,0,0,0,0,0,0,0,0,0,0,0,13000
058542,T50反1富邦9B購01,0,0,0,0,0,0,0,0,0,12000,0,0,0,12000,0,12000,12000
058382,S&P500中信99購01,0,0,0,0,0,0,0,0,0,12000,0,0,0,12000,0,12000,12000
059513,揚明光永豐99購01,0,0,0,0,0,0,0,0,0,12000,0,0,0,22000,10000,12000,12000
060010,義隆群益99購02  ,0,0,0,0,0,0,0,0,0,12000,0,0,0,31000,19000,12000,12000
058735,南茂永豐99購01  ,0,0,0,0,0,0,0,0,0,12000,0,0,0,80000,68000,12000,12000
058717,南電台新99購02  ,0,0,0,0,0,0,0,0,0,12000,0,0,0,12000,0,12000,12000
060058,牧德凱基9B購01  ,0,0,0,0,0,0,0,0,0,12000,0,0,0,42000,30000,12000,12000
060436,巨大永豐9A購01  ,0,0,0,0,0,0,0,0,0,12000,0,0,0,30000,18000,12000,12000
059745,欣興元富99購04  ,0,0,0,0,0,0,0,0,0,12000,0,0,0,13000,1000,12000,12000
059901,滬深2X元大9C購07,0,0,0,0,0,0,0,0,0,12000,0,0,0,22000,10000,12000,12000
056714,晶相光永豐98購02,0,0,0,0,0,0,0,0,0,12000,0,0,0,12000,0,12000,12000
00753L,中信中國50正2   ,0,0,0,0,0,0,0,0,0,12000,0,0,0,117000,105000,12000,12000
00766L,台新MSCI中國正2 ,0,0,0,0,0,0,0,0,0,12000,0,0,0,132000,120000,12000,12000
04953P,台積電群益94售13,0,0,0,0,0,0,0,0,0,12000,0,0,0,12000,0,12000,12000
049597,泰鼎元大96購01  ,0,0,0,0,0,0,0,0,0,12000,0,0,0,12000,0,12000,12000
049600,緯穎元大95購02  ,0,0,0,0,0,0,0,0,0,12000,0,0,0,19000,7000,12000,12000
051842,大成鋼富邦97購01,0,0,0,0,0,0,0,0,0,12000,0,0,0,12000,0,12000,12000
051402,玉晶光永豐95購04,0,0,0,0,0,0,0,0,0,12000,0,0,0,22000,10000,12000,12000
050673,旺宏富邦96購02  ,0,0,0,0,0,0,0,0,0,12000,0,0,0,12000,0,12000,12000
052417,聯發科兆豐9B購01,0,0,0,0,0,0,0,0,0,12000,0,0,0,22000,10000,12000,12000
054807,台化元大9A購02  ,0,0,0,0,0,0,0,0,0,12000,0,0,0,12000,0,12000,12000
054897,信錦康和97購01  ,0,0,0,0,0,0,0,0,0,12000,0,0,0,12000,0,12000,12000
055521,S&P反1群益01購01,0,0,0,0,0,0,0,0,0,12000,0,0,0,12000,0,12000,12000
054376,聯茂中信97購01  ,0,0,0,0,0,0,0,0,0,12000,0,0,0,100000,88000,12000,12000
055590,聯發科元大98購02,0,0,0,0,0,0,0,0,0,12000,0,0,0,12000,0,12000,12000
053358,晶技統一98購01  ,0,0,0,0,0,0,0,0,0,12000,0,0,0,12000,0,12000,12000
056518,美律國票99購01  ,0,0,0,0,0,0,0,0,0,12000,0,0,0,12000,0,12000,12000
055911,可成凱基98購02  ,0,0,0,0,0,0,0,0,0,12000,0,0,0,37000,25000,12000,12000
2882A,國泰特          ,10000,0,10000,0,0,0,0,0,0,2000,2000,0,2000,0,0,0,12000
8104,錸寶            ,26000,14000,12000,0,0,0,0,0,0,0,0,0,0,0,0,0,12000
9944,新麗            ,120000,108000,12000,0,0,0,0,0,0,0,0,0,0,0,0,0,12000
2476,鉅祥            ,26000,14000,12000,0,0,0,0,0,0,0,0,0,0,0,0,0,12000
07309P,聯發科凱基99售18,0,0,0,0,0,0,0,0,0,12000,0,0,0,12000,0,12000,12000
06957P,FBVIX凱基01售01 ,0,0,0,0,0,0,0,0,0,12000,0,0,0,12000,0,12000,12000
060558,億豐凱基9A購01  ,0,0,0,0,0,0,0,0,0,12000,0,0,0,22000,10000,12000,12000
06242P,大立光元富9A售02,0,0,0,0,0,0,0,0,0,12000,0,0,0,23000,11000,12000,12000
05634P,玉晶光台新97售01,0,0,0,0,0,0,0,0,0,11000,0,0,0,68000,57000,11000,11000
056921,京元電兆豐98購01,0,0,0,0,0,0,0,0,0,11000,0,0,0,202000,191000,11000,11000
057271,國巨元大98購17  ,0,0,0,0,0,0,0,0,0,11000,0,0,0,11000,0,11000,11000
057420,美食凱基98購01  ,0,10000,-10000,0,0,0,0,0,0,21000,0,0,0,21000,0,21000,11000
058081,技嘉群益9A購03  ,0,0,0,0,0,0,0,0,0,11000,0,0,0,31000,20000,11000,11000
058572,百和凱基9A購01  ,0,0,0,0,0,0,0,0,0,11000,0,0,0,20000,9000,11000,11000
058848,台積電群益99購07,0,0,0,0,0,0,0,0,0,11000,0,0,0,11000,0,11000,11000
056580,泰鼎元大9A購01  ,0,0,0,0,0,0,0,0,0,11000,0,0,0,11000,0,11000,11000
056613,旺宏永豐98購01  ,0,0,0,0,0,0,0,0,0,11000,0,0,0,61000,50000,11000,11000
058799,晶技元大99購04  ,0,0,0,0,0,0,0,0,0,11000,0,0,0,41000,30000,11000,11000
059377,台積電群益99購09,0,0,0,0,0,0,0,0,0,11000,0,0,0,11000,0,11000,11000
055892,國巨統一99購01  ,0,0,0,0,0,0,0,0,0,11000,0,0,0,11000,0,11000,11000
054276,國巨群益96購07  ,0,0,0,0,0,0,0,0,0,11000,0,0,0,11000,0,11000,11000
05250P,臻鼎國票96售01  ,0,0,0,0,0,0,0,0,0,11000,0,0,0,13000,2000,11000,11000
052612,康舒元大97購01  ,0,0,0,0,0,0,0,0,0,11000,0,0,0,80000,69000,11000,11000
055360,台表科凱基97購02,0,0,0,0,0,0,0,0,0,11000,0,0,0,11000,0,11000,11000
053729,聯茂凱基96購05  ,0,0,0,0,0,0,0,0,0,11000,0,0,0,30000,19000,11000,11000
053748,燿華永豐96購04  ,0,0,0,0,0,0,0,0,0,11000,0,0,0,11000,0,11000,11000
04928P,大立光凱基95售07,0,0,0,0,0,0,0,0,0,11000,0,0,0,11000,0,11000,11000
051705,富邦金群益97購01,0,0,0,0,0,0,0,0,0,11000,0,0,0,11000,0,11000,11000
047211,華新科富邦99購01,0,0,0,0,0,0,0,0,0,11000,0,0,0,11000,0,11000,11000
06682P,玉晶光元大99售08,0,0,0,0,0,0,0,0,0,11000,0,0,0,11000,0,11000,11000
07267P,臺股指元大99售23,0,0,0,0,0,0,0,0,0,11000,0,0,0,11000,0,11000,11000
1615,大山            ,15000,2000,13000,0,0,0,0,0,0,-2000,1000,3000,-2000,0,0,0,11000
9912,偉聯            ,11000,0,11000,0,0,0,0,0,0,0,0,0,0,0,0,0,11000
2545,皇翔            ,45000,48000,-3000,0,0,0,0,0,0,14000,17000,3000,14000,0,0,0,11000
3346,麗清            ,30000,19000,11000,0,0,0,0,0,0,0,0,0,0,0,0,0,11000
3257,虹冠電          ,20000,9000,11000,0,0,0,0,0,0,0,0,0,0,0,0,0,11000
8926,台汽電          ,629000,676150,-47150,0,0,0,0,0,0,58000,32000,34000,-2000,60000,0,60000,10850
059376,國巨群益99購09  ,0,0,0,0,0,0,0,0,0,10000,0,0,0,10000,0,10000,10000
059303,國巨兆豐99購04  ,0,0,0,0,0,0,0,0,0,10000,0,0,0,10000,0,10000,10000
059112,上銀永豐99購01  ,0,0,0,0,0,0,0,0,0,10000,0,0,0,10000,0,10000,10000
059129,麗豐中信99購01  ,0,0,0,0,0,0,0,0,0,10000,0,0,0,40000,30000,10000,10000
059058,可成凱基9B購01  ,0,0,0,0,0,0,0,0,0,10000,0,0,0,30000,20000,10000,10000
059158,S&P正2凱基99購01,0,0,0,0,0,0,0,0,0,10000,0,0,0,10000,0,10000,10000
059159,上銀凱基99購05  ,0,0,0,0,0,0,0,0,0,10000,0,0,0,10000,0,10000,10000
059152,臺股指國票99購15,0,0,0,0,0,0,0,0,0,10000,0,0,0,10000,0,10000,10000
056536,義隆凱基98購04  ,0,0,0,0,0,0,0,0,0,10000,0,0,0,26000,16000,10000,10000
058864,欣興凱基99購04  ,0,0,0,0,0,0,0,0,0,10000,0,0,0,10000,0,10000,10000
058860,SGBR2X凱基9A購01,0,0,0,0,0,0,0,0,0,10000,0,0,0,10000,0,10000,10000
058845,元油2X群益9C購04,0,0,0,0,0,0,0,0,0,10000,0,0,0,10000,0,10000,10000
059572,華新科凱基99購08,0,0,0,0,0,0,0,0,0,10000,0,0,0,10000,0,10000,10000
059581,日月光元富99購02,0,0,0,0,0,0,0,0,0,10000,0,0,0,244000,234000,10000,10000
058564,元金2X凱基9C購01,0,0,0,0,0,0,0,0,0,10000,0,0,0,10000,0,10000,10000
058538,智邦台新99購02  ,0,0,0,0,0,0,0,0,0,10000,0,0,0,10000,0,10000,10000
058529,S&P正2元富9B購01,0,0,0,0,0,0,0,0,0,10000,0,0,0,10000,0,10000,10000
058495,元大金群益9B購01,0,0,0,0,0,0,0,0,0,10000,0,0,0,10000,0,10000,10000
058514,潤泰全元大99購01,0,0,0,0,0,0,0,0,0,10000,0,0,0,22000,12000,10000,10000
058378,南電凱基99購01  ,0,0,0,0,0,0,0,0,0,10000,0,0,0,49000,39000,10000,10000
058414,大立光兆豐99購02,0,0,0,0,0,0,0,0,0,10000,0,0,0,20000,10000,10000,10000
058452,義隆永豐99購02  ,0,0,0,0,0,0,0,0,0,10000,0,0,0,12000,2000,10000,10000
057813,京元電元大98購03,0,0,0,0,0,0,0,0,0,10000,0,0,0,10000,0,10000,10000
058154,泰碩統一9A購01  ,0,0,0,0,0,0,0,0,0,10000,0,0,0,10000,0,10000,10000
058149,百和元大99購02  ,0,0,0,0,0,0,0,0,0,10000,0,0,0,10000,0,10000,10000
058298,聯茂凱基99購05  ,0,0,0,0,0,0,0,0,0,10000,0,0,0,21000,11000,10000,10000
058171,國巨凱基9A購07  ,0,0,0,0,0,0,0,0,0,10000,0,0,0,10000,0,10000,10000
058196,台塑中信99購01  ,0,0,0,0,0,0,0,0,0,10000,0,0,0,10000,0,10000,10000
057410,南電群益98購01  ,0,0,0,0,0,0,0,0,0,10000,0,0,0,10000,0,10000,10000
057436,義隆國票99購02  ,0,0,0,0,0,0,0,0,0,10000,0,0,0,10000,0,10000,10000
057449,華新科元富99購02,0,0,0,0,0,0,0,0,0,10000,0,0,0,10000,0,10000,10000
057239,貿聯凱基98購05  ,0,0,0,0,0,0,0,0,0,10000,0,0,0,10000,0,10000,10000
059495,台灣50元富9C購02,0,0,0,0,0,0,0,0,0,10000,0,0,0,10000,0,10000,10000
058701,鴻海元大99購16  ,0,0,0,0,0,0,0,0,0,10000,0,0,0,10000,0,10000,10000
05870P,聯發科凱基96售19,0,0,0,0,0,0,0,0,0,10000,0,0,0,10000,0,10000,10000
060033,臻鼎永豐99購01  ,0,0,0,0,0,0,0,0,0,10000,0,0,0,62000,52000,10000,10000
060013,S&P正2康和99購01,0,0,0,0,0,0,0,0,0,10000,0,0,0,10000,0,10000,10000
057719,欣興元富02購01  ,0,0,0,0,0,0,0,0,0,10000,0,0,0,10000,0,10000,10000
056969,智易永豐98購01  ,0,0,0,0,0,0,0,0,0,10000,0,0,0,10000,0,10000,10000
056381,台虹元富98購01  ,0,0,0,0,0,0,0,0,0,10000,0,0,0,10000,0,10000,10000
058052,南電元大98購02  ,0,0,0,0,0,0,0,0,0,10000,0,0,0,10000,0,10000,10000
058017,漢唐凱基99購01  ,0,0,0,0,0,0,0,0,0,10000,0,0,0,10000,0,10000,10000
056204,嘉澤永豐97購01  ,0,0,0,0,0,0,0,0,0,10000,0,0,0,10000,0,10000,10000
056175,可成元富97購03  ,0,0,0,0,0,0,0,0,0,10000,0,0,0,10000,0,10000,10000
056247,台郡群益97購01  ,0,0,0,0,0,0,0,0,0,10000,0,0,0,11000,1000,10000,10000
058942,南茂中信99購01  ,0,0,0,0,0,0,0,0,0,10000,0,0,0,10000,0,10000,10000
058946,SGBR2X群益9B購01,0,0,0,0,0,0,0,0,0,10000,0,0,0,10000,0,10000,10000
057963,緯穎元大98購08  ,0,0,0,0,0,0,0,0,0,10000,0,0,0,12000,2000,10000,10000
056675,聯發科元富02購01,0,0,0,0,0,0,0,0,0,10000,0,0,0,10000,0,10000,10000
056703,群創國泰9A購01  ,0,0,0,0,0,0,0,0,0,10000,0,0,0,10000,0,10000,10000
056776,聯茂元大99購01  ,0,0,0,0,0,0,0,0,0,10000,0,0,0,16000,6000,10000,10000
056778,元石油群益9B購01,0,0,0,0,0,0,0,0,0,10000,0,0,0,10000,0,10000,10000
056738,國巨凱基9A購02  ,0,0,0,0,0,0,0,0,0,10000,0,0,0,65000,55000,10000,10000
056845,揚明光元富98購01,0,0,0,0,0,0,0,0,0,10000,0,0,0,10000,0,10000,10000
057888,貿聯群益98購02  ,0,0,0,0,0,0,0,0,0,10000,0,0,0,10000,0,10000,10000
059820,南亞科凱基99購07,0,0,0,0,0,0,0,0,0,10000,0,0,0,67000,57000,10000,10000
059861,聯發科群益9A購01,0,0,0,0,0,0,0,0,0,10000,0,0,0,10000,0,10000,10000
059882,臺股指凱基9C購06,0,0,0,0,0,0,0,0,0,10000,0,0,0,11000,1000,10000,10000
059674,玉山金元富99購02,0,0,0,0,0,0,0,0,0,10000,0,0,0,10000,0,10000,10000
059779,滬深2X元大9C購05,0,0,0,0,0,0,0,0,0,10000,0,0,0,10000,0,10000,10000
059815,SP黃豆凱基9A購03,0,0,0,0,0,0,0,0,0,10000,0,0,0,10000,0,10000,10000
059808,創意元富99購01  ,0,0,0,0,0,0,0,0,0,10000,0,0,0,10000,0,10000,10000
059941,聯發科永豐99購04,0,0,0,0,0,0,0,0,0,10000,0,0,0,10000,0,10000,10000
059044,聯電日盛99購02  ,0,0,0,0,0,0,0,0,0,10000,0,0,0,10000,0,10000,10000
060073,台積電元富99購03,0,0,0,0,0,0,0,0,0,10000,0,0,0,10000,0,10000,10000
057016,中石化凱基9B購01,0,0,0,0,0,0,0,0,0,10000,0,0,0,10000,0,10000,10000
057049,新日興元大98購02,0,0,0,0,0,0,0,0,0,10000,0,0,0,10000,0,10000,10000
060372,A50正2元富9A購04,0,0,0,0,0,0,0,0,0,10000,0,0,0,10000,0,10000,10000
060353,A50正2元富9A購01,0,0,0,0,0,0,0,0,0,10000,0,0,0,10000,0,10000,10000
060467,神基元大9A購01  ,0,0,0,0,0,0,0,0,0,10000,0,0,0,64000,54000,10000,10000
06189P,華新科永豐97售03,0,0,0,0,0,0,0,0,0,10000,0,0,0,20000,10000,10000,10000
060304,大立光富邦9C購05,0,0,0,0,0,0,0,0,0,10000,0,0,0,10000,0,10000,10000
06021P,世紀鋼元富96售03,0,0,0,0,0,0,0,0,0,10000,0,0,0,10000,0,10000,10000
047202,欣興元富96購01  ,0,0,0,0,0,0,0,0,0,10000,0,0,0,10000,0,10000,10000
047493,旺宏元富96購01  ,0,0,0,0,0,0,0,0,0,10000,0,0,0,10000,0,10000,10000
04775P,台積電凱基94售29,0,0,0,0,0,0,0,0,0,10000,0,0,0,10000,0,10000,10000
051749,矽力國泰97購01  ,0,0,0,0,0,0,0,0,0,10000,0,0,0,10000,0,10000,10000
051753,華通元大96購03  ,0,0,0,0,0,0,0,0,0,10000,0,0,0,10000,0,10000,10000
051682,元黃金凱基97購01,0,0,0,0,0,0,0,0,0,10000,0,0,0,10000,0,10000,10000
047774,台表科元大95購01,0,0,0,0,0,0,0,0,0,10000,0,0,0,10000,0,10000,10000
045753,大立光國泰94購02,0,0,0,0,0,0,0,0,0,10000,0,0,0,53000,43000,10000,10000
04630P,嘉聯益元大95售02,0,0,0,0,0,0,0,0,0,10000,0,0,0,10000,0,10000,10000
046053,滬深2X群益94購01,0,0,0,0,0,0,0,0,0,10000,0,0,0,10000,0,10000,10000
04634P,臺股指群益94售09,0,0,0,0,0,0,0,0,0,10000,0,0,0,10000,0,10000,10000
046375,友達凱基98購01  ,0,0,0,0,0,0,0,0,0,10000,0,0,0,10000,0,10000,10000
046793,聯發科元富99購01,0,0,0,0,0,0,0,0,0,10000,0,0,0,10000,0,10000,10000
051873,緯穎凱基95購02  ,0,0,0,0,0,0,0,0,0,10000,0,0,0,23000,13000,10000,10000
051802,同欣電永豐95購02,0,0,0,0,0,0,0,0,0,10000,0,0,0,10000,0,10000,10000
052055,緯穎凱基95購03  ,0,0,0,0,0,0,0,0,0,10000,0,0,0,10000,0,10000,10000
051908,國泰金元大96購02,0,0,0,0,0,0,0,0,0,10000,0,0,0,10000,0,10000,10000
049598,超眾元大95購03  ,0,0,0,0,0,0,0,0,0,10000,0,0,0,10000,0,10000,10000
049816,緯穎元大94購07  ,0,0,0,0,0,0,0,0,0,10000,0,0,0,10000,0,10000,10000
049721,晶技凱基94購02  ,0,0,0,0,0,0,0,0,0,10000,0,0,0,10000,0,10000,10000
049759,元黃金富邦9A購01,0,0,0,0,0,0,0,0,0,10000,0,0,0,10000,0,10000,10000
052682,上銀元大97購01  ,0,0,0,0,0,0,0,0,0,10000,0,0,0,10000,0,10000,10000
00770,國泰北美科技    ,0,3000,-3000,0,0,0,0,0,0,13000,0,0,0,16000,3000,13000,10000
03026X,元展23          ,0,0,0,0,0,0,0,0,0,10000,0,0,0,10000,0,10000,10000
00656R,國泰中國A50反1  ,0,0,0,0,0,0,0,0,0,10000,0,0,0,21000,11000,10000,10000
035277,景碩台新97購01  ,0,0,0,0,0,0,0,0,0,10000,0,0,0,10000,0,10000,10000
049150,新光金元大96購01,0,0,0,0,0,0,0,0,0,10000,0,0,0,10000,0,10000,10000
04834P,鴻海元大94售17  ,0,0,0,0,0,0,0,0,0,10000,0,0,0,10000,0,10000,10000
048832,玉晶光凱基95購02,0,0,0,0,0,0,0,0,0,10000,0,0,0,19000,9000,10000,10000
053728,茂林凱基97購01  ,0,0,0,0,0,0,0,0,0,10000,0,0,0,12000,2000,10000,10000
053792,百和元大96購01  ,0,0,0,0,0,0,0,0,0,10000,0,0,0,10000,0,10000,10000
053799,矽創中信9A購01  ,0,0,0,0,0,0,0,0,0,10000,0,0,0,10000,0,10000,10000
055245,凱美統一99購01  ,0,0,0,0,0,0,0,0,0,10000,0,0,0,10000,0,10000,10000
055372,宏達電元大97購04,0,0,0,0,0,0,0,0,0,10000,0,0,0,10000,0,10000,10000
055374,明泰元大97購01  ,0,0,0,0,0,0,0,0,0,10000,0,0,0,10000,0,10000,10000
055334,禾伸堂兆豐97購01,0,0,0,0,0,0,0,0,0,10000,0,0,0,10000,0,10000,10000
052625,南電亞東97購01  ,0,0,0,0,0,0,0,0,0,10000,0,0,0,10000,0,10000,10000
053557,聯茂凱基96購04  ,0,0,0,0,0,0,0,0,0,10000,0,0,0,10000,0,10000,10000
053644,台表科國票97購03,0,0,0,0,0,0,0,0,0,10000,0,0,0,10000,0,10000,10000
053712,台光電凱基96購04,0,0,0,0,0,0,0,0,0,10000,0,0,0,10000,0,10000,10000
051643,瑞昱康和95購01  ,0,0,0,0,0,0,0,0,0,10000,0,0,0,10000,0,10000,10000
05239P,欣興永豐95售03  ,0,0,0,0,0,0,0,0,0,10000,0,0,0,10000,0,10000,10000
051582,聯發科元大97購02,0,0,0,0,0,0,0,0,0,10000,0,0,0,10000,0,10000,10000
050695,台積電凱基94購40,0,0,0,0,0,0,0,0,0,10000,0,0,0,10000,0,10000,10000
050601,台表科國泰96購01,0,0,0,0,0,0,0,0,0,10000,0,0,0,10000,0,10000,10000
050808,台達電凱基96購02,0,0,0,0,0,0,0,0,0,10000,0,0,0,10000,0,10000,10000
050832,力成凱基95購01  ,0,0,0,0,0,0,0,0,0,10000,0,0,0,10000,0,10000,10000
050836,緯穎凱基95購01  ,0,0,0,0,0,0,0,0,0,10000,0,0,0,10000,0,10000,10000
051484,玉晶光凱基97購01,0,0,0,0,0,0,0,0,0,10000,0,0,0,10000,0,10000,10000
051116,可成麥證95購01  ,0,0,0,10000,0,10000,0,0,0,10000,0,0,0,10000,0,10000,10000
050964,晶技永豐95購02  ,0,0,0,0,0,0,0,0,0,10000,0,0,0,10000,0,10000,10000
050414,泰鼎永豐94購04  ,0,0,0,0,0,0,0,0,0,10000,0,0,0,10000,0,10000,10000
050362,深中小元大94購04,0,0,0,0,0,0,0,0,0,10000,0,0,0,10000,0,10000,10000
050335,正崴國泰96購01  ,0,0,0,0,0,0,0,0,0,10000,0,0,0,10000,0,10000,10000
050309,亞泥兆豐94購01  ,0,0,0,0,0,0,0,0,0,10000,0,0,0,10000,0,10000,10000
049859,味全兆豐95購01  ,0,0,0,0,0,0,0,0,0,10000,0,0,0,10000,0,10000,10000
049913,微星元大94購01  ,0,0,0,0,0,0,0,0,0,10000,0,0,0,10000,0,10000,10000
054309,禾伸堂凱基98購01,0,0,0,0,0,0,0,0,0,10000,0,0,0,10000,0,10000,10000
055471,聯發科凱基97購04,0,0,0,0,0,0,0,0,0,10000,0,0,0,10000,0,10000,10000
054962,玉晶光元大99購02,0,0,0,0,0,0,0,0,0,10000,0,0,0,10000,0,10000,10000
05492P,聯茂元大95售02  ,0,0,0,0,0,0,0,0,0,10000,0,0,0,10000,0,10000,10000
054808,東元元大9A購01  ,0,0,0,0,0,0,0,0,0,10000,0,0,0,10000,0,10000,10000
054805,台苯元大9A購01  ,0,0,0,0,0,0,0,0,0,10000,0,0,0,10000,0,10000,10000
054756,世紀鋼凱基99購01,0,0,0,0,0,0,0,0,0,10000,0,0,0,10000,0,10000,10000
054747,麗豐凱基98購01  ,0,0,0,0,0,0,0,0,0,10000,0,0,0,10000,0,10000,10000
053373,台泥元大96購01  ,0,0,0,0,0,0,0,0,0,10000,0,0,0,10000,0,10000,10000
053292,美律中信98購01  ,0,0,0,0,0,0,0,0,0,10000,0,0,0,106000,96000,10000,10000
053130,聯發科麥證96購01,0,0,0,0,0,0,0,0,0,10000,0,0,0,10000,0,10000,10000
053256,上銀富邦98購01  ,0,0,0,0,0,0,0,0,0,10000,0,0,0,10000,0,10000,10000
053969,瑞昱元大97購01  ,0,0,0,0,0,0,0,0,0,10000,0,0,0,10000,0,10000,10000
053926,晶相光國票97購01,0,0,0,0,0,0,0,0,0,10000,0,0,0,10000,0,10000,10000
055398,超眾統一97購03  ,0,0,0,0,0,0,0,0,0,10000,0,0,0,10000,0,10000,10000
052745,欣興元大96購04  ,0,0,0,0,0,0,0,0,0,10000,0,0,0,10000,0,10000,10000
052765,新日興群益97購01,0,0,0,0,0,0,0,0,0,10000,0,0,0,10000,0,10000,10000
053098,國巨元富96購04  ,0,0,0,0,0,0,0,0,0,10000,0,0,0,10000,0,10000,10000
055882,嘉聯益元富97購01,0,0,0,0,0,0,0,0,0,10000,0,0,0,10000,0,10000,10000
055986,祥碩元富97購01  ,0,0,0,0,0,0,0,0,0,10000,0,0,0,10000,0,10000,10000
05605P,嘉聯益元大97售02,0,0,0,0,0,0,0,0,0,10000,0,0,0,10000,0,10000,10000
05600P,玉晶光台新96售04,0,0,0,0,0,0,0,0,0,10000,0,0,0,10000,0,10000,10000
05412P,泰碩國票95售02  ,0,0,0,0,0,0,0,0,0,10000,0,0,0,10000,0,10000,10000
055067,禾聯碩永豐97購01,0,0,0,0,0,0,0,0,0,10000,0,0,0,10000,0,10000,10000
055021,亞德客國泰98購01,0,0,0,0,0,0,0,0,0,10000,0,0,0,10000,0,10000,10000
055022,精元國泰99購01  ,0,0,0,0,0,0,0,0,0,10000,0,0,0,10000,0,10000,10000
054195,亞泥國泰98購01  ,0,0,0,0,0,0,0,0,0,10000,0,0,0,10000,0,10000,10000
054221,華新科統一96購05,0,0,0,0,0,0,0,0,0,10000,0,0,0,20000,10000,10000,10000
055675,亞德客凱基97購02,0,0,0,0,0,0,0,0,0,10000,0,0,0,147000,137000,10000,10000
055654,景碩元富97購01  ,0,0,0,0,0,0,0,0,0,10000,0,0,0,10000,0,10000,10000
057580,玉山金中信9A購01,0,0,0,0,0,0,0,0,0,10000,0,0,0,10000,0,10000,10000
05649P,矽創國票97售03  ,0,0,0,0,0,0,0,0,0,10000,0,0,0,10000,0,10000,10000
054233,聯發科群益96購04,0,0,0,0,0,0,0,0,0,10000,0,0,0,10000,0,10000,10000
054237,茂林群益97購01  ,0,0,0,0,0,0,0,0,0,10000,0,0,0,10000,0,10000,10000
056412,上証2X中信9A購02,0,0,0,0,0,0,0,0,0,10000,0,0,0,10000,0,10000,10000
058646,聯茂富邦9A購01  ,0,0,0,0,0,0,0,0,0,10000,0,0,0,10000,0,10000,10000
058665,台灣50群益9B購02,0,0,0,0,0,0,0,0,0,10000,0,0,0,10000,0,10000,10000
058614,台郡元大9A購01  ,0,0,0,0,0,0,0,0,0,10000,0,0,0,10000,0,10000,10000
058620,滬深2X國票9A購02,0,0,0,0,0,0,0,0,0,10000,0,0,0,10000,0,10000,10000
059428,國巨元大99購25  ,0,0,0,0,0,0,0,0,0,10000,0,0,0,31000,21000,10000,10000
059413,台灣50元大99購05,0,0,0,0,0,0,0,0,0,10000,0,0,0,10000,0,10000,10000
059974,臺指反元大9C購05,0,0,0,0,0,0,0,0,0,10000,0,0,0,10000,0,10000,10000
059456,智易永豐99購01  ,0,0,0,0,0,0,0,0,0,10000,0,0,0,10000,0,10000,10000
2022,聚亨            ,19000,9000,10000,0,0,0,0,0,0,0,0,0,0,0,0,0,10000
07537P,玉晶光元富9A售04,0,0,0,0,0,0,0,0,0,10000,0,0,0,12000,2000,10000,10000
07301P,臺股指元大9A售34,0,0,0,0,0,0,0,0,0,10000,0,0,0,10000,0,10000,10000
07126P,台積電元大99售23,0,0,0,0,0,0,0,0,0,10000,0,0,0,10000,0,10000,10000
07000P,T50反1元大99售03,0,0,0,0,0,0,0,0,0,10000,0,0,0,10000,0,10000,10000
06738P,瑞昱兆豐98售02  ,0,0,0,0,0,0,0,0,0,10000,0,0,0,10000,0,10000,10000
06782P,大立光元大99售07,0,0,0,0,0,0,0,0,0,10000,0,0,0,10000,0,10000,10000
06857P,超眾永豐98售02  ,0,0,0,0,0,0,0,0,0,10000,0,0,0,10000,0,10000,10000
06655P,TPK元大98售02   ,0,0,0,0,0,0,0,0,0,10000,0,0,0,11000,1000,10000,10000
06236P,台積電元大97售25,0,0,0,0,0,0,0,0,0,10000,0,0,0,10000,0,10000,10000
06163P,聯詠群益97售01  ,0,0,0,0,0,0,0,0,0,10000,0,0,0,10000,0,10000,10000
06394P,台積電元大97售28,0,0,0,0,0,0,0,0,0,10000,0,0,0,10000,0,10000,10000
060517,臺股指元大9B購14,0,0,0,0,0,0,0,0,0,10000,0,0,0,20000,10000,10000,10000
060524,國巨中信9A購03  ,0,0,0,0,0,0,0,0,0,10000,0,0,0,30000,20000,10000,10000
059908,元金2X元大99購01,0,0,0,0,0,0,0,0,0,9000,0,0,0,48000,39000,9000,9000
058014,上銀凱基99購02  ,0,0,0,0,0,0,0,0,0,9000,0,0,0,10000,1000,9000,9000
057997,旺宏第一9C購01  ,0,0,0,0,0,0,0,0,0,9000,0,0,0,10000,1000,9000,9000
056380,麗豐元富98購01  ,0,0,0,0,0,0,0,0,0,9000,0,0,0,10000,1000,9000,9000
057727,華邦電國泰9A購01,0,0,0,0,0,0,0,0,0,9000,0,0,0,9000,0,9000,9000
058764,康友群益99購01  ,0,0,0,0,0,0,0,0,0,9000,0,0,0,131000,122000,9000,9000
057321,台泥群益98購01  ,0,0,0,0,0,0,0,0,0,9000,0,0,0,9000,0,9000,9000
057843,晶技永豐98購02  ,0,0,0,0,0,0,0,0,0,9000,0,0,0,16000,7000,9000,9000
058342,鴻海群益9A購01  ,0,0,0,0,0,0,0,0,0,9000,0,0,0,9000,0,9000,9000
059573,健策凱基9A購02  ,0,0,0,0,0,0,0,0,0,9000,0,0,0,98000,89000,9000,9000
058802,矽創元大99購02  ,0,0,0,0,0,0,0,0,0,9000,0,0,0,11000,2000,9000,9000
059212,鴻海元大99購28  ,0,0,0,0,0,0,0,0,0,9000,0,0,0,9000,0,9000,9000
059287,華通元富99購03  ,0,0,0,0,0,0,0,0,0,9000,0,0,0,21000,12000,9000,9000
05865P,大立光元大96售09,0,0,0,0,0,0,0,0,0,9000,0,0,0,11000,2000,9000,9000
05642P,玉晶光兆豐97售02,0,0,0,0,0,0,0,0,0,9000,0,0,0,19000,10000,9000,9000
055872,亞泥元富97購01  ,0,0,0,0,0,0,0,0,0,9000,0,0,0,50000,41000,9000,9000
053493,智邦兆豐97購02  ,0,0,0,0,0,0,0,0,0,9000,0,0,0,9000,0,9000,9000
054260,貿聯元大96購03  ,0,0,0,0,0,0,0,0,0,9000,0,0,0,9000,0,9000,9000
04892P,聯發科元大94售14,0,0,0,0,0,0,0,0,0,9000,0,0,0,9000,0,9000,9000
03010X,元展10          ,0,0,0,0,0,0,0,0,0,9000,0,0,0,9000,0,9000,9000
00703,台新MSCI中國    ,0,0,0,0,0,0,0,0,0,9000,0,0,0,69000,60000,9000,9000
049563,華新統一95購01  ,0,0,0,0,0,0,0,0,0,9000,0,0,0,9000,0,9000,9000
047937,元金2X國票97購02,0,0,0,0,0,0,0,0,0,9000,0,0,0,9000,0,9000,9000
047439,漢唐元大95購01  ,0,0,0,0,0,0,0,0,0,9000,0,0,0,9000,0,9000,9000
06865P,亞德客元大98售04,0,0,0,0,0,0,0,0,0,9000,0,0,0,9000,0,9000,9000
07009P,臺股指中信9B售01,0,0,0,0,0,0,0,0,0,9000,0,0,0,9000,0,9000,9000
07239P,台灣50國票9A售04,0,0,0,0,0,0,0,0,0,9000,0,0,0,9000,0,9000,9000
07424P,大立光元大9B售01,0,0,0,0,0,0,0,0,0,9000,0,0,0,20000,11000,9000,9000
05938P,旺宏凱基96售07  ,0,0,0,0,0,0,0,0,0,8000,0,0,0,19000,11000,8000,8000
059072,元油2X元大9C購13,0,0,0,0,0,0,0,0,0,8000,0,0,0,135000,127000,8000,8000
057860,金寶凱基98購01  ,0,0,0,0,0,0,0,0,0,8000,0,0,0,8000,0,8000,8000
057297,新日興永豐98購01,0,0,0,0,0,0,0,0,0,8000,0,0,0,9000,1000,8000,8000
057806,國巨元大98購20  ,0,0,0,0,0,0,0,0,0,8000,0,0,0,8000,0,8000,8000
05744P,台表科元大96售04,0,0,0,0,0,0,0,0,0,8000,0,0,0,8000,0,8000,8000
059530,華新科凱基9A購05,0,0,0,0,0,0,0,0,0,8000,0,0,0,22000,14000,8000,8000
059544,創意亞東99購01  ,0,0,0,0,0,0,0,0,0,8000,0,0,0,10000,2000,8000,8000
057269,鈺齊兆豐98購01  ,0,0,0,0,0,0,0,0,0,8000,0,0,0,8000,0,8000,8000
056401,國巨群益98購07  ,0,0,0,0,0,0,0,0,0,8000,0,0,0,8000,0,8000,8000
056828,國巨富邦9A購03  ,0,0,0,0,0,0,0,0,0,8000,0,0,0,8000,0,8000,8000
060196,泰鼎元富9A購01  ,0,0,0,0,0,0,0,0,0,8000,0,0,0,14000,6000,8000,8000
051789,嘉澤國票96購01  ,0,0,0,0,0,0,0,0,0,8000,0,0,0,10000,2000,8000,8000
04929P,同欣電凱基95售01,0,0,0,0,0,0,0,0,0,8000,0,0,0,28000,20000,8000,8000
051633,可成國票96購03  ,0,0,0,0,0,0,0,0,0,8000,0,0,0,8000,0,8000,8000
055480,元上證元大97購02,0,0,0,0,0,0,0,0,0,8000,0,0,0,8000,0,8000,8000
053432,世紀鋼永豐96購02,0,0,0,0,0,0,0,0,0,8000,0,0,0,30000,22000,8000,8000
053942,超眾國泰96購02  ,0,0,0,0,0,0,0,0,0,8000,0,0,0,8000,0,8000,8000
053516,茂林群益96購05  ,0,0,0,0,0,0,0,0,0,8000,0,0,0,138000,130000,8000,8000
052761,可成群益96購02  ,0,0,0,0,0,0,0,0,0,8000,0,0,0,8000,0,8000,8000
05273P,國巨群益95售02  ,0,0,0,0,0,0,0,0,0,8000,0,0,0,35000,27000,8000,8000
056068,欣興元大97購05  ,0,0,0,0,0,0,0,0,0,8000,0,0,0,28000,20000,8000,8000
06483P,聯發科凱基98售10,0,0,0,0,0,0,0,0,0,8000,0,0,0,8000,0,8000,8000
6491,晶碩            ,23000,15000,8000,0,0,0,0,0,0,0,0,0,0,0,0,0,8000
3617,碩天            ,34000,24000,10000,0,0,0,0,0,0,-2000,0,3000,-3000,1000,0,1000,8000
4104,佳醫            ,28000,19000,9000,0,0,0,0,0,0,-1000,0,1000,-1000,0,0,0,8000
3021,鴻名            ,0,0,0,0,0,0,0,0,0,8000,8000,0,8000,0,0,0,8000
1503,士電            ,28001,7000,21001,0,0,0,0,1156,-1156,-12000,0,12000,-12000,0,0,0,7845
059689,南亞科永豐99購02,0,0,0,0,0,0,0,0,0,7000,0,0,0,15000,8000,7000,7000
056397,彩晶永豐99購01  ,0,0,0,0,0,0,0,0,0,7000,0,0,0,128000,121000,7000,7000
058009,智易國票99購01  ,0,0,0,0,0,0,0,0,0,7000,0,0,0,7000,0,7000,7000
057163,上銀元大98購04  ,0,0,0,0,0,0,0,0,0,7000,0,0,0,7000,0,7000,7000
059502,台灣50台新9B購04,0,0,0,0,0,0,0,0,0,7000,0,0,0,20000,13000,7000,7000
057657,國巨兆豐98購04  ,0,0,0,0,0,0,0,0,0,7000,0,0,0,17000,10000,7000,7000
059997,華航元富99購01  ,0,0,0,0,0,0,0,0,0,7000,0,0,0,40000,33000,7000,7000
058156,超眾統一9A購02  ,0,0,0,0,0,0,0,0,0,7000,0,0,0,7000,0,7000,7000
059223,大立光元大99購14,0,0,0,0,0,0,0,0,0,7000,0,0,0,9000,2000,7000,7000
059145,創意國票99購02  ,0,0,0,0,0,0,0,0,0,7000,0,0,0,10000,3000,7000,7000
059240,台積電凱基9A購09,0,0,0,0,0,0,0,0,0,7000,0,0,0,55000,48000,7000,7000
058354,台積電凱基9A購06,0,0,0,0,0,0,0,0,0,7000,0,0,0,7000,0,7000,7000
058524,超眾元大99購04  ,0,0,0,0,0,0,0,0,0,7000,0,0,0,7000,0,7000,7000
058537,彩晶統一9B購01  ,0,0,0,0,0,0,0,0,0,7000,0,0,0,10000,3000,7000,7000
055073,易華電永豐97購01,0,0,0,0,0,0,0,0,0,7000,0,0,0,7000,0,7000,7000
054076,義隆第一96購01  ,0,0,0,0,0,0,0,0,0,7000,0,0,0,7000,0,7000,7000
051224,華通群益96購03  ,0,0,0,0,0,0,0,0,0,7000,0,0,0,7000,0,7000,7000
051882,潤泰全永豐95購01,0,0,0,0,0,0,0,0,0,7000,0,0,0,7000,0,7000,7000
051985,智邦元大95購05  ,0,0,0,0,0,0,0,0,0,7000,0,0,0,7000,0,7000,7000
049430,國巨國票95購02  ,0,0,0,0,0,0,0,0,0,7000,0,0,0,7000,0,7000,7000
047410,上銀元富96購01  ,0,0,0,0,0,0,0,0,0,7000,0,0,0,36000,29000,7000,7000
00685L,群益臺灣加權正2 ,0,0,0,0,0,0,0,0,0,7000,0,0,0,16000,9000,7000,7000
07417P,聯發科元大99售44,0,0,0,0,0,0,0,0,0,7000,0,0,0,57000,50000,7000,7000
07328P,FBVIX國泰9B售01 ,0,0,0,0,0,0,0,0,0,7000,0,0,0,7000,0,7000,7000
06431P,新日興元大97售05,0,0,0,0,0,0,0,0,0,7000,0,0,0,17000,10000,7000,7000
07276P,臺股指群益99售19,0,0,0,0,0,0,0,0,0,7000,0,0,0,115000,108000,7000,7000
4108,懷特            ,28000,21000,7000,0,0,0,0,0,0,0,0,0,0,0,0,0,7000
4722,國精化          ,27000,19000,8000,0,0,0,0,0,0,-1000,0,1000,-1000,0,0,0,7000
3266,昇陽            ,51000,35000,16000,0,0,0,0,0,0,-9000,0,9000,-9000,0,0,0,7000
3311,閎暉            ,21000,14000,7000,0,0,0,0,0,0,0,0,0,0,0,0,0,7000
6412,群電            ,99000,73000,26000,0,0,0,0,1972,-1972,-18000,0,0,0,0,18000,-18000,6028
056537,冠德凱基98購01  ,0,0,0,0,0,0,0,0,0,6000,0,0,0,6000,0,6000,6000
056573,華新科元大99購06,0,0,0,0,0,0,0,0,0,6000,0,0,0,8000,2000,6000,6000
058839,瑞儀中信99購02  ,0,0,0,0,0,0,0,0,0,6000,0,0,0,6000,0,6000,6000
059346,新日興凱基99購03,0,0,0,0,0,0,0,0,0,6000,0,0,0,21000,15000,6000,6000
059174,訊芯凱基99購01  ,0,0,0,0,0,0,0,0,0,6000,0,0,0,50000,44000,6000,6000
059075,FBVIX元大99購01 ,0,0,0,0,0,0,0,0,0,6000,0,0,0,7000,1000,6000,6000
057316,國巨凱基99購04  ,0,0,0,0,0,0,0,0,0,6000,0,0,0,6000,0,6000,6000
060038,台積電國票99購13,0,0,0,0,0,0,0,0,0,6000,0,0,0,63000,57000,6000,6000
057721,華擎元富98購02  ,0,0,0,0,0,0,0,0,0,6000,0,0,0,36000,30000,6000,6000
05716P,T50反1元大98售03,0,0,0,0,0,0,0,0,0,6000,0,0,0,6000,0,6000,6000
058008,禾伸堂國票99購02,0,0,0,0,0,0,0,0,0,6000,0,0,0,6000,0,6000,6000
058933,FBVIX台新9B購01 ,0,0,0,0,0,0,0,0,0,6000,0,0,0,8000,2000,6000,6000
056192,智邦富邦98購01  ,0,0,0,0,0,0,0,0,0,6000,0,0,0,11000,5000,6000,6000
060242,潤泰全元大9C購01,0,0,0,0,0,0,0,0,0,6000,0,0,0,6000,0,6000,6000
00700,富邦恒生國企    ,0,0,0,0,0,0,0,0,0,6000,0,0,0,6000,0,6000,6000
04893P,創意元大94售03  ,0,0,0,0,0,0,0,0,0,6000,0,0,0,8000,2000,6000,6000
048380,T50反1國票94購02,0,0,0,0,0,0,0,0,0,6000,0,0,0,16000,10000,6000,6000
03676C,臺股指元大04牛03,0,0,0,0,0,0,0,0,0,6000,0,0,0,6000,0,6000,6000
04744P,臻鼎元富94售04  ,0,0,0,0,0,0,0,0,0,6000,0,0,0,6000,0,6000,6000
046492,旺宏富邦94購02  ,0,0,0,0,0,0,0,0,0,6000,0,0,0,6000,0,6000,6000
052117,鴻海國票96購03  ,0,0,0,0,0,0,0,0,0,6000,0,0,0,6000,0,6000,6000
04960P,大立光凱基96售04,0,0,0,0,0,0,0,0,0,6000,0,0,0,6000,0,6000,6000
051361,泰鼎元大95購01  ,0,0,0,0,0,0,0,0,0,6000,0,0,0,6000,0,6000,6000
051469,友達日盛9B購01  ,0,0,0,0,0,0,0,0,0,6000,0,0,0,6000,0,6000,6000
050093,國巨永豐94購05  ,0,0,0,0,0,0,0,0,0,6000,0,0,0,6000,0,6000,6000
052434,茂林國泰97購01  ,0,0,0,0,0,0,0,0,0,6000,0,0,0,6000,0,6000,6000
053765,智邦富邦96購01  ,0,0,0,0,0,0,0,0,0,6000,0,0,0,6000,0,6000,6000
055834,國巨元大97購13  ,0,0,0,0,0,0,0,0,0,6000,0,0,0,142000,136000,6000,6000
05581P,華新科凱基96售07,0,0,0,0,0,0,0,0,0,6000,0,0,0,10000,4000,6000,6000
056440,智邦凱基98購03  ,0,0,0,0,0,0,0,0,0,6000,0,0,0,26000,20000,6000,6000
056160,智易凱基97購03  ,0,0,0,0,0,0,0,0,0,6000,0,0,0,21000,15000,6000,6000
057646,玉山金元大98購01,0,0,0,0,0,0,0,0,0,6000,0,0,0,6000,0,6000,6000
053071,南電群益96購01  ,0,0,0,0,0,0,0,0,0,6000,0,0,0,6000,0,6000,6000
053288,臺股指元大96購16,0,0,0,0,0,0,0,0,0,6000,0,0,0,6000,0,6000,6000
053195,玉晶光元富96購02,0,0,0,0,0,0,0,0,0,6000,0,0,0,6000,0,6000,6000
053216,京鼎凱基96購02  ,0,0,0,0,0,0,0,0,0,6000,0,0,0,16000,10000,6000,6000
053306,晶技凱基97購01  ,0,0,0,0,0,0,0,0,0,6000,0,0,0,6000,0,6000,6000
054033,欣興中信96購02  ,0,0,0,0,0,0,0,0,0,6000,0,0,0,6000,0,6000,6000
054017,茂林永豐96購02  ,0,0,0,0,0,0,0,0,0,6000,0,0,0,28000,22000,6000,6000
05426P,聯發科凱基95售12,0,0,0,0,0,0,0,0,0,6000,0,0,0,6000,0,6000,6000
054922,文曄凱基98購01  ,0,0,0,0,0,0,0,0,0,6000,0,0,0,6000,0,6000,6000
6205,詮欣            ,7000,1000,6000,0,0,0,0,0,0,0,0,0,0,0,0,0,6000
4572,駐龍            ,9000,3000,6000,0,0,0,0,0,0,0,0,0,0,0,0,0,6000
07026P,超眾凱基99售03  ,0,0,0,0,0,0,0,0,0,6000,0,0,0,16000,10000,6000,6000
06960P,國巨凱基99售08  ,0,0,0,0,0,0,0,0,0,6000,0,0,0,6000,0,6000,6000
06975P,臺股指元大9A售13,0,0,0,0,0,0,0,0,0,6000,0,0,0,6000,0,6000,6000
06864P,健策凱基98售01  ,0,0,0,0,0,0,0,0,0,6000,0,0,0,77000,71000,6000,6000
06729P,聯詠元大98售03  ,0,0,0,0,0,0,0,0,0,6000,0,0,0,6000,0,6000,6000
06399P,台表科凱基97售05,0,0,0,0,0,0,0,0,0,6000,0,0,0,27000,21000,6000,6000
060564,南亞科富邦9C購01,0,0,0,0,0,0,0,0,0,6000,0,0,0,19000,13000,6000,6000
060641,聯鈞永豐9A購01  ,0,0,0,0,0,0,0,0,0,6000,0,0,0,29000,23000,6000,6000
07415P,台積電元大99售52,0,0,0,0,0,0,0,0,0,6000,0,0,0,43000,37000,6000,6000
07395P,台積電群益99售13,0,0,0,0,0,0,0,0,0,6000,0,0,0,6000,0,6000,6000
07547P,緯穎凱基9A售05  ,0,0,0,0,0,0,0,0,0,6000,0,0,0,55000,49000,6000,6000
2467,志聖            ,88000,81000,7000,0,0,0,0,0,0,-1000,0,1000,-1000,0,0,0,6000
060258,T50反1凱基9A購06,0,0,0,0,0,0,0,0,0,5000,0,0,0,5000,0,5000,5000
060354,A50正2元富9A購02,0,0,0,0,0,0,0,0,0,5000,0,0,0,10000,5000,5000,5000
060349,上証2X元富9A購04,0,0,0,0,0,0,0,0,0,5000,0,0,0,5000,0,5000,5000
059703,旺宏凱基99購11  ,0,0,0,0,0,0,0,0,0,5000,0,0,0,5000,0,5000,5000
057047,華新科元大99購07,0,0,0,0,0,0,0,0,0,5000,0,0,0,5000,0,5000,5000
05620P,大立光富邦9B售01,0,0,0,0,0,0,0,0,0,5000,0,0,0,5000,0,5000,5000
058905,京鼎元大99購01  ,0,0,0,0,0,0,0,0,0,5000,0,0,0,5000,0,5000,5000
058011,台虹國票99購01  ,0,0,0,0,0,0,0,0,0,5000,0,0,0,5000,0,5000,5000
059803,S&P正2元富9B購03,0,0,0,0,0,0,0,0,0,5000,0,0,0,5000,0,5000,5000
056834,華新元富99購01  ,0,0,0,0,0,0,0,0,0,5000,0,0,0,5000,0,5000,5000
057908,國泰金亞東99購01,0,0,0,0,0,0,0,0,0,5000,0,0,0,5000,0,5000,5000
059523,滬深2X凱基9C購04,0,0,0,0,0,0,0,0,0,5000,0,0,0,5000,0,5000,5000
059532,華新科凱基9B購03,0,0,0,0,0,0,0,0,0,5000,0,0,0,28000,23000,5000,5000
057133,京鼎凱基98購02  ,0,0,0,0,0,0,0,0,0,5000,0,0,0,5000,0,5000,5000
057304,為升兆豐99購02  ,0,0,0,0,0,0,0,0,0,5000,0,0,0,15000,10000,5000,5000
057448,致茂元富98購01  ,0,0,0,0,0,0,0,0,0,5000,0,0,0,15000,10000,5000,5000
057421,智原凱基98購04  ,0,0,0,0,0,0,0,0,0,5000,0,0,0,5000,0,5000,5000
058080,台積電群益98購06,0,0,0,0,0,0,0,0,0,5000,0,0,0,9000,4000,5000,5000
05907P,聯發科元富96售05,0,0,0,0,0,0,0,0,0,5000,0,0,0,5000,0,5000,5000
059126,臺指反中信9B購01,0,0,0,0,0,0,0,0,0,5000,0,0,0,5000,0,5000,5000
059147,矽創國票99購01  ,0,0,0,0,0,0,0,0,0,5000,0,0,0,5000,0,5000,5000
059229,臺股指元大99購22,0,0,0,0,0,0,0,0,0,5000,0,0,0,5000,0,5000,5000
059230,滬深2X國票9B購02,0,0,0,0,0,0,0,0,0,5000,0,0,0,10000,5000,5000,5000
058852,貿聯群益99購04  ,0,0,0,0,0,0,0,0,0,5000,0,0,0,5000,0,5000,5000
059561,滬深2X凱基9C購05,0,0,0,0,0,0,0,0,0,5000,0,0,0,5000,0,5000,5000
059570,全新凱基99購04  ,0,0,0,0,0,0,0,0,0,5000,0,0,0,25000,20000,5000,5000
059600,緯穎元大99購07  ,0,0,0,0,0,0,0,0,0,5000,0,0,0,13000,8000,5000,5000
058489,台灣50群益9B購01,0,0,0,0,0,0,0,0,0,5000,0,0,0,5000,0,5000,5000
054767,日電貿國票98購01,0,0,0,0,0,0,0,0,0,5000,0,0,0,45000,40000,5000,5000
05479P,華新科台新96售01,0,0,0,0,0,0,0,0,0,5000,0,0,0,5000,0,5000,5000
05437P,聯詠永豐95售02  ,0,0,0,0,0,0,0,0,0,5000,0,0,0,5000,0,5000,5000
054042,華泰元大96購01  ,0,0,0,0,0,0,0,0,0,5000,0,0,0,5000,0,5000,5000
053258,上証2X群益9A購03,0,0,0,0,0,0,0,0,0,5000,0,0,0,5000,0,5000,5000
053990,晶技兆豐96購01  ,0,0,0,0,0,0,0,0,0,5000,0,0,0,5000,0,5000,5000
053480,祥碩元大96購02  ,0,0,0,0,0,0,0,0,0,5000,0,0,0,27000,22000,5000,5000
053483,嘉澤第一96購01  ,0,0,0,0,0,0,0,0,0,5000,0,0,0,5000,0,5000,5000
053084,國巨元大98購01  ,0,0,0,0,0,0,0,0,0,5000,0,0,0,5000,0,5000,5000
05307P,光寶科中信95售01,0,0,0,0,0,0,0,0,0,5000,0,0,0,5000,0,5000,5000
052952,矽創國票97購02  ,0,0,0,0,0,0,0,0,0,5000,0,0,0,5000,0,5000,5000
052980,上銀元大96購03  ,0,0,0,0,0,0,0,0,0,5000,0,0,0,5000,0,5000,5000
055409,元黃金富邦01購01,0,0,0,0,0,0,0,0,0,5000,0,0,0,5000,0,5000,5000
055416,欣興富邦98購01  ,0,0,0,0,0,0,0,0,0,5000,0,0,0,5000,0,5000,5000
05755P,臺股指中信99售04,0,0,0,0,0,0,0,0,0,5000,0,0,0,5000,0,5000,5000
056415,聯發科中信98購04,0,0,0,0,0,0,0,0,0,5000,0,0,0,5000,0,5000,5000
056129,義隆麥證97購01  ,0,0,0,5000,0,5000,0,0,0,5000,0,0,0,5000,0,5000,5000
058632,世紀鋼國票9A購01,0,0,0,0,0,0,0,0,0,5000,0,0,0,5000,0,5000,5000
05941P,聯發科凱基96售22,0,0,0,0,0,0,0,0,0,5000,0,0,0,5000,0,5000,5000
059451,國巨永豐99購05  ,0,0,0,0,0,0,0,0,0,5000,0,0,0,15000,10000,5000,5000
055756,臺股指兆豐97購01,0,0,0,0,0,0,0,0,0,5000,0,0,0,5000,0,5000,5000
056069,新日興元大97購03,0,0,0,0,0,0,0,0,0,5000,0,0,0,5000,0,5000,5000
055994,聯發科國泰99購02,0,0,0,0,0,0,0,0,0,5000,0,0,0,5000,0,5000,5000
055062,文曄永豐97購01  ,0,0,0,0,0,0,0,0,0,5000,0,0,0,5000,0,5000,5000
054967,神達元大97購01  ,0,0,0,0,0,0,0,0,0,5000,0,0,0,5000,0,5000,5000
054202,樺漢富邦97購01  ,0,0,0,0,0,0,0,0,0,5000,0,0,0,5000,0,5000,5000
053721,國泰金凱基97購01,0,0,0,0,0,0,0,0,0,5000,0,0,0,10000,5000,5000,5000
051639,康友國票96購02  ,0,0,0,0,0,0,0,0,0,5000,0,0,0,5000,0,5000,5000
051580,宏碁元大95購02  ,0,0,0,0,0,0,0,0,0,5000,0,0,0,5000,0,5000,5000
05154P,台積電兆豐95售05,0,0,0,0,0,0,0,0,0,5000,0,0,0,15000,10000,5000,5000
053562,玉晶光國泰98購02,0,0,0,0,0,0,0,0,0,5000,0,0,0,5000,0,5000,5000
050149,東元群益94購01  ,0,0,0,0,0,0,0,0,0,5000,0,0,0,5000,0,5000,5000
050124,元金2X凱基95購01,0,0,0,0,0,0,0,0,0,5000,0,0,0,15000,10000,5000,5000
052274,大立光群益95購03,0,0,0,0,0,0,0,0,0,5000,0,0,0,10000,5000,5000,5000
051400,國巨永豐95購01  ,0,0,0,0,0,0,0,0,0,5000,0,0,0,5000,0,5000,5000
05140P,台表科國票96售01,0,0,0,0,0,0,0,0,0,5000,0,0,0,25000,20000,5000,5000
050890,南電富邦99購01  ,0,0,0,0,0,0,0,0,0,5000,0,0,0,5000,0,5000,5000
051098,矽格元大95購01  ,0,0,0,0,0,0,0,0,0,5000,0,0,0,5000,0,5000,5000
050613,台光電元大94購09,0,0,0,0,0,0,0,0,0,5000,0,0,0,5000,0,5000,5000
051946,健策統一98購01  ,0,0,0,0,0,0,0,0,0,5000,0,0,0,5000,0,5000,5000
052056,緯穎凱基95購04  ,0,0,0,0,0,0,0,0,0,5000,0,0,0,8000,3000,5000,5000
04693P,超眾群益95售01  ,0,0,0,0,0,0,0,0,0,5000,0,0,0,5000,0,5000,5000
04774P,金融類元大94售02,0,0,0,0,0,0,0,0,0,5000,0,0,0,5000,0,5000,5000
04776P,聯發科凱基94售06,0,0,0,0,0,0,0,0,0,5000,0,0,0,5000,0,5000,5000
047630,元油反元大96購02,0,0,0,0,0,0,0,0,0,5000,0,0,0,15000,10000,5000,5000
048221,鴻海凱基95購01  ,0,0,0,0,0,0,0,0,0,5000,0,0,0,5000,0,5000,5000
04817P,創意國票95售02  ,0,0,0,0,0,0,0,0,0,5000,0,0,0,5000,0,5000,5000
048533,景碩國票94購01  ,0,0,0,0,0,0,0,0,0,5000,0,0,0,25000,20000,5000,5000
048588,世紀鋼中信94購01,0,0,0,0,0,0,0,0,0,5000,0,0,0,5000,0,5000,5000
00662,富邦NASDAQ      ,3000,3000,0,0,0,0,0,0,0,5000,0,0,0,168000,163000,5000,5000
048070,聯發科元富99購03,0,0,0,0,0,0,0,0,0,5000,0,0,0,5000,0,5000,5000
048128,超眾元大95購01  ,0,0,0,0,0,0,0,0,0,5000,0,0,0,5000,0,5000,5000
0055,元大MSCI金融    ,0,0,0,0,0,0,0,0,0,5000,0,0,0,10000,5000,5000,5000
07350P,台灣50國票99售11,0,0,0,0,0,0,0,0,0,5000,0,0,0,8000,3000,5000,5000
07367P,鴻海凱基99售17  ,0,0,0,0,0,0,0,0,0,5000,0,0,0,5000,0,5000,5000
07439P,臺股指麥證9B售01,0,0,0,16000,11000,5000,0,0,0,5000,0,0,0,16000,11000,5000,5000
06274P,臺股指凱基97售06,0,0,0,0,0,0,0,0,0,5000,0,0,0,5000,0,5000,5000
06130P,玉晶光元富97售07,0,0,0,0,0,0,0,0,0,5000,0,0,0,5000,0,5000,5000
06123P,玉晶光元大97售04,0,0,0,0,0,0,0,0,0,5000,0,0,0,5000,0,5000,5000
06523P,台積電麥證98售02,0,0,0,5000,0,5000,0,0,0,5000,0,0,0,5000,0,5000,5000
06644P,亞德客元大98售03,0,0,0,0,0,0,0,0,0,5000,0,0,0,5000,0,5000,5000
06620P,聯發科元大98售07,0,0,0,0,0,0,0,0,0,5000,0,0,0,5000,0,5000,5000
06981P,台灣50麥證99售02,0,0,0,5000,0,5000,0,0,0,5000,0,0,0,5000,0,5000,5000
06982P,義隆凱基99售02  ,0,0,0,0,0,0,0,0,0,5000,0,0,0,5000,0,5000,5000
07247P,聯發科凱基9A售06,0,0,0,0,0,0,0,0,0,5000,0,0,0,5000,0,5000,5000
07216P,大立光凱基99售08,0,0,0,0,0,0,0,0,0,5000,0,0,0,5000,0,5000,5000
07149P,健鼎元大99售03  ,0,0,0,0,0,0,0,0,0,5000,0,0,0,5000,0,5000,5000
4144,康聯-KY         ,9000,4000,5000,0,0,0,0,0,0,0,0,0,0,0,0,0,5000
2882B,國泰金乙特      ,0,0,0,0,0,0,0,0,0,5000,5000,0,5000,0,0,0,5000
2482,連宇            ,16000,11000,5000,0,0,0,0,0,0,0,0,0,0,0,0,0,5000
4994,傳奇            ,68000,64000,4000,0,0,0,0,0,0,1000,0,1000,-1000,2000,0,2000,5000
1313,聯成            ,392364,382510,9854,0,0,0,0,0,0,-5000,0,5000,-5000,0,0,0,4854
056556,南電凱基98購01  ,0,0,0,0,0,0,0,0,0,4000,0,0,0,4000,0,4000,4000
059165,南亞科凱基99購04,0,0,0,0,0,0,0,0,0,4000,0,0,0,25000,21000,4000,4000
057447,智邦元富02購01  ,0,0,0,0,0,0,0,0,0,4000,0,0,0,4000,0,4000,4000
057315,台灣50康和9A購03,0,0,0,0,0,0,0,0,0,4000,0,0,0,4000,0,4000,4000
057810,技嘉元大98購06  ,0,0,0,0,0,0,0,0,0,4000,0,0,0,4000,0,4000,4000
057776,京元電群益98購02,0,0,0,0,0,0,0,0,0,4000,0,0,0,6000,2000,4000,4000
059515,牧德永豐99購01  ,0,0,0,0,0,0,0,0,0,4000,0,0,0,37000,33000,4000,4000
05999P,世芯元大96售01  ,0,0,0,0,0,0,0,0,0,4000,0,0,0,4000,0,4000,4000
057901,大立光永豐98購04,0,0,0,0,0,0,0,0,0,4000,0,0,0,4000,0,4000,4000
058034,神達永豐98購02  ,0,0,0,0,0,0,0,0,0,4000,0,0,0,4000,0,4000,4000
056877,群創凱基99購04  ,0,0,0,0,0,0,0,0,0,4000,0,0,0,4000,0,4000,4000
056920,友達兆豐98購02  ,0,0,0,0,0,0,0,0,0,4000,0,0,0,4000,0,4000,4000
056910,超眾元大99購02  ,0,0,0,0,0,0,0,0,0,4000,0,0,0,4000,0,4000,4000
056289,合勤控永豐97購01,0,0,0,0,0,0,0,0,0,4000,0,0,0,4000,0,4000,4000
060148,臺股指國票9A購08,0,0,0,0,0,0,0,0,0,4000,0,0,0,4000,0,4000,4000
060110,茂林元大99購06  ,0,0,0,0,0,0,0,0,0,4000,0,0,0,85000,81000,4000,4000
058994,道瓊指元大99購01,0,0,0,0,0,0,0,0,0,4000,0,0,0,4000,0,4000,4000
060358,國巨元富9A購01  ,0,0,0,0,0,0,0,0,0,4000,0,0,0,49000,45000,4000,4000
060362,建準元富9A購02  ,0,0,0,0,0,0,0,0,0,4000,0,0,0,49000,45000,4000,4000
060252,緯穎元大9A購02  ,0,0,0,0,0,0,0,0,0,4000,0,0,0,6000,2000,4000,4000
060322,卜蜂群益9A購01  ,0,0,0,0,0,0,0,0,0,4000,0,0,0,5000,1000,4000,4000
00682U,元大美元指數    ,0,0,0,0,0,0,0,0,0,4000,0,0,0,14000,10000,4000,4000
00702,國泰標普低波高息,1000,0,1000,0,0,0,0,0,0,3000,0,0,0,8000,5000,3000,4000
00851,台新全球AI      ,0,0,0,0,0,0,0,0,0,4000,0,0,0,6000,2000,4000,4000
020016,統一MSCI美科技N ,0,0,0,0,0,0,0,0,0,4000,0,0,0,6000,2000,4000,4000
048269,瀚宇博國泰95購01,0,0,0,0,0,0,0,0,0,4000,0,0,0,4000,0,4000,4000
03047X,元展44          ,0,0,0,0,0,0,0,0,0,4000,0,0,0,4000,0,4000,4000
03437B,臺股指元富9C熊01,0,0,0,0,0,0,0,0,0,4000,0,0,0,5000,1000,4000,4000
051673,玉晶光元大96購04,0,0,0,0,0,0,0,0,0,4000,0,0,0,4000,0,4000,4000
045106,玉晶光群益95購01,0,0,0,0,0,0,0,0,0,4000,0,0,0,4000,0,4000,4000
051830,健策元大97購01  ,0,0,0,0,0,0,0,0,0,4000,0,0,0,4000,0,4000,4000
050660,欣興元大96購02  ,0,0,0,0,0,0,0,0,0,4000,0,0,0,4000,0,4000,4000
050774,健策元大96購02  ,0,0,0,0,0,0,0,0,0,4000,0,0,0,4000,0,4000,4000
04991P,台表科元大94售05,0,0,0,0,0,0,0,0,0,4000,0,0,0,14000,10000,4000,4000
05212P,台積電國票96售04,0,0,0,0,0,0,0,0,0,4000,0,0,0,4000,0,4000,4000
05013P,台積電元大96售05,0,0,0,0,0,0,0,0,0,4000,0,0,0,4000,0,4000,4000
052520,南亞科元大95購06,0,0,0,0,0,0,0,0,0,4000,0,0,0,4000,0,4000,4000
055157,晶豪科元大97購01,0,0,0,0,0,0,0,0,0,4000,0,0,0,4000,0,4000,4000
055289,泰碩元大98購01  ,0,0,0,0,0,0,0,0,0,4000,0,0,0,4000,0,4000,4000
054156,聯電亞東98購01  ,0,0,0,0,0,0,0,0,0,4000,0,0,0,4000,0,4000,4000
055782,新日興凱基99購01,0,0,0,0,0,0,0,0,0,4000,0,0,0,4000,0,4000,4000
058578,聯發科群益99購03,0,0,0,0,0,0,0,0,0,4000,0,0,0,20000,16000,4000,4000
052858,華通凱基97購02  ,0,0,0,0,0,0,0,0,0,4000,0,0,0,4000,0,4000,4000
052816,上銀永豐96購01  ,0,0,0,0,0,0,0,0,0,4000,0,0,0,52000,48000,4000,4000
053929,正文國票97購01  ,0,0,0,0,0,0,0,0,0,4000,0,0,0,43000,39000,4000,4000
055475,臻鼎凱基97購02  ,0,0,0,0,0,0,0,0,0,4000,0,0,0,9000,5000,4000,4000
054069,亞光國泰98購01  ,0,0,0,0,0,0,0,0,0,4000,0,0,0,4000,0,4000,4000
054353,世紀鋼國泰98購01,0,0,0,0,0,0,0,0,0,4000,0,0,0,4000,0,4000,4000
05482P,鴻海凱基95售22  ,0,0,0,0,0,0,0,0,0,4000,0,0,0,4000,0,4000,4000
054516,國巨元大97購02  ,0,0,0,0,0,0,0,0,0,4000,0,0,0,4000,0,4000,4000
1449,佳和            ,18000,14000,4000,0,0,0,0,0,0,0,0,0,0,0,0,0,4000
07525P,臺股指中信9B售07,0,0,0,0,0,0,0,0,0,4000,0,0,0,4000,0,4000,4000
07512P,國巨元大9A售08  ,0,0,0,0,0,0,0,0,0,4000,0,0,0,10000,6000,4000,4000
2348,海悅            ,6000,5000,1000,0,0,0,0,0,0,3000,4000,1000,3000,0,0,0,4000
2115,六暉-KY         ,4000,0,4000,0,0,0,0,0,0,0,0,0,0,0,0,0,4000
1614,三洋電          ,4000,0,4000,0,0,0,0,0,0,0,0,0,0,0,0,0,4000
2002A,中鋼特          ,0,0,0,0,0,0,0,0,0,4000,4000,0,4000,0,0,0,4000
060403,上銀國泰9B購01  ,0,0,0,0,0,0,0,0,0,4000,0,0,0,35000,31000,4000,4000
06726P,欣興元富98售04  ,0,0,0,0,0,0,0,0,0,4000,0,0,0,5000,1000,4000,4000
06731P,聯茂元大98售05  ,0,0,0,0,0,0,0,0,0,4000,0,0,0,4000,0,4000,4000
06621P,欣興元大98售06  ,0,0,0,0,0,0,0,0,0,4000,0,0,0,44000,40000,4000,4000
06479P,聯發科中信99售02,0,0,0,0,0,0,0,0,0,4000,0,0,0,4000,0,4000,4000
06480P,上銀凱基98售04  ,0,0,0,0,0,0,0,0,0,4000,0,0,0,4000,0,4000,4000
06507P,台表科國票99售01,0,0,0,0,0,0,0,0,0,4000,0,0,0,4000,0,4000,4000
06265P,美律凱基97售01  ,0,0,0,0,0,0,0,0,0,4000,0,0,0,4000,0,4000,4000
06353P,電子類富邦99售02,0,0,0,0,0,0,0,0,0,4000,0,0,0,4000,0,4000,4000
06447P,上銀元大98售01  ,0,0,0,0,0,0,0,0,0,4000,0,0,0,4000,0,4000,4000
5007,三星            ,12000,6000,6000,0,0,0,0,0,0,-2000,0,2000,-2000,0,0,0,4000
6579,研揚            ,4000,0,4000,0,0,0,0,0,0,0,0,0,0,0,0,0,4000
8072,陞泰            ,4000,0,4000,0,0,0,0,0,0,0,0,0,0,0,0,0,4000
9937,全國            ,5000,1000,4000,0,0,0,0,0,0,0,0,0,0,0,0,0,4000
2936,客思達-KY       ,5000,1000,4000,0,0,0,0,0,0,0,0,0,0,0,0,0,4000
3356,奇偶            ,52000,47000,5000,0,0,0,0,0,0,-1000,0,1000,-1000,0,0,0,4000
3557,嘉威            ,61000,57000,4000,0,0,0,0,0,0,0,0,0,0,0,0,0,4000
3296,勝德            ,5000,0,5000,0,0,0,0,0,0,-1000,0,1000,-1000,0,0,0,4000
060049,華通凱基99購06  ,0,0,0,0,0,0,0,0,0,3000,0,0,0,3000,0,3000,3000
060488,台灣50群益9C購01,0,0,0,0,0,0,0,0,0,3000,0,0,0,3000,0,3000,3000
059015,華通元富99購02  ,0,0,0,0,0,0,0,0,0,3000,0,0,0,3000,0,3000,3000
058999,台積電元大99購24,0,0,0,0,0,0,0,0,0,3000,0,0,0,3000,0,3000,3000
059943,信邦永豐99購01  ,0,0,0,0,0,0,0,0,0,3000,0,0,0,70000,67000,3000,3000
056265,國泰金統一97購01,0,0,0,0,0,0,0,0,0,3000,0,0,0,3000,0,3000,3000
056163,嘉聯益凱基98購03,0,0,0,0,0,0,0,0,0,3000,0,0,0,3000,0,3000,3000
056188,晶相光統一99購01,0,0,0,0,0,0,0,0,0,3000,0,0,0,3000,0,3000,3000
056907,群創元大9C購04  ,0,0,0,0,0,0,0,0,0,3000,0,0,0,3000,0,3000,3000
056914,臺股指元大99購09,0,0,0,0,0,0,0,0,0,3000,0,0,0,3000,0,3000,3000
056366,玉晶光元大99購04,0,0,0,0,0,0,0,0,0,3000,0,0,0,11000,8000,3000,3000
057925,貿聯凱基99購01  ,0,0,0,0,0,0,0,0,0,3000,0,0,0,3000,0,3000,3000
056820,欣興永豐98購02  ,0,0,0,0,0,0,0,0,0,3000,0,0,0,3000,0,3000,3000
059782,A50正2元大9C購04,0,0,0,0,0,0,0,0,0,3000,0,0,0,6000,3000,3000,3000
059830,台郡凱基99購05  ,0,0,0,0,0,0,0,0,0,3000,0,0,0,20000,17000,3000,3000
060009,南亞科群益99購03,0,0,0,0,0,0,0,0,0,3000,0,0,0,3000,0,3000,3000
057674,台郡元大99購03  ,0,0,0,0,0,0,0,0,0,3000,0,0,0,3000,0,3000,3000
058691,友訊國票9A購01  ,0,0,0,0,0,0,0,0,0,3000,0,0,0,41000,38000,3000,3000
05873P,華通群益97售02  ,0,0,0,0,0,0,0,0,0,3000,0,0,0,4000,1000,3000,3000
059548,台積電群益99購10,0,0,0,0,0,0,0,0,0,3000,0,0,0,3000,0,3000,3000
058141,嘉聯益元大99購05,0,0,0,0,0,0,0,0,0,3000,0,0,0,111000,108000,3000,3000
058113,百和元富98購01  ,0,0,0,0,0,0,0,0,0,3000,0,0,0,3000,0,3000,3000
059218,台積電元大99購31,0,0,0,0,0,0,0,0,0,3000,0,0,0,3000,0,3000,3000
059197,可成永豐99購02  ,0,0,0,0,0,0,0,0,0,3000,0,0,0,24000,21000,3000,3000
059297,大立光元富9C購01,0,0,0,0,0,0,0,0,0,3000,0,0,0,59000,56000,3000,3000
058350,T50正2凱基9B購01,0,0,0,0,0,0,0,0,0,3000,0,0,0,3000,0,3000,3000
058434,旺宏統一9B購01  ,0,0,0,0,0,0,0,0,0,3000,0,0,0,3000,0,3000,3000
054842,台達電兆豐98購01,0,0,0,0,0,0,0,0,0,3000,0,0,0,3000,0,3000,3000
054845,智邦兆豐98購01  ,0,0,0,0,0,0,0,0,0,3000,0,0,0,3000,0,3000,3000
053464,喬山元大96購01  ,0,0,0,0,0,0,0,0,0,3000,0,0,0,3000,0,3000,3000
053159,同欣電元大96購02,0,0,0,0,0,0,0,0,0,3000,0,0,0,3000,0,3000,3000
053345,欣興國票97購02  ,0,0,0,0,0,0,0,0,0,3000,0,0,0,3000,0,3000,3000
053357,可成統一96購02  ,0,0,0,0,0,0,0,0,0,3000,0,0,0,3000,0,3000,3000
053331,玉晶光永豐97購02,0,0,0,0,0,0,0,0,0,3000,0,0,0,3000,0,3000,3000
052760,盟立群益96購01  ,0,0,0,0,0,0,0,0,0,3000,0,0,0,3000,0,3000,3000
056523,光寶科中信98購01,0,0,0,0,0,0,0,0,0,3000,0,0,0,3000,0,3000,3000
057599,技嘉群益9A購01  ,0,0,0,0,0,0,0,0,0,3000,0,0,0,3000,0,3000,3000
056139,貿聯元大97購04  ,0,0,0,0,0,0,0,0,0,3000,0,0,0,3000,0,3000,3000
056454,欣興凱基98購02  ,0,0,0,0,0,0,0,0,0,3000,0,0,0,10000,7000,3000,3000
059436,大立光元大99購18,0,0,0,0,0,0,0,0,0,3000,0,0,0,8000,5000,3000,3000
058625,旺宏國票9A購01  ,0,0,0,0,0,0,0,0,0,3000,0,0,0,3000,0,3000,3000
056025,嘉晶群益97購01  ,0,0,0,0,0,0,0,0,0,3000,0,0,0,5000,2000,3000,3000
055332,奇力新兆豐98購01,0,0,0,0,0,0,0,0,0,3000,0,0,0,3000,0,3000,3000
055297,啟碁元大97購01  ,0,0,0,0,0,0,0,0,0,3000,0,0,0,3000,0,3000,3000
055283,聯發科元大97購16,0,0,0,0,0,0,0,0,0,3000,0,0,0,3000,0,3000,3000
055243,國巨統一97購04  ,0,0,0,0,0,0,0,0,0,3000,0,0,0,3000,0,3000,3000
053666,臺股指凱基96購29,0,0,0,0,0,0,0,0,0,3000,0,0,0,3000,0,3000,3000
052341,泰鼎凱基96購02  ,0,0,0,0,0,0,0,0,0,3000,0,0,0,3000,0,3000,3000
050779,超眾元大96購03  ,0,0,0,0,0,0,0,0,0,3000,0,0,0,3000,0,3000,3000
05101P,大立光凱基95售11,0,0,0,0,0,0,0,0,0,3000,0,0,0,3000,0,3000,3000
051902,T50反1元大97購01,0,0,0,0,0,0,0,0,0,3000,0,0,0,10000,7000,3000,3000
051934,緯穎國票96購01  ,0,0,0,0,0,0,0,0,0,3000,0,0,0,13000,10000,3000,3000
046217,康友富邦94購01  ,0,0,0,0,0,0,0,0,0,3000,0,0,0,3000,0,3000,3000
04684P,欣興元大94售07  ,0,0,0,0,0,0,0,0,0,3000,0,0,0,3000,0,3000,3000
051748,超眾國泰96購01  ,0,0,0,0,0,0,0,0,0,3000,0,0,0,3000,0,3000,3000
047689,瑞昱富邦97購01  ,0,0,0,0,0,0,0,0,0,3000,0,0,0,3000,0,3000,3000
020015,統一MSCI美低波N ,0,0,0,0,0,0,0,0,0,3000,0,0,0,5000,2000,3000,3000
3494,誠研            ,3000,0,3000,0,0,0,0,0,0,0,0,0,0,0,0,0,3000
2613,中櫃            ,3000,0,3000,0,0,0,0,0,0,0,0,0,0,0,0,0,3000
9136,巨騰-DR         ,4000,1000,3000,0,0,0,0,0,0,0,0,0,0,0,0,0,3000
6405,悅城            ,3000,0,3000,0,0,0,0,0,0,0,0,0,0,0,0,0,3000
06408P,聯茂元富97售02  ,0,0,0,0,0,0,0,0,0,3000,0,0,0,5000,2000,3000,3000
06416P,大立光群益97售06,0,0,0,0,0,0,0,0,0,3000,0,0,0,3000,0,3000,3000
06283P,祥碩永豐97售01  ,0,0,0,0,0,0,0,0,0,3000,0,0,0,3000,0,3000,3000
06266P,大立光凱基97售11,0,0,0,0,0,0,0,0,0,3000,0,0,0,3000,0,3000,3000
06122P,亞光元大98售01  ,0,0,0,0,0,0,0,0,0,3000,0,0,0,5000,2000,3000,3000
06546P,聯發科元大98售05,0,0,0,0,0,0,0,0,0,3000,0,0,0,3000,0,3000,3000
06582P,可成凱基98售06  ,0,0,0,0,0,0,0,0,0,3000,0,0,0,3000,0,3000,3000
06783P,亞光元大98售03  ,0,0,0,0,0,0,0,0,0,3000,0,0,0,8000,5000,3000,3000
060399,康友國票9A購02  ,0,0,0,0,0,0,0,0,0,3000,0,0,0,3000,0,3000,3000
07169P,臺股指國票99售06,0,0,0,0,0,0,0,0,0,3000,0,0,0,6000,3000,3000,3000
07193P,聯發科元大99售24,0,0,0,0,0,0,0,0,0,3000,0,0,0,3000,0,3000,3000
07127P,精元元大99售01  ,0,0,0,0,0,0,0,0,0,3000,0,0,0,8000,5000,3000,3000
07075P,FBVIX凱基9C售04 ,0,0,0,0,0,0,0,0,0,3000,0,0,0,3000,0,3000,3000
07221P,臺股指中信9B售04,0,0,0,0,0,0,0,0,0,3000,0,0,0,3000,0,3000,3000
07489P,國巨國票9A售07  ,0,0,0,0,0,0,0,0,0,3000,0,0,0,42000,39000,3000,3000
6409,旭隼            ,85101,75370,9731,0,0,0,0,320,-320,-7000,1000,8000,-7000,0,0,0,2411
05884P,旺宏統一96售01  ,0,0,0,0,0,0,0,0,0,2000,0,0,0,2000,0,2000,2000
058850,華新科群益99購03,0,0,0,0,0,0,0,0,0,2000,0,0,0,2000,0,2000,2000
059292,華新科元富9B購02,0,0,0,0,0,0,0,0,0,2000,0,0,0,10000,8000,2000,2000
059388,國巨凱基99購13  ,0,0,0,0,0,0,0,0,0,2000,0,0,0,30000,28000,2000,2000
059204,台灣50元大01購02,0,0,0,0,0,0,0,0,0,2000,0,0,0,2000,0,2000,2000
059234,台灣50凱基9C購03,0,0,0,0,0,0,0,0,0,2000,0,0,0,2000,0,2000,2000
059125,台積電第一03購02,0,0,0,0,0,0,0,0,0,2000,0,0,0,2000,0,2000,2000
059077,FBVIX元大99購05 ,0,0,0,0,0,0,0,0,0,2000,0,0,0,4000,2000,2000,2000
059066,道瓊指國票04購01,0,0,0,0,0,0,0,0,0,2000,0,0,0,2000,0,2000,2000
057478,智邦元大99購01  ,0,0,0,0,0,0,0,0,0,2000,0,0,0,2000,0,2000,2000
059528,華新科凱基99購06,0,0,0,0,0,0,0,0,0,2000,0,0,0,5000,3000,2000,2000
057188,佐登元大98購01  ,0,0,0,0,0,0,0,0,0,2000,0,0,0,2000,0,2000,2000
057665,技嘉元大99購01  ,0,0,0,0,0,0,0,0,0,2000,0,0,0,2000,0,2000,2000
056639,國產康和98購01  ,0,0,0,0,0,0,0,0,0,2000,0,0,0,70000,68000,2000,2000
05888P,友達元大97售01  ,0,0,0,0,0,0,0,0,0,2000,0,0,0,2000,0,2000,2000
05682P,大立光元大98售03,0,0,0,0,0,0,0,0,0,2000,0,0,0,2000,0,2000,2000
057918,旺宏凱基99購01  ,0,0,0,0,0,0,0,0,0,2000,0,0,0,3000,1000,2000,2000
056915,上銀兆豐99購01  ,0,0,0,0,0,0,0,0,0,2000,0,0,0,2000,0,2000,2000
056978,技嘉群益99購01  ,0,0,0,0,0,0,0,0,0,2000,0,0,0,2000,0,2000,2000
058981,國巨凱基99購10  ,0,0,0,0,0,0,0,0,0,2000,0,0,0,72000,70000,2000,2000
056171,鴻海元富97購10  ,0,0,0,0,0,0,0,0,0,2000,0,0,0,2000,0,2000,2000
056195,群創富邦98購01  ,0,0,0,0,0,0,0,0,0,2000,0,0,0,2000,0,2000,2000
056231,嘉聯益凱基97購02,0,0,0,0,0,0,0,0,0,2000,0,0,0,41000,39000,2000,2000
059906,臺指反元大9C購04,0,0,0,0,0,0,0,0,0,2000,0,0,0,12000,10000,2000,2000
059748,聯發科台新99購03,0,0,0,0,0,0,0,0,0,2000,0,0,0,26000,24000,2000,2000
059706,嘉晶凱基99購01  ,0,0,0,0,0,0,0,0,0,2000,0,0,0,160000,158000,2000,2000
00763U,街口道瓊銅      ,0,0,0,0,0,0,0,0,0,2000,0,0,0,64000,62000,2000,2000
00865B,國泰US短期公債  ,0,0,0,0,0,0,0,0,0,2000,0,0,0,102000,100000,2000,2000
03022X,富展01          ,0,0,0,0,0,0,0,0,0,2000,0,0,0,2000,0,2000,2000
049251,國巨元大95購02  ,0,0,0,0,0,0,0,0,0,2000,0,0,0,64000,62000,2000,2000
035275,台積電台新97購01,0,0,0,0,0,0,0,0,0,2000,0,0,0,14000,12000,2000,2000
04832P,為升元大94售09  ,0,0,0,0,0,0,0,0,0,2000,0,0,0,2000,0,2000,2000
048422,瑞昱元富96購02  ,0,0,0,0,0,0,0,0,0,2000,0,0,0,50000,48000,2000,2000
048867,台積電兆豐95購01,0,0,0,0,0,0,0,0,0,2000,0,0,0,2000,0,2000,2000
048873,玉晶光國票95購02,0,0,0,0,0,0,0,0,0,2000,0,0,0,5000,3000,2000,2000
051698,旺宏麥證95購01  ,0,0,0,10000,8000,2000,0,0,0,2000,0,0,0,10000,8000,2000,2000
051805,元黃金凱基97購02,0,0,0,0,0,0,0,0,0,2000,0,0,0,2000,0,2000,2000
050523,義隆元大94購05  ,0,0,0,0,0,0,0,0,0,2000,0,0,0,2000,0,2000,2000
050457,力成元大94購01  ,0,0,0,0,0,0,0,0,0,2000,0,0,0,2000,0,2000,2000
053662,矽力凱基97購01  ,0,0,0,0,0,0,0,0,0,2000,0,0,0,12000,10000,2000,2000
053535,宏達電永豐96購02,0,0,0,0,0,0,0,0,0,2000,0,0,0,2000,0,2000,2000
053759,晶相光國泰98購01,0,0,0,0,0,0,0,0,0,2000,0,0,0,2000,0,2000,2000
055176,大毅統一98購02  ,0,0,0,0,0,0,0,0,0,2000,0,0,0,8000,6000,2000,2000
053901,T50反1凱基99購03,0,0,0,0,0,0,0,0,0,2000,0,0,0,2000,0,2000,2000
053840,燿華統一96購02  ,0,0,0,0,0,0,0,0,0,2000,0,0,0,2000,0,2000,2000
053848,聯發科元富96購03,0,0,0,0,0,0,0,0,0,2000,0,0,0,2000,0,2000,2000
056088,台郡統一97購02  ,0,0,0,0,0,0,0,0,0,2000,0,0,0,2000,0,2000,2000
055974,上銀統一97購05  ,0,0,0,0,0,0,0,0,0,2000,0,0,0,105000,103000,2000,2000
05573P,仁寶元富96售02  ,0,0,0,0,0,0,0,0,0,2000,0,0,0,2000,0,2000,2000
055733,奇力新元富97購01,0,0,0,0,0,0,0,0,0,2000,0,0,0,2000,0,2000,2000
055102,上銀凱基98購01  ,0,0,0,0,0,0,0,0,0,2000,0,0,0,2000,0,2000,2000
055070,聯茂永豐97購01  ,0,0,0,0,0,0,0,0,0,2000,0,0,0,107000,105000,2000,2000
056478,晶技元大99購01  ,0,0,0,0,0,0,0,0,0,2000,0,0,0,2000,0,2000,2000
056432,鴻海凱基98購08  ,0,0,0,0,0,0,0,0,0,2000,0,0,0,2000,0,2000,2000
052764,景碩群益98購01  ,0,0,0,0,0,0,0,0,0,2000,0,0,0,2000,0,2000,2000
053005,微星永豐96購01  ,0,0,0,0,0,0,0,0,0,2000,0,0,0,2000,0,2000,2000
053229,南電台新97購01  ,0,0,0,0,0,0,0,0,0,2000,0,0,0,2000,0,2000,2000
054961,玉晶光元大99購01,0,0,0,0,0,0,0,0,0,2000,0,0,0,2000,0,2000,2000
05460P,台郡凱基95售05  ,0,0,0,0,0,0,0,0,0,2000,0,0,0,2000,0,2000,2000
054559,台光電群益99購01,0,0,0,0,0,0,0,0,0,2000,0,0,0,2000,0,2000,2000
054575,聯鈞元大97購01  ,0,0,0,0,0,0,0,0,0,2000,0,0,0,2000,0,2000,2000
05439P,聯發科國票95售06,0,0,0,0,0,0,0,0,0,2000,0,0,0,7000,5000,2000,2000
054294,世芯元大96購02  ,0,0,0,0,0,0,0,0,0,2000,0,0,0,2000,0,2000,2000
055572,鴻海統一98購04  ,0,0,0,0,0,0,0,0,0,2000,0,0,0,20000,18000,2000,2000
054057,晶豪科國票97購01,0,0,0,0,0,0,0,0,0,2000,0,0,0,2000,0,2000,2000
6464,台數科          ,3000,1000,2000,0,0,0,0,0,0,0,0,0,0,0,0,0,2000
4989,榮科            ,30000,27000,3000,0,0,0,0,0,0,-1000,0,1000,-1000,0,0,0,2000
9941A,裕融甲特        ,0,0,0,0,0,0,0,0,0,2000,2000,0,2000,0,0,0,2000
6625,必應            ,2000,0,2000,0,0,0,0,0,0,0,0,0,0,0,0,0,2000
8462,柏文            ,13000,17000,-4000,0,0,0,0,0,0,6000,0,0,0,7000,1000,6000,2000
8466,美吉吉-KY       ,2000,0,2000,0,0,0,0,0,0,0,0,0,0,0,0,0,2000
2891B,中信金乙特      ,0,0,0,0,0,0,0,0,0,2000,2000,0,2000,0,0,0,2000
3040,遠見            ,11000,9000,2000,0,0,0,0,0,0,0,0,0,0,0,0,0,2000
07401P,台積電凱基99售21,0,0,0,0,0,0,0,0,0,2000,0,0,0,4000,2000,2000,2000
1256,鮮活果汁-KY     ,7000,5000,2000,0,0,0,0,0,0,0,0,0,0,0,0,0,2000
1312A,國喬特          ,0,0,0,0,0,0,0,0,0,2000,3000,1000,2000,0,0,0,2000
2012,春雨            ,2000,0,2000,0,0,0,0,0,0,0,0,0,0,0,0,0,2000
2033,佳大            ,1000,0,1000,0,0,0,0,0,0,1000,1000,0,1000,0,0,0,2000
1587,吉茂            ,2000,0,2000,0,0,0,0,0,0,0,0,0,0,0,0,0,2000
2236,百達-KY         ,2000,0,2000,0,0,0,0,0,0,0,0,0,0,0,0,0,2000
07271P,台灣50元大9C售04,0,0,0,0,0,0,0,0,0,2000,0,0,0,2000,0,2000,2000
07194P,聯發科元大99售25,0,0,0,0,0,0,0,0,0,2000,0,0,0,4000,2000,2000,2000
07196P,大立光元大99售13,0,0,0,0,0,0,0,0,0,2000,0,0,0,2000,0,2000,2000
06988P,鴻海元富99售09  ,0,0,0,0,0,0,0,0,0,2000,0,0,0,2000,0,2000,2000
06802P,緯穎群益98售03  ,0,0,0,0,0,0,0,0,0,2000,0,0,0,2000,0,2000,2000
06808P,電子類群益98售02,0,0,0,0,0,0,0,0,0,2000,0,0,0,2000,0,2000,2000
06771P,台灣50中信02售01,0,0,0,0,0,0,0,0,0,2000,0,0,0,2000,0,2000,2000
06550P,健策元大99售01  ,0,0,0,0,0,0,0,0,0,2000,0,0,0,2000,0,2000,2000
060520,臺指2X中信01購02,0,0,0,0,0,0,0,0,0,2000,0,0,0,2000,0,2000,2000
059726,華新科元大99購18,0,0,0,0,0,0,0,0,0,1000,0,0,0,13000,12000,1000,1000
059003,中壽元大99購01  ,0,0,0,0,0,0,0,0,0,1000,0,0,0,1000,0,1000,1000
059049,元油2X凱基9A購12,0,0,0,0,0,0,0,0,0,1000,0,0,0,1000,0,1000,1000
059762,禾伸堂永豐99購02,0,0,0,0,0,0,0,0,0,1000,0,0,0,10000,9000,1000,1000
057015,元油2X凱基9B購04,0,0,0,0,0,0,0,0,0,1000,0,0,0,1000,0,1000,1000
060369,滬深2X元富01購01,0,0,0,0,0,0,0,0,0,1000,0,0,0,1000,0,1000,1000
060449,元金2X元大9A購02,0,0,0,0,0,0,0,0,0,1000,0,0,0,1000,0,1000,1000
060323,華通群益9C購01  ,0,0,0,0,0,0,0,0,0,1000,0,0,0,3000,2000,1000,1000
056232,瑞儀凱基98購01  ,0,0,0,0,0,0,0,0,0,1000,0,0,0,1000,0,1000,1000
056166,微星台新97購01  ,0,0,0,0,0,0,0,0,0,1000,0,0,0,1000,0,1000,1000
058982,台積電凱基99購08,0,0,0,0,0,0,0,0,0,1000,0,0,0,1000,0,1000,1000
056918,台積電兆豐98購01,0,0,0,0,0,0,0,0,0,1000,0,0,0,1000,0,1000,1000
056892,旺宏元大9A購02  ,0,0,0,0,0,0,0,0,0,1000,0,0,0,1000,0,1000,1000
056827,元油2X富邦02購01,0,0,0,0,0,0,0,0,0,1000,0,0,0,1000,0,1000,1000
056862,聯發科群益98購03,0,0,0,0,0,0,0,0,0,1000,0,0,0,1000,0,1000,1000
056781,元油2X群益9B購02,0,0,0,0,0,0,0,0,0,1000,0,0,0,1000,0,1000,1000
05670P,台積電國票98售01,0,0,0,0,0,0,0,0,0,1000,0,0,0,1000,0,1000,1000
059781,A50正2元大9C購03,0,0,0,0,0,0,0,0,0,1000,0,0,0,1000,0,1000,1000
059813,滬深2X凱基9B購01,0,0,0,0,0,0,0,0,0,1000,0,0,0,1000,0,1000,1000
057739,新日興富邦9B購01,0,0,0,0,0,0,0,0,0,1000,0,0,0,1000,0,1000,1000
057745,泰鼎永豐99購01  ,0,0,0,0,0,0,0,0,0,1000,0,0,0,1000,0,1000,1000
057185,群創元大98購06  ,0,0,0,0,0,0,0,0,0,1000,0,0,0,1000,0,1000,1000
057270,遠東新元大98購01,0,0,0,0,0,0,0,0,0,1000,0,0,0,1000,0,1000,1000
059531,華新科凱基9B購02,0,0,0,0,0,0,0,0,0,1000,0,0,0,10000,9000,1000,1000
057128,台光電凱基98購03,0,0,0,0,0,0,0,0,0,1000,0,0,0,1000,0,1000,1000
057118,欣興日盛9A購01  ,0,0,0,0,0,0,0,0,0,1000,0,0,0,1000,0,1000,1000
057296,智原永豐98購01  ,0,0,0,0,0,0,0,0,0,1000,0,0,0,1000,0,1000,1000
057427,華通兆豐99購01  ,0,0,0,0,0,0,0,0,0,1000,0,0,0,11000,10000,1000,1000
057831,聯發科元富02購04,0,0,0,0,0,0,0,0,0,1000,0,0,0,1000,0,1000,1000
058186,聯發科永豐99購01,0,0,0,0,0,0,0,0,0,1000,0,0,0,1000,0,1000,1000
059076,FBVIX元大99購04 ,0,0,0,0,0,0,0,0,0,1000,0,0,0,1000,0,1000,1000
059124,台積電第一03購01,0,0,0,0,0,0,0,0,0,1000,0,0,0,1000,0,1000,1000
059135,臺股指群益99購10,0,0,0,0,0,0,0,0,0,1000,0,0,0,10000,9000,1000,1000
059642,健策凱基99購04  ,0,0,0,0,0,0,0,0,0,1000,0,0,0,22000,21000,1000,1000
059392,臺股指凱基99購38,0,0,0,0,0,0,0,0,0,1000,0,0,0,1000,0,1000,1000
059630,美律凱基99購07  ,0,0,0,0,0,0,0,0,0,1000,0,0,0,21000,20000,1000,1000
059334,A50正2國票9A購02,0,0,0,0,0,0,0,0,0,1000,0,0,0,51000,50000,1000,1000
059363,超眾永豐99購02  ,0,0,0,0,0,0,0,0,0,1000,0,0,0,153000,152000,1000,1000
059228,臺股指元大99購21,0,0,0,0,0,0,0,0,0,1000,0,0,0,1000,0,1000,1000
058875,台表科國票9A購02,0,0,0,0,0,0,0,0,0,1000,0,0,0,1000,0,1000,1000
056557,世紀鋼凱基98購02,0,0,0,0,0,0,0,0,0,1000,0,0,0,11000,10000,1000,1000
056590,樺漢統一9A購01  ,0,0,0,0,0,0,0,0,0,1000,0,0,0,1000,0,1000,1000
058419,聯發科麥證99購02,0,0,0,0,0,0,0,0,0,1000,0,0,0,1000,0,1000,1000
058355,旺宏凱基99購04  ,0,0,0,0,0,0,0,0,0,1000,0,0,0,3000,2000,1000,1000
058362,聯發科凱基99購06,0,0,0,0,0,0,0,0,0,1000,0,0,0,1000,0,1000,1000
058377,茂林凱基9A購03  ,0,0,0,0,0,0,0,0,0,1000,0,0,0,20000,19000,1000,1000
058463,宏達電兆豐99購02,0,0,0,0,0,0,0,0,0,1000,0,0,0,68000,67000,1000,1000
054047,富邦金元大97購01,0,0,0,0,0,0,0,0,0,1000,0,0,0,1000,0,1000,1000
055568,緯穎凱基97購02  ,0,0,0,0,0,0,0,0,0,1000,0,0,0,1000,0,1000,1000
054428,禾伸堂富邦98購01,0,0,0,0,0,0,0,0,0,1000,0,0,0,1000,0,1000,1000
05444P,大立光元大95售10,0,0,0,0,0,0,0,0,0,1000,0,0,0,1000,0,1000,1000
054965,健策元大98購04  ,0,0,0,0,0,0,0,0,0,1000,0,0,0,1000,0,1000,1000
054933,南港元大97購01  ,0,0,0,0,0,0,0,0,0,1000,0,0,0,1000,0,1000,1000
054906,神達康和97購01  ,0,0,0,0,0,0,0,0,0,1000,0,0,0,1000,0,1000,1000
054866,宏盛群益98購01  ,0,0,0,0,0,0,0,0,0,1000,0,0,0,1000,0,1000,1000
054759,台化國票98購01  ,0,0,0,0,0,0,0,0,0,1000,0,0,0,1000,0,1000,1000
053197,超眾元富96購02  ,0,0,0,0,0,0,0,0,0,1000,0,0,0,1000,0,1000,1000
053162,緯穎元大97購01  ,0,0,0,0,0,0,0,0,0,1000,0,0,0,1000,0,1000,1000
053129,緯穎凱基96購01  ,0,0,0,0,0,0,0,0,0,1000,0,0,0,4000,3000,1000,1000
053324,康舒群益96購01  ,0,0,0,0,0,0,0,0,0,1000,0,0,0,1000,0,1000,1000
053928,智易國票97購03  ,0,0,0,0,0,0,0,0,0,1000,0,0,0,20000,19000,1000,1000
053960,晶技永豐96購02  ,0,0,0,0,0,0,0,0,0,1000,0,0,0,1000,0,1000,1000
053063,力山群益98購01  ,0,0,0,0,0,0,0,0,0,1000,0,0,0,1000,0,1000,1000
053079,世紀鋼永豐96購01,0,0,0,0,0,0,0,0,0,1000,0,0,0,1000,0,1000,1000
052846,智邦統一97購01  ,0,0,0,0,0,0,0,0,0,1000,0,0,0,1000,0,1000,1000
05650P,台積電富邦96售01,0,0,0,0,0,0,0,0,0,1000,0,0,0,1000,0,1000,1000
05756P,臺股指中信99售05,0,0,0,0,0,0,0,0,0,1000,0,0,0,1000,0,1000,1000
057547,技嘉凱基99購01  ,0,0,0,0,0,0,0,0,0,1000,0,0,0,11000,10000,1000,1000
057601,中磊群益98購01  ,0,0,0,0,0,0,0,0,0,1000,0,0,0,1000,0,1000,1000
057625,泰鼎國泰9A購01  ,0,0,0,0,0,0,0,0,0,1000,0,0,0,1000,0,1000,1000
058661,臺股指中信9C購01,0,0,0,0,0,0,0,0,0,1000,0,0,0,1000,0,1000,1000
058652,SGBR2X中信01購01,0,0,0,0,0,0,0,0,0,1000,0,0,0,1000,0,1000,1000
058668,元油2X群益9B購04,0,0,0,0,0,0,0,0,0,1000,0,0,0,1000,0,1000,1000
058669,上銀群益99購01  ,0,0,0,0,0,0,0,0,0,1000,0,0,0,27000,26000,1000,1000
055599,TPK元大97購01   ,0,0,0,0,0,0,0,0,0,1000,0,0,0,1000,0,1000,1000
054142,致伸元大97購01  ,0,0,0,0,0,0,0,0,0,1000,0,0,0,1000,0,1000,1000
054187,亞光永豐96購03  ,0,0,0,0,0,0,0,0,0,1000,0,0,0,1000,0,1000,1000
05559P,臺股指麥證96售01,0,0,0,1000,0,1000,0,0,0,1000,0,0,0,1000,0,1000,1000
055676,亞德客凱基97購03,0,0,0,0,0,0,0,0,0,1000,0,0,0,1000,0,1000,1000
055660,台光電兆豐97購01,0,0,0,0,0,0,0,0,0,1000,0,0,0,1000,0,1000,1000
055688,力成凱基98購02  ,0,0,0,0,0,0,0,0,0,1000,0,0,0,1000,0,1000,1000
055797,華通富邦98購01  ,0,0,0,0,0,0,0,0,0,1000,0,0,0,1000,0,1000,1000
055919,景碩凱基98購02  ,0,0,0,0,0,0,0,0,0,1000,0,0,0,11000,10000,1000,1000
055925,上銀群益97購01  ,0,0,0,0,0,0,0,0,0,1000,0,0,0,1000,0,1000,1000
056095,臻鼎元富9A購01  ,0,0,0,0,0,0,0,0,0,1000,0,0,0,1000,0,1000,1000
053825,南電群益96購02  ,0,0,0,0,0,0,0,0,0,1000,0,0,0,1000,0,1000,1000
053800,華通凱基97購03  ,0,0,0,0,0,0,0,0,0,1000,0,0,0,3000,2000,1000,1000
055335,健策兆豐98購01  ,0,0,0,0,0,0,0,0,0,1000,0,0,0,1000,0,1000,1000
055202,神達群益97購01  ,0,0,0,0,0,0,0,0,0,1000,0,0,0,1000,0,1000,1000
052588,玉晶光永豐98購01,0,0,0,0,0,0,0,0,0,1000,0,0,0,1000,0,1000,1000
053587,京元電元大98購01,0,0,0,0,0,0,0,0,0,1000,0,0,0,1000,0,1000,1000
053704,國巨群益96購06  ,0,0,0,0,0,0,0,0,0,1000,0,0,0,1000,0,1000,1000
05020P,廣達中信95售01  ,0,0,0,0,0,0,0,0,0,1000,0,0,0,1000,0,1000,1000
050351,華新科群益95購02,0,0,0,0,0,0,0,0,0,1000,0,0,0,1000,0,1000,1000
050356,緯穎群益94購05  ,0,0,0,0,0,0,0,0,0,1000,0,0,0,1000,0,1000,1000
050012,台積電國泰95購03,0,0,0,0,0,0,0,0,0,1000,0,0,0,1000,0,1000,1000
052172,致茂元大95購01  ,0,0,0,0,0,0,0,0,0,1000,0,0,0,1000,0,1000,1000
052137,台表科凱基96購02,0,0,0,0,0,0,0,0,0,1000,0,0,0,4000,3000,1000,1000
050957,T50反1台新05購01,0,0,0,0,0,0,0,0,0,1000,0,0,0,1000,0,1000,1000
050801,元金2X群益98購01,0,0,0,0,0,0,0,0,0,1000,0,0,0,1000,0,1000,1000
051461,聯詠國泰96購01  ,0,0,0,0,0,0,0,0,0,1000,0,0,0,87000,86000,1000,1000
051463,世芯國泰97購02  ,0,0,0,0,0,0,0,0,0,1000,0,0,0,1000,0,1000,1000
052049,緯創凱基97購01  ,0,0,0,0,0,0,0,0,0,1000,0,0,0,1000,0,1000,1000
049702,台表科元大95購03,0,0,0,0,0,0,0,0,0,1000,0,0,0,1000,0,1000,1000
04669P,臺股指國票94售08,0,0,0,0,0,0,0,0,0,1000,0,0,0,1000,0,1000,1000
045872,元油2X元富98購03,0,0,0,0,0,0,0,0,0,1000,0,0,0,1000,0,1000,1000
044254,深中小元大94購01,0,0,0,0,0,0,0,0,0,1000,0,0,0,1000,0,1000,1000
040381,元金2X元富95購01,0,0,0,0,0,0,0,0,0,1000,0,0,0,1000,0,1000,1000
048874,玉晶光國票96購01,0,0,0,0,0,0,0,0,0,1000,0,0,0,1000,0,1000,1000
048707,南電國票95購01  ,0,0,0,0,0,0,0,0,0,1000,0,0,0,39000,38000,1000,1000
04822P,台積電元富94售08,0,0,0,0,0,0,0,0,0,1000,0,0,0,1000,0,1000,1000
048551,鴻海元大94購02  ,0,0,0,0,0,0,0,0,0,1000,0,0,0,1000,0,1000,1000
04842P,群創元大96售02  ,0,0,0,0,0,0,0,0,0,1000,0,0,0,1000,0,1000,1000
048637,鴻海元大96購01  ,0,0,0,0,0,0,0,0,0,1000,0,0,0,1000,0,1000,1000
048460,盛群凱基94購01  ,0,0,0,0,0,0,0,0,0,1000,0,0,0,1000,0,1000,1000
03821P,上海銀統一95售01,0,0,0,0,0,0,0,0,0,1000,0,0,0,1000,0,1000,1000
04047P,華邦電元大94售03,0,0,0,0,0,0,0,0,0,1000,0,0,0,1000,0,1000,1000
03896P,長榮航凱基95售01,0,0,0,0,0,0,0,0,0,1000,0,0,0,1000,0,1000,1000
03388P,元油2X元富98售02,0,0,0,0,0,0,0,0,0,1000,0,0,0,1000,0,1000,1000
00775B,新光投等債15+   ,31000,0,31000,0,0,0,0,0,0,-30000,0,0,0,0,30000,-30000,1000
020011,統一微波高息20N ,0,0,0,0,0,0,0,0,0,1000,0,0,0,1000,0,1000,1000
00733,富邦臺灣中小    ,0,0,0,0,0,0,0,0,0,1000,0,0,0,208000,207000,1000,1000
00735,國泰臺韓科技    ,0,0,0,0,0,0,0,0,0,1000,0,0,0,101000,100000,1000,1000
0061,元大寶滬深      ,0,3000,-3000,0,0,0,0,0,0,4000,0,0,0,5000,1000,4000,1000
060605,大立光凱基9C購01,0,0,0,0,0,0,0,0,0,1000,0,0,0,1000,0,1000,1000
06136P,華新科國泰99售02,0,0,0,0,0,0,0,0,0,1000,0,0,0,1000,0,1000,1000
06162P,大立光群益97售02,0,0,0,0,0,0,0,0,0,1000,0,0,0,1000,0,1000,1000
06303P,臺股指元大97售09,0,0,0,0,0,0,0,0,0,1000,0,0,0,1000,0,1000,1000
06448P,華通元大99售01  ,0,0,0,0,0,0,0,0,0,1000,0,0,0,1000,0,1000,1000
06745P,台積電群益98售05,0,0,0,0,0,0,0,0,0,1000,0,0,0,1000,0,1000,1000
06860P,台灣50兆豐98售01,0,0,0,0,0,0,0,0,0,1000,0,0,0,1000,0,1000,1000
07010P,T50正2凱基9C售01,0,0,0,0,0,0,0,0,0,1000,0,0,0,3000,2000,1000,1000
07217P,大立光凱基9A售05,0,0,0,0,0,0,0,0,0,1000,0,0,0,1000,0,1000,1000
07124P,台積電元大99售21,0,0,0,0,0,0,0,0,0,1000,0,0,0,1000,0,1000,1000
07273P,台灣50群益99售03,0,0,0,0,0,0,0,0,0,1000,0,0,0,1000,0,1000,1000
2440,太空梭          ,1000,0,1000,0,0,0,0,0,0,0,0,0,0,0,0,0,1000
2423,固緯            ,15000,13000,2000,0,0,0,0,0,0,-1000,0,1000,-1000,0,0,0,1000
1525,江申            ,2000,1000,1000,0,0,0,0,0,0,0,0,0,0,0,0,0,1000
1324,地球            ,1000,0,1000,0,0,0,0,0,0,0,0,0,0,0,0,0,1000
1341,富林-KY         ,1000,0,1000,0,0,0,0,0,0,0,0,0,0,0,0,0,1000
07538P,玉晶光元富9A售05,0,0,0,0,0,0,0,0,0,1000,0,0,0,1000,0,1000,1000
3055,蔚華科          ,6000,5000,1000,0,0,0,0,0,0,0,0,0,0,0,0,0,1000
4545,銘鈺            ,8000,7000,1000,0,0,0,0,0,0,0,0,0,0,0,0,0,1000
4439,冠星-KY         ,1000,0,1000,0,0,0,0,0,0,0,0,0,0,0,0,0,1000
4562,穎漢            ,3000,1000,2000,0,0,0,0,0,0,-1000,0,1000,-1000,0,0,0,1000
2543,皇昌            ,3000,2000,1000,0,0,0,0,0,0,0,0,0,0,0,0,0,1000
9918,欣天然          ,2000,1000,1000,0,0,0,0,0,0,0,0,0,0,0,0,0,1000
9929,秋雨            ,1000,0,1000,0,0,0,0,0,0,0,0,0,0,0,0,0,1000
9931,欣高            ,1000,0,1000,0,0,0,0,0,0,0,0,0,0,0,0,0,1000
5906,台南-KY         ,1000,0,1000,0,0,0,0,0,0,0,0,0,0,0,0,0,1000
6283,淳安            ,13000,12000,1000,0,0,0,0,0,0,0,0,0,0,0,0,0,1000
05850P,台積電兆豐96售06,0,0,0,0,0,0,0,0,0,0,0,0,0,10000,10000,0,0
058503,鴻海元大99購14  ,0,0,0,0,0,0,0,0,0,0,0,0,0,58000,58000,0,0
058551,義隆永豐99購03  ,0,0,0,0,0,0,0,0,0,0,0,0,0,10000,10000,0,0
058556,百和永豐99購01  ,0,0,0,0,0,0,0,0,0,0,0,0,0,108000,108000,0,0
058360,台光電凱基9A購02,0,0,0,0,0,0,0,0,0,0,0,0,0,10000,10000,0,0
058361,美律凱基99購06  ,0,0,0,0,0,0,0,0,0,0,0,0,0,10000,10000,0,0
058336,鴻海元富99購07  ,0,0,0,0,0,0,0,0,0,0,0,0,0,40000,40000,0,0
058347,玉晶光群益9B購01,0,0,0,0,0,0,0,0,0,0,0,0,0,21000,21000,0,0
058422,百和麥證99購01  ,0,0,0,50000,0,50000,0,0,0,0,0,0,0,50000,50000,0,0
058438,大立光統一9B購01,0,0,0,0,0,0,0,0,0,0,0,0,0,40000,40000,0,0
058412,聯發科兆豐99購01,0,0,0,0,0,0,0,0,0,0,0,0,0,10000,10000,0,0
056559,華通群益98購02  ,0,0,0,0,0,0,0,0,0,0,0,0,0,3000,3000,0,0
056563,華新科群益98購04,0,0,0,0,0,0,0,0,0,0,0,0,0,10000,10000,0,0
058792,鴻海元大99購18  ,0,0,0,0,0,0,0,0,0,0,0,0,0,9000,9000,0,0
058874,聯鈞國票9A購01  ,0,0,0,0,0,0,0,0,0,0,0,0,0,29000,29000,0,0
058861,國巨凱基9A購08  ,0,0,0,0,0,0,0,0,0,0,0,0,0,135000,135000,0,0
059590,台積電元大99購39,0,0,0,0,0,0,0,0,0,0,0,0,0,1000,1000,0,0
059586,上銀元大9A購02  ,0,0,0,0,0,0,0,0,0,0,0,0,0,23000,23000,0,0
059239,台積電凱基99購12,0,0,0,0,0,0,0,0,0,0,0,0,0,1000,1000,0,0
059248,華新科凱基99購04,0,0,0,0,0,0,0,0,0,0,0,0,0,13000,13000,0,0
059241,旺宏凱基99購07  ,0,0,0,0,0,0,0,0,0,0,0,0,0,55000,55000,0,0
059260,國巨中信99購05  ,0,0,0,0,0,0,0,0,0,0,0,0,0,116000,116000,0,0
059291,華新科元富9B購01,0,0,0,0,0,0,0,0,0,0,0,0,0,40000,40000,0,0
05930P,景碩康和96售01  ,0,0,0,0,0,0,0,0,0,0,0,0,0,10000,10000,0,0
059316,國巨元大99購23  ,0,0,0,0,0,0,0,0,0,0,0,0,0,57000,57000,0,0
059372,台灣50群益99購02,0,0,0,0,0,0,0,0,0,0,0,0,0,27000,27000,0,0
059085,鴻海元大99購25  ,0,0,0,0,0,0,0,0,0,0,0,0,0,19000,19000,0,0
059142,道瓊指國票9B購02,0,0,0,0,0,0,0,0,0,0,0,0,0,2000,2000,0,0
058177,華新科凱基99購02,0,0,0,0,0,0,0,0,0,0,0,0,0,2000,2000,0,0
058199,國巨康和99購01  ,0,0,0,0,0,0,0,0,0,0,0,0,0,200000,200000,0,0
058236,大立光元大99購09,0,0,0,0,0,0,0,0,0,0,0,0,0,50000,50000,0,0
058249,緯穎元大99購04  ,0,0,0,0,0,0,0,0,0,0,0,0,0,9000,9000,0,0
058147,鈺齊元大99購01  ,0,0,0,0,0,0,0,0,0,0,0,0,0,10000,10000,0,0
057301,嘉聯益永豐98購02,0,0,0,0,0,0,0,0,0,0,0,0,0,1000,1000,0,0
057353,玉晶光統一99購01,0,0,0,0,0,0,0,0,0,0,0,0,0,4000,4000,0,0
057489,奇力新元大99購06,0,0,0,0,0,0,0,0,0,0,0,0,0,3000,3000,0,0
057527,億光元大98購01  ,0,0,0,0,0,0,0,0,0,0,0,0,0,20000,20000,0,0
057790,台積電統一99購04,0,0,0,0,0,0,0,0,0,0,0,0,0,2000,2000,0,0
057113,祥碩群益98購01  ,0,0,0,0,0,0,0,0,0,0,0,0,0,2000,2000,0,0
059541,T50正2康和99購01,0,0,0,0,0,0,0,0,0,0,0,0,0,10000,10000,0,0
057131,奇力新凱基98購05,0,0,0,0,0,0,0,0,0,0,0,0,0,1000,1000,0,0
059539,緯穎凱基99購03  ,0,0,0,0,0,0,0,0,0,0,0,0,0,5000,5000,0,0
057267,康控兆豐99購01  ,0,0,0,0,0,0,0,0,0,0,0,0,0,20000,20000,0,0
057234,宏達電凱基98購05,0,0,0,0,0,0,0,0,0,0,0,0,0,10000,10000,0,0
057214,瑞昱群益98購01  ,0,0,0,0,0,0,0,0,0,0,0,0,0,4000,4000,0,0
057170,瑞昱元大98購01  ,0,0,0,0,0,0,0,0,0,0,0,0,0,32000,32000,0,0
057165,國巨元大99購05  ,0,0,0,0,0,0,0,0,0,0,0,0,0,100000,100000,0,0
057139,華新科兆豐98購02,0,0,0,0,0,0,0,0,0,0,0,0,0,10000,10000,0,0
057766,矽力凱基98購03  ,0,0,0,0,0,0,0,0,0,0,0,0,0,10000,10000,0,0
057757,鴻海凱基98購13  ,0,0,0,0,0,0,0,0,0,0,0,0,0,12000,12000,0,0
057760,聯發科凱基98購18,0,0,0,0,0,0,0,0,0,0,0,0,0,1000,1000,0,0
058729,國巨永豐99購03  ,0,0,0,0,0,0,0,0,0,0,0,0,0,189000,189000,0,0
060037,鴻海國票99購10  ,0,0,0,0,0,0,0,0,0,0,0,0,0,1000,1000,0,0
058679,可成日盛99購01  ,0,0,0,0,0,0,0,0,0,0,0,0,0,70000,70000,0,0
05768P,台積電凱基96售15,0,0,0,0,0,0,0,0,0,0,0,0,0,20000,20000,0,0
059787,奇力新元大9A購02,0,0,0,0,0,0,0,0,0,0,0,0,0,4000,4000,0,0
05964P,華通凱基96售06  ,0,0,0,0,0,0,0,0,0,0,0,0,0,10000,10000,0,0
059658,國巨元大9A購03  ,0,0,0,0,0,0,0,0,0,0,0,0,0,16000,16000,0,0
059866,國巨凱基99購18  ,0,0,0,0,0,0,0,0,0,0,0,0,0,107000,107000,0,0
059837,健策國泰9B購01  ,0,0,0,0,0,0,0,0,0,0,0,0,0,48000,48000,0,0
056732,國巨凱基98購07  ,0,0,0,0,0,0,0,0,0,0,0,0,0,71000,71000,0,0
056711,亞光永豐98購01  ,0,0,0,0,0,0,0,0,0,0,0,0,0,4000,4000,0,0
056678,力成元富98購01  ,0,0,0,0,0,0,0,0,0,0,0,0,0,4000,4000,0,0
056682,鴻海統一98購10  ,0,0,0,0,0,0,0,0,0,0,0,0,0,2000,2000,0,0
056676,國產元富98購01  ,0,0,0,0,0,0,0,0,0,0,0,0,0,10000,10000,0,0
056784,南亞科群益98購01,0,0,0,0,0,0,0,0,0,0,0,0,0,9000,9000,0,0
056745,聯茂凱基99購03  ,0,0,0,0,0,0,0,0,0,0,0,0,0,36000,36000,0,0
056752,國巨兆豐98購02  ,0,0,0,0,0,0,0,0,0,0,0,0,0,10000,10000,0,0
056736,國巨凱基99購03  ,0,0,0,0,0,0,0,0,0,0,0,0,0,66000,66000,0,0
056737,國巨凱基9A購01  ,0,0,0,0,0,0,0,0,0,0,0,0,0,55000,55000,0,0
056757,T50反1元大98購07,0,0,0,0,0,0,0,0,0,0,0,0,0,50000,50000,0,0
05685P,臺股指元大96售10,0,0,0,0,0,0,0,0,0,0,0,0,0,28000,28000,0,0
057874,可成元大99購02  ,0,0,0,0,0,0,0,0,0,0,0,0,0,1000,1000,0,0
056836,國巨元富98購01  ,0,0,0,0,0,0,0,0,0,0,0,0,0,500000,500000,0,0
056817,國巨永豐98購04  ,0,0,0,0,0,0,0,0,0,0,0,0,0,105000,105000,0,0
057910,華新科兆豐99購02,0,0,0,0,0,0,0,0,0,0,0,0,0,10000,10000,0,0
057900,南亞科永豐98購01,0,0,0,0,0,0,0,0,0,0,0,0,0,4000,4000,0,0
057948,嘉聯益國票99購02,0,0,0,0,0,0,0,0,0,0,0,0,0,1000,1000,0,0
056882,華邦電康和98購01,0,0,0,0,0,0,0,0,0,0,0,0,0,68000,68000,0,0
056900,可成元大98購02  ,0,0,0,0,0,0,0,0,0,0,0,0,0,57000,57000,0,0
058986,華新科凱基9A購03,0,0,0,0,0,0,0,0,0,0,0,0,0,26000,26000,0,0
058980,鴻海凱基99購06  ,0,0,0,0,0,0,0,0,0,0,0,0,0,20000,20000,0,0
058068,旺宏凱基98購11  ,0,0,0,0,0,0,0,0,0,0,0,0,0,50000,50000,0,0
058070,華新科凱基98購07,0,0,0,0,0,0,0,0,0,0,0,0,0,33000,33000,0,0
058974,臺股指永豐99購03,0,0,0,0,0,0,0,0,0,0,0,0,0,5000,5000,0,0
058044,鴻海元大99購07  ,0,0,0,0,0,0,0,0,0,0,0,0,0,30000,30000,0,0
058018,南亞科凱基99購03,0,0,0,0,0,0,0,0,0,0,0,0,0,8000,8000,0,0
05698P,群創凱基96售01  ,0,0,0,0,0,0,0,0,0,0,0,0,0,1000,1000,0,0
056167,力成台新97購01  ,0,0,0,0,0,0,0,0,0,0,0,0,0,237000,237000,0,0
058967,可成麥證99購01  ,0,0,0,0,7000,-7000,0,0,0,0,0,0,0,7000,7000,0,0
056164,聯茂凱基98購03  ,0,0,0,0,0,0,0,0,0,0,0,0,0,2000,2000,0,0
060313,淘帝永豐9A購01  ,0,0,0,0,0,0,0,0,0,0,0,0,0,40000,40000,0,0
060290,興富發元大9C購01,0,0,0,0,0,0,0,0,0,0,0,0,0,80000,80000,0,0
06201P,可成元大97售01  ,0,0,0,0,0,0,0,0,0,0,0,0,0,10000,10000,0,0
060127,牧德永豐99購02  ,0,0,0,0,0,0,0,0,0,0,0,0,0,4000,4000,0,0
060257,臺股指元大9B購08,0,0,0,0,0,0,0,0,0,0,0,0,0,1000,1000,0,0
060220,華新科凱基9A購08,0,0,0,0,0,0,0,0,0,0,0,0,0,12000,12000,0,0
060454,葡萄王元大9A購01,0,6000,-6000,0,0,0,0,0,0,6000,0,0,0,6000,0,6000,0
060386,台勝科凱基9B購01,0,0,0,0,0,0,0,0,0,0,0,0,0,8000,8000,0,0
060461,鴻海元大9A購09  ,0,0,0,0,0,0,0,0,0,0,0,0,0,33000,33000,0,0
060506,京元電元大9A購02,0,0,0,0,0,0,0,0,0,0,0,0,0,69000,69000,0,0
05994P,奇鋐元大96售02  ,0,0,0,0,0,0,0,0,0,0,0,0,0,26000,26000,0,0
057017,和大凱基98購01  ,0,0,0,0,0,0,0,0,0,0,0,0,0,60000,60000,0,0
057024,義隆凱基99購01  ,0,0,0,0,0,0,0,0,0,0,0,0,0,14000,14000,0,0
060074,台積電元富99購04,0,0,0,0,0,0,0,0,0,0,0,0,0,10000,10000,0,0
060075,台積電元富99購05,0,0,0,0,0,0,0,0,0,0,0,0,0,10000,10000,0,0
06005P,晶豪科永豐96售04,0,0,0,0,0,0,0,0,0,0,0,0,0,10000,10000,0,0
060103,聯詠元大99購01  ,0,0,0,0,0,0,0,0,0,0,0,0,0,20000,20000,0,0
060087,鴻海元大99購43  ,0,0,0,0,0,0,0,0,0,0,0,0,0,42000,42000,0,0
06018P,康控凱基96售03  ,0,0,0,0,0,0,0,0,0,0,0,0,0,5000,5000,0,0
059917,華新科元大99購19,0,0,0,0,0,0,0,0,0,0,0,0,0,10000,10000,0,0
058998,鴻海元大99購22  ,0,0,0,0,0,0,0,0,0,0,0,0,0,30000,30000,0,0
059716,鴻海元大99購35  ,0,0,0,0,0,0,0,0,0,0,0,0,0,4000,4000,0,0
00625K,富邦上証+R      ,0,0,0,0,0,0,0,0,0,0,0,0,0,50000,50000,0,0
00636K,國泰中國A50+U   ,0,0,0,0,0,0,0,0,0,0,0,0,0,100,100,0,0
0054,元大台商50      ,0,0,0,0,0,0,0,0,0,0,0,0,0,1000,1000,0,0
048001,中工元大96購01  ,0,0,0,0,0,0,0,0,0,0,0,0,0,42000,42000,0,0
00657K,國泰日經225+U   ,0,0,0,0,0,0,0,0,0,0,0,0,0,100,100,0,0
00668K,國泰美國道瓊+U  ,0,0,0,0,0,0,0,0,0,0,0,0,0,100,100,0,0
00776,新光ICE美國權值 ,0,0,0,0,0,0,0,0,0,0,0,0,0,2000,2000,0,0
00774B,新光中國政金綠債,0,0,0,0,0,0,0,0,0,0,0,0,0,2000,2000,0,0
00732,國泰RMB短期報酬 ,0,0,0,0,0,0,0,0,0,0,0,0,0,100000,100000,0,0
00707R,元大S&P日圓反1  ,0,0,0,0,0,0,0,0,0,0,0,0,0,104000,104000,0,0
049130,臺指反元大98購01,0,0,0,0,0,0,0,0,0,0,0,0,0,2000,2000,0,0
049220,聯發科國票95購02,0,0,0,0,0,0,0,0,0,0,0,0,0,40000,40000,0,0
03650C,T50反1元大98牛05,0,0,0,0,0,0,0,0,0,0,0,0,0,100000,100000,0,0
04857P,美律元富94售01  ,0,0,0,0,0,0,0,0,0,0,0,0,0,17000,17000,0,0
048575,旺宏國泰94購04  ,0,0,0,0,0,0,0,0,0,0,0,0,0,20000,20000,0,0
048248,聯發科兆豐95購01,0,0,0,0,0,0,0,0,0,0,0,0,0,10000,10000,0,0
048383,元金2X國票99購01,0,0,0,0,0,0,0,0,0,0,0,0,0,10000,10000,0,0
048733,台勝科麥證95購02,0,0,0,10000,10000,0,0,0,0,0,0,0,0,10000,10000,0,0
04867P,美律統一94售03  ,0,0,0,0,0,0,0,0,0,0,0,0,0,10000,10000,0,0
048937,玉晶光永豐95購01,0,0,0,0,0,0,0,0,0,0,0,0,0,4000,4000,0,0
04909P,鴻海統一94售10  ,0,0,0,0,0,0,0,0,0,0,0,0,0,84000,84000,0,0
04365P,台積電元富95售02,0,0,0,0,0,0,0,0,0,0,0,0,0,10000,10000,0,0
045572,元油2X元大98購01,10000,0,10000,0,0,0,0,0,0,-10000,0,0,0,0,10000,-10000,0
046562,大立光凱基95購01,0,0,0,0,0,0,0,0,0,0,0,0,0,30000,30000,0,0
046570,旺宏國泰94購01  ,0,0,0,0,0,0,0,0,0,0,0,0,0,10000,10000,0,0
04700P,臺股指元富94售06,0,0,0,0,0,0,0,0,0,0,0,0,0,192000,192000,0,0
05173P,臺股指元大95售17,0,0,0,0,0,0,0,0,0,0,0,0,0,1000,1000,0,0
047711,華新科凱基94購03,0,0,0,0,0,0,0,0,0,0,0,0,0,10000,10000,0,0
047736,聯發科台新94購01,0,0,0,0,0,0,0,0,0,0,0,0,0,356000,356000,0,0
047768,大立光元大95購01,0,0,0,0,0,0,0,0,0,0,0,0,0,40000,40000,0,0
04753P,台積電統一94售11,0,0,0,0,0,0,0,0,0,0,0,0,0,130000,130000,0,0
047685,嘉聯益國泰95購01,0,0,0,0,0,0,0,0,0,0,0,0,0,18000,18000,0,0
049803,華新科元大95購07,0,0,0,0,0,0,0,0,0,0,0,0,0,35000,35000,0,0
049694,華新科元大95購06,0,0,0,0,0,0,0,0,0,0,0,0,0,20000,20000,0,0
049491,聯發科元大95購01,0,0,0,0,0,0,0,0,0,0,0,0,0,100000,100000,0,0
051362,台郡元大95購04  ,0,0,0,0,0,0,0,0,0,0,0,0,0,4000,4000,0,0
05135P,鴻海凱基96售07  ,0,0,0,0,0,0,0,0,0,0,0,0,0,7000,7000,0,0
051317,亞德客國票96購01,0,0,0,0,0,0,0,0,0,0,0,0,0,30000,30000,0,0
05096P,台積電日盛95售01,0,0,0,0,0,0,0,0,0,0,0,0,0,30000,30000,0,0
051062,超眾群益95購02  ,0,0,0,0,0,0,0,0,0,0,0,0,0,10000,10000,0,0
05106P,鴻海永豐95售02  ,0,0,0,0,0,0,0,0,0,0,0,0,0,4000,4000,0,0
050634,華新科群益96購01,0,0,0,0,0,0,0,0,0,0,0,0,0,10000,10000,0,0
050649,華新科凱基96購01,0,0,0,0,0,0,0,0,0,0,0,0,0,25000,25000,0,0
052133,華邦電凱基9B購01,0,0,0,0,0,0,0,0,0,0,0,0,0,1000,1000,0,0
049897,華新科統一94購07,0,0,0,0,0,0,0,0,0,0,0,0,0,15000,15000,0,0
052185,奇力新群益95購03,0,0,0,0,0,0,0,0,0,0,0,0,0,7000,7000,0,0
049974,聯發科日盛94購02,0,0,0,0,0,0,0,0,0,0,0,0,0,260000,260000,0,0
052312,美律富邦96購02  ,0,0,0,0,0,0,0,0,0,0,0,0,0,200000,200000,0,0
050320,台表科國票94購01,0,0,0,0,0,0,0,0,0,0,0,0,0,50000,50000,0,0
050198,緯穎元大94購09  ,0,0,0,0,0,0,0,0,0,0,0,0,0,10000,10000,0,0
050058,國巨凱基94購06  ,0,0,0,0,0,0,0,0,0,0,0,0,0,30000,30000,0,0
05015P,臺股指元大95售06,0,0,0,0,0,0,0,0,0,0,0,0,0,1000,1000,0,0
050106,台達電元大94購11,0,0,0,0,0,0,0,0,0,0,0,0,0,19000,19000,0,0
05000P,臺股指永豐95售01,0,0,0,0,0,0,0,0,0,0,0,0,0,5000,5000,0,0
050254,大立光富邦96購02,0,0,0,0,0,0,0,0,0,0,0,0,0,60000,60000,0,0
053703,緯穎兆豐96購01  ,0,0,0,0,0,0,0,0,0,0,0,0,0,2000,2000,0,0
053687,智邦元大96購02  ,0,0,0,0,0,0,0,0,0,0,0,0,0,25000,25000,0,0
052508,矽力日盛95購02  ,0,0,0,0,0,0,0,0,0,0,0,0,0,10000,10000,0,0
052548,旺宏亞東96購01  ,0,0,0,0,0,0,0,0,0,0,0,0,0,10000,10000,0,0
052561,矽創國票97購01  ,0,0,0,0,0,0,0,0,0,0,0,0,0,38000,38000,0,0
052470,華新科亞東97購01,0,0,0,0,0,0,0,0,0,0,0,0,0,20000,20000,0,0
05238P,禾伸堂永豐95售01,0,0,0,0,0,0,0,0,0,0,0,0,0,2000,2000,0,0
055217,緯創凱基97購02  ,0,0,0,0,0,0,0,0,0,0,0,0,0,20000,20000,0,0
055229,大毅國票97購02  ,0,0,0,0,0,0,0,0,0,0,0,0,0,3000,3000,0,0
055339,緯穎兆豐98購01  ,0,0,0,0,0,0,0,0,0,0,0,0,0,2000,2000,0,0
055353,華新科凱基98購03,0,0,0,0,0,0,0,0,0,0,0,0,0,13000,13000,0,0
053815,聯發科群益96購01,0,0,0,0,0,0,0,0,0,0,0,0,0,250000,250000,0,0
053905,華新科凱基96購10,0,0,0,0,0,0,0,0,0,0,0,0,0,10000,10000,0,0
053894,創意群益96購01  ,0,0,0,0,0,0,0,0,0,0,0,0,0,1000,1000,0,0
056058,建準元大97購02  ,0,0,0,0,0,0,0,0,0,0,0,0,0,20000,20000,0,0
056100,楠梓電永豐97購02,0,0,0,0,0,0,0,0,0,0,0,0,0,37000,37000,0,0
055926,國巨群益98購06  ,0,0,0,0,0,0,0,0,0,0,0,0,0,106000,106000,0,0
055754,和大兆豐97購01  ,0,0,0,0,0,0,0,0,0,0,0,0,0,10000,10000,0,0
05582P,群創凱基98售06  ,0,0,0,0,0,0,0,0,0,0,0,0,0,8000,8000,0,0
055841,南亞科元大97購04,0,0,0,0,0,0,0,0,0,0,0,0,0,3000,3000,0,0
055672,國巨日盛97購02  ,0,0,0,0,0,0,0,0,0,0,0,0,0,321000,321000,0,0
055704,亞德客永豐97購04,0,0,0,0,0,0,0,0,0,0,0,0,0,8000,8000,0,0
055608,華邦電康和97購01,0,0,0,0,0,0,0,0,0,0,0,0,0,68000,68000,0,0
05409P,京元電元富95售05,0,0,0,0,0,0,0,0,0,0,0,0,0,10000,10000,0,0
055093,京鼎群益98購01  ,0,0,0,0,0,0,0,0,0,0,0,0,0,50000,50000,0,0
055090,國巨群益97購03  ,0,0,0,0,0,0,0,0,0,0,0,0,0,50000,50000,0,0
055017,緯穎元富97購01  ,0,0,0,0,0,0,0,0,0,0,0,0,0,1000,1000,0,0
055019,福懋科元富97購01,0,0,0,0,0,0,0,0,0,0,0,0,0,20000,20000,0,0
059427,國巨元大99購24  ,0,0,0,0,0,0,0,0,0,0,0,0,0,50000,50000,0,0
059434,全新元大99購05  ,0,0,0,0,0,0,0,0,0,0,0,0,0,32000,32000,0,0
059400,滬深2X元富9C購04,0,0,0,0,0,0,0,0,0,0,0,0,0,1000,1000,0,0
058673,華新科群益9A購02,0,0,0,0,0,0,0,0,0,0,0,0,0,19000,19000,0,0
059466,國巨元大99購26  ,0,0,0,0,0,0,0,0,0,0,0,0,0,70000,70000,0,0
059985,華新科元大99購22,0,0,0,0,0,0,0,0,0,0,0,0,0,33000,33000,0,0
057642,南亞科元大98購07,0,0,0,0,0,0,0,0,0,0,0,0,0,2000,2000,0,0
057644,奇力新元大98購04,0,0,0,0,0,0,0,0,0,0,0,0,0,3000,3000,0,0
057561,大立光兆豐98購02,0,0,0,0,0,0,0,0,0,0,0,0,0,10000,10000,0,0
05647P,聯發科國票97售02,0,0,0,0,0,0,0,0,0,0,0,0,0,5000,5000,0,0
056434,國巨凱基98購03  ,0,0,0,0,0,0,0,0,0,0,0,0,0,27000,27000,0,0
056435,台積電凱基98購09,0,0,0,0,0,0,0,0,0,0,0,0,0,6000,6000,0,0
056449,義隆凱基98購03  ,0,0,0,0,0,0,0,0,0,0,0,0,0,17000,17000,0,0
056132,台光電元大97購03,0,0,0,0,0,0,0,0,0,0,0,0,0,100000,100000,0,0
052817,楠梓電永豐96購02,0,0,0,0,0,0,0,0,0,0,0,0,0,43000,43000,0,0
052819,義隆永豐96購01  ,0,0,0,0,0,0,0,0,0,0,0,0,0,11000,11000,0,0
052792,大立光兆豐96購01,0,0,0,0,0,0,0,0,0,0,0,0,0,10000,10000,0,0
052795,健策兆豐97購01  ,0,0,0,0,0,0,0,0,0,0,0,0,0,2000,2000,0,0
055400,緯穎統一97購01  ,0,0,0,0,0,0,0,0,0,0,0,0,0,12000,12000,0,0
052741,聯發科元大96購08,0,0,0,0,0,0,0,0,0,0,0,0,0,30000,30000,0,0
052743,華新科元大97購01,0,0,0,0,0,0,0,0,0,0,0,0,0,4000,4000,0,0
052987,華新科元大99購01,0,0,0,0,0,0,0,0,0,0,0,0,0,81000,81000,0,0
05305P,華新科國泰97售01,0,0,0,0,0,0,0,0,0,0,0,0,0,350000,350000,0,0
053012,國巨統一96購03  ,0,0,0,0,0,0,0,0,0,0,0,0,0,20000,20000,0,0
052930,華新科元大97購03,0,0,0,0,0,0,0,0,0,0,0,0,0,36000,36000,0,0
053935,華通元富96購02  ,0,0,0,0,0,0,0,0,0,0,0,0,0,200000,200000,0,0
053340,建準國票97購01  ,0,0,0,0,0,0,0,0,0,0,0,0,0,23000,23000,0,0
053123,京元電凱基96購01,0,0,0,0,0,0,0,0,0,0,0,0,0,30000,30000,0,0
053224,矽力凱基96購02  ,0,0,0,0,0,0,0,0,0,0,0,0,0,10000,10000,0,0
053226,國巨台新97購02  ,0,0,0,0,0,0,0,0,0,0,0,0,0,44000,44000,0,0
054778,世紀鋼國票99購01,0,0,0,0,0,0,0,0,0,0,0,0,0,15000,15000,0,0
054823,祥碩元大97購02  ,0,0,0,0,0,0,0,0,0,0,0,0,0,20000,20000,0,0
05456P,鴻海凱基95售19  ,0,0,0,0,0,0,0,0,0,0,0,0,0,16000,16000,0,0
054470,緯穎國票97購04  ,0,0,0,0,0,0,0,0,0,0,0,0,0,5000,5000,0,0
054749,聯茂凱基98購01  ,0,0,0,0,0,0,0,0,0,0,0,0,0,4000,4000,0,0
054720,禾伸堂永豐97購01,0,0,0,0,0,0,0,0,0,0,0,0,0,50000,50000,0,0
054696,嘉聯益永豐97購01,0,0,0,0,0,0,0,0,0,0,0,0,0,2000,2000,0,0
054644,A50正2群益9B購01,0,0,0,0,0,0,0,0,0,0,0,0,0,1000,1000,0,0
05467P,聯電元大95售02  ,0,0,0,0,0,0,0,0,0,0,0,0,0,10000,10000,0,0
054420,緯穎元大96購08  ,0,0,0,0,0,0,0,0,0,0,0,0,0,31000,31000,0,0
054390,智邦元富96購03  ,0,0,0,0,0,0,0,0,0,0,0,0,0,50000,50000,0,0
05427P,聯發科凱基96售07,0,0,0,0,0,0,0,0,0,0,0,0,0,6000,6000,0,0
05551P,電子類元大96售01,0,0,0,0,0,0,0,0,0,0,0,0,0,1000,1000,0,0
055469,台光電凱基97購01,0,0,0,0,0,0,0,0,0,0,0,0,0,10000,10000,0,0
054062,TPK國票96購02   ,0,0,0,0,0,0,0,0,0,0,0,0,0,10000,10000,0,0
054004,鴻海統一96購14  ,0,0,0,0,0,0,0,0,0,0,0,0,0,5000,5000,0,0
055456,上銀富邦99購01  ,0,0,0,0,0,0,0,0,0,0,0,0,0,20000,20000,0,0
6431,光麗-KY         ,1000,1000,0,0,0,0,0,0,0,0,0,0,0,0,0,0,0
6573,虹揚-KY         ,1000,1000,0,0,0,0,0,0,0,0,0,0,0,0,0,0,0
6133,金橋            ,1000,0,1000,0,0,0,0,0,0,-1000,0,1000,-1000,0,0,0,0
911616,杜康-DR         ,8000,8000,0,0,0,0,0,0,0,0,0,0,0,0,0,0,0
8463,潤泰材          ,13000,13000,0,0,0,0,0,0,0,0,0,0,0,0,0,0,0
6666,羅麗芬-KY       ,7000,7000,0,0,0,0,0,0,0,0,0,0,0,0,0,0,0
6671,三能-KY         ,2000,2000,0,0,0,0,0,0,0,0,0,0,0,0,0,0,0
8033,雷虎            ,4000,4000,0,0,0,0,0,0,0,0,0,0,0,0,0,0,0
2910,統領            ,1000,1000,0,0,0,0,0,0,0,0,0,0,0,0,0,0,0
3032,偉訓            ,16000,16000,0,0,0,0,0,0,0,0,0,0,0,0,0,0,0
4755,三福化          ,1000,1000,0,0,0,0,0,0,0,0,0,0,0,0,0,0,0
3308,聯德            ,1000,1000,0,0,0,0,0,0,0,0,0,0,0,0,0,0,0
07546P,玉晶光凱基9A售09,0,0,0,0,0,0,0,0,0,0,0,0,0,490000,490000,0,0
1219,福壽            ,3000,0,3000,0,0,0,0,0,0,-3000,0,3000,-3000,0,0,0,0
07327P,台灣50群益9A售06,0,0,0,0,0,0,0,0,0,0,0,0,0,10000,10000,0,0
07506P,中租元大9A售01  ,0,0,0,0,0,0,0,0,0,0,0,0,0,121000,121000,0,0
1541,錩泰            ,1000,1000,0,0,0,0,0,0,0,0,0,0,0,0,0,0,0
1724,台硝            ,2000,1000,1000,0,0,0,0,0,0,-1000,0,1000,-1000,0,0,0,0
2427,三商電          ,2000,2000,0,0,0,0,0,0,0,0,0,0,0,0,0,0,0
2465,麗臺            ,1000,1000,0,0,0,0,0,0,0,0,0,0,0,0,0,0,0
2462,良得電          ,7000,5000,2000,0,0,0,0,0,0,-2000,0,2000,-2000,0,0,0,0
07294P,滬深2X元富9C售08,0,0,0,0,0,0,0,0,0,0,0,0,0,60000,60000,0,0
07295P,滬深2X元富9C售09,0,0,0,0,0,0,0,0,0,0,0,0,0,5000,5000,0,0
07219P,臺股指凱基99售32,0,0,0,0,0,0,0,0,0,0,0,0,0,2000,2000,0,0
07141P,台灣50國票9A售03,0,0,0,0,0,0,0,0,0,0,0,0,0,210000,210000,0,0
07110P,台灣50群益9B售03,0,0,0,0,0,0,0,0,0,0,0,0,0,30000,30000,0,0
07202P,台灣50凱基9C售04,0,0,0,0,0,0,0,0,0,0,0,0,0,400000,400000,0,0
07138P,台灣50群益9B售04,0,0,0,0,0,0,0,0,0,0,0,0,0,129000,129000,0,0
06994P,台光電凱基99售02,0,0,0,0,0,0,0,0,0,0,0,0,0,15000,15000,0,0
07004P,大立光兆豐9A售01,0,0,0,0,0,0,0,0,0,0,0,0,0,10000,10000,0,0
07022P,嘉晶永豐99售02  ,0,0,0,0,0,0,0,0,0,0,0,0,0,20000,20000,0,0
07023P,南電永豐99售02  ,0,0,0,0,0,0,0,0,0,0,0,0,0,2000,2000,0,0
06862P,大立光凱基98售16,0,0,0,0,0,0,0,0,0,0,0,0,0,10000,10000,0,0
06812P,台灣50元富9C售01,0,0,0,0,0,0,0,0,0,0,0,0,0,68000,68000,0,0
06832P,玉晶光凱基98售03,0,0,0,0,0,0,0,0,0,0,0,0,0,10000,10000,0,0
06732P,台灣50日盛9A售01,0,0,0,0,0,0,0,0,0,0,0,0,0,130000,130000,0,0
06396P,新日興康和97售01,0,0,0,0,0,0,0,0,0,0,0,0,0,30000,30000,0,0
06329P,大立光兆豐97售04,0,0,0,0,0,0,0,0,0,0,0,0,0,10000,10000,0,0
06551P,貿聯元大98售05  ,0,0,0,0,0,0,0,0,0,0,0,0,0,5000,5000,0,0
06583P,可成凱基98售07  ,0,0,0,0,0,0,0,0,0,0,0,0,0,2000,2000,0,0
06516P,國巨凱基98售08  ,0,0,0,0,0,0,0,0,0,0,0,0,0,90000,90000,0,0
06617P,智邦元大98售03  ,0,0,0,0,0,0,0,0,0,0,0,0,0,10000,10000,0,0
06697P,台積電國票99售05,0,0,0,0,0,0,0,0,0,0,0,0,0,92000,92000,0,0
06643P,大立光兆豐98售01,0,0,0,0,0,0,0,0,0,0,0,0,0,10000,10000,0,0
060594,國巨麥證9A購01  ,0,0,0,13000,0,13000,0,0,0,0,0,0,0,13000,13000,0,0
060565,大立光富邦01購01,0,0,0,0,0,0,0,0,0,0,0,0,0,30000,30000,0,0
060537,台灣50凱基9B購01,0,0,0,0,0,0,0,0,0,0,0,0,0,50000,50000,0,0
060660,國巨凱基9B購04  ,0,0,0,0,0,0,0,0,0,0,0,0,0,105000,105000,0,0
060661,台積電凱基9A購18,0,0,0,0,0,0,0,0,0,0,0,0,0,1000,1000,0,0
060665,康控凱基9A購01  ,0,0,0,0,0,0,0,0,0,0,0,0,0,10000,10000,0,0
060627,國巨國泰9B購05  ,0,0,0,0,0,0,0,0,0,0,0,0,0,488000,488000,0,0
060682,牧德元大9A購03  ,0,0,0,0,0,0,0,0,0,0,0,0,0,6000,6000,0,0
060712,建準永豐9A購01  ,0,0,0,0,0,0,0,0,0,0,0,0,0,10000,10000,0,0
060721,瑞儀永豐9A購01  ,0,0,0,0,0,0,0,0,0,0,0,0,0,51000,51000,0,0
059001,聯發科元大99購17,0,0,0,0,0,0,0,0,0,-1000,0,0,0,0,1000,-1000,-1000
05902P,華通國票96售02  ,0,0,0,0,0,0,0,0,0,-1000,0,0,0,1000,2000,-1000,-1000
059756,奇力新富邦9C購01,0,0,0,0,0,0,0,0,0,-1000,0,0,0,4000,5000,-1000,-1000
060182,旺宏元富9A購01  ,0,0,0,0,0,0,0,0,0,-1000,0,0,0,0,1000,-1000,-1000
060091,技嘉元大99購03  ,0,0,0,0,0,0,0,0,0,-1000,0,0,0,4000,5000,-1000,-1000
060105,牧德元大9B購01  ,0,0,0,0,0,0,0,0,0,-1000,0,0,0,29000,30000,-1000,-1000
060464,台積電元大9A購11,0,0,0,0,0,0,0,0,0,-1000,0,0,0,0,1000,-1000,-1000
060458,華通元大9A購02  ,0,0,0,0,0,0,0,0,0,-1000,0,0,0,0,1000,-1000,-1000
060344,聯發科統一01購01,0,0,0,0,0,0,0,0,0,-1000,0,0,0,1000,2000,-1000,-1000
060222,貿聯凱基9A購02  ,0,0,0,0,0,0,0,0,0,-1000,0,0,0,34000,35000,-1000,-1000
060223,台灣50元大9A購05,0,0,0,0,0,0,0,0,0,-1000,0,0,0,0,1000,-1000,-1000
060251,易華電元大9C購01,0,0,0,0,0,0,0,0,0,-1000,0,0,0,0,1000,-1000,-1000
060123,光罩永豐99購02  ,0,0,0,0,0,0,0,0,0,-1000,0,0,0,6000,7000,-1000,-1000
060135,台灣50國票9C購02,0,0,0,0,0,0,0,0,0,-1000,0,0,0,0,1000,-1000,-1000
060326,群光群益9A購01  ,0,0,0,0,0,0,0,0,0,-1000,0,0,0,0,1000,-1000,-1000
056994,緯穎兆豐98購02  ,0,0,0,0,0,0,0,0,0,-1000,0,0,0,0,1000,-1000,-1000
056375,玉晶光統一01購01,0,0,0,0,0,0,0,0,0,-1000,0,0,0,0,1000,-1000,-1000
057929,上銀群益98購02  ,0,0,0,0,0,0,0,0,0,-1000,0,0,0,0,1000,-1000,-1000
059836,大立光國泰9B購02,0,0,0,0,0,0,0,0,0,-1000,0,0,0,18000,19000,-1000,-1000
059873,華新科凱基99購09,0,0,0,0,0,0,0,0,0,-1000,0,0,0,0,1000,-1000,-1000
059657,華通元大99購09  ,0,0,0,0,0,0,0,0,0,-1000,0,0,0,0,1000,-1000,-1000
059801,T50反1元富99購10,0,0,0,0,0,0,0,0,0,-1000,0,0,0,0,1000,-1000,-1000
060011,臺股指群益9C購06,0,1000,-1000,0,0,0,0,0,0,0,0,0,0,1000,1000,0,-1000
058722,台郡元富99購01  ,0,0,0,0,0,0,0,0,0,-1000,0,0,0,0,1000,-1000,-1000
057158,義隆永豐99購01  ,0,0,0,0,0,0,0,0,0,-1000,0,0,0,0,1000,-1000,-1000
05747P,漢唐群益96售03  ,0,0,0,0,0,0,0,0,0,-1000,0,0,0,0,1000,-1000,-1000
057313,聯發科麥證99購01,0,0,0,0,1000,-1000,0,0,0,-1000,0,0,0,0,1000,-1000,-1000
058213,欣興群益99購01  ,0,0,0,0,0,0,0,0,0,-1000,0,0,0,0,1000,-1000,-1000
059195,國巨永豐99購04  ,0,0,0,0,0,0,0,0,0,-1000,0,0,0,136000,137000,-1000,-1000
059132,臺股指群益99購07,0,0,0,0,0,0,0,0,0,-1000,0,0,0,4000,5000,-1000,-1000
059394,臺股指凱基99購40,0,0,0,0,0,0,0,0,0,-1000,0,0,0,15000,16000,-1000,-1000
059288,旺宏元富99購03  ,0,0,0,0,0,0,0,0,0,-1000,0,0,0,0,1000,-1000,-1000
059267,群創中信01購02  ,0,0,0,0,0,0,0,0,0,-1000,0,0,0,0,1000,-1000,-1000
059247,可成凱基99購05  ,0,0,0,0,0,0,0,0,0,-1000,0,0,0,33000,34000,-1000,-1000
059608,聯發科富邦9B購04,0,0,0,0,0,0,0,0,0,-1000,0,0,0,0,1000,-1000,-1000
058791,鴻海元大99購17  ,0,0,0,0,0,0,0,0,0,-1000,0,0,0,0,1000,-1000,-1000
058413,義隆兆豐99購01  ,0,0,0,0,0,0,0,0,0,-1000,0,0,0,0,1000,-1000,-1000
05843P,台積電元大96售16,0,0,0,0,0,0,0,0,0,-1000,0,0,0,0,1000,-1000,-1000
058567,華新科凱基9A購02,0,0,0,0,0,0,0,0,0,-1000,0,0,0,0,1000,-1000,-1000
054066,緯穎國票97購03  ,0,0,0,0,0,0,0,0,0,-1000,0,0,0,3000,4000,-1000,-1000
054925,神達凱基97購01  ,0,0,0,0,0,0,0,0,0,-1000,0,0,0,0,1000,-1000,-1000
053111,緯創兆豐97購01  ,0,0,0,0,0,0,0,0,0,-1000,0,0,0,0,1000,-1000,-1000
053940,康友元富96購01  ,0,0,0,0,0,0,0,0,0,-1000,0,0,0,0,1000,-1000,-1000
052777,燿華國票98購01  ,0,0,0,0,0,0,0,0,0,-1000,0,0,0,1000,2000,-1000,-1000
056120,聯茂群益97購02  ,0,0,0,0,0,0,0,0,0,-1000,0,0,0,14000,15000,-1000,-1000
056422,全新統一98購02  ,0,0,0,0,0,0,0,0,0,-1000,0,0,0,0,1000,-1000,-1000
058671,旺宏群益9A購01  ,0,0,0,0,0,0,0,0,0,-1000,0,0,0,1000,2000,-1000,-1000
055044,信錦永豐97購01  ,0,0,0,0,0,0,0,0,0,-1000,0,0,0,0,1000,-1000,-1000
055659,百和元富97購01  ,0,0,0,0,0,0,0,0,0,-1000,0,0,0,0,1000,-1000,-1000
055618,麗豐國票98購01  ,0,0,0,0,0,0,0,0,0,-1000,0,0,0,0,1000,-1000,-1000
055802,新日興永豐97購01,0,0,0,0,0,0,0,0,0,-1000,0,0,0,0,1000,-1000,-1000
056026,智易群益97購01  ,0,0,0,0,0,0,0,0,0,-1000,0,0,0,0,1000,-1000,-1000
056049,奇力新國票98購01,0,0,0,0,0,0,0,0,0,-1000,0,0,0,0,1000,-1000,-1000
053895,智易群益96購02  ,0,0,0,0,0,0,0,0,0,-1000,0,0,0,0,1000,-1000,-1000
055299,康友元大97購02  ,0,0,0,0,0,0,0,0,0,-1000,0,0,0,0,1000,-1000,-1000
05519P,上証2X凱基98售01,0,0,0,0,0,0,0,0,0,-1000,0,0,0,0,1000,-1000,-1000
053742,創意國票97購01  ,0,0,0,0,0,0,0,0,0,-1000,0,0,0,6000,7000,-1000,-1000
051606,華新科群益95購05,0,0,0,0,0,0,0,0,0,-1000,0,0,0,0,1000,-1000,-1000
051624,智邦麥證95購02  ,0,0,0,0,1000,-1000,0,0,0,-1000,0,0,0,0,1000,-1000,-1000
051558,元金2X國泰97購01,0,0,0,0,0,0,0,0,0,-1000,0,0,0,0,1000,-1000,-1000
051545,裕隆康和95購01  ,0,0,0,0,0,0,0,0,0,-1000,0,0,0,0,1000,-1000,-1000
053718,全新凱基97購02  ,0,0,0,0,0,0,0,0,0,-1000,0,0,0,0,1000,-1000,-1000
052272,T50反1群益95購03,0,0,0,0,0,0,0,0,0,-1000,0,0,0,29000,30000,-1000,-1000
05067P,欣興兆豐96售02  ,0,0,0,0,0,0,0,0,0,-1000,0,0,0,0,1000,-1000,-1000
050725,光磊國票96購01  ,0,0,0,0,0,0,0,0,0,-1000,0,0,0,0,1000,-1000,-1000
05141P,華通台新96售01  ,0,0,0,0,0,0,0,0,0,-1000,0,0,0,0,1000,-1000,-1000
05267P,欣興元大95售08  ,0,0,0,0,0,0,0,0,0,-1000,0,0,0,0,1000,-1000,-1000
052664,麗豐國票96購02  ,0,0,0,0,0,0,0,0,0,-1000,0,0,0,1000,2000,-1000,-1000
052115,T50反1國票95購03,0,0,0,0,0,0,0,0,0,-1000,0,0,0,0,1000,-1000,-1000
052094,瀚宇博元大96購02,0,0,0,0,0,0,0,0,0,-1000,0,0,0,36000,37000,-1000,-1000
049675,台光電國票95購01,0,0,0,0,0,0,0,0,0,-1000,0,0,0,38000,39000,-1000,-1000
049685,T50反1元大94購01,0,0,0,0,0,0,0,0,0,-1000,0,0,0,0,1000,-1000,-1000
049686,T50反1元大94購02,0,0,0,0,0,0,0,0,0,-1000,0,0,0,0,1000,-1000,-1000
049260,華新科元大96購01,0,0,0,0,0,0,0,0,0,-1000,0,0,0,0,1000,-1000,-1000
045759,T50反1統一94購02,0,0,0,0,0,0,0,0,0,-1000,0,0,0,0,1000,-1000,-1000
04249P,大立光統一94售04,0,0,0,0,0,0,0,0,0,-1000,0,0,0,0,1000,-1000,-1000
04910P,台積電統一94售12,0,0,0,0,0,0,0,0,0,-1000,0,0,0,0,1000,-1000,-1000
04906P,欣興國票95售01  ,0,0,0,0,0,0,0,0,0,-1000,0,0,0,0,1000,-1000,-1000
048589,國巨兆豐96購01  ,0,0,0,0,0,0,0,0,0,-1000,0,0,0,9000,10000,-1000,-1000
04839P,大立光元大94售17,0,0,0,0,0,0,0,0,0,-1000,0,0,0,10000,11000,-1000,-1000
03619C,臺股指元大95牛02,0,0,0,0,0,0,0,0,0,-1000,0,0,0,1000,2000,-1000,-1000
039212,台達電台新9A購01,0,0,0,0,0,0,0,0,0,-1000,0,0,0,0,1000,-1000,-1000
00709,富邦歐洲        ,0,0,0,0,0,0,0,0,0,-1000,0,0,0,100000,101000,-1000,-1000
00688L,國泰20年美債正2 ,0,0,0,0,0,0,0,0,0,-1000,0,0,0,100000,101000,-1000,-1000
03006X,元展06          ,0,0,0,0,0,0,0,0,0,-1000,0,0,0,0,1000,-1000,-1000
00666R,富邦恒生國企反1 ,0,0,0,0,0,0,0,0,0,-1000,0,0,0,0,1000,-1000,-1000
060701,玉晶光國泰9C購01,0,0,0,0,0,0,0,0,0,-1000,0,0,0,0,1000,-1000,-1000
060671,亞德客元大9A購03,0,0,0,0,0,0,0,0,0,-1000,0,0,0,0,1000,-1000,-1000
060620,玉晶光元大9A購04,0,0,0,0,0,0,0,0,0,-1000,0,0,0,0,1000,-1000,-1000
060647,T50反1第一9A購01,0,0,0,0,0,0,0,0,0,-1000,0,0,0,0,1000,-1000,-1000
060649,國巨第一9A購01  ,0,0,0,0,0,0,0,0,0,-1000,0,0,0,0,1000,-1000,-1000
060549,聯發科凱基9B購03,0,0,0,0,0,0,0,0,0,-1000,0,0,0,0,1000,-1000,-1000
060523,鴻海中信9C購03  ,0,0,0,0,0,0,0,0,0,-1000,0,0,0,0,1000,-1000,-1000
060515,臺股指元大9B購12,0,0,0,0,0,0,0,0,0,-1000,0,0,0,0,1000,-1000,-1000
060600,台積電凱基9C購01,0,0,0,0,0,0,0,0,0,-1000,0,0,0,0,1000,-1000,-1000
06656P,GIS元大98售02   ,0,0,0,0,0,0,0,0,0,-1000,0,0,0,32000,33000,-1000,-1000
06549P,大立光元大98售11,0,0,0,0,0,0,0,0,0,-1000,0,0,0,0,1000,-1000,-1000
06299P,可成元大97售04  ,0,0,0,0,0,0,0,0,0,-1000,0,0,0,10000,11000,-1000,-1000
06844P,智邦元大98售13  ,0,0,0,0,0,0,0,0,0,-1000,0,0,0,0,1000,-1000,-1000
06973P,臺股指元大9A售11,0,0,0,0,0,0,0,0,0,-1000,0,0,0,0,1000,-1000,-1000
07192P,聯發科元大99售23,0,0,0,0,0,0,0,0,0,-1000,0,0,0,2000,3000,-1000,-1000
07123P,鴻海元大99售23  ,0,0,0,0,0,0,0,0,0,-1000,0,0,0,0,1000,-1000,-1000
07278P,台灣50元富9C售03,0,0,0,0,0,0,0,0,0,-1000,0,0,0,0,1000,-1000,-1000
07305P,T50正2群益99售02,0,0,0,0,0,0,0,0,0,-1000,0,0,0,0,1000,-1000,-1000
1726,永記            ,2000,3000,-1000,0,0,0,0,0,0,0,0,0,0,0,0,0,-1000
1903,士紙            ,0,1000,-1000,0,0,0,0,0,0,0,0,0,0,0,0,0,-1000
2024,志聯            ,0,0,0,0,0,0,0,0,0,-1000,0,1000,-1000,0,0,0,-1000
1468,昶和            ,1000,2000,-1000,0,0,0,0,0,0,0,0,0,0,0,0,0,-1000
1516,川飛            ,2000,3000,-1000,0,0,0,0,0,0,0,0,0,0,0,0,0,-1000
1540,喬福            ,5000,5000,0,0,0,0,0,0,0,-1000,0,1000,-1000,0,0,0,-1000
07497P,鴻海元大9A售06  ,0,0,0,0,0,0,0,0,0,-1000,0,0,0,0,1000,-1000,-1000
07495P,鴻海元大9A售04  ,0,0,0,0,0,0,0,0,0,-1000,0,0,0,0,1000,-1000,-1000
07450P,鴻海元大9A售03  ,0,0,0,0,0,0,0,0,0,-1000,0,0,0,0,1000,-1000,-1000
07340P,鴻海凱基99售15  ,0,0,0,0,0,0,0,0,0,-1000,0,0,0,1000,2000,-1000,-1000
07562P,台灣50第一9A售01,0,0,0,0,0,0,0,0,0,-1000,0,0,0,0,1000,-1000,-1000
07533P,臺股指中信9C售04,0,0,0,0,0,0,0,0,0,-1000,0,0,0,0,1000,-1000,-1000
07522P,台積電中信9A售03,0,0,0,0,0,0,0,0,0,-1000,0,0,0,16000,17000,-1000,-1000
1235,興泰            ,0,1000,-1000,0,0,0,0,0,0,0,0,0,0,0,0,0,-1000
1443,立益            ,0,1000,-1000,0,0,0,0,0,0,0,0,0,0,0,0,0,-1000
1432,大魯閣          ,0,1000,-1000,0,0,0,0,0,0,0,0,0,0,0,0,0,-1000
3432,台端            ,1000,1000,0,0,0,0,0,0,0,-1000,0,1000,-1000,0,0,0,-1000
3054,立萬利          ,0,1000,-1000,0,0,0,0,0,0,0,0,0,0,0,0,0,-1000
6674,鋐寶科技        ,1000,2000,-1000,0,0,0,0,0,0,0,0,0,0,0,0,0,-1000
8442,威宏-KY         ,0,1000,-1000,0,0,0,0,0,0,0,0,0,0,0,0,0,-1000
9906,欣巴巴          ,0,1000,-1000,0,0,0,0,0,0,0,0,0,0,0,0,0,-1000
6117,迎廣            ,0,1000,-1000,0,0,0,0,0,0,0,0,0,0,0,0,0,-1000
058478,聯發科凱基9A購01,0,0,0,0,0,0,0,0,0,-2000,0,0,0,0,2000,-2000,-2000
058408,華通兆豐99購02  ,0,0,0,0,0,0,0,0,0,-2000,0,0,0,0,2000,-2000,-2000
058326,祥碩台新99購01  ,0,0,0,0,0,0,0,0,0,-2000,0,0,0,0,2000,-2000,-2000
059577,旺宏元富99購04  ,0,0,0,0,0,0,0,0,0,-2000,0,0,0,0,2000,-2000,-2000
059252,聯詠凱基99購03  ,0,0,0,0,0,0,0,0,0,-2000,0,0,0,5000,7000,-2000,-2000
059225,臺股指元大99購18,0,0,0,0,0,0,0,0,0,-2000,0,0,0,0,2000,-2000,-2000
058232,聯發科元大99購05,0,0,0,0,0,0,0,0,0,-2000,0,0,0,0,2000,-2000,-2000
058310,大立光元大99購10,0,0,0,0,0,0,0,0,0,-2000,0,0,0,0,2000,-2000,-2000
058283,世紀鋼中信99購01,0,0,0,0,0,0,0,0,0,-2000,0,0,0,526000,528000,-2000,-2000
057363,華通元大99購02  ,0,0,0,0,0,0,0,0,0,-2000,0,0,0,0,2000,-2000,-2000
05752P,台積電中信96售06,0,0,0,0,0,0,0,0,0,-2000,0,0,0,10000,12000,-2000,-2000
058759,義隆群益99購01  ,0,0,0,0,0,0,0,0,0,-2000,0,0,0,1000,3000,-2000,-2000
058746,華通凱基9A購02  ,0,0,0,0,0,0,0,0,0,-2000,0,0,0,13000,15000,-2000,-2000
057933,聯發科群益98購06,0,0,0,0,0,0,0,0,0,-2000,0,0,0,0,2000,-2000,-2000
056863,義隆群益98購01  ,0,0,0,0,0,0,0,0,0,-2000,0,0,0,0,2000,-2000,-2000
056719,台虹永豐98購01  ,0,0,0,0,0,0,0,0,0,-2000,0,0,0,0,2000,-2000,-2000
056365,欣興元大98購01  ,0,0,0,0,0,0,0,0,0,-2000,0,0,0,17000,19000,-2000,-2000
058927,勤誠元富99購02  ,0,0,0,0,0,0,0,0,0,-2000,0,0,0,0,2000,-2000,-2000
058906,晶相光元大99購01,0,0,0,0,0,0,0,0,0,-2000,0,0,0,0,2000,-2000,-2000
06053P,緯穎國票97售05  ,0,0,0,0,0,0,0,0,0,-2000,0,0,0,0,2000,-2000,-2000
060051,台積電凱基9B購01,0,0,0,0,0,0,0,0,0,-2000,0,0,0,17000,19000,-2000,-2000
05990P,台積電群益96售13,0,0,0,0,0,0,0,0,0,-2000,0,0,0,0,2000,-2000,-2000
059911,國巨元大99購27  ,0,0,0,0,0,0,0,0,0,-2000,0,0,0,474000,476000,-2000,-2000
0057,富邦摩台        ,0,0,0,0,0,0,0,0,0,-2000,0,0,0,21000,23000,-2000,-2000
006203,元大MSCI台灣    ,1000,0,1000,0,0,0,0,0,0,-3000,0,0,0,116000,119000,-3000,-2000
03009X,元展09          ,0,0,0,0,0,0,0,0,0,-2000,0,0,0,0,2000,-2000,-2000
03039X,元展36          ,0,0,0,0,0,0,0,0,0,-2000,0,0,0,0,2000,-2000,-2000
03052X,元展49          ,0,0,0,0,0,0,0,0,0,-2000,0,0,0,0,2000,-2000,-2000
03094X,大立光元大68展08,0,0,0,0,0,0,0,0,0,-2000,0,0,0,0,2000,-2000,-2000
03430B,臺股指元大9B熊01,0,0,0,0,0,0,0,0,0,-2000,0,0,0,0,2000,-2000,-2000
048535,超眾國票94購02  ,0,0,0,0,0,0,0,0,0,-2000,0,0,0,0,2000,-2000,-2000
048847,A50群益98購01   ,0,0,0,0,0,0,0,0,0,-2000,0,0,0,0,2000,-2000,-2000
04617P,臺股指群益95售03,0,0,0,0,0,0,0,0,0,-2000,0,0,0,1000,3000,-2000,-2000
05075P,台積電麥證95售01,0,0,0,0,2000,-2000,0,0,0,-2000,0,0,0,0,2000,-2000,-2000
052246,超眾康和95購01  ,0,0,0,0,0,0,0,0,0,-2000,0,0,0,218000,220000,-2000,-2000
052210,華夏元大95購01  ,0,0,0,0,0,0,0,0,0,-2000,0,0,0,0,2000,-2000,-2000
053653,京元電凱基96購02,0,0,0,0,0,0,0,0,0,-2000,0,0,0,0,2000,-2000,-2000
053523,T50反1中信9A購01,0,0,0,0,0,0,0,0,0,-2000,0,0,0,0,2000,-2000,-2000
053541,泰鼎永豐96購02  ,0,0,0,0,0,0,0,0,0,-2000,0,0,0,10000,12000,-2000,-2000
055304,瑞昱第一98購01  ,0,0,0,0,0,0,0,0,0,-2000,0,0,0,0,2000,-2000,-2000
055305,旺宏群益99購01  ,0,0,0,0,0,0,0,0,0,-2000,0,0,0,0,2000,-2000,-2000
056085,聯發科統一97購01,0,0,0,0,0,0,0,0,0,-2000,0,0,0,0,2000,-2000,-2000
055947,元油反元大98購03,0,0,0,0,0,0,0,0,0,-2000,0,0,0,1000,3000,-2000,-2000
055788,緯穎凱基97購04  ,0,0,0,0,0,0,0,0,0,-2000,0,0,0,0,2000,-2000,-2000
055773,瑞昱凱基97購03  ,0,0,0,0,0,0,0,0,0,-2000,0,0,0,0,2000,-2000,-2000
05579P,友達凱基98售03  ,0,0,0,0,0,0,0,0,0,-2000,0,0,0,0,2000,-2000,-2000
055604,訊芯元大98購02  ,0,0,0,0,0,0,0,0,0,-2000,0,0,0,0,2000,-2000,-2000
054216,聯茂國票97購03  ,0,0,0,0,0,0,0,0,0,-2000,0,0,0,0,2000,-2000,-2000
054210,台光電國票97購03,0,0,0,0,0,0,0,0,0,-2000,0,0,0,9000,11000,-2000,-2000
054111,緯穎凱基97購01  ,0,0,0,0,0,0,0,0,0,-2000,0,0,0,7000,9000,-2000,-2000
058654,鴻海中信03購01  ,0,0,0,0,0,0,0,0,0,-2000,0,0,0,0,2000,-2000,-2000
059410,滬深2X國票9A購04,0,0,0,0,0,0,0,0,0,-2000,0,0,0,0,2000,-2000,-2000
059470,華新科元大99購16,0,0,0,0,0,0,0,0,0,-2000,0,0,0,12000,14000,-2000,-2000
057574,中磊永豐98購01  ,0,0,0,0,0,0,0,0,0,-2000,0,0,0,0,2000,-2000,-2000
052712,旺宏凱基96購02  ,0,0,0,0,0,0,0,0,0,-2000,0,0,0,0,2000,-2000,-2000
055432,臻鼎群益97購02  ,0,0,0,0,0,0,0,0,0,-2000,0,0,0,0,2000,-2000,-2000
053952,南亞科台新96購01,0,0,0,0,0,0,0,0,0,-2000,0,0,0,0,2000,-2000,-2000
053447,京鼎凱基96購03  ,0,0,0,0,0,0,0,0,0,-2000,0,0,0,0,2000,-2000,-2000
05454P,奇鋐群益95售04  ,0,0,0,0,0,0,0,0,0,-2000,0,0,0,0,2000,-2000,-2000
055472,大立光凱基97購07,0,0,0,0,0,0,0,0,0,-2000,0,0,0,0,2000,-2000,-2000
8940,新天地          ,0,2000,-2000,0,0,0,0,0,0,0,0,0,0,0,0,0,-2000
8497,格威傳媒        ,2000,4000,-2000,0,0,0,0,0,0,0,0,0,0,0,0,0,-2000
3501,維熹            ,23000,21000,2000,0,0,0,0,0,0,-4000,0,4000,-4000,0,0,0,-2000
3593,力銘            ,0,2000,-2000,0,0,0,0,0,0,0,0,0,0,0,0,0,-2000
1423,利華            ,2000,4000,-2000,0,0,0,0,0,0,0,0,0,0,0,0,0,-2000
1438,裕豐            ,1000,3000,-2000,0,0,0,0,0,0,0,0,0,0,0,0,0,-2000
1452,宏益            ,30000,32000,-2000,0,0,0,0,0,0,0,0,0,0,0,0,0,-2000
1453,大將            ,4000,2000,2000,0,0,0,0,0,0,-4000,0,4000,-4000,0,0,0,-2000
1236,宏亞            ,5000,7000,-2000,0,0,0,0,0,0,0,0,0,0,0,0,0,-2000
1410,南染            ,3000,5000,-2000,0,0,0,0,0,0,0,0,0,0,0,0,0,-2000
08818P,台灣50凱基01售18,0,0,0,0,0,0,0,0,0,-2000,0,0,0,0,2000,-2000,-2000
07338P,滬深2X凱基99售02,0,0,0,0,0,0,0,0,0,-2000,0,0,0,0,2000,-2000,-2000
07357P,鴻海元大99售38  ,0,0,0,0,0,0,0,0,0,-2000,0,0,0,0,2000,-2000,-2000
07374P,鴻海元大99售41  ,0,0,0,0,0,0,0,0,0,-2000,0,0,0,0,2000,-2000,-2000
1713,國化            ,1000,3000,-2000,0,0,0,0,0,0,0,1000,1000,0,0,0,0,-2000
1617,榮星            ,0,2000,-2000,0,0,0,0,0,0,0,0,0,0,0,0,0,-2000
1533,車王電          ,2000,4000,-2000,0,0,0,0,0,0,0,0,0,0,0,0,0,-2000
1527,鑽全            ,30000,30000,0,0,0,0,0,0,0,-2000,0,2000,-2000,0,0,0,-2000
1529,樂士            ,2000,4000,-2000,0,0,0,0,0,0,0,0,0,0,0,0,0,-2000
2008,高興昌          ,0,2000,-2000,0,0,0,0,0,0,0,0,0,0,0,0,0,-2000
2028,威致            ,0,2000,-2000,0,0,0,0,0,0,0,0,0,0,0,0,0,-2000
2443,億麗            ,0,2000,-2000,0,0,0,0,0,0,0,0,0,0,0,0,0,-2000
2243,宏旭-KY         ,2000,4000,-2000,0,0,0,0,0,0,0,0,0,0,0,0,0,-2000
07322P,鴻海元大99售33  ,0,0,0,0,0,0,0,0,0,-2000,0,0,0,0,2000,-2000,-2000
07307P,上証2X凱基9A售02,0,0,0,0,0,0,0,0,0,-2000,0,0,0,0,2000,-2000,-2000
07313P,台灣50元大99售11,0,0,0,0,0,0,0,0,0,-2000,0,0,0,0,2000,-2000,-2000
07281P,鴻海凱基99售13  ,0,0,0,0,0,0,0,0,0,-2000,0,0,0,20000,22000,-2000,-2000
07258P,台灣50台新9A售01,0,0,0,0,0,0,0,0,0,-2000,0,0,0,0,2000,-2000,-2000
07243P,台灣50凱基9A售04,0,0,0,0,0,0,0,0,0,-2000,0,0,0,6000,8000,-2000,-2000
07119P,台積電凱基9A售08,0,0,0,0,0,0,0,0,0,-2000,0,0,0,0,2000,-2000,-2000
07201P,臺股指元大99售17,0,0,0,0,0,0,0,0,0,-2000,0,0,0,0,2000,-2000,-2000
06936P,瑞儀元大98售01  ,0,0,0,0,0,0,0,0,0,-2000,0,0,0,0,2000,-2000,-2000
07012P,智邦群益9A售01  ,0,0,0,0,0,0,0,0,0,-2000,0,0,0,0,2000,-2000,-2000
06084P,宏達電元富97售02,0,0,0,0,0,0,0,0,0,-2000,0,0,0,0,2000,-2000,-2000
06556P,臺股指元大99售08,0,0,0,0,0,0,0,0,0,-2000,0,0,0,0,2000,-2000,-2000
06500P,臺股指元大9A售05,0,0,0,0,0,0,0,0,0,-2000,0,0,0,0,2000,-2000,-2000
06466P,台積電統一9B售01,0,0,0,0,0,0,0,0,0,-2000,0,0,0,0,2000,-2000,-2000
06599P,宏達電永豐98售02,0,0,0,0,0,0,0,0,0,-2000,0,0,0,0,2000,-2000,-2000
06592P,欣興元大98售04  ,0,0,0,0,0,0,0,0,0,-2000,0,0,0,10000,12000,-2000,-2000
060578,臺股指中信9C購03,0,0,0,0,0,0,0,0,0,-2000,0,0,0,0,2000,-2000,-2000
060541,正隆凱基9A購01  ,0,0,0,0,0,0,0,0,0,-2000,0,0,0,0,2000,-2000,-2000
060686,康友元大9A購02  ,0,0,0,0,0,0,0,0,0,-2000,0,0,0,0,2000,-2000,-2000
060702,玉晶光國泰9C購02,0,0,0,0,0,0,0,0,0,-2000,0,0,0,0,2000,-2000,-2000
060716,新唐永豐9A購01  ,0,0,0,0,0,0,0,0,0,-2000,0,0,0,0,2000,-2000,-2000
00752,中信中國50      ,0,1000,-1000,0,0,0,0,0,0,-1685,0,0,0,2000,3685,-1685,-2685
058972,新日興永豐9A購01,4000,0,4000,0,0,0,0,0,0,-7000,0,0,0,0,7000,-7000,-3000
060163,健策永豐9B購01  ,0,0,0,0,0,0,0,0,0,-3000,0,0,0,266000,269000,-3000,-3000
060044,大立光群益99購09,0,0,0,0,0,0,0,0,0,-3000,0,0,0,0,3000,-3000,-3000
060247,牧德元大9A購02  ,0,0,0,0,0,0,0,0,0,-3000,0,0,0,70000,73000,-3000,-3000
060332,聯發科麥證9A購01,0,0,0,0,3000,-3000,0,0,0,-3000,0,0,0,0,3000,-3000,-3000
060373,元金2X元富9A購01,0,0,0,0,0,0,0,0,0,-3000,0,0,0,13000,16000,-3000,-3000
060499,鴻海元大9A購11  ,0,0,0,0,0,0,0,0,0,-3000,0,0,0,0,3000,-3000,-3000
058916,SGBR2X元富99購02,0,0,0,0,0,0,0,0,0,-3000,0,0,0,21000,24000,-3000,-3000
058951,南電群益99購01  ,0,0,0,0,0,0,0,0,0,-3000,0,0,0,45000,48000,-3000,-3000
056689,玉晶光統一9A購03,0,0,0,0,0,0,0,0,0,-3000,0,0,0,46000,49000,-3000,-3000
059493,國巨國票9B購01  ,0,0,0,0,0,0,0,0,0,-3000,0,0,0,2000,5000,-3000,-3000
059525,上銀凱基99購08  ,0,0,0,0,0,0,0,0,0,-3000,0,0,0,17000,20000,-3000,-3000
057503,世紀鋼群益98購02,0,0,0,0,0,0,0,0,0,-3000,0,0,0,0,3000,-3000,-3000
058258,世芯國泰9A購01  ,0,0,0,0,0,0,0,0,0,-3000,0,0,0,213000,216000,-3000,-3000
058127,FBVIX元大9C購01 ,0,0,0,0,0,0,0,0,0,-3000,0,0,0,0,3000,-3000,-3000
057832,聯發科元富02購05,0,0,0,0,0,0,0,0,0,-3000,0,0,0,3000,6000,-3000,-3000
059324,智易元大99購04  ,0,0,0,0,0,0,0,0,0,-3000,0,0,0,69000,72000,-3000,-3000
059638,大立光凱基99購11,0,0,0,0,0,0,0,0,0,-3000,0,0,0,0,3000,-3000,-3000
059353,滬深2X富邦9A購02,0,0,0,0,0,0,0,0,0,-3000,0,0,0,0,3000,-3000,-3000
058473,上銀凱基9A購03  ,0,0,0,0,0,0,0,0,0,-3000,0,0,0,3000,6000,-3000,-3000
056534,京元電凱基98購01,0,0,0,0,0,0,0,0,0,-3000,0,0,0,20000,23000,-3000,-3000
006204,永豐臺灣加權    ,0,0,0,0,0,0,0,0,0,-3000,0,0,0,0,3000,-3000,-3000
052034,臺股指群益95購07,0,0,0,0,0,0,0,0,0,-3000,0,0,0,0,3000,-3000,-3000
049611,緯穎兆豐95購02  ,0,0,0,0,0,0,0,0,0,-3000,0,0,0,0,3000,-3000,-3000
053749,揚明光永豐97購01,0,0,0,0,0,0,0,0,0,-3000,0,0,0,0,3000,-3000,-3000
051489,世芯凱基95購01  ,0,0,0,0,0,0,0,0,0,-3000,0,0,0,15000,18000,-3000,-3000
054393,漢唐永豐96購01  ,0,0,0,0,0,0,0,0,0,-3000,0,0,0,0,3000,-3000,-3000
054471,T50反1中信9C購01,0,0,0,0,0,0,0,0,0,-3000,0,0,0,5000,8000,-3000,-3000
054669,凌華元富97購01  ,0,0,0,0,0,0,0,0,0,-3000,0,0,0,0,3000,-3000,-3000
053281,茂林元大96購02  ,0,0,0,0,0,0,0,0,0,-3000,0,0,0,68000,71000,-3000,-3000
052972,義隆群益96購04  ,0,0,0,0,0,0,0,0,0,-3000,0,0,0,2000,5000,-3000,-3000
058606,聯發科元大99購13,0,0,0,0,0,0,0,0,0,-3000,0,0,0,0,3000,-3000,-3000
059454,亞光永豐99購01  ,0,0,0,0,0,0,0,0,0,-3000,0,0,0,25000,28000,-3000,-3000
054180,亞泥康和96購01  ,0,0,0,0,0,0,0,0,0,-3000,0,0,0,65000,68000,-3000,-3000
055804,祥碩永豐97購02  ,0,0,0,0,0,0,0,0,0,-3000,0,0,0,0,3000,-3000,-3000
056041,禾伸堂凱基98購03,0,0,0,0,0,0,0,0,0,-3000,0,0,0,0,3000,-3000,-3000
060654,大毅群益9B購01  ,0,0,0,0,0,0,0,0,0,-3000,0,0,0,0,3000,-3000,-3000
06062P,宏達電元富97售01,0,0,0,0,0,0,0,0,0,-3000,0,0,0,0,3000,-3000,-3000
06966P,健策台新9A售02  ,0,0,0,0,0,0,0,0,0,-3000,0,0,0,0,3000,-3000,-3000
06883P,聯茂群益98售03  ,0,0,0,0,0,0,0,0,0,-3000,0,0,0,7000,10000,-3000,-3000
06849P,欣興元大98售12  ,0,0,0,0,0,0,0,0,0,-3000,0,0,0,31000,34000,-3000,-3000
07187P,臺股指台新99售10,0,0,0,0,0,0,0,0,0,-3000,0,0,0,0,3000,-3000,-3000
1725,元禎            ,0,3000,-3000,0,0,0,0,0,0,0,0,0,0,0,0,0,-3000
1735,日勝化          ,0,2000,-2000,0,0,0,0,0,0,-1000,0,1000,-1000,0,0,0,-3000
07451P,鴻海元大9B售01  ,0,0,0,0,0,0,0,0,0,-3000,0,0,0,0,3000,-3000,-3000
07452P,國巨元大9A售05  ,0,0,0,0,0,0,0,0,0,-3000,0,0,0,10000,13000,-3000,-3000
07496P,鴻海元大9A售05  ,0,0,0,0,0,0,0,0,0,-3000,0,0,0,0,3000,-3000,-3000
07488P,鴻海國票9A售02  ,0,0,0,0,0,0,0,0,0,-3000,0,0,0,0,3000,-3000,-3000
1233,天仁            ,2000,4000,-2000,0,0,0,0,0,0,-1000,0,1000,-1000,0,0,0,-3000
1110,東泥            ,1000,4000,-3000,0,0,0,0,0,0,0,0,0,0,0,0,0,-3000
3591,艾笛森          ,2000,3000,-1000,0,0,0,0,0,0,-2000,0,2000,-2000,0,0,0,-3000
4566,時碩工業        ,13000,16000,-3000,0,0,0,0,0,0,0,0,0,0,0,0,0,-3000
3209,全科            ,44000,46000,-2000,0,0,0,0,0,0,-1000,0,1000,-1000,0,0,0,-3000
2904,匯僑            ,8000,10000,-2000,0,0,0,0,0,0,-1000,0,1000,-1000,0,0,0,-3000
2887E,台新戊特        ,0,3000,-3000,0,0,0,0,0,0,0,0,0,0,0,0,0,-3000
2611,志信            ,0,3000,-3000,0,0,0,0,0,0,0,0,0,0,0,0,0,-3000
8473,山林水          ,16000,4000,12000,0,0,0,0,0,0,-15000,0,15000,-15000,0,0,0,-3000
6641,基士德-KY       ,0,3000,-3000,0,0,0,0,0,0,0,0,0,0,0,0,0,-3000
6120,達運            ,232000,207000,25000,0,0,0,0,0,0,-28000,0,28000,-28000,0,0,0,-3000
4720,德淵            ,2000,4000,-2000,0,0,0,0,0,0,-1000,0,1000,-1000,0,0,0,-3000
4807,日成-KY         ,2000,5000,-3000,0,0,0,0,0,0,0,0,0,0,0,0,0,-3000
058541,T50反1富邦01購01,0,0,0,0,0,0,0,0,0,-4000,0,0,0,0,4000,-4000,-4000
059349,台郡凱基99購04  ,0,0,0,0,0,0,0,0,0,-4000,0,0,0,36000,40000,-4000,-4000
059373,滬深2X群益01購03,0,0,0,0,0,0,0,0,0,-4000,0,0,0,0,4000,-4000,-4000
059345,禾伸堂凱基99購03,0,0,0,0,0,0,0,0,0,-4000,0,0,0,0,4000,-4000,-4000
059298,大立光元富9C購02,0,0,0,0,0,0,0,0,0,-4000,0,0,0,100000,104000,-4000,-4000
059262,致茂中信01購01  ,0,0,0,0,0,0,0,0,0,-4000,0,0,0,11000,15000,-4000,-4000
059177,臺股指凱基99購28,0,0,0,0,0,0,0,0,0,-4000,0,0,0,0,4000,-4000,-4000
058311,緯穎元大99購05  ,0,0,0,0,0,0,0,0,0,-4000,0,0,0,34000,38000,-4000,-4000
058167,鴻海凱基9A購03  ,0,0,0,0,0,0,0,0,0,-4000,0,0,0,0,4000,-4000,-4000
057397,茂林中信9A購01  ,0,0,0,0,0,0,0,0,0,-4000,0,0,0,36000,40000,-4000,-4000
059487,聯發科兆豐99購03,0,0,0,0,0,0,0,0,0,-4000,0,0,0,0,4000,-4000,-4000
059480,美律群益9A購01  ,0,0,0,0,0,0,0,0,0,-4000,0,0,0,0,4000,-4000,-4000
057152,緯穎國票99購03  ,0,0,0,0,0,0,0,0,0,-4000,0,0,0,0,4000,-4000,-4000
059788,華新科元大9A購05,0,0,0,0,0,0,0,0,0,-4000,0,0,0,10000,14000,-4000,-4000
059859,國巨群益9A購03  ,0,0,0,0,0,0,0,0,0,-4000,0,0,0,100000,104000,-4000,-4000
056287,亞光永豐97購02  ,0,0,0,0,0,0,0,0,0,-4000,0,0,0,14000,18000,-4000,-4000
056949,義隆統一98購01  ,0,0,0,0,0,0,0,0,0,-4000,0,0,0,0,4000,-4000,-4000
06050P,玉晶光國票98售01,0,0,0,0,0,0,0,0,0,-4000,0,0,0,19000,23000,-4000,-4000
060504,技嘉元大9A購02  ,0,0,0,0,0,0,0,0,0,-4000,0,0,0,0,4000,-4000,-4000
060224,台灣50元大9A購09,0,0,0,0,0,0,0,0,0,-4000,0,0,0,0,4000,-4000,-4000
057061,華擎國泰9A購01  ,0,0,0,0,0,0,0,0,0,-4000,0,0,0,195000,199000,-4000,-4000
059404,鴻海台新99購03  ,0,0,0,0,0,0,0,0,0,-4000,0,0,0,43000,47000,-4000,-4000
058664,百和兆豐99購01  ,0,0,0,0,0,0,0,0,0,-4000,0,0,0,146000,150000,-4000,-4000
058573,鴻海群益9A購02  ,0,0,0,0,0,0,0,0,0,-4000,0,0,0,13000,17000,-4000,-4000
057631,康控永豐98購02  ,0,0,0,0,0,0,0,0,0,-4000,0,0,0,5000,9000,-4000,-4000
05270P,台表科元大95售05,0,0,0,0,0,0,0,0,0,-4000,0,0,0,18000,22000,-4000,-4000
053253,友達國泰97購02  ,0,0,0,0,0,0,0,0,0,-4000,0,0,0,0,4000,-4000,-4000
053234,奇鋐永豐96購01  ,0,0,0,0,0,0,0,0,0,-4000,0,0,0,0,4000,-4000,-4000
053238,麗豐永豐96購01  ,0,0,0,0,0,0,0,0,0,-4000,0,0,0,4000,8000,-4000,-4000
053438,玉晶光麥證97購02,0,0,0,0,0,0,0,0,0,-4000,0,0,0,0,4000,-4000,-4000
05471P,聯電統一95售01  ,0,0,0,0,0,0,0,0,0,-4000,0,0,0,0,4000,-4000,-4000
054789,高鐵群益98購01  ,0,0,0,0,0,0,0,0,0,-4000,0,0,0,0,4000,-4000,-4000
05116P,台積電群益95售03,0,0,0,0,0,0,0,0,0,-4000,0,0,0,2000,6000,-4000,-4000
050651,大立光凱基96購02,0,0,0,0,0,0,0,0,0,-4000,0,0,0,0,4000,-4000,-4000
050648,全新凱基96購01  ,0,0,0,0,0,0,0,0,0,-4000,0,0,0,29000,33000,-4000,-4000
050208,燿華兆豐95購02  ,0,0,0,0,0,0,0,0,0,-4000,0,0,0,0,4000,-4000,-4000
053619,和碩群益96購01  ,0,0,0,0,0,0,0,0,0,-4000,0,0,0,0,4000,-4000,-4000
04751P,智邦兆豐95售02  ,0,0,0,0,0,0,0,0,0,-4000,0,0,0,0,4000,-4000,-4000
049255,旺宏元大97購02  ,0,0,0,0,0,0,0,0,0,-4000,0,0,0,0,4000,-4000,-4000
6128,上福            ,2000,6000,-4000,0,0,0,0,0,0,0,0,0,0,0,0,0,-4000
6136,富爾特          ,4000,8000,-4000,0,0,0,0,0,0,0,0,0,0,0,0,0,-4000
5284,jpp-KY          ,1000,5000,-4000,0,0,0,0,0,0,0,0,0,0,0,0,0,-4000
8222,寶一            ,0,3000,-3000,0,0,0,0,0,0,-1000,0,1000,-1000,0,0,0,-4000
3416,融程電          ,3000,7000,-4000,0,0,0,0,0,0,0,0,0,0,0,0,0,-4000
4560,強信-KY         ,41000,45000,-4000,0,0,0,0,0,0,0,0,0,0,0,0,0,-4000
4764,雙鍵            ,0,4000,-4000,0,0,0,0,0,0,0,0,0,0,0,0,0,-4000
1466,聚隆            ,3000,7000,-4000,0,0,0,0,0,0,0,0,0,0,0,0,0,-4000
1436,華友聯          ,12000,16000,-4000,0,0,0,0,0,0,0,0,0,0,0,0,0,-4000
07515P,台積電元大9A售15,0,0,0,0,0,0,0,0,0,-4000,0,0,0,0,4000,-4000,-4000
07412P,國巨元大99售32  ,0,0,0,0,0,0,0,0,0,-4000,0,0,0,0,4000,-4000,-4000
07332P,臺股指群益99售23,0,0,0,0,0,0,0,0,0,-4000,0,0,0,0,4000,-4000,-4000
1539,巨庭            ,10000,13000,-3000,0,0,0,0,0,0,-1000,0,1000,-1000,0,0,0,-4000
2397,友通            ,3000,7000,-4000,0,0,0,0,0,0,0,0,0,0,0,0,0,-4000
2431,聯昌            ,5000,9000,-4000,0,0,0,0,0,0,0,0,0,0,0,0,0,-4000
07068P,欣興台新99售01  ,0,0,0,0,0,0,0,0,0,-4000,0,0,0,0,4000,-4000,-4000
07277P,臺股指群益99售20,0,0,0,0,0,0,0,0,0,-4000,0,0,0,0,4000,-4000,-4000
07236P,台灣50國票99售05,0,0,0,0,0,0,0,0,0,-4000,0,0,0,100000,104000,-4000,-4000
07318P,鴻海凱基01售02  ,0,0,0,0,0,0,0,0,0,-4000,0,0,0,1000,5000,-4000,-4000
06923P,鴻海群益98售09  ,0,0,0,0,0,0,0,0,0,-4000,0,0,0,2000,6000,-4000,-4000
060698,旺宏國泰9C購01  ,0,0,0,0,0,0,0,0,0,-4000,0,0,0,0,4000,-4000,-4000
06645P,上銀元大98售05  ,0,0,0,0,0,0,0,0,0,-4000,0,0,0,0,4000,-4000,-4000
06501P,臺股指元大9A售06,0,0,0,0,0,0,0,0,0,-4000,0,0,0,3000,7000,-4000,-4000
06219P,國巨元富97售05  ,0,0,0,0,0,0,0,0,0,-4000,0,0,0,0,4000,-4000,-4000
6415,矽力-KY         ,170740,167330,3410,0,0,0,0,5188,-5188,-3000,0,5000,-5000,3000,1000,2000,-4778
057032,A50反1元大9B購01,0,0,0,0,0,0,0,0,0,-5000,0,0,0,0,5000,-5000,-5000
060080,台灣50元大02購01,0,0,0,0,0,0,0,0,0,-5000,0,0,0,0,5000,-5000,-5000
058993,滬深反元大9C購01,0,0,0,0,0,0,0,0,0,-5000,0,0,0,0,5000,-5000,-5000
05901P,臺股指凱基9C售01,0,0,0,0,0,0,0,0,0,-5000,0,0,0,0,5000,-5000,-5000
059057,聯發科凱基99購10,0,0,0,0,0,0,0,0,0,-5000,0,0,0,5000,10000,-5000,-5000
059953,聯發科康和99購01,0,0,0,0,0,0,0,0,0,-5000,0,0,0,0,5000,-5000,-5000
060041,T50反1群益99購04,0,0,0,0,0,0,0,0,0,-5000,0,0,0,0,5000,-5000,-5000
060056,大立光凱基9B購01,0,0,0,0,0,0,0,0,0,-5000,0,0,0,0,5000,-5000,-5000
060510,大立光元大9A購03,0,0,0,0,0,0,0,0,0,-5000,0,0,0,0,5000,-5000,-5000
060496,滬深2X元大9A購05,0,0,0,0,0,0,0,0,0,-5000,0,0,0,0,5000,-5000,-5000
060490,華新科台新9A購01,0,0,0,0,0,0,0,0,0,-5000,0,0,0,0,5000,-5000,-5000
060341,國巨統一9C購02  ,0,0,0,0,0,0,0,0,0,-5000,0,0,0,200000,205000,-5000,-5000
056958,喬山永豐98購01  ,0,0,0,0,0,0,0,0,0,-5000,0,0,0,45000,50000,-5000,-5000
056962,技嘉永豐98購01  ,0,0,0,0,0,0,0,0,0,-5000,0,0,0,1000,6000,-5000,-5000
056992,祥碩兆豐98購01  ,0,0,0,0,0,0,0,0,0,-5000,0,0,0,0,5000,-5000,-5000
05804P,美律永豐96售01  ,0,0,0,0,0,0,0,0,0,-5000,0,0,0,0,5000,-5000,-5000
056241,緯創群益97購01  ,0,0,0,0,0,0,0,0,0,-5000,0,0,0,1000,6000,-5000,-5000
057964,緯穎元大99購03  ,0,0,0,0,0,0,0,0,0,-5000,0,0,0,2000,7000,-5000,-5000
058940,聯發科中信9A購03,0,0,0,0,0,0,0,0,0,-5000,0,0,0,0,5000,-5000,-5000
059871,義隆凱基99購03  ,0,0,0,0,0,0,0,0,0,-5000,0,0,0,14000,19000,-5000,-5000
05662P,景碩元富96售01  ,0,0,0,0,0,0,0,0,0,-5000,0,0,0,0,5000,-5000,-5000
056651,聯茂凱基98購04  ,0,0,0,0,0,0,0,0,0,-5000,0,0,0,31000,36000,-5000,-5000
059784,台光電元大9A購01,0,0,0,0,0,0,0,0,0,-5000,0,0,0,25000,30000,-5000,-5000
059798,臺股指國票99購21,0,0,0,0,0,0,0,0,0,-5000,0,0,0,1000,6000,-5000,-5000
059817,華通凱基99購05  ,0,0,0,0,0,0,0,0,0,-5000,0,0,0,20000,25000,-5000,-5000
057149,京鼎國票99購02  ,0,0,0,0,0,0,0,0,0,-5000,0,0,0,5000,10000,-5000,-5000
060008,華邦電群益9A購01,0,0,0,0,0,0,0,0,0,-5000,0,0,0,0,5000,-5000,-5000
060003,上証2X群益9B購02,0,0,0,0,0,0,0,0,0,-5000,0,0,0,0,5000,-5000,-5000
059555,台灣50凱基9A購06,0,0,0,0,0,0,0,0,0,-5000,0,0,0,8000,13000,-5000,-5000
058201,華通凱基9A購01  ,0,0,0,0,0,0,0,0,0,-5000,0,0,0,1000,6000,-5000,-5000
058129,國巨元大99購10  ,0,0,0,0,0,0,0,0,0,-5000,0,0,0,45000,50000,-5000,-5000
059624,鴻海凱基01購01  ,0,0,0,0,0,0,0,0,0,-5000,0,0,0,0,5000,-5000,-5000
05963P,貿聯國票97售02  ,0,0,0,0,0,0,0,0,0,-5000,0,0,0,0,5000,-5000,-5000
059635,華新科凱基9A購06,0,0,0,0,0,0,0,0,0,-5000,0,0,0,7000,12000,-5000,-5000
058480,新日興凱基9A購01,0,0,0,0,0,0,0,0,0,-5000,0,0,0,26000,31000,-5000,-5000
058358,技嘉凱基9A購01  ,0,0,0,0,0,0,0,0,0,-5000,0,0,0,0,5000,-5000,-5000
058439,玉晶光統一01購02,0,0,0,0,0,0,0,0,0,-5000,0,0,0,0,5000,-5000,-5000
059605,臺股指元大9A購42,0,0,0,0,0,0,0,0,0,-5000,0,0,0,0,5000,-5000,-5000
05660P,玉晶光第一96售01,0,0,0,0,0,0,0,0,0,-5000,0,0,0,0,5000,-5000,-5000
03049X,元展46          ,0,0,0,0,0,0,0,0,0,-5000,0,0,0,0,5000,-5000,-5000
048870,義隆國票96購01  ,0,0,0,0,0,0,0,0,0,-5000,0,0,0,0,5000,-5000,-5000
048790,大立光元大95購05,0,0,0,0,0,0,0,0,0,-5000,0,0,0,0,5000,-5000,-5000
00645,富邦日本        ,0,0,0,0,0,0,0,0,0,-5000,0,0,0,64000,69000,-5000,-5000
03012X,元展12          ,0,0,0,0,0,0,0,0,0,-5000,0,0,0,0,5000,-5000,-5000
04727P,臺股指凱基96售03,0,0,0,0,0,0,0,0,0,-5000,0,0,0,0,5000,-5000,-5000
04544P,欣興富邦96售02  ,0,0,0,0,0,0,0,0,0,-5000,0,0,0,0,5000,-5000,-5000
052066,華邦電兆豐96購01,0,0,0,0,0,0,0,0,0,-5000,0,0,0,5000,10000,-5000,-5000
052104,英業達兆豐96購01,0,0,0,0,0,0,0,0,0,-5000,0,0,0,10000,15000,-5000,-5000
053611,聯茂麥證96購01  ,0,0,0,40000,45000,-5000,0,0,0,-5000,0,0,0,40000,45000,-5000,-5000
053660,群創凱基98購08  ,0,0,0,0,0,0,0,0,0,-5000,0,0,0,0,5000,-5000,-5000
055137,GIS富邦98購01   ,0,0,0,0,0,0,0,0,0,-5000,0,0,0,0,5000,-5000,-5000
055194,昇陽半元富97購01,0,0,0,0,0,0,0,0,0,-5000,0,0,0,0,5000,-5000,-5000
053884,緯穎第一96購01  ,0,0,0,0,0,0,0,0,0,-5000,0,0,0,5000,10000,-5000,-5000
050656,瑞儀凱基96購01  ,0,0,0,0,0,0,0,0,0,-5000,0,0,0,0,5000,-5000,-5000
054514,道瓊銀元大98購01,0,0,0,0,0,0,0,0,0,-5000,0,0,0,0,5000,-5000,-5000
054463,瑞昱凱基97購01  ,0,0,0,0,0,0,0,0,0,-5000,0,0,0,0,5000,-5000,-5000
054444,緯穎台新97購01  ,0,0,0,0,0,0,0,0,0,-5000,0,0,0,0,5000,-5000,-5000
053513,義隆群益96購05  ,0,0,0,0,0,0,0,0,0,-5000,0,0,0,9000,14000,-5000,-5000
05763P,致新永豐96售01  ,0,0,0,0,0,0,0,0,0,-5000,0,0,0,0,5000,-5000,-5000
057546,台積電凱基02購01,0,0,0,0,0,0,0,0,0,-5000,0,0,0,0,5000,-5000,-5000
05861P,瀚宇博永豐96售02,0,0,0,0,0,0,0,0,0,-5000,0,0,0,0,5000,-5000,-5000
055988,矽力元富97購01  ,0,0,0,0,0,0,0,0,0,-5000,0,0,0,40000,45000,-5000,-5000
055861,矽力元大97購03  ,0,0,0,0,0,0,0,0,0,-5000,0,0,0,0,5000,-5000,-5000
055615,宏達電國票99購02,0,0,0,0,0,0,0,0,0,-5000,0,0,0,0,5000,-5000,-5000
054135,大立光元大97購04,0,0,0,0,0,0,0,0,0,-5000,0,0,0,0,5000,-5000,-5000
054160,華泰凱基98購01  ,0,0,0,0,0,0,0,0,0,-5000,0,0,0,0,5000,-5000,-5000
055112,晶豪科凱基98購01,0,0,0,0,0,0,0,0,0,-5000,0,0,0,0,5000,-5000,-5000
055122,國巨兆豐98購01  ,0,0,0,0,0,0,0,0,0,-5000,0,0,0,0,5000,-5000,-5000
6152,百一            ,3000,8000,-5000,0,0,0,0,0,0,0,0,0,0,0,0,0,-5000
8374,羅昇            ,2000,6000,-4000,0,0,0,0,0,0,-1000,0,1000,-1000,0,0,0,-5000
3018,同開            ,18000,23000,-5000,0,0,0,0,0,0,0,0,0,0,0,0,0,-5000
06089P,矽創永豐97售01  ,0,0,0,0,0,0,0,0,0,-5000,0,0,0,5000,10000,-5000,-5000
06159P,牧德元富97售02  ,0,0,0,0,0,0,0,0,0,-5000,0,0,0,0,5000,-5000,-5000
06145P,華新科永豐97售02,0,0,0,0,0,0,0,0,0,-5000,0,0,0,10000,15000,-5000,-5000
06304P,臺股指元大97售10,0,0,0,0,0,0,0,0,0,-5000,0,0,0,1000,6000,-5000,-5000
06611P,祥碩國票98售01  ,0,0,0,0,0,0,0,0,0,-5000,0,0,0,1000,6000,-5000,-5000
060688,世紀鋼元大9C購01,0,0,0,0,0,0,0,0,0,-5000,0,0,0,67000,72000,-5000,-5000
060709,緯穎富邦9B購01  ,0,0,0,0,0,0,0,0,0,-5000,0,0,0,0,5000,-5000,-5000
060658,台灣50凱基01購04,0,0,0,0,0,0,0,0,0,-5000,0,0,0,0,5000,-5000,-5000
060635,義隆永豐9A購01  ,0,0,0,0,0,0,0,0,0,-5000,0,0,0,12000,17000,-5000,-5000
060544,國巨凱基9B購03  ,0,0,0,0,0,0,0,0,0,-5000,0,0,0,79000,84000,-5000,-5000
060530,聯發科中信9C購03,0,0,0,0,0,0,0,0,0,-5000,0,0,0,10000,15000,-5000,-5000
06751P,旺宏凱基98售10  ,0,0,0,0,0,0,0,0,0,-5000,0,0,0,0,5000,-5000,-5000
06992P,玉晶光日盛9B售01,0,0,0,0,0,0,0,0,0,-5000,0,0,0,0,5000,-5000,-5000
060263,臺指反國票9C購01,0,0,0,0,0,0,0,0,0,-5000,0,0,0,0,5000,-5000,-5000
060264,華新科國票9A購02,0,0,0,0,0,0,0,0,0,-5000,0,0,0,0,5000,-5000,-5000
060276,S&P反1元大9A購03,0,0,0,0,0,0,0,0,0,-5000,0,0,0,40000,45000,-5000,-5000
07282P,聯發科凱基99售17,0,0,0,0,0,0,0,0,0,-5000,0,0,0,10000,15000,-5000,-5000
07241P,台灣50國票9A售05,0,0,0,0,0,0,0,0,0,-5000,0,0,0,800000,805000,-5000,-5000
07161P,臺股指群益99售12,0,0,0,0,0,0,0,0,0,-5000,0,0,0,0,5000,-5000,-5000
2433,互盛電          ,9000,6000,3000,0,0,0,0,0,0,-8000,0,8000,-8000,0,0,0,-5000
2107,厚生            ,184000,187000,-3000,0,0,0,0,0,0,-2000,1000,3000,-2000,0,0,0,-5000
1616,億泰            ,0,5000,-5000,0,0,0,0,0,0,0,0,0,0,0,0,0,-5000
1732,毛寶            ,154000,158000,-4000,0,0,0,0,0,0,-1000,2000,3000,-1000,0,0,0,-5000
2007,燁興            ,0,5000,-5000,0,0,0,0,0,0,0,0,0,0,0,0,0,-5000
07348P,滬深2X凱基9A售04,0,0,0,0,0,0,0,0,0,-5000,0,0,0,0,5000,-5000,-5000
07394P,國巨群益99售12  ,0,0,0,0,0,0,0,0,0,-5000,0,0,0,80000,85000,-5000,-5000
07437P,臺股指麥證9A售04,0,0,0,0,5000,-5000,0,0,0,-5000,0,0,0,0,5000,-5000,-5000
07441P,臺股指麥證9B售03,0,0,0,0,5000,-5000,0,0,0,-5000,0,0,0,0,5000,-5000,-5000
1419,新紡            ,2000,7000,-5000,0,0,0,0,0,0,0,0,0,0,0,0,0,-5000
1413,宏洲            ,1000,6000,-5000,0,0,0,0,0,0,0,0,0,0,0,0,0,-5000
07570P,旺宏凱基9A售04  ,0,0,0,0,0,0,0,0,0,-5000,0,0,0,0,5000,-5000,-5000
07560P,台積電國泰9B售01,0,0,0,0,0,0,0,0,0,-5000,0,0,0,0,5000,-5000,-5000
07551P,國巨元大9A售10  ,0,0,0,0,0,0,0,0,0,-5000,0,0,0,33000,38000,-5000,-5000
2923,鼎固-KY         ,4000,1000,3000,0,0,0,0,8166,-8166,0,0,0,0,0,0,0,-5166
056626,同欣電永豐98購01,0,0,0,0,0,0,0,0,0,-6000,0,0,0,0,6000,-6000,-6000
059596,大立光元大99購20,0,0,0,0,0,0,0,0,0,-6000,0,0,0,0,6000,-6000,-6000
058558,鴻海日盛9A購02  ,0,0,0,0,0,0,0,0,0,-6000,0,0,0,10000,16000,-6000,-6000
059387,華通凱基9A購03  ,0,0,0,0,0,0,0,0,0,-6000,0,0,0,7000,13000,-6000,-6000
05925P,晶技永豐96售03  ,0,0,0,0,0,0,0,0,0,-6000,0,0,0,9000,15000,-6000,-6000
059176,臺股指凱基99購27,0,0,0,0,0,0,0,0,0,-6000,0,0,0,0,6000,-6000,-6000
057859,神達康和98購01  ,0,0,0,0,0,0,0,0,0,-6000,0,0,0,191000,197000,-6000,-6000
058242,玉晶光元大9A購01,0,0,0,0,0,0,0,0,0,-6000,0,0,0,0,6000,-6000,-6000
057795,鴻海兆豐99購02  ,0,0,0,0,0,0,0,0,0,-6000,0,0,0,0,6000,-6000,-6000
057494,玉晶光元大99購09,0,0,0,0,0,0,0,0,0,-6000,0,0,0,6000,12000,-6000,-6000
05742P,可成元大96售04  ,0,0,0,0,0,0,0,0,0,-6000,0,0,0,0,6000,-6000,-6000
059519,台郡永豐99購01  ,0,0,0,0,0,0,0,0,0,-6000,0,0,0,8000,14000,-6000,-6000
059847,喬山永豐99購01  ,0,0,0,0,0,0,0,0,0,-6000,0,0,0,45000,51000,-6000,-6000
057949,南電國票99購01  ,0,0,0,0,0,0,0,0,0,-6000,0,0,0,18000,24000,-6000,-6000
058902,聯發科元大99購15,0,0,0,0,0,0,0,0,0,-6000,0,0,0,0,6000,-6000,-6000
060328,可成群益9A購06  ,0,0,0,0,0,0,0,0,0,-6000,0,0,0,0,6000,-6000,-6000
060292,聯詠元大9A購01  ,0,0,0,0,0,0,0,0,0,-6000,0,0,0,20000,26000,-6000,-6000
060062,聯發科兆豐99購04,0,0,0,0,0,0,0,0,0,-6000,0,0,0,0,6000,-6000,-6000
060076,台灣50台新9B購05,0,0,0,0,0,0,0,0,0,-6000,0,0,0,2000,8000,-6000,-6000
059417,上証反元大9C購01,0,0,0,0,0,0,0,0,0,-6000,0,0,0,0,6000,-6000,-6000
059433,聯發科元大99購27,0,0,0,0,0,0,0,0,0,-6000,0,0,0,4000,10000,-6000,-6000
059992,S&P正2元富9B購04,0,0,0,0,0,0,0,0,0,-6000,0,0,0,0,6000,-6000,-6000
05341P,臺股指兆豐95售02,0,0,0,0,0,0,0,0,0,-6000,0,0,0,4000,10000,-6000,-6000
053451,致新凱基96購02  ,0,0,0,0,0,0,0,0,0,-6000,0,0,0,0,6000,-6000,-6000
052997,國巨康和96購01  ,0,0,0,0,0,0,0,0,0,-6000,0,0,0,54000,60000,-6000,-6000
053887,聯茂兆豐97購02  ,0,0,0,0,0,0,0,0,0,-6000,0,0,0,24000,30000,-6000,-6000
053826,光磊麥證97購01  ,0,0,0,0,6000,-6000,0,0,0,-6000,0,0,0,0,6000,-6000,-6000
055124,建準兆豐97購01  ,0,0,0,0,0,0,0,0,0,-6000,0,0,0,0,6000,-6000,-6000
04980P,臺股指凱基96售08,0,0,0,0,0,0,0,0,0,-6000,0,0,0,0,6000,-6000,-6000
049842,道瓊反中信98購01,0,0,0,0,0,0,0,0,0,-6000,0,0,0,0,6000,-6000,-6000
01002T,土銀國泰R1      ,0,6000,-6000,0,0,0,0,0,0,0,0,0,0,0,0,0,-6000
00689R,國泰20年美債反1 ,0,0,0,0,0,0,0,0,0,-6000,0,0,0,100000,106000,-6000,-6000
00714,群益道瓊美國地產,0,0,0,0,0,0,0,0,0,-6000,0,0,0,23000,29000,-6000,-6000
00661,元大日經225     ,0,0,0,0,0,0,0,0,0,-6000,0,0,0,0,6000,-6000,-6000
2630,亞航            ,2000,8000,-6000,0,0,0,0,0,0,0,0,0,0,0,0,0,-6000
2706,第一店          ,11000,17000,-6000,0,0,0,0,0,0,0,0,0,0,0,0,0,-6000
2701,萬企            ,5000,11000,-6000,0,0,0,0,0,0,0,0,0,0,0,0,0,-6000
3454,晶睿            ,14000,17000,-3000,0,0,0,0,0,0,-3000,0,3000,-3000,0,0,0,-6000
3528,安馳            ,1000,6000,-5000,0,0,0,0,0,0,-1000,0,1000,-1000,0,0,0,-6000
3046,建碁            ,0,6000,-6000,0,0,0,0,0,0,0,0,0,0,0,0,0,-6000
3047,訊舟            ,40000,45000,-5000,0,0,0,0,0,0,-1000,0,1000,-1000,0,0,0,-6000
6581,鋼聯            ,0,6000,-6000,0,0,0,0,0,0,0,0,0,0,0,0,0,-6000
6201,亞弘電          ,5000,9000,-4000,0,0,0,0,0,0,-2000,0,2000,-2000,0,0,0,-6000
5283,禾聯碩          ,17000,19000,-2000,0,0,0,0,0,0,-4000,0,0,0,0,4000,-4000,-6000
1220,台榮            ,0,4000,-4000,0,0,0,0,0,0,-2000,0,2000,-2000,0,0,0,-6000
07581P,臺股指元大9A售44,0,0,0,0,0,0,0,0,0,-6000,0,0,0,0,6000,-6000,-6000
07582P,臺股指元大9A售45,0,0,0,0,0,0,0,0,0,-6000,0,0,0,0,6000,-6000,-6000
07460P,臺股指元大9B售03,0,0,0,0,0,0,0,0,0,-6000,0,0,0,0,6000,-6000,-6000
07461P,臺股指元大9B售04,0,0,0,0,0,0,0,0,0,-6000,0,0,0,0,6000,-6000,-6000
07331P,臺股指群益99售22,0,0,0,0,0,0,0,0,0,-6000,0,0,0,0,6000,-6000,-6000
1805,寶徠            ,2000,8000,-6000,0,0,0,0,0,0,0,0,0,0,0,0,0,-6000
1817,凱撒衛          ,0,5000,-5000,0,0,0,0,0,0,-1000,0,1000,-1000,0,0,0,-6000
2208,台船            ,141000,147000,-6000,0,0,0,0,0,0,0,0,0,0,0,0,0,-6000
2460,建通            ,2000,7000,-5000,0,0,0,0,0,0,-1000,0,1000,-1000,0,0,0,-6000
2468,華經            ,5000,11000,-6000,0,0,0,0,0,0,0,0,0,0,0,0,0,-6000
07190P,臺股指富邦9C售02,0,0,0,0,0,0,0,0,0,-6000,0,0,0,0,6000,-6000,-6000
07108P,FBVIX台新99售02 ,0,0,0,0,0,0,0,0,0,-6000,0,0,0,0,6000,-6000,-6000
07323P,鴻海元大99售34  ,0,0,0,0,0,0,0,0,0,-6000,0,0,0,0,6000,-6000,-6000
06977P,臺股指元大9A售15,0,0,0,0,0,0,0,0,0,-6000,0,0,0,0,6000,-6000,-6000
06974P,臺股指元大9A售12,0,0,0,0,0,0,0,0,0,-6000,0,0,0,0,6000,-6000,-6000
060415,葡萄王永豐9A購01,0,0,0,0,0,0,0,0,0,-6000,0,0,0,0,6000,-6000,-6000
06904P,TPK凱基98售03   ,0,0,0,0,0,0,0,0,0,-6000,0,0,0,0,6000,-6000,-6000
06310P,精元元富97售02  ,0,0,0,0,0,0,0,0,0,-6000,0,0,0,0,6000,-6000,-6000
06254P,臺股指群益97售07,0,0,0,0,0,0,0,0,0,-6000,0,0,0,0,6000,-6000,-6000
060101,大立光元大99購31,0,0,0,0,0,0,0,0,0,-7000,0,0,0,0,7000,-7000,-7000
060097,華新科元大99購23,0,0,0,0,0,0,0,0,0,-7000,0,0,0,31000,38000,-7000,-7000
060185,聯發科元富04購01,0,0,0,0,0,0,0,0,0,-7000,0,0,0,0,7000,-7000,-7000
06016P,京元電凱基96售03,0,0,0,0,0,0,0,0,0,-7000,0,0,0,0,7000,-7000,-7000
059949,啟碁永豐99購01  ,0,0,0,0,0,0,0,0,0,-7000,0,0,0,0,7000,-7000,-7000
059935,國巨永豐99購07  ,0,0,0,0,0,0,0,0,0,-7000,0,0,0,43000,50000,-7000,-7000
059054,國巨凱基99購11  ,0,0,0,0,0,0,0,0,0,-7000,0,0,0,0,7000,-7000,-7000
05973P,聯詠元大96售06  ,0,0,0,0,0,0,0,0,0,-7000,0,0,0,39000,46000,-7000,-7000
059040,訊芯群益99購03  ,0,0,0,0,0,0,0,0,0,-7000,0,0,0,0,7000,-7000,-7000
057147,新日興國票99購01,0,0,0,0,0,0,0,0,0,-7000,0,0,0,64000,71000,-7000,-7000
057736,鴻海富邦99購04  ,0,0,0,0,0,0,0,0,0,-7000,0,0,0,0,7000,-7000,-7000
057502,訊芯群益98購02  ,0,0,0,0,0,0,0,0,0,-7000,0,0,0,0,7000,-7000,-7000
059140,大立光兆豐9A購02,0,0,0,0,0,0,0,0,0,-7000,0,0,0,3000,10000,-7000,-7000
059620,聯發科日盛99購02,0,0,0,0,0,0,0,0,0,-7000,0,0,0,14000,21000,-7000,-7000
0053,元大電子        ,0,0,0,0,0,0,0,0,0,-7000,0,0,0,3000,10000,-7000,-7000
0051,元大中型100     ,0,0,0,0,0,0,0,0,0,-7000,0,0,0,257000,264000,-7000,-7000
00866,新光Shiller CAPE,0,0,0,0,0,0,0,0,0,-7000,0,0,0,27000,34000,-7000,-7000
04974P,聯發科凱基96售02,0,0,0,0,0,0,0,0,0,-7000,0,0,0,0,7000,-7000,-7000
04729P,臺股指中信96售01,0,0,0,0,0,0,0,0,0,-7000,0,0,0,0,7000,-7000,-7000
05252P,華通凱基95售01  ,0,0,0,0,0,0,0,0,0,-7000,0,0,0,0,7000,-7000,-7000
050045,祥碩兆豐94購01  ,0,0,0,0,0,0,0,0,0,-7000,0,0,0,0,7000,-7000,-7000
052237,嘉澤國票96購02  ,0,0,0,0,0,0,0,0,0,-7000,0,0,0,0,7000,-7000,-7000
055589,台光電元大98購04,0,0,0,0,0,0,0,0,0,-7000,0,0,0,0,7000,-7000,-7000
059430,台積電元大99購36,0,0,0,0,0,0,0,0,0,-7000,0,0,0,16000,23000,-7000,-7000
054115,台塑康和96購01  ,0,0,0,0,0,0,0,0,0,-7000,0,0,0,3000,10000,-7000,-7000
055065,神達永豐97購01  ,0,0,0,0,0,0,0,0,0,-7000,0,0,0,0,7000,-7000,-7000
054989,精元元富97購01  ,0,0,0,0,0,0,0,0,0,-7000,0,0,0,14000,21000,-7000,-7000
055603,超眾元大97購04  ,0,0,0,0,0,0,0,0,0,-7000,0,0,0,18000,25000,-7000,-7000
055955,微星元大97購01  ,0,0,0,0,0,0,0,0,0,-7000,0,0,0,5000,12000,-7000,-7000
06564P,國巨富邦9A售04  ,0,0,0,0,0,0,0,0,0,-7000,0,0,0,0,7000,-7000,-7000
060638,玉晶光永豐9A購04,0,0,0,0,0,0,0,0,0,-7000,0,0,0,0,7000,-7000,-7000
06851P,鈺齊元大98售01  ,0,0,0,0,0,0,0,0,0,-7000,0,0,0,73000,80000,-7000,-7000
1786,科妍            ,17000,24000,-7000,0,0,0,0,0,0,0,2000,2000,0,0,0,0,-7000
1810,和成            ,19000,23000,-4000,0,0,0,0,0,0,-3000,0,3000,-3000,0,0,0,-7000
1583,程泰            ,0,7000,-7000,0,0,0,0,0,0,0,0,0,0,0,0,0,-7000
07428P,華新科國票9A售01,0,0,0,0,0,0,0,0,0,-7000,0,0,0,7000,14000,-7000,-7000
07574P,國巨元大9A售12  ,0,0,0,0,0,0,0,0,0,-7000,0,0,0,50000,57000,-7000,-7000
1414,東和            ,4000,9000,-5000,0,0,0,0,0,0,-2000,0,2000,-2000,0,0,0,-7000
1473,台南            ,20000,27000,-7000,0,0,0,0,0,0,0,0,0,0,0,0,0,-7000
1459,聯發            ,0,7000,-7000,0,0,0,0,0,0,0,0,0,0,0,0,0,-7000
6442,光聖            ,0,7000,-7000,0,0,0,0,0,0,0,0,0,0,0,0,0,-7000
6552,易華電          ,111000,118000,-7000,0,0,0,0,0,0,0,0,0,0,0,0,0,-7000
8367,建新國際        ,1000,10000,-9000,0,0,0,0,0,0,2000,2000,0,2000,0,0,0,-7000
9942,茂順            ,13000,9000,4000,0,0,0,0,0,0,-11000,0,11000,-11000,0,0,0,-7000
4557,永新-KY         ,0,7000,-7000,0,0,0,0,0,0,0,0,0,0,0,0,0,-7000
1232,大統益          ,19100,18000,1100,0,0,0,0,0,0,-9000,0,9000,-9000,0,0,0,-7900
2441,超豐            ,99000,103000,-4000,0,0,0,0,2900,-2900,-1000,22000,23000,-1000,0,0,0,-7900
2227,裕日車          ,14000,25000,-11000,0,0,0,0,947,-947,4000,4000,0,4000,0,0,0,-7947
059082,華通元大99購06  ,0,0,0,0,0,0,0,0,0,-8000,0,0,0,0,8000,-8000,-8000
059123,訊芯永豐99購03  ,0,0,0,0,0,0,0,0,0,-8000,0,0,0,0,8000,-8000,-8000
059236,鴻海凱基99購09  ,0,0,0,0,0,0,0,0,0,-8000,0,0,0,0,8000,-8000,-8000
059284,緯穎永豐99購03  ,0,0,0,0,0,0,0,0,0,-8000,0,0,0,0,8000,-8000,-8000
058494,可成群益9B購01  ,0,0,0,0,0,0,0,0,0,-8000,0,0,0,0,8000,-8000,-8000
057320,玉晶光凱基98購01,0,0,0,0,0,0,0,0,0,-8000,0,0,0,8000,16000,-8000,-8000
058688,矽創凱基9A購01  ,0,0,0,0,0,0,0,0,0,-8000,0,0,0,2000,10000,-8000,-8000
057201,華擎元富98購01  ,0,0,0,0,0,0,0,0,0,-8000,0,0,0,91000,99000,-8000,-8000
06010P,國泰金元富96售01,0,0,0,0,0,0,0,0,0,-8000,0,0,0,0,8000,-8000,-8000
060061,旺宏兆豐99購02  ,0,0,0,0,0,0,0,0,0,-8000,0,0,0,7000,15000,-8000,-8000
060219,聯發科凱基9A購09,0,0,0,0,0,0,0,0,0,-8000,0,0,0,0,8000,-8000,-8000
060367,緯穎元富9A購02  ,0,0,0,0,0,0,0,0,0,-8000,0,0,0,0,8000,-8000,-8000
058050,台郡元大99購05  ,0,0,0,0,0,0,0,0,0,-8000,0,0,0,81000,89000,-8000,-8000
056669,貿聯國票99購01  ,0,0,0,0,0,0,0,0,0,-8000,0,0,0,76000,84000,-8000,-8000
059783,旺宏元大99購17  ,0,0,0,0,0,0,0,0,0,-8000,0,0,0,2000,10000,-8000,-8000
055859,啟碁元大97購03  ,0,0,0,0,0,0,0,0,0,-8000,0,0,0,40000,48000,-8000,-8000
054974,台表科元大98購02,0,0,0,0,0,0,0,0,0,-8000,0,0,0,2000,10000,-8000,-8000
059988,大立光元大9A購02,0,0,0,0,0,0,0,0,0,-8000,0,0,0,0,8000,-8000,-8000
056516,晶豪科兆豐98購01,0,0,0,0,0,0,0,0,0,-8000,0,0,0,0,8000,-8000,-8000
054363,世芯凱基97購01  ,0,0,0,0,0,0,0,0,0,-8000,0,0,0,10000,18000,-8000,-8000
053407,台積電兆豐96購02,0,0,0,0,0,0,0,0,0,-8000,0,0,0,0,8000,-8000,-8000
053207,SP黃豆凱基96購01,0,0,0,0,0,0,0,0,0,-8000,0,0,0,0,8000,-8000,-8000
05222P,致伸凱基95售02  ,0,0,0,0,0,0,0,0,0,-8000,0,0,0,20000,28000,-8000,-8000
049929,祥碩元大94購03  ,0,0,0,0,0,0,0,0,0,-8000,0,0,0,0,8000,-8000,-8000
053635,技嘉永豐96購01  ,0,0,0,0,0,0,0,0,0,-8000,0,0,0,0,8000,-8000,-8000
2239,英利-KY         ,10000,18000,-8000,0,0,0,0,0,0,0,0,0,0,0,0,0,-8000
2466,冠西電          ,2000,10000,-8000,0,0,0,0,0,0,0,0,0,0,0,0,0,-8000
1708,東鹼            ,63000,71000,-8000,0,0,0,0,0,0,0,0,0,0,0,0,0,-8000
1530,亞崴            ,0,6000,-6000,0,0,0,0,0,0,-2000,0,2000,-2000,0,0,0,-8000
1467,南緯            ,6000,13000,-7000,0,0,0,0,0,0,-1000,0,1000,-1000,0,0,0,-8000
1445,大宇            ,0,7000,-7000,0,0,0,0,0,0,-1000,0,1000,-1000,0,0,0,-8000
07365P,超眾元大99售07  ,0,0,0,0,0,0,0,0,0,-8000,0,0,0,12000,20000,-8000,-8000
07371P,滬深2X元大99售07,0,0,0,0,0,0,0,0,0,-8000,0,0,0,0,8000,-8000,-8000
06753P,智邦富邦98售03  ,0,0,0,0,0,0,0,0,0,-8000,0,0,0,42000,50000,-8000,-8000
060416,神隆永豐9A購01  ,0,0,0,0,0,0,0,0,0,-8000,0,0,0,70000,78000,-8000,-8000
060266,潤泰全國票9A購01,0,0,0,0,0,0,0,0,0,-8000,0,0,0,29000,37000,-8000,-8000
06952P,大立光統一9A售03,0,0,0,0,0,0,0,0,0,-8000,0,0,0,0,8000,-8000,-8000
060609,玉晶光凱基9B購01,0,0,0,0,0,0,0,0,0,-8000,0,0,0,0,8000,-8000,-8000
06535P,可成群益99售02  ,0,0,0,0,0,0,0,0,0,-8000,0,0,0,0,8000,-8000,-8000
06387P,緯穎永豐97售02  ,0,0,0,0,0,0,0,0,0,-8000,0,0,0,2000,10000,-8000,-8000
4148,全宇生技-KY     ,5000,13000,-8000,0,0,0,0,0,0,0,0,0,0,0,0,0,-8000
3530,晶相光          ,111000,116000,-5000,0,0,0,0,0,0,-3000,0,3000,-3000,0,0,0,-8000
2906,高林            ,3000,10000,-7000,0,0,0,0,0,0,-1000,0,1000,-1000,0,0,0,-8000
2887F,台新戊特二      ,0,8000,-8000,0,0,0,0,0,0,0,0,0,0,0,0,0,-8000
8070,長華*           ,4000,12000,-8000,0,0,0,0,0,0,0,0,0,0,0,0,0,-8000
2373,震旦行          ,7000,8000,-1000,0,0,0,0,2202,-2202,-5000,0,5000,-5000,0,0,0,-8202
1507,永大            ,9000,15000,-6000,0,0,0,0,2371,-2371,0,0,0,0,0,0,0,-8371
057894,華通元富02購02  ,0,0,0,0,0,0,0,0,0,-9000,0,0,0,0,9000,-9000,-9000
058047,可成元大98購11  ,0,0,0,0,0,0,0,0,0,-9000,0,0,0,0,9000,-9000,-9000
056304,創意元大97購03  ,0,0,0,0,0,0,0,0,0,-9000,0,0,0,0,9000,-9000,-9000
060235,瑞昱元大9A購01  ,0,0,0,0,0,0,0,0,0,-9000,0,0,0,0,9000,-9000,-9000
059023,可成統一9B購02  ,0,0,0,0,0,0,0,0,0,-9000,0,0,0,51000,60000,-9000,-9000
059947,貿聯永豐99購03  ,0,0,0,0,0,0,0,0,0,-9000,0,0,0,10000,19000,-9000,-9000
058693,旭富國票9A購01  ,0,0,0,0,0,0,0,0,0,-9000,0,0,0,30000,39000,-9000,-9000
057325,可成群益9A購01  ,0,0,0,0,0,0,0,0,0,-9000,0,0,0,0,9000,-9000,-9000
057526,智邦元大98購10  ,0,0,0,0,0,0,0,0,0,-9000,0,0,0,56000,65000,-9000,-9000
058459,南電永豐99購01  ,0,0,0,0,0,0,0,0,0,-9000,0,0,0,94000,103000,-9000,-9000
058389,聯茂國票9A購01  ,0,0,0,0,0,0,0,0,0,-9000,0,0,0,20000,29000,-9000,-9000
05931P,鴻海凱基96售15  ,0,0,0,0,0,0,0,0,0,-9000,0,0,0,0,9000,-9000,-9000
059348,日月光凱基99購01,0,0,0,0,0,0,0,0,0,-9000,0,0,0,0,9000,-9000,-9000
059149,臺股指國票99購12,0,0,0,0,0,0,0,0,0,-9000,0,0,0,7000,16000,-9000,-9000
055209,勤誠康和97購01  ,0,0,0,0,0,0,0,0,0,-9000,0,0,0,1000,10000,-9000,-9000
049335,聯電統一97購01  ,0,0,0,0,0,0,0,0,0,-9000,0,0,0,0,9000,-9000,-9000
00731,FH富時高息低波  ,0,0,0,0,0,0,0,0,0,-9000,0,0,0,11000,20000,-9000,-9000
00711B,FH彭博新興債    ,0,0,0,0,0,0,0,0,0,-9000,0,0,0,122000,131000,-9000,-9000
05539P,鎧勝永豐96售01  ,0,0,0,0,0,0,0,0,0,-9000,0,0,0,0,9000,-9000,-9000
055509,訊芯元大97購03  ,0,0,0,0,0,0,0,0,0,-9000,0,0,0,0,9000,-9000,-9000
057557,聯茂凱基99購04  ,0,0,0,0,0,0,0,0,0,-9000,0,0,0,25000,34000,-9000,-9000
059459,訊芯永豐99購04  ,0,0,0,0,0,0,0,0,0,-9000,0,0,0,0,9000,-9000,-9000
055842,建準元大98購01  ,0,0,0,0,0,0,0,0,0,-9000,0,0,0,6000,15000,-9000,-9000
2380,虹光            ,0,9000,-9000,0,0,0,0,0,0,0,0,0,0,0,0,0,-9000
2477,美隆電          ,7000,4000,3000,0,0,0,0,0,0,-12000,0,12000,-12000,0,0,0,-9000
2438,翔耀            ,3000,12000,-9000,0,0,0,0,0,0,0,0,0,0,0,0,0,-9000
2425,承啟            ,69000,78000,-9000,0,0,0,0,0,0,0,0,0,0,0,0,0,-9000
2413,環科            ,3000,12000,-9000,0,0,0,0,0,0,0,0,0,0,0,0,0,-9000
1234,黑松            ,3000,12000,-9000,0,0,0,0,0,0,0,0,0,0,0,0,0,-9000
1225,福懋油          ,18000,26000,-8000,0,0,0,0,0,0,-1000,0,1000,-1000,0,0,0,-9000
06578P,華新科國票98售02,0,0,0,0,0,0,0,0,0,-9000,0,0,0,0,9000,-9000,-9000
060570,南亞科永豐9A購01,0,0,0,0,0,0,0,0,0,-9000,0,0,0,20000,29000,-9000,-9000
07260P,台灣50元大9A售01,0,0,0,0,0,0,0,0,0,-9000,0,0,0,17000,26000,-9000,-9000
8478,東哥遊艇        ,1000,9000,-8000,0,0,0,0,0,0,-1000,0,1000,-1000,0,0,0,-9000
9902,台火            ,2000,10000,-8000,0,0,0,0,0,0,-1000,0,1000,-1000,0,0,0,-9000
9926,新海            ,0,9000,-9000,0,0,0,0,0,0,0,0,0,0,0,0,0,-9000
6281,全國電          ,5000,10000,-5000,0,0,0,0,0,0,-4000,2000,6000,-4000,0,0,0,-9000
6168,宏齊            ,28000,27000,1000,0,0,0,0,0,0,-10000,0,10000,-10000,0,0,0,-9000
2739,寒舍            ,1000,10000,-9000,0,0,0,0,0,0,0,0,0,0,0,0,0,-9000
2540,愛山林          ,0,9000,-9000,0,0,0,0,0,0,0,0,0,0,0,0,0,-9000
2528,皇普            ,0,10000,-10000,0,0,0,0,0,0,1000,2000,1000,1000,0,0,0,-9000
2509,全坤建          ,4000,13000,-9000,0,0,0,0,0,0,0,0,0,0,0,0,0,-9000
2497,怡利電          ,4000,13000,-9000,0,0,0,0,0,0,0,0,0,0,0,0,0,-9000
3031,佰鴻            ,44000,53000,-9000,0,0,0,0,0,0,0,0,0,0,0,0,0,-9000
059139,全新兆豐9A購01  ,0,0,0,0,0,0,0,0,0,-10000,0,0,0,0,10000,-10000,-10000
059160,華通凱基99購03  ,0,0,0,0,0,0,0,0,0,-10000,0,0,0,0,10000,-10000,-10000
059162,國巨凱基99購12  ,0,0,0,0,0,0,0,0,0,-10000,0,0,0,76000,86000,-10000,-10000
059167,聯發科凱基99購11,0,0,0,0,0,0,0,0,0,-10000,0,0,0,0,10000,-10000,-10000
059192,臺股指富邦9C購01,0,0,0,0,0,0,0,0,0,-10000,0,0,0,0,10000,-10000,-10000
059622,上銀凱基99購10  ,0,0,0,0,0,0,0,0,0,-10000,0,0,0,0,10000,-10000,-10000
05905P,晶技統一97售01  ,0,0,0,0,0,0,0,0,0,-10000,0,0,0,0,10000,-10000,-10000
059342,聯發科凱基9A購05,0,0,0,0,0,0,0,0,0,-10000,0,0,0,0,10000,-10000,-10000
059644,茂林凱基99購03  ,0,0,0,0,0,0,0,0,0,-10000,0,0,0,0,10000,-10000,-10000
059243,聯發科凱基99購12,0,0,0,0,0,0,0,0,0,-10000,0,0,0,0,10000,-10000,-10000
058415,祥碩兆豐99購01  ,0,0,0,0,0,0,0,0,0,-10000,0,0,0,0,10000,-10000,-10000
058455,玉晶光永豐99購03,0,0,0,0,0,0,0,0,0,-10000,0,0,0,0,10000,-10000,-10000
058447,玉晶光富邦9A購02,0,0,0,0,0,0,0,0,0,-10000,0,0,0,0,10000,-10000,-10000
058357,智邦凱基99購02  ,0,0,0,0,0,0,0,0,0,-10000,0,0,0,0,10000,-10000,-10000
058323,泰鼎永豐9A購01  ,0,0,0,0,0,0,0,0,0,-10000,0,0,0,0,10000,-10000,-10000
058550,南亞科永豐99購01,0,0,0,0,0,0,0,0,0,-10000,0,0,0,2000,12000,-10000,-10000
058570,臻鼎凱基9A購01  ,0,0,0,0,0,0,0,0,0,-10000,0,0,0,0,10000,-10000,-10000
059562,上銀凱基99購09  ,0,0,0,0,0,0,0,0,0,-10000,0,0,0,40000,50000,-10000,-10000
058879,智邦富邦99購01  ,0,0,0,0,0,0,0,0,0,-10000,0,0,0,0,10000,-10000,-10000
056622,高鐵永豐98購01  ,0,0,0,0,0,0,0,0,0,-10000,0,0,0,0,10000,-10000,-10000
058770,貿聯兆豐9A購01  ,0,0,0,0,0,0,0,0,0,-10000,0,0,0,0,10000,-10000,-10000
056592,台積電元富98購01,0,0,0,0,0,0,0,0,0,-10000,0,0,0,0,10000,-10000,-10000
056600,聯茂元富98購01  ,0,0,0,0,0,0,0,0,0,-10000,0,0,0,15000,25000,-10000,-10000
057796,鴻海兆豐99購03  ,0,0,0,0,0,0,0,0,0,-10000,0,0,0,0,10000,-10000,-10000
057797,大立光兆豐99購01,0,0,0,0,0,0,0,0,0,-10000,0,0,0,0,10000,-10000,-10000
057305,南亞科兆豐98購02,0,0,0,0,0,0,0,0,0,-10000,0,0,0,0,10000,-10000,-10000
057431,京鼎兆豐98購02  ,0,0,0,0,0,0,0,0,0,-10000,0,0,0,0,10000,-10000,-10000
057371,可成元大98購08  ,0,0,0,0,0,0,0,0,0,-10000,0,0,0,0,10000,-10000,-10000
057399,滬深反群益9C購01,0,0,0,0,0,0,0,0,0,-10000,0,0,0,0,10000,-10000,-10000
058221,上銀統一99購04  ,0,0,0,0,0,0,0,0,0,-10000,0,0,0,0,10000,-10000,-10000
058194,勤誠永豐99購01  ,0,0,0,0,0,0,0,0,0,-10000,0,0,0,0,10000,-10000,-10000
057842,緯穎富邦99購02  ,0,0,0,0,0,0,0,0,0,-10000,0,0,0,0,10000,-10000,-10000
05764P,世紀鋼永豐96售03,0,0,0,0,0,0,0,0,0,-10000,0,0,0,0,10000,-10000,-10000
057658,玉晶光兆豐99購02,0,0,0,0,0,0,0,0,0,-10000,0,0,0,0,10000,-10000,-10000
057142,力成兆豐98購01  ,0,0,0,0,0,0,0,0,0,-10000,0,0,0,0,10000,-10000,-10000
057262,友達兆豐98購03  ,0,0,0,0,0,0,0,0,0,-10000,0,0,0,0,10000,-10000,-10000
057263,可成兆豐99購01  ,0,0,0,0,0,0,0,0,0,-10000,0,0,0,0,10000,-10000,-10000
057264,新光金兆豐98購01,0,0,0,0,0,0,0,0,0,-10000,0,0,0,0,10000,-10000,-10000
057292,國巨國泰9B購01  ,0,0,0,0,0,0,0,0,0,-10000,0,0,0,0,10000,-10000,-10000
059508,聯發科永豐99購03,0,0,0,0,0,0,0,0,0,-10000,0,0,0,0,10000,-10000,-10000
059509,奇力新永豐99購02,0,0,0,0,0,0,0,0,0,-10000,0,0,0,3000,13000,-10000,-10000
059491,國巨國票9A購05  ,0,0,0,0,0,0,0,0,0,-10000,0,0,0,0,10000,-10000,-10000
059501,可成元富99購01  ,0,0,0,0,0,0,0,0,0,-10000,0,0,0,25000,35000,-10000,-10000
057138,亞德客兆豐98購01,0,0,0,0,0,0,0,0,0,-10000,0,0,0,0,10000,-10000,-10000
056995,華新科日盛99購01,0,0,0,0,0,0,0,0,0,-10000,0,0,0,0,10000,-10000,-10000
059056,技嘉凱基99購02  ,0,0,0,0,0,0,0,0,0,-10000,0,0,0,0,10000,-10000,-10000
059707,健策凱基9A購03  ,0,0,0,0,0,0,0,0,0,-10000,0,0,0,16000,26000,-10000,-10000
05709P,大立光國票97售01,0,0,0,0,0,0,0,0,0,-10000,0,0,0,0,10000,-10000,-10000
060095,聯發科元大99購42,0,0,0,0,0,0,0,0,0,-10000,0,0,0,0,10000,-10000,-10000
060395,儒鴻國票9A購01  ,0,0,0,0,0,0,0,0,0,-10000,0,0,0,0,10000,-10000,-10000
060503,技嘉元大9A購01  ,0,0,0,0,0,0,0,0,0,-10000,0,0,0,0,10000,-10000,-10000
060469,台勝科元大9A購02,0,0,0,0,0,0,0,0,0,-10000,0,0,0,0,10000,-10000,-10000
056251,聯發科兆豐97購02,0,0,0,0,0,0,0,0,0,-10000,0,0,0,0,10000,-10000,-10000
056252,聯發科兆豐97購03,0,0,0,0,0,0,0,0,0,-10000,0,0,0,0,10000,-10000,-10000
056225,聯發科凱基97購09,0,0,0,0,0,0,0,0,0,-10000,0,0,0,0,10000,-10000,-10000
05803P,臺股指兆豐96售03,0,0,0,0,0,0,0,0,0,-10000,0,0,0,0,10000,-10000,-10000
057994,技嘉中信98購01  ,0,0,0,0,0,0,0,0,0,-10000,0,0,0,0,10000,-10000,-10000
056990,聯發科兆豐98購01,0,0,0,0,0,0,0,0,0,-10000,0,0,0,0,10000,-10000,-10000
056988,聚陽兆豐98購01  ,0,0,0,0,0,0,0,0,0,-10000,0,0,0,0,10000,-10000,-10000
057879,電子類元大99購02,0,0,0,0,0,0,0,0,0,-10000,0,0,0,0,10000,-10000,-10000
057881,SP黃豆群益9A購01,0,0,0,0,0,0,0,0,0,-10000,0,0,0,0,10000,-10000,-10000
056840,友達元富98購02  ,0,0,0,0,0,0,0,0,0,-10000,0,0,0,0,10000,-10000,-10000
056841,友達元富98購03  ,0,0,0,0,0,0,0,0,0,-10000,0,0,0,0,10000,-10000,-10000
056743,貿聯凱基98購04  ,0,0,0,0,0,0,0,0,0,-10000,0,0,0,0,10000,-10000,-10000
056774,和鑫元大98購01  ,0,0,0,0,0,0,0,0,0,-10000,0,0,0,110000,120000,-10000,-10000
059659,旺宏元大9A購03  ,0,0,0,0,0,0,0,0,0,-10000,0,0,0,0,10000,-10000,-10000
05979P,華新科中信96售02,0,0,0,0,0,0,0,0,0,-10000,0,0,0,20000,30000,-10000,-10000
05978P,麗豐永豐96售02  ,0,0,0,0,0,0,0,0,0,-10000,0,0,0,10000,20000,-10000,-10000
059843,華新科富邦9B購03,0,0,0,0,0,0,0,0,0,-10000,0,0,0,0,10000,-10000,-10000
059893,台積電台新9A購02,0,0,0,0,0,0,0,0,0,-10000,0,0,0,13000,23000,-10000,-10000
059869,友達凱基99購07  ,0,0,0,0,0,0,0,0,0,-10000,0,0,0,55000,65000,-10000,-10000
05583P,訊芯凱基96售01  ,0,0,0,0,0,0,0,0,0,-10000,0,0,0,0,10000,-10000,-10000
05590P,臺股指中信96售05,0,0,0,0,0,0,0,0,0,-10000,0,0,0,0,10000,-10000,-10000
055906,大立光兆豐97購03,0,0,0,0,0,0,0,0,0,-10000,0,0,0,0,10000,-10000,-10000
056036,鴻海凱基97購07  ,0,0,0,0,0,0,0,0,0,-10000,0,0,0,0,10000,-10000,-10000
056077,矽力元大97購07  ,0,0,0,0,0,0,0,0,0,-10000,0,0,0,0,10000,-10000,-10000
05419P,矽力永豐95售02  ,0,0,0,0,0,0,0,0,0,-10000,0,0,0,0,10000,-10000,-10000
055663,崇越中信97購01  ,0,0,0,0,0,0,0,0,0,-10000,0,0,0,0,10000,-10000,-10000
059471,華新科元大99購17,0,0,0,0,0,0,0,0,0,-10000,0,0,0,26000,36000,-10000,-10000
059453,奇力新永豐99購01,0,0,0,0,0,0,0,0,0,-10000,0,0,0,2000,12000,-10000,-10000
059981,聯發科元大99購36,0,0,0,0,0,0,0,0,0,-10000,0,0,0,0,10000,-10000,-10000
058636,亞光兆豐9A購01  ,0,0,0,0,0,0,0,0,0,-10000,0,0,0,0,10000,-10000,-10000
057563,旭富國泰9A購01  ,0,0,0,0,0,0,0,0,0,-10000,0,0,0,0,10000,-10000,-10000
057621,崇越凱基98購01  ,0,0,0,0,0,0,0,0,0,-10000,0,0,0,0,10000,-10000,-10000
056479,玉晶光元大99購05,0,0,0,0,0,0,0,0,0,-10000,0,0,0,9000,19000,-10000,-10000
055490,台光電元大97購01,0,0,0,0,0,0,0,0,0,-10000,0,0,0,0,10000,-10000,-10000
055545,國巨凱基97購06  ,0,0,0,0,0,0,0,0,0,-10000,0,0,0,39000,49000,-10000,-10000
055441,緯穎國票98購01  ,0,0,0,0,0,0,0,0,0,-10000,0,0,0,1000,11000,-10000,-10000
054391,宏達電元富96購04,0,0,0,0,0,0,0,0,0,-10000,0,0,0,147000,157000,-10000,-10000
054279,揚明光群益98購01,0,0,0,0,0,0,0,0,0,-10000,0,0,0,0,10000,-10000,-10000
054619,昇陽半永豐97購03,0,0,0,0,0,0,0,0,0,-10000,0,0,0,0,10000,-10000,-10000
054621,華新科兆豐98購01,0,0,0,0,0,0,0,0,0,-10000,0,0,0,0,10000,-10000,-10000
054889,京鼎統一99購01  ,0,0,0,0,0,0,0,0,0,-10000,0,0,0,0,10000,-10000,-10000
054873,帆宣群益99購01  ,0,0,0,0,0,0,0,0,0,-10000,0,0,0,0,10000,-10000,-10000
054896,聯茂日盛97購01  ,0,0,0,0,0,0,0,0,0,-10000,0,0,0,0,10000,-10000,-10000
052811,玉晶光台新96購03,0,0,0,0,0,0,0,0,0,-10000,0,0,0,190000,200000,-10000,-10000
052790,智邦兆豐97購01  ,0,0,0,0,0,0,0,0,0,-10000,0,0,0,30000,40000,-10000,-10000
052791,友達兆豐97購01  ,0,0,0,0,0,0,0,0,0,-10000,0,0,0,0,10000,-10000,-10000
052820,宏達電永豐96購01,0,0,0,0,0,0,0,0,0,-10000,0,0,0,0,10000,-10000,-10000
052825,TPK永豐96購01   ,0,0,0,0,0,0,0,0,0,-10000,0,0,0,0,10000,-10000,-10000
052941,康控兆豐97購01  ,0,0,0,0,0,0,0,0,0,-10000,0,0,0,0,10000,-10000,-10000
052936,華通兆豐98購01  ,0,0,0,0,0,0,0,0,0,-10000,0,0,0,0,10000,-10000,-10000
053050,華通國票97購02  ,0,0,0,0,0,0,0,0,0,-10000,0,0,0,0,10000,-10000,-10000
053110,大立光兆豐97購01,0,0,0,0,0,0,0,0,0,-10000,0,0,0,0,10000,-10000,-10000
053353,玉晶光兆豐97購03,0,0,0,0,0,0,0,0,0,-10000,0,0,0,0,10000,-10000,-10000
053408,友達兆豐98購01  ,0,0,0,0,0,0,0,0,0,-10000,0,0,0,0,10000,-10000,-10000
053419,光罩永豐96購01  ,0,0,0,0,0,0,0,0,0,-10000,0,0,0,0,10000,-10000,-10000
053495,聯發科兆豐96購02,0,0,0,0,0,0,0,0,0,-10000,0,0,0,0,10000,-10000,-10000
053946,全新富邦97購02  ,0,0,0,0,0,0,0,0,0,-10000,0,0,0,0,10000,-10000,-10000
05394P,聯詠中信95售02  ,0,0,0,0,0,0,0,0,0,-10000,0,0,0,0,10000,-10000,-10000
048158,大立光兆豐95購01,0,0,0,0,0,0,0,0,0,-10000,0,0,0,0,10000,-10000,-10000
04881P,高股息凱基96售01,0,0,0,0,0,0,0,0,0,-10000,0,0,0,0,10000,-10000,-10000
048732,台勝科麥證95購01,0,0,0,0,10000,-10000,0,0,0,-10000,0,0,0,0,10000,-10000,-10000
049004,聯發科中信96購01,0,0,0,0,0,0,0,0,0,-10000,0,0,0,0,10000,-10000,-10000
03999P,鴻海凱基94售11  ,0,0,0,0,0,0,0,0,0,-10000,0,0,0,0,10000,-10000,-10000
03671P,大立光凱基95售02,0,0,0,0,0,0,0,0,0,-10000,0,0,0,60000,70000,-10000,-10000
049785,華新科兆豐95購01,0,0,0,0,0,0,0,0,0,-10000,0,0,0,0,10000,-10000,-10000
049425,喬山兆豐95購01  ,0,0,0,0,0,0,0,0,0,-10000,0,0,0,0,10000,-10000,-10000
04496P,國巨國泰96售02  ,0,0,0,0,0,0,0,0,0,-10000,0,0,0,0,10000,-10000,-10000
04633P,旺宏群益96售04  ,0,0,0,0,0,0,0,0,0,-10000,0,0,0,5000,15000,-10000,-10000
047063,漢唐凱基95購01  ,0,0,0,0,0,0,0,0,0,-10000,0,0,0,0,10000,-10000,-10000
055207,致新中信99購01  ,0,0,0,0,0,0,0,0,0,-10000,0,0,0,0,10000,-10000,-10000
055195,昇陽半元富97購02,0,0,0,0,0,0,0,0,0,-10000,0,0,0,0,10000,-10000,-10000
05521P,創意永豐96售01  ,0,0,0,0,0,0,0,0,0,-10000,0,0,0,0,10000,-10000,-10000
053769,香港反元大99購01,0,0,0,0,0,0,0,0,0,-10000,0,0,0,0,10000,-10000,-10000
055288,日電貿元大97購02,0,0,0,0,0,0,0,0,0,-10000,0,0,0,140000,150000,-10000,-10000
053625,國巨兆豐96購03  ,0,0,0,0,0,0,0,0,0,-10000,0,0,0,0,10000,-10000,-10000
053559,台積電國泰98購01,0,0,0,0,0,0,0,0,0,-10000,0,0,0,0,10000,-10000,-10000
053551,可成凱基96購05  ,0,0,0,0,0,0,0,0,0,-10000,0,0,0,0,10000,-10000,-10000
052580,高鐵元富96購01  ,0,0,0,0,0,0,0,0,0,-10000,0,0,0,0,10000,-10000,-10000
052585,友達永豐97購01  ,0,0,0,0,0,0,0,0,0,-10000,0,0,0,0,10000,-10000,-10000
05261P,鴻海元大95售20  ,0,0,0,0,0,0,0,0,0,-10000,0,0,0,0,10000,-10000,-10000
051598,瑞昱兆豐95購01  ,0,0,0,0,0,0,0,0,0,-10000,0,0,0,0,10000,-10000,-10000
049946,智邦兆豐95購01  ,0,0,0,0,0,0,0,0,0,-10000,0,0,0,0,10000,-10000,-10000
04998P,京元電永豐95售01,0,0,0,0,0,0,0,0,0,-10000,0,0,0,0,10000,-10000,-10000
052243,致茂康和95購01  ,0,0,0,0,0,0,0,0,0,-10000,0,0,0,0,10000,-10000,-10000
052360,FB上証國票96購01,0,0,0,0,0,0,0,0,0,-10000,0,0,0,0,10000,-10000,-10000
052221,東元凱基95購01  ,0,0,0,0,0,0,0,0,0,-10000,0,0,0,0,10000,-10000,-10000
052204,台泥中信96購01  ,0,0,0,0,0,0,0,0,0,-10000,0,0,0,0,10000,-10000,-10000
052159,瑞昱永豐95購01  ,0,0,0,0,0,0,0,0,0,-10000,0,0,0,0,10000,-10000,-10000
050722,聯電國票96購01  ,0,0,0,0,0,0,0,0,0,-10000,0,0,0,0,10000,-10000,-10000
05063P,聯電元大96售03  ,0,0,0,0,0,0,0,0,0,-10000,0,0,0,0,10000,-10000,-10000
05062P,大立光富邦98售03,0,0,0,0,0,0,0,0,0,-10000,0,0,0,0,10000,-10000,-10000
050597,聯電麥證94購01  ,0,0,0,0,10000,-10000,0,0,0,-10000,0,0,0,0,10000,-10000,-10000
050921,旺宏凱基95購02  ,0,0,0,0,0,0,0,0,0,-10000,0,0,0,30000,40000,-10000,-10000
050809,鴻海凱基95購08  ,0,0,0,0,0,0,0,0,0,-10000,0,0,0,0,10000,-10000,-10000
05144P,美律永豐95售02  ,0,0,0,0,0,0,0,0,0,-10000,0,0,0,0,10000,-10000,-10000
051393,新光金兆豐96購01,0,0,0,0,0,0,0,0,0,-10000,0,0,0,0,10000,-10000,-10000
3679,新至陞          ,0,7000,-7000,0,0,0,0,0,0,-3000,0,3000,-3000,0,0,0,-10000
2748,雲品            ,4000,14000,-10000,0,0,0,0,0,0,0,0,0,0,0,0,0,-10000
9930,中聯資源        ,7000,15000,-8000,0,0,0,0,0,0,-2000,0,2000,-2000,0,0,0,-10000
8480,泰昇-KY         ,0,4000,-4000,0,0,0,0,0,0,-6000,1000,7000,-6000,0,0,0,-10000
07268P,臺股指元大99售24,0,0,0,0,0,0,0,0,0,-10000,0,0,0,0,10000,-10000,-10000
07279P,台灣50台新99售02,0,0,0,0,0,0,0,0,0,-10000,0,0,0,0,10000,-10000,-10000
07235P,T50正2元大9C售02,0,0,0,0,0,0,0,0,0,-10000,0,0,0,0,10000,-10000,-10000
07230P,滬深2X群益01售02,0,0,0,0,0,0,0,0,0,-10000,0,0,0,0,10000,-10000,-10000
07057P,大立光康和9B售02,0,0,0,0,0,0,0,0,0,-10000,0,0,0,5000,15000,-10000,-10000
07175P,聯詠凱基99售02  ,0,0,0,0,0,0,0,0,0,-10000,0,0,0,0,10000,-10000,-10000
07183P,臺股指凱基99售25,0,0,0,0,0,0,0,0,0,-10000,0,0,0,0,10000,-10000,-10000
06912P,台光電元大99售02,0,0,0,0,0,0,0,0,0,-10000,0,0,0,0,10000,-10000,-10000
06935P,神達元大98售02  ,0,0,0,0,0,0,0,0,0,-10000,0,0,0,0,10000,-10000,-10000
06055P,華通凱基97售04  ,0,0,0,0,0,0,0,0,0,-10000,0,0,0,0,10000,-10000,-10000
060601,技嘉凱基9A購02  ,0,0,0,0,0,0,0,0,0,-10000,0,0,0,0,10000,-10000,-10000
060526,台積電中信9A購02,0,0,0,0,0,0,0,0,0,-10000,0,0,0,1000,11000,-10000,-10000
060636,大毅永豐9A購02  ,0,0,0,0,0,0,0,0,0,-10000,0,0,0,13000,23000,-10000,-10000
060651,瑞儀中信9B購01  ,0,0,0,0,0,0,0,0,0,-10000,0,0,0,0,10000,-10000,-10000
060670,臺指反元大01購03,0,0,0,0,0,0,0,0,0,-10000,0,0,0,0,10000,-10000,-10000
060676,京元電元大9A購03,0,0,0,0,0,0,0,0,0,-10000,0,0,0,0,10000,-10000,-10000
060704,台積電富邦01購01,0,0,0,0,0,0,0,0,0,-10000,0,0,0,0,10000,-10000,-10000
06567P,鴻海永豐98售02  ,0,0,0,0,0,0,0,0,0,-10000,0,0,0,0,10000,-10000,-10000
06533P,上証2X中信9B售01,0,0,0,0,0,0,0,0,0,-10000,0,0,0,0,10000,-10000,-10000
06667P,鴻海凱基98售11  ,0,0,0,0,0,0,0,0,0,-10000,0,0,0,0,10000,-10000,-10000
06269P,群創凱基98售10  ,0,0,0,0,0,0,0,0,0,-10000,0,0,0,0,10000,-10000,-10000
06232P,智易永豐97售01  ,0,0,0,0,0,0,0,0,0,-10000,0,0,0,0,10000,-10000,-10000
06155P,智邦統一97售02  ,0,0,0,0,0,0,0,0,0,-10000,0,0,0,0,10000,-10000,-10000
1108,幸福            ,2000,12000,-10000,0,0,0,0,0,0,0,0,0,0,0,0,0,-10000
07532P,台灣50中信01售02,0,0,0,0,0,0,0,0,0,-10000,0,0,0,0,10000,-10000,-10000
07372P,滬深2X元大99售08,0,0,0,0,0,0,0,0,0,-10000,0,0,0,0,10000,-10000,-10000
07465P,台灣50元大9C售24,0,0,0,0,0,0,0,0,0,-10000,0,0,0,6000,16000,-10000,-10000
2459,敦吉            ,8000,13000,-5000,0,0,0,0,0,0,-5000,0,5000,-5000,0,0,0,-10000
1560,中砂            ,82000,109000,-27000,0,0,0,0,0,0,17000,17000,0,17000,0,0,0,-10000
6670,復盛應用        ,110000,89080,20920,0,0,0,0,30925,-30925,0,0,0,0,0,0,0,-10005
00657,國泰日經225     ,0,0,0,0,0,0,0,0,0,-10112,0,0,0,101000,111112,-10112,-10112
6277,宏正            ,16000,21260,-5260,0,0,0,0,0,0,-5000,0,5000,-5000,0,0,0,-10260
060108,泰鼎元大99購04  ,0,0,0,0,0,0,0,0,0,-11000,0,0,0,1000,12000,-11000,-11000
059705,華新科凱基9A購07,0,0,0,0,0,0,0,0,0,-11000,0,0,0,2000,13000,-11000,-11000
059725,聯發科元大99購31,0,0,0,0,0,0,0,0,0,-11000,0,0,0,2000,13000,-11000,-11000
059526,鴻海凱基99購12  ,0,0,0,0,0,0,0,0,0,-11000,0,0,0,7000,18000,-11000,-11000
058718,台灣50元富03購01,0,0,0,0,0,0,0,0,0,-11000,0,0,0,0,11000,-11000,-11000
04616P,臺股指群益95售02,0,0,0,0,0,0,0,0,0,-11000,0,0,0,23000,34000,-11000,-11000
045479,T50反1中信95購01,0,0,0,0,0,0,0,0,0,-11000,0,0,0,0,11000,-11000,-11000
04604P,華新科國票95售01,0,0,0,0,0,0,0,0,0,-11000,0,0,0,15000,26000,-11000,-11000
05206P,南茂元大95售01  ,0,0,0,0,0,0,0,0,0,-11000,0,0,0,86000,97000,-11000,-11000
050114,群創元大95購01  ,0,0,0,0,0,0,0,0,0,-11000,0,0,0,0,11000,-11000,-11000
051603,深中小群益99購03,0,0,0,0,0,0,0,0,0,-11000,0,0,0,0,11000,-11000,-11000
053849,聯發科元富96購04,0,0,0,0,0,0,0,0,0,-11000,0,0,0,0,11000,-11000,-11000
053727,麗豐凱基97購01  ,0,0,0,0,0,0,0,0,0,-11000,0,0,0,0,11000,-11000,-11000
053053,京元電國票97購02,0,0,0,0,0,0,0,0,0,-11000,0,0,0,0,11000,-11000,-11000
054895,南電統一97購01  ,0,0,0,0,0,0,0,0,0,-11000,0,0,0,14000,25000,-11000,-11000
058672,可成群益9B購02  ,0,0,0,0,0,0,0,0,0,-11000,0,0,0,0,11000,-11000,-11000
056104,義隆永豐97購01  ,0,0,0,0,0,0,0,0,0,-11000,0,0,0,11000,22000,-11000,-11000
6164,華興            ,2000,12000,-10000,0,0,0,0,0,0,-1000,0,1000,-1000,0,0,0,-11000
5225,東科-KY         ,59000,70000,-11000,0,0,0,0,0,0,0,0,0,0,0,0,0,-11000
4976,佳凌            ,51000,61000,-10000,0,0,0,0,0,0,-1000,0,1000,-1000,0,0,0,-11000
9905,大華            ,8000,16000,-8000,0,0,0,0,0,0,-3000,0,3000,-3000,0,0,0,-11000
2527,宏璟            ,14000,25000,-11000,0,0,0,0,0,0,0,0,0,0,0,0,0,-11000
3024,憶聲            ,8000,19000,-11000,0,0,0,0,0,0,0,0,0,0,0,0,0,-11000
3669,圓展            ,90000,101000,-11000,0,0,0,0,0,0,0,0,0,0,0,0,0,-11000
3694,海華            ,9000,20000,-11000,0,0,0,0,0,0,0,0,0,0,0,0,0,-11000
2032,新鋼            ,0,10000,-10000,0,0,0,0,0,0,-1000,0,1000,-1000,0,0,0,-11000
2430,燦坤            ,4000,15000,-11000,0,0,0,0,0,0,0,0,0,0,0,0,0,-11000
07410P,鴻海元大99售44  ,0,0,0,0,0,0,0,0,0,-11000,0,0,0,40000,51000,-11000,-11000
07454P,台積電元大9A售06,0,0,0,0,0,0,0,0,0,-11000,0,0,0,0,11000,-11000,-11000
07387P,臺股指群益99售25,0,0,0,0,0,0,0,0,0,-11000,0,0,0,20000,31000,-11000,-11000
07351P,鴻海國票99售08  ,0,0,0,0,0,0,0,0,0,-11000,0,0,0,10000,21000,-11000,-11000
1437,勤益控          ,23000,26000,-3000,0,0,0,0,0,0,-8000,0,8000,-8000,0,0,0,-11000
06475P,牧德永豐98售03  ,0,0,0,0,0,0,0,0,0,-11000,0,0,0,0,11000,-11000,-11000
060567,華擎富邦9C購01  ,0,0,0,0,0,0,0,0,0,-11000,0,0,0,1000,12000,-11000,-11000
060569,台積電永豐9A購01,0,0,0,0,0,0,0,0,0,-11000,0,0,0,0,11000,-11000,-11000
06900P,FBVIX國票12售01 ,0,0,0,0,0,0,0,0,0,-11000,0,0,0,2000,13000,-11000,-11000
06869P,金融類元大99售01,0,0,0,0,0,0,0,0,0,-11000,0,0,0,0,11000,-11000,-11000
06980P,緯穎永豐99售02  ,0,0,0,0,0,0,0,0,0,-11000,0,0,0,4000,15000,-11000,-11000
057651,矽力元大98購03  ,0,0,0,0,0,0,0,0,0,-12000,0,0,0,0,12000,-12000,-12000
058116,正崴中信99購02  ,0,0,0,0,0,0,0,0,0,-12000,0,0,0,53000,65000,-12000,-12000
059598,欣興元大99購08  ,0,0,0,0,0,0,0,0,0,-12000,0,0,0,4000,16000,-12000,-12000
059246,奇力新凱基9A購02,0,0,0,0,0,0,0,0,0,-12000,0,0,0,2000,14000,-12000,-12000
059766,同欣電永豐99購03,0,0,0,0,0,0,0,0,0,-12000,0,0,0,30000,42000,-12000,-12000
060331,台積電麥證9A購01,0,0,0,0,12000,-12000,0,0,0,-12000,0,0,0,0,12000,-12000,-12000
060393,泰鼎群益9A購01  ,0,0,0,0,0,0,0,0,0,-12000,0,0,0,3000,15000,-12000,-12000
056688,聯詠統一98購01  ,0,0,0,0,0,0,0,0,0,-12000,0,0,0,0,12000,-12000,-12000
056838,旺宏元富98購01  ,0,0,0,0,0,0,0,0,0,-12000,0,0,0,30000,42000,-12000,-12000
057941,聯電國票99購01  ,0,0,0,0,0,0,0,0,0,-12000,0,0,0,114000,126000,-12000,-12000
056911,緯穎元大99購01  ,0,0,0,0,0,0,0,0,0,-12000,0,0,0,9000,21000,-12000,-12000
056330,玉晶光國票99購03,0,0,0,0,0,0,0,0,0,-12000,0,0,0,0,12000,-12000,-12000
056183,南亞科統一97購02,0,0,0,0,0,0,0,0,0,-12000,0,0,0,0,12000,-12000,-12000
058947,SGBR2X群益9B購02,0,0,0,0,0,0,0,0,0,-12000,0,0,0,3000,15000,-12000,-12000
055968,祥碩元大97購04  ,0,0,0,0,0,0,0,0,0,-12000,0,0,0,23000,35000,-12000,-12000
054161,友訊凱基98購01  ,0,0,0,0,0,0,0,0,0,-12000,0,0,0,10000,22000,-12000,-12000
05943P,欣興凱基96售03  ,0,0,0,0,0,0,0,0,0,-12000,0,0,0,0,12000,-12000,-12000
059411,臺股指國票99購17,0,0,0,0,0,0,0,0,0,-12000,0,0,0,5000,17000,-12000,-12000
059987,大立光元大99購28,0,0,0,0,0,0,0,0,0,-12000,0,0,0,0,12000,-12000,-12000
056515,燿華兆豐99購01  ,0,0,0,0,0,0,0,0,0,-12000,0,0,0,2000,14000,-12000,-12000
054742,京鼎凱基99購01  ,0,0,0,0,0,0,0,0,0,-12000,0,0,0,30000,42000,-12000,-12000
053496,義隆兆豐96購02  ,0,0,0,0,0,0,0,0,0,-12000,0,0,0,48000,60000,-12000,-12000
05379P,可成凱基95售11  ,0,0,0,0,0,0,0,0,0,-12000,0,0,0,2000,14000,-12000,-12000
052648,茂林永豐96購01  ,0,0,0,0,0,0,0,0,0,-12000,0,0,0,0,12000,-12000,-12000
07032P,聯發科統一9C售02,0,0,0,0,0,0,0,0,0,-12000,0,0,0,23000,35000,-12000,-12000
07218P,臺股指凱基99售31,0,0,0,0,0,0,0,0,0,-12000,0,0,0,36000,48000,-12000,-12000
07114P,旺宏兆豐9A售01  ,0,0,0,0,0,0,0,0,0,-12000,0,0,0,10000,22000,-12000,-12000
07256P,臺股指凱基99售36,0,0,0,0,0,0,0,0,0,-12000,0,0,0,31000,43000,-12000,-12000
06058P,玉晶光凱基97售04,0,0,0,0,0,0,0,0,0,-12000,0,0,0,150000,162000,-12000,-12000
060527,台積電中信9C購04,0,0,0,0,0,0,0,0,0,-12000,0,0,0,3000,15000,-12000,-12000
060616,宏碁元大9A購02  ,0,0,0,0,0,0,0,0,0,-12000,0,0,0,0,12000,-12000,-12000
060617,華新科元大9A購08,0,0,0,0,0,0,0,0,0,-12000,0,0,0,25000,37000,-12000,-12000
06173P,華通元大97售02  ,0,0,0,0,0,0,0,0,0,-12000,0,0,0,0,12000,-12000,-12000
06374P,台表科元大97售06,0,0,0,0,0,0,0,0,0,-12000,0,0,0,2000,14000,-12000,-12000
07579P,聯茂元大9A售01  ,0,0,0,0,0,0,0,0,0,-12000,0,0,0,45000,57000,-12000,-12000
1506,正道            ,0,12000,-12000,0,0,0,0,0,0,0,0,0,0,0,0,0,-12000
4438,廣越            ,1000,13000,-12000,0,0,0,0,0,0,0,0,0,0,0,0,0,-12000
3167,大量            ,1000,13000,-12000,0,0,0,0,0,0,0,0,0,0,0,0,0,-12000
3027,盛達            ,3000,15000,-12000,0,0,0,0,0,0,0,0,0,0,0,0,0,-12000
2483,百容            ,0,12000,-12000,0,0,0,0,0,0,0,0,0,0,0,0,0,-12000
2491,吉祥全          ,2000,14000,-12000,0,0,0,0,0,0,0,0,0,0,0,0,0,-12000
5706,鳳凰            ,5000,17000,-12000,0,0,0,0,0,0,0,0,0,0,0,0,0,-12000
056883,美食康和98購01  ,0,0,0,0,0,0,0,0,0,-13000,0,0,0,5000,18000,-13000,-13000
056903,大立光元大99購04,0,0,0,0,0,0,0,0,0,-13000,0,0,0,0,13000,-13000,-13000
059877,康控凱基99購05  ,0,0,0,0,0,0,0,0,0,-13000,0,0,0,20000,33000,-13000,-13000
059688,燿華永豐99購01  ,0,0,0,0,0,0,0,0,0,-13000,0,0,0,22000,35000,-13000,-13000
058517,景碩元大99購06  ,0,0,0,0,0,0,0,0,0,-13000,0,0,0,0,13000,-13000,-13000
057525,光磊元大99購01  ,0,0,0,0,0,0,0,0,0,-13000,0,0,0,12000,25000,-13000,-13000
057481,技嘉元大98購04  ,0,0,0,0,0,0,0,0,0,-13000,0,0,0,2000,15000,-13000,-13000
00663L,國泰臺灣加權正2 ,0,0,0,0,0,0,0,0,0,-13000,0,0,0,157000,170000,-13000,-13000
0052,富邦科技        ,1000,1000,0,0,0,0,0,0,0,-13000,0,0,0,100000,113000,-13000,-13000
04840P,大立光元大94售18,0,0,0,0,0,0,0,0,0,-13000,0,0,0,53000,66000,-13000,-13000
055173,瑞昱統一97購01  ,0,0,0,0,0,0,0,0,0,-13000,0,0,0,0,13000,-13000,-13000
05161P,華新科國票96售01,0,0,0,0,0,0,0,0,0,-13000,0,0,0,1000,14000,-13000,-13000
052542,友達元富98購01  ,0,0,0,0,0,0,0,0,0,-13000,0,0,0,178000,191000,-13000,-13000
055687,瀚宇博凱基97購01,0,0,0,0,0,0,0,0,0,-13000,0,0,0,137000,150000,-13000,-13000
055958,台光電元大97購02,0,0,0,0,0,0,0,0,0,-13000,0,0,0,62000,75000,-13000,-13000
6184,大豐電          ,18000,5000,13000,0,0,0,0,0,0,-26000,0,26000,-26000,0,0,0,-13000
8499,鼎炫-KY         ,7000,20000,-13000,0,0,0,0,0,0,0,0,0,0,0,0,0,-13000
3011,今皓            ,0,13000,-13000,0,0,0,0,0,0,0,0,0,0,0,0,0,-13000
3164,景岳            ,11000,23000,-12000,0,0,0,0,0,0,-1000,0,1000,-1000,0,0,0,-13000
1535,中宇            ,2000,15000,-13000,0,0,0,0,0,0,0,0,0,0,0,0,0,-13000
07561P,玉晶光永豐9A售02,0,0,0,0,0,0,0,0,0,-13000,0,0,0,10000,23000,-13000,-13000
06262P,國巨凱基97售07  ,0,0,0,0,0,0,0,0,0,-13000,0,0,0,0,13000,-13000,-13000
06581P,南亞科凱基98售04,0,0,0,0,0,0,0,0,0,-13000,0,0,0,0,13000,-13000,-13000
07242P,台灣50凱基9A售03,0,0,0,0,0,0,0,0,0,-13000,0,0,0,1000,14000,-13000,-13000
07164P,臺股指群益99售15,0,0,0,0,0,0,0,0,0,-13000,0,0,0,60000,73000,-13000,-13000
06868P,電子類元大99售01,0,0,0,0,0,0,0,0,0,-13000,0,0,0,0,13000,-13000,-13000
06903P,技嘉凱基98售04  ,0,0,0,0,0,0,0,0,0,-13000,0,0,0,0,13000,-13000,-13000
1454,台富            ,0,13632,-13632,0,0,0,0,0,0,0,0,0,0,0,0,0,-13632
059062,群創凱基99購05  ,0,0,0,0,0,0,0,0,0,-14000,0,0,0,58000,72000,-14000,-14000
059113,群光永豐99購01  ,0,0,0,0,0,0,0,0,0,-14000,0,0,0,0,14000,-14000,-14000
059671,滬深2X元富99購05,0,0,0,0,0,0,0,0,0,-14000,0,0,0,0,14000,-14000,-14000
056940,嘉聯益元富98購01,0,0,0,0,0,0,0,0,0,-14000,0,0,0,42000,56000,-14000,-14000
060296,和碩元大9A購01  ,0,0,0,0,0,0,0,0,0,-14000,0,0,0,47000,61000,-14000,-14000
060244,大立光元大9B購02,0,0,0,0,0,0,0,0,0,-14000,0,0,0,10000,24000,-14000,-14000
059755,宏達電國泰9A購01,0,0,0,0,0,0,0,0,0,-14000,0,0,0,193000,207000,-14000,-14000
060109,茂林元大99購05  ,0,0,0,0,0,0,0,0,0,-14000,0,0,0,7000,21000,-14000,-14000
060060,台積電兆豐99購05,0,0,0,0,0,0,0,0,0,-14000,0,0,0,18000,32000,-14000,-14000
055813,聯發科國票98購04,0,0,0,0,0,0,0,0,0,-14000,0,0,0,4000,18000,-14000,-14000
055043,中砂永豐97購01  ,0,0,0,0,0,0,0,0,0,-14000,0,0,0,11000,25000,-14000,-14000
059966,台積電凱基99購19,0,0,0,0,0,0,0,0,0,-14000,0,0,0,0,14000,-14000,-14000
058616,台虹元大9A購01  ,0,0,0,0,0,0,0,0,0,-14000,0,0,0,0,14000,-14000,-14000
05524P,瀚宇博國票97售02,0,0,0,0,0,0,0,0,0,-14000,0,0,0,1000,15000,-14000,-14000
00742,新光內需收益    ,0,0,0,0,0,0,0,0,0,-14000,0,0,0,100000,114000,-14000,-14000
1435,中福            ,0,14000,-14000,0,0,0,0,0,0,0,0,0,0,0,0,0,-14000
07389P,臺股指群益9C售08,0,0,0,0,0,0,0,0,0,-14000,0,0,0,3000,17000,-14000,-14000
1711,永光            ,110000,124000,-14000,0,0,0,0,0,0,0,0,0,0,0,0,0,-14000
1721,三晃            ,4000,17000,-13000,0,0,0,0,0,0,-1000,0,1000,-1000,0,0,0,-14000
1773,勝一            ,28000,25000,3000,0,0,0,0,0,0,-17000,0,17000,-17000,0,0,0,-14000
2486,一詮            ,59000,71000,-12000,0,0,0,0,0,0,-2000,0,2000,-2000,0,0,0,-14000
060279,SP黃豆元大9A購01,0,0,0,0,0,0,0,0,0,-14000,0,0,0,4000,18000,-14000,-14000
060275,元黃金元大9A購01,0,0,0,0,0,0,0,0,0,-14000,0,0,0,33000,47000,-14000,-14000
060531,大立光中信9A購04,0,0,0,0,0,0,0,0,0,-14000,0,0,0,0,14000,-14000,-14000
060584,玉晶光元富9A購01,0,0,0,0,0,0,0,0,0,-14000,0,0,0,23000,37000,-14000,-14000
4571,鈞興-KY         ,3000,0,3000,0,0,0,0,0,0,-17000,0,17000,-17000,0,0,0,-14000
2850,新產            ,18000,32000,-14000,0,0,0,0,0,0,0,0,0,0,0,0,0,-14000
2496,卓越            ,0,14000,-14000,0,0,0,0,0,0,0,0,0,0,0,0,0,-14000
4912,聯德控股-KY     ,8000,22000,-14000,0,0,0,0,0,0,0,0,0,0,0,0,0,-14000
4952,凌通            ,6000,20000,-14000,0,0,0,0,0,0,0,0,0,0,0,0,0,-14000
1524,耿鼎            ,2000,16549,-14549,0,0,0,0,0,0,0,0,0,0,0,0,0,-14549
057097,致新元富98購01  ,0,0,0,0,0,0,0,0,0,-15000,0,0,0,0,15000,-15000,-15000
059741,聯發科元富99購07,0,0,0,0,0,0,0,0,0,-15000,0,0,0,0,15000,-15000,-15000
056885,元油2X元大99購03,0,0,0,0,0,0,0,0,0,-15000,0,0,0,0,15000,-15000,-15000
058033,景碩永豐98購02  ,0,0,0,0,0,0,0,0,0,-15000,0,0,0,10000,25000,-15000,-15000
058948,道瓊銀群益9C購01,0,0,0,0,0,0,0,0,0,-15000,0,0,0,0,15000,-15000,-15000
059690,建準永豐99購01  ,0,0,0,0,0,0,0,0,0,-15000,0,0,0,5000,20000,-15000,-15000
059175,臺股指凱基99購26,0,0,0,0,0,0,0,0,0,-15000,0,0,0,0,15000,-15000,-15000
059314,上銀元大99購03  ,0,0,0,0,0,0,0,0,0,-15000,0,0,0,0,15000,-15000,-15000
059640,聯詠凱基99購04  ,0,0,0,0,0,0,0,0,0,-15000,0,0,0,103000,118000,-15000,-15000
059378,台光電群益9B購01,0,0,0,0,0,0,0,0,0,-15000,0,0,0,35000,50000,-15000,-15000
058482,祥碩凱基99購02  ,0,0,0,0,0,0,0,0,0,-15000,0,0,0,5000,20000,-15000,-15000
058545,義隆富邦9C購01  ,0,0,0,0,0,0,0,0,0,-15000,0,0,0,12000,27000,-15000,-15000
059589,國巨元大9A購02  ,0,0,0,0,0,0,0,0,0,-15000,0,0,0,0,15000,-15000,-15000
059571,奇力新凱基99購06,0,0,0,0,0,0,0,0,0,-15000,0,0,0,0,15000,-15000,-15000
058264,瑞昱永豐99購01  ,0,0,0,0,0,0,0,0,0,-15000,0,0,0,5000,20000,-15000,-15000
04925P,和碩元大94售03  ,0,0,0,0,0,0,0,0,0,-15000,0,0,0,0,15000,-15000,-15000
051903,T50反1元大97購02,0,0,0,0,0,0,0,0,0,-15000,0,0,0,0,15000,-15000,-15000
046628,大立光統一98購01,0,0,0,0,0,0,0,0,0,-15000,0,0,0,0,15000,-15000,-15000
055168,光罩統一98購01  ,0,0,0,0,0,0,0,0,0,-15000,0,0,0,0,15000,-15000,-15000
052511,聯發科凱基95購14,0,0,0,0,0,0,0,0,0,-15000,0,0,0,0,15000,-15000,-15000
050420,鴻海凱基95購03  ,0,0,0,0,0,0,0,0,0,-15000,0,0,0,5000,20000,-15000,-15000
051318,上銀國票96購01  ,0,0,0,0,0,0,0,0,0,-15000,0,0,0,2000,17000,-15000,-15000
059432,聯發科元大99購26,0,0,0,0,0,0,0,0,0,-15000,0,0,0,0,15000,-15000,-15000
056119,欣興群益97購02  ,0,0,0,0,0,0,0,0,0,-15000,0,0,0,0,15000,-15000,-15000
055715,智邦元大97購04  ,0,0,0,0,0,0,0,0,0,-15000,0,0,0,34000,49000,-15000,-15000
055433,嘉聯益群益99購01,0,0,0,0,0,0,0,0,0,-15000,0,0,0,238000,253000,-15000,-15000
054021,義隆台新96購01  ,0,0,0,0,0,0,0,0,0,-15000,0,0,0,0,15000,-15000,-15000
2069,運錩            ,4000,16000,-12000,0,0,0,0,0,0,-3000,0,3000,-3000,0,0,0,-15000
2029,盛餘            ,4000,19000,-15000,0,0,0,0,0,0,0,0,0,0,0,0,0,-15000
2114,鑫永銓          ,1000,16000,-15000,0,0,0,0,0,0,0,0,0,0,0,0,0,-15000
07378P,大立光元大99售29,0,0,0,0,0,0,0,0,0,-15000,0,0,0,15000,30000,-15000,-15000
07474P,滬深2X群益9C售03,0,0,0,0,0,0,0,0,0,-15000,0,0,0,0,15000,-15000,-15000
1446,宏和            ,26000,39000,-13000,0,0,0,0,0,0,-2000,0,2000,-2000,0,0,0,-15000
060588,台灣50台新9A購03,0,0,0,0,0,0,0,0,0,-15000,0,0,0,0,15000,-15000,-15000
060603,聯發科凱基9A購12,0,0,0,0,0,0,0,0,0,-15000,0,0,0,0,15000,-15000,-15000
06634P,欣興國票98售02  ,0,0,0,0,0,0,0,0,0,-15000,0,0,0,43000,58000,-15000,-15000
060417,正隆永豐9A購01  ,0,0,0,0,0,0,0,0,0,-15000,0,0,0,0,15000,-15000,-15000
06890P,金融類元大98售02,0,0,0,0,0,0,0,0,0,-15000,0,0,0,0,15000,-15000,-15000
06845P,億光元大98售02  ,0,0,0,0,0,0,0,0,0,-15000,0,0,0,5000,20000,-15000,-15000
07253P,台灣50凱基9A售05,0,0,0,0,0,0,0,0,0,-15000,0,0,0,0,15000,-15000,-15000
07223P,鴻海元大99售29  ,0,0,0,0,0,0,0,0,0,-15000,0,0,0,0,15000,-15000,-15000
6192,巨路            ,33000,48000,-15000,0,0,0,0,0,0,0,0,0,0,0,0,0,-15000
6655,科定            ,0,10000,-10000,0,0,0,0,0,0,-5000,0,5000,-5000,0,0,0,-15000
2705,六福            ,0,15000,-15000,0,0,0,0,0,0,0,0,0,0,0,0,0,-15000
3535,晶彩科          ,89000,104000,-15000,0,0,0,0,0,0,0,0,0,0,0,0,0,-15000
057378,康友元大98購02  ,0,0,0,0,0,0,0,0,0,-16000,0,0,0,10000,26000,-16000,-16000
057334,技嘉國票98購02  ,0,0,0,0,0,0,0,0,0,-16000,0,0,0,5000,21000,-16000,-16000
058698,華通元大99購05  ,0,0,0,0,0,0,0,0,0,-16000,0,0,0,0,16000,-16000,-16000
057132,華新科凱基98購05,0,0,0,0,0,0,0,0,0,-16000,0,0,0,17000,33000,-16000,-16000
059594,奇力新元大9B購01,0,0,0,0,0,0,0,0,0,-16000,0,0,0,5000,21000,-16000,-16000
059669,台灣50元富9B購05,0,0,0,0,0,0,0,0,0,-16000,0,0,0,80000,96000,-16000,-16000
059828,健策凱基99購05  ,0,0,0,0,0,0,0,0,0,-16000,0,0,0,89000,105000,-16000,-16000
059867,華邦電凱基99購02,0,0,0,0,0,0,0,0,0,-16000,0,0,0,79000,95000,-16000,-16000
056794,上銀麥證98購01  ,0,0,0,24000,40000,-16000,0,0,0,-16000,0,0,0,24000,40000,-16000,-16000
058015,旺宏凱基99購02  ,0,0,0,0,0,0,0,0,0,-16000,0,0,0,0,16000,-16000,-16000
059914,台積電元大99購47,0,0,0,0,0,0,0,0,0,-16000,0,0,0,30000,46000,-16000,-16000
059721,旺宏元大99購16  ,0,0,0,0,0,0,0,0,0,-16000,0,0,0,4000,20000,-16000,-16000
055557,華新科凱基97購01,0,0,0,0,0,0,0,0,0,-16000,0,0,0,0,16000,-16000,-16000
053446,欣興凱基96購02  ,0,0,0,0,0,0,0,0,0,-16000,0,0,0,0,16000,-16000,-16000
053309,泰鼎凱基96購03  ,0,0,0,0,0,0,0,0,0,-16000,0,0,0,11000,27000,-16000,-16000
057553,景碩凱基98購03  ,0,0,0,0,0,0,0,0,0,-16000,0,0,0,0,16000,-16000,-16000
052374,瑞昱元大95購02  ,0,0,0,0,0,0,0,0,0,-16000,0,0,0,2000,18000,-16000,-16000
052654,友達統一97購01  ,0,0,0,0,0,0,0,0,0,-16000,0,0,0,0,16000,-16000,-16000
035276,南亞科台新97購01,0,0,0,0,0,0,0,0,0,-16000,0,0,0,0,16000,-16000,-16000
00728,第一金工業30    ,0,0,0,0,0,0,0,0,0,-16000,0,0,0,420000,436000,-16000,-16000
6165,捷泰            ,14000,30000,-16000,0,0,0,0,0,0,0,0,0,0,0,0,0,-16000
6215,和椿            ,12000,28000,-16000,0,0,0,0,0,0,0,0,0,0,0,0,0,-16000
07160P,台灣50中信03售04,0,0,0,0,0,0,0,0,0,-16000,0,0,0,0,16000,-16000,-16000
07150P,和碩元大99售01  ,0,0,0,0,0,0,0,0,0,-16000,0,0,0,0,16000,-16000,-16000
06365P,鴻海凱基97售09  ,0,0,0,0,0,0,0,0,0,-16000,0,0,0,0,16000,-16000,-16000
060586,玉晶光元富9A購03,0,0,0,0,0,0,0,0,0,-16000,0,0,0,2000,18000,-16000,-16000
060563,智邦富邦9A購01  ,0,0,0,0,0,0,0,0,0,-16000,0,0,0,8000,24000,-16000,-16000
07388P,臺股指群益9C售07,0,0,0,0,0,0,0,0,0,-16000,0,0,0,0,16000,-16000,-16000
1727,中華化          ,0,15000,-15000,0,0,0,0,0,0,-1000,0,1000,-1000,0,0,0,-16000
06007P,世芯永豐96售01  ,0,0,0,0,0,0,0,0,0,-17000,0,0,0,3000,20000,-17000,-17000
060346,華新科統一01購01,0,0,0,0,0,0,0,0,0,-17000,0,0,0,0,17000,-17000,-17000
05889P,群創元大98售02  ,0,0,0,0,0,0,0,0,0,-17000,0,0,0,0,17000,-17000,-17000
058801,致伸元大99購01  ,0,0,0,0,0,0,0,0,0,-17000,0,0,0,0,17000,-17000,-17000
059321,欣興元大99購07  ,0,0,0,0,0,0,0,0,0,-17000,0,0,0,13000,30000,-17000,-17000
059107,南茂國泰9A購01  ,0,0,0,0,0,0,0,0,0,-17000,0,0,0,105000,122000,-17000,-17000
058274,世紀鋼永豐99購01,0,0,0,0,0,0,0,0,0,-17000,0,0,0,15000,32000,-17000,-17000
05525P,奇力新群益96售02,0,0,0,0,0,0,0,0,0,-17000,0,0,0,59000,76000,-17000,-17000
05499P,聯詠元富95售02  ,0,0,0,0,0,0,0,0,0,-17000,0,0,0,200000,217000,-17000,-17000
053062,緯穎富邦97購01  ,0,0,0,0,0,0,0,0,0,-17000,0,0,0,31000,48000,-17000,-17000
054384,瀚宇博群益96購02,0,0,0,0,0,0,0,0,0,-17000,0,0,0,57000,74000,-17000,-17000
054457,強茂群益96購01  ,0,0,0,0,0,0,0,0,0,-17000,0,0,0,3000,20000,-17000,-17000
2038,海光            ,1000,17000,-16000,0,0,0,0,0,0,-1000,0,1000,-1000,0,0,0,-17000
2414,精技            ,11000,27000,-16000,0,0,0,0,0,0,-1000,0,1000,-1000,0,0,0,-17000
1315,達新            ,20000,36000,-16000,0,0,0,0,0,0,-1000,0,1000,-1000,0,0,0,-17000
1203,味王            ,4000,21000,-17000,0,0,0,0,0,0,0,0,0,0,0,0,0,-17000
07133P,臺股指元大9A售27,0,0,0,0,0,0,0,0,0,-17000,0,0,0,0,17000,-17000,-17000
6226,光鼎            ,96000,113000,-17000,0,0,0,0,0,0,0,0,0,0,0,0,0,-17000
5525,順天            ,9000,26000,-17000,0,0,0,0,0,0,0,0,0,0,0,0,0,-17000
00830,國泰費城半導體  ,39000,122000,-83000,0,0,0,0,0,0,65600,79000,2000,77000,83000,94400,-11400,-17400
058295,欣興凱基99購02  ,0,0,0,0,0,0,0,0,0,-18000,0,0,0,163000,181000,-18000,-18000
059529,華新科凱基9A購04,0,0,0,0,0,0,0,0,0,-18000,0,0,0,22000,40000,-18000,-18000
05719P,可成元大96售03  ,0,0,0,0,0,0,0,0,0,-18000,0,0,0,3000,21000,-18000,-18000
058793,鴻海元大99購19  ,0,0,0,0,0,0,0,0,0,-18000,0,0,0,0,18000,-18000,-18000
058481,玉晶光凱基9A購04,0,0,0,0,0,0,0,0,0,-18000,0,0,0,5000,23000,-18000,-18000
060063,可成兆豐9B購01  ,0,0,0,0,0,0,0,0,0,-18000,0,0,0,0,18000,-18000,-18000
03033X,元展30          ,0,0,0,0,0,0,0,0,0,-18000,0,0,0,0,18000,-18000,-18000
052667,漢唐群益96購01  ,0,0,0,0,0,0,0,0,0,-18000,0,0,0,32000,50000,-18000,-18000
04250P,嘉晶統一95售02  ,0,0,0,0,0,0,0,0,0,-18000,0,0,0,0,18000,-18000,-18000
051552,牧德永豐95購03  ,0,0,0,0,0,0,0,0,0,-18000,0,0,0,196000,214000,-18000,-18000
052895,台積電群益96購04,0,0,0,0,0,0,0,0,0,-18000,0,0,0,60000,78000,-18000,-18000
056122,勤誠群益97購02  ,0,0,0,0,0,0,0,0,0,-18000,0,0,0,6000,24000,-18000,-18000
8114,振樺電          ,7000,25000,-18000,0,0,0,0,0,0,0,0,0,0,0,0,0,-18000
9908,大台北          ,34000,46000,-12000,0,0,0,0,0,0,-6000,0,6000,-6000,0,0,0,-18000
2832,台產            ,25000,43000,-18000,0,0,0,0,0,0,0,0,0,0,0,0,0,-18000
3004,豐達科          ,48000,66000,-18000,0,0,0,0,0,0,0,0,0,0,0,0,0,-18000
2816,旺旺保          ,11000,21000,-10000,0,0,0,0,0,0,-8000,0,8000,-8000,0,0,0,-18000
07109P,聯發科中信9B售02,0,0,0,0,0,0,0,0,0,-18000,0,0,0,32000,50000,-18000,-18000
06739P,聯詠兆豐98售02  ,0,0,0,0,0,0,0,0,0,-18000,0,0,0,0,18000,-18000,-18000
06850P,聯茂元大98售06  ,0,0,0,0,0,0,0,0,0,-18000,0,0,0,2000,20000,-18000,-18000
060710,上銀永豐9A購01  ,0,0,0,0,0,0,0,0,0,-18000,0,0,0,0,18000,-18000,-18000
06323P,台郡統一97售01  ,0,0,0,0,0,0,0,0,0,-18000,0,0,0,0,18000,-18000,-18000
2461,光群雷          ,30000,44000,-14000,0,0,0,0,0,0,-4000,0,4000,-4000,0,0,0,-18000
1521,大億            ,2000,20000,-18000,0,0,0,0,0,0,0,0,0,0,0,0,0,-18000
2912,統一超          ,228000,208040,19960,0,0,0,0,2111,-2111,-36000,3000,39000,-36000,0,0,0,-18151
060065,大立光兆豐9B購01,0,0,0,0,0,0,0,0,0,-19000,0,0,0,14000,33000,-19000,-19000
059731,康控元大99購04  ,0,0,0,0,0,0,0,0,0,-19000,0,0,0,7000,26000,-19000,-19000
060203,緯穎元富9A購01  ,0,0,0,0,0,0,0,0,0,-19000,0,0,0,0,19000,-19000,-19000
057969,緯穎國泰99購01  ,0,0,0,0,0,0,0,0,0,-19000,0,0,0,11000,30000,-19000,-19000
059169,可成凱基99購04  ,0,0,0,0,0,0,0,0,0,-19000,0,0,0,1000,20000,-19000,-19000
059265,美律中信01購01  ,0,0,0,0,0,0,0,0,0,-19000,0,0,0,0,19000,-19000,-19000
058115,台光電中信99購01,0,0,0,0,0,0,0,0,0,-19000,0,0,0,65000,84000,-19000,-19000
058580,華新科群益99購02,0,0,0,0,0,0,0,0,0,-19000,0,0,0,0,19000,-19000,-19000
059435,大立光元大99購17,0,0,0,0,0,0,0,0,0,-19000,0,0,0,6000,25000,-19000,-19000
059955,美食康和99購01  ,0,0,0,0,0,0,0,0,0,-19000,0,0,0,0,19000,-19000,-19000
059984,華新科元大99購21,0,0,0,0,0,0,0,0,0,-19000,0,0,0,25000,44000,-19000,-19000
055798,聯茂富邦98購01  ,0,0,0,0,0,0,0,0,0,-19000,0,0,0,0,19000,-19000,-19000
056003,智伸科永豐97購02,0,0,0,0,0,0,0,0,0,-19000,0,0,0,0,19000,-19000,-19000
052959,聯電凱基97購01  ,0,0,0,0,0,0,0,0,0,-19000,0,0,0,159000,178000,-19000,-19000
053134,南亞科國票97購01,0,0,0,0,0,0,0,0,0,-19000,0,0,0,41000,60000,-19000,-19000
5203,訊連            ,73000,93000,-20000,0,0,0,0,0,0,1000,11000,10000,1000,0,0,0,-19000
6155,鈞寶            ,44000,62000,-18000,0,0,0,0,0,0,-1000,0,1000,-1000,0,0,0,-19000
2405,浩鑫            ,87000,106000,-19000,0,0,0,0,0,0,0,0,0,0,0,0,0,-19000
07288P,台灣50凱基99售06,0,0,0,0,0,0,0,0,0,-19000,0,0,0,46000,65000,-19000,-19000
057848,台表科永豐98購02,0,0,0,0,0,0,0,0,0,-20000,0,0,0,0,20000,-20000,-20000
058206,祥碩凱基99購01  ,0,0,0,0,0,0,0,0,0,-20000,0,0,0,47000,67000,-20000,-20000
057276,全新元大99購03  ,0,0,0,0,0,0,0,0,0,-20000,0,0,0,0,20000,-20000,-20000
059255,臺股指凱基99購33,0,0,0,0,0,0,0,0,0,-20000,0,0,0,22000,42000,-20000,-20000
059381,TPK亞東99購01   ,0,0,0,0,0,0,0,0,0,-20000,0,0,0,0,20000,-20000,-20000
058560,T50反1凱基9A購04,0,0,0,0,0,0,0,0,0,-20000,0,0,0,0,20000,-20000,-20000
058565,鴻海凱基9A購07  ,0,0,0,0,0,0,0,0,0,-20000,0,0,0,10000,30000,-20000,-20000
058334,鴻海元富99購05  ,0,0,0,0,0,0,0,0,0,-20000,0,0,0,0,20000,-20000,-20000
058335,鴻海元富99購06  ,0,0,0,0,0,0,0,0,0,-20000,0,0,0,0,20000,-20000,-20000
059595,華新科元大9A購03,0,0,0,0,0,0,0,0,0,-20000,0,0,0,17000,37000,-20000,-20000
058854,樺漢群益9B購01  ,0,0,0,0,0,0,0,0,0,-20000,0,0,0,0,20000,-20000,-20000
056162,祥碩凱基97購03  ,0,0,0,0,0,0,0,0,0,-20000,0,0,0,3000,23000,-20000,-20000
056170,鴻海元富97購09  ,0,0,0,0,0,0,0,0,0,-20000,0,0,0,0,20000,-20000,-20000
057979,華新科永豐98購03,0,0,0,0,0,0,0,0,0,-20000,0,0,0,0,20000,-20000,-20000
056354,國巨元大98購10  ,0,0,0,0,0,0,0,0,0,-20000,0,0,0,179000,199000,-20000,-20000
056813,聯茂統一99購01  ,0,0,0,0,0,0,0,0,0,-20000,0,0,0,0,20000,-20000,-20000
059850,日電貿永豐99購01,0,0,0,0,0,0,0,0,0,-20000,0,0,0,43000,63000,-20000,-20000
059824,大立光凱基99購13,0,0,0,0,0,0,0,0,0,-20000,0,0,0,0,20000,-20000,-20000
060379,T50反1凱基9A購07,0,0,0,0,0,0,0,0,0,-20000,0,0,0,0,20000,-20000,-20000
060455,葡萄王元大9A購02,0,0,0,0,0,0,0,0,0,-20000,0,0,0,0,20000,-20000,-20000
059765,嘉聯益永豐99購02,0,0,0,0,0,0,0,0,0,-20000,0,0,0,43000,63000,-20000,-20000
059937,旺宏永豐99購03  ,0,0,0,0,0,0,0,0,0,-20000,0,0,0,0,20000,-20000,-20000
059923,緯穎元大99購09  ,0,0,0,0,0,0,0,0,0,-20000,0,0,0,2000,22000,-20000,-20000
053321,智原群益96購02  ,0,0,0,0,0,0,0,0,0,-20000,0,0,0,0,20000,-20000,-20000
053397,國泰金中信96購01,0,0,0,0,0,0,0,0,0,-20000,0,0,0,0,20000,-20000,-20000
053398,和鑫中信99購01  ,0,0,0,0,0,0,0,0,0,-20000,0,0,0,0,20000,-20000,-20000
053351,A50正2兆豐97購01,0,0,0,0,0,0,0,0,0,-20000,0,0,0,0,20000,-20000,-20000
052939,富邦金兆豐96購01,0,0,0,0,0,0,0,0,0,-20000,0,0,0,0,20000,-20000,-20000
05276P,GIS永豐95售02   ,0,0,0,0,0,0,0,0,0,-20000,0,0,0,0,20000,-20000,-20000
052708,楠梓電永豐97購01,0,0,0,0,0,0,0,0,0,-20000,0,0,0,204000,224000,-20000,-20000
054616,智伸科永豐97購01,0,0,0,0,0,0,0,0,0,-20000,0,0,0,0,20000,-20000,-20000
054738,聯發科凱基97購01,0,0,0,0,0,0,0,0,0,-20000,0,0,0,0,20000,-20000,-20000
054649,聯茂群益97購01  ,0,0,0,0,0,0,0,0,0,-20000,0,0,0,0,20000,-20000,-20000
054597,南亞台新97購01  ,0,0,0,0,0,0,0,0,0,-20000,0,0,0,0,20000,-20000,-20000
054378,楠梓電群益98購01,0,0,0,0,0,0,0,0,0,-20000,0,0,0,1000,21000,-20000,-20000
055803,鎧勝永豐97購01  ,0,0,0,0,0,0,0,0,0,-20000,0,0,0,54000,74000,-20000,-20000
055776,宏達電凱基98購02,0,0,0,0,0,0,0,0,0,-20000,0,0,0,17000,37000,-20000,-20000
055887,上銀統一97購03  ,0,0,0,0,0,0,0,0,0,-20000,0,0,0,0,20000,-20000,-20000
055031,南港富邦99購01  ,0,0,0,0,0,0,0,0,0,-20000,0,0,0,0,20000,-20000,-20000
054120,奇力新永豐96購01,0,0,0,0,0,0,0,0,0,-20000,0,0,0,0,20000,-20000,-20000
055671,世紀鋼群益97購01,0,0,0,0,0,0,0,0,0,-20000,0,0,0,0,20000,-20000,-20000
054223,大立光統一98購04,0,0,0,0,0,0,0,0,0,-20000,0,0,0,0,20000,-20000,-20000
059954,華新科康和99購01,0,0,0,0,0,0,0,0,0,-20000,0,0,0,46000,66000,-20000,-20000
056413,上証反中信9A購01,0,0,0,0,0,0,0,0,0,-20000,0,0,0,0,20000,-20000,-20000
056405,聯茂群益98購01  ,0,0,0,0,0,0,0,0,0,-20000,0,0,0,6000,26000,-20000,-20000
056408,奇鋐國票99購01  ,0,0,0,0,0,0,0,0,0,-20000,0,0,0,26000,46000,-20000,-20000
052515,矽力凱基95購02  ,0,0,0,0,0,0,0,0,0,-20000,0,0,0,0,20000,-20000,-20000
052544,牧德元富95購01  ,0,0,0,0,0,0,0,0,0,-20000,0,0,0,10000,30000,-20000,-20000
052568,漢唐凱基96購02  ,0,0,0,0,0,0,0,0,0,-20000,0,0,0,0,20000,-20000,-20000
053599,崇越元大96購01  ,0,0,0,0,0,0,0,0,0,-20000,0,0,0,0,20000,-20000,-20000
055249,大毅統一99購01  ,0,0,0,0,0,0,0,0,0,-20000,0,0,0,0,20000,-20000,-20000
053768,S&P反1元大99購01,0,0,0,0,0,0,0,0,0,-20000,0,0,0,52000,72000,-20000,-20000
055174,精元統一97購01  ,0,0,0,0,0,0,0,0,0,-20000,0,0,0,0,20000,-20000,-20000
050551,大立光凱基95購05,0,0,0,0,0,0,0,0,0,-20000,0,0,0,0,20000,-20000,-20000
050575,南亞科國票94購01,0,0,0,0,0,0,0,0,0,-20000,0,0,0,0,20000,-20000,-20000
051222,世紀鋼元富95購01,0,0,0,0,0,0,0,0,0,-20000,0,0,0,0,20000,-20000,-20000
051133,台積電永豐95購02,0,0,0,0,0,0,0,0,0,-20000,0,0,0,0,20000,-20000,-20000
050760,矽力元富94購03  ,0,0,0,0,0,0,0,0,0,-20000,0,0,0,0,20000,-20000,-20000
052659,上証2X國票99購01,0,0,0,0,0,0,0,0,0,-20000,0,0,0,0,20000,-20000,-20000
052068,瑞儀兆豐96購01  ,0,0,0,0,0,0,0,0,0,-20000,0,0,0,0,20000,-20000,-20000
049784,台積電兆豐94購05,0,0,0,0,0,0,0,0,0,-20000,0,0,0,0,20000,-20000,-20000
049797,台積電元大94購17,0,0,0,0,0,0,0,0,0,-20000,0,0,0,0,20000,-20000,-20000
051807,瑞昱凱基95購03  ,0,0,0,0,0,0,0,0,0,-20000,0,0,0,0,20000,-20000,-20000
051769,矽力元大95購01  ,0,0,0,0,0,0,0,0,0,-20000,0,0,0,0,20000,-20000,-20000
051953,矽力元富95購03  ,0,0,0,0,0,0,0,0,0,-20000,0,0,0,0,20000,-20000,-20000
03658C,T50反1元大9A牛02,0,0,0,0,0,0,0,0,0,-20000,0,0,0,105000,125000,-20000,-20000
07233P,台灣50元大99售04,0,0,0,0,0,0,0,0,0,-20000,0,0,0,11000,31000,-20000,-20000
06813P,友訊元富98售03  ,0,0,0,0,0,0,0,0,0,-20000,0,0,0,0,20000,-20000,-20000
060538,S&P反1凱基9A購01,0,0,0,0,0,0,0,0,0,-20000,0,0,0,22000,42000,-20000,-20000
07577P,華新科元大9A售09,0,0,0,0,0,0,0,0,0,-20000,0,0,0,0,20000,-20000,-20000
07564P,臺股指中信01售01,0,0,0,0,0,0,0,0,0,-20000,0,0,0,0,20000,-20000,-20000
07526P,臺股指中信9B售08,0,0,0,0,0,0,0,0,0,-20000,0,0,0,10000,30000,-20000,-20000
07376P,聯發科元大99售39,0,20000,-20000,0,0,0,0,0,0,0,0,0,0,20000,20000,0,-20000
07373P,A50正2元大99售01,0,0,0,0,0,0,0,0,0,-20000,0,0,0,0,20000,-20000,-20000
07416P,台積電元大99售53,0,0,0,0,0,0,0,0,0,-20000,0,0,0,90000,110000,-20000,-20000
07475P,A50正2群益9C售02,0,0,0,0,0,0,0,0,0,-20000,0,0,0,0,20000,-20000,-20000
07440P,臺股指麥證9B售02,0,0,0,20000,40000,-20000,0,0,0,-20000,0,0,0,20000,40000,-20000,-20000
8201,無敵            ,6000,26000,-20000,0,0,0,0,0,0,0,0,0,0,0,0,0,-20000
3645,達邁            ,29000,44000,-15000,0,0,0,0,0,0,-5000,0,5000,-5000,0,0,0,-20000
060249,正文元大9C購01  ,0,0,0,0,0,0,0,0,0,-21000,0,0,0,183000,204000,-21000,-21000
05987P,健策統一96售02  ,0,0,0,0,0,0,0,0,0,-21000,0,0,0,0,21000,-21000,-21000
056954,聯詠富邦9A購01  ,0,0,0,0,0,0,0,0,0,-21000,0,0,0,254000,275000,-21000,-21000
058835,元油2X中信9C購02,0,0,0,0,0,0,0,0,0,-21000,0,0,0,0,21000,-21000,-21000
058788,喬山元大99購01  ,0,0,0,0,0,0,0,0,0,-21000,0,0,0,100000,121000,-21000,-21000
059360,全新永豐99購02  ,0,0,0,0,0,0,0,0,0,-21000,0,0,0,4000,25000,-21000,-21000
057240,茂林凱基9A購01  ,0,0,0,0,0,0,0,0,0,-21000,0,0,0,0,21000,-21000,-21000
057189,康控元大98購02  ,0,0,0,0,0,0,0,0,0,-21000,0,0,0,17000,38000,-21000,-21000
057530,奇鋐元大99購01  ,0,0,0,0,0,0,0,0,0,-21000,0,0,0,47000,68000,-21000,-21000
00736,國泰新興市場    ,0,0,0,0,0,0,0,0,0,-21000,0,0,0,103000,124000,-21000,-21000
047694,SP黃豆國票9B購01,0,0,0,0,0,0,0,0,0,-21000,0,0,0,0,21000,-21000,-21000
055257,景碩統一97購01  ,0,0,0,0,0,0,0,0,0,-21000,0,0,0,2000,23000,-21000,-21000
057630,茂林永豐98購01  ,0,0,0,0,0,0,0,0,0,-21000,0,0,0,1000,22000,-21000,-21000
057556,智易凱基99購01  ,0,0,0,0,0,0,0,0,0,-21000,0,0,0,0,21000,-21000,-21000
059452,全新永豐99購03  ,0,0,0,0,0,0,0,0,0,-21000,0,0,0,7000,28000,-21000,-21000
059967,聯發科凱基99購20,0,0,0,0,0,0,0,0,0,-21000,0,0,0,0,21000,-21000,-21000
059405,台灣50國票01購01,0,0,0,0,0,0,0,0,0,-21000,0,0,0,23000,44000,-21000,-21000
059397,T50反1元富99購05,0,0,0,0,0,0,0,0,0,-21000,0,0,0,1143000,1164000,-21000,-21000
058617,南電元大99購01  ,0,0,0,0,0,0,0,0,0,-21000,0,0,0,31000,52000,-21000,-21000
055875,光罩元富97購02  ,0,0,0,0,0,0,0,0,0,-21000,0,0,0,19000,40000,-21000,-21000
054064,台郡國票97購04  ,0,0,0,0,0,0,0,0,0,-21000,0,0,0,0,21000,-21000,-21000
054802,高股息元大97購01,0,0,0,0,0,0,0,0,0,-21000,0,0,0,10000,31000,-21000,-21000
3057,喬鼎            ,0,21000,-21000,0,0,0,0,0,0,0,0,0,0,0,0,0,-21000
2616,山隆            ,2000,23000,-21000,0,0,0,0,0,0,0,0,0,0,0,0,0,-21000
07444P,聯發科凱基9A售10,0,0,0,0,0,0,0,0,0,-21000,0,0,0,0,21000,-21000,-21000
1218,泰山            ,135000,113000,22000,0,0,0,0,0,0,-43000,0,43000,-43000,0,0,0,-21000
2010,春源            ,8000,28000,-20000,0,0,0,0,0,0,-1000,0,1000,-1000,0,0,0,-21000
06515P,國巨凱基98售06  ,0,0,0,0,0,0,0,0,0,-21000,0,0,0,81000,102000,-21000,-21000
06734P,智邦凱基98售05  ,0,0,0,0,0,0,0,0,0,-21000,0,0,0,10000,31000,-21000,-21000
07050P,宏達電中信9B售01,0,0,0,0,0,0,0,0,0,-21000,0,0,0,0,21000,-21000,-21000
3023,信邦            ,117000,138670,-21670,0,0,0,0,1244,-1244,1000,15000,14000,1000,0,0,0,-21914
057834,聯發科元富02購07,0,0,0,0,0,0,0,0,0,-22000,0,0,0,0,22000,-22000,-22000
057684,聯茂日盛99購01  ,0,0,0,0,0,0,0,0,0,-22000,0,0,0,0,22000,-22000,-22000
059203,勤誠永豐99購02  ,0,0,0,0,0,0,0,0,0,-22000,0,0,0,33000,55000,-22000,-22000
058022,樺漢凱基99購02  ,0,0,0,0,0,0,0,0,0,-22000,0,0,0,10000,32000,-22000,-22000
059661,大立光元大99購22,0,0,0,0,0,0,0,0,0,-22000,0,0,0,0,22000,-22000,-22000
059677,大立光台新99購01,0,0,0,0,0,0,0,0,0,-22000,0,0,0,0,22000,-22000,-22000
056804,T50反1統一9A購03,0,0,0,0,0,0,0,0,0,-22000,0,0,0,0,22000,-22000,-22000
059771,台積電群益99購11,0,0,0,0,0,0,0,0,0,-22000,0,0,0,104000,126000,-22000,-22000
054063,聯茂國票97購02  ,0,0,0,0,0,0,0,0,0,-22000,0,0,0,0,22000,-22000,-22000
055075,南電永豐97購01  ,0,0,0,0,0,0,0,0,0,-22000,0,0,0,76000,98000,-22000,-22000
058653,光寶科中信9A購01,0,0,0,0,0,0,0,0,0,-22000,0,0,0,66000,88000,-22000,-22000
05388P,南亞科元大95售04,0,0,0,0,0,0,0,0,0,-22000,0,0,0,8000,30000,-22000,-22000
050892,聯電元大96購02  ,0,0,0,0,0,0,0,0,0,-22000,0,0,0,838000,860000,-22000,-22000
2702,華園            ,1000,23000,-22000,0,0,0,0,0,0,0,0,0,0,0,0,0,-22000
06721P,臺股指中信9A售03,0,0,0,0,0,0,0,0,0,-22000,0,0,0,0,22000,-22000,-22000
06514P,國巨凱基98售05  ,0,0,0,0,0,0,0,0,0,-22000,0,0,0,0,22000,-22000,-22000
060533,臺股指中信9B購05,0,0,0,0,0,0,0,0,0,-22000,0,0,0,0,22000,-22000,-22000
060590,台積電台新9C購02,0,0,0,0,0,0,0,0,0,-22000,0,0,0,201000,223000,-22000,-22000
1340,勝悅-KY         ,4000,24000,-20000,0,0,0,0,0,0,-2000,0,2000,-2000,0,0,0,-22000
059727,大立光元大9A購01,0,0,0,0,0,0,0,0,0,-23000,0,0,0,0,23000,-23000,-23000
056771,嘉晶元大99購01  ,0,0,0,0,0,0,0,0,0,-23000,0,0,0,0,23000,-23000,-23000
059134,臺股指群益99購09,0,0,0,0,0,0,0,0,0,-23000,0,0,0,0,23000,-23000,-23000
058549,藍天永豐99購01  ,0,0,0,0,0,0,0,0,0,-23000,0,0,0,0,23000,-23000,-23000
058111,健鼎元富98購01  ,0,0,0,0,0,0,0,0,0,-23000,0,0,0,0,23000,-23000,-23000
057303,喬山兆豐99購01  ,0,0,0,0,0,0,0,0,0,-23000,0,0,0,17000,40000,-23000,-23000
051403,玉晶光永豐95購05,0,0,0,0,0,0,0,0,0,-23000,0,0,0,10000,33000,-23000,-23000
051638,聯茂國票96購01  ,0,0,0,0,0,0,0,0,0,-23000,0,0,0,38000,61000,-23000,-23000
00651R,FH香港反1       ,41000,0,41000,0,0,0,0,0,0,-64000,0,0,0,2000,66000,-64000,-23000
058645,康控富邦01購01  ,0,0,0,0,0,0,0,0,0,-23000,0,0,0,20000,43000,-23000,-23000
059964,元金2X凱基99購02,0,0,0,0,0,0,0,0,0,-23000,0,0,0,20000,43000,-23000,-23000
056110,嘉聯益永豐97購02,0,0,0,0,0,0,0,0,0,-23000,0,0,0,11000,34000,-23000,-23000
054158,國巨日盛99購01  ,0,0,0,0,0,0,0,0,0,-23000,0,0,0,17000,40000,-23000,-23000
054872,瀚宇博群益98購01,0,0,0,0,0,0,0,0,0,-23000,0,0,0,25000,48000,-23000,-23000
1417,嘉裕            ,73000,96000,-23000,0,0,0,0,0,0,0,0,0,0,0,0,0,-23000
07552P,技嘉元大9A售03  ,0,0,0,0,0,0,0,0,0,-23000,0,0,0,0,23000,-23000,-23000
07422P,大立光元大99售32,0,0,0,0,0,0,0,0,0,-23000,0,0,0,10000,33000,-23000,-23000
1517,利奇            ,3000,24000,-21000,0,0,0,0,0,0,-2000,0,2000,-2000,0,0,0,-23000
1603,華電            ,9000,32000,-23000,0,0,0,0,0,0,0,0,0,0,0,0,0,-23000
07170P,臺股指國票99售07,0,0,0,0,0,0,0,0,0,-23000,0,0,0,0,23000,-23000,-23000
4536,拓凱            ,12000,35000,-23000,0,0,0,0,0,0,0,0,0,0,0,0,0,-23000
8249,菱光            ,6000,26000,-20000,0,0,0,0,0,0,-3000,0,3000,-3000,0,0,0,-23000
9917,中保科          ,26000,25000,1000,0,0,0,0,2607,-2607,-22000,0,22000,-22000,0,0,0,-23607
057452,新日興元富98購01,0,0,0,0,0,0,0,0,0,-24000,0,0,0,22000,46000,-24000,-24000
058520,智易元大99購03  ,0,0,0,0,0,0,0,0,0,-24000,0,0,0,50000,74000,-24000,-24000
058832,立積永豐99購01  ,0,0,0,0,0,0,0,0,0,-24000,0,0,0,0,24000,-24000,-24000
060210,上銀康和9A購01  ,0,0,0,0,0,0,0,0,0,-24000,0,0,0,11000,35000,-24000,-24000
056065,奇鋐元大97購01  ,0,0,0,0,0,0,0,0,0,-24000,0,0,0,4000,28000,-24000,-24000
051743,揚明光國票96購02,0,0,0,0,0,0,0,0,0,-24000,0,0,0,0,24000,-24000,-24000
051540,力成國票95購01  ,0,0,0,0,0,0,0,0,0,-24000,0,0,0,22000,46000,-24000,-24000
6172,互億            ,4000,28000,-24000,0,0,0,0,0,0,0,0,0,0,0,0,0,-24000
4930,燦星網          ,2000,35000,-33000,0,0,0,0,0,0,9000,10000,1000,9000,0,0,0,-24000
1582,信錦            ,70000,85000,-15000,0,0,0,0,0,0,-9000,0,9000,-9000,0,0,0,-24000
07466P,亞德客元大9A售02,0,0,0,0,0,0,0,0,0,-24000,0,0,0,15000,39000,-24000,-24000
060465,聯發科元大9A購02,0,0,0,0,0,0,0,0,0,-25000,0,0,0,0,25000,-25000,-25000
060500,鴻海元大9A購12  ,0,0,0,0,0,0,0,0,0,-25000,0,0,0,0,25000,-25000,-25000
059030,奇力新兆豐99購03,0,0,0,0,0,0,0,0,0,-25000,0,0,0,45000,70000,-25000,-25000
060113,祥碩元大9B購01  ,0,0,0,0,0,0,0,0,0,-25000,0,0,0,45000,70000,-25000,-25000
060094,聯發科元大99購41,0,0,0,0,0,0,0,0,0,-25000,0,0,0,0,25000,-25000,-25000
056766,義隆元大98購01  ,0,0,0,0,0,0,0,0,0,-25000,0,0,0,25000,50000,-25000,-25000
059786,全新元大99購06  ,0,0,0,0,0,0,0,0,0,-25000,0,0,0,30000,55000,-25000,-25000
057992,大立光日盛98購01,0,0,0,0,0,0,0,0,0,-25000,0,0,0,0,25000,-25000,-25000
056168,鴻海元富97購07  ,0,0,0,0,0,0,0,0,0,-25000,0,0,0,0,25000,-25000,-25000
058883,旭富永豐99購01  ,0,0,0,0,0,0,0,0,0,-25000,0,0,0,100000,125000,-25000,-25000
059591,台積電元大9A購04,0,0,0,0,0,0,0,0,0,-25000,0,0,0,21000,46000,-25000,-25000
059154,可成日盛99購02  ,0,0,0,0,0,0,0,0,0,-25000,0,0,0,1000,26000,-25000,-25000
058110,光寶科元富98購01,0,0,0,0,0,0,0,0,0,-25000,0,0,0,10000,35000,-25000,-25000
058248,聯茂元大99購05  ,0,0,0,0,0,0,0,0,0,-25000,0,0,0,2000,27000,-25000,-25000
057178,可成元大98購03  ,0,0,0,0,0,0,0,0,0,-25000,0,0,0,7000,32000,-25000,-25000
051594,和碩元大96購01  ,0,0,0,0,0,0,0,0,0,-25000,0,0,0,0,25000,-25000,-25000
051625,聯發科麥證95購01,0,0,0,0,25000,-25000,0,0,0,-25000,0,0,0,0,25000,-25000,-25000
05138P,嘉聯益凱基96售02,0,0,0,0,0,0,0,0,0,-25000,0,0,0,0,25000,-25000,-25000
00684R,元大美元指數反1 ,0,0,0,0,0,0,0,0,0,-25000,0,0,0,5000,30000,-25000,-25000
054212,聯詠國票97購03  ,0,0,0,0,0,0,0,0,0,-25000,0,0,0,54000,79000,-25000,-25000
057575,世紀鋼永豐98購02,0,0,0,0,0,0,0,0,0,-25000,0,0,0,20000,45000,-25000,-25000
053915,光罩國票96購02  ,0,0,0,0,0,0,0,0,0,-25000,0,0,0,106000,131000,-25000,-25000
07483P,國巨台新9A售01  ,0,0,0,0,0,0,0,0,0,-25000,0,0,0,0,25000,-25000,-25000
07434P,臺股指國票9A售06,0,0,0,0,0,0,0,0,0,-25000,0,0,0,5000,30000,-25000,-25000
07403P,聯發科凱基99售21,0,0,0,0,0,0,0,0,0,-25000,0,0,0,0,25000,-25000,-25000
07381P,鴻海群益99售05  ,0,0,0,0,0,0,0,0,0,-25000,0,0,0,49000,74000,-25000,-25000
07234P,台灣50元大9B售04,0,0,0,0,0,0,0,0,0,-25000,0,0,0,0,25000,-25000,-25000
07226P,貿聯富邦9B售01  ,0,0,0,0,0,0,0,0,0,-25000,0,0,0,0,25000,-25000,-25000
07325P,台積電元大99售41,0,0,0,0,0,0,0,0,0,-25000,0,0,0,0,25000,-25000,-25000
060420,神基永豐9A購01  ,0,0,0,0,0,0,0,0,0,-25000,0,0,0,0,25000,-25000,-25000
060604,宏達電凱基9B購01,0,0,0,0,0,0,0,0,0,-25000,0,0,0,5000,30000,-25000,-25000
060719,瀚宇博永豐9A購01,0,0,0,0,0,0,0,0,0,-25000,0,0,0,21000,46000,-25000,-25000
9927,泰銘            ,15000,39000,-24000,0,0,0,0,0,0,-1000,0,1000,-1000,0,0,0,-25000
8996,高力            ,522000,439000,83000,0,0,0,0,0,0,-108000,1000,109000,-108000,0,0,0,-25000
6271,同欣電          ,513000,392290,120710,0,0,0,0,318,-318,-146000,0,144000,-144000,8000,10000,-2000,-25608
057257,台泥兆豐99購01  ,0,0,0,0,0,0,0,0,0,-26000,0,0,0,8000,34000,-26000,-26000
057507,貿聯國票98購02  ,0,0,0,0,0,0,0,0,0,-26000,0,0,0,0,26000,-26000,-26000
059231,華通國票9A購04  ,0,0,0,0,0,0,0,0,0,-26000,0,0,0,292000,318000,-26000,-26000
059117,禾伸堂永豐99購01,0,0,0,0,0,0,0,0,0,-26000,0,0,0,1000,27000,-26000,-26000
059063,康控凱基99購04  ,0,0,0,0,0,0,0,0,0,-26000,0,0,0,0,26000,-26000,-26000
058828,大毅永豐99購01  ,0,0,0,0,0,0,0,0,0,-26000,0,0,0,0,26000,-26000,-26000
05855P,滬深2X中信9C售01,0,0,0,0,0,0,0,0,0,-26000,0,0,0,10000,36000,-26000,-26000
058977,SGBR2X凱基03購01,0,0,0,0,0,0,0,0,0,-26000,0,0,0,67000,93000,-26000,-26000
059857,台灣50群益99購06,0,0,0,0,0,0,0,0,0,-26000,0,0,0,0,26000,-26000,-26000
057102,亞光中信9A購01  ,0,0,0,0,0,0,0,0,0,-26000,0,0,0,0,26000,-26000,-26000
060512,祥碩元大9A購02  ,0,0,0,0,0,0,0,0,0,-26000,0,0,0,22000,48000,-26000,-26000
060339,國巨統一01購01  ,0,0,0,0,0,0,0,0,0,-26000,0,0,0,205000,231000,-26000,-26000
053184,世紀鋼元富96購01,0,0,0,0,0,0,0,0,0,-26000,0,0,0,0,26000,-26000,-26000
052180,緯穎元大96購05  ,0,0,0,0,0,0,0,0,0,-26000,0,0,0,35000,61000,-26000,-26000
052208,力成麥證95購01  ,0,0,0,0,26000,-26000,0,0,0,-26000,0,0,0,0,26000,-26000,-26000
3686,達能            ,1000,27000,-26000,0,0,0,0,0,0,0,0,0,0,0,0,0,-26000
060534,友達麥證9A購01  ,0,0,0,0,26000,-26000,0,0,0,-26000,0,0,0,0,26000,-26000,-26000
07358P,鴻海元大99售39  ,0,0,0,0,0,0,0,0,0,-26000,0,0,0,1000,27000,-26000,-26000
2013,中鋼構          ,16000,42000,-26000,0,0,0,0,0,0,0,0,0,0,0,0,0,-26000
060154,堤維西永豐9A購01,0,0,0,0,0,0,0,0,0,-27000,0,0,0,0,27000,-27000,-27000
059856,昇陽半永豐99購03,0,0,0,0,0,0,0,0,0,-27000,0,0,0,47000,74000,-27000,-27000
057885,台光電群益98購04,0,0,0,0,0,0,0,0,0,-27000,0,0,0,0,27000,-27000,-27000
057887,智原群益98購04  ,0,0,0,0,0,0,0,0,0,-27000,0,0,0,3000,30000,-27000,-27000
056872,旺宏凱基98購08  ,0,0,0,0,0,0,0,0,0,-27000,0,0,0,3000,30000,-27000,-27000
059253,康控凱基9B購02  ,0,0,0,0,0,0,0,0,0,-27000,0,0,0,0,27000,-27000,-27000
057465,智易永豐98購02  ,0,0,0,0,0,0,0,0,0,-27000,0,0,0,0,27000,-27000,-27000
057689,南亞科凱基99購02,0,0,0,0,0,0,0,0,0,-27000,0,0,0,34000,61000,-27000,-27000
052423,宏達電國票96購02,0,0,0,0,0,0,0,0,0,-27000,0,0,0,0,27000,-27000,-27000
053595,創意元大96購02  ,0,0,0,0,0,0,0,0,0,-27000,0,0,0,47000,74000,-27000,-27000
053710,華通凱基96購05  ,0,0,0,0,0,0,0,0,0,-27000,0,0,0,3000,30000,-27000,-27000
055380,智易元大98購02  ,0,0,0,0,0,0,0,0,0,-27000,0,0,0,111000,138000,-27000,-27000
055230,大毅國票98購01  ,0,0,0,0,0,0,0,0,0,-27000,0,0,0,63000,90000,-27000,-27000
045842,T50反1台新98購01,0,0,0,0,0,0,0,0,0,-27000,0,0,0,0,27000,-27000,-27000
054694,聯鈞永豐97購01  ,0,0,0,0,0,0,0,0,0,-27000,0,0,0,0,27000,-27000,-27000
058626,瑞昱國票9A購01  ,0,0,0,0,0,0,0,0,0,-27000,0,0,0,3000,30000,-27000,-27000
055970,聯茂元大97購04  ,0,0,0,0,0,0,0,0,0,-27000,0,0,0,0,27000,-27000,-27000
1465,偉全            ,4000,31000,-27000,0,0,0,0,0,0,0,0,0,0,0,0,0,-27000
4737,華廣            ,43000,70000,-27000,0,0,0,0,0,0,0,0,0,0,0,0,0,-27000
3305,昇貿            ,1000,28000,-27000,0,0,0,0,0,0,0,0,0,0,0,0,0,-27000
2905,三商            ,184000,207000,-23000,0,0,0,0,0,0,-4000,0,4000,-4000,0,0,0,-27000
6108,競國            ,20000,46000,-26000,0,0,0,0,0,0,-1000,0,1000,-1000,0,0,0,-27000
060012,電子類群益99購02,0,0,0,0,0,0,0,0,0,-28000,0,0,0,2000,30000,-28000,-28000
058442,玉晶光台新99購01,0,0,0,0,0,0,0,0,0,-28000,0,0,0,510000,538000,-28000,-28000
060064,華新科兆豐99購07,0,0,0,0,0,0,0,0,0,-28000,0,0,0,260000,288000,-28000,-28000
059007,南電元大99購05  ,0,0,0,0,0,0,0,0,0,-28000,0,0,0,25000,53000,-28000,-28000
059702,台積電凱基9A購14,0,0,0,0,0,0,0,0,0,-28000,0,0,0,0,28000,-28000,-28000
055619,同欣電國票98購02,0,0,0,0,0,0,0,0,0,-28000,0,0,0,38000,66000,-28000,-28000
057558,致新凱基98購01  ,0,0,0,0,0,0,0,0,0,-28000,0,0,0,0,28000,-28000,-28000
056477,欣興元大98購02  ,0,0,0,0,0,0,0,0,0,-28000,0,0,0,8000,36000,-28000,-28000
053962,聯茂永豐96購01  ,0,0,0,0,0,0,0,0,0,-28000,0,0,0,12000,40000,-28000,-28000
05528P,臺股指群益96售01,0,0,0,0,0,0,0,0,0,-28000,0,0,0,103000,131000,-28000,-28000
3013,晟銘電          ,12000,39000,-27000,0,0,0,0,0,0,-1000,0,1000,-1000,0,0,0,-28000
2704,國賓            ,11000,39000,-28000,0,0,0,0,0,0,0,0,0,0,0,0,0,-28000
07509P,牧德國票9A售03  ,0,0,0,0,0,0,0,0,0,-28000,0,0,0,0,28000,-28000,-28000
07494P,葡萄王元大9A售03,0,0,0,0,0,0,0,0,0,-28000,0,0,0,12000,40000,-28000,-28000
1809,中釉            ,54000,82000,-28000,0,0,0,0,0,0,0,0,0,0,0,0,0,-28000
2233,宇隆            ,10000,36000,-26000,0,0,0,0,0,0,-2000,0,2000,-2000,0,0,0,-28000
060535,群創麥證9A購01  ,0,0,0,0,28000,-28000,0,0,0,-28000,0,0,0,0,28000,-28000,-28000
060556,緯穎凱基9A購04  ,0,0,0,0,0,0,0,0,0,-28000,0,0,0,4000,32000,-28000,-28000
060705,台光電富邦9B購01,0,0,0,0,0,0,0,0,0,-28000,0,0,0,0,28000,-28000,-28000
060619,玉晶光元大9A購03,0,0,0,0,0,0,0,0,0,-28000,0,0,0,0,28000,-28000,-28000
060625,華擎元大9A購01  ,0,0,0,0,0,0,0,0,0,-28000,0,0,0,10000,38000,-28000,-28000
06641P,智邦兆豐99售01  ,0,0,0,0,0,0,0,0,0,-28000,0,0,0,0,28000,-28000,-28000
06626P,大立光統一9A售01,0,0,0,0,0,0,0,0,0,-28000,0,0,0,34000,62000,-28000,-28000
06179P,國巨群益97售04  ,0,0,0,0,0,0,0,0,0,-28000,0,0,0,0,28000,-28000,-28000
07039P,南電台新99售01  ,0,0,0,0,0,0,0,0,0,-28000,0,0,0,33000,61000,-28000,-28000
07197P,臺股指元大99售13,0,0,0,0,0,0,0,0,0,-28000,0,0,0,2000,30000,-28000,-28000
2395,研華            ,158000,203080,-45080,0,0,0,38000,1922,36078,-19000,0,19000,-19000,0,0,0,-28002
057087,台郡統一99購01  ,0,0,0,0,0,0,0,0,0,-29000,0,0,0,0,29000,-29000,-29000
060202,康友元富9A購01  ,0,0,0,0,0,0,0,0,0,-29000,0,0,0,7000,36000,-29000,-29000
058965,祥碩兆豐99購02  ,0,0,0,0,0,0,0,0,0,-29000,0,0,0,11000,40000,-29000,-29000
057789,上銀統一9A購01  ,0,0,0,0,0,0,0,0,0,-29000,0,0,0,1000,30000,-29000,-29000
058168,國巨凱基9A購04  ,0,0,0,0,0,0,0,0,0,-29000,0,0,0,120000,149000,-29000,-29000
058102,楠梓電永豐98購04,0,0,0,0,0,0,0,0,0,-29000,0,0,0,2000,31000,-29000,-29000
053617,宏達電群益96購02,0,0,0,0,0,0,0,0,0,-29000,0,0,0,158000,187000,-29000,-29000
054883,億光統一97購01  ,0,0,0,0,0,0,0,0,0,-29000,0,0,0,0,29000,-29000,-29000
055562,欣興凱基97購06  ,0,0,0,0,0,0,0,0,0,-29000,0,0,0,3000,32000,-29000,-29000
056484,聯茂元大98購02  ,0,0,0,0,0,0,0,0,0,-29000,0,0,0,0,29000,-29000,-29000
059959,訊芯康和99購01  ,0,0,0,0,0,0,0,0,0,-29000,0,0,0,0,29000,-29000,-29000
055705,微星永豐97購01  ,0,0,0,0,0,0,0,0,0,-29000,0,0,0,0,29000,-29000,-29000
2009,第一銅          ,1000,27000,-26000,0,0,0,0,0,0,-3000,0,3000,-3000,0,0,0,-29000
1442,名軒            ,23000,51000,-28000,0,0,0,0,0,0,-1000,0,1000,-1000,0,0,0,-29000
1321,大洋            ,11000,25000,-14000,0,0,0,0,0,0,-15000,11000,26000,-15000,0,0,0,-29000
1339,昭輝            ,18000,43000,-25000,0,0,0,0,0,0,-4000,0,4000,-4000,0,0,0,-29000
07207P,台積電凱基99售13,0,0,0,0,0,0,0,0,0,-29000,0,0,0,1000,30000,-29000,-29000
3550,聯穎            ,2000,33000,-31000,0,0,0,0,0,0,2000,2000,0,2000,0,0,0,-29000
6214,精誠            ,121000,134000,-13000,0,0,0,0,0,0,-16000,10000,26000,-16000,0,0,0,-29000
4916,事欣科          ,28000,57000,-29000,0,0,0,0,0,0,0,0,0,0,0,0,0,-29000
058272,超眾永豐9A購01  ,0,0,0,0,0,0,0,0,0,-30000,0,0,0,47000,77000,-30000,-30000
057162,上銀元大98購03  ,0,0,0,0,0,0,0,0,0,-30000,0,0,0,27000,57000,-30000,-30000
057195,南茂元大98購01  ,0,0,0,0,0,0,0,0,0,-30000,0,0,0,193000,223000,-30000,-30000
057125,國巨凱基98購12  ,0,0,0,0,0,0,0,0,0,-30000,0,0,0,10000,40000,-30000,-30000
058320,華新科永豐99購02,0,0,0,0,0,0,0,0,0,-30000,0,0,0,0,30000,-30000,-30000
059588,鴻海元大99購32  ,0,0,0,0,0,0,0,0,0,-30000,0,0,0,0,30000,-30000,-30000
059333,滬深2X國票9A購03,0,0,0,0,0,0,0,0,0,-30000,0,0,0,30000,60000,-30000,-30000
056984,嘉晶群益98購01  ,0,0,0,0,0,0,0,0,0,-30000,0,0,0,2000,32000,-30000,-30000
058074,欣興凱基99購01  ,0,0,0,0,0,0,0,0,0,-30000,0,0,0,0,30000,-30000,-30000
058069,美律凱基99購05  ,0,0,0,0,0,0,0,0,0,-30000,0,0,0,0,30000,-30000,-30000
058038,滬深反元大98購01,0,0,0,0,0,0,0,0,0,-30000,0,0,0,0,30000,-30000,-30000
056835,聯電元富99購01  ,0,0,0,0,0,0,0,0,0,-30000,0,0,0,0,30000,-30000,-30000
05669P,嘉晶永豐96售03  ,0,0,0,0,0,0,0,0,0,-30000,0,0,0,0,30000,-30000,-30000
059854,台表科永豐99購03,0,0,0,0,0,0,0,0,0,-30000,0,0,0,13000,43000,-30000,-30000
059692,聯詠永豐99購01  ,0,0,0,0,0,0,0,0,0,-30000,0,0,0,13000,43000,-30000,-30000
059654,T50反1元大99購09,0,0,0,0,0,0,0,0,0,-30000,0,0,0,0,30000,-30000,-30000
060287,燿華元大9A購01  ,0,0,0,0,0,0,0,0,0,-30000,0,0,0,0,30000,-30000,-30000
060301,國巨富邦9C購02  ,0,0,0,0,0,0,0,0,0,-30000,0,0,0,423000,453000,-30000,-30000
060396,友達國票9A購01  ,0,0,0,0,0,0,0,0,0,-30000,0,0,0,0,30000,-30000,-30000
060350,元黃金元富9B購01,0,0,0,0,0,0,0,0,0,-30000,0,0,0,20000,50000,-30000,-30000
05971P,世紀鋼永豐96售04,0,0,0,0,0,0,0,0,0,-30000,0,0,0,0,30000,-30000,-30000
059467,旺宏元大99購15  ,0,0,0,0,0,0,0,0,0,-30000,0,0,0,0,30000,-30000,-30000
059440,康控元大9B購01  ,0,0,0,0,0,0,0,0,0,-30000,0,0,0,30000,60000,-30000,-30000
056403,茂林群益98購01  ,0,0,0,0,0,0,0,0,0,-30000,0,0,0,0,30000,-30000,-30000
054697,凌華永豐97購01  ,0,0,0,0,0,0,0,0,0,-30000,0,0,0,0,30000,-30000,-30000
053112,中磊兆豐97購01  ,0,0,0,0,0,0,0,0,0,-30000,0,0,0,0,30000,-30000,-30000
053289,臺股指元大96購17,0,0,0,0,0,0,0,0,0,-30000,0,0,0,0,30000,-30000,-30000
053392,致新元大96購01  ,0,0,0,0,0,0,0,0,0,-30000,0,0,0,110000,140000,-30000,-30000
053313,世紀鋼凱基96購01,0,0,0,0,0,0,0,0,0,-30000,0,0,0,0,30000,-30000,-30000
05538P,玉晶光國票97售02,0,0,0,0,0,0,0,0,0,-30000,0,0,0,205000,235000,-30000,-30000
055233,康友國票98購01  ,0,0,0,0,0,0,0,0,0,-30000,0,0,0,0,30000,-30000,-30000
050117,麗豐元大96購02  ,0,0,0,0,0,0,0,0,0,-30000,0,0,0,0,30000,-30000,-30000
051801,牧德永豐95購04  ,0,0,0,0,0,0,0,0,0,-30000,0,0,0,0,30000,-30000,-30000
00713,元大台灣高息低波,0,23000,-23000,0,0,0,0,0,0,-7000,0,0,0,1000,8000,-7000,-30000
6224,聚鼎            ,85000,115000,-30000,0,0,0,0,0,0,0,0,0,0,0,0,0,-30000
6243,迅杰            ,0,30000,-30000,0,0,0,0,0,0,0,0,0,0,0,0,0,-30000
06962P,華新科永豐99售01,0,0,0,0,0,0,0,0,0,-30000,0,0,0,20000,50000,-30000,-30000
06886P,旺宏元大99售07  ,0,0,0,0,0,0,0,0,0,-30000,0,0,0,0,30000,-30000,-30000
060633,玉晶光富邦02購01,0,0,0,0,0,0,0,0,0,-30000,0,0,0,0,30000,-30000,-30000
060553,祥碩凱基9A購01  ,0,0,0,0,0,0,0,0,0,-30000,0,0,0,144000,174000,-30000,-30000
060546,旺宏凱基9A購02  ,0,0,0,0,0,0,0,0,0,-30000,0,0,0,0,30000,-30000,-30000
060529,聯發科中信9A購04,0,0,0,0,0,0,0,0,0,-30000,0,0,0,0,30000,-30000,-30000
07575P,瑞昱元大9A售02  ,0,0,0,0,0,0,0,0,0,-30000,0,0,0,0,30000,-30000,-30000
07539P,玉山金台新9A售01,0,0,0,0,0,0,0,0,0,-30000,0,0,0,0,30000,-30000,-30000
07578P,高鐵元大9A售02  ,0,0,0,0,0,0,0,0,0,-30000,0,0,0,0,30000,-30000,-30000
07463P,台積電國票9A售05,0,0,0,0,0,0,0,0,0,-30000,0,0,0,0,30000,-30000,-30000
07396P,聯發科群益9B售01,0,0,0,0,0,0,0,0,0,-30000,0,0,0,11000,41000,-30000,-30000
2420,新巨            ,11000,41000,-30000,0,0,0,0,0,0,0,0,0,0,0,0,0,-30000
057075,嘉聯益永豐98購01,0,0,0,0,0,0,0,0,0,-31000,0,0,0,85000,116000,-31000,-31000
059662,旭富元大9C購01  ,0,0,0,0,0,0,0,0,0,-31000,0,0,0,5000,36000,-31000,-31000
057957,嘉晶元大98購01  ,0,0,0,0,0,0,0,0,0,-31000,0,0,0,11000,42000,-31000,-31000
059340,鴻海凱基9A購12  ,0,0,0,0,0,0,0,0,0,-31000,0,0,0,36000,67000,-31000,-31000
04324P,新光金元大94售01,0,0,0,0,0,0,0,0,0,-31000,0,0,0,0,31000,-31000,-31000
051536,玉晶光國票97購01,0,0,0,0,0,0,0,0,0,-31000,0,0,0,64000,95000,-31000,-31000
059962,S&P正2凱基99購02,0,0,0,0,0,0,0,0,0,-31000,0,0,0,4000,35000,-31000,-31000
055098,臺股指群益97購01,0,0,0,0,0,0,0,0,0,-31000,0,0,0,90000,121000,-31000,-31000
2457,飛宏            ,29000,59000,-30000,0,0,0,0,0,0,-1000,0,1000,-1000,0,0,0,-31000
07361P,聯發科元大99售34,0,0,0,0,0,0,0,0,0,-31000,0,0,0,20000,51000,-31000,-31000
060282,聚陽元大9A購01  ,0,0,0,0,0,0,0,0,0,-31000,0,0,0,6000,37000,-31000,-31000
4766,南寶            ,12000,43000,-31000,0,0,0,0,0,0,0,0,0,0,0,0,0,-31000
4763,材料-KY         ,1000,34000,-33000,0,0,0,0,0,0,2000,8000,6000,2000,0,0,0,-31000
058878,旭富國泰9B購01  ,0,0,0,0,0,0,0,0,0,-32000,0,0,0,306000,338000,-32000,-32000
058683,可成凱基9A購01  ,0,0,0,0,0,0,0,0,0,-32000,0,0,0,11000,43000,-32000,-32000
057498,台郡元大98購04  ,0,0,0,0,0,0,0,0,0,-32000,0,0,0,2000,34000,-32000,-32000
056243,創意群益97購03  ,0,0,0,0,0,0,0,0,0,-32000,0,0,0,1000,33000,-32000,-32000
056113,新日興兆豐98購01,0,0,0,0,0,0,0,0,0,-32000,0,0,0,0,32000,-32000,-32000
00678,群益NBI生技     ,2000,81000,-79000,0,0,0,0,0,0,47000,10000,0,10000,50000,13000,37000,-32000
8482,商億-KY         ,1000,34000,-33000,0,0,0,0,0,0,1000,1000,0,1000,0,0,0,-32000
8101,華冠            ,50000,82000,-32000,0,0,0,0,0,0,0,0,0,0,0,0,0,-32000
07171P,臺股指國票99售08,0,0,0,0,0,0,0,0,0,-32000,0,0,0,219000,251000,-32000,-32000
2450,神腦            ,3000,33000,-30000,0,0,0,0,0,0,-2000,0,2000,-2000,0,0,0,-32000
1626,艾美特-KY       ,8000,41000,-33000,0,0,0,0,0,0,1000,1000,0,1000,0,0,0,-32000
1201,味全            ,251000,283050,-32050,0,0,0,0,0,0,0,0,0,0,0,0,0,-32050
059842,台積電富邦9C購05,0,0,0,0,0,0,0,0,0,-33000,0,0,0,200000,233000,-33000,-33000
059921,大立光元大99購24,0,0,0,0,0,0,0,0,0,-33000,0,0,0,0,33000,-33000,-33000
060122,亞德客永豐99購02,0,0,0,0,0,0,0,0,0,-33000,0,0,0,47000,80000,-33000,-33000
056582,易華電元大98購01,0,0,0,0,0,0,0,0,0,-33000,0,0,0,0,33000,-33000,-33000
059361,玉晶光永豐99購04,0,0,0,0,0,0,0,0,0,-33000,0,0,0,0,33000,-33000,-33000
00757,統一FANG+       ,0,0,0,0,0,0,0,0,0,-33000,0,0,0,209000,242000,-33000,-33000
051911,大立光元大98購02,0,0,0,0,0,0,0,0,0,-33000,0,0,0,0,33000,-33000,-33000
049700,瀚宇博元大97購01,0,0,0,0,0,0,0,0,0,-33000,0,0,0,551000,584000,-33000,-33000
053984,康友元大96購05  ,0,0,0,0,0,0,0,0,0,-33000,0,0,0,0,33000,-33000,-33000
053424,欣興永豐96購02  ,0,0,0,0,0,0,0,0,0,-33000,0,0,0,3000,36000,-33000,-33000
1463,強盛            ,9000,42000,-33000,0,0,0,0,0,0,0,0,0,0,0,0,0,-33000
07085P,超眾元富9C售01  ,0,0,0,0,0,0,0,0,0,-33000,0,0,0,0,33000,-33000,-33000
060421,華擎永豐9A購01  ,0,0,0,0,0,0,0,0,0,-33000,0,0,0,12000,45000,-33000,-33000
3002,歐格            ,0,33000,-33000,0,0,0,0,0,0,0,0,0,0,0,0,0,-33000
1808,潤隆            ,43000,44000,-1000,0,0,0,0,1415,-1415,-31000,0,31000,-31000,0,0,0,-33415
059259,FBVIX中信03購06 ,0,0,0,0,0,0,0,0,0,-34000,0,0,0,143000,177000,-34000,-34000
059317,台積電元大99購34,0,0,0,0,0,0,0,0,0,-34000,0,0,0,0,34000,-34000,-34000
058372,欣興凱基99購03  ,0,0,0,0,0,0,0,0,0,-34000,0,0,0,4000,38000,-34000,-34000
058519,嘉澤元大99購01  ,0,0,0,0,0,0,0,0,0,-34000,0,0,0,26000,60000,-34000,-34000
057390,台表科永豐98購01,0,0,0,0,0,0,0,0,0,-34000,0,0,0,0,34000,-34000,-34000
060357,上銀元富9A購02  ,0,0,0,0,0,0,0,0,0,-34000,0,0,0,0,34000,-34000,-34000
059944,欣興永豐99購03  ,0,0,0,0,0,0,0,0,0,-34000,0,0,0,25000,59000,-34000,-34000
057081,大立光統一98購07,0,0,0,0,0,0,0,0,0,-34000,0,0,0,16000,50000,-34000,-34000
05430P,台積電統一95售07,0,0,0,0,0,0,0,0,0,-34000,0,0,0,0,34000,-34000,-34000
054253,宏達電元大97購03,0,0,0,0,0,0,0,0,0,-34000,0,0,0,61000,95000,-34000,-34000
052685,技嘉元大96購01  ,0,0,0,0,0,0,0,0,0,-34000,0,0,0,4000,38000,-34000,-34000
051653,南電永豐95購02  ,0,0,0,0,0,0,0,0,0,-34000,0,0,0,20000,54000,-34000,-34000
07265P,大立光元大99售16,0,0,0,0,0,0,0,0,0,-34000,0,0,0,86000,120000,-34000,-34000
060591,富邦金台新9A購01,0,0,0,0,0,0,0,0,0,-34000,0,0,0,115000,149000,-34000,-34000
060573,力成永豐9A購01  ,0,0,0,0,0,0,0,0,0,-34000,0,0,0,0,34000,-34000,-34000
6668,中揚光          ,64000,98000,-34000,0,0,0,0,0,0,0,0,0,0,0,0,0,-34000
5533,皇鼎            ,0,34000,-34000,0,0,0,0,0,0,0,0,0,0,0,0,0,-34000
2615,萬海            ,535000,532555,2445,0,0,0,0,12265,-12265,-25000,50000,75000,-25000,0,0,0,-34820
059714,A50正2元大9C購01,0,0,0,0,0,0,0,0,0,-35000,0,0,0,0,35000,-35000,-35000
060507,聯發科元大9A購03,0,0,0,0,0,0,0,0,0,-35000,0,0,0,0,35000,-35000,-35000
059874,大立光凱基99購15,0,0,0,0,0,0,0,0,0,-35000,0,0,0,40000,75000,-35000,-35000
059685,T50正2永豐99購02,0,0,0,0,0,0,0,0,0,-35000,0,0,0,0,35000,-35000,-35000
057896,嘉晶元富98購01  ,0,0,0,0,0,0,0,0,0,-35000,0,0,0,15000,50000,-35000,-35000
057815,信邦元大98購01  ,0,0,0,0,0,0,0,0,0,-35000,0,0,0,15000,50000,-35000,-35000
057701,嘉聯益群益98購02,0,0,0,0,0,0,0,0,0,-35000,0,0,0,1000,36000,-35000,-35000
058500,元石油元大9C購01,0,35000,-35000,0,0,0,0,0,0,0,0,0,0,0,0,0,-35000
059263,瑞昱中信01購01  ,0,0,0,0,0,0,0,0,0,-35000,0,0,0,1000,36000,-35000,-35000
059341,台積電凱基99購15,0,0,0,0,0,0,0,0,0,-35000,0,0,0,24000,59000,-35000,-35000
052006,康友富邦98購01  ,0,0,0,0,0,0,0,0,0,-35000,0,0,0,0,35000,-35000,-35000
052016,神基永豐95購01  ,0,0,0,0,0,0,0,0,0,-35000,0,0,0,40000,75000,-35000,-35000
00730,富邦臺灣優質高息,1000,0,1000,0,0,0,0,0,0,-36000,0,0,0,200000,236000,-36000,-35000
053719,可成凱基96購08  ,0,0,0,0,0,0,0,0,0,-35000,0,0,0,4000,39000,-35000,-35000
055349,京元電凱基97購02,0,0,0,0,0,0,0,0,0,-35000,0,0,0,25000,60000,-35000,-35000
2428,興勤            ,13000,48000,-35000,0,0,0,0,0,0,0,1000,0,1000,0,1000,-1000,-35000
2359,所羅門          ,35000,68000,-33000,0,0,0,0,0,0,-2000,0,2000,-2000,0,0,0,-35000
07369P,台積電凱基99售20,0,0,0,0,0,0,0,0,0,-35000,0,0,0,35000,70000,-35000,-35000
07409P,台積電台新99售07,0,0,0,0,0,0,0,0,0,-35000,0,0,0,0,35000,-35000,-35000
2383,台光電          ,482243,721370,-239127,0,0,0,201000,1291,199709,4000,29000,27000,2000,14000,12000,2000,-35418
059198,華新科永豐99購06,0,0,0,0,0,0,0,0,0,-36000,0,0,0,56000,92000,-36000,-36000
058553,合勤控永豐99購01,0,0,0,0,0,0,0,0,0,-36000,0,0,0,10000,46000,-36000,-36000
058876,南電國票9A購02  ,0,0,0,0,0,0,0,0,0,-36000,0,0,0,68000,104000,-36000,-36000
057243,樺漢凱基99購01  ,0,0,0,0,0,0,0,0,0,-36000,0,0,0,0,36000,-36000,-36000
055382,台郡元大99購01  ,0,0,0,0,0,0,0,0,0,-36000,0,0,0,2000,38000,-36000,-36000
03439B,臺股指元大99熊29,0,0,0,0,0,0,0,0,0,-36000,0,0,0,0,36000,-36000,-36000
052076,可成元富98購01  ,0,0,0,0,0,0,0,0,0,-36000,0,0,0,23000,59000,-36000,-36000
052102,台泥兆豐96購01  ,0,0,0,0,0,0,0,0,0,-36000,0,0,0,0,36000,-36000,-36000
053430,樺漢永豐96購01  ,0,0,0,0,0,0,0,0,0,-36000,0,0,0,0,36000,-36000,-36000
053489,上銀兆豐97購01  ,0,0,0,0,0,0,0,0,0,-36000,0,0,0,15000,51000,-36000,-36000
053950,緯穎富邦97購02  ,0,0,0,0,0,0,0,0,0,-36000,0,0,0,2000,38000,-36000,-36000
053383,京元電元大97購01,0,0,0,0,0,0,0,0,0,-36000,0,0,0,22000,58000,-36000,-36000
057606,健策統一98購03  ,0,0,0,0,0,0,0,0,0,-36000,0,0,0,325000,361000,-36000,-36000
6235,華孚            ,16000,49000,-33000,0,0,0,0,0,0,-3000,0,3000,-3000,0,0,0,-36000
6449,鈺邦            ,10000,45000,-35000,0,0,0,0,0,0,-1000,3000,4000,-1000,0,0,0,-36000
058761,欣興群益99購02  ,0,0,0,0,0,0,0,0,0,-37000,0,0,0,100000,137000,-37000,-37000
056564,亞光群益98購02  ,0,0,0,0,0,0,0,0,0,-37000,0,0,0,0,37000,-37000,-37000
056561,台光電群益98購02,0,0,0,0,0,0,0,0,0,-37000,0,0,0,0,37000,-37000,-37000
058777,台光電國票9A購01,0,0,0,0,0,0,0,0,0,-37000,0,0,0,0,37000,-37000,-37000
058496,文曄群益99購01  ,0,0,0,0,0,0,0,0,0,-37000,0,0,0,27000,64000,-37000,-37000
059199,欣興永豐99購02  ,0,0,0,0,0,0,0,0,0,-37000,0,0,0,0,37000,-37000,-37000
060149,元金2X富邦04購01,0,0,0,0,0,0,0,0,0,-37000,0,0,0,11000,48000,-37000,-37000
060187,華新科元富9A購02,0,0,0,0,0,0,0,0,0,-37000,0,0,0,1672000,1709000,-37000,-37000
060102,禾伸堂元大99購06,0,0,0,0,0,0,0,0,0,-37000,0,0,0,1000,38000,-37000,-37000
056153,華新科凱基97購02,0,0,0,0,0,0,0,0,0,-37000,0,0,0,10000,47000,-37000,-37000
055780,禾伸堂凱基99購01,0,0,0,0,0,0,0,0,0,-37000,0,0,0,0,37000,-37000,-37000
053018,旺宏元富96購02  ,0,0,0,0,0,0,0,0,0,-37000,0,0,0,13000,50000,-37000,-37000
051572,上銀元大95購01  ,0,0,0,0,0,0,0,0,0,-37000,0,0,0,161000,198000,-37000,-37000
050580,強茂國票95購01  ,0,0,0,0,0,0,0,0,0,-37000,0,0,0,1000,38000,-37000,-37000
6414,樺漢            ,95000,214000,-119000,0,0,0,2000,0,2000,80000,69000,10000,59000,22000,1000,21000,-37000
5243,乙盛-KY         ,25000,58000,-33000,0,0,0,0,0,0,-4000,0,4000,-4000,0,0,0,-37000
9911,櫻花            ,19000,79000,-60000,0,0,0,0,0,0,23000,25000,2000,23000,0,0,0,-37000
2305,全友            ,14000,49000,-35000,0,0,0,0,0,0,-2000,0,2000,-2000,0,0,0,-37000
1531,高林股          ,55000,92000,-37000,0,0,0,0,0,0,0,0,0,0,0,0,0,-37000
9946,三發地產        ,54000,91190,-37190,0,0,0,0,0,0,0,0,0,0,0,0,0,-37190
060106,旭富元大99購02  ,0,0,0,0,0,0,0,0,0,-38000,0,0,0,63000,101000,-38000,-38000
059020,元油2X統一9B購02,0,0,0,0,0,0,0,0,0,-38000,0,0,0,5000,43000,-38000,-38000
060059,鴻海兆豐99購06  ,0,0,0,0,0,0,0,0,0,-38000,0,0,0,0,38000,-38000,-38000
059792,台灣50國票9A購09,0,0,0,0,0,0,0,0,0,-38000,0,0,0,0,38000,-38000,-38000
059143,國巨國票9A購04  ,0,0,0,0,0,0,0,0,0,-38000,0,0,0,35000,73000,-38000,-38000
059328,台灣50國票99購08,0,0,0,0,0,0,0,0,0,-38000,0,0,0,0,38000,-38000,-38000
059331,台灣50國票9A購06,0,0,0,0,0,0,0,0,0,-38000,0,0,0,0,38000,-38000,-38000
059641,群創凱基99購06  ,0,0,0,0,0,0,0,0,0,-38000,0,0,0,56000,94000,-38000,-38000
056551,台郡凱基98購04  ,0,0,0,0,0,0,0,0,0,-38000,0,0,0,0,38000,-38000,-38000
059520,台表科永豐99購02,0,0,0,0,0,0,0,0,0,-38000,0,0,0,56000,94000,-38000,-38000
049199,茂林永豐95購01  ,0,0,0,0,0,0,0,0,0,-38000,0,0,0,62000,100000,-38000,-38000
048879,瀚宇博國票95購01,0,0,0,0,0,0,0,0,0,-38000,0,0,0,0,38000,-38000,-38000
053349,台郡國票97購02  ,0,0,0,0,0,0,0,0,0,-38000,0,0,0,53000,91000,-38000,-38000
054502,泰碩永豐96購01  ,0,0,0,0,0,0,0,0,0,-38000,0,0,0,302000,340000,-38000,-38000
059407,台灣50國票9B購01,0,0,0,0,0,0,0,0,0,-38000,0,0,0,0,38000,-38000,-38000
6177,達麗            ,51000,89000,-38000,0,0,0,0,0,0,0,0,0,0,0,0,0,-38000
2228,劍麟            ,55000,95000,-40000,0,0,0,0,0,0,2000,0,0,0,2000,0,2000,-38000
058781,康友國票9A購01  ,0,0,0,0,0,0,0,0,0,-39000,0,0,0,0,39000,-39000,-39000
059639,大立光凱基9A購06,0,0,0,0,0,0,0,0,0,-39000,0,0,0,42000,81000,-39000,-39000
059729,群創元大9C購05  ,0,0,0,0,0,0,0,0,0,-39000,0,0,0,61000,100000,-39000,-39000
059918,華新科元大99購20,0,0,0,0,0,0,0,0,0,-39000,0,0,0,23000,62000,-39000,-39000
060086,鴻海元大99購42  ,0,0,0,0,0,0,0,0,0,-39000,0,0,0,11000,50000,-39000,-39000
054449,中環第一96購01  ,0,0,0,0,0,0,0,0,0,-39000,0,0,0,0,39000,-39000,-39000
055578,群創統一98購03  ,0,0,0,0,0,0,0,0,0,-39000,0,0,0,0,39000,-39000,-39000
053074,嘉晶永豐96購02  ,0,0,0,0,0,0,0,0,0,-39000,0,0,0,0,39000,-39000,-39000
052706,台虹國票97購01  ,0,0,0,0,0,0,0,0,0,-39000,0,0,0,0,39000,-39000,-39000
051422,超眾國票96購01  ,0,0,0,0,0,0,0,0,0,-39000,0,0,0,247000,286000,-39000,-39000
07502P,美食元大9A售01  ,0,0,0,0,0,0,0,0,0,-39000,0,0,0,44000,83000,-39000,-39000
6209,今國光          ,107000,146000,-39000,0,0,0,0,0,0,0,0,0,0,0,0,0,-39000
060169,群電永豐9A購01  ,0,0,0,0,0,0,0,0,0,-40000,0,0,0,0,40000,-40000,-40000
059939,技嘉永豐99購01  ,0,0,0,0,0,0,0,0,0,-40000,0,0,0,8000,48000,-40000,-40000
059898,T50反1元大99購15,0,0,0,0,0,0,0,0,0,-40000,0,0,0,0,40000,-40000,-40000
060511,群創元大9B購08  ,0,0,0,0,0,0,0,0,0,-40000,0,0,0,0,40000,-40000,-40000
06042P,華新科永豐96售04,0,0,0,0,0,0,0,0,0,-40000,0,0,0,11000,51000,-40000,-40000
059846,力山永豐99購01  ,0,0,0,0,0,0,0,0,0,-40000,0,0,0,166000,206000,-40000,-40000
059855,緯穎永豐99購04  ,0,0,0,0,0,0,0,0,0,-40000,0,0,0,0,40000,-40000,-40000
056674,華邦電元富98購01,0,0,0,0,0,0,0,0,0,-40000,0,0,0,0,40000,-40000,-40000
057985,華通元富02購03  ,0,0,0,0,0,0,0,0,0,-40000,0,0,0,0,40000,-40000,-40000
05912P,和大元大96售01  ,0,0,0,0,0,0,0,0,0,-40000,0,0,0,0,40000,-40000,-40000
058345,台光電群益99購03,0,0,0,0,0,0,0,0,0,-40000,0,0,0,98000,138000,-40000,-40000
057376,新日興元大98購04,0,0,0,0,0,0,0,0,0,-40000,0,0,0,0,40000,-40000,-40000
051406,泰鼎永豐96購01  ,0,0,0,0,0,0,0,0,0,-40000,0,0,0,25000,65000,-40000,-40000
051339,智易永豐95購02  ,0,0,0,0,0,0,0,0,0,-40000,0,0,0,0,40000,-40000,-40000
052378,矽力元大96購01  ,0,0,0,0,0,0,0,0,0,-40000,0,0,0,0,40000,-40000,-40000
055214,聯電凱基97購02  ,0,0,0,0,0,0,0,0,0,-40000,0,0,0,60000,100000,-40000,-40000
038489,T50反1台新9A購01,0,0,0,0,0,0,0,0,0,-40000,0,0,0,0,40000,-40000,-40000
05282P,可成元大95售09  ,0,0,0,0,0,0,0,0,0,-40000,0,0,0,0,40000,-40000,-40000
055976,台積電統一99購03,0,0,0,0,0,0,0,0,0,-40000,0,0,0,0,40000,-40000,-40000
054139,揚明光元大96購01,0,0,0,0,0,0,0,0,0,-40000,0,0,0,0,40000,-40000,-40000
6477,安集            ,8000,47000,-39000,0,0,0,0,0,0,-1000,0,1000,-1000,0,0,0,-40000
5285,界霖            ,14000,54000,-40000,0,0,0,0,0,0,0,0,0,0,0,0,0,-40000
3607,谷崧            ,3000,42000,-39000,0,0,0,0,0,0,-1000,0,1000,-1000,0,0,0,-40000
07433P,臺股指國票9A售05,0,0,0,0,0,0,0,0,0,-40000,0,0,0,0,40000,-40000,-40000
1806,冠軍            ,0,36000,-36000,0,0,0,0,0,0,-4000,0,4000,-4000,0,0,0,-40000
060673,旺宏元大9A購04  ,0,0,0,0,0,0,0,0,0,-40000,0,0,0,0,40000,-40000,-40000
060667,力成凱基9A購01  ,0,0,0,0,0,0,0,0,0,-40000,0,0,0,0,40000,-40000,-40000
060267,上緯控國票9C購01,0,0,0,0,0,0,0,0,0,-40000,0,0,0,0,40000,-40000,-40000
2520,冠德            ,248000,457985,-209985,0,0,0,170000,0,170000,-1000,6000,7000,-1000,0,0,0,-40985
058703,台積電元大99購16,0,0,0,0,0,0,0,0,0,-41000,0,0,0,14000,55000,-41000,-41000
059128,友達中信99購02  ,0,0,0,0,0,0,0,0,0,-41000,0,0,0,487000,528000,-41000,-41000
057980,聯詠永豐98購01  ,0,0,0,0,0,0,0,0,0,-41000,0,0,0,51000,92000,-41000,-41000
060508,聯發科元大9A購04,0,0,0,0,0,0,0,0,0,-41000,0,0,0,0,41000,-41000,-41000
056996,矽力日盛99購01  ,0,0,0,0,0,0,0,0,0,-41000,0,0,0,0,41000,-41000,-41000
054352,世芯國泰98購01  ,0,0,0,0,0,0,0,0,0,-41000,0,0,0,55000,96000,-41000,-41000
051667,光磊元大96購02  ,0,0,0,0,0,0,0,0,0,-41000,0,0,0,0,41000,-41000,-41000
6115,鎰勝            ,2000,34000,-32000,0,0,0,0,0,0,-9000,0,9000,-9000,0,0,0,-41000
1731,美吾華          ,39000,80000,-41000,0,0,0,0,0,0,0,0,0,0,0,0,0,-41000
2109,華豐            ,4000,45000,-41000,0,0,0,0,0,0,0,0,0,0,0,0,0,-41000
1323,永裕            ,6000,47000,-41000,0,0,0,0,0,0,0,0,0,0,0,0,0,-41000
060146,健策國票9A購03  ,0,0,0,0,0,0,0,0,0,-42000,0,0,0,74000,116000,-42000,-42000
060043,全新群益9B購02  ,0,0,0,0,0,0,0,0,0,-42000,0,0,0,15000,57000,-42000,-42000
059888,華新科國票99購03,0,0,0,0,0,0,0,0,0,-42000,0,0,0,0,42000,-42000,-42000
059663,旭富元大9C購02  ,0,0,0,0,0,0,0,0,0,-42000,0,0,0,2000,44000,-42000,-42000
059258,台灣50群益99購01,0,0,0,0,0,0,0,0,0,-42000,0,0,0,0,42000,-42000,-42000
050121,南電元大95購02  ,0,0,0,0,0,0,0,0,0,-42000,0,0,0,68000,110000,-42000,-42000
050576,南亞科國票95購01,0,0,0,0,0,0,0,0,0,-42000,0,0,0,0,42000,-42000,-42000
050482,台郡國票94購04  ,0,0,0,0,0,0,0,0,0,-42000,0,0,0,7000,49000,-42000,-42000
055540,京鼎台新97購01  ,0,0,0,0,0,0,0,0,0,-42000,0,0,0,0,42000,-42000,-42000
052946,智原國票97購02  ,0,0,0,0,0,0,0,0,0,-42000,0,0,0,0,42000,-42000,-42000
054170,泰鼎凱基98購01  ,0,0,0,0,0,0,0,0,0,-42000,0,0,0,3000,45000,-42000,-42000
8011,台通            ,4000,43000,-39000,0,0,0,0,0,0,-3000,0,3000,-3000,0,0,0,-42000
8021,尖點            ,53000,88000,-35000,0,0,0,0,0,0,-7000,0,7000,-7000,0,0,0,-42000
3673,TPK-KY          ,1413000,1568820,-155820,0,0,0,0,3288,-3288,117000,20000,27000,-7000,125000,1000,124000,-42108
2534,宏盛            ,589000,654710,-65710,0,0,0,0,0,0,23000,0,7000,-7000,30000,0,30000,-42710
058391,T50反1元大99購02,0,0,0,0,0,0,0,0,0,-43000,0,0,0,0,43000,-43000,-43000
057878,台郡元大99購04  ,0,0,0,0,0,0,0,0,0,-43000,0,0,0,1000,44000,-43000,-43000
056295,國巨元大97購16  ,0,0,0,0,0,0,0,0,0,-43000,0,0,0,37000,80000,-43000,-43000
059971,台灣50元大9B購08,0,0,0,0,0,0,0,0,0,-43000,0,0,0,0,43000,-43000,-43000
054255,亞光元大96購05  ,0,0,0,0,0,0,0,0,0,-43000,0,0,0,0,43000,-43000,-43000
052151,義隆富邦96購01  ,0,0,0,0,0,0,0,0,0,-43000,0,0,0,0,43000,-43000,-43000
053631,欣興兆豐97購01  ,0,0,0,0,0,0,0,0,0,-43000,0,0,0,47000,90000,-43000,-43000
1537,廣隆            ,4000,46000,-42000,0,0,0,0,0,0,-1000,0,1000,-1000,0,0,0,-43000
06457P,玉晶光統一98售02,0,0,0,0,0,0,0,0,0,-43000,0,0,0,2000,45000,-43000,-43000
6206,飛捷            ,22000,52350,-30350,0,0,0,0,0,0,-13000,0,13000,-13000,0,0,0,-43350
057074,立積永豐98購01  ,0,0,0,0,0,0,0,0,0,-44000,0,0,0,61000,105000,-44000,-44000
060026,聯發科富邦9B購05,0,0,0,0,0,0,0,0,0,-44000,0,0,0,0,44000,-44000,-44000
059477,FBVIX群益99購01 ,0,0,0,0,0,0,0,0,0,-44000,0,0,0,0,44000,-44000,-44000
057504,技嘉麥證98購01  ,0,0,0,2000,46000,-44000,0,0,0,-44000,0,0,0,2000,46000,-44000,-44000
057529,嘉晶元大99購02  ,0,0,0,0,0,0,0,0,0,-44000,0,0,0,0,44000,-44000,-44000
058241,景碩元大99購05  ,0,0,0,0,0,0,0,0,0,-44000,0,0,0,37000,81000,-44000,-44000
053806,鎧勝凱基96購02  ,0,0,0,0,0,0,0,0,0,-44000,0,0,0,123000,167000,-44000,-44000
051503,玉晶光統一97購01,0,0,0,0,0,0,0,0,0,-44000,0,0,0,52000,96000,-44000,-44000
051941,樺漢群益95購02  ,0,0,0,0,0,0,0,0,0,-44000,0,0,0,0,44000,-44000,-44000
054213,欣興國票97購04  ,0,0,0,0,0,0,0,0,0,-44000,0,0,0,80000,124000,-44000,-44000
6166,凌華            ,120000,185000,-65000,0,0,0,0,0,0,21000,15000,2000,13000,8000,0,8000,-44000
2612,中航            ,12000,56000,-44000,0,0,0,0,0,0,0,0,0,0,0,0,0,-44000
4725,信昌化          ,90000,134000,-44000,0,0,0,0,0,0,0,0,0,0,0,0,0,-44000
06997P,台灣50中信03售01,0,0,0,0,0,0,0,0,0,-44000,0,0,0,0,44000,-44000,-44000
1618,合機            ,10000,77000,-67000,0,0,0,0,0,0,23000,27000,4000,23000,0,0,0,-44000
057841,茂林富邦9A購02  ,0,0,0,0,0,0,0,0,0,-45000,0,0,0,86000,131000,-45000,-45000
057249,華邦電統一9A購01,0,0,0,0,0,0,0,0,0,-45000,0,0,0,5000,50000,-45000,-45000
057146,技嘉國票98購01  ,0,0,0,0,0,0,0,0,0,-45000,0,0,0,0,45000,-45000,-45000
05880P,創意康和96售01  ,0,0,0,0,0,0,0,0,0,-45000,0,0,0,0,45000,-45000,-45000
059369,滬深2X元富9C購01,0,0,0,0,0,0,0,0,0,-45000,0,0,0,5000,50000,-45000,-45000
060216,鴻海凱基9A購17  ,0,0,0,0,0,0,0,0,0,-45000,0,0,0,65000,110000,-45000,-45000
059660,華新科元大9A購04,0,0,0,0,0,0,0,0,0,-45000,0,0,0,19000,64000,-45000,-45000
054311,世芯凱基96購02  ,0,0,0,0,0,0,0,0,0,-45000,0,0,0,43000,88000,-45000,-45000
055555,全新凱基9A購01  ,0,0,0,0,0,0,0,0,0,-45000,0,0,0,0,45000,-45000,-45000
055497,開發金元大97購01,20000,25000,-5000,0,0,0,0,0,0,-40000,0,0,0,109000,149000,-40000,-45000
04864P,欣興元大94售10  ,0,0,0,0,0,0,0,0,0,-45000,0,0,0,0,45000,-45000,-45000
053900,T50反1日盛99購01,0,0,0,0,0,0,0,0,0,-45000,0,0,0,279000,324000,-45000,-45000
8261,富鼎            ,6000,51000,-45000,0,0,0,0,0,0,0,0,0,0,0,0,0,-45000
056981,全新群益99購03  ,0,0,0,0,0,0,0,0,0,-46000,0,0,0,72000,118000,-46000,-46000
05635P,健策台新96售02  ,0,0,0,0,0,0,0,0,0,-46000,0,0,0,10000,56000,-46000,-46000
060156,光磊永豐9A購01  ,0,0,0,0,0,0,0,0,0,-46000,0,0,0,16000,62000,-46000,-46000
059934,華通永豐99購02  ,0,0,0,0,0,0,0,0,0,-46000,0,0,0,10000,56000,-46000,-46000
059754,訊芯群益9A購01  ,0,0,0,0,0,0,0,0,0,-46000,0,0,0,10000,56000,-46000,-46000
2851,中再保          ,40000,79000,-39000,0,0,0,0,0,0,-7000,0,7000,-7000,0,0,0,-46000
07343P,高鐵康和99售01  ,0,0,0,0,0,0,0,0,0,-46000,0,0,0,17000,63000,-46000,-46000
07317P,T50正2凱基9B售02,0,0,0,0,0,0,0,0,0,-46000,0,0,0,15000,61000,-46000,-46000
056823,智伸科永豐98購01,0,0,0,0,0,0,0,0,0,-47000,0,0,0,72000,119000,-47000,-47000
058398,中環元大99購02  ,0,0,0,0,0,0,0,0,0,-47000,0,0,0,99000,146000,-47000,-47000
057773,技嘉群益9A購02  ,0,0,0,0,0,0,0,0,0,-47000,0,0,0,3000,50000,-47000,-47000
054466,欣興凱基97購03  ,0,0,0,0,0,0,0,0,0,-47000,0,0,0,2000,49000,-47000,-47000
053956,旺宏永豐96購04  ,0,0,0,0,0,0,0,0,0,-47000,0,0,0,3000,50000,-47000,-47000
059403,T50反1台新03購03,0,0,0,0,0,0,0,0,0,-47000,0,0,0,0,47000,-47000,-47000
6416,瑞祺電通        ,84000,167000,-83000,0,0,0,0,0,0,36000,60000,23000,37000,4000,5000,-1000,-47000
060022,勤誠康和99購01  ,0,0,0,0,0,0,0,0,0,-48000,0,0,0,0,48000,-48000,-48000
058706,聯鈞元大9C購01  ,0,0,0,0,0,0,0,0,0,-48000,0,0,0,2000,50000,-48000,-48000
058536,群創統一9B購01  ,0,0,0,0,0,0,0,0,0,-48000,0,0,0,0,48000,-48000,-48000
059275,可成元大99購05  ,0,0,0,0,0,0,0,0,0,-48000,0,0,0,55000,103000,-48000,-48000
060374,儒鴻元富9A購01  ,0,0,0,0,0,0,0,0,0,-48000,0,0,0,61000,109000,-48000,-48000
057577,廣宇中信9A購01  ,0,0,0,0,0,0,0,0,0,-48000,0,0,0,4000,52000,-48000,-48000
055805,矽力永豐97購01  ,0,0,0,0,0,0,0,0,0,-48000,0,0,0,7000,55000,-48000,-48000
053955,華通永豐96購04  ,0,0,0,0,0,0,0,0,0,-48000,0,0,0,2000,50000,-48000,-48000
053442,光罩凱基96購01  ,0,0,0,0,0,0,0,0,0,-48000,0,0,0,0,48000,-48000,-48000
053770,元金2X元大98購01,0,0,0,0,0,0,0,0,0,-48000,0,0,0,2000,50000,-48000,-48000
053864,義隆元大96購01  ,0,0,0,0,0,0,0,0,0,-48000,0,0,0,0,48000,-48000,-48000
2524,京城            ,22000,70000,-48000,0,0,0,0,0,0,0,0,0,0,0,0,0,-48000
4190,佐登-KY         ,37000,69000,-32000,0,0,0,0,0,0,-16000,0,16000,-16000,0,0,0,-48000
07370P,南亞科凱基99售08,0,0,0,0,0,0,0,0,0,-48000,0,0,0,5000,53000,-48000,-48000
06150P,奇力新元大97售06,0,0,0,0,0,0,0,0,0,-48000,0,0,0,59000,107000,-48000,-48000
06460P,亞德客元富98售02,0,0,0,0,0,0,0,0,0,-48000,0,0,0,0,48000,-48000,-48000
8422,可寧衛          ,22100,60000,-37900,0,0,0,0,0,0,-11000,0,11000,-11000,0,0,0,-48900
060423,智易永豐9A購01  ,0,0,0,0,0,0,0,0,0,-49000,0,0,0,0,49000,-49000,-49000
059666,台表科元大9B購01,0,0,0,0,0,0,0,0,0,-49000,0,0,0,2000,51000,-49000,-49000
059844,大立光富邦9C購04,0,0,0,0,0,0,0,0,0,-49000,0,0,0,19000,68000,-49000,-49000
056905,欣興元大98購03  ,0,0,0,0,0,0,0,0,0,-49000,0,0,0,60000,109000,-49000,-49000
059610,上銀永豐99購02  ,0,0,0,0,0,0,0,0,0,-49000,0,0,0,10000,59000,-49000,-49000
057817,景碩元大98購01  ,0,0,0,0,0,0,0,0,0,-49000,0,0,0,40000,89000,-49000,-49000
050794,大立光富邦96購04,0,0,0,0,0,0,0,0,0,-49000,0,0,0,51000,100000,-49000,-49000
051918,聯茂元大95購01  ,0,0,0,0,0,0,0,0,0,-49000,0,0,0,126000,175000,-49000,-49000
055594,華新科元大98購02,0,0,0,0,0,0,0,0,0,-49000,0,0,0,15000,64000,-49000,-49000
056453,禾伸堂凱基99購02,0,0,0,0,0,0,0,0,0,-49000,0,0,0,4000,53000,-49000,-49000
059960,健策國票99購01  ,0,0,0,0,0,0,0,0,0,-49000,0,0,0,169000,218000,-49000,-49000
9924,福興            ,4000,47000,-43000,0,0,0,0,6000,-6000,0,0,0,0,0,0,0,-49000
060568,SP黃豆永豐9A購01,0,0,0,0,0,0,0,0,0,-49000,0,0,0,1000,50000,-49000,-49000
06728P,全新元大98售03  ,0,0,0,0,0,0,0,0,0,-49000,0,0,0,61000,110000,-49000,-49000
1702,南僑            ,19000,69000,-50000,0,0,0,0,0,0,1000,2000,1000,1000,0,0,0,-49000
05814P,臺股指國票96售07,0,0,0,0,0,0,0,0,0,-50000,0,0,0,1000,51000,-50000,-50000
058135,景碩元大99購01  ,0,0,0,0,0,0,0,0,0,-50000,0,0,0,0,50000,-50000,-50000
058230,國巨元大99購11  ,0,0,0,0,0,0,0,0,0,-50000,0,0,0,30000,80000,-50000,-50000
057780,台郡群益98購02  ,0,0,0,0,0,0,0,0,0,-50000,0,0,0,2000,52000,-50000,-50000
058700,鴻海元大99購15  ,0,0,0,0,0,0,0,0,0,-50000,0,0,0,0,50000,-50000,-50000
058521,日月光元大99購01,0,0,0,0,0,0,0,0,0,-50000,0,0,0,0,50000,-50000,-50000
059327,南茂元大99購01  ,0,0,0,0,0,0,0,0,0,-50000,0,0,0,5000,55000,-50000,-50000
059207,臺指反元大9C購02,0,0,0,0,0,0,0,0,0,-50000,0,0,0,0,50000,-50000,-50000
056890,國巨元大98購11  ,0,0,0,0,0,0,0,0,0,-50000,0,0,0,0,50000,-50000,-50000
05624P,同欣電中信98售01,0,0,0,0,0,0,0,0,0,-50000,0,0,0,0,50000,-50000,-50000
059839,T50反1富邦99購02,0,0,0,0,0,0,0,0,0,-50000,0,0,0,0,50000,-50000,-50000
060477,和潤元大9A購01  ,0,0,0,0,0,0,0,0,0,-50000,0,0,0,0,50000,-50000,-50000
059916,聯發科元大99購33,0,0,0,0,0,0,0,0,0,-50000,0,0,0,0,50000,-50000,-50000
060071,國巨元富99購03  ,0,0,0,0,0,0,0,0,0,-50000,0,0,0,12000,62000,-50000,-50000
057040,國巨元大98購12  ,0,0,0,0,0,0,0,0,0,-50000,0,0,0,32000,82000,-50000,-50000
058631,鈺齊國票9A購01  ,0,0,0,0,0,0,0,0,0,-50000,0,0,0,38000,88000,-50000,-50000
057570,技嘉永豐98購02  ,0,0,0,0,0,0,0,0,0,-50000,0,0,0,50000,100000,-50000,-50000
056083,億光統一97購03  ,0,0,0,0,0,0,0,0,0,-50000,0,0,0,0,50000,-50000,-50000
055036,中工富邦9B購01  ,0,0,0,0,0,0,0,0,0,-50000,0,0,0,60000,110000,-50000,-50000
055586,旺宏元大98購06  ,0,0,0,0,0,0,0,0,0,-50000,0,0,0,0,50000,-50000,-50000
053999,台表科群益96購06,0,0,0,0,0,0,0,0,0,-50000,0,0,0,160000,210000,-50000,-50000
054674,台光電台新97購01,0,0,0,0,0,0,0,0,0,-50000,0,0,0,0,50000,-50000,-50000
053486,T50反1兆豐96購01,0,0,0,0,0,0,0,0,0,-50000,0,0,0,93000,143000,-50000,-50000
053931,楠梓電統一96購01,0,0,0,0,0,0,0,0,0,-50000,0,0,0,0,50000,-50000,-50000
053250,百和國票97購02  ,0,0,0,0,0,0,0,0,0,-50000,0,0,0,0,50000,-50000,-50000
051800,旺宏永豐95購02  ,0,0,0,0,0,0,0,0,0,-50000,0,0,0,0,50000,-50000,-50000
051895,聯茂元富95購02  ,0,0,0,0,0,0,0,0,0,-50000,0,0,0,10000,60000,-50000,-50000
049224,致新國票95購01  ,0,0,0,0,0,0,0,0,0,-50000,0,0,0,38000,88000,-50000,-50000
050818,華新科凱基95購02,0,0,0,0,0,0,0,0,0,-50000,0,0,0,10000,60000,-50000,-50000
050210,華新科國票94購08,0,0,0,0,0,0,0,0,0,-50000,0,0,0,0,50000,-50000,-50000
052459,道瓊反統一95購04,0,0,0,0,0,0,0,0,0,-50000,0,0,0,0,50000,-50000,-50000
052513,大立光凱基95購13,0,0,0,0,0,0,0,0,0,-50000,0,0,0,0,50000,-50000,-50000
2358,廷鑫            ,10000,60000,-50000,0,0,0,0,0,0,0,0,0,0,0,0,0,-50000
07504P,聯詠元大9A售02  ,0,0,0,0,0,0,0,0,0,-50000,0,0,0,7000,57000,-50000,-50000
06905P,上証2X國泰99售02,0,0,0,0,0,0,0,0,0,-50000,0,0,0,0,50000,-50000,-50000
07272P,台灣50元大9C售05,0,0,0,0,0,0,0,0,0,-50000,0,0,0,0,50000,-50000,-50000
06458P,玉晶光統一9A售02,0,0,0,0,0,0,0,0,0,-50000,0,0,0,0,50000,-50000,-50000
6698,旭暉應材        ,13000,30000,-17000,0,0,0,0,0,0,-33000,0,33000,-33000,0,0,0,-50000
2514,龍邦            ,46000,96000,-50000,0,0,0,0,0,0,0,0,0,0,0,0,0,-50000
2617,台航            ,70000,120000,-50000,0,0,0,0,0,0,0,0,0,0,0,0,0,-50000
3025,星通            ,14000,64000,-50000,0,0,0,0,0,0,0,0,0,0,0,0,0,-50000
3030,德律            ,73000,111340,-38340,0,0,0,0,0,0,-12000,0,12000,-12000,0,0,0,-50340
059695,聯鈞永豐99購02  ,0,0,0,0,0,0,0,0,0,-51000,0,0,0,103000,154000,-51000,-51000
058929,可成統一9C購01  ,0,0,0,0,0,0,0,0,0,-51000,0,0,0,0,51000,-51000,-51000
058749,康控凱基99購03  ,0,0,0,0,0,0,0,0,0,-51000,0,0,0,0,51000,-51000,-51000
058224,世芯統一9B購02  ,0,0,0,0,0,0,0,0,0,-51000,0,0,0,221000,272000,-51000,-51000
055381,茂林元大97購02  ,0,0,0,0,0,0,0,0,0,-51000,0,0,0,22000,73000,-51000,-51000
046813,聯電凱基96購01  ,0,0,0,0,0,0,0,0,0,-51000,0,0,0,5000,56000,-51000,-51000
053113,瀚宇博兆豐97購01,0,0,0,0,0,0,0,0,0,-51000,0,0,0,55000,106000,-51000,-51000
054258,牧德元大97購01  ,0,0,0,0,0,0,0,0,0,-51000,0,0,0,13000,64000,-51000,-51000
2852,第一保          ,10000,57000,-47000,0,0,0,0,0,0,-4000,0,4000,-4000,0,0,0,-51000
9105,泰金寶-DR       ,0,51000,-51000,0,0,0,0,0,0,0,0,0,0,0,0,0,-51000
060521,鴻海中信01購03  ,0,0,0,0,0,0,0,0,0,-51000,0,0,0,0,51000,-51000,-51000
057762,全新凱基99購03  ,0,0,0,0,0,0,0,0,0,-52000,0,0,0,0,52000,-52000,-52000
059362,健策永豐99購03  ,0,0,0,0,0,0,0,0,0,-52000,0,0,0,78000,130000,-52000,-52000
058319,大毅永豐9A購01  ,0,0,0,0,0,0,0,0,0,-52000,0,0,0,2000,54000,-52000,-52000
060159,健和興永豐9A購01,0,0,0,0,0,0,0,0,0,-52000,0,0,0,0,52000,-52000,-52000
060459,鴻海元大9A購07  ,0,0,0,0,0,0,0,0,0,-52000,0,0,0,37000,89000,-52000,-52000
060248,日月光元大9A購01,0,0,0,0,0,0,0,0,0,-52000,0,0,0,42000,94000,-52000,-52000
060288,群光元大9C購01  ,0,0,0,0,0,0,0,0,0,-52000,0,0,0,0,52000,-52000,-52000
03828P,致茂中信95售01  ,0,0,0,0,0,0,0,0,0,-52000,0,0,0,16000,68000,-52000,-52000
048396,奇力新國票94購02,0,0,0,0,0,0,0,0,0,-52000,0,0,0,1000,53000,-52000,-52000
1558,伸興            ,8000,60000,-52000,0,0,0,0,0,0,0,0,0,0,0,0,0,-52000
2535,達欣工          ,100000,152000,-52000,0,0,0,0,0,0,0,0,0,0,0,0,0,-52000
060098,華新科元大99購24,0,0,0,0,0,0,0,0,0,-53000,0,0,0,32000,85000,-53000,-53000
056603,嘉聯益國泰9A購01,0,0,0,0,0,0,0,0,0,-53000,0,0,0,101000,154000,-53000,-53000
060032,利勤永豐99購01  ,0,0,0,0,0,0,0,0,0,-53000,0,0,0,0,53000,-53000,-53000
057707,臺股指群益98購07,0,0,0,0,0,0,0,0,0,-53000,0,0,0,55000,108000,-53000,-53000
00680L,元大美債20正2   ,0,0,0,0,0,0,0,0,0,-53000,0,0,0,3000,56000,-53000,-53000
051375,道瓊反群益9A購01,0,0,0,0,0,0,0,0,0,-53000,0,0,0,0,53000,-53000,-53000
055058,大毅永豐97購01  ,0,0,0,0,0,0,0,0,0,-53000,0,0,0,15000,68000,-53000,-53000
055916,奇鋐凱基99購01  ,0,0,0,0,0,0,0,0,0,-53000,0,0,0,50000,103000,-53000,-53000
056517,茂林兆豐99購01  ,0,0,0,0,0,0,0,0,0,-53000,0,0,0,20000,73000,-53000,-53000
3419,譁裕            ,18000,71000,-53000,0,0,0,0,0,0,0,0,0,0,0,0,0,-53000
058685,TPK凱基99購01   ,0,0,0,0,0,0,0,0,0,-54000,0,0,0,51000,105000,-54000,-54000
058327,大毅統一9B購01  ,0,0,0,0,0,0,0,0,0,-54000,0,0,0,217000,271000,-54000,-54000
059133,臺股指群益99購08,0,0,0,0,0,0,0,0,0,-54000,0,0,0,5000,59000,-54000,-54000
056098,矽創元富97購02  ,0,0,0,0,0,0,0,0,0,-54000,0,0,0,0,54000,-54000,-54000
053539,智易永豐96購01  ,0,0,0,0,0,0,0,0,0,-54000,0,0,0,1000,55000,-54000,-54000
2429,銘旺科          ,0,54000,-54000,0,0,0,0,0,0,0,0,0,0,0,0,0,-54000
06371P,茂林國票98售04  ,0,0,0,0,0,0,0,0,0,-54000,0,0,0,69000,123000,-54000,-54000
07067P,旺宏台新99售02  ,0,0,0,0,0,0,0,0,0,-54000,0,0,0,151000,205000,-54000,-54000
056576,晶技元大99購02  ,0,0,0,0,0,0,0,0,0,-55000,0,0,0,132000,187000,-55000,-55000
059999,緯穎元富99購01  ,0,0,0,0,0,0,0,0,0,-55000,0,0,0,2000,57000,-55000,-55000
059510,華新科永豐99購07,0,0,0,0,0,0,0,0,0,-55000,0,0,0,90000,145000,-55000,-55000
059551,T50正2康和99購02,0,0,0,0,0,0,0,0,0,-55000,0,0,0,5000,60000,-55000,-55000
058271,訊連永豐99購01  ,0,0,0,0,0,0,0,0,0,-55000,0,0,0,0,55000,-55000,-55000
058096,南電元大98購04  ,0,0,0,0,0,0,0,0,0,-55000,0,0,0,207000,262000,-55000,-55000
057462,光磊永豐98購02  ,0,0,0,0,0,0,0,0,0,-55000,0,0,0,16000,71000,-55000,-55000
057477,智邦元大98購09  ,0,0,0,0,0,0,0,0,0,-55000,0,0,0,4000,59000,-55000,-55000
059910,鴻海元大99購37  ,0,0,0,0,0,0,0,0,0,-55000,0,0,0,0,55000,-55000,-55000
040761,T50反1凱基95購02,0,0,0,0,0,0,0,0,0,-55000,0,0,0,0,55000,-55000,-55000
05594P,旺宏國票96售04  ,0,0,0,0,0,0,0,0,0,-55000,0,0,0,13000,68000,-55000,-55000
05509P,智邦元富96售02  ,0,0,0,0,0,0,0,0,0,-55000,0,0,0,34000,89000,-55000,-55000
054754,昇陽半凱基98購02,0,0,0,0,0,0,0,0,0,-55000,0,0,0,0,55000,-55000,-55000
053361,友達元富99購01  ,0,0,0,0,0,0,0,0,0,-55000,0,0,0,300000,355000,-55000,-55000
052727,仁寶元富96購01  ,0,0,0,0,0,0,0,0,0,-55000,0,0,0,200000,255000,-55000,-55000
06933P,禾伸堂元大98售03,0,0,0,0,0,0,0,0,0,-55000,0,0,0,0,55000,-55000,-55000
2472,立隆電          ,59000,109000,-50000,0,0,0,0,0,0,-5000,0,5000,-5000,0,0,0,-55000
060392,華擎群益9C購02  ,0,0,0,0,0,0,0,0,0,-56000,0,0,0,100000,156000,-56000,-56000
058955,台積電國票9A購04,0,0,0,0,0,0,0,0,0,-56000,0,0,0,171000,227000,-56000,-56000
056297,台光電元大97購04,0,0,0,0,0,0,0,0,0,-56000,0,0,0,121000,177000,-56000,-56000
056919,英業達兆豐98購01,0,0,0,0,0,0,0,0,0,-56000,0,0,0,33000,89000,-56000,-56000
060023,T50反1國泰9A購03,0,0,0,0,0,0,0,0,0,-56000,0,0,0,16000,72000,-56000,-56000
057763,康控凱基99購02  ,0,0,0,0,0,0,0,0,0,-56000,0,0,0,10000,66000,-56000,-56000
058734,康友永豐99購01  ,0,0,0,0,0,0,0,0,0,-56000,0,0,0,0,56000,-56000,-56000
059256,臺股指凱基99購34,0,0,0,0,0,0,0,0,0,-56000,0,0,0,2000,58000,-56000,-56000
058630,日月光國票9A購01,0,0,0,0,0,0,0,0,0,-56000,0,0,0,40000,96000,-56000,-56000
050424,鴻海凱基96購03  ,0,0,0,0,0,0,0,0,0,-56000,0,0,0,0,56000,-56000,-56000
1568,倉佑            ,5000,61000,-56000,0,0,0,0,0,0,0,0,0,0,0,0,0,-56000
07559P,祥碩元大9A售03  ,0,0,0,0,0,0,0,0,0,-56000,0,0,0,0,56000,-56000,-56000
07081P,南電群益9A售01  ,0,0,0,0,0,0,0,0,0,-56000,0,0,0,10000,66000,-56000,-56000
9943,好樂迪          ,59000,115000,-56000,0,0,0,0,0,0,0,0,0,0,0,0,0,-56000
059870,全新凱基99購05  ,0,0,0,0,0,0,0,0,0,-57000,0,0,0,0,57000,-57000,-57000
060297,和碩元大9A購02  ,0,0,0,0,0,0,0,0,0,-57000,0,0,0,81000,138000,-57000,-57000
059942,全新永豐99購04  ,0,0,0,0,0,0,0,0,0,-57000,0,0,0,92000,149000,-57000,-57000
060111,臻鼎元大99購04  ,0,0,0,0,0,0,0,0,0,-57000,0,0,0,0,57000,-57000,-57000
057058,祥碩元大98購04  ,0,0,0,0,0,0,0,0,0,-57000,0,0,0,0,57000,-57000,-57000
060079,台郡台新99購03  ,0,0,0,0,0,0,0,0,0,-57000,0,0,0,10000,67000,-57000,-57000
051728,道瓊反國票97購01,0,0,0,0,0,0,0,0,0,-57000,0,0,0,0,57000,-57000,-57000
056471,台光電元大99購01,0,0,0,0,0,0,0,0,0,-57000,0,0,0,0,57000,-57000,-57000
4555,氣立            ,1000,58000,-57000,0,0,0,0,0,0,0,0,0,0,0,0,0,-57000
2908,特力            ,9000,66000,-57000,0,0,0,0,0,0,0,0,0,0,0,0,0,-57000
07094P,華通國票9A售03  ,0,0,0,0,0,0,0,0,0,-57000,0,0,0,47000,104000,-57000,-57000
060551,大立光凱基9B購02,0,0,0,0,0,0,0,0,0,-57000,0,0,0,0,57000,-57000,-57000
2020,美亞            ,0,56000,-56000,0,0,0,0,0,0,-1000,0,1000,-1000,0,0,0,-57000
059868,台光電凱基99購03,0,0,0,0,0,0,0,0,0,-58000,0,0,0,18000,76000,-58000,-58000
056199,美律永豐97購01  ,0,0,0,0,0,0,0,0,0,-58000,0,0,0,0,58000,-58000,-58000
059347,京鼎凱基99購02  ,0,2000,-2000,0,0,0,0,0,0,-56000,0,0,0,143000,199000,-56000,-58000
059455,玉晶光永豐99購05,0,0,0,0,0,0,0,0,0,-58000,0,0,0,4000,62000,-58000,-58000
055824,臺股指國票97購11,0,0,0,0,0,0,0,0,0,-58000,0,0,0,190000,248000,-58000,-58000
054745,智易凱基97購01  ,0,0,0,0,0,0,0,0,0,-58000,0,0,0,42000,100000,-58000,-58000
055458,燿華永豐98購01  ,0,0,0,0,0,0,0,0,0,-58000,0,0,0,0,58000,-58000,-58000
07544P,大立光凱基9A售09,0,0,0,0,0,0,0,0,0,-58000,0,0,0,10000,68000,-58000,-58000
06662P,玉晶光中信9A售01,0,0,0,0,0,0,0,0,0,-58000,0,0,0,0,58000,-58000,-58000
5907,大洋-KY         ,33000,91000,-58000,0,0,0,0,0,0,0,0,0,0,0,0,0,-58000
058479,亞光凱基9A購01  ,0,0,0,0,0,0,0,0,0,-59000,0,0,0,5000,64000,-59000,-59000
052088,漢唐元大95購02  ,0,0,0,0,0,0,0,0,0,-59000,0,0,0,0,59000,-59000,-59000
00710B,FH彭博高收益債  ,1000,0,1000,0,0,0,0,0,0,-60000,0,0,0,238000,298000,-60000,-59000
6605,帝寶            ,4000,63000,-59000,0,0,0,0,0,0,0,0,0,0,0,0,0,-59000
07482P,南亞科元富9A售04,0,0,0,0,0,0,0,0,0,-59000,0,0,0,18000,77000,-59000,-59000
07473P,祥碩元大9A售01  ,0,0,0,0,0,0,0,0,0,-59000,0,0,0,77000,136000,-59000,-59000
07457P,宏達電元大9A售01,0,0,0,0,0,0,0,0,0,-59000,0,0,0,21000,80000,-59000,-59000
056607,貿聯富邦99購02  ,0,0,0,0,0,0,0,0,0,-60000,0,0,0,0,60000,-60000,-60000
056572,義隆元大99購01  ,0,0,0,0,0,0,0,0,0,-60000,0,0,0,9000,69000,-60000,-60000
059357,華通永豐99購01  ,0,0,0,0,0,0,0,0,0,-60000,0,0,0,0,60000,-60000,-60000
059068,台虹國票9A購01  ,0,0,0,0,0,0,0,0,0,-60000,0,0,0,44000,104000,-60000,-60000
059215,台積電元大99購28,0,0,0,0,0,0,0,0,0,-60000,0,0,0,0,60000,-60000,-60000
058085,景碩群益9A購01  ,0,0,0,0,0,0,0,0,0,-60000,0,0,0,0,60000,-60000,-60000
059872,華新科凱基01購01,0,0,0,0,0,0,0,0,0,-60000,0,0,0,40000,100000,-60000,-60000
051991,泰碩元大95購02  ,0,0,0,0,0,0,0,0,0,-60000,0,0,0,0,60000,-60000,-60000
052077,可成元富98購02  ,0,0,0,0,0,0,0,0,0,-60000,0,0,0,0,60000,-60000,-60000
047298,聯茂元富96購01  ,0,0,0,0,0,0,0,0,0,-60000,0,0,0,0,60000,-60000,-60000
054203,滬深2X國票96購03,0,0,0,0,0,0,0,0,0,-60000,0,0,0,0,60000,-60000,-60000
058676,聯茂群益99購01  ,0,0,0,0,0,0,0,0,0,-60000,0,0,0,38000,98000,-60000,-60000
054241,深中小元大98購01,0,0,0,0,0,0,0,0,0,-60000,0,0,0,0,60000,-60000,-60000
060683,泰鼎元大9A購02  ,0,0,0,0,0,0,0,0,0,-60000,0,0,0,8000,68000,-60000,-60000
07189P,聯發科富邦9B售03,0,0,0,0,0,0,0,0,0,-60000,0,0,0,0,60000,-60000,-60000
2911,麗嬰房          ,2000,61000,-59000,0,0,0,0,0,0,-1000,0,1000,-1000,0,0,0,-60000
059819,台積電凱基99購17,0,0,0,0,0,0,0,0,0,-61000,0,0,0,67000,128000,-61000,-61000
057877,神達元大99購01  ,0,0,0,0,0,0,0,0,0,-61000,0,0,0,0,61000,-61000,-61000
056205,貿聯永豐97購01  ,0,0,0,0,0,0,0,0,0,-61000,0,0,0,4000,65000,-61000,-61000
058055,華擎統一9A購01  ,0,0,0,0,0,0,0,0,0,-61000,0,0,0,12000,73000,-61000,-61000
059761,國巨永豐99購06  ,0,0,0,0,0,0,0,0,0,-61000,0,0,0,17000,78000,-61000,-61000
058166,鴻海凱基9A購01  ,0,0,0,0,0,0,0,0,0,-61000,0,0,0,0,61000,-61000,-61000
058588,致茂中信9B購01  ,0,0,0,0,0,0,0,0,0,-61000,0,0,0,70000,131000,-61000,-61000
054077,中石化中信98購01,0,0,0,0,0,0,0,0,0,-61000,0,0,0,0,61000,-61000,-61000
053500,新日興兆豐97購01,0,0,0,0,0,0,0,0,0,-61000,0,0,0,5000,66000,-61000,-61000
9919,康那香          ,663000,774000,-111000,0,0,0,0,0,0,50000,50000,0,50000,0,0,0,-61000
07059P,華通國票9A售02  ,0,0,0,0,0,0,0,0,0,-61000,0,0,0,11000,72000,-61000,-61000
06914P,南茂元大98售03  ,0,0,0,0,0,0,0,0,0,-61000,0,0,0,93000,154000,-61000,-61000
060642,華擎永豐9A購02  ,0,0,0,0,0,0,0,0,0,-61000,0,0,0,0,61000,-61000,-61000
1737,臺鹽            ,7000,67000,-60000,0,0,0,0,0,0,-1000,0,1000,-1000,0,0,0,-61000
058134,信邦元大99購01  ,0,0,0,0,0,0,0,0,0,-62000,0,0,0,0,62000,-62000,-62000
058093,神達元大9A購01  ,0,0,0,0,0,0,0,0,0,-62000,0,0,0,0,62000,-62000,-62000
058237,嘉晶元大99購04  ,0,0,0,0,0,0,0,0,0,-62000,0,0,0,2000,64000,-62000,-62000
059648,台表科凱基99購03,0,0,0,0,0,0,0,0,0,-62000,0,0,0,11000,73000,-62000,-62000
04023P,臺股指元富99售02,0,0,0,0,0,0,0,0,0,-62000,0,0,0,0,62000,-62000,-62000
048628,T50反1元大96購03,0,0,0,0,0,0,0,0,0,-62000,0,0,0,0,62000,-62000,-62000
060657,旺宏統一9B購05  ,0,0,0,0,0,0,0,0,0,-62000,0,0,0,0,62000,-62000,-62000
06653P,美食元大98售02  ,0,0,0,0,0,0,0,0,0,-62000,0,0,0,0,62000,-62000,-62000
06602P,國巨統一99售02  ,0,0,0,0,0,0,0,0,0,-62000,0,0,0,1000000,1062000,-62000,-62000
07163P,臺股指群益99售14,0,0,0,0,0,0,0,0,0,-62000,0,0,0,12000,74000,-62000,-62000
058240,景碩元大99購04  ,0,0,0,0,0,0,0,0,0,-63000,0,0,0,0,63000,-63000,-63000
057809,英業達元大98購01,0,0,0,0,0,0,0,0,0,-63000,0,0,0,10000,73000,-63000,-63000
048651,美利達元大96購05,0,0,0,0,0,0,0,0,0,-63000,0,0,0,0,63000,-63000,-63000
052490,禾伸堂國票95購01,0,0,0,0,0,0,0,0,0,-63000,0,0,0,0,63000,-63000,-63000
055525,國巨群益98購05  ,0,0,0,0,0,0,0,0,0,-63000,0,0,0,2000,65000,-63000,-63000
058637,晶技兆豐99購01  ,0,0,0,0,0,0,0,0,0,-63000,0,0,0,539000,602000,-63000,-63000
2015,豐興            ,52000,85000,-33000,0,0,0,0,5014,-5014,-25000,0,25000,-25000,0,0,0,-63014
058210,臺股指凱基9C購04,0,0,0,0,0,0,0,0,0,-64000,0,0,0,0,64000,-64000,-64000
057662,上銀元大9A購01  ,0,0,0,0,0,0,0,0,0,-64000,0,0,0,5000,69000,-64000,-64000
057649,嘉聯益元大99購04,0,0,0,0,0,0,0,0,0,-64000,0,0,0,97000,161000,-64000,-64000
058621,華通國票9A購01  ,0,0,0,0,0,0,0,0,0,-64000,0,0,0,50000,114000,-64000,-64000
050138,台表科國票95購02,0,0,0,0,0,0,0,0,0,-64000,0,0,0,18000,82000,-64000,-64000
2488,漢平            ,24000,88000,-64000,0,0,0,0,0,0,0,0,0,0,0,0,0,-64000
07442P,華航康和9A售02  ,0,0,0,0,0,0,0,0,0,-64000,0,0,0,20000,84000,-64000,-64000
060630,國巨富邦9C購03  ,0,0,0,0,0,0,0,0,0,-64000,0,0,0,10000,74000,-64000,-64000
5608,四維航          ,3092,66000,-62908,0,0,0,0,0,0,-2000,0,2000,-2000,0,0,0,-64908
05817P,可成凱基96售07  ,0,0,0,0,0,0,0,0,0,-65000,0,0,0,15000,80000,-65000,-65000
059364,昇陽半永豐99購02,0,0,0,0,0,0,0,0,0,-65000,0,0,0,0,65000,-65000,-65000
059168,奇力新凱基99購05,0,10000,-10000,0,0,0,0,0,0,-55000,0,0,0,38000,93000,-55000,-65000
059099,元油2X統一9C購01,0,0,0,0,0,0,0,0,0,-65000,0,0,0,0,65000,-65000,-65000
060143,台積電國票9B購03,0,0,0,0,0,0,0,0,0,-65000,0,0,0,54000,119000,-65000,-65000
056441,燿華凱基98購01  ,0,0,0,0,0,0,0,0,0,-65000,0,0,0,60000,125000,-65000,-65000
053473,聯發科元大96購15,0,0,0,0,0,0,0,0,0,-65000,0,0,0,0,65000,-65000,-65000
2484,希華            ,56000,119000,-63000,0,0,0,0,0,0,-2000,0,2000,-2000,0,0,0,-65000
060656,國巨統一9C購03  ,0,0,0,0,0,0,0,0,0,-65000,0,0,0,100000,165000,-65000,-65000
060675,南亞科元大9A購02,0,0,0,0,0,0,0,0,0,-65000,0,0,0,3000,68000,-65000,-65000
06208P,台郡凱基97售03  ,0,0,0,0,0,0,0,0,0,-65000,0,0,0,0,65000,-65000,-65000
07263P,台積電元大99售37,0,0,0,0,0,0,0,0,0,-65000,0,0,0,61000,126000,-65000,-65000
06763P,技嘉元大98售05  ,0,0,0,0,0,0,0,0,0,-65000,0,0,0,27000,92000,-65000,-65000
07438P,臺股指麥證9A售05,0,0,0,0,65000,-65000,0,0,0,-65000,0,0,0,0,65000,-65000,-65000
07408P,台積電兆豐99售06,0,0,0,0,0,0,0,0,0,-65000,0,0,0,0,65000,-65000,-65000
3008,大立光          ,166000,237880,-71880,0,0,0,16000,25237,-9237,16000,12000,4000,8000,8000,0,8000,-65117
9940,信義            ,70000,99850,-29850,0,0,0,0,5519,-5519,-30000,0,30000,-30000,0,0,0,-65369
059804,台積電元富99購01,0,0,0,0,0,0,0,0,0,-66000,0,0,0,100000,166000,-66000,-66000
059095,訊芯元大99購01  ,0,0,0,0,0,0,0,0,0,-66000,0,0,0,5000,71000,-66000,-66000
059618,台積電日盛99購01,0,0,0,0,0,0,0,0,0,-66000,0,0,0,403000,469000,-66000,-66000
07326P,大立光元大99售23,0,0,0,0,0,0,0,0,0,-66000,0,0,0,0,66000,-66000,-66000
059144,嘉晶國票9A購02  ,0,0,0,0,0,0,0,0,0,-67000,0,0,0,0,67000,-67000,-67000
059643,日月光凱基99購02,0,0,0,0,0,0,0,0,0,-67000,0,0,0,63000,130000,-67000,-67000
059597,大立光元大99購21,0,0,0,0,0,0,0,0,0,-67000,0,0,0,49000,116000,-67000,-67000
059567,台積電凱基9A購12,0,0,0,0,0,0,0,0,0,-67000,0,0,0,31000,98000,-67000,-67000
057744,健策永豐98購02  ,0,0,0,0,0,0,0,0,0,-67000,0,0,0,169000,236000,-67000,-67000
056893,智邦元大98購02  ,0,0,0,0,0,0,0,0,0,-67000,0,0,0,88000,155000,-67000,-67000
07105P,大毅元富99售02  ,0,0,0,0,0,0,0,0,0,-67000,0,0,0,34000,101000,-67000,-67000
07344P,鴻海富邦9A售03  ,0,0,0,0,0,0,0,0,0,-67000,0,0,0,24000,91000,-67000,-67000
8131,福懋科          ,48000,124000,-76000,0,0,0,0,0,0,9000,27000,17000,10000,0,1000,-1000,-67000
057977,台光電永豐98購02,0,0,0,0,0,0,0,0,0,-68000,0,0,0,0,68000,-68000,-68000
056351,鴻海元大98購06  ,0,0,0,0,0,0,0,0,0,-68000,0,0,0,0,68000,-68000,-68000
056352,鴻海元大99購01  ,0,0,0,0,0,0,0,0,0,-68000,0,0,0,0,68000,-68000,-68000
057976,旺宏永豐98購03  ,0,0,0,0,0,0,0,0,0,-68000,0,0,0,0,68000,-68000,-68000
059840,鴻海富邦9A購02  ,0,0,0,0,0,0,0,0,0,-68000,0,0,0,150000,218000,-68000,-68000
056668,光磊國票99購01  ,0,0,0,0,0,0,0,0,0,-68000,0,0,0,25000,93000,-68000,-68000
056709,華通永豐98購01  ,0,0,0,0,0,0,0,0,0,-68000,0,0,0,0,68000,-68000,-68000
060161,牧德永豐9A購02  ,0,0,0,0,0,0,0,0,0,-68000,0,0,0,4000,72000,-68000,-68000
057059,易華電元大99購01,0,0,0,0,0,0,0,0,0,-68000,0,0,0,0,68000,-68000,-68000
060119,上銀富邦9B購03  ,0,0,0,0,0,0,0,0,0,-68000,0,0,0,184000,252000,-68000,-68000
060243,潤泰全元大9C購02,0,0,0,0,0,0,0,0,0,-68000,0,0,0,0,68000,-68000,-68000
060213,牧德康和9A購01  ,0,0,0,0,0,0,0,0,0,-68000,0,0,0,41000,109000,-68000,-68000
060335,明泰康和9A購01  ,0,0,0,0,0,0,0,0,0,-68000,0,0,0,10000,78000,-68000,-68000
058234,華新科元大99購12,0,0,0,0,0,0,0,0,0,-68000,0,0,0,0,68000,-68000,-68000
057370,可成元大98購07  ,0,0,0,0,0,0,0,0,0,-68000,0,0,0,0,68000,-68000,-68000
058450,旺宏永豐99購01  ,0,0,0,0,0,0,0,0,0,-68000,0,0,0,0,68000,-68000,-68000
059276,可成元大99購06  ,0,0,0,0,0,0,0,0,0,-68000,0,0,0,103000,171000,-68000,-68000
054245,鴻海元大96購23  ,0,0,0,0,0,0,0,0,0,-68000,0,0,0,0,68000,-68000,-68000
054936,鴻海元大97購10  ,0,0,0,0,0,0,0,0,0,-68000,0,0,0,0,68000,-68000,-68000
059415,台灣50元大9A購03,0,0,0,0,0,0,0,0,0,-68000,0,0,0,7000,75000,-68000,-68000
054164,強茂凱基98購01  ,0,0,0,0,0,0,0,0,0,-68000,0,0,0,0,68000,-68000,-68000
055835,華邦電元大97購03,0,0,0,0,0,0,0,0,0,-68000,0,0,0,0,68000,-68000,-68000
056057,華邦電元大97購05,0,0,0,0,0,0,0,0,0,-68000,0,0,0,0,68000,-68000,-68000
2417,圓剛            ,97000,165000,-68000,0,0,0,0,0,0,0,0,0,0,0,0,0,-68000
2351,順德            ,49000,122000,-73000,0,0,0,62000,50000,12000,-7000,0,7000,-7000,0,0,0,-68000
059268,鎧勝中信01購01  ,0,0,0,0,0,0,0,0,0,-69000,0,0,0,133000,202000,-69000,-69000
058775,台積電國票9A購02,0,0,0,0,0,0,0,0,0,-69000,0,0,0,103000,172000,-69000,-69000
060053,聯發科凱基9B購02,0,0,0,0,0,0,0,0,0,-69000,0,0,0,0,69000,-69000,-69000
056271,嘉澤統一97購01  ,0,0,0,0,0,0,0,0,0,-69000,0,0,0,0,69000,-69000,-69000
054626,建準凱基98購01  ,0,0,0,0,0,0,0,0,0,-69000,0,0,0,0,69000,-69000,-69000
054530,台光電國泰97購03,0,0,0,0,0,0,0,0,0,-69000,0,0,0,8000,77000,-69000,-69000
053287,臺股指元大96購15,0,0,0,0,0,0,0,0,0,-69000,0,0,0,1000,70000,-69000,-69000
00643,群益深証中小    ,25000,126000,-101000,0,0,0,0,0,0,32000,0,0,0,90000,58000,32000,-69000
1104,環泥            ,4059000,4128000,-69000,0,0,0,0,0,0,0,0,0,0,0,0,0,-69000
060576,欣興中信9B購01  ,0,0,0,0,0,0,0,0,0,-69000,0,0,0,0,69000,-69000,-69000
4155,訊映            ,34000,103000,-69000,0,0,0,0,0,0,0,0,0,0,0,0,0,-69000
3059,華晶科          ,115000,182000,-67000,0,0,0,0,0,0,-2000,0,2000,-2000,0,0,0,-69000
2104,國際中橡        ,590000,692920,-102920,0,0,0,0,6415,-6415,40000,0,40000,-40000,86000,6000,80000,-69335
059875,信邦凱基99購02  ,0,0,0,0,0,0,0,0,0,-70000,0,0,0,45000,115000,-70000,-70000
060643,牧德永豐9A購03  ,0,0,0,0,0,0,0,0,0,-70000,0,0,0,8000,78000,-70000,-70000
060218,台積電凱基9A購15,0,0,0,0,0,0,0,0,0,-70000,0,0,0,4000,74000,-70000,-70000
060089,台積電元大99購54,0,0,0,0,0,0,0,0,0,-70000,0,0,0,0,70000,-70000,-70000
059237,鴻海凱基9A購10  ,0,0,0,0,0,0,0,0,0,-70000,0,0,0,0,70000,-70000,-70000
057460,楠梓電永豐98購03,0,0,0,0,0,0,0,0,0,-70000,0,0,0,1000,71000,-70000,-70000
058245,訊連元大99購01  ,0,0,0,0,0,0,0,0,0,-70000,0,0,0,30000,100000,-70000,-70000
057824,日月光元大98購01,0,0,0,0,0,0,0,0,0,-70000,0,0,0,20000,90000,-70000,-70000
059517,茂林永豐99購02  ,0,0,0,0,0,0,0,0,0,-70000,0,0,0,20000,90000,-70000,-70000
057164,國巨元大98購14  ,0,0,0,0,0,0,0,0,0,-70000,0,0,0,48000,118000,-70000,-70000
050329,超眾永豐94購03  ,0,0,0,0,0,0,0,0,0,-70000,0,0,0,0,70000,-70000,-70000
052157,東元永豐95購01  ,0,0,0,0,0,0,0,0,0,-70000,0,0,0,50000,120000,-70000,-70000
052428,嘉晶永豐95購01  ,0,0,0,0,0,0,0,0,0,-70000,0,0,0,0,70000,-70000,-70000
052827,昇陽半永豐97購01,0,0,0,0,0,0,0,0,0,-70000,0,0,0,0,70000,-70000,-70000
05464P,華通康和95售02  ,0,0,0,0,0,0,0,0,0,-70000,0,0,0,80000,150000,-70000,-70000
054373,富邦金中信97購01,0,0,0,0,0,0,0,0,0,-70000,0,0,0,0,70000,-70000,-70000
07359P,台積電元大99售45,0,0,0,0,0,0,0,0,0,-70000,0,0,0,0,70000,-70000,-70000
07391P,台灣50國泰02售01,0,0,0,0,0,0,0,0,0,-70000,0,0,0,5000,75000,-70000,-70000
06657P,寶成元大98售01  ,0,0,0,0,0,0,0,0,0,-70000,0,0,0,0,70000,-70000,-70000
8411,福貞-KY         ,4000,74000,-70000,0,0,0,0,0,0,0,0,0,0,0,0,0,-70000
2368,金像電          ,6620000,7570910,-950910,0,0,0,491000,0,491000,389000,793000,404000,389000,0,0,0,-70910
060363,美律元富9A購01  ,0,0,0,0,0,0,0,0,0,-71000,0,0,0,154000,225000,-71000,-71000
054358,矽創兆豐96購01  ,0,0,0,0,0,0,0,0,0,-71000,0,0,0,0,71000,-71000,-71000
058658,瑞儀中信99購01  ,0,0,0,0,0,0,0,0,0,-71000,0,0,0,31000,102000,-71000,-71000
057632,傳奇永豐98購01  ,0,0,0,0,0,0,0,0,0,-71000,0,0,0,46000,117000,-71000,-71000
052269,T50反1日盛9B購01,0,0,0,0,0,0,0,0,0,-71000,0,0,0,0,71000,-71000,-71000
4934,太極            ,358000,429000,-71000,0,0,0,0,0,0,0,0,0,0,0,0,0,-71000
2608,嘉里大榮        ,36000,58000,-22000,0,0,0,0,6469,-6469,-43000,0,43000,-43000,0,0,0,-71469
060394,欣興麥證9A購01  ,0,0,0,1000,73000,-72000,0,0,0,-72000,0,0,0,1000,73000,-72000,-72000
056772,欣興元大99購01  ,0,0,0,0,0,0,0,0,0,-72000,0,0,0,10000,82000,-72000,-72000
058145,聯茂元大99購03  ,0,0,0,0,0,0,0,0,0,-72000,0,0,0,42000,114000,-72000,-72000
051929,GIS中信96購01   ,0,0,0,0,0,0,0,0,0,-72000,0,0,0,0,72000,-72000,-72000
055703,緯穎富邦98購01  ,0,0,0,0,0,0,0,0,0,-72000,0,0,0,0,72000,-72000,-72000
052886,世紀鋼兆豐96購01,0,0,0,0,0,0,0,0,0,-72000,0,0,0,0,72000,-72000,-72000
057355,彩晶統一98購03  ,0,0,0,0,0,0,0,0,0,-73000,0,0,0,12000,85000,-73000,-73000
057136,立積凱基98購02  ,0,0,0,0,0,0,0,0,0,-73000,0,0,0,0,73000,-73000,-73000
056529,中環凱基98購01  ,0,0,0,0,0,0,0,0,0,-73000,0,0,0,43000,116000,-73000,-73000
060253,昇陽半元大9C購01,0,0,0,0,0,0,0,0,0,-73000,0,0,0,5000,78000,-73000,-73000
059983,聯發科元大99購38,0,0,0,0,0,0,0,0,0,-73000,0,0,0,2000,75000,-73000,-73000
3518,柏騰            ,68000,141000,-73000,0,0,0,0,0,0,0,0,0,0,0,0,0,-73000
060342,台積電統一02購01,0,0,0,0,0,0,0,0,0,-74000,0,0,0,210000,284000,-74000,-74000
059764,健策永豐99購04  ,0,0,0,0,0,0,0,0,0,-74000,0,0,0,111000,185000,-74000,-74000
057691,健策凱基99購01  ,0,0,0,0,0,0,0,0,0,-74000,0,0,0,115000,189000,-74000,-74000
058239,景碩元大99購03  ,0,0,0,0,0,0,0,0,0,-74000,0,0,0,0,74000,-74000,-74000
058618,南電元大99購02  ,0,0,0,0,0,0,0,0,0,-74000,0,0,0,8000,82000,-74000,-74000
1598,岱宇            ,99000,171000,-72000,0,0,0,0,0,0,-2000,1000,3000,-2000,0,0,0,-74000
06718P,聯詠元大98售01  ,0,0,0,0,0,0,0,0,0,-74000,0,0,0,25000,99000,-74000,-74000
1464,得力            ,60293,99000,-38707,0,0,0,0,0,0,-36000,0,14000,-14000,0,22000,-22000,-74707
059862,全新群益99購04  ,0,0,0,0,0,0,0,0,0,-75000,0,0,0,2000,77000,-75000,-75000
055120,南港兆豐97購01  ,0,0,0,0,0,0,0,0,0,-75000,0,0,0,0,75000,-75000,-75000
060513,緯穎元大9B購01  ,0,0,0,0,0,0,0,0,0,-75000,0,0,0,2000,77000,-75000,-75000
060684,同欣電元大9A購01,0,0,0,0,0,0,0,0,0,-75000,0,0,0,5000,80000,-75000,-75000
058909,神達元大99購03  ,0,0,0,0,0,0,0,0,0,-76000,0,0,0,5000,81000,-76000,-76000
060145,牧德國票9A購02  ,0,0,0,0,0,0,0,0,0,-76000,0,0,0,29000,105000,-76000,-76000
059391,立積凱基9A購01  ,0,0,0,0,0,0,0,0,0,-76000,0,0,0,25000,101000,-76000,-76000
055731,美律元富97購01  ,0,0,0,0,0,0,0,0,0,-76000,0,0,0,53000,129000,-76000,-76000
058611,欣興元大99購06  ,0,0,0,0,0,0,0,0,0,-76000,0,0,0,0,76000,-76000,-76000
054239,台郡群益96購02  ,0,0,0,0,0,0,0,0,0,-76000,0,0,0,6000,82000,-76000,-76000
03414B,臺股指凱基99熊01,70000,0,70000,0,0,0,0,0,0,-146000,0,0,0,86000,232000,-146000,-76000
051413,富邦金國票96購02,0,0,0,0,0,0,0,0,0,-76000,0,0,0,0,76000,-76000,-76000
053563,台積電富邦97購01,0,0,0,0,0,0,0,0,0,-76000,0,0,0,0,76000,-76000,-76000
053910,嘉聯益凱基98購01,0,0,0,0,0,0,0,0,0,-76000,0,0,0,64000,140000,-76000,-76000
06668P,祥碩凱基98售02  ,0,0,0,0,0,0,0,0,0,-76000,0,0,0,0,76000,-76000,-76000
9925,新保            ,12000,85000,-73000,0,0,0,0,0,0,-3000,0,3000,-3000,0,0,0,-76000
2849,安泰銀          ,17000,77000,-60000,0,0,0,0,16361,-16361,0,0,0,0,0,0,0,-76361
059524,FBVIX凱基9A購02 ,0,0,0,0,0,0,0,0,0,-77000,0,0,0,168000,245000,-77000,-77000
06025P,臺股指元大99售02,0,0,0,0,0,0,0,0,0,-77000,0,0,0,193000,270000,-77000,-77000
053006,玉晶光永豐96購03,0,0,0,0,0,0,0,0,0,-77000,0,0,0,8000,85000,-77000,-77000
054271,中石化中信99購01,0,0,0,0,0,0,0,0,0,-77000,0,0,0,3000,80000,-77000,-77000
06852P,臺股指元大98售11,0,0,0,0,0,0,0,0,0,-77000,0,0,0,571000,648000,-77000,-77000
1906,寶隆            ,7000,88000,-81000,0,0,0,0,0,0,4000,4000,0,4000,0,0,0,-77000
060200,同欣電元富9A購01,0,0,0,0,0,0,0,0,0,-78000,0,0,0,67000,145000,-78000,-78000
05976P,國巨凱基96售14  ,0,0,0,0,0,0,0,0,0,-78000,0,0,0,8000,86000,-78000,-78000
058027,鴻海富邦98購04  ,0,0,0,0,0,0,0,0,0,-78000,0,0,0,5000,83000,-78000,-78000
059083,華通元大99購07  ,0,0,0,0,0,0,0,0,0,-78000,0,0,0,0,78000,-78000,-78000
2374,佳能            ,9000,85000,-76000,0,0,0,0,0,0,-2000,0,2000,-2000,0,0,0,-78000
2390,云辰            ,32000,110000,-78000,0,0,0,0,0,0,0,0,0,0,0,0,0,-78000
06717P,可成元大98售09  ,0,0,0,0,0,0,0,0,0,-78000,0,0,0,6000,84000,-78000,-78000
4576,大銀微系統      ,34000,112000,-78000,0,0,0,0,0,0,0,0,0,0,0,0,0,-78000
3622,洋華            ,18000,96000,-78000,0,0,0,0,0,0,0,0,0,0,0,0,0,-78000
059574,台表科凱基99購02,0,0,0,0,0,0,0,0,0,-79000,0,0,0,12000,91000,-79000,-79000
057288,聯茂元大98購03  ,0,0,0,0,0,0,0,0,0,-79000,0,0,0,0,79000,-79000,-79000
058273,同欣電永豐99購01,0,0,0,0,0,0,0,0,0,-79000,0,0,0,0,79000,-79000,-79000
060312,潤泰全永豐9A購01,0,0,0,0,0,0,0,0,0,-79000,0,0,0,1000,80000,-79000,-79000
054506,矽格永豐96購01  ,0,0,0,0,0,0,0,0,0,-79000,0,0,0,0,79000,-79000,-79000
056142,超眾元大97購06  ,0,0,0,0,0,0,0,0,0,-79000,0,0,0,254000,333000,-79000,-79000
053898,康友群益97購01  ,0,0,0,0,0,0,0,0,0,-79000,0,0,0,0,79000,-79000,-79000
059709,上証2X元大9C購01,0,0,0,0,0,0,0,0,0,-80000,0,0,0,20000,100000,-80000,-80000
059050,元油2X凱基9B購08,0,0,0,0,0,0,0,0,0,-80000,0,0,0,0,80000,-80000,-80000
057713,美律統一99購01  ,0,0,0,0,0,0,0,0,0,-80000,0,0,0,272000,352000,-80000,-80000
060029,嘉晶永豐99購03  ,0,0,0,0,0,0,0,0,0,-80000,0,0,0,73000,153000,-80000,-80000
058766,力山兆豐99購01  ,0,0,0,0,0,0,0,0,0,-80000,0,0,0,0,80000,-80000,-80000
059646,聯茂凱基99購06  ,0,0,0,0,0,0,0,0,0,-80000,0,0,0,59000,139000,-80000,-80000
059266,緯創中信01購01  ,0,0,0,0,0,0,0,0,0,-80000,0,0,0,0,80000,-80000,-80000
053836,亞光永豐96購02  ,0,0,0,0,0,0,0,0,0,-80000,0,0,0,0,80000,-80000,-80000
055324,TPK國票98購03   ,0,0,0,0,0,0,0,0,0,-80000,0,0,0,0,80000,-80000,-80000
051192,緯創兆豐96購01  ,0,0,0,0,0,0,0,0,0,-80000,0,0,0,0,80000,-80000,-80000
050902,南電元大96購01  ,0,0,0,0,0,0,0,0,0,-80000,0,0,0,104000,184000,-80000,-80000
059989,嘉晶元大9A購01  ,0,0,0,0,0,0,0,0,0,-80000,0,0,0,4000,84000,-80000,-80000
055725,嘉聯益元大98購03,0,0,0,0,0,0,0,0,0,-80000,0,0,0,58000,138000,-80000,-80000
054090,瑞昱群益97購01  ,0,0,0,0,0,0,0,0,0,-80000,0,0,0,5000,85000,-80000,-80000
055479,GIS凱基97購04   ,0,0,0,0,0,0,0,0,0,-80000,0,0,0,0,80000,-80000,-80000
055461,TPK永豐97購01   ,0,0,0,0,0,0,0,0,0,-80000,0,0,0,0,80000,-80000,-80000
053429,彩晶永豐96購01  ,0,0,0,0,0,0,0,0,0,-80000,0,0,0,0,80000,-80000,-80000
3712,永崴投控        ,27000,105000,-78000,0,0,0,0,0,0,-2000,0,2000,-2000,0,0,0,-80000
4526,東台            ,10000,88000,-78000,0,0,0,0,0,0,-2000,0,2000,-2000,0,0,0,-80000
4942,嘉彰            ,10000,90000,-80000,0,0,0,0,0,0,0,0,0,0,0,0,0,-80000
06453P,群創元大9B售02  ,0,0,0,0,0,0,0,0,0,-80000,0,0,0,0,80000,-80000,-80000
1608,華榮            ,105000,179000,-74000,0,0,0,0,0,0,-6000,0,6000,-6000,0,0,0,-80000
07535P,上銀元富9A售03  ,0,0,0,0,0,0,0,0,0,-80000,0,0,0,0,80000,-80000,-80000
057816,欣興元大98購13  ,0,0,0,0,0,0,0,0,0,-81000,0,0,0,0,81000,-81000,-81000
060285,聯電元大9C購01  ,0,0,0,0,0,0,0,0,0,-81000,0,0,0,335000,416000,-81000,-81000
053244,光磊國票97購01  ,0,0,0,0,0,0,0,0,0,-81000,0,0,0,0,81000,-81000,-81000
055240,京元電元富97購01,0,0,0,0,0,0,0,0,0,-81000,0,0,0,294000,375000,-81000,-81000
048859,玉晶光群益96購02,0,0,0,0,0,0,0,0,0,-81000,0,0,0,5000,86000,-81000,-81000
1455,集盛            ,69000,144363,-75363,0,0,0,0,0,0,-6000,0,6000,-6000,0,0,0,-81363
1604,聲寶            ,41000,117000,-76000,0,0,0,0,0,0,-6000,0,6000,-6000,0,0,0,-82000
060561,台積電富邦04購01,0,0,0,0,0,0,0,0,0,-82000,0,0,0,249000,331000,-82000,-82000
2548,華固            ,170000,207800,-37800,0,0,0,0,2330,-2330,-42000,50000,92000,-42000,0,0,0,-82130
060195,旭富元富9A購02  ,0,0,0,0,0,0,0,0,0,-83000,0,0,0,58000,141000,-83000,-83000
05708P,奇力新國票97售04,0,0,0,0,0,0,0,0,0,-83000,0,0,0,86000,169000,-83000,-83000
057342,玉晶光台新98購01,0,0,0,0,0,0,0,0,0,-83000,0,0,0,600000,683000,-83000,-83000
057471,昇陽半永豐98購02,0,0,0,0,0,0,0,0,0,-83000,0,0,0,0,83000,-83000,-83000
055327,致新國票98購01  ,0,0,0,0,0,0,0,0,0,-83000,0,0,0,38000,121000,-83000,-83000
050754,元金2X元富9B購01,0,0,0,0,0,0,0,0,0,-83000,0,0,0,0,83000,-83000,-83000
055584,國巨元大97購11  ,0,0,0,0,0,0,0,0,0,-83000,0,0,0,53000,136000,-83000,-83000
06492P,上銀永豐98售01  ,0,0,0,0,0,0,0,0,0,-83000,0,0,0,0,83000,-83000,-83000
2062,橋椿            ,12000,92000,-80000,0,0,0,0,0,0,-3000,0,3000,-3000,0,0,0,-83000
5434,崇越            ,80000,154240,-74240,0,0,0,0,0,0,-9000,0,9000,-9000,0,0,0,-83240
2897,王道銀行        ,190000,117000,73000,0,0,0,0,11711,-11711,-145000,0,145000,-145000,0,0,0,-83711
057176,全新元大99購02  ,0,0,0,0,0,0,0,0,0,-84000,0,0,0,16000,100000,-84000,-84000
059305,台灣50元大99購02,0,0,0,0,0,0,0,0,0,-84000,0,0,0,0,84000,-84000,-84000
060131,GIS永豐99購03   ,0,0,0,0,0,0,0,0,0,-84000,0,0,0,76000,160000,-84000,-84000
042315,T50反1台新96購01,0,0,0,0,0,0,0,0,0,-84000,0,0,0,0,84000,-84000,-84000
00638R,元大滬深300反1  ,23000,29000,-6000,0,0,0,0,0,0,-78000,0,0,0,69000,147000,-78000,-84000
3028,增你強          ,8000,89000,-81000,0,0,0,0,0,0,-3000,0,3000,-3000,0,0,0,-84000
3321,同泰            ,10000,94000,-84000,0,0,0,0,0,0,0,0,0,0,0,0,0,-84000
3052,夆典            ,75002,159000,-83998,0,0,0,0,0,0,-1000,1000,2000,-1000,0,0,0,-84998
058728,SP黃豆永豐99購01,0,0,0,0,0,0,0,0,0,-85000,0,0,0,0,85000,-85000,-85000
051721,玉晶光永豐96購02,0,0,0,0,0,0,0,0,0,-85000,0,0,0,30000,115000,-85000,-85000
055147,鴻海元大97購11  ,0,0,0,0,0,0,0,0,0,-85000,0,0,0,0,85000,-85000,-85000
1309,台達化          ,119000,203000,-84000,0,0,0,0,0,0,-1000,0,1000,-1000,0,0,0,-85000
07553P,嘉晶元大9A售02  ,0,0,0,0,0,0,0,0,0,-85000,0,0,0,200000,285000,-85000,-85000
07354P,臺股指國票99售22,0,0,0,0,0,0,0,0,0,-85000,0,0,0,50000,135000,-85000,-85000
07469P,台達電元大9A售01,0,0,0,0,0,0,0,0,0,-85000,0,0,0,0,85000,-85000,-85000
06654P,欣興元大98售08  ,0,0,0,0,0,0,0,0,0,-85000,0,0,0,103000,188000,-85000,-85000
07304P,臺股指元大9A售37,0,0,0,0,0,0,0,0,0,-85000,0,0,0,31000,116000,-85000,-85000
059611,台積電永豐99購05,0,0,0,0,0,0,0,0,0,-86000,0,0,0,1000,87000,-86000,-86000
058836,FBVIX中信03購05 ,0,0,0,0,0,0,0,0,0,-86000,0,0,0,62000,148000,-86000,-86000
059833,緯穎康和99購01  ,0,0,0,0,0,0,0,0,0,-86000,0,0,0,55000,141000,-86000,-86000
055136,聯發科富邦99購06,0,0,0,0,0,0,0,0,0,-86000,0,0,0,0,86000,-86000,-86000
050169,臺指反元大97購01,0,0,0,0,0,0,0,0,0,-86000,0,0,0,0,86000,-86000,-86000
00706L,元大S&P日圓正2  ,0,0,0,0,0,0,0,0,0,-86000,0,0,0,66000,152000,-86000,-86000
052781,瀚宇博國票97購03,0,0,0,0,0,0,0,0,0,-86000,0,0,0,0,86000,-86000,-86000
05565P,鎧勝元大96售01  ,0,0,0,0,0,0,0,0,0,-86000,0,0,0,5000,91000,-86000,-86000
054229,超眾元富96購05  ,0,0,0,0,0,0,0,0,0,-86000,0,0,0,668000,754000,-86000,-86000
060281,卜蜂元大9C購01  ,0,0,0,0,0,0,0,0,0,-86000,0,0,0,0,86000,-86000,-86000
05306P,泰碩國泰97售01  ,0,0,0,0,0,0,0,0,0,-87000,0,0,0,86000,173000,-87000,-87000
07421P,國泰金元大99售01,0,0,0,0,0,0,0,0,0,-87000,0,0,0,0,87000,-87000,-87000
058390,樺漢國票9A購01  ,0,0,0,0,0,0,0,0,0,-88000,0,0,0,0,88000,-88000,-88000
055815,亞光國票99購01  ,0,0,0,0,0,0,0,0,0,-88000,0,0,0,12000,100000,-88000,-88000
046791,台郡統一96購01  ,0,0,0,0,0,0,0,0,0,-88000,0,0,0,0,88000,-88000,-88000
060514,南電元大9A購02  ,0,0,0,0,0,0,0,0,0,-88000,0,0,0,20000,108000,-88000,-88000
2207,和泰車          ,95000,167010,-72010,0,0,0,0,1325,-1325,-15000,0,15000,-15000,0,0,0,-88335
9939,宏全            ,75000,147350,-72350,0,0,0,0,0,0,-16000,10000,26000,-16000,0,0,0,-88350
057536,康控元大99購03  ,0,0,0,0,0,0,0,0,0,-89000,0,0,0,17000,106000,-89000,-89000
060387,盛群凱基9A購01  ,0,0,0,0,0,0,0,0,0,-89000,0,0,0,10000,99000,-89000,-89000
060476,瑞祺元大9A購02  ,0,0,0,0,0,0,0,0,0,-89000,0,0,0,277000,366000,-89000,-89000
050644,國巨凱基96購01  ,0,0,0,0,0,0,0,0,0,-89000,0,0,0,22000,111000,-89000,-89000
051644,聯茂康和95購01  ,0,0,0,0,0,0,0,0,0,-89000,0,0,0,38000,127000,-89000,-89000
054582,致新元大97購01  ,0,0,0,0,0,0,0,0,0,-89000,0,0,0,103000,192000,-89000,-89000
3698,隆達            ,201000,235000,-34000,0,0,0,0,0,0,-55000,2000,21000,-19000,0,36000,-36000,-89000
3022,威強電          ,27000,107000,-80000,0,0,0,0,0,0,-9000,0,9000,-9000,0,0,0,-89000
07519P,臺股指元大9B售10,0,0,0,0,0,0,0,0,0,-89000,0,0,0,0,89000,-89000,-89000
07290P,台灣50凱基9A售08,0,0,0,0,0,0,0,0,0,-89000,0,0,0,16000,105000,-89000,-89000
07270P,台灣50元大01售09,0,0,0,0,0,0,0,0,0,-89000,0,0,0,2000,91000,-89000,-89000
057072,日月光永豐98購01,0,0,0,0,0,0,0,0,0,-90000,0,0,0,27000,117000,-90000,-90000
059004,嘉晶元大99購05  ,0,0,0,0,0,0,0,0,0,-90000,0,0,0,0,90000,-90000,-90000
059915,聯發科元大99購32,0,0,0,0,0,0,0,0,0,-90000,0,0,0,0,90000,-90000,-90000
056526,力山凱基98購01  ,0,0,0,0,0,0,0,0,0,-90000,0,0,0,68000,158000,-90000,-90000
058488,華擎國票9A購01  ,0,0,0,0,0,0,0,0,0,-90000,0,0,0,0,90000,-90000,-90000
059219,旺宏元大99購12  ,0,0,0,0,0,0,0,0,0,-90000,0,0,0,20000,110000,-90000,-90000
053183,大立光元富96購03,0,0,0,0,0,0,0,0,0,-90000,0,0,0,10000,100000,-90000,-90000
050171,臺指反元大97購03,0,0,0,0,0,0,0,0,0,-90000,0,0,0,0,90000,-90000,-90000
07084P,S&P正2元富9B售02,0,0,0,0,0,0,0,0,0,-90000,0,0,0,0,90000,-90000,-90000
060552,群創凱基9B購05  ,0,0,0,0,0,0,0,0,0,-90000,0,0,0,0,90000,-90000,-90000
1723,中碳            ,23000,96000,-73000,0,0,0,0,1734,-1734,-16000,1000,17000,-16000,0,0,0,-90734
058824,晶技富邦9A購01  ,0,0,0,0,0,0,0,0,0,-91000,0,0,0,0,91000,-91000,-91000
060298,鎧勝元大9C購01  ,0,0,0,0,0,0,0,0,0,-91000,0,0,0,253000,344000,-91000,-91000
03441B,臺股指凱基9A熊05,0,0,0,0,0,0,0,0,0,-91000,0,0,0,210000,301000,-91000,-91000
1109,信大            ,36000,127000,-91000,0,0,0,0,0,0,0,0,0,0,0,0,0,-91000
060634,矽創富邦9B購01  ,0,0,0,0,0,0,0,0,0,-91000,0,0,0,0,91000,-91000,-91000
07316P,長榮航康和99售01,0,0,0,0,0,0,0,0,0,-91000,0,0,0,48000,139000,-91000,-91000
2634,漢翔            ,146000,189000,-43000,0,0,0,0,3288,-3288,-45000,0,45000,-45000,0,0,0,-91288
060045,嘉晶群益99購02  ,0,0,0,0,0,0,0,0,0,-92000,0,0,0,3000,95000,-92000,-92000
057499,奇鋐群益98購01  ,0,0,0,0,0,0,0,0,0,-92000,0,0,0,115000,207000,-92000,-92000
057491,美食元大98購03  ,0,0,0,0,0,0,0,0,0,-92000,0,0,0,3000,95000,-92000,-92000
03433B,臺股指元大9C熊01,0,0,0,0,0,0,0,0,0,-92000,0,0,0,130000,222000,-92000,-92000
052681,T50反1元大98購02,0,0,0,0,0,0,0,0,0,-92000,0,0,0,210000,302000,-92000,-92000
050514,聯電元大94購01  ,0,0,0,0,0,0,0,0,0,-92000,0,0,0,221000,313000,-92000,-92000
055785,祥碩凱基97購02  ,0,0,0,0,0,0,0,0,0,-92000,0,0,0,10000,102000,-92000,-92000
3035,智原            ,177000,253000,-76000,0,0,0,0,0,0,-16000,12000,26000,-14000,0,2000,-2000,-92000
2316,楠梓電          ,448000,640000,-192000,0,0,0,0,0,0,100000,0,3000,-3000,112000,9000,103000,-92000
057486,美律元大98購04  ,0,0,0,0,0,0,0,0,0,-93000,0,0,0,23000,116000,-93000,-93000
059170,康控凱基9B購01  ,0,0,0,0,0,0,0,0,0,-93000,0,0,0,22000,115000,-93000,-93000
059264,台光電中信99購02,0,0,0,0,0,0,0,0,0,-93000,0,0,0,171000,264000,-93000,-93000
060204,矽創元富9A購01  ,0,0,0,0,0,0,0,0,0,-93000,0,0,0,22000,115000,-93000,-93000
059740,瑞昱元富99購02  ,0,0,0,0,0,0,0,0,0,-93000,0,0,0,0,93000,-93000,-93000
053922,亞光國票96購01  ,0,0,0,0,0,0,0,0,0,-93000,0,0,0,3000,96000,-93000,-93000
1526,日馳            ,13000,106000,-93000,0,0,0,0,0,0,0,0,0,0,0,0,0,-93000
07319P,台積電凱基01售02,10000,0,10000,0,0,0,0,0,0,-103000,0,0,0,49000,152000,-103000,-93000
2362,藍天            ,98000,186000,-88000,0,0,0,0,5302,-5302,0,0,0,0,0,0,0,-93302
060233,宏碁元大9A購01  ,0,0,0,0,0,0,0,0,0,-94000,0,0,0,40000,134000,-94000,-94000
060293,緯創元大9A購01  ,0,0,0,0,0,0,0,0,0,-94000,0,0,0,0,94000,-94000,-94000
059816,聯電凱基99購03  ,0,0,0,0,0,0,0,0,0,-94000,0,0,0,17000,111000,-94000,-94000
059814,SP黃豆凱基9A購02,0,0,0,0,0,0,0,0,0,-94000,0,0,0,25000,119000,-94000,-94000
059568,台積電凱基9A購13,0,0,0,0,0,0,0,0,0,-94000,0,0,0,5000,99000,-94000,-94000
053954,貿聯康和96購01  ,0,0,0,0,0,0,0,0,0,-94000,0,0,0,0,94000,-94000,-94000
055052,凱美永豐97購01  ,0,0,0,0,0,0,0,0,0,-94000,0,0,0,16000,110000,-94000,-94000
04713P,創意元大95售01  ,0,0,0,0,0,0,0,0,0,-94000,0,0,0,0,94000,-94000,-94000
5519,隆大            ,101000,195000,-94000,0,0,0,0,0,0,0,0,0,0,0,0,0,-94000
3665,貿聯-KY         ,314000,243550,70450,0,0,0,0,20334,-20334,-145000,0,135000,-135000,0,10000,-10000,-94884
059059,宏達電凱基99購03,0,0,0,0,0,0,0,0,0,-95000,0,0,0,47000,142000,-95000,-95000
057324,億光群益98購01  ,0,0,0,0,0,0,0,0,0,-95000,0,0,0,4000,99000,-95000,-95000
057222,鴻海國票99購04  ,0,0,0,0,0,0,0,0,0,-95000,0,0,0,0,95000,-95000,-95000
052986,聯發科元大97購05,0,0,0,0,0,0,0,0,0,-95000,0,0,0,0,95000,-95000,-95000
2536,宏普            ,45000,125000,-80000,0,0,0,0,0,0,-15000,1000,16000,-15000,0,0,0,-95000
06034P,世芯凱基96售03  ,0,0,0,0,0,0,0,0,0,-96000,0,0,0,0,96000,-96000,-96000
060160,聯陽永豐9A購01  ,0,0,0,0,0,0,0,0,0,-96000,0,0,0,61000,157000,-96000,-96000
054751,GIS凱基98購01   ,0,0,0,0,0,0,0,0,0,-96000,0,0,0,0,96000,-96000,-96000
056127,致新國票98購02  ,0,0,0,0,0,0,0,0,0,-96000,0,0,0,0,96000,-96000,-96000
050846,緯創國票96購01  ,0,0,0,0,0,0,0,0,0,-96000,0,0,0,1000,97000,-96000,-96000
2006,東和鋼鐵        ,82000,227340,-145340,0,0,0,0,5842,-5842,55000,100000,45000,55000,0,0,0,-96182
059047,元油2X凱基9A購10,0,0,0,0,0,0,0,0,0,-97000,0,0,0,549000,646000,-97000,-97000
058741,欣興日盛99購01  ,0,0,0,0,0,0,0,0,0,-97000,0,0,0,0,97000,-97000,-97000
057470,易華電永豐98購02,0,0,0,0,0,0,0,0,0,-97000,0,0,0,5000,102000,-97000,-97000
059187,國巨富邦9B購02  ,0,0,0,0,0,0,0,0,0,-97000,0,0,0,318000,415000,-97000,-97000
059637,大立光凱基01購01,0,0,0,0,0,0,0,0,0,-97000,0,0,0,45000,142000,-97000,-97000
050512,台泥元大94購01  ,0,0,0,0,0,0,0,0,0,-97000,0,0,0,2000,99000,-97000,-97000
055963,欣興元大97購04  ,0,0,0,0,0,0,0,0,0,-97000,0,0,0,0,97000,-97000,-97000
2401,凌陽            ,184000,255000,-71000,0,0,0,0,0,0,-26000,0,26000,-26000,0,0,0,-97000
07312P,台灣50元大99售10,0,0,0,0,0,0,0,0,0,-97000,0,0,0,48000,145000,-97000,-97000
06885P,國巨國票99售06  ,0,0,0,0,0,0,0,0,0,-97000,0,0,0,13000,110000,-97000,-97000
057446,旺宏元富02購01  ,0,0,0,0,0,0,0,0,0,-98000,0,0,0,0,98000,-98000,-98000
058732,矽格永豐99購01  ,0,0,0,0,0,0,0,0,0,-98000,0,0,0,64000,162000,-98000,-98000
056788,日月光群益98購01,0,0,0,0,0,0,0,0,0,-98000,0,0,0,0,98000,-98000,-98000
054862,群光群益97購01  ,0,0,0,0,0,0,0,0,0,-98000,0,0,0,0,98000,-98000,-98000
053376,鴻海元大96購19  ,0,0,0,0,0,0,0,0,0,-98000,0,0,0,0,98000,-98000,-98000
060566,聯詠富邦9C購01  ,0,0,0,0,0,0,0,0,0,-98000,0,0,0,23000,121000,-98000,-98000
07360P,台積電元大99售46,0,0,0,0,0,0,0,0,0,-98000,0,0,0,1000,99000,-98000,-98000
6706,惠特            ,91000,139000,-48000,0,0,0,0,0,0,-50000,0,50000,-50000,0,0,0,-98000
2707,晶華            ,10000,95000,-85000,0,0,0,0,555,-555,-13000,0,13000,-13000,0,0,0,-98555
059687,卜蜂永豐99購01  ,0,0,0,0,0,0,0,0,0,-99000,0,0,0,0,99000,-99000,-99000
056178,嘉澤元富97購02  ,0,0,0,0,0,0,0,0,0,-99000,0,0,0,0,99000,-99000,-99000
059073,元油2X元大9C購14,0,0,0,0,0,0,0,0,0,-99000,0,0,0,239000,338000,-99000,-99000
056617,美律永豐98購01  ,0,0,0,0,0,0,0,0,0,-99000,0,0,0,27000,126000,-99000,-99000
058468,聯茂中信99購02  ,0,0,0,0,0,0,0,0,0,-99000,0,0,0,0,99000,-99000,-99000
058416,鴻海麥證99購01  ,0,0,0,0,99000,-99000,0,0,0,-99000,0,0,0,0,99000,-99000,-99000
055449,超眾統一9A購01  ,0,0,0,0,0,0,0,0,0,-99000,0,0,0,121000,220000,-99000,-99000
054169,上緯控凱基98購01,0,0,0,0,0,0,0,0,0,-99000,0,0,0,2000,101000,-99000,-99000
058583,臻鼎群益99購01  ,0,0,0,0,0,0,0,0,0,-99000,0,0,0,0,99000,-99000,-99000
046937,聯電元大99購01  ,0,0,0,0,0,0,0,0,0,-99000,0,0,0,481000,580000,-99000,-99000
049690,義隆元大95購02  ,0,0,0,0,0,0,0,0,0,-99000,0,0,0,0,99000,-99000,-99000
048850,聯電群益96購01  ,0,0,0,0,0,0,0,0,0,-99000,0,0,0,80000,179000,-99000,-99000
1451,年興            ,1000,100000,-99000,0,0,0,0,0,0,0,0,0,0,0,0,0,-99000
1589,永冠-KY         ,22000,93000,-71000,0,0,0,0,0,0,-28000,0,28000,-28000,0,0,0,-99000
060714,晶技永豐9A購02  ,0,0,0,0,0,0,0,0,0,-99000,0,0,0,0,99000,-99000,-99000
1736,喬山            ,332000,477475,-145475,0,0,0,0,712,-712,47000,0,0,0,50000,3000,47000,-99187
058507,美律元大9A購01  ,0,0,0,0,0,0,0,0,0,-100000,0,0,0,50000,150000,-100000,-100000
056596,光磊元富98購01  ,0,0,0,0,0,0,0,0,0,-100000,0,0,0,0,100000,-100000,-100000
058699,楠梓電元大99購02,0,0,0,0,0,0,0,0,0,-100000,0,0,0,0,100000,-100000,-100000
057106,美律群益98購03  ,0,0,0,0,0,0,0,0,0,-100000,0,0,0,0,100000,-100000,-100000
058136,景碩元大99購02  ,0,0,0,0,0,0,0,0,0,-100000,0,0,0,0,100000,-100000,-100000
056308,TPK元大97購02   ,0,0,0,0,0,0,0,0,0,-100000,0,0,0,68000,168000,-100000,-100000
057956,全新元大99購04  ,0,0,0,0,0,0,0,0,0,-100000,0,0,0,0,100000,-100000,-100000
056989,鴻海兆豐98購02  ,0,0,0,0,0,0,0,0,0,-100000,0,0,0,0,100000,-100000,-100000
056378,欣興元富98購01  ,0,0,0,0,0,0,0,0,0,-100000,0,0,0,0,100000,-100000,-100000
056763,國巨元大99購02  ,0,0,0,0,0,0,0,0,0,-100000,0,0,0,130000,230000,-100000,-100000
059006,樺漢元大99購01  ,0,0,0,0,0,0,0,0,0,-100000,0,0,0,39000,139000,-100000,-100000
059946,健策永豐99購05  ,0,0,0,0,0,0,0,0,0,-100000,0,0,0,222000,322000,-100000,-100000
060048,元金2X凱基99購03,0,0,0,0,0,0,0,0,0,-100000,0,0,0,10000,110000,-100000,-100000
048433,聯詠國票94購01  ,0,0,0,0,0,0,0,0,0,-100000,0,0,0,50000,150000,-100000,-100000
03657C,T50反1元大99牛01,0,0,0,0,0,0,0,0,0,-100000,0,0,0,100000,200000,-100000,-100000
052067,中磊兆豐96購01  ,0,0,0,0,0,0,0,0,0,-100000,0,0,0,0,100000,-100000,-100000
05194P,玉晶光康和95售01,0,0,0,0,0,0,0,0,0,-100000,0,0,0,0,100000,-100000,-100000
051793,臻鼎國票95購02  ,0,0,0,0,0,0,0,0,0,-100000,0,0,0,0,100000,-100000,-100000
050459,台表科元大94購03,0,0,0,0,0,0,0,0,0,-100000,0,0,0,0,100000,-100000,-100000
050263,旺宏元大94購10  ,0,0,0,0,0,0,0,0,0,-100000,0,0,0,0,100000,-100000,-100000
050116,嘉澤元大94購03  ,0,0,0,0,0,0,0,0,0,-100000,0,0,0,0,100000,-100000,-100000
051600,新日興兆豐96購02,0,0,0,0,0,0,0,0,0,-100000,0,0,0,0,100000,-100000,-100000
054167,揚明光凱基98購01,0,0,0,0,0,0,0,0,0,-100000,0,0,0,0,100000,-100000,-100000
055682,智原凱基98購02  ,0,0,0,0,0,0,0,0,0,-100000,0,0,0,0,100000,-100000,-100000
055745,臻鼎元富97購01  ,0,0,0,0,0,0,0,0,0,-100000,0,0,0,0,100000,-100000,-100000
055900,瀚宇博中信97購01,0,0,0,0,0,0,0,0,0,-100000,0,0,0,15000,115000,-100000,-100000
052867,晶技凱基96購01  ,0,0,0,0,0,0,0,0,0,-100000,0,0,0,0,100000,-100000,-100000
055419,國巨永豐97購03  ,0,0,0,0,0,0,0,0,0,-100000,0,0,0,0,100000,-100000,-100000
052697,滬深2X國票98購01,0,0,0,0,0,0,0,0,0,-100000,0,0,0,0,100000,-100000,-100000
1783,和康生          ,16000,116000,-100000,0,0,0,0,0,0,0,0,0,0,0,0,0,-100000
2436,偉詮電          ,33000,126000,-93000,0,0,0,0,0,0,-7000,0,7000,-7000,0,0,0,-100000
07505P,台勝科元大9A售01,0,0,0,0,0,0,0,0,0,-100000,0,0,0,0,100000,-100000,-100000
060602,京元電凱基9A購01,0,0,0,0,0,0,0,0,0,-100000,0,0,0,0,100000,-100000,-100000
060611,同欣電凱基9A購02,0,0,0,0,0,0,0,0,0,-100000,0,0,0,23000,123000,-100000,-100000
4739,康普            ,31000,125000,-94000,0,0,0,0,0,0,-6000,0,6000,-6000,0,0,0,-100000
057211,鴻海群益98購05  ,0,0,0,0,0,0,0,0,0,-101000,0,0,0,95000,196000,-101000,-101000
054405,樺漢康和96購01  ,0,0,0,0,0,0,0,0,0,-101000,0,0,0,0,101000,-101000,-101000
1612,宏泰            ,11000,110000,-99000,0,0,0,0,0,0,-2000,0,2000,-2000,0,0,0,-101000
060246,晶相光元大9C購03,0,0,0,0,0,0,0,0,0,-102000,0,0,0,55000,157000,-102000,-102000
055505,新唐元大97購02  ,0,0,0,0,0,0,0,0,0,-102000,0,0,0,68000,170000,-102000,-102000
055397,超眾統一97購02  ,0,0,0,0,0,0,0,0,0,-102000,0,0,0,0,102000,-102000,-102000
055101,台肥凱基97購01  ,0,0,0,0,0,0,0,0,0,-102000,0,0,0,0,102000,-102000,-102000
03670C,元油2X元富99牛01,0,0,0,0,0,0,0,0,0,-102000,0,0,0,33000,135000,-102000,-102000
1307,三芳            ,4000,106000,-102000,0,0,0,0,0,0,0,0,0,0,0,0,0,-102000
06059P,泰碩元大97售02  ,0,0,0,0,0,0,0,0,0,-102000,0,0,0,23000,125000,-102000,-102000
060155,友訊永豐9A購01  ,0,0,0,0,0,0,0,0,0,-103000,0,0,0,12000,115000,-103000,-103000
058730,玉晶光永豐9A購01,0,0,0,0,0,0,0,0,0,-103000,0,0,0,0,103000,-103000,-103000
03677C,臺股指元大05牛02,0,0,0,0,0,0,0,0,0,-103000,0,0,0,18000,121000,-103000,-103000
053745,康友國票97購01  ,0,0,0,0,0,0,0,0,0,-103000,0,0,0,25000,128000,-103000,-103000
057609,友訊元富98購01  ,0,0,0,0,0,0,0,0,0,-103000,0,0,0,342000,445000,-103000,-103000
057251,泰鼎統一98購02  ,0,0,0,0,0,0,0,0,0,-104000,0,0,0,70000,174000,-104000,-104000
058405,訊連元大99購02  ,0,0,0,0,0,0,0,0,0,-104000,0,0,0,100000,204000,-104000,-104000
056298,億光元大97購02  ,0,0,0,0,0,0,0,0,0,-104000,0,0,0,0,104000,-104000,-104000
2495,普安            ,0,101000,-101000,0,0,0,0,0,0,-3000,0,3000,-3000,0,0,0,-104000
058892,元油2X元大9C購08,0,0,0,0,0,0,0,0,0,-105000,0,0,0,0,105000,-105000,-105000
05898P,旺宏凱基96售06  ,0,0,0,0,0,0,0,0,0,-105000,0,0,0,0,105000,-105000,-105000
059711,滬深2X元大9C購02,0,0,0,0,0,0,0,0,0,-105000,0,0,0,40000,145000,-105000,-105000
059290,全新元富99購01  ,0,0,0,0,0,0,0,0,0,-105000,0,0,0,7000,112000,-105000,-105000
054109,南亞科凱基96購05,0,0,0,0,0,0,0,0,0,-105000,0,0,0,80000,185000,-105000,-105000
055726,台表科元大98購03,0,0,0,0,0,0,0,0,0,-105000,0,0,0,2000,107000,-105000,-105000
5534,長虹            ,49000,138000,-89000,0,0,0,0,872,-872,-16000,6000,22000,-16000,0,0,0,-105872
3149,正達            ,33000,139000,-106000,0,0,0,0,0,0,0,0,0,0,0,0,0,-106000
1592,英瑞-KY         ,33000,139000,-106000,0,0,0,0,0,0,0,0,0,0,0,0,0,-106000
059807,大立光元富99購09,0,0,0,0,0,0,0,0,0,-107000,0,0,0,126000,233000,-107000,-107000
057589,超眾國票9A購01  ,0,0,0,0,0,0,0,0,0,-107000,0,0,0,60000,167000,-107000,-107000
07471P,南亞科元大9A售01,0,0,0,0,0,0,0,0,0,-107000,0,0,0,0,107000,-107000,-107000
06505P,康控國票99售02  ,0,0,0,0,0,0,0,0,0,-107000,0,0,0,4000,111000,-107000,-107000
056309,合勤控元大97購01,0,0,0,0,0,0,0,0,0,-108000,0,0,0,0,108000,-108000,-108000
056970,TPK永豐98購01   ,0,0,0,0,0,0,0,0,0,-108000,0,0,0,80000,188000,-108000,-108000
060077,台積電台新9B購01,0,0,0,0,0,0,0,0,0,-108000,0,0,0,1000,109000,-108000,-108000
060485,華新科富邦9C購04,0,0,0,0,0,0,0,0,0,-108000,0,0,0,50000,158000,-108000,-108000
058613,茂林元大99購03  ,0,0,0,0,0,0,0,0,0,-108000,0,0,0,111000,219000,-108000,-108000
054923,晶技凱基98購01  ,0,0,0,0,0,0,0,0,0,-108000,0,0,0,15000,123000,-108000,-108000
060624,玉晶光元大9C購02,0,0,0,0,0,0,0,0,0,-108000,0,0,0,0,108000,-108000,-108000
060677,京元電元大9A購04,0,0,0,0,0,0,0,0,0,-108000,0,0,0,0,108000,-108000,-108000
07245P,台積電凱基99售16,0,0,0,0,0,0,0,0,0,-108000,0,0,0,37000,145000,-108000,-108000
4426,利勤            ,38000,150000,-112000,0,0,0,0,0,0,4000,0,0,0,4000,0,4000,-108000
050385,貿聯國票95購02  ,0,0,0,0,0,0,0,0,0,-109000,0,0,0,0,109000,-109000,-109000
056169,鴻海元富97購08  ,0,0,0,0,0,0,0,0,0,-110000,0,0,0,0,110000,-110000,-110000
059623,聯電凱基99購02  ,0,0,0,0,0,0,0,0,0,-110000,0,0,0,13000,123000,-110000,-110000
058348,台表科群益99購01,0,0,0,0,0,0,0,0,0,-110000,0,0,0,176000,286000,-110000,-110000
059563,鴻海凱基9A購14  ,0,0,0,0,0,0,0,0,0,-110000,0,0,0,45000,155000,-110000,-110000
051381,玉晶光群益98購01,0,0,0,0,0,0,0,0,0,-110000,0,0,0,2000,112000,-110000,-110000
06502P,A50中信98售01   ,0,0,0,0,0,0,0,0,0,-110000,0,0,0,0,110000,-110000,-110000
056939,康控元富98購01  ,0,0,0,0,0,0,0,0,0,-111000,0,0,0,46000,157000,-111000,-111000
054211,奇鋐國票97購03  ,0,0,0,0,0,0,0,0,0,-111000,0,0,0,41000,152000,-111000,-111000
06622P,牧德元大98售01  ,0,0,0,0,0,0,0,0,0,-111000,0,0,0,65000,176000,-111000,-111000
2913,農林            ,132000,241000,-109000,0,0,0,0,0,0,-2000,6000,8000,-2000,0,0,0,-111000
057960,聯鈞元大98購02  ,0,0,0,0,0,0,0,0,0,-112000,0,0,0,274000,386000,-112000,-112000
060184,建準元富9A購01  ,0,0,0,0,0,0,0,0,0,-112000,0,0,0,73000,185000,-112000,-112000
057070,美律永豐98購02  ,0,0,0,0,0,0,0,0,0,-113000,0,0,0,0,113000,-113000,-113000
060308,劍麟永豐9A購01  ,0,0,0,0,0,0,0,0,0,-113000,0,0,0,0,113000,-113000,-113000
056715,瀚宇博永豐98購01,0,0,0,0,0,0,0,0,0,-113000,0,0,0,27000,140000,-113000,-113000
057700,新日興群益9A購01,0,0,0,0,0,0,0,0,0,-113000,0,0,0,0,113000,-113000,-113000
053092,台表科元大97購02,0,0,0,0,0,0,0,0,0,-113000,0,0,0,39000,152000,-113000,-113000
050135,禾伸堂兆豐95購01,0,0,0,0,0,0,0,0,0,-113000,0,0,0,107000,220000,-113000,-113000
8429,金麗-KY         ,35000,146000,-111000,0,0,0,0,0,0,-2000,0,2000,-2000,0,0,0,-113000
2034,允強            ,22000,132000,-110000,0,0,0,0,0,0,-3000,0,3000,-3000,0,0,0,-113000
056196,聯茂富邦98購02  ,0,0,0,0,0,0,0,0,0,-114000,0,0,0,500000,614000,-114000,-114000
057045,美律元大99購04  ,0,0,0,0,0,0,0,0,0,-114000,0,0,0,0,114000,-114000,-114000
2030,彰源            ,5000,119000,-114000,0,0,0,0,0,0,0,0,0,0,0,0,0,-114000
07477P,國巨群益9A售04  ,0,0,0,0,0,0,0,0,0,-114000,0,0,0,7000,121000,-114000,-114000
2881A,富邦特          ,18000,0,18000,0,0,0,0,0,0,-132000,0,132000,-132000,0,0,0,-114000
2388,威盛            ,63000,177380,-114380,0,0,0,0,0,0,0,0,0,0,0,0,0,-114380
060427,聯茂永豐9A購01  ,0,0,0,0,0,0,0,0,0,-115000,0,0,0,80000,195000,-115000,-115000
058095,昇陽半元大98購03,0,0,0,0,0,0,0,0,0,-115000,0,0,0,26000,141000,-115000,-115000
057403,亞光群益98購04  ,0,0,0,0,0,0,0,0,0,-115000,0,0,0,13000,128000,-115000,-115000
054065,樺漢國票97購01  ,0,0,0,0,0,0,0,0,0,-115000,0,0,0,0,115000,-115000,-115000
057265,聯詠兆豐98購01  ,0,0,0,0,0,0,0,0,0,-117000,0,0,0,0,117000,-117000,-117000
07420P,可成元大99售07  ,0,0,0,0,0,0,0,0,0,-117000,0,0,0,12000,129000,-117000,-117000
060687,GIS元大9A購01   ,0,0,0,0,0,0,0,0,0,-117000,0,0,0,0,117000,-117000,-117000
07135P,臺股指元大9A售29,0,0,0,0,0,0,0,0,0,-117000,0,0,0,3000,120000,-117000,-117000
060327,美律群益9A購02  ,0,0,0,0,0,0,0,0,0,-118000,0,0,0,0,118000,-118000,-118000
059976,道瓊銀元大99購01,0,0,0,0,0,0,0,0,0,-118000,0,0,0,0,118000,-118000,-118000
048748,國巨元富96購01  ,0,0,0,0,0,0,0,0,0,-118000,0,0,0,6000,124000,-118000,-118000
06765P,欣興元大98售11  ,0,0,0,0,0,0,0,0,0,-118000,0,0,0,32000,150000,-118000,-118000
06593P,欣興元大98售05  ,0,0,0,0,0,0,0,0,0,-118000,0,0,0,84000,202000,-118000,-118000
2415,錩新            ,1000,113000,-112000,0,0,0,0,0,0,-6000,0,6000,-6000,0,0,0,-118000
2314,台揚            ,90000,201000,-111000,0,0,0,0,0,0,-7000,0,1000,-1000,1000,7000,-6000,-118000
8028,昇陽半導體      ,349000,486000,-137000,0,0,0,0,0,0,19000,0,5000,-5000,24000,0,24000,-118000
3019,亞光            ,563000,712740,-149740,0,0,0,0,1428,-1428,33000,94000,105000,-11000,68000,24000,44000,-118168
060194,旭富元富9A購01  ,0,0,0,0,0,0,0,0,0,-119000,0,0,0,16000,135000,-119000,-119000
057071,華擎永豐98購02  ,0,0,0,0,0,0,0,0,0,-119000,0,0,0,184000,303000,-119000,-119000
059743,開發金元富99購01,0,0,0,0,0,0,0,0,0,-119000,0,0,0,59000,178000,-119000,-119000
058956,健策國票9A購02  ,0,0,0,0,0,0,0,0,0,-119000,0,0,0,67000,186000,-119000,-119000
058051,同欣電元大98購03,0,0,0,0,0,0,0,0,0,-120000,0,0,0,0,120000,-120000,-120000
03428B,臺股指凱基97熊18,0,0,0,0,0,0,0,0,0,-120000,0,0,0,0,120000,-120000,-120000
050483,樺漢國票94購01  ,0,0,0,0,0,0,0,0,0,-120000,0,0,0,0,120000,-120000,-120000
052691,GIS元大96購01   ,0,0,0,0,0,0,0,0,0,-120000,0,0,0,0,120000,-120000,-120000
07375P,台積電元大99售48,0,0,0,0,0,0,0,0,0,-120000,0,0,0,10000,130000,-120000,-120000
056256,聯茂元富97購03  ,0,0,0,0,0,0,0,0,0,-121000,0,0,0,12000,133000,-121000,-121000
052234,GIS凱基97購01   ,0,0,0,0,0,0,0,0,0,-121000,0,0,0,58000,179000,-121000,-121000
03826P,瀚宇博元大95售01,0,0,0,0,0,0,0,0,0,-121000,0,0,0,180000,301000,-121000,-121000
059785,美律元大9A購03  ,0,0,0,0,0,0,0,0,0,-122000,0,0,0,30000,152000,-122000,-122000
059885,台積電國票99購12,0,0,0,0,0,0,0,0,0,-122000,0,0,0,91000,213000,-122000,-122000
054163,燿華凱基97購02  ,0,0,0,0,0,0,0,0,0,-122000,0,0,0,0,122000,-122000,-122000
06338P,亞德客統一97售02,0,0,0,0,0,0,0,0,0,-122000,0,0,0,19000,141000,-122000,-122000
060412,儒鴻永豐9A購01  ,0,0,0,0,0,0,0,0,0,-122000,0,0,0,68000,190000,-122000,-122000
3033,威健            ,10000,128000,-118000,0,0,0,0,0,0,-4000,0,4000,-4000,0,0,0,-122000
5469,瀚宇博          ,991000,1249510,-258510,0,0,0,100000,2764,97236,39000,0,0,0,134000,95000,39000,-122274
058043,鴻海元大98購13  ,0,0,0,0,0,0,0,0,0,-123000,0,0,0,0,123000,-123000,-123000
060380,T50反1凱基9A購08,0,0,0,0,0,0,0,0,0,-123000,0,0,0,32000,155000,-123000,-123000
059614,致新永豐99購01  ,0,0,0,0,0,0,0,0,0,-123000,0,0,0,68000,191000,-123000,-123000
059102,聯鈞元富99購01  ,0,0,0,0,0,0,0,0,0,-123000,0,0,0,20000,143000,-123000,-123000
054411,光磊元大97購02  ,0,0,0,0,0,0,0,0,0,-123000,0,0,0,21000,144000,-123000,-123000
00655L,國泰中國A50正2  ,224000,0,224000,0,0,0,0,0,0,-347000,0,0,0,1145000,1492000,-347000,-123000
060197,臻鼎元富9A購02  ,0,0,0,0,0,0,0,0,0,-124000,0,0,0,72000,196000,-124000,-124000
060231,台積電元大9A購08,0,0,0,0,0,0,0,0,0,-124000,0,0,0,8000,132000,-124000,-124000
054943,群光元大97購01  ,0,0,0,0,0,0,0,0,0,-124000,0,0,0,10000,134000,-124000,-124000
055620,樺漢國票98購01  ,0,0,0,0,0,0,0,0,0,-124000,0,0,0,0,124000,-124000,-124000
060085,華通元大99購10  ,0,0,0,0,0,0,0,0,0,-125000,0,0,0,109000,234000,-125000,-125000
058025,聯茂國泰99購01  ,0,0,0,0,0,0,0,0,0,-125000,0,0,0,223000,348000,-125000,-125000
058497,新日興群益9B購01,0,0,0,0,0,0,0,0,0,-125000,0,0,0,0,125000,-125000,-125000
057717,友訊元富98購02  ,0,0,0,0,0,0,0,0,0,-125000,0,0,0,40000,165000,-125000,-125000
054278,晶技群益97購02  ,0,0,0,0,0,0,0,0,0,-125000,0,0,0,0,125000,-125000,-125000
053638,信邦永豐96購01  ,0,0,0,0,0,0,0,0,0,-125000,0,0,0,0,125000,-125000,-125000
059852,康控永豐99購02  ,0,0,0,0,0,0,0,0,0,-126000,0,0,0,77000,203000,-126000,-126000
9935,慶豐富          ,125000,251000,-126000,0,0,0,0,0,0,0,0,0,0,0,0,0,-126000
2102,泰豐            ,801000,919000,-118000,0,0,0,0,0,0,-8000,0,8000,-8000,0,0,0,-126000
057827,康友元大98購03  ,0,0,0,0,0,0,0,0,0,-127000,0,0,0,0,127000,-127000,-127000
058820,致茂國泰9B購01  ,0,0,0,0,0,0,0,0,0,-127000,0,0,0,2000,129000,-127000,-127000
6669,緯穎            ,138000,251720,-113720,0,0,0,32000,31486,514,-14000,5000,28000,-23000,11000,2000,9000,-127206
058750,緯穎凱基9A購03  ,0,0,0,0,0,0,0,0,0,-128000,0,0,0,58000,186000,-128000,-128000
056810,群創統一9A購01  ,0,0,0,0,0,0,0,0,0,-128000,0,0,0,0,128000,-128000,-128000
056266,開發金統一9A購01,0,0,0,0,0,0,0,0,0,-128000,0,0,0,476000,604000,-128000,-128000
05024P,華通國票96售01  ,0,0,0,0,0,0,0,0,0,-128000,0,0,0,10000,138000,-128000,-128000
055537,康友群益97購03  ,0,0,0,0,0,0,0,0,0,-128000,0,0,0,0,128000,-128000,-128000
053375,鴻海元大96購18  ,0,0,0,0,0,0,0,0,0,-128000,0,0,0,0,128000,-128000,-128000
2402,毅嘉            ,67000,192000,-125000,0,0,0,0,0,0,-3000,0,3000,-3000,0,0,0,-128000
2027,大成鋼          ,412000,501250,-89250,0,0,0,0,8877,-8877,-30000,0,43000,-43000,38000,25000,13000,-128127
2206,三陽工業        ,53000,175670,-122670,0,0,0,0,0,0,-7000,0,7000,-7000,0,0,0,-129670
059680,台積電國泰9A購03,0,0,0,0,0,0,0,0,0,-130000,0,0,0,458000,588000,-130000,-130000
058992,上証反元大99購02,0,0,0,0,0,0,0,0,0,-130000,0,0,0,0,130000,-130000,-130000
060644,泰鼎永豐9A購02  ,0,0,0,0,0,0,0,0,0,-130000,0,0,0,4000,134000,-130000,-130000
057695,S&P反1群益9B購01,0,0,0,0,0,0,0,0,0,-130000,0,0,0,0,130000,-130000,-130000
055937,康舒群益97購01  ,0,0,0,0,0,0,0,0,0,-130000,0,0,0,0,130000,-130000,-130000
1532,勤美            ,12000,137000,-125000,0,0,0,0,0,0,-5000,0,5000,-5000,0,0,0,-130000
07484P,台灣50凱基04售02,0,0,0,0,0,0,0,0,0,-130000,0,0,0,0,130000,-130000,-130000
057670,欣興元大99購02  ,0,0,0,0,0,0,0,0,0,-131000,0,0,0,0,131000,-131000,-131000
056574,亞光元大99購03  ,0,0,0,0,0,0,0,0,0,-131000,0,0,0,0,131000,-131000,-131000
058707,泰鼎元大99購02  ,0,0,0,0,0,0,0,0,0,-132000,0,0,0,191000,323000,-132000,-132000
060646,南電永豐9A購01  ,0,0,0,0,0,0,0,0,0,-132000,0,0,0,9000,141000,-132000,-132000
060532,欣興中信9A購01  ,0,0,0,0,0,0,0,0,0,-132000,0,0,0,28000,160000,-132000,-132000
6189,豐藝            ,8000,139000,-131000,0,0,0,0,0,0,-1000,0,1000,-1000,0,0,0,-132000
059996,美律元富99購01  ,0,0,0,0,0,0,0,0,0,-133000,0,0,0,39000,172000,-133000,-133000
056987,南茂群益98購01  ,0,0,0,0,0,0,0,0,0,-133000,0,0,0,0,133000,-133000,-133000
055512,聯詠兆豐97購01  ,0,0,0,0,0,0,0,0,0,-133000,0,0,0,241000,374000,-133000,-133000
1217,愛之味          ,138000,271000,-133000,0,0,0,0,0,0,0,0,0,0,0,0,0,-133000
055747,康舒元富97購01  ,0,0,0,0,0,0,0,0,0,-134000,0,0,0,50000,184000,-134000,-134000
4919,新唐            ,166000,265000,-99000,0,0,0,0,0,0,-35000,0,30000,-30000,0,5000,-5000,-134000
4306,炎洲            ,108000,238000,-130000,0,0,0,0,0,0,-4000,0,4000,-4000,0,0,0,-134000
058826,台積電永豐99購02,0,0,0,0,0,0,0,0,0,-135000,0,0,0,1000,136000,-135000,-135000
054912,群光凱基97購01  ,0,0,0,0,0,0,0,0,0,-135000,0,0,0,0,135000,-135000,-135000
2607,榮運            ,50000,185000,-135000,0,0,0,0,0,0,0,0,0,0,0,0,0,-135000
059118,晶技永豐9A購01  ,0,0,0,0,0,0,0,0,0,-136000,0,0,0,72000,208000,-136000,-136000
059299,欣興元富99購03  ,0,0,0,0,0,0,0,0,0,-136000,0,0,0,23000,159000,-136000,-136000
057268,臻鼎兆豐99購01  ,0,0,0,0,0,0,0,0,0,-136000,0,0,0,0,136000,-136000,-136000
058901,美律元大99購07  ,0,0,0,0,0,0,0,0,0,-136000,0,0,0,153000,289000,-136000,-136000
1316,上曜            ,41000,175000,-134000,0,0,0,0,0,0,-2000,0,2000,-2000,0,0,0,-136000
058041,FBVIX元大98購02 ,0,0,0,0,0,0,0,0,0,-137000,0,0,0,0,137000,-137000,-137000
051220,大立光元富95購08,0,0,0,0,0,0,0,0,0,-137000,0,0,0,0,137000,-137000,-137000
060621,玉晶光元大9A購05,0,0,0,0,0,0,0,0,0,-137000,0,0,0,10000,147000,-137000,-137000
060645,台表科永豐9A購02,0,0,0,0,0,0,0,0,0,-137000,0,0,0,41000,178000,-137000,-137000
3532,台勝科          ,54000,194000,-140000,0,0,0,0,2555,-2555,5000,0,5000,-5000,12000,2000,10000,-137555
058932,FBVIX台新99購01 ,0,0,0,0,0,0,0,0,0,-138000,0,0,0,13000,151000,-138000,-138000
056629,昇陽半永豐98購01,0,0,0,0,0,0,0,0,0,-138000,0,0,0,0,138000,-138000,-138000
058290,南電國票9A購01  ,0,0,0,0,0,0,0,0,0,-138000,0,0,0,65000,203000,-138000,-138000
059945,嘉澤永豐99購03  ,0,0,0,0,0,0,0,0,0,-139000,0,0,0,78000,217000,-139000,-139000
042929,台積電中信95購02,0,0,0,0,0,0,0,0,0,-139000,0,0,0,8000,147000,-139000,-139000
4960,誠美材          ,0,139000,-139000,0,0,0,0,0,0,0,0,0,0,0,0,0,-139000
07148P,富邦金元大99售01,0,0,0,0,0,0,0,0,0,-139000,0,0,0,23000,162000,-139000,-139000
2329,華泰            ,177000,291000,-114000,0,0,0,0,0,0,-25000,5000,28000,-23000,0,2000,-2000,-139000
058487,晶技國票9A購01  ,0,0,0,0,0,0,0,0,0,-140000,0,0,0,0,140000,-140000,-140000
048754,瀚宇博元富97購01,0,0,0,0,0,0,0,0,0,-140000,0,0,0,70000,210000,-140000,-140000
05124P,華新科富邦97售02,0,0,0,0,0,0,0,0,0,-140000,0,0,0,0,140000,-140000,-140000
053057,聯電國泰97購02  ,0,0,0,0,0,0,0,0,0,-140000,0,0,0,340000,480000,-140000,-140000
055940,致新群益98購01  ,0,0,0,0,0,0,0,0,0,-140000,0,0,0,10000,150000,-140000,-140000
2331,精英            ,18000,145000,-127000,0,0,0,0,0,0,-13000,10000,23000,-13000,0,0,0,-140000
1902,台紙            ,55000,192000,-137000,0,0,0,0,0,0,-3000,0,3000,-3000,0,0,0,-140000
3048,益登            ,45000,185000,-140000,0,0,0,0,0,0,0,0,0,0,0,0,0,-140000
060347,大立光統一02購01,0,0,0,0,0,0,0,0,0,-141000,0,0,0,5000,146000,-141000,-141000
053103,瀚宇博元富96購01,0,0,0,0,0,0,0,0,0,-141000,0,0,0,249000,390000,-141000,-141000
9941,裕融            ,39000,160690,-121690,0,0,0,0,1415,-1415,-18000,0,18000,-18000,0,0,0,-141105
057712,南亞科統一9A購01,0,0,0,0,0,0,0,0,0,-142000,0,0,0,6000,148000,-142000,-142000
058143,瑞儀元大99購02  ,0,0,0,0,0,0,0,0,0,-142000,0,0,0,78000,220000,-142000,-142000
052647,晶技永豐97購01  ,0,0,0,0,0,0,0,0,0,-142000,0,0,0,49000,191000,-142000,-142000
056583,昇陽半元大98購02,0,0,0,0,0,0,0,0,0,-143000,0,0,0,0,143000,-143000,-143000
060112,祥碩元大99購04  ,0,0,0,0,0,0,0,0,0,-143000,0,0,0,32000,175000,-143000,-143000
057568,友訊永豐99購01  ,0,0,0,0,0,0,0,0,0,-143000,0,0,0,0,143000,-143000,-143000
060599,國巨凱基9C購01  ,0,0,0,0,0,0,0,0,0,-143000,0,0,0,655000,798000,-143000,-143000
059730,晶相光元大9C購02,0,0,0,0,0,0,0,0,0,-144000,0,0,0,48000,192000,-144000,-144000
059302,大立光群益99購08,0,0,0,0,0,0,0,0,0,-144000,0,0,0,10000,154000,-144000,-144000
05922P,京元電兆豐96售01,0,0,0,0,0,0,0,0,0,-144000,0,0,0,3000,147000,-144000,-144000
07382P,台積電群益9B售01,0,0,0,0,0,0,0,0,0,-144000,0,0,0,12000,156000,-144000,-144000
4551,智伸科          ,73000,245000,-172000,0,0,0,22000,0,22000,6000,4000,1000,3000,5000,2000,3000,-144000
059679,國巨國泰9B購03  ,0,0,0,0,0,0,0,0,0,-145000,0,0,0,5000,150000,-145000,-145000
055121,鴻海兆豐97購03  ,0,0,0,0,0,0,0,0,0,-145000,0,0,0,0,145000,-145000,-145000
8039,台虹            ,168000,269000,-101000,0,0,0,0,0,0,-44000,8000,39000,-31000,11000,24000,-13000,-145000
060557,南電凱基9A購02  ,0,0,0,0,0,0,0,0,0,-145000,0,0,0,87000,232000,-145000,-145000
056926,日月光兆豐98購01,0,0,0,0,0,0,0,0,0,-146000,0,0,0,80000,226000,-146000,-146000
054799,超眾群益98購01  ,0,0,0,0,0,0,0,0,0,-146000,0,0,0,240000,386000,-146000,-146000
047886,京元電富邦95購01,0,0,0,0,0,0,0,0,0,-146000,0,0,0,59000,205000,-146000,-146000
060239,國揚元大9C購01  ,0,0,0,0,0,0,0,0,0,-147000,0,0,0,13000,160000,-147000,-147000
055806,致新永豐97購02  ,0,0,0,0,0,0,0,0,0,-147000,0,0,0,69000,216000,-147000,-147000
058610,欣興元大99購05  ,0,0,0,0,0,0,0,0,0,-147000,0,0,0,50000,197000,-147000,-147000
060572,景碩永豐9A購01  ,0,0,0,0,0,0,0,0,0,-147000,0,0,0,0,147000,-147000,-147000
059879,GIS凱基99購03   ,0,0,0,0,0,0,0,0,0,-148000,0,0,0,32000,180000,-148000,-148000
6139,亞翔            ,81000,218000,-137000,0,0,0,0,0,0,-11000,0,11000,-11000,0,0,0,-148000
058904,晶技元大99購05  ,0,0,0,0,0,0,0,0,0,-149000,0,0,0,100000,249000,-149000,-149000
057299,立積永豐98購02  ,0,0,0,0,0,0,0,0,0,-149000,0,0,0,17000,166000,-149000,-149000
054448,矽力兆豐96購01  ,0,0,0,0,0,0,0,0,0,-149000,0,0,0,0,149000,-149000,-149000
4141,龍燈-KY         ,36000,195000,-159000,0,0,0,0,0,0,10000,10000,0,10000,0,0,0,-149000
07283P,華新科凱基99售07,0,0,0,0,0,0,0,0,0,-149000,0,0,0,1000,150000,-149000,-149000
057647,欣興元大98購10  ,0,0,0,0,0,0,0,0,0,-150000,0,0,0,18000,168000,-150000,-150000
056207,茂林永豐97購03  ,0,0,0,0,0,0,0,0,0,-150000,0,0,0,0,150000,-150000,-150000
060070,國巨元富99購02  ,0,0,0,0,0,0,0,0,0,-150000,0,0,0,70000,220000,-150000,-150000
053368,京元電富邦98購01,0,0,0,0,0,0,0,0,0,-150000,0,0,0,0,150000,-150000,-150000
05760P,京鼎永豐96售02  ,0,0,0,0,0,0,0,0,0,-150000,0,0,0,0,150000,-150000,-150000
055896,南電統一97購02  ,6000,0,6000,0,0,0,0,0,0,-156000,0,0,0,15000,171000,-156000,-150000
052657,友達元富96購01  ,0,0,0,0,0,0,0,0,0,-150000,0,0,0,0,150000,-150000,-150000
051193,新日興兆豐96購01,0,0,0,0,0,0,0,0,0,-150000,0,0,0,0,150000,-150000,-150000
060666,聯茂凱基9A購02  ,0,0,0,0,0,0,0,0,0,-150000,0,0,0,0,150000,-150000,-150000
057619,玉晶光凱基98購02,0,0,0,0,0,0,0,0,0,-151000,0,0,0,26000,177000,-151000,-151000
052893,聯電群益98購01  ,0,0,0,0,0,0,0,0,0,-151000,0,0,0,11000,162000,-151000,-151000
06730P,祥碩元大98售07  ,0,0,0,0,0,0,0,0,0,-151000,0,0,0,68000,219000,-151000,-151000
8464,億豐            ,54000,144440,-90440,0,0,0,0,60787,-60787,0,0,0,0,0,0,0,-151227
1457,宜進            ,0,140450,-140450,0,0,0,0,0,0,-11000,0,11000,-11000,0,0,0,-151450
2352,佳世達          ,1033001,1020276,12725,0,0,0,0,4524,-4524,-160000,34000,194000,-160000,0,0,0,-151799
058170,國巨凱基9A購06  ,0,0,0,0,0,0,0,0,0,-152000,0,0,0,41000,193000,-152000,-152000
9802,鈺齊-KY         ,143000,297285,-154285,0,0,0,0,2189,-2189,4000,0,9000,-9000,17000,4000,13000,-152474
060575,大立光中信9B購02,0,0,0,0,0,0,0,0,0,-153000,0,0,0,20000,173000,-153000,-153000
057787,TPK國票99購01   ,0,0,0,0,0,0,0,0,0,-154000,0,0,0,0,154000,-154000,-154000
060493,美律元富01購01  ,0,0,0,0,0,0,0,0,0,-154000,0,0,0,82000,236000,-154000,-154000
057938,台表科群益98購02,0,0,0,0,0,0,0,0,0,-154000,0,0,0,7000,161000,-154000,-154000
04908P,南電國票95售03  ,0,0,0,0,0,0,0,0,0,-154000,0,0,0,0,154000,-154000,-154000
2838,聯邦銀          ,217000,272000,-55000,0,0,0,0,21814,-21814,-78000,0,78000,-78000,0,0,0,-154814
060457,中橡元大9A購02  ,0,0,0,0,0,0,0,0,0,-155000,0,0,0,15000,170000,-155000,-155000
057357,超眾統一98購01  ,0,0,0,0,0,0,0,0,0,-155000,0,0,0,441000,596000,-155000,-155000
054334,超眾永豐96購04  ,0,0,0,0,0,0,0,0,0,-155000,0,0,0,22000,177000,-155000,-155000
055972,GIS元大97購04   ,0,0,0,0,0,0,0,0,0,-155000,0,0,0,0,155000,-155000,-155000
060528,友達中信9C購01  ,0,0,0,0,0,0,0,0,0,-155000,0,0,0,143000,298000,-155000,-155000
07527P,台灣50凱基9B售02,0,0,0,0,0,0,0,0,0,-155000,0,0,0,111000,266000,-155000,-155000
3010,華立            ,37000,191790,-154790,0,0,0,0,0,0,-1000,0,1000,-1000,0,0,0,-155790
1416,廣豐            ,1000,156000,-155000,0,0,0,0,0,0,-1000,0,1000,-1000,0,0,0,-156000
058091,欣興元大99購03  ,0,0,0,0,0,0,0,0,0,-157000,0,0,0,0,157000,-157000,-157000
059613,泰鼎永豐99購02  ,0,0,0,0,0,0,0,0,0,-157000,0,0,0,17000,174000,-157000,-157000
057975,台積電永豐98購05,0,0,0,0,0,0,0,0,0,-157000,0,0,0,2000,159000,-157000,-157000
2516,新建            ,10000,165000,-155000,0,0,0,0,0,0,-2000,0,2000,-2000,0,0,0,-157000
2106,建大            ,42000,165000,-123000,0,0,0,0,7566,-7566,-27000,0,27000,-27000,0,0,0,-157566
058284,滬深反群益01購01,0,0,0,0,0,0,0,0,0,-158000,0,0,0,0,158000,-158000,-158000
052020,聯茂永豐95購02  ,0,0,0,0,0,0,0,0,0,-158000,0,0,0,0,158000,-158000,-158000
1802,台玻            ,442000,499188,-57188,0,0,0,0,11249,-11249,-90000,0,90000,-90000,0,0,0,-158437
056615,燿華永豐98購02  ,0,0,0,0,0,0,0,0,0,-159000,0,0,0,7000,166000,-159000,-159000
059166,友達凱基99購05  ,0,0,0,0,0,0,0,0,0,-160000,0,0,0,0,160000,-160000,-160000
051647,華新科永豐95購02,0,0,0,0,0,0,0,0,0,-160000,0,0,0,0,160000,-160000,-160000
055138,大毅永豐97購02  ,0,0,0,0,0,0,0,0,0,-160000,0,0,0,0,160000,-160000,-160000
07162P,臺股指群益99售13,0,0,0,0,0,0,0,0,0,-162000,0,0,0,282000,444000,-162000,-162000
3661,世芯-KY         ,479000,673000,-194000,0,0,0,36000,0,36000,-4000,25000,30000,-5000,12000,11000,1000,-162000
1319,東陽            ,144000,259650,-115650,0,0,0,0,3863,-3863,-44000,0,44000,-44000,0,0,0,-163513
058748,景碩凱基9A購01  ,0,0,0,0,0,0,0,0,0,-164000,0,0,0,1000,165000,-164000,-164000
049706,世紀鋼元大95購02,0,0,0,0,0,0,0,0,0,-164000,0,0,0,100000,264000,-164000,-164000
055796,南電國泰98購01  ,0,0,0,0,0,0,0,0,0,-164000,0,0,0,561000,725000,-164000,-164000
056452,亞光凱基98購02  ,0,0,0,0,0,0,0,0,0,-165000,0,0,0,10000,175000,-165000,-165000
07259P,滬深2X國票01售01,0,0,0,0,0,0,0,0,0,-165000,0,0,0,20000,185000,-165000,-165000
059326,康友元大99購01  ,0,0,0,0,0,0,0,0,0,-166000,0,0,0,189000,355000,-166000,-166000
059457,立積永豐99購02  ,0,0,0,0,0,0,0,0,0,-166000,0,0,0,162000,328000,-166000,-166000
048273,南電富邦97購01  ,0,0,0,0,0,0,0,0,0,-166000,0,0,0,30000,196000,-166000,-166000
1590,亞德客-KY       ,573565,679600,-106035,0,0,0,42000,58498,-16498,-44000,4000,25000,-21000,4000,27000,-23000,-166533
057181,亞光元大98購02  ,0,0,0,0,0,0,0,0,0,-167000,0,0,0,33000,200000,-167000,-167000
056418,台光電元富98購01,0,0,0,0,0,0,0,0,0,-167000,0,0,0,119000,286000,-167000,-167000
056803,群創台新99購02  ,0,0,0,0,0,0,0,0,0,-168000,0,0,0,5000,173000,-168000,-168000
00690,兆豐藍籌30      ,0,0,0,0,0,0,0,0,0,-168000,0,0,0,151000,319000,-168000,-168000
052084,台泥元大95購01  ,0,0,0,0,0,0,0,0,0,-168000,0,0,0,0,168000,-168000,-168000
058926,勤誠元富99購01  ,0,0,0,0,0,0,0,0,0,-169000,0,0,0,0,169000,-169000,-169000
059031,元石油中信03購01,0,0,0,0,0,0,0,0,0,-169000,0,0,0,0,169000,-169000,-169000
058369,亞光凱基99購02  ,0,0,0,0,0,0,0,0,0,-169000,0,0,0,29000,198000,-169000,-169000
6282,康舒            ,1590000,1697000,-107000,0,0,0,0,0,0,-62000,0,35000,-35000,15000,42000,-27000,-169000
058214,世芯群益9A購01  ,0,0,0,0,0,0,0,0,0,-170000,0,0,0,23000,193000,-170000,-170000
059468,智邦元大99購02  ,0,0,0,0,0,0,0,0,0,-170000,0,0,0,83000,253000,-170000,-170000
1440,南紡            ,204000,360000,-156000,0,0,0,0,0,0,-14000,0,14000,-14000,0,0,0,-170000
07106P,國巨統一9B售05  ,0,0,0,0,0,0,0,0,0,-170000,0,0,0,92000,262000,-170000,-170000
060696,道瓊反國泰9C購01,0,0,0,0,0,0,0,0,0,-170000,0,0,0,0,170000,-170000,-170000
05440P,緯穎國票96售02  ,0,0,0,0,0,0,0,0,0,-171000,0,0,0,99000,270000,-171000,-171000
058522,聯茂元大99購07  ,0,0,0,0,0,0,0,0,0,-173000,0,0,0,57000,230000,-173000,-173000
057603,樺漢群益98購02  ,0,0,0,0,0,0,0,0,0,-173000,0,0,0,0,173000,-173000,-173000
07462P,臺股指元大9B售05,0,0,0,0,0,0,0,0,0,-173000,0,0,0,56000,229000,-173000,-173000
059913,台積電元大99購44,0,0,0,0,0,0,0,0,0,-174000,0,0,0,1000,175000,-174000,-174000
060230,台積電元大9A購07,0,0,0,0,0,0,0,0,0,-174000,0,0,0,3000,177000,-174000,-174000
059825,嘉晶凱基99購02  ,0,0,0,0,0,0,0,0,0,-174000,0,0,0,246000,420000,-174000,-174000
2442,新美齊          ,34000,199000,-165000,0,0,0,0,0,0,-9000,0,9000,-9000,0,0,0,-174000
059878,聯茂凱基99購07  ,0,0,0,0,0,0,0,0,0,-175000,0,0,0,12000,187000,-175000,-175000
056620,華新科永豐98購02,0,0,0,0,0,0,0,0,0,-175000,0,0,0,0,175000,-175000,-175000
00675L,富邦臺灣加權正2 ,0,0,0,0,0,0,0,0,0,-175000,0,0,0,175000,350000,-175000,-175000
058216,TPK群益99購01   ,0,0,0,0,0,0,0,0,0,-176000,0,0,0,92000,268000,-176000,-176000
04831P,聯詠富邦96售01  ,0,0,0,0,0,0,0,0,0,-176000,0,0,0,19000,195000,-176000,-176000
07315P,台積電台新99售06,0,0,0,0,0,0,0,0,0,-176000,0,0,0,0,176000,-176000,-176000
6005,群益證          ,1083000,1245820,-162820,0,0,0,0,13226,-13226,0,0,0,0,0,0,0,-176046
056568,台表科群益98購01,0,0,0,0,0,0,0,0,0,-177000,0,0,0,2000,179000,-177000,-177000
058931,玉晶光統一9C購01,0,0,0,0,0,0,0,0,0,-177000,0,0,0,237000,414000,-177000,-177000
06023P,超眾國票96售03  ,0,0,0,0,0,0,0,0,0,-177000,0,0,0,208000,385000,-177000,-177000
060400,南電國票9A購03  ,0,0,0,0,0,0,0,0,0,-177000,0,0,0,111000,288000,-177000,-177000
060199,台郡元富9A購01  ,0,0,0,0,0,0,0,0,0,-178000,0,0,0,8000,186000,-178000,-178000
059865,國巨凱基01購01  ,0,0,0,0,0,0,0,0,0,-178000,0,0,0,552000,730000,-178000,-178000
058790,楠梓電元大99購03,0,0,0,0,0,0,0,0,0,-178000,0,0,0,0,178000,-178000,-178000
057740,茂林富邦9A購01  ,0,0,0,0,0,0,0,0,0,-178000,0,0,0,619000,797000,-178000,-178000
059173,矽力凱基99購01  ,0,0,0,0,0,0,0,0,0,-179000,0,0,0,59000,238000,-179000,-179000
059829,超眾凱基99購05  ,0,0,0,0,0,0,0,0,0,-179000,0,0,0,177000,356000,-179000,-179000
058970,鴻海永豐99購02  ,0,0,0,0,0,0,0,0,0,-179000,0,0,0,400000,579000,-179000,-179000
05506P,茂林凱基96售03  ,0,0,0,0,0,0,0,0,0,-179000,0,0,0,52000,231000,-179000,-179000
060310,瑞昱永豐9A購01  ,0,0,0,0,0,0,0,0,0,-180000,0,0,0,24000,204000,-180000,-180000
059723,美律元大9A購02  ,0,0,0,0,0,0,0,0,0,-180000,0,0,0,12000,192000,-180000,-180000
055921,新唐凱基98購01  ,0,0,0,0,0,0,0,0,0,-180000,0,0,0,0,180000,-180000,-180000
054617,超眾永豐97購01  ,0,0,0,0,0,0,0,0,0,-180000,0,0,0,10000,190000,-180000,-180000
052426,國巨台新96購01  ,0,0,0,0,0,0,0,0,0,-180000,0,0,0,624000,804000,-180000,-180000
6024,群益期          ,8000,168000,-160000,0,0,0,0,0,0,-20000,0,20000,-20000,0,0,0,-180000
058406,聯茂元大99購06  ,0,0,0,0,0,0,0,0,0,-181000,0,0,0,10000,191000,-181000,-181000
00654R,富邦印度反1     ,0,0,0,0,0,0,0,0,0,-181000,0,0,0,26000,207000,-181000,-181000
057731,華擎國泰9A購02  ,0,0,0,0,0,0,0,0,0,-182000,0,0,0,178000,360000,-182000,-182000
055658,南電元富97購01  ,0,0,0,0,0,0,0,0,0,-182000,0,0,0,97000,279000,-182000,-182000
4956,光鋐            ,21000,203000,-182000,0,0,0,0,0,0,0,0,0,0,0,0,0,-182000
9934,成霖            ,18000,198000,-180000,0,0,0,0,0,0,-2000,1000,3000,-2000,0,0,0,-182000
2605,新興            ,114000,286000,-172000,0,0,0,0,0,0,-10000,14000,24000,-10000,0,0,0,-182000
059991,超眾元大9A購02  ,0,0,0,0,0,0,0,0,0,-183000,0,0,0,394000,577000,-183000,-183000
3702A,大聯大甲特      ,0,41000,-41000,0,0,0,0,9000,-9000,-134000,0,134000,-134000,0,0,0,-184000
1709,和益            ,22000,207000,-185000,0,0,0,0,0,0,0,0,0,0,0,0,0,-185000
052254,康友永豐95購03  ,0,0,0,0,0,0,0,0,0,-186000,0,0,0,0,186000,-186000,-186000
058723,元石油國泰9A購01,0,0,0,0,0,0,0,0,0,-187000,0,0,0,0,187000,-187000,-187000
057826,祥碩元大98購08  ,0,0,0,0,0,0,0,0,0,-187000,0,0,0,39000,226000,-187000,-187000
059760,楠梓電永豐99購01,0,0,0,0,0,0,0,0,0,-187000,0,0,0,2000,189000,-187000,-187000
055746,同欣電元富97購01,0,0,0,0,0,0,0,0,0,-187000,0,0,0,193000,380000,-187000,-187000
2451,創見            ,69000,232360,-163360,0,0,0,0,2820,-2820,-23000,0,34000,-34000,11000,0,11000,-189180
058467,日月光中信9A購01,0,0,0,0,0,0,0,0,0,-190000,0,0,0,437000,627000,-190000,-190000
06839P,玉晶光統一9A售05,0,0,0,0,0,0,0,0,0,-190000,0,0,0,0,190000,-190000,-190000
060057,欣興凱基9B購01  ,0,0,0,0,0,0,0,0,0,-191000,0,0,0,60000,251000,-191000,-191000
056177,嘉澤元富97購01  ,0,0,0,0,0,0,0,0,0,-192000,0,0,0,10000,202000,-192000,-192000
8163,達方            ,156000,340000,-184000,0,0,0,0,0,0,-8000,6000,8000,-2000,0,6000,-6000,-192000
2354,鴻準            ,302000,422920,-120920,0,0,0,0,4911,-4911,-67000,2000,67000,-65000,0,2000,-2000,-192831
054298,台表科元大97購03,0,0,0,0,0,0,0,0,0,-194000,0,0,0,30000,224000,-194000,-194000
057966,金融類元大98購01,0,0,0,0,0,0,0,0,0,-195000,0,0,0,25000,220000,-195000,-195000
059746,聯鈞元富99購03  ,0,0,0,0,0,0,0,0,0,-195000,0,0,0,60000,255000,-195000,-195000
054307,高鐵凱基98購01  ,0,0,0,0,0,0,0,0,0,-195000,0,0,0,0,195000,-195000,-195000
055909,大成鋼凱基98購02,0,0,0,0,0,0,0,0,0,-195000,0,0,0,30000,225000,-195000,-195000
051483,玉晶光凱基96購02,0,0,0,0,0,0,0,0,0,-195000,0,0,0,45000,240000,-195000,-195000
056812,泰鼎統一98購01  ,0,0,0,0,0,0,0,0,0,-197000,0,0,0,61000,258000,-197000,-197000
058399,美律元大99購05  ,0,0,0,0,0,0,0,0,0,-197000,0,0,0,25000,222000,-197000,-197000
00652,富邦印度        ,0,2000,-2000,0,0,0,0,0,0,-195000,0,0,0,3000,198000,-195000,-197000
05919P,京鼎元大96售03  ,0,0,0,0,0,0,0,0,0,-198000,0,0,0,269000,467000,-198000,-198000
054205,華新國票97購02  ,0,0,0,0,0,0,0,0,0,-198000,0,0,0,0,198000,-198000,-198000
054683,川湖永豐97購01  ,0,0,0,0,0,0,0,0,0,-199000,0,0,0,0,199000,-199000,-199000
050212,瀚宇博國票95購02,0,0,0,0,0,0,0,0,0,-199000,0,0,0,27000,226000,-199000,-199000
6196,帆宣            ,340000,494000,-154000,0,0,0,0,0,0,-45000,0,0,0,16000,61000,-45000,-199000
047970,鴻海富邦95購01  ,0,0,0,0,0,0,0,0,0,-200000,0,0,0,0,200000,-200000,-200000
055402,正文元富97購02  ,0,0,0,0,0,0,0,0,0,-200000,0,0,0,20000,220000,-200000,-200000
055607,華通康和97購01  ,0,0,0,0,0,0,0,0,0,-200000,0,0,0,0,200000,-200000,-200000
2049,上銀            ,328000,449330,-121330,0,0,0,0,973,-973,-78000,16000,104000,-88000,33000,23000,10000,-200303
060426,盛群永豐9A購01  ,0,0,0,0,0,0,0,0,0,-201000,0,0,0,0,201000,-201000,-201000
054178,中磊台新97購01  ,0,0,0,0,0,0,0,0,0,-201000,0,0,0,0,201000,-201000,-201000
2855,統一證          ,297000,498110,-201110,0,0,0,0,0,0,0,0,0,0,0,0,0,-201110
1304,台聚            ,510000,712000,-202000,0,0,0,0,0,0,0,0,0,0,0,0,0,-202000
056895,技嘉元大98購01  ,2000,0,2000,0,0,0,0,0,0,-205000,0,0,0,0,205000,-205000,-203000
046340,滬深2X國票96購01,0,0,0,0,0,0,0,0,0,-203000,0,0,0,0,203000,-203000,-203000
055684,京鼎凱基97購01  ,0,0,0,0,0,0,0,0,0,-204000,0,0,0,6000,210000,-204000,-204000
060639,玉晶光永豐9A購05,0,0,0,0,0,0,0,0,0,-206000,0,0,0,54000,260000,-206000,-206000
8016,矽創            ,114000,314820,-200820,0,0,0,0,638,-638,-5000,25000,30000,-5000,1000,1000,0,-206458
056133,可成元大97購05  ,0,0,0,0,0,0,0,0,0,-207000,0,0,0,0,207000,-207000,-207000
055403,泰鼎元富97購01  ,0,0,0,0,0,0,0,0,0,-207000,0,0,0,109000,316000,-207000,-207000
07386P,臺股指群益99售24,0,0,0,0,0,0,0,0,0,-207000,0,0,0,10000,217000,-207000,-207000
058402,欣興元大99購04  ,0,0,0,0,0,0,0,0,0,-208000,0,0,0,117000,325000,-208000,-208000
057377,康控元大99購02  ,0,0,0,0,0,0,0,0,0,-208000,0,0,0,8000,216000,-208000,-208000
056488,致新元大99購01  ,0,0,0,0,0,0,0,0,0,-208000,0,0,0,48000,256000,-208000,-208000
00641R,富邦日本反1     ,0,4000,-4000,0,0,0,0,0,0,-204150,0,0,0,247000,451150,-204150,-208150
054082,楠梓電元富96購01,0,0,0,0,0,0,0,0,0,-209000,0,0,0,0,209000,-209000,-209000
1215,卜蜂            ,139200,414800,-275600,0,0,0,0,0,0,66000,0,0,0,66000,0,66000,-209600
057935,晶技群益98購02  ,0,0,0,0,0,0,0,0,0,-210000,0,0,0,53000,263000,-210000,-210000
3704,合勤控          ,154000,364000,-210000,0,0,0,0,0,0,0,0,0,0,0,0,0,-210000
048983,牧德元大95購01  ,0,0,0,0,0,0,0,0,0,-211000,0,0,0,400000,611000,-211000,-211000
05192P,玉晶光台新96售02,0,0,0,0,0,0,0,0,0,-211000,0,0,0,27000,238000,-211000,-211000
2538,基泰            ,24000,235000,-211000,0,0,0,0,0,0,0,0,0,0,0,0,0,-211000
059507,鴻海永豐99購03  ,0,0,0,0,0,0,0,0,0,-212000,0,0,0,0,212000,-212000,-212000
05782P,聯詠元富96售02  ,0,0,0,0,0,0,0,0,0,-213000,0,0,0,0,213000,-213000,-213000
060047,道瓊反凱基99購01,0,0,0,0,0,0,0,0,0,-213000,0,0,0,0,213000,-213000,-213000
059250,大立光凱基99購06,0,0,0,0,0,0,0,0,0,-214000,0,0,0,10000,224000,-214000,-214000
3003,健和興          ,9000,218000,-209000,0,0,0,0,0,0,-5000,0,10000,-10000,5000,0,5000,-214000
057872,旺宏元大99購06  ,0,0,0,0,0,0,0,0,0,-215000,0,0,0,99000,314000,-215000,-215000
03662C,FBVIX凱基03牛01 ,0,0,0,0,0,0,0,0,0,-215000,0,0,0,10000,225000,-215000,-215000
057523,大成鋼元大99購01,0,0,0,0,0,0,0,0,0,-216000,0,0,0,31000,247000,-216000,-216000
058833,台表科永豐99購01,0,0,0,0,0,0,0,0,0,-216000,0,0,0,278000,494000,-216000,-216000
060260,京鼎凱基9C購01  ,0,0,0,0,0,0,0,0,0,-216000,0,0,0,34000,250000,-216000,-216000
054860,台積電群益98購01,0,0,0,0,0,0,0,0,0,-216000,0,0,0,0,216000,-216000,-216000
07458P,長榮航元大9A售01,0,0,0,0,0,0,0,0,0,-216000,0,0,0,105000,321000,-216000,-216000
03678C,臺股指凱基01牛02,0,0,0,0,0,0,0,0,0,-217000,0,0,0,84000,301000,-217000,-217000
6153,嘉聯益          ,550000,642295,-92295,0,0,0,0,0,0,-125000,92000,88000,4000,42000,171000,-129000,-217295
2836,高雄銀          ,39000,255000,-216000,0,0,0,0,0,0,-2000,0,2000,-2000,0,0,0,-218000
059791,超眾元大99購06  ,0,0,0,0,0,0,0,0,0,-219000,0,0,0,235000,454000,-219000,-219000
059295,大立光元富99購05,0,0,0,0,0,0,0,0,0,-220000,0,0,0,142000,362000,-220000,-220000
055923,矽力凱基98購01  ,0,0,0,0,0,0,0,0,0,-220000,0,0,0,0,220000,-220000,-220000
058159,健策台新9A購01  ,0,0,0,0,0,0,0,0,0,-221000,0,0,0,180000,401000,-221000,-221000
055444,致新台新97購01  ,0,0,0,0,0,0,0,0,0,-221000,0,0,0,0,221000,-221000,-221000
060054,華新科凱基9B購04,0,0,0,0,0,0,0,0,0,-223000,0,0,0,27000,250000,-223000,-223000
055858,聯茂元大97購03  ,0,0,0,0,0,0,0,0,0,-223000,0,0,0,5000,228000,-223000,-223000
050590,晶技永豐95購01  ,0,0,0,0,0,0,0,0,0,-223000,0,0,0,253000,476000,-223000,-223000
055583,國巨元大97購10  ,0,0,0,0,0,0,0,0,0,-224000,0,0,0,84000,308000,-224000,-224000
056189,樺漢統一97購02  ,0,0,0,0,0,0,0,0,0,-225000,0,0,0,0,225000,-225000,-225000
059474,元石油群益99購01,0,0,0,0,0,0,0,0,0,-226000,0,0,0,101000,327000,-226000,-226000
1103,嘉泥            ,23000,165000,-142000,0,0,0,0,0,0,-84000,0,84000,-84000,0,0,0,-226000
1337,再生-KY         ,3000,227000,-224000,0,0,0,0,0,0,-2000,0,2000,-2000,0,0,0,-226000
07173P,臺股指國票99售10,0,0,0,0,0,0,0,0,0,-226000,0,0,0,67000,293000,-226000,-226000
057626,技嘉富邦9A購01  ,0,0,0,0,0,0,0,0,0,-229000,0,0,0,36000,265000,-229000,-229000
060215,柏文康和9A購01  ,0,0,0,0,0,0,0,0,0,-230000,0,0,0,0,230000,-230000,-230000
056486,樺漢元大98購04  ,0,0,0,0,0,0,0,0,0,-230000,0,0,0,0,230000,-230000,-230000
050024,旺宏元大94購09  ,0,0,0,0,0,0,0,0,0,-231000,0,0,0,0,231000,-231000,-231000
054523,GIS元大96購05   ,0,0,0,0,0,0,0,0,0,-232000,0,0,0,0,232000,-232000,-232000
060628,和大富邦9B購01  ,0,0,0,0,0,0,0,0,0,-232000,0,0,0,0,232000,-232000,-232000
060294,嘉澤元大9A購01  ,0,0,0,0,0,0,0,0,0,-233000,0,0,0,44000,277000,-233000,-233000
053913,華新國票97購01  ,0,0,0,0,0,0,0,0,0,-233000,0,0,0,40000,273000,-233000,-233000
2537,聯上發          ,91000,324000,-233000,0,0,0,0,0,0,0,0,0,0,0,0,0,-233000
059676,台積電台新99購05,0,0,0,0,0,0,0,0,0,-234000,0,0,0,267000,501000,-234000,-234000
057742,喬山永豐98購02  ,0,0,0,0,0,0,0,0,0,-234000,0,0,0,0,234000,-234000,-234000
056190,昇陽半統一97購01,0,0,0,0,0,0,0,0,0,-236000,0,0,0,0,236000,-236000,-236000
059425,SGBR2X元大9A購02,0,0,0,0,0,0,0,0,0,-236000,0,0,0,474000,710000,-236000,-236000
054826,復盛元大9A購01  ,0,0,0,0,0,0,0,0,0,-237000,0,0,0,80000,317000,-237000,-237000
00692,富邦公司治理    ,3000,1000,2000,0,0,0,0,0,0,-240000,0,0,0,1391000,1631000,-240000,-238000
06355P,聯茂永豐97售02  ,0,0,0,0,0,0,0,0,0,-238000,0,0,0,12000,250000,-238000,-238000
059475,元石油群益99購02,20000,0,20000,0,0,0,0,0,0,-259000,0,0,0,21000,280000,-259000,-239000
3563,牧德            ,176000,276000,-100000,0,0,0,0,69000,-69000,-70000,19000,59000,-40000,18000,48000,-30000,-239000
1477,聚陽            ,382500,623020,-240520,0,0,0,0,1674,-1674,3000,2000,2000,0,6000,3000,3000,-239194
059514,嘉澤永豐99購02  ,0,0,0,0,0,0,0,0,0,-240000,0,0,0,26000,266000,-240000,-240000
060289,京元電元大9A購01,0,0,0,0,0,0,0,0,0,-240000,0,0,0,230000,470000,-240000,-240000
054481,鎧勝中信96購01  ,0,0,0,0,0,0,0,0,0,-242000,0,0,0,87000,329000,-242000,-242000
055196,致新元富97購01  ,0,0,0,0,0,0,0,0,0,-243000,0,0,0,130000,373000,-243000,-243000
060225,S&P反1元大9A購02,0,0,0,0,0,0,0,0,0,-245000,0,0,0,40000,285000,-245000,-245000
057802,卜蜂元大98購01  ,0,0,0,0,0,0,0,0,0,-245000,0,0,0,4000,249000,-245000,-245000
059631,京元電凱基99購02,0,0,0,0,0,0,0,0,0,-245000,0,0,0,44000,289000,-245000,-245000
059065,南電凱基9A購01  ,0,0,0,0,0,0,0,0,0,-245000,0,0,0,260000,505000,-245000,-245000
055133,致新康和97購01  ,0,0,0,0,0,0,0,0,0,-246000,0,0,0,68000,314000,-246000,-246000
1514,亞力            ,60000,306000,-246000,0,0,0,0,0,0,0,0,0,0,0,0,0,-246000
058675,康控群益9B購01  ,0,0,0,0,0,0,0,0,0,-247000,0,0,0,0,247000,-247000,-247000
07006P,旺宏統一9B售03  ,0,0,0,0,0,0,0,0,0,-247000,0,0,0,4000,251000,-247000,-247000
8110,華東            ,45000,286000,-241000,0,0,0,0,0,0,-6000,0,6000,-6000,0,0,0,-247000
056106,晶相光永豐97購02,0,0,0,0,0,0,0,0,0,-248000,0,0,0,0,248000,-248000,-248000
053875,GIS元大97購01   ,0,0,0,0,0,0,0,0,0,-248000,0,0,0,162000,410000,-248000,-248000
056323,旺宏兆豐98購01  ,0,0,0,0,0,0,0,0,0,-249000,0,0,0,1000,250000,-249000,-249000
07542P,台積電凱基9A售16,0,0,0,0,0,0,0,0,0,-249000,0,0,0,0,249000,-249000,-249000
3044,健鼎            ,539000,692960,-153960,0,0,0,200000,1341,198659,-294000,0,287000,-287000,0,7000,-7000,-249301
051424,緯穎國票97購01  ,0,0,0,0,0,0,0,0,0,-250000,0,0,0,5000,255000,-250000,-250000
051356,全新元大96購04  ,0,0,0,0,0,0,0,0,0,-250000,0,0,0,0,250000,-250000,-250000
060674,瑞昱元大9A購03  ,0,0,0,0,0,0,0,0,0,-250000,0,0,0,0,250000,-250000,-250000
03603P,群創凱基98售04  ,0,0,0,0,0,0,0,0,0,-251000,0,0,0,15000,266000,-251000,-251000
2637,慧洋-KY         ,61000,254165,-193165,0,0,0,0,3170,-3170,-56000,0,56000,-56000,0,0,0,-252335
055197,致新元富97購02  ,0,0,0,0,0,0,0,0,0,-255000,0,0,0,156000,411000,-255000,-255000
055235,金寶台新98購01  ,0,0,0,0,0,0,0,0,0,-255000,0,0,0,20000,275000,-255000,-255000
052599,S&P反1元大96購01,0,0,0,0,0,0,0,0,0,-255000,0,0,0,40000,295000,-255000,-255000
3016,嘉晶            ,244000,508000,-264000,0,0,0,0,0,0,9000,0,6000,-6000,33000,18000,15000,-255000
3702,大聯大          ,321000,554971,-233971,0,0,0,0,4389,-4389,-17000,4000,48000,-44000,27000,0,27000,-255360
9910,豐泰            ,636000,870490,-234490,0,0,0,0,2295,-2295,-19000,0,19000,-19000,0,0,0,-255785
1305,華夏            ,283000,533000,-250000,0,0,0,0,0,0,-6000,0,6000,-6000,0,0,0,-256000
047673,瑞昱元富96購01  ,0,0,0,0,0,0,0,0,0,-261000,0,0,0,0,261000,-261000,-261000
057283,欣興元大98購07  ,0,0,0,0,0,0,0,0,0,-263000,0,0,0,127000,390000,-263000,-263000
059473,T50反1群益99購03,0,0,0,0,0,0,0,0,0,-263000,0,0,0,45000,308000,-263000,-263000
057696,聯電群益9A購01  ,0,0,0,0,0,0,0,0,0,-263000,0,0,0,203000,466000,-263000,-263000
057572,明泰永豐98購01  ,0,0,0,0,0,0,0,0,0,-263000,0,0,0,0,263000,-263000,-263000
06595P,祥碩元大98售03  ,0,0,0,0,0,0,0,0,0,-263000,0,0,0,240000,503000,-263000,-263000
059371,聯鈞元富99購02  ,0,0,0,0,0,0,0,0,0,-266000,0,0,0,25000,291000,-266000,-266000
058966,元油2X日盛99購03,0,0,0,0,0,0,0,0,0,-266000,0,0,0,3000,269000,-266000,-266000
056497,GIS國泰99購01   ,0,0,0,0,0,0,0,0,0,-267000,0,0,0,0,267000,-267000,-267000
060212,華航康和9A購01  ,0,0,0,0,0,0,0,0,0,-268000,0,0,0,60000,328000,-268000,-268000
049595,麗豐元大95購01  ,0,0,0,0,0,0,0,0,0,-268000,0,0,0,9000,277000,-268000,-268000
3041,揚智            ,155000,423000,-268000,0,0,0,0,0,0,0,0,0,0,0,0,0,-268000
2505,國揚            ,438000,684000,-246000,0,0,0,0,0,0,-22000,0,0,0,0,22000,-22000,-268000
059796,台積電國票99購10,0,0,0,0,0,0,0,0,0,-270000,0,0,0,121000,391000,-270000,-270000
057592,美律兆豐99購01  ,0,0,0,0,0,0,0,0,0,-270000,0,0,0,98000,368000,-270000,-270000
055510,GIS元大97購03   ,0,0,0,0,0,0,0,0,0,-270000,0,0,0,0,270000,-270000,-270000
059005,嘉晶元大99購06  ,0,0,0,0,0,0,0,0,0,-272000,0,0,0,77000,349000,-272000,-272000
059283,康友永豐99購02  ,0,0,0,0,0,0,0,0,0,-272000,0,0,0,14000,286000,-272000,-272000
1707,葡萄王          ,74000,77510,-3510,0,0,0,0,250555,-250555,-18000,1000,19000,-18000,0,0,0,-272065
00640L,富邦日本正2     ,0,1000,-1000,0,0,0,0,0,0,-272000,0,0,0,418000,690000,-272000,-273000
07303P,臺股指元大9A售36,0,0,0,0,0,0,0,0,0,-274000,0,0,0,69000,343000,-274000,-274000
059254,台表科凱基9A購02,0,0,0,0,0,0,0,0,0,-276000,0,0,0,145000,421000,-276000,-276000
054932,台肥元大97購01  ,0,0,0,0,0,0,0,0,0,-276000,0,0,0,516000,792000,-276000,-276000
1717,長興            ,84000,293000,-209000,0,0,0,0,6439,-6439,-62000,0,62000,-62000,0,0,0,-277439
060084,聯電元大99購02  ,0,0,0,0,0,0,0,0,0,-278000,0,0,0,255000,533000,-278000,-278000
060226,道瓊反元大9A購01,0,0,0,0,0,0,0,0,0,-279000,0,0,0,70000,349000,-279000,-279000
006208,富邦台50        ,0,0,0,0,0,0,0,0,0,-279000,0,0,0,418000,697000,-279000,-279000
1528,恩德            ,5000,283000,-278000,0,0,0,0,0,0,-1000,0,1000,-1000,0,0,0,-279000
059832,超眾康和99購01  ,0,0,0,0,0,0,0,0,0,-280000,0,0,0,301000,581000,-280000,-280000
056296,旺宏元大97購07  ,0,0,0,0,0,0,0,0,0,-280000,0,0,0,20000,300000,-280000,-280000
059559,T50反1凱基99購07,0,0,0,0,0,0,0,0,0,-280000,0,0,0,60000,340000,-280000,-280000
056067,智原元大97購01  ,0,0,0,0,0,0,0,0,0,-280000,0,0,0,21000,301000,-280000,-280000
4961,天鈺            ,59000,339000,-280000,0,0,0,0,0,0,0,0,0,0,0,0,0,-280000
059516,TPK永豐99購01   ,0,0,0,0,0,0,0,0,0,-281000,0,0,0,78000,359000,-281000,-281000
3058,立德            ,6000,288000,-282000,0,0,0,0,0,0,-2000,0,2000,-2000,0,0,0,-284000
1447,力鵬            ,22000,298000,-276000,0,0,0,0,0,0,-8000,0,8000,-8000,0,0,0,-284000
059977,鴻海元大99購40  ,0,0,0,0,0,0,0,0,0,-285000,0,0,0,0,285000,-285000,-285000
052483,超眾群益95購03  ,0,0,0,0,0,0,0,0,0,-285000,0,0,0,45000,330000,-285000,-285000
052614,聯電國泰97購01  ,0,0,0,0,0,0,0,0,0,-286000,0,0,0,471000,757000,-286000,-286000
3703,欣陸            ,87000,373000,-286000,0,0,0,0,0,0,0,0,0,0,0,0,0,-286000
8404,百和興業-KY     ,29000,315000,-286000,0,0,0,0,0,0,0,0,0,0,0,0,0,-286000
00712,FH富時不動產    ,1000,4000,-3000,0,0,0,0,0,0,-284000,0,0,0,89000,373000,-284000,-287000
060183,南亞科元富9A購01,0,0,0,0,0,0,0,0,0,-288000,0,0,0,43000,331000,-288000,-288000
05869P,旺宏凱基96售05  ,0,0,0,0,0,0,0,0,0,-289000,0,0,0,0,289000,-289000,-289000
056200,大毅永豐98購01  ,0,0,0,0,0,0,0,0,0,-290000,0,0,0,91000,381000,-290000,-290000
00631L,元大台灣50正2   ,233000,233000,0,0,0,0,0,0,0,-294000,0,0,0,3156000,3450000,-294000,-294000
2606,裕民            ,91000,381760,-290760,0,0,0,0,1684,-1684,-2000,5000,28000,-23000,21000,0,21000,-294444
2511,太子            ,35000,329730,-294730,0,0,0,0,0,0,0,0,0,0,0,0,0,-294730
059375,道瓊反群益9C購02,0,0,0,0,0,0,0,0,0,-295000,0,0,0,0,295000,-295000,-295000
056599,臻鼎元富98購01  ,0,0,0,0,0,0,0,0,0,-296000,0,0,0,22000,318000,-296000,-296000
059678,鴻海國泰9A購03  ,0,0,0,0,0,0,0,0,0,-297000,0,0,0,5000,302000,-297000,-297000
056677,智伸科元富98購01,0,0,0,0,0,0,0,0,0,-298000,0,0,0,100000,398000,-298000,-298000
059485,台灣50兆豐99購02,0,0,0,0,0,0,0,0,0,-299000,0,0,0,135000,434000,-299000,-299000
5607,遠雄港          ,34000,333413,-299413,0,0,0,0,0,0,0,0,0,0,0,0,0,-299413
050184,信邦元大94購01  ,0,0,0,0,0,0,0,0,0,-300000,0,0,0,0,300000,-300000,-300000
058244,神達元大99購02  ,0,0,0,0,0,0,0,0,0,-301000,0,0,0,104000,405000,-301000,-301000
056264,聯發科統一98購02,0,0,0,0,0,0,0,0,0,-301000,0,0,0,0,301000,-301000,-301000
058944,元石油群益9C購02,0,0,0,0,0,0,0,0,0,-302000,0,0,0,80000,382000,-302000,-302000
060425,凌華永豐9A購01  ,0,0,0,0,0,0,0,0,0,-302000,0,0,0,0,302000,-302000,-302000
052194,旺宏元富95購04  ,0,0,0,0,0,0,0,0,0,-303000,0,0,0,0,303000,-303000,-303000
07468P,聯電元大9A售02  ,0,0,0,0,0,0,0,0,0,-303000,0,0,0,10000,313000,-303000,-303000
06068P,玉晶光康和97售01,0,0,0,0,0,0,0,0,0,-303000,0,0,0,47000,350000,-303000,-303000
055330,上銀兆豐98購02  ,0,0,0,0,0,0,0,0,0,-304000,0,0,0,25000,329000,-304000,-304000
060596,元黃金凱基9A購02,0,0,0,0,0,0,0,0,0,-304000,0,0,0,0,304000,-304000,-304000
059350,樺漢凱基9A購01  ,0,0,0,0,0,0,0,0,0,-305000,0,0,0,42000,347000,-305000,-305000
059431,旺宏元大99購14  ,0,0,0,0,0,0,0,0,0,-305000,0,0,0,31000,336000,-305000,-305000
2915,潤泰全          ,238000,539045,-301045,0,0,0,0,1482,-1482,-4000,36000,28000,8000,16000,28000,-12000,-306527
00673R,元大S&P原油反1  ,252000,563000,-311000,0,0,0,0,0,0,4000,0,0,0,1338000,1334000,4000,-307000
1714,和桐            ,259000,561000,-302000,0,0,0,0,0,0,-5000,0,5000,-5000,0,0,0,-307000
057393,台積電中信02購01,0,0,0,0,0,0,0,0,0,-310000,0,0,0,0,310000,-310000,-310000
060046,S&P反1凱基99購02,0,0,0,0,0,0,0,0,0,-310000,0,0,0,10000,320000,-310000,-310000
059767,矽力永豐99購01  ,0,0,0,0,0,0,0,0,0,-310000,0,0,0,35000,345000,-310000,-310000
06337P,祥碩元大97售05  ,0,0,0,0,0,0,0,0,0,-310000,0,0,0,475000,785000,-310000,-310000
2347,聯強            ,324000,565500,-241500,0,0,0,0,8354,-8354,-64000,0,87000,-87000,23000,0,23000,-313854
054147,GIS元大96購02   ,0,0,0,0,0,0,0,0,0,-314000,0,0,0,0,314000,-314000,-314000
053094,聯電統一97購02  ,0,0,0,0,0,0,0,0,0,-315000,0,0,0,0,315000,-315000,-315000
2031,新光鋼          ,147000,251000,-104000,0,0,0,0,200000,-200000,-12000,9000,21000,-12000,0,0,0,-316000
4532,瑞智            ,10000,324000,-314000,0,0,0,0,0,0,-5000,0,5000,-5000,0,0,0,-319000
056894,佳世達元大99購01,0,0,0,0,0,0,0,0,0,-320000,0,0,0,30000,350000,-320000,-320000
058195,鈺齊永豐99購01  ,0,0,0,0,0,0,0,0,0,-320000,0,0,0,0,320000,-320000,-320000
059086,國巨元大99購18  ,0,0,0,0,0,0,0,0,0,-320000,0,0,0,56000,376000,-320000,-320000
060092,瑞昱元大99購03  ,0,0,0,0,0,0,0,0,0,-322000,0,0,0,55000,377000,-322000,-322000
059061,晶技凱基9A購01  ,0,0,0,0,0,0,0,0,0,-327000,0,0,0,0,327000,-327000,-327000
057375,欣興元大98購09  ,0,0,0,0,0,0,0,0,0,-328000,0,0,0,15000,343000,-328000,-328000
9904,寶成            ,1949000,2066700,-117700,0,0,0,0,9040,-9040,-202000,0,160000,-160000,0,42000,-42000,-328740
060209,喬山康和9A購01  ,0,0,0,0,0,0,0,0,0,-330000,0,0,0,14000,344000,-330000,-330000
2017,官田鋼          ,5000,82000,-77000,0,0,0,0,0,0,-253000,0,253000,-253000,0,0,0,-330000
060277,道瓊反元大9A購02,0,0,0,0,0,0,0,0,0,-330000,0,0,0,34000,364000,-330000,-330000
059835,聯發科國泰9B購01,0,0,0,0,0,0,0,0,0,-333000,0,0,0,121000,454000,-333000,-333000
1609,大亞            ,160000,457000,-297000,0,0,0,0,0,0,-36000,0,36000,-36000,0,0,0,-333000
056269,新日興統一98購01,0,0,0,0,0,0,0,0,0,-335000,0,0,0,10000,345000,-335000,-335000
057747,致新永豐98購01  ,0,0,0,0,0,0,0,0,0,-336000,0,0,0,0,336000,-336000,-336000
3056,總太            ,50000,370000,-320000,0,0,0,0,0,0,-18000,0,18000,-18000,0,0,0,-338000
056665,上証2X國票99購02,0,0,0,0,0,0,0,0,0,-340000,0,0,0,0,340000,-340000,-340000
055920,智伸科凱基97購02,0,0,0,0,0,0,0,0,0,-340000,0,0,0,0,340000,-340000,-340000
058200,世芯康和99購01  ,0,0,0,0,0,0,0,0,0,-341000,0,0,0,699000,1040000,-341000,-341000
9933,中鼎            ,188000,483490,-295490,0,0,0,0,4694,-4694,-42000,0,42000,-42000,0,0,0,-342184
1905,華紙            ,25000,369000,-344000,0,0,0,0,0,0,0,0,0,0,0,0,0,-344000
2890,永豐金          ,2048000,4009560,-1961560,0,0,0,2000000,23665,1976335,-361000,0,341000,-341000,0,20000,-20000,-346225
060025,台積電富邦9C購06,0,0,0,0,0,0,0,0,0,-347000,0,0,0,282000,629000,-347000,-347000
054002,GIS群益96購03   ,0,0,0,0,0,0,0,0,0,-347000,0,0,0,0,347000,-347000,-347000
060547,瑞昱凱基9A購01  ,0,0,0,0,0,0,0,0,0,-347000,0,0,0,0,347000,-347000,-347000
057808,旺宏元大99購05  ,0,0,0,0,0,0,0,0,0,-348000,0,0,0,0,348000,-348000,-348000
058958,台表科國票9A購03,0,0,0,0,0,0,0,0,0,-348000,0,0,0,11000,359000,-348000,-348000
054874,帆宣群益99購02  ,0,0,0,0,0,0,0,0,0,-348000,0,0,0,50000,398000,-348000,-348000
051722,玉晶光永豐97購01,0,0,0,0,0,0,0,0,0,-349000,0,0,0,386000,735000,-349000,-349000
053141,景碩永豐96購02  ,0,0,0,0,0,0,0,0,0,-350000,0,0,0,0,350000,-350000,-350000
060381,元黃金凱基9A購01,0,0,0,0,0,0,0,0,0,-353000,0,0,0,2000,355000,-353000,-353000
8105,凌巨            ,75000,413000,-338000,0,0,0,0,0,0,-15000,0,15000,-15000,0,0,0,-353000
07334P,臺股指國票99售19,0,0,0,0,0,0,0,0,0,-357000,0,0,0,118000,475000,-357000,-357000
4968,立積            ,348000,700000,-352000,0,0,0,20000,0,20000,-27000,0,2000,-2000,9000,34000,-25000,-359000
059948,正文永豐99購01  ,0,0,0,0,0,0,0,0,0,-360000,0,0,0,164000,524000,-360000,-360000
049235,元油2X元富96購05,0,10000,-10000,0,0,0,0,0,0,-350000,0,0,0,300000,650000,-350000,-360000
3036,文曄            ,80000,228000,-148000,0,0,0,0,0,0,-214000,0,183000,-183000,0,31000,-31000,-362000
9907,統一實          ,76000,429000,-353000,0,0,0,0,0,0,-14000,0,14000,-14000,0,0,0,-367000
1312,國喬            ,1014000,1320805,-306805,0,0,0,0,0,0,-61000,10000,71000,-61000,0,0,0,-367805
2101,南港            ,649000,802610,-153610,0,0,0,0,4454,-4454,-210000,0,47000,-47000,18000,181000,-163000,-368064
04631P,臺股指中信95售08,0,0,0,0,0,0,0,0,0,-370000,0,0,0,0,370000,-370000,-370000
059980,台積電元大99購50,0,0,0,0,0,0,0,0,0,-370000,0,0,0,10000,380000,-370000,-370000
057044,旺宏元大98購08  ,0,0,0,0,0,0,0,0,0,-371000,0,0,0,0,371000,-371000,-371000
059822,聯發科凱基99購19,0,0,0,0,0,0,0,0,0,-371000,0,0,0,0,371000,-371000,-371000
6257,矽格            ,395000,463025,-68025,0,0,0,0,0,0,-303000,9000,322000,-313000,11000,1000,10000,-371025
057001,華邦電國票99購02,0,0,0,0,0,0,0,0,0,-373000,0,0,0,90000,463000,-373000,-373000
060229,楠梓電元大9C購01,0,0,0,0,0,0,0,0,0,-374000,0,0,0,0,374000,-374000,-374000
055901,超眾中信97購01  ,0,0,0,0,0,0,0,0,0,-377000,0,0,0,39000,416000,-377000,-377000
07310P,大立光凱基99售12,0,0,0,0,0,0,0,0,0,-377000,0,0,0,0,377000,-377000,-377000
058910,泰鼎元大99購03  ,0,0,0,0,0,0,0,0,0,-378000,0,0,0,136000,514000,-378000,-378000
059153,臺股指國票99購16,0,0,0,0,0,0,0,0,0,-379000,0,0,0,171000,550000,-379000,-379000
2376,技嘉            ,460000,574150,-114150,0,0,0,0,202126,-202126,-64000,36000,64000,-28000,78000,114000,-36000,-380276
058222,玉晶光統一9B購01,0,0,0,0,0,0,0,0,0,-381000,0,0,0,199000,580000,-381000,-381000
053672,嘉澤元富96購02  ,0,0,0,0,0,0,0,0,0,-381000,0,0,0,20000,401000,-381000,-381000
2355,敬鵬            ,400000,751110,-351110,0,0,0,0,0,0,-30000,0,16000,-16000,0,14000,-14000,-381110
4414,如興            ,203000,547000,-344000,0,0,0,0,0,0,-38000,0,38000,-38000,0,0,0,-382000
07352P,台積電國票99售11,0,0,0,0,0,0,0,0,0,-386000,0,0,0,22000,408000,-386000,-386000
054455,楠梓電群益98購02,0,0,0,0,0,0,0,0,0,-387000,0,0,0,1000,388000,-387000,-387000
056786,亞光群益98購03  ,0,0,0,0,0,0,0,0,0,-388000,0,0,0,0,388000,-388000,-388000
060168,台表科永豐9A購01,0,0,0,0,0,0,0,0,0,-391000,0,0,0,20000,411000,-391000,-391000
2609,陽明            ,35000,399000,-364000,0,0,0,0,27616,-27616,0,0,0,0,0,0,0,-391616
057856,聯鈞國票99購03  ,0,0,0,0,0,0,0,0,0,-392000,0,0,0,245000,637000,-392000,-392000
2489,瑞軒            ,45000,401000,-356000,0,0,0,0,0,0,-36000,22000,58000,-36000,0,0,0,-392000
059359,精元永豐99購01  ,0,0,0,0,0,0,0,0,0,-395000,0,0,0,67000,462000,-395000,-395000
3605,宏致            ,62000,454000,-392000,0,0,0,0,0,0,-5000,0,5000,-5000,0,0,0,-397000
2820,華票            ,82000,376000,-294000,0,0,0,0,11415,-11415,-92000,0,92000,-92000,0,0,0,-397415
2231,為升            ,44000,406000,-362000,0,0,0,0,824,-824,-35000,18000,35000,-17000,1000,19000,-18000,-397824
9921,巨大            ,317000,699470,-382470,0,0,0,0,1587,-1587,-14000,1000,15000,-14000,0,0,0,-398057
056899,可成元大98購01  ,0,0,0,0,0,0,0,0,0,-400000,0,0,0,9000,409000,-400000,-400000
057628,旺宏永豐98購02  ,0,0,0,0,0,0,0,0,0,-400000,0,0,0,0,400000,-400000,-400000
1536,和大            ,107000,325600,-218600,0,0,0,0,42280,-42280,-141000,5000,121000,-116000,3000,28000,-25000,-401880
2722,夏都            ,0,2000,-2000,0,0,0,0,0,0,-400000,0,400000,-400000,0,0,0,-402000
055938,矽力群益97購01  ,0,0,0,0,0,0,0,0,0,-405000,0,0,0,0,405000,-405000,-405000
2501,國建            ,106000,447320,-341320,0,0,0,0,8022,-8022,-56000,6000,62000,-56000,0,0,0,-405342
05625P,國巨國票97售01  ,0,0,0,0,0,0,0,0,0,-407000,0,0,0,74000,481000,-407000,-407000
3005,神基            ,84000,519580,-435580,0,0,0,0,3776,-3776,29000,15000,28000,-13000,42000,0,42000,-410356
5269,祥碩            ,235000,292770,-57770,0,0,0,2000,295217,-293217,-60000,12000,35000,-23000,3000,40000,-37000,-410987
6191,精成科          ,153000,566000,-413000,0,0,0,0,0,0,0,0,1000,-1000,1000,0,1000,-413000
059629,友達凱基99購06  ,0,0,0,0,0,0,0,0,0,-417000,0,0,0,193000,610000,-417000,-417000
052463,聯電統一96購01  ,0,0,0,0,0,0,0,0,0,-417000,0,0,0,1000,418000,-417000,-417000
055183,聯鈞統一97購01  ,0,0,0,0,0,0,0,0,0,-417000,0,0,0,257000,674000,-417000,-417000
060555,台表科凱基9A購03,0,0,0,0,0,0,0,0,0,-417000,0,0,0,0,417000,-417000,-417000
060193,群創元富9A購01  ,0,0,0,0,0,0,0,0,0,-419000,0,0,0,0,419000,-419000,-419000
06072P,牧德永豐97售01  ,0,0,0,0,0,0,0,0,0,-419000,0,0,0,0,419000,-419000,-419000
060302,台積電富邦02購01,0,0,0,0,0,0,0,0,0,-423000,0,0,0,59000,482000,-423000,-423000
057903,聯鈞永豐99購01  ,0,0,0,0,0,0,0,0,0,-423000,0,0,0,0,423000,-423000,-423000
053658,亞光凱基96購01  ,0,0,0,0,0,0,0,0,0,-423000,0,0,0,0,423000,-423000,-423000
2809,京城銀          ,176000,507660,-331660,0,0,0,0,3076,-3076,-89000,0,89000,-89000,0,0,0,-423736
052590,祥碩永豐96購01  ,0,0,0,0,0,0,0,0,0,-424000,0,0,0,10000,434000,-424000,-424000
060336,南電康和9A購01  ,0,0,0,0,0,0,0,0,0,-426000,0,0,0,184000,610000,-426000,-426000
055404,超眾元富97購01  ,0,0,0,0,0,0,0,0,0,-426000,0,0,0,609000,1035000,-426000,-426000
057624,新日興國泰99購01,0,0,0,0,0,0,0,0,0,-430000,0,0,0,72000,502000,-430000,-430000
4904,遠傳            ,489000,768150,-279150,0,0,0,0,5987,-5987,-153000,16000,167000,-151000,0,2000,-2000,-438137
060390,聯鈞群益9A購01  ,0,0,0,0,0,0,0,0,0,-445000,0,0,0,177000,622000,-445000,-445000
054890,聯鈞統一99購01  ,0,0,0,0,0,0,0,0,0,-446000,0,0,0,74000,520000,-446000,-446000
057407,超眾群益99購01  ,0,0,0,0,0,0,0,0,0,-448000,0,0,0,49000,497000,-448000,-448000
1210,大成            ,314500,732630,-418130,0,0,0,0,3615,-3615,-30000,0,30000,-30000,0,0,0,-451745
2204,中華            ,17000,444000,-427000,0,0,0,0,0,0,-28000,0,28000,-28000,0,0,0,-455000
6285,啟碁            ,145000,418900,-273900,0,0,0,50000,1348,48652,-232000,2000,224000,-222000,0,10000,-10000,-457248
052313,聯電元大98購01  ,0,0,0,0,0,0,0,0,0,-458000,0,0,0,392000,850000,-458000,-458000
050515,聯電元大96購01  ,0,0,0,0,0,0,0,0,0,-459000,0,0,0,209000,668000,-459000,-459000
049972,南電國票95購02  ,0,0,0,0,0,0,0,0,0,-461000,0,0,0,79000,540000,-461000,-461000
00635U,元大S&P黃金     ,0,390000,-390000,0,0,0,0,0,0,-73000,0,0,0,295000,368000,-73000,-463000
3576,聯合再生        ,353000,750700,-397700,0,0,0,0,26171,-26171,-46000,0,46000,-46000,0,0,0,-469871
3006,晶豪科          ,453000,937000,-484000,0,0,0,0,0,0,10000,28000,13000,15000,7000,12000,-5000,-474000
051669,建準元大95購01  ,0,0,0,0,0,0,0,0,0,-479000,0,0,0,20000,499000,-479000,-479000
1795,美時            ,207000,686000,-479000,0,0,0,0,0,0,-4000,0,4000,-4000,0,0,0,-483000
4119,旭富            ,617000,773000,-156000,0,0,0,0,286000,-286000,-42000,0,30000,-30000,26000,38000,-12000,-484000
060134,鈺齊群益9A購01  ,0,0,0,0,0,0,0,0,0,-489000,0,0,0,0,489000,-489000,-489000
055041,致新富邦97購01  ,0,0,0,0,0,0,0,0,0,-489000,0,0,0,10000,499000,-489000,-489000
07342P,大立光凱基99售14,0,0,0,0,0,0,0,0,0,-489000,0,0,0,741000,1230000,-489000,-489000
056717,康友永豐98購01  ,0,0,0,0,0,0,0,0,0,-490000,0,0,0,220000,710000,-490000,-490000
060208,卜蜂康和9A購01  ,0,0,0,0,0,0,0,0,0,-492000,0,0,0,0,492000,-492000,-492000
050392,群創統一96購01  ,0,0,0,0,0,0,0,0,0,-497000,0,0,0,30000,527000,-497000,-497000
1907,永豐餘          ,200000,619180,-419180,0,0,0,0,0,0,-78000,77000,155000,-78000,0,0,0,-497180
8213,志超            ,51000,549000,-498000,0,0,0,0,0,0,0,0,0,0,0,0,0,-498000
3338,泰碩            ,384000,934000,-550000,0,0,0,20000,0,20000,31000,208000,120000,88000,60000,117000,-57000,-499000
1434,福懋            ,75000,468675,-393675,0,0,0,0,8142,-8142,-98000,9000,107000,-98000,0,0,0,-499817
060418,中橡永豐9A購01  ,0,0,0,0,0,0,0,0,0,-501000,0,0,0,126000,627000,-501000,-501000
058896,中環元大99購03  ,0,0,0,0,0,0,0,0,0,-503000,0,0,0,47000,550000,-503000,-503000
051360,緯創元大95購03  ,0,0,0,0,0,0,0,0,0,-503000,0,0,0,0,503000,-503000,-503000
2014,中鴻            ,346000,791795,-445795,0,0,0,0,0,0,-63000,0,63000,-63000,0,0,0,-508795
059460,GIS永豐99購02   ,0,0,0,0,0,0,0,0,0,-512000,0,0,0,105000,617000,-512000,-512000
00634R,富邦上証反1     ,0,0,0,0,0,0,0,0,0,-515000,0,0,0,189000,704000,-515000,-515000
9945,潤泰新          ,238000,694385,-456385,0,0,0,0,3736,-3736,-58000,2000,50000,-48000,0,10000,-10000,-518121
060468,聯鈞元大9A購02  ,0,0,0,0,0,0,0,0,0,-520000,0,0,0,272000,792000,-520000,-520000
058315,TPK富邦9C購01   ,0,0,0,0,0,0,0,0,0,-520000,0,0,0,45000,565000,-520000,-520000
059566,台積電凱基9A購11,0,0,0,0,0,0,0,0,0,-521000,0,0,0,200000,721000,-521000,-521000
048139,南電國票94購02  ,0,0,0,0,0,0,0,0,0,-521000,0,0,0,80000,601000,-521000,-521000
07292P,臺股指凱基99售44,0,0,0,0,0,0,0,0,0,-523000,0,0,0,74000,597000,-523000,-523000
059922,大立光元大99購25,0,0,0,0,0,0,0,0,0,-530000,0,0,0,48000,578000,-530000,-530000
048576,義隆國泰95購01  ,0,0,0,0,0,0,0,0,0,-530000,0,0,0,2000,532000,-530000,-530000
056605,台積電富邦9B購02,0,0,0,0,0,0,0,0,0,-536000,0,0,0,0,536000,-536000,-536000
03033P,微星國票03售01  ,0,0,0,0,0,0,0,0,0,-537000,0,0,0,0,537000,-537000,-537000
058082,美律群益98購05  ,0,0,0,0,0,0,0,0,0,-538000,0,0,0,0,538000,-538000,-538000
3045,台灣大          ,421100,769070,-347970,0,0,0,0,7582,-7582,-183000,87000,270000,-183000,0,0,0,-538552
060487,盛群富邦9B購01  ,0,0,0,0,0,0,0,0,0,-543000,0,0,0,0,543000,-543000,-543000
054423,華新富邦96購01  ,0,0,0,0,0,0,0,0,0,-545000,0,0,0,5000,550000,-545000,-545000
060250,台表科元大9A購01,0,0,0,0,0,0,0,0,0,-546000,0,0,0,29000,575000,-546000,-546000
3189,景碩            ,356000,859470,-503470,0,0,0,20000,3055,16945,-61000,6000,50000,-44000,13000,30000,-17000,-547525
2547,日勝生          ,97000,632600,-535600,0,0,0,0,0,0,-14000,0,14000,-14000,0,0,0,-549600
5215,科嘉-KY         ,125000,411000,-286000,0,0,0,100000,366000,-266000,0,5000,5000,0,0,0,0,-552000
059928,道瓊銀富邦03購01,0,0,0,0,0,0,0,0,0,-554000,0,0,0,0,554000,-554000,-554000
058725,美律富邦9A購01  ,0,0,0,0,0,0,0,0,0,-554000,0,0,0,150000,704000,-554000,-554000
060150,華通富邦9B購01  ,0,0,0,0,0,0,0,0,0,-556000,0,0,0,0,556000,-556000,-556000
2023,燁輝            ,200000,738400,-538400,0,0,0,0,0,0,-18000,0,18000,-18000,0,0,0,-556400
054265,GIS元大96購03   ,0,0,0,0,0,0,0,0,0,-558000,0,0,0,561000,1119000,-558000,-558000
1904,正隆            ,391000,545770,-154770,0,0,0,0,430000,-430000,25000,44000,13000,31000,0,6000,-6000,-559770
057973,神達富邦9A購01  ,0,0,0,0,0,0,0,0,0,-562000,0,0,0,10000,572000,-562000,-562000
3515,華擎            ,800000,462000,338000,0,0,0,0,879000,-879000,-21000,19000,50000,-31000,50000,40000,10000,-562000
07580P,緯穎元大9A售03  ,0,0,0,0,0,0,0,0,0,-563000,0,0,0,0,563000,-563000,-563000
059155,台表科日盛99購01,0,0,0,0,0,0,0,0,0,-574000,0,0,0,450000,1024000,-574000,-574000
060191,亞光元富9A購02  ,0,0,0,0,0,0,0,0,0,-579000,0,0,0,2000,581000,-579000,-579000
056829,台積電富邦9A購01,0,0,0,0,0,0,0,0,0,-580000,0,0,0,0,580000,-580000,-580000
047564,滬深2X國票99購01,0,0,0,0,0,0,0,0,0,-580000,0,0,0,20000,600000,-580000,-580000
1310,台苯            ,83000,577950,-494950,0,0,0,0,0,0,-91000,0,23000,-23000,0,68000,-68000,-585950
058622,國巨國票99購07  ,0,0,0,0,0,0,0,0,0,-589000,0,0,0,20000,609000,-589000,-589000
060434,台汽電永豐9A購01,0,0,0,0,0,0,0,0,0,-593000,0,0,0,10000,603000,-593000,-593000
060560,欣興國泰9C購01  ,0,0,0,0,0,0,0,0,0,-594000,0,0,0,0,594000,-594000,-594000
00708L,元大S&P黃金正2  ,0,95000,-95000,0,0,0,0,0,0,-502000,0,0,0,2772000,3274000,-502000,-597000
056855,祥碩中信98購02  ,0,0,0,0,0,0,0,0,0,-610000,0,0,0,0,610000,-610000,-610000
056664,上証反中信9B購01,0,0,0,0,0,0,0,0,0,-617000,0,0,0,0,617000,-617000,-617000
2385,群光            ,876000,1481387,-605387,0,0,0,7000,3507,3493,-18000,12000,33000,-21000,9000,6000,3000,-619894
2542,興富發          ,57000,569830,-512830,0,0,0,0,5596,-5596,-106000,9000,89000,-80000,0,26000,-26000,-624426
057332,旺宏國票99購03  ,0,0,0,0,0,0,0,0,0,-630000,0,0,0,0,630000,-630000,-630000
059396,T50反1元富99購04,0,0,0,0,0,0,0,0,0,-644000,0,0,0,152000,796000,-644000,-644000
2342,茂矽            ,317000,968000,-651000,0,0,0,0,0,0,0,0,0,0,0,0,0,-651000
056961,凱美永豐98購01  ,0,0,0,0,0,0,0,0,0,-652000,0,0,0,3000,655000,-652000,-652000
1444,力麗            ,54000,709070,-655070,0,0,0,0,0,0,-9000,0,9000,-9000,0,0,0,-664070
053752,超眾永豐96購02  ,0,0,0,0,0,0,0,0,0,-669000,0,0,0,219000,888000,-669000,-669000
3413,京鼎            ,335000,713000,-378000,0,0,0,0,209000,-209000,-82000,7000,17000,-10000,6000,78000,-72000,-669000
050170,臺指反元大97購02,0,0,0,0,0,0,0,0,0,-674000,0,0,0,416000,1090000,-674000,-674000
2105,正新            ,371000,949221,-578221,0,0,0,0,10503,-10503,-88000,11000,105000,-94000,6000,0,6000,-676724
058822,樺漢國泰9B購01  ,0,0,0,0,0,0,0,0,0,-680000,0,0,0,275000,955000,-680000,-680000
1710,東聯            ,207000,807790,-600790,0,0,0,0,0,0,-80000,0,80000,-80000,0,0,0,-680790
058547,世紀鋼富邦9A購01,0,0,0,0,0,0,0,0,0,-683000,0,0,0,280000,963000,-683000,-683000
054693,神基永豐97購01  ,0,0,0,0,0,0,0,0,0,-685000,0,0,0,2000,687000,-685000,-685000
053536,明泰永豐96購01  ,0,0,0,0,0,0,0,0,0,-687000,0,0,0,0,687000,-687000,-687000
1909,榮成            ,433000,799030,-366030,0,0,0,0,0,0,-321000,0,313000,-313000,0,8000,-8000,-687030
2327,國巨            ,1195000,2177760,-982760,0,0,0,252000,1445,250555,16000,217000,98000,119000,115000,218000,-103000,-716205
055037,宏盛富邦99購01  ,0,0,0,0,0,0,0,0,0,-719000,0,0,0,0,719000,-719000,-719000
057202,TPK元富98購02   ,0,0,0,0,0,0,0,0,0,-727000,0,0,0,0,727000,-727000,-727000
2308,台達電          ,1632000,2744720,-1112720,0,0,0,456000,6093,449907,-73000,92000,137000,-45000,3000,31000,-28000,-735813
055657,超眾元富97購02  ,0,0,0,0,0,0,0,0,0,-741000,0,0,0,356000,1097000,-741000,-741000
054244,華新元大96購01  ,0,0,0,0,0,0,0,0,0,-747000,0,0,0,456000,1203000,-747000,-747000
07543P,台積電凱基9A售17,0,0,0,0,0,0,0,0,0,-754000,0,0,0,0,754000,-754000,-754000
03440B,臺股指元大9B熊02,0,0,0,0,0,0,0,0,0,-755000,0,0,0,306000,1061000,-755000,-755000
052602,聯電元大97購01  ,0,0,0,0,0,0,0,0,0,-775000,0,0,0,411000,1186000,-775000,-775000
054819,裕民元大9A購01  ,0,0,0,0,0,0,0,0,0,-800000,0,0,0,21000,821000,-800000,-800000
2481,強茂            ,164000,1010560,-846560,0,0,0,0,0,0,43000,54000,1000,53000,2000,12000,-10000,-803560
1303,南亞            ,1013000,1631397,-618397,0,0,0,60000,15559,44441,-235000,21000,258000,-237000,2000,0,2000,-808956
058100,聯茂國泰99購02  ,0,0,0,0,0,0,0,0,0,-812000,0,0,0,211000,1023000,-812000,-812000
059157,元石油凱基9C購01,0,0,0,0,0,0,0,0,0,-812000,0,0,0,0,812000,-812000,-812000
00646,元大S&P500      ,241000,6000,235000,0,0,0,0,0,0,-1089000,0,0,0,66000,1155000,-1089000,-854000
00850,元大臺灣ESG永續 ,0,0,0,0,0,0,0,0,0,-855000,0,0,0,524000,1379000,-855000,-855000
058013,SP黃豆凱基9A購01,0,0,0,0,0,0,0,0,0,-880000,0,0,0,0,880000,-880000,-880000
3038,全台            ,370000,1201000,-831000,0,0,0,0,0,0,-65000,35000,100000,-65000,0,0,0,-896000
055131,茂林康和97購01  ,0,0,0,0,0,0,0,0,0,-902000,0,0,0,585000,1487000,-902000,-902000
2903,遠百            ,113000,942345,-829345,0,0,0,0,8917,-8917,-64000,0,64000,-64000,0,0,0,-902262
3037,欣興            ,4805000,11393025,-6588025,0,0,0,5439000,3312,5435688,249000,471000,311000,160000,431000,342000,89000,-903337
2504,國產            ,198000,807860,-609860,0,0,0,0,0,0,-304000,0,15000,-15000,0,289000,-289000,-913860
1718,中纖            ,264000,1191530,-927530,0,0,0,0,0,0,-15000,0,15000,-15000,0,0,0,-942530
5876,上海商銀        ,420000,1240650,-820650,0,0,0,0,10438,-10438,-136000,48000,195000,-147000,12000,1000,11000,-967088
07459P,緯穎元大9A售01  ,0,0,0,0,0,0,0,0,0,-972000,0,0,0,85000,1057000,-972000,-972000
053248,智伸科國票97購01,0,0,0,0,0,0,0,0,0,-988000,0,0,0,0,988000,-988000,-988000
059845,欣興富邦9A購02  ,0,0,0,0,0,0,0,0,0,-991000,0,0,0,206000,1197000,-991000,-991000
00671R,富邦NASDAQ反1   ,0,0,0,0,0,0,0,0,0,-999000,0,0,0,136000,1135000,-999000,-999000
00653L,富邦印度正2     ,518000,287000,231000,0,0,0,0,0,0,-1242000,0,0,0,658000,1900000,-1242000,-1011000
059307,T50反1元大99購06,0,0,0,0,0,0,0,0,0,-1029000,0,0,0,814000,1843000,-1029000,-1029000
2614,東森            ,192000,1232000,-1040000,0,0,0,0,0,0,0,0,0,0,0,0,0,-1040000
2478,大毅            ,819000,1689000,-870000,0,0,0,0,0,0,-172000,0,9000,-9000,56000,219000,-163000,-1042000
9958,世紀鋼          ,568000,1344000,-776000,0,0,0,0,2000,-2000,-265000,9000,1000,8000,88000,361000,-273000,-1043000
060429,南六永豐9A購01  ,0,0,0,0,0,0,0,0,0,-1055000,0,0,0,27000,1082000,-1055000,-1055000
03438B,臺股指元大96熊27,0,0,0,0,0,0,0,0,0,-1064000,0,0,0,102000,1166000,-1064000,-1064000
060539,道瓊反凱基9A購01,0,0,0,0,0,0,0,0,0,-1067000,0,0,0,210000,1277000,-1067000,-1067000
1409,新纖            ,88000,1102600,-1014600,0,0,0,0,0,0,-59000,0,59000,-59000,0,0,0,-1073600
051832,復盛元大95購01  ,0,0,0,0,0,0,0,0,0,-1080000,0,0,0,0,1080000,-1080000,-1080000
00648R,元大S&P500反1   ,17000,17000,0,0,0,0,0,0,0,-1094000,0,0,0,207000,1301000,-1094000,-1094000
00701,國泰股利精選30  ,0,67000,-67000,0,0,0,0,0,0,-1039200,0,0,0,374000,1413200,-1039200,-1106200
058736,鈺齊永豐99購02  ,0,0,0,0,0,0,0,0,0,-1112000,0,0,0,0,1112000,-1112000,-1112000
6505,台塑化          ,505000,1356600,-851600,0,0,0,0,17329,-17329,-245000,0,245000,-245000,0,0,0,-1113929
00664R,國泰臺灣加權反1 ,0,0,0,0,0,0,0,0,0,-1143000,3879000,0,3879000,617000,5639000,-5022000,-1143000
2328,廣宇            ,79000,1177000,-1098000,0,0,0,0,0,0,-65000,2000,67000,-65000,0,0,0,-1163000
5871,中租-KY         ,356634,1479330,-1122696,0,0,0,0,3491,-3491,-66000,4000,46000,-42000,22000,46000,-24000,-1192187
3682,亞太電          ,258000,1457300,-1199300,0,0,0,0,0,0,0,0,0,0,0,0,0,-1199300
060201,台表科元富9A購01,0,0,0,0,0,0,0,0,0,-1210000,0,0,0,46000,1256000,-1210000,-1210000
2633,台灣高鐵        ,264000,1375450,-1111450,0,0,0,0,8632,-8632,-90000,10000,103000,-93000,4000,1000,3000,-1210082
2515,中工            ,312000,1535000,-1223000,0,0,0,0,0,0,4000,4000,25000,-21000,46000,21000,25000,-1219000
057730,聯鈞國泰9A購01  ,0,0,0,0,0,0,0,0,0,-1253000,0,0,0,349000,1602000,-1253000,-1253000
00674R,元大S&P黃金反1  ,38000,0,38000,0,0,0,0,0,0,-1297000,0,0,0,4000,1301000,-1297000,-1259000
058137,玉晶光元大99購11,0,0,0,0,0,0,0,0,0,-1274000,0,0,0,20000,1294000,-1274000,-1274000
059560,T50反1凱基99購08,0,0,0,0,0,0,0,0,0,-1289000,0,0,0,234000,1523000,-1289000,-1289000
2301,光寶科          ,466000,1682780,-1216780,0,0,0,0,47424,-47424,-32000,19000,68000,-49000,17000,0,17000,-1296204
059982,聯發科元大99購37,0,0,0,0,0,0,0,0,0,-1298000,0,0,0,0,1298000,-1298000,-1298000
060120,聯電富邦9B購01  ,0,0,0,0,0,0,0,0,0,-1309000,0,0,0,55000,1364000,-1309000,-1309000
1326,台化            ,491000,1759610,-1268610,0,0,0,0,11434,-11434,-123000,6000,137000,-131000,8000,0,8000,-1403044
060407,南六國泰9C購01  ,10000,0,10000,0,0,0,0,0,0,-1435000,0,0,0,210000,1645000,-1435000,-1425000
3711,日月光投控      ,1065000,2560720,-1495720,0,0,0,0,10281,-10281,56000,115000,113000,2000,78000,24000,54000,-1450001
4938,和碩            ,956000,2427112,-1471112,0,0,0,450000,6768,443232,-461000,30000,499000,-469000,11000,3000,8000,-1488880
0056,元大高股息      ,413000,29000,384000,0,0,0,103000,0,103000,-1981000,65000,0,65000,1103000,3149000,-2046000,-1494000
8150,南茂            ,900000,1955565,-1055565,0,0,0,0,4033,-4033,-436000,0,353000,-353000,29000,112000,-83000,-1495598
1102,亞泥            ,358000,1572220,-1214220,0,0,0,0,7919,-7919,-305000,5000,317000,-312000,25000,18000,7000,-1527139
2332,友訊            ,207001,1598000,-1390999,0,0,0,0,0,0,-168000,4000,116000,-112000,143000,199000,-56000,-1558999
4935,茂林-KY         ,564000,644000,-80000,0,0,0,291000,1389000,-1098000,-392000,106000,426000,-320000,18000,90000,-72000,-1570000
00633L,富邦上証正2     ,346000,25000,321000,0,0,0,0,0,0,-1918000,0,206000,-206000,1817000,3529000,-1712000,-1597000
3380,明泰            ,762000,2133515,-1371515,0,0,0,0,0,0,-276000,48000,478000,-430000,154000,0,154000,-1647515
2889,國票金          ,304000,1760450,-1456450,0,0,0,0,13627,-13627,-205000,0,205000,-205000,0,0,0,-1675077
1216,統一            ,1639000,3215770,-1576770,0,0,0,10000,111457,-101457,-169000,49000,218000,-169000,0,0,0,-1847227
1605,華新            ,2542000,5518730,-2976730,0,0,0,1562000,15956,1546044,-436000,46000,749000,-703000,345000,78000,267000,-1866686
059311,元石油元大99購04,0,0,0,0,0,0,0,0,0,-1883000,0,0,0,35000,1918000,-1883000,-1883000
1101,台泥            ,381000,2102280,-1721280,0,0,0,0,9959,-9959,-168000,0,35000,-35000,42000,175000,-133000,-1899239
2841,台開            ,379000,2353000,-1974000,0,0,0,0,0,0,-8000,0,8000,-8000,0,0,0,-1982000
2474,可成            ,1376000,3368370,-1992370,0,0,0,0,2168,-2168,-89000,16000,47000,-31000,8000,66000,-58000,-2083538
2892,第一金          ,3034000,4868000,-1834000,0,0,0,216000,30596,185404,-450000,0,374000,-374000,16000,92000,-76000,-2098596
2887,台新金          ,4405000,6180690,-1775690,0,0,0,0,31104,-31104,-303000,10000,305000,-295000,2000,10000,-8000,-2109794
2375,凱美            ,398000,2726000,-2328000,0,0,0,0,0,0,69000,51000,12000,39000,75000,45000,30000,-2259000
1504,東元            ,346000,2394680,-2048680,0,0,0,0,10284,-10284,-207000,12000,163000,-151000,22000,78000,-56000,-2265964
00676R,富邦臺灣加權反1 ,0,0,0,0,0,0,0,0,0,-2289000,0,0,0,520000,2809000,-2289000,-2289000
2312,金寶            ,384000,2782330,-2398330,0,0,0,0,0,0,65000,0,9000,-9000,78000,4000,74000,-2333330
053564,台積電富邦99購01,0,0,0,0,0,0,0,0,0,-2370000,0,0,0,0,2370000,-2370000,-2370000
2823,中壽            ,1740000,3972000,-2232000,0,0,0,0,12053,-12053,-163000,1000,255000,-254000,117000,26000,91000,-2407053
0050,元大台灣50      ,143000,687000,-544000,0,0,0,106000,0,106000,-1992000,0,670000,-670000,871000,2193000,-1322000,-2430000
2845,遠東銀          ,212000,2440698,-2228698,0,0,0,0,14142,-14142,-234000,0,234000,-234000,0,0,0,-2476840
2344,華邦電          ,3008000,5022050,-2014050,0,0,0,0,11002,-11002,-482000,114000,413000,-299000,27000,210000,-183000,-2507052
059312,元石油元大99購05,0,0,0,0,0,0,0,0,0,-2548000,0,0,0,0,2548000,-2548000,-2548000
2618,長榮航          ,1148000,3043430,-1895430,0,0,0,0,18934,-18934,-677000,97000,774000,-677000,0,0,0,-2591364
00637L,元大滬深300正2  ,435000,3799000,-3364000,0,0,0,0,0,0,731000,0,518000,-518000,13419000,12170000,1249000,-2633000
6116,彩晶            ,1861000,4389920,-2528920,0,0,0,0,23796,-23796,-100000,10000,103000,-93000,116000,123000,-7000,-2652716
053082,聯電元大98購03  ,0,0,0,0,0,0,0,0,0,-2691000,0,0,0,231000,2922000,-2691000,-2691000
2337,旺宏            ,2492000,5269180,-2777180,0,0,0,745000,320404,424596,-363000,0,411000,-411000,267000,219000,48000,-2715584
1301,台塑            ,634000,3372430,-2738430,0,0,0,6000,13365,-7365,-98000,10000,103000,-93000,22000,27000,-5000,-2843795
2002,中鋼            ,1163000,3585560,-2422560,0,0,0,0,37246,-37246,-390000,8000,304000,-296000,6000,100000,-94000,-2849806
2610,華航            ,683000,3314090,-2631090,0,0,0,0,17815,-17815,-263000,0,213000,-213000,63000,113000,-50000,-2911905
1314,中石化          ,708000,3187485,-2479485,0,0,0,0,17838,-17838,-417000,82000,367000,-285000,1000,133000,-132000,-2914323
2812,台中銀          ,233000,2993530,-2760530,0,0,0,0,13460,-13460,-232000,0,232000,-232000,0,0,0,-3005990
057475,聯電元大9A購01  ,0,0,0,0,0,0,0,0,0,-3051000,0,0,0,44000,3095000,-3051000,-3051000
2801,彰銀            ,659000,2167070,-1508070,0,0,0,0,27044,-27044,-1582000,0,364000,-364000,17000,1235000,-1218000,-3117114
059313,元石油元大99購06,0,0,0,0,0,0,0,0,0,-3196000,0,0,0,0,3196000,-3196000,-3196000
2880,華南金          ,978000,3947430,-2969430,0,0,0,0,23359,-23359,-307000,0,321000,-321000,14000,0,14000,-3299789
2313,華通            ,3306000,4021780,-715780,0,0,0,550000,2322430,-1772430,-919000,329000,1116000,-787000,54000,186000,-132000,-3407210
052376,聯詠元大95購04  ,0,0,0,0,0,0,0,0,0,-3494000,0,0,0,0,3494000,-3494000,-3494000
00738U,元大道瓊白銀    ,10000,2346000,-2336000,0,0,0,0,0,0,-1344000,0,0,0,402000,1746000,-1344000,-3680000
00693U,街口S&P黃豆     ,18000,0,18000,0,0,0,0,0,0,-3785000,0,0,0,133000,3918000,-3785000,-3767000
2881,富邦金          ,2229000,5528858,-3299858,0,0,0,0,22635,-22635,-519000,0,370000,-370000,18000,167000,-149000,-3841493
2103,台橡            ,1118000,5185060,-4067060,0,0,0,0,0,0,-34000,0,34000,-34000,0,0,0,-4101060
1402,遠東新          ,2352000,5417300,-3065300,0,0,0,200000,9919,190081,-1951000,83000,2040000,-1957000,8000,2000,6000,-4826219
5880,合庫金          ,545000,5015160,-4470160,0,0,0,0,28537,-28537,-356000,0,304000,-304000,0,52000,-52000,-4854697
2882,國泰金          ,1596000,5869000,-4273000,0,0,0,0,25339,-25339,-905000,0,519000,-519000,0,386000,-386000,-5203339
2408,南亞科          ,2567000,8178600,-5611600,0,0,0,720000,225375,494625,-815000,224000,1010000,-786000,70000,99000,-29000,-5931975
2834,臺企銀          ,3381000,9568600,-6187600,0,0,0,0,22441,-22441,-408000,0,390000,-390000,0,18000,-18000,-6618041
2330,台積電          ,6542100,12194770,-5652670,0,0,0,200000,160576,39424,-1194000,143000,1188000,-1045000,157000,306000,-149000,-6807246
2885,元大金          ,949000,8334842,-7385842,0,0,0,0,28642,-28642,81000,100000,5000,95000,0,14000,-14000,-7333484
2883,開發金          ,3323000,11580670,-8257670,0,0,0,0,43328,-43328,-87000,78000,472000,-394000,427000,120000,307000,-8387998
2886,兆豐金          ,1793000,9780440,-7987440,0,0,0,0,201831,-201831,-538000,2000,531000,-529000,33000,42000,-9000,-8727271
2317,鴻海            ,6427000,14207630,-7780630,0,0,0,0,25375,-25375,-1010000,32000,447000,-415000,106000,701000,-595000,-8816005
2884,玉山金          ,5437000,13550580,-8113580,0,0,0,0,29109,-29109,-682000,78000,703000,-625000,0,57000,-57000,-8824689
00677U,富邦VIX         ,3722000,17799000,-14077000,0,0,0,0,0,0,4921000,2201000,200000,2001000,7010000,4090000,2920000,-9156000
00715L,街口布蘭特油正2 ,29000,122000,-93000,0,0,0,0,0,0,-10490000,0,0,0,772000,11262000,-10490000,-10583000
00669R,國泰美國道瓊反1 ,5000,75000,-70000,0,0,0,0,0,0,-14086000,0,0,0,834000,14920000,-14086000,-14156000
2409,友達            ,6322000,23995865,-17673865,0,0,0,0,3581932,-3581932,-958000,100000,910000,-810000,235000,383000,-148000,-22213797
2888,新光金          ,3424000,28483370,-25059370,0,0,0,0,42314,-42314,2096000,2191000,6000,2185000,602000,691000,-89000,-23005684
3481,群創            ,13177000,45747025,-32570025,0,0,0,0,38283,-38283,507000,824000,1295000,-471000,1279000,301000,978000,-32101308
00632R,元大台灣50反1   ,16000000,502000,15498000,0,0,0,0,0,0,-56978000,8147000,2044000,6103000,1738000,64819000,-63081000,-41480000
00642U,元大S&P石油     ,3702000,1002000,2700000,0,0,0,0,0,0,-56790000,0,0,0,62854000,119644000,-56790000,-54090000
