證券代號,證券名稱,外陸資買進股數(不含外資自營商),外陸資賣出股數(不含外資自營商),外陸資買賣超股數(不含外資自營商),外資自營商買進股數,外資自營商賣出股數,外資自營商買賣超股數,投信買進股數,投信賣出股數,投信買賣超股數,自營商買賣超股數,自營商買進股數(自行買賣),自營商賣出股數(自行買賣),自營商買賣超股數(自行買賣),自營商買進股數(避險),自營商賣出股數(避險),自營商買賣超股數(避險),三大法人買賣超股數
00637L,元大滬深300正2  ,7919000,979000,6940000,0,0,0,0,0,0,8420000,0,0,0,26980000,18560000,8420000,15360000
00861,元大全球未來通訊,4566000,0,4566000,0,0,0,0,0,0,6080000,0,100000,-100000,6596000,416000,6180000,10646000
2303,聯電            ,44446000,38703975,5742025,0,0,0,416000,13000,403000,928000,1654000,3436000,-1782000,3292000,582000,2710000,7073025
053564,台積電富邦99購01,0,10000,-10000,0,0,0,0,0,0,5289000,0,0,0,5289000,0,5289000,5279000
8112,至上            ,8734070,2617000,6117070,0,0,0,0,2000,-2000,-848000,16000,13000,3000,0,851000,-851000,5267070
2330,台積電          ,21588042,16558725,5029317,0,0,0,0,120000,-120000,-387000,172000,406000,-234000,361000,514000,-153000,4522317
00653L,富邦印度正2     ,497000,37000,460000,0,0,0,0,0,0,3575000,0,0,0,3687000,112000,3575000,4035000
0056,元大高股息      ,52000,52000,0,0,0,0,50000,0,50000,3901000,0,0,0,5401000,1500000,3901000,3951000
00633L,富邦上証正2     ,1320000,50000,1270000,0,0,0,0,0,0,2176000,0,0,0,4277000,2101000,2176000,3446000
6239,力成            ,5909000,3419240,2489760,0,0,0,937000,101000,836000,0,73000,150000,-77000,136000,59000,77000,3325760
3481,群創            ,16789000,12300125,4488875,0,0,0,0,0,0,-1465000,6000,804000,-798000,234000,901000,-667000,3023875
8046,南電            ,4248000,4450000,-202000,0,0,0,1976000,0,1976000,652000,590000,215000,375000,451000,174000,277000,2426000
1101,台泥            ,7684000,6611073,1072927,0,0,0,1462000,7000,1455000,-215250,1000,205000,-204000,94000,105250,-11250,2312677
00738U,元大道瓊白銀    ,1031000,32000,999000,0,0,0,0,0,0,1263000,0,0,0,1631000,368000,1263000,2262000
053082,聯電元大98購03  ,0,0,0,0,0,0,0,0,0,2178000,0,0,0,2568000,390000,2178000,2178000
057475,聯電元大9A購01  ,0,0,0,0,0,0,0,0,0,2109000,0,0,0,2414000,305000,2109000,2109000
3049,和鑫            ,2362586,287000,2075586,0,0,0,0,6000,-6000,-47000,0,48000,-48000,1000,0,1000,2022586
2458,義隆            ,2334000,1697620,636380,0,0,0,1268000,314000,954000,409000,268000,104000,164000,305000,60000,245000,1999380
1325,恆大            ,1147000,894000,253000,0,0,0,1722000,0,1722000,0,10000,10000,0,0,0,0,1975000
061132,志超永豐9A購01  ,0,0,0,0,0,0,0,0,0,1902000,0,0,0,1944000,42000,1902000,1902000
2448,晶電            ,6002000,4890000,1112000,0,0,0,928000,713000,215000,538000,822000,122000,700000,12000,174000,-162000,1865000
3026,禾伸堂          ,1262000,600000,662000,0,0,0,1135000,0,1135000,8000,0,26000,-26000,107000,73000,34000,1805000
00673R,元大S&P原油反1  ,1000,1000,0,0,0,0,0,0,0,1518000,0,0,0,2163000,645000,1518000,1518000
00655L,國泰中國A50正2  ,771000,164000,607000,0,0,0,0,0,0,908000,0,0,0,2530000,1622000,908000,1515000
060406,瑞祺國泰9B購01  ,0,0,0,0,0,0,0,0,0,1468000,0,0,0,1629000,161000,1468000,1468000
052602,聯電元大97購01  ,0,0,0,0,0,0,0,0,0,1459000,0,0,0,1821000,362000,1459000,1459000
00636,國泰中國A50     ,960000,0,960000,0,0,0,0,0,0,457000,0,129000,-129000,985000,399000,586000,1417000
07477P,國巨群益9A售04  ,0,0,0,0,0,0,0,0,0,1302000,0,0,0,1309000,7000,1302000,1302000
057721,華擎元富98購02  ,0,0,0,0,0,0,0,0,0,1297000,0,0,0,1556000,259000,1297000,1297000
1304,台聚            ,1283000,431000,852000,0,0,0,454000,2000,452000,-11000,0,11000,-11000,0,0,0,1293000
2382,廣達            ,3000000,1719540,1280460,0,0,0,14000,2000,12000,-4000,97000,45000,52000,10000,66000,-56000,1288460
059114,華新科永豐99購05,0,0,0,0,0,0,0,0,0,1286000,0,0,0,1316000,30000,1286000,1286000
057940,和大國票99購01  ,0,0,0,0,0,0,0,0,0,1220000,0,0,0,1341000,121000,1220000,1220000
2603,長榮            ,4652270,3784210,868060,0,0,0,359000,6000,353000,-9000,103000,113000,-10000,1000,0,1000,1212060
058450,旺宏永豐99購01  ,0,0,0,0,0,0,0,0,0,1193000,0,0,0,1235000,42000,1193000,1193000
2481,強茂            ,964000,2271000,-1307000,0,0,0,2137000,0,2137000,301000,170000,2000,168000,207000,74000,133000,1131000
057707,臺股指群益98購07,0,0,0,0,0,0,0,0,0,1092000,0,0,0,1820000,728000,1092000,1092000
2474,可成            ,1856000,1027400,828600,0,0,0,101000,0,101000,150000,130000,33000,97000,73000,20000,53000,1079600
00852L,國泰美國道瓊正2 ,3211000,1467000,1744000,0,0,0,0,0,0,-671000,0,0,0,5892000,6563000,-671000,1073000
00674R,元大S&P黃金反1  ,0,10000,-10000,0,0,0,0,0,0,1076000,0,0,0,1185000,109000,1076000,1066000
053675,臺股指元富96購02,0,0,0,0,0,0,0,0,0,1050000,0,0,0,1050000,0,1050000,1050000
046340,滬深2X國票96購01,0,0,0,0,0,0,0,0,0,1049000,0,0,0,1100000,51000,1049000,1049000
07459P,緯穎元大9A售01  ,0,0,0,0,0,0,0,0,0,1020000,0,0,0,1217000,197000,1020000,1020000
04875P,台積電中信94售04,0,0,0,0,0,0,0,0,0,998000,0,0,0,998000,0,998000,998000
057628,旺宏永豐98購02  ,0,0,0,0,0,0,0,0,0,990000,0,0,0,1000000,10000,990000,990000
6269,台郡            ,2327000,1225702,1101298,0,0,0,124000,127000,-3000,-111000,12000,152000,-140000,38000,9000,29000,987298
1718,中纖            ,1571000,377000,1194000,0,0,0,0,0,0,-211000,1000,202000,-201000,0,10000,-10000,983000
2377,微星            ,929000,1083810,-154810,0,0,0,971000,1000,970000,165000,94000,38000,56000,173000,64000,109000,980190
055177,宏達電統一99購01,0,0,0,0,0,0,0,0,0,971000,0,0,0,971000,0,971000,971000
07082P,美律元大99售06  ,0,0,0,0,0,0,0,0,0,952000,0,0,0,952000,0,952000,952000
053006,玉晶光永豐96購03,0,0,0,0,0,0,0,0,0,948000,0,0,0,972000,24000,948000,948000
061001,智邦兆豐9B購01  ,0,0,0,0,0,0,0,0,0,934000,0,0,0,1729000,795000,934000,934000
060699,華新科國泰9B購03,0,0,0,0,0,0,0,0,0,933000,0,0,0,954000,21000,933000,933000
051107,鴻海統一95購05  ,0,0,0,0,0,0,0,0,0,931000,0,0,0,931000,0,931000,931000
060547,瑞昱凱基9A購01  ,0,0,0,0,0,0,0,0,0,927000,0,0,0,1061000,134000,927000,927000
3037,欣興            ,6919000,6382000,537000,0,0,0,569000,1000,568000,-181000,213000,208000,5000,39000,225000,-186000,924000
2392,正崴            ,1080000,369000,711000,0,0,0,258000,3000,255000,-48000,0,116000,-116000,68000,0,68000,918000
050416,高股息凱基96購02,0,0,0,0,0,0,0,0,0,905000,0,0,0,905000,0,905000,905000
060376,瑞祺元富9A購01  ,0,0,0,0,0,0,0,0,0,875000,0,0,0,1052000,177000,875000,875000
056136,京鼎元大98購01  ,0,0,0,0,0,0,0,0,0,864000,0,0,0,864000,0,864000,864000
05446P,緯穎元大95售04  ,0,0,0,0,0,0,0,0,0,861000,0,0,0,861000,0,861000,861000
060700,華新科國泰9C購01,0,0,0,0,0,0,0,0,0,825000,0,0,0,916000,91000,825000,825000
3042,晶技            ,3140000,2593000,547000,0,0,0,35000,218000,-183000,458000,588000,132000,456000,85000,83000,2000,822000
052225,台積電凱基96購03,0,0,0,0,0,0,0,0,0,800000,0,0,0,800000,0,800000,800000
1210,大成            ,230000,204190,25810,0,0,0,738000,2000,736000,33000,59000,26000,33000,0,0,0,794810
4142,國光生          ,1552000,799000,753000,0,0,0,0,0,0,40000,40000,0,40000,0,0,0,793000
2345,智邦            ,4646000,4170674,475326,0,0,0,271000,46000,225000,89000,233000,126000,107000,74000,92000,-18000,789326
060667,力成凱基9A購01  ,0,0,0,0,0,0,0,0,0,789000,0,0,0,1111000,322000,789000,789000
051832,復盛元大95購01  ,0,0,0,0,0,0,0,0,0,780000,0,0,0,780000,0,780000,780000
060779,臺股指凱基9A購07,0,0,0,0,0,0,0,0,0,775000,0,0,0,1088000,313000,775000,775000
056189,樺漢統一97購02  ,0,0,0,0,0,0,0,0,0,767000,0,0,0,767000,0,767000,767000
2353,宏碁            ,4056000,3164505,891495,0,0,0,15000,1000,14000,-145000,64000,148000,-84000,60000,121000,-61000,760495
1102,亞泥            ,4326000,4434406,-108406,0,0,0,1190000,105000,1085000,-236000,55000,168000,-113000,1000,124000,-123000,740594
4906,正文            ,1119000,407000,712000,0,0,0,0,0,0,21000,0,15000,-15000,36000,0,36000,733000
3035,智原            ,746000,780000,-34000,0,0,0,220000,0,220000,532000,238000,28000,210000,376000,54000,322000,718000
048422,瑞昱元富96購02  ,0,0,0,0,0,0,0,0,0,705000,0,0,0,768000,63000,705000,705000
058910,泰鼎元大99購03  ,0,0,0,0,0,0,0,0,0,703000,0,0,0,915000,212000,703000,703000
057570,技嘉永豐98購02  ,0,0,0,0,0,0,0,0,0,702000,0,0,0,702000,0,702000,702000
8016,矽創            ,948000,175000,773000,0,0,0,0,0,0,-76000,0,101000,-101000,29000,4000,25000,697000
060196,泰鼎元富9A購01  ,0,0,0,0,0,0,0,0,0,697000,0,0,0,707000,10000,697000,697000
050378,上証2X群益98購02,0,0,0,0,0,0,0,0,0,688000,0,0,0,688000,0,688000,688000
052393,康友群益95購05  ,0,0,0,0,0,0,0,0,0,684000,0,0,0,684000,0,684000,684000
051056,華新科群益95購03,0,0,0,0,0,0,0,0,0,681000,0,0,0,1057000,376000,681000,681000
2421,建準            ,508000,155000,353000,0,0,0,380000,0,380000,-56000,3000,17000,-14000,5000,47000,-42000,677000
047564,滬深2X國票99購01,0,0,0,0,0,0,0,0,0,669000,0,0,0,690000,21000,669000,669000
1902,台紙            ,1426000,760000,666000,0,0,0,0,2000,-2000,0,0,0,0,0,0,0,664000
059298,大立光元富9C購02,0,0,0,0,0,0,0,0,0,663000,0,0,0,673000,10000,663000,663000
061118,GIS富邦9A購01   ,0,0,0,0,0,0,0,0,0,658000,0,0,0,663000,5000,658000,658000
058244,神達元大99購02  ,50000,75000,-25000,0,0,0,0,0,0,676000,0,0,0,837000,161000,676000,651000
058181,華新科國泰9B購01,0,0,0,0,0,0,0,0,0,647000,0,0,0,770000,123000,647000,647000
058234,華新科元大99購12,0,0,0,0,0,0,0,0,0,640000,0,0,0,720000,80000,640000,640000
060237,友達元大9A購06  ,0,0,0,0,0,0,0,0,0,633000,0,0,0,658000,25000,633000,633000
2376,技嘉            ,1714000,585000,1129000,0,0,0,0,440000,-440000,-56000,2000,52000,-50000,79000,85000,-6000,633000
060932,南六永豐9A購02  ,0,0,0,0,0,0,0,0,0,623000,0,0,0,1804000,1181000,623000,623000
054441,力成台新96購01  ,0,0,0,0,0,0,0,0,0,623000,0,0,0,623000,0,623000,623000
00676R,富邦臺灣加權反1 ,0,4000,-4000,0,0,0,0,0,0,626000,0,0,0,2838000,2212000,626000,622000
056497,GIS國泰99購01   ,0,0,0,0,0,0,0,0,0,621000,0,0,0,639000,18000,621000,621000
052085,聯電元大95購01  ,0,0,0,0,0,0,0,0,0,607000,0,0,0,679000,72000,607000,607000
060928,明泰永豐9A購01  ,0,0,0,0,0,0,0,0,0,603000,0,0,0,603000,0,603000,603000
060784,鴻海富邦9C購01  ,0,0,0,0,0,0,0,0,0,600000,0,0,0,812000,212000,600000,600000
056255,華新科元富97購05,0,0,0,0,0,0,0,0,0,600000,0,0,0,614000,14000,600000,600000
055116,康控凱基98購01  ,0,0,0,0,0,0,0,0,0,598000,0,0,0,598000,0,598000,598000
050311,上銀兆豐95購01  ,0,0,0,0,0,0,0,0,0,590000,0,0,0,600000,10000,590000,590000
060568,SP黃豆永豐9A購01,0,0,0,0,0,0,0,0,0,589000,0,0,0,619000,30000,589000,589000
057987,大立光元富98購02,0,0,0,0,0,0,0,0,0,588000,0,0,0,839000,251000,588000,588000
00739,元大MSCI A股    ,240000,0,240000,0,0,0,0,0,0,347000,0,0,0,650000,303000,347000,587000
059313,元石油元大99購06,0,0,0,0,0,0,0,0,0,586000,0,0,0,885000,299000,586000,586000
059370,玉晶光元富99購02,0,0,0,0,0,0,0,0,0,569000,0,0,0,801000,232000,569000,569000
3034,聯詠            ,2705157,2040380,664777,0,0,0,0,28000,-28000,-70000,6000,69000,-63000,14000,21000,-7000,566777
059675,大立光元富99購08,0,0,0,0,0,0,0,0,0,566000,0,0,0,636000,70000,566000,566000
052938,華新科兆豐96購01,0,0,0,0,0,0,0,0,0,563000,0,0,0,623000,60000,563000,563000
060709,緯穎富邦9B購01  ,0,0,0,0,0,0,0,0,0,561000,0,0,0,646000,85000,561000,561000
055433,嘉聯益群益99購01,0,0,0,0,0,0,0,0,0,561000,0,0,0,597000,36000,561000,561000
060548,友達凱基9B購03  ,0,0,0,0,0,0,0,0,0,557000,0,0,0,635000,78000,557000,557000
057808,旺宏元大99購05  ,0,0,0,0,0,0,0,0,0,550000,0,0,0,550000,0,550000,550000
00670L,富邦NASDAQ正2   ,32000,31000,1000,0,0,0,0,0,0,547000,0,0,0,1112000,565000,547000,548000
058055,華擎統一9A購01  ,0,0,0,0,0,0,0,0,0,547000,0,0,0,858000,311000,547000,547000
058994,道瓊指元大99購01,0,0,0,0,0,0,0,0,0,544000,0,0,0,599000,55000,544000,544000
2601,益航            ,979000,404000,575000,0,0,0,0,4000,-4000,-29000,0,29000,-29000,0,0,0,542000
060429,南六永豐9A購01  ,0,0,0,0,0,0,0,0,0,539000,0,0,0,986000,447000,539000,539000
060187,華新科元富9A購02,0,0,0,0,0,0,0,0,0,539000,0,0,0,692000,153000,539000,539000
061214,華擎元大9A購04  ,0,0,0,0,0,0,0,0,0,533000,0,0,0,604000,71000,533000,533000
059295,大立光元富99購05,0,0,0,0,0,0,0,0,0,533000,0,0,0,635000,102000,533000,533000
1301,台塑            ,2948000,2602900,345100,0,0,0,224000,7000,217000,-33000,2000,25000,-23000,5000,15000,-10000,529100
3023,信邦            ,771470,303000,468470,0,0,0,40000,84000,-44000,93000,74000,8000,66000,28000,1000,27000,517470
1907,永豐餘          ,861000,297000,564000,0,0,0,0,9000,-9000,-39000,0,39000,-39000,0,0,0,516000
057972,群創富邦9C購01  ,0,0,0,0,0,0,0,0,0,514000,0,0,0,519000,5000,514000,514000
051845,世紀鋼富邦96購01,0,0,0,0,0,0,0,0,0,507000,0,0,0,507000,0,507000,507000
3006,晶豪科          ,959000,394000,565000,0,0,0,0,0,0,-58000,18000,26000,-8000,6000,56000,-50000,507000
056296,旺宏元大97購07  ,0,0,0,0,0,0,0,0,0,506000,0,0,0,506000,0,506000,506000
057061,華擎國泰9A購01  ,0,0,0,0,0,0,0,0,0,506000,0,0,0,539000,33000,506000,506000
6230,超眾            ,498000,280000,218000,0,0,0,136000,0,136000,151000,2000,0,2000,200000,51000,149000,505000
06025P,臺股指元大99售02,0,0,0,0,0,0,0,0,0,503000,0,0,0,536000,33000,503000,503000
054523,GIS元大96購05   ,0,0,0,0,0,0,0,0,0,500000,0,0,0,600000,100000,500000,500000
055198,奇力新第一97購01,0,0,0,0,0,0,0,0,0,499000,0,0,0,499000,0,499000,499000
049216,華邦電國票95購01,0,0,0,0,0,0,0,0,0,499000,0,0,0,499000,0,499000,499000
049301,致新群益95購01  ,0,0,0,0,0,0,0,0,0,499000,0,0,0,499000,0,499000,499000
05118P,超眾元大96售04  ,5000,0,5000,0,0,0,0,0,0,493000,0,0,0,891000,398000,493000,498000
00647L,元大S&P500正2   ,18000,17000,1000,0,0,0,0,0,0,496000,0,0,0,866000,370000,496000,497000
054805,台苯元大9A購01  ,0,0,0,0,0,0,0,0,0,497000,0,0,0,565000,68000,497000,497000
00762,元大全球AI      ,0,0,0,0,0,0,0,0,0,496000,0,0,0,517000,21000,496000,496000
057508,康控國票99購03  ,0,0,0,0,0,0,0,0,0,495000,0,0,0,643000,148000,495000,495000
2354,鴻準            ,1422216,909639,512577,0,0,0,6000,1000,5000,-25000,14000,39000,-25000,0,0,0,492577
056995,華新科日盛99購01,0,0,0,0,0,0,0,0,0,490000,0,0,0,588000,98000,490000,490000
060398,立積國票9B購01  ,0,0,0,0,0,0,0,0,0,488000,0,0,0,540000,52000,488000,488000
05711P,茂林國票97售03  ,0,0,0,0,0,0,0,0,0,487000,0,0,0,605000,118000,487000,487000
048391,友訊國票94購01  ,0,0,0,0,0,0,0,0,0,485000,0,0,0,485000,0,485000,485000
052221,東元凱基95購01  ,0,0,0,0,0,0,0,0,0,484000,0,0,0,484000,0,484000,484000
058200,世芯康和99購01  ,0,0,0,0,0,0,0,0,0,483000,0,0,0,603000,120000,483000,483000
057008,華新科中信99購02,0,0,0,0,0,0,0,0,0,481000,0,0,0,495000,14000,481000,481000
058245,訊連元大99購01  ,0,0,0,0,0,0,0,0,0,479000,0,0,0,579000,100000,479000,479000
060967,鈺齊凱基9A購02  ,0,0,0,0,0,0,0,0,0,477000,0,0,0,477000,0,477000,477000
056803,群創台新99購02  ,0,0,0,0,0,0,0,0,0,474000,0,0,0,474000,0,474000,474000
052820,宏達電永豐96購01,0,0,0,0,0,0,0,0,0,470000,0,0,0,470000,0,470000,470000
060346,華新科統一01購01,0,0,0,0,0,0,0,0,0,465000,0,0,0,465000,0,465000,465000
056160,智易凱基97購03  ,0,0,0,0,0,0,0,0,0,464000,0,0,0,489000,25000,464000,464000
2369,菱生            ,649000,182000,467000,0,0,0,0,0,0,-9000,1000,10000,-9000,0,0,0,458000
059358,旺宏永豐99購02  ,0,0,0,0,0,0,0,0,0,457000,0,0,0,653000,196000,457000,457000
060188,華新科元富9A購03,0,0,0,0,0,0,0,0,0,456000,0,0,0,472000,16000,456000,456000
058730,玉晶光永豐9A購01,0,0,0,0,0,0,0,0,0,455000,0,0,0,534000,79000,455000,455000
056769,國產元大98購01  ,0,0,0,0,0,0,0,0,0,455000,0,0,0,465000,10000,455000,455000
058831,茂林永豐99購01  ,0,0,0,0,0,0,0,0,0,454000,0,0,0,455000,1000,454000,454000
056939,康控元富98購01  ,0,0,0,0,0,0,0,0,0,454000,0,0,0,552000,98000,454000,454000
060238,強茂元大9C購01  ,0,0,0,0,0,0,0,0,0,451000,0,0,0,575000,124000,451000,451000
056872,旺宏凱基98購08  ,0,0,0,0,0,0,0,0,0,448000,0,0,0,458000,10000,448000,448000
058977,SGBR2X凱基03購01,0,0,0,0,0,0,0,0,0,444000,0,0,0,527000,83000,444000,444000
6257,矽格            ,1015000,405000,610000,0,0,0,0,2000,-2000,-164000,68000,218000,-150000,14000,28000,-14000,444000
060432,達方永豐9A購01  ,0,0,0,0,0,0,0,0,0,443000,0,0,0,449000,6000,443000,443000
056684,旺宏統一98購02  ,0,0,0,0,0,0,0,0,0,441000,0,0,0,441000,0,441000,441000
055343,國巨凱基97購03  ,0,0,0,0,0,0,0,0,0,440000,0,0,0,460000,20000,440000,440000
2340,光磊            ,763000,338000,425000,0,0,0,0,1000,-1000,15000,46000,80000,-34000,78000,29000,49000,439000
05920P,力成元大96售04  ,0,0,0,0,0,0,0,0,0,439000,0,0,0,725000,286000,439000,439000
053041,可成凱基96購02  ,0,0,0,0,0,0,0,0,0,432000,0,0,0,432000,0,432000,432000
058577,南亞科群益99購02,0,0,0,0,0,0,0,0,0,432000,0,0,0,432000,0,432000,432000
060625,華擎元大9A購01  ,0,0,0,0,0,0,0,0,0,431000,0,0,0,431000,0,431000,431000
059101,康控統一9A購01  ,0,0,0,0,0,0,0,0,0,431000,0,0,0,431000,0,431000,431000
00640L,富邦日本正2     ,68000,0,68000,0,0,0,0,0,0,362000,0,0,0,875000,513000,362000,430000
059343,宏達電凱基99購04,0,0,0,0,0,0,0,0,0,430000,0,0,0,490000,60000,430000,430000
057731,華擎國泰9A購02  ,0,0,0,0,0,0,0,0,0,427000,0,0,0,456000,29000,427000,427000
1714,和桐            ,505000,68000,437000,0,0,0,0,0,0,-14000,0,14000,-14000,0,0,0,423000
054744,晶相光凱基99購01,0,0,0,0,0,0,0,0,0,423000,0,0,0,423000,0,423000,423000
048850,聯電群益96購01  ,0,0,0,0,0,0,0,0,0,423000,0,0,0,660000,237000,423000,423000
054304,台積電凱基96購23,0,0,0,0,0,0,0,0,0,422000,0,0,0,452000,30000,422000,422000
054042,華泰元大96購01  ,0,0,0,0,0,0,0,0,0,419000,0,0,0,428000,9000,419000,419000
059629,友達凱基99購06  ,0,0,0,0,0,0,0,0,0,419000,0,0,0,419000,0,419000,419000
2454,聯發科          ,4461196,3790202,670994,0,0,0,0,159000,-159000,-95000,16000,117000,-101000,36000,30000,6000,416994
057730,聯鈞國泰9A購01  ,0,0,0,0,0,0,0,0,0,416000,0,0,0,1098000,682000,416000,416000
060436,巨大永豐9A購01  ,0,0,0,0,0,0,0,0,0,415000,0,0,0,515000,100000,415000,415000
060232,友訊元大9C購01  ,0,0,0,0,0,0,0,0,0,415000,0,0,0,415000,0,415000,415000
060131,GIS永豐99購03   ,0,0,0,0,0,0,0,0,0,407000,0,0,0,429000,22000,407000,407000
054762,奇力新國票99購01,0,0,0,0,0,0,0,0,0,406000,0,0,0,406000,0,406000,406000
050774,健策元大96購02  ,0,0,0,0,0,0,0,0,0,404000,0,0,0,404000,0,404000,404000
060299,友訊國泰9B購01  ,0,0,0,0,0,0,0,0,0,402000,0,0,0,482000,80000,402000,402000
1536,和大            ,705240,328000,377240,0,0,0,3000,0,3000,18000,32000,13000,19000,43000,44000,-1000,398240
058675,康控群益9B購01  ,0,0,0,0,0,0,0,0,0,397000,0,0,0,398000,1000,397000,397000
060390,聯鈞群益9A購01  ,0,0,0,0,0,0,0,0,0,396000,0,0,0,551000,155000,396000,396000
051000,台郡元大96購01  ,0,0,0,0,0,0,0,0,0,396000,0,0,0,396000,0,396000,396000
057214,瑞昱群益98購01  ,0,0,0,0,0,0,0,0,0,394000,0,0,0,399000,5000,394000,394000
061161,南六群益9A購01  ,0,0,0,0,0,0,0,0,0,393000,0,0,0,650000,257000,393000,393000
058990,GIS凱基99購02   ,0,0,0,0,0,0,0,0,0,393000,0,0,0,493000,100000,393000,393000
6504,南六            ,612000,515000,97000,0,0,0,288000,0,288000,8000,62000,22000,40000,32000,64000,-32000,393000
054164,強茂凱基98購01  ,0,0,0,0,0,0,0,0,0,392000,0,0,0,511000,119000,392000,392000
1609,大亞            ,682000,271000,411000,0,0,0,0,0,0,-20000,0,20000,-20000,0,0,0,391000
049219,聯發科國票95購01,0,0,0,0,0,0,0,0,0,390000,0,0,0,390000,0,390000,390000
055233,康友國票98購01  ,0,0,0,0,0,0,0,0,0,390000,0,0,0,390000,0,390000,390000
059676,台積電台新99購05,0,0,0,0,0,0,0,0,0,390000,0,0,0,400000,10000,390000,390000
059869,友達凱基99購07  ,0,0,0,0,0,0,0,0,0,390000,0,0,0,390000,0,390000,390000
058180,華新科國泰9A購01,0,0,0,0,0,0,0,0,0,389000,0,0,0,894000,505000,389000,389000
051816,臺股指凱基95購07,0,0,0,0,0,0,0,0,0,387000,0,0,0,387000,0,387000,387000
056846,晶相光元富98購01,0,0,0,0,0,0,0,0,0,387000,0,0,0,452000,65000,387000,387000
1477,聚陽            ,1146000,438051,707949,0,0,0,0,300000,-300000,-21000,4000,50000,-46000,25000,0,25000,386949
057835,華擎元富9B購01  ,0,0,0,0,0,0,0,0,0,384000,0,0,0,531000,147000,384000,384000
060361,南亞科元富9A購03,0,0,0,0,0,0,0,0,0,379000,0,0,0,387000,8000,379000,379000
006206,元大上證50      ,341000,0,341000,0,0,0,0,0,0,37000,0,0,0,205000,168000,37000,378000
060780,祥碩國泰9B購01  ,0,0,0,0,0,0,0,0,0,377000,0,0,0,580000,203000,377000,377000
060706,群創富邦9A購01  ,0,0,0,0,0,0,0,0,0,375000,0,0,0,375000,0,375000,375000
059816,聯電凱基99購03  ,0,0,0,0,0,0,0,0,0,375000,0,0,0,461000,86000,375000,375000
052237,嘉澤國票96購02  ,0,0,0,0,0,0,0,0,0,371000,0,0,0,501000,130000,371000,371000
06846P,美律元大98售05  ,0,0,0,0,0,0,0,0,0,370000,0,0,0,380000,10000,370000,370000
057044,旺宏元大98購08  ,0,0,0,0,0,0,0,0,0,370000,0,0,0,438000,68000,370000,370000
055340,華新科日盛97購01,0,0,0,0,0,0,0,0,0,368000,0,0,0,398000,30000,368000,368000
052818,智邦永豐96購01  ,0,0,0,0,0,0,0,0,0,364000,0,0,0,420000,56000,364000,364000
060582,玉晶光群益9C購01,0,0,0,0,0,0,0,0,0,362000,0,0,0,366000,4000,362000,362000
07640P,國巨群益9A售07  ,0,0,0,0,0,0,0,0,0,360000,0,0,0,429000,69000,360000,360000
054826,復盛元大9A購01  ,0,0,0,0,0,0,0,0,0,360000,0,0,0,360000,0,360000,360000
055877,奇鋐元富97購01  ,0,0,0,0,0,0,0,0,0,360000,0,0,0,370000,10000,360000,360000
057872,旺宏元大99購06  ,0,0,0,0,0,0,0,0,0,360000,0,0,0,780000,420000,360000,360000
06337P,祥碩元大97售05  ,0,0,0,0,0,0,0,0,0,359000,0,0,0,568000,209000,359000,359000
047673,瑞昱元富96購01  ,0,0,0,0,0,0,0,0,0,357000,0,0,0,396000,39000,357000,357000
058315,TPK富邦9C購01   ,0,0,0,0,0,0,0,0,0,356000,0,0,0,403000,47000,356000,356000
055030,帆宣國泰99購02  ,0,0,0,0,0,0,0,0,0,355000,0,0,0,355000,0,355000,355000
060051,台積電凱基9B購01,0,0,0,0,0,0,0,0,0,353000,0,0,0,1072000,719000,353000,353000
061023,茂林國泰9B購02  ,0,0,0,0,0,0,0,0,0,351000,0,0,0,351000,0,351000,351000
056109,彩晶永豐98購01  ,0,0,0,0,0,0,0,0,0,351000,0,0,0,351000,0,351000,351000
060313,淘帝永豐9A購01  ,0,0,0,0,0,0,0,0,0,350000,0,0,0,355000,5000,350000,350000
057054,立積元大98購03  ,0,0,0,0,0,0,0,0,0,350000,0,0,0,409000,59000,350000,350000
052738,聯電元大98購02  ,0,0,0,0,0,0,0,0,0,349000,0,0,0,385000,36000,349000,349000
059870,全新凱基99購05  ,0,0,0,0,0,0,0,0,0,348000,0,0,0,493000,145000,348000,348000
054221,華新科統一96購05,0,0,0,0,0,0,0,0,0,347000,0,0,0,459000,112000,347000,347000
058955,台積電國票9A購04,0,0,0,0,0,0,0,0,0,346000,0,0,0,527000,181000,346000,346000
1795,美時            ,560176,216000,344176,0,0,0,0,0,0,-1000,0,1000,-1000,0,0,0,343176
052943,奇力新國票96購02,0,0,0,0,0,0,0,0,0,343000,0,0,0,403000,60000,343000,343000
058188,華擎永豐99購01  ,0,0,0,0,0,0,0,0,0,343000,0,0,0,348000,5000,343000,343000
054002,GIS群益96購03   ,0,0,0,0,0,0,0,0,0,342000,0,0,0,416000,74000,342000,342000
061182,南六凱基9A購01  ,1000,0,1000,0,0,0,0,0,0,336000,0,0,0,665000,329000,336000,337000
059288,旺宏元富99購03  ,0,0,0,0,0,0,0,0,0,337000,0,0,0,361000,24000,337000,337000
6288,聯嘉            ,612000,274000,338000,0,0,0,0,0,0,-1000,6000,7000,-1000,0,0,0,337000
057762,全新凱基99購03  ,0,0,0,0,0,0,0,0,0,336000,0,0,0,336000,0,336000,336000
054351,華新科國泰97購03,0,0,0,0,0,0,0,0,0,335000,0,0,0,442000,107000,335000,335000
058559,華新科日盛99購02,0,0,0,0,0,0,0,0,0,335000,0,0,0,404000,69000,335000,335000
059945,嘉澤永豐99購03  ,0,0,0,0,0,0,0,0,0,335000,0,0,0,1004000,669000,335000,335000
055025,華新科國泰98購02,0,0,0,0,0,0,0,0,0,332000,0,0,0,417000,85000,332000,332000
054935,華通元大98購03  ,0,0,0,0,0,0,0,0,0,331000,0,0,0,331000,0,331000,331000
058821,泰鼎國泰9B購01  ,0,0,0,0,0,0,0,0,0,331000,0,0,0,386000,55000,331000,331000
059926,世紀鋼國泰9B購01,0,0,0,0,0,0,0,0,0,331000,0,0,0,336000,5000,331000,331000
060774,南亞科凱基9A購01,0,0,0,0,0,0,0,0,0,330000,0,0,0,339000,9000,330000,330000
059903,S&P正2元大99購02,0,0,0,0,0,0,0,0,0,330000,0,0,0,330000,0,330000,330000
2515,中工            ,1302000,895000,407000,0,0,0,0,0,0,-78000,0,91000,-91000,13000,0,13000,329000
052959,聯電凱基97購01  ,0,0,0,0,0,0,0,0,0,329000,0,0,0,345000,16000,329000,329000
052223,聯電凱基96購02  ,0,0,0,0,0,0,0,0,0,329000,0,0,0,371000,42000,329000,329000
058930,華新科統一9B購01,0,0,0,0,0,0,0,0,0,329000,0,0,0,353000,24000,329000,329000
057289,力成元大98購03  ,0,0,0,0,0,0,0,0,0,328000,0,0,0,428000,100000,328000,328000
060483,友達富邦9A購01  ,0,0,0,0,0,0,0,0,0,325000,0,0,0,517000,192000,325000,325000
056028,GIS群益97購02   ,0,0,0,0,0,0,0,0,0,324000,0,0,0,396000,72000,324000,324000
060711,旺宏永豐9A購01  ,0,0,0,0,0,0,0,0,0,322000,0,0,0,322000,0,322000,322000
060246,晶相光元大9C購03,0,0,0,0,0,0,0,0,0,321000,0,0,0,324000,3000,321000,321000
060360,南亞科元富9A購02,0,0,0,0,0,0,0,0,0,321000,0,0,0,321000,0,321000,321000
060552,群創凱基9B購05  ,0,0,0,0,0,0,0,0,0,321000,0,0,0,489000,168000,321000,321000
2323,中環            ,1676000,1066000,610000,0,0,0,0,0,0,-289000,64000,94000,-30000,2000,261000,-259000,321000
060214,茂林康和9A購01  ,0,0,0,0,0,0,0,0,0,321000,0,0,0,344000,23000,321000,321000
2609,陽明            ,384000,65000,319000,0,0,0,0,0,0,0,0,0,0,0,0,0,319000
060628,和大富邦9B購01  ,0,0,0,0,0,0,0,0,0,318000,0,0,0,398000,80000,318000,318000
051505,台積電元富95購05,0,0,0,0,0,0,0,0,0,318000,0,0,0,318000,0,318000,318000
060687,GIS元大9A購01   ,0,0,0,0,0,0,0,0,0,315000,0,0,0,331000,16000,315000,315000
058752,鈺齊凱基9A購01  ,0,0,0,0,0,0,0,0,0,315000,0,0,0,319000,4000,315000,315000
9914,美利達          ,587000,321000,266000,0,0,0,193000,138000,55000,-6000,1000,7000,-6000,0,0,0,315000
059918,華新科元大99購20,0,0,0,0,0,0,0,0,0,315000,0,0,0,335000,20000,315000,315000
059100,元油2X統一9C購02,0,0,0,0,0,0,0,0,0,311000,0,0,0,1087000,776000,311000,311000
05590P,臺股指中信96售05,0,0,0,0,0,0,0,0,0,310000,0,0,0,310000,0,310000,310000
056245,嘉澤群益97購01  ,0,0,0,0,0,0,0,0,0,310000,0,0,0,693000,383000,310000,310000
057729,華新科國泰99購04,0,0,0,0,0,0,0,0,0,309000,0,0,0,322000,13000,309000,309000
053516,茂林群益96購05  ,0,0,0,0,0,0,0,0,0,309000,0,0,0,384000,75000,309000,309000
056138,群創元大9B購01  ,0,0,0,0,0,0,0,0,0,308000,0,0,0,308000,0,308000,308000
060020,康控康和99購01  ,0,0,0,0,0,0,0,0,0,308000,0,0,0,395000,87000,308000,308000
060303,宏達電富邦9B購01,0,0,0,0,0,0,0,0,0,307000,0,0,0,369000,62000,307000,307000
057202,TPK元富98購02   ,0,0,0,0,0,0,0,0,0,307000,0,0,0,317000,10000,307000,307000
061057,華新科國票9A購04,0,0,0,0,0,0,0,0,0,305000,0,0,0,305000,0,305000,305000
057817,景碩元大98購01  ,0,0,0,0,0,0,0,0,0,305000,0,0,0,356000,51000,305000,305000
051404,牧德永豐96購01  ,0,0,0,0,0,0,0,0,0,305000,0,0,0,313000,8000,305000,305000
059730,晶相光元大9C購02,0,0,0,0,0,0,0,0,0,304000,0,0,0,307000,3000,304000,304000
060505,友達元大9C購05  ,0,0,0,0,0,0,0,0,0,302000,0,0,0,424000,122000,302000,302000
060435,鈺齊永豐9A購01  ,0,0,0,0,0,0,0,0,0,302000,0,0,0,327000,25000,302000,302000
054558,劍麟群益99購01  ,0,0,0,0,0,0,0,0,0,302000,0,0,0,306000,4000,302000,302000
059289,瑞昱元富99購01  ,0,0,0,0,0,0,0,0,0,302000,0,0,0,322000,20000,302000,302000
060966,台表科凱基9B購01,0,0,0,0,0,0,0,0,0,301000,0,0,0,311000,10000,301000,301000
059740,瑞昱元富99購02  ,0,0,0,0,0,0,0,0,0,301000,0,0,0,313000,12000,301000,301000
044201,群創國票95購01  ,0,0,0,0,0,0,0,0,0,300000,0,0,0,300000,0,300000,300000
048705,GIS國票95購01   ,0,0,0,0,0,0,0,0,0,300000,0,0,0,300000,0,300000,300000
057387,奇力新永豐98購03,0,0,0,0,0,0,0,0,0,300000,0,0,0,300000,0,300000,300000
055945,上証2X元大97購04,0,0,0,0,0,0,0,0,0,300000,0,0,0,300000,0,300000,300000
058514,潤泰全元大99購01,0,0,0,0,0,0,0,0,0,300000,0,0,0,300000,0,300000,300000
059834,友達國泰9B購01  ,0,0,0,0,0,0,0,0,0,299000,0,0,0,350000,51000,299000,299000
07015P,國巨元大99售13  ,0,0,0,0,0,0,0,0,0,297000,0,0,0,307000,10000,297000,297000
006205,富邦上証        ,554000,0,554000,0,0,0,0,0,0,-257000,0,1000,-1000,939000,1195000,-256000,297000
054716,緯穎康和97購01  ,0,0,0,0,0,0,0,0,0,297000,0,0,0,521000,224000,297000,297000
057446,旺宏元富02購01  ,0,0,0,0,0,0,0,0,0,297000,0,0,0,297000,0,297000,297000
057717,友訊元富98購02  ,0,0,0,0,0,0,0,0,0,293000,0,0,0,394000,101000,293000,293000
056549,嘉聯益凱基98購04,0,0,0,0,0,0,0,0,0,292000,0,0,0,292000,0,292000,292000
060800,華新科第一9A購01,0,0,0,0,0,0,0,0,0,291000,0,0,0,291000,0,291000,291000
6669,緯穎            ,677000,484222,192778,0,0,0,82000,94000,-12000,110000,65000,8000,57000,56000,3000,53000,290778
06338P,亞德客統一97售02,0,0,0,0,0,0,0,0,0,290000,0,0,0,300000,10000,290000,290000
051654,致新永豐95購01  ,0,0,0,0,0,0,0,0,0,290000,0,0,0,290000,0,290000,290000
051380,禾伸堂群益95購01,0,0,0,0,0,0,0,0,0,290000,0,0,0,290000,0,290000,290000
060635,義隆永豐9A購01  ,0,0,0,0,0,0,0,0,0,289000,0,0,0,351000,62000,289000,289000
056422,全新統一98購02  ,0,0,0,0,0,0,0,0,0,289000,0,0,0,289000,0,289000,289000
051406,泰鼎永豐96購01  ,0,0,0,0,0,0,0,0,0,288000,0,0,0,323000,35000,288000,288000
3596,智易            ,982835,924000,58835,0,0,0,189000,1000,188000,40000,9000,52000,-43000,134000,51000,83000,286835
060761,南亞科元大9A購05,0,0,0,0,0,0,0,0,0,286000,0,0,0,317000,31000,286000,286000
057278,可成元大98購06  ,0,0,0,0,0,0,0,0,0,286000,0,0,0,350000,64000,286000,286000
2605,新興            ,800000,639000,161000,0,0,0,0,1000,-1000,126000,100000,0,100000,26000,0,26000,286000
05348P,美律元富98售01  ,0,0,0,0,0,0,0,0,0,285000,0,0,0,691000,406000,285000,285000
055575,華新科統一98購01,0,0,0,0,0,0,0,0,0,285000,0,0,0,285000,0,285000,285000
1313,聯成            ,589717,298000,291717,0,0,0,0,2000,-2000,-5000,0,5000,-5000,0,0,0,284717
057249,華邦電統一9A購01,0,0,0,0,0,0,0,0,0,284000,0,0,0,446000,162000,284000,284000
058225,旺宏元富99購01  ,0,0,0,0,0,0,0,0,0,284000,0,0,0,287000,3000,284000,284000
07423P,大立光元大99售33,0,0,0,0,0,0,0,0,0,283000,0,0,0,290000,7000,283000,283000
060898,世芯凱基9A購03  ,0,0,0,0,0,0,0,0,0,283000,0,0,0,333000,50000,283000,283000
058283,世紀鋼中信99購01,0,0,0,0,0,0,0,0,0,281000,0,0,0,431000,150000,281000,281000
5521,工信            ,364000,84000,280000,0,0,0,0,0,0,0,0,0,0,0,0,0,280000
058820,致茂國泰9B購01  ,0,0,0,0,0,0,0,0,0,279000,0,0,0,296000,17000,279000,279000
059338,滬深2X凱基9C購02,0,0,0,0,0,0,0,0,0,277000,0,0,0,451000,174000,277000,277000
2823,中壽            ,3779000,3498540,280460,0,0,0,0,4000,-4000,-1000,60000,146000,-86000,201000,116000,85000,275460
052742,可成元大96購01  ,0,0,0,0,0,0,0,0,0,275000,0,0,0,280000,5000,275000,275000
059290,全新元富99購01  ,0,0,0,0,0,0,0,0,0,275000,0,0,0,375000,100000,275000,275000
07580P,緯穎元大9A售03  ,0,0,0,0,0,0,0,0,0,274000,0,0,0,325000,51000,274000,274000
056177,嘉澤元富97購01  ,0,0,0,0,0,0,0,0,0,273000,0,0,0,446000,173000,273000,273000
057103,禾伸堂中信9A購01,0,0,0,0,0,0,0,0,0,272000,0,0,0,533000,261000,272000,272000
053494,南亞科兆豐96購02,0,0,0,0,0,0,0,0,0,271000,0,0,0,271000,0,271000,271000
053036,聯電凱基98購01  ,0,0,0,0,0,0,0,0,0,270000,0,0,0,300000,30000,270000,270000
056241,緯創群益97購01  ,0,0,0,0,0,0,0,0,0,270000,0,0,0,270000,0,270000,270000
061025,創意富邦9B購01  ,0,0,0,0,0,0,0,0,0,269000,0,0,0,384000,115000,269000,269000
061204,國巨元大9A購16  ,0,0,0,0,0,0,0,0,0,269000,0,0,0,340000,71000,269000,269000
061183,友達國泰9B購02  ,0,0,0,0,0,0,0,0,0,268000,0,0,0,268000,0,268000,268000
053745,康友國票97購01  ,0,0,0,0,0,0,0,0,0,268000,0,0,0,328000,60000,268000,268000
058093,神達元大9A購01  ,0,0,0,0,0,0,0,0,0,268000,0,0,0,268000,0,268000,268000
00631L,元大台灣50正2   ,710000,483000,227000,0,0,0,0,0,0,40000,0,0,0,6569000,6529000,40000,267000
056670,樺漢國票99購01  ,0,0,0,0,0,0,0,0,0,267000,0,0,0,268000,1000,267000,267000
060911,大毅元大9A購01  ,0,0,0,0,0,0,0,0,0,266000,0,0,0,282000,16000,266000,266000
055536,嘉聯益群益99購02,0,0,0,0,0,0,0,0,0,266000,0,0,0,464000,198000,266000,266000
060320,元金2X群益02購01,0,0,0,0,0,0,0,0,0,265000,0,0,0,341000,76000,265000,265000
059187,國巨富邦9B購02  ,0,0,0,0,0,0,0,0,0,265000,0,0,0,310000,45000,265000,265000
057201,華擎元富98購01  ,0,0,0,0,0,0,0,0,0,265000,0,0,0,296000,31000,265000,265000
1308,亞聚            ,668000,404498,263502,0,0,0,0,0,0,0,0,0,0,0,0,0,263502
057605,旺宏統一99購03  ,0,0,0,0,0,0,0,0,0,262000,0,0,0,264000,2000,262000,262000
5305,敦南            ,367000,104000,263000,0,0,0,0,0,0,-2000,0,2000,-2000,0,0,0,261000
07638P,長榮航國票9A售01,0,0,0,0,0,0,0,0,0,259000,0,0,0,293000,34000,259000,259000
060616,宏碁元大9A購02  ,0,0,0,0,0,0,0,0,0,259000,0,0,0,440000,181000,259000,259000
057820,華擎元大98購02  ,0,0,0,0,0,0,0,0,0,259000,0,0,0,508000,249000,259000,259000
9919,康那香          ,865000,606000,259000,0,0,0,0,0,0,0,0,0,0,0,0,0,259000
051086,鴻海元大96購04  ,0,0,0,0,0,0,0,0,0,258000,0,0,0,258000,0,258000,258000
058721,立積元富9C購01  ,0,0,0,0,0,0,0,0,0,257000,0,0,0,558000,301000,257000,257000
058153,景碩統一9B購01  ,0,0,0,0,0,0,0,0,0,256000,0,0,0,278000,22000,256000,256000
060189,宏達電元富9B購03,0,0,0,0,0,0,0,0,0,255000,0,0,0,255000,0,255000,255000
054244,華新元大96購01  ,0,0,0,0,0,0,0,0,0,254000,0,0,0,322000,68000,254000,254000
059852,康控永豐99購02  ,0,0,0,0,0,0,0,0,0,254000,0,0,0,302000,48000,254000,254000
07574P,國巨元大9A售12  ,0,0,0,0,0,0,0,0,0,253000,0,0,0,274000,21000,253000,253000
060193,群創元富9A購01  ,0,0,0,0,0,0,0,0,0,253000,0,0,0,255000,2000,253000,253000
053973,晶豪科元大96購01,0,0,0,0,0,0,0,0,0,251000,0,0,0,254000,3000,251000,251000
059879,GIS凱基99購03   ,0,0,0,0,0,0,0,0,0,251000,0,0,0,407000,156000,251000,251000
059350,樺漢凱基9A購01  ,0,0,0,0,0,0,0,0,0,251000,0,0,0,325000,74000,251000,251000
07354P,臺股指國票99售22,0,0,0,0,0,0,0,0,0,250000,0,0,0,270000,20000,250000,250000
057187,群創元大9B購04  ,0,0,0,0,0,0,0,0,0,250000,0,0,0,300000,50000,250000,250000
059680,台積電國泰9A購03,0,0,0,0,0,0,0,0,0,250000,0,0,0,670000,420000,250000,250000
9938,百和            ,395000,315000,80000,0,0,0,216000,0,216000,-47000,14000,77000,-63000,16000,0,16000,249000
059166,友達凱基99購05  ,0,0,0,0,0,0,0,0,0,248000,0,0,0,474000,226000,248000,248000
056167,力成台新97購01  ,0,0,0,0,0,0,0,0,0,247000,0,0,0,267000,20000,247000,247000
1720,生達            ,334000,114000,220000,0,0,0,0,0,0,26000,70000,44000,26000,0,0,0,246000
048460,盛群凱基94購01  ,0,0,0,0,0,0,0,0,0,246000,0,0,0,246000,0,246000,246000
058686,祥碩凱基99購03  ,0,0,0,0,0,0,0,0,0,246000,0,0,0,257000,11000,246000,246000
056314,力成元大97購01  ,0,0,0,0,0,0,0,0,0,246000,0,0,0,689000,443000,246000,246000
052362,瑞昱國票96購02  ,0,0,0,0,0,0,0,0,0,244000,0,0,0,244000,0,244000,244000
060183,南亞科元富9A購01,0,0,0,0,0,0,0,0,0,244000,0,0,0,315000,71000,244000,244000
6558,興能高          ,294000,123000,171000,0,0,0,73000,0,73000,0,1000,1000,0,0,0,0,244000
057733,嘉聯益國泰99購01,0,0,0,0,0,0,0,0,0,243000,0,0,0,243000,0,243000,243000
055732,全新元富9A購01  ,0,0,0,0,0,0,0,0,0,243000,0,0,0,243000,0,243000,243000
059952,旺宏康和99購01  ,0,0,0,0,0,0,0,0,0,242000,0,0,0,252000,10000,242000,242000
059820,南亞科凱基99購07,0,0,0,0,0,0,0,0,0,242000,0,0,0,249000,7000,242000,242000
052452,茂林元大95購03  ,0,0,0,0,0,0,0,0,0,241000,0,0,0,241000,0,241000,241000
058170,國巨凱基9A購06  ,0,0,0,0,0,0,0,0,0,241000,0,0,0,347000,106000,241000,241000
059683,康控富邦9C購01  ,0,0,0,0,0,0,0,0,0,241000,0,0,0,246000,5000,241000,241000
2723,美食-KY         ,513000,276000,237000,0,0,0,0,0,0,4000,0,8000,-8000,13000,1000,12000,241000
07386P,臺股指群益99售24,0,0,0,0,0,0,0,0,0,240000,0,0,0,248000,8000,240000,240000
00830,國泰費城半導體  ,0,1000,-1000,0,0,0,0,0,0,241000,0,24000,-24000,382000,117000,265000,240000
050853,南電國票96購01  ,0,0,0,0,0,0,0,0,0,240000,0,0,0,240000,0,240000,240000
057251,泰鼎統一98購02  ,0,0,0,0,0,0,0,0,0,240000,0,0,0,255000,15000,240000,240000
059286,S&P正2元富01購03,0,0,0,0,0,0,0,0,0,240000,0,0,0,349000,109000,240000,240000
052227,瑞昱凱基95購05  ,0,0,0,0,0,0,0,0,0,239000,0,0,0,342000,103000,239000,239000
055403,泰鼎元富97購01  ,0,0,0,0,0,0,0,0,0,239000,0,0,0,359000,120000,239000,239000
5269,祥碩            ,527000,290773,236227,0,0,0,0,24000,-24000,24000,28000,6000,22000,6000,4000,2000,236227
057692,臺股指凱基98購10,0,0,0,0,0,0,0,0,0,235000,0,0,0,235000,0,235000,235000
060157,致茂永豐9A購02  ,0,0,0,0,0,0,0,0,0,235000,0,0,0,258000,23000,235000,235000
053631,欣興兆豐97購01  ,0,0,0,0,0,0,0,0,0,234000,0,0,0,369000,135000,234000,234000
061069,嘉聯益凱基9A購01,0,0,0,0,0,0,0,0,0,233000,0,0,0,233000,0,233000,233000
058026,上銀富邦9A購01  ,0,0,0,0,0,0,0,0,0,233000,0,0,0,251000,18000,233000,233000
058854,樺漢群益9B購01  ,0,0,0,0,0,0,0,0,0,233000,0,0,0,237000,4000,233000,233000
052088,漢唐元大95購02  ,0,0,0,0,0,0,0,0,0,232000,0,0,0,232000,0,232000,232000
060634,矽創富邦9B購01  ,0,0,0,0,0,0,0,0,0,231000,0,0,0,653000,422000,231000,231000
054771,茂林國票98購02  ,0,0,0,0,0,0,0,0,0,230000,0,0,0,240000,10000,230000,230000
07173P,臺股指國票99售10,0,0,0,0,0,0,0,0,0,229000,0,0,0,449000,220000,229000,229000
053441,旺宏凱基98購01  ,0,0,0,0,0,0,0,0,0,229000,0,0,0,229000,0,229000,229000
054076,義隆第一96購01  ,0,0,0,0,0,0,0,0,0,229000,0,0,0,423000,194000,229000,229000
07592P,台灣50元大9A售17,0,0,0,0,0,0,0,0,0,228000,0,0,0,228000,0,228000,228000
058963,華新科兆豐99購05,0,0,0,0,0,0,0,0,0,228000,0,0,0,261000,33000,228000,228000
1303,南亞            ,3074000,2890410,183590,0,0,0,109000,6000,103000,-59000,13000,37000,-24000,0,35000,-35000,227590
060561,台積電富邦04購01,0,0,0,0,0,0,0,0,0,227000,0,0,0,620000,393000,227000,227000
060715,日電貿永豐9A購01,0,0,0,0,0,0,0,0,0,227000,0,0,0,227000,0,227000,227000
059311,元石油元大99購04,0,0,0,0,0,0,0,0,0,227000,0,0,0,523000,296000,227000,227000
054109,南亞科凱基96購05,0,0,0,0,0,0,0,0,0,225000,0,0,0,225000,0,225000,225000
058670,鴻海群益9A購03  ,0,0,0,0,0,0,0,0,0,225000,0,0,0,225000,0,225000,225000
059473,T50反1群益99購03,0,0,0,0,0,0,0,0,0,225000,0,0,0,225000,0,225000,225000
054874,帆宣群益99購02  ,0,0,0,0,0,0,0,0,0,224000,0,0,0,254000,30000,224000,224000
060245,聯陽元大9C購01  ,0,0,0,0,0,0,0,0,0,223000,0,0,0,284000,61000,223000,223000
060488,台灣50群益9C購01,0,0,0,0,0,0,0,0,0,223000,0,0,0,260000,37000,223000,223000
059761,國巨永豐99購06  ,0,0,0,0,0,0,0,0,0,223000,0,0,0,223000,0,223000,223000
056961,凱美永豐98購01  ,0,0,0,0,0,0,0,0,0,223000,0,0,0,223000,0,223000,223000
054540,泰鼎國票99購01  ,0,0,0,0,0,0,0,0,0,221000,0,0,0,221000,0,221000,221000
058241,景碩元大99購05  ,0,0,0,0,0,0,0,0,0,221000,0,0,0,342000,121000,221000,221000
056183,南亞科統一97購02,0,0,0,0,0,0,0,0,0,221000,0,0,0,256000,35000,221000,221000
056075,瀚宇博元大97購03,0,0,0,0,0,0,0,0,0,220000,0,0,0,268000,48000,220000,220000
6224,聚鼎            ,374000,151000,223000,0,0,0,0,0,0,-3000,0,3000,-3000,0,0,0,220000
060553,祥碩凱基9A購01  ,0,0,0,0,0,0,0,0,0,219000,0,0,0,353000,134000,219000,219000
07635P,世芯永豐9A售05  ,0,0,0,0,0,0,0,0,0,219000,0,0,0,330000,111000,219000,219000
057397,茂林中信9A購01  ,0,0,0,0,0,0,0,0,0,219000,0,0,0,249000,30000,219000,219000
057609,友訊元富98購01  ,0,0,0,0,0,0,0,0,0,219000,0,0,0,394000,175000,219000,219000
055301,台虹元大97購01  ,0,0,0,0,0,0,0,0,0,218000,0,0,0,218000,0,218000,218000
058397,大成鋼元大99購02,0,0,0,0,0,0,0,0,0,217000,0,0,0,218000,1000,217000,217000
052542,友達元富98購01  ,0,0,0,0,0,0,0,0,0,216000,0,0,0,333000,117000,216000,216000
059274,國巨元大99購22  ,0,0,0,0,0,0,0,0,0,216000,0,0,0,413000,197000,216000,216000
1604,聲寶            ,292000,75000,217000,0,0,0,0,2000,-2000,0,0,0,0,0,0,0,215000
07172P,臺股指國票99售09,0,0,0,0,0,0,0,0,0,214000,0,0,0,402000,188000,214000,214000
060782,道瓊指富邦9C購01,0,0,0,0,0,0,0,0,0,213000,0,0,0,213000,0,213000,213000
052432,康友永豐95購04  ,0,0,0,0,0,0,0,0,0,213000,0,0,0,213000,0,213000,213000
059995,南亞科元富99購01,0,0,0,0,0,0,0,0,0,213000,0,0,0,215000,2000,213000,213000
056674,華邦電元富98購01,0,0,0,0,0,0,0,0,0,213000,0,0,0,213000,0,213000,213000
06465P,國巨統一98售04  ,0,0,0,0,0,0,0,0,0,212000,0,0,0,212000,0,212000,212000
053018,旺宏元富96購02  ,0,0,0,0,0,0,0,0,0,212000,0,0,0,212000,0,212000,212000
057071,華擎永豐98購02  ,0,0,0,0,0,0,0,0,0,212000,0,0,0,519000,307000,212000,212000
058691,友訊國票9A購01  ,0,0,0,0,0,0,0,0,0,211000,0,0,0,247000,36000,211000,211000
058068,旺宏凱基98購11  ,0,0,0,0,0,0,0,0,0,211000,0,0,0,251000,40000,211000,211000
057613,瑞昱元富02購02  ,0,0,0,0,0,0,0,0,0,211000,0,0,0,211000,0,211000,211000
061076,台達電兆豐9A購01,0,0,0,0,0,0,0,0,0,210000,0,0,0,260000,50000,210000,210000
052897,緯創群益96購03  ,0,0,0,0,0,0,0,0,0,210000,0,0,0,210000,0,210000,210000
4942,嘉彰            ,235000,23000,212000,0,0,0,0,2000,-2000,0,0,0,0,0,0,0,210000
050686,欣興兆豐96購01  ,0,0,0,0,0,0,0,0,0,209000,0,0,0,209000,0,209000,209000
045600,道瓊指國票95購01,0,0,0,0,0,0,0,0,0,209000,0,0,0,209000,0,209000,209000
2301,光寶科          ,3461000,3539200,-78200,0,0,0,348000,1000,347000,-60000,70000,83000,-13000,11000,58000,-47000,208800
046942,友達元大99購01  ,0,0,0,0,0,0,0,0,0,208000,0,0,0,330000,122000,208000,208000
058136,景碩元大99購02  ,0,0,0,0,0,0,0,0,0,208000,0,0,0,210000,2000,208000,208000
058622,國巨國票99購07  ,0,0,0,0,0,0,0,0,0,207000,0,0,0,238000,31000,207000,207000
058385,創意中信99購01  ,0,0,0,0,0,0,0,0,0,206000,0,0,0,320000,114000,206000,206000
057612,瑞昱元富02購01  ,0,0,0,0,0,0,0,0,0,206000,0,0,0,206000,0,206000,206000
059297,大立光元富9C購01,0,0,0,0,0,0,0,0,0,206000,0,0,0,211000,5000,206000,206000
060471,台勝科元大9B購01,0,0,0,0,0,0,0,0,0,205000,0,0,0,236000,31000,205000,205000
060982,旺宏元大9A購09  ,0,0,0,0,0,0,0,0,0,205000,0,0,0,243000,38000,205000,205000
057659,台表科兆豐98購01,0,0,0,0,0,0,0,0,0,205000,0,0,0,225000,20000,205000,205000
061205,旺宏元大9A購11  ,0,0,0,0,0,0,0,0,0,204000,0,0,0,247000,43000,204000,204000
056026,智易群益97購01  ,0,0,0,0,0,0,0,0,0,204000,0,0,0,236000,32000,204000,204000
058797,大毅元大99購03  ,0,0,0,0,0,0,0,0,0,204000,0,0,0,220000,16000,204000,204000
1707,葡萄王          ,344785,135000,209785,0,0,0,0,0,0,-6000,0,6000,-6000,0,0,0,203785
056689,玉晶光統一9A購03,0,0,0,0,0,0,0,0,0,203000,0,0,0,206000,3000,203000,203000
057001,華邦電國票99購02,0,0,0,0,0,0,0,0,0,203000,0,0,0,203000,0,203000,203000
03810P,大立光富邦98售01,0,0,0,0,0,0,0,0,0,202000,0,0,0,202000,0,202000,202000
06836P,玉晶光國票99售06,0,0,0,0,0,0,0,0,0,201000,0,0,0,257000,56000,201000,201000
057107,華新科群益98購06,0,0,0,0,0,0,0,0,0,201000,0,0,0,201000,0,201000,201000
056403,茂林群益98購01  ,0,0,0,0,0,0,0,0,0,201000,0,0,0,283000,82000,201000,201000
059706,嘉晶凱基99購01  ,0,0,0,0,0,0,0,0,0,201000,0,0,0,312000,111000,201000,201000
060467,神基元大9A購01  ,0,0,0,0,0,0,0,0,0,200000,0,0,0,200000,0,200000,200000
045872,元油2X元富98購03,200000,0,200000,0,0,0,0,0,0,0,0,0,0,0,0,0,200000
048380,T50反1國票94購02,0,0,0,0,0,0,0,0,0,200000,0,0,0,200000,0,200000,200000
051048,臺指反群益96購01,0,0,0,0,0,0,0,0,0,200000,0,0,0,200000,0,200000,200000
053167,欣興群益96購03  ,0,0,0,0,0,0,0,0,0,200000,0,0,0,200000,0,200000,200000
055416,欣興富邦98購01  ,0,0,0,0,0,0,0,0,0,200000,0,0,0,200000,0,200000,200000
055010,佐登元富97購01  ,0,0,0,0,0,0,0,0,0,200000,0,0,0,200000,0,200000,200000
061129,文曄永豐9A購01  ,0,0,0,0,0,0,0,0,0,199000,0,0,0,225000,26000,199000,199000
058844,元油2X群益9C購03,0,0,0,0,0,0,0,0,0,198000,0,0,0,198000,0,198000,198000
059180,祥碩元富9A購01  ,0,0,0,0,0,0,0,0,0,198000,0,0,0,288000,90000,198000,198000
060698,旺宏國泰9C購01  ,0,0,0,0,0,0,0,0,0,197000,0,0,0,739000,542000,197000,197000
059241,旺宏凱基99購07  ,0,0,0,0,0,0,0,0,0,196000,0,0,0,297000,101000,196000,196000
060155,友訊永豐9A購01  ,0,0,0,0,0,0,0,0,0,196000,0,0,0,271000,75000,196000,196000
07358P,鴻海元大99售39  ,0,0,0,0,0,0,0,0,0,195000,0,0,0,245000,50000,195000,195000
057567,嘉聯益富邦9A購01,0,0,0,0,0,0,0,0,0,195000,0,0,0,217000,22000,195000,195000
058267,奇鋐永豐99購01  ,0,0,0,0,0,0,0,0,0,195000,0,0,0,235000,40000,195000,195000
054617,超眾永豐97購01  ,0,0,0,0,0,0,0,0,0,194000,0,0,0,195000,1000,194000,194000
055393,華新科統一97購03,0,0,0,0,0,0,0,0,0,194000,0,0,0,194000,0,194000,194000
058345,台光電群益99購03,0,0,0,0,0,0,0,0,0,194000,0,0,0,194000,0,194000,194000
057533,晶相光元大98購02,0,0,0,0,0,0,0,0,0,193000,0,0,0,196000,3000,193000,193000
059953,聯發科康和99購01,0,0,0,0,0,0,0,0,0,193000,0,0,0,205000,12000,193000,193000
059914,台積電元大99購47,0,0,0,0,0,0,0,0,0,192000,0,0,0,509000,317000,192000,192000
053347,茂林國票98購01  ,0,0,0,0,0,0,0,0,0,191000,0,0,0,249000,58000,191000,191000
058363,全新凱基9A購02  ,0,0,0,0,0,0,0,0,0,190000,0,0,0,192000,2000,190000,190000
00737,國泰AI+Robo     ,0,0,0,0,0,0,0,0,0,190000,0,0,0,327000,137000,190000,190000
00686R,群益臺灣加權反1 ,0,0,0,0,0,0,0,0,0,190000,0,0,0,563000,373000,190000,190000
059872,華新科凱基01購01,0,0,0,0,0,0,0,0,0,190000,0,0,0,530000,340000,190000,190000
059882,臺股指凱基9C購06,0,0,0,0,0,0,0,0,0,190000,0,0,0,465000,275000,190000,190000
054090,瑞昱群益97購01  ,0,0,0,0,0,0,0,0,0,189000,0,0,0,206000,17000,189000,189000
056358,友訊元大99購01  ,0,0,0,0,0,0,0,0,0,189000,0,0,0,189000,0,189000,189000
05500P,臺股指中信96售04,0,0,0,0,0,0,0,0,0,189000,0,0,0,331000,142000,189000,189000
059256,臺股指凱基99購34,0,0,0,0,0,0,0,0,0,189000,0,0,0,290000,101000,189000,189000
07622P,華新科統一9B售02,0,0,0,0,0,0,0,0,0,188000,0,0,0,200000,12000,188000,188000
060766,世芯元大9A購02  ,0,0,0,0,0,0,0,0,0,188000,0,0,0,280000,92000,188000,188000
06385P,聯發科永豐97售02,0,0,0,0,0,0,0,0,0,188000,0,0,0,200000,12000,188000,188000
055295,瀚宇博元大97購02,0,0,0,0,0,0,0,0,0,188000,0,0,0,202000,14000,188000,188000
058312,大毅國泰9B購01  ,0,0,0,0,0,0,0,0,0,188000,0,0,0,344000,156000,188000,188000
058580,華新科群益99購02,0,0,0,0,0,0,0,0,0,186000,0,0,0,196000,10000,186000,186000
060775,世芯凱基9A購02  ,0,0,0,0,0,0,0,0,0,185000,0,0,0,342000,157000,185000,185000
060422,台勝科永豐9A購01,0,0,0,0,0,0,0,0,0,185000,0,0,0,222000,37000,185000,185000
056320,京鼎群益99購01  ,0,0,0,0,0,0,0,0,0,185000,0,0,0,185000,0,185000,185000
054863,億光群益97購01  ,0,0,0,0,0,0,0,0,0,185000,0,0,0,289000,104000,185000,185000
054151,瑞昱國泰97購01  ,0,0,0,0,0,0,0,0,0,185000,0,0,0,185000,0,185000,185000
058182,日電貿國泰9A購01,0,0,0,0,0,0,0,0,0,185000,0,0,0,185000,0,185000,185000
059695,聯鈞永豐99購02  ,0,0,0,0,0,0,0,0,0,185000,0,0,0,457000,272000,185000,185000
059565,國巨凱基99購16  ,0,0,0,0,0,0,0,0,0,185000,0,0,0,185000,0,185000,185000
061236,台積電元大9A購24,0,0,0,0,0,0,0,0,0,184000,0,0,0,275000,91000,184000,184000
060984,南亞科元大9A購07,0,0,0,0,0,0,0,0,0,184000,0,0,0,185000,1000,184000,184000
060981,旺宏元大9A購08  ,0,0,0,0,0,0,0,0,0,184000,0,0,0,273000,89000,184000,184000
055257,景碩統一97購01  ,0,0,0,0,0,0,0,0,0,184000,0,0,0,209000,25000,184000,184000
060235,瑞昱元大9A購01  ,0,0,0,0,0,0,0,0,0,183000,0,0,0,189000,6000,183000,183000
053536,明泰永豐96購01  ,0,0,0,0,0,0,0,0,0,183000,0,0,0,203000,20000,183000,183000
057377,康控元大99購02  ,0,0,0,0,0,0,0,0,0,183000,0,0,0,384000,201000,183000,183000
055566,台表科凱基97購03,0,0,0,0,0,0,0,0,0,182000,0,0,0,217000,35000,182000,182000
057206,立積元富98購01  ,0,0,0,0,0,0,0,0,0,182000,0,0,0,334000,152000,182000,182000
060008,華邦電群益9A購01,0,0,0,0,0,0,0,0,0,182000,0,0,0,312000,130000,182000,182000
056770,國產元大98購02  ,0,0,0,0,0,0,0,0,0,182000,0,0,0,182000,0,182000,182000
055334,禾伸堂兆豐97購01,0,0,0,0,0,0,0,0,0,181000,0,0,0,183000,2000,181000,181000
056850,彩晶元富99購01  ,0,0,0,0,0,0,0,0,0,181000,0,0,0,186000,5000,181000,181000
057053,立積元大98購02  ,0,0,0,0,0,0,0,0,0,181000,0,0,0,195000,14000,181000,181000
059438,群創元大99購06  ,0,0,0,0,0,0,0,0,0,181000,0,0,0,389000,208000,181000,181000
060477,和潤元大9A購01  ,0,0,0,0,0,0,0,0,0,180000,0,0,0,236000,56000,180000,180000
055093,京鼎群益98購01  ,0,0,0,0,0,0,0,0,0,180000,0,0,0,180000,0,180000,180000
055397,超眾統一97購02  ,0,0,0,0,0,0,0,0,0,180000,0,0,0,357000,177000,180000,180000
048876,牧德國票95購02  ,0,0,0,0,0,0,0,0,0,180000,0,0,0,180000,0,180000,180000
050559,聯發科統一94購10,0,0,0,0,0,0,0,0,0,180000,0,0,0,180000,0,180000,180000
056838,旺宏元富98購01  ,0,0,0,0,0,0,0,0,0,180000,0,0,0,200000,20000,180000,180000
3533,嘉澤            ,337000,380000,-43000,0,0,0,114000,0,114000,109000,85000,9000,76000,55000,22000,33000,180000
058243,華擎元大99購01  ,0,0,0,0,0,0,0,0,0,178000,0,0,0,417000,239000,178000,178000
056406,建準國票99購01  ,0,0,0,0,0,0,0,0,0,178000,0,0,0,246000,68000,178000,178000
056589,康控統一98購01  ,0,0,0,0,0,0,0,0,0,178000,0,0,0,428000,250000,178000,178000
057265,聯詠兆豐98購01  ,0,0,0,0,0,0,0,0,0,178000,0,0,0,178000,0,178000,178000
04391P,玉晶光凱基95售03,0,0,0,0,0,0,0,0,0,177000,0,0,0,177000,0,177000,177000
055525,國巨群益98購05  ,0,0,0,0,0,0,0,0,0,177000,0,0,0,182000,5000,177000,177000
3036,文曄            ,374000,183000,191000,0,0,0,0,3000,-3000,-11000,2000,10000,-8000,28000,31000,-3000,177000
060717,康控永豐9A購01  ,0,0,0,0,0,0,0,0,0,176000,0,0,0,176000,0,176000,176000
060824,旺宏元大9A購06  ,0,0,0,0,0,0,0,0,0,176000,0,0,0,250000,74000,176000,176000
060918,康友國泰9C購01  ,0,0,0,0,0,0,0,0,0,176000,0,0,0,461000,285000,176000,176000
059863,和大凱基99購01  ,0,0,0,0,0,0,0,0,0,176000,0,0,0,176000,0,176000,176000
058282,聯茂中信99購01  ,0,0,0,0,0,0,0,0,0,175000,0,0,0,235000,60000,175000,175000
060317,台灣50群益02購01,0,0,0,0,0,0,0,0,0,174000,0,0,0,181000,7000,174000,174000
060301,國巨富邦9C購02  ,0,0,0,0,0,0,0,0,0,173000,0,0,0,180000,7000,173000,173000
053584,友達元大9B購02  ,0,0,0,0,0,0,0,0,0,173000,0,0,0,174000,1000,173000,173000
056496,康控國泰99購01  ,0,0,0,0,0,0,0,0,0,173000,0,0,0,184000,11000,173000,173000
058549,藍天永豐99購01  ,0,0,0,0,0,0,0,0,0,173000,0,0,0,176000,3000,173000,173000
056178,嘉澤元富97購02  ,0,0,0,0,0,0,0,0,0,173000,0,0,0,183000,10000,173000,173000
05583P,訊芯凱基96售01  ,0,0,0,0,0,0,0,0,0,173000,0,0,0,203000,30000,173000,173000
059771,台積電群益99購11,0,0,0,0,0,0,0,0,0,173000,0,0,0,293000,120000,173000,173000
060283,台肥元大9C購01  ,0,0,0,0,0,0,0,0,0,171000,0,0,0,171000,0,171000,171000
056351,鴻海元大98購06  ,0,0,0,0,0,0,0,0,0,171000,0,0,0,212000,41000,171000,171000
054745,智易凱基97購01  ,0,0,0,0,0,0,0,0,0,171000,0,0,0,338000,167000,171000,171000
056784,南亞科群益98購01,0,0,0,0,0,0,0,0,0,171000,0,0,0,182000,11000,171000,171000
055488,華邦電元大98購01,0,0,0,0,0,0,0,0,0,170000,0,0,0,170000,0,170000,170000
053621,臺股指群益96購07,0,0,0,0,0,0,0,0,0,170000,0,0,0,208000,38000,170000,170000
046869,聯發科統一95購01,0,0,0,0,0,0,0,0,0,170000,0,0,0,170000,0,170000,170000
051801,牧德永豐95購04  ,0,0,0,0,0,0,0,0,0,170000,0,0,0,190000,20000,170000,170000
060172,智原台新9A購01  ,0,0,0,0,0,0,0,0,0,170000,0,0,0,920000,750000,170000,170000
059016,晶相光元富99購03,0,0,0,0,0,0,0,0,0,170000,0,0,0,262000,92000,170000,170000
055193,世芯元富97購02  ,0,0,0,0,0,0,0,0,0,169000,0,0,0,170000,1000,169000,169000
058748,景碩凱基9A購01  ,0,0,0,0,0,0,0,0,0,169000,0,0,0,286000,117000,169000,169000
055060,聯陽永豐97購01  ,0,0,0,0,0,0,0,0,0,168000,0,0,0,220000,52000,168000,168000
058702,國巨元大99購16  ,0,0,0,0,0,0,0,0,0,168000,0,0,0,215000,47000,168000,168000
055288,日電貿元大97購02,0,0,0,0,0,0,0,0,0,167000,0,0,0,167000,0,167000,167000
057837,康控國泰99購02  ,0,0,0,0,0,0,0,0,0,167000,0,0,0,167000,0,167000,167000
058841,深中小群益01購01,0,0,0,0,0,0,0,0,0,167000,0,0,0,618000,451000,167000,167000
057141,嘉聯益兆豐99購01,0,0,0,0,0,0,0,0,0,167000,0,0,0,195000,28000,167000,167000
054970,帆宣元大97購01  ,0,0,0,0,0,0,0,0,0,166000,0,0,0,166000,0,166000,166000
053364,友達國泰98購01  ,0,0,0,0,0,0,0,0,0,166000,0,0,0,166000,0,166000,166000
057130,全新凱基98購03  ,0,0,0,0,0,0,0,0,0,166000,0,0,0,166000,0,166000,166000
060125,強茂永豐99購01  ,0,0,0,0,0,0,0,0,0,166000,0,0,0,181000,15000,166000,166000
055900,瀚宇博中信97購01,0,0,0,0,0,0,0,0,0,166000,0,0,0,166000,0,166000,166000
050547,華新科凱基95購01,0,0,0,0,0,0,0,0,0,165000,0,0,0,191000,26000,165000,165000
055639,上銀元富97購02  ,0,0,0,0,0,0,0,0,0,165000,0,0,0,232000,67000,165000,165000
052305,GIS永豐95購03   ,0,0,0,0,0,0,0,0,0,164000,0,0,0,169000,5000,164000,164000
060097,華新科元大99購23,0,0,0,0,0,0,0,0,0,164000,0,0,0,266000,102000,164000,164000
060160,聯陽永豐9A購01  ,0,0,0,0,0,0,0,0,0,164000,0,0,0,221000,57000,164000,164000
060236,精元元大9C購01  ,0,0,0,0,0,0,0,0,0,163000,0,0,0,346000,183000,163000,163000
060760,南亞科元大9A購04,0,0,0,0,0,0,0,0,0,163000,0,0,0,163000,0,163000,163000
060670,臺指反元大01購03,0,0,0,0,0,0,0,0,0,163000,0,0,0,192000,29000,163000,163000
059980,台積電元大99購50,0,0,0,0,0,0,0,0,0,163000,0,0,0,172000,9000,163000,163000
059729,群創元大9C購05  ,0,0,0,0,0,0,0,0,0,163000,0,0,0,426000,263000,163000,163000
058923,華新科元富99購06,0,0,0,0,0,0,0,0,0,163000,0,0,0,186000,23000,163000,163000
050725,光磊國票96購01  ,0,0,0,0,0,0,0,0,0,162000,0,0,0,162000,0,162000,162000
057701,嘉聯益群益98購02,0,0,0,0,0,0,0,0,0,162000,0,0,0,168000,6000,162000,162000
060052,宏碁凱基99購01  ,0,0,0,0,0,0,0,0,0,162000,0,0,0,181000,19000,162000,162000
060564,南亞科富邦9C購01,0,0,0,0,0,0,0,0,0,161000,0,0,0,170000,9000,161000,161000
060991,京鼎元大9A購01  ,0,0,0,0,0,0,0,0,0,161000,0,0,0,502000,341000,161000,161000
1217,愛之味          ,234000,73000,161000,0,0,0,0,0,0,0,0,0,0,0,0,0,161000
060633,玉晶光富邦02購01,0,0,0,0,0,0,0,0,0,160000,0,0,0,162000,2000,160000,160000
05492P,聯茂元大95售02  ,0,0,0,0,0,0,0,0,0,160000,0,0,0,160000,0,160000,160000
058992,上証反元大99購02,0,0,0,0,0,0,0,0,0,160000,0,0,0,160000,0,160000,160000
056535,全新凱基99購02  ,0,0,0,0,0,0,0,0,0,160000,0,0,0,210000,50000,160000,160000
059517,茂林永豐99購02  ,0,0,0,0,0,0,0,0,0,160000,0,0,0,160000,0,160000,160000
056304,創意元大97購03  ,0,0,0,0,0,0,0,0,0,159000,0,0,0,159000,0,159000,159000
060060,台積電兆豐99購05,0,0,0,0,0,0,0,0,0,159000,0,0,0,222000,63000,159000,159000
057390,台表科永豐98購01,0,0,0,0,0,0,0,0,0,159000,0,0,0,199000,40000,159000,159000
058135,景碩元大99購01  ,0,0,0,0,0,0,0,0,0,158000,0,0,0,160000,2000,158000,158000
2614,東森            ,510000,352000,158000,0,0,0,0,0,0,0,0,0,0,0,0,0,158000
060869,超眾永豐9A購02  ,0,0,0,0,0,0,0,0,0,157000,0,0,0,162000,5000,157000,157000
061187,瀚宇博國泰9C購01,0,0,0,0,0,0,0,0,0,157000,0,0,0,183000,26000,157000,157000
07366P,國巨康和99售02  ,0,0,0,0,0,0,0,0,0,157000,0,0,0,768000,611000,157000,157000
07256P,臺股指凱基99售36,0,0,0,0,0,0,0,0,0,157000,0,0,0,492000,335000,157000,157000
056715,瀚宇博永豐98購01,0,0,0,0,0,0,0,0,0,157000,0,0,0,195000,38000,157000,157000
060998,華通兆豐9A購01  ,0,0,0,0,0,0,0,0,0,156000,0,0,0,170000,14000,156000,156000
055175,建準統一97購01  ,0,0,0,0,0,0,0,0,0,156000,0,0,0,156000,0,156000,156000
059006,樺漢元大99購01  ,0,0,0,0,0,0,0,0,0,156000,0,0,0,176000,20000,156000,156000
3705,永信            ,178000,19000,159000,0,0,0,0,0,0,-3000,0,3000,-3000,0,0,0,156000
2104,國際中橡        ,780639,601000,179639,0,0,0,0,0,0,-24000,0,34000,-34000,10000,0,10000,155639
07561P,玉晶光永豐9A售02,0,0,0,0,0,0,0,0,0,155000,0,0,0,185000,30000,155000,155000
052376,聯詠元大95購04  ,0,0,0,0,0,0,0,0,0,155000,0,0,0,155000,0,155000,155000
057649,嘉聯益元大99購04,0,0,0,0,0,0,0,0,0,155000,0,0,0,155000,0,155000,155000
059864,亞德客凱基99購01,0,0,0,0,0,0,0,0,0,155000,0,0,0,185000,30000,155000,155000
1904,正隆            ,1392000,920000,472000,0,0,0,0,303000,-303000,-15000,0,30000,-30000,15000,0,15000,154000
061206,旺宏元大9A購12  ,0,0,0,0,0,0,0,0,0,154000,0,0,0,179000,25000,154000,154000
060776,世芯凱基9B購01  ,0,0,0,0,0,0,0,0,0,154000,0,0,0,196000,42000,154000,154000
049700,瀚宇博元大97購01,0,0,0,0,0,0,0,0,0,154000,0,0,0,173000,19000,154000,154000
059871,義隆凱基99購03  ,0,0,0,0,0,0,0,0,0,154000,0,0,0,384000,230000,154000,154000
057743,華擎永豐98購03  ,0,0,0,0,0,0,0,0,0,153000,0,0,0,184000,31000,153000,153000
053854,聯茂國泰97購02  ,0,0,0,0,0,0,0,0,0,153000,0,0,0,200000,47000,153000,153000
055813,聯發科國票98購04,0,0,0,0,0,0,0,0,0,153000,0,0,0,167000,14000,153000,153000
060234,凱美元大9C購01  ,0,0,0,0,0,0,0,0,0,152000,0,0,0,153000,1000,152000,152000
061140,華擎統一9C購01  ,0,0,0,0,0,0,0,0,0,152000,0,0,0,173000,21000,152000,152000
055698,茂林國票98購03  ,0,0,0,0,0,0,0,0,0,152000,0,0,0,152000,0,152000,152000
059213,國巨元大99購19  ,0,0,0,0,0,0,0,0,0,152000,0,0,0,222000,70000,152000,152000
056495,泰鼎國泰99購01  ,0,0,0,0,0,0,0,0,0,152000,0,0,0,152000,0,152000,152000
6213,聯茂            ,800000,932519,-132519,0,0,0,70000,0,70000,214000,257000,99000,158000,72000,16000,56000,151481
060683,泰鼎元大9A購02  ,0,0,0,0,0,0,0,0,0,151000,0,0,0,169000,18000,151000,151000
060300,佐登國泰9B購01  ,0,0,0,0,0,0,0,0,0,151000,0,0,0,151000,0,151000,151000
049775,旺宏統一95購02  ,0,0,0,0,0,0,0,0,0,151000,0,0,0,151000,0,151000,151000
056812,泰鼎統一98購01  ,0,0,0,0,0,0,0,0,0,151000,0,0,0,291000,140000,151000,151000
060123,光罩永豐99購02  ,0,0,0,0,0,0,0,0,0,151000,0,0,0,151000,0,151000,151000
060638,玉晶光永豐9A購04,0,0,0,0,0,0,0,0,0,150000,0,0,0,157000,7000,150000,150000
060604,宏達電凱基9B購01,0,0,0,0,0,0,0,0,0,150000,0,0,0,150000,0,150000,150000
048726,儒鴻麥證95購01  ,0,0,0,150000,0,150000,0,0,0,150000,0,0,0,150000,0,150000,150000
052094,瀚宇博元大96購02,0,0,0,0,0,0,0,0,0,150000,0,0,0,150000,0,150000,150000
051236,鴻海元大96購05  ,0,0,0,0,0,0,0,0,0,150000,0,0,0,150000,0,150000,150000
058664,百和兆豐99購01  ,0,0,0,0,0,0,0,0,0,150000,0,0,0,151000,1000,150000,150000
055044,信錦永豐97購01  ,0,0,0,0,0,0,0,0,0,150000,0,0,0,180000,30000,150000,150000
057176,全新元大99購02  ,0,0,0,0,0,0,0,0,0,150000,0,0,0,150000,0,150000,150000
057195,南茂元大98購01  ,0,0,0,0,0,0,0,0,0,150000,0,0,0,402000,252000,150000,150000
057137,鈺齊凱基98購01  ,0,0,0,0,0,0,0,0,0,150000,0,0,0,150000,0,150000,150000
056748,T50反1兆豐99購01,0,0,0,0,0,0,0,0,0,150000,0,0,0,150000,0,150000,150000
060759,南亞科元大9A購03,0,0,0,0,0,0,0,0,0,149000,0,0,0,199000,50000,149000,149000
060704,台積電富邦01購01,0,0,0,0,0,0,0,0,0,149000,0,0,0,149000,0,149000,149000
07368P,國巨凱基99售19  ,0,0,0,0,0,0,0,0,0,149000,0,0,0,500000,351000,149000,149000
051647,華新科永豐95購02,0,0,0,0,0,0,0,0,0,149000,0,0,0,149000,0,149000,149000
058984,全新凱基9A購03  ,0,0,0,0,0,0,0,0,0,149000,0,0,0,249000,100000,149000,149000
060578,臺股指中信9C購03,0,0,0,0,0,0,0,0,0,148000,0,0,0,501000,353000,148000,148000
050675,奇鋐富邦96購01  ,0,0,0,0,0,0,0,0,0,148000,0,0,0,148000,0,148000,148000
046630,京元電元富95購03,0,0,0,0,0,0,0,0,0,148000,0,0,0,157000,9000,148000,148000
057930,旺宏群益99購04  ,0,0,0,0,0,0,0,0,0,148000,0,0,0,207000,59000,148000,148000
061081,宏碁兆豐9A購01  ,0,0,0,0,0,0,0,0,0,147000,0,0,0,352000,205000,147000,147000
061213,群創元大9A購05  ,0,0,0,0,0,0,0,0,0,147000,0,0,0,147000,0,147000,147000
061002,瑞昱兆豐9B購01  ,0,0,0,0,0,0,0,0,0,147000,0,0,0,251000,104000,147000,147000
060154,堤維西永豐9A購01,0,0,0,0,0,0,0,0,0,147000,0,0,0,147000,0,147000,147000
061121,智邦永豐9A購02  ,0,0,0,0,0,0,0,0,0,146000,0,0,0,212000,66000,146000,146000
060629,鴻海富邦9B購01  ,0,0,0,0,0,0,0,0,0,146000,0,0,0,146000,0,146000,146000
052575,茂林凱基96購04  ,0,0,0,0,0,0,0,0,0,146000,0,0,0,186000,40000,146000,146000
055216,友達凱基98購05  ,0,0,0,0,0,0,0,0,0,146000,0,0,0,146000,0,146000,146000
059819,台積電凱基99購17,0,0,0,0,0,0,0,0,0,146000,0,0,0,196000,50000,146000,146000
059260,國巨中信99購05  ,0,0,0,0,0,0,0,0,0,146000,0,0,0,157000,11000,146000,146000
061125,億光永豐9A購01  ,0,0,0,0,0,0,0,0,0,145000,0,0,0,145000,0,145000,145000
07260P,台灣50元大9A售01,0,0,0,0,0,0,0,0,0,145000,0,0,0,157000,12000,145000,145000
06928P,鴻海元大99售10  ,0,0,0,0,0,0,0,0,0,145000,0,0,0,160000,15000,145000,145000
1709,和益            ,176000,31000,145000,0,0,0,0,0,0,0,0,0,0,0,0,0,145000
051428,玉晶光統一96購01,0,0,0,0,0,0,0,0,0,145000,0,0,0,146000,1000,145000,145000
057389,玉晶光永豐98購06,0,0,0,0,0,0,0,0,0,145000,0,0,0,180000,35000,145000,145000
058582,禾伸堂群益99購02,0,0,0,0,0,0,0,0,0,145000,0,0,0,326000,181000,145000,145000
3338,泰碩            ,547000,566000,-19000,0,0,0,30000,0,30000,134000,64000,33000,31000,148000,45000,103000,145000
060511,群創元大9B購08  ,0,0,0,0,0,0,0,0,0,144000,0,0,0,254000,110000,144000,144000
2939,凱羿-KY         ,178000,28000,150000,0,0,0,0,0,0,-6000,0,6000,-6000,0,0,0,144000
060665,康控凱基9A購01  ,0,0,0,0,0,0,0,0,0,143000,0,0,0,218000,75000,143000,143000
06617P,智邦元大98售03  ,0,0,0,0,0,0,0,0,0,143000,0,0,0,215000,72000,143000,143000
049252,國巨元大96購01  ,0,0,0,0,0,0,0,0,0,143000,0,0,0,147000,4000,143000,143000
053849,聯發科元富96購04,0,0,0,0,0,0,0,0,0,143000,0,0,0,225000,82000,143000,143000
057906,福懋科中信99購01,0,0,0,0,0,0,0,0,0,143000,0,0,0,143000,0,143000,143000
058480,新日興凱基9A購01,0,0,0,0,0,0,0,0,0,143000,0,0,0,143000,0,143000,143000
059570,全新凱基99購04  ,0,0,0,0,0,0,0,0,0,143000,0,0,0,279000,136000,143000,143000
059917,華新科元大99購19,0,0,0,0,0,0,0,0,0,143000,0,0,0,260000,117000,143000,143000
060583,南亞科元富9A購05,0,0,0,0,0,0,0,0,0,142000,0,0,0,142000,0,142000,142000
056849,瀚宇博元富98購01,0,0,0,0,0,0,0,0,0,142000,0,0,0,152000,10000,142000,142000
059198,華新科永豐99購06,0,0,0,0,0,0,0,0,0,142000,0,0,0,192000,50000,142000,142000
059628,智邦凱基99購04  ,25000,0,25000,0,0,0,0,0,0,117000,0,0,0,260000,143000,117000,142000
2453,凌群            ,171000,22000,149000,0,0,0,0,0,0,-8000,0,8000,-8000,0,0,0,141000
053571,奇鋐統一96購02  ,0,0,0,0,0,0,0,0,0,141000,0,0,0,166000,25000,141000,141000
054873,帆宣群益99購01  ,0,0,0,0,0,0,0,0,0,141000,0,0,0,141000,0,141000,141000
060027,元金2X永豐99購02,0,0,0,0,0,0,0,0,0,141000,0,0,0,202000,61000,141000,141000
056548,瀚宇博凱基98購02,0,0,0,0,0,0,0,0,0,141000,0,0,0,151000,10000,141000,141000
060404,台勝科國泰9B購01,0,0,0,0,0,0,0,0,0,140000,0,0,0,175000,35000,140000,140000
059008,鈺齊元大99購03  ,0,0,0,0,0,0,0,0,0,140000,0,0,0,173000,33000,140000,140000
056920,友達兆豐98購02  ,0,0,0,0,0,0,0,0,0,140000,0,0,0,140000,0,140000,140000
060211,智邦康和9A購01  ,0,0,0,0,0,0,0,0,0,140000,0,0,0,233000,93000,140000,140000
057199,台達電元富02購01,0,0,0,0,0,0,0,0,0,140000,0,0,0,398000,258000,140000,140000
060641,聯鈞永豐9A購01  ,0,0,0,0,0,0,0,0,0,139000,0,0,0,164000,25000,139000,139000
060906,旺宏元大9A購07  ,0,0,0,0,0,0,0,0,0,139000,0,0,0,177000,38000,139000,139000
06900P,FBVIX國票12售01 ,0,0,0,0,0,0,0,0,0,139000,0,0,0,154000,15000,139000,139000
053403,彩晶群益98購01  ,0,0,0,0,0,0,0,0,0,139000,0,0,0,150000,11000,139000,139000
060544,國巨凱基9B購03  ,0,0,0,0,0,0,0,0,0,138000,0,0,0,139000,1000,138000,138000
060681,華擎元大9A購02  ,0,0,0,0,0,0,0,0,0,138000,0,0,0,179000,41000,138000,138000
058348,台表科群益99購01,0,0,0,0,0,0,0,0,0,138000,0,0,0,223000,85000,138000,138000
055053,瑞昱永豐97購01  ,0,0,0,0,0,0,0,0,0,138000,0,0,0,138000,0,138000,138000
055240,京元電元富97購01,0,0,0,0,0,0,0,0,0,138000,0,0,0,139000,1000,138000,138000
051251,信邦元大95購01  ,0,0,0,0,0,0,0,0,0,138000,0,0,0,215000,77000,138000,138000
057457,華邦電富邦98購01,0,0,0,0,0,0,0,0,0,138000,0,0,0,138000,0,138000,138000
058995,台達電元大99購01,0,0,0,0,0,0,0,0,0,138000,0,0,0,139000,1000,138000,138000
058257,聯陽國泰9B購01  ,0,0,0,0,0,0,0,0,0,138000,0,0,0,138000,0,138000,138000
057056,立積元大99購02  ,0,0,0,0,0,0,0,0,0,138000,0,0,0,138000,0,138000,138000
056509,晶相光永豐98購01,0,0,0,0,0,0,0,0,0,138000,0,0,0,138000,0,138000,138000
3062,建漢            ,459000,321000,138000,0,0,0,0,0,0,0,0,0,0,0,0,0,138000
07715P,台灣50群益9A售14,0,0,0,0,0,0,0,0,0,137000,0,0,0,257000,120000,137000,137000
04706P,力山元大95售01  ,0,0,0,0,0,0,0,0,0,137000,0,0,0,225000,88000,137000,137000
9945,潤泰新          ,809000,692775,116225,0,0,0,4000,1000,3000,17000,40000,23000,17000,0,0,0,136225
060720,嘉聯益永豐9A購02,0,0,0,0,0,0,0,0,0,136000,0,0,0,136000,0,136000,136000
060732,玉晶光群益9C購02,0,0,0,0,0,0,0,0,0,136000,0,0,0,216000,80000,136000,136000
051944,智邦統一95購02  ,0,0,0,0,0,0,0,0,0,136000,0,0,0,141000,5000,136000,136000
059170,康控凱基9B購01  ,0,0,0,0,0,0,0,0,0,136000,0,0,0,186000,50000,136000,136000
060108,泰鼎元大99購04  ,0,0,0,0,0,0,0,0,0,136000,0,0,0,164000,28000,136000,136000
060057,欣興凱基9B購01  ,0,0,0,0,0,0,0,0,0,136000,0,0,0,276000,140000,136000,136000
060521,鴻海中信01購03  ,0,0,0,0,0,0,0,0,0,135000,0,0,0,145000,10000,135000,135000
07283P,華新科凱基99售07,0,0,0,0,0,0,0,0,0,135000,0,0,0,153000,18000,135000,135000
048187,臺指反元大96購04,0,0,0,0,0,0,0,0,0,134000,0,0,0,150000,16000,134000,134000
054743,聯鈞凱基99購01  ,0,0,0,0,0,0,0,0,0,134000,0,0,0,134000,0,134000,134000
059612,奇鋐永豐99購02  ,0,0,0,0,0,0,0,0,0,134000,0,0,0,200000,66000,134000,134000
059296,大立光元富99購06,0,0,0,0,0,0,0,0,0,134000,0,0,0,170000,36000,134000,134000
056699,光罩國泰99購01  ,0,0,0,0,0,0,0,0,0,134000,0,0,0,153000,19000,134000,134000
059536,新光金凱基99購05,0,0,0,0,0,0,0,0,0,134000,0,0,0,230000,96000,134000,134000
058924,晶相光元富99購02,0,0,0,0,0,0,0,0,0,133000,0,0,0,133000,0,133000,133000
057536,康控元大99購03  ,0,0,0,0,0,0,0,0,0,133000,0,0,0,135000,2000,133000,133000
057556,智易凱基99購01  ,0,0,0,0,0,0,0,0,0,133000,0,0,0,206000,73000,133000,133000
059440,康控元大9B購01  ,0,0,0,0,0,0,0,0,0,133000,0,0,0,175000,42000,133000,133000
05921P,同欣電元大96售06,0,1000,-1000,0,0,0,0,0,0,133000,0,0,0,185000,52000,133000,132000
056492,全新國泰9A購01  ,0,0,0,0,0,0,0,0,0,132000,0,0,0,132000,0,132000,132000
058160,奇鋐元富99購01  ,0,0,0,0,0,0,0,0,0,132000,0,0,0,230000,98000,132000,132000
2456,奇力新          ,878000,739000,139000,0,0,0,7000,0,7000,-15000,14000,8000,6000,2000,23000,-21000,131000
060396,友達國票9A購01  ,0,0,0,0,0,0,0,0,0,131000,0,0,0,158000,27000,131000,131000
055173,瑞昱統一97購01  ,0,0,0,0,0,0,0,0,0,131000,0,0,0,131000,0,131000,131000
049490,京元電元大95購02,0,0,0,0,0,0,0,0,0,131000,0,0,0,141000,10000,131000,131000
049199,茂林永豐95購01  ,0,0,0,0,0,0,0,0,0,131000,0,0,0,151000,20000,131000,131000
059215,台積電元大99購28,0,0,0,0,0,0,0,0,0,131000,0,0,0,186000,55000,131000,131000
060565,大立光富邦01購01,0,0,0,0,0,0,0,0,0,130000,0,0,0,163000,33000,130000,130000
07253P,台灣50凱基9A售05,0,0,0,0,0,0,0,0,0,130000,0,0,0,130000,0,130000,130000
046628,大立光統一98購01,0,0,0,0,0,0,0,0,0,130000,0,0,0,160000,30000,130000,130000
051561,玉晶光國泰97購04,0,0,0,0,0,0,0,0,0,130000,0,0,0,131000,1000,130000,130000
055068,亞翔永豐97購01  ,0,0,0,0,0,0,0,0,0,130000,0,0,0,130000,0,130000,130000
055962,晶豪科元大97購02,0,0,0,0,0,0,0,0,0,130000,0,0,0,130000,0,130000,130000
058224,世芯統一9B購02  ,0,0,0,0,0,0,0,0,0,130000,0,0,0,406000,276000,130000,130000
059626,台積電凱基01購01,0,0,0,0,0,0,0,0,0,130000,0,0,0,130000,0,130000,130000
059773,康控群益99購01  ,0,0,0,0,0,0,0,0,0,130000,0,0,0,130000,0,130000,130000
058259,訊連國泰9B購01  ,0,0,0,0,0,0,0,0,0,130000,0,0,0,130000,0,130000,130000
058246,帆宣元大99購01  ,0,0,0,0,0,0,0,0,0,130000,0,0,0,135000,5000,130000,130000
058049,帆宣元大98購01  ,0,0,0,0,0,0,0,0,0,130000,0,0,0,130000,0,130000,130000
056733,國巨凱基98購10  ,0,0,0,0,0,0,0,0,0,130000,0,0,0,130000,0,130000,130000
4961,天鈺            ,173000,43000,130000,0,0,0,0,0,0,0,0,0,0,0,0,0,130000
051503,玉晶光統一97購01,0,0,0,0,0,0,0,0,0,129000,0,0,0,143000,14000,129000,129000
058476,旺宏凱基9A購01  ,0,0,0,0,0,0,0,0,0,129000,0,0,0,129000,0,129000,129000
057401,晶豪科群益99購01,0,0,0,0,0,0,0,0,0,129000,0,0,0,154000,25000,129000,129000
6591,動力-KY         ,186000,57000,129000,0,0,0,0,0,0,-1000,0,1000,-1000,0,0,0,128000
060340,國巨統一01購02  ,0,0,0,0,0,0,0,0,0,128000,0,0,0,228000,100000,128000,128000
05359P,嘉澤元大95售02  ,0,0,0,0,0,0,0,0,0,128000,0,0,0,398000,270000,128000,128000
055921,新唐凱基98購01  ,0,0,0,0,0,0,0,0,0,128000,0,0,0,128000,0,128000,128000
058467,日月光中信9A購01,0,0,0,0,0,0,0,0,0,128000,0,0,0,229000,101000,128000,128000
051745,玉晶光國泰97購06,0,0,0,0,0,0,0,0,0,127000,0,0,0,133000,6000,127000,127000
058882,晶相光永豐99購01,0,0,0,0,0,0,0,0,0,127000,0,0,0,127000,0,127000,127000
056141,聯茂元大97購05  ,0,0,0,0,0,0,0,0,0,127000,0,0,0,182000,55000,127000,127000
05564P,玉晶光元大97售02,0,0,0,0,0,0,0,0,0,127000,0,0,0,127000,0,127000,127000
059375,道瓊反群益9C購02,0,0,0,0,0,0,0,0,0,127000,0,0,0,267000,140000,127000,127000
061106,群創元大9B購09  ,0,0,0,0,0,0,0,0,0,126000,0,0,0,174000,48000,126000,126000
060630,國巨富邦9C購03  ,0,0,0,0,0,0,0,0,0,126000,0,0,0,175000,49000,126000,126000
1734,杏輝            ,144000,18000,126000,0,0,0,0,0,0,0,0,0,0,0,0,0,126000
058204,世芯凱基9A購01  ,0,0,0,0,0,0,0,0,0,126000,0,0,0,277000,151000,126000,126000
058878,旭富國泰9B購01  ,0,0,0,0,0,0,0,0,0,126000,0,0,0,206000,80000,126000,126000
058240,景碩元大99購04  ,0,0,0,0,0,0,0,0,0,126000,0,0,0,127000,1000,126000,126000
2504,國產            ,700000,1003000,-303000,0,0,0,429000,0,429000,-1000,0,18000,-18000,17000,0,17000,125000
061179,華擎凱基9A購01  ,0,0,0,0,0,0,0,0,0,125000,0,0,0,125000,0,125000,125000
054057,晶豪科國票97購01,0,0,0,0,0,0,0,0,0,125000,0,0,0,125000,0,125000,125000
047421,聯茂富邦97購01  ,0,0,0,0,0,0,0,0,0,125000,0,0,0,230000,105000,125000,125000
050656,瑞儀凱基96購01  ,0,0,0,0,0,0,0,0,0,125000,0,0,0,125000,0,125000,125000
050155,華新科群益95購01,0,0,0,0,0,0,0,0,0,125000,0,0,0,135000,10000,125000,125000
057073,康控永豐98購01  ,0,0,0,0,0,0,0,0,0,125000,0,0,0,152000,27000,125000,125000
056801,國巨台新98購01  ,0,0,0,0,0,0,0,0,0,125000,0,0,0,196000,71000,125000,125000
058788,喬山元大99購01  ,0,0,0,0,0,0,0,0,0,125000,0,0,0,128000,3000,125000,125000
2349,錸德            ,378000,250001,127999,0,0,0,0,0,0,-3000,0,3000,-3000,0,0,0,124999
9944,新麗            ,200000,64000,136000,0,0,0,0,0,0,-12000,0,12000,-12000,0,0,0,124000
060632,可成富邦9B購01  ,0,0,0,0,0,0,0,0,0,124000,0,0,0,451000,327000,124000,124000
060562,旺宏富邦9C購02  ,0,0,0,0,0,0,0,0,0,124000,0,0,0,140000,16000,124000,124000
06614P,祥碩永豐98售03  ,0,0,0,0,0,0,0,0,0,123000,0,0,0,273000,150000,123000,123000
8105,凌巨            ,196000,63000,133000,0,0,0,0,0,0,-10000,0,10000,-10000,0,0,0,123000
057805,華通元大98購06  ,0,0,0,0,0,0,0,0,0,123000,0,0,0,193000,70000,123000,123000
058707,泰鼎元大99購02  ,0,0,0,0,0,0,0,0,0,123000,0,0,0,148000,25000,123000,123000
059978,國巨元大99購29  ,0,0,0,0,0,0,0,0,0,123000,0,0,0,144000,21000,123000,123000
060092,瑞昱元大99購03  ,0,0,0,0,0,0,0,0,0,123000,0,0,0,164000,41000,123000,123000
059878,聯茂凱基99購07  ,0,0,0,0,0,0,0,0,0,123000,0,0,0,284000,161000,123000,123000
060416,神隆永豐9A購01  ,0,0,0,0,0,0,0,0,0,122000,0,0,0,246000,124000,122000,122000
054457,強茂群益96購01  ,0,0,0,0,0,0,0,0,0,122000,0,0,0,238000,116000,122000,122000
058576,南亞科群益99購01,0,0,0,0,0,0,0,0,0,122000,0,0,0,122000,0,122000,122000
059645,祥碩凱基99購05  ,0,0,0,0,0,0,0,0,0,121000,0,0,0,313000,192000,121000,121000
055916,奇鋐凱基99購01  ,0,0,0,0,0,0,0,0,0,121000,0,0,0,216000,95000,121000,121000
059460,GIS永豐99購02   ,0,0,0,0,0,0,0,0,0,121000,0,0,0,125000,4000,121000,121000
052887,華通中信96購01  ,0,0,0,0,0,0,0,0,0,120000,0,0,0,240000,120000,120000,120000
058355,旺宏凱基99購04  ,0,0,0,0,0,0,0,0,0,120000,0,0,0,123000,3000,120000,120000
053485,矽創國票97購04  ,0,0,0,0,0,0,0,0,0,120000,0,0,0,120000,0,120000,120000
048271,可成富邦95購02  ,0,0,0,0,0,0,0,0,0,120000,0,0,0,120000,0,120000,120000
053958,京元電永豐96購01,0,0,0,0,0,0,0,0,0,120000,0,0,0,121000,1000,120000,120000
052374,瑞昱元大95購02  ,0,0,0,0,0,0,0,0,0,120000,0,0,0,120000,0,120000,120000
051375,道瓊反群益9A購01,0,0,0,0,0,0,0,0,0,120000,0,0,0,150000,30000,120000,120000
060007,鴻海群益99購04  ,0,0,0,0,0,0,0,0,0,120000,0,0,0,124000,4000,120000,120000
060407,南六國泰9C購01  ,0,0,0,0,0,0,0,0,0,119000,0,0,0,148000,29000,119000,119000
00656R,國泰中國A50反1  ,0,4000,-4000,0,0,0,0,0,0,123000,0,0,0,137000,14000,123000,119000
054909,福懋科康和97購01,0,0,0,0,0,0,0,0,0,119000,0,0,0,157000,38000,119000,119000
046384,群創凱基98購02  ,0,0,0,0,0,0,0,0,0,118000,0,0,0,118000,0,118000,118000
056890,國巨元大98購11  ,0,0,0,0,0,0,0,0,0,118000,0,0,0,118000,0,118000,118000
05529P,臺股指群益96售02,0,0,0,0,0,0,0,0,0,117000,0,0,0,118000,1000,117000,117000
058838,國巨中信99購03  ,0,0,0,0,0,0,0,0,0,117000,0,0,0,217000,100000,117000,117000
060573,力成永豐9A購01  ,0,0,0,0,0,0,0,0,0,116000,0,0,0,328000,212000,116000,116000
052893,聯電群益98購01  ,0,0,0,0,0,0,0,0,0,116000,0,0,0,285000,169000,116000,116000
00652,富邦印度        ,200000,0,200000,0,0,0,0,0,0,-84000,0,0,0,12000,96000,-84000,116000
054071,泰鼎國泰97購02  ,0,0,0,0,0,0,0,0,0,116000,0,0,0,116000,0,116000,116000
057574,中磊永豐98購01  ,0,0,0,0,0,0,0,0,0,116000,0,0,0,116000,0,116000,116000
3266,昇陽            ,125000,7000,118000,0,0,0,0,0,0,-2000,0,2000,-2000,0,0,0,116000
1455,集盛            ,240000,122000,118000,0,0,0,0,0,0,-3000,0,3000,-3000,0,0,0,115000
051630,力山國票96購01  ,0,0,0,0,0,0,0,0,0,115000,0,0,0,126000,11000,115000,115000
049438,嘉晶國泰96購01  ,0,0,0,0,0,0,0,0,0,115000,0,0,0,170000,55000,115000,115000
050894,旺宏元大96購03  ,0,0,0,0,0,0,0,0,0,114000,0,0,0,118000,4000,114000,114000
059975,元金2X元大99購02,0,0,0,0,0,0,0,0,0,114000,0,0,0,149000,35000,114000,114000
060098,華新科元大99購24,0,0,0,0,0,0,0,0,0,114000,0,0,0,139000,25000,114000,114000
057283,欣興元大98購07  ,0,0,0,0,0,0,0,0,0,114000,0,0,0,343000,229000,114000,114000
059070,道瓊指元大99購02,0,0,0,0,0,0,0,0,0,114000,0,0,0,115000,1000,114000,114000
05869P,旺宏凱基96售05  ,0,0,0,0,0,0,0,0,0,114000,0,0,0,116000,2000,114000,114000
059503,大立光富邦9B購04,0,0,0,0,0,0,0,0,0,114000,0,0,0,344000,230000,114000,114000
061068,祥碩凱基9B購01  ,0,0,0,0,0,0,0,0,0,113000,0,0,0,204000,91000,113000,113000
051156,鴻海富邦97購01  ,0,0,0,0,0,0,0,0,0,113000,0,0,0,113000,0,113000,113000
05149P,緯穎國泰96售01  ,0,0,0,0,0,0,0,0,0,113000,0,0,0,113000,0,113000,113000
053003,國巨永豐96購02  ,0,0,0,0,0,0,0,0,0,113000,0,0,0,113000,0,113000,113000
059050,元油2X凱基9B購08,0,0,0,0,0,0,0,0,0,113000,0,0,0,423000,310000,113000,113000
8110,華東            ,203000,86000,117000,0,0,0,0,6000,-6000,1000,12000,11000,1000,0,0,0,112000
2365,昆盈            ,140000,25000,115000,0,0,0,0,0,0,-3000,0,3000,-3000,0,0,0,112000
051906,國巨元大95購09  ,0,0,0,0,0,0,0,0,0,112000,0,0,0,150000,38000,112000,112000
03435B,臺股指凱基99熊29,0,0,0,0,0,0,0,0,0,112000,0,0,0,959000,847000,112000,112000
056603,嘉聯益國泰9A購01,0,0,0,0,0,0,0,0,0,112000,0,0,0,124000,12000,112000,112000
060099,宏達電元大99購09,0,0,0,0,0,0,0,0,0,112000,0,0,0,147000,35000,112000,112000
060161,牧德永豐9A購02  ,0,0,0,0,0,0,0,0,0,112000,0,0,0,150000,38000,112000,112000
059618,台積電日盛99購01,0,0,0,0,0,0,0,0,0,112000,0,0,0,510000,398000,112000,112000
07359P,台積電元大99售45,0,0,0,0,0,0,0,0,0,111000,0,0,0,166000,55000,111000,111000
060474,中租元大9B購01  ,0,0,0,0,0,0,0,0,0,111000,0,0,0,111000,0,111000,111000
03433B,臺股指元大9C熊01,0,0,0,0,0,0,0,0,0,111000,0,0,0,176000,65000,111000,111000
04616P,臺股指群益95售02,0,0,0,0,0,0,0,0,0,111000,0,0,0,192000,81000,111000,111000
057300,訊連永豐98購01  ,0,0,0,0,0,0,0,0,0,111000,0,0,0,121000,10000,111000,111000
049040,亞光兆豐95購01  ,0,0,0,0,0,0,0,0,0,110000,0,0,0,110000,0,110000,110000
053965,聯電元大98購04  ,0,0,0,0,0,0,0,0,0,110000,0,0,0,110000,0,110000,110000
052997,國巨康和96購01  ,0,0,0,0,0,0,0,0,0,110000,0,0,0,110000,0,110000,110000
053694,創意元大96購03  ,0,0,0,0,0,0,0,0,0,110000,0,0,0,155000,45000,110000,110000
053368,京元電富邦98購01,0,0,0,0,0,0,0,0,0,110000,0,0,0,161000,51000,110000,110000
056163,嘉聯益凱基98購03,0,0,0,0,0,0,0,0,0,110000,0,0,0,110000,0,110000,110000
056250,瑞昱兆豐97購02  ,0,0,0,0,0,0,0,0,0,110000,0,0,0,110000,0,110000,110000
055837,致茂元大97購02  ,0,0,0,0,0,0,0,0,0,110000,0,0,0,110000,0,110000,110000
055746,同欣電元富97購01,0,0,0,0,0,0,0,0,0,110000,0,0,0,339000,229000,110000,110000
057666,奇力新元大9A購01,0,0,0,0,0,0,0,0,0,110000,0,0,0,110000,0,110000,110000
058754,元油2X群益99購02,120000,0,120000,0,0,0,0,0,0,-10000,0,0,0,0,10000,-10000,110000
058133,華新科元大9A購02,0,0,0,0,0,0,0,0,0,110000,0,0,0,162000,52000,110000,110000
07263P,台積電元大99售37,0,0,0,0,0,0,0,0,0,109000,0,0,0,557000,448000,109000,109000
06515P,國巨凱基98售06  ,0,0,0,0,0,0,0,0,0,109000,0,0,0,252000,143000,109000,109000
058411,技嘉兆豐99購01  ,0,0,0,0,0,0,0,0,0,109000,0,0,0,115000,6000,109000,109000
055844,大毅元大98購01  ,0,0,0,0,0,0,0,0,0,109000,0,0,0,189000,80000,109000,109000
053570,京元電統一96購01,0,0,0,0,0,0,0,0,0,108000,0,0,0,108000,0,108000,108000
056281,深中小永豐97購01,0,0,0,0,0,0,0,0,0,108000,0,0,0,110000,2000,108000,108000
055408,力成國泰98購01  ,0,0,0,0,0,0,0,0,0,108000,0,0,0,123000,15000,108000,108000
048429,旺宏國票94購02  ,0,0,0,0,0,0,0,0,0,108000,0,0,0,108000,0,108000,108000
055859,啟碁元大97購03  ,0,0,0,0,0,0,0,0,0,108000,0,0,0,108000,0,108000,108000
059608,聯發科富邦9B購04,0,0,0,0,0,0,0,0,0,108000,0,0,0,168000,60000,108000,108000
6456,GIS-KY          ,610000,420657,189343,0,0,0,0,0,0,-82000,2000,12000,-10000,3000,75000,-72000,107343
060735,鴻海統一9C購03  ,0,0,0,0,0,0,0,0,0,107000,0,0,0,157000,50000,107000,107000
05089P,亞德客元大95售01,0,0,0,0,0,0,0,0,0,107000,0,0,0,107000,0,107000,107000
051154,國巨國泰96購03  ,0,0,0,0,0,0,0,0,0,107000,0,0,0,130000,23000,107000,107000
052908,大成鋼統一96購01,0,0,0,0,0,0,0,0,0,107000,0,0,0,107000,0,107000,107000
053658,亞光凱基96購01  ,0,0,0,0,0,0,0,0,0,107000,0,0,0,107000,0,107000,107000
3041,揚智            ,392000,284000,108000,0,0,0,0,0,0,-1000,0,1000,-1000,0,0,0,107000
060675,南亞科元大9A購02,0,0,0,0,0,0,0,0,0,106000,0,0,0,106000,0,106000,106000
061004,友達兆豐9A購01  ,0,0,0,0,0,0,0,0,0,106000,0,0,0,106000,0,106000,106000
056124,華通國票98購02  ,0,0,0,0,0,0,0,0,0,106000,0,0,0,106000,0,106000,106000
8341,日友            ,98000,76000,22000,0,0,0,86000,0,86000,-3000,0,3000,-3000,0,0,0,105000
054590,嘉聯益國泰98購01,0,0,0,0,0,0,0,0,0,105000,0,0,0,105000,0,105000,105000
05755P,臺股指中信99售04,0,0,0,0,0,0,0,0,0,105000,0,0,0,121000,16000,105000,105000
060089,台積電元大99購54,0,0,0,0,0,0,0,0,0,105000,0,0,0,180000,75000,105000,105000
058429,欣興元富99購01  ,0,0,0,0,0,0,0,0,0,105000,0,0,0,105000,0,105000,105000
059907,道瓊指元大99購03,0,0,0,0,0,0,0,0,0,105000,0,0,0,105000,0,105000,105000
059679,國巨國泰9B購03  ,0,0,0,0,0,0,0,0,0,105000,0,0,0,105000,0,105000,105000
060931,GIS永豐9A購01   ,0,0,0,0,0,0,0,0,0,104000,0,0,0,104000,0,104000,104000
060256,臺股指元大9B購07,0,0,0,0,0,0,0,0,0,104000,0,0,0,104000,0,104000,104000
060324,台積電群益9B購02,0,0,0,0,0,0,0,0,0,104000,0,0,0,133000,29000,104000,104000
051641,矽創國票96購01  ,0,0,0,0,0,0,0,0,0,104000,0,0,0,142000,38000,104000,104000
058801,致伸元大99購01  ,0,0,0,0,0,0,0,0,0,104000,0,0,0,131000,27000,104000,104000
059177,臺股指凱基99購28,0,0,0,0,0,0,0,0,0,104000,0,0,0,106000,2000,104000,104000
057616,聯電凱基99購01  ,0,0,0,0,0,0,0,0,0,104000,0,0,0,144000,40000,104000,104000
06641P,智邦兆豐99售01  ,0,0,0,0,0,0,0,0,0,103000,0,0,0,123000,20000,103000,103000
054274,智易中信96購02  ,0,0,0,0,0,0,0,0,0,103000,0,0,0,188000,85000,103000,103000
046791,台郡統一96購01  ,0,0,0,0,0,0,0,0,0,103000,0,0,0,108000,5000,103000,103000
056083,億光統一97購03  ,0,0,0,0,0,0,0,0,0,103000,0,0,0,143000,40000,103000,103000
055909,大成鋼凱基98購02,0,0,0,0,0,0,0,0,0,103000,0,0,0,112000,9000,103000,103000
057172,南亞科元大98購03,0,0,0,0,0,0,0,0,0,103000,0,0,0,103000,0,103000,103000
059786,全新元大99購06  ,0,0,0,0,0,0,0,0,0,103000,0,0,0,111000,8000,103000,103000
6582,申豐            ,164000,64000,100000,0,0,0,0,0,0,2000,11000,11000,0,2000,0,2000,102000
055510,GIS元大97購03   ,0,0,0,0,0,0,0,0,0,102000,0,0,0,102000,0,102000,102000
053492,華邦電兆豐97購01,0,0,0,0,0,0,0,0,0,102000,0,0,0,102000,0,102000,102000
056366,玉晶光元大99購04,0,0,0,0,0,0,0,0,0,102000,0,0,0,104000,2000,102000,102000
059214,國巨元大99購20  ,0,0,0,0,0,0,0,0,0,102000,0,0,0,137000,35000,102000,102000
056714,晶相光永豐98購02,0,0,0,0,0,0,0,0,0,102000,0,0,0,102000,0,102000,102000
056726,友達日盛9A購01  ,0,0,0,0,0,0,0,0,0,102000,0,0,0,102000,0,102000,102000
059678,鴻海國泰9A購03  ,0,0,0,0,0,0,0,0,0,102000,0,0,0,184000,82000,102000,102000
059494,國巨國票9C購01  ,0,0,0,0,0,0,0,0,0,102000,0,0,0,144000,42000,102000,102000
060823,旺宏元大9A購05  ,0,0,0,0,0,0,0,0,0,101000,0,0,0,121000,20000,101000,101000
060284,南港元大01購01  ,0,0,0,0,0,0,0,0,0,101000,0,0,0,101000,0,101000,101000
053340,建準國票97購01  ,0,0,0,0,0,0,0,0,0,101000,0,0,0,101000,0,101000,101000
052068,瑞儀兆豐96購01  ,0,0,0,0,0,0,0,0,0,101000,0,0,0,101000,0,101000,101000
057527,億光元大98購01  ,0,0,0,0,0,0,0,0,0,101000,0,0,0,106000,5000,101000,101000
059711,滬深2X元大9C購02,0,0,0,0,0,0,0,0,0,101000,0,0,0,121000,20000,101000,101000
060221,大立光凱基9A購07,0,0,0,0,0,0,0,0,0,100000,0,0,0,124000,24000,100000,100000
060420,神基永豐9A購01  ,0,0,0,0,0,0,0,0,0,100000,0,0,0,100000,0,100000,100000
060433,億豐永豐9A購01  ,0,0,0,0,0,0,0,0,0,100000,0,0,0,100000,0,100000,100000
061178,晶技凱基9B購01  ,0,0,0,0,0,0,0,0,0,100000,0,0,0,100000,0,100000,100000
061157,聯鈞群益9A購02  ,0,0,0,0,0,0,0,0,0,100000,0,0,0,149000,49000,100000,100000
06690P,玉晶光群益9A售05,0,0,0,0,0,0,0,0,0,100000,0,0,0,100000,0,100000,100000
07208P,台積電凱基99售14,0,0,0,0,0,0,0,0,0,100000,0,0,0,100000,0,100000,100000
052084,台泥元大95購01  ,0,0,0,0,0,0,0,0,0,100000,0,0,0,195000,95000,100000,100000
050955,達方群益97購01  ,0,0,0,0,0,0,0,0,0,100000,0,0,0,100000,0,100000,100000
054015,晶豪科永豐96購03,0,0,0,0,0,0,0,0,0,100000,0,0,0,100000,0,100000,100000
052587,景碩永豐97購01  ,0,0,0,0,0,0,0,0,0,100000,0,0,0,120000,20000,100000,100000
046568,臻鼎元富95購01  ,0,0,0,0,0,0,0,0,0,100000,0,0,0,100000,0,100000,100000
050727,華新科國票94購09,0,0,0,0,0,0,0,0,0,100000,0,0,0,100000,0,100000,100000
050715,台積電群益96購01,0,0,0,0,0,0,0,0,0,100000,0,0,0,100000,0,100000,100000
050798,TPK中信96購01   ,0,0,0,0,0,0,0,0,0,100000,0,0,0,100000,0,100000,100000
01003T,兆豐新光R1      ,100000,0,100000,0,0,0,0,0,0,0,0,0,0,0,0,0,100000
053583,漢唐元大96購03  ,0,0,0,0,0,0,0,0,0,100000,0,0,0,200000,100000,100000,100000
058616,台虹元大9A購01  ,0,0,0,0,0,0,0,0,0,100000,0,0,0,110000,10000,100000,100000
056280,上証2X永豐98購01,0,0,0,0,0,0,0,0,0,100000,0,0,0,100000,0,100000,100000
052622,貿聯兆豐97購01  ,0,0,0,0,0,0,0,0,0,100000,0,0,0,100000,0,100000,100000
054691,裕民永豐97購01  ,0,0,0,0,0,0,0,0,0,100000,0,0,0,100000,0,100000,100000
054855,得力群益98購01  ,0,0,0,0,0,0,0,0,0,100000,0,0,0,100000,0,100000,100000
058222,玉晶光統一9B購01,0,0,0,0,0,0,0,0,0,100000,0,0,0,120000,20000,100000,100000
056006,義隆亞東97購01  ,0,0,0,0,0,0,0,0,0,100000,0,0,0,163000,63000,100000,100000
058525,台虹元大99購02  ,0,0,0,0,0,0,0,0,0,100000,0,0,0,100000,0,100000,100000
057064,華新科富邦9B購01,0,0,0,0,0,0,0,0,0,100000,0,0,0,100000,0,100000,100000
056823,智伸科永豐98購01,0,0,0,0,0,0,0,0,0,100000,0,0,0,110000,10000,100000,100000
07474P,滬深2X群益9C售03,0,0,0,0,0,0,0,0,0,99000,0,0,0,101000,2000,99000,99000
060919,滬深2X富邦9B購01,0,0,0,0,0,0,0,0,0,99000,0,0,0,99000,0,99000,99000
053080,力山元大96購02  ,0,0,0,0,0,0,0,0,0,99000,0,0,0,100000,1000,99000,99000
048350,世紀鋼元大95購01,0,0,0,0,0,0,0,0,0,99000,0,0,0,100000,1000,99000,99000
050846,緯創國票96購01  ,0,0,0,0,0,0,0,0,0,99000,0,0,0,120000,21000,99000,99000
055670,矽創群益98購02  ,0,0,0,0,0,0,0,0,0,99000,0,0,0,159000,60000,99000,99000
059984,華新科元大99購21,0,0,0,0,0,0,0,0,0,99000,0,0,0,131000,32000,99000,99000
059461,鈺齊永豐99購03  ,0,0,0,0,0,0,0,0,0,99000,0,0,0,101000,2000,99000,99000
060987,華新科元大9A購11,0,0,0,0,0,0,0,0,0,98000,0,0,0,98000,0,98000,98000
060347,大立光統一02購01,0,0,0,0,0,0,0,0,0,98000,0,0,0,124000,26000,98000,98000
1712,興農            ,160000,53000,107000,0,0,0,0,1000,-1000,-8000,0,8000,-8000,0,0,0,98000
053810,台達電群益96購01,0,0,0,0,0,0,0,0,0,98000,0,0,0,98000,0,98000,98000
056297,台光電元大97購04,0,0,0,0,0,0,0,0,0,98000,0,0,0,100000,2000,98000,98000
055390,國巨統一98購03  ,0,0,0,0,0,0,0,0,0,98000,0,0,0,98000,0,98000,98000
057228,友達凱基9B購01  ,0,0,0,0,0,0,0,0,0,98000,0,0,0,98000,0,98000,98000
060701,玉晶光國泰9C購01,0,0,0,0,0,0,0,0,0,97000,0,0,0,107000,10000,97000,97000
057189,康控元大98購02  ,0,0,0,0,0,0,0,0,0,97000,0,0,0,97000,0,97000,97000
055620,樺漢國票98購01  ,0,0,0,0,0,0,0,0,0,97000,0,0,0,97000,0,97000,97000
059986,宏達電元大99購08,0,0,0,0,0,0,0,0,0,97000,0,0,0,121000,24000,97000,97000
058206,祥碩凱基99購01  ,0,0,0,0,0,0,0,0,0,97000,0,0,0,131000,34000,97000,97000
058575,智邦群益99購01  ,0,0,0,0,0,0,0,0,0,97000,0,0,0,123000,26000,97000,97000
060402,神隆國泰9B購01  ,0,0,0,0,0,0,0,0,0,96000,0,0,0,96000,0,96000,96000
052611,力成元大96購02  ,0,0,0,0,0,0,0,0,0,96000,0,0,0,446000,350000,96000,96000
05647P,聯發科國票97售02,0,0,0,0,0,0,0,0,0,96000,0,0,0,100000,4000,96000,96000
059722,南亞科元大99購02,0,0,0,0,0,0,0,0,0,96000,0,0,0,101000,5000,96000,96000
060322,卜蜂群益9A購01  ,0,0,0,0,0,0,0,0,0,95000,0,0,0,95000,0,95000,95000
050397,力成元富94購01  ,0,0,0,0,0,0,0,0,0,95000,0,0,0,95000,0,95000,95000
047212,宏達電富邦97購01,0,0,0,0,0,0,0,0,0,95000,0,0,0,95000,0,95000,95000
053725,晶相光凱基96購01,0,0,0,0,0,0,0,0,0,95000,0,0,0,95000,0,95000,95000
059763,華擎永豐99購03  ,0,0,0,0,0,0,0,0,0,95000,0,0,0,107000,12000,95000,95000
060049,華通凱基99購06  ,0,0,0,0,0,0,0,0,0,95000,0,0,0,105000,10000,95000,95000
057895,全新元富9B購01  ,0,0,0,0,0,0,0,0,0,95000,0,0,0,195000,100000,95000,95000
059165,南亞科凱基99購04,0,0,0,0,0,0,0,0,0,95000,0,0,0,95000,0,95000,95000
2881,富邦金          ,6091000,5929055,161945,0,0,0,267000,11000,256000,-323000,11000,287000,-276000,2000,49000,-47000,94945
060819,國巨統一9C購04  ,0,0,0,0,0,0,0,0,0,94000,0,0,0,111000,17000,94000,94000
060805,國巨群益9A購06  ,0,0,0,0,0,0,0,0,0,94000,0,0,0,235000,141000,94000,94000
057727,華邦電國泰9A購01,0,0,0,0,0,0,0,0,0,94000,0,0,0,94000,0,94000,94000
006207,FH滬深          ,131000,0,131000,0,0,0,0,0,0,-37000,0,40000,-40000,119000,116000,3000,94000
056517,茂林兆豐99購01  ,0,0,0,0,0,0,0,0,0,94000,0,0,0,94000,0,94000,94000
057530,奇鋐元大99購01  ,0,0,0,0,0,0,0,0,0,94000,0,0,0,206000,112000,94000,94000
061091,奇力新統一9C購02,0,0,0,0,0,0,0,0,0,93000,0,0,0,135000,42000,93000,93000
060546,旺宏凱基9A購02  ,0,0,0,0,0,0,0,0,0,93000,0,0,0,95000,2000,93000,93000
05410P,聯發科元富95售04,0,0,0,0,0,0,0,0,0,93000,0,0,0,93000,0,93000,93000
059005,嘉晶元大99購06  ,0,0,0,0,0,0,0,0,0,93000,0,0,0,123000,30000,93000,93000
057057,立積元大9A購01  ,0,0,0,0,0,0,0,0,0,93000,0,0,0,98000,5000,93000,93000
058144,聯茂元大99購02  ,0,0,0,0,0,0,0,0,0,93000,0,0,0,93000,0,93000,93000
058008,禾伸堂國票99購02,0,0,0,0,0,0,0,0,0,93000,0,0,0,104000,11000,93000,93000
059254,台表科凱基9A購02,0,0,0,0,0,0,0,0,0,93000,0,0,0,113000,20000,93000,93000
059351,台虹凱基99購01  ,0,0,0,0,0,0,0,0,0,93000,0,0,0,161000,68000,93000,93000
059919,宏達電元大99購06,0,0,0,0,0,0,0,0,0,93000,0,0,0,138000,45000,93000,93000
059838,茂林國泰9B購01  ,0,0,0,0,0,0,0,0,0,93000,0,0,0,103000,10000,93000,93000
061050,康友中信9A購01  ,0,0,0,0,0,0,0,0,0,92000,0,0,0,92000,0,92000,92000
053326,瀚宇博台新96購01,0,0,0,0,0,0,0,0,0,92000,0,0,0,92000,0,92000,92000
052823,創意永豐96購02  ,0,0,0,0,0,0,0,0,0,92000,0,0,0,92000,0,92000,92000
061104,華新科元大9A購13,0,0,0,0,0,0,0,0,0,91000,0,0,0,91000,0,91000,91000
07698P,臺股指元大9A售51,0,0,0,0,0,0,0,0,0,91000,0,0,0,101000,10000,91000,91000
055432,臻鼎群益97購02  ,0,0,0,0,0,0,0,0,0,91000,0,0,0,189000,98000,91000,91000
052527,泰鼎元大96購02  ,0,0,0,0,0,0,0,0,0,91000,0,0,0,91000,0,91000,91000
059243,聯發科凱基99購12,0,0,0,0,0,0,0,0,0,91000,0,0,0,100000,9000,91000,91000
059347,京鼎凱基99購02  ,0,0,0,0,0,0,0,0,0,91000,0,0,0,181000,90000,91000,91000
2461,光群雷          ,169000,77000,92000,0,0,0,0,0,0,-2000,0,2000,-2000,0,0,0,90000
07336P,台灣50台新99售05,0,0,0,0,0,0,0,0,0,90000,0,0,0,90000,0,90000,90000
060523,鴻海中信9C購03  ,0,0,0,0,0,0,0,0,0,90000,0,0,0,90000,0,90000,90000
061036,晶技永豐9A購03  ,0,15000,-15000,0,0,0,0,0,0,105000,0,0,0,155000,50000,105000,90000
054158,國巨日盛99購01  ,0,0,0,0,0,0,0,0,0,90000,0,0,0,90000,0,90000,90000
054349,同欣電國票97購02,0,0,0,0,0,0,0,0,0,90000,0,0,0,406000,316000,90000,90000
055518,華新科中信99購01,0,0,0,0,0,0,0,0,0,90000,0,0,0,90000,0,90000,90000
055354,宏達電凱基98購01,0,0,0,0,0,0,0,0,0,90000,0,0,0,90000,0,90000,90000
053632,新唐兆豐96購01  ,0,0,0,0,0,0,0,0,0,90000,0,0,0,90000,0,90000,90000
053506,南茂兆豐97購01  ,0,0,0,0,0,0,0,0,0,90000,0,0,0,105000,15000,90000,90000
053115,滬深2X中信97購01,0,0,0,0,0,0,0,0,0,90000,0,0,0,90000,0,90000,90000
055650,華新科元富98購01,0,0,0,0,0,0,0,0,0,90000,0,0,0,90000,0,90000,90000
059987,大立光元大99購28,0,0,0,0,0,0,0,0,0,90000,0,0,0,90000,0,90000,90000
057959,欣興元大98購14  ,0,0,0,0,0,0,0,0,0,90000,0,0,0,90000,0,90000,90000
059086,國巨元大99購18  ,0,0,0,0,0,0,0,0,0,90000,0,0,0,145000,55000,90000,90000
059135,臺股指群益99購10,0,0,0,0,0,0,0,0,0,90000,0,0,0,90000,0,90000,90000
059876,智易凱基99購02  ,0,0,0,0,0,0,0,0,0,90000,0,0,0,525000,435000,90000,90000
060364,奇力新元富9A購01,0,0,0,0,0,0,0,0,0,89000,0,0,0,162000,73000,89000,89000
053151,華新科元大96購04,0,0,0,0,0,0,0,0,0,89000,0,0,0,95000,6000,89000,89000
054265,GIS元大96購03   ,0,0,0,0,0,0,0,0,0,89000,0,0,0,320000,231000,89000,89000
049064,T50反1凱基96購03,0,0,0,0,0,0,0,0,0,89000,0,0,0,91000,2000,89000,89000
055687,瀚宇博凱基97購01,0,0,0,0,0,0,0,0,0,89000,0,0,0,89000,0,89000,89000
057299,立積永豐98購02  ,0,0,0,0,0,0,0,0,0,89000,0,0,0,119000,30000,89000,89000
5434,崇越            ,206564,114000,92564,0,0,0,0,0,0,-4000,2000,7000,-5000,1000,0,1000,88564
07411P,國巨元大99售31  ,0,0,0,0,0,0,0,0,0,88000,0,0,0,88000,0,88000,88000
057832,聯發科元富02購05,0,0,0,0,0,0,0,0,0,88000,0,0,0,88000,0,88000,88000
057112,立積群益99購01  ,0,0,0,0,0,0,0,0,0,88000,0,0,0,98000,10000,88000,88000
057614,華新科元富99購04,0,0,0,0,0,0,0,0,0,88000,0,0,0,138000,50000,88000,88000
5243,乙盛-KY         ,119000,30000,89000,0,0,0,0,0,0,-1000,0,1000,-1000,0,0,0,88000
059851,晶相光永豐99購02,0,0,0,0,0,0,0,0,0,88000,0,0,0,88000,0,88000,88000
4919,新唐            ,223000,127933,95067,0,0,0,0,0,0,-8000,0,6000,-6000,4000,6000,-2000,87067
057779,禾伸堂群益98購02,0,0,0,0,0,0,0,0,0,87000,0,0,0,287000,200000,87000,87000
00678,群益NBI生技     ,31000,10000,21000,0,0,0,0,0,0,66000,20000,0,20000,346000,300000,46000,87000
057128,台光電凱基98購03,0,0,0,0,0,0,0,0,0,87000,0,0,0,87000,0,87000,87000
055966,茂林元大99購01  ,0,0,0,0,0,0,0,0,0,87000,0,0,0,87000,0,87000,87000
058762,貿聯群益99購03  ,0,0,0,0,0,0,0,0,0,87000,0,0,0,97000,10000,87000,87000
2642,宅配通          ,98000,11000,87000,0,0,0,0,0,0,0,0,0,0,0,0,0,87000
050721,台泥國票94購01  ,0,0,0,0,0,0,0,0,0,86000,0,0,0,86000,0,86000,86000
051722,玉晶光永豐97購01,0,0,0,0,0,0,0,0,0,86000,0,0,0,160000,74000,86000,86000
055235,金寶台新98購01  ,0,0,0,0,0,0,0,0,0,86000,0,0,0,181000,95000,86000,86000
056486,樺漢元大98購04  ,0,0,0,0,0,0,0,0,0,86000,0,0,0,86000,0,86000,86000
055842,建準元大98購01  ,0,0,0,0,0,0,0,0,0,86000,0,0,0,96000,10000,86000,86000
055674,南港康和97購02  ,0,0,0,0,0,0,0,0,0,86000,0,0,0,86000,0,86000,86000
4426,利勤            ,159127,72000,87127,0,0,0,0,0,0,-2000,0,0,0,0,2000,-2000,85127
07626P,台灣50凱基04售07,0,0,0,0,0,0,0,0,0,85000,0,0,0,131000,46000,85000,85000
060373,元金2X元富9A購01,0,0,0,0,0,0,0,0,0,85000,0,0,0,103000,18000,85000,85000
061284,友達統一9C購01  ,0,0,0,0,0,0,0,0,0,85000,0,0,0,110000,25000,85000,85000
054491,瀚宇博台新96購02,0,0,0,0,0,0,0,0,0,85000,0,0,0,85000,0,85000,85000
053892,景碩群益96購02  ,0,0,0,0,0,0,0,0,0,85000,0,0,0,88000,3000,85000,85000
053784,奇力新元大97購02,0,0,0,0,0,0,0,0,0,85000,0,0,0,87000,2000,85000,85000
054147,GIS元大96購02   ,0,0,0,0,0,0,0,0,0,85000,0,0,0,85000,0,85000,85000
047202,欣興元富96購01  ,0,0,0,0,0,0,0,0,0,85000,0,0,0,85000,0,85000,85000
060702,玉晶光國泰9C購02,0,0,0,0,0,0,0,0,0,84000,0,0,0,96000,12000,84000,84000
8210,勤誠            ,204000,178000,26000,0,0,0,50000,1000,49000,9000,10000,4000,6000,4000,1000,3000,84000
07659P,中租凱基9A售02  ,0,0,0,0,0,0,0,0,0,84000,0,0,0,90000,6000,84000,84000
049690,義隆元大95購02  ,0,0,0,0,0,0,0,0,0,84000,0,0,0,282000,198000,84000,84000
054217,台表科國票97購05,0,0,0,0,0,0,0,0,0,84000,0,0,0,84000,0,84000,84000
054017,茂林永豐96購02  ,0,0,0,0,0,0,0,0,0,84000,0,0,0,84000,0,84000,84000
051818,國巨統一95購02  ,0,0,0,0,0,0,0,0,0,84000,0,0,0,239000,155000,84000,84000
058374,玉晶光凱基9A購03,0,0,0,0,0,0,0,0,0,84000,0,0,0,84000,0,84000,84000
054689,華新科永豐97購01,0,0,0,0,0,0,0,0,0,84000,0,0,0,84000,0,84000,84000
052860,旺宏凱基96購03  ,0,0,0,0,0,0,0,0,0,84000,0,0,0,100000,16000,84000,84000
056231,嘉聯益凱基97購02,0,0,0,0,0,0,0,0,0,84000,0,0,0,84000,0,84000,84000
07104P,聯發科元富99售04,0,0,0,0,0,0,0,0,0,83000,0,0,0,100000,17000,83000,83000
06230P,亞德客永豐97售03,0,0,0,0,0,0,0,0,0,83000,0,0,0,130000,47000,83000,83000
057511,健策統一98購02  ,0,0,0,0,0,0,0,0,0,83000,0,0,0,101000,18000,83000,83000
059938,凱美永豐99購01  ,0,0,0,0,0,0,0,0,0,83000,0,0,0,93000,10000,83000,83000
060685,康友元大9A購01  ,0,0,0,0,0,0,0,0,0,82000,0,0,0,116000,34000,82000,82000
060639,玉晶光永豐9A購05,0,0,0,0,0,0,0,0,0,82000,0,0,0,84000,2000,82000,82000
2505,國揚            ,358000,315000,43000,0,0,0,0,0,0,39000,0,0,0,40000,1000,39000,82000
055318,華通國票98購01  ,0,0,0,0,0,0,0,0,0,82000,0,0,0,402000,320000,82000,82000
055058,大毅永豐97購01  ,0,0,0,0,0,0,0,0,0,82000,0,0,0,82000,0,82000,82000
056615,燿華永豐98購02  ,0,0,0,0,0,0,0,0,0,82000,0,0,0,105000,23000,82000,82000
058184,鴻海永豐99購01  ,0,0,0,0,0,0,0,0,0,82000,0,0,0,82000,0,82000,82000
053962,聯茂永豐96購01  ,0,0,0,0,0,0,0,0,0,81000,0,0,0,90000,9000,81000,81000
057025,華新科凱基98購04,0,0,0,0,0,0,0,0,0,81000,0,0,0,81000,0,81000,81000
057982,帆宣永豐98購01  ,0,0,0,0,0,0,0,0,0,81000,0,0,0,81000,0,81000,81000
056786,亞光群益98購03  ,0,0,0,0,0,0,0,0,0,81000,0,0,0,81000,0,81000,81000
058481,玉晶光凱基9A購04,0,0,0,0,0,0,0,0,0,81000,0,0,0,83000,2000,81000,81000
059954,華新科康和99購01,0,0,0,0,0,0,0,0,0,81000,0,0,0,131000,50000,81000,81000
060216,鴻海凱基9A購17  ,0,0,0,0,0,0,0,0,0,80000,0,0,0,111000,31000,80000,80000
061077,國巨兆豐9B購01  ,0,0,0,0,0,0,0,0,0,80000,0,0,0,80000,0,80000,80000
061048,國巨中信9A購05  ,0,0,0,0,0,0,0,0,0,80000,0,0,0,80000,0,80000,80000
052101,滬深2X兆豐96購01,0,0,0,0,0,0,0,0,0,80000,0,0,0,80000,0,80000,80000
051602,南茂兆豐96購01  ,0,0,0,0,0,0,0,0,0,80000,0,0,0,80000,0,80000,80000
051553,牧德永豐96購02  ,0,0,0,0,0,0,0,0,0,80000,0,0,0,90000,10000,80000,80000
051570,和碩富邦97購01  ,0,0,0,0,0,0,0,0,0,80000,0,0,0,110000,30000,80000,80000
055528,華邦電群益97購01,0,0,0,0,0,0,0,0,0,80000,0,0,0,80000,0,80000,80000
052778,智原國票97購01  ,0,0,0,0,0,0,0,0,0,80000,0,0,0,80000,0,80000,80000
058646,聯茂富邦9A購01  ,0,0,0,0,0,0,0,0,0,80000,0,0,0,170000,90000,80000,80000
056343,高鐵凱基98購02  ,0,0,0,0,0,0,0,0,0,80000,0,0,0,80000,0,80000,80000
053103,瀚宇博元富96購01,0,0,0,0,0,0,0,0,0,80000,0,0,0,80000,0,80000,80000
058749,康控凱基99購03  ,0,0,0,0,0,0,0,0,0,80000,0,0,0,80000,0,80000,80000
056521,群創日盛98購01  ,0,0,0,0,0,0,0,0,0,80000,0,0,0,80000,0,80000,80000
056533,友達凱基9A購02  ,0,0,0,0,0,0,0,0,0,80000,0,0,0,80000,0,80000,80000
058785,臺股指國票99購04,0,0,0,0,0,0,0,0,0,80000,0,0,0,80000,0,80000,80000
058000,FBVIX群益9B購01 ,0,0,0,0,0,0,0,0,0,80000,0,0,0,80000,0,80000,80000
058100,聯茂國泰99購02  ,0,0,0,0,0,0,0,0,0,80000,0,0,0,198000,118000,80000,80000
057553,景碩凱基98購03  ,0,0,0,0,0,0,0,0,0,80000,0,0,0,94000,14000,80000,80000
056003,智伸科永豐97購02,0,0,0,0,0,0,0,0,0,80000,0,0,0,80000,0,80000,80000
057243,樺漢凱基99購01  ,0,0,0,0,0,0,0,0,0,80000,0,0,0,80000,0,80000,80000
059965,鴻海凱基99購16  ,0,0,0,0,0,0,0,0,0,80000,0,0,0,80000,0,80000,80000
059806,聯發科元富99購08,0,0,0,0,0,0,0,0,0,80000,0,0,0,80000,0,80000,80000
059434,全新元大99購05  ,0,0,0,0,0,0,0,0,0,80000,0,0,0,87000,7000,80000,80000
059488,大立光兆豐99購03,0,0,0,0,0,0,0,0,0,80000,0,0,0,80000,0,80000,80000
2520,冠德            ,258000,186000,72000,0,0,0,0,0,0,7000,34000,27000,7000,0,0,0,79000
06859P,元金2X中信9C售01,0,0,0,0,0,0,0,0,0,79000,0,0,0,284000,205000,79000,79000
052159,瑞昱永豐95購01  ,0,0,0,0,0,0,0,0,0,79000,0,0,0,93000,14000,79000,79000
050615,奇力新元大95購03,0,0,0,0,0,0,0,0,0,79000,0,0,0,91000,12000,79000,79000
055983,全新元富9A購02  ,0,0,0,0,0,0,0,0,0,79000,0,0,0,179000,100000,79000,79000
056192,智邦富邦98購01  ,0,0,0,0,0,0,0,0,0,79000,0,0,0,79000,0,79000,79000
059468,智邦元大99購02  ,0,0,0,0,0,0,0,0,0,79000,0,0,0,181000,102000,79000,79000
059119,華擎永豐99購02  ,0,0,0,0,0,0,0,0,0,79000,0,0,0,101000,22000,79000,79000
058236,大立光元大99購09,0,0,0,0,0,0,0,0,0,79000,0,0,0,80000,1000,79000,79000
059908,元金2X元大99購01,0,0,0,0,0,0,0,0,0,79000,0,0,0,263000,184000,79000,79000
1732,毛寶            ,142000,64000,78000,0,0,0,0,0,0,0,0,0,0,0,0,0,78000
00752,中信中國50      ,6000,6000,0,0,0,0,0,0,0,78000,0,0,0,349000,271000,78000,78000
052513,大立光凱基95購13,0,0,0,0,0,0,0,0,0,78000,0,0,0,78000,0,78000,78000
053867,創意元大96購04  ,0,0,0,0,0,0,0,0,0,78000,0,0,0,104000,26000,78000,78000
053895,智易群益96購02  ,0,0,0,0,0,0,0,0,0,78000,0,0,0,98000,20000,78000,78000
056288,健鼎永豐97購01  ,0,0,0,0,0,0,0,0,0,78000,0,0,0,78000,0,78000,78000
057798,貿聯兆豐99購01  ,0,0,0,0,0,0,0,0,0,78000,0,0,0,190000,112000,78000,78000
05538P,玉晶光國票97售02,0,0,0,0,0,0,0,0,0,78000,0,0,0,675000,597000,78000,78000
054831,緯穎國泰98購01  ,0,0,0,0,0,0,0,0,0,78000,0,0,0,188000,110000,78000,78000
056967,奇鋐永豐98購01  ,0,0,0,0,0,0,0,0,0,78000,0,0,0,134000,56000,78000,78000
055707,聯鈞永豐98購01  ,0,0,0,0,0,0,0,0,0,78000,0,0,0,80000,2000,78000,78000
057181,亞光元大98購02  ,0,0,0,0,0,0,0,0,0,78000,0,0,0,82000,4000,78000,78000
059915,聯發科元大99購32,0,0,0,0,0,0,0,0,0,78000,0,0,0,103000,25000,78000,78000
060217,國巨凱基9A購10  ,0,0,0,0,0,0,0,0,0,77000,0,0,0,97000,20000,77000,77000
055261,帆宣統一98購01  ,0,0,0,0,0,0,0,0,0,77000,0,0,0,77000,0,77000,77000
060109,茂林元大99購05  ,0,0,0,0,0,0,0,0,0,77000,0,0,0,132000,55000,77000,77000
057087,台郡統一99購01  ,0,0,0,0,0,0,0,0,0,77000,0,0,0,77000,0,77000,77000
059319,台光電元大99購04,0,0,0,0,0,0,0,0,0,77000,0,0,0,97000,20000,77000,77000
059844,大立光富邦9C購04,0,0,0,0,0,0,0,0,0,77000,0,0,0,77000,0,77000,77000
060534,友達麥證9A購01  ,0,0,0,80000,4000,76000,0,0,0,76000,0,0,0,80000,4000,76000,76000
058645,康控富邦01購01  ,0,0,0,0,0,0,0,0,0,76000,0,0,0,176000,100000,76000,76000
03434B,臺股指元大99熊10,0,0,0,0,0,0,0,0,0,76000,0,0,0,77000,1000,76000,76000
057024,義隆凱基99購01  ,0,0,0,0,0,0,0,0,0,76000,0,0,0,146000,70000,76000,76000
057834,聯發科元富02購07,0,0,0,0,0,0,0,0,0,76000,0,0,0,76000,0,76000,76000
057623,友訊國泰99購01  ,0,0,0,0,0,0,0,0,0,76000,0,0,0,76000,0,76000,76000
057388,奇鋐永豐98購02  ,0,0,0,0,0,0,0,0,0,76000,0,0,0,76000,0,76000,76000
059818,鴻海凱基99購14  ,0,0,0,0,0,0,0,0,0,76000,0,0,0,76000,0,76000,76000
061107,世芯元大9A購05  ,0,0,0,0,0,0,0,0,0,75000,0,0,0,92000,17000,75000,75000
060368,緯穎元富9A購03  ,0,0,0,0,0,0,0,0,0,75000,0,0,0,115000,40000,75000,75000
060275,元黃金元大9A購01,0,0,0,0,0,0,0,0,0,75000,0,0,0,208000,133000,75000,75000
1702,南僑            ,121000,41000,80000,0,0,0,0,1000,-1000,-4000,0,4000,-4000,0,0,0,75000
2488,漢平            ,98000,22000,76000,0,0,0,0,0,0,-1000,0,1000,-1000,0,0,0,75000
07601P,國巨統一9A售05  ,0,0,0,0,0,0,0,0,0,75000,0,0,0,80000,5000,75000,75000
00714,群益道瓊美國地產,0,0,0,0,0,0,0,0,0,75000,0,0,0,76000,1000,75000,75000
051800,旺宏永豐95購02  ,0,0,0,0,0,0,0,0,0,75000,0,0,0,75000,0,75000,75000
052490,禾伸堂國票95購01,0,0,0,0,0,0,0,0,0,75000,0,0,0,75000,0,75000,75000
052423,宏達電國票96購02,0,0,0,0,0,0,0,0,0,75000,0,0,0,84000,9000,75000,75000
051266,國巨富邦99購01  ,3000,8000,-5000,0,0,0,0,0,0,80000,0,0,0,97000,17000,80000,75000
055851,智原元大98購01  ,0,0,0,0,0,0,0,0,0,75000,0,0,0,75000,0,75000,75000
056065,奇鋐元大97購01  ,0,0,0,0,0,0,0,0,0,75000,0,0,0,83000,8000,75000,75000
057624,新日興國泰99購01,0,0,0,0,0,0,0,0,0,75000,0,0,0,102000,27000,75000,75000
057449,華新科元富99購02,0,0,0,0,0,0,0,0,0,75000,0,0,0,156000,81000,75000,75000
056480,京鼎元大98購02  ,0,0,0,0,0,0,0,0,0,75000,0,0,0,95000,20000,75000,75000
058250,台虹元大99購01  ,0,0,0,0,0,0,0,0,0,75000,0,0,0,75000,0,75000,75000
059168,奇力新凱基99購05,0,0,0,0,0,0,0,0,0,75000,0,0,0,100000,25000,75000,75000
1439,中和            ,229000,153000,76000,0,0,0,0,0,0,-2000,0,2000,-2000,0,0,0,74000
057438,禾伸堂國票99購01,0,0,0,0,0,0,0,0,0,74000,0,0,0,110000,36000,74000,74000
060130,瀚宇博永豐99購02,0,0,0,0,0,0,0,0,0,74000,0,0,0,81000,7000,74000,74000
059292,華新科元富9B購02,0,0,0,0,0,0,0,0,0,74000,0,0,0,94000,20000,74000,74000
056107,智易永豐97購02  ,0,0,0,0,0,0,0,0,0,74000,0,0,0,138000,64000,74000,74000
059201,祥碩永豐99購02  ,0,0,0,0,0,0,0,0,0,74000,0,0,0,89000,15000,74000,74000
060335,明泰康和9A購01  ,0,0,0,0,0,0,0,0,0,73000,0,0,0,120000,47000,73000,73000
060430,和潤永豐9A購01  ,0,0,0,0,0,0,0,0,0,73000,0,0,0,148000,75000,73000,73000
060428,瑞祺永豐9A購01  ,0,0,0,0,0,0,0,0,0,73000,0,0,0,285000,212000,73000,73000
060470,台勝科元大9A購03,0,0,0,0,0,0,0,0,0,73000,0,0,0,127000,54000,73000,73000
061062,和大凱基9A購02  ,0,0,0,0,0,0,0,0,0,73000,0,0,0,326000,253000,73000,73000
055172,凱美統一97購02  ,0,0,0,0,0,0,0,0,0,73000,0,0,0,121000,48000,73000,73000
054442,啟碁台新96購01  ,0,0,0,0,0,0,0,0,0,73000,0,0,0,73000,0,73000,73000
059985,華新科元大99購22,0,0,0,0,0,0,0,0,0,73000,0,0,0,73000,0,73000,73000
060110,茂林元大99購06  ,0,0,0,0,0,0,0,0,0,73000,0,0,0,431000,358000,73000,73000
059619,台積電日盛9A購04,0,0,0,0,0,0,0,0,0,73000,0,0,0,142000,69000,73000,73000
059130,台灣50群益9B購05,0,0,0,0,0,0,0,0,0,73000,0,0,0,73000,0,73000,73000
057943,可成國票99購03  ,0,0,0,0,0,0,0,0,0,73000,0,0,0,73000,0,73000,73000
07160P,台灣50中信03售04,0,0,0,0,0,0,0,0,0,72000,0,0,0,77000,5000,72000,72000
057775,南亞科群益98購02,0,0,0,0,0,0,0,0,0,72000,0,0,0,101000,29000,72000,72000
057720,日電貿元富98購01,0,0,0,0,0,0,0,0,0,72000,0,0,0,72000,0,72000,72000
052239,泰鼎國票97購01  ,0,0,0,0,0,0,0,0,0,72000,0,0,0,73000,1000,72000,72000
054203,滬深2X國票96購03,0,0,0,0,0,0,0,0,0,72000,0,0,0,72000,0,72000,72000
059123,訊芯永豐99購03  ,0,0,0,0,0,0,0,0,0,72000,0,0,0,217000,145000,72000,72000
058949,上銀群益99購02  ,0,0,0,0,0,0,0,0,0,72000,0,0,0,72000,0,72000,72000
055912,宏達電凱基98購03,0,0,0,0,0,0,0,0,0,72000,0,0,0,122000,50000,72000,72000
055589,台光電元大98購04,0,0,0,0,0,0,0,0,0,72000,0,0,0,72000,0,72000,72000
059788,華新科元大9A購05,0,0,0,0,0,0,0,0,0,72000,0,0,0,84000,12000,72000,72000
059717,國巨元大99購21  ,0,0,0,0,0,0,0,0,0,72000,0,0,0,78000,6000,72000,72000
07343P,高鐵康和99售01  ,0,0,0,0,0,0,0,0,0,71000,0,0,0,71000,0,71000,71000
2493,揚博            ,78000,6000,72000,0,0,0,0,0,0,-1000,0,1000,-1000,0,0,0,71000
060813,高鐵凱基9A購01  ,0,0,0,0,0,0,0,0,0,71000,0,0,0,166000,95000,71000,71000
060729,國巨群益9A購05  ,0,0,0,0,0,0,0,0,0,71000,0,0,0,71000,0,71000,71000
061074,儒鴻兆豐9B購01  ,0,0,0,0,0,0,0,0,0,71000,0,0,0,262000,191000,71000,71000
052274,大立光群益95購03,0,0,0,0,0,0,0,0,0,71000,0,0,0,71000,0,71000,71000
00662,富邦NASDAQ      ,0,0,0,0,0,0,0,0,0,71000,0,42000,-42000,216000,103000,113000,71000
054484,仁寶台新96購01  ,0,0,0,0,0,0,0,0,0,71000,0,0,0,71000,0,71000,71000
055324,TPK國票98購03   ,0,0,0,0,0,0,0,0,0,71000,0,0,0,71000,0,71000,71000
057514,華新科元富99購03,0,0,0,0,0,0,0,0,0,71000,0,0,0,145000,74000,71000,71000
058703,台積電元大99購16,0,0,0,0,0,0,0,0,0,71000,0,0,0,113000,42000,71000,71000
056622,高鐵永豐98購01  ,0,0,0,0,0,0,0,0,0,71000,0,0,0,184000,113000,71000,71000
056737,國巨凱基9A購01  ,0,0,0,0,0,0,0,0,0,71000,0,0,0,71000,0,71000,71000
060612,世紀鋼凱基9A購01,0,0,0,0,0,0,0,0,0,70000,0,0,0,90000,20000,70000,70000
060955,大立光群益9A購02,0,0,0,0,0,0,0,0,0,70000,0,0,0,90000,20000,70000,70000
055234,昇陽半國票98購02,0,0,0,0,0,0,0,0,0,70000,0,0,0,70000,0,70000,70000
053321,智原群益96購02  ,0,0,0,0,0,0,0,0,0,70000,0,0,0,80000,10000,70000,70000
00703,台新MSCI中國    ,0,0,0,0,0,0,0,0,0,70000,0,0,0,130000,60000,70000,70000
047689,瑞昱富邦97購01  ,0,0,0,0,0,0,0,0,0,70000,0,0,0,70000,0,70000,70000
049814,超眾元大95購04  ,0,0,0,0,0,0,0,0,0,70000,0,0,0,70000,0,70000,70000
052235,聯發科國票96購02,0,0,0,0,0,0,0,0,0,70000,0,0,0,70000,0,70000,70000
054167,揚明光凱基98購01,0,0,0,0,0,0,0,0,0,70000,0,0,0,70000,0,70000,70000
052077,可成元富98購02  ,0,0,0,0,0,0,0,0,0,70000,0,0,0,70000,0,70000,70000
058751,南茂凱基9A購01  ,0,0,0,0,0,0,0,0,0,70000,0,0,0,70000,0,70000,70000
058031,旺宏永豐98購04  ,0,0,0,0,0,0,0,0,0,70000,0,0,0,70000,0,70000,70000
057494,玉晶光元大99購09,0,0,0,0,0,0,0,0,0,70000,0,0,0,78000,8000,70000,70000
060185,聯發科元富04購01,0,0,0,0,0,0,0,0,0,70000,0,0,0,115000,45000,70000,70000
057406,茂林群益98購03  ,0,0,0,0,0,0,0,0,0,70000,0,0,0,170000,100000,70000,70000
059955,美食康和99購01  ,0,0,0,0,0,0,0,0,0,70000,0,0,0,95000,25000,70000,70000
059400,滬深2X元富9C購04,0,0,0,0,0,0,0,0,0,70000,0,0,0,70000,0,70000,70000
2882A,國泰特          ,0,0,0,0,0,0,0,0,0,70000,70000,0,70000,0,0,0,70000
061111,台表科元大9A購02,0,0,0,0,0,0,0,0,0,69000,0,0,0,71000,2000,69000,69000
061087,國巨統一01購04  ,0,0,0,0,0,0,0,0,0,69000,0,0,0,100000,31000,69000,69000
0061,元大寶滬深      ,115000,7000,108000,0,0,0,0,0,0,-39000,0,100000,-100000,61000,0,61000,69000
054550,旺宏凱基98購02  ,0,0,0,0,0,0,0,0,0,69000,0,0,0,142000,73000,69000,69000
058264,瑞昱永豐99購01  ,0,0,0,0,0,0,0,0,0,69000,0,0,0,164000,95000,69000,69000
056481,創意元大98購01  ,0,0,0,0,0,0,0,0,0,69000,0,0,0,79000,10000,69000,69000
059326,康友元大99購01  ,0,0,0,0,0,0,0,0,0,69000,0,0,0,98000,29000,69000,69000
059825,嘉晶凱基99購02  ,0,0,0,0,0,0,0,0,0,69000,0,0,0,89000,20000,69000,69000
060679,聯詠元大9A購04  ,0,0,0,0,0,0,0,0,0,68000,0,0,0,68000,0,68000,68000
060291,高鐵元大9A購01  ,0,0,0,0,0,0,0,0,0,68000,0,0,0,106000,38000,68000,68000
054932,台肥元大97購01  ,0,0,0,0,0,0,0,0,0,68000,0,0,0,68000,0,68000,68000
052857,大成鋼凱基96購01,0,0,0,0,0,0,0,0,0,68000,0,0,0,68000,0,68000,68000
00783,富邦中証500     ,24000,1000,23000,0,0,0,0,0,0,45000,0,0,0,895000,850000,45000,68000
051731,聯電國票96購02  ,0,0,0,0,0,0,0,0,0,68000,0,0,0,68000,0,68000,68000
053984,康友元大96購05  ,0,0,0,0,0,0,0,0,0,68000,0,0,0,68000,0,68000,68000
058526,鈺齊元大99購02  ,0,0,0,0,0,0,0,0,0,68000,0,0,0,100000,32000,68000,68000
058892,元油2X元大9C購08,0,0,0,0,0,0,0,0,0,68000,0,0,0,330000,262000,68000,68000
057859,神達康和98購01  ,0,0,0,0,0,0,0,0,0,68000,0,0,0,68000,0,68000,68000
057392,福懋科永豐98購01,0,0,0,0,0,0,0,0,0,68000,0,0,0,79000,11000,68000,68000
05620P,大立光富邦9B售01,0,0,0,0,0,0,0,0,0,68000,0,0,0,68000,0,68000,68000
059976,道瓊銀元大99購01,0,0,0,0,0,0,0,0,0,68000,0,0,0,70000,2000,68000,68000
059253,康控凱基9B購02  ,0,0,0,0,0,0,0,0,0,68000,0,0,0,215000,147000,68000,68000
060723,致新永豐9A購01  ,0,0,0,0,0,0,0,0,0,67000,0,0,0,232000,165000,67000,67000
060983,南亞科元大9A購06,0,0,0,0,0,0,0,0,0,67000,0,0,0,82000,15000,67000,67000
061067,貿聯凱基9A購03  ,0,0,0,0,0,0,0,0,0,67000,0,0,0,70000,3000,67000,67000
060806,華新科群益9A購03,0,0,0,0,0,0,0,0,0,67000,0,0,0,88000,21000,67000,67000
1708,東鹼            ,121000,54000,67000,0,0,0,0,0,0,0,0,0,0,0,0,0,67000
07303P,臺股指元大9A售36,0,0,0,0,0,0,0,0,0,67000,0,0,0,502000,435000,67000,67000
07514P,台積電元大9A售14,0,0,0,0,0,0,0,0,0,67000,0,0,0,67000,0,67000,67000
054323,旺宏台新96購02  ,0,0,0,0,0,0,0,0,0,67000,0,0,0,96000,29000,67000,67000
052712,旺宏凱基96購02  ,0,0,0,0,0,0,0,0,0,67000,0,0,0,254000,187000,67000,67000
057824,日月光元大98購01,0,0,0,0,0,0,0,0,0,67000,0,0,0,70000,3000,67000,67000
058091,欣興元大99購03  ,0,0,0,0,0,0,0,0,0,67000,0,0,0,81000,14000,67000,67000
058973,麗豐永豐99購01  ,0,0,0,0,0,0,0,0,0,67000,0,0,0,148000,81000,67000,67000
05978P,麗豐永豐96售02  ,0,0,0,0,0,0,0,0,0,67000,0,0,0,67000,0,67000,67000
3673,TPK-KY          ,534000,415000,119000,0,0,0,0,0,0,-52000,0,25000,-25000,8000,35000,-27000,67000
057802,卜蜂元大98購01  ,0,0,0,0,0,0,0,0,0,66000,0,0,0,66000,0,66000,66000
057736,鴻海富邦99購04  ,0,0,0,0,0,0,0,0,0,66000,0,0,0,75000,9000,66000,66000
054883,億光統一97購01  ,0,0,0,0,0,0,0,0,0,66000,0,0,0,114000,48000,66000,66000
055236,建準台新98購01  ,0,0,0,0,0,0,0,0,0,66000,0,0,0,66000,0,66000,66000
054694,聯鈞永豐97購01  ,0,0,0,0,0,0,0,0,0,66000,0,0,0,76000,10000,66000,66000
057997,旺宏第一9C購01  ,0,0,0,0,0,0,0,0,0,66000,0,0,0,342000,276000,66000,66000
058018,南亞科凱基99購03,0,0,0,0,0,0,0,0,0,66000,0,0,0,66000,0,66000,66000
057447,智邦元富02購01  ,0,0,0,0,0,0,0,0,0,66000,0,0,0,218000,152000,66000,66000
2314,台揚            ,455000,388000,67000,0,0,0,0,0,0,-2000,0,2000,-2000,0,0,0,65000
060854,台積電富邦9C購08,0,0,0,0,0,0,0,0,0,65000,0,0,0,90000,25000,65000,65000
061085,聯茂兆豐9A購01  ,0,0,0,0,0,0,0,0,0,65000,0,0,0,269000,204000,65000,65000
061112,台表科元大9A購03,0,0,0,0,0,0,0,0,0,65000,0,0,0,66000,1000,65000,65000
060465,聯發科元大9A購02,0,0,0,0,0,0,0,0,0,65000,0,0,0,102000,37000,65000,65000
054673,京鼎國泰98購01  ,0,0,0,0,0,0,0,0,0,65000,0,0,0,65000,0,65000,65000
058359,瑞昱凱基99購01  ,0,0,0,0,0,0,0,0,0,65000,0,0,0,78000,13000,65000,65000
053804,富邦金凱基96購01,0,0,0,0,0,0,0,0,0,65000,0,0,0,78000,13000,65000,65000
054271,中石化中信99購01,0,0,0,0,0,0,0,0,0,65000,0,0,0,85000,20000,65000,65000
05684P,臺股指元大96售09,0,0,0,0,0,0,0,0,0,65000,0,0,0,66000,1000,65000,65000
056693,國產群益98購01  ,0,0,0,0,0,0,0,0,0,65000,0,0,0,95000,30000,65000,65000
3048,益登            ,139000,72000,67000,0,0,0,0,0,0,-2000,0,2000,-2000,0,0,0,65000
060718,中磊永豐9A購01  ,0,0,0,0,0,0,0,0,0,64000,0,0,0,66000,2000,64000,64000
060265,宏達電國票9A購02,0,0,0,0,0,0,0,0,0,64000,0,0,0,82000,18000,64000,64000
07595P,台灣50中信03售07,0,0,0,0,0,0,0,0,0,64000,0,0,0,64000,0,64000,64000
07190P,臺股指富邦9C售02,0,0,0,0,0,0,0,0,0,64000,0,0,0,71000,7000,64000,64000
056365,欣興元大98購01  ,0,0,0,0,0,0,0,0,0,64000,0,0,0,76000,12000,64000,64000
058238,奇鋐元大99購02  ,0,0,0,0,0,0,0,0,0,64000,0,0,0,72000,8000,64000,64000
060424,中租永豐9A購01  ,0,0,0,0,0,0,0,0,0,63000,0,0,0,121000,58000,63000,63000
061045,儒鴻第一9A購01  ,0,0,0,0,0,0,0,0,0,63000,0,0,0,73000,10000,63000,63000
053083,中環元大99購01  ,0,0,0,0,0,0,0,0,0,63000,0,0,0,63000,0,63000,63000
052837,友達國泰97購01  ,0,0,0,0,0,0,0,0,0,63000,0,0,0,63000,0,63000,63000
054872,瀚宇博群益98購01,0,0,0,0,0,0,0,0,0,63000,0,0,0,63000,0,63000,63000
056629,昇陽半永豐98購01,0,0,0,0,0,0,0,0,0,63000,0,0,0,103000,40000,63000,63000
059223,大立光元大99購14,0,0,0,0,0,0,0,0,0,63000,0,0,0,63000,0,63000,63000
060953,富邦金群益9A購01,0,0,0,0,0,0,0,0,0,62000,0,0,0,183000,121000,62000,62000
060386,台勝科凱基9B購01,0,0,0,0,0,0,0,0,0,62000,0,0,0,133000,71000,62000,62000
06938P,南電元大98售03  ,0,0,0,0,0,0,0,0,0,62000,0,0,0,62000,0,62000,62000
050135,禾伸堂兆豐95購01,0,0,0,0,0,0,0,0,0,62000,0,0,0,62000,0,62000,62000
053800,華通凱基97購03  ,0,0,0,0,0,0,0,0,0,62000,0,0,0,67000,5000,62000,62000
057322,旺宏群益98購04  ,0,0,0,0,0,0,0,0,0,62000,0,0,0,63000,1000,62000,62000
057111,立積群益98購02  ,0,0,0,0,0,0,0,0,0,62000,0,0,0,62000,0,62000,62000
055594,華新科元大98購02,0,0,0,0,0,0,0,0,0,62000,0,0,0,62000,0,62000,62000
059783,旺宏元大99購17  ,0,0,0,0,0,0,0,0,0,62000,0,0,0,63000,1000,62000,62000
059755,宏達電國泰9A購01,0,0,0,0,0,0,0,0,0,62000,0,0,0,126000,64000,62000,62000
057934,華新科群益98購07,0,0,0,0,0,0,0,0,0,62000,0,0,0,62000,0,62000,62000
6166,凌華            ,102000,33000,69000,0,0,0,0,0,0,-7000,0,4000,-4000,0,3000,-3000,62000
060374,儒鴻元富9A購01  ,0,0,0,0,0,0,0,0,0,61000,0,0,0,164000,103000,61000,61000
060481,巨大元大9A購01  ,0,0,0,0,0,0,0,0,0,61000,0,0,0,145000,84000,61000,61000
053315,漢唐群益96購02  ,0,0,0,0,0,0,0,0,0,61000,0,0,0,61000,0,61000,61000
058380,臺股指凱基99購15,0,0,0,0,0,0,0,0,0,61000,0,0,0,61000,0,61000,61000
057789,上銀統一9A購01  ,0,0,0,0,0,0,0,0,0,61000,0,0,0,71000,10000,61000,61000
050674,瑞昱富邦94購02  ,0,0,0,0,0,0,0,0,0,61000,0,0,0,61000,0,61000,61000
048696,台達電國票96購01,0,0,0,0,0,0,0,0,0,61000,0,0,0,61000,0,61000,61000
058171,國巨凱基9A購07  ,0,0,0,0,0,0,0,0,0,61000,0,0,0,61000,0,61000,61000
057647,欣興元大98購10  ,0,0,0,0,0,0,0,0,0,61000,0,0,0,63000,2000,61000,61000
057324,億光群益98購01  ,0,0,0,0,0,0,0,0,0,61000,0,0,0,86000,25000,61000,61000
059224,大立光元大99購15,0,0,0,0,0,0,0,0,0,61000,0,0,0,62000,1000,61000,61000
059075,FBVIX元大99購01 ,0,0,0,0,0,0,0,0,0,61000,0,0,0,170000,109000,61000,61000
059063,康控凱基99購04  ,0,0,0,0,0,0,0,0,0,61000,0,0,0,61000,0,61000,61000
060295,貿聯元大9A購03  ,0,0,0,0,0,0,0,0,0,60000,0,0,0,60000,0,60000,60000
061055,康控群益9A購01  ,0,0,0,0,0,0,0,0,0,60000,0,0,0,60000,0,60000,60000
061217,臺股指元大9A購54,0,0,0,0,0,0,0,0,0,60000,0,0,0,60000,0,60000,60000
061180,華擎凱基9B購01  ,0,0,0,0,0,0,0,0,0,60000,0,0,0,60000,0,60000,60000
07069P,欣興元富99售02  ,0,0,0,0,0,0,0,0,0,60000,0,0,0,60000,0,60000,60000
07547P,緯穎凱基9A售05  ,0,0,0,0,0,0,0,0,0,60000,0,0,0,62000,2000,60000,60000
050548,華固凱基95購01  ,0,0,0,0,0,0,0,0,0,60000,0,0,0,60000,0,60000,60000
050096,國巨國泰95購05  ,0,0,0,0,0,0,0,0,0,60000,0,0,0,60000,0,60000,60000
046574,泰鼎國泰94購01  ,0,0,0,0,0,0,0,0,0,60000,0,0,0,60000,0,60000,60000
054279,揚明光群益98購01,0,0,0,0,0,0,0,0,0,60000,0,0,0,60000,0,60000,60000
052279,旺宏凱基95購07  ,0,0,0,0,0,0,0,0,0,60000,0,0,0,60000,0,60000,60000
050911,光磊中信98購01  ,0,0,0,0,0,0,0,0,0,60000,0,0,0,60000,0,60000,60000
057827,康友元大98購03  ,0,0,0,0,0,0,0,0,0,60000,0,0,0,71000,11000,60000,60000
058360,台光電凱基9A購02,0,0,0,0,0,0,0,0,0,60000,0,0,0,60000,0,60000,60000
055545,國巨凱基97購06  ,0,0,0,0,0,0,0,0,0,60000,0,0,0,60000,0,60000,60000
055302,達方元大97購01  ,0,0,0,0,0,0,0,0,0,60000,0,0,0,130000,70000,60000,60000
052624,微星亞東97購01  ,0,0,0,0,0,0,0,0,0,60000,0,0,0,60000,0,60000,60000
054954,華新科元大97購06,0,0,0,0,0,0,0,0,0,60000,0,0,0,60000,0,60000,60000
057158,義隆永豐99購01  ,0,0,0,0,0,0,0,0,0,60000,0,0,0,758000,698000,60000,60000
057163,上銀元大98購04  ,0,0,0,0,0,0,0,0,0,60000,0,0,0,75000,15000,60000,60000
060096,聯發科元大99購43,0,0,0,0,0,0,0,0,0,60000,0,0,0,65000,5000,60000,60000
058132,義隆元大99購03  ,0,0,0,0,0,0,0,0,0,60000,0,0,0,313000,253000,60000,60000
057055,立積元大99購01  ,0,0,0,0,0,0,0,0,0,60000,0,0,0,157000,97000,60000,60000
059164,旺宏凱基99購06  ,0,0,0,0,0,0,0,0,0,60000,0,0,0,110000,50000,60000,60000
059160,華通凱基99購03  ,0,0,0,0,0,0,0,0,0,60000,0,0,0,60000,0,60000,60000
058791,鴻海元大99購17  ,0,0,0,0,0,0,0,0,0,60000,0,0,0,68000,8000,60000,60000
058819,華通國泰9B購01  ,0,0,0,0,0,0,0,0,0,60000,0,0,0,80000,20000,60000,60000
057909,台光電兆豐98購01,0,0,0,0,0,0,0,0,0,60000,0,0,0,190000,130000,60000,60000
059401,牧德元富99購01  ,0,0,0,0,0,0,0,0,0,60000,0,0,0,60000,0,60000,60000
059920,宏達電元大99購07,0,0,0,0,0,0,0,0,0,60000,0,0,0,85000,25000,60000,60000
07147P,高鐵元大99售01  ,0,0,0,0,0,0,0,0,0,59000,0,0,0,100000,41000,59000,59000
1711,永光            ,105000,46000,59000,0,0,0,0,0,0,0,0,0,0,0,0,0,59000
1338,廣華-KY         ,96000,37000,59000,0,0,0,0,0,0,0,0,0,0,0,0,0,59000
060960,金像電凱基9B購01,0,0,0,0,0,0,0,0,0,59000,0,0,0,69000,10000,59000,59000
060794,景碩永豐9A購02  ,0,0,0,0,0,0,0,0,0,59000,0,0,0,59000,0,59000,59000
060469,台勝科元大9A購02,0,0,0,0,0,0,0,0,0,59000,0,0,0,109000,50000,59000,59000
054709,宏達電統一97購01,0,0,0,0,0,0,0,0,0,59000,0,0,0,59000,0,59000,59000
053836,亞光永豐96購02  ,0,0,0,0,0,0,0,0,0,59000,0,0,0,59000,0,59000,59000
03677C,臺股指元大05牛02,0,0,0,0,0,0,0,0,0,59000,0,0,0,194000,135000,59000,59000
058839,瑞儀中信99購02  ,0,0,0,0,0,0,0,0,0,59000,0,0,0,147000,88000,59000,59000
056559,華通群益98購02  ,0,0,0,0,0,0,0,0,0,59000,0,0,0,81000,22000,59000,59000
057413,臺股指群益9C購04,0,0,0,0,0,0,0,0,0,59000,0,0,0,94000,35000,59000,59000
059360,全新永豐99購02  ,0,0,0,0,0,0,0,0,0,59000,0,0,0,59000,0,59000,59000
6477,安集            ,80000,20000,60000,0,0,0,0,0,0,-1000,0,1000,-1000,0,0,0,59000
060731,奇力新群益9A購01,0,0,0,0,0,0,0,0,0,58000,0,0,0,73000,15000,58000,58000
060242,潤泰全元大9C購01,0,0,0,0,0,0,0,0,0,58000,0,0,0,168000,110000,58000,58000
061034,晶豪科永豐9A購01,0,0,0,0,0,0,0,0,0,58000,0,0,0,108000,50000,58000,58000
052612,康舒元大97購01  ,0,0,0,0,0,0,0,0,0,58000,0,0,0,68000,10000,58000,58000
053569,漢唐統一98購01  ,0,0,0,0,0,0,0,0,0,58000,0,0,0,58000,0,58000,58000
053230,達方台新97購01  ,0,0,0,0,0,0,0,0,0,58000,0,0,0,58000,0,58000,58000
054842,台達電兆豐98購01,0,0,0,0,0,0,0,0,0,58000,0,0,0,71000,13000,58000,58000
055806,致新永豐97購02  ,0,0,0,0,0,0,0,0,0,58000,0,0,0,78000,20000,58000,58000
060015,國巨康和99購03  ,0,0,0,0,0,0,0,0,0,58000,0,0,0,67000,9000,58000,58000
058262,大立光富邦9C購02,0,0,0,0,0,0,0,0,0,58000,0,0,0,98000,40000,58000,58000
3669,圓展            ,403000,345000,58000,0,0,0,0,0,0,0,0,0,0,0,0,0,58000
059867,華邦電凱基99購02,0,0,0,0,0,0,0,0,0,58000,0,0,0,148000,90000,58000,58000
060999,國巨兆豐9A購01  ,0,0,0,0,0,0,0,0,0,57000,0,0,0,71000,14000,57000,57000
060912,華新科元大9A購10,0,0,0,0,0,0,0,0,0,57000,0,0,0,97000,40000,57000,57000
060228,亞德客元大9A購01,0,0,0,0,0,0,0,0,0,57000,0,0,0,61000,4000,57000,57000
053721,國泰金凱基97購01,0,0,0,0,0,0,0,0,0,57000,0,0,0,64000,7000,57000,57000
051531,國巨國票96購04  ,0,0,0,0,0,0,0,0,0,57000,0,0,0,86000,29000,57000,57000
050651,大立光凱基96購02,0,0,0,0,0,0,0,0,0,57000,0,0,0,67000,10000,57000,57000
058958,台表科國票9A購03,0,0,0,0,0,0,0,0,0,57000,0,0,0,69000,12000,57000,57000
056660,臺股指元大9A購07,0,0,0,0,0,0,0,0,0,57000,0,0,0,57000,0,57000,57000
058216,TPK群益99購01   ,0,0,0,0,0,0,0,0,0,57000,0,0,0,119000,62000,57000,57000
057320,玉晶光凱基98購01,0,0,0,0,0,0,0,0,0,57000,0,0,0,62000,5000,57000,57000
9911,櫻花            ,320000,259000,61000,0,0,0,0,1000,-1000,-3000,0,3000,-3000,0,0,0,57000
060746,玉晶光國票9B購02,0,0,0,0,0,0,0,0,0,56000,0,0,0,59000,3000,56000,56000
060617,華新科元大9A購08,0,0,0,0,0,0,0,0,0,56000,0,0,0,117000,61000,56000,56000
060421,華擎永豐9A購01  ,0,0,0,0,0,0,0,0,0,56000,0,0,0,103000,47000,56000,56000
060922,金像電永豐9A購01,0,0,0,0,0,0,0,0,0,56000,0,0,0,78000,22000,56000,56000
2329,華泰            ,1261000,1251000,10000,0,0,0,0,4000,-4000,50000,0,15000,-15000,65000,0,65000,56000
04346P,大立光兆豐95售02,0,0,0,0,0,0,0,0,0,56000,0,0,0,56000,0,56000,56000
051423,GIS國票97購01   ,0,0,0,0,0,0,0,0,0,56000,0,0,0,56000,0,56000,56000
056265,國泰金統一97購01,0,0,0,0,0,0,0,0,0,56000,0,0,0,58000,2000,56000,56000
052674,智邦國泰98購01  ,0,0,0,0,0,0,0,0,0,56000,0,0,0,66000,10000,56000,56000
052895,台積電群益96購04,0,0,0,0,0,0,0,0,0,56000,0,0,0,156000,100000,56000,56000
056198,台光電永豐97購02,0,0,0,0,0,0,0,0,0,56000,0,0,0,76000,20000,56000,56000
055974,上銀統一97購05  ,0,0,0,0,0,0,0,0,0,56000,0,0,0,76000,20000,56000,56000
059982,聯發科元大99購37,0,0,0,0,0,0,0,0,0,56000,0,0,0,337000,281000,56000,56000
058408,華通兆豐99購02  ,0,0,0,0,0,0,0,0,0,56000,0,0,0,64000,8000,56000,56000
3059,華晶科          ,124000,66000,58000,0,0,0,0,0,0,-2000,0,2000,-2000,0,0,0,56000
07530P,聯發科凱基9A售11,0,0,0,0,0,0,0,0,0,55000,0,0,0,435000,380000,55000,55000
060942,智邦國票9A購02  ,0,0,0,0,0,0,0,0,0,55000,0,0,0,114000,59000,55000,55000
061169,GIS兆豐9A購01   ,0,0,0,0,0,0,0,0,0,55000,0,0,0,75000,20000,55000,55000
060680,玉晶光元大9C購03,0,0,0,0,0,0,0,0,0,55000,0,0,0,128000,73000,55000,55000
052764,景碩群益98購01  ,0,0,0,0,0,0,0,0,0,55000,0,0,0,57000,2000,55000,55000
054830,世芯國泰99購01  ,0,0,0,0,0,0,0,0,0,55000,0,0,0,74000,19000,55000,55000
055237,晶豪科台新97購01,0,0,0,0,0,0,0,0,0,55000,0,0,0,55000,0,55000,55000
055069,帆宣永豐97購01  ,0,0,0,0,0,0,0,0,0,55000,0,0,0,55000,0,55000,55000
053448,智易凱基96購03  ,0,0,0,0,0,0,0,0,0,55000,0,0,0,55000,0,55000,55000
049922,禾伸堂元大95購01,0,0,0,0,0,0,0,0,0,55000,0,0,0,55000,0,55000,55000
00650L,FH香港正2       ,0,1000,-1000,0,0,0,0,0,0,56000,0,0,0,228000,172000,56000,55000
058965,祥碩兆豐99購02  ,0,0,0,0,0,0,0,0,0,55000,0,0,0,58000,3000,55000,55000
056819,奇力新永豐98購01,0,0,0,0,0,0,0,0,0,55000,0,0,0,60000,5000,55000,55000
058085,景碩群益9A購01  ,0,0,0,0,0,0,0,0,0,55000,0,0,0,55000,0,55000,55000
059078,FBVIX元大99購06 ,0,0,0,0,0,0,0,0,0,55000,0,0,0,90000,35000,55000,55000
059747,台達電台新99購01,0,0,0,0,0,0,0,0,0,55000,0,0,0,103000,48000,55000,55000
059748,聯發科台新99購03,0,0,0,0,0,0,0,0,0,55000,0,0,0,90000,35000,55000,55000
060212,華航康和9A購01  ,0,0,0,0,0,0,0,0,0,55000,0,0,0,60000,5000,55000,55000
057631,康控永豐98購02  ,0,0,0,0,0,0,0,0,0,55000,0,0,0,55000,0,55000,55000
055936,彩晶群益98購02  ,0,0,0,0,0,0,0,0,0,55000,0,0,0,79000,24000,55000,55000
4164,承業醫          ,94000,36000,58000,0,0,0,0,0,0,-3000,1000,4000,-3000,0,0,0,55000
6541,泰福-KY         ,107000,52000,55000,0,0,0,0,0,0,0,0,0,0,0,0,0,55000
059911,國巨元大99購27  ,0,0,0,0,0,0,0,0,0,55000,0,0,0,241000,186000,55000,55000
060627,國巨國泰9B購05  ,0,0,0,0,0,0,0,0,0,54000,0,0,0,426000,372000,54000,54000
06347P,祥碩元富97售02  ,0,0,0,0,0,0,0,0,0,54000,0,0,0,54000,0,54000,54000
2399,映泰            ,101000,46000,55000,0,0,0,0,0,0,-1000,0,1000,-1000,0,0,0,54000
050105,力山元大95購02  ,0,0,0,0,0,0,0,0,0,54000,0,0,0,60000,6000,54000,54000
052453,崇越元大95購01  ,0,0,0,0,0,0,0,0,0,54000,0,0,0,54000,0,54000,54000
055029,帆宣國泰99購01  ,0,0,0,0,0,0,0,0,0,54000,0,0,0,54000,0,54000,54000
05454P,奇鋐群益95售04  ,0,0,0,0,0,0,0,0,0,54000,0,0,0,77000,23000,54000,54000
054623,華新科第一97購01,0,0,0,0,0,0,0,0,0,54000,0,0,0,54000,0,54000,54000
060032,利勤永豐99購01  ,0,0,0,0,0,0,0,0,0,54000,0,0,0,54000,0,54000,54000
057927,勤誠凱基98購01  ,0,0,0,0,0,0,0,0,0,54000,0,0,0,105000,51000,54000,54000
059526,鴻海凱基99購12  ,0,0,0,0,0,0,0,0,0,54000,0,0,0,54000,0,54000,54000
5531,鄉林            ,95101,42000,53101,0,0,0,0,0,0,0,0,0,0,0,0,0,53101
6672,騰輝電子-KY     ,111000,57000,54000,0,0,0,0,0,0,-1000,0,1000,-1000,0,0,0,53000
060797,世芯永豐9A購04  ,0,0,0,0,0,0,0,0,0,53000,0,0,0,70000,17000,53000,53000
060856,健策富邦9B購02  ,0,0,0,0,0,0,0,0,0,53000,0,0,0,167000,114000,53000,53000
060654,大毅群益9B購01  ,0,0,0,0,0,0,0,0,0,53000,0,0,0,80000,27000,53000,53000
060558,億豐凱基9A購01  ,0,0,0,0,0,0,0,0,0,53000,0,0,0,67000,14000,53000,53000
054928,帆宣凱基98購01  ,0,0,0,0,0,0,0,0,0,53000,0,0,0,153000,100000,53000,53000
055534,晶技群益97購03  ,0,0,0,0,0,0,0,0,0,53000,0,0,0,53000,0,53000,53000
055320,建準國票98購01  ,0,0,0,0,0,0,0,0,0,53000,0,0,0,53000,0,53000,53000
053426,創意永豐96購04  ,0,0,0,0,0,0,0,0,0,53000,0,0,0,55000,2000,53000,53000
056286,奇鋐永豐97購01  ,0,0,0,0,0,0,0,0,0,53000,0,0,0,54000,1000,53000,53000
052447,聯發科元大96購04,0,0,0,0,0,0,0,0,0,53000,0,0,0,59000,6000,53000,53000
052529,力成元大95購03  ,0,0,0,0,0,0,0,0,0,53000,0,0,0,206000,153000,53000,53000
056418,台光電元富98購01,0,0,0,0,0,0,0,0,0,53000,0,0,0,272000,219000,53000,53000
058520,智易元大99購03  ,0,0,0,0,0,0,0,0,0,53000,0,0,0,177000,124000,53000,53000
058521,日月光元大99購01,0,0,0,0,0,0,0,0,0,53000,0,0,0,53000,0,53000,53000
058606,聯發科元大99購13,0,0,0,0,0,0,0,0,0,53000,0,0,0,74000,21000,53000,53000
055716,致茂元大97購01  ,0,0,0,0,0,0,0,0,0,53000,0,0,0,73000,20000,53000,53000
060460,鴻海元大9A購08  ,0,0,0,0,0,0,0,0,0,52000,0,0,0,52000,0,52000,52000
060624,玉晶光元大9C購02,0,0,0,0,0,0,0,0,0,52000,0,0,0,52000,0,52000,52000
061150,國巨群益9A購09  ,0,0,0,0,0,0,0,0,0,52000,0,0,0,53000,1000,52000,52000
1315,達新            ,85000,28000,57000,0,0,0,0,1000,-1000,-4000,0,4000,-4000,0,0,0,52000
050673,旺宏富邦96購02  ,0,0,0,0,0,0,0,0,0,52000,0,0,0,52000,0,52000,52000
020000,富邦特選蘋果N   ,0,0,0,0,0,0,0,0,0,52000,0,0,0,67000,15000,52000,52000
055230,大毅國票98購01  ,0,0,0,0,0,0,0,0,0,52000,0,0,0,63000,11000,52000,52000
054720,禾伸堂永豐97購01,0,0,0,0,0,0,0,0,0,52000,0,0,0,72000,20000,52000,52000
057956,全新元大99購04  ,0,0,0,0,0,0,0,0,0,52000,0,0,0,52000,0,52000,52000
056438,旺宏凱基98購05  ,0,0,0,0,0,0,0,0,0,52000,0,0,0,53000,1000,52000,52000
056462,訊芯凱基98購03  ,0,0,0,0,0,0,0,0,0,52000,0,0,0,52000,0,52000,52000
056408,奇鋐國票99購01  ,0,0,0,0,0,0,0,0,0,52000,0,0,0,52000,0,52000,52000
058438,大立光統一9B購01,0,0,0,0,0,0,0,0,0,52000,0,0,0,86000,34000,52000,52000
060458,華通元大9A購02  ,0,0,0,0,0,0,0,0,0,51000,0,0,0,56000,5000,51000,51000
055097,福懋科群益97購01,0,0,0,0,0,0,0,0,0,51000,0,0,0,51000,0,51000,51000
03064X,元展59          ,0,0,0,0,0,0,0,0,0,51000,0,0,0,51000,0,51000,51000
050351,華新科群益95購02,0,0,0,0,0,0,0,0,0,51000,0,0,0,109000,58000,51000,51000
053954,貿聯康和96購01  ,0,0,0,0,0,0,0,0,0,51000,0,0,0,52000,1000,51000,51000
054254,晶豪科元大96購02,0,0,0,0,0,0,0,0,0,51000,0,0,0,51000,0,51000,51000
056710,漢唐永豐98購01  ,0,0,0,0,0,0,0,0,0,51000,0,0,0,73000,22000,51000,51000
059039,致伸群益99購01  ,0,0,0,0,0,0,0,0,0,51000,0,0,0,51000,0,51000,51000
058017,漢唐凱基99購01  ,0,0,0,0,0,0,0,0,0,51000,0,0,0,51000,0,51000,51000
055755,禾伸堂兆豐97購02,0,0,0,0,0,0,0,0,0,51000,0,0,0,64000,13000,51000,51000
060501,鴻海元大9A購13  ,0,0,0,0,0,0,0,0,0,50000,0,0,0,50000,0,50000,50000
060656,國巨統一9C購03  ,0,0,0,0,0,0,0,0,0,50000,0,0,0,50000,0,50000,50000
060754,華通元大9A購04  ,0,0,0,0,0,0,0,0,0,50000,0,0,0,50000,0,50000,50000
061105,宏達電元大9A購04,0,0,0,0,0,0,0,0,0,50000,0,0,0,50000,0,50000,50000
060251,易華電元大9C購01,0,0,0,0,0,0,0,0,0,50000,0,0,0,50000,0,50000,50000
060316,福懋科永豐9A購01,0,0,0,0,0,0,0,0,0,50000,0,0,0,61000,11000,50000,50000
07550P,國巨元大9A售09  ,0,0,0,0,0,0,0,0,0,50000,0,0,0,50000,0,50000,50000
07219P,臺股指凱基99售32,0,0,0,0,0,0,0,0,0,50000,0,0,0,62000,12000,50000,50000
07105P,大毅元富99售02  ,0,0,0,0,0,0,0,0,0,50000,0,0,0,50000,0,50000,50000
06893P,致新元富98售02  ,0,0,0,0,0,0,0,0,0,50000,0,0,0,50000,0,50000,50000
054261,智伸科元大96購03,0,0,0,0,0,0,0,0,0,50000,0,0,0,50000,0,50000,50000
054250,漢唐元大96購04  ,0,0,0,0,0,0,0,0,0,50000,0,0,0,50000,0,50000,50000
05418P,瑞昱永豐95售02  ,0,0,0,0,0,0,0,0,0,50000,0,0,0,50000,0,50000,50000
054043,漢唐元大97購01  ,0,0,0,0,0,0,0,0,0,50000,0,0,0,50000,0,50000,50000
052360,FB上証國票96購01,0,0,0,0,0,0,0,0,0,50000,0,0,0,50000,0,50000,50000
052254,康友永豐95購03  ,0,0,0,0,0,0,0,0,0,50000,0,0,0,50000,0,50000,50000
052053,泰鼎凱基96購01  ,0,0,0,0,0,0,0,0,0,50000,0,0,0,50000,0,50000,50000
052049,緯創凱基97購01  ,0,0,0,0,0,0,0,0,0,50000,0,0,0,50000,0,50000,50000
051951,聯發科元富95購02,0,0,0,0,0,0,0,0,0,50000,0,0,0,50000,0,50000,50000
051421,彩晶國票95購01  ,0,0,0,0,0,0,0,0,0,50000,0,0,0,50000,0,50000,50000
051684,瑞昱凱基95購02  ,0,0,0,0,0,0,0,0,0,50000,0,0,0,50000,0,50000,50000
051378,奇力新群益95購01,0,0,0,0,0,0,0,0,0,50000,0,0,0,50000,0,50000,50000
050590,晶技永豐95購01  ,0,0,0,0,0,0,0,0,0,50000,0,0,0,50000,0,50000,50000
04633P,旺宏群益96售04  ,0,0,0,0,0,0,0,0,0,50000,0,0,0,50000,0,50000,50000
048349,美利達元大96購02,0,0,0,0,0,0,0,0,0,50000,0,0,0,50000,0,50000,50000
052667,漢唐群益96購01  ,0,0,0,0,0,0,0,0,0,50000,0,0,0,50000,0,50000,50000
052847,漢唐統一99購01  ,0,0,0,0,0,0,0,0,0,50000,0,0,0,50000,0,50000,50000
054725,國巨日盛97購01  ,0,0,0,0,0,0,0,0,0,50000,0,0,0,50000,0,50000,50000
054760,台化國票9A購01  ,0,0,0,0,0,0,0,0,0,50000,0,0,0,50000,0,50000,50000
054772,康控國票98購02  ,0,0,0,0,0,0,0,0,0,50000,0,0,0,50000,0,50000,50000
054462,旺宏凱基96購08  ,0,0,0,0,0,0,0,0,0,50000,0,0,0,50000,0,50000,50000
054395,華新科永豐96購03,0,0,0,0,0,0,0,0,0,50000,0,0,0,50000,0,50000,50000
055206,台虹中信97購01  ,0,0,0,0,0,0,0,0,0,50000,0,0,0,50000,0,50000,50000
053223,台郡凱基96購02  ,0,0,0,0,0,0,0,0,0,50000,0,0,0,50000,0,50000,50000
057768,華新科中信9A購01,0,0,0,0,0,0,0,0,0,50000,0,0,0,50000,0,50000,50000
057821,晶相光元大98購03,0,0,0,0,0,0,0,0,0,50000,0,0,0,53000,3000,50000,50000
053501,明泰兆豐96購01  ,0,0,0,0,0,0,0,0,0,50000,0,0,0,70000,20000,50000,50000
053040,全新凱基98購01  ,0,0,0,0,0,0,0,0,0,50000,0,0,0,50000,0,50000,50000
057123,上銀凱基98購05  ,0,0,0,0,0,0,0,0,0,50000,0,0,0,50000,0,50000,50000
056239,宏達電群益98購01,0,0,0,0,0,0,0,0,0,50000,0,0,0,50000,0,50000,50000
055958,台光電元大97購02,0,0,0,0,0,0,0,0,0,50000,0,0,0,50000,0,50000,50000
057136,立積凱基98購02  ,0,0,0,0,0,0,0,0,0,50000,0,0,0,58000,8000,50000,50000
057684,聯茂日盛99購01  ,0,0,0,0,0,0,0,0,0,50000,0,0,0,50000,0,50000,50000
057627,和大永豐98購01  ,0,0,0,0,0,0,0,0,0,50000,0,0,0,50000,0,50000,50000
059293,宏達電元富9B購01,0,0,0,0,0,0,0,0,0,50000,0,0,0,50000,0,50000,50000
058952,南茂群益99購01  ,0,0,0,0,0,0,0,0,0,50000,0,0,0,59000,9000,50000,50000
056900,可成元大98購02  ,0,0,0,0,0,0,0,0,0,50000,0,0,0,61000,11000,50000,50000
056970,TPK永豐98購01   ,0,0,0,0,0,0,0,0,0,50000,0,0,0,98000,48000,50000,50000
058741,欣興日盛99購01  ,0,0,0,0,0,0,0,0,0,50000,0,0,0,50000,0,50000,50000
056696,茂林群益98購02  ,0,0,0,0,0,0,0,0,0,50000,0,0,0,50000,0,50000,50000
058422,百和麥證99購01  ,0,0,0,50000,0,50000,0,0,0,50000,0,0,0,50000,0,50000,50000
057937,神達群益98購02  ,0,0,0,0,0,0,0,0,0,50000,0,0,0,93000,43000,50000,50000
058773,和碩兆豐99購01  ,0,0,0,0,0,0,0,0,0,50000,0,0,0,80000,30000,50000,50000
057888,貿聯群益98購02  ,0,0,0,0,0,0,0,0,0,50000,0,0,0,60000,10000,50000,50000
3588,通嘉            ,78000,28000,50000,0,0,0,0,0,0,0,0,0,0,0,0,0,50000
2887E,台新戊特        ,0,0,0,0,0,0,0,0,0,50000,50000,0,50000,0,0,0,50000
2739,寒舍            ,56000,6000,50000,0,0,0,0,0,0,0,0,0,0,0,0,0,50000
059804,台積電元富99購01,0,0,0,0,0,0,0,0,0,50000,0,0,0,50000,0,50000,50000
059850,日電貿永豐99購01,0,0,0,0,0,0,0,0,0,50000,0,0,0,50000,0,50000,50000
2387,精元            ,627000,577000,50000,0,0,0,0,0,0,-1000,34000,59000,-25000,32000,8000,24000,49000
060229,楠梓電元大9C購01,0,0,0,0,0,0,0,0,0,49000,0,0,0,102000,53000,49000,49000
060599,國巨凱基9C購01  ,0,0,0,0,0,0,0,0,0,49000,0,0,0,172000,123000,49000,49000
060499,鴻海元大9A購11  ,0,0,0,0,0,0,0,0,0,49000,0,0,0,50000,1000,49000,49000
056607,貿聯富邦99購02  ,0,0,0,0,0,0,0,0,0,49000,0,0,0,55000,6000,49000,49000
056534,京元電凱基98購01,0,0,0,0,0,0,0,0,0,49000,0,0,0,53000,4000,49000,49000
058079,鴻海群益98購08  ,0,0,0,0,0,0,0,0,0,49000,0,0,0,263000,214000,49000,49000
058043,鴻海元大98購13  ,0,0,0,0,0,0,0,0,0,49000,0,0,0,260000,211000,49000,49000
058271,訊連永豐99購01  ,0,0,0,0,0,0,0,0,0,49000,0,0,0,49000,0,49000,49000
05817P,可成凱基96售07  ,0,0,0,0,0,0,0,0,0,49000,0,0,0,51000,2000,49000,49000
059312,元石油元大99購05,0,0,0,0,0,0,0,0,0,49000,0,0,0,786000,737000,49000,49000
059731,康控元大99購04  ,0,0,0,0,0,0,0,0,0,49000,0,0,0,49000,0,49000,49000
059637,大立光凱基01購01,0,0,0,0,0,0,0,0,0,49000,0,0,0,50000,1000,49000,49000
058215,貿聯群益99購02  ,0,0,0,0,0,0,0,0,0,49000,0,0,0,49000,0,49000,49000
057479,致茂元大98購03  ,0,0,0,0,0,0,0,0,0,49000,0,0,0,63000,14000,49000,49000
056000,佳世達永豐97購01,0,0,0,0,0,0,0,0,0,49000,0,0,0,70000,21000,49000,49000
056076,超眾元大97購05  ,0,0,0,0,0,0,0,0,0,49000,0,0,0,52000,3000,49000,49000
4536,拓凱            ,74000,57000,17000,0,0,0,32000,0,32000,0,0,0,0,0,0,0,49000
6206,飛捷            ,110000,60000,50000,0,0,0,0,0,0,-1000,0,1000,-1000,0,0,0,49000
060223,台灣50元大9A購05,0,0,0,0,0,0,0,0,0,48000,0,0,0,48000,0,48000,48000
060351,滬深2X元富9A購01,0,0,0,0,0,0,0,0,0,48000,0,0,0,74000,26000,48000,48000
06179P,國巨群益97售04  ,0,0,0,0,0,0,0,0,0,48000,0,0,0,50000,2000,48000,48000
07669P,華新科元大9A售14,0,0,0,0,0,0,0,0,0,48000,0,0,0,66000,18000,48000,48000
054785,建準群益98購01  ,0,0,0,0,0,0,0,0,0,48000,0,0,0,48000,0,48000,48000
055479,GIS凱基97購04   ,0,0,0,0,0,0,0,0,0,48000,0,0,0,51000,3000,48000,48000
020012,富邦行動通訊N   ,0,0,0,0,0,0,0,0,0,48000,0,0,0,141000,93000,48000,48000
052201,超眾統一96購01  ,0,0,0,0,0,0,0,0,0,48000,0,0,0,48000,0,48000,48000
054231,國巨群益98購03  ,0,0,0,0,0,0,0,0,0,48000,0,0,0,109000,61000,48000,48000
057105,致茂群益9A購01  ,0,0,0,0,0,0,0,0,0,48000,0,0,0,48000,0,48000,48000
056459,茂林凱基99購01  ,0,0,0,0,0,0,0,0,0,48000,0,0,0,188000,140000,48000,48000
058439,玉晶光統一01購02,0,0,0,0,0,0,0,0,0,48000,0,0,0,49000,1000,48000,48000
07377P,聯發科元大99售40,0,0,0,0,0,0,0,0,0,47000,0,0,0,67000,20000,47000,47000
053932,華新科統一96購03,0,0,0,0,0,0,0,0,0,47000,0,0,0,47000,0,47000,47000
00683L,元大美元指數正2 ,0,0,0,0,0,0,0,0,0,47000,0,0,0,47000,0,47000,47000
050551,大立光凱基95購05,0,0,0,0,0,0,0,0,0,47000,0,0,0,47000,0,47000,47000
053073,技嘉康和96購01  ,0,0,0,0,0,0,0,0,0,47000,0,0,0,108000,61000,47000,47000
056519,創意國票99購01  ,0,0,0,0,0,0,0,0,0,47000,0,0,0,47000,0,47000,47000
057369,奇力新元大99購05,0,0,0,0,0,0,0,0,0,47000,0,0,0,62000,15000,47000,47000
060058,牧德凱基9B購01  ,0,0,0,0,0,0,0,0,0,47000,0,0,0,50000,3000,47000,47000
2426,鼎元            ,92000,45000,47000,0,0,0,0,0,0,-1000,0,1000,-1000,0,0,0,46000
060812,智邦凱基9A購01  ,0,0,0,0,0,0,0,0,0,46000,0,0,0,46000,0,46000,46000
061008,群創兆豐9A購02  ,0,0,0,0,0,0,0,0,0,46000,0,0,0,96000,50000,46000,46000
060342,台積電統一02購01,0,0,0,0,0,0,0,0,0,46000,0,0,0,66000,20000,46000,46000
061094,彩晶統一9B購02  ,0,0,0,0,0,0,0,0,0,46000,0,0,0,48000,2000,46000,46000
060528,友達中信9C購01  ,0,0,0,0,0,0,0,0,0,46000,0,0,0,178000,132000,46000,46000
060745,京元電國票9A購01,0,0,0,0,0,0,0,0,0,46000,0,0,0,46000,0,46000,46000
058358,技嘉凱基9A購01  ,0,0,0,0,0,0,0,0,0,46000,0,0,0,46000,0,46000,46000
052727,仁寶元富96購01  ,0,0,0,0,0,0,0,0,0,46000,0,0,0,212000,166000,46000,46000
051789,嘉澤國票96購01  ,0,0,0,0,0,0,0,0,0,46000,0,0,0,53000,7000,46000,46000
060215,柏文康和9A購01  ,0,0,0,0,0,0,0,0,0,46000,0,0,0,46000,0,46000,46000
060134,鈺齊群益9A購01  ,0,0,0,0,0,0,0,0,0,46000,0,0,0,64000,18000,46000,46000
055720,宏達電元大97購05,0,0,0,0,0,0,0,0,0,46000,0,0,0,47000,1000,46000,46000
056243,創意群益97購03  ,0,0,0,0,0,0,0,0,0,46000,0,0,0,57000,11000,46000,46000
059041,南茂群益99購02  ,0,0,0,0,0,0,0,0,0,46000,0,0,0,130000,84000,46000,46000
6202,盛群            ,219000,186000,33000,0,0,0,0,0,0,13000,0,5000,-5000,18000,0,18000,46000
059789,貿聯元大9A購02  ,0,0,0,0,0,0,0,0,0,46000,0,0,0,46000,0,46000,46000
1733,五鼎            ,70320,24000,46320,0,0,0,0,0,0,-1000,0,1000,-1000,0,0,0,45320
07699P,臺股指元大9A售52,0,0,0,0,0,0,0,0,0,45000,0,0,0,105000,60000,45000,45000
07365P,超眾元大99售07  ,0,0,0,0,0,0,0,0,0,45000,0,0,0,55000,10000,45000,45000
07404P,華新科凱基99售10,0,0,0,0,0,0,0,0,0,45000,0,0,0,71000,26000,45000,45000
060722,矽格永豐9A購01  ,0,0,0,0,0,0,0,0,0,45000,0,0,0,45000,0,45000,45000
061003,南亞科兆豐9A購01,0,0,0,0,0,0,0,0,0,45000,0,0,0,142000,97000,45000,45000
049463,華新科富邦97購01,0,0,0,0,0,0,0,0,0,45000,0,0,0,45000,0,45000,45000
052406,力成凱基95購03  ,0,0,0,0,0,0,0,0,0,45000,0,0,0,50000,5000,45000,45000
054298,台表科元大97購03,0,0,0,0,0,0,0,0,0,45000,0,0,0,136000,91000,45000,45000
05161P,華新科國票96售01,0,0,0,0,0,0,0,0,0,45000,0,0,0,118000,73000,45000,45000
051415,晶技國票96購01  ,0,0,0,0,0,0,0,0,0,45000,0,0,0,45000,0,45000,45000
055349,京元電凱基97購02,0,0,0,0,0,0,0,0,0,45000,0,0,0,45000,0,45000,45000
055032,億光富邦99購01  ,0,0,0,0,0,0,0,0,0,45000,0,0,0,45000,0,45000,45000
058626,瑞昱國票9A購01  ,0,0,0,0,0,0,0,0,0,45000,0,0,0,75000,30000,45000,45000
056354,國巨元大98購10  ,0,0,0,0,0,0,0,0,0,45000,0,0,0,48000,3000,45000,45000
056309,合勤控元大97購01,0,0,0,0,0,0,0,0,0,45000,0,0,0,198000,153000,45000,45000
053101,創意元富96購03  ,0,0,0,0,0,0,0,0,0,45000,0,0,0,55000,10000,45000,45000
059054,國巨凱基99購11  ,0,0,0,0,0,0,0,0,0,45000,0,0,0,45000,0,45000,45000
057043,台積電元大99購02,0,0,0,0,0,0,0,0,0,45000,0,0,0,45000,0,45000,45000
056202,國揚永豐97購01  ,0,0,0,0,0,0,0,0,0,45000,0,0,0,45000,0,45000,45000
055726,台表科元大98購03,0,0,0,0,0,0,0,0,0,45000,0,0,0,51000,6000,45000,45000
057267,康控兆豐99購01  ,0,0,0,0,0,0,0,0,0,45000,0,0,0,45000,0,45000,45000
060151,旺宏富邦9A購02  ,0,0,0,0,0,0,0,0,0,45000,0,0,0,70000,25000,45000,45000
059741,聯發科元富99購07,0,0,0,0,0,0,0,0,0,45000,0,0,0,80000,35000,45000,45000
057572,明泰永豐98購01  ,0,0,0,0,0,0,0,0,0,45000,0,0,0,58000,13000,45000,45000
059607,台積電富邦9C購04,0,0,0,0,0,0,0,0,0,45000,0,0,0,46000,1000,45000,45000
059912,國巨元大99購28  ,0,0,0,0,0,0,0,0,0,45000,0,0,0,127000,82000,45000,45000
059700,鴻海凱基9A購16  ,0,0,0,0,0,0,0,0,0,45000,0,0,0,83000,38000,45000,45000
059459,訊芯永豐99購04  ,0,0,0,0,0,0,0,0,0,45000,0,0,0,128000,83000,45000,45000
060895,華新科凱基9B購05,0,0,0,0,0,0,0,0,0,44000,0,0,0,44000,0,44000,44000
060874,中鋼中信02購01  ,0,0,0,0,0,0,0,0,0,44000,0,0,0,53000,9000,44000,44000
061306,瑞祺永豐9A購02  ,0,0,0,0,0,0,0,0,0,44000,0,0,0,370000,326000,44000,44000
060719,瀚宇博永豐9A購01,0,0,0,0,0,0,0,0,0,44000,0,0,0,44000,0,44000,44000
060393,泰鼎群益9A購01  ,0,0,0,0,0,0,0,0,0,44000,0,0,0,63000,19000,44000,44000
060551,大立光凱基9B購02,0,0,0,0,0,0,0,0,0,44000,0,0,0,94000,50000,44000,44000
051919,台郡元大96購02  ,0,0,0,0,0,0,0,0,0,44000,0,0,0,50000,6000,44000,44000
00668,國泰美國道瓊    ,1000,0,1000,0,0,0,0,0,0,43000,0,0,0,73000,30000,43000,44000
057583,啟碁中信9A購01  ,0,0,0,0,0,0,0,0,0,44000,0,0,0,44000,0,44000,44000
060087,鴻海元大99購43  ,0,0,0,0,0,0,0,0,0,44000,0,0,0,92000,48000,44000,44000
058983,旺宏凱基99購05  ,0,0,0,0,0,0,0,0,0,44000,0,0,0,54000,10000,44000,44000
058537,彩晶統一9B購01  ,0,0,0,0,0,0,0,0,0,44000,0,0,0,56000,12000,44000,44000
056677,智伸科元富98購01,0,0,0,0,0,0,0,0,0,44000,0,0,0,124000,80000,44000,44000
060611,同欣電凱基9A購02,0,0,0,0,0,0,0,0,0,43000,0,0,0,195000,152000,43000,43000
060312,潤泰全永豐9A購01,0,0,0,0,0,0,0,0,0,43000,0,0,0,53000,10000,43000,43000
061122,敬鵬永豐9A購01  ,0,0,0,0,0,0,0,0,0,43000,0,0,0,43000,0,43000,43000
07573P,國巨元大9A售11  ,0,0,0,0,0,0,0,0,0,43000,0,0,0,194000,151000,43000,43000
07623P,大立光統一9B售05,0,0,0,0,0,0,0,0,0,43000,0,0,0,97000,54000,43000,43000
07127P,精元元大99售01  ,0,0,0,0,0,0,0,0,0,43000,0,0,0,43000,0,43000,43000
045054,聯發科元富98購02,0,0,0,0,0,0,0,0,0,43000,0,0,0,43000,0,43000,43000
053281,茂林元大96購02  ,0,0,0,0,0,0,0,0,0,43000,0,0,0,153000,110000,43000,43000
055344,國巨凱基97購04  ,0,0,0,0,0,0,0,0,0,43000,0,0,0,53000,10000,43000,43000
060088,國巨元大99購30  ,0,0,0,0,0,0,0,0,0,43000,0,0,0,55000,12000,43000,43000
059514,嘉澤永豐99購02  ,0,0,0,0,0,0,0,0,0,43000,0,0,0,131000,88000,43000,43000
059660,華新科元大9A購04,0,0,0,0,0,0,0,0,0,43000,0,0,0,88000,45000,43000,43000
1312,國喬            ,1377000,1353000,24000,0,0,0,0,1000,-1000,19000,24000,5000,19000,0,0,0,42000
060297,和碩元大9A購02  ,0,0,0,0,0,0,0,0,0,42000,0,0,0,169000,127000,42000,42000
060572,景碩永豐9A購01  ,0,0,0,0,0,0,0,0,0,42000,0,0,0,44000,2000,42000,42000
060747,聯鈞國票9A購02  ,0,0,0,0,0,0,0,0,0,42000,0,0,0,50000,8000,42000,42000
060440,台灣50元大9C購27,0,0,0,0,0,0,0,0,0,42000,0,0,0,42000,0,42000,42000
060978,國巨元大9A購13  ,0,0,0,0,0,0,0,0,0,42000,0,0,0,97000,55000,42000,42000
050095,國巨國泰95購04  ,0,0,0,0,0,0,0,0,0,42000,0,0,0,42000,0,42000,42000
050992,台積電元大97購01,0,0,0,0,0,0,0,0,0,42000,0,0,0,42000,0,42000,42000
052231,景碩凱基96購01  ,0,0,0,0,0,0,0,0,0,42000,0,0,0,54000,12000,42000,42000
059971,台灣50元大9B購08,0,0,0,0,0,0,0,0,0,42000,0,0,0,42000,0,42000,42000
060191,亞光元富9A購02  ,0,0,0,0,0,0,0,0,0,42000,0,0,0,92000,50000,42000,42000
057504,技嘉麥證98購01  ,0,0,0,52000,10000,42000,0,0,0,42000,0,0,0,52000,10000,42000,42000
059228,臺股指元大99購21,0,0,0,0,0,0,0,0,0,42000,0,0,0,42000,0,42000,42000
056098,矽創元富97購02  ,0,0,0,0,0,0,0,0,0,42000,0,0,0,112000,70000,42000,42000
056470,旺宏元大99購01  ,0,0,0,0,0,0,0,0,0,42000,0,0,0,80000,38000,42000,42000
059137,電子類群益99購01,0,0,0,0,0,0,0,0,0,42000,0,0,0,60000,18000,42000,42000
056928,旺宏台新98購01  ,0,0,0,0,0,0,0,0,0,42000,0,0,0,44000,2000,42000,42000
058015,旺宏凱基99購02  ,0,0,0,0,0,0,0,0,0,42000,0,0,0,60000,18000,42000,42000
06676P,華新科國票98售03,0,0,0,0,0,0,0,0,0,41000,0,0,0,61000,20000,41000,41000
060508,聯發科元大9A購04,0,0,0,0,0,0,0,0,0,41000,0,0,0,50000,9000,41000,41000
060233,宏碁元大9A購01  ,0,0,0,0,0,0,0,0,0,41000,0,0,0,209000,168000,41000,41000
1417,嘉裕            ,67000,26000,41000,0,0,0,0,0,0,0,0,0,0,0,0,0,41000
054258,牧德元大97購01  ,0,0,0,0,0,0,0,0,0,41000,0,0,0,52000,11000,41000,41000
051539,瀚宇博國票97購01,0,0,0,0,0,0,0,0,0,41000,0,0,0,41000,0,41000,41000
052713,智邦凱基96購01  ,0,0,0,0,0,0,0,0,0,41000,0,0,0,41000,0,41000,41000
054660,禾伸堂元大97購03,0,0,0,0,0,0,0,0,0,41000,0,0,0,41000,0,41000,41000
054418,茂林元大97購01  ,0,0,0,0,0,0,0,0,0,41000,0,0,0,77000,36000,41000,41000
053124,聯發科凱基96購12,0,0,0,0,0,0,0,0,0,41000,0,0,0,41000,0,41000,41000
058596,旺宏台新99購01  ,0,0,0,0,0,0,0,0,0,41000,0,0,0,89000,48000,41000,41000
056926,日月光兆豐98購01,0,0,0,0,0,0,0,0,0,41000,0,0,0,41000,0,41000,41000
056580,泰鼎元大9A購01  ,0,0,0,0,0,0,0,0,0,41000,0,0,0,46000,5000,41000,41000
058403,玉晶光元大99購12,0,0,0,0,0,0,0,0,0,41000,0,0,0,139000,98000,41000,41000
059062,群創凱基99購05  ,0,0,0,0,0,0,0,0,0,41000,0,0,0,49000,8000,41000,41000
057477,智邦元大98購09  ,0,0,0,0,0,0,0,0,0,41000,0,0,0,41000,0,41000,41000
059563,鴻海凱基9A購14  ,0,0,0,0,0,0,0,0,0,41000,0,0,0,45000,4000,41000,41000
07158P,FBVIX國泰9C售01 ,0,0,0,0,0,0,0,0,0,40000,0,0,0,40000,0,40000,40000
07578P,高鐵元大9A售02  ,0,0,0,0,0,0,0,0,0,40000,0,0,0,50000,10000,40000,40000
060677,京元電元大9A購04,0,0,0,0,0,0,0,0,0,40000,0,0,0,149000,109000,40000,40000
060712,建準永豐9A購01  ,0,0,0,0,0,0,0,0,0,40000,0,0,0,40000,0,40000,40000
060293,緯創元大9A購01  ,0,0,0,0,0,0,0,0,0,40000,0,0,0,112000,72000,40000,40000
060653,全新群益9A購02  ,0,0,0,0,0,0,0,0,0,40000,0,0,0,91000,51000,40000,40000
060977,亞德客元大9A購04,0,0,0,0,0,0,0,0,0,40000,0,0,0,51000,11000,40000,40000
053885,全新兆豐96購01  ,0,0,0,0,0,0,0,0,0,40000,0,0,0,40000,0,40000,40000
052659,上証2X國票99購01,0,0,0,0,0,0,0,0,0,40000,0,0,0,65000,25000,40000,40000
055323,貿聯國票98購01  ,0,0,0,0,0,0,0,0,0,40000,0,0,0,40000,0,40000,40000
052629,訊芯中信99購01  ,0,0,0,0,0,0,0,0,0,40000,0,0,0,40000,0,40000,40000
052743,華新科元大97購01,0,0,0,0,0,0,0,0,0,40000,0,0,0,40000,0,40000,40000
051460,S&P反1國泰97購01,0,0,0,0,0,0,0,0,0,40000,0,0,0,104000,64000,40000,40000
051113,聯電元富95購01  ,0,0,0,0,0,0,0,0,0,40000,0,0,0,40000,0,40000,40000
052160,美律永豐95購03  ,0,0,0,0,0,0,0,0,0,40000,0,0,0,40000,0,40000,40000
052429,禾伸堂永豐95購02,0,0,0,0,0,0,0,0,0,40000,0,0,0,40000,0,40000,40000
052366,聯詠國票96購01  ,0,0,0,0,0,0,0,0,0,40000,0,0,0,40000,0,40000,40000
049926,智易元大95購02  ,0,0,0,0,0,0,0,0,0,40000,0,0,0,40000,0,40000,40000
057639,國巨元大99購07  ,0,0,0,0,0,0,0,0,0,40000,0,0,0,50000,10000,40000,40000
060034,立積永豐99購04  ,0,0,0,0,0,0,0,0,0,40000,0,0,0,53000,13000,40000,40000
057164,國巨元大98購14  ,0,0,0,0,0,0,0,0,0,40000,0,0,0,40000,0,40000,40000
057263,可成兆豐99購01  ,0,0,0,0,0,0,0,0,0,40000,0,0,0,50000,10000,40000,40000
057403,亞光群益98購04  ,0,0,0,0,0,0,0,0,0,40000,0,0,0,40000,0,40000,40000
055686,致伸凱基97購02  ,0,0,0,0,0,0,0,0,0,40000,0,0,0,60000,20000,40000,40000
055654,景碩元富97購01  ,0,0,0,0,0,0,0,0,0,40000,0,0,0,40000,0,40000,40000
055748,GIS元富97購01   ,0,0,0,0,0,0,0,0,0,40000,0,0,0,40000,0,40000,40000
056709,華通永豐98購01  ,0,0,0,0,0,0,0,0,0,40000,0,0,0,40000,0,40000,40000
056763,國巨元大99購02  ,0,0,0,0,0,0,0,0,0,40000,0,0,0,285000,245000,40000,40000
058850,華新科群益99購03,0,0,0,0,0,0,0,0,0,40000,0,0,0,58000,18000,40000,40000
056678,力成元富98購01  ,0,0,0,0,0,0,0,0,0,40000,0,0,0,40000,0,40000,40000
058829,華新科永豐99購04,0,0,0,0,0,0,0,0,0,40000,0,0,0,40000,0,40000,40000
056839,台光電元富98購02,0,0,0,0,0,0,0,0,0,40000,0,0,0,55000,15000,40000,40000
056845,揚明光元富98購01,0,0,0,0,0,0,0,0,0,40000,0,0,0,70000,30000,40000,40000
058292,上銀凱基9A購01  ,0,0,0,0,0,0,0,0,0,40000,0,0,0,40000,0,40000,40000
059381,TPK亞東99購01   ,0,0,0,0,0,0,0,0,0,40000,0,0,0,40000,0,40000,40000
059713,滬深2X元大9C購04,0,0,0,0,0,0,0,0,0,40000,0,0,0,40000,0,40000,40000
059813,滬深2X凱基9B購01,0,0,0,0,0,0,0,0,0,40000,0,0,0,50000,10000,40000,40000
060610,玉晶光凱基9B購02,0,0,0,0,0,0,0,0,0,39000,0,0,0,57000,18000,39000,39000
060527,台積電中信9C購04,0,0,0,0,0,0,0,0,0,39000,0,0,0,53000,14000,39000,39000
07582P,臺股指元大9A售45,0,0,0,0,0,0,0,0,0,39000,0,0,0,39000,0,39000,39000
058588,致茂中信9B購01  ,0,0,0,0,0,0,0,0,0,39000,0,0,0,39000,0,39000,39000
056732,國巨凱基98購07  ,0,0,0,0,0,0,0,0,0,39000,0,0,0,39000,0,39000,39000
056567,瀚宇博群益98購02,0,0,0,0,0,0,0,0,0,39000,0,0,0,87000,48000,39000,39000
057473,T50反1元大98購08,0,0,0,0,0,0,0,0,0,39000,0,0,0,39000,0,39000,39000
059305,台灣50元大99購02,0,0,0,0,0,0,0,0,0,39000,0,0,0,54000,15000,39000,39000
059597,大立光元大99購21,0,0,0,0,0,0,0,0,0,39000,0,0,0,66000,27000,39000,39000
059928,道瓊銀富邦03購01,0,0,0,0,0,0,0,0,0,39000,0,0,0,50000,11000,39000,39000
1731,美吾華          ,52000,14000,38000,0,0,0,0,0,0,0,0,0,0,0,0,0,38000
2108,南帝            ,125000,85000,40000,0,0,0,0,2000,-2000,0,0,0,0,0,0,0,38000
8011,台通            ,178000,138000,40000,0,0,0,0,0,0,-2000,0,2000,-2000,0,0,0,38000
060526,台積電中信9A購02,0,0,0,0,0,0,0,0,0,38000,0,0,0,44000,6000,38000,38000
060571,京元電永豐9A購01,0,0,0,0,0,0,0,0,0,38000,0,0,0,82000,44000,38000,38000
050322,世紀鋼國票95購01,0,0,0,0,0,0,0,0,0,38000,0,0,0,38000,0,38000,38000
040215,上証反凱基95購01,0,0,0,0,0,0,0,0,0,38000,0,0,0,38000,0,38000,38000
054205,華新國票97購02  ,0,0,0,0,0,0,0,0,0,38000,0,0,0,38000,0,38000,38000
054065,樺漢國票97購01  ,0,0,0,0,0,0,0,0,0,38000,0,0,0,38000,0,38000,38000
053122,美律凱基98購01  ,0,0,0,0,0,0,0,0,0,38000,0,0,0,38000,0,38000,38000
057776,京元電群益98購02,0,0,0,0,0,0,0,0,0,38000,0,0,0,75000,37000,38000,38000
057484,南亞科元大98購06,0,0,0,0,0,0,0,0,0,38000,0,0,0,38000,0,38000,38000
057150,貿聯國票99購02  ,0,0,0,0,0,0,0,0,0,38000,0,0,0,38000,0,38000,38000
057334,技嘉國票98購02  ,0,0,0,0,0,0,0,0,0,38000,0,0,0,38000,0,38000,38000
057375,欣興元大98購09  ,0,0,0,0,0,0,0,0,0,38000,0,0,0,50000,12000,38000,38000
056611,國巨永豐98購03  ,0,0,0,0,0,0,0,0,0,38000,0,0,0,45000,7000,38000,38000
056735,國巨凱基99購02  ,0,0,0,0,0,0,0,0,0,38000,0,0,0,40000,2000,38000,38000
056842,全新元富98購01  ,0,0,0,0,0,0,0,0,0,38000,0,0,0,110000,72000,38000,38000
056915,上銀兆豐99購01  ,0,0,0,0,0,0,0,0,0,38000,0,0,0,50000,12000,38000,38000
058063,旺宏中信98購04  ,0,0,0,0,0,0,0,0,0,38000,0,0,0,39000,1000,38000,38000
059429,台積電元大99購35,0,0,0,0,0,0,0,0,0,38000,0,0,0,52000,14000,38000,38000
060567,華擎富邦9C購01  ,0,0,0,0,0,0,0,0,0,37000,0,0,0,37000,0,37000,37000
060375,葡萄王元富9A購01,0,0,0,0,0,0,0,0,0,37000,0,0,0,159000,122000,37000,37000
060841,宏達電國票9B購01,0,0,0,0,0,0,0,0,0,37000,0,0,0,63000,26000,37000,37000
1465,偉全            ,42000,5000,37000,0,0,0,0,0,0,0,0,0,0,0,0,0,37000
055562,欣興凱基97購06  ,0,0,0,0,0,0,0,0,0,37000,0,0,0,37000,0,37000,37000
052062,臺股指國票95購09,0,0,0,0,0,0,0,0,0,37000,0,0,0,192000,155000,37000,37000
052173,廣達元大95購02  ,0,0,0,0,0,0,0,0,0,37000,0,0,0,105000,68000,37000,37000
049842,道瓊反中信98購01,0,0,0,0,0,0,0,0,0,37000,0,0,0,46000,9000,37000,37000
00675L,富邦臺灣加權正2 ,0,0,0,0,0,0,0,0,0,37000,0,0,0,741000,704000,37000,37000
058567,華新科凱基9A購02,0,0,0,0,0,0,0,0,0,37000,0,0,0,131000,94000,37000,37000
058156,超眾統一9A購02  ,0,0,0,0,0,0,0,0,0,37000,0,0,0,93000,56000,37000,37000
056471,台光電元大99購01,0,0,0,0,0,0,0,0,0,37000,0,0,0,71000,34000,37000,37000
057582,亞光中信9A購02  ,0,0,0,0,0,0,0,0,0,37000,0,0,0,38000,1000,37000,37000
057619,玉晶光凱基98購02,0,0,0,0,0,0,0,0,0,37000,0,0,0,107000,70000,37000,37000
059530,華新科凱基9A購05,0,0,0,0,0,0,0,0,0,37000,0,0,0,45000,8000,37000,37000
061061,聯發科麥證9A購02,0,0,0,41000,5000,36000,0,0,0,36000,0,0,0,41000,5000,36000,36000
053483,嘉澤第一96購01  ,0,0,0,0,0,0,0,0,0,36000,0,0,0,36000,0,36000,36000
058685,TPK凱基99購01   ,0,0,0,0,0,0,0,0,0,36000,0,0,0,58000,22000,36000,36000
053258,上証2X群益9A購03,0,0,0,0,0,0,0,0,0,36000,0,0,0,36000,0,36000,36000
056308,TPK元大97購02   ,0,0,0,0,0,0,0,0,0,36000,0,0,0,40000,4000,36000,36000
055280,智邦元大97購01  ,0,0,0,0,0,0,0,0,0,36000,0,0,0,94000,58000,36000,36000
06007P,世芯永豐96售01  ,0,0,0,0,0,0,0,0,0,36000,0,0,0,36000,0,36000,36000
059232,台灣50凱基03購01,0,0,0,0,0,0,0,0,0,36000,0,0,0,36000,0,36000,36000
058946,SGBR2X群益9B購01,0,0,0,0,0,0,0,0,0,36000,0,0,0,36000,0,36000,36000
058750,緯穎凱基9A購03  ,0,0,0,0,0,0,0,0,0,36000,0,0,0,76000,40000,36000,36000
056620,華新科永豐98購02,0,0,0,0,0,0,0,0,0,36000,0,0,0,36000,0,36000,36000
058027,鴻海富邦98購04  ,0,0,0,0,0,0,0,0,0,36000,0,0,0,68000,32000,36000,36000
059534,國泰金凱基99購01,0,0,0,0,0,0,0,0,0,36000,0,0,0,105000,69000,36000,36000
059316,國巨元大99購23  ,0,0,0,0,0,0,0,0,0,36000,0,0,0,51000,15000,36000,36000
4106,雃博            ,165000,129000,36000,0,0,0,0,0,0,0,0,0,0,0,0,0,36000
06437P,玉晶光國票99售01,0,0,0,0,0,0,0,0,0,35000,0,0,0,35000,0,35000,35000
07506P,中租元大9A售01  ,0,0,0,0,0,0,0,0,0,35000,0,0,0,65000,30000,35000,35000
06783P,亞光元大98售03  ,0,0,0,0,0,0,0,0,0,35000,0,0,0,37000,2000,35000,35000
06582P,可成凱基98售06  ,0,0,0,0,0,0,0,0,0,35000,0,0,0,37000,2000,35000,35000
058674,宏達電群益99購01,0,0,0,0,0,0,0,0,0,35000,0,0,0,35000,0,35000,35000
053424,欣興永豐96購02  ,0,0,0,0,0,0,0,0,0,35000,0,0,0,35000,0,35000,35000
052041,鴻海日盛95購02  ,0,0,0,0,0,0,0,0,0,35000,0,0,0,35000,0,35000,35000
052428,嘉晶永豐95購01  ,0,0,0,0,0,0,0,0,0,35000,0,0,0,35000,0,35000,35000
052020,聯茂永豐95購02  ,0,0,0,0,0,0,0,0,0,35000,0,0,0,36000,1000,35000,35000
051339,智易永豐95購02  ,0,0,0,0,0,0,0,0,0,35000,0,0,0,45000,10000,35000,35000
054120,奇力新永豐96購01,0,0,0,0,0,0,0,0,0,35000,0,0,0,35000,0,35000,35000
056713,華擎永豐98購01  ,0,0,0,0,0,0,0,0,0,35000,0,0,0,35000,0,35000,35000
058405,訊連元大99購02  ,0,0,0,0,0,0,0,0,0,35000,0,0,0,50000,15000,35000,35000
057356,彩晶統一98購04  ,0,0,0,0,0,0,0,0,0,35000,0,0,0,35000,0,35000,35000
057252,牧德元富98購01  ,0,0,0,0,0,0,0,0,0,35000,0,0,0,40000,5000,35000,35000
057465,智易永豐98購02  ,0,0,0,0,0,0,0,0,0,35000,0,0,0,80000,45000,35000,35000
057667,可成元大99購01  ,0,0,0,0,0,0,0,0,0,35000,0,0,0,50000,15000,35000,35000
4155,訊映            ,59000,24000,35000,0,0,0,0,0,0,0,0,0,0,0,0,0,35000
060788,嘉晶富邦9B購01  ,0,0,0,0,0,0,0,0,0,34000,0,0,0,44000,10000,34000,34000
060533,臺股指中信9B購05,0,0,0,0,0,0,0,0,0,34000,0,0,0,57000,23000,34000,34000
060425,凌華永豐9A購01  ,0,0,0,0,0,0,0,0,0,34000,0,0,0,34000,0,34000,34000
054354,技嘉富邦97購01  ,0,0,0,0,0,0,0,0,0,34000,0,0,0,88000,54000,34000,34000
049255,旺宏元大97購02  ,0,0,0,0,0,0,0,0,0,34000,0,0,0,94000,60000,34000,34000
048651,美利達元大96購05,0,0,0,0,0,0,0,0,0,34000,0,0,0,88000,54000,34000,34000
053405,台達電兆豐96購01,0,0,0,0,0,0,0,0,0,34000,0,0,0,34000,0,34000,34000
058369,亞光凱基99購02  ,0,0,0,0,0,0,0,0,0,34000,0,0,0,35000,1000,34000,34000
052915,創意元富96購01  ,0,0,0,0,0,0,0,0,0,34000,0,0,0,44000,10000,34000,34000
059588,鴻海元大99購32  ,0,0,0,0,0,0,0,0,0,34000,0,0,0,51000,17000,34000,34000
057174,南亞科元大98購05,0,0,0,0,0,0,0,0,0,34000,0,0,0,34000,0,34000,34000
055599,TPK元大97購01   ,0,0,0,0,0,0,0,0,0,34000,0,0,0,34000,0,34000,34000
055615,宏達電國票99購02,0,0,0,0,0,0,0,0,0,34000,0,0,0,34000,0,34000,34000
057946,晶相光國票99購01,0,0,0,0,0,0,0,0,0,34000,0,0,0,34000,0,34000,34000
058591,台灣50統一9B購02,0,0,0,0,0,0,0,0,0,34000,0,0,0,82000,48000,34000,34000
058975,台灣50凱基01購02,0,0,0,0,0,0,0,0,0,34000,0,0,0,76000,42000,34000,34000
058147,鈺齊元大99購01  ,0,0,0,0,0,0,0,0,0,34000,0,0,0,72000,38000,34000,34000
059196,聯發科永豐99購02,0,0,0,0,0,0,0,0,0,34000,0,0,0,68000,34000,34000,34000
4994,傳奇            ,68000,22000,46000,0,0,0,0,0,0,-12000,0,12000,-12000,0,0,0,34000
059318,旺宏元大99購13  ,0,0,0,0,0,0,0,0,0,34000,0,0,0,41000,7000,34000,34000
059456,智易永豐99購01  ,0,0,0,0,0,0,0,0,0,34000,0,0,0,97000,63000,34000,34000
07191P,台積電元大99售32,0,0,0,0,0,0,0,0,0,33000,0,0,0,68000,35000,33000,33000
057774,台光電群益99購02,0,0,0,0,0,0,0,0,0,33000,0,0,0,33000,0,33000,33000
058625,旺宏國票9A購01  ,0,0,0,0,0,0,0,0,0,33000,0,0,0,33000,0,33000,33000
05331P,上証2X國票96售01,0,0,0,0,0,0,0,0,0,33000,0,0,0,40000,7000,33000,33000
053627,宏碁兆豐97購01  ,0,0,0,0,0,0,0,0,0,33000,0,0,0,33000,0,33000,33000
050545,奇力新凱基95購01,0,0,0,0,0,0,0,0,0,33000,0,0,0,36000,3000,33000,33000
055713,國巨元大98購09  ,0,0,0,0,0,0,0,0,0,33000,0,0,0,41000,8000,33000,33000
059327,南茂元大99購01  ,0,0,0,0,0,0,0,0,0,33000,0,0,0,46000,13000,33000,33000
059910,鴻海元大99購37  ,0,0,0,0,0,0,0,0,0,33000,0,0,0,33000,0,33000,33000
059860,台積電群益9A購02,0,0,0,0,0,0,0,0,0,33000,0,0,0,123000,90000,33000,33000
4976,佳凌            ,105000,70000,35000,0,0,0,0,0,0,-2000,0,2000,-2000,0,0,0,33000
6443,元晶            ,115000,81000,34000,0,0,0,0,0,0,-1000,0,1000,-1000,0,0,0,33000
4766,南寶            ,66000,27000,39000,0,0,0,0,0,0,-6000,0,6000,-6000,0,0,0,33000
07102P,南電元大99售03  ,0,0,0,0,0,0,0,0,0,32000,0,0,0,32000,0,32000,32000
048572,美利達元大96購04,0,0,0,0,0,0,0,0,0,32000,0,0,0,32000,0,32000,32000
03566P,臺股指日盛03售01,0,0,0,0,0,0,0,0,0,32000,0,0,0,132000,100000,32000,32000
054021,義隆台新96購01  ,0,0,0,0,0,0,0,0,0,32000,0,0,0,136000,104000,32000,32000
054029,瀚宇博凱基96購02,0,0,0,0,0,0,0,0,0,32000,0,0,0,32000,0,32000,32000
053875,GIS元大97購01   ,0,0,0,0,0,0,0,0,0,32000,0,0,0,100000,68000,32000,32000
052846,智邦統一97購01  ,0,0,0,0,0,0,0,0,0,32000,0,0,0,32000,0,32000,32000
05513P,玉山金台新96售01,0,0,0,0,0,0,0,0,0,32000,0,0,0,32000,0,32000,32000
054504,聯鈞永豐96購01  ,0,0,0,0,0,0,0,0,0,32000,0,0,0,70000,38000,32000,32000
055007,晶相光元富9A購02,0,0,0,0,0,0,0,0,0,32000,0,0,0,32000,0,32000,32000
054792,揚明光群益97購01,0,0,0,0,0,0,0,0,0,32000,0,0,0,32000,0,32000,32000
058213,欣興群益99購01  ,0,0,0,0,0,0,0,0,0,32000,0,0,0,94000,62000,32000,32000
056502,A50正2永豐98購01,0,0,0,0,0,0,0,0,0,32000,0,0,0,32000,0,32000,32000
06550P,健策元大99售01  ,0,0,0,0,0,0,0,0,0,31000,0,0,0,44000,13000,31000,31000
06849P,欣興元大98售12  ,0,0,0,0,0,0,0,0,0,31000,0,0,0,43000,12000,31000,31000
060535,群創麥證9A購01  ,0,0,0,31000,0,31000,0,0,0,31000,0,0,0,31000,0,31000,31000
060738,矽格統一9C購01  ,0,0,0,0,0,0,0,0,0,31000,0,0,0,31000,0,31000,31000
052907,嘉澤國票97購01  ,0,0,0,0,0,0,0,0,0,31000,0,0,0,38000,7000,31000,31000
054163,燿華凱基97購02  ,0,0,0,0,0,0,0,0,0,31000,0,0,0,292000,261000,31000,31000
051458,臺股指元大95購18,0,0,0,0,0,0,0,0,0,31000,0,0,0,31000,0,31000,31000
04230P,臺股指中信95售06,0,0,0,0,0,0,0,0,0,31000,0,0,0,31000,0,31000,31000
05637P,聯電元大96售04  ,0,0,0,0,0,0,0,0,0,31000,0,0,0,80000,49000,31000,31000
058555,矽創永豐9A購01  ,0,0,0,0,0,0,0,0,0,31000,0,0,0,158000,127000,31000,31000
058900,旺宏元大99購11  ,0,0,0,0,0,0,0,0,0,31000,0,0,0,31000,0,31000,31000
059142,道瓊指國票9B購02,0,0,0,0,0,0,0,0,0,31000,0,0,0,31000,0,31000,31000
057563,旭富國泰9A購01  ,0,0,0,0,0,0,0,0,0,31000,0,0,0,33000,2000,31000,31000
057203,麗豐元富98購02  ,0,0,0,0,0,0,0,0,0,31000,0,0,0,199000,168000,31000,31000
055824,臺股指國票97購11,0,0,0,0,0,0,0,0,0,31000,0,0,0,84000,53000,31000,31000
4552,力達-KY         ,45000,14000,31000,0,0,0,0,0,0,0,0,0,0,0,0,0,31000
059682,可成富邦9A購01  ,0,0,0,0,0,0,0,0,0,31000,0,0,0,31000,0,31000,31000
059558,T50正2凱基9C購03,0,0,0,0,0,0,0,0,0,31000,0,0,0,31000,0,31000,31000
060615,T50反1元大9A購07,0,0,0,0,0,0,0,0,0,30000,0,0,0,30000,0,30000,30000
06063P,玉晶光元富97售01,0,0,0,0,0,0,0,0,0,30000,0,0,0,30000,0,30000,30000
060462,鴻海元大9A購10  ,0,0,0,0,0,0,0,0,0,30000,0,0,0,30000,0,30000,30000
060384,葡萄王凱基9B購01,0,0,0,0,0,0,0,0,0,30000,0,0,0,50000,20000,30000,30000
06070P,漢唐永豐97售01  ,0,0,0,0,0,0,0,0,0,30000,0,0,0,30000,0,30000,30000
060938,臺指反國票9B購03,0,0,0,0,0,0,0,0,0,30000,0,0,0,30000,0,30000,30000
060924,大毅永豐9A購03  ,0,0,0,0,0,0,0,0,0,30000,0,0,0,60000,30000,30000,30000
061053,國巨群益9A購08  ,0,0,0,0,0,0,0,0,0,30000,0,0,0,94000,64000,30000,30000
06130P,玉晶光元富97售07,0,0,0,0,0,0,0,0,0,30000,0,0,0,30000,0,30000,30000
06728P,全新元大98售03  ,0,0,0,0,0,0,0,0,0,30000,0,0,0,30000,0,30000,30000
06504P,麗豐國票99售02  ,0,0,0,0,0,0,0,0,0,30000,0,0,0,30000,0,30000,30000
06431P,新日興元大97售05,0,0,0,0,0,0,0,0,0,30000,0,0,0,30000,0,30000,30000
042929,台積電中信95購02,0,0,0,0,0,0,0,0,0,30000,0,0,0,30000,0,30000,30000
044996,嘉晶國泰95購01  ,0,0,0,0,0,0,0,0,0,30000,0,0,0,30000,0,30000,30000
044717,旺宏統一94購01  ,0,0,0,0,0,0,0,0,0,30000,0,0,0,30000,0,30000,30000
04798P,牧德元大95售02  ,0,0,0,0,0,0,0,0,0,30000,0,0,0,30000,0,30000,30000
046961,大立光中信95購02,0,0,0,0,0,0,0,0,0,30000,0,0,0,30000,0,30000,30000
046570,旺宏國泰94購01  ,0,0,0,0,0,0,0,0,0,30000,0,0,0,30000,0,30000,30000
03418B,臺股指元大95熊20,0,0,0,0,0,0,0,0,0,30000,0,0,0,36000,6000,30000,30000
048695,滬深2X國票95購03,0,0,0,0,0,0,0,0,0,30000,0,0,0,30000,0,30000,30000
049149,華新科元大95購03,0,0,0,0,0,0,0,0,0,30000,0,0,0,30000,0,30000,30000
020008,元大特股高息N   ,0,0,0,0,0,0,0,0,0,30000,0,0,0,41000,11000,30000,30000
051631,國巨國票96購06  ,0,0,0,0,0,0,0,0,0,30000,0,0,0,46000,16000,30000,30000
051640,GIS國票96購03   ,0,0,0,0,0,0,0,0,0,30000,0,0,0,30000,0,30000,30000
052052,嘉澤凱基95購02  ,0,0,0,0,0,0,0,0,0,30000,0,0,0,30000,0,30000,30000
052200,台光電統一95購02,0,0,0,0,0,0,0,0,0,30000,0,0,0,30000,0,30000,30000
054141,TPK元大96購02   ,0,0,0,0,0,0,0,0,0,30000,0,0,0,30000,0,30000,30000
05430P,台積電統一95售07,0,0,0,0,0,0,0,0,0,30000,0,0,0,186000,156000,30000,30000
054316,矽創凱基97購01  ,0,0,0,0,0,0,0,0,0,30000,0,0,0,50000,20000,30000,30000
052940,玉晶光兆豐97購01,0,0,0,0,0,0,0,0,0,30000,0,0,0,511000,481000,30000,30000
052691,GIS元大96購01   ,0,0,0,0,0,0,0,0,0,30000,0,0,0,128000,98000,30000,30000
054888,泰碩統一97購01  ,0,0,0,0,0,0,0,0,0,30000,0,0,0,40000,10000,30000,30000
055067,禾聯碩永豐97購01,0,0,0,0,0,0,0,0,0,30000,0,0,0,30000,0,30000,30000
054567,拓凱群益98購01  ,0,0,0,0,0,0,0,0,0,30000,0,0,0,30000,0,30000,30000
054450,聯茂第一96購01  ,0,0,0,0,0,0,0,0,0,30000,0,0,0,30000,0,30000,30000
053817,華新科群益97購02,0,0,0,0,0,0,0,0,0,30000,0,0,0,31000,1000,30000,30000
053332,創意永豐96購03  ,0,0,0,0,0,0,0,0,0,30000,0,0,0,40000,10000,30000,30000
053451,致新凱基96購02  ,0,0,0,0,0,0,0,0,0,30000,0,0,0,50000,20000,30000,30000
057787,TPK國票99購01   ,0,0,0,0,0,0,0,0,0,30000,0,0,0,54000,24000,30000,30000
057725,台達電國泰9A購01,0,0,0,0,0,0,0,0,0,30000,0,0,0,223000,193000,30000,30000
055856,新唐元大97購03  ,0,0,0,0,0,0,0,0,0,30000,0,0,0,30000,0,30000,30000
056176,創意元富97購01  ,0,0,0,0,0,0,0,0,0,30000,0,0,0,30000,0,30000,30000
057607,旺宏台新98購02  ,0,0,0,0,0,0,0,0,0,30000,0,0,0,30000,0,30000,30000
057598,鴻海群益98購07  ,0,0,0,0,0,0,0,0,0,30000,0,0,0,30000,0,30000,30000
060061,旺宏兆豐99購02  ,0,0,0,0,0,0,0,0,0,30000,0,0,0,33000,3000,30000,30000
060028,國揚永豐99購01  ,0,0,0,0,0,0,0,0,0,30000,0,0,0,30000,0,30000,30000
059126,臺指反中信9B購01,0,0,0,0,0,0,0,0,0,30000,0,0,0,30000,0,30000,30000
058986,華新科凱基9A購03,0,0,0,0,0,0,0,0,0,30000,0,0,0,40000,10000,30000,30000
058070,華新科凱基98購07,0,0,0,0,0,0,0,0,0,30000,0,0,0,30000,0,30000,30000
056946,國巨統一98購05  ,0,0,0,0,0,0,0,0,0,30000,0,0,0,30000,0,30000,30000
056960,光罩永豐98購01  ,0,0,0,0,0,0,0,0,0,30000,0,0,0,30000,0,30000,30000
058613,茂林元大99購03  ,0,0,0,0,0,0,0,0,0,30000,0,0,0,72000,42000,30000,30000
058010,帆宣國票98購01  ,0,0,0,0,0,0,0,0,0,30000,0,0,0,30000,0,30000,30000
058426,旺宏元富99購02  ,0,0,0,0,0,0,0,0,0,30000,0,0,0,30000,0,30000,30000
056417,欣興中信98購01  ,0,0,0,0,0,0,0,0,0,30000,0,0,0,30000,0,30000,30000
059566,台積電凱基9A購11,0,0,0,0,0,0,0,0,0,30000,0,0,0,32000,2000,30000,30000
059512,晶豪科永豐99購02,0,0,0,0,0,0,0,0,0,30000,0,0,0,30000,0,30000,30000
059431,旺宏元大99購14  ,0,0,0,0,0,0,0,0,0,30000,0,0,0,40000,10000,30000,30000
059435,大立光元大99購17,0,0,0,0,0,0,0,0,0,30000,0,0,0,30000,0,30000,30000
059369,滬深2X元富9C購01,0,0,0,0,0,0,0,0,0,30000,0,0,0,30000,0,30000,30000
059665,嘉聯益元大99購06,0,0,0,0,0,0,0,0,0,30000,0,0,0,30000,0,30000,30000
059337,台灣50凱基9C購05,0,0,0,0,0,0,0,0,0,30000,0,0,0,30000,0,30000,30000
059857,台灣50群益99購06,0,0,0,0,0,0,0,0,0,30000,0,0,0,31000,1000,30000,30000
1773,勝一            ,45000,12000,33000,0,0,0,0,0,0,-4000,0,4000,-4000,0,0,0,29000
058379,臺股指凱基99購14,0,0,0,0,0,0,0,0,0,29000,0,0,0,60000,31000,29000,29000
05296P,牧德凱基96售01  ,0,0,0,0,0,0,0,0,0,29000,0,0,0,29000,0,29000,29000
052851,滬深2X元富96購02,0,0,0,0,0,0,0,0,0,29000,0,0,0,29000,0,29000,29000
03437B,臺股指元富9C熊01,0,0,0,0,0,0,0,0,0,29000,0,0,0,31000,2000,29000,29000
056558,台達電群益98購01,0,0,0,0,0,0,0,0,0,29000,0,0,0,127000,98000,29000,29000
057849,南茂永豐98購02  ,0,0,0,0,0,0,0,0,0,29000,0,0,0,39000,10000,29000,29000
058774,台郡兆豐9A購01  ,0,0,0,0,0,0,0,0,0,29000,0,0,0,33000,4000,29000,29000
057960,聯鈞元大98購02  ,0,0,0,0,0,0,0,0,0,29000,0,0,0,210000,181000,29000,29000
058239,景碩元大99購03  ,0,0,0,0,0,0,0,0,0,29000,0,0,0,31000,2000,29000,29000
058177,華新科凱基99購02,0,0,0,0,0,0,0,0,0,29000,0,0,0,29000,0,29000,29000
060031,旭富永豐99購02  ,0,0,0,0,0,0,0,0,0,29000,0,0,0,45000,16000,29000,29000
059784,台光電元大9A購01,0,0,0,0,0,0,0,0,0,29000,0,0,0,29000,0,29000,29000
059640,聯詠凱基99購04  ,0,0,0,0,0,0,0,0,0,29000,0,0,0,46000,17000,29000,29000
056223,華邦電凱基97購04,0,0,0,0,0,0,0,0,0,29000,0,0,0,49000,20000,29000,29000
055689,台郡凱基99購01  ,0,0,0,0,0,0,0,0,0,29000,0,0,0,49000,20000,29000,29000
059443,嘉聯益元大9B購01,0,0,0,0,0,0,0,0,0,29000,0,0,0,35000,6000,29000,29000
6120,達運            ,146000,99000,47000,0,0,0,0,0,0,-18000,0,18000,-18000,0,0,0,29000
07048P,台積電中信03售01,0,0,0,0,0,0,0,0,0,28000,0,0,0,28000,0,28000,28000
07400P,國巨凱基99售20  ,0,0,0,0,0,0,0,0,0,28000,0,0,0,76000,48000,28000,28000
060250,台表科元大9A購01,0,0,0,0,0,0,0,0,0,28000,0,0,0,58000,30000,28000,28000
054077,中石化中信98購01,0,0,0,0,0,0,0,0,0,28000,0,0,0,28000,0,28000,28000
052025,國巨群益96購01  ,0,0,0,0,0,0,0,0,0,28000,0,0,0,57000,29000,28000,28000
055152,旺宏元大98購04  ,0,0,0,0,0,0,0,0,0,28000,0,0,0,28000,0,28000,28000
055178,晶豪科統一97購01,0,0,0,0,0,0,0,0,0,28000,0,0,0,76000,48000,28000,28000
057799,世紀鋼兆豐98購01,0,0,0,0,0,0,0,0,0,28000,0,0,0,28000,0,28000,28000
058647,華新科永豐99購03,0,0,0,0,0,0,0,0,0,28000,0,0,0,28000,0,28000,28000
058308,全新元大9B購01  ,0,0,0,0,0,0,0,0,0,28000,0,0,0,43000,15000,28000,28000
056110,嘉聯益永豐97購02,0,0,0,0,0,0,0,0,0,28000,0,0,0,48000,20000,28000,28000
059579,聯發科元富99購06,0,0,0,0,0,0,0,0,0,28000,0,0,0,66000,38000,28000,28000
060115,南電元大99購06  ,0,0,0,0,0,0,0,0,0,28000,0,0,0,28000,0,28000,28000
3419,譁裕            ,81000,29000,52000,0,0,0,0,0,0,-24000,0,24000,-24000,0,0,0,28000
059493,國巨國票9B購01  ,0,0,0,0,0,0,0,0,0,28000,0,0,0,80000,52000,28000,28000
6415,矽力-KY         ,382000,324137,57863,0,0,0,12000,57000,-45000,15000,0,2000,-2000,17000,0,17000,27863
060307,南港永豐9A購01  ,0,0,0,0,0,0,0,0,0,27000,0,0,0,38000,11000,27000,27000
060513,緯穎元大9B購01  ,0,0,0,0,0,0,0,0,0,27000,0,0,0,35000,8000,27000,27000
061030,喬山永豐9A購01  ,0,0,0,0,0,0,0,0,0,27000,0,0,0,27000,0,27000,27000
07174P,臺股指國票99售11,0,0,0,0,0,0,0,0,0,27000,0,0,0,220000,193000,27000,27000
06505P,康控國票99售02  ,0,0,0,0,0,0,0,0,0,27000,0,0,0,35000,8000,27000,27000
058318,致茂永豐9A購01  ,0,0,0,0,0,0,0,0,0,27000,0,0,0,27000,0,27000,27000
058648,聯陽永豐99購01  ,0,0,0,0,0,0,0,0,0,27000,0,0,0,54000,27000,27000,27000
058676,聯茂群益99購01  ,0,0,0,0,0,0,0,0,0,27000,0,0,0,108000,81000,27000,27000
053770,元金2X元大98購01,0,0,0,0,0,0,0,0,0,27000,0,0,0,27000,0,27000,27000
056114,台達電群益97購02,0,0,0,0,0,0,0,0,0,27000,0,0,0,27000,0,27000,27000
055919,景碩凱基98購02  ,0,0,0,0,0,0,0,0,0,27000,0,0,0,38000,11000,27000,27000
055610,光磊國票98購01  ,0,0,0,0,0,0,0,0,0,27000,0,0,0,27000,0,27000,27000
059113,群光永豐99購01  ,0,0,0,0,0,0,0,0,0,27000,0,0,0,37000,10000,27000,27000
056966,嘉晶永豐98購01  ,0,0,0,0,0,0,0,0,0,27000,0,0,0,31000,4000,27000,27000
056754,智易兆豐99購01  ,0,0,0,0,0,0,0,0,0,27000,0,0,0,37000,10000,27000,27000
058931,玉晶光統一9C購01,0,0,0,0,0,0,0,0,0,27000,0,0,0,29000,2000,27000,27000
059873,華新科凱基99購09,0,0,0,0,0,0,0,0,0,27000,0,0,0,53000,26000,27000,27000
07084P,S&P正2元富9B售02,0,0,0,0,0,0,0,0,0,26000,0,0,0,27000,1000,26000,26000
07646P,世芯元大9A售04  ,0,0,0,0,0,0,0,0,0,26000,0,0,0,105000,79000,26000,26000
2390,云辰            ,235000,209000,26000,0,0,0,0,0,0,0,0,0,0,0,0,0,26000
052234,GIS凱基97購01   ,0,0,0,0,0,0,0,0,0,26000,0,0,0,29000,3000,26000,26000
048527,鴻海國票94購02  ,0,0,0,0,0,0,0,0,0,26000,0,0,0,26000,0,26000,26000
04590P,元石油元大97售01,0,0,0,0,0,0,0,0,0,26000,0,0,0,26000,0,26000,26000
056479,玉晶光元大99購05,0,0,0,0,0,0,0,0,0,26000,0,0,0,80000,54000,26000,26000
056434,國巨凱基98購03  ,0,0,0,0,0,0,0,0,0,26000,0,0,0,129000,103000,26000,26000
056397,彩晶永豐99購01  ,0,0,0,0,0,0,0,0,0,26000,0,0,0,26000,0,26000,26000
058440,玉晶光統一99購02,0,44000,-44000,0,0,0,0,0,0,70000,0,0,0,71000,1000,70000,26000
056655,旺宏元大99購02  ,0,0,0,0,0,0,0,0,0,26000,0,0,0,50000,24000,26000,26000
057875,京鼎元大98購03  ,0,0,0,0,0,0,0,0,0,26000,0,0,0,36000,10000,26000,26000
056921,京元電兆豐98購01,0,0,0,0,0,0,0,0,0,26000,0,0,0,190000,164000,26000,26000
6108,競國            ,82000,49000,33000,0,0,0,0,0,0,-7000,0,7000,-7000,0,0,0,26000
1906,寶隆            ,51000,26000,25000,0,0,0,0,0,0,0,0,0,0,0,0,0,25000
07131P,緯穎元大99售06  ,0,0,0,0,0,0,0,0,0,25000,0,0,0,61000,36000,25000,25000
06595P,祥碩元大98售03  ,0,0,0,0,0,0,0,0,0,25000,0,0,0,25000,0,25000,25000
07393P,台灣50富邦9B售02,0,0,0,0,0,0,0,0,0,25000,0,0,0,25000,0,25000,25000
07600P,台灣50凱基04售06,0,0,0,0,0,0,0,0,0,25000,0,0,0,50000,25000,25000,25000
060913,宏達電元大9A購03,0,0,0,0,0,0,0,0,0,25000,0,0,0,25000,0,25000,25000
060790,日月光富邦9A購01,0,0,0,0,0,0,0,0,0,25000,0,0,0,25000,0,25000,25000
06295P,國巨元大97售14  ,0,0,0,0,0,0,0,0,0,25000,0,0,0,25000,0,25000,25000
060530,聯發科中信9C購03,0,0,0,0,0,0,0,0,0,25000,0,0,0,30000,5000,25000,25000
060370,滬深2X元富04購01,0,0,0,0,0,0,0,0,0,25000,0,0,0,30000,5000,25000,25000
00753L,中信中國50正2   ,209000,193000,16000,0,0,0,0,0,0,9000,0,0,0,415000,406000,9000,25000
054058,晶豪科國票98購01,0,0,0,0,0,0,0,0,0,25000,0,0,0,25000,0,25000,25000
052176,景碩元大96購01  ,0,0,0,0,0,0,0,0,0,25000,0,0,0,25000,0,25000,25000
053114,聯茂兆豐97購01  ,0,0,0,0,0,0,0,0,0,25000,0,0,0,25000,0,25000,25000
053642,瀚宇博永豐96購01,0,0,0,0,0,0,0,0,0,25000,0,0,0,25000,0,25000,25000
058309,大毅元大99購02  ,0,0,0,0,0,0,0,0,0,25000,0,0,0,26000,1000,25000,25000
056330,玉晶光國票99購03,0,0,0,0,0,0,0,0,0,25000,0,0,0,26000,1000,25000,25000
056295,國巨元大97購16  ,0,0,0,0,0,0,0,0,0,25000,0,0,0,35000,10000,25000,25000
052926,旺宏元大98購02  ,0,0,0,0,0,0,0,0,0,25000,0,0,0,25000,0,25000,25000
055063,玉晶光永豐99購01,0,0,0,0,0,0,0,0,0,25000,0,0,0,25000,0,25000,25000
055214,聯電凱基97購02  ,0,0,0,0,0,0,0,0,0,25000,0,0,0,25000,0,25000,25000
056883,美食康和98購01  ,0,0,0,0,0,0,0,0,0,25000,0,0,0,118000,93000,25000,25000
058110,光寶科元富98購01,0,0,0,0,0,0,0,0,0,25000,0,0,0,35000,10000,25000,25000
05917P,宏達電元大96售02,0,0,0,0,0,0,0,0,0,25000,0,0,0,25000,0,25000,25000
057040,國巨元大98購12  ,0,0,0,0,0,0,0,0,0,25000,0,0,0,25000,0,25000,25000
056563,華新科群益98購04,0,0,0,0,0,0,0,0,0,25000,0,0,0,35000,10000,25000,25000
058479,亞光凱基9A購01  ,0,0,0,0,0,0,0,0,0,25000,0,0,0,25000,0,25000,25000
055924,深中小群益9B購01,0,0,0,0,0,0,0,0,0,25000,0,0,0,25000,0,25000,25000
055947,元油反元大98購03,0,0,0,0,0,0,0,0,0,25000,0,0,0,25000,0,25000,25000
057524,旺宏元大99購04  ,0,0,0,0,0,0,0,0,0,25000,0,0,0,36000,11000,25000,25000
6155,鈞寶            ,113000,88000,25000,0,0,0,0,0,0,0,0,0,0,0,0,0,25000
059334,A50正2國票9A購02,0,0,0,0,0,0,0,0,0,25000,0,0,0,80000,55000,25000,25000
059654,T50反1元大99購09,0,0,0,0,0,0,0,0,0,25000,0,0,0,25000,0,25000,25000
059516,TPK永豐99購01   ,0,0,0,0,0,0,0,0,0,25000,0,0,0,44000,19000,25000,25000
059531,華新科凱基9B購02,0,0,0,0,0,0,0,0,0,25000,0,0,0,28000,3000,25000,25000
059436,大立光元大99購18,0,0,0,0,0,0,0,0,0,25000,0,0,0,26000,1000,25000,25000
059383,台灣50凱基99購03,0,0,0,0,0,0,0,0,0,25000,0,0,0,57000,32000,25000,25000
059390,華新科凱基99購05,0,0,0,0,0,0,0,0,0,25000,0,0,0,25000,0,25000,25000
060268,台灣50元大9C購20,0,0,0,0,0,0,0,0,0,24000,0,0,0,24000,0,24000,24000
060686,康友元大9A購02  ,0,0,0,0,0,0,0,0,0,24000,0,0,0,42000,18000,24000,24000
060925,華新科永豐9A購01,0,0,0,0,0,0,0,0,0,24000,0,0,0,274000,250000,24000,24000
07279P,台灣50台新99售02,0,0,0,0,0,0,0,0,0,24000,0,0,0,154000,130000,24000,24000
054981,國巨元富97購02  ,0,0,0,0,0,0,0,0,0,24000,0,0,0,24000,0,24000,24000
055459,建準永豐97購03  ,0,0,0,0,0,0,0,0,0,24000,0,0,0,24000,0,24000,24000
053211,漢唐凱基96購03  ,0,0,0,0,0,0,0,0,0,24000,0,0,0,68000,44000,24000,24000
051321,建準國票96購01  ,0,0,0,0,0,0,0,0,0,24000,0,0,0,24000,0,24000,24000
051319,光磊國票96購02  ,0,0,0,0,0,0,0,0,0,24000,0,0,0,24000,0,24000,24000
054070,創意國泰96購02  ,0,0,0,0,0,0,0,0,0,24000,0,0,0,24000,0,24000,24000
00665L,富邦恒生國企正2 ,20000,26000,-6000,0,0,0,0,0,0,30000,0,0,0,56000,26000,30000,24000
046492,旺宏富邦94購02  ,0,0,0,0,0,0,0,0,0,24000,0,0,0,24000,0,24000,24000
057637,上銀元大98購07  ,0,0,0,0,0,0,0,0,0,24000,0,0,0,42000,18000,24000,24000
059994,國巨元富99購01  ,0,0,0,0,0,0,0,0,0,24000,0,0,0,24000,0,24000,24000
060024,T50反1國泰9B購02,0,0,0,0,0,0,0,0,0,24000,0,0,0,32000,8000,24000,24000
059072,元油2X元大9C購13,0,0,0,0,0,0,0,0,0,24000,0,0,0,240000,216000,24000,24000
059204,台灣50元大01購02,0,0,0,0,0,0,0,0,0,24000,0,0,0,26000,2000,24000,24000
058145,聯茂元大99購03  ,0,0,0,0,0,0,0,0,0,24000,0,0,0,110000,86000,24000,24000
3029,零壹            ,193000,162000,31000,0,0,0,0,0,0,-7000,0,7000,-7000,0,0,0,24000
9907,統一實          ,158000,134000,24000,0,0,0,0,0,0,0,0,0,0,0,0,0,24000
6283,淳安            ,55000,30000,25000,0,0,0,0,0,0,-1000,0,1000,-1000,0,0,0,24000
07396P,聯發科群益9B售01,0,0,0,0,0,0,0,0,0,23000,0,0,0,60000,37000,23000,23000
07621P,台積電統一9B售09,0,0,0,0,0,0,0,0,0,23000,0,0,0,23000,0,23000,23000
07693P,群創元大9B售10  ,0,0,0,0,0,0,0,0,0,23000,0,0,0,124000,101000,23000,23000
1321,大洋            ,36000,13000,23000,0,0,0,0,0,0,0,0,0,0,0,0,0,23000
060716,新唐永豐9A購01  ,0,0,0,0,0,0,0,0,0,23000,0,0,0,23000,0,23000,23000
061126,京元電永豐9A購02,0,0,0,0,0,0,0,0,0,23000,0,0,0,23000,0,23000,23000
060515,臺股指元大9B購12,0,0,0,0,0,0,0,0,0,23000,0,0,0,33000,10000,23000,23000
054011,旺宏永豐96購05  ,0,0,0,0,0,0,0,0,0,23000,0,0,0,23000,0,23000,23000
053430,樺漢永豐96購01  ,0,0,0,0,0,0,0,0,0,23000,0,0,0,23000,0,23000,23000
053361,友達元富99購01  ,0,0,0,0,0,0,0,0,0,23000,0,0,0,26000,3000,23000,23000
053728,茂林凱基97購01  ,0,0,0,0,0,0,0,0,0,23000,0,0,0,24000,1000,23000,23000
053710,華通凱基96購05  ,0,0,0,0,0,0,0,0,0,23000,0,0,0,23000,0,23000,23000
055466,台達電凱基97購03,0,0,0,0,0,0,0,0,0,23000,0,0,0,24000,1000,23000,23000
054951,大毅元大97購01  ,0,0,0,0,0,0,0,0,0,23000,0,0,0,24000,1000,23000,23000
054638,國泰金中信99購01,0,0,0,0,0,0,0,0,0,23000,0,0,0,23000,0,23000,23000
059191,茂林富邦9B購01  ,0,0,0,0,0,0,0,0,0,23000,0,0,0,104000,81000,23000,23000
059131,國巨群益99購07  ,0,0,0,0,0,0,0,0,0,23000,0,0,0,125000,102000,23000,23000
058771,神達兆豐99購01  ,0,0,0,0,0,0,0,0,0,23000,0,0,0,53000,30000,23000,23000
058909,神達元大99購03  ,0,0,0,0,0,0,0,0,0,23000,0,0,0,89000,66000,23000,23000
059246,奇力新凱基9A購02,0,0,0,0,0,0,0,0,0,23000,0,0,0,23000,0,23000,23000
057173,南亞科元大98購04,0,0,0,0,0,0,0,0,0,23000,0,0,0,25000,2000,23000,23000
057232,京元電凱基98購02,0,0,0,0,0,0,0,0,0,23000,0,0,0,23000,0,23000,23000
057284,新日興元大98購03,0,0,0,0,0,0,0,0,0,23000,0,0,0,62000,39000,23000,23000
055997,矽創國泰99購01  ,0,0,0,0,0,0,0,0,0,23000,0,0,0,161000,138000,23000,23000
060150,華通富邦9B購01  ,0,0,0,0,0,0,0,0,0,23000,0,0,0,32000,9000,23000,23000
057689,南亞科凱基99購02,0,0,0,0,0,0,0,0,0,23000,0,0,0,26000,3000,23000,23000
059719,台積電元大99購42,0,0,0,0,0,0,0,0,0,23000,0,0,0,39000,16000,23000,23000
059886,可成國票99購04  ,0,0,0,0,0,0,0,0,0,23000,0,0,0,37000,14000,23000,23000
059666,台表科元大9B購01,0,0,0,0,0,0,0,0,0,23000,0,0,0,60000,37000,23000,23000
059527,聯發科凱基99購16,0,0,0,0,0,0,0,0,0,23000,0,0,0,50000,27000,23000,23000
060457,中橡元大9A購02  ,0,0,0,0,0,0,0,0,0,22000,0,0,0,92000,70000,22000,22000
060636,大毅永豐9A購02  ,0,0,0,0,0,0,0,0,0,22000,0,0,0,22000,0,22000,22000
060777,茂林凱基9C購01  ,0,0,0,0,0,0,0,0,0,22000,0,0,0,80000,58000,22000,22000
060356,上銀元富9A購01  ,0,0,0,0,0,0,0,0,0,22000,0,0,0,49000,27000,22000,22000
1527,鑽全            ,168000,145000,23000,0,0,0,0,1000,-1000,0,0,0,0,0,0,0,22000
07467P,上銀元大9A售03  ,0,0,0,0,0,0,0,0,0,22000,0,0,0,72000,50000,22000,22000
07300P,臺股指元大9A售33,0,0,0,0,0,0,0,0,0,22000,0,0,0,81000,59000,22000,22000
055294,智易元大98購01  ,0,0,0,0,0,0,0,0,0,22000,0,0,0,22000,0,22000,22000
053999,台表科群益96購06,0,0,0,0,0,0,0,0,0,22000,0,0,0,32000,10000,22000,22000
051740,可成國票96購04  ,0,0,0,0,0,0,0,0,0,22000,0,0,0,60000,38000,22000,22000
050634,華新科群益96購01,0,0,0,0,0,0,0,0,0,22000,0,0,0,22000,0,22000,22000
050481,泰鼎國票96購01  ,0,0,0,0,0,0,0,0,0,22000,0,0,0,80000,58000,22000,22000
050842,旺宏國票97購01  ,0,0,0,0,0,0,0,0,0,22000,0,0,0,22000,0,22000,22000
00664R,國泰臺灣加權反1 ,2000,1000,1000,0,0,0,0,0,0,21000,0,0,0,1404000,1383000,21000,22000
057626,技嘉富邦9A購01  ,0,0,0,0,0,0,0,0,0,22000,0,0,0,109000,87000,22000,22000
059278,群創元大9A購04  ,0,0,0,0,0,0,0,0,0,22000,0,0,0,23000,1000,22000,22000
055984,大立光元富97購02,0,0,0,0,0,0,0,0,0,22000,0,0,0,24000,2000,22000,22000
055772,致茂凱基97購01  ,0,0,0,0,0,0,0,0,0,22000,0,0,0,22000,0,22000,22000
058456,京鼎永豐99購01  ,0,0,0,0,0,0,0,0,0,22000,0,0,0,34000,12000,22000,22000
056791,嘉聯益群益98購01,0,0,0,0,0,0,0,0,0,22000,0,0,0,22000,0,22000,22000
059480,美律群益9A購01  ,0,0,0,0,0,0,0,0,0,22000,0,0,0,26000,4000,22000,22000
059413,台灣50元大99購05,0,0,0,0,0,0,0,0,0,22000,0,0,0,22000,0,22000,22000
059455,玉晶光永豐99購05,0,0,0,0,0,0,0,0,0,22000,0,0,0,33000,11000,22000,22000
3033,威健            ,65000,40000,25000,0,0,0,0,0,0,-3000,0,3000,-3000,0,0,0,22000
059885,台積電國票99購12,0,0,0,0,0,0,0,0,0,22000,0,0,0,32000,10000,22000,22000
6142,友勁            ,1000,9000,-8000,0,0,0,0,0,0,30000,31000,1000,30000,0,0,0,22000
07197P,臺股指元大99售13,0,0,0,0,0,0,0,0,0,21000,0,0,0,21000,0,21000,21000
1506,正道            ,29000,8000,21000,0,0,0,0,0,0,0,0,0,0,0,0,0,21000
1810,和成            ,35000,9000,26000,0,0,0,0,0,0,-5000,0,5000,-5000,0,0,0,21000
060676,京元電元大9A購03,0,0,0,0,0,0,0,0,0,21000,0,0,0,108000,87000,21000,21000
060600,台積電凱基9C購01,0,0,0,0,0,0,0,0,0,21000,0,0,0,26000,5000,21000,21000
051424,緯穎國票97購01  ,0,0,0,0,0,0,0,0,0,21000,0,0,0,21000,0,21000,21000
055142,健策永豐98購01  ,0,0,0,0,0,0,0,0,0,21000,0,0,0,65000,44000,21000,21000
053355,超眾兆豐97購01  ,0,0,0,0,0,0,0,0,0,21000,0,0,0,43000,22000,21000,21000
055556,奇力新凱基98購03,0,0,0,0,0,0,0,0,0,21000,0,0,0,21000,0,21000,21000
055810,T50反1國票99購01,0,0,0,0,0,0,0,0,0,21000,0,0,0,21000,0,21000,21000
060111,臻鼎元大99購04  ,0,0,0,0,0,0,0,0,0,21000,0,0,0,22000,1000,21000,21000
6172,互億            ,62000,39000,23000,0,0,0,0,0,0,-2000,0,2000,-2000,0,0,0,21000
059807,大立光元富99購09,0,0,0,0,0,0,0,0,0,21000,0,0,0,149000,128000,21000,21000
059396,T50反1元富99購04,27000,0,27000,0,0,0,0,0,0,-6000,0,0,0,4000,10000,-6000,21000
060563,智邦富邦9A購01  ,0,0,0,0,0,0,0,0,0,20000,0,0,0,160000,140000,20000,20000
061080,華邦電兆豐9B購01,0,0,0,0,0,0,0,0,0,20000,0,0,0,30000,10000,20000,20000
060281,卜蜂元大9C購01  ,0,0,0,0,0,0,0,0,0,20000,0,0,0,20000,0,20000,20000
06091P,華新科統一97售01,0,0,0,0,0,0,0,0,0,20000,0,0,0,33000,13000,20000,20000
060876,國巨中信9A購04  ,0,0,0,0,0,0,0,0,0,20000,0,0,0,50000,30000,20000,20000
060868,致伸永豐9A購01  ,10000,0,10000,0,0,0,0,0,0,10000,0,0,0,30000,20000,10000,20000
060857,旭富富邦9B購01  ,0,0,0,0,0,0,0,0,0,20000,0,0,0,63000,43000,20000,20000
060944,國泰金國票9A購01,0,0,0,0,0,0,0,0,0,20000,0,0,0,20000,0,20000,20000
061000,旺宏兆豐9A購02  ,0,0,0,0,0,0,0,0,0,20000,0,0,0,20000,0,20000,20000
06410P,祥碩統一97售01  ,0,0,0,0,0,0,0,0,0,20000,0,0,0,20000,0,20000,20000
061141,臻鼎統一9A購01  ,0,0,0,0,0,0,0,0,0,20000,0,0,0,20000,0,20000,20000
061286,大立光統一9A購05,0,0,0,0,0,0,0,0,0,20000,0,0,0,20000,0,20000,20000
061247,玉晶光群益9A購09,0,0,0,0,0,0,0,0,0,20000,0,0,0,21000,1000,20000,20000
1454,台富            ,29000,9000,20000,0,0,0,0,0,0,0,0,0,0,0,0,0,20000
07676P,華新科永豐9A售02,0,0,0,0,0,0,0,0,0,20000,0,0,0,20000,0,20000,20000
07686P,祥碩凱基9A售02  ,0,0,0,0,0,0,0,0,0,20000,0,0,0,20000,0,20000,20000
07664P,台灣50元大9C售30,0,0,0,0,0,0,0,0,0,20000,0,0,0,20000,0,20000,20000
8114,振樺電          ,32000,11000,21000,0,0,0,0,0,0,-1000,0,1000,-1000,0,0,0,20000
07087P,聯發科台新99售02,0,0,0,0,0,0,0,0,0,20000,0,0,0,20000,0,20000,20000
06985P,華新科富邦9C售02,0,0,0,0,0,0,0,0,0,20000,0,0,0,20000,0,20000,20000
06577P,聯發科日盛9A售02,0,0,0,0,0,0,0,0,0,20000,0,0,0,20000,0,20000,20000
06502P,A50中信98售01   ,0,0,0,0,0,0,0,0,0,20000,0,0,0,20000,0,20000,20000
06791P,聯發科凱基98售16,0,0,0,0,0,0,0,0,0,20000,0,0,0,20000,0,20000,20000
06853P,華擎元富98售03  ,0,0,0,0,0,0,0,0,0,20000,0,0,0,20000,0,20000,20000
07328P,FBVIX國泰9B售01 ,0,0,0,0,0,0,0,0,0,20000,0,0,0,20000,0,20000,20000
07356P,臺股指國票99售24,0,0,0,0,0,0,0,0,0,20000,0,0,0,20000,0,20000,20000
07606P,台灣50國票01售02,0,0,0,0,0,0,0,0,0,20000,0,0,0,20000,0,20000,20000
055559,大立光凱基97購09,0,0,0,0,0,0,0,0,0,20000,0,0,0,20000,0,20000,20000
053372,元油反元大98購01,0,0,0,0,0,0,0,0,0,20000,0,0,0,20000,0,20000,20000
053495,聯發科兆豐96購02,0,0,0,0,0,0,0,0,0,20000,0,0,0,20000,0,20000,20000
053781,友達元大9B購03  ,0,0,0,0,0,0,0,0,0,20000,0,0,0,20000,0,20000,20000
055333,晶豪科兆豐97購01,0,0,0,0,0,0,0,0,0,20000,0,0,0,20000,0,20000,20000
055469,台光電凱基97購01,0,0,0,0,0,0,0,0,0,20000,0,0,0,20000,0,20000,20000
052955,國巨日盛96購01  ,0,0,0,0,0,0,0,0,0,20000,0,0,0,20000,0,20000,20000
055015,帆宣元富97購01  ,0,0,0,0,0,0,0,0,0,20000,0,0,0,30000,10000,20000,20000
051416,創意國票96購02  ,0,0,0,0,0,0,0,0,0,20000,0,0,0,20000,0,20000,20000
051693,華新科統一95購02,0,0,0,0,0,0,0,0,0,20000,0,0,0,20000,0,20000,20000
051622,和碩凱基96購01  ,0,0,0,0,0,0,0,0,0,20000,0,0,0,20000,0,20000,20000
05091P,台積電元大95售11,0,0,0,0,0,0,0,0,0,20000,0,0,0,20000,0,20000,20000
051807,瑞昱凱基95購03  ,0,0,0,0,0,0,0,0,0,20000,0,0,0,20000,0,20000,20000
052056,緯穎凱基95購04  ,0,0,0,0,0,0,0,0,0,20000,0,0,0,30000,10000,20000,20000
052585,友達永豐97購01  ,0,0,0,0,0,0,0,0,0,20000,0,0,0,20000,0,20000,20000
054295,世芯元大96購03  ,0,0,0,0,0,0,0,0,0,20000,0,0,0,20000,0,20000,20000
054329,華新科永豐96購02,0,0,0,0,0,0,0,0,0,20000,0,0,0,20000,0,20000,20000
054334,超眾永豐96購04  ,0,0,0,0,0,0,0,0,0,20000,0,0,0,20000,0,20000,20000
054196,台光電國泰97購02,0,0,0,0,0,0,0,0,0,20000,0,0,0,20000,0,20000,20000
00713,元大台灣高息低波,26000,0,26000,0,0,0,0,0,0,-6000,0,0,0,11000,17000,-6000,20000
048623,世紀鋼凱基94購03,0,0,0,0,0,0,0,0,0,20000,0,0,0,20000,0,20000,20000
049251,國巨元大95購02  ,0,0,0,0,0,0,0,0,0,20000,0,0,0,69000,49000,20000,20000
050543,聯發科凱基95購01,0,0,0,0,0,0,0,0,0,20000,0,0,0,20000,0,20000,20000
050219,台積電元富95購03,0,0,0,0,0,0,0,0,0,20000,0,0,0,20000,0,20000,20000
050303,S&P反1中信96購01,0,0,0,0,0,0,0,0,0,20000,0,0,0,20000,0,20000,20000
050457,力成元大94購01  ,0,0,0,0,0,0,0,0,0,20000,0,0,0,20000,0,20000,20000
04628P,欣興元大95售01  ,0,0,0,0,0,0,0,0,0,20000,0,0,0,259000,239000,20000,20000
060129,祥碩永豐99購03  ,0,0,0,0,0,0,0,0,0,20000,0,0,0,35000,15000,20000,20000
060166,佐登永豐9A購01  ,0,0,0,0,0,0,0,0,0,20000,0,0,0,20000,0,20000,20000
060021,立積康和99購01  ,0,0,0,0,0,0,0,0,0,20000,0,0,0,20000,0,20000,20000
060070,國巨元富99購02  ,0,0,0,0,0,0,0,0,0,20000,0,0,0,220000,200000,20000,20000
059281,創意永豐99購02  ,0,0,0,0,0,0,0,0,0,20000,0,0,0,30000,10000,20000,20000
059630,美律凱基99購07  ,0,0,0,0,0,0,0,0,0,20000,0,0,0,40000,20000,20000,20000
057466,泰鼎永豐98購01  ,0,0,0,0,0,0,0,0,0,20000,0,0,0,20000,0,20000,20000
055590,聯發科元大98購02,0,0,0,0,0,0,0,0,0,20000,0,0,0,20000,0,20000,20000
055585,國巨元大98購08  ,0,0,0,0,0,0,0,0,0,20000,0,0,0,20000,0,20000,20000
05618P,聯發科元富96售02,0,0,0,0,0,0,0,0,0,20000,0,0,0,20000,0,20000,20000
057125,國巨凱基98購12  ,0,0,0,0,0,0,0,0,0,20000,0,0,0,40000,20000,20000,20000
057132,華新科凱基98購05,0,0,0,0,0,0,0,0,0,20000,0,0,0,20000,0,20000,20000
056012,勤誠中信99購01  ,0,0,0,0,0,0,0,0,0,20000,0,0,0,20000,0,20000,20000
055939,GIS群益97購01   ,0,0,0,0,0,0,0,0,0,20000,0,0,0,20000,0,20000,20000
055963,欣興元大97購04  ,0,0,0,0,0,0,0,0,0,20000,0,0,0,117000,97000,20000,20000
056066,奇鋐元大98購02  ,0,0,0,0,0,0,0,0,0,20000,0,0,0,20000,0,20000,20000
056179,康友元富97購02  ,0,0,0,0,0,0,0,0,0,20000,0,0,0,20000,0,20000,20000
057258,中環兆豐98購01  ,0,0,0,0,0,0,0,0,0,20000,0,0,0,75000,55000,20000,20000
057430,富邦金兆豐98購01,0,0,0,0,0,0,0,0,0,20000,0,0,0,20000,0,20000,20000
059235,鴻海凱基99購08  ,0,0,0,0,0,0,0,0,0,20000,0,0,0,20000,0,20000,20000
058016,智邦凱基98購06  ,0,0,0,0,0,0,0,0,0,20000,0,0,0,25000,5000,20000,20000
057954,宏碁元大99購01  ,0,0,0,0,0,0,0,0,0,20000,0,0,0,20000,0,20000,20000
057988,鈺齊元富98購02  ,0,0,0,0,0,0,0,0,0,20000,0,0,0,30000,10000,20000,20000
058022,樺漢凱基99購02  ,0,0,0,0,0,0,0,0,0,20000,0,0,0,20000,0,20000,20000
059155,台表科日盛99購01,0,0,0,0,0,0,0,0,0,20000,0,0,0,183000,163000,20000,20000
059194,元金2X永豐99購01,0,0,0,0,0,0,0,0,0,20000,0,0,0,25000,5000,20000,20000
058192,訊芯永豐99購01  ,0,0,0,0,0,0,0,0,0,20000,0,0,0,30000,10000,20000,20000
055875,光罩元富97購02  ,0,0,0,0,0,0,0,0,0,20000,0,0,0,29000,9000,20000,20000
057074,立積永豐98購01  ,0,0,0,0,0,0,0,0,0,20000,0,0,0,166000,146000,20000,20000
058911,茂林元大99購04  ,0,0,0,0,0,0,0,0,0,20000,0,0,0,88000,68000,20000,20000
058815,華新科台新99購03,0,0,0,0,0,0,0,0,0,20000,0,0,0,20000,0,20000,20000
057870,大立光凱基99購02,0,0,0,0,0,0,0,0,0,20000,0,0,0,20000,0,20000,20000
058753,元石油群益9B購03,0,0,0,0,0,0,0,0,0,20000,0,0,0,20000,0,20000,20000
056368,祥碩元大98購02  ,0,0,0,0,0,0,0,0,0,20000,0,0,0,20000,0,20000,20000
058698,華通元大99購05  ,0,0,0,0,0,0,0,0,0,20000,0,0,0,30000,10000,20000,20000
056614,智邦永豐98購01  ,0,0,0,0,0,0,0,0,0,20000,0,0,0,63000,43000,20000,20000
056610,鴻海永豐98購01  ,0,0,0,0,0,0,0,0,0,20000,0,0,0,20000,0,20000,20000
056393,精元永豐98購01  ,0,0,0,0,0,0,0,0,0,20000,0,0,0,20000,0,20000,20000
056379,玉晶光元富98購01,0,0,0,0,0,0,0,0,0,20000,0,0,0,20000,0,20000,20000
059382,台灣50凱基99購02,0,0,0,0,0,0,0,0,0,20000,0,0,0,20000,0,20000,20000
059430,台積電元大99購36,0,0,0,0,0,0,0,0,0,20000,0,0,0,51000,31000,20000,20000
059528,華新科凱基99購06,0,0,0,0,0,0,0,0,0,20000,0,0,0,20000,0,20000,20000
910861,神州-DR         ,20000,0,20000,0,0,0,0,0,0,0,0,0,0,0,0,0,20000
059659,旺宏元大9A購03  ,0,0,0,0,0,0,0,0,0,20000,0,0,0,20000,0,20000,20000
059942,全新永豐99購04  ,0,0,0,0,0,0,0,0,0,20000,0,0,0,44000,24000,20000,20000
059250,大立光凱基99購06,0,0,0,0,0,0,0,0,0,20000,0,0,0,20000,0,20000,20000
059712,滬深2X元大9C購03,0,0,0,0,0,0,0,0,0,20000,0,0,0,20000,0,20000,20000
059690,建準永豐99購01  ,0,0,0,0,0,0,0,0,0,20000,0,0,0,30000,10000,20000,20000
059691,大立光永豐99購02,0,0,0,0,0,0,0,0,0,20000,0,0,0,30000,10000,20000,20000
5519,隆大            ,73000,53000,20000,0,0,0,0,0,0,0,0,0,0,0,0,0,20000
6189,豐藝            ,54000,32000,22000,0,0,0,0,0,0,-2000,0,2000,-2000,0,0,0,20000
4306,炎洲            ,74116,57000,17116,0,0,0,0,0,0,2000,4000,2000,2000,0,0,0,19116
061035,亞光永豐9A購01  ,0,0,0,0,0,0,0,0,0,19000,0,0,0,29000,10000,19000,19000
060855,華新科富邦01購01,0,0,0,0,0,0,0,0,0,19000,0,0,0,145000,126000,19000,19000
060825,聯詠元大9A購05  ,0,0,0,0,0,0,0,0,0,19000,0,0,0,31000,12000,19000,19000
060556,緯穎凱基9A購04  ,0,0,0,0,0,0,0,0,0,19000,0,0,0,60000,41000,19000,19000
060524,國巨中信9A購03  ,0,0,0,0,0,0,0,0,0,19000,0,0,0,19000,0,19000,19000
060755,鴻海元大9A購15  ,0,0,0,0,0,0,0,0,0,19000,0,0,0,19000,0,19000,19000
053972,華新科元大96購06,0,0,0,0,0,0,0,0,0,19000,0,0,0,19000,0,19000,19000
055229,大毅國票97購02  ,0,0,0,0,0,0,0,0,0,19000,0,0,0,20000,1000,19000,19000
054390,智邦元富96購03  ,0,0,0,0,0,0,0,0,0,19000,0,0,0,40000,21000,19000,19000
054554,大立光凱基98購02,0,0,0,0,0,0,0,0,0,19000,0,0,0,20000,1000,19000,19000
055121,鴻海兆豐97購03  ,0,0,0,0,0,0,0,0,0,19000,0,0,0,74000,55000,19000,19000
056579,麗豐元大99購01  ,0,0,0,0,0,0,0,0,0,19000,0,0,0,134000,115000,19000,19000
058901,美律元大99購07  ,0,0,0,0,0,0,0,0,0,19000,0,0,0,42000,23000,19000,19000
058237,嘉晶元大99購04  ,0,0,0,0,0,0,0,0,0,19000,0,0,0,50000,31000,19000,19000
056963,建準永豐98購01  ,0,0,0,0,0,0,0,0,0,19000,0,0,0,19000,0,19000,19000
058053,上銀統一9B購01  ,0,0,0,0,0,0,0,0,0,19000,0,0,0,19000,0,19000,19000
058957,貿聯國票9A購01  ,0,0,0,0,0,0,0,0,0,19000,0,0,0,66000,47000,19000,19000
055779,國泰金凱基97購02,0,0,0,0,0,0,0,0,0,19000,0,0,0,62000,43000,19000,19000
057502,訊芯群益98購02  ,0,0,0,0,0,0,0,0,0,19000,0,0,0,185000,166000,19000,19000
060054,華新科凱基9B購04,0,0,0,0,0,0,0,0,0,19000,0,0,0,29000,10000,19000,19000
060065,大立光兆豐9B購01,0,0,0,0,0,0,0,0,0,19000,0,0,0,30000,11000,19000,19000
060081,台灣50元大02購02,0,0,0,0,0,0,0,0,0,19000,0,0,0,36000,17000,19000,19000
6168,宏齊            ,58000,34000,24000,0,0,0,0,0,0,-5000,0,5000,-5000,0,0,0,19000
059790,立積元大9C購02  ,0,0,0,0,0,0,0,0,0,19000,0,0,0,19000,0,19000,19000
060644,泰鼎永豐9A購02  ,0,0,0,0,0,0,0,0,0,18000,0,0,0,117000,99000,18000,18000
06052P,台郡國票97售06  ,0,0,0,0,0,0,0,0,0,18000,0,0,0,18000,0,18000,18000
061298,華新科富邦01購02,0,0,0,0,0,0,0,0,0,18000,0,0,0,100000,82000,18000,18000
05439P,聯發科國票95售06,0,0,0,0,0,0,0,0,0,18000,0,0,0,22000,4000,18000,18000
055054,群光永豐97購01  ,0,0,0,0,0,0,0,0,0,18000,0,0,0,58000,40000,18000,18000
054922,文曄凱基98購01  ,0,0,0,0,0,0,0,0,0,18000,0,0,0,20000,2000,18000,18000
053750,致伸永豐96購02  ,0,0,0,0,0,0,0,0,0,18000,0,0,0,18000,0,18000,18000
058326,祥碩台新99購01  ,0,0,0,0,0,0,0,0,0,18000,0,0,0,18000,0,18000,18000
052294,創意國票96購03  ,0,0,0,0,0,0,0,0,0,18000,0,0,0,19000,1000,18000,18000
046937,聯電元大99購01  ,0,0,0,0,0,0,0,0,0,18000,0,0,0,63000,45000,18000,18000
047418,智邦富邦97購01  ,0,0,0,0,0,0,0,0,0,18000,0,0,0,28000,10000,18000,18000
050882,華泰國泰96購01  ,0,0,0,0,0,0,0,0,0,18000,0,0,0,18000,0,18000,18000
02001L,富邦蘋果正二N   ,0,0,0,0,0,0,0,0,0,18000,0,0,0,24000,6000,18000,18000
06004P,奇力新永豐96售02,0,0,0,0,0,0,0,0,0,18000,0,0,0,40000,22000,18000,18000
060011,臺股指群益9C購06,0,0,0,0,0,0,0,0,0,18000,0,0,0,18000,0,18000,18000
060203,緯穎元富9A購01  ,0,0,0,0,0,0,0,0,0,18000,0,0,0,70000,52000,18000,18000
059282,嘉聯益永豐99購01,0,0,0,0,0,0,0,0,0,18000,0,0,0,22000,4000,18000,18000
059203,勤誠永豐99購02  ,0,0,0,0,0,0,0,0,0,18000,0,0,0,40000,22000,18000,18000
059212,鴻海元大99購28  ,0,0,0,0,0,0,0,0,0,18000,0,0,0,50000,32000,18000,18000
056980,建準群益98購02  ,0,0,0,0,0,0,0,0,0,18000,0,0,0,23000,5000,18000,18000
059103,旭富元富99購03  ,0,0,0,0,0,0,0,0,0,18000,0,0,0,47000,29000,18000,18000
058399,美律元大99購05  ,0,0,0,0,0,0,0,0,0,18000,0,0,0,25000,7000,18000,18000
056719,台虹永豐98購01  ,0,0,0,0,0,0,0,0,0,18000,0,0,0,31000,13000,18000,18000
056507,創意永豐98購02  ,0,0,0,0,0,0,0,0,0,18000,0,0,0,120000,102000,18000,18000
056410,康控國票99購01  ,0,0,0,0,0,0,0,0,0,18000,0,0,0,18000,0,18000,18000
058550,南亞科永豐99購01,0,0,0,0,0,0,0,0,0,18000,0,0,0,18000,0,18000,18000
059821,美律凱基99購08  ,0,0,0,0,0,0,0,0,0,18000,0,0,0,38000,20000,18000,18000
059854,台表科永豐99購03,0,0,0,0,0,0,0,0,0,18000,0,0,0,20000,2000,18000,18000
05982P,漢唐國票96售03  ,0,0,0,0,0,0,0,0,0,18000,0,0,0,18000,0,18000,18000
059959,訊芯康和99購01  ,0,0,0,0,0,0,0,0,0,18000,0,0,0,34000,16000,18000,18000
059674,玉山金元富99購02,0,0,0,0,0,0,0,0,0,18000,0,0,0,40000,22000,18000,18000
5706,鳳凰            ,29000,11000,18000,0,0,0,0,0,0,0,0,0,0,0,0,0,18000
060861,漢唐永豐9A購01  ,0,0,0,0,0,0,0,0,0,17000,0,0,0,66000,49000,17000,17000
060694,旺宏麥證9A購02  ,0,0,0,17000,0,17000,0,0,0,17000,0,0,0,17000,0,17000,17000
07662P,台積電兆豐9A售03,0,0,0,0,0,0,0,0,0,17000,0,0,0,17000,0,17000,17000
0054,元大台商50      ,0,0,0,0,0,0,0,0,0,17000,0,0,0,18000,1000,17000,17000
049554,禾伸堂富邦96購01,0,0,0,0,0,0,0,0,0,17000,0,0,0,17000,0,17000,17000
053947,義隆富邦97購01  ,0,0,0,0,0,0,0,0,0,17000,0,0,0,274000,257000,17000,17000
053905,華新科凱基96購10,0,0,0,0,0,0,0,0,0,17000,0,0,0,22000,5000,17000,17000
053761,健策國泰98購01  ,0,0,0,0,0,0,0,0,0,17000,0,0,0,17000,0,17000,17000
055563,智易凱基97購02  ,0,0,0,0,0,0,0,0,0,17000,0,0,0,128000,111000,17000,17000
053320,華新科群益97購01,0,50000,-50000,0,0,0,0,0,0,67000,0,0,0,96000,29000,67000,17000
055132,台虹康和97購01  ,0,0,0,0,0,0,0,0,0,17000,0,0,0,17000,0,17000,17000
055287,日電貿元大97購01,0,0,0,0,0,0,0,0,0,17000,0,0,0,17000,0,17000,17000
052700,奇鋐國票97購02  ,0,0,0,0,0,0,0,0,0,17000,0,0,0,87000,70000,17000,17000
052928,美律元大98購01  ,0,0,0,0,0,0,0,0,0,17000,0,0,0,17000,0,17000,17000
057928,鈺齊凱基98購02  ,0,0,0,0,0,0,0,0,0,17000,0,0,0,17000,0,17000,17000
058140,臻鼎元大99購02  ,0,0,0,0,0,0,0,0,0,17000,0,0,0,23000,6000,17000,17000
057352,大立光統一9A購02,0,0,0,0,0,0,0,0,0,17000,0,0,0,17000,0,17000,17000
056121,勤誠群益97購01  ,0,0,0,0,0,0,0,0,0,17000,0,0,0,94000,77000,17000,17000
059264,台光電中信99購02,0,0,0,0,0,0,0,0,0,17000,0,0,0,153000,136000,17000,17000
05761P,嘉澤永豐96售01  ,0,0,0,0,0,0,0,0,0,17000,0,0,0,27000,10000,17000,17000
059636,宏達電凱基99購05,0,0,0,0,0,0,0,0,0,17000,0,0,0,20000,3000,17000,17000
057517,矽創元富98購02  ,0,0,0,0,0,0,0,0,0,17000,0,0,0,27000,10000,17000,17000
057509,聯發科統一9A購03,0,0,0,0,0,0,0,0,0,17000,0,0,0,17000,0,17000,17000
060126,創意永豐99購04  ,0,0,0,0,0,0,0,0,0,17000,0,0,0,106000,89000,17000,17000
060063,可成兆豐9B購01  ,0,0,0,0,0,0,0,0,0,17000,0,0,0,17000,0,17000,17000
3704,合勤控          ,275000,262000,13000,0,0,0,0,0,0,4000,0,3000,-3000,7000,0,7000,17000
059921,大立光元大99購24,0,0,0,0,0,0,0,0,0,17000,0,0,0,17000,0,17000,17000
059425,SGBR2X元大9A購02,0,0,0,0,0,0,0,0,0,17000,0,0,0,317000,300000,17000,17000
3024,憶聲            ,36000,18000,18000,0,0,0,0,0,0,-1000,0,1000,-1000,0,0,0,17000
2545,皇翔            ,48000,30000,18000,0,0,0,0,0,0,-1000,0,1000,-1000,0,0,0,17000
2597,潤弘            ,21000,4000,17000,0,0,0,0,0,0,0,0,0,0,0,0,0,17000
1203,味王            ,18000,2000,16000,0,0,0,0,0,0,0,0,0,0,0,0,0,16000
9955,佳龍            ,58000,42000,16000,0,0,0,0,0,0,0,0,0,0,0,0,0,16000
07392P,台積電國泰02售01,0,0,0,0,0,0,0,0,0,16000,0,0,0,100000,84000,16000,16000
07327P,台灣50群益9A售06,0,0,0,0,0,0,0,0,0,16000,0,0,0,16000,0,16000,16000
07023P,南電永豐99售02  ,0,0,0,0,0,0,0,0,0,16000,0,0,0,16000,0,16000,16000
061123,燿華永豐9A購01  ,0,0,0,0,0,0,0,0,0,16000,0,0,0,68000,52000,16000,16000
060662,旺宏凱基9A購03  ,0,0,0,0,0,0,0,0,0,16000,0,0,0,31000,15000,16000,16000
060649,國巨第一9A購01  ,0,0,0,0,0,0,0,0,0,16000,0,0,0,16000,0,16000,16000
060818,上銀統一9C購01  ,0,0,0,0,0,0,0,0,0,16000,0,0,0,208000,192000,16000,16000
061019,大毅國票9A購01  ,0,0,0,0,0,0,0,0,0,16000,0,0,0,18000,2000,16000,16000
055555,全新凱基9A購01  ,0,0,0,0,0,0,0,0,0,16000,0,0,0,216000,200000,16000,16000
053891,欣興群益98購01  ,0,0,0,0,0,0,0,0,0,16000,0,0,0,16000,0,16000,16000
051721,玉晶光永豐96購02,0,0,0,0,0,0,0,0,0,16000,0,0,0,44000,28000,16000,16000
060148,臺股指國票9A購08,0,0,0,0,0,0,0,0,0,16000,0,0,0,26000,10000,16000,16000
059606,上銀富邦9B購02  ,0,0,0,0,0,0,0,0,0,16000,0,0,0,16000,0,16000,16000
058956,健策國票9A購02  ,0,0,0,0,0,0,0,0,0,16000,0,0,0,21000,5000,16000,16000
058105,旺宏統一9A購02  ,0,0,0,0,0,0,0,0,0,16000,0,0,0,26000,10000,16000,16000
058916,SGBR2X元富99購02,0,0,0,0,0,0,0,0,0,16000,0,0,0,45000,29000,16000,16000
059502,台灣50台新9B購04,0,0,0,0,0,0,0,0,0,16000,0,0,0,18000,2000,16000,16000
059574,台表科凱基99購02,0,0,0,0,0,0,0,0,0,16000,0,0,0,22000,6000,16000,16000
4576,大銀微系統      ,31000,15000,16000,0,0,0,0,0,0,0,0,0,0,0,0,0,16000
3311,閎暉            ,37000,21000,16000,0,0,0,0,0,0,0,0,0,0,0,0,0,16000
060879,華新科中信9A購02,0,0,0,0,0,0,0,0,0,15000,0,0,0,65000,50000,15000,15000
06454P,緯穎元大98售04  ,0,0,0,0,0,0,0,0,0,15000,0,0,0,15000,0,15000,15000
06073P,健策永豐97售01  ,0,0,0,0,0,0,0,0,0,15000,0,0,0,15000,0,15000,15000
060620,玉晶光元大9A購04,0,0,0,0,0,0,0,0,0,15000,0,0,0,15000,0,15000,15000
060554,中租凱基9A購01  ,0,0,0,0,0,0,0,0,0,15000,0,0,0,69000,54000,15000,15000
060486,中租富邦9A購01  ,0,0,0,0,0,0,0,0,0,15000,0,0,0,15000,0,15000,15000
060371,A50正2元富01購01,0,0,0,0,0,0,0,0,0,15000,0,0,0,15000,0,15000,15000
060239,國揚元大9C購01  ,0,0,0,0,0,0,0,0,0,15000,0,0,0,81000,66000,15000,15000
07031P,台灣50中信03售02,0,0,0,0,0,0,0,0,0,15000,0,0,0,15000,0,15000,15000
06813P,友訊元富98售03  ,0,0,0,0,0,0,0,0,0,15000,0,0,0,15000,0,15000,15000
06494P,鴻海永昌98售03  ,0,0,0,0,0,0,0,0,0,15000,0,0,0,15000,0,15000,15000
07317P,T50正2凱基9B售02,0,0,0,0,0,0,0,0,0,15000,0,0,0,22000,7000,15000,15000
07360P,台積電元大99售46,0,0,0,0,0,0,0,0,0,15000,0,0,0,15000,0,15000,15000
07390P,華新科康和99售02,0,0,0,0,0,0,0,0,0,15000,0,0,0,15000,0,15000,15000
07569P,國巨凱基9A售13  ,0,0,0,0,0,0,0,0,0,15000,0,0,0,15000,0,15000,15000
8104,錸寶            ,82000,67000,15000,0,0,0,0,0,0,0,0,0,0,0,0,0,15000
2455,全新            ,723000,622000,101000,0,0,0,0,0,0,-86000,34000,38000,-4000,26000,108000,-82000,15000
054170,泰鼎凱基98購01  ,0,0,0,0,0,0,0,0,0,15000,0,0,0,15000,0,15000,15000
054363,世芯凱基97購01  ,0,0,0,0,0,0,0,0,0,15000,0,0,0,35000,20000,15000,15000
054282,泰鼎群益98購02  ,0,0,0,0,0,0,0,0,0,15000,0,0,0,15000,0,15000,15000
054106,元油反凱基9C購01,0,0,0,0,0,0,0,0,0,15000,0,0,0,15000,0,15000,15000
049128,滬深2X元大97購03,0,0,0,0,0,0,0,0,0,15000,0,0,0,15000,0,15000,15000
049017,旺宏群益96購03  ,0,0,0,0,0,0,0,0,0,15000,0,0,0,15000,0,15000,15000
048269,瀚宇博國泰95購01,0,0,0,0,0,0,0,0,0,15000,0,0,0,15000,0,15000,15000
050332,鴻海國泰96購05  ,0,0,0,0,0,0,0,0,0,15000,0,0,0,45000,30000,15000,15000
046645,技嘉國泰94購01  ,0,0,0,0,0,0,0,0,0,15000,0,0,0,15000,0,15000,15000
053079,世紀鋼永豐96購01,0,0,0,0,0,0,0,0,0,15000,0,0,0,15000,0,15000,15000
053309,泰鼎凱基96購03  ,0,0,0,0,0,0,0,0,0,15000,0,0,0,15000,0,15000,15000
053587,京元電元大98購01,0,0,0,0,0,0,0,0,0,15000,0,0,0,15000,0,15000,15000
057698,奇力新群益98購02,0,0,0,0,0,0,0,0,0,15000,0,0,0,15000,0,15000,15000
054788,華新科群益98購02,0,0,0,0,0,0,0,0,0,15000,0,0,0,20000,5000,15000,15000
054858,台肥群益97購01  ,0,0,0,0,0,0,0,0,0,15000,0,0,0,15000,0,15000,15000
054421,臺股指元大99購03,0,0,0,0,0,0,0,0,0,15000,0,0,0,15000,0,15000,15000
054428,禾伸堂富邦98購01,0,0,0,0,0,0,0,0,0,15000,0,0,0,15000,0,15000,15000
054575,聯鈞元大97購01  ,0,0,0,0,0,0,0,0,0,15000,0,0,0,15000,0,15000,15000
054692,台航永豐97購01  ,0,0,0,0,0,0,0,0,0,15000,0,0,0,15000,0,15000,15000
059042,世紀鋼群益99購02,0,0,0,0,0,0,0,0,0,15000,0,0,0,30000,15000,15000,15000
059035,旺宏群益99購06  ,0,0,0,0,0,0,0,0,0,15000,0,0,0,16000,1000,15000,15000
056402,智易群益98購02  ,0,0,0,0,0,0,0,0,0,15000,0,0,0,15000,0,15000,15000
056557,世紀鋼凱基98購02,0,0,0,0,0,0,0,0,0,15000,0,0,0,67000,52000,15000,15000
056573,華新科元大99購06,0,0,0,0,0,0,0,0,0,15000,0,0,0,40000,25000,15000,15000
056617,美律永豐98購01  ,0,0,0,0,0,0,0,0,0,15000,0,0,0,90000,75000,15000,15000
058875,台表科國票9A購02,0,0,0,0,0,0,0,0,0,15000,0,0,0,15000,0,15000,15000
057971,華新科富邦9B購02,0,0,0,0,0,0,0,0,0,15000,0,0,0,100000,85000,15000,15000
056807,元油2X統一9B購01,118000,103000,15000,0,0,0,0,0,0,0,0,0,0,0,0,0,15000
058972,新日興永豐9A購01,0,0,0,0,0,0,0,0,0,15000,0,0,0,15000,0,15000,15000
05804P,美律永豐96售01  ,0,0,0,0,0,0,0,0,0,15000,0,0,0,15000,0,15000,15000
056876,群創凱基98購11  ,0,0,0,0,0,0,0,0,0,15000,0,0,0,25000,10000,15000,15000
058174,台積電凱基9A購05,0,0,0,0,0,0,0,0,0,15000,0,0,0,15000,0,15000,15000
059152,臺股指國票99購15,0,0,0,0,0,0,0,0,0,15000,0,0,0,20000,5000,15000,15000
058210,臺股指凱基9C購04,0,0,0,0,0,0,0,0,0,15000,0,0,0,15000,0,15000,15000
060064,華新科兆豐99購07,0,0,0,0,0,0,0,0,0,15000,0,0,0,15000,0,15000,15000
059992,S&P正2元富9B購04,0,0,0,0,0,0,0,0,0,15000,0,0,0,15000,0,15000,15000
059990,健策元大9A購01  ,0,0,0,0,0,0,0,0,0,15000,0,0,0,34000,19000,15000,15000
059775,台灣50元大9C購16,0,0,0,0,0,0,0,0,0,15000,0,0,0,15000,0,15000,15000
057332,旺宏國票99購03  ,0,0,0,0,0,0,0,0,0,15000,0,0,0,15000,0,15000,15000
055736,宏達電元富99購01,0,0,0,0,0,0,0,0,0,15000,0,0,0,100000,85000,15000,15000
059507,鴻海永豐99購03  ,0,0,0,0,0,0,0,0,0,15000,0,0,0,15000,0,15000,15000
059877,康控凱基99購05  ,0,0,0,0,0,0,0,0,0,15000,0,0,0,40000,25000,15000,15000
059796,台積電國票99購10,0,0,0,0,0,0,0,0,0,15000,0,0,0,34000,19000,15000,15000
2423,固緯            ,36000,22000,14000,0,0,0,0,0,0,0,0,0,0,0,0,0,14000
07584P,台積電永豐9A售02,0,0,0,0,0,0,0,0,0,14000,0,0,0,21000,7000,14000,14000
07403P,聯發科凱基99售21,0,0,0,0,0,0,0,0,0,14000,0,0,0,14000,0,14000,14000
060943,宏達電國票9B購02,0,0,0,0,0,0,0,0,0,14000,0,0,0,24000,10000,14000,14000
060808,欣興群益9A購01  ,0,0,0,0,0,0,0,0,0,14000,0,0,0,14000,0,14000,14000
060839,聯發科國票9A購02,0,0,0,0,0,0,0,0,0,14000,0,0,0,14000,0,14000,14000
060945,緯穎國票9A購02  ,0,0,0,0,0,0,0,0,0,14000,0,0,0,14000,0,14000,14000
05483P,國巨凱基95售07  ,0,0,0,0,0,0,0,0,0,14000,0,0,0,14000,0,14000,14000
054900,金寶康和97購01  ,0,0,0,0,0,0,0,0,0,14000,0,0,0,35000,21000,14000,14000
056274,彩晶統一98購02  ,0,0,0,0,0,0,0,0,0,14000,0,0,0,19000,5000,14000,14000
058372,欣興凱基99購03  ,0,0,0,0,0,0,0,0,0,14000,0,0,0,22000,8000,14000,14000
053092,台表科元大97購02,0,0,0,0,0,0,0,0,0,14000,0,0,0,15000,1000,14000,14000
00733,富邦臺灣中小    ,0,0,0,0,0,0,0,0,0,14000,0,0,0,215000,201000,14000,14000
055715,智邦元大97購04  ,0,0,0,0,0,0,0,0,0,14000,0,0,0,49000,35000,14000,14000
059209,華通元大99購08  ,0,0,0,0,0,0,0,0,0,14000,0,0,0,17000,3000,14000,14000
05604P,聯發科元大96售10,0,0,0,0,0,0,0,0,0,14000,0,0,0,14000,0,14000,14000
057104,康友中信99購01  ,0,0,0,0,0,0,0,0,0,14000,0,0,0,14000,0,14000,14000
055627,亞德客永豐97購02,0,0,0,0,0,0,0,0,0,14000,0,0,0,14000,0,14000,14000
057948,嘉聯益國票99購02,0,0,0,0,0,0,0,0,0,14000,0,0,0,14000,0,14000,14000
058096,南電元大98購04  ,0,0,0,0,0,0,0,0,0,14000,0,0,0,44000,30000,14000,14000
058398,中環元大99購02  ,0,0,0,0,0,0,0,0,0,14000,0,0,0,14000,0,14000,14000
059515,牧德永豐99購01  ,0,0,0,0,0,0,0,0,0,14000,0,0,0,30000,16000,14000,14000
059452,全新永豐99購03  ,0,0,0,0,0,0,0,0,0,14000,0,0,0,14000,0,14000,14000
059404,鴻海台新99購03  ,0,0,0,0,0,0,0,0,0,14000,0,0,0,128000,114000,14000,14000
2636,台驊投控        ,20000,6000,14000,0,0,0,0,0,0,0,0,0,0,0,0,0,14000
6452,康友-KY         ,116000,99361,16639,0,0,0,0,0,0,-3000,0,5000,-5000,12000,10000,2000,13639
061059,世芯國票9B購01  ,0,0,0,0,0,0,0,0,0,13000,0,0,0,14000,1000,13000,13000
060836,上銀國票9A購03  ,0,0,0,0,0,0,0,0,0,13000,0,0,0,13000,0,13000,13000
06286P,世芯國票97售02  ,0,0,0,0,0,0,0,0,0,13000,0,0,0,57000,44000,13000,13000
061153,奇力新群益9A購02,0,0,0,0,0,0,0,0,0,13000,0,0,0,13000,0,13000,13000
061079,台積電兆豐9A購02,0,0,0,0,0,0,0,0,0,13000,0,0,0,20000,7000,13000,13000
060642,華擎永豐9A購02  ,0,0,0,0,0,0,0,0,0,13000,0,0,0,72000,59000,13000,13000
060762,長榮航元大9A購02,0,0,0,0,0,0,0,0,0,13000,0,0,0,64000,51000,13000,13000
06558P,旺宏元富98售02  ,0,0,0,0,0,0,0,0,0,13000,0,0,0,13000,0,13000,13000
06952P,大立光統一9A售03,0,0,0,0,0,0,0,0,0,13000,0,0,0,13000,0,13000,13000
07701P,玉晶光第一9A售02,0,0,0,0,0,0,0,0,0,13000,0,0,0,13000,0,13000,13000
1786,科妍            ,59000,44000,15000,0,0,0,0,0,0,-2000,0,2000,-2000,0,0,0,13000
2020,美亞            ,45000,32000,13000,0,0,0,0,0,0,0,0,0,0,0,0,0,13000
00851,台新全球AI      ,0,0,0,0,0,0,0,0,0,13000,0,0,0,84000,71000,13000,13000
00645,富邦日本        ,0,0,0,0,0,0,0,0,0,13000,0,0,0,74000,61000,13000,13000
050115,群創元大96購01  ,0,0,0,0,0,0,0,0,0,13000,0,0,0,13000,0,13000,13000
054343,世紀鋼元富96購02,0,0,0,0,0,0,0,0,0,13000,0,0,0,19000,6000,13000,13000
053910,嘉聯益凱基98購01,0,0,0,0,0,0,0,0,0,13000,0,0,0,13000,0,13000,13000
052588,玉晶光永豐98購01,0,0,0,0,0,0,0,0,0,13000,0,0,0,15000,2000,13000,13000
053671,可成統一96購03  ,0,0,0,0,0,0,0,0,0,13000,0,0,0,20000,7000,13000,13000
056271,嘉澤統一97購01  ,0,0,0,0,0,0,0,0,0,13000,0,0,0,74000,61000,13000,13000
053195,玉晶光元富96購02,0,0,0,0,0,0,0,0,0,13000,0,0,0,13000,0,13000,13000
052898,樺漢群益96購01  ,0,0,0,0,0,0,0,0,0,13000,0,0,0,13000,0,13000,13000
058822,樺漢國泰9B購01  ,0,0,0,0,0,0,0,0,0,13000,0,0,0,13000,0,13000,13000
058061,貿聯元富9B購01  ,0,0,0,0,0,0,0,0,0,13000,0,0,0,43000,30000,13000,13000
059118,晶技永豐9A購01  ,0,0,0,0,0,0,0,0,0,13000,0,0,0,13000,0,13000,13000
055852,聯鈞元大98購01  ,0,0,0,0,0,0,0,0,0,13000,0,0,0,13000,0,13000,13000
056213,建準國票98購02  ,0,0,0,0,0,0,0,0,0,13000,0,0,0,31000,18000,13000,13000
057168,旺宏元大99購03  ,0,0,0,0,0,0,0,0,0,13000,0,0,0,48000,35000,13000,13000
060009,南亞科群益99購03,0,0,0,0,0,0,0,0,0,13000,0,0,0,28000,15000,13000,13000
3032,偉訓            ,21000,8000,13000,0,0,0,0,0,0,0,0,0,0,0,0,0,13000
3013,晟銘電          ,20000,5000,15000,0,0,0,0,0,0,-2000,0,2000,-2000,0,0,0,13000
1612,宏泰            ,37000,25000,12000,0,0,0,0,0,0,0,0,0,0,0,0,0,12000
07494P,葡萄王元大9A售03,0,0,0,0,0,0,0,0,0,12000,0,0,0,12000,0,12000,12000
060664,聯詠凱基9A購01  ,0,0,0,0,0,0,0,0,0,12000,0,0,0,12000,0,12000,12000
060461,鴻海元大9A購09  ,0,0,0,0,0,0,0,0,0,12000,0,0,0,86000,74000,12000,12000
055207,致新中信99購01  ,0,0,0,0,0,0,0,0,0,12000,0,0,0,22000,10000,12000,12000
054767,日電貿國票98購01,0,0,0,0,0,0,0,0,0,12000,0,0,0,62000,50000,12000,12000
05443P,宏達電元大95售05,0,0,0,0,0,0,0,0,0,12000,0,0,0,22000,10000,12000,12000
053577,上証2X元大96購02,0,0,0,0,0,0,0,0,0,12000,0,0,0,12000,0,12000,12000
053484,國巨國票97購03  ,0,0,0,0,0,0,0,0,0,12000,0,0,0,12000,0,12000,12000
053924,京鼎國票97購01  ,0,0,0,0,0,0,0,0,0,12000,0,0,0,12000,0,12000,12000
054215,創意國票97購02  ,0,0,0,0,0,0,0,0,0,12000,0,0,0,12000,0,12000,12000
050519,旺宏元大95購03  ,0,0,0,0,0,0,0,0,0,12000,0,0,0,20000,8000,12000,12000
048273,南電富邦97購01  ,0,0,0,0,0,0,0,0,0,12000,0,0,0,21000,9000,12000,12000
059977,鴻海元大99購40  ,0,0,0,0,0,0,0,0,0,12000,0,0,0,12000,0,12000,12000
060039,大立光國票99購04,0,0,0,0,0,0,0,0,0,12000,0,0,0,12000,0,12000,12000
060112,祥碩元大99購04  ,0,0,0,0,0,0,0,0,0,12000,0,0,0,68000,56000,12000,12000
057157,群創富邦98購02  ,0,0,0,0,0,0,0,0,0,12000,0,0,0,12000,0,12000,12000
05905P,晶技統一97售01  ,0,0,0,0,0,0,0,0,0,12000,0,0,0,12000,0,12000,12000
055653,聯詠元富01購02  ,0,0,0,0,0,0,0,0,0,12000,0,0,0,12000,0,12000,12000
057386,聯發科永豐98購04,0,0,0,0,0,0,0,0,0,12000,0,0,0,23000,11000,12000,12000
059157,元石油凱基9C購01,0,0,0,0,0,0,0,0,0,12000,0,0,0,15000,3000,12000,12000
055902,同欣電中信99購01,0,0,0,0,0,0,0,0,0,12000,0,0,0,42000,30000,12000,12000
055892,國巨統一99購01  ,0,0,0,0,0,0,0,0,0,12000,0,0,0,12000,0,12000,12000
057052,華擎元大98購01  ,0,0,0,0,0,0,0,0,0,12000,0,0,0,12000,0,12000,12000
058447,玉晶光富邦9A購02,0,0,0,0,0,0,0,0,0,12000,0,0,0,12000,0,12000,12000
058934,台灣50中信03購03,0,0,0,0,0,0,0,0,0,12000,0,0,0,23000,11000,12000,12000
2816,旺旺保          ,25000,13000,12000,0,0,0,0,0,0,0,0,0,0,0,0,0,12000
059451,國巨永豐99購05  ,0,0,0,0,0,0,0,0,0,12000,0,0,0,14000,2000,12000,12000
059901,滬深2X元大9C購07,0,0,0,0,0,0,0,0,0,12000,0,0,0,14000,2000,12000,12000
059935,國巨永豐99購07  ,0,0,0,0,0,0,0,0,0,12000,0,0,0,12000,0,12000,12000
4144,康聯-KY         ,20000,8000,12000,0,0,0,0,0,0,0,0,0,0,0,0,0,12000
060450,南亞元大9A購02  ,0,0,0,0,0,0,0,0,0,11000,0,0,0,11000,0,11000,11000
060657,旺宏統一9B購05  ,0,0,0,0,0,0,0,0,0,11000,0,0,0,12000,1000,11000,11000
060744,鴻海國票9A購04  ,0,0,0,0,0,0,0,0,0,11000,0,0,0,23000,12000,11000,11000
060341,國巨統一9C購02  ,0,0,0,0,0,0,0,0,0,11000,0,0,0,11000,0,11000,11000
060290,興富發元大9C購01,0,0,0,0,0,0,0,0,0,11000,0,0,0,31000,20000,11000,11000
06680P,智邦元大98售06  ,0,0,0,0,0,0,0,0,0,11000,0,0,0,265000,254000,11000,11000
060843,大立光國票9A購06,0,0,0,0,0,0,0,0,0,11000,0,0,0,11000,0,11000,11000
060940,國巨國票9B購03  ,0,0,0,0,0,0,0,0,0,11000,0,0,0,53000,42000,11000,11000
061027,儒鴻永豐9A購02  ,0,0,0,0,0,0,0,0,0,11000,0,0,0,73000,62000,11000,11000
07455P,聯發科元大9A售01,0,0,0,0,0,0,0,0,0,11000,0,0,0,17000,6000,11000,11000
07612P,國巨國泰9B售06  ,0,0,0,0,0,0,0,0,0,11000,0,0,0,399000,388000,11000,11000
07169P,臺股指國票99售06,0,0,0,0,0,0,0,0,0,11000,0,0,0,21000,10000,11000,11000
06593P,欣興元大98售05  ,0,0,0,0,0,0,0,0,0,11000,0,0,0,28000,17000,11000,11000
1452,宏益            ,15000,4000,11000,0,0,0,0,0,0,0,0,0,0,0,0,0,11000
051743,揚明光國票96購02,0,0,0,0,0,0,0,0,0,11000,0,0,0,11000,0,11000,11000
053523,T50反1中信9A購01,0,0,0,0,0,0,0,0,0,11000,0,0,0,20000,9000,11000,11000
053660,群創凱基98購08  ,0,0,0,0,0,0,0,0,0,11000,0,0,0,21000,10000,11000,11000
052781,瀚宇博國票97購03,0,0,0,0,0,0,0,0,0,11000,0,0,0,11000,0,11000,11000
052821,晶技永豐96購01  ,0,0,0,0,0,0,0,0,0,11000,0,0,0,11000,0,11000,11000
058694,鈺齊國票9A購02  ,0,0,0,0,0,0,0,0,0,11000,0,0,0,12000,1000,11000,11000
056586,光罩統一98購02  ,0,0,0,0,0,0,0,0,0,11000,0,0,0,141000,130000,11000,11000
056738,國巨凱基9A購02  ,0,0,0,0,0,0,0,0,0,11000,0,0,0,11000,0,11000,11000
058848,台積電群益99購07,0,0,0,0,0,0,0,0,0,11000,0,0,0,11000,0,11000,11000
058799,晶技元大99購04  ,0,0,0,0,0,0,0,0,0,11000,0,0,0,11000,0,11000,11000
056882,華邦電康和98購01,0,0,0,0,0,0,0,0,0,11000,0,0,0,48000,37000,11000,11000
056909,嘉聯益元大99購03,0,0,0,0,0,0,0,0,0,11000,0,0,0,11000,0,11000,11000
056817,國巨永豐98購04  ,0,0,0,0,0,0,0,0,0,11000,0,0,0,16000,5000,11000,11000
057424,訊芯凱基98購04  ,0,0,0,0,0,0,0,0,0,11000,0,0,0,13000,2000,11000,11000
056191,世紀鋼統一97購01,0,0,0,0,0,0,0,0,0,11000,0,0,0,11000,0,11000,11000
056212,台光電國票98購03,0,0,0,0,0,0,0,0,0,11000,0,0,0,11000,0,11000,11000
060182,旺宏元富9A購01  ,0,0,0,0,0,0,0,0,0,11000,0,0,0,11000,0,11000,11000
060071,國巨元富99購03  ,0,0,0,0,0,0,0,0,0,11000,0,0,0,12000,1000,11000,11000
059721,旺宏元大99購16  ,0,0,0,0,0,0,0,0,0,11000,0,0,0,12000,1000,11000,11000
3167,大量            ,17000,6000,11000,0,0,0,0,0,0,0,0,0,0,0,0,0,11000
2727,王品            ,19000,5000,14000,0,0,0,0,0,0,-3000,0,3000,-3000,0,0,0,11000
07677P,祥碩永豐9A售01  ,0,0,0,0,0,0,0,0,0,10000,0,0,0,30000,20000,10000,10000
2467,志聖            ,84000,65000,19000,0,0,0,0,0,0,-9000,0,9000,-9000,0,0,0,10000
06566P,華通永豐98售03  ,0,0,0,0,0,0,0,0,0,10000,0,0,0,10000,0,10000,10000
06506P,台郡國票99售02  ,0,0,0,0,0,0,0,0,0,10000,0,0,0,15000,5000,10000,10000
06889P,臺股指元大98售13,0,0,0,0,0,0,0,0,0,10000,0,0,0,10000,0,10000,10000
07620P,國巨統一9B售07  ,0,0,0,0,0,0,0,0,0,10000,0,0,0,29000,19000,10000,10000
07587P,台灣50國票9A售11,0,0,0,0,0,0,0,0,0,10000,0,0,0,10000,0,10000,10000
07371P,滬深2X元大99售07,0,0,0,0,0,0,0,0,0,10000,0,0,0,10000,0,10000,10000
07372P,滬深2X元大99售08,0,0,0,0,0,0,0,0,0,10000,0,0,0,10000,0,10000,10000
07281P,鴻海凱基99售13  ,0,0,0,0,0,0,0,0,0,10000,0,0,0,40000,30000,10000,10000
061051,臺股指中信9A購06,0,0,0,0,0,0,0,0,0,10000,0,0,0,10000,0,10000,10000
06618P,智邦元大98售04  ,0,0,0,0,0,0,0,0,0,10000,0,0,0,10000,0,10000,10000
060867,智伸科永豐9A購01,0,0,0,0,0,0,0,0,0,10000,0,0,0,30000,20000,10000,10000
06088P,建準永豐97售01  ,0,0,0,0,0,0,0,0,0,10000,0,0,0,10000,0,10000,10000
06679P,旺宏元大98售09  ,0,0,0,0,0,0,0,0,0,10000,0,0,0,10000,0,10000,10000
06669P,緯穎凱基98售05  ,0,0,0,0,0,0,0,0,0,10000,0,0,0,10000,0,10000,10000
061224,道瓊反中信01購01,0,0,0,0,0,0,0,0,0,10000,0,0,0,10000,0,10000,10000
061208,聯發科元大9A購09,0,0,0,0,0,0,0,0,0,10000,0,0,0,60000,50000,10000,10000
06332P,世紀鋼群益98售01,0,0,0,0,0,0,0,0,0,10000,0,0,0,10000,0,10000,10000
06247P,同欣電元富97售02,0,0,0,0,0,0,0,0,0,10000,0,0,0,10000,0,10000,10000
06407P,創意元富97售02  ,0,0,0,0,0,0,0,0,0,10000,0,0,0,10000,0,10000,10000
060314,元翎永豐9A購01  ,0,0,0,0,0,0,0,0,0,10000,0,0,0,20000,10000,10000,10000
060741,滬深2X國票9A購05,0,0,0,0,0,0,0,0,0,10000,0,0,0,10000,0,10000,10000
060602,京元電凱基9A購01,0,0,0,0,0,0,0,0,0,10000,0,0,0,12000,2000,10000,10000
060587,牧德元富9A購01  ,0,0,0,0,0,0,0,0,0,10000,0,0,0,10000,0,10000,10000
060555,台表科凱基9A購03,0,0,0,0,0,0,0,0,0,10000,0,0,0,10000,0,10000,10000
060531,大立光中信9A購04,0,0,0,0,0,0,0,0,0,10000,0,0,0,10000,0,10000,10000
052795,健策兆豐97購01  ,0,0,0,0,0,0,0,0,0,10000,0,0,0,64000,54000,10000,10000
052737,滬深2X元大96購06,0,0,0,0,0,0,0,0,0,10000,0,0,0,10000,0,10000,10000
05273P,國巨群益95售02  ,0,0,0,0,0,0,0,0,0,10000,0,0,0,20000,10000,10000,10000
052756,國巨群益96購02  ,0,0,0,0,0,0,0,0,0,10000,0,0,0,10000,0,10000,10000
052934,中磊元大96購01  ,0,0,0,0,0,0,0,0,0,10000,0,0,0,10000,0,10000,10000
052707,景碩台新96購01  ,0,0,0,0,0,0,0,0,0,10000,0,0,0,10000,0,10000,10000
05266P,華新科元大95售11,0,0,0,0,0,0,0,0,0,10000,0,0,0,10000,0,10000,10000
055304,瑞昱第一98購01  ,0,0,0,0,0,0,0,0,0,10000,0,0,0,10000,0,10000,10000
055137,GIS富邦98購01   ,0,0,0,0,0,0,0,0,0,10000,0,0,0,10000,0,10000,10000
055246,美律統一98購01  ,0,0,0,0,0,0,0,0,0,10000,0,0,0,10000,0,10000,10000
054412,智邦元大96購03  ,0,0,0,0,0,0,0,0,0,10000,0,0,0,10000,0,10000,10000
054393,漢唐永豐96購01  ,0,0,0,0,0,0,0,0,0,10000,0,0,0,10000,0,10000,10000
054380,世芯群益97購02  ,0,0,0,0,0,0,0,0,0,10000,0,0,0,10000,0,10000,10000
054384,瀚宇博群益96購02,0,0,0,0,0,0,0,0,0,10000,0,0,0,11000,1000,10000,10000
054555,欣興凱基98購01  ,0,0,0,0,0,0,0,0,0,10000,0,0,0,10000,0,10000,10000
054467,隆達凱基97購01  ,0,0,0,0,0,0,0,0,0,10000,0,0,0,31000,21000,10000,10000
054478,可成中信97購01  ,0,0,0,0,0,0,0,0,0,10000,0,0,0,10000,0,10000,10000
054751,GIS凱基98購01   ,0,0,0,0,0,0,0,0,0,10000,0,0,0,10000,0,10000,10000
054601,奇鋐台新98購01  ,0,0,0,0,0,0,0,0,0,10000,0,0,0,10000,0,10000,10000
054634,FB上証中信99購01,0,0,0,0,0,0,0,0,0,10000,0,0,0,10000,0,10000,10000
054636,華通中信97購01  ,0,0,0,0,0,0,0,0,0,10000,0,0,0,10000,0,10000,10000
055205,京鼎中信99購01  ,0,0,0,0,0,0,0,0,0,10000,0,0,0,10000,0,10000,10000
054862,群光群益97購01  ,0,0,0,0,0,0,0,0,0,10000,0,0,0,10000,0,10000,10000
054846,瑞昱兆豐97購01  ,0,0,0,0,0,0,0,0,0,10000,0,0,0,10000,0,10000,10000
055062,文曄永豐97購01  ,0,0,0,0,0,0,0,0,0,10000,0,0,0,10000,0,10000,10000
055019,福懋科元富97購01,0,0,0,0,0,0,0,0,0,10000,0,0,0,20000,10000,10000,10000
054952,大毅元大97購02  ,0,0,0,0,0,0,0,0,0,10000,0,0,0,10000,0,10000,10000
054971,帆宣元大97購02  ,0,0,0,0,0,0,0,0,0,10000,0,0,0,10000,0,10000,10000
054942,凱美元大97購02  ,0,0,0,0,0,0,0,0,0,10000,0,0,0,10000,0,10000,10000
053547,台積電凱基96購14,0,0,0,0,0,0,0,0,0,10000,0,0,0,10000,0,10000,10000
053370,上証2X元大97購03,0,0,0,0,0,0,0,0,0,10000,0,0,0,10000,0,10000,10000
053436,聯茂日盛96購01  ,0,0,0,0,0,0,0,0,0,10000,0,0,0,27000,17000,10000,10000
053428,中磊永豐96購02  ,0,0,0,0,0,0,0,0,0,10000,0,0,0,10000,0,10000,10000
053723,奇鋐凱基98購01  ,0,0,0,0,0,0,0,0,0,10000,0,0,0,10000,0,10000,10000
05301P,矽力元大95售02  ,0,0,0,0,0,0,0,0,0,10000,0,0,0,10000,0,10000,10000
053797,台積電中信98購01,0,0,0,0,0,0,0,0,0,10000,0,0,0,10000,0,10000,10000
056292,統一元大97購01  ,0,0,0,0,0,0,0,0,0,10000,0,0,0,10000,0,10000,10000
056310,神達元大97購02  ,0,0,0,0,0,0,0,0,0,10000,0,0,0,10000,0,10000,10000
056356,台積電元大99購01,0,0,0,0,0,0,0,0,0,10000,0,0,0,10000,0,10000,10000
057709,電子類群益98購01,0,0,0,0,0,0,0,0,0,10000,0,0,0,10000,0,10000,10000
058617,南電元大99購01  ,0,0,0,0,0,0,0,0,0,10000,0,0,0,10000,0,10000,10000
057734,訊芯國泰9A購01  ,0,0,0,0,0,0,0,0,0,10000,0,0,0,10000,0,10000,10000
057747,致新永豐98購01  ,0,0,0,0,0,0,0,0,0,10000,0,0,0,30000,20000,10000,10000
057748,華通國票98購04  ,0,0,0,0,0,0,0,0,0,10000,0,0,0,10000,0,10000,10000
058354,台積電凱基9A購06,0,0,0,0,0,0,0,0,0,10000,0,0,0,10000,0,10000,10000
058391,T50反1元大99購02,0,0,0,0,0,0,0,0,0,10000,0,0,0,20000,10000,10000,10000
058334,鴻海元富99購05  ,0,0,0,0,0,0,0,0,0,10000,0,0,0,10000,0,10000,10000
058319,大毅永豐9A購01  ,0,0,0,0,0,0,0,0,0,10000,0,0,0,10000,0,10000,10000
058323,泰鼎永豐9A購01  ,0,0,0,0,0,0,0,0,0,10000,0,0,0,10000,0,10000,10000
058651,FBVIX中信9C購01 ,0,0,0,0,0,0,0,0,0,10000,0,0,0,10000,0,10000,10000
058621,華通國票9A購01  ,0,0,0,0,0,0,0,0,0,10000,0,0,0,48000,38000,10000,10000
051850,臻鼎中信96購01  ,0,0,0,0,0,0,0,0,0,10000,0,0,0,10000,0,10000,10000
052022,南電永豐95購03  ,0,0,0,0,0,0,0,0,0,10000,0,0,0,10000,0,10000,10000
052006,康友富邦98購01  ,0,0,0,0,0,0,0,0,0,10000,0,0,0,10000,0,10000,10000
051941,樺漢群益95購02  ,0,0,0,0,0,0,0,0,0,10000,0,0,0,10000,0,10000,10000
051961,泰碩永豐95購01  ,0,0,0,0,0,0,0,0,0,10000,0,0,0,10000,0,10000,10000
051969,世紀鋼永豐95購01,0,0,0,0,0,0,0,0,0,10000,0,0,0,10000,0,10000,10000
052194,旺宏元富95購04  ,0,0,0,0,0,0,0,0,0,10000,0,0,0,10000,0,10000,10000
052204,台泥中信96購01  ,0,0,0,0,0,0,0,0,0,10000,0,0,0,10000,0,10000,10000
052462,上銀統一95購03  ,0,0,0,0,0,0,0,0,0,10000,0,0,0,10000,0,10000,10000
052103,台積電兆豐95購06,0,0,0,0,0,0,0,0,0,10000,0,0,0,20000,10000,10000,10000
052117,鴻海國票96購03  ,0,0,0,0,0,0,0,0,0,10000,0,0,0,10000,0,10000,10000
050952,健策群益96購01  ,0,0,0,0,0,0,0,0,0,10000,0,0,0,10000,0,10000,10000
051361,泰鼎元大95購01  ,0,0,0,0,0,0,0,0,0,10000,0,0,0,10000,0,10000,10000
051268,創意富邦97購01  ,0,0,0,0,0,0,0,0,0,10000,0,0,0,10000,0,10000,10000
051258,鈺齊國泰97購01  ,0,0,0,0,0,0,0,0,0,10000,0,0,0,10000,0,10000,10000
051562,玉晶光國泰97購05,0,0,0,0,0,0,0,0,0,10000,0,0,0,15000,5000,10000,10000
051666,旺宏元大96購05  ,0,0,0,0,0,0,0,0,0,10000,0,0,0,10000,0,10000,10000
051490,世芯凱基96購01  ,0,0,0,0,0,0,0,0,0,10000,0,0,0,10000,0,10000,10000
051522,玉晶光凱基95購05,0,0,0,0,0,0,0,0,0,10000,0,0,0,10000,0,10000,10000
054296,世芯元大97購01  ,0,0,0,0,0,0,0,0,0,10000,0,0,0,10000,0,10000,10000
054054,光磊國票97購02  ,0,0,0,0,0,0,0,0,0,10000,0,0,0,10000,0,10000,10000
054036,T50反1元大96購08,0,0,0,0,0,0,0,0,0,10000,0,0,0,10000,0,10000,10000
054091,晶豪科群益96購01,0,0,0,0,0,0,0,0,0,10000,0,0,0,10000,0,10000,10000
052609,智易元大97購01  ,0,0,0,0,0,0,0,0,0,10000,0,0,0,10000,0,10000,10000
053939,台表科元富96購03,0,0,0,0,0,0,0,0,0,10000,0,0,0,110000,100000,10000,10000
052371,元金2X元大95購01,0,0,0,0,0,0,0,0,0,10000,0,0,0,10000,0,10000,10000
052387,台積電群益95購08,0,0,0,0,0,0,0,0,0,10000,0,0,0,10000,0,10000,10000
00865B,國泰US短期公債  ,0,0,0,0,0,0,0,0,0,10000,0,0,0,110000,100000,10000,10000
00706L,元大S&P日圓正2  ,0,0,0,0,0,0,0,0,0,10000,0,0,0,10000,0,10000,10000
00661,元大日經225     ,0,0,0,0,0,0,0,0,0,10000,0,0,0,11000,1000,10000,10000
049008,傳奇中信95購01  ,0,0,0,0,0,0,0,0,0,10000,0,0,0,10000,0,10000,10000
048681,漢唐富邦96購01  ,0,0,0,0,0,0,0,0,0,10000,0,0,0,10000,0,10000,10000
03039X,元展36          ,0,0,0,0,0,0,0,0,0,10000,0,0,0,10000,0,10000,10000
04931P,臻鼎元富94售09  ,0,0,0,0,0,0,0,0,0,10000,0,0,0,10000,0,10000,10000
03442B,臺股指元大9A熊48,0,0,0,0,0,0,0,0,0,10000,0,0,0,10000,0,10000,10000
050613,台光電元大94購09,0,0,0,0,0,0,0,0,0,10000,0,0,0,10000,0,10000,10000
05081P,京鼎永豐95售01  ,0,0,0,0,0,0,0,0,0,10000,0,0,0,10000,0,10000,10000
050754,元金2X元富9B購01,0,0,0,0,0,0,0,0,0,10000,0,0,0,11000,1000,10000,10000
050744,健策永豐94購04  ,0,0,0,0,0,0,0,0,0,10000,0,0,0,10000,0,10000,10000
049888,智邦國泰96購01  ,0,0,0,0,0,0,0,0,0,10000,0,0,0,10000,0,10000,10000
049892,國巨富邦96購01  ,0,0,0,0,0,0,0,0,0,10000,0,0,0,10000,0,10000,10000
04974P,聯發科凱基96售02,0,0,0,0,0,0,0,0,0,10000,0,0,0,10000,0,10000,10000
050180,華新科元大95購08,0,0,0,0,0,0,0,0,0,10000,0,0,0,10000,0,10000,10000
04693P,超眾群益95售01  ,0,0,0,0,0,0,0,0,0,10000,0,0,0,10000,0,10000,10000
047298,聯茂元富96購01  ,0,0,0,0,0,0,0,0,0,10000,0,0,0,10000,0,10000,10000
04751P,智邦兆豐95售02  ,0,0,0,0,0,0,0,0,0,10000,0,0,0,10000,0,10000,10000
047990,臺指反元大96購02,0,0,0,0,0,0,0,0,0,10000,0,0,0,10000,0,10000,10000
048149,泰鼎元富95購01  ,0,0,0,0,0,0,0,0,0,10000,0,0,0,10000,0,10000,10000
049560,香港反統一95購01,0,0,0,0,0,0,0,0,0,10000,0,0,0,10000,0,10000,10000
045568,上証2X元大95購01,0,0,0,0,0,0,0,0,0,10000,0,0,0,10000,0,10000,10000
059635,華新科凱基9A購06,0,0,0,0,0,0,0,0,0,10000,0,0,0,10000,0,10000,10000
059638,大立光凱基99購11,0,0,0,0,0,0,0,0,0,10000,0,0,0,10000,0,10000,10000
059639,大立光凱基9A購06,0,0,0,0,0,0,0,0,0,10000,0,0,0,10000,0,10000,10000
059625,國巨凱基99購17  ,0,0,0,0,0,0,0,0,0,10000,0,0,0,10000,0,10000,10000
059622,上銀凱基99購10  ,0,0,0,0,0,0,0,0,0,10000,0,0,0,10000,0,10000,10000
059302,大立光群益99購08,0,0,0,0,0,0,0,0,0,10000,0,0,0,10000,0,10000,10000
057503,世紀鋼群益98購02,0,0,0,0,0,0,0,0,0,10000,0,0,0,10000,0,10000,10000
05762P,昇陽半永豐96售04,0,0,0,0,0,0,0,0,0,10000,0,0,0,10000,0,10000,10000
057476,國巨元大98購19  ,0,0,0,0,0,0,0,0,0,10000,0,0,0,10000,0,10000,10000
060056,大立光凱基9B購01,0,0,0,0,0,0,0,0,0,10000,0,0,0,10000,0,10000,10000
059743,開發金元富99購01,0,0,0,0,0,0,0,0,0,10000,0,0,0,30000,20000,10000,10000
060147,臺股指國票9A購07,0,0,0,0,0,0,0,0,0,10000,0,0,0,26000,16000,10000,10000
057138,亞德客兆豐98購01,0,0,0,0,0,0,0,0,0,10000,0,0,0,10000,0,10000,10000
056252,聯發科兆豐97購03,0,0,0,0,0,0,0,0,0,10000,0,0,0,10000,0,10000,10000
055815,亞光國票99購01  ,0,0,0,0,0,0,0,0,0,10000,0,0,0,10000,0,10000,10000
055776,宏達電凱基98購02,0,0,0,0,0,0,0,0,0,10000,0,0,0,30000,20000,10000,10000
055982,T50反1元富97購01,0,0,0,0,0,0,0,0,0,10000,0,0,0,19000,9000,10000,10000
055986,祥碩元富97購01  ,0,0,0,0,0,0,0,0,0,10000,0,0,0,10000,0,10000,10000
055990,矽創元富97購01  ,0,0,0,0,0,0,0,0,0,10000,0,0,0,10000,0,10000,10000
05603P,聯發科元大96售09,0,0,0,0,0,0,0,0,0,10000,0,0,0,10000,0,10000,10000
056185,全新統一98購01  ,0,0,0,0,0,0,0,0,0,10000,0,0,0,10000,0,10000,10000
055568,緯穎凱基97購02  ,0,0,0,0,0,0,0,0,0,10000,0,0,0,10000,0,10000,10000
056145,緯穎元大98購03  ,0,0,0,0,0,0,0,0,0,10000,0,0,0,10000,0,10000,10000
057429,華新科兆豐98購03,0,0,0,0,0,0,0,0,0,10000,0,0,0,20000,10000,10000,10000
057212,台積電群益98購03,0,0,0,0,0,0,0,0,0,10000,0,0,0,10000,0,10000,10000
059244,聯發科凱基99購13,0,0,0,0,0,0,0,0,0,10000,0,0,0,10000,0,10000,10000
059226,臺股指元大99購19,0,0,0,0,0,0,0,0,0,10000,0,0,0,10000,0,10000,10000
059221,聯發科元大99購21,0,0,0,0,0,0,0,0,0,10000,0,0,0,10000,0,10000,10000
057986,華新科元富99購05,0,0,0,0,0,0,0,0,0,10000,0,0,0,10000,0,10000,10000
056904,大立光元大99購05,0,0,0,0,0,0,0,0,0,10000,0,0,0,10000,0,10000,10000
056930,晶豪科台新98購01,0,0,0,0,0,0,0,0,0,10000,0,0,0,10000,0,10000,10000
058069,美律凱基99購05  ,0,0,0,0,0,0,0,0,0,10000,0,0,0,10000,0,10000,10000
056990,聯發科兆豐98購01,0,0,0,0,0,0,0,0,0,10000,0,0,0,60000,50000,10000,10000
058987,華新科凱基9B購01,0,0,0,0,0,0,0,0,0,10000,0,0,0,10000,0,10000,10000
058289,奇鋐國票9A購01  ,0,0,0,0,0,0,0,0,0,10000,0,0,0,10000,0,10000,10000
055889,鴻海統一97購05  ,0,0,0,0,0,0,0,0,0,10000,0,0,0,10000,0,10000,10000
058143,瑞儀元大99購02  ,0,0,0,0,0,0,0,0,0,10000,0,0,0,474000,464000,10000,10000
059161,鴻海凱基9A購09  ,0,0,0,0,0,0,0,0,0,10000,0,0,0,12000,2000,10000,10000
059162,國巨凱基99購12  ,0,0,0,0,0,0,0,0,0,10000,0,0,0,12000,2000,10000,10000
059192,臺股指富邦9C購01,0,0,0,0,0,0,0,0,0,10000,0,0,0,10000,0,10000,10000
059102,聯鈞元富99購01  ,0,0,0,0,0,0,0,0,0,10000,0,0,0,40000,30000,10000,10000
058806,道瓊銀統一9B購01,0,0,0,0,0,0,0,0,0,10000,0,0,0,10000,0,10000,10000
058834,GIS永豐99購01   ,0,0,0,0,0,0,0,0,0,10000,0,0,0,10000,0,10000,10000
056651,聯茂凱基98購04  ,0,0,0,0,0,0,0,0,0,10000,0,0,0,10000,0,10000,10000
057891,華新科統一9A購01,0,0,0,0,0,0,0,0,0,10000,0,0,0,10000,0,10000,10000
058868,元油2X國票99購06,0,0,0,0,0,0,0,0,0,10000,0,0,0,10000,0,10000,10000
05844P,旺宏元大96售07  ,0,0,0,0,0,0,0,0,0,10000,0,0,0,10000,0,10000,10000
056506,晶豪科永豐98購02,0,0,0,0,0,0,0,0,0,10000,0,0,0,14000,4000,10000,10000
056399,上証2X群益9C購01,0,0,0,0,0,0,0,0,0,10000,0,0,0,10000,0,10000,10000
058761,欣興群益99購02  ,0,0,0,0,0,0,0,0,0,10000,0,0,0,10000,0,10000,10000
058489,台灣50群益9B購01,0,0,0,0,0,0,0,0,0,10000,0,0,0,10000,0,10000,10000
058535,玉晶光統一9A購06,0,0,0,0,0,0,0,0,0,10000,0,0,0,10000,0,10000,10000
058527,世紀鋼元大99購01,0,0,0,0,0,0,0,0,0,10000,0,0,0,10000,0,10000,10000
059391,立積凱基9A購01  ,0,0,0,0,0,0,0,0,0,10000,0,0,0,10000,0,10000,10000
059378,台光電群益9B購01,0,0,0,0,0,0,0,0,0,10000,0,0,0,20000,10000,10000,10000
059529,華新科凱基9A購04,0,0,0,0,0,0,0,0,0,10000,0,0,0,10000,0,10000,10000
059541,T50正2康和99購01,0,0,0,0,0,0,0,0,0,10000,0,0,0,27000,17000,10000,10000
059929,華新科富邦9C購03,0,0,0,0,0,0,0,0,0,10000,0,0,0,10000,0,10000,10000
059692,聯詠永豐99購01  ,0,0,0,0,0,0,0,0,0,10000,0,0,0,10000,0,10000,10000
059262,致茂中信01購01  ,0,0,0,0,0,0,0,0,0,10000,0,0,0,10000,0,10000,10000
059906,臺指反元大9C購04,0,0,0,0,0,0,0,0,0,10000,0,0,0,60000,50000,10000,10000
059861,聯發科群益9A購01,0,0,0,0,0,0,0,0,0,10000,0,0,0,22000,12000,10000,10000
911616,杜康-DR         ,10000,0,10000,0,0,0,0,0,0,0,0,0,0,0,0,0,10000
5283,禾聯碩          ,14000,6000,8000,0,0,0,0,0,0,2000,0,0,0,3000,1000,2000,10000
3645,達邁            ,79400,47000,32400,0,0,0,0,0,0,-23000,24000,47000,-23000,0,0,0,9400
2524,京城            ,29000,17860,11140,0,0,0,0,2000,-2000,0,0,0,0,0,0,0,9140
07694P,超眾元大9A售05  ,0,0,0,0,0,0,0,0,0,9000,0,0,0,22000,13000,9000,9000
06860P,台灣50兆豐98售01,0,0,0,0,0,0,0,0,0,9000,0,0,0,154000,145000,9000,9000
060557,南電凱基9A購02  ,0,0,0,0,0,0,0,0,0,9000,0,0,0,163000,154000,9000,9000
060608,玉晶光凱基9A購08,0,0,0,0,0,0,0,0,0,9000,0,0,0,9000,0,9000,9000
060332,聯發科麥證9A購01,0,0,0,13000,4000,9000,0,0,0,9000,0,0,0,13000,4000,9000,9000
060372,A50正2元富9A購04,0,0,0,0,0,0,0,0,0,9000,0,0,0,9000,0,9000,9000
060697,鴻海國泰9C購01  ,0,0,0,0,0,0,0,0,0,9000,0,0,0,9000,0,9000,9000
06254P,臺股指群益97售07,0,0,0,0,0,0,0,0,0,9000,0,0,0,24000,15000,9000,9000
061210,玉山金元大9A購02,0,0,0,0,0,0,0,0,0,9000,0,0,0,34000,25000,9000,9000
061234,國巨元大9A購18  ,0,0,0,0,0,0,0,0,0,9000,0,0,0,43000,34000,9000,9000
060939,鴻海國票9A購06  ,0,0,0,0,0,0,0,0,0,9000,0,0,0,9000,0,9000,9000
060859,鴻海永豐9A購01  ,0,0,0,0,0,0,0,0,0,9000,0,0,0,9000,0,9000,9000
047285,鴻海統一95購02  ,0,0,0,0,0,0,0,0,0,9000,0,0,0,9000,0,9000,9000
048551,鴻海元大94購02  ,0,0,0,0,0,0,0,0,0,9000,0,0,0,9000,0,9000,9000
048346,智易元大95購01  ,0,0,0,0,0,0,0,0,0,9000,0,0,0,9000,0,9000,9000
05401P,聯茂永豐95售03  ,0,0,0,0,0,0,0,0,0,9000,0,0,0,9000,0,9000,9000
054352,世芯國泰98購01  ,0,0,0,0,0,0,0,0,0,9000,0,0,0,73000,64000,9000,9000
052124,京鼎國票95購01  ,0,0,0,0,0,0,0,0,0,9000,0,0,0,9000,0,9000,9000
058654,鴻海中信03購01  ,0,0,0,0,0,0,0,0,0,9000,0,0,0,9000,0,9000,9000
058310,大立光元大99購10,0,0,0,0,0,0,0,0,0,9000,0,0,0,10000,1000,9000,9000
053158,茂林元大96購01  ,0,0,0,0,0,0,0,0,0,9000,0,0,0,9000,0,9000,9000
053074,嘉晶永豐96購02  ,0,0,0,0,0,0,0,0,0,9000,0,0,0,9000,0,9000,9000
054626,建準凱基98購01  ,0,0,0,0,0,0,0,0,0,9000,0,0,0,9000,0,9000,9000
055138,大毅永豐97購02  ,0,0,0,0,0,0,0,0,0,9000,0,0,0,19000,10000,9000,9000
055285,華新科元大99購03,0,0,0,0,0,0,0,0,0,9000,0,0,0,9000,0,9000,9000
055527,旺宏群益99購03  ,0,0,0,0,0,0,0,0,0,9000,0,0,0,10000,1000,9000,9000
055437,禾伸堂中信99購01,0,0,0,0,0,0,0,0,0,9000,0,0,0,76000,67000,9000,9000
058427,大毅元富99購01  ,0,0,0,0,0,0,0,0,0,9000,0,0,0,9000,0,9000,9000
058412,聯發科兆豐99購01,0,0,0,0,0,0,0,0,0,9000,0,0,0,69000,60000,9000,9000
059003,中壽元大99購01  ,0,0,0,0,0,0,0,0,0,9000,0,0,0,9000,0,9000,9000
05691P,聯發科中信98售01,0,0,0,0,0,0,0,0,0,9000,0,0,0,20000,11000,9000,9000
056975,元油2X群益98購03,99000,90000,9000,0,0,0,0,0,0,0,0,0,0,0,0,0,9000
058573,鴻海群益9A購02  ,0,0,0,0,0,0,0,0,0,9000,0,0,0,263000,254000,9000,9000
057327,玉晶光群益9A購04,0,0,0,0,0,0,0,0,0,9000,0,0,0,65000,56000,9000,9000
057269,鈺齊兆豐98購01  ,0,0,0,0,0,0,0,0,0,9000,0,0,0,9000,0,9000,9000
056127,致新國票98購02  ,0,0,0,0,0,0,0,0,0,9000,0,0,0,9000,0,9000,9000
056051,T50反1元大97購05,0,0,0,0,0,0,0,0,0,9000,0,0,0,9000,0,9000,9000
055787,聯茂凱基99購01  ,0,0,0,0,0,0,0,0,0,9000,0,0,0,9000,0,9000,9000
056211,南港國票98購01  ,0,0,0,0,0,0,0,0,0,9000,0,0,0,9000,0,9000,9000
056214,義隆國票99購01  ,0,0,0,0,0,0,0,0,0,9000,0,0,0,20000,11000,9000,9000
056251,聯發科兆豐97購02,0,0,0,0,0,0,0,0,0,9000,0,0,0,10000,1000,9000,9000
059641,群創凱基99購06  ,0,0,0,0,0,0,0,0,0,9000,0,0,0,15000,6000,9000,9000
3356,奇偶            ,45000,36000,9000,0,0,0,0,0,0,0,0,0,0,0,0,0,9000
059823,奇力新凱基99購07,0,0,0,0,0,0,0,0,0,9000,0,0,0,9000,0,9000,9000
059949,啟碁永豐99購01  ,0,0,0,0,0,0,0,0,0,9000,0,0,0,34000,25000,9000,9000
3052,夆典            ,28000,9000,19000,0,0,0,0,0,0,-10000,0,10000,-10000,0,0,0,9000
060684,同欣電元大9A購01,0,0,0,0,0,0,0,0,0,8000,0,0,0,201000,193000,8000,8000
060310,瑞昱永豐9A購01  ,0,0,0,0,0,0,0,0,0,8000,0,0,0,28000,20000,8000,8000
060730,台積電群益9A購03,0,0,0,0,0,0,0,0,0,8000,0,0,0,15000,7000,8000,8000
060497,臺指反元大01購02,0,0,0,0,0,0,0,0,0,8000,0,0,0,8000,0,8000,8000
06046P,健策統一96售03  ,0,0,0,0,0,0,0,0,0,8000,0,0,0,10000,2000,8000,8000
06891P,緯穎富邦99售03  ,0,0,0,0,0,0,0,0,0,8000,0,0,0,51000,43000,8000,8000
07009P,臺股指中信9B售01,0,0,0,0,0,0,0,0,0,8000,0,0,0,10000,2000,8000,8000
07118P,台積電凱基99售09,0,0,0,0,0,0,0,0,0,8000,0,0,0,8000,0,8000,8000
07531P,大立光國泰9B售03,0,0,0,0,0,0,0,0,0,8000,0,0,0,208000,200000,8000,8000
1903,士紙            ,17000,9000,8000,0,0,0,0,0,0,0,0,0,0,0,0,0,8000
8454,富邦媒          ,53000,47000,6000,0,0,0,0,0,0,2000,5000,3000,2000,0,0,0,8000
054735,漢唐凱基98購01  ,0,0,0,0,0,0,0,0,0,8000,0,0,0,8000,0,8000,8000
054710,東元元富97購01  ,0,0,0,0,0,0,0,0,0,8000,0,0,0,124000,116000,8000,8000
054625,旺宏凱基98購03  ,0,0,0,0,0,0,0,0,0,8000,0,0,0,11000,3000,8000,8000
054516,國巨元大97購02  ,0,0,0,0,0,0,0,0,0,8000,0,0,0,8000,0,8000,8000
05306P,泰碩國泰97售01  ,0,0,0,0,0,0,0,0,0,8000,0,0,0,43000,35000,8000,8000
053171,中磊群益96購01  ,0,0,0,0,0,0,0,0,0,8000,0,0,0,8000,0,8000,8000
053183,大立光元富96購03,0,0,0,0,0,0,0,0,0,8000,0,0,0,208000,200000,8000,8000
053894,創意群益96購01  ,0,0,0,0,0,0,0,0,0,8000,0,0,0,18000,10000,8000,8000
053593,晶技元大98購01  ,0,0,0,0,0,0,0,0,0,8000,0,0,0,125000,117000,8000,8000
051281,健策兆豐96購01  ,0,0,0,0,0,0,0,0,0,8000,0,0,0,38000,30000,8000,8000
05013P,台積電元大96售05,0,0,0,0,0,0,0,0,0,8000,0,0,0,8000,0,8000,8000
050424,鴻海凱基96購03  ,0,0,0,0,0,0,0,0,0,8000,0,0,0,18000,10000,8000,8000
05060P,台達電富邦97售02,0,0,0,0,0,0,0,0,0,8000,0,0,0,9000,1000,8000,8000
059590,台積電元大99購39,0,0,0,0,0,0,0,0,0,8000,0,0,0,8000,0,8000,8000
060037,鴻海國票99購10  ,0,0,0,0,0,0,0,0,0,8000,0,0,0,15000,7000,8000,8000
056188,晶相光統一99購01,0,0,0,0,0,0,0,0,0,8000,0,0,0,8000,0,8000,8000
056049,奇力新國票98購01,0,0,0,0,0,0,0,0,0,8000,0,0,0,8000,0,8000,8000
057148,玉晶光國票99購04,0,0,0,0,0,0,0,0,0,8000,0,0,0,9000,1000,8000,8000
058960,臺股指國票99購05,0,0,0,0,0,0,0,0,0,8000,0,0,0,17000,9000,8000,8000
058052,南電元大98購02  ,0,0,0,0,0,0,0,0,0,8000,0,0,0,9000,1000,8000,8000
058159,健策台新9A購01  ,0,0,0,0,0,0,0,0,0,8000,0,0,0,64000,56000,8000,8000
057090,奇力新元富98購02,0,0,0,0,0,0,0,0,0,8000,0,0,0,8000,0,8000,8000
058813,旺宏統一9B購04  ,0,0,0,0,0,0,0,0,0,8000,0,0,0,8000,0,8000,8000
057846,神達永豐98購01  ,0,0,0,0,0,0,0,0,0,8000,0,0,0,18000,10000,8000,8000
056504,國巨永豐98購02  ,0,0,0,0,0,0,0,0,0,8000,0,0,0,8000,0,8000,8000
059532,華新科凱基9B購03,0,0,0,0,0,0,0,0,0,8000,0,0,0,10000,2000,8000,8000
059513,揚明光永豐99購01,0,0,0,0,0,0,0,0,0,8000,0,0,0,8000,0,8000,8000
059405,台灣50國票01購01,0,0,0,0,0,0,0,0,0,8000,0,0,0,8000,0,8000,8000
059966,台積電凱基99購19,0,0,0,0,0,0,0,0,0,8000,0,0,0,10000,2000,8000,8000
059671,滬深2X元富99購05,0,0,0,0,0,0,0,0,0,8000,0,0,0,20000,12000,8000,8000
059321,欣興元大99購07  ,0,0,0,0,0,0,0,0,0,8000,0,0,0,8000,0,8000,8000
059846,力山永豐99購01  ,0,0,0,0,0,0,0,0,0,8000,0,0,0,9000,1000,8000,8000
059887,華新科國票99購02,0,0,0,0,0,0,0,0,0,8000,0,0,0,8000,0,8000,8000
2425,承啟            ,113000,98000,15000,0,0,0,0,0,0,-8000,0,8000,-8000,0,0,0,7000
07428P,華新科國票9A售01,0,0,0,0,0,0,0,0,0,7000,0,0,0,10000,3000,7000,7000
06750P,聯發科元富02售03,0,0,0,0,0,0,0,0,0,7000,0,0,0,7000,0,7000,7000
060596,元黃金凱基9A購02,0,0,0,0,0,0,0,0,0,7000,0,0,0,564000,557000,7000,7000
060594,國巨麥證9A購01  ,0,0,0,7000,0,7000,0,0,0,7000,0,0,0,7000,0,7000,7000
060358,國巨元富9A購01  ,0,0,0,0,0,0,0,0,0,7000,0,0,0,7000,0,7000,7000
060405,中租國泰9C購01  ,0,0,0,0,0,0,0,0,0,7000,0,0,0,52000,45000,7000,7000
060845,欣興國票9A購01  ,0,0,0,0,0,0,0,0,0,7000,0,0,0,7000,0,7000,7000
06652P,長榮航元大98售01,0,0,0,0,0,0,0,0,0,7000,0,0,0,7000,0,7000,7000
061041,南電永豐9A購03  ,0,0,0,0,0,0,0,0,0,7000,0,0,0,155000,148000,7000,7000
061170,南茂兆豐9B購01  ,0,0,0,0,0,0,0,0,0,7000,0,0,0,30000,23000,7000,7000
06216P,上銀元富97售03  ,0,0,0,0,0,0,0,0,0,7000,0,0,0,7000,0,7000,7000
06212P,華新科元大97售11,0,0,0,0,0,0,0,0,0,7000,0,0,0,84000,77000,7000,7000
050212,瀚宇博國票95購02,0,0,0,0,0,0,0,0,0,7000,0,0,0,7000,0,7000,7000
049955,崇越群益95購01  ,0,0,0,0,0,0,0,0,0,7000,0,0,0,7000,0,7000,7000
047410,上銀元富96購01  ,0,0,0,0,0,0,0,0,0,7000,0,0,0,50000,43000,7000,7000
04514P,元石油中信97售01,0,0,0,0,0,0,0,0,0,7000,0,0,0,7000,0,7000,7000
03428B,臺股指凱基97熊18,0,0,0,0,0,0,0,0,0,7000,0,0,0,7000,0,7000,7000
03432B,臺股指凱基98熊13,0,0,0,0,0,0,0,0,0,7000,0,0,0,7000,0,7000,7000
03422B,臺股指凱基96熊28,0,0,0,0,0,0,0,0,0,7000,0,0,0,7000,0,7000,7000
05171P,臺股指元大95售15,0,0,0,0,0,0,0,0,0,7000,0,0,0,7000,0,7000,7000
051597,T50反1中信99購02,0,0,0,0,0,0,0,0,0,7000,0,0,0,7000,0,7000,7000
052123,泰碩國票95購01  ,0,0,0,0,0,0,0,0,0,7000,0,0,0,7000,0,7000,7000
052137,台表科凱基96購02,0,0,0,0,0,0,0,0,0,7000,0,0,0,7000,0,7000,7000
054177,牧德台新97購01  ,0,0,0,0,0,0,0,0,0,7000,0,0,0,7000,0,7000,7000
054204,元金2X國票9B購02,0,0,0,0,0,0,0,0,0,7000,0,0,0,7000,0,7000,7000
053996,晶相光群益97購01,0,0,0,0,0,0,0,0,0,7000,0,0,0,7000,0,7000,7000
053493,智邦兆豐97購02  ,0,0,0,0,0,0,0,0,0,7000,0,0,0,7000,0,7000,7000
053777,台積電元大96購20,0,0,0,0,0,0,0,0,0,7000,0,0,0,7000,0,7000,7000
058628,宏達電國票9A購01,0,0,0,0,0,0,0,0,0,7000,0,0,0,45000,38000,7000,7000
057826,祥碩元大98購08  ,0,0,0,0,0,0,0,0,0,7000,0,0,0,26000,19000,7000,7000
056321,創意群益98購02  ,0,0,0,0,0,0,0,0,0,7000,0,0,0,16000,9000,7000,7000
054947,興勤元大97購01  ,0,0,0,0,0,0,0,0,0,7000,0,0,0,7000,0,7000,7000
055399,超眾統一99購01  ,0,0,0,0,0,0,0,0,0,7000,0,0,0,7000,0,7000,7000
052918,智易富邦97購02  ,0,0,0,0,0,0,0,0,0,7000,0,0,0,7000,0,7000,7000
056420,台表科元富98購01,0,0,0,0,0,0,0,0,0,7000,0,0,0,20000,13000,7000,7000
057853,旺宏國票99購05  ,0,0,0,0,0,0,0,0,0,7000,0,0,0,7000,0,7000,7000
057003,立積國票98購01  ,0,0,0,0,0,0,0,0,0,7000,0,0,0,14000,7000,7000,7000
058033,景碩永豐98購02  ,0,0,0,0,0,0,0,0,0,7000,0,0,0,9000,2000,7000,7000
057346,鴻海統一98購13  ,0,0,0,0,0,0,0,0,0,7000,0,0,0,8000,1000,7000,7000
057273,智邦元大98購05  ,0,0,0,0,0,0,0,0,0,7000,0,0,0,128000,121000,7000,7000
057236,聯詠凱基98購03  ,0,0,0,0,0,0,0,0,0,7000,0,0,0,48000,41000,7000,7000
059021,台積電統一9B購07,0,0,0,0,0,0,0,0,0,7000,0,0,0,7000,0,7000,7000
055617,TPK國票98購04   ,0,0,0,0,0,0,0,0,0,7000,0,0,0,45000,38000,7000,7000
059746,聯鈞元富99購03  ,0,0,0,0,0,0,0,0,0,7000,0,0,0,16000,9000,7000,7000
059724,聯發科元大99購30,0,0,0,0,0,0,0,0,0,7000,0,0,0,10000,3000,7000,7000
059267,群創中信01購02  ,0,0,0,0,0,0,0,0,0,7000,0,0,0,7000,0,7000,7000
057507,貿聯國票98購02  ,0,0,0,0,0,0,0,0,0,7000,0,0,0,28000,21000,7000,7000
057642,南亞科元大98購07,0,0,0,0,0,0,0,0,0,7000,0,0,0,27000,20000,7000,7000
059845,欣興富邦9A購02  ,0,0,0,0,0,0,0,0,0,7000,0,0,0,16000,9000,7000,7000
059323,新日興元大99購02,0,0,0,0,0,0,0,0,0,7000,0,0,0,7000,0,7000,7000
059941,聯發科永豐99購04,0,0,0,0,0,0,0,0,0,7000,0,0,0,7000,0,7000,7000
059487,聯發科兆豐99購03,0,0,0,0,0,0,0,0,0,7000,0,0,0,7000,0,7000,7000
3591,艾笛森          ,26000,18000,8000,0,0,0,0,0,0,-1000,0,1000,-1000,0,0,0,7000
4912,聯德控股-KY     ,29795,23000,6795,0,0,0,0,0,0,0,0,0,0,0,0,0,6795
061198,世紀鋼永豐9A購03,0,0,0,0,0,0,0,0,0,6000,0,0,0,6000,0,6000,6000
061012,國巨麥證9A購03  ,0,0,0,8000,2000,6000,0,0,0,6000,0,0,0,8000,2000,6000,6000
060934,台汽電永豐9A購02,0,0,0,0,0,0,0,0,0,6000,0,0,0,80000,74000,6000,6000
060926,宏達電永豐9A購01,0,0,0,0,0,0,0,0,0,6000,0,0,0,25000,19000,6000,6000
060927,嘉晶永豐9A購01  ,0,0,0,0,0,0,0,0,0,6000,0,0,0,25000,19000,6000,6000
060591,富邦金台新9A購01,0,0,0,0,0,0,0,0,0,6000,0,0,0,21000,15000,6000,6000
060452,儒鴻元大9A購01  ,0,0,0,0,0,0,0,0,0,6000,0,0,0,45000,39000,6000,6000
060415,葡萄王永豐9A購01,0,0,0,0,0,0,0,0,0,6000,0,0,0,130000,124000,6000,6000
060549,聯發科凱基9B購03,0,0,0,0,0,0,0,0,0,6000,0,0,0,10000,4000,6000,6000
06880P,鈺齊凱基98售03  ,0,0,0,0,0,0,0,0,0,6000,0,0,0,6000,0,6000,6000
06572P,台積電永昌99售01,0,0,0,0,0,0,0,0,0,6000,0,0,0,6000,0,6000,6000
06973P,臺股指元大9A售11,0,0,0,0,0,0,0,0,0,6000,0,0,0,6000,0,6000,6000
07161P,臺股指群益99售12,0,0,0,0,0,0,0,0,0,6000,0,0,0,46000,40000,6000,6000
07129P,華新科元大99售14,0,0,0,0,0,0,0,0,0,6000,0,0,0,36000,30000,6000,6000
07402P,瑞昱凱基99售02  ,0,0,0,0,0,0,0,0,0,6000,0,0,0,11000,5000,6000,6000
07280P,FBVIX凱基99售01 ,0,0,0,0,0,0,0,0,0,6000,0,0,0,6000,0,6000,6000
07288P,台灣50凱基99售06,0,0,0,0,0,0,0,0,0,6000,0,0,0,6000,0,6000,6000
1540,喬福            ,18000,12000,6000,0,0,0,0,0,0,0,0,0,0,0,0,0,6000
052858,華通凱基97購02  ,0,0,0,0,0,0,0,0,0,6000,0,0,0,6000,0,6000,6000
055473,禾伸堂凱基97購01,0,0,0,0,0,0,0,0,0,6000,0,0,0,6000,0,6000,6000
055492,華新科元大97購08,0,0,0,0,0,0,0,0,0,6000,0,0,0,6000,0,6000,6000
055273,華泰元大97購01  ,0,0,0,0,0,0,0,0,0,6000,0,0,0,6000,0,6000,6000
055156,華新科元大99購02,0,0,0,0,0,0,0,0,0,6000,0,0,0,6000,0,6000,6000
055018,緯穎元富97購02  ,0,0,0,0,0,0,0,0,0,6000,0,0,0,6000,0,6000,6000
054519,禾伸堂元大97購02,0,0,0,0,0,0,0,0,0,6000,0,0,0,11000,5000,6000,6000
056256,聯茂元富97購03  ,0,0,0,0,0,0,0,0,0,6000,0,0,0,16000,10000,6000,6000
052987,華新科元大99購01,0,0,0,0,0,0,0,0,0,6000,0,0,0,6000,0,6000,6000
053664,臺股指凱基96購25,0,0,0,0,0,0,0,0,0,6000,0,0,0,11000,5000,6000,6000
053630,奇鋐兆豐97購01  ,0,0,0,0,0,0,0,0,0,6000,0,0,0,156000,150000,6000,6000
055521,S&P反1群益01購01,0,0,0,0,0,0,0,0,0,6000,0,0,0,10000,4000,6000,6000
052511,聯發科凱基95購14,0,0,0,0,0,0,0,0,0,6000,0,0,0,11000,5000,6000,6000
052115,T50反1國票95購03,0,0,0,0,0,0,0,0,0,6000,0,0,0,6000,0,6000,6000
052418,玉晶光兆豐96購01,0,0,0,0,0,0,0,0,0,6000,0,0,0,6000,0,6000,6000
03443B,臺股指凱基9A熊27,0,0,0,0,0,0,0,0,0,6000,0,0,0,12000,6000,6000,6000
00766L,台新MSCI中國正2 ,0,0,0,0,0,0,0,0,0,6000,0,0,0,80000,74000,6000,6000
045678,華新科元大95購01,0,0,0,0,0,0,0,0,0,6000,0,0,0,6000,0,6000,6000
057571,泰碩永豐98購01  ,0,0,0,0,0,0,0,0,0,6000,0,0,0,30000,24000,6000,6000
059644,茂林凱基99購03  ,0,0,0,0,0,0,0,0,0,6000,0,0,0,6000,0,6000,6000
056206,泰鼎永豐97購01  ,0,0,0,0,0,0,0,0,0,6000,0,0,0,6000,0,6000,6000
057427,華通兆豐99購01  ,0,0,0,0,0,0,0,0,0,6000,0,0,0,6000,0,6000,6000
059061,晶技凱基9A購01  ,0,0,0,0,0,0,0,0,0,6000,0,0,0,56000,50000,6000,6000
059066,道瓊指國票04購01,0,0,0,0,0,0,0,0,0,6000,0,0,0,6000,0,6000,6000
058981,國巨凱基99購10  ,0,0,0,0,0,0,0,0,0,6000,0,0,0,6000,0,6000,6000
058996,台達電元大99購02,0,0,0,0,0,0,0,0,0,6000,0,0,0,211000,205000,6000,6000
056877,群創凱基99購04  ,0,0,0,0,0,0,0,0,0,6000,0,0,0,6000,0,6000,6000
058247,聯茂元大99購04  ,0,0,0,0,0,0,0,0,0,6000,0,0,0,73000,67000,6000,6000
059195,國巨永豐99購04  ,0,0,0,0,0,0,0,0,0,6000,0,0,0,6000,0,6000,6000
058793,鴻海元大99購19  ,0,0,0,0,0,0,0,0,0,6000,0,0,0,14000,8000,6000,6000
058421,國泰金麥證01購01,0,0,0,6000,0,6000,0,0,0,6000,0,0,0,6000,0,6000,6000
059052,為升凱基99購01  ,0,0,0,0,0,0,0,0,0,6000,0,0,0,6000,0,6000,6000
059055,旺宏凱基9B購02  ,0,0,0,0,0,0,0,0,0,6000,0,0,0,7000,1000,6000,6000
056551,台郡凱基98購04  ,0,0,0,0,0,0,0,0,0,6000,0,0,0,39000,33000,6000,6000
058541,T50反1富邦01購01,0,0,0,0,0,0,0,0,0,6000,0,0,0,10000,4000,6000,6000
058915,SGBR2X元富99購01,0,0,0,0,0,0,0,0,0,6000,0,0,0,15000,9000,6000,6000
059373,滬深2X群益01購03,0,0,0,0,0,0,0,0,0,6000,0,0,0,6000,0,6000,6000
059664,立積元大9C購01  ,0,0,0,0,0,0,0,0,0,6000,0,0,0,6000,0,6000,6000
059881,臺股指凱基99購46,0,0,0,0,0,0,0,0,0,6000,0,0,0,16000,10000,6000,6000
059809,貿聯元富99購01  ,0,0,0,0,0,0,0,0,0,6000,0,0,0,20000,14000,6000,6000
4104,佳醫            ,23773,14000,9773,0,0,0,0,0,0,-4000,0,4000,-4000,0,0,0,5773
2459,敦吉            ,32000,26841,5159,0,0,0,0,0,0,0,0,0,0,0,0,0,5159
2114,鑫永銓          ,5000,0,5000,0,0,0,0,0,0,0,0,0,0,0,0,0,5000
2002A,中鋼特          ,0,0,0,0,0,0,0,0,0,5000,6000,1000,5000,0,0,0,5000
07661P,台灣50兆豐9A售03,0,0,0,0,0,0,0,0,0,5000,0,0,0,5000,0,5000,5000
07301P,臺股指元大9A售34,0,0,0,0,0,0,0,0,0,5000,0,0,0,95000,90000,5000,5000
07314P,T50正2元大9C售03,0,0,0,0,0,0,0,0,0,5000,0,0,0,5000,0,5000,5000
07355P,臺股指國票99售23,0,0,0,0,0,0,0,0,0,5000,0,0,0,25000,20000,5000,5000
07433P,臺股指國票9A售05,0,0,0,0,0,0,0,0,0,5000,0,0,0,5000,0,5000,5000
07439P,臺股指麥證9B售01,0,0,0,10000,5000,5000,0,0,0,5000,0,0,0,10000,5000,5000,5000
07375P,台積電元大99售48,0,0,0,0,0,0,0,0,0,5000,0,0,0,50000,45000,5000,5000
07526P,臺股指中信9B售08,0,0,0,0,0,0,0,0,0,5000,0,0,0,5000,0,5000,5000
07490P,大立光國票9A售03,0,0,0,0,0,0,0,0,0,5000,0,0,0,15000,10000,5000,5000
07013P,玉晶光群益9A售06,0,0,0,0,0,0,0,0,0,5000,0,0,0,5000,0,5000,5000
07026P,超眾凱基99售03  ,0,0,0,0,0,0,0,0,0,5000,0,0,0,5000,0,5000,5000
07053P,台灣50兆豐01售01,0,0,0,0,0,0,0,0,0,5000,0,0,0,15000,10000,5000,5000
06866P,聯發科元大98售13,0,0,0,0,0,0,0,0,0,5000,0,0,0,10000,5000,5000,5000
06771P,台灣50中信02售01,0,0,0,0,0,0,0,0,0,5000,0,0,0,10000,5000,5000,5000
060517,臺股指元大9B購14,0,0,0,0,0,0,0,0,0,5000,0,0,0,5000,0,5000,5000
060598,鴻海凱基9A購20  ,0,0,0,0,0,0,0,0,0,5000,0,0,0,12000,7000,5000,5000
060688,世紀鋼元大9C購01,0,0,0,0,0,0,0,0,0,5000,0,0,0,60000,55000,5000,5000
06024P,台郡國票97售05  ,0,0,0,0,0,0,0,0,0,5000,0,0,0,5000,0,5000,5000
061083,京元電兆豐9A購01,0,0,0,0,0,0,0,0,0,5000,0,0,0,16000,11000,5000,5000
060844,大立光國票9A購07,0,0,0,0,0,0,0,0,0,5000,0,0,0,11000,6000,5000,5000
060792,信錦永豐9A購01  ,0,0,0,0,0,0,0,0,0,5000,0,0,0,28000,23000,5000,5000
060995,泰鼎元大9A購03  ,0,0,0,0,0,0,0,0,0,5000,0,0,0,146000,141000,5000,5000
061200,道瓊反元大9A購06,0,0,0,0,0,0,0,0,0,5000,0,0,0,5000,0,5000,5000
06150P,奇力新元大97售06,0,0,0,0,0,0,0,0,0,5000,0,0,0,5000,0,5000,5000
061297,台積電富邦9C購09,0,0,0,0,0,0,0,0,0,5000,0,0,0,80000,75000,5000,5000
06245P,健策元富97售03  ,0,0,0,0,0,0,0,0,0,5000,0,0,0,5000,0,5000,5000
04543P,鴻海富邦95售03  ,0,0,0,0,0,0,0,0,0,5000,0,0,0,5000,0,5000,5000
04462P,全新元富96售01  ,0,0,0,0,0,0,0,0,0,5000,0,0,0,5000,0,5000,5000
036628,統一台新99購01  ,0,0,0,0,0,0,0,0,0,5000,0,0,0,5000,0,5000,5000
049583,台積電元大95購04,0,0,0,0,0,0,0,0,0,5000,0,0,0,5000,0,5000,5000
049909,國巨元大95購01  ,0,0,0,0,0,0,0,0,0,5000,0,0,0,5000,0,5000,5000
050254,大立光富邦96購02,0,0,0,0,0,0,0,0,0,5000,0,0,0,45000,40000,5000,5000
050765,鴻海元大96購02  ,0,0,0,0,0,0,0,0,0,5000,0,0,0,5000,0,5000,5000
03436B,臺股指元富99熊13,0,0,0,0,0,0,0,0,0,5000,0,0,0,5000,0,5000,5000
048754,瀚宇博元富97購01,0,0,0,0,0,0,0,0,0,5000,0,0,0,15000,10000,5000,5000
049108,玉晶光富邦96購02,0,0,0,0,0,0,0,0,0,5000,0,0,0,6000,1000,5000,5000
052421,元油反國票9B購01,0,0,0,0,0,0,0,0,0,5000,0,0,0,5000,0,5000,5000
052060,旺宏國票96購02  ,0,0,0,0,0,0,0,0,0,5000,0,0,0,5000,0,5000,5000
052443,台積電元大95購23,0,0,0,0,0,0,0,0,0,5000,0,0,0,5000,0,5000,5000
051412,奇力新國票96購01,0,0,0,0,0,0,0,0,0,5000,0,0,0,5000,0,5000,5000
052530,台郡元大96購04  ,0,0,0,0,0,0,0,0,0,5000,0,0,0,5000,0,5000,5000
05246P,南電元大95售04  ,0,0,0,0,0,0,0,0,0,5000,0,0,0,5000,0,5000,5000
052383,臺股指元大95購29,0,0,0,0,0,0,0,0,0,5000,0,0,0,5000,0,5000,5000
052391,瑞儀群益95購01  ,0,0,0,0,0,0,0,0,0,5000,0,0,0,5000,0,5000,5000
053969,瑞昱元大97購01  ,0,0,0,0,0,0,0,0,0,5000,0,0,0,5000,0,5000,5000
054237,茂林群益97購01  ,0,0,0,0,0,0,0,0,0,5000,0,0,0,5000,0,5000,5000
054156,聯電亞東98購01  ,0,0,0,0,0,0,0,0,0,5000,0,0,0,5000,0,5000,5000
055537,康友群益97購03  ,0,0,0,0,0,0,0,0,0,5000,0,0,0,5000,0,5000,5000
053473,聯發科元大96購15,0,0,0,0,0,0,0,0,0,5000,0,0,0,49000,44000,5000,5000
053623,臺股指群益96購09,0,0,0,0,0,0,0,0,0,5000,0,0,0,5000,0,5000,5000
053521,緯穎群益96購02  ,0,0,0,0,0,0,0,0,0,5000,0,0,0,5000,0,5000,5000
053045,國巨中信97購01  ,0,0,0,0,0,0,0,0,0,5000,0,0,0,5000,0,5000,5000
053184,世紀鋼元富96購01,0,0,0,0,0,0,0,0,0,5000,0,0,0,5000,0,5000,5000
053279,景碩元大97購01  ,0,0,0,0,0,0,0,0,0,5000,0,0,0,5000,0,5000,5000
057785,智邦國票99購02  ,0,0,0,0,0,0,0,0,0,5000,0,0,0,5000,0,5000,5000
054549,台積電凱基98購01,0,0,0,0,0,0,0,0,0,5000,0,0,0,5000,0,5000,5000
054459,鈺齊群益96購01  ,0,0,0,0,0,0,0,0,0,5000,0,0,0,5000,0,5000,5000
054426,國泰金富邦97購02,0,0,0,0,0,0,0,0,0,5000,0,0,0,5000,0,5000,5000
054572,國巨元大98購03  ,0,0,0,0,0,0,0,0,0,5000,0,0,0,5000,0,5000,5000
054654,全新麥證99購01  ,0,0,0,5000,0,5000,0,0,0,5000,0,0,0,5000,0,5000,5000
05466P,旺宏富邦97售01  ,0,0,0,0,0,0,0,0,0,5000,0,0,0,5000,0,5000,5000
054740,強茂凱基99購01  ,0,0,0,0,0,0,0,0,0,5000,0,0,0,5000,0,5000,5000
054966,貿聯元大98購02  ,0,0,0,0,0,0,0,0,0,5000,0,0,0,5000,0,5000,5000
055136,聯發科富邦99購06,0,0,0,0,0,0,0,0,0,5000,0,0,0,6000,1000,5000,5000
055276,台積電元大97購20,0,0,0,0,0,0,0,0,0,5000,0,0,0,5000,0,5000,5000
055272,國巨元大98購04  ,0,0,0,0,0,0,0,0,0,5000,0,0,0,5000,0,5000,5000
05291P,鴻海凱基95售16  ,0,0,0,0,0,0,0,0,0,5000,0,0,0,5000,0,5000,5000
058524,超眾元大99購04  ,0,0,0,0,0,0,0,0,0,5000,0,0,0,5000,0,5000,5000
058530,為升元富99購01  ,0,0,0,0,0,0,0,0,0,5000,0,0,0,5000,0,5000,5000
058716,華新科台新99購02,0,0,0,0,0,0,0,0,0,5000,0,0,0,5000,0,5000,5000
058719,智邦元富99購01  ,0,0,0,0,0,0,0,0,0,5000,0,0,0,168000,163000,5000,5000
056576,晶技元大99購02  ,0,0,0,0,0,0,0,0,0,5000,0,0,0,5000,0,5000,5000
056409,麗豐國票99購01  ,0,0,0,0,0,0,0,0,0,5000,0,0,0,5000,0,5000,5000
056394,晶豪科永豐98購01,0,0,0,0,0,0,0,0,0,5000,0,0,0,10000,5000,5000,5000
058400,聯發科元大99購09,0,0,0,0,0,0,0,0,0,5000,0,0,0,39000,34000,5000,5000
056747,致新凱基99購01  ,0,0,0,0,0,0,0,0,0,5000,0,0,0,5000,0,5000,5000
057926,帆宣凱基98購02  ,0,0,0,0,0,0,0,0,0,5000,0,0,0,5000,0,5000,5000
058772,茂林兆豐9A購01  ,0,0,0,0,0,0,0,0,0,5000,0,0,0,222000,217000,5000,5000
057852,國巨國票99購05  ,0,0,0,0,0,0,0,0,0,5000,0,0,0,5000,0,5000,5000
058228,為升元大99購01  ,0,0,0,0,0,0,0,0,0,5000,0,0,0,5000,0,5000,5000
059149,臺股指國票99購12,0,0,0,0,0,0,0,0,0,5000,0,0,0,5000,0,5000,5000
059093,旭富元大99購01  ,0,0,0,0,0,0,0,0,0,5000,0,0,0,5000,0,5000,5000
059085,鴻海元大99購25  ,0,0,0,0,0,0,0,0,0,5000,0,0,0,231000,226000,5000,5000
059134,臺股指群益99購09,0,0,0,0,0,0,0,0,0,5000,0,0,0,10000,5000,5000,5000
059127,國巨中信99購04  ,0,0,0,0,0,0,0,0,0,5000,0,0,0,77000,72000,5000,5000
057063,立積國泰9A購01  ,0,0,0,0,0,0,0,0,0,5000,0,0,0,5000,0,5000,5000
058168,國巨凱基9A購04  ,0,0,0,0,0,0,0,0,0,5000,0,0,0,5000,0,5000,5000
058595,T50正2元富99購01,0,0,0,0,0,0,0,0,0,5000,0,0,0,5000,0,5000,5000
059067,上銀國票9A購02  ,0,0,0,0,0,0,0,0,0,5000,0,0,0,5000,0,5000,5000
057351,奇力新統一98購02,0,0,0,0,0,0,0,0,0,5000,0,0,0,5000,0,5000,5000
056215,華新科國票97購03,0,0,0,0,0,0,0,0,0,5000,0,0,0,5000,0,5000,5000
055781,聯詠凱基98購01  ,0,0,0,0,0,0,0,0,0,5000,0,0,0,5000,0,5000,5000
056103,聯發科永豐97購03,0,0,0,0,0,0,0,0,0,5000,0,0,0,5000,0,5000,5000
055989,矽力元富9A購01  ,0,0,0,0,0,0,0,0,0,5000,0,0,0,20000,15000,5000,5000
055968,祥碩元大97購04  ,0,0,0,0,0,0,0,0,0,5000,0,0,0,36000,31000,5000,5000
055940,致新群益98購01  ,0,0,0,0,0,0,0,0,0,5000,0,0,0,51000,46000,5000,5000
059633,聯發科凱基9A購07,0,0,0,0,0,0,0,0,0,5000,0,0,0,10000,5000,5000,5000
059591,台積電元大9A購04,0,0,0,0,0,0,0,0,0,5000,0,0,0,17000,12000,5000,5000
059310,元石油元大99購03,0,0,0,0,0,0,0,0,0,5000,0,0,0,8000,3000,5000,5000
057595,健鼎兆豐98購01  ,0,0,0,0,0,0,0,0,0,5000,0,0,0,40000,35000,5000,5000
057566,欣興富邦99購01  ,0,0,0,0,0,0,0,0,0,5000,0,0,0,5000,0,5000,5000
05767P,國巨凱基96售11  ,0,0,0,0,0,0,0,0,0,5000,0,0,0,5000,0,5000,5000
057648,和碩元大98購01  ,0,0,0,0,0,0,0,0,0,5000,0,0,0,5000,0,5000,5000
059754,訊芯群益9A購01  ,0,0,0,0,0,0,0,0,0,5000,0,0,0,5000,0,5000,5000
060090,台積電元大99購55,0,0,0,0,0,0,0,0,0,5000,0,0,0,60000,55000,5000,5000
060162,碩天永豐9A購01  ,0,0,0,0,0,0,0,0,0,5000,0,0,0,27000,22000,5000,5000
060127,牧德永豐99購02  ,0,0,0,0,0,0,0,0,0,5000,0,0,0,23000,18000,5000,5000
060208,卜蜂康和9A購01  ,0,0,0,0,0,0,0,0,0,5000,0,0,0,19000,14000,5000,5000
060184,建準元富9A購01  ,0,0,0,0,0,0,0,0,0,5000,0,0,0,5000,0,5000,5000
9912,偉聯            ,8000,2000,6000,0,0,0,0,0,0,-1000,0,1000,-1000,0,0,0,5000
059827,晶技凱基99購03  ,0,0,0,0,0,0,0,0,0,5000,0,0,0,5000,0,5000,5000
059603,臺股指元大9A購40,0,0,0,0,0,0,0,0,0,5000,0,0,0,5000,0,5000,5000
059701,國巨凱基9A購09  ,0,0,0,0,0,0,0,0,0,5000,0,0,0,5000,0,5000,5000
059699,華通凱基99購04  ,0,0,0,0,0,0,0,0,0,5000,0,0,0,5000,0,5000,5000
059467,旺宏元大99購15  ,0,0,0,0,0,0,0,0,0,5000,0,0,0,15000,10000,5000,5000
059510,華新科永豐99購07,0,0,0,0,0,0,0,0,0,5000,0,0,0,9000,4000,5000,5000
059569,旺宏凱基99購09  ,0,0,0,0,0,0,0,0,0,5000,0,0,0,5000,0,5000,5000
06306P,臺股指元大97售12,0,0,0,0,0,0,0,0,0,4000,0,0,0,4000,0,4000,4000
06283P,祥碩永豐97售01  ,0,0,0,0,0,0,0,0,0,4000,0,0,0,5000,1000,4000,4000
06373P,聯發科元大97售22,0,0,0,0,0,0,0,0,0,4000,0,0,0,14000,10000,4000,4000
06661P,玉晶光永豐98售05,0,0,0,0,0,0,0,0,0,4000,0,0,0,44000,40000,4000,4000
060817,華邦電台新9A購01,0,0,0,0,0,0,0,0,0,4000,0,0,0,5000,1000,4000,4000
060264,華新科國票9A購02,0,0,0,0,0,0,0,0,0,4000,0,0,0,56000,52000,4000,4000
060345,聯發科統一9B購05,0,0,0,0,0,0,0,0,0,4000,0,0,0,10000,6000,4000,4000
060672,鴻海元大9A購14  ,0,0,0,0,0,0,0,0,0,4000,0,0,0,10000,6000,4000,4000
06861P,台積電國票99售08,0,0,0,0,0,0,0,0,0,4000,0,0,0,4000,0,4000,4000
07074P,FBVIX凱基9A售01 ,0,0,0,0,0,0,0,0,0,4000,0,0,0,4000,0,4000,4000
07193P,聯發科元大99售24,0,0,0,0,0,0,0,0,0,4000,0,0,0,4000,0,4000,4000
07460P,臺股指元大9B售03,0,0,0,0,0,0,0,0,0,4000,0,0,0,4000,0,4000,4000
07534P,台灣50群益9A售12,0,0,0,0,0,0,0,0,0,4000,0,0,0,4000,0,4000,4000
07610P,大立光國票9A售04,0,0,0,0,0,0,0,0,0,4000,0,0,0,4000,0,4000,4000
07671P,超眾元大9A售04  ,0,0,0,0,0,0,0,0,0,4000,0,0,0,24000,20000,4000,4000
1436,華友聯          ,13000,9000,4000,0,0,0,0,0,0,0,0,0,0,0,0,0,4000
1737,臺鹽            ,28000,24000,4000,0,0,0,0,0,0,0,0,0,0,0,0,0,4000
2359,所羅門          ,58000,49000,9000,0,0,0,0,0,0,-5000,0,5000,-5000,0,0,0,4000
052888,台表科中信9A購01,0,0,0,0,0,0,0,0,0,4000,0,0,0,4000,0,4000,4000
052849,可成統一97購01  ,0,0,0,0,0,0,0,0,0,4000,0,0,0,4000,0,4000,4000
052949,智易國票97購02  ,0,0,0,0,0,0,0,0,0,4000,0,0,0,4000,0,4000,4000
055168,光罩統一98購01  ,0,0,0,0,0,0,0,0,0,4000,0,0,0,4000,0,4000,4000
052822,泰碩永豐97購01  ,0,0,0,0,0,0,0,0,0,4000,0,0,0,140000,136000,4000,4000
055231,大毅國票98購02  ,0,0,0,0,0,0,0,0,0,4000,0,0,0,4000,0,4000,4000
054881,光罩統一97購01  ,0,0,0,0,0,0,0,0,0,4000,0,0,0,52000,48000,4000,4000
054695,世芯永豐98購01  ,0,0,0,0,0,0,0,0,0,4000,0,0,0,4000,0,4000,4000
058632,世紀鋼國票9A購01,0,0,0,0,0,0,0,0,0,4000,0,0,0,14000,10000,4000,4000
058673,華新科群益9A購02,0,0,0,0,0,0,0,0,0,4000,0,0,0,13000,9000,4000,4000
058688,矽創凱基9A購01  ,0,0,0,0,0,0,0,0,0,4000,0,0,0,120000,116000,4000,4000
058324,嘉聯益永豐9A購01,0,0,0,0,0,0,0,0,0,4000,0,0,0,10000,6000,4000,4000
053022,欣興國泰98購01  ,0,0,0,0,0,0,0,0,0,4000,0,0,0,35000,31000,4000,4000
054139,揚明光元大96購01,0,0,0,0,0,0,0,0,0,4000,0,0,0,4000,0,4000,4000
054373,富邦金中信97購01,0,0,0,0,0,0,0,0,0,4000,0,0,0,50000,46000,4000,4000
052599,S&P反1元大96購01,0,0,0,0,0,0,0,0,0,4000,0,0,0,25000,21000,4000,4000
051534,景碩國票97購01  ,0,0,0,0,0,0,0,0,0,4000,0,0,0,4000,0,4000,4000
051635,大立光國票96購04,0,0,0,0,0,0,0,0,0,4000,0,0,0,5000,1000,4000,4000
051030,康友元富95購01  ,0,0,0,0,0,0,0,0,0,4000,0,0,0,4000,0,4000,4000
01002T,土銀國泰R1      ,11000,7000,4000,0,0,0,0,0,0,0,0,0,0,0,0,0,4000
03007X,元展07          ,0,0,0,0,0,0,0,0,0,4000,0,0,0,4000,0,4000,4000
00681R,元大美債20反1   ,0,0,0,0,0,0,0,0,0,4000,0,0,0,4000,0,4000,4000
050705,南電凱基96購01  ,0,0,0,0,0,0,0,0,0,4000,0,0,0,10000,6000,4000,4000
050580,強茂國票95購01  ,0,0,0,0,0,0,0,0,0,4000,0,0,0,80000,76000,4000,4000
050353,華擎群益95購01  ,0,0,0,0,0,0,0,0,0,4000,0,0,0,4000,0,4000,4000
060059,鴻海兆豐99購06  ,0,0,0,0,0,0,0,0,0,4000,0,0,0,10000,6000,4000,4000
059782,A50正2元大9C購04,0,0,0,0,0,0,0,0,0,4000,0,0,0,4000,0,4000,4000
059973,A50正2元大99購02,0,0,0,0,0,0,0,0,0,4000,0,0,0,4000,0,4000,4000
057670,欣興元大99購02  ,0,0,0,0,0,0,0,0,0,4000,0,0,0,4000,0,4000,4000
057470,易華電永豐98購02,0,0,0,0,0,0,0,0,0,4000,0,0,0,4000,0,4000,4000
057170,瑞昱元大98購01  ,0,0,0,0,0,0,0,0,0,4000,0,0,0,143000,139000,4000,4000
059234,台灣50凱基9C購03,0,0,0,0,0,0,0,0,0,4000,0,0,0,25000,21000,4000,4000
058959,南茂國票9A購01  ,0,0,0,0,0,0,0,0,0,4000,0,0,0,14000,10000,4000,4000
058118,瑞昱群益99購01  ,0,0,0,0,0,0,0,0,0,4000,0,0,0,4000,0,4000,4000
057059,易華電元大99購01,0,0,0,0,0,0,0,0,0,4000,0,0,0,24000,20000,4000,4000
05899P,臺股指凱基96售30,0,0,0,0,0,0,0,0,0,4000,0,0,0,4000,0,4000,4000
058780,牧德國票9A購01  ,0,0,0,0,0,0,0,0,0,4000,0,0,0,7000,3000,4000,4000
058462,台積電兆豐99購01,0,0,0,0,0,0,0,0,0,4000,0,0,0,14000,10000,4000,4000
056381,台虹元富98購01  ,0,0,0,0,0,0,0,0,0,4000,0,0,0,4000,0,4000,4000
056505,聯發科永豐98購01,0,0,0,0,0,0,0,0,0,4000,0,0,0,4000,0,4000,4000
058545,義隆富邦9C購01  ,0,0,0,0,0,0,0,0,0,4000,0,0,0,27000,23000,4000,4000
059013,臺股指元大9A購32,0,0,0,0,0,0,0,0,0,4000,0,0,0,4000,0,4000,4000
059470,華新科元大99購16,0,0,0,0,0,0,0,0,0,4000,0,0,0,4000,0,4000,4000
059441,祥碩元大99購02  ,0,0,0,0,0,0,0,0,0,4000,0,0,0,21000,17000,4000,4000
059458,鎧勝永豐99購01  ,0,0,0,0,0,0,0,0,0,4000,0,0,0,14000,10000,4000,4000
059925,可成國泰9B購01  ,0,0,0,0,0,0,0,0,0,4000,0,0,0,64000,60000,4000,4000
059874,大立光凱基99購15,0,0,0,0,0,0,0,0,0,4000,0,0,0,4000,0,4000,4000
910322,康師傅-DR       ,5000,1000,4000,0,0,0,0,0,0,0,0,0,0,0,0,0,4000
5215,科嘉-KY         ,321000,417000,-96000,0,0,0,0,0,0,100000,100000,0,100000,0,0,0,4000
6136,富爾特          ,12000,7000,5000,0,0,0,0,0,0,-1000,0,1000,-1000,0,0,0,4000
2374,佳能            ,22000,18000,4000,0,0,0,0,0,0,-1000,0,1000,-1000,0,0,0,3000
8422,可寧衛          ,17000,10000,7000,0,0,0,0,1000,-1000,-3000,0,3000,-3000,0,0,0,3000
1783,和康生          ,30000,27000,3000,0,0,0,0,0,0,0,0,0,0,0,0,0,3000
07544P,大立光凱基9A售09,0,0,0,0,0,0,0,0,0,3000,0,0,0,15000,12000,3000,3000
07522P,台積電中信9A售03,0,0,0,0,0,0,0,0,0,3000,0,0,0,3000,0,3000,3000
07512P,國巨元大9A售08  ,0,0,0,0,0,0,0,0,0,3000,0,0,0,3000,0,3000,3000
07278P,台灣50元富9C售03,0,0,0,0,0,0,0,0,0,3000,0,0,0,3000,0,3000,3000
060244,大立光元大9B購02,0,0,0,0,0,0,0,0,0,3000,0,0,0,3000,0,3000,3000
060714,晶技永豐9A購02  ,0,0,0,0,0,0,0,0,0,3000,0,0,0,99000,96000,3000,3000
06375P,矽力元大97售06  ,0,0,0,0,0,0,0,0,0,3000,0,0,0,3000,0,3000,3000
06157P,聯鈞統一97售02  ,0,0,0,0,0,0,0,0,0,3000,0,0,0,3000,0,3000,3000
06165P,臺股指凱基9A售03,0,0,0,0,0,0,0,0,0,3000,0,0,0,3000,0,3000,3000
061292,玉晶光統一01購06,0,0,0,0,0,0,0,0,0,3000,0,0,0,3000,0,3000,3000
050252,聯發科國泰95購01,0,0,0,0,0,0,0,0,0,3000,0,0,0,183000,180000,3000,3000
050228,中磊中信96購01  ,0,0,0,0,0,0,0,0,0,3000,0,0,0,3000,0,3000,3000
049803,華新科元大95購07,0,0,0,0,0,0,0,0,0,3000,0,0,0,3000,0,3000,3000
049600,緯穎元大95購02  ,0,0,0,0,0,0,0,0,0,3000,0,0,0,3000,0,3000,3000
03679C,臺股指元大04牛04,0,0,0,0,0,0,0,0,0,3000,0,0,0,3000,0,3000,3000
03831P,臺股指中信95售02,0,0,0,0,0,0,0,0,0,3000,0,0,0,3000,0,3000,3000
039212,台達電台新9A購01,0,0,0,0,0,0,0,0,0,3000,0,0,0,3000,0,3000,3000
04249P,大立光統一94售04,0,0,0,0,0,0,0,0,0,3000,0,0,0,3000,0,3000,3000
04915P,鴻海永昌96售02  ,0,0,0,0,0,0,0,0,0,3000,0,0,0,3000,0,3000,3000
049007,玉晶光中信96購01,0,0,0,0,0,0,0,0,0,3000,0,0,0,233000,230000,3000,3000
048637,鴻海元大96購01  ,0,0,0,0,0,0,0,0,0,3000,0,0,0,3000,0,3000,3000
04953P,台積電群益94售13,0,0,0,0,0,0,0,0,0,3000,0,0,0,3000,0,3000,3000
051362,台郡元大95購04  ,0,0,0,0,0,0,0,0,0,3000,0,0,0,3000,0,3000,3000
051606,華新科群益95購05,0,0,0,0,0,0,0,0,0,3000,0,0,0,3000,0,3000,3000
051382,玉晶光群益98購02,0,0,0,0,0,0,0,0,0,3000,0,0,0,114000,111000,3000,3000
054064,台郡國票97購04  ,0,0,0,0,0,0,0,0,0,3000,0,0,0,3000,0,3000,3000
053742,創意國票97購01  ,0,0,0,0,0,0,0,0,0,3000,0,0,0,9000,6000,3000,3000
053628,微星兆豐96購01  ,0,0,0,0,0,0,0,0,0,3000,0,0,0,3000,0,3000,3000
056363,華新科元大99購04,0,0,0,0,0,0,0,0,0,3000,0,0,0,3000,0,3000,3000
054616,智伸科永豐97購01,0,0,0,0,0,0,0,0,0,3000,0,0,0,3000,0,3000,3000
054886,大毅統一97購01  ,0,0,0,0,0,0,0,0,0,3000,0,0,0,15000,12000,3000,3000
055327,致新國票98購01  ,0,0,0,0,0,0,0,0,0,3000,0,0,0,3000,0,3000,3000
052933,祥碩元大96購01  ,0,0,0,0,0,0,0,0,0,3000,0,0,0,7000,4000,3000,3000
055475,臻鼎凱基97購02  ,0,0,0,0,0,0,0,0,0,3000,0,0,0,3000,0,3000,3000
052759,京元電群益96購01,0,0,0,0,0,0,0,0,0,3000,0,0,0,72000,69000,3000,3000
056451,可成凱基99購01  ,0,0,0,0,0,0,0,0,0,3000,0,0,0,3000,0,3000,3000
058455,玉晶光永豐99購03,0,0,0,0,0,0,0,0,0,3000,0,0,0,5000,2000,3000,3000
058435,旺宏統一9B購02  ,0,0,0,0,0,0,0,0,0,3000,0,0,0,48000,45000,3000,3000
057860,金寶凱基98購01  ,0,0,0,0,0,0,0,0,0,3000,0,0,0,3000,0,3000,3000
057867,大立光凱基98購17,0,0,0,0,0,0,0,0,0,3000,0,0,0,3000,0,3000,3000
059084,鴻海元大99購24  ,0,0,0,0,0,0,0,0,0,3000,0,0,0,433000,430000,3000,3000
058255,臺股指元大9A購19,0,0,0,0,0,0,0,0,0,3000,0,0,0,3000,0,3000,3000
058988,大立光凱基9A購02,0,0,0,0,0,0,0,0,0,3000,0,0,0,3000,0,3000,3000
058004,大立光群益98購03,0,0,0,0,0,0,0,0,0,3000,0,0,0,3000,0,3000,3000
056820,欣興永豐98購02  ,0,0,0,0,0,0,0,0,0,3000,0,0,0,4000,1000,3000,3000
05683P,矽創元大96售01  ,0,0,0,0,0,0,0,0,0,3000,0,0,0,3000,0,3000,3000
056794,上銀麥證98購01  ,0,0,0,28000,25000,3000,0,0,0,3000,0,0,0,28000,25000,3000,3000
059236,鴻海凱基99購09  ,0,0,0,0,0,0,0,0,0,3000,0,0,0,5000,2000,3000,3000
057190,立積元大9A購02  ,0,0,0,0,0,0,0,0,0,3000,0,0,0,3000,0,3000,3000
057282,大立光元大99購06,0,0,0,0,0,0,0,0,0,3000,0,0,0,3000,0,3000,3000
055979,聯鈞統一97購03  ,0,0,0,0,0,0,0,0,0,3000,0,0,0,3000,0,3000,3000
056203,興富發永豐97購01,0,0,0,0,0,0,0,0,0,3000,0,0,0,19000,16000,3000,3000
059599,健策元大9B購02  ,0,0,0,0,0,0,0,0,0,3000,0,0,0,18000,15000,3000,3000
060192,欣興元富9A購01  ,0,0,0,0,0,0,0,0,0,3000,0,0,0,3000,0,3000,3000
6216,居易            ,10000,7000,3000,0,0,0,0,0,0,0,0,0,0,0,0,0,3000
4438,廣越            ,11000,8000,3000,0,0,0,0,0,0,0,0,0,0,0,0,0,3000
4720,德淵            ,6000,3000,3000,0,0,0,0,0,0,0,0,0,0,0,0,0,3000
4571,鈞興-KY         ,6000,3000,3000,0,0,0,0,0,0,0,0,0,0,0,0,0,3000
059349,台郡凱基99購04  ,0,0,0,0,0,0,0,0,0,3000,0,0,0,15000,12000,3000,3000
059457,立積永豐99購02  ,0,0,0,0,0,0,0,0,0,3000,0,0,0,3000,0,3000,3000
059388,國巨凱基99購13  ,0,0,0,0,0,0,0,0,0,3000,0,0,0,3000,0,3000,3000
059509,奇力新永豐99購02,0,0,0,0,0,0,0,0,0,3000,0,0,0,3000,0,3000,3000
2239,英利-KY         ,14060,12000,2060,0,0,0,0,0,0,0,0,0,0,0,0,0,2060
2013,中鋼構          ,19000,17000,2000,0,0,0,0,0,0,0,0,0,0,0,0,0,2000
1615,大山            ,11000,15000,-4000,0,0,0,0,0,0,6000,0,0,0,6000,0,6000,2000
1589,永冠-KY         ,50000,51000,-1000,0,0,0,0,0,0,3000,5000,2000,3000,0,0,0,2000
1323,永裕            ,7000,5000,2000,0,0,0,0,0,0,0,0,0,0,0,0,0,2000
07716P,臺股指群益9A售05,0,0,0,0,0,0,0,0,0,2000,0,0,0,2000,0,2000,2000
07284P,大立光凱基99售10,0,0,0,0,0,0,0,0,0,2000,0,0,0,6000,4000,2000,2000
07305P,T50正2群益99售02,0,0,0,0,0,0,0,0,0,2000,0,0,0,22000,20000,2000,2000
07362P,聯發科元大99售35,0,0,0,0,0,0,0,0,0,2000,0,0,0,29000,27000,2000,2000
07412P,國巨元大99售32  ,0,0,0,0,0,0,0,0,0,2000,0,0,0,7000,5000,2000,2000
07140P,台灣50日盛99售01,0,0,0,0,0,0,0,0,0,2000,0,0,0,22000,20000,2000,2000
07146P,瑞昱元大99售02  ,0,0,0,0,0,0,0,0,0,2000,0,0,0,2000,0,2000,2000
06937P,GIS元大98售03   ,0,0,0,0,0,0,0,0,0,2000,0,0,0,2000,0,2000,2000
06752P,訊芯凱基98售05  ,0,0,0,0,0,0,0,0,0,2000,0,0,0,2000,0,2000,2000
06765P,欣興元大98售11  ,0,0,0,0,0,0,0,0,0,2000,0,0,0,4000,2000,2000,2000
06576P,台光電群益98售03,0,0,0,0,0,0,0,0,0,2000,0,0,0,2000,0,2000,2000
06549P,大立光元大98售11,0,0,0,0,0,0,0,0,0,2000,0,0,0,2000,0,2000,2000
06738P,瑞昱兆豐98售02  ,0,0,0,0,0,0,0,0,0,2000,0,0,0,2000,0,2000,2000
06440P,台積電凱基98售07,0,0,0,0,0,0,0,0,0,2000,0,0,0,2000,0,2000,2000
06456P,聯發科統一98售03,0,0,0,0,0,0,0,0,0,2000,0,0,0,2000,0,2000,2000
060820,上証2X元大9A購04,0,0,0,0,0,0,0,0,0,2000,0,0,0,4000,2000,2000,2000
061032,金像電永豐9A購03,0,0,0,0,0,0,0,0,0,2000,0,0,0,56000,54000,2000,2000
060962,義隆凱基9B購01  ,0,0,0,0,0,0,0,0,0,2000,0,0,0,2000,0,2000,2000
060219,聯發科凱基9A購09,0,0,0,0,0,0,0,0,0,2000,0,0,0,20000,18000,2000,2000
060334,群光康和9A購01  ,0,0,0,0,0,0,0,0,0,2000,0,0,0,8000,6000,2000,2000
060727,高股息中信9C購02,0,0,0,0,0,0,0,0,0,2000,0,0,0,2000,0,2000,2000
060770,宏達電麥證9A購01,0,0,0,2000,0,2000,0,0,0,2000,0,0,0,2000,0,2000,2000
060601,技嘉凱基9A購02  ,0,0,0,0,0,0,0,0,0,2000,0,0,0,50000,48000,2000,2000
060645,台表科永豐9A購02,0,0,0,0,0,0,0,0,0,2000,0,0,0,5000,3000,2000,2000
060621,玉晶光元大9A購05,0,0,0,0,0,0,0,0,0,2000,0,0,0,22000,20000,2000,2000
060498,華通元大9A購03  ,0,0,0,0,0,0,0,0,0,2000,0,0,0,9000,7000,2000,2000
060414,中興電永豐9A購01,0,0,0,0,0,0,0,0,0,2000,0,0,0,2000,0,2000,2000
060431,復盛永豐9A購01  ,0,0,0,0,0,0,0,0,0,2000,0,0,0,2000,0,2000,2000
052867,晶技凱基96購01  ,0,0,0,0,0,0,0,0,0,2000,0,0,0,2000,0,2000,2000
055270,上銀元大97購03  ,0,0,0,0,0,0,0,0,0,2000,0,0,0,2000,0,2000,2000
05533P,滬深2X富邦97售01,0,0,0,0,0,0,0,0,0,2000,0,0,0,2000,0,2000,2000
054895,南電統一97購01  ,0,0,0,0,0,0,0,0,0,2000,0,0,0,2000,0,2000,2000
054915,興勤凱基97購01  ,0,0,0,0,0,0,0,0,0,2000,0,0,0,2000,0,2000,2000
054941,凱美元大97購01  ,0,0,0,0,0,0,0,0,0,2000,0,0,0,2000,0,2000,2000
054593,滬深2X永昌9A購01,0,0,0,0,0,0,0,0,0,2000,0,0,0,4000,2000,2000,2000
054470,緯穎國票97購04  ,0,0,0,0,0,0,0,0,0,2000,0,0,0,12000,10000,2000,2000
05437P,聯詠永豐95售02  ,0,0,0,0,0,0,0,0,0,2000,0,0,0,3000,1000,2000,2000
054556,世芯凱基99購01  ,0,0,0,0,0,0,0,0,0,2000,0,0,0,2000,0,2000,2000
056367,祥碩元大98購01  ,0,0,0,0,0,0,0,0,0,2000,0,0,0,2000,0,2000,2000
058623,國巨國票99購08  ,0,0,0,0,0,0,0,0,0,2000,0,0,0,2000,0,2000,2000
057847,聯茂永豐98購01  ,0,0,0,0,0,0,0,0,0,2000,0,0,0,2000,0,2000,2000
053306,晶技凱基97購01  ,0,0,0,0,0,0,0,0,0,2000,0,0,0,2000,0,2000,2000
053194,緯穎統一99購01  ,0,0,0,0,0,0,0,0,0,2000,0,0,0,2000,0,2000,2000
053181,滬深2X元富99購02,0,0,0,0,0,0,0,0,0,2000,0,0,0,2000,0,2000,2000
056287,亞光永豐97購02  ,0,0,0,0,0,0,0,0,0,2000,0,0,0,2000,0,2000,2000
058631,鈺齊國票9A購01  ,0,0,0,0,0,0,0,0,0,2000,0,0,0,9000,7000,2000,2000
053527,創意中信97購01  ,0,0,0,0,0,0,0,0,0,2000,0,0,0,2000,0,2000,2000
053173,矽格群益97購01  ,0,0,0,0,0,0,0,0,0,2000,0,0,0,2000,0,2000,2000
053819,大立光群益96購04,1000,0,1000,0,0,0,0,0,0,1000,0,0,0,2000,1000,1000,2000
054098,嘉晶國票97購04  ,0,0,0,0,0,0,0,0,0,2000,0,0,0,2000,0,2000,2000
054105,元油反凱基9A購01,0,0,0,0,0,0,0,0,0,2000,0,0,0,2000,0,2000,2000
054135,大立光元大97購04,0,0,0,0,0,0,0,0,0,2000,0,0,0,2000,0,2000,2000
054311,世芯凱基96購02  ,0,0,0,0,0,0,0,0,0,2000,0,0,0,55000,53000,2000,2000
052561,矽創國票97購01  ,0,0,0,0,0,0,0,0,0,2000,0,0,0,2000,0,2000,2000
05399P,GIS國票95售03   ,0,0,0,0,0,0,0,0,0,2000,0,0,0,10000,8000,2000,2000
052351,中環元富95購01  ,0,0,0,0,0,0,0,0,0,2000,0,0,0,2000,0,2000,2000
051468,智邦日盛95購01  ,0,0,0,0,0,0,0,0,0,2000,0,0,0,22000,20000,2000,2000
051598,瑞昱兆豐95購01  ,0,0,0,0,0,0,0,0,0,2000,0,0,0,10000,8000,2000,2000
051682,元黃金凱基97購01,0,0,0,0,0,0,0,0,0,2000,0,0,0,2000,0,2000,2000
05116P,台積電群益95售03,0,0,0,0,0,0,0,0,0,2000,0,0,0,2000,0,2000,2000
051103,緯穎元大96購03  ,0,0,0,0,0,0,0,0,0,2000,0,0,0,2000,0,2000,2000
052067,中磊兆豐96購01  ,0,0,0,0,0,0,0,0,0,2000,0,0,0,2000,0,2000,2000
051849,旺宏中信98購01  ,0,0,0,0,0,0,0,0,0,2000,0,0,0,2000,0,2000,2000
03052X,元展49          ,0,0,0,0,0,0,0,0,0,2000,0,0,0,2000,0,2000,2000
03427B,臺股指元大9A熊02,0,0,0,0,0,0,0,0,0,2000,0,0,0,2000,0,2000,2000
049130,臺指反元大98購01,0,0,0,0,0,0,0,0,0,2000,0,0,0,2000,0,2000,2000
049217,智邦國票95購01  ,0,0,0,0,0,0,0,0,0,2000,0,0,0,2000,0,2000,2000
00776,新光ICE美國權值 ,0,0,0,0,0,0,0,0,0,2000,0,0,0,103000,101000,2000,2000
050694,國巨凱基96購03  ,0,0,0,0,0,0,0,0,0,2000,0,0,0,29000,27000,2000,2000
060156,光磊永豐9A購01  ,0,0,0,0,0,0,0,0,0,2000,0,0,0,146000,144000,2000,2000
060026,聯發科富邦9B購05,0,0,0,0,0,0,0,0,0,2000,0,0,0,10000,8000,2000,2000
059616,滬深2X群益01購04,0,0,0,0,0,0,0,0,0,2000,0,0,0,2000,0,2000,2000
059634,可成凱基99購07  ,0,0,0,0,0,0,0,0,0,2000,0,0,0,2000,0,2000,2000
059738,上証2X元富99購01,0,0,0,0,0,0,0,0,0,2000,0,0,0,2000,0,2000,2000
057591,鴻海兆豐99購01  ,0,0,0,0,0,0,0,0,0,2000,0,0,0,2000,0,2000,2000
058220,世芯國票9A購01  ,0,0,0,0,0,0,0,0,0,2000,0,0,0,21000,19000,2000,2000
056230,可成凱基98購03  ,0,0,0,0,0,0,0,0,0,2000,0,0,0,2000,0,2000,2000
055817,京鼎國票99購01  ,0,0,0,0,0,0,0,0,0,2000,0,0,0,2000,0,2000,2000
055847,大立光元大97購10,0,0,0,0,0,0,0,0,0,2000,0,0,0,3000,1000,2000,2000
055848,大立光元大97購11,0,0,0,0,0,0,0,0,0,2000,0,0,0,2000,0,2000,2000
056010,力成中信97購01  ,0,0,0,0,0,0,0,0,0,2000,0,0,0,120000,118000,2000,2000
055931,冠德群益97購02  ,0,0,0,0,0,0,0,0,0,2000,0,0,0,2000,0,2000,2000
055910,瑞昱凱基98購01  ,0,0,0,0,0,0,0,0,0,2000,0,0,0,2000,0,2000,2000
056085,聯發科統一97購01,0,0,0,0,0,0,0,0,0,2000,0,0,0,2000,0,2000,2000
056087,世芯統一97購01  ,0,0,0,0,0,0,0,0,0,2000,0,0,0,2000,0,2000,2000
056129,義隆麥證97購01  ,0,0,0,15000,13000,2000,0,0,0,2000,0,0,0,15000,13000,2000,2000
057433,上銀國票98購04  ,0,0,0,0,0,0,0,0,0,2000,0,0,0,2000,0,2000,2000
057165,國巨元大99購05  ,0,0,0,0,0,0,0,0,0,2000,0,0,0,2000,0,2000,2000
057153,祥碩國泰99購01  ,0,0,0,0,0,0,0,0,0,2000,0,0,0,2000,0,2000,2000
059225,臺股指元大99購18,0,0,0,0,0,0,0,0,0,2000,0,0,0,2000,0,2000,2000
056788,日月光群益98購01,0,0,0,0,0,0,0,0,0,2000,0,0,0,2000,0,2000,2000
056848,泰鼎元富98購01  ,0,0,0,0,0,0,0,0,0,2000,0,0,0,2000,0,2000,2000
056941,台郡元富9B購01  ,0,0,0,0,0,0,0,0,0,2000,0,0,0,2000,0,2000,2000
057072,日月光永豐98購01,0,0,0,0,0,0,0,0,0,2000,0,0,0,3000,1000,2000,2000
057028,台郡凱基99購02  ,0,0,0,0,0,0,0,0,0,2000,0,0,0,2000,0,2000,2000
058129,國巨元大99購10  ,0,0,0,0,0,0,0,0,0,2000,0,0,0,25000,23000,2000,2000
059077,FBVIX元大99購05 ,0,0,0,0,0,0,0,0,0,2000,0,0,0,2000,0,2000,2000
059116,晶豪科永豐99購01,0,0,0,0,0,0,0,0,0,2000,0,0,0,2000,0,2000,2000
059146,貿聯國票9A購02  ,0,0,0,0,0,0,0,0,0,2000,0,0,0,10000,8000,2000,2000
056663,臺股指元大9A購10,0,0,0,0,0,0,0,0,0,2000,0,0,0,2000,0,2000,2000
058795,可成元大99購03  ,0,0,0,0,0,0,0,0,0,2000,0,0,0,2000,0,2000,2000
057925,貿聯凱基99購01  ,0,0,0,0,0,0,0,0,0,2000,0,0,0,2000,0,2000,2000
058812,台積電統一9B購06,0,0,0,0,0,0,0,0,0,2000,0,0,0,2000,0,2000,2000
05880P,創意康和96售01  ,0,0,0,0,0,0,0,0,0,2000,0,0,0,50000,48000,2000,2000
058824,晶技富邦9A購01  ,0,0,0,0,0,0,0,0,0,2000,0,0,0,2000,0,2000,2000
057938,台表科群益98購02,0,0,0,0,0,0,0,0,0,2000,0,0,0,3000,1000,2000,2000
056743,貿聯凱基98購04  ,0,0,0,0,0,0,0,0,0,2000,0,0,0,51000,49000,2000,2000
056720,世紀鋼永豐98購01,0,0,0,0,0,0,0,0,0,2000,0,0,0,10000,8000,2000,2000
056455,群創凱基9A購01  ,0,0,0,0,0,0,0,0,0,2000,0,0,0,2000,0,2000,2000
056564,亞光群益98購02  ,0,0,0,0,0,0,0,0,0,2000,0,0,0,2000,0,2000,2000
056597,宏碁元富98購01  ,0,0,0,0,0,0,0,0,0,2000,0,0,0,2000,0,2000,2000
058951,南電群益99購01  ,0,0,0,0,0,0,0,0,0,2000,0,0,0,91000,89000,2000,2000
058917,SGBR2X元富99購03,0,0,0,0,0,0,0,0,0,2000,0,0,0,2000,0,2000,2000
058523,聯茂元大99購08  ,0,0,0,0,0,0,0,0,0,2000,0,0,0,70000,68000,2000,2000
058531,華通元富99購01  ,0,0,0,0,0,0,0,0,0,2000,0,0,0,7000,5000,2000,2000
059453,奇力新永豐99購01,0,0,0,0,0,0,0,0,0,2000,0,0,0,12000,10000,2000,2000
2891C,中信金丙特      ,0,0,0,0,0,0,0,0,0,2000,2000,0,2000,0,0,0,2000
2705,六福            ,15000,13000,2000,0,0,0,0,0,0,0,0,0,0,0,0,0,2000
2838A,聯邦銀甲特      ,0,0,0,0,0,0,0,0,0,2000,2000,0,2000,0,0,0,2000
2617,台航            ,58000,56000,2000,0,0,0,0,0,0,0,0,0,0,0,0,0,2000
059937,旺宏永豐99購03  ,0,0,0,0,0,0,0,0,0,2000,0,0,0,2000,0,2000,2000
059681,華新科國泰9B購02,0,0,0,0,0,0,0,0,0,2000,0,0,0,2000,0,2000,2000
8480,泰昇-KY         ,5000,3000,2000,0,0,0,0,0,0,0,0,0,0,0,0,0,2000
6183,關貿            ,17000,14000,3000,0,0,0,0,0,0,-1000,0,1000,-1000,0,0,0,2000
060447,A50正2元大9A購02,0,0,0,0,0,0,0,0,0,1000,0,0,0,1000,0,1000,1000
060495,台灣50元大01購13,0,0,0,0,0,0,0,0,0,1000,0,0,0,1000,0,1000,1000
060647,T50反1第一9A購01,0,0,0,0,0,0,0,0,0,1000,0,0,0,31000,30000,1000,1000
060609,玉晶光凱基9B購01,0,0,0,0,0,0,0,0,0,1000,0,0,0,1000,0,1000,1000
060605,大立光凱基9C購01,0,0,0,0,0,0,0,0,0,1000,0,0,0,1000,0,1000,1000
060756,鴻海元大9A購16  ,0,0,0,0,0,0,0,0,0,1000,0,0,0,1000,0,1000,1000
061130,牧德永豐9A購04  ,0,0,0,0,0,0,0,0,0,1000,0,0,0,4000,3000,1000,1000
060353,A50正2元富9A購01,0,0,0,0,0,0,0,0,0,1000,0,0,0,1000,0,1000,1000
060378,台灣50凱基04購01,0,0,0,0,0,0,0,0,0,1000,0,0,0,1000,0,1000,1000
061120,台積電永豐9A購03,0,0,0,0,0,0,0,0,0,1000,0,0,0,1000,0,1000,1000
060970,T50反1元大9A購08,0,0,0,0,0,0,0,0,0,1000,0,0,0,1000,0,1000,1000
061013,台積電麥證9A購03,0,0,0,53000,52000,1000,0,0,0,1000,0,0,0,53000,52000,1000,1000
06104P,大立光凱基97售04,0,0,0,0,0,0,0,0,0,1000,0,0,0,1000,0,1000,1000
061066,嘉晶凱基9B購01  ,0,0,0,0,0,0,0,0,0,1000,0,0,0,1000,0,1000,1000
060863,聯發科永豐9A購02,0,0,0,0,0,0,0,0,0,1000,0,0,0,1000,0,1000,1000
060882,大立光中信9A購05,0,0,0,0,0,0,0,0,0,1000,0,0,0,3000,2000,1000,1000
061302,晶技永豐9A購04  ,0,0,0,0,0,0,0,0,0,1000,0,0,0,1000,0,1000,1000
061255,道瓊反凱基9C購01,0,0,0,0,0,0,0,0,0,1000,0,0,0,1000,0,1000,1000
06684P,緯穎元大98售06  ,0,0,0,0,0,0,0,0,0,1000,0,0,0,1000,0,1000,1000
06581P,南亞科凱基98售04,0,0,0,0,0,0,0,0,0,1000,0,0,0,1000,0,1000,1000
06500P,臺股指元大9A售05,0,0,0,0,0,0,0,0,0,1000,0,0,0,1000,0,1000,1000
06534P,聯發科群益98售04,0,0,0,0,0,0,0,0,0,1000,0,0,0,1000,0,1000,1000
06469P,臺股指凱基99售09,0,0,0,0,0,0,0,0,0,1000,0,0,0,1000,0,1000,1000
06487P,聯發科統一99售02,0,0,0,0,0,0,0,0,0,1000,0,0,0,11000,10000,1000,1000
06751P,旺宏凱基98售10  ,0,0,0,0,0,0,0,0,0,1000,0,0,0,1000,0,1000,1000
06896P,信邦中信98售01  ,0,0,0,0,0,0,0,0,0,1000,0,0,0,1000,0,1000,1000
07075P,FBVIX凱基9C售04 ,0,0,0,0,0,0,0,0,0,1000,0,0,0,1000,0,1000,1000
07064P,臺股指元大9A售25,0,0,0,0,0,0,0,0,0,1000,0,0,0,201000,200000,1000,1000
07571P,台灣50元大9A售14,0,0,0,0,0,0,0,0,0,1000,0,0,0,1000,0,1000,1000
1537,廣隆            ,20000,18000,2000,0,0,0,0,1000,-1000,0,0,0,0,0,0,0,1000
1467,南緯            ,34000,33000,1000,0,0,0,0,0,0,0,0,0,0,0,0,0,1000
2302,麗正            ,1000,0,1000,0,0,0,0,0,0,0,0,0,0,0,0,0,1000
2428,興勤            ,29000,24000,5000,0,0,0,0,1000,-1000,-3000,0,3000,-3000,0,0,0,1000
2433,互盛電          ,5000,1000,4000,0,0,0,0,0,0,-3000,0,3000,-3000,0,0,0,1000
9941A,裕融甲特        ,0,0,0,0,0,0,0,0,0,1000,1000,0,1000,0,0,0,1000
9942,茂順            ,13000,12000,1000,0,0,0,0,0,0,0,0,0,0,0,0,0,1000
8028,昇陽半導體      ,177000,176000,1000,0,0,0,0,0,0,0,0,1000,-1000,3000,2000,1000,1000
2486,一詮            ,54000,49000,5000,0,0,0,0,0,0,-4000,0,4000,-4000,0,0,0,1000
050685,緯穎元富94購02  ,0,0,0,0,0,0,0,0,0,1000,0,0,0,1000,0,1000,1000
04980P,臺股指凱基96售08,0,0,0,0,0,0,0,0,0,1000,0,0,0,1000,0,1000,1000
03896P,長榮航凱基95售01,0,0,0,0,0,0,0,0,0,1000,0,0,0,1000,0,1000,1000
03676C,臺股指元大04牛03,0,0,0,0,0,0,0,0,0,1000,0,0,0,1000,0,1000,1000
044088,國巨元富95購01  ,0,0,0,0,0,0,0,0,0,1000,0,0,0,1000,0,1000,1000
04957P,上証2X凱基96售02,0,0,0,0,0,0,0,0,0,1000,0,0,0,1000,0,1000,1000
051799,台積電永豐96購01,0,0,0,0,0,0,0,0,0,1000,0,0,0,1000,0,1000,1000
047905,元油反元大96購04,0,0,0,0,0,0,0,0,0,1000,0,0,0,1000,0,1000,1000
047211,華新科富邦99購01,0,0,0,0,0,0,0,0,0,1000,0,0,0,1000,0,1000,1000
00707R,元大S&P日圓反1  ,0,0,0,0,0,0,0,0,0,1000,0,0,0,2000,1000,1000,1000
00690,兆豐藍籌30      ,0,0,0,0,0,0,0,0,0,1000,0,0,0,168000,167000,1000,1000
0057,富邦摩台        ,0,0,0,0,0,0,0,0,0,1000,0,0,0,42000,41000,1000,1000
049042,玉晶光兆豐95購01,0,0,0,0,0,0,0,0,0,1000,0,0,0,1000,0,1000,1000
03618C,高股息凱基95牛01,0,0,0,0,0,0,0,0,0,1000,0,0,0,1000,0,1000,1000
03619C,臺股指元大95牛02,0,0,0,0,0,0,0,0,0,1000,0,0,0,1000,0,1000,1000
03033X,元展30          ,0,0,0,0,0,0,0,0,0,1000,0,0,0,4000,3000,1000,1000
04927P,大立光凱基95售06,0,0,0,0,0,0,0,0,0,1000,0,0,0,1000,0,1000,1000
051899,欣興國泰97購01  ,0,0,0,0,0,0,0,0,0,1000,0,0,0,1000,0,1000,1000
051087,國巨元大97購01  ,0,0,0,0,0,0,0,0,0,1000,0,0,0,30000,29000,1000,1000
050903,臺股指元大95購10,0,0,0,0,0,0,0,0,0,1000,0,0,0,1000,0,1000,1000
051624,智邦麥證95購02  ,0,0,0,1000,0,1000,0,0,0,1000,0,0,0,1000,0,1000,1000
052492,易華電國票96購02,0,0,0,0,0,0,0,0,0,1000,0,0,0,1000,0,1000,1000
053952,南亞科台新96購01,0,0,0,0,0,0,0,0,0,1000,0,0,0,1000,0,1000,1000
052555,漢唐國票97購01  ,0,0,0,0,0,0,0,0,0,1000,0,0,0,1000,0,1000,1000
054299,南電元大96購03  ,0,0,0,0,0,0,0,0,0,1000,0,0,0,1000,0,1000,1000
054235,欣興群益96購06  ,0,0,0,0,0,0,0,0,0,1000,0,0,0,81000,80000,1000,1000
05414P,台表科國票96售02,0,0,0,0,0,0,0,0,0,1000,0,0,0,1000,0,1000,1000
054080,微星中信98購01  ,0,0,0,0,0,0,0,0,0,1000,0,0,0,1000,0,1000,1000
054072,台積電富邦98購02,0,0,0,0,0,0,0,0,0,1000,0,0,0,1000,0,1000,1000
054039,元油反元大96購08,0,0,0,0,0,0,0,0,0,1000,0,0,0,1000,0,1000,1000
053765,智邦富邦96購01  ,0,0,0,0,0,0,0,0,0,1000,0,0,0,1000,0,1000,1000
053504,祥碩兆豐96購01  ,0,0,0,0,0,0,0,0,0,1000,0,0,0,13000,12000,1000,1000
053611,聯茂麥證96購01  ,0,0,0,1000,0,1000,0,0,0,1000,0,0,0,1000,0,1000,1000
053417,上銀永豐96購02  ,0,0,0,0,0,0,0,0,0,1000,0,0,0,1000,0,1000,1000
058330,鴻海元富99購01  ,0,0,0,0,0,0,0,0,0,1000,0,0,0,1000,0,1000,1000
058383,道瓊指中信9C購02,0,0,0,0,0,0,0,0,0,1000,0,0,0,1000,0,1000,1000
056334,台積電凱基98購06,0,0,0,0,0,0,0,0,0,1000,0,0,0,1000,0,1000,1000
053197,超眾元富96購02  ,0,0,0,0,0,0,0,0,0,1000,0,0,0,1000,0,1000,1000
053304,可成凱基96購03  ,0,0,0,0,0,0,0,0,0,1000,0,0,0,1000,0,1000,1000
057771,鴻海群益99購01  ,0,0,0,0,0,0,0,0,0,1000,0,0,0,1000,0,1000,1000
057756,瑞昱日盛99購01  ,0,0,0,0,0,0,0,0,0,1000,0,0,0,1000,0,1000,1000
057728,瑞昱國泰99購01  ,0,0,0,0,0,0,0,0,0,1000,0,0,0,1000,0,1000,1000
054543,元金2X中信01購01,0,0,0,0,0,0,0,0,0,1000,0,0,0,1000,0,1000,1000
054672,華新科國泰99購01,0,0,0,0,0,0,0,0,0,1000,0,0,0,1000,0,1000,1000
054773,台郡國票98購01  ,0,0,0,0,0,0,0,0,0,1000,0,0,0,1000,0,1000,1000
054974,台表科元大98購02,0,0,0,0,0,0,0,0,0,1000,0,0,0,70000,69000,1000,1000
055006,晶相光元富9A購01,0,0,0,0,0,0,0,0,0,1000,0,0,0,1000,0,1000,1000
055039,神達富邦99購01  ,0,0,0,0,0,0,0,0,0,1000,0,0,0,1000,0,1000,1000
052647,晶技永豐97購01  ,0,0,0,0,0,0,0,0,0,1000,0,0,0,11000,10000,1000,1000
058557,健策第一01購01  ,0,0,0,0,0,0,0,0,0,1000,0,0,0,1000,0,1000,1000
058708,臺股指元大9A購21,0,0,0,0,0,0,0,0,0,1000,0,0,0,1000,0,1000,1000
058729,國巨永豐99購03  ,0,0,0,0,0,0,0,0,0,1000,0,0,0,1000,0,1000,1000
058723,元石油國泰9A購01,0,0,0,0,0,0,0,0,0,1000,0,0,0,1000,0,1000,1000
058697,亞德客元大99購01,0,0,0,0,0,0,0,0,0,1000,0,0,0,1000,0,1000,1000
057843,晶技永豐98購02  ,0,0,0,0,0,0,0,0,0,1000,0,0,0,11000,10000,1000,1000
05654P,台光電統一96售01,0,0,0,0,0,0,0,0,0,1000,0,0,0,1000,0,1000,1000
056426,上証2X凱基9A購01,0,0,0,0,0,0,0,0,0,1000,0,0,0,1000,0,1000,1000
059059,宏達電凱基99購03,0,0,0,0,0,0,0,0,0,1000,0,0,0,69000,68000,1000,1000
058860,SGBR2X凱基9A購01,0,0,0,0,0,0,0,0,0,1000,0,0,0,1000,0,1000,1000
058845,元油2X群益9C購04,0,0,0,0,0,0,0,0,0,1000,0,0,0,1000,0,1000,1000
058416,鴻海麥證99購01  ,0,0,0,2000,1000,1000,0,0,0,1000,0,0,0,2000,1000,1000,1000
058419,聯發科麥證99購02,0,0,0,0,20000,-20000,0,0,0,1000,0,0,0,21000,20000,1000,1000
058832,立積永豐99購01  ,0,0,0,0,0,0,0,0,0,1000,0,0,0,180000,179000,1000,1000
058833,台表科永豐99購01,0,0,0,0,0,0,0,0,0,1000,0,0,0,1000,0,1000,1000
058794,旺宏元大99購09  ,0,0,0,0,0,0,0,0,0,1000,0,0,0,1000,0,1000,1000
056664,上証反中信9B購01,0,0,0,0,0,0,0,0,0,1000,0,0,0,1000,0,1000,1000
057881,SP黃豆群益9A購01,0,0,0,0,0,0,0,0,0,1000,0,0,0,1000,0,1000,1000
059147,矽創國票99購01  ,0,0,0,0,0,0,0,0,0,1000,0,0,0,1000,0,1000,1000
059139,全新兆豐9A購01  ,0,0,0,0,0,0,0,0,0,1000,0,0,0,62000,61000,1000,1000
059145,創意國票99購02  ,0,0,0,0,0,0,0,0,0,1000,0,0,0,1000,0,1000,1000
059190,欣興富邦9A購01  ,0,0,0,0,0,0,0,0,0,1000,0,0,0,1000,0,1000,1000
057046,奇力新元大99購03,0,0,0,0,0,0,0,0,0,1000,0,0,0,1000,0,1000,1000
058298,聯茂凱基99購05  ,0,0,0,0,0,0,0,0,0,1000,0,0,0,1000,0,1000,1000
057012,康控中信98購01  ,0,0,0,0,0,0,0,0,0,1000,0,0,0,1000,0,1000,1000
056984,嘉晶群益98購01  ,0,0,0,0,0,0,0,0,0,1000,0,0,0,1000,0,1000,1000
056902,大立光元大98購12,0,0,0,0,0,0,0,0,0,1000,0,0,0,1000,0,1000,1000
056991,牧德兆豐98購01  ,0,0,0,0,0,0,0,0,0,1000,0,0,0,1000,0,1000,1000
058034,神達永豐98購02  ,0,0,0,0,0,0,0,0,0,1000,0,0,0,1000,0,1000,1000
058570,臻鼎凱基9A購01  ,0,0,0,0,0,0,0,0,0,1000,0,0,0,1000,0,1000,1000
05809P,臺股指國票96售02,0,0,0,0,0,0,0,0,0,1000,0,0,0,1000,0,1000,1000
057293,力成國泰99購01  ,0,0,0,0,0,0,0,0,0,1000,0,0,0,1000,0,1000,1000
057194,南電元大98購01  ,0,0,0,0,0,0,0,0,0,1000,0,0,0,9000,8000,1000,1000
057422,欣興凱基98購04  ,0,0,0,0,0,0,0,0,0,1000,0,0,0,1000,0,1000,1000
057281,大立光元大98購16,0,0,0,0,0,0,0,0,0,1000,0,0,0,1000,0,1000,1000
056070,新日興元大97購04,0,0,0,0,0,0,0,0,0,1000,0,0,0,1000,0,1000,1000
055816,新日興國票98購01,0,0,0,0,0,0,0,0,0,1000,0,0,0,1000,0,1000,1000
055777,冠德凱基97購01  ,0,0,0,0,0,0,0,0,0,1000,0,0,0,4000,3000,1000,1000
055582,亞德客元大97購01,0,0,0,0,0,0,0,0,0,1000,0,0,0,1000,0,1000,1000
056232,瑞儀凱基98購01  ,0,0,0,0,0,0,0,0,0,1000,0,0,0,1000,0,1000,1000
05766P,A50正2凱基99售01,0,0,0,0,0,0,0,0,0,1000,0,0,0,1000,0,1000,1000
057492,大立光元大98購18,0,0,0,0,0,0,0,0,0,1000,0,0,0,1000,0,1000,1000
059304,華新科兆豐99購06,0,0,0,0,0,0,0,0,0,1000,0,0,0,1000,0,1000,1000
059598,欣興元大99購08  ,0,0,0,0,0,0,0,0,0,1000,0,0,0,1000,0,1000,1000
059632,聯發科凱基01購01,0,0,0,0,0,0,0,0,0,1000,0,0,0,6000,5000,1000,1000
05960P,欣興統一96售01  ,0,0,0,0,0,0,0,0,0,1000,0,0,0,1000,0,1000,1000
060012,電子類群益99購02,0,0,0,0,0,0,0,0,0,1000,0,0,0,24000,23000,1000,1000
6192,巨路            ,17000,15000,2000,0,0,0,0,0,0,-1000,0,1000,-1000,0,0,0,1000
6141,柏承            ,149000,147000,2000,0,0,0,0,0,0,-1000,0,1000,-1000,0,0,0,1000
5906,台南-KY         ,2000,1000,1000,0,0,0,0,0,0,0,0,0,0,0,0,0,1000
5225,東科-KY         ,82000,81000,1000,0,0,0,0,0,0,0,0,0,0,0,0,0,1000
4581,光隆精密-KY     ,1000,0,1000,0,0,0,0,0,0,0,0,0,0,0,0,0,1000
3094,聯傑            ,25000,24000,1000,0,0,0,0,0,0,0,0,0,0,0,0,0,1000
059787,奇力新元大9A購02,0,0,0,0,0,0,0,0,0,1000,0,0,0,16000,15000,1000,1000
059696,立積永豐99購03  ,0,0,0,0,0,0,0,0,0,1000,0,0,0,11000,10000,1000,1000
059604,臺股指元大9A購41,0,0,0,0,0,0,0,0,0,1000,0,0,0,1000,0,1000,1000
2406,國碩            ,139000,137000,2000,0,0,0,0,0,0,-1541,0,1541,-1541,0,0,0,459
2243,宏旭-KY         ,1000,1000,0,0,0,0,0,0,0,0,0,0,0,0,0,0,0
2115,六暉-KY         ,0,1000,-1000,0,0,0,0,0,0,1000,1000,0,1000,0,0,0,0
2482,連宇            ,6000,6000,0,0,0,0,0,0,0,0,0,0,0,0,0,0,0
6625,必應            ,1000,1000,0,0,0,0,0,0,0,0,0,0,0,0,0,0,0
1453,大將            ,1000,1000,0,0,0,0,0,0,0,0,0,0,0,0,0,0,0
1614,三洋電          ,7000,7000,0,0,0,0,0,0,0,0,0,0,0,0,0,0,0
1616,億泰            ,5000,5000,0,0,0,0,0,0,0,0,0,0,0,0,0,0,0
08864P,欣興元大01售01  ,0,0,0,0,0,0,0,0,0,0,0,0,0,2000,2000,0,0
07553P,嘉晶元大9A售02  ,0,0,0,0,0,0,0,0,0,0,0,0,0,35000,35000,0,0
07605P,台灣50元大9B售10,0,0,0,0,0,0,0,0,0,0,0,0,0,2000,2000,0,0
07628P,臺股指凱基9A售09,0,0,0,0,0,0,0,0,0,0,0,0,0,5000,5000,0,0
07529P,國巨凱基9A售11  ,0,0,0,0,0,0,0,0,0,0,0,0,0,5000,5000,0,0
07364P,大立光元大99售27,0,0,0,0,0,0,0,0,0,0,0,0,0,100000,100000,0,0
07311P,台灣50元大99售09,0,0,0,0,0,0,0,0,0,0,0,0,0,20000,20000,0,0
07322P,鴻海元大99售33  ,0,0,0,0,0,0,0,0,0,0,0,0,0,35000,35000,0,0
07325P,台積電元大99售41,0,0,0,0,0,0,0,0,0,0,0,0,0,200000,200000,0,0
07265P,大立光元大99售16,0,0,0,0,0,0,0,0,0,0,0,0,0,27000,27000,0,0
07270P,台灣50元大01售09,0,0,0,0,0,0,0,0,0,0,0,0,0,10000,10000,0,0
07051P,大立光中信99售02,0,0,0,0,0,0,0,0,0,0,0,0,0,10000,10000,0,0
07121P,華新科凱基99售03,0,0,0,0,0,0,0,0,0,0,0,0,0,967000,967000,0,0
06986P,台積電台新9A售01,0,0,0,0,0,0,0,0,0,0,0,0,0,10000,10000,0,0
06959P,鴻海凱基9A售02  ,0,0,0,0,0,0,0,0,0,0,0,0,0,49000,49000,0,0
07130P,台郡元大9B售01  ,0,0,0,0,0,0,0,0,0,0,0,0,0,10000,10000,0,0
07123P,鴻海元大99售23  ,0,0,0,0,0,0,0,0,0,0,0,0,0,5000,5000,0,0
07207P,台積電凱基99售13,0,0,0,0,0,0,0,0,0,0,0,0,0,40000,40000,0,0
07192P,聯發科元大99售23,0,0,0,0,0,0,0,0,0,0,0,0,0,2000,2000,0,0
07235P,T50正2元大9C售02,0,0,0,0,0,0,0,0,0,0,0,0,0,5000,5000,0,0
06929P,鴻海元大99售11  ,0,0,0,0,0,0,0,0,0,0,0,0,0,10000,10000,0,0
06772P,國巨中信99售01  ,0,0,0,0,0,0,0,0,0,0,0,0,0,10000,10000,0,0
06453P,群創元大9B售02  ,0,0,0,0,0,0,0,0,0,0,0,0,0,60000,60000,0,0
06461P,玉晶光國泰9A售01,0,0,0,0,0,0,0,0,0,0,0,0,0,1000,1000,0,0
06486P,麗豐元大98售02  ,0,0,0,0,0,0,0,0,0,0,0,0,0,54000,54000,0,0
06568P,國巨永豐98售05  ,0,0,0,0,0,0,0,0,0,0,0,0,0,97000,97000,0,0
06569P,可成永豐98售01  ,0,0,0,0,0,0,0,0,0,0,0,0,0,10000,10000,0,0
06543P,鴻海元大98售08  ,0,0,0,0,0,0,0,0,0,0,0,0,0,15000,15000,0,0
06544P,鴻海元大98售09  ,0,0,0,0,0,0,0,0,0,0,0,0,0,580000,580000,0,0
06588P,台積電元大98售11,0,0,0,0,0,0,0,0,0,0,0,0,0,10000,10000,0,0
06589P,台積電元大98售12,0,0,0,0,0,0,0,0,0,0,0,0,0,10000,10000,0,0
06707P,臺股指台新99售04,0,0,0,0,0,0,0,0,0,0,0,0,0,10000,10000,0,0
061139,玉晶光統一9C購02,0,0,0,0,0,0,0,0,0,0,0,0,0,2000,2000,0,0
06723P,台灣50麥證99售01,0,0,0,0,30000,-30000,0,0,0,0,0,0,0,30000,30000,0,0
061174,鴻海凱基9A購23  ,0,0,0,0,0,0,0,0,0,0,0,0,0,7000,7000,0,0
061181,牧德凱基9A購01  ,0,0,0,0,0,0,0,0,0,0,0,0,0,14000,14000,0,0
061256,亞德客凱基9B購01,0,0,0,0,0,0,0,0,0,0,0,0,0,2000,2000,0,0
061248,健策群益9A購03  ,0,0,0,0,0,0,0,0,0,0,0,0,0,24000,24000,0,0
061246,玉晶光群益9A購08,0,0,0,0,0,0,0,0,0,0,0,0,0,10000,10000,0,0
061193,玉晶光永豐9B購02,0,0,0,0,0,0,0,0,0,0,0,0,0,2000,2000,0,0
061195,健策永豐9B購02  ,0,0,0,0,0,0,0,0,0,0,0,0,0,28000,28000,0,0
061333,華通元大9A購08  ,0,0,0,0,0,0,0,0,0,0,0,0,0,7000,7000,0,0
061334,華通元大9A購09  ,0,0,0,0,0,0,0,0,0,0,0,0,0,1000,1000,0,0
061350,牧德元大9B購03  ,0,0,0,0,0,0,0,0,0,0,0,0,0,1000,1000,0,0
061358,世紀鋼元大9A購04,0,0,0,0,0,0,0,0,0,0,0,0,0,6000,6000,0,0
06176P,台積電元大97售22,0,0,0,0,0,0,0,0,0,0,0,0,0,158000,158000,0,0
061392,泰鼎群益9A購02  ,0,0,0,0,0,0,0,0,0,0,0,0,0,14000,14000,0,0
06369P,台積電凱基97售16,0,0,0,0,0,0,0,0,0,0,0,0,0,40000,40000,0,0
06360P,台積電群益97售05,0,0,0,0,0,0,0,0,0,0,0,0,0,5000,5000,0,0
06308P,國巨元富97售06  ,0,0,0,0,0,0,0,0,0,0,0,0,0,10000,10000,0,0
06269P,群創凱基98售10  ,0,0,0,0,0,0,0,0,0,0,0,0,0,10000,10000,0,0
060881,玉山金中信02購01,0,0,0,0,0,0,0,0,0,0,0,0,0,17000,17000,0,0
060860,國巨永豐9A購02  ,50000,0,50000,0,0,0,0,0,0,-50000,0,0,0,0,50000,-50000,0
060831,T50反1國票9B購03,0,0,0,0,0,0,0,0,0,0,0,0,0,20000,20000,0,0
061065,神基凱基9A購01  ,0,0,0,0,0,0,0,0,0,0,0,0,0,90000,90000,0,0
06660P,大立光富邦9B售03,0,0,0,0,0,0,0,0,0,0,0,0,0,10000,10000,0,0
06655P,TPK元大98售02   ,0,0,0,0,0,0,0,0,0,0,0,0,0,6000,6000,0,0
06656P,GIS元大98售02   ,0,0,0,0,0,0,0,0,0,0,0,0,0,67000,67000,0,0
06647P,台積電元大98售13,0,0,0,0,0,0,0,0,0,0,0,0,0,10000,10000,0,0
061047,大立光第一9A購01,0,0,0,0,0,0,0,0,0,0,0,0,0,10000,10000,0,0
061018,台積電國票9B購05,0,0,0,0,0,0,0,0,0,0,0,0,0,4000,4000,0,0
061095,台積電台新9B購03,0,0,0,0,0,0,0,0,0,0,0,0,0,100000,100000,0,0
060359,國巨元富9A購02  ,0,0,0,0,0,0,0,0,0,0,0,0,0,10000,10000,0,0
060369,滬深2X元富01購01,0,0,0,0,0,0,0,0,0,0,0,0,0,20000,20000,0,0
060267,上緯控國票9C購01,0,0,0,0,0,0,0,0,0,0,0,0,0,10000,10000,0,0
060736,旺宏統一01購01  ,0,0,0,0,0,0,0,0,0,0,0,0,0,249000,249000,0,0
060767,世紀鋼元大9A購02,0,0,0,0,0,0,0,0,0,0,0,0,0,65000,65000,0,0
060671,亞德客元大9A購03,0,0,0,0,0,0,0,0,0,0,0,0,0,50000,50000,0,0
06072P,牧德永豐97售01  ,0,0,0,0,0,0,0,0,0,0,0,0,0,10000,10000,0,0
06064P,台積電台新98售01,0,0,0,0,0,0,0,0,0,0,0,0,0,10000,10000,0,0
060606,玉晶光凱基9A購05,0,0,0,0,0,0,0,0,0,0,0,0,0,4000,4000,0,0
060593,華通麥證9A購01  ,0,0,0,1000,1000,0,0,0,0,0,0,0,0,1000,1000,0,0
060643,牧德永豐9A購03  ,0,0,0,0,0,0,0,0,0,0,0,0,0,1000,1000,0,0
060623,玉晶光元大9C購01,0,0,0,0,0,0,0,0,0,0,0,0,0,10000,10000,0,0
060550,可成凱基9A購02  ,0,0,0,0,0,0,0,0,0,0,0,0,0,1000,1000,0,0
060449,元金2X元大9A購02,0,0,0,0,0,0,0,0,0,0,0,0,0,39000,39000,0,0
060459,鴻海元大9A購07  ,0,0,0,0,0,0,0,0,0,0,0,0,0,5000,5000,0,0
055251,華新科統一99購01,0,0,0,0,0,0,0,0,0,0,0,0,0,30000,30000,0,0
055122,國巨兆豐98購01  ,0,0,0,0,0,0,0,0,0,0,0,0,0,10000,10000,0,0
055079,台光電中信97購01,0,0,0,0,0,0,0,0,0,0,0,0,0,630000,630000,0,0
052735,燿華富邦98購01  ,0,0,0,0,0,0,0,0,0,0,0,0,0,1000,1000,0,0
055271,鴻海元大98購03  ,0,0,0,0,0,0,0,0,0,0,0,0,0,8000,8000,0,0
055331,國巨兆豐99購01  ,0,0,0,0,0,0,0,0,0,0,0,0,0,10000,10000,0,0
055305,旺宏群益99購01  ,0,0,0,0,0,0,0,0,0,0,0,0,0,2000,2000,0,0
052969,建準群益97購01  ,0,0,0,0,0,0,0,0,0,0,0,0,0,60000,60000,0,0
05551P,電子類元大96售01,0,0,0,0,0,0,0,0,0,0,0,0,0,17000,17000,0,0
052791,友達兆豐97購01  ,0,0,0,0,0,0,0,0,0,0,0,0,0,10000,10000,0,0
05535P,台積電元大97售06,0,0,0,0,0,0,0,0,0,0,0,0,0,68000,68000,0,0
055377,揚明光元大98購01,0,0,0,0,0,0,0,0,0,0,0,0,0,5000,5000,0,0
055227,聯發科國票98購02,0,0,0,0,0,0,0,0,0,0,0,0,0,20000,20000,0,0
054898,台肥康和97購01  ,0,0,0,0,0,0,0,0,0,0,0,0,0,10000,10000,0,0
054882,台光電統一97購02,0,0,0,0,0,0,0,0,0,0,0,0,0,48000,48000,0,0
054877,百和群益98購01  ,0,0,0,0,0,0,0,0,0,0,0,0,0,15000,15000,0,0
054707,聯茂亞東97購01  ,0,0,0,0,0,0,0,0,0,0,0,0,0,20000,20000,0,0
054547,鴻海凱基98購02  ,0,0,0,0,0,0,0,0,0,0,0,0,0,5000,5000,0,0
054475,鴻海中信96購04  ,0,0,0,0,0,0,0,0,0,0,0,0,0,220000,220000,0,0
057739,新日興富邦9B購01,0,0,0,0,0,0,0,0,0,0,0,0,0,20000,20000,0,0
057757,鴻海凱基98購13  ,0,0,0,0,0,0,0,0,0,0,0,0,0,105000,105000,0,0
057759,聯發科凱基98購17,0,0,0,0,0,0,0,0,0,0,0,0,0,20000,20000,0,0
056333,台積電日盛9B購01,0,0,0,0,0,0,0,0,0,0,0,0,0,10000,10000,0,0
057783,台積電國票9A購01,0,0,0,0,0,0,0,0,0,0,0,0,0,11000,11000,0,0
057797,大立光兆豐99購01,0,0,0,0,0,0,0,0,0,0,0,0,0,530000,530000,0,0
057833,聯發科元富02購06,0,0,0,0,0,0,0,0,0,0,0,0,0,15000,15000,0,0
058332,鴻海元富99購03  ,0,0,0,0,0,0,0,0,0,0,0,0,0,170000,170000,0,0
058629,嘉晶國票9A購01  ,0,0,0,0,0,0,0,0,0,0,0,0,0,10000,10000,0,0
058681,大立光康和9B購01,0,0,0,0,0,0,0,0,0,0,0,0,0,950000,950000,0,0
058660,樺漢中信9A購01  ,0,0,0,0,0,0,0,0,0,0,0,0,0,10000,10000,0,0
053415,聯茂國票97購01  ,0,0,0,0,0,0,0,0,0,0,0,0,0,104000,104000,0,0
053376,鴻海元大96購19  ,0,0,0,0,0,0,0,0,0,0,0,0,0,1000000,1000000,0,0
053356,聯發科統一96購07,0,0,0,0,0,0,0,0,0,0,0,0,0,20000,20000,0,0
053353,玉晶光兆豐97購03,0,0,0,0,0,0,0,0,0,0,0,0,0,668000,668000,0,0
053349,台郡國票97購02  ,29000,0,29000,0,0,0,0,0,0,-29000,0,0,0,0,29000,-29000,0
053560,漢唐國泰98購01  ,0,0,0,0,0,0,0,0,0,0,0,0,0,30000,30000,0,0
053502,智伸科兆豐97購01,0,0,0,0,0,0,0,0,0,0,0,0,0,50000,50000,0,0
052988,智易元大96購02  ,0,0,0,0,0,0,0,0,0,0,0,0,0,70000,70000,0,0
053023,泰鼎國泰97購01  ,0,0,0,0,0,0,0,0,0,0,0,0,0,2000,2000,0,0
053025,燿華富邦98購02  ,0,0,0,0,0,0,0,0,0,0,0,0,0,1000,1000,0,0
05299P,旺宏元大95售04  ,0,0,0,0,0,0,0,0,0,0,0,0,0,40000,40000,0,0
053129,緯穎凱基96購01  ,0,0,0,0,0,0,0,0,0,0,0,0,0,34000,34000,0,0
05388P,南亞科元大95售04,0,0,0,0,0,0,0,0,0,0,0,0,0,20000,20000,0,0
054059,欣興國票97購03  ,0,0,0,0,0,0,0,0,0,0,0,0,0,5000,5000,0,0
054152,漢唐國泰98購02  ,0,0,0,0,0,0,0,0,0,0,0,0,0,10000,10000,0,0
054260,貿聯元大96購03  ,0,0,0,0,0,0,0,0,0,0,0,0,0,68000,68000,0,0
054339,聯詠統一96購02  ,0,0,0,0,0,0,0,0,0,0,0,0,0,48000,48000,0,0
052581,訊芯元富98購01  ,0,0,0,0,0,0,0,0,0,0,0,0,0,10000,10000,0,0
053921,嘉晶國票97購03  ,0,0,0,0,0,0,0,0,0,0,0,0,0,200000,200000,0,0
053922,亞光國票96購01  ,0,0,0,0,0,0,0,0,0,0,0,0,0,5000,5000,0,0
053959,晶豪科永豐96購02,0,0,0,0,0,0,0,0,0,0,0,0,0,30000,30000,0,0
05395P,旺宏元大96售06  ,0,0,0,0,0,0,0,0,0,0,0,0,0,270000,270000,0,0
052266,義隆亞東95購02  ,0,0,0,0,0,0,0,0,0,0,0,0,0,30000,30000,0,0
05146P,鴻海元大95售10  ,0,0,0,0,0,0,0,0,0,0,0,0,0,156000,156000,0,0
051078,力山富邦97購01  ,0,0,0,0,0,0,0,0,0,0,0,0,0,100000,100000,0,0
051157,華新科富邦98購01,0,0,0,0,0,0,0,0,0,0,0,0,0,20000,20000,0,0
051152,鴻海國泰97購01  ,0,0,0,0,0,0,0,0,0,0,0,0,0,10000,10000,0,0
051153,鴻海國泰97購02  ,0,0,0,0,0,0,0,0,0,0,0,0,0,20000,20000,0,0
05133P,臺股指日盛95售01,0,0,0,0,0,0,0,0,0,0,0,0,0,50000,50000,0,0
05138P,嘉聯益凱基96售02,0,0,0,0,0,0,0,0,0,0,0,0,0,10000,10000,0,0
051988,台光電元大95購01,0,0,0,0,0,0,0,0,0,0,0,0,0,60000,60000,0,0
052026,漢唐群益95購01  ,0,0,0,0,0,0,0,0,0,0,0,0,0,10000,10000,0,0
05243P,鴻海元大95售19  ,0,0,0,0,0,0,0,0,0,0,0,0,0,124000,124000,0,0
05242P,群創國泰97售01  ,0,0,0,0,0,0,0,0,0,0,0,0,0,120000,120000,0,0
052076,可成元富98購01  ,0,0,0,0,0,0,0,0,0,0,0,0,0,15000,15000,0,0
052161,義隆永豐95購03  ,0,0,0,0,0,0,0,0,0,0,0,0,0,30000,30000,0,0
05219P,鴻海元大95售17  ,0,0,0,0,0,0,0,0,0,0,0,0,0,31000,31000,0,0
04929P,同欣電凱基95售01,0,0,0,0,0,0,0,0,0,0,0,0,0,8000,8000,0,0
049369,義隆元大95購01  ,0,0,0,0,0,0,0,0,0,0,0,0,0,80000,80000,0,0
049484,台積電元大95購02,0,0,0,0,0,0,0,0,0,0,0,0,0,200000,200000,0,0
048867,台積電兆豐95購01,0,0,0,0,0,0,0,0,0,0,0,0,0,10000,10000,0,0
04854P,鴻海國泰96售04  ,0,0,0,0,0,0,0,0,0,0,0,0,0,50000,50000,0,0
048798,華新科國泰95購01,0,0,0,0,0,0,0,0,0,0,0,0,0,5000,5000,0,0
00625K,富邦上証+R      ,0,0,0,0,0,0,0,0,0,0,0,0,0,50000,50000,0,0
00636K,國泰中國A50+U   ,0,0,0,0,0,0,0,0,0,0,0,0,0,100,100,0,0
00700,富邦恒生國企    ,0,0,0,0,0,0,0,0,0,0,0,0,0,100000,100000,0,0
00684R,元大美元指數反1 ,0,0,0,0,0,0,0,0,0,0,0,0,0,1000,1000,0,0
00666R,富邦恒生國企反1 ,1000,0,1000,0,0,0,0,0,0,-1000,0,0,0,0,1000,-1000,0
00668K,國泰美國道瓊+U  ,0,0,0,0,0,0,0,0,0,0,0,0,0,100,100,0,0
00657,國泰日經225     ,0,0,0,0,0,0,0,0,0,0,0,0,0,102000,102000,0,0
00657K,國泰日經225+U   ,0,0,0,0,0,0,0,0,0,0,0,0,0,100,100,0,0
00709,富邦歐洲        ,0,0,0,0,0,0,0,0,0,0,0,0,0,100000,100000,0,0
00711B,FH彭博新興債    ,0,0,0,0,0,0,0,0,0,0,0,0,0,100000,100000,0,0
00731,FH富時高息低波  ,3000,0,3000,0,0,0,0,0,0,-3000,0,0,0,10000,13000,-3000,0
00732,國泰RMB短期報酬 ,0,0,0,0,0,0,0,0,0,0,0,0,0,100000,100000,0,0
00774B,新光中國政金綠債,0,0,0,0,0,0,0,0,0,0,0,0,0,2000,2000,0,0
00775B,新光投等債15+   ,0,0,0,0,0,0,0,0,0,0,0,0,0,2000,2000,0,0
00743,國泰中國A150    ,0,0,0,0,0,0,0,0,0,0,0,0,0,1000,1000,0,0
020011,統一微波高息20N ,0,0,0,0,0,0,0,0,0,0,0,0,0,1000,1000,0,0
04826P,華新科麥證95售01,0,0,0,505000,0,505000,0,0,0,0,0,0,0,505000,505000,0,0
020015,統一MSCI美低波N ,0,0,0,0,0,0,0,0,0,0,0,0,0,1000,1000,0,0
020016,統一MSCI美科技N ,0,0,0,0,0,0,0,0,0,0,0,0,0,5000,5000,0,0
049595,麗豐元大95購01  ,0,0,0,0,0,0,0,0,0,0,0,0,0,58000,58000,0,0
045479,T50反1中信95購01,0,0,0,0,0,0,0,0,0,0,0,0,0,50000,50000,0,0
050161,鴻海國泰96購03  ,0,0,0,0,0,0,0,0,0,0,0,0,0,30000,30000,0,0
050261,國巨元大95購04  ,0,0,0,0,0,0,0,0,0,0,0,0,0,10000,10000,0,0
050333,鴻海國泰96購06  ,0,0,0,0,0,0,0,0,0,0,0,0,0,49000,49000,0,0
050387,鴻海統一94購08  ,0,0,0,0,0,0,0,0,0,0,0,0,0,318000,318000,0,0
050579,聯發科國票95購04,0,0,0,0,0,0,0,0,0,0,0,0,0,20000,20000,0,0
050491,旺宏國泰96購01  ,0,0,0,0,0,0,0,0,0,0,0,0,0,10000,10000,0,0
059997,華航元富99購01  ,0,0,0,0,0,0,0,0,0,0,0,0,0,10000,10000,0,0
059764,健策永豐99購04  ,0,0,0,0,0,0,0,0,0,0,0,0,0,10000,10000,0,0
059765,嘉聯益永豐99購02,0,0,0,0,0,0,0,0,0,0,0,0,0,17000,17000,0,0
060030,晶相光永豐99購03,0,0,0,0,0,0,0,0,0,0,0,0,0,3000,3000,0,0
06006P,欣興永豐96售04  ,0,0,0,0,0,0,0,0,0,0,0,0,0,27000,27000,0,0
060145,牧德國票9A購02  ,0,0,0,0,0,0,0,0,0,0,0,0,0,14000,14000,0,0
059594,奇力新元大9B購01,0,0,0,0,0,0,0,0,0,0,0,0,0,10000,10000,0,0
059585,台灣50元大9C購10,0,0,0,0,0,0,0,0,0,0,0,0,0,5000,5000,0,0
05756P,臺股指中信99售05,0,0,0,0,0,0,0,0,0,0,0,0,0,1000,1000,0,0
057506,聯鈞國票99購02  ,0,0,0,0,0,0,0,0,0,0,0,0,0,25000,25000,0,0
057444,台泥元富98購01  ,0,0,0,0,0,0,0,0,0,0,0,0,0,30000,30000,0,0
057495,牧德元大99購04  ,0,0,0,0,0,0,0,0,0,0,0,0,0,12000,12000,0,0
05748P,臺股指群益99售02,0,0,0,0,0,0,0,0,0,0,0,0,0,2000,2000,0,0
059028,嘉聯益台新99購02,0,0,0,0,0,0,0,0,0,0,0,0,0,98000,98000,0,0
057139,華新科兆豐98購02,0,0,0,0,0,0,0,0,0,0,0,0,0,10000,10000,0,0
057116,鴻海日盛9A購01  ,0,0,0,0,0,0,0,0,0,0,0,0,0,20000,20000,0,0
05582P,群創凱基98售06  ,0,0,0,0,0,0,0,0,0,0,0,0,0,36000,36000,0,0
056162,祥碩凱基97購03  ,0,0,0,0,0,0,0,0,0,0,0,0,0,2000,2000,0,0
056175,可成元富97購03  ,0,0,0,0,0,0,0,0,0,0,0,0,0,30000,30000,0,0
055911,可成凱基98購02  ,0,0,0,0,0,0,0,0,0,0,0,0,0,2000,2000,0,0
055943,瑞昱麥證97購01  ,0,0,0,1000,1000,0,0,0,0,0,0,0,0,1000,1000,0,0
055953,上銀元大97購09  ,0,0,0,0,0,0,0,0,0,0,0,0,0,50000,50000,0,0
056047,台積電兆豐97購02,0,0,0,0,0,0,0,0,0,0,0,0,0,10000,10000,0,0
055988,矽力元富97購01  ,0,0,0,0,0,0,0,0,0,0,0,0,0,10000,10000,0,0
05723P,華通永豐96售03  ,0,0,0,0,0,0,0,0,0,0,0,0,0,40000,40000,0,0
055695,大毅國票98購03  ,0,0,0,0,0,0,0,0,0,0,0,0,0,1000,1000,0,0
057313,聯發科麥證99購01,0,0,0,3000,3000,0,0,0,0,0,0,0,0,3000,3000,0,0
059237,鴻海凱基9A購10  ,0,0,0,0,0,0,0,0,0,0,0,0,0,7000,7000,0,0
059229,臺股指元大99購22,0,0,0,0,0,0,0,0,0,0,0,0,0,1000,1000,0,0
057376,新日興元大98購04,0,0,0,0,0,0,0,0,0,0,0,0,0,68000,68000,0,0
059247,可成凱基99購05  ,0,0,0,0,0,0,0,0,0,0,0,0,0,1000,1000,0,0
059211,鴻海元大99購27  ,0,0,0,0,0,0,0,0,0,0,0,0,0,220000,220000,0,0
058086,鴻海元大98購14  ,0,0,0,0,0,0,0,0,0,0,0,0,0,519000,519000,0,0
058087,鴻海元大98購15  ,0,0,0,0,0,0,0,0,0,0,0,0,0,280000,280000,0,0
058084,大立光群益98購04,0,0,0,0,0,0,0,0,0,0,0,0,0,10000,10000,0,0
058608,華新科元大99購13,0,0,0,0,0,0,0,0,0,0,0,0,0,1000,1000,0,0
057984,聯發科台新98購01,0,0,0,0,0,0,0,0,0,0,0,0,0,300000,300000,0,0
058044,鴻海元大99購07  ,0,0,0,0,0,0,0,0,0,0,0,0,0,62000,62000,0,0
058042,鴻海元大98購12  ,0,0,0,0,0,0,0,0,0,0,0,0,0,8000,8000,0,0
058078,景碩國票99購01  ,0,0,0,0,0,0,0,0,0,0,0,0,0,3000,3000,0,0
058998,鴻海元大99購22  ,0,0,0,0,0,0,0,0,0,0,0,0,0,4000,4000,0,0
058980,鴻海凱基99購06  ,0,0,0,0,0,0,0,0,0,0,0,0,0,219000,219000,0,0
056917,國巨兆豐98購03  ,0,0,0,0,0,0,0,0,0,0,0,0,0,10000,10000,0,0
05686P,臺股指元大96售11,0,0,0,0,0,0,0,0,0,0,0,0,0,1000,1000,0,0
056859,台積電群益98購02,0,0,0,0,0,0,0,0,0,0,0,0,0,260000,260000,0,0
056943,華通統一99購01  ,0,0,0,0,0,0,0,0,0,0,0,0,0,60000,60000,0,0
056944,鴻海統一98購11  ,0,0,0,0,0,0,0,0,0,0,0,0,0,1000,1000,0,0
058304,鴻海元大99購12  ,0,0,0,0,0,0,0,0,0,0,0,0,0,513000,513000,0,0
057047,華新科元大99購07,0,0,0,0,0,0,0,0,0,0,0,0,0,30000,30000,0,0
057045,美律元大99購04  ,0,0,0,0,0,0,0,0,0,0,0,0,0,5000,5000,0,0
057070,美律永豐98購02  ,0,0,0,0,0,0,0,0,0,0,0,0,0,10000,10000,0,0
058124,玉晶光國票9A購01,0,0,0,0,0,0,0,0,0,0,0,0,0,1000,1000,0,0
058194,勤誠永豐99購01  ,0,0,0,0,0,0,0,0,0,0,0,0,0,20000,20000,0,0
059199,欣興永豐99購02  ,0,0,0,0,0,0,0,0,0,0,0,0,0,10000,10000,0,0
059172,台郡凱基99購03  ,0,0,0,0,0,0,0,0,0,0,0,0,0,10000,10000,0,0
059129,麗豐中信99購01  ,0,0,0,0,0,0,0,0,0,0,0,0,0,10000,10000,0,0
057902,嘉晶永豐98購02  ,0,0,0,0,0,0,0,0,0,0,0,0,0,120000,120000,0,0
057910,華新科兆豐99購02,0,0,0,0,0,0,0,0,0,0,0,0,0,10000,10000,0,0
056657,華邦電元大99購01,0,0,0,0,0,0,0,0,0,0,0,0,0,15000,15000,0,0
056658,美食元大98購01  ,0,0,0,0,0,0,0,0,0,0,0,0,0,10000,10000,0,0
056644,宏達電凱基98購04,0,0,0,0,0,0,0,0,0,0,0,0,0,3000,3000,0,0
056636,台積電日盛9A購01,0,0,0,0,0,0,0,0,0,0,0,0,0,100000,100000,0,0
058792,鴻海元大99購18  ,0,0,0,0,0,0,0,0,0,0,0,0,0,218000,218000,0,0
056682,鴻海統一98購10  ,0,0,0,0,0,0,0,0,0,0,0,0,0,2000,2000,0,0
058816,祥碩台新99購02  ,0,0,0,0,0,0,0,0,0,0,0,0,0,10000,10000,0,0
058811,台積電統一9A購05,0,0,0,0,0,0,0,0,0,0,0,0,0,20000,20000,0,0
05842P,台積電元大96售15,0,0,0,0,0,0,0,0,0,0,0,0,0,10000,10000,0,0
058895,鴻海元大99購20  ,0,0,0,0,0,0,0,0,0,0,0,0,0,233000,233000,0,0
058883,旭富永豐99購01  ,0,0,0,0,0,0,0,0,0,0,0,0,0,10000,10000,0,0
058904,晶技元大99購05  ,0,0,0,0,0,0,0,0,0,0,0,0,0,2000,2000,0,0
05889P,群創元大98售02  ,0,0,0,0,0,0,0,0,0,0,0,0,0,60000,60000,0,0
056745,聯茂凱基99購03  ,0,0,0,0,0,0,0,0,0,0,0,0,0,1000,1000,0,0
056694,欣興群益98購04  ,0,0,0,0,0,0,0,0,0,0,0,0,0,1000,1000,0,0
059053,鴻海凱基99購07  ,0,0,0,0,0,0,0,0,0,0,0,0,0,32000,32000,0,0
056407,嘉晶國票99購01  ,0,0,0,0,0,0,0,0,0,0,0,0,0,31000,31000,0,0
056550,瑞儀凱基99購01  ,0,0,0,0,0,0,0,0,0,0,0,0,0,1000,1000,0,0
056491,南亞科國泰99購01,0,0,0,0,0,0,0,0,0,0,0,0,0,40000,40000,0,0
056574,亞光元大99購03  ,0,0,0,0,0,0,0,0,0,0,0,0,0,73000,73000,0,0
058700,鴻海元大99購15  ,0,0,0,0,0,0,0,0,0,0,0,0,0,11000,11000,0,0
058701,鴻海元大99購16  ,0,0,0,0,0,0,0,0,0,0,0,0,0,7000,7000,0,0
058502,鴻海元大99購13  ,0,0,0,0,0,0,0,0,0,0,0,0,0,8000,8000,0,0
058503,鴻海元大99購14  ,0,0,0,0,0,0,0,0,0,0,0,0,0,107000,107000,0,0
058743,可成康和99購01  ,0,0,0,0,0,0,0,0,0,0,0,0,0,10000,10000,0,0
058731,貿聯永豐99購02  ,0,0,0,0,0,0,0,0,0,0,0,0,0,1000,1000,0,0
058506,台積電元大99購09,0,0,0,0,0,0,0,0,0,0,0,0,0,200000,200000,0,0
059043,聯電日盛99購01  ,0,0,0,0,0,0,0,0,0,0,0,0,0,10000,10000,0,0
05924P,超眾元富96售04  ,0,0,0,0,0,0,0,0,0,0,0,0,0,539000,539000,0,0
059716,鴻海元大99購35  ,0,0,0,0,0,0,0,0,0,0,0,0,0,28000,28000,0,0
059325,超眾元大99購05  ,0,0,0,0,0,0,0,0,0,0,0,0,0,1000,1000,0,0
059331,台灣50國票9A購06,0,0,0,0,0,0,0,0,0,0,0,0,0,49000,49000,0,0
059317,台積電元大99購34,0,0,0,0,0,0,0,0,0,0,0,0,0,2000,2000,0,0
05992P,華通元大96售05  ,0,0,0,0,0,0,0,0,0,0,0,0,0,10000,10000,0,0
059794,滬深2X國票99購04,0,0,0,0,0,0,0,0,0,0,0,0,0,2000,2000,0,0
059795,鴻海國票99購07  ,0,0,0,0,0,0,0,0,0,0,0,0,0,2000,2000,0,0
059798,臺股指國票99購21,0,0,0,0,0,0,0,0,0,0,0,0,0,1000,1000,0,0
059828,健策凱基99購05  ,0,0,0,0,0,0,0,0,0,0,0,0,0,7000,7000,0,0
2906,高林            ,1000,1000,0,0,0,0,0,0,0,0,0,0,0,0,0,0,0
3054,立萬利          ,2000,2000,0,0,0,0,0,0,0,0,0,0,0,0,0,0,0
059415,台灣50元大9A購03,0,0,0,0,0,0,0,0,0,0,0,0,0,5000,5000,0,0
059409,台灣50國票9C購01,0,0,0,0,0,0,0,0,0,0,0,0,0,100000,100000,0,0
059392,臺股指凱基99購38,0,0,0,0,0,0,0,0,0,0,0,0,0,1000,1000,0,0
059376,國巨群益99購09  ,0,0,0,0,0,0,0,0,0,0,0,0,0,10000,10000,0,0
059491,國巨國票9A購05  ,0,0,0,0,0,0,0,0,0,0,0,0,0,2000,2000,0,0
059553,台灣50凱基99購05,0,0,0,0,0,0,0,0,0,0,0,0,0,20000,20000,0,0
059555,台灣50凱基9A購06,0,0,0,0,0,0,0,0,0,0,0,0,0,1000,1000,0,0
3383,新世紀          ,2000,2000,0,0,0,0,0,0,0,0,0,0,0,0,0,0,0
3593,力銘            ,2000,2000,0,0,0,0,0,0,0,0,0,0,0,0,0,0,0
5533,皇鼎            ,10000,7000,3000,0,0,0,0,0,0,-3000,0,3000,-3000,0,0,0,0
6431,光麗-KY         ,1000,1000,0,0,0,0,0,0,0,0,0,0,0,0,0,0,0
06043P,創意永豐96售06  ,0,0,0,0,0,0,0,0,0,-1000,0,0,0,30000,31000,-1000,-1000
060516,臺股指元大9B購13,0,0,0,0,0,0,0,0,0,-1000,0,0,0,0,1000,-1000,-1000
060613,T50反1元大9A購05,0,0,0,0,0,0,0,0,0,-1000,0,0,0,1000,2000,-1000,-1000
060768,鴻海麥證9A購02  ,0,0,0,0,1000,-1000,0,0,0,-1000,0,0,0,0,1000,-1000,-1000
060753,上銀元大9A購05  ,0,0,0,0,0,0,0,0,0,-1000,0,0,0,61000,62000,-1000,-1000
060331,台積電麥證9A購01,0,0,0,4000,5000,-1000,0,0,0,-1000,0,0,0,4000,5000,-1000,-1000
061082,台光電兆豐9A購01,0,0,0,0,0,0,0,0,0,-1000,0,0,0,0,1000,-1000,-1000
060726,聯發科第一9A購01,0,0,0,0,0,0,0,0,0,-1000,0,0,0,0,1000,-1000,-1000
060257,臺股指元大9B購08,0,0,0,0,0,0,0,0,0,-1000,0,0,0,0,1000,-1000,-1000
060692,鴻海麥證9A購01  ,0,0,0,0,1000,-1000,0,0,0,-1000,0,0,0,0,1000,-1000,-1000
060693,台積電麥證9A購02,0,0,0,5000,6000,-1000,0,0,0,-1000,0,0,0,5000,6000,-1000,-1000
061038,TPK永豐9A購01   ,0,0,0,0,0,0,0,0,0,-1000,0,0,0,35000,36000,-1000,-1000
060888,金像電統一9C購01,0,0,0,0,0,0,0,0,0,-1000,0,0,0,53000,54000,-1000,-1000
06256P,臺股指群益97售09,0,0,0,0,0,0,0,0,0,-1000,0,0,0,0,1000,-1000,-1000
06342P,世芯統一98售01  ,0,0,0,0,0,0,0,0,0,-1000,0,0,0,0,1000,-1000,-1000
06284P,台積電國票98售03,0,0,0,0,0,0,0,0,0,-1000,0,0,0,9000,10000,-1000,-1000
06273P,台表科凱基97售04,0,0,0,0,0,0,0,0,0,-1000,0,0,0,0,1000,-1000,-1000
06441P,台積電凱基98售08,0,0,0,0,0,0,0,0,0,-1000,0,0,0,10000,11000,-1000,-1000
06206P,台積電凱基97售11,0,0,0,0,0,0,0,0,0,-1000,0,0,0,0,1000,-1000,-1000
061376,瑞昱永豐9A購02  ,0,0,0,0,0,0,0,0,0,-1000,0,0,0,0,1000,-1000,-1000
061322,華新科凱基9A購12,0,0,0,0,0,0,0,0,0,-1000,0,0,0,0,1000,-1000,-1000
06711P,臺股指台新99售08,0,0,0,0,0,0,0,0,0,-1000,0,0,0,10000,11000,-1000,-1000
061135,聯發科統一9C購03,0,0,0,0,0,0,0,0,0,-1000,0,0,0,0,1000,-1000,-1000
06691P,臺股指群益9C售05,0,0,0,0,0,0,0,0,0,-1000,0,0,0,0,1000,-1000,-1000
06737P,台郡凱基98售07  ,0,0,0,0,0,0,0,0,0,-1000,0,0,0,2000,3000,-1000,-1000
06501P,臺股指元大9A售06,0,0,0,0,0,0,0,0,0,-1000,0,0,0,4000,5000,-1000,-1000
06459P,亞德客元富98售01,0,0,0,0,0,0,0,0,0,-1000,0,0,0,0,1000,-1000,-1000
06865P,亞德客元大98售04,0,0,0,0,0,0,0,0,0,-1000,0,0,0,0,1000,-1000,-1000
06869P,金融類元大99售01,0,0,0,0,0,0,0,0,0,-1000,0,0,0,1000,2000,-1000,-1000
07183P,臺股指凱基99售25,0,0,0,0,0,0,0,0,0,-1000,0,0,0,0,1000,-1000,-1000
06980P,緯穎永豐99售02  ,0,0,0,0,0,0,0,0,0,-1000,0,0,0,129000,130000,-1000,-1000
07046P,大立光富邦9C售03,0,0,0,0,0,0,0,0,0,-1000,0,0,0,0,1000,-1000,-1000
07309P,聯發科凱基99售18,0,0,0,0,0,0,0,0,0,-1000,0,0,0,0,1000,-1000,-1000
07391P,台灣50國泰02售01,0,0,0,0,0,0,0,0,0,-1000,0,0,0,13000,14000,-1000,-1000
07387P,臺股指群益99售25,0,0,0,0,0,0,0,0,0,-1000,0,0,0,0,1000,-1000,-1000
07440P,臺股指麥證9B售02,0,0,0,0,1000,-1000,0,0,0,-1000,0,0,0,0,1000,-1000,-1000
07429P,臺股指國票9A售01,0,0,0,0,0,0,0,0,0,-1000,0,0,0,0,1000,-1000,-1000
07420P,可成元大99售07  ,0,0,0,0,0,0,0,0,0,-1000,0,0,0,123000,124000,-1000,-1000
07537P,玉晶光元富9A售04,0,0,0,0,0,0,0,0,0,-1000,0,0,0,4000,5000,-1000,-1000
07538P,玉晶光元富9A售05,0,0,0,0,0,0,0,0,0,-1000,0,0,0,0,1000,-1000,-1000
07508P,華新科國票9A售03,0,0,0,0,0,0,0,0,0,-1000,0,0,0,0,1000,-1000,-1000
07452P,國巨元大9A售05  ,0,0,0,0,0,0,0,0,0,-1000,0,0,0,0,1000,-1000,-1000
07484P,台灣50凱基04售02,0,0,0,0,0,0,0,0,0,-1000,0,0,0,0,1000,-1000,-1000
07577P,華新科元大9A售09,0,0,0,0,0,0,0,0,0,-1000,0,0,0,40000,41000,-1000,-1000
1341,富林-KY         ,0,1000,-1000,0,0,0,0,0,0,0,0,0,0,0,0,0,-1000
1410,南染            ,2000,3000,-1000,0,0,0,0,0,0,0,0,0,0,0,0,0,-1000
1725,元禎            ,0,1000,-1000,0,0,0,0,0,0,0,0,0,0,0,0,0,-1000
2007,燁興            ,0,0,0,0,0,0,0,0,0,-1000,0,1000,-1000,0,0,0,-1000
2008,高興昌          ,0,0,0,0,0,0,0,0,0,-1000,0,1000,-1000,0,0,0,-1000
1805,寶徠            ,0,1000,-1000,0,0,0,0,0,0,0,0,0,0,0,0,0,-1000
1539,巨庭            ,0,1000,-1000,0,0,0,0,0,0,0,0,0,0,0,0,0,-1000
1516,川飛            ,1000,2000,-1000,0,0,0,0,0,0,0,0,0,0,0,0,0,-1000
1521,大億            ,2000,3000,-1000,0,0,0,0,0,0,0,0,0,0,0,0,0,-1000
2527,宏璟            ,32000,33000,-1000,0,0,0,0,0,0,0,0,0,0,0,0,0,-1000
8103,瀚荃            ,17000,18000,-1000,0,0,0,0,0,0,0,0,0,0,0,0,0,-1000
8367,建新國際        ,9000,8000,1000,0,0,0,0,0,0,-2000,0,2000,-2000,0,0,0,-1000
8442,威宏-KY         ,0,1000,-1000,0,0,0,0,0,0,0,0,0,0,0,0,0,-1000
050783,旺宏國泰96購02  ,0,0,0,0,0,0,0,0,0,-1000,0,0,0,0,1000,-1000,-1000
05014P,臺股指元大95售05,0,0,0,0,0,0,0,0,0,-1000,0,0,0,0,1000,-1000,-1000
04983P,臺股指康和94售03,0,0,0,0,0,0,0,0,0,-1000,0,0,0,0,1000,-1000,-1000
04984P,臺股指康和94售04,0,0,0,0,0,0,0,0,0,-1000,0,0,0,2797000,2798000,-1000,-1000
04433P,上証2X國票95售01,0,0,0,0,0,0,0,0,0,-1000,0,0,0,0,1000,-1000,-1000
04198P,滬深2X群益95售04,0,0,0,0,0,0,0,0,0,-1000,0,0,0,0,1000,-1000,-1000
042793,台積電台新9C購01,0,0,0,0,0,0,0,0,0,-1000,0,0,0,0,1000,-1000,-1000
04964P,鴻海元大94售26  ,0,0,0,0,0,0,0,0,0,-1000,0,0,0,0,1000,-1000,-1000
047024,奇力新元大95購01,0,0,0,0,0,0,0,0,0,-1000,0,0,0,0,1000,-1000,-1000
046949,群創元大99購01  ,0,0,0,0,0,0,0,0,0,-1000,0,0,0,0,1000,-1000,-1000
03012X,元展12          ,0,0,0,0,0,0,0,0,0,-1000,0,0,0,0,1000,-1000,-1000
01004T,土銀富邦R2      ,0,1000,-1000,0,0,0,0,0,0,0,0,0,0,0,0,0,-1000
00742,新光內需收益    ,0,0,0,0,0,0,0,0,0,-1000,0,0,0,100000,101000,-1000,-1000
00771,元大US高息特別股,0,0,0,0,0,0,0,0,0,-1000,0,0,0,10000,11000,-1000,-1000
006204,永豐臺灣加權    ,0,0,0,0,0,0,0,0,0,-1000,0,0,0,0,1000,-1000,-1000
04866P,台積電統一95售02,0,0,0,0,0,0,0,0,0,-1000,0,0,0,0,1000,-1000,-1000
04947P,聯詠元大94售05  ,0,0,0,0,0,0,0,0,0,-1000,0,0,0,0,1000,-1000,-1000
035275,台積電台新97購01,0,0,0,0,0,0,0,0,0,-1000,0,0,0,1000,2000,-1000,-1000
052222,力山凱基95購02  ,0,0,0,0,0,0,0,0,0,-1000,0,0,0,0,1000,-1000,-1000
05211P,國巨國票96售05  ,0,0,0,0,0,0,0,0,0,-1000,0,0,0,0,1000,-1000,-1000
050907,臺股指元大95購14,0,0,0,0,0,0,0,0,0,-1000,0,0,0,0,1000,-1000,-1000
051508,元黃金中信97購01,0,0,0,0,0,0,0,0,0,-1000,0,0,0,0,1000,-1000,-1000
051544,T50反1康和98購01,0,0,0,0,0,0,0,0,0,-1000,0,0,0,0,1000,-1000,-1000
052269,T50反1日盛9B購01,0,0,0,0,0,0,0,0,0,-1000,0,0,0,0,1000,-1000,-1000
052512,全新凱基96購03  ,0,0,0,0,0,0,0,0,0,-1000,0,0,0,0,1000,-1000,-1000
052521,友達元大9B購01  ,0,0,0,0,0,0,0,0,0,-1000,0,0,0,0,1000,-1000,-1000
054281,世芯群益97購01  ,0,0,0,0,0,0,0,0,0,-1000,0,0,0,2000,3000,-1000,-1000
054264,超眾元大97購02  ,0,0,0,0,0,0,0,0,0,-1000,0,0,0,0,1000,-1000,-1000
05424P,台達電亞東96售02,0,0,0,0,0,0,0,0,0,-1000,0,0,0,0,1000,-1000,-1000
05298P,上銀元大95售03  ,0,0,0,0,0,0,0,0,0,-1000,0,0,0,0,1000,-1000,-1000
053597,牧德元大99購01  ,0,0,0,0,0,0,0,0,0,-1000,0,0,0,0,1000,-1000,-1000
053635,技嘉永豐96購01  ,0,0,0,0,0,0,0,0,0,-1000,0,0,0,0,1000,-1000,-1000
055542,亞德客凱基97購01,0,0,0,0,0,0,0,0,0,-1000,0,0,0,0,1000,-1000,-1000
053398,和鑫中信99購01  ,0,0,0,0,0,0,0,0,0,-1000,0,0,0,0,1000,-1000,-1000
056302,大立光元大97購17,0,0,0,0,0,0,0,0,0,-1000,0,0,0,1000,2000,-1000,-1000
057697,國巨群益98購09  ,0,0,0,0,0,0,0,0,0,-1000,0,0,0,0,1000,-1000,-1000
054378,楠梓電群益98購01,0,0,0,0,0,0,0,0,0,-1000,0,0,0,40000,41000,-1000,-1000
054680,華新科康和97購02,0,0,0,0,0,0,0,0,0,-1000,0,0,0,0,1000,-1000,-1000
05485P,旺宏凱基95售08  ,0,0,0,0,0,0,0,0,0,-1000,0,0,0,15000,16000,-1000,-1000
054844,華邦電兆豐98購01,0,0,0,0,0,0,0,0,0,-1000,0,0,0,0,1000,-1000,-1000
054924,景碩凱基98購01  ,0,0,0,0,0,0,0,0,0,-1000,0,0,0,0,1000,-1000,-1000
055217,緯創凱基97購02  ,0,0,0,0,0,0,0,0,0,-1000,0,0,0,49000,50000,-1000,-1000
054962,玉晶光元大99購02,0,0,0,0,0,0,0,0,0,-1000,0,0,0,0,1000,-1000,-1000
054964,智易元大99購01  ,0,0,0,0,0,0,0,0,0,-1000,0,0,0,0,1000,-1000,-1000
054996,聯陽元富97購01  ,0,0,0,0,0,0,0,0,0,-1000,0,0,0,0,1000,-1000,-1000
055364,矽創凱基97購03  ,0,0,0,0,0,0,0,0,0,-1000,0,0,0,0,1000,-1000,-1000
052784,緯穎國票97購02  ,0,0,0,0,0,0,0,0,0,-1000,0,0,0,0,1000,-1000,-1000
052753,電子類元大96購02,0,0,0,0,0,0,0,0,0,-1000,0,0,0,0,1000,-1000,-1000
05539P,鎧勝永豐96售01  ,0,0,0,0,0,0,0,0,0,-1000,0,0,0,0,1000,-1000,-1000
055440,矽力國票98購01  ,0,0,0,0,0,0,0,0,0,-1000,0,0,0,0,1000,-1000,-1000
052963,智邦凱基96購02  ,0,0,0,0,0,0,0,0,0,-1000,0,0,0,1000,2000,-1000,-1000
052681,T50反1元大98購02,0,0,0,0,0,0,0,0,0,-1000,0,0,0,0,1000,-1000,-1000
05515P,台積電群益96售03,0,0,0,0,0,0,0,0,0,-1000,0,0,0,180000,181000,-1000,-1000
059012,臺股指元大9A購31,0,0,0,0,0,0,0,0,0,-1000,0,0,0,5000,6000,-1000,-1000
058709,臺股指元大9A購22,0,0,0,0,0,0,0,0,0,-1000,0,0,0,0,1000,-1000,-1000
058717,南電台新99購02  ,0,0,0,0,0,0,0,0,0,-1000,0,0,0,0,1000,-1000,-1000
056562,奇力新群益98購01,0,0,0,0,0,0,0,0,0,-1000,0,0,0,0,1000,-1000,-1000
056584,鴻海統一9B購01  ,0,0,0,0,0,0,0,0,0,-1000,0,0,0,0,1000,-1000,-1000
056419,欣興元富98購02  ,0,0,0,0,0,0,0,0,0,-1000,0,0,0,0,1000,-1000,-1000
056457,嘉澤凱基98購01  ,0,0,0,0,0,0,0,0,0,-1000,0,0,0,0,1000,-1000,-1000
058865,群創凱基01購01  ,0,0,0,0,0,0,0,0,0,-1000,0,0,0,0,1000,-1000,-1000
058897,國巨元大99購17  ,0,0,0,0,0,0,0,0,0,-1000,0,0,0,0,1000,-1000,-1000
056691,元油2X群益9B購01,0,0,0,0,0,0,0,0,0,-1000,0,0,0,0,1000,-1000,-1000
056642,旺宏凱基98購07  ,0,0,0,0,0,0,0,0,0,-1000,0,0,0,9000,10000,-1000,-1000
059109,台積電富邦9C購03,0,0,0,0,0,0,0,0,0,-1000,0,0,0,0,1000,-1000,-1000
059091,中信金元大99購01,0,0,0,0,0,0,0,0,0,-1000,0,0,0,0,1000,-1000,-1000
058235,大立光元大99購08,0,0,0,0,0,0,0,0,0,-1000,0,0,0,0,1000,-1000,-1000
058242,玉晶光元大9A購01,0,0,0,0,0,0,0,0,0,-1000,0,0,0,0,1000,-1000,-1000
056938,泰碩元富98購01  ,0,0,0,0,0,0,0,0,0,-1000,0,0,0,0,1000,-1000,-1000
056989,鴻海兆豐98購02  ,0,0,0,0,0,0,0,0,0,-1000,0,0,0,1000,2000,-1000,-1000
056895,技嘉元大98購01  ,0,0,0,0,0,0,0,0,0,-1000,0,0,0,0,1000,-1000,-1000
058961,台灣50兆豐9C購01,0,0,0,0,0,0,0,0,0,-1000,0,0,0,0,1000,-1000,-1000
058615,矽創元大99購01  ,0,0,0,0,0,0,0,0,0,-1000,0,0,0,0,1000,-1000,-1000
057947,和碩國票99購01  ,0,0,0,0,0,0,0,0,0,-1000,0,0,0,0,1000,-1000,-1000
057306,玉晶光兆豐99購01,0,0,0,0,0,0,0,0,0,-1000,0,0,0,0,1000,-1000,-1000
057303,喬山兆豐99購01  ,0,0,0,0,0,0,0,0,0,-1000,0,0,0,0,1000,-1000,-1000
057335,技嘉國票99購01  ,0,0,0,0,0,0,0,0,0,-1000,0,0,0,0,1000,-1000,-1000
057178,可成元大98購03  ,0,0,0,0,0,0,0,0,0,-1000,0,0,0,0,1000,-1000,-1000
055690,矽力凱基97購02  ,0,0,0,0,0,0,0,0,0,-1000,0,0,0,0,1000,-1000,-1000
05570P,聯發科統一96售04,0,0,0,0,0,0,0,0,0,-1000,0,0,0,0,1000,-1000,-1000
055644,致茂元富97購01  ,0,0,0,0,0,0,0,0,0,-1000,0,0,0,0,1000,-1000,-1000
057222,鴻海國票99購04  ,0,0,0,0,0,0,0,0,0,-1000,0,0,0,0,1000,-1000,-1000
055728,緯穎元大97購03  ,0,0,0,0,0,0,0,0,0,-1000,0,0,0,0,1000,-1000,-1000
055934,景碩群益98購03  ,0,0,0,0,0,0,0,0,0,-1000,0,0,0,1000,2000,-1000,-1000
05605P,嘉聯益元大97售02,0,0,0,0,0,0,0,0,0,-1000,0,0,0,0,1000,-1000,-1000
057134,茂林凱基98購02  ,0,0,0,0,0,0,0,0,0,-1000,0,0,0,199000,200000,-1000,-1000
057515,智原元富98購02  ,0,0,0,0,0,0,0,0,0,-1000,0,0,0,0,1000,-1000,-1000
057557,聯茂凱基99購04  ,0,0,0,0,0,0,0,0,0,-1000,0,0,0,0,1000,-1000,-1000
059299,欣興元富99購03  ,0,0,0,0,0,0,0,0,0,-1000,0,0,0,2000,3000,-1000,-1000
059611,台積電永豐99購05,0,0,0,0,0,0,0,0,0,-1000,0,0,0,12000,13000,-1000,-1000
060133,牧德群益9B購01  ,0,0,0,0,0,0,0,0,0,-1000,0,0,0,19000,20000,-1000,-1000
060105,牧德元大9B購01  ,0,0,0,0,0,0,0,0,0,-1000,0,0,0,9000,10000,-1000,-1000
060045,嘉晶群益99購02  ,0,0,0,0,0,0,0,0,0,-1000,0,0,0,0,1000,-1000,-1000
059751,華通群益9B購03  ,0,0,0,0,0,0,0,0,0,-1000,0,0,0,0,1000,-1000,-1000
6442,光聖            ,2000,3000,-1000,0,0,0,0,0,0,0,0,0,0,0,0,0,-1000
4999,鑫禾            ,12000,10000,2000,0,0,0,0,0,0,-3000,0,3000,-3000,0,0,0,-1000
5484,慧友            ,2000,2000,0,0,0,0,0,0,0,-1000,0,1000,-1000,0,0,0,-1000
3308,聯德            ,2000,3000,-1000,0,0,0,0,0,0,0,0,0,0,0,0,0,-1000
3051,力特            ,0,0,0,0,0,0,0,0,0,-1000,0,1000,-1000,0,0,0,-1000
4807,日成-KY         ,0,1000,-1000,0,0,0,0,0,0,0,0,0,0,0,0,0,-1000
4119,旭富            ,239000,242000,-3000,0,0,0,0,1000,-1000,3000,0,1000,-1000,13000,9000,4000,-1000
059575,臺股指凱基99購41,0,0,0,0,0,0,0,0,0,-1000,0,0,0,5000,6000,-1000,-1000
3021,鴻名            ,4000,5000,-1000,0,0,0,0,0,0,0,0,0,0,0,0,0,-1000
2882B,國泰金乙特      ,0,0,0,0,0,0,0,0,0,-1000,0,1000,-1000,0,0,0,-1000
059811,高股息凱基99購02,0,0,0,0,0,0,0,0,0,-1000,0,0,0,0,1000,-1000,-1000
8488,吉源-KY         ,1000,2000,-1000,0,0,0,0,0,0,0,0,0,0,0,0,0,-1000
059936,台積電永豐99購06,0,0,0,0,0,0,0,0,0,-1000,0,0,0,1000,2000,-1000,-1000
059939,技嘉永豐99購01  ,0,0,0,0,0,0,0,0,0,-1000,0,0,0,0,1000,-1000,-1000
059657,華通元大99購09  ,0,0,0,0,0,0,0,0,0,-1000,0,0,0,0,1000,-1000,-1000
059341,台積電凱基99購15,0,0,0,0,0,0,0,0,0,-1000,0,0,0,1000,2000,-1000,-1000
6525,捷敏-KY         ,16200,18000,-1800,0,0,0,0,0,0,0,0,0,0,0,0,0,-1800
9946,三發地產        ,0,2000,-2000,0,0,0,0,0,0,0,0,0,0,0,0,0,-2000
8072,陞泰            ,0,1000,-1000,0,0,0,0,0,0,-1000,0,1000,-1000,0,0,0,-2000
2465,麗臺            ,0,2000,-2000,0,0,0,0,0,0,0,0,0,0,0,0,0,-2000
2497,怡利電          ,0,1000,-1000,0,0,0,0,0,0,-1000,0,1000,-1000,0,0,0,-2000
2419,仲琦            ,65000,66000,-1000,0,0,0,0,0,0,-1000,0,1000,-1000,0,0,0,-2000
2440,太空梭          ,3000,6000,-3000,0,0,0,0,0,0,1000,1000,0,1000,0,0,0,-2000
1456,怡華            ,2000,4000,-2000,0,0,0,0,0,0,0,0,0,0,0,0,0,-2000
1443,立益            ,3000,5000,-2000,0,0,0,0,0,0,0,0,0,0,0,0,0,-2000
1466,聚隆            ,1000,3000,-2000,0,0,0,0,0,0,0,0,0,0,0,0,0,-2000
1583,程泰            ,2000,4000,-2000,0,0,0,0,0,0,0,0,0,0,0,0,0,-2000
1529,樂士            ,1000,6000,-5000,0,0,0,0,0,0,3000,3000,0,3000,0,0,0,-2000
2009,第一銅          ,12000,14000,-2000,0,0,0,0,0,0,0,0,0,0,0,0,0,-2000
1776,展宇            ,1000,3000,-2000,0,0,0,0,0,0,0,0,0,0,0,0,0,-2000
1735,日勝化          ,0,2000,-2000,0,0,0,0,0,0,0,0,0,0,0,0,0,-2000
1414,東和            ,5000,5000,0,0,0,0,0,0,0,-2000,0,2000,-2000,0,0,0,-2000
07564P,臺股指中信01售01,0,0,0,0,0,0,0,0,0,-2000,0,0,0,0,2000,-2000,-2000
07476P,鴻海群益9A售04  ,0,0,0,0,0,0,0,0,0,-2000,0,0,0,0,2000,-2000,-2000
07533P,臺股指中信9C售04,0,0,0,0,0,0,0,0,0,-2000,0,0,0,0,2000,-2000,-2000
07524P,臺股指中信9B售06,0,0,0,0,0,0,0,0,0,-2000,0,0,0,0,2000,-2000,-2000
07417P,聯發科元大99售44,0,0,0,0,0,0,0,0,0,-2000,0,0,0,47000,49000,-2000,-2000
07394P,國巨群益99售12  ,0,0,0,0,0,0,0,0,0,-2000,0,0,0,0,2000,-2000,-2000
07289P,台灣50凱基99售07,0,0,0,0,0,0,0,0,0,-2000,0,0,0,18000,20000,-2000,-2000
07089P,臺指2X中信01售01,0,0,0,0,0,0,0,0,0,-2000,0,0,0,0,2000,-2000,-2000
07045P,上銀國票9A售01  ,0,0,0,0,0,0,0,0,0,-2000,0,0,0,0,2000,-2000,-2000
06809P,電子類群益98售03,0,0,0,0,0,0,0,0,0,-2000,0,0,0,0,2000,-2000,-2000
06838P,台積電統一99售05,0,0,0,0,0,0,0,0,0,-2000,0,0,0,4000,6000,-2000,-2000
061207,美律元大9A購04  ,0,0,0,0,0,0,0,0,0,-2000,0,0,0,51000,53000,-2000,-2000
061366,台勝科國票9A購01,0,0,0,0,0,0,0,0,0,-2000,0,0,0,0,2000,-2000,-2000
061335,國巨元大9A購19  ,0,0,0,0,0,0,0,0,0,-2000,0,0,0,0,2000,-2000,-2000
06166P,大立光國票98售01,0,0,0,0,0,0,0,0,0,-2000,0,0,0,0,2000,-2000,-2000
061389,華新科群益9B購01,0,0,0,0,0,0,0,0,0,-2000,0,0,0,0,2000,-2000,-2000
06262P,國巨凱基97售07  ,0,0,0,0,0,0,0,0,0,-2000,0,0,0,0,2000,-2000,-2000
06102P,智邦凱基97售03  ,0,0,0,0,0,0,0,0,0,-2000,0,0,0,0,2000,-2000,-2000
061060,台灣50麥證9B購01,0,0,0,0,2000,-2000,0,0,0,-2000,0,0,0,0,2000,-2000,-2000
061071,復盛凱基9A購01  ,0,0,0,0,0,0,0,0,0,-2000,0,0,0,0,2000,-2000,-2000
060344,聯發科統一01購01,0,0,0,0,0,0,0,0,0,-2000,0,0,0,3000,5000,-2000,-2000
060394,欣興麥證9A購01  ,0,0,0,4000,6000,-2000,0,0,0,-2000,0,0,0,4000,6000,-2000,-2000
060751,高股息元大9B購01,0,0,0,0,0,0,0,0,0,-2000,0,0,0,0,2000,-2000,-2000
052724,力成統一97購01  ,0,0,0,0,0,0,0,0,0,-2000,0,0,0,0,2000,-2000,-2000
052703,貿聯國票97購01  ,0,0,0,0,0,0,0,0,0,-2000,0,0,0,36000,38000,-2000,-2000
052882,南電凱基96購02  ,0,0,0,0,0,0,0,0,0,-2000,0,0,0,5000,7000,-2000,-2000
054845,智邦兆豐98購01  ,0,0,0,0,0,0,0,0,0,-2000,0,0,0,13000,15000,-2000,-2000
054859,鴻海群益97購02  ,0,0,0,0,0,0,0,0,0,-2000,0,0,0,0,2000,-2000,-2000
054756,世紀鋼凱基99購01,0,0,0,0,0,0,0,0,0,-2000,0,0,0,0,2000,-2000,-2000
054385,矽創群益98購01  ,0,0,0,0,0,0,0,0,0,-2000,0,0,0,0,2000,-2000,-2000
057714,聯發科統一98購05,0,0,0,0,0,0,0,0,0,-2000,0,0,0,5000,7000,-2000,-2000
053266,全新群益98購01  ,0,0,0,0,0,0,0,0,0,-2000,0,0,0,0,2000,-2000,-2000
058662,禾伸堂兆豐99購01,0,0,0,0,0,0,0,0,0,-2000,0,0,0,46000,48000,-2000,-2000
057831,聯發科元富02購04,0,0,0,0,0,0,0,0,0,-2000,0,0,0,24000,26000,-2000,-2000
058362,聯發科凱基99購06,0,0,0,0,0,0,0,0,0,-2000,0,0,0,0,2000,-2000,-2000
053668,鴻海統一97購01  ,0,0,0,0,0,0,0,0,0,-2000,0,0,0,0,2000,-2000,-2000
053759,晶相光國泰98購01,0,0,0,0,0,0,0,0,0,-2000,0,0,0,0,2000,-2000,-2000
053884,緯穎第一96購01  ,0,0,0,0,0,0,0,0,0,-2000,0,0,0,0,2000,-2000,-2000
054189,貿聯永豐96購03  ,0,0,0,0,0,0,0,0,0,-2000,0,0,0,18000,20000,-2000,-2000
054310,牧德凱基98購01  ,0,0,0,0,0,0,0,0,0,-2000,0,0,0,0,2000,-2000,-2000
054169,上緯控凱基98購01,0,0,0,0,0,0,0,0,0,-2000,0,0,0,1000,3000,-2000,-2000
052325,高股息中信99購01,0,0,0,0,0,0,0,0,0,-2000,0,0,0,1000,3000,-2000,-2000
051690,超眾凱基95購03  ,0,0,0,0,0,0,0,0,0,-2000,0,0,0,10000,12000,-2000,-2000
051101,台表科元大96購02,0,0,0,0,0,0,0,0,0,-2000,0,0,0,0,2000,-2000,-2000
051292,牧德統一97購01  ,0,0,0,0,0,0,0,0,0,-2000,0,0,0,1000,3000,-2000,-2000
04872P,高股息中信94售01,0,0,0,0,0,0,0,0,0,-2000,0,0,0,0,2000,-2000,-2000
048583,智原富邦98購01  ,0,0,0,0,0,0,0,0,0,-2000,0,0,0,0,2000,-2000,-2000
0051,元大中型100     ,0,0,0,0,0,0,0,0,0,-2000,0,0,0,3000,5000,-2000,-2000
00774C,新光中政金綠債+R,0,0,0,0,0,0,0,0,0,-2000,0,0,0,0,2000,-2000,-2000
020004,兆豐電菁英30N   ,0,0,0,0,0,0,0,0,0,-2000,0,0,0,0,2000,-2000,-2000
04289P,臺股指中信95售07,0,0,0,0,0,0,0,0,0,-2000,0,0,0,2000,4000,-2000,-2000
04495P,台積電國票95售01,0,0,0,0,0,0,0,0,0,-2000,0,0,0,80000,82000,-2000,-2000
05996P,華新科群益96售03,0,0,0,0,0,0,0,0,0,-2000,0,0,0,0,2000,-2000,-2000
059979,台積電元大99購49,0,0,0,0,0,0,0,0,0,-2000,0,0,0,10000,12000,-2000,-2000
060149,元金2X富邦04購01,0,0,0,0,0,0,0,0,0,-2000,0,0,0,0,2000,-2000,-2000
057630,茂林永豐98購01  ,0,0,0,0,0,0,0,0,0,-2000,0,0,0,0,2000,-2000,-2000
057462,光磊永豐98購02  ,0,0,0,0,0,0,0,0,0,-2000,0,0,0,55000,57000,-2000,-2000
05757P,旺宏永豐96售03  ,0,0,0,0,0,0,0,0,0,-2000,0,0,0,0,2000,-2000,-2000
056208,崇越永豐97購01  ,0,0,0,0,0,0,0,0,0,-2000,0,0,0,0,2000,-2000,-2000
055576,嘉晶統一98購01  ,0,0,0,0,0,0,0,0,0,-2000,0,0,0,0,2000,-2000,-2000
057261,瑞昱兆豐98購01  ,0,0,0,0,0,0,0,0,0,-2000,0,0,0,0,2000,-2000,-2000
057363,華通元大99購02  ,0,0,0,0,0,0,0,0,0,-2000,0,0,0,9000,11000,-2000,-2000
058997,鴻海元大99購21  ,0,0,0,0,0,0,0,0,0,-2000,0,0,0,194000,196000,-2000,-2000
056905,欣興元大98購03  ,0,0,0,0,0,0,0,0,0,-2000,0,0,0,54000,56000,-2000,-2000
056863,義隆群益98購01  ,0,0,0,0,0,0,0,0,0,-2000,0,0,0,7000,9000,-2000,-2000
059136,臺股指群益99購11,0,0,0,0,0,0,0,0,0,-2000,0,0,0,0,2000,-2000,-2000
055863,緯穎元大97購05  ,0,0,0,0,0,0,0,0,0,-2000,0,0,0,0,2000,-2000,-2000
058158,台積電台新99購01,0,0,0,0,0,0,0,0,0,-2000,0,0,0,8000,10000,-2000,-2000
05790P,臺股指永昌96售07,0,0,0,0,0,0,0,0,0,-2000,0,0,0,0,2000,-2000,-2000
056675,聯發科元富02購01,0,0,0,0,0,0,0,0,0,-2000,0,0,0,0,2000,-2000,-2000
058804,T50反1統一9B購01,0,0,0,0,0,0,0,0,0,-2000,0,0,0,0,2000,-2000,-2000
058454,嘉晶永豐99購01  ,0,0,0,0,0,0,0,0,0,-2000,0,0,0,31000,33000,-2000,-2000
056435,台積電凱基98購09,0,0,0,0,0,0,0,0,0,-2000,0,0,0,2000,4000,-2000,-2000
057842,緯穎富邦99購02  ,0,0,0,0,0,0,0,0,0,-2000,0,0,0,0,2000,-2000,-2000
058744,FBVIX凱基9C購03 ,0,0,0,0,0,0,0,0,0,-2000,0,0,0,0,2000,-2000,-2000
05849P,臺股指元大96售25,0,0,0,0,0,0,0,0,0,-2000,0,0,0,0,2000,-2000,-2000
05851P,力山群益97售01  ,0,0,0,0,0,0,0,0,0,-2000,0,0,0,0,2000,-2000,-2000
6573,虹揚-KY         ,0,2000,-2000,0,0,0,0,0,0,0,0,0,0,0,0,0,-2000
6165,捷泰            ,24000,26000,-2000,0,0,0,0,0,0,0,0,0,0,0,0,0,-2000
6117,迎廣            ,1000,3000,-2000,0,0,0,0,0,0,0,0,0,0,0,0,0,-2000
4148,全宇生技-KY     ,0,2000,-2000,0,0,0,0,0,0,0,0,0,0,0,0,0,-2000
4764,雙鍵            ,0,2000,-2000,0,0,0,0,0,0,0,0,0,0,0,0,0,-2000
4562,穎漢            ,0,2000,-2000,0,0,0,0,0,0,0,0,0,0,0,0,0,-2000
3209,全科            ,17000,18000,-1000,0,0,0,0,0,0,-1000,0,1000,-1000,0,0,0,-2000
3229,晟鈦            ,2000,4000,-2000,0,0,0,0,0,0,0,0,0,0,0,0,0,-2000
059342,聯發科凱基9A購05,0,0,0,0,0,0,0,0,0,-2000,0,0,0,0,2000,-2000,-2000
059934,華通永豐99購02  ,0,0,0,0,0,0,0,0,0,-2000,0,0,0,0,2000,-2000,-2000
8940,新天地          ,0,2000,-2000,0,0,0,0,0,0,0,0,0,0,0,0,0,-2000
8467,波力-KY         ,0,2000,-2000,0,0,0,0,0,0,0,0,0,0,0,0,0,-2000
9930,中聯資源        ,7000,8000,-1000,0,0,0,0,0,0,-1000,0,1000,-1000,0,0,0,-2000
2936,客思達-KY       ,2000,3000,-1000,0,0,0,0,0,0,-1000,0,1000,-1000,0,0,0,-2000
3010,華立            ,29000,27000,2000,0,0,0,0,1000,-1000,-3000,0,3000,-3000,0,0,0,-2000
2888A,新光金甲特      ,0,2000,-2000,0,0,0,0,0,0,0,0,0,0,0,0,0,-2000
059482,貿聯群益99購05  ,0,0,0,0,0,0,0,0,0,-2000,0,0,0,0,2000,-2000,-2000
05950P,台積電國票97售04,0,0,0,0,0,0,0,0,0,-2000,0,0,0,0,2000,-2000,-2000
059411,臺股指國票99購17,0,0,0,0,0,0,0,0,0,-2000,0,0,0,0,2000,-2000,-2000
059427,國巨元大99購24  ,0,0,0,0,0,0,0,0,0,-2000,0,0,0,0,2000,-2000,-2000
059428,國巨元大99購25  ,0,0,0,0,0,0,0,0,0,-2000,0,0,0,0,2000,-2000,-2000
059466,國巨元大99購26  ,0,0,0,0,0,0,0,0,0,-2000,0,0,0,0,2000,-2000,-2000
059433,聯發科元大99購27,0,0,0,0,0,0,0,0,0,-2000,0,0,0,0,2000,-2000,-2000
060663,聯發科凱基9A購13,0,0,0,0,0,0,0,0,0,-3000,0,0,0,0,3000,-3000,-3000
06059P,泰碩元大97售02  ,0,0,0,0,0,0,0,0,0,-3000,0,0,0,73000,76000,-3000,-3000
060570,南亞科永豐9A購01,0,0,0,0,0,0,0,0,0,-3000,0,0,0,12000,15000,-3000,-3000
060352,滬深2X元富9A購02,0,0,0,0,0,0,0,0,0,-3000,0,0,0,12000,15000,-3000,-3000
06616P,國巨元大98售15  ,0,0,0,0,0,0,0,0,0,-3000,0,0,0,0,3000,-3000,-3000
061052,和大群益9A購01  ,0,0,0,0,0,0,0,0,0,-3000,0,0,0,17000,20000,-3000,-3000
060980,台積電元大9A購21,0,0,0,0,0,0,0,0,0,-3000,0,0,0,3000,6000,-3000,-3000
060963,禾伸堂凱基9A購01,0,0,0,0,0,0,0,0,0,-3000,0,0,0,172000,175000,-3000,-3000
06448P,華通元大99售01  ,0,0,0,0,0,0,0,0,0,-3000,0,0,0,7000,10000,-3000,-3000
061388,台積電群益9A購05,0,0,0,0,0,0,0,0,0,-3000,0,0,0,0,3000,-3000,-3000
061380,巨大永豐9A購02  ,0,0,0,0,0,0,0,0,0,-3000,0,0,0,0,3000,-3000,-3000
06184P,大立光元大97售06,0,0,0,0,0,0,0,0,0,-3000,0,0,0,0,3000,-3000,-3000
061325,晶技凱基9A購03  ,0,0,0,0,0,0,0,0,0,-3000,0,0,0,0,3000,-3000,-3000
061280,國巨統一9C購06  ,0,0,0,0,0,0,0,0,0,-3000,0,0,0,0,3000,-3000,-3000
061295,台積電國泰9B購02,0,0,0,0,0,0,0,0,0,-3000,0,0,0,1000,4000,-3000,-3000
07011P,宏達電凱基99售02,0,0,0,0,0,0,0,0,0,-3000,0,0,0,0,3000,-3000,-3000
07049P,聯發科中信99售03,0,0,0,0,0,0,0,0,0,-3000,0,0,0,86000,89000,-3000,-3000
07067P,旺宏台新99售02  ,0,0,0,0,0,0,0,0,0,-3000,0,0,0,0,3000,-3000,-3000
07246P,旺宏凱基99售08  ,0,0,0,0,0,0,0,0,0,-3000,0,0,0,15000,18000,-3000,-3000
07139P,元油2X群益9C售06,0,0,0,0,0,0,0,0,0,-3000,0,0,0,28000,31000,-3000,-3000
07165P,臺股指群益99售16,0,0,0,0,0,0,0,0,0,-3000,0,0,0,0,3000,-3000,-3000
07350P,台灣50國票99售11,0,0,0,0,0,0,0,0,0,-3000,0,0,0,0,3000,-3000,-3000
1339,昭輝            ,32000,35000,-3000,0,0,0,0,0,0,0,0,0,0,0,0,0,-3000
1324,地球            ,2000,5000,-3000,0,0,0,0,0,0,0,0,0,0,0,0,0,-3000
1307,三芳            ,20000,21000,-1000,0,0,0,0,0,0,-2000,0,2000,-2000,0,0,0,-3000
07660P,聯茂凱基9A售03  ,0,0,0,0,0,0,0,0,0,-3000,0,0,0,0,3000,-3000,-3000
1726,永記            ,0,3000,-3000,0,0,0,0,0,0,0,0,0,0,0,0,0,-3000
1530,亞崴            ,1000,3000,-2000,0,0,0,0,0,0,-1000,0,1000,-1000,0,0,0,-3000
1535,中宇            ,0,3000,-3000,0,0,0,0,0,0,0,0,0,0,0,0,0,-3000
1587,吉茂            ,0,3000,-3000,0,0,0,0,0,0,0,0,0,0,0,0,0,-3000
1524,耿鼎            ,4000,7000,-3000,0,0,0,0,0,0,0,0,0,0,0,0,0,-3000
2032,新鋼            ,5000,7000,-2000,0,0,0,0,0,0,-1000,0,1000,-1000,0,0,0,-3000
2491,吉祥全          ,0,3000,-3000,0,0,0,0,0,0,0,0,0,0,0,0,0,-3000
2468,華經            ,2000,5000,-3000,0,0,0,0,0,0,0,0,0,0,0,0,0,-3000
6641,基士德-KY       ,0,3000,-3000,0,0,0,0,0,0,0,0,0,0,0,0,0,-3000
6674,鋐寶科技        ,0,3000,-3000,0,0,0,0,0,0,0,0,0,0,0,0,0,-3000
8201,無敵            ,2000,5000,-3000,0,0,0,0,0,0,0,0,0,0,0,0,0,-3000
8222,寶一            ,0,3000,-3000,0,0,0,0,0,0,0,0,0,0,0,0,0,-3000
8466,美吉吉-KY       ,2000,4000,-2000,0,0,0,0,0,0,-1000,0,1000,-1000,0,0,0,-3000
04606P,高股息中信96售01,0,0,0,0,0,0,0,0,0,-3000,0,0,0,0,3000,-3000,-3000
050459,台表科元大94購03,0,0,0,0,0,0,0,0,0,-3000,0,0,0,0,3000,-3000,-3000
050337,南電國泰95購01  ,0,0,0,0,0,0,0,0,0,-3000,0,0,0,0,3000,-3000,-3000
00866,新光Shiller CAPE,0,0,0,0,0,0,0,0,0,-3000,0,0,0,27000,30000,-3000,-3000
00735,國泰臺韓科技    ,0,0,0,0,0,0,0,0,0,-3000,0,0,0,227000,230000,-3000,-3000
051049,亞德客群益95購01,0,0,0,0,0,0,0,0,0,-3000,0,0,0,0,3000,-3000,-3000
052028,健策群益95購02  ,0,0,0,0,0,0,0,0,0,-3000,0,0,0,10000,13000,-3000,-3000
052313,聯電元大98購01  ,0,0,0,0,0,0,0,0,0,-3000,0,0,0,33000,36000,-3000,-3000
054066,緯穎國票97購03  ,0,0,0,0,0,0,0,0,0,-3000,0,0,0,0,3000,-3000,-3000
054245,鴻海元大96購23  ,0,0,0,0,0,0,0,0,0,-3000,0,0,0,0,3000,-3000,-3000
053880,智邦中信96購01  ,0,0,0,0,0,0,0,0,0,-3000,0,0,0,19000,22000,-3000,-3000
057822,牧德元大9A購01  ,0,0,0,0,0,0,0,0,0,-3000,0,0,0,0,3000,-3000,-3000
058666,上証反群益01購01,0,0,0,0,0,0,0,0,0,-3000,0,0,0,0,3000,-3000,-3000
058649,健策永豐99購01  ,0,0,0,0,0,0,0,0,0,-3000,0,0,0,9000,12000,-3000,-3000
053292,美律中信98購01  ,0,0,0,0,0,0,0,0,0,-3000,0,0,0,0,3000,-3000,-3000
056267,文曄統一97購02  ,0,0,0,0,0,0,0,0,0,-3000,0,0,0,93000,96000,-3000,-3000
057760,聯發科凱基98購18,0,0,0,0,0,0,0,0,0,-3000,0,0,0,1000,4000,-3000,-3000
057738,旺宏富邦9A購01  ,0,0,0,0,0,0,0,0,0,-3000,0,0,0,7000,10000,-3000,-3000
052766,玉晶光群益9A購01,0,0,0,0,0,0,0,0,0,-3000,0,0,0,0,3000,-3000,-3000
055241,T50反1統一99購01,0,0,0,0,0,0,0,0,0,-3000,0,0,0,0,3000,-3000,-3000
055075,南電永豐97購01  ,0,0,0,0,0,0,0,0,0,-3000,0,0,0,0,3000,-3000,-3000
055091,微星群益97購01  ,0,0,0,0,0,0,0,0,0,-3000,0,0,0,0,3000,-3000,-3000
058495,元大金群益9B購01,0,0,0,0,0,0,0,0,0,-3000,0,0,0,50000,53000,-3000,-3000
059056,技嘉凱基99購02  ,0,0,0,0,0,0,0,0,0,-3000,0,0,0,0,3000,-3000,-3000
058396,力山元大99購01  ,0,0,0,0,0,0,0,0,0,-3000,0,0,0,14000,17000,-3000,-3000
058414,大立光兆豐99購02,0,0,0,0,0,0,0,0,0,-3000,0,0,0,7000,10000,-3000,-3000
057920,奇力新凱基98購08,0,0,0,0,0,0,0,0,0,-3000,0,0,0,0,3000,-3000,-3000
058190,貿聯永豐99購01  ,0,0,0,0,0,0,0,0,0,-3000,0,0,0,20000,23000,-3000,-3000
059080,亞泥元大99購01  ,0,0,0,0,0,0,0,0,0,-3000,0,0,0,57000,60000,-3000,-3000
056908,牧德元大99購03  ,0,0,0,0,0,0,0,0,0,-3000,0,0,0,0,3000,-3000,-3000
059238,台積電凱基99購11,0,0,0,0,0,0,0,0,0,-3000,0,0,0,0,3000,-3000,-3000
057162,上銀元大98購03  ,0,0,0,0,0,0,0,0,0,-3000,0,0,0,0,3000,-3000,-3000
05614P,臺股指康和96售03,0,0,0,0,0,0,0,0,0,-3000,0,0,0,0,3000,-3000,-3000
056079,世紀鋼元大97購02,0,0,0,0,0,0,0,0,0,-3000,0,0,0,0,3000,-3000,-3000
057131,奇力新凱基98購05,0,0,0,0,0,0,0,0,0,-3000,0,0,0,0,3000,-3000,-3000
057127,旺宏凱基98購09  ,0,0,0,0,0,0,0,0,0,-3000,0,0,0,12000,15000,-3000,-3000
059015,華通元富99購02  ,0,0,0,0,0,0,0,0,0,-3000,0,0,0,0,3000,-3000,-3000
057646,玉山金元大98購01,0,0,0,0,0,0,0,0,0,-3000,0,0,0,0,3000,-3000,-3000
057481,技嘉元大98購04  ,0,0,0,0,0,0,0,0,0,-3000,0,0,0,0,3000,-3000,-3000
059726,華新科元大99購18,0,0,0,0,0,0,0,0,0,-3000,0,0,0,0,3000,-3000,-3000
059287,華通元富99購03  ,0,0,0,0,0,0,0,0,0,-3000,0,0,0,22000,25000,-3000,-3000
057600,大立光群益99購03,0,0,0,0,0,0,0,0,0,-3000,0,0,0,368000,371000,-3000,-3000
06010P,國泰金元富96售01,0,0,0,0,0,0,0,0,0,-3000,0,0,0,0,3000,-3000,-3000
059469,智邦元大99購03  ,0,0,0,0,0,0,0,0,0,-3000,0,0,0,72000,75000,-3000,-3000
060038,台積電國票99購13,0,0,0,0,0,0,0,0,0,-3000,0,0,0,1000,4000,-3000,-3000
059417,上証反元大9C購01,0,0,0,0,0,0,0,0,0,-3000,0,0,0,0,3000,-3000,-3000
05937P,台積電凱基96售21,0,0,0,0,0,0,0,0,0,-3000,0,0,0,30000,33000,-3000,-3000
2540,愛山林          ,0,1000,-1000,0,0,0,0,0,0,-2000,0,2000,-2000,0,0,0,-3000
059554,台灣50凱基99購08,0,0,0,0,0,0,0,0,0,-3000,0,0,0,2000,5000,-3000,-3000
05954P,旺宏國票97售03  ,0,0,0,0,0,0,0,0,0,-3000,0,0,0,0,3000,-3000,-3000
9929,秋雨            ,0,2000,-2000,0,0,0,0,0,0,-1000,0,1000,-1000,0,0,0,-3000
8481,政伸            ,0,3000,-3000,0,0,0,0,0,0,0,0,0,0,0,0,0,-3000
059849,興勤永豐99購01  ,0,0,0,0,0,0,0,0,0,-3000,0,0,0,0,3000,-3000,-3000
059880,世紀鋼凱基99購02,0,0,0,0,0,0,0,0,0,-3000,0,0,0,9000,12000,-3000,-3000
059892,台灣50台新9A購02,0,0,0,0,0,0,0,0,0,-3000,0,0,0,0,3000,-3000,-3000
059248,華新科凱基99購04,0,0,0,0,0,0,0,0,0,-3000,0,0,0,481000,484000,-3000,-3000
3257,虹冠電          ,11000,13000,-2000,0,0,0,0,0,0,-1000,0,1000,-1000,0,0,0,-3000
3296,勝德            ,0,2000,-2000,0,0,0,0,0,0,-1000,0,1000,-1000,0,0,0,-3000
3432,台端            ,0,2000,-2000,0,0,0,0,0,0,-1000,0,1000,-1000,0,0,0,-3000
5284,jpp-KY          ,0,3000,-3000,0,0,0,0,0,0,0,0,0,0,0,0,0,-3000
6405,悅城            ,1000,4000,-3000,0,0,0,0,0,0,0,0,0,0,0,0,0,-3000
6205,詮欣            ,0,2000,-2000,0,0,0,0,0,0,-1000,0,1000,-1000,0,0,0,-3000
6209,今國光          ,85000,86000,-1000,0,0,0,0,0,0,-2000,0,2000,-2000,0,0,0,-3000
6277,宏正            ,64000,54000,10000,0,0,0,0,0,0,-13000,0,13000,-13000,0,0,0,-3000
6666,羅麗芬-KY       ,6000,8000,-2000,0,0,0,0,0,0,-1300,0,0,0,0,1300,-1300,-3300
2430,燦坤            ,1006,3000,-1994,0,0,0,0,0,0,-2000,0,2000,-2000,0,0,0,-3994
2358,廷鑫            ,10000,9000,1000,0,0,0,0,0,0,-5000,0,5000,-5000,0,0,0,-4000
2033,佳大            ,4000,8000,-4000,0,0,0,0,0,0,0,0,0,0,0,0,0,-4000
6671,三能-KY         ,0,4000,-4000,0,0,0,0,0,0,0,0,0,0,0,0,0,-4000
2514,龍邦            ,49000,46000,3000,0,0,0,0,7000,-7000,0,0,0,0,0,0,0,-4000
9937,全國            ,5000,8000,-3000,0,0,0,0,0,0,-1000,0,1000,-1000,0,0,0,-4000
1568,倉佑            ,0,4000,-4000,0,0,0,0,0,0,0,0,0,0,0,0,0,-4000
1233,天仁            ,0,3000,-3000,0,0,0,0,0,0,-1000,0,1000,-1000,0,0,0,-4000
1423,利華            ,0,4000,-4000,0,0,0,0,0,0,0,0,0,0,0,0,0,-4000
07539P,玉山金台新9A售01,0,0,0,0,0,0,0,0,0,-4000,0,0,0,44000,48000,-4000,-4000
07206P,鴻海凱基9A售11  ,0,0,0,0,0,0,0,0,0,-4000,0,0,0,0,4000,-4000,-4000
07059P,華通國票9A售02  ,0,0,0,0,0,0,0,0,0,-4000,0,0,0,178000,182000,-4000,-4000
07090P,台灣50凱基01售01,0,0,0,0,0,0,0,0,0,-4000,0,0,0,1000,5000,-4000,-4000
07094P,華通國票9A售03  ,0,0,0,0,0,0,0,0,0,-4000,0,0,0,1000,5000,-4000,-4000
06954P,大立光元富99售01,0,0,0,0,0,0,0,0,0,-4000,0,0,0,290000,294000,-4000,-4000
06787P,臺股指元大98售04,0,0,0,0,0,0,0,0,0,-4000,0,0,0,0,4000,-4000,-4000
061296,台積電國泰9C購01,0,0,0,0,0,0,0,0,0,-4000,0,0,0,1000,5000,-4000,-4000
061241,晶技兆豐9A購01  ,0,0,0,0,0,0,0,0,0,-4000,0,0,0,0,4000,-4000,-4000
06301P,臺股指元大97售04,0,0,0,0,0,0,0,0,0,-4000,0,0,0,1000,5000,-4000,-4000
060941,台積電國票9B購04,0,0,0,0,0,0,0,0,0,-4000,0,0,0,0,4000,-4000,-4000
060689,臺股指元大9A購43,0,0,0,0,0,0,0,0,0,-4000,0,0,0,0,4000,-4000,-4000
060586,玉晶光元富9A購03,0,0,0,0,0,0,0,0,0,-4000,0,0,0,0,4000,-4000,-4000
060479,億豐元大9A購01  ,0,0,0,0,0,0,0,0,0,-4000,0,0,0,6000,10000,-4000,-4000
055441,緯穎國票98購01  ,0,0,0,0,0,0,0,0,0,-4000,0,0,0,0,4000,-4000,-4000
054501,強茂永豐96購02  ,0,0,0,0,0,0,0,0,0,-4000,0,0,0,0,4000,-4000,-4000
054717,亞德客永豐97購01,0,0,0,0,0,0,0,0,0,-4000,0,0,0,6000,10000,-4000,-4000
055008,隆達元富97購01  ,0,0,0,0,0,0,0,0,0,-4000,0,0,0,0,4000,-4000,-4000
055033,漢唐富邦98購01  ,0,0,0,0,0,0,0,0,0,-4000,0,0,0,0,4000,-4000,-4000
055215,智邦凱基98購02  ,0,0,0,0,0,0,0,0,0,-4000,0,0,0,0,4000,-4000,-4000
05774P,臺股指凱基99售04,0,0,0,0,0,0,0,0,0,-4000,0,0,0,0,4000,-4000,-4000
058682,聯發科凱基99購07,0,0,0,0,0,0,0,0,0,-4000,0,0,0,0,4000,-4000,-4000
053136,彩晶國票97購01  ,0,0,0,0,0,0,0,0,0,-4000,0,0,0,0,4000,-4000,-4000
053825,南電群益96購02  ,0,0,0,0,0,0,0,0,0,-4000,0,0,0,0,4000,-4000,-4000
055557,華新科凱基97購01,0,0,0,0,0,0,0,0,0,-4000,0,0,0,0,4000,-4000,-4000
054309,禾伸堂凱基98購01,0,0,0,0,0,0,0,0,0,-4000,0,0,0,6000,10000,-4000,-4000
054300,華通凱基96購07  ,0,0,0,0,0,0,0,0,0,-4000,0,0,0,0,4000,-4000,-4000
052584,喬山永豐96購01  ,0,0,0,0,0,0,0,0,0,-4000,0,0,0,0,4000,-4000,-4000
05209P,鴻海凱基96售09  ,0,0,0,0,0,0,0,0,0,-4000,0,0,0,0,4000,-4000,-4000
052151,義隆富邦96購01  ,0,0,0,0,0,0,0,0,0,-4000,0,0,0,0,4000,-4000,-4000
051001,緯穎元大96購02  ,0,0,0,0,0,0,0,0,0,-4000,0,0,0,0,4000,-4000,-4000
051026,健策統一96購01  ,0,0,0,0,0,0,0,0,0,-4000,0,0,0,10000,14000,-4000,-4000
051233,力成群益97購01  ,0,0,0,0,0,0,0,0,0,-4000,0,0,0,10000,14000,-4000,-4000
00702,國泰標普低波高息,0,7000,-7000,0,0,0,0,0,0,3000,0,0,0,9000,6000,3000,-4000
03425B,臺股指元大9A熊01,0,0,0,0,0,0,0,0,0,-4000,0,0,0,4000,8000,-4000,-4000
050794,大立光富邦96購04,0,0,0,0,0,0,0,0,0,-4000,0,0,0,6000,10000,-4000,-4000
04578P,微星富邦96售01  ,0,0,0,0,0,0,0,0,0,-4000,0,0,0,0,4000,-4000,-4000
060029,嘉晶永豐99購03  ,0,0,0,0,0,0,0,0,0,-4000,0,0,0,1000,5000,-4000,-4000
060003,上証2X群益9B購02,0,0,0,0,0,0,0,0,0,-4000,0,0,0,0,4000,-4000,-4000
060146,健策國票9A購03  ,0,0,0,0,0,0,0,0,0,-4000,0,0,0,3000,7000,-4000,-4000
057489,奇力新元大99購06,0,0,0,0,0,0,0,0,0,-4000,0,0,0,12000,16000,-4000,-4000
057558,致新凱基98購01  ,0,0,0,0,0,0,0,0,0,-4000,0,0,0,10000,14000,-4000,-4000
055584,國巨元大97購11  ,0,0,0,0,0,0,0,0,0,-4000,0,0,0,15000,19000,-4000,-4000
059219,旺宏元大99購12  ,0,0,0,0,0,0,0,0,0,-4000,0,0,0,24000,28000,-4000,-4000
057288,聯茂元大98購03  ,0,0,0,0,0,0,0,0,0,-4000,0,0,0,30000,34000,-4000,-4000
056978,技嘉群益99購01  ,0,0,0,0,0,0,0,0,0,-4000,0,0,0,0,4000,-4000,-4000
058985,可成凱基99購03  ,0,0,0,0,0,0,0,0,0,-4000,0,0,0,16000,20000,-4000,-4000
058099,鴻海國泰9A購02  ,0,0,0,0,0,0,0,0,0,-4000,0,0,0,0,4000,-4000,-4000
058766,力山兆豐99購01  ,0,0,0,0,0,0,0,0,0,-4000,0,0,0,276000,280000,-4000,-4000
05676P,欣興群益96售04  ,0,0,0,0,0,0,0,0,0,-4000,0,0,0,0,4000,-4000,-4000
056395,玉晶光永豐9B購01,0,0,0,0,0,0,0,0,0,-4000,0,0,0,0,4000,-4000,-4000
056474,華新科元大99購05,0,0,0,0,0,0,0,0,0,-4000,0,0,0,40000,44000,-4000,-4000
058718,台灣50元富03購01,0,0,0,0,0,0,0,0,0,-4000,0,0,0,0,4000,-4000,-4000
058940,聯發科中信9A購03,0,0,0,0,0,0,0,0,0,-4000,0,0,0,0,4000,-4000,-4000
5515,建國            ,15000,19000,-4000,0,0,0,0,0,0,0,0,0,0,0,0,0,-4000
3679,新至陞          ,2000,5000,-3000,0,0,0,0,0,0,-1000,0,1000,-1000,0,0,0,-4000
3528,安馳            ,1000,4000,-3000,0,0,0,0,0,0,-1000,0,1000,-1000,0,0,0,-4000
4545,銘鈺            ,2000,6000,-4000,0,0,0,0,0,0,0,0,0,0,0,0,0,-4000
059956,玉山金康和99購01,0,0,0,0,0,0,0,0,0,-4000,0,0,0,259000,263000,-4000,-4000
059672,滬深2X元富99購06,0,0,0,0,0,0,0,0,0,-4000,0,0,0,0,4000,-4000,-4000
9925,新保            ,23000,27000,-4000,0,0,0,0,0,0,0,0,0,0,0,0,0,-4000
9931,欣高            ,0,4000,-4000,0,0,0,0,0,0,0,0,0,0,0,0,0,-4000
059362,健策永豐99購03  ,0,0,0,0,0,0,0,0,0,-4000,0,0,0,8000,12000,-4000,-4000
3011,今皓            ,0,4000,-4000,0,0,0,0,0,0,0,0,0,0,0,0,0,-4000
3025,星通            ,3000,7000,-4000,0,0,0,0,0,0,0,0,0,0,0,0,0,-4000
3027,盛達            ,3000,6000,-3000,0,0,0,0,0,0,-1000,0,1000,-1000,0,0,0,-4000
3040,遠見            ,2000,6000,-4000,0,0,0,0,0,0,0,0,0,0,0,0,0,-4000
2630,亞航            ,3000,7000,-4000,0,0,0,0,0,0,0,0,0,0,0,0,0,-4000
2704,國賓            ,27000,31000,-4000,0,0,0,0,0,0,0,0,0,0,0,0,0,-4000
060510,大立光元大9A購03,0,0,0,0,0,0,0,0,0,-5000,0,0,0,0,5000,-5000,-5000
060580,A50正2群益9C購03,0,0,0,0,0,0,0,0,0,-5000,0,0,0,0,5000,-5000,-5000
060648,鴻海第一9A購01  ,0,0,0,0,0,0,0,0,0,-5000,0,0,0,0,5000,-5000,-5000
060743,鴻海國票9A購03  ,0,0,0,0,0,0,0,0,0,-5000,0,0,0,0,5000,-5000,-5000
060231,台積電元大9A購08,0,0,0,0,0,0,0,0,0,-5000,0,0,0,5000,10000,-5000,-5000
060388,世紀鋼凱基9B購01,0,0,0,0,0,0,0,0,0,-5000,0,0,0,0,5000,-5000,-5000
060929,健策永豐9A購01  ,0,0,0,0,0,0,0,0,0,-5000,0,0,0,21000,26000,-5000,-5000
060917,台表科國泰9B購01,0,0,0,0,0,0,0,0,0,-5000,0,0,0,0,5000,-5000,-5000
060822,華通元大9A購05  ,0,0,0,0,0,0,0,0,0,-5000,0,0,0,53000,58000,-5000,-5000
060947,台積電統一9C購03,0,0,0,0,0,0,0,0,0,-5000,0,0,0,0,5000,-5000,-5000
06303P,臺股指元大97售09,0,0,0,0,0,0,0,0,0,-5000,0,0,0,0,5000,-5000,-5000
06234P,亞德客元大97售02,0,0,0,0,0,0,0,0,0,-5000,0,0,0,0,5000,-5000,-5000
06386P,欣興永豐97售03  ,0,0,0,0,0,0,0,0,0,-5000,0,0,0,5000,10000,-5000,-5000
061338,台積電元大9A購28,0,0,0,0,0,0,0,0,0,-5000,0,0,0,0,5000,-5000,-5000
061321,華新科凱基9A購09,0,0,0,0,0,0,0,0,0,-5000,0,0,0,0,5000,-5000,-5000
061314,滬深2X凱基9B購06,0,0,0,0,0,0,0,0,0,-5000,0,0,0,0,5000,-5000,-5000
06214P,國巨國票98售04  ,0,0,0,0,0,0,0,0,0,-5000,0,0,0,0,5000,-5000,-5000
06181P,國巨中信97售02  ,0,0,0,0,0,0,0,0,0,-5000,0,0,0,0,5000,-5000,-5000
061387,鴻海群益9A購05  ,0,0,0,0,0,0,0,0,0,-5000,0,0,0,0,5000,-5000,-5000
061154,可成群益9B購04  ,0,0,0,0,0,0,0,0,0,-5000,0,0,0,0,5000,-5000,-5000
06767P,台積電永昌99售03,0,0,0,0,0,0,0,0,0,-5000,0,0,0,0,5000,-5000,-5000
06839P,玉晶光統一9A售05,0,0,0,0,0,0,0,0,0,-5000,0,0,0,0,5000,-5000,-5000
06801P,技嘉群益99售02  ,0,0,0,0,0,0,0,0,0,-5000,0,0,0,45000,50000,-5000,-5000
06847P,奇力新元大98售05,0,0,0,0,0,0,0,0,0,-5000,0,0,0,0,5000,-5000,-5000
06466P,台積電統一9B售01,0,0,0,0,0,0,0,0,0,-5000,0,0,0,17000,22000,-5000,-5000
06496P,台灣50日盛98售01,0,0,0,0,0,0,0,0,0,-5000,0,0,0,0,5000,-5000,-5000
06546P,聯發科元大98售05,0,0,0,0,0,0,0,0,0,-5000,0,0,0,0,5000,-5000,-5000
07086P,力成元富9C售01  ,0,0,0,0,0,0,0,0,0,-5000,0,0,0,0,5000,-5000,-5000
07236P,台灣50國票99售05,0,0,0,0,0,0,0,0,0,-5000,0,0,0,0,5000,-5000,-5000
07500P,微星元大9A售01  ,0,0,0,0,0,0,0,0,0,-5000,0,0,0,5000,10000,-5000,-5000
07349P,大立光凱基99售16,0,0,0,0,0,0,0,0,0,-5000,0,0,0,0,5000,-5000,-5000
07353P,大立光國票99售02,0,0,0,0,0,0,0,0,0,-5000,0,0,0,0,5000,-5000,-5000
07316P,長榮航康和99售01,0,0,0,0,0,0,0,0,0,-5000,0,0,0,16000,21000,-5000,-5000
07272P,台灣50元大9C售05,0,0,0,0,0,0,0,0,0,-5000,0,0,0,0,5000,-5000,-5000
07385P,緯穎群益99售04  ,0,0,0,0,0,0,0,0,0,-5000,0,0,0,0,5000,-5000,-5000
1437,勤益控          ,19000,24000,-5000,0,0,0,0,0,0,0,0,0,0,0,0,0,-5000
1235,興泰            ,0,0,0,0,0,0,0,0,0,-5000,0,5000,-5000,0,0,0,-5000
1236,宏亞            ,0,5000,-5000,0,0,0,0,0,0,0,0,0,0,0,0,0,-5000
07648P,祥碩國票9B售01  ,0,0,0,0,0,0,0,0,0,-5000,0,0,0,5000,10000,-5000,-5000
07768P,緯穎群益9A售02  ,0,0,0,0,0,0,0,0,0,-5000,0,0,0,0,5000,-5000,-5000
07740P,臺股指永豐9A售01,0,0,0,0,0,0,0,0,0,-5000,0,0,0,0,5000,-5000,-5000
1470,大統新創        ,0,4000,-4000,0,0,0,0,0,0,-1000,0,1000,-1000,0,0,0,-5000
1730,花仙子          ,24000,29000,-5000,0,0,0,0,0,0,0,0,0,0,0,0,0,-5000
2466,冠西電          ,2000,5000,-3000,0,0,0,0,0,0,-2000,0,2000,-2000,0,0,0,-5000
2484,希華            ,80000,84000,-4000,0,0,0,0,0,0,-1000,0,1000,-1000,0,0,0,-5000
2373,震旦行          ,1000,0,1000,0,0,0,0,0,0,-6000,0,6000,-6000,0,0,0,-5000
2413,環科            ,10000,15000,-5000,0,0,0,0,0,0,0,0,0,0,0,0,0,-5000
04505P,佳世達元富96售03,0,0,0,0,0,0,0,0,0,-5000,0,0,0,0,5000,-5000,-5000
043442,大立光台新01購01,0,0,0,0,0,0,0,0,0,-5000,0,0,0,0,5000,-5000,-5000
048192,華通元大96購01  ,0,0,0,0,0,0,0,0,0,-5000,0,0,0,0,5000,-5000,-5000
050854,世紀鋼國票97購01,0,0,0,0,0,0,0,0,0,-5000,0,0,0,0,5000,-5000,-5000
050847,創意國票96購01  ,0,0,0,0,0,0,0,0,0,-5000,0,0,0,7000,12000,-5000,-5000
050751,聯電統一94購05  ,0,0,0,0,0,0,0,0,0,-5000,0,0,0,0,5000,-5000,-5000
03091X,元展85          ,0,0,0,0,0,0,0,0,0,-5000,0,0,0,0,5000,-5000,-5000
03607P,滬深2X富邦95售01,0,0,0,0,0,0,0,0,0,-5000,0,0,0,0,5000,-5000,-5000
049260,華新科元大96購01,0,0,0,0,0,0,0,0,0,-5000,0,0,0,5000,10000,-5000,-5000
052454,力成元大95購02  ,0,0,0,0,0,0,0,0,0,-5000,0,0,0,5000,10000,-5000,-5000
052413,上証反中信97購01,0,0,0,0,0,0,0,0,0,-5000,0,0,0,0,5000,-5000,-5000
051873,緯穎凱基95購02  ,0,0,0,0,0,0,0,0,0,-5000,0,0,0,0,5000,-5000,-5000
051727,S&P反1國票97購01,0,0,0,0,0,0,0,0,0,-5000,0,0,0,0,5000,-5000,-5000
052276,力成群益96購01  ,0,0,0,0,0,0,0,0,0,-5000,0,0,0,1000,6000,-5000,-5000
052336,矽力日盛95購01  ,0,0,0,0,0,0,0,0,0,-5000,0,0,0,0,5000,-5000,-5000
054137,聯詠元大97購02  ,0,0,0,0,0,0,0,0,0,-5000,0,0,0,0,5000,-5000,-5000
053427,鎧勝永豐96購02  ,0,0,0,0,0,0,0,0,0,-5000,0,0,0,5000,10000,-5000,-5000
053461,台郡永昌99購01  ,0,0,0,0,0,0,0,0,0,-5000,0,0,0,0,5000,-5000,-5000
053855,康友國泰98購01  ,0,0,0,0,0,0,0,0,0,-5000,0,0,0,0,5000,-5000,-5000
053050,華通國票97購02  ,0,0,0,0,0,0,0,0,0,-5000,0,0,0,0,5000,-5000,-5000
053069,同欣電群益98購01,0,0,0,0,0,0,0,0,0,-5000,0,0,0,0,5000,-5000,-5000
057792,群創統一99購01  ,0,0,0,0,0,0,0,0,0,-5000,0,0,0,0,5000,-5000,-5000
057810,技嘉元大98購06  ,0,0,0,0,0,0,0,0,0,-5000,0,0,0,2000,7000,-5000,-5000
057713,美律統一99購01  ,0,0,0,0,0,0,0,0,0,-5000,0,0,0,20000,25000,-5000,-5000
057705,臺股指群益98購05,0,0,0,0,0,0,0,0,0,-5000,0,0,0,2000,7000,-5000,-5000
056350,上銀元大98購02  ,0,0,0,0,0,0,0,0,0,-5000,0,0,0,0,5000,-5000,-5000
053250,百和國票97購02  ,0,0,0,0,0,0,0,0,0,-5000,0,0,0,0,5000,-5000,-5000
053192,創意統一96購01  ,0,0,0,0,0,0,0,0,0,-5000,0,0,0,0,5000,-5000,-5000
05521P,創意永豐96售01  ,0,0,0,0,0,0,0,0,0,-5000,0,0,0,0,5000,-5000,-5000
055049,智邦永豐97購01  ,0,0,0,0,0,0,0,0,0,-5000,0,0,0,26000,31000,-5000,-5000
054758,南亞國票9A購01  ,0,0,0,0,0,0,0,0,0,-5000,0,0,0,20000,25000,-5000,-5000
054588,玉晶光國泰99購02,0,0,0,0,0,0,0,0,0,-5000,0,0,0,0,5000,-5000,-5000
054522,康友元大96購07  ,0,0,0,0,0,0,0,0,0,-5000,0,0,0,0,5000,-5000,-5000
054525,奇鋐元富96購01  ,0,0,0,0,0,0,0,0,0,-5000,0,0,0,0,5000,-5000,-5000
052775,滬深2X國票99購02,0,0,0,0,0,0,0,0,0,-5000,0,0,0,8000,13000,-5000,-5000
052777,燿華國票98購01  ,0,0,0,0,0,0,0,0,0,-5000,0,0,0,10000,15000,-5000,-5000
055388,華通統一97購03  ,0,0,0,0,0,0,0,0,0,-5000,0,0,0,1000,6000,-5000,-5000
052864,奇力新凱基96購02,0,0,0,0,0,0,0,0,0,-5000,0,0,0,10000,15000,-5000,-5000
055145,T50反1元大97購04,0,0,0,0,0,0,0,0,0,-5000,0,0,0,0,5000,-5000,-5000
055126,嘉澤兆豐97購01  ,0,0,0,0,0,0,0,0,0,-5000,0,0,0,0,5000,-5000,-5000
055289,泰碩元大98購01  ,0,0,0,0,0,0,0,0,0,-5000,0,0,0,0,5000,-5000,-5000
05271P,國巨富邦97售01  ,0,0,0,0,0,0,0,0,0,-5000,0,0,0,0,5000,-5000,-5000
055352,奇力新凱基97購01,0,0,0,0,0,0,0,0,0,-5000,0,0,0,0,5000,-5000,-5000
056600,聯茂元富98購01  ,0,0,0,0,0,0,0,0,0,-5000,0,0,0,0,5000,-5000,-5000
056554,GIS凱基99購01   ,0,0,0,0,0,0,0,0,0,-5000,0,0,0,0,5000,-5000,-5000
058558,鴻海日盛9A購02  ,0,0,0,0,0,0,0,0,0,-5000,0,0,0,0,5000,-5000,-5000
056639,國產康和98購01  ,0,0,0,0,0,0,0,0,0,-5000,0,0,0,0,5000,-5000,-5000
058090,聯發科元大98購16,0,0,0,0,0,0,0,0,0,-5000,0,0,0,0,5000,-5000,-5000
058023,南電凱基98購02  ,0,0,0,0,0,0,0,0,0,-5000,0,0,0,5000,10000,-5000,-5000
056783,國巨群益99購01  ,0,0,0,0,0,0,0,0,0,-5000,0,0,0,0,5000,-5000,-5000
059082,華通元大99購06  ,0,0,0,0,0,0,0,0,0,-5000,0,0,0,0,5000,-5000,-5000
057066,緯穎富邦99購01  ,0,0,0,0,0,0,0,0,0,-5000,0,0,0,30000,35000,-5000,-5000
058296,明泰凱基99購01  ,0,0,0,0,0,0,0,0,0,-5000,0,0,0,0,5000,-5000,-5000
05572P,群創統一96售02  ,0,0,0,0,0,0,0,0,0,-5000,0,0,0,0,5000,-5000,-5000
057353,玉晶光統一99購01,0,0,0,0,0,0,0,0,0,-5000,0,0,0,0,5000,-5000,-5000
056156,禾伸堂凱基98購04,0,0,0,0,0,0,0,0,0,-5000,0,0,0,0,5000,-5000,-5000
057486,美律元大98購04  ,0,0,0,0,0,0,0,0,0,-5000,0,0,0,0,5000,-5000,-5000
059648,台表科凱基99購03,0,0,0,0,0,0,0,0,0,-5000,0,0,0,0,5000,-5000,-5000
2546,根基            ,12000,16000,-4000,0,0,0,0,0,0,-1000,0,1000,-1000,0,0,0,-5000
059571,奇力新凱基99購06,0,0,0,0,0,0,0,0,0,-5000,0,0,0,0,5000,-5000,-5000
2722,夏都            ,0,4000,-4000,0,0,0,0,0,0,-1000,0,1000,-1000,0,0,0,-5000
3055,蔚華科          ,3000,8000,-5000,0,0,0,0,0,0,0,0,0,0,0,0,0,-5000
3002,歐格            ,0,4000,-4000,0,0,0,0,0,0,-1000,0,1000,-1000,0,0,0,-5000
059793,滬深2X國票99購03,0,0,0,0,0,0,0,0,0,-5000,0,0,0,0,5000,-5000,-5000
9926,新海            ,0,5000,-5000,0,0,0,0,0,0,0,0,0,0,0,0,0,-5000
9906,欣巴巴          ,0,5000,-5000,0,0,0,0,0,0,0,0,0,0,0,0,0,-5000
059905,A50正2元大9C購06,0,0,0,0,0,0,0,0,0,-5000,0,0,0,0,5000,-5000,-5000
059946,健策永豐99購05  ,0,0,0,0,0,0,0,0,0,-5000,0,0,0,9000,14000,-5000,-5000
3164,景岳            ,4000,9000,-5000,0,0,0,0,0,0,0,0,0,0,0,0,0,-5000
5525,順天            ,6000,11000,-5000,0,0,0,0,0,0,0,0,0,0,0,0,0,-5000
6201,亞弘電          ,0,3000,-3000,0,0,0,0,0,0,-2000,0,2000,-2000,0,0,0,-5000
3018,同開            ,51966,57000,-5034,0,0,0,0,0,0,0,0,0,0,0,0,0,-5034
2069,運錩            ,2000,8000,-6000,0,0,0,0,0,0,0,0,0,0,0,0,0,-6000
2471,資通            ,47000,53000,-6000,0,0,0,0,0,0,0,0,0,0,0,0,0,-6000
8443,阿瘦            ,0,4000,-4000,0,0,0,0,0,0,-2000,0,2000,-2000,0,0,0,-6000
1533,車王電          ,0,6000,-6000,0,0,0,0,0,0,0,0,0,0,0,0,0,-6000
07656P,國巨凱基9A售15  ,0,0,0,0,0,0,0,0,0,-6000,0,0,0,15000,21000,-6000,-6000
1256,鮮活果汁-KY     ,2000,8000,-6000,0,0,0,0,0,0,0,0,0,0,0,0,0,-6000
1416,廣豐            ,0,5000,-5000,0,0,0,0,0,0,-1000,0,1000,-1000,0,0,0,-6000
1441,大東            ,2000,8000,-6000,0,0,0,0,0,0,0,0,0,0,0,0,0,-6000
07445P,大立光凱基9A售08,0,0,0,0,0,0,0,0,0,-6000,0,0,0,16000,22000,-6000,-6000
07243P,台灣50凱基9A售04,0,0,0,0,0,0,0,0,0,-6000,0,0,0,7000,13000,-6000,-6000
07306P,台灣50凱基9A售09,0,0,0,0,0,0,0,0,0,-6000,0,0,0,1000,7000,-6000,-6000
07558P,玉晶光元大9A售10,0,0,0,0,0,0,0,0,0,-6000,0,0,0,0,6000,-6000,-6000
07210P,智邦凱基99售03  ,0,0,0,0,0,0,0,0,0,-6000,0,0,0,0,6000,-6000,-6000
07199P,臺股指元大99售15,0,0,0,0,0,0,0,0,0,-6000,0,0,0,0,6000,-6000,-6000
06533P,上証2X中信9B售01,0,0,0,0,0,0,0,0,0,-6000,0,0,0,0,6000,-6000,-6000
06899P,嘉澤群益98售01  ,0,0,0,0,0,0,0,0,0,-6000,0,0,0,0,6000,-6000,-6000
061163,台灣50兆豐9A購04,0,0,0,0,0,0,0,0,0,-6000,0,0,0,0,6000,-6000,-6000
061176,聯發科凱基9A購14,0,0,0,0,0,0,0,0,0,-6000,0,0,0,0,6000,-6000,-6000
061196,世芯永豐9A購06  ,0,0,0,0,0,0,0,0,0,-6000,0,0,0,2000,8000,-6000,-6000
061029,力山永豐9A購01  ,0,0,0,0,0,0,0,0,0,-6000,0,0,0,106000,112000,-6000,-6000
060769,國巨麥證9A購02  ,0,0,0,4000,10000,-6000,0,0,0,-6000,0,0,0,4000,10000,-6000,-6000
060652,滬深2X群益9C購04,0,0,0,0,0,0,0,0,0,-6000,0,0,0,0,6000,-6000,-6000
060637,玉晶光永豐9A購03,0,0,0,0,0,0,0,0,0,-6000,0,0,0,1000,7000,-6000,-6000
060569,台積電永豐9A購01,0,0,0,0,0,0,0,0,0,-6000,0,0,0,0,6000,-6000,-6000
060507,聯發科元大9A購03,0,0,0,0,0,0,0,0,0,-6000,0,0,0,0,6000,-6000,-6000
055381,茂林元大97購02  ,0,0,0,0,0,0,0,0,0,-6000,0,0,0,34000,40000,-6000,-6000
054821,貿聯元大9A購01  ,0,0,0,0,0,0,0,0,0,-6000,0,0,0,0,6000,-6000,-6000
053249,致伸國票97購02  ,0,0,0,0,0,0,0,0,0,-6000,0,0,0,32000,38000,-6000,-6000
058389,聯茂國票9A購01  ,0,0,0,0,0,0,0,0,0,-6000,0,0,0,0,6000,-6000,-6000
053741,漢唐國票97購03  ,0,0,0,0,0,0,0,0,0,-6000,0,0,0,0,6000,-6000,-6000
053152,大立光元大99購01,0,0,0,0,0,0,0,0,0,-6000,0,0,0,0,6000,-6000,-6000
052508,矽力日盛95購02  ,0,0,0,0,0,0,0,0,0,-6000,0,0,0,0,6000,-6000,-6000
05402P,台郡永豐95售02  ,0,0,0,0,0,0,0,0,0,-6000,0,0,0,0,6000,-6000,-6000
051780,矽力群益95購01  ,0,0,0,0,0,0,0,0,0,-6000,0,0,0,0,6000,-6000,-6000
051823,矽力元富95購02  ,0,0,0,0,0,0,0,0,0,-6000,0,0,0,0,6000,-6000,-6000
05124P,華新科富邦97售02,0,0,0,0,0,0,0,0,0,-6000,0,0,0,0,6000,-6000,-6000
051540,力成國票95購01  ,0,0,0,0,0,0,0,0,0,-6000,0,0,0,0,6000,-6000,-6000
049335,聯電統一97購01  ,0,0,0,0,0,0,0,0,0,-6000,0,0,0,0,6000,-6000,-6000
03420B,臺股指元大95熊31,0,0,0,0,0,0,0,0,0,-6000,0,0,0,0,6000,-6000,-6000
03438P,群創群益98售03  ,0,0,0,0,0,0,0,0,0,-6000,0,0,0,0,6000,-6000,-6000
04912P,可成元富94售06  ,0,0,0,0,0,0,0,0,0,-6000,0,0,0,0,6000,-6000,-6000
00689R,國泰20年美債反1 ,0,0,0,0,0,0,0,0,0,-6000,0,0,0,199000,205000,-6000,-6000
05052P,友達群益97售01  ,0,0,0,0,0,0,0,0,0,-6000,0,0,0,0,6000,-6000,-6000
048070,聯發科元富99購03,0,0,0,0,0,0,0,0,0,-6000,0,0,0,0,6000,-6000,-6000
047887,智原富邦97購01  ,0,0,0,0,0,0,0,0,0,-6000,0,0,0,0,6000,-6000,-6000
04241P,欣興國泰95售02  ,0,0,0,0,0,0,0,0,0,-6000,0,0,0,0,6000,-6000,-6000
057478,智邦元大99購01  ,0,0,0,0,0,0,0,0,0,-6000,0,0,0,4000,10000,-6000,-6000
055938,矽力群益97購01  ,0,0,0,0,0,0,0,0,0,-6000,0,0,0,0,6000,-6000,-6000
055623,貿聯國泰99購01  ,0,0,0,0,0,0,0,0,0,-6000,0,0,0,0,6000,-6000,-6000
055788,緯穎凱基97購04  ,0,0,0,0,0,0,0,0,0,-6000,0,0,0,0,6000,-6000,-6000
056226,聯發科凱基97購10,0,0,0,0,0,0,0,0,0,-6000,0,0,0,0,6000,-6000,-6000
057211,鴻海群益98購05  ,0,0,0,0,0,0,0,0,0,-6000,0,0,0,345000,351000,-6000,-6000
058187,泰碩永豐99購01  ,0,0,0,0,0,0,0,0,0,-6000,0,0,0,160000,166000,-6000,-6000
059083,華通元大99購07  ,0,0,0,0,0,0,0,0,0,-6000,0,0,0,21000,27000,-6000,-6000
059004,嘉晶元大99購05  ,0,0,0,0,0,0,0,0,0,-6000,0,0,0,25000,31000,-6000,-6000
059087,台積電元大99購26,0,0,0,0,0,0,0,0,0,-6000,0,0,0,0,6000,-6000,-6000
057944,新日興國票99購02,0,0,0,0,0,0,0,0,0,-6000,0,0,0,0,6000,-6000,-6000
05858P,矽力中信96售01  ,0,0,0,0,0,0,0,0,0,-6000,0,0,0,0,6000,-6000,-6000
05855P,滬深2X中信9C售01,0,0,0,0,0,0,0,0,0,-6000,0,0,0,0,6000,-6000,-6000
058452,義隆永豐99購02  ,0,0,0,0,0,0,0,0,0,-6000,0,0,0,34000,40000,-6000,-6000
058402,欣興元大99購04  ,0,0,0,0,0,0,0,0,0,-6000,0,0,0,18000,24000,-6000,-6000
05642P,玉晶光兆豐97售02,0,0,0,0,0,0,0,0,0,-6000,0,0,0,4000,10000,-6000,-6000
059057,聯發科凱基99購10,0,0,0,0,0,0,0,0,0,-6000,0,0,0,0,6000,-6000,-6000
058944,元石油群益9C購02,0,0,0,0,0,0,0,0,0,-6000,0,0,0,112000,118000,-6000,-6000
2901,欣欣            ,2000,7000,-5000,0,0,0,0,0,0,-1000,0,1000,-1000,0,0,0,-6000
2748,雲品            ,0,1000,-1000,0,0,0,0,5000,-5000,0,0,0,0,0,0,0,-6000
2852,第一保          ,1000,3000,-2000,0,0,0,0,0,0,-4000,0,4000,-4000,0,0,0,-6000
2616,山隆            ,5000,11000,-6000,0,0,0,0,0,0,0,0,0,0,0,0,0,-6000
059355,國巨富邦9B購03  ,0,0,0,0,0,0,0,0,0,-6000,0,0,0,109000,115000,-6000,-6000
059960,健策國票99購01  ,0,0,0,0,0,0,0,0,0,-6000,0,0,0,0,6000,-6000,-6000
8478,東哥遊艇        ,0,6000,-6000,0,0,0,0,0,0,0,0,0,0,0,0,0,-6000
6177,達麗            ,34000,40000,-6000,0,0,0,0,0,0,0,0,0,0,0,0,0,-6000
5007,三星            ,10000,10000,0,0,0,0,0,0,0,-6000,0,6000,-6000,0,0,0,-6000
3550,聯穎            ,0,6000,-6000,0,0,0,0,0,0,0,0,0,0,0,0,0,-6000
4722,國精化          ,7078,14000,-6922,0,0,0,0,0,0,0,0,0,0,0,0,0,-6922
060480,億豐元大9A購02  ,0,0,0,0,0,0,0,0,0,-7000,0,0,0,0,7000,-7000,-7000
060590,台積電台新9C購02,0,0,0,0,0,0,0,0,0,-7000,0,0,0,1000,8000,-7000,-7000
060395,儒鴻國票9A購01  ,0,0,0,0,0,0,0,0,0,-7000,0,0,0,17000,24000,-7000,-7000
061078,台積電兆豐9A購01,0,0,0,0,0,0,0,0,0,-7000,0,0,0,0,7000,-7000,-7000
060889,國泰金統一9C購01,0,0,0,0,0,0,0,0,0,-7000,0,0,0,107000,114000,-7000,-7000
060896,晶技凱基9A購02  ,0,0,0,0,0,0,0,0,0,-7000,0,0,0,178000,185000,-7000,-7000
06713P,臺股指富邦99售04,0,0,0,0,0,0,0,0,0,-7000,0,0,0,0,7000,-7000,-7000
06142P,台虹康和97售02  ,0,0,0,0,0,0,0,0,0,-7000,0,0,0,89000,96000,-7000,-7000
061318,智邦凱基9B購01  ,0,0,0,0,0,0,0,0,0,-7000,0,0,0,0,7000,-7000,-7000
061364,國巨國票9A購09  ,0,0,0,0,0,0,0,0,0,-7000,0,0,0,0,7000,-7000,-7000
06844P,智邦元大98售13  ,0,0,0,0,0,0,0,0,0,-7000,0,0,0,0,7000,-7000,-7000
06962P,華新科永豐99售01,0,0,0,0,0,0,0,0,0,-7000,0,0,0,13000,20000,-7000,-7000
07012P,智邦群益9A售01  ,0,0,0,0,0,0,0,0,0,-7000,0,0,0,0,7000,-7000,-7000
06999P,玉晶光國票9B售01,0,0,0,0,0,0,0,0,0,-7000,0,0,0,4000,11000,-7000,-7000
07555P,玉晶光元大9A售07,0,0,0,0,0,0,0,0,0,-7000,0,0,0,1000,8000,-7000,-7000
07518P,臺股指元大9B售09,0,0,0,0,0,0,0,0,0,-7000,0,0,0,0,7000,-7000,-7000
1445,大宇            ,7000,14000,-7000,0,0,0,0,0,0,0,0,0,0,0,0,0,-7000
1432,大魯閣          ,0,7000,-7000,0,0,0,0,0,0,0,0,0,0,0,0,0,-7000
1468,昶和            ,0,7000,-7000,0,0,0,0,0,0,0,0,0,0,0,0,0,-7000
1459,聯發            ,0,7000,-7000,0,0,0,0,0,0,0,0,0,0,0,0,0,-7000
1724,台硝            ,0,3000,-3000,0,0,0,0,0,0,-4000,0,4000,-4000,0,0,0,-7000
2462,良得電          ,1000,8000,-7000,0,0,0,0,0,0,0,0,0,0,0,0,0,-7000
2506,太設            ,2000,7000,-5000,0,0,0,0,0,0,-2000,0,2000,-2000,0,0,0,-7000
2233,宇隆            ,11000,18000,-7000,0,0,0,0,0,0,0,0,0,0,0,0,0,-7000
2414,精技            ,3000,8000,-5000,0,0,0,0,0,0,-2000,0,2000,-2000,0,0,0,-7000
2415,錩新            ,0,7000,-7000,0,0,0,0,0,0,0,0,0,0,0,0,0,-7000
2438,翔耀            ,0,7000,-7000,0,0,0,0,0,0,0,0,0,0,0,0,0,-7000
0055,元大MSCI金融    ,1000,0,1000,0,0,0,0,0,0,-8000,0,4000,-4000,0,4000,-4000,-7000
054160,華泰凱基98購01  ,0,0,0,0,0,0,0,0,0,-7000,0,0,0,33000,40000,-7000,-7000
054210,台光電國票97購03,0,0,0,0,0,0,0,0,0,-7000,0,0,0,38000,45000,-7000,-7000
058387,國巨國票9A購03  ,0,0,0,0,0,0,0,0,0,-7000,0,0,0,14000,21000,-7000,-7000
058669,上銀群益99購01  ,0,0,0,0,0,0,0,0,0,-7000,0,0,0,0,7000,-7000,-7000
053198,亞德客日盛96購01,0,0,0,0,0,0,0,0,0,-7000,0,0,0,1000,8000,-7000,-7000
053209,台積電凱基96購07,0,0,0,0,0,0,0,0,0,-7000,0,0,0,11000,18000,-7000,-7000
054891,聯鈞統一99購02  ,0,0,0,0,0,0,0,0,0,-7000,0,0,0,0,7000,-7000,-7000
054892,彩晶統一99購01  ,0,0,0,0,0,0,0,0,0,-7000,0,0,0,0,7000,-7000,-7000
052799,上銀元大96購01  ,0,0,0,0,0,0,0,0,0,-7000,0,0,0,0,7000,-7000,-7000
055405,華泰國泰98購01  ,0,0,0,0,0,0,0,0,0,-7000,0,0,0,0,7000,-7000,-7000
055339,緯穎兆豐98購01  ,0,0,0,0,0,0,0,0,0,-7000,0,0,0,0,7000,-7000,-7000
059058,可成凱基9B購01  ,0,0,0,0,0,0,0,0,0,-7000,0,0,0,6000,13000,-7000,-7000
058019,美律凱基99購04  ,0,0,0,0,0,0,0,0,0,-7000,0,0,0,0,7000,-7000,-7000
058011,台虹國票99購01  ,0,0,0,0,0,0,0,0,0,-7000,0,0,0,0,7000,-7000,-7000
058040,FBVIX元大98購01 ,0,0,0,0,0,0,0,0,0,-7000,0,0,0,0,7000,-7000,-7000
058041,FBVIX元大98購02 ,0,0,0,0,0,0,0,0,0,-7000,0,0,0,0,7000,-7000,-7000
058201,華通凱基9A購01  ,0,0,0,0,0,0,0,0,0,-7000,0,0,0,0,7000,-7000,-7000
058196,台塑中信99購01  ,0,0,0,0,0,0,0,0,0,-7000,0,0,0,5000,12000,-7000,-7000
057309,南茂兆豐99購01  ,0,0,0,0,0,0,0,0,0,-7000,0,0,0,0,7000,-7000,-7000
055935,創意群益97購02  ,0,0,0,0,0,0,0,0,0,-7000,0,0,0,8000,15000,-7000,-7000
056120,聯茂群益97購02  ,0,0,0,0,0,0,0,0,0,-7000,0,0,0,0,7000,-7000,-7000
057454,上銀國泰99購02  ,0,0,0,0,0,0,0,0,0,-7000,0,0,0,29000,36000,-7000,-7000
058208,百和凱基99購01  ,0,0,0,0,0,0,0,0,0,-7000,0,0,0,0,7000,-7000,-7000
059766,同欣電永豐99購03,0,0,0,0,0,0,0,0,0,-7000,0,0,0,11000,18000,-7000,-7000
3501,維熹            ,7000,14000,-7000,0,0,0,0,0,0,0,0,0,0,0,0,0,-7000
3416,融程電          ,0,5000,-5000,0,0,0,0,0,0,-2000,0,2000,-2000,0,0,0,-7000
6133,金橋            ,1000,7000,-6000,0,0,0,0,0,0,-1000,0,1000,-1000,0,0,0,-7000
6152,百一            ,0,7000,-7000,0,0,0,0,0,0,0,0,0,0,0,0,0,-7000
6184,大豐電          ,8000,15000,-7000,0,0,0,0,0,0,0,0,0,0,0,0,0,-7000
6281,全國電          ,1000,7000,-6000,0,0,0,0,0,0,-1000,0,1000,-1000,0,0,0,-7000
9105,泰金寶-DR       ,0,7000,-7000,0,0,0,0,0,0,0,0,0,0,0,0,0,-7000
059552,台灣50凱基99購04,0,0,0,0,0,0,0,0,0,-7000,0,0,0,0,7000,-7000,-7000
059500,鴻海元富99購11  ,0,0,0,0,0,0,0,0,0,-7000,0,0,0,13000,20000,-7000,-7000
2611,志信            ,4000,11000,-7000,0,0,0,0,0,0,0,0,0,0,0,0,0,-7000
2543,皇昌            ,4000,11000,-7000,0,0,0,0,0,0,0,0,0,0,0,0,0,-7000
2712,遠雄來          ,2000,9000,-7000,0,0,0,0,0,0,0,0,0,0,0,0,0,-7000
3015,全漢            ,45000,51000,-6000,0,0,0,0,0,0,-1000,0,1000,-1000,0,0,0,-7000
3031,佰鴻            ,55000,62000,-7000,0,0,0,0,0,0,0,0,0,0,0,0,0,-7000
2351,順德            ,64000,91000,-27000,0,0,0,39000,17000,22000,-3000,0,3000,-3000,0,0,0,-8000
9943,好樂迪          ,12000,20000,-8000,0,0,0,0,0,0,0,0,0,0,0,0,0,-8000
1463,強盛            ,1000,9000,-8000,0,0,0,0,0,0,0,0,0,0,0,0,0,-8000
1220,台榮            ,0,8000,-8000,0,0,0,0,0,0,0,0,0,0,0,0,0,-8000
07717P,臺股指群益9A售06,0,0,0,0,0,0,0,0,0,-8000,0,0,0,7000,15000,-8000,-8000
07194P,聯發科元大99售25,0,0,0,0,0,0,0,0,0,-8000,0,0,0,1000,9000,-8000,-8000
06825P,臺股指國票98售01,0,0,0,0,0,0,0,0,0,-8000,0,0,0,0,8000,-8000,-8000
06271P,彩晶凱基97售01  ,0,0,0,0,0,0,0,0,0,-8000,0,0,0,22000,30000,-8000,-8000
061257,上銀凱基9A購06  ,0,0,0,0,0,0,0,0,0,-8000,0,0,0,0,8000,-8000,-8000
061058,健策國票9A購05  ,0,0,0,0,0,0,0,0,0,-8000,0,0,0,22000,30000,-8000,-8000
060230,台積電元大9A購07,0,0,0,0,0,0,0,0,0,-8000,0,0,0,7000,15000,-8000,-8000
06068P,玉晶光康和97售01,0,0,0,0,0,0,0,0,0,-8000,0,0,0,2000,10000,-8000,-8000
060673,旺宏元大9A購04  ,0,0,0,0,0,0,0,0,0,-8000,0,0,0,7000,15000,-8000,-8000
060576,欣興中信9B購01  ,0,0,0,0,0,0,0,0,0,-8000,0,0,0,51000,59000,-8000,-8000
060464,台積電元大9A購11,0,0,0,0,0,0,0,0,0,-8000,0,0,0,1000,9000,-8000,-8000
060560,欣興國泰9C購01  ,0,0,0,0,0,0,0,0,0,-8000,0,0,0,0,8000,-8000,-8000
054921,文曄凱基97購01  ,0,0,0,0,0,0,0,0,0,-8000,0,0,0,52000,60000,-8000,-8000
054589,聯鈞國泰99購01  ,0,0,0,0,0,0,0,0,0,-8000,0,0,0,3000,11000,-8000,-8000
057773,技嘉群益9A購02  ,0,0,0,0,0,0,0,0,0,-8000,0,0,0,0,8000,-8000,-8000
058642,旺宏麥證9A購01  ,0,0,0,12000,20000,-8000,0,0,0,-8000,0,0,0,12000,20000,-8000,-8000
058347,玉晶光群益9B購01,0,0,0,0,0,0,0,0,0,-8000,0,0,0,52000,60000,-8000,-8000
058338,康友元富99購01  ,0,0,0,0,0,0,0,0,0,-8000,0,0,0,2000,10000,-8000,-8000
053064,國巨群益96購04  ,0,0,0,0,0,0,0,0,0,-8000,0,0,0,8000,16000,-8000,-8000
053067,牧德群益96購01  ,0,0,0,0,0,0,0,0,0,-8000,0,0,0,12000,20000,-8000,-8000
053639,禾伸堂永豐96購01,0,0,0,0,0,0,0,0,0,-8000,0,0,0,43000,51000,-8000,-8000
05189P,新光金凱基97售02,0,0,0,0,0,0,0,0,0,-8000,0,0,0,40000,48000,-8000,-8000
00641R,富邦日本反1     ,1000,1000,0,0,0,0,0,0,0,-8000,0,0,0,161000,169000,-8000,-8000
049552,鴻海國泰96購01  ,0,0,0,0,0,0,0,0,0,-8000,0,0,0,0,8000,-8000,-8000
042752,台灣50元大96購03,0,0,0,0,0,0,0,0,0,-8000,0,0,0,0,8000,-8000,-8000
050522,聯發科元大95購03,0,0,0,0,0,0,0,0,0,-8000,0,0,0,0,8000,-8000,-8000
060213,牧德康和9A購01  ,0,0,0,0,0,0,0,0,0,-8000,0,0,0,45000,53000,-8000,-8000
057526,智邦元大98購10  ,0,0,0,0,0,0,0,0,0,-8000,0,0,0,12000,20000,-8000,-8000
059596,大立光元大99購20,0,0,0,0,0,0,0,0,0,-8000,0,0,0,3000,11000,-8000,-8000
057596,聯茂兆豐99購01  ,0,0,0,0,0,0,0,0,0,-8000,0,0,0,5000,13000,-8000,-8000
059303,國巨兆豐99購04  ,0,0,0,0,0,0,0,0,0,-8000,0,0,0,2000,10000,-8000,-8000
059276,可成元大99購06  ,0,0,0,0,0,0,0,0,0,-8000,0,0,0,73000,81000,-8000,-8000
05612P,台積電元大96售13,0,0,0,0,0,0,0,0,0,-8000,0,0,0,2000,10000,-8000,-8000
055572,鴻海統一98購04  ,0,0,0,0,0,0,0,0,0,-8000,0,0,0,0,8000,-8000,-8000
056119,欣興群益97購02  ,0,0,0,0,0,0,0,0,0,-8000,0,0,0,0,8000,-8000,-8000
056224,聯發科凱基97購08,0,0,0,0,0,0,0,0,0,-8000,0,0,0,0,8000,-8000,-8000
057151,易華電國票99購01,0,0,0,0,0,0,0,0,0,-8000,0,0,0,39000,47000,-8000,-8000
057147,新日興國票99購01,0,0,0,0,0,0,0,0,0,-8000,0,0,0,1000,9000,-8000,-8000
059216,台積電元大99購29,0,0,0,0,0,0,0,0,0,-8000,0,0,0,0,8000,-8000,-8000
059068,台虹國票9A購01  ,0,0,0,0,0,0,0,0,0,-8000,0,0,0,0,8000,-8000,-8000
058265,奇力新永豐9A購01,0,0,0,0,0,0,0,0,0,-8000,0,0,0,17000,25000,-8000,-8000
059171,祥碩凱基99購04  ,0,0,0,0,0,0,0,0,0,-8000,0,0,0,54000,62000,-8000,-8000
058009,智易國票99購01  ,0,0,0,0,0,0,0,0,0,-8000,0,0,0,12000,20000,-8000,-8000
058006,台郡群益98購04  ,0,0,0,0,0,0,0,0,0,-8000,0,0,0,2000,10000,-8000,-8000
057949,南電國票99購01  ,0,0,0,0,0,0,0,0,0,-8000,0,0,0,37000,45000,-8000,-8000
05853P,欣興群益96售05  ,0,0,0,0,0,0,0,0,0,-8000,0,0,0,0,8000,-8000,-8000
058540,嘉聯益國泰9A購02,0,0,0,0,0,0,0,0,0,-8000,0,0,0,0,8000,-8000,-8000
056702,欣興國泰9A購01  ,0,0,0,0,0,0,0,0,0,-8000,0,0,0,37000,45000,-8000,-8000
2908,特力            ,3000,5000,-2000,0,0,0,0,0,0,-6000,0,6000,-6000,0,0,0,-8000
2881A,富邦特          ,3000,11000,-8000,0,0,0,0,0,0,0,0,0,0,0,0,0,-8000
8499,鼎炫-KY         ,3000,11000,-8000,0,0,0,0,0,0,0,0,0,0,0,0,0,-8000
059345,禾伸堂凱基99購03,0,0,0,0,0,0,0,0,0,-8000,0,0,0,15000,23000,-8000,-8000
6215,和椿            ,5000,13000,-8000,0,0,0,0,0,0,0,0,0,0,0,0,0,-8000
6464,台數科          ,0,8000,-8000,0,0,0,0,0,0,0,0,0,0,0,0,0,-8000
6164,華興            ,1000,6000,-5000,0,0,0,0,0,0,-3000,0,3000,-3000,0,0,0,-8000
3694,海華            ,3000,10000,-7000,0,0,0,0,0,0,-1000,0,1000,-1000,0,0,0,-8000
3617,碩天            ,26000,30000,-4000,0,0,0,0,1000,-1000,-3000,0,2000,-2000,0,1000,-1000,-8000
4560,強信-KY         ,54000,62000,-8000,0,0,0,0,0,0,0,0,0,0,0,0,0,-8000
3701,大眾控          ,0,8000,-8000,0,0,0,0,0,0,0,0,0,0,0,0,0,-8000
8473,山林水          ,2225,11000,-8775,0,0,0,0,0,0,0,0,0,0,0,0,0,-8775
061089,台積電統一9C購04,0,0,0,0,0,0,0,0,0,-9000,0,0,0,20000,29000,-9000,-9000
061056,臺指反國票02購01,0,0,0,0,0,0,0,0,0,-9000,0,0,0,0,9000,-9000,-9000
061015,旺宏麥證9A購03  ,0,0,0,0,9000,-9000,0,0,0,-9000,0,0,0,0,9000,-9000,-9000
060838,華通國票9A購05  ,0,0,0,0,0,0,0,0,0,-9000,0,0,0,5000,14000,-9000,-9000
06706P,智原台新98售02  ,0,0,0,0,0,0,0,0,0,-9000,0,0,0,2000,11000,-9000,-9000
07112P,聯發科群益99售05,0,0,0,0,0,0,0,0,0,-9000,0,0,0,1000,10000,-9000,-9000
07532P,台灣50中信01售02,0,0,0,0,0,0,0,0,0,-9000,0,0,0,1000,10000,-9000,-9000
07497P,鴻海元大9A售06  ,0,0,0,0,0,0,0,0,0,-9000,0,0,0,25000,34000,-9000,-9000
07712P,茂林元大9A售03  ,0,0,0,0,0,0,0,0,0,-9000,0,0,0,0,9000,-9000,-9000
1541,錩泰            ,3000,8000,-5000,0,0,0,0,0,0,-4000,0,4000,-4000,0,0,0,-9000
1727,中華化          ,2000,11000,-9000,0,0,0,0,0,0,0,0,0,0,0,0,0,-9000
2024,志聯            ,0,9000,-9000,0,0,0,0,0,0,0,0,0,0,0,0,0,-9000
1817,凱撒衛          ,0,8000,-8000,0,0,0,0,0,0,-1000,0,1000,-1000,0,0,0,-9000
8070,長華*           ,9000,16000,-7000,0,0,0,0,1000,-1000,-1000,0,1000,-1000,0,0,0,-9000
2483,百容            ,1000,9000,-8000,0,0,0,0,0,0,-1000,0,1000,-1000,0,0,0,-9000
2516,新建            ,6000,15000,-9000,0,0,0,0,0,0,0,0,0,0,0,0,0,-9000
6698,旭暉應材        ,17000,26000,-9000,0,0,0,0,0,0,0,0,0,0,0,0,0,-9000
2231,為升            ,136000,143000,-7000,0,0,0,0,0,0,-2000,1000,4000,-3000,9000,8000,1000,-9000
2380,虹光            ,0,9000,-9000,0,0,0,0,0,0,0,0,0,0,0,0,0,-9000
05057P,鴻海國票96售01  ,0,0,0,0,0,0,0,0,0,-9000,0,0,0,0,9000,-9000,-9000
050760,矽力元富94購03  ,0,0,0,0,0,0,0,0,0,-9000,0,0,0,1000,10000,-9000,-9000
042953,鴻海台新01購01  ,0,0,0,0,0,0,0,0,0,-9000,0,0,0,0,9000,-9000,-9000
00715L,街口布蘭特油正2 ,285000,0,285000,0,0,0,0,0,0,-294000,0,0,0,830000,1124000,-294000,-9000
00770,國泰北美科技    ,0,0,0,0,0,0,0,0,0,-9000,0,0,0,12000,21000,-9000,-9000
00763U,街口道瓊銅      ,0,0,0,0,0,0,0,0,0,-9000,0,0,0,7000,16000,-9000,-9000
054270,寶滬深中信98購01,0,0,0,0,0,0,0,0,0,-9000,0,0,0,0,9000,-9000,-9000
054111,緯穎凱基97購01  ,0,0,0,0,0,0,0,0,0,-9000,0,0,0,13000,22000,-9000,-9000
052295,揚明光國票96購03,0,0,0,0,0,0,0,0,0,-9000,0,0,0,16000,25000,-9000,-9000
058335,鴻海元富99購06  ,0,0,0,0,0,0,0,0,0,-9000,0,0,0,0,9000,-9000,-9000
057828,緯穎元大99購02  ,0,0,0,0,0,0,0,0,0,-9000,0,0,0,0,9000,-9000,-9000
05471P,聯電統一95售01  ,0,0,0,0,0,0,0,0,0,-9000,0,0,0,0,9000,-9000,-9000
054479,緯創中信98購01  ,0,0,0,0,0,0,0,0,0,-9000,0,0,0,0,9000,-9000,-9000
05487P,台表科凱基95售02,0,0,0,0,0,0,0,0,0,-9000,0,0,0,0,9000,-9000,-9000
055026,健和興國泰98購01,0,0,0,0,0,0,0,0,0,-9000,0,0,0,1000,10000,-9000,-9000
055197,致新元富97購02  ,0,0,0,0,0,0,0,0,0,-9000,0,0,0,44000,53000,-9000,-9000
052615,鴻海國泰98購01  ,0,0,0,0,0,0,0,0,0,-9000,0,0,0,0,9000,-9000,-9000
052616,鴻海國泰98購02  ,0,0,0,0,0,0,0,0,0,-9000,0,0,0,0,9000,-9000,-9000
052885,高鐵兆豐98購01  ,0,0,0,0,0,0,0,0,0,-9000,0,0,0,1000,10000,-9000,-9000
05289P,鴻海永豐95售05  ,0,0,0,0,0,0,0,0,0,-9000,0,0,0,1000,10000,-9000,-9000
052953,百和國票97購01  ,0,0,0,0,0,0,0,0,0,-9000,0,0,0,0,9000,-9000,-9000
057923,晶豪科凱基98購02,0,0,0,0,0,0,0,0,0,-9000,0,0,0,0,9000,-9000,-9000
058080,台積電群益98購06,0,0,0,0,0,0,0,0,0,-9000,0,0,0,61000,70000,-9000,-9000
055796,南電國泰98購01  ,0,0,0,0,0,0,0,0,0,-9000,0,0,0,2000,11000,-9000,-9000
059300,國巨群益99購08  ,0,0,0,0,0,0,0,0,0,-9000,0,0,0,0,9000,-9000,-9000
057601,中磊群益98購01  ,0,0,0,0,0,0,0,0,0,-9000,0,0,0,1000,10000,-9000,-9000
057529,嘉晶元大99購02  ,0,0,0,0,0,0,0,0,0,-9000,0,0,0,0,9000,-9000,-9000
057580,玉山金中信9A購01,0,0,0,0,0,0,0,0,0,-9000,0,0,0,0,9000,-9000,-9000
060066,欣興兆豐9B購01  ,0,0,0,0,0,0,0,0,0,-9000,0,0,0,0,9000,-9000,-9000
9917,中保科          ,31000,29000,2000,0,0,0,1000,1000,0,-11000,0,11000,-11000,0,0,0,-9000
2832,台產            ,10000,9000,1000,0,0,0,0,0,0,-10000,0,10000,-10000,0,0,0,-9000
2613,中櫃            ,0,5000,-5000,0,0,0,0,0,0,-4000,0,4000,-4000,0,0,0,-9000
05948P,茂林元大96售03  ,0,0,0,0,0,0,0,0,0,-9000,0,0,0,1000,10000,-9000,-9000
6128,上福            ,2000,10000,-8000,0,0,0,0,0,0,-1000,0,1000,-1000,0,0,0,-9000
5538,東明-KY         ,1000,10000,-9000,0,0,0,0,0,0,0,0,0,0,0,0,0,-9000
6449,鈺邦            ,20000,28000,-8000,0,0,0,0,0,0,-1000,2000,3000,-1000,0,0,0,-9000
2397,友通            ,3000,11000,-8000,0,0,0,0,0,0,-2000,0,2000,-2000,0,0,0,-10000
6579,研揚            ,2000,11000,-9000,0,0,0,0,0,0,-1000,0,1000,-1000,0,0,0,-10000
8374,羅昇            ,1000,11000,-10000,0,0,0,0,0,0,0,0,0,0,0,0,0,-10000
1713,國化            ,1000,11000,-10000,0,0,0,0,0,0,0,0,0,0,0,0,0,-10000
08525P,台灣50凱基96售02,0,0,0,0,0,0,0,0,0,-10000,0,0,0,430000,440000,-10000,-10000
08852P,台灣50台新01售01,0,0,0,0,0,0,0,0,0,-10000,0,0,0,0,10000,-10000,-10000
1231,聯華食          ,13000,23000,-10000,0,0,0,0,0,0,0,0,0,0,0,0,0,-10000
1442,名軒            ,16000,19000,-3000,0,0,0,0,5000,-5000,-2000,0,2000,-2000,0,0,0,-10000
07489P,國巨國票9A售07  ,0,0,0,0,0,0,0,0,0,-10000,0,0,0,0,10000,-10000,-10000
07463P,台積電國票9A售05,0,0,0,0,0,0,0,0,0,-10000,0,0,0,20000,30000,-10000,-10000
07525P,臺股指中信9B售07,0,0,0,0,0,0,0,0,0,-10000,0,0,0,0,10000,-10000,-10000
07519P,臺股指元大9B售10,0,0,0,0,0,0,0,0,0,-10000,0,0,0,0,10000,-10000,-10000
07492P,臺股指國票9A售10,0,0,0,0,0,0,0,0,0,-10000,0,0,0,0,10000,-10000,-10000
07554P,玉晶光元大9A售06,0,0,0,0,0,0,0,0,0,-10000,0,0,0,0,10000,-10000,-10000
07639P,緯穎國票9A售01  ,0,0,0,0,0,0,0,0,0,-10000,0,0,0,10000,20000,-10000,-10000
07619P,鴻海統一9A售03  ,0,0,0,0,0,0,0,0,0,-10000,0,0,0,0,10000,-10000,-10000
07348P,滬深2X凱基9A售04,0,0,0,0,0,0,0,0,0,-10000,0,0,0,0,10000,-10000,-10000
07339P,滬深2X凱基9A售03,0,0,0,0,0,0,0,0,0,-10000,0,0,0,0,10000,-10000,-10000
07437P,臺股指麥證9A售04,0,0,0,0,10000,-10000,0,0,0,-10000,0,0,0,0,10000,-10000,-10000
07405P,大立光凱基99售17,0,0,0,0,0,0,0,0,0,-10000,0,0,0,5000,15000,-10000,-10000
07122P,欣興凱基99售05  ,0,0,0,0,0,0,0,0,0,-10000,0,0,0,0,10000,-10000,-10000
07119P,台積電凱基9A售08,0,0,0,0,0,0,0,0,0,-10000,0,0,0,0,10000,-10000,-10000
06991P,矽創群益99售01  ,0,0,0,0,0,0,0,0,0,-10000,0,0,0,0,10000,-10000,-10000
07248P,可成凱基99售06  ,0,0,0,0,0,0,0,0,0,-10000,0,0,0,0,10000,-10000,-10000
07142P,台灣50元大01售01,0,0,0,0,0,0,0,0,0,-10000,0,0,0,0,10000,-10000,-10000
07133P,臺股指元大9A售27,0,0,0,0,0,0,0,0,0,-10000,0,0,0,10000,20000,-10000,-10000
06773P,台灣50兆豐9A售01,0,0,0,0,0,0,0,0,0,-10000,0,0,0,0,10000,-10000,-10000
06778P,台積電元大99售06,0,0,0,0,0,0,0,0,0,-10000,0,0,0,0,10000,-10000,-10000
06901P,亞德客凱基98售02,0,0,0,0,0,0,0,0,0,-10000,0,0,0,0,10000,-10000,-10000
06922P,元上證群益9C售01,0,0,0,0,0,0,0,0,0,-10000,0,0,0,0,10000,-10000,-10000
06876P,台灣50兆豐9B售01,0,0,0,0,0,0,0,0,0,-10000,0,0,0,0,10000,-10000,-10000
06851P,鈺齊元大98售01  ,0,0,0,0,0,0,0,0,0,-10000,0,0,0,0,10000,-10000,-10000
06535P,可成群益99售02  ,0,0,0,0,0,0,0,0,0,-10000,0,0,0,0,10000,-10000,-10000
06479P,聯發科中信99售02,0,0,0,0,0,0,0,0,0,-10000,0,0,0,11000,21000,-10000,-10000
06552P,茂林元大99售02  ,0,0,0,0,0,0,0,0,0,-10000,0,0,0,0,10000,-10000,-10000
06567P,鴻海永豐98售02  ,0,0,0,0,0,0,0,0,0,-10000,0,0,0,0,10000,-10000,-10000
06599P,宏達電永豐98售02,0,0,0,0,0,0,0,0,0,-10000,0,0,0,0,10000,-10000,-10000
06709P,臺股指台新99售06,0,0,0,0,0,0,0,0,0,-10000,0,0,0,0,10000,-10000,-10000
06682P,玉晶光元大99售08,0,0,0,0,0,0,0,0,0,-10000,0,0,0,0,10000,-10000,-10000
061238,晶技元大9A購02  ,0,0,0,0,0,0,0,0,0,-10000,0,0,0,5000,15000,-10000,-10000
061274,臺股指凱基9A購24,0,0,0,0,0,0,0,0,0,-10000,0,0,0,0,10000,-10000,-10000
061220,臺股指元大9A購57,0,0,0,0,0,0,0,0,0,-10000,0,0,0,10000,20000,-10000,-10000
06326P,鴻海中信01售01  ,0,0,0,0,0,0,0,0,0,-10000,0,0,0,0,10000,-10000,-10000
06219P,國巨元富97售05  ,0,0,0,0,0,0,0,0,0,-10000,0,0,0,0,10000,-10000,-10000
06263P,燿華凱基97售04  ,0,0,0,0,0,0,0,0,0,-10000,0,0,0,0,10000,-10000,-10000
06399P,台表科凱基97售05,0,0,0,0,0,0,0,0,0,-10000,0,0,0,0,10000,-10000,-10000
06392P,T50反1元大9A售01,0,0,0,0,0,0,0,0,0,-10000,0,0,0,0,10000,-10000,-10000
06364P,鴻海凱基97售08  ,0,0,0,0,0,0,0,0,0,-10000,0,0,0,0,10000,-10000,-10000
06425P,TPK永豐97售02   ,0,0,0,0,0,0,0,0,0,-10000,0,0,0,0,10000,-10000,-10000
061305,帆宣永豐9A購01  ,0,0,0,0,0,0,0,0,0,-10000,0,0,0,0,10000,-10000,-10000
061317,旺宏凱基9A購05  ,0,0,0,0,0,0,0,0,0,-10000,0,0,0,0,10000,-10000,-10000
06195P,台積電元富97售06,0,0,0,0,0,0,0,0,0,-10000,0,0,0,0,10000,-10000,-10000
06100P,台積電日盛97售03,0,0,0,0,0,0,0,0,0,-10000,0,0,0,40000,50000,-10000,-10000
06650P,聯發科元大98售09,0,0,0,0,0,0,0,0,0,-10000,0,0,0,0,10000,-10000,-10000
06613P,華新科富邦9A售03,0,0,0,0,0,0,0,0,0,-10000,0,0,0,0,10000,-10000,-10000
06626P,大立光統一9A售01,0,0,0,0,0,0,0,0,0,-10000,0,0,0,30000,40000,-10000,-10000
061096,上証2X元大9A購06,0,0,0,0,0,0,0,0,0,-10000,0,0,0,0,10000,-10000,-10000
061101,道瓊銀元大9A購02,0,0,0,0,0,0,0,0,0,-10000,0,0,0,0,10000,-10000,-10000
061119,國巨永豐9A購03  ,0,0,0,0,0,0,0,0,0,-10000,0,0,0,0,10000,-10000,-10000
060705,台光電富邦9B購01,0,0,0,0,0,0,0,0,0,-10000,0,0,0,103000,113000,-10000,-10000
060707,台郡富邦9A購01  ,0,0,0,0,0,0,0,0,0,-10000,0,0,0,297000,307000,-10000,-10000
060254,世紀鋼元大9A購01,0,0,0,0,0,0,0,0,0,-10000,0,0,0,35000,45000,-10000,-10000
060682,牧德元大9A購03  ,0,0,0,0,0,0,0,0,0,-10000,0,0,0,37000,47000,-10000,-10000
060306,台肥永豐9A購01  ,0,0,0,0,0,0,0,0,0,-10000,0,0,0,0,10000,-10000,-10000
060537,台灣50凱基9B購01,0,0,0,0,0,0,0,0,0,-10000,0,0,0,20000,30000,-10000,-10000
060532,欣興中信9A購01  ,0,0,0,0,0,0,0,0,0,-10000,0,0,0,0,10000,-10000,-10000
060482,東元富邦9A購01  ,0,0,0,0,0,0,0,0,0,-10000,0,0,0,0,10000,-10000,-10000
060584,玉晶光元富9A購01,0,0,0,0,0,0,0,0,0,-10000,0,0,0,0,10000,-10000,-10000
052936,華通兆豐98購01  ,0,0,0,0,0,0,0,0,0,-10000,0,0,0,0,10000,-10000,-10000
052937,國巨兆豐97購01  ,0,0,0,0,0,0,0,0,0,-10000,0,0,0,0,10000,-10000,-10000
052939,富邦金兆豐96購01,0,0,0,0,0,0,0,0,0,-10000,0,0,0,0,10000,-10000,-10000
055425,聚陽群益99購01  ,0,0,0,0,0,0,0,0,0,-10000,0,0,0,20000,30000,-10000,-10000
055426,旺宏群益99購02  ,0,0,0,0,0,0,0,0,0,-10000,0,0,0,0,10000,-10000,-10000
055188,亞翔統一97購01  ,0,0,0,0,0,0,0,0,0,-10000,0,0,0,0,10000,-10000,-10000
052642,滬深2X永豐96購03,0,0,0,0,0,0,0,0,0,-10000,0,0,0,0,10000,-10000,-10000
055499,大立光元大98購05,0,0,0,0,0,0,0,0,0,-10000,0,0,0,0,10000,-10000,-10000
055144,T50反1元大97購03,0,0,0,0,0,0,0,0,0,-10000,0,0,0,0,10000,-10000,-10000
055120,南港兆豐97購01  ,0,0,0,0,0,0,0,0,0,-10000,0,0,0,0,10000,-10000,-10000
055123,億光兆豐97購01  ,0,0,0,0,0,0,0,0,0,-10000,0,0,0,0,10000,-10000,-10000
052696,玉晶光麥證97購01,0,0,0,45000,27000,18000,0,0,0,-10000,0,0,0,61000,71000,-10000,-10000
055282,聯發科元大97購15,0,0,0,0,0,0,0,0,0,-10000,0,0,0,0,10000,-10000,-10000
055310,聯詠群益97購02  ,0,0,0,0,0,0,0,0,0,-10000,0,0,0,0,10000,-10000,-10000
055052,凱美永豐97購01  ,0,0,0,0,0,0,0,0,0,-10000,0,0,0,0,10000,-10000,-10000
055056,億光永豐97購01  ,0,0,0,0,0,0,0,0,0,-10000,0,0,0,0,10000,-10000,-10000
054848,群創兆豐98購01  ,0,0,0,0,0,0,0,0,0,-10000,0,0,0,0,10000,-10000,-10000
054840,T50反1兆豐98購01,0,0,0,0,0,0,0,0,0,-10000,0,0,0,0,10000,-10000,-10000
054790,禾伸堂群益98購01,0,0,0,0,0,0,0,0,0,-10000,0,0,0,0,10000,-10000,-10000
05520P,聯詠凱基96售01  ,0,0,0,0,0,0,0,0,0,-10000,0,0,0,0,10000,-10000,-10000
054688,兆赫永豐97購01  ,0,0,0,0,0,0,0,0,0,-10000,0,0,0,0,10000,-10000,-10000
054582,致新元大97購01  ,0,0,0,0,0,0,0,0,0,-10000,0,0,0,124000,134000,-10000,-10000
054608,致茂永豐97購01  ,0,0,0,0,0,0,0,0,0,-10000,0,0,0,0,10000,-10000,-10000
054621,華新科兆豐98購01,0,0,0,0,0,0,0,0,0,-10000,0,0,0,0,10000,-10000,-10000
057796,鴻海兆豐99購03  ,0,0,0,0,0,0,0,0,0,-10000,0,0,0,0,10000,-10000,-10000
058361,美律凱基99購06  ,0,0,0,0,0,0,0,0,0,-10000,0,0,0,5000,15000,-10000,-10000
058357,智邦凱基99購02  ,0,0,0,0,0,0,0,0,0,-10000,0,0,0,0,10000,-10000,-10000
058333,鴻海元富99購04  ,0,0,0,0,0,0,0,0,0,-10000,0,0,0,20000,30000,-10000,-10000
058331,鴻海元富99購02  ,0,0,0,0,0,0,0,0,0,-10000,0,0,0,3000000,3010000,-10000,-10000
057741,超眾富邦98購01  ,0,0,0,0,0,0,0,0,0,-10000,0,0,0,0,10000,-10000,-10000
05320P,華通凱基96售03  ,0,0,0,0,0,0,0,0,0,-10000,0,0,0,0,10000,-10000,-10000
056264,聯發科統一98購02,0,0,0,0,0,0,0,0,0,-10000,0,0,0,0,10000,-10000,-10000
056325,群創兆豐9A購01  ,0,0,0,0,0,0,0,0,0,-10000,0,0,0,0,10000,-10000,-10000
053497,新光金兆豐97購01,0,0,0,0,0,0,0,0,0,-10000,0,0,0,0,10000,-10000,-10000
053550,聯發科凱基96購15,0,0,0,0,0,0,0,0,0,-10000,0,0,0,0,10000,-10000,-10000
053557,聯茂凱基96購04  ,0,0,0,0,0,0,0,0,0,-10000,0,0,0,0,10000,-10000,-10000
053447,京鼎凱基96購03  ,0,0,0,0,0,0,0,0,0,-10000,0,0,0,0,10000,-10000,-10000
055538,鴻海日盛97購04  ,0,0,0,0,0,0,0,0,0,-10000,0,0,0,20000,30000,-10000,-10000
053363,旺宏國泰98購02  ,0,0,0,0,0,0,0,0,0,-10000,0,0,0,175000,185000,-10000,-10000
053034,上海銀兆豐96購01,0,0,0,0,0,0,0,0,0,-10000,0,0,0,0,10000,-10000,-10000
053099,正崴元富96購01  ,0,0,0,0,0,0,0,0,0,-10000,0,0,0,0,10000,-10000,-10000
053086,宏達電元大97購01,0,0,0,0,0,0,0,0,0,-10000,0,0,0,0,10000,-10000,-10000
053701,台積電兆豐96購05,0,0,0,0,0,0,0,0,0,-10000,0,0,0,0,10000,-10000,-10000
053712,台光電凱基96購04,0,0,0,0,0,0,0,0,0,-10000,0,0,0,0,10000,-10000,-10000
053713,漢唐凱基96購04  ,0,0,0,0,0,0,0,0,0,-10000,0,0,0,38000,48000,-10000,-10000
053749,揚明光永豐97購01,0,0,0,0,0,0,0,0,0,-10000,0,0,0,0,10000,-10000,-10000
05379P,可成凱基95售11  ,0,0,0,0,0,0,0,0,0,-10000,0,0,0,0,10000,-10000,-10000
053769,香港反元大99購01,0,0,0,0,0,0,0,0,0,-10000,0,0,0,0,10000,-10000,-10000
053110,大立光兆豐97購01,0,0,0,0,0,0,0,0,0,-10000,0,0,0,0,10000,-10000,-10000
052297,旭富國票96購01  ,0,0,0,0,0,0,0,0,0,-10000,0,0,0,0,10000,-10000,-10000
052323,矽力元大95購04  ,0,0,0,0,0,0,0,0,0,-10000,0,0,0,0,10000,-10000,-10000
052353,高鐵群益97購01  ,0,0,0,0,0,0,0,0,0,-10000,0,0,0,0,10000,-10000,-10000
05222P,致伸凱基95售02  ,0,0,0,0,0,0,0,0,0,-10000,0,0,0,0,10000,-10000,-10000
052477,美律群益98購01  ,0,0,0,0,0,0,0,0,0,-10000,0,0,0,0,10000,-10000,-10000
054030,台苯中信98購01  ,0,0,0,0,0,0,0,0,0,-10000,0,0,0,0,10000,-10000,-10000
053919,可成國票97購02  ,0,0,0,0,0,0,0,0,0,-10000,0,0,0,0,10000,-10000,-10000
053935,華通元富96購02  ,0,0,0,0,0,0,0,0,0,-10000,0,0,0,0,10000,-10000,-10000
054115,台塑康和96購01  ,0,0,0,0,0,0,0,0,0,-10000,0,0,0,0,10000,-10000,-10000
054104,T50反1凱基9A購02,0,0,0,0,0,0,0,0,0,-10000,0,0,0,0,10000,-10000,-10000
054063,聯茂國票97購02  ,0,0,0,0,0,0,0,0,0,-10000,0,0,0,0,10000,-10000,-10000
054038,T50反1元大98購04,0,0,0,0,0,0,0,0,0,-10000,0,0,0,0,10000,-10000,-10000
05423P,聯電亞東95售02  ,0,0,0,0,0,0,0,0,0,-10000,0,0,0,0,10000,-10000,-10000
054337,智邦統一96購01  ,0,0,0,0,0,0,0,0,0,-10000,0,0,0,18000,28000,-10000,-10000
051872,矽力凱基96購01  ,0,0,0,0,0,0,0,0,0,-10000,0,0,0,0,10000,-10000,-10000
051808,美律凱基96購02  ,0,0,0,0,0,0,0,0,0,-10000,0,0,0,0,10000,-10000,-10000
051744,嘉聯益國票97購01,0,0,0,0,0,0,0,0,0,-10000,0,0,0,0,10000,-10000,-10000
051987,廣達元大95購01  ,0,0,0,0,0,0,0,0,0,-10000,0,0,0,0,10000,-10000,-10000
051956,滬深2X台新96購01,0,0,0,0,0,0,0,0,0,-10000,0,0,0,0,10000,-10000,-10000
052066,華邦電兆豐96購01,0,0,0,0,0,0,0,0,0,-10000,0,0,0,0,10000,-10000,-10000
052446,聯發科元大96購03,0,0,0,0,0,0,0,0,0,-10000,0,0,0,0,10000,-10000,-10000
052133,華邦電凱基9B購01,0,0,0,0,0,0,0,0,0,-10000,0,0,0,0,10000,-10000,-10000
052220,T50反1凱基98購01,0,0,0,0,0,0,0,0,0,-10000,0,0,0,0,10000,-10000,-10000
051461,聯詠國泰96購01  ,0,0,0,0,0,0,0,0,0,-10000,0,0,0,0,10000,-10000,-10000
051696,新日興中信96購01,0,0,0,0,0,0,0,0,0,-10000,0,0,0,0,10000,-10000,-10000
05155P,聯發科兆豐95售03,0,0,0,0,0,0,0,0,0,-10000,0,0,0,0,10000,-10000,-10000
051393,新光金兆豐96購01,0,0,0,0,0,0,0,0,0,-10000,0,0,0,0,10000,-10000,-10000
051394,奇鋐兆豐95購01  ,0,0,0,0,0,0,0,0,0,-10000,0,0,0,0,10000,-10000,-10000
051403,玉晶光永豐95購05,0,0,0,0,0,0,0,0,0,-10000,0,0,0,0,10000,-10000,-10000
050899,旭富元大95購01  ,0,0,0,0,0,0,0,0,0,-10000,0,0,0,0,10000,-10000,-10000
050915,健策中信98購01  ,0,0,0,0,0,0,0,0,0,-10000,0,0,0,10000,20000,-10000,-10000
051041,大立光永豐95購01,0,0,0,0,0,0,0,0,0,-10000,0,0,0,0,10000,-10000,-10000
048248,聯發科兆豐95購01,0,0,0,0,0,0,0,0,0,-10000,0,0,0,0,10000,-10000,-10000
048326,滬深2X國泰94購03,0,0,0,0,0,0,0,0,0,-10000,0,0,0,0,10000,-10000,-10000
00688L,國泰20年美債正2 ,0,0,0,0,0,0,0,0,0,-10000,0,0,0,314000,324000,-10000,-10000
00685L,群益臺灣加權正2 ,0,0,0,0,0,0,0,0,0,-10000,0,0,0,21000,31000,-10000,-10000
03412P,滬深2X群益98售01,0,0,0,0,0,0,0,0,0,-10000,0,0,0,0,10000,-10000,-10000
03647C,T50反1元富99牛02,0,0,0,0,0,0,0,0,0,-10000,0,0,0,0,10000,-10000,-10000
049117,矽格統一96購01  ,0,0,0,0,0,0,0,0,0,-10000,0,0,0,0,10000,-10000,-10000
049156,緯穎元大96購01  ,0,0,0,0,0,0,0,0,0,-10000,0,0,0,0,10000,-10000,-10000
048898,晶相光國泰96購01,0,0,0,0,0,0,0,0,0,-10000,0,0,0,0,10000,-10000,-10000
048747,華通元富97購01  ,0,0,0,0,0,0,0,0,0,-10000,0,0,0,0,10000,-10000,-10000
04881P,高股息凱基96售01,0,0,0,0,0,0,0,0,0,-10000,0,0,0,0,10000,-10000,-10000
042315,T50反1台新96購01,0,0,0,0,0,0,0,0,0,-10000,0,0,0,0,10000,-10000,-10000
041527,T50反1中信96購01,0,0,0,0,0,0,0,0,0,-10000,0,0,0,0,10000,-10000,-10000
03959P,義隆元富96售01  ,0,0,0,0,0,0,0,0,0,-10000,0,0,0,0,10000,-10000,-10000
03875P,滬深2X國票05售01,0,0,0,0,0,0,0,0,0,-10000,0,0,0,0,10000,-10000,-10000
045842,T50反1台新98購01,0,0,0,0,0,0,0,0,0,-10000,0,0,0,0,10000,-10000,-10000
04794P,友達元大96售03  ,0,0,0,0,0,0,0,0,0,-10000,0,0,0,0,10000,-10000,-10000
047420,全新富邦97購01  ,0,0,0,0,0,0,0,0,0,-10000,0,0,0,0,10000,-10000,-10000
047630,元油反元大96購02,0,1000,-1000,0,0,0,0,0,0,-9000,0,0,0,3000,12000,-9000,-10000
050786,健策國泰96購01  ,0,0,0,0,0,0,0,0,0,-10000,0,0,0,0,10000,-10000,-10000
050601,台表科國泰96購01,0,0,0,0,0,0,0,0,0,-10000,0,0,0,0,10000,-10000,-10000
050402,緯穎中信96購01  ,0,0,0,0,0,0,0,0,0,-10000,0,0,0,0,10000,-10000,-10000
050188,貿聯元大96購01  ,0,0,0,0,0,0,0,0,0,-10000,0,0,0,0,10000,-10000,-10000
050334,鴻海國泰96購07  ,0,0,0,0,0,0,0,0,0,-10000,0,0,0,10000,20000,-10000,-10000
049859,味全兆豐95購01  ,0,0,0,0,0,0,0,0,0,-10000,0,0,0,0,10000,-10000,-10000
060074,台積電元富99購04,0,0,0,0,0,0,0,0,0,-10000,0,0,0,0,10000,-10000,-10000
060077,台積電台新9B購01,0,0,0,0,0,0,0,0,0,-10000,0,0,0,21000,31000,-10000,-10000
060017,全新康和99購01  ,0,0,0,0,0,0,0,0,0,-10000,0,0,0,1000,11000,-10000,-10000
059968,世紀鋼凱基99購03,0,0,0,0,0,0,0,0,0,-10000,0,0,0,0,10000,-10000,-10000
060201,台表科元富9A購01,0,0,0,0,0,0,0,0,0,-10000,0,0,0,40000,50000,-10000,-10000
060152,上証2X永豐9A購02,0,0,0,0,0,0,0,0,0,-10000,0,0,0,0,10000,-10000,-10000
06017P,亞光凱基96售04  ,0,0,0,0,0,0,0,0,0,-10000,0,0,0,0,10000,-10000,-10000
060124,奇力新永豐99購03,0,0,0,0,0,0,0,0,0,-10000,0,0,0,5000,15000,-10000,-10000
057561,大立光兆豐98購02,0,0,0,0,0,0,0,0,0,-10000,0,0,0,0,10000,-10000,-10000
057683,技嘉日盛98購01  ,0,0,0,0,0,0,0,0,0,-10000,0,0,0,0,10000,-10000,-10000
058221,上銀統一99購04  ,0,0,0,0,0,0,0,0,0,-10000,0,0,0,0,10000,-10000,-10000
057640,台積電元大98購16,0,0,0,0,0,0,0,0,0,-10000,0,0,0,0,10000,-10000,-10000
057645,華新科元大99購11,0,0,0,0,0,0,0,0,0,-10000,0,0,0,20000,30000,-10000,-10000
057657,國巨兆豐98購04  ,0,0,0,0,0,0,0,0,0,-10000,0,0,0,0,10000,-10000,-10000
059728,聯鈞元大99購01  ,0,0,0,0,0,0,0,0,0,-10000,0,0,0,33000,43000,-10000,-10000
059720,台積電元大99購43,0,0,0,0,0,0,0,0,0,-10000,0,0,0,40000,50000,-10000,-10000
05574P,英業達元富96售01,0,0,0,0,0,0,0,0,0,-10000,0,0,0,0,10000,-10000,-10000
055754,和大兆豐97購01  ,0,0,0,0,0,0,0,0,0,-10000,0,0,0,0,10000,-10000,-10000
055747,康舒元富97購01  ,0,0,0,0,0,0,0,0,0,-10000,0,0,0,20000,30000,-10000,-10000
055761,創意群益97購01  ,0,0,0,0,0,0,0,0,0,-10000,0,0,0,0,10000,-10000,-10000
055780,禾伸堂凱基99購01,0,0,0,0,0,0,0,0,0,-10000,0,0,0,0,10000,-10000,-10000
059029,旺宏兆豐99購01  ,0,0,0,0,0,0,0,0,0,-10000,0,0,0,0,10000,-10000,-10000
057142,力成兆豐98購01  ,0,0,0,0,0,0,0,0,0,-10000,0,0,0,0,10000,-10000,-10000
056118,聯詠群益97購03  ,0,0,0,0,0,0,0,0,0,-10000,0,0,0,0,10000,-10000,-10000
056080,世紀鋼元大97購03,0,0,0,0,0,0,0,0,0,-10000,0,0,0,0,10000,-10000,-10000
056171,鴻海元富97購10  ,0,0,0,0,0,0,0,0,0,-10000,0,0,0,5000,15000,-10000,-10000
055917,禾伸堂凱基98購02,0,0,0,0,0,0,0,0,0,-10000,0,0,0,0,10000,-10000,-10000
055957,瑞昱元大97購06  ,0,0,0,0,0,0,0,0,0,-10000,0,0,0,0,10000,-10000,-10000
056043,力成凱基97購01  ,0,0,0,0,0,0,0,0,0,-10000,0,0,0,0,10000,-10000,-10000
059207,臺指反元大9C購02,0,0,0,0,0,0,0,0,0,-10000,0,0,0,0,10000,-10000,-10000
059240,台積電凱基9A購09,0,0,0,0,0,0,0,0,0,-10000,0,0,0,50000,60000,-10000,-10000
057292,國巨國泰9B購01  ,0,0,0,0,0,0,0,0,0,-10000,0,0,0,0,10000,-10000,-10000
057305,南亞科兆豐98購02,0,0,0,0,0,0,0,0,0,-10000,0,0,0,0,10000,-10000,-10000
057226,上銀凱基98購06  ,0,0,0,0,0,0,0,0,0,-10000,0,0,0,0,10000,-10000,-10000
055727,矽力元大97購02  ,0,0,0,0,0,0,0,0,0,-10000,0,0,0,0,10000,-10000,-10000
055637,亞德客元富97購01,0,0,0,0,0,0,0,0,0,-10000,0,0,0,0,10000,-10000,-10000
055648,可成元富97購01  ,0,0,0,0,0,0,0,0,0,-10000,0,0,0,0,10000,-10000,-10000
055668,欣興群益97購01  ,0,0,0,0,0,0,0,0,0,-10000,0,0,0,0,10000,-10000,-10000
057385,光罩永豐99購01  ,0,0,0,0,0,0,0,0,0,-10000,0,0,0,6000,16000,-10000,-10000
057425,臺股指凱基9C購02,0,0,0,0,0,0,0,0,0,-10000,0,0,0,0,10000,-10000,-10000
057408,台郡群益98購01  ,0,0,0,0,0,0,0,0,0,-10000,0,0,0,0,10000,-10000,-10000
057262,友達兆豐98購03  ,0,0,0,0,0,0,0,0,0,-10000,0,0,0,0,10000,-10000,-10000
058072,大立光凱基98購20,0,0,0,0,0,0,0,0,0,-10000,0,0,0,0,10000,-10000,-10000
058969,亞德客永豐99購01,0,0,0,0,0,0,0,0,0,-10000,0,0,0,3000,13000,-10000,-10000
056925,群創兆豐98購03  ,0,0,0,0,0,0,0,0,0,-10000,0,0,0,0,10000,-10000,-10000
058560,T50反1凱基9A購04,0,0,0,0,0,0,0,0,0,-10000,0,0,0,0,10000,-10000,-10000
058607,聯發科元大99購14,0,0,0,0,0,0,0,0,0,-10000,0,0,0,0,10000,-10000,-10000
058113,百和元富98購01  ,0,0,0,0,0,0,0,0,0,-10000,0,0,0,0,10000,-10000,-10000
058082,美律群益98購05  ,0,0,0,0,0,0,0,0,0,-10000,0,0,0,0,10000,-10000,-10000
059186,華通富邦9A購01  ,0,0,0,0,0,0,0,0,0,-10000,0,0,0,0,10000,-10000,-10000
059088,台積電元大99購27,0,0,0,0,0,0,0,0,0,-10000,0,0,0,0,10000,-10000,-10000
059011,臺股指元大9A購30,0,0,0,0,0,0,0,0,0,-10000,0,0,0,0,10000,-10000,-10000
059140,大立光兆豐9A購02,0,0,0,0,0,0,0,0,0,-10000,0,0,0,0,10000,-10000,-10000
05911P,南亞科永豐96售03,0,0,0,0,0,0,0,0,0,-10000,0,0,0,10000,20000,-10000,-10000
05819P,臺股指凱基96售16,0,0,0,0,0,0,0,0,0,-10000,0,0,0,0,10000,-10000,-10000
055872,亞泥元富97購01  ,0,0,0,0,0,0,0,0,0,-10000,0,0,0,0,10000,-10000,-10000
055882,嘉聯益元富97購01,0,0,0,0,0,0,0,0,0,-10000,0,0,0,0,10000,-10000,-10000
055905,可成兆豐97購03  ,0,0,0,0,0,0,0,0,0,-10000,0,0,0,0,10000,-10000,-10000
055906,大立光兆豐97購03,0,0,0,0,0,0,0,0,0,-10000,0,0,0,0,10000,-10000,-10000
058164,FBVIX凱基03購02 ,0,0,0,0,0,0,0,0,0,-10000,0,0,0,0,10000,-10000,-10000
057856,聯鈞國票99購03  ,0,0,0,0,0,0,0,0,0,-10000,0,0,0,25000,35000,-10000,-10000
057857,牧德國票99購01  ,0,0,0,0,0,0,0,0,0,-10000,0,0,0,0,10000,-10000,-10000
057863,美律凱基9A購01  ,0,0,0,0,0,0,0,0,0,-10000,0,0,0,5000,15000,-10000,-10000
057850,上銀兆豐99購02  ,0,0,0,0,0,0,0,0,0,-10000,0,0,0,0,10000,-10000,-10000
056701,國產國泰9A購01  ,0,0,0,0,0,0,0,0,0,-10000,0,0,0,10000,20000,-10000,-10000
056707,鴻海富邦99購03  ,0,0,0,0,0,0,0,0,0,-10000,0,0,0,0,10000,-10000,-10000
056749,滬深2X兆豐99購01,0,0,0,0,0,0,0,0,0,-10000,0,0,0,0,10000,-10000,-10000
056751,和大兆豐98購01  ,0,0,0,0,0,0,0,0,0,-10000,0,0,0,0,10000,-10000,-10000
056753,群創兆豐98購02  ,0,0,0,0,0,0,0,0,0,-10000,0,0,0,0,10000,-10000,-10000
056766,義隆元大98購01  ,1000,0,1000,0,0,0,0,0,0,-11000,0,0,0,81000,92000,-11000,-10000
056756,T50反1元大98購06,0,0,0,0,0,0,0,0,0,-10000,0,0,0,0,10000,-10000,-10000
05884P,旺宏統一96售01  ,0,0,0,0,0,0,0,0,0,-10000,0,0,0,0,10000,-10000,-10000
058856,新光金兆豐99購01,0,0,0,0,0,0,0,0,0,-10000,0,0,0,40000,50000,-10000,-10000
058898,台積電元大99購20,0,0,0,0,0,0,0,0,0,-10000,0,0,0,0,10000,-10000,-10000
058899,旺宏元大99購10  ,0,0,0,0,0,0,0,0,0,-10000,0,0,0,0,10000,-10000,-10000
058436,聯發科統一9B購03,0,0,0,0,0,0,0,0,0,-10000,0,0,0,200000,210000,-10000,-10000
058556,百和永豐99購01  ,0,0,0,0,0,0,0,0,0,-10000,0,0,0,34000,44000,-10000,-10000
058937,仁寶中信99購01  ,0,0,0,0,0,0,0,0,0,-10000,0,0,0,10000,20000,-10000,-10000
058488,華擎國票9A購01  ,0,0,0,0,0,0,0,0,0,-10000,0,0,0,0,10000,-10000,-10000
058504,台積電元大99購07,0,0,0,0,0,0,0,0,0,-10000,0,0,0,0,10000,-10000,-10000
056374,聯發科統一9B購01,0,0,0,0,0,0,0,0,0,-10000,0,0,0,0,10000,-10000,-10000
056440,智邦凱基98購03  ,0,0,0,0,0,0,0,0,0,-10000,0,0,0,0,10000,-10000,-10000
056414,國巨中信98購02  ,0,0,0,0,0,0,0,0,0,-10000,0,0,0,0,10000,-10000,-10000
056415,聯發科中信98購04,0,0,0,0,0,0,0,0,0,-10000,0,0,0,30000,40000,-10000,-10000
056453,禾伸堂凱基99購02,0,0,0,0,0,0,0,0,0,-10000,0,0,0,20000,30000,-10000,-10000
056555,矽創凱基98購01  ,0,0,0,0,0,0,0,0,0,-10000,0,0,0,0,10000,-10000,-10000
056560,旺宏群益98購03  ,0,0,0,0,0,0,0,0,0,-10000,0,0,0,0,10000,-10000,-10000
4566,時碩工業        ,19000,29000,-10000,0,0,0,0,0,0,0,0,0,0,0,0,0,-10000
4755,三福化          ,0,7000,-7000,0,0,0,0,0,0,-3000,0,3000,-3000,0,0,0,-10000
059490,國巨國票99購09  ,0,0,0,0,0,0,0,0,0,-10000,0,0,0,1000,11000,-10000,-10000
059486,A50正2兆豐9A購01,0,0,0,0,0,0,0,0,0,-10000,0,0,0,0,10000,-10000,-10000
2911,麗嬰房          ,4000,14000,-10000,0,0,0,0,0,0,0,0,0,0,0,0,0,-10000
9924,福興            ,26000,10000,16000,0,0,0,0,0,0,-26000,0,0,0,0,26000,-26000,-10000
059891,臺股指國票99購25,0,0,0,0,0,0,0,0,0,-10000,0,0,0,4000,14000,-10000,-10000
059324,智易元大99購04  ,0,0,0,0,0,0,0,0,0,-10000,0,0,0,40000,50000,-10000,-10000
059252,聯詠凱基99購03  ,0,0,0,0,0,0,0,0,0,-10000,0,0,0,10000,20000,-10000,-10000
059687,卜蜂永豐99購01  ,0,0,0,0,0,0,0,0,0,-10000,0,0,0,26000,36000,-10000,-10000
059669,台灣50元富9B購05,0,0,0,0,0,0,0,0,0,-10000,0,0,0,34000,44000,-10000,-10000
1460,宏遠            ,5285,16000,-10715,0,0,0,0,0,0,0,0,0,0,0,0,0,-10715
1464,得力            ,112000,121000,-9000,0,0,0,0,2000,-2000,0,0,0,0,0,0,0,-11000
1558,伸興            ,5000,16000,-11000,0,0,0,0,0,0,0,0,0,0,0,0,0,-11000
1526,日馳            ,67000,78000,-11000,0,0,0,0,0,0,0,0,0,0,0,0,0,-11000
1721,三晃            ,6000,17000,-11000,0,0,0,0,0,0,0,0,0,0,0,0,0,-11000
1234,黑松            ,0,11000,-11000,0,0,0,0,0,0,0,0,0,0,0,0,0,-11000
8462,柏文            ,10000,20000,-10000,0,0,0,0,0,0,-1000,0,0,0,0,1000,-1000,-11000
6581,鋼聯            ,1000,12000,-11000,0,0,0,0,0,0,0,0,0,0,0,0,0,-11000
2495,普安            ,13000,23000,-10000,0,0,0,0,0,0,-1000,0,1000,-1000,0,0,0,-11000
2236,百達-KY         ,1000,11000,-10000,0,0,0,0,0,0,-1000,0,1000,-1000,0,0,0,-11000
07223P,鴻海元大99售29  ,0,0,0,0,0,0,0,0,0,-11000,0,0,0,265000,276000,-11000,-11000
07050P,宏達電中信9B售01,0,0,0,0,0,0,0,0,0,-11000,0,0,0,0,11000,-11000,-11000
07357P,鴻海元大99售38  ,0,0,0,0,0,0,0,0,0,-11000,0,0,0,0,11000,-11000,-11000
07333P,台灣50國票9B售03,0,0,0,0,0,0,0,0,0,-11000,0,0,0,0,11000,-11000,-11000
07637P,國巨國票9A售08  ,0,0,0,0,0,0,0,0,0,-11000,0,0,0,0,11000,-11000,-11000
07472P,和碩元大9A售03  ,0,0,0,0,0,0,0,0,0,-11000,0,0,0,4000,15000,-11000,-11000
060412,儒鴻永豐9A購01  ,0,0,0,0,0,0,0,0,0,-11000,0,0,0,0,11000,-11000,-11000
06036P,台表科凱基96售04,0,0,0,0,0,0,0,0,0,-11000,0,0,0,0,11000,-11000,-11000
060850,康友國票9A購03  ,0,0,0,0,0,0,0,0,0,-11000,0,0,0,29000,40000,-11000,-11000
060837,上銀國票9A購04  ,0,0,0,0,0,0,0,0,0,-11000,0,0,0,31000,42000,-11000,-11000
061382,台灣50群益9C購02,0,0,0,0,0,0,0,0,0,-11000,0,0,0,0,11000,-11000,-11000
06447P,上銀元大98售01  ,0,0,0,0,0,0,0,0,0,-11000,0,0,0,4000,15000,-11000,-11000
061237,晶技元大9A購01  ,0,0,0,0,0,0,0,0,0,-11000,0,0,0,2000,13000,-11000,-11000
061156,玉晶光群益9A購07,0,0,0,0,0,0,0,0,0,-11000,0,0,0,4000,15000,-11000,-11000
061146,台表科中信9A購02,0,0,0,0,0,0,0,0,0,-11000,0,0,0,0,11000,-11000,-11000
00660,元大歐洲50      ,0,0,0,0,0,0,0,0,0,-11000,0,0,0,83000,94000,-11000,-11000
052568,漢唐凱基96購02  ,0,0,0,0,0,0,0,0,0,-11000,0,0,0,9000,20000,-11000,-11000
053673,超眾元富96購03  ,0,0,0,0,0,0,0,0,0,-11000,0,0,0,1000,12000,-11000,-11000
05358P,大立光元大95售09,0,0,0,0,0,0,0,0,0,-11000,0,0,0,0,11000,-11000,-11000
056357,台積電元大9A購01,0,0,0,0,0,0,0,0,0,-11000,0,0,0,0,11000,-11000,-11000
05465P,台表科永豐95售03,0,0,0,0,0,0,0,0,0,-11000,0,0,0,20000,31000,-11000,-11000
05456P,鴻海凱基95售19  ,0,0,0,0,0,0,0,0,0,-11000,0,0,0,0,11000,-11000,-11000
054934,金寶元大97購01  ,0,0,0,0,0,0,0,0,0,-11000,0,0,0,0,11000,-11000,-11000
052825,TPK永豐96購01   ,0,0,0,0,0,0,0,0,0,-11000,0,0,0,0,11000,-11000,-11000
058720,旭富元富99購01  ,0,0,0,0,0,0,0,0,0,-11000,0,0,0,0,11000,-11000,-11000
057838,台郡國泰99購01  ,0,0,0,0,0,0,0,0,0,-11000,0,0,0,35000,46000,-11000,-11000
058927,勤誠元富99購02  ,0,0,0,0,0,0,0,0,0,-11000,0,0,0,17000,28000,-11000,-11000
058902,聯發科元大99購15,0,0,0,0,0,0,0,0,0,-11000,0,0,0,5000,16000,-11000,-11000
05882P,華新科永豐96售01,0,0,0,0,0,0,0,0,0,-11000,0,0,0,0,11000,-11000,-11000
058295,欣興凱基99購02  ,0,0,0,0,0,0,0,0,0,-11000,0,0,0,223000,234000,-11000,-11000
057058,祥碩元大98購04  ,0,0,0,0,0,0,0,0,0,-11000,0,0,0,0,11000,-11000,-11000
057985,華通元富02購03  ,0,0,0,0,0,0,0,0,0,-11000,0,0,0,19000,30000,-11000,-11000
057964,緯穎元大99購03  ,0,0,0,0,0,0,0,0,0,-11000,0,0,0,30000,41000,-11000,-11000
057998,玉晶光麥證9A購01,0,0,0,29000,40000,-11000,0,0,0,-11000,0,0,0,29000,40000,-11000,-11000
058967,可成麥證99購01  ,0,0,0,14000,26000,-12000,0,0,0,-11000,0,0,0,15000,26000,-11000,-11000
055702,美律富邦98購01  ,0,0,0,0,0,0,0,0,0,-11000,0,0,0,0,11000,-11000,-11000
055731,美律元富97購01  ,0,0,0,0,0,0,0,0,0,-11000,0,0,0,98000,109000,-11000,-11000
056077,矽力元大97購07  ,0,0,0,0,0,0,0,0,0,-11000,0,0,0,65000,76000,-11000,-11000
060116,世紀鋼元大99購07,0,0,0,0,0,0,0,0,0,-11000,0,0,0,50000,61000,-11000,-11000
060159,健和興永豐9A購01,0,0,0,0,0,0,0,0,0,-11000,0,0,0,11000,22000,-11000,-11000
059944,欣興永豐99購03  ,0,0,0,0,0,0,0,0,0,-11000,0,0,0,6000,17000,-11000,-11000
059249,大立光凱基99購05,0,0,0,0,0,0,0,0,0,-11000,0,0,0,1000,12000,-11000,-11000
059475,元石油群益99購02,0,0,0,0,0,0,0,0,0,-11000,0,0,0,0,11000,-11000,-11000
059709,上証2X元大9C購01,0,0,0,0,0,0,0,0,0,-11000,0,0,0,4000,15000,-11000,-11000
059340,鴻海凱基9A購12  ,0,0,0,0,0,0,0,0,0,-11000,0,0,0,11000,22000,-11000,-11000
05951P,台積電國票97售05,0,0,0,0,0,0,0,0,0,-11000,0,0,0,0,11000,-11000,-11000
4930,燦星網          ,3000,8000,-5000,0,0,0,0,0,0,-6000,0,6000,-6000,0,0,0,-11000
6243,迅杰            ,0,11000,-11000,0,0,0,0,0,0,0,0,0,0,0,0,0,-11000
06395P,台積電元大97售29,0,0,0,0,0,0,0,0,0,-12000,0,0,0,91000,103000,-12000,-12000
06167P,欣興國票97售05  ,0,0,0,0,0,0,0,0,0,-12000,0,0,0,0,12000,-12000,-12000
061351,智伸科元大9A購01,0,0,0,0,0,0,0,0,0,-12000,0,0,0,0,12000,-12000,-12000
060988,華新科元大9A購12,0,0,0,0,0,0,0,0,0,-12000,0,0,0,84000,96000,-12000,-12000
060277,道瓊反元大9A購02,0,0,0,0,0,0,0,0,0,-12000,0,0,0,83000,95000,-12000,-12000
06109P,華新科群益97售05,0,0,0,0,0,0,0,0,0,-12000,0,0,0,100000,112000,-12000,-12000
060749,祥碩國票9A購01  ,0,0,0,0,0,0,0,0,0,-12000,0,0,0,17000,29000,-12000,-12000
060475,瑞祺元大9A購01  ,0,0,0,0,0,0,0,0,0,-12000,0,0,0,98000,110000,-12000,-12000
060538,S&P反1凱基9A購01,0,0,0,0,0,0,0,0,0,-12000,0,0,0,3000,15000,-12000,-12000
07450P,鴻海元大9A售03  ,0,0,0,0,0,0,0,0,0,-12000,0,0,0,0,12000,-12000,-12000
07267P,臺股指元大99售23,0,0,0,0,0,0,0,0,0,-12000,0,0,0,0,12000,-12000,-12000
07410P,鴻海元大99售44  ,0,0,0,0,0,0,0,0,0,-12000,0,0,0,0,12000,-12000,-12000
06598P,奇力新永豐98售02,0,0,0,0,0,0,0,0,0,-12000,0,0,0,0,12000,-12000,-12000
06850P,聯茂元大98售06  ,0,0,0,0,0,0,0,0,0,-12000,0,0,0,0,12000,-12000,-12000
2496,卓越            ,0,12000,-12000,0,0,0,0,0,0,0,0,0,0,0,0,0,-12000
2528,皇普            ,0,12000,-12000,0,0,0,0,0,0,0,1000,1000,0,0,0,0,-12000
07723P,臺股指凱基9A售15,0,0,0,0,0,0,0,0,0,-12000,0,0,0,0,12000,-12000,-12000
055444,致新台新97購01  ,0,0,0,0,0,0,0,0,0,-12000,0,0,0,10000,22000,-12000,-12000
055129,鈺齊兆豐97購01  ,0,0,0,0,0,0,0,0,0,-12000,0,0,0,0,12000,-12000,-12000
05472P,國巨統一96售02  ,0,0,0,0,0,0,0,0,0,-12000,0,0,0,0,12000,-12000,-12000
057819,新日興元大99購01,0,0,0,0,0,0,0,0,0,-12000,0,0,0,13000,25000,-12000,-12000
053331,玉晶光永豐97購02,0,0,0,0,0,0,0,0,0,-12000,0,0,0,0,12000,-12000,-12000
052537,力成富邦95購01  ,0,0,0,0,0,0,0,0,0,-12000,0,0,0,0,12000,-12000,-12000
052238,智易國票96購01  ,0,0,0,0,0,0,0,0,0,-12000,0,0,0,0,12000,-12000,-12000
051950,旺宏元富95購02  ,0,0,0,0,0,0,0,0,0,-12000,0,0,0,0,12000,-12000,-12000
0053,元大電子        ,0,0,0,0,0,0,0,0,0,-12000,0,0,0,5000,17000,-12000,-12000
03439B,臺股指元大99熊29,0,0,0,0,0,0,0,0,0,-12000,0,0,0,50000,62000,-12000,-12000
049894,嘉聯益富邦98購01,0,0,0,0,0,0,0,0,0,-12000,0,0,0,0,12000,-12000,-12000
047769,大立光元大96購01,0,0,0,0,0,0,0,0,0,-12000,0,0,0,0,12000,-12000,-12000
060169,群電永豐9A購01  ,0,0,0,0,0,0,0,0,0,-12000,0,0,0,0,12000,-12000,-12000
059785,美律元大9A購03  ,0,0,0,0,0,0,0,0,0,-12000,0,0,0,5000,17000,-12000,-12000
060075,台積電元富99購05,0,0,0,0,0,0,0,0,0,-12000,0,0,0,5000,17000,-12000,-12000
057664,台積電元大9A購03,10000,0,10000,0,0,0,0,0,0,-22000,0,0,0,0,22000,-22000,-12000
057097,致新元富98購01  ,0,0,0,0,0,0,0,0,0,-12000,0,0,0,0,12000,-12000,-12000
056200,大毅永豐98購01  ,0,0,0,0,0,0,0,0,0,-12000,0,0,0,18000,30000,-12000,-12000
057381,微星國泰9A購01  ,0,0,0,0,0,0,0,0,0,-12000,0,0,0,22000,34000,-12000,-12000
056919,英業達兆豐98購01,0,0,0,0,0,0,0,0,0,-12000,0,0,0,20000,32000,-12000,-12000
058226,世芯元富99購01  ,0,0,0,0,0,0,0,0,0,-12000,0,0,0,23000,35000,-12000,-12000
058933,FBVIX台新9B購01 ,0,0,0,0,0,0,0,0,0,-12000,0,0,0,0,12000,-12000,-12000
058942,南茂中信99購01  ,0,0,0,0,0,0,0,0,0,-12000,0,0,0,0,12000,-12000,-12000
4952,凌通            ,14000,25000,-11000,0,0,0,0,0,0,-1000,0,1000,-1000,0,0,0,-12000
5285,界霖            ,24000,34000,-10000,0,0,0,0,0,0,-2000,0,2000,-2000,0,0,0,-12000
3622,洋華            ,44000,55000,-11000,0,0,0,0,0,0,-1000,0,1000,-1000,0,0,0,-12000
3543,州巧            ,1000,11000,-10000,0,0,0,0,0,0,-2000,0,2000,-2000,0,0,0,-12000
059364,昇陽半永豐99購02,0,0,0,0,0,0,0,0,0,-12000,0,0,0,0,12000,-12000,-12000
059704,聯發科凱基9A購08,0,0,0,0,0,0,0,0,0,-12000,0,0,0,61000,73000,-12000,-12000
1517,利奇            ,6000,11025,-5025,0,0,0,0,0,0,-7000,0,7000,-7000,0,0,0,-12025
2443,億麗            ,1000,13082,-12082,0,0,0,0,0,0,0,0,0,0,0,0,0,-12082
6409,旭隼            ,158000,170426,-12426,0,0,0,0,0,0,0,1000,1000,0,0,0,0,-12426
2427,三商電          ,0,10000,-10000,0,0,0,0,0,0,-3000,0,3000,-3000,0,0,0,-13000
2038,海光            ,5000,16000,-11000,0,0,0,0,0,0,-2000,0,2000,-2000,0,0,0,-13000
1232,大統益          ,3000,16000,-13000,0,0,0,0,0,0,0,0,0,0,0,0,0,-13000
1413,宏洲            ,0,13000,-13000,0,0,0,0,0,0,0,0,0,0,0,0,0,-13000
06600P,貿聯永豐98售01  ,0,0,0,0,0,0,0,0,0,-13000,0,0,0,13000,26000,-13000,-13000
07055P,景碩群益9A售02  ,0,0,0,0,0,0,0,0,0,-13000,0,0,0,0,13000,-13000,-13000
07070P,晶相光元富99售01,0,0,0,0,0,0,0,0,0,-13000,0,0,0,32000,45000,-13000,-13000
07572P,台灣50元大9A售15,0,0,0,0,0,0,0,0,0,-13000,0,0,0,0,13000,-13000,-13000
060308,劍麟永豐9A購01  ,0,0,0,0,0,0,0,0,0,-13000,0,0,0,0,13000,-13000,-13000
050142,聯發科元富9A購01,0,0,0,0,0,0,0,0,0,-13000,0,0,0,0,13000,-13000,-13000
048748,國巨元富96購01  ,0,0,0,0,0,0,0,0,0,-13000,0,0,0,18000,31000,-13000,-13000
051462,世芯國泰97購01  ,0,0,0,0,0,0,0,0,0,-13000,0,0,0,17000,30000,-13000,-13000
053780,南亞科元大96購03,0,0,0,0,0,0,0,0,0,-13000,0,0,0,75000,88000,-13000,-13000
058863,可成凱基99購02  ,0,0,0,0,0,0,0,0,0,-13000,0,0,0,4000,17000,-13000,-13000
059197,可成永豐99購02  ,0,0,0,0,0,0,0,0,0,-13000,0,0,0,1000,14000,-13000,-13000
059117,禾伸堂永豐99購01,0,0,0,0,0,0,0,0,0,-13000,0,0,0,46000,59000,-13000,-13000
058272,超眾永豐9A購01  ,0,0,0,0,0,0,0,0,0,-13000,0,0,0,0,13000,-13000,-13000
05708P,奇力新國票97售04,0,0,0,0,0,0,0,0,0,-13000,0,0,0,157000,170000,-13000,-13000
056986,超眾群益98購03  ,0,0,0,0,0,0,0,0,0,-13000,0,0,0,1000,14000,-13000,-13000
056843,冠德元富98購01  ,0,0,0,0,0,0,0,0,0,-13000,0,0,0,0,13000,-13000,-13000
058603,台積電元大99購12,0,0,0,0,0,0,0,0,0,-13000,0,0,0,2000,15000,-13000,-13000
057241,超眾凱基99購02  ,0,0,0,0,0,0,0,0,0,-13000,0,0,0,0,13000,-13000,-13000
057337,聯發科國票99購02,0,0,0,0,0,0,0,0,0,-13000,0,0,0,0,13000,-13000,-13000
055949,亞德客元大97購04,0,0,0,0,0,0,0,0,0,-13000,0,0,0,5000,18000,-13000,-13000
057675,同欣電元大98購02,0,0,0,0,0,0,0,0,0,-13000,0,0,0,47000,60000,-13000,-13000
059586,上銀元大9A購02  ,0,0,0,0,0,0,0,0,0,-13000,0,0,0,4000,17000,-13000,-13000
060050,鴻海凱基9B購01  ,0,0,0,0,0,0,0,0,0,-13000,0,0,0,0,13000,-13000,-13000
059745,欣興元富99購04  ,0,0,0,0,0,0,0,0,0,-13000,0,0,0,0,13000,-13000,-13000
060100,新光金元大9C購01,0,0,0,0,0,0,0,0,0,-13000,0,0,0,68000,81000,-13000,-13000
3305,昇貿            ,2000,15000,-13000,0,0,0,0,0,0,0,0,0,0,0,0,0,-13000
059847,喬山永豐99購01  ,0,0,0,0,0,0,0,0,0,-13000,0,0,0,14000,27000,-13000,-13000
1590,亞德客-KY       ,439000,552232,-113232,0,0,0,142000,57000,85000,15000,11000,12000,-1000,18000,2000,16000,-13232
2480,敦陽科          ,69000,78600,-9600,0,0,0,0,1000,-1000,-3000,0,3000,-3000,0,0,0,-13600
2702,華園            ,320,14000,-13680,0,0,0,0,0,0,0,0,0,0,0,0,0,-13680
8411,福貞-KY         ,0,14000,-14000,0,0,0,0,0,0,0,0,0,0,0,0,0,-14000
2028,威致            ,0,14000,-14000,0,0,0,0,0,0,0,0,0,0,0,0,0,-14000
07745P,華新科凱基9A售10,0,0,0,0,0,0,0,0,0,-14000,0,0,0,0,14000,-14000,-14000
07760P,力山永豐9A售03  ,0,0,0,0,0,0,0,0,0,-14000,0,0,0,0,14000,-14000,-14000
07495P,鴻海元大9A售04  ,0,0,0,0,0,0,0,0,0,-14000,0,0,0,0,14000,-14000,-14000
07258P,台灣50台新9A售01,0,0,0,0,0,0,0,0,0,-14000,0,0,0,181000,195000,-14000,-14000
07344P,鴻海富邦9A售03  ,0,0,0,0,0,0,0,0,0,-14000,0,0,0,0,14000,-14000,-14000
07126P,台積電元大99售23,0,0,0,0,0,0,0,0,0,-14000,0,0,0,6000,20000,-14000,-14000
06885P,國巨國票99售06  ,0,0,0,0,0,0,0,0,0,-14000,0,0,0,50000,64000,-14000,-14000
060399,康友國票9A購02  ,0,0,0,0,0,0,0,0,0,-14000,0,0,0,0,14000,-14000,-14000
060592,上銀麥證9A購01  ,0,0,0,7000,21000,-14000,0,0,0,-14000,0,0,0,7000,21000,-14000,-14000
060848,聯茂國票9A購02  ,0,0,0,0,0,0,0,0,0,-14000,0,0,0,24000,38000,-14000,-14000
061336,國巨元大9A購20  ,0,0,0,0,0,0,0,0,0,-14000,0,0,0,0,14000,-14000,-14000
061301,華新科永豐9A購03,0,0,0,0,0,0,0,0,0,-14000,0,0,0,0,14000,-14000,-14000
06674P,祥碩群益98售02  ,0,0,0,0,0,0,0,0,0,-14000,0,0,0,9000,23000,-14000,-14000
06726P,欣興元富98售04  ,0,0,0,0,0,0,0,0,0,-14000,0,0,0,0,14000,-14000,-14000
053662,矽力凱基97購01  ,0,0,0,0,0,0,0,0,0,-14000,0,0,0,6000,20000,-14000,-14000
05463P,創意國票96售04  ,0,0,0,0,0,0,0,0,0,-14000,0,0,0,0,14000,-14000,-14000
055470,南亞科凱基97購01,0,0,0,0,0,0,0,0,0,-14000,0,0,0,1000,15000,-14000,-14000
051650,矽力永豐95購01  ,0,0,0,0,0,0,0,0,0,-14000,0,0,0,0,14000,-14000,-14000
051809,義隆凱基96購01  ,0,0,0,0,0,0,0,0,0,-14000,0,0,0,28000,42000,-14000,-14000
046813,聯電凱基96購01  ,0,0,0,0,0,0,0,0,0,-14000,0,0,0,4000,18000,-14000,-14000
056088,台郡統一97購02  ,0,0,0,0,0,0,0,0,0,-14000,0,0,0,30000,44000,-14000,-14000
05696P,南亞科凱基96售01,0,0,0,0,0,0,0,0,0,-14000,0,0,0,0,14000,-14000,-14000
058258,世芯國泰9A購01  ,0,0,0,0,0,0,0,0,0,-14000,0,0,0,57000,71000,-14000,-14000
056681,鴻海統一98購09  ,0,0,0,0,0,0,0,0,0,-14000,0,0,0,16000,30000,-14000,-14000
058487,晶技國票9A購01  ,0,0,0,0,0,0,0,0,0,-14000,0,0,0,73000,87000,-14000,-14000
056383,上銀國泰99購01  ,0,0,0,0,0,0,0,0,0,-14000,0,0,0,0,14000,-14000,-14000
059387,華通凱基9A購03  ,0,0,0,0,0,0,0,0,0,-14000,0,0,0,3000,17000,-14000,-14000
059673,玉山金元富99購01,0,0,0,0,0,0,0,0,0,-14000,0,0,0,4000,18000,-14000,-14000
4572,駐龍            ,0,14000,-14000,0,0,0,0,0,0,0,0,0,0,0,0,0,-14000
06155P,智邦統一97售02  ,0,0,0,0,0,0,0,0,0,-15000,0,0,0,31000,46000,-15000,-15000
06427P,鴻海元大97售13  ,0,0,0,0,0,0,0,0,0,-15000,0,0,0,0,15000,-15000,-15000
06244P,智易元富97售02  ,0,0,0,0,0,0,0,0,0,-15000,0,0,0,0,15000,-15000,-15000
060873,道瓊反中信9C購01,0,0,0,0,0,0,0,0,0,-15000,0,0,0,0,15000,-15000,-15000
060965,中租凱基9B購01  ,0,0,0,0,0,0,0,0,0,-15000,0,0,0,6000,21000,-15000,-15000
061010,上銀麥證9A購02  ,0,0,0,9000,24000,-15000,0,0,0,-15000,0,0,0,9000,24000,-15000,-15000
06645P,上銀元大98售05  ,0,0,0,0,0,0,0,0,0,-15000,0,0,0,0,15000,-15000,-15000
060503,技嘉元大9A購01  ,0,0,0,0,0,0,0,0,0,-15000,0,0,0,4000,19000,-15000,-15000
06735P,奇力新凱基98售07,0,0,0,0,0,0,0,0,0,-15000,0,0,0,0,15000,-15000,-15000
07266P,大立光元大99售19,0,0,0,0,0,0,0,0,0,-15000,0,0,0,0,15000,-15000,-15000
07451P,鴻海元大9B售01  ,0,0,0,0,0,0,0,0,0,-15000,0,0,0,1000,16000,-15000,-15000
07556P,玉晶光元大9A售08,0,0,0,0,0,0,0,0,0,-15000,0,0,0,3000,18000,-15000,-15000
07611P,大立光國票9A售05,0,0,0,0,0,0,0,0,0,-15000,0,0,0,0,15000,-15000,-15000
07761P,智邦永豐9A售03  ,0,0,0,0,0,0,0,0,0,-15000,0,0,0,0,15000,-15000,-15000
07734P,台積電富邦9C售10,0,0,0,0,0,0,0,0,0,-15000,0,0,0,0,15000,-15000,-15000
07692P,玉晶光元大9A售11,0,0,0,0,0,0,0,0,0,-15000,0,0,0,0,15000,-15000,-15000
1108,幸福            ,5000,20000,-15000,0,0,0,0,0,0,0,0,0,0,0,0,0,-15000
2363,矽統            ,1769000,1781000,-12000,0,0,0,0,0,0,-3000,0,3000,-3000,0,0,0,-15000
050183,奇鋐元大96購01  ,0,0,0,0,0,0,0,0,0,-15000,0,0,0,15000,30000,-15000,-15000
050514,聯電元大94購01  ,0,0,0,0,0,0,0,0,0,-15000,0,0,0,20000,35000,-15000,-15000
050515,聯電元大96購01  ,35000,0,35000,0,0,0,0,0,0,-50000,0,0,0,15000,65000,-50000,-15000
048533,景碩國票94購01  ,0,0,0,0,0,0,0,0,0,-15000,0,0,0,0,15000,-15000,-15000
052208,力成麥證95購01  ,0,0,0,40000,55000,-15000,0,0,0,-15000,0,0,0,40000,55000,-15000,-15000
051591,玉晶光元大97購01,0,0,0,0,0,0,0,0,0,-15000,0,0,0,0,15000,-15000,-15000
051170,南電元大95購03  ,0,0,0,0,0,0,0,0,0,-15000,0,0,0,0,15000,-15000,-15000
052389,聯發科群益95購05,0,0,0,0,0,0,0,0,0,-15000,0,0,0,0,15000,-15000,-15000
055457,聚陽永豐97購01  ,0,0,0,0,0,0,0,0,0,-15000,0,0,0,0,15000,-15000,-15000
05272P,臻鼎中信97售03  ,0,0,0,0,0,0,0,0,0,-15000,0,0,0,0,15000,-15000,-15000
054737,京元電凱基99購01,0,0,0,0,0,0,0,0,0,-15000,0,0,0,0,15000,-15000,-15000
053773,上銀元大96購04  ,0,0,0,0,0,0,0,0,0,-15000,0,0,0,4000,19000,-15000,-15000
057744,健策永豐98購02  ,0,0,0,0,0,0,0,0,0,-15000,0,0,0,23000,38000,-15000,-15000
056385,創意國泰99購01  ,0,0,0,0,0,0,0,0,0,-15000,0,0,0,36000,51000,-15000,-15000
056488,致新元大99購01  ,0,0,0,0,0,0,0,0,0,-15000,0,0,0,57000,72000,-15000,-15000
05848P,臺股指元大96售24,0,0,0,0,0,0,0,0,0,-15000,0,0,0,0,15000,-15000,-15000
058932,FBVIX台新99購01 ,0,0,0,0,0,0,0,0,0,-15000,0,0,0,5000,20000,-15000,-15000
058770,貿聯兆豐9A購01  ,0,0,0,0,0,0,0,0,0,-15000,0,0,0,5000,20000,-15000,-15000
058796,可成元大99購04  ,0,0,0,0,0,0,0,0,0,-15000,0,0,0,0,15000,-15000,-15000
057917,台積電凱基98購17,0,0,0,0,0,0,0,0,0,-15000,0,0,0,0,15000,-15000,-15000
058478,聯發科凱基9A購01,0,0,0,0,0,0,0,0,0,-15000,0,0,0,0,15000,-15000,-15000
05812P,臺股指國票96售05,0,0,0,0,0,0,0,0,0,-15000,0,0,0,1000,16000,-15000,-15000
059124,台積電第一03購01,0,0,0,0,0,0,0,0,0,-15000,0,0,0,0,15000,-15000,-15000
056856,華通群益9A購01  ,0,0,0,0,0,0,0,0,0,-15000,0,0,0,0,15000,-15000,-15000
056885,元油2X元大99購03,0,0,0,0,0,0,0,0,0,-15000,0,0,0,0,15000,-15000,-15000
058578,聯發科群益99購03,0,0,0,0,0,0,0,0,0,-15000,0,0,0,40000,55000,-15000,-15000
057996,臻鼎中信98購01  ,0,0,0,0,0,0,0,0,0,-15000,0,0,0,10000,25000,-15000,-15000
056233,超眾凱基97購02  ,0,0,0,0,0,0,0,0,0,-15000,0,0,0,20000,35000,-15000,-15000
055626,力山永豐97購01  ,0,0,0,0,0,0,0,0,0,-15000,0,0,0,2000,17000,-15000,-15000
055809,T50反1國票98購02,0,0,0,0,0,0,0,0,0,-15000,0,0,0,0,15000,-15000,-15000
057365,智邦元大98購07  ,0,0,0,0,0,0,0,0,0,-15000,0,0,0,19000,34000,-15000,-15000
055705,微星永豐97購01  ,0,0,0,0,0,0,0,0,0,-15000,0,0,0,23000,38000,-15000,-15000
060019,彰銀康和99購01  ,0,0,0,0,0,0,0,0,0,-15000,0,0,0,0,15000,-15000,-15000
059263,瑞昱中信01購01  ,0,0,0,0,0,0,0,0,0,-15000,0,0,0,26000,41000,-15000,-15000
3321,同泰            ,4000,19000,-15000,0,0,0,0,0,0,0,0,0,0,0,0,0,-15000
3605,宏致            ,136000,151000,-15000,0,0,0,0,0,0,0,0,0,0,0,0,0,-15000
059916,聯發科元大99購33,0,0,0,0,0,0,0,0,0,-15000,0,0,0,0,15000,-15000,-15000
8482,商億-KY         ,4000,19000,-15000,0,0,0,0,0,0,0,0,0,0,0,0,0,-15000
912000,晨訊科-DR       ,0,15000,-15000,0,0,0,0,0,0,0,0,0,0,0,0,0,-15000
05979P,華新科中信96售02,0,0,0,0,0,0,0,0,0,-15000,0,0,0,5000,20000,-15000,-15000
059450,和大永豐99購01  ,0,0,0,0,0,0,0,0,0,-15000,0,0,0,84000,99000,-15000,-15000
2910,統領            ,2000,17000,-15000,0,0,0,0,0,0,0,0,0,0,0,0,0,-15000
2509,全坤建          ,1000,17000,-16000,0,0,0,0,0,0,0,0,0,0,0,0,0,-16000
1446,宏和            ,11000,27000,-16000,0,0,0,0,0,0,0,0,0,0,0,0,0,-16000
1618,合機            ,6000,16000,-10000,0,0,0,0,0,0,-6000,0,6000,-6000,0,0,0,-16000
060455,葡萄王元大9A購02,0,0,0,0,0,0,0,0,0,-16000,0,0,0,39000,55000,-16000,-16000
053308,智易凱基96購02  ,0,0,0,0,0,0,0,0,0,-16000,0,0,0,0,16000,-16000,-16000
058671,旺宏群益9A購01  ,0,0,0,0,0,0,0,0,0,-16000,0,0,0,1000,17000,-16000,-16000
053176,矽力群益96購02  ,0,0,0,0,0,0,0,0,0,-16000,0,0,0,1000,17000,-16000,-16000
053887,聯茂兆豐97購02  ,0,0,0,0,0,0,0,0,0,-16000,0,0,0,17000,33000,-16000,-16000
054439,健策台新96購03  ,0,0,0,0,0,0,0,0,0,-16000,0,0,0,16000,32000,-16000,-16000
054923,晶技凱基98購01  ,0,0,0,0,0,0,0,0,0,-16000,0,0,0,2000,18000,-16000,-16000
055458,燿華永豐98購01  ,0,0,0,0,0,0,0,0,0,-16000,0,0,0,71000,87000,-16000,-16000
052378,矽力元大96購01  ,0,0,0,0,0,0,0,0,0,-16000,0,0,0,0,16000,-16000,-16000
052515,矽力凱基95購02  ,0,0,0,0,0,0,0,0,0,-16000,0,0,0,0,16000,-16000,-16000
04889P,華通元大94售03  ,0,0,0,0,0,0,0,0,0,-16000,0,0,0,4000,20000,-16000,-16000
05024P,華通國票96售01  ,0,0,0,0,0,0,0,0,0,-16000,0,0,0,50000,66000,-16000,-16000
049602,南電元大95購01  ,0,0,0,0,0,0,0,0,0,-16000,0,0,0,0,16000,-16000,-16000
059272,台灣50元大99購01,0,0,0,0,0,0,0,0,0,-16000,0,0,0,3000,19000,-16000,-16000
059750,台灣50群益9A購05,0,0,0,0,0,0,0,0,0,-16000,0,0,0,0,16000,-16000,-16000
055704,亞德客永豐97購04,0,0,0,0,0,0,0,0,0,-16000,0,0,0,0,16000,-16000,-16000
057374,禾伸堂元大99購03,0,0,0,0,0,0,0,0,0,-16000,0,0,0,199000,215000,-16000,-16000
055587,智邦元大97購02  ,0,0,0,0,0,0,0,0,0,-16000,0,0,0,18000,34000,-16000,-16000
057119,微星康和98購01  ,0,0,0,0,0,0,0,0,0,-16000,0,0,0,48000,64000,-16000,-16000
057957,嘉晶元大98購01  ,0,0,0,0,0,0,0,0,0,-16000,0,0,0,37000,53000,-16000,-16000
056669,貿聯國票99購01  ,0,0,0,0,0,0,0,0,0,-16000,0,0,0,38000,54000,-16000,-16000
057935,晶技群益98購02  ,0,0,0,0,0,0,0,0,0,-16000,0,0,0,0,16000,-16000,-16000
058510,全新元大9B購02  ,0,0,0,0,0,0,0,0,0,-16000,0,0,0,0,16000,-16000,-16000
058517,景碩元大99購06  ,0,0,0,0,0,0,0,0,0,-16000,0,0,0,27000,43000,-16000,-16000
2701,萬企            ,0,15000,-15000,0,0,0,0,0,0,-1000,0,1000,-1000,0,0,0,-16000
2731,雄獅            ,15000,31000,-16000,0,0,0,0,0,0,0,0,0,0,0,0,0,-16000
9188,精熙-DR         ,0,16000,-16000,0,0,0,0,0,0,0,0,0,0,0,0,0,-16000
4989,榮科            ,13000,28000,-15000,0,0,0,0,0,0,-1000,0,1000,-1000,0,0,0,-16000
4960,誠美材          ,92000,103000,-11000,0,0,0,0,0,0,-5000,0,5000,-5000,0,0,0,-16000
060408,和潤國泰9C購01  ,0,0,0,0,0,0,0,0,0,-17000,0,0,0,54000,71000,-17000,-17000
06624P,訊芯元大98售06  ,0,0,0,0,0,0,0,0,0,-17000,0,0,0,10000,27000,-17000,-17000
06457P,玉晶光統一98售02,0,0,0,0,0,0,0,0,0,-17000,0,0,0,1000,18000,-17000,-17000
061191,可成永豐9A購02  ,0,0,0,0,0,0,0,0,0,-17000,0,0,0,0,17000,-17000,-17000
1525,江申            ,0,6000,-6000,0,0,0,0,10000,-10000,-1000,0,1000,-1000,0,0,0,-17000
8429,金麗-KY         ,3000,18000,-15000,0,0,0,0,0,0,-2000,0,2000,-2000,0,0,0,-17000
07448P,台灣50元大9A售08,0,0,0,0,0,0,0,0,0,-17000,0,0,0,5000,22000,-17000,-17000
07419P,聯發科元大99售46,0,0,0,0,0,0,0,0,0,-17000,0,0,0,0,17000,-17000,-17000
06743P,創意永豐98售03  ,0,0,0,0,0,0,0,0,0,-17000,0,0,0,30000,47000,-17000,-17000
07179P,臺股指凱基99售21,0,0,0,0,0,0,0,0,0,-17000,0,0,0,0,17000,-17000,-17000
049973,T50反1日盛9A購01,0,0,0,0,0,0,0,0,0,-17000,0,0,0,0,17000,-17000,-17000
049224,致新國票95購01  ,0,0,0,0,0,0,0,0,0,-17000,0,0,0,0,17000,-17000,-17000
053928,智易國票97購03  ,0,0,0,0,0,0,0,0,0,-17000,0,0,0,23000,40000,-17000,-17000
051979,群創凱基97購01  ,0,0,0,0,0,0,0,0,0,-17000,0,0,0,0,17000,-17000,-17000
055264,國巨永豐98購01  ,0,0,0,0,0,0,0,0,0,-17000,0,0,0,30000,47000,-17000,-17000
054806,台化元大9A購01  ,0,0,0,0,0,0,0,0,0,-17000,0,0,0,0,17000,-17000,-17000
054989,精元元富97購01  ,0,0,0,0,0,0,0,0,0,-17000,0,0,0,43000,60000,-17000,-17000
054408,義隆國票98購01  ,0,0,0,0,0,0,0,0,0,-17000,0,0,0,34000,51000,-17000,-17000
053186,健策中信9C購01  ,0,0,0,0,0,0,0,0,0,-17000,0,0,0,3000,20000,-17000,-17000
053489,上銀兆豐97購01  ,0,0,0,0,0,0,0,0,0,-17000,0,0,0,93000,110000,-17000,-17000
053487,台泥兆豐97購01  ,0,0,0,0,0,0,0,0,0,-17000,0,0,0,23000,40000,-17000,-17000
058947,SGBR2X群益9B購02,0,0,0,0,0,0,0,0,0,-17000,0,0,0,1000,18000,-17000,-17000
056618,京元電永豐98購01,0,0,0,0,0,0,0,0,0,-17000,0,0,0,84000,101000,-17000,-17000
058879,智邦富邦99購01  ,0,0,0,0,0,0,0,0,0,-17000,0,0,0,24000,41000,-17000,-17000
056981,全新群益99購03  ,0,0,0,0,0,0,0,0,0,-17000,0,0,0,116000,133000,-17000,-17000
059107,南茂國泰9A購01  ,0,0,0,0,0,0,0,0,0,-17000,0,0,0,0,17000,-17000,-17000
056209,超眾永豐97購02  ,0,0,0,0,0,0,0,0,0,-17000,0,0,0,10000,27000,-17000,-17000
057436,義隆國票99購02  ,0,0,0,0,0,0,0,0,0,-17000,0,0,0,9000,26000,-17000,-17000
059772,可成群益9A購05  ,0,0,0,0,0,0,0,0,0,-17000,0,0,0,3000,20000,-17000,-17000
060053,聯發科凱基9B購02,0,0,0,0,0,0,0,0,0,-17000,0,0,0,34000,51000,-17000,-17000
059266,緯創中信01購01  ,0,0,0,0,0,0,0,0,0,-17000,0,0,0,2000,19000,-17000,-17000
059600,緯穎元大99購07  ,0,0,0,0,0,0,0,0,0,-17000,0,0,0,15000,32000,-17000,-17000
057547,技嘉凱基99購01  ,0,0,0,0,0,0,0,0,0,-17000,0,0,0,0,17000,-17000,-17000
3050,鈺德            ,34000,51000,-17000,0,0,0,0,0,0,0,0,0,0,0,0,0,-17000
4739,康普            ,67000,84000,-17000,0,0,0,0,0,0,0,0,0,0,0,0,0,-17000
059661,大立光元大99購22,0,0,0,0,0,0,0,0,0,-17000,0,0,0,33000,50000,-17000,-17000
059361,玉晶光永豐99購04,0,0,0,0,0,0,0,0,0,-17000,0,0,0,4000,21000,-17000,-17000
3008,大立光          ,277002,281778,-4776,0,0,0,1000,0,1000,-14000,0,9000,-9000,1000,6000,-5000,-17776
07085P,超眾元富9C售01  ,0,0,0,0,0,0,0,0,0,-18000,0,0,0,210000,228000,-18000,-18000
2460,建通            ,0,16000,-16000,0,0,0,0,0,0,-2000,0,2000,-2000,0,0,0,-18000
06668P,祥碩凱基98售02  ,0,0,0,0,0,0,0,0,0,-18000,0,0,0,22000,40000,-18000,-18000
061033,台光電永豐9A購01,0,0,0,0,0,0,0,0,0,-18000,0,0,0,1000,19000,-18000,-18000
060979,國巨元大9A購14  ,0,0,0,0,0,0,0,0,0,-18000,0,0,0,52000,70000,-18000,-18000
053744,台郡國票97購03  ,0,0,0,0,0,0,0,0,0,-18000,0,0,0,0,18000,-18000,-18000
054416,禾伸堂元大97購01,0,0,0,0,0,0,0,0,0,-18000,0,0,0,32000,50000,-18000,-18000
054897,信錦康和97購01  ,0,0,0,0,0,0,0,0,0,-18000,0,0,0,0,18000,-18000,-18000
05123P,鴻海永昌96售07  ,0,0,0,0,0,0,0,0,0,-18000,0,0,0,0,18000,-18000,-18000
051659,力山國泰97購01  ,0,0,0,0,0,0,0,0,0,-18000,0,0,0,204000,222000,-18000,-18000
050480,健策國票95購04  ,0,0,0,0,0,0,0,0,0,-18000,0,0,0,42000,60000,-18000,-18000
03662C,FBVIX凱基03牛01 ,0,0,0,0,0,0,0,0,0,-18000,0,0,0,11000,29000,-18000,-18000
060022,勤誠康和99購01  ,0,0,0,0,0,0,0,0,0,-18000,0,0,0,12000,30000,-18000,-18000
060102,禾伸堂元大99購06,0,0,0,0,0,0,0,0,0,-18000,0,0,0,112000,130000,-18000,-18000
057146,技嘉國票98購01  ,0,0,0,0,0,0,0,0,0,-18000,0,0,0,1000,19000,-18000,-18000
059133,臺股指群益99購08,0,0,0,0,0,0,0,0,0,-18000,0,0,0,9000,27000,-18000,-18000
059154,可成日盛99購02  ,0,0,0,0,0,0,0,0,0,-18000,0,0,0,0,18000,-18000,-18000
058581,大立光群益99購05,0,0,0,0,0,0,0,0,0,-18000,0,0,0,0,18000,-18000,-18000
058896,中環元大99購03  ,0,0,0,0,0,0,0,0,0,-18000,0,0,0,12000,30000,-18000,-18000
058907,健策元大99購04  ,0,0,0,0,0,0,0,0,0,-18000,0,0,0,77000,95000,-18000,-18000
058498,世紀鋼群益99購01,0,0,0,0,0,0,0,0,0,-18000,0,0,0,2000,20000,-18000,-18000
2706,第一店          ,2000,5000,-3000,0,0,0,0,0,0,-15000,0,15000,-15000,0,0,0,-18000
059540,新光金日盛99購01,0,0,0,0,0,0,0,0,0,-18000,0,0,0,0,18000,-18000,-18000
9908,大台北          ,6000,22000,-16000,0,0,0,0,0,0,-2000,0,2000,-2000,0,0,0,-18000
060828,高股息國票9A購01,0,0,0,0,0,0,0,0,0,-19000,0,0,0,81000,100000,-19000,-19000
061216,世芯元大9A購06  ,0,0,0,0,0,0,0,0,0,-19000,0,0,0,77000,96000,-19000,-19000
061201,FBVIX元大01購03 ,0,0,0,0,0,0,0,0,0,-19000,0,0,0,5000,24000,-19000,-19000
061307,和潤永豐9A購02  ,0,0,0,0,0,0,0,0,0,-19000,0,0,0,0,19000,-19000,-19000
061340,義隆元大9A購01  ,0,0,0,0,0,0,0,0,0,-19000,0,0,0,12000,31000,-19000,-19000
6655,科定            ,0,19000,-19000,0,0,0,0,0,0,0,0,0,0,0,0,0,-19000
2420,新巨            ,2000,20000,-18000,0,0,0,0,0,0,-1000,0,1000,-1000,0,0,0,-19000
1101B,台泥乙特        ,0,0,0,0,0,0,0,0,0,-19000,1000,20000,-19000,0,0,0,-19000
06868P,電子類元大99售01,0,0,0,0,0,0,0,0,0,-19000,0,0,0,3000,22000,-19000,-19000
06935P,神達元大98售02  ,0,0,0,0,0,0,0,0,0,-19000,0,0,0,1000,20000,-19000,-19000
07245P,台積電凱基99售16,0,0,0,0,0,0,0,0,0,-19000,0,0,0,58000,77000,-19000,-19000
05063P,聯電元大96售03  ,0,0,0,0,0,0,0,0,0,-19000,0,0,0,3000,22000,-19000,-19000
04907P,超眾國票95售01  ,0,0,0,0,0,0,0,0,0,-19000,0,0,0,0,19000,-19000,-19000
00728,第一金工業30    ,0,0,0,0,0,0,0,0,0,-19000,0,0,0,449000,468000,-19000,-19000
051386,富邦金麥證96購01,0,0,0,13000,32000,-19000,0,0,0,-19000,0,0,0,13000,32000,-19000,-19000
051346,仁寶元大95購01  ,0,0,0,0,0,0,0,0,0,-19000,0,0,0,50000,69000,-19000,-19000
05192P,玉晶光台新96售02,0,0,0,0,0,0,0,0,0,-19000,0,0,0,0,19000,-19000,-19000
052388,旺宏群益96購05  ,0,0,0,0,0,0,0,0,0,-19000,0,0,0,147000,166000,-19000,-19000
05282P,可成元大95售09  ,0,0,0,0,0,0,0,0,0,-19000,0,0,0,0,19000,-19000,-19000
058339,康友元富99購02  ,0,0,0,0,0,0,0,0,0,-19000,0,0,0,1000,20000,-19000,-19000
058693,旭富國票9A購01  ,0,0,0,0,0,0,0,0,0,-19000,0,0,0,34000,53000,-19000,-19000
059007,南電元大99購05  ,0,0,0,0,0,0,0,0,0,-19000,0,0,0,1000,20000,-19000,-19000
055586,旺宏元大98購06  ,0,0,0,0,0,0,0,0,0,-19000,0,0,0,41000,60000,-19000,-19000
056091,百和統一97購01  ,0,0,0,0,0,0,0,0,0,-19000,0,0,0,55000,74000,-19000,-19000
056036,鴻海凱基97購07  ,0,0,0,0,0,0,0,0,0,-19000,0,0,0,3000,22000,-19000,-19000
055691,訊芯凱基97購02  ,0,0,0,0,0,0,0,0,0,-19000,0,0,0,0,19000,-19000,-19000
057341,技嘉台新98購01  ,0,0,0,0,0,0,0,0,0,-19000,0,0,0,0,19000,-19000,-19000
060103,聯詠元大99購01  ,0,0,0,0,0,0,0,0,0,-19000,0,0,0,20000,39000,-19000,-19000
057656,大成鋼兆豐98購01,0,0,0,0,0,0,0,0,0,-19000,0,0,0,1000,20000,-19000,-19000
9927,泰銘            ,6000,25000,-19000,0,0,0,0,0,0,0,0,0,0,0,0,0,-19000
059836,大立光國泰9B購02,0,0,0,0,0,0,0,0,0,-19000,0,0,0,28000,47000,-19000,-19000
059320,華新科元大99購15,0,0,0,0,0,0,0,0,0,-19000,0,0,0,0,19000,-19000,-19000
3030,德律            ,98000,110000,-12000,0,0,0,0,1000,-1000,-6000,0,6000,-6000,0,0,0,-19000
3583,辛耘            ,42000,61000,-19000,0,0,0,0,0,0,0,0,0,0,0,0,0,-19000
3494,誠研            ,0,19000,-19000,0,0,0,0,0,0,0,0,0,0,0,0,0,-19000
07252P,台灣50凱基99售01,0,0,0,0,0,0,0,0,0,-20000,0,0,0,116000,136000,-20000,-20000
07347P,上証2X凱基99售02,0,0,0,0,0,0,0,0,0,-20000,0,0,0,10000,30000,-20000,-20000
07324P,台積電元大99售40,0,0,0,0,0,0,0,0,0,-20000,0,0,0,150000,170000,-20000,-20000
07315P,台積電台新99售06,0,0,0,0,0,0,0,0,0,-20000,0,0,0,0,20000,-20000,-20000
07566P,台積電台新9B售02,0,0,0,0,0,0,0,0,0,-20000,0,0,0,0,20000,-20000,-20000
07487P,鴻海國票9A售01  ,0,0,0,0,0,0,0,0,0,-20000,0,0,0,0,20000,-20000,-20000
06753P,智邦富邦98售03  ,0,0,0,0,0,0,0,0,0,-20000,0,0,0,0,20000,-20000,-20000
06503P,臺股指中信9A售02,0,0,0,0,0,0,0,0,0,-20000,0,0,0,0,20000,-20000,-20000
06507P,台表科國票99售01,0,0,0,0,0,0,0,0,0,-20000,0,0,0,0,20000,-20000,-20000
07057P,大立光康和9B售02,0,0,0,0,0,0,0,0,0,-20000,0,0,0,10000,30000,-20000,-20000
06964P,臺股指凱基9B售01,0,0,0,0,0,0,0,0,0,-20000,0,0,0,0,20000,-20000,-20000
06967P,台郡台新99售02  ,0,0,0,0,0,0,0,0,0,-20000,0,0,0,0,20000,-20000,-20000
07238P,台灣50國票99售07,0,0,0,0,0,0,0,0,0,-20000,0,0,0,0,20000,-20000,-20000
07134P,臺股指元大9A售28,0,0,0,0,0,0,0,0,0,-20000,0,0,0,9000,29000,-20000,-20000
07703P,玉晶光中信9B售03,0,0,0,0,0,0,0,0,0,-20000,0,0,0,0,20000,-20000,-20000
8033,雷虎            ,8000,28000,-20000,0,0,0,0,0,0,0,0,0,0,0,0,0,-20000
061370,晶技國泰9C購01  ,0,0,0,0,0,0,0,0,0,-20000,0,0,0,0,20000,-20000,-20000
06192P,高股息中信98售01,0,0,0,0,0,0,0,0,0,-20000,0,0,0,0,20000,-20000,-20000
06452P,大立光元大98售08,0,0,0,0,0,0,0,0,0,-20000,0,0,0,0,20000,-20000,-20000
06421P,嘉澤統一97售02  ,0,0,0,0,0,0,0,0,0,-20000,0,0,0,10000,30000,-20000,-20000
06239P,奇力新元大97售08,0,0,0,0,0,0,0,0,0,-20000,0,0,0,30000,50000,-20000,-20000
06314P,GIS元富97售02   ,0,0,0,0,0,0,0,0,0,-20000,0,0,0,0,20000,-20000,-20000
061235,台積電元大9A購23,0,0,0,0,0,0,0,0,0,-20000,0,0,0,0,20000,-20000,-20000
061267,玉山金凱基9B購01,0,0,0,0,0,0,0,0,0,-20000,0,0,0,0,20000,-20000,-20000
061145,臻鼎中信9A購02  ,0,0,0,0,0,0,0,0,0,-20000,0,0,0,0,20000,-20000,-20000
06717P,可成元大98售09  ,0,0,0,0,0,0,0,0,0,-20000,0,0,0,0,20000,-20000,-20000
06087P,國巨永豐97售01  ,0,0,0,0,0,0,0,0,0,-20000,0,0,0,0,20000,-20000,-20000
06603P,立積統一99售01  ,0,0,0,0,0,0,0,0,0,-20000,0,0,0,3000,23000,-20000,-20000
060274,T50反1元大9A購04,0,0,0,0,0,0,0,0,0,-20000,0,0,0,0,20000,-20000,-20000
060512,祥碩元大9A購02  ,0,0,0,0,0,0,0,0,0,-20000,0,0,0,4000,24000,-20000,-20000
060778,臺股指凱基9A購06,0,0,0,0,0,0,0,0,0,-20000,0,0,0,167000,187000,-20000,-20000
058644,元黃金富邦03購01,0,0,0,0,0,0,0,0,0,-20000,0,0,0,0,20000,-20000,-20000
056342,中工凱基98購01  ,0,0,0,0,0,0,0,0,0,-20000,0,0,0,0,20000,-20000,-20000
056360,智邦元大98購01  ,0,0,0,0,0,0,0,0,0,-20000,0,0,0,21000,41000,-20000,-20000
057700,新日興群益9A購01,0,0,0,0,0,0,0,0,0,-20000,0,0,0,0,20000,-20000,-20000
057702,同欣電群益99購01,0,0,0,0,0,0,0,0,0,-20000,0,0,0,0,20000,-20000,-20000
052995,上銀康和96購01  ,0,0,0,0,0,0,0,0,0,-20000,0,0,0,0,20000,-20000,-20000
053093,緯穎元大96購06  ,0,0,0,0,0,0,0,0,0,-20000,0,0,0,0,20000,-20000,-20000
053019,禾伸堂元富96購01,0,0,0,0,0,0,0,0,0,-20000,0,0,0,0,20000,-20000,-20000
053789,彩晶元大9C購02  ,0,0,0,0,0,0,0,0,0,-20000,0,0,0,0,20000,-20000,-20000
053568,智伸科富邦98購01,0,0,0,0,0,0,0,0,0,-20000,0,0,0,1000,21000,-20000,-20000
053459,康控國泰97購01  ,0,0,0,0,0,0,0,0,0,-20000,0,0,0,0,20000,-20000,-20000
053481,同欣電元大97購01,0,0,0,0,0,0,0,0,0,-20000,0,0,0,0,20000,-20000,-20000
053382,友達元大9C購02  ,0,0,0,0,0,0,0,0,0,-20000,0,0,0,0,20000,-20000,-20000
055507,樺漢元大98購02  ,0,0,0,0,0,0,0,0,0,-20000,0,0,0,0,20000,-20000,-20000
05537P,群創中信98售01  ,0,0,0,0,0,0,0,0,0,-20000,0,0,0,0,20000,-20000,-20000
05525P,奇力新群益96售02,0,0,0,0,0,0,0,0,0,-20000,0,0,0,20000,40000,-20000,-20000
054835,致新中信97購01  ,0,0,0,0,0,0,0,0,0,-20000,0,0,0,0,20000,-20000,-20000
054890,聯鈞統一99購01  ,0,0,0,0,0,0,0,0,0,-20000,0,0,0,36000,56000,-20000,-20000
054917,聯發科凱基98購05,0,0,0,0,0,0,0,0,0,-20000,0,0,0,0,20000,-20000,-20000
054969,亞翔元大97購01  ,0,0,0,0,0,0,0,0,0,-20000,0,0,0,0,20000,-20000,-20000
054961,玉晶光元大99購01,0,0,0,0,0,0,0,0,0,-20000,0,0,0,0,20000,-20000,-20000
054544,統一中信97購01  ,0,0,0,0,0,0,0,0,0,-20000,0,0,0,0,20000,-20000,-20000
054481,鎧勝中信96購01  ,0,0,0,0,0,0,0,0,0,-20000,0,0,0,38000,58000,-20000,-20000
054662,同欣電元大97購02,0,0,0,0,0,0,0,0,0,-20000,0,0,0,0,20000,-20000,-20000
052488,旺宏國票96購03  ,0,0,0,0,0,0,0,0,0,-20000,0,0,0,1000,21000,-20000,-20000
05260P,和碩元富95售02  ,0,0,0,0,0,0,0,0,0,-20000,0,0,0,0,20000,-20000,-20000
051831,緯穎元大96購04  ,0,0,0,0,0,0,0,0,0,-20000,0,0,0,0,20000,-20000,-20000
052132,旺宏凱基9B購01  ,0,0,0,0,0,0,0,0,0,-20000,0,0,0,10000,30000,-20000,-20000
052174,聯發科元大95購13,0,0,0,0,0,0,0,0,0,-20000,0,0,0,0,20000,-20000,-20000
052430,泰碩永豐95購02  ,0,0,0,0,0,0,0,0,0,-20000,0,0,0,10000,30000,-20000,-20000
050957,T50反1台新05購01,0,0,0,0,0,0,0,0,0,-20000,0,0,0,0,20000,-20000,-20000
051422,超眾國票96購01  ,0,0,0,0,0,0,0,0,0,-20000,0,0,0,17000,37000,-20000,-20000
051667,光磊元大96購02  ,0,0,0,0,0,0,0,0,0,-20000,0,0,0,0,20000,-20000,-20000
048499,達運元大96購01  ,0,0,0,0,0,0,0,0,0,-20000,0,0,0,0,20000,-20000,-20000
03314P,台積電元大02售16,0,0,0,0,0,0,0,0,0,-20000,0,0,0,0,20000,-20000,-20000
03033P,微星國票03售01  ,0,0,0,0,0,0,0,0,0,-20000,0,0,0,0,20000,-20000,-20000
049236,元油2X元富96購06,0,0,0,0,0,0,0,0,0,-20000,0,0,0,0,20000,-20000,-20000
049238,元油2X元富96購08,0,0,0,0,0,0,0,0,0,-20000,0,0,0,0,20000,-20000,-20000
03686P,大立光統一98售02,0,0,0,0,0,0,0,0,0,-20000,0,0,0,0,20000,-20000,-20000
045768,大立光元富95購02,0,0,0,0,0,0,0,0,0,-20000,0,0,0,0,20000,-20000,-20000
05764P,世紀鋼永豐96售03,0,0,0,0,0,0,0,0,0,-20000,0,0,0,0,20000,-20000,-20000
057469,康友永豐98購02  ,0,0,0,0,0,0,0,0,0,-20000,0,0,0,0,20000,-20000,-20000
059273,臺指反元大9C購03,0,0,0,0,0,0,0,0,0,-20000,0,0,0,0,20000,-20000,-20000
059268,鎧勝中信01購01  ,0,0,0,0,0,0,0,0,0,-20000,0,0,0,7000,27000,-20000,-20000
060165,上緯控永豐9A購01,0,0,0,0,0,0,0,0,0,-20000,0,0,0,0,20000,-20000,-20000
057304,為升兆豐99購02  ,0,0,0,0,0,0,0,0,0,-20000,0,0,0,0,20000,-20000,-20000
057296,智原永豐98購01  ,0,0,0,0,0,0,0,0,0,-20000,0,0,0,62000,82000,-20000,-20000
055659,百和元富97購01  ,0,0,0,0,0,0,0,0,0,-20000,0,0,0,0,20000,-20000,-20000
057416,T50反1凱基9C購01,0,0,0,0,0,0,0,0,0,-20000,0,0,0,0,20000,-20000,-20000
055933,欣興群益98購02  ,0,0,0,0,0,0,0,0,0,-20000,0,0,0,2000,22000,-20000,-20000
056092,亞德客元富97購02,0,0,0,0,0,0,0,0,0,-20000,0,0,0,29000,49000,-20000,-20000
056097,訊芯元富97購02  ,0,0,0,0,0,0,0,0,0,-20000,0,0,0,0,20000,-20000,-20000
056164,聯茂凱基98購03  ,0,0,0,0,0,0,0,0,0,-20000,0,0,0,1000,21000,-20000,-20000
059089,聯發科元大99購19,0,0,0,0,0,0,0,0,0,-20000,0,0,0,0,20000,-20000,-20000
058125,元油2X元大9C購01,0,0,0,0,0,0,0,0,0,-20000,0,0,0,0,20000,-20000,-20000
055887,上銀統一97購03  ,0,0,0,0,0,0,0,0,0,-20000,0,0,0,0,20000,-20000,-20000
056804,T50反1統一9A購03,0,0,0,0,0,0,0,0,0,-20000,0,0,0,50000,70000,-20000,-20000
056973,T50反1永昌9C購01,9000,0,9000,0,0,0,0,0,0,-29000,0,0,0,0,29000,-29000,-20000
056897,南亞科元大98購02,0,0,0,0,0,0,0,0,0,-20000,0,0,0,51000,71000,-20000,-20000
058081,技嘉群益9A購03  ,0,0,0,0,0,0,0,0,0,-20000,0,0,0,24000,44000,-20000,-20000
058704,台積電元大99購17,0,0,0,0,0,0,0,0,0,-20000,0,0,0,0,20000,-20000,-20000
058727,嘉晶富邦9A購01  ,0,0,0,0,0,0,0,0,0,-20000,0,0,0,50000,70000,-20000,-20000
056546,致伸凱基98購01  ,0,0,0,0,0,0,0,0,0,-20000,0,0,0,0,20000,-20000,-20000
059038,健策群益9A購02  ,0,0,0,0,0,0,0,0,0,-20000,0,0,0,0,20000,-20000,-20000
058470,台灣50日盛9B購02,0,0,0,0,0,0,0,0,0,-20000,0,0,0,0,20000,-20000,-20000
05843P,台積電元大96售16,0,0,0,0,0,0,0,0,0,-20000,0,0,0,0,20000,-20000,-20000
058853,日月光群益99購01,0,0,0,0,0,0,0,0,0,-20000,0,0,0,0,20000,-20000,-20000
058842,元油2X群益9C購01,0,0,0,0,0,0,0,0,0,-20000,0,0,0,0,20000,-20000,-20000
05673P,台積電群益96售05,0,0,0,0,0,0,0,0,0,-20000,0,0,0,40000,60000,-20000,-20000
056627,訊芯永豐98購01  ,0,0,0,0,0,0,0,0,0,-20000,0,0,0,23000,43000,-20000,-20000
056652,上証反元大9B購01,0,0,0,0,0,0,0,0,0,-20000,0,0,0,0,20000,-20000,-20000
058836,FBVIX中信03購05 ,0,0,0,0,0,0,0,0,0,-20000,0,0,0,58000,78000,-20000,-20000
058809,國巨統一9B購03  ,0,0,0,0,0,0,0,0,0,-20000,0,0,0,0,20000,-20000,-20000
058827,聯發科永豐9A購01,0,0,0,0,0,0,0,0,0,-20000,0,0,0,0,20000,-20000,-20000
3686,達能            ,1000,21000,-20000,0,0,0,0,0,0,0,0,0,0,0,0,0,-20000
059655,T50反1元大99購10,0,0,0,0,0,0,0,0,0,-20000,0,0,0,0,20000,-20000,-20000
059964,元金2X凱基99購02,0,0,0,0,0,0,0,0,0,-20000,0,0,0,25000,45000,-20000,-20000
060763,聯鈞元大9A購03  ,0,0,0,0,0,0,0,0,0,-21000,0,0,0,224000,245000,-21000,-21000
060289,京元電元大9A購01,0,0,0,0,0,0,0,0,0,-21000,0,0,0,53000,74000,-21000,-21000
6715,嘉基            ,1000,22000,-21000,0,0,0,0,0,0,0,0,0,0,0,0,0,-21000
2059,川湖            ,81000,102000,-21000,0,0,0,0,0,0,0,6000,6000,0,0,0,0,-21000
07505P,台勝科元大9A售01,0,0,0,0,0,0,0,0,0,-21000,0,0,0,6000,27000,-21000,-21000
07413P,國巨元大99售33  ,0,0,0,0,0,0,0,0,0,-21000,0,0,0,29000,50000,-21000,-21000
07374P,鴻海元大99售41  ,0,0,0,0,0,0,0,0,0,-21000,0,0,0,0,21000,-21000,-21000
05059P,大立光國票96售02,0,0,0,0,0,0,0,0,0,-21000,0,0,0,21000,42000,-21000,-21000
050121,南電元大95購02  ,0,0,0,0,0,0,0,0,0,-21000,0,0,0,10000,31000,-21000,-21000
00757,統一FANG+       ,0,0,0,0,0,0,0,0,0,-21000,0,0,0,221000,242000,-21000,-21000
0052,富邦科技        ,2000,1000,1000,0,0,0,0,0,0,-22000,0,0,0,117000,139000,-22000,-21000
054003,鴻海統一96購13  ,0,0,0,0,0,0,0,0,0,-21000,0,0,0,0,21000,-21000,-21000
054649,聯茂群益97購01  ,0,0,0,0,0,0,0,0,0,-21000,0,0,0,0,21000,-21000,-21000
057788,嘉聯益國票99購01,0,0,0,0,0,0,0,0,0,-21000,0,0,0,0,21000,-21000,-21000
056412,上証2X中信9A購02,0,0,0,0,0,0,0,0,0,-21000,0,0,0,9000,30000,-21000,-21000
059001,聯發科元大99購17,0,0,0,0,0,0,0,0,0,-21000,0,0,0,0,21000,-21000,-21000
055619,同欣電國票98購02,0,0,0,0,0,0,0,0,0,-21000,0,0,0,0,21000,-21000,-21000
059030,奇力新兆豐99購03,0,0,0,0,0,0,0,0,0,-21000,0,0,0,24000,45000,-21000,-21000
057256,元油2X兆豐98購01,0,0,0,0,0,0,0,0,0,-21000,0,0,0,0,21000,-21000,-21000
05727P,新光金日盛96售02,0,0,0,0,0,0,0,0,0,-21000,0,0,0,0,21000,-21000,-21000
057268,臻鼎兆豐99購01  ,0,0,0,0,0,0,0,0,0,-21000,0,0,0,0,21000,-21000,-21000
3022,威強電          ,29000,47000,-18000,0,0,0,0,0,0,-3000,0,3000,-3000,0,0,0,-21000
6115,鎰勝            ,4000,20000,-16000,0,0,0,0,0,0,-5000,0,5000,-5000,0,0,0,-21000
07378P,大立光元大99售29,0,0,0,0,0,0,0,0,0,-22000,0,0,0,3000,25000,-22000,-22000
07291P,臺股指凱基99售43,0,0,0,0,0,0,0,0,0,-22000,0,0,0,20000,42000,-22000,-22000
07171P,臺股指國票99售08,0,0,0,0,0,0,0,0,0,-22000,0,0,0,10000,32000,-22000,-22000
06843P,鴻海元大98售11  ,0,0,0,0,0,0,0,0,0,-22000,0,0,0,15000,37000,-22000,-22000
2030,彰源            ,15000,34000,-19000,0,0,0,0,0,0,-3000,0,3000,-3000,0,0,0,-22000
07765P,台積電群益9A售06,0,0,0,0,0,0,0,0,0,-22000,0,0,0,50000,72000,-22000,-22000
1435,中福            ,4000,26000,-22000,0,0,0,0,0,0,0,0,0,0,0,0,0,-22000
060357,上銀元富9A購02  ,0,0,0,0,0,0,0,0,0,-22000,0,0,0,0,22000,-22000,-22000
060595,台灣50凱基04購04,0,0,0,0,0,0,0,0,0,-22000,0,0,0,0,22000,-22000,-22000
06683P,訊芯元大98售07  ,0,0,0,0,0,0,0,0,0,-22000,0,0,0,0,22000,-22000,-22000
06180P,禾伸堂群益97售01,0,0,0,0,0,0,0,0,0,-22000,0,0,0,10000,32000,-22000,-22000
057699,可成群益9A購02  ,0,0,0,0,0,0,0,0,0,-22000,0,0,0,81000,103000,-22000,-22000
052614,聯電國泰97購01  ,35000,0,35000,0,0,0,0,0,0,-57000,0,0,0,25000,82000,-57000,-22000
048001,中工元大96購01  ,0,0,0,0,0,0,0,0,0,-22000,0,0,0,5000,27000,-22000,-22000
057191,祥碩元大98購05  ,0,0,0,0,0,0,0,0,0,-22000,0,0,0,50000,72000,-22000,-22000
058970,鴻海永豐99購02  ,0,0,0,0,0,0,0,0,0,-22000,0,0,0,3000,25000,-22000,-22000
058714,美律統一9B購01  ,0,0,0,0,0,0,0,0,0,-22000,0,0,0,10000,32000,-22000,-22000
056621,宏達電永豐98購01,0,0,0,0,0,0,0,0,0,-22000,0,0,0,0,22000,-22000,-22000
056762,亞德客元大98購01,0,0,0,0,0,0,0,0,0,-22000,0,0,0,8000,30000,-22000,-22000
058876,南電國票9A購02  ,0,0,0,0,0,0,0,0,0,-22000,0,0,0,0,22000,-22000,-22000
6197,佳必琪          ,57000,71000,-14000,0,0,0,0,0,0,-8000,0,8000,-8000,0,0,0,-22000
060996,臻鼎元大9A購01  ,0,0,0,0,0,0,0,0,0,-23000,0,0,0,20000,43000,-23000,-23000
060241,國泰金元大9A購01,0,0,0,0,0,0,0,0,0,-23000,0,0,0,84000,107000,-23000,-23000
1531,高林股          ,3000,26000,-23000,0,0,0,0,0,0,0,0,0,0,0,0,0,-23000
07722P,玉晶光凱基9A售10,0,0,0,0,0,0,0,0,0,-23000,0,0,0,0,23000,-23000,-23000
2348,海悅            ,6000,27000,-21000,0,0,0,0,0,0,-2000,0,2000,-2000,0,0,0,-23000
8249,菱光            ,9000,32000,-23000,0,0,0,0,0,0,0,0,0,0,0,0,0,-23000
06902P,聯電凱基98售02  ,0,0,0,0,0,0,0,0,0,-23000,0,0,0,0,23000,-23000,-23000
07198P,臺股指元大99售14,0,0,0,0,0,0,0,0,0,-23000,0,0,0,0,23000,-23000,-23000
03675C,臺股指元大04牛02,0,0,0,0,0,0,0,0,0,-23000,0,0,0,10000,33000,-23000,-23000
050014,國巨富邦98購01  ,0,0,0,0,0,0,0,0,0,-23000,0,0,0,0,23000,-23000,-23000
05468P,鴻海元大96售14  ,0,0,0,0,0,0,0,0,0,-23000,0,0,0,0,23000,-23000,-23000
054925,神達凱基97購01  ,0,0,0,0,0,0,0,0,0,-23000,0,0,0,0,23000,-23000,-23000
058377,茂林凱基9A購03  ,0,0,0,0,0,0,0,0,0,-23000,0,0,0,189000,212000,-23000,-23000
058926,勤誠元富99購01  ,0,0,0,0,0,0,0,0,0,-23000,0,0,0,43000,66000,-23000,-23000
059143,國巨國票9A購04  ,0,0,0,0,0,0,0,0,0,-23000,0,0,0,71000,94000,-23000,-23000
057076,緯穎永豐98購01  ,0,0,0,0,0,0,0,0,0,-23000,0,0,0,0,23000,-23000,-23000
05719P,可成元大96售03  ,0,0,0,0,0,0,0,0,0,-23000,0,0,0,0,23000,-23000,-23000
057636,上銀元大98購06  ,0,0,0,0,0,0,0,0,0,-23000,0,0,0,0,23000,-23000,-23000
059379,聯電亞東99購02  ,0,0,0,0,0,0,0,0,0,-23000,0,0,0,0,23000,-23000,-23000
059856,昇陽半永豐99購03,0,0,0,0,0,0,0,0,0,-23000,0,0,0,0,23000,-23000,-23000
059824,大立光凱基99購13,0,0,0,0,0,0,0,0,0,-23000,0,0,0,0,23000,-23000,-23000
9902,台火            ,9000,32000,-23000,0,0,0,0,0,0,0,0,0,0,0,0,0,-23000
07241P,台灣50國票9A售05,0,0,0,0,0,0,0,0,0,-24000,0,0,0,5000,29000,-24000,-24000
06982P,義隆凱基99售02  ,0,0,0,0,0,0,0,0,0,-24000,0,0,0,29000,53000,-24000,-24000
06475P,牧德永豐98售03  ,0,0,0,0,0,0,0,0,0,-24000,0,0,0,6000,30000,-24000,-24000
07504P,聯詠元大9A售02  ,0,0,0,0,0,0,0,0,0,-24000,0,0,0,1000,25000,-24000,-24000
07521P,台積電中信01售05,0,0,0,0,0,0,0,0,0,-24000,0,0,0,0,24000,-24000,-24000
07552P,技嘉元大9A售03  ,0,0,0,0,0,0,0,0,0,-24000,0,0,0,50000,74000,-24000,-24000
6605,帝寶            ,10000,34000,-24000,0,0,0,0,0,0,0,0,0,0,0,0,0,-24000
2477,美隆電          ,5000,24000,-19000,0,0,0,0,0,0,-5000,0,5000,-5000,0,0,0,-24000
2227,裕日車          ,9000,23000,-14000,0,0,0,0,1000,-1000,-9000,0,9000,-9000,0,0,0,-24000
1507,永大            ,8000,20000,-12000,0,0,0,0,0,0,-12000,0,12000,-12000,0,0,0,-24000
060323,華通群益9C購01  ,0,0,0,0,0,0,0,0,0,-24000,0,0,0,122000,146000,-24000,-24000
06328P,台積電中信01售02,0,0,0,0,0,0,0,0,0,-24000,0,0,0,0,24000,-24000,-24000
054445,技嘉兆豐96購01  ,0,0,0,0,0,0,0,0,0,-24000,0,0,0,0,24000,-24000,-24000
052263,聯電亞東95購01  ,0,0,0,0,0,0,0,0,0,-24000,0,0,0,0,24000,-24000,-24000
054050,創意元大96購06  ,0,0,0,0,0,0,0,0,0,-24000,0,0,0,26000,50000,-24000,-24000
052206,燿華中信95購02  ,0,0,0,0,0,0,0,0,0,-24000,0,0,0,0,24000,-24000,-24000
059275,可成元大99購05  ,0,0,0,0,0,0,0,0,0,-24000,0,0,0,20000,44000,-24000,-24000
060198,祥碩元富9A購02  ,0,0,0,0,0,0,0,0,0,-24000,0,0,0,26000,50000,-24000,-24000
060001,台灣50群益9A購10,0,0,0,0,0,0,0,0,0,-24000,0,0,0,0,24000,-24000,-24000
059023,可成統一9B購02  ,0,0,0,0,0,0,0,0,0,-24000,0,0,0,96000,120000,-24000,-24000
056143,訊芯元大97購04  ,0,0,0,0,0,0,0,0,0,-24000,0,0,0,78000,102000,-24000,-24000
059009,世紀鋼元大99購04,0,0,0,0,0,0,0,0,0,-24000,0,0,0,42000,66000,-24000,-24000
059174,訊芯凱基99購01  ,0,0,0,0,0,0,0,0,0,-24000,0,0,0,56000,80000,-24000,-24000
058553,合勤控永豐99購01,0,0,0,0,0,0,0,0,0,-24000,0,0,0,25000,49000,-24000,-24000
056398,南茂永豐98購01  ,0,0,0,0,0,0,0,0,0,-24000,0,0,0,71000,95000,-24000,-24000
056711,亞光永豐98購01  ,0,0,0,0,0,0,0,0,0,-24000,0,0,0,0,24000,-24000,-24000
059817,華通凱基99購05  ,0,0,0,0,0,0,0,0,0,-24000,0,0,0,2000,26000,-24000,-24000
2904,匯僑            ,1000,25000,-24000,0,0,0,0,0,0,0,0,0,0,0,0,0,-24000
4532,瑞智            ,17000,40000,-23000,0,0,0,0,0,0,-1000,0,1000,-1000,0,0,0,-24000
4137,麗豐-KY         ,34000,55000,-21000,0,0,0,0,0,0,-3000,0,3000,-3000,2000,2000,0,-24000
4141,龍燈-KY         ,4000,28000,-24000,0,0,0,0,0,0,0,0,0,0,0,0,0,-24000
06327P,台積電中信01售01,0,0,0,0,0,0,0,0,0,-25000,0,0,0,0,25000,-25000,-25000
06396P,新日興康和97售01,0,0,0,0,0,0,0,0,0,-25000,0,0,0,0,25000,-25000,-25000
06355P,聯茂永豐97售02  ,0,0,0,0,0,0,0,0,0,-25000,0,0,0,0,25000,-25000,-25000
061346,玉晶光元大9B購03,0,0,0,0,0,0,0,0,0,-25000,0,0,0,0,25000,-25000,-25000
061209,聯發科元大9A購10,0,0,0,0,0,0,0,0,0,-25000,0,0,0,0,25000,-25000,-25000
061134,大成鋼統一9C購01,0,0,0,0,0,0,0,0,0,-25000,0,0,0,0,25000,-25000,-25000
06038P,國泰金台新96售01,0,0,0,0,0,0,0,0,0,-25000,0,0,0,0,25000,-25000,-25000
060502,國巨元大9A購07  ,0,0,0,0,0,0,0,0,0,-25000,0,0,0,36000,61000,-25000,-25000
060419,漢翔永豐9A購01  ,0,0,0,0,0,0,0,0,0,-25000,0,0,0,5000,30000,-25000,-25000
07687P,上銀元大9A售06  ,0,0,0,0,0,0,0,0,0,-25000,0,0,0,0,25000,-25000,-25000
1104,環泥            ,53000,77000,-24000,0,0,0,0,1000,-1000,0,0,0,0,0,0,0,-25000
2355,敬鵬            ,195000,179000,16000,0,0,0,0,0,0,-41000,0,41000,-41000,0,0,0,-25000
07503P,禾伸堂元大9A售01,0,0,0,0,0,0,0,0,0,-25000,0,0,0,5000,30000,-25000,-25000
07542P,台積電凱基9A售16,0,0,0,0,0,0,0,0,0,-25000,0,0,0,0,25000,-25000,-25000
07379P,大立光元大99售30,0,0,0,0,0,0,0,0,0,-25000,0,0,0,100000,125000,-25000,-25000
07395P,台積電群益99售13,0,0,0,0,0,0,0,0,0,-25000,0,0,0,77000,102000,-25000,-25000
06584P,欣興凱基98售03  ,0,0,0,0,0,0,0,0,0,-25000,0,0,0,0,25000,-25000,-25000
06744P,嘉聯益永豐98售03,0,0,0,0,0,0,0,0,0,-25000,0,0,0,8000,33000,-25000,-25000
07108P,FBVIX台新99售02 ,0,0,0,0,0,0,0,0,0,-25000,0,0,0,1000,26000,-25000,-25000
052095,彩晶元大97購01  ,0,0,0,0,0,0,0,0,0,-25000,0,0,0,0,25000,-25000,-25000
054025,鴻海凱基96購17  ,0,0,0,0,0,0,0,0,0,-25000,0,0,0,18000,43000,-25000,-25000
052246,超眾康和95購01  ,0,0,0,0,0,0,0,0,0,-25000,0,0,0,23000,48000,-25000,-25000
050829,臻鼎凱基96購01  ,0,0,0,0,0,0,0,0,0,-25000,0,0,0,0,25000,-25000,-25000
04914P,國巨國泰95售06  ,0,0,0,0,0,0,0,0,0,-25000,0,0,0,0,25000,-25000,-25000
055022,精元國泰99購01  ,0,0,0,0,0,0,0,0,0,-25000,0,0,0,20000,45000,-25000,-25000
055497,開發金元大97購01,0,0,0,0,0,0,0,0,0,-25000,0,0,0,42000,67000,-25000,-25000
052816,上銀永豐96購01  ,0,0,0,0,0,0,0,0,0,-25000,0,0,0,23000,48000,-25000,-25000
055374,明泰元大97購01  ,0,0,0,0,0,0,0,0,0,-25000,0,0,0,0,25000,-25000,-25000
05861P,瀚宇博永豐96售02,0,0,0,0,0,0,0,0,0,-25000,0,0,0,0,25000,-25000,-25000
053510,聯電群益97購01  ,0,0,0,0,0,0,0,0,0,-25000,0,0,0,554000,579000,-25000,-25000
058828,大毅永豐99購01  ,0,0,0,0,0,0,0,0,0,-25000,0,0,0,15000,40000,-25000,-25000
056458,日月光凱基98購02,0,0,0,0,0,0,0,0,0,-25000,0,0,0,5000,30000,-25000,-25000
058726,宏達電富邦9A購01,0,0,0,0,0,0,0,0,0,-25000,0,0,0,0,25000,-25000,-25000
057000,亞德客國票99購01,0,0,0,0,0,0,0,0,0,-25000,0,0,0,6000,31000,-25000,-25000
05805P,義隆永豐96售02  ,0,0,0,0,0,0,0,0,0,-25000,0,0,0,40000,65000,-25000,-25000
056777,矽力元大98購02  ,0,0,0,0,0,0,0,0,0,-25000,0,0,0,0,25000,-25000,-25000
057973,神達富邦9A購01  ,0,0,0,0,0,0,0,0,0,-25000,0,0,0,57000,82000,-25000,-25000
056142,超眾元大97購06  ,0,0,0,0,0,0,0,0,0,-25000,0,0,0,60000,85000,-25000,-25000
057383,玉晶光富邦9A購01,0,0,0,0,0,0,0,0,0,-25000,0,0,0,0,25000,-25000,-25000
059725,聯發科元大99購31,0,0,0,0,0,0,0,0,0,-25000,0,0,0,0,25000,-25000,-25000
3557,嘉威            ,52000,77000,-25000,0,0,0,0,0,0,0,0,0,0,0,0,0,-25000
05943P,欣興凱基96售03  ,0,0,0,0,0,0,0,0,0,-25000,0,0,0,5000,30000,-25000,-25000
9918,欣天然          ,0,25000,-25000,0,0,0,0,0,0,0,0,0,0,0,0,0,-25000
06984P,上銀富邦9B售01  ,0,0,0,0,0,0,0,0,0,-26000,0,0,0,5000,31000,-26000,-26000
06908P,健策國泰99售02  ,0,0,0,0,0,0,0,0,0,-26000,0,0,0,0,26000,-26000,-26000
07294P,滬深2X元富9C售08,0,0,0,0,0,0,0,0,0,-26000,0,0,0,100000,126000,-26000,-26000
2429,銘旺科          ,6000,32000,-26000,0,0,0,0,0,0,0,0,0,0,0,0,0,-26000
2431,聯昌            ,13000,39000,-26000,0,0,0,0,0,0,0,0,0,0,0,0,0,-26000
8101,華冠            ,4000,30000,-26000,0,0,0,0,0,0,0,0,0,0,0,0,0,-26000
1219,福壽            ,13000,34000,-21000,0,0,0,0,0,0,-5000,0,5000,-5000,0,0,0,-26000
060382,儒鴻凱基9A購01  ,0,0,0,0,0,0,0,0,0,-26000,0,0,0,59000,85000,-26000,-26000
061278,和大統一9A購01  ,0,0,0,0,0,0,0,0,0,-26000,0,0,0,16000,42000,-26000,-26000
060829,T50反1國票9A購06,0,0,0,0,0,0,0,0,0,-26000,0,0,0,0,26000,-26000,-26000
058342,鴻海群益9A購01  ,0,0,0,0,0,0,0,0,0,-26000,0,0,0,69000,95000,-26000,-26000
055382,台郡元大99購01  ,0,0,0,0,0,0,0,0,0,-26000,0,0,0,7000,33000,-26000,-26000
055406,大毅國泰99購01  ,0,0,0,0,0,0,0,0,0,-26000,0,0,0,0,26000,-26000,-26000
051653,南電永豐95購02  ,0,0,0,0,0,0,0,0,0,-26000,0,0,0,10000,36000,-26000,-26000
060025,台積電富邦9C購06,0,0,0,0,0,0,0,0,0,-26000,0,0,0,203000,229000,-26000,-26000
057277,可成元大98購05  ,0,0,0,0,0,0,0,0,0,-26000,0,0,0,33000,59000,-26000,-26000
057325,可成群益9A購01  ,0,0,0,0,0,0,0,0,0,-26000,0,0,0,5000,31000,-26000,-26000
056166,微星台新97購01  ,0,0,0,0,0,0,0,0,0,-26000,0,0,0,0,26000,-26000,-26000
059020,元油2X統一9B購02,0,0,0,0,0,0,0,0,0,-26000,0,0,0,85000,111000,-26000,-26000
055834,國巨元大97購13  ,0,0,0,0,0,0,0,0,0,-26000,0,0,0,0,26000,-26000,-26000
058108,台郡台新99購01  ,0,0,0,0,0,0,0,0,0,-26000,0,0,0,0,26000,-26000,-26000
057075,嘉聯益永豐98購01,0,0,0,0,0,0,0,0,0,-26000,0,0,0,0,26000,-26000,-26000
056619,強茂永豐98購01  ,0,0,0,0,0,0,0,0,0,-26000,0,0,0,50000,76000,-26000,-26000
056668,光磊國票99購01  ,0,0,0,0,0,0,0,0,0,-26000,0,0,0,37000,63000,-26000,-26000
059898,T50反1元大99購15,0,0,0,0,0,0,0,0,0,-26000,0,0,0,110000,136000,-26000,-26000
05925P,晶技永豐96售03  ,0,0,0,0,0,0,0,0,0,-26000,0,0,0,0,26000,-26000,-26000
1218,泰山            ,43545,70000,-26455,0,0,0,0,0,0,0,0,0,0,0,0,0,-26455
1409,新纖            ,321000,303000,18000,0,0,0,0,0,0,-45000,0,45000,-45000,0,0,0,-27000
1340,勝悅-KY         ,1000,28000,-27000,0,0,0,0,0,0,0,0,0,0,0,0,0,-27000
060866,世芯永豐9B購01  ,0,0,0,0,0,0,0,0,0,-27000,0,0,0,36000,63000,-27000,-27000
061017,國泰金麥證9A購01,0,0,0,0,27000,-27000,0,0,0,-27000,0,0,0,0,27000,-27000,-27000
06185P,台表科元大97售05,0,0,0,0,0,0,0,0,0,-27000,0,0,0,66000,93000,-27000,-27000
06411P,晶相光永豐97售03,0,0,0,0,0,0,0,0,0,-27000,0,0,0,10000,37000,-27000,-27000
060581,玉晶光群益9B購02,0,0,0,0,0,0,0,0,0,-27000,0,0,0,0,27000,-27000,-27000
051381,玉晶光群益98購01,0,0,0,0,0,0,0,0,0,-27000,0,0,0,7000,34000,-27000,-27000
051728,道瓊反國票97購01,0,0,0,0,0,0,0,0,0,-27000,0,0,0,0,27000,-27000,-27000
052483,超眾群益95購03  ,0,0,0,0,0,0,0,0,0,-27000,0,0,0,33000,60000,-27000,-27000
03049X,元展46          ,0,0,0,0,0,0,0,0,0,-27000,0,0,0,0,27000,-27000,-27000
03657C,T50反1元大99牛01,0,0,0,0,0,0,0,0,0,-27000,0,0,0,84000,111000,-27000,-27000
02001R,富邦蘋果反一N   ,0,0,0,0,0,0,0,0,0,-27000,0,0,0,15000,42000,-27000,-27000
050047,奇鋐國票95購01  ,0,0,0,0,0,0,0,0,0,-27000,0,0,0,11000,38000,-27000,-27000
045444,群創元富98購02  ,0,0,0,0,0,0,0,0,0,-27000,0,0,0,0,27000,-27000,-27000
052874,超眾凱基96購01  ,0,0,0,0,0,0,0,0,0,-27000,0,0,0,0,27000,-27000,-27000
057766,矽力凱基98購03  ,0,0,0,0,0,0,0,0,0,-27000,0,0,0,0,27000,-27000,-27000
058453,可成永豐99購01  ,0,0,0,0,0,0,0,0,0,-27000,0,0,0,0,27000,-27000,-27000
058722,台郡元富99購01  ,0,0,0,0,0,0,0,0,0,-27000,0,0,0,4000,31000,-27000,-27000
057102,亞光中信9A購01  ,0,0,0,0,0,0,0,0,0,-27000,0,0,0,0,27000,-27000,-27000
05990P,台積電群益96售13,0,0,0,0,0,0,0,0,0,-27000,0,0,0,10000,37000,-27000,-27000
059368,T50正2元富99購02,0,0,0,0,0,0,0,0,0,-27000,0,0,0,58000,85000,-27000,-27000
060506,京元電元大9A購02,0,0,0,0,0,0,0,0,0,-28000,0,0,0,11000,39000,-28000,-28000
061075,亞德客兆豐9A購01,0,0,0,0,0,0,0,0,0,-28000,0,0,0,2000,30000,-28000,-28000
061203,國巨元大9A購15  ,0,0,0,0,0,0,0,0,0,-28000,0,0,0,26000,54000,-28000,-28000
06697P,台積電國票99售05,0,0,0,0,0,0,0,0,0,-28000,0,0,0,0,28000,-28000,-28000
06720P,智邦亞東99售01  ,0,0,0,0,0,0,0,0,0,-28000,0,0,0,0,28000,-28000,-28000
060865,創意永豐9A購01  ,0,0,0,0,0,0,0,0,0,-28000,0,0,0,102000,130000,-28000,-28000
07688P,華通元大9A售07  ,0,0,0,0,0,0,0,0,0,-28000,0,0,0,0,28000,-28000,-28000
8081,致新            ,353000,400000,-47000,0,0,0,8000,0,8000,11000,18000,16000,2000,18000,9000,9000,-28000
8463,潤泰材          ,18000,46000,-28000,0,0,0,0,0,0,0,0,0,0,0,0,0,-28000
2476,鉅祥            ,5000,33000,-28000,0,0,0,0,0,0,0,0,0,0,0,0,0,-28000
2464,盟立            ,34000,58000,-24000,0,0,0,0,0,0,-4000,0,4000,-4000,0,0,0,-28000
07370P,南亞科凱基99售08,0,0,0,0,0,0,0,0,0,-28000,0,0,0,46000,74000,-28000,-28000
07408P,台積電兆豐99售06,0,0,0,0,0,0,0,0,0,-28000,0,0,0,53000,81000,-28000,-28000
06763P,技嘉元大98售05  ,0,0,0,0,0,0,0,0,0,-28000,0,0,0,0,28000,-28000,-28000
055476,台郡凱基97購02  ,0,0,0,0,0,0,0,0,0,-28000,0,0,0,2000,30000,-28000,-28000
046680,上証反群益95購01,0,0,0,0,0,0,0,0,0,-28000,0,0,0,0,28000,-28000,-28000
00736,國泰新興市場    ,62000,0,62000,0,0,0,0,0,0,-90000,0,0,0,100000,190000,-90000,-28000
052134,智邦凱基95購09  ,0,0,0,0,0,0,0,0,0,-28000,0,0,0,0,28000,-28000,-28000
056135,緯創元大98購01  ,0,0,0,0,0,0,0,0,0,-28000,0,0,0,14000,42000,-28000,-28000
057316,國巨凱基99購04  ,0,0,0,0,0,0,0,0,0,-28000,0,0,0,172000,200000,-28000,-28000
057221,華通國票98購03  ,0,0,0,0,0,0,0,0,0,-28000,0,0,0,167000,195000,-28000,-28000
055733,奇力新元富97購01,0,0,0,0,0,0,0,0,0,-28000,0,0,0,72000,100000,-28000,-28000
059983,聯發科元大99購38,0,0,0,0,0,0,0,0,0,-28000,0,0,0,23000,51000,-28000,-28000
059613,泰鼎永豐99購02  ,0,0,0,0,0,0,0,0,0,-28000,0,0,0,86000,114000,-28000,-28000
056776,聯茂元大99購01  ,0,0,0,0,0,0,0,0,0,-28000,0,0,0,0,28000,-28000,-28000
057915,台泥凱基98購01  ,0,0,0,0,0,0,0,0,0,-28000,0,0,0,0,28000,-28000,-28000
058107,全新台新99購01  ,0,0,0,0,0,0,0,0,0,-28000,0,0,0,0,28000,-28000,-28000
059386,上銀凱基99購07  ,0,0,0,0,0,0,0,0,0,-28000,0,0,0,23000,51000,-28000,-28000
05956P,漢唐國票96售02  ,0,0,0,0,0,0,0,0,0,-28000,0,0,0,24000,52000,-28000,-28000
2905,三商            ,74000,78000,-4000,0,0,0,0,0,0,-24000,0,24000,-24000,0,0,0,-28000
3047,訊舟            ,68000,94000,-26000,0,0,0,0,0,0,-2000,0,2000,-2000,0,0,0,-28000
059705,華新科凱基9A購07,0,0,0,0,0,0,0,0,0,-28000,0,0,0,2000,30000,-28000,-28000
4133,亞諾法          ,401000,422000,-21000,0,0,0,0,0,0,-7000,0,7000,-7000,0,0,0,-28000
6112,聚碩            ,22000,49000,-27000,0,0,0,0,0,0,-1000,0,1000,-1000,0,0,0,-28000
07182P,臺股指凱基99售24,0,0,0,0,0,0,0,0,0,-29000,0,0,0,0,29000,-29000,-29000
1451,年興            ,36000,65000,-29000,0,0,0,0,0,0,0,0,0,0,0,0,0,-29000
2010,春源            ,5000,34000,-29000,0,0,0,0,0,0,0,0,0,0,0,0,0,-29000
060849,力成國票9A購01  ,0,0,0,0,0,0,0,0,0,-29000,0,0,0,9000,38000,-29000,-29000
060840,可成國票9B購01  ,0,0,0,0,0,0,0,0,0,-29000,0,0,0,1000,30000,-29000,-29000
06721P,臺股指中信9A售03,0,0,0,0,0,0,0,0,0,-29000,0,0,0,45000,74000,-29000,-29000
06398P,禾伸堂凱基97售02,0,0,0,0,0,0,0,0,0,-29000,0,0,0,4000,33000,-29000,-29000
060626,貿聯元大9A購04  ,0,0,0,0,0,0,0,0,0,-29000,0,0,0,39000,68000,-29000,-29000
053913,華新國票97購01  ,0,0,0,0,0,0,0,0,0,-29000,0,0,0,34000,63000,-29000,-29000
03603P,群創凱基98售04  ,0,0,0,0,0,0,0,0,0,-29000,0,0,0,118000,147000,-29000,-29000
058936,國喬中信99購01  ,0,0,0,0,0,0,0,0,0,-29000,0,0,0,78000,107000,-29000,-29000
05644P,大立光中信9A售03,0,0,0,0,0,0,0,0,0,-29000,0,0,0,0,29000,-29000,-29000
059631,京元電凱基99購02,0,0,0,0,0,0,0,0,0,-29000,0,0,0,35000,64000,-29000,-29000
057604,鴻海統一9C購01  ,0,0,0,0,0,0,0,0,0,-29000,0,0,0,0,29000,-29000,-29000
057301,嘉聯益永豐98購02,0,0,0,0,0,0,0,0,0,-29000,0,0,0,9000,38000,-29000,-29000
055597,禾伸堂元大98購02,0,0,0,0,0,0,0,0,0,-29000,0,0,0,60000,89000,-29000,-29000
056247,台郡群益97購01  ,0,0,0,0,0,0,0,0,0,-29000,0,0,0,21000,50000,-29000,-29000
6533,晶心科          ,46000,74000,-28000,0,0,0,0,0,0,-1000,0,1000,-1000,0,0,0,-29000
059568,台積電凱基9A購13,0,0,0,0,0,0,0,0,0,-29000,0,0,0,3000,32000,-29000,-29000
060589,台灣50台新9B購06,0,0,0,0,0,0,0,0,0,-30000,0,0,0,10000,40000,-30000,-30000
060520,臺指2X中信01購02,0,0,0,0,0,0,0,0,0,-30000,0,0,0,30000,60000,-30000,-30000
060484,聯發科富邦9C購02,0,0,0,0,0,0,0,0,0,-30000,0,0,0,0,30000,-30000,-30000
060463,台積電元大9A購10,0,0,0,0,0,0,0,0,0,-30000,0,0,0,22000,52000,-30000,-30000
061093,華新科統一9B購03,0,0,0,0,0,0,0,0,0,-30000,0,0,0,20000,50000,-30000,-30000
06681P,致茂元大98售02  ,0,0,0,0,0,0,0,0,0,-30000,0,0,0,0,30000,-30000,-30000
06677P,牧德國票98售02  ,0,0,0,0,0,0,0,0,0,-30000,0,0,0,199000,229000,-30000,-30000
06662P,玉晶光中信9A售01,0,0,0,0,0,0,0,0,0,-30000,0,0,0,486000,516000,-30000,-30000
1503,士電            ,5000,22000,-17000,0,0,0,0,0,0,-13000,0,13000,-13000,0,0,0,-30000
1419,新紡            ,1000,31000,-30000,0,0,0,0,0,0,0,0,0,0,0,0,0,-30000
07109P,聯發科中信9B售02,0,0,0,0,0,0,0,0,0,-30000,0,0,0,0,30000,-30000,-30000
06759P,台積電元大98售17,0,0,0,0,0,0,0,0,0,-30000,0,0,0,0,30000,-30000,-30000
06602P,國巨統一99售02  ,0,0,0,0,0,0,0,0,0,-30000,0,0,0,203000,233000,-30000,-30000
07381P,鴻海群益99售05  ,0,0,0,0,0,0,0,0,0,-30000,0,0,0,40000,70000,-30000,-30000
07293P,臺股指凱基99售45,0,0,0,0,0,0,0,0,0,-30000,0,0,0,93000,123000,-30000,-30000
07517P,台積電元大9A售17,0,0,0,0,0,0,0,0,0,-30000,0,0,0,10000,40000,-30000,-30000
07625P,台灣50凱基01售06,0,0,0,0,0,0,0,0,0,-30000,0,0,0,0,30000,-30000,-30000
04935P,鴻海中信96售01  ,0,0,0,0,0,0,0,0,0,-30000,0,0,0,0,30000,-30000,-30000
047194,世紀鋼元大96購01,0,0,0,0,0,0,0,0,0,-30000,0,0,0,6000,36000,-30000,-30000
045443,群創元富98購01  ,0,0,0,0,0,0,0,0,0,-30000,0,0,0,0,30000,-30000,-30000
050662,智易元大96購01  ,0,0,0,0,0,0,0,0,0,-30000,0,0,0,10000,40000,-30000,-30000
053900,T50反1日盛99購01,0,0,0,0,0,0,0,0,0,-30000,0,0,0,0,30000,-30000,-30000
053966,旺宏元大96購08  ,0,0,0,0,0,0,0,0,0,-30000,0,0,0,0,30000,-30000,-30000
05238P,禾伸堂永豐95售01,0,0,0,0,0,0,0,0,0,-30000,0,0,0,0,30000,-30000,-30000
054355,上海銀富邦98購01,0,0,0,0,0,0,0,0,0,-30000,0,0,0,0,30000,-30000,-30000
051847,香港反中信99購01,0,0,0,0,0,0,0,0,0,-30000,0,0,0,0,30000,-30000,-30000
051320,燿華國票96購01  ,0,0,0,0,0,0,0,0,0,-30000,0,0,0,0,30000,-30000,-30000
055402,正文元富97購02  ,0,0,0,0,0,0,0,0,0,-30000,0,0,0,0,30000,-30000,-30000
055265,玉晶光永豐98購03,0,0,0,0,0,0,0,0,0,-30000,0,0,0,20000,50000,-30000,-30000
054789,高鐵群益98購01  ,0,0,0,0,0,0,0,0,0,-30000,0,0,0,10000,40000,-30000,-30000
054834,帆宣中信97購01  ,0,0,0,0,0,0,0,0,0,-30000,0,0,0,0,30000,-30000,-30000
054423,華新富邦96購01  ,0,0,0,0,0,0,0,0,0,-30000,0,0,0,0,30000,-30000,-30000
054738,聯發科凱基97購01,0,0,0,0,0,0,0,0,0,-30000,0,0,0,18000,48000,-30000,-30000
05555P,健策群益98售01  ,0,0,0,0,0,0,0,0,0,-30000,0,0,0,0,30000,-30000,-30000
053698,中磊元大96購02  ,0,0,0,0,0,0,0,0,0,-30000,0,0,0,0,30000,-30000,-30000
055794,聯發科國泰99購01,0,0,0,0,0,0,0,0,0,-30000,0,0,0,0,30000,-30000,-30000
056100,楠梓電永豐97購02,0,0,0,0,0,0,0,0,0,-30000,0,0,0,0,30000,-30000,-30000
055996,矽力國泰99購01  ,0,0,0,0,0,0,0,0,0,-30000,0,0,0,0,30000,-30000,-30000
055964,正文元大97購02  ,0,0,0,0,0,0,0,0,0,-30000,0,0,0,0,30000,-30000,-30000
057217,奇力新群益99購01,0,0,0,0,0,0,0,0,0,-30000,0,0,0,0,30000,-30000,-30000
057276,全新元大99購03  ,0,0,0,0,0,0,0,0,0,-30000,0,0,0,40000,70000,-30000,-30000
057260,微星兆豐98購01  ,0,0,0,0,0,0,0,0,0,-30000,0,0,0,22000,52000,-30000,-30000
05926P,智易永豐96售02  ,0,0,0,0,0,0,0,0,0,-30000,0,0,0,10000,40000,-30000,-30000
059284,緯穎永豐99購03  ,0,0,0,0,0,0,0,0,0,-30000,0,0,0,0,30000,-30000,-30000
057450,國泰金元富98購01,0,0,0,0,0,0,0,0,0,-30000,0,0,0,37000,67000,-30000,-30000
057451,大立光元富9B購01,0,0,0,0,0,0,0,0,0,-30000,0,0,0,0,30000,-30000,-30000
05752P,台積電中信96售06,0,0,0,0,0,0,0,0,0,-30000,0,0,0,0,30000,-30000,-30000
060128,健策永豐99購06  ,0,0,0,0,0,0,0,0,0,-30000,0,0,0,92000,122000,-30000,-30000
056478,晶技元大99購01  ,0,0,0,0,0,0,0,0,0,-30000,0,0,0,0,30000,-30000,-30000
056734,國巨凱基99購01  ,0,0,0,0,0,0,0,0,0,-30000,0,0,0,0,30000,-30000,-30000
058463,宏達電兆豐99購02,0,0,0,0,0,0,0,0,0,-30000,0,0,0,0,30000,-30000,-30000
058571,緯穎凱基9A購02  ,0,0,0,0,0,0,0,0,0,-30000,0,0,0,0,30000,-30000,-30000
057953,聚陽元大98購01  ,0,0,0,0,0,0,0,0,0,-30000,0,0,0,0,30000,-30000,-30000
05697P,友達凱基96售01  ,0,0,0,0,0,0,0,0,0,-30000,0,0,0,20000,50000,-30000,-30000
059501,可成元富99購01  ,0,0,0,0,0,0,0,0,0,-30000,0,0,0,0,30000,-30000,-30000
059363,超眾永豐99購02  ,0,0,0,0,0,0,0,0,0,-30000,0,0,0,53000,83000,-30000,-30000
059703,旺宏凱基99購11  ,0,0,0,0,0,0,0,0,0,-30000,0,0,0,0,30000,-30000,-30000
059884,鴻海國票99購09  ,0,0,0,0,0,0,0,0,0,-30000,0,0,0,0,30000,-30000,-30000
6214,精誠            ,128000,149000,-21000,0,0,0,0,1000,-1000,-8000,2000,10000,-8000,0,0,0,-30000
3454,晶睿            ,25000,53000,-28000,0,0,0,0,0,0,-2000,0,2000,-2000,0,0,0,-30000
9939,宏全            ,166000,192554,-26554,0,0,0,0,1000,-1000,-3000,1000,8000,-7000,4000,0,4000,-30554
2017,官田鋼          ,6000,24000,-18000,0,0,0,0,0,0,-13000,0,13000,-13000,0,0,0,-31000
1608,華榮            ,47000,78000,-31000,0,0,0,0,0,0,0,0,0,0,0,0,0,-31000
07249P,T50正2富邦03售02,0,0,0,0,0,0,0,0,0,-31000,0,0,0,0,31000,-31000,-31000
07166P,台灣50兆豐03售01,0,0,0,0,0,0,0,0,0,-31000,0,0,0,1000,32000,-31000,-31000
07135P,臺股指元大9A售29,0,0,0,0,0,0,0,0,0,-31000,0,0,0,1000,32000,-31000,-31000
060951,元黃金群益9A購01,0,0,0,0,0,0,0,0,0,-31000,0,0,0,0,31000,-31000,-31000
061109,臻鼎元大9A購03  ,0,0,0,0,0,0,0,0,0,-31000,0,0,0,40000,71000,-31000,-31000
053480,祥碩元大96購02  ,0,0,0,0,0,0,0,0,0,-31000,0,0,0,23000,54000,-31000,-31000
053500,新日興兆豐97購01,0,0,0,0,0,0,0,0,0,-31000,0,0,0,2000,33000,-31000,-31000
053244,光磊國票97購01  ,0,0,0,0,0,0,0,0,0,-31000,0,0,0,134000,165000,-31000,-31000
052782,超眾國票96購02  ,0,0,0,0,0,0,0,0,0,-31000,0,0,0,0,31000,-31000,-31000
051891,智邦元富95購04  ,0,0,0,0,0,0,0,0,0,-31000,0,0,0,2000,33000,-31000,-31000
054180,亞泥康和96購01  ,0,0,0,0,0,0,0,0,0,-31000,0,0,0,3000,34000,-31000,-31000
052256,台泥國泰96購01  ,0,0,0,0,0,0,0,0,0,-31000,0,0,0,0,31000,-31000,-31000
045055,聯發科元富98購03,0,0,0,0,0,0,0,0,0,-31000,0,0,0,0,31000,-31000,-31000
035274,華新台新97購01  ,0,0,0,0,0,0,0,0,0,-31000,0,0,0,0,31000,-31000,-31000
057062,立積國泰99購01  ,0,0,0,0,0,0,0,0,0,-31000,0,0,0,0,31000,-31000,-31000
05814P,臺股指國票96售07,0,0,0,0,0,0,0,0,0,-31000,0,0,0,1000,32000,-31000,-31000
058874,聯鈞國票9A購01  ,0,0,0,0,0,0,0,0,0,-31000,0,0,0,30000,61000,-31000,-31000
056405,聯茂群益98購01  ,0,0,0,0,0,0,0,0,0,-31000,0,0,0,5000,36000,-31000,-31000
056536,義隆凱基98購04  ,0,0,0,0,0,0,0,0,0,-31000,0,0,0,30000,61000,-31000,-31000
060104,新日興元大99購03,0,0,0,0,0,0,0,0,0,-31000,0,0,0,0,31000,-31000,-31000
060018,國產康和99購01  ,0,0,0,0,0,0,0,0,0,-31000,0,0,0,110000,141000,-31000,-31000
058209,臺股指凱基01購01,0,0,0,0,0,0,0,0,0,-31000,0,0,0,0,31000,-31000,-31000
057562,奇鋐兆豐98購01  ,0,0,0,0,0,0,0,0,0,-31000,0,0,0,10000,41000,-31000,-31000
059643,日月光凱基99購02,0,0,0,0,0,0,0,0,0,-31000,0,0,0,39000,70000,-31000,-31000
055740,智易元富97購01  ,0,0,0,0,0,0,0,0,0,-31000,0,0,0,20000,51000,-31000,-31000
05983P,聯詠國票96售02  ,0,0,0,0,0,0,0,0,0,-31000,0,0,0,0,31000,-31000,-31000
060400,南電國票9A購03  ,0,0,0,0,0,0,0,0,0,-32000,0,0,0,80000,112000,-32000,-32000
060454,葡萄王元大9A購01,0,0,0,0,0,0,0,0,0,-32000,0,0,0,33000,65000,-32000,-32000
060964,日月光凱基9A購01,0,0,0,0,0,0,0,0,0,-32000,0,0,0,4000,36000,-32000,-32000
061011,華通麥證9A購02  ,0,0,0,1000,33000,-32000,0,0,0,-32000,0,0,0,1000,33000,-32000,-32000
061152,微星群益9A購01  ,0,0,0,0,0,0,0,0,0,-32000,0,0,0,0,32000,-32000,-32000
061384,T50反1群益9A購04,0,0,0,0,0,0,0,0,0,-32000,0,0,0,0,32000,-32000,-32000
061344,禾伸堂元大9A購02,0,0,0,0,0,0,0,0,0,-32000,0,0,0,56000,88000,-32000,-32000
1513,中興電          ,83000,118000,-35000,0,0,0,0,1000,-1000,4000,6000,0,6000,0,2000,-2000,-32000
1603,華電            ,2000,34000,-32000,0,0,0,0,0,0,0,0,0,0,0,0,0,-32000
2305,全友            ,1000,31000,-30000,0,0,0,0,0,0,-2000,0,2000,-2000,0,0,0,-32000
2436,偉詮電          ,330000,358000,-28000,0,0,0,0,0,0,-4000,0,4000,-4000,0,0,0,-32000
05250P,臻鼎國票96售01  ,0,0,0,0,0,0,0,0,0,-32000,0,0,0,0,32000,-32000,-32000
054061,晶技國票97購03  ,0,0,0,0,0,0,0,0,0,-32000,0,0,0,16000,48000,-32000,-32000
055461,TPK永豐97購01   ,0,0,0,0,0,0,0,0,0,-32000,0,0,0,18000,50000,-32000,-32000
055519,茂林中信99購01  ,0,0,0,0,0,0,0,0,0,-32000,0,0,0,0,32000,-32000,-32000
057770,亞德客群益98購01,0,0,0,0,0,0,0,0,0,-32000,0,0,0,4000,36000,-32000,-32000
057691,健策凱基99購01  ,0,0,0,0,0,0,0,0,0,-32000,0,0,0,12000,44000,-32000,-32000
053033,智易兆豐97購01  ,0,0,0,0,0,0,0,0,0,-32000,0,0,0,0,32000,-32000,-32000
053097,超眾統一96購03  ,0,0,0,0,0,0,0,0,0,-32000,0,0,0,0,32000,-32000,-32000
053864,義隆元大96購01  ,0,0,0,0,0,0,0,0,0,-32000,0,0,0,380000,412000,-32000,-32000
057366,智邦元大98購08  ,0,0,0,0,0,0,0,0,0,-32000,0,0,0,101000,133000,-32000,-32000
060080,台灣50元大02購01,0,0,0,0,0,0,0,0,0,-32000,0,0,0,0,32000,-32000,-32000
057886,聯詠群益98購01  ,0,0,0,0,0,0,0,0,0,-32000,0,0,0,0,32000,-32000,-32000
057936,健策群益99購01  ,0,0,0,0,0,0,0,0,0,-32000,0,0,0,22000,54000,-32000,-32000
059121,瑞儀永豐99購01  ,0,0,0,0,0,0,0,0,0,-32000,0,0,0,20000,52000,-32000,-32000
058060,貿聯元富98購01  ,0,0,0,0,0,0,0,0,0,-32000,0,0,0,0,32000,-32000,-32000
057962,超眾元大99購03  ,0,0,0,0,0,0,0,0,0,-32000,0,0,0,5000,37000,-32000,-32000
1560,中砂            ,25000,42000,-17000,0,0,0,0,1000,-1000,-15000,2000,17000,-15000,0,0,0,-33000
1626,艾美特-KY       ,4000,37000,-33000,0,0,0,0,0,0,0,0,0,0,0,0,0,-33000
1337,再生-KY         ,7000,32000,-25000,0,0,0,0,0,0,-8000,0,8000,-8000,0,0,0,-33000
07589P,玉晶光國票9A售02,0,0,0,0,0,0,0,0,0,-33000,0,0,0,21000,54000,-33000,-33000
061228,聯茂中信9A購01  ,0,0,0,0,0,0,0,0,0,-33000,0,0,0,0,33000,-33000,-33000
060985,聯發科元大9A購06,0,0,0,0,0,0,0,0,0,-33000,0,0,0,0,33000,-33000,-33000
060734,華通統一9C購01  ,0,0,0,0,0,0,0,0,0,-33000,0,0,0,50000,83000,-33000,-33000
060261,臺股指凱基9A購04,0,0,0,0,0,0,0,0,0,-33000,0,0,0,14000,47000,-33000,-33000
052796,和碩兆豐96購01  ,0,0,0,0,0,0,0,0,0,-33000,0,0,0,12000,45000,-33000,-33000
054674,台光電台新97購01,0,0,0,0,0,0,0,0,0,-33000,0,0,0,0,33000,-33000,-33000
054078,鴻海中信98購01  ,0,0,0,0,0,0,0,0,0,-33000,0,0,0,0,33000,-33000,-33000
054121,奇鋐永豐96購02  ,0,0,0,0,0,0,0,0,0,-33000,0,0,0,52000,85000,-33000,-33000
051643,瑞昱康和95購01  ,0,0,0,0,0,0,0,0,0,-33000,0,0,0,61000,94000,-33000,-33000
05159P,聯發科永豐95售04,0,0,0,0,0,0,0,0,0,-33000,0,0,0,0,33000,-33000,-33000
057955,技嘉元大98購07  ,0,0,0,0,0,0,0,0,0,-33000,0,0,0,27000,60000,-33000,-33000
057029,緯穎凱基98購04  ,0,0,0,0,0,0,0,0,0,-33000,0,0,0,0,33000,-33000,-33000
058800,健策元大99購03  ,0,0,0,0,0,0,0,0,0,-33000,0,0,0,57000,90000,-33000,-33000
060048,元金2X凱基99購03,0,0,0,0,0,0,0,0,0,-33000,0,0,0,16000,49000,-33000,-33000
05729P,臺股指凱基97售02,0,0,0,0,0,0,0,0,0,-33000,0,0,0,2000,35000,-33000,-33000
056038,可成凱基97購01  ,0,0,0,0,0,0,0,0,0,-33000,0,0,0,39000,72000,-33000,-33000
055841,南亞科元大97購04,0,0,0,0,0,0,0,0,0,-33000,0,0,0,35000,68000,-33000,-33000
059567,台積電凱基9A購12,0,0,0,0,0,0,0,0,0,-33000,0,0,0,0,33000,-33000,-33000
3149,正達            ,16000,49000,-33000,0,0,0,0,0,0,0,0,0,0,0,0,0,-33000
6491,晶碩            ,9000,42000,-33000,0,0,0,0,0,0,0,0,0,0,0,0,0,-33000
6024,群益期          ,4000,37000,-33000,0,0,0,0,0,0,0,0,0,0,0,0,0,-33000
060286,佳世達元大9C購01,0,0,0,0,0,0,0,0,0,-34000,0,0,0,33000,67000,-34000,-34000
060543,鴻海凱基9B購02  ,0,0,0,0,0,0,0,0,0,-34000,0,0,0,1000,35000,-34000,-34000
060827,健策元大9A購02  ,0,0,0,0,0,0,0,0,0,-34000,0,0,0,58000,92000,-34000,-34000
060795,世芯永豐9A購02  ,0,0,0,0,0,0,0,0,0,-34000,0,0,0,41000,75000,-34000,-34000
060789,禾伸堂富邦9B購02,0,0,0,0,0,0,0,0,0,-34000,0,0,0,741000,775000,-34000,-34000
060923,全新永豐9A購01  ,0,0,0,0,0,0,0,0,0,-34000,0,0,0,0,34000,-34000,-34000
07708P,玉晶光元大9A售13,0,0,0,0,0,0,0,0,0,-34000,0,0,0,0,34000,-34000,-34000
2539,櫻花建          ,11000,45000,-34000,0,0,0,0,0,0,0,0,0,0,0,0,0,-34000
054074,健策富邦98購01  ,0,0,0,0,0,0,0,0,0,-34000,0,0,0,50000,84000,-34000,-34000
054302,鴻海凱基96購18  ,0,0,0,0,0,0,0,0,0,-34000,0,0,0,2000,36000,-34000,-34000
050392,群創統一96購01  ,0,0,0,0,0,0,0,0,0,-34000,0,0,0,6000,40000,-34000,-34000
055291,京鼎元大97購02  ,0,0,0,0,0,0,0,0,0,-34000,0,0,0,131000,165000,-34000,-34000
055335,健策兆豐98購01  ,0,0,0,0,0,0,0,0,0,-34000,0,0,0,0,34000,-34000,-34000
057362,元油2X元大98購12,0,0,0,0,0,0,0,0,0,-34000,0,0,0,0,34000,-34000,-34000
060094,聯發科元大99購41,0,0,0,0,0,0,0,0,0,-34000,0,0,0,54000,88000,-34000,-34000
059623,聯電凱基99購02  ,0,0,0,0,0,0,0,0,0,-34000,0,0,0,153000,187000,-34000,-34000
05841P,華通元大96售04  ,0,0,0,0,0,0,0,0,0,-34000,0,0,0,0,34000,-34000,-34000
056616,台光電永豐98購01,0,0,0,0,0,0,0,0,0,-34000,0,0,0,62000,96000,-34000,-34000
056581,超眾元大99購01  ,0,0,0,0,0,0,0,0,0,-34000,0,0,0,38000,72000,-34000,-34000
057980,聯詠永豐98購01  ,0,0,0,0,0,0,0,0,0,-34000,0,0,0,13000,47000,-34000,-34000
4916,事欣科          ,14000,46000,-32000,0,0,0,0,0,0,-2000,0,2000,-2000,0,0,0,-34000
07672P,南電元大9A售05  ,0,0,0,0,0,0,0,0,0,-35000,0,0,0,64000,99000,-35000,-35000
1109,信大            ,66000,99000,-33000,0,0,0,0,2000,-2000,0,0,0,0,0,0,0,-35000
07583P,台積電富邦9B售05,0,150000,-150000,0,0,0,0,0,0,115000,0,0,0,213000,98000,115000,-35000
06996P,臺股指凱基99售17,0,0,0,0,0,0,0,0,0,-35000,0,0,0,0,35000,-35000,-35000
06934P,聯鈞元大98售03  ,0,0,0,0,0,0,0,0,0,-35000,0,0,0,10000,45000,-35000,-35000
061186,牧德國泰9C購01  ,0,0,0,0,0,0,0,0,0,-35000,0,0,0,19000,54000,-35000,-35000
061188,大成鋼富邦9B購01,0,0,0,0,0,0,0,0,0,-35000,0,0,0,0,35000,-35000,-35000
060466,玉山金元大9A購01,0,0,0,0,0,0,0,0,0,-35000,0,0,0,96000,131000,-35000,-35000
060338,鴻海統一9C購02  ,0,0,0,0,0,0,0,0,0,-35000,0,0,0,5000,40000,-35000,-35000
060397,群創國票9A購01  ,0,0,0,0,0,0,0,0,0,-35000,0,0,0,0,35000,-35000,-35000
060343,台積電統一9C購02,0,0,0,0,0,0,0,0,0,-35000,0,0,0,37000,72000,-35000,-35000
060363,美律元富9A購01  ,0,0,0,0,0,0,0,0,0,-35000,0,0,0,115000,150000,-35000,-35000
06022P,緯穎永豐96售03  ,0,0,0,0,0,0,0,0,0,-35000,0,0,0,0,35000,-35000,-35000
05440P,緯穎國票96售02  ,0,0,0,0,0,0,0,0,0,-35000,0,0,0,120000,155000,-35000,-35000
054861,智邦群益97購01  ,0,0,0,0,0,0,0,0,0,-35000,0,0,0,8000,43000,-35000,-35000
055071,群電永豐97購01  ,0,0,0,0,0,0,0,0,0,-35000,0,0,0,0,35000,-35000,-35000
058344,旺宏群益99購05  ,0,0,0,0,0,0,0,0,0,-35000,0,0,0,20000,55000,-35000,-35000
048383,元金2X國票99購01,0,0,0,0,0,0,0,0,0,-35000,0,0,0,25000,60000,-35000,-35000
052304,可成永豐95購03  ,0,0,0,0,0,0,0,0,0,-35000,0,0,0,0,35000,-35000,-35000
057877,神達元大99購01  ,0,0,0,0,0,0,0,0,0,-35000,0,0,0,9000,44000,-35000,-35000
060139,T50反1國票9A購04,0,0,0,0,0,0,0,0,0,-35000,0,0,0,30000,65000,-35000,-35000
059065,南電凱基9A購01  ,10000,20000,-10000,0,0,0,0,0,0,-25000,0,0,0,156000,181000,-25000,-35000
057323,智邦群益98購01  ,0,0,0,0,0,0,0,0,0,-35000,0,0,0,0,35000,-35000,-35000
4555,氣立            ,0,35000,-35000,0,0,0,0,0,0,0,0,0,0,0,0,0,-35000
2608,嘉里大榮        ,26000,49000,-23000,0,0,0,0,0,0,-12000,0,12000,-12000,0,0,0,-35000
2612,中航            ,23000,58000,-35000,0,0,0,0,0,0,0,0,0,0,0,0,0,-35000
3028,增你強          ,24000,56000,-32000,0,0,0,0,0,0,-3000,0,3000,-3000,0,0,0,-35000
059255,臺股指凱基99購33,0,0,0,0,0,0,0,0,0,-35000,0,0,0,277000,312000,-35000,-35000
060678,聯詠元大9A購03  ,0,0,0,0,0,0,0,0,0,-36000,0,0,0,0,36000,-36000,-36000
061042,致新永豐9A購02  ,0,0,0,0,0,0,0,0,0,-36000,0,0,0,6000,42000,-36000,-36000
07319P,台積電凱基01售02,0,0,0,0,0,0,0,0,0,-36000,0,0,0,19000,55000,-36000,-36000
1440,南紡            ,322000,359000,-37000,0,0,0,0,0,0,1000,6000,5000,1000,0,0,0,-36000
2012,春雨            ,0,36000,-36000,0,0,0,0,0,0,0,0,0,0,0,0,0,-36000
2022,聚亨            ,0,35000,-35000,0,0,0,0,0,0,-1000,0,1000,-1000,0,0,0,-36000
1538,正峰新          ,0,36000,-36000,0,0,0,0,0,0,0,0,0,0,0,0,0,-36000
047295,欣興元富96購02  ,0,0,0,0,0,0,0,0,0,-36000,0,0,0,0,36000,-36000,-36000
058378,南電凱基99購01  ,0,0,0,0,0,0,0,0,0,-36000,0,0,0,25000,61000,-36000,-36000
053702,智易兆豐97購02  ,0,0,0,0,0,0,0,0,0,-36000,0,0,0,0,36000,-36000,-36000
053534,微星永豐96購02  ,0,0,0,0,0,0,0,0,0,-36000,0,0,0,20000,56000,-36000,-36000
057101,新光金中信9A購01,0,0,0,0,0,0,0,0,0,-36000,0,0,0,2000,38000,-36000,-36000
060106,旭富元大99購02  ,0,0,0,0,0,0,0,0,0,-36000,0,0,0,25000,61000,-36000,-36000
060135,台灣50國票9C購02,0,0,0,0,0,0,0,0,0,-36000,0,0,0,0,36000,-36000,-36000
058290,南電國票9A購01  ,0,0,0,0,0,0,0,0,0,-36000,0,0,0,35000,71000,-36000,-36000
059667,矽力元大99購01  ,0,0,0,0,0,0,0,0,0,-36000,0,0,0,0,36000,-36000,-36000
07276P,臺股指群益99售19,0,0,0,0,0,0,0,0,0,-37000,0,0,0,118000,155000,-37000,-37000
07414P,台積電元大99售51,0,0,0,0,0,0,0,0,0,-37000,0,0,0,150000,187000,-37000,-37000
07576P,可成元大9A售01  ,0,0,0,0,0,0,0,0,0,-37000,0,0,0,1000,38000,-37000,-37000
06485P,玉晶光群益9A售02,0,0,0,0,0,0,0,0,0,-37000,0,0,0,1000,38000,-37000,-37000
060992,健策元大9A購05  ,0,0,0,0,0,0,0,0,0,-37000,0,0,0,88000,125000,-37000,-37000
061016,可成麥證9A購01  ,0,0,0,0,37000,-37000,0,0,0,-37000,0,0,0,0,37000,-37000,-37000
060798,旭富永豐9A購01  ,0,0,0,0,0,0,0,0,0,-37000,0,0,0,0,37000,-37000,-37000
053231,奇力新康和96購01,0,0,0,0,0,0,0,0,0,-37000,0,0,0,50000,87000,-37000,-37000
055306,燿華群益97購01  ,0,0,0,0,0,0,0,0,0,-37000,0,0,0,0,37000,-37000,-37000
055400,緯穎統一97購01  ,0,0,0,0,0,0,0,0,0,-37000,0,0,0,0,37000,-37000,-37000
049675,台光電國票95購01,0,0,0,0,0,0,0,0,0,-37000,0,0,0,1000,38000,-37000,-37000
054201,聯詠富邦97購02  ,0,0,0,0,0,0,0,0,0,-37000,0,0,0,0,37000,-37000,-37000
051317,亞德客國票96購01,0,0,0,0,0,0,0,0,0,-37000,0,0,0,5000,42000,-37000,-37000
057963,緯穎元大98購08  ,0,0,0,0,0,0,0,0,0,-37000,0,0,0,0,37000,-37000,-37000
058908,貿聯元大99購03  ,0,0,0,0,0,0,0,0,0,-37000,0,0,0,39000,76000,-37000,-37000
056477,欣興元大98購02  ,0,0,0,0,0,0,0,0,0,-37000,0,0,0,18000,55000,-37000,-37000
060158,廣達永豐9A購01  ,0,0,0,0,0,0,0,0,0,-37000,0,0,0,25000,62000,-37000,-37000
059762,禾伸堂永豐99購02,0,0,0,0,0,0,0,0,0,-37000,0,0,0,190000,227000,-37000,-37000
056122,勤誠群益97購02  ,0,0,0,0,0,0,0,0,0,-37000,0,0,0,0,37000,-37000,-37000
057255,聯發科麥證98購02,0,0,0,54000,91000,-37000,0,0,0,-37000,0,0,0,54000,91000,-37000,-37000
059663,旭富元大9C購02  ,0,0,0,0,0,0,0,0,0,-37000,0,0,0,15000,52000,-37000,-37000
6235,華孚            ,5000,40000,-35000,0,0,0,0,0,0,-2000,0,2000,-2000,0,0,0,-37000
06622P,牧德元大98售01  ,0,0,0,0,0,0,0,0,0,-38000,0,0,0,153000,191000,-38000,-38000
06387P,緯穎永豐97售02  ,0,0,0,0,0,0,0,0,0,-38000,0,0,0,34000,72000,-38000,-38000
060541,正隆凱基9A購01  ,0,0,0,0,0,0,0,0,0,-38000,0,0,0,50000,88000,-38000,-38000
06050P,玉晶光國票98售01,0,0,0,0,0,0,0,0,0,-38000,0,0,0,15000,53000,-38000,-38000
060622,玉晶光元大9B購02,0,0,0,0,0,0,0,0,0,-38000,0,0,0,2000,40000,-38000,-38000
07233P,台灣50元大99售04,0,0,0,0,0,0,0,0,0,-38000,0,0,0,4000,42000,-38000,-38000
1447,力鵬            ,26000,48000,-22000,0,0,0,0,0,0,-16000,0,16000,-16000,0,0,0,-38000
07651P,道瓊指中信01售01,0,0,0,0,0,0,0,0,0,-38000,0,0,0,2000,40000,-38000,-38000
2368,金像電          ,7826000,9882000,-2056000,0,0,0,822000,0,822000,1196000,1769000,603000,1166000,146000,116000,30000,-38000
2228,劍麟            ,61000,99000,-38000,0,0,0,0,0,0,0,0,0,0,0,0,0,-38000
051536,玉晶光國票97購01,0,0,0,0,0,0,0,0,0,-38000,0,0,0,67000,105000,-38000,-38000
04617P,臺股指群益95售03,0,0,0,0,0,0,0,0,0,-38000,0,0,0,2000,40000,-38000,-38000
048793,超眾元大95購02  ,0,0,0,0,0,0,0,0,0,-38000,0,0,0,50000,88000,-38000,-38000
055147,鴻海元大97購11  ,0,0,0,0,0,0,0,0,0,-38000,0,0,0,0,38000,-38000,-38000
053735,矽力中信97購01  ,0,0,0,0,0,0,0,0,0,-38000,0,0,0,0,38000,-38000,-38000
055804,祥碩永豐97購02  ,0,0,0,0,0,0,0,0,0,-38000,0,0,0,0,38000,-38000,-38000
060107,旭富元大99購03  ,0,0,0,0,0,0,0,0,0,-38000,0,0,0,92000,130000,-38000,-38000
059610,上銀永豐99購02  ,0,0,0,0,0,0,0,0,0,-38000,0,0,0,50000,88000,-38000,-38000
057543,華通凱基99購02  ,0,0,0,0,0,0,0,0,0,-38000,0,0,0,17000,55000,-38000,-38000
057894,華通元富02購02  ,0,0,0,0,0,0,0,0,0,-38000,0,0,0,13000,51000,-38000,-38000
5234,達興材料        ,22000,59000,-37000,0,0,0,1000,0,1000,-2000,0,2000,-2000,0,0,0,-38000
07590P,玉晶光國票9A售03,0,0,0,0,0,0,0,0,0,-39000,0,0,0,21000,60000,-39000,-39000
06888P,日月光元大98售02,0,0,0,0,0,0,0,0,0,-39000,0,0,0,0,39000,-39000,-39000
060733,和大統一9C購01  ,0,0,0,0,0,0,0,0,0,-39000,0,0,0,38000,77000,-39000,-39000
060765,世芯元大9A購01  ,0,0,0,0,0,0,0,0,0,-39000,0,0,0,132000,171000,-39000,-39000
061218,臺股指元大9A購55,0,0,0,0,0,0,0,0,0,-39000,0,0,0,0,39000,-39000,-39000
060783,亞德客富邦9B購01,0,0,0,0,0,0,0,0,0,-39000,0,0,0,51000,90000,-39000,-39000
057777,可成群益9A購03  ,0,0,0,0,0,0,0,0,0,-39000,0,0,0,15000,54000,-39000,-39000
057778,大立光群益98購02,0,0,0,0,0,0,0,0,0,-39000,0,0,0,0,39000,-39000,-39000
05546P,全新元大97售01  ,0,0,0,0,0,0,0,0,0,-39000,0,0,0,151000,190000,-39000,-39000
046629,群創統一98購01  ,0,0,0,0,0,0,0,0,0,-39000,0,0,0,6000,45000,-39000,-39000
058457,創意永豐99購01  ,0,0,0,0,0,0,0,0,0,-39000,0,0,0,1000,40000,-39000,-39000
5907,大洋-KY         ,34000,73000,-39000,0,0,0,0,0,0,0,0,0,0,0,0,0,-39000
060842,新光金國票9B購01,0,0,0,0,0,0,0,0,0,-40000,0,0,0,1000,41000,-40000,-40000
060468,聯鈞元大9A購02  ,0,0,0,0,0,0,0,0,0,-40000,0,0,0,197000,237000,-40000,-40000
060224,台灣50元大9A購09,0,0,0,0,0,0,0,0,0,-40000,0,0,0,0,40000,-40000,-40000
07259P,滬深2X國票01售01,0,0,0,0,0,0,0,0,0,-40000,0,0,0,30000,70000,-40000,-40000
07654P,台灣50凱基01售08,0,0,0,0,0,0,0,0,0,-40000,0,0,0,0,40000,-40000,-40000
1309,台達化          ,271000,309000,-38000,0,0,0,0,0,0,-2000,0,2000,-2000,0,0,0,-40000
050797,聯發科中信99購01,0,0,0,0,0,0,0,0,0,-40000,0,0,0,0,40000,-40000,-40000
051644,聯茂康和95購01  ,0,0,0,0,0,0,0,0,0,-40000,0,0,0,0,40000,-40000,-40000
050895,聯發科元大97購01,0,0,0,0,0,0,0,0,0,-40000,0,0,0,0,40000,-40000,-40000
052069,聯茂兆豐96購01  ,0,0,0,0,0,0,0,0,0,-40000,0,0,0,0,40000,-40000,-40000
054075,GIS富邦97購02   ,0,0,0,0,0,0,0,0,0,-40000,0,0,0,0,40000,-40000,-40000
052497,楠梓電永豐96購01,0,0,0,0,0,0,0,0,0,-40000,0,0,0,0,40000,-40000,-40000
05261P,鴻海元大95售20  ,0,0,0,0,0,0,0,0,0,-40000,0,0,0,0,40000,-40000,-40000
052686,華新科元大96購03,0,0,0,0,0,0,0,0,0,-40000,0,0,0,0,40000,-40000,-40000
054609,正崴永豐97購01  ,0,0,0,0,0,0,0,0,0,-40000,0,0,0,44000,84000,-40000,-40000
057740,茂林富邦9A購01  ,0,0,0,0,0,0,0,0,0,-40000,0,0,0,5000,45000,-40000,-40000
053457,旺宏國泰98購03  ,0,0,0,0,0,0,0,0,0,-40000,0,0,0,0,40000,-40000,-40000
056665,上証2X國票99購02,0,0,0,0,0,0,0,0,0,-40000,0,0,0,0,40000,-40000,-40000
058518,玉晶光元大99購13,0,0,0,0,0,0,0,0,0,-40000,0,0,0,0,40000,-40000,-40000
058610,欣興元大99購05  ,0,0,0,0,0,0,0,0,0,-40000,0,0,0,4000,44000,-40000,-40000
05803P,臺股指兆豐96售03,0,0,0,0,0,0,0,0,0,-40000,0,0,0,0,40000,-40000,-40000
056893,智邦元大98購02  ,0,0,0,0,0,0,0,0,0,-40000,0,0,0,189000,229000,-40000,-40000
057078,國巨統一9A購02  ,0,0,0,0,0,0,0,0,0,-40000,0,0,0,0,40000,-40000,-40000
055876,美食元富9A購01  ,0,0,0,0,0,0,0,0,0,-40000,0,0,0,0,40000,-40000,-40000
059081,和大元大99購01  ,0,0,0,0,0,0,0,0,0,-40000,0,0,0,0,40000,-40000,-40000
059097,世紀鋼元大99購05,0,0,0,0,0,0,0,0,0,-40000,0,0,0,10000,50000,-40000,-40000
059182,台灣50台新9B購03,0,0,0,0,0,0,0,0,0,-40000,0,0,0,0,40000,-40000,-40000
057575,世紀鋼永豐98購02,0,0,0,0,0,0,0,0,0,-40000,0,0,0,0,40000,-40000,-40000
059031,元石油中信03購01,0,0,0,0,0,0,0,0,0,-40000,0,0,0,0,40000,-40000,-40000
056067,智原元大97購01  ,0,0,0,0,0,0,0,0,0,-40000,0,0,0,10000,50000,-40000,-40000
055932,玉山金群益99購01,0,0,0,0,0,0,0,0,0,-40000,0,0,0,0,40000,-40000,-40000
05741P,聯發科元大96售14,0,0,0,0,0,0,0,0,0,-40000,0,0,0,30000,70000,-40000,-40000
05731P,創意統一96售03  ,0,0,0,0,0,0,0,0,0,-40000,0,0,0,20000,60000,-40000,-40000
059217,台積電元大99購30,0,0,0,0,0,0,0,0,0,-40000,0,0,0,0,40000,-40000,-40000
4935,茂林-KY         ,232000,699000,-467000,0,0,0,398000,0,398000,29000,55000,7000,48000,39000,58000,-19000,-40000
059922,大立光元大99購25,0,0,0,0,0,0,0,0,0,-40000,0,0,0,130000,170000,-40000,-40000
059702,台積電凱基9A購14,0,0,0,0,0,0,0,0,0,-40000,0,0,0,107000,147000,-40000,-40000
059805,台積電元富99購02,0,0,0,0,0,0,0,0,0,-40000,0,0,0,80000,120000,-40000,-40000
1474,弘裕            ,2000,41000,-39000,0,0,0,0,0,0,-2000,0,2000,-2000,0,0,0,-41000
07337P,台灣50凱基99售09,0,0,0,0,0,0,0,0,0,-41000,0,0,0,0,41000,-41000,-41000
07498P,台積電元大9A售09,0,0,0,0,0,0,0,0,0,-41000,0,0,0,42000,83000,-41000,-41000
06857P,超眾永豐98售02  ,0,0,0,0,0,0,0,0,0,-41000,0,0,0,53000,94000,-41000,-41000
06492P,上銀永豐98售01  ,0,0,0,0,0,0,0,0,0,-41000,0,0,0,57000,98000,-41000,-41000
06470P,臺股指凱基99售10,0,0,0,0,0,0,0,0,0,-41000,0,0,0,0,41000,-41000,-41000
061155,華新科群益9A購06,0,0,0,0,0,0,0,0,0,-41000,0,0,0,9000,50000,-41000,-41000
054559,台光電群益99購01,0,0,0,0,0,0,0,0,0,-41000,0,0,0,10000,51000,-41000,-41000
055023,億光國泰98購01  ,0,0,0,0,0,0,0,0,0,-41000,0,0,0,0,41000,-41000,-41000
05016P,臺股指元大95售07,0,0,0,0,0,0,0,0,0,-41000,0,0,0,0,41000,-41000,-41000
049272,世紀鋼元大96購02,0,0,0,0,0,0,0,0,0,-41000,0,0,0,164000,205000,-41000,-41000
057198,智伸科統一9B購01,0,0,0,0,0,0,0,0,0,-41000,0,0,0,0,41000,-41000,-41000
055745,臻鼎元富97購01  ,0,0,0,0,0,0,0,0,0,-41000,0,0,0,349000,390000,-41000,-41000
059732,超眾元大9A購01  ,0,0,0,0,0,0,0,0,0,-41000,0,0,0,25000,66000,-41000,-41000
06018P,康控凱基96售03  ,0,0,0,0,0,0,0,0,0,-41000,0,0,0,15000,56000,-41000,-41000
055901,超眾中信97購01  ,0,0,0,0,0,0,0,0,0,-41000,0,0,0,10000,51000,-41000,-41000
056835,聯電元富99購01  ,0,0,0,0,0,0,0,0,0,-41000,0,0,0,0,41000,-41000,-41000
058507,美律元大9A購01  ,0,0,0,0,0,0,0,0,0,-41000,0,0,0,45000,86000,-41000,-41000
056484,聯茂元大98購02  ,0,0,0,0,0,0,0,0,0,-41000,0,0,0,1000,42000,-41000,-41000
056723,國巨中信9A購01  ,0,0,0,0,0,0,0,0,0,-41000,0,0,0,85000,126000,-41000,-41000
059348,日月光凱基99購01,0,0,0,0,0,0,0,0,0,-41000,0,0,0,0,41000,-41000,-41000
059662,旭富元大9C購01  ,0,0,0,0,0,0,0,0,0,-41000,0,0,0,6000,47000,-41000,-41000
06140P,華新科群益97售06,0,0,0,0,0,0,0,0,0,-42000,0,0,0,6000,48000,-42000,-42000
060809,康友群益9A購01  ,0,0,0,0,0,0,0,0,0,-42000,0,0,0,55000,97000,-42000,-42000
06780P,義隆元大98售02  ,0,0,0,0,0,0,0,0,0,-42000,0,0,0,48000,90000,-42000,-42000
051769,矽力元大95購01  ,0,0,0,0,0,0,0,0,0,-42000,0,0,0,0,42000,-42000,-42000
053005,微星永豐96購01  ,0,0,0,0,0,0,0,0,0,-42000,0,0,0,9000,51000,-42000,-42000
058375,群創凱基9B購04  ,0,0,0,0,0,0,0,0,0,-42000,0,0,0,4000,46000,-42000,-42000
058410,國巨兆豐99購03  ,0,0,0,0,0,0,0,0,0,-42000,0,0,0,20000,62000,-42000,-42000
058611,欣興元大99購06  ,0,0,0,0,0,0,0,0,0,-42000,0,0,0,27000,69000,-42000,-42000
056969,智易永豐98購01  ,0,0,0,0,0,0,0,0,0,-42000,0,0,0,21000,63000,-42000,-42000
060113,祥碩元大9B購01  ,0,0,0,0,0,0,0,0,0,-42000,0,0,0,57000,99000,-42000,-42000
057179,可成元大98購04  ,0,0,0,0,0,0,0,0,0,-42000,0,0,0,4000,46000,-42000,-42000
05919P,京鼎元大96售03  ,0,0,0,0,0,0,0,0,0,-42000,0,0,0,10000,52000,-42000,-42000
059947,貿聯永豐99購03  ,0,0,0,0,0,0,0,0,0,-42000,0,0,0,0,42000,-42000,-42000
2836,高雄銀          ,26000,66000,-40000,0,0,0,0,0,0,-2000,0,2000,-2000,0,0,0,-42000
06551P,貿聯元大98售05  ,0,0,0,0,0,0,0,0,0,-43000,0,0,0,20000,63000,-43000,-43000
07535P,上銀元富9A售03  ,0,0,0,0,0,0,0,0,0,-43000,0,0,0,0,43000,-43000,-43000
07579P,聯茂元大9A售01  ,0,0,0,0,0,0,0,0,0,-43000,0,0,0,198000,241000,-43000,-43000
1592,英瑞-KY         ,53000,96000,-43000,0,0,0,0,0,0,0,0,0,0,0,0,0,-43000
07747P,晶技凱基9A售04  ,0,0,0,0,0,0,0,0,0,-43000,0,0,0,0,43000,-43000,-43000
2535,達欣工          ,18000,71000,-53000,0,0,0,0,0,0,10000,10000,0,10000,0,0,0,-43000
06282P,聯鈞永豐97售02  ,0,0,0,0,0,0,0,0,0,-43000,0,0,0,0,43000,-43000,-43000
060222,貿聯凱基9A購02  ,0,0,0,0,0,0,0,0,0,-43000,0,0,0,70000,113000,-43000,-43000
060509,宏達電元大9A購02,0,0,0,0,0,0,0,0,0,-43000,0,0,0,25000,68000,-43000,-43000
060504,技嘉元大9A購02  ,0,0,0,0,0,0,0,0,0,-43000,0,0,0,31000,74000,-43000,-43000
056289,合勤控永豐97購01,0,0,0,0,0,0,0,0,0,-43000,0,0,0,0,43000,-43000,-43000
056307,貿聯元大97購05  ,0,0,0,0,0,0,0,0,0,-43000,0,0,0,25000,68000,-43000,-43000
053153,大立光元大99購02,0,0,0,0,0,0,0,0,0,-43000,0,0,0,0,43000,-43000,-43000
055131,茂林康和97購01  ,0,0,0,0,0,0,0,0,0,-43000,0,0,0,126000,169000,-43000,-43000
055080,正崴中信99購01  ,0,0,0,0,0,0,0,0,0,-43000,0,0,0,0,43000,-43000,-43000
051192,緯創兆豐96購01  ,0,0,0,0,0,0,0,0,0,-43000,0,0,0,0,43000,-43000,-43000
051463,世芯國泰97購02  ,0,0,0,0,0,0,0,0,0,-43000,0,0,0,20000,63000,-43000,-43000
052229,奇力新凱基96購01,0,0,0,0,0,0,0,0,0,-43000,0,0,0,50000,93000,-43000,-43000
056168,鴻海元富97購07  ,0,0,0,0,0,0,0,0,0,-43000,0,0,0,0,43000,-43000,-43000
059996,美律元富99購01  ,0,0,0,0,0,0,0,0,0,-43000,0,0,0,88000,131000,-43000,-43000
057912,美律日盛99購01  ,0,0,0,0,0,0,0,0,0,-43000,0,0,0,84000,127000,-43000,-43000
056608,力山永豐98購01  ,0,0,0,0,0,0,0,0,0,-43000,0,0,0,0,43000,-43000,-43000
056568,台表科群益98購01,0,0,0,0,0,0,0,0,0,-43000,0,0,0,8000,51000,-43000,-43000
2929,淘帝-KY         ,99000,126000,-27000,0,0,0,0,0,0,-16000,0,0,0,0,16000,-16000,-43000
059791,超眾元大99購06  ,0,0,0,0,0,0,0,0,0,-43000,0,0,0,38000,81000,-43000,-43000
059868,台光電凱基99購03,0,0,0,0,0,0,0,0,0,-43000,0,0,0,17000,60000,-43000,-43000
3712,永崴投控        ,50000,92000,-42000,0,0,0,0,0,0,-1000,0,1000,-1000,0,0,0,-43000
5258,虹堡            ,8000,55000,-47000,0,0,0,0,0,0,4000,4000,0,4000,0,0,0,-43000
060772,FBVIX凱基9A購03 ,0,0,0,0,0,0,0,0,0,-44000,0,0,0,6000,50000,-44000,-44000
060326,群光群益9A購01  ,0,0,0,0,0,0,0,0,0,-44000,0,0,0,11000,55000,-44000,-44000
060910,聯發科元大9A購05,0,0,0,0,0,0,0,0,0,-44000,0,0,0,0,44000,-44000,-44000
2405,浩鑫            ,121000,165000,-44000,0,0,0,0,0,0,0,0,0,0,0,0,0,-44000
1611,中電            ,177000,221000,-44000,0,0,0,0,0,0,0,0,0,0,0,0,0,-44000
1806,冠軍            ,11000,44000,-33000,0,0,0,0,0,0,-11000,0,11000,-11000,0,0,0,-44000
06933P,禾伸堂元大98售03,0,0,0,0,0,0,0,0,0,-44000,0,0,0,344000,388000,-44000,-44000
054919,興富發凱基97購01,0,0,0,0,0,0,0,0,0,-44000,0,0,0,0,44000,-44000,-44000
058519,嘉澤元大99購01  ,0,0,0,0,0,0,0,0,0,-44000,0,0,0,243000,287000,-44000,-44000
058036,南電永豐98購01  ,0,0,0,0,0,0,0,0,0,-44000,0,0,0,0,44000,-44000,-44000
060016,廣達康和99購01  ,0,0,0,0,0,0,0,0,0,-44000,0,0,0,86000,130000,-44000,-44000
057499,奇鋐群益98購01  ,0,0,0,0,0,0,0,0,0,-44000,0,0,0,88000,132000,-44000,-44000
05744P,台表科元大96售04,0,0,0,0,0,0,0,0,0,-44000,0,0,0,8000,52000,-44000,-44000
5388,中磊            ,205000,156000,49000,0,0,0,0,81000,-81000,-12000,6000,9000,-3000,0,9000,-9000,-44000
4725,信昌化          ,66000,110000,-44000,0,0,0,0,0,0,0,0,0,0,0,0,0,-44000
059314,上銀元大99購03  ,0,0,0,0,0,0,0,0,0,-44000,0,0,0,10000,54000,-44000,-44000
059535,玉山金凱基99購01,0,0,0,0,0,0,0,0,0,-44000,0,0,0,5000,49000,-44000,-44000
07543P,台積電凱基9A售17,0,0,0,0,0,0,0,0,0,-45000,0,0,0,85000,130000,-45000,-45000
07369P,台積電凱基99售20,0,0,0,0,0,0,0,0,0,-45000,0,0,0,30000,75000,-45000,-45000
2441,超豐            ,105000,156000,-51000,0,0,0,0,2000,-2000,8000,22000,14000,8000,0,0,0,-45000
060993,健策元大9B購03  ,0,0,0,0,0,0,0,0,0,-45000,0,0,0,99000,144000,-45000,-45000
054506,矽格永豐96購01  ,0,0,0,0,0,0,0,0,0,-45000,0,0,0,0,45000,-45000,-45000
052968,燿華群益98購01  ,0,0,0,0,0,0,0,0,0,-45000,0,0,0,3000,48000,-45000,-45000
053423,亞光永豐96購01  ,0,0,0,0,0,0,0,0,0,-45000,0,0,0,99000,144000,-45000,-45000
053496,義隆兆豐96購02  ,0,0,0,0,0,0,0,0,0,-45000,0,0,0,10000,55000,-45000,-45000
049004,聯發科中信96購01,0,0,0,0,0,0,0,0,0,-45000,0,0,0,0,45000,-45000,-45000
057501,超眾群益98購04  ,0,0,0,0,0,0,0,0,0,-45000,0,0,0,1000,46000,-45000,-45000
05971P,世紀鋼永豐96售04,0,0,0,0,0,0,0,0,0,-45000,0,0,0,0,45000,-45000,-45000
05930P,景碩康和96售01  ,0,0,0,0,0,0,0,0,0,-45000,0,0,0,128000,173000,-45000,-45000
058249,緯穎元大99購04  ,0,0,0,0,0,0,0,0,0,-45000,0,0,0,39000,84000,-45000,-45000
058763,和碩群益99購01  ,0,0,0,0,0,0,0,0,0,-45000,0,0,0,55000,100000,-45000,-45000
059694,創意永豐99購03  ,0,0,0,0,0,0,0,0,0,-45000,0,0,0,27000,72000,-45000,-45000
4526,東台            ,18000,57000,-39000,0,0,0,0,0,0,-6000,0,6000,-6000,0,0,0,-45000
061014,台積電麥證9A購04,0,0,0,5000,51000,-46000,0,0,0,-46000,0,0,0,5000,51000,-46000,-46000
06243P,亞光元富97售01  ,0,0,0,0,0,0,0,0,0,-46000,0,0,0,0,46000,-46000,-46000
06374P,台表科元大97售06,0,0,0,0,0,0,0,0,0,-46000,0,0,0,3000,49000,-46000,-46000
06718P,聯詠元大98售01  ,0,0,0,0,0,0,0,0,0,-46000,0,0,0,0,46000,-46000,-46000
060658,台灣50凱基01購04,0,0,0,0,0,0,0,0,0,-46000,0,0,0,12000,58000,-46000,-46000
2538,基泰            ,27000,30000,-3000,0,0,0,0,0,0,-43000,0,43000,-43000,0,0,0,-46000
1522,堤維西          ,147000,173000,-26000,0,0,0,0,1000,-1000,-19000,0,0,0,0,19000,-19000,-46000
05240P,玉晶光永豐96售01,0,0,0,0,0,0,0,0,0,-46000,0,0,0,7000,53000,-46000,-46000
053519,力成群益96購02  ,0,0,0,0,0,0,0,0,0,-46000,0,0,0,66000,112000,-46000,-46000
053718,全新凱基97購02  ,0,0,0,0,0,0,0,0,0,-46000,0,0,0,40000,86000,-46000,-46000
058637,晶技兆豐99購01  ,0,0,0,0,0,0,0,0,0,-46000,0,0,0,53000,99000,-46000,-46000
056515,燿華兆豐99購01  ,0,0,0,0,0,0,0,0,0,-46000,0,0,0,0,46000,-46000,-46000
058231,技嘉元大99購02  ,0,0,0,0,0,0,0,0,0,-46000,0,0,0,0,46000,-46000,-46000
060190,國泰金元富9A購01,0,0,0,0,0,0,0,0,0,-46000,0,0,0,142000,188000,-46000,-46000
9905,大華            ,1000,45000,-44000,0,0,0,0,0,0,-2000,0,2000,-2000,0,0,0,-46000
07705P,台積電元大9A售26,0,0,0,0,0,0,0,0,0,-47000,0,0,0,0,47000,-47000,-47000
2034,允強            ,8000,53000,-45000,0,0,0,0,0,0,-2000,0,2000,-2000,0,0,0,-47000
07645P,華通元大9A售06  ,0,0,0,0,0,0,0,0,0,-47000,0,0,0,0,47000,-47000,-47000
06553P,訊芯元大98售05  ,0,0,0,0,0,0,0,0,0,-47000,0,0,0,0,47000,-47000,-47000
06545P,致茂元大98售01  ,0,0,0,0,0,0,0,0,0,-47000,0,0,0,0,47000,-47000,-47000
07170P,臺股指國票99售07,0,0,0,0,0,0,0,0,0,-47000,0,0,0,250000,297000,-47000,-47000
06686P,麗豐永豐98售02  ,0,0,0,0,0,0,0,0,0,-47000,0,0,0,0,47000,-47000,-47000
061243,麗豐兆豐9A購01  ,0,0,0,0,0,0,0,0,0,-47000,0,0,0,0,47000,-47000,-47000
06458P,玉晶光統一9A售02,0,0,0,0,0,0,0,0,0,-47000,0,0,0,5000,52000,-47000,-47000
053410,啟碁兆豐96購01  ,0,0,0,0,0,0,0,0,0,-47000,0,0,0,9000,56000,-47000,-47000
055125,智原兆豐97購01  ,0,0,0,0,0,0,0,0,0,-47000,0,0,0,350000,397000,-47000,-47000
054053,聯茂元大96購01  ,0,0,0,0,0,0,0,0,0,-47000,0,0,0,52000,99000,-47000,-47000
060209,喬山康和9A購01  ,0,0,0,0,0,0,0,0,0,-47000,0,0,0,43000,90000,-47000,-47000
060010,義隆群益99購02  ,0,0,0,0,0,0,0,0,0,-47000,0,0,0,45000,92000,-47000,-47000
059967,聯發科凱基99購20,0,0,0,0,0,0,0,0,0,-47000,0,0,0,0,47000,-47000,-47000
060091,技嘉元大99購03  ,0,0,0,0,0,0,0,0,0,-47000,0,0,0,1000,48000,-47000,-47000
055714,智邦元大97購03  ,0,0,0,0,0,0,0,0,0,-47000,0,0,0,8000,55000,-47000,-47000
055647,義隆元富97購01  ,0,0,0,0,0,0,0,0,0,-47000,0,0,0,26000,73000,-47000,-47000
058035,旭富永豐98購02  ,0,0,0,0,0,0,0,0,0,-47000,0,0,0,152000,199000,-47000,-47000
056949,義隆統一98購01  ,0,0,0,0,0,0,0,0,0,-47000,0,0,0,13000,60000,-47000,-47000
058115,台光電中信99購01,0,0,0,0,0,0,0,0,0,-47000,0,0,0,19000,66000,-47000,-47000
059259,FBVIX中信03購06 ,0,0,0,0,0,0,0,0,0,-47000,0,0,0,170000,217000,-47000,-47000
061160,瑞祺群益9A購01  ,0,0,0,0,0,0,0,0,0,-48000,0,0,0,164000,212000,-48000,-48000
060603,聯發科凱基9A購12,0,0,0,0,0,0,0,0,0,-48000,0,0,0,274000,322000,-48000,-48000
060427,聯茂永豐9A購01  ,0,0,0,0,0,0,0,0,0,-48000,0,0,0,2000,50000,-48000,-48000
1225,福懋油          ,39000,87000,-48000,0,0,0,0,0,0,0,0,0,0,0,0,0,-48000
1457,宜進            ,13000,61000,-48000,0,0,0,0,0,0,0,0,0,0,0,0,0,-48000
05011P,南電國泰96售01  ,0,0,0,0,0,0,0,0,0,-48000,0,0,0,0,48000,-48000,-48000
056291,聯茂永豐97購03  ,0,0,0,0,0,0,0,0,0,-48000,0,0,0,60000,108000,-48000,-48000
056936,禾伸堂元富98購01,0,0,0,0,0,0,0,0,0,-48000,0,0,0,299000,347000,-48000,-48000
059178,臺股指凱基99購30,0,0,0,0,0,0,0,0,0,-48000,0,0,0,2000,50000,-48000,-48000
05636P,國巨永豐96售03  ,0,0,0,0,0,0,0,0,0,-48000,0,0,0,10000,58000,-48000,-48000
05922P,京元電兆豐96售01,0,0,0,0,0,0,0,0,0,-48000,0,0,0,2000,50000,-48000,-48000
059981,聯發科元大99購36,0,0,0,0,0,0,0,0,0,-48000,0,0,0,0,48000,-48000,-48000
057525,光磊元大99購01  ,0,0,0,0,0,0,0,0,0,-48000,0,0,0,3000,51000,-48000,-48000
059883,T50反1國票99購02,0,0,0,0,0,0,0,0,0,-48000,0,0,0,0,48000,-48000,-48000
4956,光鋐            ,134000,182000,-48000,0,0,0,0,0,0,0,0,0,0,0,0,0,-48000
1316,上曜            ,27000,75000,-48000,0,0,0,0,0,0,-1000,0,1000,-1000,0,0,0,-49000
07707P,玉山金元大9A售03,0,0,0,0,0,0,0,0,0,-49000,0,0,0,12000,61000,-49000,-49000
07684P,大立光凱基9A售11,0,0,0,0,0,0,0,0,0,-49000,0,0,0,1000,50000,-49000,-49000
2450,神腦            ,19000,60000,-41000,0,0,0,0,0,0,-8000,0,8000,-8000,0,0,0,-49000
07636P,鴻海國票9A售05  ,0,0,0,0,0,0,0,0,0,-49000,0,0,0,0,49000,-49000,-49000
060328,可成群益9A購06  ,0,0,0,0,0,0,0,0,0,-49000,0,0,0,2000,51000,-49000,-49000
060333,金寶康和9A購01  ,0,0,0,0,0,0,0,0,0,-49000,0,0,0,40000,89000,-49000,-49000
060296,和碩元大9A購01  ,0,0,0,0,0,0,0,0,0,-49000,0,0,0,37000,86000,-49000,-49000
060835,亞德客國票9A購01,0,0,0,0,0,0,0,0,0,-49000,0,0,0,32000,81000,-49000,-49000
055133,致新康和97購01  ,0,0,0,0,0,0,0,0,0,-49000,0,0,0,55000,104000,-49000,-49000
052946,智原國票97購02  ,0,0,0,0,0,0,0,0,0,-49000,0,0,0,72000,121000,-49000,-49000
052424,泰碩國票97購01  ,0,0,0,0,0,0,0,0,0,-49000,0,0,0,5000,54000,-49000,-49000
057672,茂林元大98購02  ,0,0,0,0,0,0,0,0,0,-49000,0,0,0,1000,50000,-49000,-49000
059989,嘉晶元大9A購01  ,0,0,0,0,0,0,0,0,0,-49000,0,0,0,0,49000,-49000,-49000
060095,聯發科元大99購42,0,0,0,0,0,0,0,0,0,-49000,0,0,0,0,49000,-49000,-49000
060033,臻鼎永豐99購01  ,0,0,0,0,0,0,0,0,0,-49000,0,0,0,1000,50000,-49000,-49000
059073,元油2X元大9C購14,0,0,0,0,0,0,0,0,0,-49000,0,0,0,46000,95000,-49000,-49000
056020,義隆群益97購01  ,0,0,0,0,0,0,0,0,0,-49000,0,0,0,21000,70000,-49000,-49000
058508,聯發科元大99購11,0,0,0,0,0,0,0,0,0,-49000,0,0,0,0,49000,-49000,-49000
058767,亞德客兆豐99購01,0,0,0,0,0,0,0,0,0,-49000,0,0,0,5000,54000,-49000,-49000
8464,億豐            ,191051,319175,-128124,0,0,0,68000,0,68000,11000,20000,8000,12000,0,1000,-1000,-49124
07683P,宏達電凱基9A售03,0,0,0,0,0,0,0,0,0,-50000,0,0,0,0,50000,-50000,-50000
07667P,亞德客元大9A售05,0,0,0,0,0,0,0,0,0,-50000,0,0,0,0,50000,-50000,-50000
07709P,創意元大9A售01  ,0,0,0,0,0,0,0,0,0,-50000,0,0,0,0,50000,-50000,-50000
07711P,世芯元大9A售07  ,0,0,0,0,0,0,0,0,0,-50000,0,0,0,0,50000,-50000,-50000
07719P,臺股指群益9A售08,0,0,0,0,0,0,0,0,0,-50000,0,0,0,100000,150000,-50000,-50000
07750P,台表科凱基9A售04,0,0,0,0,0,0,0,0,0,-50000,0,0,0,0,50000,-50000,-50000
1519,華城            ,91000,140000,-49000,0,0,0,0,0,0,-1000,0,1000,-1000,0,0,0,-50000
07513P,台積電元大9A售13,0,0,0,0,0,0,0,0,0,-50000,0,0,0,50000,100000,-50000,-50000
06490P,鴻海富邦99售02  ,0,0,0,0,0,0,0,0,0,-50000,0,0,0,3000,53000,-50000,-50000
060814,健策凱基9B購01  ,0,0,0,0,0,0,0,0,0,-50000,0,0,0,68000,118000,-50000,-50000
060914,健策元大9A購03  ,0,0,0,0,0,0,0,0,0,-50000,0,0,0,46000,96000,-50000,-50000
060871,台灣50中信01購03,0,0,0,0,0,0,0,0,0,-50000,0,0,0,25000,75000,-50000,-50000
060885,世紀鋼中信9A購01,0,0,0,0,0,0,0,0,0,-50000,0,0,0,0,50000,-50000,-50000
060897,健策凱基9A購04  ,0,0,0,0,0,0,0,0,0,-50000,0,0,0,63000,113000,-50000,-50000
061294,奇力新麥證9A購01,0,0,0,0,50000,-50000,0,0,0,-50000,0,0,0,0,50000,-50000,-50000
060276,S&P反1元大9A購03,0,0,0,0,0,0,0,0,0,-50000,0,0,0,0,50000,-50000,-50000
061103,聯發科元大9A購08,0,0,0,0,0,0,0,0,0,-50000,0,0,0,3000,53000,-50000,-50000
060708,康友富邦9B購01  ,0,0,0,0,0,0,0,0,0,-50000,0,0,0,50000,100000,-50000,-50000
051828,微星元大95購03  ,0,0,0,0,0,0,0,0,0,-50000,0,0,0,90000,140000,-50000,-50000
054161,友訊凱基98購01  ,0,0,0,0,0,0,0,0,0,-50000,0,0,0,0,50000,-50000,-50000
054239,台郡群益96購02  ,0,0,0,0,0,0,0,0,0,-50000,0,0,0,200000,250000,-50000,-50000
054252,奇力新元大96購04,0,0,0,0,0,0,0,0,0,-50000,0,0,0,0,50000,-50000,-50000
052576,聯茂凱基96購01  ,0,0,0,0,0,0,0,0,0,-50000,0,0,0,0,50000,-50000,-50000
04975P,華新科凱基96售02,0,0,0,0,0,0,0,0,0,-50000,0,0,0,0,50000,-50000,-50000
050867,聯鈞永豐95購01  ,0,0,0,0,0,0,0,0,0,-50000,0,0,0,10000,60000,-50000,-50000
047970,鴻海富邦95購01  ,0,0,0,0,0,0,0,0,0,-50000,0,0,0,40000,90000,-50000,-50000
052927,友達元大98購02  ,0,0,0,0,0,0,0,0,0,-50000,0,0,0,0,50000,-50000,-50000
055387,世紀鋼元大97購01,0,0,0,0,0,0,0,0,0,-50000,0,0,0,0,50000,-50000,-50000
054640,健策中信9B購01  ,0,0,0,0,0,0,0,0,0,-50000,0,0,0,100000,150000,-50000,-50000
054880,華泰統一97購01  ,0,0,0,0,0,0,0,0,0,-50000,0,0,0,0,50000,-50000,-50000
054832,興勤中信97購01  ,0,0,0,0,0,0,0,0,0,-50000,0,0,0,0,50000,-50000,-50000
058343,台積電群益99購02,0,0,0,0,0,0,0,0,0,-50000,0,0,0,0,50000,-50000,-50000
058692,華邦電國票9B購01,0,0,0,0,0,0,0,0,0,-50000,0,0,0,0,50000,-50000,-50000
053531,國泰金康和96購01,0,0,0,0,0,0,0,0,0,-50000,0,0,0,0,50000,-50000,-50000
053137,旺宏富邦98購01  ,0,0,0,0,0,0,0,0,0,-50000,0,0,0,0,50000,-50000,-50000
053127,貿聯凱基97購01  ,0,0,0,0,0,0,0,0,0,-50000,0,0,0,0,50000,-50000,-50000
056705,超眾國泰99購01  ,0,0,0,0,0,0,0,0,0,-50000,0,0,0,123000,173000,-50000,-50000
058230,國巨元大99購11  ,0,0,0,0,0,0,0,0,0,-50000,0,0,0,0,50000,-50000,-50000
05701P,彩晶凱基96售01  ,0,0,0,0,0,0,0,0,0,-50000,0,0,0,0,50000,-50000,-50000
056912,臺股指元大99購04,0,0,0,0,0,0,0,0,0,-50000,0,0,0,4000,54000,-50000,-50000
058966,元油2X日盛99購03,0,0,0,0,0,0,0,0,0,-50000,0,0,0,0,50000,-50000,-50000
056834,華新元富99購01  ,0,0,0,0,0,0,0,0,0,-50000,0,0,0,0,50000,-50000,-50000
055937,康舒群益97購01  ,0,0,0,0,0,0,0,0,0,-50000,0,0,0,108000,158000,-50000,-50000
056132,台光電元大97購03,0,0,0,0,0,0,0,0,0,-50000,0,0,0,0,50000,-50000,-50000
056157,聯詠凱基97購03  ,0,0,0,0,0,0,0,0,0,-50000,0,0,0,0,50000,-50000,-50000
059024,大立光統一9B購04,0,0,0,0,0,0,0,0,0,-50000,0,0,0,0,50000,-50000,-50000
057161,亞德客元大98購02,0,0,0,0,0,0,0,0,0,-50000,0,0,0,6000,56000,-50000,-50000
055675,亞德客凱基97購02,0,0,0,0,0,0,0,0,0,-50000,0,0,0,40000,90000,-50000,-50000
057538,緯穎元大98購07  ,0,0,0,0,0,0,0,0,0,-50000,0,0,0,10000,60000,-50000,-50000
057621,崇越凱基98購01  ,0,0,0,0,0,0,0,0,0,-50000,0,0,0,0,50000,-50000,-50000
059923,緯穎元大99購09  ,0,0,0,0,0,0,0,0,0,-50000,0,0,0,53000,103000,-50000,-50000
059525,上銀凱基99購08  ,0,0,0,0,0,0,0,0,0,-50000,0,0,0,11000,61000,-50000,-50000
059562,上銀凱基99購09  ,0,0,0,0,0,0,0,0,0,-50000,0,0,0,0,50000,-50000,-50000
061108,臻鼎元大9A購02  ,0,0,0,0,0,0,0,0,0,-51000,0,0,0,32000,83000,-51000,-51000
060298,鎧勝元大9C購01  ,0,0,0,0,0,0,0,0,0,-51000,0,0,0,24000,75000,-51000,-51000
061254,道瓊反凱基9A購02,0,0,0,0,0,0,0,0,0,-51000,0,0,0,0,51000,-51000,-51000
060830,T50反1國票9A購07,0,0,0,0,0,0,0,0,0,-51000,0,0,0,27000,78000,-51000,-51000
07312P,台灣50元大99售10,0,0,0,0,0,0,0,0,0,-51000,0,0,0,141000,192000,-51000,-51000
053886,亞光兆豐96購01  ,0,0,0,0,0,0,0,0,0,-51000,0,0,0,37000,88000,-51000,-51000
053344,嘉晶國票97購02  ,0,0,0,0,0,0,0,0,0,-51000,0,0,0,7000,58000,-51000,-51000
052853,友達日盛99購01  ,0,0,0,0,0,0,0,0,0,-51000,0,0,0,0,51000,-51000,-51000
057534,旭富元大98購01  ,0,0,0,0,0,0,0,0,0,-51000,0,0,0,0,51000,-51000,-51000
057480,技嘉元大98購03  ,0,0,0,0,0,0,0,0,0,-51000,0,0,0,0,51000,-51000,-51000
055603,超眾元大97購04  ,0,0,0,0,0,0,0,0,0,-51000,0,0,0,4000,55000,-51000,-51000
3708,上緯投控        ,45000,96000,-51000,0,0,0,0,0,0,0,0,0,0,0,0,0,-51000
4564,元翎            ,28000,79000,-51000,0,0,0,0,0,0,0,0,0,0,0,0,0,-51000
07488P,鴻海國票9A售02  ,0,0,0,0,0,0,0,0,0,-52000,0,0,0,0,52000,-52000,-52000
07457P,宏達電元大9A售01,0,0,0,0,0,0,0,0,0,-52000,0,0,0,35000,87000,-52000,-52000
06739P,聯詠兆豐98售02  ,0,0,0,0,0,0,0,0,0,-52000,0,0,0,32000,84000,-52000,-52000
07227P,聯發科元富99售05,0,0,0,0,0,0,0,0,0,-52000,0,0,0,25000,77000,-52000,-52000
1532,勤美            ,1000,53000,-52000,0,0,0,0,0,0,0,0,0,0,0,0,0,-52000
2109,華豐            ,4000,55000,-51000,0,0,0,0,0,0,-1000,0,1000,-1000,0,0,0,-52000
060994,世芯元大9A購03  ,0,0,0,0,0,0,0,0,0,-52000,0,0,0,116000,168000,-52000,-52000
061304,創意永豐9A購02  ,0,0,0,0,0,0,0,0,0,-52000,0,0,0,0,52000,-52000,-52000
06137P,玉晶光永豐97售04,0,0,0,0,0,0,0,0,0,-52000,0,0,0,67000,119000,-52000,-52000
061124,微星永豐9A購02  ,0,0,0,0,0,0,0,0,0,-52000,0,0,0,0,52000,-52000,-52000
060451,中石化元大9C購02,0,0,0,0,0,0,0,0,0,-52000,0,0,0,84000,136000,-52000,-52000
04817P,創意國票95售02  ,0,0,0,0,0,0,0,0,0,-52000,0,0,0,0,52000,-52000,-52000
050644,國巨凱基96購01  ,0,0,0,0,0,0,0,0,0,-52000,0,0,0,80000,132000,-52000,-52000
03658C,T50反1元大9A牛02,0,0,0,0,0,0,0,0,0,-52000,0,0,0,2000,54000,-52000,-52000
057468,台郡永豐98購01  ,0,0,0,0,0,0,0,0,0,-52000,0,0,0,28000,80000,-52000,-52000
06015P,大立光富邦98售04,0,0,0,0,0,0,0,0,0,-52000,0,0,0,8000,60000,-52000,-52000
057878,台郡元大99購04  ,0,0,0,0,0,0,0,0,0,-52000,0,0,0,12000,64000,-52000,-52000
056637,台光電日盛9A購01,0,0,0,0,0,0,0,0,0,-52000,0,0,0,0,52000,-52000,-52000
056649,智易凱基98購01  ,0,0,0,0,0,0,0,0,0,-52000,0,0,0,6000,58000,-52000,-52000
9935,慶豐富          ,105000,157000,-52000,0,0,0,0,0,0,0,0,0,0,0,0,0,-52000
060339,國巨統一01購01  ,0,0,0,0,0,0,0,0,0,-53000,0,0,0,16000,69000,-53000,-53000
061167,臻鼎兆豐9B購01  ,0,0,0,0,0,0,0,0,0,-53000,0,0,0,0,53000,-53000,-53000
2029,盛餘            ,0,44000,-44000,0,0,0,0,0,0,-9000,0,9000,-9000,0,0,0,-53000
07228P,台灣50群益9B售06,0,0,0,0,0,0,0,0,0,-53000,0,0,0,0,53000,-53000,-53000
07149P,健鼎元大99售03  ,0,0,0,0,0,0,0,0,0,-53000,0,0,0,0,53000,-53000,-53000
06983P,台積電國泰9A售02,0,0,0,0,0,0,0,0,0,-53000,0,0,0,11000,64000,-53000,-53000
07361P,聯發科元大99售34,0,0,0,0,0,0,0,0,0,-53000,0,0,0,6000,59000,-53000,-53000
048859,玉晶光群益96購02,0,0,0,0,0,0,0,0,0,-53000,0,0,0,23000,76000,-53000,-53000
054331,世芯永豐96購03  ,0,0,0,0,0,0,0,0,0,-53000,0,0,0,41000,94000,-53000,-53000
056326,TPK兆豐98購01   ,0,0,0,0,0,0,0,0,0,-53000,0,0,0,3000,56000,-53000,-53000
053248,智伸科國票97購01,0,0,0,0,0,0,0,0,0,-53000,0,0,0,0,53000,-53000,-53000
058725,美律富邦9A購01  ,0,0,0,0,0,0,0,0,0,-53000,0,0,0,100000,153000,-53000,-53000
056583,昇陽半元大98購02,0,0,0,0,0,0,0,0,0,-53000,0,0,0,0,53000,-53000,-53000
058293,光寶科凱基9A購01,0,0,0,0,0,0,0,0,0,-53000,0,0,0,98000,151000,-53000,-53000
059970,台灣50元大9B購07,0,0,0,0,0,0,0,0,0,-53000,0,0,0,0,53000,-53000,-53000
059735,T50反1元富99購06,0,0,0,0,0,0,0,0,0,-53000,0,0,0,0,53000,-53000,-53000
057319,奇力新凱基99購02,0,0,0,0,0,0,0,0,0,-53000,0,0,0,0,53000,-53000,-53000
059831,聯詠康和99購01  ,0,0,0,0,0,0,0,0,0,-53000,0,0,0,30000,83000,-53000,-53000
3004,豐達科          ,48000,99000,-51000,0,0,0,0,0,0,-2000,0,2000,-2000,0,0,0,-53000
2850,新產            ,15000,47000,-32000,0,0,0,0,0,0,-21000,0,21000,-21000,0,0,0,-53000
3346,麗清            ,11000,64000,-53000,0,0,0,0,0,0,0,0,0,0,0,0,0,-53000
07071P,立積元富99售01  ,0,0,0,0,0,0,0,0,0,-54000,0,0,0,18000,72000,-54000,-54000
1473,台南            ,34000,88000,-54000,0,0,0,0,0,0,0,0,0,0,0,0,0,-54000
060674,瑞昱元大9A購03  ,0,0,0,0,0,0,0,0,0,-54000,0,0,0,304000,358000,-54000,-54000
060661,台積電凱基9A購18,0,0,0,0,0,0,0,0,0,-54000,0,0,0,41000,95000,-54000,-54000
052819,義隆永豐96購01  ,0,0,0,0,0,0,0,0,0,-54000,0,0,0,18000,72000,-54000,-54000
052328,台表科中信99購01,0,0,0,0,0,0,0,0,0,-54000,0,0,0,46000,100000,-54000,-54000
052203,T50反1中信99購03,0,0,0,0,0,0,0,0,0,-54000,0,0,0,23000,77000,-54000,-54000
05160P,國巨國票96售03  ,0,0,0,0,0,0,0,0,0,-54000,0,0,0,31000,85000,-54000,-54000
057539,南茂元大98購02  ,0,0,0,0,0,0,0,0,0,-54000,0,0,0,246000,300000,-54000,-54000
056572,義隆元大99購01  ,0,0,0,0,0,0,0,0,0,-54000,0,0,0,311000,365000,-54000,-54000
4190,佐登-KY         ,48000,39000,9000,0,0,0,0,65000,-65000,2000,0,0,0,9000,7000,2000,-54000
059377,台積電群益99購09,0,0,0,0,0,0,0,0,0,-54000,0,0,0,0,54000,-54000,-54000
060666,聯茂凱基9A購02  ,0,0,0,0,0,0,0,0,0,-55000,0,0,0,103000,158000,-55000,-55000
06042P,華新科永豐96售04,0,0,0,0,0,0,0,0,0,-55000,0,0,0,20000,75000,-55000,-55000
06034P,世芯凱基96售03  ,0,0,0,0,0,0,0,0,0,-55000,0,0,0,0,55000,-55000,-55000
07652P,臺股指中信9A售07,0,0,0,0,0,0,0,0,0,-55000,0,0,0,52000,107000,-55000,-55000
06994P,台光電凱基99售02,0,0,0,0,0,0,0,0,0,-55000,0,0,0,0,55000,-55000,-55000
07251P,台灣50元富01售04,0,0,0,0,0,0,0,0,0,-55000,0,0,0,6000,61000,-55000,-55000
07383P,聯發科群益99售06,0,0,0,0,0,0,0,0,0,-55000,0,0,0,2000,57000,-55000,-55000
07527P,台灣50凱基9B售02,0,0,0,0,0,0,0,0,0,-55000,0,0,0,118000,173000,-55000,-55000
057809,英業達元大98購01,0,0,0,0,0,0,0,0,0,-55000,0,0,0,50000,105000,-55000,-55000
053453,新光金統一98購01,0,0,0,0,0,0,0,0,0,-55000,0,0,0,4000,59000,-55000,-55000
056523,光寶科中信98購01,0,0,0,0,0,0,0,0,0,-55000,0,0,0,10000,65000,-55000,-55000
058473,上銀凱基9A購03  ,0,0,0,0,0,0,0,0,0,-55000,0,0,0,0,55000,-55000,-55000
055631,創意永豐98購01  ,0,0,0,0,0,0,0,0,0,-55000,0,0,0,0,55000,-55000,-55000
07501P,華新科元大9A售07,0,0,0,0,0,0,0,0,0,-56000,0,0,0,0,56000,-56000,-56000
1808,潤隆            ,51000,94000,-43000,0,0,0,0,0,0,-13000,0,13000,-13000,0,0,0,-56000
2402,毅嘉            ,52000,105000,-53000,0,0,0,0,0,0,-3000,0,3000,-3000,0,0,0,-56000
2393,億光            ,414000,564000,-150000,0,0,0,140000,0,140000,-46000,0,34000,-34000,5000,17000,-12000,-56000
060930,超眾永豐9A購03  ,0,0,0,0,0,0,0,0,0,-56000,0,0,0,3000,59000,-56000,-56000
052326,滬深反中信99購01,0,0,0,0,0,0,0,0,0,-56000,0,0,0,0,56000,-56000,-56000
00710B,FH彭博高收益債  ,0,0,0,0,0,0,0,0,0,-56000,0,0,0,100000,156000,-56000,-56000
057599,技嘉群益9A購01  ,0,0,0,0,0,0,0,0,0,-56000,0,0,0,0,56000,-56000,-56000
057885,台光電群益98購04,0,0,0,0,0,0,0,0,0,-56000,0,0,0,154000,210000,-56000,-56000
2385,群光            ,845189,1040445,-195256,0,0,0,200000,1000,199000,-60000,0,30000,-30000,2000,32000,-30000,-56256
07704P,台積電元大9A售25,0,0,0,0,0,0,0,0,0,-57000,0,0,0,60000,117000,-57000,-57000
07415P,台積電元大99售52,0,0,0,0,0,0,0,0,0,-57000,0,0,0,19000,76000,-57000,-57000
051902,T50反1元大97購01,0,0,0,0,0,0,0,0,0,-57000,0,0,0,69000,126000,-57000,-57000
05626P,景碩國票97售03  ,0,0,0,0,0,0,0,0,0,-57000,0,0,0,0,57000,-57000,-57000
056529,中環凱基98購01  ,0,0,0,0,0,0,0,0,0,-57000,0,0,0,72000,129000,-57000,-57000
058268,泰碩永豐9A購01  ,0,0,0,0,0,0,0,0,0,-57000,0,0,0,0,57000,-57000,-57000
058014,上銀凱基99購02  ,0,0,0,0,0,0,0,0,0,-57000,0,0,0,0,57000,-57000,-57000
057370,可成元大98購07  ,0,0,0,0,0,0,0,0,0,-57000,0,0,0,61000,118000,-57000,-57000
056044,同欣電凱基97購03,0,0,0,0,0,0,0,0,0,-57000,0,0,0,3000,60000,-57000,-57000
059853,超眾永豐99購03  ,0,0,0,0,0,0,0,0,0,-57000,0,0,0,33000,90000,-57000,-57000
2472,立隆電          ,196000,254000,-58000,0,0,0,0,0,0,0,10000,10000,0,0,0,0,-58000
060862,美律永豐9A購01  ,0,0,0,0,0,0,0,0,0,-58000,0,0,0,0,58000,-58000,-58000
060958,儒鴻凱基9A購02  ,0,0,0,0,0,0,0,0,0,-58000,0,0,0,21000,79000,-58000,-58000
06035P,同欣電凱基96售03,0,0,0,0,0,0,0,0,0,-58000,0,0,0,94000,152000,-58000,-58000
060413,東元永豐9A購01  ,0,0,0,0,0,0,0,0,0,-58000,0,0,0,0,58000,-58000,-58000
060288,群光元大9C購01  ,0,0,0,0,0,0,0,0,0,-58000,0,0,0,34000,92000,-58000,-58000
060259,潤泰全凱基9C購01,0,0,0,0,0,0,0,0,0,-58000,0,0,0,0,58000,-58000,-58000
053768,S&P反1元大99購01,0,0,0,0,0,0,0,0,0,-58000,0,0,0,0,58000,-58000,-58000
054693,神基永豐97購01  ,0,0,0,0,0,0,0,0,0,-58000,0,0,0,0,58000,-58000,-58000
00680L,元大美債20正2   ,0,0,0,0,0,0,0,0,0,-58000,0,0,0,128000,186000,-58000,-58000
05656P,台表科統一96售01,0,0,0,0,0,0,0,0,0,-58000,0,0,0,0,58000,-58000,-58000
056473,奇力新元大99購02,0,0,0,0,0,0,0,0,0,-58000,0,0,0,0,58000,-58000,-58000
057883,中環群益98購01  ,0,0,0,0,0,0,0,0,0,-58000,0,0,0,50000,108000,-58000,-58000
05669P,嘉晶永豐96售03  ,0,0,0,0,0,0,0,0,0,-58000,0,0,0,100000,158000,-58000,-58000
5608,四維航          ,11000,63000,-52000,0,0,0,0,0,0,-6000,0,6000,-6000,0,0,0,-58000
060292,聯詠元大9A購01  ,0,0,0,0,0,0,0,0,0,-59000,0,0,0,43000,102000,-59000,-59000
060287,燿華元大9A購01  ,0,0,0,0,0,0,0,0,0,-59000,0,0,0,62000,121000,-59000,-59000
2316,楠梓電          ,823000,957000,-134000,0,0,0,0,0,0,75000,4000,17000,-13000,99000,11000,88000,-59000
046881,智原富邦99購01  ,0,0,0,0,0,0,0,0,0,-59000,0,0,0,20000,79000,-59000,-59000
05259P,臺股指凱基96售12,0,0,0,0,0,0,0,0,0,-59000,0,0,0,293000,352000,-59000,-59000
054001,康友群益96購02  ,0,0,0,0,0,0,0,0,0,-59000,0,0,0,0,59000,-59000,-59000
055442,矽創國票98購02  ,0,0,0,0,0,0,0,0,0,-59000,0,0,0,38000,97000,-59000,-59000
053149,京元電元大96購02,0,0,0,0,0,0,0,0,0,-59000,0,0,0,9000,68000,-59000,-59000
056266,開發金統一9A購01,0,0,0,0,0,0,0,0,0,-59000,0,0,0,138000,197000,-59000,-59000
058732,矽格永豐99購01  ,0,0,0,0,0,0,0,0,0,-59000,0,0,0,46000,105000,-59000,-59000
058047,可成元大98購11  ,0,0,0,0,0,0,0,0,0,-59000,0,0,0,11000,70000,-59000,-59000
05807P,泰鼎永豐96售03  ,0,0,0,0,0,0,0,0,0,-59000,0,0,0,0,59000,-59000,-59000
05609P,國泰金凱基96售01,0,0,0,0,0,0,0,0,0,-59000,0,0,0,105000,164000,-59000,-59000
055604,訊芯元大98購02  ,0,0,0,0,0,0,0,0,0,-59000,0,0,0,58000,117000,-59000,-59000
059742,富邦金元富99購01,0,0,0,0,0,0,0,0,0,-59000,0,0,0,20000,79000,-59000,-59000
07673P,電子類元大9A售01,0,0,0,0,0,0,0,0,0,-60000,0,0,0,0,60000,-60000,-60000
07644P,南電凱基9A售03  ,0,0,0,0,0,0,0,0,0,-60000,0,0,0,23000,83000,-60000,-60000
07617P,聯發科中信9C售04,0,0,0,0,0,0,0,0,0,-60000,0,0,0,30000,90000,-60000,-60000
060285,聯電元大9C購01  ,0,0,0,0,0,0,0,0,0,-60000,0,0,0,25000,85000,-60000,-60000
060536,祥碩麥證9A購01  ,0,0,0,13000,73000,-60000,0,0,0,-60000,0,0,0,13000,73000,-60000,-60000
060781,台郡國泰9B購01  ,0,0,0,0,0,0,0,0,0,-60000,0,0,0,229000,289000,-60000,-60000
06270P,致伸凱基97售03  ,0,0,0,0,0,0,0,0,0,-60000,0,0,0,0,60000,-60000,-60000
057790,台積電統一99購04,0,0,0,0,0,0,0,0,0,-60000,0,0,0,2000,62000,-60000,-60000
052772,台虹群益96購01  ,0,0,0,0,0,0,0,0,0,-60000,0,0,0,0,60000,-60000,-60000
055512,聯詠兆豐97購01  ,0,0,0,0,0,0,0,0,0,-60000,0,0,0,0,60000,-60000,-60000
054455,楠梓電群益98購02,0,0,0,0,0,0,0,0,0,-60000,0,0,0,0,60000,-60000,-60000
055065,神達永豐97購01  ,0,0,0,0,0,0,0,0,0,-60000,0,0,0,0,60000,-60000,-60000
052491,泰碩國票99購01  ,0,0,0,0,0,0,0,0,0,-60000,0,0,0,0,60000,-60000,-60000
054149,達方元大96購01  ,0,0,0,0,0,0,0,0,0,-60000,0,0,0,0,60000,-60000,-60000
049612,香港反中信96購01,0,0,0,0,0,0,0,0,0,-60000,0,0,0,0,60000,-60000,-60000
03035X,元展32          ,0,0,0,0,0,0,0,0,0,-60000,0,0,0,0,60000,-60000,-60000
059753,貿聯群益99購06  ,0,0,0,0,0,0,0,0,0,-60000,0,0,0,0,60000,-60000,-60000
05977P,旺宏永豐96售06  ,0,0,0,0,0,0,0,0,0,-60000,0,0,0,30000,90000,-60000,-60000
059308,T50反1元大99購07,0,0,0,0,0,0,0,0,0,-60000,0,0,0,0,60000,-60000,-60000
059614,致新永豐99購01  ,0,0,0,0,0,0,0,0,0,-60000,0,0,0,30000,90000,-60000,-60000
057644,奇力新元大98購04,0,0,0,0,0,0,0,0,0,-60000,0,0,0,0,60000,-60000,-60000
055805,矽力永豐97購01  ,0,0,0,0,0,0,0,0,0,-60000,0,0,0,29000,89000,-60000,-60000
057307,瀚宇博兆豐99購01,0,0,0,0,0,0,0,0,0,-60000,0,0,0,27000,87000,-60000,-60000
057395,旺宏中信98購03  ,0,0,0,0,0,0,0,0,0,-60000,0,0,0,0,60000,-60000,-60000
058273,同欣電永豐99購01,0,0,0,0,0,0,0,0,0,-60000,0,0,0,0,60000,-60000,-60000
058914,元油2X元富01購02,0,0,0,0,0,0,0,0,0,-60000,0,0,0,0,60000,-60000,-60000
058852,貿聯群益99購04  ,0,0,0,0,0,0,0,0,0,-60000,0,0,0,0,60000,-60000,-60000
057882,華通群益9A購03  ,0,0,0,0,0,0,0,0,0,-60000,0,0,0,20000,80000,-60000,-60000
057865,富邦金凱基98購01,0,0,0,0,0,0,0,0,0,-60000,0,0,0,0,60000,-60000,-60000
059403,T50反1台新03購03,100000,0,100000,0,0,0,0,0,0,-160000,0,0,0,31000,191000,-160000,-60000
060890,大立光統一01購01,0,0,0,0,0,0,0,0,0,-61000,0,0,0,197000,258000,-61000,-61000
060650,奇力新中信9A購01,0,0,0,0,0,0,0,0,0,-61000,0,0,0,47000,108000,-61000,-61000
07418P,聯發科元大99售45,0,0,0,0,0,0,0,0,0,-61000,0,0,0,62000,123000,-61000,-61000
07225P,台積電元大99售33,0,0,0,0,0,0,0,0,0,-61000,0,0,0,55000,116000,-61000,-61000
05252P,華通凱基95售01  ,0,0,0,0,0,0,0,0,0,-61000,0,0,0,0,61000,-61000,-61000
054466,欣興凱基97購03  ,0,0,0,0,0,0,0,0,0,-61000,0,0,0,1000,62000,-61000,-61000
057704,台虹群益98購03  ,0,0,0,0,0,0,0,0,0,-61000,0,0,0,10000,71000,-61000,-61000
057092,健策元富98購01  ,0,0,0,0,0,0,0,0,0,-61000,0,0,0,70000,131000,-61000,-61000
058233,聯發科元大99購06,0,0,0,0,0,0,0,0,0,-61000,0,0,0,1000,62000,-61000,-61000
059153,臺股指國票99購16,0,0,0,0,0,0,0,0,0,-61000,0,0,0,104000,165000,-61000,-61000
056054,亞德客元大97購05,0,0,0,0,0,0,0,0,0,-61000,0,0,0,3000,64000,-61000,-61000
059739,華通元富99購04  ,0,0,0,0,0,0,0,0,0,-61000,0,0,0,50000,111000,-61000,-61000
060085,華通元大99購10  ,0,0,0,0,0,0,0,0,0,-61000,0,0,0,93000,154000,-61000,-61000
2501,國建            ,84800,100000,-15200,0,0,0,0,0,0,-46000,0,46000,-46000,0,0,0,-61200
07175P,聯詠凱基99售02  ,0,0,0,0,0,0,0,0,0,-62000,0,0,0,10000,72000,-62000,-62000
07407P,欣興凱基99售07  ,0,0,0,0,0,0,0,0,0,-62000,0,0,0,9000,71000,-62000,-62000
060892,超眾統一9C購01  ,0,0,0,0,0,0,0,0,0,-62000,0,0,0,0,62000,-62000,-62000
061212,聯鈞元大9A購04  ,0,0,0,0,0,0,0,0,0,-62000,0,0,0,153000,215000,-62000,-62000
058618,南電元大99購02  ,0,0,0,0,0,0,0,0,0,-62000,0,0,0,10000,72000,-62000,-62000
058353,國巨凱基99購09  ,0,0,0,0,0,0,0,0,0,-62000,0,0,0,139000,201000,-62000,-62000
055196,致新元富97購01  ,0,0,0,0,0,0,0,0,0,-62000,0,0,0,80000,142000,-62000,-62000
051898,富邦金國泰97購01,0,0,0,0,0,0,0,0,0,-62000,0,0,0,49000,111000,-62000,-62000
060210,上銀康和9A購01  ,0,0,0,0,0,0,0,0,0,-62000,0,0,0,31000,93000,-62000,-62000
056004,南電永豐97購02  ,0,0,0,0,0,0,0,0,0,-62000,0,0,0,48000,110000,-62000,-62000
05566P,景碩永豐96售01  ,0,0,0,0,0,0,0,0,0,-62000,0,0,0,9000,71000,-62000,-62000
058451,智邦永豐9A購01  ,0,0,0,0,0,0,0,0,0,-62000,0,0,0,0,62000,-62000,-62000
059913,台積電元大99購44,0,0,0,0,0,0,0,0,0,-62000,0,0,0,18000,80000,-62000,-62000
061049,奇力新中信9A購02,0,0,0,0,0,0,0,0,0,-63000,0,0,0,22000,85000,-63000,-63000
060367,緯穎元富9A購02  ,0,0,0,0,0,0,0,0,0,-63000,0,0,0,50000,113000,-63000,-63000
07397P,大立光群益99售10,0,0,0,0,0,0,0,0,0,-63000,0,0,0,5000,68000,-63000,-63000
052191,超眾群益96購01  ,0,0,0,0,0,0,0,0,0,-63000,0,0,0,0,63000,-63000,-63000
052096,力成元大95購01  ,0,0,0,0,0,0,0,0,0,-63000,0,0,0,93000,156000,-63000,-63000
053970,聯發科元大97購08,0,0,0,0,0,0,0,0,0,-63000,0,0,0,0,63000,-63000,-63000
058459,南電永豐99購01  ,0,0,0,0,0,0,0,0,0,-63000,0,0,0,9000,72000,-63000,-63000
058551,義隆永豐99購03  ,0,0,0,0,0,0,0,0,0,-63000,0,0,0,54000,117000,-63000,-63000
057060,緯穎元大98購05  ,0,0,0,0,0,0,0,0,0,-63000,0,0,0,24000,87000,-63000,-63000
058583,臻鼎群益99購01  ,0,0,0,0,0,0,0,0,0,-63000,0,0,0,0,63000,-63000,-63000
057230,建準凱基98購02  ,0,0,0,0,0,0,0,0,0,-63000,0,0,0,81000,144000,-63000,-63000
06005P,晶豪科永豐96售04,0,0,0,0,0,0,0,0,0,-63000,0,0,0,0,63000,-63000,-63000
059688,燿華永豐99購01  ,0,0,0,0,0,0,0,0,0,-63000,0,0,0,41000,104000,-63000,-63000
9934,成霖            ,56000,117000,-61000,0,0,0,0,2000,-2000,0,0,0,0,0,0,0,-63000
3057,喬鼎            ,0,63000,-63000,0,0,0,0,0,0,0,0,0,0,0,0,0,-63000
07614P,華新科群益9A售04,0,0,0,0,0,0,0,0,0,-64000,0,0,0,0,64000,-64000,-64000
1809,中釉            ,45000,109000,-64000,0,0,0,0,0,0,0,0,0,0,0,0,0,-64000
06151P,華新科元大97售07,0,0,0,0,0,0,0,0,0,-64000,0,0,0,80000,144000,-64000,-64000
053595,創意元大96購02  ,0,0,0,0,0,0,0,0,0,-64000,0,0,0,301000,365000,-64000,-64000
058764,康友群益99購01  ,0,0,0,0,0,0,0,0,0,-64000,0,0,0,0,64000,-64000,-64000
1449,佳和            ,20000,85000,-65000,0,0,0,0,0,0,0,0,0,0,0,0,0,-65000
07202P,台灣50凱基9C售04,0,0,0,0,0,0,0,0,0,-65000,0,0,0,84000,149000,-65000,-65000
058322,玉晶光永豐99購02,0,0,0,0,0,0,0,0,0,-65000,0,0,0,0,65000,-65000,-65000
053303,建準凱基96購03  ,0,0,0,0,0,0,0,0,0,-65000,0,0,0,0,65000,-65000,-65000
054768,泰碩國票99購02  ,0,0,0,0,0,0,0,0,0,-65000,0,0,0,33000,98000,-65000,-65000
054933,南港元大97購01  ,0,0,0,0,0,0,0,0,0,-65000,0,0,0,10000,75000,-65000,-65000
052586,晶豪科永豐96購01,0,0,0,0,0,0,0,0,0,-65000,0,0,0,0,65000,-65000,-65000
054130,漢唐元大97購02  ,0,0,0,0,0,0,0,0,0,-65000,0,0,0,45000,110000,-65000,-65000
049436,義隆國泰96購02  ,0,0,0,0,0,0,0,0,0,-65000,0,0,0,15000,80000,-65000,-65000
048189,臺指反元大96購06,0,0,0,0,0,0,0,0,0,-65000,0,0,0,10000,75000,-65000,-65000
058781,康友國票9A購01  ,0,0,0,0,0,0,0,0,0,-65000,0,0,0,32000,97000,-65000,-65000
056962,技嘉永豐98購01  ,0,0,0,0,0,0,0,0,0,-65000,0,0,0,137000,202000,-65000,-65000
060122,亞德客永豐99購02,0,0,0,0,0,0,0,0,0,-65000,0,0,0,1000,66000,-65000,-65000
059581,日月光元富99購02,0,0,0,0,0,0,0,0,0,-65000,0,0,0,47000,112000,-65000,-65000
057569,光磊永豐98購03  ,0,0,0,0,0,0,0,0,0,-65000,0,0,0,78000,143000,-65000,-65000
057279,國揚元大98購01  ,0,0,0,0,0,0,0,0,0,-65000,0,0,0,17000,82000,-65000,-65000
3504,揚明光          ,44000,117000,-73000,0,0,0,0,0,0,8000,10000,2000,8000,0,0,0,-65000
1215,卜蜂            ,123000,185000,-62000,0,0,0,0,1000,-1000,-3000,0,0,0,0,3000,-3000,-66000
2107,厚生            ,79000,138000,-59000,0,0,0,0,6000,-6000,-1000,0,1000,-1000,0,0,0,-66000
060327,美律群益9A購02  ,0,0,0,0,0,0,0,0,0,-66000,0,0,0,0,66000,-66000,-66000
05545P,台表科國泰98售01,0,0,0,0,0,0,0,0,0,-66000,0,0,0,80000,146000,-66000,-66000
053255,貿聯國泰97購01  ,0,0,0,0,0,0,0,0,0,-66000,0,0,0,0,66000,-66000,-66000
057421,智原凱基98購04  ,0,0,0,0,0,0,0,0,0,-66000,0,0,0,0,66000,-66000,-66000
058941,華新科中信99購03,0,0,0,0,0,0,0,0,0,-66000,0,0,0,49000,115000,-66000,-66000
060403,上銀國泰9B購01  ,0,0,0,0,0,0,0,0,0,-67000,0,0,0,159000,226000,-67000,-67000
060383,葡萄王凱基9A購01,0,0,0,0,0,0,0,0,0,-67000,0,0,0,5000,72000,-67000,-67000
060248,日月光元大9A購01,0,0,0,0,0,0,0,0,0,-67000,0,0,0,12000,79000,-67000,-67000
06936P,瑞儀元大98售01  ,0,0,0,0,0,0,0,0,0,-67000,0,0,0,102000,169000,-67000,-67000
06848P,聯詠元大98售04  ,0,0,0,0,0,0,0,0,0,-67000,0,0,0,0,67000,-67000,-67000
056352,鴻海元大99購01  ,0,0,0,0,0,0,0,0,0,-67000,0,0,0,1000,68000,-67000,-67000
057803,上銀元大98購08  ,0,0,0,0,0,0,0,0,0,-67000,0,0,0,48000,115000,-67000,-67000
05509P,智邦元富96售02  ,0,0,0,0,0,0,0,0,0,-67000,0,0,0,18000,85000,-67000,-67000
052693,微星中信96購01  ,0,0,0,0,0,0,0,0,0,-67000,0,0,0,6000,73000,-67000,-67000
00651R,FH香港反1       ,0,46000,-46000,0,0,0,0,0,0,-21000,0,0,0,371000,392000,-21000,-67000
056911,緯穎元大99購01  ,0,0,0,0,0,0,0,0,0,-67000,0,0,0,0,67000,-67000,-67000
060144,全新國票9B購01  ,0,0,0,0,0,0,0,0,0,-67000,0,0,0,39000,106000,-67000,-67000
059830,台郡凱基99購05  ,0,0,0,0,0,0,0,0,0,-67000,0,0,0,21000,88000,-67000,-67000
059909,鴻海元大99購36  ,0,0,0,0,0,0,0,0,0,-67000,0,0,0,0,67000,-67000,-67000
07178P,臺股指凱基99售20,0,0,0,0,0,0,0,0,0,-68000,0,0,0,3000,71000,-68000,-68000
6706,惠特            ,11000,79000,-68000,0,0,0,0,0,0,0,0,0,0,0,0,0,-68000
061110,超眾元大9A購03  ,0,0,0,0,0,0,0,0,0,-68000,0,0,0,24000,92000,-68000,-68000
06240P,奇力新元富97售03,0,0,0,0,0,0,0,0,0,-68000,0,0,0,6000,74000,-68000,-68000
060894,奇力新凱基9A購03,0,0,0,0,0,0,0,0,0,-68000,0,0,0,0,68000,-68000,-68000
049488,智邦元大95購01  ,0,0,0,0,0,0,0,0,0,-68000,0,0,0,0,68000,-68000,-68000
054045,奇力新元大97購03,0,0,0,0,0,0,0,0,0,-68000,0,0,0,0,68000,-68000,-68000
057746,同欣電永豐98購02,0,0,0,0,0,0,0,0,0,-68000,0,0,0,32000,100000,-68000,-68000
053598,日月光元大96購04,0,0,0,0,0,0,0,0,0,-68000,0,0,0,0,68000,-68000,-68000
053374,台達電元大96購03,0,0,0,0,0,0,0,0,0,-68000,0,0,0,0,68000,-68000,-68000
056133,可成元大97購05  ,0,0,0,0,0,0,0,0,0,-68000,0,0,0,1000,69000,-68000,-68000
057874,可成元大99購02  ,0,0,0,0,0,0,0,0,0,-68000,0,0,0,0,68000,-68000,-68000
059437,京鼎元大99購02  ,0,0,0,0,0,0,0,0,0,-68000,0,0,0,4000,72000,-68000,-68000
060329,鎧勝群益9B購01  ,0,0,0,0,0,0,0,0,0,-69000,0,0,0,16000,85000,-69000,-69000
07470P,國巨元大9A售06  ,0,0,0,0,0,0,0,0,0,-69000,0,0,0,27000,96000,-69000,-69000
058337,日月光元富99購01,0,0,0,0,0,0,0,0,0,-69000,0,0,0,74000,143000,-69000,-69000
054280,牧德群益98購01  ,0,0,0,0,0,0,0,0,0,-69000,0,0,0,0,69000,-69000,-69000
058046,國巨元大9A購01  ,0,0,0,0,0,0,0,0,0,-69000,0,0,0,0,69000,-69000,-69000
059353,滬深2X富邦9A購02,0,0,0,0,0,0,0,0,0,-69000,0,0,0,1000,70000,-69000,-69000
07469P,台達電元大9A售01,0,0,0,0,0,0,0,0,0,-70000,0,0,0,5000,75000,-70000,-70000
060365,京鼎元富9A購01  ,0,0,0,0,0,0,0,0,0,-70000,0,0,0,279000,349000,-70000,-70000
060757,台積電元大9A購18,0,0,0,0,0,0,0,0,0,-70000,0,0,0,0,70000,-70000,-70000
054212,聯詠國票97購03  ,0,0,0,0,0,0,0,0,0,-70000,0,0,0,0,70000,-70000,-70000
051234,南電群益95購02  ,0,0,0,0,0,0,0,0,0,-70000,0,0,0,0,70000,-70000,-70000
050383,超眾兆豐95購01  ,0,0,0,0,0,0,0,0,0,-70000,0,0,0,0,70000,-70000,-70000
052702,群創國票97購03  ,0,0,0,0,0,0,0,0,0,-70000,0,0,0,0,70000,-70000,-70000
055092,開發金群益9B購01,0,0,0,0,0,0,0,0,0,-70000,0,0,0,0,70000,-70000,-70000
058146,勤誠元大99購01  ,0,0,0,0,0,0,0,0,0,-70000,0,0,0,20000,90000,-70000,-70000
058468,聯茂中信99購02  ,0,0,0,0,0,0,0,0,0,-70000,0,0,0,30000,100000,-70000,-70000
058877,T50反1國泰9B購01,0,0,0,0,0,0,0,0,0,-70000,0,0,0,55000,125000,-70000,-70000
056561,台光電群益98購02,0,0,0,0,0,0,0,0,0,-70000,0,0,0,92000,162000,-70000,-70000
055743,TPK元富98購01   ,0,0,0,0,0,0,0,0,0,-70000,0,0,0,150000,220000,-70000,-70000
057287,彩晶元大9C購03  ,0,0,0,0,0,0,0,0,0,-70000,0,0,0,30000,100000,-70000,-70000
060202,康友元富9A購01  ,0,0,0,0,0,0,0,0,0,-70000,0,0,0,20000,90000,-70000,-70000
060084,聯電元大99購02  ,0,0,0,0,0,0,0,0,0,-70000,0,0,0,29000,99000,-70000,-70000
060043,全新群益9B購02  ,0,0,0,0,0,0,0,0,0,-70000,0,0,0,16000,86000,-70000,-70000
4737,華廣            ,54000,123000,-69000,0,0,0,0,0,0,-1000,0,1000,-1000,0,0,0,-70000
060948,可成第一9A購01  ,0,0,0,0,0,0,0,0,0,-71000,0,0,0,0,71000,-71000,-71000
060989,國泰金元大9A購02,0,0,0,0,0,0,0,0,0,-71000,0,0,0,68000,139000,-71000,-71000
07351P,鴻海國票99售08  ,0,0,0,0,0,0,0,0,0,-71000,0,0,0,0,71000,-71000,-71000
06867P,訊芯元大98售08  ,0,0,0,0,0,0,0,0,0,-71000,0,0,0,5000,76000,-71000,-71000
055183,聯鈞統一97購01  ,0,0,0,0,0,0,0,0,0,-71000,0,0,0,202000,273000,-71000,-71000
053488,中石化兆豐97購01,0,0,0,0,0,0,0,0,0,-71000,0,0,0,50000,121000,-71000,-71000
049946,智邦兆豐95購01  ,0,0,0,0,0,0,0,0,0,-71000,0,0,0,40000,111000,-71000,-71000
050570,聯發科中信97購02,0,0,0,0,0,0,0,0,0,-71000,0,0,0,0,71000,-71000,-71000
050890,南電富邦99購01  ,0,0,0,0,0,0,0,0,0,-71000,0,0,0,30000,101000,-71000,-71000
052489,義隆國票96購02  ,0,0,0,0,0,0,0,0,0,-71000,0,0,0,4000,75000,-71000,-71000
055730,建準元富97購02  ,0,0,0,0,0,0,0,0,0,-71000,0,0,0,4000,75000,-71000,-71000
057321,台泥群益98購01  ,0,0,0,0,0,0,0,0,0,-71000,0,0,0,3000,74000,-71000,-71000
056449,義隆凱基98購03  ,0,0,0,0,0,0,0,0,0,-71000,0,0,0,45000,116000,-71000,-71000
058604,華邦電元大99購03,0,0,0,0,0,0,0,0,0,-71000,0,0,0,49000,120000,-71000,-71000
059442,祥碩元大99購03  ,0,0,0,0,0,0,0,0,0,-71000,0,0,0,13000,84000,-71000,-71000
07226P,貿聯富邦9B售01  ,0,0,0,0,0,0,0,0,0,-72000,0,0,0,14000,86000,-72000,-72000
061194,聯鈞永豐9A購02  ,0,0,0,0,0,0,0,0,0,-72000,0,0,0,50000,122000,-72000,-72000
061265,富邦金凱基9B購01,0,0,0,0,0,0,0,0,0,-72000,0,0,0,13000,85000,-72000,-72000
053915,光罩國票96購02  ,0,0,0,0,0,0,0,0,0,-72000,0,0,0,0,72000,-72000,-72000
053637,強茂永豐96購01  ,0,0,0,0,0,0,0,0,0,-72000,0,0,0,9000,81000,-72000,-72000
053752,超眾永豐96購02  ,0,0,0,0,0,0,0,0,0,-72000,0,0,0,40000,112000,-72000,-72000
058677,矽格群益99購01  ,0,0,0,0,0,0,0,0,0,-72000,0,0,0,10000,82000,-72000,-72000
056526,力山凱基98購01  ,0,0,0,0,0,0,0,0,0,-72000,0,0,0,125000,197000,-72000,-72000
058738,FBVIX中信03購04 ,0,0,0,0,0,0,0,0,0,-72000,0,0,0,0,72000,-72000,-72000
056104,義隆永豐97購01  ,0,0,0,0,0,0,0,0,0,-72000,0,0,0,13000,85000,-72000,-72000
059371,聯鈞元富99購02  ,0,0,0,0,0,0,0,0,0,-72000,0,0,0,23000,95000,-72000,-72000
059485,台灣50兆豐99購02,0,0,0,0,0,0,0,0,0,-72000,0,0,0,60000,132000,-72000,-72000
4108,懷特            ,7000,79000,-72000,0,0,0,0,0,0,0,0,0,0,0,0,0,-72000
6191,精成科          ,311000,376000,-65000,0,0,0,0,2000,-2000,-5000,0,4000,-4000,0,1000,-1000,-72000
061185,嘉晶國泰9B購01  ,0,0,0,0,0,0,0,0,0,-73000,0,0,0,21000,94000,-73000,-73000
060990,新光金元大9B購03,0,0,0,0,0,0,0,0,0,-73000,0,0,0,23000,96000,-73000,-73000
060870,旭富群益9A購01  ,0,0,0,0,0,0,0,0,0,-73000,0,0,0,75000,148000,-73000,-73000
060473,中租元大9A購03  ,0,0,0,0,0,0,0,0,0,-73000,0,0,0,64000,137000,-73000,-73000
07304P,臺股指元大9A售37,0,0,0,0,0,0,0,0,0,-73000,0,0,0,306000,379000,-73000,-73000
1736,喬山            ,102000,200000,-98000,0,0,0,0,0,0,25000,17000,2000,15000,10000,0,10000,-73000
054082,楠梓電元富96購01,0,0,0,0,0,0,0,0,0,-73000,0,0,0,0,73000,-73000,-73000
057367,技嘉元大98購02  ,0,0,0,0,0,0,0,0,0,-73000,0,0,0,0,73000,-73000,-73000
057523,大成鋼元大99購01,0,0,0,0,0,0,0,0,0,-73000,0,0,0,37000,110000,-73000,-73000
05973P,聯詠元大96售06  ,0,0,0,0,0,0,0,0,0,-73000,0,0,0,4000,77000,-73000,-73000
056847,佐登元富98購01  ,0,0,0,0,0,0,0,0,0,-73000,0,0,0,277000,350000,-73000,-73000
058137,玉晶光元大99購11,0,0,0,0,0,0,0,0,0,-73000,0,0,0,10000,83000,-73000,-73000
058248,聯茂元大99購05  ,0,0,0,0,0,0,0,0,0,-73000,0,0,0,18000,91000,-73000,-73000
059539,緯穎凱基99購03  ,0,0,0,0,0,0,0,0,0,-73000,0,0,0,0,73000,-73000,-73000
00717,富邦美國特別股  ,0,0,0,0,0,0,0,0,0,-73998,0,0,0,573000,646998,-73998,-73998
07643P,禾伸堂凱基9A售02,0,0,0,0,0,0,0,0,0,-74000,0,0,0,15000,89000,-74000,-74000
061158,世芯群益9A購02  ,0,0,0,0,0,0,0,0,0,-74000,0,0,0,58000,132000,-74000,-74000
054376,聯茂中信97購01  ,0,0,0,0,0,0,0,0,0,-74000,0,0,0,80000,154000,-74000,-74000
054778,世紀鋼國票99購01,0,0,0,0,0,0,0,0,0,-74000,0,0,0,19000,93000,-74000,-74000
056910,超眾元大99購02  ,0,0,0,0,0,0,0,0,0,-74000,0,0,0,61000,135000,-74000,-74000
3698,隆達            ,247000,304000,-57000,0,0,0,0,0,0,-17000,10000,27000,-17000,0,0,0,-74000
8404,百和興業-KY     ,53256,124000,-70744,0,0,0,0,0,0,-4000,0,4000,-4000,0,0,0,-74744
2534,宏盛            ,197000,272000,-75000,0,0,0,0,0,0,0,0,0,0,0,0,0,-75000
07435P,台積電富邦9C售07,0,0,0,0,0,0,0,0,0,-75000,0,0,0,22000,97000,-75000,-75000
07424P,大立光元大9B售01,0,0,0,0,0,0,0,0,0,-75000,0,0,0,0,75000,-75000,-75000
060905,台積電元大9A購20,0,0,0,0,0,0,0,0,0,-75000,0,0,0,20000,95000,-75000,-75000
05770P,聯發科凱基96售16,0,0,0,0,0,0,0,0,0,-75000,0,0,0,0,75000,-75000,-75000
051748,超眾國泰96購01  ,0,0,0,0,0,0,0,0,0,-75000,0,0,0,433000,508000,-75000,-75000
056772,欣興元大99購01  ,0,0,0,0,0,0,0,0,0,-75000,0,0,0,36000,111000,-75000,-75000
059578,智邦元富99購02  ,0,0,0,0,0,0,0,0,0,-75000,0,0,0,69000,144000,-75000,-75000
057690,美律凱基99購03  ,0,0,0,0,0,0,0,0,0,-75000,0,0,0,0,75000,-75000,-75000
057407,超眾群益99購01  ,0,0,0,0,0,0,0,0,0,-75000,0,0,0,1000,76000,-75000,-75000
056084,漢唐統一97購03  ,0,0,0,0,0,0,0,0,0,-75000,0,0,0,40000,115000,-75000,-75000
061277,智邦台新9A購01  ,0,0,0,0,0,0,0,0,0,-76000,0,0,0,10000,86000,-76000,-76000
060453,儒鴻元大9A購02  ,0,0,0,0,0,0,0,0,0,-76000,0,0,0,26000,102000,-76000,-76000
060337,FBVIX統一9A購01 ,0,0,0,0,0,0,0,0,0,-76000,0,0,0,43000,119000,-76000,-76000
057712,南亞科統一9A購01,0,0,0,0,0,0,0,0,0,-76000,0,0,0,0,76000,-76000,-76000
9940,信義            ,28000,78511,-50511,0,0,0,0,0,0,-26000,0,26000,-26000,0,0,0,-76511
1110,東泥            ,12000,91000,-79000,0,0,0,0,0,0,2000,2000,0,2000,0,0,0,-77000
07466P,亞德客元大9A售02,0,0,0,0,0,0,0,0,0,-77000,0,0,0,20000,97000,-77000,-77000
06144P,台光電永豐97售01,0,0,0,0,0,0,0,0,0,-77000,0,0,0,0,77000,-77000,-77000
057589,超眾國票9A購01  ,0,0,0,0,0,0,0,0,0,-77000,0,0,0,11000,88000,-77000,-77000
058919,SGBR2X元富99購05,0,0,0,0,0,0,0,0,0,-77000,0,0,0,146000,223000,-77000,-77000
060936,T50反1國票9A購09,0,0,0,0,0,0,0,0,0,-78000,0,0,0,0,78000,-78000,-78000
060713,聯詠永豐9A購01  ,0,0,0,0,0,0,0,0,0,-78000,0,0,0,19000,97000,-78000,-78000
8261,富鼎            ,42000,120000,-78000,0,0,0,0,0,0,0,0,0,0,0,0,0,-78000
8131,福懋科          ,115000,171000,-56000,0,0,0,0,1000,-1000,-21000,0,11000,-11000,2000,12000,-10000,-78000
2457,飛宏            ,29000,97000,-68000,0,0,0,0,0,0,-10000,0,10000,-10000,0,0,0,-78000
057812,友達元大9A購05  ,0,0,0,0,0,0,0,0,0,-78000,0,0,0,277000,355000,-78000,-78000
053865,欣興元大97購02  ,0,0,0,0,0,0,0,0,0,-78000,0,0,0,0,78000,-78000,-78000
054950,奇力新元大98購02,0,0,0,0,0,0,0,0,0,-78000,0,0,0,0,78000,-78000,-78000
052426,國巨台新96購01  ,0,0,0,0,0,0,0,0,0,-78000,0,0,0,50000,128000,-78000,-78000
060164,合勤控永豐9A購01,0,0,0,0,0,0,0,0,0,-78000,0,0,0,0,78000,-78000,-78000
3312,弘憶股          ,15000,93000,-78000,0,0,0,0,0,0,0,0,0,0,0,0,0,-78000
059474,元石油群益99購01,0,0,0,0,0,0,0,0,0,-78000,0,0,0,18000,96000,-78000,-78000
9941,裕融            ,24300,96000,-71700,0,0,0,0,0,0,-7000,0,7000,-7000,0,0,0,-78700
055248,可成統一97購02  ,0,0,0,0,0,0,0,0,0,-79000,0,0,0,1000,80000,-79000,-79000
055153,台光電元大98購02,0,0,0,0,0,0,0,0,0,-79000,0,0,0,6000,85000,-79000,-79000
060194,旭富元富9A購01  ,0,0,0,0,0,0,0,0,0,-79000,0,0,0,31000,110000,-79000,-79000
05895P,奇力新群益96售03,0,0,0,0,0,0,0,0,0,-79000,0,0,0,0,79000,-79000,-79000
06914P,南茂元大98售03  ,0,0,0,0,0,0,0,0,0,-80000,0,0,0,0,80000,-80000,-80000
060742,臺指反國票9B購02,0,0,0,0,0,0,0,0,0,-80000,0,0,0,70000,150000,-80000,-80000
054563,泰碩群益99購01  ,0,0,0,0,0,0,0,0,0,-80000,0,0,0,88000,168000,-80000,-80000
053147,楠梓電元大98購01,0,0,0,0,0,0,0,0,0,-80000,0,0,0,0,80000,-80000,-80000
05206P,南茂元大95售01  ,0,0,0,0,0,0,0,0,0,-80000,0,0,0,0,80000,-80000,-80000
03047X,元展44          ,0,0,0,0,0,0,0,0,0,-80000,0,0,0,0,80000,-80000,-80000
03826P,瀚宇博元大95售01,0,0,0,0,0,0,0,0,0,-80000,0,0,0,0,80000,-80000,-80000
057967,聯發科國泰9A購02,0,0,0,0,0,0,0,0,0,-80000,0,0,0,20000,100000,-80000,-80000
058605,華邦電元大99購04,0,0,0,0,0,0,0,0,0,-80000,0,0,0,30000,110000,-80000,-80000
056105,智原永豐97購01  ,0,0,0,0,0,0,0,0,0,-80000,0,0,0,0,80000,-80000,-80000
056112,勤誠永豐97購02  ,0,0,0,0,0,0,0,0,0,-80000,0,0,0,0,80000,-80000,-80000
05624P,同欣電中信98售01,0,0,0,0,0,0,0,0,0,-80000,0,0,0,0,80000,-80000,-80000
057275,友達元大9A購04  ,0,0,0,0,0,0,0,0,0,-80000,0,0,0,0,80000,-80000,-80000
059359,精元永豐99購01  ,0,0,0,0,0,0,0,0,0,-80000,0,0,0,76000,156000,-80000,-80000
059542,聯發科亞東99購01,0,0,0,0,0,0,0,0,0,-80000,0,0,0,0,80000,-80000,-80000
061127,美食永豐9A購01  ,0,0,0,0,0,0,0,0,0,-81000,0,0,0,27000,108000,-81000,-81000
060791,聯茂富邦9A購02  ,0,0,0,0,0,0,0,0,0,-81000,0,0,0,6000,87000,-81000,-81000
060804,T50反1群益9A購02,0,0,0,0,0,0,0,0,0,-81000,0,0,0,46000,127000,-81000,-81000
061005,可成兆豐9A購01  ,0,0,0,0,0,0,0,0,0,-81000,0,0,0,5000,86000,-81000,-81000
061046,上銀第一9A購01  ,0,0,0,0,0,0,0,0,0,-81000,0,0,0,0,81000,-81000,-81000
061393,緯穎群益9A購01  ,0,0,0,0,0,0,0,0,0,-81000,0,0,0,10000,91000,-81000,-81000
2388,威盛            ,35000,116000,-81000,0,0,0,0,0,0,0,0,0,0,0,0,0,-81000
058584,百和群益9A購01  ,0,0,0,0,0,0,0,0,0,-81000,0,0,0,0,81000,-81000,-81000
058497,新日興群益9B購01,0,0,0,0,0,0,0,0,0,-81000,0,0,0,0,81000,-81000,-81000
05994P,奇鋐元大96售02  ,0,0,0,0,0,0,0,0,0,-81000,0,0,0,20000,101000,-81000,-81000
5871,中租-KY         ,1759000,1801180,-42180,0,0,0,0,2000,-2000,-37000,0,46000,-46000,14000,5000,9000,-81180
2201,裕隆            ,1311000,1417000,-106000,0,0,0,100000,0,100000,-76000,0,76000,-76000,0,0,0,-82000
07559P,祥碩元大9A售03  ,0,0,0,0,0,0,0,0,0,-82000,0,0,0,148000,230000,-82000,-82000
048270,T50反1富邦99購01,0,0,0,0,0,0,0,0,0,-82000,0,0,0,25000,107000,-82000,-82000
055858,聯茂元大97購03  ,0,0,0,0,0,0,0,0,0,-82000,0,0,0,50000,132000,-82000,-82000
060793,微星永豐9A購01  ,0,0,0,0,0,0,0,0,0,-83000,0,0,0,0,83000,-83000,-83000
058569,健策凱基9A購01  ,0,0,0,0,0,0,0,0,0,-83000,0,0,0,22000,105000,-83000,-83000
2841,台開            ,204542,279000,-74458,0,0,0,0,0,0,-9000,0,9000,-9000,0,0,0,-83458
060489,世紀鋼群益9A購01,0,0,0,0,0,0,0,0,0,-84000,0,0,0,0,84000,-84000,-84000
06734P,智邦凱基98售05  ,0,0,0,0,0,0,0,0,0,-84000,0,0,0,12000,96000,-84000,-84000
058590,南電中信9A購02  ,0,0,0,0,0,0,0,0,0,-84000,0,0,0,0,84000,-84000,-84000
059138,台積電兆豐99購04,0,0,0,0,0,0,0,0,0,-84000,0,0,0,0,84000,-84000,-84000
059051,和大凱基9A購01  ,0,0,0,0,0,0,0,0,0,-84000,0,0,0,83000,167000,-84000,-84000
3003,健和興          ,55000,135000,-80000,0,0,0,0,1000,-1000,-3000,0,4000,-4000,1000,0,1000,-84000
059931,緯穎富邦9A購01  ,0,0,0,0,0,0,0,0,0,-84000,0,0,0,30000,114000,-84000,-84000
3535,晶彩科          ,214000,289000,-75000,0,0,0,0,0,0,-9000,0,9000,-9000,0,0,0,-84000
060803,台灣50群益9A購13,0,0,0,0,0,0,0,0,0,-85000,0,0,0,22000,107000,-85000,-85000
060887,台積電統一01購01,0,0,0,0,0,0,0,0,0,-85000,0,0,0,10000,95000,-85000,-85000
061227,日月光中信9B購01,0,0,0,0,0,0,0,0,0,-85000,0,0,0,0,85000,-85000,-85000
061184,大立光國泰9C購01,0,0,0,0,0,0,0,0,0,-85000,0,0,0,0,85000,-85000,-85000
048983,牧德元大95購01  ,0,0,0,0,0,0,0,0,0,-85000,0,0,0,0,85000,-85000,-85000
052324,康友元大96購02  ,0,0,0,0,0,0,0,0,0,-85000,0,0,0,0,85000,-85000,-85000
054742,京鼎凱基99購01  ,0,0,0,0,0,0,0,0,0,-85000,0,0,0,0,85000,-85000,-85000
056596,光磊元富98購01  ,0,0,0,0,0,0,0,0,0,-85000,0,0,0,20000,105000,-85000,-85000
058500,元石油元大9C購01,0,0,0,0,0,0,0,0,0,-85000,0,0,0,0,85000,-85000,-85000
058406,聯茂元大99購06  ,0,0,0,0,0,0,0,0,0,-85000,0,0,0,65000,150000,-85000,-85000
059189,國泰金富邦9B購01,0,0,0,0,0,0,0,0,0,-85000,0,0,0,3000,88000,-85000,-85000
058185,國巨永豐99購01  ,0,0,0,0,0,0,0,0,0,-85000,0,0,0,50000,135000,-85000,-85000
058281,奇力新中信99購01,0,0,0,0,0,0,0,0,0,-85000,0,0,0,0,85000,-85000,-85000
060119,上銀富邦9B購03  ,0,0,0,0,0,0,0,0,0,-85000,0,0,0,315000,400000,-85000,-85000
059991,超眾元大9A購02  ,0,0,0,0,0,0,0,0,0,-85000,0,0,0,7000,92000,-85000,-85000
057531,禾伸堂元大99購04,0,0,0,0,0,0,0,0,0,-85000,0,0,0,111000,196000,-85000,-85000
5288,豐祥-KY         ,49000,127000,-78000,0,0,0,0,7000,-7000,0,0,0,0,0,0,0,-85000
060811,亞德客凱基9A購02,0,0,0,0,0,0,0,0,0,-86000,0,0,0,3000,89000,-86000,-86000
061040,康友永豐9A購01  ,0,0,0,0,0,0,0,0,0,-86000,0,0,0,84000,170000,-86000,-86000
060478,南電元大9A購01  ,0,0,0,0,0,0,0,0,0,-86000,0,0,0,11000,97000,-86000,-86000
07560P,台積電國泰9B售01,0,0,0,0,0,0,0,0,0,-86000,0,0,0,143000,229000,-86000,-86000
07509P,牧德國票9A售03  ,0,0,0,0,0,0,0,0,0,-86000,0,0,0,21000,107000,-86000,-86000
07710P,華擎元大9A售05  ,0,0,0,0,0,0,0,0,0,-86000,0,0,0,20000,106000,-86000,-86000
1528,恩德            ,1000,83000,-82000,0,0,0,0,0,0,-4000,0,4000,-4000,0,0,0,-86000
053312,緯穎凱基96購02  ,0,0,0,0,0,0,0,0,0,-86000,0,0,0,25000,111000,-86000,-86000
058684,健策凱基99購02  ,0,0,0,0,0,0,0,0,0,-86000,0,0,0,10000,96000,-86000,-86000
058327,大毅統一9B購01  ,0,0,0,0,0,0,0,0,0,-86000,0,0,0,97000,183000,-86000,-86000
052590,祥碩永豐96購01  ,0,0,0,0,0,0,0,0,0,-86000,0,0,0,11000,97000,-86000,-86000
051736,旺宏國票96購01  ,0,0,0,0,0,0,0,0,0,-86000,0,0,0,120000,206000,-86000,-86000
048628,T50反1元大96購03,0,0,0,0,0,0,0,0,0,-86000,0,0,0,0,86000,-86000,-86000
00646,元大S&P500      ,2000,3000,-1000,0,0,0,0,0,0,-85000,0,0,0,106000,191000,-85000,-86000
050588,矽創國票95購01  ,0,0,0,0,0,0,0,0,0,-86000,0,0,0,0,86000,-86000,-86000
05758P,光罩永豐96售02  ,0,0,0,0,0,0,0,0,0,-86000,0,0,0,0,86000,-86000,-86000
059957,中信金康和99購01,0,0,0,0,0,0,0,0,0,-86000,0,0,0,92000,178000,-86000,-86000
07022P,嘉晶永豐99售02  ,0,0,0,0,0,0,0,0,0,-87000,0,0,0,0,87000,-87000,-87000
060240,富邦金元大9A購01,0,0,0,0,0,0,0,0,0,-87000,0,0,0,83000,170000,-87000,-87000
053513,義隆群益96購05  ,0,0,0,0,0,0,0,0,0,-87000,0,0,0,67000,154000,-87000,-87000
054471,T50反1中信9C購01,0,0,0,0,0,0,0,0,0,-87000,0,0,0,5000,92000,-87000,-87000
055951,大成鋼元大97購02,0,0,0,0,0,0,0,0,0,-87000,0,0,0,13000,100000,-87000,-87000
057295,可成永豐98購02  ,0,0,0,0,0,0,0,0,0,-87000,0,0,0,6000,93000,-87000,-87000
056686,可成統一98購01  ,0,0,0,0,0,0,0,0,0,-87000,0,0,0,34000,121000,-87000,-87000
060878,奇力新中信9C購01,0,0,0,0,0,0,0,0,0,-88000,0,0,0,12000,100000,-88000,-88000
061272,超眾凱基9A購03  ,0,0,0,0,0,0,0,0,0,-88000,0,0,0,0,88000,-88000,-88000
07670P,茂林元大9A售02  ,0,0,0,0,0,0,0,0,0,-88000,0,0,0,42000,130000,-88000,-88000
048870,義隆國票96購01  ,0,0,0,0,0,0,0,0,0,-88000,0,0,0,0,88000,-88000,-88000
051926,聯電中信97購01  ,0,0,0,0,0,0,0,0,0,-88000,0,0,0,0,88000,-88000,-88000
058847,國巨群益99購05  ,0,0,0,0,0,0,0,0,0,-88000,0,0,0,56000,144000,-88000,-88000
3060,銘異            ,93000,180000,-87000,0,0,0,0,0,0,-1000,0,1000,-1000,0,0,0,-88000
06172P,台虹永豐97售02  ,0,0,0,0,0,0,0,0,0,-89000,0,0,0,0,89000,-89000,-89000
060418,中橡永豐9A購01  ,0,0,0,0,0,0,0,0,0,-89000,0,0,0,0,89000,-89000,-89000
057240,茂林凱基9A購01  ,0,0,0,0,0,0,0,0,0,-89000,0,0,0,205000,294000,-89000,-89000
059951,台塑康和99購01  ,0,0,0,0,0,0,0,0,0,-89000,0,0,0,0,89000,-89000,-89000
9802,鈺齊-KY         ,200000,232000,-32000,0,0,0,44000,85000,-41000,-16000,1000,5000,-4000,2000,14000,-12000,-89000
059432,聯發科元大99購26,0,0,0,0,0,0,0,0,0,-89000,0,0,0,10000,99000,-89000,-89000
060545,台積電凱基9B購02,0,0,0,0,0,0,0,0,0,-90000,0,0,0,12000,102000,-90000,-90000
060891,世芯統一9A購01  ,0,0,0,0,0,0,0,0,0,-90000,0,0,0,71000,161000,-90000,-90000
061070,超眾凱基9C購01  ,0,0,0,0,0,0,0,0,0,-90000,0,0,0,1000,91000,-90000,-90000
2101,南港            ,198000,277000,-79000,0,0,0,0,0,0,-11000,3000,24000,-21000,45000,35000,10000,-90000
2328,廣宇            ,235000,272000,-37000,0,0,0,0,3000,-3000,-50000,0,36000,-36000,0,14000,-14000,-90000
07341P,台積電凱基99售18,0,0,0,0,0,0,0,0,0,-90000,0,0,0,75000,165000,-90000,-90000
054685,國巨永豐97購02  ,0,0,0,0,0,0,0,0,0,-90000,0,0,0,0,90000,-90000,-90000
052685,技嘉元大96購01  ,0,0,0,0,0,0,0,0,0,-90000,0,0,0,0,90000,-90000,-90000
053806,鎧勝凱基96購02  ,0,0,0,0,0,0,0,0,0,-90000,0,0,0,10000,100000,-90000,-90000
057225,華新凱基98購01  ,0,0,0,0,0,0,0,0,0,-90000,0,0,0,11000,101000,-90000,-90000
055803,鎧勝永豐97購01  ,0,0,0,0,0,0,0,0,0,-90000,0,0,0,17000,107000,-90000,-90000
055763,鎧勝群益97購01  ,0,0,0,0,0,0,0,0,0,-90000,0,0,0,120000,210000,-90000,-90000
057651,矽力元大98購03  ,0,0,0,0,0,0,0,0,0,-90000,0,0,0,41000,131000,-90000,-90000
058102,楠梓電永豐98購04,0,0,0,0,0,0,0,0,0,-90000,0,0,0,25000,115000,-90000,-90000
2637,慧洋-KY         ,180000,257000,-77000,0,0,0,0,0,0,-13000,0,13000,-13000,0,0,0,-90000
6414,樺漢            ,97000,154000,-57000,0,0,0,0,0,0,-33000,4000,26000,-22000,0,11000,-11000,-90000
061031,神隆永豐9A購02  ,0,0,0,0,0,0,0,0,0,-91000,0,0,0,0,91000,-91000,-91000
061233,國巨元大9A購17  ,0,0,0,0,0,0,0,0,0,-91000,0,0,0,0,91000,-91000,-91000
061175,台積電凱基9A購19,0,0,0,0,0,0,0,0,0,-91000,0,0,0,11000,102000,-91000,-91000
058007,南電群益98購02  ,0,0,0,0,0,0,0,0,0,-91000,0,0,0,3000,94000,-91000,-91000
059179,祥碩元富99購01  ,0,0,0,0,0,0,0,0,0,-91000,0,0,0,120000,211000,-91000,-91000
058803,世紀鋼元大99購03,0,0,0,0,0,0,0,0,0,-91000,0,0,0,0,91000,-91000,-91000
057876,隆達元大98購01  ,0,0,0,0,0,0,0,0,0,-91000,0,0,0,0,91000,-91000,-91000
058512,宏達電元大99購04,0,0,0,0,0,0,0,0,0,-91000,0,0,0,68000,159000,-91000,-91000
061223,T50反1中信01購01,0,0,0,0,0,0,0,0,0,-92000,0,0,0,2000,94000,-92000,-92000
07189P,聯發科富邦9B售03,0,0,0,0,0,0,0,0,0,-92000,0,0,0,169000,261000,-92000,-92000
054807,台化元大9A購02  ,0,0,0,0,0,0,0,0,0,-92000,0,0,0,0,92000,-92000,-92000
048576,義隆國泰95購01  ,0,0,0,0,0,0,0,0,0,-92000,0,0,0,63000,155000,-92000,-92000
050641,上証反凱基96購01,0,0,0,0,0,0,0,0,0,-92000,0,0,0,0,92000,-92000,-92000
3607,谷崧            ,11000,103000,-92000,0,0,0,0,0,0,0,0,0,0,0,0,0,-92000
2851,中再保          ,7000,90000,-83000,0,0,0,0,0,0,-9000,0,9000,-9000,0,0,0,-92000
059564,鴻海凱基9A購15  ,0,0,0,0,0,0,0,0,0,-92000,0,0,0,3000,95000,-92000,-92000
059822,聯發科凱基99購19,0,0,0,0,0,0,0,0,0,-92000,0,0,0,47000,139000,-92000,-92000
2485,兆赫            ,127000,203000,-76000,0,0,0,0,0,0,-17000,0,17000,-17000,0,0,0,-93000
07690P,華新科元大9A售15,0,0,0,0,0,0,0,0,0,-93000,0,0,0,0,93000,-93000,-93000
060472,中租元大9A購02  ,0,0,0,0,0,0,0,0,0,-93000,0,0,0,41000,134000,-93000,-93000
056697,緯穎群益98購01  ,0,0,0,0,0,0,0,0,0,-93000,0,0,0,0,93000,-93000,-93000
055710,亞德客元大97購03,0,0,0,0,0,0,0,0,0,-93000,0,0,0,114000,207000,-93000,-93000
059859,國巨群益9A購03  ,0,0,0,0,0,0,0,0,0,-93000,0,0,0,7000,100000,-93000,-93000
07516P,台積電元大9A售16,0,0,0,0,0,0,0,0,0,-94000,0,0,0,0,94000,-94000,-94000
055665,亞德客群益97購01,0,0,0,0,0,0,0,0,0,-94000,0,0,0,2000,96000,-94000,-94000
059744,禾伸堂元富99購02,0,0,0,0,0,0,0,0,0,-94000,0,0,0,94000,188000,-94000,-94000
060262,臺股指凱基9B購02,0,0,0,0,0,0,0,0,0,-95000,0,0,0,122000,217000,-95000,-95000
057916,國巨凱基98購13  ,0,0,0,0,0,0,0,0,0,-95000,0,0,0,59000,154000,-95000,-95000
059144,嘉晶國票9A購02  ,0,0,0,0,0,0,0,0,0,-95000,0,0,0,10000,105000,-95000,-95000
057006,國巨中信98購03  ,0,0,0,0,0,0,0,0,0,-95000,0,0,0,0,95000,-95000,-95000
060949,祥碩中信9A購01  ,0,0,0,0,0,0,0,0,0,-96000,0,0,0,32000,128000,-96000,-96000
07163P,臺股指群益99售14,0,0,0,0,0,0,0,0,0,-96000,0,0,0,26000,122000,-96000,-96000
03648C,T50反1元大96牛07,0,0,0,0,0,0,0,0,0,-96000,0,0,0,2000,98000,-96000,-96000
051918,聯茂元大95購01  ,0,0,0,0,0,0,0,0,0,-96000,0,0,0,16000,112000,-96000,-96000
058051,同欣電元大98購03,0,0,0,0,0,0,0,0,0,-96000,0,0,0,0,96000,-96000,-96000
059036,可成群益9B購03  ,0,0,0,0,0,0,0,0,0,-96000,0,0,0,59000,155000,-96000,-96000
059993,上銀元富99購01  ,0,0,0,0,0,0,0,0,0,-96000,0,0,0,34000,130000,-96000,-96000
056094,大立光元富97購03,0,0,0,0,0,0,0,0,0,-96000,0,0,0,2000,98000,-96000,-96000
5607,遠雄港          ,77000,173000,-96000,0,0,0,0,0,0,0,0,0,0,0,0,0,-96000
07145P,為升元大99售03  ,0,0,0,0,0,0,0,0,0,-97000,0,0,0,13000,110000,-97000,-97000
07641P,上銀凱基9A售05  ,0,0,0,0,0,0,0,0,0,-97000,0,0,0,28000,125000,-97000,-97000
2006,東和鋼鐵        ,97000,112000,-15000,0,0,0,0,1000,-1000,-81000,0,81000,-81000,0,0,0,-97000
2536,宏普            ,11000,77000,-66000,0,0,0,0,31000,-31000,0,0,0,0,0,0,0,-97000
060710,上銀永豐9A購01  ,0,0,0,0,0,0,0,0,0,-97000,0,0,0,5000,102000,-97000,-97000
060362,建準元富9A購02  ,0,0,0,0,0,0,0,0,0,-97000,0,0,0,0,97000,-97000,-97000
058311,緯穎元大99購05  ,0,0,0,0,0,0,0,0,0,-97000,0,0,0,10000,107000,-97000,-97000
056954,聯詠富邦9A購01  ,0,0,0,0,0,0,0,0,0,-97000,0,0,0,23000,120000,-97000,-97000
060379,T50反1凱基9A購07,0,0,0,0,0,0,0,0,0,-98000,0,0,0,47000,145000,-98000,-98000
060434,台汽電永豐9A購01,0,0,0,0,0,0,0,0,0,-98000,0,0,0,38000,136000,-98000,-98000
054458,復盛群益96購01  ,0,0,0,0,0,0,0,0,0,-98000,0,0,0,0,98000,-98000,-98000
054502,泰碩永豐96購01  ,0,0,0,0,0,0,0,0,0,-98000,0,0,0,89000,187000,-98000,-98000
051607,緯創群益96購02  ,0,0,0,0,0,0,0,0,0,-98000,0,0,0,0,98000,-98000,-98000
057460,楠梓電永豐98購03,0,0,0,0,0,0,0,0,0,-98000,0,0,0,44000,142000,-98000,-98000
059624,鴻海凱基01購01  ,0,0,0,0,0,0,0,0,0,-98000,0,0,0,2000,100000,-98000,-98000
059685,T50正2永豐99購02,0,0,0,0,0,0,0,0,0,-98000,0,0,0,11000,109000,-98000,-98000
060660,國巨凱基9B購04  ,0,0,0,0,0,0,0,0,0,-99000,0,0,0,1000,100000,-99000,-99000
060260,京鼎凱基9C購01  ,10000,0,10000,0,0,0,0,0,0,-109000,0,0,0,168000,277000,-109000,-99000
052216,康友元大96購01  ,0,0,0,0,0,0,0,0,0,-99000,0,0,0,0,99000,-99000,-99000
049501,台郡元大95購01  ,0,0,0,0,0,0,0,0,0,-99000,0,0,0,0,99000,-99000,-99000
049972,南電國票95購02  ,0,0,0,0,0,0,0,0,0,-99000,0,0,0,48000,147000,-99000,-99000
059200,京鼎永豐99購02  ,0,0,0,0,0,0,0,0,0,-99000,0,0,0,269000,368000,-99000,-99000
056511,超眾永豐98購01  ,0,0,0,0,0,0,0,0,0,-99000,0,0,0,20000,119000,-99000,-99000
058851,大立光群益99購07,0,0,0,0,0,0,0,0,0,-99000,0,0,0,0,99000,-99000,-99000
058849,奇力新群益99購02,0,0,0,0,0,0,0,0,0,-99000,0,0,0,0,99000,-99000,-99000
4551,智伸科          ,50000,156000,-106000,0,0,0,0,0,0,7000,6000,1000,5000,3000,1000,2000,-99000
060243,潤泰全元大9C購02,0,0,0,0,0,0,0,0,0,-100000,0,0,0,0,100000,-100000,-100000
061271,聯茂凱基9A購04  ,0,0,0,0,0,0,0,0,0,-100000,0,0,0,0,100000,-100000,-100000
07742P,台積電凱基9A售25,0,0,0,0,0,0,0,0,0,-100000,0,0,0,0,100000,-100000,-100000
07421P,國泰金元大99售01,0,0,0,0,0,0,0,0,0,-100000,0,0,0,20000,120000,-100000,-100000
07444P,聯發科凱基9A售10,0,0,0,0,0,0,0,0,0,-100000,0,0,0,0,100000,-100000,-100000
07409P,台積電台新99售07,0,0,0,0,0,0,0,0,0,-100000,0,0,0,20000,120000,-100000,-100000
07106P,國巨統一9B售05  ,0,0,0,0,0,0,0,0,0,-100000,0,0,0,0,100000,-100000,-100000
06525P,上証2X國泰99售01,0,0,0,0,0,0,0,0,0,-100000,0,0,0,10000,110000,-100000,-100000
06864P,健策凱基98售01  ,0,0,0,0,0,0,0,0,0,-100000,0,0,0,25000,125000,-100000,-100000
06822P,上銀富邦99售03  ,0,0,0,0,0,0,0,0,0,-100000,0,0,0,0,100000,-100000,-100000
050306,聯發科中信97購01,0,0,0,0,0,0,0,0,0,-100000,0,0,0,0,100000,-100000,-100000
050778,瑞儀元大96購01  ,0,0,0,0,0,0,0,0,0,-100000,0,0,0,0,100000,-100000,-100000
047680,上証反中信96購01,0,0,0,0,0,0,0,0,0,-100000,0,0,0,200000,300000,-100000,-100000
049539,元油2X群益9A購01,0,0,0,0,0,0,0,0,0,-100000,0,0,0,0,100000,-100000,-100000
052163,康舒永豐95購02  ,0,0,0,0,0,0,0,0,0,-100000,0,0,0,0,100000,-100000,-100000
051738,全新國票96購02  ,0,0,0,0,0,0,0,0,0,-100000,0,0,0,0,100000,-100000,-100000
050902,南電元大96購01  ,0,0,0,0,0,0,0,0,0,-100000,0,0,0,68000,168000,-100000,-100000
055435,佳世達中信99購01,0,0,0,0,0,0,0,0,0,-100000,0,0,0,0,100000,-100000,-100000
052838,新唐國泰98購01  ,0,0,0,0,0,0,0,0,0,-100000,0,0,0,0,100000,-100000,-100000
058760,嘉晶群益9A購01  ,0,0,0,0,0,0,0,0,0,-100000,0,0,0,0,100000,-100000,-100000
057032,A50反1元大9B購01,0,0,0,0,0,0,0,0,0,-100000,0,0,0,0,100000,-100000,-100000
058141,嘉聯益元大99購05,0,0,0,0,0,0,0,0,0,-100000,0,0,0,0,100000,-100000,-100000
059159,上銀凱基99購05  ,0,0,0,0,0,0,0,0,0,-100000,0,0,0,0,100000,-100000,-100000
055725,嘉聯益元大98購03,0,0,0,0,0,0,0,0,0,-100000,0,0,0,0,100000,-100000,-100000
056023,晶豪科群益97購01,0,0,0,0,0,0,0,0,0,-100000,0,0,0,33000,133000,-100000,-100000
05763P,致新永豐96售01  ,0,0,0,0,0,0,0,0,0,-100000,0,0,0,0,100000,-100000,-100000
058205,神達凱基9B購01  ,0,0,0,0,0,0,0,0,0,-100000,0,0,0,0,100000,-100000,-100000
057577,廣宇中信9A購01  ,0,0,0,0,0,0,0,0,0,-100000,0,0,0,0,100000,-100000,-100000
3056,總太            ,54000,151000,-97000,0,0,0,0,3000,-3000,0,0,0,0,0,0,0,-100000
060227,和大元大9A購01  ,0,0,0,0,0,0,0,0,0,-101000,0,0,0,95000,196000,-101000,-101000
055359,超眾凱基97購01  ,0,0,0,0,0,0,0,0,0,-101000,0,0,0,37000,138000,-101000,-101000
054546,玉晶光中信9B購01,0,0,0,0,0,0,0,0,0,-101000,0,0,0,42000,143000,-101000,-101000
051594,和碩元大96購01  ,0,0,0,0,0,0,0,0,0,-101000,0,0,0,14000,115000,-101000,-101000
2049,上銀            ,1832134,2099103,-266969,0,0,0,146000,0,146000,19000,32000,2000,30000,29000,40000,-11000,-101969
07006P,旺宏統一9B售03  ,0,0,0,0,0,0,0,0,0,-102000,0,0,0,5000,107000,-102000,-102000
07456P,華新科元大9A售06,0,0,0,0,0,0,0,0,0,-102000,0,0,0,0,102000,-102000,-102000
049706,世紀鋼元大95購02,0,0,0,0,0,0,0,0,0,-102000,0,0,0,8000,110000,-102000,-102000
056599,臻鼎元富98購01  ,0,0,0,0,0,0,0,0,0,-102000,0,0,0,141000,243000,-102000,-102000
07642P,華通凱基9A售05  ,0,0,0,0,0,0,0,0,0,-103000,0,0,0,0,103000,-103000,-103000
052560,康舒國票97購01  ,0,0,0,0,0,0,0,0,0,-103000,0,0,0,0,103000,-103000,-103000
055729,金寶元富99購01  ,0,0,0,0,0,0,0,0,0,-103000,0,0,0,2000,105000,-103000,-103000
057398,台郡中信99購01  ,0,0,0,0,0,0,0,0,0,-103000,0,0,0,0,103000,-103000,-103000
2849,安泰銀          ,0,99000,-99000,0,0,0,0,0,0,-4000,0,4000,-4000,0,0,0,-103000
2062,橋椿            ,12000,112000,-100000,0,0,0,0,0,0,-4000,0,4000,-4000,0,0,0,-104000
07649P,金像電永豐9A售02,0,0,0,0,0,0,0,0,0,-104000,0,0,0,40000,144000,-104000,-104000
059202,禾聯碩永豐99購01,0,0,0,0,0,0,0,0,0,-104000,0,0,0,0,104000,-104000,-104000
056116,義隆群益97購02  ,0,0,0,0,0,0,0,0,0,-104000,0,0,0,38000,142000,-104000,-104000
055814,晶豪科國票97購02,0,0,0,0,0,0,0,0,0,-104000,0,0,0,19000,123000,-104000,-104000
057931,正崴群益98購02  ,0,0,0,0,0,0,0,0,0,-104000,0,0,0,0,104000,-104000,-104000
2923,鼎固-KY         ,0,101000,-101000,0,0,0,0,0,0,-3000,0,3000,-3000,0,0,0,-104000
8996,高力            ,276000,365000,-89000,0,0,0,0,15000,-15000,0,1000,1000,0,0,0,0,-104000
061356,南電元大9A購06  ,1000,0,1000,0,0,0,0,0,0,-106000,0,0,0,0,106000,-106000,-105000
061006,新光金兆豐9A購01,0,0,0,0,0,0,0,0,0,-105000,0,0,0,4000,109000,-105000,-105000
060921,中橡永豐9A購02  ,0,0,0,0,0,0,0,0,0,-105000,0,0,0,21000,126000,-105000,-105000
051572,上銀元大95購01  ,0,0,0,0,0,0,0,0,0,-105000,0,0,0,0,105000,-105000,-105000
058929,可成統一9C購01  ,0,0,0,0,0,0,0,0,0,-105000,0,0,0,6000,111000,-105000,-105000
058532,禾伸堂元富99購01,0,0,0,0,0,0,0,0,0,-105000,0,0,0,195000,300000,-105000,-105000
060385,台勝科凱基9A購01,55000,0,55000,0,0,0,0,0,0,-161000,0,0,0,181000,342000,-161000,-106000
07499P,台積電元大9A售12,0,0,0,0,0,0,0,0,0,-106000,0,0,0,0,106000,-106000,-106000
059723,美律元大9A購02  ,0,0,0,0,0,0,0,0,0,-106000,0,0,0,5000,111000,-106000,-106000
059932,世紀鋼富邦9A購02,0,0,0,0,0,0,0,0,0,-106000,0,0,0,0,106000,-106000,-106000
07389P,臺股指群益9C售08,0,0,0,0,0,0,0,0,0,-107000,0,0,0,0,107000,-107000,-107000
060355,元金2X元富9C購01,0,0,0,0,0,0,0,0,0,-107000,0,0,0,89000,196000,-107000,-107000
061244,和碩兆豐9A購01  ,0,0,0,0,0,0,0,0,0,-107000,0,0,0,0,107000,-107000,-107000
054801,康友群益97購02  ,0,0,0,0,0,0,0,0,0,-107000,0,0,0,0,107000,-107000,-107000
057298,旭富永豐98購01  ,0,0,0,0,0,0,0,0,0,-107000,0,0,0,52000,159000,-107000,-107000
059040,訊芯群益99購03  ,0,0,0,0,0,0,0,0,0,-107000,0,0,0,36000,143000,-107000,-107000
6668,中揚光          ,50000,158000,-108000,0,0,0,0,0,0,0,0,0,0,0,0,0,-108000
055297,啟碁元大97購01  ,0,0,0,0,0,0,0,0,0,-108000,0,0,0,0,108000,-108000,-108000
057498,台郡元大98購04  ,0,0,0,0,0,0,0,0,0,-108000,0,0,0,0,108000,-108000,-108000
07088P,訊芯永豐99售02  ,0,0,0,0,0,0,0,0,0,-109000,0,0,0,2000,111000,-109000,-109000
06949P,台表科元大99售01,0,0,0,0,0,0,0,0,0,-109000,0,0,0,20000,129000,-109000,-109000
06594P,立積元大98售01  ,0,0,0,0,0,0,0,0,0,-109000,0,0,0,22000,131000,-109000,-109000
060252,緯穎元大9A購02  ,0,0,0,0,0,0,0,0,0,-109000,0,0,0,21000,130000,-109000,-109000
060529,聯發科中信9A購04,0,0,0,0,0,0,0,0,0,-109000,0,0,0,165000,274000,-109000,-109000
055407,祥碩國泰98購01  ,0,0,0,0,0,0,0,0,0,-109000,0,0,0,70000,179000,-109000,-109000
048788,華新科元大95購02,0,0,0,0,0,0,0,0,0,-109000,0,0,0,5000,114000,-109000,-109000
056237,智邦群益97購02  ,0,0,0,0,0,0,0,0,0,-109000,0,0,0,2000,111000,-109000,-109000
058765,緯穎群益99購03  ,0,0,0,0,0,0,0,0,0,-109000,0,0,0,0,109000,-109000,-109000
060456,正隆元大9A購01  ,0,0,0,0,0,0,0,0,0,-110000,0,0,0,83000,193000,-110000,-110000
061264,全新凱基9B購01  ,0,0,0,0,0,0,0,0,0,-110000,0,0,0,0,110000,-110000,-110000
060961,台光電凱基9A購03,0,0,0,0,0,0,0,0,0,-110000,0,0,0,11000,121000,-110000,-110000
07181P,臺股指凱基99售23,0,0,0,0,0,0,0,0,0,-110000,0,0,0,4000,114000,-110000,-110000
07401P,台積電凱基99售21,0,0,0,0,0,0,0,0,0,-110000,0,0,0,0,110000,-110000,-110000
07721P,台積電凱基9A售22,0,0,0,0,0,0,0,0,0,-110000,0,0,0,0,110000,-110000,-110000
057903,聯鈞永豐99購01  ,0,0,0,0,0,0,0,0,0,-110000,0,0,0,58000,168000,-110000,-110000
058739,喬山中信99購01  ,0,0,0,0,0,0,0,0,0,-110000,0,0,0,0,110000,-110000,-110000
05760P,京鼎永豐96售02  ,0,0,0,0,0,0,0,0,0,-110000,0,0,0,0,110000,-110000,-110000
05993P,國巨元大96售13  ,0,0,0,0,0,0,0,0,0,-110000,0,0,0,0,110000,-110000,-110000
2023,燁輝            ,94684,179000,-84316,0,0,0,0,0,0,-26000,0,26000,-26000,0,0,0,-110316
06611P,祥碩國票98售01  ,0,0,0,0,0,0,0,0,0,-111000,0,0,0,65000,176000,-111000,-111000
060392,華擎群益9C購02  ,0,0,0,0,0,0,0,0,0,-111000,0,0,0,5000,116000,-111000,-111000
060167,禾聯碩永豐9A購01,0,0,0,0,0,0,0,0,0,-111000,0,0,0,0,111000,-111000,-111000
06208P,台郡凱基97售03  ,0,0,0,0,0,0,0,0,0,-112000,0,0,0,0,112000,-112000,-112000
07714P,世紀鋼元大9A售03,0,0,0,0,0,0,0,0,0,-112000,0,0,0,0,112000,-112000,-112000
05152P,玉晶光群益96售05,0,0,0,0,0,0,0,0,0,-112000,0,0,0,34000,146000,-112000,-112000
053352,義隆兆豐96購01  ,0,0,0,0,0,0,0,0,0,-112000,0,0,0,27000,139000,-112000,-112000
1802,台玻            ,275889,283000,-7111,0,0,0,0,0,0,-105000,0,105000,-105000,0,0,0,-112111
06493P,聯發科永豐98售02,0,0,0,0,0,0,0,0,0,-113000,0,0,0,3000,116000,-113000,-113000
06246P,茂林元富97售03  ,0,0,0,0,0,0,0,0,0,-113000,0,0,0,80000,193000,-113000,-113000
055021,亞德客國泰98購01,0,0,0,0,0,0,0,0,0,-113000,0,0,0,5000,118000,-113000,-113000
059733,緯穎元大99購08  ,0,0,0,0,0,0,0,0,0,-113000,0,0,0,40000,153000,-113000,-113000
057048,新日興元大98購01,0,0,0,0,0,0,0,0,0,-113000,0,0,0,0,113000,-113000,-113000
6139,亞翔            ,40000,149000,-109000,0,0,0,0,3000,-3000,-1000,0,1000,-1000,0,0,0,-113000
07691P,宏達電元大9A售05,0,0,0,0,0,0,0,0,0,-114000,0,0,0,0,114000,-114000,-114000
2530,華建            ,7000,121000,-114000,0,0,0,0,0,0,0,0,0,0,0,0,0,-114000
055232,泰碩國票98購01  ,0,0,0,0,0,0,0,0,0,-114000,0,0,0,60000,174000,-114000,-114000
054018,華新台新96購01  ,0,0,0,0,0,0,0,0,0,-114000,0,0,0,0,114000,-114000,-114000
03670C,元油2X元富99牛01,0,0,0,0,0,0,0,0,0,-114000,0,0,0,0,114000,-114000,-114000
057329,緯穎群益98購02  ,0,0,0,0,0,0,0,0,0,-114000,0,0,0,0,114000,-114000,-114000
057378,康友元大98購02  ,0,0,0,0,0,0,0,0,0,-114000,0,0,0,0,114000,-114000,-114000
057428,正崴兆豐98購01  ,0,0,0,0,0,0,0,0,0,-114000,0,0,0,6000,120000,-114000,-114000
1476,儒鴻            ,312000,455550,-143550,0,0,0,30000,1000,29000,0,6000,2000,4000,1000,5000,-4000,-114550
07653P,華新科群益9A售05,0,0,0,0,0,0,0,0,0,-115000,0,0,0,1000,116000,-115000,-115000
07570P,旺宏凱基9A售04  ,0,0,0,0,0,0,0,0,0,-115000,0,0,0,0,115000,-115000,-115000
061215,健策元大9A購06  ,0,0,0,0,0,0,0,0,0,-115000,0,0,0,22000,137000,-115000,-115000
053956,旺宏永豐96購04  ,0,0,0,0,0,0,0,0,0,-115000,0,0,0,0,115000,-115000,-115000
054786,全新群益99購02  ,0,0,0,0,0,0,0,0,0,-115000,0,0,0,0,115000,-115000,-115000
058653,光寶科中信9A購01,0,0,0,0,0,0,0,0,0,-115000,0,0,0,142000,257000,-115000,-115000
057638,上銀元大99購01  ,0,0,0,0,0,0,0,0,0,-115000,0,0,0,0,115000,-115000,-115000
059173,矽力凱基99購01  ,0,0,0,0,0,0,0,0,0,-115000,0,0,0,15000,130000,-115000,-115000
058759,義隆群益99購01  ,0,0,0,0,0,0,0,0,0,-115000,0,0,0,17000,132000,-115000,-115000
053113,瀚宇博兆豐97購01,0,0,0,0,0,0,0,0,0,-116000,0,0,0,80000,196000,-116000,-116000
054943,群光元大97購01  ,0,0,0,0,0,0,0,0,0,-116000,0,0,0,80000,196000,-116000,-116000
05724P,致茂永豐96售01  ,0,0,0,0,0,0,0,0,0,-116000,0,0,0,0,116000,-116000,-116000
055700,緯穎國泰98購02  ,0,0,0,0,0,0,0,0,0,-116000,0,0,0,3000,119000,-116000,-116000
2912,統一超          ,1322763,1438149,-115386,0,0,0,0,1000,-1000,0,0,0,0,0,0,0,-116386
060785,國巨富邦9B購04  ,0,0,0,0,0,0,0,0,0,-117000,0,0,0,15000,132000,-117000,-117000
07257P,臺股指凱基99售37,0,0,0,0,0,0,0,0,0,-117000,0,0,0,51000,168000,-117000,-117000
006208,富邦台50        ,6000,4000,2000,0,0,0,0,0,0,-119000,0,0,0,750000,869000,-119000,-117000
057357,超眾統一98購01  ,0,0,0,0,0,0,0,0,0,-117000,0,0,0,96000,213000,-117000,-117000
07575P,瑞昱元大9A售02  ,0,0,0,0,0,0,0,0,0,-118000,0,0,0,81000,199000,-118000,-118000
061072,南電凱基9B購01  ,0,0,0,0,0,0,0,0,0,-118000,0,0,0,0,118000,-118000,-118000
060485,華新科富邦9C購04,0,0,0,0,0,0,0,0,0,-118000,0,0,0,213000,331000,-118000,-118000
053929,正文國票97購01  ,0,0,0,0,0,0,0,0,0,-118000,0,0,0,10000,128000,-118000,-118000
054420,緯穎元大96購08  ,0,0,0,0,0,0,0,0,0,-118000,0,0,0,40000,158000,-118000,-118000
058699,楠梓電元大99購02,0,0,0,0,0,0,0,0,0,-118000,0,0,0,0,118000,-118000,-118000
056899,可成元大98購01  ,0,0,0,0,0,0,0,0,0,-118000,0,0,0,0,118000,-118000,-118000
056878,元油2X國票99購02,0,0,0,0,0,0,0,0,0,-118000,0,0,0,0,118000,-118000,-118000
054399,智易永豐96購03  ,0,0,0,0,0,0,0,0,0,-119000,0,0,0,2000,121000,-119000,-119000
058496,文曄群益99購01  ,0,0,0,0,0,0,0,0,0,-119000,0,0,0,0,119000,-119000,-119000
059395,T50反1元富99購03,0,0,0,0,0,0,0,0,0,-119000,0,0,0,630000,749000,-119000,-119000
3090,日電貿          ,173000,251000,-78000,0,0,0,0,0,0,-41000,2000,6000,-4000,1000,38000,-37000,-119000
060417,正隆永豐9A購01  ,0,0,0,0,0,0,0,0,0,-120000,0,0,0,23000,143000,-120000,-120000
060748,臻鼎國票9A購01  ,0,0,0,0,0,0,0,0,0,-120000,0,0,0,11000,131000,-120000,-120000
060880,中壽中信9C購01  ,0,0,0,0,0,0,0,0,0,-120000,0,0,0,90000,210000,-120000,-120000
052942,聯發科中信97購04,0,0,0,0,0,0,0,0,0,-120000,0,0,0,0,120000,-120000,-120000
050572,大立光中信97購01,0,0,0,0,0,0,0,0,0,-120000,0,0,0,0,120000,-120000,-120000
058950,國巨群益99購06  ,0,0,0,0,0,0,0,0,0,-120000,0,0,0,0,120000,-120000,-120000
058464,矽創兆豐9A購01  ,0,0,0,0,0,0,0,0,0,-120000,0,0,0,0,120000,-120000,-120000
055896,南電統一97購02  ,0,0,0,0,0,0,0,0,0,-120000,0,0,0,0,120000,-120000,-120000
05902P,華通國票96售02  ,0,0,0,0,0,0,0,0,0,-120000,0,0,0,0,120000,-120000,-120000
057579,長榮航中信9A購01,0,0,0,0,0,0,0,0,0,-120000,0,0,0,0,120000,-120000,-120000
057490,可成元大98購10  ,0,0,0,0,0,0,0,0,0,-120000,0,0,0,5000,125000,-120000,-120000
060200,同欣電元富9A購01,0,0,0,0,0,0,0,0,0,-120000,0,0,0,175000,295000,-120000,-120000
059998,華航元富99購02  ,0,0,0,0,0,0,0,0,0,-120000,0,0,0,40000,160000,-120000,-120000
060487,盛群富邦9B購01  ,0,0,0,0,0,0,0,0,0,-121000,0,0,0,0,121000,-121000,-121000
07630P,臺股指凱基9A售11,0,0,0,0,0,0,0,0,0,-121000,0,0,0,31000,152000,-121000,-121000
07732P,台灣50台新9A售05,0,0,0,0,0,0,0,0,0,-121000,0,0,0,0,121000,-121000,-121000
054480,和碩中信98購01  ,0,0,0,0,0,0,0,0,0,-121000,0,0,0,0,121000,-121000,-121000
059257,臺股指凱基99購35,0,0,0,0,0,0,0,0,0,-121000,0,0,0,0,121000,-121000,-121000
059866,國巨凱基99購18  ,0,0,0,0,0,0,0,0,0,-121000,0,0,0,43000,164000,-121000,-121000
2031,新光鋼          ,71437,88000,-16563,0,0,0,0,105000,-105000,0,0,0,0,0,0,0,-121563
2204,中華            ,324000,445604,-121604,0,0,0,0,0,0,0,0,0,0,0,0,0,-121604
061381,台灣50群益9B購07,0,0,0,0,0,0,0,0,0,-122000,0,0,0,0,122000,-122000,-122000
050892,聯電元大96購02  ,0,0,0,0,0,0,0,0,0,-122000,0,0,0,370000,492000,-122000,-122000
058148,百和元大99購01  ,0,0,0,0,0,0,0,0,0,-122000,0,0,0,68000,190000,-122000,-122000
059835,聯發科國泰9B購01,0,0,0,0,0,0,0,0,0,-122000,0,0,0,33000,155000,-122000,-122000
061136,可成統一9A購01  ,0,0,0,0,0,0,0,0,0,-123000,0,0,0,0,123000,-123000,-123000
060901,臺股指凱基9A購13,0,0,0,0,0,0,0,0,0,-123000,0,0,0,205000,328000,-123000,-123000
060282,聚陽元大9A購01  ,0,0,0,0,0,0,0,0,0,-123000,0,0,0,69000,192000,-123000,-123000
07103P,南電元大99售04  ,0,0,0,0,0,0,0,0,0,-123000,0,0,0,25000,148000,-123000,-123000
054358,矽創兆豐96購01  ,0,0,0,0,0,0,0,0,0,-123000,0,0,0,0,123000,-123000,-123000
059999,緯穎元富99購01  ,0,0,0,0,0,0,0,0,0,-123000,0,0,0,0,123000,-123000,-123000
056169,鴻海元富97購08  ,0,0,0,0,0,0,0,0,0,-123000,0,0,0,40000,163000,-123000,-123000
055955,微星元大97購01  ,0,0,0,0,0,0,0,0,0,-123000,0,0,0,156000,279000,-123000,-123000
060514,南電元大9A購02  ,0,0,0,0,0,0,0,0,0,-124000,0,0,0,89000,213000,-124000,-124000
06058P,玉晶光凱基97售04,0,0,0,0,0,0,0,0,0,-124000,0,0,0,150000,274000,-124000,-124000
00730,富邦臺灣優質高息,0,0,0,0,0,0,0,0,0,-124000,0,0,0,402000,526000,-124000,-124000
052972,義隆群益96購04  ,0,0,0,0,0,0,0,0,0,-124000,0,0,0,47000,171000,-124000,-124000
053539,智易永豐96購01  ,0,0,0,0,0,0,0,0,0,-124000,0,0,0,1000,125000,-124000,-124000
057742,喬山永豐98購02  ,0,0,0,0,0,0,0,0,0,-124000,0,0,0,0,124000,-124000,-124000
058297,茂林凱基9A購02  ,0,0,0,0,0,0,0,0,0,-124000,0,0,0,126000,250000,-124000,-124000
06766P,玉晶光元大99售10,0,0,0,0,0,0,0,0,0,-125000,0,0,0,14000,139000,-125000,-125000
055127,台虹兆豐97購01  ,0,0,0,0,0,0,0,0,0,-125000,0,0,0,85000,210000,-125000,-125000
059181,世紀鋼元富9C購01,0,0,0,0,0,0,0,0,0,-125000,0,0,0,4000,129000,-125000,-125000
058846,鴻海群益99購03  ,0,0,0,0,0,0,0,0,0,-125000,0,0,0,0,125000,-125000,-125000
2537,聯上發          ,102000,228000,-126000,0,0,0,0,0,0,0,0,0,0,0,0,0,-126000
060933,南電永豐9A購02  ,0,0,0,0,0,0,0,0,0,-126000,0,0,0,61000,187000,-126000,-126000
055170,光磊統一97購01  ,0,0,0,0,0,0,0,0,0,-126000,0,0,0,77000,203000,-126000,-126000
053672,嘉澤元富96購02  ,0,0,0,0,0,0,0,0,0,-126000,0,0,0,389000,515000,-126000,-126000
053950,緯穎富邦97購02  ,0,0,0,0,0,0,0,0,0,-126000,0,0,0,0,126000,-126000,-126000
059064,緯穎凱基99購02  ,0,0,0,0,0,0,0,0,0,-126000,0,0,0,20000,146000,-126000,-126000
059855,緯穎永豐99購04  ,0,0,0,0,0,0,0,0,0,-126000,0,0,0,20000,146000,-126000,-126000
053111,緯創兆豐97購01  ,0,0,0,0,0,0,0,0,0,-127000,0,0,0,0,127000,-127000,-127000
059832,超眾康和99購01  ,0,0,0,0,0,0,0,0,0,-127000,0,0,0,126000,253000,-127000,-127000
059950,百和永豐99購02  ,0,0,0,0,0,0,0,0,0,-127000,0,0,0,30000,157000,-127000,-127000
059519,台郡永豐99購01  ,0,0,0,0,0,0,0,0,0,-127000,0,0,0,54000,181000,-127000,-127000
4540,全球傳動        ,53000,180000,-127000,0,0,0,0,0,0,0,0,0,0,0,0,0,-127000
4763,材料-KY         ,9000,162000,-153000,0,0,0,0,0,0,26000,30000,4000,26000,0,0,0,-127000
2105,正新            ,1594000,1673180,-79180,0,0,0,0,1000,-1000,-47000,23000,68000,-45000,2000,4000,-2000,-127180
2404,漢唐            ,237000,336400,-99400,0,0,0,0,0,0,-28000,0,11000,-11000,5000,22000,-17000,-127400
1201,味全            ,98000,241000,-143000,0,0,0,0,0,0,15000,0,0,0,15000,0,15000,-128000
061102,台積電元大9A購22,0,0,0,0,0,0,0,0,0,-128000,0,0,0,5000,133000,-128000,-128000
054579,聯茂元大97購01  ,0,0,0,0,0,0,0,0,0,-128000,0,0,0,24000,152000,-128000,-128000
057606,健策統一98購03  ,0,0,0,0,0,0,0,0,0,-128000,0,0,0,57000,185000,-128000,-128000
059090,台新金元大99購01,0,0,0,0,0,0,0,0,0,-128000,0,0,0,0,128000,-128000,-128000
9921,巨大            ,1088000,1335081,-247081,0,0,0,120000,0,120000,-1000,17000,11000,6000,0,7000,-7000,-128081
054912,群光凱基97購01  ,0,0,0,0,0,0,0,0,0,-129000,0,0,0,23000,152000,-129000,-129000
049024,玉晶光群益97購01,0,0,0,0,0,0,0,0,0,-129000,0,0,0,14000,143000,-129000,-129000
056673,中石化元富9B購01,0,0,0,0,0,0,0,0,0,-129000,0,0,0,324000,453000,-129000,-129000
054263,聯茂元大96購02  ,0,0,0,0,0,0,0,0,0,-130000,0,0,0,0,130000,-130000,-130000
051483,玉晶光凱基96購02,0,0,0,0,0,0,0,0,0,-130000,0,0,0,0,130000,-130000,-130000
052697,滬深2X國票98購01,0,0,0,0,0,0,0,0,0,-130000,0,0,0,0,130000,-130000,-130000
052922,國巨永豐96購01  ,0,0,0,0,0,0,0,0,0,-130000,0,0,0,0,130000,-130000,-130000
057065,牧德富邦99購01  ,0,0,0,0,0,0,0,0,0,-130000,0,0,0,0,130000,-130000,-130000
6412,群電            ,139000,263000,-124000,0,0,0,0,0,0,-6000,0,8000,-8000,3000,1000,2000,-130000
060258,T50反1凱基9A購06,0,0,0,0,0,0,0,0,0,-131000,0,0,0,24000,155000,-131000,-131000
053409,和碩兆豐96購02  ,0,0,0,0,0,0,0,0,0,-131000,0,0,0,4000,135000,-131000,-131000
058445,旺宏富邦9C購01  ,0,0,0,0,0,0,0,0,0,-131000,0,0,0,0,131000,-131000,-131000
059283,康友永豐99購02  ,0,0,0,0,0,0,0,0,0,-131000,0,0,0,33000,164000,-131000,-131000
058212,華新科群益9A購01,0,0,0,0,0,0,0,0,0,-131000,0,0,0,317000,448000,-131000,-131000
07568P,鴻海凱基9A售22  ,0,0,0,0,0,0,0,0,0,-132000,0,0,0,186000,318000,-132000,-132000
00638R,元大滬深300反1  ,31000,329000,-298000,0,0,0,0,0,0,166000,0,0,0,214000,48000,166000,-132000
059125,台積電第一03購02,0,0,0,0,0,0,0,0,0,-132000,0,0,0,0,132000,-132000,-132000
07462P,臺股指元大9B售05,0,0,0,0,0,0,0,0,0,-133000,0,0,0,165000,298000,-133000,-133000
053400,緯穎中信9A購01  ,0,0,0,0,0,0,0,0,0,-133000,0,0,0,211000,344000,-133000,-133000
054905,國揚康和97購01  ,0,0,0,0,0,0,0,0,0,-133000,0,0,0,0,133000,-133000,-133000
060195,旭富元富9A購02  ,0,0,0,0,0,0,0,0,0,-133000,0,0,0,0,133000,-133000,-133000
060121,新光金富邦99購01,0,0,0,0,0,0,0,0,0,-133000,0,0,0,106000,239000,-133000,-133000
056196,聯茂富邦98購02  ,0,0,0,0,0,0,0,0,0,-133000,0,0,0,50000,183000,-133000,-133000
06023P,超眾國票96售03  ,0,0,0,0,0,0,0,0,0,-134000,0,0,0,263000,397000,-134000,-134000
061117,美律國泰9C購01  ,0,0,0,0,0,0,0,0,0,-134000,0,0,0,20000,154000,-134000,-134000
057169,微星元大98購01  ,0,0,0,0,0,0,0,0,0,-134000,0,0,0,60000,194000,-134000,-134000
057662,上銀元大9A購01  ,0,0,0,0,0,0,0,0,0,-134000,0,0,0,0,134000,-134000,-134000
057491,美食元大98購03  ,0,0,0,0,0,0,0,0,0,-134000,0,0,0,41000,175000,-134000,-134000
3443,創意            ,245000,372000,-127000,0,0,0,0,0,0,-7000,19000,15000,4000,7000,18000,-11000,-134000
2615,萬海            ,130000,220000,-90000,0,0,0,0,2000,-2000,-42000,0,42000,-42000,0,0,0,-134000
07255P,國巨凱基99售15  ,0,0,0,0,0,0,0,0,0,-135000,0,0,0,69000,204000,-135000,-135000
06748P,智邦台新98售02  ,0,0,0,0,0,0,0,0,0,-135000,0,0,0,45000,180000,-135000,-135000
07128P,大毅元大99售04  ,0,0,0,0,0,0,0,0,0,-135000,0,0,0,30000,165000,-135000,-135000
051277,聯發科中信9A購01,131000,0,131000,0,0,0,0,0,0,-266000,0,0,0,0,266000,-266000,-135000
056809,旺宏統一98購03  ,0,0,0,0,0,0,0,0,0,-135000,0,0,0,0,135000,-135000,-135000
05859P,台表科國票97售04,0,0,0,0,0,0,0,0,0,-135000,0,0,0,0,135000,-135000,-135000
07471P,南亞科元大9A售01,0,0,0,0,0,0,0,0,0,-136000,0,0,0,5000,141000,-136000,-136000
057573,京鼎永豐98購02  ,0,0,0,0,0,0,0,0,0,-136000,0,0,0,337000,473000,-136000,-136000
059559,T50反1凱基99購07,0,0,0,0,0,0,0,0,0,-136000,0,0,0,0,136000,-136000,-136000
1582,信錦            ,130000,261250,-131250,0,0,0,0,0,0,-5000,0,4000,-4000,0,1000,-1000,-136250
061131,崇越永豐9A購01  ,0,0,0,0,0,0,0,0,0,-137000,0,0,0,0,137000,-137000,-137000
053094,聯電統一97購02  ,0,0,0,0,0,0,0,0,0,-137000,0,0,0,35000,172000,-137000,-137000
059580,大立光元富99購07,0,0,0,0,0,0,0,0,0,-137000,0,0,0,90000,227000,-137000,-137000
4968,立積            ,272000,548000,-276000,0,0,0,65000,0,65000,74000,88000,6000,82000,18000,26000,-8000,-137000
06657P,寶成元大98售01  ,0,0,0,0,0,0,0,0,0,-138000,0,0,0,45000,183000,-138000,-138000
055174,精元統一97購01  ,0,0,0,0,0,0,0,0,0,-138000,0,0,0,191000,329000,-138000,-138000
051243,微星元大95購01  ,0,0,0,0,0,0,0,0,0,-138000,0,0,0,0,138000,-138000,-138000
056716,康舒永豐98購01  ,0,0,0,0,0,0,0,0,0,-138000,0,0,0,0,138000,-138000,-138000
2360,致茂            ,306000,492500,-186500,0,0,0,90000,16000,74000,-26000,0,10000,-10000,0,16000,-16000,-138500
060758,台積電元大9A購19,0,0,0,0,0,0,0,0,0,-139000,0,0,0,201000,340000,-139000,-139000
049947,S&P反1中信97購01,0,0,0,0,0,0,0,0,0,-139000,0,0,0,1000,140000,-139000,-139000
053542,超眾永豐96購01  ,0,0,0,0,0,0,0,0,0,-139000,0,0,0,3000,142000,-139000,-139000
058586,鴻海中信01購02  ,0,0,0,0,0,0,0,0,0,-139000,0,0,0,0,139000,-139000,-139000
057991,健策統一9C購01  ,0,0,0,0,0,0,0,0,0,-139000,0,0,0,44000,183000,-139000,-139000
060752,上銀元大9A購04  ,0,0,0,0,0,0,0,0,0,-140000,0,0,0,78000,218000,-140000,-140000
060387,盛群凱基9A購01  ,35000,0,35000,0,0,0,0,0,0,-175000,0,0,0,32000,207000,-175000,-140000
1760,寶齡富錦        ,47000,187000,-140000,0,0,0,0,0,0,0,0,0,0,0,0,0,-140000
07060P,台表科國票9A售01,0,0,0,0,0,0,0,0,0,-140000,0,0,0,17000,157000,-140000,-140000
054828,正崴國泰99購01  ,0,0,0,0,0,0,0,0,0,-140000,0,0,0,3000,143000,-140000,-140000
04979P,臺股指凱基96售07,0,0,0,0,0,0,0,0,0,-140000,0,0,0,0,140000,-140000,-140000
054739,義隆凱基98購02  ,0,0,0,0,0,0,0,0,0,-140000,0,0,0,50000,190000,-140000,-140000
054031,中鋼中信98購01  ,0,0,0,0,0,0,0,0,0,-140000,0,0,0,0,140000,-140000,-140000
057017,和大凱基98購01  ,0,0,0,0,0,0,0,0,0,-140000,0,0,0,0,140000,-140000,-140000
057629,泰碩永豐98購02  ,0,0,0,0,0,0,0,0,0,-140000,0,0,0,57000,197000,-140000,-140000
060138,T50反1國票9A購03,0,0,0,0,0,0,0,0,0,-140000,0,0,0,0,140000,-140000,-140000
06012P,世芯國票96售01  ,0,0,0,0,0,0,0,0,0,-140000,0,0,0,49000,189000,-140000,-140000
05565P,鎧勝元大96售01  ,0,0,0,0,0,0,0,0,0,-140000,0,0,0,54000,194000,-140000,-140000
059551,T50正2康和99購02,0,0,0,0,0,0,0,0,0,-140000,0,0,0,5000,145000,-140000,-140000
061092,可成統一9C購02  ,0,0,0,0,0,0,0,0,0,-141000,0,0,0,18000,159000,-141000,-141000
3376,新日興          ,483000,442000,41000,0,0,0,78000,175000,-97000,-85000,1000,84000,-83000,7000,9000,-2000,-141000
3665,貿聯-KY         ,104000,341810,-237810,0,0,0,100000,0,100000,-4000,1000,4000,-3000,6000,7000,-1000,-141810
06653P,美食元大98售02  ,0,0,0,0,0,0,0,0,0,-142000,0,0,0,20000,162000,-142000,-142000
052544,牧德元富95購01  ,0,0,0,0,0,0,0,0,0,-143000,0,0,0,0,143000,-143000,-143000
00639,富邦深100       ,180000,14000,166000,0,0,0,0,0,0,-309000,0,198000,-198000,757000,868000,-111000,-143000
053486,T50反1兆豐96購01,0,0,0,0,0,0,0,0,0,-143000,0,0,0,353000,496000,-143000,-143000
061137,晶技統一9B購01  ,0,0,0,0,0,0,0,0,0,-145000,0,0,0,46000,191000,-145000,-145000
07310P,大立光凱基99售12,0,0,0,0,0,0,0,0,0,-145000,0,0,0,0,145000,-145000,-145000
057780,台郡群益98購02  ,20000,0,20000,0,0,0,0,0,0,-165000,0,0,0,274000,439000,-165000,-145000
059889,華新科國票99購04,0,0,0,0,0,0,0,0,0,-145000,0,0,0,2000,147000,-145000,-145000
05782P,聯詠元富96售02  ,0,0,0,0,0,0,0,0,0,-146000,0,0,0,40000,186000,-146000,-146000
051749,矽力國泰97購01  ,0,0,0,0,0,0,0,0,0,-146000,0,0,0,0,146000,-146000,-146000
055798,聯茂富邦98購01  ,0,0,0,0,0,0,0,0,0,-146000,0,0,0,151000,297000,-146000,-146000
05970P,超眾永豐96售03  ,0,0,0,0,0,0,0,0,0,-146000,0,0,0,0,146000,-146000,-146000
061378,南六永豐9A購03  ,0,0,0,0,0,0,0,0,0,-147000,0,0,0,0,147000,-147000,-147000
061020,超眾國票9A購02  ,0,0,0,0,0,0,0,0,0,-147000,0,0,0,18000,165000,-147000,-147000
060542,上銀凱基9A購04  ,0,0,0,0,0,0,0,0,0,-147000,0,0,0,8000,155000,-147000,-147000
059019,元石油統一9B購03,0,0,0,0,0,0,0,0,0,-147000,0,0,0,0,147000,-147000,-147000
07032P,聯發科統一9C售02,0,0,0,0,0,0,0,0,0,-148000,0,0,0,37000,185000,-148000,-148000
07148P,富邦金元大99售01,0,0,0,0,0,0,0,0,0,-148000,0,0,0,136000,284000,-148000,-148000
1103,嘉泥            ,24000,155000,-131000,0,0,0,0,5000,-5000,-12000,0,12000,-12000,0,0,0,-148000
054425,聯發科富邦99購03,0,0,0,0,0,0,0,0,0,-148000,0,0,0,0,148000,-148000,-148000
1310,台苯            ,290000,400000,-110000,0,0,0,0,3000,-3000,-36000,0,36000,-36000,0,0,0,-149000
052684,旺宏元大98購01  ,0,0,0,0,0,0,0,0,0,-149000,0,0,0,56000,205000,-149000,-149000
07502P,美食元大9A售01  ,0,0,0,0,0,0,0,0,0,-150000,0,0,0,0,150000,-150000,-150000
07618P,大立光中信9A售06,0,0,0,0,0,0,0,0,0,-150000,0,0,0,100000,250000,-150000,-150000
052733,台郡國泰97購01  ,0,0,0,0,0,0,0,0,0,-150000,0,0,0,21000,171000,-150000,-150000
054977,SP黃豆元富9B購01,0,0,0,0,0,0,0,0,0,-150000,0,0,0,10000,160000,-150000,-150000
056323,旺宏兆豐98購01  ,0,0,0,0,0,0,0,0,0,-150000,0,0,0,50000,200000,-150000,-150000
050799,嘉聯益中信98購01,0,0,0,0,0,0,0,0,0,-150000,0,0,0,0,150000,-150000,-150000
059115,美食永豐99購01  ,0,0,0,0,0,0,0,0,0,-150000,0,0,0,0,150000,-150000,-150000
056818,正崴永豐98購01  ,0,0,0,0,0,0,0,0,0,-150000,0,0,0,44000,194000,-150000,-150000
057924,健策凱基98購02  ,0,0,0,0,0,0,0,0,0,-150000,0,0,0,10000,160000,-150000,-150000
05881P,彩晶康和96售01  ,0,0,0,0,0,0,0,0,0,-150000,0,0,0,0,150000,-150000,-150000
07632P,臺股指凱基9A售14,0,0,0,0,0,0,0,0,0,-151000,0,0,0,0,151000,-151000,-151000
07382P,台積電群益9B售01,0,0,0,0,0,0,0,0,0,-151000,0,0,0,0,151000,-151000,-151000
060640,京鼎永豐9A購01  ,0,0,0,0,0,0,0,0,0,-151000,0,0,0,149000,300000,-151000,-151000
051077,台郡國泰96購02  ,0,0,0,0,0,0,0,0,0,-151000,0,0,0,0,151000,-151000,-151000
6282,康舒            ,482000,572000,-90000,0,0,0,0,5000,-5000,-56000,2000,84000,-82000,26000,0,26000,-151000
061084,京元電兆豐9A購02,0,0,0,0,0,0,0,0,0,-152000,0,0,0,21000,173000,-152000,-152000
2015,豐興            ,17000,144000,-127000,0,0,0,0,1000,-1000,-24000,0,24000,-24000,0,0,0,-152000
8215,明基材          ,139000,287000,-148000,0,0,0,0,2000,-2000,-2000,0,2000,-2000,0,0,0,-152000
04908P,南電國票95售03  ,0,0,0,0,0,0,0,0,0,-152000,0,0,0,160000,312000,-152000,-152000
05499P,聯詠元富95售02  ,0,0,0,0,0,0,0,0,0,-152000,0,0,0,10000,162000,-152000,-152000
056626,同欣電永豐98購01,0,0,0,0,0,0,0,0,0,-152000,0,0,0,0,152000,-152000,-152000
2707,晶華            ,18000,165000,-147000,0,0,0,0,0,0,-5000,0,5000,-5000,0,0,0,-152000
2362,藍天            ,82000,212000,-130000,0,0,0,0,0,0,-23000,0,16000,-16000,0,7000,-7000,-153000
00663L,國泰臺灣加權正2 ,0,0,0,0,0,0,0,0,0,-153000,0,0,0,136000,289000,-153000,-153000
057989,旺宏統一99購04  ,0,0,0,0,0,0,0,0,0,-153000,0,0,0,13000,166000,-153000,-153000
056894,佳世達元大99購01,0,0,0,0,0,0,0,0,0,-154000,0,0,0,88000,242000,-154000,-154000
056416,華新科中信98購01,0,0,0,0,0,0,0,0,0,-154000,0,0,0,52000,206000,-154000,-154000
2338,光罩            ,408000,504000,-96000,0,0,0,0,2000,-2000,-57000,0,1000,-1000,32000,88000,-56000,-155000
1789,神隆            ,385000,522000,-137000,0,0,0,0,0,0,-18000,0,0,0,0,18000,-18000,-155000
07373P,A50正2元大99售01,0,0,0,0,0,0,0,0,0,-155000,0,0,0,0,155000,-155000,-155000
060249,正文元大9C購01  ,0,0,0,0,0,0,0,0,0,-155000,0,0,0,47000,202000,-155000,-155000
05140P,台表科國票96售01,0,0,0,0,0,0,0,0,0,-155000,0,0,0,10000,165000,-155000,-155000
2913,農林            ,47000,183000,-136000,0,0,0,0,0,0,-19000,1000,20000,-19000,0,0,0,-155000
060954,國泰金群益9A購02,0,0,0,0,0,0,0,0,0,-156000,0,0,0,0,156000,-156000,-156000
052990,超眾元大97購01  ,0,0,0,0,0,0,0,0,0,-156000,0,0,0,9000,165000,-156000,-156000
058522,聯茂元大99購07  ,0,0,0,0,0,0,0,0,0,-156000,0,0,0,89000,245000,-156000,-156000
6552,易華電          ,107000,239000,-132000,0,0,0,0,0,0,-24000,0,20000,-20000,0,4000,-4000,-156000
060309,佳世達永豐9A購01,0,0,0,0,0,0,0,0,0,-157000,0,0,0,25000,182000,-157000,-157000
07482P,南亞科元富9A售04,0,0,0,0,0,0,0,0,0,-157000,0,0,0,91000,248000,-157000,-157000
06779P,智邦元大98售12  ,0,0,0,0,0,0,0,0,0,-157000,0,0,0,63000,220000,-157000,-157000
059122,超眾永豐99購01  ,0,0,0,0,0,0,0,0,0,-157000,0,0,0,0,157000,-157000,-157000
2395,研華            ,764000,984925,-220925,0,0,0,65000,0,65000,-2000,3000,5000,-2000,0,0,0,-157925
2208,台船            ,64000,222000,-158000,0,0,0,0,0,0,0,0,0,0,0,0,0,-158000
060986,聯發科元大9A購07,0,0,0,0,0,0,0,0,0,-158000,0,0,0,373000,531000,-158000,-158000
053997,健策群益97購02  ,0,0,0,0,0,0,0,0,0,-158000,0,0,0,59000,217000,-158000,-158000
057039,元油2X元大9B購07,0,0,0,0,0,0,0,0,0,-158000,0,0,0,0,158000,-158000,-158000
059940,微星永豐99購01  ,0,0,0,0,0,0,0,0,0,-158000,0,0,0,4000,162000,-158000,-158000
061354,瑞儀元大9A購01  ,0,0,0,0,0,0,0,0,0,-159000,0,0,0,146000,305000,-159000,-159000
3530,晶相光          ,161000,273000,-112000,0,0,0,0,0,0,-47000,20000,1000,19000,2000,68000,-66000,-159000
060826,牧德元大9B購02  ,0,0,0,0,0,0,0,0,0,-160000,0,0,0,101000,261000,-160000,-160000
060391,華擎群益9C購01  ,0,0,0,0,0,0,0,0,0,-160000,0,0,0,0,160000,-160000,-160000
060380,T50反1凱基9A購08,0,0,0,0,0,0,0,0,0,-160000,0,0,0,115000,275000,-160000,-160000
03414B,臺股指凱基99熊01,50000,40000,10000,0,0,0,0,0,0,-170000,0,0,0,155000,325000,-170000,-160000
053159,同欣電元大96購02,0,0,0,0,0,0,0,0,0,-160000,0,0,0,0,160000,-160000,-160000
054427,潤泰全富邦97購01,0,0,0,0,0,0,0,0,0,-160000,0,0,0,140000,300000,-160000,-160000
054531,聯發科國泰97購02,0,0,0,0,0,0,0,0,0,-160000,0,0,0,0,160000,-160000,-160000
057077,國巨統一98購06  ,0,0,0,0,0,0,0,0,0,-160000,0,0,0,10000,170000,-160000,-160000
058149,百和元大99購02  ,0,0,0,0,0,0,0,0,0,-160000,0,0,0,0,160000,-160000,-160000
057113,祥碩群益98購01  ,0,0,0,0,0,0,0,0,0,-160000,0,0,0,7000,167000,-160000,-160000
055861,矽力元大97購03  ,0,0,0,0,0,0,0,0,0,-160000,0,0,0,0,160000,-160000,-160000
07491P,臺股指國票9A售09,0,0,0,0,0,0,0,0,0,-161000,0,0,0,0,161000,-161000,-161000
051675,瑞儀元大96購02  ,0,0,0,0,0,0,0,0,0,-161000,0,0,0,0,161000,-161000,-161000
3005,神基            ,118000,190000,-72000,0,0,0,1000,1000,0,-89000,5000,14000,-9000,3000,83000,-80000,-161000
05121P,創意國泰96售01  ,0,0,0,0,0,0,0,0,0,-162000,0,0,0,0,162000,-162000,-162000
048707,南電國票95購01  ,0,0,0,0,0,0,0,0,0,-162000,0,0,0,3000,165000,-162000,-162000
6416,瑞祺電通        ,131000,245000,-114000,0,0,0,0,0,0,-48000,55000,21000,34000,9000,91000,-82000,-162000
3576,聯合再生        ,803430,901000,-97570,0,0,0,0,0,0,-65000,0,65000,-65000,0,0,0,-162570
054791,泰碩群益99購02  ,0,0,0,0,0,0,0,0,0,-163000,0,0,0,0,163000,-163000,-163000
058920,SGBR2X元富99購06,0,0,0,0,0,0,0,0,0,-163000,0,0,0,237000,400000,-163000,-163000
056774,和鑫元大98購01  ,0,0,0,0,0,0,0,0,0,-163000,0,0,0,248000,411000,-163000,-163000
060908,金像電元大9A購03,0,0,0,0,0,0,0,0,0,-164000,0,0,0,327000,491000,-164000,-164000
055112,晶豪科凱基98購01,0,0,0,0,0,0,0,0,0,-164000,0,0,0,45000,209000,-164000,-164000
05213P,台積電國票96售05,0,0,0,0,0,0,0,0,0,-164000,0,0,0,52000,216000,-164000,-164000
059099,元油2X統一9C購01,0,0,0,0,0,0,0,0,0,-165000,0,0,0,5000,170000,-165000,-165000
055992,智原台新97購02  ,0,0,0,0,0,0,0,0,0,-165000,0,0,0,0,165000,-165000,-165000
056139,貿聯元大97購04  ,0,0,0,0,0,0,0,0,0,-165000,0,0,0,51000,216000,-165000,-165000
6451,訊芯-KY         ,220000,389000,-169000,0,0,0,0,0,0,4000,3000,3000,0,12000,8000,4000,-165000
060915,旭富元大9A購01  ,0,0,0,0,0,0,0,0,0,-166000,0,0,0,100000,266000,-166000,-166000
04294P,台積電元大95售01,0,0,0,0,0,0,0,0,0,-166000,0,0,0,0,166000,-166000,-166000
058116,正崴中信99購02  ,0,0,0,0,0,0,0,0,0,-166000,0,0,0,71000,237000,-166000,-166000
3014,聯陽            ,169000,335000,-166000,0,0,0,0,2000,-2000,2000,24000,4000,20000,34000,52000,-18000,-166000
058139,臻鼎元大99購01  ,0,0,0,0,0,0,0,0,0,-167000,0,0,0,1000,168000,-167000,-167000
2207,和泰車          ,172000,339300,-167300,0,0,0,0,0,0,0,0,0,0,0,0,0,-167300
07352P,台積電國票99售11,0,0,0,0,0,0,0,0,0,-168000,0,0,0,98000,266000,-168000,-168000
061138,晶技統一9C購01  ,0,0,0,0,0,0,0,0,0,-168000,0,0,0,0,168000,-168000,-168000
058251,百和元大99購03  ,0,0,0,0,0,0,0,0,0,-168000,0,0,0,0,168000,-168000,-168000
2444,兆勁            ,23000,192000,-169000,0,0,0,0,0,0,0,0,0,0,0,0,0,-169000
051774,聯茂中信96購01  ,0,0,0,0,0,0,0,0,0,-169000,0,0,0,130000,299000,-169000,-169000
052005,矽力國泰97購02  ,0,0,0,0,0,0,0,0,0,-169000,0,0,0,80000,249000,-169000,-169000
2014,中鴻            ,296892,444000,-147108,0,0,0,0,0,0,-22000,0,22000,-22000,0,0,0,-169108
055449,超眾統一9A購01  ,0,0,0,0,0,0,0,0,0,-170000,0,0,0,58000,228000,-170000,-170000
058368,奇鋐凱基9A購01  ,0,0,0,0,0,0,0,0,0,-170000,0,0,0,0,170000,-170000,-170000
058733,同欣電永豐99購02,0,0,0,0,0,0,0,0,0,-170000,0,0,0,58000,228000,-170000,-170000
059646,聯茂凱基99購06  ,0,0,0,0,0,0,0,0,0,-170000,0,0,0,5000,175000,-170000,-170000
058214,世芯群益9A購01  ,0,0,0,0,0,0,0,0,0,-170000,0,0,0,27000,197000,-170000,-170000
057671,群創元大9B購06  ,0,0,0,0,0,0,0,0,0,-170000,0,0,0,32000,202000,-170000,-170000
5203,訊連            ,45000,171000,-126000,0,0,0,0,0,0,-44000,5000,40000,-35000,0,9000,-9000,-170000
060721,瑞儀永豐9A購01  ,0,0,0,0,0,0,0,0,0,-171000,0,0,0,117000,288000,-171000,-171000
05528P,臺股指群益96售01,0,0,0,0,0,0,0,0,0,-171000,0,0,0,152000,323000,-171000,-171000
060117,國巨國泰9B購04  ,0,0,0,0,0,0,0,0,0,-171000,0,0,0,146000,317000,-171000,-171000
060493,美律元富01購01  ,0,0,0,0,0,0,0,0,0,-172000,0,0,0,96000,268000,-172000,-172000
06654P,欣興元大98售08  ,0,0,0,0,0,0,0,0,0,-172000,0,0,0,2000,174000,-172000,-172000
07718P,臺股指群益9A售07,0,0,0,0,0,0,0,0,0,-172000,0,0,0,0,172000,-172000,-172000
1701,中化            ,148000,321000,-173000,0,0,0,0,0,0,0,0,0,0,0,0,0,-173000
054148,矽創元大96購03  ,0,0,0,0,0,0,0,0,0,-173000,0,0,0,117000,290000,-173000,-173000
059760,楠梓電永豐99購01,0,0,0,0,0,0,0,0,0,-173000,0,0,0,34000,207000,-173000,-173000
056441,燿華凱基98購01  ,0,0,0,0,0,0,0,0,0,-174000,0,0,0,0,174000,-174000,-174000
3038,全台            ,576000,753000,-177000,0,0,0,0,0,0,3000,24000,21000,3000,0,0,0,-174000
061007,聯詠兆豐9A購01  ,0,0,0,0,0,0,0,0,0,-176000,0,0,0,103000,279000,-176000,-176000
054134,強茂元大96購01  ,0,0,0,0,0,0,0,0,0,-176000,0,0,0,10000,186000,-176000,-176000
060047,道瓊反凱基99購01,0,0,0,0,0,0,0,0,0,-176000,0,0,0,125000,301000,-176000,-176000
049820,世紀鋼元大96購03,0,0,0,0,0,0,0,0,0,-177000,0,0,0,12000,189000,-177000,-177000
6271,同欣電          ,639000,1390000,-751000,0,0,0,787000,240000,547000,27000,7000,2000,5000,26000,4000,22000,-177000
055252,新光金統一98購02,0,0,0,0,0,0,0,0,0,-178000,0,0,0,53000,231000,-178000,-178000
053170,茂林群益96購04  ,0,0,0,0,0,0,0,0,0,-178000,0,0,0,195000,373000,-178000,-178000
057420,美食凱基98購01  ,0,0,0,0,0,0,0,0,0,-178000,0,0,0,38000,216000,-178000,-178000
060476,瑞祺元大9A購02  ,0,0,0,0,0,0,0,0,0,-179000,0,0,0,140000,319000,-179000,-179000
05310P,智原永豐95售04  ,0,0,0,0,0,0,0,0,0,-179000,0,0,0,12000,191000,-179000,-179000
055829,上銀元大97購06  ,0,0,0,0,0,0,0,0,0,-179000,0,0,0,12000,191000,-179000,-179000
07629P,臺股指凱基9A售10,0,0,0,0,0,0,0,0,0,-180000,0,0,0,60000,240000,-180000,-180000
04938P,亞德客國票95售01,0,0,0,0,0,0,0,0,0,-180000,0,0,0,50000,230000,-180000,-180000
059014,SGBR2X元富03購01,0,0,0,0,0,0,0,0,0,-180000,0,0,0,21000,201000,-180000,-180000
057010,景碩中信98購01  ,0,0,0,0,0,0,0,0,0,-180000,0,0,0,0,180000,-180000,-180000
07557P,玉晶光元大9A售09,0,0,0,0,0,0,0,0,0,-181000,0,0,0,7000,188000,-181000,-181000
2331,精英            ,46000,224000,-178000,0,0,0,0,0,0,-3000,8000,11000,-3000,0,0,0,-181000
060566,聯詠富邦9C購01  ,0,0,0,0,0,0,0,0,0,-181000,0,0,0,20000,201000,-181000,-181000
05634P,玉晶光台新97售01,0,0,0,0,0,0,0,0,0,-181000,0,0,0,0,181000,-181000,-181000
058768,南港兆豐99購01  ,0,0,0,0,0,0,0,0,0,-182000,0,0,0,85000,267000,-182000,-182000
060909,金像電元大9B購01,0,0,0,0,0,0,0,0,0,-183000,0,0,0,54000,237000,-183000,-183000
06529P,貿聯富邦99售03  ,0,0,0,0,0,0,0,0,0,-183000,0,0,0,80000,263000,-183000,-183000
00643,群益深証中小    ,212000,21000,191000,0,0,0,0,0,0,-374000,0,150000,-150000,19000,243000,-224000,-183000
057405,麗豐群益98購01  ,0,0,0,0,0,0,0,0,0,-183000,0,0,0,0,183000,-183000,-183000
9910,豐泰            ,692756,913960,-221204,0,0,0,68000,1000,67000,-29500,0,29500,-29500,0,0,0,-183704
052180,緯穎元大96購05  ,0,0,0,0,0,0,0,0,0,-184000,0,0,0,109000,293000,-184000,-184000
059175,臺股指凱基99購26,0,0,0,0,0,0,0,0,0,-184000,0,0,0,0,184000,-184000,-184000
055505,新唐元大97購02  ,0,0,0,0,0,0,0,0,0,-185000,0,0,0,0,185000,-185000,-185000
059188,京元電富邦9B購01,0,0,0,0,0,0,0,0,0,-186000,0,0,0,114000,300000,-186000,-186000
057368,微星元大98購02  ,0,0,0,0,0,0,0,0,0,-186000,0,0,0,176000,362000,-186000,-186000
061273,臺股指凱基9A購23,0,0,0,0,0,0,0,0,0,-187000,0,0,0,0,187000,-187000,-187000
060120,聯電富邦9B購01  ,0,0,0,0,0,0,0,0,0,-187000,0,0,0,0,187000,-187000,-187000
058802,矽創元大99購02  ,0,0,0,0,0,0,0,0,0,-187000,0,0,0,19000,206000,-187000,-187000
2820,華票            ,15000,152000,-137000,0,0,0,0,0,0,-50000,0,50000,-50000,0,0,0,-187000
059095,訊芯元大99購01  ,0,0,0,0,0,0,0,0,0,-188000,0,0,0,448000,636000,-188000,-188000
060350,元黃金元富9B購01,0,0,0,0,0,0,0,0,0,-189000,0,0,0,14000,203000,-189000,-189000
07627P,超眾凱基9A售02  ,0,0,0,0,0,0,0,0,0,-190000,0,0,0,59000,249000,-190000,-190000
8163,達方            ,247000,350000,-103000,0,0,0,0,0,0,-87000,17000,45000,-28000,0,59000,-59000,-190000
058790,楠梓電元大99購03,0,0,0,0,0,0,0,0,0,-190000,0,0,0,0,190000,-190000,-190000
058025,聯茂國泰99購01  ,0,0,0,0,0,0,0,0,0,-191000,0,0,0,1000,192000,-191000,-191000
6005,群益證          ,399000,583000,-184000,0,0,0,0,7000,-7000,0,0,0,0,0,0,0,-191000
03680C,臺股指凱基9A牛26,0,0,0,0,0,0,0,0,0,-192000,0,0,0,42000,234000,-192000,-192000
05710P,禾伸堂國票97售02,0,0,0,0,0,0,0,0,0,-192000,0,0,0,77000,269000,-192000,-192000
060884,超眾中信9B購01  ,0,0,0,0,0,0,0,0,0,-193000,0,0,0,0,193000,-193000,-193000
053998,泰鼎群益98購01  ,0,0,0,0,0,0,0,0,0,-193000,0,0,0,15000,208000,-193000,-193000
057958,禾伸堂元大99購05,0,0,0,0,0,0,0,0,0,-193000,0,0,0,84000,277000,-193000,-193000
058077,超眾凱基98購02  ,0,0,0,0,0,0,0,0,0,-193000,0,0,0,29000,222000,-193000,-193000
059151,臺股指國票99購14,0,0,0,0,0,0,0,0,0,-193000,0,0,0,22000,215000,-193000,-193000
8039,台虹            ,301000,466000,-165000,0,0,0,0,0,0,-29000,9000,54000,-45000,19000,3000,16000,-194000
056298,億光元大97購02  ,0,0,0,0,0,0,0,0,0,-194000,0,0,0,6000,200000,-194000,-194000
061022,健策國泰9B購03  ,0,0,0,0,0,0,0,0,0,-195000,0,0,0,95000,290000,-195000,-195000
052104,英業達兆豐96購01,0,0,0,0,0,0,0,0,0,-195000,0,0,0,160000,355000,-195000,-195000
059096,百和元大99購04  ,0,0,0,0,0,0,0,0,0,-197000,0,0,0,0,197000,-197000,-197000
2547,日勝生          ,163000,358000,-195000,0,0,0,0,0,0,-2000,0,2000,-2000,0,0,0,-197000
057482,微星元大98購03  ,0,0,0,0,0,0,0,0,0,-198000,0,0,0,60000,258000,-198000,-198000
060833,道瓊反國票9A購01,0,0,0,0,0,0,0,0,0,-199000,0,0,0,0,199000,-199000,-199000
060401,世紀鋼國票9B購01,0,0,0,0,0,0,0,0,0,-199000,0,0,0,299000,498000,-199000,-199000
07520P,臺股指元大9B售11,0,0,0,0,0,0,0,0,0,-199000,0,0,0,20000,219000,-199000,-199000
07164P,臺股指群益99售15,0,0,0,0,0,0,0,0,0,-199000,0,0,0,56000,255000,-199000,-199000
05759P,智邦永豐96售02  ,0,0,0,0,0,0,0,0,0,-199000,0,0,0,209000,408000,-199000,-199000
055684,京鼎凱基97購01  ,0,0,0,0,0,0,0,0,0,-199000,0,0,0,106000,305000,-199000,-199000
2548,華固            ,82000,269000,-187000,0,0,0,0,1000,-1000,-11000,10000,21000,-11000,0,0,0,-199000
060619,玉晶光元大9A購03,0,0,0,0,0,0,0,0,0,-200000,0,0,0,0,200000,-200000,-200000
061043,百和永豐9A購01  ,0,0,0,0,0,0,0,0,0,-200000,0,0,0,0,200000,-200000,-200000
061189,可成富邦9B購02  ,0,0,0,0,0,0,0,0,0,-200000,0,0,0,0,200000,-200000,-200000
061149,華通群益9A購05  ,0,0,0,0,0,0,0,0,0,-200000,0,0,0,0,200000,-200000,-200000
054367,鴻海中信98購03  ,150000,0,150000,0,0,0,0,0,0,-350000,0,0,0,140000,490000,-350000,-200000
041991,元油2X國票98購01,0,0,0,0,0,0,0,0,0,-200000,0,0,0,0,200000,-200000,-200000
053300,大成鋼凱基96購02,0,0,0,0,0,0,0,0,0,-200000,0,0,0,0,200000,-200000,-200000
053232,友達永豐97購02  ,0,0,0,0,0,0,0,0,0,-200000,0,0,0,0,200000,-200000,-200000
053471,正崴元大96購01  ,0,0,0,0,0,0,0,0,0,-200000,0,0,0,0,200000,-200000,-200000
05270P,台表科元大95售05,0,0,0,0,0,0,0,0,0,-200000,0,0,0,0,200000,-200000,-200000
056761,元油2X元大98購07,0,0,0,0,0,0,0,0,0,-200000,0,0,0,0,200000,-200000,-200000
057845,晶相光永豐98購03,0,0,0,0,0,0,0,0,0,-200000,0,0,0,0,200000,-200000,-200000
059046,滬深2X凱基9C購01,0,0,0,0,0,0,0,0,0,-200000,0,0,0,0,200000,-200000,-200000
8021,尖點            ,91000,278000,-187000,0,0,0,0,0,0,-14000,0,14000,-14000,0,0,0,-201000
052153,GIS富邦96購02   ,0,0,0,0,0,0,0,0,0,-201000,0,0,0,0,201000,-201000,-201000
060083,和大元大99購02  ,0,0,0,0,0,0,0,0,0,-201000,0,0,0,104000,305000,-201000,-201000
05913P,國巨元大96售11  ,0,0,0,0,0,0,0,0,0,-202000,0,0,0,0,202000,-202000,-202000
06631P,玉晶光群益9A售03,0,0,0,0,0,0,0,0,0,-203000,0,0,0,35000,238000,-203000,-203000
060409,味全永豐9A購01  ,0,0,0,0,0,0,0,0,0,-203000,0,0,0,0,203000,-203000,-203000
059076,FBVIX元大99購04 ,0,0,0,0,0,0,0,0,0,-203000,0,0,0,0,203000,-203000,-203000
055822,臺股指國票97購09,0,0,0,0,0,0,0,0,0,-203000,0,0,0,1000,204000,-203000,-203000
060900,超眾凱基9B購01  ,0,0,0,0,0,0,0,0,0,-204000,0,0,0,0,204000,-204000,-204000
055703,緯穎富邦98購01  ,0,0,0,0,0,0,0,0,0,-204000,0,0,0,30000,234000,-204000,-204000
058494,可成群益9B購01  ,0,0,0,0,0,0,0,0,0,-205000,0,0,0,7000,212000,-205000,-205000
2607,榮運            ,23000,228000,-205000,0,0,0,0,0,0,0,0,0,0,0,0,0,-205000
4934,太極            ,151000,356000,-205000,0,0,0,0,0,0,0,0,0,0,0,0,0,-205000
2417,圓剛            ,809000,1014000,-205000,0,0,0,0,0,0,-1000,0,1000,-1000,0,0,0,-206000
1905,華紙            ,114000,302000,-188000,0,0,0,0,0,0,-18000,0,18000,-18000,0,0,0,-206000
060799,茂林永豐9A購01  ,0,0,0,0,0,0,0,0,0,-207000,0,0,0,19000,226000,-207000,-207000
061037,嘉澤永豐9A購01  ,0,0,0,0,0,0,0,0,0,-207000,0,0,0,138000,345000,-207000,-207000
060163,健策永豐9B購01  ,0,0,0,0,0,0,0,0,0,-208000,0,0,0,25000,233000,-208000,-208000
07724P,臺股指凱基9A售16,0,0,0,0,0,0,0,0,0,-209000,0,0,0,0,209000,-209000,-209000
3532,台勝科          ,149000,291000,-142000,0,0,0,0,0,0,-67000,0,16000,-16000,2000,53000,-51000,-209000
055082,台郡中信97購01  ,0,0,0,0,0,0,0,0,0,-210000,0,0,0,0,210000,-210000,-210000
056578,智易元大99購02  ,0,0,0,0,0,0,0,0,0,-210000,0,0,0,397000,607000,-210000,-210000
056672,元油2X元富98購10,0,0,0,0,0,0,0,0,0,-210000,0,0,0,0,210000,-210000,-210000
07720P,臺股指群益9A售09,0,0,0,0,0,0,0,0,0,-211000,0,0,0,2000,213000,-211000,-211000
1319,東陽            ,420000,601000,-181000,0,0,0,0,1000,-1000,-29000,10000,39000,-29000,0,0,0,-211000
060764,華擎元大9A購03  ,0,0,0,0,0,0,0,0,0,-211000,0,0,0,335000,546000,-211000,-211000
058658,瑞儀中信99購01  ,0,0,0,0,0,0,0,0,0,-211000,0,0,0,6000,217000,-211000,-211000
051781,緯穎群益96購01  ,0,0,0,0,0,0,0,0,0,-211000,0,0,0,0,211000,-211000,-211000
06371P,茂林國票98售04  ,0,0,0,0,0,0,0,0,0,-212000,0,0,0,0,212000,-212000,-212000
07729P,臺股指凱基9A售21,0,0,0,0,0,0,0,0,0,-212000,0,0,0,6000,218000,-212000,-212000
07731P,臺股指凱基9A售28,0,0,0,0,0,0,0,0,0,-212000,0,0,0,0,212000,-212000,-212000
058614,台郡元大9A購01  ,0,0,0,0,0,0,0,0,0,-212000,0,0,0,10000,222000,-212000,-212000
07416P,台積電元大99售53,0,0,0,0,0,0,0,0,0,-213000,0,0,0,38000,251000,-213000,-213000
058989,茂林凱基99購02  ,0,0,0,0,0,0,0,0,0,-213000,0,0,0,157000,370000,-213000,-213000
3702A,大聯大甲特      ,0,0,0,0,0,0,0,0,0,-213000,0,213000,-213000,0,0,0,-213000
05212P,台積電國票96售04,0,0,0,0,0,0,0,0,0,-214000,0,0,0,407000,621000,-214000,-214000
05226P,智邦統一95售01  ,0,0,0,0,0,0,0,0,0,-214000,0,0,0,76000,290000,-214000,-214000
6670,復盛應用        ,39000,246000,-207000,0,0,0,0,0,0,-8000,0,8000,-8000,0,0,0,-215000
060807,新光金群益9A購01,0,0,0,0,0,0,0,0,0,-215000,0,0,0,0,215000,-215000,-215000
2489,瑞軒            ,178000,323000,-145000,0,0,0,0,0,0,-71000,2000,59000,-57000,0,14000,-14000,-216000
1227,佳格            ,439000,594565,-155565,0,0,0,0,2000,-2000,-60000,0,60000,-60000,0,0,0,-217565
2451,創見            ,102000,373000,-271000,0,0,0,101000,0,101000,-49000,3000,13000,-10000,0,39000,-39000,-219000
07039P,南電台新99售01  ,0,0,0,0,0,0,0,0,0,-219000,0,0,0,10000,229000,-219000,-219000
061197,矽創永豐9A購02  ,0,0,0,0,0,0,0,0,0,-219000,0,0,0,19000,238000,-219000,-219000
058392,元油2X元大99購12,0,0,0,0,0,0,0,0,0,-219000,0,0,0,0,219000,-219000,-219000
060851,國巨國泰9C購01  ,0,0,0,0,0,0,0,0,0,-220000,0,0,0,414000,634000,-220000,-220000
060695,同欣電麥證9A購01,0,0,0,20000,240000,-220000,0,0,0,-220000,0,0,0,20000,240000,-220000,-220000
07728P,臺股指凱基9A售20,0,0,0,0,0,0,0,0,0,-220000,0,0,0,0,220000,-220000,-220000
058663,瑞儀兆豐9A購01  ,0,0,0,0,0,0,0,0,0,-220000,0,0,0,116000,336000,-220000,-220000
058111,健鼎元富98購01  ,0,0,0,0,0,0,0,0,0,-221000,0,0,0,30000,251000,-221000,-221000
060218,台積電凱基9A購15,0,0,0,0,0,0,0,0,0,-222000,0,0,0,115000,337000,-222000,-222000
2375,凱美            ,298000,499000,-201000,0,0,0,0,0,0,-22000,0,4000,-4000,0,18000,-18000,-223000
9136,巨騰-DR         ,0,223000,-223000,0,0,0,0,0,0,0,0,0,0,0,0,0,-223000
059958,鎧勝康和99購01  ,0,0,0,0,0,0,0,0,0,-223000,0,0,0,62000,285000,-223000,-223000
2845,遠東銀          ,556000,673081,-117081,0,0,0,0,1000,-1000,-105000,0,105000,-105000,0,0,0,-223081
07218P,臺股指凱基99售31,0,0,0,0,0,0,0,0,0,-224000,0,0,0,134000,358000,-224000,-224000
059508,聯發科永豐99購03,0,0,0,0,0,0,0,0,0,-224000,0,0,0,31000,255000,-224000,-224000
07287P,全新群益9B售01  ,0,0,0,0,0,0,0,0,0,-225000,0,0,0,0,225000,-225000,-225000
057995,華新科中信98購02,0,0,0,0,0,0,0,0,0,-225000,0,0,0,219000,444000,-225000,-225000
059924,世紀鋼元大99購06,0,0,0,0,0,0,0,0,0,-225000,0,0,0,0,225000,-225000,-225000
2347,聯強            ,1306513,1411600,-105087,0,0,0,7000,2000,5000,-125000,4000,47000,-43000,0,82000,-82000,-225087
060381,元黃金凱基9A購01,0,0,0,0,0,0,0,0,0,-227000,0,0,0,630000,857000,-227000,-227000
2383,台光電          ,424000,380000,44000,0,0,0,0,258000,-258000,-16000,8000,21000,-13000,8000,11000,-3000,-230000
05194P,玉晶光康和95售01,0,0,0,0,0,0,0,0,0,-230000,0,0,0,50000,280000,-230000,-230000
8926,台汽電          ,156000,351000,-195000,0,0,0,0,4000,-4000,-32000,0,34000,-34000,7000,5000,2000,-231000
07264P,台積電元大99售38,0,0,0,0,0,0,0,0,0,-232000,0,0,0,113000,345000,-232000,-232000
07081P,南電群益9A售01  ,0,0,0,0,0,0,0,0,0,-233000,0,0,0,45000,278000,-233000,-233000
1514,亞力            ,50000,285000,-235000,0,0,0,0,0,0,0,0,0,0,0,0,0,-235000
061054,台積電群益9A購04,0,0,0,0,0,0,0,0,0,-237000,0,0,0,78000,315000,-237000,-237000
03421B,臺股指元大99熊01,0,0,0,0,0,0,0,0,0,-237000,0,0,0,1000,238000,-237000,-237000
3545,敦泰            ,1715000,1990000,-275000,0,0,0,0,0,0,38000,50000,12000,38000,0,0,0,-237000
061028,聚陽永豐9A購01  ,0,0,0,0,0,0,0,0,0,-238000,0,0,0,39000,277000,-238000,-238000
07363P,大立光元大99售26,0,0,0,0,0,0,0,0,0,-238000,0,0,0,2000,240000,-238000,-238000
055830,上銀元大97購07  ,0,0,0,0,0,0,0,0,0,-238000,0,0,0,4000,242000,-238000,-238000
05304P,國巨國泰97售02  ,0,0,0,0,0,0,0,0,0,-239000,0,0,0,10000,249000,-239000,-239000
057096,緯穎元富98購01  ,0,0,0,0,0,0,0,0,0,-239000,0,0,0,60000,299000,-239000,-239000
3563,牧德            ,109000,358000,-249000,0,0,0,0,0,0,9313,13000,3000,10000,11000,11687,-687,-239687
060976,SP黃豆元大9A購03,0,0,0,0,0,0,0,0,0,-240000,0,0,0,0,240000,-240000,-240000
2915,潤泰全          ,319000,511370,-192370,0,0,0,2000,1000,1000,-49000,0,13000,-13000,16000,52000,-36000,-240370
04831P,聯詠富邦96售01  ,0,0,0,0,0,0,0,0,0,-241000,0,0,0,8000,249000,-241000,-241000
060114,緯穎元大99購10  ,0,0,0,0,0,0,0,0,0,-242000,0,0,0,33000,275000,-242000,-242000
6285,啟碁            ,947000,1148000,-201000,0,0,0,1000,0,1000,-42000,2000,41000,-39000,2000,5000,-3000,-242000
2439,美律            ,180208,380000,-199792,0,0,0,0,41000,-41000,-2000,14000,47000,-33000,73000,42000,31000,-242792
6196,帆宣            ,79000,302000,-223000,0,0,0,0,0,0,-20000,0,3000,-3000,0,17000,-17000,-243000
3703,欣陸            ,66000,309000,-243000,0,0,0,0,0,0,0,0,0,0,0,0,0,-243000
052102,台泥兆豐96購01  ,0,0,0,0,0,0,0,0,0,-244000,0,0,0,6000,250000,-244000,-244000
2511,太子            ,46000,239000,-193000,0,0,0,0,0,0,-52000,0,52000,-52000,0,0,0,-245000
060651,瑞儀中信9B購01  ,0,0,0,0,0,0,0,0,0,-245000,0,0,0,17000,262000,-245000,-245000
2809,京城銀          ,264000,471000,-207000,0,0,0,0,1000,-1000,-37000,0,37000,-37000,0,0,0,-245000
2838,聯邦銀          ,103000,253000,-150000,0,0,0,0,0,0,-95000,0,95000,-95000,0,0,0,-245000
059848,智邦永豐99購01  ,0,0,0,0,0,0,0,0,0,-249000,0,0,0,61000,310000,-249000,-249000
6226,光鼎            ,196000,444000,-248000,0,0,0,0,0,0,-1000,0,1000,-1000,0,0,0,-249000
060225,S&P反1元大9A購02,0,0,0,0,0,0,0,0,0,-250000,0,0,0,0,250000,-250000,-250000
055583,國巨元大97購10  ,0,0,0,0,0,0,0,0,0,-250000,0,0,0,1000,251000,-250000,-250000
061262,智邦凱基9A購02  ,0,0,0,0,0,0,0,0,0,-251000,0,0,0,1000,252000,-251000,-251000
2606,裕民            ,736000,952000,-216000,0,0,0,0,1000,-1000,-34000,0,35000,-35000,1000,0,1000,-251000
058912,祥碩元大99購01  ,0,0,0,0,0,0,0,0,0,-252000,0,0,0,96000,348000,-252000,-252000
1909,榮成            ,664000,658000,6000,0,0,0,0,1000,-1000,-258000,4000,262000,-258000,0,0,0,-253000
056860,正崴群益98購01  ,0,0,0,0,0,0,0,0,0,-253000,0,0,0,30000,283000,-253000,-253000
06173P,華通元大97售02  ,0,0,0,0,0,0,0,0,0,-255000,0,0,0,15000,270000,-255000,-255000
053754,英業達元富96購02,0,0,0,0,0,0,0,0,0,-256000,0,0,0,100000,356000,-256000,-256000
8271,宇瞻            ,369000,625000,-256000,0,0,0,0,0,0,-1000,0,1000,-1000,0,0,0,-257000
054819,裕民元大9A購01  ,0,0,0,0,0,0,0,0,0,-257000,0,0,0,707000,964000,-257000,-257000
059205,元石油元大99購01,0,0,0,0,0,0,0,0,0,-257000,0,0,0,0,257000,-257000,-257000
059961,T50反1凱基99購09,0,0,0,0,0,0,0,0,0,-258000,0,0,0,174000,432000,-258000,-258000
058659,力成中信99購01  ,0,0,0,0,0,0,0,0,0,-260000,0,0,0,479000,739000,-260000,-260000
057110,立積群益98購01  ,0,0,0,0,0,0,0,0,0,-260000,0,0,0,90000,350000,-260000,-260000
060199,台郡元富9A購01  ,0,0,0,0,0,0,0,0,0,-260000,0,0,0,106000,366000,-260000,-260000
061269,嘉澤凱基9A購01  ,0,0,0,0,0,0,0,0,0,-261000,0,0,0,0,261000,-261000,-261000
057815,信邦元大98購01  ,0,0,0,0,0,0,0,0,0,-261000,0,0,0,45000,306000,-261000,-261000
058999,台積電元大99購24,0,0,0,0,0,0,0,0,0,-261000,0,0,0,10000,271000,-261000,-261000
060336,南電康和9A購01  ,0,0,0,0,0,0,0,0,0,-262000,0,0,0,11000,273000,-262000,-262000
045189,大立光元富98購01,0,0,0,0,0,0,0,0,0,-262000,0,0,0,0,262000,-262000,-262000
057109,信邦群益98購01  ,0,0,0,0,0,0,0,0,0,-262000,0,0,0,0,262000,-262000,-262000
059524,FBVIX凱基9A購02 ,0,0,0,0,0,0,0,0,0,-262000,0,0,0,0,262000,-262000,-262000
060916,金像電國泰9C購01,0,0,0,0,0,0,0,0,0,-263000,0,0,0,34000,297000,-263000,-263000
050784,美律國泰96購01  ,0,0,0,0,0,0,0,0,0,-263000,0,0,0,39000,302000,-263000,-263000
2206,三陽工業        ,27000,281000,-254000,0,0,0,0,0,0,-10000,0,10000,-10000,0,0,0,-264000
1598,岱宇            ,42000,304000,-262000,0,0,0,0,0,0,-3000,4000,7000,-3000,0,0,0,-265000
054240,訊芯群益96購03  ,0,0,0,0,0,0,0,0,0,-265000,0,0,0,0,265000,-265000,-265000
058050,台郡元大99購05  ,0,0,0,0,0,0,0,0,0,-265000,0,0,0,111000,376000,-265000,-265000
056391,大立光富邦9C購01,0,0,0,0,0,0,0,0,0,-265000,0,0,0,0,265000,-265000,-265000
06123P,玉晶光元大97售04,0,0,0,0,0,0,0,0,0,-267000,0,0,0,33000,300000,-267000,-267000
1444,力麗            ,51000,286000,-235000,0,0,0,0,0,0,-33000,0,33000,-33000,0,0,0,-268000
03441B,臺股指凱基9A熊05,0,0,0,0,0,0,0,0,0,-268000,0,0,0,1093000,1361000,-268000,-268000
05594P,旺宏國票96售04  ,0,0,0,0,0,0,0,0,0,-268000,0,0,0,0,268000,-268000,-268000
07593P,臺股指凱基9A售08,0,0,0,0,0,0,0,0,0,-269000,0,0,0,21000,290000,-269000,-269000
06055P,華通凱基97售04  ,0,0,0,0,0,0,0,0,0,-269000,0,0,0,116000,385000,-269000,-269000
053057,聯電國泰97購02  ,0,0,0,0,0,0,0,0,0,-269000,0,0,0,598000,867000,-269000,-269000
054910,信錦凱基97購01  ,0,0,0,0,0,0,0,0,0,-270000,0,0,0,0,270000,-270000,-270000
2855,統一證          ,0,263000,-263000,0,0,0,0,8000,-8000,0,0,0,0,0,0,0,-271000
060540,南亞凱基9A購01  ,0,0,0,0,0,0,0,0,0,-273000,0,0,0,82000,355000,-273000,-273000
07384P,大立光群益9A售01,0,0,0,0,0,0,0,0,0,-273000,0,0,0,1000,274000,-273000,-273000
055509,訊芯元大97購03  ,0,0,0,0,0,0,0,0,0,-273000,0,0,0,135000,408000,-273000,-273000
059829,超眾凱基99購05  ,0,0,0,0,0,0,0,0,0,-273000,0,0,0,68000,341000,-273000,-273000
05625P,國巨國票97售01  ,0,0,0,0,0,0,0,0,0,-274000,0,0,0,7000,281000,-274000,-274000
056916,台達電兆豐98購02,0,0,0,0,0,0,0,0,0,-274000,0,0,0,136000,410000,-274000,-274000
058154,泰碩統一9A購01  ,0,0,0,0,0,0,0,0,0,-275000,0,0,0,23000,298000,-275000,-275000
055874,中環元富9A購01  ,0,0,0,0,0,0,0,0,0,-276000,0,0,0,186000,462000,-276000,-276000
9933,中鼎            ,400000,651000,-251000,0,0,0,4000,0,4000,-29000,0,29000,-29000,0,0,0,-276000
2442,新美齊          ,27007,292000,-264993,0,0,0,0,0,0,-12000,0,12000,-12000,0,0,0,-276993
060042,台積電群益99購12,0,0,0,0,0,0,0,0,0,-277000,0,0,0,0,277000,-277000,-277000
055041,致新富邦97購01  ,0,0,0,0,0,0,0,0,0,-278000,0,0,0,38000,316000,-278000,-278000
055682,智原凱基98購02  ,0,0,0,0,0,0,0,0,0,-278000,0,0,0,12000,290000,-278000,-278000
05910P,力山永豐96售02  ,0,0,0,0,0,0,0,0,0,-279000,0,0,0,37000,316000,-279000,-279000
057724,亞德客國泰99購01,0,0,0,0,0,0,0,0,0,-280000,0,0,0,147000,427000,-280000,-280000
057592,美律兆豐99購01  ,0,0,0,0,0,0,0,0,0,-280000,0,0,0,0,280000,-280000,-280000
053505,瑞儀兆豐97購01  ,0,0,0,0,0,0,0,0,0,-281000,0,0,0,8000,289000,-281000,-281000
07634P,金像電元大9A售01,0,0,0,0,0,0,0,0,0,-282000,0,0,0,119000,401000,-282000,-282000
4977,眾達-KY         ,170000,496000,-326000,0,0,0,0,0,0,44000,51000,7000,44000,0,0,0,-282000
057650,力成元大98購04  ,0,0,0,0,0,0,0,0,0,-283000,0,0,0,72000,355000,-283000,-283000
3518,柏騰            ,239000,522000,-283000,0,0,0,0,0,0,0,0,0,0,0,0,0,-283000
060426,盛群永豐9A購01  ,0,0,0,0,0,0,0,0,0,-286000,0,0,0,0,286000,-286000,-286000
3437,榮創            ,302000,589000,-287000,0,0,0,0,0,0,0,0,0,0,0,0,0,-287000
07442P,華航康和9A售02  ,0,0,0,0,0,0,0,0,0,-289000,0,0,0,70000,359000,-289000,-289000
3019,亞光            ,301000,459000,-158000,0,0,0,0,0,0,-131000,5000,139000,-134000,14000,11000,3000,-289000
07434P,臺股指國票9A售06,0,0,0,0,0,0,0,0,0,-290000,0,0,0,0,290000,-290000,-290000
054690,新興永豐97購01  ,0,0,0,0,0,0,0,0,0,-290000,0,0,0,20000,310000,-290000,-290000
060796,世芯永豐9A購03  ,0,0,0,0,0,0,0,0,0,-292000,0,0,0,110000,402000,-292000,-292000
060279,SP黃豆元大9A購01,0,0,0,0,0,0,0,0,0,-293000,0,0,0,0,293000,-293000,-293000
3682,亞太電          ,260000,553000,-293000,0,0,0,0,0,0,0,0,0,0,0,0,0,-293000
052785,滬深2X中信99購03,0,0,0,0,0,0,0,0,0,-295000,0,0,0,0,295000,-295000,-295000
059948,正文永豐99購01  ,0,0,0,0,0,0,0,0,0,-295000,0,0,0,14000,309000,-295000,-295000
060696,道瓊反國泰9C購01,0,0,0,0,0,0,0,0,0,-296000,0,0,0,10000,306000,-296000,-296000
061293,聯茂統一9A購01  ,0,0,0,0,0,0,0,0,0,-296000,0,0,0,52000,348000,-296000,-296000
055404,超眾元富97購01  ,0,0,0,0,0,0,0,0,0,-296000,0,0,0,69000,365000,-296000,-296000
2897,王道銀行        ,74000,295000,-221000,0,0,0,0,0,0,-75000,0,75000,-75000,0,0,0,-296000
052917,大立光富邦99購02,0,0,0,0,0,0,0,0,0,-297000,0,0,0,0,297000,-297000,-297000
060886,國巨統一01購03  ,0,0,0,0,0,0,0,0,0,-299000,0,0,0,12000,311000,-299000,-299000
060423,智易永豐9A購01  ,0,0,0,0,0,0,0,0,0,-299000,0,0,0,89000,388000,-299000,-299000
057904,矽力永豐98購01  ,0,0,0,0,0,0,0,0,0,-299000,0,0,0,10000,309000,-299000,-299000
1723,中碳            ,149000,319000,-170000,0,0,0,0,122000,-122000,-8000,0,8000,-8000,0,0,0,-300000
055078,亞泥中信98購01  ,0,0,0,0,0,0,0,0,0,-300000,0,0,0,0,300000,-300000,-300000
051360,緯創元大95購03  ,0,0,0,0,0,0,0,0,0,-300000,0,0,0,0,300000,-300000,-300000
057873,義隆元大98購03  ,0,0,0,0,0,0,0,0,0,-300000,0,0,0,149000,449000,-300000,-300000
056653,元石油元大98購01,0,0,0,0,0,0,0,0,0,-300000,0,0,0,0,300000,-300000,-300000
058568,宏達電凱基9A購02,0,0,0,0,0,0,0,0,0,-300000,0,0,0,0,300000,-300000,-300000
3058,立德            ,5000,305000,-300000,0,0,0,0,0,0,0,0,0,0,0,0,0,-300000
059047,元油2X凱基9A購10,0,0,0,0,0,0,0,0,0,-301000,0,0,0,377000,678000,-301000,-301000
060197,臻鼎元富9A購02  ,0,0,0,0,0,0,0,0,0,-301000,0,0,0,324000,625000,-301000,-301000
056186,智原統一97購01  ,0,0,0,0,0,0,0,0,0,-301000,0,0,0,0,301000,-301000,-301000
059875,信邦凱基99購02  ,0,0,0,0,0,0,0,0,0,-302000,0,0,0,32000,334000,-302000,-302000
07342P,大立光凱基99售14,0,0,0,0,0,0,0,0,0,-303000,0,0,0,30000,333000,-303000,-303000
053297,鎧勝中信98購01  ,0,0,0,0,0,0,0,0,0,-304000,0,0,0,96000,400000,-304000,-304000
055891,鴻海統一9A購01  ,0,0,0,0,0,0,0,0,0,-304000,0,0,0,0,304000,-304000,-304000
3653,健策            ,240000,462000,-222000,0,0,0,45000,148000,-103000,21000,0,7000,-7000,52000,24000,28000,-304000
2357,華碩            ,1127000,1415680,-288680,0,0,0,4000,1000,3000,-19000,9000,17000,-8000,0,11000,-11000,-304680
060646,南電永豐9A購01  ,0,0,0,0,0,0,0,0,0,-305000,0,0,0,107000,412000,-305000,-305000
057625,泰鼎國泰9A購01  ,0,0,0,0,0,0,0,0,0,-305000,0,0,0,253000,558000,-305000,-305000
060815,茂林凱基9B購01  ,0,0,0,0,0,0,0,0,0,-307000,0,0,0,70000,377000,-307000,-307000
059865,國巨凱基01購01  ,0,0,0,0,0,0,0,0,0,-307000,0,0,0,188000,495000,-307000,-307000
057716,神達統一98購01  ,0,0,0,0,0,0,0,0,0,-308000,0,0,0,0,308000,-308000,-308000
5264,鎧勝-KY         ,292121,636000,-343879,0,0,0,0,0,0,35000,0,11000,-11000,46000,0,46000,-308879
2903,遠百            ,308715,581000,-272285,0,0,0,0,0,0,-38000,0,38000,-38000,0,0,0,-310285
053062,緯穎富邦97購01  ,0,0,0,0,0,0,0,0,0,-311000,0,0,0,10000,321000,-311000,-311000
059560,T50反1凱基99購08,0,0,0,0,0,0,0,0,0,-312000,0,0,0,657000,969000,-312000,-312000
07546P,玉晶光凱基9A售09,0,0,0,0,0,0,0,0,0,-315000,0,0,0,556000,871000,-315000,-315000
07536P,華新科元富9A售04,0,0,0,0,0,0,0,0,0,-316000,0,0,0,25000,341000,-316000,-316000
056979,微星群益98購01  ,2000,0,2000,0,0,0,0,0,0,-318000,0,0,0,7000,325000,-318000,-316000
061232,和大元大9A購03  ,0,0,0,0,0,0,0,0,0,-319000,0,0,0,7000,326000,-319000,-319000
059424,SGBR2X元大9A購01,0,0,0,0,0,0,0,0,0,-319000,0,0,0,114000,433000,-319000,-319000
061192,奇鋐永豐9A購01  ,0,0,0,0,0,0,0,0,0,-320000,0,0,0,0,320000,-320000,-320000
054535,旺宏富邦97購02  ,0,0,0,0,0,0,0,0,0,-320000,0,0,0,0,320000,-320000,-320000
060035,臺股指永豐99購04,0,0,0,0,0,0,0,0,0,-320000,0,0,0,0,320000,-320000,-320000
057393,台積電中信02購01,0,0,0,0,0,0,0,0,0,-320000,0,0,0,0,320000,-320000,-320000
5534,長虹            ,24000,334000,-310000,0,0,0,2000,1000,1000,-12000,0,12000,-12000,0,0,0,-321000
059814,SP黃豆凱基9A購02,0,0,0,0,0,0,0,0,0,-323000,0,0,0,610000,933000,-323000,-323000
047694,SP黃豆國票9B購01,0,0,0,0,0,0,0,0,0,-324000,0,0,0,0,324000,-324000,-324000
061283,智邦統一9A購01  ,0,0,0,0,0,0,0,0,0,-325000,0,0,0,0,325000,-325000,-325000
07187P,臺股指台新99售10,0,0,0,0,0,0,0,0,0,-325000,0,0,0,1000,326000,-325000,-325000
054079,鴻海中信98購02  ,0,0,0,0,0,0,0,0,0,-325000,0,0,0,1003000,1328000,-325000,-325000
06971P,台光電元大99售03,0,0,0,0,0,0,0,0,0,-330000,0,0,0,30000,360000,-330000,-330000
07458P,長榮航元大9A售01,0,0,0,0,0,0,0,0,0,-330000,0,0,0,205000,535000,-330000,-330000
00654R,富邦印度反1     ,0,0,0,0,0,0,0,0,0,-330000,0,0,0,0,330000,-330000,-330000
052986,聯發科元大97購05,0,0,0,0,0,0,0,0,0,-330000,0,0,0,25000,355000,-330000,-330000
00701,國泰股利精選30  ,65000,0,65000,0,0,0,0,0,0,-396000,0,0,0,509000,905000,-396000,-331000
053942,超眾國泰96購02  ,0,0,0,0,0,0,0,0,0,-331000,0,0,0,28000,359000,-331000,-331000
060204,矽創元富9A購01  ,0,0,0,0,0,0,0,0,0,-331000,0,0,0,165000,496000,-331000,-331000
6592,和潤企業        ,192000,504000,-312000,0,0,0,0,0,0,-21000,0,12000,-12000,7000,16000,-9000,-333000
057257,台泥兆豐99購01  ,0,0,0,0,0,0,0,0,0,-337000,0,0,0,81000,418000,-337000,-337000
055785,祥碩凱基97購02  ,0,0,0,0,0,0,0,0,0,-340000,0,0,0,14000,354000,-340000,-340000
058131,義隆元大99購02  ,0,0,0,0,0,0,0,0,0,-342000,0,0,0,232000,574000,-342000,-342000
1710,東聯            ,259000,491000,-232000,0,0,0,0,0,0,-114000,0,114000,-114000,0,0,0,-346000
055348,旺宏凱基97購01  ,0,0,0,0,0,0,0,0,0,-347000,0,0,0,4000,351000,-347000,-347000
3016,嘉晶            ,380000,691000,-311000,0,0,0,0,0,0,-36000,0,34000,-34000,42000,44000,-2000,-347000
5471,松翰            ,1244000,1640000,-396000,0,0,0,0,0,0,49000,50000,1000,49000,0,0,0,-347000
07597P,臺股指中信01售02,0,0,0,0,0,0,0,0,0,-348000,0,0,0,285000,633000,-348000,-348000
06673P,大立光群益98售01,0,0,0,0,0,0,0,0,0,-350000,0,0,0,0,350000,-350000,-350000
059693,智原永豐99購01  ,0,0,0,0,0,0,0,0,0,-350000,0,0,0,62000,412000,-350000,-350000
4414,如興            ,127000,462000,-335000,0,0,0,0,0,0,-16000,9000,25000,-16000,0,0,0,-351000
2344,華邦電          ,5510000,5810295,-300295,0,0,0,0,2000,-2000,-49000,114000,87000,27000,106000,182000,-76000,-351295
060899,超眾凱基9A購01  ,0,0,0,0,0,0,0,0,0,-352000,0,0,0,19000,371000,-352000,-352000
4938,和碩            ,6062751,6230870,-168119,0,0,0,0,4000,-4000,-180000,28000,195000,-167000,39000,52000,-13000,-352119
055419,國巨永豐97購03  ,0,0,0,0,0,0,0,0,0,-353000,0,0,0,407000,760000,-353000,-353000
058218,緯穎群益99購01  ,0,0,0,0,0,0,0,0,0,-356000,0,0,0,0,356000,-356000,-356000
052536,聯茂國泰97購01  ,0,0,0,0,0,0,0,0,0,-357000,0,0,0,4000,361000,-357000,-357000
057887,智原群益98購04  ,0,0,0,0,0,0,0,0,0,-359000,0,0,0,294000,653000,-359000,-359000
059650,緯穎凱基99購04  ,0,0,0,0,0,0,0,0,0,-367000,0,0,0,0,367000,-367000,-367000
4958,臻鼎-KY         ,1181000,1418560,-237560,0,0,0,0,121000,-121000,-9000,42000,62000,-20000,28000,17000,11000,-367560
052714,義隆凱基96購02  ,0,0,0,0,0,0,0,0,0,-368000,0,0,0,6000,374000,-368000,-368000
054852,奇鋐國票98購01  ,0,0,0,0,0,0,0,0,0,-371000,0,0,0,154000,525000,-371000,-371000
057674,台郡元大99購03  ,0,0,0,0,0,0,0,0,0,-371000,0,0,0,213000,584000,-371000,-371000
1722,台肥            ,256000,455000,-199000,0,0,0,3000,1000,2000,-178000,6000,184000,-178000,0,0,0,-375000
060079,台郡台新99購03  ,0,0,0,0,0,0,0,0,0,-376000,0,0,0,86000,462000,-376000,-376000
061113,南電元大9A購03  ,0,0,0,0,0,0,0,0,0,-379000,0,0,0,27000,406000,-379000,-379000
6531,愛普            ,541000,946001,-405001,0,0,0,10000,0,10000,15000,15000,0,15000,0,0,0,-380001
06085P,義隆台新97售01  ,0,0,0,0,0,0,0,0,0,-382000,0,0,0,10000,392000,-382000,-382000
061162,南電群益9A購02  ,0,0,0,0,0,0,0,0,0,-383000,0,0,0,98000,481000,-383000,-383000
07647P,健策國票9A售04  ,0,0,0,0,0,0,0,0,0,-383000,0,0,0,0,383000,-383000,-383000
058656,燿華中信99購01  ,0,0,0,0,0,0,0,0,0,-385000,0,0,0,80000,465000,-385000,-385000
3406,玉晶光          ,393000,586471,-193471,0,0,0,0,0,0,-194000,117000,265000,-148000,17000,63000,-46000,-387471
059647,超眾凱基99購04  ,0,0,0,0,0,0,0,0,0,-388000,0,0,0,114000,502000,-388000,-388000
060959,金像電凱基9A購01,0,0,0,0,0,0,0,0,0,-389000,0,0,0,122000,511000,-389000,-389000
060366,健策元富9A購01  ,0,0,0,0,0,0,0,0,0,-389000,0,0,0,119000,508000,-389000,-389000
057945,京鼎國票99購03  ,0,0,0,0,0,0,0,0,0,-390000,0,0,0,20000,410000,-390000,-390000
2867,三商壽          ,779545,1097000,-317455,0,0,0,0,0,0,-73000,4000,77000,-73000,0,0,0,-390455
055330,上銀兆豐98購02  ,0,0,0,0,0,0,0,0,0,-392000,0,0,0,40000,432000,-392000,-392000
05464P,華通康和95售02  ,0,0,0,0,0,0,0,0,0,-395000,0,0,0,10000,405000,-395000,-395000
05976P,國巨凱基96售14  ,0,0,0,0,0,0,0,0,0,-397000,0,0,0,25000,422000,-397000,-397000
07545P,玉晶光凱基9A售07,0,0,0,0,0,0,0,0,0,-400000,0,0,0,81000,481000,-400000,-400000
053107,旺宏兆豐97購01  ,0,0,0,0,0,0,0,0,0,-400000,0,0,0,0,400000,-400000,-400000
055862,矽力元大97購04  ,0,0,0,0,0,0,0,0,0,-400000,0,0,0,0,400000,-400000,-400000
053243,楠梓電國票97購02,0,0,0,0,0,0,0,0,0,-401000,0,0,0,0,401000,-401000,-401000
07700P,臺股指元大9A售53,0,0,0,0,0,0,0,0,0,-404000,0,0,0,131000,535000,-404000,-404000
3044,健鼎            ,418000,803000,-385000,0,0,0,0,0,0,-20000,22000,42000,-20000,0,0,0,-405000
060956,超眾群益9A購01  ,0,0,0,0,0,0,0,0,0,-407000,0,0,0,0,407000,-407000,-407000
06067P,華新科康和97售01,0,0,0,0,0,0,0,0,0,-408000,0,0,0,1612000,2020000,-408000,-408000
2027,大成鋼          ,580393,827000,-246607,0,0,0,6000,0,6000,-169000,0,51000,-51000,15000,133000,-118000,-409607
053509,華新群益98購01  ,0,0,0,0,0,0,0,0,0,-410000,0,0,0,0,410000,-410000,-410000
045873,元油2X元富98購04,0,0,0,0,0,0,0,0,0,-410000,0,0,0,0,410000,-410000,-410000
059943,信邦永豐99購01  ,0,0,0,0,0,0,0,0,0,-410000,0,0,0,61000,471000,-410000,-410000
060907,金像電元大9A購02,0,0,0,0,0,0,0,0,0,-411000,0,0,0,77000,488000,-411000,-411000
061168,力成兆豐9A購01  ,0,0,0,0,0,0,0,0,0,-411000,0,0,0,531000,942000,-411000,-411000
059862,全新群益99購04  ,0,0,0,0,0,0,0,0,0,-412000,0,0,0,5000,417000,-412000,-412000
054527,國巨統一97購03  ,0,0,0,0,0,0,0,0,0,-413000,0,0,0,31000,444000,-413000,-413000
056319,智原群益98購02  ,0,0,0,0,0,0,0,0,0,-414000,0,0,0,30000,444000,-414000,-414000
04479P,同欣電中信96售02,0,0,0,0,0,0,0,0,0,-414000,0,0,0,36000,450000,-414000,-414000
059767,矽力永豐99購01  ,0,0,0,0,0,0,0,0,0,-414000,0,0,0,20000,434000,-414000,-414000
3661,世芯-KY         ,1157000,1663000,-506000,0,0,0,150000,37000,113000,-26000,33000,54000,-21000,28000,33000,-5000,-419000
00692,富邦公司治理    ,13000,13000,0,0,0,0,0,0,0,-420000,0,0,0,1447000,1867000,-420000,-420000
053883,大立光中信98購02,0,0,0,0,0,0,0,0,0,-420000,0,0,0,0,420000,-420000,-420000
058413,義隆兆豐99購01  ,0,0,0,0,0,0,0,0,0,-420000,0,0,0,2000,422000,-420000,-420000
4943,康控-KY         ,309000,700000,-391000,0,0,0,0,0,0,-29000,38000,7000,31000,7000,67000,-60000,-420000
050171,臺指反元大97購03,0,0,0,0,0,0,0,0,0,-426000,0,0,0,45000,471000,-426000,-426000
055611,燿華國票98購02  ,0,0,0,0,0,0,0,0,0,-430000,0,0,0,0,430000,-430000,-430000
1762,中化生          ,510000,942000,-432000,0,0,0,0,0,0,0,0,0,0,0,0,0,-432000
057207,立積元富98購02  ,0,0,0,0,0,0,0,0,0,-432000,0,0,0,346000,778000,-432000,-432000
3413,京鼎            ,170000,697950,-527950,0,0,0,12000,0,12000,83000,36000,6000,30000,70000,17000,53000,-432950
07743P,智邦凱基9A售03  ,0,0,0,0,0,0,0,0,0,-436000,0,0,0,0,436000,-436000,-436000
053392,致新元大96購01  ,0,0,0,0,0,0,0,0,0,-437000,0,0,0,0,437000,-437000,-437000
2633,台灣高鐵        ,530001,1205980,-675979,0,0,0,300000,1000,299000,-62000,1000,68000,-67000,6000,1000,5000,-438979
061349,嘉澤元大9A購02  ,0,0,0,0,0,0,0,0,0,-439000,0,0,0,60000,499000,-439000,-439000
053638,信邦永豐96購01  ,0,0,0,0,0,0,0,0,0,-440000,0,0,0,0,440000,-440000,-440000
060539,道瓊反凱基9A購01,0,0,0,0,0,0,0,0,0,-442000,0,0,0,59000,501000,-442000,-442000
060737,瑞儀統一9C購01  ,0,0,0,0,0,0,0,0,0,-444000,0,0,0,28000,472000,-444000,-444000
060278,道瓊反元大9A購03,0,0,0,0,0,0,0,0,0,-445000,0,0,0,0,445000,-445000,-445000
1717,長興            ,167000,569000,-402000,0,0,0,0,0,0,-43000,0,43000,-43000,0,0,0,-445000
059128,友達中信99購02  ,0,0,0,0,0,0,0,0,0,-450000,0,0,0,87000,537000,-450000,-450000
056851,瑞儀元富98購01  ,0,0,0,0,0,0,0,0,0,-451000,0,0,0,73000,524000,-451000,-451000
2401,凌陽            ,97000,500000,-403000,0,0,0,0,0,0,-50000,2000,52000,-50000,0,0,0,-453000
058203,信邦凱基99購01  ,0,0,0,0,0,0,0,0,0,-453000,0,0,0,5000,458000,-453000,-453000
2102,泰豐            ,757198,1214000,-456802,0,0,0,0,0,0,3000,6000,3000,3000,0,0,0,-453802
058775,台積電國票9A購02,0,0,0,0,0,0,0,0,0,-455000,0,0,0,425000,880000,-455000,-455000
2367,燿華            ,2119000,2698000,-579000,0,0,0,0,2000,-2000,122000,0,16000,-16000,174000,36000,138000,-459000
050170,臺指反元大97購02,0,0,0,0,0,0,0,0,0,-460000,0,0,0,280000,740000,-460000,-460000
2812,台中銀          ,866504,1204000,-337496,0,0,0,0,3000,-3000,-121000,0,121000,-121000,0,0,0,-461496
057841,茂林富邦9A購02  ,0,0,0,0,0,0,0,0,0,-465000,0,0,0,1000,466000,-465000,-465000
055380,智易元大98購02  ,0,0,0,0,0,0,0,0,0,-466000,0,0,0,121000,587000,-466000,-466000
2634,漢翔            ,86000,536000,-450000,0,0,0,0,0,0,-18000,0,18000,-18000,0,0,0,-468000
058142,瑞儀元大99購01  ,15000,0,15000,0,0,0,0,0,0,-484000,0,0,0,222000,706000,-484000,-469000
054799,超眾群益98購01  ,0,0,0,0,0,0,0,0,0,-470000,0,0,0,0,470000,-470000,-470000
07010P,T50正2凱基9C售01,0,0,0,0,0,0,0,0,0,-472000,0,0,0,2000,474000,-472000,-472000
3043,科風            ,0,473000,-473000,0,0,0,0,0,0,0,0,0,0,0,0,0,-473000
052004,泰碩國泰97購03  ,0,0,0,0,0,0,0,0,0,-474000,0,0,0,2000,476000,-474000,-474000
059656,T50反1元大99購11,0,0,0,0,0,0,0,0,0,-476000,0,0,0,54000,530000,-476000,-476000
053394,鴻海中信9A購01  ,0,0,0,0,0,0,0,0,0,-480000,0,0,0,0,480000,-480000,-480000
056996,矽力日盛99購01  ,0,0,0,0,0,0,0,0,0,-492000,0,0,0,82000,574000,-492000,-492000
060143,台積電國票9B購03,0,0,0,0,0,0,0,0,0,-493000,0,0,0,12000,505000,-493000,-493000
051510,新光金中信97購01,0,0,0,0,0,0,0,0,0,-499000,0,0,0,0,499000,-499000,-499000
060142,臺指反國票9B購01,0,0,0,0,0,0,0,0,0,-499000,0,0,0,0,499000,-499000,-499000
057149,京鼎國票99購02  ,0,0,0,0,0,0,0,0,0,-499000,0,0,0,127000,626000,-499000,-499000
054229,超眾元富96購05  ,150000,0,150000,0,0,0,0,0,0,-656000,0,0,0,56000,712000,-656000,-506000
07473P,祥碩元大9A售01  ,0,0,0,0,0,0,0,0,0,-507000,0,0,0,66000,573000,-507000,-507000
2332,友訊            ,226000,587000,-361000,0,0,0,0,0,0,-147000,28000,69000,-41000,6000,112000,-106000,-508000
1229,聯華            ,278655,683000,-404345,0,0,0,6000,4000,2000,-106000,0,106000,-106000,0,0,0,-508345
060904,臺指反元大9C購07,0,0,0,0,0,0,0,0,0,-509000,0,0,0,0,509000,-509000,-509000
059974,臺指反元大9C購05,0,0,0,0,0,0,0,0,0,-509000,0,0,0,0,509000,-509000,-509000
2327,國巨            ,2055000,3075695,-1020695,0,0,0,558000,0,558000,-55000,81000,27000,54000,76000,185000,-109000,-517695
057009,信邦中信99購01  ,0,0,0,0,0,0,0,0,0,-519000,0,0,0,1000,520000,-519000,-519000
059815,SP黃豆凱基9A購03,0,0,0,0,0,0,0,0,0,-524000,0,0,0,0,524000,-524000,-524000
3702,大聯大          ,958000,1443561,-485561,0,0,0,8000,1000,7000,-46000,102000,54000,48000,0,94000,-94000,-524561
05467P,聯電元大95售02  ,0,0,0,0,0,0,0,0,0,-529000,0,0,0,202000,731000,-529000,-529000
060280,元金2X元大9A購01,0,0,0,0,0,0,0,0,0,-530000,0,0,0,60000,590000,-530000,-530000
053337,聯電國票97購01  ,0,0,0,0,0,0,0,0,0,-531000,0,0,0,10000,541000,-531000,-531000
057483,微星元大98購04  ,0,0,0,0,0,0,0,0,0,-531000,0,0,0,122000,653000,-531000,-531000
061114,南電元大9A購04  ,15000,0,15000,0,0,0,0,0,0,-550000,0,0,0,363000,913000,-550000,-535000
060302,台積電富邦02購01,0,0,0,0,0,0,0,0,0,-539000,0,0,0,222000,761000,-539000,-539000
052003,泰碩國泰97購02  ,0,0,0,0,0,0,0,0,0,-541000,0,0,0,89000,630000,-541000,-541000
061100,SP黃豆元大9A購04,0,0,0,0,0,0,0,0,0,-545000,0,0,0,15000,560000,-545000,-545000
07162P,臺股指群益99售13,0,0,0,0,0,0,0,0,0,-546000,0,0,0,343000,889000,-546000,-546000
06915P,晶技元富98售02  ,0,0,0,0,0,0,0,0,0,-547000,0,0,0,0,547000,-547000,-547000
03678C,臺股指凱基01牛02,0,0,0,0,0,0,0,0,0,-553000,0,0,0,1130000,1683000,-553000,-553000
056025,嘉晶群益97購01  ,0,0,0,0,0,0,0,0,0,-566000,0,0,0,0,566000,-566000,-566000
061159,同欣電群益9A購01,0,0,0,0,0,0,0,0,0,-575000,0,0,0,0,575000,-575000,-575000
1434,福懋            ,965000,1510065,-545065,0,0,0,5000,0,5000,-37000,18000,55000,-37000,0,0,0,-577065
061231,聚陽元大9A購02  ,0,0,0,0,0,0,0,0,0,-589000,0,0,0,0,589000,-589000,-589000
07282P,聯發科凱基99售17,0,0,0,0,0,0,0,0,0,-594000,0,0,0,76000,670000,-594000,-594000
060631,微星富邦9B購01  ,0,0,0,0,0,0,0,0,0,-595000,0,0,0,84000,679000,-595000,-595000
06852P,臺股指元大98售11,0,0,0,0,0,0,0,0,0,-596000,0,0,0,1238000,1834000,-596000,-596000
056931,智原台新98購01  ,0,0,0,0,0,0,0,0,0,-603000,0,0,0,0,603000,-603000,-603000
00634R,富邦上証反1     ,0,107000,-107000,0,0,0,0,0,0,-497000,0,0,0,120000,617000,-497000,-604000
053460,緯穎國泰97購01  ,0,0,0,0,0,0,0,0,0,-604000,0,0,0,0,604000,-604000,-604000
07685P,玉晶光凱基9B售03,0,0,0,0,0,0,0,0,0,-605000,0,0,0,0,605000,-605000,-605000
060920,超眾富邦9B購01  ,0,0,0,0,0,0,0,0,0,-608000,0,0,0,200000,808000,-608000,-608000
07468P,聯電元大9A售02  ,0,0,0,0,0,0,0,0,0,-610000,0,0,0,0,610000,-610000,-610000
5522,遠雄            ,122000,621476,-499476,0,0,0,1000,0,1000,-115000,0,115000,-115000,0,0,0,-613476
2379,瑞昱            ,1241000,2240720,-999720,0,0,0,440000,1000,439000,-56000,91000,37000,54000,8000,118000,-110000,-616720
8213,志超            ,78000,517000,-439000,0,0,0,0,2000,-2000,-182000,0,0,0,0,182000,-182000,-623000
07585P,台灣50中信03售06,0,0,0,0,0,0,0,0,0,-623000,0,0,0,300000,923000,-623000,-623000
059533,富邦金凱基99購01,0,0,0,0,0,0,0,0,0,-623000,0,0,0,61000,684000,-623000,-623000
2889,國票金          ,30101,555000,-524899,0,0,0,0,3000,-3000,-96000,30000,126000,-96000,0,0,0,-623899
056829,台積電富邦9A購01,0,0,0,0,0,0,0,0,0,-625000,0,0,0,472000,1097000,-625000,-625000
061164,燿華兆豐9B購01  ,0,0,0,0,0,0,0,0,0,-627000,0,0,0,50000,677000,-627000,-627000
058134,信邦元大99購01  ,0,0,0,0,0,0,0,0,0,-628000,0,0,0,33000,661000,-628000,-628000
4967,十銓            ,286000,928000,-642000,0,0,0,0,0,0,14000,20000,6000,14000,0,0,0,-628000
059069,臺指反元大9C購01,0,0,0,0,0,0,0,0,0,-634000,0,0,0,549000,1183000,-634000,-634000
055657,超眾元富97購02  ,0,0,0,0,0,0,0,0,0,-643000,0,0,0,284000,927000,-643000,-643000
057969,緯穎國泰99購01  ,0,0,0,0,0,0,0,0,0,-651000,0,0,0,21000,672000,-651000,-651000
056571,燿華元大98購02  ,0,0,0,0,0,0,0,0,0,-656000,0,0,0,18000,674000,-656000,-656000
3380,明泰            ,124000,466000,-342000,0,0,0,0,0,0,-316000,90000,253000,-163000,15000,168000,-153000,-658000
4746,台耀            ,561000,1232175,-671175,0,0,0,0,0,0,-2000,1000,3000,-2000,0,0,0,-673175
6176,瑞儀            ,1182000,2135703,-953703,0,0,0,0,41000,-41000,319000,369000,109000,260000,98000,39000,59000,-675703
054533,泰碩國泰98購01  ,0,0,0,0,0,0,0,0,0,-676000,0,0,0,56000,732000,-676000,-676000
059307,T50反1元大99購06,0,0,0,0,0,0,0,0,0,-686000,0,0,0,216000,902000,-686000,-686000
052463,聯電統一96購01  ,0,0,0,0,0,0,0,0,0,-689000,0,0,0,20000,709000,-689000,-689000
6505,台塑化          ,1181000,2043945,-862945,0,0,0,180000,9000,171000,0,0,0,0,0,0,0,-691945
2890,永豐金          ,8823000,9057375,-234375,0,0,0,54000,12000,42000,-500000,0,500000,-500000,0,0,0,-692375
053072,國巨台新97購01  ,0,0,0,0,0,0,0,0,0,-694000,0,0,0,27000,721000,-694000,-694000
6278,台表科          ,1957000,2102000,-145000,0,0,0,136000,548000,-412000,-138000,12000,91000,-79000,9000,68000,-59000,-695000
1305,華夏            ,632000,1160296,-528296,0,0,0,0,151000,-151000,-20000,0,20000,-20000,0,0,0,-699296
2542,興富發          ,658000,1337940,-679940,0,0,0,4000,0,4000,-29000,45000,74000,-29000,0,0,0,-704940
00635U,元大S&P黃金     ,38000,1000,37000,0,0,0,0,0,0,-742000,0,0,0,395000,1137000,-742000,-705000
038489,T50反1台新9A購01,0,0,0,0,0,0,0,0,0,-730000,0,0,0,0,730000,-730000,-730000
07292P,臺股指凱基99售44,0,0,0,0,0,0,0,0,0,-731000,0,0,0,250000,981000,-731000,-731000
07014P,華通元大99售04  ,0,0,0,0,0,0,0,0,0,-735000,0,0,0,68000,803000,-735000,-735000
061024,南電國泰9B購01  ,0,0,0,0,0,0,0,0,0,-738000,0,0,0,307000,1045000,-738000,-738000
061026,南電富邦9B購01  ,0,0,0,0,0,0,0,0,0,-740000,0,0,0,52000,792000,-740000,-740000
058918,SGBR2X元富99購04,0,0,0,0,0,0,0,0,0,-740000,0,0,0,15000,755000,-740000,-740000
06477P,緯穎國票99售02  ,0,0,0,0,0,0,0,0,0,-743000,0,0,0,147000,890000,-743000,-743000
057270,遠東新元大98購01,0,0,0,0,0,0,0,0,0,-748000,0,0,0,252000,1000000,-748000,-748000
2498,宏達電          ,553000,1039000,-486000,0,0,0,0,0,0,-271000,0,176000,-176000,8000,103000,-95000,-757000
057941,聯電國票99購01  ,0,0,0,0,0,0,0,0,0,-759000,0,0,0,47000,806000,-759000,-759000
00850,元大臺灣ESG永續 ,0,0,0,0,0,0,0,0,0,-764000,0,0,0,378000,1142000,-764000,-764000
1314,中石化          ,2068450,2595000,-526550,0,0,0,0,0,0,-240000,0,242000,-242000,60000,58000,2000,-766550
2610,華航            ,3161000,4318000,-1157000,0,0,0,0,10000,-10000,395000,0,105000,-105000,500000,0,500000,-772000
059841,國巨富邦9C購01  ,5000,0,5000,0,0,0,0,0,0,-790000,0,0,0,289000,1079000,-790000,-785000
05873P,華通群益97售02  ,0,0,0,0,0,0,0,0,0,-791000,0,0,0,249000,1040000,-791000,-791000
060093,友達元大03購01  ,0,0,0,0,0,0,0,0,0,-797000,0,0,0,407000,1204000,-797000,-797000
060046,S&P反1凱基99購02,0,0,0,0,0,0,0,0,0,-810000,0,0,0,0,810000,-810000,-810000
056855,祥碩中信98購02  ,0,0,0,0,0,0,0,0,0,-819000,0,0,0,160000,979000,-819000,-819000
2342,茂矽            ,218562,1046000,-827438,0,0,0,0,0,0,-3000,0,3000,-3000,0,0,0,-830438
6153,嘉聯益          ,423273,1090000,-666727,0,0,0,0,0,0,-171000,9000,33000,-24000,17000,164000,-147000,-837727
3231,緯創            ,4057569,4669195,-611626,0,0,0,0,3000,-3000,-234000,36000,176000,-140000,44000,138000,-94000,-848626
060957,SP黃豆凱基9A購04,0,0,0,0,0,0,0,0,0,-872000,0,0,0,0,872000,-872000,-872000
060186,義隆元富9A購01  ,0,0,0,0,0,0,0,0,0,-872000,0,0,0,275000,1147000,-872000,-872000
4904,遠傳            ,950000,1804695,-854695,0,0,0,16000,2000,14000,-34000,0,31000,-31000,0,3000,-3000,-874695
07334P,臺股指國票99售19,0,0,0,0,0,0,0,0,0,-883000,0,0,0,183000,1066000,-883000,-883000
058547,世紀鋼富邦9A購01,0,0,0,0,0,0,0,0,0,-901000,0,0,0,34000,935000,-901000,-901000
060852,京鼎國泰9B購01  ,0,0,0,0,0,0,0,0,0,-918000,0,0,0,237000,1155000,-918000,-918000
2371,大同            ,2208000,2824120,-616120,0,0,0,0,0,0,-332000,2000,334000,-332000,0,0,0,-948120
054374,信邦中信96購01  ,0,0,0,0,0,0,0,0,0,-952000,0,0,0,0,952000,-952000,-952000
2308,台達電          ,3362000,4350045,-988045,0,0,0,100000,2000,98000,-66000,12000,61000,-49000,17000,34000,-17000,-956045
4915,致伸            ,393000,1334300,-941300,0,0,0,0,1000,-1000,-17000,0,8000,-8000,1000,10000,-9000,-959300
049235,元油2X元富96購05,0,0,0,0,0,0,0,0,0,-965000,0,0,0,0,965000,-965000,-965000
5469,瀚宇博          ,302522,1161000,-858478,0,0,0,0,3000,-3000,-114000,0,0,0,34000,148000,-114000,-975478
5876,上海商銀        ,907000,1885040,-978040,0,0,0,0,4000,-4000,-5000,7000,6000,1000,1000,7000,-6000,-987040
059397,T50反1元富99購05,0,0,0,0,0,0,0,0,0,-1000000,0,0,0,84000,1084000,-1000000,-1000000
2352,佳世達          ,833000,1610000,-777000,0,0,0,7000,205000,-198000,-30000,18000,48000,-30000,10000,10000,0,-1005000
2883,開發金          ,8825000,9560905,-735905,0,0,0,0,6000,-6000,-268000,26000,318000,-292000,30000,6000,24000,-1009905
060023,T50反1國泰9A購03,75000,0,75000,0,0,0,0,0,0,-1085000,0,0,0,0,1085000,-1085000,-1010000
057328,京鼎群益99購02  ,0,0,0,0,0,0,0,0,0,-1015000,0,0,0,98000,1113000,-1015000,-1015000
057696,聯電群益9A購01  ,0,0,0,0,0,0,0,0,0,-1026000,0,0,0,601000,1627000,-1026000,-1026000
054532,強茂國泰98購01  ,0,0,0,0,0,0,0,0,0,-1028000,0,0,0,930000,1958000,-1028000,-1028000
1515,力山            ,300000,1317000,-1017000,0,0,0,0,0,0,-12000,14000,11000,3000,21000,36000,-15000,-1029000
00712,FH富時不動產    ,0,825000,-825000,0,0,0,0,0,0,-222000,0,0,0,36000,258000,-222000,-1047000
3515,華擎            ,303000,1298000,-995000,0,0,0,171000,3000,168000,-225000,10000,12000,-2000,17000,240000,-223000,-1052000
03440B,臺股指元大9B熊02,0,0,0,0,0,0,0,0,0,-1054000,0,0,0,1321000,2375000,-1054000,-1054000
061142,南電統一9A購01  ,0,0,0,0,0,0,0,0,0,-1093000,0,0,0,11000,1104000,-1093000,-1093000
061021,聯電國泰9B購01  ,0,0,0,0,0,0,0,0,0,-1125000,0,0,0,747000,1872000,-1125000,-1125000
00671R,富邦NASDAQ反1   ,1000,0,1000,0,0,0,0,0,0,-1127000,0,0,0,511000,1638000,-1127000,-1126000
2882,國泰金          ,4518000,5751332,-1233332,0,0,0,60000,13000,47000,57000,8000,0,8000,77000,28000,49000,-1129332
053524,聯電中信97購02  ,0,0,0,0,0,0,0,0,0,-1211000,0,0,0,0,1211000,-1211000,-1211000
047962,T50反1中信96購02,0,0,0,0,0,0,0,0,0,-1235000,0,0,0,289000,1524000,-1235000,-1235000
057532,智原元大98購03  ,0,0,0,0,0,0,0,0,0,-1238000,0,0,0,278000,1516000,-1238000,-1238000
3711,日月光投控      ,5411500,6133122,-721622,0,0,0,0,444000,-444000,-74000,0,75000,-75000,2000,1000,1000,-1239622
9958,世紀鋼          ,252000,397000,-145000,0,0,0,0,1095000,-1095000,-17000,36000,22000,14000,25000,56000,-31000,-1257000
6251,定穎            ,2813000,3862000,-1049000,0,0,0,0,4000,-4000,-213000,115000,328000,-213000,0,0,0,-1266000
3017,奇鋐            ,926000,2613000,-1687000,0,0,0,330000,0,330000,77000,270000,79000,191000,59000,173000,-114000,-1280000
060937,T50反1國票9A購10,26000,0,26000,0,0,0,0,0,0,-1324000,0,0,0,165000,1489000,-1324000,-1298000
3706,神達            ,323700,1432000,-1108300,0,0,0,0,209000,-209000,3000,0,32000,-32000,56000,21000,35000,-1314300
060294,嘉澤元大9A購01  ,0,0,0,0,0,0,0,0,0,-1333000,0,0,0,207000,1540000,-1333000,-1333000
2312,金寶            ,1723000,3134000,-1411000,0,0,0,0,3000,-3000,50000,0,8000,-8000,98000,40000,58000,-1364000
0050,元大台灣50      ,399150,1281000,-881850,0,0,0,32000,0,32000,-518000,136000,324000,-188000,4002000,4332000,-330000,-1367850
4927,泰鼎-KY         ,845000,2291000,-1446000,0,0,0,846000,879000,-33000,105000,407000,26000,381000,66000,342000,-276000,-1374000
2478,大毅            ,889000,2307250,-1418250,0,0,0,0,0,0,18000,90000,23000,67000,20000,69000,-49000,-1400250
3450,聯鈞            ,594300,2000000,-1405700,0,0,0,30000,0,30000,-32000,81000,87000,-6000,93000,119000,-26000,-1407700
1402,遠東新          ,2711000,4209810,-1498810,0,0,0,0,4000,-4000,-45000,25000,113000,-88000,43000,0,43000,-1547810
00875,國泰網路資安    ,0,5000,-5000,0,0,0,0,0,0,-1552000,0,0,0,333000,1885000,-1552000,-1557000
3189,景碩            ,999000,1651000,-652000,0,0,0,160000,880000,-720000,-195000,1000,32000,-31000,6000,170000,-164000,-1567000
2449,京元電子        ,508000,2016522,-1508522,0,0,0,0,4000,-4000,-57000,141000,145000,-4000,114000,167000,-53000,-1569522
3045,台灣大          ,1000000,2644755,-1644755,0,0,0,9000,3000,6000,-27000,3000,30000,-27000,0,0,0,-1665755
2106,建大            ,154000,1865142,-1711142,0,0,0,0,1000,-1000,-21000,0,21000,-21000,0,0,0,-1733142
1216,統一            ,5633328,7210000,-1576672,0,0,0,36000,195000,-159000,-8000,4000,12000,-8000,0,0,0,-1743672
2002,中鋼            ,5696080,7163345,-1467265,0,0,0,0,329000,-329000,-56000,12000,68000,-56000,0,0,0,-1852265
060226,道瓊反元大9A購01,0,0,0,0,0,0,0,0,0,-1869000,0,0,0,0,1869000,-1869000,-1869000
1504,東元            ,413000,2223000,-1810000,0,0,0,0,1000,-1000,-73000,0,73000,-73000,0,0,0,-1884000
00648R,元大S&P500反1   ,2000,2000,0,0,0,0,0,0,0,-1904000,0,0,0,98000,2002000,-1904000,-1904000
6116,彩晶            ,937000,2357000,-1420000,0,0,0,0,0,0,-498000,2000,345000,-343000,38000,193000,-155000,-1918000
060821,SP黃豆元大9A購02,0,0,0,0,0,0,0,0,0,-2008000,0,0,0,0,2008000,-2008000,-2008000
1326,台化            ,3017150,5016655,-1999505,0,0,0,18000,4000,14000,-63000,19000,38000,-19000,0,44000,-44000,-2048505
2317,鴻海            ,14082701,15996951,-1914250,0,0,0,500000,13000,487000,-675000,40000,366000,-326000,287000,636000,-349000,-2102250
1605,華新            ,1224000,2927000,-1703000,0,0,0,16000,0,16000,-471000,8000,200000,-192000,19000,298000,-279000,-2158000
9904,寶成            ,4043872,6261801,-2217929,0,0,0,0,3000,-3000,-77000,10000,87000,-77000,0,0,0,-2297929
8150,南茂            ,587000,2853448,-2266448,0,0,0,0,0,0,-85000,43000,23000,20000,21000,126000,-105000,-2351448
07478P,南電康和9A售02  ,0,0,0,0,0,0,0,0,0,-2405000,0,0,0,236000,2641000,-2405000,-2405000
00708L,元大S&P黃金正2  ,632000,0,632000,0,0,0,0,0,0,-3226000,0,0,0,2402000,5628000,-3226000,-2594000
2324,仁寶            ,9000215,11425629,-2425414,0,0,0,21000,0,21000,-269000,4000,100000,-96000,0,173000,-173000,-2673414
2408,南亞科          ,4055000,6087229,-2032229,0,0,0,0,422000,-422000,-526000,0,159000,-159000,19000,386000,-367000,-2980229
2412,中華電          ,2225000,5222065,-2997065,0,0,0,0,6000,-6000,-49000,1000,50000,-49000,0,0,0,-3052065
00669R,國泰美國道瓊反1 ,137000,576000,-439000,0,0,0,0,0,0,-3168000,0,0,0,1194000,4362000,-3168000,-3607000
2834,臺企銀          ,3639000,7080916,-3441916,0,0,0,0,1000,-1000,-241000,0,235000,-235000,0,6000,-6000,-3683916
2313,華通            ,2312000,4235933,-1923933,0,0,0,558000,1003000,-445000,-1337000,466000,1126000,-660000,42000,719000,-677000,-3705933
2492,華新科          ,1377000,4263021,-2886021,0,0,0,52000,92000,-40000,-817000,252000,402000,-150000,77000,744000,-667000,-3743021
2880,華南金          ,3375542,7147481,-3771939,0,0,0,0,15000,-15000,-11000,0,11000,-11000,0,0,0,-3797939
2618,長榮航          ,2112300,5959820,-3847520,0,0,0,0,2000,-2000,-70000,48000,188000,-140000,70000,0,70000,-3919520
2356,英業達          ,4207479,8071456,-3863977,0,0,0,15000,0,15000,-152000,32000,95000,-63000,67000,156000,-89000,-4000977
2103,台橡            ,1039000,5345450,-4306450,0,0,0,0,0,0,-20000,0,20000,-20000,0,0,0,-4326450
2337,旺宏            ,4093400,9580000,-5486600,0,0,0,1521000,1000,1520000,-609000,900000,468000,432000,370000,1411000,-1041000,-4575600
00672L,元大S&P原油正2  ,0,0,0,0,0,0,0,0,0,-5009000,0,0,0,359000,5368000,-5009000,-5009000
2801,彰銀            ,3639000,8792283,-5153283,0,0,0,0,12000,-12000,-10000,1000,1000,0,0,10000,-10000,-5175283
2409,友達            ,9764000,13598135,-3834135,0,0,0,0,0,0,-1546000,35000,450000,-415000,384000,1515000,-1131000,-5380135
2884,玉山金          ,8849000,14562987,-5713987,0,0,0,0,121000,-121000,-79000,3000,101000,-98000,34000,15000,19000,-5913987
2888,新光金          ,10215000,16378950,-6163950,0,0,0,0,3000,-3000,-132000,104000,234000,-130000,332000,334000,-2000,-6298950
2887,台新金          ,3929000,10211106,-6282106,0,0,0,0,164751,-164751,-203000,2000,203000,-201000,2000,4000,-2000,-6649857
2885,元大金          ,7905000,14780854,-6875854,0,0,0,62000,11000,51000,41000,45000,4000,41000,0,0,0,-6783854
5880,合庫金          ,4940000,14342460,-9402460,0,0,0,0,9000,-9000,-35000,1000,12000,-11000,0,24000,-24000,-9446460
2892,第一金          ,7115000,16080606,-8965606,0,0,0,0,37000,-37000,-511000,49000,598000,-549000,62000,24000,38000,-9513606
2886,兆豐金          ,5619000,15626405,-10007405,0,0,0,136000,15000,121000,-115000,34000,24000,10000,4000,129000,-125000,-10001405
00642U,元大S&P石油     ,31000,0,31000,0,0,0,0,0,0,-12509000,0,0,0,1359000,13868000,-12509000,-12478000
2891,中信金          ,11935000,23692825,-11757825,0,0,0,0,1429000,-1429000,-91000,3000,126000,-123000,35000,3000,32000,-13277825
00632R,元大台灣50反1   ,4807000,11000,4796000,0,0,0,0,0,0,-19149000,3866000,1778000,2088000,29937000,51174000,-21237000,-14353000
00693U,街口S&P黃豆     ,27000,0,27000,0,0,0,0,0,0,-14726000,0,0,0,889000,15615000,-14726000,-14699000
00677U,富邦VIX         ,12591000,40009000,-27418000,0,0,0,0,0,0,-6446000,472000,600000,-128000,9753000,16071000,-6318000,-33864000
