證券代號,證券名稱,外陸資買進股數(不含外資自營商),外陸資賣出股數(不含外資自營商),外陸資買賣超股數(不含外資自營商),外資自營商買進股數,外資自營商賣出股數,外資自營商買賣超股數,投信買進股數,投信賣出股數,投信買賣超股數,自營商買賣超股數,自營商買進股數(自行買賣),自營商賣出股數(自行買賣),自營商買賣超股數(自行買賣),自營商買進股數(避險),自營商賣出股數(避險),自營商買賣超股數(避險),三大法人買賣超股數
00677U,富邦VIX         ,226064000,185401000,40663000,0,0,0,0,0,0,119824000,14852000,2235000,12617000,112772000,5565000,107207000,160487000
00632R,元大台灣50反1   ,25357000,8956000,16401000,0,0,0,682000,0,682000,69114000,4820000,6632000,-1812000,127840000,56914000,70926000,86197000
03091X,元展85          ,0,0,0,0,0,0,0,0,0,10239000,0,0,0,10239000,0,10239000,10239000
00669R,國泰美國道瓊反1 ,0,23000,-23000,0,0,0,0,0,0,9474000,0,0,0,11216000,1742000,9474000,9451000
00648R,元大S&P500反1   ,0,65000,-65000,0,0,0,501000,0,501000,7069000,0,0,0,7617000,548000,7069000,7505000
00672L,元大S&P原油正2  ,1949000,4747000,-2798000,0,0,0,0,0,0,9962000,0,0,0,13507000,3545000,9962000,7164000
1605,華新            ,5857000,5762000,95000,0,0,0,14000,0,14000,6460000,1307000,356000,951000,5552000,43000,5509000,6569000
00671R,富邦NASDAQ反1   ,0,0,0,0,0,0,0,0,0,6502000,0,0,0,7444000,942000,6502000,6502000
2449,京元電子        ,5074000,4845000,229000,0,0,0,1158000,0,1158000,2390000,1001000,95000,906000,1655000,171000,1484000,3777000
058686,祥碩凱基99購03  ,0,0,0,0,0,0,0,0,0,3731000,0,0,0,3849000,118000,3731000,3731000
3049,和鑫            ,7187000,3629000,3558000,0,0,0,0,0,0,-50000,0,2000,-2000,1000,49000,-48000,3508000
2027,大成鋼          ,2096000,1002019,1093981,0,0,0,0,0,0,1754604,35000,243000,-208000,2120000,157396,1962604,2848585
2303,聯電            ,75769281,71936786,3832495,0,0,0,160000,0,160000,-1358000,1842000,2227000,-385000,166000,1139000,-973000,2634495
056914,臺股指元大99購09,0,0,0,0,0,0,0,0,0,2300000,0,0,0,2319000,19000,2300000,2300000
051997,康友元大95購02  ,0,0,0,0,0,0,0,0,0,2146000,0,0,0,2196000,50000,2146000,2146000
00640L,富邦日本正2     ,233000,1000,232000,0,0,0,0,0,0,1817000,0,0,0,2227000,410000,1817000,2049000
00664R,國泰臺灣加權反1 ,0,0,0,0,0,0,0,0,0,2025000,0,0,0,4607000,2582000,2025000,2025000
2915,潤泰全          ,2775500,1578000,1197500,0,0,0,0,0,0,616000,8000,164000,-156000,883000,111000,772000,1813500
00634R,富邦上証反1     ,442000,0,442000,0,0,0,0,0,0,1353000,200000,0,200000,2895000,1742000,1153000,1795000
0061,元大寶滬深      ,4895000,10000,4885000,0,0,0,0,0,0,-3091000,110000,650000,-540000,251000,2802000,-2551000,1794000
3576,聯合再生        ,2079000,309000,1770000,0,0,0,0,0,0,-5000,1000,6000,-5000,0,0,0,1765000
056977,國巨群益9A購01  ,0,0,0,0,0,0,0,0,0,1712000,0,0,0,1732000,20000,1712000,1712000
4927,泰鼎-KY         ,2459000,1437000,1022000,0,0,0,877000,0,877000,-199000,29000,120000,-91000,128000,236000,-108000,1700000
045479,T50反1中信95購01,0,0,0,0,0,0,0,0,0,1600000,0,0,0,1633000,33000,1600000,1600000
058941,華新科中信99購03,0,0,0,0,0,0,0,0,0,1575000,0,0,0,1846000,271000,1575000,1575000
3406,玉晶光          ,3177123,1177000,2000123,0,0,0,0,325000,-325000,-120000,469000,452000,17000,51000,188000,-137000,1555123
050786,健策國泰96購01  ,0,0,0,0,0,0,0,0,0,1541000,0,0,0,1575000,34000,1541000,1541000
058191,祥碩永豐99購01  ,0,0,0,0,0,0,0,0,0,1477000,0,0,0,1718000,241000,1477000,1477000
057269,鈺齊兆豐98購01  ,0,0,0,0,0,0,0,0,0,1406000,0,0,0,1406000,0,1406000,1406000
058174,台積電凱基9A購05,0,0,0,0,0,0,0,0,0,1397000,0,0,0,2256000,859000,1397000,1397000
8046,南電            ,1529000,3541000,-2012000,0,0,0,3388000,0,3388000,19000,158000,134000,24000,139000,144000,-5000,1395000
056597,宏碁元富98購01  ,0,0,0,0,0,0,0,0,0,1388000,0,0,0,1388000,0,1388000,1388000
05180P,玉晶光凱基95售04,0,0,0,0,0,0,0,0,0,1352000,0,0,0,1611000,259000,1352000,1352000
9935,慶豐富          ,1682000,350000,1332000,0,0,0,0,0,0,0,0,0,0,0,0,0,1332000
056835,聯電元富99購01  ,0,0,0,0,0,0,0,0,0,1284000,0,0,0,1525000,241000,1284000,1284000
054311,世芯凱基96購02  ,0,0,0,0,0,0,0,0,0,1242000,0,0,0,1242000,0,1242000,1242000
058663,瑞儀兆豐9A購01  ,0,0,0,0,0,0,0,0,0,1230000,0,0,0,1295000,65000,1230000,1230000
5264,鎧勝-KY         ,1249000,732000,517000,0,0,0,750000,0,750000,-67000,0,49000,-49000,0,18000,-18000,1200000
059179,祥碩元富99購01  ,0,0,0,0,0,0,0,0,0,1138000,0,0,0,1832000,694000,1138000,1138000
049251,國巨元大95購02  ,0,0,0,0,0,0,0,0,0,1101000,0,0,0,1270000,169000,1101000,1101000
050235,國巨凱基94購11  ,0,0,0,0,0,0,0,0,0,1099000,0,0,0,1526000,427000,1099000,1099000
9958,世紀鋼          ,1969000,901000,1068000,0,0,0,113000,0,113000,-82000,38000,84000,-46000,167000,203000,-36000,1099000
059000,台積電元大99購25,0,0,0,0,0,0,0,0,0,1092000,0,0,0,1843000,751000,1092000,1092000
058934,台灣50中信03購03,0,0,0,0,0,0,0,0,0,1086000,0,0,0,1126000,40000,1086000,1086000
03050X,元展47          ,0,0,0,0,0,0,0,0,0,1067000,0,0,0,1338000,271000,1067000,1067000
2492,華新科          ,3300124,2643287,656837,0,0,0,0,0,0,383000,783000,709000,74000,557000,248000,309000,1039837
052269,T50反1日盛9B購01,0,0,0,0,0,0,0,0,0,1039000,0,0,0,1069000,30000,1039000,1039000
03526P,欣興凱基02售13  ,0,0,0,0,0,0,0,0,0,1000000,0,0,0,1000000,0,1000000,1000000
050679,上証2X元富97購02,0,0,0,0,0,0,0,0,0,998000,0,0,0,998000,0,998000,998000
2360,致茂            ,2350258,1139000,1211258,0,0,0,0,172000,-172000,-47000,42000,86000,-44000,11000,14000,-3000,992258
6213,聯茂            ,2525164,1651000,874164,0,0,0,981000,616000,365000,-249000,136000,312000,-176000,49000,122000,-73000,990164
049972,南電國票95購02  ,0,0,0,0,0,0,0,0,0,988000,0,0,0,988000,0,988000,988000
059171,祥碩凱基99購04  ,0,0,0,0,0,0,0,0,0,987000,0,0,0,1177000,190000,987000,987000
052107,台積電統一95購06,0,0,0,0,0,0,0,0,0,986000,0,0,0,986000,0,986000,986000
6230,超眾            ,1342099,432000,910099,0,0,0,58000,0,58000,12000,15000,30000,-15000,37000,10000,27000,980099
03638C,T50反1元大94牛03,0,70000,-70000,0,0,0,0,0,0,1043000,0,0,0,1254000,211000,1043000,973000
050797,聯發科中信99購01,0,0,0,0,0,0,0,0,0,970000,0,0,0,1020000,50000,970000,970000
044974,鴻海國票94購01  ,0,0,0,0,0,0,0,0,0,951000,0,0,0,951000,0,951000,951000
2347,聯強            ,5413200,6051034,-637834,0,0,0,300000,0,300000,1278000,25000,193000,-168000,1446000,0,1446000,940166
057149,京鼎國票99購02  ,0,0,0,0,0,0,0,0,0,937000,0,0,0,947000,10000,937000,937000
055363,緯穎凱基98購03  ,0,0,0,0,0,0,0,0,0,913000,0,0,0,954000,41000,913000,913000
045817,滬深2X凱基95購02,0,0,0,0,0,0,0,0,0,910000,0,0,0,910000,0,910000,910000
056412,上証2X中信9A購02,0,0,0,0,0,0,0,0,0,895000,0,0,0,1075000,180000,895000,895000
4142,國光生          ,2398000,1741000,657000,0,0,0,0,0,0,214000,288000,74000,214000,0,0,0,871000
058921,聯發科元富03購01,0,0,0,0,0,0,0,0,0,861000,0,0,0,1019000,158000,861000,861000
04814P,健策元大96售01  ,0,0,0,0,0,0,0,0,0,845000,0,0,0,970000,125000,845000,845000
056878,元油2X國票99購02,0,0,0,0,0,0,0,0,0,839000,0,0,0,839000,0,839000,839000
03016P,滬深2X群益01售09,0,0,0,0,0,0,0,0,0,832000,0,0,0,832000,0,832000,832000
054859,鴻海群益97購02  ,0,0,0,0,0,0,0,0,0,817000,0,0,0,837000,20000,817000,817000
04215P,鴻海國票93售02  ,0,0,0,0,0,0,0,0,0,811000,0,0,0,811000,0,811000,811000
057263,可成兆豐99購01  ,0,0,0,0,0,0,0,0,0,805000,0,0,0,970000,165000,805000,805000
050551,大立光凱基95購05,0,0,0,0,0,0,0,0,0,790000,0,0,0,790000,0,790000,790000
057513,智邦台新98購01  ,0,0,0,0,0,0,0,0,0,786000,0,0,0,831000,45000,786000,786000
056612,台積電永豐98購01,0,0,0,0,0,0,0,0,0,750000,0,0,0,750000,0,750000,750000
057069,台積電永豐98購02,0,0,0,0,0,0,0,0,0,733000,0,0,0,733000,0,733000,733000
04168P,元金2X凱基99售01,0,0,0,0,0,0,0,0,0,732000,0,0,0,732000,0,732000,732000
056413,上証反中信9A購01,0,0,0,0,0,0,0,0,0,730000,0,0,0,770000,40000,730000,730000
3017,奇鋐            ,1853000,1715000,138000,0,0,0,516000,5000,511000,71000,75000,1000,74000,55000,58000,-3000,720000
052818,智邦永豐96購01  ,0,0,0,0,0,0,0,0,0,720000,0,0,0,742000,22000,720000,720000
03777P,華通中信95售01  ,0,0,0,0,0,0,0,0,0,710000,0,0,0,710000,0,710000,710000
052994,群創台新99購01  ,0,0,0,0,0,0,0,0,0,710000,0,0,0,710000,0,710000,710000
00676R,富邦臺灣加權反1 ,0,0,0,0,0,0,0,0,0,703000,0,0,0,3528000,2825000,703000,703000
058538,智邦台新99購02  ,0,0,0,0,0,0,0,0,0,694000,0,0,0,745000,51000,694000,694000
055022,精元國泰99購01  ,0,0,0,0,0,0,0,0,0,686000,0,0,0,751000,65000,686000,686000
054679,台積電康和99購01,0,0,0,0,0,0,0,0,0,678000,0,0,0,678000,0,678000,678000
038095,T50反1群益93購02,0,1000,-1000,0,0,0,0,0,0,667000,0,0,0,667000,0,667000,666000
2439,美律            ,1322000,1150000,172000,0,0,0,0,0,0,491000,748000,553000,195000,391000,95000,296000,663000
057625,泰鼎國泰9A購01  ,0,0,0,0,0,0,0,0,0,658000,0,0,0,986000,328000,658000,658000
08484P,台灣50中信96售01,0,0,0,0,0,0,0,0,0,640000,0,0,0,640000,0,640000,640000
053357,可成統一96購02  ,0,0,0,0,0,0,0,0,0,640000,0,0,0,640000,0,640000,640000
056994,緯穎兆豐98購02  ,0,0,0,0,0,0,0,0,0,637000,0,0,0,637000,0,637000,637000
055157,晶豪科元大97購01,0,0,0,0,0,0,0,0,0,630000,0,0,0,670000,40000,630000,630000
2841,台開            ,1288000,662000,626000,0,0,0,0,0,0,-1000,0,1000,-1000,0,0,0,625000
055520,矽力中信97購02  ,0,0,0,0,0,0,0,0,0,625000,0,0,0,760000,135000,625000,625000
048588,世紀鋼中信94購01,0,0,0,0,0,0,0,0,0,624000,0,0,0,659000,35000,624000,624000
2316,楠梓電          ,1569000,914000,655000,0,0,0,0,0,0,-32000,0,22000,-22000,0,10000,-10000,623000
058576,南亞科群益99購01,0,0,0,0,0,0,0,0,0,622000,0,0,0,1035000,413000,622000,622000
052785,滬深2X中信99購03,0,0,0,0,0,0,0,0,0,614000,0,0,0,614000,0,614000,614000
053043,嘉晶凱基96購01  ,0,0,0,0,0,0,0,0,0,611000,0,0,0,653000,42000,611000,611000
059088,台積電元大99購27,0,0,0,0,0,0,0,0,0,608000,0,0,0,669000,61000,608000,608000
4968,立積            ,1416000,505000,911000,0,0,0,3000,290000,-287000,-16000,0,1000,-1000,6000,21000,-15000,608000
051461,聯詠國泰96購01  ,0,0,0,0,0,0,0,0,0,607000,0,0,0,712000,105000,607000,607000
059180,祥碩元富9A購01  ,0,0,0,0,0,0,0,0,0,606000,0,0,0,1917000,1311000,606000,606000
6278,台表科          ,2368000,1733000,635000,0,0,0,75000,80000,-5000,-28000,1000,2000,-1000,0,27000,-27000,602000
06012P,世芯國票96售01  ,0,0,0,0,0,0,0,0,0,595000,0,0,0,600000,5000,595000,595000
048505,滬深2X群益99購03,0,0,0,0,0,0,0,0,0,591000,0,0,0,591000,0,591000,591000
058709,臺股指元大9A購22,0,0,0,0,0,0,0,0,0,580000,0,0,0,584000,4000,580000,580000
048346,智易元大95購01  ,0,0,0,0,0,0,0,0,0,575000,0,0,0,575000,0,575000,575000
051928,大立光中信96購03,0,0,0,0,0,0,0,0,0,560000,0,0,0,560000,0,560000,560000
048124,大立光元大95購03,0,0,0,0,0,0,0,0,0,559000,0,0,0,999000,440000,559000,559000
053458,聯詠國泰97購01  ,0,0,0,0,0,0,0,0,0,559000,0,0,0,559000,0,559000,559000
2356,英業達          ,4639856,6290000,-1650144,0,0,0,18000,0,18000,2181000,149000,420000,-271000,2477000,25000,2452000,548856
057917,台積電凱基98購17,0,0,0,0,0,0,0,0,0,546000,0,0,0,1905000,1359000,546000,546000
051832,復盛元大95購01  ,0,0,0,0,0,0,0,0,0,541000,0,0,0,541000,0,541000,541000
051062,超眾群益95購02  ,0,0,0,0,0,0,0,0,0,536000,0,0,0,592000,56000,536000,536000
056565,欣興群益98購03  ,0,0,0,0,0,0,0,0,0,527000,0,0,0,777000,250000,527000,527000
037839,T50反1群益93購01,0,0,0,0,0,0,0,0,0,521000,0,0,0,521000,0,521000,521000
054259,健策元大97購03  ,0,0,0,0,0,0,0,0,0,520000,0,0,0,590000,70000,520000,520000
04503P,元油2X元富98售09,0,0,0,0,0,0,0,0,0,510000,0,0,0,520000,10000,510000,510000
2353,宏碁            ,9018846,7900330,1118516,0,0,0,4000,0,4000,-613000,155000,593000,-438000,21000,196000,-175000,509516
057729,華新科國泰99購04,0,0,0,0,0,0,0,0,0,504000,0,0,0,514000,10000,504000,504000
059149,臺股指國票99購12,0,0,0,0,0,0,0,0,0,503000,0,0,0,714000,211000,503000,503000
00656R,國泰中國A50反1  ,37000,0,37000,0,0,0,0,0,0,465000,0,0,0,1460000,995000,465000,502000
054142,致伸元大97購01  ,0,0,0,0,0,0,0,0,0,500000,0,0,0,500000,0,500000,500000
050986,上証2X永昌97購01,0,0,0,0,0,0,0,0,0,499000,0,0,0,499000,0,499000,499000
052715,可成凱基96購01  ,0,0,0,0,0,0,0,0,0,499000,0,0,0,499000,0,499000,499000
053408,友達兆豐98購01  ,0,0,0,0,0,0,0,0,0,499000,0,0,0,499000,0,499000,499000
053316,友達群益9A購01  ,0,0,0,0,0,0,0,0,0,498000,0,0,0,498000,0,498000,498000
04545P,國巨元大94售05  ,0,0,0,0,0,0,0,0,0,482000,0,0,0,482000,0,482000,482000
051479,兆豐金凱基95購01,0,0,0,0,0,0,0,0,0,480000,0,0,0,490000,10000,480000,480000
059216,台積電元大99購29,0,0,0,0,0,0,0,0,0,478000,0,0,0,629000,151000,478000,478000
052790,智邦兆豐97購01  ,0,0,0,0,0,0,0,0,0,476000,0,0,0,543000,67000,476000,476000
050941,T50反1群益95購01,0,0,0,0,0,0,0,0,0,470000,0,0,0,470000,0,470000,470000
053677,同欣電國泰97購01,0,0,0,0,0,0,0,0,0,470000,0,0,0,490000,20000,470000,470000
041832,T50反1統一94購01,0,0,0,0,0,0,0,0,0,467000,0,0,0,467000,0,467000,467000
058595,T50正2元富99購01,0,0,0,0,0,0,0,0,0,465000,0,0,0,1774000,1309000,465000,465000
2327,國巨            ,5291724,4325140,966584,0,0,0,1000,636000,-635000,133000,293000,372000,-79000,514000,302000,212000,464584
3596,智易            ,1482000,993000,489000,0,0,0,0,0,0,-25000,14000,65000,-51000,38000,12000,26000,464000
058391,T50反1元大99購02,0,0,0,0,0,0,0,0,0,464000,0,0,0,599000,135000,464000,464000
04049P,大立光元大95售02,0,0,0,0,0,0,0,0,0,464000,0,0,0,955000,491000,464000,464000
057996,臻鼎中信98購01  ,0,0,0,0,0,0,0,0,0,464000,0,0,0,568000,104000,464000,464000
058745,元金2X凱基9C購02,0,0,0,0,0,0,0,0,0,462000,0,0,0,462000,0,462000,462000
053611,聯茂麥證96購01  ,0,0,0,847000,390000,457000,0,0,0,457000,0,0,0,847000,390000,457000,457000
8210,勤誠            ,750000,418000,332000,0,0,0,159000,0,159000,-36000,10000,46000,-36000,6000,6000,0,455000
057806,國巨元大98購20  ,0,0,0,0,0,0,0,0,0,451000,0,0,0,451000,0,451000,451000
052865,大立光凱基96購11,0,0,0,0,0,0,0,0,0,450000,0,0,0,520000,70000,450000,450000
3050,鈺德            ,592000,144000,448000,0,0,0,0,0,0,0,0,0,0,0,0,0,448000
00643,群益深証中小    ,186000,21000,165000,0,0,0,0,0,0,282000,20000,0,20000,384000,122000,262000,447000
055060,聯陽永豐97購01  ,0,0,0,0,0,0,0,0,0,447000,0,0,0,447000,0,447000,447000
8028,昇陽半導體      ,783000,491000,292000,0,0,0,150000,0,150000,4000,7000,0,7000,0,3000,-3000,446000
054845,智邦兆豐98購01  ,0,0,0,0,0,0,0,0,0,445000,0,0,0,860000,415000,445000,445000
049492,聯發科元大95購02,0,0,0,0,0,0,0,0,0,440000,0,0,0,440000,0,440000,440000
4935,茂林-KY         ,1122043,1101000,21043,0,0,0,524000,0,524000,-105723,10000,15000,-5000,1000,101723,-100723,439320
049579,鴻海元大94購06  ,0,0,0,0,0,0,0,0,0,439000,0,0,0,471000,32000,439000,439000
054427,潤泰全富邦97購01,0,0,0,0,0,0,0,0,0,436000,0,0,0,446000,10000,436000,436000
056356,台積電元大99購01,0,0,0,0,0,0,0,0,0,435000,0,0,0,435000,0,435000,435000
058061,貿聯元富9B購01  ,0,0,0,0,0,0,0,0,0,432000,0,0,0,432000,0,432000,432000
054462,旺宏凱基96購08  ,0,0,0,0,0,0,0,0,0,430000,0,0,0,450000,20000,430000,430000
057768,華新科中信9A購01,0,0,0,0,0,0,0,0,0,430000,0,0,0,470000,40000,430000,430000
08852P,台灣50台新01售01,0,0,0,0,0,0,0,0,0,426000,0,0,0,428000,2000,426000,426000
052811,玉晶光台新96購03,0,0,0,0,0,0,0,0,0,424000,0,0,0,425000,1000,424000,424000
054241,深中小元大98購01,0,0,0,0,0,0,0,0,0,423000,0,0,0,423000,0,423000,423000
06310P,精元元富97售02  ,0,0,0,0,0,0,0,0,0,422000,0,0,0,432000,10000,422000,422000
050559,聯發科統一94購10,0,0,0,0,0,0,0,0,0,418000,0,0,0,418000,0,418000,418000
03763P,聯發科元富96售01,0,0,0,0,0,0,0,0,0,417000,0,0,0,437000,20000,417000,417000
052889,致伸麥證97購01  ,0,0,0,402000,0,402000,0,0,0,402000,0,0,0,402000,0,402000,402000
056993,GIS兆豐99購01   ,0,0,0,0,0,0,0,0,0,402000,0,0,0,402000,0,402000,402000
04858P,健策元富94售01  ,0,0,0,0,0,0,0,0,0,401000,0,0,0,461000,60000,401000,401000
051863,技嘉凱基95購01  ,0,0,0,0,0,0,0,0,0,400000,0,0,0,400000,0,400000,400000
056429,華通凱基98購02  ,0,0,0,0,0,0,0,0,0,400000,0,0,0,400000,0,400000,400000
054712,上証2X中信98購02,0,0,0,0,0,0,0,0,0,400000,0,0,0,400000,0,400000,400000
057654,A50正2中信98購01,0,0,0,0,0,0,0,0,0,400000,0,0,0,400000,0,400000,400000
051830,健策元大97購01  ,0,0,0,0,0,0,0,0,0,399000,0,0,0,399000,0,399000,399000
051694,A50正2中信96購03,0,0,0,0,0,0,0,0,0,396000,0,0,0,396000,0,396000,396000
057656,大成鋼兆豐98購01,0,0,0,0,0,0,0,0,0,390000,0,0,0,390000,0,390000,390000
058836,FBVIX中信03購05 ,0,0,0,0,0,0,0,0,0,388000,0,0,0,1592000,1204000,388000,388000
08602P,台灣50凱基96售04,0,0,0,0,0,0,0,0,0,386000,0,0,0,386000,0,386000,386000
2458,義隆            ,1496000,2165000,-669000,0,0,0,801000,0,801000,253000,212000,86000,126000,201000,74000,127000,385000
051849,旺宏中信98購01  ,0,0,0,0,0,0,0,0,0,385000,0,0,0,385000,0,385000,385000
052614,聯電國泰97購01  ,0,0,0,0,0,0,0,0,0,382000,0,0,0,539000,157000,382000,382000
058457,創意永豐99購01  ,0,0,0,0,0,0,0,0,0,380000,0,0,0,407000,27000,380000,380000
6166,凌華            ,779000,366000,413000,0,0,0,0,35000,-35000,-1000,0,1000,-1000,0,0,0,377000
8215,明基材          ,975000,598000,377000,0,0,0,0,0,0,-1000,1000,2000,-1000,0,0,0,376000
057034,道瓊反元大9B購01,0,0,0,0,0,0,0,0,0,372000,0,0,0,387000,15000,372000,372000
056602,嘉澤國泰99購01  ,0,0,0,0,0,0,0,0,0,369000,0,0,0,420000,51000,369000,369000
055049,智邦永豐97購01  ,0,0,0,0,0,0,0,0,0,369000,0,0,0,369000,0,369000,369000
00708L,元大S&P黃金正2  ,715000,0,715000,0,0,0,0,0,0,-349000,0,0,0,2861000,3210000,-349000,366000
056918,台積電兆豐98購01,0,0,0,0,0,0,0,0,0,365000,0,0,0,365000,0,365000,365000
06760P,台積電元大98售18,0,0,0,0,0,0,0,0,0,364000,0,0,0,378000,14000,364000,364000
055512,聯詠兆豐97購01  ,0,0,0,0,0,0,0,0,0,362000,0,0,0,555000,193000,362000,362000
059138,台積電兆豐99購04,0,0,0,0,0,0,0,0,0,360000,0,0,0,1020000,660000,360000,360000
05764P,世紀鋼永豐96售03,0,0,0,0,0,0,0,0,0,360000,0,0,0,400000,40000,360000,360000
2104,國際中橡        ,1477810,1009000,468810,0,0,0,0,0,0,-109000,0,109000,-109000,0,0,0,359810
058462,台積電兆豐99購01,0,0,0,0,0,0,0,0,0,359000,0,0,0,379000,20000,359000,359000
05855P,滬深2X中信9C售01,0,0,0,0,0,0,0,0,0,358000,0,0,0,459000,101000,358000,358000
052074,鴻海元富95購10  ,0,0,0,0,0,0,0,0,0,355000,0,0,0,355000,0,355000,355000
050492,漢唐國泰96購01  ,0,0,0,0,0,0,0,0,0,352000,0,0,0,372000,20000,352000,352000
05397P,大立光凱基96售08,0,0,0,0,0,0,0,0,0,352000,0,0,0,581000,229000,352000,352000
00636,國泰中國A50     ,360000,144000,216000,0,0,0,0,0,0,135000,65000,20000,45000,473000,383000,90000,351000
8105,凌巨            ,896000,498000,398000,0,0,0,0,0,0,-47000,0,47000,-47000,0,0,0,351000
055421,玉晶光永豐98購04,0,0,0,0,0,0,0,0,0,350000,0,0,0,350000,0,350000,350000
057795,鴻海兆豐99購02  ,0,0,0,0,0,0,0,0,0,350000,0,0,0,370000,20000,350000,350000
054656,深中小元大97購01,0,0,0,0,0,0,0,0,0,350000,0,0,0,350000,0,350000,350000
059217,台積電元大99購30,0,0,0,0,0,0,0,0,0,349000,0,0,0,400000,51000,349000,349000
4906,正文            ,1178000,831000,347000,0,0,0,0,0,0,-1000,19000,10000,9000,0,10000,-10000,346000
058451,智邦永豐9A購01  ,0,0,0,0,0,0,0,0,0,345000,0,0,0,421000,76000,345000,345000
6558,興能高          ,1040000,378300,661700,0,0,0,0,300000,-300000,-17000,0,17000,-17000,0,0,0,344700
05975P,國巨日盛99售02  ,0,0,0,0,0,0,0,0,0,344000,0,0,0,374000,30000,344000,344000
05434P,世紀鋼元富95售02,0,0,0,0,0,0,0,0,0,337000,0,0,0,341000,4000,337000,337000
03857P,聯發科元富99售02,0,0,0,0,0,0,0,0,0,335000,0,0,0,355000,20000,335000,335000
051075,智邦國泰97購01  ,0,0,0,0,0,0,0,0,0,332000,0,0,0,485000,153000,332000,332000
050213,華新科台新94購03,0,0,0,0,0,0,0,0,0,332000,0,0,0,332000,0,332000,332000
054295,世芯元大96購03  ,0,0,0,0,0,0,0,0,0,332000,0,0,0,342000,10000,332000,332000
058708,臺股指元大9A購21,0,0,0,0,0,0,0,0,0,331000,0,0,0,626000,295000,331000,331000
057721,華擎元富98購02  ,0,0,0,0,0,0,0,0,0,331000,0,0,0,331000,0,331000,331000
049927,健策元大94購02  ,0,0,0,0,0,0,0,0,0,330000,0,0,0,330000,0,330000,330000
056537,冠德凱基98購01  ,0,0,0,0,0,0,0,0,0,330000,0,0,0,330000,0,330000,330000
2603,長榮            ,10310640,9171000,1139640,0,0,0,23000,0,23000,-833000,201000,1054000,-853000,164000,144000,20000,329640
058323,泰鼎永豐9A購01  ,0,0,0,0,0,0,0,0,0,321000,0,0,0,361000,40000,321000,321000
058960,臺股指國票99購05,0,0,0,0,0,0,0,0,0,320000,0,0,0,320000,0,320000,320000
051592,健策元大96購05  ,0,0,0,0,0,0,0,0,0,320000,0,0,0,340000,20000,320000,320000
055065,神達永豐97購01  ,0,0,0,0,0,0,0,0,0,320000,0,0,0,350000,30000,320000,320000
054358,矽創兆豐96購01  ,0,0,0,0,0,0,0,0,0,320000,0,0,0,620000,300000,320000,320000
6552,易華電          ,722000,352000,370000,0,0,0,0,0,0,-51000,0,45000,-45000,1000,7000,-6000,319000
049072,台積電凱基94購08,0,0,0,0,0,0,0,0,0,318000,0,0,0,458000,140000,318000,318000
053560,漢唐國泰98購01  ,0,0,0,0,0,0,0,0,0,318000,0,0,0,476000,158000,318000,318000
054316,矽創凱基97購01  ,0,0,0,0,0,0,0,0,0,316000,0,0,0,316000,0,316000,316000
051474,智邦凱基95購04  ,0,0,0,0,0,0,0,0,0,315000,0,0,0,415000,100000,315000,315000
057640,台積電元大98購16,0,0,0,0,0,0,0,0,0,315000,0,0,0,325000,10000,315000,315000
052325,高股息中信99購01,0,0,0,0,0,0,0,0,0,314000,0,0,0,324000,10000,314000,314000
055460,華擎永豐97購01  ,0,0,0,0,0,0,0,0,0,313000,0,0,0,349000,36000,313000,313000
053962,聯茂永豐96購01  ,0,0,0,0,0,0,0,0,0,313000,0,0,0,313000,0,313000,313000
059062,群創凱基99購05  ,0,0,0,0,0,0,0,0,0,312000,0,0,0,348000,36000,312000,312000
052738,聯電元大98購02  ,0,0,0,0,0,0,0,0,0,311000,0,0,0,345000,34000,311000,311000
058412,聯發科兆豐99購01,0,0,0,0,0,0,0,0,0,310000,0,0,0,320000,10000,310000,310000
058505,台積電元大99購08,0,0,0,0,0,0,0,0,0,310000,0,0,0,310000,0,310000,310000
059052,為升凱基99購01  ,0,0,0,0,0,0,0,0,0,307000,0,0,0,307000,0,307000,307000
4746,台耀            ,737000,474000,263000,0,0,0,0,0,0,42000,86000,44000,42000,0,0,0,305000
8996,高力            ,928000,821000,107000,0,0,0,0,0,0,197000,197000,0,197000,0,0,0,304000
06915P,晶技元富98售02  ,0,0,0,0,0,0,0,0,0,303000,0,0,0,303000,0,303000,303000
050971,緯穎永豐95購01  ,0,0,0,0,0,0,0,0,0,303000,0,0,0,312000,9000,303000,303000
052345,矽力凱基95購01  ,0,0,0,0,0,0,0,0,0,301000,0,0,0,301000,0,301000,301000
051298,智邦凱基95購03  ,0,0,0,0,0,0,0,0,0,301000,0,0,0,351000,50000,301000,301000
058481,玉晶光凱基9A購04,0,0,0,0,0,0,0,0,0,300000,0,0,0,300000,0,300000,300000
052626,上証2X中信9A購01,0,0,0,0,0,0,0,0,0,300000,0,0,0,300000,0,300000,300000
051887,上証2X元富98購01,0,0,0,0,0,0,0,0,0,300000,0,0,0,300000,0,300000,300000
054277,亞光群益97購01  ,0,0,0,0,0,0,0,0,0,300000,0,0,0,300000,0,300000,300000
057428,正崴兆豐98購01  ,0,0,0,0,0,0,0,0,0,300000,0,0,0,300000,0,300000,300000
054630,聯鈞凱基98購01  ,0,0,0,0,0,0,0,0,0,300000,0,0,0,300000,0,300000,300000
052732,新唐國泰97購01  ,0,0,0,0,0,0,0,0,0,299000,0,0,0,299000,0,299000,299000
052971,京元電群益98購01,0,0,0,0,0,0,0,0,0,299000,0,0,0,299000,0,299000,299000
054843,中環兆豐97購01  ,0,0,0,0,0,0,0,0,0,299000,0,0,0,299000,0,299000,299000
054702,智邦第一97購01  ,0,0,0,0,0,0,0,0,0,298000,0,0,0,298000,0,298000,298000
040761,T50反1凱基95購02,0,0,0,0,0,0,0,0,0,297000,0,0,0,297000,0,297000,297000
055515,聚陽中信9A購01  ,0,0,0,0,0,0,0,0,0,297000,0,0,0,310000,13000,297000,297000
059152,臺股指國票99購15,0,0,0,0,0,0,0,0,0,293000,0,0,0,567000,274000,293000,293000
058600,國巨元大99購15  ,0,0,0,0,0,0,0,0,0,290000,0,0,0,313000,23000,290000,290000
047123,中石化中信95購01,0,0,0,0,0,0,0,0,0,290000,0,0,0,400000,110000,290000,290000
055438,鴻海國票98購01  ,0,0,0,0,0,0,0,0,0,290000,0,0,0,290000,0,290000,290000
05668P,滬深2X永豐96售04,0,0,0,0,0,0,0,0,0,286000,0,0,0,286000,0,286000,286000
053220,瀚宇博凱基98購01,0,0,0,0,0,0,0,0,0,285000,0,0,0,285000,0,285000,285000
058821,泰鼎國泰9B購01  ,0,0,0,0,0,0,0,0,0,283000,0,0,0,355000,72000,283000,283000
051699,世紀鋼麥證95購01,0,0,0,281000,0,281000,0,0,0,281000,0,0,0,281000,0,281000,281000
055281,台光電元大98購03,0,0,0,0,0,0,0,0,0,280000,0,0,0,290000,10000,280000,280000
058597,瑞昱台新99購01  ,0,0,0,0,0,0,0,0,0,279000,0,0,0,312000,33000,279000,279000
046944,奇力新元大96購01,0,0,0,0,0,0,0,0,0,279000,0,0,0,328000,49000,279000,279000
049888,智邦國泰96購01  ,0,0,0,0,0,0,0,0,0,278000,0,0,0,314000,36000,278000,278000
055493,華新科元大97購09,0,0,0,0,0,0,0,0,0,278000,0,0,0,282000,4000,278000,278000
058530,為升元富99購01  ,0,0,0,0,0,0,0,0,0,277000,0,0,0,277000,0,277000,277000
055583,國巨元大97購10  ,0,0,0,0,0,0,0,0,0,277000,0,0,0,297000,20000,277000,277000
05004P,健策統一95售01  ,0,0,0,0,0,0,0,0,0,273000,0,0,0,288000,15000,273000,273000
00674R,元大S&P黃金反1  ,0,0,0,0,0,0,0,0,0,271000,0,0,0,419000,148000,271000,271000
058549,藍天永豐99購01  ,0,0,0,0,0,0,0,0,0,270000,0,0,0,270000,0,270000,270000
057274,友達元大98購03  ,0,0,0,0,0,0,0,0,0,270000,0,0,0,340000,70000,270000,270000
06013P,世芯國泰97售03  ,0,0,0,0,0,0,0,0,0,269000,0,0,0,378000,109000,269000,269000
056614,智邦永豐98購01  ,0,0,0,0,0,0,0,0,0,269000,0,0,0,419000,150000,269000,269000
046942,友達元大99購01  ,0,0,0,0,0,0,0,0,0,268000,0,0,0,268000,0,268000,268000
047569,世紀鋼國票94購02,0,0,0,0,0,0,0,0,0,266000,0,0,0,266000,0,266000,266000
00693U,街口S&P黃豆     ,276000,728000,-452000,0,0,0,0,0,0,718000,0,0,0,718000,0,718000,266000
040760,T50反1凱基95購01,0,0,0,0,0,0,0,0,0,266000,0,0,0,266000,0,266000,266000
056770,國產元大98購02  ,0,0,0,0,0,0,0,0,0,262000,0,0,0,360000,98000,262000,262000
056355,台積電元大98購08,0,0,0,0,0,0,0,0,0,261000,0,0,0,261000,0,261000,261000
048628,T50反1元大96購03,0,0,0,0,0,0,0,0,0,261000,0,0,0,261000,0,261000,261000
00651R,FH香港反1       ,15000,135000,-120000,0,0,0,0,0,0,380000,0,0,0,519000,139000,380000,260000
051254,健策元大96購04  ,0,0,0,0,0,0,0,0,0,260000,0,0,0,260000,0,260000,260000
00654R,富邦印度反1     ,144000,76000,68000,0,0,0,0,0,0,191000,0,0,0,248000,57000,191000,259000
04787P,台積電永昌96售04,0,0,0,0,0,0,0,0,0,258000,0,0,0,304000,46000,258000,258000
055124,建準兆豐97購01  ,0,0,0,0,0,0,0,0,0,258000,0,0,0,258000,0,258000,258000
056385,創意國泰99購01  ,0,0,0,0,0,0,0,0,0,257000,0,0,0,545000,288000,257000,257000
056675,聯發科元富02購01,0,0,0,0,0,0,0,0,0,256000,0,0,0,256000,0,256000,256000
054888,泰碩統一97購01  ,0,0,0,0,0,0,0,0,0,256000,0,0,0,256000,0,256000,256000
8150,南茂            ,1887000,2486000,-599000,0,0,0,1000000,0,1000000,-145000,50000,108000,-58000,44000,131000,-87000,256000
057093,臻鼎元富98購02  ,0,0,0,0,0,0,0,0,0,255000,0,0,0,255000,0,255000,255000
055905,可成兆豐97購03  ,0,0,0,0,0,0,0,0,0,255000,0,0,0,300000,45000,255000,255000
05205P,緯穎元大95售03  ,0,0,0,0,0,0,0,0,0,254000,0,0,0,460000,206000,254000,254000
056721,台灣50永昌9A購01,0,0,0,0,0,0,0,0,0,253000,0,0,0,749000,496000,253000,253000
058073,大立光凱基99購04,0,0,0,0,0,0,0,0,0,253000,0,0,0,273000,20000,253000,253000
054356,可成兆豐97購01  ,0,0,0,0,0,0,0,0,0,251000,0,0,0,255000,4000,251000,251000
051346,仁寶元大95購01  ,0,0,0,0,0,0,0,0,0,250000,0,0,0,250000,0,250000,250000
04749P,臺股指元大94售25,0,0,0,0,0,0,0,0,0,250000,0,0,0,250000,0,250000,250000
045907,鴻海中信94購02  ,0,0,0,0,0,0,0,0,0,250000,0,0,0,250000,0,250000,250000
055755,禾伸堂兆豐97購02,0,0,0,0,0,0,0,0,0,250000,0,0,0,250000,0,250000,250000
058214,世芯群益9A購01  ,0,0,0,0,0,0,0,0,0,250000,0,0,0,250000,0,250000,250000
055970,聯茂元大97購04  ,0,0,0,0,0,0,0,0,0,250000,0,0,0,270000,20000,250000,250000
4943,康控-KY         ,874000,592954,281046,0,0,0,0,0,0,-32000,5000,14000,-9000,6000,29000,-23000,249046
053562,玉晶光國泰98購02,0,0,0,0,0,0,0,0,0,248000,0,0,0,278000,30000,248000,248000
03438P,群創群益98售03  ,0,0,0,0,0,0,0,0,0,243000,0,0,0,325000,82000,243000,243000
050789,矽創國泰96購01  ,0,0,0,0,0,0,0,0,0,243000,0,0,0,243000,0,243000,243000
04993P,上銀兆豐96售01  ,0,0,0,0,0,0,0,0,0,242000,0,0,0,252000,10000,242000,242000
058320,華新科永豐99購02,0,0,0,0,0,0,0,0,0,240000,0,0,0,240000,0,240000,240000
052020,聯茂永豐95購02  ,0,0,0,0,0,0,0,0,0,239000,0,0,0,239000,0,239000,239000
051596,超眾元大95購05  ,0,0,0,0,0,0,0,0,0,238000,0,0,0,310000,72000,238000,238000
051485,玉晶光凱基97購02,0,0,0,0,0,0,0,0,0,237000,0,0,0,267000,30000,237000,237000
04230P,臺股指中信95售06,0,0,0,0,0,0,0,0,0,237000,0,0,0,237000,0,237000,237000
2474,可成            ,3753951,3434940,319011,0,0,0,86000,25000,61000,-145000,41000,156000,-115000,15000,45000,-30000,235011
058660,樺漢中信9A購01  ,0,0,0,0,0,0,0,0,0,234000,0,0,0,286000,52000,234000,234000
055524,鴻海群益98購01  ,0,0,0,0,0,0,0,0,0,231000,0,0,0,236000,5000,231000,231000
049946,智邦兆豐95購01  ,0,0,0,0,0,0,0,0,0,230000,0,0,0,250000,20000,230000,230000
057630,茂林永豐98購01  ,0,0,0,0,0,0,0,0,0,230000,0,0,0,230000,0,230000,230000
057675,同欣電元大98購02,0,0,0,0,0,0,0,0,0,230000,0,0,0,250000,20000,230000,230000
053318,全新群益99購01  ,0,0,0,0,0,0,0,0,0,230000,0,0,0,230000,0,230000,230000
053258,上証2X群益9A購03,0,0,0,0,0,0,0,0,0,230000,0,0,0,230000,0,230000,230000
053495,聯發科兆豐96購02,0,0,0,0,0,0,0,0,0,230000,0,0,0,260000,30000,230000,230000
057562,奇鋐兆豐98購01  ,0,0,0,0,0,0,0,0,0,229000,0,0,0,302000,73000,229000,229000
035277,景碩台新97購01  ,0,0,0,0,0,0,0,0,0,228000,0,0,0,241000,13000,228000,228000
06127P,泰碩元富97售01  ,0,0,0,0,0,0,0,0,0,227000,0,0,0,227000,0,227000,227000
050396,欣興元富94購02  ,0,0,0,0,0,0,0,0,0,226000,0,0,0,226000,0,226000,226000
053041,可成凱基96購02  ,0,0,0,0,0,0,0,0,0,225000,0,0,0,225000,0,225000,225000
050363,臺指反元大98購04,0,0,0,0,0,0,0,0,0,224000,0,0,0,224000,0,224000,224000
058134,信邦元大99購01  ,0,0,0,0,0,0,0,0,0,224000,0,0,0,379000,155000,224000,224000
058662,禾伸堂兆豐99購01,0,0,0,0,0,0,0,0,0,222000,0,0,0,249000,27000,222000,222000
056363,華新科元大99購04,0,0,0,0,0,0,0,0,0,222000,0,0,0,342000,120000,222000,222000
08674P,嘉晶元富07售02  ,0,0,0,0,0,0,0,0,0,221000,0,0,0,221000,0,221000,221000
053074,嘉晶永豐96購02  ,0,0,0,0,0,0,0,0,0,221000,0,0,0,321000,100000,221000,221000
2345,智邦            ,3611331,3379442,231889,0,0,0,280000,0,280000,-291000,127000,175000,-48000,40000,283000,-243000,220889
058614,台郡元大9A購01  ,0,0,0,0,0,0,0,0,0,220000,0,0,0,247000,27000,220000,220000
06394P,台積電元大97售28,0,0,0,0,0,0,0,0,0,220000,0,0,0,220000,0,220000,220000
040215,上証反凱基95購01,0,0,0,0,0,0,0,0,0,220000,0,0,0,220000,0,220000,220000
056936,禾伸堂元富98購01,0,0,0,0,0,0,0,0,0,220000,0,0,0,220000,0,220000,220000
053229,南電台新97購01  ,0,0,0,0,0,0,0,0,0,220000,0,0,0,330000,110000,220000,220000
058878,旭富國泰9B購01  ,0,0,0,0,0,0,0,0,0,219000,0,0,0,275000,56000,219000,219000
2365,昆盈            ,293000,74000,219000,0,0,0,0,0,0,0,0,0,0,0,0,0,219000
052965,廣宇群益97購01  ,0,0,0,0,0,0,0,0,0,219000,0,0,0,219000,0,219000,219000
050378,上証2X群益98購02,0,0,0,0,0,0,0,0,0,219000,0,0,0,409000,190000,219000,219000
053353,玉晶光兆豐97購03,0,0,0,0,0,0,0,0,0,219000,0,0,0,219000,0,219000,219000
2605,新興            ,676000,458000,218000,0,0,0,0,0,0,-1000,0,0,0,0,1000,-1000,217000
00783,富邦中証500     ,314000,13000,301000,0,0,0,0,0,0,-84000,0,0,0,979000,1063000,-84000,217000
056603,嘉聯益國泰9A購01,0,0,0,0,0,0,0,0,0,216000,0,0,0,216000,0,216000,216000
3673,TPK-KY          ,2096000,1992000,104000,0,0,0,1000,0,1000,109000,212000,44000,168000,20000,79000,-59000,214000
055804,祥碩永豐97購02  ,0,0,0,0,0,0,0,0,0,213000,0,0,0,272000,59000,213000,213000
04410P,大立光統一94售05,0,0,0,0,0,0,0,0,0,212000,0,0,0,212000,0,212000,212000
055334,禾伸堂兆豐97購01,0,0,0,0,0,0,0,0,0,212000,0,0,0,212000,0,212000,212000
05505P,聯發科凱基96售09,0,0,0,0,0,0,0,0,0,212000,0,0,0,246000,34000,212000,212000
053507,百和兆豐96購01  ,0,0,0,0,0,0,0,0,0,211000,0,0,0,211000,0,211000,211000
06459P,亞德客元富98售01,0,0,0,0,0,0,0,0,0,210000,0,0,0,210000,0,210000,210000
051755,台積電元大96購08,0,0,0,0,0,0,0,0,0,210000,0,0,0,210000,0,210000,210000
052069,聯茂兆豐96購01  ,0,0,0,0,0,0,0,0,0,210000,0,0,0,210000,0,210000,210000
054281,世芯群益97購01  ,0,0,0,0,0,0,0,0,0,210000,0,0,0,210000,0,210000,210000
045736,台積電群益94購01,0,0,0,0,0,0,0,0,0,209000,0,0,0,579000,370000,209000,209000
057980,聯詠永豐98購01  ,0,0,0,0,0,0,0,0,0,209000,0,0,0,209000,0,209000,209000
08714P,華碩元富01售03  ,0,1000,-1000,0,0,0,0,0,0,209000,0,0,0,209000,0,209000,208000
04611P,元油2X群益98售02,0,0,0,0,0,0,0,0,0,208000,0,0,0,208000,0,208000,208000
050261,國巨元大95購04  ,0,0,0,0,0,0,0,0,0,208000,0,0,0,278000,70000,208000,208000
053445,可成凱基96購04  ,0,0,0,0,0,0,0,0,0,208000,0,0,0,208000,0,208000,208000
05542P,滬深2X元富96售01,0,0,0,0,0,0,0,0,0,208000,0,0,0,208000,0,208000,208000
054317,昇陽半凱基98購01,0,0,0,0,0,0,0,0,0,207000,0,0,0,207000,0,207000,207000
053797,台積電中信98購01,0,0,0,0,0,0,0,0,0,205000,0,0,0,205000,0,205000,205000
048652,巨大元大96購01  ,0,0,0,0,0,0,0,0,0,204000,0,0,0,217000,13000,204000,204000
3380,明泰            ,406774,506000,-99226,0,0,0,0,0,0,303000,354000,356000,-2000,318000,13000,305000,203774
058526,鈺齊元大99購02  ,0,0,0,0,0,0,0,0,0,203000,0,0,0,220000,17000,203000,203000
08703P,華碩凱基01售02  ,0,0,0,0,0,0,0,0,0,202000,0,0,0,242000,40000,202000,202000
053115,滬深2X中信97購01,0,0,0,0,0,0,0,0,0,202000,0,0,0,202000,0,202000,202000
06273P,台表科凱基97售04,0,0,0,0,0,0,0,0,0,201000,0,0,0,201000,0,201000,201000
049659,旺宏台新95購01  ,0,0,0,0,0,0,0,0,0,201000,0,0,0,201000,0,201000,201000
052451,旭富元大95購02  ,0,0,0,0,0,0,0,0,0,201000,0,0,0,246000,45000,201000,201000
051618,智邦凱基95購06  ,0,0,0,0,0,0,0,0,0,201000,0,0,0,231000,30000,201000,201000
049982,嘉晶凱基94購01  ,0,0,0,0,0,0,0,0,0,201000,0,0,0,201000,0,201000,201000
056491,南亞科國泰99購01,0,0,0,0,0,0,0,0,0,200000,0,0,0,200000,0,200000,200000
052239,泰鼎國票97購01  ,0,0,0,0,0,0,0,0,0,200000,0,0,0,200000,0,200000,200000
056820,欣興永豐98購02  ,0,0,0,0,0,0,0,0,0,200000,0,0,0,200000,0,200000,200000
052047,建準凱基96購01  ,0,0,0,0,0,0,0,0,0,200000,0,0,0,200000,0,200000,200000
048141,大成鋼統一93購02,0,0,0,0,0,0,0,0,0,200000,0,0,0,200000,0,200000,200000
04829P,大立光凱基94售14,0,0,0,0,0,0,0,0,0,200000,0,0,0,300000,100000,200000,200000
053185,友達中信99購01  ,0,0,0,0,0,0,0,0,0,200000,0,0,0,200000,0,200000,200000
055968,祥碩元大97購04  ,0,0,0,0,0,0,0,0,0,200000,0,0,0,213000,13000,200000,200000
054567,拓凱群益98購01  ,0,0,0,0,0,0,0,0,0,200000,0,0,0,200000,0,200000,200000
057859,神達康和98購01  ,0,0,0,0,0,0,0,0,0,200000,0,0,0,200000,0,200000,200000
058172,國巨凱基9B購02  ,0,0,0,0,0,0,0,0,0,200000,0,0,0,440000,240000,200000,200000
058200,世芯康和99購01  ,0,0,0,0,0,0,0,0,0,200000,0,0,0,260000,60000,200000,200000
054380,世芯群益97購02  ,0,0,0,0,0,0,0,0,0,200000,0,0,0,200000,0,200000,200000
054381,世芯群益98購01  ,0,0,0,0,0,0,0,0,0,200000,0,0,0,200000,0,200000,200000
053349,台郡國票97購02  ,0,0,0,0,0,0,0,0,0,200000,0,0,0,200000,0,200000,200000
057659,台表科兆豐98購01,0,0,0,0,0,0,0,0,0,200000,0,0,0,200000,0,200000,200000
057745,泰鼎永豐99購01  ,0,0,0,0,0,0,0,0,0,200000,0,0,0,230000,30000,200000,200000
053865,欣興元大97購02  ,0,0,0,0,0,0,0,0,0,200000,0,0,0,200000,0,200000,200000
054349,同欣電國票97購02,0,0,0,0,0,0,0,0,0,200000,0,0,0,200000,0,200000,200000
054234,可成群益96購05  ,0,0,0,0,0,0,0,0,0,200000,0,0,0,200000,0,200000,200000
055260,晶相光統一98購01,0,0,0,0,0,0,0,0,0,200000,0,0,0,200000,0,200000,200000
054120,奇力新永豐96購01,0,0,0,0,0,0,0,0,0,200000,0,0,0,200000,0,200000,200000
052877,矽創凱基96購01  ,0,0,0,0,0,0,0,0,0,199000,0,0,0,199000,0,199000,199000
053230,達方台新97購01  ,0,0,0,0,0,0,0,0,0,199000,0,0,0,209000,10000,199000,199000
057266,TPK兆豐98購02   ,0,0,0,0,0,0,0,0,0,198000,0,0,0,223000,25000,198000,198000
057258,中環兆豐98購01  ,0,0,0,0,0,0,0,0,0,198000,0,0,0,198000,0,198000,198000
06395P,台積電元大97售29,0,0,0,0,0,0,0,0,0,197000,0,0,0,212000,15000,197000,197000
056516,晶豪科兆豐98購01,0,0,0,0,0,0,0,0,0,197000,0,0,0,300000,103000,197000,197000
051800,旺宏永豐95購02  ,0,0,0,0,0,0,0,0,0,197000,0,0,0,297000,100000,197000,197000
056786,亞光群益98購03  ,0,0,0,0,0,0,0,0,0,196000,0,0,0,202000,6000,196000,196000
056705,超眾國泰99購01  ,0,0,0,0,0,0,0,0,0,196000,0,0,0,270000,74000,196000,196000
052940,玉晶光兆豐97購01,0,0,0,0,0,0,0,0,0,195000,0,0,0,325000,130000,195000,195000
054637,智邦中信98購01  ,0,0,0,0,0,0,0,0,0,195000,0,0,0,215000,20000,195000,195000
051889,智邦元富95購02  ,0,0,0,0,0,0,0,0,0,194000,0,0,0,196000,2000,194000,194000
08663P,台灣50元大96售01,0,0,0,0,0,0,0,0,0,193000,0,0,0,193000,0,193000,193000
3702A,大聯大甲特      ,2000,16000,-14000,0,0,0,0,0,0,207000,207000,0,207000,0,0,0,193000
051807,瑞昱凱基95購03  ,0,0,0,0,0,0,0,0,0,193000,0,0,0,193000,0,193000,193000
056713,華擎永豐98購01  ,0,0,0,0,0,0,0,0,0,193000,0,0,0,193000,0,193000,193000
054921,文曄凱基97購01  ,0,0,0,0,0,0,0,0,0,193000,0,0,0,253000,60000,193000,193000
04159P,滬深2X中信95售08,0,0,0,0,0,0,0,0,0,192000,0,0,0,192000,0,192000,192000
2912,統一超          ,2507706,2378537,129169,0,0,0,79000,0,79000,-17000,1000,21000,-20000,3000,0,3000,191169
06238P,台積電元大98售07,0,0,0,0,0,0,0,0,0,191000,0,0,0,191000,0,191000,191000
055929,聯發科群益97購05,0,0,0,0,0,0,0,0,0,191000,0,0,0,191000,0,191000,191000
057063,立積國泰9A購01  ,0,0,0,0,0,0,0,0,0,191000,0,0,0,196000,5000,191000,191000
058861,國巨凱基9A購08  ,0,0,0,0,0,0,0,0,0,190000,0,0,0,200000,10000,190000,190000
03563P,台灣50群益02售14,0,0,0,0,0,0,0,0,0,190000,0,0,0,190000,0,190000,190000
04557P,茂林群益94售03  ,0,0,0,0,0,0,0,0,0,190000,0,0,0,190000,0,190000,190000
051769,矽力元大95購01  ,0,0,0,0,0,0,0,0,0,190000,0,0,0,190000,0,190000,190000
052022,南電永豐95購03  ,0,0,0,0,0,0,0,0,0,190000,0,0,0,200000,10000,190000,190000
049738,神基群益94購01  ,0,0,0,0,0,0,0,0,0,190000,0,0,0,190000,0,190000,190000
055971,矽力元大97購05  ,0,0,0,0,0,0,0,0,0,190000,0,0,0,190000,0,190000,190000
058443,T50正2富邦01購01,0,0,0,0,0,0,0,0,0,188000,0,0,0,200000,12000,188000,188000
06237P,台積電元大97售26,0,0,0,0,0,0,0,0,0,188000,0,0,0,188000,0,188000,188000
056735,國巨凱基99購02  ,0,0,0,0,0,0,0,0,0,188000,0,0,0,188000,0,188000,188000
045657,T50反1國泰94購01,0,0,0,0,0,0,0,0,0,188000,0,0,0,188000,0,188000,188000
055424,聚陽群益98購01  ,0,0,0,0,0,0,0,0,0,186000,0,0,0,186000,0,186000,186000
058664,百和兆豐99購01  ,0,0,0,0,0,0,0,0,0,185000,0,0,0,185000,0,185000,185000
04756P,大立光元富94售08,0,0,0,0,0,0,0,0,0,185000,0,0,0,195000,10000,185000,185000
056361,美律元大99購02  ,0,0,0,0,0,0,0,0,0,185000,0,0,0,190000,5000,185000,185000
055287,日電貿元大97購01,0,0,0,0,0,0,0,0,0,185000,0,0,0,200000,15000,185000,185000
2723,美食-KY         ,627000,425880,201120,0,0,0,1000,0,1000,-19000,0,19000,-19000,0,0,0,183120
06653P,美食元大98售02  ,0,0,0,0,0,0,0,0,0,183000,0,0,0,341000,158000,183000,183000
052045,瑞昱凱基96購01  ,0,0,0,0,0,0,0,0,0,183000,0,0,0,183000,0,183000,183000
054444,緯穎台新97購01  ,0,0,0,0,0,0,0,0,0,182000,0,0,0,182000,0,182000,182000
058442,玉晶光台新99購01,0,0,0,0,0,0,0,0,0,180000,0,0,0,250000,70000,180000,180000
050142,聯發科元富9A購01,0,0,0,0,0,0,0,0,0,180000,0,0,0,180000,0,180000,180000
055566,台表科凱基97購03,0,0,0,0,0,0,0,0,0,180000,0,0,0,180000,0,180000,180000
056144,GIS元大98購01   ,0,0,0,0,0,0,0,0,0,180000,0,0,0,200000,20000,180000,180000
057267,康控兆豐99購01  ,0,0,0,0,0,0,0,0,0,180000,0,0,0,180000,0,180000,180000
053859,台積電元大97購09,0,0,0,0,0,0,0,0,0,180000,0,0,0,180000,0,180000,180000
053624,A50正2兆豐97購02,0,0,0,0,0,0,0,0,0,180000,0,0,0,180000,0,180000,180000
051855,道瓊反凱基97購01,0,0,0,0,0,0,0,0,0,179000,0,0,0,179000,0,179000,179000
038489,T50反1台新9A購01,0,0,0,0,0,0,0,0,0,179000,0,0,0,179000,0,179000,179000
04272P,元上證凱基94售01,0,0,0,0,0,0,0,0,0,179000,0,0,0,179000,0,179000,179000
006206,元大上證50      ,154000,214000,-60000,0,0,0,0,0,0,239000,300000,0,300000,52000,113000,-61000,179000
047652,滬深2X兆豐94購03,0,0,0,0,0,0,0,0,0,178000,0,0,0,178000,0,178000,178000
057663,國巨元大99購08  ,0,0,0,0,0,0,0,0,0,176000,0,0,0,196000,20000,176000,176000
057835,華擎元富9B購01  ,0,0,0,0,0,0,0,0,0,176000,0,0,0,176000,0,176000,176000
3062,建漢            ,633000,406000,227000,0,0,0,0,0,0,-52000,1000,53000,-52000,0,0,0,175000
053482,矽力元大96購03  ,0,0,0,0,0,0,0,0,0,175000,0,0,0,180000,5000,175000,175000
055120,南港兆豐97購01  ,0,0,0,0,0,0,0,0,0,174000,0,0,0,226000,52000,174000,174000
053880,智邦中信96購01  ,0,0,0,0,0,0,0,0,0,174000,0,0,0,184000,10000,174000,174000
4919,新唐            ,197000,178000,19000,0,0,0,1000,0,1000,151000,169000,1000,168000,3000,20000,-17000,171000
048262,台積電元富94購01,0,0,0,0,0,0,0,0,0,171000,0,0,0,171000,0,171000,171000
048785,台積電元大96購01,0,0,0,0,0,0,0,0,0,171000,0,0,0,507000,336000,171000,171000
058426,旺宏元富99購02  ,0,0,0,0,0,0,0,0,0,170000,0,0,0,181000,11000,170000,170000
049136,華通元大95購01  ,0,0,0,0,0,0,0,0,0,170000,0,0,0,170000,0,170000,170000
03627P,大立光兆豐93售03,0,0,0,0,0,0,0,0,0,170000,0,0,0,170000,0,170000,170000
03177P,國巨群益01售12  ,0,0,0,0,0,0,0,0,0,170000,0,0,0,170000,0,170000,170000
056367,祥碩元大98購01  ,0,0,0,0,0,0,0,0,0,170000,0,0,0,180000,10000,170000,170000
056777,矽力元大98購02  ,0,0,0,0,0,0,0,0,0,170000,0,0,0,170000,0,170000,170000
052386,鴻海群益96購02  ,0,0,0,0,0,0,0,0,0,170000,0,0,0,240000,70000,170000,170000
055216,友達凱基98購05  ,0,0,0,0,0,0,0,0,0,170000,0,0,0,170000,0,170000,170000
053894,創意群益96購01  ,0,0,0,0,0,0,0,0,0,169000,0,0,0,180000,11000,169000,169000
1515,力山            ,613000,420000,193000,0,0,0,0,0,0,-25000,0,25000,-25000,1000,1000,0,168000
04672P,台積電統一94售09,0,0,0,0,0,0,0,0,0,168000,0,0,0,198000,30000,168000,168000
057202,TPK元富98購02   ,0,0,0,0,0,0,0,0,0,168000,0,0,0,168000,0,168000,168000
06407P,創意元富97售02  ,0,0,0,0,0,0,0,0,0,167000,0,0,0,167000,0,167000,167000
057127,旺宏凱基98購09  ,0,0,0,0,0,0,0,0,0,167000,0,0,0,170000,3000,167000,167000
06738P,瑞昱兆豐98售02  ,0,0,0,0,0,0,0,0,0,166000,0,0,0,217000,51000,166000,166000
06992P,玉晶光日盛9B售01,0,0,0,0,0,0,0,0,0,166000,0,0,0,227000,61000,166000,166000
047689,瑞昱富邦97購01  ,0,0,0,0,0,0,0,0,0,166000,0,0,0,166000,0,166000,166000
058997,鴻海元大99購21  ,0,0,0,0,0,0,0,0,0,165000,0,0,0,385000,220000,165000,165000
2405,浩鑫            ,361000,197000,164000,0,0,0,0,0,0,0,0,0,0,0,0,0,164000
051684,瑞昱凱基95購02  ,0,0,0,0,0,0,0,0,0,164000,0,0,0,164000,0,164000,164000
051613,S&P反1凱基96購01,0,0,0,0,0,0,0,0,0,163000,0,0,0,163000,0,163000,163000
08653P,台灣50凱基96售07,0,0,0,0,0,0,0,0,0,162000,0,0,0,181000,19000,162000,162000
058898,台積電元大99購20,0,0,0,0,0,0,0,0,0,162000,0,0,0,171000,9000,162000,162000
058794,旺宏元大99購09  ,0,0,0,0,0,0,0,0,0,162000,0,0,0,347000,185000,162000,162000
050165,泰鼎國泰95購02  ,0,0,0,0,0,0,0,0,0,162000,0,0,0,163000,1000,162000,162000
053765,智邦富邦96購01  ,0,0,0,0,0,0,0,0,0,162000,0,0,0,162000,0,162000,162000
056715,瀚宇博永豐98購01,0,0,0,0,0,0,0,0,0,161000,0,0,0,166000,5000,161000,161000
04555P,元油2X群益95售01,0,0,0,0,0,0,0,0,0,161000,0,0,0,941000,780000,161000,161000
049003,智邦中信95購01  ,0,0,0,0,0,0,0,0,0,160000,0,0,0,160000,0,160000,160000
057206,立積元富98購01  ,0,0,0,0,0,0,0,0,0,159000,0,0,0,171000,12000,159000,159000
058211,國巨群益9A購02  ,0,0,0,0,0,0,0,0,0,159000,0,0,0,190000,31000,159000,159000
056096,超眾元富9A購01  ,0,0,0,0,0,0,0,0,0,158000,0,0,0,168000,10000,158000,158000
055910,瑞昱凱基98購01  ,0,0,0,0,0,0,0,0,0,158000,0,0,0,158000,0,158000,158000
046792,京元電元富96購01,0,0,0,0,0,0,0,0,0,156000,0,0,0,428000,272000,156000,156000
056501,貿聯富邦99購01  ,0,0,0,0,0,0,0,0,0,156000,0,0,0,156000,0,156000,156000
049505,臺股指元大94購16,0,0,0,0,0,0,0,0,0,156000,0,0,0,156000,0,156000,156000
054644,A50正2群益9B購01,0,0,0,0,0,0,0,0,0,156000,0,0,0,156000,0,156000,156000
053493,智邦兆豐97購02  ,0,0,0,0,0,0,0,0,0,156000,0,0,0,204000,48000,156000,156000
058634,可成兆豐99購03  ,0,0,0,0,0,0,0,0,0,155000,0,0,0,155000,0,155000,155000
047212,宏達電富邦97購01,0,0,0,0,0,0,0,0,0,155000,0,0,0,415000,260000,155000,155000
058136,景碩元大99購02  ,0,0,0,0,0,0,0,0,0,155000,0,0,0,160000,5000,155000,155000
058116,正崴中信99購02  ,0,0,0,0,0,0,0,0,0,155000,0,0,0,203000,48000,155000,155000
2337,旺宏            ,13717000,14081000,-364000,0,0,0,1660000,375000,1285000,-767000,567000,424000,143000,205000,1115000,-910000,154000
057575,世紀鋼永豐98購02,0,0,0,0,0,0,0,0,0,154000,0,0,0,224000,70000,154000,154000
055562,欣興凱基97購06  ,0,0,0,0,0,0,0,0,0,154000,0,0,0,154000,0,154000,154000
058935,元油2X中信9C購03,0,0,0,0,0,0,0,0,0,153000,0,0,0,153000,0,153000,153000
050801,元金2X群益98購01,0,0,0,0,0,0,0,0,0,153000,0,0,0,153000,0,153000,153000
056872,旺宏凱基98購08  ,0,0,0,0,0,0,0,0,0,153000,0,0,0,153000,0,153000,153000
056932,T50反1元富98購01,0,0,0,0,0,0,0,0,0,152000,0,0,0,152000,0,152000,152000
052209,深中小元大95購02,0,0,0,0,0,0,0,0,0,151000,0,0,0,151000,0,151000,151000
055773,瑞昱凱基97購03  ,0,0,0,0,0,0,0,0,0,151000,0,0,0,161000,10000,151000,151000
057965,臺股指元大98購14,0,0,0,0,0,0,0,0,0,151000,0,0,0,217000,66000,151000,151000
08570P,台灣50凱基96售03,0,0,0,0,0,0,0,0,0,150000,0,0,0,150000,0,150000,150000
052185,奇力新群益95購03,0,0,0,0,0,0,0,0,0,150000,0,0,0,150000,0,150000,150000
050137,臺指反國票96購01,0,0,0,0,0,0,0,0,0,150000,0,0,0,150000,0,150000,150000
050636,上証2X國票94購01,0,0,0,0,0,0,0,0,0,150000,0,0,0,150000,0,150000,150000
046648,和鑫國泰94購01  ,0,0,0,0,0,0,0,0,0,150000,0,0,0,150000,0,150000,150000
052969,建準群益97購01  ,0,0,0,0,0,0,0,0,0,150000,0,0,0,150000,0,150000,150000
048637,鴻海元大96購01  ,0,0,0,0,0,0,0,0,0,150000,0,0,0,595000,445000,150000,150000
057026,長榮航凱基98購01,0,0,0,0,0,0,0,0,0,150000,0,0,0,150000,0,150000,150000
054876,群電群益97購02  ,0,0,0,0,0,0,0,0,0,150000,0,0,0,150000,0,150000,150000
054863,億光群益97購01  ,0,0,0,0,0,0,0,0,0,150000,0,0,0,150000,0,150000,150000
055029,帆宣國泰99購01  ,0,0,0,0,0,0,0,0,0,150000,0,0,0,160000,10000,150000,150000
055092,開發金群益9B購01,0,0,0,0,0,0,0,0,0,150000,0,0,0,150000,0,150000,150000
055303,鈺齊元大97購01  ,0,0,0,0,0,0,0,0,0,150000,0,0,0,150000,0,150000,150000
054248,燿華元大97購02  ,0,0,0,0,0,0,0,0,0,150000,0,0,0,150000,0,150000,150000
055336,茂林兆豐98購01  ,0,0,0,0,0,0,0,0,0,150000,0,0,0,150000,0,150000,150000
056963,建準永豐98購01  ,0,0,0,0,0,0,0,0,0,150000,0,0,0,150000,0,150000,150000
055459,建準永豐97購03  ,0,0,0,0,0,0,0,0,0,150000,0,0,0,150000,0,150000,150000
054790,禾伸堂群益98購01,0,0,0,0,0,0,0,0,0,150000,0,0,0,150000,0,150000,150000
054819,裕民元大9A購01  ,0,0,0,0,0,0,0,0,0,150000,0,0,0,300000,150000,150000,150000
058506,台積電元大99購09,0,0,0,0,0,0,0,0,0,149000,0,0,0,149000,0,149000,149000
06552P,茂林元大99售02  ,0,0,0,0,0,0,0,0,0,149000,0,0,0,235000,86000,149000,149000
056318,鴻海群益98購02  ,0,0,0,0,0,0,0,0,0,149000,0,0,0,249000,100000,149000,149000
056507,創意永豐98購02  ,0,0,0,0,0,0,0,0,0,149000,0,0,0,185000,36000,149000,149000
054711,禾伸堂元富97購01,0,0,0,0,0,0,0,0,0,149000,0,0,0,149000,0,149000,149000
057743,華擎永豐98購03  ,0,0,0,0,0,0,0,0,0,149000,0,0,0,150000,1000,149000,149000
057786,聯發科國票98購05,0,0,0,0,0,0,0,0,0,149000,0,0,0,159000,10000,149000,149000
06588P,台積電元大98售11,0,0,0,0,0,0,0,0,0,148000,0,0,0,148000,0,148000,148000
07044P,台積電元大99售13,0,0,0,0,0,0,0,0,0,148000,0,0,0,148000,0,148000,148000
054846,瑞昱兆豐97購01  ,0,0,0,0,0,0,0,0,0,148000,0,0,0,148000,0,148000,148000
6414,樺漢            ,404000,176000,228000,0,0,0,0,0,0,-81000,106000,176000,-70000,2000,13000,-11000,147000
058283,世紀鋼中信99購01,0,0,0,0,0,0,0,0,0,146000,0,0,0,917000,771000,146000,146000
053293,聯發科中信9B購01,0,0,0,0,0,0,0,0,0,146000,0,0,0,175000,29000,146000,146000
05538P,玉晶光國票97售02,0,0,0,0,0,0,0,0,0,146000,0,0,0,146000,0,146000,146000
054335,緯穎永豐96購02  ,0,0,0,0,0,0,0,0,0,146000,0,0,0,146000,0,146000,146000
049761,亞德客國泰95購03,0,0,0,0,0,0,0,0,0,145000,0,0,0,145000,0,145000,145000
057557,聯茂凱基99購04  ,0,0,0,0,0,0,0,0,0,145000,0,0,0,163000,18000,145000,145000
056002,嘉晶永豐97購01  ,0,0,0,0,0,0,0,0,0,145000,0,0,0,246000,101000,145000,145000
05635P,健策台新96售02  ,0,0,0,0,0,0,0,0,0,144000,0,0,0,263000,119000,144000,144000
055466,台達電凱基97購03,0,0,0,0,0,0,0,0,0,144000,0,0,0,144000,0,144000,144000
052674,智邦國泰98購01  ,0,0,0,0,0,0,0,0,0,143000,0,0,0,176000,33000,143000,143000
04225P,台積電元富94售02,0,0,0,0,0,0,0,0,0,143000,0,0,0,143000,0,143000,143000
052417,聯發科兆豐9B購01,0,0,0,0,0,0,0,0,0,142000,0,0,0,242000,100000,142000,142000
058074,欣興凱基99購01  ,0,0,0,0,0,0,0,0,0,142000,0,0,0,292000,150000,142000,142000
057183,玉晶光元大99購07,0,0,0,0,0,0,0,0,0,142000,0,0,0,257000,115000,142000,142000
058542,T50反1富邦9B購01,0,0,0,0,0,0,0,0,0,141000,0,0,0,200000,59000,141000,141000
058659,力成中信99購01  ,0,0,0,0,0,0,0,0,0,141000,0,0,0,333000,192000,141000,141000
058824,晶技富邦9A購01  ,0,0,0,0,0,0,0,0,0,141000,0,0,0,141000,0,141000,141000
4164,承業醫          ,283000,140000,143000,0,0,0,0,0,0,-2000,7000,9000,-2000,0,0,0,141000
055726,台表科元大98購03,0,0,0,0,0,0,0,0,0,141000,0,0,0,141000,0,141000,141000
056967,奇鋐永豐98購01  ,0,0,0,0,0,0,0,0,0,141000,0,0,0,146000,5000,141000,141000
058797,大毅元大99購03  ,0,0,0,0,0,0,0,0,0,140000,0,0,0,214000,74000,140000,140000
058658,瑞儀中信99購01  ,0,0,0,0,0,0,0,0,0,140000,0,0,0,209000,69000,140000,140000
050347,上証2X群益98購01,0,0,0,0,0,0,0,0,0,140000,0,0,0,340000,200000,140000,140000
03026P,國巨元大01售13  ,0,0,0,0,0,0,0,0,0,140000,0,0,0,140000,0,140000,140000
00710B,FH彭博高收益債  ,0,0,0,0,0,0,0,0,0,140000,0,0,0,240000,100000,140000,140000
046629,群創統一98購01  ,0,0,0,0,0,0,0,0,0,140000,0,0,0,140000,0,140000,140000
046906,新光金凱基99購02,0,0,0,0,0,0,0,0,0,140000,0,0,0,140000,0,140000,140000
047482,新光金凱基99購03,0,0,0,0,0,0,0,0,0,140000,0,0,0,200000,60000,140000,140000
055028,佐登國泰98購01  ,0,0,0,0,0,0,0,0,0,140000,0,0,0,190000,50000,140000,140000
054211,奇鋐國票97購03  ,0,0,0,0,0,0,0,0,0,140000,0,0,0,140000,0,140000,140000
053444,奇力新凱基96購03,0,0,0,0,0,0,0,0,0,140000,0,0,0,150000,10000,140000,140000
2498,宏達電          ,2179000,1707000,472000,0,0,0,0,0,0,-333000,31000,258000,-227000,97000,203000,-106000,139000
052413,上証反中信97購01,0,0,0,0,0,0,0,0,0,139000,0,0,0,165000,26000,139000,139000
052528,茂林元大95購05  ,0,0,0,0,0,0,0,0,0,138000,0,0,0,140000,2000,138000,138000
052003,泰碩國泰97購02  ,0,0,0,0,0,0,0,0,0,138000,0,0,0,138000,0,138000,138000
03635C,滬深2X元富99牛01,0,0,0,0,0,0,0,0,0,138000,0,0,0,138000,0,138000,138000
06006P,欣興永豐96售04  ,0,0,0,0,0,0,0,0,0,137000,0,0,0,159000,22000,137000,137000
042994,葡萄王元大94購02,0,0,0,0,0,0,0,0,0,137000,0,0,0,223000,86000,137000,137000
057849,南茂永豐98購02  ,0,0,0,0,0,0,0,0,0,137000,0,0,0,137000,0,137000,137000
03267P,台灣50元大02售06,0,0,0,0,0,0,0,0,0,136000,0,0,0,147000,11000,136000,136000
6196,帆宣            ,460000,341000,119000,0,0,0,0,0,0,16000,0,0,0,20000,4000,16000,135000
051381,玉晶光群益98購01,0,0,0,0,0,0,0,0,0,135000,0,0,0,165000,30000,135000,135000
057882,華通群益9A購03  ,0,0,0,0,0,0,0,0,0,135000,0,0,0,150000,15000,135000,135000
057673,臻鼎元大98購01  ,0,0,0,0,0,0,0,0,0,135000,0,0,0,135000,0,135000,135000
056157,聯詠凱基97購03  ,0,0,0,0,0,0,0,0,0,135000,0,0,0,234000,99000,135000,135000
053465,聯電元大96購05  ,0,0,0,0,0,0,0,0,0,135000,0,0,0,135000,0,135000,135000
055388,華通統一97購03  ,0,0,0,0,0,0,0,0,0,135000,0,0,0,135000,0,135000,135000
054137,聯詠元大97購02  ,0,0,0,0,0,0,0,0,0,135000,0,0,0,370000,235000,135000,135000
06730P,祥碩元大98售07  ,0,0,0,0,0,0,0,0,0,132000,0,0,0,390000,258000,132000,132000
050356,緯穎群益94購05  ,0,0,0,0,0,0,0,0,0,132000,0,0,0,132000,0,132000,132000
053658,亞光凱基96購01  ,0,0,0,0,0,0,0,0,0,132000,0,0,0,132000,0,132000,132000
051690,超眾凱基95購03  ,0,0,0,0,0,0,0,0,0,131000,0,0,0,131000,0,131000,131000
053602,台虹元大96購01  ,0,0,0,0,0,0,0,0,0,131000,0,0,0,153000,22000,131000,131000
050135,禾伸堂兆豐95購01,0,0,0,0,0,0,0,0,0,130000,0,0,0,130000,0,130000,130000
047521,台積電元大94購03,0,0,0,0,0,0,0,0,0,130000,0,0,0,130000,0,130000,130000
055322,欣興國票97購06  ,0,0,0,0,0,0,0,0,0,130000,0,0,0,130000,0,130000,130000
057372,華新科元大99購10,0,0,0,0,0,0,0,0,0,130000,0,0,0,130000,0,130000,130000
057475,聯電元大9A購01  ,0,0,0,0,0,0,0,0,0,130000,0,0,0,140000,10000,130000,130000
057176,全新元大99購02  ,0,0,0,0,0,0,0,0,0,130000,0,0,0,230000,100000,130000,130000
056245,嘉澤群益97購01  ,0,0,0,0,0,0,0,0,0,130000,0,0,0,130000,0,130000,130000
053154,聯詠元大96購01  ,0,0,0,0,0,0,0,0,0,130000,0,0,0,130000,0,130000,130000
058168,國巨凱基9A購04  ,0,0,0,0,0,0,0,0,0,130000,0,0,0,130000,0,130000,130000
06175P,台積電元大97售21,0,0,0,0,0,0,0,0,0,129000,0,0,0,129000,0,129000,129000
05096P,台積電日盛95售01,0,0,0,0,0,0,0,0,0,129000,0,0,0,349000,220000,129000,129000
06614P,祥碩永豐98售03  ,0,0,0,0,0,0,0,0,0,128000,0,0,0,173000,45000,128000,128000
06780P,義隆元大98售02  ,0,0,0,0,0,0,0,0,0,128000,0,0,0,130000,2000,128000,128000
04889P,華通元大94售03  ,0,0,0,0,0,0,0,0,0,128000,0,0,0,128000,0,128000,128000
058373,晶技凱基99購02  ,0,0,0,0,0,0,0,0,0,127000,0,0,0,209000,82000,127000,127000
057205,元翎元富98購01  ,0,0,0,0,0,0,0,0,0,127000,0,0,0,128000,1000,127000,127000
058830,健策永豐99購02  ,0,0,0,0,0,0,0,0,0,126000,0,0,0,126000,0,126000,126000
043961,道瓊反國泰94購01,0,0,0,0,0,0,0,0,0,125000,0,0,0,125000,0,125000,125000
051873,緯穎凱基95購02  ,0,0,0,0,0,0,0,0,0,125000,0,0,0,139000,14000,125000,125000
054426,國泰金富邦97購02,0,0,0,0,0,0,0,0,0,125000,0,0,0,125000,0,125000,125000
055907,台虹兆豐98購01  ,0,0,0,0,0,0,0,0,0,125000,0,0,0,125000,0,125000,125000
2425,承啟            ,441000,317000,124000,0,0,0,0,0,0,0,0,0,0,0,0,0,124000
056773,晶技元大99購03  ,0,0,0,0,0,0,0,0,0,124000,0,0,0,137000,13000,124000,124000
047722,南電凱基94購02  ,0,0,0,0,0,0,0,0,0,124000,0,0,0,134000,10000,124000,124000
053467,鴻海元大96購20  ,0,0,0,0,0,0,0,0,0,124000,0,0,0,124000,0,124000,124000
057132,華新科凱基98購05,0,0,0,0,0,0,0,0,0,124000,0,0,0,124000,0,124000,124000
05535P,台積電元大97售06,0,0,0,0,0,0,0,0,0,124000,0,0,0,125000,1000,124000,124000
053398,和鑫中信99購01  ,0,0,0,0,0,0,0,0,0,123000,0,0,0,123000,0,123000,123000
053197,超眾元富96購02  ,0,0,0,0,0,0,0,0,0,123000,0,0,0,123000,0,123000,123000
3515,華擎            ,309000,945000,-636000,0,0,0,905000,100000,805000,-47000,8000,13000,-5000,4000,46000,-42000,122000
06996P,臺股指凱基99售17,0,0,0,0,0,0,0,0,0,122000,0,0,0,122000,0,122000,122000
058717,南電台新99購02  ,0,0,0,0,0,0,0,0,0,122000,0,0,0,368000,246000,122000,122000
056074,茂林元大97購04  ,0,0,0,0,0,0,0,0,0,122000,0,0,0,142000,20000,122000,122000
055497,開發金元大97購01,0,0,0,0,0,0,0,0,0,122000,0,0,0,122000,0,122000,122000
06028P,智邦台新97售01  ,0,0,0,0,0,0,0,0,0,121000,0,0,0,122000,1000,121000,121000
042676,臺指反元大93購01,0,0,0,0,0,0,0,0,0,121000,0,0,0,121000,0,121000,121000
049653,緯穎凱基94購03  ,0,0,0,0,0,0,0,0,0,121000,0,0,0,121000,0,121000,121000
057889,致新群益99購01  ,0,0,0,0,0,0,0,0,0,121000,0,0,0,121000,0,121000,121000
8101,華冠            ,176000,55000,121000,0,0,0,0,0,0,0,0,0,0,0,0,0,121000
05965P,健策凱基96售05  ,0,0,0,0,0,0,0,0,0,120000,0,0,0,130000,10000,120000,120000
06347P,祥碩元富97售02  ,0,0,0,0,0,0,0,0,0,120000,0,0,0,130000,10000,120000,120000
058305,華邦電元大99購02,0,0,0,0,0,0,0,0,0,120000,0,0,0,120000,0,120000,120000
05149P,緯穎國泰96售01  ,0,0,0,0,0,0,0,0,0,120000,0,0,0,130000,10000,120000,120000
050362,深中小元大94購04,0,0,0,0,0,0,0,0,0,120000,0,0,0,120000,0,120000,120000
050433,華新科凱基94購11,0,0,0,0,0,0,0,0,0,120000,0,0,0,120000,0,120000,120000
050470,智邦台新94購01  ,0,0,0,0,0,0,0,0,0,120000,0,0,0,165000,45000,120000,120000
056517,茂林兆豐99購01  ,0,0,0,0,0,0,0,0,0,120000,0,0,0,120000,0,120000,120000
00639,富邦深100       ,660000,377000,283000,0,0,0,0,0,0,-163000,0,0,0,1097000,1260000,-163000,120000
048760,S&P反1凱基94購01,0,0,0,0,0,0,0,0,0,120000,0,0,0,120000,0,120000,120000
045837,群創群益98購02  ,0,0,0,0,0,0,0,0,0,120000,0,0,0,120000,0,120000,120000
058151,台積電統一9A購04,0,0,0,0,0,0,0,0,0,120000,0,0,0,120000,0,120000,120000
053281,茂林元大96購02  ,0,0,0,0,0,0,0,0,0,120000,0,0,0,120000,0,120000,120000
057658,玉晶光兆豐99購02,0,0,0,0,0,0,0,0,0,120000,0,0,0,160000,40000,120000,120000
057709,電子類群益98購01,0,0,0,0,0,0,0,0,0,120000,0,0,0,120000,0,120000,120000
054922,文曄凱基98購01  ,0,0,0,0,0,0,0,0,0,120000,0,0,0,140000,20000,120000,120000
053142,緯穎永豐96購01  ,0,0,0,0,0,0,0,0,0,120000,0,0,0,140000,20000,120000,120000
055367,台積電元大97購23,0,0,0,0,0,0,0,0,0,120000,0,0,0,120000,0,120000,120000
055348,旺宏凱基97購01  ,0,0,0,0,0,0,0,0,0,120000,0,0,0,120000,0,120000,120000
057121,立積康和98購01  ,0,0,0,0,0,0,0,0,0,120000,0,0,0,120000,0,120000,120000
06714P,台積電元大98售15,0,0,0,0,0,0,0,0,0,119000,0,0,0,119000,0,119000,119000
059153,臺股指國票99購16,0,0,0,0,0,0,0,0,0,119000,0,0,0,269000,150000,119000,119000
048551,鴻海元大94購02  ,0,0,0,0,0,0,0,0,0,118000,0,0,0,256000,138000,118000,118000
055674,南港康和97購02  ,0,0,0,0,0,0,0,0,0,118000,0,0,0,118000,0,118000,118000
054506,矽格永豐96購01  ,0,0,0,0,0,0,0,0,0,118000,0,0,0,172000,54000,118000,118000
6142,友勁            ,17000,5000,12000,0,0,0,0,0,0,105000,105000,0,105000,0,0,0,117000
047383,鴻海元大95購01  ,0,0,0,0,0,0,0,0,0,117000,0,0,0,229000,112000,117000,117000
051827,智邦元大95購04  ,0,0,0,0,0,0,0,0,0,117000,0,0,0,498000,381000,117000,117000
057385,光罩永豐99購01  ,0,0,0,0,0,0,0,0,0,117000,0,0,0,122000,5000,117000,117000
053639,禾伸堂永豐96購01,0,0,0,0,0,0,0,0,0,117000,0,0,0,135000,18000,117000,117000
052167,亞泥元大96購01  ,0,0,0,0,0,0,0,0,0,116000,0,0,0,277000,161000,116000,116000
052777,燿華國票98購01  ,0,0,0,0,0,0,0,0,0,116000,0,0,0,116000,0,116000,116000
053587,京元電元大98購01,0,0,0,0,0,0,0,0,0,116000,0,0,0,156000,40000,116000,116000
055387,世紀鋼元大97購01,0,0,0,0,0,0,0,0,0,116000,0,0,0,160000,44000,116000,116000
057141,嘉聯益兆豐99購01,0,0,0,0,0,0,0,0,0,116000,0,0,0,116000,0,116000,116000
054405,樺漢康和96購01  ,0,0,0,0,0,0,0,0,0,116000,0,0,0,116000,0,116000,116000
046208,滬深2X元富95購03,0,0,0,0,0,0,0,0,0,115000,0,0,0,115000,0,115000,115000
03252P,台積電台新02售01,0,0,0,0,0,0,0,0,0,115000,0,0,0,117000,2000,115000,115000
055408,力成國泰98購01  ,0,0,0,0,0,0,0,0,0,115000,0,0,0,135000,20000,115000,115000
054300,華通凱基96購07  ,0,0,0,0,0,0,0,0,0,115000,0,0,0,115000,0,115000,115000
4551,智伸科          ,308000,127000,181000,0,0,0,0,74000,-74000,6000,27000,20000,7000,0,1000,-1000,113000
050369,台積電元大94購23,0,0,0,0,0,0,0,0,0,113000,0,0,0,118000,5000,113000,113000
053219,祥碩凱基96購01  ,0,0,0,0,0,0,0,0,0,113000,0,0,0,123000,10000,113000,113000
053057,聯電國泰97購02  ,0,0,0,0,0,0,0,0,0,112000,0,0,0,413000,301000,112000,112000
910322,康師傅-DR       ,114000,2000,112000,0,0,0,0,0,0,0,0,0,0,0,0,0,112000
1316,上曜            ,240000,129000,111000,0,0,0,0,0,0,0,0,0,0,0,0,0,111000
05980P,台積電永昌96售09,0,0,0,0,0,0,0,0,0,111000,0,0,0,127000,16000,111000,111000
06496P,台灣50日盛98售01,0,0,0,0,0,0,0,0,0,111000,0,0,0,111000,0,111000,111000
03435B,臺股指凱基99熊29,0,0,0,0,0,0,0,0,0,111000,0,0,0,151000,40000,111000,111000
057862,智邦凱基99購01  ,0,0,0,0,0,0,0,0,0,111000,0,0,0,121000,10000,111000,111000
06528P,台積電富邦99售03,0,0,0,0,0,0,0,0,0,110000,0,0,0,117000,7000,110000,110000
03861P,群創元富99售01  ,0,0,0,0,0,0,0,0,0,110000,0,0,0,110000,0,110000,110000
048697,華新科國票94購06,0,0,0,0,0,0,0,0,0,110000,0,0,0,110000,0,110000,110000
052759,京元電群益96購01,0,0,0,0,0,0,0,0,0,110000,0,0,0,110000,0,110000,110000
050687,上銀日盛94購01  ,0,0,0,0,0,0,0,0,0,110000,0,0,0,110000,0,110000,110000
04973P,台積電凱基94售41,0,0,0,0,0,0,0,0,0,110000,0,0,0,240000,130000,110000,110000
04954P,健策國票96售01  ,0,0,0,0,0,0,0,0,0,110000,0,0,0,110000,0,110000,110000
052186,宏達電群益95購04,0,0,0,0,0,0,0,0,0,110000,0,0,0,110000,0,110000,110000
05179P,大立光凱基96售06,0,0,0,0,0,0,0,0,0,110000,0,0,0,110000,0,110000,110000
050998,訊連元大95購01  ,0,0,0,0,0,0,0,0,0,110000,0,0,0,110000,0,110000,110000
051762,國泰金元大95購01,0,0,0,0,0,0,0,0,0,110000,0,0,0,110000,0,110000,110000
056312,茂林元大98購01  ,0,0,0,0,0,0,0,0,0,110000,0,0,0,110000,0,110000,110000
056702,欣興國泰9A購01  ,0,0,0,0,0,0,0,0,0,110000,0,0,0,110000,0,110000,110000
057084,立積統一9B購01  ,0,0,0,0,0,0,0,0,0,110000,0,0,0,110000,0,110000,110000
053528,南電中信9A購01  ,0,0,0,0,0,0,0,0,0,110000,0,0,0,110000,0,110000,110000
053505,瑞儀兆豐97購01  ,0,0,0,0,0,0,0,0,0,110000,0,0,0,110000,0,110000,110000
057431,京鼎兆豐98購02  ,0,0,0,0,0,0,0,0,0,110000,0,0,0,110000,0,110000,110000
058856,新光金兆豐99購01,0,0,0,0,0,0,0,0,0,109000,0,0,0,109000,0,109000,109000
049835,緯穎凱基94購05  ,0,0,0,0,0,0,0,0,0,109000,0,0,0,125000,16000,109000,109000
049477,泰鼎永豐94購01  ,0,0,0,0,0,0,0,0,0,109000,0,0,0,182000,73000,109000,109000
055770,欣興麥證97購01  ,0,0,0,109000,0,109000,0,0,0,109000,0,0,0,109000,0,109000,109000
053551,可成凱基96購05  ,0,0,0,0,0,0,0,0,0,109000,0,0,0,109000,0,109000,109000
054303,國巨凱基96購15  ,0,0,0,0,0,0,0,0,0,109000,0,0,0,109000,0,109000,109000
054463,瑞昱凱基97購01  ,0,0,0,0,0,0,0,0,0,109000,0,0,0,119000,10000,109000,109000
055687,瀚宇博凱基97購01,0,0,0,0,0,0,0,0,0,109000,0,0,0,109000,0,109000,109000
058738,FBVIX中信03購04 ,0,0,0,0,0,0,0,0,0,108000,0,0,0,108000,0,108000,108000
057455,景碩國泰99購01  ,0,0,0,0,0,0,0,0,0,108000,0,0,0,108000,0,108000,108000
6451,訊芯-KY         ,608000,501000,107000,0,0,0,0,0,0,1000,8000,8000,0,9000,8000,1000,108000
06872P,亞德客元富98售04,0,0,0,0,0,0,0,0,0,107000,0,0,0,109000,2000,107000,107000
5471,松翰            ,663000,556000,107000,0,0,0,0,0,0,0,0,0,0,0,0,0,107000
04727P,臺股指凱基96售03,0,0,0,0,0,0,0,0,0,107000,0,0,0,107000,0,107000,107000
057386,聯發科永豐98購04,0,0,0,0,0,0,0,0,0,107000,0,0,0,157000,50000,107000,107000
057691,健策凱基99購01  ,0,0,0,0,0,0,0,0,0,107000,0,0,0,107000,0,107000,107000
2399,映泰            ,667000,561000,106000,0,0,0,0,0,0,0,0,0,0,0,0,0,106000
3022,威強電          ,166000,79000,87000,0,0,0,0,0,0,19000,19000,0,19000,0,0,0,106000
058306,聯發科元大99購07,0,0,0,0,0,0,0,0,0,106000,0,0,0,313000,207000,106000,106000
047603,瑞昱國泰94購01  ,0,0,0,0,0,0,0,0,0,106000,0,0,0,106000,0,106000,106000
04875P,台積電中信94售04,0,0,0,0,0,0,0,0,0,106000,0,0,0,106000,0,106000,106000
020000,富邦特選蘋果N   ,0,0,0,0,0,0,0,0,0,106000,0,0,0,161000,55000,106000,106000
051378,奇力新群益95購01,0,0,0,0,0,0,0,0,0,106000,0,0,0,106000,0,106000,106000
057815,信邦元大98購01  ,0,0,0,0,0,0,0,0,0,106000,0,0,0,364000,258000,106000,106000
057242,台郡凱基98購05  ,0,0,0,0,0,0,0,0,0,106000,0,0,0,150000,44000,106000,106000
053499,禾伸堂兆豐96購01,0,0,0,0,0,0,0,0,0,106000,0,0,0,116000,10000,106000,106000
2414,精技            ,226000,121000,105000,0,0,0,0,0,0,0,0,0,0,0,0,0,105000
051049,亞德客群益95購01,0,0,0,0,0,0,0,0,0,105000,0,0,0,120000,15000,105000,105000
044996,嘉晶國泰95購01  ,0,0,0,0,0,0,0,0,0,105000,0,0,0,305000,200000,105000,105000
03557P,欣興元大02售17  ,0,0,0,0,0,0,0,0,0,105000,0,0,0,105000,0,105000,105000
048509,上証反凱基99購02,0,0,0,0,0,0,0,0,0,105000,0,0,0,105000,0,105000,105000
05532P,臺股指群益96售05,0,0,0,0,0,0,0,0,0,105000,0,0,0,105000,0,105000,105000
053332,創意永豐96購03  ,0,0,0,0,0,0,0,0,0,105000,0,0,0,106000,1000,105000,105000
5215,科嘉-KY         ,171000,149000,22000,0,0,0,241000,144000,97000,-15000,0,15000,-15000,0,0,0,104000
047885,元金2X富邦99購01,0,0,0,0,0,0,0,0,0,104000,0,0,0,104000,0,104000,104000
050644,國巨凱基96購01  ,0,0,0,0,0,0,0,0,0,104000,0,0,0,314000,210000,104000,104000
055863,緯穎元大97購05  ,0,0,0,0,0,0,0,0,0,104000,0,0,0,210000,106000,104000,104000
054781,台化群益99購01  ,0,0,0,0,0,0,0,0,0,104000,0,0,0,503000,399000,104000,104000
058773,和碩兆豐99購01  ,0,0,0,0,0,0,0,0,0,103000,0,0,0,103000,0,103000,103000
052518,道瓊反元大95購02,0,0,0,0,0,0,0,0,0,103000,0,0,0,103000,0,103000,103000
04116P,京元電元大94售02,0,0,0,0,0,0,0,0,0,103000,0,0,0,120000,17000,103000,103000
054579,聯茂元大97購01  ,0,0,0,0,0,0,0,0,0,103000,0,0,0,210000,107000,103000,103000
058540,嘉聯益國泰9A購02,0,0,0,0,0,0,0,0,0,102000,0,0,0,102000,0,102000,102000
08818P,台灣50凱基01售18,0,0,0,0,0,0,0,0,0,102000,0,0,0,102000,0,102000,102000
052928,美律元大98購01  ,0,0,0,0,0,0,0,0,0,102000,0,0,0,102000,0,102000,102000
052229,奇力新凱基96購01,0,0,0,0,0,0,0,0,0,102000,0,0,0,102000,0,102000,102000
056321,創意群益98購02  ,0,0,0,0,0,0,0,0,0,102000,0,0,0,119000,17000,102000,102000
054912,群光凱基97購01  ,0,0,0,0,0,0,0,0,0,102000,0,0,0,140000,38000,102000,102000
057838,台郡國泰99購01  ,0,0,0,0,0,0,0,0,0,102000,0,0,0,102000,0,102000,102000
054363,世芯凱基97購01  ,0,0,0,0,0,0,0,0,0,102000,0,0,0,102000,0,102000,102000
4426,利勤            ,305000,193000,112000,0,0,0,0,0,0,-11000,0,0,0,0,11000,-11000,101000
059025,台灣50台新9B購02,0,0,0,0,0,0,0,0,0,101000,0,0,0,206000,105000,101000,101000
052515,矽力凱基95購02  ,0,0,0,0,0,0,0,0,0,101000,0,0,0,101000,0,101000,101000
052874,超眾凱基96購01  ,0,0,0,0,0,0,0,0,0,101000,0,0,0,139000,38000,101000,101000
051257,光寶科國泰96購01,0,0,0,0,0,0,0,0,0,101000,0,0,0,101000,0,101000,101000
047993,鑽全元大96購01  ,0,0,0,0,0,0,0,0,0,101000,0,0,0,101000,0,101000,101000
057260,微星兆豐98購01  ,0,0,0,0,0,0,0,0,0,101000,0,0,0,101000,0,101000,101000
055013,訊連元富97購01  ,0,0,0,0,0,0,0,0,0,101000,0,0,0,101000,0,101000,101000
056966,嘉晶永豐98購01  ,0,0,0,0,0,0,0,0,0,101000,0,0,0,170000,69000,101000,101000
058771,神達兆豐99購01  ,0,0,0,0,0,0,0,0,0,100000,0,0,0,100000,0,100000,100000
058835,元油2X中信9C購02,0,0,0,0,0,0,0,0,0,100000,0,0,0,100000,0,100000,100000
058377,茂林凱基9A購03  ,0,0,0,0,0,0,0,0,0,100000,0,0,0,100000,0,100000,100000
06176P,台積電元大97售22,0,0,0,0,0,0,0,0,0,100000,0,0,0,102000,2000,100000,100000
07240P,台灣50台新94售01,0,0,0,0,0,0,0,0,0,100000,0,0,0,100000,0,100000,100000
04850P,全新永豐94售03  ,0,0,0,0,0,0,0,0,0,100000,0,0,0,100000,0,100000,100000
04700P,臺股指元富94售06,0,0,0,0,0,0,0,0,0,100000,0,0,0,100000,0,100000,100000
051077,台郡國泰96購02  ,0,0,0,0,0,0,0,0,0,100000,0,0,0,100000,0,100000,100000
051058,景碩群益96購01  ,0,0,0,0,0,0,0,0,0,100000,0,0,0,100000,0,100000,100000
051092,禾伸堂元大95購02,0,0,0,0,0,0,0,0,0,100000,0,0,0,100000,0,100000,100000
051107,鴻海統一95購05  ,0,0,0,0,0,0,0,0,0,100000,0,0,0,100000,0,100000,100000
052760,盟立群益96購01  ,0,0,0,0,0,0,0,0,0,100000,0,0,0,100000,0,100000,100000
05277P,深中小統一95售02,0,0,0,0,0,0,0,0,0,100000,0,0,0,100000,0,100000,100000
049267,瀚宇博元大95購02,0,0,0,0,0,0,0,0,0,100000,0,0,0,100000,0,100000,100000
049283,滬深2X中信95購10,0,0,0,0,0,0,0,0,0,100000,0,0,0,100000,0,100000,100000
04190P,大立光兆豐94售03,0,0,0,0,0,0,0,0,0,100000,0,0,0,100000,0,100000,100000
042516,健策凱基93購01  ,0,0,0,0,0,0,0,0,0,100000,0,0,0,100000,0,100000,100000
051957,旺宏台新95購02  ,0,0,0,0,0,0,0,0,0,100000,0,0,0,100000,0,100000,100000
051409,美律國票96購01  ,0,0,0,0,0,0,0,0,0,100000,0,0,0,100000,0,100000,100000
049501,台郡元大95購01  ,0,0,0,0,0,0,0,0,0,100000,0,0,0,100000,0,100000,100000
052985,美律元大96購02  ,0,0,0,0,0,0,0,0,0,100000,0,0,0,100000,0,100000,100000
051996,康友元大95購01  ,0,0,0,0,0,0,0,0,0,100000,0,0,0,100000,0,100000,100000
050614,聯發科元大95購04,0,0,0,0,0,0,0,0,0,100000,0,0,0,100000,0,100000,100000
051540,力成國票95購01  ,0,0,0,0,0,0,0,0,0,100000,0,0,0,100000,0,100000,100000
050360,T50反1元大94購06,0,0,0,0,0,0,0,0,0,100000,0,0,0,100000,0,100000,100000
056335,微星凱基98購01  ,0,0,0,0,0,0,0,0,0,100000,0,0,0,100000,0,100000,100000
056718,GIS永豐98購01   ,0,0,0,0,0,0,0,0,0,100000,0,0,0,100000,0,100000,100000
056749,滬深2X兆豐99購01,0,0,0,0,0,0,0,0,0,100000,0,0,0,100000,0,100000,100000
049871,T50反1台新9A購02,0,0,0,0,0,0,0,0,0,100000,0,0,0,100000,0,100000,100000
050984,大立光國泰97購01,0,0,0,0,0,0,0,0,0,100000,0,0,0,100000,0,100000,100000
051729,華新國票96購01  ,0,0,0,0,0,0,0,0,0,100000,0,0,0,100000,0,100000,100000
055079,台光電中信97購01,0,0,0,0,0,0,0,0,0,100000,0,0,0,100000,0,100000,100000
054900,金寶康和97購01  ,0,0,0,0,0,0,0,0,0,100000,0,0,0,100000,0,100000,100000
054585,禾伸堂國泰99購01,0,0,0,0,0,0,0,0,0,100000,0,0,0,100000,0,100000,100000
057578,可成中信99購01  ,0,0,0,0,0,0,0,0,0,100000,0,0,0,100000,0,100000,100000
057589,超眾國票9A購01  ,0,0,0,0,0,0,0,0,0,100000,0,0,0,100000,0,100000,100000
057599,技嘉群益9A購01  ,0,0,0,0,0,0,0,0,0,100000,0,0,0,100000,0,100000,100000
057839,台積電富邦9A購02,0,0,0,0,0,0,0,0,0,100000,0,0,0,100000,0,100000,100000
057879,電子類元大99購02,0,0,0,0,0,0,0,0,0,100000,0,0,0,110000,10000,100000,100000
057892,上証2X元富02購01,0,0,0,0,0,0,0,0,0,100000,0,0,0,100000,0,100000,100000
058122,美律國票9A購01  ,0,0,0,0,0,0,0,0,0,100000,0,0,0,100000,0,100000,100000
058123,亞光國票9A購01  ,0,0,0,0,0,0,0,0,0,100000,0,0,0,100000,0,100000,100000
057682,台積電日盛9A購03,0,0,0,0,0,0,0,0,0,100000,0,0,0,240000,140000,100000,100000
057257,台泥兆豐99購01  ,0,0,0,0,0,0,0,0,0,100000,0,0,0,100000,0,100000,100000
055431,和鑫群益98購01  ,0,0,0,0,0,0,0,0,0,100000,0,0,0,100000,0,100000,100000
055417,健策富邦98購02  ,0,0,0,0,0,0,0,0,0,100000,0,0,0,100000,0,100000,100000
055372,宏達電元大97購04,0,0,0,0,0,0,0,0,0,100000,0,0,0,100000,0,100000,100000
055423,亞光亞東99購01  ,0,0,0,0,0,0,0,0,0,100000,0,0,0,100000,0,100000,100000
05363P,臺股指富邦95售03,0,0,0,0,0,0,0,0,0,100000,0,0,0,100000,0,100000,100000
053625,國巨兆豐96購03  ,0,0,0,0,0,0,0,0,0,100000,0,0,0,100000,0,100000,100000
056926,日月光兆豐98購01,0,0,0,0,0,0,0,0,0,100000,0,0,0,100000,0,100000,100000
053974,大立光元大96購10,0,0,0,0,0,0,0,0,0,100000,0,0,0,100000,0,100000,100000
054253,宏達電元大97購03,0,0,0,0,0,0,0,0,0,100000,0,0,0,100000,0,100000,100000
055290,玉晶光元大98購08,0,0,0,0,0,0,0,0,0,100000,0,0,0,110000,10000,100000,100000
054132,聯發科元大97購10,0,0,0,0,0,0,0,0,0,100000,0,0,0,100000,0,100000,100000
057306,玉晶光兆豐99購01,0,0,0,0,0,0,0,0,0,100000,0,0,0,100000,0,100000,100000
056991,牧德兆豐98購01  ,0,0,0,0,0,0,0,0,0,100000,0,0,0,100000,0,100000,100000
054015,晶豪科永豐96購03,0,0,0,0,0,0,0,0,0,100000,0,0,0,100000,0,100000,100000
054096,佳世達國票97購01,0,0,0,0,0,0,0,0,0,100000,0,0,0,100000,0,100000,100000
058383,道瓊指中信9C購02,0,0,0,0,0,0,0,0,0,99000,0,0,0,100000,1000,99000,99000
058303,華通元大99購03  ,0,0,0,0,0,0,0,0,0,99000,0,0,0,263000,164000,99000,99000
051619,智邦凱基95購07  ,0,0,0,0,0,0,0,0,0,99000,0,0,0,99000,0,99000,99000
056641,華通凱基98購03  ,0,0,0,0,0,0,0,0,0,99000,0,0,0,125000,26000,99000,99000
05076P,深中小群益99售02,0,0,0,0,0,0,0,0,0,99000,0,0,0,99000,0,99000,99000
042542,台灣50元大93購14,0,0,0,0,0,0,0,0,0,99000,0,0,0,99000,0,99000,99000
03615C,臺股指元大94牛01,0,0,0,0,0,0,0,0,0,99000,0,0,0,188000,89000,99000,99000
055212,和大凱基97購02  ,0,0,0,0,0,0,0,0,0,99000,0,0,0,99000,0,99000,99000
057179,可成元大98購04  ,0,0,0,0,0,0,0,0,0,99000,0,0,0,129000,30000,99000,99000
056972,祥碩永豐98購02  ,0,0,0,0,0,0,0,0,0,99000,0,0,0,181000,82000,99000,99000
055921,新唐凱基98購01  ,0,0,0,0,0,0,0,0,0,99000,0,0,0,99000,0,99000,99000
058747,友達凱基9A購03  ,0,0,0,0,0,0,0,0,0,98000,0,0,0,100000,2000,98000,98000
00865B,國泰US短期公債  ,0,0,0,0,0,0,0,0,0,98000,0,0,0,98000,0,98000,98000
056360,智邦元大98購01  ,0,0,0,0,0,0,0,0,0,98000,0,0,0,140000,42000,98000,98000
05012P,台積電元大95售07,0,0,0,0,0,0,0,0,0,98000,0,0,0,98000,0,98000,98000
055779,國泰金凱基97購02,0,0,0,0,0,0,0,0,0,98000,0,0,0,100000,2000,98000,98000
054785,建準群益98購01  ,0,0,0,0,0,0,0,0,0,98000,0,0,0,98000,0,98000,98000
058366,元大金凱基99購01,0,0,0,0,0,0,0,0,0,97000,0,0,0,97000,0,97000,97000
06589P,台積電元大98售12,0,0,0,0,0,0,0,0,0,97000,0,0,0,167000,70000,97000,97000
043735,元金2X元大94購01,0,0,0,0,0,0,0,0,0,97000,0,0,0,99000,2000,97000,97000
058267,奇鋐永豐99購01  ,0,0,0,0,0,0,0,0,0,96000,0,0,0,96000,0,96000,96000
051038,健策台新95購01  ,0,0,0,0,0,0,0,0,0,96000,0,0,0,96000,0,96000,96000
054716,緯穎康和97購01  ,0,0,0,0,0,0,0,0,0,96000,0,0,0,220000,124000,96000,96000
057847,聯茂永豐98購01  ,0,0,0,0,0,0,0,0,0,96000,0,0,0,96000,0,96000,96000
057634,道瓊反元大99購01,0,0,0,0,0,0,0,0,0,96000,0,0,0,96000,0,96000,96000
056362,聯發科元大99購01,0,0,0,0,0,0,0,0,0,95000,0,0,0,191000,96000,95000,95000
056623,禾伸堂永豐98購01,0,0,0,0,0,0,0,0,0,95000,0,0,0,95000,0,95000,95000
051349,國巨元大95購08  ,0,0,0,0,0,0,0,0,0,95000,0,0,0,150000,55000,95000,95000
03420B,臺股指元大95熊31,0,0,0,0,0,0,0,0,0,95000,0,0,0,95000,0,95000,95000
049141,旺宏元大95購01  ,0,0,0,0,0,0,0,0,0,95000,0,0,0,125000,30000,95000,95000
055018,緯穎元富97購02  ,0,0,0,0,0,0,0,0,0,95000,0,0,0,108000,13000,95000,95000
057592,美律兆豐99購01  ,0,0,0,0,0,0,0,0,0,95000,0,0,0,100000,5000,95000,95000
055148,鴻海元大98購02  ,0,0,0,0,0,0,0,0,0,95000,0,0,0,95000,0,95000,95000
047680,上証反中信96購01,0,0,0,0,0,0,0,0,0,94000,0,0,0,109000,15000,94000,94000
053561,玉晶光國泰98購01,0,0,0,0,0,0,0,0,0,94000,0,0,0,200000,106000,94000,94000
058063,旺宏中信98購04  ,0,0,0,0,0,0,0,0,0,94000,0,0,0,94000,0,94000,94000
058186,聯發科永豐99購01,0,0,0,0,0,0,0,0,0,94000,0,0,0,119000,25000,94000,94000
053638,信邦永豐96購01  ,0,0,0,0,0,0,0,0,0,93000,0,0,0,150000,57000,93000,93000
057207,立積元富98購02  ,0,0,0,0,0,0,0,0,0,93000,0,0,0,118000,25000,93000,93000
3532,台勝科          ,395000,793000,-398000,0,0,0,2000,171000,-169000,659000,3000,8000,-5000,665000,1000,664000,92000
04750P,臺股指元大94售26,0,0,0,0,0,0,0,0,0,92000,0,0,0,124000,32000,92000,92000
050553,緯穎凱基94購06  ,0,0,0,0,0,0,0,0,0,92000,0,0,0,92000,0,92000,92000
053687,智邦元大96購02  ,0,0,0,0,0,0,0,0,0,92000,0,0,0,244000,152000,92000,92000
056861,美律群益99購01  ,0,0,0,0,0,0,0,0,0,92000,0,0,0,92000,0,92000,92000
05442P,鴻海元大96售13  ,0,0,0,0,0,0,0,0,0,92000,0,0,0,199000,107000,92000,92000
9911,櫻花            ,613000,478000,135000,0,0,0,0,0,0,-43000,0,43000,-43000,0,0,0,92000
058688,矽創凱基9A購01  ,0,0,0,0,0,0,0,0,0,91000,0,0,0,111000,20000,91000,91000
050650,大立光凱基96購01,0,0,0,0,0,0,0,0,0,91000,0,0,0,92000,1000,91000,91000
049860,亞德客兆豐94購01,0,0,0,0,0,0,0,0,0,91000,0,0,0,91000,0,91000,91000
053322,京鼎群益97購01  ,0,0,0,0,0,0,0,0,0,91000,0,0,0,91000,0,91000,91000
058235,大立光元大99購08,0,0,0,0,0,0,0,0,0,91000,0,0,0,93000,2000,91000,91000
055501,創意元大97購01  ,0,0,0,0,0,0,0,0,0,91000,0,0,0,381000,290000,91000,91000
055144,T50反1元大97購03,0,0,0,0,0,0,0,0,0,91000,0,0,0,91000,0,91000,91000
055785,祥碩凱基97購02  ,0,0,0,0,0,0,0,0,0,91000,0,0,0,209000,118000,91000,91000
058532,禾伸堂元富99購01,0,0,0,0,0,0,0,0,0,90000,0,0,0,90000,0,90000,90000
058350,T50正2凱基9B購01,0,0,0,0,0,0,0,0,0,90000,0,0,0,90000,0,90000,90000
058964,群創兆豐99購01  ,0,0,0,0,0,0,0,0,0,90000,0,0,0,100000,10000,90000,90000
06058P,玉晶光凱基97售04,0,0,0,0,0,0,0,0,0,90000,0,0,0,100000,10000,90000,90000
08897P,國巨群益01售10  ,0,0,0,0,0,0,0,0,0,90000,0,0,0,90000,0,90000,90000
049885,緯穎永豐94購01  ,0,0,0,0,0,0,0,0,0,90000,0,0,0,90000,0,90000,90000
049814,超眾元大95購04  ,0,0,0,0,0,0,0,0,0,90000,0,0,0,130000,40000,90000,90000
056527,大成鋼凱基98購03,0,0,0,0,0,0,0,0,0,90000,0,0,0,90000,0,90000,90000
051982,深中小元大95購01,0,0,0,0,0,0,0,0,0,90000,0,0,0,220000,130000,90000,90000
049478,祥碩永豐94購02  ,0,0,0,0,0,0,0,0,0,90000,0,0,0,217000,127000,90000,90000
052700,奇鋐國票97購02  ,0,0,0,0,0,0,0,0,0,90000,0,0,0,90000,0,90000,90000
052624,微星亞東97購01  ,0,0,0,0,0,0,0,0,0,90000,0,0,0,90000,0,90000,90000
04687P,全新凱基94售02  ,0,0,0,0,0,0,0,0,0,90000,0,0,0,100000,10000,90000,90000
055759,技嘉群益98購02  ,0,0,0,0,0,0,0,0,0,90000,0,0,0,120000,30000,90000,90000
056425,聯發科日盛9A購01,0,0,0,0,0,0,0,0,0,90000,0,0,0,100000,10000,90000,90000
053888,和大群益97購01  ,0,0,0,0,0,0,0,0,0,90000,0,0,0,150000,60000,90000,90000
057208,上海銀元富98購01,0,0,0,0,0,0,0,0,0,90000,0,0,0,100000,10000,90000,90000
053486,T50反1兆豐96購01,0,0,0,0,0,0,0,0,0,90000,0,0,0,90000,0,90000,90000
05550P,臺股指元大96售07,0,0,0,0,0,0,0,0,0,90000,0,0,0,90000,0,90000,90000
055535,緯創群益98購01  ,0,0,0,0,0,0,0,0,0,90000,0,0,0,120000,30000,90000,90000
058229,為升元大99購02  ,100000,0,100000,0,0,0,0,0,0,-10000,0,0,0,0,10000,-10000,90000
057918,旺宏凱基99購01  ,0,0,0,0,0,0,0,0,0,90000,0,0,0,90000,0,90000,90000
055587,智邦元大97購02  ,0,0,0,0,0,0,0,0,0,90000,0,0,0,100000,10000,90000,90000
058735,南茂永豐99購01  ,0,0,0,0,0,0,0,0,0,89000,0,0,0,89000,0,89000,89000
058879,智邦富邦99購01  ,0,0,0,0,0,0,0,0,0,89000,0,0,0,189000,100000,89000,89000
047681,滬深反中信95購01,0,0,0,0,0,0,0,0,0,89000,0,0,0,186000,97000,89000,89000
056535,全新凱基99購02  ,0,0,0,0,0,0,0,0,0,89000,0,0,0,89000,0,89000,89000
051014,智邦凱基95購01  ,0,0,0,0,0,0,0,0,0,89000,0,0,0,188000,99000,89000,89000
052130,國巨凱基9B購01  ,0,0,0,0,0,0,0,0,0,89000,0,0,0,298000,209000,89000,89000
057834,聯發科元富02購07,0,0,0,0,0,0,0,0,0,89000,0,0,0,89000,0,89000,89000
058189,嘉澤永豐99購01  ,0,0,0,0,0,0,0,0,0,89000,0,0,0,102000,13000,89000,89000
059043,聯電日盛99購01  ,0,0,0,0,0,0,0,0,0,88000,0,0,0,323000,235000,88000,88000
07003P,聯發科兆豐99售02,0,0,0,0,0,0,0,0,0,88000,0,0,0,100000,12000,88000,88000
05774P,臺股指凱基99售04,0,0,0,0,0,0,0,0,0,88000,0,0,0,88000,0,88000,88000
053463,可成富邦98購01  ,0,0,0,0,0,0,0,0,0,88000,0,0,0,90000,2000,88000,88000
06152P,玉晶光元大98售06,0,0,0,0,0,0,0,0,0,87000,0,0,0,87000,0,87000,87000
05221P,玉晶光元大95售04,0,0,0,0,0,0,0,0,0,87000,0,0,0,766000,679000,87000,87000
006207,FH滬深          ,1000,36000,-35000,0,0,0,0,0,0,122000,60000,0,60000,95000,33000,62000,87000
06692P,瑞昱凱基98售03  ,0,0,0,0,0,0,0,0,0,86000,0,0,0,115000,29000,86000,86000
03434B,臺股指元大99熊10,0,0,0,0,0,0,0,0,0,86000,0,0,0,396000,310000,86000,86000
048574,台積電國泰95購02,0,0,0,0,0,0,0,0,0,86000,0,0,0,106000,20000,86000,86000
054756,世紀鋼凱基99購01,0,0,0,0,0,0,0,0,0,86000,0,0,0,102000,16000,86000,86000
05456P,鴻海凱基95售19  ,0,0,0,0,0,0,0,0,0,86000,0,0,0,602000,516000,86000,86000
056219,T50反1日盛02購01,0,0,0,0,0,0,0,0,0,85000,0,0,0,110000,25000,85000,85000
058201,華通凱基9A購01  ,0,0,0,0,0,0,0,0,0,85000,0,0,0,85000,0,85000,85000
057526,智邦元大98購10  ,0,0,0,0,0,0,0,0,0,85000,0,0,0,157000,72000,85000,85000
056386,TPK國泰99購01   ,0,0,0,0,0,0,0,0,0,85000,0,0,0,270000,185000,85000,85000
057136,立積凱基98購02  ,0,0,0,0,0,0,0,0,0,85000,0,0,0,85000,0,85000,85000
049349,國巨康和94購01  ,0,0,0,0,0,0,0,0,0,84000,0,0,0,84000,0,84000,84000
050586,康友國票94購01  ,0,0,0,0,0,0,0,0,0,84000,0,0,0,90000,6000,84000,84000
054710,東元元富97購01  ,0,0,0,0,0,0,0,0,0,84000,0,0,0,252000,168000,84000,84000
055399,超眾統一99購01  ,0,0,0,0,0,0,0,0,0,84000,0,0,0,99000,15000,84000,84000
054353,世紀鋼國泰98購01,0,0,0,0,0,0,0,0,0,84000,0,0,0,186000,102000,84000,84000
053083,中環元大99購01  ,0,0,0,0,0,0,0,0,0,84000,0,0,0,120000,36000,84000,84000
056044,同欣電凱基97購03,0,0,0,0,0,0,0,0,0,84000,0,0,0,84000,0,84000,84000
03889P,國巨國泰94售04  ,0,0,0,0,0,0,0,0,0,83000,0,0,0,83000,0,83000,83000
048976,華擎元大94購01  ,0,0,0,0,0,0,0,0,0,83000,0,0,0,83000,0,83000,83000
056228,可成凱基97購03  ,0,0,0,0,0,0,0,0,0,83000,0,0,0,83000,0,83000,83000
3060,銘異            ,234000,152000,82000,0,0,0,0,0,0,0,0,0,0,0,0,0,82000
052885,高鐵兆豐98購01  ,0,0,0,0,0,0,0,0,0,82000,0,0,0,123000,41000,82000,82000
052279,旺宏凱基95購07  ,0,0,0,0,0,0,0,0,0,82000,0,0,0,82000,0,82000,82000
052172,致茂元大95購01  ,0,0,0,0,0,0,0,0,0,82000,0,0,0,200000,118000,82000,82000
053996,晶相光群益97購01,0,0,0,0,0,0,0,0,0,82000,0,0,0,82000,0,82000,82000
056137,聯鈞元大9A購01  ,0,0,0,0,0,0,0,0,0,82000,0,0,0,83000,1000,82000,82000
057366,智邦元大98購08  ,0,0,0,0,0,0,0,0,0,82000,0,0,0,196000,114000,82000,82000
00665L,富邦恒生國企正2 ,137000,8000,129000,0,0,0,0,0,0,-48000,0,0,0,49000,97000,-48000,81000
044049,元金2X元大94購03,0,0,0,0,0,0,0,0,0,80000,0,0,0,430000,350000,80000,80000
040381,元金2X元富95購01,0,0,0,0,0,0,0,0,0,80000,0,0,0,80000,0,80000,80000
051269,康友富邦97購01  ,0,0,0,0,0,0,0,0,0,80000,0,0,0,80000,0,80000,80000
049236,元油2X元富96購06,0,0,0,0,0,0,0,0,0,80000,0,0,0,80000,0,80000,80000
047692,T50反1國票94購01,0,0,0,0,0,0,0,0,0,80000,0,0,0,80000,0,80000,80000
047355,世紀鋼凱基94購01,0,0,0,0,0,0,0,0,0,80000,0,0,0,80000,0,80000,80000
04729P,臺股指中信96售01,0,0,0,0,0,0,0,0,0,80000,0,0,0,80000,0,80000,80000
056533,友達凱基9A購02  ,0,0,0,0,0,0,0,0,0,80000,0,0,0,80000,0,80000,80000
051828,微星元大95購03  ,0,0,0,0,0,0,0,0,0,80000,0,0,0,110000,30000,80000,80000
052016,神基永豐95購01  ,0,0,0,0,0,0,0,0,0,80000,0,0,0,80000,0,80000,80000
054143,茂林元大96購04  ,0,0,0,0,0,0,0,0,0,80000,0,0,0,170000,90000,80000,80000
053898,康友群益97購01  ,0,0,0,0,0,0,0,0,0,80000,0,0,0,80000,0,80000,80000
053718,全新凱基97購02  ,0,0,0,0,0,0,0,0,0,80000,0,0,0,80000,0,80000,80000
054727,台積電日盛97購02,0,0,0,0,0,0,0,0,0,80000,0,0,0,80000,0,80000,80000
057041,國巨元大99購04  ,0,0,0,0,0,0,0,0,0,80000,0,0,0,109000,29000,80000,80000
055030,帆宣國泰99購02  ,0,0,0,0,0,0,0,0,0,80000,0,0,0,130000,50000,80000,80000
054893,帆宣統一99購01  ,0,0,0,0,0,0,0,0,0,80000,0,0,0,80000,0,80000,80000
057878,台郡元大99購04  ,0,0,0,0,0,0,0,0,0,80000,0,0,0,80000,0,80000,80000
055601,茂林元大97購03  ,0,0,0,0,0,0,0,0,0,80000,0,0,0,80000,0,80000,80000
054481,鎧勝中信96購01  ,0,0,0,0,0,0,0,0,0,80000,0,0,0,80000,0,80000,80000
020012,富邦行動通訊N   ,0,0,0,0,0,0,0,0,0,79000,0,0,0,672000,593000,79000,79000
05770P,聯發科凱基96售16,0,0,0,0,0,0,0,0,0,79000,0,0,0,102000,23000,79000,79000
1435,中福            ,103000,25000,78000,0,0,0,0,0,0,0,0,0,0,0,0,0,78000
05994P,奇鋐元大96售02  ,0,0,0,0,0,0,0,0,0,78000,0,0,0,243000,165000,78000,78000
058863,可成凱基99購02  ,0,0,0,0,0,0,0,0,0,78000,0,0,0,78000,0,78000,78000
00771,元大US高息特別股,0,0,0,0,0,0,0,0,0,78000,0,0,0,139000,61000,78000,78000
052056,緯穎凱基95購04  ,0,0,0,0,0,0,0,0,0,78000,0,0,0,85000,7000,78000,78000
053195,玉晶光元富96購02,0,0,0,0,0,0,0,0,0,78000,0,0,0,78000,0,78000,78000
07093P,台積電凱基99售07,0,0,0,0,0,0,0,0,0,77000,0,0,0,77000,0,77000,77000
2349,錸德            ,653000,575000,78000,0,0,0,0,0,0,-1000,0,1000,-1000,0,0,0,77000
048573,世紀鋼元大93購05,0,0,0,0,0,0,0,0,0,77000,0,0,0,177000,100000,77000,77000
056448,全新凱基99購01  ,0,0,0,0,0,0,0,0,0,77000,0,0,0,82000,5000,77000,77000
055749,智邦永昌9C購01  ,0,0,0,0,0,0,0,0,0,77000,0,0,0,77000,0,77000,77000
6283,淳安            ,176000,99000,77000,0,0,0,0,0,0,0,0,0,0,0,0,0,77000
6541,泰福-KY         ,242000,165000,77000,0,0,0,0,0,0,0,0,0,0,0,0,0,77000
06428P,國巨元大97售17  ,0,0,0,0,0,0,0,0,0,76000,0,0,0,80000,4000,76000,76000
04175P,台積電群益94售05,0,0,0,0,0,0,0,0,0,76000,0,0,0,76000,0,76000,76000
052802,華新科元大97購02,0,0,0,0,0,0,0,0,0,76000,0,0,0,81000,5000,76000,76000
053427,鎧勝永豐96購02  ,0,0,0,0,0,0,0,0,0,76000,0,0,0,96000,20000,76000,76000
054509,上証反元大99購01,0,0,0,0,0,0,0,0,0,76000,0,0,0,76000,0,76000,76000
056206,泰鼎永豐97購01  ,0,0,0,0,0,0,0,0,0,76000,0,0,0,127000,51000,76000,76000
059003,中壽元大99購01  ,0,0,0,0,0,0,0,0,0,75000,0,0,0,75000,0,75000,75000
07061P,台積電元大99售14,0,0,0,0,0,0,0,0,0,75000,0,0,0,84000,9000,75000,75000
06897P,FBVIX群益01售01 ,0,0,0,0,0,0,0,0,0,75000,0,0,0,653000,578000,75000,75000
06930P,台積電元大98售19,0,0,0,0,0,0,0,0,0,75000,0,0,0,157000,82000,75000,75000
047825,道瓊反元大96購01,0,0,0,0,0,0,0,0,0,75000,0,0,0,102000,27000,75000,75000
03885P,華新科統一96售01,0,0,0,0,0,0,0,0,0,75000,0,0,0,75000,0,75000,75000
042379,T50反1群益93購03,0,0,0,0,0,0,0,0,0,75000,0,0,0,75000,0,75000,75000
052601,大成鋼元大96購01,0,0,0,0,0,0,0,0,0,75000,0,0,0,80000,5000,75000,75000
049597,泰鼎元大96購01  ,0,0,0,0,0,0,0,0,0,75000,0,0,0,102000,27000,75000,75000
056988,聚陽兆豐98購01  ,0,0,0,0,0,0,0,0,0,75000,0,0,0,120000,45000,75000,75000
05791P,臺股指中信99售06,0,0,0,0,0,0,0,0,0,75000,0,0,0,75000,0,75000,75000
057828,緯穎元大99購02  ,0,0,0,0,0,0,0,0,0,75000,0,0,0,111000,36000,75000,75000
2882A,國泰特          ,0,7000,-7000,0,0,0,0,0,0,81000,81000,0,81000,0,0,0,74000
058973,麗豐永豐99購01  ,0,0,0,0,0,0,0,0,0,74000,0,0,0,91000,17000,74000,74000
059029,旺宏兆豐99購01  ,0,0,0,0,0,0,0,0,0,74000,0,0,0,74000,0,74000,74000
06332P,世紀鋼群益98售01,0,0,0,0,0,0,0,0,0,74000,0,0,0,129000,55000,74000,74000
050836,緯穎凱基95購01  ,0,0,0,0,0,0,0,0,0,74000,0,0,0,84000,10000,74000,74000
056453,禾伸堂凱基99購02,0,0,0,0,0,0,0,0,0,74000,0,0,0,74000,0,74000,74000
056231,嘉聯益凱基97購02,0,0,0,0,0,0,0,0,0,74000,0,0,0,74000,0,74000,74000
056041,禾伸堂凱基98購03,0,0,0,0,0,0,0,0,0,74000,0,0,0,74000,0,74000,74000
057138,亞德客兆豐98購01,0,0,0,0,0,0,0,0,0,74000,0,0,0,74000,0,74000,74000
06224P,可成元富97售02  ,0,0,0,0,0,0,0,0,0,73000,0,0,0,73000,0,73000,73000
058278,FBVIX中信03購02 ,0,0,0,0,0,0,0,0,0,73000,0,0,0,73000,0,73000,73000
058482,祥碩凱基99購02  ,0,0,0,0,0,0,0,0,0,73000,0,0,0,136000,63000,73000,73000
3661,世芯-KY         ,1133000,1098000,35000,0,0,0,135000,0,135000,-97000,0,38000,-38000,6000,65000,-59000,73000
07113P,台積電兆豐99售03,0,0,0,0,0,0,0,0,0,73000,0,0,0,161000,88000,73000,73000
050545,奇力新凱基95購01,0,0,0,0,0,0,0,0,0,73000,0,0,0,83000,10000,73000,73000
052171,台積電元大95購21,0,0,0,0,0,0,0,0,0,73000,0,0,0,93000,20000,73000,73000
051872,矽力凱基96購01  ,0,0,0,0,0,0,0,0,0,73000,0,0,0,83000,10000,73000,73000
056538,國泰金凱基98購01,0,0,0,0,0,0,0,0,0,73000,0,0,0,82000,9000,73000,73000
04327P,台積電國泰95售01,0,0,0,0,0,0,0,0,0,73000,0,0,0,73000,0,73000,73000
039212,台達電台新9A購01,0,0,0,0,0,0,0,0,0,73000,0,0,0,76000,3000,73000,73000
05519P,上証2X凱基98售01,0,0,0,0,0,0,0,0,0,73000,0,0,0,73000,0,73000,73000
053292,美律中信98購01  ,0,0,0,0,0,0,0,0,0,73000,0,0,0,83000,10000,73000,73000
2702,華園            ,101000,29000,72000,0,0,0,0,0,0,0,0,0,0,0,0,0,72000
03253P,台灣50國泰03售02,0,0,0,0,0,0,0,0,0,72000,0,0,0,286000,214000,72000,72000
051725,緯穎永豐95購02  ,0,0,0,0,0,0,0,0,0,72000,0,0,0,72000,0,72000,72000
05034P,台積電元大95售08,0,0,0,0,0,0,0,0,0,72000,0,0,0,94000,22000,72000,72000
049585,旺宏元大95購02  ,0,0,0,0,0,0,0,0,0,72000,0,0,0,106000,34000,72000,72000
057733,嘉聯益國泰99購01,0,0,0,0,0,0,0,0,0,72000,0,0,0,72000,0,72000,72000
056852,矽格元富98購01  ,0,0,0,0,0,0,0,0,0,72000,0,0,0,155000,83000,72000,72000
058817,嘉聯益台新99購01,0,0,0,0,0,0,0,0,0,71000,0,0,0,71000,0,71000,71000
051780,矽力群益95購01  ,0,0,0,0,0,0,0,0,0,71000,0,0,0,171000,100000,71000,71000
053309,泰鼎凱基96購03  ,0,0,0,0,0,0,0,0,0,71000,0,0,0,71000,0,71000,71000
058849,奇力新群益99購02,0,0,0,0,0,0,0,0,0,70000,0,0,0,150000,80000,70000,70000
058739,喬山中信99購01  ,0,0,0,0,0,0,0,0,0,70000,0,0,0,70000,0,70000,70000
058938,台積電中信01購03,0,0,0,0,0,0,0,0,0,70000,0,0,0,162000,92000,70000,70000
059169,可成凱基99購04  ,0,0,0,0,0,0,0,0,0,70000,0,0,0,70000,0,70000,70000
06470P,臺股指凱基99售10,0,0,0,0,0,0,0,0,0,70000,0,0,0,70000,0,70000,70000
06922P,元上證群益9C售01,0,0,0,0,0,0,0,0,0,70000,0,0,0,70000,0,70000,70000
04956P,臺股指日盛94售02,0,0,0,0,0,0,0,0,0,70000,0,0,0,70000,0,70000,70000
050327,泰鼎永豐94購03  ,0,0,0,0,0,0,0,0,0,70000,0,0,0,70000,0,70000,70000
050595,緯穎永豐94購03  ,0,0,0,0,0,0,0,0,0,70000,0,0,0,70000,0,70000,70000
050831,超眾凱基95購01  ,0,0,0,0,0,0,0,0,0,70000,0,0,0,70000,0,70000,70000
050760,矽力元富94購03  ,0,0,0,0,0,0,0,0,0,70000,0,0,0,70000,0,70000,70000
049170,亞德客凱基94購01,0,0,0,0,0,0,0,0,0,70000,0,0,0,70000,0,70000,70000
05288P,寶成元富95售02  ,0,0,0,0,0,0,0,0,0,70000,0,0,0,80000,10000,70000,70000
057777,可成群益9A購03  ,0,0,0,0,0,0,0,0,0,70000,0,0,0,70000,0,70000,70000
058182,日電貿國泰9A購01,0,0,0,0,0,0,0,0,0,70000,0,0,0,70000,0,70000,70000
055923,矽力凱基98購01  ,0,0,0,0,0,0,0,0,0,70000,0,0,0,75000,5000,70000,70000
056454,欣興凱基98購02  ,0,0,0,0,0,0,0,0,0,70000,0,0,0,70000,0,70000,70000
055110,美律凱基98購02  ,0,0,0,0,0,0,0,0,0,70000,0,0,0,70000,0,70000,70000
055516,上銀中信97購01  ,0,0,0,0,0,0,0,0,0,70000,0,0,0,70000,0,70000,70000
057029,緯穎凱基98購04  ,0,0,0,0,0,0,0,0,0,70000,0,0,0,70000,0,70000,70000
056913,臺股指元大99購05,0,0,0,0,0,0,0,0,0,70000,0,0,0,70000,0,70000,70000
054166,日電貿凱基98購01,0,0,0,0,0,0,0,0,0,70000,0,0,0,70000,0,70000,70000
055294,智易元大98購01  ,0,0,0,0,0,0,0,0,0,70000,0,0,0,200000,130000,70000,70000
055282,聯發科元大97購15,0,0,0,0,0,0,0,0,0,70000,0,0,0,70000,0,70000,70000
055380,智易元大98購02  ,0,0,0,0,0,0,0,0,0,70000,0,0,0,90000,20000,70000,70000
054751,GIS凱基98購01   ,0,0,0,0,0,0,0,0,0,70000,0,0,0,70000,0,70000,70000
06901P,亞德客凱基98售02,0,0,0,0,0,0,0,0,0,69000,0,0,0,69000,0,69000,69000
07075P,FBVIX凱基9C售04 ,0,0,0,0,0,0,0,0,0,69000,0,0,0,102000,33000,69000,69000
059119,華擎永豐99購02  ,0,0,0,0,0,0,0,0,0,69000,0,0,0,134000,65000,69000,69000
06216P,上銀元富97售03  ,0,0,0,0,0,0,0,0,0,69000,0,0,0,69000,0,69000,69000
058834,GIS永豐99購01   ,0,0,0,0,0,0,0,0,0,69000,0,0,0,69000,0,69000,69000
04434P,玉晶光國票96售02,0,0,0,0,0,0,0,0,0,69000,0,0,0,74000,5000,69000,69000
049582,台積電元大95購03,0,0,0,0,0,0,0,0,0,69000,0,0,0,69000,0,69000,69000
053662,矽力凱基97購01  ,0,0,0,0,0,0,0,0,0,69000,0,0,0,82000,13000,69000,69000
054841,亞德客兆豐97購01,20000,0,20000,0,0,0,0,0,0,49000,0,0,0,264000,215000,49000,69000
056452,亞光凱基98購02  ,0,0,0,0,0,0,0,0,0,69000,0,0,0,69000,0,69000,69000
056133,可成元大97購05  ,0,0,0,0,0,0,0,0,0,69000,0,0,0,100000,31000,69000,69000
058382,S&P500中信99購01,0,0,0,0,0,0,0,0,0,68000,0,0,0,68000,0,68000,68000
052178,台郡元大96購03  ,0,0,0,0,0,0,0,0,0,68000,0,0,0,68000,0,68000,68000
056492,全新國泰9A購01  ,0,0,0,0,0,0,0,0,0,68000,0,0,0,68000,0,68000,68000
056637,台光電日盛9A購01,0,0,0,0,0,0,0,0,0,68000,0,0,0,71000,3000,68000,68000
04294P,台積電元大95售01,5000,0,5000,0,0,0,0,0,0,63000,0,0,0,106000,43000,63000,68000
046740,大立光群益95購01,0,0,0,0,0,0,0,0,0,68000,0,0,0,68000,0,68000,68000
053759,晶相光國泰98購01,0,0,0,0,0,0,0,0,0,68000,0,0,0,68000,0,68000,68000
055780,禾伸堂凱基99購01,0,0,0,0,0,0,0,0,0,68000,0,0,0,68000,0,68000,68000
058309,大毅元大99購02  ,0,0,0,0,0,0,0,0,0,67000,0,0,0,110000,43000,67000,67000
058363,全新凱基9A購02  ,0,0,0,0,0,0,0,0,0,67000,0,0,0,77000,10000,67000,67000
058606,聯發科元大99購13,0,0,0,0,0,0,0,0,0,67000,0,0,0,205000,138000,67000,67000
05901P,臺股指凱基9C售01,0,0,0,0,0,0,0,0,0,67000,0,0,0,67000,0,67000,67000
055912,宏達電凱基98購03,0,0,0,0,0,0,0,0,0,67000,0,0,0,77000,10000,67000,67000
055025,華新科國泰98購02,0,0,0,0,0,0,0,0,0,67000,0,0,0,72000,5000,67000,67000
6416,瑞祺電通        ,477000,362000,115000,0,0,0,80000,121000,-41000,-7000,56000,63000,-7000,0,0,0,67000
06219P,國巨元富97售05  ,0,0,0,0,0,0,0,0,0,66000,0,0,0,66000,0,66000,66000
051087,國巨元大97購01  ,0,0,0,0,0,0,0,0,0,66000,0,0,0,174000,108000,66000,66000
04401P,玉晶光兆豐94售01,0,0,0,0,0,0,0,0,0,66000,0,0,0,126000,60000,66000,66000
04497P,元油2X富邦97售03,0,0,0,0,0,0,0,0,0,66000,0,0,0,66000,0,66000,66000
041527,T50反1中信96購01,0,0,0,0,0,0,0,0,0,66000,0,0,0,66000,0,66000,66000
057018,亞德客凱基98購01,0,0,0,0,0,0,0,0,0,66000,0,0,0,66000,0,66000,66000
058015,旺宏凱基99購02  ,0,0,0,0,0,0,0,0,0,66000,0,0,0,66000,0,66000,66000
053501,明泰兆豐96購01  ,0,0,0,0,0,0,0,0,0,66000,0,0,0,66000,0,66000,66000
059087,台積電元大99購26,0,0,0,0,0,0,0,0,0,65000,0,0,0,606000,541000,65000,65000
06963P,鴻海凱基99售04  ,0,0,0,0,0,0,0,0,0,65000,0,0,0,65000,0,65000,65000
049394,T50反1群益94購01,0,0,0,0,0,0,0,0,0,65000,0,0,0,65000,0,65000,65000
050754,元金2X元富9B購01,0,0,0,0,0,0,0,0,0,65000,0,0,0,65000,0,65000,65000
051576,台積電元大97購02,0,0,0,0,0,0,0,0,0,65000,0,0,0,95000,30000,65000,65000
053951,T50反1台新06購02,0,0,0,0,0,0,0,0,0,65000,0,0,0,65000,0,65000,65000
058059,晶技元富98購01  ,0,0,0,0,0,0,0,0,0,65000,0,0,0,65000,0,65000,65000
057645,華新科元大99購11,0,0,0,0,0,0,0,0,0,65000,0,0,0,65000,0,65000,65000
053166,聯詠群益96購02  ,0,0,0,0,0,0,0,0,0,65000,0,0,0,65000,0,65000,65000
05295P,緯創凱基95售01  ,0,0,0,0,0,0,0,0,0,64000,0,0,0,114000,50000,64000,64000
046961,大立光中信95購02,0,0,0,0,0,0,0,0,0,64000,0,0,0,96000,32000,64000,64000
056077,矽力元大97購07  ,0,0,0,0,0,0,0,0,0,64000,0,0,0,64000,0,64000,64000
057883,中環群益98購01  ,0,0,0,0,0,0,0,0,0,64000,0,0,0,65000,1000,64000,64000
058204,世芯凱基9A購01  ,0,0,0,0,0,0,0,0,0,64000,0,0,0,64000,0,64000,64000
058245,訊連元大99購01  ,0,0,0,0,0,0,0,0,0,64000,0,0,0,70000,6000,64000,64000
053361,友達元富99購01  ,0,0,0,0,0,0,0,0,0,64000,0,0,0,64000,0,64000,64000
053708,道瓊反凱基98購01,0,0,0,0,0,0,0,0,0,64000,0,0,0,64000,0,64000,64000
053534,微星永豐96購02  ,0,0,0,0,0,0,0,0,0,64000,0,0,0,64000,0,64000,64000
055808,世紀鋼永豐97購01,0,0,0,0,0,0,0,0,0,64000,0,0,0,93000,29000,64000,64000
06961P,台積電凱基99售05,0,0,0,0,0,0,0,0,0,63000,0,0,0,64000,1000,63000,63000
058673,華新科群益9A購02,0,0,0,0,0,0,0,0,0,63000,0,0,0,67000,4000,63000,63000
05971P,世紀鋼永豐96售04,0,0,0,0,0,0,0,0,0,63000,0,0,0,63000,0,63000,63000
046476,鴻海統一96購01  ,0,0,0,0,0,0,0,0,0,63000,0,0,0,63000,0,63000,63000
050031,嘉澤元大95購01  ,0,0,0,0,0,0,0,0,0,63000,0,0,0,73000,10000,63000,63000
057447,智邦元富02購01  ,0,0,0,0,0,0,0,0,0,63000,0,0,0,123000,60000,63000,63000
054720,禾伸堂永豐97購01,0,0,0,0,0,0,0,0,0,63000,0,0,0,63000,0,63000,63000
06022P,緯穎永豐96售03  ,0,0,0,0,0,0,0,0,0,62000,0,0,0,152000,90000,62000,62000
06193P,台積電元富97售04,0,0,0,0,0,0,0,0,0,62000,0,0,0,94000,32000,62000,62000
052428,嘉晶永豐95購01  ,0,0,0,0,0,0,0,0,0,62000,0,0,0,131000,69000,62000,62000
04496P,國巨國泰96售02  ,0,0,0,0,0,0,0,0,0,62000,0,0,0,62000,0,62000,62000
056434,國巨凱基98購03  ,0,0,0,0,0,0,0,0,0,62000,0,0,0,72000,10000,62000,62000
055788,緯穎凱基97購04  ,0,0,0,0,0,0,0,0,0,62000,0,0,0,62000,0,62000,62000
057151,易華電國票99購01,0,0,0,0,0,0,0,0,0,62000,0,0,0,62000,0,62000,62000
058025,聯茂國泰99購01  ,0,0,0,0,0,0,0,0,0,62000,0,0,0,62000,0,62000,62000
06038P,國泰金台新96售01,0,0,0,0,0,0,0,0,0,61000,0,0,0,220000,159000,61000,61000
058369,亞光凱基99購02  ,0,0,0,0,0,0,0,0,0,61000,0,0,0,62000,1000,61000,61000
2355,敬鵬            ,425000,385000,40000,0,0,0,0,0,0,21000,78000,57000,21000,0,0,0,61000
058180,華新科國泰9A購01,0,0,0,0,0,0,0,0,0,61000,0,0,0,61000,0,61000,61000
06966P,健策台新9A售02  ,0,0,0,0,0,0,0,0,0,60000,0,0,0,60000,0,60000,60000
058326,祥碩台新99購01  ,0,0,0,0,0,0,0,0,0,60000,0,0,0,60000,0,60000,60000
058565,鴻海凱基9A購07  ,0,0,0,0,0,0,0,0,0,60000,0,0,0,61000,1000,60000,60000
059101,康控統一9A購01  ,0,0,0,0,0,0,0,0,0,60000,0,0,0,60000,0,60000,60000
058865,群創凱基01購01  ,0,0,0,0,0,0,0,0,0,60000,0,0,0,60000,0,60000,60000
058746,華通凱基9A購02  ,0,0,0,0,0,0,0,0,0,60000,0,0,0,60000,0,60000,60000
06044P,同欣電永豐96售03,0,0,0,0,0,0,0,0,0,60000,0,0,0,60000,0,60000,60000
059166,友達凱基99購05  ,0,0,0,0,0,0,0,0,0,60000,0,0,0,60000,0,60000,60000
06400P,鴻海元富97售12  ,0,0,0,0,0,0,0,0,0,60000,0,0,0,60000,0,60000,60000
049090,茂林凱基94購01  ,0,0,0,0,0,0,0,0,0,60000,0,0,0,60000,0,60000,60000
048710,奇力新台新94購01,0,0,0,0,0,0,0,0,0,60000,0,0,0,60000,0,60000,60000
03890P,聯詠國泰94售02  ,0,0,0,0,0,0,0,0,0,60000,0,0,0,60000,0,60000,60000
03831P,臺股指中信95售02,0,0,0,0,0,0,0,0,0,60000,0,0,0,60000,0,60000,60000
03543P,台泥中信02售01  ,0,0,0,0,0,0,0,0,0,60000,0,0,0,60000,0,60000,60000
046599,S&P反1群益93購01,0,0,0,0,0,0,0,0,0,60000,0,0,0,60000,0,60000,60000
04682P,臺股指統一96售01,0,0,0,0,0,0,0,0,0,60000,0,0,0,60000,0,60000,60000
05111P,台積電統一95售04,0,0,0,0,0,0,0,0,0,60000,0,0,0,70000,10000,60000,60000
052860,旺宏凱基96購03  ,0,0,0,0,0,0,0,0,0,60000,0,0,0,60000,0,60000,60000
048395,南亞科國票93購02,0,0,0,0,0,0,0,0,0,60000,0,0,0,60000,0,60000,60000
04784P,超眾元富94售01  ,0,0,0,0,0,0,0,0,0,60000,0,0,0,60000,0,60000,60000
047439,漢唐元大95購01  ,0,0,0,0,0,0,0,0,0,60000,0,0,0,70000,10000,60000,60000
052351,中環元富95購01  ,0,0,0,0,0,0,0,0,0,60000,0,0,0,60000,0,60000,60000
050263,旺宏元大94購10  ,0,0,0,0,0,0,0,0,0,60000,0,0,0,60000,0,60000,60000
050315,和碩兆豐95購01  ,0,0,0,0,0,0,0,0,0,60000,0,0,0,60000,0,60000,60000
050388,鴻海統一94購09  ,0,0,0,0,0,0,0,0,0,60000,0,0,0,60000,0,60000,60000
05009P,大立光元富95售06,0,0,0,0,0,0,0,0,0,60000,0,0,0,60000,0,60000,60000
050016,緯穎富邦95購01  ,0,0,0,0,0,0,0,0,0,60000,0,0,0,60000,0,60000,60000
056707,鴻海富邦99購03  ,0,0,0,0,0,0,0,0,0,60000,0,0,0,140000,80000,60000,60000
056744,麗豐凱基9A購01  ,0,0,0,0,0,0,0,0,0,60000,0,0,0,60000,0,60000,60000
056763,國巨元大99購02  ,0,0,0,0,0,0,0,0,0,60000,0,0,0,60000,0,60000,60000
058181,華新科國泰9B購01,0,0,0,0,0,0,0,0,0,60000,0,0,0,60000,0,60000,60000
058207,南茂凱基99購01  ,0,0,0,0,0,0,0,0,0,60000,0,0,0,60000,0,60000,60000
058071,大立光凱基98購19,0,0,0,0,0,0,0,0,0,60000,0,0,0,60000,0,60000,60000
054417,牧德元大96購01  ,0,0,0,0,0,0,0,0,0,60000,0,0,0,60000,0,60000,60000
056163,嘉聯益凱基98購03,0,0,0,0,0,0,0,0,0,60000,0,0,0,60000,0,60000,60000
056069,新日興元大97購03,0,0,0,0,0,0,0,0,0,60000,0,0,0,60000,0,60000,60000
057559,可成兆豐99購02  ,0,0,0,0,0,0,0,0,0,60000,0,0,0,60000,0,60000,60000
057565,可成富邦99購01  ,0,0,0,0,0,0,0,0,0,60000,0,0,0,170000,110000,60000,60000
055519,茂林中信99購01  ,0,0,0,0,0,0,0,0,0,60000,0,0,0,60000,0,60000,60000
055070,聯茂永豐97購01  ,0,0,0,0,0,0,0,0,0,60000,0,0,0,60000,0,60000,60000
055072,康友永豐97購02  ,0,0,0,0,0,0,0,0,0,60000,0,0,0,60000,0,60000,60000
054847,創意兆豐97購01  ,0,0,0,0,0,0,0,0,0,60000,0,0,0,80000,20000,60000,60000
057126,台積電凱基99購03,0,0,0,0,0,0,0,0,0,60000,0,0,0,60000,0,60000,60000
055258,玉晶光統一97購03,0,0,0,0,0,0,0,0,0,60000,0,0,0,60000,0,60000,60000
055715,智邦元大97購04  ,0,0,0,0,0,0,0,0,0,60000,0,0,0,60000,0,60000,60000
056903,大立光元大99購04,0,0,0,0,0,0,0,0,0,60000,0,0,0,148000,88000,60000,60000
054017,茂林永豐96購02  ,0,0,0,0,0,0,0,0,0,60000,0,0,0,60000,0,60000,60000
055352,奇力新凱基97購01,0,0,0,0,0,0,0,0,0,60000,0,0,0,60000,0,60000,60000
055357,欣興凱基97購04  ,0,0,0,0,0,0,0,0,0,60000,0,0,0,60000,0,60000,60000
057491,美食元大98購03  ,0,0,0,0,0,0,0,0,0,60000,0,0,0,180000,120000,60000,60000
057320,玉晶光凱基98購01,0,0,0,0,0,0,0,0,0,60000,0,0,0,60000,0,60000,60000
057295,可成永豐98購02  ,0,0,0,0,0,0,0,0,0,60000,0,0,0,60000,0,60000,60000
05467P,聯電元大95售02  ,0,0,0,0,0,0,0,0,0,60000,0,0,0,63000,3000,60000,60000
06750P,聯發科元富02售03,0,0,0,0,0,0,0,0,0,59000,0,0,0,59000,0,59000,59000
06204P,鴻海群益97售04  ,0,0,0,0,0,0,0,0,0,59000,0,0,0,659000,600000,59000,59000
2609,陽明            ,245000,186000,59000,0,0,0,0,0,0,0,0,0,0,0,0,0,59000
056659,泰碩元大99購01  ,0,0,0,0,0,0,0,0,0,59000,0,0,0,71000,12000,59000,59000
05270P,台表科元大95售05,0,0,0,0,0,0,0,0,0,59000,0,0,0,79000,20000,59000,59000
049174,台積電凱基94購11,0,0,0,0,0,0,0,0,0,59000,0,0,0,120000,61000,59000,59000
053817,華新科群益97購02,0,0,0,0,0,0,0,0,0,59000,0,0,0,59000,0,59000,59000
2881A,富邦特          ,0,23000,-23000,0,0,0,0,0,0,81000,81000,0,81000,0,0,0,58000
2329,華泰            ,1512000,1371000,141000,0,0,0,0,0,0,-83000,0,82000,-82000,0,1000,-1000,58000
3504,揚明光          ,398000,332000,66000,0,0,0,0,0,0,-8000,0,1000,-1000,0,7000,-7000,58000
048548,緯穎永豐93購02  ,0,0,0,0,0,0,0,0,0,58000,0,0,0,58000,0,58000,58000
050217,健策永豐94購03  ,0,0,0,0,0,0,0,0,0,58000,0,0,0,58000,0,58000,58000
05531P,臺股指群益96售04,0,0,0,0,0,0,0,0,0,58000,0,0,0,58000,0,58000,58000
056437,台積電凱基98購11,0,0,0,0,0,0,0,0,0,58000,0,0,0,168000,110000,58000,58000
054447,國泰金兆豐96購01,0,0,0,0,0,0,0,0,0,58000,0,0,0,58000,0,58000,58000
058068,旺宏凱基98購11  ,0,0,0,0,0,0,0,0,0,58000,0,0,0,58000,0,58000,58000
06229P,欣興凱基97售07  ,0,0,0,0,0,0,0,0,0,57000,0,0,0,102000,45000,57000,57000
05858P,矽力中信96售01  ,0,0,0,0,0,0,0,0,0,57000,0,0,0,106000,49000,57000,57000
049551,電子類群益94購01,0,0,0,0,0,0,0,0,0,57000,0,0,0,57000,0,57000,57000
056599,臻鼎元富98購01  ,0,0,0,0,0,0,0,0,0,57000,0,0,0,57000,0,57000,57000
05766P,A50正2凱基99售01,0,0,0,0,0,0,0,0,0,57000,0,0,0,57000,0,57000,57000
056457,嘉澤凱基98購01  ,0,0,0,0,0,0,0,0,0,57000,0,0,0,57000,0,57000,57000
057305,南亞科兆豐98購02,0,0,0,0,0,0,0,0,0,57000,0,0,0,57000,0,57000,57000
055721,聯詠元大97購04  ,0,0,0,0,0,0,0,0,0,57000,0,0,0,57000,0,57000,57000
057240,茂林凱基9A購01  ,0,0,0,0,0,0,0,0,0,57000,0,0,0,57000,0,57000,57000
055427,技嘉群益98購01  ,0,0,0,0,0,0,0,0,0,57000,0,0,0,57000,0,57000,57000
054309,禾伸堂凱基98購01,0,0,0,0,0,0,0,0,0,57000,0,0,0,57000,0,57000,57000
058899,旺宏元大99購10  ,0,0,0,0,0,0,0,0,0,56000,0,0,0,57000,1000,56000,56000
08447P,緯穎永豐9C售02  ,0,0,0,0,0,0,0,0,0,56000,0,0,0,56000,0,56000,56000
04229P,臺股指中信95售05,0,0,0,0,0,0,0,0,0,56000,0,0,0,56000,0,56000,56000
057538,緯穎元大98購07  ,0,0,0,0,0,0,0,0,0,56000,0,0,0,67000,11000,56000,56000
055039,神達富邦99購01  ,0,0,0,0,0,0,0,0,0,56000,0,0,0,79000,23000,56000,56000
058142,瑞儀元大99購01  ,0,0,0,0,0,0,0,0,0,56000,0,0,0,85000,29000,56000,56000
8462,柏文            ,197000,61000,136000,0,0,0,0,80000,-80000,0,0,0,0,0,0,0,56000
058603,台積電元大99購12,0,0,0,0,0,0,0,0,0,55000,0,0,0,207000,152000,55000,55000
04896P,上証2X中信95售01,0,0,0,0,0,0,0,0,0,55000,0,0,0,55000,0,55000,55000
047408,嘉晶統一95購01  ,0,0,0,0,0,0,0,0,0,55000,0,0,0,55000,0,55000,55000
045856,南亞科國泰94購01,0,0,0,0,0,0,0,0,0,55000,0,0,0,55000,0,55000,55000
056574,亞光元大99購03  ,0,0,0,0,0,0,0,0,0,55000,0,0,0,55000,0,55000,55000
051918,聯茂元大95購01  ,0,0,0,0,0,0,0,0,0,55000,0,0,0,80000,25000,55000,55000
051961,泰碩永豐95購01  ,0,0,0,0,0,0,0,0,0,55000,0,0,0,60000,5000,55000,55000
049668,大立光國泰96購02,0,0,0,0,0,0,0,0,0,55000,0,0,0,55000,0,55000,55000
058195,鈺齊永豐99購01  ,0,0,0,0,0,0,0,0,0,55000,0,0,0,55000,0,55000,55000
054126,和大元大96購02  ,0,0,0,0,0,0,0,0,0,55000,0,0,0,55000,0,55000,55000
056440,智邦凱基98購03  ,0,0,0,0,0,0,0,0,0,55000,0,0,0,55000,0,55000,55000
058774,台郡兆豐9A購01  ,0,0,0,0,0,0,0,0,0,54000,0,0,0,100000,46000,54000,54000
06406P,可成元富97售04  ,0,0,0,0,0,0,0,0,0,54000,0,0,0,54000,0,54000,54000
3712,永崴投控        ,199000,144000,55000,0,0,0,0,0,0,-1000,1000,2000,-1000,0,0,0,54000
052055,緯穎凱基95購03  ,0,0,0,0,0,0,0,0,0,54000,0,0,0,61000,7000,54000,54000
051113,聯電元富95購01  ,0,0,0,0,0,0,0,0,0,54000,0,0,0,54000,0,54000,54000
054360,智邦凱基96購03  ,0,0,0,0,0,0,0,0,0,54000,0,0,0,54000,0,54000,54000
054625,旺宏凱基98購03  ,0,0,0,0,0,0,0,0,0,54000,0,0,0,54000,0,54000,54000
3149,正達            ,86000,33000,53000,0,0,0,0,0,0,0,0,0,0,0,0,0,53000
06717P,可成元大98售09  ,0,0,0,0,0,0,0,0,0,53000,0,0,0,100000,47000,53000,53000
058984,全新凱基9A購03  ,0,0,0,0,0,0,0,0,0,53000,0,0,0,60000,7000,53000,53000
056598,京元電元富98購01,0,0,0,0,0,0,0,0,0,53000,0,0,0,54000,1000,53000,53000
055503,健策元大98購05  ,0,0,0,0,0,0,0,0,0,53000,0,0,0,53000,0,53000,53000
053706,S&P反1凱基99購01,0,0,0,0,0,0,0,0,0,53000,0,0,0,53000,0,53000,53000
057402,嘉晶群益98購02  ,0,0,0,0,0,0,0,0,0,53000,0,0,0,53000,0,53000,53000
054094,創意群益96購02  ,0,0,0,0,0,0,0,0,0,53000,0,0,0,70000,17000,53000,53000
9105,泰金寶-DR       ,418000,365000,53000,0,0,0,0,0,0,0,0,0,0,0,0,0,53000
3037,欣興            ,6847000,7026001,-179001,0,0,0,1052000,325000,727000,-495000,598000,790000,-192000,97000,400000,-303000,52999
058820,致茂國泰9B購01  ,0,0,0,0,0,0,0,0,0,52000,0,0,0,200000,148000,52000,52000
058527,世紀鋼元大99購01,0,0,0,0,0,0,0,0,0,52000,0,0,0,390000,338000,52000,52000
059229,臺股指元大99購22,0,0,0,0,0,0,0,0,0,52000,0,0,0,67000,15000,52000,52000
052025,國巨群益96購01  ,0,0,0,0,0,0,0,0,0,52000,0,0,0,52000,0,52000,52000
049600,緯穎元大95購02  ,0,0,0,0,0,0,0,0,0,52000,0,0,0,83000,31000,52000,52000
056295,國巨元大97購16  ,0,0,0,0,0,0,0,0,0,52000,0,0,0,52000,0,52000,52000
06450P,聯發科元大98售03,0,0,0,0,0,0,0,0,0,51000,0,0,0,51000,0,51000,51000
058359,瑞昱凱基99購01  ,0,0,0,0,0,0,0,0,0,51000,0,0,0,232000,181000,51000,51000
07866P,上証2X國票97售01,0,0,0,0,0,0,0,0,0,51000,0,0,0,51000,0,51000,51000
048847,A50群益98購01   ,0,0,0,0,0,0,0,0,0,51000,0,0,0,52000,1000,51000,51000
053378,台積電元大98購02,0,0,0,0,0,0,0,0,0,51000,0,0,0,110000,59000,51000,51000
057802,卜蜂元大98購01  ,0,0,0,0,0,0,0,0,0,51000,0,0,0,60000,9000,51000,51000
054060,晶技國票97購02  ,0,0,0,0,0,0,0,0,0,51000,0,0,0,51000,0,51000,51000
1626,艾美特-KY       ,81913,31000,50913,0,0,0,0,0,0,0,0,0,0,0,0,0,50913
08506P,台灣50中信96售02,0,0,0,0,0,0,0,0,0,50000,0,0,0,50000,0,50000,50000
058289,奇鋐國票9A購01  ,0,0,0,0,0,0,0,0,0,50000,0,0,0,50000,0,50000,50000
058433,台積電統一9B購04,0,0,0,0,0,0,0,0,0,50000,0,0,0,50000,0,50000,50000
058422,百和麥證99購01  ,0,0,0,50000,0,50000,0,0,0,50000,0,0,0,50000,0,50000,50000
058490,元黃金群益9B購01,0,0,0,0,0,0,0,0,0,50000,0,0,0,50000,0,50000,50000
058601,台積電元大99購10,0,0,0,0,0,0,0,0,0,50000,0,0,0,50000,0,50000,50000
058684,健策凱基99購02  ,0,0,0,0,0,0,0,0,0,50000,0,0,0,96000,46000,50000,50000
058657,大立光中信99購01,0,0,0,0,0,0,0,0,0,50000,0,0,0,60000,10000,50000,50000
058896,中環元大99購03  ,0,0,0,0,0,0,0,0,0,50000,0,0,0,70000,20000,50000,50000
058769,友達兆豐99購01  ,0,0,0,0,0,0,0,0,0,50000,0,0,0,100000,50000,50000,50000
058783,臺股指國票99購02,0,0,0,0,0,0,0,0,0,50000,0,0,0,50000,0,50000,50000
058721,立積元富9C購01  ,0,0,0,0,0,0,0,0,0,50000,0,0,0,115000,65000,50000,50000
058985,可成凱基99購03  ,0,0,0,0,0,0,0,0,0,50000,0,0,0,50000,0,50000,50000
059054,國巨凱基99購11  ,0,0,0,0,0,0,0,0,0,50000,0,0,0,51000,1000,50000,50000
06286P,世芯國票97售02  ,0,0,0,0,0,0,0,0,0,50000,0,0,0,50000,0,50000,50000
06704P,玉晶光元富98售05,0,0,0,0,0,0,0,0,0,50000,0,0,0,50000,0,50000,50000
06640P,國巨兆豐99售02  ,0,0,0,0,0,0,0,0,0,50000,0,0,0,50000,0,50000,50000
044589,國巨統一93購03  ,0,0,0,0,0,0,0,0,0,50000,0,0,0,50000,0,50000,50000
042501,台灣50凱基96購06,0,0,0,0,0,0,0,0,0,50000,0,0,0,50000,0,50000,50000
042719,臺指反群益93購01,0,0,0,0,0,0,0,0,0,50000,0,0,0,50000,0,50000,50000
045678,華新科元大95購01,0,0,0,0,0,0,0,0,0,50000,0,0,0,60000,10000,50000,50000
046598,T50反1群益93購04,0,0,0,0,0,0,0,0,0,50000,0,0,0,50000,0,50000,50000
046155,道瓊反群益94購01,0,0,0,0,0,0,0,0,0,50000,0,0,0,50000,0,50000,50000
04610P,世紀鋼永豐94售03,0,0,0,0,0,0,0,0,0,50000,0,0,0,52000,2000,50000,50000
048172,祥碩永豐93購02  ,0,0,0,0,0,0,0,0,0,50000,0,0,0,50000,0,50000,50000
049685,T50反1元大94購01,0,0,0,0,0,0,0,0,0,50000,0,0,0,50000,0,50000,50000
051464,彩晶國泰96購01  ,0,0,0,0,0,0,0,0,0,50000,0,0,0,50000,0,50000,50000
050371,台積電元大94購25,0,0,0,0,0,0,0,0,0,50000,0,0,0,50000,0,50000,50000
050695,台積電凱基94購40,0,0,0,0,0,0,0,0,0,50000,0,0,0,50000,0,50000,50000
050641,上証反凱基96購01,0,0,0,0,0,0,0,0,0,50000,0,0,0,50000,0,50000,50000
051347,國巨元大95購06  ,0,0,0,0,0,0,0,0,0,50000,0,0,0,50000,0,50000,50000
052686,華新科元大96購03,0,0,0,0,0,0,0,0,0,50000,0,0,0,50000,0,50000,50000
052412,上証2X中信98購01,0,0,0,0,0,0,0,0,0,50000,0,0,0,50000,0,50000,50000
056581,超眾元大99購01  ,0,0,0,0,0,0,0,0,0,50000,0,0,0,60000,10000,50000,50000
056486,樺漢元大98購04  ,0,0,0,0,0,0,0,0,0,50000,0,0,0,50000,0,50000,50000
051636,嘉晶國票95購02  ,0,0,0,0,0,0,0,0,0,50000,0,0,0,50000,0,50000,50000
051609,貿聯群益95購03  ,0,0,0,0,0,0,0,0,0,50000,0,0,0,50000,0,50000,50000
05160P,國巨國票96售03  ,0,0,0,0,0,0,0,0,0,50000,0,0,0,50000,0,50000,50000
055153,台光電元大98購02,0,0,0,0,0,0,0,0,0,50000,0,0,0,50000,0,50000,50000
056859,台積電群益98購02,0,0,0,0,0,0,0,0,0,50000,0,0,0,50000,0,50000,50000
055709,深中小元大97購03,0,0,0,0,0,0,0,0,0,50000,0,0,0,50000,0,50000,50000
057133,京鼎凱基98購02  ,0,0,0,0,0,0,0,0,0,50000,0,0,0,50000,0,50000,50000
057135,立積凱基98購01  ,0,0,0,0,0,0,0,0,0,50000,0,0,0,50000,0,50000,50000
056388,勤誠國泰99購01  ,0,0,0,0,0,0,0,0,0,50000,0,0,0,50000,0,50000,50000
056399,上証2X群益9C購01,0,0,0,0,0,0,0,0,0,50000,0,0,0,70000,20000,50000,50000
057430,富邦金兆豐98購01,0,0,0,0,0,0,0,0,0,50000,0,0,0,50000,0,50000,50000
057437,可成國票99購01  ,0,0,0,0,0,0,0,0,0,50000,0,0,0,50000,0,50000,50000
057336,聯發科國票99購01,0,0,0,0,0,0,0,0,0,50000,0,0,0,50000,0,50000,50000
056432,鴻海凱基98購08  ,0,0,0,0,0,0,0,0,0,50000,0,0,0,50000,0,50000,50000
056416,華新科中信98購01,0,0,0,0,0,0,0,0,0,50000,0,0,0,50000,0,50000,50000
054213,欣興國票97購04  ,0,0,0,0,0,0,0,0,0,50000,0,0,0,100000,50000,50000,50000
053806,鎧勝凱基96購02  ,0,0,0,0,0,0,0,0,0,50000,0,0,0,60000,10000,50000,50000
05376P,聯發科日盛95售04,0,0,0,0,0,0,0,0,0,50000,0,0,0,50000,0,50000,50000
054350,美律國泰98購01  ,0,0,0,0,0,0,0,0,0,50000,0,0,0,50000,0,50000,50000
053403,彩晶群益98購01  ,0,0,0,0,0,0,0,0,0,50000,0,0,0,50000,0,50000,50000
057228,友達凱基9B購01  ,0,0,0,0,0,0,0,0,0,50000,0,0,0,50000,0,50000,50000
057734,訊芯國泰9A購01  ,0,0,0,0,0,0,0,0,0,50000,0,0,0,50000,0,50000,50000
054450,聯茂第一96購01  ,0,10000,-10000,0,0,0,0,0,0,60000,0,0,0,60000,0,60000,50000
054390,智邦元富96購03  ,0,0,0,0,0,0,0,0,0,50000,0,0,0,50000,0,50000,50000
058076,神達凱基98購02  ,0,0,0,0,0,0,0,0,0,50000,0,0,0,50000,0,50000,50000
057836,南亞科國泰9A購01,0,0,0,0,0,0,0,0,0,50000,0,0,0,50000,0,50000,50000
053183,大立光元富96購03,0,0,0,0,0,0,0,0,0,50000,0,0,0,50000,0,50000,50000
056180,南茂元富97購01  ,0,0,0,0,0,0,0,0,0,50000,0,0,0,50000,0,50000,50000
056145,緯穎元大98購03  ,0,0,0,0,0,0,0,0,0,50000,0,0,0,50000,0,50000,50000
055915,大立光凱基98購07,0,0,0,0,0,0,0,0,0,50000,0,0,0,50000,0,50000,50000
057094,祥碩元富98購01  ,0,0,0,0,0,0,0,0,0,50000,0,0,0,50000,0,50000,50000
05583P,訊芯凱基96售01  ,0,0,0,0,0,0,0,0,0,50000,0,0,0,60000,10000,50000,50000
054627,義隆凱基98購01  ,0,0,0,0,0,0,0,0,0,50000,0,0,0,50000,0,50000,50000
055008,隆達元富97購01  ,0,0,0,0,0,0,0,0,0,50000,0,0,0,50000,0,50000,50000
054906,神達康和97購01  ,0,0,0,0,0,0,0,0,0,50000,0,0,0,100000,50000,50000,50000
06326P,鴻海中信01售01  ,0,0,0,0,0,0,0,0,0,49000,0,0,0,49000,0,49000,49000
052230,大立光凱基96購09,0,0,0,0,0,0,0,0,0,49000,0,0,0,50000,1000,49000,49000
049484,台積電元大95購02,0,0,0,0,0,0,0,0,0,49000,0,0,0,99000,50000,49000,49000
049625,智易群益95購01  ,0,0,0,0,0,0,0,0,0,49000,0,0,0,299000,250000,49000,49000
046865,鴻海統一95購01  ,0,0,0,0,0,0,0,0,0,49000,0,0,0,50000,1000,49000,49000
04935P,鴻海中信96售01  ,0,0,0,0,0,0,0,0,0,49000,0,0,0,55000,6000,49000,49000
057842,緯穎富邦99購02  ,0,0,0,0,0,0,0,0,0,49000,0,0,0,69000,20000,49000,49000
055667,致茂群益98購01  ,0,0,0,0,0,0,0,0,0,49000,0,0,0,60000,11000,49000,49000
053506,南茂兆豐97購01  ,0,0,0,0,0,0,0,0,0,49000,0,0,0,49000,0,49000,49000
1460,宏遠            ,243000,195000,48000,0,0,0,0,0,0,0,0,0,0,0,0,0,48000
4560,強信-KY         ,119000,71000,48000,0,0,0,0,0,0,0,0,0,0,0,0,0,48000
056720,世紀鋼永豐98購01,0,0,0,0,0,0,0,0,0,48000,0,0,0,60000,12000,48000,48000
057195,南茂元大98購01  ,0,0,0,0,0,0,0,0,0,48000,0,0,0,64000,16000,48000,48000
057365,智邦元大98購07  ,0,0,0,0,0,0,0,0,0,48000,0,0,0,78000,30000,48000,48000
057874,可成元大99購02  ,0,0,0,0,0,0,0,0,0,48000,0,0,0,60000,12000,48000,48000
06268P,聯詠凱基97售02  ,0,0,0,0,0,0,0,0,0,47000,0,0,0,50000,3000,47000,47000
059204,台灣50元大01購02,0,0,0,0,0,0,0,0,0,47000,0,0,0,72000,25000,47000,47000
06147P,國巨元大97售05  ,0,0,0,0,0,0,0,0,0,47000,0,0,0,72000,25000,47000,47000
051563,泰鼎國泰96購01  ,0,0,0,0,0,0,0,0,0,47000,0,0,0,109000,62000,47000,47000
052833,康控群益96購01  ,0,0,0,0,0,0,0,0,0,47000,0,0,0,48000,1000,47000,47000
056166,微星台新97購01  ,0,0,0,0,0,0,0,0,0,47000,0,0,0,115000,68000,47000,47000
056398,南茂永豐98購01  ,0,0,0,0,0,0,0,0,0,47000,0,0,0,47000,0,47000,47000
055215,智邦凱基98購02  ,0,0,0,0,0,0,0,0,0,47000,0,0,0,47000,0,47000,47000
06069P,台積電永豐97售01,0,0,0,0,0,0,0,0,0,46000,0,0,0,46000,0,46000,46000
059013,臺股指元大9A購32,0,0,0,0,0,0,0,0,0,46000,0,0,0,1233000,1187000,46000,46000
058384,大成鋼中信99購01,0,0,0,0,0,0,0,0,0,46000,0,0,0,48000,2000,46000,46000
042387,台積電永昌93購02,0,0,0,0,0,0,0,0,0,46000,0,0,0,46000,0,46000,46000
048832,玉晶光凱基95購02,0,0,0,0,0,0,0,0,0,46000,0,0,0,46000,0,46000,46000
048575,旺宏國泰94購04  ,0,0,0,0,0,0,0,0,0,46000,0,0,0,126000,80000,46000,46000
056396,祥碩永豐98購01  ,0,0,0,0,0,0,0,0,0,46000,0,0,0,55000,9000,46000,46000
05638P,國巨統一96售04  ,0,0,0,0,0,0,0,0,0,46000,0,0,0,46000,0,46000,46000
053415,聯茂國票97購01  ,0,0,0,0,0,0,0,0,0,46000,0,0,0,46000,0,46000,46000
054998,玉晶光元富97購02,0,0,0,0,0,0,0,0,0,46000,0,0,0,46000,0,46000,46000
6531,愛普            ,589000,553000,36000,0,0,0,10000,0,10000,0,0,0,0,0,0,0,46000
058983,旺宏凱基99購05  ,0,0,0,0,0,0,0,0,0,45000,0,0,0,45000,0,45000,45000
06472P,道瓊銀元大98售03,0,0,0,0,0,0,0,0,0,45000,0,0,0,45000,0,45000,45000
045842,T50反1台新98購01,0,0,0,0,0,0,0,0,0,45000,0,0,0,45000,0,45000,45000
050548,華固凱基95購01  ,0,0,0,0,0,0,0,0,0,45000,0,0,0,150000,105000,45000,45000
055468,智邦凱基97購04  ,0,0,0,0,0,0,0,0,0,45000,0,0,0,45000,0,45000,45000
058016,智邦凱基98購06  ,0,0,0,0,0,0,0,0,0,45000,0,0,0,62000,17000,45000,45000
054669,凌華元富97購01  ,0,0,0,0,0,0,0,0,0,45000,0,0,0,45000,0,45000,45000
054823,祥碩元大97購02  ,0,0,0,0,0,0,0,0,0,45000,0,0,0,45000,0,45000,45000
053705,滬深2X凱基99購01,0,0,0,0,0,0,0,0,0,45000,0,0,0,45000,0,45000,45000
057449,華新科元富99購02,0,0,0,0,0,0,0,0,0,45000,0,0,0,45000,0,45000,45000
055341,台達電凱基97購02,0,0,0,0,0,0,0,0,0,45000,0,0,0,45000,0,45000,45000
06139P,台積電中信99售02,0,0,0,0,0,0,0,0,0,44000,0,0,0,45000,1000,44000,44000
058940,聯發科中信9A購03,0,0,0,0,0,0,0,0,0,44000,0,0,0,94000,50000,44000,44000
2707,晶華            ,167000,93000,74000,0,0,0,0,0,0,-30000,2000,32000,-30000,0,0,0,44000
2731,雄獅            ,71000,27000,44000,0,0,0,0,0,0,0,0,0,0,0,0,0,44000
051939,同欣電群益97購01,0,0,0,0,0,0,0,0,0,44000,0,0,0,54000,10000,44000,44000
04565P,聯詠凱基94售01  ,0,0,0,0,0,0,0,0,0,44000,0,0,0,50000,6000,44000,44000
04592P,台積電元大94售10,0,0,0,0,0,0,0,0,0,44000,0,0,0,316000,272000,44000,44000
04771P,友達元大96售02  ,0,0,0,0,0,0,0,0,0,44000,0,0,0,112000,68000,44000,44000
053193,超眾統一97購01  ,0,0,0,0,0,0,0,0,0,44000,0,0,0,60000,16000,44000,44000
05491P,茂林元大95售04  ,0,10000,-10000,0,0,0,0,0,0,54000,0,0,0,54000,0,54000,44000
056240,嘉晶群益97購02  ,0,0,0,0,0,0,0,0,0,44000,0,0,0,44000,0,44000,44000
055852,聯鈞元大98購01  ,0,0,0,0,0,0,0,0,0,44000,0,0,0,44000,0,44000,44000
4737,華廣            ,76000,34000,42000,0,0,0,0,0,0,1000,1000,0,1000,0,0,0,43000
1446,宏和            ,87000,44000,43000,0,0,0,0,0,0,0,0,0,0,0,0,0,43000
052882,南電凱基96購02  ,0,0,0,0,0,0,0,0,0,43000,0,0,0,43000,0,43000,43000
04023P,臺股指元富99售02,2000,0,2000,0,0,0,0,0,0,41000,0,0,0,51000,10000,41000,43000
03425B,臺股指元大9A熊01,0,0,0,0,0,0,0,0,0,43000,0,0,0,51000,8000,43000,43000
052067,中磊兆豐96購01  ,0,0,0,0,0,0,0,0,0,43000,0,0,0,48000,5000,43000,43000
054926,神達凱基98購01  ,0,0,0,0,0,0,0,0,0,43000,0,0,0,68000,25000,43000,43000
055313,南電群益97購01  ,0,0,0,0,0,0,0,0,0,43000,0,0,0,45000,2000,43000,43000
056438,旺宏凱基98購05  ,0,0,0,0,0,0,0,0,0,43000,0,0,0,73000,30000,43000,43000
056848,泰鼎元富98購01  ,0,0,0,0,0,0,0,0,0,43000,0,0,0,43000,0,43000,43000
057243,樺漢凱基99購01  ,0,0,0,0,0,0,0,0,0,43000,0,0,0,43000,0,43000,43000
058602,台積電元大99購11,0,0,0,0,0,0,0,0,0,42000,0,0,0,42000,0,42000,42000
058587,台積電中信9C購03,0,0,0,0,0,0,0,0,0,42000,0,0,0,102000,60000,42000,42000
06327P,台積電中信01售01,0,0,0,0,0,0,0,0,0,42000,0,0,0,62000,20000,42000,42000
050890,南電富邦99購01  ,0,0,0,0,0,0,0,0,0,42000,0,0,0,46000,4000,42000,42000
049929,祥碩元大94購03  ,0,0,0,0,0,0,0,0,0,42000,0,0,0,50000,8000,42000,42000
048944,茂林永豐94購01  ,0,0,0,0,0,0,0,0,0,42000,0,0,0,42000,0,42000,42000
047194,世紀鋼元大96購01,0,0,0,0,0,0,0,0,0,42000,0,0,0,110000,68000,42000,42000
05573P,仁寶元富96售02  ,0,0,0,0,0,0,0,0,0,42000,0,0,0,42000,0,42000,42000
056153,華新科凱基97購02,0,0,0,0,0,0,0,0,0,42000,0,0,0,42000,0,42000,42000
057978,聯發科永豐98購05,0,0,0,0,0,0,0,0,0,42000,0,0,0,42000,0,42000,42000
058376,貿聯凱基9A購01  ,0,0,0,0,0,0,0,0,0,41000,0,0,0,41000,0,41000,41000
058368,奇鋐凱基9A購01  ,0,0,0,0,0,0,0,0,0,41000,0,0,0,41000,0,41000,41000
048177,臺指反富邦99購01,0,0,0,0,0,0,0,0,0,41000,0,0,0,41000,0,41000,41000
052829,上銀群益96購01  ,0,0,0,0,0,0,0,0,0,41000,0,0,0,41000,0,41000,41000
050337,南電國泰95購01  ,0,0,0,0,0,0,0,0,0,41000,0,0,0,41000,0,41000,41000
057043,台積電元大99購02,0,0,0,0,0,0,0,0,0,41000,0,0,0,41000,0,41000,41000
056011,矽力中信99購01  ,0,0,0,0,0,0,0,0,0,41000,0,0,0,230000,189000,41000,41000
055541,聚陽凱基98購01  ,0,0,0,0,0,0,0,0,0,41000,0,0,0,61000,20000,41000,41000
057273,智邦元大98購05  ,0,0,0,0,0,0,0,0,0,41000,0,0,0,70000,29000,41000,41000
058361,美律凱基99購06  ,0,0,0,0,0,0,0,0,0,40000,0,0,0,40000,0,40000,40000
058439,玉晶光統一01購02,0,0,0,0,0,0,0,0,0,40000,0,0,0,50000,10000,40000,40000
058635,華新科兆豐99購03,0,0,0,0,0,0,0,0,0,40000,0,0,0,40000,0,40000,40000
058766,力山兆豐99購01  ,0,0,0,0,0,0,0,0,0,40000,0,0,0,40000,0,40000,40000
058909,神達元大99購03  ,0,0,0,0,0,0,0,0,0,40000,0,0,0,101000,61000,40000,40000
058815,華新科台新99購03,0,0,0,0,0,0,0,0,0,40000,0,0,0,635000,595000,40000,40000
058864,欣興凱基99購04  ,0,0,0,0,0,0,0,0,0,40000,0,0,0,40000,0,40000,40000
06644P,亞德客元大98售03,0,0,0,0,0,0,0,0,0,40000,0,0,0,70000,30000,40000,40000
06740P,台灣50國泰9A售02,0,0,0,0,0,0,0,0,0,40000,0,0,0,40000,0,40000,40000
06156P,大立光統一97售05,0,0,0,0,0,0,0,0,0,40000,0,0,0,40000,0,40000,40000
05992P,華通元大96售05  ,0,0,0,0,0,0,0,0,0,40000,0,0,0,50000,10000,40000,40000
05923P,旺宏元富96售05  ,0,0,0,0,0,0,0,0,0,40000,0,0,0,50000,10000,40000,40000
06859P,元金2X中信9C售01,0,0,0,0,0,0,0,0,0,40000,0,0,0,40000,0,40000,40000
07011P,宏達電凱基99售02,0,0,0,0,0,0,0,0,0,40000,0,0,0,70000,30000,40000,40000
3653,健策            ,724000,880000,-156000,0,0,0,686000,491000,195000,1000,60000,45000,15000,80000,94000,-14000,40000
2705,六福            ,48000,8000,40000,0,0,0,0,0,0,0,0,0,0,0,0,0,40000
051522,玉晶光凱基95購05,0,0,0,0,0,0,0,0,0,40000,0,0,0,40000,0,40000,40000
050896,華新科元大96購02,0,0,0,0,0,0,0,0,0,40000,0,0,0,100000,60000,40000,40000
049462,康友元富94購01  ,0,0,0,0,0,0,0,0,0,40000,0,0,0,40000,0,40000,40000
052656,力山元富96購01  ,0,0,0,0,0,0,0,0,0,40000,0,0,0,40000,0,40000,40000
052115,T50反1國票95購03,0,0,0,0,0,0,0,0,0,40000,0,0,0,40000,0,40000,40000
051639,康友國票96購02  ,0,0,0,0,0,0,0,0,0,40000,0,0,0,55000,15000,40000,40000
051633,可成國票96購03  ,0,0,0,0,0,0,0,0,0,40000,0,0,0,40000,0,40000,40000
050055,道瓊反凱基95購01,0,0,0,0,0,0,0,0,0,40000,0,0,0,40000,0,40000,40000
050134,世紀鋼凱基94購04,0,0,0,0,0,0,0,0,0,40000,0,0,0,75000,35000,40000,40000
056306,晶相光元大98購01,0,0,0,0,0,0,0,0,0,40000,0,0,0,92000,52000,40000,40000
052970,美律群益96購01  ,0,0,0,0,0,0,0,0,0,40000,0,0,0,40000,0,40000,40000
051067,台積電國票96購03,0,0,0,0,0,0,0,0,0,40000,0,0,0,40000,0,40000,40000
049207,茂林群益94購02  ,0,0,0,0,0,0,0,0,0,40000,0,0,0,40000,0,40000,40000
047063,漢唐凱基95購01  ,0,0,0,0,0,0,0,0,0,40000,0,0,0,60000,20000,40000,40000
048418,瑞昱統一93購04  ,0,0,0,0,0,0,0,0,0,40000,0,0,0,40000,0,40000,40000
042903,金寶元大94購01  ,0,0,0,0,0,0,0,0,0,40000,0,0,0,40000,0,40000,40000
04407P,滬深2X統一94售02,0,0,0,0,0,0,0,0,0,40000,0,0,0,40000,0,40000,40000
055325,佐登國票98購01  ,0,0,0,0,0,0,0,0,0,40000,0,0,0,40000,0,40000,40000
055343,國巨凱基97購03  ,0,0,0,0,0,0,0,0,0,40000,0,0,0,400000,360000,40000,40000
055741,健策元富97購01  ,0,0,0,0,0,0,0,0,0,40000,0,0,0,40000,0,40000,40000
055231,大毅國票98購02  ,0,0,0,0,0,0,0,0,0,40000,0,0,0,40000,0,40000,40000
056894,佳世達元大99購01,0,0,0,0,0,0,0,0,0,40000,0,0,0,40000,0,40000,40000
054829,亞光國泰99購01  ,0,0,0,0,0,0,0,0,0,40000,0,0,0,40000,0,40000,40000
054811,裕隆元大9A購01  ,0,0,0,0,0,0,0,0,0,40000,0,0,0,40000,0,40000,40000
054818,奇力新元大97購05,0,0,0,0,0,0,0,0,0,40000,0,0,0,40000,0,40000,40000
05536P,奇力新元大96售03,0,0,0,0,0,0,0,0,0,40000,0,0,0,75000,35000,40000,40000
055366,國巨元大98購05  ,0,0,0,0,0,0,0,0,0,40000,0,0,0,40000,0,40000,40000
053713,漢唐凱基96購04  ,0,0,0,0,0,0,0,0,0,40000,0,0,0,81000,41000,40000,40000
053875,GIS元大97購01   ,0,0,0,0,0,0,0,0,0,40000,0,0,0,40000,0,40000,40000
053919,可成國票97購02  ,0,0,0,0,0,0,0,0,0,40000,0,0,0,40000,0,40000,40000
053510,聯電群益97購01  ,0,0,0,0,0,0,0,0,0,40000,0,0,0,50000,10000,40000,40000
053051,楠梓電國票97購01,0,0,0,0,0,0,0,0,0,40000,0,0,0,40000,0,40000,40000
053028,康控富邦98購01  ,0,0,0,0,0,0,0,0,0,40000,0,0,0,40000,0,40000,40000
057566,欣興富邦99購01  ,0,0,0,0,0,0,0,0,0,40000,0,0,0,40000,0,40000,40000
057604,鴻海統一9C購01  ,0,0,0,0,0,0,0,0,0,40000,0,0,0,40000,0,40000,40000
054952,大毅元大97購02  ,0,0,0,0,0,0,0,0,0,40000,0,0,0,80000,40000,40000,40000
055099,可成日盛97購01  ,0,0,0,0,0,0,0,0,0,40000,0,0,0,40000,0,40000,40000
055993,致茂國泰99購01  ,0,0,0,0,0,0,0,0,0,40000,0,0,0,50000,10000,40000,40000
055838,致茂元大97購03  ,0,0,0,0,0,0,0,0,0,40000,0,0,0,40000,0,40000,40000
056124,華通國票98購02  ,0,0,0,0,0,0,0,0,0,40000,0,0,0,40000,0,40000,40000
053144,上証2X元大96購01,0,0,0,0,0,0,0,0,0,40000,0,0,0,40000,0,40000,40000
058075,貿聯凱基99購02  ,0,0,0,0,0,0,0,0,0,40000,0,0,0,40000,0,40000,40000
057857,牧德國票99購01  ,0,0,0,0,0,0,0,0,0,40000,0,0,0,40000,0,40000,40000
057910,華新科兆豐99購02,0,0,0,0,0,0,0,0,0,40000,0,0,0,40000,0,40000,40000
057933,聯發科群益98購06,0,0,0,0,0,0,0,0,0,40000,0,0,0,50000,10000,40000,40000
058219,台灣50國票9A購02,0,0,0,0,0,0,0,0,0,40000,0,0,0,40000,0,40000,40000
058257,聯陽國泰9B購01  ,0,0,0,0,0,0,0,0,0,40000,0,0,0,40000,0,40000,40000
058238,奇鋐元大99購02  ,0,0,0,0,0,0,0,0,0,40000,0,0,0,40000,0,40000,40000
058140,臻鼎元大99購02  ,0,0,0,0,0,0,0,0,0,40000,0,0,0,40000,0,40000,40000
056476,智原元大98購02  ,0,0,0,0,0,0,0,0,0,40000,0,0,0,40000,0,40000,40000
055603,超眾元大97購04  ,0,0,0,0,0,0,0,0,0,40000,0,0,0,40000,0,40000,40000
055683,晶技凱基99購01  ,0,0,0,0,0,0,0,0,0,40000,0,0,0,40000,0,40000,40000
057788,嘉聯益國票99購01,0,0,0,0,0,0,0,0,0,40000,0,0,0,40000,0,40000,40000
01003T,兆豐新光R1      ,39000,0,39000,0,0,0,0,0,0,0,0,0,0,0,0,0,39000
056575,禾伸堂元大99購01,0,0,0,0,0,0,0,0,0,39000,0,0,0,48000,9000,39000,39000
051919,台郡元大96購02  ,0,0,0,0,0,0,0,0,0,39000,0,0,0,113000,74000,39000,39000
055591,全新元大98購01  ,0,0,0,0,0,0,0,0,0,39000,0,0,0,44000,5000,39000,39000
053102,祥碩元富96購01  ,0,0,0,0,0,0,0,0,0,39000,0,0,0,40000,1000,39000,39000
056954,聯詠富邦9A購01  ,0,0,0,0,0,0,0,0,0,39000,0,0,0,39000,0,39000,39000
054357,可成兆豐97購02  ,0,0,0,0,0,0,0,0,0,39000,0,0,0,46000,7000,39000,39000
057300,訊連永豐98購01  ,0,0,0,0,0,0,0,0,0,39000,0,0,0,41000,2000,39000,39000
057477,智邦元大98購09  ,0,0,0,0,0,0,0,0,0,39000,0,0,0,60000,21000,39000,39000
06192P,高股息中信98售01,0,0,0,0,0,0,0,0,0,38000,0,0,0,38000,0,38000,38000
06705P,臻鼎元富98售03  ,0,0,0,0,0,0,0,0,0,38000,0,0,0,50000,12000,38000,38000
058476,旺宏凱基9A購01  ,0,0,0,0,0,0,0,0,0,38000,0,0,0,48000,10000,38000,38000
058343,台積電群益99購02,0,0,0,0,0,0,0,0,0,38000,0,0,0,228000,190000,38000,38000
052405,聯茂凱基95購01  ,0,0,0,0,0,0,0,0,0,38000,0,0,0,38000,0,38000,38000
049114,玉晶光統一94購02,0,0,0,0,0,0,0,0,0,38000,0,0,0,38000,0,38000,38000
048350,世紀鋼元大95購01,0,0,0,0,0,0,0,0,0,38000,0,0,0,107000,69000,38000,38000
057309,南茂兆豐99購01  ,0,0,0,0,0,0,0,0,0,38000,0,0,0,255000,217000,38000,38000
057298,旭富永豐98購01  ,0,0,0,0,0,0,0,0,0,38000,0,0,0,38000,0,38000,38000
055300,緯穎元大98購01  ,0,0,0,0,0,0,0,0,0,38000,0,0,0,51000,13000,38000,38000
055221,矽創凱基97購02  ,0,0,0,0,0,0,0,0,0,38000,0,0,0,42000,4000,38000,38000
055235,金寶台新98購01  ,0,0,0,0,0,0,0,0,0,38000,0,0,0,38000,0,38000,38000
055776,宏達電凱基98購02,0,0,0,0,0,0,0,0,0,38000,0,0,0,58000,20000,38000,38000
057259,台積電兆豐98購03,0,0,0,0,0,0,0,0,0,38000,0,0,0,38000,0,38000,38000
054966,貿聯元大98購02  ,0,0,0,0,0,0,0,0,0,38000,0,0,0,38000,0,38000,38000
058415,祥碩兆豐99購01  ,0,0,0,0,0,0,0,0,0,37000,0,0,0,37000,0,37000,37000
058897,國巨元大99購17  ,0,0,0,0,0,0,0,0,0,37000,0,0,0,251000,214000,37000,37000
07158P,FBVIX國泰9C售01 ,0,0,0,0,0,0,0,0,0,37000,0,0,0,153000,116000,37000,37000
2204,中華            ,314000,240000,74000,0,0,0,1000,0,1000,-38000,0,38000,-38000,0,0,0,37000
048282,世紀鋼永豐94購01,0,0,0,0,0,0,0,0,0,37000,0,0,0,37000,0,37000,37000
051406,泰鼎永豐96購01  ,0,0,0,0,0,0,0,0,0,37000,0,0,0,133000,96000,37000,37000
051643,瑞昱康和95購01  ,0,0,0,0,0,0,0,0,0,37000,0,0,0,37000,0,37000,37000
057727,華邦電國泰9A購01,0,0,0,0,0,0,0,0,0,37000,0,0,0,84000,47000,37000,37000
058087,鴻海元大98購15  ,0,0,0,0,0,0,0,0,0,37000,0,0,0,240000,203000,37000,37000
057953,聚陽元大98購01  ,0,0,0,0,0,0,0,0,0,37000,0,0,0,332000,295000,37000,37000
1736,喬山            ,483000,399000,84000,0,0,0,0,40000,-40000,-8000,0,0,0,2000,10000,-8000,36000
06868P,電子類元大99售01,0,0,0,0,0,0,0,0,0,36000,0,0,0,63000,27000,36000,36000
050995,貿聯元大95購02  ,0,0,0,0,0,0,0,0,0,36000,0,0,0,36000,0,36000,36000
049985,華擎凱基94購01  ,0,0,0,0,0,0,0,0,0,36000,0,0,0,90000,54000,36000,36000
056320,京鼎群益99購01  ,0,0,0,0,0,0,0,0,0,36000,0,0,0,36000,0,36000,36000
049352,泰鼎永豐95購01  ,0,0,0,0,0,0,0,0,0,36000,0,0,0,106000,70000,36000,36000
048819,國巨凱基94購01  ,0,0,0,0,0,0,0,0,0,36000,0,0,0,176000,140000,36000,36000
057821,晶相光元大98購03,0,0,0,0,0,0,0,0,0,36000,0,0,0,36000,0,36000,36000
055661,亞德客中信98購01,0,0,0,0,0,0,0,0,0,36000,0,0,0,36000,0,36000,36000
053250,百和國票97購02  ,0,0,0,0,0,0,0,0,0,36000,0,0,0,36000,0,36000,36000
056156,禾伸堂凱基98購04,0,0,0,0,0,0,0,0,0,36000,0,0,0,36000,0,36000,36000
05682P,大立光元大98售03,0,0,0,0,0,0,0,0,0,36000,0,0,0,36000,0,36000,36000
05409P,京元電元富95售05,0,0,0,0,0,0,0,0,0,36000,0,0,0,39000,3000,36000,36000
06855P,聯發科富邦9A售01,0,0,0,0,0,0,0,0,0,35000,0,0,0,40000,5000,35000,35000
1340,勝悅-KY         ,139000,102000,37000,0,0,0,0,0,0,-2000,0,2000,-2000,0,0,0,35000
058685,TPK凱基99購01   ,0,0,0,0,0,0,0,0,0,35000,0,0,0,37000,2000,35000,35000
05996P,華新科群益96售03,0,0,0,0,0,0,0,0,0,35000,0,0,0,35000,0,35000,35000
03388P,元油2X元富98售02,0,0,0,0,0,0,0,0,0,35000,0,0,0,35000,0,35000,35000
052963,智邦凱基96購02  ,0,0,0,0,0,0,0,0,0,35000,0,0,0,64000,29000,35000,35000
046602,新日興群益94購01,0,0,0,0,0,0,0,0,0,35000,0,0,0,35000,0,35000,35000
056526,力山凱基98購01  ,0,0,0,0,0,0,0,0,0,35000,0,0,0,35000,0,35000,35000
056741,大立光凱基98購14,0,0,0,0,0,0,0,0,0,35000,0,0,0,35000,0,35000,35000
050021,鴻海元大94購10  ,0,0,0,0,0,0,0,0,0,35000,0,0,0,35000,0,35000,35000
050172,臺指反元大98購02,0,0,0,0,0,0,0,0,0,35000,0,0,0,35000,0,35000,35000
05064P,台積電元大95售10,0,0,0,0,0,0,0,0,0,35000,0,0,0,459000,424000,35000,35000
05148P,臻鼎元大95售01  ,0,0,0,0,0,0,0,0,0,35000,0,0,0,35000,0,35000,35000
049636,上証反凱基9A購01,0,0,0,0,0,0,0,0,0,35000,0,0,0,35000,0,35000,35000
05722P,玉晶光國票97售03,0,0,0,0,0,0,0,0,0,35000,0,0,0,35000,0,35000,35000
053477,大立光元大97購03,0,0,0,0,0,0,0,0,0,35000,0,0,0,40000,5000,35000,35000
053129,緯穎凱基96購01  ,0,0,0,0,0,0,0,0,0,35000,0,0,0,68000,33000,35000,35000
056281,深中小永豐97購01,0,0,0,0,0,0,0,0,0,35000,0,0,0,35000,0,35000,35000
055014,達興元富97購01  ,0,0,0,0,0,0,0,0,0,35000,0,0,0,100000,65000,35000,35000
053371,滬深2X元大99購01,0,0,0,0,0,0,0,0,0,35000,0,0,0,251000,216000,35000,35000
057667,可成元大99購01  ,0,0,0,0,0,0,0,0,0,35000,0,0,0,40000,5000,35000,35000
05767P,國巨凱基96售11  ,0,0,0,0,0,0,0,0,0,35000,0,0,0,55000,20000,35000,35000
057826,祥碩元大98購08  ,0,0,0,0,0,0,0,0,0,35000,0,0,0,144000,109000,35000,35000
8104,錸寶            ,82000,47000,35000,0,0,0,0,0,0,0,0,0,0,0,0,0,35000
058421,國泰金麥證01購01,0,0,0,44000,10000,34000,0,0,0,34000,0,0,0,44000,10000,34000,34000
1731,美吾華          ,174000,140000,34000,0,0,0,0,0,0,0,0,0,0,0,0,0,34000
051999,勤誠元大95購01  ,0,0,0,0,0,0,0,0,0,34000,0,0,0,55000,21000,34000,34000
051829,玉晶光元大98購02,0,0,0,0,0,0,0,0,0,34000,0,0,0,46000,12000,34000,34000
052768,泰鼎群益96購01  ,0,0,0,0,0,0,0,0,0,34000,0,0,0,45000,11000,34000,34000
01002T,土銀國泰R1      ,41000,7000,34000,0,0,0,0,0,0,0,0,0,0,0,0,0,34000
054412,智邦元大96購03  ,0,0,0,0,0,0,0,0,0,34000,0,0,0,117000,83000,34000,34000
057961,茂林元大9A購01  ,0,0,0,0,0,0,0,0,0,34000,0,0,0,47000,13000,34000,34000
057935,晶技群益98購02  ,0,0,0,0,0,0,0,0,0,34000,0,0,0,34000,0,34000,34000
056916,台達電兆豐98購02,0,0,0,0,0,0,0,0,0,34000,0,0,0,100000,66000,34000,34000
057120,茂林康和98購01  ,0,0,0,0,0,0,0,0,0,34000,0,0,0,34000,0,34000,34000
057296,智原永豐98購01  ,0,0,0,0,0,0,0,0,0,34000,0,0,0,34000,0,34000,34000
06772P,國巨中信99售01  ,0,0,0,0,0,0,0,0,0,33000,0,0,0,33000,0,33000,33000
2431,聯昌            ,79000,46000,33000,0,0,0,0,0,0,0,0,0,0,0,0,0,33000
3052,夆典            ,317000,284000,33000,0,0,0,0,0,0,0,0,0,0,0,0,0,33000
058632,世紀鋼國票9A購01,0,0,0,0,0,0,0,0,0,33000,0,0,0,33000,0,33000,33000
058884,世紀鋼永豐99購02,0,0,0,0,0,0,0,0,0,33000,0,0,0,85000,52000,33000,33000
00635U,元大S&P黃金     ,0,0,0,0,0,0,0,0,0,33000,0,271000,-271000,495000,191000,304000,33000
03427P,聯電元大02售11  ,0,0,0,0,0,0,0,0,0,33000,0,0,0,33000,0,33000,33000
03428P,台積電元大02售28,0,0,0,0,0,0,0,0,0,33000,0,0,0,33000,0,33000,33000
056534,京元電凱基98購01,0,0,0,0,0,0,0,0,0,33000,0,0,0,43000,10000,33000,33000
056348,S&P反1元大9A購01,0,0,0,0,0,0,0,0,0,33000,0,0,0,33000,0,33000,33000
049438,嘉晶國泰96購01  ,0,0,0,0,0,0,0,0,0,33000,0,0,0,33000,0,33000,33000
051552,牧德永豐95購03  ,0,0,0,0,0,0,0,0,0,33000,0,0,0,83000,50000,33000,33000
058230,國巨元大99購11  ,0,0,0,0,0,0,0,0,0,33000,0,0,0,35000,2000,33000,33000
055477,同欣電凱基98購01,0,0,0,0,0,0,0,0,0,33000,0,0,0,33000,0,33000,33000
057045,美律元大99購04  ,0,0,0,0,0,0,0,0,0,33000,0,0,0,35000,2000,33000,33000
055988,矽力元富97購01  ,0,0,0,0,0,0,0,0,0,33000,0,0,0,33000,0,33000,33000
058372,欣興凱基99購03  ,0,0,0,0,0,0,0,0,0,32000,0,0,0,32000,0,32000,32000
06560P,台積電統一98售07,0,0,0,0,0,0,0,0,0,32000,0,0,0,32000,0,32000,32000
06475P,牧德永豐98售03  ,0,0,0,0,0,0,0,0,0,32000,0,0,0,42000,10000,32000,32000
1338,廣華-KY         ,100000,70000,30000,0,0,0,0,0,0,2000,2000,0,2000,0,0,0,32000
056743,貿聯凱基98購04  ,0,0,0,0,0,0,0,0,0,32000,0,0,0,32000,0,32000,32000
052795,健策兆豐97購01  ,0,0,0,0,0,0,0,0,0,32000,0,0,0,222000,190000,32000,32000
04596P,臺股指元大94售14,0,0,0,0,0,0,0,0,0,32000,0,0,0,32000,0,32000,32000
054873,帆宣群益99購01  ,0,0,0,0,0,0,0,0,0,32000,0,0,0,32000,0,32000,32000
054874,帆宣群益99購02  ,0,0,0,0,0,0,0,0,0,32000,0,0,0,32000,0,32000,32000
058160,奇鋐元富99購01  ,0,0,0,0,0,0,0,0,0,32000,0,0,0,42000,10000,32000,32000
055568,緯穎凱基97購02  ,0,0,0,0,0,0,0,0,0,32000,0,0,0,32000,0,32000,32000
055409,元黃金富邦01購01,0,0,0,0,0,0,0,0,0,32000,0,0,0,32000,0,32000,32000
059144,嘉晶國票9A購02  ,0,0,0,0,0,0,0,0,0,31000,0,0,0,32000,1000,31000,31000
058767,亞德客兆豐99購01,0,0,0,0,0,0,0,0,0,31000,0,0,0,87000,56000,31000,31000
052689,玉晶光元大98購03,0,0,0,0,0,0,0,0,0,31000,0,0,0,234000,203000,31000,31000
054999,玉晶光元富97購03,0,0,0,0,0,0,0,0,0,31000,0,0,0,31000,0,31000,31000
05644P,大立光中信9A售03,0,0,0,0,0,0,0,0,0,31000,0,0,0,46000,15000,31000,31000
056987,南茂群益98購01  ,0,0,0,0,0,0,0,0,0,31000,0,0,0,31000,0,31000,31000
058839,瑞儀中信99購02  ,0,0,0,0,0,0,0,0,0,30000,0,0,0,50000,20000,30000,30000
058375,群創凱基9B購04  ,0,0,0,0,0,0,0,0,0,30000,0,0,0,30000,0,30000,30000
058411,技嘉兆豐99購01  ,0,0,0,0,0,0,0,0,0,30000,0,0,0,50000,20000,30000,30000
058402,欣興元大99購04  ,0,0,0,0,0,0,0,0,0,30000,0,0,0,30000,0,30000,30000
058403,玉晶光元大99購12,0,0,0,0,0,0,0,0,0,30000,0,0,0,80000,50000,30000,30000
06197P,國巨元大97售08  ,0,0,0,0,0,0,0,0,0,30000,0,0,0,30000,0,30000,30000
06121P,同欣電凱基97售02,0,0,0,0,0,0,0,0,0,30000,0,0,0,30000,0,30000,30000
06444P,大立光凱基98售08,0,0,0,0,0,0,0,0,0,30000,0,0,0,30000,0,30000,30000
06626P,大立光統一9A售01,0,0,0,0,0,0,0,0,0,30000,0,0,0,40000,10000,30000,30000
06635P,聯發科凱基98售15,0,0,0,0,0,0,0,0,0,30000,0,0,0,30000,0,30000,30000
1786,科妍            ,137000,104000,33000,0,0,0,0,0,0,-3000,1000,4000,-3000,0,0,0,30000
07019P,鴻海台新99售01  ,0,0,0,0,0,0,0,0,0,30000,0,0,0,100000,70000,30000,30000
07062P,台積電元大99售15,0,0,0,0,0,0,0,0,0,30000,0,0,0,33000,3000,30000,30000
2923,鼎固-KY         ,113000,83000,30000,0,0,0,0,0,0,0,0,0,0,0,0,0,30000
052691,GIS元大96購01   ,0,0,0,0,0,0,0,0,0,30000,0,0,0,30000,0,30000,30000
052667,漢唐群益96購01  ,0,0,0,0,0,0,0,0,0,30000,0,0,0,30000,0,30000,30000
052575,茂林凱基96購04  ,0,0,0,0,0,0,0,0,0,30000,0,0,0,50000,20000,30000,30000
052079,康友元富98購01  ,0,0,0,0,0,0,0,0,0,30000,0,0,0,30000,0,30000,30000
052054,台表科凱基96購01,0,0,0,0,0,0,0,0,0,30000,0,0,0,30000,0,30000,30000
049560,香港反統一95購01,0,0,0,0,0,0,0,0,0,30000,0,0,0,30000,0,30000,30000
051551,新日興永豐95購01,0,0,0,0,0,0,0,0,0,30000,0,0,0,30000,0,30000,30000
051500,聯茂群益95購01  ,0,0,0,0,0,0,0,0,0,30000,0,0,0,30000,0,30000,30000
051534,景碩國票97購01  ,0,0,0,0,0,0,0,0,0,30000,0,0,0,30000,0,30000,30000
050717,京鼎群益96購01  ,0,0,0,0,0,0,0,0,0,30000,0,0,0,30000,0,30000,30000
050749,道瓊銀統一96購03,0,0,0,0,0,0,0,0,0,30000,0,0,0,30000,0,30000,30000
050634,華新科群益96購01,0,0,0,0,0,0,0,0,0,30000,0,0,0,50000,20000,30000,30000
056756,T50反1元大98購06,0,0,0,0,0,0,0,0,0,30000,0,0,0,30000,0,30000,30000
056716,康舒永豐98購01  ,0,0,0,0,0,0,0,0,0,30000,0,0,0,30000,0,30000,30000
056588,聯發科統一9A購02,0,0,0,0,0,0,0,0,0,30000,0,0,0,30000,0,30000,30000
049925,創意元大95購02  ,0,0,0,0,0,0,0,0,0,30000,0,0,0,30000,0,30000,30000
052104,英業達兆豐96購01,0,0,0,0,0,0,0,0,0,30000,0,0,0,230000,200000,30000,30000
052126,群創國票97購01  ,0,0,0,0,0,0,0,0,0,30000,0,0,0,30000,0,30000,30000
050174,技嘉元大94購01  ,0,0,0,0,0,0,0,0,0,30000,0,0,0,40000,10000,30000,30000
051667,光磊元大96購02  ,0,0,0,0,0,0,0,0,0,30000,0,0,0,30000,0,30000,30000
045906,鴻海中信94購01  ,0,0,0,0,0,0,0,0,0,30000,0,0,0,30000,0,30000,30000
04628P,欣興元大95售01  ,0,0,0,0,0,0,0,0,0,30000,0,0,0,30000,0,30000,30000
051168,訊連元大95購02  ,0,0,0,0,0,0,0,0,0,30000,0,0,0,30000,0,30000,30000
052748,群創元大9A購02  ,0,0,0,0,0,0,0,0,0,30000,0,0,0,37000,7000,30000,30000
051267,美律富邦96購01  ,0,0,0,0,0,0,0,0,0,30000,0,0,0,30000,0,30000,30000
052878,台虹凱基96購01  ,0,0,0,0,0,0,0,0,0,30000,0,0,0,35000,5000,30000,30000
047049,聯發科國票94購01,0,0,0,0,0,0,0,0,0,30000,0,0,0,30000,0,30000,30000
04777P,聯發科凱基94售10,0,0,0,0,0,0,0,0,0,30000,0,0,0,30000,0,30000,30000
047904,臺指反元大96購01,0,0,0,0,0,0,0,0,0,30000,0,0,0,30000,0,30000,30000
04416P,牧德元富94售06  ,0,0,0,0,0,0,0,0,0,30000,0,0,0,30000,0,30000,30000
049034,台達電兆豐94購01,0,0,0,0,0,0,0,0,0,30000,0,0,0,30000,0,30000,30000
04487P,南亞科凱基94售01,0,0,0,0,0,0,0,0,0,30000,0,0,0,30000,0,30000,30000
039550,滬深反凱基94購01,0,0,0,0,0,0,0,0,0,30000,0,0,0,30000,0,30000,30000
04145P,聯發科凱基93售28,0,0,0,0,0,0,0,0,0,30000,0,0,0,30000,0,30000,30000
04188P,康控元富93售03  ,0,0,0,0,0,0,0,0,0,30000,0,0,0,30000,0,30000,30000
048682,奇力新富邦96購01,0,0,0,0,0,0,0,0,0,30000,0,0,0,30000,0,30000,30000
053184,世紀鋼元富96購01,0,0,0,0,0,0,0,0,0,30000,0,0,0,120000,90000,30000,30000
053186,健策中信9C購01  ,0,0,0,0,0,0,0,0,0,30000,0,0,0,47000,17000,30000,30000
056127,致新國票98購02  ,0,0,0,0,0,0,0,0,0,30000,0,0,0,30000,0,30000,30000
05602P,國巨元大96售06  ,0,0,0,0,0,0,0,0,0,30000,0,0,0,40000,10000,30000,30000
055096,緯穎群益97購01  ,0,0,0,0,0,0,0,0,0,30000,0,0,0,30000,0,30000,30000
054836,勤誠中信97購01  ,0,0,0,0,0,0,0,0,0,30000,0,0,0,90000,60000,30000,30000
054928,帆宣凱基98購01  ,0,0,0,0,0,0,0,0,0,30000,0,0,0,30000,0,30000,30000
054473,鴻海中信96購02  ,0,0,0,0,0,0,0,0,0,30000,0,0,0,30000,0,30000,30000
054415,奇力新元大96購06,0,0,0,0,0,0,0,0,0,30000,0,0,0,30000,0,30000,30000
057819,新日興元大99購01,0,0,0,0,0,0,0,0,0,30000,0,0,0,30000,0,30000,30000
057740,茂林富邦9A購01  ,0,0,0,0,0,0,0,0,0,30000,0,0,0,30000,0,30000,30000
057759,聯發科凱基98購17,0,0,0,0,0,0,0,0,0,30000,0,0,0,30000,0,30000,30000
055658,南電元富97購01  ,0,0,0,0,0,0,0,0,0,30000,0,0,0,30000,0,30000,30000
058141,嘉聯益元大99購05,0,0,0,0,0,0,0,0,0,30000,0,0,0,30000,0,30000,30000
058208,百和凱基99購01  ,0,0,0,0,0,0,0,0,0,30000,0,0,0,30000,0,30000,30000
057864,奇力新凱基99購03,0,0,0,0,0,0,0,0,0,30000,0,0,0,30000,0,30000,30000
057987,大立光元富98購02,0,0,0,0,0,0,0,0,0,30000,0,0,0,30000,0,30000,30000
055378,晶相光元大97購02,0,0,0,0,0,0,0,0,0,30000,0,0,0,30000,0,30000,30000
053406,國巨兆豐96購02  ,0,0,0,0,0,0,0,0,0,30000,0,0,0,30000,0,30000,30000
054784,順德群益9A購01  ,0,0,0,0,0,0,0,0,0,30000,0,0,0,40000,10000,30000,30000
054755,世紀鋼凱基98購01,0,0,0,0,0,0,0,0,0,30000,0,0,0,95000,65000,30000,30000
053381,友達元大9A購02  ,0,0,0,0,0,0,0,0,0,30000,0,0,0,40000,10000,30000,30000
053978,創意元大96購05  ,0,0,0,0,0,0,0,0,0,30000,0,0,0,40000,10000,30000,30000
053921,嘉晶國票97購03  ,0,0,0,0,0,0,0,0,0,30000,0,0,0,30000,0,30000,30000
053904,漢唐凱基97購01  ,0,0,0,0,0,0,0,0,0,30000,0,0,0,130000,100000,30000,30000
053584,友達元大9B購02  ,0,0,0,0,0,0,0,0,0,30000,0,0,0,102000,72000,30000,30000
057328,京鼎群益99購02  ,0,0,0,0,0,0,0,0,0,30000,0,0,0,30000,0,30000,30000
055262,台虹國泰98購01  ,0,0,0,0,0,0,0,0,0,30000,0,0,0,30000,0,30000,30000
055326,緯穎國票97購06  ,0,0,0,0,0,0,0,0,0,30000,0,0,0,40000,10000,30000,30000
055354,宏達電凱基98購01,0,0,0,0,0,0,0,0,0,30000,0,0,0,35000,5000,30000,30000
056430,鴻海凱基98購06  ,0,0,0,0,0,0,0,0,0,30000,0,0,0,30000,0,30000,30000
057164,國巨元大98購14  ,0,0,0,0,0,0,0,0,0,30000,0,0,0,30000,0,30000,30000
055197,致新元富97購02  ,0,0,0,0,0,0,0,0,0,30000,0,0,0,30000,0,30000,30000
055234,昇陽半國票98購02,0,0,0,0,0,0,0,0,0,30000,0,0,0,30000,0,30000,30000
055257,景碩統一97購01  ,0,0,0,0,0,0,0,0,0,30000,0,0,0,30000,0,30000,30000
056901,華新科元大98購03,0,0,0,0,0,0,0,0,0,30000,0,0,0,30000,0,30000,30000
056899,可成元大98購01  ,0,0,0,0,0,0,0,0,0,30000,0,0,0,30000,0,30000,30000
054053,聯茂元大96購01  ,0,0,0,0,0,0,0,0,0,30000,0,0,0,40000,10000,30000,30000
054040,中石化元大9C購01,0,0,0,0,0,0,0,0,0,30000,0,0,0,30000,0,30000,30000
055164,矽創元大98購01  ,0,0,0,0,0,0,0,0,0,30000,0,0,0,30000,0,30000,30000
059059,宏達電凱基99購03,0,0,0,0,0,0,0,0,0,29000,0,0,0,65000,36000,29000,29000
048732,台勝科麥證95購01,0,0,0,53000,24000,29000,0,0,0,29000,0,0,0,53000,24000,29000,29000
044809,道瓊反國票93購01,0,0,0,0,0,0,0,0,0,29000,0,0,0,29000,0,29000,29000
056771,嘉晶元大99購01  ,0,0,0,0,0,0,0,0,0,29000,0,0,0,29000,0,29000,29000
055286,晶技元大98購03  ,0,0,0,0,0,0,0,0,0,29000,0,0,0,99000,70000,29000,29000
057479,致茂元大98購03  ,0,0,0,0,0,0,0,0,0,29000,0,0,0,33000,4000,29000,29000
053521,緯穎群益96購02  ,0,0,0,0,0,0,0,0,0,29000,0,0,0,29000,0,29000,29000
057071,華擎永豐98購02  ,0,0,0,0,0,0,0,0,0,29000,0,0,0,60000,31000,29000,29000
06716P,台積電元大9A售02,0,0,0,0,0,0,0,0,0,28000,0,0,0,88000,60000,28000,28000
5706,鳳凰            ,62000,34000,28000,0,0,0,0,0,0,0,0,0,0,0,0,0,28000
06953P,景碩統一9A售01  ,0,0,0,0,0,0,0,0,0,28000,0,0,0,40000,12000,28000,28000
05238P,禾伸堂永豐95售01,0,0,0,0,0,0,0,0,0,28000,0,0,0,38000,10000,28000,28000
03421B,臺股指元大99熊01,0,0,0,0,0,0,0,0,0,28000,0,0,0,28000,0,28000,28000
04550P,超眾元大94售01  ,0,0,0,0,0,0,0,0,0,28000,0,0,0,38000,10000,28000,28000
04605P,台積電兆豐94售03,0,0,0,0,0,0,0,0,0,28000,0,0,0,270000,242000,28000,28000
055876,美食元富9A購01  ,0,0,0,0,0,0,0,0,0,28000,0,0,0,28000,0,28000,28000
056233,超眾凱基97購02  ,0,0,0,0,0,0,0,0,0,28000,0,0,0,76000,48000,28000,28000
055206,台虹中信97購01  ,0,0,0,0,0,0,0,0,0,28000,0,0,0,58000,30000,28000,28000
054016,嘉晶永豐96購04  ,0,0,0,0,0,0,0,0,0,28000,0,0,0,73000,45000,28000,28000
07040P,台灣50元大9C售02,0,0,0,0,0,0,0,0,0,27000,0,0,0,61000,34000,27000,27000
2438,翔耀            ,30000,3000,27000,0,0,0,0,0,0,0,0,0,0,0,0,0,27000
06358P,力成中信97售02  ,0,0,0,0,0,0,0,0,0,27000,0,0,0,27000,0,27000,27000
06295P,國巨元大97售14  ,0,0,0,0,0,0,0,0,0,27000,0,0,0,319000,292000,27000,27000
059228,臺股指元大99購21,0,0,0,0,0,0,0,0,0,27000,0,0,0,27000,0,27000,27000
058324,嘉聯益永豐9A購01,0,0,0,0,0,0,0,0,0,27000,0,0,0,27000,0,27000,27000
052929,可成元大96購02  ,0,0,0,0,0,0,0,0,0,27000,0,0,0,27000,0,27000,27000
04712P,國泰金元大94售01,0,0,0,0,0,0,0,0,0,27000,0,0,0,100000,73000,27000,27000
05090P,國巨元大95售05  ,0,0,0,0,0,0,0,0,0,27000,0,0,0,83000,56000,27000,27000
056694,欣興群益98購04  ,0,0,0,0,0,0,0,0,0,27000,0,0,0,100000,73000,27000,27000
055986,祥碩元富97購01  ,0,0,0,0,0,0,0,0,0,27000,0,0,0,27000,0,27000,27000
055085,大毅國票97購01  ,0,0,0,0,0,0,0,0,0,27000,0,0,0,37000,10000,27000,27000
058008,禾伸堂國票99購02,0,0,0,0,0,0,0,0,0,27000,0,0,0,27000,0,27000,27000
057927,勤誠凱基98購01  ,0,0,0,0,0,0,0,0,0,27000,0,0,0,40000,13000,27000,27000
058194,勤誠永豐99購01  ,0,0,0,0,0,0,0,0,0,27000,0,0,0,27000,0,27000,27000
058656,燿華中信99購01  ,0,0,0,0,0,0,0,0,0,26000,0,0,0,450000,424000,26000,26000
05898P,旺宏凱基96售06  ,0,0,0,0,0,0,0,0,0,26000,0,0,0,39000,13000,26000,26000
059212,鴻海元大99購28  ,0,0,0,0,0,0,0,0,0,26000,0,0,0,57000,31000,26000,26000
06211P,鴻海元大98售04  ,0,0,0,0,0,0,0,0,0,26000,0,0,0,31000,5000,26000,26000
06312P,樺漢元富97售02  ,0,0,0,0,0,0,0,0,0,26000,0,0,0,26000,0,26000,26000
056545,TPK凱基98購02   ,0,0,0,0,0,0,0,0,0,26000,0,0,0,26000,0,26000,26000
056384,玉晶光國泰9A購02,0,0,0,0,0,0,0,0,0,26000,0,0,0,46000,20000,26000,26000
051023,S&P反1統一95購02,0,0,0,0,0,0,0,0,0,26000,0,0,0,26000,0,26000,26000
050030,嘉晶元大94購03  ,0,0,0,0,0,0,0,0,0,26000,0,0,0,29000,3000,26000,26000
050372,全新元大96購03  ,0,0,0,0,0,0,0,0,0,26000,0,0,0,26000,0,26000,26000
05237P,為升永豐95售01  ,0,0,0,0,0,0,0,0,0,26000,0,0,0,26000,0,26000,26000
051978,泰碩凱基96購01  ,0,0,0,0,0,0,0,0,0,26000,0,0,0,26000,0,26000,26000
049406,T50反1日盛97購01,0,0,0,0,0,0,0,0,0,26000,0,0,0,26000,0,26000,26000
05286P,矽力統一95售02  ,0,0,0,0,0,0,0,0,0,26000,0,0,0,26000,0,26000,26000
044247,道瓊反元富97購01,0,0,0,0,0,0,0,0,0,26000,0,0,0,66000,40000,26000,26000
04313P,國巨元富95售03  ,0,0,0,0,0,0,0,0,0,26000,0,0,0,26000,0,26000,26000
043585,道瓊反元大94購01,0,0,0,0,0,0,0,0,0,26000,0,0,0,26000,0,26000,26000
054975,福懋科元大97購01,0,0,0,0,0,0,0,0,0,26000,0,0,0,151000,125000,26000,26000
057062,立積國泰99購01  ,0,0,0,0,0,0,0,0,0,26000,0,0,0,26000,0,26000,26000
06393P,台積電元大97售27,0,0,0,0,0,0,0,0,0,25000,0,0,0,25000,0,25000,25000
06235P,國巨元大97售12  ,0,0,0,0,0,0,0,0,0,25000,0,0,0,25000,0,25000,25000
06247P,同欣電元富97售02,0,0,0,0,0,0,0,0,0,25000,0,0,0,25000,0,25000,25000
06408P,聯茂元富97售02  ,0,0,0,0,0,0,0,0,0,25000,0,0,0,26000,1000,25000,25000
06715P,台積電元大99售04,0,0,0,0,0,0,0,0,0,25000,0,0,0,25000,0,25000,25000
06636P,可成凱基98售08  ,0,0,0,0,0,0,0,0,0,25000,0,0,0,30000,5000,25000,25000
06017P,亞光凱基96售04  ,0,0,0,0,0,0,0,0,0,25000,0,0,0,25000,0,25000,25000
059181,世紀鋼元富9C購01,0,0,0,0,0,0,0,0,0,25000,0,0,0,40000,15000,25000,25000
059131,國巨群益99購07  ,0,0,0,0,0,0,0,0,0,25000,0,0,0,25000,0,25000,25000
058989,茂林凱基99購02  ,0,0,0,0,0,0,0,0,0,25000,0,0,0,25000,0,25000,25000
058923,華新科元富99購06,0,0,0,0,0,0,0,0,0,25000,0,0,0,25000,0,25000,25000
058847,國巨群益99購05  ,0,0,0,0,0,0,0,0,0,25000,0,0,0,25000,0,25000,25000
058851,大立光群益99購07,0,0,0,0,0,0,0,0,0,25000,0,0,0,35000,10000,25000,25000
058761,欣興群益99購02  ,0,0,0,0,0,0,0,0,0,25000,0,0,0,25000,0,25000,25000
058605,華邦電元大99購04,0,0,0,0,0,0,0,0,0,25000,0,0,0,25000,0,25000,25000
058357,智邦凱基99購02  ,0,0,0,0,0,0,0,0,0,25000,0,0,0,39000,14000,25000,25000
1726,永記            ,43000,18000,25000,0,0,0,0,0,0,0,0,0,0,0,0,0,25000
043656,上証反元大94購01,0,0,0,0,0,0,0,0,0,25000,0,0,0,25000,0,25000,25000
048783,國巨元大94購01  ,0,0,0,0,0,0,0,0,0,25000,0,0,0,35000,10000,25000,25000
051072,強茂國票95購02  ,0,0,0,0,0,0,0,0,0,25000,0,0,0,25000,0,25000,25000
047989,深中小元大96購02,0,0,0,0,0,0,0,0,0,25000,0,0,0,25000,0,25000,25000
047687,元金2X富邦96購01,0,0,0,0,0,0,0,0,0,25000,0,0,0,25000,0,25000,25000
052980,上銀元大96購03  ,0,0,0,0,0,0,0,0,0,25000,0,0,0,60000,35000,25000,25000
052590,祥碩永豐96購01  ,0,0,0,0,0,0,0,0,0,25000,0,0,0,72000,47000,25000,25000
052692,滬深2X中信99購02,0,0,0,0,0,0,0,0,0,25000,0,0,0,25000,0,25000,25000
050842,旺宏國票97購01  ,0,0,0,0,0,0,0,0,0,25000,0,0,0,25000,0,25000,25000
051590,玉晶光元大96購02,0,0,0,0,0,0,0,0,0,25000,0,0,0,50000,25000,25000,25000
05002P,台積電統一95售03,0,0,0,0,0,0,0,0,0,25000,0,0,0,35000,10000,25000,25000
050930,矽格凱基95購01  ,0,0,0,0,0,0,0,0,0,25000,0,0,0,35000,10000,25000,25000
05013P,台積電元大96售05,0,0,0,0,0,0,0,0,0,25000,0,0,0,55000,30000,25000,25000
056310,神達元大97購02  ,0,0,0,0,0,0,0,0,0,25000,0,0,0,40000,15000,25000,25000
056668,光磊國票99購01  ,0,0,0,0,0,0,0,0,0,25000,0,0,0,25000,0,25000,25000
056644,宏達電凱基98購04,0,0,0,0,0,0,0,0,0,25000,0,0,0,97000,72000,25000,25000
056194,聯發科富邦9B購01,0,0,0,0,0,0,0,0,0,25000,0,0,0,25000,0,25000,25000
056291,聯茂永豐97購03  ,0,0,0,0,0,0,0,0,0,25000,0,0,0,63000,38000,25000,25000
055476,台郡凱基97購02  ,0,0,0,0,0,0,0,0,0,25000,0,0,0,25000,0,25000,25000
054632,緯穎凱基9A購01  ,0,0,0,0,0,0,0,0,0,25000,0,0,0,25000,0,25000,25000
058106,神達統一98購02  ,0,0,0,0,0,0,0,0,0,25000,0,0,0,25000,0,25000,25000
056472,美律元大99購03  ,0,0,0,0,0,0,0,0,0,25000,0,0,0,31000,6000,25000,25000
055127,台虹兆豐97購01  ,0,0,0,0,0,0,0,0,0,25000,0,0,0,25000,0,25000,25000
055307,瑞昱群益97購02  ,0,0,0,0,0,0,0,0,0,25000,0,0,0,120000,95000,25000,25000
055335,健策兆豐98購01  ,0,0,0,0,0,0,0,0,0,25000,0,0,0,25000,0,25000,25000
05366P,鴻海元富95售12  ,0,0,0,0,0,0,0,0,0,25000,0,0,0,25000,0,25000,25000
053850,嘉澤元富96購03  ,0,0,0,0,0,0,0,0,0,25000,0,0,0,25000,0,25000,25000
054714,和鑫台新98購01  ,0,0,0,0,0,0,0,0,0,25000,0,0,0,25000,0,25000,25000
054299,南電元大96購03  ,0,0,0,0,0,0,0,0,0,25000,0,0,0,45000,20000,25000,25000
05543P,鴻海元富96售04  ,0,0,0,0,0,0,0,0,0,25000,0,0,0,25000,0,25000,25000
6666,羅麗芬-KY       ,64000,39000,25000,0,0,0,0,0,0,0,0,0,0,0,0,0,25000
9136,巨騰-DR         ,36000,11000,25000,0,0,0,0,0,0,0,0,0,0,0,0,0,25000
06851P,鈺齊元大98售01  ,0,0,0,0,0,0,0,0,0,24000,0,0,0,120000,96000,24000,24000
058330,鴻海元富99購01  ,0,0,0,0,0,0,0,0,0,24000,0,0,0,24000,0,24000,24000
058829,華新科永豐99購04,0,0,0,0,0,0,0,0,0,24000,0,0,0,24000,0,24000,24000
058900,旺宏元大99購11  ,0,0,0,0,0,0,0,0,0,24000,0,0,0,158000,134000,24000,24000
06441P,台積電凱基98售08,0,0,0,0,0,0,0,0,0,24000,0,0,0,24000,0,24000,24000
05223P,臻鼎凱基95售02  ,0,0,0,0,0,0,0,0,0,24000,0,0,0,24000,0,24000,24000
049973,T50反1日盛9A購01,0,0,0,0,0,0,0,0,0,24000,0,0,0,24000,0,24000,24000
04643P,京元電凱基94售02,0,0,0,0,0,0,0,0,0,24000,0,0,0,24000,0,24000,24000
049314,京鼎凱基94購01  ,0,0,0,0,0,0,0,0,0,24000,0,0,0,24000,0,24000,24000
052854,聯詠日盛96購01  ,0,0,0,0,0,0,0,0,0,24000,0,0,0,24000,0,24000,24000
048627,T50反1元大96購02,0,0,0,0,0,0,0,0,0,24000,0,0,0,24000,0,24000,24000
053787,健策元大97購02  ,0,0,0,0,0,0,0,0,0,24000,0,0,0,86000,62000,24000,24000
053731,矽創凱基96購03  ,0,0,0,0,0,0,0,0,0,24000,0,0,0,24000,0,24000,24000
057165,國巨元大99購05  ,0,0,0,0,0,0,0,0,0,24000,0,0,0,65000,41000,24000,24000
058166,鴻海凱基9A購01  ,0,0,0,0,0,0,0,0,0,24000,0,0,0,24000,0,24000,24000
058734,康友永豐99購01  ,0,0,0,0,0,0,0,0,0,23000,0,0,0,23000,0,23000,23000
058328,世紀鋼統一9B購01,0,0,0,0,0,0,0,0,0,23000,0,0,0,23000,0,23000,23000
1615,大山            ,39000,16000,23000,0,0,0,0,0,0,0,0,0,0,0,0,0,23000
00689R,國泰20年美債反1 ,0,0,0,0,0,0,0,0,0,23000,0,0,0,137000,114000,23000,23000
020008,元大特股高息N   ,0,0,0,0,0,0,0,0,0,23000,0,0,0,37000,14000,23000,23000
046797,T50反1元大96購01,0,0,0,0,0,0,0,0,0,23000,0,0,0,30000,7000,23000,23000
048058,大立光國泰95購01,0,0,0,0,0,0,0,0,0,23000,0,0,0,543000,520000,23000,23000
05159P,聯發科永豐95售04,0,0,0,0,0,0,0,0,0,23000,0,0,0,28000,5000,23000,23000
050767,京元電元大96購01,0,0,0,0,0,0,0,0,0,23000,0,0,0,33000,10000,23000,23000
052420,道瓊反國票9B購01,0,0,0,0,0,0,0,0,0,23000,0,0,0,23000,0,23000,23000
057762,全新凱基99購03  ,0,0,0,0,0,0,0,0,0,23000,0,0,0,23000,0,23000,23000
055532,中工群益98購01  ,0,0,0,0,0,0,0,0,0,23000,0,0,0,23000,0,23000,23000
057537,聯茂元大98購04  ,0,0,0,0,0,0,0,0,0,23000,0,0,0,23000,0,23000,23000
6288,聯嘉            ,494000,491000,3000,0,0,0,0,0,0,20000,25000,5000,20000,0,0,0,23000
4571,鈞興-KY         ,32000,7000,25000,0,0,0,0,0,0,-3000,1000,4000,-3000,0,0,0,22000
3494,誠研            ,30000,8000,22000,0,0,0,0,0,0,0,0,0,0,0,0,0,22000
3437,榮創            ,183000,161000,22000,0,0,0,0,0,0,0,0,0,0,0,0,0,22000
058354,台積電凱基9A購06,0,0,0,0,0,0,0,0,0,22000,0,0,0,35000,13000,22000,22000
058414,大立光兆豐99購02,0,0,0,0,0,0,0,0,0,22000,0,0,0,22000,0,22000,22000
05891P,聯發科中信98售03,0,0,0,0,0,0,0,0,0,22000,0,0,0,32000,10000,22000,22000
059064,緯穎凱基99購02  ,0,0,0,0,0,0,0,0,0,22000,0,0,0,24000,2000,22000,22000
051415,晶技國票96購01  ,0,0,0,0,0,0,0,0,0,22000,0,0,0,22000,0,22000,22000
050818,華新科凱基95購02,0,0,0,0,0,0,0,0,0,22000,0,0,0,22000,0,22000,22000
049723,緯穎凱基94購04  ,0,0,0,0,0,0,0,0,0,22000,0,0,0,22000,0,22000,22000
048190,道瓊反元大96購02,0,0,0,0,0,0,0,0,0,22000,0,0,0,22000,0,22000,22000
048485,泰鼎國泰94購02  ,0,0,0,0,0,0,0,0,0,22000,0,0,0,22000,0,22000,22000
00736,國泰新興市場    ,14000,1000,13000,0,0,0,0,0,0,9000,0,0,0,109000,100000,9000,22000
00650L,FH香港正2       ,0,0,0,0,0,0,0,0,0,22000,0,0,0,145000,123000,22000,22000
03417B,臺股指凱基95熊19,0,0,0,0,0,0,0,0,0,22000,0,0,0,40000,18000,22000,22000
053673,超眾元富96購03  ,0,0,0,0,0,0,0,0,0,22000,0,0,0,356000,334000,22000,22000
053769,香港反元大99購01,0,0,0,0,0,0,0,0,0,22000,0,0,0,22000,0,22000,22000
053487,台泥兆豐97購01  ,0,0,0,0,0,0,0,0,0,22000,0,0,0,60000,38000,22000,22000
054742,京鼎凱基99購01  ,0,0,0,0,0,0,0,0,0,22000,0,0,0,22000,0,22000,22000
05411P,台積電國票96售08,0,0,0,0,0,0,0,0,0,22000,0,0,0,87000,65000,22000,22000
055094,智易群益98購01  ,0,0,0,0,0,0,0,0,0,22000,0,0,0,22000,0,22000,22000
055862,矽力元大97購04  ,0,0,0,0,0,0,0,0,0,22000,0,0,0,22000,0,22000,22000
057672,茂林元大98購02  ,0,0,0,0,0,0,0,0,0,22000,0,0,0,22000,0,22000,22000
057713,美律統一99購01  ,0,0,0,0,0,0,0,0,0,22000,0,0,0,22000,0,22000,22000
057964,緯穎元大99購03  ,0,0,0,0,0,0,0,0,0,22000,0,0,0,39000,17000,22000,22000
058388,健策國票9A購01  ,0,0,0,0,0,0,0,0,0,21000,0,0,0,31000,10000,21000,21000
05854P,華新科凱基96售09,0,0,0,0,0,0,0,0,0,21000,0,0,0,21000,0,21000,21000
06460P,亞德客元富98售02,0,0,0,0,0,0,0,0,0,21000,0,0,0,21000,0,21000,21000
06118P,上証2X凱基98售03,0,0,0,0,0,0,0,0,0,21000,0,0,0,21000,0,21000,21000
052662,華新科國票97購01,0,0,0,0,0,0,0,0,0,21000,0,0,0,21000,0,21000,21000
051902,T50反1元大97購01,0,0,0,0,0,0,0,0,0,21000,0,0,0,21000,0,21000,21000
056696,茂林群益98購02  ,0,0,0,0,0,0,0,0,0,21000,0,0,0,21000,0,21000,21000
058005,茂林群益98購04  ,0,0,0,0,0,0,0,0,0,21000,0,0,0,21000,0,21000,21000
058138,晶相光元大9C購01,0,0,0,0,0,0,0,0,0,21000,0,0,0,21000,0,21000,21000
057818,泰碩元大9A購01  ,0,0,0,0,0,0,0,0,0,21000,0,0,0,47000,26000,21000,21000
057066,緯穎富邦99購01  ,0,0,0,0,0,0,0,0,0,21000,0,0,0,231000,210000,21000,21000
056071,創意元大97購02  ,0,0,0,0,0,0,0,0,0,21000,0,0,0,46000,25000,21000,21000
057596,聯茂兆豐99購01  ,0,0,0,0,0,0,0,0,0,21000,0,0,0,21000,0,21000,21000
054111,緯穎凱基97購01  ,0,0,0,0,0,0,0,0,0,21000,0,0,0,24000,3000,21000,21000
054237,茂林群益97購01  ,0,0,0,0,0,0,0,0,0,21000,0,0,0,21000,0,21000,21000
057403,亞光群益98購04  ,0,0,0,0,0,0,0,0,0,21000,0,0,0,21000,0,21000,21000
05472P,國巨統一96售02  ,0,0,0,0,0,0,0,0,0,21000,0,0,0,21000,0,21000,21000
053443,智邦凱基97購01  ,0,0,0,0,0,0,0,0,0,21000,0,0,0,32000,11000,21000,21000
055415,禾伸堂富邦9B購01,0,0,0,0,0,0,0,0,0,21000,0,0,0,21000,0,21000,21000
05367P,鴻海元富95售13  ,0,0,0,0,0,0,0,0,0,21000,0,0,0,21000,0,21000,21000
059122,超眾永豐99購01  ,0,0,0,0,0,0,0,0,0,20000,0,0,0,20000,0,20000,20000
059211,鴻海元大99購27  ,0,0,0,0,0,0,0,0,0,20000,0,0,0,50000,30000,20000,20000
06421P,嘉澤統一97售02  ,0,0,0,0,0,0,0,0,0,20000,0,0,0,20000,0,20000,20000
06282P,聯鈞永豐97售02  ,0,0,0,0,0,0,0,0,0,20000,0,0,0,20000,0,20000,20000
06578P,華新科國票98售02,0,0,0,0,0,0,0,0,0,20000,0,0,0,20000,0,20000,20000
06690P,玉晶光群益9A售05,0,0,0,0,0,0,0,0,0,20000,0,0,0,20000,0,20000,20000
06724P,台灣50國票98售01,0,0,0,0,0,0,0,0,0,20000,0,0,0,20000,0,20000,20000
06766P,玉晶光元大99售10,0,0,0,0,0,0,0,0,0,20000,0,0,0,20000,0,20000,20000
058533,玉晶光元富99購01,0,0,0,0,0,0,0,0,0,20000,0,0,0,30000,10000,20000,20000
058616,台虹元大9A購01  ,0,0,0,0,0,0,0,0,0,20000,0,0,0,20000,0,20000,20000
058675,康控群益9B購01  ,0,0,0,0,0,0,0,0,0,20000,0,0,0,34000,14000,20000,20000
058692,華邦電國票9B購01,0,0,0,0,0,0,0,0,0,20000,0,0,0,20000,0,20000,20000
058472,亞德客凱基9A購01,0,0,0,0,0,0,0,0,0,20000,0,0,0,27000,7000,20000,20000
058339,康友元富99購02  ,0,0,0,0,0,0,0,0,0,20000,0,0,0,20000,0,20000,20000
058308,全新元大9B購01  ,0,0,0,0,0,0,0,0,0,20000,0,0,0,60000,40000,20000,20000
059023,可成統一9B購02  ,0,0,0,0,0,0,0,0,0,20000,0,0,0,20000,0,20000,20000
059096,百和元大99購04  ,0,0,0,0,0,0,0,0,0,20000,0,0,0,20000,0,20000,20000
058926,勤誠元富99購01  ,0,0,0,0,0,0,0,0,0,20000,0,0,0,41000,21000,20000,20000
058827,聯發科永豐9A購01,0,0,0,0,0,0,0,0,0,20000,0,0,0,30000,10000,20000,20000
058846,鴻海群益99購03  ,0,0,0,0,0,0,0,0,0,20000,0,0,0,30000,10000,20000,20000
2429,銘旺科          ,57000,37000,20000,0,0,0,0,0,0,0,0,0,0,0,0,0,20000
08637P,台灣50中信96售03,0,0,0,0,0,0,0,0,0,20000,0,0,0,20000,0,20000,20000
06877P,台積電兆豐98售04,0,0,0,0,0,0,0,0,0,20000,0,0,0,20000,0,20000,20000
06823P,台灣50永豐98售02,0,0,0,0,0,0,0,0,0,20000,0,0,0,20000,0,20000,20000
06944P,健鼎元富98售02  ,0,0,0,0,0,0,0,0,0,20000,0,0,0,30000,10000,20000,20000
07034P,大立光元富99售03,0,0,0,0,0,0,0,0,0,20000,0,0,0,24000,4000,20000,20000
07109P,聯發科中信9B售02,0,0,0,0,0,0,0,0,0,20000,0,0,0,24000,4000,20000,20000
07171P,臺股指國票99售08,0,0,0,0,0,0,0,0,0,20000,0,0,0,230000,210000,20000,20000
056695,景碩群益99購01  ,0,0,0,0,0,0,0,0,0,20000,0,0,0,20000,0,20000,20000
056731,國巨凱基98購04  ,0,0,0,0,0,0,0,0,0,20000,0,0,0,20000,0,20000,20000
056617,美律永豐98購01  ,0,0,0,0,0,0,0,0,0,20000,0,0,0,25000,5000,20000,20000
05663P,創意元富96售04  ,0,0,0,0,0,0,0,0,0,20000,0,0,0,20000,0,20000,20000
056796,國巨麥證98購02  ,0,0,0,20000,0,20000,0,0,0,20000,0,0,0,20000,0,20000,20000
05680P,聯發科元大96售12,0,0,0,0,0,0,0,0,0,20000,0,0,0,20000,0,20000,20000
056552,台表科凱基99購01,0,0,0,0,0,0,0,0,0,20000,0,0,0,20000,0,20000,20000
056582,易華電元大98購01,0,0,0,0,0,0,0,0,0,20000,0,0,0,20000,0,20000,20000
056606,華新科富邦9A購02,0,0,0,0,0,0,0,0,0,20000,0,0,0,20000,0,20000,20000
051931,美律國票96購02  ,0,0,0,0,0,0,0,0,0,20000,0,0,0,20000,0,20000,20000
05220P,台積電元大95售16,0,0,0,0,0,0,0,0,0,20000,0,0,0,20000,0,20000,20000
051841,南茂國泰96購01  ,0,0,0,0,0,0,0,0,0,20000,0,0,0,20000,0,20000,20000
049934,緯穎元大94購08  ,0,0,0,0,0,0,0,0,0,20000,0,0,0,99000,79000,20000,20000
05102P,臺股指凱基96售09,0,0,0,0,0,0,0,0,0,20000,0,0,0,20000,0,20000,20000
051668,智邦元大95購02  ,0,0,0,0,0,0,0,0,0,20000,0,0,0,250000,230000,20000,20000
052672,世紀鋼群益96購02,0,0,0,0,0,0,0,0,0,20000,0,0,0,160000,140000,20000,20000
049572,華固統一94購03  ,0,0,0,0,0,0,0,0,0,20000,0,0,0,20000,0,20000,20000
04950P,上証2X中信96售02,0,0,0,0,0,0,0,0,0,20000,0,0,0,53000,33000,20000,20000
049407,台積電日盛94購02,0,0,0,0,0,0,0,0,0,20000,0,0,0,20000,0,20000,20000
049778,宏達電統一94購02,0,0,0,0,0,0,0,0,0,20000,0,0,0,20000,0,20000,20000
049808,聯詠元大94購03  ,0,0,0,0,0,0,0,0,0,20000,0,0,0,20000,0,20000,20000
049809,聯詠元大94購04  ,0,0,0,0,0,0,0,0,0,20000,0,0,0,20000,0,20000,20000
049593,群創元大9A購01  ,0,0,0,0,0,0,0,0,0,20000,0,0,0,20000,0,20000,20000
051523,牧德凱基95購02  ,0,0,0,0,0,0,0,0,0,20000,0,0,0,20000,0,20000,20000
05150P,玉晶光第一95售01,0,0,0,0,0,0,0,0,0,20000,0,0,0,20000,0,20000,20000
050892,聯電元大96購02  ,0,0,0,0,0,0,0,0,0,20000,0,0,0,50000,30000,20000,20000
050406,台積電台新95購02,0,0,0,0,0,0,0,0,0,20000,0,0,0,80000,60000,20000,20000
050522,聯發科元大95購03,0,0,0,0,0,0,0,0,0,20000,0,0,0,50000,30000,20000,20000
050458,台郡元大94購03  ,0,0,0,0,0,0,0,0,0,20000,0,0,0,40000,20000,20000,20000
050550,大立光凱基95購04,0,0,0,0,0,0,0,0,0,20000,0,0,0,20000,0,20000,20000
03102P,臺股指凱基03售08,0,0,0,0,0,0,0,0,0,20000,0,0,0,20000,0,20000,20000
044302,智邦兆豐93購02  ,0,0,0,0,0,0,0,0,0,20000,0,0,0,20000,0,20000,20000
04365P,台積電元富95售02,0,0,0,0,0,0,0,0,0,20000,0,0,0,90000,70000,20000,20000
04234P,華通群益94售02  ,0,0,0,0,0,0,0,0,0,20000,0,0,0,28000,8000,20000,20000
048733,台勝科麥證95購02,0,0,0,52000,32000,20000,0,0,0,20000,0,0,0,52000,32000,20000,20000
048738,台積電統一94購04,0,0,0,0,0,0,0,0,0,20000,0,0,0,20000,0,20000,20000
048975,玉晶光元大94購03,0,0,0,0,0,0,0,0,0,20000,0,0,0,20000,0,20000,20000
048983,牧德元大95購01  ,0,0,0,0,0,0,0,0,0,20000,0,0,0,20000,0,20000,20000
04823P,台積電元富94售09,0,0,0,0,0,0,0,0,0,20000,0,0,0,70000,50000,20000,20000
04824P,亞泥中信94售02  ,0,0,0,0,0,0,0,0,0,20000,0,0,0,20000,0,20000,20000
048270,T50反1富邦99購01,0,0,0,0,0,0,0,0,0,20000,0,0,0,20000,0,20000,20000
048305,深100凱基96購01 ,0,0,0,0,0,0,0,0,0,20000,0,0,0,20000,0,20000,20000
047987,力成群益93購01  ,0,0,0,0,0,0,0,0,0,20000,0,0,0,20000,0,20000,20000
04763P,臺股指凱基96售05,0,0,0,0,0,0,0,0,0,20000,0,0,0,20000,0,20000,20000
04761P,可成凱基94售09  ,0,0,0,0,0,0,0,0,0,20000,0,0,0,20000,0,20000,20000
05105P,大立光台新95售02,0,0,0,0,0,0,0,0,0,20000,0,0,0,20000,0,20000,20000
051095,貿聯元大95購03  ,0,0,0,0,0,0,0,0,0,20000,0,0,0,20000,0,20000,20000
051250,大立光元大98購01,0,0,0,0,0,0,0,0,0,20000,0,0,0,30000,10000,20000,20000
051200,國巨麥證95購01  ,0,0,0,20000,0,20000,0,0,0,20000,0,0,0,20000,0,20000,20000
04645P,禾伸堂凱基94售03,0,0,0,0,0,0,0,0,0,20000,0,0,0,30000,10000,20000,20000
045504,群創凱基94購01  ,0,0,0,0,0,0,0,0,0,20000,0,0,0,20000,0,20000,20000
052884,台積電兆豐96購01,0,0,0,0,0,0,0,0,0,20000,0,0,0,20000,0,20000,20000
05289P,鴻海永豐95售05  ,0,0,0,0,0,0,0,0,0,20000,0,0,0,50000,30000,20000,20000
052930,華新科元大97購03,0,0,0,0,0,0,0,0,0,20000,0,0,0,20000,0,20000,20000
053754,英業達元富96購02,0,0,0,0,0,0,0,0,0,20000,0,0,0,20000,0,20000,20000
053773,上銀元大96購04  ,0,0,0,0,0,0,0,0,0,20000,0,0,0,20000,0,20000,20000
053779,台光電元大96購02,0,0,0,0,0,0,0,0,0,20000,0,0,0,20000,0,20000,20000
053855,康友國泰98購01  ,0,0,0,0,0,0,0,0,0,20000,0,0,0,20000,0,20000,20000
056939,康控元富98購01  ,0,0,0,0,0,0,0,0,0,20000,0,0,0,100000,80000,20000,20000
053509,華新群益98購01  ,0,0,0,0,0,0,0,0,0,20000,0,0,0,20000,0,20000,20000
054319,世紀鋼凱基96購02,0,0,0,0,0,0,0,0,0,20000,0,0,0,22000,2000,20000,20000
05347P,滬深2X元富9B售02,0,0,0,0,0,0,0,0,0,20000,0,0,0,20000,0,20000,20000
053483,嘉澤第一96購01  ,0,0,0,0,0,0,0,0,0,20000,0,0,0,20000,0,20000,20000
053474,聯發科元大97購06,0,0,0,0,0,0,0,0,0,20000,0,0,0,20000,0,20000,20000
054282,泰鼎群益98購02  ,0,0,0,0,0,0,0,0,0,20000,0,0,0,20000,0,20000,20000
054739,義隆凱基98購02  ,0,0,0,0,0,0,0,0,0,20000,0,0,0,30000,10000,20000,20000
054763,宏達電國票99購01,0,0,0,0,0,0,0,0,0,20000,0,0,0,20000,0,20000,20000
057251,泰鼎統一98購02  ,0,0,0,0,0,0,0,0,0,20000,0,0,0,25000,5000,20000,20000
057216,聯發科群益99購01,0,0,0,0,0,0,0,0,0,20000,0,0,0,20000,0,20000,20000
05744P,台表科元大96售04,0,0,0,0,0,0,0,0,0,20000,0,0,0,20000,0,20000,20000
057316,國巨凱基99購04  ,0,0,0,0,0,0,0,0,0,20000,0,0,0,20000,0,20000,20000
054245,鴻海元大96購23  ,0,0,0,0,0,0,0,0,0,20000,0,0,0,20000,0,20000,20000
055292,聯鈞元大97購02  ,0,0,0,0,0,0,0,0,0,20000,0,0,0,20000,0,20000,20000
056408,奇鋐國票99購01  ,0,0,0,0,0,0,0,0,0,20000,0,0,0,20000,0,20000,20000
054178,中磊台新97購01  ,0,0,0,0,0,0,0,0,0,20000,0,0,0,55000,35000,20000,20000
054066,緯穎國票97購03  ,0,0,0,0,0,0,0,0,0,20000,0,0,0,20000,0,20000,20000
05512P,華新科台新97售01,0,0,0,0,0,0,0,0,0,20000,0,0,0,36000,16000,20000,20000
055152,旺宏元大98購04  ,0,0,0,0,0,0,0,0,0,20000,0,0,0,20000,0,20000,20000
054023,和大康和96購01  ,0,0,0,0,0,0,0,0,0,20000,0,0,0,20000,0,20000,20000
056891,國巨元大99購03  ,0,0,0,0,0,0,0,0,0,20000,0,0,0,20000,0,20000,20000
056847,佐登元富98購01  ,0,0,0,0,0,0,0,0,0,20000,0,0,0,30000,10000,20000,20000
056851,瑞儀元富98購01  ,0,0,0,0,0,0,0,0,0,20000,0,0,0,30000,10000,20000,20000
055774,台光電凱基97購02,0,0,0,0,0,0,0,0,0,20000,0,0,0,20000,0,20000,20000
055745,臻鼎元富97購01  ,0,0,0,0,0,0,0,0,0,20000,0,0,0,20000,0,20000,20000
055757,大成鋼群益99購01,0,0,0,0,0,0,0,0,0,20000,0,0,0,20000,0,20000,20000
057621,崇越凱基98購01  ,0,0,0,0,0,0,0,0,0,20000,0,0,0,20000,0,20000,20000
057010,景碩中信98購01  ,0,0,0,0,0,0,0,0,0,20000,0,0,0,20000,0,20000,20000
05702P,矽創凱基96售02  ,0,0,0,0,0,0,0,0,0,20000,0,0,0,20000,0,20000,20000
055559,大立光凱基97購09,0,0,0,0,0,0,0,0,0,20000,0,0,0,20000,0,20000,20000
05551P,電子類元大96售01,0,0,0,0,0,0,0,0,0,20000,0,0,0,20000,0,20000,20000
055521,S&P反1群益01購01,0,0,0,0,0,0,0,0,0,20000,0,0,0,20000,0,20000,20000
055097,福懋科群益97購01,0,0,0,0,0,0,0,0,0,20000,0,0,0,20000,0,20000,20000
054519,禾伸堂元大97購02,0,0,0,0,0,0,0,0,0,20000,0,0,0,20000,0,20000,20000
054861,智邦群益97購01  ,0,0,0,0,0,0,0,0,0,20000,0,0,0,40000,20000,20000,20000
055956,瑞昱元大97購05  ,0,0,0,0,0,0,0,0,0,20000,0,0,0,20000,0,20000,20000
055859,啟碁元大97購03  ,0,0,0,0,0,0,0,0,0,20000,0,0,0,20000,0,20000,20000
055880,神達元富97購02  ,0,0,0,0,0,0,0,0,0,20000,0,0,0,20000,0,20000,20000
056986,超眾群益98購03  ,0,0,0,0,0,0,0,0,0,20000,0,0,0,20000,0,20000,20000
056173,廣達元富97購01  ,0,0,0,0,0,0,0,0,0,20000,0,0,0,50000,30000,20000,20000
056179,康友元富97購02  ,0,0,0,0,0,0,0,0,0,20000,0,0,0,20000,0,20000,20000
057820,華擎元大98購02  ,0,0,0,0,0,0,0,0,0,20000,0,0,0,20000,0,20000,20000
056475,宏達電元大99購02,0,0,0,0,0,0,0,0,0,20000,0,0,0,21000,1000,20000,20000
053224,矽力凱基96購02  ,0,0,0,0,0,0,0,0,0,20000,0,0,0,20000,0,20000,20000
054464,奇力新凱基98購02,0,0,0,0,0,0,0,0,0,20000,0,0,0,20000,0,20000,20000
054510,S&P反1元大98購01,0,0,0,0,0,0,0,0,0,20000,0,0,0,24000,4000,20000,20000
058098,T50反1國泰9A購02,0,0,0,0,0,0,0,0,0,20000,0,0,0,20000,0,20000,20000
058226,世芯元富99購01  ,0,0,0,0,0,0,0,0,0,20000,0,0,0,30000,10000,20000,20000
058244,神達元大99購02  ,0,0,0,0,0,0,0,0,0,20000,0,0,0,30000,10000,20000,20000
06822P,上銀富邦99售03  ,0,0,0,0,0,0,0,0,0,19000,0,0,0,20000,1000,19000,19000
08625P,台灣50凱基96售05,0,0,0,0,0,0,0,0,0,19000,0,0,0,19000,0,19000,19000
4766,南寶            ,140000,121000,19000,0,0,0,0,0,0,0,0,0,0,0,0,0,19000
05847P,大立光元大96售08,0,0,0,0,0,0,0,0,0,19000,0,0,0,19000,0,19000,19000
06308P,國巨元富97售06  ,0,0,0,0,0,0,0,0,0,19000,0,0,0,24000,5000,19000,19000
06471P,臺股指凱基99售11,0,0,0,0,0,0,0,0,0,19000,0,0,0,19000,0,19000,19000
06508P,台灣50統一98售01,0,0,0,0,0,0,0,0,0,19000,0,0,0,29000,10000,19000,19000
059121,瑞儀永豐99購01  ,0,0,0,0,0,0,0,0,0,19000,0,0,0,19000,0,19000,19000
06060P,玉晶光元大97售03,0,0,0,0,0,0,0,0,0,19000,0,0,0,181000,162000,19000,19000
051057,信邦群益95購01  ,0,0,0,0,0,0,0,0,0,19000,0,0,0,19000,0,19000,19000
050451,嘉晶元大95購01  ,0,0,0,0,0,0,0,0,0,19000,0,0,0,57000,38000,19000,19000
05021P,瑞昱凱基95售01  ,0,0,0,0,0,0,0,0,0,19000,0,0,0,30000,11000,19000,19000
050982,台積電國泰96購04,0,0,0,0,0,0,0,0,0,19000,0,0,0,49000,30000,19000,19000
053175,矽力群益96購01  ,0,0,0,0,0,0,0,0,0,19000,0,0,0,50000,31000,19000,19000
06503P,臺股指中信9A售02,0,0,0,0,0,0,0,0,0,18000,0,0,0,18000,0,18000,18000
06734P,智邦凱基98售05  ,0,0,0,0,0,0,0,0,0,18000,0,0,0,20000,2000,18000,18000
058318,致茂永豐9A購01  ,0,0,0,0,0,0,0,0,0,18000,0,0,0,18000,0,18000,18000
058751,南茂凱基9A購01  ,0,0,0,0,0,0,0,0,0,18000,0,0,0,28000,10000,18000,18000
058683,可成凱基9A購01  ,0,0,0,0,0,0,0,0,0,18000,0,0,0,88000,70000,18000,18000
4148,全宇生技-KY     ,29000,11000,18000,0,0,0,0,0,0,0,0,0,0,0,0,0,18000
07123P,鴻海元大99售23  ,0,0,0,0,0,0,0,0,0,18000,0,0,0,21000,3000,18000,18000
05101P,大立光凱基95售11,0,0,0,0,0,0,0,0,0,18000,0,0,0,20000,2000,18000,18000
051608,新日興群益96購01,0,0,0,0,0,0,0,0,0,18000,0,0,0,18000,0,18000,18000
056592,台積電元富98購01,0,0,0,0,0,0,0,0,0,18000,0,0,0,43000,25000,18000,18000
049726,道瓊反中信96購01,0,0,0,0,0,0,0,0,0,18000,0,0,0,18000,0,18000,18000
050547,華新科凱基95購01,0,0,0,0,0,0,0,0,0,18000,0,0,0,18000,0,18000,18000
052895,台積電群益96購04,0,0,0,0,0,0,0,0,0,18000,0,0,0,18000,0,18000,18000
04923P,GIS凱基94售06   ,0,0,0,0,0,0,0,0,0,18000,0,0,0,18000,0,18000,18000
04929P,同欣電凱基95售01,0,0,0,0,0,0,0,0,0,18000,0,0,0,28000,10000,18000,18000
052806,玉晶光元大98購04,0,0,0,0,0,0,0,0,0,18000,0,0,0,75000,57000,18000,18000
03094X,大立光元大68展08,0,0,0,0,0,0,0,0,0,18000,0,0,0,18000,0,18000,18000
055966,茂林元大99購01  ,0,0,0,0,0,0,0,0,0,18000,0,0,0,25000,7000,18000,18000
055979,聯鈞統一97購03  ,0,0,0,0,0,0,0,0,0,18000,0,0,0,18000,0,18000,18000
055481,聚陽元大97購01  ,0,0,0,0,0,0,0,0,0,18000,0,0,0,115000,97000,18000,18000
054667,神基元富97購01  ,0,0,0,0,0,0,0,0,0,18000,0,0,0,20000,2000,18000,18000
058167,鴻海凱基9A購03  ,0,0,0,0,0,0,0,0,0,18000,0,0,0,18000,0,18000,18000
058019,美律凱基99購04  ,0,0,0,0,0,0,0,0,0,18000,0,0,0,20000,2000,18000,18000
057902,嘉晶永豐98購02  ,0,220000,-220000,0,0,0,0,0,0,238000,0,0,0,253000,15000,238000,18000
056469,國巨元大99購01  ,0,0,0,0,0,0,0,0,0,18000,0,0,0,111000,93000,18000,18000
05561P,大立光兆豐96售02,0,0,0,0,0,0,0,0,0,18000,0,0,0,18000,0,18000,18000
056855,祥碩中信98購02  ,0,0,0,0,0,0,0,0,0,18000,0,0,0,20000,2000,18000,18000
054138,晶技元大98購02  ,0,0,0,0,0,0,0,0,0,18000,0,0,0,18000,0,18000,18000
057182,禾伸堂元大99購02,0,0,0,0,0,0,0,0,0,18000,0,0,0,20000,2000,18000,18000
05749P,臺股指群益99售03,0,0,0,0,0,0,0,0,0,18000,0,0,0,18000,0,18000,18000
054743,聯鈞凱基99購01  ,0,0,0,0,0,0,0,0,0,18000,0,0,0,28000,10000,18000,18000
053932,華新科統一96購03,0,0,0,0,0,0,0,0,0,18000,0,0,0,18000,0,18000,18000
07060P,台表科國票9A售01,0,0,0,0,0,0,0,0,0,17000,0,0,0,17000,0,17000,17000
1903,士紙            ,19000,2000,17000,0,0,0,0,0,0,0,0,0,0,0,0,0,17000
3588,通嘉            ,163000,146000,17000,0,0,0,0,0,0,0,0,0,0,0,0,0,17000
6139,亞翔            ,231000,190000,41000,0,0,0,0,0,0,-24000,0,24000,-24000,0,0,0,17000
2443,億麗            ,22000,5000,17000,0,0,0,0,0,0,0,0,0,0,0,0,0,17000
058850,華新科群益99購03,0,0,0,0,0,0,0,0,0,17000,0,0,0,17000,0,17000,17000
058932,FBVIX台新99購01 ,0,0,0,0,0,0,0,0,0,17000,0,0,0,17000,0,17000,17000
058990,GIS凱基99購02   ,0,0,0,0,0,0,0,0,0,17000,0,0,0,56000,39000,17000,17000
058978,SGBR2X凱基9A購03,0,0,0,0,0,0,0,0,0,17000,0,0,0,17000,0,17000,17000
059058,可成凱基9B購01  ,0,0,0,0,0,0,0,0,0,17000,0,0,0,17000,0,17000,17000
058651,FBVIX中信9C購01 ,0,0,0,0,0,0,0,0,0,17000,0,0,0,17000,0,17000,17000
059123,訊芯永豐99購03  ,0,0,0,0,0,0,0,0,0,17000,0,0,0,17000,0,17000,17000
04475P,欣興元大94售03  ,0,0,0,0,0,0,0,0,0,17000,0,0,0,17000,0,17000,17000
04730P,臺股指中信96售02,0,0,0,0,0,0,0,0,0,17000,0,0,0,17000,0,17000,17000
047046,台積電國票94購01,0,0,0,0,0,0,0,0,0,17000,0,0,0,17000,0,17000,17000
050515,聯電元大96購01  ,0,0,0,0,0,0,0,0,0,17000,0,0,0,90000,73000,17000,17000
050899,旭富元大95購01  ,0,0,0,0,0,0,0,0,0,17000,0,0,0,60000,43000,17000,17000
056719,台虹永豐98購01  ,0,0,0,0,0,0,0,0,0,17000,0,0,0,17000,0,17000,17000
05167P,百和元富95售03  ,0,0,0,0,0,0,0,0,0,17000,0,0,0,17000,0,17000,17000
050122,臺指反凱基96購01,0,0,0,0,0,0,0,0,0,17000,0,0,0,17000,0,17000,17000
05694P,台積電凱基96售09,0,0,0,0,0,0,0,0,0,17000,0,0,0,17000,0,17000,17000
057230,建準凱基98購02  ,0,0,0,0,0,0,0,0,0,17000,0,0,0,27000,10000,17000,17000
057466,泰鼎永豐98購01  ,0,0,0,0,0,0,0,0,0,17000,0,0,0,67000,50000,17000,17000
055333,晶豪科兆豐97購01,0,0,0,0,0,0,0,0,0,17000,0,0,0,17000,0,17000,17000
056427,上銀凱基98購03  ,0,0,0,0,0,0,0,0,0,17000,0,0,0,17000,0,17000,17000
056846,晶相光元富98購01,0,0,0,0,0,0,0,0,0,17000,0,0,0,20000,3000,17000,17000
053351,A50正2兆豐97購01,0,0,0,0,0,0,0,0,0,17000,0,0,0,17000,0,17000,17000
056023,晶豪科群益97購01,0,0,0,0,0,0,0,0,0,17000,0,0,0,17000,0,17000,17000
06665P,欣興兆豐99售01  ,0,0,0,0,0,0,0,0,0,16000,0,0,0,32000,16000,16000,16000
058274,世紀鋼永豐99購01,0,0,0,0,0,0,0,0,0,16000,0,0,0,19000,3000,16000,16000
059053,鴻海凱基99購07  ,0,0,0,0,0,0,0,0,0,16000,0,0,0,16000,0,16000,16000
050121,南電元大95購02  ,0,0,0,0,0,0,0,0,0,16000,0,0,0,16000,0,16000,16000
056528,為升凱基98購01  ,0,0,0,0,0,0,0,0,0,16000,0,0,0,16000,0,16000,16000
056344,嘉晶凱基98購02  ,0,0,0,0,0,0,0,0,0,16000,0,0,0,37000,21000,16000,16000
052521,友達元大9B購01  ,0,0,0,0,0,0,0,0,0,16000,0,0,0,16000,0,16000,16000
04854P,鴻海國泰96售04  ,0,0,0,0,0,0,0,0,0,16000,0,0,0,17000,1000,16000,16000
049254,台積電元大96購02,0,0,0,0,0,0,0,0,0,16000,0,0,0,434000,418000,16000,16000
04450P,京元電凱基94售01,0,0,0,0,0,0,0,0,0,16000,0,0,0,26000,10000,16000,16000
049129,S&P反1元大97購01,0,0,0,0,0,0,0,0,0,16000,0,0,0,16000,0,16000,16000
020011,統一微波高息20N ,0,0,0,0,0,0,0,0,0,16000,0,0,0,16000,0,16000,16000
055479,GIS凱基97購04   ,0,0,0,0,0,0,0,0,0,16000,0,0,0,16000,0,16000,16000
05548P,臺股指元大96售02,0,0,0,0,0,0,0,0,0,16000,0,0,0,16000,0,16000,16000
055007,晶相光元富9A購02,0,0,0,0,0,0,0,0,0,16000,0,0,0,17000,1000,16000,16000
057750,神達國票99購01  ,0,0,0,0,0,0,0,0,0,16000,0,0,0,16000,0,16000,16000
053502,智伸科兆豐97購01,0,0,0,0,0,0,0,0,0,16000,0,0,0,16000,0,16000,16000
4576,大銀微系統      ,31000,15100,15900,0,0,0,0,0,0,0,0,0,0,0,0,0,15900
2486,一詮            ,75000,59000,16000,0,0,0,0,0,0,-1000,0,1000,-1000,0,0,0,15000
1410,南染            ,21000,5000,16000,0,0,0,0,0,0,-1000,0,1000,-1000,0,0,0,15000
07004P,大立光兆豐9A售01,0,0,0,0,0,0,0,0,0,15000,0,0,0,15000,0,15000,15000
06977P,臺股指元大9A售15,0,0,0,0,0,0,0,0,0,15000,0,0,0,15000,0,15000,15000
059086,國巨元大99購18  ,0,0,0,0,0,0,0,0,0,15000,0,0,0,45000,30000,15000,15000
058958,台表科國票9A購03,0,0,0,0,0,0,0,0,0,15000,0,0,0,15000,0,15000,15000
058895,鴻海元大99購20  ,0,0,0,0,0,0,0,0,0,15000,0,0,0,147000,132000,15000,15000
058487,晶技國票9A購01  ,0,0,0,0,0,0,0,0,0,15000,0,0,0,17000,2000,15000,15000
058378,南電凱基99購01  ,0,0,0,0,0,0,0,0,0,15000,0,0,0,15000,0,15000,15000
06571P,欣興永豐98售03  ,0,0,0,0,0,0,0,0,0,15000,0,0,0,15000,0,15000,15000
06501P,臺股指元大9A售06,0,0,0,0,0,0,0,0,0,15000,0,0,0,20000,5000,15000,15000
06452P,大立光元大98售08,0,0,0,0,0,0,0,0,0,15000,0,0,0,15000,0,15000,15000
06240P,奇力新元富97售03,0,0,0,0,0,0,0,0,0,15000,0,0,0,15000,0,15000,15000
06129P,玉晶光元富97售06,0,0,0,0,0,0,0,0,0,15000,0,0,0,15000,0,15000,15000
06097P,茂林永豐97售01  ,0,0,0,0,0,0,0,0,0,15000,0,0,0,15000,0,15000,15000
06198P,台積電元大98售06,0,0,0,0,0,0,0,0,0,15000,0,0,0,15000,0,15000,15000
044249,T50反1中信94購01,0,0,0,0,0,0,0,0,0,15000,0,0,0,15000,0,15000,15000
042315,T50反1台新96購01,0,0,0,0,0,0,0,0,0,15000,0,0,0,43000,28000,15000,15000
04307P,國巨凱基93售09  ,0,0,0,0,0,0,0,0,0,15000,0,0,0,15000,0,15000,15000
049024,玉晶光群益97購01,0,0,0,0,0,0,0,0,0,15000,0,0,0,20000,5000,15000,15000
052805,晶技元大97購01  ,0,5000,-5000,0,0,0,0,0,0,20000,0,0,0,20000,0,20000,15000
051227,技嘉群益97購01  ,0,0,0,0,0,0,0,0,0,15000,0,0,0,30000,15000,15000,15000
051248,華固元大95購01  ,0,0,0,0,0,0,0,0,0,15000,0,0,0,65000,50000,15000,15000
048562,宏達電元大95購01,0,0,0,0,0,0,0,0,0,15000,0,0,0,20000,5000,15000,15000
04551P,台表科元大94售02,0,0,0,0,0,0,0,0,0,15000,0,0,0,45000,30000,15000,15000
052478,大立光群益95購05,0,0,0,0,0,0,0,0,0,15000,0,0,0,15000,0,15000,15000
052010,兆豐金中信95購01,0,0,0,0,0,0,0,0,0,15000,0,0,0,15000,0,15000,15000
050552,禾伸堂凱基94購05,0,0,0,0,0,0,0,0,0,15000,0,0,0,15000,0,15000,15000
050424,鴻海凱基96購03  ,0,0,0,0,0,0,0,0,0,15000,0,0,0,15000,0,15000,15000
056479,玉晶光元大99購05,0,0,0,0,0,0,0,0,0,15000,0,0,0,25000,10000,15000,15000
056482,貿聯元大99購01  ,0,0,0,0,0,0,0,0,0,15000,0,0,0,15000,0,15000,15000
05651P,大立光元大97售02,0,0,0,0,0,0,0,0,0,15000,0,0,0,15000,0,15000,15000
056739,美律凱基98購04  ,0,0,0,0,0,0,0,0,0,15000,0,0,0,45000,30000,15000,15000
053582,英業達元大97購01,0,0,0,0,0,0,0,0,0,15000,0,0,0,15000,0,15000,15000
057539,南茂元大98購02  ,0,0,0,0,0,0,0,0,0,15000,0,0,0,35000,20000,15000,15000
05304P,國巨國泰97售02  ,0,0,0,0,0,0,0,0,0,15000,0,0,0,15000,0,15000,15000
053792,百和元大96購01  ,0,0,0,0,0,0,0,0,0,15000,0,0,0,15000,0,15000,15000
057225,華新凱基98購01  ,0,0,0,0,0,0,0,0,0,15000,0,0,0,88000,73000,15000,15000
05480P,滬深2X凱基96售05,0,0,0,0,0,0,0,0,0,15000,0,0,0,15000,0,15000,15000
053489,上銀兆豐97購01  ,0,0,0,0,0,0,0,0,0,15000,0,0,0,35000,20000,15000,15000
054048,國泰金元大96購04,0,0,0,0,0,0,0,0,0,15000,0,0,0,20000,5000,15000,15000
05522P,友達元富96售02  ,0,0,0,0,0,0,0,0,0,15000,0,0,0,15000,0,15000,15000
055623,貿聯國泰99購01  ,0,0,0,0,0,0,0,0,0,15000,0,0,0,71000,56000,15000,15000
053215,禾伸堂凱基96購01,0,0,0,0,0,0,0,0,0,15000,0,0,0,15000,0,15000,15000
055067,禾聯碩永豐97購01,0,0,0,0,0,0,0,0,0,15000,0,0,0,15000,0,15000,15000
05549P,臺股指元大96售03,0,0,0,0,0,0,0,0,0,15000,0,0,0,45000,30000,15000,15000
057054,立積元大98購03  ,0,0,0,0,0,0,0,0,0,15000,0,0,0,15000,0,15000,15000
056297,台光電元大97購04,0,0,0,0,0,0,0,0,0,15000,0,0,0,65000,50000,15000,15000
056285,可成永豐97購02  ,0,0,0,0,0,0,0,0,0,15000,0,0,0,15000,0,15000,15000
06165P,臺股指凱基9A售03,0,0,0,0,0,0,0,0,0,14000,0,0,0,14000,0,14000,14000
06566P,華通永豐98售03  ,0,0,0,0,0,0,0,0,0,14000,0,0,0,65000,51000,14000,14000
058519,嘉澤元大99購01  ,0,0,0,0,0,0,0,0,0,14000,0,0,0,84000,70000,14000,14000
058573,鴻海群益9A購02  ,0,0,0,0,0,0,0,0,0,14000,0,0,0,14000,0,14000,14000
058948,道瓊銀群益9C購01,0,0,0,0,0,0,0,0,0,14000,0,0,0,108000,94000,14000,14000
06997P,台灣50中信03售01,0,0,0,0,0,0,0,0,0,14000,0,0,0,14000,0,14000,14000
06832P,玉晶光凱基98售03,0,0,0,0,0,0,0,0,0,14000,0,0,0,15000,1000,14000,14000
2465,麗臺            ,14000,0,14000,0,0,0,0,0,0,0,0,0,0,0,0,0,14000
4956,光鋐            ,51000,37000,14000,0,0,0,0,0,0,0,0,0,0,0,0,0,14000
049611,緯穎兆豐95購02  ,0,0,0,0,0,0,0,0,0,14000,0,0,0,26000,12000,14000,14000
052765,新日興群益97購01,0,0,0,0,0,0,0,0,0,14000,0,0,0,36000,22000,14000,14000
052891,台泥群益96購01  ,0,0,0,0,0,0,0,0,0,14000,0,0,0,15000,1000,14000,14000
048782,亞泥元大94購01  ,0,0,0,0,0,0,0,0,0,14000,0,0,0,14000,0,14000,14000
04222P,台積電統一93售08,0,0,0,0,0,0,0,0,0,14000,0,0,0,14000,0,14000,14000
057080,華新科統一99購02,0,0,0,0,0,0,0,0,0,14000,0,0,0,14000,0,14000,14000
05493P,華新科富邦99售02,0,0,0,0,0,0,0,0,0,14000,0,0,0,24000,10000,14000,14000
056428,台達電凱基99購01,0,0,0,0,0,0,0,0,0,14000,0,0,0,81000,67000,14000,14000
057450,國泰金元富98購01,0,0,0,0,0,0,0,0,0,14000,0,0,0,54000,40000,14000,14000
057388,奇鋐永豐98購02  ,0,0,0,0,0,0,0,0,0,14000,0,0,0,14000,0,14000,14000
054308,嘉晶凱基98購01  ,0,0,0,0,0,0,0,0,0,14000,0,0,0,29000,15000,14000,14000
05436P,台積電群益95售07,0,0,0,0,0,0,0,0,0,14000,0,0,0,441000,427000,14000,14000
053735,矽力中信97購01  ,0,0,0,0,0,0,0,0,0,14000,0,0,0,24000,10000,14000,14000
911868,同方友友-DR     ,14000,0,14000,0,0,0,0,0,0,0,0,0,0,0,0,0,14000
2239,英利-KY         ,28000,15000,13000,0,0,0,0,0,0,0,0,0,0,0,0,0,13000
06764P,聯發科元大98售11,0,0,0,0,0,0,0,0,0,13000,0,0,0,105000,92000,13000,13000
07087P,聯發科台新99售02,0,0,0,0,0,0,0,0,0,13000,0,0,0,13000,0,13000,13000
08609P,世紀鋼永豐9C售03,0,0,0,0,0,0,0,0,0,13000,0,0,0,13000,0,13000,13000
2033,佳大            ,13000,5000,8000,0,0,0,0,0,0,5000,5000,0,5000,0,0,0,13000
058974,臺股指永豐99購03,0,0,0,0,0,0,0,0,0,13000,0,0,0,13000,0,13000,13000
059009,世紀鋼元大99購04,0,0,0,0,0,0,0,0,0,13000,0,0,0,361000,348000,13000,13000
058608,華新科元大99購13,0,0,0,0,0,0,0,0,0,13000,0,0,0,56000,43000,13000,13000
06412P,南亞科日盛97售01,0,0,0,0,0,0,0,0,0,13000,0,0,0,13000,0,13000,13000
06174P,國巨元大97售07  ,0,0,0,0,0,0,0,0,0,13000,0,0,0,13000,0,13000,13000
05917P,宏達電元大96售02,0,0,0,0,0,0,0,0,0,13000,0,0,0,25000,12000,13000,13000
04482P,臺股指日盛94售01,0,0,0,0,0,0,0,0,0,13000,0,0,0,13000,0,13000,13000
03662C,FBVIX凱基03牛01 ,0,0,0,0,0,0,0,0,0,13000,0,0,0,14000,1000,13000,13000
050446,鴻海元大94購22  ,0,0,0,0,0,0,0,0,0,13000,0,0,0,13000,0,13000,13000
051272,嘉晶群益95購01  ,0,0,0,0,0,0,0,0,0,13000,0,0,0,23000,10000,13000,13000
05162P,玉晶光國票96售03,0,0,0,0,0,0,0,0,0,13000,0,0,0,337000,324000,13000,13000
051603,深中小群益99購03,0,0,0,0,0,0,0,0,0,13000,0,0,0,13000,0,13000,13000
049945,樺漢第一94購01  ,0,0,0,0,0,0,0,0,0,13000,0,0,0,13000,0,13000,13000
053542,超眾永豐96購01  ,0,0,0,0,0,0,0,0,0,13000,0,0,0,13000,0,13000,13000
055400,緯穎統一97購01  ,0,0,0,0,0,0,0,0,0,13000,0,0,0,13000,0,13000,13000
057281,大立光元大98購16,0,0,0,0,0,0,0,0,0,13000,0,0,0,73000,60000,13000,13000
057340,玉晶光元富98購04,0,0,0,0,0,0,0,0,0,13000,0,0,0,35000,22000,13000,13000
057279,國揚元大98購01  ,0,0,0,0,0,0,0,0,0,13000,0,0,0,30000,17000,13000,13000
055304,瑞昱第一98購01  ,0,0,0,0,0,0,0,0,0,13000,0,0,0,24000,11000,13000,13000
05618P,聯發科元富96售02,0,0,0,0,0,0,0,0,0,13000,0,0,0,13000,0,13000,13000
057871,國巨元大99購09  ,0,0,0,0,0,0,0,0,0,13000,0,0,0,13000,0,13000,13000
6533,晶心科          ,168000,149000,19000,0,0,0,0,0,0,-6000,0,6000,-6000,0,0,0,13000
06554P,臺股指元大99售06,0,0,0,0,0,0,0,0,0,12000,0,0,0,16000,4000,12000,12000
05862P,大立光國泰98售01,0,0,0,0,0,0,0,0,0,12000,0,0,0,12000,0,12000,12000
058312,大毅國泰9B購01  ,0,0,0,0,0,0,0,0,0,12000,0,0,0,30000,18000,12000,12000
058358,技嘉凱基9A購01  ,0,0,0,0,0,0,0,0,0,12000,0,0,0,12000,0,12000,12000
058986,華新科凱基9A購03,0,0,0,0,0,0,0,0,0,12000,0,0,0,12000,0,12000,12000
06950P,鴻海統一9B售02  ,0,0,0,0,0,0,0,0,0,12000,0,0,0,12000,0,12000,12000
2415,錩新            ,15000,8000,7000,0,0,0,0,0,0,5000,5000,0,5000,0,0,0,12000
4739,康普            ,286000,261000,25000,0,0,0,0,0,0,-13000,0,13000,-13000,0,0,0,12000
051660,緯穎國泰96購02  ,0,0,0,0,0,0,0,0,0,12000,0,0,0,12000,0,12000,12000
056677,智伸科元富98購01,0,0,0,0,0,0,0,0,0,12000,0,0,0,12000,0,12000,12000
051316,T50反1國票95購02,0,0,0,0,0,0,0,0,0,12000,0,0,0,12000,0,12000,12000
052309,健策國泰97購01  ,0,0,0,0,0,0,0,0,0,12000,0,0,0,12000,0,12000,12000
050745,茂林永豐94購06  ,0,0,0,0,0,0,0,0,0,12000,0,0,0,12000,0,12000,12000
050228,中磊中信96購01  ,0,0,0,0,0,0,0,0,0,12000,0,0,0,12000,0,12000,12000
03980P,群創凱基95售02  ,0,0,0,0,0,0,0,0,0,12000,0,0,0,12000,0,12000,12000
00691R,兆豐藍籌30反1   ,0,0,0,0,0,0,0,0,0,12000,0,0,0,66000,54000,12000,12000
04408P,台積電統一94售06,0,0,0,0,0,0,0,0,0,12000,0,0,0,22000,10000,12000,12000
04599P,南亞科凱基94售03,0,0,0,0,0,0,0,0,0,12000,0,0,0,12000,0,12000,12000
058046,國巨元大9A購01  ,0,0,0,0,0,0,0,0,0,12000,0,0,0,12000,0,12000,12000
058132,義隆元大99購03  ,0,0,0,0,0,0,0,0,0,12000,0,0,0,80000,68000,12000,12000
058232,聯發科元大99購05,0,0,0,0,0,0,0,0,0,12000,0,0,0,320000,308000,12000,12000
055584,國巨元大97購11  ,0,0,0,0,0,0,0,0,0,12000,0,0,0,12000,0,12000,12000
055597,禾伸堂元大98購02,0,0,0,0,0,0,0,0,0,12000,0,0,0,24000,12000,12000,12000
055669,緯穎群益97購02  ,0,0,0,0,0,0,0,0,0,12000,0,0,0,12000,0,12000,12000
053155,晶技元大97購02  ,0,0,0,0,0,0,0,0,0,12000,0,0,0,12000,0,12000,12000
054778,世紀鋼國票99購01,0,0,0,0,0,0,0,0,0,12000,0,0,0,39000,27000,12000,12000
053023,泰鼎國泰97購01  ,0,0,0,0,0,0,0,0,0,12000,0,0,0,12000,0,12000,12000
053812,台積電群益96購09,0,0,0,0,0,0,0,0,0,12000,0,0,0,12000,0,12000,12000
053877,奇力新亞東96購01,0,0,0,0,0,0,0,0,0,12000,0,0,0,12000,0,12000,12000
2340,光磊            ,774000,600000,174000,0,0,0,0,35000,-35000,-128000,25000,161000,-136000,16000,8000,8000,11000
2380,虹光            ,11000,0,11000,0,0,0,0,0,0,0,0,0,0,0,0,0,11000
2358,廷鑫            ,41000,30000,11000,0,0,0,0,0,0,0,0,0,0,0,0,0,11000
06833P,矽力群益99售01  ,0,0,0,0,0,0,0,0,0,11000,0,0,0,41000,30000,11000,11000
06810P,國巨統一99售03  ,0,0,0,0,0,0,0,0,0,11000,0,0,0,21000,10000,11000,11000
06888P,日月光元大98售02,0,0,0,0,0,0,0,0,0,11000,0,0,0,13000,2000,11000,11000
07104P,聯發科元富99售04,0,0,0,0,0,0,0,0,0,11000,0,0,0,29000,18000,11000,11000
07009P,臺股指中信9B售01,0,0,0,0,0,0,0,0,0,11000,0,0,0,11000,0,11000,11000
07048P,台積電中信03售01,0,0,0,0,0,0,0,0,0,11000,0,0,0,11000,0,11000,11000
1524,耿鼎            ,45000,35000,10000,0,0,0,0,0,0,1000,1000,0,1000,0,0,0,11000
08671P,友訊國票01售01  ,0,0,0,0,0,0,0,0,0,11000,0,0,0,11000,0,11000,11000
1432,大魯閣          ,30000,19000,11000,0,0,0,0,0,0,0,0,0,0,0,0,0,11000
058949,上銀群益99購02  ,0,0,0,0,0,0,0,0,0,11000,0,0,0,11000,0,11000,11000
05906P,國巨元富96售05  ,0,0,0,0,0,0,0,0,0,11000,0,0,0,31000,20000,11000,11000
058342,鴻海群益9A購01  ,0,0,0,0,0,0,0,0,0,11000,0,0,0,11000,0,11000,11000
058580,華新科群益99購02,0,0,0,0,0,0,0,0,0,11000,0,0,0,11000,0,11000,11000
058561,T50反1凱基9A購05,0,0,0,0,0,0,0,0,0,11000,0,0,0,11000,0,11000,11000
06537P,華通凱基98售04  ,0,0,0,0,0,0,0,0,0,11000,0,0,0,27000,16000,11000,11000
06597P,國巨富邦9A售05  ,0,0,0,0,0,0,0,0,0,11000,0,0,0,11000,0,11000,11000
06602P,國巨統一99售02  ,0,0,0,0,0,0,0,0,0,11000,0,0,0,11000,0,11000,11000
06513P,鴻海凱基98售10  ,0,0,0,0,0,0,0,0,0,11000,0,0,0,293000,282000,11000,11000
06382P,大毅元富97售02  ,0,0,0,0,0,0,0,0,0,11000,0,0,0,31000,20000,11000,11000
05934P,國巨凱基96售13  ,0,0,0,0,0,0,0,0,0,11000,0,0,0,31000,20000,11000,11000
05944P,富邦金中信96售01,0,0,0,0,0,0,0,0,0,11000,0,0,0,11000,0,11000,11000
06183P,大立光元大97售05,0,0,0,0,0,0,0,0,0,11000,0,0,0,16000,5000,11000,11000
06195P,台積電元富97售06,0,0,0,0,0,0,0,0,0,11000,0,0,0,21000,10000,11000,11000
047196,上銀統一97購01  ,0,0,0,0,0,0,0,0,0,11000,0,0,0,23000,12000,11000,11000
04337P,台積電元大93售25,0,0,0,0,0,0,0,0,0,11000,0,0,0,151000,140000,11000,11000
04177P,富邦金元大94售01,0,0,0,0,0,0,0,0,0,11000,0,0,0,11000,0,11000,11000
04519P,國泰金群益94售01,0,0,0,0,0,0,0,0,0,11000,0,0,0,11000,0,11000,11000
049610,奇力新兆豐95購01,0,0,0,0,0,0,0,0,0,11000,0,0,0,11000,0,11000,11000
05232P,緯穎群益95售01  ,0,0,0,0,0,0,0,0,0,11000,0,0,0,41000,30000,11000,11000
05272P,臻鼎中信97售03  ,0,0,0,0,0,0,0,0,0,11000,0,0,0,30000,19000,11000,11000
052053,泰鼎凱基96購01  ,0,0,0,0,0,0,0,0,0,11000,0,0,0,12000,1000,11000,11000
052058,臺股指凱基95購16,11000,0,11000,0,0,0,0,0,0,0,0,0,0,0,0,0,11000
052028,健策群益95購02  ,0,0,0,0,0,0,0,0,0,11000,0,0,0,11000,0,11000,11000
055339,緯穎兆豐98購01  ,0,0,0,0,0,0,0,0,0,11000,0,0,0,19000,8000,11000,11000
057409,台虹群益98購02  ,0,0,0,0,0,0,0,0,0,11000,0,0,0,11000,0,11000,11000
053151,華新科元大96購04,0,0,0,0,0,0,0,0,0,11000,0,0,0,31000,20000,11000,11000
05582P,群創凱基98售06  ,0,0,0,0,0,0,0,0,0,11000,0,0,0,12000,1000,11000,11000
055954,南港元大97購02  ,0,0,0,0,0,0,0,0,0,11000,0,0,0,12000,1000,11000,11000
05590P,臺股指中信96售05,0,0,0,0,0,0,0,0,0,11000,0,0,0,11000,0,11000,11000
054925,神達凱基97購01  ,0,0,0,0,0,0,0,0,0,11000,0,0,0,67000,56000,11000,11000
055017,緯穎元富97購01  ,0,0,0,0,0,0,0,0,0,11000,0,0,0,11000,0,11000,11000
057704,台虹群益98購03  ,0,0,0,0,0,0,0,0,0,11000,0,0,0,11000,0,11000,11000
058206,祥碩凱基99購01  ,0,0,0,0,0,0,0,0,0,11000,0,0,0,122000,111000,11000,11000
058081,技嘉群益9A購03  ,0,0,0,0,0,0,0,0,0,11000,0,0,0,11000,0,11000,11000
057877,神達元大99購01  ,0,0,0,0,0,0,0,0,0,11000,0,0,0,36000,25000,11000,11000
6409,旭隼            ,335000,315958,19042,0,0,0,0,0,0,-9000,0,9000,-9000,0,0,0,10042
06181P,國巨中信97售02  ,0,0,0,0,0,0,0,0,0,10000,0,0,0,10000,0,10000,10000
06169P,華新科元富97售02,0,0,0,0,0,0,0,0,0,10000,0,0,0,10000,0,10000,10000
06151P,華新科元大97售07,0,0,0,0,0,0,0,0,0,10000,0,0,0,10000,0,10000,10000
06091P,華新科統一97售01,0,0,0,0,0,0,0,0,0,10000,0,0,0,10000,0,10000,10000
06130P,玉晶光元富97售07,0,0,0,0,0,0,0,0,0,10000,0,0,0,10000,0,10000,10000
05974P,國巨富邦97售03  ,0,0,0,0,0,0,0,0,0,10000,0,0,0,10000,0,10000,10000
05943P,欣興凱基96售03  ,0,0,0,0,0,0,0,0,0,10000,0,0,0,10000,0,10000,10000
059223,大立光元大99購14,0,0,0,0,0,0,0,0,0,10000,0,0,0,10000,0,10000,10000
05924P,超眾元富96售04  ,0,0,0,0,0,0,0,0,0,10000,0,0,0,20000,10000,10000,10000
06371P,茂林國票98售04  ,0,0,0,0,0,0,0,0,0,10000,0,0,0,10000,0,10000,10000
06386P,欣興永豐97售03  ,0,0,0,0,0,0,0,0,0,10000,0,0,0,10000,0,10000,10000
06336P,鴻海元大98售05  ,0,0,0,0,0,0,0,0,0,10000,0,0,0,20000,10000,10000,10000
06339P,上銀統一97售06  ,0,0,0,0,0,0,0,0,0,10000,0,0,0,10000,0,10000,10000
06263P,燿華凱基97售04  ,0,0,0,0,0,0,0,0,0,10000,0,0,0,10000,0,10000,10000
06416P,大立光群益97售06,0,0,0,0,0,0,0,0,0,10000,0,0,0,10000,0,10000,10000
06469P,臺股指凱基99售09,0,0,0,0,0,0,0,0,0,10000,0,0,0,10000,0,10000,10000
06629P,台灣50第一98售01,0,0,0,0,0,0,0,0,0,10000,0,0,0,10000,0,10000,10000
06647P,台積電元大98售13,0,0,0,0,0,0,0,0,0,10000,0,0,0,10000,0,10000,10000
06667P,鴻海凱基98售11  ,0,0,0,0,0,0,0,0,0,10000,0,0,0,58000,48000,10000,10000
06702P,智邦元富98售01  ,0,0,0,0,0,0,0,0,0,10000,0,0,0,10000,0,10000,10000
06685P,鴻海國泰9A售01  ,0,0,0,0,0,0,0,0,0,10000,0,0,0,261000,251000,10000,10000
06688P,鴻海中信02售01  ,0,0,0,0,0,0,0,0,0,10000,0,0,0,13000,3000,10000,10000
06752P,訊芯凱基98售05  ,0,0,0,0,0,0,0,0,0,10000,0,0,0,10000,0,10000,10000
058585,S&P正2中信9B購02,0,0,0,0,0,0,0,0,0,10000,0,0,0,10000,0,10000,10000
058628,宏達電國票9A購01,0,0,0,0,0,0,0,0,0,10000,0,0,0,10000,0,10000,10000
058629,嘉晶國票9A購01  ,0,0,0,0,0,0,0,0,0,10000,0,0,0,10000,0,10000,10000
058613,茂林元大99購03  ,0,0,0,0,0,0,0,0,0,10000,0,0,0,10000,0,10000,10000
058644,元黃金富邦03購01,0,0,0,0,0,0,0,0,0,10000,0,0,0,10000,0,10000,10000
05863P,滬深2X元大96售09,0,0,0,0,0,0,0,0,0,10000,0,0,0,20000,10000,10000,10000
058649,健策永豐99購01  ,0,0,0,0,0,0,0,0,0,10000,0,0,0,10000,0,10000,10000
058699,楠梓電元大99購02,0,0,0,0,0,0,0,0,0,10000,0,0,0,10000,0,10000,10000
058674,宏達電群益99購01,0,0,0,0,0,0,0,0,0,10000,0,0,0,10000,0,10000,10000
058365,奇力新凱基9A購01,0,0,0,0,0,0,0,0,0,10000,0,0,0,10000,0,10000,10000
058367,大立光凱基9A購01,0,0,0,0,0,0,0,0,0,10000,0,0,0,10000,0,10000,10000
058319,大毅永豐9A購01  ,0,0,0,0,0,0,0,0,0,10000,0,0,0,10000,0,10000,10000
059066,道瓊指國票04購01,0,0,0,0,0,0,0,0,0,10000,0,0,0,10000,0,10000,10000
059085,鴻海元大99購25  ,0,0,0,0,0,0,0,0,0,10000,0,0,0,10000,0,10000,10000
059083,華通元大99購07  ,0,0,0,0,0,0,0,0,0,10000,0,0,0,10000,0,10000,10000
059095,訊芯元大99購01  ,0,0,0,0,0,0,0,0,0,10000,0,0,0,10000,0,10000,10000
059022,聯發科統一9B購04,0,0,0,0,0,0,0,0,0,10000,0,0,0,10000,0,10000,10000
059008,鈺齊元大99購03  ,0,0,0,0,0,0,0,0,0,10000,0,0,0,10000,0,10000,10000
058998,鴻海元大99購22  ,0,0,0,0,0,0,0,0,0,10000,0,0,0,10000,0,10000,10000
058996,台達電元大99購02,0,0,0,0,0,0,0,0,0,10000,0,0,0,15000,5000,10000,10000
05899P,臺股指凱基96售30,0,0,0,0,0,0,0,0,0,10000,0,0,0,10000,0,10000,10000
058906,晶相光元大99購01,0,0,0,0,0,0,0,0,0,10000,0,0,0,10000,0,10000,10000
05887P,友達元富99售03  ,0,0,0,0,0,0,0,0,0,10000,0,0,0,10000,0,10000,10000
058894,元油2X元大9C購11,0,0,0,0,0,0,0,0,0,10000,0,0,0,10000,0,10000,10000
058702,國巨元大99購16  ,0,0,0,0,0,0,0,0,0,10000,0,0,0,10000,0,10000,10000
058764,康友群益99購01  ,0,0,0,0,0,0,0,0,0,10000,0,0,0,10000,0,10000,10000
058796,可成元大99購04  ,0,0,0,0,0,0,0,0,0,10000,0,0,0,10000,0,10000,10000
08679P,台灣50元大01售15,10000,0,10000,0,0,0,0,0,0,0,0,0,0,0,0,0,10000
08751P,友達群益01售01  ,0,0,0,0,0,0,0,0,0,10000,0,0,0,10000,0,10000,10000
1617,榮星            ,10000,0,10000,0,0,0,0,0,0,0,0,0,0,0,0,0,10000
2028,威致            ,20000,10000,10000,0,0,0,0,0,0,0,0,0,0,0,0,0,10000
2002A,中鋼特          ,0,0,0,0,0,0,0,0,0,10000,10000,0,10000,0,0,0,10000
07029P,緯穎群益99售02  ,0,0,0,0,0,0,0,0,0,10000,0,0,0,20000,10000,10000,10000
07021P,台積電富邦9C售02,0,0,0,0,0,0,0,0,0,10000,0,0,0,10000,0,10000,10000
07078P,鴻海群益99售02  ,0,0,0,0,0,0,0,0,0,10000,0,0,0,20000,10000,10000,10000
06827P,臺股指國票98售03,0,0,0,0,0,0,0,0,0,10000,0,0,0,10000,0,10000,10000
06841P,臺股指統一9A售02,0,0,0,0,0,0,0,0,0,10000,0,0,0,10000,0,10000,10000
06847P,奇力新元大98售05,0,0,0,0,0,0,0,0,0,10000,0,0,0,26000,16000,10000,10000
06984P,上銀富邦9B售01  ,0,0,0,0,0,0,0,0,0,10000,0,0,0,10000,0,10000,10000
06959P,鴻海凱基9A售02  ,0,0,0,0,0,0,0,0,0,10000,0,0,0,10000,0,10000,10000
2910,統領            ,14000,4000,10000,0,0,0,0,0,0,0,0,0,0,0,0,0,10000
2881B,富邦金乙特      ,0,0,0,0,0,0,0,0,0,10000,10000,0,10000,0,0,0,10000
2887F,台新戊特二      ,0,0,0,0,0,0,0,0,0,10000,10000,0,10000,0,0,0,10000
052005,矽力國泰97購02  ,0,0,0,0,0,0,0,0,0,10000,0,0,0,10000,0,10000,10000
051973,華新科凱基96購04,0,0,0,0,0,0,0,0,0,10000,0,0,0,10000,0,10000,10000
05207P,高股息中信97售03,0,0,0,0,0,0,0,0,0,10000,0,0,0,10000,0,10000,10000
052076,可成元富98購01  ,0,0,0,0,0,0,0,0,0,10000,0,0,0,10000,0,10000,10000
049434,茂林國票95購01  ,0,0,0,0,0,0,0,0,0,10000,0,0,0,10000,0,10000,10000
051317,亞德客國票96購01,0,0,0,0,0,0,0,0,0,10000,0,0,0,10000,0,10000,10000
051278,臻鼎中信97購02  ,0,0,0,0,0,0,0,0,0,10000,0,0,0,10000,0,10000,10000
052378,矽力元大96購01  ,0,0,0,0,0,0,0,0,0,10000,0,0,0,13000,3000,10000,10000
052491,泰碩國票99購01  ,0,0,0,0,0,0,0,0,0,10000,0,0,0,10000,0,10000,10000
052421,元油反國票9B購01,0,0,0,0,0,0,0,0,0,10000,0,0,0,10000,0,10000,10000
05242P,群創國泰97售01  ,0,0,0,0,0,0,0,0,0,10000,0,0,0,10000,0,10000,10000
052452,茂林元大95購03  ,0,0,0,0,0,0,0,0,0,10000,0,0,0,10000,0,10000,10000
052453,崇越元大95購01  ,0,0,0,0,0,0,0,0,0,10000,0,0,0,10000,0,10000,10000
052736,T50反1元大96購05,0,0,0,0,0,0,0,0,0,10000,0,0,0,10000,0,10000,10000
052695,台表科中信98購01,0,0,0,0,0,0,0,0,0,10000,0,0,0,10000,0,10000,10000
052604,建準元大97購01  ,0,0,0,0,0,0,0,0,0,10000,0,0,0,10000,0,10000,10000
052544,牧德元富95購01  ,0,0,0,0,0,0,0,0,0,10000,0,0,0,10000,0,10000,10000
04966P,台表科元大94售04,0,0,0,0,0,0,0,0,0,10000,0,0,0,10000,0,10000,10000
049714,國巨凱基94購02  ,0,0,0,0,0,0,0,0,0,10000,0,0,0,10000,0,10000,10000
049705,緯穎元大94購05  ,0,0,0,0,0,0,0,0,0,10000,0,0,0,10000,0,10000,10000
051476,聯發科凱基95購09,0,0,0,0,0,0,0,0,0,10000,0,0,0,10000,0,10000,10000
051463,世芯國泰97購02  ,0,0,0,0,0,0,0,0,0,10000,0,0,0,10000,0,10000,10000
050312,大立光兆豐94購04,0,0,0,0,0,0,0,0,0,10000,0,0,0,10000,0,10000,10000
051490,世芯凱基96購01  ,0,0,0,0,0,0,0,0,0,10000,0,0,0,10000,0,10000,10000
051489,世芯凱基95購01  ,0,0,0,0,0,0,0,0,0,10000,0,0,0,10000,0,10000,10000
05158P,華通永豐95售01  ,0,0,0,0,0,0,0,0,0,10000,0,0,0,10000,0,10000,10000
051562,玉晶光國泰97購05,0,0,0,0,0,0,0,0,0,10000,0,0,0,50000,40000,10000,10000
050652,大立光凱基96購03,0,0,0,0,0,0,0,0,0,10000,0,0,0,10000,0,10000,10000
050685,緯穎元富94購02  ,0,0,0,0,0,0,0,0,0,10000,0,0,0,10000,0,10000,10000
050894,旺宏元大96購03  ,0,0,0,0,0,0,0,0,0,10000,0,0,0,10000,0,10000,10000
050817,可成凱基95購01  ,0,0,0,0,0,0,0,0,0,10000,0,0,0,10000,0,10000,10000
050429,漢唐凱基94購04  ,0,0,0,0,0,0,0,0,0,10000,0,0,0,10000,0,10000,10000
050571,美食中信95購01  ,0,0,0,0,0,0,0,0,0,10000,0,0,0,10000,0,10000,10000
050609,鴻海元大94購23  ,0,0,0,0,0,0,0,0,0,10000,0,0,0,10000,0,10000,10000
05054P,臻鼎群益95售02  ,0,0,0,0,0,0,0,0,0,10000,0,0,0,10000,0,10000,10000
056686,可成統一98購01  ,0,0,0,0,0,0,0,0,0,10000,0,0,0,10000,0,10000,10000
056697,緯穎群益98購01  ,0,0,0,0,0,0,0,0,0,10000,0,0,0,10000,0,10000,10000
056649,智易凱基98購01  ,0,0,0,0,0,0,0,0,0,10000,0,0,0,10000,0,10000,10000
056808,台積電統一98購06,0,0,0,0,0,0,0,0,0,10000,0,0,0,10000,0,10000,10000
056755,聯茂兆豐98購01  ,0,0,0,0,0,0,0,0,0,10000,0,0,0,10000,0,10000,10000
056765,友達元大9B購05  ,0,0,0,0,0,0,0,0,0,10000,0,0,0,70000,60000,10000,10000
056524,欣興中信98購02  ,0,0,0,0,0,0,0,0,0,10000,0,0,0,30000,20000,10000,10000
056557,世紀鋼凱基98購02,0,0,0,0,0,0,0,0,0,10000,0,0,0,20000,10000,10000,10000
05655P,南亞科統一96售01,0,0,0,0,0,0,0,0,0,10000,0,0,0,10000,0,10000,10000
056487,康友元大98購01  ,0,0,0,0,0,0,0,0,0,10000,0,0,0,40000,30000,10000,10000
056478,晶技元大99購01  ,0,0,0,0,0,0,0,0,0,10000,0,0,0,10000,0,10000,10000
056340,可成凱基98購04  ,0,0,0,0,0,0,0,0,0,10000,0,0,0,20000,10000,10000,10000
056331,聯鈞國票99購01  ,0,0,0,0,0,0,0,0,0,10000,0,0,0,10000,0,10000,10000
052247,深中小永豐95購01,0,0,0,0,0,0,0,0,0,10000,0,0,0,30000,20000,10000,10000
051013,旺宏凱基95購03  ,0,0,0,0,0,0,0,0,0,10000,0,0,0,10000,0,10000,10000
051047,深中小群益99購01,0,0,0,0,0,0,0,0,0,10000,0,0,0,10000,0,10000,10000
04996P,台積電凱基95售02,0,0,0,0,0,0,0,0,0,10000,0,0,0,10000,0,10000,10000
049955,崇越群益95購01  ,0,0,0,0,0,0,0,0,0,10000,0,0,0,10000,0,10000,10000
051833,昇陽半元大96購01,0,0,0,0,0,0,0,0,0,10000,0,0,0,10000,0,10000,10000
052191,超眾群益96購01  ,0,0,0,0,0,0,0,0,0,10000,0,0,0,10000,0,10000,10000
052134,智邦凱基95購09  ,0,0,0,0,0,0,0,0,0,10000,0,0,0,20000,10000,10000,10000
052084,台泥元大95購01  ,0,0,0,0,0,0,0,0,0,10000,0,0,0,11000,1000,10000,10000
05187P,力山凱基95售01  ,0,0,0,0,0,0,0,0,0,10000,0,0,0,10000,0,10000,10000
044964,旺宏中信94購01  ,0,0,0,0,0,0,0,0,0,10000,0,0,0,10000,0,10000,10000
04507P,台光電元大94售03,0,0,0,0,0,0,0,0,0,10000,0,0,0,10000,0,10000,10000
045101,玉晶光中信94購01,0,0,0,0,0,0,0,0,0,10000,0,0,0,10000,0,10000,10000
048757,美利達元富96購01,0,0,0,0,0,0,0,0,0,10000,0,0,0,10000,0,10000,10000
048986,訊連元大94購01  ,0,0,0,0,0,0,0,0,0,10000,0,0,0,10000,0,10000,10000
048987,崇越元大94購01  ,0,0,0,0,0,0,0,0,0,10000,0,0,0,10000,0,10000,10000
04169P,鴻海凱基93售34  ,0,0,0,0,0,0,0,0,0,10000,0,0,0,10000,0,10000,10000
04144P,瑞昱凱基93售10  ,0,0,0,0,0,0,0,0,0,10000,0,0,0,10000,0,10000,10000
03993P,滬深2X中信94售03,0,0,0,0,0,0,0,0,0,10000,0,0,0,10000,0,10000,10000
03935P,可成富邦95售01  ,0,0,0,0,0,0,0,0,0,10000,0,0,0,10000,0,10000,10000
048648,祥碩元大93購03  ,0,0,0,0,0,0,0,0,0,10000,0,0,0,20000,10000,10000,10000
04342P,揚明光永豐93售03,0,0,0,0,0,0,0,0,0,10000,0,0,0,10000,0,10000,10000
044439,南電元大93購01  ,0,0,0,0,0,0,0,0,0,10000,0,0,0,10000,0,10000,10000
044362,元油2X中信94購01,0,0,0,0,0,0,0,0,0,10000,0,0,0,10000,0,10000,10000
03154P,華新科群益01售07,0,0,0,0,0,0,0,0,0,10000,0,0,0,10000,0,10000,10000
03314P,台積電元大02售16,0,0,0,0,0,0,0,0,0,10000,0,0,0,10000,0,10000,10000
03430B,臺股指元大9B熊01,0,0,0,0,0,0,0,0,0,10000,0,0,0,75000,65000,10000,10000
047184,漢唐元大94購02  ,0,0,0,0,0,0,0,0,0,10000,0,0,0,10000,0,10000,10000
047219,美律麥證94購01  ,0,0,0,10000,0,10000,0,0,0,10000,0,0,0,10000,0,10000,10000
04534P,臻鼎元富94售03  ,0,0,0,0,0,0,0,0,0,10000,0,0,0,10000,0,10000,10000
04536P,長榮航統一94售01,0,0,0,0,0,0,0,0,0,10000,0,0,0,10000,0,10000,10000
045443,群創元富98購01  ,0,0,0,0,0,0,0,0,0,10000,0,0,0,10000,0,10000,10000
04563P,可成凱基94售05  ,0,0,0,0,0,0,0,0,0,10000,0,0,0,10000,0,10000,10000
047014,元油反元大99購01,0,0,0,0,0,0,0,0,0,10000,0,0,0,10000,0,10000,10000
048568,緯穎元大93購06  ,0,0,0,0,0,0,0,0,0,10000,0,0,0,10000,0,10000,10000
04851P,創意永豐94售02  ,0,0,0,0,0,0,0,0,0,10000,0,0,0,10000,0,10000,10000
048288,T50反1群益93購05,0,0,0,0,0,0,0,0,0,10000,0,0,0,10000,0,10000,10000
049212,T50反1國票94購04,0,0,0,0,0,0,0,0,0,10000,0,0,0,10000,0,10000,10000
047470,聯發科中信94購03,0,0,0,0,0,0,0,0,0,10000,0,0,0,10000,0,10000,10000
048012,嘉晶國票94購01  ,0,0,0,0,0,0,0,0,0,10000,0,0,0,20000,10000,10000,10000
048145,大立光統一93購10,0,0,0,0,0,0,0,0,0,10000,0,0,0,10000,0,10000,10000
047969,台達電富邦97購01,0,0,0,0,0,0,0,0,0,10000,0,0,0,30000,20000,10000,10000
047832,漢唐元大94購03  ,0,0,0,0,0,0,0,0,0,10000,0,0,0,10000,0,10000,10000
045996,南電富邦94購01  ,0,0,0,0,0,0,0,0,0,10000,0,0,0,10000,0,10000,10000
04570P,台積電國票94售05,0,0,0,0,0,0,0,0,0,10000,0,0,0,10000,0,10000,10000
04586P,光罩永豐94售02  ,0,0,0,0,0,0,0,0,0,10000,0,0,0,10000,0,10000,10000
04633P,旺宏群益96售04  ,0,0,0,0,0,0,0,0,0,10000,0,0,0,10000,0,10000,10000
046241,聯發科中信94購02,0,0,0,0,0,0,0,0,0,10000,0,0,0,10000,0,10000,10000
04655P,臺股指凱基94售14,0,0,0,0,0,0,0,0,0,10000,0,0,0,10000,0,10000,10000
052746,泰碩元大97購01  ,0,0,0,0,0,0,0,0,0,10000,0,0,0,10000,0,10000,10000
051055,友達群益98購01  ,0,0,0,0,0,0,0,0,0,10000,0,0,0,10000,0,10000,10000
046703,瑞昱元富95購01  ,0,0,0,0,0,0,0,0,0,10000,0,0,0,10000,0,10000,10000
052916,華新科富邦96購01,0,0,0,0,0,0,0,0,0,10000,0,0,0,10000,0,10000,10000
052866,大立光凱基96購12,0,0,0,0,0,0,0,0,0,10000,0,0,0,10000,0,10000,10000
052958,T50反1凱基99購02,0,0,0,0,0,0,0,0,0,10000,0,0,0,10000,0,10000,10000
052799,上銀元大96購01  ,0,0,0,0,0,0,0,0,0,10000,0,0,0,10000,0,10000,10000
052822,泰碩永豐97購01  ,0,0,0,0,0,0,0,0,0,10000,0,0,0,10000,0,10000,10000
049274,臺股指元大94購09,0,0,0,0,0,0,0,0,0,10000,0,0,0,10000,0,10000,10000
057896,嘉晶元富98購01  ,0,0,0,0,0,0,0,0,0,10000,0,0,0,10000,0,10000,10000
057833,聯發科元富02購06,0,0,0,0,0,0,0,0,0,10000,0,0,0,10000,0,10000,10000
057825,和碩元大98購02  ,0,0,0,0,0,0,0,0,0,10000,0,0,0,20000,10000,10000,10000
058026,上銀富邦9A購01  ,0,0,0,0,0,0,0,0,0,10000,0,0,0,10000,0,10000,10000
057993,中環中信98購01  ,0,0,0,0,0,0,0,0,0,10000,0,0,0,10000,0,10000,10000
057983,緯穎永豐98購03  ,0,0,0,0,0,0,0,0,0,10000,0,0,0,10000,0,10000,10000
057963,緯穎元大98購08  ,0,0,0,0,0,0,0,0,0,10000,0,0,0,10000,0,10000,10000
058218,緯穎群益99購01  ,0,0,0,0,0,0,0,0,0,10000,0,0,0,10000,0,10000,10000
058239,景碩元大99購03  ,0,0,0,0,0,0,0,0,0,10000,0,0,0,10000,0,10000,10000
058240,景碩元大99購04  ,0,0,0,0,0,0,0,0,0,10000,0,0,0,10000,0,10000,10000
058241,景碩元大99購05  ,0,0,0,0,0,0,0,0,0,10000,0,0,0,10000,0,10000,10000
058249,緯穎元大99購04  ,0,0,0,0,0,0,0,0,0,10000,0,0,0,10000,0,10000,10000
058148,百和元大99購01  ,0,0,0,0,0,0,0,0,0,10000,0,0,0,10000,0,10000,10000
058149,百和元大99購02  ,0,0,0,0,0,0,0,0,0,10000,0,0,0,10000,0,10000,10000
058156,超眾統一9A購02  ,0,0,0,0,0,0,0,0,0,10000,0,0,0,10000,0,10000,10000
058093,神達元大9A購01  ,0,0,0,0,0,0,0,0,0,10000,0,0,0,24000,14000,10000,10000
058095,昇陽半元大98購03,0,0,0,0,0,0,0,0,0,10000,0,0,0,10000,0,10000,10000
057728,瑞昱國泰99購01  ,0,0,0,0,0,0,0,0,0,10000,0,0,0,10000,0,10000,10000
057695,S&P反1群益9B購01,0,0,0,0,0,0,0,0,0,10000,0,0,0,10000,0,10000,10000
057776,京元電群益98購02,0,0,0,0,0,0,0,0,0,10000,0,0,0,10000,0,10000,10000
057778,大立光群益98購02,0,0,0,0,0,0,0,0,0,10000,0,0,0,10000,0,10000,10000
055644,致茂元富97購01  ,0,0,0,0,0,0,0,0,0,10000,0,0,0,10000,0,10000,10000
057670,欣興元大99購02  ,0,0,0,0,0,0,0,0,0,10000,0,0,0,10000,0,10000,10000
053370,上証2X元大97購03,0,0,0,0,0,0,0,0,0,10000,0,0,0,10000,0,10000,10000
053279,景碩元大97購01  ,0,0,0,0,0,0,0,0,0,10000,0,0,0,20000,10000,10000,10000
053307,泰碩凱基97購01  ,0,0,0,0,0,0,0,0,0,10000,0,0,0,10000,0,10000,10000
053344,嘉晶國票97購02  ,0,0,0,0,0,0,0,0,0,10000,0,0,0,20000,10000,10000,10000
054413,台光電元大96購03,0,0,0,0,0,0,0,0,0,10000,0,0,0,30000,20000,10000,10000
054478,可成中信97購01  ,0,0,0,0,0,0,0,0,0,10000,0,0,0,10000,0,10000,10000
05557P,S&P500中信96售02,0,0,0,0,0,0,0,0,0,10000,0,0,0,10000,0,10000,10000
054448,矽力兆豐96購01  ,0,0,0,0,0,0,0,0,0,10000,0,0,0,10000,0,10000,10000
055074,台虹永豐97購01  ,0,0,0,0,0,0,0,0,0,10000,0,0,0,10000,0,10000,10000
055075,南電永豐97購01  ,0,0,0,0,0,0,0,0,0,10000,0,0,0,10000,0,10000,10000
055078,亞泥中信98購01  ,0,0,0,0,0,0,0,0,0,10000,0,0,0,10000,0,10000,10000
054557,臻鼎凱基98購01  ,0,0,0,0,0,0,0,0,0,10000,0,0,0,10000,0,10000,10000
054559,台光電群益99購01,0,0,0,0,0,0,0,0,0,10000,0,0,0,10000,0,10000,10000
054941,凱美元大97購01  ,0,0,0,0,0,0,0,0,0,10000,0,0,0,10000,0,10000,10000
054934,金寶元大97購01  ,0,0,0,0,0,0,0,0,0,10000,0,0,0,10000,0,10000,10000
054969,亞翔元大97購01  ,0,0,0,0,0,0,0,0,0,10000,0,0,0,10000,0,10000,10000
054902,億光康和97購01  ,0,0,0,0,0,0,0,0,0,10000,0,0,0,10000,0,10000,10000
054898,台肥康和97購01  ,0,0,0,0,0,0,0,0,0,10000,0,0,0,10000,0,10000,10000
055483,和大元大97購03  ,0,0,0,0,0,0,0,0,0,10000,0,0,0,10000,0,10000,10000
055551,致茂凱基98購01  ,0,0,0,0,0,0,0,0,0,10000,0,0,0,10000,0,10000,10000
055556,奇力新凱基98購03,0,0,0,0,0,0,0,0,0,10000,0,0,0,10000,0,10000,10000
057033,A50反1元大9B購02,0,0,0,0,0,0,0,0,0,10000,0,0,0,10000,0,10000,10000
057022,智邦凱基98購04  ,0,0,0,0,0,0,0,0,0,10000,0,0,0,10000,0,10000,10000
055924,深中小群益9B購01,0,0,0,0,0,0,0,0,0,10000,0,0,0,10000,0,10000,10000
055961,國泰金元大97購01,0,0,0,0,0,0,0,0,0,10000,0,0,0,10000,0,10000,10000
055962,晶豪科元大97購02,0,0,0,0,0,0,0,0,0,10000,0,0,0,10000,0,10000,10000
05597P,鴻海元富96售06  ,0,0,0,0,0,0,0,0,0,10000,0,0,0,10000,0,10000,10000
055985,聯鈞元富97購01  ,0,0,0,0,0,0,0,0,0,10000,0,0,0,10000,0,10000,10000
056015,華通群益99購01  ,0,0,0,0,0,0,0,0,0,10000,0,0,0,90000,80000,10000,10000
055888,鴻海統一97購04  ,0,0,0,0,0,0,0,0,0,10000,0,0,0,10000,0,10000,10000
05589P,大立光中信9A售01,0,0,0,0,0,0,0,0,0,10000,0,0,0,56000,46000,10000,10000
05707P,中磊永豐96售01  ,0,0,0,0,0,0,0,0,0,10000,0,0,0,10000,0,10000,10000
053149,京元電元大96購02,0,0,0,0,0,0,0,0,0,10000,0,0,0,10000,0,10000,10000
056273,祥碩統一97購02  ,0,0,0,0,0,0,0,0,0,10000,0,0,0,10000,0,10000,10000
056450,可成凱基98購05  ,0,0,0,0,0,0,0,0,0,10000,0,0,0,10000,0,10000,10000
056451,可成凱基99購01  ,0,0,0,0,0,0,0,0,0,10000,0,0,0,10000,0,10000,10000
056246,祥碩群益97購01  ,0,0,0,0,0,0,0,0,0,10000,0,0,0,10000,0,10000,10000
056248,康友群益97購04  ,0,0,0,0,0,0,0,0,0,10000,0,0,0,10000,0,10000,10000
057406,茂林群益98購03  ,0,0,0,0,0,0,0,0,0,10000,0,0,0,21000,11000,10000,10000
057451,大立光元富9B購01,0,0,0,0,0,0,0,0,0,10000,0,0,0,10000,0,10000,10000
057283,欣興元大98購07  ,0,0,0,0,0,0,0,0,0,10000,0,0,0,50000,40000,10000,10000
057284,新日興元大98購03,0,0,0,0,0,0,0,0,0,10000,0,0,0,10000,0,10000,10000
057364,國巨元大98購18  ,0,0,0,0,0,0,0,0,0,10000,0,0,0,10000,0,10000,10000
057329,緯穎群益98購02  ,0,0,0,0,0,0,0,0,0,10000,0,0,0,10000,0,10000,10000
057379,寶成元大98購02  ,0,0,0,0,0,0,0,0,0,10000,0,0,0,20000,10000,10000,10000
055288,日電貿元大97購02,0,0,0,0,0,0,0,0,0,10000,0,0,0,10000,0,10000,10000
05526P,茂林群益96售03  ,0,0,0,0,0,0,0,0,0,10000,0,0,0,10000,0,10000,10000
056405,聯茂群益98購01  ,0,0,0,0,0,0,0,0,0,10000,0,0,0,11000,1000,10000,10000
056415,聯發科中信98購04,0,0,0,0,0,0,0,0,0,10000,0,0,0,20000,10000,10000,10000
054215,創意國票97購02  ,0,0,0,0,0,0,0,0,0,10000,0,0,0,10000,0,10000,10000
054146,康友元大96購06  ,0,0,0,0,0,0,0,0,0,10000,0,0,0,10000,0,10000,10000
054152,漢唐國泰98購02  ,0,0,0,0,0,0,0,0,0,10000,0,0,0,50000,40000,10000,10000
05717P,鴻海元大97售07  ,0,0,0,0,0,0,0,0,0,10000,0,0,0,10000,0,10000,10000
057178,可成元大98購03  ,0,0,0,0,0,0,0,0,0,10000,0,0,0,40000,30000,10000,10000
057175,美律元大98購03  ,0,0,0,0,0,0,0,0,0,10000,0,0,0,90000,80000,10000,10000
055200,和大群益98購01  ,0,0,0,0,0,0,0,0,0,10000,0,0,0,10000,0,10000,10000
055158,亞光元大99購01  ,0,0,0,0,0,0,0,0,0,10000,0,0,0,10000,0,10000,10000
055159,玉晶光元大98購05,0,0,0,0,0,0,0,0,0,10000,0,0,0,40000,30000,10000,10000
053997,健策群益97購02  ,0,0,0,0,0,0,0,0,0,10000,0,0,0,10000,0,10000,10000
053813,友達群益9A購03  ,0,0,0,0,0,0,0,0,0,10000,0,0,0,10000,0,10000,10000
053758,華新科國泰97購02,0,0,0,0,0,0,0,0,0,10000,0,0,0,10000,0,10000,10000
05369P,可成元富95售04  ,0,0,0,0,0,0,0,0,0,10000,0,0,0,10000,0,10000,10000
053066,欣興群益96購02  ,0,0,0,0,0,0,0,0,0,10000,0,0,0,10000,0,10000,10000
057533,晶相光元大98購02,0,0,0,0,0,0,0,0,0,10000,0,0,0,10000,0,10000,10000
053019,禾伸堂元富96購01,0,0,0,0,0,0,0,0,0,10000,0,0,0,10000,0,10000,10000
053533,光罩永豐96購03  ,0,0,0,0,0,0,0,0,0,10000,0,0,0,10000,0,10000,10000
053628,微星兆豐96購01  ,0,0,0,0,0,0,0,0,0,10000,0,0,0,10000,0,10000,10000
054825,康友元大97購01  ,0,0,0,0,0,0,0,0,0,10000,0,0,0,10000,0,10000,10000
054822,祥碩元大97購01  ,0,0,0,0,0,0,0,0,0,10000,0,0,0,51000,41000,10000,10000
054690,新興永豐97購01  ,0,0,0,0,0,0,0,0,0,10000,0,0,0,10000,0,10000,10000
057234,宏達電凱基98購05,0,0,0,0,0,0,0,0,0,10000,0,0,0,95000,85000,10000,10000
055432,臻鼎群益97購02  ,0,0,0,0,0,0,0,0,0,10000,0,0,0,10000,0,10000,10000
055403,泰鼎元富97購01  ,0,0,0,0,0,0,0,0,0,10000,0,0,0,10000,0,10000,10000
055430,宏達電群益97購01,0,0,0,0,0,0,0,0,0,10000,0,0,0,10000,0,10000,10000
054301,楠梓電凱基98購01,0,0,0,0,0,0,0,0,0,10000,0,0,0,10000,0,10000,10000
053480,祥碩元大96購02  ,0,0,0,0,0,0,0,0,0,10000,0,0,0,42000,32000,10000,10000
2838A,聯邦銀甲特      ,0,7000,-7000,0,0,0,0,0,0,16000,16000,0,16000,0,0,0,9000
4581,光隆精密-KY     ,9000,0,9000,0,0,0,0,0,0,0,0,0,0,0,0,0,9000
3701,大眾控          ,12000,3000,9000,0,0,0,0,0,0,0,0,0,0,0,0,0,9000
06949P,台表科元大99售01,0,0,0,0,0,0,0,0,0,9000,0,0,0,9000,0,9000,9000
06835P,台灣50國票9A售01,0,0,0,0,0,0,0,0,0,9000,0,0,0,9000,0,9000,9000
07122P,欣興凱基99售05  ,0,0,0,0,0,0,0,0,0,9000,0,0,0,71000,62000,9000,9000
1459,聯發            ,23000,14000,9000,0,0,0,0,0,0,0,0,0,0,0,0,0,9000
058627,聯發科國票99購04,0,0,0,0,0,0,0,0,0,9000,0,0,0,10000,1000,9000,9000
058586,鴻海中信01購02  ,0,0,0,0,0,0,0,0,0,9000,0,0,0,34000,25000,9000,9000
06723P,台灣50麥證99售01,0,0,0,10000,1000,9000,0,0,0,9000,0,0,0,10000,1000,9000,9000
06624P,訊芯元大98售06  ,0,0,0,0,0,0,0,0,0,9000,0,0,0,10000,1000,9000,9000
06234P,亞德客元大97售02,0,0,0,0,0,0,0,0,0,9000,0,0,0,49000,40000,9000,9000
05993P,國巨元大96售13  ,0,0,0,0,0,0,0,0,0,9000,0,0,0,9000,0,9000,9000
06166P,大立光國票98售01,0,0,0,0,0,0,0,0,0,9000,0,0,0,10000,1000,9000,9000
04747P,臺股指元大94售22,0,0,0,0,0,0,0,0,0,9000,0,0,0,9000,0,9000,9000
047395,聯茂元大94購01  ,0,0,0,0,0,0,0,0,0,9000,0,0,0,9000,0,9000,9000
04838P,宏達電元大95售02,0,0,0,0,0,0,0,0,0,9000,0,0,0,10000,1000,9000,9000
044927,聯詠國泰94購01  ,0,0,0,0,0,0,0,0,0,9000,0,0,0,9000,0,9000,9000
056352,鴻海元大99購01  ,0,0,0,0,0,0,0,0,0,9000,0,0,0,20000,11000,9000,9000
05660P,玉晶光第一96售01,0,0,0,0,0,0,0,0,0,9000,0,0,0,9000,0,9000,9000
056555,矽創凱基98購01  ,0,0,0,0,0,0,0,0,0,9000,0,0,0,10000,1000,9000,9000
050807,群臺反凱基95購01,0,0,0,0,0,0,0,0,0,9000,0,0,0,9000,0,9000,9000
049602,南電元大95購01  ,0,0,0,0,0,0,0,0,0,9000,0,0,0,9000,0,9000,9000
04945P,鴻海永豐94售06  ,0,0,0,0,0,0,0,0,0,9000,0,0,0,79000,70000,9000,9000
057210,T50反1群益98購01,0,0,0,0,0,0,0,0,0,9000,0,0,0,30000,21000,9000,9000
054001,康友群益96購02  ,0,0,0,0,0,0,0,0,0,9000,0,0,0,9000,0,9000,9000
056992,祥碩兆豐98購01  ,0,0,0,0,0,0,0,0,0,9000,0,0,0,9000,0,9000,9000
055163,訊芯元大98購01  ,0,0,0,0,0,0,0,0,0,9000,0,0,0,10000,1000,9000,9000
054130,漢唐元大97購02  ,0,0,0,0,0,0,0,0,0,9000,0,0,0,94000,85000,9000,9000
056420,台表科元富98購01,0,0,0,0,0,0,0,0,0,9000,0,0,0,9000,0,9000,9000
055283,聯發科元大97購16,0,0,0,0,0,0,0,0,0,9000,0,0,0,10000,1000,9000,9000
057473,T50反1元大98購08,0,0,0,0,0,0,0,0,0,9000,0,0,0,10000,1000,9000,9000
055494,華新科元大98購01,0,0,0,0,0,0,0,0,0,9000,0,0,0,9000,0,9000,9000
053205,台光電麥證96購01,0,0,0,29000,20000,9000,0,0,0,9000,0,0,0,29000,20000,9000,9000
058246,帆宣元大99購01  ,0,0,0,0,0,0,0,0,0,9000,0,0,0,9000,0,9000,9000
6573,虹揚-KY         ,17000,8000,9000,0,0,0,0,0,0,0,0,0,0,0,0,0,9000
8463,潤泰材          ,103000,94000,9000,0,0,0,0,0,0,0,0,0,0,0,0,0,9000
8341,日友            ,148000,141000,7000,0,0,0,15000,0,15000,-13000,0,13000,-13000,0,0,0,9000
8454,富邦媒          ,142050,104000,38050,0,0,0,1000,0,1000,-31000,1000,32000,-31000,0,0,0,8050
06162P,大立光群益97售02,0,0,0,0,0,0,0,0,0,8000,0,0,0,10000,2000,8000,8000
06142P,台虹康和97售02  ,0,0,0,0,0,0,0,0,0,8000,0,0,0,10000,2000,8000,8000
06536P,臺股指群益98售04,0,0,0,0,0,0,0,0,0,8000,0,0,0,8000,0,8000,8000
05850P,台積電兆豐96售06,0,0,0,0,0,0,0,0,0,8000,0,0,0,8000,0,8000,8000
2024,志聯            ,20000,12000,8000,0,0,0,0,0,0,0,0,0,0,0,0,0,8000
07159P,台積電永豐99售04,0,0,0,0,0,0,0,0,0,8000,0,0,0,29000,21000,8000,8000
052621,台郡富邦97購01  ,0,0,0,0,0,0,0,0,0,8000,0,0,0,23000,15000,8000,8000
04963P,鴻海元大94售25  ,0,0,0,0,0,0,0,0,0,8000,0,0,0,25000,17000,8000,8000
050366,鴻海元大94購19  ,0,0,0,0,0,0,0,0,0,8000,0,0,0,8000,0,8000,8000
05631P,國巨富邦9A售01  ,0,0,0,0,0,0,0,0,0,8000,0,0,0,8000,0,8000,8000
051848,元金2X中信98購02,0,0,0,0,0,0,0,0,0,8000,0,0,0,8000,0,8000,8000
052203,T50反1中信99購03,0,0,0,0,0,0,0,0,0,8000,0,0,0,8000,0,8000,8000
042792,T50反1台新9C購01,0,0,0,0,0,0,0,0,0,8000,0,0,0,8000,0,8000,8000
01004T,土銀富邦R2      ,8000,0,8000,0,0,0,0,0,0,0,0,0,0,0,0,0,8000
048331,臺指反富邦97購01,0,0,0,0,0,0,0,0,0,8000,0,0,0,8000,0,8000,8000
053278,禾伸堂元大96購01,0,0,0,0,0,0,0,0,0,8000,0,0,0,43000,35000,8000,8000
053372,元油反元大98購01,0,0,0,0,0,0,0,0,0,8000,0,0,0,15000,7000,8000,8000
057769,T50反1群益98購02,0,0,0,0,0,0,0,0,0,8000,0,0,0,8000,0,8000,8000
057020,台積電凱基99購02,0,0,0,0,0,0,0,0,0,8000,0,0,0,8000,0,8000,8000
057410,南電群益98購01  ,0,0,0,0,0,0,0,0,0,8000,0,0,0,10000,2000,8000,8000
057373,大立光元大98購17,0,0,0,0,0,0,0,0,0,8000,0,0,0,20000,12000,8000,8000
055280,智邦元大97購01  ,0,0,0,0,0,0,0,0,0,8000,0,0,0,53000,45000,8000,8000
053523,T50反1中信9A購01,0,0,0,0,0,0,0,0,0,8000,0,0,0,8000,0,8000,8000
053686,台積電元大97購08,0,0,0,0,0,0,0,0,0,8000,0,0,0,13000,5000,8000,8000
910861,神州-DR         ,8000,0,8000,0,0,0,0,0,0,0,0,0,0,0,0,0,8000
8480,泰昇-KY         ,13000,5000,8000,0,0,0,0,0,0,0,0,0,0,0,0,0,8000
6491,晶碩            ,27000,20000,7000,0,0,0,0,0,0,1000,1000,0,1000,0,0,0,8000
07149P,健鼎元大99售03  ,0,0,0,0,0,0,0,0,0,7000,0,0,0,7000,0,7000,7000
06964P,臺股指凱基9B售01,0,0,0,0,0,0,0,0,0,7000,0,0,0,7000,0,7000,7000
06954P,大立光元富99售01,0,0,0,0,0,0,0,0,0,7000,0,0,0,20000,13000,7000,7000
2712,遠雄來          ,7000,0,7000,0,0,0,0,0,0,0,0,0,0,0,0,0,7000
06660P,大立光富邦9B售03,0,0,0,0,0,0,0,0,0,7000,0,0,0,29000,22000,7000,7000
06123P,玉晶光元大97售04,0,0,0,0,0,0,0,0,0,7000,0,0,0,10000,3000,7000,7000
06196P,元上證元大97售01,0,0,0,0,0,0,0,0,0,7000,0,0,0,7000,0,7000,7000
06207P,聯發科凱基97售07,0,0,0,0,0,0,0,0,0,7000,0,0,0,7000,0,7000,7000
05984P,台積電統一98售01,0,0,0,0,0,0,0,0,0,7000,0,0,0,7000,0,7000,7000
048221,鴻海凱基95購01  ,0,0,0,0,0,0,0,0,0,7000,0,0,0,7000,0,7000,7000
047145,鴻海群益95購01  ,0,0,0,0,0,0,0,0,0,7000,0,0,0,10000,3000,7000,7000
04919P,聯詠凱基94售05  ,0,0,0,0,0,0,0,0,0,7000,0,0,0,7000,0,7000,7000
047623,世紀鋼凱基94購02,0,0,0,0,0,0,0,0,0,7000,0,0,0,7000,0,7000,7000
04802P,國巨凱基94售07  ,0,0,0,0,0,0,0,0,0,7000,0,0,0,8000,1000,7000,7000
03422B,臺股指凱基96熊28,0,0,0,0,0,0,0,0,0,7000,0,0,0,20000,13000,7000,7000
04464P,可成元富94售04  ,0,0,0,0,0,0,0,0,0,7000,0,0,0,7000,0,7000,7000
03567P,可成凱基02售06  ,0,0,0,0,0,0,0,0,0,7000,0,0,0,7000,0,7000,7000
03576P,台灣50元富06售01,0,0,0,0,0,0,0,0,0,7000,0,0,0,7000,0,7000,7000
052133,華邦電凱基9B購01,0,0,0,0,0,0,0,0,0,7000,0,0,0,7000,0,7000,7000
05015P,臺股指元大95售06,0,5000,-5000,0,0,0,0,0,0,12000,0,0,0,12000,0,12000,7000
056488,致新元大99購01  ,0,0,0,0,0,0,0,0,0,7000,0,0,0,7000,0,7000,7000
056560,旺宏群益98購03  ,0,0,0,0,0,0,0,0,0,7000,0,0,0,7000,0,7000,7000
050853,南電國票96購01  ,0,0,0,0,0,0,0,0,0,7000,0,0,0,8000,1000,7000,7000
050710,元黃金中信96購01,0,0,0,0,0,0,0,0,0,7000,0,0,0,25000,18000,7000,7000
05141P,華通台新96售01  ,0,0,0,0,0,0,0,0,0,7000,0,0,0,7000,0,7000,7000
053746,彰銀康和96購01  ,0,0,0,0,0,0,0,0,0,7000,0,0,0,21000,14000,7000,7000
053612,T50反1群益96購01,0,0,0,0,0,0,0,0,0,7000,0,0,0,7000,0,7000,7000
053441,旺宏凱基98購01  ,0,0,0,0,0,0,0,0,0,7000,0,0,0,7000,0,7000,7000
055323,貿聯國票98購01  ,0,0,0,0,0,0,0,0,0,7000,0,0,0,13000,6000,7000,7000
054170,泰鼎凱基98購01  ,0,0,0,0,0,0,0,0,0,7000,0,0,0,7000,0,7000,7000
055359,超眾凱基97購01  ,0,0,0,0,0,0,0,0,0,7000,0,0,0,167000,160000,7000,7000
057493,聯詠元大98購02  ,0,0,0,0,0,0,0,0,0,7000,0,0,0,51000,44000,7000,7000
05691P,聯發科中信98售01,0,0,0,0,0,0,0,0,0,7000,0,0,0,20000,13000,7000,7000
057148,玉晶光國票99購04,0,0,0,0,0,0,0,0,0,7000,0,0,0,7000,0,7000,7000
054899,南港康和97購01  ,0,0,0,0,0,0,0,0,0,7000,0,0,0,50000,43000,7000,7000
056292,統一元大97購01  ,0,0,0,0,0,0,0,0,0,7000,0,0,0,157000,150000,7000,7000
05780P,台積電統一96售07,0,0,0,0,0,0,0,0,0,7000,0,0,0,77000,70000,7000,7000
05437P,聯詠永豐95售02  ,0,0,0,0,0,0,0,0,0,7000,0,0,0,7000,0,7000,7000
06066P,群創台新98售01  ,0,0,0,0,0,0,0,0,0,6000,0,0,0,6000,0,6000,6000
06035P,同欣電凱基96售03,0,0,0,0,0,0,0,0,0,6000,0,0,0,6000,0,6000,6000
06078P,臺股指凱基9A售01,0,0,0,0,0,0,0,0,0,6000,0,0,0,6000,0,6000,6000
05920P,力成元大96售04  ,0,0,0,0,0,0,0,0,0,6000,0,0,0,27000,21000,6000,6000
059196,聯發科永豐99購02,0,0,0,0,0,0,0,0,0,6000,0,0,0,447000,441000,6000,6000
06673P,大立光群益98售01,0,0,0,0,0,0,0,0,0,6000,0,0,0,6000,0,6000,6000
06721P,臺股指中信9A售03,0,0,0,0,0,0,0,0,0,6000,0,0,0,6000,0,6000,6000
06603P,立積統一99售01  ,0,0,0,0,0,0,0,0,0,6000,0,0,0,6000,0,6000,6000
06261P,上銀凱基97售03  ,0,0,0,0,0,0,0,0,0,6000,0,0,0,11000,5000,6000,6000
06392P,T50反1元大9A售01,0,0,0,0,0,0,0,0,0,6000,0,0,0,10000,4000,6000,6000
06383P,聯茂元富97售01  ,0,0,0,0,0,0,0,0,0,6000,0,0,0,10000,4000,6000,6000
058682,聯發科凱基99購07,0,0,0,0,0,0,0,0,0,6000,0,0,0,6000,0,6000,6000
058311,緯穎元大99購05  ,0,0,0,0,0,0,0,0,0,6000,0,0,0,47000,41000,6000,6000
058270,上緯控永豐99購01,0,0,0,0,0,0,0,0,0,6000,0,0,0,6000,0,6000,6000
058284,滬深反群益01購01,0,0,0,0,0,0,0,0,0,6000,0,0,0,6000,0,6000,6000
058484,元金2X國票04購01,0,0,0,0,0,0,0,0,0,6000,0,0,0,6000,0,6000,6000
058450,旺宏永豐99購01  ,0,0,0,0,0,0,0,0,0,6000,0,0,0,6000,0,6000,6000
058720,旭富元富99購01  ,0,0,0,0,0,0,0,0,0,6000,0,0,0,6000,0,6000,6000
058710,臺股指元大9A購23,0,0,0,0,0,0,0,0,0,6000,0,0,0,6000,0,6000,6000
059034,華通群益9B購02  ,0,0,0,0,0,0,0,0,0,6000,0,0,0,6000,0,6000,6000
2543,皇昌            ,16000,10000,6000,0,0,0,0,0,0,0,0,0,0,0,0,0,6000
3011,今皓            ,8000,2000,6000,0,0,0,0,0,0,0,0,0,0,0,0,0,6000
2440,太空梭          ,8000,2000,6000,0,0,0,0,0,0,0,0,0,0,0,0,0,6000
06943P,致茂元富98售03  ,0,0,0,0,0,0,0,0,0,6000,0,0,0,6000,0,6000,6000
06902P,聯電凱基98售02  ,0,0,0,0,0,0,0,0,0,6000,0,0,0,6000,0,6000,6000
06917P,聯電亞東99售01  ,0,0,0,0,0,0,0,0,0,6000,0,0,0,6000,0,6000,6000
06878P,台灣50日盛9B售01,0,0,0,0,0,0,0,0,0,6000,0,0,0,6000,0,6000,6000
07121P,華新科凱基99售03,0,0,0,0,0,0,0,0,0,6000,0,0,0,17000,11000,6000,6000
07118P,台積電凱基99售09,0,0,0,0,0,0,0,0,0,6000,0,0,0,475000,469000,6000,6000
07073P,臺股指中信9B售02,0,0,0,0,0,0,0,0,0,6000,0,0,0,6000,0,6000,6000
1526,日馳            ,108000,102000,6000,0,0,0,0,0,0,0,0,0,0,0,0,0,6000
1506,正道            ,11000,5000,6000,0,0,0,0,0,0,0,0,0,0,0,0,0,6000
08795P,聯發科凱基01售11,0,0,0,0,0,0,0,0,0,6000,0,0,0,6000,0,6000,6000
08966P,臺指反元大04售07,0,0,0,0,0,0,0,0,0,6000,0,0,0,6000,0,6000,6000
049630,臺股指群益94購03,0,0,0,0,0,0,0,0,0,6000,0,0,0,6000,0,6000,6000
05041P,大立光凱基95售09,0,0,0,0,0,0,0,0,0,6000,0,0,0,6000,0,6000,6000
04951P,緯創中信94售01  ,0,0,0,0,0,0,0,0,0,6000,0,0,0,8000,2000,6000,6000
051383,京鼎群益96購02  ,0,0,0,0,0,0,0,0,0,6000,0,0,0,6000,0,6000,6000
056593,台積電元富98購02,0,0,0,0,0,0,0,0,0,6000,0,0,0,40000,34000,6000,6000
056548,瀚宇博凱基98購02,0,0,0,0,0,0,0,0,0,6000,0,0,0,6000,0,6000,6000
05661P,聯發科統一96售06,0,0,0,0,0,0,0,0,0,6000,0,0,0,6000,0,6000,6000
056722,滬深反中信9B購01,0,0,0,0,0,0,0,0,0,6000,0,0,0,31000,25000,6000,6000
050069,禾伸堂凱基94購04,0,0,0,0,0,0,0,0,0,6000,0,0,0,6000,0,6000,6000
04994P,大成鋼凱基95售01,0,0,0,0,0,0,0,0,0,6000,0,0,0,6000,0,6000,6000
03765P,大立光元富96售01,0,0,0,0,0,0,0,0,0,6000,0,0,0,6000,0,6000,6000
04133P,友達群益93售01  ,0,0,0,0,0,0,0,0,0,6000,0,0,0,6000,0,6000,6000
04139P,大立光國票93售03,0,0,0,0,0,0,0,0,0,6000,0,0,0,6000,0,6000,6000
03064P,台灣50群益01售14,0,0,0,0,0,0,0,0,0,6000,0,0,0,83000,77000,6000,6000
03064X,元展59          ,0,0,0,0,0,0,0,0,0,6000,0,0,0,6000,0,6000,6000
04392P,牧德凱基94售05  ,0,0,0,0,0,0,0,0,0,6000,0,0,0,6000,0,6000,6000
04393P,牧德凱基94售06  ,0,0,0,0,0,0,0,0,0,6000,0,0,0,6000,0,6000,6000
00851,台新全球AI      ,0,0,0,0,0,0,0,0,0,6000,0,0,0,18000,12000,6000,6000
00703,台新MSCI中國    ,0,1000,-1000,0,0,0,0,0,0,7000,0,0,0,58000,51000,7000,6000
048541,緯穎台新93購01  ,0,0,0,0,0,0,0,0,0,6000,0,0,0,6000,0,6000,6000
049233,聯發科統一94購04,0,0,0,0,0,0,0,0,0,6000,0,0,0,6000,0,6000,6000
052911,友達統一97購02  ,0,0,0,0,0,0,0,0,0,6000,0,0,0,6000,0,6000,6000
051126,訊連群益95購01  ,0,0,0,0,0,0,0,0,0,6000,0,0,0,6000,0,6000,6000
04640P,上銀凱基94售05  ,0,0,0,0,0,0,0,0,0,6000,0,0,0,6000,0,6000,6000
046492,旺宏富邦94購02  ,0,0,0,0,0,0,0,0,0,6000,0,0,0,6000,0,6000,6000
058176,聯發科凱基99購05,0,0,0,0,0,0,0,0,0,6000,0,0,0,6000,0,6000,6000
058032,大立光永豐98購05,0,0,0,0,0,0,0,0,0,6000,0,0,0,6000,0,6000,6000
057091,華新科元富9A購01,0,0,0,0,0,0,0,0,0,6000,0,0,0,6000,0,6000,6000
055545,國巨凱基97購06  ,0,0,0,0,0,0,0,0,0,6000,0,0,0,28000,22000,6000,6000
057558,致新凱基98購01  ,0,0,0,0,0,0,0,0,0,6000,0,0,0,6000,0,6000,6000
055760,新日興群益98購02,0,0,0,0,0,0,0,0,0,6000,0,0,0,6000,0,6000,6000
05516P,台積電元大96售12,0,0,0,0,0,0,0,0,0,6000,0,0,0,6000,0,6000,6000
057490,可成元大98購10  ,0,0,0,0,0,0,0,0,0,6000,0,0,0,86000,80000,6000,6000
057529,嘉晶元大99購02  ,0,0,0,0,0,0,0,0,0,6000,0,0,0,25000,19000,6000,6000
054239,台郡群益96購02  ,0,0,0,0,0,0,0,0,0,6000,0,0,0,6000,0,6000,6000
053460,緯穎國泰97購01  ,0,0,0,0,0,0,0,0,0,6000,0,0,0,6000,0,6000,6000
05471P,聯電統一95售01  ,0,0,0,0,0,0,0,0,0,6000,0,0,0,6000,0,6000,6000
054794,貿聯群益98購01  ,0,0,0,0,0,0,0,0,0,6000,0,0,0,6000,0,6000,6000
052997,國巨康和96購01  ,0,0,0,0,0,0,0,0,0,6000,0,0,0,6000,0,6000,6000
1312A,國喬特          ,0,0,0,0,0,0,0,0,0,5000,12000,7000,5000,0,0,0,5000
1413,宏洲            ,6000,1000,5000,0,0,0,0,0,0,0,0,0,0,0,0,0,5000
1616,億泰            ,12000,7000,5000,0,0,0,0,0,0,0,0,0,0,0,0,0,5000
07043P,國巨元大99售14  ,0,0,0,0,0,0,0,0,0,5000,0,0,0,146000,141000,5000,5000
07051P,大立光中信99售02,0,0,0,0,0,0,0,0,0,5000,0,0,0,5000,0,5000,5000
07146P,瑞昱元大99售02  ,0,0,0,0,0,0,0,0,0,5000,0,0,0,10000,5000,5000,5000
06860P,台灣50兆豐98售01,0,0,0,0,0,0,0,0,0,5000,0,0,0,40000,35000,5000,5000
06791P,聯發科凱基98售16,0,0,0,0,0,0,0,0,0,5000,0,0,0,7000,2000,5000,5000
06986P,台積電台新9A售01,0,0,0,0,0,0,0,0,0,5000,0,0,0,115000,110000,5000,5000
06998P,S&P正2中信9B售01,0,0,0,0,0,0,0,0,0,5000,0,0,0,5000,0,5000,5000
3356,奇偶            ,129000,124000,5000,0,0,0,0,0,0,0,0,0,0,0,0,0,5000
5285,界霖            ,72000,66000,6000,0,0,0,0,0,0,-1000,0,1000,-1000,0,0,0,5000
059077,FBVIX元大99購05 ,0,0,0,0,0,0,0,0,0,5000,0,0,0,5000,0,5000,5000
058486,大立光國票9A購01,0,0,0,0,0,0,0,0,0,5000,0,0,0,5000,0,5000,5000
058404,貿聯元大99購02  ,0,0,0,0,0,0,0,0,0,5000,0,0,0,10000,5000,5000,5000
058355,旺宏凱基99購04  ,0,0,0,0,0,0,0,0,0,5000,0,0,0,5000,0,5000,5000
06387P,緯穎永豐97售02  ,0,0,0,0,0,0,0,0,0,5000,0,0,0,10000,5000,5000,5000
06241P,大立光元富9A售01,0,0,0,0,0,0,0,0,0,5000,0,0,0,5000,0,5000,5000
06244P,智易元富97售02  ,0,0,0,0,0,0,0,0,0,5000,0,0,0,5000,0,5000,5000
06430P,大立光元大97售16,0,0,0,0,0,0,0,0,0,5000,0,0,0,5000,0,5000,5000
06504P,麗豐國票99售02  ,0,0,0,0,0,0,0,0,0,5000,0,0,0,5000,0,5000,5000
06488P,台積電元富98售05,0,0,0,0,0,0,0,0,0,5000,0,0,0,5000,0,5000,5000
06645P,上銀元大98售05  ,0,0,0,0,0,0,0,0,0,5000,0,0,0,5000,0,5000,5000
06651P,華新科元大99售09,0,0,0,0,0,0,0,0,0,5000,0,0,0,116000,111000,5000,5000
06564P,國巨富邦9A售04  ,0,0,0,0,0,0,0,0,0,5000,0,0,0,5000,0,5000,5000
06733P,鴻海凱基99售02  ,0,0,0,0,0,0,0,0,0,5000,0,0,0,95000,90000,5000,5000
05919P,京鼎元大96售03  ,0,0,0,0,0,0,0,0,0,5000,0,0,0,5000,0,5000,5000
05964P,華通凱基96售06  ,0,0,0,0,0,0,0,0,0,5000,0,0,0,5000,0,5000,5000
06203P,奇力新中信98售02,0,0,0,0,0,0,0,0,0,5000,0,0,0,5000,0,5000,5000
06064P,台積電台新98售01,0,0,0,0,0,0,0,0,0,5000,0,0,0,505000,500000,5000,5000
04588P,茂林永豐94售04  ,0,0,0,0,0,0,0,0,0,5000,0,0,0,5000,0,5000,5000
045768,大立光元富95購02,0,0,0,0,0,0,0,0,0,5000,0,0,0,5000,0,5000,5000
051086,鴻海元大96購04  ,0,0,0,0,0,0,0,0,0,5000,0,0,0,5000,0,5000,5000
051160,亞德客元大95購02,0,0,0,0,0,0,0,0,0,5000,0,0,0,5000,0,5000,5000
04930P,國巨統一94售08  ,0,0,0,0,0,0,0,0,0,5000,0,0,0,5000,0,5000,5000
049367,全新元大96購01  ,0,0,0,0,0,0,0,0,0,5000,0,0,0,5000,0,5000,5000
05296P,牧德凱基96售01  ,0,0,0,0,0,0,0,0,0,5000,0,0,0,96000,91000,5000,5000
052950,超眾國票98購01  ,0,0,0,0,0,0,0,0,0,5000,0,0,0,5000,0,5000,5000
048273,南電富邦97購01  ,0,0,0,0,0,0,0,0,0,5000,0,0,0,20000,15000,5000,5000
047127,臻鼎中信95購01  ,0,0,0,0,0,0,0,0,0,5000,0,0,0,5000,0,5000,5000
04724P,可成凱基94售08  ,0,0,0,0,0,0,0,0,0,5000,0,0,0,15000,10000,5000,5000
04769P,高股息元大94售01,0,0,0,0,0,0,0,0,0,5000,0,0,0,5000,0,5000,5000
047608,聯發科第一95購01,0,0,0,0,0,0,0,0,0,5000,0,0,0,5000,0,5000,5000
04743P,台積電元富94售07,0,0,0,0,0,0,0,0,0,5000,0,0,0,5000,0,5000,5000
00866,新光Shiller CAPE,0,0,0,0,0,0,0,0,0,5000,0,0,0,32000,27000,5000,5000
04207P,臺股指元大93售47,0,0,0,0,0,0,0,0,0,5000,0,0,0,5000,0,5000,5000
04204P,臺股指元大93售44,0,0,0,0,0,0,0,0,0,5000,0,0,0,5000,0,5000,5000
04314P,聯茂元富93售01  ,0,0,0,0,0,0,0,0,0,5000,0,0,0,10000,5000,5000,5000
04290P,滬深2X富邦96售03,0,0,0,0,0,0,0,0,0,5000,0,0,0,5000,0,5000,5000
042927,道瓊反中信94購01,0,0,0,0,0,0,0,0,0,5000,0,0,0,5000,0,5000,5000
04172P,大立光凱基93售34,0,0,0,0,0,0,0,0,0,5000,0,0,0,5000,0,5000,5000
03975P,大立光元大94售02,0,0,0,0,0,0,0,0,0,5000,0,0,0,10000,5000,5000,5000
04054P,滬深2X富邦96售02,0,0,0,0,0,0,0,0,0,5000,0,0,0,5000,0,5000,5000
044639,京元電元富94購01,0,0,0,0,0,0,0,0,0,5000,0,0,0,5000,0,5000,5000
04463P,可成元富94售03  ,0,0,0,0,0,0,0,0,0,5000,0,0,0,5000,0,5000,5000
04493P,漢唐永豐94售01  ,0,0,0,0,0,0,0,0,0,5000,0,0,0,5000,0,5000,5000
049158,元油2X中信94購03,0,0,0,0,0,0,0,0,0,5000,0,0,0,5000,0,5000,5000
04444P,玉晶光永豐94售06,0,0,0,0,0,0,0,0,0,5000,0,0,0,5000,0,5000,5000
05164P,南亞科元富95售04,0,0,0,0,0,0,0,0,0,5000,0,0,0,19000,14000,5000,5000
05018P,臺股指元大95售09,0,0,0,0,0,0,0,0,0,5000,0,0,0,5000,0,5000,5000
050173,旺宏元大96購02  ,0,0,0,0,0,0,0,0,0,5000,0,0,0,65000,60000,5000,5000
056642,旺宏凱基98購07  ,0,0,0,0,0,0,0,0,0,5000,0,0,0,5000,0,5000,5000
05662P,景碩元富96售01  ,0,0,0,0,0,0,0,0,0,5000,0,0,0,5000,0,5000,5000
05664P,國巨凱基96售09  ,0,0,0,0,0,0,0,0,0,5000,0,0,0,420000,415000,5000,5000
056811,健策統一9B購01  ,0,0,0,0,0,0,0,0,0,5000,0,0,0,5000,0,5000,5000
052234,GIS凱基97購01   ,0,0,0,0,0,0,0,0,0,5000,0,0,0,5000,0,5000,5000
051403,玉晶光永豐95購05,0,0,0,0,0,0,0,0,0,5000,0,0,0,5000,0,5000,5000
052725,為升元富96購01  ,0,0,0,0,0,0,0,0,0,5000,0,0,0,5000,0,5000,5000
052338,道瓊反凱基97購02,0,0,0,0,0,0,0,0,0,5000,0,0,0,5000,0,5000,5000
05065P,燿華元大96售03  ,0,0,0,0,0,0,0,0,0,5000,0,0,0,5000,0,5000,5000
049721,晶技凱基94購02  ,0,0,0,0,0,0,0,0,0,5000,0,0,0,5000,0,5000,5000
050334,鴻海國泰96購07  ,0,0,0,0,0,0,0,0,0,5000,0,0,0,35000,30000,5000,5000
051597,T50反1中信99購02,0,0,0,0,0,0,0,0,0,5000,0,0,0,5000,0,5000,5000
053079,世紀鋼永豐96購01,0,0,0,0,0,0,0,0,0,5000,0,0,0,5000,0,5000,5000
05307P,光寶科中信95售01,0,0,0,0,0,0,0,0,0,5000,0,0,0,5000,0,5000,5000
053887,聯茂兆豐97購02  ,0,0,0,0,0,0,0,0,0,5000,0,0,0,5000,0,5000,5000
053861,台光電元大98購01,0,0,0,0,0,0,0,0,0,5000,0,0,0,65000,60000,5000,5000
053864,義隆元大96購01  ,0,0,0,0,0,0,0,0,0,5000,0,0,0,65000,60000,5000,5000
053905,華新科凱基96購10,0,0,0,0,0,0,0,0,0,5000,0,0,0,5000,0,5000,5000
053916,漢唐國票97購04  ,0,0,0,0,0,0,0,0,0,5000,0,0,0,5000,0,5000,5000
056938,泰碩元富98購01  ,0,0,0,0,0,0,0,0,0,5000,0,0,0,15000,10000,5000,5000
05693P,滬深2X凱基98售02,0,0,0,0,0,0,0,0,0,5000,0,0,0,5000,0,5000,5000
053412,台達電國票97購02,0,0,0,0,0,0,0,0,0,5000,0,0,0,5000,0,5000,5000
054285,國巨元大98購02  ,0,0,0,0,0,0,0,0,0,5000,0,0,0,5000,0,5000,5000
053492,華邦電兆豐97購01,0,0,0,0,0,0,0,0,0,5000,0,0,0,35000,30000,5000,5000
05420P,大立光國泰97售03,0,0,0,0,0,0,0,0,0,5000,0,0,0,5000,0,5000,5000
056407,嘉晶國票99購01  ,0,0,0,0,0,0,0,0,0,5000,0,0,0,5000,0,5000,5000
056443,南亞科凱基98購03,0,0,0,0,0,0,0,0,0,5000,0,0,0,5000,0,5000,5000
057497,祥碩元大98購06  ,0,0,0,0,0,0,0,0,0,5000,0,0,0,99000,94000,5000,5000
057280,大立光元大98購15,0,0,0,0,0,0,0,0,0,5000,0,0,0,38000,33000,5000,5000
057392,福懋科永豐98購01,0,0,0,0,0,0,0,0,0,5000,0,0,0,5000,0,5000,5000
055138,大毅永豐97購02  ,0,0,0,0,0,0,0,0,0,5000,0,0,0,5000,0,5000,5000
055789,台虹凱基97購01  ,0,0,0,0,0,0,0,0,0,5000,0,0,0,5000,0,5000,5000
055790,南電凱基97購01  ,0,0,0,0,0,0,0,0,0,5000,0,0,0,96000,91000,5000,5000
055809,T50反1國票98購02,0,0,0,0,0,0,0,0,0,5000,0,0,0,5000,0,5000,5000
055211,A50反1凱基9A購01,0,0,0,0,0,0,0,0,0,5000,0,0,0,5000,0,5000,5000
057112,立積群益99購01  ,0,0,0,0,0,0,0,0,0,5000,0,0,0,10000,5000,5000,5000
057173,南亞科元大98購04,0,0,0,0,0,0,0,0,0,5000,0,0,0,20000,15000,5000,5000
056400,道瓊反群益9C購01,0,0,0,0,0,0,0,0,0,5000,0,0,0,5000,0,5000,5000
057574,中磊永豐98購01  ,0,0,0,0,0,0,0,0,0,5000,0,0,0,5000,0,5000,5000
05552P,聯詠群益96售01  ,0,0,0,0,0,0,0,0,0,5000,0,0,0,5000,0,5000,5000
056969,智易永豐98購01  ,0,0,0,0,0,0,0,0,0,5000,0,0,0,12000,7000,5000,5000
057052,華擎元大98購01  ,0,0,0,0,0,0,0,0,0,5000,0,0,0,5000,0,5000,5000
055891,鴻海統一9A購01  ,0,0,0,0,0,0,0,0,0,5000,0,0,0,5000,0,5000,5000
05628P,茂林國票97售02  ,0,0,0,0,0,0,0,0,0,5000,0,0,0,17000,12000,5000,5000
053188,旺宏統一97購03  ,0,0,0,0,0,0,0,0,0,5000,0,0,0,5000,0,5000,5000
056229,可成凱基97購04  ,0,0,0,0,0,0,0,0,0,5000,0,0,0,5000,0,5000,5000
05805P,義隆永豐96售02  ,0,0,0,0,0,0,0,0,0,5000,0,0,0,5000,0,5000,5000
057875,京鼎元大98購03  ,0,0,0,0,0,0,0,0,0,5000,0,0,0,5000,0,5000,5000
057942,可成國票99購02  ,0,0,0,0,0,0,0,0,0,5000,0,0,0,5000,0,5000,5000
058146,勤誠元大99購01  ,0,0,0,0,0,0,0,0,0,5000,0,0,0,10000,5000,5000,5000
05815P,台積電凱基97售06,0,0,0,0,0,0,0,0,0,5000,0,0,0,5000,0,5000,5000
058092,牧德元大98購02  ,0,0,0,0,0,0,0,0,0,5000,0,0,0,55000,50000,5000,5000
054389,為升元富96購02  ,0,0,0,0,0,0,0,0,0,5000,0,0,0,5000,0,5000,5000
053369,T50反1元大96購06,0,0,0,0,0,0,0,0,0,5000,0,0,0,5000,0,5000,5000
057746,同欣電永豐98購02,0,0,0,0,0,0,0,0,0,5000,0,0,0,5000,0,5000,5000
057674,台郡元大99購03  ,0,0,0,0,0,0,0,0,0,5000,0,0,0,20000,15000,5000,5000
055693,南茂凱基97購01  ,0,0,0,0,0,0,0,0,0,5000,0,0,0,5000,0,5000,5000
05986P,大立光統一97售03,0,0,0,0,0,0,0,0,0,4000,0,0,0,4000,0,4000,4000
06047P,聯發科富邦99售04,0,0,0,0,0,0,0,0,0,4000,0,0,0,9000,5000,4000,4000
059190,欣興富邦9A購01  ,0,0,0,0,0,0,0,0,0,4000,0,0,0,6000,2000,4000,4000
06763P,技嘉元大98售05  ,0,0,0,0,0,0,0,0,0,4000,0,0,0,4000,0,4000,4000
06581P,南亞科凱基98售04,0,0,0,0,0,0,0,0,0,4000,0,0,0,4000,0,4000,4000
06591P,大立光元大98售14,0,0,0,0,0,0,0,0,0,4000,0,0,0,14000,10000,4000,4000
058336,鴻海元富99購07  ,0,0,0,0,0,0,0,0,0,4000,0,0,0,4000,0,4000,4000
058569,健策凱基9A購01  ,0,0,0,0,0,0,0,0,0,4000,0,0,0,78000,74000,4000,4000
05897P,國巨凱基96售12  ,0,0,0,0,0,0,0,0,0,4000,0,0,0,64000,60000,4000,4000
058904,晶技元大99購05  ,0,0,0,0,0,0,0,0,0,4000,0,0,0,4000,0,4000,4000
058840,T50反1群益99購02,0,0,0,0,0,0,0,0,0,4000,0,0,0,45000,41000,4000,4000
5484,慧友            ,5000,1000,4000,0,0,0,0,0,0,0,0,0,0,0,0,0,4000
4961,天鈺            ,288000,284000,4000,0,0,0,0,0,0,0,0,0,0,0,0,0,4000
06955P,臻鼎元富99售01  ,0,0,0,0,0,0,0,0,0,4000,0,0,0,69000,65000,4000,4000
06916P,聯鈞元富98售02  ,0,0,0,0,0,0,0,0,0,4000,0,0,0,4000,0,4000,4000
06771P,台灣50中信02售01,0,0,0,0,0,0,0,0,0,4000,0,0,0,4000,0,4000,4000
07114P,旺宏兆豐9A售01  ,0,0,0,0,0,0,0,0,0,4000,0,0,0,111000,107000,4000,4000
07111P,台積電群益99售08,0,0,0,0,0,0,0,0,0,4000,0,0,0,7000,3000,4000,4000
07010P,T50正2凱基9C售01,0,0,0,0,0,0,0,0,0,4000,0,0,0,4000,0,4000,4000
1438,裕豐            ,6000,2000,4000,0,0,0,0,0,0,0,0,0,0,0,0,0,4000
1443,立益            ,8000,4000,4000,0,0,0,0,0,0,0,0,0,0,0,0,0,4000
051532,潤泰全國票96購01,0,0,0,0,0,0,0,0,0,4000,0,0,0,4000,0,4000,4000
050729,聯鈞國票94購01  ,0,0,0,0,0,0,0,0,0,4000,0,0,0,4000,0,4000,4000
050398,上証2X中信97購01,0,0,0,0,0,0,0,0,0,4000,0,0,0,4000,0,4000,4000
052299,T50反1台新05購03,0,0,0,0,0,0,0,0,0,4000,0,0,0,4000,0,4000,4000
05245P,台積電元大95售18,0,0,0,0,0,0,0,0,0,4000,0,0,0,155000,151000,4000,4000
052706,台虹國票97購01  ,0,0,0,0,0,0,0,0,0,4000,0,0,0,4000,0,4000,4000
04949P,致新元大94售04  ,0,0,0,0,0,0,0,0,0,4000,0,0,0,12000,8000,4000,4000
04957P,上証2X凱基96售02,0,0,0,0,0,0,0,0,0,4000,0,0,0,4000,0,4000,4000
051970,元黃金凱基98購01,0,0,0,0,0,0,0,0,0,4000,0,0,0,4000,0,4000,4000
056615,燿華永豐98購02  ,0,0,0,0,0,0,0,0,0,4000,0,0,0,4000,0,4000,4000
050189,旭富元大94購01  ,0,0,0,0,0,0,0,0,0,4000,0,0,0,10000,6000,4000,4000
050035,聯茂元大94購07  ,0,0,0,0,0,0,0,0,0,4000,0,0,0,55000,51000,4000,4000
04517P,宏達電群益95售01,0,0,0,0,0,0,0,0,0,4000,0,0,0,4000,0,4000,4000
048748,國巨元富96購01  ,0,0,0,0,0,0,0,0,0,4000,0,0,0,23000,19000,4000,4000
048572,美利達元大96購04,0,0,0,0,0,0,0,0,0,4000,0,0,0,4000,0,4000,4000
04396P,玉晶光群益94售02,0,0,0,0,0,0,0,0,0,4000,0,0,0,4000,0,4000,4000
043973,元金2X元大94購02,0,0,0,0,0,0,0,0,0,4000,0,0,0,4000,0,4000,4000
03025X,元展22          ,0,0,0,0,0,0,0,0,0,4000,0,0,0,6000,2000,4000,4000
020004,兆豐電菁英30N   ,0,0,0,0,0,0,0,0,0,4000,0,0,0,4000,0,4000,4000
047784,元油反富邦94購03,0,0,0,0,0,0,0,0,0,4000,0,0,0,4000,0,4000,4000
047096,元油反國泰96購01,0,0,0,0,0,0,0,0,0,4000,0,0,0,4000,0,4000,4000
04819P,嘉澤永豐94售01  ,0,0,0,0,0,0,0,0,0,4000,0,0,0,9000,5000,4000,4000
048381,T50反1國票94購03,0,0,0,0,0,0,0,0,0,4000,0,0,0,4000,0,4000,4000
051233,力成群益97購01  ,0,0,0,0,0,0,0,0,0,4000,0,0,0,4000,0,4000,4000
053276,友達元大9C購01  ,0,0,0,0,0,0,0,0,0,4000,0,0,0,20000,16000,4000,4000
053337,聯電國票97購01  ,0,0,0,0,0,0,0,0,0,4000,0,0,0,10000,6000,4000,4000
058266,宏達電永豐99購01,0,0,0,0,0,0,0,0,0,4000,0,0,0,4000,0,4000,4000
057972,群創富邦9C購01  ,0,0,0,0,0,0,0,0,0,4000,0,0,0,4000,0,4000,4000
056131,鴻海元大97購12  ,0,0,0,0,0,0,0,0,0,4000,0,0,0,14000,10000,4000,4000
057085,立積統一9B購02  ,0,0,0,0,0,0,0,0,0,4000,0,0,0,20000,16000,4000,4000
057070,美律永豐98購02  ,0,0,0,0,0,0,0,0,0,4000,0,0,0,4000,0,4000,4000
055955,微星元大97購01  ,0,0,0,0,0,0,0,0,0,4000,0,0,0,13000,9000,4000,4000
054868,國泰金群益9A購01,0,0,0,0,0,0,0,0,0,4000,0,0,0,195000,191000,4000,4000
054896,聯茂日盛97購01  ,0,0,0,0,0,0,0,0,0,4000,0,0,0,4000,0,4000,4000
055522,道瓊反群益01購01,0,0,0,0,0,0,0,0,0,4000,0,0,0,4000,0,4000,4000
057159,晶技永豐98購01  ,0,0,0,0,0,0,0,0,0,4000,0,0,0,14000,10000,4000,4000
054061,晶技國票97購03  ,0,0,0,0,0,0,0,0,0,4000,0,0,0,4000,0,4000,4000
056893,智邦元大98購02  ,0,0,0,0,0,0,0,0,0,4000,0,0,0,88000,84000,4000,4000
05743P,創意元大96售01  ,0,0,0,0,0,0,0,0,0,4000,0,0,0,8000,4000,4000,4000
054189,貿聯永豐96購03  ,0,0,0,0,0,0,0,0,0,4000,0,0,0,30000,26000,4000,4000
053481,同欣電元大97購01,0,0,0,0,0,0,0,0,0,4000,0,0,0,10000,6000,4000,4000
055442,矽創國票98購02  ,0,0,0,0,0,0,0,0,0,4000,0,0,0,4000,0,4000,4000
055379,牧德元大97購03  ,0,0,0,0,0,0,0,0,0,4000,0,0,0,4000,0,4000,4000
053869,嘉澤元大96購02  ,0,0,0,0,0,0,0,0,0,4000,0,0,0,5000,1000,4000,4000
053517,崇越群益97購01  ,0,0,0,0,0,0,0,0,0,4000,0,0,0,4000,0,4000,4000
8114,振樺電          ,66000,57000,9000,0,0,0,0,0,0,-5000,0,5000,-5000,0,0,0,4000
9906,欣巴巴          ,5000,1000,4000,0,0,0,0,0,0,0,0,0,0,0,0,0,4000
9929,秋雨            ,6000,2000,4000,0,0,0,0,0,0,0,0,0,0,0,0,0,4000
8429,金麗-KY         ,49190,46000,3190,0,0,0,0,0,0,0,0,0,0,0,0,0,3190
1341,富林-KY         ,4000,1000,3000,0,0,0,0,0,0,0,0,0,0,0,0,0,3000
1817,凱撒衛          ,29000,26000,3000,0,0,0,0,0,0,0,0,0,0,0,0,0,3000
1805,寶徠            ,5000,2000,3000,0,0,0,0,0,0,0,0,0,0,0,0,0,3000
07020P,玉晶光台新99售02,0,0,0,0,0,0,0,0,0,3000,0,0,0,13000,10000,3000,3000
07006P,旺宏統一9B售03  ,0,0,0,0,0,0,0,0,0,3000,0,0,0,3000,0,3000,3000
07076P,鴻海凱基9A售08  ,0,0,0,0,0,0,0,0,0,3000,0,0,0,13000,10000,3000,3000
07189P,聯發科富邦9B售03,0,0,0,0,0,0,0,0,0,3000,0,0,0,4000,1000,3000,3000
06933P,禾伸堂元大98售03,0,0,0,0,0,0,0,0,0,3000,0,0,0,71000,68000,3000,3000
5538,東明-KY         ,9000,6000,3000,0,0,0,0,0,0,0,0,0,0,0,0,0,3000
3308,聯德            ,6000,3000,3000,0,0,0,0,0,0,0,0,0,0,0,0,0,3000
05877P,大立光群益96售06,0,0,0,0,0,0,0,0,0,3000,0,0,0,3000,0,3000,3000
058582,禾伸堂群益99購02,0,0,0,0,0,0,0,0,0,3000,0,0,0,3000,0,3000,3000
058564,元金2X凱基9C購01,0,10000,-10000,0,0,0,0,0,0,13000,0,0,0,13000,0,13000,3000
058344,旺宏群益99購05  ,0,0,0,0,0,0,0,0,0,3000,0,0,0,13000,10000,3000,3000
06726P,欣興元富98售04  ,0,0,0,0,0,0,0,0,0,3000,0,0,0,16000,13000,3000,3000
06657P,寶成元大98售01  ,0,0,0,0,0,0,0,0,0,3000,0,0,0,49000,46000,3000,3000
06658P,台灣50富邦9C售01,0,0,0,0,0,0,0,0,0,3000,0,0,0,3000,0,3000,3000
06707P,臺股指台新99售04,0,0,0,0,0,0,0,0,0,3000,0,0,0,3000,0,3000,3000
059137,電子類群益99購01,0,0,0,0,0,0,0,0,0,3000,0,0,0,23000,20000,3000,3000
05973P,聯詠元大96售06  ,0,0,0,0,0,0,0,0,0,3000,0,0,0,3000,0,3000,3000
051176,聯發科凱基95購07,0,0,0,0,0,0,0,0,0,3000,0,0,0,3000,0,3000,3000
046218,T50反1元大93購02,0,0,0,0,0,0,0,0,0,3000,0,0,0,3000,0,3000,3000
04623P,台積電元大94售13,0,0,0,0,0,0,0,0,0,3000,0,0,0,3000,0,3000,3000
049269,超眾元大96購02  ,0,0,0,0,0,0,0,0,0,3000,0,0,0,3000,0,3000,3000
05276P,GIS永豐95售02   ,0,0,0,0,0,0,0,0,0,3000,0,0,0,3000,0,3000,3000
048399,祥碩國票94購01  ,0,0,0,0,0,0,0,0,0,3000,0,0,0,3000,0,3000,3000
04844P,京元電亞東94售01,0,0,0,0,0,0,0,0,0,3000,0,0,0,3000,0,3000,3000
048021,滬深反凱基93購02,0,0,0,0,0,0,0,0,0,3000,0,0,0,3000,0,3000,3000
047514,亞光國票94購01  ,0,0,0,0,0,0,0,0,0,3000,0,0,0,3000,0,3000,3000
04753P,台積電統一94售11,0,0,0,0,0,0,0,0,0,3000,0,0,0,20000,17000,3000,3000
04422P,玉晶光永豐94售03,0,0,0,0,0,0,0,0,0,3000,0,0,0,3000,0,3000,3000
03650C,T50反1元大98牛05,0,0,0,0,0,0,0,0,0,3000,0,0,0,3000,0,3000,3000
050175,台光電元大94購08,0,0,0,0,0,0,0,0,0,3000,0,0,0,3000,0,3000,3000
05214P,台積電國票97售02,0,0,0,0,0,0,0,0,0,3000,0,0,0,3000,0,3000,3000
051911,大立光元大98購02,0,0,0,0,0,0,0,0,0,3000,0,0,0,5000,2000,3000,3000
052255,T50反1國泰96購01,0,0,0,0,0,0,0,0,0,3000,0,0,0,3000,0,3000,3000
056299,友達元大9B購04  ,0,0,0,0,0,0,0,0,0,3000,0,0,0,3000,0,3000,3000
04953P,台積電群益94售13,0,0,0,0,0,0,0,0,0,3000,0,0,0,13000,10000,3000,3000
05247P,上銀群益95售01  ,0,0,0,0,0,0,0,0,0,3000,0,0,0,3000,0,3000,3000
05039P,鴻海凱基95售10  ,0,0,0,0,0,0,0,0,0,3000,0,0,0,3000,0,3000,3000
049694,華新科元大95購06,0,0,0,0,0,0,0,0,0,3000,0,0,0,3000,0,3000,3000
04979P,臺股指凱基96售07,0,0,0,0,0,0,0,0,0,3000,0,0,0,3000,0,3000,3000
049686,T50反1元大94購02,0,0,0,0,0,0,0,0,0,3000,0,0,0,3000,0,3000,3000
053640,上緯控永豐96購01,0,0,0,0,0,0,0,0,0,3000,0,0,0,3000,0,3000,3000
053591,大立光元大99購03,0,0,0,0,0,0,0,0,0,3000,0,0,0,3000,0,3000,3000
05753P,臺股指中信99售02,0,0,0,0,0,0,0,0,0,3000,0,0,0,3000,0,3000,3000
054352,世芯國泰98購01  ,0,0,0,0,0,0,0,0,0,3000,0,0,0,3000,0,3000,3000
053395,致茂中信96購01  ,0,0,0,0,0,0,0,0,0,3000,0,0,0,3000,0,3000,3000
054717,亞德客永豐97購01,0,0,0,0,0,0,0,0,0,3000,0,0,0,3000,0,3000,3000
057223,富邦金日盛99購01,0,0,0,0,0,0,0,0,0,3000,0,0,0,3000,0,3000,3000
057191,祥碩元大98購05  ,0,0,0,0,0,0,0,0,0,3000,0,0,0,58000,55000,3000,3000
057423,台郡凱基98購06  ,0,0,0,0,0,0,0,0,0,3000,0,0,0,3000,0,3000,3000
057492,大立光元大98購18,0,0,0,0,0,0,0,0,0,3000,0,0,0,27000,24000,3000,3000
056864,新日興群益99購01,0,0,0,0,0,0,0,0,0,3000,0,0,0,3000,0,3000,3000
055233,康友國票98購01  ,0,0,0,0,0,0,0,0,0,3000,0,0,0,24000,21000,3000,3000
055844,大毅元大98購01  ,0,0,0,0,0,0,0,0,0,3000,0,0,0,13000,10000,3000,3000
053168,晶技群益98購01  ,0,0,0,0,0,0,0,0,0,3000,0,0,0,3000,0,3000,3000
054420,緯穎元大96購08  ,0,0,0,0,0,0,0,0,0,3000,0,0,0,48000,45000,3000,3000
057749,華新科國票99購01,0,0,0,0,0,0,0,0,0,3000,0,0,0,3000,0,3000,3000
8442,威宏-KY         ,8000,5000,3000,0,0,0,0,0,0,0,0,0,0,0,0,0,3000
8482,商億-KY         ,46000,43000,3000,0,0,0,0,0,0,0,0,0,0,0,0,0,3000
06076P,大立光凱基98售03,0,0,0,0,0,0,0,0,0,2000,0,0,0,3000,1000,2000,2000
06077P,GIS凱基97售02   ,0,0,0,0,0,0,0,0,0,2000,0,0,0,2000,0,2000,2000
06132P,正文元富97售01  ,0,0,0,0,0,0,0,0,0,2000,0,0,0,2000,0,2000,2000
06178P,大立光第一99售01,0,0,0,0,0,0,0,0,0,2000,0,0,0,2000,0,2000,2000
059120,致伸永豐99購01  ,0,0,0,0,0,0,0,0,0,2000,0,0,0,10000,8000,2000,2000
06586P,鴻海元大9C售01  ,0,0,0,0,0,0,0,0,0,2000,0,0,0,2000,0,2000,2000
06572P,台積電永昌99售01,0,0,0,0,0,0,0,0,0,2000,0,0,0,2000,0,2000,2000
06604P,聯發科元富02售02,0,0,0,0,0,0,0,0,0,2000,0,0,0,27000,25000,2000,2000
06606P,訊芯元富98售02  ,0,0,0,0,0,0,0,0,0,2000,0,0,0,2000,0,2000,2000
06609P,元油2X凱基9B售06,0,0,0,0,0,0,0,0,0,2000,0,0,0,3000,1000,2000,2000
06612P,元油2X富邦9B售03,0,0,0,0,0,0,0,0,0,2000,0,0,0,2000,0,2000,2000
06621P,欣興元大98售06  ,0,0,0,0,0,0,0,0,0,2000,0,0,0,2000,0,2000,2000
06483P,聯發科凱基98售10,0,0,0,0,0,0,0,0,0,2000,0,0,0,2000,0,2000,2000
06534P,聯發科群益98售04,0,0,0,0,0,0,0,0,0,2000,0,0,0,2000,0,2000,2000
06374P,台表科元大97售06,0,0,0,0,0,0,0,0,0,2000,0,0,0,2000,0,2000,2000
058418,台積電麥證99購01,0,0,0,9000,7000,2000,0,0,0,2000,0,0,0,9000,7000,2000,2000
058623,國巨國票99購08  ,0,0,0,0,0,0,0,0,0,2000,0,0,0,2000,0,2000,2000
05860P,旺宏康和96售01  ,0,0,0,0,0,0,0,0,0,2000,0,0,0,2000,0,2000,2000
058801,致伸元大99購01  ,0,0,0,0,0,0,0,0,0,2000,0,0,0,2000,0,2000,2000
05885P,牧德統一96售01  ,0,0,0,0,0,0,0,0,0,2000,0,0,0,2000,0,2000,2000
4144,康聯-KY         ,8000,6000,2000,0,0,0,0,0,0,0,0,0,0,0,0,0,2000
5258,虹堡            ,73000,71000,2000,0,0,0,0,0,0,0,0,0,0,0,0,0,2000
6209,今國光          ,172000,170000,2000,0,0,0,0,0,0,0,0,0,0,0,0,0,2000
2424,隴華            ,2000,0,2000,0,0,0,0,0,0,0,0,0,0,0,0,0,2000
3021,鴻名            ,8000,14000,-6000,0,0,0,0,0,0,8000,8000,0,8000,0,0,0,2000
06932P,大立光元大98售21,0,0,0,0,0,0,0,0,0,2000,0,0,0,62000,60000,2000,2000
06920P,台灣50凱基9A售01,0,0,0,0,0,0,0,0,0,2000,0,0,0,2000,0,2000,2000
06813P,友訊元富98售03  ,0,0,0,0,0,0,0,0,0,2000,0,0,0,2000,0,2000,2000
07165P,臺股指群益99售16,0,0,0,0,0,0,0,0,0,2000,0,0,0,2000,0,2000,2000
07126P,台積電元大99售23,0,0,0,0,0,0,0,0,0,2000,0,0,0,52000,50000,2000,2000
07129P,華新科元大99售14,0,0,0,0,0,0,0,0,0,2000,0,0,0,6000,4000,2000,2000
07090P,台灣50凱基01售01,0,0,0,0,0,0,0,0,0,2000,0,0,0,2000,0,2000,2000
1472,三洋紡          ,2000,0,2000,0,0,0,0,0,0,0,0,0,0,0,0,0,2000
1468,昶和            ,11000,9000,2000,0,0,0,0,0,0,0,0,0,0,0,0,0,2000
1470,大統新創        ,6000,4000,2000,0,0,0,0,0,0,0,0,0,0,0,0,0,2000
08864P,欣興元大01售01  ,0,0,0,0,0,0,0,0,0,2000,0,0,0,2000,0,2000,2000
08672P,聯發科統一01售09,0,0,0,0,0,0,0,0,0,2000,0,0,0,2000,0,2000,2000
049804,華固元大94購01  ,0,0,0,0,0,0,0,0,0,2000,0,0,0,62000,60000,2000,2000
04975P,華新科凱基96售02,0,0,0,0,0,0,0,0,0,2000,0,0,0,2000,0,2000,2000
050283,T50反1凱基9A購01,0,0,0,0,0,0,0,0,0,2000,0,0,0,2000,0,2000,2000
050653,聯鈞凱基96購01  ,0,0,0,0,0,0,0,0,0,2000,0,0,0,49000,47000,2000,2000
050669,嘉晶永豐96購01  ,0,0,0,0,0,0,0,0,0,2000,0,0,0,2000,0,2000,2000
05061P,鴻海富邦96售03  ,0,0,0,0,0,0,0,0,0,2000,0,0,0,2000,0,2000,2000
052476,台光電群益98購01,0,0,0,0,0,0,0,0,0,2000,0,0,0,70000,68000,2000,2000
05241P,鴻海國泰97售04  ,0,0,0,0,0,0,0,0,0,2000,0,0,0,7000,5000,2000,2000
05257P,欣興凱基95售04  ,0,0,0,0,0,0,0,0,0,2000,0,0,0,2000,0,2000,2000
04958P,和大凱基94售04  ,0,0,0,0,0,0,0,0,0,2000,0,0,0,2000,0,2000,2000
051979,群創凱基97購01  ,0,0,0,0,0,0,0,0,0,2000,0,0,0,7000,5000,2000,2000
052080,康友元富98購02  ,0,0,0,0,0,0,0,0,0,2000,0,0,0,2000,0,2000,2000
049387,緯穎元大94購03  ,0,0,0,0,0,0,0,0,0,2000,0,0,0,10000,8000,2000,2000
056536,義隆凱基98購04  ,0,0,0,0,0,0,0,0,0,2000,0,0,0,52000,50000,2000,2000
05678P,群創群益97售01  ,0,0,0,0,0,0,0,0,0,2000,0,0,0,2000,0,2000,2000
05020P,廣達中信95售01  ,0,0,0,0,0,0,0,0,0,2000,0,0,0,2000,0,2000,2000
050214,嘉晶台新94購01  ,0,0,0,0,0,0,0,0,0,2000,0,0,0,2000,0,2000,2000
05005P,台表科統一95售01,0,0,0,0,0,0,0,0,0,2000,0,0,0,2000,0,2000,2000
03647P,京元電元富95售02,0,0,0,0,0,0,0,0,0,2000,0,0,0,12000,10000,2000,2000
03832P,臺股指中信95售03,0,0,0,0,0,0,0,0,0,2000,0,0,0,2000,0,2000,2000
03751P,旺宏富邦95售01  ,0,0,0,0,0,0,0,0,0,2000,0,0,0,2000,0,2000,2000
04874P,高股息中信97售01,0,0,0,0,0,0,0,0,0,2000,0,0,0,2000,0,2000,2000
04483P,元油2X凱基97售04,0,0,0,0,0,0,0,0,0,2000,0,0,0,13000,11000,2000,2000
04455P,台積電統一94售07,0,0,0,0,0,0,0,0,0,2000,0,0,0,2000,0,2000,2000
044533,S&P反1中信94購02,0,0,0,0,0,0,0,0,0,2000,0,0,0,2000,0,2000,2000
04400P,台積電兆豐95售02,0,0,0,0,0,0,0,0,0,2000,0,0,0,2000,0,2000,2000
03007X,元展07          ,0,0,0,0,0,0,0,0,0,2000,0,0,0,2000,0,2000,2000
03005P,旭富群益01售05  ,0,0,0,0,0,0,0,0,0,2000,0,0,0,2000,0,2000,2000
00707R,元大S&P日圓反1  ,0,0,0,0,0,0,0,0,0,2000,0,0,0,2000,0,2000,2000
0053,元大電子        ,0,0,0,0,0,0,0,0,0,2000,0,0,0,17000,15000,2000,2000
04709P,台積電元大94售15,0,0,0,0,0,0,0,0,0,2000,0,0,0,2000,0,2000,2000
045659,華新科國泰94購01,0,0,0,0,0,0,0,0,0,2000,0,0,0,2000,0,2000,2000
049300,南電群益94購01  ,0,0,0,0,0,0,0,0,0,2000,0,0,0,2000,0,2000,2000
052272,T50反1群益95購03,0,0,0,0,0,0,0,0,0,2000,0,0,0,2000,0,2000,2000
051052,台積電群益95購01,0,0,0,0,0,0,0,0,0,2000,0,0,0,2000,0,2000,2000
057724,亞德客國泰99購01,0,0,0,0,0,0,0,0,0,2000,0,0,0,112000,110000,2000,2000
053312,緯穎凱基96購02  ,0,0,0,0,0,0,0,0,0,2000,0,0,0,13000,11000,2000,2000
053194,緯穎統一99購01  ,0,0,0,0,0,0,0,0,0,2000,0,0,0,6000,4000,2000,2000
056088,台郡統一97購02  ,0,0,0,0,0,0,0,0,0,2000,0,0,0,2000,0,2000,2000
056095,臻鼎元富9A購01  ,0,0,0,0,0,0,0,0,0,2000,0,0,0,2000,0,2000,2000
056162,祥碩凱基97購03  ,0,0,0,0,0,0,0,0,0,2000,0,0,0,3000,1000,2000,2000
05585P,臺股指凱基96售14,0,0,0,0,0,0,0,0,0,2000,0,0,0,2000,0,2000,2000
055857,嘉聯益元大97購04,0,0,0,0,0,0,0,0,0,2000,0,0,0,2000,0,2000,2000
056068,欣興元大97購05  ,0,0,0,0,0,0,0,0,0,2000,0,0,0,2000,0,2000,2000
056050,晶技國票98購01  ,0,0,0,0,0,0,0,0,0,2000,0,0,0,2000,0,2000,2000
056060,宏達電元大99購01,0,0,0,0,0,0,0,0,0,2000,0,0,0,2000,0,2000,2000
054573,漢唐元大98購01  ,0,0,0,0,0,0,0,0,0,2000,0,0,0,25000,23000,2000,2000
054887,大毅統一98購01  ,0,0,0,0,0,0,0,0,0,2000,0,0,0,32000,30000,2000,2000
054540,泰鼎國票99購01  ,0,0,0,0,0,0,0,0,0,2000,0,0,0,22000,20000,2000,2000
056970,TPK永豐98購01   ,0,0,0,0,0,0,0,0,0,2000,0,0,0,2000,0,2000,2000
055232,泰碩國票98購01  ,0,0,0,0,0,0,0,0,0,2000,0,0,0,2000,0,2000,2000
057188,佐登元大98購01  ,0,0,0,0,0,0,0,0,0,2000,0,0,0,10000,8000,2000,2000
057153,祥碩國泰99購01  ,0,0,0,0,0,0,0,0,0,2000,0,0,0,2000,0,2000,2000
054204,元金2X國票9B購02,0,0,0,0,0,0,0,0,0,2000,0,0,0,12000,10000,2000,2000
056447,聯發科凱基98購09,0,0,0,0,0,0,0,0,0,2000,0,0,0,2000,0,2000,2000
057250,大立光統一98購08,0,0,0,0,0,0,0,0,0,2000,0,0,0,2000,0,2000,2000
054768,泰碩國票99購02  ,0,0,0,0,0,0,0,0,0,2000,0,0,0,2000,0,2000,2000
054809,大成鋼元大97購01,0,0,0,0,0,0,0,0,0,2000,0,0,0,3000,1000,2000,2000
056922,全新兆豐99購01  ,0,0,0,0,0,0,0,0,0,2000,0,0,0,7000,5000,2000,2000
05352P,臺股指元富95售06,0,0,0,0,0,0,0,0,0,2000,0,0,0,2000,0,2000,2000
053902,S&P反1凱基97購01,0,0,0,0,0,0,0,0,0,2000,0,0,0,2000,0,2000,2000
053938,彩晶元富96購01  ,0,0,0,0,0,0,0,0,0,2000,0,0,0,2000,0,2000,2000
8488,吉源-KY         ,7000,5000,2000,0,0,0,0,0,0,0,0,0,0,0,0,0,2000
6625,必應            ,6000,4000,2000,0,0,0,0,0,0,0,0,0,0,0,0,0,2000
6405,悅城            ,10000,8000,2000,0,0,0,0,0,0,0,0,0,0,0,0,0,2000
6431,光麗-KY         ,2000,0,2000,0,0,0,0,0,0,0,0,0,0,0,0,0,2000
1503,士電            ,122000,115000,7000,0,0,0,0,0,0,-6000,0,6000,-6000,0,0,0,1000
07033P,大立光統一9B售03,0,0,0,0,0,0,0,0,0,1000,0,0,0,1000,0,1000,1000
06804P,臺股指群益98售10,0,0,0,0,0,0,0,0,0,1000,0,0,0,1000,0,1000,1000
06849P,欣興元大98售12  ,0,0,0,0,0,0,0,0,0,1000,0,0,0,1000,0,1000,1000
06871P,元油2X群益98售04,0,0,0,0,0,0,0,0,0,1000,0,0,0,68000,67000,1000,1000
06942P,台灣50台新02售01,0,0,0,0,0,0,0,0,0,1000,0,0,0,1000,0,1000,1000
06995P,臺股指凱基99售16,0,0,0,0,0,0,0,0,0,1000,0,0,0,1000,0,1000,1000
2891B,中信金乙特      ,0,0,0,0,0,0,0,0,0,1000,1000,0,1000,0,0,0,1000
2617,台航            ,168000,181000,-13000,0,0,0,0,0,0,14000,14000,0,14000,0,0,0,1000
2236,百達-KY         ,2000,1000,1000,0,0,0,0,0,0,0,0,0,0,0,0,0,1000
6152,百一            ,20000,19000,1000,0,0,0,0,0,0,0,0,0,0,0,0,0,1000
6117,迎廣            ,9000,8000,1000,0,0,0,0,0,0,0,0,0,0,0,0,0,1000
4106,雃博            ,78000,77000,1000,0,0,0,0,0,0,0,0,0,0,0,0,0,1000
3686,達能            ,9000,8000,1000,0,0,0,0,0,0,0,0,0,0,0,0,0,1000
05900P,臺股指凱基99售05,0,0,0,0,0,0,0,0,0,1000,0,0,0,1000,0,1000,1000
059115,美食永豐99購01  ,0,0,0,0,0,0,0,0,0,1000,0,0,0,1000,0,1000,1000
05840P,臺股指富邦96售07,0,0,0,0,0,0,0,0,0,1000,0,0,0,1000,0,1000,1000
058360,台光電凱基9A購02,0,0,0,0,0,0,0,0,0,1000,0,0,0,1000,0,1000,1000
06350P,臺股指台新99售02,0,0,0,0,0,0,0,0,0,1000,0,0,0,1000,0,1000,1000
06243P,亞光元富97售01  ,0,0,0,0,0,0,0,0,0,1000,0,0,0,1000,0,1000,1000
06257P,臺股指群益97售10,0,0,0,0,0,0,0,0,0,1000,0,0,0,1000,0,1000,1000
06453P,群創元大9B售02  ,0,0,0,0,0,0,0,0,0,1000,0,0,0,1000,0,1000,1000
06711P,臺股指台新99售08,0,0,0,0,0,0,0,0,0,1000,0,0,0,1000,0,1000,1000
06696P,台灣50國票99售01,0,0,0,0,0,0,0,0,0,1000,0,0,0,1000,0,1000,1000
06722P,臺股指中信9A售04,0,0,0,0,0,0,0,0,0,1000,0,0,0,1000,0,1000,1000
06719P,台灣50群益9A售01,0,0,0,0,0,0,0,0,0,1000,0,0,0,1000,0,1000,1000
06745P,台積電群益98售05,0,0,0,0,0,0,0,0,0,1000,0,0,0,1000,0,1000,1000
059174,訊芯凱基99購01  ,0,0,0,0,0,0,0,0,0,1000,0,0,0,11000,10000,1000,1000
059201,祥碩永豐99購02  ,0,0,0,0,0,0,0,0,0,1000,0,0,0,96000,95000,1000,1000
06213P,大立光元大98售07,0,0,0,0,0,0,0,0,0,1000,0,0,0,1000,0,1000,1000
06158P,玉晶光元富97售08,0,0,0,0,0,0,0,0,0,1000,0,0,0,1000,0,1000,1000
06072P,牧德永豐97售01  ,0,0,0,0,0,0,0,0,0,1000,0,0,0,2000,1000,1000,1000
06057P,大立光凱基98售01,0,0,0,0,0,0,0,0,0,1000,0,0,0,1000,0,1000,1000
05981P,可成永昌98售02  ,0,0,0,0,0,0,0,0,0,1000,0,0,0,1000,0,1000,1000
046813,聯電凱基96購01  ,0,0,0,0,0,0,0,0,0,1000,0,0,0,40000,39000,1000,1000
04664P,臺股指國票94售03,0,0,0,0,0,0,0,0,0,1000,0,0,0,1000,0,1000,1000
04571P,華新科國泰95售03,0,0,0,0,0,0,0,0,0,1000,0,0,0,1000,0,1000,1000
04926P,聯發科凱基95售03,0,0,0,0,0,0,0,0,0,1000,0,0,0,11000,10000,1000,1000
045516,聯茂統一94購01  ,0,0,0,0,0,0,0,0,0,1000,0,0,0,1000,0,1000,1000
04526P,美律凱基94售03  ,0,0,0,0,0,0,0,0,0,1000,0,0,0,1000,0,1000,1000
04530P,上海銀凱基94售03,0,0,0,0,0,0,0,0,0,1000,0,0,0,1000,0,1000,1000
048412,台勝科亞東93購01,0,0,0,0,0,0,0,0,0,1000,0,0,0,1000,0,1000,1000
04748P,臺股指元大94售23,0,0,0,0,0,0,0,0,0,1000,0,0,0,1000,0,1000,1000
047342,T50反1中信99購01,0,0,0,0,0,0,0,0,0,1000,0,0,0,1000,0,1000,1000
04801P,矽力元大94售02  ,0,0,0,0,0,0,0,0,0,1000,0,0,0,21000,20000,1000,1000
048119,臺指反元大96購03,0,0,0,0,0,0,0,0,0,1000,0,0,0,1000,0,1000,1000
047760,元油反元大96購03,0,0,0,0,0,0,0,0,0,1000,0,0,0,1000,0,1000,1000
0055,元大MSCI金融    ,2000,3000,-1000,0,0,0,0,0,0,2000,0,0,0,12000,10000,2000,1000
03005X,元展05          ,0,0,0,0,0,0,0,0,0,1000,0,0,0,1000,0,1000,1000
04214P,美利達凱基93售04,0,0,0,0,0,0,0,0,0,1000,0,0,0,1000,0,1000,1000
04383P,泰鼎國泰95售01  ,0,0,0,0,0,0,0,0,0,1000,0,0,0,50000,49000,1000,1000
04289P,臺股指中信95售07,0,0,0,0,0,0,0,0,0,1000,0,0,0,1000,0,1000,1000
03026X,元展23          ,0,0,0,0,0,0,0,0,0,1000,0,0,0,2000,1000,1000,1000
03111P,元油2X富邦97售01,0,0,0,0,0,0,0,0,0,1000,0,0,0,1000,0,1000,1000
04914P,國巨國泰95售06  ,0,0,0,0,0,0,0,0,0,1000,0,0,0,1000,0,1000,1000
04884P,聯發科凱基94售20,0,0,0,0,0,0,0,0,0,1000,0,0,0,1000,0,1000,1000
048899,茂林國泰95購01  ,0,0,0,0,0,0,0,0,0,1000,0,0,0,1000,0,1000,1000
04165P,南亞科元富95售03,0,0,0,0,0,0,0,0,0,1000,0,0,0,1000,0,1000,1000
03658C,T50反1元大9A牛02,0,0,0,0,0,0,0,0,0,1000,0,0,0,22000,21000,1000,1000
03648C,T50反1元大96牛07,0,0,0,0,0,0,0,0,0,1000,0,0,0,1000,0,1000,1000
050188,貿聯元大96購01  ,0,0,0,0,0,0,0,0,0,1000,0,0,0,1000,0,1000,1000
051624,智邦麥證95購02  ,0,0,0,1000,0,1000,0,0,0,1000,0,0,0,1000,0,1000,1000
05173P,臺股指元大95售17,0,0,0,0,0,0,0,0,0,1000,0,0,0,1000,0,1000,1000
05177P,台積電凱基95售12,0,0,0,0,0,0,0,0,0,1000,0,0,0,1000,0,1000,1000
05219P,鴻海元大95售17  ,0,0,0,0,0,0,0,0,0,1000,0,0,0,1000,0,1000,1000
04999P,南電永豐95售01  ,0,0,0,0,0,0,0,0,0,1000,0,0,0,27000,26000,1000,1000
05670P,台積電國票98售01,0,0,0,0,0,0,0,0,0,1000,0,0,0,31000,30000,1000,1000
05636P,國巨永豐96售03  ,0,0,0,0,0,0,0,0,0,1000,0,0,0,233000,232000,1000,1000
051424,緯穎國票97購01  ,0,0,0,0,0,0,0,0,0,1000,0,0,0,1000,0,1000,1000
05128P,聯發科中信97售03,0,0,0,0,0,0,0,0,0,1000,0,0,0,11000,10000,1000,1000
052576,聯茂凱基96購01  ,0,0,0,0,0,0,0,0,0,1000,0,0,0,1000,0,1000,1000
052426,國巨台新96購01  ,0,0,0,0,0,0,0,0,0,1000,0,0,0,1000,0,1000,1000
05062P,大立光富邦98售03,0,0,0,0,0,0,0,0,0,1000,0,0,0,1000,0,1000,1000
050671,超眾永豐94購04  ,0,0,0,0,0,0,0,0,0,1000,0,0,0,1000,0,1000,1000
050617,神基元大94購01  ,0,0,0,0,0,0,0,0,0,1000,0,0,0,1000,0,1000,1000
050218,世紀鋼統一94購02,0,0,0,0,0,0,0,0,0,1000,0,0,0,1000,0,1000,1000
05152P,玉晶光群益96售05,0,0,0,0,0,0,0,0,0,1000,0,0,0,1000,0,1000,1000
049700,瀚宇博元大97購01,0,0,0,0,0,0,0,0,0,1000,0,0,0,51000,50000,1000,1000
04977P,力成凱基96售01  ,0,0,0,0,0,0,0,0,0,1000,0,0,0,1000,0,1000,1000
051462,世芯國泰97購01  ,0,0,0,0,0,0,0,0,0,1000,0,0,0,1000,0,1000,1000
04960P,大立光凱基96售04,0,0,0,0,0,0,0,0,0,1000,0,0,0,1000,0,1000,1000
053928,智易國票97購03  ,0,0,0,0,0,0,0,0,0,1000,0,0,0,1000,0,1000,1000
053983,樺漢元大97購02  ,0,0,0,0,0,0,0,0,0,1000,0,0,0,1000,0,1000,1000
053689,台光電元大96購01,0,0,0,0,0,0,0,0,0,1000,0,0,0,1000,0,1000,1000
053807,T50反1群益96購02,0,0,0,0,0,0,0,0,0,1000,0,0,0,1000,0,1000,1000
05365P,臺股指富邦95售05,0,0,0,0,0,0,0,0,0,1000,0,0,0,1000,0,1000,1000
055464,聚陽凱基97購01  ,0,0,0,0,0,0,0,0,0,1000,0,0,0,1000,0,1000,1000
053457,旺宏國泰98購03  ,0,0,0,0,0,0,0,0,0,1000,0,0,0,1000,0,1000,1000
05433P,智原元富95售02  ,0,0,0,0,0,0,0,0,0,1000,0,0,0,1000,0,1000,1000
054208,台積電國票97購07,0,0,0,0,0,0,0,0,0,1000,0,0,0,50000,49000,1000,1000
05416P,喬山永豐95售04  ,0,0,0,0,0,0,0,0,0,1000,0,0,0,1000,0,1000,1000
05748P,臺股指群益99售02,0,0,0,0,0,0,0,0,0,1000,0,0,0,1000,0,1000,1000
05745P,富邦金兆豐96售02,0,0,0,0,0,0,0,0,0,1000,0,0,0,1000,0,1000,1000
057278,可成元大98購06  ,0,0,0,0,0,0,0,0,0,1000,0,0,0,36000,35000,1000,1000
05733P,臺股指統一96售03,0,0,0,0,0,0,0,0,0,1000,0,0,0,1000,0,1000,1000
05576P,群創日盛99售02  ,0,0,0,0,0,0,0,0,0,1000,0,0,0,1000,0,1000,1000
05515P,台積電群益96售03,0,0,0,0,0,0,0,0,0,1000,0,0,0,1000,0,1000,1000
054543,元金2X中信01購01,0,0,0,0,0,0,0,0,0,1000,0,0,0,1000,0,1000,1000
055101,台肥凱基97購01  ,0,0,0,0,0,0,0,0,0,1000,0,0,0,1000,0,1000,1000
05500P,臺股指中信96售04,0,0,0,0,0,0,0,0,0,1000,0,0,0,1000,0,1000,1000
054931,緯穎凱基98購01  ,0,0,0,0,0,0,0,0,0,1000,0,0,0,1000,0,1000,1000
05554P,群創群益96售02  ,0,0,0,0,0,0,0,0,0,1000,0,0,0,1000,0,1000,1000
05762P,昇陽半永豐96售04,0,0,0,0,0,0,0,0,0,1000,0,0,0,1000,0,1000,1000
057073,康控永豐98購01  ,0,0,0,0,0,0,0,0,0,1000,0,0,0,21000,20000,1000,1000
05700P,臻鼎凱基96售02  ,0,0,0,0,0,0,0,0,0,1000,0,0,0,1000,0,1000,1000
056147,鴻海日盛97購05  ,0,0,0,0,0,0,0,0,0,1000,0,0,0,1000,0,1000,1000
05614P,臺股指康和96售03,0,0,0,0,0,0,0,0,0,1000,0,0,0,2000,1000,1000,1000
056200,大毅永豐98購01  ,0,0,0,0,0,0,0,0,0,1000,0,0,0,1000,0,1000,1000
053159,同欣電元大96購02,0,0,0,0,0,0,0,0,0,1000,0,0,0,1000,0,1000,1000
053114,聯茂兆豐97購01  ,0,0,0,0,0,0,0,0,0,1000,0,0,0,1000,0,1000,1000
05332P,臺股指國票95售01,0,0,0,0,0,0,0,0,0,1000,0,0,0,1000,0,1000,1000
054513,元金2X元大96購01,0,0,0,0,0,0,0,0,0,1000,0,0,0,1000,0,1000,1000
05336P,臺股指國票95售05,0,0,0,0,0,0,0,0,0,1000,0,0,0,1000,0,1000,1000
05790P,臺股指永昌96售07,0,0,0,0,0,0,0,0,0,1000,0,0,0,21000,20000,1000,1000
05789P,臺股指永昌96售06,0,0,0,0,0,0,0,0,0,1000,0,0,0,11000,10000,1000,1000
05788P,臺股指永昌96售05,0,0,0,0,0,0,0,0,0,1000,0,0,0,11000,10000,1000,1000
6655,科定            ,12000,13000,-1000,0,0,0,0,0,0,2000,2000,0,2000,0,0,0,1000
8033,雷虎            ,7000,6000,1000,0,0,0,0,0,0,0,0,0,0,0,0,0,1000
8467,波力-KY         ,5000,4000,1000,0,0,0,0,0,0,0,0,0,0,0,0,0,1000
911616,杜康-DR         ,3000,2000,1000,0,0,0,0,0,0,0,0,0,0,0,0,0,1000
8427,基勝-KY         ,8000,7000,1000,0,0,0,0,0,0,0,0,0,0,0,0,0,1000
05985P,燿華統一96售03  ,0,0,0,0,0,0,0,0,0,0,0,0,0,10000,10000,0,0
06073P,健策永豐97售01  ,0,0,0,0,0,0,0,0,0,0,0,0,0,15000,15000,0,0
06046P,健策統一96售03  ,0,0,0,0,0,0,0,0,0,0,0,0,0,1000,1000,0,0
06023P,超眾國票96售03  ,0,0,0,0,0,0,0,0,0,0,0,0,0,10000,10000,0,0
06136P,華新科國泰99售02,0,0,0,0,0,0,0,0,0,0,0,0,0,2000,2000,0,0
06100P,台積電日盛97售03,0,0,0,0,0,0,0,0,0,0,0,0,0,40000,40000,0,0
06101P,聯發科日盛97售03,0,0,0,0,0,0,0,0,0,0,0,0,0,3000,3000,0,0
06184P,大立光元大97售06,0,0,0,0,0,0,0,0,0,0,0,0,0,12000,12000,0,0
06199P,聯發科元大97售17,0,0,0,0,0,0,0,0,0,0,0,0,0,5000,5000,0,0
06200P,聯發科元大97售18,0,0,0,0,0,0,0,0,0,0,0,0,0,16000,16000,0,0
059205,元石油元大99購01,0,0,0,0,0,0,0,0,0,0,0,0,0,15000,15000,0,0
05932P,鴻海凱基96售16  ,0,0,0,0,0,0,0,0,0,0,0,0,0,20000,20000,0,0
05936P,台積電凱基96售20,0,0,0,0,0,0,0,0,0,0,0,0,0,150000,150000,0,0
06545P,致茂元大98售01  ,0,0,0,0,0,0,0,0,0,0,0,0,0,10000,10000,0,0
06443P,台積電凱基99售01,0,0,0,0,0,0,0,0,0,0,0,0,0,230000,230000,0,0
06530P,元油2X元富98售13,0,0,0,0,0,0,0,0,0,0,0,0,0,70000,70000,0,0
06531P,元油2X元富98售14,0,0,0,0,0,0,0,0,0,0,0,0,0,260000,260000,0,0
06516P,國巨凱基98售08  ,0,0,0,0,0,0,0,0,0,0,0,0,0,1000,1000,0,0
06511P,元油2X中信9B售01,0,0,0,0,0,0,0,0,0,0,0,0,0,70000,70000,0,0
06473P,鴻海元大99售03  ,0,0,0,0,0,0,0,0,0,0,0,0,0,115000,115000,0,0
06491P,台積電富邦99售02,0,0,0,0,0,0,0,0,0,0,0,0,0,10000,10000,0,0
06267P,大立光凱基97售12,0,0,0,0,0,0,0,0,0,0,0,0,0,10000,10000,0,0
06298P,聯發科元大97售20,0,0,0,0,0,0,0,0,0,0,0,0,0,5000,5000,0,0
06361P,聯發科群益97售06,0,0,0,0,0,0,0,0,0,0,0,0,0,10000,10000,0,0
06365P,鴻海凱基97售09  ,0,0,0,0,0,0,0,0,0,0,0,0,0,10000,10000,0,0
06385P,聯發科永豐97售02,0,0,0,0,0,0,0,0,0,0,0,0,0,5000,5000,0,0
06372P,聯發科元大97售21,0,0,0,0,0,0,0,0,0,0,0,0,0,5000,5000,0,0
06373P,聯發科元大97售22,0,0,0,0,0,0,0,0,0,0,0,0,0,30000,30000,0,0
058313,台積電富邦9B購04,0,0,0,0,0,0,0,0,0,0,0,0,0,30000,30000,0,0
058405,訊連元大99購02  ,0,0,0,0,0,0,0,0,0,0,0,0,0,10000,10000,0,0
058485,智邦國票9A購01  ,0,0,0,0,0,0,0,0,0,0,0,0,0,5000,5000,0,0
05844P,旺宏元大96售07  ,0,0,0,0,0,0,0,0,0,0,0,0,0,23000,23000,0,0
058618,南電元大99購02  ,0,0,0,0,0,0,0,0,0,0,0,0,0,10000,10000,0,0
058624,台積電國票99購09,0,0,0,0,0,0,0,0,0,0,0,0,0,145000,145000,0,0
058568,宏達電凱基9A購02,0,0,0,0,0,0,0,0,0,0,0,0,0,64000,64000,0,0
058513,宏達電元大99購05,0,0,0,0,0,0,0,0,0,0,0,0,0,10000,10000,0,0
059063,康控凱基99購04  ,0,0,0,0,0,0,0,0,0,0,0,0,0,10000,10000,0,0
059001,聯發科元大99購17,0,0,0,0,0,0,0,0,0,0,0,0,0,123000,123000,0,0
058902,聯發科元大99購15,0,0,0,0,0,0,0,0,0,0,0,0,0,55000,55000,0,0
058919,SGBR2X元富99購05,0,0,0,0,0,0,0,0,0,0,0,0,0,3000,3000,0,0
058752,鈺齊凱基9A購01  ,0,0,0,0,0,0,0,0,0,0,0,0,0,50000,50000,0,0
4439,冠星-KY         ,2000,2000,0,0,0,0,0,0,0,0,0,0,0,0,0,0,0
4562,穎漢            ,6000,4000,2000,0,0,0,0,0,0,-2000,0,2000,-2000,0,0,0,0
3432,台端            ,7000,7000,0,0,0,0,0,0,0,0,0,0,0,0,0,0,0
5284,jpp-KY          ,3000,3000,0,0,0,0,0,0,0,0,0,0,0,0,0,0,0
4807,日成-KY         ,2000,2000,0,0,0,0,0,0,0,0,0,0,0,0,0,0,0
2484,希華            ,205000,205000,0,0,0,0,0,0,0,0,0,0,0,0,0,0,0
2491,吉祥全          ,5000,5000,0,0,0,0,0,0,0,0,0,0,0,0,0,0,0
2540,愛山林          ,10000,10000,0,0,0,0,0,0,0,0,0,0,0,0,0,0,0
06999P,玉晶光國票9B售01,0,0,0,0,0,0,0,0,0,0,0,0,0,1000,1000,0,0
06965P,台積電台新99售02,0,0,0,0,0,0,0,0,0,0,0,0,0,220000,220000,0,0
06970P,旺宏元大99售08  ,0,0,0,0,0,0,0,0,0,0,0,0,0,154000,154000,0,0
06940P,旺宏永豐98售05  ,0,0,0,0,0,0,0,0,0,0,0,0,0,10000,10000,0,0
06895P,台灣50統一9A售01,0,0,0,0,0,0,0,0,0,0,0,0,0,10000,10000,0,0
06874P,台積電台新98售02,0,0,0,0,0,0,0,0,0,0,0,0,0,265000,265000,0,0
06876P,台灣50兆豐9B售01,0,0,0,0,0,0,0,0,0,0,0,1000,-1000,1000,0,1000,0
06861P,台積電國票99售08,0,0,0,0,0,0,0,0,0,0,0,0,0,10000,10000,0,0
06866P,聯發科元大98售13,0,0,0,0,0,0,0,0,0,0,0,0,0,15000,15000,0,0
06821P,臺股指元富98售10,0,0,0,0,0,0,0,0,0,0,0,0,0,2000,2000,0,0
06773P,台灣50兆豐9A售01,0,0,0,0,0,0,0,0,0,0,0,11000,-11000,11000,0,11000,0
07032P,聯發科統一9C售02,0,0,0,0,0,0,0,0,0,0,0,0,0,1000,1000,0,0
07017P,台灣50元富9B售02,0,0,0,0,0,0,0,0,0,0,0,0,0,170000,170000,0,0
07005P,台積電統一9B售05,0,0,0,0,0,0,0,0,0,0,0,0,0,20000,20000,0,0
07081P,南電群益9A售01  ,0,0,0,0,0,0,0,0,0,0,0,0,0,3000,3000,0,0
07084P,S&P正2元富9B售02,0,0,0,0,0,0,0,0,0,0,0,0,0,25000,25000,0,0
07137P,大立光中信9B售01,0,0,0,0,0,0,0,0,0,0,0,0,0,20000,20000,0,0
07172P,臺股指國票99售09,0,0,0,0,0,0,0,0,0,0,0,0,0,199000,199000,0,0
1324,地球            ,10000,8000,2000,0,0,0,0,0,0,-2000,0,2000,-2000,0,0,0,0
1417,嘉裕            ,34000,34000,0,0,0,0,0,0,0,0,0,0,0,0,0,0,0
2208,台船            ,290000,289000,1000,0,0,0,0,0,0,-1000,0,1000,-1000,0,0,0,0
1529,樂士            ,8000,11000,-3000,0,0,0,0,0,0,3000,3000,0,3000,0,0,0,0
049599,樺漢元大95購01  ,0,0,0,0,0,0,0,0,0,0,0,0,0,42000,42000,0,0
051575,國巨元大96購03  ,0,0,0,0,0,0,0,0,0,0,0,0,0,21000,21000,0,0
050512,台泥元大94購01  ,0,0,0,0,0,0,0,0,0,0,0,0,0,7000,7000,0,0
050513,亞泥元大94購02  ,0,0,0,0,0,0,0,0,0,0,0,0,0,70000,70000,0,0
050887,台積電富邦95購05,0,0,0,0,0,0,0,0,0,0,0,0,0,10000,10000,0,0
050778,瑞儀元大96購01  ,0,0,0,0,0,0,0,0,0,0,0,0,0,1000,1000,0,0
052297,旭富國票96購01  ,0,0,0,0,0,0,0,0,0,0,0,0,0,90000,90000,0,0
052377,景碩元大96購02  ,0,0,0,0,0,0,0,0,0,0,0,0,0,10000,10000,0,0
052551,台積電國票97購03,0,0,0,0,0,0,0,0,0,0,0,0,0,20000,20000,0,0
052647,晶技永豐97購01  ,0,0,0,0,0,0,0,0,0,0,0,0,0,10000,10000,0,0
052648,茂林永豐96購01  ,0,12000,-12000,0,0,0,0,0,0,12000,0,0,0,12000,0,12000,0
051348,國巨元大95購07  ,0,0,0,0,0,0,0,0,0,0,0,0,0,10000,10000,0,0
049483,台積電元大94購12,0,0,0,0,0,0,0,0,0,0,0,0,0,20000,20000,0,0
04940P,台積電國票95售02,0,0,0,0,0,0,0,0,0,0,0,0,0,50000,50000,0,0
04942P,台積電台新94售01,0,0,0,0,0,0,0,0,0,0,0,0,0,90000,90000,0,0
049439,牧德國泰96購01  ,0,0,0,0,0,0,0,0,0,0,0,0,0,40000,40000,0,0
04944P,元油2X永豐94售06,0,0,0,0,0,0,0,0,0,0,0,0,0,949000,949000,0,0
056368,祥碩元大98購02  ,0,0,0,0,0,0,0,0,0,0,0,0,0,10000,10000,0,0
056496,康控國泰99購01  ,0,0,0,0,0,0,0,0,0,0,0,0,0,87000,87000,0,0
052180,緯穎元大96購05  ,0,0,0,0,0,0,0,0,0,0,0,0,0,10000,10000,0,0
056303,亞光元大97購04  ,0,0,0,0,0,0,0,0,0,0,0,0,0,100000,100000,0,0
056508,揚明光永豐98購01,0,0,0,0,0,0,0,0,0,0,0,0,0,70000,70000,0,0
056578,智易元大99購02  ,0,0,0,0,0,0,0,0,0,0,0,0,0,20000,20000,0,0
056579,麗豐元大99購01  ,0,0,0,0,0,0,0,0,0,0,0,0,0,19000,19000,0,0
056681,鴻海統一98購09  ,0,0,0,0,0,0,0,0,0,0,0,0,0,2000,2000,0,0
056639,國產康和98購01  ,0,0,0,0,0,0,0,0,0,0,0,0,0,5000,5000,0,0
056764,友達元大9A購03  ,0,0,0,0,0,0,0,0,0,0,0,0,0,10000,10000,0,0
05181P,健策凱基95售01  ,0,0,0,0,0,0,0,0,0,0,0,0,0,22000,22000,0,0
049928,祥碩元大94購02  ,0,0,0,0,0,0,0,0,0,0,0,0,0,10000,10000,0,0
049864,聯發科兆豐94購01,0,0,0,0,0,0,0,0,0,0,0,0,0,22000,22000,0,0
049872,聯發科台新94購03,0,0,0,0,0,0,0,0,0,0,0,0,0,22000,22000,0,0
04983P,臺股指康和94售03,0,0,0,0,0,0,0,0,0,0,0,0,0,1000,1000,0,0
04984P,臺股指康和94售04,0,0,0,0,0,0,0,0,0,0,0,0,0,1000,1000,0,0
051875,聯發科兆豐95購04,0,0,0,0,0,0,0,0,0,0,0,0,0,20000,20000,0,0
05016P,臺股指元大95售07,0,0,0,0,0,0,0,0,0,0,0,0,0,30000,30000,0,0
050036,矽格元大94購03  ,0,0,0,0,0,0,0,0,0,0,0,0,0,30000,30000,0,0
03602C,臺股指元大93牛01,0,0,0,0,0,0,0,0,0,0,0,0,0,2000,2000,0,0
03450P,元油2X元富98售05,0,0,0,0,0,0,0,0,0,0,0,0,0,180000,180000,0,0
03454P,台積電凱基03售14,0,0,0,0,0,0,0,0,0,0,0,0,0,206000,206000,0,0
03720P,元油2X富邦95售01,0,0,0,0,0,0,0,0,0,0,0,0,0,365000,365000,0,0
03892P,元油2X中信95售01,0,0,0,0,0,0,0,0,0,0,0,0,0,41000,41000,0,0
04028P,燿華凱基94售02  ,0,0,0,0,0,0,0,0,0,0,0,0,0,30000,30000,0,0
04867P,美律統一94售03  ,0,0,0,0,0,0,0,0,0,0,0,0,0,10000,10000,0,0
04857P,美律元富94售01  ,0,0,0,0,0,0,0,0,0,0,0,0,0,235000,235000,0,0
048985,茂林元大94購01  ,0,0,0,0,0,0,0,0,0,0,0,0,0,10000,10000,0,0
048937,玉晶光永豐95購01,0,0,0,0,0,0,0,0,0,0,0,0,0,120000,120000,0,0
04478P,元油2X中信95售03,0,0,0,0,0,0,0,0,0,0,0,0,0,221000,221000,0,0
04446P,元油2X凱基94售03,0,0,0,0,0,0,0,0,0,0,0,0,0,351000,351000,0,0
04460P,元油2X元富96售04,0,0,0,0,0,0,0,0,0,0,0,0,0,10000,10000,0,0
04465P,大立光元富94售03,0,0,0,0,0,0,0,0,0,0,0,0,0,1000,1000,0,0
04467P,元油2X元大94售03,0,0,0,0,0,0,0,0,0,0,0,0,0,798000,798000,0,0
03366P,TPK元大02售03   ,0,0,0,0,0,0,0,0,0,0,0,0,0,290000,290000,0,0
03298P,台積電統一03售15,0,0,0,0,0,0,0,0,0,0,0,0,0,271000,271000,0,0
03307P,臺股指中信05售02,0,0,0,0,0,0,0,0,0,0,0,0,0,334000,334000,0,0
03431B,元油2X凱基9B熊03,0,0,0,0,0,0,0,0,0,0,0,0,0,1000,1000,0,0
04443P,台積電永豐94售01,0,0,0,0,0,0,0,0,0,0,0,0,0,10000,10000,0,0
04291P,鴻海富邦93售04  ,0,0,0,0,0,0,0,0,0,0,0,0,0,50000,50000,0,0
04345P,景碩國泰94售02  ,0,0,0,0,0,0,0,0,0,0,0,0,0,10000,10000,0,0
04205P,臺股指元大93售45,0,0,0,0,0,0,0,0,0,0,0,4257000,-4257000,4257000,0,4257000,0
00774B,新光中國政金綠債,0,0,0,0,0,0,0,0,0,0,0,0,0,2000,2000,0,0
00775B,新光投等債15+   ,0,0,0,0,0,0,0,0,0,0,0,0,0,2000,2000,0,0
00776,新光ICE美國權值 ,0,0,0,0,0,0,0,0,0,0,0,0,0,2000,2000,0,0
00711B,FH彭博新興債    ,0,0,0,0,0,0,0,0,0,0,0,0,0,501000,501000,0,0
00732,國泰RMB短期報酬 ,0,0,0,0,0,0,0,0,0,0,0,0,0,100000,100000,0,0
0057,富邦摩台        ,0,0,0,0,0,0,0,0,0,0,0,0,0,20000,20000,0,0
00625K,富邦上証+R      ,0,0,0,0,0,0,0,0,0,0,0,0,0,50000,50000,0,0
00668K,國泰美國道瓊+U  ,0,0,0,0,0,0,0,0,0,0,0,0,0,100,100,0,0
00657K,國泰日經225+U   ,0,0,0,0,0,0,0,0,0,0,0,0,0,100,100,0,0
04803P,台積電凱基94售30,0,0,0,0,0,0,0,0,0,0,0,0,0,50000,50000,0,0
04816P,台積電兆豐94售06,0,0,0,0,0,0,0,0,0,0,0,0,0,10000,10000,0,0
049200,元黃金群益98購01,0,0,0,0,0,0,0,0,0,0,0,0,0,82000,82000,0,0
047435,台積電元大94購01,0,0,0,0,0,0,0,0,0,0,0,0,0,470000,470000,0,0
047556,群創凱基95購01  ,0,0,0,0,0,0,0,0,0,0,0,0,0,51000,51000,0,0
04757P,元油2X凱基94售04,0,0,0,0,0,0,0,0,0,0,0,0,0,260000,260000,0,0
048287,嘉晶兆豐94購01  ,0,0,0,0,0,0,0,0,0,0,0,0,0,350000,350000,0,0
04833P,鴻海元大94售16  ,0,0,0,0,0,0,0,0,0,0,0,0,0,23000,23000,0,0
047213,新日興富邦97購01,0,0,0,0,0,0,0,0,0,0,0,0,0,2000,2000,0,0
04924P,元油2X元大94售12,0,0,0,0,0,0,0,0,0,0,0,0,0,761000,761000,0,0
052855,群創日盛99購01  ,0,0,0,0,0,0,0,0,0,0,0,0,0,350000,350000,0,0
052838,新唐國泰98購01  ,0,0,0,0,0,0,0,0,0,0,0,0,0,10000,10000,0,0
052801,友達元大9A購01  ,0,0,0,0,0,0,0,0,0,0,0,0,0,18000,18000,0,0
052807,貿聯元大98購01  ,0,0,0,0,0,0,0,0,0,0,0,0,0,5000,5000,0,0
04627P,聯發科元大94售08,0,0,0,0,0,0,0,0,0,0,0,0,0,17000,17000,0,0
04681P,臺股指統一94售06,0,0,0,0,0,0,0,0,0,0,0,0,0,30000,30000,0,0
051103,緯穎元大96購03  ,0,0,0,0,0,0,0,0,0,0,0,0,0,28000,28000,0,0
052747,京鼎元大97購01  ,0,0,0,0,0,0,0,0,0,0,0,0,0,10000,10000,0,0
057637,上銀元大98購07  ,0,0,0,0,0,0,0,0,0,0,0,0,0,1000,1000,0,0
05787P,臺股指永昌96售04,0,0,0,0,0,0,0,0,0,0,0,0,0,11000,11000,0,0
057837,康控國泰99購02  ,0,0,0,0,0,0,0,0,0,0,0,0,0,10000,10000,0,0
057966,金融類元大98購01,0,0,0,0,0,0,0,0,0,0,0,0,0,20000,20000,0,0
058066,可成亞東99購01  ,0,0,0,0,0,0,0,0,0,0,0,0,0,25000,25000,0,0
05817P,可成凱基96售07  ,0,0,0,0,0,0,0,0,0,0,0,0,0,10000,10000,0,0
055672,國巨日盛97購02  ,0,0,0,0,0,0,0,0,0,0,0,0,0,10000,10000,0,0
055650,華新科元富98購01,0,0,0,0,0,0,0,0,0,0,0,0,0,12000,12000,0,0
055649,華新科元富97購03,0,0,0,0,0,0,0,0,0,0,0,0,0,45000,45000,0,0
055636,元油反元富97購02,0,0,0,0,0,0,0,0,0,0,0,0,0,400000,400000,0,0
055585,國巨元大98購08  ,0,0,0,0,0,0,0,0,0,0,0,0,0,30000,30000,0,0
054424,大成鋼富邦97購02,0,0,0,0,0,0,0,0,0,0,0,0,0,100000,100000,0,0
054387,台積電統一98購02,0,0,0,0,0,0,0,0,0,0,0,0,0,40000,40000,0,0
053299,台泥凱基96購01  ,0,0,0,0,0,0,0,0,0,0,0,0,0,1000,1000,0,0
053271,喬山元大97購01  ,0,0,0,0,0,0,0,0,0,0,0,0,0,1000,1000,0,0
053280,群創元大9C購01  ,0,0,0,0,0,0,0,0,0,0,0,0,0,7000,7000,0,0
05321P,鴻海凱基95售17  ,0,0,0,0,0,0,0,0,0,0,0,0,0,1000,1000,0,0
053256,上銀富邦98購01  ,0,0,0,0,0,0,0,0,0,0,0,0,0,10000,10000,0,0
05323P,瑞昱凱基96售02  ,0,0,0,0,0,0,0,0,0,0,0,0,0,20000,20000,0,0
056989,鴻海兆豐98購02  ,0,0,0,0,0,0,0,0,0,0,0,0,0,15000,15000,0,0
053162,緯穎元大97購01  ,0,0,0,0,0,0,0,0,0,0,0,0,0,41000,41000,0,0
056290,正文永豐98購01  ,0,0,0,0,0,0,0,0,0,0,0,0,0,70000,70000,0,0
056275,國巨國泰98購04  ,0,0,0,0,0,0,0,0,0,0,0,0,0,190000,190000,0,0
056224,聯發科凱基97購08,0,0,0,0,0,0,0,0,0,0,0,0,0,200000,200000,0,0
056170,鴻海元富97購09  ,0,0,0,0,0,0,0,0,0,0,0,0,0,300000,300000,0,0
056140,康控元大98購01  ,0,0,0,0,0,0,0,0,0,0,0,0,0,15000,15000,0,0
056161,康控凱基98購02  ,0,0,0,0,0,0,0,0,0,0,0,0,0,15000,15000,0,0
05615P,臺股指康和96售04,0,0,0,0,0,0,0,0,0,0,0,0,0,1000,1000,0,0
05610P,國巨群益98售01  ,0,0,0,0,0,0,0,0,0,0,0,0,0,20000,20000,0,0
055858,聯茂元大97購03  ,0,0,0,0,0,0,0,0,0,0,0,0,0,10000,10000,0,0
055847,大立光元大97購10,0,0,0,0,0,0,0,0,0,0,0,0,0,23000,23000,0,0
056055,國巨元大97購15  ,0,0,0,0,0,0,0,0,0,0,0,0,0,36000,36000,0,0
057620,康控凱基99購01  ,0,0,0,0,0,0,0,0,0,0,0,0,0,15000,15000,0,0
057593,聯發科兆豐98購03,0,0,0,0,0,0,0,0,0,0,0,0,0,100000,100000,0,0
05454P,奇鋐群益95售04  ,0,0,0,0,0,0,0,0,0,0,0,0,0,1000,1000,0,0
054959,禾伸堂元大98購01,0,0,0,0,0,0,0,0,0,0,0,0,0,20000,20000,0,0
054951,大毅元大97購01  ,0,0,0,0,0,0,0,0,0,0,0,0,0,20000,20000,0,0
055021,亞德客國泰98購01,0,0,0,0,0,0,0,0,0,0,0,0,0,64000,64000,0,0
055209,勤誠康和97購01  ,0,0,0,0,0,0,0,0,0,0,0,0,0,30000,30000,0,0
055121,鴻海兆豐97購03  ,0,0,0,0,0,0,0,0,0,0,0,0,0,20000,20000,0,0
055145,T50反1元大97購04,0,0,0,0,0,0,0,0,0,0,0,0,0,10000,10000,0,0
054043,漢唐元大97購01  ,0,0,0,0,0,0,0,0,0,0,0,0,0,64000,64000,0,0
054105,元油反凱基9A購01,0,0,0,0,0,0,0,0,0,0,0,0,0,250000,250000,0,0
054081,聯電元富96購01  ,0,0,0,0,0,0,0,0,0,0,0,0,0,10000,10000,0,0
056900,可成元大98購02  ,0,0,0,0,0,0,0,0,0,0,0,0,0,50000,50000,0,0
055220,緯穎凱基98購02  ,0,0,0,0,0,0,0,0,0,0,0,0,0,40000,40000,0,0
055728,緯穎元大97購03  ,0,0,0,0,0,0,0,0,0,0,0,0,0,5000,5000,0,0
05738P,臺股指統一97售01,0,0,0,0,0,0,0,0,0,0,0,0,0,30000,30000,0,0
057370,可成元大98購07  ,0,0,0,0,0,0,0,0,0,0,0,0,0,50000,50000,0,0
057456,道瓊銀富邦9C購01,0,0,0,0,0,0,0,0,0,0,0,0,0,15000,15000,0,0
057444,台泥元富98購01  ,0,0,0,0,0,0,0,0,0,0,0,0,0,60000,60000,0,0
057396,健鼎中信99購01  ,0,0,0,0,0,0,0,0,0,0,0,0,0,6000,6000,0,0
05415P,台積電台新95售04,0,0,0,0,0,0,0,0,0,0,0,0,0,90000,90000,0,0
055271,鴻海元大98購03  ,0,0,0,0,0,0,0,0,0,0,0,0,0,10000,10000,0,0
054336,台積電統一96購11,0,0,0,0,0,0,0,0,0,0,0,0,0,20000,20000,0,0
053449,超眾凱基98購01  ,0,0,0,0,0,0,0,0,0,0,0,0,0,1000,1000,0,0
053472,漢唐元大96購02  ,0,0,0,0,0,0,0,0,0,0,0,0,0,8000,8000,0,0
05718P,國巨元大96售09  ,0,0,0,0,0,0,0,0,0,0,0,0,0,50000,50000,0,0
057194,南電元大98購01  ,0,0,0,0,0,0,0,0,0,0,0,0,0,10000,10000,0,0
054671,國巨國泰98購01  ,0,0,0,0,0,0,0,0,0,0,0,0,0,142000,142000,0,0
054798,超眾群益97購01  ,0,0,0,0,0,0,0,0,0,0,0,0,0,1000,1000,0,0
053643,漢唐國票97購02  ,0,0,0,0,0,0,0,0,0,0,0,0,0,191000,191000,0,0
05361P,聯發科富邦97售01,0,0,0,0,0,0,0,0,0,0,0,0,0,6000,6000,0,0
057536,康控元大99購03  ,0,0,0,0,0,0,0,0,0,0,0,0,0,15000,15000,0,0
053085,華新科元大97購04,0,0,0,0,0,0,0,0,0,0,0,0,0,20000,20000,0,0
053062,緯穎富邦97購01  ,0,0,0,0,0,0,0,0,0,0,0,0,0,15000,15000,0,0
053089,貿聯元大97購02  ,0,0,0,0,0,0,0,0,0,0,0,0,0,10000,10000,0,0
053013,台積電統一97購01,0,0,0,0,0,0,0,0,0,0,0,0,0,40000,40000,0,0
053814,美律群益97購02  ,0,0,0,0,0,0,0,0,0,0,0,0,0,10000,10000,0,0
05395P,旺宏元大96售06  ,0,0,0,0,0,0,0,0,0,0,0,0,0,10000,10000,0,0
05695P,台積電凱基96售10,0,0,0,0,0,0,0,0,0,0,0,0,0,61000,61000,0,0
053388,群創元大9C購02  ,0,0,0,0,0,0,0,0,0,0,0,0,0,2000,2000,0,0
05392P,鴻海統一95售13  ,0,0,0,0,0,0,0,0,0,0,0,0,0,10000,10000,0,0
053941,國巨國泰96購05  ,0,0,0,0,0,0,0,0,0,0,0,0,0,189000,189000,0,0
2038,海光            ,24000,25000,-1000,0,0,0,0,0,0,0,0,0,0,0,0,0,-1000
1776,展宇            ,5000,6000,-1000,0,0,0,0,0,0,0,0,0,0,0,0,0,-1000
1441,大東            ,18000,19000,-1000,0,0,0,0,0,0,0,0,0,0,0,0,0,-1000
1471,首利            ,0,1000,-1000,0,0,0,0,0,0,0,0,0,0,0,0,0,-1000
07177P,臺股指凱基99售19,0,0,0,0,0,0,0,0,0,-1000,0,0,0,0,1000,-1000,-1000
07187P,臺股指台新99售10,0,0,0,0,0,0,0,0,0,-1000,0,0,0,0,1000,-1000,-1000
07094P,華通國票9A售03  ,0,0,0,0,0,0,0,0,0,-1000,0,0,0,0,1000,-1000,-1000
07026P,超眾凱基99售03  ,0,0,0,0,0,0,0,0,0,-1000,0,0,0,0,1000,-1000,-1000
06951P,台積電統一9B售02,0,0,0,0,0,0,0,0,0,-1000,0,0,0,3000,4000,-1000,-1000
06973P,臺股指元大9A售11,0,0,0,0,0,0,0,0,0,-1000,0,0,0,0,1000,-1000,-1000
2482,連宇            ,11000,12000,-1000,0,0,0,0,0,0,0,0,0,0,0,0,0,-1000
2434,統懋            ,0,1000,-1000,0,0,0,0,0,0,0,0,0,0,0,0,0,-1000
2243,宏旭-KY         ,2000,3000,-1000,0,0,0,0,0,0,0,0,0,0,0,0,0,-1000
4555,氣立            ,8000,9000,-1000,0,0,0,0,0,0,0,0,0,0,0,0,0,-1000
5906,台南-KY         ,3000,4000,-1000,0,0,0,0,0,0,0,0,0,0,0,0,0,-1000
059036,可成群益9B購03  ,0,0,0,0,0,0,0,0,0,-1000,0,0,0,0,1000,-1000,-1000
058511,華新科元大9B購01,0,0,0,0,0,0,0,0,0,-1000,0,0,0,210000,211000,-1000,-1000
058648,聯陽永豐99購01  ,0,0,0,0,0,0,0,0,0,-1000,0,0,0,0,1000,-1000,-1000
05865P,大立光元大96售09,0,0,0,0,0,0,0,0,0,-1000,0,0,0,0,1000,-1000,-1000
05846P,大立光元大96售07,0,0,0,0,0,0,0,0,0,-1000,0,0,0,10000,11000,-1000,-1000
06355P,聯茂永豐97售02  ,0,0,0,0,0,0,0,0,0,-1000,0,0,0,0,1000,-1000,-1000
06303P,臺股指元大97售09,0,0,0,0,0,0,0,0,0,-1000,0,0,0,0,1000,-1000,-1000
06429P,大立光元大97售15,0,0,0,0,0,0,0,0,0,-1000,0,0,0,0,1000,-1000,-1000
06540P,聯發科凱基98售13,0,0,0,0,0,0,0,0,0,-1000,0,0,0,0,1000,-1000,-1000
06549P,大立光元大98售11,0,0,0,0,0,0,0,0,0,-1000,0,0,0,42000,43000,-1000,-1000
06611P,祥碩國票98售01  ,0,0,0,0,0,0,0,0,0,-1000,0,0,0,0,1000,-1000,-1000
059253,康控凱基9B購02  ,0,0,0,0,0,0,0,0,0,-1000,0,0,0,0,1000,-1000,-1000
059241,旺宏凱基99購07  ,0,0,0,0,0,0,0,0,0,-1000,0,0,0,0,1000,-1000,-1000
059136,臺股指群益99購11,0,0,0,0,0,0,0,0,0,-1000,0,0,0,0,1000,-1000,-1000
06084P,宏達電元富97售02,0,0,0,0,0,0,0,0,0,-1000,0,0,0,0,1000,-1000,-1000
06062P,宏達電元富97售01,0,0,0,0,0,0,0,0,0,-1000,0,0,0,0,1000,-1000,-1000
05963P,貿聯國票97售02  ,0,0,0,0,0,0,0,0,0,-1000,0,0,0,0,1000,-1000,-1000
04587P,聯發科永豐94售02,0,0,0,0,0,0,0,0,0,-1000,0,0,0,0,1000,-1000,-1000
052849,可成統一97購01  ,0,0,0,0,0,0,0,0,0,-1000,0,0,0,0,1000,-1000,-1000
052975,嘉聯益群益96購01,0,0,0,0,0,0,0,0,0,-1000,0,0,0,0,1000,-1000,-1000
052979,上銀元大96購02  ,0,0,0,0,0,0,0,0,0,-1000,0,0,0,0,1000,-1000,-1000
052947,晶技國票97購01  ,0,0,0,0,0,0,0,0,0,-1000,0,0,0,9000,10000,-1000,-1000
052893,聯電群益98購01  ,0,0,0,0,0,0,0,0,0,-1000,0,0,0,0,1000,-1000,-1000
04560P,台積電凱基94售16,0,0,0,0,0,0,0,0,0,-1000,0,0,0,0,1000,-1000,-1000
048249,嘉澤兆豐94購01  ,0,0,0,0,0,0,0,0,0,-1000,0,0,0,0,1000,-1000,-1000
047690,美律富邦97購01  ,0,0,0,0,0,0,0,0,0,-1000,0,0,0,0,1000,-1000,-1000
00660,元大歐洲50      ,0,0,0,0,0,0,0,0,0,-1000,0,0,0,43000,44000,-1000,-1000
00657,國泰日經225     ,0,0,0,0,0,0,0,0,0,-1000,0,0,0,100000,101000,-1000,-1000
00700,富邦恒生國企    ,0,0,0,0,0,0,0,0,0,-1000,0,0,0,102000,103000,-1000,-1000
04255P,台積電國票94售03,0,0,0,0,0,0,0,0,0,-1000,0,0,0,5000,6000,-1000,-1000
03027X,元展24          ,0,0,0,0,0,0,0,0,0,-1000,0,0,0,0,1000,-1000,-1000
03010X,元展10          ,0,0,0,0,0,0,0,0,0,-1000,0,0,0,0,1000,-1000,-1000
03415B,臺股指元大93熊49,0,0,0,0,0,0,0,0,0,-1000,0,0,0,0,1000,-1000,-1000
04472P,中環元大94售01  ,0,0,0,0,0,0,0,0,0,-1000,0,0,0,0,1000,-1000,-1000
049137,華通元大95購02  ,0,0,0,0,0,0,0,0,0,-1000,0,0,0,0,1000,-1000,-1000
048902,昇陽半國泰96購01,0,0,0,0,0,0,0,0,0,-1000,0,0,0,0,1000,-1000,-1000
048891,傳奇元富97購02  ,0,0,0,0,0,0,0,0,0,-1000,0,0,0,0,1000,-1000,-1000
041534,T50反1凱基96購01,0,0,0,0,0,0,0,0,0,-1000,0,0,0,39000,40000,-1000,-1000
036628,統一台新99購01  ,0,0,0,0,0,0,0,0,0,-1000,0,0,0,0,1000,-1000,-1000
03561P,台灣50群益02售12,0,0,0,0,0,0,0,0,0,-1000,0,0,0,0,1000,-1000,-1000
051934,緯穎國票96購01  ,0,0,0,0,0,0,0,0,0,-1000,0,0,0,0,1000,-1000,-1000
04995P,台達電凱基96售03,0,0,0,0,0,0,0,0,0,-1000,0,0,0,5000,6000,-1000,-1000
051847,香港反中信99購01,0,0,0,0,0,0,0,0,0,-1000,0,0,0,0,1000,-1000,-1000
056590,樺漢統一9A購01  ,0,0,0,0,0,0,0,0,0,-1000,0,0,0,0,1000,-1000,-1000
056559,華通群益98購02  ,0,0,0,0,0,0,0,0,0,-1000,0,0,0,0,1000,-1000,-1000
05630P,大立光永昌96售06,0,0,0,0,0,0,0,0,0,-1000,0,0,0,10000,11000,-1000,-1000
056372,訊芯元大98購04  ,0,0,0,0,0,0,0,0,0,-1000,0,0,0,0,1000,-1000,-1000
04938P,亞德客國票95售01,0,0,0,0,0,0,0,0,0,-1000,0,0,0,1000,2000,-1000,-1000
052038,國巨永昌96購01  ,0,0,0,0,0,0,0,0,0,-1000,0,0,0,55000,56000,-1000,-1000
050630,大立光亞東96購01,0,0,0,0,0,0,0,0,0,-1000,0,0,0,0,1000,-1000,-1000
050527,嘉聯益元大96購01,0,0,0,0,0,0,0,0,0,-1000,0,0,0,0,1000,-1000,-1000
050385,貿聯國票95購02  ,0,0,0,0,0,0,0,0,0,-1000,0,0,0,5000,6000,-1000,-1000
051561,玉晶光國泰97購04,0,0,0,0,0,0,0,0,0,-1000,0,0,0,0,1000,-1000,-1000
04976P,中磊凱基94售01  ,0,0,0,0,0,0,0,0,0,-1000,0,0,0,10000,11000,-1000,-1000
049759,元黃金富邦9A購01,0,0,0,0,0,0,0,0,0,-1000,0,0,0,0,1000,-1000,-1000
053799,矽創中信9A購01  ,0,0,0,0,0,0,0,0,0,-1000,0,0,0,0,1000,-1000,-1000
053661,嘉澤凱基97購01  ,0,0,0,0,0,0,0,0,0,-1000,0,0,0,0,1000,-1000,-1000
053552,華新科凱基96購08,0,0,0,0,0,0,0,0,0,-1000,0,0,0,24000,25000,-1000,-1000
054820,新日興元大97購01,0,0,0,0,0,0,0,0,0,-1000,0,0,0,20000,21000,-1000,-1000
054750,聯茂凱基98購02  ,0,0,0,0,0,0,0,0,0,-1000,0,0,0,0,1000,-1000,-1000
054296,世芯元大97購01  ,0,0,0,0,0,0,0,0,0,-1000,0,0,0,0,1000,-1000,-1000
05431P,台光電統一97售01,0,0,0,0,0,0,0,0,0,-1000,0,0,0,0,1000,-1000,-1000
054355,上海銀富邦98購01,0,0,0,0,0,0,0,0,0,-1000,0,0,0,0,1000,-1000,-1000
055446,奇力新統一9A購01,0,0,0,0,0,0,0,0,0,-1000,0,0,0,0,1000,-1000,-1000
055301,台虹元大97購01  ,0,0,0,0,0,0,0,0,0,-1000,0,0,0,0,1000,-1000,-1000
055358,臻鼎凱基97購01  ,0,0,0,0,0,0,0,0,0,-1000,0,0,0,0,1000,-1000,-1000
057414,華新科日盛9A購01,0,0,0,0,0,0,0,0,0,-1000,0,0,0,0,1000,-1000,-1000
057418,台光電凱基98購04,0,0,0,0,0,0,0,0,0,-1000,0,0,0,0,1000,-1000,-1000
05752P,台積電中信96售06,0,0,0,0,0,0,0,0,0,-1000,0,0,0,0,1000,-1000,-1000
057515,智原元富98購02  ,0,0,0,0,0,0,0,0,0,-1000,0,0,0,0,1000,-1000,-1000
057272,台積電元大98購14,0,0,0,0,0,0,0,0,0,-1000,0,0,0,107000,108000,-1000,-1000
05577P,上銀凱基96售02  ,0,0,0,0,0,0,0,0,0,-1000,0,0,0,1000,2000,-1000,-1000
055753,貿聯第一98購01  ,0,0,0,0,0,0,0,0,0,-1000,0,0,0,0,1000,-1000,-1000
055744,茂林元富97購02  ,0,0,0,0,0,0,0,0,0,-1000,0,0,0,0,1000,-1000,-1000
055814,晶豪科國票97購02,0,0,0,0,0,0,0,0,0,-1000,0,0,0,0,1000,-1000,-1000
057103,禾伸堂中信9A購01,0,0,0,0,0,0,0,0,0,-1000,0,0,0,0,1000,-1000,-1000
05579P,友達凱基98售03  ,0,0,0,0,0,0,0,0,0,-1000,0,0,0,0,1000,-1000,-1000
053998,泰鼎群益98購01  ,0,0,0,0,0,0,0,0,0,-1000,0,0,0,0,1000,-1000,-1000
054028,臻鼎凱基96購03  ,0,0,0,0,0,0,0,0,0,-1000,0,0,0,0,1000,-1000,-1000
055006,晶相光元富9A購01,0,0,0,0,0,0,0,0,0,-1000,0,0,0,0,1000,-1000,-1000
054623,華新科第一97購01,0,0,0,0,0,0,0,0,0,-1000,0,0,0,0,1000,-1000,-1000
054614,玉晶光永豐97購03,0,0,0,0,0,0,0,0,0,-1000,0,0,0,0,1000,-1000,-1000
057567,嘉聯益富邦9A購01,0,0,0,0,0,0,0,0,0,-1000,0,0,0,0,1000,-1000,-1000
055952,上銀元大97購08  ,0,0,0,0,0,0,0,0,0,-1000,0,0,0,0,1000,-1000,-1000
055904,貿聯亞東99購01  ,0,0,0,0,0,0,0,0,0,-1000,0,0,0,0,1000,-1000,-1000
055831,台達電元大97購01,0,0,0,0,0,0,0,0,0,-1000,0,0,0,0,1000,-1000,-1000
055877,奇鋐元富97購01  ,0,0,0,0,0,0,0,0,0,-1000,0,0,0,66000,67000,-1000,-1000
053173,矽格群益97購01  ,0,0,0,0,0,0,0,0,0,-1000,0,0,0,5000,6000,-1000,-1000
053288,臺股指元大96購16,0,0,0,0,0,0,0,0,0,-1000,0,0,0,0,1000,-1000,-1000
058034,神達永豐98購02  ,0,0,0,0,0,0,0,0,0,-1000,0,0,0,0,1000,-1000,-1000
057988,鈺齊元富98購02  ,0,0,0,0,0,0,0,0,0,-1000,0,0,0,0,1000,-1000,-1000
057991,健策統一9C購01  ,0,0,0,0,0,0,0,0,0,-1000,0,0,0,0,1000,-1000,-1000
05784P,臺股指元大96售18,0,0,0,0,0,0,0,0,0,-1000,0,0,0,0,1000,-1000,-1000
05786P,臺股指永昌96售03,0,0,0,0,0,0,0,0,0,-1000,0,0,0,9000,10000,-1000,-1000
8499,鼎炫-KY         ,33000,34000,-1000,0,0,0,0,0,0,0,0,0,0,0,0,0,-1000
6674,鋐寶科技        ,9000,10000,-1000,0,0,0,0,0,0,0,0,0,0,0,0,0,-1000
05968P,鴻海台新96售02  ,0,0,0,0,0,0,0,0,0,-2000,0,0,0,0,2000,-2000,-2000
05989P,健策元富96售01  ,0,0,0,0,0,0,0,0,0,-2000,0,0,0,18000,20000,-2000,-2000
06043P,創意永豐96售06  ,0,0,0,0,0,0,0,0,0,-2000,0,0,0,0,2000,-2000,-2000
06172P,台虹永豐97售02  ,0,0,0,0,0,0,0,0,0,-2000,0,0,0,0,2000,-2000,-2000
059189,國泰金富邦9B購01,0,0,0,0,0,0,0,0,0,-2000,0,0,0,10000,12000,-2000,-2000
05938P,旺宏凱基96售07  ,0,0,0,0,0,0,0,0,0,-2000,0,0,0,28000,30000,-2000,-2000
059299,欣興元富99購03  ,0,0,0,0,0,0,0,0,0,-2000,0,0,0,0,2000,-2000,-2000
059277,群創元大99購05  ,0,0,0,0,0,0,0,0,0,-2000,0,0,0,6000,8000,-2000,-2000
06661P,玉晶光永豐98售05,0,0,0,0,0,0,0,0,0,-2000,0,0,0,2000,4000,-2000,-2000
06497P,大立光凱基98售11,0,0,0,0,0,0,0,0,0,-2000,0,0,0,0,2000,-2000,-2000
06206P,台積電凱基97售11,0,0,0,0,0,0,0,0,0,-2000,0,0,0,0,2000,-2000,-2000
058449,台積電永豐99購01,0,0,0,0,0,0,0,0,0,-2000,0,0,0,0,2000,-2000,-2000
058477,億光凱基9A購01  ,0,0,0,0,0,0,0,0,0,-2000,0,0,0,0,2000,-2000,-2000
058645,康控富邦01購01  ,0,0,0,0,0,0,0,0,0,-2000,0,0,0,0,2000,-2000,-2000
058498,世紀鋼群益99購01,0,0,0,0,0,0,0,0,0,-2000,0,0,0,0,2000,-2000,-2000
059017,台灣50統一9B購03,0,0,0,0,0,0,0,0,0,-2000,0,0,0,0,2000,-2000,-2000
059108,台灣50富邦9B購01,0,0,0,0,0,0,0,0,0,-2000,0,0,0,0,2000,-2000,-2000
05909P,康友元富96售02  ,0,0,0,0,0,0,0,0,0,-2000,0,0,0,0,2000,-2000,-2000
059084,鴻海元大99購24  ,0,0,0,0,0,0,0,0,0,-2000,0,0,0,118000,120000,-2000,-2000
05892P,大立光中信98售03,0,0,0,0,0,0,0,0,0,-2000,0,0,0,20000,22000,-2000,-2000
058808,大成鋼統一9B購01,0,0,0,0,0,0,0,0,0,-2000,0,0,0,0,2000,-2000,-2000
058911,茂林元大99購04  ,0,0,0,0,0,0,0,0,0,-2000,0,0,0,130000,132000,-2000,-2000
3593,力銘            ,4000,6000,-2000,0,0,0,0,0,0,0,0,0,0,0,0,0,-2000
2302,麗正            ,14000,16000,-2000,0,0,0,0,0,0,0,0,0,0,0,0,0,-2000
2887E,台新戊特        ,0,2000,-2000,0,0,0,0,0,0,0,0,0,0,0,0,0,-2000
06880P,鈺齊凱基98售03  ,0,0,0,0,0,0,0,0,0,-2000,0,0,0,0,2000,-2000,-2000
07110P,台灣50群益9B售03,0,0,0,0,0,0,0,0,0,-2000,0,0,0,30000,32000,-2000,-2000
07170P,臺股指國票99售07,0,0,0,0,0,0,0,0,0,-2000,0,0,0,0,2000,-2000,-2000
07132P,臺股指元大99售11,0,0,0,0,0,0,0,0,0,-2000,0,0,0,0,2000,-2000,-2000
1456,怡華            ,6000,8000,-2000,0,0,0,0,0,0,0,0,0,0,0,0,0,-2000
1516,川飛            ,4000,6000,-2000,0,0,0,0,0,0,0,0,0,0,0,0,0,-2000
1724,台硝            ,10000,12000,-2000,0,0,0,0,0,0,0,0,0,0,0,0,0,-2000
050489,聯詠元富94購01  ,0,0,0,0,0,0,0,0,0,-2000,0,0,0,0,2000,-2000,-2000
052987,華新科元大99購01,0,0,0,0,0,0,0,0,0,-2000,0,0,0,0,2000,-2000,-2000
052563,京元電日盛96購01,0,0,0,0,0,0,0,0,0,-2000,0,0,0,0,2000,-2000,-2000
052418,玉晶光兆豐96購01,0,0,0,0,0,0,0,0,0,-2000,0,0,0,121000,123000,-2000,-2000
05228P,大立光元富95售09,0,0,0,0,0,0,0,0,0,-2000,0,0,0,50000,52000,-2000,-2000
056556,南電凱基98購01  ,0,0,0,0,0,0,0,0,0,-2000,0,0,0,4000,6000,-2000,-2000
056506,晶豪科永豐98購02,0,0,0,0,0,0,0,0,0,-2000,0,0,0,0,2000,-2000,-2000
056584,鴻海統一9B購01  ,0,0,0,0,0,0,0,0,0,-2000,0,0,0,0,2000,-2000,-2000
056576,晶技元大99購02  ,0,0,0,0,0,0,0,0,0,-2000,0,0,0,0,2000,-2000,-2000
051752,緯穎富邦96購01  ,0,0,0,0,0,0,0,0,0,-2000,0,0,0,0,2000,-2000,-2000
03640P,百和凱基93售05  ,0,0,0,0,0,0,0,0,0,-2000,0,0,0,0,2000,-2000,-2000
04870P,大立光元富94售11,0,0,0,0,0,0,0,0,0,-2000,0,0,0,1000,3000,-2000,-2000
04514P,元石油中信97售01,0,0,0,0,0,0,0,0,0,-2000,0,0,0,0,2000,-2000,-2000
03419B,臺股指元富99熊03,0,0,0,0,0,0,0,0,0,-2000,0,0,0,0,2000,-2000,-2000
03078X,元展73          ,0,0,0,0,0,0,0,0,0,-2000,0,0,0,0,2000,-2000,-2000
04286P,滬深2X中信96售01,0,0,0,0,0,0,0,0,0,-2000,0,0,0,0,2000,-2000,-2000
04363P,儒鴻元富94售01  ,0,0,0,0,0,0,0,0,0,-2000,0,0,0,0,2000,-2000,-2000
00706L,元大S&P日圓正2  ,0,0,0,0,0,0,0,0,0,-2000,0,0,0,2000,4000,-2000,-2000
00733,富邦臺灣中小    ,0,0,0,0,0,0,0,0,0,-2000,0,0,0,205000,207000,-2000,-2000
01001T,土銀富邦R1      ,0,2000,-2000,0,0,0,0,0,0,0,0,0,0,0,0,0,-2000
00770,國泰北美科技    ,0,102000,-102000,0,0,0,0,0,0,100000,0,0,0,100000,0,100000,-2000
03006X,元展06          ,0,0,0,0,0,0,0,0,0,-2000,0,0,0,0,2000,-2000,-2000
047579,大立光群益94購02,0,0,0,0,0,0,0,0,0,-2000,0,0,0,0,2000,-2000,-2000
047406,香港反統一94購01,0,0,0,0,0,0,0,0,0,-2000,0,0,0,0,2000,-2000,-2000
04779P,大立光凱基94售10,0,0,0,0,0,0,0,0,0,-2000,0,0,0,1000,3000,-2000,-2000
047937,元金2X國票97購02,0,0,0,0,0,0,0,0,0,-2000,0,0,0,0,2000,-2000,-2000
04825P,元大金中信94售01,0,0,0,0,0,0,0,0,0,-2000,0,0,0,0,2000,-2000,-2000
04847P,聯發科凱基94售17,0,0,0,0,0,0,0,0,0,-2000,0,0,0,0,2000,-2000,-2000
05290P,國巨永豐95售04  ,0,0,0,0,0,0,0,0,0,-2000,0,0,0,213000,215000,-2000,-2000
052766,玉晶光群益9A購01,0,0,0,0,0,0,0,0,0,-2000,0,0,0,0,2000,-2000,-2000
051082,上証2X元大98購01,0,0,0,0,0,0,0,0,0,-2000,0,0,0,0,2000,-2000,-2000
057648,和碩元大98購01  ,0,0,0,0,0,0,0,0,0,-2000,0,0,0,0,2000,-2000,-2000
058077,超眾凱基98購02  ,0,0,0,0,0,0,0,0,0,-2000,0,0,0,60000,62000,-2000,-2000
058158,台積電台新99購01,0,0,0,0,0,0,0,0,0,-2000,0,0,0,70000,72000,-2000,-2000
058121,國巨國票9A購01  ,0,0,0,0,0,0,0,0,0,-2000,0,0,0,0,2000,-2000,-2000
058261,大立光富邦03購01,0,0,0,0,0,0,0,0,0,-2000,0,0,0,0,2000,-2000,-2000
05781P,臺股指統一99售02,0,0,0,0,0,0,0,0,0,-2000,0,0,0,0,2000,-2000,-2000
05315P,鴻海永昌96售08  ,0,0,0,0,0,0,0,0,0,-2000,0,0,0,0,2000,-2000,-2000
055827,中石化元大98購01,0,0,0,0,0,0,0,0,0,-2000,0,0,0,0,2000,-2000,-2000
057577,廣宇中信9A購01  ,0,0,0,0,0,0,0,0,0,-2000,0,0,0,0,2000,-2000,-2000
054576,健策元大98購03  ,0,0,0,0,0,0,0,0,0,-2000,0,0,0,0,2000,-2000,-2000
055103,南港凱基97購01  ,0,0,0,0,0,0,0,0,0,-2000,0,0,0,0,2000,-2000,-2000
054000,訊芯群益96購02  ,0,0,0,0,0,0,0,0,0,-2000,0,0,0,0,2000,-2000,-2000
05689P,滬深2X中信97售02,0,0,0,0,0,0,0,0,0,-2000,0,0,0,150000,152000,-2000,-2000
054069,亞光國泰98購01  ,0,0,0,0,0,0,0,0,0,-2000,0,0,0,0,2000,-2000,-2000
055180,文曄統一97購01  ,0,0,0,0,0,0,0,0,0,-2000,0,0,0,0,2000,-2000,-2000
057130,全新凱基98購03  ,0,0,0,0,0,0,0,0,0,-2000,0,0,0,0,2000,-2000,-2000
057189,康控元大98購02  ,0,0,0,0,0,0,0,0,0,-2000,0,0,0,15000,17000,-2000,-2000
057398,台郡中信99購01  ,0,0,0,0,0,0,0,0,0,-2000,0,0,0,0,2000,-2000,-2000
057445,華通元富02購01  ,0,0,0,0,0,0,0,0,0,-2000,0,0,0,0,2000,-2000,-2000
057478,智邦元大99購01  ,0,0,0,0,0,0,0,0,0,-2000,0,0,0,165000,167000,-2000,-2000
054741,亞光凱基99購01  ,0,0,0,0,0,0,0,0,0,-2000,0,0,0,0,2000,-2000,-2000
05468P,鴻海元大96售14  ,0,0,0,0,0,0,0,0,0,-2000,0,0,0,132000,134000,-2000,-2000
054694,聯鈞永豐97購01  ,0,0,0,0,0,0,0,0,0,-2000,0,0,0,0,2000,-2000,-2000
05470P,康控元大95售05  ,0,0,0,0,0,0,0,0,0,-2000,0,0,0,0,2000,-2000,-2000
05720P,可成中信98售01  ,0,0,0,0,0,0,0,0,0,-2000,0,0,0,3000,5000,-2000,-2000
053086,宏達電元大97購01,0,0,0,0,0,0,0,0,0,-2000,0,0,0,0,2000,-2000,-2000
053006,玉晶光永豐96購03,0,0,0,0,0,0,0,0,0,-2000,0,0,0,0,2000,-2000,-2000
05394P,聯詠中信95售02  ,0,0,0,0,0,0,0,0,0,-2000,0,0,0,2000,4000,-2000,-2000
9902,台火            ,24000,26000,-2000,0,0,0,0,0,0,0,0,0,0,0,0,0,-2000
1727,中華化          ,10000,14000,-4000,0,0,0,0,0,0,1000,1000,0,1000,0,0,0,-3000
1587,吉茂            ,12000,15000,-3000,0,0,0,0,0,0,0,0,0,0,0,0,0,-3000
2007,燁興            ,34000,37000,-3000,0,0,0,0,0,0,0,0,0,0,0,0,0,-3000
1454,台富            ,15000,18000,-3000,0,0,0,0,0,0,0,0,0,0,0,0,0,-3000
1414,東和            ,27000,30000,-3000,0,0,0,0,0,0,0,0,0,0,0,0,0,-3000
07222P,台灣50元大01售04,0,0,0,0,0,0,0,0,0,-3000,0,0,0,0,3000,-3000,-3000
1236,宏亞            ,9000,13000,-4000,0,0,0,0,0,0,1000,1000,0,1000,0,0,0,-3000
06802P,緯穎群益98售03  ,0,0,0,0,0,0,0,0,0,-3000,0,0,0,7000,10000,-3000,-3000
06974P,臺股指元大9A售12,0,0,0,0,0,0,0,0,0,-3000,0,0,0,0,3000,-3000,-3000
2936,客思達-KY       ,10000,13000,-3000,0,0,0,0,0,0,0,0,0,0,0,0,0,-3000
2468,華經            ,7000,10000,-3000,0,0,0,0,0,0,0,0,0,0,0,0,0,-3000
4540,全球傳動        ,113000,116000,-3000,0,0,0,0,0,0,0,0,0,0,0,0,0,-3000
3025,星通            ,26000,29000,-3000,0,0,0,0,0,0,0,0,0,0,0,0,0,-3000
4572,駐龍            ,13000,16000,-3000,0,0,0,0,0,0,0,0,0,0,0,0,0,-3000
058947,SGBR2X群益9B購02,0,0,0,0,0,0,0,0,0,-3000,0,0,0,0,3000,-3000,-3000
058553,合勤控永豐99購01,0,0,0,0,0,0,0,0,0,-3000,0,0,0,0,3000,-3000,-3000
058615,矽創元大99購01  ,0,0,0,0,0,0,0,0,0,-3000,0,0,0,12000,15000,-3000,-3000
06338P,亞德客統一97售02,0,0,0,0,0,0,0,0,0,-3000,0,0,0,0,3000,-3000,-3000
06477P,緯穎國票99售02  ,0,0,0,0,0,0,0,0,0,-3000,0,0,0,0,3000,-3000,-3000
06613P,華新科富邦9A售03,0,0,0,0,0,0,0,0,0,-3000,0,0,0,0,3000,-3000,-3000
06569P,可成永豐98售01  ,0,0,0,0,0,0,0,0,0,-3000,0,0,0,20000,23000,-3000,-3000
059230,滬深2X國票9B購02,0,0,0,0,0,0,0,0,0,-3000,0,0,0,0,3000,-3000,-3000
06099P,鴻海日盛97售03  ,0,0,0,0,0,0,0,0,0,-3000,0,0,0,0,3000,-3000,-3000
05969P,台積電台新96售04,0,0,0,0,0,0,0,0,0,-3000,0,0,0,20000,23000,-3000,-3000
052809,訊芯元大97購01  ,0,0,0,0,0,0,0,0,0,-3000,0,0,0,115000,118000,-3000,-3000
04813P,智邦元大94售07  ,0,0,0,0,0,0,0,0,0,-3000,0,0,0,0,3000,-3000,-3000
04820P,聯茂永豐94售02  ,0,0,0,0,0,0,0,0,0,-3000,0,0,0,0,3000,-3000,-3000
04547P,高鐵元大94售01  ,0,0,0,0,0,0,0,0,0,-3000,0,0,0,7000,10000,-3000,-3000
04708P,國巨元大94售11  ,0,0,0,0,0,0,0,0,0,-3000,0,0,0,247000,250000,-3000,-3000
04714P,上海銀元大94售01,0,0,0,0,0,0,0,0,0,-3000,0,0,0,0,3000,-3000,-3000
047995,台達電元大96購01,0,0,0,0,0,0,0,0,0,-3000,0,0,0,0,3000,-3000,-3000
01007T,兆豐國泰R2      ,0,3000,-3000,0,0,0,0,0,0,0,0,0,0,0,0,0,-3000
00735,國泰臺韓科技    ,0,68000,-68000,0,0,0,0,0,0,65000,0,0,0,165000,100000,65000,-3000
04353P,全新永豐94售01  ,0,0,0,0,0,0,0,0,0,-3000,0,0,0,0,3000,-3000,-3000
04354P,華新科永豐94售01,0,0,0,0,0,0,0,0,0,-3000,0,0,0,2000,5000,-3000,-3000
04495P,台積電國票95售01,0,0,0,0,0,0,0,0,0,-3000,0,0,0,50000,53000,-3000,-3000
050927,聯詠凱基95購01  ,0,0,0,0,0,0,0,0,0,-3000,0,0,0,0,3000,-3000,-3000
051818,國巨統一95購02  ,0,0,0,0,0,0,0,0,0,-3000,0,0,0,0,3000,-3000,-3000
052132,旺宏凱基9B購01  ,0,0,0,0,0,0,0,0,0,-3000,0,0,0,0,3000,-3000,-3000
056616,台光電永豐98購01,0,0,0,0,0,0,0,0,0,-3000,0,0,0,0,3000,-3000,-3000
056825,深中小富邦9B購01,0,0,0,0,0,0,0,0,0,-3000,0,0,0,6000,9000,-3000,-3000
052371,元金2X元大95購01,0,0,0,0,0,0,0,0,0,-3000,0,0,0,288000,291000,-3000,-3000
052625,南電亞東97購01  ,0,0,0,0,0,0,0,0,0,-3000,0,0,0,480000,483000,-3000,-3000
049589,奇力新元大95購02,0,0,0,0,0,0,0,0,0,-3000,0,0,0,0,3000,-3000,-3000
050437,聯詠凱基94購04  ,0,0,0,0,0,0,0,0,0,-3000,0,0,0,12000,15000,-3000,-3000
051560,玉晶光國泰97購03,0,0,0,0,0,0,0,0,0,-3000,0,0,0,2000,5000,-3000,-3000
053949,康控富邦9A購01  ,0,0,0,0,0,0,0,0,0,-3000,0,0,0,0,3000,-3000,-3000
053053,京元電國票97購02,0,0,0,0,0,0,0,0,0,-3000,0,0,0,0,3000,-3000,-3000
057233,聯發科凱基98購14,0,0,0,0,0,0,0,0,0,-3000,0,0,0,20000,23000,-3000,-3000
054297,台郡元大98購01  ,0,0,0,0,0,0,0,0,0,-3000,0,0,0,0,3000,-3000,-3000
054263,聯茂元大96購02  ,0,0,0,0,0,0,0,0,0,-3000,0,0,0,30000,33000,-3000,-3000
057483,微星元大98購04  ,0,0,0,0,0,0,0,0,0,-3000,0,0,0,0,3000,-3000,-3000
056920,友達兆豐98購02  ,0,0,0,0,0,0,0,0,0,-3000,0,0,0,0,3000,-3000,-3000
056389,鴻海富邦99購01  ,0,0,0,0,0,0,0,0,0,-3000,0,0,0,0,3000,-3000,-3000
05714P,群創統一97售03  ,0,0,0,0,0,0,0,0,0,-3000,0,0,0,0,3000,-3000,-3000
056902,大立光元大98購12,0,0,0,0,0,0,0,0,0,-3000,0,0,0,0,3000,-3000,-3000
056911,緯穎元大99購01  ,0,0,0,0,0,0,0,0,0,-3000,0,0,0,84000,87000,-3000,-3000
054865,可成群益97購01  ,0,0,0,0,0,0,0,0,0,-3000,0,0,0,0,3000,-3000,-3000
05485P,旺宏凱基95售08  ,0,0,0,0,0,0,0,0,0,-3000,0,0,0,32000,35000,-3000,-3000
057591,鴻海兆豐99購01  ,0,0,0,0,0,0,0,0,0,-3000,0,0,0,0,3000,-3000,-3000
053152,大立光元大99購01,0,0,0,0,0,0,0,0,0,-3000,0,0,0,0,3000,-3000,-3000
057765,康舒凱基98購01  ,0,0,0,0,0,0,0,0,0,-3000,0,0,0,0,3000,-3000,-3000
054491,瀚宇博台新96購02,0,0,0,0,0,0,0,0,0,-3000,0,0,0,0,3000,-3000,-3000
058085,景碩群益9A購01  ,0,0,0,0,0,0,0,0,0,-3000,0,0,0,0,3000,-3000,-3000
9912,偉聯            ,10000,11000,-1000,0,0,0,0,0,0,-2000,0,2000,-2000,0,0,0,-3000
9926,新海            ,12000,15000,-3000,0,0,0,0,0,0,0,0,0,0,0,0,0,-3000
8481,政伸            ,7000,10000,-3000,0,0,0,0,0,0,0,0,0,0,0,0,0,-3000
8443,阿瘦            ,10000,12000,-2000,0,0,0,0,0,0,-1000,0,1000,-1000,0,0,0,-3000
06133P,帆宣元富97售02  ,0,0,0,0,0,0,0,0,0,-4000,0,0,0,3000,7000,-4000,-4000
059214,國巨元大99購20  ,0,0,0,0,0,0,0,0,0,-4000,0,0,0,103000,107000,-4000,-4000
059246,奇力新凱基9A購02,0,0,0,0,0,0,0,0,0,-4000,0,0,0,0,4000,-4000,-4000
059294,宏達電元富9B購02,0,0,0,0,0,0,0,0,0,-4000,0,0,0,0,4000,-4000,-4000
059117,禾伸堂永豐99購01,0,0,0,0,0,0,0,0,0,-4000,0,0,0,3000,7000,-4000,-4000
059124,台積電第一03購01,0,0,0,0,0,0,0,0,0,-4000,0,0,0,0,4000,-4000,-4000
06535P,可成群益99售02  ,0,0,0,0,0,0,0,0,0,-4000,0,0,0,0,4000,-4000,-4000
058593,大立光統一9B購02,0,0,0,0,0,0,0,0,0,-4000,0,0,0,0,4000,-4000,-4000
05889P,群創元大98售02  ,0,0,0,0,0,0,0,0,0,-4000,0,0,0,0,4000,-4000,-4000
058726,宏達電富邦9A購01,0,0,0,0,0,0,0,0,0,-4000,0,0,0,0,4000,-4000,-4000
4755,三福化          ,6000,10000,-4000,0,0,0,0,0,0,0,1000,1000,0,0,0,0,-4000
6165,捷泰            ,41000,45000,-4000,0,0,0,0,0,0,0,0,0,0,0,0,0,-4000
6205,詮欣            ,7000,11000,-4000,0,0,0,0,0,0,0,0,0,0,0,0,0,-4000
3054,立萬利          ,11000,15000,-4000,0,0,0,0,0,0,0,0,0,0,0,0,0,-4000
3694,海華            ,19000,23000,-4000,0,0,0,0,0,0,0,0,0,0,0,0,0,-4000
2630,亞航            ,7000,14000,-7000,0,0,0,0,0,0,3000,3000,0,3000,0,0,0,-4000
06911P,鴻海元大99售09  ,0,0,0,0,0,0,0,0,0,-4000,0,0,0,246000,250000,-4000,-4000
07157P,臺股指元富99售12,0,0,0,0,0,0,0,0,0,-4000,0,0,0,0,4000,-4000,-4000
07064P,臺股指元大9A售25,0,0,0,0,0,0,0,0,0,-4000,0,0,0,0,4000,-4000,-4000
1416,廣豐            ,13000,17000,-4000,0,0,0,0,0,0,0,0,0,0,0,0,0,-4000
1735,日勝化          ,7000,11000,-4000,0,0,0,0,0,0,0,0,0,0,0,0,0,-4000
04964P,鴻海元大94售26  ,0,0,0,0,0,0,0,0,0,-4000,0,0,0,7000,11000,-4000,-4000
050673,旺宏富邦96購02  ,0,0,0,0,0,0,0,0,0,-4000,0,0,0,10000,14000,-4000,-4000
049487,智邦元大94購03  ,0,0,0,0,0,0,0,0,0,-4000,0,0,0,0,4000,-4000,-4000
05230P,京元電群益95售01,0,0,0,0,0,0,0,0,0,-4000,0,0,0,0,4000,-4000,-4000
052322,力成元大96購01  ,0,0,0,0,0,0,0,0,0,-4000,0,0,0,0,4000,-4000,-4000
052470,華新科亞東97購01,0,0,0,0,0,0,0,0,0,-4000,0,0,0,0,4000,-4000,-4000
056738,國巨凱基9A購02  ,0,0,0,0,0,0,0,0,0,-4000,0,0,0,0,4000,-4000,-4000
056610,鴻海永豐98購01  ,0,0,0,0,0,0,0,0,0,-4000,0,0,0,0,4000,-4000,-4000
056497,GIS國泰99購01   ,0,0,0,0,0,0,0,0,0,-4000,0,0,0,66000,70000,-4000,-4000
052123,泰碩國票95購01  ,0,0,0,0,0,0,0,0,0,-4000,0,0,0,0,4000,-4000,-4000
04985P,景碩永豐94售02  ,0,0,0,0,0,0,0,0,0,-4000,0,0,0,0,4000,-4000,-4000
05007P,旺宏元富95售01  ,0,0,0,0,0,0,0,0,0,-4000,0,0,0,0,4000,-4000,-4000
03560P,台積電兆豐03售10,0,0,0,0,0,0,0,0,0,-4000,0,0,0,0,4000,-4000,-4000
04866P,台積電統一95售02,0,0,0,0,0,0,0,0,0,-4000,0,0,0,0,4000,-4000,-4000
03022X,富展01          ,0,0,0,0,0,0,0,0,0,-4000,0,0,0,0,4000,-4000,-4000
00661,元大日經225     ,0,0,0,0,0,0,0,0,0,-4000,0,0,0,1000,5000,-4000,-4000
00666R,富邦恒生國企反1 ,4000,0,4000,0,0,0,0,0,0,-8000,0,0,0,82000,90000,-8000,-4000
00684R,元大美元指數反1 ,0,0,0,0,0,0,0,0,0,-4000,0,0,0,5000,9000,-4000,-4000
05279P,上銀元大95售02  ,0,0,0,0,0,0,0,0,0,-4000,0,0,0,9000,13000,-4000,-4000
049255,旺宏元大97購02  ,0,0,0,0,0,0,0,0,0,-4000,0,0,0,0,4000,-4000,-4000
058250,台虹元大99購01  ,0,0,0,0,0,0,0,0,0,-4000,0,0,0,6000,10000,-4000,-4000
058041,FBVIX元大98購02 ,0,0,0,0,0,0,0,0,0,-4000,0,0,0,0,4000,-4000,-4000
054371,台積電中信9C購01,0,0,0,0,0,0,0,0,0,-4000,0,0,0,61000,65000,-4000,-4000
056286,奇鋐永豐97購01  ,0,0,0,0,0,0,0,0,0,-4000,0,0,0,0,4000,-4000,-4000
055193,世芯元富97購02  ,0,0,0,0,0,0,0,0,0,-4000,0,0,0,0,4000,-4000,-4000
05298P,上銀元大95售03  ,0,0,0,0,0,0,0,0,0,-4000,0,0,0,0,4000,-4000,-4000
053703,緯穎兆豐96購01  ,0,0,0,0,0,0,0,0,0,-4000,0,0,0,6000,10000,-4000,-4000
9928,中視            ,0,0,0,0,0,0,0,0,0,-4000,0,4000,-4000,0,0,0,-4000
9918,欣天然          ,15000,19000,-4000,0,0,0,0,0,0,0,0,0,0,0,0,0,-4000
8940,新天地          ,5000,8000,-3000,0,0,0,0,0,0,-1000,0,1000,-1000,0,0,0,-4000
912000,晨訊科-DR       ,0,4000,-4000,0,0,0,0,0,0,0,0,0,0,0,0,0,-4000
6464,台數科          ,8000,12000,-4000,0,0,0,0,0,0,0,0,0,0,0,0,0,-4000
6477,安集            ,36000,51000,-15000,0,0,0,1000,0,1000,10000,11000,1000,10000,0,0,0,-4000
9941A,裕融甲特        ,0,4000,-4000,0,0,0,0,0,0,0,0,0,0,0,0,0,-4000
1568,倉佑            ,11000,16000,-5000,0,0,0,0,0,0,0,0,0,0,0,0,0,-5000
1466,聚隆            ,8000,12000,-4000,0,0,0,0,0,0,-1000,0,1000,-1000,0,0,0,-5000
07226P,貿聯富邦9B售01  ,0,0,0,0,0,0,0,0,0,-5000,0,0,0,0,5000,-5000,-5000
07049P,聯發科中信99售03,0,0,0,0,0,0,0,0,0,-5000,0,0,0,43000,48000,-5000,-5000
07012P,智邦群益9A售01  ,0,0,0,0,0,0,0,0,0,-5000,0,0,0,0,5000,-5000,-5000
07116P,台灣50麥證9A售02,0,0,0,29000,34000,-5000,0,0,0,-5000,0,0,0,29000,34000,-5000,-5000
06956P,國巨日盛99售04  ,0,0,0,0,0,0,0,0,0,-5000,0,0,0,30000,35000,-5000,-5000
06776P,鴻海元大99售05  ,0,0,0,0,0,0,0,0,0,-5000,0,0,0,25000,30000,-5000,-5000
06884P,台郡群益98售03  ,0,0,0,0,0,0,0,0,0,-5000,0,0,0,0,5000,-5000,-5000
06894P,鈺齊元富98售03  ,0,0,0,0,0,0,0,0,0,-5000,0,0,0,0,5000,-5000,-5000
2611,志信            ,13000,18000,-5000,0,0,0,0,0,0,0,0,0,0,0,0,0,-5000
2613,中櫃            ,12000,17000,-5000,0,0,0,0,0,0,0,0,0,0,0,0,0,-5000
2739,寒舍            ,7000,12000,-5000,0,0,0,0,0,0,0,0,0,0,0,0,0,-5000
3027,盛達            ,9000,14000,-5000,0,0,0,0,0,0,0,0,0,0,0,0,0,-5000
6172,互億            ,2000,7000,-5000,0,0,0,0,0,0,0,0,0,0,0,0,0,-5000
4763,材料-KY         ,80000,119000,-39000,0,0,0,40000,0,40000,-6000,1000,7000,-6000,0,0,0,-5000
058803,世紀鋼元大99購03,0,0,0,0,0,0,0,0,0,-5000,0,0,0,118000,123000,-5000,-5000
058920,SGBR2X元富99購06,0,0,0,0,0,0,0,0,0,-5000,0,0,0,0,5000,-5000,-5000
058630,日月光國票9A購01,0,0,0,0,0,0,0,0,0,-5000,0,0,0,0,5000,-5000,-5000
058655,鴻海中信03購02  ,0,0,0,0,0,0,0,0,0,-5000,0,0,0,0,5000,-5000,-5000
058334,鴻海元富99購05  ,0,0,0,0,0,0,0,0,0,-5000,0,0,0,0,5000,-5000,-5000
06467P,旺宏統一98售01  ,0,0,0,0,0,0,0,0,0,-5000,0,0,0,5000,10000,-5000,-5000
06356P,啟碁永豐97售01  ,0,0,0,0,0,0,0,0,0,-5000,0,0,0,0,5000,-5000,-5000
06548P,大立光元大98售10,0,0,0,0,0,0,0,0,0,-5000,0,0,0,0,5000,-5000,-5000
06729P,聯詠元大98售03  ,0,0,0,0,0,0,0,0,0,-5000,0,0,0,1000,6000,-5000,-5000
059271,台灣50元大01購05,0,0,0,0,0,0,0,0,0,-5000,0,0,0,0,5000,-5000,-5000
06189P,華新科永豐97售03,0,0,0,0,0,0,0,0,0,-5000,0,0,0,15000,20000,-5000,-5000
06205P,台積電群益97售03,0,0,0,0,0,0,0,0,0,-5000,0,0,0,0,5000,-5000,-5000
06018P,康控凱基96售03  ,0,0,0,0,0,0,0,0,0,-5000,0,0,0,5000,10000,-5000,-5000
06010P,國泰金元富96售01,0,0,0,0,0,0,0,0,0,-5000,0,0,0,10000,15000,-5000,-5000
052945,嘉晶國票97購01  ,0,0,0,0,0,0,0,0,0,-5000,0,0,0,0,5000,-5000,-5000
05119P,聯發科國泰96售02,0,0,0,0,0,0,0,0,0,-5000,0,0,0,0,5000,-5000,-5000
051119,光寶科群益95購01,0,0,0,0,0,0,0,0,0,-5000,0,0,0,0,5000,-5000,-5000
048102,矽力凱基94購01  ,0,0,0,0,0,0,0,0,0,-5000,0,0,0,0,5000,-5000,-5000
048105,滬深2X群益99購02,0,0,0,0,0,0,0,0,0,-5000,0,0,0,30000,35000,-5000,-5000
048128,超眾元大95購01  ,0,0,0,0,0,0,0,0,0,-5000,0,0,0,0,5000,-5000,-5000
04786P,鴻海永昌96售01  ,0,0,0,0,0,0,0,0,0,-5000,0,0,0,0,5000,-5000,-5000
04755P,大立光元富94售07,0,0,0,0,0,0,0,0,0,-5000,0,0,0,0,5000,-5000,-5000
04690P,國巨群益94售06  ,0,0,0,0,0,0,0,0,0,-5000,0,0,0,5000,10000,-5000,-5000
00683L,元大美元指數正2 ,0,0,0,0,0,0,0,0,0,-5000,0,0,0,20000,25000,-5000,-5000
03945P,欣興群益94售01  ,0,0,0,0,0,0,0,0,0,-5000,0,0,0,0,5000,-5000,-5000
03657C,T50反1元大99牛01,0,0,0,0,0,0,0,0,0,-5000,0,0,0,0,5000,-5000,-5000
03583P,微星元大02售03  ,0,0,0,0,0,0,0,0,0,-5000,0,0,0,0,5000,-5000,-5000
03896P,長榮航凱基95售01,0,0,0,0,0,0,0,0,0,-5000,0,0,0,549000,554000,-5000,-5000
03826P,瀚宇博元大95售01,0,0,0,0,0,0,0,0,0,-5000,0,0,0,100000,105000,-5000,-5000
04452P,超眾國泰95售01  ,0,0,0,0,0,0,0,0,0,-5000,0,0,0,0,5000,-5000,-5000
056305,群創元大9A購03  ,0,0,0,0,0,0,0,0,0,-5000,0,0,0,0,5000,-5000,-5000
052231,景碩凱基96購01  ,0,0,0,0,0,0,0,0,0,-5000,0,0,0,0,5000,-5000,-5000
056636,台積電日盛9A購01,0,0,0,0,0,0,0,0,0,-5000,0,0,0,0,5000,-5000,-5000
056621,宏達電永豐98購01,0,0,0,0,0,0,0,0,0,-5000,0,0,0,0,5000,-5000,-5000
05665P,台積電凱基96售08,0,0,0,0,0,0,0,0,0,-5000,0,0,0,0,5000,-5000,-5000
056658,美食元大98購01  ,0,0,0,0,0,0,0,0,0,-5000,0,0,0,0,5000,-5000,-5000
056685,光罩統一98購03  ,0,0,0,0,0,0,0,0,0,-5000,0,0,0,0,5000,-5000,-5000
052319,可成元大95購12  ,0,0,0,0,0,0,0,0,0,-5000,0,0,0,0,5000,-5000,-5000
052597,茂林群益96購01  ,0,0,0,0,0,0,0,0,0,-5000,0,0,0,0,5000,-5000,-5000
05263P,台積電元大96售09,0,0,0,0,0,0,0,0,0,-5000,0,0,0,26000,31000,-5000,-5000
052682,上銀元大97購01  ,0,0,0,0,0,0,0,0,0,-5000,0,0,0,0,5000,-5000,-5000
051944,智邦統一95購02  ,0,0,0,0,0,0,0,0,0,-5000,0,0,0,0,5000,-5000,-5000
049485,台積電元大96購03,0,0,0,0,0,0,0,0,0,-5000,0,0,0,15000,20000,-5000,-5000
049591,開發金元大98購01,0,0,0,0,0,0,0,0,0,-5000,0,0,0,0,5000,-5000,-5000
051339,智易永豐95購02  ,0,0,0,0,0,0,0,0,0,-5000,0,0,0,0,5000,-5000,-5000
050665,南電台新94購01  ,0,0,0,0,0,0,0,0,0,-5000,0,0,0,0,5000,-5000,-5000
05044P,亞德客永豐95售01,0,0,0,0,0,0,0,0,0,-5000,0,0,0,0,5000,-5000,-5000
051439,川湖元大95購01  ,0,0,0,0,0,0,0,0,0,-5000,0,0,0,0,5000,-5000,-5000
04974P,聯發科凱基96售02,0,0,0,0,0,0,0,0,0,-5000,0,0,0,0,5000,-5000,-5000
053950,緯穎富邦97購02  ,0,0,0,0,0,0,0,0,0,-5000,0,0,0,0,5000,-5000,-5000
053952,南亞科台新96購01,0,0,0,0,0,0,0,0,0,-5000,0,0,0,0,5000,-5000,-5000
053024,國巨富邦97購02  ,0,0,0,0,0,0,0,0,0,-5000,0,0,0,3000,8000,-5000,-5000
053593,晶技元大98購01  ,0,0,0,0,0,0,0,0,0,-5000,0,0,0,0,5000,-5000,-5000
053596,嘉澤元大96購01  ,0,0,0,0,0,0,0,0,0,-5000,0,0,0,0,5000,-5000,-5000
053391,嘉聯益元大99購01,0,0,0,0,0,0,0,0,0,-5000,0,0,0,10000,15000,-5000,-5000
055371,正崴元大97購02  ,0,0,0,0,0,0,0,0,0,-5000,0,0,0,0,5000,-5000,-5000
054774,同欣電國票98購01,0,0,0,0,0,0,0,0,0,-5000,0,0,0,0,5000,-5000,-5000
057000,亞德客國票99購01,0,0,0,0,0,0,0,0,0,-5000,0,0,0,5000,10000,-5000,-5000
056867,華通麥證98購01  ,0,0,0,0,5000,-5000,0,0,0,-5000,0,0,0,0,5000,-5000,-5000
056845,揚明光元富98購01,0,0,0,0,0,0,0,0,0,-5000,0,0,0,15000,20000,-5000,-5000
055241,T50反1統一99購01,0,0,0,0,0,0,0,0,0,-5000,0,0,0,0,5000,-5000,-5000
05419P,矽力永豐95售02  ,0,0,0,0,0,0,0,0,0,-5000,0,0,0,0,5000,-5000,-5000
056439,華邦電凱基98購02,0,0,0,0,0,0,0,0,0,-5000,0,0,0,0,5000,-5000,-5000
05640P,旺宏元富96售03  ,0,0,0,0,0,0,0,0,0,-5000,0,0,0,0,5000,-5000,-5000
057518,世紀鋼元富98購01,0,0,0,0,0,0,0,0,0,-5000,0,0,0,15000,20000,-5000,-5000
057271,國巨元大98購17  ,0,0,0,0,0,0,0,0,0,-5000,0,0,0,20000,25000,-5000,-5000
056218,億光中信98購01  ,0,0,0,0,0,0,0,0,0,-5000,0,0,0,0,5000,-5000,-5000
05581P,華新科凱基96售07,0,0,0,0,0,0,0,0,0,-5000,0,0,0,1000,6000,-5000,-5000
057049,新日興元大98購02,0,0,0,0,0,0,0,0,0,-5000,0,0,0,10000,15000,-5000,-5000
057058,祥碩元大98購04  ,0,0,0,0,0,0,0,0,0,-5000,0,0,0,119000,124000,-5000,-5000
055933,欣興群益98購02  ,0,0,0,0,0,0,0,0,0,-5000,0,0,0,0,5000,-5000,-5000
055958,台光電元大97購02,0,0,0,0,0,0,0,0,0,-5000,0,0,0,5000,10000,-5000,-5000
055994,聯發科國泰99購02,0,0,0,0,0,0,0,0,0,-5000,0,0,0,0,5000,-5000,-5000
054643,上証2X群益9B購01,0,0,0,0,0,0,0,0,0,-5000,0,0,0,0,5000,-5000,-5000
054565,玉晶光群益99購02,0,0,0,0,0,0,0,0,0,-5000,0,0,0,5000,10000,-5000,-5000
055470,南亞科凱基97購01,0,0,0,0,0,0,0,0,0,-5000,0,0,0,0,5000,-5000,-5000
055471,聯發科凱基97購04,0,0,0,0,0,0,0,0,0,-5000,0,0,0,0,5000,-5000,-5000
054917,聯發科凱基98購05,0,0,0,0,0,0,0,0,0,-5000,0,0,0,0,5000,-5000,-5000
05696P,南亞科凱基96售01,0,0,0,0,0,0,0,0,0,-5000,0,0,0,19000,24000,-5000,-5000
055571,鴻海統一97購03  ,0,0,0,0,0,0,0,0,0,-5000,0,0,0,0,5000,-5000,-5000
053273,國巨元大96購08  ,0,0,0,0,0,0,0,0,0,-5000,0,0,0,0,5000,-5000,-5000
057804,為升元大98購01  ,5000,0,5000,0,0,0,0,0,0,-10000,0,0,0,0,10000,-10000,-5000
057943,可成國票99購03  ,0,0,0,0,0,0,0,0,0,-5000,0,0,0,0,5000,-5000,-5000
057973,神達富邦9A購01  ,0,0,0,0,0,0,0,0,0,-5000,0,0,0,0,5000,-5000,-5000
8466,美吉吉-KY       ,9000,14000,-5000,0,0,0,0,0,0,0,0,0,0,0,0,0,-5000
06055P,華通凱基97售04  ,0,0,0,0,0,0,0,0,0,-6000,0,0,0,0,6000,-6000,-6000
059283,康友永豐99購02  ,0,0,0,0,0,0,0,0,0,-6000,0,0,0,0,6000,-6000,-6000
059289,瑞昱元富99購01  ,0,0,0,0,0,0,0,0,0,-6000,0,0,0,0,6000,-6000,-6000
059222,聯發科元大99購22,0,0,0,0,0,0,0,0,0,-6000,0,0,0,166000,172000,-6000,-6000
059114,華新科永豐99購05,0,0,0,0,0,0,0,0,0,-6000,0,0,0,0,6000,-6000,-6000
059135,臺股指群益99購10,0,0,0,0,0,0,0,0,0,-6000,0,0,0,0,6000,-6000,-6000
06580P,元油2X凱基9A售06,0,0,0,0,0,0,0,0,0,-6000,0,0,0,160000,166000,-6000,-6000
06305P,臺股指元大97售11,0,0,0,0,0,0,0,0,0,-6000,0,0,0,0,6000,-6000,-6000
06507P,台表科國票99售01,0,0,0,0,0,0,0,0,0,-6000,0,0,0,0,6000,-6000,-6000
058946,SGBR2X群益9B購01,0,0,0,0,0,0,0,0,0,-6000,0,0,0,0,6000,-6000,-6000
4108,懷特            ,29000,35000,-6000,0,0,0,0,0,0,0,0,0,0,0,0,0,-6000
2904,匯僑            ,6000,12000,-6000,0,0,0,0,0,0,0,0,0,0,0,0,0,-6000
06873P,嘉晶元富98售02  ,0,0,0,0,0,0,0,0,0,-6000,0,0,0,85000,91000,-6000,-6000
1234,黑松            ,29000,34000,-5000,0,0,0,0,0,0,-1000,0,1000,-1000,0,0,0,-6000
04980P,臺股指凱基96售08,0,0,0,0,0,0,0,0,0,-6000,0,0,0,19000,25000,-6000,-6000
049641,台達電凱基94購08,0,0,0,0,0,0,0,0,0,-6000,0,0,0,0,6000,-6000,-6000
05038P,牧德元大95售03  ,0,0,0,0,0,0,0,0,0,-6000,0,0,0,20000,26000,-6000,-6000
050590,晶技永豐95購01  ,0,0,0,0,0,0,0,0,0,-6000,0,0,0,5000,11000,-6000,-6000
05063P,聯電元大96售03  ,0,0,0,0,0,0,0,0,0,-6000,0,0,0,117000,123000,-6000,-6000
051361,泰鼎元大95購01  ,0,0,0,0,0,0,0,0,0,-6000,0,0,0,0,6000,-6000,-6000
051416,創意國票96購02  ,0,0,0,0,0,0,0,0,0,-6000,0,0,0,0,6000,-6000,-6000
05126P,牧德群益95售01  ,0,0,0,0,0,0,0,0,0,-6000,0,0,0,0,6000,-6000,-6000
051983,道瓊反元大95購01,0,0,0,0,0,0,0,0,0,-6000,0,0,0,4000,10000,-6000,-6000
051601,群創兆豐95購02  ,0,0,0,0,0,0,0,0,0,-6000,0,0,0,0,6000,-6000,-6000
049142,智邦元大94購01  ,0,0,0,0,0,0,0,0,0,-6000,0,0,0,0,6000,-6000,-6000
04869P,鴻海元富95售02  ,0,0,0,0,0,0,0,0,0,-6000,0,0,0,9000,15000,-6000,-6000
006204,永豐臺灣加權    ,0,0,0,0,0,0,0,0,0,-6000,0,0,0,0,6000,-6000,-6000
00702,國泰標普低波高息,0,0,0,0,0,0,0,0,0,-6000,0,0,0,213000,219000,-6000,-6000
03020X,元展20          ,0,0,0,0,0,0,0,0,0,-6000,0,0,0,0,6000,-6000,-6000
03052X,元展49          ,0,0,0,0,0,0,0,0,0,-6000,0,0,0,0,6000,-6000,-6000
03035X,元展32          ,0,0,0,0,0,0,0,0,0,-6000,0,0,0,0,6000,-6000,-6000
048189,臺指反元大96購06,0,0,0,0,0,0,0,0,0,-6000,0,0,0,0,6000,-6000,-6000
048070,聯發科元富99購03,0,0,0,0,0,0,0,0,0,-6000,0,0,0,54000,60000,-6000,-6000
05226P,智邦統一95售01  ,0,0,0,0,0,0,0,0,0,-6000,0,0,0,0,6000,-6000,-6000
057904,矽力永豐98購01  ,0,0,0,0,0,0,0,0,0,-6000,0,0,0,0,6000,-6000,-6000
05319P,上銀凱基95售02  ,0,0,0,0,0,0,0,0,0,-6000,0,0,0,0,6000,-6000,-6000
05494P,華邦電統一95售02,0,0,0,0,0,0,0,0,0,-6000,0,0,0,0,6000,-6000,-6000
05603P,聯發科元大96售09,0,0,0,0,0,0,0,0,0,-6000,0,0,0,0,6000,-6000,-6000
055855,牧德元大99購02  ,0,0,0,0,0,0,0,0,0,-6000,0,0,0,0,6000,-6000,-6000
057337,聯發科國票99購02,0,0,0,0,0,0,0,0,0,-6000,0,0,0,0,6000,-6000,-6000
054172,易華電凱基98購01,0,0,0,0,0,0,0,0,0,-6000,0,0,0,0,6000,-6000,-6000
055722,聯鈞元大97購03  ,0,0,0,0,0,0,0,0,0,-6000,0,0,0,6000,12000,-6000,-6000
056854,友達中信9A購01  ,0,0,0,0,0,0,0,0,0,-6000,0,0,0,64000,70000,-6000,-6000
054039,元油反元大96購08,0,0,0,0,0,0,0,0,0,-6000,0,0,0,20000,26000,-6000,-6000
055404,超眾元富97購01  ,0,0,0,0,0,0,0,0,0,-6000,0,0,0,0,6000,-6000,-6000
05428P,滬深2X統一95售01,0,0,0,0,0,0,0,0,0,-6000,0,0,0,0,6000,-6000,-6000
053585,友達元大9C購03  ,0,0,0,0,0,0,0,0,0,-6000,0,0,0,0,6000,-6000,-6000
053527,創意中信97購01  ,0,0,0,0,0,0,0,0,0,-6000,0,0,0,0,6000,-6000,-6000
1233,天仁            ,10000,13000,-3000,0,0,0,0,0,0,-4000,0,4000,-4000,0,0,0,-7000
1453,大將            ,7000,14000,-7000,0,0,0,0,0,0,0,0,0,0,0,0,0,-7000
2012,春雨            ,18000,25000,-7000,0,0,0,0,0,0,0,0,0,0,0,0,0,-7000
2062,橋椿            ,85000,92000,-7000,0,0,0,0,0,0,0,0,0,0,0,0,0,-7000
2032,新鋼            ,15000,22000,-7000,0,0,0,0,0,0,0,0,0,0,0,0,0,-7000
06867P,訊芯元大98售08  ,0,0,0,0,0,0,0,0,0,-7000,0,0,0,0,7000,-7000,-7000
06788P,臺股指元大98售05,0,0,0,0,0,0,0,0,0,-7000,0,0,0,0,7000,-7000,-7000
07092P,上銀凱基99售03  ,0,0,0,0,0,0,0,0,0,-7000,0,0,0,39000,46000,-7000,-7000
2496,卓越            ,1000,8000,-7000,0,0,0,0,0,0,0,0,0,0,0,0,0,-7000
3550,聯穎            ,6000,13000,-7000,0,0,0,0,0,0,0,0,0,0,0,0,0,-7000
3164,景岳            ,9000,15000,-6000,0,0,0,0,0,0,-1000,0,1000,-1000,0,0,0,-7000
4720,德淵            ,6000,13000,-7000,0,0,0,0,0,0,0,0,0,0,0,0,0,-7000
6133,金橋            ,6000,12000,-6000,0,0,0,0,0,0,-1000,0,1000,-1000,0,0,0,-7000
059049,元油2X凱基9A購12,0,0,0,0,0,0,0,0,0,-7000,0,0,0,20000,27000,-7000,-7000
058744,FBVIX凱基9C購03 ,0,0,0,0,0,0,0,0,0,-7000,0,0,0,0,7000,-7000,-7000
058750,緯穎凱基9A購03  ,0,0,0,0,0,0,0,0,0,-7000,0,0,0,10000,17000,-7000,-7000
058331,鴻海元富99購02  ,0,0,0,0,0,0,0,0,0,-7000,0,0,0,0,7000,-7000,-7000
058577,南亞科群益99購02,0,0,0,0,0,0,0,0,0,-7000,0,0,0,0,7000,-7000,-7000
06521P,矽力元大98售01  ,0,0,0,0,0,0,0,0,0,-7000,0,0,0,68000,75000,-7000,-7000
04925P,和碩元大94售03  ,0,0,0,0,0,0,0,0,0,-7000,0,0,0,10000,17000,-7000,-7000
006203,元大MSCI台灣    ,0,2000,-2000,0,0,0,0,0,0,-5000,0,0,0,0,5000,-5000,-7000
04898P,瑞儀中信95售01  ,0,0,0,0,0,0,0,0,0,-7000,0,0,0,5000,12000,-7000,-7000
049856,緯穎群益94購02  ,0,0,0,0,0,0,0,0,0,-7000,0,0,0,0,7000,-7000,-7000
051897,台光電國泰97購01,0,0,0,0,0,0,0,0,0,-7000,0,0,0,250000,257000,-7000,-7000
056647,晶技凱基98購02  ,0,0,0,0,0,0,0,0,0,-7000,0,0,0,3000,10000,-7000,-7000
052321,華擎元大95購01  ,0,0,0,0,0,0,0,0,0,-7000,0,0,0,65000,72000,-7000,-7000
050414,泰鼎永豐94購04  ,0,0,0,0,0,0,0,0,0,-7000,0,0,0,61000,68000,-7000,-7000
05378P,台積電凱基96售02,0,0,0,0,0,0,0,0,0,-7000,0,0,0,10000,17000,-7000,-7000
054266,緯穎元大96購07  ,0,0,0,0,0,0,0,0,0,-7000,0,0,0,5000,12000,-7000,-7000
05699P,茂林凱基96售05  ,0,0,0,0,0,0,0,0,0,-7000,0,0,0,207000,214000,-7000,-7000
054232,台積電群益96購12,0,0,0,0,0,0,0,0,0,-7000,0,0,0,43000,50000,-7000,-7000
057308,同欣電兆豐99購01,0,0,0,0,0,0,0,0,0,-7000,0,0,0,53000,60000,-7000,-7000
056079,世紀鋼元大97購02,0,0,0,0,0,0,0,0,0,-7000,0,0,0,281000,288000,-7000,-7000
05555P,健策群益98售01  ,0,0,0,0,0,0,0,0,0,-7000,0,0,0,1000,8000,-7000,-7000
05771P,大立光凱基96售13,0,0,0,0,0,0,0,0,0,-7000,0,0,0,0,7000,-7000,-7000
057928,鈺齊凱基98購02  ,0,0,0,0,0,0,0,0,0,-7000,0,0,0,100000,107000,-7000,-7000
057958,禾伸堂元大99購05,0,0,0,0,0,0,0,0,0,-7000,0,0,0,13000,20000,-7000,-7000
058097,台灣50國泰99購01,0,0,0,0,0,0,0,0,0,-7000,0,0,0,0,7000,-7000,-7000
058103,台積電永豐98購06,0,0,0,0,0,0,0,0,0,-7000,0,0,0,32000,39000,-7000,-7000
8261,富鼎            ,95000,104000,-9000,0,0,0,0,0,0,2000,2000,0,2000,0,0,0,-7000
6581,鋼聯            ,12000,19000,-7000,0,0,0,0,0,0,0,0,0,0,0,0,0,-7000
06067P,華新科康和97售01,0,0,0,0,0,0,0,0,0,-8000,0,0,0,4000,12000,-8000,-8000
06085P,義隆台新97售01  ,0,0,0,0,0,0,0,0,0,-8000,0,0,0,0,8000,-8000,-8000
058554,瀚宇博永豐99購01,0,0,0,0,0,0,0,0,0,-8000,0,0,0,0,8000,-8000,-8000
058693,旭富國票9A購01  ,0,0,0,0,0,0,0,0,0,-8000,0,0,0,0,8000,-8000,-8000
058276,道瓊指中信9C購01,0,0,0,0,0,0,0,0,0,-8000,0,0,0,0,8000,-8000,-8000
058459,南電永豐99購01  ,0,0,0,0,0,0,0,0,0,-8000,0,0,0,17000,25000,-8000,-8000
05882P,華新科永豐96售01,0,0,0,0,0,0,0,0,0,-8000,0,0,0,2000,10000,-8000,-8000
058931,玉晶光統一9C購01,0,0,0,0,0,0,0,0,0,-8000,0,0,0,0,8000,-8000,-8000
4564,元翎            ,165000,158000,7000,0,0,0,0,0,0,-15000,0,0,0,0,15000,-15000,-8000
2390,云辰            ,380000,388000,-8000,0,0,0,0,0,0,0,0,0,0,0,0,0,-8000
07151P,台灣50統一9B售04,0,0,0,0,0,0,0,0,0,-8000,0,0,0,0,8000,-8000,-8000
06784P,臺股指元大98售01,0,0,0,0,0,0,0,0,0,-8000,0,0,0,0,8000,-8000,-8000
05151P,台光電群益95售02,0,0,0,0,0,0,0,0,0,-8000,0,0,0,0,8000,-8000,-8000
052532,台積電國泰96購07,0,0,0,0,0,0,0,0,0,-8000,0,0,0,162000,170000,-8000,-8000
052237,嘉澤國票96購02  ,0,0,0,0,0,0,0,0,0,-8000,0,0,0,2000,10000,-8000,-8000
056498,A50正2富邦9B購01,0,0,0,0,0,0,0,0,0,-8000,0,0,0,1000,9000,-8000,-8000
052135,聯發科凱基9B購01,0,0,0,0,0,0,0,0,0,-8000,0,0,0,2000,10000,-8000,-8000
050171,臺指反元大97購03,0,0,0,0,0,0,0,0,0,-8000,0,0,0,0,8000,-8000,-8000
048610,華新科凱基94購04,0,0,0,0,0,0,0,0,0,-8000,0,0,0,2000,10000,-8000,-8000
00688L,國泰20年美債正2 ,0,0,0,0,0,0,0,0,0,-8000,0,0,0,5000,13000,-8000,-8000
04362P,聯詠統一94售01  ,0,0,0,0,0,0,0,0,0,-8000,0,0,0,0,8000,-8000,-8000
052743,華新科元大97購01,0,0,0,0,0,0,0,0,0,-8000,0,0,0,400000,408000,-8000,-8000
052278,國巨凱基95購06  ,0,0,0,0,0,0,0,0,0,-8000,0,0,0,78000,86000,-8000,-8000
04785P,鴻海永豐94售03  ,0,0,0,0,0,0,0,0,0,-8000,0,0,0,0,8000,-8000,-8000
047630,元油反元大96購02,0,0,0,0,0,0,0,0,0,-8000,0,0,0,4000,12000,-8000,-8000
04688P,大立光凱基94售09,0,0,0,0,0,0,0,0,0,-8000,0,0,0,20000,28000,-8000,-8000
057831,聯發科元富02購04,0,0,0,0,0,0,0,0,0,-8000,0,0,0,0,8000,-8000,-8000
056470,旺宏元大99購01  ,0,0,0,0,0,0,0,0,0,-8000,0,0,0,12000,20000,-8000,-8000
057579,長榮航中信9A購01,0,0,0,0,0,0,0,0,0,-8000,0,0,0,0,8000,-8000,-8000
054886,大毅統一97購01  ,0,0,0,0,0,0,0,0,0,-8000,0,0,0,0,8000,-8000,-8000
055816,新日興國票98購01,0,0,0,0,0,0,0,0,0,-8000,0,0,0,0,8000,-8000,-8000
055879,神達元富97購01  ,0,0,0,0,0,0,0,0,0,-8000,0,0,0,2000,10000,-8000,-8000
055989,矽力元富9A購01  ,0,0,0,0,0,0,0,0,0,-8000,0,0,0,0,8000,-8000,-8000
05400P,台積電永豐95售05,0,0,0,0,0,0,0,0,0,-8000,0,0,0,12000,20000,-8000,-8000
054129,技嘉元大96購02  ,0,0,0,0,0,0,0,0,0,-8000,0,0,0,6000,14000,-8000,-8000
6591,動力-KY         ,86000,88000,-2000,0,0,0,0,0,0,-6000,1000,7000,-6000,0,0,0,-8000
06779P,智邦元大98售12  ,0,0,0,0,0,0,0,0,0,-9000,0,0,0,0,9000,-9000,-9000
2115,六暉-KY         ,6000,15000,-9000,0,0,0,0,0,0,0,0,0,0,0,0,0,-9000
1530,亞崴            ,6000,15000,-9000,0,0,0,0,0,0,0,0,0,0,0,0,0,-9000
1521,大億            ,12000,21000,-9000,0,0,0,0,0,0,0,0,0,0,0,0,0,-9000
1235,興泰            ,6000,15000,-9000,0,0,0,0,0,0,0,0,0,0,0,0,0,-9000
2901,欣欣            ,9000,18000,-9000,0,0,0,0,0,0,0,0,0,0,0,0,0,-9000
2911,麗嬰房          ,19000,28000,-9000,0,0,0,0,0,0,0,0,0,0,0,0,0,-9000
4930,燦星網          ,13000,22000,-9000,0,0,0,0,0,0,0,0,0,0,0,0,0,-9000
058346,嘉晶群益99購01  ,0,0,0,0,0,0,0,0,0,-9000,0,0,0,1000,10000,-9000,-9000
058566,聯發科凱基9A購02,0,0,0,0,0,0,0,0,0,-9000,0,0,0,9000,18000,-9000,-9000
06212P,華新科元大97售11,0,0,0,0,0,0,0,0,0,-9000,0,0,0,1000,10000,-9000,-9000
05976P,國巨凱基96售14  ,0,0,0,0,0,0,0,0,0,-9000,0,0,0,200000,209000,-9000,-9000
059221,聯發科元大99購21,0,0,0,0,0,0,0,0,0,-9000,0,0,0,180000,189000,-9000,-9000
06399P,台表科凱基97售05,0,0,0,0,0,0,0,0,0,-9000,0,0,0,0,9000,-9000,-9000
04783P,貿聯元富94售01  ,0,0,0,0,0,0,0,0,0,-9000,0,0,0,1000,10000,-9000,-9000
046628,大立光統一98購01,0,0,0,0,0,0,0,0,0,-9000,0,0,0,3000,12000,-9000,-9000
00742,新光內需收益    ,0,1000,-1000,0,0,0,0,0,0,-8000,0,0,0,1000,9000,-8000,-9000
00861,元大全球未來通訊,0,7000,-7000,0,0,0,0,0,0,-2000,0,0,0,2740000,2742000,-2000,-9000
05008P,大立光元富95售05,0,0,0,0,0,0,0,0,0,-9000,0,0,0,1000,10000,-9000,-9000
056776,聯茂元大99購01  ,0,0,0,0,0,0,0,0,0,-9000,0,0,0,3000,12000,-9000,-9000
056767,大毅元大99購01  ,0,0,0,0,0,0,0,0,0,-9000,0,0,0,18000,27000,-9000,-9000
057146,技嘉國票98購01  ,0,0,0,0,0,0,0,0,0,-9000,0,0,0,0,9000,-9000,-9000
05751P,台積電中信96售05,0,0,0,0,0,0,0,0,0,-9000,0,0,0,0,9000,-9000,-9000
057494,玉晶光元大99購09,0,0,0,0,0,0,0,0,0,-9000,0,0,0,16000,25000,-9000,-9000
05746P,台積電群益96售07,0,0,0,0,0,0,0,0,0,-9000,0,0,0,0,9000,-9000,-9000
05692P,聯發科中信9A售02,0,0,0,0,0,0,0,0,0,-9000,0,0,0,35000,44000,-9000,-9000
054842,台達電兆豐98購01,0,0,0,0,0,0,0,0,0,-9000,0,0,0,12000,21000,-9000,-9000
9937,全國            ,19000,29000,-10000,0,0,0,0,0,0,1000,1000,0,1000,0,0,0,-9000
06489P,台積電元富98售06,0,0,0,0,0,0,0,0,0,-10000,0,0,0,160000,170000,-10000,-10000
06309P,光罩元富97售03  ,0,0,0,0,0,0,0,0,0,-10000,0,0,0,10000,20000,-10000,-10000
06398P,禾伸堂凱基97售02,0,0,0,0,0,0,0,0,0,-10000,0,0,0,5000,15000,-10000,-10000
06272P,台郡凱基97售04  ,0,0,0,0,0,0,0,0,0,-10000,0,0,0,0,10000,-10000,-10000
06582P,可成凱基98售06  ,0,0,0,0,0,0,0,0,0,-10000,0,0,0,20000,30000,-10000,-10000
06584P,欣興凱基98售03  ,0,0,0,0,0,0,0,0,0,-10000,0,0,0,0,10000,-10000,-10000
06568P,國巨永豐98售05  ,0,0,0,0,0,0,0,0,0,-10000,0,0,0,0,10000,-10000,-10000
06619P,聯發科元大98售06,0,0,0,0,0,0,0,0,0,-10000,0,0,0,105000,115000,-10000,-10000
059258,台灣50群益99購01,0,0,0,0,0,0,0,0,0,-10000,0,0,0,0,10000,-10000,-10000
059244,聯發科凱基99購13,0,0,0,0,0,0,0,0,0,-10000,0,0,0,0,10000,-10000,-10000
059284,緯穎永豐99購03  ,0,0,0,0,0,0,0,0,0,-10000,0,0,0,0,10000,-10000,-10000
05913P,國巨元大96售11  ,0,0,0,0,0,0,0,0,0,-10000,0,0,0,126000,136000,-10000,-10000
05972P,瑞昱元大96售01  ,0,0,0,0,0,0,0,0,0,-10000,0,0,0,20000,30000,-10000,-10000
05955P,台光電國票97售02,0,0,0,0,0,0,0,0,0,-10000,0,0,0,0,10000,-10000,-10000
05991P,聯茂群益96售05  ,0,0,0,0,0,0,0,0,0,-10000,0,0,0,0,10000,-10000,-10000
06031P,新光金兆豐96售02,0,0,0,0,0,0,0,0,0,-10000,0,0,0,0,10000,-10000,-10000
06215P,康控永豐97售02  ,0,0,0,0,0,0,0,0,0,-10000,0,0,0,0,10000,-10000,-10000
06222P,致茂元富97售02  ,0,0,0,0,0,0,0,0,0,-10000,0,0,0,0,10000,-10000,-10000
06188P,大立光元富97售01,0,0,0,0,0,0,0,0,0,-10000,0,0,0,0,10000,-10000,-10000
06179P,國巨群益97售04  ,0,0,0,0,0,0,0,0,0,-10000,0,0,0,0,10000,-10000,-10000
06177P,玉晶光元大98售07,0,0,0,0,0,0,0,0,0,-10000,0,0,0,0,10000,-10000,-10000
06145P,華新科永豐97售02,0,0,0,0,0,0,0,0,0,-10000,0,0,0,0,10000,-10000,-10000
06120P,大立光凱基98售05,0,0,0,0,0,0,0,0,0,-10000,0,0,0,0,10000,-10000,-10000
06125P,楠梓電元富99售01,0,0,0,0,0,0,0,0,0,-10000,0,0,0,30000,40000,-10000,-10000
06160P,台達電群益97售01,0,0,0,0,0,0,0,0,0,-10000,0,0,0,0,10000,-10000,-10000
058541,T50反1富邦01購01,0,0,0,0,0,0,0,0,0,-10000,0,0,0,0,10000,-10000,-10000
058529,S&P正2元富9B購01,0,0,0,0,0,0,0,0,0,-10000,0,0,0,0,10000,-10000,-10000
058671,旺宏群益9A購01  ,0,0,0,0,0,0,0,0,0,-10000,0,0,0,0,10000,-10000,-10000
058619,台灣50國票99購04,0,0,0,0,0,0,0,0,0,-10000,0,0,0,0,10000,-10000,-10000
058349,滬深2X日盛9A購01,0,0,0,0,0,0,0,0,0,-10000,0,0,0,0,10000,-10000,-10000
058374,玉晶光凱基9A購03,0,0,0,0,0,0,0,0,0,-10000,0,0,0,0,10000,-10000,-10000
058483,道瓊指國票9A購01,0,0,0,0,0,0,0,0,0,-10000,0,0,0,0,10000,-10000,-10000
058424,滬深2X元富99購04,0,0,0,0,0,0,0,0,0,-10000,0,0,0,0,10000,-10000,-10000
058440,玉晶光統一99購02,0,0,0,0,0,0,0,0,0,-10000,0,0,0,0,10000,-10000,-10000
058955,台積電國票9A購04,0,0,0,0,0,0,0,0,0,-10000,0,0,0,0,10000,-10000,-10000
059048,元油2X凱基9A購11,0,0,0,0,0,0,0,0,0,-10000,0,0,0,0,10000,-10000,-10000
059089,聯發科元大99購19,0,0,0,0,0,0,0,0,0,-10000,0,0,0,86000,96000,-10000,-10000
059112,上銀永豐99購01  ,0,0,0,0,0,0,0,0,0,-10000,0,0,0,0,10000,-10000,-10000
058811,台積電統一9A購05,0,0,0,0,0,0,0,0,0,-10000,0,0,0,0,10000,-10000,-10000
058749,康控凱基99購03  ,0,0,0,0,0,0,0,0,0,-10000,0,0,0,45000,55000,-10000,-10000
058789,喬山元大99購02  ,0,0,0,0,0,0,0,0,0,-10000,0,0,0,0,10000,-10000,-10000
058780,牧德國票9A購01  ,0,0,0,0,0,0,0,0,0,-10000,0,0,0,0,10000,-10000,-10000
3130,一零四          ,2000,12000,-10000,0,0,0,0,0,0,0,0,0,0,0,0,0,-10000
07219P,臺股指凱基99售32,0,0,0,0,0,0,0,0,0,-10000,0,0,0,0,10000,-10000,-10000
1445,大宇            ,10000,19000,-9000,0,0,0,0,0,0,-1000,0,1000,-1000,0,0,0,-10000
1539,巨庭            ,9000,21000,-12000,0,0,0,0,0,0,2000,2000,0,2000,0,0,0,-10000
1583,程泰            ,9000,19000,-10000,0,0,0,0,0,0,0,0,0,0,0,0,0,-10000
06848P,聯詠元大98售04  ,0,0,0,0,0,0,0,0,0,-10000,0,0,0,0,10000,-10000,-10000
06887P,華新科元大98售04,0,0,0,0,0,0,0,0,0,-10000,0,0,0,5000,15000,-10000,-10000
07001P,國巨元大99售12  ,0,0,0,0,0,0,0,0,0,-10000,0,0,0,461000,471000,-10000,-10000
06925P,致茂群益9A售02  ,0,0,0,0,0,0,0,0,0,-10000,0,0,0,0,10000,-10000,-10000
06927P,台灣50元大9B售03,0,0,0,0,0,0,0,0,0,-10000,0,0,0,900000,910000,-10000,-10000
06929P,鴻海元大99售11  ,0,0,0,0,0,0,0,0,0,-10000,0,0,0,25000,35000,-10000,-10000
07095P,台灣50元大9C售03,0,0,0,0,0,0,0,0,0,-10000,0,0,0,0,10000,-10000,-10000
07023P,南電永豐99售02  ,0,0,0,0,0,0,0,0,0,-10000,0,0,0,0,10000,-10000,-10000
07053P,台灣50兆豐01售01,0,0,0,0,0,0,0,0,0,-10000,0,0,0,90000,100000,-10000,-10000
056379,玉晶光元富98購01,0,0,0,0,0,0,0,0,0,-10000,0,0,0,0,10000,-10000,-10000
056346,聯茂凱基99購02  ,0,0,0,0,0,0,0,0,0,-10000,0,0,0,0,10000,-10000,-10000
056315,同欣電元大97購05,0,0,0,0,0,0,0,0,0,-10000,0,0,0,0,10000,-10000,-10000
056553,啟碁凱基98購02  ,0,0,0,0,0,0,0,0,0,-10000,0,0,0,0,10000,-10000,-10000
050080,國巨統一94購06  ,0,0,0,0,0,0,0,0,0,-10000,0,0,0,0,10000,-10000,-10000
050062,聯發科凱基94購08,0,0,0,0,0,0,0,0,0,-10000,0,0,0,0,10000,-10000,-10000
050101,台積電永昌96購03,0,0,0,0,0,0,0,0,0,-10000,0,0,0,0,10000,-10000,-10000
050163,群創國泰95購01  ,0,0,0,0,0,0,0,0,0,-10000,0,0,0,0,10000,-10000,-10000
050936,國巨國票95購04  ,0,0,0,0,0,0,0,0,0,-10000,0,0,0,0,10000,-10000,-10000
050964,晶技永豐95購02  ,0,0,0,0,0,0,0,0,0,-10000,0,0,0,35000,45000,-10000,-10000
051631,國巨國票96購06  ,0,0,0,0,0,0,0,0,0,-10000,0,0,0,0,10000,-10000,-10000
051746,玉晶光國泰97購07,0,0,0,0,0,0,0,0,0,-10000,0,0,0,48000,58000,-10000,-10000
051747,貿聯國泰96購01  ,0,0,0,0,0,0,0,0,0,-10000,0,0,0,0,10000,-10000,-10000
052152,創意富邦98購01  ,0,0,0,0,0,0,0,0,0,-10000,0,0,0,0,10000,-10000,-10000
052204,台泥中信96購01  ,0,0,0,0,0,0,0,0,0,-10000,0,0,0,0,10000,-10000,-10000
05222P,致伸凱基95售02  ,0,0,0,0,0,0,0,0,0,-10000,0,0,0,0,10000,-10000,-10000
051904,深100元大95購01 ,0,0,0,0,0,0,0,0,0,-10000,0,0,0,0,10000,-10000,-10000
049889,欣興國泰96購01  ,0,0,0,0,0,0,0,0,0,-10000,0,0,0,0,10000,-10000,-10000
050028,華新科元大94購03,0,0,0,0,0,0,0,0,0,-10000,0,0,0,0,10000,-10000,-10000
052529,力成元大95購03  ,0,0,0,0,0,0,0,0,0,-10000,0,0,0,0,10000,-10000,-10000
052531,台積電國泰96購06,0,0,0,0,0,0,0,0,0,-10000,0,0,0,0,10000,-10000,-10000
052498,台積電永豐95購06,0,0,0,0,0,0,0,0,0,-10000,0,0,0,10000,20000,-10000,-10000
052456,滬深2X元富9B購03,0,0,0,0,0,0,0,0,0,-10000,0,0,0,0,10000,-10000,-10000
052400,聯詠凱基97購01  ,0,0,0,0,0,0,0,0,0,-10000,0,0,0,0,10000,-10000,-10000
052739,國巨元大96購04  ,0,0,0,0,0,0,0,0,0,-10000,0,0,0,0,10000,-10000,-10000
05297P,臻鼎凱基95售04  ,0,0,0,0,0,0,0,0,0,-10000,0,0,0,0,10000,-10000,-10000
052727,仁寶元富96購01  ,0,0,0,0,0,0,0,0,0,-10000,0,0,0,20000,30000,-10000,-10000
052675,新光金國泰98購01,0,0,0,0,0,0,0,0,0,-10000,0,0,0,0,10000,-10000,-10000
052679,致伸富邦98購01  ,0,0,0,0,0,0,0,0,0,-10000,0,0,0,0,10000,-10000,-10000
052709,光寶科日盛96購01,0,0,0,0,0,0,0,0,0,-10000,0,0,0,0,10000,-10000,-10000
052696,玉晶光麥證97購01,0,0,0,200000,10000,190000,0,0,0,-10000,0,0,0,200000,210000,-10000,-10000
052629,訊芯中信99購01  ,0,0,0,0,0,0,0,0,0,-10000,0,0,0,0,10000,-10000,-10000
052559,茂林國票97購01  ,0,0,0,0,0,0,0,0,0,-10000,0,0,0,0,10000,-10000,-10000
052062,臺股指國票95購09,0,0,0,0,0,0,0,0,0,-10000,0,0,0,0,10000,-10000,-10000
049430,國巨國票95購02  ,0,0,0,0,0,0,0,0,0,-10000,0,0,0,0,10000,-10000,-10000
051307,康舒凱基95購01  ,0,0,0,0,0,0,0,0,0,-10000,0,0,0,0,10000,-10000,-10000
049498,茂林元大95購01  ,0,0,0,0,0,0,0,0,0,-10000,0,0,0,0,10000,-10000,-10000
049552,鴻海國泰96購01  ,0,0,0,0,0,0,0,0,0,-10000,0,0,0,0,10000,-10000,-10000
049559,香港反統一94購02,0,0,0,0,0,0,0,0,0,-10000,0,0,0,0,10000,-10000,-10000
051524,貿聯凱基95購02  ,0,0,0,0,0,0,0,0,0,-10000,0,0,0,0,10000,-10000,-10000
051544,T50反1康和98購01,0,0,0,0,0,0,0,0,0,-10000,0,0,0,0,10000,-10000,-10000
051567,台積電富邦95購06,0,0,0,0,0,0,0,0,0,-10000,0,0,0,0,10000,-10000,-10000
051600,新日興兆豐96購02,0,0,0,0,0,0,0,0,0,-10000,0,0,0,0,10000,-10000,-10000
050239,廣達凱基94購01  ,0,0,0,0,0,0,0,0,0,-10000,0,0,0,0,10000,-10000,-10000
050245,大立光凱基94購12,0,0,0,0,0,0,0,0,0,-10000,0,0,0,0,10000,-10000,-10000
04961P,貿聯凱基94售03  ,0,0,0,0,0,0,0,0,0,-10000,0,0,0,0,10000,-10000,-10000
049671,上証2X富邦95購01,0,0,0,0,0,0,0,0,0,-10000,0,0,0,0,10000,-10000,-10000
051422,超眾國票96購01  ,0,0,0,0,0,0,0,0,0,-10000,0,0,0,0,10000,-10000,-10000
050380,台積電亞東94購02,0,0,0,0,0,0,0,0,0,-10000,0,0,0,40000,50000,-10000,-10000
05060P,台達電富邦97售02,0,0,0,0,0,0,0,0,0,-10000,0,0,0,0,10000,-10000,-10000
050612,台積電元大95購06,0,0,0,0,0,0,0,0,0,-10000,0,0,0,0,10000,-10000,-10000
050484,世紀鋼國票95購02,0,0,0,0,0,0,0,0,0,-10000,0,0,0,0,10000,-10000,-10000
050541,智邦凱基94購04  ,0,0,0,0,0,0,0,0,0,-10000,0,0,0,0,10000,-10000,-10000
05072P,聯電元富95售02  ,0,0,0,0,0,0,0,0,0,-10000,0,0,0,0,10000,-10000,-10000
050732,台虹國票94購01  ,0,0,0,0,0,0,0,0,0,-10000,0,0,0,0,10000,-10000,-10000
050897,嘉晶元大95購03  ,0,0,0,0,0,0,0,0,0,-10000,0,0,0,0,10000,-10000,-10000
04197P,台積電亞東94售01,0,0,0,0,0,0,0,0,0,-10000,0,0,0,200000,210000,-10000,-10000
04357P,智易永豐94售01  ,0,0,0,0,0,0,0,0,0,-10000,0,0,0,0,10000,-10000,-10000
044088,國巨元富95購01  ,0,0,0,0,0,0,0,0,0,-10000,0,0,0,0,10000,-10000,-10000
04288P,台積電中信95售06,0,0,0,0,0,0,0,0,0,-10000,0,0,0,0,10000,-10000,-10000
03921P,亞光凱基94售01  ,0,0,0,0,0,0,0,0,0,-10000,0,0,0,0,10000,-10000,-10000
04083P,欣興統一94售01  ,0,0,0,0,0,0,0,0,0,-10000,0,0,0,0,10000,-10000,-10000
03675C,臺股指元大04牛02,0,0,0,0,0,0,0,0,0,-10000,0,0,0,0,10000,-10000,-10000
048938,玉晶光永豐95購02,0,0,0,0,0,0,0,0,0,-10000,0,0,0,0,10000,-10000,-10000
044468,台積電群益93購01,0,0,0,0,0,0,0,0,0,-10000,0,0,0,0,10000,-10000,-10000
049117,矽格統一96購01  ,0,0,0,0,0,0,0,0,0,-10000,0,0,0,0,10000,-10000,-10000
04907P,超眾國票95售01  ,0,0,0,0,0,0,0,0,0,-10000,0,0,0,0,10000,-10000,-10000
049006,和鑫中信94購01  ,0,0,0,0,0,0,0,0,0,-10000,0,0,0,0,10000,-10000,-10000
048701,健策國票95購01  ,0,0,0,0,0,0,0,0,0,-10000,0,0,0,0,10000,-10000,-10000
048804,和碩富邦94購01  ,0,0,0,0,0,0,0,0,0,-10000,0,0,0,0,10000,-10000,-10000
048848,滬深2X群益98購02,0,0,0,0,0,0,0,0,0,-10000,0,0,0,0,10000,-10000,-10000
04516P,台積電群益94售07,0,0,0,0,0,0,0,0,0,-10000,0,0,0,0,10000,-10000,-10000
045189,大立光元富98購01,0,0,0,0,0,0,0,0,0,-10000,0,0,0,0,10000,-10000,-10000
045213,A50正2元大95購01,0,0,0,0,0,0,0,0,0,-10000,0,0,0,0,10000,-10000,-10000
045087,玉晶光元大95購01,10000,0,10000,0,0,0,0,0,0,-20000,0,0,0,30000,50000,-20000,-10000
04477P,南電元大94售04  ,0,0,0,0,0,0,0,0,0,-10000,0,0,0,0,10000,-10000,-10000
04657P,國巨永豐94售03  ,0,0,0,0,0,0,0,0,0,-10000,0,0,0,20000,30000,-10000,-10000
04567P,臺股指凱基95售01,0,20000,-20000,0,0,0,0,0,0,10000,0,0,0,10000,0,10000,-10000
04603P,訊芯凱基94售03  ,0,0,0,0,0,0,0,0,0,-10000,0,0,0,0,10000,-10000,-10000
051124,創意群益95購01  ,0,0,0,0,0,0,0,0,0,-10000,0,0,0,0,10000,-10000,-10000
051153,鴻海國泰97購02  ,0,0,0,0,0,0,0,0,0,-10000,0,0,0,0,10000,-10000,-10000
051193,新日興兆豐96購01,0,0,0,0,0,0,0,0,0,-10000,0,0,0,0,10000,-10000,-10000
051206,大立光麥證95購02,0,0,0,0,10000,-10000,0,0,0,-10000,0,0,0,0,10000,-10000,-10000
051109,美律統一95購02  ,0,0,0,0,0,0,0,0,0,-10000,0,0,0,0,10000,-10000,-10000
051089,旺宏元大96購04  ,0,0,0,0,0,0,0,0,0,-10000,0,0,0,0,10000,-10000,-10000
05108P,欣興中信95售02  ,0,0,0,0,0,0,0,0,0,-10000,0,0,0,0,10000,-10000,-10000
046685,世紀鋼群益93購02,0,0,0,0,0,0,0,0,0,-10000,0,0,0,0,10000,-10000,-10000
052259,深100富邦95購01 ,0,0,0,0,0,0,0,0,0,-10000,0,0,0,0,10000,-10000,-10000
052934,中磊元大96購01  ,0,0,0,0,0,0,0,0,0,-10000,0,0,0,20000,30000,-10000,-10000
052880,台積電凱基96購06,0,0,0,0,0,0,0,0,0,-10000,0,0,0,0,10000,-10000,-10000
049260,華新科元大96購01,0,0,0,0,0,0,0,0,0,-10000,0,0,0,0,10000,-10000,-10000
052851,滬深2X元富96購02,0,0,0,0,0,0,0,0,0,-10000,0,0,0,0,10000,-10000,-10000
052844,台積電統一96購02,0,0,0,0,0,0,0,0,0,-10000,0,0,0,0,10000,-10000,-10000
04790P,台積電元大94售19,0,0,0,0,0,0,0,0,0,-10000,0,0,0,305000,315000,-10000,-10000
04789P,台積電富邦95售03,0,0,0,0,0,0,0,0,0,-10000,0,0,0,0,10000,-10000,-10000
048076,亞光第一94購01  ,0,0,0,0,0,0,0,0,0,-10000,0,0,0,0,10000,-10000,-10000
048010,嘉聯益富邦97購01,0,0,0,0,0,0,0,0,0,-10000,0,0,0,0,10000,-10000,-10000
047694,SP黃豆國票9B購01,0,0,0,0,0,0,0,0,0,-10000,0,0,0,0,10000,-10000,-10000
047468,為升中信95購01  ,0,0,0,0,0,0,0,0,0,-10000,0,0,0,0,10000,-10000,-10000
047572,深中小群益95購01,0,0,0,0,0,0,0,0,0,-10000,0,0,0,0,10000,-10000,-10000
047296,日月光元富96購01,0,0,0,0,0,0,0,0,0,-10000,0,0,0,0,10000,-10000,-10000
04920P,智易凱基94售05  ,0,0,0,0,0,0,0,0,0,-10000,0,0,0,0,10000,-10000,-10000
047193,南電元大94購02  ,0,0,0,0,0,0,0,0,0,-10000,0,0,0,0,10000,-10000,-10000
045444,群創元富98購02  ,0,0,0,0,0,0,0,0,0,-10000,0,0,0,0,10000,-10000,-10000
048192,華通元大96購01  ,0,0,0,0,0,0,0,0,0,-10000,0,0,0,0,10000,-10000,-10000
046866,台積電統一94購03,0,0,0,0,0,0,0,0,0,-10000,0,0,0,0,10000,-10000,-10000
046864,和大統一97購01  ,0,0,0,0,0,0,0,0,0,-10000,0,0,0,0,10000,-10000,-10000
054937,國巨元大97購03  ,0,0,0,0,0,0,0,0,0,-10000,0,0,0,0,10000,-10000,-10000
054535,旺宏富邦97購02  ,0,0,0,0,0,0,0,0,0,-10000,0,0,0,0,10000,-10000,-10000
057570,技嘉永豐98購02  ,0,0,0,0,0,0,0,0,0,-10000,0,0,0,0,10000,-10000,-10000
057581,元大金中信9A購01,0,0,0,0,0,0,0,0,0,-10000,0,0,0,0,10000,-10000,-10000
055467,國巨凱基97購05  ,0,0,0,0,0,0,0,0,0,-10000,0,0,0,0,10000,-10000,-10000
055487,國巨元大98購07  ,0,0,0,0,0,0,0,0,0,-10000,0,0,0,10000,20000,-10000,-10000
055507,樺漢元大98購02  ,0,0,0,0,0,0,0,0,0,-10000,0,0,0,0,10000,-10000,-10000
054628,可成凱基98購01  ,0,0,0,0,0,0,0,0,0,-10000,0,0,0,0,10000,-10000,-10000
055930,可成群益98購01  ,0,0,0,0,0,0,0,0,0,-10000,0,0,0,0,10000,-10000,-10000
056039,宏達電凱基97購02,0,0,0,0,0,0,0,0,0,-10000,0,0,0,66000,76000,-10000,-10000
056062,大立光元大97購12,0,0,0,0,0,0,0,0,0,-10000,0,0,0,0,10000,-10000,-10000
056070,新日興元大97購04,0,0,0,0,0,0,0,0,0,-10000,0,0,0,15000,25000,-10000,-10000
055820,矽力國票98購02  ,0,0,0,0,0,0,0,0,0,-10000,0,0,0,0,10000,-10000,-10000
056165,矽力凱基98購02  ,0,0,0,0,0,0,0,0,0,-10000,0,0,0,50000,60000,-10000,-10000
055564,茂林凱基98購01  ,0,0,0,0,0,0,0,0,0,-10000,0,0,0,0,10000,-10000,-10000
056467,上証2X元大98購02,0,0,0,0,0,0,0,0,0,-10000,0,0,0,0,10000,-10000,-10000
056474,華新科元大99購05,0,0,0,0,0,0,0,0,0,-10000,0,0,0,0,10000,-10000,-10000
053268,日月光群益96購01,0,0,0,0,0,0,0,0,0,-10000,0,0,0,0,10000,-10000,-10000
053314,A50正2群益9A購01,0,0,0,0,0,0,0,0,0,-10000,0,0,0,0,10000,-10000,-10000
053333,新唐永豐96購01  ,0,0,0,0,0,0,0,0,0,-10000,0,0,0,0,10000,-10000,-10000
054493,同欣電台新96購01,0,0,0,0,0,0,0,0,0,-10000,0,0,0,0,10000,-10000,-10000
05446P,緯穎元大95售04  ,0,0,0,0,0,0,0,0,0,-10000,0,0,0,20000,30000,-10000,-10000
054396,日電貿永豐96購02,0,0,0,0,0,0,0,0,0,-10000,0,0,0,0,10000,-10000,-10000
057717,友訊元富98購02  ,0,0,0,0,0,0,0,0,0,-10000,0,0,0,0,10000,-10000,-10000
057718,旺宏元富02購02  ,0,0,0,0,0,0,0,0,0,-10000,0,0,0,0,10000,-10000,-10000
057771,鴻海群益99購01  ,0,0,0,0,0,0,0,0,0,-10000,0,0,0,0,10000,-10000,-10000
057783,台積電國票9A購01,0,0,0,0,0,0,0,0,0,-10000,0,0,0,0,10000,-10000,-10000
057809,英業達元大98購01,0,0,0,0,0,0,0,0,0,-10000,0,0,0,0,10000,-10000,-10000
057827,康友元大98購03  ,0,0,0,0,0,0,0,0,0,-10000,0,0,0,10000,20000,-10000,-10000
055645,技嘉元富97購01  ,0,0,0,0,0,0,0,0,0,-10000,0,0,0,0,10000,-10000,-10000
055696,華新科國票98購01,0,0,0,0,0,0,0,0,0,-10000,0,0,0,0,10000,-10000,-10000
057688,國巨凱基99購07  ,0,0,0,0,0,0,0,0,0,-10000,0,0,0,0,10000,-10000,-10000
05768P,台積電凱基96售15,0,0,0,0,0,0,0,0,0,-10000,0,0,0,0,10000,-10000,-10000
057666,奇力新元大9A購01,0,0,0,0,0,0,0,0,0,-10000,0,0,0,0,10000,-10000,-10000
057858,T50正2康和98購01,0,0,0,0,0,0,0,0,0,-10000,0,0,0,0,10000,-10000,-10000
057843,晶技永豐98購02  ,0,0,0,0,0,0,0,0,0,-10000,0,0,0,0,10000,-10000,-10000
057995,華新科中信98購02,0,0,0,0,0,0,0,0,0,-10000,0,0,0,0,10000,-10000,-10000
058024,台積電國泰9A購01,0,0,0,0,0,0,0,0,0,-10000,0,0,0,0,10000,-10000,-10000
058110,光寶科元富98購01,0,0,0,0,0,0,0,0,0,-10000,0,0,0,0,10000,-10000,-10000
058120,台灣50國票99購03,0,0,0,0,0,0,0,0,0,-10000,0,0,0,0,10000,-10000,-10000
058124,玉晶光國票9A購01,0,0,0,0,0,0,0,0,0,-10000,0,0,0,0,10000,-10000,-10000
058224,世芯統一9B購02  ,0,0,0,0,0,0,0,0,0,-10000,0,0,0,0,10000,-10000,-10000
058184,鴻海永豐99購01  ,0,0,0,0,0,0,0,0,0,-10000,0,0,0,0,10000,-10000,-10000
058188,華擎永豐99購01  ,0,0,0,0,0,0,0,0,0,-10000,0,0,0,0,10000,-10000,-10000
058192,訊芯永豐99購01  ,0,0,0,0,0,0,0,0,0,-10000,0,0,0,0,10000,-10000,-10000
054256,創意元大96購07  ,0,0,0,0,0,0,0,0,0,-10000,0,0,0,0,10000,-10000,-10000
052991,台積電台新96購01,0,0,0,0,0,0,0,0,0,-10000,0,0,0,0,10000,-10000,-10000
053010,鴻海統一96購11  ,0,0,0,0,0,0,0,0,0,-10000,0,0,0,0,10000,-10000,-10000
053012,國巨統一96購03  ,0,0,0,0,0,0,0,0,0,-10000,0,0,0,0,10000,-10000,-10000
053054,禾伸堂國票97購01,0,0,0,0,0,0,0,0,0,-10000,0,0,0,0,10000,-10000,-10000
053537,玉晶光永豐98購02,0,0,0,0,0,0,0,0,0,-10000,0,0,0,0,10000,-10000,-10000
05358P,大立光元大95售09,0,0,0,0,0,0,0,0,0,-10000,0,0,0,71000,81000,-10000,-10000
053790,嘉聯益元大99購02,0,0,0,0,0,0,0,0,0,-10000,0,0,0,0,10000,-10000,-10000
05377P,鴻海凱基95售18  ,0,0,0,0,0,0,0,0,0,-10000,0,0,0,0,10000,-10000,-10000
053768,S&P反1元大99購01,0,0,0,0,0,0,0,0,0,-10000,0,0,0,20000,30000,-10000,-10000
053851,鴻海國泰98購03  ,0,0,0,0,0,0,0,0,0,-10000,0,0,0,0,10000,-10000,-10000
053678,南亞科富邦97購01,0,0,0,0,0,0,0,0,0,-10000,0,0,0,0,10000,-10000,-10000
053676,新光金國泰98購02,0,0,0,0,0,0,0,0,0,-10000,0,0,0,0,10000,-10000,-10000
053669,台積電統一96購08,0,0,0,0,0,0,0,0,0,-10000,0,0,0,0,10000,-10000,-10000
053380,南亞科元大97購01,0,0,0,0,0,0,0,0,0,-10000,0,0,0,0,10000,-10000,-10000
053926,晶相光國票97購01,0,0,0,0,0,0,0,0,0,-10000,0,0,0,0,10000,-10000,-10000
053917,友達國票97購03  ,0,0,0,0,0,0,0,0,0,-10000,0,0,0,0,10000,-10000,-10000
053484,國巨國票97購03  ,0,0,0,0,0,0,0,0,0,-10000,0,0,0,0,10000,-10000,-10000
053423,亞光永豐96購01  ,0,0,0,0,0,0,0,0,0,-10000,0,0,0,0,10000,-10000,-10000
055384,緯穎元大98購02  ,0,0,0,0,0,0,0,0,0,-10000,0,0,0,21000,31000,-10000,-10000
054347,上緯控國票96購02,0,0,0,0,0,0,0,0,0,-10000,0,0,0,0,10000,-10000,-10000
05430P,台積電統一95售07,0,0,0,0,0,0,0,0,0,-10000,0,0,0,0,10000,-10000,-10000
054310,牧德凱基98購01  ,0,0,0,0,0,0,0,0,0,-10000,0,0,0,0,10000,-10000,-10000
054796,康普群益98購01  ,0,0,0,0,0,0,0,0,0,-10000,0,0,0,0,10000,-10000,-10000
054704,玉晶光第一97購01,0,0,0,0,0,0,0,0,0,-10000,0,0,0,0,10000,-10000,-10000
054722,傳奇永豐97購01  ,0,0,0,0,0,0,0,0,0,-10000,0,0,0,0,10000,-10000,-10000
054753,復盛凱基98購01  ,0,0,0,0,0,0,0,0,0,-10000,0,0,0,0,10000,-10000,-10000
057248,台積電統一98購08,0,0,0,0,0,0,0,0,0,-10000,0,0,0,0,10000,-10000,-10000
054675,美律台新98購01  ,0,0,0,0,0,0,0,0,0,-10000,0,0,0,0,10000,-10000,-10000
057200,技嘉元富98購01  ,0,0,0,0,0,0,0,0,0,-10000,0,0,0,1000,11000,-10000,-10000
057198,智伸科統一9B購01,0,0,0,0,0,0,0,0,0,-10000,0,0,0,0,10000,-10000,-10000
057446,旺宏元富02購01  ,0,0,0,0,0,0,0,0,0,-10000,0,0,0,0,10000,-10000,-10000
057523,大成鋼元大99購01,0,0,0,0,0,0,0,0,0,-10000,0,0,0,0,10000,-10000,-10000
057292,國巨國泰9B購01  ,0,0,0,0,0,0,0,0,0,-10000,0,0,0,135000,145000,-10000,-10000
057311,玉晶光日盛9A購01,0,0,0,0,0,0,0,0,0,-10000,0,0,0,0,10000,-10000,-10000
057317,技嘉凱基98購02  ,0,0,0,0,0,0,0,0,0,-10000,0,0,0,20000,30000,-10000,-10000
057347,國巨統一9A購03  ,0,0,0,0,0,0,0,0,0,-10000,0,0,0,0,10000,-10000,-10000
057270,遠東新元大98購01,0,0,0,0,0,0,0,0,0,-10000,0,0,0,60000,70000,-10000,-10000
057276,全新元大99購03  ,0,0,0,0,0,0,0,0,0,-10000,0,0,0,0,10000,-10000,-10000
05422P,大立光中信97售02,0,0,0,0,0,0,0,0,0,-10000,0,0,0,10000,20000,-10000,-10000
055265,玉晶光永豐98購03,0,0,0,0,0,0,0,0,0,-10000,0,0,0,0,10000,-10000,-10000
05528P,臺股指群益96售01,0,0,0,0,0,0,0,0,0,-10000,0,0,0,0,10000,-10000,-10000
05533P,滬深2X富邦97售01,0,0,0,0,0,0,0,0,0,-10000,0,0,0,0,10000,-10000,-10000
054156,聯電亞東98購01  ,0,0,0,0,0,0,0,0,0,-10000,0,0,0,0,10000,-10000,-10000
054227,宏達電元富96購02,0,0,0,0,0,0,0,0,0,-10000,0,0,0,0,10000,-10000,-10000
056417,欣興中信98購01  ,0,0,0,0,0,0,0,0,0,-10000,0,0,0,0,10000,-10000,-10000
05641P,貿聯元富96售02  ,0,0,0,0,0,0,0,0,0,-10000,0,0,0,0,10000,-10000,-10000
05712P,友達統一97售03  ,0,0,0,0,0,0,0,0,0,-10000,0,0,0,0,10000,-10000,-10000
05713P,大立光統一96售05,0,0,0,0,0,0,0,0,0,-10000,0,0,0,0,10000,-10000,-10000
055811,國巨國票98購05  ,0,0,0,0,0,0,0,0,0,-10000,0,0,0,0,10000,-10000,-10000
055812,台積電國票99購02,0,0,0,0,0,0,0,0,0,-10000,0,0,0,0,10000,-10000,-10000
057167,台積電元大99購03,0,0,0,0,0,0,0,0,0,-10000,0,0,0,20000,30000,-10000,-10000
055218,彩晶凱基99購01  ,0,0,0,0,0,0,0,0,0,-10000,0,0,0,0,10000,-10000,-10000
055167,友訊統一97購01  ,0,0,0,0,0,0,0,0,0,-10000,0,0,0,0,10000,-10000,-10000
055188,亞翔統一97購01  ,0,0,0,0,0,0,0,0,0,-10000,0,0,0,0,10000,-10000,-10000
055205,京鼎中信99購01  ,0,0,0,0,0,0,0,0,0,-10000,0,0,0,0,10000,-10000,-10000
054031,中鋼中信98購01  ,0,0,0,0,0,0,0,0,0,-10000,0,0,0,0,10000,-10000,-10000
054117,宏全康和96購01  ,0,0,0,0,0,0,0,0,0,-10000,0,0,0,0,10000,-10000,-10000
057003,立積國票98購01  ,0,0,0,0,0,0,0,0,0,-10000,0,0,0,0,10000,-10000,-10000
8103,瀚荃            ,17000,27000,-10000,0,0,0,0,0,0,0,0,0,0,0,0,0,-10000
06991P,矽創群益99售01  ,0,0,0,0,0,0,0,0,0,-11000,0,0,0,0,11000,-11000,-11000
06853P,華擎元富98售03  ,0,0,0,0,0,0,0,0,0,-11000,0,0,0,1000,12000,-11000,-11000
1783,和康生          ,8000,23000,-15000,0,0,0,0,0,0,4000,4000,0,4000,0,0,0,-11000
3058,立德            ,22000,33000,-11000,0,0,0,0,0,0,0,0,0,0,0,0,0,-11000
3312,弘憶股          ,99000,110000,-11000,0,0,0,0,0,0,0,0,0,0,0,0,0,-11000
058952,南茂群益99購01  ,0,0,0,0,0,0,0,0,0,-11000,0,0,0,0,11000,-11000,-11000
05848P,臺股指元大96售24,0,0,0,0,0,0,0,0,0,-11000,0,0,0,0,11000,-11000,-11000
058292,上銀凱基9A購01  ,0,0,0,0,0,0,0,0,0,-11000,0,0,0,0,11000,-11000,-11000
058552,欣興永豐99購01  ,0,0,0,0,0,0,0,0,0,-11000,0,0,0,0,11000,-11000,-11000
059143,國巨國票9A購04  ,0,0,0,0,0,0,0,0,0,-11000,0,0,0,5000,16000,-11000,-11000
059293,宏達電元富9B購01,0,0,0,0,0,0,0,0,0,-11000,0,0,0,0,11000,-11000,-11000
047013,超眾元富96購01  ,0,0,0,0,0,0,0,0,0,-11000,0,0,0,0,11000,-11000,-11000
04782P,智伸科統一96售01,0,0,0,0,0,0,0,0,0,-11000,0,0,0,0,11000,-11000,-11000
04932P,香港2X中信96售01,0,0,0,0,0,0,0,0,0,-11000,0,0,0,0,11000,-11000,-11000
04494P,台積電國票94售04,0,0,0,0,0,0,0,0,0,-11000,0,0,0,120000,131000,-11000,-11000
04373P,滬深2X元大97售01,0,0,0,0,0,0,0,0,0,-11000,0,0,0,21000,32000,-11000,-11000
051471,國巨凱基97購01  ,0,0,0,0,0,0,0,0,0,-11000,0,0,0,0,11000,-11000,-11000
049857,緯穎群益94購03  ,0,0,0,0,0,0,0,0,0,-11000,0,0,0,13000,24000,-11000,-11000
056558,台達電群益98購01,0,0,0,0,0,0,0,0,0,-11000,0,0,0,0,11000,-11000,-11000
056546,致伸凱基98購01  ,0,0,0,0,0,0,0,0,0,-11000,0,0,0,15000,26000,-11000,-11000
05650P,台積電富邦96售01,0,0,0,0,0,0,0,0,0,-11000,0,0,0,9000,20000,-11000,-11000
055714,智邦元大97購03  ,0,0,0,0,0,0,0,0,0,-11000,0,0,0,115000,126000,-11000,-11000
058082,美律群益98購05  ,0,0,0,0,0,0,0,0,0,-11000,0,0,0,0,11000,-11000,-11000
055935,創意群益97購02  ,0,0,0,0,0,0,0,0,0,-11000,0,0,0,60000,71000,-11000,-11000
6671,三能-KY         ,11000,22000,-11000,0,0,0,0,0,0,0,0,0,0,0,0,0,-11000
6579,研揚            ,14000,25000,-11000,0,0,0,0,0,0,0,0,0,0,0,0,0,-11000
6442,光聖            ,7000,18000,-11000,0,0,0,0,0,0,0,0,0,0,0,0,0,-11000
06155P,智邦統一97售02  ,0,0,0,0,0,0,0,0,0,-12000,0,0,0,10000,22000,-12000,-12000
06103P,漢唐凱基97售02  ,0,0,0,0,0,0,0,0,0,-12000,0,0,0,4000,16000,-12000,-12000
06032P,健策群益97售03  ,0,0,0,0,0,0,0,0,0,-12000,0,0,0,0,12000,-12000,-12000
06762P,智邦元大98售11  ,0,0,0,0,0,0,0,0,0,-12000,0,0,0,0,12000,-12000,-12000
06431P,新日興元大97售05,0,0,0,0,0,0,0,0,0,-12000,0,0,0,19000,31000,-12000,-12000
058939,台積電中信9B購01,0,0,0,0,0,0,0,0,0,-12000,0,0,0,0,12000,-12000,-12000
058776,台積電國票9A購03,0,0,0,0,0,0,0,0,0,-12000,0,0,0,5000,17000,-12000,-12000
3321,同泰            ,32000,39000,-7000,0,0,0,0,5000,-5000,0,0,0,0,0,0,0,-12000
4557,永新-KY         ,3000,15000,-12000,0,0,0,0,0,0,0,0,0,0,0,0,0,-12000
2305,全友            ,15000,27000,-12000,0,0,0,0,0,0,0,0,0,0,0,0,0,-12000
1108,幸福            ,31000,42000,-11000,0,0,0,0,0,0,-1000,0,1000,-1000,0,0,0,-12000
056714,晶相光永豐98購02,0,0,0,0,0,0,0,0,0,-12000,0,0,0,0,12000,-12000,-12000
050170,臺指反元大97購02,0,0,0,0,0,0,0,0,0,-12000,0,0,0,0,12000,-12000,-12000
052594,友訊群益98購01  ,0,0,0,0,0,0,0,0,0,-12000,0,0,0,0,12000,-12000,-12000
03009X,元展09          ,0,0,0,0,0,0,0,0,0,-12000,0,0,0,10000,22000,-12000,-12000
03071X,元展66          ,0,0,0,0,0,0,0,0,0,-12000,0,0,0,0,12000,-12000,-12000
00743,國泰中國A150    ,0,19000,-19000,0,0,0,0,0,0,7000,0,0,0,11000,4000,7000,-12000
00682U,元大美元指數    ,0,0,0,0,0,0,0,0,0,-12000,0,0,0,8000,20000,-12000,-12000
04909P,鴻海統一94售10  ,0,0,0,0,0,0,0,0,0,-12000,0,0,0,0,12000,-12000,-12000
04843P,致新元大94售02  ,0,0,0,0,0,0,0,0,0,-12000,0,0,0,0,12000,-12000,-12000
053163,上証2X群益9A購02,0,0,0,0,0,0,0,0,0,-12000,0,0,0,14000,26000,-12000,-12000
058099,鴻海國泰9A購02  ,0,0,0,0,0,0,0,0,0,-12000,0,0,0,0,12000,-12000,-12000
056444,南亞科凱基99購01,0,0,0,0,0,0,0,0,0,-12000,0,0,0,0,12000,-12000,-12000
055406,大毅國泰99購01  ,0,0,0,0,0,0,0,0,0,-12000,0,0,0,153000,165000,-12000,-12000
8478,東哥遊艇        ,15000,25000,-10000,0,0,0,0,0,0,-2000,0,2000,-2000,0,0,0,-12000
1307,三芳            ,46000,70000,-24000,0,0,0,0,0,0,11000,11000,0,11000,0,0,0,-13000
1423,利華            ,14000,27000,-13000,0,0,0,0,0,0,0,0,0,0,0,0,0,-13000
1713,國化            ,11000,13000,-2000,0,0,0,0,0,0,-11000,0,11000,-11000,0,0,0,-13000
06931P,大立光元大98售20,0,0,0,0,0,0,0,0,0,-13000,0,0,0,0,13000,-13000,-13000
3257,虹冠電          ,36000,49000,-13000,0,0,0,0,0,0,0,0,0,0,0,0,0,-13000
058748,景碩凱基9A購01  ,0,0,0,0,0,0,0,0,0,-13000,0,0,0,0,13000,-13000,-13000
058719,智邦元富99購01  ,0,0,0,0,0,0,0,0,0,-13000,0,0,0,55000,68000,-13000,-13000
06208P,台郡凱基97售03  ,0,0,0,0,0,0,0,0,0,-13000,0,0,0,6000,19000,-13000,-13000
04799P,健策元大94售03  ,0,0,0,0,0,0,0,0,0,-13000,0,0,0,30000,43000,-13000,-13000
04609P,健策永豐94售01  ,0,0,0,0,0,0,0,0,0,-13000,0,0,0,10000,23000,-13000,-13000
0052,富邦科技        ,5000,5000,0,0,0,0,0,0,0,-13000,0,0,0,108000,121000,-13000,-13000
03039P,玉晶光國票02售04,0,0,0,0,0,0,0,0,0,-13000,0,0,0,2000,15000,-13000,-13000
05136P,台積電凱基95售08,0,0,0,0,0,0,0,0,0,-13000,0,0,0,0,13000,-13000,-13000
051985,智邦元大95購05  ,0,0,0,0,0,0,0,0,0,-13000,0,0,0,245000,258000,-13000,-13000
05095P,景碩元大95售01  ,0,0,0,0,0,0,0,0,0,-13000,0,0,0,160000,173000,-13000,-13000
057201,華擎元富98購01  ,0,0,0,0,0,0,0,0,0,-13000,0,0,0,32000,45000,-13000,-13000
053784,奇力新元大97購02,0,0,0,0,0,0,0,0,0,-13000,0,0,0,28000,41000,-13000,-13000
055743,TPK元富98購01   ,0,0,0,0,0,0,0,0,0,-13000,0,0,0,0,13000,-13000,-13000
055716,致茂元大97購01  ,0,0,0,0,0,0,0,0,0,-13000,0,0,0,60000,73000,-13000,-13000
054074,健策富邦98購01  ,0,0,0,0,0,0,0,0,0,-13000,0,0,0,0,13000,-13000,-13000
057880,金融類元大99購02,0,0,0,0,0,0,0,0,0,-13000,0,0,0,0,13000,-13000,-13000
057060,緯穎元大98購05  ,0,0,0,0,0,0,0,0,0,-13000,0,0,0,94000,107000,-13000,-13000
05492P,聯茂元大95售02  ,0,0,0,0,0,0,0,0,0,-13000,0,0,0,0,13000,-13000,-13000
8374,羅昇            ,7000,20000,-13000,0,0,0,0,0,0,0,0,0,0,0,0,0,-13000
059268,鎧勝中信01購01  ,0,0,0,0,0,0,0,0,0,-14000,0,0,0,0,14000,-14000,-14000
059240,台積電凱基9A購09,0,0,0,0,0,0,0,0,0,-14000,0,0,0,0,14000,-14000,-14000
06479P,聯發科中信99售02,0,0,0,0,0,0,0,0,0,-14000,0,0,0,5000,19000,-14000,-14000
06494P,鴻海永昌98售03  ,0,0,0,0,0,0,0,0,0,-14000,0,0,0,0,14000,-14000,-14000
06228P,亞德客凱基97售04,0,0,0,0,0,0,0,0,0,-14000,0,0,0,15000,29000,-14000,-14000
6183,關貿            ,25000,39000,-14000,0,0,0,0,0,0,0,0,0,0,0,0,0,-14000
2426,鼎元            ,435000,416000,19000,0,0,0,0,0,0,-33000,0,33000,-33000,0,0,0,-14000
3002,歐格            ,16000,29000,-13000,0,0,0,0,0,0,-1000,0,1000,-1000,0,0,0,-14000
1232,大統益          ,20000,30000,-10000,0,0,0,0,0,0,-4000,0,4000,-4000,0,0,0,-14000
1110,東泥            ,39000,55000,-16000,0,0,0,0,0,0,2000,2000,0,2000,0,0,0,-14000
056381,台虹元富98購01  ,0,0,0,0,0,0,0,0,0,-14000,0,0,0,15000,29000,-14000,-14000
049803,華新科元大95購07,0,0,0,0,0,0,0,0,0,-14000,0,0,0,0,14000,-14000,-14000
03999P,鴻海凱基94售11  ,0,0,0,0,0,0,0,0,0,-14000,0,0,0,0,14000,-14000,-14000
04859P,台達電群益94售04,0,0,0,0,0,0,0,0,0,-14000,0,0,0,0,14000,-14000,-14000
052764,景碩群益98購01  ,0,0,0,0,0,0,0,0,0,-14000,0,0,0,36000,50000,-14000,-14000
047688,亞德客富邦95購01,0,0,0,0,0,0,0,0,0,-14000,0,0,0,0,14000,-14000,-14000
05703P,矽力群益96售03  ,0,0,0,0,0,0,0,0,0,-14000,0,0,0,0,14000,-14000,-14000
057784,台積電國票9B購01,0,0,0,0,0,0,0,0,0,-14000,0,0,0,0,14000,-14000,-14000
055713,國巨元大98購09  ,0,0,0,0,0,0,0,0,0,-14000,0,0,0,6000,20000,-14000,-14000
6641,基士德-KY       ,4000,18000,-14000,0,0,0,0,0,0,0,0,0,0,0,0,0,-14000
1220,台榮            ,17000,24000,-7000,0,0,0,0,0,0,-8000,0,8000,-8000,0,0,0,-15000
1436,華友聯          ,10000,25000,-15000,0,0,0,0,0,0,0,0,0,0,0,0,0,-15000
1725,元禎            ,14000,29000,-15000,0,0,0,0,0,0,0,0,0,0,0,0,0,-15000
06502P,A50中信98售01   ,0,0,0,0,0,0,0,0,0,-15000,0,0,0,42000,57000,-15000,-15000
06742P,可成富邦99售02  ,0,0,0,0,0,0,0,0,0,-15000,0,0,0,0,15000,-15000,-15000
06728P,全新元大98售03  ,0,0,0,0,0,0,0,0,0,-15000,0,0,0,0,15000,-15000,-15000
06679P,旺宏元大98售09  ,0,0,0,0,0,0,0,0,0,-15000,0,0,0,7000,22000,-15000,-15000
059247,可成凱基99購05  ,0,0,0,0,0,0,0,0,0,-15000,0,0,0,0,15000,-15000,-15000
05947P,大成鋼元大96售03,0,0,0,0,0,0,0,0,0,-15000,0,0,0,0,15000,-15000,-15000
06170P,禾伸堂元富97售02,0,0,0,0,0,0,0,0,0,-15000,0,0,0,0,15000,-15000,-15000
058760,嘉晶群益9A購01  ,0,0,0,0,0,0,0,0,0,-15000,0,0,0,0,15000,-15000,-15000
058995,台達電元大99購01,0,0,0,0,0,0,0,0,0,-15000,0,0,0,0,15000,-15000,-15000
059092,聯陽元大99購01  ,0,0,0,0,0,0,0,0,0,-15000,0,0,0,25000,40000,-15000,-15000
058352,鴻海凱基9A購05  ,0,0,0,0,0,0,0,0,0,-15000,0,0,0,0,15000,-15000,-15000
058480,新日興凱基9A購01,0,0,0,0,0,0,0,0,0,-15000,0,0,0,0,15000,-15000,-15000
058471,台積電日盛9C購01,0,0,0,0,0,0,0,0,0,-15000,0,0,0,0,15000,-15000,-15000
047990,臺指反元大96購02,0,0,0,0,0,0,0,0,0,-15000,0,0,0,0,15000,-15000,-15000
048687,旺宏群益96購01  ,0,0,0,0,0,0,0,0,0,-15000,0,0,0,0,15000,-15000,-15000
04430P,晶相光元大94售04,0,0,0,0,0,0,0,0,0,-15000,0,0,0,0,15000,-15000,-15000
0054,元大台商50      ,0,0,0,0,0,0,0,0,0,-15000,0,0,0,5000,20000,-15000,-15000
049688,台光電元大94購04,0,0,0,0,0,0,0,0,0,-15000,0,0,0,0,15000,-15000,-15000
051400,國巨永豐95購01  ,0,0,0,0,0,0,0,0,0,-15000,0,0,0,10000,25000,-15000,-15000
049583,台積電元大95購04,0,0,0,0,0,0,0,0,0,-15000,0,0,0,0,15000,-15000,-15000
052341,泰鼎凱基96購02  ,0,0,0,0,0,0,0,0,0,-15000,0,0,0,0,15000,-15000,-15000
052535,日月光國泰96購01,0,0,0,0,0,0,0,0,0,-15000,0,0,0,0,15000,-15000,-15000
051908,國泰金元大96購02,0,0,0,0,0,0,0,0,0,-15000,0,0,0,0,15000,-15000,-15000
056401,國巨群益98購07  ,0,0,0,0,0,0,0,0,0,-15000,0,0,0,0,15000,-15000,-15000
056889,元油2X元大99購07,0,0,0,0,0,0,0,0,0,-15000,0,0,0,0,15000,-15000,-15000
05643P,大立光中信98售01,0,0,0,0,0,0,0,0,0,-15000,0,0,0,20000,35000,-15000,-15000
054140,智易元大97購03  ,0,0,0,0,0,0,0,0,0,-15000,0,0,0,0,15000,-15000,-15000
054246,國巨元大96購12  ,0,0,0,0,0,0,0,0,0,-15000,0,0,0,0,15000,-15000,-15000
057282,大立光元大99購06,0,0,0,0,0,0,0,0,0,-15000,0,0,0,22000,37000,-15000,-15000
05379P,可成凱基95售11  ,0,0,0,0,0,0,0,0,0,-15000,0,0,0,0,15000,-15000,-15000
053599,崇越元大96購01  ,0,0,0,0,0,0,0,0,0,-15000,0,0,0,0,15000,-15000,-15000
05300P,健策元大95售02  ,0,0,0,0,0,0,0,0,0,-15000,0,0,0,85000,100000,-15000,-15000
057204,利勤元富98購01  ,0,0,0,0,0,0,0,0,0,-15000,0,0,0,0,15000,-15000,-15000
055605,緯穎元大97購02  ,0,0,0,0,0,0,0,0,0,-15000,0,0,0,26000,41000,-15000,-15000
058072,大立光凱基98購20,0,0,0,0,0,0,0,0,0,-15000,0,0,0,0,15000,-15000,-15000
058152,聯發科統一9B購02,0,0,0,0,0,0,0,0,0,-15000,0,0,0,5000,20000,-15000,-15000
057048,新日興元大98購01,0,0,0,0,0,0,0,0,0,-15000,0,0,0,60000,75000,-15000,-15000
05316P,台積電永昌96售06,0,0,0,0,0,0,0,0,0,-15000,0,0,0,26000,41000,-15000,-15000
056277,上銀富邦99購02  ,0,0,0,0,0,0,0,0,0,-15000,0,0,0,0,15000,-15000,-15000
056198,台光電永豐97購02,0,0,0,0,0,0,0,0,0,-15000,0,0,0,5000,20000,-15000,-15000
054916,聯發科凱基98購04,0,0,0,0,0,0,0,0,0,-15000,0,0,0,0,15000,-15000,-15000
9931,欣高            ,6000,21000,-15000,0,0,0,0,0,0,0,0,0,0,0,0,0,-15000
1525,江申            ,5000,21000,-16000,0,0,0,0,0,0,0,0,0,0,0,0,0,-16000
2102,泰豐            ,498000,514000,-16000,0,0,0,0,0,0,0,0,0,0,0,0,0,-16000
4976,佳凌            ,402000,411000,-9000,0,0,0,0,0,0,-7000,0,7000,-7000,0,0,0,-16000
3229,晟鈦            ,7000,23000,-16000,0,0,0,0,0,0,0,0,0,0,0,0,0,-16000
3040,遠見            ,4000,20000,-16000,0,0,0,0,0,0,0,0,0,0,0,0,0,-16000
051840,康友國泰97購02  ,0,0,0,0,0,0,0,0,0,-16000,0,0,0,2000,18000,-16000,-16000
048007,明基材元大96購01,0,0,0,0,0,0,0,0,0,-16000,0,0,0,0,16000,-16000,-16000
052742,可成元大96購01  ,0,0,0,0,0,0,0,0,0,-16000,0,0,0,4000,20000,-16000,-16000
05458P,台積電凱基97售02,0,0,0,0,0,0,0,0,0,-16000,0,0,0,39000,55000,-16000,-16000
057549,台光電凱基98購05,0,0,0,0,0,0,0,0,0,-16000,0,0,0,0,16000,-16000,-16000
05622P,台積電中信96售02,0,0,0,0,0,0,0,0,0,-16000,0,0,0,0,16000,-16000,-16000
05612P,台積電元大96售13,0,0,0,0,0,0,0,0,0,-16000,0,0,0,25000,41000,-16000,-16000
054370,台積電中信9A購01,0,0,0,0,0,0,0,0,0,-16000,0,0,0,19000,35000,-16000,-16000
055612,台光電國票97購04,0,0,0,0,0,0,0,0,0,-16000,0,0,0,20000,36000,-16000,-16000
053222,聯茂凱基96購03  ,0,0,0,0,0,0,0,0,0,-16000,0,0,0,0,16000,-16000,-16000
054793,牧德群益9A購01  ,0,0,0,0,0,0,0,0,0,-16000,0,0,0,44000,60000,-16000,-16000
053500,新日興兆豐97購01,0,0,0,0,0,0,0,0,0,-16000,0,0,0,80000,96000,-16000,-16000
8072,陞泰            ,5000,21000,-16000,0,0,0,0,0,0,0,0,0,0,0,0,0,-16000
4912,聯德控股-KY     ,22000,39000,-17000,0,0,0,0,0,0,0,0,0,0,0,0,0,-17000
6164,華興            ,15000,20000,-5000,0,0,0,0,0,0,-12000,0,12000,-12000,0,0,0,-17000
08218P,滬深2X凱基96售01,0,0,0,0,0,0,0,0,0,-17000,0,0,0,4000,21000,-17000,-17000
07128P,大毅元大99售04  ,0,0,0,0,0,0,0,0,0,-17000,0,0,0,80000,97000,-17000,-17000
058510,全新元大9B購02  ,0,0,0,0,0,0,0,0,0,-17000,0,0,0,8000,25000,-17000,-17000
059116,晶豪科永豐99購01,0,0,0,0,0,0,0,0,0,-17000,0,0,0,0,17000,-17000,-17000
058733,同欣電永豐99購02,0,0,0,0,0,0,0,0,0,-17000,0,0,0,3000,20000,-17000,-17000
06767P,台積電永昌99售03,0,0,0,0,0,0,0,0,0,-17000,0,0,0,0,17000,-17000,-17000
06573P,台積電永昌99售02,0,0,0,0,0,0,0,0,0,-17000,0,0,0,3000,20000,-17000,-17000
06474P,鴻海富邦98售03  ,0,0,0,0,0,0,0,0,0,-17000,0,0,0,3000,20000,-17000,-17000
04732P,聯茂群益94售01  ,0,0,0,0,0,0,0,0,0,-17000,0,0,0,0,17000,-17000,-17000
03418B,臺股指元大95熊20,1000,0,1000,0,0,0,0,0,0,-18000,0,0,0,21000,39000,-18000,-17000
04287P,A50正2中信96售01,0,0,0,0,0,0,0,0,0,-17000,0,0,0,21000,38000,-17000,-17000
04881P,高股息凱基96售01,0,0,0,0,0,0,0,0,0,-17000,0,0,0,58000,75000,-17000,-17000
052201,超眾統一96購01  ,0,0,0,0,0,0,0,0,0,-17000,0,0,0,13000,30000,-17000,-17000
056812,泰鼎統一98購01  ,0,0,0,0,0,0,0,0,0,-17000,0,0,0,3000,20000,-17000,-17000
049433,健策國票95購03  ,0,0,0,0,0,0,0,0,0,-17000,0,0,0,13000,30000,-17000,-17000
053977,新日興元大96購03,0,0,0,0,0,0,0,0,0,-17000,0,0,0,0,17000,-17000,-17000
055337,超眾兆豐98購01  ,0,0,0,0,0,0,0,0,0,-17000,0,0,0,33000,50000,-17000,-17000
057662,上銀元大9A購01  ,0,0,0,0,0,0,0,0,0,-17000,0,0,0,12000,29000,-17000,-17000
057829,臺股指元大98購12,0,0,0,0,0,0,0,0,0,-17000,0,0,0,200000,217000,-17000,-17000
056114,台達電群益97購02,0,0,0,0,0,0,0,0,0,-17000,0,0,0,0,17000,-17000,-17000
6452,康友-KY         ,375000,320000,55000,0,0,0,0,0,0,-72000,0,58000,-58000,13000,27000,-14000,-17000
058798,大立光元大99購11,0,0,0,0,0,0,0,0,0,-18000,0,0,0,54000,72000,-18000,-18000
07013P,玉晶光群益9A售06,0,0,0,0,0,0,0,0,0,-18000,0,0,0,3000,21000,-18000,-18000
06865P,亞德客元大98售04,0,0,0,0,0,0,0,0,0,-18000,0,0,0,84000,102000,-18000,-18000
1474,弘裕            ,16000,32000,-16000,0,0,0,0,0,0,-2000,0,2000,-2000,0,0,0,-18000
6216,居易            ,6000,24000,-18000,0,0,0,0,0,0,0,0,0,0,0,0,0,-18000
2471,資通            ,19000,37000,-18000,0,0,0,0,0,0,0,0,0,0,0,0,0,-18000
04971P,矽力元富94售02  ,0,0,0,0,0,0,0,0,0,-18000,0,0,0,3000,21000,-18000,-18000
04793P,台光電元大94售07,0,0,0,0,0,0,0,0,0,-18000,0,0,0,0,18000,-18000,-18000
048187,臺指反元大96購04,0,0,0,0,0,0,0,0,0,-18000,0,0,0,2000,20000,-18000,-18000
04564P,大立光凱基94售06,0,0,0,0,0,0,0,0,0,-18000,0,0,0,2000,20000,-18000,-18000
052867,晶技凱基96購01  ,0,0,0,0,0,0,0,0,0,-18000,0,0,0,2000,20000,-18000,-18000
055489,瑞昱元大97購02  ,0,0,0,0,0,0,0,0,0,-18000,0,0,0,5000,23000,-18000,-18000
054410,國巨元大96購14  ,0,0,0,0,0,0,0,0,0,-18000,0,0,0,0,18000,-18000,-18000
053725,晶相光凱基96購01,0,0,0,0,0,0,0,0,0,-18000,0,0,0,12000,30000,-18000,-18000
1419,新紡            ,19000,38000,-19000,0,0,0,0,0,0,0,0,0,0,0,0,0,-19000
1535,中宇            ,9000,28000,-19000,0,0,0,0,0,0,0,0,0,0,0,0,0,-19000
058492,華通群益9B購01  ,0,0,0,0,0,0,0,0,0,-19000,0,0,0,11000,30000,-19000,-19000
05845P,大立光元大96售06,0,0,0,0,0,0,0,0,0,-19000,0,0,0,10000,29000,-19000,-19000
058371,智原凱基9A購01  ,0,0,0,0,0,0,0,0,0,-19000,0,0,0,0,19000,-19000,-19000
06490P,鴻海富邦99售02  ,0,0,0,0,0,0,0,0,0,-19000,0,0,0,0,19000,-19000,-19000
06595P,祥碩元大98售03  ,0,0,0,0,0,0,0,0,0,-19000,0,0,0,346000,365000,-19000,-19000
06608P,立積群益99售02  ,0,0,0,0,0,0,0,0,0,-19000,0,0,0,9000,28000,-19000,-19000
06068P,玉晶光康和97售01,0,0,0,0,0,0,0,0,0,-19000,0,0,0,2000,21000,-19000,-19000
06015P,大立光富邦98售04,0,0,0,0,0,0,0,0,0,-19000,0,0,0,6000,25000,-19000,-19000
04936P,大立光中信95售03,0,0,0,0,0,0,0,0,0,-19000,0,0,0,3000,22000,-19000,-19000
04607P,A50中信94售01   ,0,0,0,0,0,0,0,0,0,-19000,0,0,0,0,19000,-19000,-19000
00731,FH富時高息低波  ,0,0,0,0,0,0,0,0,0,-19000,0,0,0,78000,97000,-19000,-19000
057371,可成元大98購08  ,0,0,0,0,0,0,0,0,0,-19000,0,0,0,41000,60000,-19000,-19000
055724,祥碩元大97購03  ,0,0,0,0,0,0,0,0,0,-19000,0,0,0,20000,39000,-19000,-19000
054594,國巨麥證97購01  ,0,0,0,0,59000,-59000,0,0,0,-19000,0,0,0,40000,59000,-19000,-19000
05621P,聯電中信96售01  ,0,0,0,0,0,0,0,0,0,-19000,0,0,0,63000,82000,-19000,-19000
06225P,華新科元富97售04,0,0,0,0,0,0,0,0,0,-20000,0,0,0,0,20000,-20000,-20000
06089P,矽創永豐97售01  ,0,0,0,0,0,0,0,0,0,-20000,0,0,0,0,20000,-20000,-20000
05930P,景碩康和96售01  ,0,0,0,0,0,0,0,0,0,-20000,0,0,0,0,20000,-20000,-20000
059281,創意永豐99購02  ,0,0,0,0,0,0,0,0,0,-20000,0,0,0,0,20000,-20000,-20000
06758P,鴻海元大98售10  ,0,0,0,0,0,0,0,0,0,-20000,0,0,0,35000,55000,-20000,-20000
06518P,奇力新兆豐99售01,0,0,0,0,0,0,0,0,0,-20000,0,0,0,0,20000,-20000,-20000
06481P,台積電凱基98售12,0,0,0,0,0,0,0,0,0,-20000,0,0,0,7000,27000,-20000,-20000
06465P,國巨統一98售04  ,0,0,0,0,0,0,0,0,0,-20000,0,0,0,40000,60000,-20000,-20000
06411P,晶相光永豐97售03,0,0,0,0,0,0,0,0,0,-20000,0,0,0,0,20000,-20000,-20000
06270P,致伸凱基97售03  ,0,0,0,0,0,0,0,0,0,-20000,0,0,0,0,20000,-20000,-20000
058362,聯發科凱基99購06,0,0,0,0,0,0,0,0,0,-20000,0,0,0,0,20000,-20000,-20000
058691,友訊國票9A購01  ,0,0,0,0,0,0,0,0,0,-20000,0,0,0,0,20000,-20000,-20000
058832,立積永豐99購01  ,0,0,0,0,0,0,0,0,0,-20000,0,0,0,30000,50000,-20000,-20000
059069,臺指反元大9C購01,0,0,0,0,0,0,0,0,0,-20000,0,0,0,0,20000,-20000,-20000
059037,宏達電群益99購02,0,0,0,0,0,0,0,0,0,-20000,0,0,0,30000,50000,-20000,-20000
058953,S&P反1國票03購01,0,0,0,0,0,0,0,0,0,-20000,0,0,0,10000,30000,-20000,-20000
08865P,欣興元大01售02  ,0,0,0,0,0,0,0,0,0,-20000,0,0,0,0,20000,-20000,-20000
06846P,美律元大98售05  ,0,0,0,0,0,0,0,0,0,-20000,0,0,0,10000,30000,-20000,-20000
06912P,台光電元大99售02,0,0,0,0,0,0,0,0,0,-20000,0,0,0,0,20000,-20000,-20000
06903P,技嘉凱基98售04  ,0,0,0,0,0,0,0,0,0,-20000,0,0,0,0,20000,-20000,-20000
06980P,緯穎永豐99售02  ,0,0,0,0,0,0,0,0,0,-20000,0,0,0,10000,30000,-20000,-20000
2483,百容            ,8000,28000,-20000,0,0,0,0,0,0,0,0,0,0,0,0,0,-20000
2495,普安            ,40000,59000,-19000,0,0,0,0,0,0,-1000,0,1000,-1000,0,0,0,-20000
2528,皇普            ,40000,61000,-21000,0,0,0,0,0,0,1000,6000,5000,1000,0,0,0,-20000
6243,迅杰            ,5000,25000,-20000,0,0,0,0,0,0,0,0,0,0,0,0,0,-20000
3416,融程電          ,8000,28000,-20000,0,0,0,0,0,0,0,0,0,0,0,0,0,-20000
04242P,台積電永昌93售08,0,0,0,0,0,0,0,0,0,-20000,0,0,0,0,20000,-20000,-20000
04395P,台積電群益94售06,0,0,0,0,0,0,0,0,0,-20000,0,0,0,1000,21000,-20000,-20000
04397P,玉晶光群益95售03,0,0,0,0,0,0,0,0,0,-20000,0,0,0,0,20000,-20000,-20000
03047X,元展44          ,0,0,0,0,0,0,0,0,0,-20000,0,0,0,0,20000,-20000,-20000
044784,華邦電中信96購01,0,0,0,0,0,0,0,0,0,-20000,0,0,0,0,20000,-20000,-20000
04466P,大立光元富94售04,0,0,0,0,0,0,0,0,0,-20000,0,0,0,1000,21000,-20000,-20000
04456P,日月光統一94售01,0,0,0,0,0,0,0,0,0,-20000,0,0,0,0,20000,-20000,-20000
045106,玉晶光群益95購01,0,0,0,0,0,0,0,0,0,-20000,0,0,0,0,20000,-20000,-20000
04003P,麗豐凱基94售03  ,0,0,0,0,0,0,0,0,0,-20000,0,0,0,0,20000,-20000,-20000
03564P,為升群益02售02  ,0,0,0,0,0,0,0,0,0,-20000,0,0,0,0,20000,-20000,-20000
03626P,可成兆豐93售03  ,0,0,0,0,0,0,0,0,0,-20000,0,0,0,0,20000,-20000,-20000
04608P,晶相光永豐94售02,0,0,0,0,0,0,0,0,0,-20000,0,0,0,0,20000,-20000,-20000
04933P,中石化中信96售01,0,0,0,0,0,0,0,0,0,-20000,0,0,0,0,20000,-20000,-20000
052276,力成群益96購01  ,0,0,0,0,0,0,0,0,0,-20000,0,0,0,0,20000,-20000,-20000
052256,台泥國泰96購01  ,0,0,0,0,0,0,0,0,0,-20000,0,0,0,0,20000,-20000,-20000
052754,上証2X群益9A購01,0,0,0,0,0,0,0,0,0,-20000,0,0,0,0,20000,-20000,-20000
05278P,台郡元富95售02  ,0,0,0,0,0,0,0,0,0,-20000,0,0,0,0,20000,-20000,-20000
052813,T50正2永豐96購01,0,0,0,0,0,0,0,0,0,-20000,0,0,0,0,20000,-20000,-20000
049221,健策國票95購02  ,0,0,0,0,0,0,0,0,0,-20000,0,0,0,10000,30000,-20000,-20000
04927P,大立光凱基95售06,0,0,0,0,0,0,0,0,0,-20000,0,0,0,0,20000,-20000,-20000
045250,華通凱基94購01  ,0,0,0,0,0,0,0,0,0,-20000,0,0,0,0,20000,-20000,-20000
046927,上銀富邦95購01  ,0,0,0,0,0,0,0,0,0,-20000,0,0,0,0,20000,-20000,-20000
048209,臺股指元大93購43,0,0,0,0,0,0,0,0,0,-20000,0,0,0,0,20000,-20000,-20000
048334,A50正2元大96購01,0,0,0,0,0,0,0,0,0,-20000,0,0,0,0,20000,-20000,-20000
04830P,大立光凱基94售15,0,0,0,0,0,0,0,0,0,-20000,0,0,0,0,20000,-20000,-20000
046870,大立光統一95購01,0,0,0,0,0,0,0,0,0,-20000,0,0,0,0,20000,-20000,-20000
048552,鴻海元大94購03  ,0,0,0,0,0,0,0,0,0,-20000,0,0,0,60000,80000,-20000,-20000
047911,晶技麥證94購01  ,0,0,0,0,20000,-20000,0,0,0,-20000,0,0,0,0,20000,-20000,-20000
047417,台塑富邦97購01  ,0,0,0,0,0,0,0,0,0,-20000,0,0,0,0,20000,-20000,-20000
047629,深中小元大96購01,0,0,0,0,0,0,0,0,0,-20000,0,0,0,10000,30000,-20000,-20000
05023P,和碩凱基95售01  ,0,0,0,0,0,0,0,0,0,-20000,0,0,0,2000,22000,-20000,-20000
050266,兆豐金元大94購01,0,0,0,0,0,0,0,0,0,-20000,0,0,0,10000,30000,-20000,-20000
050262,台積電元大94購21,0,0,0,0,0,0,0,0,0,-20000,0,0,0,10000,30000,-20000,-20000
050714,深中小群益98購01,0,0,0,0,0,0,0,0,0,-20000,0,0,0,0,20000,-20000,-20000
05049P,矽創永豐95售01  ,0,0,0,0,0,0,0,0,0,-20000,0,0,0,50000,70000,-20000,-20000
051987,廣達元大95購01  ,0,0,0,0,0,0,0,0,0,-20000,0,0,0,50000,70000,-20000,-20000
051412,奇力新國票96購01,0,0,0,0,0,0,0,0,0,-20000,0,0,0,0,20000,-20000,-20000
051384,康友群益95購01  ,0,0,0,0,0,0,0,0,0,-20000,0,0,0,0,20000,-20000,-20000
052523,奇力新元大97購01,0,0,0,0,0,0,0,0,0,-20000,0,0,0,0,20000,-20000,-20000
052520,南亞科元大95購06,0,0,0,0,0,0,0,0,0,-20000,0,0,0,0,20000,-20000,-20000
05673P,台積電群益96售05,0,0,0,0,0,0,0,0,0,-20000,0,0,0,100000,120000,-20000,-20000
056645,大立光凱基98購12,0,0,0,0,0,0,0,0,0,-20000,0,0,0,0,20000,-20000,-20000
056495,泰鼎國泰99購01  ,0,0,0,0,0,0,0,0,0,-20000,0,0,0,60000,80000,-20000,-20000
056375,玉晶光統一01購01,0,0,0,0,0,0,0,0,0,-20000,0,0,0,0,20000,-20000,-20000
056376,玉晶光統一98購01,0,0,0,0,0,0,0,0,0,-20000,0,0,0,0,20000,-20000,-20000
050015,友達富邦95購01  ,0,0,0,0,0,0,0,0,0,-20000,0,0,0,0,20000,-20000,-20000
049843,康友中信95購01  ,0,0,0,0,0,0,0,0,0,-20000,0,0,0,4000,24000,-20000,-20000
049893,日月光富邦98購01,0,0,0,0,0,0,0,0,0,-20000,0,0,0,0,20000,-20000,-20000
04989P,國巨元大94售15  ,0,0,0,0,0,0,0,0,0,-20000,0,0,0,230000,250000,-20000,-20000
049954,健策群益95購01  ,0,0,0,0,0,0,0,0,0,-20000,0,0,0,0,20000,-20000,-20000
049916,台光電元大94購06,0,0,0,0,0,0,0,0,0,-20000,0,0,0,0,20000,-20000,-20000
05094P,大立光元大95售07,0,0,0,0,0,0,0,0,0,-20000,0,0,0,0,20000,-20000,-20000
049820,世紀鋼元大96購03,0,0,0,0,0,0,0,0,0,-20000,0,0,0,46000,66000,-20000,-20000
051673,玉晶光元大96購04,0,0,0,0,0,0,0,0,0,-20000,0,0,0,40000,60000,-20000,-20000
051627,華新科麥證95購03,0,0,0,10000,30000,-20000,0,0,0,-20000,0,0,0,10000,30000,-20000,-20000
051650,矽力永豐95購01  ,0,0,0,0,0,0,0,0,0,-20000,0,0,0,0,20000,-20000,-20000
053120,復盛中信9A購01  ,0,0,0,0,0,0,0,0,0,-20000,0,0,0,0,20000,-20000,-20000
057042,台積電元大98購10,10000,0,10000,0,0,0,0,0,0,-30000,0,0,0,10000,40000,-30000,-20000
057079,台積電統一9A購02,0,0,0,0,0,0,0,0,0,-20000,0,0,0,0,20000,-20000,-20000
055849,聯詠元大97購05  ,0,0,0,0,0,0,0,0,0,-20000,0,0,0,30000,50000,-20000,-20000
055902,同欣電中信99購01,0,0,0,0,0,0,0,0,0,-20000,0,0,0,0,20000,-20000,-20000
055951,大成鋼元大97購02,0,0,0,0,0,0,0,0,0,-20000,0,0,0,0,20000,-20000,-20000
054634,FB上証中信99購01,0,0,0,0,0,0,0,0,0,-20000,0,0,0,0,20000,-20000,-20000
054569,GIS群益98購01   ,0,0,0,0,0,0,0,0,0,-20000,0,0,0,0,20000,-20000,-20000
055508,矽力元大97購01  ,0,0,0,0,0,0,0,0,0,-20000,0,0,0,0,20000,-20000,-20000
057617,國巨凱基99購06  ,0,0,0,0,0,0,0,0,0,-20000,0,0,0,0,20000,-20000,-20000
054944,精元元大97購01  ,0,0,0,0,0,0,0,0,0,-20000,0,0,0,0,20000,-20000,-20000
054545,奇力新中信98購01,0,0,0,0,0,0,0,0,0,-20000,0,0,0,0,20000,-20000,-20000
055031,南港富邦99購01  ,0,0,0,0,0,0,0,0,0,-20000,0,0,0,0,20000,-20000,-20000
055594,華新科元大98購02,0,0,0,0,0,0,0,0,0,-20000,0,0,0,70000,90000,-20000,-20000
053178,南亞科統一98購01,0,0,0,0,0,0,0,0,0,-20000,0,0,0,0,20000,-20000,-20000
053243,楠梓電國票97購02,0,0,0,0,0,0,0,0,0,-20000,0,0,0,0,20000,-20000,-20000
055653,聯詠元富01購02  ,0,0,0,0,0,0,0,0,0,-20000,0,0,0,0,20000,-20000,-20000
055663,崇越中信97購01  ,0,0,0,0,0,0,0,0,0,-20000,0,0,0,10000,30000,-20000,-20000
057782,台積電國票99購07,0,0,0,0,0,0,0,0,0,-20000,0,0,0,0,20000,-20000,-20000
057767,緯穎凱基98購06  ,0,0,0,0,0,0,0,0,0,-20000,0,0,0,0,20000,-20000,-20000
057807,友訊元大98購02  ,0,0,0,0,0,0,0,0,0,-20000,0,0,0,0,20000,-20000,-20000
057876,隆達元大98購01  ,0,0,0,0,0,0,0,0,0,-20000,0,0,0,10000,30000,-20000,-20000
058083,聯發科群益98購08,0,0,0,0,0,0,0,0,0,-20000,0,0,0,0,20000,-20000,-20000
058035,旭富永豐98購02  ,0,0,0,0,0,0,0,0,0,-20000,0,0,0,0,20000,-20000,-20000
057955,技嘉元大98購07  ,0,0,0,0,0,0,0,0,0,-20000,0,0,0,0,20000,-20000,-20000
058091,欣興元大99購03  ,0,0,0,0,0,0,0,0,0,-20000,0,0,0,10000,30000,-20000,-20000
058127,FBVIX元大9C購01 ,0,0,0,0,0,0,0,0,0,-20000,0,0,0,0,20000,-20000,-20000
058105,旺宏統一9A購02  ,0,0,0,0,0,0,0,0,0,-20000,0,0,0,0,20000,-20000,-20000
055239,帆宣台新97購01  ,0,0,0,0,0,0,0,0,0,-20000,0,0,0,0,20000,-20000,-20000
057181,亞光元大98購02  ,0,0,0,0,0,0,0,0,0,-20000,0,0,0,20000,40000,-20000,-20000
057117,開發金日盛9B購01,0,0,0,0,0,0,0,0,0,-20000,0,0,0,0,20000,-20000,-20000
057118,欣興日盛9A購01  ,0,0,0,0,0,0,0,0,0,-20000,0,0,0,0,20000,-20000,-20000
056908,牧德元大99購03  ,0,0,0,0,0,0,0,0,0,-20000,0,0,0,0,20000,-20000,-20000
054090,瑞昱群益97購01  ,0,0,0,0,0,0,0,0,0,-20000,0,0,0,0,20000,-20000,-20000
054036,T50反1元大96購08,0,0,0,0,0,0,0,0,0,-20000,0,0,0,0,20000,-20000,-20000
05404P,台積電群益95售06,0,0,0,0,0,0,0,0,0,-20000,0,0,0,490000,510000,-20000,-20000
054047,富邦金元大97購01,0,0,0,0,0,0,0,0,0,-20000,0,0,0,0,20000,-20000,-20000
054128,台積電元大97購10,0,0,0,0,0,0,0,0,0,-20000,0,0,0,0,20000,-20000,-20000
055131,茂林康和97購01  ,0,0,0,0,0,0,0,0,0,-20000,0,0,0,0,20000,-20000,-20000
057348,台積電統一98購09,0,0,0,0,0,0,0,0,0,-20000,0,0,0,0,20000,-20000,-20000
057525,光磊元大99購01  ,0,0,0,0,0,0,0,0,0,-20000,0,0,0,60000,80000,-20000,-20000
057531,禾伸堂元大99購04,0,0,0,0,0,0,0,0,0,-20000,0,0,0,0,20000,-20000,-20000
057498,台郡元大98購04  ,0,0,0,0,0,0,0,0,0,-20000,0,0,0,0,20000,-20000,-20000
057484,南亞科元大98購06,0,0,0,0,0,0,0,0,0,-20000,0,0,0,0,20000,-20000,-20000
057314,全新麥證98購01  ,0,0,0,0,20000,-20000,0,0,0,-20000,0,0,0,0,20000,-20000,-20000
054254,晶豪科元大96購02,0,0,0,0,0,0,0,0,0,-20000,0,0,0,0,20000,-20000,-20000
055272,國巨元大98購04  ,0,0,0,0,0,0,0,0,0,-20000,0,0,0,32000,52000,-20000,-20000
054191,香港2X中信98購01,0,0,0,0,0,0,0,0,0,-20000,0,0,0,0,20000,-20000,-20000
054162,光罩凱基98購01  ,0,0,0,0,0,0,0,0,0,-20000,0,0,0,0,20000,-20000,-20000
053786,新日興元大96購02,0,0,0,0,0,0,0,0,0,-20000,0,0,0,52000,72000,-20000,-20000
053770,元金2X元大98購01,0,0,0,0,0,0,0,0,0,-20000,0,0,0,0,20000,-20000,-20000
053385,聯詠元大96購02  ,0,0,0,0,0,0,0,0,0,-20000,0,0,0,0,20000,-20000,-20000
053987,宏碁亞東96購01  ,0,0,0,0,0,0,0,0,0,-20000,0,0,0,0,20000,-20000,-20000
053525,台積電中信96購04,0,0,0,0,0,0,0,0,0,-20000,0,0,0,0,20000,-20000,-20000
05360P,健策元大95售03  ,0,0,0,0,0,0,0,0,0,-20000,0,0,0,55000,75000,-20000,-20000
053059,聯發科永昌99購01,0,0,0,0,0,0,0,0,0,-20000,0,0,0,0,20000,-20000,-20000
053033,智易兆豐97購01  ,0,0,0,0,0,0,0,0,0,-20000,0,0,0,0,20000,-20000,-20000
05309P,康友中信95售03  ,0,0,0,0,0,0,0,0,0,-20000,0,0,0,0,20000,-20000,-20000
054834,帆宣中信97購01  ,0,0,0,0,0,0,0,0,0,-20000,0,0,0,0,20000,-20000,-20000
054759,台化國票98購01  ,0,0,0,0,0,0,0,0,0,-20000,0,0,0,0,20000,-20000,-20000
057224,和碩日盛9A購01  ,0,0,0,0,0,0,0,0,0,-20000,0,0,0,0,20000,-20000,-20000
057261,瑞昱兆豐98購01  ,0,0,0,0,0,0,0,0,0,-20000,0,0,0,0,20000,-20000,-20000
055414,奇力新富邦9B購01,0,0,0,0,0,0,0,0,0,-20000,0,0,0,0,20000,-20000,-20000
054369,鴻海中信9C購01  ,0,0,0,0,0,0,0,0,0,-20000,0,0,0,0,20000,-20000,-20000
053394,鴻海中信9A購01  ,0,0,0,0,0,0,0,0,0,-20000,0,0,0,0,20000,-20000,-20000
054272,華通中信98購01  ,0,0,0,0,0,0,0,0,0,-20000,0,0,0,0,20000,-20000,-20000
3296,勝德            ,8000,29000,-21000,0,0,0,0,0,0,0,0,0,0,0,0,0,-21000
4764,雙鍵            ,15000,36000,-21000,0,0,0,0,0,0,0,0,0,0,0,0,0,-21000
5269,祥碩            ,209000,306000,-97000,0,0,0,117000,0,117000,-41000,39000,35000,4000,8000,53000,-45000,-21000
2939,凱羿-KY         ,9000,30000,-21000,0,0,0,0,0,0,0,0,0,0,0,0,0,-21000
06785P,臺股指元大98售02,0,0,0,0,0,0,0,0,0,-21000,0,0,0,0,21000,-21000,-21000
1611,中電            ,148000,169000,-21000,0,0,0,0,0,0,0,0,0,0,0,0,0,-21000
058818,南電台新99購03  ,0,0,0,0,0,0,0,0,0,-21000,0,0,0,110000,131000,-21000,-21000
06245P,健策元富97售03  ,0,0,0,0,0,0,0,0,0,-21000,0,0,0,5000,26000,-21000,-21000
06593P,欣興元大98售05  ,0,0,0,0,0,0,0,0,0,-21000,0,0,0,0,21000,-21000,-21000
05922P,京元電兆豐96售01,0,0,0,0,0,0,0,0,0,-21000,0,0,0,0,21000,-21000,-21000
05658P,日月光元富96售02,0,0,0,0,0,0,0,0,0,-21000,0,0,0,20000,41000,-21000,-21000
056619,強茂永豐98購01  ,0,0,0,0,0,0,0,0,0,-21000,0,0,0,0,21000,-21000,-21000
049436,義隆國泰96購02  ,0,0,0,0,0,0,0,0,0,-21000,0,0,0,79000,100000,-21000,-21000
05033P,T50反1元大98售01,0,0,0,0,0,0,0,0,0,-21000,0,0,0,0,21000,-21000,-21000
052828,滬深2X群益9A購02,0,0,0,0,0,0,0,0,0,-21000,0,0,0,0,21000,-21000,-21000
053889,致茂群益97購01  ,0,0,0,0,0,0,0,0,0,-21000,0,0,0,0,21000,-21000,-21000
057761,聯發科凱基99購04,0,0,0,0,0,0,0,0,0,-21000,0,0,0,100000,121000,-21000,-21000
056473,奇力新元大99購02,0,0,0,0,0,0,0,0,0,-21000,0,0,0,0,21000,-21000,-21000
054962,玉晶光元大99購02,0,0,0,0,0,0,0,0,0,-21000,0,0,0,0,21000,-21000,-21000
05921P,同欣電元大96售06,0,0,0,0,0,0,0,0,0,-22000,0,0,0,0,22000,-22000,-22000
05948P,茂林元大96售03  ,0,0,0,0,0,0,0,0,0,-22000,0,0,0,215000,237000,-22000,-22000
05942P,奇力新凱基96售04,0,0,0,0,0,0,0,0,0,-22000,0,0,0,10000,32000,-22000,-22000
06737P,台郡凱基98售07  ,0,0,0,0,0,0,0,0,0,-22000,0,0,0,0,22000,-22000,-22000
1592,英瑞-KY         ,39000,61000,-22000,0,0,0,0,0,0,0,0,0,0,0,0,0,-22000
1760,寶齡富錦        ,210000,231000,-21000,0,0,0,0,0,0,-1000,0,0,0,0,1000,-1000,-22000
06782P,大立光元大99售07,0,0,0,0,0,0,0,0,0,-22000,0,0,0,50000,72000,-22000,-22000
06994P,台光電凱基99售02,0,0,0,0,0,0,0,0,0,-22000,0,0,0,0,22000,-22000,-22000
07035P,大立光元富99售04,0,0,0,0,0,0,0,0,0,-22000,0,0,0,11000,33000,-22000,-22000
07206P,鴻海凱基9A售11  ,0,0,0,0,0,0,0,0,0,-22000,0,0,0,0,22000,-22000,-22000
2539,櫻花建          ,41000,63000,-22000,0,0,0,0,0,0,0,0,0,0,0,0,0,-22000
6215,和椿            ,5000,27000,-22000,0,0,0,0,0,0,0,0,0,0,0,0,0,-22000
4545,銘鈺            ,16000,30000,-14000,0,0,0,0,0,0,-8000,0,8000,-8000,0,0,0,-22000
052923,台積電永豐96購02,0,0,0,0,0,0,0,0,0,-22000,0,0,0,0,22000,-22000,-22000
04602P,聯詠凱基94售02  ,0,0,0,0,0,0,0,0,0,-22000,0,0,0,30000,52000,-22000,-22000
05116P,台積電群益95售03,0,0,0,0,0,0,0,0,0,-22000,0,0,0,5000,27000,-22000,-22000
04723P,美律凱基94售06  ,0,0,0,0,0,0,0,0,0,-22000,0,0,0,9000,31000,-22000,-22000
054862,群光群益97購01  ,0,0,0,0,0,0,0,0,0,-22000,0,0,0,0,22000,-22000,-22000
055102,上銀凱基98購01  ,0,0,0,0,0,0,0,0,0,-22000,0,0,0,0,22000,-22000,-22000
057595,健鼎兆豐98購01  ,0,0,0,0,0,0,0,0,0,-22000,0,0,0,0,22000,-22000,-22000
056142,超眾元大97購06  ,0,0,0,0,0,0,0,0,0,-22000,0,0,0,0,22000,-22000,-22000
055668,欣興群益97購01  ,0,0,0,0,0,0,0,0,0,-22000,0,0,0,80000,102000,-22000,-22000
3591,艾笛森          ,18000,41000,-23000,0,0,0,0,0,0,0,0,0,0,0,0,0,-23000
07198P,臺股指元大99售14,0,0,0,0,0,0,0,0,0,-23000,0,0,0,0,23000,-23000,-23000
07161P,臺股指群益99售12,0,0,0,0,0,0,0,0,0,-23000,0,0,0,0,23000,-23000,-23000
07070P,晶相光元富99售01,0,0,0,0,0,0,0,0,0,-23000,0,0,0,3000,26000,-23000,-23000
06778P,台積電元大99售06,0,0,0,0,0,0,0,0,0,-23000,0,0,0,133000,156000,-23000,-23000
1321,大洋            ,54000,77000,-23000,0,0,0,0,0,0,0,0,0,0,0,0,0,-23000
059194,元金2X永豐99購01,0,0,0,0,0,0,0,0,0,-23000,0,0,0,0,23000,-23000,-23000
058491,滬深2X群益01購01,0,0,0,0,0,0,0,0,0,-23000,0,0,0,73000,96000,-23000,-23000
046905,新光金凱基99購01,0,0,0,0,0,0,0,0,0,-23000,0,0,0,0,23000,-23000,-23000
04918P,華新科凱基94售12,0,0,0,0,0,0,0,0,0,-23000,0,0,0,7000,30000,-23000,-23000
050915,健策中信98購01  ,0,0,0,0,0,0,0,0,0,-23000,0,0,0,43000,66000,-23000,-23000
056155,嘉晶凱基97購01  ,0,0,0,0,0,0,0,0,0,-23000,0,0,0,20000,43000,-23000,-23000
2748,雲品            ,8000,20000,-12000,0,0,0,0,0,0,-11714,0,11714,-11714,0,0,0,-23714
3057,喬鼎            ,17000,41000,-24000,0,0,0,0,0,0,0,0,0,0,0,0,0,-24000
6201,亞弘電          ,10000,34000,-24000,0,0,0,0,0,0,0,0,0,0,0,0,0,-24000
2227,裕日車          ,33000,61000,-28000,0,0,0,1000,0,1000,3000,5000,2000,3000,0,0,0,-24000
06936P,瑞儀元大98售01  ,0,0,0,0,0,0,0,0,0,-24000,0,0,0,104000,128000,-24000,-24000
059254,台表科凱基9A購02,0,0,0,0,0,0,0,0,0,-24000,0,0,0,0,24000,-24000,-24000
06743P,創意永豐98售03  ,0,0,0,0,0,0,0,0,0,-24000,0,0,0,0,24000,-24000,-24000
05088P,大立光富邦99售01,0,0,0,0,0,0,0,0,0,-24000,0,0,0,7000,31000,-24000,-24000
05137P,華新科凱基96售03,0,0,0,0,0,0,0,0,0,-24000,0,0,0,27000,51000,-24000,-24000
052482,茂林群益95購01  ,0,0,0,0,0,0,0,0,0,-24000,0,0,0,0,24000,-24000,-24000
056664,上証反中信9B購01,0,0,0,0,0,0,0,0,0,-24000,0,0,0,150000,174000,-24000,-24000
03033X,元展30          ,0,0,0,0,0,0,0,0,0,-24000,0,0,0,1000,25000,-24000,-24000
04804P,聯發科凱基94售12,0,0,0,0,0,0,0,0,0,-24000,0,0,0,0,24000,-24000,-24000
051259,鴻海永昌96購03  ,0,0,0,0,0,0,0,0,0,-24000,0,0,0,0,24000,-24000,-24000
04634P,臺股指群益94售09,0,0,0,0,0,0,0,0,0,-24000,0,0,0,0,24000,-24000,-24000
056289,合勤控永豐97購01,0,0,0,0,0,0,0,0,0,-24000,0,0,0,0,24000,-24000,-24000
055469,台光電凱基97購01,0,0,0,0,0,0,0,0,0,-24000,0,0,0,0,24000,-24000,-24000
055064,碩天永豐97購01  ,0,0,0,0,0,0,0,0,0,-24000,0,0,0,0,24000,-24000,-24000
057737,國巨富邦99購02  ,0,0,0,0,0,0,0,0,0,-24000,0,0,0,0,24000,-24000,-24000
054428,禾伸堂富邦98購01,0,0,0,0,0,0,0,0,0,-24000,0,0,0,0,24000,-24000,-24000
05719P,可成元大96售03  ,0,0,0,0,0,0,0,0,0,-24000,0,0,0,1000,25000,-24000,-24000
06080P,景碩群益98售02  ,0,0,0,0,0,0,0,0,0,-25000,0,0,0,10000,35000,-25000,-25000
06056P,台積電凱基98售02,0,0,0,0,0,0,0,0,0,-25000,0,0,0,19000,44000,-25000,-25000
058705,長榮航元大99購01,0,0,0,0,0,0,0,0,0,-25000,0,0,0,220000,245000,-25000,-25000
06967P,台郡台新99售02  ,0,0,0,0,0,0,0,0,0,-25000,0,0,0,0,25000,-25000,-25000
07106P,國巨統一9B售05  ,0,0,0,0,0,0,0,0,0,-25000,0,0,0,25000,50000,-25000,-25000
07101P,台郡元大99售06  ,0,0,0,0,0,0,0,0,0,-25000,0,0,0,55000,80000,-25000,-25000
07135P,臺股指元大9A售29,0,0,0,0,0,0,0,0,0,-25000,0,0,0,0,25000,-25000,-25000
1533,車王電          ,32000,57000,-25000,0,0,0,0,0,0,0,0,0,0,0,0,0,-25000
6128,上福            ,9000,34000,-25000,0,0,0,0,0,0,0,0,0,0,0,0,0,-25000
3528,安馳            ,11000,36000,-25000,0,0,0,0,0,0,0,0,0,0,0,0,0,-25000
4104,佳醫            ,39000,64000,-25000,0,0,0,0,0,0,0,0,0,0,0,0,0,-25000
2642,宅配通          ,60000,85000,-25000,0,0,0,0,0,0,0,0,0,0,0,0,0,-25000
2460,建通            ,22000,47000,-25000,0,0,0,0,0,0,0,0,0,0,0,0,0,-25000
05104P,智邦台新95售02  ,0,0,0,0,0,0,0,0,0,-25000,0,0,0,20000,45000,-25000,-25000
05275P,國巨凱基95售05  ,0,0,0,0,0,0,0,0,0,-25000,0,0,0,40000,65000,-25000,-25000
048049,滬深反中信96購01,0,0,0,0,0,0,0,0,0,-25000,0,0,0,47000,72000,-25000,-25000
035276,南亞科台新97購01,0,0,0,0,0,0,0,0,0,-25000,0,0,0,1000,26000,-25000,-25000
056740,大立光凱基98購13,0,0,0,0,0,0,0,0,0,-25000,0,0,0,10000,35000,-25000,-25000
05017P,臺股指元大95售08,0,0,0,0,0,0,0,0,0,-25000,0,0,0,27000,52000,-25000,-25000
050099,台積電永昌96購01,0,0,0,0,0,0,0,0,0,-25000,0,0,0,187000,212000,-25000,-25000
049890,嘉澤國泰95購01  ,0,0,0,0,0,0,0,0,0,-25000,0,0,0,76000,101000,-25000,-25000
050402,緯穎中信96購01  ,0,0,0,0,0,0,0,0,0,-25000,0,0,0,20000,45000,-25000,-25000
053400,緯穎中信9A購01  ,0,0,0,0,0,0,0,0,0,-25000,0,0,0,0,25000,-25000,-25000
055161,貿聯元大98購03  ,0,0,0,0,0,0,0,0,0,-25000,0,0,0,0,25000,-25000,-25000
054458,復盛群益96購01  ,0,0,0,0,0,0,0,0,0,-25000,0,0,0,3000,28000,-25000,-25000
054957,興富發元大97購01,0,0,0,0,0,0,0,0,0,-25000,0,0,0,25000,50000,-25000,-25000
056073,智伸科元大97購01,0,0,0,0,0,0,0,0,0,-25000,0,0,0,20000,45000,-25000,-25000
8367,建新國際        ,5000,30000,-25000,0,0,0,0,0,0,0,0,0,0,0,0,0,-25000
1590,亞德客-KY       ,1702546,1770000,-67454,0,0,0,117000,58000,59000,-17000,16000,34000,-18000,15000,14000,1000,-25454
07227P,聯發科元富99售05,0,0,0,0,0,0,0,0,0,-26000,0,0,0,0,26000,-26000,-26000
06812P,台灣50元富9C售01,0,0,0,0,0,0,0,0,0,-26000,0,0,0,113000,139000,-26000,-26000
2485,兆赫            ,541000,509000,32000,0,0,0,0,0,0,-58000,48000,100000,-52000,2000,8000,-6000,-26000
2530,華建            ,19000,45000,-26000,0,0,0,0,0,0,0,0,0,0,0,0,0,-26000
4438,廣越            ,9000,24000,-15000,0,0,0,0,0,0,-11000,5000,16000,-11000,0,0,0,-26000
058501,S&P正2元大99購01,0,0,0,0,0,0,0,0,0,-26000,0,0,0,0,26000,-26000,-26000
06074P,台積電凱基98售04,0,0,0,0,0,0,0,0,0,-26000,0,0,0,0,26000,-26000,-26000
06585P,鴻海元大99售04  ,0,0,0,0,0,0,0,0,0,-26000,0,0,0,0,26000,-26000,-26000
06417P,台積電兆豐97售03,0,0,0,0,0,0,0,0,0,-26000,0,0,0,0,26000,-26000,-26000
04883P,台積電凱基94售35,0,0,0,0,0,0,0,0,0,-26000,0,0,0,0,26000,-26000,-26000
04780P,大立光凱基94售11,0,0,0,0,0,0,0,0,0,-26000,0,0,0,0,26000,-26000,-26000
057690,美律凱基99購03  ,0,0,0,0,0,0,0,0,0,-26000,0,0,0,0,26000,-26000,-26000
058243,華擎元大99購01  ,0,0,0,0,0,0,0,0,0,-26000,0,0,0,0,26000,-26000,-26000
058236,大立光元大99購09,0,0,0,0,0,0,0,0,0,-26000,0,0,0,29000,55000,-26000,-26000
057467,祥碩永豐98購04  ,0,0,0,0,0,0,0,0,0,-26000,0,0,0,53000,79000,-26000,-26000
6672,騰輝電子-KY     ,73000,99000,-26000,0,0,0,0,0,0,0,0,0,0,0,0,0,-26000
06486P,麗豐元大98售02  ,0,0,0,0,0,0,0,0,0,-27000,0,0,0,45000,72000,-27000,-27000
06239P,奇力新元大97售08,0,0,0,0,0,0,0,0,0,-27000,0,0,0,0,27000,-27000,-27000
059213,國巨元大99購19  ,0,0,0,0,0,0,0,0,0,-27000,0,0,0,16000,43000,-27000,-27000
058888,元油2X元大99購16,0,0,0,0,0,0,0,0,0,-27000,0,0,0,10000,37000,-27000,-27000
4190,佐登-KY         ,112000,123000,-11000,0,0,0,0,0,0,-16000,2000,17000,-15000,0,1000,-1000,-27000
5288,豐祥-KY         ,15000,43000,-28000,0,0,0,0,0,0,1000,1000,0,1000,0,0,0,-27000
2497,怡利電          ,14000,38000,-24000,0,0,0,0,0,0,-3000,0,3000,-3000,0,0,0,-27000
2404,漢唐            ,321000,662000,-341000,0,0,0,0,0,0,314000,62000,7000,55000,325000,66000,259000,-27000
06790P,台積電凱基9A售04,0,0,0,0,0,0,0,0,0,-27000,0,0,0,72000,99000,-27000,-27000
06803P,臺股指群益98售09,0,0,0,0,0,0,0,0,0,-27000,0,0,0,15000,42000,-27000,-27000
1608,華榮            ,164000,185000,-21000,0,0,0,0,0,0,-6000,0,6000,-6000,0,0,0,-27000
05292P,台積電凱基95售16,0,0,0,0,0,0,0,0,0,-27000,0,0,0,0,27000,-27000,-27000
042993,葡萄王元大94購01,0,0,0,0,0,0,0,0,0,-27000,0,0,0,53000,80000,-27000,-27000
0051,元大中型100     ,0,0,0,0,0,0,0,0,0,-27000,0,0,0,1000,28000,-27000,-27000
05022P,智易凱基95售01  ,0,0,0,0,0,0,0,0,0,-27000,0,0,0,0,27000,-27000,-27000
055565,祥碩凱基97購01  ,0,0,0,0,0,0,0,0,0,-27000,0,0,0,11000,38000,-27000,-27000
8411,福貞-KY         ,21000,43000,-22000,0,0,0,0,0,0,-5000,0,5000,-5000,0,0,0,-27000
1540,喬福            ,10000,38000,-28000,0,0,0,0,0,0,0,0,0,0,0,0,0,-28000
2069,運錩            ,32000,60000,-28000,0,0,0,0,0,0,0,0,0,0,0,0,0,-28000
2008,高興昌          ,13000,41000,-28000,0,0,0,0,0,0,0,0,0,0,0,0,0,-28000
1467,南緯            ,11000,33000,-22000,0,0,0,0,0,0,-6000,0,6000,-6000,0,0,0,-28000
06952P,大立光統一9A售03,0,0,0,0,0,0,0,0,0,-28000,0,0,0,4000,32000,-28000,-28000
07139P,元油2X群益9C售06,0,0,0,0,0,0,0,0,0,-28000,0,0,0,27000,55000,-28000,-28000
058792,鴻海元大99購18  ,0,0,0,0,0,0,0,0,0,-28000,0,0,0,49000,77000,-28000,-28000
058793,鴻海元大99購19  ,0,0,0,0,0,0,0,0,0,-28000,0,0,0,40000,68000,-28000,-28000
058502,鴻海元大99購13  ,0,0,0,0,0,0,0,0,0,-28000,0,0,0,49000,77000,-28000,-28000
058507,美律元大9A購01  ,0,0,0,0,0,0,0,0,0,-28000,0,0,0,32000,60000,-28000,-28000
06447P,上銀元大98售01  ,0,0,0,0,0,0,0,0,0,-28000,0,0,0,30000,58000,-28000,-28000
06727P,台光電元大98售05,0,0,0,0,0,0,0,0,0,-28000,0,0,0,90000,118000,-28000,-28000
05037P,華新科元大95售09,0,0,0,0,0,0,0,0,0,-28000,0,0,0,160000,188000,-28000,-28000
00763U,街口道瓊銅      ,0,0,0,0,0,0,0,0,0,-28000,0,0,0,0,28000,-28000,-28000
03028X,元展25          ,0,0,0,0,0,0,0,0,0,-28000,0,0,0,0,28000,-28000,-28000
058130,瑞昱元大99購01  ,0,0,0,0,0,0,0,0,0,-28000,0,0,0,120000,148000,-28000,-28000
05460P,台郡凱基95售05  ,0,0,0,0,0,0,0,0,0,-28000,0,0,0,20000,48000,-28000,-28000
057376,新日興元大98購04,0,0,0,0,0,0,0,0,0,-28000,0,0,0,22000,50000,-28000,-28000
057377,康控元大99購02  ,0,0,0,0,0,0,0,0,0,-28000,0,0,0,25000,53000,-28000,-28000
054688,兆赫永豐97購01  ,0,0,0,0,0,0,0,0,0,-28000,0,0,0,0,28000,-28000,-28000
053923,亞光國票97購01  ,0,0,0,0,0,0,0,0,0,-28000,0,0,0,0,28000,-28000,-28000
053810,台達電群益96購01,0,0,0,0,0,0,0,0,0,-28000,0,0,0,0,28000,-28000,-28000
9942,茂順            ,22000,50000,-28000,0,0,0,0,0,0,0,0,0,0,0,0,0,-28000
07138P,台灣50群益9B售04,0,0,0,0,0,0,0,0,0,-29000,0,0,0,17000,46000,-29000,-29000
07201P,臺股指元大99售17,0,0,0,0,0,0,0,0,0,-29000,0,0,0,0,29000,-29000,-29000
2906,高林            ,21000,50000,-29000,0,0,0,0,0,0,0,0,0,0,0,0,0,-29000
03416B,臺股指凱基95熊05,0,0,0,0,0,0,0,0,0,-29000,0,0,0,10000,39000,-29000,-29000
03951P,新光金凱基95售01,0,0,0,0,0,0,0,0,0,-29000,0,0,0,10000,39000,-29000,-29000
04928P,大立光凱基95售07,0,0,0,0,0,0,0,0,0,-29000,0,0,0,0,29000,-29000,-29000
04568P,瑞昱兆豐94售02  ,0,0,0,0,0,0,0,0,0,-29000,0,0,0,0,29000,-29000,-29000
047436,台積電元大94購02,0,0,0,0,0,0,0,0,0,-29000,0,0,0,10000,39000,-29000,-29000
05182P,嘉晶統一95售03  ,0,0,0,0,0,0,0,0,0,-29000,0,0,0,0,29000,-29000,-29000
053701,台積電兆豐96購05,0,0,0,0,0,0,0,0,0,-29000,0,0,0,0,29000,-29000,-29000
057580,玉山金中信9A購01,0,0,0,0,0,0,0,0,0,-29000,0,0,0,0,29000,-29000,-29000
05486P,大立光凱基95售14,0,0,0,0,0,0,0,0,0,-29000,0,0,0,24000,53000,-29000,-29000
058242,玉晶光元大9A購01,0,0,0,0,0,0,0,0,0,-29000,0,0,0,61000,90000,-29000,-29000
9908,大台北          ,85000,113000,-28000,0,0,0,0,0,0,-1000,0,1000,-1000,0,0,0,-29000
2462,良得電          ,12000,42000,-30000,0,0,0,0,0,0,0,0,0,0,0,0,0,-30000
2466,冠西電          ,12000,42000,-30000,0,0,0,0,0,0,0,0,0,0,0,0,0,-30000
5907,大洋-KY         ,85000,116000,-31000,0,0,0,0,0,0,1000,1000,0,1000,0,0,0,-30000
07055P,景碩群益9A售02  ,0,0,0,0,0,0,0,0,0,-30000,0,0,0,0,30000,-30000,-30000
06845P,億光元大98售02  ,0,0,0,0,0,0,0,0,0,-30000,0,0,0,0,30000,-30000,-30000
1203,味王            ,16000,46000,-30000,0,0,0,0,0,0,0,0,0,0,0,0,0,-30000
06761P,台積電元大99售05,0,0,0,0,0,0,0,0,0,-30000,0,0,0,237000,267000,-30000,-30000
06492P,上銀永豐98售01  ,0,0,0,0,0,0,0,0,0,-30000,0,0,0,0,30000,-30000,-30000
06262P,國巨凱基97售07  ,0,0,0,0,0,0,0,0,0,-30000,0,0,0,160000,190000,-30000,-30000
059193,台灣50永豐99購05,0,0,0,0,0,0,0,0,0,-30000,0,0,0,0,30000,-30000,-30000
058665,台灣50群益9B購02,0,0,0,0,0,0,0,0,0,-30000,0,0,0,10000,40000,-30000,-30000
058470,台灣50日盛9B購02,0,0,0,0,0,0,0,0,0,-30000,0,0,0,0,30000,-30000,-30000
058425,S&P正2元富01購02,0,0,0,0,0,0,0,0,0,-30000,0,0,0,0,30000,-30000,-30000
058416,鴻海麥證99購01  ,0,0,0,10000,50000,-40000,0,0,0,-30000,0,0,0,20000,50000,-30000,-30000
058296,明泰凱基99購01  ,0,0,0,0,0,0,0,0,0,-30000,0,0,0,20000,50000,-30000,-30000
058307,聯發科元大99購08,0,0,0,0,0,0,0,0,0,-30000,0,0,0,500000,530000,-30000,-30000
058701,鴻海元大99購16  ,0,0,0,0,0,0,0,0,0,-30000,0,0,0,0,30000,-30000,-30000
058892,元油2X元大9C購08,0,0,0,0,0,0,0,0,0,-30000,0,0,0,0,30000,-30000,-30000
058933,FBVIX台新9B購01 ,0,0,0,0,0,0,0,0,0,-30000,0,0,0,15000,45000,-30000,-30000
059024,大立光統一9B購04,0,0,0,0,0,0,0,0,0,-30000,0,0,0,0,30000,-30000,-30000
050022,鴻海元大94購11  ,0,0,0,0,0,0,0,0,0,-30000,0,0,0,70000,100000,-30000,-30000
049899,台積電元富94購05,0,0,0,0,0,0,0,0,0,-30000,0,0,0,326000,356000,-30000,-30000
052173,廣達元大95購02  ,0,0,0,0,0,0,0,0,0,-30000,0,0,0,150000,180000,-30000,-30000
05172P,臺股指元大95售16,0,0,0,0,0,0,0,0,0,-30000,0,0,0,0,30000,-30000,-30000
051756,台積電元大97購04,0,0,0,0,0,0,0,0,0,-30000,0,0,0,0,30000,-30000,-30000
050454,嘉澤元大94購04  ,0,0,0,0,0,0,0,0,0,-30000,0,0,0,0,30000,-30000,-30000
050613,台光電元大94購09,0,0,0,0,0,0,0,0,0,-30000,0,0,0,0,30000,-30000,-30000
050799,嘉聯益中信98購01,0,0,0,0,0,0,0,0,0,-30000,0,0,0,0,30000,-30000,-30000
05154P,台積電兆豐95售05,0,0,0,0,0,0,0,0,0,-30000,0,0,0,0,30000,-30000,-30000
051510,新光金中信97購01,0,0,0,0,0,0,0,0,0,-30000,0,0,0,0,30000,-30000,-30000
051421,彩晶國票95購01  ,0,0,0,0,0,0,0,0,0,-30000,0,0,0,0,30000,-30000,-30000
049612,香港反中信96購01,0,0,0,0,0,0,0,0,0,-30000,0,0,0,0,30000,-30000,-30000
052579,亞泥元富96購01  ,0,0,0,0,0,0,0,0,0,-30000,0,0,0,0,30000,-30000,-30000
051338,揚明光永豐95購02,0,0,0,0,0,0,0,0,0,-30000,0,0,0,0,30000,-30000,-30000
049497,茂林元大94購04  ,0,0,0,0,0,0,0,0,0,-30000,0,0,0,0,30000,-30000,-30000
04795P,聯發科元大94售09,0,0,0,0,0,0,0,0,0,-30000,0,0,0,11000,41000,-30000,-30000
04809P,台光電群益94售04,0,0,0,0,0,0,0,0,0,-30000,0,0,0,0,30000,-30000,-30000
046937,聯電元大99購01  ,0,0,0,0,0,0,0,0,0,-30000,0,0,0,82000,112000,-30000,-30000
04715P,聯茂元大94售06  ,0,0,0,0,0,0,0,0,0,-30000,0,0,0,10000,40000,-30000,-30000
047211,華新科富邦99購01,0,0,0,0,0,0,0,0,0,-30000,0,0,0,5000,35000,-30000,-30000
04840P,大立光元大94售18,0,0,0,0,0,0,0,0,0,-30000,0,0,0,0,30000,-30000,-30000
04835P,鴻海元大94售18  ,0,0,0,0,0,0,0,0,0,-30000,0,0,0,43000,73000,-30000,-30000
049297,日電貿群益95購01,0,0,0,0,0,0,0,0,0,-30000,0,0,0,0,30000,-30000,-30000
04922P,日月光凱基94售02,0,0,0,0,0,0,0,0,0,-30000,0,0,0,0,30000,-30000,-30000
052821,晶技永豐96購01  ,0,0,0,0,0,0,0,0,0,-30000,0,0,0,20000,50000,-30000,-30000
052756,國巨群益96購02  ,0,0,0,0,0,0,0,0,0,-30000,0,0,0,0,30000,-30000,-30000
052926,旺宏元大98購02  ,0,0,0,0,0,0,0,0,0,-30000,0,0,0,0,30000,-30000,-30000
052959,聯電凱基97購01  ,0,0,0,0,0,0,0,0,0,-30000,0,0,0,0,30000,-30000,-30000
048653,巨大元大96購02  ,0,0,0,0,0,0,0,0,0,-30000,0,0,0,0,30000,-30000,-30000
03786P,鴻海群益94售02  ,0,0,0,0,0,0,0,0,0,-30000,0,0,0,10000,40000,-30000,-30000
03413B,臺股指凱基94熊19,0,0,0,0,0,0,0,0,0,-30000,0,0,0,420000,450000,-30000,-30000
04376P,漢唐元大94售04  ,0,0,0,0,0,0,0,0,0,-30000,0,0,0,0,30000,-30000,-30000
058049,帆宣元大98購01  ,0,0,0,0,0,0,0,0,0,-30000,0,0,0,0,30000,-30000,-30000
058050,台郡元大99購05  ,0,0,0,0,0,0,0,0,0,-30000,0,0,0,0,30000,-30000,-30000
054456,華泰群益99購01  ,0,0,0,0,0,0,0,0,0,-30000,0,0,0,0,30000,-30000,-30000
055596,新光金元大9B購02,0,0,0,0,0,0,0,0,0,-30000,0,0,0,50000,80000,-30000,-30000
054504,聯鈞永豐96購01  ,0,0,0,0,0,0,0,0,0,-30000,0,0,0,0,30000,-30000,-30000
053236,群創永豐97購02  ,0,0,0,0,0,0,0,0,0,-30000,0,0,0,0,30000,-30000,-30000
053282,彩晶元大9C購01  ,0,0,0,0,0,0,0,0,0,-30000,0,0,0,27000,57000,-30000,-30000
054522,康友元大96購07  ,0,0,0,0,0,0,0,0,0,-30000,0,0,0,20000,50000,-30000,-30000
055543,為升凱基97購01  ,0,0,0,0,0,0,0,0,0,-30000,0,0,0,0,30000,-30000,-30000
057586,台積電國票99購06,0,0,0,0,0,0,0,0,0,-30000,0,0,0,0,30000,-30000,-30000
057019,台積電凱基98購14,0,0,0,0,0,0,0,0,0,-30000,0,0,0,0,30000,-30000,-30000
057023,美律凱基99購02  ,0,0,0,0,0,0,0,0,0,-30000,0,0,0,0,30000,-30000,-30000
054554,大立光凱基98購02,0,0,0,0,0,0,0,0,0,-30000,0,0,0,10000,40000,-30000,-30000
056276,同欣電國泰98購01,0,0,0,0,0,0,0,0,0,-30000,0,0,0,0,30000,-30000,-30000
053798,台積電中信98購02,0,0,0,0,0,0,0,0,0,-30000,0,0,0,0,30000,-30000,-30000
053005,微星永豐96購01  ,0,0,0,0,0,0,0,0,0,-30000,0,0,0,0,30000,-30000,-30000
053637,強茂永豐96購01  ,0,0,0,0,0,0,0,0,0,-30000,0,0,0,0,30000,-30000,-30000
053553,聯詠凱基96購03  ,0,0,0,0,0,0,0,0,0,-30000,0,0,0,0,30000,-30000,-30000
05724P,致茂永豐96售01  ,0,0,0,0,0,0,0,0,0,-30000,0,0,0,10000,40000,-30000,-30000
055365,華通元大97購03  ,0,0,0,0,0,0,0,0,0,-30000,0,0,0,30000,60000,-30000,-30000
054366,和大中信98購01  ,0,0,0,0,0,0,0,0,0,-30000,0,0,0,0,30000,-30000,-30000
057363,華通元大99購02  ,0,0,0,0,0,0,0,0,0,-30000,0,0,0,0,30000,-30000,-30000
057394,台積電中信9C購02,0,0,0,0,0,0,0,0,0,-30000,0,0,0,0,30000,-30000,-30000
054136,亞光元大96購04  ,0,0,0,0,0,0,0,0,0,-30000,0,0,0,0,30000,-30000,-30000
056445,聯發科凱基98購07,0,0,0,0,0,0,0,0,0,-30000,0,0,0,0,30000,-30000,-30000
057474,T50反1元大98購09,0,0,0,0,0,0,0,0,0,-30000,0,0,0,0,30000,-30000,-30000
056844,欣興元富98購03  ,0,0,0,0,0,0,0,0,0,-30000,0,0,0,0,30000,-30000,-30000
056402,智易群益98購02  ,0,0,0,0,0,0,0,0,0,-30000,0,0,0,10000,40000,-30000,-30000
055225,華邦電國票99購01,0,0,0,0,0,0,0,0,0,-30000,0,0,0,0,30000,-30000,-30000
055214,聯電凱基97購02  ,0,0,0,0,0,0,0,0,0,-30000,0,0,0,20000,50000,-30000,-30000
055735,宏達電元富98購01,0,0,0,0,0,0,0,0,0,-30000,0,0,0,0,30000,-30000,-30000
05574P,英業達元富96售01,0,0,0,0,0,0,0,0,0,-30000,0,0,0,20000,50000,-30000,-30000
9930,中聯資源        ,24000,51000,-27000,0,0,0,0,0,0,-3000,0,3000,-3000,0,0,0,-30000
058967,可成麥證99購01  ,0,0,0,0,31000,-31000,0,0,0,-31000,0,0,0,0,31000,-31000,-31000
059007,南電元大99購05  ,0,0,0,0,0,0,0,0,0,-31000,0,0,0,21000,52000,-31000,-31000
058912,祥碩元大99購01  ,0,0,0,0,0,0,0,0,0,-31000,0,0,0,373000,404000,-31000,-31000
058503,鴻海元大99購14  ,0,0,0,0,0,0,0,0,0,-31000,0,0,0,42000,73000,-31000,-31000
059186,華通富邦9A購01  ,0,0,0,0,0,0,0,0,0,-31000,0,0,0,120000,151000,-31000,-31000
06510P,燿華永豐98售03  ,0,0,0,0,0,0,0,0,0,-31000,0,0,0,0,31000,-31000,-31000
1528,恩德            ,29000,60000,-31000,0,0,0,0,0,0,0,0,0,0,0,0,0,-31000
06896P,信邦中信98售01  ,0,0,0,0,0,0,0,0,0,-31000,0,0,0,0,31000,-31000,-31000
06972P,聯發科元大99售04,0,0,0,0,0,0,0,0,0,-31000,0,0,0,0,31000,-31000,-31000
07160P,台灣50中信03售04,0,0,0,0,0,0,0,0,0,-31000,0,0,0,0,31000,-31000,-31000
3018,同開            ,123000,154000,-31000,0,0,0,0,0,0,0,0,0,0,0,0,0,-31000
04882P,鴻海凱基94售19  ,0,0,0,0,0,0,0,0,0,-31000,0,0,0,0,31000,-31000,-31000
051222,世紀鋼元富95購01,0,0,0,0,0,0,0,0,0,-31000,0,0,0,10000,41000,-31000,-31000
051591,玉晶光元大97購01,0,0,0,0,0,0,0,0,0,-31000,0,0,0,54000,85000,-31000,-31000
050719,世紀鋼群益96購01,0,0,0,0,0,0,0,0,0,-31000,0,0,0,154000,185000,-31000,-31000
054037,T50反1元大96購09,0,0,0,0,0,0,0,0,0,-31000,0,0,0,4000,35000,-31000,-31000
055351,聯發科凱基97購03,0,0,0,0,0,0,0,0,0,-31000,0,0,0,4000,35000,-31000,-31000
055850,聯詠元大97購06  ,0,0,0,0,0,0,0,0,0,-31000,0,0,0,60000,91000,-31000,-31000
054964,智易元大99購01  ,0,0,0,0,0,0,0,0,0,-31000,0,0,0,10000,41000,-31000,-31000
2509,全坤建          ,13000,45000,-32000,0,0,0,0,0,0,0,0,0,0,0,0,0,-32000
2453,凌群            ,65000,97000,-32000,0,0,0,0,0,0,0,0,0,0,0,0,0,-32000
3311,閎暉            ,8000,40000,-32000,0,0,0,0,0,0,0,0,0,0,0,0,0,-32000
3346,麗清            ,30000,62000,-32000,0,0,0,0,0,0,0,0,0,0,0,0,0,-32000
3266,昇陽            ,26000,58000,-32000,0,0,0,0,0,0,0,0,0,0,0,0,0,-32000
06913P,聯發科元大98售14,0,0,0,0,0,0,0,0,0,-32000,0,0,0,34000,66000,-32000,-32000
06844P,智邦元大98售13  ,0,0,0,0,0,0,0,0,0,-32000,0,0,0,105000,137000,-32000,-32000
06543P,鴻海元大98售08  ,0,0,0,0,0,0,0,0,0,-32000,0,0,0,25000,57000,-32000,-32000
06623P,立積元大98售04  ,0,0,0,0,0,0,0,0,0,-32000,0,0,0,41000,73000,-32000,-32000
059098,元油2X統一9B購03,0,0,0,0,0,0,0,0,0,-32000,0,0,0,0,32000,-32000,-32000
04543P,鴻海富邦95售03  ,0,0,0,0,0,0,0,0,0,-32000,0,0,0,10000,42000,-32000,-32000
04454P,大立光富邦98售02,0,0,0,0,0,0,0,0,0,-32000,0,0,0,20000,52000,-32000,-32000
056294,上銀元大97購11  ,0,0,0,0,0,0,0,0,0,-32000,0,0,0,0,32000,-32000,-32000
053338,台光電國票97購01,0,0,0,0,0,0,0,0,0,-32000,0,0,0,0,32000,-32000,-32000
057998,玉晶光麥證9A購01,0,0,0,20000,52000,-32000,0,0,0,-32000,0,0,0,20000,52000,-32000,-32000
057166,國巨元大99購06  ,0,0,0,0,0,0,0,0,0,-32000,0,0,0,2000,34000,-32000,-32000
057154,易華電國泰99購01,0,0,0,0,0,0,0,0,0,-32000,0,0,0,0,32000,-32000,-32000
057212,台積電群益98購03,0,0,0,0,0,0,0,0,0,-32000,0,0,0,0,32000,-32000,-32000
053984,康友元大96購05  ,0,0,0,0,0,0,0,0,0,-32000,0,0,0,18000,50000,-32000,-32000
6415,矽力-KY         ,714521,774685,-60164,0,0,0,62000,28000,34000,-6000,1000,0,1000,0,7000,-7000,-32164
058903,聯發科元大99購16,0,0,0,0,0,0,0,0,0,-33000,0,0,0,577000,610000,-33000,-33000
06500P,臺股指元大9A售05,0,0,0,0,0,0,0,0,0,-33000,0,0,0,6000,39000,-33000,-33000
059188,京元電富邦9B購01,0,0,0,0,0,0,0,0,0,-33000,0,0,0,0,33000,-33000,-33000
07065P,臺股指元大9A售26,0,0,0,0,0,0,0,0,0,-33000,0,0,0,3000,36000,-33000,-33000
1225,福懋油          ,15000,48000,-33000,0,0,0,0,0,0,0,0,0,0,0,0,0,-33000
043442,大立光台新01購01,0,0,0,0,0,0,0,0,0,-33000,0,0,0,109000,142000,-33000,-33000
042754,元黃金元大93購01,0,0,0,0,0,0,0,0,0,-33000,0,0,0,7000,40000,-33000,-33000
03433B,臺股指元大9C熊01,0,0,0,0,0,0,0,0,0,-33000,0,0,0,13000,46000,-33000,-33000
050694,國巨凱基96購03  ,0,0,0,0,0,0,0,0,0,-33000,0,0,0,174000,207000,-33000,-33000
050100,台積電永昌96購02,0,0,0,0,0,0,0,0,0,-33000,0,0,0,34000,67000,-33000,-33000
056745,聯茂凱基99購03  ,0,0,0,0,0,0,0,0,0,-33000,0,0,0,55000,88000,-33000,-33000
057480,技嘉元大98購03  ,0,0,0,0,0,0,0,0,0,-33000,0,0,0,0,33000,-33000,-33000
4989,榮科            ,39000,73000,-34000,0,0,0,0,0,0,0,0,0,0,0,0,0,-34000
05912P,和大元大96售01  ,0,0,0,0,0,0,0,0,0,-34000,0,0,0,0,34000,-34000,-34000
06753P,智邦富邦98售03  ,0,0,0,0,0,0,0,0,0,-34000,0,0,0,0,34000,-34000,-34000
058901,美律元大99購07  ,0,0,0,0,0,0,0,0,0,-34000,0,0,0,68000,102000,-34000,-34000
058653,光寶科中信9A購01,0,0,0,0,0,0,0,0,0,-34000,0,0,0,178000,212000,-34000,-34000
05192P,玉晶光台新96售02,0,0,0,0,0,0,0,0,0,-34000,0,0,0,380000,414000,-34000,-34000
050690,台達電凱基96購01,0,0,0,0,0,0,0,0,0,-34000,0,0,0,0,34000,-34000,-34000
044475,國巨元富95購02  ,0,0,0,0,0,0,0,0,0,-34000,0,0,0,0,34000,-34000,-34000
03810P,大立光富邦98售01,0,0,0,0,0,0,0,0,0,-34000,0,0,0,0,34000,-34000,-34000
048567,台郡元大93購03  ,0,0,0,0,0,0,0,0,0,-34000,0,0,0,0,34000,-34000,-34000
047683,亞德客國泰95購01,0,0,0,0,0,0,0,0,0,-34000,0,0,0,52000,86000,-34000,-34000
055369,友訊元大97購01  ,0,0,0,0,0,0,0,0,0,-34000,0,0,0,10000,44000,-34000,-34000
059065,南電凱基9A購01  ,0,0,0,0,0,0,0,0,0,-35000,0,0,0,0,35000,-35000,-35000
059140,大立光兆豐9A購02,0,0,0,0,0,0,0,0,0,-35000,0,0,0,96000,131000,-35000,-35000
059191,茂林富邦9B購01  ,0,0,0,0,0,0,0,0,0,-35000,0,0,0,0,35000,-35000,-35000
059291,華新科元富9B購01,0,0,0,0,0,0,0,0,0,-35000,0,0,0,0,35000,-35000,-35000
06033P,可成凱基96售09  ,0,0,0,0,0,0,0,0,0,-35000,0,0,0,46000,81000,-35000,-35000
6136,富爾特          ,7000,43000,-36000,0,0,0,0,0,0,1000,5000,4000,1000,0,0,0,-35000
3059,華晶科          ,287000,321000,-34000,0,0,0,0,0,0,-1000,0,1000,-1000,0,0,0,-35000
3557,嘉威            ,53000,88000,-35000,0,0,0,0,0,0,0,0,0,0,0,0,0,-35000
1256,鮮活果汁-KY     ,44000,48000,-4000,0,0,0,0,31000,-31000,0,0,0,0,0,0,0,-35000
06914P,南茂元大98售03  ,0,0,0,0,0,0,0,0,0,-35000,0,0,0,0,35000,-35000,-35000
06983P,台積電國泰9A售02,0,0,0,0,0,0,0,0,0,-35000,0,0,0,0,35000,-35000,-35000
04693P,超眾群益95售01  ,0,0,0,0,0,0,0,0,0,-35000,0,0,0,0,35000,-35000,-35000
051251,信邦元大95購01  ,0,0,0,0,0,0,0,0,0,-35000,0,0,0,20000,55000,-35000,-35000
052892,大成鋼群益96購01,0,0,0,0,0,0,0,0,0,-35000,0,0,0,15000,50000,-35000,-35000
048794,易華電元大97購01,0,0,0,0,0,0,0,0,0,-35000,0,0,0,0,35000,-35000,-35000
04902P,國巨台新94售04  ,0,0,0,0,0,0,0,0,0,-35000,0,0,0,630000,665000,-35000,-35000
04436P,聯發科中信96售02,0,0,0,0,0,0,0,0,0,-35000,0,0,0,15000,50000,-35000,-35000
050597,聯電麥證94購01  ,0,0,0,0,35000,-35000,0,0,0,-35000,0,0,0,0,35000,-35000,-35000
051486,玉晶光凱基97購03,0,0,0,0,0,0,0,0,0,-35000,0,0,0,20000,55000,-35000,-35000
056655,旺宏元大99購02  ,0,0,0,0,0,0,0,0,0,-35000,0,0,0,0,35000,-35000,-35000
056532,技嘉凱基98購01  ,0,0,0,0,0,0,0,0,0,-35000,0,0,0,76000,111000,-35000,-35000
053029,國巨第一96購01  ,0,0,0,0,0,0,0,0,0,-35000,0,0,0,0,35000,-35000,-35000
057488,聯發科元大99購02,0,0,0,0,0,0,0,0,0,-35000,0,0,0,165000,200000,-35000,-35000
054071,泰鼎國泰97購02  ,0,0,0,0,0,0,0,0,0,-35000,0,0,0,50000,85000,-35000,-35000
057994,技嘉中信98購01  ,0,0,0,0,0,0,0,0,0,-35000,0,0,0,20000,55000,-35000,-35000
058161,T50反1日盛03購01,0,0,0,0,0,0,0,0,0,-35000,0,0,0,0,35000,-35000,-35000
053331,玉晶光永豐97購02,0,0,0,0,0,0,0,0,0,-35000,0,0,0,0,35000,-35000,-35000
055707,聯鈞永豐98購01  ,0,0,0,0,0,0,0,0,0,-35000,0,0,0,0,35000,-35000,-35000
057823,神達元大98購01  ,0,0,0,0,0,0,0,0,0,-35000,0,0,0,26000,61000,-35000,-35000
053176,矽力群益96購02  ,0,0,0,0,0,0,0,0,0,-35000,0,0,0,194000,229000,-35000,-35000
056134,可成元大97購06  ,0,0,0,0,0,0,0,0,0,-35000,0,0,0,190000,225000,-35000,-35000
056164,聯茂凱基98購03  ,0,0,0,0,0,0,0,0,0,-35000,0,0,0,0,35000,-35000,-35000
055925,上銀群益97購01  ,0,0,0,0,0,0,0,0,0,-35000,0,0,0,0,35000,-35000,-35000
6449,鈺邦            ,48000,83000,-35000,0,0,0,0,0,0,0,0,0,0,0,0,0,-35000
06938P,南電元大98售03  ,0,0,0,0,0,0,0,0,0,-36000,0,0,0,1000,37000,-36000,-36000
1618,合機            ,16000,52000,-36000,0,0,0,0,0,0,0,0,0,0,0,0,0,-36000
3679,新至陞          ,17000,47000,-30000,0,0,0,0,0,0,-6000,0,6000,-6000,0,0,0,-36000
4994,傳奇            ,11000,45000,-34000,0,0,0,0,0,0,-2000,0,0,0,0,2000,-2000,-36000
06150P,奇力新元大97售06,0,0,0,0,0,0,0,0,0,-36000,0,0,0,10000,46000,-36000,-36000
058852,貿聯群益99購04  ,0,0,0,0,0,0,0,0,0,-36000,0,0,0,20000,56000,-36000,-36000
058777,台光電國票9A購01,0,0,0,0,0,0,0,0,0,-36000,0,0,0,1000,37000,-36000,-36000
058765,緯穎群益99購03  ,0,0,0,0,0,0,0,0,0,-36000,0,0,0,14000,50000,-36000,-36000
050006,華擎永豐94購03  ,0,0,0,0,0,0,0,0,0,-36000,0,0,0,20000,56000,-36000,-36000
051001,緯穎元大96購02  ,0,0,0,0,0,0,0,0,0,-36000,0,0,0,5000,41000,-36000,-36000
00766L,台新MSCI中國正2 ,0,0,0,0,0,0,0,0,0,-36000,0,0,0,180000,216000,-36000,-36000
00645,富邦日本        ,0,0,0,0,0,0,0,0,0,-36000,0,0,0,78000,114000,-36000,-36000
04518P,高鐵群益95售01  ,0,0,0,0,0,0,0,0,0,-36000,0,0,0,10000,46000,-36000,-36000
048675,台達電國泰94購02,0,0,0,0,0,0,0,0,0,-36000,0,0,0,13000,49000,-36000,-36000
04032P,聯茂凱基94售02  ,0,0,0,0,0,0,0,0,0,-36000,0,0,0,0,36000,-36000,-36000
054538,台光電國票98購01,0,0,0,0,0,0,0,0,0,-36000,0,0,0,0,36000,-36000,-36000
057861,台積電凱基98購16,0,0,0,0,0,0,0,0,0,-36000,0,0,0,5000,41000,-36000,-36000
054201,聯詠富邦97購02  ,0,0,0,0,0,0,0,0,0,-36000,0,0,0,0,36000,-36000,-36000
053610,矽力中信98購01  ,0,0,0,0,0,0,0,0,0,-36000,0,0,0,6000,42000,-36000,-36000
06748P,智邦台新98售02  ,0,0,0,0,0,0,0,0,0,-37000,0,0,0,2000,39000,-37000,-37000
06254P,臺股指群益97售07,0,0,0,0,0,0,0,0,0,-37000,0,0,0,0,37000,-37000,-37000
4141,龍燈-KY         ,13000,50000,-37000,0,0,0,0,0,0,0,0,0,0,0,0,0,-37000
3047,訊舟            ,142000,179000,-37000,0,0,0,0,0,0,0,1000,1000,0,0,0,0,-37000
2597,潤弘            ,13000,50000,-37000,0,0,0,0,0,0,0,3000,3000,0,0,0,0,-37000
1721,三晃            ,76000,113000,-37000,0,0,0,0,0,0,0,0,0,0,0,0,0,-37000
1465,偉全            ,7000,44000,-37000,0,0,0,0,0,0,0,0,0,0,0,0,0,-37000
1337,再生-KY         ,26000,63000,-37000,0,0,0,0,0,0,0,0,0,0,0,0,0,-37000
03049X,元展46          ,0,0,0,0,0,0,0,0,0,-37000,0,0,0,0,37000,-37000,-37000
051570,和碩富邦97購01  ,0,0,0,0,0,0,0,0,0,-37000,0,0,0,0,37000,-37000,-37000
05601P,鴻海元大97售04  ,0,0,0,0,0,0,0,0,0,-37000,0,0,0,404000,441000,-37000,-37000
057059,易華電元大99購01,0,0,0,0,0,0,0,0,0,-37000,0,0,0,25000,62000,-37000,-37000
8473,山林水          ,25000,62000,-37000,0,0,0,0,0,0,0,0,0,0,0,0,0,-37000
2109,華豐            ,22000,60000,-38000,0,0,0,0,0,0,0,0,0,0,0,0,0,-38000
07150P,和碩元大99售01  ,0,0,0,0,0,0,0,0,0,-38000,0,0,0,0,38000,-38000,-38000
07127P,精元元大99售01  ,0,0,0,0,0,0,0,0,0,-38000,0,0,0,30000,68000,-38000,-38000
2516,新建            ,19000,57000,-38000,0,0,0,0,0,0,0,0,0,0,0,0,0,-38000
5525,順天            ,21000,59000,-38000,0,0,0,0,0,0,0,0,0,0,0,0,0,-38000
06681P,致茂元大98售02  ,0,0,0,0,0,0,0,0,0,-38000,0,0,0,0,38000,-38000,-38000
06620P,聯發科元大98售07,0,0,0,0,0,0,0,0,0,-38000,0,0,0,5000,43000,-38000,-38000
049463,華新科富邦97購01,0,0,0,0,0,0,0,0,0,-38000,0,0,0,1000,39000,-38000,-38000
05266P,華新科元大95售11,0,0,0,0,0,0,0,0,0,-38000,0,0,0,318000,356000,-38000,-38000
056059,美律元大98購02  ,0,0,0,0,0,0,0,0,0,-38000,0,0,0,2000,40000,-38000,-38000
058042,鴻海元大98購12  ,0,0,0,0,0,0,0,0,0,-38000,0,0,0,39000,77000,-38000,-38000
05563P,台積電元大97售07,0,0,0,0,0,0,0,0,0,-38000,0,0,0,170000,208000,-38000,-38000
055429,華新科群益99購01,0,0,0,0,0,0,0,0,0,-38000,0,0,0,0,38000,-38000,-38000
06265P,美律凱基97售01  ,0,0,0,0,0,0,0,0,0,-39000,0,0,0,25000,64000,-39000,-39000
06370P,貿聯凱基97售03  ,0,0,0,0,0,0,0,0,0,-39000,0,0,0,0,39000,-39000,-39000
2427,三商電          ,13000,52000,-39000,0,0,0,0,0,0,0,0,0,0,0,0,0,-39000
07162P,臺股指群益99售13,0,0,0,0,0,0,0,0,0,-39000,0,0,0,0,39000,-39000,-39000
1507,永大            ,91000,130000,-39000,0,0,0,0,0,0,0,0,0,0,0,0,0,-39000
05229P,台積電群益95售05,0,0,0,0,0,0,0,0,0,-39000,0,0,0,11000,50000,-39000,-39000
05189P,新光金凱基97售02,0,0,0,0,0,0,0,0,0,-39000,0,0,0,45000,84000,-39000,-39000
056561,台光電群益98購02,0,0,0,0,0,0,0,0,0,-39000,0,0,0,11000,50000,-39000,-39000
057367,技嘉元大98購02  ,0,0,0,0,0,0,0,0,0,-39000,0,0,0,10000,49000,-39000,-39000
8201,無敵            ,9000,48000,-39000,0,0,0,0,0,0,0,0,0,0,0,0,0,-39000
1702,南僑            ,115000,147000,-32000,0,0,0,0,0,0,-8000,4000,12000,-8000,0,0,0,-40000
1598,岱宇            ,13000,47000,-34000,0,0,0,0,0,0,-6000,0,6000,-6000,0,0,0,-40000
07068P,欣興台新99售01  ,0,0,0,0,0,0,0,0,0,-40000,0,0,0,0,40000,-40000,-40000
07105P,大毅元富99售02  ,0,0,0,0,0,0,0,0,0,-40000,0,0,0,26000,66000,-40000,-40000
06777P,鴻海元大99售06  ,0,0,0,0,0,0,0,0,0,-40000,0,0,0,25000,65000,-40000,-40000
2444,兆勁            ,14000,54000,-40000,0,0,0,0,0,0,0,0,0,0,0,0,0,-40000
06527P,T50正2富邦9C售01,0,0,0,0,0,0,0,0,0,-40000,0,0,0,0,40000,-40000,-40000
06533P,上証2X中信9B售01,0,0,0,0,0,0,0,0,0,-40000,0,0,0,10000,50000,-40000,-40000
06515P,國巨凱基98售06  ,0,0,0,0,0,0,0,0,0,-40000,0,0,0,0,40000,-40000,-40000
059242,南亞科凱基99購06,0,0,0,0,0,0,0,0,0,-40000,0,0,0,0,40000,-40000,-40000
058707,泰鼎元大99購02  ,0,0,0,0,0,0,0,0,0,-40000,0,0,0,38000,78000,-40000,-40000
058833,台表科永豐99購01,0,0,0,0,0,0,0,0,0,-40000,0,0,0,60000,100000,-40000,-40000
059038,健策群益9A購02  ,0,0,0,0,0,0,0,0,0,-40000,0,0,0,0,40000,-40000,-40000
058922,聯發科元富03購02,0,0,0,0,0,0,0,0,0,-40000,0,0,0,30000,70000,-40000,-40000
058661,臺股指中信9C購01,0,0,0,0,0,0,0,0,0,-40000,0,0,0,0,40000,-40000,-40000
058594,台灣50元富9B購03,0,0,0,0,0,0,0,0,0,-40000,0,0,0,201000,241000,-40000,-40000
058446,新光金富邦9C購01,0,0,0,0,0,0,0,0,0,-40000,0,0,0,0,40000,-40000,-40000
056594,台積電元富98購03,0,0,0,0,0,0,0,0,0,-40000,0,0,0,0,40000,-40000,-40000
056676,國產元富98購01  ,0,0,0,0,0,0,0,0,0,-40000,0,0,0,0,40000,-40000,-40000
056795,鴻海麥證98購01  ,0,0,0,0,40000,-40000,0,0,0,-40000,0,0,0,0,40000,-40000,-40000
051898,富邦金國泰97購01,0,0,0,0,0,0,0,0,0,-40000,0,0,0,60000,100000,-40000,-40000
049909,國巨元大95購01  ,0,0,0,0,0,0,0,0,0,-40000,0,0,0,100000,140000,-40000,-40000
051696,新日興中信96購01,0,0,0,0,0,0,0,0,0,-40000,0,0,0,0,40000,-40000,-40000
052446,聯發科元大96購03,0,0,0,0,0,0,0,0,0,-40000,0,0,0,0,40000,-40000,-40000
050351,華新科群益95購02,0,0,0,0,0,0,0,0,0,-40000,0,0,0,0,40000,-40000,-40000
050514,聯電元大94購01  ,0,0,0,0,0,0,0,0,0,-40000,0,0,0,40000,80000,-40000,-40000
03021P,玉晶光群益02售25,0,0,0,0,0,0,0,0,0,-40000,0,0,0,0,40000,-40000,-40000
03412P,滬深2X群益98售01,0,0,0,0,0,0,0,0,0,-40000,0,0,0,0,40000,-40000,-40000
04321P,國巨元大93售12  ,0,0,0,0,0,0,0,0,0,-40000,0,0,0,10000,50000,-40000,-40000
04862P,台積電元大94售26,0,0,0,0,0,0,0,0,0,-40000,0,0,0,10000,50000,-40000,-40000
049004,聯發科中信96購01,0,0,0,0,0,0,0,0,0,-40000,0,0,0,0,40000,-40000,-40000
05291P,鴻海凱基95售16  ,0,0,0,0,0,0,0,0,0,-40000,0,0,0,30000,70000,-40000,-40000
052808,矽力元大96購02  ,0,0,0,0,0,0,0,0,0,-40000,0,0,0,30000,70000,-40000,-40000
045468,健策元大94購01  ,0,0,0,0,0,0,0,0,0,-40000,0,0,0,0,40000,-40000,-40000
046855,嘉晶元大94購01  ,0,0,0,0,0,0,0,0,0,-40000,0,0,0,80000,120000,-40000,-40000
05348P,美律元富98售01  ,0,0,0,0,0,0,0,0,0,-40000,0,0,0,0,40000,-40000,-40000
053541,泰鼎永豐96購02  ,0,0,0,0,0,0,0,0,0,-40000,0,0,0,10000,50000,-40000,-40000
057541,台灣50康和9A購04,0,0,0,0,0,0,0,0,0,-40000,0,0,0,0,40000,-40000,-40000
053825,南電群益96購02  ,0,0,0,0,0,0,0,0,0,-40000,0,0,0,124000,164000,-40000,-40000
05566P,景碩永豐96售01  ,0,0,0,0,0,0,0,0,0,-40000,0,0,0,0,40000,-40000,-40000
054437,欣興台新97購02  ,0,0,0,0,0,0,0,0,0,-40000,0,0,0,0,40000,-40000,-40000
058101,台積電富邦9C購01,0,0,0,0,0,0,0,0,0,-40000,0,0,0,0,40000,-40000,-40000
055992,智原台新97購02  ,0,0,0,0,0,0,0,0,0,-40000,0,0,0,0,40000,-40000,-40000
057057,立積元大9A購01  ,0,0,0,0,0,0,0,0,0,-40000,0,0,0,10000,50000,-40000,-40000
056459,茂林凱基99購01  ,0,0,0,0,0,0,0,0,0,-40000,0,0,0,0,40000,-40000,-40000
05453P,智邦群益95售03  ,0,0,0,0,0,0,0,0,0,-40000,0,0,0,0,40000,-40000,-40000
056964,聯發科永豐98購03,0,0,0,0,0,0,0,0,0,-40000,0,0,0,0,40000,-40000,-40000
054575,聯鈞元大97購01  ,0,0,0,0,0,0,0,0,0,-40000,0,0,0,0,40000,-40000,-40000
055475,臻鼎凱基97購02  ,0,0,0,0,0,0,0,0,0,-40000,0,0,0,0,40000,-40000,-40000
055482,聚陽元大97購02  ,0,0,0,0,0,0,0,0,0,-40000,0,0,0,70000,110000,-40000,-40000
06655P,TPK元大98售02   ,0,0,0,0,0,0,0,0,0,-41000,0,0,0,0,41000,-41000,-41000
4552,力達-KY         ,63000,104000,-41000,0,0,0,0,0,0,0,0,0,0,0,0,0,-41000
1463,強盛            ,18000,57000,-39000,0,0,0,0,0,0,-2000,0,2000,-2000,0,0,0,-41000
03671P,大立光凱基95售02,0,0,0,0,0,0,0,0,0,-41000,0,0,0,150000,191000,-41000,-41000
03649C,T50反1凱基99牛05,0,0,0,0,0,0,0,0,0,-41000,0,0,0,0,41000,-41000,-41000
052387,台積電群益95購08,0,0,0,0,0,0,0,0,0,-41000,0,0,0,205000,246000,-41000,-41000
05262P,台積電元大95售19,0,0,0,0,0,0,0,0,0,-41000,0,0,0,350000,391000,-41000,-41000
049908,鴻海元大94購08  ,0,0,0,0,0,0,0,0,0,-41000,0,0,0,50000,91000,-41000,-41000
056132,台光電元大97購03,0,0,0,0,0,0,0,0,0,-41000,0,0,0,10000,51000,-41000,-41000
1603,華電            ,27000,71000,-44000,0,0,0,0,0,0,2000,2000,0,2000,0,0,0,-42000
4566,時碩工業        ,45000,87000,-42000,0,0,0,0,0,0,0,0,0,0,0,0,0,-42000
3501,維熹            ,24000,56000,-32000,0,0,0,0,0,0,-10000,0,10000,-10000,0,0,0,-42000
058521,日月光元大99購01,0,0,0,0,0,0,0,0,0,-42000,0,0,0,9000,51000,-42000,-42000
059111,元油2X永豐99購03,0,0,0,0,0,0,0,0,0,-42000,0,0,0,10000,52000,-42000,-42000
049143,智邦元大94購02  ,0,0,0,0,0,0,0,0,0,-42000,0,0,0,40000,82000,-42000,-42000
046934,智邦元富96購01  ,0,0,0,0,0,0,0,0,0,-42000,0,0,0,0,42000,-42000,-42000
045767,大立光元富95購01,0,0,0,0,0,0,0,0,0,-42000,0,0,0,71000,113000,-42000,-42000
057696,聯電群益9A購01  ,0,0,0,0,0,0,0,0,0,-42000,0,0,0,0,42000,-42000,-42000
057288,聯茂元大98購03  ,0,0,0,0,0,0,0,0,0,-42000,0,0,0,213000,255000,-42000,-42000
054210,台光電國票97購03,0,0,0,0,0,0,0,0,0,-42000,0,0,0,0,42000,-42000,-42000
055311,健策群益98購02  ,0,0,0,0,0,0,0,0,0,-42000,0,0,0,0,42000,-42000,-42000
05412P,泰碩國票95售02  ,0,0,0,0,0,0,0,0,0,-42000,0,0,0,24000,66000,-42000,-42000
056909,嘉聯益元大99購03,0,0,0,0,0,0,0,0,0,-42000,0,0,0,12000,54000,-42000,-42000
057128,台光電凱基98購03,0,0,0,0,0,0,0,0,0,-42000,0,0,0,0,42000,-42000,-42000
6698,旭暉應材        ,91000,44000,47000,0,0,0,0,98000,-98000,9000,9000,0,9000,0,0,0,-42000
05888P,友達元大97售01  ,0,0,0,0,0,0,0,0,0,-43000,0,0,0,0,43000,-43000,-43000
058293,光寶科凱基9A購01,0,0,0,0,0,0,0,0,0,-43000,0,0,0,0,43000,-43000,-43000
2433,互盛電          ,34000,71000,-37000,0,0,0,0,0,0,-6000,0,6000,-6000,0,0,0,-43000
2397,友通            ,21000,59000,-38000,0,0,0,0,0,0,-5000,0,5000,-5000,0,0,0,-43000
3004,豐達科          ,132000,176000,-44000,0,0,0,0,0,0,1000,1000,0,1000,0,0,0,-43000
04760P,旺宏凱基94售02  ,0,0,0,0,0,0,0,0,0,-43000,0,0,0,0,43000,-43000,-43000
047564,滬深2X國票99購01,0,0,0,0,0,0,0,0,0,-43000,0,0,0,17000,60000,-43000,-43000
04797P,華新科元大94售04,0,0,0,0,0,0,0,0,0,-43000,0,0,0,5000,48000,-43000,-43000
04892P,聯發科元大94售14,0,0,0,0,0,0,0,0,0,-43000,0,0,0,137000,180000,-43000,-43000
05727P,新光金日盛96售02,0,0,0,0,0,0,0,0,0,-43000,0,0,0,58000,101000,-43000,-43000
058129,國巨元大99購10  ,0,0,0,0,0,0,0,0,0,-43000,0,0,0,0,43000,-43000,-43000
055104,台達電凱基98購01,0,0,0,0,0,0,0,0,0,-43000,0,0,0,7000,50000,-43000,-43000
5608,四維航          ,30000,74000,-44000,0,0,0,0,0,0,0,0,0,0,0,0,0,-44000
06642P,可成兆豐98售01  ,0,0,0,0,0,0,0,0,0,-44000,0,0,0,40000,84000,-44000,-44000
04382P,美律國泰95售01  ,0,0,0,0,0,0,0,0,0,-44000,0,0,0,100000,144000,-44000,-44000
00757,統一FANG+       ,0,0,0,0,0,0,0,0,0,-44000,0,0,0,210000,254000,-44000,-44000
051801,牧德永豐95購04  ,0,0,0,0,0,0,0,0,0,-44000,0,0,0,0,44000,-44000,-44000
050155,華新科群益95購01,0,0,0,0,0,0,0,0,0,-44000,0,0,0,160000,204000,-44000,-44000
051568,智邦富邦95購01  ,0,0,0,0,0,0,0,0,0,-44000,0,0,0,61000,105000,-44000,-44000
057021,台積電凱基9A購02,0,0,0,0,0,0,0,0,0,-44000,0,0,0,10000,54000,-44000,-44000
057601,中磊群益98購01  ,0,0,0,0,0,0,0,0,0,-44000,0,0,0,0,44000,-44000,-44000
057550,聯發科凱基02購01,0,0,0,0,0,0,0,0,0,-44000,0,0,0,2000,46000,-44000,-44000
053712,台光電凱基96購04,0,0,0,0,0,0,0,0,0,-44000,0,0,0,0,44000,-44000,-44000
059272,台灣50元大99購01,0,0,0,0,0,0,0,0,0,-45000,0,0,0,0,45000,-45000,-45000
2882B,國泰金乙特      ,0,55000,-55000,0,0,0,0,0,0,10000,10000,0,10000,0,0,0,-45000
2506,太設            ,25000,70000,-45000,0,0,0,0,0,0,0,0,0,0,0,0,0,-45000
2009,第一銅          ,62000,107000,-45000,0,0,0,0,0,0,0,0,0,0,0,0,0,-45000
07125P,台積電元大99售22,0,0,0,0,0,0,0,0,0,-45000,0,0,0,10000,55000,-45000,-45000
051452,貿聯元大95購04  ,0,0,0,0,0,0,0,0,0,-45000,0,0,0,25000,70000,-45000,-45000
052687,國泰金元大96購03,0,0,0,0,0,0,0,0,0,-45000,0,0,0,125000,170000,-45000,-45000
051392,玉山金兆豐95購01,0,0,0,0,0,0,0,0,0,-45000,0,0,0,0,45000,-45000,-45000
05215P,台積電台新95售03,0,0,0,0,0,0,0,0,0,-45000,0,0,0,371000,416000,-45000,-45000
056547,臻鼎凱基99購01  ,0,0,0,0,0,0,0,0,0,-45000,0,0,0,0,45000,-45000,-45000
056353,鴻海元大99購02  ,0,0,0,0,0,0,0,0,0,-45000,0,0,0,0,45000,-45000,-45000
052819,義隆永豐96購01  ,0,0,0,0,0,0,0,0,0,-45000,0,0,0,15000,60000,-45000,-45000
049252,國巨元大96購01  ,0,0,0,0,0,0,0,0,0,-45000,0,0,0,261000,306000,-45000,-45000
053980,泰鼎元大97購02  ,0,0,0,0,0,0,0,0,0,-45000,0,0,0,0,45000,-45000,-45000
054291,高鐵元大97購01  ,0,0,0,0,0,0,0,0,0,-45000,0,0,0,200000,245000,-45000,-45000
054673,京鼎國泰98購01  ,0,0,0,0,0,0,0,0,0,-45000,0,0,0,60000,105000,-45000,-45000
05477P,華新科群益95售06,0,0,0,0,0,0,0,0,0,-45000,0,0,0,117000,162000,-45000,-45000
057374,禾伸堂元大99購03,0,0,0,0,0,0,0,0,0,-45000,0,0,0,40000,85000,-45000,-45000
05755P,臺股指中信99售04,0,0,0,0,0,0,0,0,0,-45000,0,0,0,5000,50000,-45000,-45000
05600P,玉晶光台新96售04,0,0,0,0,0,0,0,0,0,-45000,0,0,0,1110000,1155000,-45000,-45000
058223,世芯統一9B購01  ,0,0,0,0,0,0,0,0,0,-45000,0,0,0,0,45000,-45000,-45000
053305,聯詠凱基96購02  ,0,0,0,0,0,0,0,0,0,-45000,0,0,0,15000,60000,-45000,-45000
1730,花仙子          ,98000,144000,-46000,0,0,0,0,0,0,0,0,0,0,0,0,0,-46000
059177,臺股指凱基99購28,0,0,0,0,0,0,0,0,0,-46000,0,0,0,0,46000,-46000,-46000
058454,嘉晶永豐99購01  ,0,0,0,0,0,0,0,0,0,-46000,0,0,0,244000,290000,-46000,-46000
058590,南電中信9A購02  ,0,0,0,0,0,0,0,0,0,-46000,0,0,0,100000,146000,-46000,-46000
04735P,聯茂兆豐94售01  ,0,0,0,0,0,0,0,0,0,-46000,0,0,0,60000,106000,-46000,-46000
056357,台積電元大9A購01,0,0,0,0,0,0,0,0,0,-46000,0,0,0,0,46000,-46000,-46000
053209,台積電凱基96購07,0,0,0,0,0,0,0,0,0,-46000,0,0,0,125000,171000,-46000,-46000
056004,南電永豐97購02  ,0,0,0,0,0,0,0,0,0,-46000,0,0,0,60000,106000,-46000,-46000
056192,智邦富邦98購01  ,0,350000,-350000,0,0,0,0,0,0,304000,0,0,0,360000,56000,304000,-46000
055736,宏達電元富99購01,0,0,0,0,0,0,0,0,0,-46000,0,0,0,10000,56000,-46000,-46000
058531,華通元富99購01  ,0,0,0,0,0,0,0,0,0,-47000,0,0,0,0,47000,-47000,-47000
2849,安泰銀          ,130000,187000,-57000,0,0,0,0,0,0,10000,10000,0,10000,0,0,0,-47000
2430,燦坤            ,11000,58000,-47000,0,0,0,0,0,0,0,0,0,0,0,0,0,-47000
2472,立隆電          ,71000,142000,-71000,0,0,0,0,0,0,24000,42000,18000,24000,0,0,0,-47000
3032,偉訓            ,36000,83000,-47000,0,0,0,0,0,0,0,0,0,0,0,0,0,-47000
04250P,嘉晶統一95售02  ,0,0,0,0,0,0,0,0,0,-47000,0,0,0,60000,107000,-47000,-47000
048831,玉晶光凱基95購01,0,0,0,0,0,0,0,0,0,-47000,0,0,0,36000,83000,-47000,-47000
056080,世紀鋼元大97購03,0,0,0,0,0,0,0,0,0,-47000,0,0,0,54000,101000,-47000,-47000
8011,台通            ,58000,103000,-45000,0,0,0,0,0,0,-2000,0,2000,-2000,0,0,0,-47000
6184,大豐電          ,18000,66000,-48000,0,0,0,0,0,0,0,0,0,0,0,0,0,-48000
2413,環科            ,22000,70000,-48000,0,0,0,0,0,0,0,0,0,0,0,0,0,-48000
2612,中航            ,87000,135000,-48000,0,0,0,0,0,0,0,0,0,0,0,0,0,-48000
044530,台積電富邦94購01,0,0,0,0,0,0,0,0,0,-48000,0,0,0,0,48000,-48000,-48000
048636,鴻海元大94購05  ,0,0,0,0,0,0,0,0,0,-48000,0,0,0,40000,88000,-48000,-48000
048263,台積電元富95購01,0,0,0,0,0,0,0,0,0,-48000,0,0,0,111000,159000,-48000,-48000
046662,大立光元大93購14,0,0,0,0,0,0,0,0,0,-48000,0,0,0,156000,204000,-48000,-48000
05194P,玉晶光康和95售01,0,0,0,0,0,0,0,0,0,-48000,0,0,0,135000,183000,-48000,-48000
053255,貿聯國泰97購01  ,0,0,0,0,0,0,0,0,0,-48000,0,0,0,35000,83000,-48000,-48000
058044,鴻海元大99購07  ,0,0,0,0,0,0,0,0,0,-48000,0,0,0,20000,68000,-48000,-48000
05396P,台郡元大95售05  ,0,0,0,0,0,0,0,0,0,-48000,0,0,0,8000,56000,-48000,-48000
6226,光鼎            ,23000,70000,-47000,0,0,0,0,0,0,-2000,0,2000,-2000,0,0,0,-49000
4999,鑫禾            ,10000,52000,-42000,0,0,0,0,0,0,-7000,0,7000,-7000,0,0,0,-49000
1201,味全            ,328000,349000,-21000,0,0,0,0,0,0,-28000,0,13000,-13000,0,15000,-15000,-49000
06857P,超眾永豐98售02  ,0,0,0,0,0,0,0,0,0,-49000,0,0,0,0,49000,-49000,-49000
06075P,智邦凱基97售02  ,0,0,0,0,0,0,0,0,0,-49000,0,0,0,51000,100000,-49000,-49000
05138P,嘉聯益凱基96售02,0,0,0,0,0,0,0,0,0,-49000,0,0,0,0,49000,-49000,-49000
056656,華邦電元大98購02,0,0,0,0,0,0,0,0,0,-49000,0,0,0,20000,69000,-49000,-49000
056849,瀚宇博元富98購01,0,0,0,0,0,0,0,0,0,-49000,0,0,0,1000,50000,-49000,-49000
054072,台積電富邦98購02,0,0,0,0,0,0,0,0,0,-49000,0,0,0,0,49000,-49000,-49000
057870,大立光凱基99購02,0,0,0,0,0,0,0,0,0,-49000,0,0,0,11000,60000,-49000,-49000
2451,創見            ,164000,844510,-680510,0,0,0,0,0,0,631000,1000,69000,-68000,699000,0,699000,-49510
2488,漢平            ,53000,103000,-50000,0,0,0,0,0,0,0,0,0,0,0,0,0,-50000
2701,萬企            ,29000,79000,-50000,0,0,0,0,0,0,0,0,0,0,0,0,0,-50000
3094,聯傑            ,25000,75000,-50000,0,0,0,0,0,0,0,0,0,0,0,0,0,-50000
06971P,台光電元大99售03,0,0,0,0,0,0,0,0,0,-50000,0,0,0,21000,71000,-50000,-50000
07130P,台郡元大9B售01  ,0,0,0,0,0,0,0,0,0,-50000,0,0,0,0,50000,-50000,-50000
07205P,鴻海凱基99售11  ,0,0,0,0,0,0,0,0,0,-50000,0,0,0,0,50000,-50000,-50000
07098P,台積電元大99售18,0,0,0,0,0,0,0,0,0,-50000,0,0,0,5000,55000,-50000,-50000
07071P,立積元富99售01  ,0,0,0,0,0,0,0,0,0,-50000,0,0,0,5000,55000,-50000,-50000
2114,鑫永銓          ,5000,56000,-51000,0,0,0,0,0,0,1000,1000,0,1000,0,0,0,-50000
059210,鴻海元大99購26  ,0,0,0,0,0,0,0,0,0,-50000,0,0,0,0,50000,-50000,-50000
059161,鴻海凱基9A購09  ,0,0,0,0,0,0,0,0,0,-50000,0,0,0,5000,55000,-50000,-50000
059256,臺股指凱基99購34,0,0,0,0,0,0,0,0,0,-50000,0,0,0,0,50000,-50000,-50000
059224,大立光元大99購15,0,0,0,0,0,0,0,0,0,-50000,0,0,0,35000,85000,-50000,-50000
06680P,智邦元大98售06  ,0,0,0,0,0,0,0,0,0,-50000,0,0,0,236000,286000,-50000,-50000
06493P,聯發科永豐98售02,0,0,0,0,0,0,0,0,0,-50000,0,0,0,5000,55000,-50000,-50000
06461P,玉晶光國泰9A售01,0,0,0,0,0,0,0,0,0,-50000,0,0,0,5000,55000,-50000,-50000
06353P,電子類富邦99售02,0,0,0,0,0,0,0,0,0,-50000,0,0,0,0,50000,-50000,-50000
06346P,聯鈞元富97售02  ,0,0,0,0,0,0,0,0,0,-50000,0,0,0,30000,80000,-50000,-50000
058420,聯發科麥證99購03,0,0,0,0,1690000,-1690000,0,0,0,-50000,0,0,0,1640000,1690000,-50000,-50000
058338,康友元富99購01  ,0,0,0,0,0,0,0,0,0,-50000,0,0,0,0,50000,-50000,-50000
058848,台積電群益99購07,0,0,0,0,0,0,0,0,0,-50000,0,0,0,958000,1008000,-50000,-50000
059055,旺宏凱基9B購02  ,0,0,0,0,0,0,0,0,0,-50000,0,0,0,0,50000,-50000,-50000
056693,國產群益98購01  ,0,0,0,0,0,0,0,0,0,-50000,0,0,0,0,50000,-50000,-50000
056789,和碩群益98購01  ,0,0,0,0,0,0,0,0,0,-50000,0,0,0,0,50000,-50000,-50000
056772,欣興元大99購01  ,0,0,0,0,0,0,0,0,0,-50000,0,0,0,50000,100000,-50000,-50000
056775,康控元大99購01  ,0,0,0,0,0,0,0,0,0,-50000,0,0,0,15000,65000,-50000,-50000
056762,亞德客元大98購01,0,0,0,0,0,0,0,0,0,-50000,0,0,0,0,50000,-50000,-50000
05188P,可成凱基95售09  ,0,0,0,0,0,0,0,0,0,-50000,0,0,0,0,50000,-50000,-50000
051700,深中小群益99購04,0,0,0,0,0,0,0,0,0,-50000,0,0,0,0,50000,-50000,-50000
049587,美律元大95購01  ,0,0,0,0,0,0,0,0,0,-50000,0,0,0,0,50000,-50000,-50000
049488,智邦元大95購01  ,0,0,0,0,0,0,0,0,0,-50000,0,0,0,0,50000,-50000,-50000
051995,矽力元大95購03  ,0,0,0,0,0,0,0,0,0,-50000,0,0,0,0,50000,-50000,-50000
052396,台積電凱基97購01,0,0,0,0,0,0,0,0,0,-50000,0,0,0,30000,80000,-50000,-50000
052353,高鐵群益97購01  ,0,0,0,0,0,0,0,0,0,-50000,0,0,0,0,50000,-50000,-50000
051598,瑞昱兆豐95購01  ,0,0,0,0,0,0,0,0,0,-50000,0,0,0,40000,90000,-50000,-50000
050500,台積電凱基94購36,0,0,0,0,0,0,0,0,0,-50000,0,0,0,0,50000,-50000,-50000
050457,力成元大94購01  ,0,0,0,0,0,0,0,0,0,-50000,0,0,0,0,50000,-50000,-50000
050447,廣達元大94購01  ,0,0,0,0,0,0,0,0,0,-50000,0,0,0,0,50000,-50000,-50000
050427,台積電凱基94購34,0,0,0,0,0,0,0,0,0,-50000,0,0,0,20000,70000,-50000,-50000
050370,台積電元大94購24,0,0,0,0,0,0,0,0,0,-50000,0,0,0,0,50000,-50000,-50000
050734,台積電台新94購02,0,0,0,0,0,0,0,0,0,-50000,0,0,0,200000,250000,-50000,-50000
046600,鴻海群益94購01  ,0,0,0,0,0,0,0,0,0,-50000,0,0,0,0,50000,-50000,-50000
046385,群創凱基98購03  ,0,0,0,0,0,0,0,0,0,-50000,0,0,0,0,50000,-50000,-50000
051230,聯詠群益95購01  ,0,0,0,0,0,0,0,0,0,-50000,0,0,0,0,50000,-50000,-50000
049298,矽格群益95購01  ,0,0,0,0,0,0,0,0,0,-50000,0,0,0,0,50000,-50000,-50000
052943,奇力新國票96購02,0,0,0,0,0,0,0,0,0,-50000,0,0,0,0,50000,-50000,-50000
045231,南電元大94購01  ,0,0,0,0,0,0,0,0,0,-50000,0,0,0,0,50000,-50000,-50000
04773P,金融類元大94售01,0,0,0,0,0,0,0,0,0,-50000,0,0,0,0,50000,-50000,-50000
048644,華固元大93購01  ,0,0,0,0,0,0,0,0,0,-50000,0,0,0,0,50000,-50000,-50000
048763,台積電凱基94購03,0,0,0,0,0,0,0,0,0,-50000,0,0,0,0,50000,-50000,-50000
04293P,滬深2X元大96售02,0,0,0,0,0,0,0,0,0,-50000,0,0,0,0,50000,-50000,-50000
04370P,聯茂凱基94售05  ,0,0,0,0,0,0,0,0,0,-50000,0,0,0,0,50000,-50000,-50000
058131,義隆元大99購02  ,0,0,0,0,0,0,0,0,0,-50000,0,0,0,0,50000,-50000,-50000
058143,瑞儀元大99購02  ,0,0,0,0,0,0,0,0,0,-50000,0,0,0,8000,58000,-50000,-50000
057651,矽力元大98購03  ,0,0,0,0,0,0,0,0,0,-50000,0,0,0,30000,80000,-50000,-50000
056250,瑞昱兆豐97購02  ,0,0,0,0,0,0,0,0,0,-50000,0,0,0,0,50000,-50000,-50000
053174,同欣電群益98購02,0,0,0,0,0,0,0,0,0,-50000,0,0,0,22000,72000,-50000,-50000
053127,貿聯凱基97購01  ,0,0,0,0,0,0,0,0,0,-50000,0,0,0,0,50000,-50000,-50000
057056,立積元大99購02  ,0,0,0,0,0,0,0,0,0,-50000,0,0,0,0,50000,-50000,-50000
057053,立積元大98購02  ,0,0,0,0,0,0,0,0,0,-50000,0,0,0,0,50000,-50000,-50000
054581,訊芯元大97購02  ,0,0,0,0,0,0,0,0,0,-50000,0,0,0,0,50000,-50000,-50000
054615,牧德永豐98購01  ,0,0,0,0,0,0,0,0,0,-50000,0,0,0,0,50000,-50000,-50000
056982,華新科群益98購05,0,0,0,0,0,0,0,0,0,-50000,0,0,0,0,50000,-50000,-50000
055027,牧德國泰99購01  ,0,0,0,0,0,0,0,0,0,-50000,0,0,0,5000,55000,-50000,-50000
054946,億光元大97購01  ,0,0,0,0,0,0,0,0,0,-50000,0,0,0,0,50000,-50000,-50000
054938,國巨元大97購04  ,0,0,0,0,0,0,0,0,0,-50000,0,0,0,0,50000,-50000,-50000
054935,華通元大98購03  ,0,0,0,0,0,0,0,0,0,-50000,0,0,0,0,50000,-50000,-50000
056896,南亞科元大98購01,0,0,0,0,0,0,0,0,0,-50000,0,0,0,0,50000,-50000,-50000
057187,群創元大9B購04  ,0,0,0,0,0,0,0,0,0,-50000,0,0,0,0,50000,-50000,-50000
056395,玉晶光永豐9B購01,0,0,0,0,0,0,0,0,0,-50000,0,0,0,0,50000,-50000,-50000
057481,技嘉元大98購04  ,0,0,0,0,0,0,0,0,0,-50000,0,0,0,0,50000,-50000,-50000
057485,友達元大9C購04  ,0,0,0,0,0,0,0,0,0,-50000,0,0,0,0,50000,-50000,-50000
055356,大立光凱基97購06,0,0,0,0,0,0,0,0,0,-50000,0,0,0,0,50000,-50000,-50000
056962,技嘉永豐98購01  ,0,0,0,0,0,0,0,0,0,-50000,0,0,0,0,50000,-50000,-50000
053694,創意元大96購03  ,0,0,0,0,0,0,0,0,0,-50000,0,0,0,0,50000,-50000,-50000
053734,友達中信98購02  ,0,0,0,0,0,0,0,0,0,-50000,0,0,0,0,50000,-50000,-50000
052989,麗豐元大98購01  ,0,0,0,0,0,0,0,0,0,-50000,0,0,0,0,50000,-50000,-50000
052996,聯電康和96購01  ,0,0,0,0,0,0,0,0,0,-50000,0,0,0,0,50000,-50000,-50000
053036,聯電凱基98購01  ,0,0,0,0,0,0,0,0,0,-50000,0,0,0,10000,60000,-50000,-50000
053535,宏達電永豐96購02,0,0,0,0,0,0,0,0,0,-50000,0,0,0,0,50000,-50000,-50000
054803,味全元大9A購01  ,0,0,0,0,0,0,0,0,0,-50000,0,0,0,0,50000,-50000,-50000
057199,台達電元富02購01,0,0,0,0,0,0,0,0,0,-50000,0,0,0,0,50000,-50000,-50000
054364,智伸科凱基96購01,0,0,0,0,0,0,0,0,0,-50000,0,0,0,0,50000,-50000,-50000
059125,台積電第一03購02,0,0,0,0,0,0,0,0,0,-51000,0,0,0,10000,61000,-51000,-51000
07204P,鴻海凱基99售10  ,0,0,0,0,0,0,0,0,0,-51000,0,0,0,0,51000,-51000,-51000
07211P,南亞科凱基99售05,0,0,0,0,0,0,0,0,0,-51000,0,0,0,0,51000,-51000,-51000
07218P,臺股指凱基99售31,0,0,0,0,0,0,0,0,0,-51000,0,0,0,0,51000,-51000,-51000
049270,台表科元大95購02,0,0,0,0,0,0,0,0,0,-51000,0,0,0,0,51000,-51000,-51000
046159,群創群益98購04  ,0,0,0,0,0,0,0,0,0,-51000,0,0,0,199000,250000,-51000,-51000
05082P,健策永豐95售02  ,0,0,0,0,0,0,0,0,0,-51000,0,0,0,12000,63000,-51000,-51000
05091P,台積電元大95售11,0,0,0,0,0,0,0,0,0,-51000,0,0,0,39000,90000,-51000,-51000
051672,玉晶光元大96購03,0,0,0,0,0,0,0,0,0,-51000,0,0,0,71000,122000,-51000,-51000
056301,開發金元大9A購01,0,0,0,0,0,0,0,0,0,-51000,0,0,0,0,51000,-51000,-51000
05507P,聯茂凱基96售02  ,0,0,0,0,0,0,0,0,0,-51000,0,0,0,10000,61000,-51000,-51000
056141,聯茂元大97購05  ,0,0,0,0,0,0,0,0,0,-51000,0,0,0,492000,543000,-51000,-51000
058100,聯茂國泰99購02  ,0,0,0,0,0,0,0,0,0,-51000,0,0,0,97000,148000,-51000,-51000
2888A,新光金甲特      ,1000,29000,-28000,0,0,0,0,19000,-19000,-5000,0,5000,-5000,0,0,0,-52000
2423,固緯            ,41000,93000,-52000,0,0,0,0,0,0,0,0,0,0,0,0,0,-52000
05999P,世芯元大96售01  ,0,0,0,0,0,0,0,0,0,-52000,0,0,0,313000,365000,-52000,-52000
06751P,旺宏凱基98售10  ,0,0,0,0,0,0,0,0,0,-52000,0,0,0,0,52000,-52000,-52000
049907,鴻海元大94購07  ,0,0,0,0,0,0,0,0,0,-52000,0,0,0,40000,92000,-52000,-52000
052610,貿聯元大97購01  ,0,0,0,0,0,0,0,0,0,-52000,0,0,0,0,52000,-52000,-52000
06757P,台灣50元大9B售01,0,0,0,0,0,0,0,0,0,-53000,0,100000,-100000,153000,106000,47000,-53000
059209,華通元大99購08  ,0,0,0,0,0,0,0,0,0,-53000,0,0,0,52000,105000,-53000,-53000
059200,京鼎永豐99購02  ,0,0,0,0,0,0,0,0,0,-53000,0,0,0,0,53000,-53000,-53000
1325,恆大            ,547000,612000,-65000,0,0,0,0,0,0,12000,12000,0,12000,0,0,0,-53000
04774P,金融類元大94售02,0,0,0,0,0,0,0,0,0,-53000,0,0,0,7000,60000,-53000,-53000
04427P,滬深2X元大97售02,0,0,0,0,0,0,0,0,0,-53000,0,0,0,2000,55000,-53000,-53000
03669C,滬深2X元富09牛01,0,0,0,0,0,0,0,0,0,-53000,0,0,0,66000,119000,-53000,-53000
055637,亞德客元富97購01,0,0,0,0,0,0,0,0,0,-53000,0,0,0,0,53000,-53000,-53000
057291,國巨國泰9A購01  ,0,0,0,0,0,0,0,0,0,-53000,0,0,0,132000,185000,-53000,-53000
057170,瑞昱元大98購01  ,0,0,0,0,0,0,0,0,0,-53000,0,0,0,48000,101000,-53000,-53000
057116,鴻海日盛9A購01  ,0,0,0,0,0,0,0,0,0,-53000,0,0,0,0,53000,-53000,-53000
05580P,美律凱基96售03  ,0,0,0,0,0,0,0,0,0,-53000,0,0,0,12000,65000,-53000,-53000
06328P,台積電中信01售02,0,0,0,0,0,0,0,0,0,-54000,0,0,0,10000,64000,-54000,-54000
050808,台達電凱基96購02,0,0,0,0,0,0,0,0,0,-54000,0,0,0,0,54000,-54000,-54000
056393,精元永豐98購01  ,0,0,0,0,0,0,0,0,0,-54000,0,0,0,0,54000,-54000,-54000
057873,義隆元大98購03  ,0,0,0,0,0,0,0,0,0,-54000,0,0,0,10000,64000,-54000,-54000
059129,麗豐中信99購01  ,0,0,0,0,0,0,0,0,0,-55000,0,0,0,0,55000,-55000,-55000
058518,玉晶光元大99購13,0,0,0,0,0,0,0,0,0,-55000,0,0,0,80000,135000,-55000,-55000
07077P,緯穎凱基99售01  ,0,0,0,0,0,0,0,0,0,-55000,0,0,0,97000,152000,-55000,-55000
06982P,義隆凱基99售02  ,0,0,0,0,0,0,0,0,0,-55000,0,0,0,0,55000,-55000,-55000
5283,禾聯碩          ,24000,55000,-31000,0,0,0,0,0,0,-24000,0,22000,-22000,0,2000,-2000,-55000
4722,國精化          ,12000,65000,-53000,0,0,0,0,0,0,-2000,0,2000,-2000,0,0,0,-55000
051028,台光電元富95購02,0,0,0,0,0,0,0,0,0,-55000,0,0,0,0,55000,-55000,-55000
053503,臻鼎兆豐97購01  ,0,0,0,0,0,0,0,0,0,-55000,0,0,0,456000,511000,-55000,-55000
053632,新唐兆豐96購01  ,0,0,0,0,0,0,0,0,0,-55000,0,0,0,45000,100000,-55000,-55000
2029,盛餘            ,28000,88000,-60000,0,0,0,0,0,0,4000,4000,0,4000,0,0,0,-56000
1808,潤隆            ,127000,177000,-50000,0,0,0,0,0,0,-6000,0,6000,-6000,0,0,0,-56000
1614,三洋電          ,23000,79000,-56000,0,0,0,0,0,0,0,0,0,0,0,0,0,-56000
058795,可成元大99購03  ,0,0,0,0,0,0,0,0,0,-56000,0,0,0,141000,197000,-56000,-56000
06499P,臺股指元大9A售04,0,0,0,0,0,0,0,0,0,-56000,0,0,0,5000,61000,-56000,-56000
06718P,聯詠元大98售01  ,0,0,0,0,0,0,0,0,0,-56000,0,0,0,0,56000,-56000,-56000
06557P,台積電兆豐98售02,0,0,0,0,0,0,0,0,0,-56000,0,0,0,476000,532000,-56000,-56000
052307,潤泰全國泰96購01,0,0,0,0,0,0,0,0,0,-56000,0,0,0,60000,116000,-56000,-56000
03686P,大立光統一98售02,0,0,0,0,0,0,0,0,0,-56000,0,0,0,4000,60000,-56000,-56000
04865P,台積電亞東95售01,0,0,0,0,0,0,0,0,0,-56000,0,0,0,270000,326000,-56000,-56000
053969,瑞昱元大97購01  ,0,0,0,0,0,0,0,0,0,-56000,0,0,0,30000,86000,-56000,-56000
054821,貿聯元大9A購01  ,0,0,0,0,0,0,0,0,0,-56000,0,0,0,44000,100000,-56000,-56000
058007,南電群益98購02  ,0,0,0,0,0,0,0,0,0,-56000,0,0,0,34000,90000,-56000,-56000
054965,健策元大98購04  ,0,0,0,0,0,0,0,0,0,-56000,0,0,0,191000,247000,-56000,-56000
06615P,鴻海元大9C售02  ,0,0,0,0,0,0,0,0,0,-57000,0,0,0,335000,392000,-57000,-57000
06283P,祥碩永豐97售01  ,0,0,0,0,0,0,0,0,0,-57000,0,0,0,10000,67000,-57000,-57000
06307P,聚陽元富97售02  ,0,0,0,0,0,0,0,0,0,-57000,0,0,0,4000,61000,-57000,-57000
04818P,華新科永豐94售03,0,0,0,0,0,0,0,0,0,-57000,0,0,0,7000,64000,-57000,-57000
052780,玉晶光國票96購04,0,0,0,0,0,0,0,0,0,-57000,0,0,0,28000,85000,-57000,-57000
054791,泰碩群益99購02  ,0,0,0,0,0,0,0,0,0,-57000,0,0,0,75000,132000,-57000,-57000
053504,祥碩兆豐96購01  ,0,0,0,0,0,0,0,0,0,-57000,0,0,0,10000,67000,-57000,-57000
05527P,聯茂群益96售01  ,0,0,0,0,0,0,0,0,0,-57000,0,0,0,0,57000,-57000,-57000
06674P,祥碩群益98售02  ,0,0,0,0,0,0,0,0,0,-58000,0,0,0,0,58000,-58000,-58000
058406,聯茂元大99購06  ,0,0,0,0,0,0,0,0,0,-58000,0,0,0,10000,68000,-58000,-58000
046717,世紀鋼國泰94購01,0,0,0,0,0,0,0,0,0,-58000,0,0,0,2000,60000,-58000,-58000
03618C,高股息凱基95牛01,0,0,0,0,0,0,0,0,0,-58000,0,0,0,0,58000,-58000,-58000
00685L,群益臺灣加權正2 ,0,0,0,0,0,0,0,0,0,-58000,0,0,0,168000,226000,-58000,-58000
056333,台積電日盛9B購01,0,0,0,0,0,0,0,0,0,-58000,0,0,0,20000,78000,-58000,-58000
056573,華新科元大99購06,0,0,0,0,0,0,0,0,0,-58000,0,0,0,10000,68000,-58000,-58000
05677P,玉晶光群益98售03,0,0,0,0,0,0,0,0,0,-58000,0,0,0,150000,208000,-58000,-58000
05546P,全新元大97售01  ,0,0,0,0,0,0,0,0,0,-58000,0,0,0,2000,60000,-58000,-58000
056029,國巨麥證98購01  ,0,0,0,0,58000,-58000,0,0,0,-58000,0,0,0,0,58000,-58000,-58000
058045,鴻海元大99購08  ,0,0,0,0,0,0,0,0,0,-58000,0,0,0,41000,99000,-58000,-58000
059276,可成元大99購06  ,0,0,0,0,0,0,0,0,0,-59000,0,0,0,6000,65000,-59000,-59000
1323,永裕            ,8000,74000,-66000,0,0,0,0,0,0,7000,7000,0,7000,0,0,0,-59000
1439,中和            ,26000,85000,-59000,0,0,0,0,0,0,0,0,0,0,0,0,0,-59000
1219,福壽            ,22000,70000,-48000,0,0,0,0,0,0,-11000,0,11000,-11000,0,0,0,-59000
3305,昇貿            ,16000,75000,-59000,0,0,0,0,0,0,0,0,0,0,0,0,0,-59000
2727,王品            ,98000,157000,-59000,0,0,0,0,0,0,0,0,0,0,0,0,0,-59000
00738U,元大道瓊白銀    ,0,469000,-469000,0,0,0,0,0,0,410000,0,0,0,942000,532000,410000,-59000
2375,凱美            ,629000,647000,-18000,0,0,0,0,0,0,-42000,0,13000,-13000,1000,30000,-29000,-60000
3607,谷崧            ,50000,110000,-60000,0,0,0,0,0,0,0,0,0,0,0,0,0,-60000
4916,事欣科          ,34000,94000,-60000,0,0,0,0,0,0,0,0,0,0,0,0,0,-60000
1457,宜進            ,68000,128000,-60000,0,0,0,0,0,0,0,0,0,0,0,0,0,-60000
06843P,鴻海元大98售11  ,0,0,0,0,0,0,0,0,0,-60000,0,0,0,25000,85000,-60000,-60000
07184P,台灣50元富01售01,0,0,0,0,0,0,0,0,0,-60000,0,0,0,805000,865000,-60000,-60000
06736P,新日興凱基98售03,0,0,0,0,0,0,0,0,0,-60000,0,0,0,0,60000,-60000,-60000
03497P,金像電凱基02售06,0,0,0,0,0,0,0,0,0,-60000,0,0,0,0,60000,-60000,-60000
048600,嘉澤國票94購01  ,0,0,0,0,0,0,0,0,0,-60000,0,0,0,0,60000,-60000,-60000
044643,滬深2X群益96購01,0,0,0,0,0,0,0,0,0,-60000,0,0,0,0,60000,-60000,-60000
04552P,南電元大94售06  ,0,0,0,0,0,0,0,0,0,-60000,0,0,0,0,60000,-60000,-60000
04752P,大立光群益94售07,0,0,0,0,0,0,0,0,0,-60000,0,0,0,0,60000,-60000,-60000
050988,廣達富邦95購01  ,0,0,0,0,0,0,0,0,0,-60000,0,0,0,0,60000,-60000,-60000
050102,鴻海富邦95購04  ,0,0,0,0,0,0,0,0,0,-60000,0,0,0,0,60000,-60000,-60000
051926,聯電中信97購01  ,0,0,0,0,0,0,0,0,0,-60000,0,0,0,0,60000,-60000,-60000
049544,台積電群益94購08,0,0,0,0,0,0,0,0,0,-60000,0,0,0,40000,100000,-60000,-60000
049769,和鑫元富96購01  ,0,0,0,0,0,0,0,0,0,-60000,0,0,0,0,60000,-60000,-60000
057945,京鼎國票99購03  ,0,0,0,0,0,0,0,0,0,-60000,0,0,0,0,60000,-60000,-60000
056076,超眾元大97購05  ,0,0,0,0,0,0,0,0,0,-60000,0,0,0,0,60000,-60000,-60000
057055,立積元大99購01  ,0,0,0,0,0,0,0,0,0,-60000,0,0,0,11000,71000,-60000,-60000
055832,台達電元大97購02,0,0,0,0,0,0,0,0,0,-60000,0,0,0,0,60000,-60000,-60000
056223,華邦電凱基97購04,0,0,0,0,0,0,0,0,0,-60000,0,0,0,0,60000,-60000,-60000
055505,新唐元大97購02  ,0,0,0,0,0,0,0,0,0,-60000,0,0,0,0,60000,-60000,-60000
055781,聯詠凱基98購01  ,0,0,0,0,0,0,0,0,0,-60000,0,0,0,0,60000,-60000,-60000
054070,創意國泰96購02  ,0,0,0,0,0,0,0,0,0,-60000,0,0,0,115000,175000,-60000,-60000
054122,康友永豐96購01  ,0,0,0,0,0,0,0,0,0,-60000,0,0,0,0,60000,-60000,-60000
055458,燿華永豐98購01  ,0,0,0,0,0,0,0,0,0,-60000,0,0,0,0,60000,-60000,-60000
055373,聯詠元大97購03  ,0,0,0,0,0,0,0,0,0,-60000,0,0,0,90000,150000,-60000,-60000
058885,元石油元大9C購02,0,0,0,0,0,0,0,0,0,-61000,0,0,0,35000,96000,-61000,-61000
06783P,亞光元大98售03  ,0,0,0,0,0,0,0,0,0,-61000,0,0,0,2000,63000,-61000,-61000
1339,昭輝            ,57000,64000,-7000,0,0,0,0,0,0,-54000,0,54000,-54000,0,0,0,-61000
051281,健策兆豐96購01  ,0,0,0,0,0,0,0,0,0,-61000,0,0,0,97000,158000,-61000,-61000
056505,聯發科永豐98購01,0,0,0,0,0,0,0,0,0,-61000,0,0,0,80000,141000,-61000,-61000
048480,FB上証中信94購01,0,0,0,0,0,0,0,0,0,-61000,0,0,0,0,61000,-61000,-61000
00714,群益道瓊美國地產,0,86000,-86000,0,0,0,0,0,0,25000,0,0,0,91000,66000,25000,-61000
054758,南亞國票9A購01  ,0,0,0,0,0,0,0,0,0,-61000,0,0,0,0,61000,-61000,-61000
054169,上緯控凱基98購01,0,0,0,0,0,0,0,0,0,-61000,0,0,0,0,61000,-61000,-61000
057487,聯發科元大98購10,0,0,0,0,0,0,0,0,0,-61000,0,0,0,380000,441000,-61000,-61000
057503,世紀鋼群益98購02,0,0,0,0,0,0,0,0,0,-61000,0,0,0,2000,63000,-61000,-61000
054550,旺宏凱基98購02  ,0,0,0,0,0,0,0,0,0,-61000,0,0,0,139000,200000,-61000,-61000
07200P,臺股指元大99售16,0,0,0,0,0,0,0,0,0,-62000,0,0,0,0,62000,-62000,-62000
4526,東台            ,18000,80000,-62000,0,0,0,0,0,0,0,0,0,0,0,0,0,-62000
2373,震旦行          ,21000,77000,-56000,0,0,0,0,0,0,-6000,0,6000,-6000,0,0,0,-62000
059004,嘉晶元大99購05  ,0,0,0,0,0,0,0,0,0,-62000,0,0,0,737000,799000,-62000,-62000
058508,聯發科元大99購11,0,0,0,0,0,0,0,0,0,-62000,0,0,0,115000,177000,-62000,-62000
058622,國巨國票99購07  ,0,0,0,0,0,0,0,0,0,-62000,0,0,0,0,62000,-62000,-62000
059219,旺宏元大99購12  ,0,0,0,0,0,0,0,0,0,-62000,0,0,0,67000,129000,-62000,-62000
00709,富邦歐洲        ,0,0,0,0,0,0,0,0,0,-62000,0,0,0,100000,162000,-62000,-62000
05634P,玉晶光台新97售01,0,0,0,0,0,0,0,0,0,-62000,0,0,0,76000,138000,-62000,-62000
057903,聯鈞永豐99購01  ,0,0,0,0,0,0,0,0,0,-62000,0,0,0,0,62000,-62000,-62000
056904,大立光元大99購05,0,0,0,0,0,0,0,0,0,-62000,0,0,0,55000,117000,-62000,-62000
058298,聯茂凱基99購05  ,0,0,0,0,0,0,0,0,0,-63000,0,0,0,24000,87000,-63000,-63000
3622,洋華            ,38000,101000,-63000,0,0,0,0,0,0,0,0,0,0,0,0,0,-63000
5225,東科-KY         ,66000,129000,-63000,0,0,0,0,0,0,0,0,0,0,0,0,0,-63000
07212P,聯發科凱基99售14,0,0,0,0,0,0,0,0,0,-63000,0,0,0,0,63000,-63000,-63000
1517,利奇            ,15000,78000,-63000,0,0,0,0,0,0,0,0,0,0,0,0,0,-63000
1109,信大            ,59000,122000,-63000,0,0,0,0,0,0,0,0,0,0,0,0,0,-63000
052941,康控兆豐97購01  ,0,0,0,0,0,0,0,0,0,-63000,0,0,0,0,63000,-63000,-63000
05683P,矽創元大96售01  ,0,0,0,0,0,0,0,0,0,-63000,0,0,0,3000,66000,-63000,-63000
055761,創意群益97購01  ,0,0,0,0,0,0,0,0,0,-63000,0,0,0,5000,68000,-63000,-63000
05479P,華新科台新96售01,0,0,0,0,0,0,0,0,0,-63000,0,0,0,304000,367000,-63000,-63000
054280,牧德群益98購01  ,0,0,0,0,0,0,0,0,0,-63000,0,0,0,0,63000,-63000,-63000
054972,聯茂元大97購02  ,0,0,0,0,0,0,0,0,0,-63000,0,0,0,2000,65000,-63000,-63000
5007,三星            ,32000,96000,-64000,0,0,0,0,0,0,0,0,0,0,0,0,0,-64000
2852,第一保          ,30000,94000,-64000,0,0,0,0,0,0,0,0,0,0,0,0,0,-64000
058427,大毅元富99購01  ,0,0,0,0,0,0,0,0,0,-64000,0,0,0,51000,115000,-64000,-64000
058636,亞光兆豐9A購01  ,0,0,0,0,0,0,0,0,0,-64000,0,0,0,125000,189000,-64000,-64000
05905P,晶技統一97售01  ,0,0,0,0,0,0,0,0,0,-64000,0,0,0,46000,110000,-64000,-64000
055701,亞德客富邦99購01,0,0,0,0,0,0,0,0,0,-64000,0,0,0,0,64000,-64000,-64000
055166,台積電統一97購05,0,0,0,0,0,0,0,0,0,-64000,0,0,0,0,64000,-64000,-64000
059057,聯發科凱基99購10,0,0,0,0,0,0,0,0,0,-65000,0,0,0,0,65000,-65000,-65000
058401,華航元大9A購01  ,0,0,0,0,0,0,0,0,0,-65000,0,0,0,40000,105000,-65000,-65000
05966P,矽力凱基96售03  ,0,0,0,0,0,0,0,0,0,-65000,0,0,0,86000,151000,-65000,-65000
06451P,聯發科元大98售04,0,0,0,0,0,0,0,0,0,-65000,0,0,0,18000,83000,-65000,-65000
07085P,超眾元富9C售01  ,0,0,0,0,0,0,0,0,0,-65000,0,0,0,0,65000,-65000,-65000
052454,力成元大95購02  ,0,0,0,0,0,0,0,0,0,-65000,0,0,0,45000,110000,-65000,-65000
05642P,玉晶光兆豐97售02,0,0,0,0,0,0,0,0,0,-65000,0,0,0,47000,112000,-65000,-65000
053439,台積電凱基96購11,0,0,0,0,0,0,0,0,0,-65000,0,0,0,0,65000,-65000,-65000
054343,世紀鋼元富96購02,0,0,0,0,0,0,0,0,0,-65000,0,0,0,12000,77000,-65000,-65000
053091,同欣電元大96購01,0,0,0,0,0,0,0,0,0,-65000,0,0,0,0,65000,-65000,-65000
053742,創意國票97購01  ,0,0,0,0,0,0,0,0,0,-65000,0,0,0,40000,105000,-65000,-65000
053788,泰鼎元大97購01  ,0,0,0,0,0,0,0,0,0,-65000,0,0,0,0,65000,-65000,-65000
057613,瑞昱元富02購02  ,0,0,0,0,0,0,0,0,0,-65000,0,0,0,0,65000,-65000,-65000
06969P,上銀元大99售02  ,0,0,0,0,0,0,0,0,0,-66000,0,0,0,214000,280000,-66000,-66000
1541,錩泰            ,9000,13000,-4000,0,0,0,0,0,0,-62000,0,62000,-62000,0,0,0,-66000
3167,大量            ,19000,74000,-55000,0,0,0,1000,0,1000,-12000,0,12000,-12000,0,0,0,-66000
054418,茂林元大97購01  ,0,0,0,0,0,0,0,0,0,-66000,0,0,0,20000,86000,-66000,-66000
058054,台積電統一9C購01,0,0,0,0,0,0,0,0,0,-66000,0,0,0,5000,71000,-66000,-66000
05301P,矽力元大95售02  ,0,0,0,0,0,0,0,0,0,-66000,0,0,0,15000,81000,-66000,-66000
058890,元油2X元大9C購06,0,0,0,0,0,0,0,0,0,-67000,0,0,0,40000,107000,-67000,-67000
057354,聯鈞統一99購03  ,0,0,0,0,0,0,0,0,0,-67000,0,0,0,18000,85000,-67000,-67000
2442,新美齊          ,302000,341000,-39000,0,0,0,1000,0,1000,-30000,0,30000,-30000,0,0,0,-68000
00652,富邦印度        ,16000,35000,-19000,0,0,0,0,0,0,-49000,0,70000,-70000,34000,13000,21000,-68000
05299P,旺宏元大95售04  ,0,0,0,0,0,0,0,0,0,-68000,0,0,0,12000,80000,-68000,-68000
057954,宏碁元大99購01  ,0,0,0,0,0,0,0,0,0,-68000,0,0,0,115000,183000,-68000,-68000
054572,國巨元大98購03  ,0,0,0,0,0,0,0,0,0,-68000,0,0,0,52000,120000,-68000,-68000
9925,新保            ,74000,105000,-31000,0,0,0,0,0,0,-37000,0,37000,-37000,0,0,0,-68000
4725,信昌化          ,29000,98000,-69000,0,0,0,0,0,0,0,0,0,0,0,0,0,-69000
059142,道瓊指國票9B購02,0,0,0,0,0,0,0,0,0,-69000,0,0,0,3000,72000,-69000,-69000
03996P,旺宏國泰95售01  ,0,0,0,0,0,0,0,0,0,-69000,0,0,0,31000,100000,-69000,-69000
052011,欣興中信96購01  ,0,0,0,0,0,0,0,0,0,-69000,0,0,0,0,69000,-69000,-69000
056608,力山永豐98購01  ,0,0,0,0,0,0,0,0,0,-69000,0,0,0,25000,94000,-69000,-69000
053629,玉山金兆豐96購01,0,0,0,0,0,0,0,0,0,-69000,0,0,0,6000,75000,-69000,-69000
056960,光罩永豐98購01  ,0,0,0,0,0,0,0,0,0,-69000,0,0,0,51000,120000,-69000,-69000
06648P,華邦電元大98售03,0,0,0,0,0,0,0,0,0,-70000,0,0,0,96000,166000,-70000,-70000
058825,同欣電富邦9A購01,0,0,0,0,0,0,0,0,0,-70000,0,0,0,0,70000,-70000,-70000
058809,國巨統一9B購03  ,0,0,0,0,0,0,0,0,0,-70000,0,0,0,0,70000,-70000,-70000
059060,大立光凱基9A購03,0,0,0,0,0,0,0,0,0,-70000,0,0,0,0,70000,-70000,-70000
059093,旭富元大99購01  ,0,0,0,0,0,0,0,0,0,-70000,0,0,0,0,70000,-70000,-70000
2314,台揚            ,361000,271000,90000,0,0,0,0,0,0,-160000,0,155000,-155000,1000,6000,-5000,-70000
2606,裕民            ,314000,288000,26000,0,0,0,4000,0,4000,-100000,9000,99000,-90000,0,10000,-10000,-70000
06948P,FBVIX元大01售02 ,0,0,0,0,0,0,0,0,0,-70000,0,0,0,0,70000,-70000,-70000
05176P,台積電凱基95售11,0,0,0,0,0,0,0,0,0,-70000,0,0,0,50000,120000,-70000,-70000
052006,康友富邦98購01  ,0,0,0,0,0,0,0,0,0,-70000,0,0,0,10000,80000,-70000,-70000
052326,滬深反中信99購01,0,0,0,0,0,0,0,0,0,-70000,0,0,0,0,70000,-70000,-70000
051578,智邦元大96購01  ,0,0,0,0,0,0,0,0,0,-70000,0,0,0,228000,298000,-70000,-70000
038455,群臺反群益94購01,0,0,0,0,0,0,0,0,0,-70000,0,0,0,0,70000,-70000,-70000
04473P,國巨元大94售03  ,0,0,0,0,0,0,0,0,0,-70000,0,0,0,0,70000,-70000,-70000
048859,玉晶光群益96購02,0,0,0,0,0,0,0,0,0,-70000,0,0,0,0,70000,-70000,-70000
048892,台郡元富97購01  ,0,0,0,0,0,0,0,0,0,-70000,0,0,0,0,70000,-70000,-70000
04278P,大立光凱基93售38,0,0,0,0,0,0,0,0,0,-70000,0,0,0,0,70000,-70000,-70000
047004,台積電統一99購01,0,0,0,0,0,0,0,0,0,-70000,0,0,0,0,70000,-70000,-70000
055416,欣興富邦98購01  ,0,0,0,0,0,0,0,0,0,-70000,0,0,0,0,70000,-70000,-70000
053440,台積電凱基96購12,0,0,0,0,0,0,0,0,0,-70000,0,0,0,0,70000,-70000,-70000
057277,可成元大98購05  ,0,0,0,0,0,0,0,0,0,-70000,0,0,0,20000,90000,-70000,-70000
057381,微星國泰9A購01  ,0,0,0,0,0,0,0,0,0,-70000,0,0,0,60000,130000,-70000,-70000
054194,國巨麥證96購02  ,0,0,0,0,380000,-380000,0,0,0,-70000,0,0,0,310000,380000,-70000,-70000
054249,技嘉元大96購03  ,0,0,0,0,0,0,0,0,0,-70000,0,0,0,110000,180000,-70000,-70000
057866,玉山金凱基98購01,0,0,0,0,0,0,0,0,0,-70000,0,0,0,0,70000,-70000,-70000
053317,友達群益9A購02  ,0,0,0,0,0,0,0,0,0,-70000,0,0,0,0,70000,-70000,-70000
04346P,大立光兆豐95售02,0,0,0,0,0,0,0,0,0,-71000,0,0,0,69000,140000,-71000,-71000
035275,台積電台新97購01,0,0,0,0,0,0,0,0,0,-71000,0,0,0,37000,108000,-71000,-71000
05253P,智邦凱基95售08  ,0,0,0,0,0,0,0,0,0,-71000,0,0,0,150000,221000,-71000,-71000
05254P,瑞昱凱基95售04  ,0,0,0,0,0,0,0,0,0,-71000,0,0,0,0,71000,-71000,-71000
050114,群創元大95購01  ,0,0,0,0,0,0,0,0,0,-71000,0,0,0,0,71000,-71000,-71000
057535,泰鼎元大99購01  ,0,0,0,0,0,0,0,0,0,-71000,0,0,0,75000,146000,-71000,-71000
046477,台積電統一94購02,0,0,0,0,0,0,0,0,0,-72000,0,0,0,0,72000,-72000,-72000
053867,創意元大96購04  ,0,0,0,0,0,0,0,0,0,-72000,0,0,0,10000,82000,-72000,-72000
055360,台表科凱基97購02,0,0,0,0,0,0,0,0,0,-72000,0,0,0,30000,102000,-72000,-72000
054158,國巨日盛99購01  ,0,0,0,0,0,0,0,0,0,-72000,0,0,0,0,72000,-72000,-72000
056471,台光電元大99購01,0,0,0,0,0,0,0,0,0,-72000,0,0,0,20000,92000,-72000,-72000
057881,SP黃豆群益9A購01,0,0,0,0,0,0,0,0,0,-72000,0,0,0,0,72000,-72000,-72000
8070,長華*           ,15000,82000,-67000,0,0,0,0,0,0,-5000,0,5000,-5000,0,0,0,-72000
1710,東聯            ,970000,967000,3000,0,0,0,1000,0,1000,-77000,0,77000,-77000,0,0,0,-73000
058409,鴻海兆豐99購05  ,0,0,0,0,0,0,0,0,0,-73000,0,0,0,110000,183000,-73000,-73000
057489,奇力新元大99購06,0,0,0,0,0,0,0,0,0,-73000,0,0,0,37000,110000,-73000,-73000
058341,T50反1群益99購01,0,0,0,0,0,0,0,0,0,-74000,0,0,0,77000,151000,-74000,-74000
1720,生達            ,42000,116000,-74000,0,0,0,0,0,0,0,0,0,0,0,0,0,-74000
2546,根基            ,10000,84000,-74000,0,0,0,0,0,0,0,0,0,0,0,0,0,-74000
2704,國賓            ,49000,123000,-74000,0,0,0,0,0,0,0,0,0,0,0,0,0,-74000
6235,華孚            ,33000,107000,-74000,0,0,0,0,0,0,0,0,0,0,0,0,0,-74000
3454,晶睿            ,47000,112000,-65000,0,0,0,0,0,0,-9000,0,9000,-9000,0,0,0,-74000
056783,國巨群益99購01  ,0,0,0,0,0,0,0,0,0,-74000,0,0,0,0,74000,-74000,-74000
05196P,台積電永豐95售03,0,0,0,0,0,0,0,0,0,-74000,0,0,0,1000,75000,-74000,-74000
051536,玉晶光國票97購01,0,0,0,0,0,0,0,0,0,-74000,0,0,0,5000,79000,-74000,-74000
053540,健策永豐96購01  ,0,0,0,0,0,0,0,0,0,-74000,0,0,0,0,74000,-74000,-74000
054318,台虹凱基98購01  ,0,0,0,0,0,0,0,0,0,-74000,0,0,0,10000,84000,-74000,-74000
05759P,智邦永豐96售02  ,0,0,0,0,0,0,0,0,0,-74000,0,0,0,45000,119000,-74000,-74000
6670,復盛應用        ,304000,361000,-57000,0,0,0,0,0,0,-17000,0,15000,-15000,0,2000,-2000,-74000
6715,嘉基            ,9000,83000,-74000,0,0,0,0,0,0,0,0,0,0,0,0,0,-74000
6443,元晶            ,59000,133000,-74000,0,0,0,0,0,0,0,0,0,0,0,0,0,-74000
06934P,聯鈞元大98售03  ,0,0,0,0,0,0,0,0,0,-75000,0,0,0,10000,85000,-75000,-75000
058399,美律元大99購05  ,0,0,0,0,0,0,0,0,0,-75000,0,0,0,25000,100000,-75000,-75000
059150,臺股指國票99購13,0,0,0,0,0,0,0,0,0,-75000,0,0,0,20000,95000,-75000,-75000
055563,智易凱基97購02  ,0,0,0,0,0,0,0,0,0,-75000,0,0,0,0,75000,-75000,-75000
056118,聯詠群益97購03  ,0,0,0,0,0,0,0,0,0,-75000,0,0,0,236000,311000,-75000,-75000
058096,南電元大98購04  ,0,0,0,0,0,0,0,0,0,-75000,0,0,0,0,75000,-75000,-75000
05443P,宏達電元大95售05,0,0,0,0,0,0,0,0,0,-75000,0,0,0,11000,86000,-75000,-75000
057650,力成元大98購04  ,0,0,0,0,0,0,0,0,0,-75000,0,0,0,0,75000,-75000,-75000
057669,嘉晶元大99購03  ,0,0,0,0,0,0,0,0,0,-75000,0,0,0,24000,99000,-75000,-75000
054258,牧德元大97購01  ,0,0,0,0,0,0,0,0,0,-75000,0,0,0,30000,105000,-75000,-75000
057516,和鑫元富98購01  ,0,0,0,0,0,0,0,0,0,-75000,0,0,0,20000,95000,-75000,-75000
057299,立積永豐98購02  ,0,0,0,0,0,0,0,0,0,-75000,0,0,0,39000,114000,-75000,-75000
8249,菱光            ,13000,88000,-75000,0,0,0,0,0,0,0,0,0,0,0,0,0,-75000
058951,南電群益99購01  ,0,0,0,0,0,0,0,0,0,-76000,0,0,0,0,76000,-76000,-76000
4137,麗豐-KY         ,115000,191000,-76000,0,0,0,0,0,0,0,0,0,0,0,0,0,-76000
6192,巨路            ,77000,153000,-76000,0,0,0,0,0,0,0,0,0,0,0,0,0,-76000
052399,台光電凱基95購03,0,0,0,0,0,0,0,0,0,-76000,0,0,0,0,76000,-76000,-76000
00713,元大台灣高息低波,2000,0,2000,0,0,0,0,0,0,-78000,0,30000,-30000,8000,56000,-48000,-76000
055381,茂林元大97購02  ,0,0,0,0,0,0,0,0,0,-76000,0,0,0,0,76000,-76000,-76000
5515,建國            ,41000,121000,-80000,0,0,0,0,0,0,3000,3000,0,3000,0,0,0,-77000
058304,鴻海元大99購12  ,0,0,0,0,0,0,0,0,0,-77000,0,0,0,356000,433000,-77000,-77000
056895,技嘉元大98購01  ,0,0,0,0,0,0,0,0,0,-77000,0,0,0,10000,87000,-77000,-77000
05925P,晶技永豐96售03  ,0,0,0,0,0,0,0,0,0,-78000,0,0,0,6000,84000,-78000,-78000
06514P,國巨凱基98售05  ,0,0,0,0,0,0,0,0,0,-78000,0,0,0,31000,109000,-78000,-78000
3055,蔚華科          ,10000,88000,-78000,0,0,0,0,0,0,0,0,0,0,0,0,0,-78000
2013,中鋼構          ,69000,147000,-78000,0,0,0,0,0,0,0,0,0,0,0,0,0,-78000
042928,台積電中信95購01,0,0,0,0,0,0,0,0,0,-78000,0,0,0,321000,399000,-78000,-78000
051053,台光電群益95購01,0,0,0,0,0,0,0,0,0,-78000,0,0,0,0,78000,-78000,-78000
052685,技嘉元大96購01  ,0,0,0,0,0,0,0,0,0,-78000,0,0,0,66000,144000,-78000,-78000
05261P,鴻海元大95售20  ,0,0,0,0,0,0,0,0,0,-78000,0,0,0,309000,387000,-78000,-78000
056423,奇鋐統一98購01  ,0,0,0,0,0,0,0,0,0,-78000,0,0,0,0,78000,-78000,-78000
1512,瑞利            ,0,79000,-79000,0,0,0,0,0,0,0,0,0,0,0,0,0,-79000
058971,台積電永豐99購03,0,0,0,0,0,0,0,0,0,-79000,0,0,0,0,79000,-79000,-79000
05256P,義隆凱基95售02  ,0,0,0,0,0,0,0,0,0,-79000,0,0,0,0,79000,-79000,-79000
056834,華新元富99購01  ,0,0,0,0,0,0,0,0,0,-79000,0,0,0,70000,149000,-79000,-79000
054589,聯鈞國泰99購01  ,0,0,0,0,0,0,0,0,0,-79000,0,0,0,383000,462000,-79000,-79000
059082,華通元大99購06  ,0,0,0,0,0,0,0,0,0,-80000,0,0,0,20000,100000,-80000,-80000
058523,聯茂元大99購08  ,0,0,0,0,0,0,0,0,0,-80000,0,0,0,0,80000,-80000,-80000
06935P,神達元大98售02  ,0,0,0,0,0,0,0,0,0,-80000,0,0,0,3000,83000,-80000,-80000
052450,嘉澤元大95購03  ,0,0,0,0,0,0,0,0,0,-80000,0,0,0,0,80000,-80000,-80000
05203P,華新科元大95售10,0,0,0,0,0,0,0,0,0,-80000,0,0,0,150000,230000,-80000,-80000
051466,玉晶光富邦97購01,0,0,0,0,0,0,0,0,0,-80000,0,0,0,50000,130000,-80000,-80000
05144P,美律永豐95售02  ,0,0,0,0,0,0,0,0,0,-80000,0,0,0,0,80000,-80000,-80000
056485,同欣電元大98購01,0,0,0,0,0,0,0,0,0,-80000,0,0,0,30000,110000,-80000,-80000
049922,禾伸堂元大95購01,0,0,0,0,0,0,0,0,0,-80000,0,0,0,20000,100000,-80000,-80000
051825,中環元大95購01  ,0,0,0,0,0,0,0,0,0,-80000,0,0,0,20000,100000,-80000,-80000
047154,新光金國票95購01,0,0,0,0,0,0,0,0,0,-80000,0,0,0,0,80000,-80000,-80000
04441P,台積電台新95售01,0,0,0,0,0,0,0,0,0,-80000,0,0,0,80000,160000,-80000,-80000
057885,台光電群益98購04,0,0,0,0,0,0,0,0,0,-80000,0,0,0,0,80000,-80000,-80000
057638,上銀元大99購01  ,0,0,0,0,0,0,0,0,0,-80000,0,0,0,20000,100000,-80000,-80000
057110,立積群益98購01  ,0,0,0,0,0,0,0,0,0,-80000,0,0,0,0,80000,-80000,-80000
054135,大立光元大97購04,0,0,0,0,0,0,0,0,0,-80000,0,0,0,22000,102000,-80000,-80000
057289,力成元大98購03  ,0,0,0,0,0,0,0,0,0,-80000,0,0,0,0,80000,-80000,-80000
3033,威健            ,148000,230000,-82000,0,0,0,0,0,0,1000,1000,0,1000,0,0,0,-81000
3617,碩天            ,41000,87000,-46000,0,0,0,0,0,0,-35000,0,35000,-35000,0,0,0,-81000
6115,鎰勝            ,26000,74000,-48000,0,0,0,0,0,0,-33000,1000,34000,-33000,0,0,0,-81000
2616,山隆            ,10000,91000,-81000,0,0,0,0,0,0,0,0,0,0,0,0,0,-81000
2428,興勤            ,102000,170000,-68000,0,0,0,0,0,0,-13000,0,13000,-13000,1000,1000,0,-81000
059287,華通元富99購03  ,0,0,0,0,0,0,0,0,0,-81000,0,0,0,0,81000,-81000,-81000
044694,道瓊反元大94購02,0,0,0,0,0,0,0,0,0,-81000,0,0,0,51000,132000,-81000,-81000
051249,潤泰全元大95購01,0,0,0,0,0,0,0,0,0,-81000,0,0,0,3000,84000,-81000,-81000
057400,全新群益9A購01  ,0,0,0,0,0,0,0,0,0,-81000,0,0,0,0,81000,-81000,-81000
056856,華通群益9A購01  ,0,0,0,0,0,0,0,0,0,-81000,0,0,0,11000,92000,-81000,-81000
055411,國巨富邦9A購02  ,0,0,0,0,0,0,0,0,0,-81000,0,0,0,0,81000,-81000,-81000
056463,台虹凱基98購02  ,0,0,0,0,0,0,0,0,0,-81000,0,0,0,0,81000,-81000,-81000
8222,寶一            ,10000,6000,4000,0,0,0,0,85000,-85000,0,0,0,0,0,0,0,-81000
058697,亞德客元大99購01,0,0,0,0,0,0,0,0,0,-82000,0,0,0,10000,92000,-82000,-82000
04891P,友達元大94售01  ,0,0,0,0,0,0,0,0,0,-82000,0,0,0,33000,115000,-82000,-82000
05704P,矽力群益96售04  ,0,0,0,0,0,0,0,0,0,-82000,0,0,0,11000,93000,-82000,-82000
05816P,台積電凱基97售07,0,0,0,0,0,0,0,0,0,-82000,0,0,0,92000,174000,-82000,-82000
053270,台塑元大96購01  ,0,0,0,0,0,0,0,0,0,-82000,0,0,0,0,82000,-82000,-82000
2395,研華            ,1812026,1901303,-89277,0,0,0,6000,0,6000,1000,2000,3000,-1000,2000,0,2000,-82277
2059,川湖            ,51000,143000,-92000,0,0,0,15000,0,15000,-6000,3000,9000,-6000,0,0,0,-83000
06618P,智邦元大98售04  ,0,0,0,0,0,0,0,0,0,-83000,0,0,0,52000,135000,-83000,-83000
048867,台積電兆豐95購01,0,0,0,0,0,0,0,0,0,-83000,0,0,0,0,83000,-83000,-83000
051394,奇鋐兆豐95購01  ,0,0,0,0,0,0,0,0,0,-83000,0,0,0,0,83000,-83000,-83000
054516,國巨元大97購02  ,0,0,0,0,0,0,0,0,0,-83000,0,0,0,0,83000,-83000,-83000
05857P,旺宏中信98售02  ,0,0,0,0,0,0,0,0,0,-84000,0,0,0,25000,109000,-84000,-84000
058400,聯發科元大99購09,0,0,0,0,0,0,0,0,0,-84000,0,0,0,169000,253000,-84000,-84000
2706,第一店          ,34000,118000,-84000,0,0,0,0,0,0,0,0,0,0,0,0,0,-84000
5533,皇鼎            ,22000,104000,-82000,0,0,0,0,0,0,-2000,0,2000,-2000,0,0,0,-84000
051449,玉晶光元大96購01,0,0,0,0,0,0,0,0,0,-84000,0,0,0,107000,191000,-84000,-84000
050784,美律國泰96購01  ,0,0,0,0,0,0,0,0,0,-84000,0,0,0,6000,90000,-84000,-84000
054477,聯發科中信9C購02,0,0,0,0,0,0,0,0,0,-84000,0,0,0,0,84000,-84000,-84000
056271,嘉澤統一97購01  ,0,0,0,0,0,0,0,0,0,-84000,0,0,0,16000,100000,-84000,-84000
9905,大華            ,19000,100000,-81000,0,0,0,0,0,0,-3000,0,3000,-3000,0,0,0,-84000
3645,達邁            ,151000,223000,-72000,0,0,0,0,0,0,-13000,0,13000,-13000,0,0,0,-85000
2450,神腦            ,19000,71000,-52000,0,0,0,0,0,0,-33000,0,33000,-33000,0,0,0,-85000
07197P,臺股指元大99售13,0,0,0,0,0,0,0,0,0,-85000,0,0,0,0,85000,-85000,-85000
058489,台灣50群益9B購01,0,0,0,0,0,0,0,0,0,-85000,0,0,0,0,85000,-85000,-85000
059074,元油2X元大9C購15,0,0,0,0,0,0,0,0,0,-85000,0,0,0,519000,604000,-85000,-85000
050618,緯創元大95購01  ,0,0,0,0,0,0,0,0,0,-85000,0,0,0,15000,100000,-85000,-85000
049482,國巨元大94購06  ,0,0,0,0,0,0,0,0,0,-85000,0,0,0,100000,185000,-85000,-85000
05264P,微星元大95售02  ,0,0,0,0,0,0,0,0,0,-85000,0,0,0,0,85000,-85000,-85000
055665,亞德客群益97購01,0,0,0,0,0,0,0,0,0,-85000,0,0,0,25000,110000,-85000,-85000
057772,台積電群益99購01,0,0,0,0,0,0,0,0,0,-85000,0,0,0,0,85000,-85000,-85000
058173,台積電凱基99購04,0,0,0,0,0,0,0,0,0,-85000,0,0,0,0,85000,-85000,-85000
057534,旭富元大98購01  ,0,0,0,0,0,0,0,0,0,-85000,0,0,0,7000,92000,-85000,-85000
056912,臺股指元大99購04,0,0,0,0,0,0,0,0,0,-85000,0,0,0,0,85000,-85000,-85000
058570,臻鼎凱基9A購01  ,0,0,0,0,0,0,0,0,0,-86000,0,0,0,0,86000,-86000,-86000
050311,上銀兆豐95購01  ,0,0,0,0,0,0,0,0,0,-86000,0,0,0,200000,286000,-86000,-86000
052830,台光電群益96購01,0,0,0,0,0,0,0,0,0,-86000,0,0,0,0,86000,-86000,-86000
054693,神基永豐97購01  ,0,0,0,0,0,0,0,0,0,-86000,0,0,0,4000,90000,-86000,-86000
3535,晶彩科          ,356000,443000,-87000,0,0,0,0,0,0,0,0,0,0,0,0,0,-87000
054647,禾伸堂群益99購01,0,0,0,0,0,0,0,0,0,-87000,0,0,0,244000,331000,-87000,-87000
054871,明泰群益98購01  ,0,0,0,0,0,0,0,0,0,-87000,0,0,0,0,87000,-87000,-87000
3029,零壹            ,363000,451000,-88000,0,0,0,0,0,0,0,0,0,0,0,0,0,-88000
3003,健和興          ,139000,211000,-72000,0,0,0,0,0,0,-16000,0,16000,-16000,0,0,0,-88000
06978P,聯發科富邦9B售02,0,0,0,0,0,0,0,0,0,-88000,0,0,0,50000,138000,-88000,-88000
1906,寶隆            ,22000,110000,-88000,0,0,0,0,0,0,0,0,0,0,0,0,0,-88000
05281P,南亞科元大95售03,0,0,0,0,0,0,0,0,0,-88000,0,0,0,70000,158000,-88000,-88000
04846P,旺宏凱基94售07  ,0,0,0,0,0,0,0,0,0,-88000,0,0,0,18000,106000,-88000,-88000
048635,鴻海元大94購04  ,0,0,0,0,0,0,0,0,0,-88000,0,0,0,50000,138000,-88000,-88000
058145,聯茂元大99購03  ,0,0,0,0,0,0,0,0,0,-88000,0,0,0,30000,118000,-88000,-88000
2534,宏盛            ,362000,349160,12840,0,0,0,0,0,0,-100997,1000,96000,-95000,0,5997,-5997,-88157
1589,永冠-KY         ,64000,150000,-86000,0,0,0,0,0,0,-3000,0,0,0,0,3000,-3000,-89000
07191P,台積電元大99售32,0,0,0,0,0,0,0,0,0,-89000,0,0,0,1000,90000,-89000,-89000
06434P,超眾群益98售02  ,0,0,0,0,0,0,0,0,0,-89000,0,0,0,0,89000,-89000,-89000
03437B,臺股指元富9C熊01,0,0,0,0,0,0,0,0,0,-89000,0,0,0,29000,118000,-89000,-89000
052068,瑞儀兆豐96購01  ,0,0,0,0,0,0,0,0,0,-89000,0,0,0,0,89000,-89000,-89000
056657,華邦電元大99購01,0,0,0,0,0,0,0,0,0,-89000,0,0,0,30000,119000,-89000,-89000
6605,帝寶            ,30000,119000,-89000,0,0,0,0,0,0,0,0,0,0,0,0,0,-89000
058641,鴻海麥證99購02  ,0,0,0,0,90000,-90000,0,0,0,-90000,0,0,0,0,90000,-90000,-90000
058337,日月光元富99購01,0,0,0,0,0,0,0,0,0,-90000,0,0,0,100000,190000,-90000,-90000
07042P,T50反1元大9C售02,0,0,0,0,0,0,0,0,0,-90000,0,0,0,499000,589000,-90000,-90000
2816,旺旺保          ,24000,114000,-90000,0,0,0,0,0,0,0,0,0,0,0,0,0,-90000
3013,晟銘電          ,33000,123000,-90000,0,0,0,0,0,0,0,0,0,0,0,0,0,-90000
4977,眾達-KY         ,581000,449000,132000,0,0,0,15000,150000,-135000,-87000,8000,93000,-85000,0,2000,-2000,-90000
056667,上銀國票99購01  ,0,0,0,0,0,0,0,0,0,-90000,0,0,0,0,90000,-90000,-90000
056788,日月光群益98購01,0,0,0,0,0,0,0,0,0,-90000,0,0,0,0,90000,-90000,-90000
056523,光寶科中信98購01,0,0,0,0,0,0,0,0,0,-90000,0,0,0,10000,100000,-90000,-90000
052179,康友元大95購03  ,0,0,0,0,0,0,0,0,0,-90000,0,0,0,10000,100000,-90000,-90000
051665,台積電元大96購07,0,0,0,0,0,0,0,0,0,-90000,0,0,0,0,90000,-90000,-90000
048998,玉晶光國票95購03,0,0,0,0,0,0,0,0,0,-90000,0,0,0,80000,170000,-90000,-90000
04917P,台積電凱基94售37,0,0,0,0,0,0,0,0,0,-90000,0,0,0,0,90000,-90000,-90000
048191,亞德客元大93購06,0,0,0,0,0,0,0,0,0,-90000,0,0,0,10000,100000,-90000,-90000
057985,華通元富02購03  ,0,0,0,0,0,0,0,0,0,-90000,0,0,0,10000,100000,-90000,-90000
057703,矽力群益98購01  ,0,0,0,0,0,0,0,0,0,-90000,0,0,0,50000,140000,-90000,-90000
054416,禾伸堂元大97購01,0,0,0,0,0,0,0,0,0,-90000,0,0,0,10000,100000,-90000,-90000
055495,長榮航元大97購01,0,0,0,0,0,0,0,0,0,-90000,0,0,0,0,90000,-90000,-90000
053172,瑞儀群益97購01  ,0,0,0,0,0,0,0,0,0,-90000,0,0,0,0,90000,-90000,-90000
053890,華新科群益98購01,0,0,0,0,0,0,0,0,0,-90000,0,0,0,0,90000,-90000,-90000
053724,聯詠凱基96購04  ,0,0,0,0,0,0,0,0,0,-90000,0,0,0,0,90000,-90000,-90000
057458,TPK富邦9A購01   ,0,0,0,0,0,0,0,0,0,-90000,0,0,0,0,90000,-90000,-90000
057501,超眾群益98購04  ,0,0,0,0,0,0,0,0,0,-90000,0,0,0,0,90000,-90000,-90000
057335,技嘉國票99購01  ,0,0,0,0,0,0,0,0,0,-90000,0,0,0,0,90000,-90000,-90000
9955,佳龍            ,77000,167000,-90000,0,0,0,0,0,0,0,0,0,0,0,0,0,-90000
1718,中纖            ,1303000,1393857,-90857,0,0,0,0,0,0,0,0,0,0,0,0,0,-90857
044429,元金2X元大94購04,0,0,0,0,0,0,0,0,0,-91000,0,0,0,0,91000,-91000,-91000
006205,富邦上証        ,18000,312000,-294000,0,0,0,0,0,0,203000,110000,0,110000,1448000,1355000,93000,-91000
053627,宏碁兆豐97購01  ,0,0,0,0,0,0,0,0,0,-91000,0,0,0,114000,205000,-91000,-91000
05322P,台積電凱基95售17,0,0,0,0,0,0,0,0,0,-91000,0,0,0,89000,180000,-91000,-91000
058231,技嘉元大99購02  ,0,0,0,0,0,0,0,0,0,-91000,0,0,0,30000,121000,-91000,-91000
2030,彰源            ,47000,139000,-92000,0,0,0,0,0,0,0,0,0,0,0,0,0,-92000
059273,臺指反元大9C購03,0,0,0,0,0,0,0,0,0,-92000,0,0,0,0,92000,-92000,-92000
059163,台積電凱基99購10,0,0,0,0,0,0,0,0,0,-92000,0,0,0,138000,230000,-92000,-92000
06153P,健策元大97售04  ,0,0,0,0,0,0,0,0,0,-92000,0,0,0,3000,95000,-92000,-92000
052588,玉晶光永豐98購01,0,0,0,0,0,0,0,0,0,-92000,0,0,0,180000,272000,-92000,-92000
2477,美隆電          ,48000,123000,-75000,0,0,0,0,0,0,-18000,0,18000,-18000,0,0,0,-93000
057221,華通國票98購03  ,0,0,0,0,0,0,0,0,0,-93000,0,0,0,5000,98000,-93000,-93000
9907,統一實          ,659000,752000,-93000,0,0,0,0,0,0,0,0,0,0,0,0,0,-93000
059199,欣興永豐99購02  ,0,0,0,0,0,0,0,0,0,-94000,0,0,0,0,94000,-94000,-94000
051776,上証2X群益99購01,0,0,0,0,0,0,0,0,0,-94000,0,0,0,110000,204000,-94000,-94000
051088,台積電元大95購09,0,0,0,0,0,0,0,0,0,-94000,0,0,0,0,94000,-94000,-94000
058233,聯發科元大99購06,0,0,0,0,0,0,0,0,0,-94000,0,0,0,174000,268000,-94000,-94000
9944,新麗            ,132000,226000,-94000,0,0,0,0,0,0,0,0,0,0,0,0,0,-94000
059021,台積電統一9B購07,0,0,0,0,0,0,0,0,0,-95000,0,0,0,0,95000,-95000,-95000
051094,健策元大96購03  ,0,0,0,0,0,0,0,0,0,-95000,0,0,0,0,95000,-95000,-95000
03183P,鴻海元大01售28  ,0,0,0,0,0,0,0,0,0,-95000,0,0,0,30000,125000,-95000,-95000
058248,聯茂元大99購05  ,0,0,0,0,0,0,0,0,0,-95000,0,0,0,23000,118000,-95000,-95000
055023,億光國泰98購01  ,0,0,0,0,0,0,0,0,0,-95000,0,0,0,10000,105000,-95000,-95000
06498P,臺股指元大9A售03,0,0,0,0,0,0,0,0,0,-96000,0,0,0,22000,118000,-96000,-96000
07173P,臺股指國票99售10,0,0,0,0,0,0,0,0,0,-96000,0,0,0,52000,148000,-96000,-96000
052927,友達元大98購02  ,0,0,0,0,0,0,0,0,0,-96000,0,0,0,0,96000,-96000,-96000
05598P,國巨元富96售03  ,0,0,0,0,0,0,0,0,0,-96000,0,0,0,130000,226000,-96000,-96000
058086,鴻海元大98購14  ,0,0,0,0,0,0,0,0,0,-96000,0,0,0,30000,126000,-96000,-96000
053438,玉晶光麥證97購02,0,0,0,80000,176000,-96000,0,0,0,-96000,0,0,0,80000,176000,-96000,-96000
1447,力鵬            ,160000,257000,-97000,0,0,0,0,0,0,0,0,0,0,0,0,0,-97000
3015,全漢            ,38000,138000,-100000,0,0,0,0,0,0,3000,3000,0,3000,0,0,0,-97000
049272,世紀鋼元大96購02,0,0,0,0,0,0,0,0,0,-97000,0,0,0,48000,145000,-97000,-97000
2489,瑞軒            ,292000,323000,-31000,0,0,0,0,0,0,-67000,18000,85000,-67000,0,0,0,-98000
2233,宇隆            ,42000,140000,-98000,0,0,0,0,0,0,0,0,0,0,0,0,0,-98000
058762,貿聯群益99購03  ,0,0,0,0,0,0,0,0,0,-98000,0,0,0,0,98000,-98000,-98000
058725,美律富邦9A購01  ,0,0,0,0,0,0,0,0,0,-98000,0,0,0,0,98000,-98000,-98000
058700,鴻海元大99購15  ,0,0,0,0,0,0,0,0,0,-98000,0,0,0,30000,128000,-98000,-98000
04796P,聯發科元大94售10,0,0,0,0,0,0,0,0,0,-98000,0,0,0,585000,683000,-98000,-98000
048901,矽格國泰95購01  ,0,0,0,0,0,0,0,0,0,-98000,0,0,0,0,98000,-98000,-98000
056092,亞德客元富97購02,0,0,0,0,0,0,0,0,0,-98000,0,0,0,0,98000,-98000,-98000
058285,牧德群益9A購02  ,0,0,0,0,0,0,0,0,0,-99000,0,0,0,1000,100000,-99000,-99000
058943,元石油群益9C購01,0,0,0,0,0,0,0,0,0,-99000,0,0,0,0,99000,-99000,-99000
059176,臺股指凱基99購27,0,0,0,0,0,0,0,0,0,-99000,0,0,0,0,99000,-99000,-99000
04845P,台積電凱基94售33,0,0,0,0,0,0,0,0,0,-99000,0,0,0,0,99000,-99000,-99000
050952,健策群益96購01  ,0,0,0,0,0,0,0,0,0,-99000,0,0,0,11000,110000,-99000,-99000
055383,GIS元大97購02   ,0,0,0,0,0,0,0,0,0,-99000,0,0,0,114000,213000,-99000,-99000
2231,為升            ,561000,674000,-113000,0,0,0,0,14000,-14000,27419,42000,14000,28000,8000,8581,-581,-99581
1455,集盛            ,255000,355000,-100000,0,0,0,0,0,0,0,0,0,0,0,0,0,-100000
07225P,台積電元大99售33,0,0,0,0,0,0,0,0,0,-100000,0,0,0,0,100000,-100000,-100000
07174P,臺股指國票99售11,0,0,0,0,0,0,0,0,0,-100000,0,0,0,0,100000,-100000,-100000
07217P,大立光凱基9A售05,0,0,0,0,0,0,0,0,0,-100000,0,0,0,0,100000,-100000,-100000
07099P,台積電元大99售19,0,0,0,0,0,0,0,0,0,-100000,0,0,0,71000,171000,-100000,-100000
6155,鈞寶            ,32000,132000,-100000,0,0,0,0,0,0,0,0,0,0,0,0,0,-100000
06119P,大立光凱基98售04,0,0,0,0,0,0,0,0,0,-100000,0,0,0,0,100000,-100000,-100000
058887,元石油元大9C購04,0,0,0,0,0,0,0,0,0,-100000,0,0,0,2000,102000,-100000,-100000
058322,玉晶光永豐99購02,0,0,0,0,0,0,0,0,0,-100000,0,0,0,0,100000,-100000,-100000
050944,智邦群益95購01  ,0,0,0,0,0,0,0,0,0,-100000,0,0,0,0,100000,-100000,-100000
051785,臻鼎兆豐96購01  ,0,0,0,0,0,0,0,0,0,-100000,0,0,0,0,100000,-100000,-100000
051933,嘉聯益國票97購03,0,0,0,0,0,0,0,0,0,-100000,0,0,0,0,100000,-100000,-100000
052097,GIS元大95購05   ,0,0,0,0,0,0,0,0,0,-100000,0,0,0,0,100000,-100000,-100000
051877,嘉聯益國票97購02,0,0,0,0,0,0,0,0,0,-100000,0,0,0,0,100000,-100000,-100000
056604,鴻海富邦9A購01  ,0,0,0,0,0,0,0,0,0,-100000,0,0,0,0,100000,-100000,-100000
056625,致伸永豐98購01  ,0,0,0,0,0,0,0,0,0,-100000,0,0,0,0,100000,-100000,-100000
051988,台光電元大95購01,0,0,0,0,0,0,0,0,0,-100000,0,0,0,46000,146000,-100000,-100000
051429,智邦元富95購01  ,0,0,0,0,0,0,0,0,0,-100000,0,0,0,110000,210000,-100000,-100000
051537,牧德國票96購01  ,0,0,0,0,0,0,0,0,0,-100000,0,0,0,0,100000,-100000,-100000
04968P,台積電富邦94售06,0,0,0,0,0,0,0,0,0,-100000,0,0,0,230000,330000,-100000,-100000
048222,台積電凱基93購26,0,0,0,0,0,0,0,0,0,-100000,0,0,0,0,100000,-100000,-100000
048178,上銀富邦95購02  ,0,0,0,0,0,0,0,0,0,-100000,0,0,0,0,100000,-100000,-100000
04758P,國巨凱基94售03  ,0,0,0,0,0,0,0,0,0,-100000,0,0,0,20000,120000,-100000,-100000
052932,正文元大97購01  ,0,0,0,0,0,0,0,0,0,-100000,0,0,0,0,100000,-100000,-100000
046680,上証反群益95購01,0,0,0,0,0,0,0,0,0,-100000,0,0,0,0,100000,-100000,-100000
04320P,亞德客元大93售07,0,0,0,0,0,0,0,0,0,-100000,0,0,0,0,100000,-100000,-100000
00762,元大全球AI      ,0,0,0,0,0,0,0,0,0,-100000,0,0,0,19000,119000,-100000,-100000
054747,麗豐凱基98購01  ,0,0,0,0,0,0,0,0,0,-100000,0,0,0,0,100000,-100000,-100000
057528,南亞科元大99購01,0,0,0,0,0,0,0,0,0,-100000,0,0,0,0,100000,-100000,-100000
056436,台積電凱基98購10,0,0,0,0,0,0,0,0,0,-100000,0,0,0,0,100000,-100000,-100000
054173,奇力新台新97購02,0,0,0,0,0,0,0,0,0,-100000,0,0,0,0,100000,-100000,-100000
054033,欣興中信96購02  ,0,0,0,0,0,0,0,0,0,-100000,0,0,0,0,100000,-100000,-100000
057161,亞德客元大98購02,0,0,0,0,0,0,0,0,0,-100000,0,0,0,0,100000,-100000,-100000
056128,和大中信99購01  ,0,0,0,0,0,0,0,0,0,-100000,0,0,0,0,100000,-100000,-100000
053113,瀚宇博兆豐97購01,0,0,0,0,0,0,0,0,0,-100000,0,0,0,0,100000,-100000,-100000
055984,大立光元富97購02,0,0,0,0,0,0,0,0,0,-100000,0,0,0,31000,131000,-100000,-100000
055826,中石化元大97購01,0,0,0,0,0,0,0,0,0,-100000,0,0,0,0,100000,-100000,-100000
054943,群光元大97購01  ,0,0,0,0,0,0,0,0,0,-100000,0,0,0,60000,160000,-100000,-100000
054642,訊芯中信9A購01  ,0,0,0,0,0,0,0,0,0,-100000,0,0,0,0,100000,-100000,-100000
058118,瑞昱群益99購01  ,0,0,0,0,0,0,0,0,0,-100000,0,0,0,0,100000,-100000,-100000
058212,華新科群益9A購01,0,0,0,0,0,0,0,0,0,-100000,0,0,0,0,100000,-100000,-100000
058062,上銀中信98購01  ,0,0,0,0,0,0,0,0,0,-100000,0,0,0,0,100000,-100000,-100000
057894,華通元富02購02  ,0,0,0,0,0,0,0,0,0,-100000,0,0,0,0,100000,-100000,-100000
053216,京鼎凱基96購02  ,0,0,0,0,0,0,0,0,0,-100000,0,0,0,0,100000,-100000,-100000
053294,聯發科中信9C購01,0,0,0,0,0,0,0,0,0,-100000,0,0,0,0,100000,-100000,-100000
054374,信邦中信96購01  ,0,0,0,0,0,0,0,0,0,-100000,0,0,0,5000,105000,-100000,-100000
057755,鴻海日盛98購01  ,0,0,0,0,0,0,0,0,0,-100000,0,0,0,0,100000,-100000,-100000
055684,京鼎凱基97購01  ,0,0,0,0,0,0,0,0,0,-100000,0,0,0,0,100000,-100000,-100000
6525,捷敏-KY         ,36000,136000,-100000,0,0,0,0,0,0,0,0,0,0,0,0,0,-100000
07016P,聯發科元大99售10,0,0,0,0,0,0,0,0,0,-101000,0,0,0,15000,116000,-101000,-101000
1708,東鹼            ,14000,114000,-100000,0,0,0,0,0,0,-1000,0,1000,-1000,0,0,0,-101000
049811,聯鈞元大94購01  ,0,0,0,0,0,0,0,0,0,-101000,0,0,0,0,101000,-101000,-101000
1231,聯華食          ,32000,134000,-102000,0,0,0,0,0,0,0,0,0,0,0,0,0,-102000
2374,佳能            ,42000,145000,-103000,0,0,0,0,0,0,1000,1000,0,1000,0,0,0,-102000
2545,皇翔            ,74000,148000,-74000,0,0,0,0,0,0,-28000,0,28000,-28000,0,0,0,-102000
059028,嘉聯益台新99購02,0,0,0,0,0,0,0,0,0,-102000,0,0,0,205000,307000,-102000,-102000
057095,祥碩元富98購02  ,0,0,0,0,0,0,0,0,0,-102000,0,0,0,0,102000,-102000,-102000
1532,勤美            ,123000,226000,-103000,0,0,0,0,0,0,0,0,0,0,0,0,0,-103000
052933,祥碩元大96購01  ,0,0,0,0,0,0,0,0,0,-103000,0,0,0,379000,482000,-103000,-103000
057097,致新元富98購01  ,0,0,0,0,0,0,0,0,0,-103000,0,0,0,28000,131000,-103000,-103000
056468,鴻海元大98購07  ,0,0,0,0,0,0,0,0,0,-103000,0,0,0,40000,143000,-103000,-103000
057495,牧德元大99購04  ,0,0,0,0,0,0,0,0,0,-103000,0,0,0,0,103000,-103000,-103000
8404,百和興業-KY     ,134000,237000,-103000,0,0,0,0,0,0,0,0,0,0,0,0,0,-103000
6224,聚鼎            ,47000,139000,-92000,0,0,0,0,35000,-35000,23000,26000,3000,23000,0,0,0,-104000
3419,譁裕            ,113000,218000,-105000,0,0,0,0,0,0,1000,1000,0,1000,0,0,0,-104000
058607,聯發科元大99購14,0,0,0,0,0,0,0,0,0,-104000,0,0,0,285000,389000,-104000,-104000
059234,台灣50凱基9C購03,0,0,0,0,0,0,0,0,0,-104000,0,0,0,0,104000,-104000,-104000
055938,矽力群益97購01  ,0,0,0,0,0,0,0,0,0,-104000,0,0,0,36000,140000,-104000,-104000
058259,訊連國泰9B購01  ,0,0,0,0,0,0,0,0,0,-104000,0,0,0,270000,374000,-104000,-104000
059295,大立光元富99購05,0,0,0,0,0,0,0,0,0,-105000,0,0,0,0,105000,-105000,-105000
3024,憶聲            ,25000,130000,-105000,0,0,0,0,0,0,0,0,0,0,0,0,0,-105000
1308,亞聚            ,188000,289000,-101000,0,0,0,0,0,0,-4000,4000,8000,-4000,0,0,0,-105000
051745,玉晶光國泰97購06,0,0,0,0,0,0,0,0,0,-105000,0,0,0,0,105000,-105000,-105000
051844,宏達電富邦96購01,0,0,0,0,0,0,0,0,0,-105000,0,0,0,0,105000,-105000,-105000
050856,智邦台新95購01  ,0,0,0,0,0,0,0,0,0,-105000,0,0,0,0,105000,-105000,-105000
056242,緯創群益9A購01  ,0,0,0,0,0,0,0,0,0,-105000,0,0,0,5000,110000,-105000,-105000
054806,台化元大9A購01  ,0,0,0,0,0,0,0,0,0,-105000,0,0,0,0,105000,-105000,-105000
059051,和大凱基9A購01  ,0,0,0,0,0,0,0,0,0,-106000,0,0,0,0,106000,-106000,-106000
055229,大毅國票97購02  ,0,0,0,0,0,0,0,0,0,-106000,0,0,0,0,106000,-106000,-106000
054924,景碩凱基98購01  ,0,0,0,0,0,0,0,0,0,-106000,0,0,0,0,106000,-106000,-106000
054996,聯陽元富97購01  ,0,0,0,0,0,0,0,0,0,-106000,0,0,0,0,106000,-106000,-106000
06594P,立積元大98售01  ,0,0,0,0,0,0,0,0,0,-107000,0,0,0,42000,149000,-107000,-107000
056651,聯茂凱基98購04  ,0,0,0,0,0,0,0,0,0,-107000,0,0,0,10000,117000,-107000,-107000
056054,亞德客元大97購05,0,0,0,0,0,0,0,0,0,-107000,0,0,0,5000,112000,-107000,-107000
053942,超眾國泰96購02  ,0,0,0,0,0,0,0,0,0,-107000,0,0,0,69000,176000,-107000,-107000
056515,燿華兆豐99購01  ,0,0,0,0,0,0,0,0,0,-108000,0,0,0,120000,228000,-108000,-108000
056226,聯發科凱基97購10,0,0,0,0,0,0,0,0,0,-108000,0,0,0,42000,150000,-108000,-108000
1464,得力            ,197000,291000,-94000,0,0,0,0,0,0,-15000,0,13000,-13000,0,2000,-2000,-109000
1437,勤益控          ,23000,132000,-109000,0,0,0,0,0,0,0,0,0,0,0,0,0,-109000
1522,堤維西          ,135000,243000,-108000,0,0,0,0,0,0,-1000,0,1000,-1000,0,0,0,-109000
07022P,嘉晶永豐99售02  ,0,0,0,0,0,0,0,0,0,-110000,0,0,0,16000,126000,-110000,-110000
07089P,臺指2X中信01售01,0,0,0,0,0,0,0,0,0,-110000,0,0,0,10000,120000,-110000,-110000
056605,台積電富邦9B購02,0,0,0,0,0,0,0,0,0,-110000,0,0,0,0,110000,-110000,-110000
056678,力成元富98購01  ,0,0,0,0,0,0,0,0,0,-110000,0,0,0,90000,200000,-110000,-110000
056742,玉晶光凱基9A購01,0,0,0,0,0,0,0,0,0,-110000,0,0,0,0,110000,-110000,-110000
050167,T50反1富邦96購01,0,0,0,0,0,0,0,0,0,-110000,0,0,0,10000,120000,-110000,-110000
04745P,祥碩元大94售04  ,0,0,0,0,0,0,0,0,0,-110000,0,0,0,15000,125000,-110000,-110000
054867,華航群益99購01  ,0,0,0,0,0,0,0,0,0,-110000,0,0,0,20000,130000,-110000,-110000
055513,旺宏亞東98購01  ,0,0,0,0,0,0,0,0,0,-110000,0,0,0,0,110000,-110000,-110000
054425,聯發科富邦99購03,0,0,0,0,0,0,0,0,0,-110000,0,0,0,0,110000,-110000,-110000
053729,聯茂凱基96購05  ,0,0,0,0,0,0,0,0,0,-110000,0,0,0,0,110000,-110000,-110000
053020,貿聯元富96購01  ,0,0,0,0,0,0,0,0,0,-110000,0,0,0,0,110000,-110000,-110000
054730,上証2X凱基98購02,0,0,0,0,0,0,0,0,0,-110000,0,0,0,0,110000,-110000,-110000
054134,強茂元大96購01  ,0,0,0,0,0,0,0,0,0,-110000,0,0,0,0,110000,-110000,-110000
07000P,T50反1元大99售03,0,0,0,0,0,0,0,0,0,-111000,0,0,0,52000,163000,-111000,-111000
059285,台灣50元富01購02,0,0,0,0,0,0,0,0,0,-111000,0,0,0,0,111000,-111000,-111000
05853P,欣興群益96售05  ,0,0,0,0,0,0,0,0,0,-111000,0,0,0,0,111000,-111000,-111000
057190,立積元大9A購02  ,0,0,0,0,0,0,0,0,0,-111000,0,0,0,40000,151000,-111000,-111000
057957,嘉晶元大98購01  ,0,0,0,0,0,0,0,0,0,-111000,0,0,0,10000,121000,-111000,-111000
1737,臺鹽            ,20000,132000,-112000,0,0,0,0,0,0,0,0,0,0,0,0,0,-112000
052789,台積電麥證96購01,0,0,0,38000,2080000,-2042000,0,0,0,-112000,0,0,0,1968000,2080000,-112000,-112000
050093,國巨永豐94購05  ,0,0,0,0,0,0,0,0,0,-113000,0,0,0,0,113000,-113000,-113000
5531,鄉林            ,298000,412000,-114000,0,0,0,0,0,0,0,0,0,0,0,0,0,-114000
04834P,鴻海元大94售17  ,0,0,0,0,0,0,0,0,0,-114000,0,0,0,42000,156000,-114000,-114000
048788,華新科元大95購02,0,0,0,0,0,0,0,0,0,-114000,0,0,0,26000,140000,-114000,-114000
058088,鴻海元大9A購01  ,0,0,0,0,0,0,0,0,0,-114000,0,0,0,105000,219000,-114000,-114000
05504P,台積電凱基96售04,0,0,0,0,0,0,0,0,0,-114000,0,0,0,0,114000,-114000,-114000
055376,群創元大01購01  ,0,0,0,0,0,0,0,0,0,-114000,0,0,0,90000,204000,-114000,-114000
058758,台積電群益99購05,0,0,0,0,0,0,0,0,0,-115000,0,0,0,28000,143000,-115000,-115000
06546P,聯發科元大98售05,0,0,0,0,0,0,0,0,0,-115000,0,0,0,10000,125000,-115000,-115000
06687P,A50正2中信9A售01,0,0,0,0,0,0,0,0,0,-115000,0,0,0,72000,187000,-115000,-115000
048898,晶相光國泰96購01,0,0,0,0,0,0,0,0,0,-115000,0,0,0,178000,293000,-115000,-115000
00753L,中信中國50正2   ,0,0,0,0,0,0,0,0,0,-115000,0,0,0,254000,369000,-115000,-115000
04696P,亞德客國泰95售02,0,0,0,0,0,0,0,0,0,-115000,0,0,0,6000,121000,-115000,-115000
05540P,亞德客凱基96售01,0,0,0,0,0,0,0,0,0,-115000,0,0,0,0,115000,-115000,-115000
054827,宏全元大9A購01  ,0,0,0,0,0,0,0,0,0,-115000,0,0,0,30000,145000,-115000,-115000
054905,國揚康和97購01  ,0,0,0,0,0,0,0,0,0,-115000,0,0,0,0,115000,-115000,-115000
057639,國巨元大99購07  ,0,0,0,0,0,0,0,0,0,-115000,0,0,0,0,115000,-115000,-115000
06850P,聯茂元大98售06  ,0,0,0,0,0,0,0,0,0,-116000,0,0,0,64000,180000,-116000,-116000
07216P,大立光凱基99售08,0,0,0,0,0,0,0,0,0,-116000,0,0,0,158000,274000,-116000,-116000
056311,泰鼎元大98購01  ,0,0,0,0,0,0,0,0,0,-116000,0,0,0,61000,177000,-116000,-116000
050779,超眾元大96購03  ,0,0,0,0,0,0,0,0,0,-116000,0,0,0,110000,226000,-116000,-116000
055960,義隆元大97購01  ,0,0,0,0,0,0,0,0,0,-116000,0,0,0,10000,126000,-116000,-116000
05402P,台郡永豐95售02  ,0,0,0,0,0,0,0,0,0,-116000,0,0,0,5000,121000,-116000,-116000
4952,凌通            ,12000,129000,-117000,0,0,0,0,0,0,0,0,0,0,0,0,0,-117000
058522,聯茂元大99購07  ,0,0,0,0,0,0,0,0,0,-117000,0,0,0,58000,175000,-117000,-117000
050686,欣興兆豐96購01  ,0,0,0,0,0,0,0,0,0,-117000,0,0,0,0,117000,-117000,-117000
058567,華新科凱基9A購02,0,0,0,0,0,0,0,0,0,-118000,0,0,0,12000,130000,-118000,-118000
2537,聯上發          ,463000,581000,-118000,0,0,0,0,0,0,0,0,0,0,0,0,0,-118000
2020,美亞            ,36000,154000,-118000,0,0,0,0,0,0,0,0,0,0,0,0,0,-118000
056769,國產元大98購01  ,0,0,0,0,0,0,0,0,0,-118000,0,0,0,50000,168000,-118000,-118000
048289,臺指反群益95購01,0,0,0,0,0,0,0,0,0,-118000,0,0,0,2000,120000,-118000,-118000
053818,富邦金群益98購01,0,0,0,0,0,0,0,0,0,-118000,0,0,0,0,118000,-118000,-118000
057635,中鋼元大98購01  ,0,0,0,0,0,0,0,0,0,-118000,0,0,0,115000,233000,-118000,-118000
058144,聯茂元大99購02  ,0,0,0,0,0,0,0,0,0,-118000,0,0,0,50000,168000,-118000,-118000
6706,惠特            ,89000,217000,-128000,0,0,0,10000,0,10000,0,0,0,0,0,0,0,-118000
058528,世紀鋼元大99購02,0,0,0,0,0,0,0,0,0,-119000,0,0,0,308000,427000,-119000,-119000
052527,泰鼎元大96購02  ,0,0,0,0,0,0,0,0,0,-119000,0,0,0,0,119000,-119000,-119000
06053P,緯穎國票97售05  ,0,0,0,0,0,0,0,0,0,-120000,0,0,0,0,120000,-120000,-120000
1773,勝一            ,21000,141000,-120000,0,0,0,0,0,0,0,0,0,0,0,0,0,-120000
08750P,台灣50群益01售04,0,0,0,0,0,0,0,0,0,-120000,0,0,0,10000,130000,-120000,-120000
056737,國巨凱基9A購01  ,0,0,0,0,0,0,0,0,0,-120000,0,0,0,10000,130000,-120000,-120000
052859,國巨凱基96購07  ,0,0,0,0,0,0,0,0,0,-120000,0,0,0,0,120000,-120000,-120000
055874,中環元富9A購01  ,0,0,0,0,0,0,0,0,0,-120000,0,0,0,10000,130000,-120000,-120000
056115,奇力新群益97購06,0,0,0,0,0,0,0,0,0,-120000,0,0,0,0,120000,-120000,-120000
05609P,國泰金凱基96售01,0,0,0,0,0,0,0,0,0,-120000,0,0,0,144000,264000,-120000,-120000
054652,裕隆麥證97購01  ,0,0,0,0,120000,-120000,0,0,0,-120000,0,0,0,0,120000,-120000,-120000
053389,彩晶元大98購01  ,0,0,0,0,0,0,0,0,0,-120000,0,0,0,0,120000,-120000,-120000
053965,聯電元大98購04  ,0,0,0,0,0,0,0,0,0,-120000,0,0,0,20000,140000,-120000,-120000
055385,昇陽半元大98購01,0,0,0,0,0,0,0,0,0,-120000,0,0,0,10000,130000,-120000,-120000
056892,旺宏元大9A購02  ,0,0,0,0,0,0,0,0,0,-120000,0,0,0,0,120000,-120000,-120000
05403P,台積電富邦95售08,0,0,0,0,0,0,0,0,0,-120000,0,0,0,0,120000,-120000,-120000
057532,智原元大98購03  ,0,0,0,0,0,0,0,0,0,-120000,0,0,0,40000,160000,-120000,-120000
00728,第一金工業30    ,0,0,0,0,0,0,0,0,0,-121000,0,0,0,655000,776000,-121000,-121000
05539P,鎧勝永豐96售01  ,0,0,0,0,0,0,0,0,0,-121000,0,0,0,4000,125000,-121000,-121000
07147P,高鐵元大99售01  ,0,0,0,0,0,0,0,0,0,-122000,0,0,0,1000,123000,-122000,-122000
04863P,技嘉元大94售02  ,0,0,0,0,0,0,0,0,0,-122000,0,0,0,8000,130000,-122000,-122000
049629,臺股指群益94購02,0,0,0,0,0,0,0,0,0,-122000,0,0,0,0,122000,-122000,-122000
057576,南亞科第一9C購01,0,0,0,0,0,0,0,0,0,-122000,0,0,0,0,122000,-122000,-122000
2022,聚亨            ,55000,177000,-122000,0,0,0,0,0,0,-1000,0,1000,-1000,0,0,0,-123000
07046P,大立光富邦9C售03,0,0,0,0,0,0,0,0,0,-124000,0,0,0,40000,164000,-124000,-124000
2636,台驊投控        ,25000,149000,-124000,0,0,0,0,0,0,0,0,0,0,0,0,0,-124000
05506P,茂林凱基96售03  ,0,0,0,0,0,0,0,0,0,-124000,0,0,0,44000,168000,-124000,-124000
057307,瀚宇博兆豐99購01,0,0,0,0,0,0,0,0,0,-124000,0,0,0,208000,332000,-124000,-124000
2401,凌陽            ,457000,465000,-8000,0,0,0,0,0,0,-117000,0,151000,-151000,34000,0,34000,-125000
07115P,T50反1日盛9C售02,0,0,0,0,0,0,0,0,0,-125000,0,0,0,380000,505000,-125000,-125000
1711,永光            ,72000,197000,-125000,0,0,0,0,0,0,0,0,0,0,0,0,0,-125000
06016P,京元電凱基96售03,0,0,0,0,0,0,0,0,0,-125000,0,0,0,4000,129000,-125000,-125000
058525,台虹元大99購02  ,0,0,0,0,0,0,0,0,0,-125000,0,0,0,0,125000,-125000,-125000
058445,旺宏富邦9C購01  ,0,0,0,0,0,0,0,0,0,-125000,0,0,0,15000,140000,-125000,-125000
058706,聯鈞元大9C購01  ,0,0,0,0,0,0,0,0,0,-125000,0,0,0,0,125000,-125000,-125000
053071,南電群益96購01  ,0,0,0,0,0,0,0,0,0,-125000,0,0,0,0,125000,-125000,-125000
053117,大立光中信9A購02,0,0,0,0,0,0,0,0,0,-125000,0,0,0,40000,165000,-125000,-125000
6668,中揚光          ,232000,150000,82000,0,0,0,0,207000,-207000,0,0,0,0,0,0,0,-125000
2929,淘帝-KY         ,208000,333000,-125000,0,0,0,0,0,0,-1000,0,1000,-1000,0,0,0,-126000
6281,全國電          ,7000,123000,-116000,0,0,0,0,0,0,-10000,0,10000,-10000,0,0,0,-126000
6177,達麗            ,96000,222000,-126000,0,0,0,0,0,0,0,0,0,0,0,0,0,-126000
1810,和成            ,46000,173000,-127000,0,0,0,0,0,0,0,0,0,0,0,0,0,-127000
058802,矽創元大99購02  ,0,0,0,0,0,0,0,0,0,-127000,0,0,0,10000,137000,-127000,-127000
058927,勤誠元富99購02  ,0,0,0,0,0,0,0,0,0,-127000,0,0,0,51000,178000,-127000,-127000
059255,臺股指凱基99購33,0,0,0,0,0,0,0,0,0,-127000,0,0,0,0,127000,-127000,-127000
057104,康友中信99購01  ,0,0,0,0,0,0,0,0,0,-127000,0,0,0,150000,277000,-127000,-127000
3209,全科            ,141226,265000,-123774,0,0,0,0,0,0,-4000,1000,5000,-4000,0,0,0,-127774
05210P,台積電凱基95售15,0,0,0,0,0,0,0,0,0,-128000,0,0,0,150000,278000,-128000,-128000
5234,達興材料        ,97000,189000,-92000,0,0,0,0,0,0,-37000,0,37000,-37000,0,0,0,-129000
1452,宏益            ,8000,137000,-129000,0,0,0,0,0,0,0,0,0,0,0,0,0,-129000
051888,國巨元富95購05  ,0,0,0,0,0,0,0,0,0,-129000,0,0,0,0,129000,-129000,-129000
2634,漢翔            ,370000,724000,-354000,0,0,0,3000,0,3000,221000,226000,5000,221000,0,0,0,-130000
06019P,緯穎凱基96售03  ,0,0,0,0,0,0,0,0,0,-130000,0,0,0,172000,302000,-130000,-130000
06654P,欣興元大98售08  ,0,0,0,0,0,0,0,0,0,-130000,0,0,0,0,130000,-130000,-130000
059107,南茂國泰9A購01  ,0,0,0,0,0,0,0,0,0,-130000,0,0,0,10000,140000,-130000,-130000
050166,彩晶國泰95購01  ,0,0,0,0,0,0,0,0,0,-130000,0,0,0,100000,230000,-130000,-130000
052984,漢唐元大96購01  ,0,0,0,0,0,0,0,0,0,-130000,0,0,0,118000,248000,-130000,-130000
03237P,大立光元大02售04,0,0,0,0,0,0,0,0,0,-130000,0,0,0,10000,140000,-130000,-130000
05742P,可成元大96售04  ,0,0,0,0,0,0,0,0,0,-130000,0,0,0,2000,132000,-130000,-130000
053490,為升兆豐97購01  ,0,0,0,0,0,0,0,0,0,-130000,0,0,0,0,130000,-130000,-130000
054757,南亞國票98購01  ,0,0,0,0,0,0,0,0,0,-130000,0,0,0,0,130000,-130000,-130000
054967,神達元大97購01  ,0,0,0,0,0,0,0,0,0,-130000,0,0,0,31000,161000,-130000,-130000
2547,日勝生          ,498000,629000,-131000,0,0,0,0,0,0,0,0,0,0,0,0,0,-131000
2832,台產            ,26000,157000,-131000,0,0,0,0,0,0,-1000,0,1000,-1000,0,0,0,-132000
5305,敦南            ,153000,285000,-132000,0,0,0,0,0,0,0,0,0,0,0,0,0,-132000
1707,葡萄王          ,158000,582000,-424000,0,0,0,268000,0,268000,24000,53000,18000,35000,0,11000,-11000,-132000
058999,台積電元大99購24,0,0,0,0,0,0,0,0,0,-132000,0,0,0,1869000,2001000,-132000,-132000
06201P,可成元大97售01  ,0,0,0,0,0,0,0,0,0,-132000,0,0,0,38000,170000,-132000,-132000
059220,聯發科元大99購20,0,0,0,0,0,0,0,0,0,-133000,0,0,0,172000,305000,-133000,-133000
057643,聯發科元大99購03,0,0,0,0,0,0,0,0,0,-133000,0,0,0,145000,278000,-133000,-133000
053570,京元電統一96購01,0,0,0,0,0,0,0,0,0,-133000,0,0,0,0,133000,-133000,-133000
057293,力成國泰99購01  ,0,0,0,0,0,0,0,0,0,-133000,0,0,0,0,133000,-133000,-133000
3518,柏騰            ,125000,259000,-134000,0,0,0,0,0,0,0,0,0,0,0,0,0,-134000
052095,彩晶元大97購01  ,0,0,0,0,0,0,0,0,0,-134000,0,0,0,0,134000,-134000,-134000
05669P,嘉晶永豐96售03  ,0,0,0,0,0,0,0,0,0,-134000,0,0,0,98000,232000,-134000,-134000
053402,A50正2群益9A購02,0,0,0,0,0,0,0,0,0,-134000,0,0,0,0,134000,-134000,-134000
1609,大亞            ,528000,543000,-15000,0,0,0,2000,0,2000,-122000,0,122000,-122000,0,0,0,-135000
059079,SGBR2X元大99購01,0,0,0,0,0,0,0,0,0,-135000,0,0,0,0,135000,-135000,-135000
058609,玉山金元大99購01,0,0,0,0,0,0,0,0,0,-135000,0,0,0,14000,149000,-135000,-135000
058687,聯茂凱基9A購01  ,0,0,0,0,0,0,0,0,0,-135000,0,0,0,30000,165000,-135000,-135000
052483,超眾群益95購03  ,0,0,0,0,0,0,0,0,0,-135000,0,0,0,60000,195000,-135000,-135000
052832,益航群益96購01  ,0,0,0,0,0,0,0,0,0,-135000,0,0,0,10000,145000,-135000,-135000
053405,台達電兆豐96購01,0,0,0,0,0,0,0,0,0,-135000,0,0,0,38000,173000,-135000,-135000
3044,健鼎            ,1808000,1854063,-46063,0,0,0,0,0,0,-89000,30000,133000,-103000,21000,7000,14000,-135063
3703,欣陸            ,136000,272000,-136000,0,0,0,0,0,0,0,0,0,0,0,0,0,-136000
2359,所羅門          ,132000,268000,-136000,0,0,0,0,0,0,0,0,0,0,0,0,0,-136000
1537,廣隆            ,25000,146000,-121000,0,0,0,0,0,0,-15000,0,15000,-15000,0,0,0,-136000
2108,南帝            ,105000,241000,-136000,0,0,0,0,0,0,0,0,0,0,0,0,0,-136000
059274,國巨元大99購22  ,0,0,0,0,0,0,0,0,0,-136000,0,0,0,0,136000,-136000,-136000
05169P,玉晶光元大95售03,0,0,0,0,0,0,0,0,0,-136000,0,0,0,139000,275000,-136000,-136000
057142,力成兆豐98購01  ,0,0,0,0,0,0,0,0,0,-136000,0,0,0,0,136000,-136000,-136000
8497,格威傳媒        ,5000,141000,-136000,0,0,0,0,0,0,0,0,0,0,0,0,0,-136000
058838,國巨中信99購03  ,0,0,0,0,0,0,0,0,0,-137000,0,0,0,73000,210000,-137000,-137000
057158,義隆永豐99購01  ,0,0,0,0,0,0,0,0,0,-137000,0,0,0,95000,232000,-137000,-137000
058109,台灣50元富9B購01,0,0,0,0,0,0,0,0,0,-137000,0,0,0,0,137000,-137000,-137000
055582,亞德客元大97購01,0,0,0,0,0,0,0,0,0,-137000,0,0,0,0,137000,-137000,-137000
058520,智易元大99購03  ,0,0,0,0,0,0,0,0,0,-138000,0,0,0,123000,261000,-138000,-138000
2908,特力            ,41000,179000,-138000,0,0,0,0,0,0,0,0,0,0,0,0,0,-138000
05209P,鴻海凱基96售09  ,0,0,0,0,0,0,0,0,0,-138000,0,0,0,5000,143000,-138000,-138000
052546,友達中信98購01  ,0,0,0,0,0,0,0,0,0,-138000,0,0,0,115000,253000,-138000,-138000
057598,鴻海群益98購07  ,0,0,0,0,0,0,0,0,0,-138000,0,0,0,0,138000,-138000,-138000
07193P,聯發科元大99售24,0,0,0,0,0,0,0,0,0,-139000,0,0,0,0,139000,-139000,-139000
00638R,元大滬深300反1  ,383000,10000,373000,0,0,0,0,0,0,-512000,400000,0,400000,1805000,2717000,-912000,-139000
6592,和潤企業        ,151000,290500,-139500,0,0,0,0,0,0,0,0,0,0,0,0,0,-139500
058514,潤泰全元大99購01,0,0,0,0,0,0,0,0,0,-140000,0,0,0,126000,266000,-140000,-140000
047024,奇力新元大95購01,0,0,0,0,0,0,0,0,0,-140000,0,0,0,10000,150000,-140000,-140000
050399,潤泰全中信95購01,0,0,0,0,0,0,0,0,0,-140000,0,0,0,0,140000,-140000,-140000
052083,S&P反1元大97購02,0,0,0,0,0,0,0,0,0,-140000,0,0,0,0,140000,-140000,-140000
054947,興勤元大97購01  ,0,0,0,0,0,0,0,0,0,-140000,0,0,0,0,140000,-140000,-140000
057863,美律凱基9A購01  ,0,0,0,0,0,0,0,0,0,-140000,0,0,0,10000,150000,-140000,-140000
057342,玉晶光台新98購01,0,0,0,0,0,0,0,0,0,-140000,0,0,0,10000,150000,-140000,-140000
4958,臻鼎-KY         ,4299147,4729795,-430648,0,0,0,879000,314000,565000,-275000,240000,406000,-166000,36000,145000,-109000,-140648
2328,廣宇            ,425000,642000,-217000,0,0,0,0,0,0,75000,110000,65000,45000,30000,0,30000,-142000
1315,達新            ,108000,275000,-167000,0,0,0,0,0,0,25000,27000,2000,25000,0,0,0,-142000
058988,大立光凱基9A購02,0,0,0,0,0,0,0,0,0,-142000,0,0,0,0,142000,-142000,-142000
05929P,宏達電康和96售01,0,0,0,0,0,0,0,0,0,-142000,0,0,0,0,142000,-142000,-142000
050823,信邦凱基95購01  ,0,0,0,0,0,0,0,0,0,-142000,0,0,0,0,142000,-142000,-142000
053204,旺宏麥證96購01  ,0,0,0,0,142000,-142000,0,0,0,-142000,0,0,0,0,142000,-142000,-142000
4306,炎洲            ,131000,267000,-136000,0,0,0,0,0,0,-7000,12000,19000,-7000,0,0,0,-143000
3028,增你強          ,46000,182000,-136000,0,0,0,0,0,0,-7000,1000,8000,-7000,0,0,0,-143000
054229,超眾元富96購05  ,0,0,0,0,0,0,0,0,0,-143000,0,0,0,116000,259000,-143000,-143000
04794P,友達元大96售03  ,0,0,0,0,0,0,0,0,0,-144000,0,0,0,54000,198000,-144000,-144000
054593,滬深2X永昌9A購01,0,0,0,0,0,0,0,0,0,-144000,0,0,0,0,144000,-144000,-144000
06587P,國巨元大98售13  ,0,0,0,0,0,0,0,0,0,-145000,0,0,0,10000,155000,-145000,-145000
05255P,義隆凱基95售01  ,0,0,0,0,0,0,0,0,0,-145000,0,0,0,40000,185000,-145000,-145000
055657,超眾元富97購02  ,0,0,0,0,0,0,0,0,0,-145000,0,0,0,98000,243000,-145000,-145000
057303,喬山兆豐99購01  ,0,0,0,0,0,0,0,0,0,-145000,0,0,0,110000,255000,-145000,-145000
055425,聚陽群益99購01  ,0,0,0,0,0,0,0,0,0,-145000,0,0,0,0,145000,-145000,-145000
5203,訊連            ,511000,625000,-114000,0,0,0,0,0,0,-32000,0,9000,-9000,8000,31000,-23000,-146000
1442,名軒            ,29000,175000,-146000,0,0,0,0,0,0,0,0,0,0,0,0,0,-146000
057378,康友元大98購02  ,0,0,0,0,0,0,0,0,0,-146000,0,0,0,20000,166000,-146000,-146000
058051,同欣電元大98購03,0,0,0,0,0,0,0,0,0,-146000,0,0,0,10000,156000,-146000,-146000
3533,嘉澤            ,422512,878000,-455488,0,0,0,367000,34000,333000,-24000,19000,36000,-17000,4000,11000,-7000,-146488
1309,台達化          ,85000,224000,-139000,0,0,0,0,0,0,-8000,0,8000,-8000,0,0,0,-147000
1734,杏輝            ,64000,211000,-147000,0,0,0,0,0,0,0,0,0,0,0,0,0,-147000
050774,健策元大96購02  ,0,0,0,0,0,0,0,0,0,-147000,0,0,0,20000,167000,-147000,-147000
058067,台積電第一9C購01,0,0,0,0,0,0,0,0,0,-147000,0,0,0,0,147000,-147000,-147000
055763,鎧勝群益97購01  ,0,0,0,0,0,0,0,0,0,-147000,0,0,0,219000,366000,-147000,-147000
05401P,聯茂永豐95售03  ,0,0,0,0,0,0,0,0,0,-148000,0,0,0,28000,176000,-148000,-148000
3583,辛耘            ,87000,236000,-149000,0,0,0,0,0,0,0,0,0,0,0,0,0,-149000
059151,臺股指國票99購14,0,0,0,0,0,0,0,0,0,-149000,0,0,0,304000,453000,-149000,-149000
056653,元石油元大98購01,0,0,0,0,0,0,0,0,0,-149000,0,0,0,0,149000,-149000,-149000
046999,康控富邦99購01  ,0,0,0,0,0,0,0,0,0,-149000,0,0,0,0,149000,-149000,-149000
059094,臻鼎元大99購03  ,0,0,0,0,0,0,0,0,0,-150000,0,0,0,110000,260000,-150000,-150000
058516,健鼎元大99購02  ,0,0,0,0,0,0,0,0,0,-150000,0,0,0,10000,160000,-150000,-150000
058417,國巨麥證99購01  ,0,0,0,0,150000,-150000,0,0,0,-150000,0,0,0,0,150000,-150000,-150000
3031,佰鴻            ,119000,269000,-150000,0,0,0,0,0,0,0,0,0,0,0,0,0,-150000
07014P,華通元大99售04  ,0,0,0,0,0,0,0,0,0,-150000,0,0,0,41000,191000,-150000,-150000
050788,台郡國泰96購01  ,0,0,0,0,0,0,0,0,0,-150000,0,0,0,30000,180000,-150000,-150000
051505,台積電元富95購05,0,0,0,0,0,0,0,0,0,-150000,0,0,0,0,150000,-150000,-150000
053565,台光電富邦98購01,0,0,0,0,0,0,0,0,0,-150000,0,0,0,0,150000,-150000,-150000
053834,卜蜂永豐96購01  ,0,0,0,0,0,0,0,0,0,-150000,0,0,0,0,150000,-150000,-150000
054910,信錦凱基97購01  ,0,0,0,0,0,0,0,0,0,-150000,0,0,0,0,150000,-150000,-150000
054544,統一中信97購01  ,0,0,0,0,0,0,0,0,0,-150000,0,0,0,0,150000,-150000,-150000
056261,台積電統一97購07,0,0,0,0,0,0,0,0,0,-150000,0,0,0,0,150000,-150000,-150000
056135,緯創元大98購01  ,0,0,0,0,0,0,0,0,0,-150000,0,0,0,0,150000,-150000,-150000
055965,泰鼎元大97購03  ,0,0,0,0,0,0,0,0,0,-150000,0,0,0,183000,333000,-150000,-150000
055950,華新元大97購02  ,0,0,0,0,0,0,0,0,0,-150000,0,0,0,0,150000,-150000,-150000
056072,群創元大97購01  ,0,0,0,0,0,0,0,0,0,-150000,0,0,0,0,150000,-150000,-150000
3443,創意            ,580000,341000,239000,0,0,0,1000,0,1000,-391000,4000,377000,-373000,4000,22000,-18000,-151000
056540,聯詠凱基98購02  ,0,0,0,0,0,0,0,0,0,-151000,0,0,0,90000,241000,-151000,-151000
048911,玉晶光富邦96購01,0,0,0,0,0,0,0,0,0,-151000,0,0,0,15000,166000,-151000,-151000
057013,聯發科麥證98購01,0,0,0,20000,1261000,-1241000,0,0,0,-151000,0,0,0,1110000,1261000,-151000,-151000
058089,聯發科元大98購15,0,0,0,0,0,0,0,0,0,-151000,0,0,0,170000,321000,-151000,-151000
07082P,美律元大99售06  ,0,0,0,0,0,0,0,0,0,-152000,0,0,0,5000,157000,-152000,-152000
2228,劍麟            ,68000,211000,-143000,0,0,0,0,10000,-10000,0,0,0,0,0,0,0,-153000
1806,冠軍            ,37000,181000,-144000,0,0,0,0,0,0,-10000,0,10000,-10000,0,0,0,-154000
1103,嘉泥            ,849000,828000,21000,0,0,0,0,0,0,-175000,48000,223000,-175000,0,0,0,-154000
05305P,華新科國泰97售01,0,0,0,0,0,0,0,0,0,-154000,0,0,0,15000,169000,-154000,-154000
046570,旺宏國泰94購01  ,0,0,0,0,0,0,0,0,0,-155000,0,0,0,0,155000,-155000,-155000
04593P,台積電元大94售11,0,0,0,0,0,0,0,0,0,-155000,0,0,0,0,155000,-155000,-155000
057725,台達電國泰9A購01,0,0,0,0,0,0,0,0,0,-155000,0,0,0,10000,165000,-155000,-155000
1558,伸興            ,12000,151000,-139000,0,0,0,0,0,0,-17000,0,17000,-17000,0,0,0,-156000
07196P,大立光元大99售13,0,0,0,0,0,0,0,0,0,-156000,0,0,0,6000,162000,-156000,-156000
6197,佳必琪          ,185000,341000,-156000,0,0,0,0,0,0,0,4000,4000,0,0,0,0,-156000
03671C,元油2X元大03牛01,0,0,0,0,0,0,0,0,0,-156000,0,0,0,25000,181000,-156000,-156000
05461P,台積電亞東97售01,0,0,0,0,0,0,0,0,0,-156000,0,0,0,869000,1025000,-156000,-156000
2383,台光電          ,1105000,1245000,-140000,0,0,0,0,0,0,-17000,181000,235000,-54000,44000,7000,37000,-157000
058310,大立光元大99購10,0,0,0,0,0,0,0,0,0,-157000,0,0,0,305000,462000,-157000,-157000
052146,泰碩群益95購01  ,0,0,0,0,0,0,0,0,0,-157000,0,0,0,120000,277000,-157000,-157000
3530,晶相光          ,438000,568000,-130000,0,0,0,0,0,0,-28000,0,1000,-1000,2000,29000,-27000,-158000
1733,五鼎            ,39000,200000,-161000,0,0,0,0,0,0,3000,4000,1000,3000,0,0,0,-158000
057315,台灣50康和9A購03,0,0,0,0,0,0,0,0,0,-158000,0,0,0,0,158000,-158000,-158000
3010,華立            ,60000,219000,-159000,0,0,0,0,0,0,0,0,0,0,0,0,0,-159000
06662P,玉晶光中信9A售01,0,0,0,0,0,0,0,0,0,-159000,0,0,0,30000,189000,-159000,-159000
04837P,華新科元大94售05,0,0,0,0,0,0,0,0,0,-159000,0,0,0,18000,177000,-159000,-159000
059232,台灣50凱基03購01,0,0,0,0,0,0,0,0,0,-160000,0,0,0,0,160000,-160000,-160000
2348,海悅            ,49000,161000,-112000,0,0,0,0,0,0,-48000,0,48000,-48000,0,0,0,-160000
6277,宏正            ,18000,165000,-147000,0,0,0,0,0,0,-13000,0,13000,-13000,0,0,0,-160000
047780,友達中信96購01  ,0,0,0,0,0,0,0,0,0,-160000,0,0,0,0,160000,-160000,-160000
046145,矽力元富95購01  ,0,0,0,0,0,0,0,0,0,-160000,0,0,0,0,160000,-160000,-160000
048789,大立光元大95購04,0,0,0,0,0,0,0,0,0,-160000,0,0,0,0,160000,-160000,-160000
04476P,玉晶光元大94售05,0,0,0,0,0,0,0,0,0,-160000,0,0,0,160000,320000,-160000,-160000
056580,泰鼎元大9A購01  ,0,0,0,0,0,0,0,0,0,-160000,0,0,0,148000,308000,-160000,-160000
056757,T50反1元大98購07,0,0,0,0,0,0,0,0,0,-160000,0,0,0,0,160000,-160000,-160000
057527,億光元大98購01  ,0,0,0,0,0,0,0,0,0,-160000,0,0,0,0,160000,-160000,-160000
054960,新日興元大97購02,0,0,0,0,0,0,0,0,0,-160000,0,0,0,1000,161000,-160000,-160000
06007P,世芯永豐96售01  ,0,0,0,0,0,0,0,0,0,-161000,0,0,0,43000,204000,-161000,-161000
04894P,世紀鋼元大94售02,0,0,0,0,0,0,0,0,0,-161000,0,0,0,51000,212000,-161000,-161000
057239,貿聯凱基98購05  ,0,0,0,0,0,0,0,0,0,-161000,0,0,0,36000,197000,-161000,-161000
059002,聯發科元大99購18,0,0,0,0,0,0,0,0,0,-162000,0,0,0,383000,545000,-162000,-162000
07133P,臺股指元大9A售27,0,0,0,0,0,0,0,0,0,-162000,0,0,0,7000,169000,-162000,-162000
048186,元黃金元大96購01,0,0,0,0,0,0,0,0,0,-162000,0,0,0,0,162000,-162000,-162000
056910,超眾元大99購02  ,0,0,0,0,0,0,0,0,0,-162000,0,0,0,40000,202000,-162000,-162000
07119P,台積電凱基9A售08,0,0,0,0,0,0,0,0,0,-163000,0,0,0,112000,275000,-163000,-163000
058398,中環元大99購02  ,0,0,0,0,0,0,0,0,0,-163000,0,0,0,1000,164000,-163000,-163000
052042,台積電日盛95購02,0,0,0,0,0,0,0,0,0,-163000,0,0,0,155000,318000,-163000,-163000
055703,緯穎富邦98購01  ,0,0,0,0,0,0,0,0,0,-163000,0,0,0,251000,414000,-163000,-163000
05444P,大立光元大95售10,0,0,0,0,0,0,0,0,0,-163000,0,0,0,86000,249000,-163000,-163000
059170,康控凱基9B購01  ,0,0,0,0,0,0,0,0,0,-164000,0,0,0,0,164000,-164000,-164000
07176P,臺股指凱基99售18,0,0,0,0,0,0,0,0,0,-164000,0,0,0,0,164000,-164000,-164000
057074,立積永豐98購01  ,0,0,0,0,0,0,0,0,0,-164000,0,0,0,22000,186000,-164000,-164000
05359P,嘉澤元大95售02  ,0,0,0,0,0,0,0,0,0,-164000,0,0,0,27000,191000,-164000,-164000
6168,宏齊            ,25000,170000,-145000,0,0,0,0,0,0,-20000,0,20000,-20000,0,0,0,-165000
058524,超眾元大99購04  ,0,0,0,0,0,0,0,0,0,-165000,0,0,0,37000,202000,-165000,-165000
058981,國巨凱基99購10  ,0,0,0,0,0,0,0,0,0,-165000,0,0,0,85000,250000,-165000,-165000
052223,聯電凱基96購02  ,0,0,0,0,0,0,0,0,0,-165000,0,0,0,0,165000,-165000,-165000
053954,貿聯康和96購01  ,0,0,0,0,0,0,0,0,0,-165000,0,0,0,0,165000,-165000,-165000
055660,台光電兆豐97購01,0,0,0,0,0,0,0,0,0,-165000,0,0,0,0,165000,-165000,-165000
059032,元石油群益9C購03,0,0,0,0,0,0,0,0,0,-166000,0,0,0,50000,216000,-166000,-166000
2913,農林            ,215000,349000,-134000,0,0,0,0,0,0,-33000,0,33000,-33000,0,0,0,-167000
055710,亞德客元大97購03,0,0,0,0,0,0,0,0,0,-167000,0,0,0,10000,177000,-167000,-167000
056618,京元電永豐98購01,0,0,0,0,0,0,0,0,0,-168000,0,0,0,46000,214000,-168000,-168000
053760,牧德國泰98購01  ,0,0,0,0,0,0,0,0,0,-168000,0,0,0,232000,400000,-168000,-168000
058617,南電元大99購01  ,0,0,0,0,0,0,0,0,0,-169000,0,0,0,0,169000,-169000,-169000
06134P,緯穎元富97售03  ,0,0,0,0,0,0,0,0,0,-169000,0,0,0,0,169000,-169000,-169000
05484P,台積電凱基95售18,0,0,0,0,0,0,0,0,0,-169000,0,0,0,996000,1165000,-169000,-169000
058698,華通元大99購05  ,0,0,0,0,0,0,0,0,0,-170000,0,0,0,0,170000,-170000,-170000
058925,旭富元富99購02  ,0,0,0,0,0,0,0,0,0,-170000,0,0,0,0,170000,-170000,-170000
4536,拓凱            ,40000,203000,-163000,0,0,0,0,7000,-7000,0,0,0,0,0,0,0,-170000
06928P,鴻海元大99售10  ,0,0,0,0,0,0,0,0,0,-170000,0,0,0,141000,311000,-170000,-170000
1531,高林股          ,33000,200000,-167000,0,0,0,0,0,0,-3000,0,3000,-3000,0,0,0,-170000
052189,玉晶光群益96購06,0,0,0,0,0,0,0,0,0,-170000,0,0,0,10000,180000,-170000,-170000
051157,華新科富邦98購01,0,0,0,0,0,0,0,0,0,-170000,0,0,0,0,170000,-170000,-170000
053466,華通元大98購01  ,0,0,0,0,0,0,0,0,0,-170000,0,0,0,0,170000,-170000,-170000
05407P,超眾凱基95售04  ,0,0,0,0,0,0,0,0,0,-170000,0,0,0,10000,180000,-170000,-170000
1809,中釉            ,162000,334000,-172000,0,0,0,0,0,0,0,0,0,0,0,0,0,-172000
6024,群益期          ,16000,188000,-172000,0,0,0,0,0,0,0,0,0,0,0,0,0,-172000
059097,世紀鋼元大99購05,0,0,0,0,0,0,0,0,0,-172000,0,0,0,46000,218000,-172000,-172000
04710P,台積電元大94售16,0,0,0,0,0,0,0,0,0,-172000,0,0,0,0,172000,-172000,-172000
054607,台積電永豐97購03,0,0,0,0,0,0,0,0,0,-172000,0,0,0,0,172000,-172000,-172000
058968,T50正2永豐99購01,0,0,0,0,0,0,0,0,0,-173000,0,0,0,35000,208000,-173000,-173000
2850,新產            ,42000,215000,-173000,0,0,0,0,0,0,0,0,0,0,0,0,0,-173000
1560,中砂            ,35000,208000,-173000,0,0,0,0,0,0,0,0,0,0,0,0,0,-173000
00681R,元大美債20反1   ,0,0,0,0,0,0,0,0,0,-173000,0,0,0,54000,227000,-173000,-173000
2010,春源            ,62000,236000,-174000,0,0,0,0,0,0,0,0,0,0,0,0,0,-174000
1473,台南            ,13000,188000,-175000,0,0,0,0,0,0,0,0,0,0,0,0,0,-175000
058905,京鼎元大99購01  ,0,0,0,0,0,0,0,0,0,-175000,0,0,0,60000,235000,-175000,-175000
058504,台積電元大99購07,0,0,0,0,0,0,0,0,0,-175000,0,0,0,15000,190000,-175000,-175000
06375P,矽力元大97售06  ,0,0,0,0,0,0,0,0,0,-175000,0,0,0,8000,183000,-175000,-175000
052114,華固中信95購01  ,0,0,0,0,0,0,0,0,0,-175000,0,0,0,25000,200000,-175000,-175000
9940,信義            ,65000,231000,-166000,0,0,0,0,0,0,-9000,0,9000,-9000,0,0,0,-175000
059134,臺股指群益99購09,0,0,0,0,0,0,0,0,0,-176000,0,0,0,1000,177000,-176000,-176000
07131P,緯穎元大99售06  ,0,0,0,0,0,0,0,0,0,-176000,0,0,0,25000,201000,-176000,-176000
055063,玉晶光永豐99購01,0,0,0,0,0,0,0,0,0,-176000,0,0,0,0,176000,-176000,-176000
4532,瑞智            ,77000,254000,-177000,0,0,0,0,0,0,0,0,0,0,0,0,0,-177000
058551,義隆永豐99購03  ,0,0,0,0,0,0,0,0,0,-177000,0,0,0,179000,356000,-177000,-177000
05170P,世芯元大95售01  ,0,0,0,0,0,0,0,0,0,-177000,0,0,0,455000,632000,-177000,-177000
056766,義隆元大98購01  ,0,0,0,0,0,0,0,0,0,-177000,0,0,0,40000,217000,-177000,-177000
00678,群益NBI生技     ,30000,248000,-218000,0,0,0,0,0,0,40800,0,0,0,78000,37200,40800,-177200
08100P,台灣50元富95售01,0,0,0,0,0,0,0,0,0,-178000,0,0,0,20000,198000,-178000,-178000
04842P,群創元大96售02  ,0,0,0,0,0,0,0,0,0,-178000,0,0,0,15000,193000,-178000,-178000
3605,宏致            ,148000,247000,-99000,0,0,0,0,0,0,-80000,0,80000,-80000,0,0,0,-179000
059183,T50反1台新03購02,0,0,0,0,0,0,0,0,0,-179000,0,0,0,0,179000,-179000,-179000
054826,復盛元大9A購01  ,0,0,0,0,0,0,0,0,0,-179000,0,0,0,0,179000,-179000,-179000
8213,志超            ,229000,329000,-100000,0,0,0,0,0,0,-79000,0,79000,-79000,0,0,0,-179000
6214,精誠            ,223000,502312,-279312,0,0,0,0,0,0,100000,142000,42000,100000,0,0,0,-179312
06993P,鴻海凱基99售05  ,0,0,0,0,0,0,0,0,0,-180000,0,0,0,175000,355000,-180000,-180000
046949,群創元大99購01  ,0,0,0,0,0,0,0,0,0,-180000,0,0,0,40000,220000,-180000,-180000
056734,國巨凱基99購01  ,0,0,0,0,0,0,0,0,0,-180000,0,0,0,10000,190000,-180000,-180000
055738,玉山金元富97購01,0,0,0,0,0,0,0,0,0,-180000,0,0,0,0,180000,-180000,-180000
055523,道瓊銀群益9A購01,0,0,0,0,0,0,0,0,0,-180000,0,0,0,0,180000,-180000,-180000
2417,圓剛            ,215000,396000,-181000,0,0,0,0,0,0,0,0,0,0,0,0,0,-181000
059132,臺股指群益99購07,0,0,0,0,0,0,0,0,0,-182000,0,0,0,142000,324000,-182000,-182000
05807P,泰鼎永豐96售03  ,0,0,0,0,0,0,0,0,0,-182000,0,0,0,4000,186000,-182000,-182000
6669,緯穎            ,703742,743214,-39472,0,0,0,88000,106000,-18000,-125000,26000,68000,-42000,0,83000,-83000,-182472
2476,鉅祥            ,31000,212000,-181000,0,0,0,0,0,0,-2000,0,2000,-2000,0,0,0,-183000
1215,卜蜂            ,182000,365000,-183000,0,0,0,0,0,0,0,0,0,0,2000,2000,0,-183000
053269,同欣電群益96購01,0,0,0,0,0,0,0,0,0,-183000,0,0,0,0,183000,-183000,-183000
05306P,泰碩國泰97售01  ,0,0,0,0,0,0,0,0,0,-184000,0,0,0,632000,816000,-184000,-184000
058791,鴻海元大99購17  ,0,0,0,0,0,0,0,0,0,-185000,0,0,0,0,185000,-185000,-185000
050540,台積電凱基94購38,0,0,0,0,0,0,0,0,0,-185000,0,0,0,15000,200000,-185000,-185000
05741P,聯發科元大96售14,0,0,0,0,0,0,0,0,0,-185000,0,0,0,89000,274000,-185000,-185000
055671,世紀鋼群益97購01,0,0,0,0,0,0,0,0,0,-185000,0,0,0,5000,190000,-185000,-185000
058198,瑞昱亞東99購01  ,0,0,0,0,0,0,0,0,0,-185000,0,0,0,0,185000,-185000,-185000
1527,鑽全            ,175000,412000,-237000,0,0,0,50000,0,50000,0,0,0,0,0,0,0,-187000
047769,大立光元大96購01,0,0,0,0,0,0,0,0,0,-187000,0,0,0,105000,292000,-187000,-187000
9103,美德醫療-DR     ,42000,229000,-187000,0,0,0,0,0,0,0,0,0,0,0,0,0,-187000
050383,超眾兆豐95購01  ,0,0,0,0,0,0,0,0,0,-188000,0,0,0,192000,380000,-188000,-188000
9924,福興            ,253000,434000,-181000,0,0,0,0,0,0,-7000,7000,14000,-7000,0,0,0,-188000
058857,元油2X日盛99購02,0,0,0,0,0,0,0,0,0,-189000,0,0,0,0,189000,-189000,-189000
4133,亞諾法          ,201000,391000,-190000,0,0,0,0,0,0,0,0,0,0,0,0,0,-190000
044864,道瓊反國票96購01,2000,194000,-192000,0,0,0,0,0,0,2000,0,0,0,7000,5000,2000,-190000
054731,S&P反1凱基98購01,0,0,0,0,0,0,0,0,0,-190000,0,0,0,35000,225000,-190000,-190000
6582,申豐            ,11000,176000,-165000,0,0,0,0,0,0,-25000,1000,26000,-25000,0,0,0,-190000
1612,宏泰            ,31000,222000,-191000,0,0,0,0,0,0,0,0,0,0,0,0,0,-191000
1902,台紙            ,77000,268000,-191000,0,0,0,0,0,0,0,0,0,0,0,0,0,-191000
08525P,台灣50凱基96售02,0,0,0,0,0,0,0,0,0,-191000,0,0,0,14000,205000,-191000,-191000
059168,奇力新凱基99購05,0,0,0,0,0,0,0,0,0,-191000,0,0,0,0,191000,-191000,-191000
06124P,超眾元大97售03  ,0,0,0,0,0,0,0,0,0,-192000,0,0,0,0,192000,-192000,-192000
05027P,南電群益95售01  ,0,0,0,0,0,0,0,0,0,-192000,0,0,0,0,192000,-192000,-192000
056919,英業達兆豐98購01,0,0,0,0,0,0,0,0,0,-192000,0,0,0,100000,292000,-192000,-192000
057884,華邦電群益98購02,0,0,0,0,0,0,0,0,0,-192000,0,0,0,60000,252000,-192000,-192000
1313,聯成            ,393000,586000,-193000,0,0,0,0,0,0,0,0,0,0,0,0,0,-193000
058090,聯發科元大98購16,0,0,0,0,0,0,0,0,0,-194000,0,0,0,234000,428000,-194000,-194000
8422,可寧衛          ,55000,235000,-180000,0,0,0,0,0,0,-14000,0,14000,-14000,0,0,0,-194000
04751P,智邦兆豐95售02  ,0,0,0,0,0,0,0,0,0,-195000,0,0,0,448000,643000,-195000,-195000
057766,矽力凱基98購03  ,0,0,0,0,0,0,0,0,0,-195000,0,0,0,5000,200000,-195000,-195000
056390,台積電富邦9B購01,0,0,0,0,0,0,0,0,0,-195000,0,0,0,0,195000,-195000,-195000
05421P,鴻海元大96售12  ,0,0,0,0,0,0,0,0,0,-196000,0,0,0,29000,225000,-196000,-196000
07041P,T50反1元大9C售01,0,0,0,0,0,0,0,0,0,-197000,0,0,0,3000,200000,-197000,-197000
2608,嘉里大榮        ,46000,231000,-185000,0,0,0,0,0,0,-12000,0,12000,-12000,0,0,0,-197000
00662,富邦NASDAQ      ,6000,5000,1000,0,0,0,0,0,0,-198000,0,0,0,0,198000,-198000,-197000
07124P,台積電元大99售21,0,0,0,0,0,0,0,0,0,-198000,0,0,0,87000,285000,-198000,-198000
053259,卜蜂群益97購01  ,0,0,0,0,0,0,0,0,0,-198000,0,0,0,0,198000,-198000,-198000
057934,華新科群益98購07,0,0,0,0,0,0,0,0,0,-198000,0,0,0,17000,215000,-198000,-198000
9927,泰銘            ,14000,142000,-128000,0,0,0,0,0,0,-70000,0,70000,-70000,0,0,0,-198000
050184,信邦元大94購01  ,0,0,0,0,0,0,0,0,0,-199000,0,0,0,0,199000,-199000,-199000
07102P,南電元大99售03  ,0,0,0,0,0,0,0,0,0,-200000,0,0,0,0,200000,-200000,-200000
1451,年興            ,17000,217000,-200000,0,0,0,0,0,0,0,0,0,0,0,0,0,-200000
2851,中再保          ,42000,241000,-199000,0,0,0,0,0,0,-1000,0,1000,-1000,0,0,0,-200000
2362,藍天            ,154000,311000,-157000,0,0,0,0,0,0,-43000,2000,35000,-33000,0,10000,-10000,-200000
059279,台灣50富邦9C購03,0,0,0,0,0,0,0,0,0,-200000,0,0,0,0,200000,-200000,-200000
058853,日月光群益99購01,0,0,0,0,0,0,0,0,0,-200000,0,0,0,0,200000,-200000,-200000
058740,T50反1日盛9B購02,0,0,0,0,0,0,0,0,0,-200000,0,0,0,0,200000,-200000,-200000
050186,京鼎元大94購01  ,0,0,0,0,0,0,0,0,0,-200000,0,0,0,0,200000,-200000,-200000
051695,元金2X中信98購01,0,0,0,0,0,0,0,0,0,-200000,0,0,0,0,200000,-200000,-200000
052561,矽創國票97購01  ,0,0,0,0,0,0,0,0,0,-200000,0,0,0,0,200000,-200000,-200000
052568,漢唐凱基96購02  ,0,0,0,0,0,0,0,0,0,-200000,0,0,0,0,200000,-200000,-200000
051940,康舒群益95購01  ,0,0,0,0,0,0,0,0,0,-200000,0,0,0,0,200000,-200000,-200000
044299,南電凱基93購02  ,0,0,0,0,0,0,0,0,0,-200000,0,0,0,0,200000,-200000,-200000
045572,元油2X元大98購01,0,0,0,0,0,0,0,0,0,-200000,0,0,0,0,200000,-200000,-200000
05293P,廣達凱基95售01  ,0,0,0,0,0,0,0,0,0,-200000,0,0,0,0,200000,-200000,-200000
053296,貿聯中信98購01  ,0,0,0,0,0,0,0,0,0,-200000,0,0,0,0,200000,-200000,-200000
054494,訊芯台新96購01  ,0,0,0,0,0,0,0,0,0,-200000,0,0,0,0,200000,-200000,-200000
054560,全新群益98購03  ,0,0,0,0,0,0,0,0,0,-200000,0,0,0,0,200000,-200000,-200000
056249,鴻海兆豐97購05  ,0,0,0,0,0,0,0,0,0,-200000,0,0,0,0,200000,-200000,-200000
056881,台灣50康和9A購01,0,0,0,0,0,0,0,0,0,-200000,0,0,0,0,200000,-200000,-200000
057007,奇力新中信98購04,0,0,0,0,0,0,0,0,0,-200000,0,0,0,0,200000,-200000,-200000
057213,華邦電群益98購01,0,0,0,0,0,0,0,0,0,-200000,0,0,0,0,200000,-200000,-200000
053577,上証2X元大96購02,0,0,0,0,0,0,0,0,0,-200000,0,0,0,0,200000,-200000,-200000
07108P,FBVIX台新99售02 ,0,0,0,0,0,0,0,0,0,-201000,0,0,0,0,201000,-201000,-201000
058196,台塑中信99購01  ,0,0,0,0,0,0,0,0,0,-201000,0,0,0,13000,214000,-201000,-201000
04792P,智邦元大94售06  ,25000,0,25000,0,0,0,0,0,0,-227000,0,0,0,45000,272000,-227000,-202000
057502,訊芯群益98購02  ,0,0,0,0,0,0,0,0,0,-202000,0,0,0,0,202000,-202000,-202000
07134P,臺股指元大9A售28,0,0,0,0,0,0,0,0,0,-203000,0,0,0,101000,304000,-203000,-203000
9802,鈺齊-KY         ,718000,646000,72000,0,0,0,0,198000,-198000,-77000,0,23000,-23000,1000,55000,-54000,-203000
06869P,金融類元大99售01,0,0,0,0,0,0,0,0,0,-204000,0,0,0,0,204000,-204000,-204000
058413,義隆兆豐99購01  ,0,0,0,0,0,0,0,0,0,-204000,0,0,0,140000,344000,-204000,-204000
051399,玉晶光台新96購01,0,0,0,0,0,0,0,0,0,-204000,0,0,0,200000,404000,-204000,-204000
055727,矽力元大97購02  ,0,0,0,0,0,0,0,0,0,-204000,0,0,0,27000,231000,-204000,-204000
058203,信邦凱基99購01  ,0,0,0,0,0,0,0,0,0,-204000,0,0,0,30000,234000,-204000,-204000
058703,台積電元大99購16,0,0,0,0,0,0,0,0,0,-205000,0,0,0,165000,370000,-205000,-205000
052216,康友元大96購01  ,0,0,0,0,0,0,0,0,0,-205000,0,0,0,18000,223000,-205000,-205000
051938,旭富群益95購01  ,0,0,0,0,0,0,0,0,0,-205000,0,0,0,0,205000,-205000,-205000
056531,佳世達凱基98購01,0,0,0,0,0,0,0,0,0,-205000,0,0,0,5000,210000,-205000,-205000
2457,飛宏            ,80000,286000,-206000,0,0,0,0,0,0,0,0,0,0,0,0,0,-206000
055771,台積電日盛97購04,0,0,0,0,0,0,0,0,0,-206000,0,0,0,173000,379000,-206000,-206000
06650P,聯發科元大98售09,0,0,0,0,0,0,0,0,0,-208000,0,0,0,213000,421000,-208000,-208000
051234,南電群益95購02  ,0,0,0,0,0,0,0,0,0,-209000,0,0,0,400000,609000,-209000,-209000
058786,元黃金元大99購01,0,0,0,0,0,0,0,0,0,-210000,0,0,0,0,210000,-210000,-210000
059090,台新金元大99購01,0,0,0,0,0,0,0,0,0,-210000,0,0,0,10000,220000,-210000,-210000
045877,友達元富95購01  ,0,0,0,0,0,0,0,0,0,-210000,0,0,0,0,210000,-210000,-210000
052771,GIS群益96購01   ,0,0,0,0,0,0,0,0,0,-210000,0,0,0,140000,350000,-210000,-210000
04717P,和大凱基94售02  ,0,0,0,0,0,0,0,0,0,-210000,0,0,0,0,210000,-210000,-210000
05271P,國巨富邦97售01  ,0,0,0,0,0,0,0,0,0,-210000,0,0,0,0,210000,-210000,-210000
06891P,緯穎富邦99售03  ,0,0,0,0,0,0,0,0,0,-211000,0,0,0,108000,319000,-211000,-211000
1709,和益            ,126000,337000,-211000,0,0,0,0,0,0,0,0,0,0,0,0,0,-211000
058043,鴻海元大98購13  ,0,0,0,0,0,0,0,0,0,-211000,0,0,0,70000,281000,-211000,-211000
058800,健策元大99購03  ,0,0,0,0,0,0,0,0,0,-212000,0,0,0,10000,222000,-212000,-212000
057814,聯發科元大98購12,0,0,0,0,0,0,0,0,0,-212000,0,0,0,686000,898000,-212000,-212000
051390,京元電兆豐95購01,0,0,0,0,0,0,0,0,0,-213000,0,0,0,6000,219000,-213000,-213000
053728,茂林凱基97購01  ,0,0,0,0,0,0,0,0,0,-214000,0,0,0,136000,350000,-214000,-214000
03672C,臺股指凱基9C牛05,0,0,0,0,0,0,0,0,0,-216000,0,0,0,0,216000,-216000,-216000
057556,智易凱基99購01  ,0,0,0,0,0,0,0,0,0,-216000,0,0,0,0,216000,-216000,-216000
06300P,緯穎元大97售04  ,0,0,0,0,0,0,0,0,0,-217000,0,0,0,231000,448000,-217000,-217000
2536,宏普            ,33000,247000,-214000,0,0,0,0,0,0,-3000,0,3000,-3000,0,0,0,-217000
03668C,臺股指元大03牛02,0,0,0,0,0,0,0,0,0,-217000,0,0,0,0,217000,-217000,-217000
1762,中化生          ,176000,395000,-219000,0,0,0,0,0,0,0,0,0,0,0,0,0,-219000
06731P,聯茂元大98售05  ,0,0,0,0,0,0,0,0,0,-219000,0,0,0,27000,246000,-219000,-219000
04618P,電子類群益94售02,0,0,0,0,0,0,0,0,0,-219000,0,0,0,41000,260000,-219000,-219000
058913,元油2X元富01購01,0,0,0,0,0,0,0,0,0,-220000,0,0,0,0,220000,-220000,-220000
1519,華城            ,98000,318000,-220000,0,0,0,0,0,0,0,0,0,0,0,0,0,-220000
047768,大立光元大95購01,0,0,0,0,0,0,0,0,0,-220000,0,0,0,20000,240000,-220000,-220000
050422,鴻海凱基96購01  ,0,0,0,0,0,0,0,0,0,-220000,0,0,0,0,220000,-220000,-220000
058169,國巨凱基9A購05  ,0,0,0,0,0,0,0,0,0,-220000,0,0,0,0,220000,-220000,-220000
2493,揚博            ,18000,239000,-221000,0,0,0,0,0,0,0,0,0,0,0,0,0,-221000
058907,健策元大99購04  ,0,0,0,0,0,0,0,0,0,-221000,0,0,0,14000,235000,-221000,-221000
058247,聯茂元大99購04  ,0,0,0,0,0,0,0,0,0,-222000,0,0,0,76000,298000,-222000,-222000
4155,訊映            ,22000,245000,-223000,0,0,0,0,0,0,0,0,0,0,0,0,0,-223000
1104,環泥            ,47000,270000,-223000,0,0,0,0,0,0,0,0,0,0,0,0,0,-223000
07145P,為升元大99售03  ,0,0,0,0,0,0,0,0,0,-223000,0,0,0,25000,248000,-223000,-223000
051845,世紀鋼富邦96購01,0,0,0,0,0,0,0,0,0,-223000,0,0,0,320000,543000,-223000,-223000
048874,玉晶光國票96購01,0,0,0,0,0,0,0,0,0,-223000,0,0,0,13000,236000,-223000,-223000
6206,飛捷            ,59000,267000,-208000,0,0,0,0,0,0,-16000,1000,17000,-16000,0,0,0,-224000
058891,元油2X元大9C購07,0,0,0,0,0,0,0,0,0,-224000,0,0,0,0,224000,-224000,-224000
06081P,深中小元大97售02,0,0,0,0,0,0,0,0,0,-224000,0,0,0,0,224000,-224000,-224000
00690,兆豐藍籌30      ,1000,0,1000,0,0,0,0,0,0,-225000,0,0,0,29000,254000,-225000,-224000
054421,臺股指元大99購03,0,0,0,0,0,0,0,0,0,-224000,0,0,0,200000,424000,-224000,-224000
06059P,泰碩元大97售02  ,0,0,0,0,0,0,0,0,0,-225000,0,0,0,145000,370000,-225000,-225000
2524,京城            ,66000,217000,-151000,0,0,0,0,0,0,-74000,0,74000,-74000,0,0,0,-225000
056160,智易凱基97購03  ,0,0,0,0,0,0,0,0,0,-225000,0,0,0,0,225000,-225000,-225000
07103P,南電元大99售04  ,0,0,0,0,0,0,0,0,0,-226000,0,0,0,2000,228000,-226000,-226000
058356,華邦電凱基99購01,0,0,0,0,0,0,0,0,0,-226000,0,0,0,2000,228000,-226000,-226000
053081,上銀元大97購02  ,0,0,0,0,0,0,0,0,0,-226000,0,0,0,14000,240000,-226000,-226000
6456,GIS-KY          ,935000,1119000,-184000,0,0,0,0,0,0,-44000,1000,36000,-35000,2000,11000,-9000,-228000
058910,泰鼎元大99購03  ,0,0,0,0,0,0,0,0,0,-230000,0,0,0,57000,287000,-230000,-230000
4960,誠美材          ,0,230000,-230000,0,0,0,0,0,0,0,0,0,0,0,0,0,-230000
00739,元大MSCI A股    ,58000,1000,57000,0,0,0,0,0,0,-287000,0,0,0,118000,405000,-287000,-230000
04728P,美律亞東94售02  ,0,0,0,0,0,0,0,0,0,-230000,0,0,0,0,230000,-230000,-230000
053960,晶技永豐96購02  ,0,0,0,0,0,0,0,0,0,-230000,0,0,0,20000,250000,-230000,-230000
9941,裕融            ,116000,230300,-114300,0,0,0,1000,79000,-78000,-38000,0,38000,-38000,0,0,0,-230300
2459,敦吉            ,11000,177000,-166000,0,0,0,0,0,0,-65000,0,65000,-65000,0,0,0,-231000
05406P,台光電凱基95售02,0,0,0,0,0,0,0,0,0,-231000,0,0,0,0,231000,-231000,-231000
06414P,矽力凱基97售03  ,0,0,0,0,0,0,0,0,0,-232000,0,0,0,121000,353000,-232000,-232000
058704,台積電元大99購17,0,0,0,0,0,0,0,0,0,-233000,0,0,0,0,233000,-233000,-233000
054020,技嘉台新97購01  ,0,0,0,0,0,0,0,0,0,-233000,0,0,0,0,233000,-233000,-233000
053352,義隆兆豐96購01  ,0,0,0,0,0,0,0,0,0,-233000,0,0,0,102000,335000,-233000,-233000
6269,台郡            ,2189000,2454000,-265000,0,0,0,241000,0,241000,-210000,68000,96000,-28000,44000,226000,-182000,-234000
6108,競國            ,99000,317000,-218000,0,0,0,0,0,0,-16000,0,16000,-16000,0,0,0,-234000
05244P,台積電元大95售17,0,0,0,0,0,0,0,0,0,-234000,0,0,0,55000,289000,-234000,-234000
053027,玉晶光富邦98購01,0,0,0,0,0,0,0,0,0,-234000,0,0,0,60000,294000,-234000,-234000
3705,永信            ,66000,285000,-219000,0,0,0,0,0,0,-16000,0,16000,-16000,0,0,0,-235000
2538,基泰            ,67000,302000,-235000,0,0,0,0,0,0,0,0,0,0,0,0,0,-235000
00663L,國泰臺灣加權正2 ,0,67000,-67000,0,0,0,0,0,0,-168000,0,0,0,423000,591000,-168000,-235000
07148P,富邦金元大99售01,0,0,0,0,0,0,0,0,0,-236000,0,0,0,90000,326000,-236000,-236000
03414B,臺股指凱基99熊01,0,0,0,0,0,0,0,0,0,-236000,0,0,0,266000,502000,-236000,-236000
2420,新巨            ,24000,236000,-212000,0,0,0,0,0,0,-25000,0,25000,-25000,0,0,0,-237000
058768,南港兆豐99購01  ,0,0,0,0,0,0,0,0,0,-237000,0,0,0,182000,419000,-237000,-237000
045055,聯發科元富98購03,0,0,0,0,0,0,0,0,0,-237000,0,0,0,0,237000,-237000,-237000
2464,盟立            ,137000,375000,-238000,0,0,0,0,0,0,0,0,0,0,0,0,0,-238000
2402,毅嘉            ,221000,459000,-238000,0,0,0,0,0,0,0,0,0,0,0,0,0,-238000
3038,全台            ,206000,297000,-91000,0,0,0,0,0,0,-148000,2000,150000,-148000,0,0,0,-239000
058991,台灣50元大03購01,0,0,0,0,0,0,0,0,0,-239000,0,0,0,45000,284000,-239000,-239000
8081,致新            ,199000,426000,-227000,0,0,0,0,0,0,-12000,0,12000,-12000,0,0,0,-239000
06538P,國巨凱基98售11  ,5000,0,5000,0,0,0,0,0,0,-245000,0,0,0,57000,302000,-245000,-240000
6112,聚碩            ,38000,189000,-151000,0,0,0,0,0,0,-89000,0,89000,-89000,0,0,0,-240000
6141,柏承            ,123000,363000,-240000,0,0,0,0,0,0,0,0,0,0,0,0,0,-240000
051989,華固元大95購02  ,0,0,0,0,0,0,0,0,0,-240000,0,0,0,30000,270000,-240000,-240000
054546,玉晶光中信9B購01,0,0,0,0,0,0,0,0,0,-240000,0,0,0,0,240000,-240000,-240000
058718,台灣50元富03購01,0,0,0,0,0,0,0,0,0,-243000,0,0,0,0,243000,-243000,-243000
057616,聯電凱基99購01  ,0,0,0,0,0,0,0,0,0,-243000,0,0,0,14000,257000,-243000,-243000
06649P,聯發科元大98售08,0,0,0,0,0,0,0,0,0,-245000,0,0,0,62000,307000,-245000,-245000
06617P,智邦元大98售03  ,0,0,0,0,0,0,0,0,0,-245000,0,0,0,231000,476000,-245000,-245000
3708,上緯投控        ,197000,170000,27000,0,0,0,0,255000,-255000,-17000,0,13000,-13000,0,4000,-4000,-245000
051393,新光金兆豐96購01,0,0,0,0,0,0,0,0,0,-245000,0,0,0,0,245000,-245000,-245000
044965,大立光中信95購01,0,0,0,0,0,0,0,0,0,-245000,0,0,0,0,245000,-245000,-245000
057197,立積台新98購01  ,0,0,0,0,0,0,0,0,0,-245000,0,0,0,340000,585000,-245000,-245000
2527,宏璟            ,22000,155000,-133000,0,0,0,0,0,0,-113000,0,113000,-113000,0,0,0,-246000
2034,允強            ,107000,351000,-244000,0,0,0,0,0,0,-2000,0,2000,-2000,0,0,0,-246000
056906,玉晶光元大9B購01,0,0,0,0,0,0,0,0,0,-246000,0,0,0,63000,309000,-246000,-246000
054563,泰碩群益99購01  ,0,0,0,0,0,0,0,0,0,-246000,0,0,0,159000,405000,-246000,-246000
058119,華新亞東99購01  ,0,0,0,0,0,0,0,0,0,-246000,0,0,0,0,246000,-246000,-246000
058282,聯茂中信99購01  ,0,0,0,0,0,0,0,0,0,-247000,0,0,0,94000,341000,-247000,-247000
5607,遠雄港          ,225000,473000,-248000,0,0,0,0,0,0,0,0,0,0,0,0,0,-248000
05142P,華新科台新95售01,0,0,0,0,0,0,0,0,0,-248000,0,0,0,62000,310000,-248000,-248000
1604,聲寶            ,206000,455000,-249000,0,0,0,0,0,0,0,0,0,0,0,0,0,-249000
052939,富邦金兆豐96購01,0,0,0,0,0,0,0,0,0,-250000,0,0,0,400000,650000,-250000,-250000
057193,力成元大98購02  ,0,0,0,0,0,0,0,0,0,-250000,0,0,0,0,250000,-250000,-250000
054810,中橡元大9A購01  ,0,0,0,0,0,0,0,0,0,-250000,0,0,0,0,250000,-250000,-250000
053090,新唐元大96購01  ,0,0,0,0,0,0,0,0,0,-250000,0,0,0,0,250000,-250000,-250000
06957P,FBVIX凱基01售01 ,0,0,0,0,0,0,0,0,0,-251000,0,0,0,1000,252000,-251000,-251000
053304,可成凱基96購03  ,0,0,0,0,0,0,0,0,0,-251000,0,0,0,259000,510000,-251000,-251000
051451,世芯元大95購03  ,0,0,0,0,0,0,0,0,0,-252000,0,0,0,157000,409000,-252000,-252000
057038,元油2X元大9B購06,0,125000,-125000,0,0,0,0,0,0,-127000,0,0,0,0,127000,-127000,-252000
054046,義隆元大96購02  ,0,0,0,0,0,0,0,0,0,-255000,0,0,0,210000,465000,-255000,-255000
2388,威盛            ,108000,363000,-255000,0,0,0,0,0,0,-1000,0,1000,-1000,0,0,0,-256000
058452,義隆永豐99購02  ,0,0,0,0,0,0,0,0,0,-259000,0,0,0,93000,352000,-259000,-259000
050044,聯詠兆豐94購02  ,0,0,0,0,0,0,0,0,0,-260000,0,0,0,0,260000,-260000,-260000
054154,智易國泰97購01  ,0,0,0,0,0,0,0,0,0,-260000,0,0,0,0,260000,-260000,-260000
050169,臺指反元大97購01,0,0,0,0,0,0,0,0,0,-261000,0,0,0,0,261000,-261000,-261000
04770P,鴻海元大94售09  ,0,0,0,0,0,0,0,0,0,-262000,0,0,0,20000,282000,-262000,-262000
2601,益航            ,419000,682000,-263000,0,0,0,0,0,0,0,0,0,0,0,0,0,-263000
053491,鴻海兆豐97購02  ,0,0,0,0,0,0,0,0,0,-263000,0,0,0,173000,436000,-263000,-263000
058052,南電元大98購02  ,0,0,0,0,0,0,0,0,0,-263000,0,0,0,10000,273000,-263000,-263000
051843,聯發科富邦99購01,0,0,0,0,0,0,0,0,0,-264000,0,0,0,0,264000,-264000,-264000
051826,智邦元大95購03  ,0,0,0,0,0,0,0,0,0,-264000,0,0,0,69000,333000,-264000,-264000
053118,大立光中信9C購01,0,0,0,0,0,0,0,0,0,-264000,0,0,0,70000,334000,-264000,-264000
055240,京元電元富97購01,0,0,0,0,0,0,0,0,0,-266000,0,0,0,0,266000,-266000,-266000
056577,玉晶光元大99購06,0,0,0,0,0,0,0,0,0,-268000,0,0,0,0,268000,-268000,-268000
04890P,台積電元大95售05,0,0,0,0,0,0,0,0,0,-269000,0,0,0,551000,820000,-269000,-269000
059010,臺股指元大99購12,0,0,0,0,0,0,0,0,0,-270000,0,0,0,0,270000,-270000,-270000
056571,燿華元大98購02  ,0,0,0,0,0,0,0,0,0,-270000,0,0,0,0,270000,-270000,-270000
055931,冠德群益97購02  ,0,0,0,0,0,0,0,0,0,-270000,0,0,0,0,270000,-270000,-270000
049706,世紀鋼元大95購02,0,0,0,0,0,0,0,0,0,-271000,0,0,0,205000,476000,-271000,-271000
053858,台達電元大96購05,0,0,0,0,0,0,0,0,0,-272000,0,0,0,27000,299000,-272000,-272000
04683P,南亞科元大94售04,0,0,0,0,0,0,0,0,0,-273000,0,0,0,0,273000,-273000,-273000
049702,台表科元大95購03,0,0,0,0,0,0,0,0,0,-274000,0,0,0,25000,299000,-274000,-274000
1217,愛之味          ,104000,379000,-275000,0,0,0,0,0,0,0,0,0,0,0,0,0,-275000
056016,鴻海群益97購06  ,0,0,0,0,0,0,0,0,0,-275000,0,0,0,310000,585000,-275000,-275000
1449,佳和            ,13000,290000,-277000,0,0,0,0,0,0,0,0,0,0,0,0,0,-277000
2467,志聖            ,91000,368000,-277000,0,0,0,0,0,0,0,0,0,0,0,0,0,-277000
059173,矽力凱基99購01  ,0,0,0,0,0,0,0,0,0,-277000,0,0,0,0,277000,-277000,-277000
2206,三陽工業        ,183000,461000,-278000,0,0,0,0,0,0,0,0,0,0,0,0,0,-278000
036630,玉山金台新99購01,0,0,0,0,0,0,0,0,0,-278000,0,0,0,13000,291000,-278000,-278000
3698,隆達            ,310000,500000,-190000,0,0,0,0,0,0,-89000,2000,91000,-89000,0,0,0,-279000
053557,聯茂凱基96購04  ,0,0,0,0,0,0,0,0,0,-279000,0,0,0,0,279000,-279000,-279000
3008,大立光          ,515113,763529,-248416,0,0,0,4300,1000,3300,-34000,2000,13000,-11000,4000,27000,-23000,-279116
053989,奇力新兆豐97購01,0,0,0,0,0,0,0,0,0,-280000,0,0,0,0,280000,-280000,-280000
054361,技嘉凱基96購01  ,0,0,0,0,0,0,0,0,0,-280000,0,0,0,0,280000,-280000,-280000
057962,超眾元大99購03  ,0,0,0,0,0,0,0,0,0,-280000,0,0,0,31000,311000,-280000,-280000
5469,瀚宇博          ,1709000,1982099,-273099,0,0,0,0,0,0,-7000,0,1000,-1000,21000,27000,-6000,-280099
057824,日月光元大98購01,0,0,0,0,0,0,0,0,0,-281000,0,0,0,19000,300000,-281000,-281000
9946,三發地產        ,6000,288000,-282000,0,0,0,0,0,0,0,0,0,0,0,0,0,-282000
2103,台橡            ,431000,577000,-146000,0,0,0,0,0,0,-138000,0,138000,-138000,0,0,0,-284000
056222,台積電凱基9A購01,0,0,0,0,0,0,0,0,0,-284000,0,0,0,0,284000,-284000,-284000
058886,元石油元大9C購03,0,0,0,0,0,0,0,0,0,-286000,0,0,0,20000,306000,-286000,-286000
2511,太子            ,283000,570000,-287000,0,0,0,0,0,0,0,0,0,0,0,0,0,-287000
058228,為升元大99購01  ,0,0,0,0,0,0,0,0,0,-287000,0,0,0,10000,297000,-287000,-287000
9917,中保科          ,91000,307000,-216000,0,0,0,0,0,0,-72000,0,72000,-72000,0,0,0,-288000
3006,晶豪科          ,312000,636000,-324000,0,0,0,0,0,0,34000,49000,46000,3000,54000,23000,31000,-290000
07210P,智邦凱基99售03  ,0,0,0,0,0,0,0,0,0,-290000,0,0,0,0,290000,-290000,-290000
058509,聯發科元大99購12,0,0,0,0,0,0,0,0,0,-294000,0,0,0,351000,645000,-294000,-294000
056217,A50正2中信99購02,0,0,0,0,0,0,0,0,0,-294000,0,0,0,0,294000,-294000,-294000
07141P,台灣50國票9A售03,0,0,0,0,0,0,0,0,0,-295000,0,0,0,20000,315000,-295000,-295000
3005,神基            ,618000,2123000,-1505000,0,0,0,0,0,0,1210000,20000,80000,-60000,1281000,11000,1270000,-295000
3413,京鼎            ,406000,408000,-2000,0,0,0,166000,445000,-279000,-14000,6000,11000,-5000,2000,11000,-9000,-295000
054933,南港元大97購01  ,0,0,0,0,0,0,0,0,0,-295000,0,0,0,15000,310000,-295000,-295000
056774,和鑫元大98購01  ,0,0,0,0,0,0,0,0,0,-296000,0,0,0,4000,300000,-296000,-296000
8926,台汽電          ,541000,634000,-93000,0,0,0,2000,0,2000,-207000,20000,227000,-207000,0,0,0,-298000
056251,聯發科兆豐97購02,0,0,0,0,0,0,0,0,0,-299000,0,0,0,0,299000,-299000,-299000
1314,中石化          ,7629000,6788450,840550,0,0,0,14000,0,14000,-1154000,313000,1402000,-1089000,72000,137000,-65000,-299450
05216P,國巨永豐95售02  ,0,0,0,0,0,0,0,0,0,-300000,0,0,0,0,300000,-300000,-300000
050230,聯發科麥證94購02,0,0,0,0,300000,-300000,0,0,0,-300000,0,0,0,0,300000,-300000,-300000
049101,聯詠國泰95購01  ,0,0,0,0,0,0,0,0,0,-300000,0,0,0,110000,410000,-300000,-300000
04762P,聯詠凱基94售03  ,0,0,0,0,0,0,0,0,0,-300000,0,0,0,0,300000,-300000,-300000
056049,奇力新國票98購01,0,0,0,0,0,0,0,0,0,-300000,0,0,0,0,300000,-300000,-300000
1310,台苯            ,568000,1145000,-577000,0,0,0,0,0,0,275000,282000,7000,275000,0,0,0,-302000
042711,台灣50國票93購01,0,0,0,0,0,0,0,0,0,-303000,0,0,0,0,303000,-303000,-303000
4942,嘉彰            ,76000,305000,-229000,0,0,0,0,0,0,-75000,0,75000,-75000,0,0,0,-304000
058982,台積電凱基99購08,0,0,0,0,0,0,0,0,0,-305000,0,0,0,1394000,1699000,-305000,-305000
056858,國巨群益99購03  ,0,0,0,0,0,0,0,0,0,-305000,0,0,0,108000,413000,-305000,-305000
07203P,T50正2凱基9C售02,0,0,0,0,0,0,0,0,0,-306000,0,0,0,0,306000,-306000,-306000
051382,玉晶光群益98購02,0,0,0,0,0,0,0,0,0,-306000,0,0,0,30000,336000,-306000,-306000
050014,國巨富邦98購01  ,0,0,0,0,0,0,0,0,0,-306000,0,0,0,35000,341000,-306000,-306000
051799,台積電永豐96購01,0,0,0,0,0,0,0,0,0,-306000,0,0,0,0,306000,-306000,-306000
2637,慧洋-KY         ,315000,594000,-279000,0,0,0,3000,0,3000,-32000,47000,74000,-27000,0,5000,-5000,-308000
056094,大立光元富97購03,0,0,0,0,0,0,0,0,0,-309000,0,0,0,0,309000,-309000,-309000
056797,台積電麥證98購01,0,0,0,0,540000,-540000,0,0,0,-310000,0,0,0,230000,540000,-310000,-310000
057024,義隆凱基99購01  ,0,0,0,0,0,0,0,0,0,-310000,0,0,0,0,310000,-310000,-310000
057822,牧德元大9A購01  ,0,0,0,0,0,0,0,0,0,-310000,0,0,0,0,310000,-310000,-310000
057312,美律麥證98購01  ,0,0,0,0,310000,-310000,0,0,0,-310000,0,0,0,0,310000,-310000,-310000
00668,國泰美國道瓊    ,0,921000,-921000,0,0,0,0,0,0,610000,0,0,0,1059000,449000,610000,-311000
2352,佳世達          ,1687000,1812000,-125000,0,0,0,8000,0,8000,-195000,22000,232000,-210000,34000,19000,15000,-312000
059044,聯電日盛99購02  ,0,0,0,0,0,0,0,0,0,-312000,0,0,0,0,312000,-312000,-312000
052354,健策群益96購02  ,0,0,0,0,0,0,0,0,0,-313000,0,0,0,0,313000,-313000,-313000
1305,華夏            ,806000,599445,206555,0,0,0,0,520000,-520000,0,3000,3000,0,0,0,0,-313445
06656P,GIS元大98售02   ,0,0,0,0,0,0,0,0,0,-314000,0,0,0,15000,329000,-314000,-314000
059011,臺股指元大9A購30,13000,0,13000,0,0,0,0,0,0,-329000,0,0,0,537000,866000,-329000,-316000
2499,東貝            ,318000,635000,-317000,0,0,0,0,0,0,1000,1000,0,1000,0,0,0,-316000
059127,國巨中信99購04  ,0,0,0,0,0,0,0,0,0,-317000,0,0,0,80000,397000,-317000,-317000
049383,健策元大95購01  ,0,0,0,0,0,0,0,0,0,-317000,0,0,0,30000,347000,-317000,-317000
058945,S&P正2群益9C購01,0,0,0,0,0,0,0,0,0,-318000,0,0,0,0,318000,-318000,-318000
056572,義隆元大99購01  ,0,0,0,0,0,0,0,0,0,-318000,0,0,0,10000,328000,-318000,-318000
2331,精英            ,119000,488000,-369000,0,0,0,0,0,0,50000,80000,30000,50000,0,0,0,-319000
6189,豐藝            ,58000,201000,-143000,0,0,0,0,0,0,-176000,1000,177000,-176000,0,0,0,-319000
056544,貿聯凱基98購03  ,0,0,0,0,0,0,0,0,0,-319000,0,0,0,12000,331000,-319000,-319000
5534,長虹            ,139000,310000,-171000,0,0,0,0,0,0,-150000,2000,152000,-150000,0,0,0,-321000
059015,華通元富99購02  ,0,0,0,0,0,0,0,0,0,-321000,0,0,0,67000,388000,-321000,-321000
057009,信邦中信99購01  ,0,0,0,0,0,0,0,0,0,-321000,0,0,0,0,321000,-321000,-321000
2049,上銀            ,1411525,1593060,-181535,0,0,0,95000,70000,25000,-165000,167000,260000,-93000,7000,79000,-72000,-321535
1723,中碳            ,55000,366000,-311000,0,0,0,0,0,0,-11000,0,11000,-11000,0,0,0,-322000
00653L,富邦印度正2     ,0,1000,-1000,0,0,0,0,0,0,-321000,0,0,0,386000,707000,-321000,-322000
6412,群電            ,680000,956000,-276000,0,0,0,1000,0,1000,-47000,0,47000,-47000,0,0,0,-322000
047418,智邦富邦97購01  ,0,0,0,0,0,0,0,0,0,-323000,0,0,0,342000,665000,-323000,-323000
053653,京元電凱基96購02,0,0,0,0,0,0,0,0,0,-325000,0,0,0,20000,345000,-325000,-325000
9943,好樂迪          ,47000,372000,-325000,0,0,0,0,0,0,0,0,0,0,0,0,0,-325000
5519,隆大            ,47000,215000,-168000,0,0,0,0,0,0,-158000,0,158000,-158000,0,0,0,-326000
056196,聯茂富邦98購02  ,10000,0,10000,0,0,0,0,0,0,-338000,0,0,0,0,338000,-338000,-328000
058646,聯茂富邦9A購01  ,0,0,0,0,0,0,0,0,0,-329000,0,0,0,0,329000,-329000,-329000
059207,臺指反元大9C購02,0,1000,-1000,0,0,0,0,0,0,-328000,0,0,0,1000,329000,-328000,-329000
059061,晶技凱基9A購01  ,0,0,0,0,0,0,0,0,0,-330000,0,0,0,100000,430000,-330000,-330000
051325,台光電台新96購01,0,0,0,0,0,0,0,0,0,-330000,0,0,0,0,330000,-330000,-330000
056942,昇陽半元富98購01,0,0,0,0,0,0,0,0,0,-330000,0,0,0,0,330000,-330000,-330000
054293,健策元大98購02  ,0,0,0,0,0,0,0,0,0,-330000,0,0,0,215000,545000,-330000,-330000
054808,東元元大9A購01  ,0,0,0,0,0,0,0,0,0,-330000,0,0,0,120000,450000,-330000,-330000
1905,華紙            ,162000,496000,-334000,0,0,0,0,0,0,0,0,0,0,0,0,0,-334000
1218,泰山            ,115000,449000,-334000,0,0,0,0,0,0,0,0,0,0,0,0,0,-334000
051450,世芯元大95購02  ,0,0,0,0,0,0,0,0,0,-336000,0,0,0,100000,436000,-336000,-336000
057530,奇鋐元大99購01  ,0,0,0,0,0,0,0,0,0,-338000,0,0,0,30000,368000,-338000,-338000
3019,亞光            ,712000,907000,-195000,0,0,0,0,0,0,-145000,67000,170000,-103000,56000,98000,-42000,-340000
04713P,創意元大95售01  ,0,0,0,0,0,0,0,0,0,-340000,0,0,0,0,340000,-340000,-340000
057114,台虹群益98購01  ,0,0,0,0,0,0,0,0,0,-340000,0,0,0,10000,350000,-340000,-340000
057548,微星凱基99購01  ,0,0,0,0,0,0,0,0,0,-340000,0,0,0,0,340000,-340000,-340000
2504,國產            ,1610000,3114000,-1504000,0,0,0,1000000,0,1000000,163000,0,0,0,169000,6000,163000,-341000
2406,國碩            ,92000,432643,-340643,0,0,0,0,0,0,-1000,0,1000,-1000,0,0,0,-341643
051774,聯茂中信96購01  ,0,0,0,0,0,0,0,0,0,-342000,0,0,0,310000,652000,-342000,-342000
06337P,祥碩元大97售05  ,0,0,0,0,0,0,0,0,0,-343000,0,0,0,320000,663000,-343000,-343000
054932,台肥元大97購01  ,0,0,0,0,0,0,0,0,0,-343000,0,0,0,37000,380000,-343000,-343000
057919,技嘉凱基98購03  ,0,0,0,0,0,0,0,0,0,-345000,0,0,0,0,345000,-345000,-345000
05246P,南電元大95售04  ,0,0,0,0,0,0,0,0,0,-346000,0,0,0,73000,419000,-346000,-346000
053123,京元電凱基96購01,0,0,0,0,0,0,0,0,0,-346000,0,0,0,0,346000,-346000,-346000
059091,中信金元大99購01,0,0,0,0,0,0,0,0,0,-347000,0,0,0,15000,362000,-347000,-347000
058950,國巨群益99購06  ,0,0,0,0,0,0,0,0,0,-347000,0,0,0,74000,421000,-347000,-347000
06890P,金融類元大98售02,0,0,0,0,0,0,0,0,0,-347000,0,0,0,153000,500000,-347000,-347000
048179,臻鼎富邦97購01  ,0,0,0,0,0,0,0,0,0,-347000,0,0,0,0,347000,-347000,-347000
2351,順德            ,122000,202000,-80000,0,0,0,0,42000,-42000,-227000,0,227000,-227000,0,0,0,-349000
056334,台積電凱基98購06,0,0,0,0,0,0,0,0,0,-349000,0,0,0,45000,394000,-349000,-349000
9938,百和            ,353000,610000,-257000,0,0,0,20000,29000,-9000,-83000,11000,60000,-49000,110000,144000,-34000,-349000
056758,元石油元大98購02,0,0,0,0,0,0,0,0,0,-350000,0,0,0,0,350000,-350000,-350000
052800,國巨元大96購05  ,0,0,0,0,0,0,0,0,0,-350000,0,0,0,0,350000,-350000,-350000
052750,臺股指元大96購04,0,0,0,0,0,0,0,0,0,-350000,0,0,0,0,350000,-350000,-350000
053228,康友台新97購01  ,0,0,0,0,0,0,0,0,0,-350000,0,0,0,0,350000,-350000,-350000
2607,榮運            ,129000,480000,-351000,0,0,0,0,0,0,0,0,0,0,0,0,0,-351000
06550P,健策元大99售01  ,0,0,0,0,0,0,0,0,0,-351000,0,0,0,37000,388000,-351000,-351000
058419,聯發科麥證99購02,0,0,0,0,352000,-352000,0,0,0,-352000,0,0,0,0,352000,-352000,-352000
053392,致新元大96購01  ,0,0,0,0,0,0,0,0,0,-352000,0,0,0,0,352000,-352000,-352000
2905,三商            ,180000,533000,-353000,0,0,0,0,0,0,0,0,0,0,0,0,0,-353000
07166P,台灣50兆豐03售01,0,0,0,0,0,0,0,0,0,-354000,0,0,0,142000,496000,-354000,-354000
051914,健策元大96購06  ,0,0,0,0,0,0,0,0,0,-356000,0,0,0,40000,396000,-356000,-356000
052329,台積電亞東96購01,0,0,0,0,0,0,0,0,0,-357000,0,0,0,384000,741000,-357000,-357000
049784,台積電兆豐94購05,0,0,0,0,0,0,0,0,0,-357000,0,0,0,395000,752000,-357000,-357000
057171,台光電元大9B購01,0,0,0,0,0,0,0,0,0,-357000,0,0,0,73000,430000,-357000,-357000
1440,南紡            ,268000,626000,-358000,0,0,0,0,0,0,0,0,0,0,0,0,0,-358000
055353,華新科凱基98購03,0,0,0,0,0,0,0,0,0,-358000,0,0,0,42000,400000,-358000,-358000
057236,聯詠凱基98購03  ,0,0,0,0,0,0,0,0,0,-359000,0,0,0,0,359000,-359000,-359000
05565P,鎧勝元大96售01  ,0,0,0,0,0,0,0,0,0,-359000,0,0,0,0,359000,-359000,-359000
9921,巨大            ,1049000,1546000,-497000,0,0,0,143000,4000,139000,-1000,0,1000,-1000,0,0,0,-359000
2820,華票            ,207000,527000,-320000,0,0,0,0,0,0,-40000,0,40000,-40000,0,0,0,-360000
051266,國巨富邦99購01  ,0,0,0,0,0,0,0,0,0,-361000,0,0,0,63000,424000,-361000,-361000
2106,建大            ,270000,605000,-335000,0,0,0,0,0,0,-28000,0,28000,-28000,0,0,0,-363000
5243,乙盛-KY         ,350000,714000,-364000,0,0,0,0,0,0,0,0,0,0,0,0,0,-364000
00655L,國泰中國A50正2  ,851000,23000,828000,0,0,0,0,0,0,-1192000,0,0,0,4010000,5202000,-1192000,-364000
054779,台塑群益98購01  ,0,0,0,0,0,0,0,0,0,-365000,0,0,0,0,365000,-365000,-365000
6271,同欣電          ,523000,1006000,-483000,0,0,0,70000,0,70000,45000,113000,230000,-117000,274000,112000,162000,-368000
00730,富邦臺灣優質高息,2000,0,2000,0,0,0,0,0,0,-371000,0,0,0,436000,807000,-371000,-369000
04471P,華通元大95售03  ,0,0,0,0,0,0,0,0,0,-370000,0,0,0,41000,411000,-370000,-370000
07074P,FBVIX凱基9A售01 ,0,0,0,0,0,0,0,0,0,-371000,0,0,0,0,371000,-371000,-371000
057265,聯詠兆豐98購01  ,0,0,0,0,0,0,0,0,0,-371000,0,0,0,570000,941000,-371000,-371000
05513P,玉山金台新96售01,0,0,0,0,0,0,0,0,0,-372000,0,0,0,71000,443000,-372000,-372000
048460,盛群凱基94購01  ,0,0,0,0,0,0,0,0,0,-373000,0,0,0,85000,458000,-373000,-373000
6504,南六            ,92000,476000,-384000,0,0,0,0,0,0,10000,10000,0,10000,0,0,0,-374000
049490,京元電元大95購02,0,0,0,0,0,0,0,0,0,-376000,0,0,0,0,376000,-376000,-376000
058599,T50反1元大99購05,0,0,0,0,0,0,0,0,0,-378000,0,0,0,0,378000,-378000,-378000
3376,新日興          ,1202000,1142000,60000,0,0,0,0,319000,-319000,-120000,39000,101000,-62000,47000,105000,-58000,-379000
3669,圓展            ,271000,650000,-379000,0,0,0,0,0,0,0,0,0,0,0,0,0,-379000
049362,國巨元大94購04  ,0,0,0,0,0,0,0,0,0,-379000,0,0,0,40000,419000,-379000,-379000
03670C,元油2X元富99牛01,0,0,0,0,0,0,0,0,0,-379000,0,0,0,17000,396000,-379000,-379000
06426P,T50正2元大9B售01,0,0,0,0,0,0,0,0,0,-382000,0,0,0,88000,470000,-382000,-382000
046630,京元電元富95購03,0,0,0,0,0,0,0,0,0,-384000,0,0,0,0,384000,-384000,-384000
059139,全新兆豐9A購01  ,0,0,0,0,0,0,0,0,0,-385000,0,0,0,0,385000,-385000,-385000
047529,嘉晶元大94購02  ,0,0,0,0,0,0,0,0,0,-386000,0,0,0,35000,421000,-386000,-386000
1536,和大            ,360000,646000,-286000,0,0,0,0,30000,-30000,-72000,44000,86000,-42000,1000,31000,-30000,-388000
052313,聯電元大98購01  ,0,0,0,0,0,0,0,0,0,-388000,0,0,0,56000,444000,-388000,-388000
2207,和泰車          ,525069,912260,-387191,0,0,0,36000,0,36000,-37000,3000,42000,-39000,2000,0,2000,-388191
1444,力麗            ,195000,584000,-389000,0,0,0,0,0,0,0,0,0,0,0,0,0,-389000
051277,聯發科中信9A購01,0,0,0,0,0,0,0,0,0,-390000,0,0,0,0,390000,-390000,-390000
045054,聯發科元富98購02,0,0,0,0,0,0,0,0,0,-391000,0,0,0,64000,455000,-391000,-391000
04812P,國巨元大95售03  ,0,0,0,0,0,0,0,0,0,-393000,0,0,0,0,393000,-393000,-393000
5434,崇越            ,202500,548000,-345500,0,0,0,0,0,0,-48000,19000,55000,-36000,0,12000,-12000,-393500
06898P,FBVIX群益9C售03 ,0,0,0,0,0,0,0,0,0,-394000,0,0,0,252000,646000,-394000,-394000
00675L,富邦臺灣加權正2 ,0,0,0,0,0,0,0,0,0,-394000,0,0,0,962000,1356000,-394000,-394000
053630,奇鋐兆豐97購01  ,0,0,0,0,0,0,0,0,0,-395000,0,0,0,26000,421000,-395000,-395000
046053,滬深2X群益94購01,0,0,0,0,0,0,0,0,0,-396000,0,0,0,0,396000,-396000,-396000
2461,光群雷          ,170000,568000,-398000,0,0,0,0,0,0,0,0,0,0,0,0,0,-398000
05011P,南電國泰96售01  ,0,0,0,0,0,0,0,0,0,-398000,0,0,0,34000,432000,-398000,-398000
9914,美利達          ,599000,771000,-172000,0,0,0,70000,239000,-169000,-57000,45000,74000,-29000,4000,32000,-28000,-398000
2436,偉詮電          ,184000,557000,-373000,0,0,0,0,0,0,-27000,0,27000,-27000,0,0,0,-400000
046187,友達凱基93購03  ,0,0,0,0,0,0,0,0,0,-400000,0,0,0,0,400000,-400000,-400000
042953,鴻海台新01購01  ,0,0,0,0,0,0,0,0,0,-400000,0,0,0,410000,810000,-400000,-400000
053323,群創群益98購07  ,0,0,0,0,0,0,0,0,0,-400000,0,0,0,0,400000,-400000,-400000
04788P,台積電永昌96售05,0,0,0,0,0,0,0,0,0,-402000,0,0,0,0,402000,-402000,-402000
06034P,世芯凱基96售03  ,0,0,0,0,0,0,0,0,0,-405000,0,0,0,78000,483000,-405000,-405000
059182,台灣50台新9B購03,0,0,0,0,0,0,0,0,0,-409000,0,0,0,50000,459000,-409000,-409000
058716,華新科台新99購02,0,0,0,0,0,0,0,0,0,-409000,0,0,0,220000,629000,-409000,-409000
055456,上銀富邦99購01  ,0,0,0,0,0,0,0,0,0,-410000,0,0,0,0,410000,-410000,-410000
053597,牧德元大99購01  ,0,0,0,0,0,0,0,0,0,-411000,0,0,0,106000,517000,-411000,-411000
056857,國巨群益99購02  ,0,0,0,0,0,0,0,0,0,-414000,0,0,0,0,414000,-414000,-414000
05564P,玉晶光元大97售02,0,0,0,0,0,0,0,0,0,-416000,0,0,0,503000,919000,-416000,-416000
3016,嘉晶            ,1782000,2148000,-366000,0,0,0,0,0,0,-51000,21000,24000,-3000,307000,355000,-48000,-417000
059215,台積電元大99購28,0,0,0,0,0,0,0,0,0,-418000,0,0,0,365000,783000,-418000,-418000
00680L,元大美債20正2   ,0,0,0,0,0,0,0,0,0,-419000,0,0,0,54000,473000,-419000,-419000
058515,健鼎元大99購01  ,0,0,0,0,0,0,0,0,0,-420000,0,0,0,0,420000,-420000,-420000
055624,聯發科富邦99購07,0,0,0,0,0,0,0,0,0,-420000,0,0,0,0,420000,-420000,-420000
054240,訊芯群益96購03  ,0,0,0,0,0,0,0,0,0,-421000,0,0,0,0,421000,-421000,-421000
053496,義隆兆豐96購02  ,0,0,0,0,0,0,0,0,0,-421000,0,0,0,142000,563000,-421000,-421000
1227,佳格            ,1599113,1857000,-257887,0,0,0,1000,0,1000,-166000,0,166000,-166000,0,0,0,-422887
6285,啟碁            ,1172000,920000,252000,0,0,0,0,0,0,-677000,45000,696000,-651000,0,26000,-26000,-425000
059233,台灣50凱基9C購02,0,0,0,0,0,0,0,0,0,-429000,0,0,0,0,429000,-429000,-429000
00830,國泰費城半導體  ,80000,301000,-221000,0,0,0,0,0,0,-208000,0,0,0,236000,444000,-208000,-429000
056494,緯創國泰99購01  ,0,0,0,0,0,0,0,0,0,-429000,0,0,0,210000,639000,-429000,-429000
058115,台光電中信99購01,0,0,0,0,0,0,0,0,0,-429000,0,0,0,186000,615000,-429000,-429000
9934,成霖            ,30000,459000,-429000,0,0,0,0,0,0,0,0,0,0,0,0,0,-429000
4414,如興            ,519000,950000,-431000,0,0,0,0,0,0,0,0,0,0,0,0,0,-431000
3036,文曄            ,234000,644000,-410000,0,0,0,3000,0,3000,-26000,42000,68000,-26000,0,0,0,-433000
3030,德律            ,136000,538000,-402000,0,0,0,0,0,0,-33000,0,33000,-33000,0,0,0,-435000
1712,興農            ,34000,469000,-435000,0,0,0,0,0,0,0,0,0,0,0,0,0,-435000
2392,正崴            ,427000,829000,-402000,0,0,0,0,0,0,-35000,45000,87000,-42000,42000,35000,7000,-437000
053145,元黃金元大96購02,0,0,0,0,0,0,0,0,0,-438000,0,0,0,0,438000,-438000,-438000
3665,貿聯-KY         ,577221,684000,-106779,0,0,0,10000,364000,-354000,15000,0,15000,-15000,43000,13000,30000,-445779
07215P,大立光凱基99售07,0,0,0,0,0,0,0,0,0,-447000,0,0,0,0,447000,-447000,-447000
1582,信錦            ,110000,540000,-430000,0,0,0,0,0,0,-18000,0,18000,-18000,0,0,0,-448000
6191,精成科          ,500000,948000,-448000,0,0,0,0,0,0,-1000,0,1000,-1000,0,0,0,-449000
6120,達運            ,709000,1088000,-379000,0,0,0,0,0,0,-71000,0,70000,-70000,0,1000,-1000,-450000
052324,康友元大96購02  ,0,0,0,0,0,0,0,0,0,-450000,0,0,0,550000,1000000,-450000,-450000
056061,國泰金元大97購02,0,0,0,0,0,0,0,0,0,-450000,0,0,0,0,450000,-450000,-450000
055270,上銀元大97購03  ,0,0,0,0,0,0,0,0,0,-450000,0,0,0,0,450000,-450000,-450000
055798,聯茂富邦98購01  ,0,0,0,0,0,0,0,0,0,-450000,0,0,0,0,450000,-450000,-450000
2614,東森            ,160000,612000,-452000,0,0,0,0,0,0,0,0,0,0,0,0,0,-452000
054195,亞泥國泰98購01  ,0,0,0,0,0,0,0,0,0,-453000,0,0,0,0,453000,-453000,-453000
058385,創意中信99購01  ,0,0,0,0,0,0,0,0,0,-454000,0,0,0,324000,778000,-454000,-454000
057380,技嘉國泰9A購01  ,0,0,0,0,0,0,0,0,0,-454000,0,0,0,41000,495000,-454000,-454000
053648,台積電凱基97購04,0,0,0,0,0,0,0,0,0,-454000,0,0,0,216000,670000,-454000,-454000
1514,亞力            ,60000,519000,-459000,0,0,0,0,0,0,0,0,0,0,0,0,0,-459000
055881,康控元富97購01  ,0,0,0,0,0,0,0,0,0,-460000,0,0,0,0,460000,-460000,-460000
049130,臺指反元大98購01,0,0,0,0,0,0,0,0,0,-461000,0,0,0,0,461000,-461000,-461000
9933,中鼎            ,559000,934000,-375000,0,0,0,0,0,0,-92000,6000,98000,-92000,0,0,0,-467000
042793,台積電台新9C購01,0,0,0,0,0,0,0,0,0,-468000,0,0,0,20000,488000,-468000,-468000
06669P,緯穎凱基98售05  ,0,0,0,0,0,0,0,0,0,-472000,0,0,0,140000,612000,-472000,-472000
05201P,玉晶光國泰97售02,0,0,0,0,0,0,0,0,0,-473000,0,0,0,21000,494000,-473000,-473000
042929,台積電中信95購02,0,0,0,0,0,0,0,0,0,-477000,0,0,0,0,477000,-477000,-477000
049150,新光金元大96購01,0,0,0,0,0,0,0,0,0,-479000,0,0,0,0,479000,-479000,-479000
053355,超眾兆豐97購01  ,0,0,0,0,0,0,0,0,0,-479000,0,0,0,188000,667000,-479000,-479000
054306,聯發科凱基96購23,0,0,0,0,0,0,0,0,0,-480000,0,0,0,50000,530000,-480000,-480000
1717,長興            ,141000,550000,-409000,0,0,0,1000,0,1000,-75000,0,75000,-75000,0,0,0,-483000
059286,S&P正2元富01購03,0,0,0,0,0,0,0,0,0,-488000,0,0,0,0,488000,-488000,-488000
053782,京元電元大98購02,0,0,0,0,0,0,0,0,0,-489000,0,0,0,15000,504000,-489000,-489000
048576,義隆國泰95購01  ,0,0,0,0,0,0,0,0,0,-491000,0,0,0,90000,581000,-491000,-491000
2722,夏都            ,12000,5000,7000,0,0,0,0,0,0,-500000,0,500000,-500000,0,0,0,-493000
051431,群創元富99購02  ,0,0,0,0,0,0,0,0,0,-493000,0,0,0,0,493000,-493000,-493000
00701,國泰股利精選30  ,102000,0,102000,0,0,0,0,0,0,-598000,0,0,0,527000,1125000,-598000,-496000
3682,亞太電          ,323000,814239,-491239,0,0,0,0,0,0,-5000,1000,6000,-5000,0,0,0,-496239
058126,元油2X元大9C購02,0,0,0,0,0,0,0,0,0,-499000,0,0,0,0,499000,-499000,-499000
2897,王道銀行        ,218000,594000,-376000,0,0,0,10000,0,10000,-134000,0,134000,-134000,0,0,0,-500000
058889,元油2X元大9C購05,0,0,0,0,0,0,0,0,0,-501000,0,0,0,47000,548000,-501000,-501000
057417,國巨凱基9A購03  ,0,0,0,0,0,0,0,0,0,-504000,0,0,0,1000,505000,-504000,-504000
2421,建準            ,994000,1437000,-443000,0,0,0,0,0,0,-62000,0,28000,-28000,0,34000,-34000,-505000
045992,鴻海富邦94購01  ,0,0,0,0,0,0,0,0,0,-505000,0,0,0,0,505000,-505000,-505000
056798,華新科麥證98購01,0,0,0,0,505000,-505000,0,0,0,-505000,0,0,0,0,505000,-505000,-505000
8464,億豐            ,515000,1014000,-499000,0,0,0,7000,5000,2000,-9000,5000,14000,-9000,0,0,0,-506000
4119,旭富            ,536033,1087000,-550967,0,0,0,1000,0,1000,43000,100000,56000,44000,20000,21000,-1000,-506967
1701,中化            ,87000,475000,-388000,0,0,0,0,0,0,-121000,0,121000,-121000,0,0,0,-509000
1789,神隆            ,937000,1449000,-512000,0,0,0,0,0,0,0,0,0,0,0,0,0,-512000
8163,達方            ,473000,1042000,-569000,0,0,0,1000,0,1000,52000,90000,12000,78000,0,26000,-26000,-516000
2369,菱生            ,355000,817000,-462000,0,0,0,0,0,0,-55000,0,55000,-55000,0,0,0,-517000
059133,臺股指群益99購08,0,0,0,0,0,0,0,0,0,-520000,0,0,0,10000,530000,-520000,-520000
056768,宏達電元大99購03,0,0,0,0,0,0,0,0,0,-520000,0,0,0,47000,567000,-520000,-520000
056349,道瓊銀元大9B購01,0,0,0,0,0,0,0,0,0,-520000,0,0,0,0,520000,-520000,-520000
048860,玉晶光群益96購03,0,0,0,0,0,0,0,0,0,-520000,0,0,0,0,520000,-520000,-520000
058135,景碩元大99購01  ,0,0,0,0,0,0,0,0,0,-521000,0,0,0,20000,541000,-521000,-521000
4934,太極            ,219000,742000,-523000,0,0,0,0,0,0,0,0,0,0,0,0,0,-523000
06889P,臺股指元大98售13,0,0,0,0,0,0,0,0,0,-524000,0,0,0,267000,791000,-524000,-524000
058908,貿聯元大99購03  ,0,0,0,0,0,0,0,0,0,-524000,0,0,0,20000,544000,-524000,-524000
049064,T50反1凱基96購03,0,0,0,0,0,0,0,0,0,-524000,0,0,0,0,524000,-524000,-524000
04878P,國巨康和94售02  ,0,0,0,0,0,0,0,0,0,-525000,0,0,0,92000,617000,-525000,-525000
056828,國巨富邦9A購03  ,0,0,0,0,0,0,0,0,0,-527000,0,0,0,2000,529000,-527000,-527000
06021P,世紀鋼元富96售03,0,0,0,0,0,0,0,0,0,-532000,0,0,0,321000,853000,-532000,-532000
06946P,T50正2元大9C售01,0,0,0,0,0,0,0,0,0,-537000,0,0,0,10000,547000,-537000,-537000
07025P,玉晶光凱基99售01,0,0,0,0,0,0,0,0,0,-543000,0,0,0,160000,703000,-543000,-543000
2101,南港            ,975000,1445000,-470000,0,0,0,0,0,0,-73000,0,93000,-93000,51000,31000,20000,-543000
059208,SGBR2X元大99購02,0,0,0,0,0,0,0,0,0,-543000,0,0,0,0,543000,-543000,-543000
03674C,臺股指元富9C牛02,0,0,0,0,0,0,0,0,0,-543000,0,0,0,267000,810000,-543000,-543000
06668P,祥碩凱基98售02  ,0,0,0,0,0,0,0,0,0,-544000,0,0,0,196000,740000,-544000,-544000
03647C,T50反1元富99牛02,0,0,0,0,0,0,0,0,0,-544000,0,0,0,0,544000,-544000,-544000
5521,工信            ,204000,750000,-546000,0,0,0,0,0,0,0,0,0,0,0,0,0,-546000
059128,友達中信99購02  ,0,0,0,0,0,0,0,0,0,-550000,0,0,0,0,550000,-550000,-550000
058914,元油2X元富01購02,0,0,0,0,0,0,0,0,0,-550000,0,0,0,0,550000,-550000,-550000
00712,FH富時不動產    ,0,2000,-2000,0,0,0,0,0,0,-548000,0,0,0,0,548000,-548000,-550000
2419,仲琦            ,112000,630000,-518000,0,0,0,0,0,0,-40000,0,40000,-40000,0,0,0,-558000
9945,潤泰新          ,2271159,2531000,-259841,0,0,0,0,0,0,-301000,9000,171000,-162000,0,139000,-139000,-560841
1319,東陽            ,422000,897000,-475000,0,0,0,0,0,0,-89000,6000,93000,-87000,0,2000,-2000,-564000
06154P,超眾元大98售01  ,0,0,0,0,0,0,0,0,0,-566000,0,0,0,39000,605000,-566000,-566000
053373,台泥元大96購01  ,0,0,0,0,0,0,0,0,0,-569000,0,0,0,10000,579000,-569000,-569000
3041,揚智            ,377000,947000,-570000,0,0,0,0,0,0,0,0,0,0,0,0,0,-570000
051397,聯茂兆豐95購03  ,0,0,0,0,0,0,0,0,0,-572000,0,0,0,130000,702000,-572000,-572000
6282,康舒            ,586000,1012000,-426000,0,0,0,0,0,0,-147000,12000,76000,-64000,0,83000,-83000,-573000
6251,定穎            ,689000,1363000,-674000,0,0,0,0,0,0,99000,101000,2000,99000,0,0,0,-575000
058612,健策元大99購02  ,0,0,0,0,0,0,0,0,0,-579000,0,0,0,20000,599000,-579000,-579000
057697,國巨群益98購09  ,0,0,0,0,0,0,0,0,0,-581000,0,0,0,0,581000,-581000,-581000
044963,台積電中信96購01,0,0,0,0,0,0,0,0,0,-582000,0,0,0,5000,587000,-582000,-582000
04613P,台積電群益94售10,0,0,0,0,0,0,0,0,0,-590000,0,0,0,0,590000,-590000,-590000
2535,達欣工          ,411000,939000,-528000,0,0,0,0,0,0,-63000,4000,67000,-63000,0,0,0,-591000
059102,聯鈞元富99購01  ,0,0,0,0,0,0,0,0,0,-592000,0,0,0,130000,722000,-592000,-592000
054804,南亞元大9A購01  ,0,0,0,0,0,0,0,0,0,-595000,0,0,0,70000,665000,-595000,-595000
9919,康那香          ,780000,1475000,-695000,0,0,0,0,0,0,100000,0,0,0,100000,0,100000,-595000
9939,宏全            ,532000,929000,-397000,0,0,0,0,0,0,-200000,42000,190000,-148000,6000,58000,-52000,-597000
058966,元油2X日盛99購03,0,0,0,0,0,0,0,0,0,-600000,0,0,0,40000,640000,-600000,-600000
046148,友達中信94購01  ,0,0,0,0,0,0,0,0,0,-602000,0,0,0,0,602000,-602000,-602000
05620P,大立光富邦9B售01,0,0,0,0,0,0,0,0,0,-605000,0,0,0,17000,622000,-605000,-605000
03840P,台積電統一99售02,0,0,0,0,0,0,0,0,0,-609000,0,0,0,0,609000,-609000,-609000
054780,中石化群益99購01,0,0,0,0,0,0,0,0,0,-610000,0,0,0,0,610000,-610000,-610000
07015P,國巨元大99售13  ,0,0,0,0,0,0,0,0,0,-611000,0,0,0,555000,1166000,-611000,-611000
053771,華新元大97購01  ,0,0,0,0,0,0,0,0,0,-615000,0,0,0,30000,645000,-615000,-615000
053900,T50反1日盛99購01,0,0,0,0,0,0,0,0,0,-619000,0,0,0,152000,771000,-619000,-619000
053383,京元電元大97購01,0,0,0,0,0,0,0,0,0,-621000,0,0,0,18000,639000,-621000,-621000
00670L,富邦NASDAQ正2   ,16000,15000,1000,0,0,0,0,0,0,-625000,0,0,0,1001000,1626000,-625000,-624000
1513,中興電          ,169000,732000,-563000,0,0,0,0,0,0,-70000,20000,90000,-70000,0,0,0,-633000
4967,十銓            ,1329000,1169000,160000,0,0,0,0,743000,-743000,-51000,8000,59000,-51000,0,0,0,-634000
05268P,玉晶光元大98售01,0,0,0,0,0,0,0,0,0,-636000,0,0,0,627000,1263000,-636000,-636000
2338,光罩            ,653000,1265000,-612000,0,0,0,0,0,0,-26000,0,14000,-14000,8000,20000,-12000,-638000
057232,京元電凱基98購02,0,0,0,0,0,0,0,0,0,-638000,0,0,0,66000,704000,-638000,-638000
058814,南亞科台新99購01,0,0,0,0,0,0,0,0,0,-639000,0,0,0,226000,865000,-639000,-639000
00737,國泰AI+Robo     ,43000,514000,-471000,0,0,0,0,0,0,-168000,0,0,0,155000,323000,-168000,-639000
00752,中信中國50      ,0,0,0,0,0,0,0,0,0,-639000,0,0,0,302000,941000,-639000,-639000
056193,聯發科富邦99購08,0,0,0,0,0,0,0,0,0,-644000,0,0,0,0,644000,-644000,-644000
1476,儒鴻            ,605500,1095000,-489500,0,0,0,1000,123760,-122760,-35003,37000,49000,-12000,1000,24003,-23003,-647263
6153,嘉聯益          ,1525000,1873940,-348940,0,0,0,0,0,0,-300000,19000,238000,-219000,6000,87000,-81000,-648940
057393,台積電中信02購01,0,0,0,0,0,0,0,0,0,-653000,0,0,0,0,653000,-653000,-653000
2836,高雄銀          ,81000,736000,-655000,0,0,0,0,0,0,-2000,0,2000,-2000,0,0,0,-657000
6005,群益證          ,1262000,1924000,-662000,0,0,0,3000,0,3000,0,0,0,0,0,0,0,-659000
8110,華東            ,212000,893000,-681000,0,0,0,0,0,0,18000,26000,8000,18000,0,0,0,-663000
2456,奇力新          ,1406000,2005422,-599422,0,0,0,140000,78000,62000,-125828,25000,71828,-46828,2000,81000,-79000,-663250
047421,聯茂富邦97購01  ,0,0,0,0,0,0,0,0,0,-664000,0,0,0,280000,944000,-664000,-664000
053376,鴻海元大96購19  ,0,0,0,0,0,0,0,0,0,-664000,0,0,0,66000,730000,-664000,-664000
3048,益登            ,74000,613000,-539000,0,0,0,0,0,0,-126000,0,126000,-126000,0,0,0,-665000
2015,豐興            ,179000,715000,-536000,0,0,0,0,0,0,-135000,5000,140000,-135000,0,0,0,-671000
056754,智易兆豐99購01  ,0,0,0,0,0,0,0,0,0,-672000,0,0,0,201000,873000,-672000,-672000
057004,滬深反中信9A購01,0,0,0,0,0,0,0,0,0,-675000,0,0,0,25000,700000,-675000,-675000
1229,聯華            ,548000,973000,-425000,0,0,0,0,5000,-5000,-247000,0,247000,-247000,0,0,0,-677000
2308,台達電          ,4512980,5032692,-519712,0,0,0,18000,0,18000,-177000,20000,287000,-267000,100000,10000,90000,-678712
054177,牧德台新97購01  ,0,0,0,0,0,0,0,0,0,-679000,0,0,0,111000,790000,-679000,-679000
06641P,智邦兆豐99售01  ,0,0,0,0,0,0,0,0,0,-680000,0,0,0,145000,825000,-680000,-680000
2615,萬海            ,1088000,1417000,-329000,0,0,0,10000,0,10000,-364000,0,364000,-364000,0,0,0,-683000
1732,毛寶            ,159000,179000,-20000,0,0,0,0,0,0,-667000,0,0,0,0,667000,-667000,-687000
3090,日電貿          ,314000,928000,-614000,0,0,0,0,0,0,-78000,1000,71000,-70000,0,8000,-8000,-692000
2385,群光            ,951096,2202071,-1250975,0,0,0,4000,2000,2000,555000,6000,26000,-20000,577000,2000,575000,-693975
058475,台積電凱基99購06,0,0,0,0,0,0,0,0,0,-694000,0,0,0,33000,727000,-694000,-694000
07120P,聯發科凱基99售09,0,0,0,0,0,0,0,0,0,-699000,0,0,0,10000,709000,-699000,-699000
057098,新光金台新98購01,0,0,0,0,0,0,0,0,0,-699000,0,0,0,0,699000,-699000,-699000
06684P,緯穎元大98售06  ,0,0,0,0,0,0,0,0,0,-709000,0,0,0,16000,725000,-709000,-709000
057813,京元電元大98購03,0,0,0,0,0,0,0,0,0,-713000,0,0,0,51000,764000,-713000,-713000
8131,福懋科          ,159000,809000,-650000,0,0,0,1000,0,1000,-72000,1000,65000,-64000,0,8000,-8000,-721000
6202,盛群            ,164000,854000,-690000,0,0,0,0,0,0,-34000,0,34000,-34000,0,0,0,-724000
2505,國揚            ,98000,809000,-711000,0,0,0,0,0,0,-15000,0,0,0,0,15000,-15000,-726000
3034,聯詠            ,2310000,3296786,-986786,0,0,0,140000,0,140000,120007,109000,112000,-3000,201000,77993,123007,-726779
2441,超豐            ,93000,731000,-638000,0,0,0,2000,0,2000,-91000,6000,97000,-91000,0,0,0,-727000
057799,世紀鋼兆豐98購01,0,0,0,0,0,0,0,0,0,-727000,0,0,0,193000,920000,-727000,-727000
05483P,國巨凱基95售07  ,0,0,0,0,0,0,0,0,0,-728000,0,0,0,69000,797000,-728000,-728000
055500,京鼎元大97購04  ,0,0,0,0,0,0,0,0,0,-730000,0,0,0,0,730000,-730000,-730000
058205,神達凱基9B購01  ,0,0,0,0,0,0,0,0,0,-730000,0,0,0,4000,734000,-730000,-730000
2363,矽統            ,707000,1443000,-736000,0,0,0,0,0,0,-1000,0,1000,-1000,0,0,0,-737000
03436B,臺股指元富99熊13,0,0,0,0,0,0,0,0,0,-738000,0,0,0,45000,783000,-738000,-738000
2855,統一證          ,236000,979000,-743000,0,0,0,0,0,0,0,0,0,0,0,0,0,-743000
051748,超眾國泰96購01  ,0,0,0,0,0,0,0,0,0,-745000,0,0,0,680000,1425000,-745000,-745000
00686R,群益臺灣加權反1 ,0,0,0,0,0,0,0,0,0,-746000,0,0,0,673000,1419000,-746000,-746000
057563,旭富國泰9A購01  ,0,0,0,0,0,0,0,0,0,-757000,0,0,0,175000,932000,-757000,-757000
055093,京鼎群益98購01  ,0,0,0,0,0,0,0,0,0,-763000,0,0,0,36000,799000,-763000,-763000
04798P,牧德元大95售02  ,0,0,0,0,0,0,0,0,0,-765000,0,0,0,30000,795000,-765000,-765000
059005,嘉晶元大99購06  ,0,0,0,0,0,0,0,0,0,-776000,0,0,0,1019000,1795000,-776000,-776000
2501,國建            ,218000,963000,-745000,0,0,0,0,0,0,-33000,0,33000,-33000,0,0,0,-778000
053590,新光金元大9A購02,0,0,0,0,0,0,0,0,0,-778000,0,0,0,1000,779000,-778000,-778000
2480,敦陽科          ,112000,836000,-724000,0,0,0,0,0,0,-55000,0,55000,-55000,0,0,0,-779000
06454P,緯穎元大98售04  ,0,0,0,0,0,0,0,0,0,-781000,0,0,0,420000,1201000,-781000,-781000
8039,台虹            ,894000,1516000,-622000,0,0,0,0,0,0,-161000,86000,48000,38000,4000,203000,-199000,-783000
5522,遠雄            ,180000,626000,-446000,0,0,0,0,0,0,-338000,0,338000,-338000,0,0,0,-784000
05089P,亞德客元大95售01,0,0,0,0,0,0,0,0,0,-789000,0,0,0,123000,912000,-789000,-789000
2023,燁輝            ,627000,1417000,-790000,0,0,0,0,0,0,0,0,0,0,0,0,0,-790000
03619C,臺股指元大95牛02,0,0,0,0,0,0,0,0,0,-791000,0,0,0,300000,1091000,-791000,-791000
1477,聚陽            ,789100,1527950,-738850,0,0,0,0,0,0,-54000,9000,98000,-89000,46000,11000,35000,-792850
06682P,玉晶光元大99售08,0,0,0,0,0,0,0,0,0,-793000,0,0,0,67000,860000,-793000,-793000
07202P,台灣50凱基9C售04,0,0,0,0,0,0,0,0,0,-794000,0,0,0,0,794000,-794000,-794000
1409,新纖            ,378000,1172000,-794000,0,0,0,0,0,0,-1000,0,1000,-1000,0,0,0,-795000
04768P,大立光國泰96售03,0,0,0,0,0,0,0,0,0,-797000,0,0,0,0,797000,-797000,-797000
048633,台達電元大94購02,0,0,0,0,0,0,0,0,0,-800000,0,0,0,0,800000,-800000,-800000
054489,牧德台新97購02  ,0,0,0,0,0,0,0,0,0,-800000,0,0,0,0,800000,-800000,-800000
2387,精元            ,678000,1139000,-461000,0,0,0,0,295000,-295000,-46000,0,0,0,2000,48000,-46000,-802000
03438B,臺股指元大96熊27,0,0,0,0,0,0,0,0,0,-805000,0,0,0,0,805000,-805000,-805000
8271,宇瞻            ,368000,1336000,-968000,0,0,0,250000,0,250000,-87000,35000,122000,-87000,0,0,0,-805000
2455,全新            ,698000,877000,-179000,0,0,0,15000,512000,-497000,-135000,68000,69000,-1000,41000,175000,-134000,-811000
2107,厚生            ,118000,805000,-687000,0,0,0,0,0,0,-124000,0,124000,-124000,0,0,0,-811000
3026,禾伸堂          ,467000,1199000,-732000,0,0,0,0,0,0,-81000,2000,17000,-15000,2000,68000,-66000,-813000
2342,茂矽            ,1055000,1809000,-754000,0,0,0,0,0,0,-60000,0,60000,-60000,0,0,0,-814000
2368,金像電          ,10595187,10053000,542187,0,0,0,1301000,0,1301000,-2658000,405000,3063000,-2658000,0,0,0,-814813
053979,健策元大98購01  ,0,0,0,0,0,0,0,0,0,-816000,0,0,0,47000,863000,-816000,-816000
1304,台聚            ,266000,914000,-648000,0,0,0,0,0,0,-169000,0,169000,-169000,0,0,0,-817000
2377,微星            ,2291090,3115000,-823910,0,0,0,3000,400000,-397000,398000,15000,100000,-85000,641000,158000,483000,-822910
07100P,華航元大99售01  ,0,0,0,0,0,0,0,0,0,-838000,0,0,0,3000,841000,-838000,-838000
059218,台積電元大99購31,0,0,0,0,0,0,0,0,0,-852000,0,0,0,1223000,2075000,-852000,-852000
05118P,超眾元大96售04  ,0,0,0,0,0,0,0,0,0,-865000,0,0,0,40000,905000,-865000,-865000
2006,東和鋼鐵        ,293000,1172000,-879000,0,0,0,174000,0,174000,-161000,5000,166000,-161000,0,0,0,-866000
3704,合勤控          ,716000,1559000,-843000,0,0,0,0,0,0,-28000,0,1000,-1000,0,27000,-27000,-871000
059012,臺股指元大9A購31,1000,0,1000,0,0,0,0,0,0,-880000,0,0,0,1032000,1912000,-880000,-879000
3563,牧德            ,507000,1078000,-571000,0,0,0,1000,286000,-285000,-31000,0,4000,-4000,7000,34000,-27000,-887000
5388,中磊            ,561000,1398000,-837000,0,0,0,0,0,0,-53000,0,48000,-48000,0,5000,-5000,-890000
00717,富邦美國特別股  ,0,0,0,0,0,0,0,0,0,-891983,0,0,0,795000,1686983,-891983,-891983
3023,信邦            ,438000,1800571,-1362571,0,0,0,496000,0,496000,-28000,72000,91000,-19000,0,9000,-9000,-894571
050645,台積電凱基94購39,0,0,0,0,0,0,0,0,0,-895000,0,0,0,189000,1084000,-895000,-895000
058094,祥碩元大98購09  ,0,0,0,0,0,0,0,0,0,-896000,0,0,0,384000,1280000,-896000,-896000
006208,富邦台50        ,12000,11000,1000,0,0,0,0,0,0,-898000,0,0,0,300000,1198000,-898000,-897000
3042,晶技            ,2228000,3104000,-876000,0,0,0,288000,0,288000,-313000,26000,86000,-60000,2000,255000,-253000,-901000
058500,元石油元大9C購01,0,0,0,0,0,0,0,0,0,-904000,0,0,0,0,904000,-904000,-904000
3035,智原            ,677000,1017000,-340000,0,0,0,0,540000,-540000,-42000,55000,118000,-63000,27000,6000,21000,-922000
057909,台光電兆豐98購01,0,0,0,0,0,0,0,0,0,-940000,0,0,0,100000,1040000,-940000,-940000
051366,康友國泰97購01  ,0,0,0,0,0,0,0,0,0,-943000,0,0,0,200000,1143000,-943000,-943000
058837,SGBR2X中信9C購01,0,0,0,0,0,0,0,0,0,-957000,0,0,0,60000,1017000,-957000,-957000
3056,總太            ,235000,1167000,-932000,0,0,0,0,0,0,-28000,29000,57000,-28000,0,0,0,-960000
2478,大毅            ,1455000,2382000,-927000,0,0,0,0,0,0,-34000,0,15000,-15000,8000,27000,-19000,-961000
057143,台郡兆豐98購01  ,0,0,0,0,0,0,0,0,0,-961000,0,0,0,300000,1261000,-961000,-961000
3014,聯陽            ,296000,1153000,-857000,0,0,0,0,0,0,-106000,1000,74000,-73000,0,33000,-33000,-963000
06652P,長榮航元大98售01,0,0,0,0,0,0,0,0,0,-964000,0,0,0,662000,1626000,-964000,-964000
00647L,元大S&P500正2   ,5000,7000,-2000,0,0,0,0,0,0,-965000,0,0,0,1031000,1996000,-965000,-967000
06852P,臺股指元大98售11,0,0,0,0,0,0,0,0,0,-968000,0,0,0,37000,1005000,-968000,-968000
057646,玉山金元大98購01,0,0,0,0,0,0,0,0,0,-971000,0,0,0,40000,1011000,-971000,-971000
059259,FBVIX中信03購06 ,0,0,0,0,0,0,0,0,0,-982000,0,0,0,0,982000,-982000,-982000
5871,中租-KY         ,6455791,7336500,-880709,0,0,0,11000,0,11000,-114000,20000,128000,-108000,18000,24000,-6000,-983709
053169,貿聯群益97購01  ,0,0,0,0,0,0,0,0,0,-998000,0,0,0,0,998000,-998000,-998000
053893,京鼎群益97購02  ,0,0,0,0,0,0,0,0,0,-998000,0,0,0,0,998000,-998000,-998000
6257,矽格            ,1071000,1794000,-723000,0,0,0,0,0,0,-290000,118000,379000,-261000,8000,37000,-29000,-1013000
2514,龍邦            ,32000,1054000,-1022000,0,0,0,0,0,0,-1000,0,1000,-1000,0,0,0,-1023000
057798,貿聯兆豐99購01  ,0,0,0,0,0,0,0,0,0,-1024000,0,0,0,50000,1074000,-1024000,-1024000
056317,華通群益99購02  ,0,0,0,0,0,0,0,0,0,-1025000,0,0,0,0,1025000,-1025000,-1025000
054860,台積電群益98購01,0,0,0,0,0,0,0,0,0,-1028000,0,0,0,0,1028000,-1028000,-1028000
055344,國巨凱基97購04  ,0,0,0,0,0,0,0,0,0,-1029000,0,0,0,62000,1091000,-1029000,-1029000
2371,大同            ,4420864,5068000,-647136,0,0,0,0,0,0,-384000,52000,436000,-384000,0,0,0,-1031136
1802,台玻            ,1188000,2137000,-949000,0,0,0,0,0,0,-97000,0,97000,-97000,0,0,0,-1046000
3450,聯鈞            ,920000,2501000,-1581000,0,0,0,604000,0,604000,-82000,12000,51000,-39000,28000,71000,-43000,-1059000
051158,嘉晶富邦96購01  ,0,0,0,0,0,0,0,0,0,-1063000,0,0,0,229000,1292000,-1063000,-1063000
8016,矽創            ,631000,1712000,-1081000,0,0,0,104000,0,104000,-97000,6000,79000,-73000,1000,25000,-24000,-1074000
1722,台肥            ,709000,1644000,-935000,0,0,0,1000,0,1000,-148000,0,148000,-148000,0,0,0,-1082000
2031,新光鋼          ,770000,568000,202000,0,0,0,0,220000,-220000,-1065000,28000,1093000,-1065000,0,0,0,-1083000
2017,官田鋼          ,30000,146000,-116000,0,0,0,0,0,0,-973000,28000,1001000,-973000,0,0,0,-1089000
052688,新日興元大96購01,0,0,0,0,0,0,0,0,0,-1095000,0,0,0,0,1095000,-1095000,-1095000
2903,遠百            ,370000,1266405,-896405,0,0,0,0,0,0,-204000,0,204000,-204000,0,0,0,-1100405
04189P,台積電兆豐94售02,0,0,0,0,0,0,0,0,0,-1106000,0,0,0,0,1106000,-1106000,-1106000
057925,貿聯凱基99購01  ,0,0,0,0,0,0,0,0,0,-1114000,0,0,0,0,1114000,-1114000,-1114000
2357,華碩            ,1524538,2794624,-1270086,0,0,0,3000,0,3000,151000,27000,91000,-64000,216000,1000,215000,-1116086
2354,鴻準            ,1807000,2752590,-945590,0,0,0,0,0,0,-175000,112000,287000,-175000,0,0,0,-1120590
056829,台積電富邦9A購01,0,0,0,0,0,0,0,0,0,-1122000,0,0,0,30000,1152000,-1122000,-1122000
2838,聯邦銀          ,439000,1243000,-804000,0,0,0,0,0,0,-319000,0,319000,-319000,0,0,0,-1123000
8021,尖點            ,237000,1254000,-1017000,0,0,0,0,0,0,-111000,0,111000,-111000,0,0,0,-1128000
2014,中鴻            ,1659000,2558000,-899000,0,0,0,0,0,0,-237000,0,237000,-237000,0,0,0,-1136000
2481,強茂            ,1183000,794000,389000,0,0,0,0,1519000,-1519000,-9000,0,1000,-1000,0,8000,-8000,-1139000
058652,SGBR2X中信01購01,0,0,0,0,0,0,0,0,0,-1159000,0,0,0,0,1159000,-1159000,-1159000
00673R,元大S&P原油反1  ,3000,197000,-194000,0,0,0,0,0,0,-971000,0,0,0,2039000,3010000,-971000,-1165000
03673C,臺股指元富99牛14,0,0,0,0,0,0,0,0,0,-1200000,0,0,0,469000,1669000,-1200000,-1200000
3338,泰碩            ,960000,2249000,-1289000,0,0,0,27000,0,27000,61000,113000,29000,84000,49000,72000,-23000,-1201000
050256,臺指反元大98購03,0,0,0,0,0,0,0,0,0,-1202000,0,0,0,21000,1223000,-1202000,-1202000
056701,國產國泰9A購01  ,0,0,0,0,0,0,0,0,0,-1203000,0,0,0,10000,1213000,-1203000,-1203000
00646,元大S&P500      ,6000,1658000,-1652000,0,0,0,0,0,0,436000,0,0,0,1198000,762000,436000,-1216000
2332,友訊            ,1150000,1421000,-271000,0,0,0,0,0,0,-967000,142000,983000,-841000,1000,127000,-126000,-1238000
2367,燿華            ,2859000,4035000,-1176000,0,0,0,0,0,0,-71998,8000,68000,-60000,2000,13998,-11998,-1247998
2520,冠德            ,233000,1130000,-897000,0,0,0,0,180000,-180000,-173000,45000,9000,36000,0,209000,-209000,-1250000
056392,玉晶光富邦9C購01,0,0,0,0,0,0,0,0,0,-1254000,0,0,0,0,1254000,-1254000,-1254000
4915,致伸            ,953000,2171544,-1218544,0,0,0,0,0,0,-51925,0,48000,-48000,1000,4925,-3925,-1270469
06025P,臺股指元大99售02,0,4000,-4000,0,0,0,0,0,0,-1280000,0,0,0,266000,1546000,-1280000,-1284000
1210,大成            ,152000,1300000,-1148000,0,0,0,0,0,0,-153000,6000,159000,-153000,0,0,0,-1301000
2393,億光            ,376000,1570000,-1194000,0,0,0,0,0,0,-118000,20000,109000,-89000,1000,30000,-29000,-1312000
1312,國喬            ,719000,2127000,-1408000,0,0,0,0,0,0,95000,138000,25000,113000,0,18000,-18000,-1313000
058770,貿聯兆豐9A購01  ,0,0,0,0,0,0,0,0,0,-1325000,0,0,0,157000,1482000,-1325000,-1325000
9910,豐泰            ,950000,2242400,-1292400,0,0,0,2000,30000,-28000,-12000,36000,50000,-14000,2000,0,2000,-1332400
3545,敦泰            ,995000,2344000,-1349000,0,0,0,0,0,0,-1000,1000,2000,-1000,0,0,0,-1350000
050057,國巨凱基94購05  ,0,0,0,0,0,0,0,0,0,-1352000,0,0,0,217000,1569000,-1352000,-1352000
2201,裕隆            ,437000,1741000,-1304000,0,0,0,0,0,0,-73000,0,61000,-61000,0,12000,-12000,-1377000
04827P,國巨凱基94售09  ,0,0,0,0,0,0,0,0,0,-1425000,0,0,0,20000,1445000,-1425000,-1425000
3702,大聯大          ,2394500,5269426,-2874926,0,0,0,6000,0,6000,1442000,3000,213000,-210000,1652000,0,1652000,-1426926
04368P,台積電凱基94售02,0,0,0,0,0,0,0,0,0,-1440000,0,0,0,0,1440000,-1440000,-1440000
6176,瑞儀            ,1003000,3056206,-2053206,0,0,0,110000,12000,98000,496000,91000,87000,4000,545000,53000,492000,-1459206
057404,貿聯群益99購01  ,0,0,0,0,0,0,0,0,0,-1487000,0,0,0,10000,1497000,-1487000,-1487000
1904,正隆            ,939000,2265000,-1326000,0,0,0,500000,600000,-100000,-97000,24000,121000,-97000,0,0,0,-1523000
07208P,台積電凱基99售14,0,0,0,0,0,0,0,0,0,-1534000,0,0,0,1398000,2932000,-1534000,-1534000
059071,元油2X元大9C購12,0,0,0,0,0,0,0,0,0,-1539000,0,0,0,6000,1545000,-1539000,-1539000
056403,茂林群益98購01  ,0,0,0,0,0,0,0,0,0,-1545000,0,0,0,0,1545000,-1545000,-1545000
8112,至上            ,497000,1820000,-1323000,0,0,0,0,0,0,-240000,27000,267000,-240000,0,0,0,-1563000
06879P,長榮航凱基98售02,0,0,0,0,0,0,0,0,0,-1576000,0,0,0,442000,2018000,-1576000,-1576000
059238,台積電凱基99購11,0,0,0,0,0,0,0,0,0,-1593000,0,0,0,0,1593000,-1593000,-1593000
059080,亞泥元大99購01  ,0,0,0,0,0,0,0,0,0,-1603000,0,0,0,14000,1617000,-1603000,-1603000
3189,景碩            ,934000,1997000,-1063000,0,0,0,0,446000,-446000,-102000,65000,123000,-58000,25000,69000,-44000,-1611000
056921,京元電兆豐98購01,0,0,0,0,0,0,0,0,0,-1636000,0,0,0,236000,1872000,-1636000,-1636000
2312,金寶            ,445000,2020000,-1575000,0,0,0,0,0,0,-95000,1000,12000,-11000,0,84000,-84000,-1670000
1795,美時            ,718000,717000,1000,0,0,0,0,1675000,-1675000,0,0,0,0,0,0,0,-1674000
2542,興富發          ,1284500,2669000,-1384500,0,0,0,0,0,0,-296000,70000,366000,-296000,0,0,0,-1680500
2323,中環            ,3210000,4719000,-1509000,0,0,0,0,0,0,-201000,29000,134000,-105000,101000,197000,-96000,-1710000
2454,聯發科          ,5627656,6657622,-1029966,0,0,0,57000,6000,51000,-734000,82000,496000,-414000,12000,332000,-320000,-1712966
4904,遠傳            ,3799119,5697384,-1898265,0,0,0,352000,0,352000,-217000,15000,240000,-225000,8000,0,8000,-1763265
1303,南亞            ,9283617,9418101,-134484,0,0,0,231000,0,231000,-1995000,22000,2039000,-2017000,46000,24000,22000,-1898484
056634,為升兆豐99購01  ,20000,0,20000,0,0,0,0,0,0,-1950000,0,0,0,0,1950000,-1950000,-1930000
2515,中工            ,841000,2850000,-2009000,0,0,0,0,0,0,9000,36000,22000,14000,0,5000,-5000,-2000000
5876,上海商銀        ,4999500,6941884,-1942384,0,0,0,8000,0,8000,-149000,203000,365000,-162000,16000,3000,13000,-2083384
2867,三商壽          ,712000,2345000,-1633000,0,0,0,0,0,0,-481000,0,481000,-481000,0,0,0,-2114000
00637L,元大滬深300正2  ,12025000,4393000,7632000,0,0,0,0,0,0,-9755000,0,0,0,30122000,39877000,-9755000,-2123000
00633L,富邦上証正2     ,738000,395000,343000,0,0,0,0,0,0,-2474000,400000,45000,355000,6931000,9760000,-2829000,-2131000
2548,華固            ,108000,2342000,-2234000,0,0,0,20000,48000,-28000,72000,318000,206000,112000,4000,44000,-40000,-2190000
2379,瑞昱            ,1361620,3794106,-2432486,0,0,0,276000,0,276000,-35000,66000,33000,33000,9000,77000,-68000,-2191486
058547,世紀鋼富邦9A購01,0,0,0,0,0,0,0,0,0,-2239000,0,0,0,330000,2569000,-2239000,-2239000
1434,福懋            ,642000,2609000,-1967000,0,0,0,9000,0,9000,-300000,0,300000,-300000,0,0,0,-2258000
059239,台積電凱基99購12,0,0,0,0,0,0,0,0,0,-2295000,0,0,0,0,2295000,-2295000,-2295000
2344,華邦電          ,12761000,13728740,-967740,0,0,0,16000,10000,6000,-1395000,528000,1150000,-622000,218000,991000,-773000,-2356740
1907,永豐餘          ,339000,2330000,-1991000,0,0,0,0,0,0,-367000,0,367000,-367000,0,0,0,-2358000
6505,台塑化          ,2803999,4674073,-1870074,0,0,0,45000,0,45000,-649000,0,656000,-656000,7000,0,7000,-2474074
2412,中華電          ,8838690,10997316,-2158626,0,0,0,215000,0,215000,-633000,29000,678000,-649000,19000,3000,16000,-2576626
00850,元大臺灣ESG永續 ,4000,1884000,-1880000,0,0,0,0,0,0,-720000,0,0,0,2241000,2961000,-720000,-2600000
00641R,富邦日本反1     ,0,738000,-738000,0,0,0,0,0,0,-1872000,0,0,0,330000,2202000,-1872000,-2610000
2633,台灣高鐵        ,3761366,6103000,-2341634,0,0,0,19000,0,19000,-321000,247000,322000,-75000,10000,256000,-246000,-2643634
1714,和桐            ,453000,3137000,-2684000,0,0,0,0,0,0,0,0,0,0,0,0,0,-2684000
4938,和碩            ,2989000,6424623,-3435623,0,0,0,18000,0,18000,728000,162000,107000,55000,778000,105000,673000,-2689623
2376,技嘉            ,1323000,4601000,-3278000,0,0,0,0,0,0,557841,158000,146000,12000,956000,410159,545841,-2720159
6239,力成            ,2581000,5335175,-2754175,0,0,0,231000,120000,111000,-113000,244000,239000,5000,49000,167000,-118000,-2756175
1102,亞泥            ,3657000,8066990,-4409990,0,0,0,323000,0,323000,1243000,79000,301000,-222000,1544000,79000,1465000,-2843990
2889,國票金          ,538000,2849000,-2311000,0,0,0,0,0,0,-577000,4000,581000,-577000,0,0,0,-2888000
04391P,玉晶光凱基95售03,0,0,0,0,0,0,0,0,0,-2982000,0,0,0,739000,3721000,-2982000,-2982000
6116,彩晶            ,4305000,6372000,-2067000,0,0,0,0,0,0,-927000,16000,359000,-343000,33000,617000,-584000,-2994000
03033P,微星國票03售01  ,0,0,0,0,0,0,0,0,0,-3180000,0,0,0,0,3180000,-3180000,-3180000
3706,神達            ,2498000,5105000,-2607000,0,0,0,0,100000,-100000,-600000,9000,545000,-536000,6000,70000,-64000,-3307000
07142P,台灣50元大01售01,0,0,0,0,0,0,0,0,0,-3332000,0,0,0,860000,4192000,-3332000,-3332000
2845,遠東銀          ,1422941,4255505,-2832564,0,0,0,16000,0,16000,-871000,0,871000,-871000,0,0,0,-3687564
2301,光寶科          ,5137174,9669014,-4531840,0,0,0,8000,3000,5000,622000,20000,455000,-435000,1069000,12000,1057000,-3904840
053564,台積電富邦99購01,0,0,0,0,0,0,0,0,0,-3946000,0,0,0,0,3946000,-3946000,-3946000
2812,台中銀          ,1654300,4798836,-3144536,0,0,0,0,0,0,-946000,0,946000,-946000,0,0,0,-4090536
058727,嘉晶富邦9A購01  ,0,0,0,0,0,0,0,0,0,-4138000,0,0,0,308000,4446000,-4138000,-4138000
2448,晶電            ,4352000,8226000,-3874000,0,0,0,70000,0,70000,-403000,96000,230000,-134000,0,269000,-269000,-4207000
1326,台化            ,5221000,10083055,-4862055,0,0,0,335000,50000,285000,307000,297000,500000,-203000,538000,28000,510000,-4270055
2610,華航            ,7512758,11690000,-4177242,0,0,0,24000,0,24000,-180000,0,77000,-77000,0,103000,-103000,-4333242
2324,仁寶            ,8982446,15761296,-6778850,0,0,0,24000,0,24000,2301000,152000,725000,-573000,2921000,47000,2874000,-4453850
2382,廣達            ,4106691,9073344,-4966653,0,0,0,26000,0,26000,422000,171000,529000,-358000,823000,43000,780000,-4518653
1909,榮成            ,2632000,5125000,-2493000,0,0,0,0,248000,-248000,-1910000,26000,1936000,-1910000,0,0,0,-4651000
2408,南亞科          ,5956918,7593857,-1636939,0,0,0,37000,3425000,-3388000,231000,84000,407000,-323000,761000,207000,554000,-4793939
1402,遠東新          ,3055317,7620784,-4565467,0,0,0,36000,0,36000,-341000,67000,427000,-360000,19000,0,19000,-4870467
1504,東元            ,1656000,6726000,-5070000,0,0,0,10000,0,10000,-165000,3000,158000,-155000,0,10000,-10000,-5225000
2809,京城銀          ,545000,3052000,-2507000,0,0,0,4000,214000,-210000,-2620000,0,2620000,-2620000,0,0,0,-5337000
00631L,元大台灣50正2   ,103000,73000,30000,0,0,0,0,0,0,-5457000,0,0,0,4776000,10233000,-5457000,-5427000
9904,寶成            ,4340000,9588410,-5248410,0,0,0,22000,0,22000,-506000,96000,608000,-512000,23000,17000,6000,-5732410
3045,台灣大          ,2761075,9129413,-6368338,0,0,0,82000,0,82000,-134000,234000,375000,-141000,7000,0,7000,-6420338
00692,富邦公司治理    ,7000,0,7000,0,0,0,0,0,0,-6599000,0,0,0,973000,7572000,-6599000,-6592000
3231,緯創            ,8044292,15873071,-7828779,0,0,0,15000,0,15000,1085000,52000,530000,-478000,1596000,33000,1563000,-6728779
00852L,國泰美國道瓊正2 ,518000,446000,72000,0,0,0,0,0,0,-7233000,0,0,0,5646000,12879000,-7233000,-7161000
2801,彰銀            ,6817660,14438760,-7621100,0,0,0,63000,0,63000,91000,91000,39000,52000,45000,6000,39000,-7467100
2618,長榮航          ,10982214,15608983,-4626769,0,0,0,23000,0,23000,-3151000,271000,669000,-398000,51000,2804000,-2753000,-7754769
2002,中鋼            ,15054137,21831249,-6777112,0,0,0,110000,0,110000,-1196000,2000,1281000,-1279000,85000,2000,83000,-7863112
2105,正新            ,3786020,5546773,-1760753,0,0,0,8000,0,8000,-6131000,8000,198000,-190000,63000,6004000,-5941000,-7883753
1216,統一            ,5132126,13557810,-8425684,0,0,0,42000,0,42000,-232000,67000,304000,-237000,23000,18000,5000,-8615684
3711,日月光投控      ,5040108,11465992,-6425884,0,0,0,186000,0,186000,-2620000,129000,2745000,-2616000,58000,62000,-4000,-8859884
2313,華通            ,6433000,10630786,-4197786,0,0,0,106000,4817000,-4711000,-121000,679000,556000,123000,261000,505000,-244000,-9029786
2823,中壽            ,10786036,19703686,-8917650,0,0,0,29000,0,29000,-986000,2000,923000,-921000,118000,183000,-65000,-9874650
2834,臺企銀          ,10657272,19202648,-8545376,0,0,0,35000,0,35000,-2515000,8000,1408000,-1400000,10000,1125000,-1115000,-11025376
2882,國泰金          ,12155885,23201098,-11045213,0,0,0,84000,0,84000,-1217990,0,864000,-864000,53000,406990,-353990,-12179203
1301,台塑            ,6106500,16760165,-10653665,0,0,0,275000,203000,72000,-1674000,329000,1977000,-1648000,27000,53000,-26000,-12255665
5880,合庫金          ,12089730,23681855,-11592125,0,0,0,86000,0,86000,-784000,213000,1036000,-823000,45000,6000,39000,-12290125
2881,富邦金          ,9018782,21203584,-12184802,0,0,0,73000,183000,-110000,-853000,0,563000,-563000,48000,338000,-290000,-13147802
2888,新光金          ,17676500,30502987,-12826487,0,0,0,94000,0,94000,-630000,35000,444000,-409000,595000,816000,-221000,-13362487
2880,華南金          ,10554742,23290171,-12735429,0,0,0,83000,0,83000,-976000,1000,979000,-978000,46000,44000,2000,-13628429
1101,台泥            ,11920117,27506430,-15586313,0,0,0,418000,0,418000,985000,549000,419000,130000,1595000,740000,855000,-14183313
2890,永豐金          ,14834713,29628369,-14793656,0,0,0,91000,0,91000,-228000,1000,179000,-178000,70000,120000,-50000,-14930656
2885,元大金          ,10702418,27312552,-16610134,0,0,0,90000,0,90000,-687000,302000,746000,-444000,87000,330000,-243000,-17207134
2886,兆豐金          ,11353269,30685461,-19332192,0,0,0,395000,0,395000,616000,200000,1186000,-986000,1674000,72000,1602000,-18321192
00642U,元大S&P石油     ,89000,9696000,-9607000,0,0,0,0,0,0,-10006000,30000,0,30000,2415000,12451000,-10036000,-19613000
2317,鴻海            ,32864109,49533343,-16669234,0,0,0,204000,0,204000,-4055001,148000,1175000,-1027000,382000,3410001,-3028001,-20520235
2883,開發金          ,16180500,36420032,-20239532,0,0,0,115000,0,115000,-1271000,3000,1194000,-1191000,84000,164000,-80000,-21395532
2887,台新金          ,17336038,38536008,-21199970,0,0,0,81000,0,81000,-975000,2000,861000,-859000,61000,177000,-116000,-22093970
0050,元大台灣50      ,2005084,22542000,-20536916,0,0,0,50000,0,50000,-4609000,293000,748000,-455000,9166000,13320000,-4154000,-25095916
2409,友達            ,28240168,52549955,-24309787,0,0,0,38000,3365000,-3327000,-81000,2539000,2175000,364000,16000,461000,-445000,-27717787
3481,群創            ,29837580,54295200,-24457620,0,0,0,0,1500000,-1500000,-3355000,354000,3015000,-2661000,0,694000,-694000,-29312620
2892,第一金          ,9991301,42477935,-32486634,0,0,0,88000,0,88000,-552000,192000,688000,-496000,57000,113000,-56000,-32950634
2330,台積電          ,47276743,79701364,-32424621,0,0,0,558000,56000,502000,-3879000,1000000,3334000,-2334000,572000,2117000,-1545000,-35801621
2891,中信金          ,21145387,61158147,-40012760,0,0,0,146000,0,146000,-1070000,549000,1647000,-1098000,107000,79000,28000,-40936760
2884,玉山金          ,29528982,77203296,-47674314,0,0,0,89000,200000,-111000,-1379000,591000,1726000,-1135000,223000,467000,-244000,-49164314
0056,元大高股息      ,27025,2000,25025,0,0,0,150000,0,150000,-61902000,170000,0,170000,0,62072000,-62072000,-61726975
00715L,街口布蘭特油正2 ,268000,8462000,-8194000,0,0,0,0,0,0,-119166000,0,0,0,2302000,121468000,-119166000,-127360000
