證券代號,證券名稱,外陸資買進股數(不含外資自營商),外陸資賣出股數(不含外資自營商),外陸資買賣超股數(不含外資自營商),外資自營商買進股數,外資自營商賣出股數,外資自營商買賣超股數,投信買進股數,投信賣出股數,投信買賣超股數,自營商買賣超股數,自營商買進股數(自行買賣),自營商賣出股數(自行買賣),自營商買賣超股數(自行買賣),自營商買進股數(避險),自營商賣出股數(避險),自營商買賣超股數(避險),三大法人買賣超股數
00637L,元大滬深300正2  ,14665000,908000,13757000,0,0,0,0,0,0,17861000,0,193000,-193000,33138000,15084000,18054000,31618000
00672L,元大S&P原油正2  ,18384000,3015000,15369000,0,0,0,0,0,0,9507000,0,600000,-600000,24885000,14778000,10107000,24876000
2891,中信金          ,30227000,21303000,8924000,0,0,0,4000,0,4000,-141000,0,100000,-100000,0,41000,-41000,8787000
00633L,富邦上証正2     ,3285000,191000,3094000,0,0,0,0,0,0,4652000,0,18000,-18000,5929000,1259000,4670000,7746000
3706,神達            ,3979000,588000,3391000,0,0,0,350000,0,350000,2845000,2982000,414000,2568000,391000,114000,277000,6586000
3545,敦泰            ,7199000,1576000,5623000,0,0,0,0,0,0,18000,0,0,0,18000,0,18000,5641000
0056,元大高股息      ,2000,1000,1000,0,0,0,0,0,0,3769000,15000,100000,-85000,4704000,850000,3854000,3770000
2892,第一金          ,3089000,1163000,1926000,0,0,0,2000,838000,-836000,2465000,2474000,1000,2473000,0,8000,-8000,3555000
2888,新光金          ,5335000,3540000,1795000,0,0,0,3000,0,3000,1221000,958000,0,958000,367000,104000,263000,3019000
05091P,台積電元大95售11,0,0,0,0,0,0,0,0,0,2755000,0,0,0,3090000,335000,2755000,2755000
00655L,國泰中國A50正2  ,67000,75000,-8000,0,0,0,0,0,0,2693000,0,98000,-98000,3802000,1011000,2791000,2685000
03840P,台積電統一99售02,0,0,0,0,0,0,0,0,0,2550000,0,0,0,2555000,5000,2550000,2550000
054713,國巨中信9B購01  ,0,0,0,0,0,0,0,0,0,2546000,0,0,0,4769000,2223000,2546000,2546000
6116,彩晶            ,4994000,1899000,3095000,0,0,0,0,0,0,-561000,15000,4000,11000,146000,718000,-572000,2534000
05980P,台積電永昌96售09,0,0,0,0,0,0,0,0,0,2466000,0,0,0,6422000,3956000,2466000,2466000
06085P,義隆台新97售01  ,0,0,0,0,0,0,0,0,0,2421000,0,0,0,2492000,71000,2421000,2421000
00643,群益深証中小    ,2168000,11000,2157000,0,0,0,0,0,0,54000,30000,30000,0,374000,320000,54000,2211000
05826P,臺股指凱基96售23,0,0,0,0,0,0,0,0,0,2095000,0,0,0,2261000,166000,2095000,2095000
3189,景碩            ,2564000,1276000,1288000,0,0,0,357000,307000,50000,710000,222000,98000,124000,610000,24000,586000,2048000
04289P,臺股指中信95售07,0,0,0,0,0,0,0,0,0,2021000,0,0,0,2285000,264000,2021000,2021000
06572P,台積電永昌99售01,0,0,0,0,0,0,0,0,0,1930000,0,0,0,3954000,2024000,1930000,1930000
00639,富邦深100       ,1678000,0,1678000,0,0,0,0,0,0,227240,0,0,0,1126240,899000,227240,1905240
06229P,欣興凱基97售07  ,0,0,0,0,0,0,0,0,0,1844000,0,0,0,2200000,356000,1844000,1844000
00861,元大全球未來通訊,133000,16000,117000,0,0,0,0,0,0,1589000,0,250000,-250000,2242000,403000,1839000,1706000
05551P,電子類元大96售01,0,0,0,0,0,0,0,0,0,1656000,0,0,0,2388000,732000,1656000,1656000
2884,玉山金          ,4435000,3141128,1293872,0,0,0,3000,0,3000,352000,251000,0,251000,101000,0,101000,1648872
06456P,聯發科統一98售03,0,0,0,0,0,0,0,0,0,1644000,0,0,0,1644000,0,1644000,1644000
2371,大同            ,2266000,709000,1557000,0,0,0,0,0,0,54000,56000,2000,54000,0,0,0,1611000
2201,裕隆            ,1776000,277000,1499000,0,0,0,0,0,0,29000,0,0,0,36000,7000,29000,1528000
054534,台積電富邦98購03,0,0,0,0,0,0,0,0,0,1445000,0,0,0,2021000,576000,1445000,1445000
06078P,臺股指凱基9A售01,0,0,0,0,0,0,0,0,0,1430000,0,0,0,1459000,29000,1430000,1430000
05729P,臺股指凱基97售02,0,0,0,0,0,0,0,0,0,1384000,0,0,0,1637000,253000,1384000,1384000
04980P,臺股指凱基96售08,0,0,0,0,0,0,0,0,0,1351000,0,0,0,1757000,406000,1351000,1351000
2887,台新金          ,2817000,1474016,1342984,0,0,0,2000,0,2000,-4000,0,0,0,0,4000,-4000,1340984
2313,華通            ,3689000,2234000,1455000,0,0,0,0,260000,-260000,105000,94000,94000,0,270000,165000,105000,1300000
3532,台勝科          ,922000,265500,656500,0,0,0,650000,0,650000,-50000,34000,49000,-15000,11000,46000,-35000,1256500
05170P,世芯元大95售01  ,0,0,0,0,0,0,0,0,0,1253000,0,0,0,1509000,256000,1253000,1253000
04755P,大立光元富94售07,0,0,0,0,0,0,0,0,0,1203000,0,0,0,1265000,62000,1203000,1203000
051113,聯電元富95購01  ,0,0,0,0,0,0,0,0,0,1198000,0,0,0,1278000,80000,1198000,1198000
05891P,聯發科中信98售03,0,0,0,0,0,0,0,0,0,1191000,0,0,0,1498000,307000,1191000,1191000
2383,台光電          ,3049000,781000,2268000,0,0,0,0,1098000,-1098000,9000,147000,111000,36000,37000,64000,-27000,1179000
0061,元大寶滬深      ,1159000,0,1159000,0,0,0,0,0,0,13000,20000,10000,10000,91000,88000,3000,1172000
3037,欣興            ,3483000,1819000,1664000,0,0,0,0,663000,-663000,169000,322000,138000,184000,148000,163000,-15000,1170000
06193P,台積電元富97售04,0,0,0,0,0,0,0,0,0,1156000,0,0,0,2921000,1765000,1156000,1156000
006205,富邦上証        ,677000,20000,657000,0,0,0,0,0,0,478507,0,0,0,1646507,1168000,478507,1135507
2886,兆豐金          ,3585000,2343000,1242000,0,0,0,2000,0,2000,-113000,0,0,0,10000,123000,-113000,1131000
2345,智邦            ,2338000,1482000,856000,0,0,0,87000,0,87000,178000,117000,0,117000,96000,35000,61000,1121000
00673R,元大S&P原油反1  ,0,705000,-705000,0,0,0,0,0,0,1814000,0,0,0,3122000,1308000,1814000,1109000
041527,T50反1中信96購01,0,0,0,0,0,0,0,0,0,1065000,0,0,0,1165000,100000,1065000,1065000
052291,鴻海元富97購02  ,0,0,0,0,0,0,0,0,0,1059000,0,0,0,1059000,0,1059000,1059000
055018,緯穎元富97購02  ,0,0,0,0,0,0,0,0,0,1056000,0,0,0,1847000,791000,1056000,1056000
042326,元油2X國票94購01,0,0,0,0,0,0,0,0,0,1050000,0,0,0,1050000,0,1050000,1050000
04682P,臺股指統一96售01,0,0,0,0,0,0,0,0,0,1041000,0,0,0,1141000,100000,1041000,1041000
05716P,T50反1元大98售03,0,0,0,0,0,0,0,0,0,1040000,0,0,0,1060000,20000,1040000,1040000
05650P,台積電富邦96售01,0,0,0,0,0,0,0,0,0,1038000,0,0,0,1038000,0,1038000,1038000
00636,國泰中國A50     ,365000,0,365000,0,0,0,0,0,0,664227,0,170000,-170000,1235227,401000,834227,1029227
050874,康控永豐95購01  ,0,0,0,0,0,0,0,0,0,1017000,0,0,0,1497000,480000,1017000,1017000
050172,臺指反元大98購02,0,0,0,0,0,0,0,0,0,1002000,0,0,0,1032000,30000,1002000,1002000
6269,台郡            ,1749000,871000,878000,0,0,0,503000,478000,25000,99000,183000,58000,125000,39000,65000,-26000,1002000
04874P,高股息中信97售01,0,0,0,0,0,0,0,0,0,998000,0,0,0,998000,0,998000,998000
6278,台表科          ,710000,305000,405000,0,0,0,535000,0,535000,57000,21000,8000,13000,80000,36000,44000,997000
2885,元大金          ,2111000,1564000,547000,0,0,0,2000,0,2000,445000,400000,0,400000,45000,0,45000,994000
052852,國巨元富96購02  ,0,0,0,0,0,0,0,0,0,992000,0,0,0,3400000,2408000,992000,992000
9958,世紀鋼          ,581000,162000,419000,0,0,0,150000,0,150000,415000,0,1000,-1000,488000,72000,416000,984000
048381,T50反1國票94購03,0,0,0,0,0,0,0,0,0,975000,0,0,0,1341000,366000,975000,975000
6282,康舒            ,1073000,787000,286000,0,0,0,0,0,0,681000,17000,0,17000,666000,2000,664000,967000
047454,滬深2X群益96購03,0,0,0,0,0,0,0,0,0,964000,0,0,0,964000,0,964000,964000
047604,智原國泰95購01  ,0,0,0,0,0,0,0,0,0,963000,0,0,0,1163000,200000,963000,963000
051259,鴻海永昌96購03  ,0,0,0,0,0,0,0,0,0,945000,0,0,0,1797000,852000,945000,945000
050104,元石油元大97購02,0,0,0,0,0,0,0,0,0,937000,0,0,0,1101000,164000,937000,937000
2474,可成            ,2743500,1764000,979500,0,0,0,0,0,0,-61000,31000,40000,-9000,88000,140000,-52000,918500
049496,和鑫元大95購01  ,0,0,0,0,0,0,0,0,0,910000,0,0,0,910000,0,910000,910000
00738U,元大道瓊白銀    ,0,1000,-1000,0,0,0,0,0,0,904000,0,0,0,1104000,200000,904000,903000
2323,中環            ,1475000,583000,892000,0,0,0,0,0,0,3000,17000,0,17000,2000,16000,-14000,895000
03025P,國巨元大01售12  ,0,0,0,0,0,0,0,0,0,879000,0,0,0,879000,0,879000,879000
2049,上銀            ,1060060,609000,451060,0,0,0,149000,3000,146000,279000,46000,72000,-26000,347000,42000,305000,876060
049891,T50反1富邦94購02,0,0,0,0,0,0,0,0,0,858000,0,0,0,903000,45000,858000,858000
3016,嘉晶            ,604000,439000,165000,0,0,0,0,0,0,693000,1000,0,1000,977000,285000,692000,858000
045994,康控富邦94購01  ,0,0,0,0,0,0,0,0,0,853000,0,0,0,873000,20000,853000,853000
050685,緯穎元富94購02  ,0,0,0,0,0,0,0,0,0,844000,0,0,0,976000,132000,844000,844000
05103P,臺股指凱基96售10,0,0,0,0,0,0,0,0,0,839000,0,0,0,1038000,199000,839000,839000
1504,東元            ,1246000,270000,976000,0,0,0,0,0,0,-145000,14000,8000,6000,0,151000,-151000,831000
00783,富邦中証500     ,293000,0,293000,0,0,0,0,0,0,533213,0,0,0,1900213,1367000,533213,826213
046039,新日興元大92購02,0,0,0,0,0,0,0,0,0,825000,0,0,0,825000,0,825000,825000
054020,技嘉台新97購01  ,0,0,0,0,0,0,0,0,0,825000,0,0,0,826000,1000,825000,825000
045484,聯電亞東94購01  ,0,0,0,0,0,0,0,0,0,822000,0,0,0,822000,0,822000,822000
05041P,大立光凱基95售09,0,0,0,0,0,0,0,0,0,821000,0,0,0,831000,10000,821000,821000
2841,台開            ,933000,113000,820000,0,0,0,0,0,0,0,0,0,0,0,0,0,820000
05450P,臺股指元大95售27,0,0,0,0,0,0,0,0,0,804000,0,0,0,954000,150000,804000,804000
2408,南亞科          ,1982000,2799000,-817000,0,0,0,1218000,0,1218000,403000,126000,93000,33000,494000,124000,370000,804000
05004P,健策統一95售01  ,0,0,0,0,0,0,0,0,0,800000,0,0,0,800000,0,800000,800000
05105P,大立光台新95售02,0,0,0,0,0,0,0,0,0,799000,0,0,0,799000,0,799000,799000
05186P,鈺齊中信95售02  ,0,0,0,0,0,0,0,0,0,796000,0,0,0,799000,3000,796000,796000
06496P,台灣50日盛98售01,0,0,0,0,0,0,0,0,0,792000,0,0,0,1407000,615000,792000,792000
2889,國票金          ,827000,38000,789000,0,0,0,0,0,0,0,0,0,0,0,0,0,789000
04327P,台積電國泰95售01,0,0,0,0,0,0,0,0,0,769000,0,0,0,769000,0,769000,769000
050991,元油2X元大96購04,0,0,0,0,0,0,0,0,0,769000,0,0,0,1460000,691000,769000,769000
05791P,臺股指中信99售06,0,0,0,0,0,0,0,0,0,736000,0,0,0,811000,75000,736000,736000
2618,長榮航          ,1423000,794000,629000,0,0,0,0,0,0,105000,223000,10000,213000,0,108000,-108000,734000
056187,京鼎統一97購01  ,0,0,0,0,0,0,0,0,0,733000,0,0,0,801000,68000,733000,733000
055403,泰鼎元富97購01  ,0,0,0,0,0,0,0,0,0,732000,0,0,0,968000,236000,732000,732000
05400P,台積電永豐95售05,0,0,0,0,0,0,0,0,0,719000,0,0,0,1218000,499000,719000,719000
05688P,臺股指元大96售13,0,0,0,0,0,0,0,0,0,711000,0,0,0,756000,45000,711000,711000
04787P,台積電永昌96售04,0,0,0,0,0,0,0,0,0,703000,0,0,0,797000,94000,703000,703000
3711,日月光投控      ,2049000,1537000,512000,0,0,0,234000,150000,84000,99000,211000,28000,183000,5000,89000,-84000,695000
054900,金寶康和97購01  ,0,0,0,0,0,0,0,0,0,691000,0,0,0,848000,157000,691000,691000
056485,同欣電元大98購01,0,0,0,0,0,0,0,0,0,687000,0,0,0,1533000,846000,687000,687000
045897,泰鼎元大93購04  ,0,0,0,0,0,0,0,0,0,682000,0,0,0,810000,128000,682000,682000
049389,元石油中信97購02,10000,0,10000,0,0,0,0,0,0,662000,0,0,0,746000,84000,662000,672000
054278,晶技群益97購02  ,0,0,0,0,0,0,0,0,0,671000,0,0,0,769000,98000,671000,671000
045618,元油2X永豐98購01,0,0,0,0,0,0,0,0,0,668000,0,0,0,679000,11000,668000,668000
055183,聯鈞統一97購01  ,0,0,0,0,0,0,0,0,0,663000,0,0,0,673000,10000,663000,663000
1229,聯華            ,735000,74000,661000,0,0,0,0,0,0,0,0,0,0,0,0,0,661000
053884,緯穎第一96購01  ,0,0,0,0,0,0,0,0,0,658000,0,0,0,688000,30000,658000,658000
05515P,台積電群益96售03,0,0,0,0,0,0,0,0,0,657000,0,0,0,1170000,513000,657000,657000
05849P,臺股指元大96售25,0,0,0,0,0,0,0,0,0,653000,0,0,0,803000,150000,653000,653000
053828,貿聯麥證96購01  ,0,0,0,652000,1000,651000,0,0,0,651000,0,0,0,652000,1000,651000,651000
05617P,大立光統一97售02,0,0,0,0,0,0,0,0,0,645000,0,0,0,646000,1000,645000,645000
044457,滬深2X國票97購01,0,0,0,0,0,0,0,0,0,644000,0,0,0,645000,1000,644000,644000
05934P,國巨凱基96售13  ,0,0,0,0,0,0,0,0,0,637000,0,0,0,697000,60000,637000,637000
050758,聯發科元富9B購01,0,0,0,0,0,0,0,0,0,636000,0,0,0,640000,4000,636000,636000
045535,A50正2群益94購01,0,0,0,0,0,0,0,0,0,630000,0,0,0,630000,0,630000,630000
05165P,欣興元富95售03  ,0,0,0,0,0,0,0,0,0,628000,0,0,0,653000,25000,628000,628000
056988,聚陽兆豐98購01  ,0,0,0,0,0,0,0,0,0,627000,0,0,0,652000,25000,627000,627000
047421,聯茂富邦97購01  ,0,0,0,0,0,0,0,0,0,624000,0,0,0,847000,223000,624000,624000
048527,鴻海國票94購02  ,0,0,0,0,0,0,0,0,0,617000,0,0,0,701000,84000,617000,617000
04249P,大立光統一94售04,0,0,0,0,0,0,0,0,0,616000,0,0,0,616000,0,616000,616000
052914,奇力新元富96購01,0,0,0,0,0,0,0,0,0,611000,0,0,0,1009000,398000,611000,611000
2610,華航            ,1522010,851000,671010,0,0,0,0,0,0,-63000,2000,0,2000,0,65000,-65000,608010
05090P,國巨元大95售05  ,0,0,0,0,0,0,0,0,0,606000,0,0,0,846000,240000,606000,606000
055852,聯鈞元大98購01  ,40000,0,40000,0,0,0,0,0,0,564000,0,0,0,924000,360000,564000,604000
05585P,臺股指凱基96售14,0,0,0,0,0,0,0,0,0,604000,0,0,0,804000,200000,604000,604000
6153,嘉聯益          ,1074000,360000,714000,0,0,0,0,0,0,-110000,34000,62000,-28000,51000,133000,-82000,604000
055802,新日興永豐97購01,0,0,0,0,0,0,0,0,0,601000,0,0,0,775000,174000,601000,601000
050882,華泰國泰96購01  ,0,0,0,0,0,0,0,0,0,601000,0,0,0,601000,0,601000,601000
03148P,聯電群益03售04  ,0,0,0,0,0,0,0,0,0,600000,0,0,0,600000,0,600000,600000
04601P,大立光凱基94售07,0,0,0,0,0,0,0,0,0,600000,0,0,0,600000,0,600000,600000
048587,康控中信93購01  ,0,0,0,0,0,0,0,0,0,599000,0,0,0,599000,0,599000,599000
052827,昇陽半永豐97購01,0,0,0,0,0,0,0,0,0,599000,0,0,0,630000,31000,599000,599000
05015P,臺股指元大95售06,0,0,0,0,0,0,0,0,0,597000,0,0,0,636000,39000,597000,597000
053981,康控元大96購05  ,0,0,0,0,0,0,0,0,0,597000,0,0,0,606000,9000,597000,597000
047967,南亞科國泰95購01,0,0,0,0,0,0,0,0,0,594000,0,0,0,1083000,489000,594000,594000
055243,國巨統一97購04  ,0,0,0,0,0,0,0,0,0,584000,0,0,0,590000,6000,584000,584000
052627,中壽中信98購01  ,0,0,0,0,0,0,0,0,0,582000,0,0,0,602000,20000,582000,582000
053309,泰鼎凱基96購03  ,0,0,0,0,0,0,0,0,0,575000,0,0,0,576000,1000,575000,575000
05721P,全新群益98售02  ,0,0,0,0,0,0,0,0,0,573000,0,0,0,806000,233000,573000,573000
055194,昇陽半元富97購01,0,0,0,0,0,0,0,0,0,572000,0,0,0,902000,330000,572000,572000
052565,上銀凱基96購01  ,0,0,0,0,0,0,0,0,0,567000,0,0,0,618000,51000,567000,567000
057196,茂林台新98購01  ,0,0,0,0,0,0,0,0,0,566000,0,0,0,616000,50000,566000,566000
056197,友訊永豐97購01  ,0,0,0,0,0,0,0,0,0,563000,0,0,0,573000,10000,563000,563000
04023P,臺股指元富99售02,0,0,0,0,0,0,0,0,0,562000,0,0,0,592000,30000,562000,562000
055336,茂林兆豐98購01  ,0,0,0,0,0,0,0,0,0,561000,0,0,0,628000,67000,561000,561000
057046,奇力新元大99購03,0,0,0,0,0,0,0,0,0,560000,0,0,0,848000,288000,560000,560000
04796P,聯發科元大94售10,0,0,0,0,0,0,0,0,0,557000,0,0,0,557000,0,557000,557000
1904,正隆            ,874000,185000,689000,0,0,0,0,0,0,-132000,18000,150000,-132000,0,0,0,557000
052878,台虹凱基96購01  ,0,0,0,0,0,0,0,0,0,551000,0,0,0,591000,40000,551000,551000
051366,康友國泰97購01  ,0,0,0,0,0,0,0,0,0,550000,0,0,0,799000,249000,550000,550000
049997,聯發科永豐94購04,0,0,0,0,0,0,0,0,0,549000,0,0,0,820000,271000,549000,549000
050867,聯鈞永豐95購01  ,0,0,0,0,0,0,0,0,0,548000,0,0,0,748000,200000,548000,548000
056589,康控統一98購01  ,0,0,0,0,0,0,0,0,0,547000,0,0,0,547000,0,547000,547000
045470,康控元大94購03  ,0,0,0,0,0,0,0,0,0,547000,0,0,0,558000,11000,547000,547000
047504,滬深2X國票9A購01,0,0,0,0,0,0,0,0,0,546000,0,0,0,601000,55000,546000,546000
049996,元油2X永豐94購05,0,0,0,0,0,0,0,0,0,544000,0,0,0,544000,0,544000,544000
06323P,台郡統一97售01  ,0,0,0,0,0,0,0,0,0,541000,0,0,0,619000,78000,541000,541000
03242P,聯電統一02售04  ,0,0,0,0,0,0,0,0,0,540000,0,0,0,540000,0,540000,540000
04854P,鴻海國泰96售04  ,0,0,0,0,0,0,0,0,0,538000,0,0,0,580000,42000,538000,538000
048842,矽格凱基94購01  ,0,0,0,0,0,0,0,0,0,536000,0,0,0,553000,17000,536000,536000
03413B,臺股指凱基94熊19,0,0,0,0,0,0,0,0,0,535000,0,0,0,1235000,700000,535000,535000
055531,華新科群益98購03,0,0,0,0,0,0,0,0,0,534000,0,0,0,574000,40000,534000,534000
053024,國巨富邦97購02  ,0,0,0,0,0,0,0,0,0,532000,0,0,0,562000,30000,532000,532000
053823,茂林群益96購06  ,0,0,0,0,0,0,0,0,0,531000,0,0,0,591000,60000,531000,531000
05009P,大立光元富95售06,0,0,0,0,0,0,0,0,0,530000,0,0,0,531000,1000,530000,530000
1227,佳格            ,870000,340000,530000,0,0,0,0,0,0,0,0,0,0,0,0,0,530000
06161P,聯發科群益97售03,0,0,0,0,0,0,0,0,0,525000,0,0,0,540000,15000,525000,525000
054095,同欣電群益98購03,0,0,0,0,0,0,0,0,0,525000,0,0,0,1073000,548000,525000,525000
054251,聯發科元大96購21,0,0,0,0,0,0,0,0,0,523000,0,0,0,573000,50000,523000,523000
052815,滬深2X永豐97購01,0,0,0,0,0,0,0,0,0,521000,0,0,0,521000,0,521000,521000
05449P,臺股指元大95售26,0,0,0,0,0,0,0,0,0,519000,0,0,0,588000,69000,519000,519000
056101,光磊永豐98購01  ,0,0,0,0,0,0,0,0,0,518000,0,0,0,567000,49000,518000,518000
056517,茂林兆豐99購01  ,0,0,0,0,0,0,0,0,0,517000,0,0,0,517000,0,517000,517000
07866P,上証2X國票97售01,0,0,0,0,0,0,0,0,0,517000,0,0,0,597000,80000,517000,517000
057117,開發金日盛9B購01,0,0,0,0,0,0,0,0,0,515000,0,0,0,525000,10000,515000,515000
054497,國巨永豐96購05  ,0,0,0,0,0,0,0,0,0,515000,0,0,0,772000,257000,515000,515000
05901P,臺股指凱基9C售01,0,0,0,0,0,0,0,0,0,514000,0,0,0,582000,68000,514000,514000
049114,玉晶光統一94購02,0,0,0,0,0,0,0,0,0,512000,0,0,0,667000,155000,512000,512000
050641,上証反凱基96購01,0,0,0,0,0,0,0,0,0,511000,0,0,0,511000,0,511000,511000
05096P,台積電日盛95售01,0,0,0,0,0,0,0,0,0,509000,0,0,0,2000000,1491000,509000,509000
054767,日電貿國票98購01,0,0,0,0,0,0,0,0,0,507000,0,0,0,542000,35000,507000,507000
00739,元大MSCI A股    ,749000,0,749000,0,0,0,0,0,0,-243000,0,0,0,273000,516000,-243000,506000
03202P,聯電凱基01售03  ,0,0,0,0,0,0,0,0,0,505000,0,0,0,505000,0,505000,505000
04672P,台積電統一94售09,0,0,0,0,0,0,0,0,0,505000,0,0,0,607000,102000,505000,505000
052157,東元永豐95購01  ,0,0,0,0,0,0,0,0,0,504000,0,0,0,506000,2000,504000,504000
1312,國喬            ,631000,137000,494000,0,0,0,0,0,0,9000,0,0,0,9000,0,9000,503000
2360,致茂            ,769000,261020,507980,0,0,0,0,0,0,-5000,2000,10000,-8000,15000,12000,3000,502980
053032,國巨兆豐97購02  ,0,0,0,0,0,0,0,0,0,500000,0,0,0,709000,209000,500000,500000
04870P,大立光元富94售11,0,0,0,0,0,0,0,0,0,499000,0,0,0,499000,0,499000,499000
03331P,臺股指群益02售05,0,0,0,0,0,0,0,0,0,499000,0,0,0,499000,0,499000,499000
053572,彩晶統一96購01  ,0,0,0,0,0,0,0,0,0,499000,0,0,0,499000,0,499000,499000
053593,晶技元大98購01  ,0,0,0,0,0,0,0,0,0,499000,0,0,0,509000,10000,499000,499000
053747,滬深2X永豐96購05,0,0,0,0,0,0,0,0,0,498000,0,0,0,499000,1000,498000,498000
053980,泰鼎元大97購02  ,0,0,0,0,0,0,0,0,0,496000,0,0,0,885000,389000,496000,496000
04342P,揚明光永豐93售03,0,0,0,0,0,0,0,0,0,495000,0,0,0,495000,0,495000,495000
044816,漢唐兆豐93購02  ,0,0,0,0,0,0,0,0,0,494000,0,0,0,494000,0,494000,494000
05713P,大立光統一96售05,0,0,0,0,0,0,0,0,0,491000,0,0,0,520000,29000,491000,491000
056601,鈺齊元富98購01  ,0,0,0,0,0,0,0,0,0,491000,0,0,0,506000,15000,491000,491000
006207,FH滬深          ,635000,22000,613000,0,0,0,0,0,0,-122000,0,0,0,440000,562000,-122000,491000
05572P,群創統一96售02  ,0,0,0,0,0,0,0,0,0,490000,0,0,0,490000,0,490000,490000
055722,聯鈞元大97購03  ,0,0,0,0,0,0,0,0,0,489000,0,0,0,1092000,603000,489000,489000
2353,宏碁            ,1216000,770000,446000,0,0,0,0,0,0,42000,8000,2000,6000,52000,16000,36000,488000
052925,日電貿永豐96購01,0,0,0,0,0,0,0,0,0,484000,0,0,0,516000,32000,484000,484000
055017,緯穎元富97購01  ,0,0,0,0,0,0,0,0,0,483000,0,0,0,504000,21000,483000,483000
045873,元油2X元富98購04,0,0,0,0,0,0,0,0,0,481000,0,0,0,591000,110000,481000,481000
05299P,旺宏元大95售04  ,0,0,0,0,0,0,0,0,0,479000,0,0,0,499000,20000,479000,479000
5871,中租-KY         ,1870000,1375219,494781,0,0,0,0,39260,-39260,20000,22000,2000,20000,0,0,0,475521
053950,緯穎富邦97購02  ,0,0,0,0,0,0,0,0,0,475000,0,0,0,476000,1000,475000,475000
046574,泰鼎國泰94購01  ,0,0,0,0,0,0,0,0,0,474000,0,0,0,649000,175000,474000,474000
05283P,健鼎元大95售04  ,0,0,0,0,0,0,0,0,0,474000,0,0,0,479000,5000,474000,474000
047844,台虹元大93購02  ,0,0,0,0,0,0,0,0,0,473000,0,0,0,536000,63000,473000,473000
04781P,欣興凱基94售06  ,0,0,0,0,0,0,0,0,0,470000,0,0,0,475000,5000,470000,470000
050755,和大元富94購01  ,0,0,0,0,0,0,0,0,0,466000,0,0,0,472000,6000,466000,466000
056821,日電貿永豐98購01,0,0,0,0,0,0,0,0,0,465000,0,0,0,553000,88000,465000,465000
049212,T50反1國票94購04,0,0,0,0,0,0,0,0,0,465000,0,0,0,752000,287000,465000,465000
049177,美律凱基94購02  ,0,0,0,0,0,0,0,0,0,464000,0,0,0,464000,0,464000,464000
052768,泰鼎群益96購01  ,0,0,0,0,0,0,0,0,0,464000,0,0,0,738000,274000,464000,464000
054395,華新科永豐96購03,0,0,0,0,0,0,0,0,0,464000,0,0,0,1004000,540000,464000,464000
06476P,臺股指永豐98售01,0,0,0,0,0,0,0,0,0,463000,0,0,0,473000,10000,463000,463000
047537,聯發科日盛93購01,0,0,0,0,0,0,0,0,0,458000,0,0,0,458000,0,458000,458000
049601,矽創元大95購02  ,0,0,0,0,0,0,0,0,0,458000,0,0,0,479000,21000,458000,458000
4142,國光生          ,1125000,672000,453000,0,0,0,0,0,0,5000,5000,0,5000,0,0,0,458000
06012P,世芯國票96售01  ,0,0,0,0,0,0,0,0,0,457000,0,0,0,558000,101000,457000,457000
055733,奇力新元富97購01,0,0,0,0,0,0,0,0,0,454000,0,0,0,696000,242000,454000,454000
048149,泰鼎元富95購01  ,0,0,0,0,0,0,0,0,0,454000,0,0,0,556000,102000,454000,454000
04634P,臺股指群益94售09,0,0,0,0,0,0,0,0,0,450000,0,0,0,450000,0,450000,450000
049663,正崴永豐94購01  ,0,0,0,0,0,0,0,0,0,450000,0,0,0,450000,0,450000,450000
6196,帆宣            ,566000,331000,235000,0,0,0,0,0,0,215000,179000,35000,144000,95000,24000,71000,450000
2377,微星            ,602244,216000,386244,0,0,0,99000,0,99000,-36000,67000,4000,63000,5000,104000,-99000,449244
1590,亞德客-KY       ,585000,235000,350000,0,0,0,61000,26000,35000,64000,14000,3000,11000,77000,24000,53000,449000
049420,日電貿凱基94購01,0,0,0,0,0,0,0,0,0,448000,0,0,0,449000,1000,448000,448000
054282,泰鼎群益98購02  ,0,0,0,0,0,0,0,0,0,448000,0,0,0,821000,373000,448000,448000
054783,國巨群益98購04  ,0,0,0,0,0,0,0,0,0,448000,0,0,0,488000,40000,448000,448000
055310,聯詠群益97購02  ,0,0,0,0,0,0,0,0,0,447000,0,0,0,459000,12000,447000,447000
056190,昇陽半統一97購01,0,0,0,0,0,0,0,0,0,447000,0,0,0,447000,0,447000,447000
050986,上証2X永昌97購01,0,0,0,0,0,0,0,0,0,447000,0,0,0,452000,5000,447000,447000
046999,康控富邦99購01  ,0,0,0,0,0,0,0,0,0,446000,0,0,0,506000,60000,446000,446000
046864,和大統一97購01  ,0,0,0,0,0,0,0,0,0,445000,0,0,0,494000,49000,445000,445000
047690,美律富邦97購01  ,0,0,0,0,0,0,0,0,0,445000,0,0,0,493000,48000,445000,445000
051370,聯詠富邦97購01  ,0,0,0,0,0,0,0,0,0,444000,0,0,0,510000,66000,444000,444000
047357,欣興麥證93購01  ,0,0,0,531000,90000,441000,0,0,0,441000,0,0,0,531000,90000,441000,441000
055959,美律元大97購03  ,0,0,0,0,0,0,0,0,0,440000,0,0,0,450000,10000,440000,440000
050309,亞泥兆豐94購01  ,0,0,0,0,0,0,0,0,0,437000,0,0,0,437000,0,437000,437000
03576P,台灣50元富06售01,0,0,0,0,0,0,0,0,0,436000,0,0,0,506000,70000,436000,436000
056819,奇力新永豐98購01,0,0,0,0,0,0,0,0,0,434000,0,0,0,434000,0,434000,434000
054833,京鼎中信97購01  ,0,0,0,0,0,0,0,0,0,432000,0,0,0,701000,269000,432000,432000
053096,康控統一96購01  ,0,0,0,0,0,0,0,0,0,432000,0,0,0,432000,0,432000,432000
056346,聯茂凱基99購02  ,0,0,0,0,0,0,0,0,0,431000,0,0,0,560000,129000,431000,431000
044187,泰鼎國泰93購01  ,0,0,0,0,0,0,0,0,0,431000,0,0,0,491000,60000,431000,431000
053951,T50反1台新06購02,0,0,0,0,0,0,0,0,0,431000,0,0,0,431000,0,431000,431000
039550,滬深反凱基94購01,0,0,0,0,0,0,0,0,0,430000,0,0,0,445000,15000,430000,430000
056857,國巨群益99購02  ,0,0,0,0,0,0,0,0,0,429000,0,0,0,492000,63000,429000,429000
05977P,旺宏永豐96售06  ,0,0,0,0,0,0,0,0,0,427000,0,0,0,477000,50000,427000,427000
051397,聯茂兆豐95購03  ,0,0,0,0,0,0,0,0,0,426000,0,0,0,431000,5000,426000,426000
06254P,臺股指群益97售07,0,0,0,0,0,0,0,0,0,426000,0,0,0,426000,0,426000,426000
053998,泰鼎群益98購01  ,0,0,0,0,0,0,0,0,0,424000,0,0,0,660000,236000,424000,424000
052981,鴻海元大97購05  ,0,0,0,0,0,0,0,0,0,423000,0,0,0,939000,516000,423000,423000
051614,元金2X凱基97購01,0,0,0,0,0,0,0,0,0,421000,0,0,0,421000,0,421000,421000
055294,智易元大98購01  ,0,0,0,0,0,0,0,0,0,420000,0,0,0,420000,0,420000,420000
06162P,大立光群益97售02,0,0,0,0,0,0,0,0,0,419000,0,0,0,799000,380000,419000,419000
049477,泰鼎永豐94購01  ,0,0,0,0,0,0,0,0,0,418000,0,0,0,428000,10000,418000,418000
056137,聯鈞元大9A購01  ,0,0,0,0,0,0,0,0,0,417000,0,0,0,570000,153000,417000,417000
055843,美律元大97購02  ,0,0,0,0,0,0,0,0,0,414000,0,0,0,430000,16000,414000,414000
06090P,旺宏統一97售06  ,0,0,0,0,0,0,0,0,0,413000,0,0,0,417000,4000,413000,413000
047411,康控元富93購02  ,0,0,0,0,0,0,0,0,0,413000,0,0,0,413000,0,413000,413000
048590,貿聯兆豐94購02  ,0,0,0,0,0,0,0,0,0,410000,0,0,0,410000,0,410000,410000
04633P,旺宏群益96售04  ,0,0,0,0,0,0,0,0,0,407000,0,0,0,410000,3000,407000,407000
044588,元金2X統一93購01,0,0,0,0,0,0,0,0,0,406000,0,0,0,419000,13000,406000,406000
048511,美律凱基93購07  ,0,0,0,0,0,0,0,0,0,405000,0,0,0,410000,5000,405000,405000
055181,日電貿統一97購01,0,0,0,0,0,0,0,0,0,404000,0,0,0,510000,106000,404000,404000
06321P,台積電統一98售03,0,0,0,0,0,0,0,0,0,404000,0,0,0,404000,0,404000,404000
055446,奇力新統一9A購01,0,0,0,0,0,0,0,0,0,403000,0,0,0,697000,294000,403000,403000
04766P,緯穎永豐94售02  ,0,0,0,0,0,0,0,0,0,400000,0,0,0,400000,0,400000,400000
045858,元油2X統一94購02,0,0,0,0,0,0,0,0,0,400000,0,0,0,500000,100000,400000,400000
05008P,大立光元富95售05,0,0,0,0,0,0,0,0,0,400000,0,0,0,400000,0,400000,400000
04955P,大立光日盛94售02,0,0,0,0,0,0,0,0,0,399000,0,0,0,399000,0,399000,399000
055429,華新科群益99購01,0,0,0,0,0,0,0,0,0,396000,0,0,0,426000,30000,396000,396000
6443,元晶            ,451000,58000,393000,0,0,0,0,0,0,-1000,1000,2000,-1000,0,0,0,392000
3090,日電貿          ,855000,78000,777000,0,0,0,0,0,0,-385000,0,4000,-4000,58000,439000,-381000,392000
046003,欣興統一92購02  ,0,0,0,0,0,0,0,0,0,390000,0,0,0,390000,0,390000,390000
06361P,聯發科群益97售06,0,0,0,0,0,0,0,0,0,390000,0,0,0,400000,10000,390000,390000
04875P,台積電中信94售04,0,0,0,0,0,0,0,0,0,388000,0,0,0,388000,0,388000,388000
051246,美律元大96購01  ,0,0,0,0,0,0,0,0,0,387000,0,0,0,397000,10000,387000,387000
054838,京鼎第一97購01  ,0,0,0,0,0,0,0,0,0,386000,0,0,0,597000,211000,386000,386000
053073,技嘉康和96購01  ,0,0,0,0,0,0,0,0,0,386000,0,0,0,425000,39000,386000,386000
06124P,超眾元大97售03  ,0,0,0,0,0,0,0,0,0,383000,0,0,0,383000,0,383000,383000
056113,新日興兆豐98購01,0,0,0,0,0,0,0,0,0,382000,0,0,0,428000,46000,382000,382000
050897,嘉晶元大95購03  ,0,0,0,0,0,0,0,0,0,382000,0,0,0,543000,161000,382000,382000
04161P,全新國泰94售01  ,0,0,0,0,0,0,0,0,0,380000,0,0,0,415000,35000,380000,380000
051999,勤誠元大95購01  ,0,0,0,0,0,0,0,0,0,378000,0,0,0,413000,35000,378000,378000
056200,大毅永豐98購01  ,0,0,0,0,0,0,0,0,0,377000,0,0,0,806000,429000,377000,377000
06081P,深中小元大97售02,0,0,0,0,0,0,0,0,0,375000,0,0,0,470000,95000,375000,375000
051524,貿聯凱基95購02  ,0,0,0,0,0,0,0,0,0,374000,0,0,0,394000,20000,374000,374000
054709,宏達電統一97購01,0,0,0,0,0,0,0,0,0,374000,0,0,0,374000,0,374000,374000
054860,台積電群益98購01,0,0,0,0,0,0,0,0,0,374000,0,0,0,507000,133000,374000,374000
055182,京鼎統一98購01  ,0,0,0,0,0,0,0,0,0,371000,0,0,0,437000,66000,371000,371000
06467P,旺宏統一98售01  ,0,0,0,0,0,0,0,0,0,369000,0,0,0,369000,0,369000,369000
05717P,鴻海元大97售07  ,0,0,0,0,0,0,0,0,0,367000,0,0,0,417000,50000,367000,367000
4938,和碩            ,1283855,968000,315855,0,0,0,1000,0,1000,50000,78000,2000,76000,40000,66000,-26000,366855
05875P,旺宏群益98售01  ,0,0,0,0,0,0,0,0,0,366000,0,0,0,366000,0,366000,366000
057078,國巨統一9A購02  ,0,0,0,0,0,0,0,0,0,365000,0,0,0,461000,96000,365000,365000
053944,亞泥富邦97購01  ,0,0,0,0,0,0,0,0,0,365000,0,0,0,375000,10000,365000,365000
057120,茂林康和98購01  ,0,0,0,0,0,0,0,0,0,363000,0,0,0,364000,1000,363000,363000
06029P,聯發科台新96售02,0,0,0,0,0,0,0,0,0,363000,0,0,0,413000,50000,363000,363000
057268,臻鼎兆豐99購01  ,0,0,0,0,0,0,0,0,0,363000,0,0,0,389000,26000,363000,363000
055966,茂林元大99購01  ,0,0,0,0,0,0,0,0,0,362000,0,0,0,1150000,788000,362000,362000
056923,奇力新兆豐99購02,0,0,0,0,0,0,0,0,0,361000,0,0,0,385000,24000,361000,361000
055875,光罩元富97購02  ,0,0,0,0,0,0,0,0,0,360000,0,0,0,454000,94000,360000,360000
053214,冠德凱基96購02  ,0,0,0,0,0,0,0,0,0,360000,0,0,0,360000,0,360000,360000
055247,聯發科統一98購01,0,0,0,0,0,0,0,0,0,360000,0,0,0,360000,0,360000,360000
056713,華擎永豐98購01  ,0,0,0,0,0,0,0,0,0,359000,0,0,0,581000,222000,359000,359000
055519,茂林中信99購01  ,0,0,0,0,0,0,0,0,0,358000,0,0,0,373000,15000,358000,358000
052709,光寶科日盛96購01,0,0,0,0,0,0,0,0,0,358000,0,0,0,358000,0,358000,358000
047529,嘉晶元大94購02  ,0,0,0,0,0,0,0,0,0,357000,0,0,0,444000,87000,357000,357000
04674P,全新統一95售01  ,0,0,0,0,0,0,0,0,0,357000,0,0,0,361000,4000,357000,357000
054589,聯鈞國泰99購01  ,0,0,0,0,0,0,0,0,0,356000,0,0,0,667000,311000,356000,356000
056089,同欣電統一98購01,0,0,0,0,0,0,0,0,0,355000,0,0,0,489000,134000,355000,355000
055058,大毅永豐97購01  ,0,0,0,0,0,0,0,0,0,352000,0,0,0,451000,99000,352000,352000
055728,緯穎元大97購03  ,0,0,0,0,0,0,0,0,0,351000,0,0,0,393000,42000,351000,351000
047263,揚明光國票94購01,0,0,0,0,0,0,0,0,0,350000,0,0,0,350000,0,350000,350000
03926P,麗豐元大93售02  ,0,0,0,0,0,0,0,0,0,350000,0,0,0,450000,100000,350000,350000
051700,深中小群益99購04,0,0,0,0,0,0,0,0,0,349000,0,0,0,618000,269000,349000,349000
052545,康控元富95購02  ,0,0,0,0,0,0,0,0,0,349000,0,0,0,499000,150000,349000,349000
056253,京鼎兆豐98購01  ,0,0,0,0,0,0,0,0,0,348000,0,0,0,351000,3000,348000,348000
057012,康控中信98購01  ,0,0,0,0,0,0,0,0,0,348000,0,0,0,358000,10000,348000,348000
054071,泰鼎國泰97購02  ,0,0,0,0,0,0,0,0,0,346000,0,0,0,349000,3000,346000,346000
052732,新唐國泰97購01  ,0,0,0,0,0,0,0,0,0,346000,0,0,0,346000,0,346000,346000
05757P,旺宏永豐96售03  ,0,0,0,0,0,0,0,0,0,345000,0,0,0,345000,0,345000,345000
3036,文曄            ,895000,572000,323000,0,0,0,0,0,0,22000,195000,219000,-24000,46000,0,46000,345000
1722,台肥            ,420000,63000,357000,0,0,0,0,0,0,-12000,0,0,0,1000,13000,-12000,345000
051550,日電貿永豐95購01,0,0,0,0,0,0,0,0,0,344000,0,0,0,408000,64000,344000,344000
1909,榮成            ,542000,1315000,-773000,0,0,0,150000,0,150000,966000,950000,2000,948000,18000,0,18000,343000
052058,臺股指凱基95購16,0,0,0,0,0,0,0,0,0,342000,0,0,0,366000,24000,342000,342000
049885,緯穎永豐94購01  ,0,0,0,0,0,0,0,0,0,342000,0,0,0,355000,13000,342000,342000
055292,聯鈞元大97購02  ,0,0,0,0,0,0,0,0,0,341000,0,0,0,646000,305000,341000,341000
052543,聯詠元富95購01  ,0,0,0,0,0,0,0,0,0,340000,0,0,0,350000,10000,340000,340000
045462,美律元大93購04  ,0,0,0,0,0,0,0,0,0,339000,0,0,0,424000,85000,339000,339000
052043,瑞昱日盛95購01  ,0,0,0,0,0,0,0,0,0,339000,0,0,0,629000,290000,339000,339000
050773,京鼎元大94購02  ,0,0,0,0,0,0,0,0,0,337000,0,0,0,499000,162000,337000,337000
06097P,茂林永豐97售01  ,0,0,0,0,0,0,0,0,0,336000,0,0,0,340000,4000,336000,336000
054335,緯穎永豐96購02  ,0,0,0,0,0,0,0,0,0,336000,0,0,0,346000,10000,336000,336000
05698P,群創凱基96售01  ,0,0,0,0,0,0,0,0,0,335000,0,0,0,535000,200000,335000,335000
048156,正崴兆豐93購01  ,0,0,0,0,0,0,0,0,0,334000,0,0,0,334000,0,334000,334000
06487P,聯發科統一99售02,0,0,0,0,0,0,0,0,0,334000,0,0,0,354000,20000,334000,334000
056136,京鼎元大98購01  ,0,0,0,0,0,0,0,0,0,332000,0,0,0,433000,101000,332000,332000
04049P,大立光元大95售02,0,0,0,0,0,0,0,0,0,332000,0,0,0,432000,100000,332000,332000
05157P,全新台新96售01  ,0,0,0,0,0,0,0,0,0,332000,0,0,0,337000,5000,332000,332000
053910,嘉聯益凱基98購01,0,0,0,0,0,0,0,0,0,332000,0,0,0,332000,0,332000,332000
056583,昇陽半元大98購02,0,0,0,0,0,0,0,0,0,331000,0,0,0,553000,222000,331000,331000
054252,奇力新元大96購04,0,0,0,0,0,0,0,0,0,331000,0,0,0,495000,164000,331000,331000
055707,聯鈞永豐98購01  ,0,0,0,0,0,0,0,0,0,330000,0,0,0,389000,59000,330000,330000
055569,聚陽統一98購01  ,0,0,0,0,0,0,0,0,0,330000,0,0,0,408000,78000,330000,330000
056639,國產康和98購01  ,0,0,0,0,0,0,0,0,0,329000,0,0,0,382000,53000,329000,329000
03421B,臺股指元大99熊01,0,0,0,0,0,0,0,0,0,329000,0,0,0,460000,131000,329000,329000
054756,世紀鋼凱基99購01,0,0,0,0,0,0,0,0,0,328000,0,0,0,450000,122000,328000,328000
053062,緯穎富邦97購01  ,0,0,0,0,0,0,0,0,0,328000,0,0,0,342000,14000,328000,328000
06013P,世芯國泰97售03  ,0,0,0,0,0,0,0,0,0,327000,0,0,0,440000,113000,327000,327000
056620,華新科永豐98購02,0,0,0,0,0,0,0,0,0,326000,0,0,0,336000,10000,326000,326000
045414,康控群益94購02  ,0,0,0,0,0,0,0,0,0,326000,0,0,0,344000,18000,326000,326000
052538,和大統一95購02  ,0,0,0,0,0,0,0,0,0,326000,0,0,0,326000,0,326000,326000
054396,日電貿永豐96購02,0,0,0,0,0,0,0,0,0,326000,0,0,0,381000,55000,326000,326000
05530P,臺股指群益96售03,0,0,0,0,0,0,0,0,0,325000,0,0,0,365000,40000,325000,325000
051500,聯茂群益95購01  ,0,0,0,0,0,0,0,0,0,323000,0,0,0,484000,161000,323000,323000
06348P,鈺齊元富97售02  ,0,0,0,0,0,0,0,0,0,323000,0,0,0,819000,496000,323000,323000
055138,大毅永豐97購02  ,0,0,0,0,0,0,0,0,0,322000,0,0,0,397000,75000,322000,322000
053170,茂林群益96購04  ,0,0,0,0,0,0,0,0,0,322000,0,0,0,458000,136000,322000,322000
8131,福懋科          ,209000,92000,117000,0,0,0,0,0,0,205000,0,0,0,282000,77000,205000,322000
055540,京鼎台新97購01  ,0,0,0,0,0,0,0,0,0,321000,0,0,0,399000,78000,321000,321000
03857P,聯發科元富99售02,0,0,0,0,0,0,0,0,0,321000,0,0,0,341000,20000,321000,321000
052069,聯茂兆豐96購01  ,0,0,0,0,0,0,0,0,0,321000,0,0,0,321000,0,321000,321000
056696,茂林群益98購02  ,0,0,0,0,0,0,0,0,0,319000,0,0,0,555000,236000,319000,319000
051367,可成富邦97購01  ,0,0,0,0,0,0,0,0,0,319000,0,0,0,879000,560000,319000,319000
056573,華新科元大99購06,0,0,0,0,0,0,0,0,0,317000,0,0,0,380000,63000,317000,317000
052106,明泰兆豐95購01  ,0,0,0,0,0,0,0,0,0,317000,0,0,0,338000,21000,317000,317000
056991,牧德兆豐98購01  ,0,0,0,0,0,0,0,0,0,316000,0,0,0,326000,10000,316000,316000
052456,滬深2X元富9B購03,0,0,0,0,0,0,0,0,0,316000,0,0,0,531000,215000,316000,316000
050006,華擎永豐94購03  ,0,0,0,0,0,0,0,0,0,316000,0,0,0,383000,67000,316000,316000
050562,瑞昱元富94購02  ,0,0,0,0,0,0,0,0,0,316000,0,0,0,626000,310000,316000,316000
050197,矽格元大94購04  ,0,0,0,0,0,0,0,0,0,316000,0,0,0,336000,20000,316000,316000
3673,TPK-KY          ,474000,472000,2000,0,0,0,0,0,0,314000,47000,10000,37000,280000,3000,277000,316000
052575,茂林凱基96購04  ,0,0,0,0,0,0,0,0,0,313000,0,0,0,313000,0,313000,313000
048773,貿聯凱基94購01  ,0,0,0,0,0,0,0,0,0,312000,0,0,0,323000,11000,312000,312000
051673,玉晶光元大96購04,0,0,0,0,0,0,0,0,0,312000,0,0,0,349000,37000,312000,312000
05068P,鴻海統一95售06  ,0,0,0,0,0,0,0,0,0,312000,0,0,0,312000,0,312000,312000
053192,創意統一96購01  ,0,0,0,0,0,0,0,0,0,312000,0,0,0,390000,78000,312000,312000
054575,聯鈞元大97購01  ,0,0,0,0,0,0,0,0,0,312000,0,0,0,530000,218000,312000,312000
04041P,大立光統一94售03,0,0,0,0,0,0,0,0,0,311000,0,0,0,311000,0,311000,311000
03604P,群創凱基98售05  ,0,0,0,0,0,0,0,0,0,310000,0,0,0,310000,0,310000,310000
05404P,台積電群益95售06,0,0,0,0,0,0,0,0,0,310000,0,0,0,315000,5000,310000,310000
05221P,玉晶光元大95售04,0,0,0,0,0,0,0,0,0,310000,0,0,0,310000,0,310000,310000
05361P,聯發科富邦97售01,0,0,0,0,0,0,0,0,0,310000,0,0,0,310000,0,310000,310000
06246P,茂林元富97售03  ,0,0,0,0,0,0,0,0,0,310000,0,0,0,384000,74000,310000,310000
052341,泰鼎凱基96購02  ,0,0,0,0,0,0,0,0,0,308000,0,0,0,348000,40000,308000,308000
05227P,大立光統一95售04,0,0,0,0,0,0,0,0,0,308000,0,0,0,308000,0,308000,308000
04434P,玉晶光國票96售02,0,0,0,0,0,0,0,0,0,307000,0,0,0,478000,171000,307000,307000
04770P,鴻海元大94售09  ,0,0,0,0,0,0,0,0,0,307000,0,0,0,307000,0,307000,307000
046572,貿聯國泰94購01  ,0,0,0,0,0,0,0,0,0,306000,0,0,0,306000,0,306000,306000
053478,京鼎元大96購01  ,0,0,0,0,0,0,0,0,0,306000,0,0,0,745000,439000,306000,306000
047536,正崴日盛93購01  ,0,0,0,0,0,0,0,0,0,305000,0,0,0,305000,0,305000,305000
051948,滬深2X元富9B購01,0,0,0,0,0,0,0,0,0,305000,0,0,0,311000,6000,305000,305000
05884P,旺宏統一96售01  ,0,0,0,0,0,0,0,0,0,303000,0,0,0,371000,68000,303000,303000
055645,技嘉元富97購01  ,0,0,0,0,0,0,0,0,0,303000,0,0,0,327000,24000,303000,303000
055876,美食元富9A購01  ,0,0,0,0,0,0,0,0,0,300000,0,0,0,398000,98000,300000,300000
056670,樺漢國票99購01  ,0,0,0,0,0,0,0,0,0,300000,0,0,0,300000,0,300000,300000
047969,台達電富邦97購01,0,0,0,0,0,0,0,0,0,300000,0,0,0,481000,181000,300000,300000
04779P,大立光凱基94售10,0,0,0,0,0,0,0,0,0,300000,0,0,0,300000,0,300000,300000
04471P,華通元大95售03  ,0,0,0,0,0,0,0,0,0,300000,0,0,0,350000,50000,300000,300000
043018,新光金元大93購01,0,0,0,0,0,0,0,0,0,300000,0,0,0,300000,0,300000,300000
046180,裕隆凱基93購01  ,0,0,0,0,0,0,0,0,0,300000,0,0,0,300000,0,300000,300000
049728,正崴中信94購01  ,0,0,0,0,0,0,0,0,0,300000,0,0,0,300000,0,300000,300000
053589,宏達電元大97購02,0,0,0,0,0,0,0,0,0,300000,0,0,0,300000,0,300000,300000
052785,滬深2X中信99購03,0,0,0,0,0,0,0,0,0,300000,0,0,0,405000,105000,300000,300000
055312,台虹群益99購01  ,0,0,0,0,0,0,0,0,0,299000,0,0,0,306000,7000,299000,299000
043665,和鑫元大93購01  ,0,0,0,0,0,0,0,0,0,299000,0,0,0,300000,1000,299000,299000
05156P,群創兆豐95售01  ,0,0,0,0,0,0,0,0,0,299000,0,0,0,299000,0,299000,299000
051249,潤泰全元大95購01,0,0,0,0,0,0,0,0,0,299000,0,0,0,553000,254000,299000,299000
06413P,聯發科凱基97售11,0,0,0,0,0,0,0,0,0,299000,0,0,0,299000,0,299000,299000
050304,台光電中信94購01,0,0,0,0,0,0,0,0,0,298000,0,0,0,700000,402000,298000,298000
048769,聯鈞凱基94購01  ,0,0,0,0,0,0,0,0,0,297000,0,0,0,410000,113000,297000,297000
046921,日電貿永豐93購01,0,0,0,0,0,0,0,0,0,296000,0,0,0,296000,0,296000,296000
03438P,群創群益98售03  ,0,0,0,0,0,0,0,0,0,296000,0,0,0,296000,0,296000,296000
054891,聯鈞統一99購02  ,0,0,0,0,0,0,0,0,0,296000,0,0,0,594000,298000,296000,296000
055381,茂林元大97購02  ,0,0,0,0,0,0,0,0,0,295000,0,0,0,482000,187000,295000,295000
046919,大毅永豐93購01  ,0,0,0,0,0,0,0,0,0,294000,0,0,0,316000,22000,294000,294000
055891,鴻海統一9A購01  ,0,0,0,0,0,0,0,0,0,293000,0,0,0,713000,420000,293000,293000
048475,台郡永豐93購02  ,0,0,0,0,0,0,0,0,0,293000,0,0,0,303000,10000,293000,293000
054170,泰鼎凱基98購01  ,0,0,0,0,0,0,0,0,0,293000,0,0,0,369000,76000,293000,293000
053537,玉晶光永豐98購02,0,0,0,0,0,0,0,0,0,293000,0,0,0,300000,7000,293000,293000
03267P,台灣50元大02售06,0,0,0,0,0,0,0,0,0,292000,0,0,0,292000,0,292000,292000
054564,玉晶光群益99購01,0,0,0,0,0,0,0,0,0,292000,0,0,0,328000,36000,292000,292000
050100,台積電永昌96購02,0,0,0,0,0,0,0,0,0,291000,0,0,0,680000,389000,291000,291000
055907,台虹兆豐98購01  ,0,0,0,0,0,0,0,0,0,290000,0,0,0,290000,0,290000,290000
04780P,大立光凱基94售11,0,0,0,0,0,0,0,0,0,290000,0,0,0,290000,0,290000,290000
049500,聯茂元大94購04  ,0,0,0,0,0,0,0,0,0,290000,0,0,0,290000,0,290000,290000
04890P,台積電元大95售05,0,0,0,0,0,0,0,0,0,290000,0,0,0,290000,0,290000,290000
052371,元金2X元大95購01,0,0,0,0,0,0,0,0,0,290000,0,0,0,300000,10000,290000,290000
3376,新日興          ,462000,176000,286000,0,0,0,35000,0,35000,-31000,90000,9000,81000,46000,158000,-112000,290000
051719,鴻海永豐95購04  ,0,0,0,0,0,0,0,0,0,289000,0,0,0,299000,10000,289000,289000
053574,奇力新元富99購01,0,0,0,0,0,0,0,0,0,289000,0,0,0,386000,97000,289000,289000
055131,茂林康和97購01  ,0,0,0,0,0,0,0,0,0,288000,0,0,0,327000,39000,288000,288000
04592P,台積電元大94售10,0,0,0,0,0,0,0,0,0,287000,0,0,0,290000,3000,287000,287000
050776,康控元大96購03  ,0,0,0,0,0,0,0,0,0,287000,0,0,0,287000,0,287000,287000
055235,金寶台新98購01  ,0,0,0,0,0,0,0,0,0,287000,0,0,0,342000,55000,287000,287000
054682,東元永豐97購01  ,0,0,0,0,0,0,0,0,0,287000,0,0,0,287000,0,287000,287000
2014,中鴻            ,354000,67000,287000,0,0,0,0,0,0,0,0,0,0,0,0,0,287000
055411,國巨富邦9A購02  ,0,0,0,0,0,0,0,0,0,285000,0,0,0,636000,351000,285000,285000
056495,泰鼎國泰99購01  ,0,0,0,0,0,0,0,0,0,285000,0,0,0,291000,6000,285000,285000
056704,健策國泰99購01  ,0,0,0,0,0,0,0,0,0,285000,0,0,0,314000,29000,285000,285000
06139P,台積電中信99售02,0,0,0,0,0,0,0,0,0,284000,0,0,0,302000,18000,284000,284000
053143,昇陽半永豐96購03,0,0,0,0,0,0,0,0,0,284000,0,0,0,304000,20000,284000,284000
051696,新日興中信96購01,0,0,0,0,0,0,0,0,0,282000,0,0,0,367000,85000,282000,282000
2412,中華電          ,1302000,1029000,273000,0,0,0,0,0,0,9000,11000,2000,9000,0,0,0,282000
2441,超豐            ,387000,117000,270000,0,0,0,0,0,0,12000,12000,0,12000,0,0,0,282000
046349,康控兆豐93購02  ,0,0,0,0,0,0,0,0,0,281000,0,0,0,281000,0,281000,281000
06006P,欣興永豐96售04  ,0,0,0,0,0,0,0,0,0,280000,0,0,0,360000,80000,280000,280000
050770,全新元大94購04  ,0,0,0,0,0,0,0,0,0,280000,0,0,0,280000,0,280000,280000
054463,瑞昱凱基97購01  ,0,0,0,0,0,0,0,0,0,280000,0,0,0,396000,116000,280000,280000
05413P,台郡國票96售02  ,0,0,0,0,0,0,0,0,0,280000,0,0,0,516000,236000,280000,280000
06622P,牧德元大98售01  ,0,0,0,0,0,0,0,0,0,280000,0,0,0,321000,41000,280000,280000
048897,日電貿國泰95購01,0,0,0,0,0,0,0,0,0,279000,0,0,0,279000,0,279000,279000
054493,同欣電台新96購01,0,0,0,0,0,0,0,0,0,279000,0,0,0,309000,30000,279000,279000
053385,聯詠元大96購02  ,0,0,0,0,0,0,0,0,0,279000,0,0,0,291000,12000,279000,279000
052344,台表科凱基98購01,0,0,0,0,0,0,0,0,0,278000,0,0,0,308000,30000,278000,278000
054308,嘉晶凱基98購01  ,0,0,0,0,0,0,0,0,0,278000,0,0,0,410000,132000,278000,278000
047639,聯發科元大93購16,0,0,0,0,0,0,0,0,0,275000,0,0,0,275000,0,275000,275000
049499,康控元大96購01  ,0,0,0,0,0,0,0,0,0,275000,0,0,0,389000,114000,275000,275000
055524,鴻海群益98購01  ,0,0,0,0,0,0,0,0,0,274000,0,0,0,466000,192000,274000,274000
05529P,臺股指群益96售02,0,0,0,0,0,0,0,0,0,274000,0,0,0,474000,200000,274000,274000
053070,訊芯群益96購01  ,0,0,0,0,0,0,0,0,0,274000,0,0,0,387000,113000,274000,274000
055399,超眾統一99購01  ,0,0,0,0,0,0,0,0,0,273000,0,0,0,428000,155000,273000,273000
3026,禾伸堂          ,585000,235000,350000,0,0,0,0,0,0,-77000,0,31000,-31000,41000,87000,-46000,273000
056394,晶豪科永豐98購01,0,0,0,0,0,0,0,0,0,272000,0,0,0,272000,0,272000,272000
056025,嘉晶群益97購01  ,0,0,0,0,0,0,0,0,0,272000,0,0,0,580000,308000,272000,272000
053308,智易凱基96購02  ,0,0,0,0,0,0,0,0,0,272000,0,0,0,272000,0,272000,272000
048279,聯鈞永豐93購01  ,0,0,0,0,0,0,0,0,0,271000,0,0,0,347000,76000,271000,271000
3702,大聯大          ,883000,494000,389000,0,0,0,0,0,0,-118000,4000,0,4000,0,122000,-122000,271000
04103P,臺股指國票93售10,0,0,0,0,0,0,0,0,0,270000,0,0,0,340000,70000,270000,270000
049438,嘉晶國泰96購01  ,0,0,0,0,0,0,0,0,0,270000,0,0,0,571000,301000,270000,270000
055238,茂林台新97購01  ,0,0,0,0,0,0,0,0,0,269000,0,0,0,269000,0,269000,269000
1217,愛之味          ,343000,74000,269000,0,0,0,0,0,0,0,0,0,0,0,0,0,269000
056146,台虹元大98購01  ,0,0,0,0,0,0,0,0,0,267000,0,0,0,267000,0,267000,267000
055333,晶豪科兆豐97購01,0,0,0,0,0,0,0,0,0,267000,0,0,0,300000,33000,267000,267000
052053,泰鼎凱基96購01  ,0,0,0,0,0,0,0,0,0,267000,0,0,0,349000,82000,267000,267000
054254,晶豪科元大96購02,0,0,0,0,0,0,0,0,0,267000,0,0,0,282000,15000,267000,267000
055482,聚陽元大97購02  ,0,0,0,0,0,0,0,0,0,266000,0,0,0,275000,9000,266000,266000
04747P,臺股指元大94售22,0,0,0,0,0,0,0,0,0,266000,0,0,0,1053000,787000,266000,266000
050536,亞泥凱基95購01  ,0,0,0,0,0,0,0,0,0,266000,0,0,0,269000,3000,266000,266000
051195,台郡中信95購01  ,0,0,0,0,0,0,0,0,0,266000,0,0,0,405000,139000,266000,266000
056059,美律元大98購02  ,0,0,0,0,0,0,0,0,0,265000,0,0,0,563000,298000,265000,265000
057096,緯穎元富98購01  ,0,0,0,0,0,0,0,0,0,265000,0,0,0,265000,0,265000,265000
05076P,深中小群益99售02,0,0,0,0,0,0,0,0,0,264000,0,0,0,700000,436000,264000,264000
053114,聯茂兆豐97購01  ,0,0,0,0,0,0,0,0,0,264000,0,0,0,319000,55000,264000,264000
2534,宏盛            ,324000,61000,263000,0,0,0,0,0,0,1000,3000,2000,1000,0,0,0,264000
053556,康控凱基97購02  ,0,0,0,0,0,0,0,0,0,263000,0,0,0,270000,7000,263000,263000
051958,貿聯台新95購01  ,0,0,0,0,0,0,0,0,0,262000,0,0,0,313000,51000,262000,262000
055700,緯穎國泰98購02  ,0,0,0,0,0,0,0,0,0,261000,0,0,0,446000,185000,261000,261000
04705P,臺股指統一95售02,0,0,0,0,0,0,0,0,0,261000,0,0,0,261000,0,261000,261000
05821P,臺股指凱基96售18,0,0,0,0,0,0,0,0,0,260000,0,0,0,285000,25000,260000,260000
045287,元油2X元大95購01,0,0,0,0,0,0,0,0,0,260000,0,0,0,260000,0,260000,260000
049745,國巨永豐94購04  ,0,0,0,0,0,0,0,0,0,260000,0,0,0,317000,57000,260000,260000
052784,緯穎國票97購02  ,0,0,0,0,0,0,0,0,0,260000,0,0,0,260000,0,260000,260000
045871,元油2X元富96購03,0,0,0,0,0,0,0,0,0,259000,0,0,0,262000,3000,259000,259000
049977,瑞昱凱基94購03  ,0,0,0,0,0,0,0,0,0,259000,0,0,0,429000,170000,259000,259000
3413,京鼎            ,383000,73000,310000,0,0,0,33000,0,33000,-84000,43000,10000,33000,54000,171000,-117000,259000
05848P,臺股指元大96售24,0,0,0,0,0,0,0,0,0,258000,0,0,0,258000,0,258000,258000
049770,康控元富95購01  ,0,0,0,0,0,0,0,0,0,258000,0,0,0,561000,303000,258000,258000
049598,超眾元大95購03  ,0,0,0,0,0,0,0,0,0,258000,0,0,0,258000,0,258000,258000
054465,亞光凱基97購01  ,0,0,0,0,0,0,0,0,0,258000,0,0,0,334000,76000,258000,258000
020000,富邦特選蘋果N   ,0,0,0,0,0,0,0,0,0,257000,0,0,0,436000,179000,257000,257000
006206,元大上證50      ,104000,4000,100000,0,0,0,0,0,0,156000,0,0,0,177000,21000,156000,256000
052747,京鼎元大97購01  ,0,0,0,0,0,0,0,0,0,256000,0,0,0,563000,307000,256000,256000
2349,錸德            ,358000,103000,255000,0,0,0,0,0,0,1000,1000,0,1000,0,0,0,256000
04439P,聯發科群益94售04,0,0,0,0,0,0,0,0,0,254000,0,0,0,263000,9000,254000,254000
056403,茂林群益98購01  ,0,0,0,0,0,0,0,0,0,251000,0,0,0,510000,259000,251000,251000
050941,T50反1群益95購01,0,0,0,0,0,0,0,0,0,251000,0,0,0,550000,299000,251000,251000
05162P,玉晶光國票96售03,0,0,0,0,0,0,0,0,0,251000,0,0,0,471000,220000,251000,251000
054506,矽格永豐96購01  ,0,0,0,0,0,0,0,0,0,251000,0,0,0,251000,0,251000,251000
05813P,臺股指國票96售06,0,0,0,0,0,0,0,0,0,250000,0,0,0,250000,0,250000,250000
04337P,台積電元大93售25,0,0,0,0,0,0,0,0,0,250000,0,0,0,250000,0,250000,250000
047102,潤泰全富邦95購01,0,0,0,0,0,0,0,0,0,250000,0,0,0,250000,0,250000,250000
050116,嘉澤元大94購03  ,0,0,0,0,0,0,0,0,0,250000,0,0,0,257000,7000,250000,250000
05094P,大立光元大95售07,0,0,0,0,0,0,0,0,0,250000,0,0,0,315000,65000,250000,250000
049785,華新科兆豐95購01,0,0,0,0,0,0,0,0,0,250000,0,0,0,378000,128000,250000,250000
050957,T50反1台新05購01,0,0,0,0,0,0,0,0,0,250000,0,0,0,250000,0,250000,250000
05496P,聯詠統一95售04  ,0,0,0,0,0,0,0,0,0,250000,0,0,0,250000,0,250000,250000
06390P,美律國票97售03  ,0,0,0,0,0,0,0,0,0,250000,0,0,0,260000,10000,250000,250000
06217P,鴻海元富97售05  ,0,0,0,0,0,0,0,0,0,250000,0,0,0,250000,0,250000,250000
056643,奇力新凱基99購01,0,0,0,0,0,0,0,0,0,249000,0,0,0,265000,16000,249000,249000
05446P,緯穎元大95售04  ,0,0,0,0,0,0,0,0,0,249000,0,0,0,249000,0,249000,249000
057110,立積群益98購01  ,0,0,0,0,0,0,0,0,0,248000,0,0,0,346000,98000,248000,248000
047280,泰鼎永豐93購01  ,0,0,0,0,0,0,0,0,0,248000,0,0,0,260000,12000,248000,248000
055198,奇力新第一97購01,0,0,0,0,0,0,0,0,0,248000,0,0,0,430000,182000,248000,248000
05374P,台積電國票96售07,0,0,0,0,0,0,0,0,0,247000,0,0,0,262000,15000,247000,247000
2481,強茂            ,256000,29000,227000,0,0,0,0,0,0,20000,4000,0,4000,22000,6000,16000,247000
3576,聯合再生        ,446000,152000,294000,0,0,0,0,0,0,-47000,3000,50000,-47000,0,0,0,247000
056812,泰鼎統一98購01  ,0,0,0,0,0,0,0,0,0,246000,0,0,0,272000,26000,246000,246000
055374,明泰元大97購01  ,0,0,0,0,0,0,0,0,0,246000,0,0,0,246000,0,246000,246000
04670P,臺股指國票94售09,0,0,0,0,0,0,0,0,0,246000,0,0,0,246000,0,246000,246000
052461,和大統一95購01  ,0,0,0,0,0,0,0,0,0,246000,0,0,0,246000,0,246000,246000
054943,群光元大97購01  ,0,0,0,0,0,0,0,0,0,246000,0,0,0,336000,90000,246000,246000
056719,台虹永豐98購01  ,0,0,0,0,0,0,0,0,0,245000,0,0,0,255000,10000,245000,245000
054000,訊芯群益96購02  ,0,0,0,0,0,0,0,0,0,245000,0,0,0,325000,80000,245000,245000
051986,燿華元大96購04  ,0,0,0,0,0,0,0,0,0,244000,0,0,0,245000,1000,244000,244000
053540,健策永豐96購01  ,0,0,0,0,0,0,0,0,0,244000,0,0,0,244000,0,244000,244000
039900,上証2X國泰92購01,0,0,0,0,0,0,0,0,0,243000,0,0,0,243000,0,243000,243000
06313P,訊芯元富97售01  ,0,0,0,0,0,0,0,0,0,243000,0,0,0,243000,0,243000,243000
2006,東和鋼鐵        ,119000,30000,89000,0,0,0,0,0,0,154000,154000,0,154000,0,0,0,243000
03162P,泰碩元大01售02  ,0,0,0,0,0,0,0,0,0,242000,0,0,0,242000,0,242000,242000
053772,大成鋼元大96購02,0,0,0,0,0,0,0,0,0,242000,0,0,0,310000,68000,242000,242000
056751,和大兆豐98購01  ,0,0,0,0,0,0,0,0,0,241000,0,0,0,339000,98000,241000,241000
057087,台郡統一99購01  ,0,1000,-1000,0,0,0,0,0,0,242000,0,0,0,242000,0,242000,241000
052115,T50反1國票95購03,0,0,0,0,0,0,0,0,0,241000,0,0,0,361000,120000,241000,241000
055262,台虹國泰98購01  ,0,0,0,0,0,0,0,0,0,241000,0,0,0,252000,11000,241000,241000
03266P,寶成國票04售01  ,0,0,0,0,0,0,0,0,0,240000,0,0,0,240000,0,240000,240000
044763,瀚宇博凱基93購01,0,0,0,0,0,0,0,0,0,240000,0,0,0,245000,5000,240000,240000
06538P,國巨凱基98售11  ,0,0,0,0,0,0,0,0,0,240000,0,0,0,240000,0,240000,240000
2880,華南金          ,1469000,1232000,237000,0,0,0,2000,0,2000,1000,1000,0,1000,0,0,0,240000
055629,華新科永豐97購04,0,0,0,0,0,0,0,0,0,239000,0,0,0,388000,149000,239000,239000
04404P,玉晶光國票94售01,0,0,0,0,0,0,0,0,0,239000,0,0,0,269000,30000,239000,239000
047901,復盛群益93購01  ,0,0,0,0,0,0,0,0,0,239000,0,0,0,239000,0,239000,239000
047673,瑞昱元富96購01  ,0,0,0,0,0,0,0,0,0,239000,0,0,0,454000,215000,239000,239000
04863P,技嘉元大94售02  ,0,0,0,0,0,0,0,0,0,238000,0,0,0,373000,135000,238000,238000
048733,台勝科麥證95購02,0,0,0,360000,122000,238000,0,0,0,238000,0,0,0,360000,122000,238000,238000
055564,茂林凱基98購01  ,0,0,0,0,0,0,0,0,0,237000,0,0,0,287000,50000,237000,237000
056166,微星台新97購01  ,0,0,0,0,0,0,0,0,0,237000,0,0,0,247000,10000,237000,237000
056243,創意群益97購03  ,0,0,0,0,0,0,0,0,0,236000,0,0,0,236000,0,236000,236000
055189,台虹統一97購01  ,0,0,0,0,0,0,0,0,0,236000,0,0,0,236000,0,236000,236000
2027,大成鋼          ,674000,253000,421000,0,0,0,0,0,0,-185000,6000,0,6000,1000,192000,-191000,236000
056210,矽創永豐97購02  ,0,0,0,0,0,0,0,0,0,235000,0,0,0,235000,0,235000,235000
055425,聚陽群益99購01  ,0,0,0,0,0,0,0,0,0,235000,0,0,0,249000,14000,235000,235000
05178P,大立光凱基96售05,0,0,0,0,0,0,0,0,0,235000,0,0,0,335000,100000,235000,235000
048068,南亞科元富95購01,0,0,0,0,0,0,0,0,0,235000,0,0,0,334000,99000,235000,235000
051968,勤誠永豐95購01  ,0,0,0,0,0,0,0,0,0,235000,0,0,0,235000,0,235000,235000
054886,大毅統一97購01  ,0,0,0,0,0,0,0,0,0,235000,0,0,0,250000,15000,235000,235000
052988,智易元大96購02  ,0,0,0,0,0,0,0,0,0,235000,0,0,0,235000,0,235000,235000
2498,宏達電          ,462000,179000,283000,0,0,0,0,0,0,-48000,3000,0,3000,87000,138000,-51000,235000
050414,泰鼎永豐94購04  ,0,0,0,0,0,0,0,0,0,234000,0,0,0,248000,14000,234000,234000
054878,和大統一97購02  ,0,0,0,0,0,0,0,0,0,234000,0,0,0,266000,32000,234000,234000
055256,日電貿統一99購01,0,0,0,0,0,0,0,0,0,234000,0,0,0,262000,28000,234000,234000
056629,昇陽半永豐98購01,0,0,0,0,0,0,0,0,0,233000,0,0,0,280000,47000,233000,233000
051316,T50反1國票95購02,0,0,0,0,0,0,0,0,0,233000,0,0,0,233000,0,233000,233000
05262P,台積電元大95售19,0,0,0,0,0,0,0,0,0,233000,0,0,0,233000,0,233000,233000
057251,泰鼎統一98購02  ,0,0,0,0,0,0,0,0,0,232000,0,0,0,278000,46000,232000,232000
055858,聯茂元大97購03  ,0,0,0,0,0,0,0,0,0,232000,0,0,0,299000,67000,232000,232000
054458,復盛群益96購01  ,0,0,0,0,0,0,0,0,0,232000,0,0,0,287000,55000,232000,232000
05722P,玉晶光國票97售03,0,0,0,0,0,0,0,0,0,231000,0,0,0,305000,74000,231000,231000
045516,聯茂統一94購01  ,0,0,0,0,0,0,0,0,0,231000,0,0,0,339000,108000,231000,231000
052386,鴻海群益96購02  ,0,0,0,0,0,0,0,0,0,231000,0,0,0,536000,305000,231000,231000
06016P,京元電凱基96售03,0,0,0,0,0,0,0,0,0,230000,0,0,0,280000,50000,230000,230000
057089,奇力新元富98購01,0,0,0,0,0,0,0,0,0,230000,0,0,0,290000,60000,230000,230000
049538,元油2X群益98購01,0,0,0,0,0,0,0,0,0,229000,0,0,0,281000,52000,229000,229000
050327,泰鼎永豐94購03  ,0,0,0,0,0,0,0,0,0,229000,0,0,0,230000,1000,229000,229000
055338,GIS兆豐97購01   ,0,0,0,0,0,0,0,0,0,228000,0,0,0,228000,0,228000,228000
056311,泰鼎元大98購01  ,0,0,0,0,0,0,0,0,0,228000,0,0,0,744000,516000,228000,228000
05154P,台積電兆豐95售05,0,0,0,0,0,0,0,0,0,228000,0,0,0,228000,0,228000,228000
052576,聯茂凱基96購01  ,0,0,0,0,0,0,0,0,0,228000,0,0,0,300000,72000,228000,228000
055177,宏達電統一99購01,0,0,0,0,0,0,0,0,0,228000,0,0,0,228000,0,228000,228000
1513,中興電          ,604000,293000,311000,0,0,0,0,50000,-50000,-33000,0,33000,-33000,0,0,0,228000
054486,漢唐台新96購01  ,0,0,0,0,0,0,0,0,0,227000,0,0,0,237000,10000,227000,227000
053281,茂林元大96購02  ,0,0,0,0,0,0,0,0,0,227000,0,0,0,301000,74000,227000,227000
04025P,宏達電國泰94售01,0,0,0,0,0,0,0,0,0,226000,0,0,0,226000,0,226000,226000
051785,臻鼎兆豐96購01  ,0,0,0,0,0,0,0,0,0,226000,0,0,0,256000,30000,226000,226000
050828,康控凱基95購01  ,0,0,0,0,0,0,0,0,0,226000,0,0,0,226000,0,226000,226000
051996,康友元大95購01  ,0,0,0,0,0,0,0,0,0,226000,0,0,0,245000,19000,226000,226000
06024P,台郡國票97售05  ,0,0,0,0,0,0,0,0,0,225000,0,0,0,274000,49000,225000,225000
047297,康控元富93購01  ,0,0,0,0,0,0,0,0,0,225000,0,0,0,225000,0,225000,225000
048100,貿聯凱基93購02  ,0,0,0,0,0,0,0,0,0,224000,0,0,0,224000,0,224000,224000
00676R,富邦臺灣加權反1 ,0,0,0,0,0,0,0,0,0,224000,0,0,0,528000,304000,224000,224000
044464,滬深2X群益95購01,0,0,0,0,0,0,0,0,0,224000,0,0,0,250000,26000,224000,224000
052415,台表科麥證95購02,0,0,0,234000,10000,224000,0,0,0,224000,0,0,0,234000,10000,224000,224000
057074,立積永豐98購01  ,0,0,0,0,0,0,0,0,0,223000,0,0,0,287000,64000,223000,223000
055127,台虹兆豐97購01  ,0,0,0,0,0,0,0,0,0,223000,0,0,0,273000,50000,223000,223000
2406,國碩            ,794000,571000,223000,0,0,0,0,0,0,0,0,0,0,0,0,0,223000
05618P,聯發科元富96售02,0,0,0,0,0,0,0,0,0,222000,0,0,0,259000,37000,222000,222000
055729,金寶元富99購01  ,0,0,0,0,0,0,0,0,0,222000,0,0,0,334000,112000,222000,222000
047989,深中小元大96購02,0,0,0,0,0,0,0,0,0,222000,0,0,0,490000,268000,222000,222000
050595,緯穎永豐94購03  ,0,0,0,0,0,0,0,0,0,222000,0,0,0,242000,20000,222000,222000
055093,京鼎群益98購01  ,0,0,0,0,0,0,0,0,0,222000,0,0,0,684000,462000,222000,222000
054689,華新科永豐97購01,0,0,0,0,0,0,0,0,0,222000,0,0,0,284000,62000,222000,222000
05330P,臺股指凱基95售14,0,0,0,0,0,0,0,0,0,222000,0,0,0,258000,36000,222000,222000
8150,南茂            ,552000,351000,201000,0,0,0,0,0,0,21000,3000,0,3000,73000,55000,18000,222000
056685,光罩統一98購03  ,0,0,0,0,0,0,0,0,0,221000,0,0,0,342000,121000,221000,221000
05163P,聯發科統一96售02,0,0,0,0,0,0,0,0,0,221000,0,0,0,398000,177000,221000,221000
049988,貿聯凱基94購02  ,0,0,0,0,0,0,0,0,0,221000,0,0,0,261000,40000,221000,221000
055065,神達永豐97購01  ,0,0,0,0,0,0,0,0,0,221000,0,0,0,1013000,792000,221000,221000
08525P,台灣50凱基96售02,0,0,0,0,0,0,0,0,0,221000,0,0,0,221000,0,221000,221000
056584,鴻海統一9B購01  ,0,0,0,0,0,0,0,0,0,220000,0,0,0,231000,11000,220000,220000
057385,光罩永豐99購01  ,0,0,0,0,0,0,0,0,0,220000,0,0,0,238000,18000,220000,220000
04667P,臺股指國票94售06,0,0,0,0,0,0,0,0,0,220000,0,0,0,220000,0,220000,220000
047571,滬深2X群益99購01,0,0,0,0,0,0,0,0,0,220000,0,0,0,527000,307000,220000,220000
048626,矽創台新93購01  ,0,0,0,0,0,0,0,0,0,220000,0,0,0,271000,51000,220000,220000
049237,元油2X元富96購07,0,0,0,0,0,0,0,0,0,220000,0,0,0,250000,30000,220000,220000
050930,矽格凱基95購01  ,0,0,0,0,0,0,0,0,0,220000,0,0,0,220000,0,220000,220000
052610,貿聯元大97購01  ,0,0,0,0,0,0,0,0,0,220000,0,0,0,241000,21000,220000,220000
054137,聯詠元大97購02  ,0,0,0,0,0,0,0,0,0,220000,0,0,0,262000,42000,220000,220000
05375P,健策國票96售02  ,0,0,0,0,0,0,0,0,0,220000,0,0,0,350000,130000,220000,220000
06508P,台灣50統一98售01,0,0,0,0,0,0,0,0,0,220000,0,0,0,385000,165000,220000,220000
05670P,台積電國票98售01,0,0,0,0,0,0,0,0,0,218000,0,0,0,270000,52000,218000,218000
049188,可成台新94購01  ,0,0,0,0,0,0,0,0,0,218000,0,0,0,218000,0,218000,218000
053888,和大群益97購01  ,0,0,0,0,0,0,0,0,0,218000,0,0,0,397000,179000,218000,218000
055635,緯穎永豐97購01  ,0,0,0,0,0,0,0,0,0,217000,0,0,0,275000,58000,217000,217000
05584P,臺股指凱基96售13,0,0,0,0,0,0,0,0,0,217000,0,0,0,307000,90000,217000,217000
044105,聯詠中信95購01  ,0,0,0,0,0,0,0,0,0,217000,0,0,0,217000,0,217000,217000
00708L,元大S&P黃金正2  ,0,0,0,0,0,0,0,0,0,217000,0,0,0,2295000,2078000,217000,217000
048928,華新科永豐94購02,0,0,0,0,0,0,0,0,0,217000,0,0,0,339000,122000,217000,217000
1216,統一            ,1831000,1563000,268000,0,0,0,1000,7000,-6000,-45000,14000,79000,-65000,26000,6000,20000,217000
8926,台汽電          ,310000,94000,216000,0,0,0,0,0,0,0,0,0,0,0,0,0,216000
057177,奇力新元大99購04,0,0,0,0,0,0,0,0,0,215000,0,0,0,350000,135000,215000,215000
054490,臻鼎台新96購02  ,0,0,0,0,0,0,0,0,0,215000,0,0,0,253000,38000,215000,215000
055372,宏達電元大97購04,0,0,0,0,0,0,0,0,0,214000,0,0,0,216000,2000,214000,214000
05638P,國巨統一96售04  ,0,0,0,0,0,0,0,0,0,213000,0,0,0,443000,230000,213000,213000
049217,智邦國票95購01  ,0,0,0,0,0,0,0,0,0,213000,0,0,0,213000,0,213000,213000
049703,訊芯元大95購01  ,0,0,0,0,0,0,0,0,0,213000,0,0,0,213000,0,213000,213000
053541,泰鼎永豐96購02  ,0,0,0,0,0,0,0,0,0,213000,0,0,0,213000,0,213000,213000
052239,泰鼎國票97購01  ,0,0,0,0,0,0,0,0,0,213000,0,0,0,213000,0,213000,213000
2002,中鋼            ,2433000,2229000,204000,0,0,0,2000,0,2000,7000,1000,0,1000,6000,0,6000,213000
2355,敬鵬            ,238000,29000,209000,0,0,0,0,0,0,4000,4000,0,4000,0,0,0,213000
056626,同欣電永豐98購01,0,0,0,0,0,0,0,0,0,212000,0,0,0,470000,258000,212000,212000
049901,瑞昱元富94購01  ,0,0,0,0,0,0,0,0,0,212000,0,0,0,306000,94000,212000,212000
052941,康控兆豐97購01  ,0,0,0,0,0,0,0,0,0,212000,0,0,0,292000,80000,212000,212000
054694,聯鈞永豐97購01  ,0,0,0,0,0,0,0,0,0,212000,0,0,0,212000,0,212000,212000
056739,美律凱基98購04  ,0,0,0,0,0,0,0,0,0,211000,0,0,0,357000,146000,211000,211000
06047P,聯發科富邦99售04,0,0,0,0,0,0,0,0,0,211000,0,0,0,214000,3000,211000,211000
045088,康控元大94購02  ,0,0,0,0,0,0,0,0,0,211000,0,0,0,223000,12000,211000,211000
051944,智邦統一95購02  ,0,0,0,0,0,0,0,0,0,211000,0,0,0,519000,308000,211000,211000
056693,國產群益98購01  ,0,0,0,0,0,0,0,0,0,210000,0,0,0,210000,0,210000,210000
04233P,儒鴻兆豐93售01  ,0,0,0,0,0,0,0,0,0,210000,0,0,0,210000,0,210000,210000
048778,聯茂凱基94購04  ,0,0,0,0,0,0,0,0,0,210000,0,0,0,210000,0,210000,210000
048616,智伸科凱基93購07,0,0,0,0,0,0,0,0,0,210000,0,0,0,213000,3000,210000,210000
047651,復盛元大93購01  ,0,0,0,0,0,0,0,0,0,210000,0,0,0,210000,0,210000,210000
055205,京鼎中信99購01  ,0,0,0,0,0,0,0,0,0,210000,0,0,0,385000,175000,210000,210000
052227,瑞昱凱基95購05  ,0,0,0,0,0,0,0,0,0,210000,0,0,0,297000,87000,210000,210000
053173,矽格群益97購01  ,0,0,0,0,0,0,0,0,0,210000,0,0,0,243000,33000,210000,210000
053135,信邦國票96購01  ,0,0,0,0,0,0,0,0,0,210000,0,0,0,213000,3000,210000,210000
053912,T50反1國票97購02,0,0,0,0,0,0,0,0,0,210000,0,0,0,212000,2000,210000,210000
053755,亞光元富96購01  ,0,0,0,0,0,0,0,0,0,210000,0,0,0,509000,299000,210000,210000
06104P,大立光凱基97售04,0,0,0,0,0,0,0,0,0,209000,0,0,0,210000,1000,209000,209000
056544,貿聯凱基98購03  ,0,0,0,0,0,0,0,0,0,209000,0,0,0,219000,10000,209000,209000
03414B,臺股指凱基99熊01,0,0,0,0,0,0,0,0,0,209000,0,0,0,280000,71000,209000,209000
055250,華新科統一97購02,0,0,0,0,0,0,0,0,0,209000,0,0,0,267000,58000,209000,209000
047759,復盛元富93購01  ,0,0,0,0,0,0,0,0,0,208000,0,0,0,208000,0,208000,208000
050653,聯鈞凱基96購01  ,0,0,0,0,0,0,0,0,0,208000,0,0,0,294000,86000,208000,208000
055491,奇力新元大98購03,0,0,0,0,0,0,0,0,0,207000,0,0,0,226000,19000,207000,207000
050543,聯發科凱基95購01,0,0,0,0,0,0,0,0,0,207000,0,0,0,274000,67000,207000,207000
052635,奇力新凱基98購01,0,0,0,0,0,0,0,0,0,207000,0,0,0,220000,13000,207000,207000
05289P,鴻海永豐95售05  ,0,0,0,0,0,0,0,0,0,207000,0,0,0,364000,157000,207000,207000
054952,大毅元大97購02  ,0,0,0,0,0,0,0,0,0,206000,0,0,0,236000,30000,206000,206000
046845,燿華永豐93購01  ,0,0,0,0,0,0,0,0,0,205000,0,0,0,205000,0,205000,205000
043735,元金2X元大94購01,0,0,0,0,0,0,0,0,0,205000,0,0,0,205000,0,205000,205000
053523,T50反1中信9A購01,0,0,0,0,0,0,0,0,0,205000,0,0,0,265000,60000,205000,205000
06621P,欣興元大98售06  ,0,0,0,0,0,0,0,0,0,205000,0,0,0,210000,5000,205000,205000
056397,彩晶永豐99購01  ,0,0,0,0,0,0,0,0,0,204000,0,0,0,209000,5000,204000,204000
05744P,台表科元大96售04,0,0,0,0,0,0,0,0,0,204000,0,0,0,204000,0,204000,204000
052619,茂林國泰99購01  ,0,0,0,0,0,0,0,0,0,204000,0,0,0,205000,1000,204000,204000
054890,聯鈞統一99購01  ,0,0,0,0,0,0,0,0,0,204000,0,0,0,204000,0,204000,204000
04455P,台積電統一94售07,0,0,0,0,0,0,0,0,0,203000,0,0,0,203000,0,203000,203000
00766L,台新MSCI中國正2 ,0,0,0,0,0,0,0,0,0,203000,0,0,0,587000,384000,203000,203000
05039P,鴻海凱基95售10  ,0,0,0,0,0,0,0,0,0,203000,0,0,0,203000,0,203000,203000
050971,緯穎永豐95購01  ,0,0,0,0,0,0,0,0,0,203000,0,0,0,617000,414000,203000,203000
054847,創意兆豐97購01  ,0,0,0,0,0,0,0,0,0,203000,0,0,0,313000,110000,203000,203000
054617,超眾永豐97購01  ,0,0,0,0,0,0,0,0,0,203000,0,0,0,203000,0,203000,203000
054160,華泰凱基98購01  ,0,0,0,0,0,0,0,0,0,203000,0,0,0,203000,0,203000,203000
053354,康控兆豐97購02  ,0,0,0,0,0,0,0,0,0,203000,0,0,0,213000,10000,203000,203000
056042,京鼎凱基97購02  ,0,0,0,0,0,0,0,0,0,202000,0,0,0,235000,33000,202000,202000
049525,華新科兆豐94購01,0,0,0,0,0,0,0,0,0,201000,0,0,0,201000,0,201000,201000
052755,滬深2X群益9A購01,0,0,0,0,0,0,0,0,0,201000,0,0,0,204000,3000,201000,201000
05869P,旺宏凱基96售05  ,0,0,0,0,0,0,0,0,0,200000,0,0,0,250000,50000,200000,200000
051881,上証2X永豐95購02,0,0,0,0,0,0,0,0,0,200000,0,0,0,200000,0,200000,200000
047312,聯發科元大93購13,0,0,0,0,0,0,0,0,0,200000,0,0,0,200000,0,200000,200000
047208,智易國泰94購01  ,0,0,0,0,0,0,0,0,0,200000,0,0,0,200000,0,200000,200000
042787,新日興兆豐93購01,0,0,0,0,0,0,0,0,0,200000,0,0,0,200000,0,200000,200000
04349P,美律國票94售02  ,0,0,0,0,0,0,0,0,0,200000,0,0,0,200000,0,200000,200000
04571P,華新科國泰95售03,0,0,0,0,0,0,0,0,0,200000,0,0,0,200000,0,200000,200000
050171,臺指反元大97購03,0,0,0,0,0,0,0,0,0,200000,0,0,0,200000,0,200000,200000
051165,可成元大95購01  ,0,0,0,0,0,0,0,0,0,200000,0,0,0,214000,14000,200000,200000
049269,超眾元大96購02  ,0,0,0,0,0,0,0,0,0,200000,0,0,0,300000,100000,200000,200000
04930P,國巨統一94售08  ,0,0,0,0,0,0,0,0,0,200000,0,0,0,300000,100000,200000,200000
051533,健鼎國票96購02  ,0,0,0,0,0,0,0,0,0,200000,0,0,0,200000,0,200000,200000
049649,信邦凱基94購01  ,0,0,0,0,0,0,0,0,0,200000,0,0,0,200000,0,200000,200000
05229P,台積電群益95售05,0,0,0,0,0,0,0,0,0,200000,0,0,0,450000,250000,200000,200000
053154,聯詠元大96購01  ,0,0,0,0,0,0,0,0,0,200000,0,0,0,269000,69000,200000,200000
06635P,聯發科凱基98售15,0,0,0,0,0,0,0,0,0,200000,0,0,0,200000,0,200000,200000
2609,陽明            ,324000,124000,200000,0,0,0,0,0,0,0,0,0,0,0,0,0,200000
05692P,聯發科中信9A售02,0,0,0,0,0,0,0,0,0,199000,0,0,0,220000,21000,199000,199000
044643,滬深2X群益96購01,0,0,0,0,0,0,0,0,0,199000,0,0,0,200000,1000,199000,199000
048724,台達電日盛94購01,0,0,0,0,0,0,0,0,0,199000,0,0,0,204000,5000,199000,199000
050893,鴻海元大96購03  ,0,0,0,0,0,0,0,0,0,199000,0,0,0,201000,2000,199000,199000
054418,茂林元大97購01  ,0,0,0,0,0,0,0,0,0,199000,0,0,0,405000,206000,199000,199000
5469,瀚宇博          ,732000,474889,257111,0,0,0,0,0,0,-59000,2000,0,2000,9000,70000,-61000,198111
056031,勤誠康和97購02  ,0,0,0,0,0,0,0,0,0,198000,0,0,0,198000,0,198000,198000
048555,技嘉元大93購02  ,0,0,0,0,0,0,0,0,0,198000,0,0,0,243000,45000,198000,198000
052000,鈺齊元大95購03  ,0,0,0,0,0,0,0,0,0,198000,0,0,0,256000,58000,198000,198000
054385,矽創群益98購01  ,0,0,0,0,0,0,0,0,0,198000,0,0,0,236000,38000,198000,198000
057198,智伸科統一9B購01,0,0,0,0,0,0,0,0,0,196000,0,0,0,216000,20000,196000,196000
046294,台勝科統一92購01,0,0,0,0,0,0,0,0,0,196000,0,0,0,221000,25000,196000,196000
041452,滬深2X元富93購01,0,0,0,0,0,0,0,0,0,196000,0,0,0,202000,6000,196000,196000
051816,臺股指凱基95購07,0,0,0,0,0,0,0,0,0,196000,0,0,0,196000,0,196000,196000
050876,復盛永豐95購01  ,0,0,0,0,0,0,0,0,0,196000,0,0,0,233000,37000,196000,196000
08795P,聯發科凱基01售11,0,0,0,0,0,0,0,0,0,196000,0,0,0,196000,0,196000,196000
05746P,台積電群益96售07,0,0,0,0,0,0,0,0,0,195000,0,0,0,240000,45000,195000,195000
05699P,茂林凱基96售05  ,0,0,0,0,0,0,0,0,0,195000,0,0,0,260000,65000,195000,195000
04639P,臺股指群益94售14,0,0,0,0,0,0,0,0,0,195000,0,0,0,257000,62000,195000,195000
054701,宏全永豐97購01  ,0,0,0,0,0,0,0,0,0,195000,0,0,0,195000,0,195000,195000
052856,滬深2X凱基98購01,0,0,0,0,0,0,0,0,0,195000,0,0,0,195000,0,195000,195000
6412,群電            ,223000,28000,195000,0,0,0,0,0,0,0,0,0,0,0,0,0,195000
045872,元油2X元富98購03,0,0,0,0,0,0,0,0,0,194000,0,0,0,1722000,1528000,194000,194000
053386,聯詠元大96購03  ,0,0,0,0,0,0,0,0,0,194000,0,0,0,205000,11000,194000,194000
053594,京鼎元大96購02  ,0,0,0,0,0,0,0,0,0,194000,0,0,0,227000,33000,194000,194000
2301,光寶科          ,1387000,884000,503000,0,0,0,0,0,0,-310000,6000,193000,-187000,0,123000,-123000,193000
049974,聯發科日盛94購02,0,0,0,0,0,0,0,0,0,192000,0,0,0,202000,10000,192000,192000
053411,深中小國票9B購01,0,0,0,0,0,0,0,0,0,192000,0,0,0,726000,534000,192000,192000
052823,創意永豐96購02  ,0,0,0,0,0,0,0,0,0,192000,0,0,0,202000,10000,192000,192000
052594,友訊群益98購01  ,0,0,0,0,0,0,0,0,0,191000,0,0,0,355000,164000,191000,191000
052528,茂林元大95購05  ,0,0,0,0,0,0,0,0,0,191000,0,0,0,519000,328000,191000,191000
051164,鴻海元大95購05  ,0,0,0,0,0,0,0,0,0,191000,0,0,0,195000,4000,191000,191000
054743,聯鈞凱基99購01  ,0,0,0,0,0,0,0,0,0,191000,0,0,0,401000,210000,191000,191000
055195,昇陽半元富97購02,0,0,0,0,0,0,0,0,0,191000,0,0,0,191000,0,191000,191000
056013,T50反1群益97購01,0,0,0,0,0,0,0,0,0,190000,0,0,0,190000,0,190000,190000
04430P,晶相光元大94售04,0,0,0,0,0,0,0,0,0,190000,0,0,0,190000,0,190000,190000
03686P,大立光統一98售02,0,0,0,0,0,0,0,0,0,190000,0,0,0,200000,10000,190000,190000
051868,貿聯凱基96購01  ,0,0,0,0,0,0,0,0,0,190000,0,0,0,200000,10000,190000,190000
051346,仁寶元大95購01  ,0,0,0,0,0,0,0,0,0,190000,0,0,0,205000,15000,190000,190000
055926,國巨群益98購06  ,0,0,0,0,0,0,0,0,0,189000,0,0,0,189000,0,189000,189000
055763,鎧勝群益97購01  ,0,0,0,0,0,0,0,0,0,189000,0,0,0,199000,10000,189000,189000
050976,台光電統一95購01,0,0,0,0,0,0,0,0,0,189000,0,0,0,189000,0,189000,189000
051098,矽格元大95購01  ,0,0,0,0,0,0,0,0,0,189000,0,0,0,205000,16000,189000,189000
054566,貿聯群益97購02  ,0,0,0,0,0,0,0,0,0,189000,0,0,0,200000,11000,189000,189000
053592,亞光元大96購01  ,0,0,0,0,0,0,0,0,0,189000,0,0,0,230000,41000,189000,189000
08703P,華碩凱基01售02  ,0,0,0,0,0,0,0,0,0,189000,0,0,0,239000,50000,189000,189000
056459,茂林凱基99購01  ,0,0,0,0,0,0,0,0,0,188000,0,0,0,203000,15000,188000,188000
057134,茂林凱基98購02  ,0,0,0,0,0,0,0,0,0,188000,0,0,0,188000,0,188000,188000
048952,川湖康和94購01  ,0,0,0,0,0,0,0,0,0,188000,0,0,0,188000,0,188000,188000
053569,漢唐統一98購01  ,0,0,0,0,0,0,0,0,0,188000,0,0,0,188000,0,188000,188000
056145,緯穎元大98購03  ,0,0,0,0,0,0,0,0,0,187000,0,0,0,266000,79000,187000,187000
055532,中工群益98購01  ,0,0,0,0,0,0,0,0,0,187000,0,0,0,187000,0,187000,187000
052648,茂林永豐96購01  ,0,0,0,0,0,0,0,0,0,186000,0,0,0,260000,74000,186000,186000
054504,聯鈞永豐96購01  ,0,0,0,0,0,0,0,0,0,186000,0,0,0,260000,74000,186000,186000
054831,緯穎國泰98購01  ,0,0,0,0,0,0,0,0,0,186000,0,0,0,230000,44000,186000,186000
3041,揚智            ,267000,81000,186000,0,0,0,0,0,0,0,0,0,0,0,0,0,186000
046205,明基材凱基93購01,0,0,0,0,0,0,0,0,0,185000,0,0,0,410000,225000,185000,185000
03189P,玉晶光元大03售05,0,0,0,0,0,0,0,0,0,185000,0,0,0,200000,15000,185000,185000
054394,奇力新永豐96購03,0,0,0,0,0,0,0,0,0,185000,0,0,0,185000,0,185000,185000
055500,京鼎元大97購04  ,0,0,0,0,0,0,0,0,0,184000,0,0,0,262000,78000,184000,184000
056191,世紀鋼統一97購01,0,0,0,0,0,0,0,0,0,184000,0,0,0,297000,113000,184000,184000
047343,台達電中信95購01,0,0,0,0,0,0,0,0,0,184000,0,0,0,189000,5000,184000,184000
049352,泰鼎永豐95購01  ,0,0,0,0,0,0,0,0,0,184000,0,0,0,184000,0,184000,184000
054881,光罩統一97購01  ,0,0,0,0,0,0,0,0,0,184000,0,0,0,184000,0,184000,184000
055489,瑞昱元大97購02  ,0,0,0,0,0,0,0,0,0,183000,0,0,0,215000,32000,183000,183000
055760,新日興群益98購02,0,0,0,0,0,0,0,0,0,183000,0,0,0,298000,115000,183000,183000
052016,神基永豐95購01  ,0,1000,-1000,0,0,0,0,0,0,184000,0,0,0,194000,10000,184000,183000
052376,聯詠元大95購04  ,0,0,0,0,0,0,0,0,0,183000,0,0,0,200000,17000,183000,183000
049119,元油2X元富94購04,0,0,0,0,0,0,0,0,0,183000,0,0,0,188000,5000,183000,183000
053894,創意群益96購01  ,0,0,0,0,0,0,0,0,0,183000,0,0,0,210000,27000,183000,183000
056501,貿聯富邦99購01  ,0,0,0,0,0,0,0,0,0,182000,0,0,0,352000,170000,182000,182000
05724P,致茂永豐96售01  ,0,0,0,0,0,0,0,0,0,182000,0,0,0,206000,24000,182000,182000
052364,全新國票95購02  ,0,0,0,0,0,0,0,0,0,182000,0,0,0,202000,20000,182000,182000
052398,瑞昱凱基95購06  ,0,0,0,0,0,0,0,0,0,182000,0,0,0,315000,133000,182000,182000
051406,泰鼎永豐96購01  ,0,0,0,0,0,0,0,0,0,182000,0,0,0,212000,30000,182000,182000
054909,福懋科康和97購01,0,0,0,0,0,0,0,0,0,182000,0,0,0,213000,31000,182000,182000
055995,華擎國泰99購01  ,0,0,0,0,0,0,0,0,0,181000,0,0,0,181000,0,181000,181000
055580,南茂統一97購01  ,0,0,0,0,0,0,0,0,0,181000,0,0,0,181000,0,181000,181000
05287P,鴻海元富95售09  ,0,0,0,0,0,0,0,0,0,181000,0,0,0,181000,0,181000,181000
056207,茂林永豐97購03  ,0,0,0,0,0,0,0,0,0,180000,0,0,0,204000,24000,180000,180000
05856P,A50正2中信99售01,0,0,0,0,0,0,0,0,0,180000,0,0,0,180000,0,180000,180000
056884,元油2X元大99購02,0,0,0,0,0,0,0,0,0,180000,0,0,0,215000,35000,180000,180000
04821P,臺股指永豐94售01,0,0,0,0,0,0,0,0,0,180000,0,0,0,180000,0,180000,180000
049813,康控元大96購02  ,0,0,0,0,0,0,0,0,0,180000,0,0,0,180000,0,180000,180000
049279,元油2X國票94購02,0,0,0,0,0,0,0,0,0,180000,0,0,0,180000,0,180000,180000
05277P,深中小統一95售02,0,0,0,0,0,0,0,0,0,180000,0,0,0,180000,0,180000,180000
05497P,聯詠統一96售01  ,0,0,0,0,0,0,0,0,0,180000,0,0,0,180000,0,180000,180000
054009,欣興元富96購03  ,0,0,0,0,0,0,0,0,0,180000,0,0,0,220000,40000,180000,180000
6456,GIS-KY          ,254000,157000,97000,0,0,0,0,0,0,83000,1000,0,1000,98000,16000,82000,180000
056961,凱美永豐98購01  ,0,0,0,0,0,0,0,0,0,179000,0,0,0,179000,0,179000,179000
051827,智邦元大95購04  ,0,0,0,0,0,0,0,0,0,179000,0,0,0,359000,180000,179000,179000
04869P,鴻海元富95售02  ,0,0,0,0,0,0,0,0,0,179000,0,0,0,211000,32000,179000,179000
053893,京鼎群益97購02  ,0,0,0,0,0,0,0,0,0,179000,0,0,0,295000,116000,179000,179000
04746P,臺股指元大94售17,0,0,0,0,0,0,0,0,0,177000,0,0,0,177000,0,177000,177000
049316,茂林凱基94購02  ,0,0,0,0,0,0,0,0,0,177000,0,0,0,177000,0,177000,177000
051752,緯穎富邦96購01  ,0,0,0,0,0,0,0,0,0,177000,0,0,0,184000,7000,177000,177000
053934,A50正2元富96購02,0,0,0,0,0,0,0,0,0,177000,0,0,0,180000,3000,177000,177000
8163,達方            ,334000,150000,184000,0,0,0,0,0,0,-7000,19000,10000,9000,0,16000,-16000,177000
050570,聯發科中信97購02,0,0,0,0,0,0,0,0,0,176000,0,0,0,196000,20000,176000,176000
052744,聯詠元大97購01  ,0,0,0,0,0,0,0,0,0,176000,0,0,0,225000,49000,176000,176000
05603P,聯發科元大96售09,0,0,0,0,0,0,0,0,0,175000,0,0,0,214000,39000,175000,175000
055415,禾伸堂富邦9B購01,0,0,0,0,0,0,0,0,0,175000,0,0,0,883000,708000,175000,175000
048627,T50反1元大96購02,0,0,0,0,0,0,0,0,0,175000,0,0,0,195000,20000,175000,175000
047866,得力永豐93購01  ,0,0,0,0,0,0,0,0,0,175000,0,0,0,175000,0,175000,175000
050201,光磊群益94購01  ,0,0,0,0,0,0,0,0,0,175000,0,0,0,185000,10000,175000,175000
051047,深中小群益99購01,0,0,0,0,0,0,0,0,0,175000,0,0,0,404000,229000,175000,175000
052516,臺股指凱基95購20,0,0,0,0,0,0,0,0,0,175000,0,0,0,175000,0,175000,175000
052593,台積電群益96購02,0,0,0,0,0,0,0,0,0,175000,0,0,0,205000,30000,175000,175000
048857,晶豪科群益94購01,0,0,0,0,0,0,0,0,0,175000,0,0,0,186000,11000,175000,175000
049437,可成國泰96購01  ,0,0,0,0,0,0,0,0,0,174000,0,0,0,393000,219000,174000,174000
054027,欣興凱基96購04  ,0,0,0,0,0,0,0,0,0,174000,0,0,0,174000,0,174000,174000
054195,亞泥國泰98購01  ,0,0,0,0,0,0,0,0,0,174000,0,0,0,174000,0,174000,174000
04456P,日月光統一94售01,0,0,0,0,0,0,0,0,0,173000,0,0,0,173000,0,173000,173000
051644,聯茂康和95購01  ,0,0,0,0,0,0,0,0,0,173000,0,0,0,173000,0,173000,173000
050743,京鼎永豐94購02  ,0,0,0,0,0,0,0,0,0,173000,0,0,0,223000,50000,173000,173000
053014,旺宏統一97購02  ,0,0,0,0,0,0,0,0,0,173000,0,0,0,198000,25000,173000,173000
052888,台表科中信9A購01,0,0,0,0,0,0,0,0,0,173000,0,0,0,193000,20000,173000,173000
056555,矽創凱基98購01  ,0,0,0,0,0,0,0,0,0,172000,0,0,0,192000,20000,172000,172000
054240,訊芯群益96購03  ,0,0,0,0,0,0,0,0,0,172000,0,0,0,363000,191000,172000,172000
054143,茂林元大96購04  ,0,0,0,0,0,0,0,0,0,172000,0,0,0,331000,159000,172000,172000
054647,禾伸堂群益99購01,0,0,0,0,0,0,0,0,0,172000,0,0,0,1456000,1284000,172000,172000
055807,勤誠永豐97購01  ,0,0,0,0,0,0,0,0,0,171000,0,0,0,171000,0,171000,171000
056289,合勤控永豐97購01,0,0,0,0,0,0,0,0,0,171000,0,0,0,202000,31000,171000,171000
044817,可成兆豐93購01  ,0,0,0,0,0,0,0,0,0,171000,0,0,0,340000,169000,171000,171000
049738,神基群益94購01  ,0,0,0,0,0,0,0,0,0,171000,0,0,0,349000,178000,171000,171000
054249,技嘉元大96購03  ,0,0,0,0,0,0,0,0,0,171000,0,0,0,216000,45000,171000,171000
052922,國巨永豐96購01  ,0,0,0,0,0,0,0,0,0,171000,0,0,0,180000,9000,171000,171000
053162,緯穎元大97購01  ,0,0,0,0,0,0,0,0,0,171000,0,0,0,509000,338000,171000,171000
055708,茂林永豐97購02  ,0,0,0,0,0,0,0,0,0,170000,0,0,0,246000,76000,170000,170000
03109P,台積電元大01售41,0,0,0,0,0,0,0,0,0,170000,0,0,0,170000,0,170000,170000
050895,聯發科元大97購01,0,0,0,0,0,0,0,0,0,170000,0,0,0,302000,132000,170000,170000
051687,大立光凱基95購12,0,0,0,0,0,0,0,0,0,170000,0,0,0,170000,0,170000,170000
052824,揚明光永豐96購02,0,0,0,0,0,0,0,0,0,170000,0,0,0,170000,0,170000,170000
2542,興富發          ,345000,161000,184000,0,0,0,0,0,0,-14000,0,14000,-14000,0,0,0,170000
047289,啟碁統一97購01  ,0,0,0,0,0,0,0,0,0,169000,0,0,0,186000,17000,169000,169000
049297,日電貿群益95購01,0,0,0,0,0,0,0,0,0,169000,0,0,0,256000,87000,169000,169000
049778,宏達電統一94購02,0,0,0,0,0,0,0,0,0,169000,0,0,0,169000,0,169000,169000
054955,宏達電元大98購01,0,0,0,0,0,0,0,0,0,169000,0,0,0,222000,53000,169000,169000
055178,晶豪科統一97購01,0,0,0,0,0,0,0,0,0,169000,0,0,0,169000,0,169000,169000
055791,臺股指凱基97購14,0,0,0,0,0,0,0,0,0,168000,0,0,0,188000,20000,168000,168000
057263,可成兆豐99購01  ,0,0,0,0,0,0,0,0,0,168000,0,0,0,193000,25000,168000,168000
048143,聯發科統一94購03,0,0,0,0,0,0,0,0,0,168000,0,0,0,188000,20000,168000,168000
04163P,可成統一93售03  ,0,0,0,0,0,0,0,0,0,168000,0,0,0,168000,0,168000,168000
03821P,上海銀統一95售01,0,0,0,0,0,0,0,0,0,168000,0,0,0,168000,0,168000,168000
047919,技嘉凱基93購06  ,0,0,0,0,0,0,0,0,0,168000,0,0,0,202000,34000,168000,168000
050016,緯穎富邦95購01  ,0,0,0,0,0,0,0,0,0,168000,0,0,0,172000,4000,168000,168000
051725,緯穎永豐95購02  ,0,0,0,0,0,0,0,0,0,168000,0,0,0,178000,10000,168000,168000
053785,聯詠元大96購05  ,0,0,0,0,0,0,0,0,0,168000,0,0,0,168000,0,168000,168000
050353,華擎群益95購01  ,0,0,0,0,0,0,0,0,0,167000,0,0,0,220000,53000,167000,167000
053969,瑞昱元大97購01  ,0,0,0,0,0,0,0,0,0,167000,0,0,0,325000,158000,167000,167000
055266,京鼎永豐97購01  ,0,0,0,0,0,0,0,0,0,167000,0,0,0,227000,60000,167000,167000
056562,奇力新群益98購01,0,0,0,0,0,0,0,0,0,166000,0,0,0,561000,395000,166000,166000
055332,奇力新兆豐98購01,0,0,0,0,0,0,0,0,0,166000,0,0,0,195000,29000,166000,166000
00743,國泰中國A150    ,121000,0,121000,0,0,0,0,0,0,45000,0,0,0,213000,168000,45000,166000
053853,康控國泰97購02  ,0,0,0,0,0,0,0,0,0,166000,0,0,0,197000,31000,166000,166000
06014P,聯發科富邦97售02,0,0,0,0,0,0,0,0,0,165000,0,0,0,180000,15000,165000,165000
03763P,聯發科元富96售01,0,0,0,0,0,0,0,0,0,165000,0,0,0,165000,0,165000,165000
054850,上海銀兆豐97購01,0,0,0,0,0,0,0,0,0,165000,0,0,0,165000,0,165000,165000
03636C,元油2X元富04牛01,0,0,0,0,0,0,0,0,0,164000,0,0,0,389000,225000,164000,164000
045685,康控元大95購01  ,0,0,0,0,0,0,0,0,0,164000,0,0,0,220000,56000,164000,164000
052586,晶豪科永豐96購01,0,0,0,0,0,0,0,0,0,164000,0,0,0,203000,39000,164000,164000
054256,創意元大96購07  ,0,0,0,0,0,0,0,0,0,164000,0,0,0,349000,185000,164000,164000
052738,聯電元大98購02  ,0,0,0,0,0,0,0,0,0,164000,0,0,0,210000,46000,164000,164000
05858P,矽力中信96售01  ,0,0,0,0,0,0,0,0,0,163000,0,0,0,180000,17000,163000,163000
05267P,欣興元大95售08  ,0,0,0,0,0,0,0,0,0,163000,0,0,0,209000,46000,163000,163000
051684,瑞昱凱基95購02  ,0,0,0,0,0,0,0,0,0,163000,0,0,0,241000,78000,163000,163000
049355,元油2X富邦96購04,0,0,0,0,0,0,0,0,0,163000,0,0,0,167000,4000,163000,163000
050529,矽格元大94購05  ,0,0,0,0,0,0,0,0,0,163000,0,0,0,168000,5000,163000,163000
052733,台郡國泰97購01  ,0,0,0,0,0,0,0,0,0,163000,0,0,0,278000,115000,163000,163000
055605,緯穎元大97購02  ,0,0,0,0,0,0,0,0,0,162000,0,0,0,468000,306000,162000,162000
04644P,全新凱基94售01  ,0,0,0,0,0,0,0,0,0,162000,0,0,0,490000,328000,162000,162000
049869,訊芯兆豐94購01  ,0,0,0,0,0,0,0,0,0,162000,0,0,0,162000,0,162000,162000
053799,矽創中信9A購01  ,0,0,0,0,0,0,0,0,0,162000,0,0,0,162000,0,162000,162000
055723,康控元大97購04  ,0,0,0,0,0,0,0,0,0,161000,0,0,0,448000,287000,161000,161000
049894,嘉聯益富邦98購01,0,0,0,0,0,0,0,0,0,161000,0,0,0,161000,0,161000,161000
049031,矽格群益94購01  ,0,0,0,0,0,0,0,0,0,161000,0,0,0,176000,15000,161000,161000
052772,台虹群益96購01  ,0,0,0,0,0,0,0,0,0,161000,0,0,0,206000,45000,161000,161000
055742,健策元富97購02  ,0,0,0,0,0,0,0,0,0,160000,0,0,0,165000,5000,160000,160000
055633,牧德永豐97購02  ,0,0,0,0,0,0,0,0,0,160000,0,0,0,160000,0,160000,160000
05660P,玉晶光第一96售01,0,0,0,0,0,0,0,0,0,160000,0,0,0,160000,0,160000,160000
03629C,元油2X元富98牛06,0,0,0,0,0,0,0,0,0,160000,0,0,0,297000,137000,160000,160000
04745P,祥碩元大94售04  ,0,0,0,0,0,0,0,0,0,160000,0,0,0,170000,10000,160000,160000
047689,瑞昱富邦97購01  ,0,0,0,0,0,0,0,0,0,160000,0,0,0,172000,12000,160000,160000
053781,友達元大9B購03  ,0,0,0,0,0,0,0,0,0,160000,0,0,0,323000,163000,160000,160000
053332,創意永豐96購03  ,0,0,0,0,0,0,0,0,0,160000,0,0,0,187000,27000,160000,160000
055141,牧德永豐98購02  ,0,0,0,0,0,0,0,0,0,160000,0,0,0,160000,0,160000,160000
055159,玉晶光元大98購05,0,0,0,0,0,0,0,0,0,160000,0,0,0,190000,30000,160000,160000
08897P,國巨群益01售10  ,0,0,0,0,0,0,0,0,0,160000,0,0,0,160000,0,160000,160000
055331,國巨兆豐99購01  ,0,0,0,0,0,0,0,0,0,159000,0,0,0,212000,53000,159000,159000
052482,茂林群益95購01  ,0,0,0,0,0,0,0,0,0,159000,0,0,0,205000,46000,159000,159000
052958,T50反1凱基99購02,0,0,0,0,0,0,0,0,0,159000,0,0,0,159000,0,159000,159000
056473,奇力新元大99購02,0,0,0,0,0,0,0,0,0,158000,0,0,0,288000,130000,158000,158000
051988,台光電元大95購01,0,0,0,0,0,0,0,0,0,158000,0,0,0,179000,21000,158000,158000
056299,友達元大9B購04  ,0,0,0,0,0,0,0,0,0,157000,0,0,0,373000,216000,157000,157000
056032,勤誠康和97購03  ,0,0,0,0,0,0,0,0,0,157000,0,0,0,167000,10000,157000,157000
052342,茂林凱基96購01  ,0,0,0,0,0,0,0,0,0,157000,0,0,0,213000,56000,157000,157000
054948,聯發科元大97購14,0,0,0,0,0,0,0,0,0,157000,0,0,0,158000,1000,157000,157000
055694,光罩國票98購01  ,0,0,0,0,0,0,0,0,0,156000,0,0,0,259000,103000,156000,156000
049244,亞光元富94購01  ,0,0,0,0,0,0,0,0,0,156000,0,0,0,166000,10000,156000,156000
047074,大立光兆豐94購02,0,0,0,0,0,0,0,0,0,156000,0,0,0,176000,20000,156000,156000
050238,瑞昱凱基94購05  ,0,0,0,0,0,0,0,0,0,156000,0,0,0,188000,32000,156000,156000
054880,華泰統一97購01  ,0,0,0,0,0,0,0,0,0,156000,0,0,0,156000,0,156000,156000
055176,大毅統一98購02  ,0,0,0,0,0,0,0,0,0,156000,0,0,0,156000,0,156000,156000
054317,昇陽半凱基98購01,0,0,0,0,0,0,0,0,0,156000,0,0,0,245000,89000,156000,156000
054382,康控群益96購03  ,0,0,0,0,0,0,0,0,0,156000,0,0,0,286000,130000,156000,156000
06477P,緯穎國票99售02  ,0,0,0,0,0,0,0,0,0,156000,0,0,0,171000,15000,156000,156000
048812,上証2X凱基96購01,0,0,0,0,0,0,0,0,0,155000,0,0,0,155000,0,155000,155000
051833,昇陽半元大96購01,0,0,0,0,0,0,0,0,0,155000,0,0,0,225000,70000,155000,155000
042724,群創群益93購01  ,0,0,0,0,0,0,0,0,0,155000,0,0,0,155000,0,155000,155000
054050,創意元大96購06  ,0,0,0,0,0,0,0,0,0,155000,0,0,0,160000,5000,155000,155000
055040,台虹富邦99購01  ,0,0,0,0,0,0,0,0,0,155000,0,0,0,160000,5000,155000,155000
053458,聯詠國泰97購01  ,0,0,0,0,0,0,0,0,0,155000,0,0,0,155000,0,155000,155000
055881,康控元富97購01  ,0,0,0,0,0,0,0,0,0,154000,0,0,0,220000,66000,154000,154000
052886,世紀鋼兆豐96購01,0,0,0,0,0,0,0,0,0,154000,0,0,0,212000,58000,154000,154000
06577P,聯發科日盛9A售02,0,0,0,0,0,0,0,0,0,154000,0,0,0,203000,49000,154000,154000
055464,聚陽凱基97購01  ,0,0,0,0,0,0,0,0,0,153000,0,0,0,259000,106000,153000,153000
056942,昇陽半元富98購01,0,0,0,0,0,0,0,0,0,153000,0,0,0,194000,41000,153000,153000
052067,中磊兆豐96購01  ,0,0,0,0,0,0,0,0,0,153000,0,0,0,254000,101000,153000,153000
053865,欣興元大97購02  ,0,0,0,0,0,0,0,0,0,153000,0,0,0,153000,0,153000,153000
054189,貿聯永豐96購03  ,0,0,0,0,0,0,0,0,0,153000,0,0,0,153000,0,153000,153000
054668,傳奇元富97購03  ,0,0,0,0,0,0,0,0,0,153000,0,0,0,311000,158000,153000,153000
056578,智易元大99購02  ,0,0,0,0,0,0,0,0,0,152000,0,0,0,169000,17000,152000,152000
044693,滬深2X元大94購01,0,0,0,0,0,0,0,0,0,152000,0,0,0,261000,109000,152000,152000
048445,瑞昱凱基93購11  ,0,0,0,0,0,0,0,0,0,152000,0,0,0,339000,187000,152000,152000
051105,台光電國票96購01,0,0,0,0,0,0,0,0,0,152000,0,0,0,182000,30000,152000,152000
05128P,聯發科中信97售03,0,0,0,0,0,0,0,0,0,152000,0,0,0,152000,0,152000,152000
05504P,台積電凱基96售04,0,0,0,0,0,0,0,0,0,152000,0,0,0,152000,0,152000,152000
055251,華新科統一99購01,0,0,0,0,0,0,0,0,0,152000,0,0,0,314000,162000,152000,152000
052197,台郡元富95購03  ,0,0,0,0,0,0,0,0,0,152000,0,0,0,169000,17000,152000,152000
06301P,臺股指元大97售04,0,0,0,0,0,0,0,0,0,152000,0,0,0,163000,11000,152000,152000
055443,台虹國票98購01  ,0,0,0,0,0,0,0,0,0,151000,0,0,0,151000,0,151000,151000
05036P,義隆元大95售03  ,0,0,0,0,0,0,0,0,0,151000,0,0,0,601000,450000,151000,151000
049144,瑞昱元大94購03  ,0,0,0,0,0,0,0,0,0,151000,0,0,0,151000,0,151000,151000
05577P,上銀凱基96售02  ,0,0,0,0,0,0,0,0,0,150000,0,0,0,150000,0,150000,150000
05568P,台積電統一96售03,0,0,0,0,0,0,0,0,0,150000,0,0,0,150000,0,150000,150000
056250,瑞昱兆豐97購02  ,0,0,0,0,0,0,0,0,0,150000,0,0,0,243000,93000,150000,150000
056532,技嘉凱基98購01  ,0,0,0,0,0,0,0,0,0,150000,0,0,0,219000,69000,150000,150000
048080,元石油凱基96購01,0,0,0,0,0,0,0,0,0,150000,0,0,0,150000,0,150000,150000
04407P,滬深2X統一94售02,0,0,0,0,0,0,0,0,0,150000,0,0,0,150000,0,150000,150000
048556,技嘉元大93購03  ,0,0,0,0,0,0,0,0,0,150000,0,0,0,254000,104000,150000,150000
048548,緯穎永豐93購02  ,0,0,0,0,0,0,0,0,0,150000,0,0,0,162000,12000,150000,150000
046335,矽創元大92購04  ,0,0,0,0,0,0,0,0,0,150000,0,0,0,150000,0,150000,150000
045480,滬深2X中信94購01,0,0,0,0,0,0,0,0,0,150000,0,0,0,150000,0,150000,150000
042040,大立光群益93購01,0,0,0,0,0,0,0,0,0,150000,0,0,0,150000,0,150000,150000
053033,智易兆豐97購01  ,0,0,0,0,0,0,0,0,0,150000,0,0,0,200000,50000,150000,150000
052403,麗豐凱基96購01  ,0,0,0,0,0,0,0,0,0,150000,0,0,0,150000,0,150000,150000
052683,鴻海元大97購03  ,0,0,0,0,0,0,0,0,0,150000,0,0,0,200000,50000,150000,150000
05133P,臺股指日盛95售01,0,0,0,0,0,0,0,0,0,150000,0,0,0,150000,0,150000,150000
05017P,臺股指元大95售08,0,0,0,0,0,0,0,0,0,150000,0,0,0,150000,0,150000,150000
049395,元油2X群益94購03,0,0,0,0,0,0,0,0,0,150000,0,0,0,150000,0,150000,150000
053313,世紀鋼凱基96購01,0,0,0,0,0,0,0,0,0,150000,0,0,0,300000,150000,150000,150000
055094,智易群益98購01  ,0,0,0,0,0,0,0,0,0,150000,0,0,0,150000,0,150000,150000
054166,日電貿凱基98購01,0,0,0,0,0,0,0,0,0,150000,0,0,0,291000,141000,150000,150000
06206P,台積電凱基97售11,0,0,0,0,0,0,0,0,0,150000,0,0,0,293000,143000,150000,150000
06395P,台積電元大97售29,0,0,0,0,0,0,0,0,0,150000,0,0,0,162000,12000,150000,150000
056569,T50正2元大9B購02,0,0,0,0,0,0,0,0,0,149000,0,0,0,156000,7000,149000,149000
05780P,台積電統一96售07,0,0,0,0,0,0,0,0,0,149000,0,0,0,348000,199000,149000,149000
047818,台郡凱基93購04  ,0,0,0,0,0,0,0,0,0,149000,0,0,0,149000,0,149000,149000
044013,友達凱基93購01  ,0,0,0,0,0,0,0,0,0,149000,0,0,0,176000,27000,149000,149000
056785,可成群益99購01  ,0,0,0,0,0,0,0,0,0,148000,0,0,0,295000,147000,148000,148000
056074,茂林元大97購04  ,0,0,0,0,0,0,0,0,0,148000,0,0,0,726000,578000,148000,148000
055426,旺宏群益99購02  ,0,0,0,0,0,0,0,0,0,148000,0,0,0,271000,123000,148000,148000
044639,京元電元富94購01,0,0,0,0,0,0,0,0,0,148000,0,0,0,198000,50000,148000,148000
04748P,臺股指元大94售23,0,0,0,0,0,0,0,0,0,148000,0,0,0,162000,14000,148000,148000
048599,和鑫國票96購01  ,0,0,0,0,0,0,0,0,0,148000,0,0,0,148000,0,148000,148000
047212,宏達電富邦97購01,0,0,0,0,0,0,0,0,0,148000,0,0,0,218000,70000,148000,148000
06256P,臺股指群益97售09,0,0,0,0,0,0,0,0,0,148000,0,0,0,178000,30000,148000,148000
055762,智伸科群益97購01,0,0,0,0,0,0,0,0,0,147000,0,0,0,147000,0,147000,147000
056045,勤誠凱基97購01  ,0,0,0,0,0,0,0,0,0,147000,0,0,0,147000,0,147000,147000
051203,微星麥證95購01  ,0,0,0,153000,6000,147000,0,0,0,147000,0,0,0,153000,6000,147000,147000
05173P,臺股指元大95售17,0,0,0,0,0,0,0,0,0,147000,0,0,0,155000,8000,147000,147000
050836,緯穎凱基95購01  ,0,0,0,0,0,0,0,0,0,147000,0,0,0,193000,46000,147000,147000
054667,神基元富97購01  ,0,0,0,0,0,0,0,0,0,147000,0,0,0,197000,50000,147000,147000
053071,南電群益96購01  ,0,0,0,0,0,0,0,0,0,147000,0,0,0,180000,33000,147000,147000
056231,嘉聯益凱基97購02,0,0,0,0,0,0,0,0,0,146000,0,0,0,166000,20000,146000,146000
055672,國巨日盛97購02  ,0,0,0,0,0,0,0,0,0,146000,0,0,0,373000,227000,146000,146000
048652,巨大元大96購01  ,0,0,0,0,0,0,0,0,0,146000,0,0,0,150000,4000,146000,146000
051724,康控永豐95購03  ,0,0,0,0,0,0,0,0,0,146000,0,0,0,146000,0,146000,146000
049290,元油2X群益94購02,0,0,0,0,0,0,0,0,0,146000,0,0,0,151000,5000,146000,146000
053297,鎧勝中信98購01  ,0,0,0,0,0,0,0,0,0,146000,0,0,0,216000,70000,146000,146000
054503,京鼎永豐96購04  ,0,0,0,0,0,0,0,0,0,146000,0,0,0,168000,22000,146000,146000
057065,牧德富邦99購01  ,0,0,0,0,0,0,0,0,0,145000,0,0,0,200000,55000,145000,145000
048653,巨大元大96購02  ,0,0,0,0,0,0,0,0,0,145000,0,0,0,150000,5000,145000,145000
051491,貿聯凱基95購01  ,0,0,0,0,0,0,0,0,0,145000,0,0,0,260000,115000,145000,145000
049381,欣興元大94購05  ,0,0,0,0,0,0,0,0,0,145000,0,0,0,152000,7000,145000,145000
054673,京鼎國泰98購01  ,0,0,0,0,0,0,0,0,0,145000,0,0,0,145000,0,145000,145000
052807,貿聯元大98購01  ,0,0,0,0,0,0,0,0,0,145000,0,0,0,196000,51000,145000,145000
057200,技嘉元富98購01  ,0,0,0,0,0,0,0,0,0,144000,0,0,0,164000,20000,144000,144000
06011P,貿聯元富96售04  ,0,0,0,0,0,0,0,0,0,144000,0,0,0,150000,6000,144000,144000
048901,矽格國泰95購01  ,0,0,0,0,0,0,0,0,0,144000,0,0,0,144000,0,144000,144000
052639,康控凱基96購02  ,0,0,0,0,0,0,0,0,0,144000,0,0,0,214000,70000,144000,144000
053142,緯穎永豐96購01  ,0,0,0,0,0,0,0,0,0,144000,0,0,0,185000,41000,144000,144000
054546,玉晶光中信9B購01,0,0,0,0,0,0,0,0,0,144000,0,0,0,234000,90000,144000,144000
05489P,臺股指凱基95售22,0,0,0,0,0,0,0,0,0,144000,0,0,0,144000,0,144000,144000
06271P,彩晶凱基97售01  ,0,0,0,0,0,0,0,0,0,144000,0,0,0,298000,154000,144000,144000
2633,台灣高鐵        ,618000,440000,178000,0,0,0,1000,0,1000,-35000,0,0,0,0,35000,-35000,144000
056908,牧德元大99購03  ,0,0,0,0,0,0,0,0,0,143000,0,0,0,256000,113000,143000,143000
05612P,台積電元大96售13,0,0,0,0,0,0,0,0,0,143000,0,0,0,153000,10000,143000,143000
047999,聯發科元大93購22,0,0,0,0,0,0,0,0,0,143000,0,0,0,185000,42000,143000,143000
03917P,鴻海凱基94售07  ,0,0,0,0,0,0,0,0,0,143000,0,0,0,143000,0,143000,143000
05171P,臺股指元大95售15,0,0,0,0,0,0,0,0,0,143000,0,0,0,151000,8000,143000,143000
05495P,大立光統一95售07,0,0,0,0,0,0,0,0,0,143000,0,0,0,284000,141000,143000,143000
055275,台積電元大97購19,0,0,0,0,0,0,0,0,0,143000,0,0,0,193000,50000,143000,143000
055908,GIS日盛97購01   ,0,0,0,0,0,0,0,0,0,142000,0,0,0,152000,10000,142000,142000
057206,立積元富98購01  ,0,0,0,0,0,0,0,0,0,142000,0,0,0,142000,0,142000,142000
048878,康控國票95購02  ,0,0,0,0,0,0,0,0,0,142000,0,0,0,172000,30000,142000,142000
051359,中信金元大95購01,0,0,0,0,0,0,0,0,0,142000,0,0,0,575000,433000,142000,142000
055481,聚陽元大97購01  ,0,0,0,0,0,0,0,0,0,141000,0,0,0,141000,0,141000,141000
052055,緯穎凱基95購03  ,0,0,0,0,0,0,0,0,0,141000,0,0,0,356000,215000,141000,141000
052944,宏達電國票97購01,0,0,0,0,0,0,0,0,0,141000,0,0,0,209000,68000,141000,141000
06316P,臺股指元富97售03,0,0,0,0,0,0,0,0,0,141000,0,0,0,150000,9000,141000,141000
06454P,緯穎元大98售04  ,0,0,0,0,0,0,0,0,0,141000,0,0,0,235000,94000,141000,141000
05770P,聯發科凱基96售16,0,0,0,0,0,0,0,0,0,140000,0,0,0,150000,10000,140000,140000
05844P,旺宏元大96售07  ,0,0,0,0,0,0,0,0,0,140000,0,0,0,293000,153000,140000,140000
052057,臺股指凱基95購15,0,0,0,0,0,0,0,0,0,140000,0,0,0,184000,44000,140000,140000
052092,貿聯元大96購02  ,0,0,0,0,0,0,0,0,0,140000,0,0,0,200000,60000,140000,140000
049353,茂林永豐94購03  ,0,0,0,0,0,0,0,0,0,140000,0,0,0,140000,0,140000,140000
052687,國泰金元大96購03,0,0,0,0,0,0,0,0,0,140000,0,0,0,150000,10000,140000,140000
053426,創意永豐96購04  ,0,0,0,0,0,0,0,0,0,140000,0,0,0,218000,78000,140000,140000
06364P,鴻海凱基97售08  ,0,0,0,0,0,0,0,0,0,140000,0,0,0,140000,0,140000,140000
056813,聯茂統一99購01  ,0,0,0,0,0,0,0,0,0,139000,0,0,0,139000,0,139000,139000
056506,晶豪科永豐98購02,0,0,0,0,0,0,0,0,0,139000,0,0,0,139000,0,139000,139000
046403,技嘉元大92購01  ,0,0,0,0,0,0,0,0,0,139000,0,0,0,149000,10000,139000,139000
050576,南亞科國票95購01,0,0,0,0,0,0,0,0,0,139000,0,0,0,180000,41000,139000,139000
056848,泰鼎元富98購01  ,0,0,0,0,0,0,0,0,0,138000,0,0,0,448000,310000,138000,138000
057201,華擎元富98購01  ,0,0,0,0,0,0,0,0,0,138000,0,0,0,279000,141000,138000,138000
057333,智邦國票99購01  ,40000,0,40000,0,0,0,0,0,0,98000,0,0,0,260000,162000,98000,138000
049306,元油2X凱基96購01,0,0,0,0,0,0,0,0,0,138000,0,0,0,250000,112000,138000,138000
051645,光寶科永豐95購01,0,0,0,0,0,0,0,0,0,138000,0,0,0,146000,8000,138000,138000
053638,信邦永豐96購01  ,0,0,0,0,0,0,0,0,0,138000,0,0,0,138000,0,138000,138000
055220,緯穎凱基98購02  ,0,0,0,0,0,0,0,0,0,138000,0,0,0,349000,211000,138000,138000
054889,京鼎統一99購01  ,0,0,0,0,0,0,0,0,0,138000,0,0,0,322000,184000,138000,138000
06212P,華新科元大97售11,0,0,0,0,0,0,0,0,0,138000,0,0,0,313000,175000,138000,138000
05990P,台積電群益96售13,0,0,0,0,0,0,0,0,0,137000,0,0,0,137000,0,137000,137000
048786,瑞昱元大94購02  ,0,0,0,0,0,0,0,0,0,137000,0,0,0,162000,25000,137000,137000
051826,智邦元大95購03  ,0,0,0,0,0,0,0,0,0,137000,0,0,0,288000,151000,137000,137000
049042,玉晶光兆豐95購01,0,0,0,0,0,0,0,0,0,137000,0,0,0,147000,10000,137000,137000
054635,台達電中信98購01,0,0,0,0,0,0,0,0,0,137000,0,0,0,138000,1000,137000,137000
05286P,矽力統一95售02  ,0,0,0,0,0,0,0,0,0,137000,0,0,0,161000,24000,137000,137000
05823P,臺股指凱基96售20,0,0,0,0,0,0,0,0,0,136000,0,0,0,176000,40000,136000,136000
056802,友達台新98購01  ,0,0,0,0,0,0,0,0,0,136000,0,0,0,151000,15000,136000,136000
05712P,友達統一97售03  ,0,0,0,0,0,0,0,0,0,136000,0,0,0,136000,0,136000,136000
050671,超眾永豐94購04  ,0,0,0,0,0,0,0,0,0,136000,0,0,0,138000,2000,136000,136000
052763,晶技群益97購01  ,0,0,0,0,0,0,0,0,0,136000,0,0,0,280000,144000,136000,136000
054710,東元元富97購01  ,0,0,0,0,0,0,0,0,0,136000,0,0,0,136000,0,136000,136000
055209,勤誠康和97購01  ,0,0,0,0,0,0,0,0,0,136000,0,0,0,136000,0,136000,136000
056115,奇力新群益97購06,0,0,0,0,0,0,0,0,0,135000,0,0,0,454000,319000,135000,135000
056001,美食永豐97購01  ,0,0,0,0,0,0,0,0,0,135000,0,0,0,135000,0,135000,135000
050892,聯電元大96購02  ,0,0,0,0,0,0,0,0,0,135000,0,0,0,135000,0,135000,135000
054862,群光群益97購01  ,0,0,0,0,0,0,0,0,0,135000,0,0,0,135000,0,135000,135000
1103,嘉泥            ,272000,123000,149000,0,0,0,0,0,0,-14000,0,14000,-14000,0,0,0,135000
057085,立積統一9B購02  ,0,0,0,0,0,0,0,0,0,134000,0,0,0,154000,20000,134000,134000
046476,鴻海統一96購01  ,0,0,0,0,0,0,0,0,0,134000,0,0,0,275000,141000,134000,134000
04035P,全新群益93售03  ,0,0,0,0,0,0,0,0,0,134000,0,0,0,134000,0,134000,134000
056121,勤誠群益97購01  ,0,0,0,0,0,0,0,0,0,133000,0,0,0,143000,10000,133000,133000
053436,聯茂日盛96購01  ,0,0,0,0,0,0,0,0,0,133000,0,0,0,203000,70000,133000,133000
053736,友達麥證96購01  ,0,0,0,348000,215000,133000,0,0,0,133000,0,0,0,348000,215000,133000,133000
3030,德律            ,213000,80000,133000,0,0,0,0,0,0,0,0,0,0,0,0,0,133000
5203,訊連            ,160000,36000,124000,0,0,0,0,0,0,9000,4000,0,4000,13000,8000,5000,133000
056984,嘉晶群益98購01  ,0,0,0,0,0,0,0,0,0,132000,0,0,0,406000,274000,132000,132000
051873,緯穎凱基95購02  ,0,0,0,0,0,0,0,0,0,132000,0,0,0,393000,261000,132000,132000
048340,聯發科元大93購25,0,0,0,0,0,0,0,0,0,132000,0,0,0,228000,96000,132000,132000
04967P,台表科永豐94售04,0,0,0,0,0,0,0,0,0,132000,0,0,0,132000,0,132000,132000
051643,瑞昱康和95購01  ,0,0,0,0,0,0,0,0,0,132000,0,0,0,132000,0,132000,132000
054931,緯穎凱基98購01  ,0,0,0,0,0,0,0,0,0,132000,0,0,0,369000,237000,132000,132000
054094,創意群益96購02  ,0,0,0,0,0,0,0,0,0,132000,0,0,0,143000,11000,132000,132000
054315,訊芯凱基98購01  ,0,0,0,0,0,0,0,0,0,132000,0,0,0,297000,165000,132000,132000
055965,泰鼎元大97購03  ,0,0,0,0,0,0,0,0,0,131000,0,0,0,451000,320000,131000,131000
051027,楠梓電元富95購01,0,0,0,0,0,0,0,0,0,131000,0,0,0,165000,34000,131000,131000
05415P,台積電台新95售04,0,0,0,0,0,0,0,0,0,131000,0,0,0,140000,9000,131000,131000
055170,光磊統一97購01  ,0,0,0,0,0,0,0,0,0,131000,0,0,0,131000,0,131000,131000
06604P,聯發科元富02售02,0,0,0,0,0,0,0,0,0,131000,0,0,0,200000,69000,131000,131000
056029,國巨麥證98購01  ,0,0,0,140000,10000,130000,0,0,0,130000,0,0,0,140000,10000,130000,130000
056140,康控元大98購01  ,0,0,0,0,0,0,0,0,0,130000,0,0,0,603000,473000,130000,130000
056458,日月光凱基98購02,0,0,0,0,0,0,0,0,0,130000,0,0,0,130000,0,130000,130000
05549P,臺股指元大96售03,0,0,0,0,0,0,0,0,0,130000,0,0,0,155000,25000,130000,130000
056939,康控元富98購01  ,0,0,0,0,0,0,0,0,0,130000,0,0,0,191000,61000,130000,130000
057103,禾伸堂中信9A購01,0,0,0,0,0,0,0,0,0,130000,0,0,0,346000,216000,130000,130000
056760,元油2X元大98購06,0,0,0,0,0,0,0,0,0,130000,0,0,0,190000,60000,130000,130000
05761P,嘉澤永豐96售01  ,0,0,0,0,0,0,0,0,0,130000,0,0,0,190000,60000,130000,130000
04824P,亞泥中信94售02  ,0,0,0,0,0,0,0,0,0,130000,0,0,0,130000,0,130000,130000
03557P,欣興元大02售17  ,0,0,0,0,0,0,0,0,0,130000,0,0,0,130000,0,130000,130000
046257,A50正2國票94購01,0,0,0,0,0,0,0,0,0,130000,0,0,0,130000,0,130000,130000
045869,滬深2X元富95購01,0,0,0,0,0,0,0,0,0,130000,0,0,0,140000,10000,130000,130000
05245P,台積電元大95售18,0,0,0,0,0,0,0,0,0,130000,0,0,0,418000,288000,130000,130000
05244P,台積電元大95售17,0,0,0,0,0,0,0,0,0,130000,0,0,0,529000,399000,130000,130000
052175,可成元大95購10  ,0,0,0,0,0,0,0,0,0,130000,0,0,0,150000,20000,130000,130000
049715,華泰凱基94購02  ,0,0,0,0,0,0,0,0,0,130000,0,0,0,130000,0,130000,130000
055273,華泰元大97購01  ,0,0,0,0,0,0,0,0,0,130000,0,0,0,130000,0,130000,130000
05444P,大立光元大95售10,0,0,0,0,0,0,0,0,0,130000,0,0,0,170000,40000,130000,130000
057199,台達電元富02購01,0,0,0,0,0,0,0,0,0,129000,0,0,0,155000,26000,129000,129000
046185,正崴凱基93購02  ,0,0,0,0,0,0,0,0,0,129000,0,0,0,139000,10000,129000,129000
049302,聯茂日盛94購01  ,0,0,0,0,0,0,0,0,0,129000,0,0,0,129000,0,129000,129000
053357,可成統一96購02  ,0,0,0,0,0,0,0,0,0,129000,0,0,0,191000,62000,129000,129000
052833,康控群益96購01  ,0,0,0,0,0,0,0,0,0,129000,0,0,0,340000,211000,129000,129000
052947,晶技國票97購01  ,0,0,0,0,0,0,0,0,0,129000,0,0,0,167000,38000,129000,129000
1710,東聯            ,151000,22000,129000,0,0,0,0,0,0,0,0,0,0,0,0,0,129000
06421P,嘉澤統一97售02  ,0,0,0,0,0,0,0,0,0,129000,0,0,0,261000,132000,129000,129000
06475P,牧德永豐98售03  ,0,0,0,0,0,0,0,0,0,129000,0,0,0,197000,68000,129000,129000
049327,台郡元富94購01  ,0,0,0,0,0,0,0,0,0,128000,0,0,0,129000,1000,128000,128000
054579,聯茂元大97購01  ,0,0,0,0,0,0,0,0,0,128000,0,0,0,130000,2000,128000,128000
3605,宏致            ,234000,109000,125000,0,0,0,0,0,0,3000,3000,0,3000,0,0,0,128000
05677P,玉晶光群益98售03,0,0,0,0,0,0,0,0,0,127000,0,0,0,282000,155000,127000,127000
054855,得力群益98購01  ,0,0,0,0,0,0,0,0,0,127000,0,0,0,162000,35000,127000,127000
053077,同欣電永豐96購01,0,0,0,0,0,0,0,0,0,127000,0,0,0,227000,100000,127000,127000
05396P,台郡元大95售05  ,0,0,0,0,0,0,0,0,0,127000,0,0,0,187000,60000,127000,127000
046604,康控群益93購02  ,0,0,0,0,0,0,0,0,0,126000,0,0,0,180000,54000,126000,126000
050408,臻鼎台新94購02  ,0,0,0,0,0,0,0,0,0,126000,0,0,0,164000,38000,126000,126000
049048,玉晶光台新94購01,0,0,0,0,0,0,0,0,0,126000,0,0,0,126000,0,126000,126000
052885,高鐵兆豐98購01  ,0,0,0,0,0,0,0,0,0,126000,0,0,0,126000,0,126000,126000
054770,健策國票98購01  ,0,0,0,0,0,0,0,0,0,126000,0,0,0,206000,80000,126000,126000
055231,大毅國票98購02  ,0,0,0,0,0,0,0,0,0,126000,0,0,0,126000,0,126000,126000
05752P,台積電中信96售06,0,0,0,0,0,0,0,0,0,125000,0,0,0,125000,0,125000,125000
055703,緯穎富邦98購01  ,0,0,0,0,0,0,0,0,0,125000,0,0,0,399000,274000,125000,125000
03253P,台灣50國泰03售02,0,0,0,0,0,0,0,0,0,125000,0,0,0,125000,0,125000,125000
044995,大立光國泰94購01,0,0,0,0,0,0,0,0,0,125000,0,0,0,155000,30000,125000,125000
045369,康控兆豐93購01  ,0,0,0,0,0,0,0,0,0,125000,0,0,0,195000,70000,125000,125000
050790,昇陽半國泰96購02,0,0,0,0,0,0,0,0,0,125000,0,0,0,171000,46000,125000,125000
055028,佐登國泰98購01  ,0,350000,-350000,0,0,0,0,0,0,475000,0,0,0,1149000,674000,475000,125000
054632,緯穎凱基9A購01  ,0,0,0,0,0,0,0,0,0,125000,0,0,0,300000,175000,125000,125000
053130,聯發科麥證96購01,0,0,0,179000,54000,125000,0,0,0,125000,0,0,0,179000,54000,125000,125000
053751,康控永豐96購02  ,0,0,0,0,0,0,0,0,0,125000,0,0,0,242000,117000,125000,125000
05363P,臺股指富邦95售03,0,0,0,0,0,0,0,0,0,125000,0,0,0,250000,125000,125000,125000
057374,禾伸堂元大99購03,0,0,0,0,0,0,0,0,0,124000,0,0,0,218000,94000,124000,124000
047772,泰鼎元大93購05  ,0,0,0,0,0,0,0,0,0,124000,0,0,0,125000,1000,124000,124000
047509,技嘉國票93購01  ,0,0,0,0,0,0,0,0,0,124000,0,0,0,124000,0,124000,124000
052375,奇力新元大96購02,0,0,0,0,0,0,0,0,0,124000,0,0,0,331000,207000,124000,124000
053536,明泰永豐96購01  ,0,0,0,0,0,0,0,0,0,124000,0,0,0,134000,10000,124000,124000
054795,合勤控群益98購01,0,0,0,0,0,0,0,0,0,124000,0,0,0,153000,29000,124000,124000
055788,緯穎凱基97購04  ,0,0,0,0,0,0,0,0,0,123000,0,0,0,123000,0,123000,123000
055311,健策群益98購02  ,0,0,0,0,0,0,0,0,0,123000,0,0,0,150000,27000,123000,123000
048001,中工元大96購01  ,0,0,0,0,0,0,0,0,0,123000,0,0,0,123000,0,123000,123000
045749,智邦富邦93購01  ,0,0,0,0,0,0,0,0,0,123000,0,0,0,123000,0,123000,123000
052339,光寶科凱基95購01,0,0,0,0,0,0,0,0,0,123000,0,0,0,123000,0,123000,123000
049985,華擎凱基94購01  ,0,0,0,0,0,0,0,0,0,123000,0,0,0,198000,75000,123000,123000
3017,奇鋐            ,570000,787000,-217000,0,0,0,329000,0,329000,11000,0,0,0,39000,28000,11000,123000
2426,鼎元            ,142000,19000,123000,0,0,0,0,0,0,0,0,0,0,0,0,0,123000
055341,台達電凱基97購02,0,0,0,0,0,0,0,0,0,122000,0,0,0,179000,57000,122000,122000
055457,聚陽永豐97購01  ,0,0,0,0,0,0,0,0,0,122000,0,0,0,132000,10000,122000,122000
057178,可成元大98購03  ,0,0,0,0,0,0,0,0,0,122000,0,0,0,124000,2000,122000,122000
044285,鴻海凱基93購06  ,0,0,0,0,0,0,0,0,0,122000,0,0,0,225000,103000,122000,122000
044683,聯鈞凱基93購01  ,0,0,0,0,0,0,0,0,0,122000,0,0,0,324000,202000,122000,122000
048003,旭富元大93購01  ,0,0,0,0,0,0,0,0,0,122000,0,0,0,122000,0,122000,122000
052523,奇力新元大97購01,0,0,0,0,0,0,0,0,0,122000,0,0,0,301000,179000,122000,122000
051667,光磊元大96購02  ,0,0,0,0,0,0,0,0,0,122000,0,0,0,165000,43000,122000,122000
049365,美律元大94購04  ,0,0,0,0,0,0,0,0,0,122000,0,0,0,122000,0,122000,122000
052208,力成麥證95購01  ,0,0,0,131000,10000,121000,0,0,0,121000,0,0,0,131000,10000,121000,121000
052574,茂林凱基96購02  ,0,0,0,0,0,0,0,0,0,121000,0,0,0,323000,202000,121000,121000
053887,聯茂兆豐97購02  ,0,0,0,0,0,0,0,0,0,121000,0,0,0,161000,40000,121000,121000
056737,國巨凱基9A購01  ,0,0,0,0,0,0,0,0,0,120000,0,0,0,120000,0,120000,120000
056683,台積電統一98購05,0,0,0,0,0,0,0,0,0,120000,0,0,0,125000,5000,120000,120000
05531P,臺股指群益96售04,0,0,0,0,0,0,0,0,0,120000,0,0,0,120000,0,120000,120000
055879,神達元富97購01  ,0,0,0,0,0,0,0,0,0,120000,0,0,0,524000,404000,120000,120000
05636P,國巨永豐96售03  ,0,0,0,0,0,0,0,0,0,120000,0,0,0,120000,0,120000,120000
056015,華通群益99購01  ,0,0,0,0,0,0,0,0,0,120000,0,0,0,131000,11000,120000,120000
047687,元金2X富邦96購01,0,0,0,0,0,0,0,0,0,120000,0,0,0,120000,0,120000,120000
04855P,上証2X元富94售02,0,0,0,0,0,0,0,0,0,120000,0,0,0,140000,20000,120000,120000
044039,康控群益93購01  ,0,0,0,0,0,0,0,0,0,120000,0,0,0,120000,0,120000,120000
043585,道瓊反元大94購01,0,0,0,0,0,0,0,0,0,120000,0,0,0,120000,0,120000,120000
041042,美律群益92購01  ,0,0,0,0,0,0,0,0,0,120000,0,0,0,120000,0,120000,120000
043391,康控元大94購01  ,0,0,0,0,0,0,0,0,0,120000,0,0,0,160000,40000,120000,120000
048902,昇陽半國泰96購01,0,0,0,0,0,0,0,0,0,120000,0,0,0,206000,86000,120000,120000
051396,健鼎兆豐95購01  ,0,0,0,0,0,0,0,0,0,120000,0,0,0,120000,0,120000,120000
050560,聯詠統一94購02  ,0,0,0,0,0,0,0,0,0,120000,0,0,0,150000,30000,120000,120000
053538,京鼎永豐96購03  ,0,0,0,0,0,0,0,0,0,120000,0,0,0,120000,0,120000,120000
053350,台表科國票97購02,0,0,0,0,0,0,0,0,0,120000,0,0,0,140000,20000,120000,120000
054999,玉晶光元富97購03,0,0,0,0,0,0,0,0,0,120000,0,0,0,180000,60000,120000,120000
055291,京鼎元大97購02  ,0,0,0,0,0,0,0,0,0,120000,0,0,0,263000,143000,120000,120000
054580,樺漢元大98購01  ,0,0,0,0,0,0,0,0,0,120000,0,0,0,120000,0,120000,120000
054316,矽創凱基97購01  ,0,0,0,0,0,0,0,0,0,120000,0,0,0,198000,78000,120000,120000
2608,嘉里大榮        ,140000,20000,120000,0,0,0,0,0,0,0,0,0,0,0,0,0,120000
06394P,台積電元大97售28,0,0,0,0,0,0,0,0,0,120000,0,0,0,120000,0,120000,120000
06237P,台積電元大97售26,0,0,0,0,0,0,0,0,0,120000,0,0,0,120000,0,120000,120000
8464,億豐            ,540000,479000,61000,0,0,0,4000,0,4000,55000,56000,1000,55000,0,0,0,120000
056496,康控國泰99購01  ,0,0,0,0,0,0,0,0,0,119000,0,0,0,154000,35000,119000,119000
048787,義隆元大94購02  ,0,0,0,0,0,0,0,0,0,119000,0,0,0,134000,15000,119000,119000
048871,晶豪科國票94購01,0,0,0,0,0,0,0,0,0,119000,0,0,0,119000,0,119000,119000
053120,復盛中信9A購01  ,0,0,0,0,0,0,0,0,0,119000,0,0,0,248000,129000,119000,119000
052881,康控凱基97購01  ,0,0,0,0,0,0,0,0,0,119000,0,0,0,131000,12000,119000,119000
2401,凌陽            ,159000,37000,122000,0,0,0,0,0,0,-3000,1000,4000,-3000,0,0,0,119000
2369,菱生            ,145000,27000,118000,0,0,0,0,0,0,1000,1000,0,1000,0,0,0,119000
5243,乙盛-KY         ,168000,49000,119000,0,0,0,0,0,0,0,0,0,0,0,0,0,119000
056011,矽力中信99購01  ,0,0,0,0,0,0,0,0,0,118000,0,0,0,349000,231000,118000,118000
055631,創意永豐98購01  ,0,0,0,0,0,0,0,0,0,118000,0,0,0,186000,68000,118000,118000
056833,和大元富9B購01  ,0,0,0,0,0,0,0,0,0,118000,0,0,0,128000,10000,118000,118000
047131,鴻海凱基94購03  ,0,0,0,0,0,0,0,0,0,118000,0,0,0,118000,0,118000,118000
051786,A50正2國票95購02,0,0,0,0,0,0,0,0,0,118000,0,0,0,244000,126000,118000,118000
052547,光磊兆豐96購01  ,0,0,0,0,0,0,0,0,0,118000,0,0,0,128000,10000,118000,118000
049861,正崴兆豐94購01  ,0,0,0,0,0,0,0,0,0,118000,0,0,0,118000,0,118000,118000
052042,台積電日盛95購02,0,0,0,0,0,0,0,0,0,118000,0,0,0,125000,7000,118000,118000
05430P,台積電統一95售07,0,0,0,0,0,0,0,0,0,118000,0,0,0,248000,130000,118000,118000
055208,京鼎康和97購02  ,0,0,0,0,0,0,0,0,0,118000,0,0,0,118000,0,118000,118000
055211,A50反1凱基9A購01,0,0,0,0,0,0,0,0,0,118000,0,0,0,245000,127000,118000,118000
055055,精元永豐97購01  ,0,0,0,0,0,0,0,0,0,118000,0,0,0,118000,0,118000,118000
054702,智邦第一97購01  ,0,0,0,0,0,0,0,0,0,118000,0,0,0,153000,35000,118000,118000
06154P,超眾元大98售01  ,0,0,0,0,0,0,0,0,0,117000,0,0,0,140000,23000,117000,117000
055525,國巨群益98購05  ,0,0,0,0,0,0,0,0,0,117000,0,0,0,237000,120000,117000,117000
043907,鴻海凱基93購01  ,0,0,0,0,0,0,0,0,0,117000,0,0,0,117000,0,117000,117000
052070,GIS兆豐95購03   ,0,0,0,0,0,0,0,0,0,117000,0,0,0,117000,0,117000,117000
050098,嘉聯益國泰95購02,0,0,0,0,0,0,0,0,0,117000,0,0,0,117000,0,117000,117000
049372,華新科元大95購04,0,0,0,0,0,0,0,0,0,117000,0,0,0,140000,23000,117000,117000
051095,貿聯元大95購03  ,0,0,0,0,0,0,0,0,0,117000,0,0,0,181000,64000,117000,117000
051345,鴻海元大95購09  ,0,0,0,0,0,0,0,0,0,117000,0,0,0,245000,128000,117000,117000
049667,大立光國泰96購01,0,0,0,0,0,0,0,0,0,117000,0,0,0,155000,38000,117000,117000
054826,復盛元大9A購01  ,0,0,0,0,0,0,0,0,0,117000,0,0,0,149000,32000,117000,117000
055009,合勤控元富97購01,0,0,0,0,0,0,0,0,0,117000,0,0,0,217000,100000,117000,117000
054148,矽創元大96購03  ,0,0,0,0,0,0,0,0,0,117000,0,0,0,117000,0,117000,117000
055412,旺宏富邦99購01  ,0,0,0,0,0,0,0,0,0,116000,0,0,0,270000,154000,116000,116000
057197,立積台新98購01  ,0,0,0,0,0,0,0,0,0,116000,0,0,0,116000,0,116000,116000
056934,國巨元富98購04  ,0,0,0,0,0,0,0,0,0,116000,0,0,0,191000,75000,116000,116000
056936,禾伸堂元富98購01,0,0,0,0,0,0,0,0,0,116000,0,0,0,489000,373000,116000,116000
048553,光磊元大93購03  ,0,0,0,0,0,0,0,0,0,116000,0,0,0,130000,14000,116000,116000
052649,康控永豐96購01  ,0,0,0,0,0,0,0,0,0,116000,0,0,0,116000,0,116000,116000
050677,光寶科統一94購01,0,0,0,0,0,0,0,0,0,116000,0,0,0,121000,5000,116000,116000
051932,康控國票96購02  ,0,0,0,0,0,0,0,0,0,116000,0,0,0,136000,20000,116000,116000
05516P,台積電元大96售12,0,0,0,0,0,0,0,0,0,116000,0,0,0,142000,26000,116000,116000
06389P,聯發科兆豐97售01,0,0,0,0,0,0,0,0,0,116000,0,0,0,116000,0,116000,116000
06426P,T50正2元大9B售01,0,0,0,0,0,0,0,0,0,116000,0,0,0,200000,84000,116000,116000
06155P,智邦統一97售02  ,0,0,0,0,0,0,0,0,0,115000,0,0,0,233000,118000,115000,115000
055692,緯穎凱基97購03  ,0,0,0,0,0,0,0,0,0,115000,0,0,0,180000,65000,115000,115000
055979,聯鈞統一97購03  ,0,0,0,0,0,0,0,0,0,115000,0,0,0,413000,298000,115000,115000
046234,彩晶元大92購01  ,0,0,0,0,0,0,0,0,0,115000,0,0,0,145000,30000,115000,115000
04669P,臺股指國票94售08,0,0,0,0,0,0,0,0,0,115000,0,0,0,155000,40000,115000,115000
050471,國泰金台新94購01,0,0,0,0,0,0,0,0,0,115000,0,0,0,153000,38000,115000,115000
051647,華新科永豐95購02,0,0,0,0,0,0,0,0,0,115000,0,0,0,181000,66000,115000,115000
054748,正文凱基98購01  ,0,0,0,0,0,0,0,0,0,115000,0,0,0,115000,0,115000,115000
052476,台光電群益98購01,0,0,0,0,0,0,0,0,0,115000,0,0,0,186000,71000,115000,115000
053901,T50反1凱基99購03,0,0,0,0,0,0,0,0,0,115000,0,0,0,115000,0,115000,115000
053983,樺漢元大97購02  ,0,0,0,0,0,0,0,0,0,115000,0,0,0,203000,88000,115000,115000
055793,臺股指凱基97購16,0,0,0,0,0,0,0,0,0,114000,0,0,0,174000,60000,114000,114000
056977,國巨群益9A購01  ,0,0,0,0,0,0,0,0,0,114000,0,0,0,129000,15000,114000,114000
056747,致新凱基99購01  ,0,0,0,0,0,0,0,0,0,114000,0,0,0,314000,200000,114000,114000
046959,技嘉中信93購01  ,0,0,0,0,0,0,0,0,0,114000,0,0,0,114000,0,114000,114000
053562,玉晶光國泰98購02,0,0,0,0,0,0,0,0,0,114000,0,0,0,200000,86000,114000,114000
053068,智伸科群益96購01,0,0,0,0,0,0,0,0,0,114000,0,0,0,129000,15000,114000,114000
05580P,美律凱基96售03  ,0,0,0,0,0,0,0,0,0,113000,0,0,0,120000,7000,113000,113000
055719,可成元大97購03  ,0,0,0,0,0,0,0,0,0,113000,0,0,0,222000,109000,113000,113000
047511,義隆國票93購02  ,0,0,0,0,0,0,0,0,0,113000,0,0,0,113000,0,113000,113000
046264,美律凱基93購05  ,0,0,0,0,0,0,0,0,0,113000,0,0,0,430000,317000,113000,113000
047895,台積電群益94購04,0,0,0,0,0,0,0,0,0,113000,0,0,0,340000,227000,113000,113000
051556,台表科永豐96購01,0,0,0,0,0,0,0,0,0,113000,0,0,0,165000,52000,113000,113000
054944,精元元大97購01  ,0,0,0,0,0,0,0,0,0,113000,0,0,0,116000,3000,113000,113000
06198P,台積電元大98售06,0,0,0,0,0,0,0,0,0,113000,0,0,0,687000,574000,113000,113000
06322P,超眾統一97售04  ,0,0,0,0,0,0,0,0,0,113000,0,0,0,113000,0,113000,113000
057179,可成元大98購04  ,0,0,0,0,0,0,0,0,0,112000,0,0,0,336000,224000,112000,112000
050339,鴻海統一94購06  ,0,0,0,0,0,0,0,0,0,112000,0,0,0,112000,0,112000,112000
053158,茂林元大96購01  ,0,0,0,0,0,0,0,0,0,112000,0,0,0,288000,176000,112000,112000
06492P,上銀永豐98售01  ,0,0,0,0,0,0,0,0,0,112000,0,0,0,188000,76000,112000,112000
06129P,玉晶光元富97售06,0,0,0,0,0,0,0,0,0,111000,0,0,0,111000,0,111000,111000
056384,玉晶光國泰9A購02,0,0,0,0,0,0,0,0,0,111000,0,0,0,233000,122000,111000,111000
048436,聯茂日盛93購01  ,0,0,0,0,0,0,0,0,0,111000,0,0,0,121000,10000,111000,111000
051283,亞德客統一95購01,0,0,0,0,0,0,0,0,0,111000,0,0,0,261000,150000,111000,111000
053997,健策群益97購02  ,0,0,0,0,0,0,0,0,0,111000,0,0,0,221000,110000,111000,111000
053787,健策元大97購02  ,0,0,0,0,0,0,0,0,0,111000,0,0,0,175000,64000,111000,111000
054192,國巨中信98購01  ,0,0,0,0,0,0,0,0,0,111000,0,0,0,175000,64000,111000,111000
056316,訊芯元大98購03  ,0,0,0,0,0,0,0,0,0,110000,0,0,0,230000,120000,110000,110000
055997,矽創國泰99購01  ,0,0,0,0,0,0,0,0,0,110000,0,0,0,120000,10000,110000,110000
056128,和大中信99購01  ,0,0,0,0,0,0,0,0,0,110000,0,0,0,197000,87000,110000,110000
05895P,奇力新群益96售03,0,0,0,0,0,0,0,0,0,110000,0,0,0,133000,23000,110000,110000
057182,禾伸堂元大99購02,0,0,0,0,0,0,0,0,0,110000,0,0,0,213000,103000,110000,110000
05673P,台積電群益96售05,0,0,0,0,0,0,0,0,0,110000,0,0,0,110000,0,110000,110000
047998,美律元大93購06  ,0,0,0,0,0,0,0,0,0,110000,0,0,0,110000,0,110000,110000
048824,聯發科凱基94購03,0,0,0,0,0,0,0,0,0,110000,0,0,0,131000,21000,110000,110000
046200,上海銀凱基93購01,0,0,0,0,0,0,0,0,0,110000,0,0,0,110000,0,110000,110000
03999P,鴻海凱基94售11  ,0,0,0,0,0,0,0,0,0,110000,0,0,0,110000,0,110000,110000
041427,滬深2X國票93購01,0,0,0,0,0,0,0,0,0,110000,0,0,0,110000,0,110000,110000
049479,矽格永豐94購01  ,0,0,0,0,0,0,0,0,0,110000,0,0,0,110000,0,110000,110000
051499,康控群益95購02  ,0,0,0,0,0,0,0,0,0,110000,0,0,0,110000,0,110000,110000
049625,智易群益95購01  ,0,0,0,0,0,0,0,0,0,110000,0,0,0,110000,0,110000,110000
051383,京鼎群益96購02  ,0,0,0,0,0,0,0,0,0,110000,0,0,0,175000,65000,110000,110000
054383,傳奇群益97購01  ,0,0,0,0,0,0,0,0,0,110000,0,0,0,368000,258000,110000,110000
052782,超眾國票96購02  ,0,0,0,0,0,0,0,0,0,110000,0,0,0,110000,0,110000,110000
052223,聯電凱基96購02  ,0,0,0,0,0,0,0,0,0,110000,0,0,0,110000,0,110000,110000
2368,金像電          ,987000,1547000,-560000,0,0,0,550000,0,550000,120000,263000,143000,120000,0,0,0,110000
056776,聯茂元大99購01  ,0,0,0,0,0,0,0,0,0,109000,0,0,0,109000,0,109000,109000
057114,台虹群益98購01  ,0,0,0,0,0,0,0,0,0,109000,0,0,0,142000,33000,109000,109000
057267,康控兆豐99購01  ,0,0,0,0,0,0,0,0,0,109000,0,0,0,122000,13000,109000,109000
05962P,大立光群益96售07,0,0,0,0,0,0,0,0,0,109000,0,0,0,116000,7000,109000,109000
056240,嘉晶群益97購02  ,0,0,0,0,0,0,0,0,0,109000,0,0,0,331000,222000,109000,109000
051425,昇陽半國票97購01,0,0,0,0,0,0,0,0,0,109000,0,0,0,109000,0,109000,109000
049693,可成元大94購08  ,0,0,0,0,0,0,0,0,0,109000,0,0,0,122000,13000,109000,109000
055705,微星永豐97購01  ,0,0,0,0,0,0,0,0,0,108000,0,0,0,184000,76000,108000,108000
049198,聯鈞永豐94購01  ,0,0,0,0,0,0,0,0,0,108000,0,0,0,113000,5000,108000,108000
048703,康控國票95購01  ,0,0,0,0,0,0,0,0,0,108000,0,0,0,108000,0,108000,108000
048295,泰鼎群益93購01  ,0,0,0,0,0,0,0,0,0,108000,0,0,0,108000,0,108000,108000
048494,瑞昱元大93購13  ,0,0,0,0,0,0,0,0,0,108000,0,0,0,118000,10000,108000,108000
047419,聯發科富邦95購01,0,0,0,0,0,0,0,0,0,108000,0,0,0,108000,0,108000,108000
045898,康控元大93購04  ,0,0,0,0,0,0,0,0,0,108000,0,0,0,308000,200000,108000,108000
049078,瑞昱凱基94購02  ,0,0,0,0,0,0,0,0,0,108000,0,0,0,198000,90000,108000,108000
053019,禾伸堂元富96購01,0,0,0,0,0,0,0,0,0,108000,0,0,0,108000,0,108000,108000
051568,智邦富邦95購01  ,0,0,0,0,0,0,0,0,0,108000,0,0,0,208000,100000,108000,108000
049519,新光金國票95購03,0,0,0,0,0,0,0,0,0,108000,0,0,0,108000,0,108000,108000
051103,緯穎元大96購03  ,0,0,0,0,0,0,0,0,0,108000,0,0,0,118000,10000,108000,108000
2363,矽統            ,260000,155000,105000,0,0,0,0,0,0,3000,3000,0,3000,0,0,0,108000
2905,三商            ,134000,26000,108000,0,0,0,0,0,0,0,0,0,0,0,0,0,108000
05532P,臺股指群益96售05,0,0,0,0,0,0,0,0,0,107000,0,0,0,204000,97000,107000,107000
056482,貿聯元大99購01  ,0,0,0,0,0,0,0,0,0,107000,0,0,0,146000,39000,107000,107000
051482,玉晶光凱基96購01,0,0,0,0,0,0,0,0,0,107000,0,0,0,173000,66000,107000,107000
050928,日月光凱基95購01,0,0,0,0,0,0,0,0,0,107000,0,0,0,144000,37000,107000,107000
053473,聯發科元大96購15,0,0,0,0,0,0,0,0,0,107000,0,0,0,175000,68000,107000,107000
054903,億光康和97購02  ,0,0,0,0,0,0,0,0,0,107000,0,0,0,107000,0,107000,107000
2809,京城銀          ,199000,138000,61000,0,0,0,0,0,0,46000,50000,4000,46000,0,0,0,107000
055996,矽力國泰99購01  ,0,0,0,0,0,0,0,0,0,106000,0,0,0,221000,115000,106000,106000
057152,緯穎國票99購03  ,0,0,0,0,0,0,0,0,0,106000,0,0,0,120000,14000,106000,106000
056627,訊芯永豐98購01  ,0,0,0,0,0,0,0,0,0,106000,0,0,0,116000,10000,106000,106000
050804,和大日盛95購01  ,0,0,0,0,0,0,0,0,0,106000,0,0,0,106000,0,106000,106000
053692,聯詠元大96購04  ,0,0,0,0,0,0,0,0,0,106000,0,0,0,106000,0,106000,106000
056859,台積電群益98購02,0,0,0,0,0,0,0,0,0,105000,0,0,0,726000,621000,105000,105000
048421,聯茂統一93購01  ,0,0,0,0,0,0,0,0,0,105000,0,0,0,105000,0,105000,105000
04414P,牧德元富94售04  ,0,0,0,0,0,0,0,0,0,105000,0,0,0,235000,130000,105000,105000
047770,聯詠元大93購10  ,0,0,0,0,0,0,0,0,0,105000,0,0,0,105000,0,105000,105000
050526,貿聯元大95購01  ,0,0,0,0,0,0,0,0,0,105000,0,0,0,105000,0,105000,105000
053965,聯電元大98購04  ,0,0,0,0,0,0,0,0,0,105000,0,0,0,115000,10000,105000,105000
053277,大立光元大96購04,0,0,0,0,0,0,0,0,0,105000,0,0,0,155000,50000,105000,105000
054520,健鼎元大96購02  ,0,0,0,0,0,0,0,0,0,105000,0,0,0,105000,0,105000,105000
056239,宏達電群益98購01,0,0,0,0,0,0,0,0,0,104000,0,0,0,128000,24000,104000,104000
056321,創意群益98購02  ,0,0,0,0,0,0,0,0,0,104000,0,0,0,104000,0,104000,104000
055455,健策國泰98購02  ,0,0,0,0,0,0,0,0,0,104000,0,0,0,162000,58000,104000,104000
048336,光磊元大93購02  ,0,0,0,0,0,0,0,0,0,104000,0,0,0,155000,51000,104000,104000
051582,聯發科元大97購02,0,0,0,0,0,0,0,0,0,104000,0,0,0,324000,220000,104000,104000
051327,元油2X永豐95購02,0,0,0,0,0,0,0,0,0,104000,0,0,0,110000,6000,104000,104000
054616,智伸科永豐97購01,0,0,0,0,0,0,0,0,0,104000,0,0,0,114000,10000,104000,104000
054805,台苯元大9A購01  ,0,0,0,0,0,0,0,0,0,104000,0,0,0,104000,0,104000,104000
05311P,臺股指群益95售10,0,0,0,0,0,0,0,0,0,104000,0,0,0,104000,0,104000,104000
06268P,聯詠凱基97售02  ,0,0,0,0,0,0,0,0,0,104000,0,0,0,104000,0,104000,104000
1434,福懋            ,202000,99000,103000,0,0,0,0,0,0,1000,1000,0,1000,0,0,0,104000
055422,康控永豐97購01  ,0,0,0,0,0,0,0,0,0,103000,0,0,0,185000,82000,103000,103000
051888,國巨元富95購05  ,0,0,0,0,0,0,0,0,0,103000,0,0,0,442000,339000,103000,103000
048629,滬深2X元大96購04,0,0,0,0,0,0,0,0,0,103000,0,0,0,115000,12000,103000,103000
048641,美律元大94購01  ,0,0,0,0,0,0,0,0,0,103000,0,0,0,168000,65000,103000,103000
04723P,美律凱基94售06  ,0,0,0,0,0,0,0,0,0,103000,0,0,0,113000,10000,103000,103000
05062P,大立光富邦98售03,0,0,0,0,0,0,0,0,0,103000,0,0,0,108000,5000,103000,103000
052706,台虹國票97購01  ,0,0,0,0,0,0,0,0,0,103000,0,0,0,176000,73000,103000,103000
055149,國巨元大97購06  ,0,0,0,0,0,0,0,0,0,103000,0,0,0,250000,147000,103000,103000
056388,勤誠國泰99購01  ,0,0,0,0,0,0,0,0,0,102000,0,0,0,162000,60000,102000,102000
048607,上銀凱基93購11  ,0,0,0,0,0,0,0,0,0,102000,0,0,0,102000,0,102000,102000
051889,智邦元富95購02  ,0,0,0,0,0,0,0,0,0,102000,0,0,0,125000,23000,102000,102000
051869,康控凱基96購01  ,0,0,0,0,0,0,0,0,0,102000,0,0,0,105000,3000,102000,102000
049256,瑞昱元大94購04  ,0,0,0,0,0,0,0,0,0,102000,0,0,0,143000,41000,102000,102000
05052P,友達群益97售01  ,0,0,0,0,0,0,0,0,0,102000,0,0,0,102000,0,102000,102000
049623,創意群益94購01  ,0,0,0,0,0,0,0,0,0,102000,0,0,0,102000,0,102000,102000
053005,微星永豐96購01  ,0,0,0,0,0,0,0,0,0,102000,0,0,0,147000,45000,102000,102000
054318,台虹凱基98購01  ,0,0,0,0,0,0,0,0,0,102000,0,0,0,152000,50000,102000,102000
053809,上銀群益96購02  ,0,0,0,0,0,0,0,0,0,102000,0,0,0,246000,144000,102000,102000
06547P,大立光元大98售09,0,0,0,0,0,0,0,0,0,102000,0,0,0,140000,38000,102000,102000
057144,南電兆豐98購01  ,0,0,0,0,0,0,0,0,0,101000,0,0,0,297000,196000,101000,101000
049187,義隆台新94購01  ,0,0,0,0,0,0,0,0,0,101000,0,0,0,112000,11000,101000,101000
051430,瑞昱元富95購02  ,0,0,0,0,0,0,0,0,0,101000,0,0,0,201000,100000,101000,101000
042712,元石油國票95購01,0,0,0,0,0,0,0,0,0,101000,0,0,0,101000,0,101000,101000
049588,聯發科元大94購06,0,0,0,0,0,0,0,0,0,101000,0,0,0,115000,14000,101000,101000
050617,神基元大94購01  ,0,0,0,0,0,0,0,0,0,101000,0,0,0,110000,9000,101000,101000
052742,可成元大96購01  ,0,0,0,0,0,0,0,0,0,101000,0,0,0,125000,24000,101000,101000
052949,智易國票97購02  ,0,0,0,0,0,0,0,0,0,101000,0,0,0,101000,0,101000,101000
053188,旺宏統一97購03  ,0,0,0,0,0,0,0,0,0,101000,0,0,0,101000,0,101000,101000
06498P,臺股指元大9A售03,0,0,0,0,0,0,0,0,0,101000,0,0,0,101000,0,101000,101000
06242P,大立光元富9A售02,0,0,0,0,0,0,0,0,0,101000,0,0,0,125000,24000,101000,101000
08484P,台灣50中信96售01,0,0,0,0,0,0,0,0,0,101000,0,0,0,111000,10000,101000,101000
056916,台達電兆豐98購02,0,0,0,0,0,0,0,0,0,100000,0,0,0,100000,0,100000,100000
056651,聯茂凱基98購04  ,0,0,0,0,0,0,0,0,0,100000,0,0,0,140000,40000,100000,100000
056664,上証反中信9B購01,0,0,0,0,0,0,0,0,0,100000,0,0,0,100000,0,100000,100000
05900P,臺股指凱基99售05,0,0,0,0,0,0,0,0,0,100000,0,0,0,100000,0,100000,100000
05840P,臺股指富邦96售07,0,0,0,0,0,0,0,0,0,100000,0,0,0,150000,50000,100000,100000
05819P,臺股指凱基96售16,0,0,0,0,0,0,0,0,0,100000,0,0,0,100000,0,100000,100000
06138P,台積電中信99售01,0,0,0,0,0,0,0,0,0,100000,0,0,0,100000,0,100000,100000
056361,美律元大99購02  ,0,0,0,0,0,0,0,0,0,100000,0,0,0,120000,20000,100000,100000
056133,可成元大97購05  ,0,0,0,0,0,0,0,0,0,100000,0,0,0,372000,272000,100000,100000
055396,瑞儀統一97購01  ,0,0,0,0,0,0,0,0,0,100000,0,0,0,100000,0,100000,100000
055385,昇陽半元大98購01,0,0,0,0,0,0,0,0,0,100000,0,0,0,458000,358000,100000,100000
055504,貿聯元大98購04  ,0,0,0,0,0,0,0,0,0,100000,0,0,0,100000,0,100000,100000
055690,矽力凱基97購02  ,0,0,0,0,0,0,0,0,0,100000,0,0,0,100000,0,100000,100000
055860,啟碁元大97購04  ,0,0,0,0,0,0,0,0,0,100000,0,0,0,100000,0,100000,100000
042470,元油2X元大93購04,0,0,0,0,0,0,0,0,0,100000,0,0,0,100000,0,100000,100000
042137,元油2X元大93購01,0,0,0,0,0,0,0,0,0,100000,0,0,0,100000,0,100000,100000
047959,南電永豐93購03  ,0,0,0,0,0,0,0,0,0,100000,0,0,0,100000,0,100000,100000
046580,正崴元大92購01  ,0,0,0,0,0,0,0,0,0,100000,0,0,0,100000,0,100000,100000
046561,可成凱基92購11  ,0,0,0,0,0,0,0,0,0,100000,0,0,0,130000,30000,100000,100000
044299,南電凱基93購02  ,0,0,0,0,0,0,0,0,0,100000,0,0,0,100000,0,100000,100000
04378P,大立光元大94售05,0,0,0,0,0,0,0,0,0,100000,0,0,0,105000,5000,100000,100000
045974,傳奇凱基93購02  ,0,0,0,0,0,0,0,0,0,100000,0,0,0,100000,0,100000,100000
04491P,光磊康和94售01  ,0,0,0,0,0,0,0,0,0,100000,0,0,0,100000,0,100000,100000
044997,信邦國泰93購01  ,0,0,0,0,0,0,0,0,0,100000,0,0,0,100000,0,100000,100000
047023,聯發科元大93購08,0,0,0,0,0,0,0,0,0,100000,0,0,0,100000,0,100000,100000
048817,光寶科凱基94購02,0,0,0,0,0,0,0,0,0,100000,0,0,0,102000,2000,100000,100000
048213,群創麥證93購02  ,0,0,0,100000,0,100000,0,0,0,100000,0,0,0,100000,0,100000,100000
048000,義隆元大93購03  ,0,0,0,0,0,0,0,0,0,100000,0,0,0,100000,0,100000,100000
047387,美律元大93購05  ,0,0,0,0,0,0,0,0,0,100000,0,0,0,100000,0,100000,100000
048500,樺漢元大93購03  ,0,0,0,0,0,0,0,0,0,100000,0,0,0,100000,0,100000,100000
048480,FB上証中信94購01,0,0,0,0,0,0,0,0,0,100000,0,0,0,170000,70000,100000,100000
050530,台表科元大95購04,0,0,0,0,0,0,0,0,0,100000,0,0,0,100000,0,100000,100000
05160P,國巨國票96售03  ,0,0,0,0,0,0,0,0,0,100000,0,0,0,100000,0,100000,100000
051528,亞泥國票96購01  ,0,0,0,0,0,0,0,0,0,100000,0,0,0,100000,0,100000,100000
051511,鈺齊中信97購01  ,0,0,0,0,0,0,0,0,0,100000,0,0,0,100000,0,100000,100000
050439,新日興凱基94購01,0,0,0,0,0,0,0,0,0,100000,0,0,0,357000,257000,100000,100000
051980,樺漢凱基96購01  ,0,0,0,0,0,0,0,0,0,100000,0,0,0,102000,2000,100000,100000
051301,聯發科凱基95購08,0,0,0,0,0,0,0,0,0,100000,0,0,0,100000,0,100000,100000
051754,廣宇元大95購01  ,0,0,0,0,0,0,0,0,0,100000,0,0,0,100000,0,100000,100000
05177P,台積電凱基95售12,0,0,0,0,0,0,0,0,0,100000,0,0,0,100000,0,100000,100000
049489,美律元大94購05  ,0,0,0,0,0,0,0,0,0,100000,0,0,0,115000,15000,100000,100000
049440,T50反1統一94購04,0,0,0,0,0,0,0,0,0,100000,0,0,0,100000,0,100000,100000
051701,華通群益97購01  ,0,0,0,0,0,0,0,0,0,100000,0,0,0,102000,2000,100000,100000
050703,矽格凱基94購02  ,0,0,0,0,0,0,0,0,0,100000,0,0,0,100000,0,100000,100000
050698,明泰凱基96購01  ,0,0,0,0,0,0,0,0,0,100000,0,0,0,110000,10000,100000,100000
050674,瑞昱富邦94購02  ,0,0,0,0,0,0,0,0,0,100000,0,0,0,130000,30000,100000,100000
050647,聯發科凱基96購01,0,0,0,0,0,0,0,0,0,100000,0,0,0,113000,13000,100000,100000
050282,T50反1凱基97購01,0,0,0,0,0,0,0,0,0,100000,0,0,0,100000,0,100000,100000
049034,台達電兆豐94購01,0,0,0,0,0,0,0,0,0,100000,0,0,0,100000,0,100000,100000
049037,可成兆豐94購01  ,0,0,0,0,0,0,0,0,0,100000,0,0,0,100000,0,100000,100000
050959,元金2X永豐95購02,0,0,0,0,0,0,0,0,0,100000,0,0,0,101000,1000,100000,100000
053166,聯詠群益96購02  ,0,0,0,0,0,0,0,0,0,100000,0,0,0,110000,10000,100000,100000
053113,瀚宇博兆豐97購01,0,0,0,0,0,0,0,0,0,100000,0,0,0,100000,0,100000,100000
052935,康友元大96購03  ,0,0,0,0,0,0,0,0,0,100000,0,0,0,136000,36000,100000,100000
052928,美律元大98購01  ,0,0,0,0,0,0,0,0,0,100000,0,0,0,100000,0,100000,100000
05383P,鴻海富邦95售06  ,0,0,0,0,0,0,0,0,0,100000,0,0,0,100000,0,100000,100000
054265,GIS元大96購03   ,0,0,0,0,0,0,0,0,0,100000,0,0,0,102000,2000,100000,100000
054239,台郡群益96購02  ,0,0,0,0,0,0,0,0,0,100000,0,0,0,105000,5000,100000,100000
054494,訊芯台新96購01  ,0,0,0,0,0,0,0,0,0,100000,0,0,0,100000,0,100000,100000
055096,緯穎群益97購01  ,0,0,0,0,0,0,0,0,0,100000,0,0,0,216000,116000,100000,100000
05525P,奇力新群益96售02,0,0,0,0,0,0,0,0,0,100000,0,0,0,100000,0,100000,100000
054804,南亞元大9A購01  ,0,0,0,0,0,0,0,0,0,100000,0,0,0,100000,0,100000,100000
054852,奇鋐國票98購01  ,0,0,0,0,0,0,0,0,0,100000,0,0,0,100000,0,100000,100000
05485P,旺宏凱基95售08  ,0,0,0,0,0,0,0,0,0,100000,0,0,0,100000,0,100000,100000
08602P,台灣50凱基96售04,0,0,0,0,0,0,0,0,0,100000,0,0,0,100000,0,100000,100000
056333,台積電日盛9B購01,0,0,0,0,0,0,0,0,0,99000,0,0,0,139000,40000,99000,99000
056318,鴻海群益98購02  ,0,0,0,0,0,0,0,0,0,99000,0,0,0,107000,8000,99000,99000
06153P,健策元大97售04  ,0,0,0,0,0,0,0,0,0,99000,0,0,0,100000,1000,99000,99000
05815P,台積電凱基97售06,0,0,0,0,0,0,0,0,0,99000,0,0,0,118000,19000,99000,99000
056779,元油2X群益9A購02,0,0,0,0,0,0,0,0,0,99000,0,0,0,109000,10000,99000,99000
047702,鴻海凱基94購13  ,0,0,0,0,0,0,0,0,0,99000,0,0,0,119000,20000,99000,99000
04816P,台積電兆豐94售06,0,0,0,0,0,0,0,0,0,99000,0,0,0,99000,0,99000,99000
048331,臺指反富邦97購01,0,0,0,0,0,0,0,0,0,99000,0,0,0,100000,1000,99000,99000
049235,元油2X元富96購05,0,0,0,0,0,0,0,0,0,99000,0,0,0,99000,0,99000,99000
051830,健策元大97購01  ,0,0,0,0,0,0,0,0,0,99000,0,0,0,145000,46000,99000,99000
044941,鴻海群益93購01  ,0,0,0,0,0,0,0,0,0,99000,0,0,0,99000,0,99000,99000
04422P,玉晶光永豐94售03,0,0,0,0,0,0,0,0,0,99000,0,0,0,247000,148000,99000,99000
044124,燿華凱基93購01  ,0,0,0,0,0,0,0,0,0,99000,0,0,0,99000,0,99000,99000
00703,台新MSCI中國    ,0,0,0,0,0,0,0,0,0,99000,0,0,0,140000,41000,99000,99000
048914,川湖台新94購01  ,0,0,0,0,0,0,0,0,0,99000,0,0,0,193000,94000,99000,99000
051062,超眾群益95購02  ,0,0,0,0,0,0,0,0,0,99000,0,0,0,118000,19000,99000,99000
050169,臺指反元大97購01,0,0,0,0,0,0,0,0,0,99000,0,0,0,99000,0,99000,99000
051266,國巨富邦99購01  ,0,0,0,0,0,0,0,0,0,99000,0,0,0,225000,126000,99000,99000
054863,億光群益97購01  ,0,0,0,0,0,0,0,0,0,99000,0,0,0,99000,0,99000,99000
054208,台積電國票97購07,0,0,0,0,0,0,0,0,0,99000,0,0,0,237000,138000,99000,99000
054314,嘉聯益凱基97購01,0,0,0,0,0,0,0,0,0,99000,0,0,0,99000,0,99000,99000
056431,鴻海凱基98購07  ,0,0,0,0,0,0,0,0,0,98000,0,0,0,100000,2000,98000,98000
056139,貿聯元大97購04  ,0,0,0,0,0,0,0,0,0,98000,0,0,0,287000,189000,98000,98000
055873,聚陽元富97購01  ,0,0,0,0,0,0,0,0,0,98000,0,0,0,123000,25000,98000,98000
055699,康控國票97購04  ,0,0,0,0,0,0,0,0,0,98000,0,0,0,98000,0,98000,98000
055534,晶技群益97購03  ,0,0,0,0,0,0,0,0,0,98000,0,0,0,167000,69000,98000,98000
05546P,全新元大97售01  ,0,0,0,0,0,0,0,0,0,98000,0,0,0,198000,100000,98000,98000
055552,瑞昱凱基97購02  ,0,0,0,0,0,0,0,0,0,98000,0,0,0,149000,51000,98000,98000
040760,T50反1凱基95購01,0,0,0,0,0,0,0,0,0,98000,0,0,0,115000,17000,98000,98000
03828P,致茂中信95售01  ,0,0,0,0,0,0,0,0,0,98000,0,0,0,228000,130000,98000,98000
045228,泰鼎元大93購01  ,0,0,0,0,0,0,0,0,0,98000,0,0,0,98000,0,98000,98000
048008,聯發科富邦95購02,0,0,0,0,0,0,0,0,0,98000,0,0,0,98000,0,98000,98000
051323,康控國票96購01  ,0,0,0,0,0,0,0,0,0,98000,0,0,0,98000,0,98000,98000
052095,彩晶元大97購01  ,0,0,0,0,0,0,0,0,0,98000,0,0,0,98000,0,98000,98000
049980,奇力新凱基94購04,0,0,0,0,0,0,0,0,0,98000,0,0,0,101000,3000,98000,98000
05423P,聯電亞東95售02  ,0,0,0,0,0,0,0,0,0,98000,0,0,0,98000,0,98000,98000
055301,台虹元大97購01  ,0,0,0,0,0,0,0,0,0,98000,0,0,0,124000,26000,98000,98000
053815,聯發科群益96購01,0,0,0,0,0,0,0,0,0,98000,0,0,0,98000,0,98000,98000
053791,同欣電元大96購05,0,0,0,0,0,0,0,0,0,98000,0,0,0,341000,243000,98000,98000
052312,美律富邦96購02  ,0,0,0,0,0,0,0,0,0,98000,0,0,0,98000,0,98000,98000
052691,GIS元大96購01   ,0,0,0,0,0,0,0,0,0,98000,0,0,0,100000,2000,98000,98000
053110,大立光兆豐97購01,0,0,0,0,0,0,0,0,0,98000,0,0,0,98000,0,98000,98000
053239,崇越永豐96購01  ,0,0,0,0,0,0,0,0,0,98000,0,0,0,138000,40000,98000,98000
2515,中工            ,221000,129000,92000,0,0,0,0,0,0,6000,6000,0,6000,0,0,0,98000
057061,華擎國泰9A購01  ,0,0,0,0,0,0,0,0,0,97000,0,0,0,185000,88000,97000,97000
047637,旺宏元大94購03  ,0,0,0,0,0,0,0,0,0,97000,0,0,0,208000,111000,97000,97000
045456,鴻海元大93購04  ,0,0,0,0,0,0,0,0,0,97000,0,0,0,97000,0,97000,97000
047766,聯發科元大93購19,0,0,0,0,0,0,0,0,0,97000,0,0,0,100000,3000,97000,97000
050137,臺指反國票96購01,0,0,0,0,0,0,0,0,0,97000,0,0,0,100000,3000,97000,97000
055001,京鼎元富97購01  ,0,0,0,0,0,0,0,0,0,97000,0,0,0,764000,667000,97000,97000
05656P,台表科統一96售01,0,0,0,0,0,0,0,0,0,96000,0,0,0,96000,0,96000,96000
047993,鑽全元大96購01  ,0,0,0,0,0,0,0,0,0,96000,0,0,0,173000,77000,96000,96000
047886,京元電富邦95購01,0,0,0,0,0,0,0,0,0,96000,0,0,0,98000,2000,96000,96000
03874P,臺股指群益95售01,0,0,0,0,0,0,0,0,0,96000,0,0,0,96000,0,96000,96000
04293P,滬深2X元大96售02,0,0,0,0,0,0,0,0,0,96000,0,0,0,100000,4000,96000,96000
04294P,台積電元大95售01,0,0,0,0,0,0,0,0,0,96000,0,0,0,256000,160000,96000,96000
050678,美律統一94購04  ,0,0,0,0,0,0,0,0,0,96000,0,0,0,96000,0,96000,96000
055012,茂林元富97購01  ,0,0,0,0,0,0,0,0,0,96000,0,0,0,610000,514000,96000,96000
054771,茂林國票98購02  ,0,0,0,0,0,0,0,0,0,96000,0,0,0,98000,2000,96000,96000
055212,和大凱基97購02  ,0,0,0,0,0,0,0,0,0,96000,0,0,0,99000,3000,96000,96000
055089,金寶群益98購01  ,0,0,0,0,0,0,0,0,0,96000,0,0,0,310000,214000,96000,96000
054348,康控國票97購03  ,0,20000,-20000,0,0,0,0,0,0,116000,0,0,0,183000,67000,116000,96000
054594,國巨麥證97購01  ,0,0,0,266000,120000,146000,0,0,0,96000,0,0,0,266000,170000,96000,96000
052946,智原國票97購02  ,0,0,0,0,0,0,0,0,0,96000,0,0,0,96000,0,96000,96000
052238,智易國票96購01  ,0,0,0,0,0,0,0,0,0,96000,0,0,0,116000,20000,96000,96000
057112,立積群益99購01  ,0,0,0,0,0,0,0,0,0,95000,0,0,0,169000,74000,95000,95000
05620P,大立光富邦9B售01,0,0,0,0,0,0,0,0,0,95000,0,0,0,210000,115000,95000,95000
042281,元油2X富邦96購02,0,0,0,0,0,0,0,0,0,95000,0,0,0,170000,75000,95000,95000
044509,台光電凱基93購03,0,0,0,0,0,0,0,0,0,95000,0,0,0,105000,10000,95000,95000
048195,聯發科元大93購23,0,0,0,0,0,0,0,0,0,95000,0,0,0,168000,73000,95000,95000
049017,旺宏群益96購03  ,0,0,0,0,0,0,0,0,0,95000,0,0,0,107000,12000,95000,95000
05083P,麗豐永豐95售02  ,0,0,0,0,0,0,0,0,0,95000,0,0,0,149000,54000,95000,95000
052554,正崴國票97購01  ,0,0,0,0,0,0,0,0,0,95000,0,0,0,95000,0,95000,95000
052434,茂林國泰97購01  ,0,0,0,0,0,0,0,0,0,95000,0,0,0,108000,13000,95000,95000
054517,高鐵元大96購01  ,0,0,0,0,0,0,0,0,0,95000,0,0,0,95000,0,95000,95000
054808,東元元大9A購01  ,0,0,0,0,0,0,0,0,0,95000,0,0,0,115000,20000,95000,95000
6209,今國光          ,120000,26000,94000,0,0,0,0,0,0,1000,1000,0,1000,0,0,0,95000
06617P,智邦元大98售03  ,0,0,0,0,0,0,0,0,0,95000,0,0,0,119000,24000,95000,95000
056509,晶相光永豐98購01,0,0,0,0,0,0,0,0,0,94000,0,0,0,106000,12000,94000,94000
055509,訊芯元大97購03  ,0,0,0,0,0,0,0,0,0,94000,0,0,0,209000,115000,94000,94000
055935,創意群益97購02  ,0,0,0,0,0,0,0,0,0,94000,0,0,0,94000,0,94000,94000
055925,上銀群益97購01  ,0,0,0,0,0,0,0,0,0,94000,0,0,0,318000,224000,94000,94000
047292,台光電元富96購01,0,0,0,0,0,0,0,0,0,94000,0,0,0,98000,4000,94000,94000
047892,康控兆豐94購01  ,0,0,0,0,0,0,0,0,0,94000,0,0,0,94000,0,94000,94000
046310,聯發科元大92購15,0,0,0,0,0,0,0,0,0,94000,0,0,0,94000,0,94000,94000
051334,宏達電永豐95購01,0,0,0,0,0,0,0,0,0,94000,0,0,0,96000,2000,94000,94000
05013P,台積電元大96售05,0,0,0,0,0,0,0,0,0,94000,0,0,0,99000,5000,94000,94000
049408,旺宏日盛94購01  ,0,0,0,0,0,0,0,0,0,94000,0,0,0,94000,0,94000,94000
054848,群創兆豐98購01  ,0,0,0,0,0,0,0,0,0,94000,0,0,0,264000,170000,94000,94000
053125,宏達電凱基96購01,0,0,0,0,0,0,0,0,0,94000,0,0,0,94000,0,94000,94000
3533,嘉澤            ,418000,164000,254000,0,0,0,39000,201000,-162000,2000,2000,17000,-15000,19000,2000,17000,94000
057084,立積統一9B購01  ,0,0,0,0,0,0,0,0,0,93000,0,0,0,93000,0,93000,93000
05684P,臺股指元大96售09,0,0,0,0,0,0,0,0,0,93000,0,0,0,455000,362000,93000,93000
03769P,聯發科元大93售04,0,0,0,0,0,0,0,0,0,93000,0,0,0,398000,305000,93000,93000
051951,聯發科元富95購02,0,0,0,0,0,0,0,0,0,93000,0,0,0,98000,5000,93000,93000
050998,訊連元大95購01  ,0,0,0,0,0,0,0,0,0,93000,0,0,0,170000,77000,93000,93000
052703,貿聯國票97購01  ,0,0,0,0,0,0,0,0,0,93000,0,0,0,93000,0,93000,93000
05378P,台積電凱基96售02,0,0,0,0,0,0,0,0,0,93000,0,0,0,205000,112000,93000,93000
056804,T50反1統一9A購03,0,0,0,0,0,0,0,0,0,92000,0,0,0,100000,8000,92000,92000
05914P,友達元大96售04  ,0,0,0,0,0,0,0,0,0,92000,0,0,0,161000,69000,92000,92000
055670,矽創群益98購02  ,0,0,0,0,0,0,0,0,0,92000,0,0,0,145000,53000,92000,92000
056507,創意永豐98購02  ,0,0,0,0,0,0,0,0,0,92000,0,0,0,149000,57000,92000,92000
056472,美律元大99購03  ,0,0,0,0,0,0,0,0,0,92000,0,0,0,117000,25000,92000,92000
048403,聯發科群益93購10,0,0,0,0,0,0,0,0,0,92000,0,0,0,107000,15000,92000,92000
053837,貿聯永豐96購02  ,0,0,0,0,0,0,0,0,0,92000,0,0,0,170000,78000,92000,92000
05315P,鴻海永昌96售08  ,0,0,0,0,0,0,0,0,0,92000,0,0,0,92000,0,92000,92000
054800,訊芯群益99購01  ,0,0,0,0,0,0,0,0,0,92000,0,0,0,183000,91000,92000,92000
047433,鴻海元大93購16  ,0,0,0,0,0,0,0,0,0,91000,0,0,0,91000,0,91000,91000
049068,元油2X凱基95購03,0,0,0,0,0,0,0,0,0,91000,0,0,0,92000,1000,91000,91000
052525,聯詠元大95購06  ,0,0,0,0,0,0,0,0,0,91000,0,0,0,133000,42000,91000,91000
052179,康友元大95購03  ,0,0,0,0,0,0,0,0,0,91000,0,0,0,218000,127000,91000,91000
054777,昇陽半國票98購01,0,0,0,0,0,0,0,0,0,91000,0,0,0,91000,0,91000,91000
054090,瑞昱群益97購01  ,0,0,0,0,0,0,0,0,0,91000,0,0,0,174000,83000,91000,91000
6191,精成科          ,192000,106000,86000,0,0,0,0,0,0,5000,8000,0,8000,0,3000,-3000,91000
1905,華紙            ,143000,52000,91000,0,0,0,0,0,0,0,0,0,0,0,0,0,91000
056416,華新科中信98購01,0,0,0,0,0,0,0,0,0,90000,0,0,0,111000,21000,90000,90000
056130,新日興麥證97購01,0,0,0,123000,31000,92000,0,0,0,90000,0,0,0,123000,33000,90000,90000
056120,聯茂群益97購02  ,0,0,0,0,0,0,0,0,0,90000,0,0,0,92000,2000,90000,90000
055816,新日興國票98購01,0,0,0,0,0,0,0,0,0,90000,0,0,0,130000,40000,90000,90000
055819,晶相光國票98購01,0,0,0,0,0,0,0,0,0,90000,0,0,0,100000,10000,90000,90000
057167,台積電元大99購03,0,0,0,0,0,0,0,0,0,90000,0,0,0,146000,56000,90000,90000
04826P,華新科麥證95售01,0,0,0,100000,10000,90000,0,0,0,90000,0,0,0,100000,10000,90000,90000
047274,華新科永豐93購02,0,0,0,0,0,0,0,0,0,90000,0,0,0,150000,60000,90000,90000
047303,寶滬深元大96購01,0,0,0,0,0,0,0,0,0,90000,0,0,0,90000,0,90000,90000
03660C,元油2X富邦02牛04,0,0,0,0,0,0,0,0,0,90000,0,0,0,100000,10000,90000,90000
043040,永冠元富94購01  ,0,0,0,0,0,0,0,0,0,90000,0,0,0,90000,0,90000,90000
043538,元石油國票97購01,0,0,0,0,0,0,0,0,0,90000,0,0,0,96000,6000,90000,90000
045449,嘉聯益國泰94購01,0,0,0,0,0,0,0,0,0,90000,0,0,0,109000,19000,90000,90000
044764,聯茂凱基93購03  ,0,0,0,0,0,0,0,0,0,90000,0,0,0,90000,0,90000,90000
04575P,新日興統一94售02,0,0,0,0,0,0,0,0,0,90000,0,0,0,105000,15000,90000,90000
049852,康控群益94購03  ,0,0,0,0,0,0,0,0,0,90000,0,0,0,90000,0,90000,90000
049824,鴻海凱基94購18  ,0,0,0,0,0,0,0,0,0,90000,0,0,0,100000,10000,90000,90000
053015,緯創統一96購01  ,0,0,0,0,0,0,0,0,0,90000,0,0,0,90000,0,90000,90000
049375,大立光元大94購13,0,0,0,0,0,0,0,0,0,90000,0,0,0,110000,20000,90000,90000
050527,嘉聯益元大96購01,0,0,0,0,0,0,0,0,0,90000,0,0,0,90000,0,90000,90000
050125,中環凱基94購01  ,0,0,0,0,0,0,0,0,0,90000,0,0,0,90000,0,90000,90000
05010P,台郡元富95售01  ,0,0,0,0,0,0,0,0,0,90000,0,0,0,110000,20000,90000,90000
051751,聯茂富邦95購01  ,0,0,0,0,0,0,0,0,0,90000,0,0,0,100000,10000,90000,90000
051639,康友國票96購02  ,0,0,0,0,0,0,0,0,0,90000,0,0,0,110000,20000,90000,90000
054151,瑞昱國泰97購01  ,0,0,0,0,0,0,0,0,0,90000,0,0,0,91000,1000,90000,90000
054568,訊芯群益97購01  ,0,0,0,0,0,0,0,0,0,90000,0,0,0,251000,161000,90000,90000
055034,建準富邦99購01  ,0,0,0,0,0,0,0,0,0,90000,0,0,0,110000,20000,90000,90000
055143,臻鼎永豐97購01  ,0,0,0,0,0,0,0,0,0,90000,0,0,0,90000,0,90000,90000
055276,台積電元大97購20,0,0,0,0,0,0,0,0,0,90000,0,0,0,100000,10000,90000,90000
053861,台光電元大98購01,0,0,0,0,0,0,0,0,0,90000,0,0,0,139000,49000,90000,90000
053933,大立光統一96購06,0,0,0,0,0,0,0,0,0,90000,0,0,0,90000,0,90000,90000
06420P,大立光統一98售06,0,0,0,0,0,0,0,0,0,90000,0,0,0,90000,0,90000,90000
056775,康控元大99購01  ,0,0,0,0,0,0,0,0,0,89000,0,0,0,188000,99000,89000,89000
05862P,大立光國泰98售01,0,0,0,0,0,0,0,0,0,89000,0,0,0,655000,566000,89000,89000
06080P,景碩群益98售02  ,0,0,0,0,0,0,0,0,0,89000,0,0,0,132000,43000,89000,89000
057323,智邦群益98購01  ,0,0,0,0,0,0,0,0,0,89000,0,0,0,125000,36000,89000,89000
055400,緯穎統一97購01  ,0,0,0,0,0,0,0,0,0,89000,0,0,0,89000,0,89000,89000
04283P,麗豐永豐93售03  ,0,0,0,0,0,0,0,0,0,89000,0,0,0,89000,0,89000,89000
051112,台郡統一95購01  ,0,0,0,0,0,0,0,0,0,89000,0,0,0,92000,3000,89000,89000
049537,元石油群益97購01,0,0,0,0,0,0,0,0,0,89000,0,0,0,122000,33000,89000,89000
053867,創意元大96購04  ,0,0,0,0,0,0,0,0,0,89000,0,0,0,119000,30000,89000,89000
6166,凌華            ,178000,89000,89000,0,0,0,0,0,0,0,1000,0,1000,0,1000,-1000,89000
2535,達欣工          ,309000,10000,299000,0,0,0,0,0,0,-210000,0,210000,-210000,0,0,0,89000
05563P,台積電元大97售07,0,0,0,0,0,0,0,0,0,88000,0,0,0,174000,86000,88000,88000
057288,聯茂元大98購03  ,0,0,0,0,0,0,0,0,0,88000,0,0,0,158000,70000,88000,88000
05863P,滬深2X元大96售09,0,0,0,0,0,0,0,0,0,88000,0,0,0,100000,12000,88000,88000
047767,聯發科元大93購20,0,0,0,0,0,0,0,0,0,88000,0,0,0,100000,12000,88000,88000
046333,康友元大92購05  ,0,0,0,0,0,0,0,0,0,88000,0,0,0,98000,10000,88000,88000
05180P,玉晶光凱基95售04,0,0,0,0,0,0,0,0,0,88000,0,0,0,170000,82000,88000,88000
052450,嘉澤元大95購03  ,0,0,0,0,0,0,0,0,0,88000,0,0,0,113000,25000,88000,88000
051506,台積電元富95購06,0,0,0,0,0,0,0,0,0,88000,0,0,0,977000,889000,88000,88000
053935,華通元富96購02  ,0,0,0,0,0,0,0,0,0,88000,0,0,0,88000,0,88000,88000
053522,臺股指群益99購01,0,0,0,0,0,0,0,0,0,88000,0,0,0,262000,174000,88000,88000
053161,康友元大96購04  ,0,0,0,0,0,0,0,0,0,88000,0,0,0,110000,22000,88000,88000
052899,和大國票97購01  ,0,0,0,0,0,0,0,0,0,88000,0,0,0,98000,10000,88000,88000
054742,京鼎凱基99購01  ,0,0,0,0,0,0,0,0,0,88000,0,0,0,88000,0,88000,88000
3504,揚明光          ,119000,23000,96000,0,0,0,0,0,0,-8000,0,0,0,0,8000,-8000,88000
055924,深中小群益9B購01,0,0,0,0,0,0,0,0,0,87000,0,0,0,87000,0,87000,87000
048598,瑞昱國票93購03  ,0,0,0,0,0,0,0,0,0,87000,0,0,0,88000,1000,87000,87000
045632,正崴凱基93購01  ,0,0,0,0,0,0,0,0,0,87000,0,0,0,145000,58000,87000,87000
050744,健策永豐94購04  ,0,0,0,0,0,0,0,0,0,87000,0,0,0,151000,64000,87000,87000
050149,東元群益94購01  ,0,0,0,0,0,0,0,0,0,87000,0,0,0,97000,10000,87000,87000
050220,台積電元富96購01,0,0,0,0,0,0,0,0,0,87000,0,0,0,101000,14000,87000,87000
052578,大立光統一97購01,0,0,0,0,0,0,0,0,0,87000,0,0,0,128000,41000,87000,87000
050823,信邦凱基95購01  ,0,0,0,0,0,0,0,0,0,87000,0,0,0,100000,13000,87000,87000
054781,台化群益99購01  ,0,0,0,0,0,0,0,0,0,87000,0,0,0,87000,0,87000,87000
054574,美律元大99購01  ,0,0,0,0,0,0,0,0,0,87000,0,0,0,137000,50000,87000,87000
9907,統一實          ,113000,26000,87000,0,0,0,0,0,0,0,0,0,0,0,0,0,87000
043156,大立光統一94購01,0,0,0,0,0,0,0,0,0,86000,0,0,0,122000,36000,86000,86000
048818,台達電凱基94購01,0,0,0,0,0,0,0,0,0,86000,0,0,0,86000,0,86000,86000
051354,聯發科元大95購09,0,0,0,0,0,0,0,0,0,86000,0,0,0,130000,44000,86000,86000
051167,京鼎元大95購01  ,0,0,0,0,0,0,0,0,0,86000,0,0,0,132000,46000,86000,86000
050532,矽創元大94購03  ,0,0,0,0,0,0,0,0,0,86000,0,0,0,154000,68000,86000,86000
049427,瑞昱兆豐94購01  ,0,0,0,0,0,0,0,0,0,86000,0,0,0,101000,15000,86000,86000
054012,廣達永豐96購01  ,0,0,0,0,0,0,0,0,0,86000,0,0,0,167000,81000,86000,86000
3530,晶相光          ,130000,135000,-5000,0,0,0,0,0,0,91000,2000,0,2000,99000,10000,89000,86000
055744,茂林元富97購02  ,0,0,0,0,0,0,0,0,0,85000,0,0,0,987000,902000,85000,85000
055986,祥碩元富97購01  ,0,0,0,0,0,0,0,0,0,85000,0,0,0,110000,25000,85000,85000
056423,奇鋐統一98購01  ,0,0,0,0,0,0,0,0,0,85000,0,0,0,268000,183000,85000,85000
06134P,緯穎元富97售03  ,0,0,0,0,0,0,0,0,0,85000,0,0,0,185000,100000,85000,85000
05824P,臺股指凱基96售21,0,0,0,0,0,0,0,0,0,85000,0,0,0,85000,0,85000,85000
047301,啟碁國泰94購01  ,0,0,0,0,0,0,0,0,0,85000,0,0,0,85000,0,85000,85000
048333,大立光富邦95購01,0,0,0,0,0,0,0,0,0,85000,0,0,0,95000,10000,85000,85000
05200P,臺股指永豐95售03,0,0,0,0,0,0,0,0,0,85000,0,0,0,85000,0,85000,85000
050226,華新科中信94購01,0,0,0,0,0,0,0,0,0,85000,0,0,0,228000,143000,85000,85000
050990,T50反1元大95購01,0,0,0,0,0,0,0,0,0,85000,0,0,0,90000,5000,85000,85000
051084,華通元大95購06  ,0,0,0,0,0,0,0,0,0,85000,0,0,0,85000,0,85000,85000
049167,元油2X凱基97購03,0,0,0,0,0,0,0,0,0,85000,0,0,0,85000,0,85000,85000
054816,聯發科元大97購12,0,0,0,0,0,0,0,0,0,85000,0,0,0,178000,93000,85000,85000
053558,訊芯凱基96購02  ,0,0,0,0,0,0,0,0,0,85000,0,0,0,348000,263000,85000,85000
056745,聯茂凱基99購03  ,0,0,0,0,0,0,0,0,0,84000,0,0,0,205000,121000,84000,84000
056741,大立光凱基98購14,0,0,0,0,0,0,0,0,0,84000,0,0,0,86000,2000,84000,84000
057106,美律群益98購03  ,0,0,0,0,0,0,0,0,0,84000,0,0,0,178000,94000,84000,84000
056450,可成凱基98購05  ,0,0,0,0,0,0,0,0,0,84000,0,0,0,178000,94000,84000,84000
056480,京鼎元大98購02  ,0,0,0,0,0,0,0,0,0,84000,0,0,0,131000,47000,84000,84000
056476,智原元大98購02  ,0,0,0,0,0,0,0,0,0,84000,0,0,0,147000,63000,84000,84000
056036,鴻海凱基97購07  ,0,0,0,0,0,0,0,0,0,84000,0,0,0,152000,68000,84000,84000
050944,智邦群益95購01  ,0,0,0,0,0,0,0,0,0,84000,0,0,0,305000,221000,84000,84000
053802,南亞科凱基96購04,0,0,0,0,0,0,0,0,0,84000,0,0,0,100000,16000,84000,84000
054630,聯鈞凱基98購01  ,0,0,0,0,0,0,0,0,0,84000,0,0,0,176000,92000,84000,84000
047196,上銀統一97購01  ,0,0,0,0,0,0,0,0,0,83000,0,0,0,732000,649000,83000,83000
04106P,滬深2X永豐93售02,0,0,0,0,0,0,0,0,0,83000,0,0,0,100000,17000,83000,83000
052385,滬深2X群益99購05,0,0,0,0,0,0,0,0,0,83000,0,0,0,143000,60000,83000,83000
051708,創意群益95購02  ,0,0,0,0,0,0,0,0,0,83000,0,0,0,83000,0,83000,83000
051535,新日興國票96購01,0,0,0,0,0,0,0,0,0,83000,0,0,0,130000,47000,83000,83000
050132,日電貿凱基94購02,0,0,0,0,0,0,0,0,0,83000,0,0,0,294000,211000,83000,83000
053872,臻鼎元大96購04  ,0,0,0,0,0,0,0,0,0,83000,0,0,0,86000,3000,83000,83000
06283P,祥碩永豐97售01  ,0,0,0,0,0,0,0,0,0,83000,0,0,0,103000,20000,83000,83000
3008,大立光          ,224640,118000,106640,0,0,0,0,37000,-37000,13000,15000,4000,11000,6000,4000,2000,82640
056516,晶豪科兆豐98購01,0,0,0,0,0,0,0,0,0,82000,0,0,0,534000,452000,82000,82000
055515,聚陽中信9A購01  ,0,0,0,0,0,0,0,0,0,82000,0,0,0,196000,114000,82000,82000
06110P,國巨國泰98售02  ,0,0,0,0,0,0,0,0,0,82000,0,0,0,213000,131000,82000,82000
06056P,台積電凱基98售02,0,0,0,0,0,0,0,0,0,82000,0,0,0,82000,0,82000,82000
051807,瑞昱凱基95購03  ,0,0,0,0,0,0,0,0,0,82000,0,0,0,87000,5000,82000,82000
051040,漢唐永豐95購01  ,0,0,0,0,0,0,0,0,0,82000,0,0,0,154000,72000,82000,82000
052102,台泥兆豐96購01  ,0,0,0,0,0,0,0,0,0,82000,0,0,0,182000,100000,82000,82000
053003,國巨永豐96購02  ,0,0,0,0,0,0,0,0,0,82000,0,0,0,97000,15000,82000,82000
049091,訊連凱基94購01  ,0,0,0,0,0,0,0,0,0,82000,0,0,0,101000,19000,82000,82000
054236,貿聯群益96購01  ,0,0,0,0,0,0,0,0,0,82000,0,0,0,82000,0,82000,82000
054324,美律台新97購01  ,0,0,0,0,0,0,0,0,0,82000,0,0,0,202000,120000,82000,82000
06347P,祥碩元富97售02  ,0,0,0,0,0,0,0,0,0,82000,0,0,0,227000,145000,82000,82000
056866,矽創群益98購03  ,0,0,0,0,0,0,0,0,0,81000,0,0,0,103000,22000,81000,81000
055397,超眾統一97購02  ,0,0,0,0,0,0,0,0,0,81000,0,0,0,81000,0,81000,81000
056484,聯茂元大98購02  ,0,0,0,0,0,0,0,0,0,81000,0,0,0,81000,0,81000,81000
056424,泰碩統一98購01  ,0,0,0,0,0,0,0,0,0,81000,0,0,0,81000,0,81000,81000
056244,群創群益98購09  ,0,0,0,0,0,0,0,0,0,81000,0,0,0,81000,0,81000,81000
046882,智易富邦97購01  ,0,0,0,0,0,0,0,0,0,81000,0,0,0,151000,70000,81000,81000
047372,創意國票94購01  ,0,0,0,0,0,0,0,0,0,81000,0,0,0,81000,0,81000,81000
04617P,臺股指群益95售03,0,0,0,0,0,0,0,0,0,81000,0,0,0,81000,0,81000,81000
050877,美律統一95購01  ,0,0,0,0,0,0,0,0,0,81000,0,0,0,204000,123000,81000,81000
051420,康控國票95購05  ,0,0,0,0,0,0,0,0,0,81000,0,0,0,137000,56000,81000,81000
052655,群創統一97購01  ,0,0,0,0,0,0,0,0,0,81000,0,0,0,246000,165000,81000,81000
054045,奇力新元大97購03,0,0,0,0,0,0,0,0,0,81000,0,0,0,209000,128000,81000,81000
054627,義隆凱基98購01  ,0,0,0,0,0,0,0,0,0,81000,0,0,0,81000,0,81000,81000
05454P,奇鋐群益95售04  ,0,0,0,0,0,0,0,0,0,81000,0,0,0,81000,0,81000,81000
053661,嘉澤凱基97購01  ,0,0,0,0,0,0,0,0,0,81000,0,0,0,106000,25000,81000,81000
053270,台塑元大96購01  ,0,0,0,0,0,0,0,0,0,81000,0,0,0,82000,1000,81000,81000
06205P,台積電群益97售03,0,0,0,0,0,0,0,0,0,81000,0,0,0,81000,0,81000,81000
06466P,台積電統一9B售01,0,0,0,0,0,0,0,0,0,81000,0,0,0,91000,10000,81000,81000
6414,樺漢            ,90000,19000,71000,0,0,0,0,0,0,10000,4000,4000,0,16000,6000,10000,81000
055870,智原台新97購01  ,0,0,0,0,0,0,0,0,0,80000,0,0,0,80000,0,80000,80000
056858,國巨群益99購03  ,0,0,0,0,0,0,0,0,0,80000,0,0,0,101000,21000,80000,80000
056805,元石油統一9B購01,0,0,0,0,0,0,0,0,0,80000,0,0,0,112000,32000,80000,80000
06033P,可成凱基96售09  ,0,0,0,0,0,0,0,0,0,80000,0,0,0,80000,0,80000,80000
05839P,臺股指富邦96售06,0,0,0,0,0,0,0,0,0,80000,0,0,0,105000,25000,80000,80000
05915P,聯發科元大96售19,0,0,0,0,0,0,0,0,0,80000,0,0,0,135000,55000,80000,80000
057261,瑞昱兆豐98購01  ,0,0,0,0,0,0,0,0,0,80000,0,0,0,120000,40000,80000,80000
041991,元油2X國票98購01,0,0,0,0,0,0,0,0,0,80000,0,0,0,100000,20000,80000,80000
044429,元金2X元大94購04,0,0,0,0,0,0,0,0,0,80000,0,0,0,80000,0,80000,80000
04760P,旺宏凱基94售02  ,0,0,0,0,0,0,0,0,0,80000,0,0,0,150000,70000,80000,80000
050378,上証2X群益98購02,0,0,0,0,0,0,0,0,0,80000,0,0,0,80000,0,80000,80000
04727P,臺股指凱基96售03,0,0,0,0,0,0,0,0,0,80000,0,0,0,82000,2000,80000,80000
047330,康舒元大93購01  ,0,0,0,0,0,0,0,0,0,80000,0,0,0,100000,20000,80000,80000
052159,瑞昱永豐95購01  ,0,0,0,0,0,0,0,0,0,80000,0,0,0,186000,106000,80000,80000
04963P,鴻海元大94售25  ,0,0,0,0,0,0,0,0,0,80000,0,0,0,85000,5000,80000,80000
049648,大立光凱基94購08,0,0,0,0,0,0,0,0,0,80000,0,0,0,80000,0,80000,80000
051527,台郡凱基95購03  ,0,0,0,0,0,0,0,0,0,80000,0,0,0,138000,58000,80000,80000
053244,光磊國票97購01  ,0,0,0,0,0,0,0,0,0,80000,0,0,0,80000,0,80000,80000
052723,新唐統一97購01  ,0,0,0,0,0,0,0,0,0,80000,0,0,0,80000,0,80000,80000
052240,臻鼎國票96購03  ,0,0,0,0,0,0,0,0,0,80000,0,0,0,85000,5000,80000,80000
053688,燿華元大96購05  ,0,0,0,0,0,0,0,0,0,80000,0,0,0,125000,45000,80000,80000
053868,群創元大99購02  ,0,0,0,0,0,0,0,0,0,80000,0,0,0,80000,0,80000,80000
053924,京鼎國票97購01  ,0,0,0,0,0,0,0,0,0,80000,0,0,0,80000,0,80000,80000
053391,嘉聯益元大99購01,0,0,0,0,0,0,0,0,0,80000,0,0,0,104000,24000,80000,80000
05448P,臺股指元大95售25,0,0,0,0,0,0,0,0,0,80000,0,0,0,110000,30000,80000,80000
054754,昇陽半凱基98購02,0,0,0,0,0,0,0,0,0,80000,0,0,0,128000,48000,80000,80000
055106,台積電凱基98購05,0,0,0,0,0,0,0,0,0,80000,0,0,0,100000,20000,80000,80000
06490P,鴻海富邦99售02  ,0,0,0,0,0,0,0,0,0,80000,0,0,0,180000,100000,80000,80000
06427P,鴻海元大97售13  ,0,0,0,0,0,0,0,0,0,80000,0,0,0,145000,65000,80000,80000
06094P,台達電中信97售01,0,0,0,0,0,0,0,0,0,79000,0,0,0,89000,10000,79000,79000
056822,佐登永豐98購01  ,0,350000,-350000,0,0,0,0,0,0,429000,0,0,0,434000,5000,429000,79000
056550,瑞儀凱基99購01  ,0,0,0,0,0,0,0,0,0,79000,0,0,0,102000,23000,79000,79000
056900,可成元大98購02  ,0,0,0,0,0,0,0,0,0,79000,0,0,0,148000,69000,79000,79000
057002,友達國票98購01  ,0,0,0,0,0,0,0,0,0,79000,0,0,0,221000,142000,79000,79000
056206,泰鼎永豐97購01  ,0,0,0,0,0,0,0,0,0,79000,0,0,0,230000,151000,79000,79000
050335,正崴國泰96購01  ,0,0,0,0,0,0,0,0,0,79000,0,0,0,79000,0,79000,79000
044673,上銀凱基93購04  ,0,0,0,0,0,0,0,0,0,79000,0,0,0,99000,20000,79000,79000
04137P,元油反國票97售01,0,0,0,0,0,0,0,0,0,79000,0,0,0,79000,0,79000,79000
051540,力成國票95購01  ,0,0,0,0,0,0,0,0,0,79000,0,0,0,100000,21000,79000,79000
049082,晶豪科凱基94購01,0,0,0,0,0,0,0,0,0,79000,0,0,0,89000,10000,79000,79000
052134,智邦凱基95購09  ,0,0,0,0,0,0,0,0,0,79000,0,0,0,134000,55000,79000,79000
054963,牧德元大97購02  ,0,1000,-1000,0,0,0,0,0,0,80000,0,0,0,458000,378000,80000,79000
054911,敬鵬凱基97購01  ,0,0,0,0,0,0,0,0,0,79000,0,0,0,80000,1000,79000,79000
054356,可成兆豐97購01  ,0,0,0,0,0,0,0,0,0,79000,0,0,0,79000,0,79000,79000
053647,臺股指國票96購10,0,0,0,0,0,0,0,0,0,79000,0,0,0,100000,21000,79000,79000
052920,景碩台新96購02  ,0,0,0,0,0,0,0,0,0,79000,0,0,0,109000,30000,79000,79000
053296,貿聯中信98購01  ,0,0,0,0,0,0,0,0,0,79000,0,0,0,82000,3000,79000,79000
053171,中磊群益96購01  ,0,0,0,0,0,0,0,0,0,79000,0,0,0,369000,290000,79000,79000
2845,遠東銀          ,143000,64000,79000,0,0,0,0,0,0,0,0,0,0,0,0,0,79000
2642,宅配通          ,231000,152000,79000,0,0,0,0,0,0,0,0,0,0,0,0,0,79000
055624,聯發科富邦99購07,0,0,0,0,0,0,0,0,0,78000,0,0,0,98000,20000,78000,78000
057049,新日興元大98購02,0,0,0,0,0,0,0,0,0,78000,0,0,0,237000,159000,78000,78000
056628,矽創永豐98購01  ,0,0,0,0,0,0,0,0,0,78000,0,0,0,118000,40000,78000,78000
05828P,台積電統一97售02,0,0,0,0,0,0,0,0,0,78000,0,0,0,908000,830000,78000,78000
045121,康控元大93購03  ,0,0,0,0,0,0,0,0,0,78000,0,0,0,285000,207000,78000,78000
052435,滬深2X富邦96購05,0,0,0,0,0,0,0,0,0,78000,0,0,0,80000,2000,78000,78000
048992,昇陽半元大94購02,0,0,0,0,0,0,0,0,0,78000,0,0,0,140000,62000,78000,78000
050522,聯發科元大95購03,0,0,0,0,0,0,0,0,0,78000,0,0,0,265000,187000,78000,78000
052919,鈺齊富邦98購01  ,0,0,0,0,0,0,0,0,0,78000,0,0,0,208000,130000,78000,78000
053334,訊芯永豐96購01  ,0,0,0,0,0,0,0,0,0,78000,0,0,0,102000,24000,78000,78000
054411,光磊元大97購02  ,0,0,0,0,0,0,0,0,0,78000,0,0,0,101000,23000,78000,78000
055405,華泰國泰98購01  ,0,0,0,0,0,0,0,0,0,77000,0,0,0,77000,0,77000,77000
056208,崇越永豐97購01  ,0,0,0,0,0,0,0,0,0,77000,0,0,0,77000,0,77000,77000
051859,劍麟凱基96購01  ,0,0,0,0,0,0,0,0,0,77000,0,0,0,77000,0,77000,77000
049734,瑞昱群益94購02  ,0,0,0,0,0,0,0,0,0,77000,0,0,0,149000,72000,77000,77000
051401,華新科永豐95購01,0,0,0,0,0,0,0,0,0,77000,0,0,0,119000,42000,77000,77000
054738,聯發科凱基97購01,0,0,0,0,0,0,0,0,0,77000,0,0,0,77000,0,77000,77000
055052,凱美永豐97購01  ,0,0,0,0,0,0,0,0,0,77000,0,0,0,77000,0,77000,77000
053970,聯發科元大97購08,0,0,0,0,0,0,0,0,0,77000,0,0,0,77000,0,77000,77000
052809,訊芯元大97購01  ,0,0,0,0,0,0,0,0,0,77000,0,0,0,110000,33000,77000,77000
056205,貿聯永豐97購01  ,0,0,0,0,0,0,0,0,0,76000,0,0,0,76000,0,76000,76000
056230,可成凱基98購03  ,0,0,0,0,0,0,0,0,0,76000,0,0,0,100000,24000,76000,76000
05939P,聯發科凱基96售20,0,0,0,0,0,0,0,0,0,76000,0,0,0,343000,267000,76000,76000
047354,訊芯凱基94購01  ,0,0,0,0,0,0,0,0,0,76000,0,0,0,81000,5000,76000,76000
051418,智易國票97購01  ,0,0,0,0,0,0,0,0,0,76000,0,0,0,96000,20000,76000,76000
048989,矽格元大94購02  ,0,0,0,0,0,0,0,0,0,76000,0,0,0,94000,18000,76000,76000
052647,晶技永豐97購01  ,0,0,0,0,0,0,0,0,0,76000,0,0,0,76000,0,76000,76000
05316P,台積電永昌96售06,0,0,0,0,0,0,0,0,0,76000,0,0,0,76000,0,76000,76000
053642,瀚宇博永豐96購01,0,0,0,0,0,0,0,0,0,76000,0,0,0,88000,12000,76000,76000
055121,鴻海兆豐97購03  ,0,0,0,0,0,0,0,0,0,76000,0,0,0,76000,0,76000,76000
055259,玉晶光統一9A購01,0,0,0,0,0,0,0,0,0,76000,0,0,0,146000,70000,76000,76000
05731P,創意統一96售03  ,0,0,0,0,0,0,0,0,0,75000,0,0,0,285000,210000,75000,75000
05760P,京鼎永豐96售02  ,0,0,0,0,0,0,0,0,0,75000,0,0,0,75000,0,75000,75000
057062,立積國泰99購01  ,0,0,0,0,0,0,0,0,0,75000,0,0,0,210000,135000,75000,75000
057111,立積群益98購02  ,0,0,0,0,0,0,0,0,0,75000,0,0,0,174000,99000,75000,75000
057076,緯穎永豐98購01  ,0,0,0,0,0,0,0,0,0,75000,0,0,0,99000,24000,75000,75000
057141,嘉聯益兆豐99購01,0,0,0,0,0,0,0,0,0,75000,0,0,0,75000,0,75000,75000
05639P,欣興統一97售01  ,0,0,0,0,0,0,0,0,0,75000,0,0,0,85000,10000,75000,75000
055842,建準元大98購01  ,0,0,0,0,0,0,0,0,0,75000,0,0,0,127000,52000,75000,75000
046589,康控元大92購03  ,0,0,0,0,0,0,0,0,0,75000,0,0,0,75000,0,75000,75000
048116,矽創群益93購02  ,0,0,0,0,0,0,0,0,0,75000,0,0,0,75000,0,75000,75000
046680,上証反群益95購01,0,0,0,0,0,0,0,0,0,75000,0,0,0,100000,25000,75000,75000
05139P,臺股指凱基95售06,0,0,0,0,0,0,0,0,0,75000,0,0,0,484000,409000,75000,75000
049298,矽格群益95購01  ,0,0,0,0,0,0,0,0,0,75000,0,0,0,81000,6000,75000,75000
050745,茂林永豐94購06  ,0,0,0,0,0,0,0,0,0,75000,0,0,0,80000,5000,75000,75000
05359P,嘉澤元大95售02  ,0,0,0,0,0,0,0,0,0,75000,0,0,0,75000,0,75000,75000
052326,滬深反中信99購01,0,0,0,0,0,0,0,0,0,75000,0,0,0,155000,80000,75000,75000
052469,宏碁亞東95購01  ,0,0,0,0,0,0,0,0,0,75000,0,0,0,75000,0,75000,75000
055384,緯穎元大98購02  ,0,0,0,0,0,0,0,0,0,74000,0,0,0,424000,350000,74000,74000
056371,樺漢元大98購03  ,0,0,0,0,0,0,0,0,0,74000,0,0,0,100000,26000,74000,74000
047572,深中小群益95購01,0,0,0,0,0,0,0,0,0,74000,0,0,0,84000,10000,74000,74000
04363P,儒鴻元富94售01  ,0,0,0,0,0,0,0,0,0,74000,0,0,0,203000,129000,74000,74000
04915P,鴻海永昌96售02  ,0,0,0,0,0,0,0,0,0,74000,0,0,0,74000,0,74000,74000
052273,新光金群益95購02,0,0,0,0,0,0,0,0,0,74000,0,0,0,74000,0,74000,74000
053168,晶技群益98購01  ,0,0,0,0,0,0,0,0,0,74000,0,0,0,282000,208000,74000,74000
055278,旺宏元大98購05  ,0,0,0,0,0,0,0,0,0,74000,0,0,0,448000,374000,74000,74000
056004,南電永豐97購02  ,0,0,0,0,0,0,0,0,0,73000,0,0,0,73000,0,73000,73000
04687P,全新凱基94售02  ,0,0,0,0,0,0,0,0,0,73000,0,0,0,378000,305000,73000,73000
05035P,聯發科元大95售06,0,0,0,0,0,0,0,0,0,73000,0,0,0,492000,419000,73000,73000
048670,華新科永豐93購03,0,0,0,0,0,0,0,0,0,73000,0,0,0,235000,162000,73000,73000
049880,健策永豐94購02  ,0,0,0,0,0,0,0,0,0,73000,0,0,0,113000,40000,73000,73000
050996,隆達元大95購01  ,0,0,0,0,0,0,0,0,0,73000,0,0,0,95000,22000,73000,73000
050131,新光金凱基94購01,0,0,0,0,0,0,0,0,0,73000,0,0,0,86000,13000,73000,73000
054864,聯發科群益97購02,0,0,0,0,0,0,0,0,0,73000,0,0,0,93000,20000,73000,73000
054984,華泰元富97購01  ,0,0,0,0,0,0,0,0,0,73000,0,0,0,73000,0,73000,73000
054370,台積電中信9A購01,0,0,0,0,0,0,0,0,0,73000,0,0,0,126000,53000,73000,73000
05426P,聯發科凱基95售12,0,0,0,0,0,0,0,0,0,73000,0,0,0,261000,188000,73000,73000
053312,緯穎凱基96購02  ,0,0,0,0,0,0,0,0,0,73000,0,0,0,93000,20000,73000,73000
053404,致新群益96購01  ,0,0,0,0,0,0,0,0,0,73000,0,0,0,217000,144000,73000,73000
05393P,鴻海統一95售14  ,0,0,0,0,0,0,0,0,0,73000,0,0,0,96000,23000,73000,73000
053666,臺股指凱基96購29,0,0,0,0,0,0,0,0,0,73000,0,0,0,189000,116000,73000,73000
06419P,國巨統一97售09  ,0,0,0,0,0,0,0,0,0,73000,0,0,0,78000,5000,73000,73000
06290P,臺股指國票97售04,0,0,0,0,0,0,0,0,0,73000,0,0,0,75000,2000,73000,73000
056617,美律永豐98購01  ,0,0,0,0,0,0,0,0,0,72000,0,0,0,157000,85000,72000,72000
05975P,國巨日盛99售02  ,0,0,0,0,0,0,0,0,0,72000,0,0,0,92000,20000,72000,72000
048407,貿聯群益93購04  ,0,0,0,0,0,0,0,0,0,72000,0,0,0,176000,104000,72000,72000
04953P,台積電群益94售13,0,0,0,0,0,0,0,0,0,72000,0,0,0,72000,0,72000,72000
053728,茂林凱基97購01  ,0,0,0,0,0,0,0,0,0,72000,0,0,0,72000,0,72000,72000
053855,康友國泰98購01  ,0,0,0,0,0,0,0,0,0,72000,0,0,0,151000,79000,72000,72000
052830,台光電群益96購01,0,0,0,0,0,0,0,0,0,72000,0,0,0,205000,133000,72000,72000
052790,智邦兆豐97購01  ,0,0,0,0,0,0,0,0,0,72000,0,0,0,72000,0,72000,72000
057170,瑞昱元大98購01  ,0,0,0,0,0,0,0,0,0,71000,0,0,0,116000,45000,71000,71000
05694P,台積電凱基96售09,0,0,0,0,0,0,0,0,0,71000,0,0,0,101000,30000,71000,71000
055691,訊芯凱基97購02  ,0,0,0,0,0,0,0,0,0,71000,0,0,0,71000,0,71000,71000
055741,健策元富97購01  ,0,0,0,0,0,0,0,0,0,71000,0,0,0,143000,72000,71000,71000
047356,貿聯兆豐94購01  ,0,0,0,0,0,0,0,0,0,71000,0,0,0,71000,0,71000,71000
048793,超眾元大95購02  ,0,0,0,0,0,0,0,0,0,71000,0,0,0,71000,0,71000,71000
051899,欣興國泰97購01  ,0,0,0,0,0,0,0,0,0,71000,0,0,0,142000,71000,71000,71000
03757P,麗豐永豐93售01  ,0,0,0,0,0,0,0,0,0,71000,0,0,0,71000,0,71000,71000
053211,漢唐凱基96購03  ,0,0,0,0,0,0,0,0,0,71000,0,0,0,71000,0,71000,71000
053783,聯發科元大96購17,0,0,0,0,0,0,0,0,0,71000,0,0,0,114000,43000,71000,71000
05340P,臺股指國票95售08,0,0,0,0,0,0,0,0,0,71000,0,0,0,76000,5000,71000,71000
2601,益航            ,121000,50000,71000,0,0,0,0,0,0,0,0,0,0,0,0,0,71000
2495,普安            ,72000,1000,71000,0,0,0,0,0,0,0,0,0,0,0,0,0,71000
055704,亞德客永豐97購04,0,0,0,0,0,0,0,0,0,70000,0,0,0,70000,0,70000,70000
057125,國巨凱基98購12  ,0,10000,-10000,0,0,0,0,0,0,80000,0,0,0,90000,10000,80000,70000
057093,臻鼎元富98購02  ,0,0,0,0,0,0,0,0,0,70000,0,0,0,110000,40000,70000,70000
056852,矽格元富98購01  ,0,0,0,0,0,0,0,0,0,70000,0,0,0,70000,0,70000,70000
05986P,大立光統一97售03,0,0,0,0,0,0,0,0,0,70000,0,0,0,70000,0,70000,70000
05913P,國巨元大96售11  ,0,0,0,0,0,0,0,0,0,70000,0,0,0,70000,0,70000,70000
06082P,華通統一98售01  ,0,0,0,0,0,0,0,0,0,70000,0,0,0,70000,0,70000,70000
057351,奇力新統一98購02,0,0,0,0,0,0,0,0,0,70000,0,0,0,80000,10000,70000,70000
046195,聯詠凱基92購08  ,0,0,0,0,0,0,0,0,0,70000,0,0,0,70000,0,70000,70000
041978,貿聯中信93購01  ,0,0,0,0,0,0,0,0,0,70000,0,0,0,70000,0,70000,70000
045866,南茂統一94購01  ,0,0,0,0,0,0,0,0,0,70000,0,0,0,70000,0,70000,70000
043784,鴻海凱基94購01  ,0,0,0,0,0,0,0,0,0,70000,0,0,0,100000,30000,70000,70000
049236,元油2X元富96購06,0,0,0,0,0,0,0,0,0,70000,0,0,0,159000,89000,70000,70000
048821,光磊凱基95購01  ,0,0,0,0,0,0,0,0,0,70000,0,0,0,70000,0,70000,70000
047032,台虹元大93購01  ,0,0,0,0,0,0,0,0,0,70000,0,0,0,148000,78000,70000,70000
047755,麗豐元富93購01  ,0,0,0,0,0,0,0,0,0,70000,0,0,0,70000,0,70000,70000
046629,群創統一98購01  ,0,0,0,0,0,0,0,0,0,70000,0,0,0,70000,0,70000,70000
049539,元油2X群益9A購01,10000,0,10000,0,0,0,0,0,0,60000,0,0,0,105000,45000,60000,70000
049074,光罩凱基94購02  ,0,0,0,0,0,0,0,0,0,70000,0,0,0,140000,70000,70000,70000
048926,燿華永豐95購01  ,0,0,0,0,0,0,0,0,0,70000,0,0,0,100000,30000,70000,70000
049867,日月光兆豐94購01,0,0,0,0,0,0,0,0,0,70000,0,0,0,70000,0,70000,70000
049826,光磊凱基94購02  ,0,0,0,0,0,0,0,0,0,70000,0,0,0,70000,0,70000,70000
049830,智易凱基94購02  ,0,0,0,0,0,0,0,0,0,70000,0,0,0,70000,0,70000,70000
053054,禾伸堂國票97購01,0,0,0,0,0,0,0,0,0,70000,0,0,0,106000,36000,70000,70000
053422,可成永豐96購01  ,0,0,0,0,0,0,0,0,0,70000,0,0,0,138000,68000,70000,70000
053568,智伸科富邦98購01,0,0,0,0,0,0,0,0,0,70000,0,0,0,170000,100000,70000,70000
053730,樺漢凱基98購01  ,0,0,0,0,0,0,0,0,0,70000,0,0,0,120000,50000,70000,70000
053977,新日興元大96購03,0,0,0,0,0,0,0,0,0,70000,0,0,0,70000,0,70000,70000
052950,超眾國票98購01  ,0,0,0,0,0,0,0,0,0,70000,0,0,0,99000,29000,70000,70000
052757,華邦電群益96購01,0,0,0,0,0,0,0,0,0,70000,0,0,0,100000,30000,70000,70000
052848,聯發科統一96購03,0,0,0,0,0,0,0,0,0,70000,0,0,0,90000,20000,70000,70000
054070,創意國泰96購02  ,0,0,0,0,0,0,0,0,0,70000,0,0,0,70000,0,70000,70000
054129,技嘉元大96購02  ,0,0,0,0,0,0,0,0,0,70000,0,0,0,323000,253000,70000,70000
05436P,台積電群益95售07,0,0,0,0,0,0,0,0,0,70000,0,0,0,90000,20000,70000,70000
054824,同欣電元大97購04,0,0,0,0,0,0,0,0,0,70000,0,0,0,286000,216000,70000,70000
055302,達方元大97購01  ,0,0,0,0,0,0,0,0,0,70000,0,0,0,70000,0,70000,70000
6668,中揚光          ,104000,34000,70000,0,0,0,0,0,0,0,0,0,0,0,0,0,70000
06257P,臺股指群益97售10,0,0,0,0,0,0,0,0,0,70000,0,0,0,70000,0,70000,70000
2548,華固            ,71037,120000,-48963,0,0,0,0,0,0,118000,122000,0,122000,1000,5000,-4000,69037
05960P,欣興統一96售01  ,0,0,0,0,0,0,0,0,0,69000,0,0,0,69000,0,69000,69000
05653P,華邦電統一96售02,0,0,0,0,0,0,0,0,0,69000,0,0,0,162000,93000,69000,69000
048464,康控台新94購01  ,0,0,0,0,0,0,0,0,0,69000,0,0,0,69000,0,69000,69000
049261,大立光元大94購08,0,0,0,0,0,0,0,0,0,69000,0,0,0,100000,31000,69000,69000
051108,鴻海統一96購02  ,0,0,0,0,0,0,0,0,0,69000,0,0,0,137000,68000,69000,69000
055244,國巨統一98購01  ,0,0,0,0,0,0,0,0,0,69000,0,0,0,176000,107000,69000,69000
053770,元金2X元大98購01,0,0,0,0,0,0,0,0,0,69000,0,0,0,93000,24000,69000,69000
2607,榮運            ,124000,55000,69000,0,0,0,0,0,0,0,0,0,0,0,0,0,69000
5907,大洋-KY         ,115000,46000,69000,0,0,0,0,0,0,0,1000,1000,0,0,0,0,69000
06483P,聯發科凱基98售10,0,0,0,0,0,0,0,0,0,69000,0,0,0,69000,0,69000,69000
056487,康友元大98購01  ,0,0,0,0,0,0,0,0,0,68000,0,0,0,171000,103000,68000,68000
056356,台積電元大99購01,0,0,0,0,0,0,0,0,0,68000,0,0,0,105000,37000,68000,68000
056295,國巨元大97購16  ,0,0,0,0,0,0,0,0,0,68000,0,0,0,89000,21000,68000,68000
056003,智伸科永豐97購02,0,0,0,0,0,0,0,0,0,68000,0,0,0,68000,0,68000,68000
055957,瑞昱元大97購06  ,0,0,0,0,0,0,0,0,0,68000,0,0,0,68000,0,68000,68000
055627,亞德客永豐97購02,0,0,0,0,0,0,0,0,0,68000,0,0,0,68000,0,68000,68000
055754,和大兆豐97購01  ,0,0,0,0,0,0,0,0,0,68000,0,0,0,106000,38000,68000,68000
055800,欣興永豐97購02  ,0,0,0,0,0,0,0,0,0,68000,0,0,0,128000,60000,68000,68000
055351,聯發科凱基97購03,0,0,0,0,0,0,0,0,0,68000,0,0,0,84000,16000,68000,68000
055371,正崴元大97購02  ,0,0,0,0,0,0,0,0,0,68000,0,0,0,252000,184000,68000,68000
049171,台達電凱基94購03,0,0,0,0,0,0,0,0,0,68000,0,0,0,68000,0,68000,68000
051474,智邦凱基95購04  ,0,0,0,0,0,0,0,0,0,68000,0,0,0,88000,20000,68000,68000
048560,聯發科元大94購01,0,0,0,0,0,0,0,0,0,68000,0,0,0,68000,0,68000,68000
048559,京元電元大93購03,0,0,0,0,0,0,0,0,0,68000,0,0,0,68000,0,68000,68000
048446,南亞科凱基93購07,0,0,0,0,0,0,0,0,0,68000,0,0,0,160000,92000,68000,68000
048314,京元電凱基93購04,0,0,0,0,0,0,0,0,0,68000,0,0,0,68000,0,68000,68000
045640,嘉晶凱基93購01  ,0,0,0,0,0,0,0,0,0,68000,0,0,0,78000,10000,68000,68000
051186,創意永豐95購01  ,0,0,0,0,0,0,0,0,0,68000,0,0,0,68000,0,68000,68000
050176,正崴元大94購03  ,0,0,0,0,0,0,0,0,0,68000,0,0,0,87000,19000,68000,68000
050298,智伸科凱基94購02,0,0,0,0,0,0,0,0,0,68000,0,0,0,68000,0,68000,68000
050646,美律凱基96購01  ,0,0,0,0,0,0,0,0,0,68000,0,0,0,68000,0,68000,68000
050544,聯發科凱基95購02,0,0,0,0,0,0,0,0,0,68000,0,0,0,68000,0,68000,68000
049419,欣興凱基94購04  ,0,0,0,0,0,0,0,0,0,68000,0,0,0,68000,0,68000,68000
049307,上銀凱基94購03  ,0,0,0,0,0,0,0,0,0,68000,0,0,0,108000,40000,68000,68000
050430,京元電凱基94購03,0,0,0,0,0,0,0,0,0,68000,0,0,0,68000,0,68000,68000
049071,台達電凱基94購02,0,0,0,0,0,0,0,0,0,68000,0,0,0,68000,0,68000,68000
050027,義隆元大94購03  ,0,0,0,0,0,0,0,0,0,68000,0,0,0,68000,0,68000,68000
050007,貿聯永豐94購01  ,0,0,0,0,0,0,0,0,0,68000,0,0,0,68000,0,68000,68000
050812,台積電凱基95購01,0,0,0,0,0,0,0,0,0,68000,0,0,0,68000,0,68000,68000
051356,全新元大96購04  ,0,0,0,0,0,0,0,0,0,68000,0,0,0,68000,0,68000,68000
05134P,鴻海凱基96售06  ,0,0,0,0,0,0,0,0,0,68000,0,0,0,74000,6000,68000,68000
049645,台積電凱基94購22,0,0,0,0,0,0,0,0,0,68000,0,0,0,68000,0,68000,68000
053775,鴻海元大96購21  ,0,0,0,0,0,0,0,0,0,68000,0,0,0,68000,0,68000,68000
053737,華新科麥證96購01,0,0,0,78000,10000,68000,0,0,0,68000,0,0,0,78000,10000,68000,68000
053864,義隆元大96購01  ,0,0,0,0,0,0,0,0,0,68000,0,0,0,68000,0,68000,68000
053524,聯電中信97購02  ,0,0,0,0,0,0,0,0,0,68000,0,0,0,70000,2000,68000,68000
053405,台達電兆豐96購01,0,0,0,0,0,0,0,0,0,68000,0,0,0,68000,0,68000,68000
052805,晶技元大97購01  ,0,0,0,0,0,0,0,0,0,68000,0,0,0,339000,271000,68000,68000
055118,嘉聯益凱基98購02,0,0,0,0,0,0,0,0,0,68000,0,0,0,68000,0,68000,68000
054899,南港康和97購01  ,0,0,0,0,0,0,0,0,0,68000,0,0,0,68000,0,68000,68000
054023,和大康和96購01  ,0,0,0,0,0,0,0,0,0,68000,0,0,0,118000,50000,68000,68000
06415P,台積電群益97售07,0,0,0,0,0,0,0,0,0,68000,0,0,0,78000,10000,68000,68000
06240P,奇力新元富97售03,0,0,0,0,0,0,0,0,0,68000,0,0,0,68000,0,68000,68000
1444,力麗            ,160000,90000,70000,0,0,0,0,0,0,-2000,0,2000,-2000,0,0,0,68000
8081,致新            ,217000,141000,76000,0,0,0,0,0,0,-8000,1000,0,1000,1000,10000,-9000,68000
055832,台達電元大97購02,0,0,0,0,0,0,0,0,0,67000,0,0,0,70000,3000,67000,67000
055958,台光電元大97購02,0,0,0,0,0,0,0,0,0,67000,0,0,0,81000,14000,67000,67000
056510,正文永豐98購02  ,0,0,0,0,0,0,0,0,0,67000,0,0,0,68000,1000,67000,67000
056451,可成凱基99購01  ,0,0,0,0,0,0,0,0,0,67000,0,0,0,145000,78000,67000,67000
056811,健策統一9B購01  ,0,0,0,0,0,0,0,0,0,67000,0,0,0,67000,0,67000,67000
056714,晶相光永豐98購02,0,0,0,0,0,0,0,0,0,67000,0,0,0,120000,53000,67000,67000
051875,聯發科兆豐95購04,0,0,0,0,0,0,0,0,0,67000,0,0,0,67000,0,67000,67000
050063,聯發科凱基94購09,0,0,0,0,0,0,0,0,0,67000,0,0,0,87000,20000,67000,67000
050072,京鼎凱基94購02  ,0,0,0,0,0,0,0,0,0,67000,0,0,0,75000,8000,67000,67000
054007,貿聯統一96購01  ,0,0,0,0,0,0,0,0,0,67000,0,0,0,67000,0,67000,67000
05411P,台積電國票96售08,0,0,0,0,0,0,0,0,0,67000,0,0,0,67000,0,67000,67000
052898,樺漢群益96購01  ,0,0,0,0,0,0,0,0,0,67000,0,0,0,174000,107000,67000,67000
8112,至上            ,249000,203000,46000,0,0,0,0,0,0,21000,21000,0,21000,0,0,0,67000
1808,潤隆            ,86000,19000,67000,0,0,0,0,0,0,0,0,0,0,0,0,0,67000
6155,鈞寶            ,147000,80000,67000,0,0,0,0,0,0,0,0,0,0,0,0,0,67000
3698,隆達            ,122000,59000,63000,0,0,0,0,0,0,4000,15000,10000,5000,0,1000,-1000,67000
057160,佐登永豐98購02  ,0,350000,-350000,0,0,0,0,0,0,416000,0,0,0,416000,0,416000,66000
056951,牧德統一99購01  ,0,0,0,0,0,0,0,0,0,66000,0,0,0,66000,0,66000,66000
055712,金寶元大97購02  ,0,0,0,0,0,0,0,0,0,66000,0,0,0,267000,201000,66000,66000
048782,亞泥元大94購01  ,0,0,0,0,0,0,0,0,0,66000,0,0,0,75000,9000,66000,66000
048668,奇力新永豐93購04,0,0,0,0,0,0,0,0,0,66000,0,0,0,66000,0,66000,66000
046652,上銀元大93購02  ,0,0,0,0,0,0,0,0,0,66000,0,0,0,70000,4000,66000,66000
048429,旺宏國票94購02  ,0,0,0,0,0,0,0,0,0,66000,0,0,0,213000,147000,66000,66000
047550,聯發科凱基93購13,0,0,0,0,0,0,0,0,0,66000,0,0,0,68000,2000,66000,66000
044784,華邦電中信96購01,0,0,0,0,0,0,0,0,0,66000,0,0,0,101000,35000,66000,66000
049617,光罩群益94購03  ,0,0,0,0,0,0,0,0,0,66000,0,0,0,199000,133000,66000,66000
053034,上海銀兆豐96購01,0,0,0,0,0,0,0,0,0,66000,0,0,0,66000,0,66000,66000
054057,晶豪科國票97購01,0,0,0,0,0,0,0,0,0,66000,0,0,0,66000,0,66000,66000
054739,義隆凱基98購02  ,0,0,0,0,0,0,0,0,0,66000,0,0,0,110000,44000,66000,66000
2429,銘旺科          ,75000,9000,66000,0,0,0,0,0,0,0,0,0,0,0,0,0,66000
06407P,創意元富97售02  ,0,0,0,0,0,0,0,0,0,66000,0,0,0,100000,34000,66000,66000
9802,鈺齊-KY         ,735000,325498,409502,0,0,0,0,249000,-249000,-95000,0,86000,-86000,8000,17000,-9000,65502
055623,貿聯國泰99購01  ,0,0,0,0,0,0,0,0,0,65000,0,0,0,70000,5000,65000,65000
055541,聚陽凱基98購01  ,0,0,0,0,0,0,0,0,0,65000,0,0,0,138000,73000,65000,65000
056284,台積電永豐97購06,0,0,0,0,0,0,0,0,0,65000,0,0,0,75000,10000,65000,65000
056883,美食康和98購01  ,0,0,0,0,0,0,0,0,0,65000,0,0,0,65000,0,65000,65000
056989,鴻海兆豐98購02  ,0,0,0,0,0,0,0,0,0,65000,0,0,0,65000,0,65000,65000
056806,元油2X統一98購02,0,0,0,0,0,0,0,0,0,65000,0,0,0,75000,10000,65000,65000
044518,京鼎凱基92購01  ,0,0,0,0,0,0,0,0,0,65000,0,0,0,65000,0,65000,65000
045910,華通國票92購01  ,0,0,0,0,0,0,0,0,0,65000,0,0,0,65000,0,65000,65000
048026,瑞昱凱基94購01  ,0,0,0,0,0,0,0,0,0,65000,0,0,0,87000,22000,65000,65000
050337,南電國泰95購01  ,0,0,0,0,0,0,0,0,0,65000,0,0,0,70000,5000,65000,65000
051360,緯創元大95購03  ,0,0,0,0,0,0,0,0,0,65000,0,0,0,80000,15000,65000,65000
050036,矽格元大94購03  ,0,0,0,0,0,0,0,0,0,65000,0,0,0,83000,18000,65000,65000
050254,大立光富邦96購02,0,0,0,0,0,0,0,0,0,65000,0,0,0,155000,90000,65000,65000
054168,貿聯凱基97購02  ,0,0,0,0,0,0,0,0,0,65000,0,0,0,213000,148000,65000,65000
054273,宏達電中信98購01,0,0,0,0,0,0,0,0,0,65000,0,0,0,66000,1000,65000,65000
054194,國巨麥證96購02  ,0,0,0,81000,2000,79000,0,0,0,65000,0,0,0,83000,18000,65000,65000
054541,康控國票98購01  ,0,0,0,0,0,0,0,0,0,65000,0,0,0,120000,55000,65000,65000
053196,康控元富96購01  ,0,0,0,0,0,0,0,0,0,65000,0,0,0,194000,129000,65000,65000
053717,聯發科凱基96購17,0,0,0,0,0,0,0,0,0,65000,0,0,0,953000,888000,65000,65000
06369P,台積電凱基97售16,0,0,0,0,0,0,0,0,0,65000,0,0,0,65000,0,65000,65000
056623,禾伸堂永豐98購01,0,0,0,0,0,0,0,0,0,64000,0,0,0,126000,62000,64000,64000
05742P,可成元大96售04  ,0,0,0,0,0,0,0,0,0,64000,0,0,0,307000,243000,64000,64000
051856,亞德客凱基95購01,0,0,0,0,0,0,0,0,0,64000,0,0,0,374000,310000,64000,64000
048611,宏達電凱基93購04,0,0,0,0,0,0,0,0,0,64000,0,0,0,64000,0,64000,64000
047000,和大統一93購01  ,0,0,0,0,0,0,0,0,0,64000,0,0,0,64000,0,64000,64000
047365,隆達群益93購01  ,0,0,0,0,0,0,0,0,0,64000,0,0,0,64000,0,64000,64000
03861P,群創元富99售01  ,0,0,0,0,0,0,0,0,0,64000,0,0,0,64000,0,64000,64000
00753L,中信中國50正2   ,0,0,0,0,0,0,0,0,0,64000,0,0,0,158000,94000,64000,64000
050301,矽創凱基94購03  ,0,0,0,0,0,0,0,0,0,64000,0,0,0,124000,60000,64000,64000
051077,台郡國泰96購02  ,0,0,0,0,0,0,0,0,0,64000,0,0,0,93000,29000,64000,64000
049914,瑞昱元大94購06  ,0,0,0,0,0,0,0,0,0,64000,0,0,0,69000,5000,64000,64000
053788,泰鼎元大97購01  ,0,0,0,0,0,0,0,0,0,64000,0,0,0,145000,81000,64000,64000
053979,健策元大98購01  ,0,0,0,0,0,0,0,0,0,64000,0,0,0,135000,71000,64000,64000
054717,亞德客永豐97購01,0,0,0,0,0,0,0,0,0,64000,0,0,0,470000,406000,64000,64000
057140,宏達電兆豐98購01,0,0,0,0,0,0,0,0,0,63000,0,0,0,79000,16000,63000,63000
057137,鈺齊凱基98購01  ,0,0,0,0,0,0,0,0,0,63000,0,0,0,230000,167000,63000,63000
056381,台虹元富98購01  ,0,0,0,0,0,0,0,0,0,63000,0,0,0,91000,28000,63000,63000
055424,聚陽群益98購01  ,0,0,0,0,0,0,0,0,0,63000,0,0,0,63000,0,63000,63000
03026X,元展23          ,0,0,0,0,0,0,0,0,0,63000,0,0,0,83000,20000,63000,63000
036805,國巨元富93購02  ,0,0,0,0,0,0,0,0,0,63000,0,0,0,63000,0,63000,63000
042927,道瓊反中信94購01,0,0,0,0,0,0,0,0,0,63000,0,0,0,93000,30000,63000,63000
048404,大立光群益93購11,0,0,0,0,0,0,0,0,0,63000,0,0,0,63000,0,63000,63000
050395,大立光元富94購10,0,0,0,0,0,0,0,0,0,63000,0,0,0,63000,0,63000,63000
049700,瀚宇博元大97購01,0,0,0,0,0,0,0,0,0,63000,0,0,0,63000,0,63000,63000
050974,大成鋼統一95購01,0,0,0,0,0,0,0,0,0,63000,0,0,0,78000,15000,63000,63000
050313,大立光兆豐94購05,0,0,0,0,0,0,0,0,0,63000,0,0,0,70000,7000,63000,63000
049509,台達電凱基94購07,0,0,0,0,0,0,0,0,0,63000,0,0,0,119000,56000,63000,63000
055133,致新康和97購01  ,0,0,0,0,0,0,0,0,0,63000,0,0,0,132000,69000,63000,63000
054259,健策元大97購03  ,0,0,0,0,0,0,0,0,0,63000,0,0,0,171000,108000,63000,63000
053400,緯穎中信9A購01  ,0,0,0,0,0,0,0,0,0,63000,0,0,0,83000,20000,63000,63000
053507,百和兆豐96購01  ,0,0,0,0,0,0,0,0,0,63000,0,0,0,63000,0,63000,63000
053176,矽力群益96購02  ,0,0,0,0,0,0,0,0,0,63000,0,0,0,90000,27000,63000,63000
2316,楠梓電          ,429000,365000,64000,0,0,0,0,0,0,-1000,2000,25000,-23000,102000,80000,22000,63000
4739,康普            ,74000,11000,63000,0,0,0,0,0,0,0,0,0,0,0,0,0,63000
055554,聯發科凱基97購06,0,0,0,0,0,0,0,0,0,62000,0,0,0,148000,86000,62000,62000
055592,奇力新元大97購07,0,0,0,0,0,0,0,0,0,62000,0,0,0,260000,198000,62000,62000
055483,和大元大97購03  ,0,0,0,0,0,0,0,0,0,62000,0,0,0,62000,0,62000,62000
055970,聯茂元大97購04  ,0,0,0,0,0,0,0,0,0,62000,0,0,0,62000,0,62000,62000
056023,晶豪科群益97購01,0,0,0,0,0,0,0,0,0,62000,0,0,0,83000,21000,62000,62000
049024,玉晶光群益97購01,0,0,0,0,0,0,0,0,0,62000,0,0,0,72000,10000,62000,62000
051339,智易永豐95購02  ,0,0,0,0,0,0,0,0,0,62000,0,0,0,62000,0,62000,62000
6552,易華電          ,133000,58000,75000,0,0,0,0,0,0,-13000,1000,0,1000,0,14000,-14000,62000
2547,日勝生          ,85000,23000,62000,0,0,0,0,0,0,0,0,0,0,0,0,0,62000
057124,為升凱基98購02  ,0,0,0,0,0,0,0,0,0,61000,0,0,0,61000,0,61000,61000
056854,友達中信9A購01  ,0,0,0,0,0,0,0,0,0,61000,0,0,0,576000,515000,61000,61000
056787,健鼎群益98購01  ,0,0,0,0,0,0,0,0,0,61000,0,0,0,119000,58000,61000,61000
05784P,臺股指元大96售18,0,0,0,0,0,0,0,0,0,61000,0,0,0,61000,0,61000,61000
048711,台郡台新94購01  ,0,0,0,0,0,0,0,0,0,61000,0,0,0,66000,5000,61000,61000
048563,明泰元大94購01  ,0,0,0,0,0,0,0,0,0,61000,0,0,0,61000,0,61000,61000
04629P,康控元大94售05  ,0,0,0,0,0,0,0,0,0,61000,0,0,0,62000,1000,61000,61000
052334,大成鋼日盛95購01,0,0,0,0,0,0,0,0,0,61000,0,0,0,71000,10000,61000,61000
051291,聯詠統一95購01  ,0,0,0,0,0,0,0,0,0,61000,0,0,0,61000,0,61000,61000
051774,聯茂中信96購01  ,0,0,0,0,0,0,0,0,0,61000,0,0,0,165000,104000,61000,61000
052819,義隆永豐96購01  ,0,0,0,0,0,0,0,0,0,61000,0,0,0,61000,0,61000,61000
052241,台郡國票96購01  ,0,0,0,0,0,0,0,0,0,61000,0,0,0,61000,0,61000,61000
053534,微星永豐96購02  ,0,0,0,0,0,0,0,0,0,61000,0,0,0,188000,127000,61000,61000
054380,世芯群益97購02  ,0,0,0,0,0,0,0,0,0,61000,0,0,0,108000,47000,61000,61000
054820,新日興元大97購01,0,0,0,0,0,0,0,0,0,61000,0,0,0,137000,76000,61000,61000
054901,群光康和97購01  ,0,0,0,0,0,0,0,0,0,61000,0,0,0,81000,20000,61000,61000
6285,啟碁            ,166000,98000,68000,0,0,0,0,0,0,-7000,5000,0,5000,2000,14000,-12000,61000
06414P,矽力凱基97售03  ,0,0,0,0,0,0,0,0,0,61000,0,0,0,70000,9000,61000,61000
05789P,臺股指永昌96售06,0,0,0,0,0,0,0,0,0,60000,0,0,0,60000,0,60000,60000
06114P,台積電統一97售03,0,0,0,0,0,0,0,0,0,60000,0,0,0,60000,0,60000,60000
056849,瀚宇博元富98購01,0,0,0,0,0,0,0,0,0,60000,0,0,0,60000,0,60000,60000
057045,美律元大99購04  ,0,0,0,0,0,0,0,0,0,60000,0,0,0,70000,10000,60000,60000
05595P,友達統一96售02  ,0,0,0,0,0,0,0,0,0,60000,0,0,0,60000,0,60000,60000
056442,瑞昱凱基98購02  ,0,0,0,0,0,0,0,0,0,60000,0,0,0,227000,167000,60000,60000
055761,創意群益97購01  ,0,0,0,0,0,0,0,0,0,60000,0,0,0,61000,1000,60000,60000
055814,晶豪科國票97購02,0,0,0,0,0,0,0,0,0,60000,0,0,0,107000,47000,60000,60000
046231,創意元大92購07  ,0,0,0,0,0,0,0,0,0,60000,0,0,0,60000,0,60000,60000
00866,新光Shiller CAPE,0,0,0,0,0,0,0,0,0,60000,0,0,0,87000,27000,60000,60000
04490P,聯發科台新94售02,0,0,0,0,0,0,0,0,0,60000,0,0,0,62000,2000,60000,60000
044750,鴻海凱基93購07  ,0,0,0,0,0,0,0,0,0,60000,0,0,0,68000,8000,60000,60000
04526P,美律凱基94售03  ,0,0,0,0,0,0,0,0,0,60000,0,0,0,60000,0,60000,60000
046512,和鑫元大92購01  ,0,0,0,0,0,0,0,0,0,60000,0,0,0,60000,0,60000,60000
047058,聯茂國票94購01  ,0,0,0,0,0,0,0,0,0,60000,0,0,0,60000,0,60000,60000
049224,致新國票95購01  ,0,0,0,0,0,0,0,0,0,60000,0,0,0,60000,0,60000,60000
05185P,鴻海中信95售04  ,0,0,0,0,0,0,0,0,0,60000,0,0,0,60000,0,60000,60000
051872,矽力凱基96購01  ,0,0,0,0,0,0,0,0,0,60000,0,0,0,110000,50000,60000,60000
047549,聯發科凱基93購12,0,0,0,0,0,0,0,0,0,60000,0,0,0,100000,40000,60000,60000
04742P,瑞昱統一94售01  ,0,0,0,0,0,0,0,0,0,60000,0,0,0,60000,0,60000,60000
046623,臻鼎凱基93購02  ,0,0,0,0,0,0,0,0,0,60000,0,0,0,110000,50000,60000,60000
046695,瑞昱凱基93購03  ,0,0,0,0,0,0,0,0,0,60000,0,0,0,60000,0,60000,60000
051306,嘉聯益凱基96購01,0,0,0,0,0,0,0,0,0,60000,0,0,0,60000,0,60000,60000
05113P,臺股指元富95售01,0,0,0,0,0,0,0,0,0,60000,0,0,0,60000,0,60000,60000
049497,茂林元大94購04  ,0,0,0,0,0,0,0,0,0,60000,0,0,0,60000,0,60000,60000
049448,光磊統一94購01  ,0,0,0,0,0,0,0,0,0,60000,0,0,0,60000,0,60000,60000
051686,宏達電凱基95購04,0,0,0,0,0,0,0,0,0,60000,0,0,0,60000,0,60000,60000
050494,可成永昌96購01  ,0,0,0,0,0,0,0,0,0,60000,0,0,0,224000,164000,60000,60000
051953,矽力元富95購03  ,0,0,0,0,0,0,0,0,0,60000,0,0,0,174000,114000,60000,60000
051926,聯電中信97購01  ,0,0,0,0,0,0,0,0,0,60000,0,0,0,100000,40000,60000,60000
05259P,臺股指凱基96售12,0,0,0,0,0,0,0,0,0,60000,0,0,0,60000,0,60000,60000
051070,正崴國票96購01  ,0,0,0,0,0,0,0,0,0,60000,0,0,0,60000,0,60000,60000
051379,新光金群益95購01,0,0,0,0,0,0,0,0,0,60000,0,0,0,60000,0,60000,60000
050822,亞光凱基95購01  ,0,0,0,0,0,0,0,0,0,60000,0,0,0,95000,35000,60000,60000
049561,道瓊銀統一96購01,0,0,0,0,0,0,0,0,0,60000,0,0,0,60000,0,60000,60000
05095P,景碩元大95售01  ,0,0,0,0,0,0,0,0,0,60000,0,0,0,60000,0,60000,60000
055011,元翎元富97購01  ,0,0,0,0,0,0,0,0,0,60000,0,0,0,70000,10000,60000,60000
054737,京元電凱基99購01,0,0,0,0,0,0,0,0,0,60000,0,0,0,89000,29000,60000,60000
054772,康控國票98購02  ,0,0,0,0,0,0,0,0,0,60000,0,0,0,60000,0,60000,60000
055140,晶相光永豐97購01,0,0,0,0,0,0,0,0,0,60000,0,0,0,60000,0,60000,60000
055172,凱美統一97購02  ,0,0,0,0,0,0,0,0,0,60000,0,0,0,138000,78000,60000,60000
055161,貿聯元大98購03  ,0,0,0,0,0,0,0,0,0,60000,0,0,0,208000,148000,60000,60000
055283,聯發科元大97購16,0,0,0,0,0,0,0,0,0,60000,0,0,0,255000,195000,60000,60000
054437,欣興台新97購02  ,0,0,0,0,0,0,0,0,0,60000,0,0,0,86000,26000,60000,60000
05465P,台表科永豐95售03,0,0,0,0,0,0,0,0,0,60000,0,0,0,60000,0,60000,60000
054199,大立光永昌96購07,0,0,0,0,0,0,0,0,0,60000,0,0,0,60000,0,60000,60000
054063,聯茂國票97購02  ,0,0,0,0,0,0,0,0,0,60000,0,0,0,64000,4000,60000,60000
054015,晶豪科永豐96購03,0,0,0,0,0,0,0,0,0,60000,0,0,0,70000,10000,60000,60000
053441,旺宏凱基98購01  ,0,0,0,0,0,0,0,0,0,60000,0,0,0,300000,240000,60000,60000
052229,奇力新凱基96購01,0,0,0,0,0,0,0,0,0,60000,0,0,0,70000,10000,60000,60000
052734,台表科國泰98購02,0,0,0,0,0,0,0,0,0,60000,0,0,0,72000,12000,60000,60000
052820,宏達電永豐96購01,0,0,0,0,0,0,0,0,0,60000,0,0,0,60000,0,60000,60000
06507P,台表科國票99售01,0,0,0,0,0,0,0,0,0,60000,0,0,0,60000,0,60000,60000
06285P,台積電國票98售04,0,0,0,0,0,0,0,0,0,60000,0,0,0,160000,100000,60000,60000
2331,精英            ,70000,15000,55000,0,0,0,0,0,0,5000,5000,0,5000,0,0,0,60000
055835,華邦電元大97購03,0,0,0,0,0,0,0,0,0,59000,0,0,0,69000,10000,59000,59000
055568,緯穎凱基97購02  ,0,0,0,0,0,0,0,0,0,59000,0,0,0,88000,29000,59000,59000
057171,台光電元大9B購01,0,0,0,0,0,0,0,0,0,59000,0,0,0,170000,111000,59000,59000
047353,台郡凱基93購03  ,0,0,0,0,0,0,0,0,0,59000,0,0,0,59000,0,59000,59000
046504,聯發科元大92購19,0,0,0,0,0,0,0,0,0,59000,0,0,0,59000,0,59000,59000
045447,鴻海國泰94購02  ,0,0,0,0,0,0,0,0,0,59000,0,0,0,62000,3000,59000,59000
044426,欣興國泰93購02  ,0,0,0,0,0,0,0,0,0,59000,0,0,0,62000,3000,59000,59000
04898P,瑞儀中信95售01  ,0,0,0,0,0,0,0,0,0,59000,0,0,0,100000,41000,59000,59000
050472,和大永豐94購01  ,0,0,0,0,0,0,0,0,0,59000,0,0,0,59000,0,59000,59000
051563,泰鼎國泰96購01  ,0,0,0,0,0,0,0,0,0,59000,0,0,0,59000,0,59000,59000
053746,彰銀康和96購01  ,0,0,0,0,0,0,0,0,0,59000,0,0,0,59000,0,59000,59000
054427,潤泰全富邦97購01,0,0,0,0,0,0,0,0,0,59000,0,0,0,299000,240000,59000,59000
055109,正崴凱基98購01  ,0,0,0,0,0,0,0,0,0,59000,0,0,0,59000,0,59000,59000
055070,聯茂永豐97購01  ,0,0,0,0,0,0,0,0,0,59000,0,0,0,59000,0,59000,59000
6698,旭暉應材        ,15000,20000,-5000,0,0,0,67000,0,67000,-3000,0,3000,-3000,0,0,0,59000
4961,天鈺            ,93000,33000,60000,0,0,0,0,0,0,-1000,0,0,0,0,1000,-1000,59000
3535,晶彩科          ,110000,51000,59000,0,0,0,0,0,0,0,0,0,0,0,0,0,59000
2912,統一超          ,218000,147354,70646,0,0,0,0,0,0,-12000,0,12000,-12000,0,0,0,58646
056549,嘉聯益凱基98購04,0,0,0,0,0,0,0,0,0,58000,0,0,0,99000,41000,58000,58000
055795,茂林國泰98購01  ,0,0,0,0,0,0,0,0,0,58000,0,0,0,139000,81000,58000,58000
056337,聯發科凱基98購06,0,0,0,0,0,0,0,0,0,58000,0,0,0,70000,12000,58000,58000
050390,聯發科統一94購09,0,0,0,0,0,0,0,0,0,58000,0,0,0,116000,58000,58000,58000
050452,智原元大95購04  ,0,0,0,0,0,0,0,0,0,58000,0,0,0,58000,0,58000,58000
050421,鴻海凱基95購04  ,0,0,0,0,0,0,0,0,0,58000,0,0,0,218000,160000,58000,58000
054664,台表科元大97購04,0,0,0,0,0,0,0,0,0,58000,0,0,0,68000,10000,58000,58000
054180,亞泥康和96購01  ,0,0,0,0,0,0,0,0,0,58000,0,0,0,58000,0,58000,58000
053989,奇力新兆豐97購01,0,0,0,0,0,0,0,0,0,58000,0,0,0,88000,30000,58000,58000
052309,健策國泰97購01  ,0,0,0,0,0,0,0,0,0,58000,0,0,0,68000,10000,58000,58000
05224P,華通統一95售03  ,0,0,0,0,0,0,0,0,0,58000,0,0,0,68000,10000,58000,58000
06328P,台積電中信01售02,0,0,0,0,0,0,0,0,0,58000,0,0,0,60000,2000,58000,58000
06499P,臺股指元大9A售04,0,0,0,0,0,0,0,0,0,58000,0,0,0,95000,37000,58000,58000
056353,鴻海元大99購02  ,0,0,0,0,0,0,0,0,0,57000,0,0,0,123000,66000,57000,57000
056298,億光元大97購02  ,0,0,0,0,0,0,0,0,0,57000,0,0,0,130000,73000,57000,57000
05575P,玉晶光元富96售01,0,0,0,0,0,0,0,0,0,57000,0,0,0,82000,25000,57000,57000
056567,瀚宇博群益98購02,0,0,0,0,0,0,0,0,0,57000,0,0,0,67000,10000,57000,57000
056780,元油2X群益9A購03,0,0,0,0,0,0,0,0,0,57000,0,0,0,60000,3000,57000,57000
046700,台郡凱基93購02  ,0,0,0,0,0,0,0,0,0,57000,0,0,0,57000,0,57000,57000
03180P,台灣50元大01售39,0,0,0,0,0,0,0,0,0,57000,0,0,0,66000,9000,57000,57000
051592,健策元大96購05  ,0,0,0,0,0,0,0,0,0,57000,0,0,0,171000,114000,57000,57000
051042,中磊永豐95購01  ,0,0,0,0,0,0,0,0,0,57000,0,0,0,151000,94000,57000,57000
05225P,鴻海統一95售09  ,0,0,0,0,0,0,0,0,0,57000,0,0,0,57000,0,57000,57000
052695,台表科中信98購01,0,0,0,0,0,0,0,0,0,57000,0,0,0,60000,3000,57000,57000
053957,瑞昱永豐96購01  ,0,0,0,0,0,0,0,0,0,57000,0,0,0,62000,5000,57000,57000
06386P,欣興永豐97售03  ,0,0,0,0,0,0,0,0,0,57000,0,0,0,125000,68000,57000,57000
06185P,台表科元大97售05,0,0,0,0,0,0,0,0,0,57000,0,0,0,78000,21000,57000,57000
1711,永光            ,102000,45000,57000,0,0,0,0,0,0,0,0,0,0,0,0,0,57000
2453,凌群            ,78000,21000,57000,0,0,0,0,0,0,0,0,0,0,0,0,0,57000
057149,京鼎國票99購02  ,0,0,0,0,0,0,0,0,0,56000,0,0,0,65000,9000,56000,56000
055606,矽創元大97購01  ,0,0,0,0,0,0,0,0,0,56000,0,0,0,131000,75000,56000,56000
055501,創意元大97購01  ,0,0,0,0,0,0,0,0,0,56000,0,0,0,188000,132000,56000,56000
055432,臻鼎群益97購02  ,0,0,0,0,0,0,0,0,0,56000,0,0,0,79000,23000,56000,56000
055962,晶豪科元大97購02,0,0,0,0,0,0,0,0,0,56000,0,0,0,56000,0,56000,56000
04828P,聯發科凱基94售15,0,0,0,0,0,0,0,0,0,56000,0,0,0,56000,0,56000,56000
051844,宏達電富邦96購01,0,0,0,0,0,0,0,0,0,56000,0,0,0,56000,0,56000,56000
048823,漢唐凱基94購01  ,0,0,0,0,0,0,0,0,0,56000,0,0,0,124000,68000,56000,56000
048753,智伸科元富94購01,0,0,0,0,0,0,0,0,0,56000,0,0,0,56000,0,56000,56000
048882,智原統一96購01  ,0,0,0,0,0,0,0,0,0,56000,0,0,0,56000,0,56000,56000
051638,聯茂國票96購01  ,0,0,0,0,0,0,0,0,0,56000,0,0,0,56000,0,56000,56000
053425,京鼎永豐96購01  ,0,0,0,0,0,0,0,0,0,56000,0,0,0,118000,62000,56000,56000
053082,聯電元大98購03  ,0,0,0,0,0,0,0,0,0,56000,0,0,0,78000,22000,56000,56000
054244,華新元大96購01  ,0,0,0,0,0,0,0,0,0,56000,0,0,0,56000,0,56000,56000
054101,茂林國票97購04  ,0,0,0,0,0,0,0,0,0,56000,0,0,0,100000,44000,56000,56000
054576,健策元大98購03  ,0,0,0,0,0,0,0,0,0,56000,0,0,0,109000,53000,56000,56000
054351,華新科國泰97購03,0,0,0,0,0,0,0,0,0,56000,0,0,0,56000,0,56000,56000
054456,華泰群益99購01  ,0,0,0,0,0,0,0,0,0,56000,0,0,0,56000,0,56000,56000
055061,聯詠永豐97購01  ,0,0,0,0,0,0,0,0,0,56000,0,0,0,56000,0,56000,56000
2395,研華            ,353000,298000,55000,0,0,0,0,0,0,1000,1000,0,1000,0,0,0,56000
5388,中磊            ,155000,101000,54000,0,0,0,0,0,0,2000,1000,0,1000,17000,16000,1000,56000
06209P,旺宏統一97售07  ,0,0,0,0,0,0,0,0,0,56000,0,0,0,72000,16000,56000,56000
056481,創意元大98購01  ,0,0,0,0,0,0,0,0,0,55000,0,0,0,65000,10000,55000,55000
055442,矽創國票98購02  ,0,0,0,0,0,0,0,0,0,55000,0,0,0,55000,0,55000,55000
055829,上銀元大97購06  ,0,0,0,0,0,0,0,0,0,55000,0,0,0,242000,187000,55000,55000
056921,京元電兆豐98購01,0,0,0,0,0,0,0,0,0,55000,0,0,0,60000,5000,55000,55000
056593,台積電元富98購02,0,0,0,0,0,0,0,0,0,55000,0,0,0,545000,490000,55000,55000
048699,嘉晶國票95購01  ,0,0,0,0,0,0,0,0,0,55000,0,0,0,195000,140000,55000,55000
046670,彩晶元大93購02  ,0,0,0,0,0,0,0,0,0,55000,0,0,0,55000,0,55000,55000
050277,上銀亞東94購01  ,0,0,0,0,0,0,0,0,0,55000,0,0,0,55000,0,55000,55000
050742,新日興永豐94購01,0,0,0,0,0,0,0,0,0,55000,0,0,0,200000,145000,55000,55000
050763,楠梓電元大94購03,0,0,0,0,0,0,0,0,0,55000,0,0,0,55000,0,55000,55000
048973,禾伸堂元大94購01,0,0,0,0,0,0,0,0,0,55000,0,0,0,56000,1000,55000,55000
052142,滬深2X群益99購04,0,0,0,0,0,0,0,0,0,55000,0,0,0,55000,0,55000,55000
052429,禾伸堂永豐95購02,0,0,0,0,0,0,0,0,0,55000,0,0,0,85000,30000,55000,55000
052501,茂林永豐95購04  ,0,0,0,0,0,0,0,0,0,55000,0,0,0,60000,5000,55000,55000
055078,亞泥中信98購01  ,0,0,0,0,0,0,0,0,0,55000,0,0,0,60000,5000,55000,55000
055112,晶豪科凱基98購01,0,0,0,0,0,0,0,0,0,55000,0,0,0,56000,1000,55000,55000
054753,復盛凱基98購01  ,0,0,0,0,0,0,0,0,0,55000,0,0,0,70000,15000,55000,55000
054439,健策台新96購03  ,0,0,0,0,0,0,0,0,0,55000,0,0,0,56000,1000,55000,55000
052816,上銀永豐96購01  ,0,0,0,0,0,0,0,0,0,55000,0,0,0,86000,31000,55000,55000
053941,國巨國泰96購05  ,0,0,0,0,0,0,0,0,0,55000,0,0,0,56000,1000,55000,55000
06310P,精元元富97售02  ,0,0,0,0,0,0,0,0,0,55000,0,0,0,55000,0,55000,55000
06540P,聯發科凱基98售13,0,0,0,0,0,0,0,0,0,55000,0,0,0,55000,0,55000,55000
3703,欣陸            ,73000,18000,55000,0,0,0,0,0,0,0,0,0,0,0,0,0,55000
2723,美食-KY         ,137000,75000,62000,0,0,0,0,0,0,-7000,0,0,0,0,7000,-7000,55000
05687P,臺股指元大96售12,0,0,0,0,0,0,0,0,0,54000,0,0,0,104000,50000,54000,54000
05948P,茂林元大96售03  ,0,0,0,0,0,0,0,0,0,54000,0,0,0,166000,112000,54000,54000
055669,緯穎群益97購02  ,0,0,0,0,0,0,0,0,0,54000,0,0,0,300000,246000,54000,54000
055581,和大元大97購04  ,0,0,0,0,0,0,0,0,0,54000,0,0,0,54000,0,54000,54000
049210,昇陽半群益94購02,0,0,0,0,0,0,0,0,0,54000,0,0,0,74000,20000,54000,54000
051468,智邦日盛95購01  ,0,0,0,0,0,0,0,0,0,54000,0,0,0,64000,10000,54000,54000
04241P,欣興國泰95售02  ,0,0,0,0,0,0,0,0,0,54000,0,0,0,59000,5000,54000,54000
044972,元金2X國票96購01,0,0,0,0,0,0,0,0,0,54000,0,0,0,54000,0,54000,54000
052527,泰鼎元大96購02  ,0,0,0,0,0,0,0,0,0,54000,0,0,0,116000,62000,54000,54000
052354,健策群益96購02  ,0,0,0,0,0,0,0,0,0,54000,0,0,0,83000,29000,54000,54000
05213P,台積電國票96售05,0,0,0,0,0,0,0,0,0,54000,0,0,0,54000,0,54000,54000
049614,聯茂中信94購01  ,0,0,0,0,0,0,0,0,0,54000,0,0,0,64000,10000,54000,54000
050949,亞光群益96購01  ,0,0,0,0,0,0,0,0,0,54000,0,0,0,92000,38000,54000,54000
050186,京鼎元大94購01  ,0,0,0,0,0,0,0,0,0,54000,0,0,0,54000,0,54000,54000
053395,致茂中信96購01  ,0,0,0,0,0,0,0,0,0,54000,0,0,0,100000,46000,54000,54000
052285,康控凱基95購02  ,0,0,0,0,0,0,0,0,0,54000,0,0,0,54000,0,54000,54000
054718,可成永豐97購01  ,0,0,0,0,0,0,0,0,0,54000,0,0,0,151000,97000,54000,54000
05479P,華新科台新96售01,0,0,0,0,0,0,0,0,0,54000,0,0,0,80000,26000,54000,54000
6202,盛群            ,90000,37000,53000,0,0,0,0,0,0,1000,1000,0,1000,0,0,0,54000
055615,宏達電國票99購02,0,0,0,0,0,0,0,0,0,53000,0,0,0,63000,10000,53000,53000
056405,聯茂群益98購01  ,0,0,0,0,0,0,0,0,0,53000,0,0,0,156000,103000,53000,53000
05978P,麗豐永豐96售02  ,0,0,0,0,0,0,0,0,0,53000,0,0,0,56000,3000,53000,53000
048557,瑞昱元大94購01  ,0,0,0,0,0,0,0,0,0,53000,0,0,0,60000,7000,53000,53000
00665L,富邦恒生國企正2 ,38000,0,38000,0,0,0,0,0,0,15000,0,0,0,35000,20000,15000,53000
048431,瑞昱國票94購01  ,0,0,0,0,0,0,0,0,0,53000,0,0,0,53000,0,53000,53000
050184,信邦元大94購01  ,0,0,0,0,0,0,0,0,0,53000,0,0,0,53000,0,53000,53000
050240,聯發科凱基94購13,0,0,0,0,0,0,0,0,0,53000,0,0,0,190000,137000,53000,53000
05120P,聯發科國泰97售01,0,0,0,0,0,0,0,0,0,53000,0,0,0,76000,23000,53000,53000
051225,台積電群益95購02,0,0,0,0,0,0,0,0,0,53000,0,0,0,798000,745000,53000,53000
052181,南茂元大95購05  ,0,0,0,0,0,0,0,0,0,53000,0,0,0,58000,5000,53000,53000
054912,群光凱基97購01  ,0,0,0,0,0,0,0,0,0,53000,0,0,0,53000,0,53000,53000
055254,聯詠統一97購03  ,0,0,0,0,0,0,0,0,0,53000,0,0,0,53000,0,53000,53000
054266,緯穎元大96購07  ,0,0,0,0,0,0,0,0,0,53000,0,0,0,283000,230000,53000,53000
052218,大立光日盛95購01,0,0,0,0,0,0,0,0,0,53000,0,0,0,53000,0,53000,53000
053499,禾伸堂兆豐96購01,0,0,0,0,0,0,0,0,0,53000,0,0,0,79000,26000,53000,53000
5876,上海商銀        ,470000,361162,108838,0,0,0,1000,0,1000,-57000,0,0,0,10000,67000,-57000,52838
056461,樺漢凱基98購02  ,0,0,0,0,0,0,0,0,0,52000,0,0,0,52000,0,52000,52000
05621P,聯電中信96售01  ,0,0,0,0,0,0,0,0,0,52000,0,0,0,122000,70000,52000,52000
048418,瑞昱統一93購04  ,0,0,0,0,0,0,0,0,0,52000,0,0,0,52000,0,52000,52000
051114,鈺齊中信95購01  ,0,0,0,0,0,0,0,0,0,52000,0,0,0,152000,100000,52000,52000
050152,聯發科群益94購07,0,0,0,0,0,0,0,0,0,52000,0,0,0,52000,0,52000,52000
049498,茂林元大95購01  ,0,0,0,0,0,0,0,0,0,52000,0,0,0,188000,136000,52000,52000
049492,聯發科元大95購02,0,0,0,0,0,0,0,0,0,52000,0,0,0,197000,145000,52000,52000
049522,華通兆豐94購02  ,0,0,0,0,0,0,0,0,0,52000,0,0,0,194000,142000,52000,52000
050495,大立光永昌96購01,0,0,0,0,0,0,0,0,0,52000,0,0,0,173000,121000,52000,52000
051918,聯茂元大95購01  ,0,0,0,0,0,0,0,0,0,52000,0,0,0,108000,56000,52000,52000
053973,晶豪科元大96購01,0,0,0,0,0,0,0,0,0,52000,0,0,0,52000,0,52000,52000
053764,A50正2富邦99購01,0,0,0,0,0,0,0,0,0,52000,0,0,0,52000,0,52000,52000
054649,聯茂群益97購01  ,0,0,0,0,0,0,0,0,0,52000,0,0,0,63000,11000,52000,52000
055215,智邦凱基98購02  ,0,0,0,0,0,0,0,0,0,52000,0,0,0,160000,108000,52000,52000
054902,億光康和97購01  ,0,0,0,0,0,0,0,0,0,52000,0,0,0,52000,0,52000,52000
6139,亞翔            ,239000,205000,34000,0,0,0,0,0,0,18000,1000,0,1000,27000,10000,17000,52000
06358P,力成中信97售02  ,0,0,0,0,0,0,0,0,0,52000,0,0,0,69000,17000,52000,52000
056255,華新科元富97購05,0,0,0,0,0,0,0,0,0,51000,0,0,0,112000,61000,51000,51000
06096P,全新永豐97售02  ,0,0,0,0,0,0,0,0,0,51000,0,0,0,91000,40000,51000,51000
05782P,聯詠元富96售02  ,0,0,0,0,0,0,0,0,0,51000,0,0,0,51000,0,51000,51000
048394,正崴國票94購01  ,0,0,0,0,0,0,0,0,0,51000,0,0,0,51000,0,51000,51000
047569,世紀鋼國票94購02,0,0,0,0,0,0,0,0,0,51000,0,0,0,51000,0,51000,51000
046942,友達元大99購01  ,0,0,0,0,0,0,0,0,0,51000,0,0,0,51000,0,51000,51000
039908,元油反富邦92購01,0,0,0,0,0,0,0,0,0,51000,0,0,0,51000,0,51000,51000
047939,亞德客國票93購02,0,0,0,0,0,0,0,0,0,51000,0,0,0,59000,8000,51000,51000
051529,東元國票96購01  ,0,0,0,0,0,0,0,0,0,51000,0,0,0,74000,23000,51000,51000
049359,台達電元大94購06,0,0,0,0,0,0,0,0,0,51000,0,0,0,54000,3000,51000,51000
051311,瑞昱麥證95購01  ,0,0,0,291000,240000,51000,0,0,0,51000,0,0,0,291000,240000,51000,51000
051085,鴻海元大95購03  ,0,0,0,0,0,0,0,0,0,51000,0,0,0,623000,572000,51000,51000
048985,茂林元大94購01  ,0,0,0,0,0,0,0,0,0,51000,0,0,0,183000,132000,51000,51000
048829,欣興凱基94購02  ,0,0,0,0,0,0,0,0,0,51000,0,0,0,104000,53000,51000,51000
054435,華新科台新97購02,0,0,0,0,0,0,0,0,0,51000,0,0,0,51000,0,51000,51000
052253,康控永豐95購04  ,0,0,0,0,0,0,0,0,0,51000,0,0,0,174000,123000,51000,51000
052862,正崴凱基96購01  ,0,0,0,0,0,0,0,0,0,51000,0,0,0,51000,0,51000,51000
053172,瑞儀群益97購01  ,0,0,0,0,0,0,0,0,0,51000,0,0,0,452000,401000,51000,51000
2480,敦陽科          ,57000,6000,51000,0,0,0,0,0,0,0,0,0,0,0,0,0,51000
057264,新光金兆豐98購01,0,0,0,0,0,0,0,0,0,50000,0,0,0,70000,20000,50000,50000
05995P,T50正2中信9C售01,0,0,0,0,0,0,0,0,0,50000,0,0,0,67000,17000,50000,50000
057007,奇力新中信98購04,0,0,0,0,0,0,0,0,0,50000,0,0,0,212000,162000,50000,50000
056580,泰鼎元大9A購01  ,0,0,0,0,0,0,0,0,0,50000,0,0,0,1481000,1431000,50000,50000
05680P,聯發科元大96售12,0,0,0,0,0,0,0,0,0,50000,0,0,0,67000,17000,50000,50000
056351,鴻海元大98購06  ,0,0,0,0,0,0,0,0,0,50000,0,0,0,101000,51000,50000,50000
056471,台光電元大99購01,0,0,0,0,0,0,0,0,0,50000,0,0,0,68000,18000,50000,50000
056216,智原第一97購01  ,0,0,0,0,0,0,0,0,0,50000,0,0,0,50000,0,50000,50000
056060,宏達電元大99購01,0,0,0,0,0,0,0,0,0,50000,0,0,0,50000,0,50000,50000
055562,欣興凱基97購06  ,0,0,0,0,0,0,0,0,0,50000,0,0,0,60000,10000,50000,50000
055326,緯穎國票97購06  ,0,0,0,0,0,0,0,0,0,50000,0,0,0,52000,2000,50000,50000
055709,深中小元大97購03,0,0,0,0,0,0,0,0,0,50000,0,0,0,300000,250000,50000,50000
05582P,群創凱基98售06  ,0,0,0,0,0,0,0,0,0,50000,0,0,0,50000,0,50000,50000
055849,聯詠元大97購05  ,0,0,0,0,0,0,0,0,0,50000,0,0,0,51000,1000,50000,50000
047971,南亞科富邦95購01,0,0,0,0,0,0,0,0,0,50000,0,0,0,50000,0,50000,50000
047911,晶技麥證94購01  ,0,0,0,70000,49000,21000,0,0,0,50000,0,0,0,99000,49000,50000,50000
046320,明泰元大92購02  ,0,0,0,0,0,0,0,0,0,50000,0,0,0,50000,0,50000,50000
04653P,臺股指凱基94售12,0,0,0,0,0,0,0,0,0,50000,0,0,0,50000,0,50000,50000
045172,欣興兆豐94購01  ,0,0,0,0,0,0,0,0,0,50000,0,0,0,50000,0,50000,50000
045084,欣興元大93購02  ,0,0,0,0,0,0,0,0,0,50000,0,0,0,52000,2000,50000,50000
044610,A50正2兆豐93購01,0,0,0,0,0,0,0,0,0,50000,0,0,0,50000,0,50000,50000
04589P,祥碩永豐94售01  ,0,0,0,0,0,0,0,0,0,50000,0,0,0,50000,0,50000,50000
045760,鴻海統一93購02  ,0,0,0,0,0,0,0,0,0,50000,0,0,0,50000,0,50000,50000
045829,滬深2X群益95購02,0,0,0,0,0,0,0,0,0,50000,0,0,0,50000,0,50000,50000
03921P,亞光凱基94售01  ,0,0,0,0,0,0,0,0,0,50000,0,0,0,50000,0,50000,50000
03826P,瀚宇博元大95售01,0,0,0,0,0,0,0,0,0,50000,0,0,0,50000,0,50000,50000
046191,新光金凱基98購01,0,0,0,0,0,0,0,0,0,50000,0,0,0,50000,0,50000,50000
046268,嘉晶凱基93購02  ,0,0,0,0,0,0,0,0,0,50000,0,0,0,50000,0,50000,50000
045568,上証2X元大95購01,0,0,0,0,0,0,0,0,0,50000,0,0,0,50000,0,50000,50000
04104P,臺股指國票93售11,0,0,0,0,0,0,0,0,0,50000,0,0,0,118000,68000,50000,50000
03332P,台積電元大02售17,0,0,0,0,0,0,0,0,0,50000,0,0,0,50000,0,50000,50000
03417P,瑞昱群益04售01  ,0,0,0,0,0,0,0,0,0,50000,0,0,0,50000,0,50000,50000
042792,T50反1台新9C購01,0,0,0,0,0,0,0,0,0,50000,0,0,0,50000,0,50000,50000
04265P,滬深2X元富93售04,0,0,0,0,0,0,0,0,0,50000,0,0,0,50000,0,50000,50000
047013,超眾元富96購01  ,0,0,0,0,0,0,0,0,0,50000,0,0,0,70000,20000,50000,50000
04732P,聯茂群益94售01  ,0,0,0,0,0,0,0,0,0,50000,0,0,0,108000,58000,50000,50000
048679,大成鋼富邦93購01,0,0,0,0,0,0,0,0,0,50000,0,0,0,50000,0,50000,50000
04867P,美律統一94售03  ,0,0,0,0,0,0,0,0,0,50000,0,0,0,50000,0,50000,50000
051902,T50反1元大97購01,0,0,0,0,0,0,0,0,0,50000,0,0,0,50000,0,50000,50000
049243,佳世達元富96購02,0,0,0,0,0,0,0,0,0,50000,0,0,0,50000,0,50000,50000
050398,上証2X中信97購01,0,0,0,0,0,0,0,0,0,50000,0,0,0,50000,0,50000,50000
04756P,大立光元富94售08,0,0,0,0,0,0,0,0,0,50000,0,0,0,83000,33000,50000,50000
047582,滬深2X永豐95購02,0,0,0,0,0,0,0,0,0,50000,0,0,0,50000,0,50000,50000
048516,麗豐凱基93購02  ,0,0,0,0,0,0,0,0,0,50000,0,0,0,50000,0,50000,50000
047359,台達電群益93購01,0,0,0,0,0,0,0,0,0,50000,0,0,0,50000,0,50000,50000
046602,新日興群益94購01,0,0,0,0,0,0,0,0,0,50000,0,0,0,168000,118000,50000,50000
046667,晶技元大93購01  ,0,0,0,0,0,0,0,0,0,50000,0,0,0,100000,50000,50000,50000
048019,GIS麥證94購01   ,0,0,0,73000,20000,53000,0,0,0,50000,0,0,0,73000,23000,50000,50000
04688P,大立光凱基94售09,0,0,0,0,0,0,0,0,0,50000,0,0,0,50000,0,50000,50000
046767,南茂凱基93購03  ,0,0,0,0,0,0,0,0,0,50000,0,0,0,60000,10000,50000,50000
050968,超眾永豐95購01  ,0,0,0,0,0,0,0,0,0,50000,0,0,0,50000,0,50000,50000
04998P,京元電永豐95售01,0,0,0,0,0,0,0,0,0,50000,0,0,0,90000,40000,50000,50000
049800,瑞昱元大94購05  ,0,0,0,0,0,0,0,0,0,50000,0,0,0,50000,0,50000,50000
049069,元油2X凱基95購04,0,0,0,0,0,0,0,0,0,50000,0,0,0,50000,0,50000,50000
049064,T50反1凱基96購03,0,0,0,0,0,0,0,0,0,50000,0,0,0,50000,0,50000,50000
049915,瑞昱元大94購07  ,0,0,0,0,0,0,0,0,0,50000,0,0,0,50000,0,50000,50000
049872,聯發科台新94購03,0,0,0,0,0,0,0,0,0,50000,0,0,0,52000,2000,50000,50000
052492,易華電國票96購02,0,0,0,0,0,0,0,0,0,50000,0,0,0,50000,0,50000,50000
051242,台積電元大96購06,0,0,0,0,0,0,0,0,0,50000,0,0,0,210000,160000,50000,50000
051187,晶相光永豐95購01,0,0,0,0,0,0,0,0,0,50000,0,0,0,80000,30000,50000,50000
05111P,台積電統一95售04,0,0,0,0,0,0,0,0,0,50000,0,0,0,66000,16000,50000,50000
049466,創意台新94購01  ,0,0,0,0,0,0,0,0,0,50000,0,0,0,50000,0,50000,50000
050676,道瓊銀統一96購02,0,0,0,0,0,0,0,0,0,50000,0,0,0,50000,0,50000,50000
049357,微星富邦94購01  ,0,0,0,0,0,0,0,0,0,50000,0,0,0,60000,10000,50000,50000
050497,臺指反凱基96購02,0,0,0,0,0,0,0,0,0,50000,0,0,0,50000,0,50000,50000
051588,聯詠元大95購03  ,0,0,0,0,0,0,0,0,0,50000,0,0,0,50000,0,50000,50000
050508,上証2X元大97購01,0,0,0,0,0,0,0,0,0,50000,0,0,0,50000,0,50000,50000
050513,亞泥元大94購02  ,0,0,0,0,0,0,0,0,0,50000,0,0,0,95000,45000,50000,50000
050062,聯發科凱基94購08,0,0,0,0,0,0,0,0,0,50000,0,0,0,54000,4000,50000,50000
050127,台積電凱基94購31,0,0,0,0,0,0,0,0,0,50000,0,0,0,50000,0,50000,50000
049717,微星凱基94購01  ,0,0,0,0,0,0,0,0,0,50000,0,0,0,111000,61000,50000,50000
05209P,鴻海凱基96售09  ,0,0,0,0,0,0,0,0,0,50000,0,0,0,50000,0,50000,50000
05205P,緯穎元大95售03  ,0,0,0,0,0,0,0,0,0,50000,0,0,0,50000,0,50000,50000
053225,昇陽半凱基96購01,0,0,0,0,0,0,0,0,0,50000,0,0,0,50000,0,50000,50000
052765,新日興群益97購01,0,0,0,0,0,0,0,0,0,50000,0,0,0,50000,0,50000,50000
053715,美律凱基96購04  ,0,0,0,0,0,0,0,0,0,50000,0,0,0,50000,0,50000,50000
053528,南電中信9A購01  ,0,0,0,0,0,0,0,0,0,50000,0,0,0,100000,50000,50000,50000
053576,智原元富96購01  ,0,0,0,0,0,0,0,0,0,50000,0,0,0,50000,0,50000,50000
054510,S&P反1元大98購01,0,0,0,0,0,0,0,0,0,50000,0,0,0,50000,0,50000,50000
054375,貿聯中信99購01  ,0,0,0,0,0,0,0,0,0,50000,0,0,0,50000,0,50000,50000
054389,為升元富96購02  ,0,0,0,0,0,0,0,0,0,50000,0,0,0,95000,45000,50000,50000
05458P,台積電凱基97售02,0,0,0,0,0,0,0,0,0,50000,0,0,0,50000,0,50000,50000
054302,鴻海凱基96購18  ,0,0,0,0,0,0,0,0,0,50000,0,0,0,118000,68000,50000,50000
054042,華泰元大96購01  ,0,0,0,0,0,0,0,0,0,50000,0,0,0,118000,68000,50000,50000
054974,台表科元大98購02,0,0,0,0,0,0,0,0,0,50000,0,0,0,50000,0,50000,50000
054949,奇力新元大98購01,0,0,0,0,0,0,0,0,0,50000,0,0,0,50000,0,50000,50000
055187,彩晶統一98購01  ,0,0,0,0,0,0,0,0,0,50000,0,0,0,130000,80000,50000,50000
055033,漢唐富邦98購01  ,0,0,0,0,0,0,0,0,0,50000,0,0,0,50000,0,50000,50000
06315P,臺股指元富97售02,0,0,0,0,0,0,0,0,0,50000,0,0,0,50000,0,50000,50000
06557P,台積電兆豐98售02,0,0,0,0,0,0,0,0,0,50000,0,0,0,50000,0,50000,50000
06488P,台積電元富98售05,0,0,0,0,0,0,0,0,0,50000,0,0,0,220000,170000,50000,50000
06619P,聯發科元大98售06,0,0,0,0,0,0,0,0,0,50000,0,0,0,50000,0,50000,50000
08966P,臺指反元大04售07,0,0,0,0,0,0,0,0,0,50000,0,0,0,50000,0,50000,50000
05570P,聯發科統一96售04,0,0,0,0,0,0,0,0,0,49000,0,0,0,82000,33000,49000,49000
055588,瑞昱元大97購03  ,0,0,0,0,0,0,0,0,0,49000,0,0,0,74000,25000,49000,49000
056127,致新國票98購02  ,0,0,0,0,0,0,0,0,0,49000,0,0,0,49000,0,49000,49000
056433,鴻海凱基98購09  ,0,0,0,0,0,0,0,0,0,49000,0,0,0,55000,6000,49000,49000
056774,和鑫元大98購01  ,0,0,0,0,0,0,0,0,0,49000,0,0,0,50000,1000,49000,49000
057218,可成群益99購03  ,0,0,0,0,0,0,0,0,0,49000,0,0,0,172000,123000,49000,49000
05808P,臺股指國票96售01,0,0,0,0,0,0,0,0,0,49000,0,0,0,52000,3000,49000,49000
048376,台達電元富93購01,0,0,0,0,0,0,0,0,0,49000,0,0,0,49000,0,49000,49000
048158,大立光兆豐95購01,0,0,0,0,0,0,0,0,0,49000,0,0,0,50000,1000,49000,49000
05144P,美律永豐95售02  ,0,0,0,0,0,0,0,0,0,49000,0,0,0,49000,0,49000,49000
047118,欣興元大93購06  ,0,0,0,0,0,0,0,0,0,49000,0,0,0,51000,2000,49000,49000
04186P,創意元富93售04  ,0,0,0,0,0,0,0,0,0,49000,0,0,0,49000,0,49000,49000
045586,創意元大93購03  ,0,0,0,0,0,0,0,0,0,49000,0,0,0,49000,0,49000,49000
051991,泰碩元大95購02  ,0,0,0,0,0,0,0,0,0,49000,0,0,0,49000,0,49000,49000
05072P,聯電元富95售02  ,0,0,0,0,0,0,0,0,0,49000,0,0,0,50000,1000,49000,49000
050699,京鼎凱基96購01  ,0,0,0,0,0,0,0,0,0,49000,0,0,0,366000,317000,49000,49000
055075,南電永豐97購01  ,0,0,0,0,0,0,0,0,0,49000,0,0,0,89000,40000,49000,49000
054260,貿聯元大96購03  ,0,0,0,0,0,0,0,0,0,49000,0,0,0,64000,15000,49000,49000
2836,高雄銀          ,69000,20000,49000,0,0,0,0,0,0,0,0,0,0,0,0,0,49000
05775P,台積電國泰98售02,0,0,0,0,0,0,0,0,0,48000,0,0,0,48000,0,48000,48000
057284,新日興元大98購03,0,0,0,0,0,0,0,0,0,48000,0,0,0,108000,60000,48000,48000
056684,旺宏統一98購02  ,0,0,0,0,0,0,0,0,0,48000,0,0,0,48000,0,48000,48000
056682,鴻海統一98購10  ,0,0,0,0,0,0,0,0,0,48000,0,0,0,48000,0,48000,48000
05629P,聯發科永昌99售02,0,0,0,0,0,0,0,0,0,48000,0,0,0,148000,100000,48000,48000
056185,全新統一98購01  ,0,0,0,0,0,0,0,0,0,48000,0,0,0,48000,0,48000,48000
056049,奇力新國票98購01,0,0,0,0,0,0,0,0,0,48000,0,0,0,53000,5000,48000,48000
042909,順德元大94購01  ,0,0,0,0,0,0,0,0,0,48000,0,0,0,48000,0,48000,48000
03126P,旭富凱基01售04  ,0,0,0,0,0,0,0,0,0,48000,0,0,0,50000,2000,48000,48000
045103,上海銀亞東94購01,0,0,0,0,0,0,0,0,0,48000,0,0,0,48000,0,48000,48000
047893,嘉聯益兆豐94購01,0,0,0,0,0,0,0,0,0,48000,0,0,0,50000,2000,48000,48000
047319,晶技元大93購02  ,0,0,0,0,0,0,0,0,0,48000,0,0,0,68000,20000,48000,48000
048565,康控元大94購04  ,0,0,0,0,0,0,0,0,0,48000,0,0,0,63000,15000,48000,48000
048725,京元電日盛94購01,0,0,0,0,0,0,0,0,0,48000,0,0,0,48000,0,48000,48000
048709,瑞昱亞東94購01  ,0,0,0,0,0,0,0,0,0,48000,0,0,0,48000,0,48000,48000
048060,台達電統一93購01,0,0,0,0,0,0,0,0,0,48000,0,0,0,48000,0,48000,48000
046863,康友元大93購01  ,0,0,0,0,0,0,0,0,0,48000,0,0,0,58000,10000,48000,48000
051284,上銀統一95購02  ,0,0,0,0,0,0,0,0,0,48000,0,0,0,48000,0,48000,48000
051924,聯茂日盛95購01  ,0,0,0,0,0,0,0,0,0,48000,0,0,0,296000,248000,48000,48000
051998,昇陽半元大96購02,0,0,0,0,0,0,0,0,0,48000,0,0,0,126000,78000,48000,48000
051551,新日興永豐95購01,0,0,0,0,0,0,0,0,0,48000,0,0,0,145000,97000,48000,48000
052402,健策凱基97購01  ,0,0,0,0,0,0,0,0,0,48000,0,0,0,475000,427000,48000,48000
052534,貿聯國泰96購02  ,0,0,0,0,0,0,0,0,0,48000,0,0,0,78000,30000,48000,48000
052502,瀚宇博永豐95購02,0,0,0,0,0,0,0,0,0,48000,0,0,0,48000,0,48000,48000
052625,南電亞東97購01  ,0,0,0,0,0,0,0,0,0,48000,0,0,0,48000,0,48000,48000
049115,創意統一94購03  ,0,0,0,0,0,0,0,0,0,48000,0,0,0,48000,0,48000,48000
049529,華新科中信95購01,0,0,0,0,0,0,0,0,0,48000,0,0,0,308000,260000,48000,48000
050854,世紀鋼國票97購01,0,0,0,0,0,0,0,0,0,48000,0,0,0,88000,40000,48000,48000
054699,復盛永豐97購01  ,0,0,0,0,0,0,0,0,0,48000,0,0,0,154000,106000,48000,48000
054773,台郡國票98購01  ,0,0,0,0,0,0,0,0,0,48000,0,0,0,48000,0,48000,48000
054750,聯茂凱基98購02  ,0,0,0,0,0,0,0,0,0,48000,0,0,0,52000,4000,48000,48000
053570,京元電統一96購01,0,0,0,0,0,0,0,0,0,48000,0,0,0,48000,0,48000,48000
053501,明泰兆豐96購01  ,0,0,0,0,0,0,0,0,0,48000,0,0,0,48000,0,48000,48000
053873,力成元大96購03  ,0,0,0,0,0,0,0,0,0,48000,0,0,0,50000,2000,48000,48000
052774,京元電亞東96購01,0,0,0,0,0,0,0,0,0,48000,0,0,0,48000,0,48000,48000
06300P,緯穎元大97售04  ,0,0,0,0,0,0,0,0,0,48000,0,0,0,78000,30000,48000,48000
05648P,康控國票97售01  ,0,0,0,0,0,0,0,0,0,47000,0,0,0,70000,23000,47000,47000
056499,鴻海富邦98購02  ,0,0,0,0,0,0,0,0,0,47000,0,0,0,98000,51000,47000,47000
055460,華擎永豐97購01  ,0,0,0,0,0,0,0,0,0,47000,0,0,0,127000,80000,47000,47000
055361,樺漢凱基97購01  ,0,0,0,0,0,0,0,0,0,47000,0,0,0,47000,0,47000,47000
047591,訊芯永豐93購02  ,0,0,0,0,0,0,0,0,0,47000,0,0,0,53000,6000,47000,47000
051877,嘉聯益國票97購02,0,0,0,0,0,0,0,0,0,47000,0,0,0,47000,0,47000,47000
048745,儒鴻元富97購02  ,0,0,0,0,0,0,0,0,0,47000,0,0,0,61000,14000,47000,47000
03454P,台積電凱基03售14,0,0,0,0,0,0,0,0,0,47000,0,0,0,50000,3000,47000,47000
048974,日電貿元大94購01,0,0,0,0,0,0,0,0,0,47000,0,0,0,173000,126000,47000,47000
05321P,鴻海凱基95售17  ,0,0,0,0,0,0,0,0,0,47000,0,0,0,49000,2000,47000,47000
053129,緯穎凱基96購01  ,0,0,0,0,0,0,0,0,0,47000,0,0,0,93000,46000,47000,47000
1718,中纖            ,221000,174000,47000,0,0,0,0,0,0,0,0,0,0,0,0,0,47000
1440,南紡            ,116000,69000,47000,0,0,0,0,0,0,0,0,0,0,0,0,0,47000
055307,瑞昱群益97購02  ,0,0,0,0,0,0,0,0,0,46000,0,0,0,79000,33000,46000,46000
055447,華新科統一97購04,0,0,0,0,0,0,0,0,0,46000,0,0,0,224000,178000,46000,46000
056186,智原統一97購01  ,0,0,0,0,0,0,0,0,0,46000,0,0,0,56000,10000,46000,46000
06041P,全新永豐96售03  ,0,0,0,0,0,0,0,0,0,46000,0,0,0,59000,13000,46000,46000
047925,可成凱基94購01  ,0,0,0,0,0,0,0,0,0,46000,0,0,0,82000,36000,46000,46000
048672,日電貿永豐93購02,0,0,0,0,0,0,0,0,0,46000,0,0,0,46000,0,46000,46000
047288,台郡統一93購01  ,0,0,0,0,0,0,0,0,0,46000,0,0,0,46000,0,46000,46000
048105,滬深2X群益99購02,0,0,0,0,0,0,0,0,0,46000,0,0,0,97000,51000,46000,46000
049158,元油2X中信94購03,0,0,0,0,0,0,0,0,0,46000,0,0,0,50000,4000,46000,46000
05249P,臻鼎國票95售01  ,0,0,0,0,0,0,0,0,0,46000,0,0,0,102000,56000,46000,46000
050246,大立光凱基94購13,0,0,0,0,0,0,0,0,0,46000,0,0,0,46000,0,46000,46000
052961,國巨凱基97購02  ,0,0,0,0,0,0,0,0,0,46000,0,0,0,80000,34000,46000,46000
052741,聯發科元大96購08,0,0,0,0,0,0,0,0,0,46000,0,0,0,133000,87000,46000,46000
054828,正崴國泰99購01  ,0,0,0,0,0,0,0,0,0,46000,0,0,0,46000,0,46000,46000
055063,玉晶光永豐99購01,0,0,0,0,0,0,0,0,0,46000,0,0,0,49000,3000,46000,46000
054638,國泰金中信99購01,0,0,0,0,0,0,0,0,0,46000,0,0,0,46000,0,46000,46000
2461,光群雷          ,75000,29000,46000,0,0,0,0,0,0,0,0,0,0,0,0,0,46000
2231,為升            ,82000,21602,60398,0,0,0,0,0,0,-15000,0,12000,-12000,1000,4000,-3000,45398
05837P,臺股指富邦96售04,0,0,0,0,0,0,0,0,0,45000,0,0,0,60000,15000,45000,45000
05878P,創意群益98售01  ,0,0,0,0,0,0,0,0,0,45000,0,0,0,45000,0,45000,45000
05651P,大立光元大97售02,0,0,0,0,0,0,0,0,0,45000,0,0,0,68000,23000,45000,45000
055668,欣興群益97購01  ,0,0,0,0,0,0,0,0,0,45000,0,0,0,105000,60000,45000,45000
055854,群創元大98購04  ,0,0,0,0,0,0,0,0,0,45000,0,0,0,56000,11000,45000,45000
048210,鴻海日盛93購01  ,0,0,0,0,0,0,0,0,0,45000,0,0,0,46000,1000,45000,45000
047719,聯茂凱基94購01  ,0,0,0,0,0,0,0,0,0,45000,0,0,0,45000,0,45000,45000
048811,鴻海日盛94購01  ,0,0,0,0,0,0,0,0,0,45000,0,0,0,45000,0,45000,45000
044346,力山富邦95購01  ,0,0,0,0,0,0,0,0,0,45000,0,0,0,95000,50000,45000,45000
03564P,為升群益02售02  ,0,0,0,0,0,0,0,0,0,45000,0,0,0,105000,60000,45000,45000
051097,嘉聯益元大96購02,0,0,0,0,0,0,0,0,0,45000,0,0,0,325000,280000,45000,45000
05202P,鴻海元大95售16  ,0,0,0,0,0,0,0,0,0,45000,0,0,0,50000,5000,45000,45000
050573,光寶科國票94購01,0,0,0,0,0,0,0,0,0,45000,0,0,0,45000,0,45000,45000
052441,亞泥元大95購01  ,0,0,0,0,0,0,0,0,0,45000,0,0,0,70000,25000,45000,45000
048972,晶豪科元大94購01,0,0,0,0,0,0,0,0,0,45000,0,0,0,45000,0,45000,45000
048843,台郡凱基94購01  ,0,0,0,0,0,0,0,0,0,45000,0,0,0,45000,0,45000,45000
049983,智原凱基94購02  ,0,0,0,0,0,0,0,0,0,45000,0,0,0,45000,0,45000,45000
048836,牧德凱基94購03  ,0,0,0,0,0,0,0,0,0,45000,0,0,0,55000,10000,45000,45000
054420,緯穎元大96購08  ,0,0,0,0,0,0,0,0,0,45000,0,0,0,300000,255000,45000,45000
054115,台塑康和96購01  ,0,0,0,0,0,0,0,0,0,45000,0,0,0,45000,0,45000,45000
055090,國巨群益97購03  ,0,0,0,0,0,0,0,0,0,45000,0,0,0,102000,57000,45000,45000
055274,華泰元大97購02  ,0,0,0,0,0,0,0,0,0,45000,0,0,0,55000,10000,45000,45000
05391P,鴻海統一95售12  ,0,0,0,0,0,0,0,0,0,45000,0,0,0,45000,0,45000,45000
053371,滬深2X元大99購01,0,0,0,0,0,0,0,0,0,45000,0,0,0,49000,4000,45000,45000
2614,東森            ,490000,445000,45000,0,0,0,0,0,0,0,0,0,0,0,0,0,45000
06297P,美律元大97售01  ,0,0,0,0,0,0,0,0,0,45000,0,0,0,50000,5000,45000,45000
06289P,臺股指國票97售03,0,0,0,0,0,0,0,0,0,45000,0,0,0,45000,0,45000,45000
06255P,臺股指群益97售08,0,0,0,0,0,0,0,0,0,45000,0,0,0,80000,35000,45000,45000
055468,智邦凱基97購04  ,0,0,0,0,0,0,0,0,0,44000,0,0,0,121000,77000,44000,44000
055469,台光電凱基97購01,0,0,0,0,0,0,0,0,0,44000,0,0,0,66000,22000,44000,44000
056269,新日興統一98購01,0,0,0,0,0,0,0,0,0,44000,0,0,0,80000,36000,44000,44000
046072,台勝科凱基92購03,0,0,0,0,0,0,0,0,0,44000,0,0,0,44000,0,44000,44000
00650L,FH香港正2       ,0,0,0,0,0,0,0,0,0,44000,0,0,0,166000,122000,44000,44000
048346,智易元大95購01  ,0,0,0,0,0,0,0,0,0,44000,0,0,0,54000,10000,44000,44000
050432,聯發科凱基94購19,0,0,0,0,0,0,0,0,0,44000,0,0,0,61000,17000,44000,44000
049325,智邦元富94購02  ,0,0,0,0,0,0,0,0,0,44000,0,0,0,243000,199000,44000,44000
053990,晶技兆豐96購01  ,0,0,0,0,0,0,0,0,0,44000,0,0,0,302000,258000,44000,44000
054991,南亞科元富97購01,0,0,0,0,0,0,0,0,0,44000,0,0,0,785000,741000,44000,44000
054387,台積電統一98購02,0,0,0,0,0,0,0,0,0,44000,0,0,0,171000,127000,44000,44000
056157,聯詠凱基97購03  ,0,0,0,0,0,0,0,0,0,43000,0,0,0,46000,3000,43000,43000
055885,大成鋼統一97購02,0,0,0,0,0,0,0,0,0,43000,0,0,0,43000,0,43000,43000
056922,全新兆豐99購01  ,0,0,0,0,0,0,0,0,0,43000,0,0,0,130000,87000,43000,43000
046625,勤誠凱基93購01  ,0,0,0,0,0,0,0,0,0,43000,0,0,0,43000,0,43000,43000
047628,新光金國票95購02,0,0,0,0,0,0,0,0,0,43000,0,0,0,43000,0,43000,43000
048606,聯發科日盛93購02,0,0,0,0,0,0,0,0,0,43000,0,0,0,43000,0,43000,43000
049994,聯茂台新94購02  ,0,0,0,0,0,0,0,0,0,43000,0,0,0,43000,0,43000,43000
050869,健策永豐95購01  ,0,0,0,0,0,0,0,0,0,43000,0,0,0,65000,22000,43000,43000
050936,國巨國票95購04  ,0,0,0,0,0,0,0,0,0,43000,0,0,0,50000,7000,43000,43000
052537,力成富邦95購01  ,0,0,0,0,0,0,0,0,0,43000,0,0,0,43000,0,43000,43000
052559,茂林國票97購01  ,0,0,0,0,0,0,0,0,0,43000,0,0,0,43000,0,43000,43000
052553,技嘉國票96購01  ,0,0,0,0,0,0,0,0,0,43000,0,0,0,102000,59000,43000,43000
052452,茂林元大95購03  ,0,0,0,0,0,0,0,0,0,43000,0,0,0,195000,152000,43000,43000
054623,華新科第一97購01,0,0,0,0,0,0,0,0,0,43000,0,0,0,229000,186000,43000,43000
054583,玉晶光統一97購02,0,0,0,0,0,0,0,0,0,43000,0,0,0,122000,79000,43000,43000
054064,台郡國票97購04  ,0,0,0,0,0,0,0,0,0,43000,0,0,0,43000,0,43000,43000
054058,晶豪科國票98購01,0,0,0,0,0,0,0,0,0,43000,0,0,0,56000,13000,43000,43000
054698,同欣電永豐97購01,0,0,0,0,0,0,0,0,0,43000,0,0,0,112000,69000,43000,43000
06228P,亞德客凱基97售04,0,0,0,0,0,0,0,0,0,43000,0,0,0,53000,10000,43000,43000
056596,光磊元富98購01  ,0,0,0,0,0,0,0,0,0,42000,0,0,0,52000,10000,42000,42000
05682P,大立光元大98售03,0,0,0,0,0,0,0,0,0,42000,0,0,0,237000,195000,42000,42000
06106P,國巨群益97售02  ,0,0,0,0,0,0,0,0,0,42000,0,0,0,80000,38000,42000,42000
055368,台積電元大97購24,0,0,0,0,0,0,0,0,0,42000,0,0,0,102000,60000,42000,42000
047519,台達電元大93購02,0,0,0,0,0,0,0,0,0,42000,0,0,0,101000,59000,42000,42000
049600,緯穎元大95購02  ,0,0,0,0,0,0,0,0,0,42000,0,0,0,72000,30000,42000,42000
04956P,臺股指日盛94售02,0,0,0,0,0,0,0,0,0,42000,0,0,0,199000,157000,42000,42000
049982,嘉晶凱基94購01  ,0,0,0,0,0,0,0,0,0,42000,0,0,0,257000,215000,42000,42000
050455,貿聯元大94購02  ,0,0,0,0,0,0,0,0,0,42000,0,0,0,95000,53000,42000,42000
052028,健策群益95購02  ,0,0,0,0,0,0,0,0,0,42000,0,0,0,53000,11000,42000,42000
050533,致新元大94購03  ,0,0,0,0,0,0,0,0,0,42000,0,0,0,42000,0,42000,42000
053985,矽創元大96購02  ,0,0,0,0,0,0,0,0,0,42000,0,0,0,100000,58000,42000,42000
053672,嘉澤元富96購02  ,0,0,0,0,0,0,0,0,0,42000,0,0,0,75000,33000,42000,42000
052685,技嘉元大96購01  ,0,0,0,0,0,0,0,0,0,42000,0,0,0,45000,3000,42000,42000
053219,祥碩凱基96購01  ,0,0,0,0,0,0,0,0,0,42000,0,0,0,43000,1000,42000,42000
06214P,國巨國票98售04  ,0,0,0,0,0,0,0,0,0,42000,0,0,0,106000,64000,42000,42000
6214,精誠            ,108000,69000,39000,0,0,0,0,0,0,3000,3000,0,3000,0,0,0,42000
4133,亞諾法          ,40000,28000,12000,0,0,0,0,0,0,30000,31000,1000,30000,0,0,0,42000
055441,緯穎國票98購01  ,0,0,0,0,0,0,0,0,0,41000,0,0,0,41000,0,41000,41000
055477,同欣電凱基98購01,0,0,0,0,0,0,0,0,0,41000,0,0,0,101000,60000,41000,41000
055698,茂林國票98購03  ,0,0,0,0,0,0,0,0,0,41000,0,0,0,51000,10000,41000,41000
057190,立積元大9A購02  ,0,0,0,0,0,0,0,0,0,41000,0,0,0,41000,0,41000,41000
057063,立積國泰9A購01  ,0,0,0,0,0,0,0,0,0,41000,0,0,0,202000,161000,41000,41000
04047P,華邦電元大94售03,0,0,0,0,0,0,0,0,0,41000,0,0,0,41000,0,41000,41000
049370,可成元大94購03  ,0,0,0,0,0,0,0,0,0,41000,0,0,0,171000,130000,41000,41000
051758,瑞昱元大95購01  ,0,0,0,0,0,0,0,0,0,41000,0,0,0,51000,10000,41000,41000
051250,大立光元大98購01,0,0,0,0,0,0,0,0,0,41000,0,0,0,41000,0,41000,41000
050729,聯鈞國票94購01  ,0,0,0,0,0,0,0,0,0,41000,0,0,0,64000,23000,41000,41000
050969,台郡永豐95購01  ,0,0,0,0,0,0,0,0,0,41000,0,0,0,127000,86000,41000,41000
050850,訊連國票96購01  ,0,0,0,0,0,0,0,0,0,41000,0,0,0,62000,21000,41000,41000
052623,台郡兆豐96購01  ,0,0,0,0,0,0,0,0,0,41000,0,0,0,51000,10000,41000,41000
054989,精元元富97購01  ,0,0,0,0,0,0,0,0,0,41000,0,0,0,41000,0,41000,41000
054928,帆宣凱基98購01  ,0,0,0,0,0,0,0,0,0,41000,0,0,0,184000,143000,41000,41000
054428,禾伸堂富邦98購01,0,0,0,0,0,0,0,0,0,41000,0,0,0,57000,16000,41000,41000
054376,聯茂中信97購01  ,0,0,0,0,0,0,0,0,0,41000,0,0,0,111000,70000,41000,41000
06417P,台積電兆豐97售03,0,0,0,0,0,0,0,0,0,41000,0,0,0,41000,0,41000,41000
1709,和益            ,52000,11000,41000,0,0,0,0,0,0,0,0,0,0,0,0,0,41000
056759,元油2X元大98購05,0,0,0,0,0,0,0,0,0,40000,0,0,0,40000,0,40000,40000
056613,旺宏永豐98購01  ,0,0,0,0,0,0,0,0,0,40000,0,0,0,108000,68000,40000,40000
055850,聯詠元大97購06  ,0,0,0,0,0,0,0,0,0,40000,0,0,0,80000,40000,40000,40000
055796,南電國泰98購01  ,0,0,0,0,0,0,0,0,0,40000,0,0,0,75000,35000,40000,40000
055437,禾伸堂中信99購01,0,0,0,0,0,0,0,0,0,40000,0,0,0,83000,43000,40000,40000
055340,華新科日盛97購01,0,0,0,0,0,0,0,0,0,40000,0,0,0,192000,152000,40000,40000
056531,佳世達凱基98購01,0,0,0,0,0,0,0,0,0,40000,0,0,0,40000,0,40000,40000
056463,台虹凱基98購02  ,0,0,0,0,0,0,0,0,0,40000,0,0,0,111000,71000,40000,40000
056430,鴻海凱基98購06  ,0,0,0,0,0,0,0,0,0,40000,0,0,0,49000,9000,40000,40000
041210,群創元富93購01  ,0,0,0,0,0,0,0,0,0,40000,0,0,0,50000,10000,40000,40000
042196,元油2X元大93購02,0,0,0,0,0,0,0,0,0,40000,0,0,0,40000,0,40000,40000
03085P,台積電元大01售34,0,0,0,0,0,0,0,0,0,40000,0,0,0,40000,0,40000,40000
03415B,臺股指元大93熊49,0,0,0,0,0,0,0,0,0,40000,0,0,0,77000,37000,40000,40000
046187,友達凱基93購03  ,0,0,0,0,0,0,0,0,0,40000,0,0,0,40000,0,40000,40000
04615P,華新科群益94售03,0,0,0,0,0,0,0,0,0,40000,0,0,0,40000,0,40000,40000
045634,友達凱基93購02  ,0,0,0,0,0,0,0,0,0,40000,0,0,0,40000,0,40000,40000
04313P,國巨元富95售03  ,0,0,0,0,0,0,0,0,0,40000,0,0,0,90000,50000,40000,40000
043144,台肥統一93購01  ,0,0,0,0,0,0,0,0,0,40000,0,0,0,50000,10000,40000,40000
045958,技嘉凱基93購04  ,0,0,0,0,0,0,0,0,0,40000,0,0,0,51000,11000,40000,40000
047896,京元電群益93購01,0,0,0,0,0,0,0,0,0,40000,0,0,0,40000,0,40000,40000
046431,中環第一92購01  ,0,0,0,0,0,0,0,0,0,40000,0,0,0,40000,0,40000,40000
048508,元上證凱基94購02,0,0,0,0,0,0,0,0,0,40000,0,0,0,40000,0,40000,40000
048247,聯發科兆豐93購03,0,0,0,0,0,0,0,0,0,40000,0,0,0,40000,0,40000,40000
046750,鴻海凱基93購17  ,0,0,0,0,0,0,0,0,0,40000,0,0,0,40000,0,40000,40000
051455,樺漢元大96購01  ,0,0,0,0,0,0,0,0,0,40000,0,0,0,40000,0,40000,40000
051471,國巨凱基97購01  ,0,0,0,0,0,0,0,0,0,40000,0,0,0,40000,0,40000,40000
051817,元金2X統一95購01,0,0,0,0,0,0,0,0,0,40000,0,0,0,50000,10000,40000,40000
051790,貿聯國票95購03  ,0,0,0,0,0,0,0,0,0,40000,0,0,0,60000,20000,40000,40000
050385,貿聯國票95購02  ,0,0,0,0,0,0,0,0,0,40000,0,0,0,50000,10000,40000,40000
052667,漢唐群益96購01  ,0,0,0,0,0,0,0,0,0,40000,0,0,0,40000,0,40000,40000
052680,T50反1元大96購04,0,0,0,0,0,0,0,0,0,40000,0,0,0,50000,10000,40000,40000
052727,仁寶元富96購01  ,0,0,0,0,0,0,0,0,0,40000,0,0,0,40000,0,40000,40000
052121,全新國票96購03  ,0,0,0,0,0,0,0,0,0,40000,0,0,0,40000,0,40000,40000
049152,大立光元大95購06,0,0,0,0,0,0,0,0,0,40000,0,0,0,100000,60000,40000,40000
050818,華新科凱基95購02,0,0,0,0,0,0,0,0,0,40000,0,0,0,45000,5000,40000,40000
049580,國巨元大94購07  ,0,0,0,0,0,0,0,0,0,40000,0,0,0,40000,0,40000,40000
051409,美律國票96購01  ,0,0,0,0,0,0,0,0,0,40000,0,0,0,50000,10000,40000,40000
049783,元油2X兆豐95購01,0,0,0,0,0,0,0,0,0,40000,0,0,0,40000,0,40000,40000
049066,元石油凱基97購01,0,0,0,0,0,0,0,0,0,40000,0,0,0,40000,0,40000,40000
049432,聯詠國票95購01  ,0,0,0,0,0,0,0,0,0,40000,0,0,0,40000,0,40000,40000
049490,京元電元大95購02,0,0,0,0,0,0,0,0,0,40000,0,0,0,91000,51000,40000,40000
051768,臻鼎元大95購04  ,0,0,0,0,0,0,0,0,0,40000,0,0,0,40000,0,40000,40000
050754,元金2X元富9B購01,0,0,0,0,0,0,0,0,0,40000,0,0,0,150000,110000,40000,40000
049354,致新永豐94購01  ,0,0,0,0,0,0,0,0,0,40000,0,0,0,40000,0,40000,40000
050071,明泰凱基94購01  ,0,0,0,0,0,0,0,0,0,40000,0,0,0,50000,10000,40000,40000
05194P,玉晶光康和95售01,0,0,0,0,0,0,0,0,0,40000,0,0,0,40000,0,40000,40000
05149P,緯穎國泰96售01  ,0,0,0,0,0,0,0,0,0,40000,0,0,0,50000,10000,40000,40000
051494,中環兆豐95購01  ,0,0,0,0,0,0,0,0,0,40000,0,0,0,50000,10000,40000,40000
05499P,聯詠元富95售02  ,0,0,0,0,0,0,0,0,0,40000,0,0,0,50000,10000,40000,40000
05473P,聯詠統一97售02  ,0,0,0,0,0,0,0,0,0,40000,0,0,0,40000,0,40000,40000
05484P,台積電凱基95售18,0,0,0,0,0,0,0,0,0,40000,0,0,0,40000,0,40000,40000
055174,精元統一97購01  ,0,0,0,0,0,0,0,0,0,40000,0,0,0,40000,0,40000,40000
053099,正崴元富96購01  ,0,0,0,0,0,0,0,0,0,40000,0,0,0,59000,19000,40000,40000
052912,日月光統一96購01,0,0,0,0,0,0,0,0,0,40000,0,0,0,68000,28000,40000,40000
052930,華新科元大97購03,0,0,0,0,0,0,0,0,0,40000,0,0,0,40000,0,40000,40000
053485,矽創國票97購04  ,0,0,0,0,0,0,0,0,0,40000,0,0,0,40000,0,40000,40000
053590,新光金元大9A購02,0,0,0,0,0,0,0,0,0,40000,0,0,0,50000,10000,40000,40000
06286P,世芯國票97售02  ,0,0,0,0,0,0,0,0,0,40000,0,0,0,277000,237000,40000,40000
2417,圓剛            ,70000,30000,40000,0,0,0,0,0,0,0,1000,1000,0,0,0,0,40000
05604P,聯發科元大96售10,0,0,0,0,0,0,0,0,0,39000,0,0,0,106000,67000,39000,39000
055680,美律凱基99購01  ,0,0,0,0,0,0,0,0,0,39000,0,0,0,107000,68000,39000,39000
056715,瀚宇博永豐98購01,0,0,0,0,0,0,0,0,0,39000,0,0,0,51000,12000,39000,39000
057060,緯穎元大98購05  ,0,0,0,0,0,0,0,0,0,39000,0,0,0,147000,108000,39000,39000
048057,宏達電國泰94購02,0,0,0,0,0,0,0,0,0,39000,0,0,0,39000,0,39000,39000
044298,南電凱基93購01  ,0,0,0,0,0,0,0,0,0,39000,0,0,0,40000,1000,39000,39000
00680L,元大美債20正2   ,0,0,0,0,0,0,0,0,0,39000,104000,0,104000,24000,89000,-65000,39000
049299,矽創群益94購01  ,0,0,0,0,0,0,0,0,0,39000,0,0,0,39000,0,39000,39000
05042P,GIS凱基95售03   ,0,0,0,0,0,0,0,0,0,39000,0,0,0,50000,11000,39000,39000
051715,和碩台新95購01  ,0,0,0,0,0,0,0,0,0,39000,0,0,0,39000,0,39000,39000
052374,瑞昱元大95購02  ,0,0,0,0,0,0,0,0,0,39000,0,0,0,45000,6000,39000,39000
052515,矽力凱基95購02  ,0,0,0,0,0,0,0,0,0,39000,0,0,0,52000,13000,39000,39000
053662,矽力凱基97購01  ,0,0,0,0,0,0,0,0,0,39000,0,0,0,79000,40000,39000,39000
052957,T50反1凱基99購01,0,0,0,0,0,0,0,0,0,39000,0,0,0,40000,1000,39000,39000
052977,奇力新麥證97購01,0,0,0,39000,0,39000,0,0,0,39000,0,0,0,39000,0,39000,39000
06308P,國巨元富97售06  ,0,0,0,0,0,0,0,0,0,39000,0,0,0,53000,14000,39000,39000
1439,中和            ,50000,11000,39000,0,0,0,0,0,0,0,0,0,0,0,0,0,39000
056743,貿聯凱基98購04  ,0,0,0,0,0,0,0,0,0,38000,0,0,0,185000,147000,38000,38000
056869,國巨日盛99購03  ,0,0,0,0,0,0,0,0,0,38000,0,0,0,43000,5000,38000,38000
056547,臻鼎凱基99購01  ,0,0,0,0,0,0,0,0,0,38000,0,0,0,56000,18000,38000,38000
06063P,玉晶光元富97售01,0,0,0,0,0,0,0,0,0,38000,0,0,0,91000,53000,38000,38000
05998P,台積電元大97售12,0,0,0,0,0,0,0,0,0,38000,0,0,0,188000,150000,38000,38000
055546,台積電凱基97購12,0,0,0,0,0,0,0,0,0,38000,0,0,0,125000,87000,38000,38000
056228,可成凱基97購03  ,0,0,0,0,0,0,0,0,0,38000,0,0,0,127000,89000,38000,38000
042093,台灣50群益94購02,0,0,0,0,0,0,0,0,0,38000,0,0,0,38000,0,38000,38000
043652,微星國泰93購01  ,0,0,0,0,0,0,0,0,0,38000,0,0,0,38000,0,38000,38000
047924,可成凱基93購10  ,0,0,0,0,0,0,0,0,0,38000,0,0,0,68000,30000,38000,38000
049502,訊芯元大94購01  ,0,0,0,0,0,0,0,0,0,38000,0,0,0,50000,12000,38000,38000
050664,全新台新94購02  ,0,0,0,0,0,0,0,0,0,38000,0,0,0,38000,0,38000,38000
050040,鴻海中信94購04  ,0,0,0,0,0,0,0,0,0,38000,0,0,0,43000,5000,38000,38000
050089,臻鼎台新94購01  ,0,0,0,0,0,0,0,0,0,38000,0,0,0,38000,0,38000,38000
050583,瑞儀國票94購01  ,0,0,0,0,0,0,0,0,0,38000,0,0,0,38000,0,38000,38000
05366P,鴻海元富95售12  ,0,0,0,0,0,0,0,0,0,38000,0,0,0,38000,0,38000,38000
055042,得力永豐97購01  ,0,0,0,0,0,0,0,0,0,38000,0,0,0,68000,30000,38000,38000
054723,鴻海日盛97購01  ,0,0,0,0,0,0,0,0,0,38000,0,0,0,40000,2000,38000,38000
054763,宏達電國票99購01,0,0,0,0,0,0,0,0,0,38000,0,0,0,38000,0,38000,38000
054677,智易台新98購02  ,0,0,0,0,0,0,0,0,0,38000,0,0,0,38000,0,38000,38000
1447,力鵬            ,52000,14000,38000,0,0,0,0,0,0,0,0,0,0,0,0,0,38000
2707,晶華            ,44000,6000,38000,0,0,0,0,0,0,0,0,0,0,0,0,0,38000
056053,和大元大97購05  ,0,0,0,0,0,0,0,0,0,37000,0,0,0,37000,0,37000,37000
056523,光寶科中信98購01,0,0,0,0,0,0,0,0,0,37000,0,0,0,37000,0,37000,37000
055727,矽力元大97購02  ,0,0,0,0,0,0,0,0,0,37000,0,0,0,38000,1000,37000,37000
06158P,玉晶光元富97售08,0,0,0,0,0,0,0,0,0,37000,0,0,0,49000,12000,37000,37000
056659,泰碩元大99購01  ,0,0,0,0,0,0,0,0,0,37000,0,0,0,38000,1000,37000,37000
03945P,欣興群益94售01  ,0,0,0,0,0,0,0,0,0,37000,0,0,0,42000,5000,37000,37000
046668,嘉澤元大93購01  ,0,0,0,0,0,0,0,0,0,37000,0,0,0,60000,23000,37000,37000
048509,上証反凱基99購02,0,0,0,0,0,0,0,0,0,37000,0,0,0,44000,7000,37000,37000
04843P,致新元大94售02  ,0,0,0,0,0,0,0,0,0,37000,0,0,0,100000,63000,37000,37000
050623,致新元大94購05  ,0,0,0,0,0,0,0,0,0,37000,0,0,0,47000,10000,37000,37000
050486,可成元富94購05  ,0,0,0,0,0,0,0,0,0,37000,0,0,0,57000,20000,37000,37000
052573,智伸科凱基97購01,0,0,0,0,0,0,0,0,0,37000,0,0,0,47000,10000,37000,37000
049087,晶相光凱基94購02,0,0,0,0,0,0,0,0,0,37000,0,0,0,37000,0,37000,37000
054303,國巨凱基96購15  ,0,0,0,0,0,0,0,0,0,37000,0,0,0,39000,2000,37000,37000
054846,瑞昱兆豐97購01  ,0,0,0,0,0,0,0,0,0,37000,0,0,0,37000,0,37000,37000
053553,聯詠凱基96購03  ,0,0,0,0,0,0,0,0,0,37000,0,0,0,74000,37000,37000,37000
053443,智邦凱基97購01  ,0,0,0,0,0,0,0,0,0,37000,0,0,0,66000,29000,37000,37000
052872,智易凱基96購01  ,0,0,0,0,0,0,0,0,0,37000,0,0,0,37000,0,37000,37000
052817,楠梓電永豐96購02,0,0,0,0,0,0,0,0,0,37000,0,0,0,91000,54000,37000,37000
2451,創見            ,117000,46000,71000,0,0,0,0,0,0,-34000,0,0,0,0,34000,-34000,37000
6224,聚鼎            ,56000,25000,31000,0,0,0,0,0,0,6000,6000,0,6000,0,0,0,37000
06528P,台積電富邦99售03,0,0,0,0,0,0,0,0,0,37000,0,0,0,40000,3000,37000,37000
056792,訊芯群益98購01  ,0,0,0,0,0,0,0,0,0,36000,0,0,0,127000,91000,36000,36000
057207,立積元富98購02  ,0,0,0,0,0,0,0,0,0,36000,0,0,0,36000,0,36000,36000
056429,華通凱基98購02  ,0,0,0,0,0,0,0,0,0,36000,0,0,0,90000,54000,36000,36000
056421,鴻海統一98購08  ,0,0,0,0,0,0,0,0,0,36000,0,0,0,36000,0,36000,36000
046712,勤誠永豐93購01  ,0,0,0,0,0,0,0,0,0,36000,0,0,0,36000,0,36000,36000
046978,復盛永豐93購01  ,0,0,0,0,0,0,0,0,0,36000,0,0,0,36000,0,36000,36000
046149,宏達電國票93購01,0,0,0,0,0,0,0,0,0,36000,0,0,0,36000,0,36000,36000
049385,茂林元大94購03  ,0,0,0,0,0,0,0,0,0,36000,0,0,0,93000,57000,36000,36000
050144,宏達電台新95購01,0,0,0,0,0,0,0,0,0,36000,0,0,0,36000,0,36000,36000
049284,瑞昱中信94購02  ,0,0,0,0,0,0,0,0,0,36000,0,0,0,83000,47000,36000,36000
051150,宏達電凱基95購02,0,0,0,0,0,0,0,0,0,36000,0,0,0,38000,2000,36000,36000
053936,旺宏元富96購04  ,0,0,0,0,0,0,0,0,0,36000,0,0,0,80000,44000,36000,36000
053874,台表科元大96購05,0,0,0,0,0,0,0,0,0,36000,0,0,0,68000,32000,36000,36000
054942,凱美元大97購02  ,0,0,0,0,0,0,0,0,0,36000,0,0,0,90000,54000,36000,36000
055261,帆宣統一98購01  ,0,0,0,0,0,0,0,0,0,36000,0,0,0,210000,174000,36000,36000
055186,正文統一97購01  ,0,0,0,0,0,0,0,0,0,36000,0,0,0,36000,0,36000,36000
054153,宏達電國泰97購01,0,0,0,0,0,0,0,0,0,36000,0,0,0,162000,126000,36000,36000
054587,玉晶光國泰99購01,0,0,0,0,0,0,0,0,0,36000,0,0,0,50000,14000,36000,36000
054581,訊芯元大97購02  ,0,0,0,0,0,0,0,0,0,36000,0,0,0,153000,117000,36000,36000
06513P,鴻海凱基98售10  ,0,0,0,0,0,0,0,0,0,36000,0,0,0,42000,6000,36000,36000
06360P,台積電群益97售05,0,0,0,0,0,0,0,0,0,36000,0,0,0,43000,7000,36000,36000
1737,臺鹽            ,39000,3000,36000,0,0,0,0,0,0,0,0,0,0,0,0,0,36000
6591,動力-KY         ,56000,20000,36000,0,0,0,0,0,0,0,0,0,0,0,0,0,36000
056362,聯發科元大99購01,0,0,0,0,0,0,0,0,0,35000,0,0,0,614000,579000,35000,35000
055344,國巨凱基97購04  ,0,0,0,0,0,0,0,0,0,35000,0,0,0,41000,6000,35000,35000
056735,國巨凱基99購02  ,0,0,0,0,0,0,0,0,0,35000,0,0,0,35000,0,35000,35000
03521P,欣興元大02售16  ,0,0,0,0,0,0,0,0,0,35000,0,0,0,35000,0,35000,35000
042558,瑞昱中信94購01  ,0,0,0,0,0,0,0,0,0,35000,0,0,0,35000,0,35000,35000
048028,聯發科凱基93購25,0,0,0,0,0,0,0,0,0,35000,0,0,0,46000,11000,35000,35000
046799,儒鴻元大93購01  ,0,0,0,0,0,0,0,0,0,35000,0,0,0,35000,0,35000,35000
048223,微星凱基93購02  ,0,0,0,0,0,0,0,0,0,35000,0,0,0,35000,0,35000,35000
047523,瑞昱元大93購09  ,0,0,0,0,0,0,0,0,0,35000,0,0,0,35000,0,35000,35000
047546,瑞昱凱基93購06  ,0,0,0,0,0,0,0,0,0,35000,0,0,0,45000,10000,35000,35000
051101,台表科元大96購02,0,0,0,0,0,0,0,0,0,35000,0,0,0,70000,35000,35000,35000
050119,瀚宇博元大95購03,0,0,0,0,0,0,0,0,0,35000,0,0,0,35000,0,35000,35000
049092,聯茂凱基94購07  ,0,0,0,0,0,0,0,0,0,35000,0,0,0,35000,0,35000,35000
04903P,全新永豐94售05  ,0,0,0,0,0,0,0,0,0,35000,0,0,0,72000,37000,35000,35000
048981,牧德元大94購01  ,0,0,0,0,0,0,0,0,0,35000,0,0,0,65000,30000,35000,35000
054933,南港元大97購01  ,0,0,0,0,0,0,0,0,0,35000,0,0,0,65000,30000,35000,35000
054961,玉晶光元大99購01,0,0,0,0,0,0,0,0,0,35000,0,0,0,78000,43000,35000,35000
053488,中石化兆豐97購01,0,0,0,0,0,0,0,0,0,35000,0,0,0,85000,50000,35000,35000
6670,復盛應用        ,130000,60000,70000,0,0,0,0,10000,-10000,-25000,2000,0,2000,0,27000,-27000,35000
06179P,國巨群益97售04  ,0,0,0,0,0,0,0,0,0,35000,0,0,0,92000,57000,35000,35000
06183P,大立光元大97售05,0,0,0,0,0,0,0,0,0,35000,0,0,0,55000,20000,35000,35000
06500P,臺股指元大9A售05,0,0,0,0,0,0,0,0,0,35000,0,0,0,55000,20000,35000,35000
9917,中保科          ,74000,39000,35000,0,0,0,0,0,0,0,0,0,0,0,0,0,35000
05679P,台表科群益96售05,0,0,0,0,0,0,0,0,0,34000,0,0,0,44000,10000,34000,34000
05711P,茂林國票97售03  ,0,0,0,0,0,0,0,0,0,34000,0,0,0,80000,46000,34000,34000
057301,嘉聯益永豐98購02,0,0,0,0,0,0,0,0,0,34000,0,0,0,104000,70000,34000,34000
06109P,華新科群益97售05,0,0,0,0,0,0,0,0,0,34000,0,0,0,34000,0,34000,34000
05859P,台表科國票97售04,0,0,0,0,0,0,0,0,0,34000,0,0,0,38000,4000,34000,34000
056357,台積電元大9A購01,0,0,0,0,0,0,0,0,0,34000,0,0,0,46000,12000,34000,34000
046639,嘉晶永豐93購01  ,0,0,0,0,0,0,0,0,0,34000,0,0,0,142000,108000,34000,34000
03418B,臺股指元大95熊20,0,0,0,0,0,0,0,0,0,34000,0,0,0,110000,76000,34000,34000
051361,泰鼎元大95購01  ,0,0,0,0,0,0,0,0,0,34000,0,0,0,76000,42000,34000,34000
052684,旺宏元大98購01  ,0,0,0,0,0,0,0,0,0,34000,0,0,0,40000,6000,34000,34000
052507,日月光日盛95購02,0,0,0,0,0,0,0,0,0,34000,0,0,0,34000,0,34000,34000
05234P,美食康和95售01  ,0,0,0,0,0,0,0,0,0,34000,0,0,0,50000,16000,34000,34000
051657,台郡元富98購01  ,0,0,0,0,0,0,0,0,0,34000,0,0,0,253000,219000,34000,34000
053521,緯穎群益96購02  ,0,0,0,0,0,0,0,0,0,34000,0,0,0,110000,76000,34000,34000
053447,京鼎凱基96購03  ,0,0,0,0,0,0,0,0,0,34000,0,0,0,44000,10000,34000,34000
052783,台郡國票97購01  ,0,0,0,0,0,0,0,0,0,34000,0,0,0,94000,60000,34000,34000
052769,達興群益96購01  ,0,0,0,0,0,0,0,0,0,34000,0,0,0,34000,0,34000,34000
055087,瑞昱亞東97購01  ,0,0,0,0,0,0,0,0,0,34000,0,0,0,34000,0,34000,34000
054487,京元電台新97購01,0,0,0,0,0,0,0,0,0,34000,0,0,0,34000,0,34000,34000
054263,聯茂元大96購02  ,0,0,0,0,0,0,0,0,0,34000,0,0,0,38000,4000,34000,34000
06278P,臺股指凱基97售10,0,0,0,0,0,0,0,0,0,34000,0,0,0,40000,6000,34000,34000
055610,光磊國票98購01  ,0,0,0,0,0,0,0,0,0,33000,0,0,0,33000,0,33000,33000
055507,樺漢元大98購02  ,0,0,0,0,0,0,0,0,0,33000,0,0,0,314000,281000,33000,33000
06170P,禾伸堂元富97售02,0,0,0,0,0,0,0,0,0,33000,0,0,0,47000,14000,33000,33000
057223,富邦金日盛99購01,0,0,0,0,0,0,0,0,0,33000,0,0,0,33000,0,33000,33000
03982P,智易國票94售02  ,0,0,0,0,0,0,0,0,0,33000,0,0,0,33000,0,33000,33000
04650P,臺股指凱基94售09,0,0,0,0,0,0,0,0,0,33000,0,0,0,33000,0,33000,33000
045448,宏達電國泰93購02,0,0,0,0,0,0,0,0,0,33000,0,0,0,48000,15000,33000,33000
050550,大立光凱基95購04,0,0,0,0,0,0,0,0,0,33000,0,0,0,33000,0,33000,33000
052390,聯詠群益95購03  ,0,0,0,0,0,0,0,0,0,33000,0,0,0,38000,5000,33000,33000
049117,矽格統一96購01  ,0,0,0,0,0,0,0,0,0,33000,0,0,0,33000,0,33000,33000
051363,矽創元大95購03  ,0,0,0,0,0,0,0,0,0,33000,0,0,0,33000,0,33000,33000
051402,玉晶光永豐95購04,0,0,0,0,0,0,0,0,0,33000,0,0,0,49000,16000,33000,33000
049546,正崴群益94購01  ,0,0,0,0,0,0,0,0,0,33000,0,0,0,33000,0,33000,33000
050901,樺漢元大95購02  ,0,0,0,0,0,0,0,0,0,33000,0,0,0,33000,0,33000,33000
048946,崇越永豐94購01  ,0,0,0,0,0,0,0,0,0,33000,0,0,0,33000,0,33000,33000
054336,台積電統一96購11,0,0,0,0,0,0,0,0,0,33000,0,0,0,205000,172000,33000,33000
054985,光罩元富97購01  ,0,0,0,0,0,0,0,0,0,33000,0,0,0,123000,90000,33000,33000
054905,國揚康和97購01  ,0,0,0,0,0,0,0,0,0,33000,0,0,0,53000,20000,33000,33000
052478,大立光群益95購05,0,0,0,0,0,0,0,0,0,33000,0,0,0,56000,23000,33000,33000
05328P,臺股指凱基95售12,0,0,0,0,0,0,0,0,0,33000,0,0,0,33000,0,33000,33000
053656,可成凱基96購06  ,0,0,0,0,0,0,0,0,0,33000,0,0,0,264000,231000,33000,33000
4155,訊映            ,55000,22000,33000,0,0,0,0,0,0,0,0,0,0,0,0,0,33000
2390,云辰            ,79000,46000,33000,0,0,0,0,0,0,0,0,0,0,0,0,0,33000
2530,華建            ,35000,2000,33000,0,0,0,0,0,0,0,0,0,0,0,0,0,33000
06064P,台積電台新98售01,0,0,0,0,0,0,0,0,0,32000,0,0,0,247000,215000,32000,32000
05860P,旺宏康和96售01  ,0,0,0,0,0,0,0,0,0,32000,0,0,0,57000,25000,32000,32000
05899P,臺股指凱基96售30,0,0,0,0,0,0,0,0,0,32000,0,0,0,62000,30000,32000,32000
052207,台郡中信95購02  ,0,0,0,0,0,0,0,0,0,32000,0,0,0,237000,205000,32000,32000
057042,台積電元大98購10,0,0,0,0,0,0,0,0,0,32000,0,0,0,240000,208000,32000,32000
057082,玉晶光統一9A購04,0,0,0,0,0,0,0,0,0,32000,0,0,0,32000,0,32000,32000
056880,緯穎國票98購02  ,0,0,0,0,0,0,0,0,0,32000,0,0,0,67000,35000,32000,32000
056903,大立光元大99購04,0,0,0,0,0,0,0,0,0,32000,0,0,0,37000,5000,32000,32000
056621,宏達電永豐98購01,0,0,0,0,0,0,0,0,0,32000,0,0,0,54000,22000,32000,32000
056558,台達電群益98購01,0,0,0,0,0,0,0,0,0,32000,0,0,0,42000,10000,32000,32000
056575,禾伸堂元大99購01,0,0,0,0,0,0,0,0,0,32000,0,0,0,176000,144000,32000,32000
055335,健策兆豐98購01  ,0,0,0,0,0,0,0,0,0,32000,0,0,0,32000,0,32000,32000
056290,正文永豐98購01  ,0,0,0,0,0,0,0,0,0,32000,0,0,0,32000,0,32000,32000
056528,為升凱基98購01  ,0,0,0,0,0,0,0,0,0,32000,0,0,0,50000,18000,32000,32000
056486,樺漢元大98購04  ,0,0,0,0,0,0,0,0,0,32000,0,0,0,84000,52000,32000,32000
055992,智原台新97購02  ,0,0,0,0,0,0,0,0,0,32000,0,0,0,32000,0,32000,32000
046562,大立光凱基95購01,0,0,0,0,0,0,0,0,0,32000,0,0,0,32000,0,32000,32000
046010,大立光元富92購03,0,0,0,0,0,0,0,0,0,32000,0,0,0,32000,0,32000,32000
050402,緯穎中信96購01  ,0,0,0,0,0,0,0,0,0,32000,0,0,0,50000,18000,32000,32000
048923,國巨永豐94購02  ,0,0,0,0,0,0,0,0,0,32000,0,0,0,61000,29000,32000,32000
049009,南亞科麥證94購01,0,0,0,91000,59000,32000,0,0,0,32000,0,0,0,91000,59000,32000,32000
050927,聯詠凱基95購01  ,0,0,0,0,0,0,0,0,0,32000,0,0,0,69000,37000,32000,32000
049166,元油2X凱基97購02,0,0,0,0,0,0,0,0,0,32000,0,0,0,35000,3000,32000,32000
049346,新光金統一95購01,0,0,0,0,0,0,0,0,0,32000,0,0,0,45000,13000,32000,32000
051694,A50正2中信96購03,0,0,0,0,0,0,0,0,0,32000,0,0,0,32000,0,32000,32000
051332,奇力新永豐95購01,0,0,0,0,0,0,0,0,0,32000,0,0,0,54000,22000,32000,32000
053822,正文群益97購01  ,0,0,0,0,0,0,0,0,0,32000,0,0,0,32000,0,32000,32000
053235,智原永豐96購01  ,0,0,0,0,0,0,0,0,0,32000,0,0,0,32000,0,32000,32000
053216,京鼎凱基96購02  ,0,0,0,0,0,0,0,0,0,32000,0,0,0,72000,40000,32000,32000
054757,南亞國票98購01  ,0,0,0,0,0,0,0,0,0,32000,0,0,0,32000,0,32000,32000
055255,欣興統一97購02  ,0,0,0,0,0,0,0,0,0,32000,0,0,0,36000,4000,32000,32000
055268,和大元大97購01  ,0,0,0,0,0,0,0,0,0,32000,0,0,0,32000,0,32000,32000
054028,臻鼎凱基96購03  ,0,0,0,0,0,0,0,0,0,32000,0,0,0,66000,34000,32000,32000
054509,上証反元大99購01,0,0,0,0,0,0,0,0,0,32000,0,0,0,137000,105000,32000,32000
2511,太子            ,49000,17000,32000,0,0,0,0,0,0,0,0,0,0,0,0,0,32000
3518,柏騰            ,100000,69000,31000,0,0,0,0,0,0,1000,1000,0,1000,0,0,0,32000
06387P,緯穎永豐97售02  ,0,0,0,0,0,0,0,0,0,32000,0,0,0,51000,19000,32000,32000
056088,台郡統一97購02  ,0,0,0,0,0,0,0,0,0,31000,0,0,0,41000,10000,31000,31000
056340,可成凱基98購04  ,0,0,0,0,0,0,0,0,0,31000,0,0,0,70000,39000,31000,31000
056377,智伸科統一9A購01,0,0,0,0,0,0,0,0,0,31000,0,0,0,31000,0,31000,31000
056648,牧德凱基99購02  ,0,0,0,0,0,0,0,0,0,31000,0,0,0,56000,25000,31000,31000
056992,祥碩兆豐98購01  ,0,0,0,0,0,0,0,0,0,31000,0,0,0,31000,0,31000,31000
06143P,鴻海永豐97售02  ,0,0,0,0,0,0,0,0,0,31000,0,0,0,31000,0,31000,31000
048036,隆達凱基93購01  ,0,0,0,0,0,0,0,0,0,31000,0,0,0,31000,0,31000,31000
047614,台郡群益93購02  ,0,0,0,0,0,0,0,0,0,31000,0,0,0,33000,2000,31000,31000
04771P,友達元大96售02  ,0,0,0,0,0,0,0,0,0,31000,0,0,0,31000,0,31000,31000
044735,光磊國泰93購01  ,0,0,0,0,0,0,0,0,0,31000,0,0,0,31000,0,31000,31000
047910,全新麥證94購01  ,0,0,0,31000,0,31000,0,0,0,31000,0,0,0,31000,0,31000,31000
047955,南亞科永豐93購01,0,0,0,0,0,0,0,0,0,31000,0,0,0,31000,0,31000,31000
046108,A50正2元大95購02,0,0,0,0,0,0,0,0,0,31000,0,0,0,31000,0,31000,31000
05020P,廣達中信95售01  ,0,0,0,0,0,0,0,0,0,31000,0,0,0,51000,20000,31000,31000
049120,元油2X元富94購05,0,0,0,0,0,0,0,0,0,31000,0,0,0,52000,21000,31000,31000
050997,麗豐元大95購03  ,0,0,0,0,0,0,0,0,0,31000,0,0,0,44000,13000,31000,31000
054051,貿聯元大97購03  ,0,0,0,0,0,0,0,0,0,31000,0,0,0,69000,38000,31000,31000
055193,世芯元富97購02  ,0,0,0,0,0,0,0,0,0,31000,0,0,0,146000,115000,31000,31000
055038,華航富邦99購01  ,0,0,0,0,0,0,0,0,0,31000,0,0,0,41000,10000,31000,31000
054711,禾伸堂元富97購01,0,0,0,0,0,0,0,0,0,31000,0,0,0,413000,382000,31000,31000
053806,鎧勝凱基96購02  ,0,0,0,0,0,0,0,0,0,31000,0,0,0,31000,0,31000,31000
053431,志超永豐96購01  ,0,0,0,0,0,0,0,0,0,31000,0,0,0,31000,0,31000,31000
053551,可成凱基96購05  ,0,0,0,0,0,0,0,0,0,31000,0,0,0,183000,152000,31000,31000
1473,台南            ,43000,12000,31000,0,0,0,0,0,0,0,0,0,0,0,0,0,31000
3617,碩天            ,37000,6000,31000,0,0,0,0,0,0,0,0,0,0,0,0,0,31000
2882A,國泰特          ,0,0,0,0,0,0,0,0,0,31000,31000,0,31000,0,0,0,31000
3003,健和興          ,52000,21000,31000,0,0,0,0,0,0,0,0,0,0,0,0,0,31000
2206,三陽工業        ,44000,13000,31000,0,0,0,0,0,0,0,0,0,0,0,0,0,31000
9103,美德醫療-DR     ,33000,2000,31000,0,0,0,0,0,0,0,0,0,0,0,0,0,31000
8454,富邦媒          ,119000,108000,11000,0,0,0,23000,0,23000,-3000,0,3000,-3000,0,0,0,31000
06149P,台積電元大97售18,0,0,0,0,0,0,0,0,0,30000,0,0,0,257000,227000,30000,30000
06171P,台積電統一97售06,0,0,0,0,0,0,0,0,0,30000,0,0,0,30000,0,30000,30000
06151P,華新科元大97售07,0,0,0,0,0,0,0,0,0,30000,0,0,0,195000,165000,30000,30000
06052P,台郡國票97售06  ,0,0,0,0,0,0,0,0,0,30000,0,0,0,40000,10000,30000,30000
05893P,國巨兆豐96售04  ,0,0,0,0,0,0,0,0,0,30000,0,0,0,40000,10000,30000,30000
05886P,華通元富96售01  ,0,0,0,0,0,0,0,0,0,30000,0,0,0,38000,8000,30000,30000
05835P,臺股指元富96售07,0,0,0,0,0,0,0,0,0,30000,0,0,0,140000,110000,30000,30000
05961P,鴻海群益97售01  ,0,0,0,0,0,0,0,0,0,30000,0,0,0,30000,0,30000,30000
057214,瑞昱群益98購01  ,0,0,0,0,0,0,0,0,0,30000,0,0,0,73000,43000,30000,30000
05785P,臺股指元大96售19,0,0,0,0,0,0,0,0,0,30000,0,0,0,30000,0,30000,30000
056999,元油2X國票98購02,0,0,0,0,0,0,0,0,0,30000,0,0,0,30000,0,30000,30000
056944,鴻海統一98購11  ,0,0,0,0,0,0,0,0,0,30000,0,0,0,30000,0,30000,30000
056640,元油2X凱基9A購01,0,0,0,0,0,0,0,0,0,30000,0,0,0,50000,20000,30000,30000
056548,瀚宇博凱基98購02,0,0,0,0,0,0,0,0,0,30000,0,0,0,45000,15000,30000,30000
056831,元油2X元富98購11,0,0,0,0,0,0,0,0,0,30000,0,0,0,30000,0,30000,30000
056723,國巨中信9A購01  ,0,0,0,0,0,0,0,0,0,30000,0,0,0,30000,0,30000,30000
056331,聯鈞國票99購01  ,0,0,0,0,0,0,0,0,0,30000,0,0,0,191000,161000,30000,30000
056300,聯發科元大97購23,0,0,0,0,0,0,0,0,0,30000,0,0,0,141000,111000,30000,30000
056297,台光電元大97購04,0,0,0,0,0,0,0,0,0,30000,0,0,0,33000,3000,30000,30000
05625P,國巨國票97售01  ,0,0,0,0,0,0,0,0,0,30000,0,0,0,40000,10000,30000,30000
056537,冠德凱基98購01  ,0,0,0,0,0,0,0,0,0,30000,0,0,0,30000,0,30000,30000
056413,上証反中信9A購01,0,0,0,0,0,0,0,0,0,30000,0,0,0,30000,0,30000,30000
056112,勤誠永豐97購02  ,0,0,0,0,0,0,0,0,0,30000,0,0,0,30000,0,30000,30000
056219,T50反1日盛02購01,0,0,0,0,0,0,0,0,0,30000,0,0,0,30000,0,30000,30000
05619P,創意元富96售02  ,0,0,0,0,0,0,0,0,0,30000,0,0,0,30000,0,30000,30000
055320,建準國票98購01  ,0,0,0,0,0,0,0,0,0,30000,0,0,0,50000,20000,30000,30000
055315,晶技麥證97購01  ,0,0,0,30000,0,30000,0,0,0,30000,0,0,0,30000,0,30000,30000
055363,緯穎凱基98購03  ,0,0,0,0,0,0,0,0,0,30000,0,0,0,73000,43000,30000,30000
055454,華邦電元富97購02,0,0,0,0,0,0,0,0,0,30000,0,0,0,88000,58000,30000,30000
05550P,臺股指元大96售07,0,0,0,0,0,0,0,0,0,30000,0,0,0,35000,5000,30000,30000
055833,華通元大98購05  ,0,0,0,0,0,0,0,0,0,30000,0,0,0,60000,30000,30000,30000
055893,大立光統一97購07,0,0,0,0,0,0,0,0,0,30000,0,0,0,45000,15000,30000,30000
046056,材料群益92購01  ,0,0,0,0,0,0,0,0,0,30000,0,0,0,30000,0,30000,30000
03039P,玉晶光國票02售04,0,0,0,0,0,0,0,0,0,30000,0,0,0,40000,10000,30000,30000
03050X,元展47          ,0,0,0,0,0,0,0,0,0,30000,0,0,0,30000,0,30000,30000
04165P,南亞科元富95售03,0,0,0,0,0,0,0,0,0,30000,0,0,0,30000,0,30000,30000
04081P,聯詠元大93售11  ,0,0,0,0,0,0,0,0,0,30000,0,0,0,30000,0,30000,30000
047912,台郡麥證94購01  ,0,0,0,35000,5000,30000,0,0,0,30000,0,0,0,35000,5000,30000,30000
047979,中石化群益95購01,0,0,0,0,0,0,0,0,0,30000,0,0,0,30000,0,30000,30000
045280,儒鴻富邦94購01  ,0,0,0,0,0,0,0,0,0,30000,0,0,0,30000,0,30000,30000
044403,新日興凱基92購01,0,0,0,0,0,0,0,0,0,30000,0,0,0,30000,0,30000,30000
044801,微星凱基93購01  ,0,0,0,0,0,0,0,0,0,30000,0,0,0,30000,0,30000,30000
044598,臻鼎亞東92購01  ,0,0,0,0,0,0,0,0,0,30000,0,0,0,30000,0,30000,30000
044462,漢唐兆豐93購01  ,0,0,0,0,0,0,0,0,0,30000,0,0,0,30000,0,30000,30000
045861,智邦統一93購02  ,0,0,0,0,0,0,0,0,0,30000,0,0,0,30000,0,30000,30000
043642,元金2X國票97購01,0,0,0,0,0,0,0,0,0,30000,0,0,0,30000,0,30000,30000
044265,滬深2X中信95購05,0,0,0,0,0,0,0,0,0,30000,0,0,0,30000,0,30000,30000
04427P,滬深2X元大97售02,0,0,0,0,0,0,0,0,0,30000,0,0,0,50000,20000,30000,30000
04850P,全新永豐94售03  ,0,0,0,0,0,0,0,0,0,30000,0,0,0,67000,37000,30000,30000
048534,貿聯國票94購01  ,0,0,0,0,0,0,0,0,0,30000,0,0,0,61000,31000,30000,30000
047481,可成凱基93購08  ,0,0,0,0,0,0,0,0,0,30000,0,0,0,58000,28000,30000,30000
047368,南電群益93購01  ,0,0,0,0,0,0,0,0,0,30000,0,0,0,30000,0,30000,30000
046619,可成凱基93購01  ,0,0,0,0,0,0,0,0,0,30000,0,0,0,40000,10000,30000,30000
046675,GIS元大93購06   ,0,0,0,0,0,0,0,0,0,30000,0,0,0,30000,0,30000,30000
048155,瑞昱兆豐93購01  ,0,0,0,0,0,0,0,0,0,30000,0,0,0,50000,20000,30000,30000
048357,漢唐永豐93購04  ,0,0,0,0,0,0,0,0,0,30000,0,0,0,30000,0,30000,30000
051853,京元電亞東95購01,0,0,0,0,0,0,0,0,0,30000,0,0,0,30000,0,30000,30000
047296,日月光元富96購01,0,0,0,0,0,0,0,0,0,30000,0,0,0,30000,0,30000,30000
048746,台達電元富94購01,0,0,0,0,0,0,0,0,0,30000,0,0,0,30000,0,30000,30000
048678,統一富邦93購01  ,0,0,0,0,0,0,0,0,0,30000,0,0,0,44000,14000,30000,30000
04866P,台積電統一95售02,0,0,0,0,0,0,0,0,0,30000,0,0,0,30000,0,30000,30000
047119,臻鼎元大93購01  ,0,0,0,0,0,0,0,0,0,30000,0,0,0,30000,0,30000,30000
050021,鴻海元大94購10  ,0,0,0,0,0,0,0,0,0,30000,0,0,0,74000,44000,30000,30000
049976,台積電凱基94購28,0,0,0,0,0,0,0,0,0,30000,0,0,0,50000,20000,30000,30000
049014,台達電群益94購02,0,0,0,0,0,0,0,0,0,30000,0,0,0,35000,5000,30000,30000
048909,聯詠富邦94購01  ,0,0,0,0,0,0,0,0,0,30000,0,0,0,30000,0,30000,30000
048917,和鑫台新94購01  ,0,0,0,0,0,0,0,0,0,30000,0,0,0,30000,0,30000,30000
049599,樺漢元大95購01  ,0,0,0,0,0,0,0,0,0,30000,0,0,0,30000,0,30000,30000
049642,鴻海凱基94購16  ,0,0,0,0,0,0,0,0,0,30000,0,0,0,30000,0,30000,30000
049562,和大統一94購01  ,0,0,0,0,0,0,0,0,0,30000,0,0,0,30000,0,30000,30000
049527,國巨中信95購01  ,0,0,0,0,0,0,0,0,0,30000,0,0,0,30000,0,30000,30000
051086,鴻海元大96購04  ,0,0,0,0,0,0,0,0,0,30000,0,0,0,571000,541000,30000,30000
049897,華新科統一94購07,0,0,0,0,0,0,0,0,0,30000,0,0,0,46000,16000,30000,30000
052370,滬深2X元大95購04,0,0,0,0,0,0,0,0,0,30000,0,0,0,30000,0,30000,30000
052171,台積電元大95購21,0,0,0,0,0,0,0,0,0,30000,0,0,0,443000,413000,30000,30000
052500,元翎永豐95購01  ,0,0,0,0,0,0,0,0,0,30000,0,0,0,30000,0,30000,30000
052405,聯茂凱基95購01  ,0,0,0,0,0,0,0,0,0,30000,0,0,0,30000,0,30000,30000
052626,上証2X中信9A購01,0,0,0,0,0,0,0,0,0,30000,0,0,0,30000,0,30000,30000
050180,華新科元大95購08,0,0,0,0,0,0,0,0,0,30000,0,0,0,30000,0,30000,30000
050316,上証2X國票98購01,0,0,0,0,0,0,0,0,0,30000,0,0,0,30000,0,30000,30000
05032P,台積電國泰96售05,0,0,0,0,0,0,0,0,0,30000,0,0,0,61000,31000,30000,30000
050775,TPK元大96購01   ,0,0,0,0,0,0,0,0,0,30000,0,0,0,30000,0,30000,30000
051738,全新國票96購02  ,0,0,0,0,0,0,0,0,0,30000,0,0,0,30000,0,30000,30000
050423,鴻海凱基96購02  ,0,0,0,0,0,0,0,0,0,30000,0,0,0,98000,68000,30000,30000
050108,鴻海元大94購13  ,0,0,0,0,0,0,0,0,0,30000,0,0,0,64000,34000,30000,30000
050051,智原群益94購01  ,0,0,0,0,0,0,0,0,0,30000,0,0,0,30000,0,30000,30000
05006P,華通元富95售01  ,0,0,0,0,0,0,0,0,0,30000,0,0,0,40000,10000,30000,30000
051632,全新國票96購01  ,0,0,0,0,0,0,0,0,0,30000,0,0,0,30000,0,30000,30000
053423,亞光永豐96購01  ,0,0,0,0,0,0,0,0,0,30000,0,0,0,75000,45000,30000,30000
053786,新日興元大96購02,0,0,0,0,0,0,0,0,0,30000,0,0,0,30000,0,30000,30000
053857,宏達電富邦97購02,0,0,0,0,0,0,0,0,0,30000,0,0,0,31000,1000,30000,30000
053206,聯發科麥證96購02,0,0,0,30000,0,30000,0,0,0,30000,0,0,0,30000,0,30000,30000
053264,南亞科群益96購01,0,0,0,0,0,0,0,0,0,30000,0,0,0,177000,147000,30000,30000
05296P,牧德凱基96售01  ,0,0,0,0,0,0,0,0,0,30000,0,0,0,30000,0,30000,30000
052960,中環凱基96購01  ,0,0,0,0,0,0,0,0,0,30000,0,0,0,30000,0,30000,30000
052278,國巨凱基95購06  ,0,0,0,0,0,0,0,0,0,30000,0,0,0,30000,0,30000,30000
05273P,國巨群益95售02  ,0,0,0,0,0,0,0,0,0,30000,0,0,0,30000,0,30000,30000
052717,正文凱基96購01  ,0,0,0,0,0,0,0,0,0,30000,0,0,0,50000,20000,30000,30000
055092,開發金群益9B購01,0,0,0,0,0,0,0,0,0,30000,0,0,0,30000,0,30000,30000
055299,康友元大97購02  ,0,0,0,0,0,0,0,0,0,30000,0,0,0,62000,32000,30000,30000
054031,中鋼中信98購01  ,0,0,0,0,0,0,0,0,0,30000,0,0,0,30000,0,30000,30000
054331,世芯永豐96購03  ,0,0,0,0,0,0,0,0,0,30000,0,0,0,103000,73000,30000,30000
054274,智易中信96購02  ,0,0,0,0,0,0,0,0,0,30000,0,0,0,30000,0,30000,30000
054480,和碩中信98購01  ,0,0,0,0,0,0,0,0,0,30000,0,0,0,30000,0,30000,30000
05445P,聯詠元大95售05  ,0,0,0,0,0,0,0,0,0,30000,0,0,0,37000,7000,30000,30000
054582,致新元大97購01  ,0,0,0,0,0,0,0,0,0,30000,0,0,0,30000,0,30000,30000
054565,玉晶光群益99購02,0,0,0,0,0,0,0,0,0,30000,0,0,0,42000,12000,30000,30000
3669,圓展            ,8000,3000,5000,0,0,0,25000,0,25000,0,0,0,0,0,0,0,30000
06380P,臺股指統一98售02,0,0,0,0,0,0,0,0,0,30000,0,0,0,30000,0,30000,30000
06449P,台積電元大98售09,0,0,0,0,0,0,0,0,0,30000,0,0,0,60000,30000,30000,30000
06211P,鴻海元大98售04  ,0,0,0,0,0,0,0,0,0,30000,0,0,0,55000,25000,30000,30000
055478,訊芯凱基97購01  ,0,0,0,0,0,0,0,0,0,29000,0,0,0,280000,251000,29000,29000
055419,國巨永豐97購03  ,0,0,0,0,0,0,0,0,0,29000,0,0,0,29000,0,29000,29000
055427,技嘉群益98購01  ,0,0,0,0,0,0,0,0,0,29000,0,0,0,56000,27000,29000,29000
055339,緯穎兆豐98購01  ,0,0,0,0,0,0,0,0,0,29000,0,0,0,33000,4000,29000,29000
056705,超眾國泰99購01  ,0,0,0,0,0,0,0,0,0,29000,0,0,0,29000,0,29000,29000
056871,新日興日盛99購01,0,0,0,0,0,0,0,0,0,29000,0,0,0,51000,22000,29000,29000
057016,中石化凱基9B購01,0,0,0,0,0,0,0,0,0,29000,0,0,0,29000,0,29000,29000
057148,玉晶光國票99購04,0,0,0,0,0,0,0,0,0,29000,0,0,0,29000,0,29000,29000
05768P,台積電凱基96售15,0,0,0,0,0,0,0,0,0,29000,0,0,0,29000,0,29000,29000
051788,奇力新國票97購02,0,0,0,0,0,0,0,0,0,29000,0,0,0,38000,9000,29000,29000
047761,亞德客元大93購02,0,0,0,0,0,0,0,0,0,29000,0,0,0,32000,3000,29000,29000
04230P,臺股指中信95售06,0,0,0,0,0,0,0,0,0,29000,0,0,0,127000,98000,29000,29000
051245,南亞科元大95購01,0,0,0,0,0,0,0,0,0,29000,0,0,0,31000,2000,29000,29000
049517,台光電國票94購02,0,0,0,0,0,0,0,0,0,29000,0,0,0,29000,0,29000,29000
052602,聯電元大97購01  ,0,0,0,0,0,0,0,0,0,29000,0,0,0,35000,6000,29000,29000
050983,新光金國泰97購01,0,0,0,0,0,0,0,0,0,29000,0,0,0,30000,1000,29000,29000
054450,聯茂第一96購01  ,0,0,0,0,0,0,0,0,0,29000,0,0,0,29000,0,29000,29000
054326,宏達電台新97購02,0,0,0,0,0,0,0,0,0,29000,0,0,0,67000,38000,29000,29000
054262,瀚宇博元大96購03,0,0,0,0,0,0,0,0,0,29000,0,0,0,95000,66000,29000,29000
053994,微星群益96購01  ,0,0,0,0,0,0,0,0,0,29000,0,0,0,62000,33000,29000,29000
053356,聯發科統一96購07,0,0,0,0,0,0,0,0,0,29000,0,0,0,41000,12000,29000,29000
06216P,上銀元富97售03  ,0,0,0,0,0,0,0,0,0,29000,0,0,0,48000,19000,29000,29000
1218,泰山            ,44000,16000,28000,0,0,0,0,0,0,1000,1000,0,1000,0,0,0,29000
6192,巨路            ,61000,32000,29000,0,0,0,0,0,0,0,0,0,0,0,0,0,29000
6177,達麗            ,41000,12000,29000,0,0,0,0,0,0,0,0,0,0,0,0,0,29000
3029,零壹            ,57000,29000,28000,0,0,0,0,0,0,1000,1000,0,1000,0,0,0,29000
05916P,聯發科元大96售20,0,0,0,0,0,0,0,0,0,28000,0,0,0,52000,24000,28000,28000
05874P,台積電群益96售10,0,0,0,0,0,0,0,0,0,28000,0,0,0,386000,358000,28000,28000
057165,國巨元大99購05  ,0,0,0,0,0,0,0,0,0,28000,0,0,0,153000,125000,28000,28000
056893,智邦元大98購02  ,0,0,0,0,0,0,0,0,0,28000,0,0,0,165000,137000,28000,28000
056647,晶技凱基98購02  ,0,0,0,0,0,0,0,0,0,28000,0,0,0,47000,19000,28000,28000
055449,超眾統一9A購01  ,0,0,0,0,0,0,0,0,0,28000,0,0,0,28000,0,28000,28000
055803,鎧勝永豐97購01  ,0,0,0,0,0,0,0,0,0,28000,0,0,0,28000,0,28000,28000
055660,台光電兆豐97購01,0,0,0,0,0,0,0,0,0,28000,0,0,0,50000,22000,28000,28000
056440,智邦凱基98購03  ,0,0,0,0,0,0,0,0,0,28000,0,0,0,47000,19000,28000,28000
056467,上証2X元大98購02,0,0,0,0,0,0,0,0,0,28000,0,0,0,35000,7000,28000,28000
056504,國巨永豐98購02  ,0,0,0,0,0,0,0,0,0,28000,0,0,0,31000,3000,28000,28000
03416B,臺股指凱基95熊05,0,0,0,0,0,0,0,0,0,28000,0,0,0,48000,20000,28000,28000
03891P,晶技國泰94售02  ,0,0,0,0,0,0,0,0,0,28000,0,0,0,28000,0,28000,28000
046269,禾伸堂凱基92購03,0,0,0,0,0,0,0,0,0,28000,0,0,0,30000,2000,28000,28000
045663,元油2X元富94購01,0,0,0,0,0,0,0,0,0,28000,0,0,0,28000,0,28000,28000
045308,泰鼎元大93購02  ,0,0,0,0,0,0,0,0,0,28000,0,0,0,31000,3000,28000,28000
047494,華邦電元富96購01,0,0,0,0,0,0,0,0,0,28000,0,0,0,28000,0,28000,28000
048864,昇陽半群益94購01,0,0,0,0,0,0,0,0,0,28000,0,0,0,64000,36000,28000,28000
050157,臻鼎群益94購02  ,0,0,0,0,0,0,0,0,0,28000,0,0,0,50000,22000,28000,28000
05114P,臺股指元富95售02,0,0,0,0,0,0,0,0,0,28000,0,0,0,28000,0,28000,28000
051766,泰鼎元大95購02  ,0,0,0,0,0,0,0,0,0,28000,0,0,0,30000,2000,28000,28000
051941,樺漢群益95購02  ,0,0,0,0,0,0,0,0,0,28000,0,0,0,115000,87000,28000,28000
053428,中磊永豐96購02  ,0,0,0,0,0,0,0,0,0,28000,0,0,0,63000,35000,28000,28000
053616,奇力新群益97購01,0,0,0,0,0,0,0,0,0,28000,0,0,0,183000,155000,28000,28000
053876,可成永昌98購01  ,0,0,0,0,0,0,0,0,0,28000,0,0,0,364000,336000,28000,28000
053880,智邦中信96購01  ,0,0,0,0,0,0,0,0,0,28000,0,0,0,38000,10000,28000,28000
053223,台郡凱基96購02  ,0,0,0,0,0,0,0,0,0,28000,0,0,0,28000,0,28000,28000
053215,禾伸堂凱基96購01,0,0,0,0,0,0,0,0,0,28000,0,0,0,92000,64000,28000,28000
054255,亞光元大96購05  ,0,0,0,0,0,0,0,0,0,28000,0,0,0,109000,81000,28000,28000
054613,大立光永豐97購02,0,0,0,0,0,0,0,0,0,28000,0,0,0,38000,10000,28000,28000
054628,可成凱基98購01  ,0,0,0,0,0,0,0,0,0,28000,0,0,0,102000,74000,28000,28000
05501P,健策國票97售01  ,0,0,0,0,0,0,0,0,0,28000,0,0,0,350000,322000,28000,28000
05491P,茂林元大95售04  ,0,0,0,0,0,0,0,0,0,28000,0,0,0,282000,254000,28000,28000
2393,億光            ,421000,522000,-101000,0,0,0,0,0,0,129000,165000,10000,155000,24000,50000,-26000,28000
056513,臻鼎亞東99購01  ,0,0,0,0,0,0,0,0,0,27000,0,0,0,85000,58000,27000,27000
056345,嘉聯益凱基99購01,0,0,0,0,0,0,0,0,0,27000,0,0,0,27000,0,27000,27000
056102,億光永豐97購02  ,0,0,0,0,0,0,0,0,0,27000,0,0,0,58000,31000,27000,27000
055956,瑞昱元大97購05  ,0,0,0,0,0,0,0,0,0,27000,0,0,0,56000,29000,27000,27000
056071,創意元大97購02  ,0,0,0,0,0,0,0,0,0,27000,0,0,0,172000,145000,27000,27000
056771,嘉晶元大99購01  ,0,0,0,0,0,0,0,0,0,27000,0,0,0,173000,146000,27000,27000
056861,美律群益99購01  ,0,0,0,0,0,0,0,0,0,27000,0,0,0,119000,92000,27000,27000
056933,國巨元富98購03  ,0,0,0,0,0,0,0,0,0,27000,0,0,0,99000,72000,27000,27000
057150,貿聯國票99購02  ,0,0,0,0,0,0,0,0,0,27000,0,0,0,27000,0,27000,27000
057075,嘉聯益永豐98購01,0,0,0,0,0,0,0,0,0,27000,0,0,0,47000,20000,27000,27000
05799P,臺股指群益96售13,0,0,0,0,0,0,0,0,0,27000,0,0,0,30000,3000,27000,27000
05743P,創意元大96售01  ,0,0,0,0,0,0,0,0,0,27000,0,0,0,92000,65000,27000,27000
051485,玉晶光凱基97購02,0,0,0,0,0,0,0,0,0,27000,0,0,0,119000,92000,27000,27000
048569,台虹元大93購03  ,0,0,0,0,0,0,0,0,0,27000,0,0,0,134000,107000,27000,27000
020008,元大特股高息N   ,0,0,0,0,0,0,0,0,0,27000,0,0,0,48000,21000,27000,27000
050587,緯穎國票94購02  ,0,0,0,0,0,0,0,0,0,27000,0,0,0,36000,9000,27000,27000
051575,國巨元大96購03  ,0,0,0,0,0,0,0,0,0,27000,0,0,0,140000,113000,27000,27000
05029P,鴻海元富95售04  ,0,0,0,0,0,0,0,0,0,27000,0,0,0,27000,0,27000,27000
048855,華新科群益94購02,0,0,0,0,0,0,0,0,0,27000,0,0,0,87000,60000,27000,27000
05086P,鴻海凱基95售13  ,0,0,0,0,0,0,0,0,0,27000,0,0,0,27000,0,27000,27000
053009,大成鋼統一96購02,0,0,0,0,0,0,0,0,0,27000,0,0,0,135000,108000,27000,27000
055021,亞德客國泰98購01,0,0,0,0,0,0,0,0,0,27000,0,0,0,27000,0,27000,27000
055059,健和興永豐97購01,0,0,0,0,0,0,0,0,0,27000,0,0,0,27000,0,27000,27000
055200,和大群益98購01  ,0,0,0,0,0,0,0,0,0,27000,0,0,0,84000,57000,27000,27000
054215,創意國票97購02  ,0,0,0,0,0,0,0,0,0,27000,0,0,0,27000,0,27000,27000
052319,可成元大95購12  ,0,0,0,0,0,0,0,0,0,27000,0,0,0,240000,213000,27000,27000
053133,華邦電國票97購01,0,0,0,0,0,0,0,0,0,27000,0,0,0,31000,4000,27000,27000
053871,臻鼎元大96購03  ,0,0,0,0,0,0,0,0,0,27000,0,0,0,39000,12000,27000,27000
053687,智邦元大96購02  ,0,0,0,0,0,0,0,0,0,27000,0,0,0,201000,174000,27000,27000
053585,友達元大9C購03  ,0,0,0,0,0,0,0,0,0,27000,0,0,0,66000,39000,27000,27000
053484,國巨國票97購03  ,0,0,0,0,0,0,0,0,0,27000,0,0,0,30000,3000,27000,27000
053427,鎧勝永豐96購02  ,0,0,0,0,0,0,0,0,0,27000,0,0,0,40000,13000,27000,27000
2365,昆盈            ,12000,9000,3000,0,0,0,0,0,0,24000,24000,0,24000,0,0,0,27000
5906,台南-KY         ,33000,6000,27000,0,0,0,0,0,0,0,0,0,0,0,0,0,27000
4540,全球傳動        ,46000,19000,27000,0,0,0,0,0,0,0,0,0,0,0,0,0,27000
1455,集盛            ,46000,19000,27000,0,0,0,0,0,0,0,0,0,0,0,0,0,27000
06194P,台積電元富97售05,0,0,0,0,0,0,0,0,0,27000,0,0,0,536000,509000,27000,27000
05797P,臺股指群益96售11,0,0,0,0,0,0,0,0,0,26000,0,0,0,61000,35000,26000,26000
05769P,台積電凱基96售16,0,0,0,0,0,0,0,0,0,26000,0,0,0,58000,32000,26000,26000
05888P,友達元大97售01  ,0,0,0,0,0,0,0,0,0,26000,0,0,0,26000,0,26000,26000
055584,國巨元大97購11  ,0,0,0,0,0,0,0,0,0,26000,0,0,0,26000,0,26000,26000
00865B,國泰US短期公債  ,0,0,0,0,0,0,0,0,0,26000,11000,0,11000,15000,0,15000,26000
044466,和大群益93購01  ,0,0,0,0,0,0,0,0,0,26000,0,0,0,75000,49000,26000,26000
044514,亞光凱基93購02  ,0,0,0,0,0,0,0,0,0,26000,0,0,0,26000,0,26000,26000
051832,復盛元大95購01  ,0,0,0,0,0,0,0,0,0,26000,0,0,0,28000,2000,26000,26000
046770,聯發科國泰94購01,0,0,0,0,0,0,0,0,0,26000,0,0,0,116000,90000,26000,26000
052629,訊芯中信99購01  ,0,0,0,0,0,0,0,0,0,26000,0,0,0,48000,22000,26000,26000
05258P,臺股指凱基96售11,0,0,0,0,0,0,0,0,0,26000,0,0,0,26000,0,26000,26000
052331,漢唐亞東97購01  ,0,0,0,0,0,0,0,0,0,26000,0,0,0,36000,10000,26000,26000
050725,光磊國票96購01  ,0,0,0,0,0,0,0,0,0,26000,0,0,0,26000,0,26000,26000
049417,奇力新凱基94購02,0,0,0,0,0,0,0,0,0,26000,0,0,0,26000,0,26000,26000
053410,啟碁兆豐96購01  ,0,0,0,0,0,0,0,0,0,26000,0,0,0,41000,15000,26000,26000
053921,嘉晶國票97購03  ,0,0,0,0,0,0,0,0,0,26000,0,0,0,86000,60000,26000,26000
052707,景碩台新96購01  ,0,0,0,0,0,0,0,0,0,26000,0,0,0,52000,26000,26000,26000
054337,智邦統一96購01  ,0,0,0,0,0,0,0,0,0,26000,0,0,0,36000,10000,26000,26000
054066,緯穎國票97購03  ,0,0,0,0,0,0,0,0,0,26000,0,0,0,28000,2000,26000,26000
054096,佳世達國票97購01,0,0,0,0,0,0,0,0,0,26000,0,0,0,26000,0,26000,26000
054080,微星中信98購01  ,0,0,0,0,0,0,0,0,0,26000,0,0,0,156000,130000,26000,26000
054171,台郡凱基97購01  ,0,0,0,0,0,0,0,0,0,26000,0,0,0,26000,0,26000,26000
054159,T50正2凱基99購01,0,0,0,0,0,0,0,0,0,26000,0,0,0,111000,85000,26000,26000
054553,宏達電凱基99購01,0,0,0,0,0,0,0,0,0,26000,0,0,0,66000,40000,26000,26000
055142,健策永豐98購01  ,0,0,0,0,0,0,0,0,0,26000,0,0,0,565000,539000,26000,26000
054914,億光凱基98購01  ,0,0,0,0,0,0,0,0,0,26000,0,0,0,39000,13000,26000,26000
054941,凱美元大97購01  ,0,0,0,0,0,0,0,0,0,26000,0,0,0,54000,28000,26000,26000
5305,敦南            ,37000,12000,25000,0,0,0,0,0,0,1000,1000,0,1000,0,0,0,26000
6409,旭隼            ,64000,38000,26000,0,0,0,0,0,0,0,1000,1000,0,0,0,0,26000
055563,智易凱基97購02  ,0,0,0,0,0,0,0,0,0,25000,0,0,0,25000,0,25000,25000
055664,和大群益98購02  ,0,0,0,0,0,0,0,0,0,25000,0,0,0,115000,90000,25000,25000
056073,智伸科元大97購01,0,0,0,0,0,0,0,0,0,25000,0,0,0,25000,0,25000,25000
055999,電子類富邦99購01,0,0,0,0,0,0,0,0,0,25000,0,0,0,30000,5000,25000,25000
05794P,華邦電群益96售04,0,0,0,0,0,0,0,0,0,25000,0,0,0,25000,0,25000,25000
057265,聯詠兆豐98購01  ,0,0,0,0,0,0,0,0,0,25000,0,0,0,157000,132000,25000,25000
057175,美律元大98購03  ,0,0,0,0,0,0,0,0,0,25000,0,0,0,25000,0,25000,25000
056798,華新科麥證98購01,0,0,0,25000,0,25000,0,0,0,25000,0,0,0,25000,0,25000,25000
046905,新光金凱基99購01,0,0,0,0,0,0,0,0,0,25000,0,0,0,25000,0,25000,25000
048380,T50反1國票94購02,0,0,0,0,0,0,0,0,0,25000,0,0,0,25000,0,25000,25000
047524,瑞昱元大93購10  ,0,0,0,0,0,0,0,0,0,25000,0,0,0,25000,0,25000,25000
047704,智邦凱基93購06  ,0,0,0,0,0,0,0,0,0,25000,0,0,0,25000,0,25000,25000
051831,緯穎元大96購04  ,0,0,0,0,0,0,0,0,0,25000,0,0,0,25000,0,25000,25000
051848,元金2X中信98購02,0,0,0,0,0,0,0,0,0,25000,0,0,0,40000,15000,25000,25000
04711P,台光電元大94售05,0,0,0,0,0,0,0,0,0,25000,0,0,0,25000,0,25000,25000
047147,嘉晶群益93購02  ,0,0,0,0,0,0,0,0,0,25000,0,0,0,25000,0,25000,25000
047163,義隆台新93購01  ,0,0,0,0,0,0,0,0,0,25000,0,0,0,25000,0,25000,25000
048645,創意元大94購02  ,0,0,0,0,0,0,0,0,0,25000,0,0,0,25000,0,25000,25000
045892,和鑫元大93購03  ,0,0,0,0,0,0,0,0,0,25000,0,0,0,25000,0,25000,25000
045768,大立光元富95購02,0,0,0,0,0,0,0,0,0,25000,0,0,0,33000,8000,25000,25000
04213P,台光電凱基93售11,0,0,0,0,0,0,0,0,0,25000,0,0,0,25000,0,25000,25000
04343P,啟碁永豐93售02  ,0,0,0,0,0,0,0,0,0,25000,0,0,0,25000,0,25000,25000
046064,中工凱基94購01  ,0,0,0,0,0,0,0,0,0,25000,0,0,0,50000,25000,25000,25000
050601,台表科國泰96購01,0,0,0,0,0,0,0,0,0,25000,0,0,0,40000,15000,25000,25000
050593,台表科永豐94購03,0,0,0,0,0,0,0,0,0,25000,0,0,0,50000,25000,25000,25000
049706,世紀鋼元大95購02,0,0,0,0,0,0,0,0,0,25000,0,0,0,75000,50000,25000,25000
051650,矽力永豐95購01  ,0,0,0,0,0,0,0,0,0,25000,0,0,0,40000,15000,25000,25000
050657,宏達電麥證94購01,0,0,0,35000,10000,25000,0,0,0,25000,0,0,0,35000,10000,25000,25000
051158,嘉晶富邦96購01  ,0,0,0,0,0,0,0,0,0,25000,0,0,0,51000,26000,25000,25000
052508,矽力日盛95購02  ,0,0,0,0,0,0,0,0,0,25000,0,0,0,25000,0,25000,25000
051083,A50正2元大98購01,0,0,0,0,0,0,0,0,0,25000,0,0,0,45000,20000,25000,25000
049122,元油2X元富94購07,0,0,0,0,0,0,0,0,0,25000,0,0,0,25000,0,25000,25000
04912P,可成元富94售06  ,0,0,0,0,0,0,0,0,0,25000,0,0,0,25000,0,25000,25000
050915,健策中信98購01  ,0,0,0,0,0,0,0,0,0,25000,0,0,0,36000,11000,25000,25000
05099P,台積電凱基95售06,0,0,0,0,0,0,0,0,0,25000,0,0,0,25000,0,25000,25000
054988,凱美元富97購02  ,0,0,0,0,0,0,0,0,0,25000,0,0,0,35000,10000,25000,25000
054821,貿聯元大9A購01  ,0,0,0,0,0,0,0,0,0,25000,0,0,0,65000,40000,25000,25000
054696,嘉聯益永豐97購01,0,0,0,0,0,0,0,0,0,25000,0,0,0,25000,0,25000,25000
054492,嘉聯益台新96購01,0,0,0,0,0,0,0,0,0,25000,0,0,0,25000,0,25000,25000
054310,牧德凱基98購01  ,0,0,0,0,0,0,0,0,0,25000,0,0,0,110000,85000,25000,25000
052795,健策兆豐97購01  ,0,0,0,0,0,0,0,0,0,25000,0,0,0,25000,0,25000,25000
052915,創意元富96購01  ,0,0,0,0,0,0,0,0,0,25000,0,0,0,35000,10000,25000,25000
053174,同欣電群益98購02,0,0,0,0,0,0,0,0,0,25000,0,0,0,49000,24000,25000,25000
053249,致伸國票97購02  ,0,0,0,0,0,0,0,0,0,25000,0,0,0,25000,0,25000,25000
053279,景碩元大97購01  ,0,0,0,0,0,0,0,0,0,25000,0,0,0,27000,2000,25000,25000
053355,超眾兆豐97購01  ,0,0,0,0,0,0,0,0,0,25000,0,0,0,25000,0,25000,25000
053490,為升兆豐97購01  ,0,0,0,0,0,0,0,0,0,25000,0,0,0,30000,5000,25000,25000
053529,國巨麥證96購01  ,0,0,0,25000,0,25000,0,0,0,25000,0,0,0,25000,0,25000,25000
05356P,臺股指元富95售10,0,0,0,0,0,0,0,0,0,25000,0,0,0,30000,5000,25000,25000
2929,淘帝-KY         ,166000,142000,24000,0,0,0,0,0,0,1000,0,0,0,1000,0,1000,25000
2727,王品            ,46000,21000,25000,0,0,0,0,0,0,0,0,0,0,0,0,0,25000
06245P,健策元富97售03  ,0,0,0,0,0,0,0,0,0,25000,0,0,0,360000,335000,25000,25000
06367P,台積電凱基97售14,0,0,0,0,0,0,0,0,0,25000,0,0,0,160000,135000,25000,25000
06368P,台積電凱基97售15,0,0,0,0,0,0,0,0,0,25000,0,0,0,75000,50000,25000,25000
06356P,啟碁永豐97售01  ,0,0,0,0,0,0,0,0,0,25000,0,0,0,25000,0,25000,25000
06353P,電子類富邦99售02,0,0,0,0,0,0,0,0,0,25000,0,0,0,25000,0,25000,25000
1417,嘉裕            ,90000,65000,25000,0,0,0,0,0,0,0,0,0,0,0,0,0,25000
057070,美律永豐98購02  ,0,0,0,0,0,0,0,0,0,24000,0,0,0,24000,0,24000,24000
057053,立積元大98購02  ,0,0,0,0,0,0,0,0,0,24000,0,0,0,24000,0,24000,24000
056946,國巨統一98購05  ,0,0,0,0,0,0,0,0,0,24000,0,0,0,31000,7000,24000,24000
057009,信邦中信99購01  ,0,0,0,0,0,0,0,0,0,24000,0,0,0,124000,100000,24000,24000
05942P,奇力新凱基96售04,0,0,0,0,0,0,0,0,0,24000,0,0,0,30000,6000,24000,24000
05943P,欣興凱基96售03  ,0,0,0,0,0,0,0,0,0,24000,0,0,0,85000,61000,24000,24000
056118,聯詠群益97購03  ,0,0,0,0,0,0,0,0,0,24000,0,0,0,45000,21000,24000,24000
056500,大立光富邦9B購02,0,0,0,0,0,0,0,0,0,24000,0,0,0,44000,20000,24000,24000
055530,聯發科群益98購01,0,0,0,0,0,0,0,0,0,24000,0,0,0,54000,30000,24000,24000
04187P,麗豐元富93售02  ,0,0,0,0,0,0,0,0,0,24000,0,0,0,24000,0,24000,24000
045630,技嘉凱基93購02  ,0,0,0,0,0,0,0,0,0,24000,0,0,0,40000,16000,24000,24000
047880,聯發科國泰94購03,0,0,0,0,0,0,0,0,0,24000,0,0,0,24000,0,24000,24000
046577,東元元大92購02  ,0,0,0,0,0,0,0,0,0,24000,0,0,0,24000,0,24000,24000
047160,台郡國票94購01  ,0,0,0,0,0,0,0,0,0,24000,0,0,0,24000,0,24000,24000
048576,義隆國泰95購01  ,0,0,0,0,0,0,0,0,0,24000,0,0,0,25000,1000,24000,24000
047722,南電凱基94購02  ,0,0,0,0,0,0,0,0,0,24000,0,0,0,25000,1000,24000,24000
048837,牧德凱基94購04  ,0,0,0,0,0,0,0,0,0,24000,0,0,0,84000,60000,24000,24000
04954P,健策國票96售01  ,0,0,0,0,0,0,0,0,0,24000,0,0,0,24000,0,24000,24000
053055,聯詠國票97購01  ,0,0,0,0,0,0,0,0,0,24000,0,0,0,24000,0,24000,24000
050655,中磊凱基96購01  ,0,0,0,0,0,0,0,0,0,24000,0,0,0,24000,0,24000,24000
051493,台郡凱基95購02  ,0,0,0,0,0,0,0,0,0,24000,0,0,0,24000,0,24000,24000
051522,玉晶光凱基95購05,0,0,0,0,0,0,0,0,0,24000,0,0,0,52000,28000,24000,24000
053396,漢唐中信9A購01  ,0,0,0,0,0,0,0,0,0,24000,0,0,0,24000,0,24000,24000
053984,康友元大96購05  ,0,0,0,0,0,0,0,0,0,24000,0,0,0,66000,42000,24000,24000
053273,國巨元大96購08  ,0,0,0,0,0,0,0,0,0,24000,0,0,0,44000,20000,24000,24000
05329P,臺股指凱基95售13,0,0,0,0,0,0,0,0,0,24000,0,0,0,24000,0,24000,24000
053243,楠梓電國票97購02,0,0,0,0,0,0,0,0,0,24000,0,0,0,90000,66000,24000,24000
053093,緯穎元大96購06  ,0,0,0,0,0,0,0,0,0,24000,0,0,0,502000,478000,24000,24000
05437P,聯詠永豐95售02  ,0,0,0,0,0,0,0,0,0,24000,0,0,0,46000,22000,24000,24000
054590,嘉聯益國泰98購01,0,0,0,0,0,0,0,0,0,24000,0,0,0,105000,81000,24000,24000
054812,鴻海元大97購08  ,0,0,0,0,0,0,0,0,0,24000,0,0,0,456000,432000,24000,24000
054906,神達康和97購01  ,0,0,0,0,0,0,0,0,0,24000,0,0,0,422000,398000,24000,24000
054897,信錦康和97購01  ,0,0,0,0,0,0,0,0,0,24000,0,0,0,34000,10000,24000,24000
2399,映泰            ,41000,19000,22000,0,0,0,0,0,0,2000,2000,0,2000,0,0,0,24000
910861,神州-DR         ,24000,0,24000,0,0,0,0,0,0,0,0,0,0,0,0,0,24000
055839,瑞昱元大97購04  ,0,0,0,0,0,0,0,0,0,23000,0,0,0,25000,2000,23000,23000
055990,矽創元富97購01  ,0,0,0,0,0,0,0,0,0,23000,0,0,0,30000,7000,23000,23000
06046P,健策統一96售03  ,0,0,0,0,0,0,0,0,0,23000,0,0,0,417000,394000,23000,23000
06117P,臺股指日盛97售02,0,0,0,0,0,0,0,0,0,23000,0,0,0,23000,0,23000,23000
05750P,臺股指群益99售04,0,0,0,0,0,0,0,0,0,23000,0,0,0,24000,1000,23000,23000
048390,國巨國票94購02  ,0,0,0,0,0,0,0,0,0,23000,0,0,0,23000,0,23000,23000
049258,美律元大94購03  ,0,0,0,0,0,0,0,0,0,23000,0,0,0,108000,85000,23000,23000
04380P,欣興元大94售02  ,0,0,0,0,0,0,0,0,0,23000,0,0,0,48000,25000,23000,23000
05197P,智原永豐95售02  ,0,0,0,0,0,0,0,0,0,23000,0,0,0,37000,14000,23000,23000
050223,聯茂元富94購02  ,0,0,0,0,0,0,0,0,0,23000,0,0,0,23000,0,23000,23000
049434,茂林國票95購01  ,0,0,0,0,0,0,0,0,0,23000,0,0,0,23000,0,23000,23000
049156,緯穎元大96購01  ,0,0,0,0,0,0,0,0,0,23000,0,0,0,31000,8000,23000,23000
052195,健策元富95購01  ,0,0,0,0,0,0,0,0,0,23000,0,0,0,38000,15000,23000,23000
050857,義隆台新95購01  ,0,0,0,0,0,0,0,0,0,23000,0,0,0,23000,0,23000,23000
055196,致新元富97購01  ,0,0,0,0,0,0,0,0,0,23000,0,0,0,40000,17000,23000,23000
052855,群創日盛99購01  ,0,0,0,0,0,0,0,0,0,23000,0,0,0,430000,407000,23000,23000
053779,台光電元大96購02,0,0,0,0,0,0,0,0,0,23000,0,0,0,52000,29000,23000,23000
053595,創意元大96購02  ,0,0,0,0,0,0,0,0,0,23000,0,0,0,109000,86000,23000,23000
2832,台產            ,31000,9000,22000,0,0,0,0,0,0,1000,1000,0,1000,0,0,0,23000
2020,美亞            ,23000,0,23000,0,0,0,0,0,0,0,0,0,0,0,0,0,23000
057260,微星兆豐98購01  ,0,0,0,0,0,0,0,0,0,22000,0,0,0,84000,62000,22000,22000
06036P,台表科凱基96售04,0,0,0,0,0,0,0,0,0,22000,0,0,0,22000,0,22000,22000
06100P,台積電日盛97售03,0,0,0,0,0,0,0,0,0,22000,0,0,0,927000,905000,22000,22000
06093P,華通元富97售03  ,0,0,0,0,0,0,0,0,0,22000,0,0,0,22000,0,22000,22000
05843P,台積電元大96售16,0,0,0,0,0,0,0,0,0,22000,0,0,0,272000,250000,22000,22000
056891,國巨元大99購03  ,0,0,0,0,0,0,0,0,0,22000,0,0,0,66000,44000,22000,22000
056855,祥碩中信98購02  ,0,0,0,0,0,0,0,0,0,22000,0,0,0,63000,41000,22000,22000
056697,緯穎群益98購01  ,0,0,0,0,0,0,0,0,0,22000,0,0,0,172000,150000,22000,22000
055911,可成凱基98購02  ,0,0,0,0,0,0,0,0,0,22000,0,0,0,31000,9000,22000,22000
055433,嘉聯益群益99購01,0,0,0,0,0,0,0,0,0,22000,0,0,0,62000,40000,22000,22000
044437,台郡元大92購02  ,0,0,0,0,0,0,0,0,0,22000,0,0,0,22000,0,22000,22000
044950,玉晶光群益94購01,0,0,0,0,0,0,0,0,0,22000,0,0,0,36000,14000,22000,22000
04322P,可成元大94售01  ,0,0,0,0,0,0,0,0,0,22000,0,0,0,79000,57000,22000,22000
042904,金寶元大94購02  ,0,0,0,0,0,0,0,0,0,22000,0,0,0,22000,0,22000,22000
047109,華邦電元大94購01,0,0,0,0,0,0,0,0,0,22000,0,0,0,68000,46000,22000,22000
047370,聯發科國票93購03,0,0,0,0,0,0,0,0,0,22000,0,0,0,22000,0,22000,22000
046730,瀚宇博元大93購02,0,0,0,0,0,0,0,0,0,22000,0,0,0,22000,0,22000,22000
050865,欣興永豐95購01  ,0,0,0,0,0,0,0,0,0,22000,0,0,0,24000,2000,22000,22000
050955,達方群益97購01  ,0,0,0,0,0,0,0,0,0,22000,0,0,0,22000,0,22000,22000
048849,光寶科群益94購01,0,0,0,0,0,0,0,0,0,22000,0,0,0,22000,0,22000,22000
048988,聯茂元大94購02  ,0,0,0,0,0,0,0,0,0,22000,0,0,0,32000,10000,22000,22000
052540,華新科統一95購03,0,0,0,0,0,0,0,0,0,22000,0,0,0,37000,15000,22000,22000
052668,聯發科群益97購01,0,0,0,0,0,0,0,0,0,22000,0,0,0,35000,13000,22000,22000
050203,美律群益94購04  ,0,0,0,0,0,0,0,0,0,22000,0,0,0,22000,0,22000,22000
050649,華新科凱基96購01,0,0,0,0,0,0,0,0,0,22000,0,0,0,52000,30000,22000,22000
051269,康友富邦97購01  ,0,0,0,0,0,0,0,0,0,22000,0,0,0,30000,8000,22000,22000
050946,瑞昱群益95購01  ,0,0,0,0,0,0,0,0,0,22000,0,0,0,24000,2000,22000,22000
051119,光寶科群益95購01,0,0,0,0,0,0,0,0,0,22000,0,0,0,22000,0,22000,22000
050750,上銀統一94購02  ,0,0,0,0,0,0,0,0,0,22000,0,0,0,50000,28000,22000,22000
052051,京鼎凱基95購01  ,0,0,0,0,0,0,0,0,0,22000,0,0,0,66000,44000,22000,22000
053496,義隆兆豐96購02  ,0,0,0,0,0,0,0,0,0,22000,0,0,0,38000,16000,22000,22000
053397,國泰金中信96購01,0,0,0,0,0,0,0,0,0,22000,0,0,0,22000,0,22000,22000
053412,台達電國票97購02,0,0,0,0,0,0,0,0,0,22000,0,0,0,26000,4000,22000,22000
053406,國巨兆豐96購02  ,0,0,0,0,0,0,0,0,0,22000,0,0,0,92000,70000,22000,22000
053742,創意國票97購01  ,0,0,0,0,0,0,0,0,0,22000,0,0,0,37000,15000,22000,22000
05278P,台郡元富95售02  ,0,0,0,0,0,0,0,0,0,22000,0,0,0,32000,10000,22000,22000
052952,矽創國票97購02  ,0,0,0,0,0,0,0,0,0,22000,0,0,0,40000,18000,22000,22000
053278,禾伸堂元大96購01,0,0,0,0,0,0,0,0,0,22000,0,0,0,39000,17000,22000,22000
055234,昇陽半國票98購02,0,0,0,0,0,0,0,0,0,22000,0,0,0,106000,84000,22000,22000
055258,玉晶光統一97購03,0,0,0,0,0,0,0,0,0,22000,0,0,0,52000,30000,22000,22000
055153,台光電元大98購02,0,0,0,0,0,0,0,0,0,22000,0,0,0,55000,33000,22000,22000
05492P,聯茂元大95售02  ,0,0,0,0,0,0,0,0,0,22000,0,0,0,123000,101000,22000,22000
054639,台新金中信99購01,0,0,0,0,0,0,0,0,0,22000,0,0,0,22000,0,22000,22000
05435P,鴻海群益95售12  ,0,0,0,0,0,0,0,0,0,22000,0,0,0,32000,10000,22000,22000
054415,奇力新元大96購06,0,0,0,0,0,0,0,0,0,22000,0,0,0,46000,24000,22000,22000
054392,華通永豐96購05  ,0,0,0,0,0,0,0,0,0,22000,0,0,0,32000,10000,22000,22000
054216,聯茂國票97購03  ,0,0,0,0,0,0,0,0,0,22000,0,0,0,25000,3000,22000,22000
06545P,致茂元大98售01  ,0,0,0,0,0,0,0,0,0,22000,0,0,0,37000,15000,22000,22000
2207,和泰車          ,62000,42000,20000,0,0,0,0,0,0,2000,2000,0,2000,0,0,0,22000
055757,大成鋼群益99購01,0,0,0,0,0,0,0,0,0,21000,0,0,0,21000,0,21000,21000
056268,新日興統一97購01,0,0,0,0,0,0,0,0,0,21000,0,0,0,21000,0,21000,21000
05693P,滬深2X凱基98售02,0,0,0,0,0,0,0,0,0,21000,0,0,0,21000,0,21000,21000
057023,美律凱基99購02  ,0,0,0,0,0,0,0,0,0,21000,0,0,0,21000,0,21000,21000
057092,健策元富98購01  ,0,0,0,0,0,0,0,0,0,21000,0,0,0,43000,22000,21000,21000
05968P,鴻海台新96售02  ,0,0,0,0,0,0,0,0,0,21000,0,0,0,21000,0,21000,21000
04807P,聯茂元富94售01  ,0,0,0,0,0,0,0,0,0,21000,0,0,0,26000,5000,21000,21000
048485,泰鼎國泰94購02  ,0,0,0,0,0,0,0,0,0,21000,0,0,0,21000,0,21000,21000
04857P,美律元富94售01  ,0,0,0,0,0,0,0,0,0,21000,0,0,0,27000,6000,21000,21000
050343,鴻海元富94購01  ,0,0,0,0,0,0,0,0,0,21000,0,0,0,31000,10000,21000,21000
048726,儒鴻麥證95購01  ,0,0,0,51000,30000,21000,0,0,0,21000,0,0,0,51000,30000,21000,21000
046194,禾伸堂凱基92購02,0,0,0,0,0,0,0,0,0,21000,0,0,0,32000,11000,21000,21000
03420B,臺股指元大95熊31,0,0,0,0,0,0,0,0,0,21000,0,0,0,101000,80000,21000,21000
044126,奇力新凱基93購01,0,0,0,0,0,0,0,0,0,21000,0,0,0,21000,0,21000,21000
046432,宏達電中信94購01,0,0,0,0,0,0,0,0,0,21000,0,0,0,21000,0,21000,21000
047871,健策永豐93購02  ,0,0,0,0,0,0,0,0,0,21000,0,0,0,55000,34000,21000,21000
051622,和碩凱基96購01  ,0,0,0,0,0,0,0,0,0,21000,0,0,0,21000,0,21000,21000
051641,矽創國票96購01  ,0,0,0,0,0,0,0,0,0,21000,0,0,0,42000,21000,21000,21000
049126,玉晶光元富94購02,0,0,0,0,0,0,0,0,0,21000,0,0,0,22000,1000,21000,21000
049892,國巨富邦96購01  ,0,0,0,0,0,0,0,0,0,21000,0,0,0,45000,24000,21000,21000
049917,華新科元大94購02,0,0,0,0,0,0,0,0,0,21000,0,0,0,65000,44000,21000,21000
054786,全新群益99購02  ,0,0,0,0,0,0,0,0,0,21000,0,0,0,42000,21000,21000,21000
053510,聯電群益97購01  ,0,0,0,0,0,0,0,0,0,21000,0,0,0,64000,43000,21000,21000
2501,國建            ,60000,39000,21000,0,0,0,0,0,0,0,0,0,0,0,0,0,21000
4906,正文            ,135000,111000,24000,0,0,0,0,0,0,-3000,12000,0,12000,8000,23000,-15000,21000
06558P,旺宏元富98售02  ,0,0,0,0,0,0,0,0,0,21000,0,0,0,21000,0,21000,21000
06203P,奇力新中信98售02,0,0,0,0,0,0,0,0,0,21000,0,0,0,51000,30000,21000,21000
1102,亞泥            ,3137000,2964000,173000,0,0,0,1000,0,1000,-153000,50000,2000,48000,0,201000,-201000,21000
05981P,可成永昌98售02  ,0,0,0,0,0,0,0,0,0,20000,0,0,0,224000,204000,20000,20000
05852P,嘉晶群益96售01  ,0,0,0,0,0,0,0,0,0,20000,0,0,0,20000,0,20000,20000
05876P,聯發科群益96售03,0,0,0,0,0,0,0,0,0,20000,0,0,0,20000,0,20000,20000
06107P,美律群益98售02  ,0,0,0,0,0,0,0,0,0,20000,0,0,0,20000,0,20000,20000
06043P,創意永豐96售06  ,0,0,0,0,0,0,0,0,0,20000,0,0,0,107000,87000,20000,20000
06163P,聯詠群益97售01  ,0,0,0,0,0,0,0,0,0,20000,0,0,0,20000,0,20000,20000
05814P,臺股指國票96售07,0,0,0,0,0,0,0,0,0,20000,0,0,0,20000,0,20000,20000
057097,致新元富98購01  ,0,0,0,0,0,0,0,0,0,20000,0,0,0,20000,0,20000,20000
057153,祥碩國泰99購01  ,0,0,0,0,0,0,0,0,0,20000,0,0,0,97000,77000,20000,20000
057154,易華電國泰99購01,0,0,0,0,0,0,0,0,0,20000,0,0,0,20000,0,20000,20000
056938,泰碩元富98購01  ,0,0,0,0,0,0,0,0,0,20000,0,0,0,20000,0,20000,20000
056929,華新科台新98購01,0,0,0,0,0,0,0,0,0,20000,0,0,0,58000,38000,20000,20000
056673,中石化元富9B購01,0,0,0,0,0,0,0,0,0,20000,0,0,0,20000,0,20000,20000
056654,元油2X元大98購02,0,0,0,0,0,0,0,0,0,20000,0,0,0,20000,0,20000,20000
056634,為升兆豐99購01  ,0,0,0,0,0,0,0,0,0,20000,0,0,0,20000,0,20000,20000
056603,嘉聯益國泰9A購01,0,0,0,0,0,0,0,0,0,20000,0,0,0,20000,0,20000,20000
056257,聯茂元富97購04  ,0,0,0,0,0,0,0,0,0,20000,0,0,0,32000,12000,20000,20000
056372,訊芯元大98購04  ,0,0,0,0,0,0,0,0,0,20000,0,0,0,20000,0,20000,20000
056385,創意國泰99購01  ,0,0,0,0,0,0,0,0,0,20000,0,0,0,20000,0,20000,20000
056342,中工凱基98購01  ,0,0,0,0,0,0,0,0,0,20000,0,0,0,20000,0,20000,20000
05649P,矽創國票97售03  ,0,0,0,0,0,0,0,0,0,20000,0,0,0,20000,0,20000,20000
056441,燿華凱基98購01  ,0,0,0,0,0,0,0,0,0,20000,0,0,0,60000,40000,20000,20000
056016,鴻海群益97購06  ,0,0,0,0,0,0,0,0,0,20000,0,0,0,38000,18000,20000,20000
055732,全新元富9A購01  ,0,0,0,0,0,0,0,0,0,20000,0,0,0,40000,20000,20000,20000
055853,群創元大98購03  ,0,0,0,0,0,0,0,0,0,20000,0,0,0,20000,0,20000,20000
055436,晶豪科中信99購01,0,0,0,0,0,0,0,0,0,20000,0,0,0,30000,10000,20000,20000
055512,聯詠兆豐97購01  ,0,0,0,0,0,0,0,0,0,20000,0,0,0,20000,0,20000,20000
05552P,聯詠群益96售01  ,0,0,0,0,0,0,0,0,0,20000,0,0,0,22000,2000,20000,20000
046315,淘帝元大92購01  ,0,0,0,0,0,0,0,0,0,20000,0,0,0,20000,0,20000,20000
047840,新日興元大93購03,0,0,0,0,0,0,0,0,0,20000,0,0,0,30000,10000,20000,20000
04535P,華新統一94售01  ,0,0,0,0,0,0,0,0,0,20000,0,0,0,20000,0,20000,20000
046417,聯詠元大92購06  ,0,0,0,0,0,0,0,0,0,20000,0,0,0,20000,0,20000,20000
046564,聯詠凱基92購09  ,0,0,0,0,0,0,0,0,0,20000,0,0,0,20000,0,20000,20000
046528,聯詠中信94購01  ,0,0,0,0,0,0,0,0,0,20000,0,0,0,20000,0,20000,20000
046500,技嘉元大92購03  ,0,0,0,0,0,0,0,0,0,20000,0,0,0,120000,100000,20000,20000
047908,南亞科元大93購02,0,0,0,0,0,0,0,0,0,20000,0,0,0,21000,1000,20000,20000
047940,台光電國票93購01,0,0,0,0,0,0,0,0,0,20000,0,0,0,20000,0,20000,20000
046339,訊芯中信92購01  ,0,0,0,0,0,0,0,0,0,20000,0,0,0,20000,0,20000,20000
045814,可成麥證93購01  ,0,0,0,40000,20000,20000,0,0,0,20000,0,0,0,40000,20000,20000,20000
045824,嘉聯益凱基93購02,0,0,0,0,0,0,0,0,0,20000,0,0,0,20000,0,20000,20000
045915,樺漢國票92購01  ,0,0,0,0,0,0,0,0,0,20000,0,0,0,20000,0,20000,20000
045908,矽創中信92購01  ,0,0,0,0,0,0,0,0,0,20000,0,0,0,40000,20000,20000,20000
045968,貿聯凱基92購03  ,0,0,0,0,0,0,0,0,0,20000,0,0,0,20000,0,20000,20000
044909,玉晶光凱基93購02,0,0,0,0,0,0,0,0,0,20000,0,0,0,23000,3000,20000,20000
04476P,玉晶光元大94售05,0,0,0,0,0,0,0,0,0,20000,0,0,0,20000,0,20000,20000
044508,微星凱基92購02  ,0,0,0,0,0,0,0,0,0,20000,0,0,0,20000,0,20000,20000
03372P,台積電元大02售25,0,0,0,0,0,0,0,0,0,20000,0,0,0,40000,20000,20000,20000
04269P,華通國票93售03  ,0,0,0,0,0,0,0,0,0,20000,0,0,0,20000,0,20000,20000
00690,兆豐藍籌30      ,0,0,0,0,0,0,0,0,0,20000,0,0,0,176000,156000,20000,20000
046189,聯發科凱基92購02,0,0,0,0,0,0,0,0,0,20000,0,0,0,20000,0,20000,20000
046220,滬深2X元大95購03,0,0,0,0,0,0,0,0,0,20000,0,0,0,30000,10000,20000,20000
042918,矽格元大94購01  ,0,0,0,0,0,0,0,0,0,20000,0,0,0,20000,0,20000,20000
046266,兆豐金凱基92購01,0,0,0,0,0,0,0,0,0,20000,0,0,0,20000,0,20000,20000
046292,聯發科統一92購02,0,0,0,0,0,0,0,0,0,20000,0,0,0,40000,20000,20000,20000
04333P,儒鴻凱基93售06  ,0,0,0,0,0,0,0,0,0,20000,0,0,0,20000,0,20000,20000
045660,欣興富邦93購03  ,0,0,0,0,0,0,0,0,0,20000,0,0,0,20000,0,20000,20000
045653,南茂凱基93購02  ,0,0,0,0,0,0,0,0,0,20000,0,0,0,20000,0,20000,20000
046053,滬深2X群益94購01,0,0,0,0,0,0,0,0,0,20000,0,0,0,20000,0,20000,20000
04003P,麗豐凱基94售03  ,0,0,0,0,0,0,0,0,0,20000,0,0,0,30000,10000,20000,20000
03871P,智邦群益93售02  ,0,0,0,0,0,0,0,0,0,20000,0,0,0,20000,0,20000,20000
03597P,玉晶光凱基03售12,0,0,0,0,0,0,0,0,0,20000,0,0,0,20000,0,20000,20000
03637C,臺股指凱基94牛18,0,0,0,0,0,0,0,0,0,20000,0,0,0,20000,0,20000,20000
03641C,臺股指凱基95牛18,0,0,0,0,0,0,0,0,0,20000,0,0,0,20000,0,20000,20000
03799P,京元電元大94售01,0,0,0,0,0,0,0,0,0,20000,0,0,0,20000,0,20000,20000
04919P,聯詠凱基94售05  ,0,0,0,0,0,0,0,0,0,20000,0,0,0,20000,0,20000,20000
051423,GIS國票97購01   ,0,0,0,0,0,0,0,0,0,20000,0,0,0,20000,0,20000,20000
046981,智伸科兆豐94購01,0,0,0,0,0,0,0,0,0,20000,0,0,0,20000,0,20000,20000
047002,鴻海統一93購04  ,0,0,0,0,0,0,0,0,0,20000,0,0,0,40000,20000,20000,20000
048759,巨大元富96購01  ,0,0,0,0,0,0,0,0,0,20000,0,0,0,20000,0,20000,20000
04876P,台光電中信94售02,0,0,0,0,0,0,0,0,0,20000,0,0,0,20000,0,20000,20000
047080,仁寶康和93購01  ,0,0,0,0,0,0,0,0,0,20000,0,0,0,20000,0,20000,20000
047081,晶技康和93購01  ,0,0,0,0,0,0,0,0,0,20000,0,0,0,20000,0,20000,20000
04849P,GIS中信94售01   ,0,0,0,0,0,0,0,0,0,20000,0,0,0,20000,0,20000,20000
047736,聯發科台新94購01,0,0,0,0,0,0,0,0,0,20000,0,0,0,20000,0,20000,20000
047740,樺漢永豐93購01  ,0,0,0,0,0,0,0,0,0,20000,0,0,0,20000,0,20000,20000
047749,富邦金元富93購01,0,0,0,0,0,0,0,0,0,20000,0,0,0,20000,0,20000,20000
047685,嘉聯益國泰95購01,0,0,0,0,0,0,0,0,0,20000,0,0,0,20000,0,20000,20000
047578,新光金群益93購01,0,0,0,0,0,0,0,0,0,20000,0,0,0,20000,0,20000,20000
047425,聯發科亞東93購02,0,0,0,0,0,0,0,0,0,20000,0,0,0,20000,0,20000,20000
04735P,聯茂兆豐94售01  ,0,0,0,0,0,0,0,0,0,20000,0,0,0,20000,0,20000,20000
04839P,大立光元大94售17,0,0,0,0,0,0,0,0,0,20000,0,0,0,35000,15000,20000,20000
047351,聯詠凱基93購02  ,0,0,0,0,0,0,0,0,0,20000,0,0,0,20000,0,20000,20000
047502,超眾永豐93購03  ,0,0,0,0,0,0,0,0,0,20000,0,0,0,20000,0,20000,20000
047484,聯詠凱基93購03  ,0,0,0,0,0,0,0,0,0,20000,0,0,0,20000,0,20000,20000
048033,大立光凱基93購28,0,0,0,0,0,0,0,0,0,20000,0,0,0,75000,55000,20000,20000
048374,味全元富94購01  ,0,0,0,0,0,0,0,0,0,20000,0,0,0,20000,0,20000,20000
048339,友達元大95購01  ,0,0,0,0,0,0,0,0,0,20000,0,0,0,30000,10000,20000,20000
048225,全新凱基93購03  ,0,0,0,0,0,0,0,0,0,20000,0,0,0,20000,0,20000,20000
048260,鴻海元富93購06  ,0,0,0,0,0,0,0,0,0,20000,0,0,0,20000,0,20000,20000
046880,瑞昱永昌93購01  ,0,0,0,0,0,0,0,0,0,20000,0,0,0,20000,0,20000,20000
046822,亞光凱基93購04  ,0,0,0,0,0,0,0,0,0,20000,0,0,0,20000,0,20000,20000
05304P,國巨國泰97售02  ,0,0,0,0,0,0,0,0,0,20000,0,0,0,20000,0,20000,20000
053018,旺宏元富96購02  ,0,0,0,0,0,0,0,0,0,20000,0,0,0,27000,7000,20000,20000
051059,康普群益95購01  ,0,0,0,0,0,0,0,0,0,20000,0,0,0,20000,0,20000,20000
049130,臺指反元大98購01,0,0,0,0,0,0,0,0,0,20000,0,0,0,30000,10000,20000,20000
04911P,美律元富94售02  ,0,0,0,0,0,0,0,0,0,20000,0,0,0,20000,0,20000,20000
049090,茂林凱基94購01  ,0,0,0,0,0,0,0,0,0,20000,0,0,0,20000,0,20000,20000
049809,聯詠元大94購04  ,0,0,0,0,0,0,0,0,0,20000,0,0,0,22000,2000,20000,20000
052589,群創永豐97購01  ,0,0,0,0,0,0,0,0,0,20000,0,0,0,40000,20000,20000,20000
052555,漢唐國票97購01  ,0,0,0,0,0,0,0,0,0,20000,0,0,0,20000,0,20000,20000
052549,喬山國票97購01  ,0,0,0,0,0,0,0,0,0,20000,0,0,0,20000,0,20000,20000
052566,國巨凱基96購04  ,0,0,0,0,0,0,0,0,0,20000,0,0,0,20000,0,20000,20000
052426,國巨台新96購01  ,0,0,0,0,0,0,0,0,0,20000,0,0,0,20000,0,20000,20000
052177,京鼎元大95購02  ,0,0,0,0,0,0,0,0,0,20000,0,0,0,369000,349000,20000,20000
05235P,健鼎康和95售02  ,0,0,0,0,0,0,0,0,0,20000,0,0,0,20000,0,20000,20000
049020,可成群益94購02  ,0,0,0,0,0,0,0,0,0,20000,0,0,0,81000,61000,20000,20000
04909P,鴻海統一94售10  ,0,0,0,0,0,0,0,0,0,20000,0,0,0,20000,0,20000,20000
049067,元油2X凱基94購02,0,0,0,0,0,0,0,0,0,20000,0,0,0,20000,0,20000,20000
04888P,臺股指凱基95售03,0,0,0,0,0,0,0,0,0,20000,0,0,0,195000,175000,20000,20000
050979,鴻海元富96購02  ,0,0,0,0,0,0,0,0,0,20000,0,0,0,20000,0,20000,20000
049934,緯穎元大94購08  ,0,0,0,0,0,0,0,0,0,20000,0,0,0,122000,102000,20000,20000
050849,智伸科國票95購01,0,0,0,0,0,0,0,0,0,20000,0,0,0,20000,0,20000,20000
049542,鴻海群益94購05  ,0,0,0,0,0,0,0,0,0,20000,0,0,0,26000,6000,20000,20000
051390,京元電兆豐95購01,0,0,0,0,0,0,0,0,0,20000,0,0,0,20000,0,20000,20000
05141P,華通台新96售01  ,0,0,0,0,0,0,0,0,0,20000,0,0,0,25000,5000,20000,20000
051364,鴻海國泰97購03  ,0,0,0,0,0,0,0,0,0,20000,0,0,0,20000,0,20000,20000
051377,鴻海群益95購07  ,0,0,0,0,0,0,0,0,0,20000,0,0,0,30000,10000,20000,20000
04965P,日月光元大94售02,0,0,0,0,0,0,0,0,0,20000,0,0,0,20000,0,20000,20000
050682,南亞科元富94購02,0,0,0,0,0,0,0,0,0,20000,0,0,0,60000,40000,20000,20000
050636,上証2X國票94購01,0,0,0,0,0,0,0,0,0,20000,0,0,0,20000,0,20000,20000
050642,和大凱基94購03  ,0,0,0,0,0,0,0,0,0,20000,0,0,0,20000,0,20000,20000
05026P,貿聯群益95售01  ,0,0,0,0,0,0,0,0,0,20000,0,0,0,20000,0,20000,20000
050196,嘉聯益元大97購01,0,0,0,0,0,0,0,0,0,20000,0,0,0,20000,0,20000,20000
05014P,臺股指元大95售05,0,0,0,0,0,0,0,0,0,20000,0,0,0,40000,20000,20000,20000
051244,正崴元大95購01  ,0,0,0,0,0,0,0,0,0,20000,0,0,0,20000,0,20000,20000
051252,健鼎元大95購01  ,0,0,0,0,0,0,0,0,0,20000,0,0,0,20000,0,20000,20000
051318,上銀國票96購01  ,0,0,0,0,0,0,0,0,0,20000,0,0,0,20000,0,20000,20000
051616,鴻海凱基96購08  ,0,0,0,0,0,0,0,0,0,20000,0,0,0,30000,10000,20000,20000
049713,鴻海凱基94購17  ,0,0,0,0,0,0,0,0,0,20000,0,0,0,36000,16000,20000,20000
050044,聯詠兆豐94購02  ,0,0,0,0,0,0,0,0,0,20000,0,0,0,20000,0,20000,20000
050092,鴻海永豐94購04  ,0,0,0,0,0,0,0,0,0,20000,0,0,0,67000,47000,20000,20000
050093,國巨永豐94購05  ,0,0,0,0,0,0,0,0,0,20000,0,0,0,20000,0,20000,20000
049401,可成群益94購04  ,0,0,0,0,0,0,0,0,0,20000,0,0,0,20000,0,20000,20000
051583,可成元大95購07  ,0,0,0,0,0,0,0,0,0,20000,0,0,0,30000,10000,20000,20000
050538,鴻海凱基95購06  ,0,0,0,0,0,0,0,0,0,20000,0,0,0,20000,0,20000,20000
052026,漢唐群益95購01  ,0,0,0,0,0,0,0,0,0,20000,0,0,0,20000,0,20000,20000
052010,兆豐金中信95購01,0,0,0,0,0,0,0,0,0,20000,0,0,0,50000,30000,20000,20000
052012,聯發科台新95購02,0,0,0,0,0,0,0,0,0,20000,0,0,0,20000,0,20000,20000
051973,華新科凱基96購04,0,0,0,0,0,0,0,0,0,20000,0,0,0,25000,5000,20000,20000
051966,台表科永豐95購01,0,0,0,0,0,0,0,0,0,20000,0,0,0,30000,10000,20000,20000
051989,華固元大95購02  ,0,0,0,0,0,0,0,0,0,20000,0,0,0,20000,0,20000,20000
05191P,鴻海台新95售01  ,0,0,0,0,0,0,0,0,0,20000,0,0,0,50000,30000,20000,20000
051553,牧德永豐96購02  ,0,0,0,0,0,0,0,0,0,20000,0,0,0,37000,17000,20000,20000
051539,瀚宇博國票97購01,0,0,0,0,0,0,0,0,0,20000,0,0,0,40000,20000,20000,20000
053505,瑞儀兆豐97購01  ,0,0,0,0,0,0,0,0,0,20000,0,0,0,20000,0,20000,20000
05348P,美律元富98售01  ,0,0,0,0,0,0,0,0,0,20000,0,0,0,20000,0,20000,20000
053471,正崴元大96購01  ,0,0,0,0,0,0,0,0,0,20000,0,0,0,20000,0,20000,20000
053370,上証2X元大97購03,0,0,0,0,0,0,0,0,0,20000,0,0,0,20000,0,20000,20000
053335,易華電永豐96購01,0,0,0,0,0,0,0,0,0,20000,0,0,0,20000,0,20000,20000
05332P,臺股指國票95售01,0,0,0,0,0,0,0,0,0,20000,0,0,0,40000,20000,20000,20000
053719,可成凱基96購08  ,0,0,0,0,0,0,0,0,0,20000,0,0,0,20000,0,20000,20000
053703,緯穎兆豐96購01  ,0,0,0,0,0,0,0,0,0,20000,0,0,0,20000,0,20000,20000
053986,矽創第一96購01  ,0,0,0,0,0,0,0,0,0,20000,0,0,0,30000,10000,20000,20000
053268,日月光群益96購01,0,0,0,0,0,0,0,0,0,20000,0,0,0,75000,55000,20000,20000
053094,聯電統一97購02  ,0,0,0,0,0,0,0,0,0,20000,0,0,0,70000,50000,20000,20000
053092,台表科元大97購02,0,0,0,0,0,0,0,0,0,20000,0,0,0,30000,10000,20000,20000
052799,上銀元大96購01  ,0,0,0,0,0,0,0,0,0,20000,0,0,0,198000,178000,20000,20000
052220,T50反1凱基98購01,0,0,0,0,0,0,0,0,0,20000,0,0,0,20000,0,20000,20000
052810,易華電元大96購02,0,0,0,0,0,0,0,0,0,20000,0,0,0,26000,6000,20000,20000
052864,奇力新凱基96購02,0,0,0,0,0,0,0,0,0,20000,0,0,0,20000,0,20000,20000
054792,揚明光群益97購01,0,0,0,0,0,0,0,0,0,20000,0,0,0,20000,0,20000,20000
054823,祥碩元大97購02  ,0,0,0,0,0,0,0,0,0,20000,0,0,0,20000,0,20000,20000
054728,聯發科日盛97購01,0,0,0,0,0,0,0,0,0,20000,0,0,0,40000,20000,20000,20000
054768,泰碩國票99購02  ,0,0,0,0,0,0,0,0,0,20000,0,0,0,20000,0,20000,20000
054968,佐登元大97購01  ,0,0,0,0,0,0,0,0,0,20000,0,0,0,20000,0,20000,20000
055088,聯詠亞東97購01  ,0,0,0,0,0,0,0,0,0,20000,0,0,0,20000,0,20000,20000
055245,凱美統一99購01  ,0,0,0,0,0,0,0,0,0,20000,0,0,0,30000,10000,20000,20000
055219,啟碁凱基98購01  ,0,0,0,0,0,0,0,0,0,20000,0,0,0,168000,148000,20000,20000
055191,牧德元富97購01  ,0,0,0,0,0,0,0,0,0,20000,0,0,0,40000,20000,20000,20000
05421P,鴻海元大96售12  ,0,0,0,0,0,0,0,0,0,20000,0,0,0,157000,137000,20000,20000
054342,亞光元富99購01  ,0,0,0,0,0,0,0,0,0,20000,0,0,0,20000,0,20000,20000
054111,緯穎凱基97購01  ,0,0,0,0,0,0,0,0,0,20000,0,0,0,61000,41000,20000,20000
054010,致伸元富96購01  ,0,0,0,0,0,0,0,0,0,20000,0,0,0,20000,0,20000,20000
054358,矽創兆豐96購01  ,0,0,0,0,0,0,0,0,0,20000,0,0,0,20000,0,20000,20000
054347,上緯控國票96購02,0,0,0,0,0,0,0,0,0,20000,0,0,0,100000,80000,20000,20000
054366,和大中信98購01  ,0,0,0,0,0,0,0,0,0,20000,0,0,0,50000,30000,20000,20000
054446,美食兆豐97購01  ,0,0,0,0,0,0,0,0,0,20000,0,0,0,20000,0,20000,20000
054436,高鐵台新97購02  ,0,0,0,0,0,0,0,0,0,20000,0,0,0,20000,0,20000,20000
054653,聯發科麥證97購02,0,0,0,20000,0,20000,0,0,0,20000,0,0,0,20000,0,20000,20000
054526,道瓊反統一98購01,0,0,0,0,0,0,0,0,0,20000,0,0,0,20000,0,20000,20000
06601P,臺股指永豐98售04,0,0,0,0,0,0,0,0,0,20000,0,0,0,20000,0,20000,20000
1732,毛寶            ,20000,0,20000,0,0,0,0,0,0,0,0,0,0,0,0,0,20000
1611,中電            ,24000,4000,20000,0,0,0,0,0,0,0,0,0,0,0,0,0,20000
06529P,貿聯富邦99售03  ,0,0,0,0,0,0,0,0,0,20000,0,0,0,20000,0,20000,20000
3702A,大聯大甲特      ,0,0,0,0,0,0,0,0,0,20000,20000,0,20000,0,0,0,20000
3059,華晶科          ,76000,57000,19000,0,0,0,0,0,0,1000,1000,0,1000,0,0,0,20000
6168,宏齊            ,32000,12000,20000,0,0,0,0,0,0,0,0,0,0,0,0,0,20000
8404,百和興業-KY     ,61000,41000,20000,0,0,0,0,0,0,0,0,0,0,0,0,0,20000
055831,台達電元大97購01,0,0,0,0,0,0,0,0,0,19000,0,0,0,24000,5000,19000,19000
056067,智原元大97購01  ,0,0,0,0,0,0,0,0,0,19000,0,0,0,53000,34000,19000,19000
056322,臺股指群益98購01,0,0,0,0,0,0,0,0,0,19000,0,0,0,20000,1000,19000,19000
056568,台表科群益98購01,0,0,0,0,0,0,0,0,0,19000,0,0,0,107000,88000,19000,19000
056653,元石油元大98購01,0,0,0,0,0,0,0,0,0,19000,0,0,0,40000,21000,19000,19000
056895,技嘉元大98購01  ,0,0,0,0,0,0,0,0,0,19000,0,0,0,93000,74000,19000,19000
057040,國巨元大98購12  ,0,0,0,0,0,0,0,0,0,19000,0,0,0,83000,64000,19000,19000
05825P,臺股指凱基96售22,0,0,0,0,0,0,0,0,0,19000,0,0,0,19000,0,19000,19000
06027P,鴻海台新96售04  ,0,0,0,0,0,0,0,0,0,19000,0,0,0,19000,0,19000,19000
05991P,聯茂群益96售05  ,0,0,0,0,0,0,0,0,0,19000,0,0,0,29000,10000,19000,19000
048035,聯詠凱基93購06  ,0,0,0,0,0,0,0,0,0,19000,0,0,0,105000,86000,19000,19000
046703,瑞昱元富95購01  ,0,0,0,0,0,0,0,0,0,19000,0,0,0,165000,146000,19000,19000
047646,貿聯元大94購01  ,0,0,0,0,0,0,0,0,0,19000,0,0,0,21000,2000,19000,19000
03430B,臺股指元大9B熊01,0,0,0,0,0,0,0,0,0,19000,0,0,0,22000,3000,19000,19000
046332,同欣電元大92購01,0,0,0,0,0,0,0,0,0,19000,0,0,0,100000,81000,19000,19000
045231,南電元大94購01  ,0,0,0,0,0,0,0,0,0,19000,0,0,0,20000,1000,19000,19000
047810,聯發科凱基93購22,0,0,0,0,0,0,0,0,0,19000,0,0,0,19000,0,19000,19000
051536,玉晶光國票97購01,0,0,0,0,0,0,0,0,0,19000,0,0,0,31000,12000,19000,19000
051231,健策群益97購01  ,0,0,0,0,0,0,0,0,0,19000,0,0,0,147000,128000,19000,19000
049788,智伸科兆豐95購01,0,0,0,0,0,0,0,0,0,19000,0,0,0,69000,50000,19000,19000
048867,台積電兆豐95購01,0,0,0,0,0,0,0,0,0,19000,0,0,0,20000,1000,19000,19000
05217P,鴻海統一95售08  ,0,0,0,0,0,0,0,0,0,19000,0,0,0,19000,0,19000,19000
05214P,台積電國票97售02,0,0,0,0,0,0,0,0,0,19000,0,0,0,19000,0,19000,19000
054937,國巨元大97購03  ,0,0,0,0,0,0,0,0,0,19000,0,0,0,177000,158000,19000,19000
054913,億光凱基97購01  ,0,0,0,0,0,0,0,0,0,19000,0,0,0,60000,41000,19000,19000
052851,滬深2X元富96購02,0,0,0,0,0,0,0,0,0,19000,0,0,0,25000,6000,19000,19000
052295,揚明光國票96購03,0,0,0,0,0,0,0,0,0,19000,0,0,0,19000,0,19000,19000
05399P,GIS國票95售03   ,0,0,0,0,0,0,0,0,0,19000,0,0,0,19000,0,19000,19000
053352,義隆兆豐96購01  ,0,0,0,0,0,0,0,0,0,19000,0,0,0,35000,16000,19000,19000
053535,宏達電永豐96購02,0,0,0,0,0,0,0,0,0,19000,0,0,0,66000,47000,19000,19000
3346,麗清            ,26000,7000,19000,0,0,0,0,0,0,0,0,0,0,0,0,0,19000
3704,合勤控          ,243000,127000,116000,0,0,0,0,0,0,-97000,0,0,0,0,97000,-97000,19000
4746,台耀            ,68000,47000,21000,0,0,0,0,0,0,-2000,3000,5000,-2000,0,0,0,19000
2528,皇普            ,26000,6000,20000,0,0,0,0,0,0,-1000,0,1000,-1000,0,0,0,19000
05871P,全新凱基96售04  ,0,0,0,0,0,0,0,0,0,18000,0,0,0,464000,446000,18000,18000
05850P,台積電兆豐96售06,0,0,0,0,0,0,0,0,0,18000,0,0,0,54000,36000,18000,18000
05857P,旺宏中信98售02  ,0,0,0,0,0,0,0,0,0,18000,0,0,0,18000,0,18000,18000
057013,聯發科麥證98購01,0,0,0,32000,12000,20000,0,0,0,18000,0,0,0,32000,14000,18000,18000
056911,緯穎元大99購01  ,0,0,0,0,0,0,0,0,0,18000,0,0,0,109000,91000,18000,18000
056689,玉晶光統一9A購03,0,0,0,0,0,0,0,0,0,18000,0,0,0,18000,0,18000,18000
056313,聯茂元大98購01  ,0,0,0,0,0,0,0,0,0,18000,0,0,0,209000,191000,18000,18000
056310,神達元大97購02  ,0,0,0,0,0,0,0,0,0,18000,0,0,0,682000,664000,18000,18000
056410,康控國票99購01  ,0,0,0,0,0,0,0,0,0,18000,0,0,0,49000,31000,18000,18000
055506,台郡元大99購02  ,0,0,0,0,0,0,0,0,0,18000,0,0,0,68000,50000,18000,18000
045073,可成元大93購01  ,0,0,0,0,0,0,0,0,0,18000,0,0,0,264000,246000,18000,18000
04835P,鴻海元大94售18  ,0,0,0,0,0,0,0,0,0,18000,0,0,0,23000,5000,18000,18000
047010,聯詠統一93購05  ,0,0,0,0,0,0,0,0,0,18000,0,0,0,68000,50000,18000,18000
046961,大立光中信95購02,0,0,0,0,0,0,0,0,0,18000,0,0,0,45000,27000,18000,18000
051439,川湖元大95購01  ,0,0,0,0,0,0,0,0,0,18000,0,0,0,84000,66000,18000,18000
049906,光寶科元大94購03,0,0,0,0,0,0,0,0,0,18000,0,0,0,20000,2000,18000,18000
049825,台積電凱基94購26,0,0,0,0,0,0,0,0,0,18000,0,0,0,103000,85000,18000,18000
051168,訊連元大95購02  ,0,0,0,0,0,0,0,0,0,18000,0,0,0,240000,222000,18000,18000
051257,光寶科國泰96購01,0,0,0,0,0,0,0,0,0,18000,0,0,0,22000,4000,18000,18000
050234,國巨凱基94購10  ,0,0,0,0,0,0,0,0,0,18000,0,0,0,18000,0,18000,18000
049443,元石油統一94購02,0,0,0,0,0,0,0,0,0,18000,0,0,0,20000,2000,18000,18000
049453,新日興統一94購01,0,0,0,0,0,0,0,0,0,18000,0,0,0,18000,0,18000,18000
049508,上銀凱基94購04  ,0,0,0,0,0,0,0,0,0,18000,0,0,0,20000,2000,18000,18000
05051P,鴻海群益95售05  ,0,0,0,0,0,0,0,0,0,18000,0,0,0,22000,4000,18000,18000
051591,玉晶光元大97購01,0,0,0,0,0,0,0,0,0,18000,0,0,0,46000,28000,18000,18000
053630,奇鋐兆豐97購01  ,0,0,0,0,0,0,0,0,0,18000,0,0,0,18000,0,18000,18000
053744,台郡國票97購03  ,0,0,0,0,0,0,0,0,0,18000,0,0,0,30000,12000,18000,18000
05231P,GIS群益95售03   ,0,0,0,0,0,0,0,0,0,18000,0,0,0,28000,10000,18000,18000
053194,緯穎統一99購01  ,0,0,0,0,0,0,0,0,0,18000,0,0,0,24000,6000,18000,18000
055002,群創元富99購04  ,0,0,0,0,0,0,0,0,0,18000,0,0,0,50000,32000,18000,18000
054832,興勤中信97購01  ,0,0,0,0,0,0,0,0,0,18000,0,0,0,30000,12000,18000,18000
054292,欣興元大96購06  ,0,0,0,0,0,0,0,0,0,18000,0,0,0,28000,10000,18000,18000
2812,台中銀          ,293000,281000,12000,0,0,0,0,0,0,6000,6000,0,6000,0,0,0,18000
2108,南帝            ,36000,18000,18000,0,0,0,0,0,0,0,0,0,0,0,0,0,18000
6112,聚碩            ,27000,12000,15000,0,0,0,0,0,0,3000,3000,0,3000,0,0,0,18000
06561P,台灣50國泰9A售01,0,0,0,0,0,0,0,0,0,18000,0,0,0,52000,34000,18000,18000
06552P,茂林元大99售02  ,0,0,0,0,0,0,0,0,0,18000,0,0,0,20000,2000,18000,18000
06264P,友達凱基98售06  ,0,0,0,0,0,0,0,0,0,18000,0,0,0,25000,7000,18000,18000
1773,勝一            ,27000,9000,18000,0,0,0,0,0,0,0,0,0,0,0,0,0,18000
06618P,智邦元大98售04  ,0,0,0,0,0,0,0,0,0,18000,0,0,0,18000,0,18000,18000
8499,鼎炫-KY         ,28000,10000,18000,0,0,0,0,0,0,0,0,0,0,0,0,0,18000
055466,台達電凱基97購03,0,0,0,0,0,0,0,0,0,17000,0,0,0,17000,0,17000,17000
056110,嘉聯益永豐97購02,0,0,0,0,0,0,0,0,0,17000,0,0,0,67000,50000,17000,17000
056598,京元電元富98購01,0,0,0,0,0,0,0,0,0,17000,0,0,0,30000,13000,17000,17000
056851,瑞儀元富98購01  ,0,0,0,0,0,0,0,0,0,17000,0,0,0,17000,0,17000,17000
056931,智原台新98購01  ,0,0,0,0,0,0,0,0,0,17000,0,0,0,17000,0,17000,17000
056995,華新科日盛99購01,0,0,0,0,0,0,0,0,0,17000,0,0,0,57000,40000,17000,17000
057151,易華電國票99購01,0,0,0,0,0,0,0,0,0,17000,0,0,0,17000,0,17000,17000
05928P,華邦電康和96售01,0,0,0,0,0,0,0,0,0,17000,0,0,0,17000,0,17000,17000
057220,鈺齊群益98購01  ,0,0,0,0,0,0,0,0,0,17000,0,0,0,122000,105000,17000,17000
049247,光寶科元大94購02,0,0,0,0,0,0,0,0,0,17000,0,0,0,19000,2000,17000,17000
048248,聯發科兆豐95購01,0,0,0,0,0,0,0,0,0,17000,0,0,0,129000,112000,17000,17000
048258,國泰金統一93購01,0,0,0,0,0,0,0,0,0,17000,0,0,0,17000,0,17000,17000
04805P,創意元富94售01  ,0,0,0,0,0,0,0,0,0,17000,0,0,0,17000,0,17000,17000
042902,光寶科元大94購01,0,0,0,0,0,0,0,0,0,17000,0,0,0,19000,2000,17000,17000
051578,智邦元大96購01  ,0,0,0,0,0,0,0,0,0,17000,0,0,0,53000,36000,17000,17000
051248,華固元大95購01  ,0,0,0,0,0,0,0,0,0,17000,0,0,0,29000,12000,17000,17000
051299,致茂凱基95購01  ,0,0,0,0,0,0,0,0,0,17000,0,0,0,18000,1000,17000,17000
049909,國巨元大95購01  ,0,0,0,0,0,0,0,0,0,17000,0,0,0,30000,13000,17000,17000
052180,緯穎元大96購05  ,0,0,0,0,0,0,0,0,0,17000,0,0,0,170000,153000,17000,17000
052666,瑞昱群益96購01  ,0,0,0,0,0,0,0,0,0,17000,0,0,0,61000,44000,17000,17000
054357,可成兆豐97購02  ,0,0,0,0,0,0,0,0,0,17000,0,0,0,50000,33000,17000,17000
05471P,聯電統一95售01  ,0,0,0,0,0,0,0,0,0,17000,0,0,0,17000,0,17000,17000
052323,矽力元大95購04  ,0,0,0,0,0,0,0,0,0,17000,0,0,0,17000,0,17000,17000
052968,燿華群益98購01  ,0,0,0,0,0,0,0,0,0,17000,0,0,0,91000,74000,17000,17000
05310P,智原永豐95售04  ,0,0,0,0,0,0,0,0,0,17000,0,0,0,27000,10000,17000,17000
052842,滬深2X統一96購01,0,0,0,0,0,0,0,0,0,17000,0,0,0,17000,0,17000,17000
053322,京鼎群益97購01  ,0,0,0,0,0,0,0,0,0,17000,0,0,0,377000,360000,17000,17000
053361,友達元富99購01  ,0,0,0,0,0,0,0,0,0,17000,0,0,0,20000,3000,17000,17000
06197P,國巨元大97售08  ,0,0,0,0,0,0,0,0,0,17000,0,0,0,17000,0,17000,17000
06509P,鴻海群益98售03  ,0,0,0,0,0,0,0,0,0,17000,0,0,0,17000,0,17000,17000
6582,申豐            ,28000,11000,17000,0,0,0,0,0,0,0,0,0,0,0,0,0,17000
4414,如興            ,577000,549000,28000,0,0,0,0,0,0,-11000,0,11000,-11000,0,0,0,17000
3013,晟銘電          ,18000,2000,16000,0,0,0,0,0,0,1000,1000,0,1000,0,0,0,17000
2913,農林            ,62000,45000,17000,0,0,0,0,0,0,0,0,0,0,0,0,0,17000
057299,立積永豐98購02  ,0,0,0,0,0,0,0,0,0,16000,0,0,0,57000,41000,16000,16000
05897P,國巨凱基96售12  ,0,0,0,0,0,0,0,0,0,16000,0,0,0,86000,70000,16000,16000
06116P,臺股指日盛97售01,0,0,0,0,0,0,0,0,0,16000,0,0,0,16000,0,16000,16000
06145P,華新科永豐97售02,0,0,0,0,0,0,0,0,0,16000,0,0,0,82000,66000,16000,16000
057116,鴻海日盛9A購01  ,0,0,0,0,0,0,0,0,0,16000,0,0,0,16000,0,16000,16000
057003,立積國票98購01  ,0,0,0,0,0,0,0,0,0,16000,0,0,0,21000,5000,16000,16000
056937,智原元富98購01  ,0,0,0,0,0,0,0,0,0,16000,0,0,0,41000,25000,16000,16000
05667P,旺宏台新96售01  ,0,0,0,0,0,0,0,0,0,16000,0,0,0,16000,0,16000,16000
056402,智易群益98購02  ,0,0,0,0,0,0,0,0,0,16000,0,0,0,41000,25000,16000,16000
056263,友訊統一99購01  ,0,0,0,0,0,0,0,0,0,16000,0,0,0,34000,18000,16000,16000
056366,玉晶光元大99購04,0,0,0,0,0,0,0,0,0,16000,0,0,0,16000,0,16000,16000
055789,台虹凱基97購01  ,0,0,0,0,0,0,0,0,0,16000,0,0,0,51000,35000,16000,16000
03756P,創意永豐93售01  ,0,0,0,0,0,0,0,0,0,16000,0,0,0,16000,0,16000,16000
045438,台郡統一94購01  ,0,0,0,0,0,0,0,0,0,16000,0,0,0,16000,0,16000,16000
046552,晶技麥證92購01  ,0,0,0,16000,0,16000,0,0,0,16000,0,0,0,16000,0,16000,16000
04452P,超眾國泰95售01  ,0,0,0,0,0,0,0,0,0,16000,0,0,0,16000,0,16000,16000
04595P,臺股指元大94售13,0,0,0,0,0,0,0,0,0,16000,0,0,0,40000,24000,16000,16000
048270,T50反1富邦99購01,0,0,0,0,0,0,0,0,0,16000,0,0,0,21000,5000,16000,16000
051823,矽力元富95購02  ,0,0,0,0,0,0,0,0,0,16000,0,0,0,20000,4000,16000,16000
047298,聯茂元富96購01  ,0,0,0,0,0,0,0,0,0,16000,0,0,0,16000,0,16000,16000
048688,瑞昱群益94購01  ,0,0,0,0,0,0,0,0,0,16000,0,0,0,94000,78000,16000,16000
05218P,大立光永昌96售04,0,0,0,0,0,0,0,0,0,16000,0,0,0,501000,485000,16000,16000
05303P,華通國泰97售01  ,0,0,0,0,0,0,0,0,0,16000,0,0,0,26000,10000,16000,16000
049030,凌華群益94購01  ,0,0,0,0,0,0,0,0,0,16000,0,0,0,16000,0,16000,16000
050806,華新科日盛95購01,0,0,0,0,0,0,0,0,0,16000,0,0,0,117000,101000,16000,16000
051229,亞光群益95購01  ,0,0,0,0,0,0,0,0,0,16000,0,0,0,65000,49000,16000,16000
049507,和大凱基94購01  ,0,0,0,0,0,0,0,0,0,16000,0,0,0,18000,2000,16000,16000
049463,華新科富邦97購01,0,0,0,0,0,0,0,0,0,16000,0,0,0,93000,77000,16000,16000
050697,冠德凱基96購01  ,0,0,0,0,0,0,0,0,0,16000,0,0,0,16000,0,16000,16000
050578,聯發科國票95購03,0,0,0,0,0,0,0,0,0,16000,0,0,0,21000,5000,16000,16000
050456,聯茂元大94購09  ,0,0,0,0,0,0,0,0,0,16000,0,0,0,38000,22000,16000,16000
053835,南亞科永豐96購02,0,0,0,0,0,0,0,0,0,16000,0,0,0,84000,68000,16000,16000
054712,上証2X中信98購02,0,0,0,0,0,0,0,0,0,16000,0,0,0,20000,4000,16000,16000
054946,億光元大97購01  ,0,0,0,0,0,0,0,0,0,16000,0,0,0,56000,40000,16000,16000
054910,信錦凱基97購01  ,0,0,0,0,0,0,0,0,0,16000,0,0,0,16000,0,16000,16000
055099,可成日盛97購01  ,0,0,0,0,0,0,0,0,0,16000,0,0,0,30000,14000,16000,16000
054441,力成台新96購01  ,0,0,0,0,0,0,0,0,0,16000,0,0,0,16000,0,16000,16000
054021,義隆台新96購01  ,0,0,0,0,0,0,0,0,0,16000,0,0,0,41000,25000,16000,16000
2887E,台新戊特        ,0,0,0,0,0,0,0,0,0,16000,16000,0,16000,0,0,0,16000
3149,正達            ,20000,4000,16000,0,0,0,0,0,0,0,0,0,0,0,0,0,16000
6197,佳必琪          ,56000,41000,15000,0,0,0,0,0,0,1000,1000,0,1000,0,0,0,16000
06388P,鴻海兆豐97售04  ,0,0,0,0,0,0,0,0,0,16000,0,0,0,24000,8000,16000,16000
06605P,玉晶光元富98售03,0,0,0,0,0,0,0,0,0,16000,0,0,0,16000,0,16000,16000
6277,宏正            ,16932,1000,15932,0,0,0,0,0,0,0,0,0,0,0,0,0,15932
055929,聯發科群益97購05,0,0,0,0,0,0,0,0,0,15000,0,0,0,70000,55000,15000,15000
05573P,仁寶元富96售02  ,0,0,0,0,0,0,0,0,0,15000,0,0,0,42000,27000,15000,15000
055695,大毅國票98購03  ,0,0,0,0,0,0,0,0,0,15000,0,0,0,76000,61000,15000,15000
055430,宏達電群益97購01,0,0,0,0,0,0,0,0,0,15000,0,0,0,45000,30000,15000,15000
055334,禾伸堂兆豐97購01,0,0,0,0,0,0,0,0,0,15000,0,0,0,35000,20000,15000,15000
056281,深中小永豐97購01,0,0,0,0,0,0,0,0,0,15000,0,0,0,15000,0,15000,15000
056680,華通統一98購04  ,0,0,0,0,0,0,0,0,0,15000,0,0,0,35000,20000,15000,15000
056642,旺宏凱基98購07  ,0,0,0,0,0,0,0,0,0,15000,0,0,0,38000,23000,15000,15000
057029,緯穎凱基98購04  ,0,0,0,0,0,0,0,0,0,15000,0,0,0,16000,1000,15000,15000
057055,立積元大99購01  ,0,0,0,0,0,0,0,0,0,15000,0,0,0,16000,1000,15000,15000
05902P,華通國票96售02  ,0,0,0,0,0,0,0,0,0,15000,0,0,0,15000,0,15000,15000
057192,力成元大98購01  ,0,0,0,0,0,0,0,0,0,15000,0,0,0,50000,35000,15000,15000
05812P,臺股指國票96售05,0,0,0,0,0,0,0,0,0,15000,0,0,0,15000,0,15000,15000
05793P,臺股指中信99售08,0,0,0,0,0,0,0,0,0,15000,0,0,0,15000,0,15000,15000
048658,鴻海統一93購09  ,0,0,0,0,0,0,0,0,0,15000,0,0,0,15000,0,15000,15000
047167,農林康和93購01  ,0,0,0,0,0,0,0,0,0,15000,0,0,0,15000,0,15000,15000
047072,義隆兆豐94購01  ,0,0,0,0,0,0,0,0,0,15000,0,0,0,20000,5000,15000,15000
04856P,光磊元富94售01  ,0,0,0,0,0,0,0,0,0,15000,0,0,0,15000,0,15000,15000
051903,T50反1元大97購02,0,0,0,0,0,0,0,0,0,15000,0,0,0,35000,20000,15000,15000
051428,玉晶光統一96購01,0,0,0,0,0,0,0,0,0,15000,0,0,0,15000,0,15000,15000
046920,華晶科永豐93購01,0,0,0,0,0,0,0,0,0,15000,0,0,0,15000,0,15000,15000
046771,聯發科國泰94購02,0,0,0,0,0,0,0,0,0,15000,0,0,0,157000,142000,15000,15000
047496,旺宏台新93購02  ,0,0,0,0,0,0,0,0,0,15000,0,0,0,15000,0,15000,15000
047541,深中小凱基94購01,0,0,0,0,0,0,0,0,0,15000,0,0,0,15000,0,15000,15000
04451P,可成凱基94售04  ,0,0,0,0,0,0,0,0,0,15000,0,0,0,140000,125000,15000,15000
044605,超眾國泰93購02  ,0,0,0,0,0,0,0,0,0,15000,0,0,0,15000,0,15000,15000
044362,元油2X中信94購01,0,0,0,0,0,0,0,0,0,15000,0,0,0,15000,0,15000,15000
04436P,聯發科中信96售02,0,0,0,0,0,0,0,0,0,15000,0,0,0,15000,0,15000,15000
046533,為升群益92購02  ,0,0,0,0,0,0,0,0,0,15000,0,0,0,15000,0,15000,15000
046448,亞德客凱基92購03,0,0,0,0,0,0,0,0,0,15000,0,0,0,15000,0,15000,15000
047898,嘉澤群益93購02  ,0,0,0,0,0,0,0,0,0,15000,0,0,0,35000,20000,15000,15000
04520P,欣興群益94售02  ,0,0,0,0,0,0,0,0,0,15000,0,0,0,20000,5000,15000,15000
03908P,致茂元大93售03  ,0,0,0,0,0,0,0,0,0,15000,0,0,0,15000,0,15000,15000
046069,禾伸堂凱基92購01,0,0,0,0,0,0,0,0,0,15000,0,0,0,15000,0,15000,15000
046302,亞德客元大92購02,0,0,0,0,0,0,0,0,0,15000,0,0,0,39000,24000,15000,15000
046222,上銀元大92購08  ,0,0,0,0,0,0,0,0,0,15000,0,0,0,15000,0,15000,15000
0053,元大電子        ,0,0,0,0,0,0,0,0,0,15000,0,0,0,17000,2000,15000,15000
05193P,台郡台新95售01  ,0,0,0,0,0,0,0,0,0,15000,0,0,0,65000,50000,15000,15000
05060P,台達電富邦97售02,0,0,0,0,0,0,0,0,0,15000,0,0,0,15000,0,15000,15000
049431,光罩國票96購01  ,0,0,0,0,0,0,0,0,0,15000,0,0,0,20000,5000,15000,15000
051197,光寶科麥證95購01,0,0,0,20000,5000,15000,0,0,0,15000,0,0,0,20000,5000,15000,15000
050761,華通元大94購05  ,0,0,0,0,0,0,0,0,0,15000,0,0,0,15000,0,15000,15000
051092,禾伸堂元大95購02,0,0,0,0,0,0,0,0,0,15000,0,0,0,63000,48000,15000,15000
051404,牧德永豐96購01  ,0,0,0,0,0,0,0,0,0,15000,0,0,0,25000,10000,15000,15000
050879,樺漢統一95購02  ,0,0,0,0,0,0,0,0,0,15000,0,0,0,41000,26000,15000,15000
050939,健鼎國票96購01  ,0,0,0,0,0,0,0,0,0,15000,0,0,0,15000,0,15000,15000
048895,光罩國泰95購01  ,0,0,0,0,0,0,0,0,0,15000,0,0,0,37000,22000,15000,15000
050003,景碩永豐94購01  ,0,0,0,0,0,0,0,0,0,15000,0,0,0,69000,54000,15000,15000
052454,力成元大95購02  ,0,0,0,0,0,0,0,0,0,15000,0,0,0,15000,0,15000,15000
049834,康控凱基94購01  ,0,0,0,0,0,0,0,0,0,15000,0,0,0,15000,0,15000,15000
049835,緯穎凱基94購05  ,0,0,0,0,0,0,0,0,0,15000,0,0,0,15000,0,15000,15000
049169,統一凱基94購01  ,0,0,0,0,0,0,0,0,0,15000,0,0,0,220000,205000,15000,15000
054092,大立光群益97購01,0,0,0,0,0,0,0,0,0,15000,0,0,0,15000,0,15000,15000
054264,超眾元大97購02  ,0,0,0,0,0,0,0,0,0,15000,0,0,0,25000,10000,15000,15000
054203,滬深2X國票96購03,0,0,0,0,0,0,0,0,0,15000,0,0,0,15000,0,15000,15000
054573,漢唐元大98購01  ,0,0,0,0,0,0,0,0,0,15000,0,0,0,27000,12000,15000,15000
053754,英業達元富96購02,0,0,0,0,0,0,0,0,0,15000,0,0,0,20000,5000,15000,15000
053323,群創群益98購07  ,0,0,0,0,0,0,0,0,0,15000,0,0,0,15000,0,15000,15000
053506,南茂兆豐97購01  ,0,0,0,0,0,0,0,0,0,15000,0,0,0,15000,0,15000,15000
05351P,臺股指元富95售05,0,0,0,0,0,0,0,0,0,15000,0,0,0,15000,0,15000,15000
052276,力成群益96購01  ,0,0,0,0,0,0,0,0,0,15000,0,0,0,50000,35000,15000,15000
052724,力成統一97購01  ,0,0,0,0,0,0,0,0,0,15000,0,0,0,15000,0,15000,15000
3209,全科            ,46000,33000,13000,0,0,0,0,0,0,2000,2000,0,2000,0,0,0,15000
2616,山隆            ,15000,0,15000,0,0,0,0,0,0,0,0,0,0,0,0,0,15000
1582,信錦            ,87000,72000,15000,0,0,0,0,0,0,0,0,0,0,0,0,0,15000
06471P,臺股指凱基99售11,0,0,0,0,0,0,0,0,0,15000,0,0,0,15000,0,15000,15000
06336P,鴻海元大98售05  ,0,0,0,0,0,0,0,0,0,15000,0,0,0,15000,0,15000,15000
06317P,臺股指元富97售04,0,0,0,0,0,0,0,0,0,15000,0,0,0,15000,0,15000,15000
8105,凌巨            ,161000,148000,13000,0,0,0,0,0,0,2000,2000,0,2000,0,0,0,15000
05800P,台積電兆豐96售04,0,0,0,0,0,0,0,0,0,14000,0,0,0,40000,26000,14000,14000
057297,新日興永豐98購01,0,0,0,0,0,0,0,0,0,14000,0,0,0,185000,171000,14000,14000
06105P,國巨國票98售02  ,0,0,0,0,0,0,0,0,0,14000,0,0,0,14000,0,14000,14000
057072,日月光永豐98購01,0,0,0,0,0,0,0,0,0,14000,0,0,0,14000,0,14000,14000
057145,上銀國票98購03  ,0,0,0,0,0,0,0,0,0,14000,0,0,0,24000,10000,14000,14000
057011,日月光中信99購01,0,0,0,0,0,0,0,0,0,14000,0,0,0,14000,0,14000,14000
05661P,聯發科統一96售06,0,0,0,0,0,0,0,0,0,14000,0,0,0,14000,0,14000,14000
056292,統一元大97購01  ,0,0,0,0,0,0,0,0,0,14000,0,0,0,87000,73000,14000,14000
056039,宏達電凱基97購02,0,0,0,0,0,0,0,0,0,14000,0,0,0,24000,10000,14000,14000
055354,宏達電凱基98購01,0,0,0,0,0,0,0,0,0,14000,0,0,0,24000,10000,14000,14000
055493,華新科元大97購09,0,0,0,0,0,0,0,0,0,14000,0,0,0,156000,142000,14000,14000
042803,天鈺元大93購01  ,0,0,0,0,0,0,0,0,0,14000,0,0,0,14000,0,14000,14000
046208,滬深2X元富95購03,0,0,0,0,0,0,0,0,0,14000,0,0,0,14000,0,14000,14000
036804,國巨元富93購01  ,0,0,0,0,0,0,0,0,0,14000,0,0,0,55000,41000,14000,14000
03583P,微星元大02售03  ,0,0,0,0,0,0,0,0,0,14000,0,0,0,16000,2000,14000,14000
045517,元油2X元富98購01,0,0,0,0,0,0,0,0,0,14000,0,0,0,120000,106000,14000,14000
045733,瑞昱國票93購01  ,0,0,0,0,0,0,0,0,0,14000,0,0,0,14000,0,14000,14000
046931,聯詠統一93購01  ,0,0,0,0,0,0,0,0,0,14000,0,0,0,14000,0,14000,14000
04837P,華新科元大94售05,0,0,0,0,0,0,0,0,0,14000,0,0,0,14000,0,14000,14000
046628,大立光統一98購01,0,0,0,0,0,0,0,0,0,14000,0,0,0,14000,0,14000,14000
051876,宏達電國票96購01,0,0,0,0,0,0,0,0,0,14000,0,0,0,209000,195000,14000,14000
051452,貿聯元大95購04  ,0,0,0,0,0,0,0,0,0,14000,0,0,0,56000,42000,14000,14000
046947,禾伸堂元大93購01,0,0,0,0,0,0,0,0,0,14000,0,0,0,15000,1000,14000,14000
047213,新日興富邦97購01,0,0,0,0,0,0,0,0,0,14000,0,0,0,62000,48000,14000,14000
049873,華新科台新94購02,0,0,0,0,0,0,0,0,0,14000,0,0,0,14000,0,14000,14000
052579,亞泥元富96購01  ,0,0,0,0,0,0,0,0,0,14000,0,0,0,26000,12000,14000,14000
051760,奇力新元大95購04,0,0,0,0,0,0,0,0,0,14000,0,0,0,14000,0,14000,14000
051213,華新科統一95購01,0,0,0,0,0,0,0,0,0,14000,0,0,0,75000,61000,14000,14000
051166,可成元大95購02  ,0,0,0,0,0,0,0,0,0,14000,0,0,0,51000,37000,14000,14000
050493,聯發科永昌96購01,0,0,0,0,0,0,0,0,0,14000,0,0,0,69000,55000,14000,14000
050459,台表科元大94購03,0,0,0,0,0,0,0,0,0,14000,0,0,0,22000,8000,14000,14000
05268P,玉晶光元大98售01,0,0,0,0,0,0,0,0,0,14000,0,0,0,231000,217000,14000,14000
052847,漢唐統一99購01  ,0,0,0,0,0,0,0,0,0,14000,0,0,0,72000,58000,14000,14000
053230,達方台新97購01  ,0,0,0,0,0,0,0,0,0,14000,0,0,0,24000,10000,14000,14000
054672,華新科國泰99購01,0,0,0,0,0,0,0,0,0,14000,0,0,0,44000,30000,14000,14000
05467P,聯電元大95售02  ,0,0,0,0,0,0,0,0,0,14000,0,0,0,14000,0,14000,14000
054460,和大凱基97購01  ,0,0,0,0,0,0,0,0,0,14000,0,0,0,14000,0,14000,14000
054470,緯穎國票97購04  ,0,0,0,0,0,0,0,0,0,14000,0,0,0,41000,27000,14000,14000
054471,T50反1中信9C購01,0,0,0,0,0,0,0,0,0,14000,0,0,0,14000,0,14000,14000
054220,國巨統一97購02  ,0,0,0,0,0,0,0,0,0,14000,0,0,0,36000,22000,14000,14000
054173,奇力新台新97購02,0,0,0,0,0,0,0,0,0,14000,0,0,0,34000,20000,14000,14000
054825,康友元大97購01  ,0,0,0,0,0,0,0,0,0,14000,0,0,0,62000,48000,14000,14000
06448P,華通元大99售01  ,0,0,0,0,0,0,0,0,0,14000,0,0,0,18000,4000,14000,14000
1536,和大            ,402000,70000,332000,0,0,0,0,258000,-258000,-60000,0,5000,-5000,10000,65000,-55000,14000
2023,燁輝            ,63000,49000,14000,0,0,0,0,0,0,0,0,0,0,0,0,0,14000
055317,金寶國票98購01  ,0,0,0,0,0,0,0,0,0,13000,0,0,0,89000,76000,13000,13000
055693,南茂凱基97購01  ,0,0,0,0,0,0,0,0,0,13000,0,0,0,332000,319000,13000,13000
055651,富邦金元富97購01,0,0,0,0,0,0,0,0,0,13000,0,0,0,30000,17000,13000,13000
056818,正崴永豐98購01  ,0,0,0,0,0,0,0,0,0,13000,0,0,0,32000,19000,13000,13000
057039,元油2X元大9B購07,0,0,0,0,0,0,0,0,0,13000,0,0,0,13000,0,13000,13000
056996,矽力日盛99購01  ,0,0,0,0,0,0,0,0,0,13000,0,0,0,13000,0,13000,13000
06101P,聯發科日盛97售03,0,0,0,0,0,0,0,0,0,13000,0,0,0,18000,5000,13000,13000
05866P,致伸元大96售01  ,0,0,0,0,0,0,0,0,0,13000,0,0,0,19000,6000,13000,13000
05983P,聯詠國票96售02  ,0,0,0,0,0,0,0,0,0,13000,0,0,0,13000,0,13000,13000
05741P,聯發科元大96售14,0,0,0,0,0,0,0,0,0,13000,0,0,0,278000,265000,13000,13000
046950,隆達元大93購01  ,0,0,0,0,0,0,0,0,0,13000,0,0,0,13000,0,13000,13000
047295,欣興元富96購02  ,0,0,0,0,0,0,0,0,0,13000,0,0,0,18000,5000,13000,13000
048735,美利達麥證95購01,0,0,0,13000,0,13000,0,0,0,13000,0,0,0,13000,0,13000,13000
047149,聯鈞群益93購01  ,0,0,0,0,0,0,0,0,0,13000,0,0,0,13000,0,13000,13000
046785,禾伸堂永豐93購01,0,0,0,0,0,0,0,0,0,13000,0,0,0,26000,13000,13000,13000
044900,建準凱基93購01  ,0,0,0,0,0,0,0,0,0,13000,0,0,0,23000,10000,13000,13000
044516,景碩凱基93購02  ,0,0,0,0,0,0,0,0,0,13000,0,0,0,164000,151000,13000,13000
04188P,康控元富93售03  ,0,0,0,0,0,0,0,0,0,13000,0,0,0,39000,26000,13000,13000
00645,富邦日本        ,0,0,0,0,0,0,0,0,0,13000,0,0,0,119000,106000,13000,13000
00763U,街口道瓊銅      ,0,0,0,0,0,0,0,0,0,13000,0,0,0,13000,0,13000,13000
00678,群益NBI生技     ,0,0,0,0,0,0,0,0,0,13000,0,0,0,318000,305000,13000,13000
052068,瑞儀兆豐96購01  ,0,0,0,0,0,0,0,0,0,13000,0,0,0,224000,211000,13000,13000
050519,旺宏元大95購03  ,0,0,0,0,0,0,0,0,0,13000,0,0,0,76000,63000,13000,13000
049493,可成元大94購05  ,0,0,0,0,0,0,0,0,0,13000,0,0,0,40000,27000,13000,13000
050231,聯發科麥證94購03,0,0,0,45000,30000,15000,0,0,0,13000,0,0,0,45000,32000,13000,13000
050283,T50反1凱基9A購01,0,0,0,0,0,0,0,0,0,13000,0,0,0,53000,40000,13000,13000
049874,全新康和94購01  ,0,0,0,0,0,0,0,0,0,13000,0,0,0,13000,0,13000,13000
049956,國巨統一94購05  ,0,0,0,0,0,0,0,0,0,13000,0,0,0,13000,0,13000,13000
049701,聯茂元大94購05  ,0,0,0,0,0,0,0,0,0,13000,0,0,0,23000,10000,13000,13000
049611,緯穎兆豐95購02  ,0,0,0,0,0,0,0,0,0,13000,0,0,0,13000,0,13000,13000
051340,健策永豐95購03  ,0,0,0,0,0,0,0,0,0,13000,0,0,0,152000,139000,13000,13000
055164,矽創元大98購01  ,0,0,0,0,0,0,0,0,0,13000,0,0,0,150000,137000,13000,13000
055114,新日興凱基98購01,0,0,0,0,0,0,0,0,0,13000,0,0,0,37000,24000,13000,13000
054379,光磊群益98購01  ,0,0,0,0,0,0,0,0,0,13000,0,0,0,111000,98000,13000,13000
052966,光磊群益96購01  ,0,0,0,0,0,0,0,0,0,13000,0,0,0,23000,10000,13000,13000
052926,旺宏元大98購02  ,0,0,0,0,0,0,0,0,0,13000,0,0,0,301000,288000,13000,13000
053418,旺宏永豐96購02  ,0,0,0,0,0,0,0,0,0,13000,0,0,0,266000,253000,13000,13000
1708,東鹼            ,14000,1000,13000,0,0,0,0,0,0,0,0,0,0,0,0,0,13000
1340,勝悅-KY         ,14000,1000,13000,0,0,0,0,0,0,0,0,0,0,0,0,0,13000
06318P,臺股指元富97售05,0,0,0,0,0,0,0,0,0,13000,0,0,0,15000,2000,13000,13000
2897,王道銀行        ,32000,19000,13000,0,0,0,0,0,0,0,0,0,0,0,0,0,13000
2359,所羅門          ,36000,24000,12000,0,0,0,0,0,0,1000,1000,0,1000,0,0,0,13000
2431,聯昌            ,52000,39000,13000,0,0,0,0,0,0,0,0,0,0,0,0,0,13000
3416,融程電          ,16000,3000,13000,0,0,0,0,0,0,0,0,0,0,0,0,0,13000
9910,豐泰            ,226000,313300,-87300,0,0,0,0,0,0,100000,100000,0,100000,0,0,0,12700
9943,好樂迪          ,17396,5000,12396,0,0,0,0,0,0,0,0,0,0,0,0,0,12396
05804P,美律永豐96售01  ,0,0,0,0,0,0,0,0,0,12000,0,0,0,12000,0,12000,12000
056870,全新日盛9A購01  ,0,0,0,0,0,0,0,0,0,12000,0,0,0,82000,70000,12000,12000
055618,麗豐國票98購01  ,0,0,0,0,0,0,0,0,0,12000,0,0,0,14000,2000,12000,12000
056084,漢唐統一97購03  ,0,0,0,0,0,0,0,0,0,12000,0,0,0,65000,53000,12000,12000
056527,大成鋼凱基98購03,0,0,0,0,0,0,0,0,0,12000,0,0,0,22000,10000,12000,12000
04252P,台達電元富93售02,0,0,0,0,0,0,0,0,0,12000,0,0,0,12000,0,12000,12000
043605,創意元大93購01  ,0,0,0,0,0,0,0,0,0,12000,0,0,0,12000,0,12000,12000
046521,台郡元大92購06  ,0,0,0,0,0,0,0,0,0,12000,0,0,0,22000,10000,12000,12000
048426,超眾元富93購01  ,0,0,0,0,0,0,0,0,0,12000,0,0,0,12000,0,12000,12000
047525,漢唐元大93購04  ,0,0,0,0,0,0,0,0,0,12000,0,0,0,12000,0,12000,12000
047493,旺宏元富96購01  ,0,0,0,0,0,0,0,0,0,12000,0,0,0,100000,88000,12000,12000
048664,華新科統一94購01,0,0,0,0,0,0,0,0,0,12000,0,0,0,12000,0,12000,12000
046965,復盛中信93購01  ,0,0,0,0,0,0,0,0,0,12000,0,0,0,12000,0,12000,12000
047242,上銀群益93購04  ,0,0,0,0,0,0,0,0,0,12000,0,0,0,12000,0,12000,12000
051895,聯茂元富95購02  ,0,0,0,0,0,0,0,0,0,12000,0,0,0,12000,0,12000,12000
050393,樺漢統一94購01  ,0,0,0,0,0,0,0,0,0,12000,0,0,0,12000,0,12000,12000
049255,旺宏元大97購02  ,0,0,0,0,0,0,0,0,0,12000,0,0,0,18000,6000,12000,12000
049590,華新科元大94購01,0,0,0,0,0,0,0,0,0,12000,0,0,0,37000,25000,12000,12000
049591,開發金元大98購01,0,0,0,0,0,0,0,0,0,12000,0,0,0,12000,0,12000,12000
049093,昇陽半凱基94購01,0,0,0,0,0,0,0,0,0,12000,0,0,0,50000,38000,12000,12000
052424,泰碩國票97購01  ,0,0,0,0,0,0,0,0,0,12000,0,0,0,22000,10000,12000,12000
049373,大立光元大94購11,0,0,0,0,0,0,0,0,0,12000,0,0,0,12000,0,12000,12000
051519,國泰金凱基95購02,5000,0,5000,0,0,0,0,0,0,7000,0,0,0,12000,5000,7000,12000
053454,創意統一96購02  ,0,0,0,0,0,0,0,0,0,12000,0,0,0,97000,85000,12000,12000
053519,力成群益96購02  ,0,0,0,0,0,0,0,0,0,12000,0,0,0,12000,0,12000,12000
053694,創意元大96購03  ,0,0,0,0,0,0,0,0,0,12000,0,0,0,47000,35000,12000,12000
052316,台積電元大96購10,0,0,0,0,0,0,0,0,0,12000,0,0,0,100000,88000,12000,12000
053086,宏達電元大97購01,0,0,0,0,0,0,0,0,0,12000,0,0,0,33000,21000,12000,12000
054430,上銀台新96購02  ,0,0,0,0,0,0,0,0,0,12000,0,0,0,44000,32000,12000,12000
054697,凌華永豐97購01  ,0,0,0,0,0,0,0,0,0,12000,0,0,0,12000,0,12000,12000
05466P,旺宏富邦97售01  ,0,0,0,0,0,0,0,0,0,12000,0,0,0,12000,0,12000,12000
05414P,台表科國票96售02,0,0,0,0,0,0,0,0,0,12000,0,0,0,12000,0,12000,12000
054217,台表科國票97購05,0,0,0,0,0,0,0,0,0,12000,0,0,0,32000,20000,12000,12000
054214,京鼎國票97購02  ,0,0,0,0,0,0,0,0,0,12000,0,0,0,42000,30000,12000,12000
055280,智邦元大97購01  ,0,0,0,0,0,0,0,0,0,12000,0,0,0,65000,53000,12000,12000
054859,鴻海群益97購02  ,0,0,0,0,0,0,0,0,0,12000,0,0,0,110000,98000,12000,12000
054883,億光統一97購01  ,0,0,0,0,0,0,0,0,0,12000,0,0,0,30000,18000,12000,12000
054995,宏盛元富97購01  ,0,0,0,0,0,0,0,0,0,12000,0,0,0,12000,0,12000,12000
6477,安集            ,39000,27000,12000,0,0,0,0,0,0,0,0,0,0,0,0,0,12000
06340P,鴻海統一98售06  ,0,0,0,0,0,0,0,0,0,12000,0,0,0,12000,0,12000,12000
06260P,臺股指群益97售13,0,0,0,0,0,0,0,0,0,12000,0,0,0,17000,5000,12000,12000
1457,宜進            ,24000,12000,12000,0,0,0,0,0,0,0,0,0,0,0,0,0,12000
05633P,台表科群益96售04,0,0,0,0,0,0,0,0,0,11000,0,0,0,30000,19000,11000,11000
056065,奇鋐元大97購01  ,0,0,0,0,0,0,0,0,0,11000,0,0,0,48000,37000,11000,11000
055621,國巨國泰98購03  ,0,0,0,0,0,0,0,0,0,11000,0,0,0,21000,10000,11000,11000
055305,旺宏群益99購01  ,0,0,0,0,0,0,0,0,0,11000,0,0,0,11000,0,11000,11000
055379,牧德元大97購03  ,0,0,0,0,0,0,0,0,0,11000,0,0,0,220000,209000,11000,11000
055395,泰鼎統一97購01  ,0,0,0,0,0,0,0,0,0,11000,0,0,0,11000,0,11000,11000
055872,亞泥元富97購01  ,0,0,0,0,0,0,0,0,0,11000,0,0,0,11000,0,11000,11000
057038,元油2X元大9B購06,0,0,0,0,0,0,0,0,0,11000,0,0,0,12000,1000,11000,11000
05675P,美律群益97售01  ,0,0,0,0,0,0,0,0,0,11000,0,0,0,11000,0,11000,11000
056641,華通凱基98購03  ,0,0,0,0,0,0,0,0,0,11000,0,0,0,31000,20000,11000,11000
05781P,臺股指統一99售02,0,0,0,0,0,0,0,0,0,11000,0,0,0,11000,0,11000,11000
05723P,華通永豐96售03  ,0,0,0,0,0,0,0,0,0,11000,0,0,0,11000,0,11000,11000
049203,智邦群益94購01  ,0,0,0,0,0,0,0,0,0,11000,0,0,0,11000,0,11000,11000
051801,牧德永豐95購04  ,0,0,0,0,0,0,0,0,0,11000,0,0,0,21000,10000,11000,11000
046940,瑞昱元大93購07  ,0,0,0,0,0,0,0,0,0,11000,0,0,0,11000,0,11000,11000
046941,瑞昱元大93購08  ,0,0,0,0,0,0,0,0,0,11000,0,0,0,11000,0,11000,11000
047151,台積電國票94購02,0,0,0,0,0,0,0,0,0,11000,0,0,0,32000,21000,11000,11000
047117,禾伸堂元大93購02,0,0,0,0,0,0,0,0,0,11000,0,0,0,11000,0,11000,11000
047469,華通中信93購01  ,0,0,0,0,0,0,0,0,0,11000,0,0,0,38000,27000,11000,11000
047445,創意元大93購04  ,0,0,0,0,0,0,0,0,0,11000,0,0,0,11000,0,11000,11000
047574,和大群益93購03  ,0,0,0,0,0,0,0,0,0,11000,0,0,0,21000,10000,11000,11000
047638,瑞昱元大93購11  ,0,0,0,0,0,0,0,0,0,11000,0,0,0,11000,0,11000,11000
048545,嘉澤永豐93購03  ,0,0,0,0,0,0,0,0,0,11000,0,0,0,11000,0,11000,11000
048265,創意元富93購05  ,0,0,0,0,0,0,0,0,0,11000,0,0,0,11000,0,11000,11000
046659,瑞昱元大93購02  ,0,0,0,0,0,0,0,0,0,11000,0,0,0,11000,0,11000,11000
047928,禾伸堂凱基93購04,0,0,0,0,0,0,0,0,0,11000,0,0,0,12000,1000,11000,11000
04784P,超眾元富94售01  ,0,0,0,0,0,0,0,0,0,11000,0,0,0,11000,0,11000,11000
04515P,元油2X群益97售02,0,0,0,0,0,0,0,0,0,11000,0,0,0,11000,0,11000,11000
04599P,南亞科凱基94售03,0,0,0,0,0,0,0,0,0,11000,0,0,0,13000,2000,11000,11000
043730,旭富國泰93購01  ,0,0,0,0,0,0,0,0,0,11000,0,0,0,11000,0,11000,11000
044604,嘉聯益國泰93購01,0,0,0,0,0,0,0,0,0,11000,0,0,0,11000,0,11000,11000
044887,亞光麥證93購01  ,0,0,0,11000,0,11000,0,0,0,11000,0,0,0,11000,0,11000,11000
044698,奇力新元大93購01,0,0,0,0,0,0,0,0,0,11000,0,0,0,11000,0,11000,11000
04085P,欣興元富93售01  ,0,0,0,0,0,0,0,0,0,11000,0,0,0,16000,5000,11000,11000
01002T,土銀國泰R1      ,11000,0,11000,0,0,0,0,0,0,0,0,0,0,0,0,0,11000
03960P,新日興元富96售02,0,0,0,0,0,0,0,0,0,11000,0,0,0,55000,44000,11000,11000
046240,中鋼中信94購01  ,0,0,0,0,0,0,0,0,0,11000,0,0,0,115000,104000,11000,11000
051498,智易群益96購01  ,0,0,0,0,0,0,0,0,0,11000,0,0,0,11000,0,11000,11000
050410,燿華永豐95購03  ,0,0,0,0,0,0,0,0,0,11000,0,0,0,11000,0,11000,11000
049268,聯茂元大94購03  ,0,0,0,0,0,0,0,0,0,11000,0,0,0,16000,5000,11000,11000
051610,GIS群益95購02   ,0,0,0,0,0,0,0,0,0,11000,0,0,0,11000,0,11000,11000
050604,上証2X永昌94購01,0,0,0,0,0,0,0,0,0,11000,0,0,0,14000,3000,11000,11000
050050,國泰金群益94購02,0,0,0,0,0,0,0,0,0,11000,0,0,0,11000,0,11000,11000
050053,訊芯群益94購03  ,0,0,0,0,0,0,0,0,0,11000,0,0,0,11000,0,11000,11000
050670,牧德永豐94購03  ,0,0,0,0,0,0,0,0,0,11000,0,0,0,21000,10000,11000,11000
049487,智邦元大94購03  ,0,0,0,0,0,0,0,0,0,11000,0,0,0,11000,0,11000,11000
049488,智邦元大95購01  ,0,0,0,0,0,0,0,0,0,11000,0,0,0,35000,24000,11000,11000
051706,國泰金群益95購01,0,0,0,0,0,0,0,0,0,11000,0,0,0,11000,0,11000,11000
051665,台積電元大96購07,0,0,0,0,0,0,0,0,0,11000,0,0,0,11000,0,11000,11000
051226,英業達群益95購01,0,0,0,0,0,0,0,0,0,11000,0,0,0,11000,0,11000,11000
050950,健鼎群益96購01  ,0,0,0,0,0,0,0,0,0,11000,0,0,0,11000,0,11000,11000
051123,和鑫群益95購01  ,0,0,0,0,0,0,0,0,0,11000,0,0,0,11000,0,11000,11000
052506,日月光日盛95購01,0,0,0,0,0,0,0,0,0,11000,0,0,0,21000,10000,11000,11000
052167,亞泥元大96購01  ,0,0,0,0,0,0,0,0,0,11000,0,0,0,11000,0,11000,11000
051063,台郡群益95購01  ,0,0,0,0,0,0,0,0,0,11000,0,0,0,91000,80000,11000,11000
049105,亞泥富邦94購01  ,0,0,0,0,0,0,0,0,0,11000,0,0,0,11000,0,11000,11000
049044,和碩兆豐94購01  ,0,0,0,0,0,0,0,0,0,11000,0,0,0,11000,0,11000,11000
049019,美律群益94購02  ,0,0,0,0,0,0,0,0,0,11000,0,0,0,11000,0,11000,11000
05135P,鴻海凱基96售07  ,0,0,0,0,0,0,0,0,0,11000,0,0,0,11000,0,11000,11000
051385,矽創群益95購01  ,0,0,0,0,0,0,0,0,0,11000,0,0,0,11000,0,11000,11000
049554,禾伸堂富邦96購01,0,0,0,0,0,0,0,0,0,11000,0,0,0,77000,66000,11000,11000
049549,瀚宇博群益94購01,0,0,0,0,0,0,0,0,0,11000,0,0,0,11000,0,11000,11000
054876,群電群益97購02  ,0,0,0,0,0,0,0,0,0,11000,0,0,0,11000,0,11000,11000
05469P,台積電元大95售24,0,0,0,0,0,0,0,0,0,11000,0,0,0,985000,974000,11000,11000
054778,世紀鋼國票99購01,0,0,0,0,0,0,0,0,0,11000,0,0,0,54000,43000,11000,11000
054281,世芯群益97購01  ,0,0,0,0,0,0,0,0,0,11000,0,0,0,11000,0,11000,11000
054344,景碩國票97購04  ,0,0,0,0,0,0,0,0,0,11000,0,0,0,41000,30000,11000,11000
054146,康友元大96購06  ,0,0,0,0,0,0,0,0,0,11000,0,0,0,72000,61000,11000,11000
054053,聯茂元大96購01  ,0,0,0,0,0,0,0,0,0,11000,0,0,0,83000,72000,11000,11000
054648,智原群益98購01  ,0,0,0,0,0,0,0,0,0,11000,0,0,0,11000,0,11000,11000
054570,易華電群益98購01,0,0,0,0,0,0,0,0,0,11000,0,0,0,11000,0,11000,11000
053089,貿聯元大97購02  ,0,0,0,0,0,0,0,0,0,11000,0,0,0,13000,2000,11000,11000
052967,智邦群益96購01  ,0,0,0,0,0,0,0,0,0,11000,0,0,0,53000,42000,11000,11000
052974,瀚宇博群益96購01,0,0,0,0,0,0,0,0,0,11000,0,0,0,11000,0,11000,11000
053302,國巨凱基96購10  ,0,0,0,0,0,0,0,0,0,11000,0,0,0,81000,70000,11000,11000
05291P,鴻海凱基95售16  ,0,0,0,0,0,0,0,0,0,11000,0,0,0,20000,9000,11000,11000
052869,新日興凱基96購01,0,0,0,0,0,0,0,0,0,11000,0,0,0,32000,21000,11000,11000
052713,智邦凱基96購01  ,0,0,0,0,0,0,0,0,0,11000,0,0,0,12000,1000,11000,11000
052761,可成群益96購02  ,0,0,0,0,0,0,0,0,0,11000,0,0,0,63000,52000,11000,11000
05280P,華通元大95售08  ,0,0,0,0,0,0,0,0,0,11000,0,0,0,16000,5000,11000,11000
053895,智易群益96購02  ,0,0,0,0,0,0,0,0,0,11000,0,0,0,11000,0,11000,11000
053467,鴻海元大96購20  ,0,0,0,0,0,0,0,0,0,11000,0,0,0,216000,205000,11000,11000
053325,GIS群益96購02   ,0,0,0,0,0,0,0,0,0,11000,0,0,0,11000,0,11000,11000
053338,台光電國票97購01,0,0,0,0,0,0,0,0,0,11000,0,0,0,11000,0,11000,11000
1436,華友聯          ,15000,4000,11000,0,0,0,0,0,0,0,0,0,0,0,0,0,11000
06657P,寶成元大98售01  ,0,0,0,0,0,0,0,0,0,11000,0,0,0,11000,0,11000,11000
06434P,超眾群益98售02  ,0,0,0,0,0,0,0,0,0,11000,0,0,0,11000,0,11000,11000
3094,聯傑            ,47000,36000,11000,0,0,0,0,0,0,0,0,0,0,0,0,0,11000
4766,南寶            ,31000,20000,11000,0,0,0,0,0,0,0,0,0,0,0,0,0,11000
2420,新巨            ,25000,14000,11000,0,0,0,0,0,0,0,0,0,0,0,0,0,11000
2850,新產            ,20000,9000,11000,0,0,0,0,0,0,0,0,0,0,0,0,0,11000
057247,元油2X統一9A購01,0,0,0,0,0,0,0,0,0,10000,0,0,0,10000,0,10000,10000
057211,鴻海群益98購05  ,0,0,0,0,0,0,0,0,0,10000,0,0,0,31000,21000,10000,10000
057195,南茂元大98購01  ,0,0,0,0,0,0,0,0,0,10000,0,0,0,19000,9000,10000,10000
057208,上海銀元富98購01,0,0,0,0,0,0,0,0,0,10000,0,0,0,68000,58000,10000,10000
05733P,臺股指統一96售03,0,0,0,0,0,0,0,0,0,10000,0,0,0,20000,10000,10000,10000
05787P,臺股指永昌96售04,0,0,0,0,0,0,0,0,0,10000,510000,20000,490000,50000,530000,-480000,10000
05795P,華邦電群益96售05,0,0,0,0,0,0,0,0,0,10000,0,0,0,10000,0,10000,10000
05802P,臺股指兆豐96售02,0,0,0,0,0,0,0,0,0,10000,0,0,0,10000,0,10000,10000
05806P,宏達電永豐96售03,0,0,0,0,0,0,0,0,0,10000,0,0,0,10000,0,10000,10000
05811P,臺股指國票96售04,0,0,0,0,0,0,0,0,0,10000,0,0,0,10000,0,10000,10000
05758P,光罩永豐96售02  ,0,0,0,0,0,0,0,0,0,10000,0,0,0,10000,0,10000,10000
05773P,臺股指凱基99售03,0,0,0,0,0,0,0,0,0,10000,0,0,0,10000,0,10000,10000
05984P,台積電統一98售01,0,0,0,0,0,0,0,0,0,10000,0,0,0,10000,0,10000,10000
05971P,世紀鋼永豐96售04,0,0,0,0,0,0,0,0,0,10000,0,0,0,10000,0,10000,10000
05964P,華通凱基96售06  ,0,0,0,0,0,0,0,0,0,10000,0,0,0,10000,0,10000,10000
05919P,京鼎元大96售03  ,0,0,0,0,0,0,0,0,0,10000,0,0,0,10000,0,10000,10000
05958P,聯發科國票97售04,0,0,0,0,0,0,0,0,0,10000,0,0,0,10000,0,10000,10000
05959P,聯發科國票98售01,0,0,0,0,0,0,0,0,0,10000,0,0,0,10000,0,10000,10000
05870P,聯發科凱基96售19,0,0,0,0,0,0,0,0,0,10000,0,0,0,12000,2000,10000,10000
06099P,鴻海日盛97售03  ,0,0,0,0,0,0,0,0,0,10000,0,0,0,10000,0,10000,10000
06086P,台積電康和97售01,0,0,0,0,0,0,0,0,0,10000,0,0,0,10000,0,10000,10000
06026P,華通台新97售01  ,0,0,0,0,0,0,0,0,0,10000,0,0,0,10000,0,10000,10000
06031P,新光金兆豐96售02,0,0,0,0,0,0,0,0,0,10000,0,0,0,10000,0,10000,10000
06053P,緯穎國票97售05  ,0,0,0,0,0,0,0,0,0,10000,0,0,0,10000,0,10000,10000
06144P,台光電永豐97售01,0,0,0,0,0,0,0,0,0,10000,0,0,0,10000,0,10000,10000
06115P,台積電統一97售04,0,0,0,0,0,0,0,0,0,10000,0,0,0,10000,0,10000,10000
056606,華新科富邦9A購02,0,0,0,0,0,0,0,0,0,10000,0,0,0,30000,20000,10000,10000
05662P,景碩元富96售01  ,0,0,0,0,0,0,0,0,0,10000,0,0,0,16000,6000,10000,10000
056665,上証2X國票99購02,0,0,0,0,0,0,0,0,0,10000,0,0,0,25000,15000,10000,10000
056668,光磊國票99購01  ,0,0,0,0,0,0,0,0,0,10000,0,0,0,10000,0,10000,10000
056581,超眾元大99購01  ,0,0,0,0,0,0,0,0,0,10000,0,0,0,15000,5000,10000,10000
056752,國巨兆豐98購02  ,0,0,0,0,0,0,0,0,0,10000,0,0,0,10000,0,10000,10000
056788,日月光群益98購01,0,0,0,0,0,0,0,0,0,10000,0,0,0,10000,0,10000,10000
056731,國巨凱基98購04  ,0,0,0,0,0,0,0,0,0,10000,0,0,0,10000,0,10000,10000
052213,富邦金元大95購01,0,0,0,0,0,0,0,0,0,10000,0,0,0,10000,0,10000,10000
056910,超眾元大99購02  ,0,0,0,0,0,0,0,0,0,10000,0,0,0,19000,9000,10000,10000
056943,華通統一99購01  ,0,0,0,0,0,0,0,0,0,10000,0,0,0,10000,0,10000,10000
056949,義隆統一98購01  ,0,0,0,0,0,0,0,0,0,10000,0,0,0,10000,0,10000,10000
05695P,台積電凱基96售10,0,0,0,0,0,0,0,0,0,10000,0,0,0,10000,0,10000,10000
056967,奇鋐永豐98購01  ,0,0,0,0,0,0,0,0,0,10000,0,0,0,20000,10000,10000,10000
057015,元油2X凱基9B購04,0,0,0,0,0,0,0,0,0,10000,0,0,0,10000,0,10000,10000
055894,欣興統一97購03  ,0,0,0,0,0,0,0,0,0,10000,0,0,0,10000,0,10000,10000
055904,貿聯亞東99購01  ,0,0,0,0,0,0,0,0,0,10000,0,0,0,10000,0,10000,10000
055781,聯詠凱基98購01  ,0,0,0,0,0,0,0,0,0,10000,0,0,0,13000,3000,10000,10000
055818,晶相光國票97購02,0,0,0,0,0,0,0,0,0,10000,0,0,0,45000,35000,10000,10000
05564P,玉晶光元大97售02,0,0,0,0,0,0,0,0,0,10000,0,0,0,30000,20000,10000,10000
055646,漢唐元富97購01  ,0,0,0,0,0,0,0,0,0,10000,0,0,0,10000,0,10000,10000
055689,台郡凱基99購01  ,0,0,0,0,0,0,0,0,0,10000,0,0,0,23000,13000,10000,10000
055755,禾伸堂兆豐97購02,0,0,0,0,0,0,0,0,0,10000,0,0,0,30000,20000,10000,10000
055377,揚明光元大98購01,0,0,0,0,0,0,0,0,0,10000,0,0,0,10000,0,10000,10000
055386,致新元大97購02  ,0,0,0,0,0,0,0,0,0,10000,0,0,0,20000,10000,10000,10000
05543P,鴻海元富96售04  ,0,0,0,0,0,0,0,0,0,10000,0,0,0,10000,0,10000,10000
055337,超眾兆豐98購01  ,0,0,0,0,0,0,0,0,0,10000,0,0,0,20000,10000,10000,10000
055616,智原國票97購03  ,0,0,0,0,0,0,0,0,0,10000,0,0,0,10000,0,10000,10000
055583,國巨元大97購10  ,0,0,0,0,0,0,0,0,0,10000,0,0,0,10000,0,10000,10000
055593,華新科元大97購10,0,0,0,0,0,0,0,0,0,10000,0,0,0,415000,405000,10000,10000
055544,鴻海凱基97購05  ,0,0,0,0,0,0,0,0,0,10000,0,0,0,20000,10000,10000,10000
055571,鴻海統一97購03  ,0,0,0,0,0,0,0,0,0,10000,0,0,0,10000,0,10000,10000
055572,鴻海統一98購04  ,0,0,0,0,0,0,0,0,0,10000,0,0,0,258000,248000,10000,10000
055528,華邦電群益97購01,0,0,0,0,0,0,0,0,0,10000,0,0,0,10000,0,10000,10000
055484,華通元大97購04  ,0,0,0,0,0,0,0,0,0,10000,0,0,0,12000,2000,10000,10000
056076,超眾元大97購05  ,0,0,0,0,0,0,0,0,0,10000,0,0,0,36000,26000,10000,10000
056030,華通日盛97購01  ,0,0,0,0,0,0,0,0,0,10000,0,0,0,10000,0,10000,10000
056008,全新中信9B購01  ,0,0,0,0,0,0,0,0,0,10000,0,0,0,110000,100000,10000,10000
055983,全新元富9A購02  ,0,0,0,0,0,0,0,0,0,10000,0,0,0,20000,10000,10000,10000
055960,義隆元大97購01  ,0,0,0,0,0,0,0,0,0,10000,0,0,0,40000,30000,10000,10000
056097,訊芯元富97購02  ,0,0,0,0,0,0,0,0,0,10000,0,0,0,10000,0,10000,10000
056159,牧德凱基99購01  ,0,0,0,0,0,0,0,0,0,10000,0,0,0,60000,50000,10000,10000
056174,億光元富97購01  ,0,0,0,0,0,0,0,0,0,10000,0,0,0,10000,0,10000,10000
056209,超眾永豐97購02  ,0,0,0,0,0,0,0,0,0,10000,0,0,0,10000,0,10000,10000
056330,玉晶光國票99購03,0,0,0,0,0,0,0,0,0,10000,0,0,0,10000,0,10000,10000
056383,上銀國泰99購01  ,0,0,0,0,0,0,0,0,0,10000,0,0,0,20000,10000,10000,10000
056307,貿聯元大97購05  ,0,0,0,0,0,0,0,0,0,10000,0,0,0,55000,45000,10000,10000
056519,創意國票99購01  ,0,0,0,0,0,0,0,0,0,10000,0,0,0,13000,3000,10000,10000
056525,T50反1凱基99購06,0,0,0,0,0,0,0,0,0,10000,0,0,0,10000,0,10000,10000
056417,欣興中信98購01  ,0,0,0,0,0,0,0,0,0,10000,0,0,0,10000,0,10000,10000
056462,訊芯凱基98購03  ,0,0,0,0,0,0,0,0,0,10000,0,0,0,231000,221000,10000,10000
05645P,聯發科凱基96售13,0,0,0,0,0,0,0,0,0,10000,0,0,0,39000,29000,10000,10000
056456,群創凱基9B購01  ,0,0,0,0,0,0,0,0,0,10000,0,0,0,20000,10000,10000,10000
046242,大立光中信93購02,0,0,0,0,0,0,0,0,0,10000,0,0,0,10000,0,10000,10000
04619P,華新統一94售02  ,0,0,0,0,0,0,0,0,0,10000,0,0,0,10000,0,10000,10000
046186,南亞科凱基92購03,0,0,0,0,0,0,0,0,0,10000,0,0,0,10000,0,10000,10000
046307,瑞昱元大92購03  ,0,0,0,0,0,0,0,0,0,10000,0,0,0,10000,0,10000,10000
042916,佐登元大94購01  ,0,0,0,0,0,0,0,0,0,10000,0,0,0,26000,16000,10000,10000
042942,永冠國票94購01  ,0,0,0,0,0,0,0,0,0,10000,0,0,0,10000,0,10000,10000
046301,亞泥元大92購02  ,0,0,0,0,0,0,0,0,0,10000,0,0,0,10000,0,10000,10000
04565P,聯詠凱基94售01  ,0,0,0,0,0,0,0,0,0,10000,0,0,0,10000,0,10000,10000
045643,臻鼎凱基93購01  ,0,0,0,0,0,0,0,0,0,10000,0,0,0,10000,0,10000,10000
045627,聯電凱基93購03  ,0,0,0,0,0,0,0,0,0,10000,0,0,0,10000,0,10000,10000
045694,智邦兆豐93購05  ,0,0,0,0,0,0,0,0,0,10000,0,0,0,10000,0,10000,10000
04326P,泰鼎元大93售06  ,0,0,0,0,0,0,0,0,0,10000,0,0,0,10000,0,10000,10000
043148,裕隆統一93購01  ,0,0,0,0,0,0,0,0,0,10000,0,0,0,10000,0,10000,10000
03904P,啟碁統一93售01  ,0,0,0,0,0,0,0,0,0,10000,0,0,0,14000,4000,10000,10000
04032P,聯茂凱基94售02  ,0,0,0,0,0,0,0,0,0,10000,0,0,0,10000,0,10000,10000
03665P,華邦電永豐92售01,0,0,0,0,0,0,0,0,0,10000,0,0,0,10000,0,10000,10000
03859P,聯詠元富93售04  ,0,0,0,0,0,0,0,0,0,10000,0,0,0,10000,0,10000,10000
03020X,元展20          ,0,0,0,0,0,0,0,0,0,10000,0,0,0,10000,0,10000,10000
04033P,啟碁凱基93售04  ,0,0,0,0,0,0,0,0,0,10000,0,0,0,10000,0,10000,10000
04062P,可成兆豐93售04  ,0,0,0,0,0,0,0,0,0,10000,0,0,0,10000,0,10000,10000
04152P,喬山永豐93售02  ,0,0,0,0,0,0,0,0,0,10000,0,0,0,20000,10000,10000,10000
04226P,宏達電元富93售01,0,0,0,0,0,0,0,0,0,10000,0,0,0,10000,0,10000,10000
042561,南電兆豐92購01  ,0,0,0,0,0,0,0,0,0,10000,0,0,0,10000,0,10000,10000
042679,群創元大92購02  ,0,0,0,0,0,0,0,0,0,10000,0,0,0,10000,0,10000,10000
04262P,景碩群益93售03  ,0,0,0,0,0,0,0,0,0,10000,0,0,0,10000,0,10000,10000
04276P,聯發科凱基93售33,0,0,0,0,0,0,0,0,0,10000,0,0,0,86000,76000,10000,10000
044759,新日興凱基93購01,0,0,0,0,0,0,0,0,0,10000,0,0,0,40000,30000,10000,10000
044536,深中小群益92購01,0,0,0,0,0,0,0,0,0,10000,0,0,0,10000,0,10000,10000
044463,全新兆豐93購01  ,0,0,0,0,0,0,0,0,0,10000,0,0,0,10000,0,10000,10000
04382P,美律國泰95售01  ,0,0,0,0,0,0,0,0,0,10000,0,0,0,10000,0,10000,10000
043912,華新科凱基93購01,0,0,0,0,0,0,0,0,0,10000,0,0,0,10000,0,10000,10000
044011,鴻海凱基93購03  ,0,0,0,0,0,0,0,0,0,10000,0,0,0,10000,0,10000,10000
044025,台表科凱基93購02,0,0,0,0,0,0,0,0,0,10000,0,0,0,30000,20000,10000,10000
044305,瀚宇博兆豐93購01,0,0,0,0,0,0,0,0,0,10000,0,0,0,10000,0,10000,10000
044284,聯電凱基92購01  ,0,0,0,0,0,0,0,0,0,10000,0,0,0,20000,10000,10000,10000
045967,日電貿凱基92購01,0,0,0,0,0,0,0,0,0,10000,0,0,0,10000,0,10000,10000
046026,友訊元大92購01  ,0,0,0,0,0,0,0,0,0,10000,0,0,0,10000,0,10000,10000
045825,力成凱基93購02  ,0,0,0,0,0,0,0,0,0,10000,0,0,0,10000,0,10000,10000
045906,鴻海中信94購01  ,0,0,0,0,0,0,0,0,0,10000,0,0,0,10000,0,10000,10000
04583P,滬深2X永豐94售06,0,0,0,0,0,0,0,0,0,10000,0,0,0,10000,0,10000,10000
045069,美律元大93購03  ,0,0,0,0,0,0,0,0,0,10000,0,0,0,10000,0,10000,10000
045393,寶齡國泰93購01  ,0,0,0,0,0,0,0,0,0,10000,0,0,0,10000,0,10000,10000
04532P,臺股指凱基94售04,0,0,0,0,0,0,0,0,0,10000,0,0,0,10000,0,10000,10000
046319,新日興元大92購03,0,0,0,0,0,0,0,0,0,10000,0,0,0,10000,0,10000,10000
047879,台積電中信93購04,0,0,0,0,0,0,0,0,0,10000,0,0,0,10000,0,10000,10000
047809,瑞昱凱基93購08  ,0,0,0,0,0,0,0,0,0,10000,0,0,0,10000,0,10000,10000
046370,全新麥證93購01  ,0,0,0,10000,0,10000,0,0,0,10000,0,0,0,10000,0,10000,10000
046356,智伸科群益93購01,0,0,0,0,0,0,0,0,0,10000,0,0,0,24000,14000,10000,10000
046391,上海銀統一94購01,0,0,0,0,0,0,0,0,0,10000,0,0,0,10000,0,10000,10000
046557,亞泥凱基93購02  ,0,0,0,0,0,0,0,0,0,10000,0,0,0,175000,165000,10000,10000
046578,聯電元大92購01  ,0,0,0,0,0,0,0,0,0,10000,0,0,0,10000,0,10000,10000
046455,瑞昱凱基92購03  ,0,0,0,0,0,0,0,0,0,10000,0,0,0,10000,0,10000,10000
046457,可成凱基92購09  ,0,0,0,0,0,0,0,0,0,10000,0,0,0,20000,10000,10000,10000
046426,臻鼎元大92購13  ,0,0,0,0,0,0,0,0,0,10000,0,0,0,10000,0,10000,10000
046692,鴻海凱基93購15  ,0,0,0,0,0,0,0,0,0,10000,0,0,0,10000,0,10000,10000
046694,智邦凱基93購01  ,0,0,0,0,0,0,0,0,0,10000,0,0,0,10000,0,10000,10000
048108,鴻海群益93購07  ,0,0,0,0,0,0,0,0,0,10000,0,0,0,34000,24000,10000,10000
048194,華邦電元大94購04,0,0,0,0,0,0,0,0,0,10000,0,0,0,10000,0,10000,10000
046620,智伸科凱基93購01,0,0,0,0,0,0,0,0,0,10000,0,0,0,10000,0,10000,10000
046621,智伸科凱基93購02,0,0,0,0,0,0,0,0,0,10000,0,0,0,10000,0,10000,10000
046592,南電元大92購03  ,0,0,0,0,0,0,0,0,0,10000,0,0,0,10000,0,10000,10000
048052,力成中信93購01  ,0,0,0,0,0,0,0,0,0,10000,0,0,0,10000,0,10000,10000
048236,A50正2國票97購02,0,0,0,0,0,0,0,0,0,10000,0,0,0,10000,0,10000,10000
048272,新光金富邦98購01,0,0,0,0,0,0,0,0,0,10000,0,0,0,10000,0,10000,10000
048283,亞德客中信94購01,0,0,0,0,0,0,0,0,0,10000,0,0,0,30000,20000,10000,10000
048371,華固統一93購02  ,0,0,0,0,0,0,0,0,0,10000,0,0,0,10000,0,10000,10000
048338,正崴元大93購01  ,0,0,0,0,0,0,0,0,0,10000,0,0,0,10000,0,10000,10000
048305,深100凱基96購01 ,0,0,0,0,0,0,0,0,0,10000,0,0,0,10000,0,10000,10000
04831P,聯詠富邦96售01  ,0,0,0,0,0,0,0,0,0,10000,0,0,0,10000,0,10000,10000
046795,瀚宇博元富93購01,0,0,0,0,0,0,0,0,0,10000,0,0,0,10000,0,10000,10000
046758,聯發科凱基93購05,0,0,0,0,0,0,0,0,0,10000,0,0,0,20000,10000,10000,10000
048220,鴻海凱基93購35  ,0,0,0,0,0,0,0,0,0,10000,0,0,0,10000,0,10000,10000
048221,鴻海凱基95購01  ,0,0,0,0,0,0,0,0,0,10000,0,0,0,12000,2000,10000,10000
048222,台積電凱基93購26,0,0,0,0,0,0,0,0,0,10000,0,0,0,10000,0,10000,10000
046813,聯電凱基96購01  ,0,0,0,0,0,0,0,0,0,10000,0,0,0,10000,0,10000,10000
046814,鴻海凱基93購20  ,0,0,0,0,0,0,0,0,0,10000,0,0,0,10000,0,10000,10000
046802,聯電元大93購01  ,0,0,0,0,0,0,0,0,0,10000,0,0,0,10000,0,10000,10000
046838,勤誠群益93購01  ,0,0,0,0,0,0,0,0,0,10000,0,0,0,10000,0,10000,10000
046913,世紀鋼凱基93購07,0,0,0,0,0,0,0,0,0,10000,0,0,0,10000,0,10000,10000
04691P,智邦群益94售02  ,0,0,0,0,0,0,0,0,0,10000,0,0,0,10000,0,10000,10000
046901,英業達凱基93購02,0,0,0,0,0,0,0,0,0,10000,0,0,0,10000,0,10000,10000
046903,友達凱基99購01  ,0,0,0,0,0,0,0,0,0,10000,0,0,0,10000,0,10000,10000
04853P,易華電永豐94售03,0,0,0,0,0,0,0,0,0,10000,0,0,0,10000,0,10000,10000
047751,玉山金元富93購01,0,0,0,0,0,0,0,0,0,10000,0,0,0,10000,0,10000,10000
047737,義隆麥證94購01  ,0,0,0,10000,0,10000,0,0,0,10000,0,0,0,10000,0,10000,10000
047764,燿華元大93購03  ,0,0,0,0,0,0,0,0,0,10000,0,0,0,10000,0,10000,10000
047632,儒鴻元大93購08  ,0,0,0,0,0,0,0,0,0,10000,0,0,0,10000,0,10000,10000
047583,深中小永豐94購01,0,0,0,0,0,0,0,0,0,10000,0,0,0,10000,0,10000,10000
047584,元金2X永豐95購01,0,0,0,0,0,0,0,0,0,10000,0,0,0,10000,0,10000,10000
047716,晶技凱基93購03  ,0,0,0,0,0,0,0,0,0,10000,0,0,0,14000,4000,10000,10000
047711,華新科凱基94購03,0,0,0,0,0,0,0,0,0,10000,0,0,0,19000,9000,10000,10000
047542,華通凱基94購02  ,0,0,0,0,0,0,0,0,0,10000,0,0,0,20000,10000,10000,10000
047547,友達凱基99購02  ,0,0,0,0,0,0,0,0,0,10000,0,0,0,10000,0,10000,10000
047522,微星元大93購02  ,0,0,0,0,0,0,0,0,0,10000,0,0,0,20000,10000,10000,10000
046927,上銀富邦95購01  ,0,0,0,0,0,0,0,0,0,10000,0,0,0,10000,0,10000,10000
046937,聯電元大99購01  ,0,0,0,0,0,0,0,0,0,10000,0,0,0,10000,0,10000,10000
047376,南電國票94購01  ,0,0,0,0,0,0,0,0,0,10000,0,0,0,10000,0,10000,10000
047138,智伸科凱基93購04,0,0,0,0,0,0,0,0,0,10000,0,0,0,10000,0,10000,10000
047127,臻鼎中信95購01  ,0,0,0,0,0,0,0,0,0,10000,0,0,0,30000,20000,10000,10000
047181,智邦元大93購06  ,0,0,0,0,0,0,0,0,0,10000,0,0,0,10000,0,10000,10000
048683,日月光富邦93購01,0,0,0,0,0,0,0,0,0,10000,0,0,0,10000,0,10000,10000
048728,台達電麥證94購01,0,0,0,10000,0,10000,0,0,0,10000,0,0,0,10000,0,10000,10000
047063,漢唐凱基95購01  ,0,0,0,0,0,0,0,0,0,10000,0,0,0,10000,0,10000,10000
048792,瑞儀元大94購01  ,0,0,0,0,0,0,0,0,0,10000,0,0,0,10000,0,10000,10000
04697P,臺股指元富94售03,0,0,0,0,0,0,0,0,0,10000,0,0,0,10000,0,10000,10000
047236,智伸科凱基93購05,0,0,0,0,0,0,0,0,0,10000,0,0,0,10000,0,10000,10000
047290,台積電元富93購04,0,0,0,0,0,0,0,0,0,10000,0,0,0,20000,10000,10000,10000
047309,鴻海元大93購13  ,0,0,0,0,0,0,0,0,0,10000,0,0,0,10000,0,10000,10000
05189P,新光金凱基97售02,0,0,0,0,0,0,0,0,0,10000,0,0,0,10000,0,10000,10000
051906,國巨元大95購09  ,0,0,0,0,0,0,0,0,0,10000,0,0,0,10000,0,10000,10000
051841,南茂國泰96購01  ,0,0,0,0,0,0,0,0,0,10000,0,0,0,40000,30000,10000,10000
049172,鴻海凱基94購14  ,0,0,0,0,0,0,0,0,0,10000,0,0,0,52000,42000,10000,10000
048702,正文國票95購01  ,0,0,0,0,0,0,0,0,0,10000,0,0,0,10000,0,10000,10000
048693,GIS群益94購02   ,0,0,0,0,0,0,0,0,0,10000,0,0,0,10000,0,10000,10000
048712,樺漢台新94購01  ,0,0,0,0,0,0,0,0,0,10000,0,0,0,10000,0,10000,10000
049197,信邦永豐94購01  ,0,0,0,0,0,0,0,0,0,10000,0,0,0,10000,0,10000,10000
049199,茂林永豐95購01  ,0,0,0,0,0,0,0,0,0,10000,0,0,0,10000,0,10000,10000
049218,燿華國票94購02  ,0,0,0,0,0,0,0,0,0,10000,0,0,0,10000,0,10000,10000
049228,台塑富邦94購01  ,0,0,0,0,0,0,0,0,0,10000,0,0,0,20000,10000,10000,10000
049229,台化富邦94購01  ,0,0,0,0,0,0,0,0,0,10000,0,0,0,10000,0,10000,10000
050383,超眾兆豐95購01  ,0,0,0,0,0,0,0,0,0,10000,0,0,0,10000,0,10000,10000
049260,華新科元大96購01,0,0,0,0,0,0,0,0,0,10000,0,0,0,10000,0,10000,10000
050332,鴻海國泰96購05  ,0,0,0,0,0,0,0,0,0,10000,0,0,0,23000,13000,10000,10000
050356,緯穎群益94購05  ,0,0,0,0,0,0,0,0,0,10000,0,0,0,31000,21000,10000,10000
049528,台積電中信94購01,0,0,0,0,0,0,0,0,0,10000,0,0,0,20000,10000,10000,10000
050808,台達電凱基96購02,0,0,0,0,0,0,0,0,0,10000,0,0,0,10000,0,10000,10000
050832,力成凱基95購01  ,0,0,0,0,0,0,0,0,0,10000,0,0,0,10000,0,10000,10000
050838,為升國票96購01  ,0,0,0,0,0,0,0,0,0,10000,0,0,0,10000,0,10000,10000
051394,奇鋐兆豐95購01  ,0,0,0,0,0,0,0,0,0,10000,0,0,0,10000,0,10000,10000
051400,國巨永豐95購01  ,0,0,0,0,0,0,0,0,0,10000,0,0,0,20000,10000,10000,10000
051421,彩晶國票95購01  ,0,0,0,0,0,0,0,0,0,10000,0,0,0,10000,0,10000,10000
051347,國巨元大95購06  ,0,0,0,0,0,0,0,0,0,10000,0,0,0,10000,0,10000,10000
049688,台光電元大94購04,0,0,0,0,0,0,0,0,0,10000,0,0,0,10000,0,10000,10000
048828,禾伸堂凱基94購02,0,0,0,0,0,0,0,0,0,10000,0,0,0,21000,11000,10000,10000
04901P,臺股指麥證94售02,0,0,0,10000,0,10000,0,0,0,10000,0,0,0,10000,0,10000,10000
049013,川湖群益94購01  ,0,0,0,0,0,0,0,0,0,10000,0,0,0,10000,0,10000,10000
048863,超眾群益94購01  ,0,0,0,0,0,0,0,0,0,10000,0,0,0,10000,0,10000,10000
048859,玉晶光群益96購02,0,0,0,0,0,0,0,0,0,10000,0,0,0,10000,0,10000,10000
04894P,世紀鋼元大94售02,0,0,0,0,0,0,0,0,0,10000,0,0,0,20000,10000,10000,10000
04896P,上証2X中信95售01,0,0,0,0,0,0,0,0,0,10000,0,0,0,10000,0,10000,10000
048959,凌華康和94購01  ,0,0,0,0,0,0,0,0,0,10000,0,0,0,10000,0,10000,10000
049948,聯發科麥證94購01,0,0,0,40000,30000,10000,0,0,0,10000,0,0,0,40000,30000,10000,10000
049727,台積電中信94購02,0,0,0,0,0,0,0,0,0,10000,0,0,0,20000,10000,10000,10000
049751,牧德永豐95購01  ,0,0,0,0,0,0,0,0,0,10000,0,0,0,10000,0,10000,10000
049760,滬深2X國泰95購02,0,0,0,0,0,0,0,0,0,10000,0,0,0,10000,0,10000,10000
051045,南茂永豐95購01  ,0,0,0,0,0,0,0,0,0,10000,0,0,0,10000,0,10000,10000
049857,緯穎群益94購03  ,0,0,0,0,0,0,0,0,0,10000,0,0,0,10000,0,10000,10000
049157,矽創元大95購01  ,0,0,0,0,0,0,0,0,0,10000,0,0,0,10000,0,10000,10000
049807,新光金元大96購02,0,0,0,0,0,0,0,0,0,10000,0,0,0,10000,0,10000,10000
052104,英業達兆豐96購01,0,0,0,0,0,0,0,0,0,10000,0,0,0,20000,10000,10000,10000
049916,台光電元大94購06,0,0,0,0,0,0,0,0,0,10000,0,0,0,10000,0,10000,10000
049923,智原元大95購02  ,0,0,0,0,0,0,0,0,0,10000,0,0,0,10000,0,10000,10000
051087,國巨元大97購01  ,0,0,0,0,0,0,0,0,0,10000,0,0,0,10000,0,10000,10000
051078,力山富邦97購01  ,0,0,0,0,0,0,0,0,0,10000,0,0,0,10000,0,10000,10000
053036,聯電凱基98購01  ,0,0,0,0,0,0,0,0,0,10000,0,0,0,208000,198000,10000,10000
052998,拓凱康和96購01  ,0,0,0,0,0,0,0,0,0,10000,0,0,0,10000,0,10000,10000
053020,貿聯元富96購01  ,0,0,0,0,0,0,0,0,0,10000,0,0,0,10000,0,10000,10000
052186,宏達電群益95購04,0,0,0,0,0,0,0,0,0,10000,0,0,0,12000,2000,10000,10000
052362,瑞昱國票96購02  ,0,0,0,0,0,0,0,0,0,10000,0,0,0,10000,0,10000,10000
052536,聯茂國泰97購01  ,0,0,0,0,0,0,0,0,0,10000,0,0,0,20000,10000,10000,10000
052496,華通台新96購02  ,0,0,0,0,0,0,0,0,0,10000,0,0,0,10000,0,10000,10000
052581,訊芯元富98購01  ,0,0,0,0,0,0,0,0,0,10000,0,0,0,10000,0,10000,10000
052561,矽創國票97購01  ,0,0,0,0,0,0,0,0,0,10000,0,0,0,30000,20000,10000,10000
052570,華新科凱基96購06,0,0,0,0,0,0,0,0,0,10000,0,0,0,10000,0,10000,10000
052611,力成元大96購02  ,0,0,0,0,0,0,0,0,0,10000,0,0,0,10000,0,10000,10000
052682,上銀元大97購01  ,0,0,0,0,0,0,0,0,0,10000,0,0,0,10000,0,10000,10000
051106,華通統一95購02  ,0,0,0,0,0,0,0,0,0,10000,0,0,0,10000,0,10000,10000
051763,新光金元大98購01,0,0,0,0,0,0,0,0,0,10000,0,0,0,10000,0,10000,10000
051742,欣興國票96購01  ,0,0,0,0,0,0,0,0,0,10000,0,0,0,20000,10000,10000,10000
051748,超眾國泰96購01  ,0,0,0,0,0,0,0,0,0,10000,0,0,0,10000,0,10000,10000
051767,臻鼎元大95購03  ,0,0,0,0,0,0,0,0,0,10000,0,0,0,10000,0,10000,10000
050771,華新科元大94購06,0,0,0,0,0,0,0,0,0,10000,0,0,0,26000,16000,10000,10000
05073P,臺股指中信95售09,0,0,0,0,0,0,0,0,0,10000,0,0,0,10000,0,10000,10000
050789,矽創國泰96購01  ,0,0,0,0,0,0,0,0,0,10000,0,0,0,10000,0,10000,10000
051202,智邦麥證95購01  ,0,0,0,40000,30000,10000,0,0,0,10000,0,0,0,40000,30000,10000,10000
051232,貿聯群益95購02  ,0,0,0,0,0,0,0,0,0,10000,0,0,0,22000,12000,10000,10000
051188,鴻海兆豐95購01  ,0,0,0,0,0,0,0,0,0,10000,0,0,0,10000,0,10000,10000
051206,大立光麥證95購02,0,0,0,21000,10000,11000,0,0,0,10000,0,0,0,21000,11000,10000,10000
051312,國泰金麥證95購01,0,0,0,10000,0,10000,0,0,0,10000,0,0,0,10000,0,10000,10000
051310,台達電麥證95購01,0,0,0,10000,0,10000,0,0,0,10000,0,0,0,10000,0,10000,10000
051675,瑞儀元大96購02  ,0,0,0,0,0,0,0,0,0,10000,0,0,0,10000,0,10000,10000
050706,柏文凱基94購01  ,0,0,0,0,0,0,0,0,0,10000,0,0,0,10000,0,10000,10000
050713,矽格麥證94購01  ,0,0,0,23000,13000,10000,0,0,0,10000,0,0,0,23000,13000,10000,10000
051702,鴻海群益95購08  ,0,0,0,0,0,0,0,0,0,10000,0,0,0,10000,0,10000,10000
04946P,華通元大94售04  ,0,0,0,0,0,0,0,0,0,10000,0,0,0,10000,0,10000,10000
050317,和鑫國票95購02  ,0,0,0,0,0,0,0,0,0,10000,0,0,0,30000,20000,10000,10000
050287,台達電凱基94購10,0,0,0,0,0,0,0,0,0,10000,0,0,0,10000,0,10000,10000
050243,華新科凱基94購10,0,0,0,0,0,0,0,0,0,10000,0,0,0,43000,33000,10000,10000
050236,旺宏凱基94購06  ,0,0,0,0,0,0,0,0,0,10000,0,0,0,15000,5000,10000,10000
050250,台郡凱基94購03  ,0,0,0,0,0,0,0,0,0,10000,0,0,0,19000,9000,10000,10000
050188,貿聯元大96購01  ,0,0,0,0,0,0,0,0,0,10000,0,0,0,72000,62000,10000,10000
050059,旺宏凱基94購03  ,0,0,0,0,0,0,0,0,0,10000,0,0,0,10000,0,10000,10000
050039,鴻海中信94購03  ,0,0,0,0,0,0,0,0,0,10000,0,0,0,30000,20000,10000,10000
050582,傳奇國票94購01  ,0,0,0,0,0,0,0,0,0,10000,0,0,0,10000,0,10000,10000
049710,大成鋼凱基94購03,0,0,0,0,0,0,0,0,0,10000,0,0,0,10000,0,10000,10000
050625,康控第一94購01  ,0,0,0,0,0,0,0,0,0,10000,0,0,0,10000,0,10000,10000
050565,矽格元富94購01  ,0,0,0,0,0,0,0,0,0,10000,0,0,0,10000,0,10000,10000
051581,聯發科元大95購12,0,0,0,0,0,0,0,0,0,10000,0,0,0,78000,68000,10000,10000
050553,緯穎凱基94購06  ,0,0,0,0,0,0,0,0,0,10000,0,0,0,10000,0,10000,10000
050554,百和凱基95購01  ,0,0,0,0,0,0,0,0,0,10000,0,0,0,30000,20000,10000,10000
05053P,新日興群益95售01,0,0,0,0,0,0,0,0,0,10000,0,0,0,10000,0,10000,10000
050514,聯電元大94購01  ,0,0,0,0,0,0,0,0,0,10000,0,0,0,10000,0,10000,10000
050516,華通元大95購05  ,0,0,0,0,0,0,0,0,0,10000,0,0,0,10000,0,10000,10000
049363,旺宏元大94購07  ,0,0,0,0,0,0,0,0,0,10000,0,0,0,10000,0,10000,10000
050489,聯詠元富94購01  ,0,0,0,0,0,0,0,0,0,10000,0,0,0,10000,0,10000,10000
049335,聯電統一97購01  ,0,0,0,0,0,0,0,0,0,10000,0,0,0,10000,0,10000,10000
049336,台達電統一94購02,0,0,0,0,0,0,0,0,0,10000,0,0,0,10000,0,10000,10000
049337,台達電統一94購03,0,0,0,0,0,0,0,0,0,10000,0,0,0,10000,0,10000,10000
049340,鴻海統一94購03  ,0,0,0,0,0,0,0,0,0,10000,0,0,0,10000,0,10000,10000
05046P,台光電永豐95售02,0,0,0,0,0,0,0,0,0,10000,0,0,0,10000,0,10000,10000
051525,日月光凱基95購02,0,0,0,0,0,0,0,0,0,10000,0,0,0,20000,10000,10000,10000
051548,鈺齊康和95購01  ,0,0,0,0,0,0,0,0,0,10000,0,0,0,10000,0,10000,10000
05196P,台積電永豐95售03,0,0,0,0,0,0,0,0,0,10000,0,0,0,10000,0,10000,10000
051982,深中小元大95購01,0,0,0,0,0,0,0,0,0,10000,0,0,0,10000,0,10000,10000
053359,矽力統一96購02  ,0,0,0,0,0,0,0,0,0,10000,0,0,0,10000,0,10000,10000
053369,T50反1元大96購06,0,0,0,0,0,0,0,0,0,10000,0,0,0,10000,0,10000,10000
05345P,臺股指統一95售05,0,0,0,0,0,0,0,0,0,10000,0,0,0,10000,0,10000,10000
053417,上銀永豐96購02  ,0,0,0,0,0,0,0,0,0,10000,0,0,0,96000,86000,10000,10000
053552,華新科凱基96購08,0,0,0,0,0,0,0,0,0,10000,0,0,0,16000,6000,10000,10000
053502,智伸科兆豐97購01,0,0,0,0,0,0,0,0,0,10000,0,0,0,20000,10000,10000,10000
053487,台泥兆豐97購01  ,0,0,0,0,0,0,0,0,0,10000,0,0,0,10000,0,10000,10000
053498,大立光兆豐96購03,0,0,0,0,0,0,0,0,0,10000,0,0,0,10000,0,10000,10000
053580,國巨元大96購10  ,0,0,0,0,0,0,0,0,0,10000,0,0,0,242000,232000,10000,10000
05386P,臺股指永豐95售05,0,0,0,0,0,0,0,0,0,10000,0,0,0,10000,0,10000,10000
053929,正文國票97購01  ,0,0,0,0,0,0,0,0,0,10000,0,0,0,10000,0,10000,10000
05368P,可成元富95售03  ,0,0,0,0,0,0,0,0,0,10000,0,0,0,20000,10000,10000,10000
053724,聯詠凱基96購04  ,0,0,0,0,0,0,0,0,0,10000,0,0,0,12000,2000,10000,10000
053776,台積電元大96購19,0,0,0,0,0,0,0,0,0,10000,0,0,0,20000,10000,10000,10000
053784,奇力新元大97購02,0,0,0,0,0,0,0,0,0,10000,0,0,0,10000,0,10000,10000
053821,群創群益98購08  ,0,0,0,0,0,0,0,0,0,10000,0,0,0,10000,0,10000,10000
053811,國巨群益98購02  ,0,0,0,0,0,0,0,0,0,10000,0,0,0,10000,0,10000,10000
052813,T50正2永豐96購01,0,0,0,0,0,0,0,0,0,10000,0,0,0,10000,0,10000,10000
052787,國巨中信96購02  ,0,0,0,0,0,0,0,0,0,10000,0,0,0,12000,2000,10000,10000
052271,力成日盛95購02  ,0,0,0,0,0,0,0,0,0,10000,0,0,0,10000,0,10000,10000
052247,深中小永豐95購01,0,0,0,0,0,0,0,0,0,10000,0,0,0,10000,0,10000,10000
052868,緯創凱基96購03  ,0,0,0,0,0,0,0,0,0,10000,0,0,0,20000,10000,10000,10000
052877,矽創凱基96購01  ,0,0,0,0,0,0,0,0,0,10000,0,0,0,10000,0,10000,10000
052829,上銀群益96購01  ,0,0,0,0,0,0,0,0,0,10000,0,0,0,112000,102000,10000,10000
05282P,可成元大95售09  ,0,0,0,0,0,0,0,0,0,10000,0,0,0,187000,177000,10000,10000
053250,百和國票97購02  ,0,0,0,0,0,0,0,0,0,10000,0,0,0,10000,0,10000,10000
053248,智伸科國票97購01,0,0,0,0,0,0,0,0,0,10000,0,0,0,22000,12000,10000,10000
053261,國巨群益96購05  ,0,0,0,0,0,0,0,0,0,10000,0,0,0,10000,0,10000,10000
053222,聯茂凱基96購03  ,0,0,0,0,0,0,0,0,0,10000,0,0,0,10000,0,10000,10000
052951,GIS國票97購02   ,0,0,0,0,0,0,0,0,0,10000,0,0,0,30000,20000,10000,10000
053100,美律元富96購01  ,0,0,0,0,0,0,0,0,0,10000,0,0,0,10000,0,10000,10000
053101,創意元富96購03  ,0,0,0,0,0,0,0,0,0,10000,0,0,0,10000,0,10000,10000
053080,力山元大96購02  ,0,0,0,0,0,0,0,0,0,10000,0,0,0,10000,0,10000,10000
053097,超眾統一96購03  ,0,0,0,0,0,0,0,0,0,10000,0,0,0,10000,0,10000,10000
053134,南亞科國票97購01,0,0,0,0,0,0,0,0,0,10000,0,0,0,12000,2000,10000,10000
054533,泰碩國泰98購01  ,0,0,0,0,0,0,0,0,0,10000,0,0,0,10000,0,10000,10000
054650,南亞麥證97購01  ,0,0,0,10000,0,10000,0,0,0,10000,0,0,0,10000,0,10000,10000
054444,緯穎台新97購01  ,0,0,0,0,0,0,0,0,0,10000,0,0,0,10000,0,10000,10000
054416,禾伸堂元大97購01,0,0,0,0,0,0,0,0,0,10000,0,0,0,11000,1000,10000,10000
05442P,鴻海元大96售13  ,0,0,0,0,0,0,0,0,0,10000,0,0,0,191000,181000,10000,10000
054067,百和國票97購03  ,0,0,0,0,0,0,0,0,0,10000,0,0,0,10000,0,10000,10000
05405P,大立光群益95售04,0,0,0,0,0,0,0,0,0,10000,0,0,0,10000,0,10000,10000
054118,國巨永豐96購04  ,0,0,0,0,0,0,0,0,0,10000,0,0,0,50000,40000,10000,10000
054334,超眾永豐96購04  ,0,0,0,0,0,0,0,0,0,10000,0,0,0,10000,0,10000,10000
054294,世芯元大96購02  ,0,0,0,0,0,0,0,0,0,10000,0,0,0,10000,0,10000,10000
054241,深中小元大98購01,0,0,0,0,0,0,0,0,0,10000,0,0,0,10000,0,10000,10000
054765,亞光國票98購02  ,0,0,0,0,0,0,0,0,0,10000,0,0,0,10000,0,10000,10000
054707,聯茂亞東97購01  ,0,0,0,0,0,0,0,0,0,10000,0,0,0,10000,0,10000,10000
054817,聯發科元大97購13,0,0,0,0,0,0,0,0,0,10000,0,0,0,78000,68000,10000,10000
05498P,友達元富95售02  ,0,0,0,0,0,0,0,0,0,10000,0,0,0,10000,0,10000,10000
05494P,華邦電統一95售02,0,0,0,0,0,0,0,0,0,10000,0,0,0,10000,0,10000,10000
054958,亞光元大97購03  ,0,0,0,0,0,0,0,0,0,10000,0,0,0,15000,5000,10000,10000
055289,泰碩元大98購01  ,0,0,0,0,0,0,0,0,0,10000,0,0,0,10000,0,10000,10000
055119,力成凱基98購01  ,0,0,0,0,0,0,0,0,0,10000,0,0,0,10000,0,10000,10000
055025,華新科國泰98購02,0,0,0,0,0,0,0,0,0,10000,0,0,0,50000,40000,10000,10000
05502P,台表科國票97售01,0,0,0,0,0,0,0,0,0,10000,0,0,0,34000,24000,10000,10000
2881A,富邦特          ,13000,0,13000,0,0,0,0,0,0,-3000,0,3000,-3000,0,0,0,10000
3557,嘉威            ,29000,19000,10000,0,0,0,0,0,0,0,0,0,0,0,0,0,10000
6172,互億            ,13000,3000,10000,0,0,0,0,0,0,0,0,0,0,0,0,0,10000
06416P,大立光群益97售06,0,0,0,0,0,0,0,0,0,10000,0,0,0,15000,5000,10000,10000
06516P,國巨凱基98售08  ,0,0,0,0,0,0,0,0,0,10000,0,0,0,50000,40000,10000,10000
06524P,臺股指麥證98售02,0,0,0,10000,0,10000,0,0,0,10000,0,0,0,10000,0,10000,10000
06265P,美律凱基97售01  ,0,0,0,0,0,0,0,0,0,10000,0,0,0,10000,0,10000,10000
06226P,聯發科麥證97售03,0,0,0,10000,0,10000,0,0,0,10000,0,0,0,10000,0,10000,10000
06236P,台積電元大97售25,0,0,0,0,0,0,0,0,0,10000,0,0,0,10000,0,10000,10000
06192P,高股息中信98售01,0,0,0,0,0,0,0,0,0,10000,0,0,0,30000,20000,10000,10000
06343P,臺股指統一98售01,0,0,0,0,0,0,0,0,0,10000,0,0,0,10000,0,10000,10000
06647P,台積電元大98售13,0,0,0,0,0,0,0,0,0,10000,0,0,0,270000,260000,10000,10000
06593P,欣興元大98售05  ,0,0,0,0,0,0,0,0,0,10000,0,0,0,57000,47000,10000,10000
06627P,華新科元富99售01,0,0,0,0,0,0,0,0,0,10000,0,0,0,10000,0,10000,10000
06630P,國巨群益98售08  ,0,0,0,0,0,0,0,0,0,10000,0,0,0,10000,0,10000,10000
1234,黑松            ,12000,2000,10000,0,0,0,0,0,0,0,0,0,0,0,0,0,10000
1529,樂士            ,2000,2000,0,0,0,0,0,0,0,10000,10000,0,10000,0,0,0,10000
056434,國巨凱基98購03  ,0,0,0,0,0,0,0,0,0,9000,0,0,0,9000,0,9000,9000
056376,玉晶光統一98購01,0,0,0,0,0,0,0,0,0,9000,0,0,0,10000,1000,9000,9000
055683,晶技凱基99購01  ,0,0,0,0,0,0,0,0,0,9000,0,0,0,10000,1000,9000,9000
055922,台郡凱基98購03  ,0,0,0,0,0,0,0,0,0,9000,0,0,0,102000,93000,9000,9000
055923,矽力凱基98購01  ,0,0,0,0,0,0,0,0,0,9000,0,0,0,158000,149000,9000,9000
056610,鴻海永豐98購01  ,0,0,0,0,0,0,0,0,0,9000,0,0,0,77000,68000,9000,9000
056669,貿聯國票99購01  ,0,0,0,0,0,0,0,0,0,9000,0,0,0,44000,35000,9000,9000
05954P,旺宏國票97售03  ,0,0,0,0,0,0,0,0,0,9000,0,0,0,32000,23000,9000,9000
05756P,臺股指中信99售05,0,0,0,0,0,0,0,0,0,9000,0,0,0,16000,7000,9000,9000
057364,國巨元大98購18  ,0,0,0,0,0,0,0,0,0,9000,0,0,0,21000,12000,9000,9000
057377,康控元大99購02  ,0,0,0,0,0,0,0,0,0,9000,0,0,0,273000,264000,9000,9000
05740P,宏達電元富96售01,0,0,0,0,0,0,0,0,0,9000,0,0,0,10000,1000,9000,9000
057282,大立光元大99購06,0,0,0,0,0,0,0,0,0,9000,0,0,0,13000,4000,9000,9000
057262,友達兆豐98購03  ,0,0,0,0,0,0,0,0,0,9000,0,0,0,90000,81000,9000,9000
050348,鴻海群益94購06  ,0,0,0,0,0,0,0,0,0,9000,0,0,0,32000,23000,9000,9000
048691,智伸科群益94購01,0,0,0,0,0,0,0,0,0,9000,0,0,0,31000,22000,9000,9000
048795,復盛元大94購01  ,0,0,0,0,0,0,0,0,0,9000,0,0,0,11000,2000,9000,9000
047417,台塑富邦97購01  ,0,0,0,0,0,0,0,0,0,9000,0,0,0,9000,0,9000,9000
046791,台郡統一96購01  ,0,0,0,0,0,0,0,0,0,9000,0,0,0,9000,0,9000,9000
048159,聯詠兆豐93購03  ,0,0,0,0,0,0,0,0,0,9000,0,0,0,10000,1000,9000,9000
047921,南亞科凱基93購05,0,0,0,0,0,0,0,0,0,9000,0,0,0,20000,11000,9000,9000
044407,聯茂凱基93購01  ,0,0,0,0,0,0,0,0,0,9000,0,0,0,19000,10000,9000,9000
03027P,玉晶光元大01售09,0,0,0,0,0,0,0,0,0,9000,0,0,0,10000,1000,9000,9000
00706L,元大S&P日圓正2  ,0,0,0,0,0,0,0,0,0,9000,0,0,0,10000,1000,9000,9000
046201,台郡凱基92購01  ,0,0,0,0,0,0,0,0,0,9000,0,0,0,10000,1000,9000,9000
051523,牧德凱基95購02  ,0,0,0,0,0,0,0,0,0,9000,0,0,0,65000,56000,9000,9000
050415,力成永豐94購01  ,0,0,0,0,0,0,0,0,0,9000,0,0,0,10000,1000,9000,9000
04934P,鴻海中信94售05  ,0,0,0,0,0,0,0,0,0,9000,0,0,0,10000,1000,9000,9000
050075,南電凱基94購04  ,0,0,0,0,0,0,0,0,0,9000,0,0,0,9000,0,9000,9000
050264,聯發科元大94購13,0,0,0,0,0,0,0,0,0,9000,0,0,0,119000,110000,9000,9000
052176,景碩元大96購01  ,0,0,0,0,0,0,0,0,0,9000,0,0,0,9000,0,9000,9000
051088,台積電元大95購09,0,0,0,0,0,0,0,0,0,9000,0,0,0,145000,136000,9000,9000
049149,華新科元大95購03,0,0,0,0,0,0,0,0,0,9000,0,0,0,106000,97000,9000,9000
048851,台達電群益94購01,0,0,0,0,0,0,0,0,0,9000,0,0,0,9000,0,9000,9000
048876,牧德國票95購02  ,0,0,0,0,0,0,0,0,0,9000,0,0,0,9000,0,9000,9000
048990,台表科元大94購01,0,0,0,0,0,0,0,0,0,9000,0,0,0,9000,0,9000,9000
049597,泰鼎元大96購01  ,0,0,0,0,0,0,0,0,0,9000,0,0,0,27000,18000,9000,9000
051384,康友群益95購01  ,0,0,0,0,0,0,0,0,0,9000,0,0,0,57000,48000,9000,9000
055284,全新元大99購01  ,0,0,0,0,0,0,0,0,0,9000,0,0,0,9000,0,9000,9000
054779,台塑群益98購01  ,0,0,0,0,0,0,0,0,0,9000,0,0,0,51000,42000,9000,9000
054213,欣興國票97購04  ,0,0,0,0,0,0,0,0,0,9000,0,0,0,10000,1000,9000,9000
054110,群創凱基98購09  ,0,0,0,0,0,0,0,0,0,9000,0,0,0,29000,20000,9000,9000
053104,台表科元富96購02,0,0,0,0,0,0,0,0,0,9000,0,0,0,30000,21000,9000,9000
053182,大立光元富96購02,0,0,0,0,0,0,0,0,0,9000,0,0,0,12000,3000,9000,9000
05281P,南亞科元大95售03,0,0,0,0,0,0,0,0,0,9000,0,0,0,15000,6000,9000,9000
052901,台達電國票97購01,0,0,0,0,0,0,0,0,0,9000,0,0,0,19000,10000,9000,9000
052770,聯茂群益96購02  ,0,0,0,0,0,0,0,0,0,9000,0,0,0,65000,56000,9000,9000
054001,康友群益96購02  ,0,0,0,0,0,0,0,0,0,9000,0,0,0,37000,28000,9000,9000
053401,臺股指中信99購01,0,0,0,0,0,0,0,0,0,9000,0,0,0,23000,14000,9000,9000
053408,友達兆豐98購01  ,0,0,0,0,0,0,0,0,0,9000,0,0,0,86000,77000,9000,9000
053349,台郡國票97購02  ,0,0,0,0,0,0,0,0,0,9000,0,0,0,29000,20000,9000,9000
053345,欣興國票97購02  ,0,0,0,0,0,0,0,0,0,9000,0,0,0,22000,13000,9000,9000
1532,勤美            ,33000,24000,9000,0,0,0,0,0,0,0,0,0,0,0,0,0,9000
1615,大山            ,13000,2000,11000,0,0,0,0,0,0,-2000,0,2000,-2000,0,0,0,9000
2062,橋椿            ,14000,5000,9000,0,0,0,0,0,0,0,0,0,0,0,0,0,9000
08164P,滬深2X中信95售04,0,0,0,0,0,0,0,0,0,9000,0,0,0,10000,1000,9000,9000
06362P,臺股指麥證97售01,0,0,0,10000,1000,9000,0,0,0,9000,0,0,0,10000,1000,9000,9000
06327P,台積電中信01售01,0,0,0,0,0,0,0,0,0,9000,0,0,0,10000,1000,9000,9000
06201P,可成元大97售01  ,0,0,0,0,0,0,0,0,0,9000,0,0,0,72000,63000,9000,9000
06506P,台郡國票99售02  ,0,0,0,0,0,0,0,0,0,9000,0,0,0,43000,34000,9000,9000
6184,大豐電          ,9000,0,9000,0,0,0,0,0,0,0,0,0,0,0,0,0,9000
6672,騰輝電子-KY     ,46000,37000,9000,0,0,0,0,0,0,0,0,0,0,0,0,0,9000
4104,佳醫            ,17000,8000,9000,0,0,0,0,0,0,0,0,0,0,0,0,0,9000
3034,聯詠            ,2553000,2570000,-17000,0,0,0,0,140000,-140000,166000,220000,0,220000,16000,70000,-54000,9000
2414,精技            ,10000,1000,9000,0,0,0,0,0,0,0,0,0,0,0,0,0,9000
2459,敦吉            ,11000,2000,9000,0,0,0,0,0,0,0,0,0,0,0,0,0,9000
05907P,聯發科元富96售05,0,0,0,0,0,0,0,0,0,8000,0,0,0,8000,0,8000,8000
05903P,聯發科統一96售09,0,0,0,0,0,0,0,0,0,8000,0,0,0,10000,2000,8000,8000
06141P,大立光日盛97售01,0,0,0,0,0,0,0,0,0,8000,0,0,0,11000,3000,8000,8000
06169P,華新科元富97售02,0,0,0,0,0,0,0,0,0,8000,0,0,0,23000,15000,8000,8000
056830,友達富邦99購01  ,0,0,0,0,0,0,0,0,0,8000,0,0,0,18000,10000,8000,8000
057118,欣興日盛9A購01  ,0,0,0,0,0,0,0,0,0,8000,0,0,0,49000,41000,8000,8000
05579P,友達凱基98售03  ,0,0,0,0,0,0,0,0,0,8000,0,0,0,8000,0,8000,8000
056116,義隆群益97購02  ,0,0,0,0,0,0,0,0,0,8000,0,0,0,23000,15000,8000,8000
04026P,燿華國票93售01  ,0,0,0,0,0,0,0,0,0,8000,0,0,0,8000,0,8000,8000
00663L,國泰臺灣加權正2 ,0,0,0,0,0,0,0,0,0,8000,0,0,0,15000,7000,8000,8000
042754,元黃金元大93購01,0,0,0,0,0,0,0,0,0,8000,0,0,0,8000,0,8000,8000
044611,正崴兆豐92購01  ,0,0,0,0,0,0,0,0,0,8000,0,0,0,18000,10000,8000,8000
044307,GIS兆豐93購01   ,0,0,0,0,0,0,0,0,0,8000,0,0,0,8000,0,8000,8000
04544P,欣興富邦96售02  ,0,0,0,0,0,0,0,0,0,8000,0,0,0,15000,7000,8000,8000
048197,義隆元大93購04  ,0,0,0,0,0,0,0,0,0,8000,0,0,0,29000,21000,8000,8000
048379,台郡元富96購01  ,0,0,0,0,0,0,0,0,0,8000,0,0,0,23000,15000,8000,8000
048345,緯創元大94購01  ,0,0,0,0,0,0,0,0,0,8000,0,0,0,8000,0,8000,8000
047383,鴻海元大95購01  ,0,0,0,0,0,0,0,0,0,8000,0,0,0,116000,108000,8000,8000
047641,可成元大93購09  ,0,0,0,0,0,0,0,0,0,8000,0,0,0,104000,96000,8000,8000
048825,華新科凱基94購05,0,0,0,0,0,0,0,0,0,8000,0,0,0,30000,22000,8000,8000
047299,樺漢元富93購01  ,0,0,0,0,0,0,0,0,0,8000,0,0,0,8000,0,8000,8000
04860P,鴻海群益94售07  ,0,0,0,0,0,0,0,0,0,8000,0,0,0,8000,0,8000,8000
050377,華通第一94購01  ,0,0,0,0,0,0,0,0,0,8000,0,0,0,10000,2000,8000,8000
050397,力成元富94購01  ,0,0,0,0,0,0,0,0,0,8000,0,0,0,73000,65000,8000,8000
051910,大立光元大97購01,0,0,0,0,0,0,0,0,0,8000,0,0,0,8000,0,8000,8000
051461,聯詠國泰96購01  ,0,0,0,0,0,0,0,0,0,8000,0,0,0,10000,2000,8000,8000
049570,華新科統一94購04,0,0,0,0,0,0,0,0,0,8000,0,0,0,80000,72000,8000,8000
051057,信邦群益95購01  ,0,0,0,0,0,0,0,0,0,8000,0,0,0,10000,2000,8000,8000
051061,中磊群益95購01  ,0,0,0,0,0,0,0,0,0,8000,0,0,0,277000,269000,8000,8000
053026,奇力新富邦98購01,0,0,0,0,0,0,0,0,0,8000,0,0,0,43000,35000,8000,8000
050194,臻鼎元大94購03  ,0,0,0,0,0,0,0,0,0,8000,0,0,0,15000,7000,8000,8000
050158,上海銀群益96購01,0,0,0,0,0,0,0,0,0,8000,0,0,0,40000,32000,8000,8000
05123P,鴻海永昌96售07  ,0,0,0,0,0,0,0,0,0,8000,0,0,0,85000,77000,8000,8000
050757,聯發科元富94購03,0,0,0,0,0,0,0,0,0,8000,0,0,0,100000,92000,8000,8000
051777,聯發科群益95購04,0,0,0,0,0,0,0,0,0,8000,0,0,0,60000,52000,8000,8000
05044P,亞德客永豐95售01,0,0,0,0,0,0,0,0,0,8000,0,0,0,13000,5000,8000,8000
051927,國巨中信96購01  ,0,0,0,0,0,0,0,0,0,8000,0,0,0,22000,14000,8000,8000
049266,和碩元大94購01  ,0,0,0,0,0,0,0,0,0,8000,0,0,0,8000,0,8000,8000
053353,玉晶光兆豐97購03,0,0,0,0,0,0,0,0,0,8000,0,0,0,10000,2000,8000,8000
05226P,智邦統一95售01  ,0,0,0,0,0,0,0,0,0,8000,0,0,0,34000,26000,8000,8000
053079,世紀鋼永豐96購01,0,0,0,0,0,0,0,0,0,8000,0,0,0,450000,442000,8000,8000
052959,聯電凱基97購01  ,0,0,0,0,0,0,0,0,0,8000,0,0,0,88000,80000,8000,8000
052991,台積電台新96購01,0,0,0,0,0,0,0,0,0,8000,0,0,0,8000,0,8000,8000
054381,世芯群益98購01  ,0,0,0,0,0,0,0,0,0,8000,0,0,0,18000,10000,8000,8000
054676,牧德台新98購01  ,0,0,0,0,0,0,0,0,0,8000,0,0,0,82000,74000,8000,8000
054693,神基永豐97購01  ,0,0,0,0,0,0,0,0,0,8000,0,0,0,129000,121000,8000,8000
054788,華新科群益98購02,0,0,0,0,0,0,0,0,0,8000,0,0,0,75000,67000,8000,8000
2816,旺旺保          ,16000,8000,8000,0,0,0,0,0,0,0,0,0,0,0,0,0,8000
5534,長虹            ,107000,57000,50000,0,0,0,0,0,0,-42000,10000,52000,-42000,0,0,0,8000
06523P,台積電麥證98售02,0,0,0,10000,2000,8000,0,0,0,8000,0,0,0,10000,2000,8000,8000
06204P,鴻海群益97售04  ,0,0,0,0,0,0,0,0,0,8000,0,0,0,8000,0,8000,8000
1731,美吾華          ,4000,7000,-3000,0,0,0,0,0,0,11000,11000,0,11000,0,0,0,8000
1809,中釉            ,49000,41000,8000,0,0,0,0,0,0,0,0,0,0,0,0,0,8000
1702,南僑            ,68000,62000,6000,0,0,0,0,0,0,2000,3000,1000,2000,0,0,0,8000
056043,力成凱基97購01  ,0,0,0,0,0,0,0,0,0,7000,0,0,0,7000,0,7000,7000
05605P,嘉聯益元大97售02,0,0,0,0,0,0,0,0,0,7000,0,0,0,7000,0,7000,7000
05628P,茂林國票97售02  ,0,0,0,0,0,0,0,0,0,7000,0,0,0,125000,118000,7000,7000
056273,祥碩統一97購02  ,0,0,0,0,0,0,0,0,0,7000,0,0,0,30000,23000,7000,7000
056538,國泰金凱基98購01,0,0,0,0,0,0,0,0,0,7000,0,0,0,7000,0,7000,7000
055786,彩晶凱基99購02  ,0,0,0,0,0,0,0,0,0,7000,0,0,0,10000,3000,7000,7000
055725,嘉聯益元大98購03,0,0,0,0,0,0,0,0,0,7000,0,0,0,48000,41000,7000,7000
055516,上銀中信97購01  ,0,0,0,0,0,0,0,0,0,7000,0,0,0,16000,9000,7000,7000
055591,全新元大98購01  ,0,0,0,0,0,0,0,0,0,7000,0,0,0,24000,17000,7000,7000
05686P,臺股指元大96售11,0,0,0,0,0,0,0,0,0,7000,0,0,0,12000,5000,7000,7000
056707,鴻海富邦99購03  ,0,0,0,0,0,0,0,0,0,7000,0,0,0,42000,35000,7000,7000
06165P,臺股指凱基9A售03,0,0,0,0,0,0,0,0,0,7000,0,0,0,10000,3000,7000,7000
05832P,臺股指元富96售04,0,0,0,0,0,0,0,0,0,7000,0,0,0,7000,0,7000,7000
057369,奇力新元大99購05,0,0,0,0,0,0,0,0,0,7000,0,0,0,282000,275000,7000,7000
051879,健策台新96購01  ,0,0,0,0,0,0,0,0,0,7000,0,0,0,7000,0,7000,7000
048667,旺宏永豐94購02  ,0,0,0,0,0,0,0,0,0,7000,0,0,0,134000,127000,7000,7000
047395,聯茂元大94購01  ,0,0,0,0,0,0,0,0,0,7000,0,0,0,12000,5000,7000,7000
047540,技嘉麥證93購01  ,0,0,0,11000,4000,7000,0,0,0,7000,0,0,0,11000,4000,7000,7000
047513,嘉晶國票93購03  ,0,0,0,0,0,0,0,0,0,7000,0,0,0,149000,142000,7000,7000
048130,美利達元大96購01,0,0,0,0,0,0,0,0,0,7000,0,0,0,7000,0,7000,7000
047870,嘉澤永豐93購02  ,0,0,0,0,0,0,0,0,0,7000,0,0,0,13000,6000,7000,7000
045537,華新群益94購01  ,0,0,0,0,0,0,0,0,0,7000,0,0,0,7000,0,7000,7000
046351,智邦群益92購01  ,0,0,0,0,0,0,0,0,0,7000,0,0,0,7000,0,7000,7000
044526,訊芯凱基93購02  ,0,0,0,0,0,0,0,0,0,7000,0,0,0,7000,0,7000,7000
04138P,智邦國票93售02  ,0,0,0,0,0,0,0,0,0,7000,0,0,0,7000,0,7000,7000
03956P,欣興統一93售02  ,0,0,0,0,0,0,0,0,0,7000,0,0,0,73000,66000,7000,7000
045585,欣興元大93購03  ,0,0,0,0,0,0,0,0,0,7000,0,0,0,9000,2000,7000,7000
052089,聯發科元大96購02,0,0,0,0,0,0,0,0,0,7000,0,0,0,87000,80000,7000,7000
051776,上証2X群益99購01,0,0,0,0,0,0,0,0,0,7000,0,0,0,7000,0,7000,7000
050193,臻鼎元大94購02  ,0,0,0,0,0,0,0,0,0,7000,0,0,0,10000,3000,7000,7000
050660,欣興元大96購02  ,0,0,0,0,0,0,0,0,0,7000,0,0,0,112000,105000,7000,7000
051662,大立光永昌96購03,0,0,0,0,0,0,0,0,0,7000,0,0,0,7000,0,7000,7000
053031,華新科第一96購01,0,0,0,0,0,0,0,0,0,7000,0,0,0,7000,0,7000,7000
049833,正文凱基94購05  ,0,0,0,0,0,0,0,0,0,7000,0,0,0,7000,0,7000,7000
052190,創意群益95購03  ,0,0,0,0,0,0,0,0,0,7000,0,0,0,7000,0,7000,7000
052369,矽力國票96購02  ,0,0,0,0,0,0,0,0,0,7000,0,0,0,41000,34000,7000,7000
048939,華擎永豐94購01  ,0,0,0,0,0,0,0,0,0,7000,0,0,0,37000,30000,7000,7000
054791,泰碩群益99購02  ,0,0,0,0,0,0,0,0,0,7000,0,0,0,57000,50000,7000,7000
054965,健策元大98購04  ,0,0,0,0,0,0,0,0,0,7000,0,0,0,212000,205000,7000,7000
054615,牧德永豐98購01  ,0,0,0,0,0,0,0,0,0,7000,0,0,0,30000,23000,7000,7000
054284,和大元大96購03  ,0,0,0,0,0,0,0,0,0,7000,0,0,0,7000,0,7000,7000
053307,泰碩凱基97購01  ,0,0,0,0,0,0,0,0,0,7000,0,0,0,7000,0,7000,7000
053376,鴻海元大96購19  ,0,0,0,0,0,0,0,0,0,7000,0,0,0,30000,23000,7000,7000
053582,英業達元大97購01,0,0,0,0,0,0,0,0,0,7000,0,0,0,57000,50000,7000,7000
053651,台光電凱基98購01,0,0,0,0,0,0,0,0,0,7000,0,0,0,244000,237000,7000,7000
053927,牧德國票97購01  ,0,0,0,0,0,0,0,0,0,7000,0,0,0,7000,0,7000,7000
053846,友達元富99購02  ,0,0,0,0,0,0,0,0,0,7000,0,0,0,7000,0,7000,7000
053658,亞光凱基96購01  ,0,0,0,0,0,0,0,0,0,7000,0,0,0,51000,44000,7000,7000
1526,日馳            ,10000,3000,7000,0,0,0,0,0,0,0,0,0,0,0,0,0,7000
1449,佳和            ,42000,35000,7000,0,0,0,0,0,0,0,0,0,0,0,0,0,7000
1203,味王            ,7000,0,7000,0,0,0,0,0,0,0,0,0,0,0,0,0,7000
1210,大成            ,149000,142000,7000,0,0,0,0,0,0,0,0,0,0,0,0,0,7000
1307,三芳            ,15000,8000,7000,0,0,0,0,0,0,0,0,0,0,0,0,0,7000
06399P,台表科凱基97售05,0,0,0,0,0,0,0,0,0,7000,0,0,0,16000,9000,7000,7000
6024,群益期          ,12000,5000,7000,0,0,0,0,0,0,0,0,0,0,0,0,0,7000
2493,揚博            ,10000,3000,7000,0,0,0,0,0,0,0,0,0,0,0,0,0,7000
2482,連宇            ,21000,14000,7000,0,0,0,0,0,0,0,0,0,0,0,0,0,7000
057368,微星元大98購02  ,0,0,0,0,0,0,0,0,0,6000,0,0,0,50000,44000,6000,6000
057380,技嘉國泰9A購01  ,0,0,0,0,0,0,0,0,0,6000,0,0,0,60000,54000,6000,6000
05798P,臺股指群益96售12,0,0,0,0,0,0,0,0,0,6000,0,0,0,10000,4000,6000,6000
057347,國巨統一9A購03  ,0,0,0,0,0,0,0,0,0,6000,0,0,0,10000,4000,6000,6000
057181,亞光元大98購02  ,0,0,0,0,0,0,0,0,0,6000,0,0,0,48000,42000,6000,6000
05994P,奇鋐元大96售02  ,0,0,0,0,0,0,0,0,0,6000,0,0,0,12000,6000,6000,6000
06028P,智邦台新97售01  ,0,0,0,0,0,0,0,0,0,6000,0,0,0,20000,14000,6000,6000
056686,可成統一98購01  ,0,0,0,0,0,0,0,0,0,6000,0,0,0,129000,123000,6000,6000
056919,英業達兆豐98購01,0,0,0,0,0,0,0,0,0,6000,0,0,0,132000,126000,6000,6000
055498,大立光元大97購07,0,0,0,0,0,0,0,0,0,6000,0,0,0,6000,0,6000,6000
055456,上銀富邦99購01  ,0,0,0,0,0,0,0,0,0,6000,0,0,0,6000,0,6000,6000
055393,華新科統一97購03,0,0,0,0,0,0,0,0,0,6000,0,0,0,45000,39000,6000,6000
056492,全新國泰9A購01  ,0,0,0,0,0,0,0,0,0,6000,0,0,0,10000,4000,6000,6000
056457,嘉澤凱基98購01  ,0,0,0,0,0,0,0,0,0,6000,0,0,0,27000,21000,6000,6000
056469,國巨元大99購01  ,0,0,0,0,0,0,0,0,0,6000,0,0,0,254000,248000,6000,6000
055994,聯發科國泰99購02,0,0,0,0,0,0,0,0,0,6000,0,0,0,28000,22000,6000,6000
046119,國泰金元大92購02,0,0,0,0,0,0,0,0,0,6000,0,0,0,6000,0,6000,6000
03673P,康控元富92售02  ,0,0,0,0,0,0,0,0,0,6000,0,0,0,6000,0,6000,6000
04083P,欣興統一94售01  ,0,0,0,0,0,0,0,0,0,6000,0,0,0,6000,0,6000,6000
042516,健策凱基93購01  ,0,0,0,0,0,0,0,0,0,6000,0,0,0,6000,0,6000,6000
00635U,元大S&P黃金     ,64000,2000,62000,0,0,0,0,0,0,-56000,0,0,0,86000,142000,-56000,6000
044190,聯詠富邦93購01  ,0,0,0,0,0,0,0,0,0,6000,0,0,0,6000,0,6000,6000
046588,大立光元大93購13,0,0,0,0,0,0,0,0,0,6000,0,0,0,6000,0,6000,6000
048378,貿聯元富93購01  ,0,0,0,0,0,0,0,0,0,6000,0,0,0,6000,0,6000,6000
048296,康控群益93購03  ,0,0,0,0,0,0,0,0,0,6000,0,0,0,6000,0,6000,6000
046803,可成元大93購03  ,0,0,0,0,0,0,0,0,0,6000,0,0,0,10000,4000,6000,6000
04754P,宏達電元富94售02,0,0,0,0,0,0,0,0,0,6000,0,0,0,6000,0,6000,6000
047558,臻鼎凱基93購06  ,0,0,0,0,0,0,0,0,0,6000,0,0,0,34000,28000,6000,6000
047033,日月光中信95購01,0,0,0,0,0,0,0,0,0,6000,0,0,0,6000,0,6000,6000
048841,聯茂凱基94購06  ,0,0,0,0,0,0,0,0,0,6000,0,0,0,6000,0,6000,6000
04978P,台表科凱基94售02,0,0,0,0,0,0,0,0,0,6000,0,0,0,6000,0,6000,6000
04979P,臺股指凱基96售07,0,0,0,0,0,0,0,0,0,6000,0,0,0,16000,10000,6000,6000
050841,國巨國票96購02  ,0,0,0,0,0,0,0,0,0,6000,0,0,0,20000,14000,6000,6000
050814,微星凱基95購01  ,0,0,0,0,0,0,0,0,0,6000,0,0,0,6000,0,6000,6000
049651,訊芯凱基94購04  ,0,0,0,0,0,0,0,0,0,6000,0,0,0,205000,199000,6000,6000
051049,亞德客群益95購01,0,0,0,0,0,0,0,0,0,6000,0,0,0,6000,0,6000,6000
049918,宏達電元大94購01,0,0,0,0,0,0,0,0,0,6000,0,0,0,6000,0,6000,6000
051716,康控康和95購01  ,0,0,0,0,0,0,0,0,0,6000,0,0,0,6000,0,6000,6000
050191,和碩元大94購02  ,0,0,0,0,0,0,0,0,0,6000,0,0,0,6000,0,6000,6000
050211,貿聯國票95購01  ,0,0,0,0,0,0,0,0,0,6000,0,0,0,16000,10000,6000,6000
050767,京元電元大96購01,0,0,0,0,0,0,0,0,0,6000,0,0,0,56000,50000,6000,6000
050453,創意元大95購03  ,0,0,0,0,0,0,0,0,0,6000,0,0,0,17000,11000,6000,6000
050441,和碩凱基94購01  ,0,0,0,0,0,0,0,0,0,6000,0,0,0,6000,0,6000,6000
049283,滬深2X中信95購10,0,0,0,0,0,0,0,0,0,6000,0,0,0,31000,25000,6000,6000
049314,京鼎凱基94購01  ,0,0,0,0,0,0,0,0,0,6000,0,0,0,6000,0,6000,6000
050535,台表科群益94購02,0,0,0,0,0,0,0,0,0,6000,0,0,0,75000,69000,6000,6000
053712,台光電凱基96購04,0,0,0,0,0,0,0,0,0,6000,0,0,0,26000,20000,6000,6000
053729,聯茂凱基96購05  ,0,0,0,0,0,0,0,0,0,6000,0,0,0,6000,0,6000,6000
053897,台郡群益96購01  ,0,0,0,0,0,0,0,0,0,6000,0,0,0,20000,14000,6000,6000
053429,彩晶永豐96購01  ,0,0,0,0,0,0,0,0,0,6000,0,0,0,6000,0,6000,6000
053468,鴻海元大98購01  ,0,0,0,0,0,0,0,0,0,6000,0,0,0,82000,76000,6000,6000
052281,全新凱基97購01  ,0,0,0,0,0,0,0,0,0,6000,0,0,0,16000,10000,6000,6000
052221,東元凱基95購01  ,0,0,0,0,0,0,0,0,0,6000,0,0,0,6000,0,6000,6000
052940,玉晶光兆豐97購01,0,0,0,0,0,0,0,0,0,6000,0,0,0,6000,0,6000,6000
054293,健策元大98購02  ,0,0,0,0,0,0,0,0,0,6000,0,0,0,106000,100000,6000,6000
054248,燿華元大97購02  ,0,0,0,0,0,0,0,0,0,6000,0,0,0,112000,106000,6000,6000
054136,亞光元大96購04  ,0,0,0,0,0,0,0,0,0,6000,0,0,0,67000,61000,6000,6000
054162,光罩凱基98購01  ,0,0,0,0,0,0,0,0,0,6000,0,0,0,270000,264000,6000,6000
054391,宏達電元富96購04,0,0,0,0,0,0,0,0,0,6000,0,0,0,6000,0,6000,6000
054467,隆達凱基97購01  ,0,0,0,0,0,0,0,0,0,6000,0,0,0,16000,10000,6000,6000
054934,金寶元大97購01  ,0,0,0,0,0,0,0,0,0,6000,0,0,0,35000,29000,6000,6000
2472,立隆電          ,29000,46000,-17000,0,0,0,0,0,0,23000,23000,0,23000,0,0,0,6000
2527,宏璟            ,12000,6000,6000,0,0,0,0,0,0,0,0,0,0,0,0,0,6000
3033,威健            ,30000,24000,6000,0,0,0,0,0,0,0,0,0,0,0,0,0,6000
3004,豐達科          ,17000,11000,6000,0,0,0,0,0,0,0,0,0,0,0,0,0,6000
2851,中再保          ,15000,9000,6000,0,0,0,0,0,0,0,0,0,0,0,0,0,6000
8033,雷虎            ,15000,9000,6000,0,0,0,0,0,0,0,0,0,0,0,0,0,6000
6573,虹揚-KY         ,7000,1000,6000,0,0,0,0,0,0,0,0,0,0,0,0,0,6000
6133,金橋            ,6000,0,6000,0,0,0,0,0,0,0,0,0,0,0,0,0,6000
06222P,致茂元富97售02  ,0,0,0,0,0,0,0,0,0,6000,0,0,0,18000,12000,6000,6000
06223P,漢唐元富97售02  ,0,0,0,0,0,0,0,0,0,6000,0,0,0,6000,0,6000,6000
06251P,臺股指永昌97售03,0,0,0,0,0,0,0,0,0,6000,0,0,0,6000,0,6000,6000
06305P,臺股指元大97售11,0,0,0,0,0,0,0,0,0,6000,0,0,0,31000,25000,6000,6000
06352P,臺股指富邦99售02,0,0,0,0,0,0,0,0,0,6000,0,0,0,6000,0,6000,6000
1452,宏益            ,6000,0,6000,0,0,0,0,0,0,0,0,0,0,0,0,0,6000
1524,耿鼎            ,7000,1000,6000,0,0,0,0,0,0,0,0,0,0,0,0,0,6000
9930,中聯資源        ,12000,6000,6000,0,0,0,0,0,0,0,0,0,0,0,0,0,6000
055968,祥碩元大97購04  ,0,0,0,0,0,0,0,0,0,5000,0,0,0,10000,5000,5000,5000
056360,智邦元大98購01  ,0,0,0,0,0,0,0,0,0,5000,0,0,0,27000,22000,5000,5000
056329,上銀國票98購02  ,0,0,0,0,0,0,0,0,0,5000,0,0,0,14000,9000,5000,5000
05562P,鴻海元大96售16  ,0,0,0,0,0,0,0,0,0,5000,0,0,0,5000,0,5000,5000
05691P,聯發科中信98售01,0,0,0,0,0,0,0,0,0,5000,0,0,0,5000,0,5000,5000
056881,台灣50康和9A購01,0,0,0,0,0,0,0,0,0,5000,0,0,0,92000,87000,5000,5000
056902,大立光元大98購12,0,0,0,0,0,0,0,0,0,5000,0,0,0,5000,0,5000,5000
057135,立積凱基98購01  ,0,0,0,0,0,0,0,0,0,5000,0,0,0,5000,0,5000,5000
05220P,台積電元大95售16,0,0,0,0,0,0,0,0,0,5000,0,0,0,5000,0,5000,5000
057051,群創元大9B購03  ,0,0,0,0,0,0,0,0,0,5000,0,0,0,145000,140000,5000,5000
056611,國巨永豐98購03  ,0,0,0,0,0,0,0,0,0,5000,0,0,0,26000,21000,5000,5000
056572,義隆元大99購01  ,0,0,0,0,0,0,0,0,0,5000,0,0,0,20000,15000,5000,5000
056844,欣興元富98購03  ,0,0,0,0,0,0,0,0,0,5000,0,0,0,7000,2000,5000,5000
06167P,欣興國票97售05  ,0,0,0,0,0,0,0,0,0,5000,0,0,0,5000,0,5000,5000
05967P,臺股指麥證96售02,0,0,0,5000,0,5000,0,0,0,5000,0,0,0,5000,0,5000,5000
05930P,景碩康和96售01  ,0,0,0,0,0,0,0,0,0,5000,0,0,0,5000,0,5000,5000
05831P,臺股指元富96售03,0,0,0,0,0,0,0,0,0,5000,0,0,0,5000,0,5000,5000
05905P,晶技統一97售01  ,0,0,0,0,0,0,0,0,0,5000,0,0,0,5000,0,5000,5000
05751P,台積電中信96售05,0,0,0,0,0,0,0,0,0,5000,0,0,0,5000,0,5000,5000
057358,元油2X元大98購08,0,0,0,0,0,0,0,0,0,5000,0,0,0,5000,0,5000,5000
047234,晶技凱基93購01  ,0,0,0,0,0,0,0,0,0,5000,0,0,0,10000,5000,5000,5000
046975,元金2X永豐93購01,0,0,0,0,0,0,0,0,0,5000,0,0,0,5000,0,5000,5000
048813,元黃金凱基94購01,0,0,0,0,0,0,0,0,0,5000,0,0,0,5000,0,5000,5000
050355,瑞儀群益94購01  ,0,0,0,0,0,0,0,0,0,5000,0,0,0,5000,0,5000,5000
051477,可成凱基95購07  ,0,0,0,0,0,0,0,0,0,5000,0,0,0,5000,0,5000,5000
051484,玉晶光凱基97購01,0,0,0,0,0,0,0,0,0,5000,0,0,0,51000,46000,5000,5000
05181P,健策凱基95售01  ,0,0,0,0,0,0,0,0,0,5000,0,0,0,10000,5000,5000,5000
048286,滬深2X兆豐94購04,0,0,0,0,0,0,0,0,0,5000,0,0,0,215000,210000,5000,5000
048137,力成國票93購01  ,0,0,0,0,0,0,0,0,0,5000,0,0,0,5000,0,5000,5000
048066,樺漢統一93購01  ,0,0,0,0,0,0,0,0,0,5000,0,0,0,5000,0,5000,5000
046649,致伸國泰94購01  ,0,0,0,0,0,0,0,0,0,5000,0,0,0,15000,10000,5000,5000
046440,義隆亞東93購01  ,0,0,0,0,0,0,0,0,0,5000,0,0,0,5000,0,5000,5000
047881,和鑫國泰95購01  ,0,0,0,0,0,0,0,0,0,5000,0,0,0,5000,0,5000,5000
044908,玉晶光凱基93購01,0,0,0,0,0,0,0,0,0,5000,0,0,0,5000,0,5000,5000
03074P,大立光國泰03售05,0,0,0,0,0,0,0,0,0,5000,0,0,0,5000,0,5000,5000
03154P,華新科群益01售07,0,0,0,0,0,0,0,0,0,5000,0,0,0,5000,0,5000,5000
04120P,智邦凱基93售09  ,0,0,0,0,0,0,0,0,0,5000,0,0,0,5000,0,5000,5000
03801P,智伸科元大93售02,0,0,0,0,0,0,0,0,0,5000,0,0,0,5000,0,5000,5000
03540P,景碩台新02售02  ,0,0,0,0,0,0,0,0,0,5000,0,0,0,5000,0,5000,5000
03450P,元油2X元富98售05,0,0,0,0,0,0,0,0,0,5000,0,0,0,5000,0,5000,5000
046105,同欣電永豐92購02,0,0,0,0,0,0,0,0,0,5000,0,0,0,5000,0,5000,5000
043511,上銀富邦93購01  ,0,0,0,0,0,0,0,0,0,5000,0,0,0,5000,0,5000,5000
050123,群臺反凱基96購01,0,0,0,0,0,0,0,0,0,5000,0,0,0,5000,0,5000,5000
050128,旺宏凱基94購04  ,0,0,0,0,0,0,0,0,0,5000,0,0,0,32000,27000,5000,5000
051625,聯發科麥證95購01,0,0,0,30000,25000,5000,0,0,0,5000,0,0,0,30000,25000,5000,5000
049274,臺股指元大94購09,0,0,0,0,0,0,0,0,0,5000,0,0,0,8000,3000,5000,5000
051503,玉晶光統一97購01,0,0,0,0,0,0,0,0,0,5000,0,0,0,10000,5000,5000,5000
05040P,聯發科凱基95售05,0,0,0,0,0,0,0,0,0,5000,0,0,0,6000,1000,5000,5000
051919,台郡元大96購02  ,0,0,0,0,0,0,0,0,0,5000,0,0,0,15000,10000,5000,5000
051970,元黃金凱基98購01,0,0,0,0,0,0,0,0,0,5000,0,0,0,5000,0,5000,5000
050749,道瓊銀統一96購03,0,0,0,0,0,0,0,0,0,5000,0,0,0,5000,0,5000,5000
051258,鈺齊國泰97購01  ,0,0,0,0,0,0,0,0,0,5000,0,0,0,10000,5000,5000,5000
050209,華通國票95購01  ,0,0,0,0,0,0,0,0,0,5000,0,0,0,5000,0,5000,5000
050274,GIS元大94購05   ,0,0,0,0,0,0,0,0,0,5000,0,0,0,5000,0,5000,5000
050300,康控凱基94購03  ,0,0,0,0,0,0,0,0,0,5000,0,0,0,5000,0,5000,5000
051663,鴻海元大95購18  ,0,0,0,0,0,0,0,0,0,5000,0,0,0,5000,0,5000,5000
051691,台表科凱基95購01,0,0,0,0,0,0,0,0,0,5000,0,0,0,5000,0,5000,5000
050688,大立光日盛94購03,0,0,0,0,0,0,0,0,0,5000,0,0,0,206000,201000,5000,5000
053037,國巨凱基96購08  ,0,0,0,0,0,0,0,0,0,5000,0,0,0,33000,28000,5000,5000
052137,台表科凱基96購02,0,0,0,0,0,0,0,0,0,5000,0,0,0,89000,84000,5000,5000
049864,聯發科兆豐94購01,0,0,0,0,0,0,0,0,0,5000,0,0,0,98000,93000,5000,5000
052442,中環元大95購02  ,0,0,0,0,0,0,0,0,0,5000,0,0,0,5000,0,5000,5000
052641,聯詠台新96購01  ,0,0,0,0,0,0,0,0,0,5000,0,0,0,5000,0,5000,5000
049641,台達電凱基94購08,0,0,0,0,0,0,0,0,0,5000,0,0,0,35000,30000,5000,5000
049671,上証2X富邦95購01,0,0,0,0,0,0,0,0,0,5000,0,0,0,5000,0,5000,5000
049629,臺股指群益94購02,0,0,0,0,0,0,0,0,0,5000,0,0,0,5000,0,5000,5000
050813,旺宏凱基96購01  ,0,0,0,0,0,0,0,0,0,5000,0,0,0,17000,12000,5000,5000
049780,智易統一94購02  ,0,0,0,0,0,0,0,0,0,5000,0,0,0,60000,55000,5000,5000
048920,川湖永豐94購01  ,0,0,0,0,0,0,0,0,0,5000,0,0,0,5000,0,5000,5000
048960,矽格康和94購01  ,0,0,0,0,0,0,0,0,0,5000,0,0,0,5000,0,5000,5000
048971,美食元大94購01  ,0,0,0,0,0,0,0,0,0,5000,0,0,0,5000,0,5000,5000
04908P,南電國票95售03  ,0,0,0,0,0,0,0,0,0,5000,0,0,0,5000,0,5000,5000
05490P,鴻海元大95售23  ,0,0,0,0,0,0,0,0,0,5000,0,0,0,5000,0,5000,5000
054867,華航群益99購01  ,0,0,0,0,0,0,0,0,0,5000,0,0,0,22000,17000,5000,5000
05508P,華通統一97售01  ,0,0,0,0,0,0,0,0,0,5000,0,0,0,5000,0,5000,5000
055173,瑞昱統一97購01  ,0,0,0,0,0,0,0,0,0,5000,0,0,0,5000,0,5000,5000
054496,為升永豐96購01  ,0,0,0,0,0,0,0,0,0,5000,0,0,0,5000,0,5000,5000
054482,大成鋼台新96購01,0,0,0,0,0,0,0,0,0,5000,0,0,0,5000,0,5000,5000
054644,A50正2群益9B購01,0,0,0,0,0,0,0,0,0,5000,0,0,0,6000,1000,5000,5000
054525,奇鋐元富96購01  ,0,0,0,0,0,0,0,0,0,5000,0,0,0,5000,0,5000,5000
054085,華新科統一96購04,0,0,0,0,0,0,0,0,0,5000,0,0,0,10000,5000,5000,5000
05403P,台積電富邦95售08,0,0,0,0,0,0,0,0,0,5000,0,0,0,5000,0,5000,5000
054006,智易統一97購01  ,0,0,0,0,0,0,0,0,0,5000,0,0,0,5000,0,5000,5000
054205,華新國票97購02  ,0,0,0,0,0,0,0,0,0,5000,0,0,0,20000,15000,5000,5000
054268,健策第一96購01  ,0,0,0,0,0,0,0,0,0,5000,0,0,0,9000,4000,5000,5000
052272,T50反1群益95購03,0,0,0,0,0,0,0,0,0,5000,0,0,0,5000,0,5000,5000
052778,智原國票97購01  ,0,0,0,0,0,0,0,0,0,5000,0,0,0,5000,0,5000,5000
05305P,華新科國泰97售01,0,0,0,0,0,0,0,0,0,5000,0,0,0,5000,0,5000,5000
052956,聯發科日盛96購01,0,0,0,0,0,0,0,0,0,5000,0,0,0,92000,87000,5000,5000
052976,台表科群益96購03,0,0,0,0,0,0,0,0,0,5000,0,0,0,41000,36000,5000,5000
053300,大成鋼凱基96購02,0,0,0,0,0,0,0,0,0,5000,0,0,0,5000,0,5000,5000
053379,南亞科元大96購01,0,0,0,0,0,0,0,0,0,5000,0,0,0,5000,0,5000,5000
053331,玉晶光永豐97購02,0,0,0,0,0,0,0,0,0,5000,0,0,0,20000,15000,5000,5000
053975,大立光元大98購04,0,0,0,0,0,0,0,0,0,5000,0,0,0,15000,10000,5000,5000
053763,T50反1富邦98購01,0,0,0,0,0,0,0,0,0,5000,0,0,0,5000,0,5000,5000
8480,泰昇-KY         ,9000,2000,7000,0,0,0,0,2000,-2000,0,0,0,0,0,0,0,5000
06664P,聯發科兆豐98售02,0,0,0,0,0,0,0,0,0,5000,0,0,0,5000,0,5000,5000
06199P,聯發科元大97售17,0,0,0,0,0,0,0,0,0,5000,0,0,0,5000,0,5000,5000
06381P,臺股指統一98售03,0,0,0,0,0,0,0,0,0,5000,0,0,0,5000,0,5000,5000
06384P,訊芯元富97售03  ,0,0,0,0,0,0,0,0,0,5000,0,0,0,5000,0,5000,5000
06366P,鴻海凱基97售10  ,0,0,0,0,0,0,0,0,0,5000,0,0,0,14000,9000,5000,5000
06451P,聯發科元大98售04,0,0,0,0,0,0,0,0,0,5000,0,0,0,5000,0,5000,5000
06503P,臺股指中信9A售02,0,0,0,0,0,0,0,0,0,5000,0,0,0,10000,5000,5000,5000
6243,迅杰            ,5000,0,5000,0,0,0,0,0,0,0,0,0,0,0,0,0,5000
3010,華立            ,14000,9000,5000,0,0,0,0,0,0,0,0,0,0,0,0,0,5000
2476,鉅祥            ,18000,13000,5000,0,0,0,0,0,0,0,0,0,0,0,0,0,5000
05774P,臺股指凱基99售04,0,0,0,0,0,0,0,0,0,4000,0,0,0,82000,78000,4000,4000
057191,祥碩元大98購05  ,0,0,0,0,0,0,0,0,0,4000,0,0,0,19000,15000,4000,4000
05842P,台積電元大96售15,0,0,0,0,0,0,0,0,0,4000,0,0,0,163000,159000,4000,4000
057056,立積元大99購02  ,0,0,0,0,0,0,0,0,0,4000,0,0,0,7000,3000,4000,4000
052209,深中小元大95購02,0,0,0,0,0,0,0,0,0,4000,0,0,0,260000,256000,4000,4000
057041,國巨元大99購04  ,0,0,0,0,0,0,0,0,0,4000,0,0,0,103000,99000,4000,4000
055465,和大凱基97購03  ,0,0,0,0,0,0,0,0,0,4000,0,0,0,21000,17000,4000,4000
056392,玉晶光富邦9C購01,0,0,0,0,0,0,0,0,0,4000,0,0,0,5000,1000,4000,4000
056296,旺宏元大97購07  ,0,0,0,0,0,0,0,0,0,4000,0,0,0,254000,250000,4000,4000
056304,創意元大97購03  ,0,0,0,0,0,0,0,0,0,4000,0,0,0,4000,0,4000,4000
056131,鴻海元大97購12  ,0,0,0,0,0,0,0,0,0,4000,0,0,0,5000,1000,4000,4000
056211,南港國票98購01  ,0,0,0,0,0,0,0,0,0,4000,0,0,0,4000,0,4000,4000
04308P,京元電凱基93售06,0,0,0,0,0,0,0,0,0,4000,0,0,0,8000,4000,4000,4000
046080,同欣電凱基92購03,0,0,0,0,0,0,0,0,0,4000,0,0,0,4000,0,4000,4000
03852P,華邦電凱基93售05,0,0,0,0,0,0,0,0,0,4000,0,0,0,16000,12000,4000,4000
044351,台光電元大92購02,0,0,0,0,0,0,0,0,0,4000,0,0,0,4000,0,4000,4000
044512,奇力新凱基93購02,0,0,0,0,0,0,0,0,0,4000,0,0,0,4000,0,4000,4000
046020,滬深2X元大95購02,0,0,0,0,0,0,0,0,0,4000,0,0,0,34000,30000,4000,4000
046348,嘉澤兆豐93購01  ,0,0,0,0,0,0,0,0,0,4000,0,0,0,20000,16000,4000,4000
047960,鈺齊永豐93購01  ,0,0,0,0,0,0,0,0,0,4000,0,0,0,4000,0,4000,4000
047833,全新元大94購02  ,0,0,0,0,0,0,0,0,0,4000,0,0,0,5000,1000,4000,4000
048307,道瓊指凱基93購01,0,0,0,0,0,0,0,0,0,4000,0,0,0,4000,0,4000,4000
046881,智原富邦99購01  ,0,0,0,0,0,0,0,0,0,4000,0,0,0,7000,3000,4000,4000
047564,滬深2X國票99購01,0,0,0,0,0,0,0,0,0,4000,0,0,0,4000,0,4000,4000
047726,友達群益94購02  ,0,0,0,0,0,0,0,0,0,4000,0,0,0,4000,0,4000,4000
048788,華新科元大95購02,0,0,0,0,0,0,0,0,0,4000,0,0,0,41000,37000,4000,4000
046988,南亞科凱基93購02,0,0,0,0,0,0,0,0,0,4000,0,0,0,41000,37000,4000,4000
048892,台郡元富97購01  ,0,0,0,0,0,0,0,0,0,4000,0,0,0,6000,2000,4000,4000
049767,奇力新元富94購01,0,0,0,0,0,0,0,0,0,4000,0,0,0,4000,0,4000,4000
049978,瑞昱凱基94購04  ,0,0,0,0,0,0,0,0,0,4000,0,0,0,207000,203000,4000,4000
051000,台郡元大96購01  ,0,0,0,0,0,0,0,0,0,4000,0,0,0,205000,201000,4000,4000
050853,南電國票96購01  ,0,0,0,0,0,0,0,0,0,4000,0,0,0,4000,0,4000,4000
049534,華擎永豐94購02  ,0,0,0,0,0,0,0,0,0,4000,0,0,0,4000,0,4000,4000
049584,台積電元大96購04,0,0,0,0,0,0,0,0,0,4000,0,0,0,282000,278000,4000,4000
052400,聯詠凱基97購01  ,0,0,0,0,0,0,0,0,0,4000,0,0,0,4000,0,4000,4000
052377,景碩元大96購02  ,0,0,0,0,0,0,0,0,0,4000,0,0,0,231000,227000,4000,4000
049847,旺宏群益94購04  ,0,0,0,0,0,0,0,0,0,4000,0,0,0,11000,7000,4000,4000
049889,欣興國泰96購01  ,0,0,0,0,0,0,0,0,0,4000,0,0,0,6000,2000,4000,4000
049165,元油2X凱基97購01,0,0,0,0,0,0,0,0,0,4000,0,0,0,4000,0,4000,4000
049814,超眾元大95購04  ,0,0,0,0,0,0,0,0,0,4000,0,0,0,4000,0,4000,4000
051207,聯茂麥證95購01  ,0,0,0,54000,50000,4000,0,0,0,4000,0,0,0,54000,50000,4000,4000
051722,玉晶光永豐97購01,0,0,0,0,0,0,0,0,0,4000,0,0,0,4000,0,4000,4000
05172P,臺股指元大95售16,0,0,0,0,0,0,0,0,0,4000,0,0,0,5000,1000,4000,4000
051934,緯穎國票96購01  ,0,0,0,0,0,0,0,0,0,4000,0,0,0,4000,0,4000,4000
052056,緯穎凱基95購04  ,0,0,0,0,0,0,0,0,0,4000,0,0,0,30000,26000,4000,4000
049313,晶技凱基94購01  ,0,0,0,0,0,0,0,0,0,4000,0,0,0,125000,121000,4000,4000
049705,緯穎元大94購05  ,0,0,0,0,0,0,0,0,0,4000,0,0,0,28000,24000,4000,4000
049423,臺股指凱基95購02,0,0,0,0,0,0,0,0,0,4000,0,0,0,14000,10000,4000,4000
049397,台達電群益94購03,0,0,0,0,0,0,0,0,0,4000,0,0,0,10000,6000,4000,4000
049369,義隆元大95購01  ,0,0,0,0,0,0,0,0,0,4000,0,0,0,4000,0,4000,4000
053347,茂林國票98購01  ,0,0,0,0,0,0,0,0,0,4000,0,0,0,4000,0,4000,4000
053629,玉山金兆豐96購01,0,0,0,0,0,0,0,0,0,4000,0,0,0,20000,16000,4000,4000
053527,創意中信97購01  ,0,0,0,0,0,0,0,0,0,4000,0,0,0,4000,0,4000,4000
052270,力成日盛95購01  ,0,0,0,0,0,0,0,0,0,4000,0,0,0,84000,80000,4000,4000
054207,國巨國票98購01  ,0,0,0,0,0,0,0,0,0,4000,0,0,0,4000,0,4000,4000
054165,亞光凱基96購02  ,0,0,0,0,0,0,0,0,0,4000,0,0,0,64000,60000,4000,4000
054452,華通亞東96購01  ,0,0,0,0,0,0,0,0,0,4000,0,0,0,4000,0,4000,4000
055032,億光富邦99購01  ,0,0,0,0,0,0,0,0,0,4000,0,0,0,45000,41000,4000,4000
055053,瑞昱永豐97購01  ,0,0,0,0,0,0,0,0,0,4000,0,0,0,10000,6000,4000,4000
055288,日電貿元大97購02,0,0,0,0,0,0,0,0,0,4000,0,0,0,287000,283000,4000,4000
2442,新美齊          ,24000,20000,4000,0,0,0,0,0,0,0,0,0,0,0,0,0,4000
4426,利勤            ,34000,30000,4000,0,0,0,0,0,0,0,0,0,0,0,0,0,4000
06437P,玉晶光國票99售01,0,0,0,0,0,0,0,0,0,4000,0,0,0,4000,0,4000,4000
06342P,世芯統一98售01  ,0,0,0,0,0,0,0,0,0,4000,0,0,0,4000,0,4000,4000
2024,志聯            ,5000,1000,4000,0,0,0,0,0,0,0,0,0,0,0,0,0,4000
8473,山林水          ,5000,1000,4000,0,0,0,0,0,0,0,0,0,0,0,0,0,4000
9927,泰銘            ,19000,15000,4000,0,0,0,0,0,0,0,0,0,0,0,0,0,4000
056199,美律永豐97購01  ,0,0,0,0,0,0,0,0,0,3000,0,0,0,37000,34000,3000,3000
056114,台達電群益97購02,0,0,0,0,0,0,0,0,0,3000,0,0,0,10000,7000,3000,3000
05626P,景碩國票97售03  ,0,0,0,0,0,0,0,0,0,3000,0,0,0,3000,0,3000,3000
056395,玉晶光永豐9B購01,0,0,0,0,0,0,0,0,0,3000,0,0,0,13000,10000,3000,3000
056426,上証2X凱基9A購01,0,0,0,0,0,0,0,0,0,3000,0,0,0,3000,0,3000,3000
056508,揚明光永豐98購01,0,0,0,0,0,0,0,0,0,3000,0,0,0,25000,22000,3000,3000
055558,大立光凱基97購08,0,0,0,0,0,0,0,0,0,3000,0,0,0,3000,0,3000,3000
055420,欣興永豐98購01  ,0,0,0,0,0,0,0,0,0,3000,0,0,0,45000,42000,3000,3000
055330,上銀兆豐98購02  ,0,0,0,0,0,0,0,0,0,3000,0,0,0,3000,0,3000,3000
05578P,鴻海凱基96售11  ,0,0,0,0,0,0,0,0,0,3000,0,0,0,3000,0,3000,3000
055844,大毅元大98購01  ,0,0,0,0,0,0,0,0,0,3000,0,0,0,1452000,1449000,3000,3000
057022,智邦凱基98購04  ,0,0,0,0,0,0,0,0,0,3000,0,0,0,257000,254000,3000,3000
056932,T50反1元富98購01,0,0,0,0,0,0,0,0,0,3000,0,0,0,105000,102000,3000,3000
056841,友達元富98購03  ,0,0,0,0,0,0,0,0,0,3000,0,0,0,3000,0,3000,3000
056740,大立光凱基98購13,0,0,0,0,0,0,0,0,0,3000,0,0,0,3000,0,3000,3000
056746,超眾凱基99購01  ,0,0,0,0,0,0,0,0,0,3000,0,0,0,11000,8000,3000,3000
056676,國產元富98購01  ,0,0,0,0,0,0,0,0,0,3000,0,0,0,20000,17000,3000,3000
05973P,聯詠元大96售06  ,0,0,0,0,0,0,0,0,0,3000,0,0,0,10000,7000,3000,3000
05779P,台積電統一96售06,0,0,0,0,0,0,0,0,0,3000,0,0,0,3000,0,3000,3000
048643,強茂元大94購01  ,0,0,0,0,0,0,0,0,0,3000,0,0,0,3000,0,3000,3000
04715P,聯茂元大94售06  ,0,0,0,0,0,0,0,0,0,3000,0,0,0,3000,0,3000,3000
047105,和大元大94購01  ,0,0,0,0,0,0,0,0,0,3000,0,0,0,8000,5000,3000,3000
051791,智伸科國票96購01,0,0,0,0,0,0,0,0,0,3000,0,0,0,40000,37000,3000,3000
051472,台積電凱基95購09,0,0,0,0,0,0,0,0,0,3000,0,0,0,25000,22000,3000,3000
050351,華新科群益95購02,0,0,0,0,0,0,0,0,0,3000,0,0,0,23000,20000,3000,3000
050404,元大金麥證94購01,0,0,0,13000,10000,3000,0,0,0,3000,0,0,0,13000,10000,3000,3000
048719,亞光永豐94購01  ,0,0,0,0,0,0,0,0,0,3000,0,0,0,41000,38000,3000,3000
049257,南亞科元大94購03,0,0,0,0,0,0,0,0,0,3000,0,0,0,16000,13000,3000,3000
047729,聯茂群益93購02  ,0,0,0,0,0,0,0,0,0,3000,0,0,0,3000,0,3000,3000
046858,群創元大94購02  ,0,0,0,0,0,0,0,0,0,3000,0,0,0,264000,261000,3000,3000
048201,智易元大93購06  ,0,0,0,0,0,0,0,0,0,3000,0,0,0,3000,0,3000,3000
046773,GIS富邦94購01   ,0,0,0,0,0,0,0,0,0,3000,0,0,0,3000,0,3000,3000
047827,東陽元大93購01  ,0,0,0,0,0,0,0,0,0,3000,0,0,0,3000,0,3000,3000
04549P,茂林元大94售02  ,0,0,0,0,0,0,0,0,0,3000,0,0,0,3000,0,3000,3000
04516P,台積電群益94售07,0,0,0,0,0,0,0,0,0,3000,0,0,0,3000,0,3000,3000
043601,亞光元大93購01  ,0,0,0,0,0,0,0,0,0,3000,0,0,0,3000,0,3000,3000
044988,玉晶光統一95購01,0,0,0,0,0,0,0,0,0,3000,0,0,0,20000,17000,3000,3000
04449P,智邦凱基94售01  ,0,0,0,0,0,0,0,0,0,3000,0,0,0,3000,0,3000,3000
04021P,寶滬深元富93售01,0,0,0,0,0,0,0,0,0,3000,0,0,0,3000,0,3000,3000
042929,台積電中信95購02,0,0,0,0,0,0,0,0,0,3000,0,0,0,4000,1000,3000,3000
04938P,亞德客國票95售01,0,0,0,0,0,0,0,0,0,3000,0,0,0,42000,39000,3000,3000
050574,微星國票94購01  ,0,0,0,0,0,0,0,0,0,3000,0,0,0,3000,0,3000,3000
051914,健策元大96購06  ,0,0,0,0,0,0,0,0,0,3000,0,0,0,19000,16000,3000,3000
051965,傳奇永豐95購01  ,0,0,0,0,0,0,0,0,0,3000,0,0,0,55000,52000,3000,3000
051721,玉晶光永豐96購02,0,0,0,0,0,0,0,0,0,3000,0,0,0,4000,1000,3000,3000
050700,健策凱基96購01  ,0,0,0,0,0,0,0,0,0,3000,0,0,0,5000,2000,3000,3000
049811,聯鈞元大94購01  ,0,0,0,0,0,0,0,0,0,3000,0,0,0,86000,83000,3000,3000
049136,華通元大95購01  ,0,0,0,0,0,0,0,0,0,3000,0,0,0,61000,58000,3000,3000
052154,緯創台新95購01  ,0,0,0,0,0,0,0,0,0,3000,0,0,0,41000,38000,3000,3000
052393,康友群益95購05  ,0,0,0,0,0,0,0,0,0,3000,0,0,0,50000,47000,3000,3000
049557,南電元富94購02  ,0,0,0,0,0,0,0,0,0,3000,0,0,0,3000,0,3000,3000
049936,柏文元大94購02  ,0,0,0,0,0,0,0,0,0,3000,0,0,0,3000,0,3000,3000
054445,技嘉兆豐96購01  ,0,0,0,0,0,0,0,0,0,3000,0,0,0,32000,29000,3000,3000
054177,牧德台新97購01  ,0,0,0,0,0,0,0,0,0,3000,0,0,0,3000,0,3000,3000
052800,國巨元大96購05  ,0,0,0,0,0,0,0,0,0,3000,0,0,0,3000,0,3000,3000
052751,臺股指元大96購05,0,0,0,0,0,0,0,0,0,3000,0,0,0,10000,7000,3000,3000
052274,大立光群益95購03,0,0,0,0,0,0,0,0,0,3000,0,0,0,13000,10000,3000,3000
053203,智易日盛96購01  ,0,0,0,0,0,0,0,0,0,3000,0,0,0,3000,0,3000,3000
052325,高股息中信99購01,0,0,0,0,0,0,0,0,0,3000,0,0,0,3000,0,3000,3000
052292,緯穎元富95購02  ,0,0,0,0,0,0,0,0,0,3000,0,0,0,5000,2000,3000,3000
053547,台積電凱基96購14,0,0,0,0,0,0,0,0,0,3000,0,0,0,3000,0,3000,3000
053566,大立光富邦99購03,0,0,0,0,0,0,0,0,0,3000,0,0,0,3000,0,3000,3000
053421,南亞科永豐96購01,0,0,0,0,0,0,0,0,0,3000,0,0,0,78000,75000,3000,3000
053849,聯發科元富96購04,0,0,0,0,0,0,0,0,0,3000,0,0,0,3000,0,3000,3000
8222,寶一            ,0,0,0,0,0,0,0,0,0,3000,3000,0,3000,0,0,0,3000
8442,威宏-KY         ,4000,1000,3000,0,0,0,0,0,0,0,0,0,0,0,0,0,3000
1726,永記            ,5000,2000,3000,0,0,0,0,0,0,0,0,0,0,0,0,0,3000
1442,名軒            ,16000,12000,4000,0,0,0,0,0,0,-1000,0,1000,-1000,0,0,0,3000
06633P,國巨國票99售01  ,0,0,0,0,0,0,0,0,0,3000,0,0,0,18000,15000,3000,3000
06244P,智易元富97售02  ,0,0,0,0,0,0,0,0,0,3000,0,0,0,3000,0,3000,3000
4545,銘鈺            ,6000,3000,3000,0,0,0,0,0,0,0,0,0,0,0,0,0,3000
3257,虹冠電          ,11000,13000,-2000,0,0,0,0,0,0,5000,5000,0,5000,0,0,0,3000
6581,鋼聯            ,4000,1000,3000,0,0,0,0,0,0,0,0,0,0,0,0,0,3000
4976,佳凌            ,41000,38000,3000,0,0,0,0,0,0,0,0,0,0,0,0,0,3000
4999,鑫禾            ,4000,1000,3000,0,0,0,0,0,0,0,0,0,0,0,0,0,3000
2427,三商電          ,3000,0,3000,0,0,0,0,0,0,0,0,0,0,0,0,0,3000
2471,資通            ,4000,4000,0,0,0,0,0,0,0,3000,3000,0,3000,0,0,0,3000
2373,震旦行          ,5000,2000,3000,0,0,0,0,0,0,0,0,0,0,0,0,0,3000
2106,建大            ,42000,46000,-4000,0,0,0,0,0,0,7000,7000,0,7000,0,0,0,3000
3021,鴻名            ,3000,0,3000,0,0,0,0,0,0,0,0,0,0,0,0,0,3000
2881B,富邦金乙特      ,0,0,0,0,0,0,0,0,0,3000,3000,0,3000,0,0,0,3000
2882B,國泰金乙特      ,0,0,0,0,0,0,0,0,0,3000,3000,0,3000,0,0,0,3000
05786P,臺股指永昌96售03,0,0,0,0,0,0,0,0,0,2000,432000,50000,382000,160000,540000,-380000,2000
05755P,臺股指中信99售04,0,0,0,0,0,0,0,0,0,2000,0,0,0,13000,11000,2000,2000
05988P,光磊元富96售02  ,0,0,0,0,0,0,0,0,0,2000,0,0,0,2000,0,2000,2000
06068P,玉晶光康和97售01,0,0,0,0,0,0,0,0,0,2000,0,0,0,2000,0,2000,2000
05681P,大立光元大96售05,0,0,0,0,0,0,0,0,0,2000,0,0,0,25000,23000,2000,2000
056809,旺宏統一98購03  ,0,0,0,0,0,0,0,0,0,2000,0,0,0,48000,46000,2000,2000
056940,嘉聯益元富98購01,0,0,0,0,0,0,0,0,0,2000,0,0,0,7000,5000,2000,2000
057017,和大凱基98購01  ,0,0,0,0,0,0,0,0,0,2000,0,0,0,47000,45000,2000,2000
056981,全新群益99購03  ,0,0,0,0,0,0,0,0,0,2000,0,0,0,43000,41000,2000,2000
057100,國巨中信9A購02  ,0,0,0,0,0,0,0,0,0,2000,0,0,0,2000,0,2000,2000
055813,聯發科國票98購04,0,0,0,0,0,0,0,0,0,2000,0,0,0,5000,3000,2000,2000
055440,矽力國票98購01  ,0,0,0,0,0,0,0,0,0,2000,0,0,0,20000,18000,2000,2000
055448,健策統一97購02  ,0,0,0,0,0,0,0,0,0,2000,0,0,0,10000,8000,2000,2000
055612,台光電國票97購04,0,0,0,0,0,0,0,0,0,2000,0,0,0,2000,0,2000,2000
056142,超眾元大97購06  ,0,0,0,0,0,0,0,0,0,2000,0,0,0,11000,9000,2000,2000
056176,創意元富97購01  ,0,0,0,0,0,0,0,0,0,2000,0,0,0,36000,34000,2000,2000
056233,超眾凱基97購02  ,0,0,0,0,0,0,0,0,0,2000,0,0,0,2000,0,2000,2000
056028,GIS群益97購02   ,0,0,0,0,0,0,0,0,0,2000,0,0,0,22000,20000,2000,2000
036628,統一台新99購01  ,0,0,0,0,0,0,0,0,0,2000,0,0,0,10000,8000,2000,2000
00683L,元大美元指數正2 ,0,0,0,0,0,0,0,0,0,2000,0,0,0,42000,40000,2000,2000
044633,台郡元大92購03  ,0,0,0,0,0,0,0,0,0,2000,0,0,0,2000,0,2000,2000
045457,光磊元大93購01  ,0,0,0,0,0,0,0,0,0,2000,0,0,0,2000,0,2000,2000
047830,智邦元大93購08  ,0,0,0,0,0,0,0,0,0,2000,0,0,0,2000,0,2000,2000
047832,漢唐元大94購03  ,0,0,0,0,0,0,0,0,0,2000,0,0,0,2000,0,2000,2000
046380,神基凱基93購01  ,0,0,0,0,0,0,0,0,0,2000,0,0,0,302000,300000,2000,2000
046460,聯鈞凱基93購02  ,0,0,0,0,0,0,0,0,0,2000,0,0,0,58000,56000,2000,2000
046465,GIS凱基95購01   ,0,0,0,0,0,0,0,0,0,2000,0,0,0,3000,1000,2000,2000
046862,台郡元大94購01  ,0,0,0,0,0,0,0,0,0,2000,0,0,0,2000,0,2000,2000
048313,南亞科凱基93購06,0,0,0,0,0,0,0,0,0,2000,0,0,0,2000,0,2000,2000
048243,儒鴻兆豐94購01  ,0,0,0,0,0,0,0,0,0,2000,0,0,0,2000,0,2000,2000
048267,元金反中信93購01,0,0,0,0,0,0,0,0,0,2000,0,0,0,2000,0,2000,2000
046734,華通國票93購02  ,0,0,0,0,0,0,0,0,0,2000,0,0,0,2000,0,2000,2000
047636,台達電元大93購03,0,0,0,0,0,0,0,0,0,2000,0,0,0,2000,0,2000,2000
047533,瑞儀元大93購02  ,0,0,0,0,0,0,0,0,0,2000,0,0,0,2000,0,2000,2000
047447,台郡元大94購02  ,0,0,0,0,0,0,0,0,0,2000,0,0,0,2000,0,2000,2000
047413,台積電永昌93購05,0,0,0,0,0,0,0,0,0,2000,0,0,0,4000,2000,2000,2000
04741P,台積電統一94售10,0,0,0,0,0,0,0,0,0,2000,0,0,0,2000,0,2000,2000
04737P,正崴永豐94售02  ,0,0,0,0,0,0,0,0,0,2000,0,0,0,2000,0,2000,2000
048410,和碩群益93購01  ,0,0,0,0,0,0,0,0,0,2000,0,0,0,12000,10000,2000,2000
051825,中環元大95購01  ,0,0,0,0,0,0,0,0,0,2000,0,0,0,2000,0,2000,2000
051849,旺宏中信98購01  ,0,0,0,0,0,0,0,0,0,2000,0,0,0,20000,18000,2000,2000
047110,智邦元大93購05  ,0,0,0,0,0,0,0,0,0,2000,0,0,0,2000,0,2000,2000
047184,漢唐元大94購02  ,0,0,0,0,0,0,0,0,0,2000,0,0,0,2000,0,2000,2000
048655,A50正2元富96購01,0,0,0,0,0,0,0,0,0,2000,0,0,0,2000,0,2000,2000
048794,易華電元大97購01,0,0,0,0,0,0,0,0,0,2000,0,0,0,2000,0,2000,2000
047055,旭富國票93購01  ,0,0,0,0,0,0,0,0,0,2000,0,0,0,3000,1000,2000,2000
047020,智邦元大93購04  ,0,0,0,0,0,0,0,0,0,2000,0,0,0,2000,0,2000,2000
048589,國巨兆豐96購01  ,0,0,0,0,0,0,0,0,0,2000,0,0,0,2000,0,2000,2000
04731P,臺股指中信96售03,0,0,0,0,0,0,0,0,0,2000,0,0,0,50000,48000,2000,2000
047339,臺股指元大93購34,0,0,0,0,0,0,0,0,0,2000,0,0,0,2000,0,2000,2000
04974P,聯發科凱基96售02,0,0,0,0,0,0,0,0,0,2000,0,0,0,11000,9000,2000,2000
051015,南亞科凱基95購04,0,0,0,0,0,0,0,0,0,2000,0,0,0,11000,9000,2000,2000
049026,晶相光群益94購01,0,0,0,0,0,0,0,0,0,2000,0,0,0,30000,28000,2000,2000
051350,台積電元大95購14,0,0,0,0,0,0,0,0,0,2000,0,0,0,163000,161000,2000,2000
052172,致茂元大95購01  ,0,0,0,0,0,0,0,0,0,2000,0,0,0,10000,8000,2000,2000
052615,鴻海國泰98購01  ,0,0,0,0,0,0,0,0,0,2000,0,0,0,50000,48000,2000,2000
049142,智邦元大94購01  ,0,0,0,0,0,0,0,0,0,2000,0,0,0,2000,0,2000,2000
049143,智邦元大94購02  ,0,0,0,0,0,0,0,0,0,2000,0,0,0,2000,0,2000,2000
049868,傳奇兆豐94購01  ,0,0,0,0,0,0,0,0,0,2000,0,0,0,62000,60000,2000,2000
049451,富邦金統一94購03,0,0,0,0,0,0,0,0,0,2000,0,0,0,2000,0,2000,2000
050759,貿聯元富94購02  ,0,0,0,0,0,0,0,0,0,2000,0,0,0,54000,52000,2000,2000
050766,燿華元大96購02  ,0,0,0,0,0,0,0,0,0,2000,0,0,0,2000,0,2000,2000
051251,信邦元大95購01  ,0,0,0,0,0,0,0,0,0,2000,0,0,0,2000,0,2000,2000
051488,健策凱基96購04  ,0,0,0,0,0,0,0,0,0,2000,0,0,0,656000,654000,2000,2000
049273,臺股指元大94購08,0,0,0,0,0,0,0,0,0,2000,0,0,0,2000,0,2000,2000
049293,友訊群益95購01  ,0,0,0,0,0,0,0,0,0,2000,0,0,0,32000,30000,2000,2000
049343,華新科統一94購03,0,0,0,0,0,0,0,0,0,2000,0,0,0,22000,20000,2000,2000
050458,台郡元大94購03  ,0,0,0,0,0,0,0,0,0,2000,0,0,0,2000,0,2000,2000
050632,國巨群益94購07  ,0,0,0,0,0,0,0,0,0,2000,0,0,0,2000,0,2000,2000
050085,國泰金元富94購01,0,0,0,0,0,0,0,0,0,2000,0,0,0,2000,0,2000,2000
049364,燿華元大94購02  ,0,0,0,0,0,0,0,0,0,2000,0,0,0,2000,0,2000,2000
049396,元油2X群益97購03,0,0,0,0,0,0,0,0,0,2000,0,0,0,2000,0,2000,2000
053937,光磊元富96購01  ,0,0,0,0,0,0,0,0,0,2000,0,0,0,2000,0,2000,2000
053469,光磊元大97購01  ,0,0,0,0,0,0,0,0,0,2000,0,0,0,12000,10000,2000,2000
053472,漢唐元大96購02  ,0,0,0,0,0,0,0,0,0,2000,0,0,0,2000,0,2000,2000
053583,漢唐元大96購03  ,0,0,0,0,0,0,0,0,0,2000,0,0,0,2000,0,2000,2000
053118,大立光中信9C購01,0,0,0,0,0,0,0,0,0,2000,0,0,0,5000,3000,2000,2000
053121,上証2X凱基9C購01,0,0,0,0,0,0,0,0,0,2000,0,0,0,2000,0,2000,2000
053155,晶技元大97購02  ,0,0,0,0,0,0,0,0,0,2000,0,0,0,14000,12000,2000,2000
053232,友達永豐97購02  ,0,0,0,0,0,0,0,0,0,2000,0,0,0,10000,8000,2000,2000
052835,滬深2X國泰98購01,0,0,0,0,0,0,0,0,0,2000,0,0,0,2000,0,2000,2000
052750,臺股指元大96購04,0,0,0,0,0,0,0,0,0,2000,0,0,0,25000,23000,2000,2000
054086,日月光亞東98購01,0,0,0,0,0,0,0,0,0,2000,0,0,0,2000,0,2000,2000
054091,晶豪科群益96購01,0,0,0,0,0,0,0,0,0,2000,0,0,0,2000,0,2000,2000
05427P,聯發科凱基96售07,0,0,0,0,0,0,0,0,0,2000,0,0,0,109000,107000,2000,2000
054309,禾伸堂凱基98購01,0,0,0,0,0,0,0,0,0,2000,0,0,0,53000,51000,2000,2000
054417,牧德元大96購01  ,0,0,0,0,0,0,0,0,0,2000,0,0,0,2000,0,2000,2000
054412,智邦元大96購03  ,0,0,0,0,0,0,0,0,0,2000,0,0,0,6000,4000,2000,2000
054636,華通中信97購01  ,0,0,0,0,0,0,0,0,0,2000,0,0,0,2000,0,2000,2000
055232,泰碩國票98購01  ,0,0,0,0,0,0,0,0,0,2000,0,0,0,2000,0,2000,2000
055241,T50反1統一99購01,0,0,0,0,0,0,0,0,0,2000,0,0,0,2000,0,2000,2000
055120,南港兆豐97購01  ,0,0,0,0,0,0,0,0,0,2000,0,0,0,30000,28000,2000,2000
054708,華通統一97購02  ,0,0,0,0,0,0,0,0,0,2000,0,0,0,2000,0,2000,2000
2891B,中信金乙特      ,0,0,0,0,0,0,0,0,0,2000,2000,0,2000,0,0,0,2000
2739,寒舍            ,0,0,0,0,0,0,0,0,0,2000,2000,0,2000,0,0,0,2000
2612,中航            ,11000,9000,2000,0,0,0,0,0,0,0,0,0,0,0,0,0,2000
6215,和椿            ,4000,2000,2000,0,0,0,0,0,0,0,0,0,0,0,0,0,2000
3583,辛耘            ,43000,41000,2000,0,0,0,0,0,0,0,0,0,0,0,0,0,2000
3591,艾笛森          ,2000,0,2000,0,0,0,0,0,0,0,0,0,0,0,0,0,2000
3419,譁裕            ,10000,8000,2000,0,0,0,0,0,0,0,0,0,0,0,0,0,2000
4572,駐龍            ,2000,0,2000,0,0,0,0,0,0,0,0,0,0,0,0,0,2000
4106,雃博            ,2000,1000,1000,0,0,0,0,0,0,1000,1000,0,1000,0,0,0,2000
06238P,台積電元大98售07,0,0,0,0,0,0,0,0,0,2000,0,0,0,2000,0,2000,2000
06294P,臺股指國票97售08,0,0,0,0,0,0,0,0,0,2000,0,0,0,3000,1000,2000,2000
06259P,臺股指群益97售12,0,0,0,0,0,0,0,0,0,2000,0,0,0,2000,0,2000,2000
06556P,臺股指元大99售08,0,0,0,0,0,0,0,0,0,2000,0,0,0,2000,0,2000,2000
1435,中福            ,2000,0,2000,0,0,0,0,0,0,0,0,0,0,0,0,0,2000
1528,恩德            ,3000,1000,2000,0,0,0,0,0,0,0,0,0,0,0,0,0,2000
1783,和康生          ,6000,4000,2000,0,0,0,0,0,0,0,0,0,0,0,0,0,2000
8374,羅昇            ,3000,1000,2000,0,0,0,0,0,0,0,0,0,0,0,0,0,2000
8261,富鼎            ,51000,49000,2000,0,0,0,0,0,0,0,0,0,0,0,0,0,2000
8114,振樺電          ,6000,4000,2000,0,0,0,0,0,0,0,0,0,0,0,0,0,2000
9912,偉聯            ,1000,0,1000,0,0,0,0,0,0,1000,1000,0,1000,0,0,0,2000
8070,長華*           ,5811,4000,1811,0,0,0,0,0,0,0,0,0,0,0,0,0,1811
008201,BP上證50        ,0,0,0,0,0,0,0,0,0,1800,0,0,0,1800,0,1800,1800
055988,矽力元富97購01  ,0,0,0,0,0,0,0,0,0,1000,0,0,0,22000,21000,1000,1000
056203,興富發永豐97購01,0,0,0,0,0,0,0,0,0,1000,0,0,0,1000,0,1000,1000
056498,A50正2富邦9B購01,0,0,0,0,0,0,0,0,0,1000,0,0,0,1000,0,1000,1000
05630P,大立光永昌96售06,0,0,0,0,0,0,0,0,0,1000,0,0,0,216000,215000,1000,1000
055389,國巨統一98購02  ,0,0,0,0,0,0,0,0,0,1000,0,0,0,1000,0,1000,1000
055382,台郡元大99購01  ,0,0,0,0,0,0,0,0,0,1000,0,0,0,1000,0,1000,1000
055318,華通國票98購01  ,0,0,0,0,0,0,0,0,0,1000,0,0,0,22000,21000,1000,1000
055806,致新永豐97購02  ,0,0,0,0,0,0,0,0,0,1000,0,0,0,43000,42000,1000,1000
057048,新日興元大98購01,0,0,0,0,0,0,0,0,0,1000,0,0,0,137000,136000,1000,1000
052210,華夏元大95購01  ,0,0,0,0,0,0,0,0,0,1000,0,0,0,1000,0,1000,1000
05674P,瑞昱群益96售02  ,0,0,0,0,0,0,0,0,0,1000,0,0,0,1000,0,1000,1000
056769,國產元大98購01  ,0,0,0,0,0,0,0,0,0,1000,0,0,0,1000,0,1000,1000
056755,聯茂兆豐98購01  ,0,0,0,0,0,0,0,0,0,1000,0,0,0,1000,0,1000,1000
056660,臺股指元大9A購07,0,0,0,0,0,0,0,0,0,1000,0,0,0,1000,0,1000,1000
06112P,台積電兆豐97售01,0,0,0,0,0,0,0,0,0,1000,0,0,0,30000,29000,1000,1000
05996P,華新科群益96售03,0,0,0,0,0,0,0,0,0,1000,0,0,0,15000,14000,1000,1000
06010P,國泰金元富96售01,0,0,0,0,0,0,0,0,0,1000,0,0,0,1000,0,1000,1000
00652,富邦印度        ,3000,0,3000,0,0,0,0,0,0,-2000,0,0,0,23000,25000,-2000,1000
0054,元大台商50      ,0,0,0,0,0,0,0,0,0,1000,0,0,0,1000,0,1000,1000
00684R,元大美元指數反1 ,0,0,0,0,0,0,0,0,0,1000,0,0,0,41000,40000,1000,1000
01003T,兆豐新光R1      ,1000,0,1000,0,0,0,0,0,0,0,0,0,0,0,0,0,1000
040381,元金2X元富95購01,0,0,0,0,0,0,0,0,0,1000,0,0,0,1000,0,1000,1000
00742,新光內需收益    ,0,0,0,0,0,0,0,0,0,1000,0,0,0,3000,2000,1000,1000
00736,國泰新興市場    ,0,0,0,0,0,0,0,0,0,1000,0,0,0,132000,131000,1000,1000
042116,元油2X國票97購01,0,0,0,0,0,0,0,0,0,1000,0,0,0,1000,0,1000,1000
04223P,友達統一93售05  ,0,0,0,0,0,0,0,0,0,1000,0,0,0,1000,0,1000,1000
03094X,大立光元大68展08,0,0,0,0,0,0,0,0,0,1000,0,0,0,1000,0,1000,1000
03033X,元展30          ,0,0,0,0,0,0,0,0,0,1000,0,0,0,1000,0,1000,1000
03417B,臺股指凱基95熊19,0,0,0,0,0,0,0,0,0,1000,0,0,0,12000,11000,1000,1000
03027X,元展24          ,0,0,0,0,0,0,0,0,0,1000,0,0,0,1000,0,1000,1000
03647C,T50反1元富99牛02,0,0,0,0,0,0,0,0,0,1000,0,0,0,1000,0,1000,1000
03771P,中磊元大93售03  ,0,0,0,0,0,0,0,0,0,1000,0,0,0,1000,0,1000,1000
03425B,臺股指元大9A熊01,0,0,0,0,0,0,0,0,0,1000,0,0,0,5000,4000,1000,1000
036084,台灣50台新98購01,0,0,0,0,0,0,0,0,0,1000,0,0,0,1000,0,1000,1000
046082,矽力凱基92購01  ,0,0,0,0,0,0,0,0,0,1000,0,0,0,11000,10000,1000,1000
03890P,聯詠國泰94售02  ,0,0,0,0,0,0,0,0,0,1000,0,0,0,1000,0,1000,1000
046428,矽力元大92購02  ,0,0,0,0,0,0,0,0,0,1000,0,0,0,11000,10000,1000,1000
047984,禾伸堂群益93購01,0,0,0,0,0,0,0,0,0,1000,0,0,0,1000,0,1000,1000
04798P,牧德元大95售02  ,0,0,0,0,0,0,0,0,0,1000,0,0,0,1000,0,1000,1000
047995,台達電元大96購01,0,0,0,0,0,0,0,0,0,1000,0,0,0,1000,0,1000,1000
047849,中工統一93購01  ,0,0,0,0,0,0,0,0,0,1000,0,0,0,1000,0,1000,1000
045401,大立光兆豐93購01,0,0,0,0,0,0,0,0,0,1000,0,0,0,11000,10000,1000,1000
045380,漢唐元大93購03  ,0,0,0,0,0,0,0,0,0,1000,0,0,0,1000,0,1000,1000
04462P,全新元富96售01  ,0,0,0,0,0,0,0,0,0,1000,0,0,0,21000,20000,1000,1000
046030,南亞科元大92購04,0,0,0,0,0,0,0,0,0,1000,0,0,0,1000,0,1000,1000
04366P,全新元富95售01  ,0,0,0,0,0,0,0,0,0,1000,0,0,0,21000,20000,1000,1000
047052,大毅國票93購01  ,0,0,0,0,0,0,0,0,0,1000,0,0,0,1000,0,1000,1000
048633,台達電元大94購02,0,0,0,0,0,0,0,0,0,1000,0,0,0,1000,0,1000,1000
048639,漢唐元大93購07  ,0,0,0,0,0,0,0,0,0,1000,0,0,0,4000,3000,1000,1000
047137,健策凱基94購01  ,0,0,0,0,0,0,0,0,0,1000,0,0,0,1000,0,1000,1000
049248,台達電元大94購04,0,0,0,0,0,0,0,0,0,1000,0,0,0,1000,0,1000,1000
049249,台達電元大94購05,0,0,0,0,0,0,0,0,0,1000,0,0,0,1000,0,1000,1000
050372,全新元大96購03  ,0,0,0,0,0,0,0,0,0,1000,0,0,0,1000,0,1000,1000
048412,台勝科亞東93購01,0,0,0,0,0,0,0,0,0,1000,0,0,0,1000,0,1000,1000
047434,台積電元大93購21,0,0,0,0,0,0,0,0,0,1000,0,0,0,1000,0,1000,1000
047487,南電凱基94購01  ,0,0,0,0,0,0,0,0,0,1000,0,0,0,1000,0,1000,1000
047557,麗豐凱基94購02  ,0,0,0,0,0,0,0,0,0,1000,0,0,0,1000,0,1000,1000
047758,康舒元富93購01  ,0,0,0,0,0,0,0,0,0,1000,0,0,0,1000,0,1000,1000
047752,健鼎元富93購01  ,0,0,0,0,0,0,0,0,0,1000,0,0,0,1000,0,1000,1000
048122,台達電元大96購02,0,0,0,0,0,0,0,0,0,1000,0,0,0,1000,0,1000,1000
048169,瑞昱永豐93購02  ,0,0,0,0,0,0,0,0,0,1000,0,0,0,1000,0,1000,1000
048073,南電元富93購02  ,0,0,0,0,0,0,0,0,0,1000,0,0,0,1000,0,1000,1000
048273,南電富邦97購01  ,0,0,0,0,0,0,0,0,0,1000,0,0,0,5000,4000,1000,1000
049360,台達電元大94購07,0,0,0,0,0,0,0,0,0,1000,0,0,0,1000,0,1000,1000
051584,可成元大95購08  ,0,0,0,0,0,0,0,0,0,1000,0,0,0,24000,23000,1000,1000
050069,禾伸堂凱基94購04,0,0,0,0,0,0,0,0,0,1000,0,0,0,11000,10000,1000,1000
050106,台達電元大94購11,0,0,0,0,0,0,0,0,0,1000,0,0,0,1000,0,1000,1000
050111,全新元大95購02  ,0,0,0,0,0,0,0,0,0,1000,0,0,0,18000,17000,1000,1000
050608,台達電元大94購12,0,0,0,0,0,0,0,0,0,1000,0,0,0,1000,0,1000,1000
050566,高股息中信97購02,0,0,0,0,0,0,0,0,0,1000,0,0,0,1000,0,1000,1000
050444,卜蜂元大94購03  ,0,0,0,0,0,0,0,0,0,1000,0,0,0,1000,0,1000,1000
051489,世芯凱基95購01  ,0,0,0,0,0,0,0,0,0,1000,0,0,0,120000,119000,1000,1000
049324,臺股指凱基94購06,0,0,0,0,0,0,0,0,0,1000,0,0,0,2000,1000,1000,1000
052094,瀚宇博元大96購02,0,0,0,0,0,0,0,0,0,1000,0,0,0,1000,0,1000,1000
052061,樺漢國票96購01  ,0,0,0,0,0,0,0,0,0,1000,0,0,0,11000,10000,1000,1000
051956,滬深2X台新96購01,0,0,0,0,0,0,0,0,0,1000,0,0,0,1000,0,1000,1000
051994,瀚宇博元大96購01,0,0,0,0,0,0,0,0,0,1000,0,0,0,1000,0,1000,1000
051224,華通群益96購03  ,0,0,0,0,0,0,0,0,0,1000,0,0,0,8000,7000,1000,1000
05074P,鴻海麥證95售01  ,0,0,0,1000,0,1000,0,0,0,1000,0,0,0,1000,0,1000,1000
051717,祥碩康和95購01  ,0,0,0,0,0,0,0,0,0,1000,0,0,0,1000,0,1000,1000
050785,全新國泰96購01  ,0,0,0,0,0,0,0,0,0,1000,0,0,0,1000,0,1000,1000
051736,旺宏國票96購01  ,0,0,0,0,0,0,0,0,0,1000,0,0,0,1000,0,1000,1000
051779,大立光群益95購02,0,0,0,0,0,0,0,0,0,1000,0,0,0,11000,10000,1000,1000
049511,奇力新凱基94購03,0,0,0,0,0,0,0,0,0,1000,0,0,0,11000,10000,1000,1000
05067P,欣興兆豐96售02  ,0,0,0,0,0,0,0,0,0,1000,0,0,0,14000,13000,1000,1000
051671,和鑫元大96購02  ,0,0,0,0,0,0,0,0,0,1000,0,0,0,1000,0,1000,1000
049135,台達電元大94購03,0,0,0,0,0,0,0,0,0,1000,0,0,0,1000,0,1000,1000
053049,T50反1國票98購01,0,0,0,0,0,0,0,0,0,1000,0,0,0,31000,30000,1000,1000
053058,台光電永昌99購01,0,0,0,0,0,0,0,0,0,1000,0,0,0,1000,0,1000,1000
052590,祥碩永豐96購01  ,0,0,0,0,0,0,0,0,0,1000,0,0,0,2000,1000,1000,1000
05266P,華新科元大95售11,0,0,0,0,0,0,0,0,0,1000,0,0,0,1000,0,1000,1000
052182,鴻海群益96購01  ,0,0,0,0,0,0,0,0,0,1000,0,0,0,92000,91000,1000,1000
052345,矽力凱基95購01  ,0,0,0,0,0,0,0,0,0,1000,0,0,0,11000,10000,1000,1000
049577,台達電元大94購08,0,0,0,0,0,0,0,0,0,1000,0,0,0,1000,0,1000,1000
049578,台達電元大94購09,0,0,0,0,0,0,0,0,0,1000,0,0,0,1000,0,1000,1000
050811,國巨凱基95購02  ,0,0,0,0,0,0,0,0,0,1000,0,0,0,1000,0,1000,1000
049675,台光電國票95購01,0,0,0,0,0,0,0,0,0,1000,0,0,0,1000,0,1000,1000
050900,台郡元大95購02  ,0,0,0,0,0,0,0,0,0,1000,0,0,0,1000,0,1000,1000
050875,訊芯永豐95購01  ,0,0,0,0,0,0,0,0,0,1000,0,0,0,1000,0,1000,1000
050881,大立光元富95購04,0,0,0,0,0,0,0,0,0,1000,0,0,0,1000,0,1000,1000
049794,台達電元大94購10,0,0,0,0,0,0,0,0,0,1000,0,0,0,1000,0,1000,1000
049796,國巨元大94購10  ,0,0,0,0,0,0,0,0,0,1000,0,0,0,1000,0,1000,1000
049941,臺股指元大94購24,0,0,0,0,0,0,0,0,0,1000,0,0,0,1000,0,1000,1000
049951,全新群益94購03  ,0,0,0,0,0,0,0,0,0,1000,0,0,0,1000,0,1000,1000
054784,順德群益9A購01  ,0,0,0,0,0,0,0,0,0,1000,0,0,0,7000,6000,1000,1000
055101,台肥凱基97購01  ,0,0,0,0,0,0,0,0,0,1000,0,0,0,1000,0,1000,1000
05528P,臺股指群益96售01,0,0,0,0,0,0,0,0,0,1000,0,0,0,1000,0,1000,1000
055295,瀚宇博元大97購02,0,0,0,0,0,0,0,0,0,1000,0,0,0,1000,0,1000,1000
055304,瑞昱第一98購01  ,0,0,0,0,0,0,0,0,0,1000,0,0,0,1000,0,1000,1000
054569,GIS群益98購01   ,0,0,0,0,0,0,0,0,0,1000,0,0,0,23000,22000,1000,1000
054296,世芯元大97購01  ,0,0,0,0,0,0,0,0,0,1000,0,0,0,12000,11000,1000,1000
054290,奇力新元大96購05,0,0,0,0,0,0,0,0,0,1000,0,0,0,3000,2000,1000,1000
054210,台光電國票97購03,0,0,0,0,0,0,0,0,0,1000,0,0,0,11000,10000,1000,1000
054062,TPK國票96購02   ,0,0,0,0,0,0,0,0,0,1000,0,0,0,109000,108000,1000,1000
054054,光磊國票97購02  ,0,0,0,0,0,0,0,0,0,1000,0,0,0,1000,0,1000,1000
052758,友達群益99購01  ,0,0,0,0,0,0,0,0,0,1000,0,0,0,1000,0,1000,1000
052808,矽力元大96購02  ,0,0,0,0,0,0,0,0,0,1000,0,0,0,1000,0,1000,1000
052230,大立光凱基96購09,0,0,0,0,0,0,0,0,0,1000,0,0,0,4000,3000,1000,1000
053256,上銀富邦98購01  ,0,0,0,0,0,0,0,0,0,1000,0,0,0,17000,16000,1000,1000
053288,臺股指元大96購16,0,0,0,0,0,0,0,0,0,1000,0,0,0,1000,0,1000,1000
05327P,臺股指凱基95售11,0,0,0,0,0,0,0,0,0,1000,0,0,0,1000,0,1000,1000
053205,台光電麥證96購01,0,0,0,63000,68000,-5000,0,0,0,1000,0,0,0,69000,68000,1000,1000
053064,國巨群益96購04  ,0,0,0,0,0,0,0,0,0,1000,0,0,0,1000,0,1000,1000
052321,華擎元大95購01  ,0,0,0,0,0,0,0,0,0,1000,0,0,0,1000,0,1000,1000
05228P,大立光元富95售09,0,0,0,0,0,0,0,0,0,1000,0,0,0,1000,0,1000,1000
052984,漢唐元大96購01  ,0,0,0,0,0,0,0,0,0,1000,0,0,0,16000,15000,1000,1000
05346P,臺股指統一95售06,0,0,0,0,0,0,0,0,0,1000,0,0,0,1000,0,1000,1000
053374,台達電元大96購03,0,0,0,0,0,0,0,0,0,1000,0,0,0,1000,0,1000,1000
053999,台表科群益96購06,0,0,0,0,0,0,0,0,0,1000,0,0,0,1000,0,1000,1000
053774,台達電元大96購04,0,0,0,0,0,0,0,0,0,1000,0,0,0,1000,0,1000,1000
053838,正文永豐96購02  ,0,0,0,0,0,0,0,0,0,1000,0,0,0,1000,0,1000,1000
05382P,電子類群益95售02,0,0,0,0,0,0,0,0,0,1000,0,0,0,13000,12000,1000,1000
8497,格威傳媒        ,1000,0,1000,0,0,0,0,0,0,0,0,0,0,0,0,0,1000
9902,台火            ,3000,2000,1000,0,0,0,0,0,0,0,0,0,0,0,0,0,1000
9944,新麗            ,0,1000,-1000,0,0,0,0,0,0,2000,2000,0,2000,0,0,0,1000
2022,聚亨            ,7000,6000,1000,0,0,0,0,0,0,0,0,0,0,0,0,0,1000
2002A,中鋼特          ,0,0,0,0,0,0,0,0,0,1000,1000,0,1000,0,0,0,1000
2009,第一銅          ,1000,0,1000,0,0,0,0,0,0,0,1000,1000,0,0,0,0,1000
1540,喬福            ,3000,2000,1000,0,0,0,0,0,0,0,0,0,0,0,0,0,1000
1517,利奇            ,2000,1000,1000,0,0,0,0,0,0,0,0,0,0,0,0,0,1000
1338,廣華-KY         ,3000,3000,0,0,0,0,0,0,0,1000,1000,0,1000,0,0,0,1000
1225,福懋油          ,2000,1000,1000,0,0,0,0,0,0,0,0,0,0,0,0,0,1000
07480P,FBVIX凱基94售01 ,0,0,0,0,0,0,0,0,0,1000,0,0,0,1000,0,1000,1000
06610P,台積電凱基9A售03,0,0,0,0,0,0,0,0,0,1000,0,0,0,1000,0,1000,1000
06284P,台積電國票98售03,0,0,0,0,0,0,0,0,0,1000,0,0,0,1000,0,1000,1000
06312P,樺漢元富97售02  ,0,0,0,0,0,0,0,0,0,1000,0,0,0,20000,19000,1000,1000
06363P,臺股指麥證97售02,0,0,0,1000,0,1000,0,0,0,1000,0,0,0,1000,0,1000,1000
06408P,聯茂元富97售02  ,0,0,0,0,0,0,0,0,0,1000,0,0,0,1000,0,1000,1000
4108,懷特            ,4000,5000,-1000,0,0,0,0,0,0,2000,2000,0,2000,0,0,0,1000
4555,氣立            ,1000,0,1000,0,0,0,0,0,0,0,0,0,0,0,0,0,1000
4562,穎漢            ,1000,0,1000,0,0,0,0,0,0,0,0,0,0,0,0,0,1000
3296,勝德            ,2000,0,2000,0,0,0,0,0,0,-1000,3000,4000,-1000,0,0,0,1000
6201,亞弘電          ,2000,1000,1000,0,0,0,0,0,0,0,0,0,0,0,0,0,1000
6541,泰福-KY         ,23000,22000,1000,0,0,0,0,0,0,0,0,0,0,0,0,0,1000
6491,晶碩            ,3000,2000,1000,0,0,0,0,0,0,0,0,0,0,0,0,0,1000
5284,jpp-KY          ,1000,0,1000,0,0,0,0,0,0,0,0,0,0,0,0,0,1000
6164,華興            ,1000,0,1000,0,0,0,0,0,0,0,0,0,0,0,0,0,1000
2509,全坤建          ,0,0,0,0,0,0,0,0,0,1000,2000,1000,1000,0,0,0,1000
2891C,中信金丙特      ,0,0,0,0,0,0,0,0,0,1000,1000,0,1000,0,0,0,1000
2911,麗嬰房          ,8000,7000,1000,0,0,0,0,0,0,0,0,0,0,0,0,0,1000
2901,欣欣            ,1000,0,1000,0,0,0,0,0,0,0,0,0,0,0,0,0,1000
2936,客思達-KY       ,2000,1000,1000,0,0,0,0,0,0,0,0,0,0,0,0,0,1000
3002,歐格            ,2000,1000,1000,0,0,0,0,0,0,0,0,0,0,0,0,0,1000
00636K,國泰中國A50+U   ,0,0,0,0,0,0,0,0,0,100,0,0,0,200,100,100,100
05931P,鴻海凱基96售15  ,0,0,0,0,0,0,0,0,0,0,0,0,0,50000,50000,0,0
05936P,台積電凱基96售20,0,0,0,0,0,0,0,0,0,0,0,0,0,27000,27000,0,0
05953P,台積電國票98售02,0,0,0,0,0,0,0,0,0,0,0,0,0,67000,67000,0,0
05865P,大立光元大96售09,0,0,0,0,0,0,0,0,0,0,0,0,0,9000,9000,0,0
05845P,大立光元大96售06,0,0,0,0,0,0,0,0,0,0,0,0,0,5000,5000,0,0
05846P,大立光元大96售07,0,0,0,0,0,0,0,0,0,0,0,0,0,5000,5000,0,0
05847P,大立光元大96售08,0,0,0,0,0,0,0,0,0,0,0,0,0,109000,109000,0,0
05892P,大立光中信98售03,0,0,0,0,0,0,0,0,0,0,0,0,0,2000,2000,0,0
05872P,大立光凱基96售15,0,0,0,0,0,0,0,0,0,0,0,0,0,13000,13000,0,0
06148P,台積電元大97售17,0,0,0,0,0,0,0,0,0,0,0,0,0,159000,159000,0,0
06160P,台達電群益97售01,0,0,0,0,0,0,0,0,0,0,0,0,0,11000,11000,0,0
057487,聯發科元大98購10,0,0,0,0,0,0,0,0,0,0,0,0,0,72000,72000,0,0
057489,奇力新元大99購06,0,0,0,0,0,0,0,0,0,0,0,0,0,39000,39000,0,0
057493,聯詠元大98購02  ,0,0,0,0,0,0,0,0,0,0,0,0,0,1000,1000,0,0
057496,佐登元大98購02  ,0,0,0,0,0,0,0,0,0,0,0,0,0,64000,64000,0,0
057497,祥碩元大98購06  ,0,0,0,0,0,0,0,0,0,0,0,0,0,6000,6000,0,0
05771P,大立光凱基96售13,0,0,0,0,0,0,0,0,0,0,0,0,0,16000,16000,0,0
05788P,臺股指永昌96售05,0,0,0,0,0,0,0,0,0,0,50000,0,50000,60000,110000,-50000,0
05810P,臺股指國票96售03,0,0,0,0,0,0,0,0,0,0,0,0,0,160000,160000,0,0
057375,欣興元大98購09  ,0,0,0,0,0,0,0,0,0,0,0,0,0,58000,58000,0,0
057365,智邦元大98購07  ,0,0,0,0,0,0,0,0,0,0,0,0,0,13000,13000,0,0
057366,智邦元大98購08  ,0,0,0,0,0,0,0,0,0,0,0,0,0,19000,19000,0,0
057382,聯發科國泰9A購01,0,0,0,0,0,0,0,0,0,0,0,0,0,25000,25000,0,0
057410,南電群益98購01  ,0,0,0,0,0,0,0,0,0,0,0,0,0,5000,5000,0,0
057422,欣興凱基98購04  ,0,0,0,0,0,0,0,0,0,0,0,0,0,7000,7000,0,0
057405,麗豐群益98購01  ,0,0,0,0,0,0,0,0,0,0,0,0,0,11000,11000,0,0
057406,茂林群益98購03  ,0,0,0,0,0,0,0,0,0,0,0,0,0,71000,71000,0,0
057418,台光電凱基98購04,0,0,0,0,0,0,0,0,0,0,0,0,0,16000,16000,0,0
057477,智邦元大98購09  ,0,0,0,0,0,0,0,0,0,0,0,0,0,15000,15000,0,0
057454,上銀國泰99購02  ,0,0,0,0,0,0,0,0,0,0,0,0,0,31000,31000,0,0
057467,祥碩永豐98購04  ,0,0,0,0,0,0,0,0,0,0,0,0,0,4000,4000,0,0
057468,台郡永豐98購01  ,0,0,0,0,0,0,0,0,0,0,0,0,0,7000,7000,0,0
057184,群創元大98購05  ,0,0,0,0,0,0,0,0,0,0,0,0,0,7000,7000,0,0
057187,群創元大9B購04  ,0,0,0,0,0,0,0,0,0,0,0,0,0,3000,3000,0,0
05719P,可成元大96售03  ,0,0,0,0,0,0,0,0,0,0,0,0,0,58000,58000,0,0
057219,群創群益98購10  ,0,0,0,0,0,0,0,0,0,0,0,0,0,25000,25000,0,0
057259,台積電兆豐98購03,0,0,0,0,0,0,0,0,0,0,0,0,0,130000,130000,0,0
057242,台郡凱基98購05  ,0,0,0,0,0,0,0,0,0,0,0,0,0,6000,6000,0,0
057236,聯詠凱基98購03  ,0,0,0,0,0,0,0,0,0,0,0,0,0,1000,1000,0,0
057239,貿聯凱基98購05  ,10000,0,10000,0,0,0,0,0,0,-10000,0,0,0,0,10000,-10000,0
057318,台光電凱基9A購01,0,0,0,0,0,0,0,0,0,0,0,0,0,27000,27000,0,0
057272,台積電元大98購14,0,0,0,0,0,0,0,0,0,0,0,0,0,5000,5000,0,0
057285,群創元大98購07  ,0,0,0,0,0,0,0,0,0,0,0,0,0,18000,18000,0,0
057296,智原永豐98購01  ,0,0,0,0,0,0,0,0,0,0,0,0,0,4000,4000,0,0
056667,上銀國票99購01  ,0,0,0,0,0,0,0,0,0,0,0,0,0,5000,5000,0,0
05666P,聯發科凱基96售14,0,0,0,0,0,0,0,0,0,0,0,0,0,3000,3000,0,0
056649,智易凱基98購01  ,0,0,0,0,0,0,0,0,0,0,0,0,0,6000,6000,0,0
056765,友達元大9B購05  ,0,0,0,0,0,0,0,0,0,0,0,0,0,112000,112000,0,0
056692,燿華群益98購03  ,0,0,0,0,0,0,0,0,0,0,0,0,0,22000,22000,0,0
056711,亞光永豐98購01  ,0,0,0,0,0,0,0,0,0,0,0,0,0,33000,33000,0,0
056843,冠德元富98購01  ,0,0,0,0,0,0,0,0,0,0,0,0,0,10000,10000,0,0
05685P,臺股指元大96售10,0,0,0,0,0,0,0,0,0,0,0,0,0,230000,230000,0,0
057128,台光電凱基98購03,0,0,0,0,0,0,0,0,0,0,0,0,0,38000,38000,0,0
057129,聯發科凱基99購03,0,0,0,0,0,0,0,0,0,0,0,0,0,16000,16000,0,0
052217,台光電日盛95購01,0,0,0,0,0,0,0,0,0,0,0,0,0,20000,20000,0,0
057158,義隆永豐99購01  ,0,0,0,0,0,0,0,0,0,0,0,0,0,10000,10000,0,0
057047,華新科元大99購07,0,0,0,0,0,0,0,0,0,0,0,0,0,15000,15000,0,0
057044,旺宏元大98購08  ,0,0,0,0,0,0,0,0,0,0,0,0,0,5000,5000,0,0
057050,群創元大99購03  ,0,0,0,0,0,0,0,0,0,0,0,0,0,3000,3000,0,0
05709P,大立光國票97售01,0,0,0,0,0,0,0,0,0,0,0,0,0,2000,2000,0,0
056980,建準群益98購02  ,0,0,0,0,0,0,0,0,0,0,0,0,0,5000,5000,0,0
056990,聯發科兆豐98購01,0,0,0,0,0,0,0,0,0,0,0,0,0,2000,2000,0,0
057027,祥碩凱基98購01  ,0,0,0,0,0,0,0,0,0,0,0,0,0,4000,4000,0,0
057028,台郡凱基99購02  ,0,0,0,0,0,0,0,0,0,0,0,0,0,7000,7000,0,0
056954,聯詠富邦9A購01  ,0,0,0,0,0,0,0,0,0,0,0,0,0,3000,3000,0,0
056927,T50反1台新02購01,0,0,0,0,0,0,0,0,0,0,0,0,0,10000,10000,0,0
056897,南亞科元大98購02,0,0,0,0,0,0,0,0,0,0,0,0,0,72000,72000,0,0
056872,旺宏凱基98購08  ,0,0,0,0,0,0,0,0,0,0,0,0,0,5000,5000,0,0
056892,旺宏元大9A購02  ,0,0,0,0,0,0,0,0,0,0,0,0,0,5000,5000,0,0
055790,南電凱基97購01  ,0,0,0,0,0,0,0,0,0,0,0,0,0,40000,40000,0,0
05592P,可成群益96售03  ,0,0,0,0,0,0,0,0,0,0,0,0,0,60000,60000,0,0
055917,禾伸堂凱基98購02,0,0,0,0,0,0,0,0,0,0,0,0,0,10000,10000,0,0
055642,廣宇元富97購01  ,0,0,0,0,0,0,0,0,0,0,0,0,0,20000,20000,0,0
055658,南電元富97購01  ,0,0,0,0,0,0,0,0,0,0,0,0,0,10000,10000,0,0
055687,瀚宇博凱基97購01,0,0,0,0,0,0,0,0,0,0,0,0,0,22000,22000,0,0
055358,臻鼎凱基97購01  ,0,0,0,0,0,0,0,0,0,0,0,0,0,20000,20000,0,0
055359,超眾凱基97購01  ,0,0,0,0,0,0,0,0,0,0,0,0,0,18000,18000,0,0
05535P,台積電元大97售06,0,0,0,0,0,0,0,0,0,0,0,0,0,199000,199000,0,0
055346,國巨凱基98購02  ,0,0,0,0,0,0,0,0,0,0,0,0,0,40000,40000,0,0
055347,台積電凱基97購10,0,0,0,0,0,0,0,0,0,0,0,0,0,68000,68000,0,0
055373,聯詠元大97購03  ,0,0,0,0,0,0,0,0,0,0,0,0,0,24000,24000,0,0
055383,GIS元大97購02   ,0,0,0,0,0,0,0,0,0,0,0,0,0,2000,2000,0,0
055602,康控元大97購03  ,0,0,0,0,0,0,0,0,0,0,0,0,0,181000,181000,0,0
055609,旺宏國票99購01  ,0,0,0,0,0,0,0,0,0,0,0,0,0,3000,3000,0,0
055585,國巨元大98購08  ,0,0,0,0,0,0,0,0,0,0,0,0,0,14000,14000,0,0
055574,美律統一97購01  ,0,0,0,0,0,0,0,0,0,0,0,0,0,48000,48000,0,0
055548,旺宏凱基97購02  ,0,0,0,0,0,0,0,0,0,0,0,0,0,5000,5000,0,0
055549,旺宏凱基97購03  ,0,0,0,0,0,0,0,0,0,0,0,0,0,5000,5000,0,0
055536,嘉聯益群益99購02,0,0,0,0,0,0,0,0,0,0,0,0,0,20000,20000,0,0
055479,GIS凱基97購04   ,0,0,0,0,0,0,0,0,0,0,0,0,0,54000,54000,0,0
055476,台郡凱基97購02  ,0,0,0,0,0,0,0,0,0,0,0,0,0,18000,18000,0,0
055508,矽力元大97購01  ,0,0,0,0,0,0,0,0,0,0,0,0,0,8000,8000,0,0
056303,亞光元大97購04  ,0,0,0,0,0,0,0,0,0,0,0,0,0,81000,81000,0,0
056285,可成永豐97購02  ,0,0,0,0,0,0,0,0,0,0,0,0,0,68000,68000,0,0
056365,欣興元大98購01  ,0,0,0,0,0,0,0,0,0,0,0,0,0,83000,83000,0,0
056338,聯發科凱基99購01,0,0,0,0,0,0,0,0,0,0,0,0,0,18000,18000,0,0
056355,台積電元大98購08,0,0,0,0,0,0,0,0,0,0,0,0,0,10000,10000,0,0
056477,欣興元大98購02  ,0,0,0,0,0,0,0,0,0,0,0,0,0,44000,44000,0,0
056540,聯詠凱基98購02  ,0,0,0,0,0,0,0,0,0,0,0,0,0,15000,15000,0,0
056530,旺宏凱基98購06  ,0,0,0,0,0,0,0,0,0,0,0,0,0,1000,1000,0,0
05642P,玉晶光兆豐97售02,0,0,0,0,0,0,0,0,0,0,0,0,0,40000,40000,0,0
056445,聯發科凱基98購07,0,0,0,0,0,0,0,0,0,0,0,0,0,20000,20000,0,0
056454,欣興凱基98購02  ,0,0,0,0,0,0,0,0,0,0,0,0,0,5000,5000,0,0
056225,聯發科凱基97購09,0,0,0,0,0,0,0,0,0,0,0,0,0,16000,16000,0,0
056227,奇力新凱基98購04,0,0,0,0,0,0,0,0,0,0,0,0,0,51000,51000,0,0
056144,GIS元大98購01   ,0,0,0,0,0,0,0,0,0,0,0,0,0,2000,2000,0,0
056152,可成凱基97購02  ,0,0,0,0,0,0,0,0,0,0,0,0,0,20000,20000,0,0
056163,嘉聯益凱基98購03,0,0,0,0,0,0,0,0,0,0,0,0,0,20000,20000,0,0
056119,欣興群益97購02  ,0,0,0,0,0,0,0,0,0,0,0,0,0,2000,2000,0,0
05597P,鴻海元富96售06  ,0,0,0,0,0,0,0,0,0,0,0,0,0,10000,10000,0,0
055972,GIS元大97購04   ,0,0,0,0,0,0,0,0,0,0,0,0,0,2000,2000,0,0
055963,欣興元大97購04  ,0,0,0,0,0,0,0,0,0,0,0,0,0,17000,17000,0,0
05594P,旺宏國票96售04  ,0,0,0,0,0,0,0,0,0,0,0,0,0,20000,20000,0,0
055952,上銀元大97購08  ,0,0,0,0,0,0,0,0,0,0,0,0,0,76000,76000,0,0
055954,南港元大97購02  ,0,0,0,0,0,0,0,0,0,0,0,0,0,11000,11000,0,0
056034,華通凱基98購01  ,0,0,0,0,0,0,0,0,0,0,0,0,0,1000,1000,0,0
056035,鴻海凱基97購06  ,0,0,0,0,0,0,0,0,0,0,0,0,0,3000,3000,0,0
0051,元大中型100     ,1000,1000,0,0,0,0,0,0,0,0,0,0,0,1000,1000,0,0
00625K,富邦上証+R      ,0,0,0,0,0,0,0,0,0,0,0,0,0,50000,50000,0,0
00657,國泰日經225     ,0,0,0,0,0,0,0,0,0,0,0,0,0,100000,100000,0,0
00657K,國泰日經225+U   ,0,0,0,0,0,0,0,0,0,0,0,0,0,100,100,0,0
00767,FH美國金融股    ,0,0,0,0,0,0,0,0,0,0,0,0,0,1000,1000,0,0
00668K,國泰美國道瓊+U  ,0,0,0,0,0,0,0,0,0,0,0,0,0,100,100,0,0
00774B,新光中國政金綠債,0,0,0,0,0,0,0,0,0,0,0,0,0,2000,2000,0,0
00775B,新光投等債15+   ,0,0,0,0,0,0,0,0,0,0,0,0,0,2000,2000,0,0
00776,新光ICE美國權值 ,0,0,0,0,0,0,0,0,0,0,0,0,0,1000,1000,0,0
00732,國泰RMB短期報酬 ,0,0,0,0,0,0,0,0,0,0,0,0,0,100000,100000,0,0
00707R,元大S&P日圓反1  ,0,0,0,0,0,0,0,0,0,0,0,0,0,1000,1000,0,0
00702,國泰標普低波高息,0,0,0,0,0,0,0,0,0,0,0,0,0,2000,2000,0,0
00711B,FH彭博新興債    ,0,0,0,0,0,0,0,0,0,0,0,0,0,102000,102000,0,0
042556,台灣50中信96購04,0,0,0,0,0,0,0,0,0,0,0,0,0,11000,11000,0,0
042089,台灣50中信94購03,0,0,0,0,0,0,0,0,0,0,0,0,0,32000,32000,0,0
04117P,聯發科元大93售21,0,0,0,0,0,0,0,0,0,0,0,0,0,60000,60000,0,0
03878P,康控國票93售01  ,0,0,0,0,0,0,0,0,0,0,0,0,0,60000,60000,0,0
03922P,中磊凱基93售01  ,0,0,0,0,0,0,0,0,0,0,0,0,0,1000,1000,0,0
04028P,燿華凱基94售02  ,0,0,0,0,0,0,0,0,0,0,0,0,0,50000,50000,0,0
03643C,臺股指元富99牛04,0,0,0,0,0,0,0,0,0,0,0,0,0,80000,80000,0,0
035277,景碩台新97購01  ,0,0,0,0,0,0,0,0,0,0,0,0,0,7000,7000,0,0
046299,大立光富邦93購04,0,0,0,0,0,0,0,0,0,0,0,0,0,10000,10000,0,0
046287,禾伸堂兆豐92購01,0,0,0,0,0,0,0,0,0,0,0,0,0,10000,10000,0,0
04628P,欣興元大95售01  ,0,0,0,0,0,0,0,0,0,0,0,0,0,5000,5000,0,0
046184,台光電凱基93購08,0,0,0,0,0,0,0,0,0,0,0,0,0,9000,9000,0,0
04616P,臺股指群益95售02,0,0,0,0,0,0,0,0,0,0,0,0,0,88000,88000,0,0
04329P,TPK群益93售04   ,0,0,0,0,0,0,0,0,0,0,0,0,0,10000,10000,0,0
04339P,欣興元大93售08  ,0,0,0,0,0,0,0,0,0,0,0,0,0,5000,5000,0,0
045679,欣興元大94購01  ,0,0,0,0,0,0,0,0,0,0,0,0,0,1000,1000,0,0
04559P,華通凱基94售03  ,0,0,0,0,0,0,0,0,0,0,0,0,0,20000,20000,0,0
04379P,大立光元大94售06,0,0,0,0,0,0,0,0,0,0,0,0,0,5000,5000,0,0
043757,欣興元大93購01  ,0,0,0,0,0,0,0,0,0,0,0,0,0,2000,2000,0,0
04377P,大立光元大94售04,0,0,0,0,0,0,0,0,0,0,0,0,0,5000,5000,0,0
044016,義隆凱基93購01  ,0,0,0,0,0,0,0,0,0,0,0,0,0,1000,1000,0,0
04428P,台光電元大94售02,0,0,0,0,0,0,0,0,0,0,0,0,0,37000,37000,0,0
044282,上銀凱基93購03  ,0,0,0,0,0,0,0,0,0,0,0,0,0,10000,10000,0,0
04359P,中磊永豐94售01  ,0,0,0,0,0,0,0,0,0,0,0,0,0,1000,1000,0,0
045907,鴻海中信94購02  ,0,0,0,0,0,0,0,0,0,0,0,0,0,10000,10000,0,0
045782,欣興元大93購04  ,0,0,0,0,0,0,0,0,0,0,0,0,0,2000,2000,0,0
045803,旺宏國票93購01  ,0,0,0,0,0,0,0,0,0,0,0,0,0,50000,50000,0,0
044966,台表科中信94購01,0,0,0,0,0,0,0,0,0,0,0,0,0,30000,30000,0,0
045015,玉晶光元大94購01,0,0,0,0,0,0,0,0,0,0,0,0,0,24000,24000,0,0
044758,玉山金凱基93購01,0,0,0,0,0,0,0,0,0,0,0,0,0,10000,10000,0,0
044705,群創元大93購03  ,0,0,0,0,0,0,0,0,0,0,0,0,0,3000,3000,0,0
044680,華新科凱基93購06,0,0,0,0,0,0,0,0,0,0,0,0,0,5000,5000,0,0
044961,聯電中信94購01  ,0,0,0,0,0,0,0,0,0,0,0,0,0,30000,30000,0,0
04477P,南電元大94售04  ,0,0,0,0,0,0,0,0,0,0,0,0,0,30000,30000,0,0
04478P,元油2X中信95售03,0,0,0,0,0,0,0,0,0,0,0,0,0,49000,49000,0,0
044852,華邦電國泰93購02,0,0,0,0,0,0,0,0,0,0,0,0,0,100000,100000,0,0
045220,漢唐元大94購01  ,0,0,0,0,0,0,0,0,0,0,0,0,0,10000,10000,0,0
045173,A50正2國票95購01,0,0,0,0,0,0,0,0,0,0,0,0,0,10000,10000,0,0
04506P,旺宏元大94售06  ,0,0,0,0,0,0,0,0,0,0,0,0,0,37000,37000,0,0
04548P,大立光元大94售14,0,0,0,0,0,0,0,0,0,0,0,0,0,5000,5000,0,0
047804,鴻海凱基93購26  ,0,0,0,0,0,0,0,0,0,0,0,0,0,450000,450000,0,0
04778P,可成凱基94售10  ,0,0,0,0,0,0,0,0,0,0,0,0,0,28000,28000,0,0
047780,友達中信96購01  ,0,0,0,0,0,0,0,0,0,0,0,0,0,20000,20000,0,0
046487,鴻海永昌92購01  ,0,0,0,0,0,0,0,0,0,0,0,0,0,10000,10000,0,0
046538,大立光群益93購06,0,0,0,0,0,0,0,0,0,0,0,0,0,10000,10000,0,0
048550,中鴻元大96購01  ,0,0,0,0,0,0,0,0,0,0,0,0,0,10000,10000,0,0
046450,鴻海凱基93購12  ,0,0,0,0,0,0,0,0,0,0,0,0,0,3000,3000,0,0
046387,臻鼎凱基92購04  ,0,0,0,0,0,0,0,0,0,0,0,0,0,20000,20000,0,0
046362,華通永豐92購02  ,0,0,0,0,0,0,0,0,0,0,0,0,0,10000,10000,0,0
047954,漢唐永豐93購02  ,0,0,0,0,0,0,0,0,0,0,0,0,0,45000,45000,0,0
048293,聯詠群益93購04  ,0,0,0,0,0,0,0,0,0,0,0,0,0,10000,10000,0,0
04684P,欣興元大94售07  ,0,0,0,0,0,0,0,0,0,0,0,0,0,5000,5000,0,0
046756,廣達凱基93購01  ,0,0,0,0,0,0,0,0,0,0,0,0,0,50000,50000,0,0
046757,漢唐凱基93購02  ,0,0,0,0,0,0,0,0,0,0,0,0,0,10000,10000,0,0
046790,康友永豐93購01  ,0,0,0,0,0,0,0,0,0,0,0,0,0,10000,10000,0,0
048203,矽力元大93購02  ,0,0,0,0,0,0,0,0,0,0,0,0,0,2000,2000,0,0
048200,欣興元大93購07  ,0,0,0,0,0,0,0,0,0,0,0,0,0,1000,1000,0,0
048072,GIS元富93購05   ,0,0,0,0,0,0,0,0,0,0,0,0,0,6000,6000,0,0
046597,可成亞東93購01  ,0,0,0,0,0,0,0,0,0,0,0,0,0,10000,10000,0,0
048093,聯發科凱基93購30,0,0,0,0,0,0,0,0,0,0,0,0,0,68000,68000,0,0
048162,矽力麥證93購01  ,0,0,0,21000,21000,0,0,0,0,0,0,0,0,21000,21000,0,0
048193,旺宏元大94購05  ,0,0,0,0,0,0,0,0,0,0,0,0,0,6000,6000,0,0
048144,華固統一93購01  ,0,0,0,0,0,0,0,0,0,0,0,0,0,10000,10000,0,0
046693,台積電凱基93購03,0,0,0,0,0,0,0,0,0,0,0,0,0,5000,5000,0,0
048441,台積電凱基93購29,0,0,0,0,0,0,0,0,0,0,0,0,0,10000,10000,0,0
048544,欣興永豐94購01  ,0,0,0,0,0,0,0,0,0,0,0,0,0,2000,2000,0,0
048536,南電國票93購04  ,0,0,0,0,0,0,0,0,0,0,0,0,0,15000,15000,0,0
04693P,超眾群益95售01  ,0,0,0,0,0,0,0,0,0,0,0,0,0,20000,20000,0,0
047670,矽力永豐93購01  ,0,0,0,0,0,0,0,0,0,0,0,0,0,10000,10000,0,0
047647,麗豐元大93購03  ,0,0,0,0,0,0,0,0,0,0,0,0,0,35000,35000,0,0
047601,上海銀中信93購01,0,0,0,0,0,0,0,0,0,0,0,0,0,10000,10000,0,0
047725,廣達群益93購01  ,0,0,0,0,0,0,0,0,0,0,0,0,0,20000,20000,0,0
047708,聯發科凱基93購17,0,0,0,0,0,0,0,0,0,0,0,0,0,1000,1000,0,0
047695,聯發科國票93購06,0,0,0,0,0,0,0,0,0,0,0,0,0,10000,10000,0,0
047678,景碩台新93購01  ,0,0,0,0,0,0,0,0,0,0,0,0,0,10000,10000,0,0
047555,欣興凱基93購01  ,0,0,0,0,0,0,0,0,0,0,0,0,0,1000,1000,0,0
047458,聯發科群益93購08,0,0,0,0,0,0,0,0,0,0,0,0,0,20000,20000,0,0
047478,旺宏凱基93購04  ,0,0,0,0,0,0,0,0,0,0,0,0,0,11000,11000,0,0
047436,台積電元大94購02,0,0,0,0,0,0,0,0,0,0,0,0,0,41000,41000,0,0
047347,台積電凱基93購14,0,0,0,0,0,0,0,0,0,0,0,0,0,10000,10000,0,0
048430,瑞昱國票93購02  ,0,0,0,0,0,0,0,0,0,0,0,0,0,1000,1000,0,0
047369,漢唐國票94購01  ,0,0,0,0,0,0,0,0,0,0,0,0,0,10000,10000,0,0
050366,鴻海元大94購19  ,0,0,0,0,0,0,0,0,0,0,0,0,0,12000,12000,0,0
050367,鴻海元大94購20  ,0,0,0,0,0,0,0,0,0,0,0,0,0,153000,153000,0,0
050341,光寶科元富94購01,0,0,0,0,0,0,0,0,0,0,0,0,0,8000,8000,0,0
049233,聯發科統一94購04,0,0,0,0,0,0,0,0,0,0,0,0,0,37000,37000,0,0
048700,和鑫國票95購01  ,0,0,0,0,0,0,0,0,0,0,0,0,0,20000,20000,0,0
051894,嘉聯益元富95購03,0,0,0,0,0,0,0,0,0,0,0,0,0,10000,10000,0,0
051905,道瓊銀元大95購01,0,0,0,0,0,0,0,0,0,0,0,0,0,5000,5000,0,0
051481,聯詠凱基95購02  ,0,0,0,0,0,0,0,0,0,0,0,0,0,100000,100000,0,0
05146P,鴻海元大95售10  ,0,0,0,0,0,0,0,0,0,0,0,0,0,235000,235000,0,0
05147P,鴻海元大95售11  ,0,0,0,0,0,0,0,0,0,0,0,0,0,39000,39000,0,0
051448,聯詠元大95購02  ,0,0,0,0,0,0,0,0,0,0,0,0,0,10000,10000,0,0
051444,聯發科元大95購11,0,0,0,0,0,0,0,0,0,0,0,0,0,68000,68000,0,0
047133,旺宏凱基93購03  ,0,0,0,0,0,0,0,0,0,0,0,0,0,10000,10000,0,0
048637,鴻海元大96購01  ,0,0,0,0,0,0,0,0,0,0,0,0,0,1000,1000,0,0
048614,欣興凱基93購05  ,0,0,0,0,0,0,0,0,0,0,0,0,0,1000,1000,0,0
048635,鴻海元大94購04  ,0,0,0,0,0,0,0,0,0,0,0,0,0,18000,18000,0,0
048767,欣興凱基94購01  ,0,0,0,0,0,0,0,0,0,0,0,0,0,1000,1000,0,0
048636,鴻海元大94購05  ,0,0,0,0,0,0,0,0,0,0,0,0,0,13000,13000,0,0
048822,燿華凱基94購03  ,0,0,0,0,0,0,0,0,0,0,0,0,0,25000,25000,0,0
048784,台積電元大94購04,0,0,0,0,0,0,0,0,0,0,0,0,0,252000,252000,0,0
047217,臺股指中信93購05,0,0,0,0,0,0,0,0,0,0,0,0,0,3000,3000,0,0
047239,瀚宇博凱基94購01,0,0,0,0,0,0,0,0,0,0,0,0,0,4000,4000,0,0
047227,華新科凱基94購01,0,0,0,0,0,0,0,0,0,0,0,0,0,15000,15000,0,0
047250,日月光群益94購01,0,0,0,0,0,0,0,0,0,0,0,0,0,40000,40000,0,0
046980,智邦兆豐94購01  ,0,0,0,0,0,0,0,0,0,0,0,0,0,45000,45000,0,0
046987,智邦凱基93購04  ,0,0,0,0,0,0,0,0,0,0,0,0,0,10000,10000,0,0
046944,奇力新元大96購01,0,0,0,0,0,0,0,0,0,0,0,0,0,24000,24000,0,0
046949,群創元大99購01  ,0,1000,-1000,0,0,0,0,0,0,1000,0,0,0,261000,260000,1000,0
048558,漢唐元大93購06  ,0,0,0,0,0,0,0,0,0,0,0,0,0,2000,2000,0,0
048577,GIS國泰94購01   ,0,0,0,0,0,0,0,0,0,0,0,0,0,3000,3000,0,0
048562,宏達電元大95購01,0,0,0,0,0,0,0,0,0,0,0,0,0,2000,2000,0,0
048566,上海銀元大93購04,0,0,0,0,0,0,0,0,0,0,0,0,0,3000,3000,0,0
048610,華新科凱基94購04,0,0,0,0,0,0,0,0,0,0,0,0,0,5000,5000,0,0
048593,華新科群益93購04,0,0,0,0,0,0,0,0,0,0,0,0,0,20000,20000,0,0
04995P,台達電凱基96售03,0,0,0,0,0,0,0,0,0,0,0,0,0,25000,25000,0,0
049797,台積電元大94購17,0,0,0,0,0,0,0,0,0,0,0,0,0,94000,94000,0,0
04976P,中磊凱基94售01  ,0,0,0,0,0,0,0,0,0,0,0,0,0,1000,1000,0,0
051013,旺宏凱基95購03  ,0,0,0,0,0,0,0,0,0,0,0,0,0,6000,6000,0,0
050984,大立光國泰97購01,0,0,0,0,0,0,0,0,0,0,0,0,0,1000,1000,0,0
05098P,鴻海凱基95售15  ,0,0,0,0,0,0,0,0,0,0,0,0,0,1000,1000,0,0
050009,昇陽半永豐94購02,0,0,0,0,0,0,0,0,0,0,0,0,0,20000,20000,0,0
050023,國巨元大94購12  ,0,0,0,0,0,0,0,0,0,0,0,0,0,10000,10000,0,0
050972,台虹永豐95購01  ,0,0,0,0,0,0,0,0,0,0,0,0,0,10000,10000,0,0
049025,華擎群益94購01  ,0,0,0,0,0,0,0,0,0,0,0,0,0,20000,20000,0,0
049022,聯詠群益94購01  ,0,0,0,0,0,0,0,0,0,0,0,0,0,21000,21000,0,0
048991,昇陽半元大94購01,0,0,0,0,0,0,0,0,0,0,0,0,0,7000,7000,0,0
049003,智邦中信95購01  ,0,0,0,0,0,0,0,0,0,0,0,0,0,48000,48000,0,0
049050,崇越康和94購01  ,0,0,0,0,0,0,0,0,0,0,0,0,0,20000,20000,0,0
048941,牧德永豐94購02  ,0,0,0,0,0,0,0,0,0,0,0,0,0,10000,10000,0,0
049691,可成元大94購06  ,0,0,0,0,0,0,0,0,0,0,0,0,0,77000,77000,0,0
050925,可成凱基95購02  ,0,0,0,0,0,0,0,0,0,0,0,0,0,68000,68000,0,0
05092P,全新元大95售03  ,0,0,0,0,0,0,0,0,0,0,0,0,0,65000,65000,0,0
049664,聯發科永豐94購03,0,0,0,0,0,0,0,0,0,0,0,0,0,68000,68000,0,0
049592,欣興元大96購01  ,0,0,0,0,0,0,0,0,0,0,0,0,0,2000,2000,0,0
049589,奇力新元大95購02,0,0,0,0,0,0,0,0,0,0,0,0,0,8000,8000,0,0
04959P,可成凱基94售14  ,0,0,0,0,0,0,0,0,0,0,0,0,0,96000,96000,0,0
050809,鴻海凱基95購08  ,0,0,0,0,0,0,0,0,0,0,0,0,0,2000,2000,0,0
050844,大立光國票96購01,10000,0,10000,0,0,0,0,0,0,-10000,0,0,0,0,10000,-10000,0
050831,超眾凱基95購01  ,0,0,0,0,0,0,0,0,0,0,0,0,0,11000,11000,0,0
051342,光寶科元大95購01,0,0,0,0,0,0,0,0,0,0,0,0,0,4000,4000,0,0
051386,富邦金麥證96購01,0,0,0,10000,10000,0,0,0,0,0,0,0,0,10000,10000,0,0
051422,超眾國票96購01  ,0,0,0,0,0,0,0,0,0,0,0,0,0,20000,20000,0,0
052188,欣興群益95購03  ,0,0,0,0,0,0,0,0,0,0,0,0,0,2000,2000,0,0
05239P,欣興永豐95售03  ,0,0,0,0,0,0,0,0,0,0,0,0,0,15000,15000,0,0
05241P,鴻海國泰97售04  ,0,0,0,0,0,0,0,0,0,0,0,0,0,10000,10000,0,0
05243P,鴻海元大95售19  ,0,0,0,0,0,0,0,0,0,0,0,0,0,214000,214000,0,0
05253P,智邦凱基95售08  ,0,0,0,0,0,0,0,0,0,0,0,0,0,100000,100000,0,0
052511,聯發科凱基95購14,0,0,0,0,0,0,0,0,0,0,0,0,0,68000,68000,0,0
052607,大立光元大96購03,0,0,0,0,0,0,0,0,0,0,0,0,0,11000,11000,0,0
053041,可成凱基96購02  ,0,0,0,0,0,0,0,0,0,0,0,0,0,14000,14000,0,0
053022,欣興國泰98購01  ,0,0,0,0,0,0,0,0,0,0,0,0,0,8000,8000,0,0
053006,玉晶光永豐96購03,0,0,0,0,0,0,0,0,0,0,0,0,0,4000,4000,0,0
049921,大立光元大94購16,0,0,0,0,0,0,0,0,0,0,0,0,0,1000,1000,0,0
049930,上海銀元大94購02,0,0,0,0,0,0,0,0,0,0,0,0,0,19000,19000,0,0
049908,鴻海元大94購08  ,0,0,0,0,0,0,0,0,0,0,0,0,0,13000,13000,0,0
05106P,鴻海永豐95售02  ,0,0,0,0,0,0,0,0,0,0,0,0,0,20000,20000,0,0
052119,漢唐國票96購01  ,0,0,0,0,0,0,0,0,0,0,0,0,0,34000,34000,0,0
049112,可成統一94購01  ,0,0,0,0,0,0,0,0,0,0,0,0,0,10000,10000,0,0
049138,台積電元大94購05,0,0,0,0,0,0,0,0,0,0,0,0,0,315000,315000,0,0
049139,台積電元大94購06,0,0,0,0,0,0,0,0,0,0,0,0,0,247000,247000,0,0
049151,大立光元大94購07,0,0,0,0,0,0,0,0,0,0,0,0,0,1000,1000,0,0
049127,上海銀元富94購01,0,0,0,0,0,0,0,0,0,0,0,0,0,6000,6000,0,0
049815,緯穎元大94購06  ,0,0,0,0,0,0,0,0,0,0,0,0,0,58000,58000,0,0
049883,台表科永豐94購02,0,0,0,0,0,0,0,0,0,0,0,0,0,10000,10000,0,0
051019,大立光凱基95購08,0,0,0,0,0,0,0,0,0,0,0,0,0,15000,15000,0,0
051072,強茂國票95購02  ,0,0,0,0,0,0,0,0,0,0,0,0,0,10000,10000,0,0
051664,鴻海元大96購07  ,0,0,0,0,0,0,0,0,0,0,0,0,0,68000,68000,0,0
051661,華新科永昌96購01,0,0,0,0,0,0,0,0,0,0,0,0,0,2000,2000,0,0
051669,建準元大95購01  ,0,0,0,0,0,0,0,0,0,0,0,0,0,30000,30000,0,0
050702,崇越凱基94購01  ,0,0,0,0,0,0,0,0,0,0,0,0,0,10000,10000,0,0
051637,嘉聯益國票96購01,0,0,0,0,0,0,0,0,0,0,0,0,0,21000,21000,0,0
049501,台郡元大95購01  ,0,0,0,0,0,0,0,0,0,0,0,0,0,4000,4000,0,0
050269,欣興元大94購09  ,0,0,0,0,0,0,0,0,0,0,0,0,0,2000,2000,0,0
050258,為升元大94購08  ,0,0,0,0,0,0,0,0,0,0,0,0,0,20000,20000,0,0
050259,鴻海元大94購14  ,0,0,0,0,0,0,0,0,0,0,0,0,0,26000,26000,0,0
050198,緯穎元大94購09  ,0,0,0,0,0,0,0,0,0,0,0,0,0,10000,10000,0,0
050199,南電元大94購09  ,0,0,0,0,0,0,0,0,0,0,0,0,0,4000,4000,0,0
050251,樺漢凱基94購02  ,0,0,0,0,0,0,0,0,0,0,0,0,0,50000,50000,0,0
050230,聯發科麥證94購02,0,0,0,2000,0,2000,0,0,0,0,0,0,0,2000,2000,0,0
050195,上海銀元大94購03,0,0,0,0,0,0,0,0,0,0,0,0,0,8000,8000,0,0
050187,群創元大94購03  ,0,0,0,0,0,0,0,0,0,0,0,0,0,31000,31000,0,0
050151,台積電群益94購12,0,0,0,0,0,0,0,0,0,0,0,0,0,52000,52000,0,0
050161,鴻海國泰96購03  ,0,0,0,0,0,0,0,0,0,0,0,0,0,4000,4000,0,0
051755,台積電元大96購08,0,0,0,0,0,0,0,0,0,0,0,0,0,50000,50000,0,0
051764,欣興元大95購07  ,0,0,0,0,0,0,0,0,0,0,0,0,0,1000,1000,0,0
051737,瑞昱國票96購01  ,0,0,0,0,0,0,0,0,0,0,0,0,0,24000,24000,0,0
051740,可成國票96購04  ,0,0,0,0,0,0,0,0,0,0,0,0,0,11000,11000,0,0
050783,旺宏國泰96購02  ,0,0,0,0,0,0,0,0,0,0,0,0,0,5000,5000,0,0
050774,健策元大96購02  ,0,0,0,0,0,0,0,0,0,0,0,0,0,9000,9000,0,0
05122P,鴻海永昌96售06  ,0,0,0,0,0,0,0,0,0,0,0,0,0,5000,5000,0,0
051212,國巨統一95購01  ,0,0,0,0,0,0,0,0,0,0,0,0,0,1000,1000,0,0
051254,健策元大96購04  ,0,0,0,0,0,0,0,0,0,0,0,0,0,9000,9000,0,0
051288,可成統一95購03  ,0,0,0,0,0,0,0,0,0,0,0,0,0,34000,34000,0,0
05132P,鴻海元富95售07  ,0,0,0,0,0,0,0,0,0,0,0,0,0,10000,10000,0,0
051337,欣興永豐95購02  ,0,0,0,0,0,0,0,0,0,0,0,0,0,2000,2000,0,0
051319,光磊國票96購02  ,0,0,0,0,0,0,0,0,0,0,0,0,0,10000,10000,0,0
051993,和碩元大95購03  ,0,0,0,0,0,0,0,0,0,0,0,0,0,299000,299000,0,0
051984,台塑元大95購01  ,0,0,0,0,0,0,0,0,0,0,0,0,0,68000,68000,0,0
051974,華新科凱基96購05,0,0,0,0,0,0,0,0,0,0,0,0,0,10000,10000,0,0
052097,GIS元大95購05   ,0,0,0,0,0,0,0,0,0,0,0,0,0,2000,2000,0,0
052090,聯發科元大97購03,0,0,0,0,0,0,0,0,0,0,0,0,0,68000,68000,0,0
052047,建準凱基96購01  ,0,0,0,0,0,0,0,0,0,0,0,0,0,4000,4000,0,0
052018,京鼎永豐95購02  ,0,0,0,0,0,0,0,0,0,0,0,0,0,70000,70000,0,0
049291,華通群益94購04  ,0,0,0,0,0,0,0,0,0,0,0,0,0,3000,3000,0,0
049344,華固統一94購01  ,0,0,0,0,0,0,0,0,0,0,0,0,0,10000,10000,0,0
049345,富邦金統一94購02,0,0,0,0,0,0,0,0,0,0,0,0,0,10000,10000,0,0
049338,台達電統一94購04,0,0,0,0,0,0,0,0,0,0,0,0,0,10000,10000,0,0
050437,聯詠凱基94購04  ,0,0,0,0,0,0,0,0,0,0,0,0,0,10000,10000,0,0
050425,國巨凱基94購12  ,0,0,0,0,0,0,0,0,0,0,0,0,0,1000,1000,0,0
050419,鴻海凱基95購02  ,0,0,0,0,0,0,0,0,0,0,0,0,0,2000,2000,0,0
050431,聯發科凱基94購18,0,0,0,0,0,0,0,0,0,0,0,0,0,3000,3000,0,0
050474,鴻海永豐94購05  ,0,0,0,0,0,0,0,0,0,0,0,0,0,68000,68000,0,0
050446,鴻海元大94購22  ,0,0,0,0,0,0,0,0,0,0,0,0,0,9000,9000,0,0
051619,智邦凱基95購07  ,0,0,0,0,0,0,0,0,0,0,0,0,0,66000,66000,0,0
051609,貿聯群益95購03  ,0,0,0,0,0,0,0,0,0,0,0,0,0,11000,11000,0,0
051621,欣興凱基95購02  ,0,0,0,0,0,0,0,0,0,0,0,0,0,1000,1000,0,0
050609,鴻海元大94購23  ,0,0,0,0,0,0,0,0,0,0,0,0,0,8000,8000,0,0
050610,鴻海元大94購24  ,0,0,0,0,0,0,0,0,0,0,0,0,0,126000,126000,0,0
050602,訊芯國泰96購01  ,0,0,0,0,0,0,0,0,0,0,0,0,0,10000,10000,0,0
050113,欣興元大95購05  ,0,0,0,0,0,0,0,0,0,0,0,0,0,2000,2000,0,0
050107,鴻海元大94購12  ,0,0,0,0,0,0,0,0,0,0,0,0,0,7000,7000,0,0
050061,聯發科凱基94購07,0,0,0,0,0,0,0,0,0,0,0,0,0,21000,21000,0,0
050058,國巨凱基94購06  ,0,0,0,0,0,0,0,0,0,0,0,0,0,4000,4000,0,0
051611,鈺齊群益95購02  ,0,0,0,0,0,0,0,0,0,0,0,0,0,10000,10000,0,0
051579,宏碁元大95購01  ,0,0,0,0,0,0,0,0,0,0,0,0,0,2000,2000,0,0
051580,宏碁元大95購02  ,0,0,0,0,0,0,0,0,0,0,0,0,0,16000,16000,0,0
051576,台積電元大97購02,0,0,0,0,0,0,0,0,0,0,0,0,0,127000,127000,0,0
050537,鴻海凱基95購05  ,0,0,0,0,0,0,0,0,0,0,0,0,0,11000,11000,0,0
050542,宏碁凱基95購01  ,0,0,0,0,0,0,0,0,0,0,0,0,0,6000,6000,0,0
050547,華新科凱基95購01,0,0,0,0,0,0,0,0,0,0,0,0,0,20000,20000,0,0
050503,聯發科凱基94購22,0,0,0,0,0,0,0,0,0,0,0,0,0,68000,68000,0,0
049348,瑞昱台新94購01  ,0,0,0,0,0,0,0,0,0,0,0,0,0,94000,94000,0,0
051560,玉晶光國泰97購03,0,0,0,0,0,0,0,0,0,0,0,0,0,79000,79000,0,0
049387,緯穎元大94購03  ,0,0,0,0,0,0,0,0,0,0,0,0,0,28000,28000,0,0
049418,大立光凱基94購05,0,0,0,0,0,0,0,0,0,0,0,0,0,1000,1000,0,0
053807,T50反1群益96購02,0,0,0,0,0,0,0,0,0,0,0,0,0,50000,50000,0,0
053801,台積電凱基96購18,0,0,0,0,0,0,0,0,0,0,0,0,0,68000,68000,0,0
053760,牧德國泰98購01  ,0,0,0,0,0,0,0,0,0,0,0,0,0,118000,118000,0,0
053705,滬深2X凱基99購01,0,0,0,0,0,0,0,0,0,0,0,0,0,50000,50000,0,0
053684,台積電元大96購17,0,0,0,0,0,0,0,0,0,0,0,0,0,101000,101000,0,0
053697,臻鼎元大96購02  ,0,0,0,0,0,0,0,0,0,0,0,0,0,10000,10000,0,0
053995,奇力新群益97購02,0,0,0,0,0,0,0,0,0,0,0,0,0,2000,2000,0,0
05397P,大立光凱基96售08,0,0,0,0,0,0,0,0,0,0,0,0,0,40000,40000,0,0
053962,聯茂永豐96購01  ,0,0,0,0,0,0,0,0,0,0,0,0,0,16000,16000,0,0
053844,GIS統一96購01   ,0,0,0,0,0,0,0,0,0,0,0,0,0,3000,3000,0,0
053859,台積電元大97購09,0,0,0,0,0,0,0,0,0,0,0,0,0,134000,134000,0,0
053905,華新科凱基96購10,0,0,0,0,0,0,0,0,0,0,0,0,0,6000,6000,0,0
053375,鴻海元大96購18  ,0,0,0,0,0,0,0,0,0,0,0,0,0,101000,101000,0,0
053381,友達元大9A購02  ,0,0,0,0,0,0,0,0,0,0,0,0,0,85000,85000,0,0
053382,友達元大9C購02  ,0,0,0,0,0,0,0,0,0,0,0,0,0,59000,59000,0,0
053383,京元電元大97購01,0,0,0,0,0,0,0,0,0,0,0,0,0,10000,10000,0,0
05358P,大立光元大95售09,0,0,0,0,0,0,0,0,0,0,0,0,0,5000,5000,0,0
053597,牧德元大99購01  ,0,0,0,0,0,0,0,0,0,0,0,0,0,10000,10000,0,0
053653,京元電凱基96購02,0,0,0,0,0,0,0,0,0,0,0,0,0,15000,15000,0,0
053489,上銀兆豐97購01  ,0,0,0,0,0,0,0,0,0,0,0,0,0,23000,23000,0,0
05349P,可成元富98售03  ,0,0,0,0,0,0,0,0,0,0,0,0,0,30000,30000,0,0
053511,鴻海群益96購04  ,0,0,0,0,0,0,0,0,0,0,0,0,0,6000,6000,0,0
052320,緯創元大95購05  ,0,0,0,0,0,0,0,0,0,0,0,0,0,41000,41000,0,0
052963,智邦凱基96購02  ,0,0,0,0,0,0,0,0,0,0,0,0,0,56000,56000,0,0
053059,聯發科永昌99購01,0,0,0,0,0,0,0,0,0,0,0,0,0,11000,11000,0,0
053066,欣興群益96購02  ,0,0,0,0,0,0,0,0,0,0,0,0,0,2000,2000,0,0
053078,昇陽半永豐97購02,0,0,0,0,0,0,0,0,0,0,0,0,0,17000,17000,0,0
053116,華新科中信96購01,0,0,0,0,0,0,0,0,0,0,0,0,0,28000,28000,0,0
053123,京元電凱基96購01,0,0,0,0,0,0,0,0,0,0,0,0,0,10000,10000,0,0
053185,友達中信99購01  ,0,0,0,0,0,0,0,0,0,0,0,0,0,20000,20000,0,0
05318P,臺股指永昌95售03,0,0,0,0,0,0,0,0,0,0,0,0,0,30000,30000,0,0
053167,欣興群益96購03  ,0,0,0,0,0,0,0,0,0,0,0,0,0,12000,12000,0,0
053274,旺宏元大98購03  ,0,0,0,0,0,0,0,0,0,0,0,0,0,5000,5000,0,0
05223P,臻鼎凱基95售02  ,0,0,0,0,0,0,0,0,0,0,0,0,0,150000,150000,0,0
052249,大成鋼永豐95購01,0,0,0,0,0,0,0,0,0,0,0,0,0,31000,31000,0,0
05222P,致伸凱基95售02  ,0,0,0,0,0,0,0,0,0,0,0,0,0,4000,4000,0,0
052228,聯發科凱基96購06,0,0,0,0,0,0,0,0,0,0,0,0,0,2000,2000,0,0
052801,友達元大9A購01  ,0,0,0,0,0,0,0,0,0,0,0,0,0,15000,15000,0,0
052759,京元電群益96購01,0,0,0,0,0,0,0,0,0,0,0,0,0,3000,3000,0,0
052839,上海銀國泰97購01,0,0,0,0,0,0,0,0,0,0,0,0,0,9000,9000,0,0
052841,群創富邦96購02  ,0,0,0,0,0,0,0,0,0,0,0,0,0,12000,12000,0,0
052489,義隆國票96購02  ,0,0,0,0,0,0,0,0,0,0,0,0,0,10000,10000,0,0
052874,超眾凱基96購01  ,0,0,0,0,0,0,0,0,0,0,0,0,0,10000,10000,0,0
052866,大立光凱基96購12,0,0,0,0,0,0,0,0,0,0,0,0,0,1000,1000,0,0
052913,鴻海元富96購05  ,0,0,0,0,0,0,0,0,0,0,0,0,0,50000,50000,0,0
052909,上銀統一96購01  ,0,0,0,0,0,0,0,0,0,0,0,0,0,36000,36000,0,0
052895,台積電群益96購04,0,0,0,0,0,0,0,0,0,0,0,0,0,173000,173000,0,0
054041,鴻海元大96購22  ,0,0,0,0,0,0,0,0,0,0,0,0,0,20000,20000,0,0
054147,GIS元大96購02   ,0,0,0,0,0,0,0,0,0,0,0,0,0,2000,2000,0,0
054300,華通凱基96購07  ,0,0,0,0,0,0,0,0,0,0,0,0,0,1000,1000,0,0
054297,台郡元大98購01  ,0,0,0,0,0,0,0,0,0,0,0,0,0,53000,53000,0,0
054285,國巨元大98購02  ,0,0,0,0,0,0,0,0,0,0,0,0,0,123000,123000,0,0
054286,台積電元大96購22,0,0,0,0,0,0,0,0,0,0,0,0,0,110000,110000,0,0
054340,大成鋼元富96購01,0,0,0,0,0,0,0,0,0,0,0,0,0,10000,10000,0,0
054531,聯發科國泰97購02,0,0,0,0,0,0,0,0,0,0,0,0,0,10000,10000,0,0
05453P,智邦群益95售03  ,0,0,0,0,0,0,0,0,0,0,0,0,0,10000,10000,0,0
054558,劍麟群益99購01  ,0,0,0,0,0,0,0,0,0,0,0,0,0,20000,20000,0,0
054559,台光電群益99購01,0,0,0,0,0,0,0,0,0,0,0,0,0,64000,64000,0,0
054655,貿聯麥證98購01  ,0,0,0,20000,20000,0,0,0,0,0,0,0,0,20000,20000,0,0
05468P,鴻海元大96售14  ,0,0,0,0,0,0,0,0,0,0,0,0,0,51000,51000,0,0
054468,台郡凱基98購01  ,0,0,0,0,0,0,0,0,0,0,0,0,0,5000,5000,0,0
054466,欣興凱基97購03  ,0,0,0,0,0,0,0,0,0,0,0,0,0,3000,3000,0,0
054462,旺宏凱基96購08  ,0,0,0,0,0,0,0,0,0,0,0,0,0,92000,92000,0,0
055298,啟碁元大97購02  ,0,0,0,0,0,0,0,0,0,0,0,0,0,50000,50000,0,0
055139,欣興永豐97購01  ,0,0,0,0,0,0,0,0,0,0,0,0,0,2000,2000,0,0
055147,鴻海元大97購11  ,0,0,0,0,0,0,0,0,0,0,0,0,0,200000,200000,0,0
055079,台光電中信97購01,0,0,0,0,0,0,0,0,0,0,0,0,0,1000,1000,0,0
054813,鴻海元大97購09  ,0,0,0,0,0,0,0,0,0,0,0,0,0,502000,502000,0,0
054814,台積電元大97購13,0,0,0,0,0,0,0,0,0,0,0,0,0,59000,59000,0,0
054809,大成鋼元大97購01,0,0,0,0,0,0,0,0,0,0,0,0,0,62000,62000,0,0
054857,信錦群益97購01  ,0,0,0,0,0,0,0,0,0,0,0,0,0,10000,10000,0,0
054725,國巨日盛97購01  ,0,0,0,0,0,0,0,0,0,0,0,0,0,3000,3000,0,0
054917,聯發科凱基98購05,0,0,0,0,0,0,0,0,0,0,0,0,0,68000,68000,0,0
054935,華通元大98購03  ,0,0,0,0,0,0,0,0,0,0,0,0,0,52000,52000,0,0
054936,鴻海元大97購10  ,0,0,0,0,0,0,0,0,0,0,0,0,0,263000,263000,0,0
054939,台積電元大97購15,0,0,0,0,0,0,0,0,0,0,0,0,0,150000,150000,0,0
054940,台積電元大97購16,0,0,0,0,0,0,0,0,0,0,0,0,0,150000,150000,0,0
054993,南亞科元富97購03,0,0,0,0,0,0,0,0,0,0,0,0,0,10000,10000,0,0
2939,凱羿-KY         ,2000,2000,0,0,0,0,0,0,0,0,0,0,0,0,0,0,0
3025,星通            ,1000,1000,0,0,0,0,0,0,0,0,0,0,0,0,0,0,0
3027,盛達            ,2000,2000,0,0,0,0,0,0,0,0,0,0,0,0,0,0,0
2524,京城            ,15000,16000,-1000,0,0,0,0,0,0,1000,1000,0,1000,0,0,0,0
2468,華經            ,1000,1000,0,0,0,0,0,0,0,0,0,0,0,0,0,0,0
2462,良得電          ,2000,3000,-1000,0,0,0,0,0,0,1000,1000,0,1000,0,0,0,0
5234,達興材料        ,12000,15000,-3000,0,0,0,0,0,0,3000,3000,0,3000,0,0,0,0
3054,立萬利          ,1000,1000,0,0,0,0,0,0,0,0,0,0,0,0,0,0,0
3356,奇偶            ,8000,8000,0,0,0,0,0,0,0,0,0,0,0,0,0,0,0
3607,谷崧            ,1000,1000,0,0,0,0,0,0,0,0,0,0,0,0,0,0,0
3588,通嘉            ,20000,20000,0,0,0,0,0,0,0,0,0,0,0,0,0,0,0
4571,鈞興-KY         ,0,0,0,0,0,0,0,0,0,0,1000,1000,0,0,0,0,0
06371P,茂林國票98售04  ,0,0,0,0,0,0,0,0,0,0,0,0,0,134000,134000,0,0
06372P,聯發科元大97售21,0,0,0,0,0,0,0,0,0,0,0,0,0,81000,81000,0,0
06385P,聯發科永豐97售02,0,0,0,0,0,0,0,0,0,0,0,0,0,10000,10000,0,0
06429P,大立光元大97售15,0,0,0,0,0,0,0,0,0,0,0,0,0,5000,5000,0,0
06430P,大立光元大97售16,0,0,0,0,0,0,0,0,0,0,0,0,0,5000,5000,0,0
06445P,大立光凱基98售09,0,0,0,0,0,0,0,0,0,0,0,0,0,3000,3000,0,0
06501P,臺股指元大9A售06,0,0,0,0,0,0,0,0,0,0,0,0,0,5000,5000,0,0
06548P,大立光元大98售10,0,0,0,0,0,0,0,0,0,0,0,0,0,5000,5000,0,0
06549P,大立光元大98售11,0,0,0,0,0,0,0,0,0,0,0,0,0,5000,5000,0,0
06578P,華新科國票98售02,0,0,0,0,0,0,0,0,0,0,0,0,0,5000,5000,0,0
06582P,可成凱基98售06  ,0,0,0,0,0,0,0,0,0,0,0,0,0,60000,60000,0,0
06355P,聯茂永豐97售02  ,0,0,0,0,0,0,0,0,0,0,0,0,0,30000,30000,0,0
06333P,臺股指群益9C售02,0,0,0,0,0,0,0,0,0,0,0,0,0,2000,2000,0,0
06329P,大立光兆豐97售04,0,0,0,0,0,0,0,0,0,0,0,0,0,10000,10000,0,0
06235P,國巨元大97售12  ,0,0,0,0,0,0,0,0,0,0,0,0,0,10000,10000,0,0
06261P,上銀凱基97售03  ,0,0,0,0,0,0,0,0,0,0,0,0,0,1000,1000,0,0
06184P,大立光元大97售06,0,0,0,0,0,0,0,0,0,0,0,0,0,5000,5000,0,0
06592P,欣興元大98售04  ,0,0,0,0,0,0,0,0,0,0,0,0,0,5000,5000,0,0
06570P,大立光永豐98售01,0,0,0,0,0,0,0,0,0,0,0,0,0,5000,5000,0,0
06571P,欣興永豐98售03  ,0,0,0,0,0,0,0,0,0,0,0,0,0,5000,5000,0,0
06589P,台積電元大98售12,0,0,0,0,0,0,0,0,0,0,0,0,0,150000,150000,0,0
06590P,大立光元大98售13,0,0,0,0,0,0,0,0,0,0,0,0,0,5000,5000,0,0
06623P,立積元大98售04  ,0,0,0,0,0,0,0,0,0,0,0,0,0,40000,40000,0,0
06662P,玉晶光中信9A售01,0,0,0,0,0,0,0,0,0,0,0,0,0,30000,30000,0,0
06673P,大立光群益98售01,0,0,0,0,0,0,0,0,0,0,0,0,0,5000,5000,0,0
06717P,可成元大98售09  ,0,0,0,0,0,0,0,0,0,0,0,0,0,50000,50000,0,0
06679P,旺宏元大98售09  ,0,0,0,0,0,0,0,0,0,0,0,0,0,60000,60000,0,0
1110,東泥            ,1000,1000,0,0,0,0,0,0,0,0,0,0,0,0,0,0,0
1539,巨庭            ,1000,1000,0,0,0,0,0,0,0,0,0,0,0,0,0,0,0
1533,車王電          ,1000,1000,0,0,0,0,0,0,0,0,0,0,0,0,0,0,0
2038,海光            ,1000,1000,0,0,0,0,0,0,0,0,0,0,0,0,0,0,0
2033,佳大            ,1000,1000,0,0,0,0,0,0,0,0,0,0,0,0,0,0,0
1817,凱撒衛          ,1000,1000,0,0,0,0,0,0,0,0,0,0,0,0,0,0,0
8463,潤泰材          ,35000,35000,0,0,0,0,0,0,0,0,0,0,0,0,0,0,0
8104,錸寶            ,9000,9000,0,0,0,0,0,0,0,0,0,0,0,0,0,0,0
4934,太極            ,203000,203121,-121,0,0,0,0,0,0,0,0,0,0,0,0,0,-121
1525,江申            ,0,0,0,0,0,0,0,520,-520,0,0,0,0,0,0,0,-520
055974,上銀統一97購05  ,0,0,0,0,0,0,0,0,0,-1000,0,0,0,9000,10000,-1000,-1000
05610P,國巨群益98售01  ,0,0,0,0,0,0,0,0,0,-1000,0,0,0,40000,41000,-1000,-1000
056169,鴻海元富97購08  ,0,0,0,0,0,0,0,0,0,-1000,0,0,0,2000,3000,-1000,-1000
056147,鴻海日盛97購05  ,0,0,0,0,0,0,0,0,0,-1000,0,0,0,0,1000,-1000,-1000
056224,聯發科凱基97購08,0,0,0,0,0,0,0,0,0,-1000,0,0,0,0,1000,-1000,-1000
056399,上証2X群益9C購01,0,0,0,0,0,0,0,0,0,-1000,0,0,0,0,1000,-1000,-1000
056534,京元電凱基98購01,0,0,0,0,0,0,0,0,0,-1000,0,0,0,11000,12000,-1000,-1000
056520,鴻海日盛99購01  ,0,0,0,0,0,0,0,0,0,-1000,0,0,0,4000,5000,-1000,-1000
056488,致新元大99購01  ,0,0,0,0,0,0,0,0,0,-1000,0,0,0,0,1000,-1000,-1000
056494,緯創國泰99購01  ,0,0,0,0,0,0,0,0,0,-1000,0,0,0,0,1000,-1000,-1000
056367,祥碩元大98購01  ,0,0,0,0,0,0,0,0,0,-1000,0,0,0,26000,27000,-1000,-1000
056286,奇鋐永豐97購01  ,0,0,0,0,0,0,0,0,0,-1000,0,0,0,0,1000,-1000,-1000
055502,群創元大9C購03  ,0,0,0,0,0,0,0,0,0,-1000,0,0,0,0,1000,-1000,-1000
055547,台積電凱基97購13,0,0,0,0,0,0,0,0,0,-1000,0,0,0,68000,69000,-1000,-1000
055613,全新國票98購01  ,0,0,0,0,0,0,0,0,0,-1000,0,0,0,13000,14000,-1000,-1000
055431,和鑫群益98購01  ,0,0,0,0,0,0,0,0,0,-1000,0,0,0,0,1000,-1000,-1000
055349,京元電凱基97購02,0,0,0,0,0,0,0,0,0,-1000,0,0,0,0,1000,-1000,-1000
055322,欣興國票97購06  ,0,0,0,0,0,0,0,0,0,-1000,0,0,0,20000,21000,-1000,-1000
055659,百和元富97購01  ,0,0,0,0,0,0,0,0,0,-1000,0,0,0,0,1000,-1000,-1000
055933,欣興群益98購02  ,0,0,0,0,0,0,0,0,0,-1000,0,0,0,22000,23000,-1000,-1000
056890,國巨元大98購11  ,0,0,0,0,0,0,0,0,0,-1000,0,0,0,210000,211000,-1000,-1000
056952,元油2X國泰99購01,0,0,0,0,0,0,0,0,0,-1000,0,0,0,0,1000,-1000,-1000
057108,潤泰全群益98購01,0,0,0,0,0,0,0,0,0,-1000,0,0,0,10000,11000,-1000,-1000
057083,立積統一98購01  ,0,0,0,0,0,0,0,0,0,-1000,0,0,0,57000,58000,-1000,-1000
057130,全新凱基98購03  ,0,0,0,0,0,0,0,0,0,-1000,0,0,0,0,1000,-1000,-1000
056749,滬深2X兆豐99購01,0,0,0,0,0,0,0,0,0,-1000,0,0,0,0,1000,-1000,-1000
057271,國巨元大98購17  ,0,0,0,0,0,0,0,0,0,-1000,0,0,0,226000,227000,-1000,-1000
057340,玉晶光元富98購04,0,0,0,0,0,0,0,0,0,-1000,0,0,0,0,1000,-1000,-1000
057189,康控元大98購02  ,0,0,0,0,0,0,0,0,0,-1000,0,0,0,38000,39000,-1000,-1000
057392,福懋科永豐98購01,0,0,0,0,0,0,0,0,0,-1000,0,0,0,224000,225000,-1000,-1000
057376,新日興元大98購04,0,0,0,0,0,0,0,0,0,-1000,0,0,0,12000,13000,-1000,-1000
057488,聯發科元大99購02,0,0,0,0,0,0,0,0,0,-1000,0,0,0,22000,23000,-1000,-1000
05917P,宏達電元大96售02,0,0,0,0,0,0,0,0,0,-1000,0,0,0,0,1000,-1000,-1000
048567,台郡元大93購03  ,0,0,0,0,0,0,0,0,0,-1000,0,0,0,0,1000,-1000,-1000
047231,大立光凱基95購03,0,0,0,0,0,0,0,0,0,-1000,0,0,0,50000,51000,-1000,-1000
047193,南電元大94購02  ,0,0,0,0,0,0,0,0,0,-1000,0,0,0,0,1000,-1000,-1000
047115,可成元大93購06  ,0,0,0,0,0,0,0,0,0,-1000,0,0,0,66000,67000,-1000,-1000
049250,華通元大95購04  ,0,0,0,0,0,0,0,0,0,-1000,0,0,0,37000,38000,-1000,-1000
048416,台達電統一93購02,0,0,0,0,0,0,0,0,0,-1000,0,0,0,0,1000,-1000,-1000
046938,致茂元大93購02  ,0,0,0,0,0,0,0,0,0,-1000,0,0,0,0,1000,-1000,-1000
047730,矽力群益93購02  ,0,0,0,0,0,0,0,0,0,-1000,0,0,0,20000,21000,-1000,-1000
046716,欣興國泰93購03  ,0,0,0,0,0,0,0,0,0,-1000,0,0,0,3000,4000,-1000,-1000
046701,T50反1統一93購03,0,0,0,0,0,0,0,0,0,-1000,0,0,0,0,1000,-1000,-1000
048134,祥碩國票93購02  ,0,0,0,0,0,0,0,0,0,-1000,0,0,0,0,1000,-1000,-1000
048189,臺指反元大96購06,0,0,0,0,0,0,0,0,0,-1000,0,0,0,0,1000,-1000,-1000
048076,亞光第一94購01  ,0,0,0,0,0,0,0,0,0,-1000,0,0,0,0,1000,-1000,-1000
046658,微星元大93購01  ,0,0,0,0,0,0,0,0,0,-1000,0,0,0,0,1000,-1000,-1000
048051,大立光中信94購03,0,0,0,0,0,0,0,0,0,-1000,0,0,0,0,1000,-1000,-1000
048027,京元電凱基93購03,0,0,0,0,0,0,0,0,0,-1000,0,0,0,100000,101000,-1000,-1000
048007,明基材元大96購01,0,0,0,0,0,0,0,0,0,-1000,0,0,0,860000,861000,-1000,-1000
048337,致茂元大93購04  ,0,0,0,0,0,0,0,0,0,-1000,0,0,0,0,1000,-1000,-1000
047882,超眾國泰94購01  ,0,0,0,0,0,0,0,0,0,-1000,0,0,0,0,1000,-1000,-1000
046510,大立光元大92購25,0,0,0,0,0,0,0,0,0,-1000,0,0,0,0,1000,-1000,-1000
047795,臺股指群益93購06,0,0,0,0,0,0,0,0,0,-1000,0,0,0,0,1000,-1000,-1000
047860,臺股指國票93購15,0,0,0,0,0,0,0,0,0,-1000,0,0,0,0,1000,-1000,-1000
04786P,鴻海永昌96售01  ,0,0,0,0,0,0,0,0,0,-1000,0,0,0,0,1000,-1000,-1000
045362,A50正2兆豐93購02,0,0,0,0,0,0,0,0,0,-1000,0,0,0,0,1000,-1000,-1000
04543P,鴻海富邦95售03  ,0,0,0,0,0,0,0,0,0,-1000,0,0,0,0,1000,-1000,-1000
044396,燿華凱基93購02  ,0,0,0,0,0,0,0,0,0,-1000,0,0,0,0,1000,-1000,-1000
045934,燿華群益93購01  ,0,0,0,0,0,0,0,0,0,-1000,0,0,0,10000,11000,-1000,-1000
04395P,台積電群益94售06,0,0,0,0,0,0,0,0,0,-1000,0,0,0,0,1000,-1000,-1000
043970,為升富邦94購01  ,0,0,0,0,0,0,0,0,0,-1000,0,0,0,9000,10000,-1000,-1000
043580,大立光元富94購01,0,0,0,0,0,0,0,0,0,-1000,0,0,0,1000,2000,-1000,-1000
042997,新光鋼元大94購01,0,0,0,0,0,0,0,0,0,-1000,0,0,0,0,1000,-1000,-1000
046225,南亞科元大92購05,0,0,0,0,0,0,0,0,0,-1000,0,0,0,0,1000,-1000,-1000
03612C,臺股指元大95牛01,0,0,0,0,0,0,0,0,0,-1000,0,0,0,18000,19000,-1000,-1000
03802P,GIS元大93售07   ,0,0,0,0,0,0,0,0,0,-1000,0,0,0,0,1000,-1000,-1000
03830P,緯創中信95售01  ,0,0,0,0,0,0,0,0,0,-1000,0,0,0,0,1000,-1000,-1000
038489,T50反1台新9A購01,0,0,0,0,0,0,0,0,0,-1000,0,0,0,0,1000,-1000,-1000
03640P,百和凱基93售05  ,0,0,0,0,0,0,0,0,0,-1000,0,0,0,0,1000,-1000,-1000
04611P,元油2X群益98售02,0,0,0,0,0,0,0,0,0,-1000,0,0,0,0,1000,-1000,-1000
039212,台達電台新9A購01,0,0,0,0,0,0,0,0,0,-1000,0,0,0,0,1000,-1000,-1000
04043P,復盛元富93售02  ,0,0,0,0,0,0,0,0,0,-1000,0,0,0,0,1000,-1000,-1000
041534,T50反1凱基96購01,0,0,0,0,0,0,0,0,0,-1000,0,0,0,0,1000,-1000,-1000
03155P,玉晶光群益01售08,0,0,0,0,0,0,0,0,0,-1000,0,0,0,0,1000,-1000,-1000
00685L,群益臺灣加權正2 ,0,0,0,0,0,0,0,0,0,-1000,0,0,0,9000,10000,-1000,-1000
050559,聯發科統一94購10,0,0,0,0,0,0,0,0,0,-1000,0,0,0,465000,466000,-1000,-1000
051501,康友群益95購02  ,0,0,0,0,0,0,0,0,0,-1000,0,0,0,59000,60000,-1000,-1000
052075,旺宏元富95購03  ,0,0,0,0,0,0,0,0,0,-1000,0,0,0,0,1000,-1000,-1000
052003,泰碩國泰97購02  ,0,0,0,0,0,0,0,0,0,-1000,0,0,0,0,1000,-1000,-1000
051261,鴻海永昌96購05  ,0,0,0,0,0,0,0,0,0,-1000,0,0,0,0,1000,-1000,-1000
051239,國巨元大96購02  ,0,0,0,0,0,0,0,0,0,-1000,0,0,0,11000,12000,-1000,-1000
051769,矽力元大95購01  ,0,0,0,0,0,0,0,0,0,-1000,0,0,0,0,1000,-1000,-1000
05176P,台積電凱基95售11,0,0,0,0,0,0,0,0,0,-1000,0,0,0,0,1000,-1000,-1000
050948,華固群益95購01  ,0,0,0,0,0,0,0,0,0,-1000,0,0,0,0,1000,-1000,-1000
05167P,百和元富95售03  ,0,0,0,0,0,0,0,0,0,-1000,0,0,0,0,1000,-1000,-1000
051685,台光電凱基95購01,0,0,0,0,0,0,0,0,0,-1000,0,0,0,0,1000,-1000,-1000
051065,台積電國票96購01,0,0,0,0,0,0,0,0,0,-1000,0,0,0,4000,5000,-1000,-1000
04913P,聯詠元富94售02  ,0,0,0,0,0,0,0,0,0,-1000,0,0,0,0,1000,-1000,-1000
052587,景碩永豐97購01  ,0,0,0,0,0,0,0,0,0,-1000,0,0,0,0,1000,-1000,-1000
052677,景碩富邦97購01  ,0,0,0,0,0,0,0,0,0,-1000,0,0,0,0,1000,-1000,-1000
052519,旺宏元大95購05  ,0,0,0,0,0,0,0,0,0,-1000,0,0,0,66000,67000,-1000,-1000
052520,南亞科元大95購06,0,0,0,0,0,0,0,0,0,-1000,0,0,0,2000,3000,-1000,-1000
050860,喬山永豐95購01  ,0,0,0,0,0,0,0,0,0,-1000,0,0,0,0,1000,-1000,-1000
049536,T50反1群益94購02,0,0,0,0,0,0,0,0,0,-1000,0,0,0,0,1000,-1000,-1000
05093P,可成元大95售03  ,0,0,0,0,0,0,0,0,0,-1000,0,0,0,51000,52000,-1000,-1000
050902,南電元大96購01  ,0,0,0,0,0,0,0,0,0,-1000,0,0,0,0,1000,-1000,-1000
049986,嘉澤凱基94購02  ,0,0,0,0,0,0,0,0,0,-1000,0,0,0,30000,31000,-1000,-1000
054959,禾伸堂元大98購01,0,0,0,0,0,0,0,0,0,-1000,0,0,0,0,1000,-1000,-1000
054829,亞光國泰99購01  ,0,0,0,0,0,0,0,0,0,-1000,0,0,0,88000,89000,-1000,-1000
054798,超眾群益97購01  ,0,0,0,0,0,0,0,0,0,-1000,0,0,0,0,1000,-1000,-1000
055069,帆宣永豐97購01  ,0,0,0,0,0,0,0,0,0,-1000,0,0,0,251000,252000,-1000,-1000
055022,精元國泰99購01  ,0,0,0,0,0,0,0,0,0,-1000,0,0,0,58000,59000,-1000,-1000
054352,世芯國泰98購01  ,0,0,0,0,0,0,0,0,0,-1000,0,0,0,19000,20000,-1000,-1000
054660,禾伸堂元大97購03,0,0,0,0,0,0,0,0,0,-1000,0,0,0,0,1000,-1000,-1000
054593,滬深2X永昌9A購01,0,0,0,0,0,0,0,0,0,-1000,0,0,0,0,1000,-1000,-1000
05275P,國巨凱基95售05  ,0,0,0,0,0,0,0,0,0,-1000,0,0,0,0,1000,-1000,-1000
053263,華邦電群益96購03,0,0,0,0,0,0,0,0,0,-1000,0,0,0,0,1000,-1000,-1000
053151,華新科元大96購04,0,0,0,0,0,0,0,0,0,-1000,0,0,0,10000,11000,-1000,-1000
053475,華新科元大96購05,0,0,0,0,0,0,0,0,0,-1000,0,0,0,0,1000,-1000,-1000
053858,台達電元大96購05,0,0,0,0,0,0,0,0,0,-1000,0,0,0,1000,2000,-1000,-1000
053952,南亞科台新96購01,0,0,0,0,0,0,0,0,0,-1000,0,0,0,14000,15000,-1000,-1000
053725,晶相光凱基96購01,0,0,0,0,0,0,0,0,0,-1000,0,0,0,54000,55000,-1000,-1000
1521,大億            ,1000,2000,-1000,0,0,0,0,0,0,0,0,0,0,0,0,0,-1000
1474,弘裕            ,0,0,0,0,0,0,0,0,0,-1000,0,1000,-1000,0,0,0,-1000
1568,倉佑            ,0,1000,-1000,0,0,0,0,0,0,0,0,0,0,0,0,0,-1000
1603,華電            ,3000,4000,-1000,0,0,0,0,0,0,0,0,0,0,0,0,0,-1000
1608,華榮            ,3000,4000,-1000,0,0,0,0,0,0,0,0,0,0,0,0,0,-1000
1724,台硝            ,0,1000,-1000,0,0,0,0,0,0,0,0,0,0,0,0,0,-1000
1713,國化            ,0,0,0,0,0,0,0,0,0,-1000,0,1000,-1000,0,0,0,-1000
1806,冠軍            ,0,1000,-1000,0,0,0,0,0,0,0,0,0,0,0,0,0,-1000
1219,福壽            ,0,0,0,0,0,0,0,0,0,-1000,0,1000,-1000,0,0,0,-1000
1235,興泰            ,0,0,0,0,0,0,0,0,0,-1000,0,1000,-1000,0,0,0,-1000
1108,幸福            ,1000,1000,0,0,0,0,0,0,0,-1000,0,1000,-1000,0,0,0,-1000
1419,新紡            ,0,1000,-1000,0,0,0,0,0,0,0,0,0,0,0,0,0,-1000
1432,大魯閣          ,1000,2000,-1000,0,0,0,0,0,0,0,0,0,0,0,0,0,-1000
1414,東和            ,0,1000,-1000,0,0,0,0,0,0,0,0,0,0,0,0,0,-1000
06188P,大立光元富97售01,0,0,0,0,0,0,0,0,0,-1000,0,0,0,10000,11000,-1000,-1000
06377P,華通統一97售04  ,0,0,0,0,0,0,0,0,0,-1000,0,0,0,0,1000,-1000,-1000
4952,凌通            ,3000,4000,-1000,0,0,0,0,0,0,0,0,0,0,0,0,0,-1000
4566,時碩工業        ,10000,11000,-1000,0,0,0,0,0,0,0,0,0,0,0,0,0,-1000
4557,永新-KY         ,0,1000,-1000,0,0,0,0,0,0,0,0,0,0,0,0,0,-1000
3040,遠見            ,0,1000,-1000,0,0,0,0,0,0,0,0,0,0,0,0,0,-1000
3046,建碁            ,0,1000,-1000,0,0,0,0,0,0,0,0,0,0,0,0,0,-1000
3266,昇陽            ,0,1000,-1000,0,0,0,0,0,0,0,0,0,0,0,0,0,-1000
3058,立德            ,0,1000,-1000,0,0,0,0,0,0,0,0,0,0,0,0,0,-1000
3167,大量            ,6000,7000,-1000,0,0,0,0,0,0,0,0,0,0,0,0,0,-1000
5007,三星            ,1000,2000,-1000,0,0,0,0,0,0,0,0,0,0,0,0,0,-1000
6142,友勁            ,0,1000,-1000,0,0,0,0,0,0,0,0,0,0,0,0,0,-1000
6115,鎰勝            ,5000,6000,-1000,0,0,0,0,0,0,0,0,0,0,0,0,0,-1000
5533,皇鼎            ,0,1000,-1000,0,0,0,0,0,0,0,0,0,0,0,0,0,-1000
6531,愛普            ,114000,181000,-67000,0,0,0,65000,0,65000,1000,5000,4000,1000,0,0,0,-1000
6674,鋐寶科技        ,0,0,0,0,0,0,0,0,0,-1000,0,1000,-1000,0,0,0,-1000
6671,三能-KY         ,1000,2000,-1000,0,0,0,0,0,0,0,0,0,0,0,0,0,-1000
6625,必應            ,0,1000,-1000,0,0,0,0,0,0,0,0,0,0,0,0,0,-1000
6205,詮欣            ,0,1000,-1000,0,0,0,0,0,0,0,0,0,0,0,0,0,-1000
6405,悅城            ,0,1000,-1000,0,0,0,0,0,0,0,0,0,0,0,0,0,-1000
2423,固緯            ,7000,8000,-1000,0,0,0,0,0,0,0,0,0,0,0,0,0,-1000
2433,互盛電          ,2000,3000,-1000,0,0,0,0,0,0,0,0,0,0,0,0,0,-1000
2227,裕日車          ,6000,13000,-7000,0,0,0,0,0,0,6000,6000,0,6000,0,0,0,-1000
2236,百達-KY         ,0,1000,-1000,0,0,0,0,0,0,0,0,0,0,0,0,0,-1000
2305,全友            ,0,1000,-1000,0,0,0,0,0,0,0,0,0,0,0,0,0,-1000
2115,六暉-KY         ,0,1000,-1000,0,0,0,0,0,0,0,0,0,0,0,0,0,-1000
2514,龍邦            ,9000,10000,-1000,0,0,0,0,0,0,0,0,0,0,0,0,0,-1000
2539,櫻花建          ,0,1000,-1000,0,0,0,0,0,0,0,0,0,0,0,0,0,-1000
2923,鼎固-KY         ,0,1000,-1000,0,0,0,0,0,0,0,0,0,0,0,0,0,-1000
8103,瀚荃            ,1000,2000,-1000,0,0,0,0,0,0,0,0,0,0,0,0,0,-1000
8427,基勝-KY         ,0,1000,-1000,0,0,0,0,0,0,0,0,0,0,0,0,0,-1000
8940,新天地          ,0,1000,-1000,0,0,0,0,0,0,0,0,0,0,0,0,0,-1000
8478,東哥遊艇        ,0,1000,-1000,0,0,0,0,0,0,0,0,0,0,0,0,0,-1000
9906,欣巴巴          ,0,1000,-1000,0,0,0,0,0,0,0,0,0,0,0,0,0,-1000
05908P,大立光元富96售05,0,0,0,0,0,0,0,0,0,-2000,0,0,0,22000,24000,-2000,-2000
057490,可成元大98購10  ,0,0,0,0,0,0,0,0,0,-2000,0,0,0,0,2000,-2000,-2000
05778P,台積電統一96售05,0,0,0,0,0,0,0,0,0,-2000,0,0,0,0,2000,-2000,-2000
057252,牧德元富98購01  ,0,0,0,0,0,0,0,0,0,-2000,0,0,0,6000,8000,-2000,-2000
057235,亞光凱基98購04  ,0,0,0,0,0,0,0,0,0,-2000,0,0,0,35000,37000,-2000,-2000
057280,大立光元大98購15,0,0,0,0,0,0,0,0,0,-2000,0,0,0,5000,7000,-2000,-2000
056777,矽力元大98購02  ,0,0,0,0,0,0,0,0,0,-2000,0,0,0,1000,3000,-2000,-2000
05665P,台積電凱基96售08,0,0,0,0,0,0,0,0,0,-2000,0,0,0,8000,10000,-2000,-2000
056909,嘉聯益元大99購03,0,0,0,0,0,0,0,0,0,-2000,0,0,0,34000,36000,-2000,-2000
056998,麗豐康和98購01  ,0,0,0,0,0,0,0,0,0,-2000,0,0,0,19000,21000,-2000,-2000
055899,群創中信99購01  ,0,0,0,0,0,0,0,0,0,-2000,0,0,0,10000,12000,-2000,-2000
055882,嘉聯益元富97購01,0,0,0,0,0,0,0,0,0,-2000,0,0,0,0,2000,-2000,-2000
055352,奇力新凱基97購01,0,0,0,0,0,0,0,0,0,-2000,0,0,0,0,2000,-2000,-2000
055353,華新科凱基98購03,0,0,0,0,0,0,0,0,0,-2000,0,0,0,5000,7000,-2000,-2000
055394,健策統一97購01  ,0,0,0,0,0,0,0,0,0,-2000,0,0,0,11000,13000,-2000,-2000
055409,元黃金富邦01購01,0,0,0,0,0,0,0,0,0,-2000,0,0,0,0,2000,-2000,-2000
055587,智邦元大97購02  ,0,0,0,0,0,0,0,0,0,-2000,0,0,0,57000,59000,-2000,-2000
055511,大立光兆豐97購02,0,0,0,0,0,0,0,0,0,-2000,0,0,0,0,2000,-2000,-2000
056368,祥碩元大98購02  ,0,0,0,0,0,0,0,0,0,-2000,0,0,0,148000,150000,-2000,-2000
056341,宏達電凱基9A購01,0,0,0,0,0,0,0,0,0,-2000,0,0,0,24000,26000,-2000,-2000
056415,聯發科中信98購04,0,0,0,0,0,0,0,0,0,-2000,0,0,0,0,2000,-2000,-2000
056411,緯穎國票99購01  ,0,0,0,0,0,0,0,0,0,-2000,0,0,0,0,2000,-2000,-2000
056153,華新科凱基97購02,0,0,0,0,0,0,0,0,0,-2000,0,0,0,10000,12000,-2000,-2000
056017,台積電群益97購04,0,0,0,0,0,0,0,0,0,-2000,0,0,0,428000,430000,-2000,-2000
00682U,元大美元指數    ,0,80000,-80000,0,0,0,0,0,0,78000,0,0,0,78000,0,78000,-2000
00668,國泰美國道瓊    ,0,0,0,0,0,0,0,0,0,-2000,0,0,0,0,2000,-2000,-2000
006204,永豐臺灣加權    ,0,0,0,0,0,0,0,0,0,-2000,0,0,0,0,2000,-2000,-2000
03029X,元展26          ,0,0,0,0,0,0,0,0,0,-2000,0,0,0,0,2000,-2000,-2000
03899P,滬深2X群益95售03,0,0,0,0,0,0,0,0,0,-2000,0,0,0,0,2000,-2000,-2000
03973P,高鐵元大93售01  ,0,0,0,0,0,0,0,0,0,-2000,0,0,0,0,2000,-2000,-2000
046298,聯發科富邦94購01,0,0,0,0,0,0,0,0,0,-2000,0,0,0,39000,41000,-2000,-2000
043513,台灣50元大96購05,0,0,0,0,0,0,0,0,0,-2000,0,0,0,0,2000,-2000,-2000
043696,瑞儀兆豐93購01  ,0,0,0,0,0,0,0,0,0,-2000,0,0,0,0,2000,-2000,-2000
045924,鴻海台新92購01  ,0,0,0,0,0,0,0,0,0,-2000,0,0,0,0,2000,-2000,-2000
044382,嘉聯益群益94購01,0,0,0,0,0,0,0,0,0,-2000,0,0,0,9000,11000,-2000,-2000
044645,元金2X群益93購01,0,0,0,0,0,0,0,0,0,-2000,0,0,0,0,2000,-2000,-2000
044496,群創元大93購02  ,0,0,0,0,0,0,0,0,0,-2000,0,0,0,0,2000,-2000,-2000
045152,大立光凱基93購03,0,0,0,0,0,0,0,0,0,-2000,0,0,0,0,2000,-2000,-2000
04645P,禾伸堂凱基94售03,0,0,0,0,0,0,0,0,0,-2000,0,0,0,0,2000,-2000,-2000
047917,台積電凱基94購01,0,0,0,0,0,0,0,0,0,-2000,0,0,0,0,2000,-2000,-2000
048324,訊芯凱基93購03  ,0,0,0,0,0,0,0,0,0,-2000,0,0,0,0,2000,-2000,-2000
048125,和鑫元大96購01  ,0,0,0,0,0,0,0,0,0,-2000,0,0,0,0,2000,-2000,-2000
048435,致新國票93購01  ,0,0,0,0,0,0,0,0,0,-2000,0,0,0,4000,6000,-2000,-2000
048427,百和元富95購01  ,0,0,0,0,0,0,0,0,0,-2000,0,0,0,8000,10000,-2000,-2000
047355,世紀鋼凱基94購01,0,0,0,0,0,0,0,0,0,-2000,0,0,0,0,2000,-2000,-2000
05034P,台積電元大95售08,0,0,0,0,0,0,0,0,0,-2000,0,0,0,0,2000,-2000,-2000
051459,臺股指元大95購19,0,0,0,0,0,0,0,0,0,-2000,0,0,0,1000,3000,-2000,-2000
051483,玉晶光凱基96購02,0,0,0,0,0,0,0,0,0,-2000,0,0,0,77000,79000,-2000,-2000
051799,台積電永豐96購01,0,0,0,0,0,0,0,0,0,-2000,0,0,0,0,2000,-2000,-2000
048790,大立光元大95購05,0,0,0,0,0,0,0,0,0,-2000,0,0,0,3000,5000,-2000,-2000
047019,台積電元大93購14,0,0,0,0,0,0,0,0,0,-2000,0,0,0,0,2000,-2000,-2000
050977,聯發科統一95購02,0,0,0,0,0,0,0,0,0,-2000,0,0,0,48000,50000,-2000,-2000
050012,台積電國泰95購03,0,0,0,0,0,0,0,0,0,-2000,0,0,0,8000,10000,-2000,-2000
051014,智邦凱基95購01  ,0,0,0,0,0,0,0,0,0,-2000,0,0,0,0,2000,-2000,-2000
048832,玉晶光凱基95購02,0,0,0,0,0,0,0,0,0,-2000,0,0,0,1000,3000,-2000,-2000
04889P,華通元大94售03  ,0,0,0,0,0,0,0,0,0,-2000,0,0,0,0,2000,-2000,-2000
049720,欣興凱基94購05  ,0,0,0,0,0,0,0,0,0,-2000,0,0,0,2000,4000,-2000,-2000
049619,宏達電群益95購02,0,0,0,0,0,0,0,0,0,-2000,0,0,0,0,2000,-2000,-2000
050829,臻鼎凱基96購01  ,0,0,0,0,0,0,0,0,0,-2000,0,0,0,0,2000,-2000,-2000
052396,台積電凱基97購01,0,0,0,0,0,0,0,0,0,-2000,0,0,0,0,2000,-2000,-2000
052381,臺股指元大95購22,0,0,0,0,0,0,0,0,0,-2000,0,0,0,0,2000,-2000,-2000
052355,為升永豐95購02  ,0,0,0,0,0,0,0,0,0,-2000,0,0,0,45000,47000,-2000,-2000
052675,新光金國泰98購01,0,0,0,0,0,0,0,0,0,-2000,0,0,0,0,2000,-2000,-2000
052662,華新科國票97購01,0,0,0,0,0,0,0,0,0,-2000,0,0,0,14000,16000,-2000,-2000
052650,台郡永豐96購01  ,0,0,0,0,0,0,0,0,0,-2000,0,0,0,39000,41000,-2000,-2000
052633,國巨凱基96購05  ,0,0,0,0,0,0,0,0,0,-2000,0,0,0,47000,49000,-2000,-2000
052628,樺漢中信96購01  ,0,0,0,0,0,0,0,0,0,-2000,0,0,0,0,2000,-2000,-2000
049803,華新科元大95購07,0,0,0,0,0,0,0,0,0,-2000,0,0,0,0,2000,-2000,-2000
051052,台積電群益95購01,0,0,0,0,0,0,0,0,0,-2000,0,0,0,423000,425000,-2000,-2000
049931,矽力元大94購01  ,0,0,0,0,0,0,0,0,0,-2000,0,0,0,1000,3000,-2000,-2000
049924,欣興元大95購04  ,0,0,0,0,0,0,0,0,0,-2000,0,0,0,2000,4000,-2000,-2000
050210,華新科國票94購08,0,0,0,0,0,0,0,0,0,-2000,0,0,0,0,2000,-2000,-2000
050650,大立光凱基96購01,0,0,0,0,0,0,0,0,0,-2000,0,0,0,0,2000,-2000,-2000
051267,美律富邦96購01  ,0,0,0,0,0,0,0,0,0,-2000,0,0,0,0,2000,-2000,-2000
051194,大立光中信96購02,0,0,0,0,0,0,0,0,0,-2000,0,0,0,0,2000,-2000,-2000
052086,鴻海元大96購08  ,0,0,0,0,0,0,0,0,0,-2000,0,0,0,0,2000,-2000,-2000
052017,奇鋐永豐95購01  ,0,0,0,0,0,0,0,0,0,-2000,0,0,0,0,2000,-2000,-2000
049341,旺宏統一95購01  ,0,0,0,0,0,0,0,0,0,-2000,0,0,0,54000,56000,-2000,-2000
050624,鈺齊元大94購01  ,0,0,0,0,0,0,0,0,0,-2000,0,0,0,0,2000,-2000,-2000
050064,華新科凱基94購08,0,0,0,0,0,0,0,0,0,-2000,0,0,0,18000,20000,-2000,-2000
050073,傳奇凱基94購02  ,0,0,0,0,0,0,0,0,0,-2000,0,0,0,70000,72000,-2000,-2000
053637,強茂永豐96購01  ,0,0,0,0,0,0,0,0,0,-2000,0,0,0,0,2000,-2000,-2000
053789,彩晶元大9C購02  ,0,0,0,0,0,0,0,0,0,-2000,0,0,0,0,2000,-2000,-2000
053847,美律元富96購02  ,0,0,0,0,0,0,0,0,0,-2000,0,0,0,0,2000,-2000,-2000
053891,欣興群益98購01  ,0,0,0,0,0,0,0,0,0,-2000,0,0,0,1000,3000,-2000,-2000
053892,景碩群益96購02  ,0,0,0,0,0,0,0,0,0,-2000,0,0,0,32000,34000,-2000,-2000
053492,華邦電兆豐97購01,0,0,0,0,0,0,0,0,0,-2000,0,0,0,28000,30000,-2000,-2000
053318,全新群益99購01  ,0,0,0,0,0,0,0,0,0,-2000,0,0,0,41000,43000,-2000,-2000
053258,上証2X群益9A購03,0,0,0,0,0,0,0,0,0,-2000,0,0,0,30000,32000,-2000,-2000
05326P,臺股指凱基95售10,0,0,0,0,0,0,0,0,0,-2000,0,0,0,0,2000,-2000,-2000
052235,聯發科國票96購02,0,0,0,0,0,0,0,0,0,-2000,0,0,0,0,2000,-2000,-2000
052893,聯電群益98購01  ,0,0,0,0,0,0,0,0,0,-2000,0,0,0,0,2000,-2000,-2000
054507,鈺齊永豐96購01  ,0,0,0,0,0,0,0,0,0,-2000,0,0,0,0,2000,-2000,-2000
054044,京元電元大96購03,0,0,0,0,0,0,0,0,0,-2000,0,0,0,0,2000,-2000,-2000
055056,億光永豐97購01  ,0,0,0,0,0,0,0,0,0,-2000,0,0,0,54000,56000,-2000,-2000
05523P,聯發科國票96售04,0,0,0,0,0,0,0,0,0,-2000,0,0,0,0,2000,-2000,-2000
05472P,國巨統一96售02  ,0,0,0,0,0,0,0,0,0,-2000,0,0,0,48000,50000,-2000,-2000
054714,和鑫台新98購01  ,0,0,0,0,0,0,0,0,0,-2000,0,0,0,0,2000,-2000,-2000
054938,國巨元大97購04  ,0,0,0,0,0,0,0,0,0,-2000,0,0,0,221000,223000,-2000,-2000
9905,大華            ,6000,8000,-2000,0,0,0,0,0,0,0,0,0,0,0,0,0,-2000
2546,根基            ,3000,5000,-2000,0,0,0,0,0,0,0,0,0,0,0,0,0,-2000
2516,新建            ,1000,3000,-2000,0,0,0,0,0,0,0,0,0,0,0,0,0,-2000
2497,怡利電          ,0,2000,-2000,0,0,0,0,0,0,0,0,0,0,0,0,0,-2000
2706,第一店          ,0,2000,-2000,0,0,0,0,0,0,0,0,0,0,0,0,0,-2000
2239,英利-KY         ,0,2000,-2000,0,0,0,0,0,0,0,0,0,0,0,0,0,-2000
2358,廷鑫            ,3000,5000,-2000,0,0,0,0,0,0,0,0,0,0,0,0,0,-2000
2397,友通            ,0,2000,-2000,0,0,0,0,0,0,0,0,0,0,0,0,0,-2000
2440,太空梭          ,0,0,0,0,0,0,0,0,0,-2000,0,2000,-2000,0,0,0,-2000
5608,四維航          ,1000,3000,-2000,0,0,0,0,0,0,0,0,0,0,0,0,0,-2000
5538,東明-KY         ,0,0,0,0,0,0,0,2000,-2000,0,0,0,0,0,0,0,-2000
3432,台端            ,0,2000,-2000,0,0,0,0,0,0,0,0,0,0,0,0,0,-2000
4807,日成-KY         ,0,2000,-2000,0,0,0,0,0,0,0,0,0,0,0,0,0,-2000
06444P,大立光凱基98售08,0,0,0,0,0,0,0,0,0,-2000,0,0,0,101000,103000,-2000,-2000
06551P,貿聯元大98售05  ,0,0,0,0,0,0,0,0,0,-2000,0,0,0,0,2000,-2000,-2000
06527P,T50正2富邦9C售01,0,0,0,0,0,0,0,0,0,-2000,0,0,0,0,2000,-2000,-2000
1232,大統益          ,3000,5000,-2000,0,0,0,0,0,0,0,0,0,0,0,0,0,-2000
1312A,國喬特          ,0,0,0,0,0,0,0,0,0,-2000,0,2000,-2000,0,0,0,-2000
06644P,亞德客元大98售03,0,0,0,0,0,0,0,0,0,-2000,0,0,0,0,2000,-2000,-2000
2032,新鋼            ,0,2000,-2000,0,0,0,0,0,0,0,0,0,0,0,0,0,-2000
2069,運錩            ,0,2000,-2000,0,0,0,0,0,0,0,0,0,0,0,0,0,-2000
1721,三晃            ,0,2000,-2000,0,0,0,0,0,0,0,0,0,0,0,0,0,-2000
1733,五鼎            ,9000,14000,-5000,0,0,0,0,0,0,3000,3000,0,3000,0,0,0,-2000
056078,勤誠元大97購01  ,0,0,0,0,0,0,0,0,0,-3000,0,0,0,4000,7000,-3000,-3000
056238,聯發科群益98購02,0,0,0,0,0,0,0,0,0,-3000,0,0,0,38000,41000,-3000,-3000
056437,台積電凱基98購11,0,0,0,0,0,0,0,0,0,-3000,0,0,0,0,3000,-3000,-3000
056449,義隆凱基98購03  ,0,0,0,0,0,0,0,0,0,-3000,0,0,0,0,3000,-3000,-3000
05544P,台表科元富96售01,0,0,0,0,0,0,0,0,0,-3000,0,0,0,12000,15000,-3000,-3000
055915,大立光凱基98購07,0,0,0,0,0,0,0,0,0,-3000,0,0,0,0,3000,-3000,-3000
055822,臺股指國票97購09,0,0,0,0,0,0,0,0,0,-3000,0,0,0,0,3000,-3000,-3000
055717,聯發科元大97購19,0,0,0,0,0,0,0,0,0,-3000,0,0,0,21000,24000,-3000,-3000
055771,台積電日盛97購04,0,0,0,0,0,0,0,0,0,-3000,0,0,0,0,3000,-3000,-3000
056941,台郡元富9B購01  ,0,0,0,0,0,0,0,0,0,-3000,0,0,0,24000,27000,-3000,-3000
057080,華新科統一99購02,0,0,0,0,0,0,0,0,0,-3000,0,0,0,52000,55000,-3000,-3000
056577,玉晶光元大99購06,0,0,0,0,0,0,0,0,0,-3000,0,0,0,1000,4000,-3000,-3000
056863,義隆群益98購01  ,0,0,0,0,0,0,0,0,0,-3000,0,0,0,16000,19000,-3000,-3000
056826,A50正2富邦9B購02,0,0,0,0,0,0,0,0,0,-3000,0,0,0,0,3000,-3000,-3000
057276,全新元大99購03  ,0,0,0,0,0,0,0,0,0,-3000,0,0,0,0,3000,-3000,-3000
05894P,友達群益98售02  ,0,0,0,0,0,0,0,0,0,-3000,0,0,0,7000,10000,-3000,-3000
06083P,華通統一98售02  ,0,0,0,0,0,0,0,0,0,-3000,0,0,0,6000,9000,-3000,-3000
048814,上銀凱基94購01  ,0,0,0,0,0,0,0,0,0,-3000,0,0,0,3000,6000,-3000,-3000
047206,元金2X國泰94購01,0,0,0,0,0,0,0,0,0,-3000,0,0,0,2000,5000,-3000,-3000
048644,華固元大93購01  ,0,0,0,0,0,0,0,0,0,-3000,0,0,0,0,3000,-3000,-3000
050405,新光金麥證94購01,0,0,0,0,3000,-3000,0,0,0,-3000,0,0,0,0,3000,-3000,-3000
047734,欣興兆豐94購02  ,0,0,0,0,0,0,0,0,0,-3000,0,0,0,0,3000,-3000,-3000
048532,大立光國票93購06,0,0,0,0,0,0,0,0,0,-3000,0,0,0,0,3000,-3000,-3000
046627,高鐵統一95購01  ,0,0,0,0,0,0,0,0,0,-3000,0,0,0,0,3000,-3000,-3000
048269,瀚宇博國泰95購01,0,0,0,0,0,0,0,0,0,-3000,0,0,0,400000,403000,-3000,-3000
045252,國巨凱基93購03  ,0,0,0,0,0,0,0,0,0,-3000,0,0,0,0,3000,-3000,-3000
047864,信邦康和93購01  ,0,0,0,0,0,0,0,0,0,-3000,0,0,0,0,3000,-3000,-3000
044861,玉晶光兆豐93購01,0,0,0,0,0,0,0,0,0,-3000,0,0,0,0,3000,-3000,-3000
045837,群創群益98購02  ,0,0,0,0,0,0,0,0,0,-3000,0,0,0,0,3000,-3000,-3000
046178,聯發科日盛92購01,0,0,0,0,0,0,0,0,0,-3000,0,0,0,0,3000,-3000,-3000
03939P,康控元大95售02  ,0,0,0,0,0,0,0,0,0,-3000,0,0,0,0,3000,-3000,-3000
03118P,台積電國票01售07,0,0,0,0,0,0,0,0,0,-3000,0,0,0,0,3000,-3000,-3000
006203,元大MSCI台灣    ,0,0,0,0,0,0,0,0,0,-3000,0,0,0,0,3000,-3000,-3000
00660,元大歐洲50      ,0,0,0,0,0,0,0,0,0,-3000,0,0,0,1000,4000,-3000,-3000
020011,統一微波高息20N ,0,0,0,0,0,0,0,0,0,-3000,0,0,0,396000,399000,-3000,-3000
00735,國泰臺韓科技    ,10000,0,10000,0,0,0,0,0,0,-13000,0,0,0,137000,150000,-13000,-3000
051532,潤泰全國票96購01,0,0,0,0,0,0,0,0,0,-3000,0,0,0,0,3000,-3000,-3000
051156,鴻海富邦97購01  ,0,0,0,0,0,0,0,0,0,-3000,0,0,0,0,3000,-3000,-3000
051142,臺股指永豐95購02,0,0,0,0,0,0,0,0,0,-3000,0,0,0,0,3000,-3000,-3000
050248,臻鼎凱基94購03  ,0,0,0,0,0,0,0,0,0,-3000,0,0,0,106000,109000,-3000,-3000
050732,台虹國票94購01  ,0,0,0,0,0,0,0,0,0,-3000,0,0,0,168000,171000,-3000,-3000
04944P,元油2X永豐94售06,0,0,0,0,0,0,0,0,0,-3000,0,0,0,13000,16000,-3000,-3000
049896,聯發科統一94購06,0,0,0,0,0,0,0,0,0,-3000,0,0,0,52000,55000,-3000,-3000
05107P,鴻海兆豐96售02  ,0,0,0,0,0,0,0,0,0,-3000,0,0,0,7000,10000,-3000,-3000
051069,智邦國票96購01  ,0,0,0,0,0,0,0,0,0,-3000,0,0,0,26000,29000,-3000,-3000
052445,南亞科元大95購05,0,0,0,0,0,0,0,0,0,-3000,0,0,0,2000,5000,-3000,-3000
052416,滬深2X兆豐96購02,0,0,0,0,0,0,0,0,0,-3000,0,0,0,5000,8000,-3000,-3000
049544,台積電群益94購08,0,0,0,0,0,0,0,0,0,-3000,0,0,0,12000,15000,-3000,-3000
050887,台積電富邦95購05,0,0,0,0,0,0,0,0,0,-3000,0,0,0,0,3000,-3000,-3000
048900,精成科國泰95購01,0,0,0,0,0,0,0,0,0,-3000,0,0,0,0,3000,-3000,-3000
04885P,大立光凱基94售19,0,0,0,0,0,0,0,0,0,-3000,0,0,0,2000,5000,-3000,-3000
048839,牧德凱基95購01  ,0,0,0,0,0,0,0,0,0,-3000,0,0,0,43000,46000,-3000,-3000
054990,凌陽元富97購01  ,0,0,0,0,0,0,0,0,0,-3000,0,0,0,7000,10000,-3000,-3000
055113,大立光凱基98購06,0,0,0,0,0,0,0,0,0,-3000,0,0,0,60000,63000,-3000,-3000
05412P,泰碩國票95售02  ,0,0,0,0,0,0,0,0,0,-3000,0,0,0,0,3000,-3000,-3000
054287,台積電元大97購11,0,0,0,0,0,0,0,0,0,-3000,0,0,0,97000,100000,-3000,-3000
054551,聯發科凱基98購02,0,0,0,0,0,0,0,0,0,-3000,0,0,0,168000,171000,-3000,-3000
054527,國巨統一97購03  ,0,0,0,0,0,0,0,0,0,-3000,0,0,0,12000,15000,-3000,-3000
054603,智易台新98購01  ,0,0,0,0,0,0,0,0,0,-3000,0,0,0,0,3000,-3000,-3000
052943,奇力新國票96購02,0,0,0,0,0,0,0,0,0,-3000,0,0,0,13000,16000,-3000,-3000
052818,智邦永豐96購01  ,0,0,0,0,0,0,0,0,0,-3000,0,0,0,132000,135000,-3000,-3000
052975,嘉聯益群益96購01,0,0,0,0,0,0,0,0,0,-3000,0,0,0,52000,55000,-3000,-3000
053530,聯發科康和96購01,0,0,0,0,0,0,0,0,0,-3000,0,0,0,0,3000,-3000,-3000
053974,大立光元大96購10,0,0,0,0,0,0,0,0,0,-3000,0,0,0,0,3000,-3000,-3000
053752,超眾永豐96購02  ,0,0,0,0,0,0,0,0,0,-3000,0,0,0,57000,60000,-3000,-3000
053797,台積電中信98購01,0,0,0,0,0,0,0,0,0,-3000,0,0,0,0,3000,-3000,-3000
053668,鴻海統一97購01  ,0,0,0,0,0,0,0,0,0,-3000,0,0,0,55000,58000,-3000,-3000
053669,台積電統一96購08,0,0,0,0,0,0,0,0,0,-3000,0,0,0,122000,125000,-3000,-3000
053714,南亞科凱基96購03,0,0,0,0,0,0,0,0,0,-3000,0,0,0,0,3000,-3000,-3000
2028,威致            ,0,2000,-2000,0,0,0,0,0,0,-1000,0,1000,-1000,0,0,0,-3000
1906,寶隆            ,0,3000,-3000,0,0,0,0,0,0,0,0,0,0,0,0,0,-3000
1503,士電            ,6000,9000,-3000,0,0,0,0,0,0,0,0,0,0,0,0,0,-3000
06481P,台積電凱基98售12,0,0,0,0,0,0,0,0,0,-3000,0,0,0,102000,105000,-3000,-3000
06332P,世紀鋼群益98售01,0,0,0,0,0,0,0,0,0,-3000,0,0,0,0,3000,-3000,-3000
06279P,臺股指凱基97售11,0,0,0,0,0,0,0,0,0,-3000,0,0,0,7000,10000,-3000,-3000
06288P,臺股指國票97售02,0,0,0,0,0,0,0,0,0,-3000,0,0,0,0,3000,-3000,-3000
4148,全宇生技-KY     ,0,3000,-3000,0,0,0,0,0,0,0,0,0,0,0,0,0,-3000
3550,聯穎            ,0,3000,-3000,0,0,0,0,0,0,0,0,0,0,0,0,0,-3000
3593,力銘            ,0,3000,-3000,0,0,0,0,0,0,0,0,0,0,0,0,0,-3000
3164,景岳            ,2000,2000,0,0,0,0,0,0,0,-3000,3000,6000,-3000,0,0,0,-3000
3057,喬鼎            ,0,3000,-3000,0,0,0,0,0,0,0,0,0,0,0,0,0,-3000
6216,居易            ,0,3000,-3000,0,0,0,0,0,0,0,0,0,0,0,0,0,-3000
2374,佳能            ,6000,10000,-4000,0,0,0,0,0,0,1000,1000,0,1000,0,0,0,-3000
2611,志信            ,1000,4000,-3000,0,0,0,0,0,0,0,0,0,0,0,0,0,-3000
2597,潤弘            ,3000,5000,-2000,0,0,0,0,0,0,-1000,0,1000,-1000,0,0,0,-3000
3032,偉訓            ,1000,4000,-3000,0,0,0,0,0,0,0,0,0,0,0,0,0,-3000
8466,美吉吉-KY       ,1000,4000,-3000,0,0,0,0,0,0,0,0,0,0,0,0,0,-3000
06050P,玉晶光國票98售01,0,0,0,0,0,0,0,0,0,-4000,0,0,0,6000,10000,-4000,-4000
05952P,台積電國票97售06,0,0,0,0,0,0,0,0,0,-4000,0,0,0,70000,74000,-4000,-4000
05974P,國巨富邦97售03  ,0,0,0,0,0,0,0,0,0,-4000,0,0,0,1000,5000,-4000,-4000
057293,力成國泰99購01  ,0,0,0,0,0,0,0,0,0,-4000,0,0,0,0,4000,-4000,-4000
057329,緯穎群益98購02  ,0,0,0,0,0,0,0,0,0,-4000,0,0,0,89000,93000,-4000,-4000
057403,亞光群益98購04  ,0,0,0,0,0,0,0,0,0,-4000,0,0,0,35000,39000,-4000,-4000
057438,禾伸堂國票99購01,0,0,0,0,0,0,0,0,0,-4000,0,0,0,0,4000,-4000,-4000
057433,上銀國票98購04  ,0,0,0,0,0,0,0,0,0,-4000,0,0,0,0,4000,-4000,-4000
057034,道瓊反元大9B購01,0,0,0,0,0,0,0,0,0,-4000,0,0,0,0,4000,-4000,-4000
057020,台積電凱基99購02,0,0,0,0,0,0,0,0,0,-4000,0,0,0,0,4000,-4000,-4000
055644,致茂元富97購01  ,0,0,0,0,0,0,0,0,0,-4000,0,0,0,65000,69000,-4000,-4000
055804,祥碩永豐97購02  ,0,0,0,0,0,0,0,0,0,-4000,0,0,0,14000,18000,-4000,-4000
056400,道瓊反群益9C購01,0,0,0,0,0,0,0,0,0,-4000,0,0,0,0,4000,-4000,-4000
056533,友達凱基9A購02  ,0,0,0,0,0,0,0,0,0,-4000,0,0,0,0,4000,-4000,-4000
056375,玉晶光統一01購01,0,0,0,0,0,0,0,0,0,-4000,0,0,0,0,4000,-4000,-4000
00689R,國泰20年美債反1 ,0,0,0,0,0,0,0,0,0,-4000,0,0,0,100000,104000,-4000,-4000
042387,台積電永昌93購02,0,0,0,0,0,0,0,0,0,-4000,0,0,0,0,4000,-4000,-4000
03656C,臺股指凱基99牛12,0,0,0,0,0,0,0,0,0,-4000,0,0,0,0,4000,-4000,-4000
04347P,全新群益94售01  ,0,0,0,0,0,0,0,0,0,-4000,0,0,0,0,4000,-4000,-4000
04310P,京元電統一93售03,0,0,0,0,0,0,0,0,0,-4000,0,0,0,6000,10000,-4000,-4000
045797,健策中信93購01  ,0,0,0,0,0,0,0,0,0,-4000,0,0,0,16000,20000,-4000,-4000
045996,南電富邦94購01  ,0,0,0,0,0,0,0,0,0,-4000,0,0,0,5000,9000,-4000,-4000
044820,臻鼎兆豐93購02  ,0,0,0,0,0,0,0,0,0,-4000,0,0,0,9000,13000,-4000,-4000
047869,景碩永豐93購01  ,0,0,0,0,0,0,0,0,0,-4000,0,0,0,0,4000,-4000,-4000
046725,可成元大93購02  ,0,0,0,0,0,0,0,0,0,-4000,0,0,0,10000,14000,-4000,-4000
048522,A50正2元富95購02,0,0,0,0,0,0,0,0,0,-4000,0,0,0,0,4000,-4000,-4000
048460,盛群凱基94購01  ,0,0,0,0,0,0,0,0,0,-4000,0,0,0,25000,29000,-4000,-4000
047380,統一元大93購01  ,0,0,0,0,0,0,0,0,0,-4000,0,0,0,96000,100000,-4000,-4000
049241,智邦元富94購01  ,0,0,0,0,0,0,0,0,0,-4000,0,0,0,1000,5000,-4000,-4000
051821,京元電元富95購04,0,0,0,0,0,0,0,0,0,-4000,0,0,0,0,4000,-4000,-4000
051886,道瓊反統一95購03,0,0,0,0,0,0,0,0,0,-4000,0,0,0,0,4000,-4000,-4000
04864P,欣興元大94售10  ,0,0,0,0,0,0,0,0,0,-4000,0,0,0,5000,9000,-4000,-4000
05002P,台積電統一95售03,0,0,0,0,0,0,0,0,0,-4000,0,0,0,10000,14000,-4000,-4000
048847,A50群益98購01   ,0,0,0,0,0,0,0,0,0,-4000,0,0,0,301000,305000,-4000,-4000
048995,宏全元大94購01  ,0,0,0,0,0,0,0,0,0,-4000,0,0,0,2000,6000,-4000,-4000
049668,大立光國泰96購02,0,0,0,0,0,0,0,0,0,-4000,0,0,0,148000,152000,-4000,-4000
049684,彩晶統一95購01  ,0,0,0,0,0,0,0,0,0,-4000,0,0,0,0,4000,-4000,-4000
052388,旺宏群益96購05  ,0,0,0,0,0,0,0,0,0,-4000,0,0,0,11000,15000,-4000,-4000
052467,嘉聯益統一96購01,0,0,0,0,0,0,0,0,0,-4000,0,0,0,44000,48000,-4000,-4000
052162,智伸科永豐95購01,0,0,0,0,0,0,0,0,0,-4000,0,0,0,0,4000,-4000,-4000
050174,技嘉元大94購01  ,0,0,0,0,0,0,0,0,0,-4000,0,0,0,0,4000,-4000,-4000
051272,嘉晶群益95購01  ,0,0,0,0,0,0,0,0,0,-4000,0,0,0,355000,359000,-4000,-4000
05204P,TPK元大95售03   ,0,0,0,0,0,0,0,0,0,-4000,0,0,0,0,4000,-4000,-4000
050502,聯發科凱基94購21,0,0,0,0,0,0,0,0,0,-4000,0,0,0,136000,140000,-4000,-4000
053825,南電群益96購02  ,0,0,0,0,0,0,0,0,0,-4000,0,0,0,4000,8000,-4000,-4000
053503,臻鼎兆豐97購01  ,0,0,0,0,0,0,0,0,0,-4000,0,0,0,0,4000,-4000,-4000
053456,大立光元富96購04,0,0,0,0,0,0,0,0,0,-4000,0,0,0,9000,13000,-4000,-4000
053084,國巨元大98購01  ,0,0,0,0,0,0,0,0,0,-4000,0,0,0,2000,6000,-4000,-4000
052870,玉晶光凱基96購03,0,0,0,0,0,0,0,0,0,-4000,0,0,0,23000,27000,-4000,-4000
054631,台郡凱基98購02  ,0,0,0,0,0,0,0,0,0,-4000,0,0,0,11000,15000,-4000,-4000
054413,台光電元大96購03,0,0,0,0,0,0,0,0,0,-4000,0,0,0,4000,8000,-4000,-4000
054328,台化康和96購01  ,0,0,0,0,0,0,0,0,0,-4000,0,0,0,0,4000,-4000,-4000
054209,台積電國票97購08,0,0,0,0,0,0,0,0,0,-4000,0,0,0,108000,112000,-4000,-4000
05416P,喬山永豐95售04  ,0,0,0,0,0,0,0,0,0,-4000,0,0,0,6000,10000,-4000,-4000
054084,旺宏統一97購05  ,0,0,0,0,0,0,0,0,0,-4000,0,0,0,0,4000,-4000,-4000
055043,中砂永豐97購01  ,0,0,0,0,0,0,0,0,0,-4000,0,0,0,0,4000,-4000,-4000
05526P,茂林群益96售03  ,0,0,0,0,0,0,0,0,0,-4000,0,0,0,2000,6000,-4000,-4000
054976,上証2X元富9A購01,0,0,0,0,0,0,0,0,0,-4000,0,0,0,0,4000,-4000,-4000
054951,大毅元大97購01  ,0,0,0,0,0,0,0,0,0,-4000,0,0,0,239000,243000,-4000,-4000
054918,華新科凱基98購02,0,0,0,0,0,0,0,0,0,-4000,0,0,0,30000,34000,-4000,-4000
2617,台航            ,20000,26000,-6000,0,0,0,0,0,0,2000,2000,0,2000,0,0,0,-4000
2450,神腦            ,3000,7000,-4000,0,0,0,0,0,0,0,0,0,0,0,0,0,-4000
2466,冠西電          ,2000,6000,-4000,0,0,0,0,0,0,0,0,0,0,0,0,0,-4000
2402,毅嘉            ,36000,44000,-8000,0,0,0,0,0,0,4000,4000,0,4000,0,0,0,-4000
5515,建國            ,2000,6000,-4000,0,0,0,0,0,0,0,0,0,0,0,0,0,-4000
5288,豐祥-KY         ,4000,8000,-4000,0,0,0,0,0,0,0,0,0,0,0,0,0,-4000
4755,三福化          ,0,3000,-3000,0,0,0,0,0,0,-1000,0,1000,-1000,0,0,0,-4000
06282P,聯鈞永豐97售02  ,0,0,0,0,0,0,0,0,0,-4000,0,0,0,0,4000,-4000,-4000
06535P,可成群益99售02  ,0,0,0,0,0,0,0,0,0,-4000,0,0,0,76000,80000,-4000,-4000
2010,春源            ,0,4000,-4000,0,0,0,0,0,0,0,0,0,0,0,0,0,-4000
2015,豐興            ,30000,34000,-4000,0,0,0,0,0,0,0,0,0,0,0,0,0,-4000
056309,合勤控元大97購01,0,0,0,0,0,0,0,0,0,-5000,0,0,0,48000,53000,-5000,-5000
056420,台表科元富98購01,0,0,0,0,0,0,0,0,0,-5000,0,0,0,74000,79000,-5000,-5000
056452,亞光凱基98購02  ,0,0,0,0,0,0,0,0,0,-5000,0,0,0,54000,59000,-5000,-5000
056229,可成凱基97購04  ,0,0,0,0,0,0,0,0,0,-5000,0,0,0,77000,82000,-5000,-5000
056222,台積電凱基9A購01,0,0,0,0,0,0,0,0,0,-5000,0,0,0,45000,50000,-5000,-5000
056160,智易凱基97購03  ,0,0,0,0,0,0,0,0,0,-5000,0,0,0,0,5000,-5000,-5000
055824,臺股指國票97購11,0,0,0,0,0,0,0,0,0,-5000,0,0,0,0,5000,-5000,-5000
055643,宏碁元富97購01  ,0,0,0,0,0,0,0,0,0,-5000,0,0,0,0,5000,-5000,-5000
055376,群創元大01購01  ,0,0,0,0,0,0,0,0,0,-5000,0,0,0,492000,497000,-5000,-5000
055494,華新科元大98購01,0,0,0,0,0,0,0,0,0,-5000,0,0,0,73000,78000,-5000,-5000
055470,南亞科凱基97購01,0,0,0,0,0,0,0,0,0,-5000,0,0,0,20000,25000,-5000,-5000
055556,奇力新凱基98購03,0,0,0,0,0,0,0,0,0,-5000,0,0,0,0,5000,-5000,-5000
05696P,南亞科凱基96售01,0,0,0,0,0,0,0,0,0,-5000,0,0,0,0,5000,-5000,-5000
05705P,上証2X永豐96售03,0,0,0,0,0,0,0,0,0,-5000,0,0,0,10000,15000,-5000,-5000
052215,樺漢元大96購02  ,0,0,0,0,0,0,0,0,0,-5000,0,0,0,0,5000,-5000,-5000
056728,元油2X凱基9A購02,0,0,0,0,0,0,0,0,0,-5000,0,0,0,0,5000,-5000,-5000
056604,鴻海富邦9A購01  ,0,0,0,0,0,0,0,0,0,-5000,0,0,0,11000,16000,-5000,-5000
057398,台郡中信99購01  ,0,0,0,0,0,0,0,0,0,-5000,0,0,0,0,5000,-5000,-5000
057390,台表科永豐98購01,0,0,0,0,0,0,0,0,0,-5000,0,0,0,0,5000,-5000,-5000
057495,牧德元大99購04  ,0,0,0,0,0,0,0,0,0,-5000,0,0,0,43000,48000,-5000,-5000
05920P,力成元大96售04  ,0,0,0,0,0,0,0,0,0,-5000,0,0,0,2000,7000,-5000,-5000
05855P,滬深2X中信9C售01,0,0,0,0,0,0,0,0,0,-5000,0,0,0,0,5000,-5000,-5000
05841P,華通元大96售04  ,0,0,0,0,0,0,0,0,0,-5000,0,0,0,0,5000,-5000,-5000
047068,南電凱基93購04  ,0,0,0,0,0,0,0,0,0,-5000,0,0,0,0,5000,-5000,-5000
048747,華通元富97購01  ,0,0,0,0,0,0,0,0,0,-5000,0,0,0,0,5000,-5000,-5000
05038P,牧德元大95售03  ,0,0,0,0,0,0,0,0,0,-5000,0,0,0,0,5000,-5000,-5000
047567,欣興國票93購05  ,0,0,0,0,0,0,0,0,0,-5000,0,0,0,0,5000,-5000,-5000
048493,微星元大93購04  ,0,0,0,0,0,0,0,0,0,-5000,0,0,0,0,5000,-5000,-5000
048181,A50正2群益95購01,0,0,0,0,0,0,0,0,0,-5000,0,0,0,0,5000,-5000,-5000
048167,旺宏永豐93購04  ,0,0,0,0,0,0,0,0,0,-5000,0,0,0,0,5000,-5000,-5000
048063,聯發科統一93購03,0,0,0,0,0,0,0,0,0,-5000,0,0,0,0,5000,-5000,-5000
045189,大立光元富98購01,0,0,0,0,0,0,0,0,0,-5000,0,0,0,12000,17000,-5000,-5000
044898,旺宏凱基93購01  ,0,0,0,0,0,0,0,0,0,-5000,0,0,0,26000,31000,-5000,-5000
044717,旺宏統一94購01  ,0,0,0,0,0,0,0,0,0,-5000,0,0,0,210000,215000,-5000,-5000
04453P,聯發科富邦94售04,0,0,0,0,0,0,0,0,0,-5000,0,0,0,0,5000,-5000,-5000
043992,康控元大93購02  ,0,0,0,0,0,0,0,0,0,-5000,0,0,0,0,5000,-5000,-5000
04402P,TPK兆豐95售01   ,0,0,0,0,0,0,0,0,0,-5000,0,0,0,0,5000,-5000,-5000
043442,大立光台新01購01,0,0,0,0,0,0,0,0,0,-5000,0,0,0,0,5000,-5000,-5000
04563P,可成凱基94售05  ,0,0,0,0,0,0,0,0,0,-5000,0,0,0,17000,22000,-5000,-5000
04630P,嘉聯益元大95售02,0,0,0,0,0,0,0,0,0,-5000,0,0,0,15000,20000,-5000,-5000
035275,台積電台新97購01,0,0,0,0,0,0,0,0,0,-5000,0,0,0,0,5000,-5000,-5000
04607P,A50中信94售01   ,0,0,0,0,0,0,0,0,0,-5000,0,0,0,0,5000,-5000,-5000
042366,元油2X國票92購01,0,0,0,0,0,0,0,0,0,-5000,0,0,0,0,5000,-5000,-5000
03388P,元油2X元富98售02,0,0,0,0,0,0,0,0,0,-5000,0,0,0,0,5000,-5000,-5000
03399P,欣興中信02售03  ,0,0,0,0,0,0,0,0,0,-5000,0,0,0,40000,45000,-5000,-5000
03412P,滬深2X群益98售01,0,0,0,0,0,0,0,0,0,-5000,0,0,0,70000,75000,-5000,-5000
04275P,南亞科凱基93售08,0,0,0,0,0,0,0,0,0,-5000,0,0,0,10000,15000,-5000,-5000
04254P,亞德客國票93售03,0,0,0,0,0,0,0,0,0,-5000,0,0,0,0,5000,-5000,-5000
03006X,元展06          ,0,0,0,0,0,0,0,0,0,-5000,0,0,0,0,5000,-5000,-5000
04034P,技嘉群益93售03  ,0,0,0,0,0,0,0,0,0,-5000,0,0,0,0,5000,-5000,-5000
00712,FH富時不動產    ,124000,0,124000,0,0,0,0,0,0,-129000,0,0,0,41000,170000,-129000,-5000
0057,富邦摩台        ,0,0,0,0,0,0,0,0,0,-5000,0,0,0,20000,25000,-5000,-5000
051577,台積電元大97購03,0,0,0,0,0,0,0,0,0,-5000,0,0,0,147000,152000,-5000,-5000
049430,國巨國票95購02  ,0,0,0,0,0,0,0,0,0,-5000,0,0,0,0,5000,-5000,-5000
050130,華新科凱基94購09,0,0,0,0,0,0,0,0,0,-5000,0,0,0,15000,20000,-5000,-5000
050628,美律中信94購02  ,0,0,0,0,0,0,0,0,0,-5000,0,0,0,292000,297000,-5000,-5000
052072,健策統一95購02  ,0,0,0,0,0,0,0,0,0,-5000,0,0,0,30000,35000,-5000,-5000
050450,富邦金元大94購03,0,0,0,0,0,0,0,0,0,-5000,0,0,0,10000,15000,-5000,-5000
05125P,鴻海群益95售06  ,0,0,0,0,0,0,0,0,0,-5000,0,0,0,0,5000,-5000,-5000
050782,台積電國泰96購03,0,0,0,0,0,0,0,0,0,-5000,0,0,0,30000,35000,-5000,-5000
050253,百和國泰96購01  ,0,0,0,0,0,0,0,0,0,-5000,0,0,0,0,5000,-5000,-5000
05027P,南電群益95售01  ,0,0,0,0,0,0,0,0,0,-5000,0,0,0,0,5000,-5000,-5000
049486,旺宏元大94購08  ,0,0,0,0,0,0,0,0,0,-5000,0,0,0,56000,61000,-5000,-5000
051683,A50正2凱基97購01,0,0,0,0,0,0,0,0,0,-5000,0,0,0,0,5000,-5000,-5000
052155,百和台新95購01  ,0,0,0,0,0,0,0,0,0,-5000,0,0,0,0,5000,-5000,-5000
052138,易華電凱基97購01,0,0,0,0,0,0,0,0,0,-5000,0,0,0,0,5000,-5000,-5000
052193,國巨元富95購06  ,0,0,0,0,0,0,0,0,0,-5000,0,0,0,74000,79000,-5000,-5000
052383,臺股指元大95購29,0,0,0,0,0,0,0,0,0,-5000,0,0,0,0,5000,-5000,-5000
052367,聯茂國票96購02  ,0,0,0,0,0,0,0,0,0,-5000,0,0,0,60000,65000,-5000,-5000
052546,友達中信98購01  ,0,0,0,0,0,0,0,0,0,-5000,0,0,0,20000,25000,-5000,-5000
052510,聯發科凱基95購13,0,0,0,0,0,0,0,0,0,-5000,0,0,0,0,5000,-5000,-5000
052601,大成鋼元大96購01,0,0,0,0,0,0,0,0,0,-5000,0,0,0,165000,170000,-5000,-5000
050848,日月光國票95購01,0,0,0,0,0,0,0,0,0,-5000,0,0,0,290000,295000,-5000,-5000
049000,元油2X中信95購02,0,0,0,0,0,0,0,0,0,-5000,0,0,0,0,5000,-5000,-5000
049084,欣興凱基94購03  ,0,0,0,0,0,0,0,0,0,-5000,0,0,0,1000,6000,-5000,-5000
048860,玉晶光群益96購03,0,0,0,0,0,0,0,0,0,-5000,0,0,0,26000,31000,-5000,-5000
049946,智邦兆豐95購01  ,0,0,0,0,0,0,0,0,0,-5000,0,0,0,30000,35000,-5000,-5000
054979,南港元富97購01  ,0,0,0,0,0,0,0,0,0,-5000,0,0,0,50000,55000,-5000,-5000
054815,台積電元大97購14,0,0,0,0,0,0,0,0,0,-5000,0,0,0,10000,15000,-5000,-5000
054822,祥碩元大97購01  ,0,0,0,0,0,0,0,0,0,-5000,0,0,0,11000,16000,-5000,-5000
055297,啟碁元大97購01  ,0,0,0,0,0,0,0,0,0,-5000,0,0,0,3000,8000,-5000,-5000
05519P,上証2X凱基98售01,0,0,0,0,0,0,0,0,0,-5000,0,0,0,0,5000,-5000,-5000
055204,宏達電中信99購01,0,0,0,0,0,0,0,0,0,-5000,0,0,0,0,5000,-5000,-5000
055062,文曄永豐97購01  ,0,0,0,0,0,0,0,0,0,-5000,0,0,0,0,5000,-5000,-5000
055091,微星群益97購01  ,0,0,0,0,0,0,0,0,0,-5000,0,0,0,11000,16000,-5000,-5000
054098,嘉晶國票97購04  ,0,0,0,0,0,0,0,0,0,-5000,0,0,0,78000,83000,-5000,-5000
054119,燿華永豐96購05  ,0,0,0,0,0,0,0,0,0,-5000,0,0,0,0,5000,-5000,-5000
054126,和大元大96購02  ,0,0,0,0,0,0,0,0,0,-5000,0,0,0,100000,105000,-5000,-5000
054245,鴻海元大96購23  ,0,0,0,0,0,0,0,0,0,-5000,0,0,0,0,5000,-5000,-5000
054261,智伸科元大96購03,0,0,0,0,0,0,0,0,0,-5000,0,0,0,26000,31000,-5000,-5000
054511,香港反元大98購01,0,0,0,0,0,0,0,0,0,-5000,0,0,0,0,5000,-5000,-5000
054484,仁寶台新96購01  ,0,0,0,0,0,0,0,0,0,-5000,0,0,0,0,5000,-5000,-5000
054448,矽力兆豐96購01  ,0,0,0,0,0,0,0,0,0,-5000,0,0,0,10000,15000,-5000,-5000
054434,友達台新96購03  ,0,0,0,0,0,0,0,0,0,-5000,0,0,0,0,5000,-5000,-5000
052892,大成鋼群益96購01,0,0,0,0,0,0,0,0,0,-5000,0,0,0,0,5000,-5000,-5000
052243,致茂康和95購01  ,0,0,0,0,0,0,0,0,0,-5000,0,0,0,0,5000,-5000,-5000
052786,S&P500中信96購01,0,0,0,0,0,0,0,0,0,-5000,0,0,0,0,5000,-5000,-5000
053065,大立光群益96購01,0,0,0,0,0,0,0,0,0,-5000,0,0,0,10000,15000,-5000,-5000
053241,元油反國票9A購01,0,0,0,0,0,0,0,0,0,-5000,0,0,0,0,5000,-5000,-5000
053150,聯發科元大96購11,0,0,0,0,0,0,0,0,0,-5000,0,0,0,26000,31000,-5000,-5000
053212,友達凱基99購04  ,0,0,0,0,0,0,0,0,0,-5000,0,0,0,0,5000,-5000,-5000
053491,鴻海兆豐97購02  ,0,0,0,0,0,0,0,0,0,-5000,0,0,0,0,5000,-5000,-5000
053611,聯茂麥證96購01  ,0,0,0,20000,25000,-5000,0,0,0,-5000,0,0,0,20000,25000,-5000,-5000
053812,台積電群益96購09,0,0,0,0,0,0,0,0,0,-5000,0,0,0,98000,103000,-5000,-5000
053768,S&P反1元大99購01,0,0,0,0,0,0,0,0,0,-5000,0,0,0,0,5000,-5000,-5000
05371P,臺股指中信95售10,0,0,0,0,0,0,0,0,0,-5000,0,0,0,30000,35000,-5000,-5000
053693,欣興元大96購05  ,0,0,0,0,0,0,0,0,0,-5000,0,0,0,0,5000,-5000,-5000
053680,臺股指富邦96購01,0,0,0,0,0,0,0,0,0,-5000,0,0,0,1000,6000,-5000,-5000
053942,超眾國泰96購02  ,0,0,0,0,0,0,0,0,0,-5000,0,0,0,10000,15000,-5000,-5000
053922,亞光國票96購01  ,0,0,0,0,0,0,0,0,0,-5000,0,0,0,6000,11000,-5000,-5000
053848,聯發科元富96購03,0,0,0,0,0,0,0,0,0,-5000,0,0,0,0,5000,-5000,-5000
1730,花仙子          ,81000,86000,-5000,0,0,0,0,0,0,0,1000,1000,0,0,0,0,-5000
1441,大東            ,2000,7000,-5000,0,0,0,0,0,0,0,0,0,0,0,0,0,-5000
06660P,大立光富邦9B售03,0,0,0,0,0,0,0,0,0,-5000,0,0,0,10000,15000,-5000,-5000
1323,永裕            ,0,5000,-5000,0,0,0,0,0,0,0,0,0,0,0,0,0,-5000
1337,再生-KY         ,2000,7000,-5000,0,0,0,0,0,0,0,0,0,0,0,0,0,-5000
06584P,欣興凱基98售03  ,0,0,0,0,0,0,0,0,0,-5000,0,0,0,5000,10000,-5000,-5000
06519P,元油2X元大98售03,0,0,0,0,0,0,0,0,0,-5000,0,0,0,0,5000,-5000,-5000
06311P,嘉聯益元富97售02,0,0,0,0,0,0,0,0,0,-5000,0,0,0,1000,6000,-5000,-5000
06196P,元上證元大97售01,0,0,0,0,0,0,0,0,0,-5000,0,0,0,0,5000,-5000,-5000
4576,大銀微系統      ,1000,6000,-5000,0,0,0,0,0,0,0,0,0,0,0,0,0,-5000
2362,藍天            ,25000,32000,-7000,0,0,0,0,0,0,2000,2000,0,2000,0,0,0,-5000
06054P,臺股指中信9A售01,0,0,0,0,0,0,0,0,0,-6000,0,0,0,0,6000,-6000,-6000
05753P,臺股指中信99售02,0,0,0,0,0,0,0,0,0,-6000,0,0,0,44000,50000,-6000,-6000
05783P,嘉澤元富96售01  ,0,0,0,0,0,0,0,0,0,-6000,0,0,0,10000,16000,-6000,-6000
057393,台積電中信02購01,0,0,0,0,0,0,0,0,0,-6000,0,0,0,0,6000,-6000,-6000
057273,智邦元大98購05  ,0,0,0,0,0,0,0,0,0,-6000,0,0,0,79000,85000,-6000,-6000
057233,聯發科凱基98購14,0,0,0,0,0,0,0,0,0,-6000,0,0,0,95000,101000,-6000,-6000
056835,聯電元富99購01  ,0,0,0,0,0,0,0,0,0,-6000,0,0,0,14000,20000,-6000,-6000
057132,華新科凱基98購05,0,0,0,0,0,0,0,0,0,-6000,0,0,0,10000,16000,-6000,-6000
055647,義隆元富97購01  ,0,0,0,0,0,0,0,0,0,-6000,0,0,0,0,6000,-6000,-6000
055681,奇鋐凱基98購03  ,0,0,0,0,0,0,0,0,0,-6000,0,0,0,58000,64000,-6000,-6000
055764,臺股指群益97購02,0,0,0,0,0,0,0,0,0,-6000,0,0,0,72000,78000,-6000,-6000
055711,上銀元大97購04  ,0,0,0,0,0,0,0,0,0,-6000,0,0,0,154000,160000,-6000,-6000
056037,美律凱基98購03  ,0,0,0,0,0,0,0,0,0,-6000,0,0,0,0,6000,-6000,-6000
00688L,國泰20年美債正2 ,0,0,0,0,0,0,0,0,0,-6000,0,0,0,113000,119000,-6000,-6000
04264P,宏碁統一93售01  ,0,0,0,0,0,0,0,0,0,-6000,0,0,0,0,6000,-6000,-6000
03351P,台積電麥證02售07,0,0,0,0,0,0,0,0,0,-6000,0,0,0,0,6000,-6000,-6000
04082P,智邦統一93售03  ,0,0,0,0,0,0,0,0,0,-6000,0,0,0,0,6000,-6000,-6000
03444P,道瓊銀群益02售04,0,0,0,0,0,0,0,0,0,-6000,0,0,0,6000,12000,-6000,-6000
04287P,A50正2中信96售01,0,0,0,0,0,0,0,0,0,-6000,0,0,0,25000,31000,-6000,-6000
04312P,聯茂統一93售02  ,0,0,0,0,0,0,0,0,0,-6000,0,0,0,0,6000,-6000,-6000
044247,道瓊反元富97購01,0,0,0,0,0,0,0,0,0,-6000,0,0,0,3000,9000,-6000,-6000
04421P,玉晶光永豐94售02,0,0,0,0,0,0,0,0,0,-6000,0,0,0,0,6000,-6000,-6000
044531,欣興富邦93購01  ,0,0,0,0,0,0,0,0,0,-6000,0,0,0,5000,11000,-6000,-6000
04500P,燿華統一94售01  ,0,0,0,0,0,0,0,0,0,-6000,0,0,0,0,6000,-6000,-6000
047768,大立光元大95購01,0,0,0,0,0,0,0,0,0,-6000,0,0,0,0,6000,-6000,-6000
046729,智伸科元大93購01,0,0,0,0,0,0,0,0,0,-6000,0,0,0,0,6000,-6000,-6000
047669,台表科永豐93購02,0,0,0,0,0,0,0,0,0,-6000,0,0,0,0,6000,-6000,-6000
047707,南亞科凱基93購03,0,0,0,0,0,0,0,0,0,-6000,0,0,0,0,6000,-6000,-6000
049214,台達電國票95購01,0,0,0,0,0,0,0,0,0,-6000,0,0,0,54000,60000,-6000,-6000
048722,台表科永豐94購01,0,0,0,0,0,0,0,0,0,-6000,0,0,0,0,6000,-6000,-6000
048561,可成元大93購13  ,0,0,0,0,0,0,0,0,0,-6000,0,0,0,70000,76000,-6000,-6000
047269,同欣電康和93購01,0,0,0,0,0,0,0,0,0,-6000,0,0,0,0,6000,-6000,-6000
049631,臺股指群益94購04,0,0,0,0,0,0,0,0,0,-6000,0,0,0,0,6000,-6000,-6000
050888,群創富邦95購01  ,0,0,0,0,0,0,0,0,0,-6000,0,0,0,10000,16000,-6000,-6000
05260P,和碩元富95售02  ,0,0,0,0,0,0,0,0,0,-6000,0,0,0,0,6000,-6000,-6000
052491,泰碩國票99購01  ,0,0,0,0,0,0,0,0,0,-6000,0,0,0,0,6000,-6000,-6000
052184,台光電群益95購03,0,0,0,0,0,0,0,0,0,-6000,0,0,0,88000,94000,-6000,-6000
049858,百和群益94購05  ,0,0,0,0,0,0,0,0,0,-6000,0,0,0,5000,11000,-6000,-6000
049124,可成元富94購02  ,0,0,0,0,0,0,0,0,0,-6000,0,0,0,0,6000,-6000,-6000
050681,南亞科元富94購01,0,0,0,0,0,0,0,0,0,-6000,0,0,0,55000,61000,-6000,-6000
050263,旺宏元大94購10  ,0,0,0,0,0,0,0,0,0,-6000,0,0,0,6000,12000,-6000,-6000
050328,臻鼎永豐94購03  ,0,0,0,0,0,0,0,0,0,-6000,0,0,0,0,6000,-6000,-6000
05121P,創意國泰96售01  ,0,0,0,0,0,0,0,0,0,-6000,0,0,0,112000,118000,-6000,-6000
050552,禾伸堂凱基94購05,0,0,0,0,0,0,0,0,0,-6000,0,0,0,117000,123000,-6000,-6000
053743,康控國票97購02  ,0,0,0,0,0,0,0,0,0,-6000,0,0,0,24000,30000,-6000,-6000
052728,上証2X國泰97購01,0,0,0,0,0,0,0,0,0,-6000,0,0,0,0,6000,-6000,-6000
054218,S&P反1統一98購02,0,0,0,0,0,0,0,0,0,-6000,0,0,0,0,6000,-6000,-6000
054034,景碩中信96購01  ,0,0,0,0,0,0,0,0,0,-6000,0,0,0,10000,16000,-6000,-6000
05509P,智邦元富96售02  ,0,0,0,0,0,0,0,0,0,-6000,0,0,0,40000,46000,-6000,-6000
054830,世芯國泰99購01  ,0,0,0,0,0,0,0,0,0,-6000,0,0,0,33000,39000,-6000,-6000
054854,台積電麥證97購01,0,0,0,0,6000,-6000,0,0,0,-6000,0,0,0,0,6000,-6000,-6000
2413,環科            ,2000,8000,-6000,0,0,0,0,0,0,0,0,0,0,0,0,0,-6000
2430,燦坤            ,0,6000,-6000,0,0,0,0,0,0,0,0,0,0,0,0,0,-6000
3023,信邦            ,94000,80000,14000,0,0,0,0,0,0,-20000,1000,16000,-15000,0,5000,-5000,-6000
4560,強信-KY         ,49000,55000,-6000,0,0,0,0,0,0,0,0,0,0,0,0,0,-6000
4956,光鋐            ,23000,29000,-6000,0,0,0,0,0,0,0,0,0,0,0,0,0,-6000
4930,燦星網          ,1000,7000,-6000,0,0,0,0,0,0,0,0,0,0,0,0,0,-6000
4960,誠美材          ,0,6000,-6000,0,0,0,0,0,0,0,0,0,0,0,0,0,-6000
3454,晶睿            ,6000,12000,-6000,0,0,0,0,0,0,0,0,0,0,0,0,0,-6000
3494,誠研            ,0,6000,-6000,0,0,0,0,0,0,0,0,0,0,0,0,0,-6000
6641,基士德-KY       ,0,6000,-6000,0,0,0,0,0,0,0,0,0,0,0,0,0,-6000
6666,羅麗芬-KY       ,1000,7000,-6000,0,0,0,0,0,0,0,0,0,0,0,0,0,-6000
06334P,臺股指群益9C售03,0,0,0,0,0,0,0,0,0,-6000,0,0,0,25000,31000,-6000,-6000
06682P,玉晶光元大99售08,0,0,0,0,0,0,0,0,0,-6000,0,0,0,0,6000,-6000,-6000
1618,合機            ,0,5000,-5000,0,0,0,0,0,0,-1000,0,1000,-1000,0,0,0,-6000
9919,康那香          ,0,6000,-6000,0,0,0,0,0,0,0,0,0,0,0,0,0,-6000
056020,義隆群益97購01  ,0,0,0,0,0,0,0,0,0,-7000,0,0,0,13000,20000,-7000,-7000
056406,建準國票99購01  ,0,0,0,0,0,0,0,0,0,-7000,0,0,0,0,7000,-7000,-7000
056474,華新科元大99購05,0,0,0,0,0,0,0,0,0,-7000,0,0,0,18000,25000,-7000,-7000
055787,聯茂凱基99購01  ,0,0,0,0,0,0,0,0,0,-7000,0,0,0,238000,245000,-7000,-7000
055551,致茂凱基98購01  ,0,0,0,0,0,0,0,0,0,-7000,0,0,0,10000,17000,-7000,-7000
055579,健策統一9A購01  ,0,0,0,0,0,0,0,0,0,-7000,0,0,0,86000,93000,-7000,-7000
055480,元上證元大97購02,0,0,0,0,0,0,0,0,0,-7000,0,0,0,3000,10000,-7000,-7000
056906,玉晶光元大9B購01,0,0,0,0,0,0,0,0,0,-7000,0,0,0,20000,27000,-7000,-7000
056842,全新元富98購01  ,0,0,0,0,0,0,0,0,0,-7000,0,0,0,0,7000,-7000,-7000
056856,華通群益9A購01  ,0,0,0,0,0,0,0,0,0,-7000,0,0,0,2000,9000,-7000,-7000
056834,華新元富99購01  ,0,0,0,0,0,0,0,0,0,-7000,0,0,0,0,7000,-7000,-7000
056772,欣興元大99購01  ,0,0,0,0,0,0,0,0,0,-7000,0,0,0,75000,82000,-7000,-7000
056633,鴻海永昌98購02  ,0,0,0,0,0,0,0,0,0,-7000,0,0,0,14000,21000,-7000,-7000
057244,鈺齊凱基99購01  ,0,0,0,0,0,0,0,0,0,-7000,0,0,0,0,7000,-7000,-7000
057292,國巨國泰9B購01  ,0,0,0,0,0,0,0,0,0,-7000,0,0,0,93000,100000,-7000,-7000
057440,台積電統一98購10,0,0,0,0,0,0,0,0,0,-7000,0,0,0,0,7000,-7000,-7000
05950P,台積電國票97售04,0,0,0,0,0,0,0,0,0,-7000,0,0,0,0,7000,-7000,-7000
047222,鴻海凱基94購04  ,0,0,0,0,0,0,0,0,0,-7000,0,0,0,10000,17000,-7000,-7000
048530,大立光國票93購04,0,0,0,0,0,0,0,0,0,-7000,0,0,0,0,7000,-7000,-7000
047763,旺宏元大94購04  ,0,0,0,0,0,0,0,0,0,-7000,0,0,0,20000,27000,-7000,-7000
048387,台達電國票94購01,0,0,0,0,0,0,0,0,0,-7000,0,0,0,3000,10000,-7000,-7000
048388,華通國票94購01  ,0,0,0,0,0,0,0,0,0,-7000,0,0,0,44000,51000,-7000,-7000
045074,華新科元大93購03,0,0,0,0,0,0,0,0,0,-7000,0,0,0,1000,8000,-7000,-7000
03644C,臺股指元大94牛28,0,0,0,0,0,0,0,0,0,-7000,0,0,0,3000,10000,-7000,-7000
04250P,嘉晶統一95售02  ,0,0,0,0,0,0,0,0,0,-7000,0,0,0,4000,11000,-7000,-7000
050541,智邦凱基94購04  ,0,0,0,0,0,0,0,0,0,-7000,0,0,0,600000,607000,-7000,-7000
050499,台達電凱基94購11,0,0,0,0,0,0,0,0,0,-7000,0,0,0,53000,60000,-7000,-7000
051214,大立光統一95購02,0,0,0,0,0,0,0,0,0,-7000,0,0,0,37000,44000,-7000,-7000
051321,建準國票96購01  ,0,0,0,0,0,0,0,0,0,-7000,0,0,0,10000,17000,-7000,-7000
051756,台積電元大97購04,0,0,0,0,0,0,0,0,0,-7000,0,0,0,395000,402000,-7000,-7000
053012,國巨統一96購03  ,0,0,0,0,0,0,0,0,0,-7000,0,0,0,213000,220000,-7000,-7000
049679,臺股指國票94購12,0,0,0,0,0,0,0,0,0,-7000,0,0,0,0,7000,-7000,-7000
050799,嘉聯益中信98購01,0,0,0,0,0,0,0,0,0,-7000,0,0,0,3000,10000,-7000,-7000
051378,奇力新群益95購01,0,0,0,0,0,0,0,0,0,-7000,0,0,0,16000,23000,-7000,-7000
049771,GIS元富94購02   ,0,0,0,0,0,0,0,0,0,-7000,0,0,0,2000,9000,-7000,-7000
051001,緯穎元大96購02  ,0,0,0,0,0,0,0,0,0,-7000,0,0,0,363000,370000,-7000,-7000
055082,台郡中信97購01  ,0,0,0,0,0,0,0,0,0,-7000,0,0,0,181000,188000,-7000,-7000
055233,康友國票98購01  ,0,0,0,0,0,0,0,0,0,-7000,0,0,0,18000,25000,-7000,-7000
054621,華新科兆豐98購01,0,0,0,0,0,0,0,0,0,-7000,0,0,0,107000,114000,-7000,-7000
054665,華通元富97購02  ,0,0,0,0,0,0,0,0,0,-7000,0,0,0,0,7000,-7000,-7000
054588,玉晶光國泰99購02,0,0,0,0,0,0,0,0,0,-7000,0,0,0,10000,17000,-7000,-7000
052773,大成鋼亞東97購01,0,0,0,0,0,0,0,0,0,-7000,0,0,0,0,7000,-7000,-7000
052232,貿聯凱基96購02  ,0,0,0,0,0,0,0,0,0,-7000,0,0,0,0,7000,-7000,-7000
052483,超眾群益95購03  ,0,0,0,0,0,0,0,0,0,-7000,0,0,0,41000,48000,-7000,-7000
053072,國巨台新97購01  ,0,0,0,0,0,0,0,0,0,-7000,0,0,0,0,7000,-7000,-7000
053690,南亞科元大96購02,0,0,0,0,0,0,0,0,0,-7000,0,0,0,57000,64000,-7000,-7000
053673,超眾元富96購03  ,0,0,0,0,0,0,0,0,0,-7000,0,0,0,0,7000,-7000,-7000
053908,貿聯凱基98購01  ,0,0,0,0,0,0,0,0,0,-7000,0,0,0,10000,17000,-7000,-7000
9925,新保            ,1000,8000,-7000,0,0,0,0,0,0,0,0,0,0,0,0,0,-7000
1531,高林股          ,0,7000,-7000,0,0,0,0,0,0,0,0,0,0,0,0,0,-7000
1786,科妍            ,11000,21000,-10000,0,0,0,0,0,0,3000,3000,0,3000,0,0,0,-7000
06331P,南亞科群益97售04,0,0,0,0,0,0,0,0,0,-7000,0,0,0,0,7000,-7000,-7000
06234P,亞德客元大97售02,0,0,0,0,0,0,0,0,0,-7000,0,0,0,311000,318000,-7000,-7000
06403P,鴻海元富97售15  ,0,0,0,0,0,0,0,0,0,-7000,0,0,0,15000,22000,-7000,-7000
6592,和潤企業        ,109000,116000,-7000,0,0,0,0,0,0,0,0,0,0,0,0,0,-7000
2838A,聯邦銀甲特      ,0,0,0,0,0,0,0,0,0,-7000,5000,12000,-7000,0,0,0,-7000
2109,華豐            ,2000,9000,-7000,0,0,0,0,0,0,0,0,0,0,0,0,0,-7000
06057P,大立光凱基98售01,0,0,0,0,0,0,0,0,0,-8000,0,0,0,50000,58000,-8000,-8000
057248,台積電統一98購08,0,0,0,0,0,0,0,0,0,-8000,0,0,0,0,8000,-8000,-8000
057224,和碩日盛9A購01  ,0,0,0,0,0,0,0,0,0,-8000,0,0,0,13000,21000,-8000,-8000
057194,南電元大98購01  ,0,0,0,0,0,0,0,0,0,-8000,0,0,0,8000,16000,-8000,-8000
056557,世紀鋼凱基98購02,0,0,0,0,0,0,0,0,0,-8000,0,0,0,132000,140000,-8000,-8000
056947,國巨統一9A購01  ,0,0,0,0,0,0,0,0,0,-8000,0,0,0,0,8000,-8000,-8000
055327,致新國票98購01  ,0,0,0,0,0,0,0,0,0,-8000,0,0,0,22000,30000,-8000,-8000
056468,鴻海元大98購07  ,0,0,0,0,0,0,0,0,0,-8000,0,0,0,16000,24000,-8000,-8000
056278,全新富邦98購02  ,0,0,0,0,0,0,0,0,0,-8000,0,0,0,2000,10000,-8000,-8000
05596P,可成統一96售01  ,0,0,0,0,0,0,0,0,0,-8000,0,0,0,70000,78000,-8000,-8000
056171,鴻海元富97購10  ,0,0,0,0,0,0,0,0,0,-8000,0,0,0,20000,28000,-8000,-8000
056100,楠梓電永豐97購02,0,0,0,0,0,0,0,0,0,-8000,0,0,0,243000,251000,-8000,-8000
056237,智邦群益97購02  ,0,0,0,0,0,0,0,0,0,-8000,0,0,0,70000,78000,-8000,-8000
04130P,台積電永豐93售03,0,0,0,0,0,0,0,0,0,-8000,0,0,0,0,8000,-8000,-8000
04314P,聯茂元富93售01  ,0,0,0,0,0,0,0,0,0,-8000,0,0,0,16000,24000,-8000,-8000
043324,緯穎統一93購01  ,0,0,0,0,0,0,0,0,0,-8000,0,0,0,0,8000,-8000,-8000
04499P,滬深2X統一94售03,0,0,0,0,0,0,0,0,0,-8000,0,0,0,0,8000,-8000,-8000
048192,華通元大96購01  ,0,0,0,0,0,0,0,0,0,-8000,0,0,0,9000,17000,-8000,-8000
047027,新光金元大95購01,0,0,0,0,0,0,0,0,0,-8000,0,0,0,2000,10000,-8000,-8000
048582,國泰金富邦93購01,0,0,0,0,0,0,0,0,0,-8000,0,0,0,0,8000,-8000,-8000
048810,玉晶光第一94購01,0,0,0,0,0,0,0,0,0,-8000,0,0,0,3000,11000,-8000,-8000
051433,中磊元富95購01  ,0,0,0,0,0,0,0,0,0,-8000,0,0,0,32000,40000,-8000,-8000
048998,玉晶光國票95購03,0,0,0,0,0,0,0,0,0,-8000,0,0,0,54000,62000,-8000,-8000
050802,康控群益95購01  ,0,0,0,0,0,0,0,0,0,-8000,0,0,0,72000,80000,-8000,-8000
049569,光磊統一94購02  ,0,0,0,0,0,0,0,0,0,-8000,0,0,0,28000,36000,-8000,-8000
049670,鈺齊國泰96購01  ,0,0,0,0,0,0,0,0,0,-8000,0,0,0,2000,10000,-8000,-8000
049587,美律元大95購01  ,0,0,0,0,0,0,0,0,0,-8000,0,0,0,109000,117000,-8000,-8000
050913,全新中信97購01  ,0,0,0,0,0,0,0,0,0,-8000,0,0,0,12000,20000,-8000,-8000
052109,可成元富95購01  ,0,0,0,0,0,0,0,0,0,-8000,0,0,0,0,8000,-8000,-8000
052149,電子類群益95購01,0,0,0,0,0,0,0,0,0,-8000,0,0,0,0,8000,-8000,-8000
052191,超眾群益96購01  ,0,0,0,0,0,0,0,0,0,-8000,0,0,0,11000,19000,-8000,-8000
052653,臺股指永豐97購01,0,0,0,0,0,0,0,0,0,-8000,0,0,0,60000,68000,-8000,-8000
051688,大立光凱基97購02,0,0,0,0,0,0,0,0,0,-8000,0,0,0,12000,20000,-8000,-8000
049473,光罩永豐94購03  ,0,0,0,0,0,0,0,0,0,-8000,0,0,0,0,8000,-8000,-8000
049382,牧德元大94購04  ,0,0,0,0,0,0,0,0,0,-8000,0,0,0,0,8000,-8000,-8000
051572,上銀元大95購01  ,0,0,0,0,0,0,0,0,0,-8000,0,0,0,238000,246000,-8000,-8000
050460,GIS元大95購03   ,0,0,0,0,0,0,0,0,0,-8000,0,0,0,77000,85000,-8000,-8000
053126,健策凱基97購02  ,0,0,0,0,0,0,0,0,0,-8000,0,0,0,52000,60000,-8000,-8000
052859,國巨凱基96購07  ,0,0,0,0,0,0,0,0,0,-8000,0,0,0,22000,30000,-8000,-8000
054424,大成鋼富邦97購02,0,0,0,0,0,0,0,0,0,-8000,0,0,0,0,8000,-8000,-8000
054386,鴻海統一98購03  ,0,0,0,0,0,0,0,0,0,-8000,0,0,0,30000,38000,-8000,-8000
054055,全新國票99購02  ,0,0,0,0,0,0,0,0,0,-8000,0,0,0,34000,42000,-8000,-8000
054056,華新科國票96購02,0,0,0,0,0,0,0,0,0,-8000,0,0,0,12000,20000,-8000,-8000
054313,麗豐凱基96購02  ,0,0,0,0,0,0,0,0,0,-8000,0,0,0,0,8000,-8000,-8000
054276,國巨群益96購07  ,0,0,0,0,0,0,0,0,0,-8000,0,0,0,2000,10000,-8000,-8000
2415,錩新            ,0,8000,-8000,0,0,0,0,0,0,0,0,0,0,0,0,0,-8000
2908,特力            ,7000,15000,-8000,0,0,0,0,0,0,0,0,0,0,0,0,0,-8000
6449,鈺邦            ,15000,24000,-9000,0,0,0,0,0,0,1000,1000,0,1000,0,0,0,-8000
5525,順天            ,1000,9000,-8000,0,0,0,0,0,0,0,0,0,0,0,0,0,-8000
3712,永崴投控        ,13000,22000,-9000,0,0,0,0,0,0,1000,1000,0,1000,0,0,0,-8000
4536,拓凱            ,2000,10000,-8000,0,0,0,0,0,0,0,0,0,0,0,0,0,-8000
06409P,康友元富97售03  ,0,0,0,0,0,0,0,0,0,-8000,0,0,0,0,8000,-8000,-8000
06494P,鴻海永昌98售03  ,0,0,0,0,0,0,0,0,0,-8000,0,0,0,0,8000,-8000,-8000
06202P,大立光元大98售06,0,0,0,0,0,0,0,0,0,-8000,0,0,0,124000,132000,-8000,-8000
06207P,聯發科凱基97售07,0,0,0,0,0,0,0,0,0,-8000,0,0,0,27000,35000,-8000,-8000
06346P,聯鈞元富97售02  ,0,0,0,0,0,0,0,0,0,-8000,0,0,0,5000,13000,-8000,-8000
06357P,臺股指永豐97售03,0,0,0,0,0,0,0,0,0,-8000,0,0,0,0,8000,-8000,-8000
1612,宏泰            ,0,8000,-8000,0,0,0,0,0,0,0,0,0,0,0,0,0,-8000
1598,岱宇            ,3000,11000,-8000,0,0,0,0,0,0,0,0,0,0,0,0,0,-8000
1466,聚隆            ,0,8000,-8000,0,0,0,0,0,0,0,0,0,0,0,0,0,-8000
1467,南緯            ,0,8000,-8000,0,0,0,0,0,0,0,0,0,0,0,0,0,-8000
08637P,台灣50中信96售03,0,0,0,0,0,0,0,0,0,-8000,0,0,0,891000,899000,-8000,-8000
8367,建新國際        ,0,8000,-8000,0,0,0,0,0,0,0,0,0,0,0,0,0,-8000
056241,緯創群益97購01  ,0,0,0,0,0,0,0,0,0,-9000,0,0,0,12000,21000,-9000,-9000
056414,國巨中信98購02  ,0,0,0,0,0,0,0,0,0,-9000,0,0,0,3000,12000,-9000,-9000
056518,美律國票99購01  ,0,0,0,0,0,0,0,0,0,-9000,0,0,0,10000,19000,-9000,-9000
055884,臺股指元富97購01,0,0,0,0,0,0,0,0,0,-9000,0,0,0,0,9000,-9000,-9000
055866,臺股指元大97購03,0,0,0,0,0,0,0,0,0,-9000,0,0,0,10000,19000,-9000,-9000
057021,台積電凱基9A購02,0,0,0,0,0,0,0,0,0,-9000,0,0,0,0,9000,-9000,-9000
056624,景碩永豐98購01  ,0,0,0,0,0,0,0,0,0,-9000,0,0,0,21000,30000,-9000,-9000
056823,智伸科永豐98購01,0,0,0,0,0,0,0,0,0,-9000,0,0,0,48000,57000,-9000,-9000
056794,上銀麥證98購01  ,0,0,0,21000,30000,-9000,0,0,0,-9000,0,0,0,21000,30000,-9000,-9000
057217,奇力新群益99購01,0,0,0,0,0,0,0,0,0,-9000,0,0,0,203000,212000,-9000,-9000
05904P,大立光統一96售07,0,0,0,0,0,0,0,0,0,-9000,0,0,0,0,9000,-9000,-9000
049170,亞德客凱基94購01,0,0,0,0,0,0,0,0,0,-9000,0,0,0,3000,12000,-9000,-9000
048766,禾伸堂凱基94購01,0,0,0,0,0,0,0,0,0,-9000,0,0,0,5000,14000,-9000,-9000
048777,瀚宇博凱基94購02,0,0,0,0,0,0,0,0,0,-9000,0,0,0,1000,10000,-9000,-9000
047107,上銀元大93購04  ,0,0,0,0,0,0,0,0,0,-9000,0,0,0,11000,20000,-9000,-9000
047040,台勝科群益93購01,0,0,0,0,0,0,0,0,0,-9000,0,0,0,1000,10000,-9000,-9000
047232,禾伸堂凱基93購02,0,0,0,0,0,0,0,0,0,-9000,0,0,0,11000,20000,-9000,-9000
047015,上銀元大93購03  ,0,0,0,0,0,0,0,0,0,-9000,0,0,0,11000,20000,-9000,-9000
048107,華通群益93購02  ,0,0,0,0,0,0,0,0,0,-9000,0,0,0,11000,20000,-9000,-9000
048484,大立光國泰95購02,0,0,0,0,0,0,0,0,0,-9000,0,0,0,21000,30000,-9000,-9000
047714,禾伸堂凱基93購03,0,0,0,0,0,0,0,0,0,-9000,0,0,0,2000,11000,-9000,-9000
04768P,大立光國泰96售03,0,0,0,0,0,0,0,0,0,-9000,0,0,0,178000,187000,-9000,-9000
045975,祥碩凱基93購04  ,0,0,0,0,0,0,0,0,0,-9000,0,0,0,6000,15000,-9000,-9000
046579,台積電元大92購32,0,0,0,0,0,0,0,0,0,-9000,0,0,0,0,9000,-9000,-9000
04253P,聯發科元富93售01,0,0,0,0,0,0,0,0,0,-9000,0,0,0,1000,10000,-9000,-9000
03177P,國巨群益01售12  ,0,0,0,0,0,0,0,0,0,-9000,0,0,0,51000,60000,-9000,-9000
00731,FH富時高息低波  ,0,0,0,0,0,0,0,0,0,-9000,0,0,0,212000,221000,-9000,-9000
049310,台積電凱基94購15,0,0,0,0,0,0,0,0,0,-9000,0,0,0,0,9000,-9000,-9000
052054,台表科凱基96購01,0,0,0,0,0,0,0,0,0,-9000,0,0,0,0,9000,-9000,-9000
049367,全新元大96購01  ,0,0,0,0,0,0,0,0,0,-9000,0,0,0,1000,10000,-9000,-9000
050056,國巨凱基94購04  ,0,0,0,0,0,0,0,0,0,-9000,0,0,0,1000,10000,-9000,-9000
050177,聯發科元大94購11,0,0,0,0,0,0,0,0,0,-9000,0,0,0,58000,67000,-9000,-9000
049735,台光電群益94購03,0,0,0,0,0,0,0,0,0,-9000,0,0,0,53000,62000,-9000,-9000
049618,美律群益94購03  ,0,0,0,0,0,0,0,0,0,-9000,0,0,0,25000,34000,-9000,-9000
054270,寶滬深中信98購01,0,0,0,0,0,0,0,0,0,-9000,0,0,0,1000,10000,-9000,-9000
054419,嘉聯益元大98購02,0,0,0,0,0,0,0,0,0,-9000,0,0,0,53000,62000,-9000,-9000
054461,台積電凱基97購09,0,0,0,0,0,0,0,0,0,-9000,0,0,0,50000,59000,-9000,-9000
054827,宏全元大9A購01  ,0,0,0,0,0,0,0,0,0,-9000,0,0,0,1000,10000,-9000,-9000
054919,興富發凱基97購01,0,0,0,0,0,0,0,0,0,-9000,0,0,0,1000,10000,-9000,-9000
05246P,南電元大95售04  ,0,0,0,0,0,0,0,0,0,-9000,0,0,0,0,9000,-9000,-9000
053660,群創凱基98購08  ,0,0,0,0,0,0,0,0,0,-9000,0,0,0,0,9000,-9000,-9000
053778,旺宏元大97購03  ,0,0,0,0,0,0,0,0,0,-9000,0,0,0,6000,15000,-9000,-9000
053451,致新凱基96購02  ,0,0,0,0,0,0,0,0,0,-9000,0,0,0,0,9000,-9000,-9000
053415,聯茂國票97購01  ,0,0,0,0,0,0,0,0,0,-9000,0,0,0,6000,15000,-9000,-9000
06705P,臻鼎元富98售03  ,0,0,0,0,0,0,0,0,0,-9000,0,0,0,0,9000,-9000,-9000
1516,川飛            ,1000,10000,-9000,0,0,0,0,0,0,0,0,0,0,0,0,0,-9000
1614,三洋電          ,2000,11000,-9000,0,0,0,0,0,0,0,0,0,0,0,0,0,-9000
1541,錩泰            ,1000,10000,-9000,0,0,0,0,0,0,0,0,0,0,0,0,0,-9000
2013,中鋼構          ,11000,20000,-9000,0,0,0,0,0,0,0,0,0,0,0,0,0,-9000
4144,康聯-KY         ,2000,11000,-9000,0,0,0,0,0,0,0,0,0,0,0,0,0,-9000
3708,上緯投控        ,45000,54000,-9000,0,0,0,0,0,0,0,0,0,0,0,0,0,-9000
4912,聯德控股-KY     ,5000,15000,-10000,0,0,0,0,0,0,1000,1000,0,1000,0,0,0,-9000
2405,浩鑫            ,1000,11000,-10000,0,0,0,0,0,0,1000,1000,0,1000,0,0,0,-9000
06015P,大立光富邦98售04,0,0,0,0,0,0,0,0,0,-10000,0,0,0,0,10000,-10000,-10000
06166P,大立光國票98售01,0,0,0,0,0,0,0,0,0,-10000,0,0,0,0,10000,-10000,-10000
057245,福懋科台新98購01,0,0,0,0,0,0,0,0,0,-10000,0,0,0,0,10000,-10000,-10000
057238,群創凱基9B購03  ,0,0,0,0,0,0,0,0,0,-10000,0,0,0,0,10000,-10000,-10000
057289,力成元大98購03  ,0,0,0,0,0,0,0,0,0,-10000,0,0,0,0,10000,-10000,-10000
057327,玉晶光群益9A購04,0,0,0,0,0,0,0,0,0,-10000,0,0,0,1000,11000,-10000,-10000
057331,台積電國票99購04,0,0,0,0,0,0,0,0,0,-10000,0,0,0,0,10000,-10000,-10000
057316,國巨凱基99購04  ,0,0,0,0,0,0,0,0,0,-10000,0,0,0,0,10000,-10000,-10000
057311,玉晶光日盛9A購01,0,0,0,0,0,0,0,0,0,-10000,0,0,0,0,10000,-10000,-10000
057425,臺股指凱基9C購02,0,0,0,0,0,0,0,0,0,-10000,0,0,0,0,10000,-10000,-10000
057378,康友元大98購02  ,0,0,0,0,0,0,0,0,0,-10000,0,0,0,43000,53000,-10000,-10000
057338,群創國票99購01  ,0,0,0,0,0,0,0,0,0,-10000,0,0,0,0,10000,-10000,-10000
056808,台積電統一98購06,0,0,0,0,0,0,0,0,0,-10000,0,0,0,0,10000,-10000,-10000
056867,華通麥證98購01  ,0,0,0,0,10000,-10000,0,0,0,-10000,0,0,0,0,10000,-10000,-10000
05676P,欣興群益96售04  ,0,0,0,0,0,0,0,0,0,-10000,0,0,0,5000,15000,-10000,-10000
056789,和碩群益98購01  ,0,0,0,0,0,0,0,0,0,-10000,0,0,0,0,10000,-10000,-10000
05672P,鴻海群益96售03  ,0,0,0,0,0,0,0,0,0,-10000,0,0,0,0,10000,-10000,-10000
056607,貿聯富邦99購02  ,0,0,0,0,0,0,0,0,0,-10000,0,0,0,0,10000,-10000,-10000
056563,華新科群益98購04,0,0,0,0,0,0,0,0,0,-10000,0,0,0,10000,20000,-10000,-10000
056612,台積電永豐98購01,0,0,0,0,0,0,0,0,0,-10000,0,0,0,125000,135000,-10000,-10000
05658P,日月光元富96售02,0,0,0,0,0,0,0,0,0,-10000,0,0,0,19000,29000,-10000,-10000
057036,元油2X元大9B購04,0,0,0,0,0,0,0,0,0,-10000,0,0,0,0,10000,-10000,-10000
056948,旺宏統一9A購01  ,0,0,0,0,0,0,0,0,0,-10000,0,0,0,0,10000,-10000,-10000
056905,欣興元大98購03  ,0,0,0,0,0,0,0,0,0,-10000,0,0,0,28000,38000,-10000,-10000
05707P,中磊永豐96售01  ,0,0,0,0,0,0,0,0,0,-10000,0,0,0,1000,11000,-10000,-10000
057069,台積電永豐98購02,0,0,0,0,0,0,0,0,0,-10000,0,0,0,0,10000,-10000,-10000
055887,上銀統一97購03  ,0,0,0,0,0,0,0,0,0,-10000,0,0,0,5000,15000,-10000,-10000
055913,中信金凱基97購01,0,0,0,0,0,0,0,0,0,-10000,0,0,0,0,10000,-10000,-10000
055932,玉山金群益99購01,0,0,0,0,0,0,0,0,0,-10000,0,0,0,11000,21000,-10000,-10000
055815,亞光國票99購01  ,0,0,0,0,0,0,0,0,0,-10000,0,0,0,0,10000,-10000,-10000
055713,國巨元大98購09  ,0,0,0,0,0,0,0,0,0,-10000,0,0,0,0,10000,-10000,-10000
055766,臺股指群益97購04,0,0,0,0,0,0,0,0,0,-10000,0,0,0,0,10000,-10000,-10000
055777,冠德凱基97購01  ,0,0,0,0,0,0,0,0,0,-10000,0,0,0,0,10000,-10000,-10000
055632,群創永豐98購01  ,0,0,0,0,0,0,0,0,0,-10000,0,0,0,0,10000,-10000,-10000
055342,鴻海凱基97購04  ,0,0,0,0,0,0,0,0,0,-10000,0,0,0,20000,30000,-10000,-10000
055356,大立光凱基97購06,0,0,0,0,0,0,0,0,0,-10000,0,0,0,0,10000,-10000,-10000
055473,禾伸堂凱基97購01,0,0,0,0,0,0,0,0,0,-10000,0,0,0,12000,22000,-10000,-10000
055499,大立光元大98購05,0,0,0,0,0,0,0,0,0,-10000,0,0,0,0,10000,-10000,-10000
055557,華新科凱基97購01,0,0,0,0,0,0,0,0,0,-10000,0,0,0,10000,20000,-10000,-10000
056526,力山凱基98購01  ,0,0,0,0,0,0,0,0,0,-10000,0,0,0,0,10000,-10000,-10000
056428,台達電凱基99購01,0,0,0,0,0,0,0,0,0,-10000,0,0,0,10000,20000,-10000,-10000
056447,聯發科凱基98購09,0,0,0,0,0,0,0,0,0,-10000,0,0,0,1000,11000,-10000,-10000
056256,聯茂元富97購03  ,0,0,0,0,0,0,0,0,0,-10000,0,0,0,12000,22000,-10000,-10000
056370,台郡元大98購03  ,0,0,0,0,0,0,0,0,0,-10000,0,0,0,47000,57000,-10000,-10000
056378,欣興元富98購01  ,0,0,0,0,0,0,0,0,0,-10000,0,0,0,0,10000,-10000,-10000
056379,玉晶光元富98購01,0,0,0,0,0,0,0,0,0,-10000,0,0,0,0,10000,-10000,-10000
056339,聯發科凱基99購02,0,0,0,0,0,0,0,0,0,-10000,0,0,0,1000,11000,-10000,-10000
056179,康友元富97購02  ,0,0,0,0,0,0,0,0,0,-10000,0,0,0,0,10000,-10000,-10000
056180,南茂元富97購01  ,0,0,0,0,0,0,0,0,0,-10000,0,0,0,19000,29000,-10000,-10000
056126,台郡國票98購02  ,0,0,0,0,0,0,0,0,0,-10000,0,0,0,0,10000,-10000,-10000
05601P,鴻海元大97售04  ,0,0,0,0,0,0,0,0,0,-10000,0,0,0,51000,61000,-10000,-10000
05602P,國巨元大96售06  ,0,0,0,0,0,0,0,0,0,-10000,0,0,0,0,10000,-10000,-10000
056041,禾伸堂凱基98購03,0,0,0,0,0,0,0,0,0,-10000,0,0,0,10000,20000,-10000,-10000
056079,世紀鋼元大97購02,0,0,0,0,0,0,0,0,0,-10000,0,0,0,191000,201000,-10000,-10000
056080,世紀鋼元大97購03,0,0,0,0,0,0,0,0,0,-10000,0,0,0,100000,110000,-10000,-10000
056062,大立光元大97購12,0,0,0,0,0,0,0,0,0,-10000,0,0,0,1000,11000,-10000,-10000
056064,大立光元大97購14,0,0,0,0,0,0,0,0,0,-10000,0,0,0,0,10000,-10000,-10000
056069,新日興元大97購03,0,0,0,0,0,0,0,0,0,-10000,0,0,0,90000,100000,-10000,-10000
00852L,國泰美國道瓊正2 ,0,0,0,0,0,0,0,0,0,-10000,25000,0,25000,1000,36000,-35000,-10000
04344P,台達電國泰94售01,0,0,0,0,0,0,0,0,0,-10000,0,0,0,137000,147000,-10000,-10000
04320P,亞德客元大93售07,0,0,0,0,0,0,0,0,0,-10000,0,0,0,80000,90000,-10000,-10000
046277,可成台新92購01  ,0,0,0,0,0,0,0,0,0,-10000,0,0,0,0,10000,-10000,-10000
046290,儒鴻統一93購01  ,0,0,0,0,0,0,0,0,0,-10000,0,0,0,0,10000,-10000,-10000
046291,友達統一94購01  ,0,0,0,0,0,0,0,0,0,-10000,0,0,0,0,10000,-10000,-10000
046213,可成統一92購06  ,0,0,0,0,0,0,0,0,0,-10000,0,0,0,0,10000,-10000,-10000
04624P,台積電元大94售14,0,0,0,0,0,0,0,0,0,-10000,0,0,0,0,10000,-10000,-10000
03492P,創意元大02售03  ,0,0,0,0,0,0,0,0,0,-10000,0,0,0,0,10000,-10000,-10000
03659C,元油2X元大98牛13,0,0,0,0,0,0,0,0,0,-10000,0,0,0,0,10000,-10000,-10000
03647P,京元電元富95售02,0,0,0,0,0,0,0,0,0,-10000,0,0,0,0,10000,-10000,-10000
046066,長榮航凱基94購01,0,0,0,0,0,0,0,0,0,-10000,0,0,0,0,10000,-10000,-10000
04019P,聯茂永豐93售01  ,0,0,0,0,0,0,0,0,0,-10000,0,0,0,1000,11000,-10000,-10000
04011P,台積電元大93售22,0,0,0,0,0,0,0,0,0,-10000,0,0,0,0,10000,-10000,-10000
03953P,易華電凱基94售01,0,0,0,0,0,0,0,0,0,-10000,0,0,0,0,10000,-10000,-10000
03912P,臺股指元大93售36,0,0,0,0,0,0,0,0,0,-10000,0,0,0,0,10000,-10000,-10000
046515,嘉澤元大92購04  ,0,0,0,0,0,0,0,0,0,-10000,0,0,0,0,10000,-10000,-10000
046479,群創元富94購01  ,0,0,0,0,0,0,0,0,0,-10000,0,0,0,30000,40000,-10000,-10000
047985,欣興群益93購07  ,0,0,0,0,0,0,0,0,0,-10000,0,0,0,0,10000,-10000,-10000
046429,矽力元大92購03  ,0,0,0,0,0,0,0,0,0,-10000,0,0,0,0,10000,-10000,-10000
046404,友達元大93購02  ,0,0,0,0,0,0,0,0,0,-10000,0,0,0,0,10000,-10000,-10000
047904,臺指反元大96購01,0,0,0,0,0,0,0,0,0,-10000,0,0,0,0,10000,-10000,-10000
047953,台積電永豐93購04,0,0,0,0,0,0,0,0,0,-10000,0,0,0,0,10000,-10000,-10000
046390,旺宏統一94購02  ,0,0,0,0,0,0,0,0,0,-10000,0,0,0,0,10000,-10000,-10000
044965,大立光中信95購01,0,0,0,0,0,0,0,0,0,-10000,0,0,0,61000,71000,-10000,-10000
045093,台表科元大93購02,0,0,0,0,0,0,0,0,0,-10000,0,0,0,0,10000,-10000,-10000
045249,亞德客凱基93購01,0,0,0,0,0,0,0,0,0,-10000,0,0,0,0,10000,-10000,-10000
04541P,智易永豐94售03  ,0,0,0,0,0,0,0,0,0,-10000,0,0,0,0,10000,-10000,-10000
045361,鈺齊凱基93購01  ,0,0,0,0,0,0,0,0,0,-10000,0,0,0,10000,20000,-10000,-10000
04536P,長榮航統一94售01,0,0,0,0,0,0,0,0,0,-10000,0,0,0,0,10000,-10000,-10000
045556,可成國票93購01  ,0,0,0,0,0,0,0,0,0,-10000,0,0,0,0,10000,-10000,-10000
04550P,超眾元大94售01  ,0,0,0,0,0,0,0,0,0,-10000,0,0,0,0,10000,-10000,-10000
047806,旺宏凱基93購05  ,0,0,0,0,0,0,0,0,0,-10000,0,0,0,0,10000,-10000,-10000
047847,鴻海統一93購07  ,0,0,0,0,0,0,0,0,0,-10000,0,0,0,0,10000,-10000,-10000
045791,台表科元大93購04,0,0,0,0,0,0,0,0,0,-10000,0,0,0,0,10000,-10000,-10000
045729,日月光亞東93購01,0,0,0,0,0,0,0,0,0,-10000,0,0,0,0,10000,-10000,-10000
04403P,景碩國票95售01  ,0,0,0,0,0,0,0,0,0,-10000,0,0,0,0,10000,-10000,-10000
043889,台表科元大93購01,0,0,0,0,0,0,0,0,0,-10000,0,0,0,0,10000,-10000,-10000
045013,大立光元大93購04,0,0,0,0,0,0,0,0,0,-10000,0,0,0,0,10000,-10000,-10000
04504P,台積電元富94售04,0,0,0,0,0,0,0,0,0,-10000,0,0,0,0,10000,-10000,-10000
04454P,大立光富邦98售02,0,0,0,0,0,0,0,0,0,-10000,0,0,0,0,10000,-10000,-10000
044927,聯詠國泰94購01  ,0,0,0,0,0,0,0,0,0,-10000,0,0,0,0,10000,-10000,-10000
04492P,元油2X永豐94售03,0,0,0,0,0,0,0,0,0,-10000,0,0,0,0,10000,-10000,-10000
044374,燿華兆豐93購01  ,0,0,0,0,0,0,0,0,0,-10000,0,0,0,0,10000,-10000,-10000
047706,燿華凱基95購01  ,0,0,0,0,0,0,0,0,0,-10000,0,0,0,0,10000,-10000,-10000
04758P,國巨凱基94售03  ,0,0,0,0,0,0,0,0,0,-10000,0,0,0,0,10000,-10000,-10000
048506,華通群益94購03  ,0,0,0,0,0,0,0,0,0,-10000,0,0,0,2000,12000,-10000,-10000
048512,全新凱基93購04  ,0,0,0,0,0,0,0,0,0,-10000,0,0,0,0,10000,-10000,-10000
048524,GIS元富94購01   ,0,0,0,0,0,0,0,0,0,-10000,0,0,0,0,10000,-10000,-10000
048395,南亞科國票93購02,0,0,0,0,0,0,0,0,0,-10000,0,0,0,0,10000,-10000,-10000
048397,TPK國票94購02   ,0,0,0,0,0,0,0,0,0,-10000,0,0,0,0,10000,-10000,-10000
047349,可成凱基93購06  ,0,0,0,0,0,0,0,0,0,-10000,0,0,0,0,10000,-10000,-10000
046933,台泥元富93購01  ,0,0,0,0,0,0,0,0,0,-10000,0,0,0,10000,20000,-10000,-10000
047366,台表科群益93購01,0,0,0,0,0,0,0,0,0,-10000,0,0,0,0,10000,-10000,-10000
047385,華邦電元大94購02,0,0,0,0,0,0,0,0,0,-10000,0,0,0,0,10000,-10000,-10000
047439,漢唐元大95購01  ,0,0,0,0,0,0,0,0,0,-10000,0,0,0,0,10000,-10000,-10000
046738,台積電群益93購05,0,0,0,0,0,0,0,0,0,-10000,0,0,0,0,10000,-10000,-10000
04817P,創意國票95售02  ,0,0,0,0,0,0,0,0,0,-10000,0,0,0,0,10000,-10000,-10000
048133,臻鼎國票94購01  ,0,0,0,0,0,0,0,0,0,-10000,0,0,0,0,10000,-10000,-10000
048061,鴻海統一95購03  ,0,0,0,0,0,0,0,0,0,-10000,0,0,0,11000,21000,-10000,-10000
048055,燿華國泰95購02  ,0,0,0,0,0,0,0,0,0,-10000,0,0,0,0,10000,-10000,-10000
048045,上銀永豐93購02  ,0,0,0,0,0,0,0,0,0,-10000,0,0,0,0,10000,-10000,-10000
046618,南亞科凱基93購01,0,0,0,0,0,0,0,0,0,-10000,0,0,0,10000,20000,-10000,-10000
048092,聯發科凱基93購29,0,0,0,0,0,0,0,0,0,-10000,0,0,0,0,10000,-10000,-10000
048196,聯發科元大93購24,0,0,0,0,0,0,0,0,0,-10000,0,0,0,90000,100000,-10000,-10000
046753,台積電凱基93購04,0,0,0,0,0,0,0,0,0,-10000,0,0,0,0,10000,-10000,-10000
046854,可成元大93購04  ,0,0,0,0,0,0,0,0,0,-10000,0,0,0,10000,20000,-10000,-10000
046900,旺宏凱基93購02  ,0,0,0,0,0,0,0,0,0,-10000,0,0,0,0,10000,-10000,-10000
046986,台積電凱基93購09,0,0,0,0,0,0,0,0,0,-10000,0,0,0,0,10000,-10000,-10000
046991,健策凱基93購04  ,0,0,0,0,0,0,0,0,0,-10000,0,0,0,0,10000,-10000,-10000
046946,益航元大94購01  ,0,0,0,0,0,0,0,0,0,-10000,0,0,0,0,10000,-10000,-10000
046962,群創中信95購03  ,0,0,0,0,0,0,0,0,0,-10000,0,0,0,0,10000,-10000,-10000
047246,華新科群益93購01,0,0,0,0,0,0,0,0,0,-10000,0,0,0,0,10000,-10000,-10000
048592,漢唐群益93購04  ,0,0,0,0,0,0,0,0,0,-10000,0,0,0,0,10000,-10000,-10000
04861P,中磊群益94售02  ,0,0,0,0,0,0,0,0,0,-10000,0,0,0,1000,11000,-10000,-10000
047302,為升富邦97購01  ,0,0,0,0,0,0,0,0,0,-10000,0,0,0,0,10000,-10000,-10000
047134,聯發科凱基93購10,0,0,0,0,0,0,0,0,0,-10000,0,0,0,0,10000,-10000,-10000
047140,滬深2X兆豐94購01,0,0,0,0,0,0,0,0,0,-10000,0,0,0,0,10000,-10000,-10000
047145,鴻海群益95購01  ,0,0,0,0,0,0,0,0,0,-10000,0,0,0,10000,20000,-10000,-10000
047180,台積電元大93購18,0,0,0,0,0,0,0,0,0,-10000,0,0,0,0,10000,-10000,-10000
048650,台表科元大93購05,0,0,0,0,0,0,0,0,0,-10000,0,0,0,0,10000,-10000,-10000
048642,聯發科元大94購02,0,0,0,0,0,0,0,0,0,-10000,0,0,0,13000,23000,-10000,-10000
048764,台光電凱基94購03,0,0,0,0,0,0,0,0,0,-10000,0,0,0,0,10000,-10000,-10000
048742,瀚宇博統一94購01,0,0,0,0,0,0,0,0,0,-10000,0,0,0,0,10000,-10000,-10000
047066,力成凱基93購04  ,0,0,0,0,0,0,0,0,0,-10000,0,0,0,0,10000,-10000,-10000
050401,鎧勝中信94購01  ,0,0,0,0,0,0,0,0,0,-10000,0,0,0,0,10000,-10000,-10000
050346,康友元富94購03  ,0,0,0,0,0,0,0,0,0,-10000,0,0,0,0,10000,-10000,-10000
049262,大立光元大94購09,0,0,0,0,0,0,0,0,0,-10000,0,0,0,0,10000,-10000,-10000
051806,華通凱基96購02  ,0,0,0,0,0,0,0,0,0,-10000,0,0,0,0,10000,-10000,-10000
051829,玉晶光元大98購02,0,0,0,0,0,0,0,0,0,-10000,0,0,0,0,10000,-10000,-10000
051824,華通元大95購07  ,0,0,0,0,0,0,0,0,0,-10000,0,0,0,0,10000,-10000,-10000
051469,友達日盛9B購01  ,0,0,0,0,0,0,0,0,0,-10000,0,0,0,0,10000,-10000,-10000
051445,可成元大95購06  ,0,0,0,0,0,0,0,0,0,-10000,0,0,0,0,10000,-10000,-10000
051440,鴻海元大95購12  ,0,0,0,0,0,0,0,0,0,-10000,0,0,0,5000,15000,-10000,-10000
051441,鴻海元大95購13  ,0,0,0,0,0,0,0,0,0,-10000,0,0,0,0,10000,-10000,-10000
049608,旺宏兆豐94購02  ,0,0,0,0,0,0,0,0,0,-10000,0,0,0,0,10000,-10000,-10000
049624,嘉澤群益94購01  ,0,0,0,0,0,0,0,0,0,-10000,0,0,0,0,10000,-10000,-10000
049669,訊芯國泰95購01  ,0,0,0,0,0,0,0,0,0,-10000,0,0,0,0,10000,-10000,-10000
049686,T50反1元大94購02,0,0,0,0,0,0,0,0,0,-10000,0,0,0,0,10000,-10000,-10000
050926,禾伸堂凱基95購01,0,0,0,0,0,0,0,0,0,-10000,0,0,0,50000,60000,-10000,-10000
050921,旺宏凱基95購02  ,0,0,0,0,0,0,0,0,0,-10000,0,0,0,5000,15000,-10000,-10000
050917,瀚宇博兆豐96購01,0,0,0,0,0,0,0,0,0,-10000,0,0,0,0,10000,-10000,-10000
049681,旺宏統一94購04  ,0,0,0,0,0,0,0,0,0,-10000,0,0,0,50000,60000,-10000,-10000
05087P,GIS國泰96售01   ,0,0,0,0,0,0,0,0,0,-10000,0,0,0,0,10000,-10000,-10000
049583,台積電元大95購04,0,0,0,0,0,0,0,0,0,-10000,0,0,0,572000,582000,-10000,-10000
049566,鴻海統一94購04  ,0,0,0,0,0,0,0,0,0,-10000,0,0,0,0,10000,-10000,-10000
050835,GIS凱基96購01   ,0,0,0,0,0,0,0,0,0,-10000,0,0,0,0,10000,-10000,-10000
050846,緯創國票96購01  ,0,0,0,0,0,0,0,0,0,-10000,0,0,0,0,10000,-10000,-10000
051416,創意國票96購02  ,0,0,0,0,0,0,0,0,0,-10000,0,0,0,30000,40000,-10000,-10000
051414,新光金國票95購04,0,0,0,0,0,0,0,0,0,-10000,0,0,0,0,10000,-10000,-10000
048848,滬深2X群益98購02,0,0,0,0,0,0,0,0,0,-10000,0,0,0,29000,39000,-10000,-10000
048918,上証2X永豐94購01,0,0,0,0,0,0,0,0,0,-10000,0,0,0,0,10000,-10000,-10000
051008,大立光麥證95購01,0,0,0,1000,10000,-9000,0,0,0,-10000,0,0,0,1000,11000,-10000,-10000
050993,聯發科元大95購05,0,0,0,0,0,0,0,0,0,-10000,0,0,0,0,10000,-10000,-10000
050010,鈺齊永豐94購01  ,0,0,0,0,0,0,0,0,0,-10000,0,0,0,0,10000,-10000,-10000
050018,高股息元大94購02,0,0,0,0,0,0,0,0,0,-10000,0,0,0,0,10000,-10000,-10000
050960,台光電永豐95購01,0,0,0,0,0,0,0,0,0,-10000,0,0,0,0,10000,-10000,-10000
049798,台積電元大94購18,0,0,0,0,0,0,0,0,0,-10000,0,0,0,0,10000,-10000,-10000
049802,可成元大94購10  ,0,0,0,0,0,0,0,0,0,-10000,0,0,0,0,10000,-10000,-10000
049781,台表科統一94購01,0,0,0,0,0,0,0,0,0,-10000,0,0,0,0,10000,-10000,-10000
052591,康友永豐97購01  ,0,0,0,0,0,0,0,0,0,-10000,0,0,0,0,10000,-10000,-10000
052187,奇鋐群益95購03  ,0,0,0,0,0,0,0,0,0,-10000,0,0,0,0,10000,-10000,-10000
052433,滬深2X國泰96購02,0,0,0,0,0,0,0,0,0,-10000,0,0,0,10000,20000,-10000,-10000
053002,鴻海永豐96購01  ,0,0,0,0,0,0,0,0,0,-10000,0,0,0,0,10000,-10000,-10000
052152,創意富邦98購01  ,0,0,0,0,0,0,0,0,0,-10000,0,0,0,22000,32000,-10000,-10000
049810,欣興元大95購03  ,0,0,0,0,0,0,0,0,0,-10000,0,0,0,2000,12000,-10000,-10000
049837,臺股指凱基96購02,0,0,0,0,0,0,0,0,0,-10000,0,0,0,0,10000,-10000,-10000
049860,亞德客兆豐94購01,0,0,0,0,0,0,0,0,0,-10000,0,0,0,0,10000,-10000,-10000
049845,台積電麥證94購01,0,0,0,0,10000,-10000,0,0,0,-10000,0,0,0,0,10000,-10000,-10000
051071,聯發科國票96購01,0,0,0,0,0,0,0,0,0,-10000,0,0,0,0,10000,-10000,-10000
051053,台光電群益95購01,0,0,0,0,0,0,0,0,0,-10000,0,0,0,26000,36000,-10000,-10000
051029,緯創元富95購01  ,0,0,0,0,0,0,0,0,0,-10000,0,0,0,0,10000,-10000,-10000
051037,大立光台新95購01,0,0,0,0,0,0,0,0,0,-10000,0,0,0,0,10000,-10000,-10000
050182,淘帝元大94購01  ,0,0,0,0,0,0,0,0,0,-10000,0,0,0,0,10000,-10000,-10000
050170,臺指反元大97購02,0,0,0,0,0,0,0,0,0,-10000,0,0,0,0,10000,-10000,-10000
050204,華新科群益94購05,0,0,0,0,0,0,0,0,0,-10000,0,0,0,25000,35000,-10000,-10000
050202,建準群益95購01  ,0,0,0,0,0,0,0,0,0,-10000,0,0,0,3000,13000,-10000,-10000
050633,義隆群益96購02  ,0,0,0,0,0,0,0,0,0,-10000,0,0,0,0,10000,-10000,-10000
05031P,台光電元富95售01,0,0,0,0,0,0,0,0,0,-10000,0,0,0,0,10000,-10000,-10000
050320,台表科國票94購01,0,0,0,0,0,0,0,0,0,-10000,0,0,0,4000,14000,-10000,-10000
050656,瑞儀凱基96購01  ,0,0,0,0,0,0,0,0,0,-10000,0,0,0,0,10000,-10000,-10000
050673,旺宏富邦96購02  ,0,0,0,0,0,0,0,0,0,-10000,0,0,0,1000,11000,-10000,-10000
050273,GIS元大94購04   ,0,0,0,0,0,0,0,0,0,-10000,0,0,0,0,10000,-10000,-10000
050290,南亞科凱基94購06,0,0,0,0,0,0,0,0,0,-10000,0,0,0,0,10000,-10000,-10000
050291,聯發科凱基94購16,0,0,0,0,0,0,0,0,0,-10000,0,0,0,10000,20000,-10000,-10000
049472,楠梓電永豐95購01,0,0,0,0,0,0,0,0,0,-10000,0,0,0,0,10000,-10000,-10000
049449,宏碁統一94購01  ,0,0,0,0,0,0,0,0,0,-10000,0,0,0,0,10000,-10000,-10000
049445,遠東新統一94購01,0,0,0,0,0,0,0,0,0,-10000,0,0,0,10000,20000,-10000,-10000
051707,欣興群益95購02  ,0,0,0,0,0,0,0,0,0,-10000,0,0,0,2000,12000,-10000,-10000
051677,達方元大95購01  ,0,0,0,0,0,0,0,0,0,-10000,0,0,0,7000,17000,-10000,-10000
051648,TPK永豐95購01   ,0,0,0,0,0,0,0,0,0,-10000,0,0,0,0,10000,-10000,-10000
050711,TPK中信94購01   ,0,0,0,0,0,0,0,0,0,-10000,0,0,0,0,10000,-10000,-10000
051775,旺宏亞東95購01  ,0,0,0,0,0,0,0,0,0,-10000,0,0,0,0,10000,-10000,-10000
050756,京元電元富94購03,0,0,0,0,0,0,0,0,0,-10000,0,0,0,0,10000,-10000,-10000
051298,智邦凱基95購03  ,0,0,0,0,0,0,0,0,0,-10000,0,0,0,9000,19000,-10000,-10000
051236,鴻海元大96購05  ,0,0,0,0,0,0,0,0,0,-10000,0,0,0,182000,192000,-10000,-10000
051201,台積電麥證95購02,0,0,0,0,10000,-10000,0,0,0,-10000,0,0,0,0,10000,-10000,-10000
051204,正崴麥證95購01  ,0,0,0,0,10000,-10000,0,0,0,-10000,0,0,0,0,10000,-10000,-10000
051209,百和麥證95購01  ,0,0,0,0,10000,-10000,0,0,0,-10000,0,0,0,0,10000,-10000,-10000
051152,鴻海國泰97購01  ,0,0,0,0,0,0,0,0,0,-10000,0,0,0,10000,20000,-10000,-10000
051185,強茂永豐95購03  ,0,0,0,0,0,0,0,0,0,-10000,0,0,0,0,10000,-10000,-10000
051162,楠梓電元大95購01,0,0,0,0,0,0,0,0,0,-10000,0,0,0,0,10000,-10000,-10000
050046,矽力兆豐94購01  ,0,0,0,0,0,0,0,0,0,-10000,0,0,0,0,10000,-10000,-10000
050079,元油2X統一94購06,0,0,0,0,0,0,0,0,0,-10000,0,0,0,0,10000,-10000,-10000
050135,禾伸堂兆豐95購01,0,0,0,0,0,0,0,0,0,-10000,0,0,0,10000,20000,-10000,-10000
050626,A50正2中信96購02,0,0,0,0,0,0,0,0,0,-10000,0,0,0,0,10000,-10000,-10000
050568,為升中信97購01  ,0,0,0,0,0,0,0,0,0,-10000,0,0,0,20000,30000,-10000,-10000
050586,康友國票94購01  ,0,0,0,0,0,0,0,0,0,-10000,0,0,0,0,10000,-10000,-10000
05161P,華新科國票96售01,0,0,0,0,0,0,0,0,0,-10000,0,0,0,0,10000,-10000,-10000
051629,上証2X國票95購04,0,0,0,0,0,0,0,0,0,-10000,0,0,0,0,10000,-10000,-10000
049380,欣興元大94購04  ,0,0,0,0,0,0,0,0,0,-10000,0,0,0,2000,12000,-10000,-10000
050491,旺宏國泰96購01  ,0,0,0,0,0,0,0,0,0,-10000,0,0,0,29000,39000,-10000,-10000
050524,宏達電元大95購04,0,0,0,0,0,0,0,0,0,-10000,0,0,0,0,10000,-10000,-10000
050509,元油2X元大94購09,0,0,0,0,0,0,0,0,0,-10000,0,0,0,0,10000,-10000,-10000
052011,欣興中信96購01  ,0,0,0,0,0,0,0,0,0,-10000,0,0,0,0,10000,-10000,-10000
052080,康友元富98購02  ,0,0,0,0,0,0,0,0,0,-10000,0,0,0,0,10000,-10000,-10000
052060,旺宏國票96購02  ,0,0,0,0,0,0,0,0,0,-10000,0,0,0,15000,25000,-10000,-10000
05206P,南茂元大95售01  ,0,0,0,0,0,0,0,0,0,-10000,0,0,0,0,10000,-10000,-10000
051983,道瓊反元大95購01,0,0,0,0,0,0,0,0,0,-10000,0,0,0,0,10000,-10000,-10000
049334,上銀統一94購01  ,0,0,0,0,0,0,0,0,0,-10000,0,0,0,0,10000,-10000,-10000
050479,上証2X國票95購02,0,0,0,0,0,0,0,0,0,-10000,0,0,0,0,10000,-10000,-10000
051543,鈺齊國票96購01  ,0,0,0,0,0,0,0,0,0,-10000,0,0,0,40000,50000,-10000,-10000
053437,啟碁日盛96購01  ,0,0,0,0,0,0,0,0,0,-10000,0,0,0,0,10000,-10000,-10000
053392,致新元大96購01  ,0,0,0,0,0,0,0,0,0,-10000,0,0,0,0,10000,-10000,-10000
05364P,臺股指富邦95售04,0,0,0,0,0,0,0,0,0,-10000,0,0,0,0,10000,-10000,-10000
053628,微星兆豐96購01  ,0,0,0,0,0,0,0,0,0,-10000,0,0,0,0,10000,-10000,-10000
053586,建準元大96購01  ,0,0,0,0,0,0,0,0,0,-10000,0,0,0,24000,34000,-10000,-10000
053494,南亞科兆豐96購02,0,0,0,0,0,0,0,0,0,-10000,0,0,0,2000,12000,-10000,-10000
053509,華新群益98購01  ,0,0,0,0,0,0,0,0,0,-10000,0,0,0,11000,21000,-10000,-10000
053545,上銀凱基96購03  ,0,0,0,0,0,0,0,0,0,-10000,0,0,0,1000,11000,-10000,-10000
053554,欣興凱基97購02  ,0,0,0,0,0,0,0,0,0,-10000,0,0,0,0,10000,-10000,-10000
053767,臻鼎富邦97購02  ,0,0,0,0,0,0,0,0,0,-10000,0,0,0,0,10000,-10000,-10000
05380P,鴻海群益95售11  ,0,0,0,0,0,0,0,0,0,-10000,0,0,0,0,10000,-10000,-10000
053808,大成鋼群益97購01,0,0,0,0,0,0,0,0,0,-10000,0,0,0,5000,15000,-10000,-10000
053829,力成麥證96購01  ,0,0,0,10000,20000,-10000,0,0,0,-10000,0,0,0,10000,20000,-10000,-10000
053655,全新凱基98購02  ,0,0,0,0,0,0,0,0,0,-10000,0,0,0,20000,30000,-10000,-10000
053679,緯創富邦96購01  ,0,0,0,0,0,0,0,0,0,-10000,0,0,0,0,10000,-10000,-10000
053722,新光金凱基9C購01,0,0,0,0,0,0,0,0,0,-10000,0,0,0,0,10000,-10000,-10000
053913,華新國票97購01  ,0,0,0,0,0,0,0,0,0,-10000,0,0,0,0,10000,-10000,-10000
053875,GIS元大97購01   ,0,0,0,0,0,0,0,0,0,-10000,0,0,0,0,10000,-10000,-10000
053940,康友元富96購01  ,0,0,0,0,0,0,0,0,0,-10000,0,0,0,0,10000,-10000,-10000
053946,全新富邦97購02  ,0,0,0,0,0,0,0,0,0,-10000,0,0,0,0,10000,-10000,-10000
052279,旺宏凱基95購07  ,0,0,0,0,0,0,0,0,0,-10000,0,0,0,0,10000,-10000,-10000
052828,滬深2X群益9A購02,0,0,0,0,0,0,0,0,0,-10000,0,0,0,0,10000,-10000,-10000
052308,大立光國泰97購02,0,0,0,0,0,0,0,0,0,-10000,0,0,0,31000,41000,-10000,-10000
05288P,寶成元富95售02  ,0,0,0,0,0,0,0,0,0,-10000,0,0,0,40000,50000,-10000,-10000
052242,台達電台新96購01,0,0,0,0,0,0,0,0,0,-10000,0,0,0,0,10000,-10000,-10000
052204,台泥中信96購01  ,0,0,0,0,0,0,0,0,0,-10000,0,0,0,0,10000,-10000,-10000
052260,為升富邦97購02  ,0,0,0,0,0,0,0,0,0,-10000,0,0,0,10000,20000,-10000,-10000
052745,欣興元大96購04  ,0,0,0,0,0,0,0,0,0,-10000,0,0,0,2000,12000,-10000,-10000
053140,燿華永豐96購02  ,0,0,0,0,0,0,0,0,0,-10000,0,0,0,0,10000,-10000,-10000
053115,滬深2X中信97購01,0,0,0,0,0,0,0,0,0,-10000,0,0,0,0,10000,-10000,-10000
053122,美律凱基98購01  ,0,0,0,0,0,0,0,0,0,-10000,0,0,0,42000,52000,-10000,-10000
053087,冠德元大96購02  ,0,0,0,0,0,0,0,0,0,-10000,0,0,0,0,10000,-10000,-10000
052969,建準群益97購01  ,0,0,0,0,0,0,0,0,0,-10000,0,0,0,0,10000,-10000,-10000
052286,力成凱基95購02  ,0,0,0,0,0,0,0,0,0,-10000,0,0,0,3000,13000,-10000,-10000
053208,鴻海凱基96購13  ,0,0,0,0,0,0,0,0,0,-10000,0,0,0,0,10000,-10000,-10000
053299,台泥凱基96購01  ,0,0,0,0,0,0,0,0,0,-10000,0,0,0,0,10000,-10000,-10000
054994,建準元富97購01  ,0,0,0,0,0,0,0,0,0,-10000,0,0,0,0,10000,-10000,-10000
055000,玉晶光元富97購04,0,0,0,0,0,0,0,0,0,-10000,0,0,0,0,10000,-10000,-10000
054945,正崴元大97購01  ,0,0,0,0,0,0,0,0,0,-10000,0,0,0,0,10000,-10000,-10000
054785,建準群益98購01  ,0,0,0,0,0,0,0,0,0,-10000,0,0,0,6000,16000,-10000,-10000
05478P,智伸科國票96售02,0,0,0,0,0,0,0,0,0,-10000,0,0,0,15000,25000,-10000,-10000
054782,國巨群益97購01  ,0,0,0,0,0,0,0,0,0,-10000,0,0,0,170000,180000,-10000,-10000
054741,亞光凱基99購01  ,0,0,0,0,0,0,0,0,0,-10000,0,0,0,0,10000,-10000,-10000
055227,聯發科國票98購02,0,0,0,0,0,0,0,0,0,-10000,0,0,0,0,10000,-10000,-10000
055218,彩晶凱基99購01  ,0,0,0,0,0,0,0,0,0,-10000,0,0,0,0,10000,-10000,-10000
055197,致新元富97購02  ,0,0,0,0,0,0,0,0,0,-10000,0,0,0,0,10000,-10000,-10000
055077,臺股指永豐97購02,0,0,0,0,0,0,0,0,0,-10000,0,0,0,0,10000,-10000,-10000
055081,健鼎中信97購01  ,0,0,0,0,0,0,0,0,0,-10000,0,0,0,0,10000,-10000,-10000
055027,牧德國泰99購01  ,0,0,0,0,0,0,0,0,0,-10000,0,0,0,293000,303000,-10000,-10000
055037,宏盛富邦99購01  ,0,0,0,0,0,0,0,0,0,-10000,0,0,0,0,10000,-10000,-10000
055116,康控凱基98購01  ,0,0,0,0,0,0,0,0,0,-10000,0,0,0,120000,130000,-10000,-10000
055111,宏盛凱基97購01  ,0,0,0,0,0,0,0,0,0,-10000,0,0,0,0,10000,-10000,-10000
055128,致新兆豐97購01  ,0,0,0,0,0,0,0,0,0,-10000,0,0,0,0,10000,-10000,-10000
055156,華新科元大99購02,0,0,0,0,0,0,0,0,0,-10000,0,0,0,40000,50000,-10000,-10000
054398,牧德永豐96購03  ,0,0,0,0,0,0,0,0,0,-10000,0,0,0,70000,80000,-10000,-10000
054369,鴻海中信9C購01  ,0,0,0,0,0,0,0,0,0,-10000,0,0,0,62000,72000,-10000,-10000
05459P,聯詠凱基95售03  ,0,0,0,0,0,0,0,0,0,-10000,0,0,0,0,10000,-10000,-10000
054600,中壽台新97購01  ,0,0,0,0,0,0,0,0,0,-10000,0,0,0,10000,20000,-10000,-10000
054592,美律永昌9A購01  ,0,0,0,0,0,0,0,0,0,-10000,0,0,0,0,10000,-10000,-10000
054620,南茂永豐97購01  ,0,0,0,0,0,0,0,0,0,-10000,0,0,0,0,10000,-10000,-10000
054642,訊芯中信9A購01  ,0,0,0,0,0,0,0,0,0,-10000,0,0,0,0,10000,-10000,-10000
054267,上銀第一96購01  ,0,0,0,0,0,0,0,0,0,-10000,0,0,0,0,10000,-10000,-10000
05429P,鴻海統一95售16  ,0,0,0,0,0,0,0,0,0,-10000,0,0,0,11000,21000,-10000,-10000
054329,華新科永豐96購02,0,0,0,0,0,0,0,0,0,-10000,0,0,0,20000,30000,-10000,-10000
054341,燿華元富96購03  ,0,0,0,0,0,0,0,0,0,-10000,0,0,0,0,10000,-10000,-10000
054338,全新統一96購01  ,0,0,0,0,0,0,0,0,0,-10000,0,0,0,20000,30000,-10000,-10000
054339,聯詠統一96購02  ,0,0,0,0,0,0,0,0,0,-10000,0,0,0,0,10000,-10000,-10000
054193,鴻海麥證96購02  ,0,0,0,0,10000,-10000,0,0,0,-10000,0,0,0,0,10000,-10000,-10000
054040,中石化元大9C購01,0,0,0,0,0,0,0,0,0,-10000,0,0,0,0,10000,-10000,-10000
054083,智伸科元富96購01,0,0,0,0,0,0,0,0,0,-10000,0,0,0,0,10000,-10000,-10000
054134,強茂元大96購01  ,0,0,0,0,0,0,0,0,0,-10000,0,0,0,0,10000,-10000,-10000
054135,大立光元大97購04,0,0,0,0,0,0,0,0,0,-10000,0,0,0,0,10000,-10000,-10000
054100,致伸國票97購03  ,0,0,0,0,0,0,0,0,0,-10000,0,0,0,0,10000,-10000,-10000
054167,揚明光凱基98購01,0,0,0,0,0,0,0,0,0,-10000,0,0,0,0,10000,-10000,-10000
054161,友訊凱基98購01  ,0,0,0,0,0,0,0,0,0,-10000,0,0,0,5000,15000,-10000,-10000
2428,興勤            ,33000,35000,-2000,0,0,0,0,0,0,-8000,0,0,0,0,8000,-8000,-10000
2436,偉詮電          ,11000,21000,-10000,0,0,0,0,0,0,0,0,0,0,0,0,0,-10000
2477,美隆電          ,7000,17000,-10000,0,0,0,0,0,0,0,0,0,0,0,0,0,-10000
2704,國賓            ,8000,18000,-10000,0,0,0,0,0,0,0,0,0,0,0,0,0,-10000
3312,弘憶股          ,25000,35000,-10000,0,0,0,0,0,0,0,0,0,0,0,0,0,-10000
6235,華孚            ,0,10000,-10000,0,0,0,0,0,0,0,0,0,0,0,0,0,-10000
1810,和成            ,0,10000,-10000,0,0,0,0,0,0,0,0,0,0,0,0,0,-10000
1445,大宇            ,0,10000,-10000,0,0,0,0,0,0,0,0,0,0,0,0,0,-10000
06685P,鴻海國泰9A售01  ,0,0,0,0,0,0,0,0,0,-10000,0,0,0,0,10000,-10000,-10000
06663P,鴻海兆豐98售03  ,0,0,0,0,0,0,0,0,0,-10000,0,0,0,0,10000,-10000,-10000
1109,信大            ,42000,52000,-10000,0,0,0,0,0,0,0,0,0,0,0,0,0,-10000
1231,聯華食          ,4000,14000,-10000,0,0,0,0,0,0,0,0,0,0,0,0,0,-10000
1325,恆大            ,0,10000,-10000,0,0,0,0,0,0,0,0,0,0,0,0,0,-10000
1316,上曜            ,1000,11000,-10000,0,0,0,0,0,0,0,0,0,0,0,0,0,-10000
06365P,鴻海凱基97售09  ,0,0,0,0,0,0,0,0,0,-10000,0,0,0,0,10000,-10000,-10000
06208P,台郡凱基97售03  ,0,0,0,0,0,0,0,0,0,-10000,0,0,0,0,10000,-10000,-10000
06258P,臺股指群益97售11,0,0,0,0,0,0,0,0,0,-10000,0,0,0,0,10000,-10000,-10000
06391P,上銀中信97售03  ,0,0,0,0,0,0,0,0,0,-10000,0,0,0,0,10000,-10000,-10000
06432P,上銀群益98售01  ,0,0,0,0,0,0,0,0,0,-10000,0,0,0,0,10000,-10000,-10000
06433P,大立光群益99售01,0,0,0,0,0,0,0,0,0,-10000,0,0,0,5000,15000,-10000,-10000
8249,菱光            ,22000,32000,-10000,0,0,0,0,0,0,0,0,0,0,0,0,0,-10000
9908,大台北          ,0,14000,-14000,0,0,0,0,0,0,4000,4000,0,4000,0,0,0,-10000
9941A,裕融甲特        ,0,0,0,0,0,0,0,0,0,-10000,1000,11000,-10000,0,0,0,-10000
056026,智易群益97購01  ,0,0,0,0,0,0,0,0,0,-11000,0,0,0,100000,111000,-11000,-11000
056087,世芯統一97購01  ,0,0,0,0,0,0,0,0,0,-11000,0,0,0,2000,13000,-11000,-11000
056212,台光電國票98購03,0,0,0,0,0,0,0,0,0,-11000,0,0,0,7000,18000,-11000,-11000
056373,上銀統一99購02  ,0,0,0,0,0,0,0,0,0,-11000,0,0,0,91000,102000,-11000,-11000
055529,華邦電群益97購02,0,0,0,0,0,0,0,0,0,-11000,0,0,0,0,11000,-11000,-11000
055676,亞德客凱基97購03,0,0,0,0,0,0,0,0,0,-11000,0,0,0,319000,330000,-11000,-11000
056564,亞光群益98購02  ,0,0,0,0,0,0,0,0,0,-11000,0,0,0,0,11000,-11000,-11000
056800,臺股指麥證98購01,0,0,0,2000,13000,-11000,0,0,0,-11000,0,0,0,2000,13000,-11000,-11000
056816,華通永豐98購02  ,0,0,0,0,0,0,0,0,0,-11000,0,0,0,2000,13000,-11000,-11000
06136P,華新科國泰99售02,0,0,0,0,0,0,0,0,0,-11000,0,0,0,167000,178000,-11000,-11000
06061P,訊芯統一97售01  ,0,0,0,0,0,0,0,0,0,-11000,0,0,0,9000,20000,-11000,-11000
06095P,燿華永豐97售01  ,0,0,0,0,0,0,0,0,0,-11000,0,0,0,0,11000,-11000,-11000
05941P,聯發科凱基96售22,0,0,0,0,0,0,0,0,0,-11000,0,0,0,0,11000,-11000,-11000
050409,華通永豐94購01  ,0,0,0,0,0,0,0,0,0,-11000,0,0,0,0,11000,-11000,-11000
050386,智伸科國票94購01,0,0,0,0,0,0,0,0,0,-11000,0,0,0,22000,33000,-11000,-11000
04859P,台達電群益94售04,0,0,0,0,0,0,0,0,0,-11000,0,0,0,0,11000,-11000,-11000
047634,亞德客元大93購01,0,0,0,0,0,0,0,0,0,-11000,0,0,0,20000,31000,-11000,-11000
045957,技嘉凱基93購03  ,0,0,0,0,0,0,0,0,0,-11000,0,0,0,60000,71000,-11000,-11000
03892P,元油2X中信95售01,0,0,0,0,0,0,0,0,0,-11000,0,0,0,89000,100000,-11000,-11000
03893P,為升凱基93售03  ,0,0,0,0,0,0,0,0,0,-11000,0,0,0,0,11000,-11000,-11000
03012X,元展12          ,0,0,0,0,0,0,0,0,0,-11000,0,0,0,0,11000,-11000,-11000
00709,富邦歐洲        ,0,0,0,0,0,0,0,0,0,-11000,0,0,0,100000,111000,-11000,-11000
00647L,元大S&P500正2   ,0,7000,-7000,0,0,0,0,0,0,-4000,236000,0,236000,0,240000,-240000,-11000
042752,台灣50元大96購03,0,0,0,0,0,0,0,0,0,-11000,0,0,0,0,11000,-11000,-11000
051492,臻鼎凱基95購01  ,0,0,0,0,0,0,0,0,0,-11000,0,0,0,24000,35000,-11000,-11000
049304,元油2X凱基95購05,0,0,0,0,0,0,0,0,0,-11000,0,0,0,5000,16000,-11000,-11000
052020,聯茂永豐95購02  ,0,0,0,0,0,0,0,0,0,-11000,0,0,0,235000,246000,-11000,-11000
051590,玉晶光元大96購02,0,0,0,0,0,0,0,0,0,-11000,0,0,0,68000,79000,-11000,-11000
051130,百和群益96購01  ,0,0,0,0,0,0,0,0,0,-11000,0,0,0,0,11000,-11000,-11000
051260,鴻海永昌96購04  ,0,0,0,0,0,0,0,0,0,-11000,0,0,0,0,11000,-11000,-11000
050281,台積電日盛94購03,0,0,0,0,0,0,0,0,0,-11000,0,0,0,39000,50000,-11000,-11000
050219,台積電元富95購03,0,0,0,0,0,0,0,0,0,-11000,0,0,0,10000,21000,-11000,-11000
049820,世紀鋼元大96購03,0,0,0,0,0,0,0,0,0,-11000,0,0,0,24000,35000,-11000,-11000
049145,南亞科元大94購01,0,0,0,0,0,0,0,0,0,-11000,0,0,0,23000,34000,-11000,-11000
052453,崇越元大95購01  ,0,0,0,0,0,0,0,0,0,-11000,0,0,0,0,11000,-11000,-11000
049955,崇越群益95購01  ,0,0,0,0,0,0,0,0,0,-11000,0,0,0,0,11000,-11000,-11000
049967,華新科國票94購07,0,0,0,0,0,0,0,0,0,-11000,0,0,0,17000,28000,-11000,-11000
050995,貿聯元大95購02  ,0,0,0,0,0,0,0,0,0,-11000,0,0,0,20000,31000,-11000,-11000
049004,聯發科中信96購01,0,0,0,0,0,0,0,0,0,-11000,0,0,0,13000,24000,-11000,-11000
051382,玉晶光群益98購02,0,0,0,0,0,0,0,0,0,-11000,0,0,0,4000,15000,-11000,-11000
051344,鴻海元大95購08  ,0,0,0,0,0,0,0,0,0,-11000,0,0,0,726000,737000,-11000,-11000
054130,漢唐元大97購02  ,0,0,0,0,0,0,0,0,0,-11000,0,0,0,176000,187000,-11000,-11000
054200,美律富邦97購02  ,0,0,0,0,0,0,0,0,0,-11000,0,0,0,0,11000,-11000,-11000
054652,裕隆麥證97購01  ,0,0,0,110000,121000,-11000,0,0,0,-11000,0,0,0,110000,121000,-11000,-11000
054359,南亞科日盛96購02,0,0,0,0,0,0,0,0,0,-11000,0,0,0,382000,393000,-11000,-11000
054514,道瓊銀元大98購01,0,0,0,0,0,0,0,0,0,-11000,0,0,0,0,11000,-11000,-11000
055163,訊芯元大98購01  ,0,0,0,0,0,0,0,0,0,-11000,0,0,0,20000,31000,-11000,-11000
055199,國喬群益97購01  ,0,0,0,0,0,0,0,0,0,-11000,0,0,0,0,11000,-11000,-11000
054752,易華電凱基97購02,0,0,0,0,0,0,0,0,0,-11000,0,0,0,20000,31000,-11000,-11000
054764,亞光國票98購01  ,0,0,0,0,0,0,0,0,0,-11000,0,0,0,0,11000,-11000,-11000
054780,中石化群益99購01,0,0,0,0,0,0,0,0,0,-11000,0,0,0,0,11000,-11000,-11000
054796,康普群益98購01  ,0,0,0,0,0,0,0,0,0,-11000,0,0,0,0,11000,-11000,-11000
054872,瀚宇博群益98購01,0,0,0,0,0,0,0,0,0,-11000,0,0,0,0,11000,-11000,-11000
054879,大成鋼統一97購01,0,0,0,0,0,0,0,0,0,-11000,0,0,0,0,11000,-11000,-11000
053236,群創永豐97購02  ,0,0,0,0,0,0,0,0,0,-11000,0,0,0,2000,13000,-11000,-11000
05314P,臺股指群益95售13,0,0,0,0,0,0,0,0,0,-11000,0,0,0,4000,15000,-11000,-11000
052965,廣宇群益97購01  ,0,0,0,0,0,0,0,0,0,-11000,0,0,0,10000,21000,-11000,-11000
052900,大成鋼國票97購01,0,0,0,0,0,0,0,0,0,-11000,0,0,0,0,11000,-11000,-11000
053898,康友群益97購01  ,0,0,0,0,0,0,0,0,0,-11000,0,0,0,41000,52000,-11000,-11000
053515,致伸群益96購02  ,0,0,0,0,0,0,0,0,0,-11000,0,0,0,0,11000,-11000,-11000
06485P,玉晶光群益9A售02,0,0,0,0,0,0,0,0,0,-11000,0,0,0,0,11000,-11000,-11000
06684P,緯穎元大98售06  ,0,0,0,0,0,0,0,0,0,-11000,0,0,0,0,11000,-11000,-11000
5269,祥碩            ,498000,392000,106000,0,0,0,0,119000,-119000,2000,15000,12000,3000,1000,2000,-1000,-11000
3130,一零四          ,0,11000,-11000,0,0,0,0,0,0,0,0,0,0,0,0,0,-11000
3705,永信            ,17000,28000,-11000,0,0,0,0,0,0,0,0,0,0,0,0,0,-11000
4526,東台            ,1000,12000,-11000,0,0,0,0,0,0,0,0,0,0,0,0,0,-11000
2888A,新光金甲特      ,0,9000,-9000,0,0,0,0,0,0,-2000,0,2000,-2000,0,0,0,-11000
05918P,大立光元大96售11,0,0,0,0,0,0,0,0,0,-12000,0,0,0,23000,35000,-12000,-12000
06131P,京鼎元富97售02  ,0,0,0,0,0,0,0,0,0,-12000,0,0,0,5000,17000,-12000,-12000
057234,宏達電凱基98購05,0,0,0,0,0,0,0,0,0,-12000,0,0,0,2000,14000,-12000,-12000
057204,利勤元富98購01  ,0,0,0,0,0,0,0,0,0,-12000,0,0,0,5000,17000,-12000,-12000
056807,元油2X統一9B購01,0,0,0,0,0,0,0,0,0,-12000,0,0,0,20000,32000,-12000,-12000
056644,宏達電凱基98購04,0,0,0,0,0,0,0,0,0,-12000,0,0,0,13000,25000,-12000,-12000
056875,亞光凱基98購03  ,0,0,0,0,0,0,0,0,0,-12000,0,0,0,44000,56000,-12000,-12000
055657,超眾元富97購02  ,0,0,0,0,0,0,0,0,0,-12000,0,0,0,11000,23000,-12000,-12000
055458,燿華永豐98購01  ,0,0,0,0,0,0,0,0,0,-12000,0,0,0,0,12000,-12000,-12000
055565,祥碩凱基97購01  ,0,0,0,0,0,0,0,0,0,-12000,0,0,0,9000,21000,-12000,-12000
055555,全新凱基9A購01  ,0,0,0,0,0,0,0,0,0,-12000,0,0,0,0,12000,-12000,-12000
055367,台積電元大97購23,0,0,0,0,0,0,0,0,0,-12000,0,0,0,5000,17000,-12000,-12000
055309,冠德群益97購01  ,0,0,0,0,0,0,0,0,0,-12000,0,0,0,0,12000,-12000,-12000
05538P,玉晶光國票97售02,0,0,0,0,0,0,0,0,0,-12000,0,0,0,10000,22000,-12000,-12000
056247,台郡群益97購01  ,0,0,0,0,0,0,0,0,0,-12000,0,0,0,58000,70000,-12000,-12000
056192,智邦富邦98購01  ,0,0,0,0,0,0,0,0,0,-12000,0,0,0,33000,45000,-12000,-12000
056103,聯發科永豐97購03,0,0,0,0,0,0,0,0,0,-12000,0,0,0,7000,19000,-12000,-12000
055949,亞德客元大97購04,0,0,0,0,0,0,0,0,0,-12000,0,0,0,223000,235000,-12000,-12000
00654R,富邦印度反1     ,0,4000,-4000,0,0,0,0,0,0,-8000,0,0,0,2000,10000,-8000,-12000
044614,聯茂兆豐92購02  ,0,0,0,0,0,0,0,0,0,-12000,0,0,0,0,12000,-12000,-12000
047837,嘉晶元大93購01  ,0,0,0,0,0,0,0,0,0,-12000,0,0,0,90000,102000,-12000,-12000
04517P,宏達電群益95售01,0,0,0,0,0,0,0,0,0,-12000,0,0,0,6000,18000,-12000,-12000
04646P,TPK凱基94售03   ,0,0,0,0,0,0,0,0,0,-12000,0,0,0,20000,32000,-12000,-12000
048239,嘉澤國票93購01  ,0,0,0,0,0,0,0,0,0,-12000,0,0,0,0,12000,-12000,-12000
046998,同欣電國泰94購01,0,0,0,0,0,0,0,0,0,-12000,0,0,0,0,12000,-12000,-12000
051891,智邦元富95購04  ,0,0,0,0,0,0,0,0,0,-12000,0,0,0,0,12000,-12000,-12000
049073,光罩凱基94購01  ,0,0,0,0,0,0,0,0,0,-12000,0,0,0,0,12000,-12000,-12000
048850,聯電群益96購01  ,0,0,0,0,0,0,0,0,0,-12000,0,0,0,92000,104000,-12000,-12000
049752,上緯控永豐94購02,0,0,0,0,0,0,0,0,0,-12000,0,0,0,0,12000,-12000,-12000
049146,南亞科元大94購02,0,0,0,0,0,0,0,0,0,-12000,0,0,0,45000,57000,-12000,-12000
05066P,康控元大95售03  ,0,0,0,0,0,0,0,0,0,-12000,0,0,0,4000,16000,-12000,-12000
050748,道瓊銀統一94購04,0,0,0,0,0,0,0,0,0,-12000,0,0,0,0,12000,-12000,-12000
050764,鴻海元大94購27  ,0,0,0,0,0,0,0,0,0,-12000,0,0,0,708000,720000,-12000,-12000
04939P,國巨國票95售03  ,0,0,0,0,0,0,0,0,0,-12000,0,0,0,20000,32000,-12000,-12000
053810,台達電群益96購01,0,0,0,0,0,0,0,0,0,-12000,0,0,0,28000,40000,-12000,-12000
052882,南電凱基96購02  ,0,0,0,0,0,0,0,0,0,-12000,0,0,0,0,12000,-12000,-12000
052318,友達元大98購01  ,0,0,0,0,0,0,0,0,0,-12000,0,0,0,0,12000,-12000,-12000
055282,聯發科元大97購15,0,0,0,0,0,0,0,0,0,-12000,0,0,0,114000,126000,-12000,-12000
054133,奇力新元大97購04,0,0,0,0,0,0,0,0,0,-12000,0,0,0,17000,29000,-12000,-12000
054099,TPK國票98購01   ,0,0,0,0,0,0,0,0,0,-12000,0,0,0,50000,62000,-12000,-12000
054074,健策富邦98購01  ,0,0,0,0,0,0,0,0,0,-12000,0,0,0,45000,57000,-12000,-12000
3015,全漢            ,1000,13000,-12000,0,0,0,0,0,0,0,0,0,0,0,0,0,-12000
5283,禾聯碩          ,0,12000,-12000,0,0,0,0,0,0,0,0,0,0,0,0,0,-12000
4989,榮科            ,6000,18000,-12000,0,0,0,0,0,0,0,0,0,0,0,0,0,-12000
06696P,台灣50國票99售01,0,0,0,0,0,0,0,0,0,-12000,0,0,0,0,12000,-12000,-12000
06645P,上銀元大98售05  ,0,0,0,0,0,0,0,0,0,-12000,0,0,0,0,12000,-12000,-12000
06638P,鴻海統一99售02  ,0,0,0,0,0,0,0,0,0,-12000,0,0,0,0,12000,-12000,-12000
1537,廣隆            ,15000,27000,-12000,0,0,0,0,0,0,0,0,0,0,0,0,0,-12000
9942,茂順            ,0,12000,-12000,0,0,0,0,0,0,0,0,0,0,0,0,0,-12000
9940,信義            ,50000,62000,-12000,0,0,0,0,0,0,0,0,0,0,0,0,0,-12000
056098,矽創元富97購02  ,0,0,0,0,0,0,0,0,0,-13000,0,0,0,22000,35000,-13000,-13000
056409,麗豐國票99購01  ,0,0,0,0,0,0,0,0,0,-13000,0,0,0,32000,45000,-13000,-13000
055475,臻鼎凱基97購02  ,0,0,0,0,0,0,0,0,0,-13000,0,0,0,53000,66000,-13000,-13000
055735,宏達電元富98購01,0,0,0,0,0,0,0,0,0,-13000,0,0,0,36000,49000,-13000,-13000
055865,臺股指元大97購02,0,0,0,0,0,0,0,0,0,-13000,0,0,0,0,13000,-13000,-13000
057164,國巨元大98購14  ,0,0,0,0,0,0,0,0,0,-13000,0,0,0,222000,235000,-13000,-13000
056561,台光電群益98購02,0,0,0,0,0,0,0,0,0,-13000,0,0,0,180000,193000,-13000,-13000
057337,聯發科國票99購02,0,0,0,0,0,0,0,0,0,-13000,0,0,0,0,13000,-13000,-13000
051878,鴻海台新96購01  ,0,0,0,0,0,0,0,0,0,-13000,0,0,0,0,13000,-13000,-13000
047049,聯發科國票94購01,0,0,0,0,0,0,0,0,0,-13000,0,0,0,0,13000,-13000,-13000
047177,上銀元大93購05  ,0,0,0,0,0,0,0,0,0,-13000,0,0,0,16000,29000,-13000,-13000
047655,聯發科兆豐93購02,0,0,0,0,0,0,0,0,0,-13000,0,0,0,15000,28000,-13000,-13000
04518P,高鐵群益95售01  ,0,0,0,0,0,0,0,0,0,-13000,0,0,0,21000,34000,-13000,-13000
045500,聯發科凱基93購04,0,0,0,0,0,0,0,0,0,-13000,0,0,0,0,13000,-13000,-13000
03022X,富展01          ,0,0,0,0,0,0,0,0,0,-13000,0,0,0,0,13000,-13000,-13000
04334P,中石化康和93售01,0,0,0,0,0,0,0,0,0,-13000,0,0,0,0,13000,-13000,-13000
050077,臺股指凱基99購02,0,0,0,0,0,0,0,0,0,-13000,0,0,0,0,13000,-13000,-13000
050769,聯發科元大94購17,0,0,0,0,0,0,0,0,0,-13000,0,0,0,21000,34000,-13000,-13000
050784,美律國泰96購01  ,0,0,0,0,0,0,0,0,0,-13000,0,0,0,110000,123000,-13000,-13000
050239,廣達凱基94購01  ,0,0,0,0,0,0,0,0,0,-13000,0,0,0,0,13000,-13000,-13000
050189,旭富元大94購01  ,0,0,0,0,0,0,0,0,0,-13000,0,0,0,15000,28000,-13000,-13000
050815,南亞科凱基95購01,0,0,0,0,0,0,0,0,0,-13000,0,0,0,0,13000,-13000,-13000
054047,富邦金元大97購01,0,0,0,0,0,0,0,0,0,-13000,0,0,0,62000,75000,-13000,-13000
055146,華通元大98購04  ,0,0,0,0,0,0,0,0,0,-13000,0,0,0,8000,21000,-13000,-13000
055117,臻鼎凱基98購02  ,0,0,0,0,0,0,0,0,0,-13000,0,0,0,0,13000,-13000,-13000
053145,元黃金元大96購02,0,0,0,0,0,0,0,0,0,-13000,0,0,0,0,13000,-13000,-13000
053207,SP黃豆凱基96購01,0,0,0,0,0,0,0,0,0,-13000,0,0,0,0,13000,-13000,-13000
053276,友達元大9C購01  ,0,1000,-1000,0,0,0,0,0,0,-12000,0,0,0,18000,30000,-12000,-13000
052884,台積電兆豐96購01,0,0,0,0,0,0,0,0,0,-13000,0,0,0,27000,40000,-13000,-13000
052871,群創凱基98購07  ,0,0,0,0,0,0,0,0,0,-13000,0,0,0,0,13000,-13000,-13000
053720,宏達電凱基97購01,0,0,0,0,0,0,0,0,0,-13000,0,0,0,0,13000,-13000,-13000
053939,台表科元富96購03,0,0,0,0,0,0,0,0,0,-13000,0,0,0,7000,20000,-13000,-13000
053615,光罩群益96購01  ,0,0,0,0,0,0,0,0,0,-13000,0,0,0,10000,23000,-13000,-13000
053623,臺股指群益96購09,0,0,0,0,0,0,0,0,0,-13000,0,0,0,61000,74000,-13000,-13000
1626,艾美特-KY       ,16000,29000,-13000,0,0,0,0,0,0,0,0,0,0,0,0,0,-13000
06574P,大立光永昌99售01,0,0,0,0,0,0,0,0,0,-13000,0,0,0,9000,22000,-13000,-13000
06575P,大立光永昌99售02,0,0,0,0,0,0,0,0,0,-13000,0,0,0,9000,22000,-13000,-13000
05790P,臺股指永昌96售07,0,0,0,0,0,0,0,0,0,-14000,0,0,0,1000,15000,-14000,-14000
056709,華通永豐98購01  ,0,0,0,0,0,0,0,0,0,-14000,0,0,0,25000,39000,-14000,-14000
056986,超眾群益98購03  ,0,0,0,0,0,0,0,0,0,-14000,0,0,0,34000,48000,-14000,-14000
055775,友達凱基9A購01  ,0,0,0,0,0,0,0,0,0,-14000,0,0,0,0,14000,-14000,-14000
055488,華邦電元大98購01,0,0,0,0,0,0,0,0,0,-14000,0,0,0,34000,48000,-14000,-14000
056272,嘉澤統一99購01  ,0,0,0,0,0,0,0,0,0,-14000,0,0,0,66000,80000,-14000,-14000
056396,祥碩永豐98購01  ,0,0,0,0,0,0,0,0,0,-14000,0,0,0,11000,25000,-14000,-14000
056181,百和元富97購02  ,0,0,0,0,0,0,0,0,0,-14000,0,0,0,3000,17000,-14000,-14000
056242,緯創群益9A購01  ,0,0,0,0,0,0,0,0,0,-14000,0,0,0,0,14000,-14000,-14000
056024,大立光群益97購05,0,0,0,0,0,0,0,0,0,-14000,0,0,0,0,14000,-14000,-14000
04552P,南電元大94售06  ,0,0,0,0,0,0,0,0,0,-14000,0,0,0,0,14000,-14000,-14000
04463P,可成元富94售03  ,0,0,0,0,0,0,0,0,0,-14000,0,0,0,6000,20000,-14000,-14000
044402,景碩凱基93購01  ,0,0,0,0,0,0,0,0,0,-14000,0,0,0,71000,85000,-14000,-14000
045763,南亞科統一93購01,0,0,0,0,0,0,0,0,0,-14000,0,0,0,10000,24000,-14000,-14000
043909,台光電凱基93購01,0,0,0,0,0,0,0,0,0,-14000,0,0,0,0,14000,-14000,-14000
04772P,欣興元大94售08  ,0,0,0,0,0,0,0,0,0,-14000,0,0,0,45000,59000,-14000,-14000
047235,嘉澤凱基93購01  ,0,0,0,0,0,0,0,0,0,-14000,0,0,0,30000,44000,-14000,-14000
050394,大立光元富94購09,0,0,0,0,0,0,0,0,0,-14000,0,0,0,0,14000,-14000,-14000
051351,台積電元大95購15,0,0,0,0,0,0,0,0,0,-14000,0,0,0,0,14000,-14000,-14000
05140P,台表科國票96售01,0,0,0,0,0,0,0,0,0,-14000,0,0,0,51000,65000,-14000,-14000
051020,健策凱基96購02  ,0,0,0,0,0,0,0,0,0,-14000,0,0,0,5000,19000,-14000,-14000
052449,創意元大95購04  ,0,0,0,0,0,0,0,0,0,-14000,0,0,0,1000,15000,-14000,-14000
05250P,臻鼎國票96售01  ,0,0,0,0,0,0,0,0,0,-14000,0,0,0,10000,24000,-14000,-14000
053959,晶豪科永豐96購02,0,0,0,0,0,0,0,0,0,-14000,0,0,0,1000,15000,-14000,-14000
053713,漢唐凱基96購04  ,0,0,0,0,0,0,0,0,0,-14000,0,0,0,62000,76000,-14000,-14000
052836,旺宏國泰98購01  ,0,0,0,0,0,0,0,0,0,-14000,0,0,0,23000,37000,-14000,-14000
05230P,京元電群益95售01,0,0,0,0,0,0,0,0,0,-14000,0,0,0,6000,20000,-14000,-14000
052690,台表科元大97購01,0,0,0,0,0,0,0,0,0,-14000,0,0,0,14000,28000,-14000,-14000
053293,聯發科中信9B購01,0,0,0,0,0,0,0,0,0,-14000,0,0,0,20000,34000,-14000,-14000
053260,喬山群益96購01  ,0,0,0,0,0,0,0,0,0,-14000,0,0,0,5000,19000,-14000,-14000
054097,淘帝國票97購01  ,0,0,0,0,0,0,0,0,0,-14000,0,0,0,0,14000,-14000,-14000
054184,A50正2永豐96購01,0,0,0,0,0,0,0,0,0,-14000,0,0,0,1000,15000,-14000,-14000
054212,聯詠國票97購03  ,0,0,0,0,0,0,0,0,0,-14000,0,0,0,0,14000,-14000,-14000
054550,旺宏凱基98購02  ,0,0,0,0,0,0,0,0,0,-14000,0,0,0,11000,25000,-14000,-14000
06370P,貿聯凱基97售03  ,0,0,0,0,0,0,0,0,0,-14000,0,0,0,0,14000,-14000,-14000
06383P,聯茂元富97售01  ,0,0,0,0,0,0,0,0,0,-14000,0,0,0,9000,23000,-14000,-14000
06299P,可成元大97售04  ,0,0,0,0,0,0,0,0,0,-14000,0,0,0,0,14000,-14000,-14000
1519,華城            ,121000,36000,85000,0,0,0,0,100000,-100000,1000,1000,0,1000,0,0,0,-14000
06600P,貿聯永豐98售01  ,0,0,0,0,0,0,0,0,0,-14000,0,0,0,0,14000,-14000,-14000
06715P,台積電元大99售04,0,0,0,0,0,0,0,0,0,-14000,0,0,0,0,14000,-14000,-14000
4438,廣越            ,7000,8000,-1000,0,0,0,0,15000,-15000,2000,2000,0,2000,0,0,0,-14000
3050,鈺德            ,6000,20000,-14000,0,0,0,0,0,0,0,0,0,0,0,0,0,-14000
3645,達邁            ,41000,56000,-15000,0,0,0,0,0,0,1000,1000,0,1000,0,0,0,-14000
3022,威強電          ,2000,16000,-14000,0,0,0,0,0,0,0,0,0,0,0,0,0,-14000
2486,一詮            ,32000,46000,-14000,0,0,0,0,0,0,0,0,0,0,0,0,0,-14000
2107,厚生            ,13000,27000,-14000,0,0,0,0,0,0,0,0,0,0,0,0,0,-14000
2388,威盛            ,18000,32000,-14000,0,0,0,0,0,0,0,0,0,0,0,0,0,-14000
2204,中華            ,162000,176400,-14400,0,0,0,0,0,0,0,0,0,0,0,0,0,-14400
05600P,玉晶光台新96售04,0,0,0,0,0,0,0,0,0,-15000,0,0,0,0,15000,-15000,-15000
056156,禾伸堂凱基98購04,0,0,0,0,0,0,0,0,0,-15000,0,0,0,10000,25000,-15000,-15000
056107,智易永豐97購02  ,0,0,0,0,0,0,0,0,0,-15000,0,0,0,22000,37000,-15000,-15000
056252,聯發科兆豐97購03,0,0,0,0,0,0,0,0,0,-15000,0,0,0,0,15000,-15000,-15000
056444,南亞科凱基99購01,0,0,0,0,0,0,0,0,0,-15000,0,0,0,41000,56000,-15000,-15000
055590,聯發科元大98購02,0,0,0,0,0,0,0,0,0,-15000,0,0,0,400000,415000,-15000,-15000
055753,貿聯第一98購01  ,0,0,0,0,0,0,0,0,0,-15000,0,0,0,0,15000,-15000,-15000
055937,康舒群益97購01  ,0,0,0,0,0,0,0,0,0,-15000,0,0,0,369000,384000,-15000,-15000
055912,宏達電凱基98購03,0,0,0,0,0,0,0,0,0,-15000,0,0,0,13000,28000,-15000,-15000
057004,滬深反中信9A購01,0,0,0,0,0,0,0,0,0,-15000,0,0,0,0,15000,-15000,-15000
056917,國巨兆豐98購03  ,0,0,0,0,0,0,0,0,0,-15000,0,0,0,0,15000,-15000,-15000
056925,群創兆豐98購03  ,0,0,0,0,0,0,0,0,0,-15000,0,0,0,0,15000,-15000,-15000
057079,台積電統一9A購02,0,0,0,0,0,0,0,0,0,-15000,0,0,0,0,15000,-15000,-15000
057068,國巨永豐98購06  ,0,0,0,0,0,0,0,0,0,-15000,0,0,0,11000,26000,-15000,-15000
057052,華擎元大98購01  ,0,0,0,0,0,0,0,0,0,-15000,0,0,0,582000,597000,-15000,-15000
056556,南電凱基98購01  ,0,0,0,0,0,0,0,0,0,-15000,0,0,0,11000,26000,-15000,-15000
056599,臻鼎元富98購01  ,0,0,0,0,0,0,0,0,0,-15000,0,0,0,84000,99000,-15000,-15000
056662,臺股指元大9A購09,0,0,0,0,0,0,0,0,0,-15000,0,0,0,0,15000,-15000,-15000
05747P,漢唐群益96售03  ,0,0,0,0,0,0,0,0,0,-15000,0,0,0,0,15000,-15000,-15000
057336,聯發科國票99購01,0,0,0,0,0,0,0,0,0,-15000,0,0,0,0,15000,-15000,-15000
057229,友達凱基9B購02  ,0,0,0,0,0,0,0,0,0,-15000,0,0,0,0,15000,-15000,-15000
057221,華通國票98購03  ,0,0,0,0,0,0,0,0,0,-15000,0,0,0,3000,18000,-15000,-15000
06137P,玉晶光永豐97售04,0,0,0,0,0,0,0,0,0,-15000,0,0,0,0,15000,-15000,-15000
05921P,同欣電元大96售06,0,0,0,0,0,0,0,0,0,-15000,0,0,0,10000,25000,-15000,-15000
048697,華新科國票94購06,0,0,0,0,0,0,0,0,0,-15000,0,0,0,13000,28000,-15000,-15000
048584,欣興富邦95購01  ,0,0,0,0,0,0,0,0,0,-15000,0,0,0,3000,18000,-15000,-15000
04730P,臺股指中信96售02,0,0,0,0,0,0,0,0,0,-15000,0,0,0,0,15000,-15000,-15000
047202,欣興元富96購01  ,0,0,0,0,0,0,0,0,0,-15000,0,0,0,0,15000,-15000,-15000
04848P,康控凱基94售02  ,0,0,0,0,0,0,0,0,0,-15000,0,0,0,0,15000,-15000,-15000
046877,燿華國泰94購01  ,0,0,0,0,0,0,0,0,0,-15000,0,0,0,20000,35000,-15000,-15000
046671,彩晶元大93購03  ,0,0,0,0,0,0,0,0,0,-15000,0,0,0,0,15000,-15000,-15000
044879,上証2X群益93購01,0,0,0,0,0,0,0,0,0,-15000,0,0,0,0,15000,-15000,-15000
047855,美律國票94購01  ,0,0,0,0,0,0,0,0,0,-15000,0,0,0,5000,20000,-15000,-15000
045479,T50反1中信95購01,0,0,0,0,0,0,0,0,0,-15000,0,0,0,0,15000,-15000,-15000
04301P,微星中信93售01  ,0,0,0,0,0,0,0,0,0,-15000,0,0,0,0,15000,-15000,-15000
00681R,元大美債20反1   ,0,0,0,0,0,0,0,0,0,-15000,0,0,0,0,15000,-15000,-15000
04198P,滬深2X群益95售04,0,0,0,0,0,0,0,0,0,-15000,0,0,0,0,15000,-15000,-15000
052173,廣達元大95購02  ,0,0,0,0,0,0,0,0,0,-15000,0,0,0,0,15000,-15000,-15000
049828,華新科凱基94購06,0,0,0,0,0,0,0,0,0,-15000,0,0,0,0,15000,-15000,-15000
049607,台積電兆豐94購04,0,0,0,0,0,0,0,0,0,-15000,0,0,0,30000,45000,-15000,-15000
049773,臺股指元富94購02,0,0,0,0,0,0,0,0,0,-15000,0,0,0,0,15000,-15000,-15000
049998,奇力新永豐94購03,0,0,0,0,0,0,0,0,0,-15000,0,0,0,20000,35000,-15000,-15000
050992,台積電元大97購01,0,0,0,0,0,0,0,0,0,-15000,0,0,0,10000,25000,-15000,-15000
050306,聯發科中信97購01,0,0,0,0,0,0,0,0,0,-15000,0,0,0,60000,75000,-15000,-15000
049516,光罩國票94購02  ,0,0,0,0,0,0,0,0,0,-15000,0,0,0,25000,40000,-15000,-15000
050787,致伸國泰96購01  ,0,0,0,0,0,0,0,0,0,-15000,0,0,0,10000,25000,-15000,-15000
051326,聯發科台新95購01,0,0,0,0,0,0,0,0,0,-15000,0,0,0,0,15000,-15000,-15000
049388,南電元大94購05  ,0,0,0,0,0,0,0,0,0,-15000,0,0,0,0,15000,-15000,-15000
051954,矽力元富95購04  ,0,0,0,0,0,0,0,0,0,-15000,0,0,0,0,15000,-15000,-15000
050463,百和元大94購04  ,0,0,0,0,0,0,0,0,0,-15000,0,0,0,0,15000,-15000,-15000
054608,致茂永豐97購01  ,0,0,0,0,0,0,0,0,0,-15000,0,0,0,60000,75000,-15000,-15000
054449,中環第一96購01  ,0,0,0,0,0,0,0,0,0,-15000,0,0,0,0,15000,-15000,-15000
054109,南亞科凱基96購05,0,0,0,0,0,0,0,0,0,-15000,0,0,0,10000,25000,-15000,-15000
054106,元油反凱基9C購01,0,0,0,0,0,0,0,0,0,-15000,0,0,0,0,15000,-15000,-15000
054120,奇力新永豐96購01,0,0,0,0,0,0,0,0,0,-15000,0,0,0,36000,51000,-15000,-15000
055115,日月光凱基98購01,0,0,0,0,0,0,0,0,0,-15000,0,0,0,150000,165000,-15000,-15000
055123,億光兆豐97購01  ,0,0,0,0,0,0,0,0,0,-15000,0,0,0,0,15000,-15000,-15000
055167,友訊統一97購01  ,0,0,0,0,0,0,0,0,0,-15000,0,0,0,113000,128000,-15000,-15000
05520P,聯詠凱基96售01  ,0,0,0,0,0,0,0,0,0,-15000,0,0,0,0,15000,-15000,-15000
055190,華新科元富97購01,0,0,0,0,0,0,0,0,0,-15000,0,0,0,35000,50000,-15000,-15000
055221,矽創凱基97購02  ,0,0,0,0,0,0,0,0,0,-15000,0,0,0,72000,87000,-15000,-15000
055222,臺股指凱基97購05,0,0,0,0,0,0,0,0,0,-15000,0,0,0,0,15000,-15000,-15000
055003,群創元富99購05  ,0,0,0,0,0,0,0,0,0,-15000,0,0,0,0,15000,-15000,-15000
054761,台光電國票98購02,0,0,0,0,0,0,0,0,0,-15000,0,0,0,42000,57000,-15000,-15000
053289,臺股指元大96購17,0,0,0,0,0,0,0,0,0,-15000,0,0,0,0,15000,-15000,-15000
053280,群創元大9C購01  ,0,0,0,0,0,0,0,0,0,-15000,0,0,0,245000,260000,-15000,-15000
052978,貿聯麥證97購01  ,0,0,0,20000,35000,-15000,0,0,0,-15000,0,0,0,20000,35000,-15000,-15000
053834,卜蜂永豐96購01  ,0,0,0,0,0,0,0,0,0,-15000,0,0,0,68000,83000,-15000,-15000
053889,致茂群益97購01  ,0,0,0,0,0,0,0,0,0,-15000,0,0,0,11000,26000,-15000,-15000
053442,光罩凱基96購01  ,0,0,0,0,0,0,0,0,0,-15000,0,0,0,0,15000,-15000,-15000
053480,祥碩元大96購02  ,0,0,0,0,0,0,0,0,0,-15000,0,0,0,6000,21000,-15000,-15000
4737,華廣            ,0,15000,-15000,0,0,0,0,0,0,0,0,0,0,0,0,0,-15000
6189,豐藝            ,0,15000,-15000,0,0,0,0,0,0,0,0,0,0,0,0,0,-15000
06683P,訊芯元大98售07  ,0,0,0,0,0,0,0,0,0,-15000,0,0,0,0,15000,-15000,-15000
06611P,祥碩國票98售01  ,0,0,0,0,0,0,0,0,0,-15000,0,0,0,0,15000,-15000,-15000
1720,生達            ,7000,22000,-15000,0,0,0,0,0,0,0,0,0,0,0,0,0,-15000
06497P,大立光凱基98售11,0,0,0,0,0,0,0,0,0,-15000,0,0,0,15000,30000,-15000,-15000
05830P,滬深2X元富99售03,0,0,0,0,0,0,0,0,0,-16000,0,0,0,116000,132000,-16000,-16000
06020P,燿華元富96售04  ,0,0,0,0,0,0,0,0,0,-16000,0,0,0,0,16000,-16000,-16000
057258,中環兆豐98購01  ,0,0,0,0,0,0,0,0,0,-16000,0,0,0,0,16000,-16000,-16000
05574P,英業達元富96售01,0,0,0,0,0,0,0,0,0,-16000,0,0,0,9000,25000,-16000,-16000
055487,國巨元大98購07  ,0,0,0,0,0,0,0,0,0,-16000,0,0,0,215000,231000,-16000,-16000
05599P,欣興台新96售01  ,0,0,0,0,0,0,0,0,0,-16000,0,0,0,0,16000,-16000,-16000
00757,統一FANG+       ,0,0,0,0,0,0,0,0,0,-16000,0,0,0,226000,242000,-16000,-16000
046259,和大凱基92購02  ,0,0,0,0,0,0,0,0,0,-16000,0,0,0,34000,50000,-16000,-16000
044507,燿華凱基93購03  ,0,0,0,0,0,0,0,0,0,-16000,0,0,0,50000,66000,-16000,-16000
045854,貿聯富邦93購01  ,0,0,0,0,0,0,0,0,0,-16000,0,0,0,0,16000,-16000,-16000
04598P,光罩凱基94售03  ,0,0,0,0,0,0,0,0,0,-16000,0,0,0,0,16000,-16000,-16000
048037,台表科凱基93購05,0,0,0,0,0,0,0,0,0,-16000,0,0,0,25000,41000,-16000,-16000
048634,華通元大94購01  ,0,0,0,0,0,0,0,0,0,-16000,0,0,0,100000,116000,-16000,-16000
050384,嘉澤國票94購02  ,0,0,0,0,0,0,0,0,0,-16000,0,0,0,0,16000,-16000,-16000
051432,群創元富99購03  ,0,0,0,0,0,0,0,0,0,-16000,0,0,0,0,16000,-16000,-16000
049264,奇鋐元大95購01  ,0,0,0,0,0,0,0,0,0,-16000,0,0,0,4000,20000,-16000,-16000
050081,聯發科統一94購07,0,0,0,0,0,0,0,0,0,-16000,0,0,0,0,16000,-16000,-16000
050731,昇陽半國票96購01,0,0,0,0,0,0,0,0,0,-16000,0,0,0,0,16000,-16000,-16000
051066,台積電國票96購02,0,0,0,0,0,0,0,0,0,-16000,0,0,0,0,16000,-16000,-16000
053407,台積電兆豐96購02,0,0,0,0,0,0,0,0,0,-16000,0,0,0,50000,66000,-16000,-16000
052983,國巨元大96購07  ,0,0,0,0,0,0,0,0,0,-16000,0,0,0,201000,217000,-16000,-16000
052237,嘉澤國票96購02  ,0,0,0,0,0,0,0,0,0,-16000,0,0,0,0,16000,-16000,-16000
054755,世紀鋼凱基98購01,0,0,0,0,0,0,0,0,0,-16000,0,0,0,0,16000,-16000,-16000
054977,SP黃豆元富9B購01,0,0,0,0,0,0,0,0,0,-16000,0,0,0,0,16000,-16000,-16000
054868,國泰金群益9A購01,0,0,0,0,0,0,0,0,0,-16000,0,0,0,0,16000,-16000,-16000
054895,南電統一97購01  ,0,0,0,0,0,0,0,0,0,-16000,0,0,0,50000,66000,-16000,-16000
055168,光罩統一98購01  ,0,0,0,0,0,0,0,0,0,-16000,0,0,0,20000,36000,-16000,-16000
06542P,台光電國票98售05,0,0,0,0,0,0,0,0,0,-16000,0,0,0,9000,25000,-16000,-16000
06637P,大立光凱基98售15,0,0,0,0,0,0,0,0,0,-16000,0,0,0,0,16000,-16000,-16000
06678P,大立光統一99售01,0,0,0,0,0,0,0,0,0,-16000,0,0,0,0,16000,-16000,-16000
3311,閎暉            ,1000,17000,-16000,0,0,0,0,0,0,0,0,0,0,0,0,0,-16000
3048,益登            ,32000,52000,-20000,0,0,0,0,0,0,4000,4000,0,4000,0,0,0,-16000
3056,總太            ,105000,121000,-16000,0,0,0,0,0,0,0,0,0,0,0,0,0,-16000
8429,金麗-KY         ,4000,20000,-16000,0,0,0,0,0,0,0,0,0,0,0,0,0,-16000
00700,富邦恒生國企    ,0,0,0,0,0,0,0,0,0,-16879,0,0,0,82121,99000,-16879,-16879
056226,聯發科凱基97購10,0,0,0,0,0,0,0,0,0,-17000,0,0,0,103000,120000,-17000,-17000
05545P,台表科國泰98售01,0,0,0,0,0,0,0,0,0,-17000,0,0,0,25000,42000,-17000,-17000
055439,台表科國票98購02,0,0,0,0,0,0,0,0,0,-17000,0,0,0,31000,48000,-17000,-17000
05720P,可成中信98售01  ,0,0,0,0,0,0,0,0,0,-17000,0,0,0,0,17000,-17000,-17000
057302,福懋科中信98購01,0,0,0,0,0,0,0,0,0,-17000,0,0,0,0,17000,-17000,-17000
056694,欣興群益98購04  ,0,0,0,0,0,0,0,0,0,-17000,0,0,0,8000,25000,-17000,-17000
056546,致伸凱基98購01  ,0,0,0,0,0,0,0,0,0,-17000,0,0,0,7000,24000,-17000,-17000
056786,亞光群益98購03  ,0,0,0,0,0,0,0,0,0,-17000,0,0,0,44000,61000,-17000,-17000
057169,微星元大98購01  ,0,0,0,0,0,0,0,0,0,-17000,0,0,0,33000,50000,-17000,-17000
00653L,富邦印度正2     ,0,4000,-4000,0,0,0,0,0,0,-13000,0,0,0,24000,37000,-13000,-17000
042502,上銀凱基93購01  ,0,0,0,0,0,0,0,0,0,-17000,0,0,0,3000,20000,-17000,-17000
03560P,台積電兆豐03售10,0,0,0,0,0,0,0,0,0,-17000,0,0,0,13000,30000,-17000,-17000
044964,旺宏中信94購01  ,0,0,0,0,0,0,0,0,0,-17000,0,0,0,118000,135000,-17000,-17000
051803,矽創永豐95購03  ,0,0,0,0,0,0,0,0,0,-17000,0,0,0,51000,68000,-17000,-17000
048600,嘉澤國票94購01  ,0,0,0,0,0,0,0,0,0,-17000,0,0,0,9000,26000,-17000,-17000
048114,景碩群益93購02  ,0,0,0,0,0,0,0,0,0,-17000,0,0,0,10000,27000,-17000,-17000
050914,健鼎中信95購01  ,0,0,0,0,0,0,0,0,0,-17000,0,0,0,3000,20000,-17000,-17000
050932,台塑國票96購01  ,0,0,0,0,0,0,0,0,0,-17000,0,0,0,0,17000,-17000,-17000
04947P,聯詠元大94售05  ,0,0,0,0,0,0,0,0,0,-17000,0,0,0,0,17000,-17000,-17000
04932P,香港2X中信96售01,0,0,0,0,0,0,0,0,0,-17000,0,0,0,13000,30000,-17000,-17000
055104,台達電凱基98購01,0,0,0,0,0,0,0,0,0,-17000,0,0,0,13000,30000,-17000,-17000
055264,國巨永豐98購01  ,0,0,0,0,0,0,0,0,0,-17000,0,0,0,107000,124000,-17000,-17000
054188,欣興永豐96購03  ,0,0,0,0,0,0,0,0,0,-17000,0,0,0,82000,99000,-17000,-17000
054516,國巨元大97購02  ,0,0,0,0,0,0,0,0,0,-17000,0,0,0,218000,235000,-17000,-17000
052324,康友元大96購02  ,0,0,0,0,0,0,0,0,0,-17000,0,0,0,96000,113000,-17000,-17000
053644,台表科國票97購03,0,0,0,0,0,0,0,0,0,-17000,0,0,0,23000,40000,-17000,-17000
4532,瑞智            ,14000,31000,-17000,0,0,0,0,0,0,0,0,0,0,0,0,0,-17000
6605,帝寶            ,0,17000,-17000,0,0,0,0,0,0,0,0,0,0,0,0,0,-17000
2705,六福            ,0,17000,-17000,0,0,0,0,0,0,0,0,0,0,0,0,0,-17000
06661P,玉晶光永豐98售05,0,0,0,0,0,0,0,0,0,-17000,0,0,0,0,17000,-17000,-17000
1437,勤益控          ,7000,24000,-17000,0,0,0,0,0,0,0,0,0,0,0,0,0,-17000
06568P,國巨永豐98售05  ,0,0,0,0,0,0,0,0,0,-17000,0,0,0,0,17000,-17000,-17000
056716,康舒永豐98購01  ,0,0,0,0,0,0,0,0,0,-18000,0,0,0,280000,298000,-18000,-18000
056836,國巨元富98購01  ,0,0,0,0,0,0,0,0,0,-18000,0,0,0,9000,27000,-18000,-18000
057469,康友永豐98購02  ,0,0,0,0,0,0,0,0,0,-18000,0,0,0,20000,38000,-18000,-18000
05772P,景碩凱基96售02  ,0,0,0,0,0,0,0,0,0,-18000,0,0,0,0,18000,-18000,-18000
055316,上銀國票98購01  ,0,0,0,0,0,0,0,0,0,-18000,0,0,0,372000,390000,-18000,-18000
055467,國巨凱基97購05  ,0,0,0,0,0,0,0,0,0,-18000,0,0,0,65000,83000,-18000,-18000
055715,智邦元大97購04  ,0,0,0,0,0,0,0,0,0,-18000,0,0,0,42000,60000,-18000,-18000
055677,喬山凱基97購01  ,0,0,0,0,0,0,0,0,0,-18000,0,0,0,73000,91000,-18000,-18000
055821,勤誠國票98購01  ,0,0,0,0,0,0,0,0,0,-18000,0,0,0,304000,322000,-18000,-18000
056443,南亞科凱基98購03,0,0,0,0,0,0,0,0,0,-18000,0,0,0,15000,33000,-18000,-18000
048736,台達電統一94購01,0,0,0,0,0,0,0,0,0,-18000,0,0,0,0,18000,-18000,-18000
04879P,康控永豐94售02  ,0,0,0,0,0,0,0,0,0,-18000,0,0,0,0,18000,-18000,-18000
047182,智邦元大93購07  ,0,0,0,0,0,0,0,0,0,-18000,0,0,0,32000,50000,-18000,-18000
051486,玉晶光凱基97購03,0,0,0,0,0,0,0,0,0,-18000,0,0,0,47000,65000,-18000,-18000
045325,元油2X永豐94購01,0,0,0,0,0,0,0,0,0,-18000,0,0,0,0,18000,-18000,-18000
03199P,台積電統一01售16,0,0,0,0,0,0,0,0,0,-18000,0,0,0,2000,20000,-18000,-18000
00733,富邦臺灣中小    ,0,0,0,0,0,0,0,0,0,-18000,0,0,0,202000,220000,-18000,-18000
050416,高股息凱基96購02,0,0,0,0,0,0,0,0,0,-18000,0,0,0,2000,20000,-18000,-18000
051928,大立光中信96購03,0,0,0,0,0,0,0,0,0,-18000,0,0,0,16000,34000,-18000,-18000
050261,國巨元大95購04  ,0,0,0,0,0,0,0,0,0,-18000,0,0,0,10000,28000,-18000,-18000
050780,台表科元大96購01,0,0,0,0,0,0,0,0,0,-18000,0,0,0,3000,21000,-18000,-18000
052887,華通中信96購01  ,0,0,0,0,0,0,0,0,0,-18000,0,0,0,0,18000,-18000,-18000
054678,麗豐台新98購02  ,0,0,0,0,0,0,0,0,0,-18000,0,0,0,30000,48000,-18000,-18000
054204,元金2X國票9B購02,0,0,0,0,0,0,0,0,0,-18000,0,0,0,32000,50000,-18000,-18000
054896,聯茂日盛97購01  ,0,0,0,0,0,0,0,0,0,-18000,0,0,0,452000,470000,-18000,-18000
054882,台光電統一97購02,0,0,0,0,0,0,0,0,0,-18000,0,0,0,30000,48000,-18000,-18000
054982,國巨元富97購03  ,0,0,0,0,0,0,0,0,0,-18000,0,0,0,579000,597000,-18000,-18000
06181P,國巨中信97售02  ,0,0,0,0,0,0,0,0,0,-18000,0,0,0,0,18000,-18000,-18000
1305,華夏            ,110000,127000,-17000,0,0,0,0,0,0,-1000,0,0,0,0,1000,-1000,-18000
2059,川湖            ,25000,42000,-17000,0,0,0,0,0,0,-1000,0,0,0,1000,2000,-1000,-18000
6152,百一            ,0,18000,-18000,0,0,0,0,0,0,0,0,0,0,0,0,0,-18000
3501,維熹            ,2000,20000,-18000,0,0,0,0,0,0,0,0,0,0,0,0,0,-18000
3622,洋華            ,23000,41000,-18000,0,0,0,0,0,0,0,0,0,0,0,0,0,-18000
8110,華東            ,43000,79000,-36000,0,0,0,0,0,0,18000,18000,0,18000,0,0,0,-18000
056542,緯創凱基98購01  ,0,0,0,0,0,0,0,0,0,-19000,0,0,0,0,19000,-19000,-19000
056358,友訊元大99購01  ,0,0,0,0,0,0,0,0,0,-19000,0,0,0,76000,95000,-19000,-19000
055726,台表科元大98購03,0,0,0,0,0,0,0,0,0,-19000,0,0,0,0,19000,-19000,-19000
055720,宏達電元大97購05,0,0,0,0,0,0,0,0,0,-19000,0,0,0,2000,21000,-19000,-19000
057449,華新科元富99購02,0,0,0,0,0,0,0,0,0,-19000,0,0,0,0,19000,-19000,-19000
057321,台泥群益98購01  ,0,0,0,0,0,0,0,0,0,-19000,0,0,0,0,19000,-19000,-19000
06076P,大立光凱基98售03,0,0,0,0,0,0,0,0,0,-19000,0,0,0,0,19000,-19000,-19000
056710,漢唐永豐98購01  ,0,0,0,0,0,0,0,0,0,-19000,0,0,0,49000,68000,-19000,-19000
057109,信邦群益98購01  ,0,0,0,0,0,0,0,0,0,-19000,0,0,0,16000,35000,-19000,-19000
041824,元油2X國票96購01,0,0,0,0,0,0,0,0,0,-19000,0,0,0,1000,20000,-19000,-19000
03646C,臺股指元大95牛32,0,0,0,0,0,0,0,0,0,-19000,0,0,0,0,19000,-19000,-19000
042903,金寶元大94購01  ,0,0,0,0,0,0,0,0,0,-19000,0,0,0,45000,64000,-19000,-19000
04353P,全新永豐94售01  ,0,0,0,0,0,0,0,0,0,-19000,0,0,0,0,19000,-19000,-19000
045856,南亞科國泰94購01,0,0,0,0,0,0,0,0,0,-19000,0,0,0,0,19000,-19000,-19000
049234,可成統一94購02  ,0,0,0,0,0,0,0,0,0,-19000,0,0,0,48000,67000,-19000,-19000
046831,大立光群益94購01,0,0,0,0,0,0,0,0,0,-19000,0,0,0,12000,31000,-19000,-19000
047437,旺宏元大94購02  ,0,0,0,0,0,0,0,0,0,-19000,0,0,0,0,19000,-19000,-19000
051118,台塑群益95購01  ,0,0,0,0,0,0,0,0,0,-19000,0,0,0,11000,30000,-19000,-19000
051215,大立光統一95購03,0,0,0,0,0,0,0,0,0,-19000,0,0,0,2000,21000,-19000,-19000
051915,日月光元大96購01,0,0,0,0,0,0,0,0,0,-19000,0,0,0,120000,139000,-19000,-19000
052077,可成元富98購02  ,0,0,0,0,0,0,0,0,0,-19000,0,0,0,10000,29000,-19000,-19000
050121,南電元大95購02  ,0,0,0,0,0,0,0,0,0,-19000,0,0,0,0,19000,-19000,-19000
051030,康友元富95購01  ,0,0,0,0,0,0,0,0,0,-19000,0,0,0,0,19000,-19000,-19000
05104P,智邦台新95售02  ,0,0,0,0,0,0,0,0,0,-19000,0,0,0,0,19000,-19000,-19000
052380,臺股指元大95購21,0,0,0,0,0,0,0,0,0,-19000,0,0,0,0,19000,-19000,-19000
05248P,矽創群益96售01  ,0,0,0,0,0,0,0,0,0,-19000,0,0,0,20000,39000,-19000,-19000
05470P,康控元大95售05  ,0,0,0,0,0,0,0,0,0,-19000,0,0,0,3000,22000,-19000,-19000
054145,嘉聯益元大98購01,0,0,0,0,0,0,0,0,0,-19000,0,0,0,0,19000,-19000,-19000
054479,緯創中信98購01  ,0,0,0,0,0,0,0,0,0,-19000,0,0,0,19000,38000,-19000,-19000
054464,奇力新凱基98購02,0,0,0,0,0,0,0,0,0,-19000,0,0,0,57000,76000,-19000,-19000
052834,彩晶群益96購01  ,0,0,0,0,0,0,0,0,0,-19000,0,0,0,11000,30000,-19000,-19000
052806,玉晶光元大98購04,0,0,0,0,0,0,0,0,0,-19000,0,0,0,37000,56000,-19000,-19000
053224,矽力凱基96購02  ,0,0,0,0,0,0,0,0,0,-19000,0,0,0,51000,70000,-19000,-19000
053152,大立光元大99購01,0,0,0,0,0,0,0,0,0,-19000,0,0,0,62000,81000,-19000,-19000
053635,技嘉永豐96購01  ,0,0,0,0,0,0,0,0,0,-19000,0,0,0,218000,237000,-19000,-19000
05388P,南亞科元大95售04,0,0,0,0,0,0,0,0,0,-19000,0,0,0,74000,93000,-19000,-19000
2636,台驊投控        ,6000,25000,-19000,0,0,0,0,0,0,0,0,0,0,0,0,0,-19000
2605,新興            ,110000,137000,-27000,0,0,0,0,0,0,8000,14000,6000,8000,0,0,0,-19000
3031,佰鴻            ,2000,21000,-19000,0,0,0,0,0,0,0,0,0,0,0,0,0,-19000
057090,奇力新元富98購02,0,0,0,0,0,0,0,0,0,-20000,0,0,0,0,20000,-20000,-20000
057176,全新元大99購02  ,0,0,0,0,0,0,0,0,0,-20000,0,0,0,0,20000,-20000,-20000
057147,新日興國票99購01,0,0,0,0,0,0,0,0,0,-20000,0,0,0,9000,29000,-20000,-20000
056924,亞光兆豐98購01  ,0,0,0,0,0,0,0,0,0,-20000,0,0,0,0,20000,-20000,-20000
056725,鴻海國票99購03  ,0,0,0,0,0,0,0,0,0,-20000,0,0,0,0,20000,-20000,-20000
056778,元石油群益9B購01,0,0,0,0,0,0,0,0,0,-20000,0,0,0,0,20000,-20000,-20000
056868,奇力新麥證98購01,0,0,0,10000,30000,-20000,0,0,0,-20000,0,0,0,10000,30000,-20000,-20000
056803,群創台新99購02  ,0,0,0,0,0,0,0,0,0,-20000,0,0,0,0,20000,-20000,-20000
056560,旺宏群益98購03  ,0,0,0,0,0,0,0,0,0,-20000,0,0,0,12000,32000,-20000,-20000
056592,台積電元富98購01,0,0,0,0,0,0,0,0,0,-20000,0,0,0,320000,340000,-20000,-20000
056658,美食元大98購01  ,0,0,0,0,0,0,0,0,0,-20000,0,0,0,45000,65000,-20000,-20000
05932P,鴻海凱基96售16  ,0,0,0,0,0,0,0,0,0,-20000,0,0,0,0,20000,-20000,-20000
057212,台積電群益98購03,0,0,0,0,0,0,0,0,0,-20000,0,0,0,0,20000,-20000,-20000
057484,南亞科元大98購06,0,0,0,0,0,0,0,0,0,-20000,0,0,0,0,20000,-20000,-20000
057442,玉晶光統一98購03,0,0,0,0,0,0,0,0,0,-20000,0,0,0,0,20000,-20000,-20000
05765P,臺股指永豐96售01,0,0,0,0,0,0,0,0,0,-20000,0,0,0,0,20000,-20000,-20000
055724,祥碩元大97購03  ,0,0,0,0,0,0,0,0,0,-20000,0,0,0,1000,21000,-20000,-20000
055737,開發金元富97購01,0,0,0,0,0,0,0,0,0,-20000,0,0,0,0,20000,-20000,-20000
055666,鴻海群益97購05  ,0,0,0,0,0,0,0,0,0,-20000,0,0,0,20000,40000,-20000,-20000
055688,力成凱基98購02  ,0,0,0,0,0,0,0,0,0,-20000,0,0,0,13000,33000,-20000,-20000
055823,臺股指國票97購10,0,0,0,0,0,0,0,0,0,-20000,0,0,0,0,20000,-20000,-20000
055874,中環元富9A購01  ,0,0,0,0,0,0,0,0,0,-20000,0,0,0,0,20000,-20000,-20000
055538,鴻海日盛97購04  ,0,0,0,0,0,0,0,0,0,-20000,0,0,0,21000,41000,-20000,-20000
055365,華通元大97購03  ,0,0,0,0,0,0,0,0,0,-20000,0,0,0,6000,26000,-20000,-20000
05542P,滬深2X元富96售01,0,0,0,0,0,0,0,0,0,-20000,0,0,0,0,20000,-20000,-20000
055452,台積電元富97購03,0,0,0,0,0,0,0,0,0,-20000,0,0,0,0,20000,-20000,-20000
056352,鴻海元大99購01  ,0,0,0,0,0,0,0,0,0,-20000,0,0,0,3000,23000,-20000,-20000
056336,南亞科凱基98購02,0,0,0,0,0,0,0,0,0,-20000,0,0,0,18000,38000,-20000,-20000
056524,欣興中信98購02  ,0,0,0,0,0,0,0,0,0,-20000,0,0,0,0,20000,-20000,-20000
056172,鴻海元富97購11  ,0,0,0,0,0,0,0,0,0,-20000,0,0,0,0,20000,-20000,-20000
056173,廣達元富97購01  ,0,0,0,0,0,0,0,0,0,-20000,0,0,0,10000,30000,-20000,-20000
05598P,國巨元富96售03  ,0,0,0,0,0,0,0,0,0,-20000,0,0,0,170000,190000,-20000,-20000
055987,台表科元富97購01,0,0,0,0,0,0,0,0,0,-20000,0,0,0,0,20000,-20000,-20000
047441,聯發科元大93購15,0,0,0,0,0,0,0,0,0,-20000,0,0,0,0,20000,-20000,-20000
047457,旺宏群益95購01  ,0,0,0,0,0,0,0,0,0,-20000,0,0,0,20000,40000,-20000,-20000
047674,群創元富96購02  ,0,0,0,0,0,0,0,0,0,-20000,0,0,0,0,20000,-20000,-20000
048302,上証反凱基93購01,0,0,0,0,0,0,0,0,0,-20000,0,0,0,0,20000,-20000,-20000
04832P,為升元大94售09  ,0,0,0,0,0,0,0,0,0,-20000,0,0,0,0,20000,-20000,-20000
048109,旺宏群益94購02  ,0,0,0,0,0,0,0,0,0,-20000,0,0,0,0,20000,-20000,-20000
051793,臻鼎國票95購02  ,0,0,0,0,0,0,0,0,0,-20000,0,0,0,20000,40000,-20000,-20000
051794,臻鼎國票96購02  ,0,0,0,0,0,0,0,0,0,-20000,0,0,0,0,20000,-20000,-20000
051796,和碩康和95購01  ,0,0,0,0,0,0,0,0,0,-20000,0,0,0,0,20000,-20000,-20000
051812,臻鼎凱基95購03  ,0,0,0,0,0,0,0,0,0,-20000,0,0,0,0,20000,-20000,-20000
051435,聯茂元富95購01  ,0,0,0,0,0,0,0,0,0,-20000,0,0,0,10000,30000,-20000,-20000
051437,百和元富95購02  ,0,0,0,0,0,0,0,0,0,-20000,0,0,0,0,20000,-20000,-20000
051476,聯發科凱基95購09,0,0,0,0,0,0,0,0,0,-20000,0,0,0,0,20000,-20000,-20000
051854,鴻海麥證95購04  ,0,0,0,0,20000,-20000,0,0,0,-20000,0,0,0,0,20000,-20000,-20000
047189,聯詠元大93購05  ,0,0,0,0,0,0,0,0,0,-20000,0,0,0,0,20000,-20000,-20000
047135,可成凱基93購05  ,0,0,0,0,0,0,0,0,0,-20000,0,0,0,20000,40000,-20000,-20000
048624,美律台新93購01  ,0,0,0,0,0,0,0,0,0,-20000,0,0,0,0,20000,-20000,-20000
046989,可成凱基93購03  ,0,0,0,0,0,0,0,0,0,-20000,0,0,0,10000,30000,-20000,-20000
043599,宏達電元大93購03,0,0,0,0,0,0,0,0,0,-20000,0,0,0,0,20000,-20000,-20000
04465P,大立光元富94售03,0,0,0,0,0,0,0,0,0,-20000,0,0,0,0,20000,-20000,-20000
044510,台光電凱基93購04,0,0,0,0,0,0,0,0,0,-20000,0,0,0,0,20000,-20000,-20000
044430,上銀元大92購03  ,0,0,0,0,0,0,0,0,0,-20000,0,0,0,0,20000,-20000,-20000
044864,道瓊反國票96購01,0,0,0,0,0,0,0,0,0,-20000,0,0,0,0,20000,-20000,-20000
044711,台郡元大93購01  ,0,0,0,0,0,0,0,0,0,-20000,0,0,0,20000,40000,-20000,-20000
044401,亞光凱基93購01  ,0,0,0,0,0,0,0,0,0,-20000,0,0,0,0,20000,-20000,-20000
045410,華邦電群益94購01,0,0,0,0,0,0,0,0,0,-20000,0,0,0,0,20000,-20000,-20000
04505P,佳世達元富96售03,0,0,0,0,0,0,0,0,0,-20000,0,0,0,0,20000,-20000,-20000
045503,群創凱基93購09  ,0,0,0,0,0,0,0,0,0,-20000,0,0,0,0,20000,-20000,-20000
045504,群創凱基94購01  ,0,0,0,0,0,0,0,0,0,-20000,0,0,0,7000,27000,-20000,-20000
046466,台虹凱基92購01  ,0,0,0,0,0,0,0,0,0,-20000,0,0,0,0,20000,-20000,-20000
046408,宏達電元大92購06,0,0,0,0,0,0,0,0,0,-20000,0,0,0,0,20000,-20000,-20000
047988,志超群益93購02  ,0,0,0,0,0,0,0,0,0,-20000,0,0,0,0,20000,-20000,-20000
046491,滬深2X富邦95購02,0,0,0,0,0,0,0,0,0,-20000,0,0,0,0,20000,-20000,-20000
047991,元油反元大96購05,0,0,0,0,0,0,0,0,0,-20000,0,0,0,0,20000,-20000,-20000
047997,南亞科元大93購03,0,0,0,0,0,0,0,0,0,-20000,0,0,0,30000,50000,-20000,-20000
046324,健策元大92購05  ,0,0,0,0,0,0,0,0,0,-20000,0,0,0,0,20000,-20000,-20000
047922,聯發科凱基94購01,0,0,0,0,0,0,0,0,0,-20000,0,0,0,60000,80000,-20000,-20000
047926,可成凱基94購02  ,0,0,0,0,0,0,0,0,0,-20000,0,0,0,0,20000,-20000,-20000
045591,彩晶元大93購01  ,0,0,0,0,0,0,0,0,0,-20000,0,0,0,0,20000,-20000,-20000
045626,上銀凱基93購05  ,0,0,0,0,0,0,0,0,0,-20000,0,0,0,0,20000,-20000,-20000
045669,華通元大93購02  ,0,0,0,0,0,0,0,0,0,-20000,0,0,0,0,20000,-20000,-20000
043460,台積電元大93購01,0,0,0,0,0,0,0,0,0,-20000,0,0,0,0,20000,-20000,-20000
04626P,聯發科元大94售07,0,0,0,0,0,0,0,0,0,-20000,0,0,0,0,20000,-20000,-20000
046254,台表科群益92購02,0,0,0,0,0,0,0,0,0,-20000,0,0,0,0,20000,-20000,-20000
046235,台表科元大92購03,0,0,0,0,0,0,0,0,0,-20000,0,0,0,20000,40000,-20000,-20000
046202,台表科凱基93購04,0,0,0,0,0,0,0,0,0,-20000,0,0,0,0,20000,-20000,-20000
03751P,旺宏富邦95售01  ,0,0,0,0,0,0,0,0,0,-20000,0,0,0,0,20000,-20000,-20000
03645C,臺股指凱基96牛27,0,0,0,0,0,0,0,0,0,-20000,0,0,0,0,20000,-20000,-20000
03642C,臺股指元大94牛27,0,0,0,0,0,0,0,0,0,-20000,0,0,0,0,20000,-20000,-20000
03993P,滬深2X中信94售03,0,0,0,0,0,0,0,0,0,-20000,0,0,0,0,20000,-20000,-20000
04022P,群創元富96售04  ,0,0,0,0,0,0,0,0,0,-20000,0,0,0,0,20000,-20000,-20000
046148,友達中信94購01  ,0,0,0,0,0,0,0,0,0,-20000,0,0,0,0,20000,-20000,-20000
04610P,世紀鋼永豐94售03,0,0,0,0,0,0,0,0,0,-20000,0,0,0,0,20000,-20000,-20000
04203P,超眾元大93售04  ,0,0,0,0,0,0,0,0,0,-20000,0,0,0,0,20000,-20000,-20000
03219P,台積電康和02售01,0,0,0,0,0,0,0,0,0,-20000,0,0,0,0,20000,-20000,-20000
03375P,玉晶光元大02售07,0,0,0,0,0,0,0,0,0,-20000,0,0,0,233000,253000,-20000,-20000
00686R,群益臺灣加權反1 ,0,0,0,0,0,0,0,0,0,-20000,0,0,0,10000,30000,-20000,-20000
05240P,玉晶光永豐96售01,0,0,0,0,0,0,0,0,0,-20000,0,0,0,0,20000,-20000,-20000
052404,臻鼎凱基95購05  ,0,0,0,0,0,0,0,0,0,-20000,0,0,0,0,20000,-20000,-20000
052378,矽力元大96購01  ,0,0,0,0,0,0,0,0,0,-20000,0,0,0,18000,38000,-20000,-20000
052674,智邦國泰98購01  ,0,0,0,0,0,0,0,0,0,-20000,0,0,0,10000,30000,-20000,-20000
052125,群創國票95購02  ,0,0,0,0,0,0,0,0,0,-20000,0,0,0,0,20000,-20000,-20000
049904,矽力元富94購01  ,0,0,0,0,0,0,0,0,0,-20000,0,0,0,40000,60000,-20000,-20000
052156,滬深2X永豐95購03,0,0,0,0,0,0,0,0,0,-20000,0,0,0,0,20000,-20000,-20000
050923,南亞科凱基95購03,0,0,0,0,0,0,0,0,0,-20000,0,0,0,15000,35000,-20000,-20000
049622,聯詠群益94購02  ,0,0,0,0,0,0,0,0,0,-20000,0,0,0,5000,25000,-20000,-20000
051362,台郡元大95購04  ,0,0,0,0,0,0,0,0,0,-20000,0,0,0,61000,81000,-20000,-20000
050966,日月光永豐95購01,0,0,0,0,0,0,0,0,0,-20000,0,0,0,0,20000,-20000,-20000
051003,中環中信97購01  ,0,0,0,0,0,0,0,0,0,-20000,0,0,0,0,20000,-20000,-20000
050963,強茂永豐95購01  ,0,0,0,0,0,0,0,0,0,-20000,0,0,0,0,20000,-20000,-20000
050951,緯創群益96購01  ,0,0,0,0,0,0,0,0,0,-20000,0,0,0,0,20000,-20000,-20000
049962,台光電元富94購01,0,0,0,0,0,0,0,0,0,-20000,0,0,0,0,20000,-20000,-20000
049795,華通元大96購02  ,0,0,0,0,0,0,0,0,0,-20000,0,0,0,5000,25000,-20000,-20000
048852,旺宏群益96購02  ,0,0,0,0,0,0,0,0,0,-20000,0,0,0,2000,22000,-20000,-20000
048883,玉晶光統一94購01,0,0,0,0,0,0,0,0,0,-20000,0,0,0,0,20000,-20000,-20000
048986,訊連元大94購01  ,0,0,0,0,0,0,0,0,0,-20000,0,0,0,0,20000,-20000,-20000
050143,臻鼎元富94購05  ,0,0,0,0,0,0,0,0,0,-20000,0,0,0,0,20000,-20000,-20000
050097,可成國泰96購02  ,0,0,0,0,0,0,0,0,0,-20000,0,0,0,69000,89000,-20000,-20000
050087,美食台新94購01  ,0,0,0,0,0,0,0,0,0,-20000,0,0,0,0,20000,-20000,-20000
050076,百和凱基94購02  ,0,0,0,0,0,0,0,0,0,-20000,0,0,0,0,20000,-20000,-20000
050496,鴻海富邦96購01  ,0,0,0,0,0,0,0,0,0,-20000,0,0,0,0,20000,-20000,-20000
049270,台表科元大95購02,0,0,0,0,0,0,0,0,0,-20000,0,0,0,0,20000,-20000,-20000
052085,聯電元大95購01  ,0,0,0,0,0,0,0,0,0,-20000,0,0,0,0,20000,-20000,-20000
052024,臺股指永豐95購04,0,0,0,0,0,0,0,0,0,-20000,0,0,0,0,20000,-20000,-20000
05043P,佳世達元富95售01,0,0,0,0,0,0,0,0,0,-20000,0,0,0,0,20000,-20000,-20000
049309,台達電凱基94購05,0,0,0,0,0,0,0,0,0,-20000,0,0,0,0,20000,-20000,-20000
049289,樺漢兆豐94購01  ,0,0,0,0,0,0,0,0,0,-20000,0,0,0,0,20000,-20000,-20000
051233,力成群益97購01  ,0,0,0,0,0,0,0,0,0,-20000,0,0,0,5000,25000,-20000,-20000
051205,華新科麥證95購02,0,0,0,0,20000,-20000,0,0,0,-20000,0,0,0,0,20000,-20000,-20000
051313,緯創麥證95購02  ,0,0,0,20000,40000,-20000,0,0,0,-20000,0,0,0,20000,40000,-20000,-20000
051115,華通麥證96購01  ,0,0,0,6000,26000,-20000,0,0,0,-20000,0,0,0,6000,26000,-20000,-20000
051094,健策元大96購03  ,0,0,0,0,0,0,0,0,0,-20000,0,0,0,45000,65000,-20000,-20000
051771,上銀中信95購01  ,0,0,0,0,0,0,0,0,0,-20000,0,0,0,37000,57000,-20000,-20000
050669,嘉晶永豐96購01  ,0,0,0,0,0,0,0,0,0,-20000,0,0,0,0,20000,-20000,-20000
050190,麗豐元大95購02  ,0,0,0,0,0,0,0,0,0,-20000,0,0,0,0,20000,-20000,-20000
050162,中環國泰95購01  ,0,0,0,0,0,0,0,0,0,-20000,0,0,0,0,20000,-20000,-20000
050228,中磊中信96購01  ,0,0,0,0,0,0,0,0,0,-20000,0,0,0,0,20000,-20000,-20000
049485,台積電元大96購03,0,0,0,0,0,0,0,0,0,-20000,0,0,0,0,20000,-20000,-20000
050726,可成國票96購01  ,0,0,0,0,0,0,0,0,0,-20000,0,0,0,0,20000,-20000,-20000
053862,南亞科元大97購02,0,0,0,0,0,0,0,0,0,-20000,0,0,0,21000,41000,-20000,-20000
053967,華邦電元大96購03,0,0,0,0,0,0,0,0,0,-20000,0,0,0,0,20000,-20000,-20000
053678,南亞科富邦97購01,0,0,0,0,0,0,0,0,0,-20000,0,0,0,16000,36000,-20000,-20000
053608,彩晶第一96購01  ,0,0,0,0,0,0,0,0,0,-20000,0,0,0,0,20000,-20000,-20000
053520,康友群益96購01  ,0,0,0,0,0,0,0,0,0,-20000,0,0,0,2000,22000,-20000,-20000
053560,漢唐國泰98購01  ,0,0,0,0,0,0,0,0,0,-20000,0,0,0,0,20000,-20000,-20000
053449,超眾凱基98購01  ,0,0,0,0,0,0,0,0,0,-20000,0,0,0,114000,134000,-20000,-20000
053446,欣興凱基96購02  ,0,0,0,0,0,0,0,0,0,-20000,0,0,0,0,20000,-20000,-20000
053156,緯創元大96購02  ,0,0,0,0,0,0,0,0,0,-20000,0,0,0,0,20000,-20000,-20000
053242,聯電國票96購04  ,0,0,0,0,0,0,0,0,0,-20000,0,0,0,0,20000,-20000,-20000
052996,聯電康和96購01  ,0,0,0,0,0,0,0,0,0,-20000,0,0,0,0,20000,-20000,-20000
053117,大立光中信9A購02,0,0,0,0,0,0,0,0,0,-20000,0,0,0,0,20000,-20000,-20000
052698,深中小國票99購01,0,0,0,0,0,0,0,0,0,-20000,0,0,0,99000,119000,-20000,-20000
052737,滬深2X元大96購06,0,0,0,0,0,0,0,0,0,-20000,0,0,0,0,20000,-20000,-20000
052277,台達電凱基97購01,0,0,0,0,0,0,0,0,0,-20000,0,0,0,10000,30000,-20000,-20000
05285P,同欣電群益95售02,0,0,0,0,0,0,0,0,0,-20000,0,0,0,130000,150000,-20000,-20000
052307,潤泰全國泰96購01,0,0,0,0,0,0,0,0,0,-20000,0,0,0,0,20000,-20000,-20000
052905,潤泰全國票97購01,0,0,0,0,0,0,0,0,0,-20000,0,0,0,0,20000,-20000,-20000
054476,聯發科中信96購03,0,0,0,0,0,0,0,0,0,-20000,0,0,0,0,20000,-20000,-20000
054519,禾伸堂元大97購02,0,0,0,0,0,0,0,0,0,-20000,0,0,0,36000,56000,-20000,-20000
054360,智邦凱基96購03  ,0,0,0,0,0,0,0,0,0,-20000,0,0,0,32000,52000,-20000,-20000
054355,上海銀富邦98購01,0,0,0,0,0,0,0,0,0,-20000,0,0,0,1000,21000,-20000,-20000
054604,麗豐台新98購01  ,0,0,0,0,0,0,0,0,0,-20000,0,0,0,20000,40000,-20000,-20000
054605,鴻海永豐97購01  ,0,0,0,0,0,0,0,0,0,-20000,0,0,0,0,20000,-20000,-20000
054538,台光電國票98購01,0,0,0,0,0,0,0,0,0,-20000,0,0,0,0,20000,-20000,-20000
054563,泰碩群益99購01  ,0,0,0,0,0,0,0,0,0,-20000,0,0,0,0,20000,-20000,-20000
054116,順德康和96購01  ,0,0,0,0,0,0,0,0,0,-20000,0,0,0,0,20000,-20000,-20000
054089,台積電群益96購11,0,0,0,0,0,0,0,0,0,-20000,0,0,0,85000,105000,-20000,-20000
054247,華邦電元大96購04,0,0,0,0,0,0,0,0,0,-20000,0,0,0,0,20000,-20000,-20000
054298,台表科元大97購03,0,0,0,0,0,0,0,0,0,-20000,0,0,0,0,20000,-20000,-20000
054735,漢唐凱基98購01  ,0,0,0,0,0,0,0,0,0,-20000,0,0,0,0,20000,-20000,-20000
055004,群創元富99購06  ,0,0,0,0,0,0,0,0,0,-20000,0,0,0,70000,90000,-20000,-20000
054964,智易元大99購01  ,0,0,0,0,0,0,0,0,0,-20000,0,0,0,0,20000,-20000,-20000
054929,群電凱基97購01  ,0,0,0,0,0,0,0,0,0,-20000,0,0,0,0,20000,-20000,-20000
055303,鈺齊元大97購01  ,0,0,0,0,0,0,0,0,0,-20000,0,0,0,0,20000,-20000,-20000
05522P,友達元富96售02  ,0,0,0,0,0,0,0,0,0,-20000,0,0,0,0,20000,-20000,-20000
055253,大立光統一97購06,0,0,0,0,0,0,0,0,0,-20000,0,0,0,210000,230000,-20000,-20000
055105,鴻海凱基98購05  ,0,0,0,0,0,0,0,0,0,-20000,0,0,0,98000,118000,-20000,-20000
05514P,康舒永豐96售01  ,0,0,0,0,0,0,0,0,0,-20000,0,0,0,0,20000,-20000,-20000
3321,同泰            ,11000,31000,-20000,0,0,0,0,0,0,0,0,0,0,0,0,0,-20000
08671P,友訊國票01售01  ,0,0,0,0,0,0,0,0,0,-20000,0,0,0,0,20000,-20000,-20000
06241P,大立光元富9A售01,0,0,0,0,0,0,0,0,0,-20000,0,0,0,18000,38000,-20000,-20000
06326P,鴻海中信01售01  ,0,0,0,0,0,0,0,0,0,-20000,0,0,0,51000,71000,-20000,-20000
06359P,上銀群益97售03  ,0,0,0,0,0,0,0,0,0,-20000,0,0,0,20000,40000,-20000,-20000
06436P,台光電國票98售04,0,0,0,0,0,0,0,0,0,-20000,0,0,0,9000,29000,-20000,-20000
06438P,玉晶光國票99售02,0,0,0,0,0,0,0,0,0,-20000,0,0,0,0,20000,-20000,-20000
055418,華通永豐97購01  ,0,0,0,0,0,0,0,0,0,-21000,0,0,0,0,21000,-21000,-21000
055390,國巨統一98購03  ,0,0,0,0,0,0,0,0,0,-21000,0,0,0,30000,51000,-21000,-21000
055537,康友群益97購03  ,0,0,0,0,0,0,0,0,0,-21000,0,0,0,131000,152000,-21000,-21000
05949P,台積電國票96售09,0,0,0,0,0,0,0,0,0,-21000,0,0,0,126000,147000,-21000,-21000
047861,臺股指國票93購16,0,0,0,0,0,0,0,0,0,-21000,0,0,0,0,21000,-21000,-21000
04417P,光罩國泰95售02  ,0,0,0,0,0,0,0,0,0,-21000,0,0,0,0,21000,-21000,-21000
048391,友訊國票94購01  ,0,0,0,0,0,0,0,0,0,-21000,0,0,0,10000,31000,-21000,-21000
050467,力成中信94購01  ,0,0,0,0,0,0,0,0,0,-21000,0,0,0,200000,221000,-21000,-21000
050457,力成元大94購01  ,0,0,0,0,0,0,0,0,0,-21000,0,0,0,0,21000,-21000,-21000
051985,智邦元大95購05  ,0,0,0,0,0,0,0,0,0,-21000,0,0,0,101000,122000,-21000,-21000
049398,微星群益94購02  ,0,0,0,0,0,0,0,0,0,-21000,0,0,0,9000,30000,-21000,-21000
050083,旺宏元富94購01  ,0,0,0,0,0,0,0,0,0,-21000,0,0,0,1000,22000,-21000,-21000
049613,華通中信94購01  ,0,0,0,0,0,0,0,0,0,-21000,0,0,0,15000,36000,-21000,-21000
053025,燿華富邦98購02  ,0,0,0,0,0,0,0,0,0,-21000,0,0,0,201000,222000,-21000,-21000
049854,超眾群益94購02  ,0,0,0,0,0,0,0,0,0,-21000,0,0,0,34000,55000,-21000,-21000
052891,台泥群益96購01  ,0,0,0,0,0,0,0,0,0,-21000,0,0,0,1000,22000,-21000,-21000
052693,微星中信96購01  ,0,0,0,0,0,0,0,0,0,-21000,0,0,0,0,21000,-21000,-21000
053108,南亞科兆豐96購01,0,0,0,0,0,0,0,0,0,-21000,0,0,0,18000,39000,-21000,-21000
053137,旺宏富邦98購01  ,0,0,0,0,0,0,0,0,0,-21000,0,0,0,0,21000,-21000,-21000
053132,國巨國票97購02  ,0,0,0,0,0,0,0,0,0,-21000,0,0,0,131000,152000,-21000,-21000
053295,奇力新中信96購01,0,0,0,0,0,0,0,0,0,-21000,0,0,0,25000,46000,-21000,-21000
06314P,GIS元富97售02   ,0,0,0,0,0,0,0,0,0,-21000,0,0,0,7000,28000,-21000,-21000
06272P,台郡凱基97售04  ,0,0,0,0,0,0,0,0,0,-21000,0,0,0,5000,26000,-21000,-21000
1515,力山            ,74000,104000,-30000,0,0,0,0,0,0,9000,0,0,0,17000,8000,9000,-21000
5706,鳳凰            ,10000,32000,-22000,0,0,0,0,0,0,1000,1000,0,1000,0,0,0,-21000
2820,華票            ,47000,68000,-21000,0,0,0,0,0,0,0,0,0,0,0,0,0,-21000
2328,廣宇            ,140000,186000,-46000,0,0,0,0,0,0,25000,27000,0,27000,0,2000,-2000,-21000
06070P,漢唐永豐97售01  ,0,0,0,0,0,0,0,0,0,-22000,0,0,0,0,22000,-22000,-22000
057335,技嘉國票99購01  ,0,0,0,0,0,0,0,0,0,-22000,0,0,0,0,22000,-22000,-22000
056587,聯發科統一9A購01,0,0,0,0,0,0,0,0,0,-22000,0,0,0,5000,27000,-22000,-22000
056761,元油2X元大98購07,0,0,0,0,0,0,0,0,0,-22000,0,0,0,97000,119000,-22000,-22000
056918,台積電兆豐98購01,0,0,0,0,0,0,0,0,0,-22000,0,0,0,125000,147000,-22000,-22000
057123,上銀凱基98購05  ,0,0,0,0,0,0,0,0,0,-22000,0,0,0,0,22000,-22000,-22000
055535,緯創群益98購01  ,0,0,0,0,0,0,0,0,0,-22000,0,0,0,0,22000,-22000,-22000
056183,南亞科統一97購02,0,0,0,0,0,0,0,0,0,-22000,0,0,0,0,22000,-22000,-22000
056502,A50正2永豐98購01,0,0,0,0,0,0,0,0,0,-22000,0,0,0,290000,312000,-22000,-22000
056511,超眾永豐98購01  ,0,0,0,0,0,0,0,0,0,-22000,0,0,0,0,22000,-22000,-22000
056512,易華電永豐98購01,0,0,0,0,0,0,0,0,0,-22000,0,0,0,0,22000,-22000,-22000
048348,矽力元大93購03  ,0,0,0,0,0,0,0,0,0,-22000,0,0,0,0,22000,-22000,-22000
048581,南亞科富邦93購02,0,0,0,0,0,0,0,0,0,-22000,0,0,0,0,22000,-22000,-22000
051847,香港反中信99購01,0,0,0,0,0,0,0,0,0,-22000,0,0,0,0,22000,-22000,-22000
051450,世芯元大95購02  ,0,0,0,0,0,0,0,0,0,-22000,0,0,0,8000,30000,-22000,-22000
047994,亞德客元大93購03,0,0,0,0,0,0,0,0,0,-22000,0,0,0,12000,34000,-22000,-22000
046061,中石化凱基98購01,0,0,0,0,0,0,0,0,0,-22000,0,0,0,0,22000,-22000,-22000
04325P,創意元大93售06  ,0,0,0,0,0,0,0,0,0,-22000,0,0,0,0,22000,-22000,-22000
051025,晶華統一95購01  ,0,0,0,0,0,0,0,0,0,-22000,0,0,0,30000,52000,-22000,-22000
052148,康友群益95購03  ,0,0,0,0,0,0,0,0,0,-22000,0,0,0,11000,33000,-22000,-22000
051352,南亞科元大95購02,0,0,0,0,0,0,0,0,0,-22000,0,0,0,69000,91000,-22000,-22000
049766,滬深2X元富94購02,0,0,0,0,0,0,0,0,0,-22000,0,0,0,480000,502000,-22000,-22000
051597,T50反1中信99購02,0,0,0,0,0,0,0,0,0,-22000,0,0,0,10000,32000,-22000,-22000
051995,矽力元大95購03  ,0,0,0,0,0,0,0,0,0,-22000,0,0,0,29000,51000,-22000,-22000
051104,鈺齊元大96購01  ,0,0,0,0,0,0,0,0,0,-22000,0,0,0,2000,24000,-22000,-22000
053262,華邦電群益96購02,0,0,0,0,0,0,0,0,0,-22000,0,0,0,140000,162000,-22000,-22000
053149,京元電元大96購02,0,0,0,0,0,0,0,0,0,-22000,0,0,0,10000,32000,-22000,-22000
053186,健策中信9C購01  ,0,0,0,0,0,0,0,0,0,-22000,0,0,0,8000,30000,-22000,-22000
053542,超眾永豐96購01  ,0,0,0,0,0,0,0,0,0,-22000,0,0,0,0,22000,-22000,-22000
053948,大立光富邦99購04,0,0,0,0,0,0,0,0,0,-22000,0,0,0,19000,41000,-22000,-22000
055023,億光國泰98購01  ,0,0,0,0,0,0,0,0,0,-22000,0,0,0,22000,44000,-22000,-22000
054234,可成群益96購05  ,0,0,0,0,0,0,0,0,0,-22000,0,0,0,105000,127000,-22000,-22000
054235,欣興群益96購06  ,0,0,0,0,0,0,0,0,0,-22000,0,0,0,12000,34000,-22000,-22000
054472,道瓊反中信9A購01,0,0,0,0,0,0,0,0,0,-22000,0,0,0,41000,63000,-22000,-22000
2731,雄獅            ,7000,29000,-22000,0,0,0,0,0,0,0,0,0,0,0,0,0,-22000
2536,宏普            ,24000,46000,-22000,0,0,0,0,0,0,0,0,0,0,0,0,0,-22000
3028,增你強          ,19000,41000,-22000,0,0,0,0,0,0,0,0,0,0,0,0,0,-22000
06642P,可成兆豐98售01  ,0,0,0,0,0,0,0,0,0,-22000,0,0,0,0,22000,-22000,-22000
06435P,臺股指群益98售02,0,0,0,0,0,0,0,0,0,-22000,0,0,0,4000,26000,-22000,-22000
06453P,群創元大9B售02  ,0,0,0,0,0,0,0,0,0,-22000,0,0,0,0,22000,-22000,-22000
056470,旺宏元大99購01  ,0,0,0,0,0,0,0,0,0,-23000,0,0,0,33000,56000,-23000,-23000
056248,康友群益97購04  ,0,0,0,0,0,0,0,0,0,-23000,0,0,0,32000,55000,-23000,-23000
056246,祥碩群益97購01  ,0,0,0,0,0,0,0,0,0,-23000,0,0,0,1000,24000,-23000,-23000
055976,台積電統一99購03,0,0,0,0,0,0,0,0,0,-23000,0,0,0,50000,73000,-23000,-23000
056724,臻鼎中信9A購01  ,0,0,0,0,0,0,0,0,0,-23000,0,0,0,20000,43000,-23000,-23000
056795,鴻海麥證98購01  ,0,0,0,10000,33000,-23000,0,0,0,-23000,0,0,0,10000,33000,-23000,-23000
056574,亞光元大99購03  ,0,0,0,0,0,0,0,0,0,-23000,0,0,0,50000,73000,-23000,-23000
056595,台積電元富98購04,0,0,0,0,0,0,0,0,0,-23000,0,0,0,1000,24000,-23000,-23000
057309,南茂兆豐99購01  ,0,0,0,0,0,0,0,0,0,-23000,0,0,0,0,23000,-23000,-23000
00770,國泰北美科技    ,0,0,0,0,0,0,0,0,0,-23000,0,0,0,0,23000,-23000,-23000
04194P,欣興永豐93售05  ,0,0,0,0,0,0,0,0,0,-23000,0,0,0,0,23000,-23000,-23000
044003,聯發科兆豐93購01,0,0,0,0,0,0,0,0,0,-23000,0,0,0,119000,142000,-23000,-23000
048704,台表科國票95購01,0,0,0,0,0,0,0,0,0,-23000,0,0,0,4000,27000,-23000,-23000
048575,旺宏國泰94購04  ,0,0,0,0,0,0,0,0,0,-23000,0,0,0,0,23000,-23000,-23000
04707P,喬山元大94售01  ,0,0,0,0,0,0,0,0,0,-23000,0,0,0,0,23000,-23000,-23000
04751P,智邦兆豐95售02  ,0,0,0,0,0,0,0,0,0,-23000,0,0,0,20000,43000,-23000,-23000
047675,群創元富96購03  ,0,0,0,0,0,0,0,0,0,-23000,0,0,0,0,23000,-23000,-23000
05110P,上銀統一95售01  ,0,0,0,0,0,0,0,0,0,-23000,0,0,0,0,23000,-23000,-23000
051305,訊連凱基96購01  ,0,0,0,0,0,0,0,0,0,-23000,0,0,0,50000,73000,-23000,-23000
051255,康控元大96購04  ,0,0,0,0,0,0,0,0,0,-23000,0,0,0,75000,98000,-23000,-23000
051128,台表科群益95購02,0,0,0,0,0,0,0,0,0,-23000,0,0,0,40000,63000,-23000,-23000
051912,健鼎元大96購01  ,0,0,0,0,0,0,0,0,0,-23000,0,0,0,0,23000,-23000,-23000
050031,嘉澤元大95購01  ,0,0,0,0,0,0,0,0,0,-23000,0,0,0,48000,71000,-23000,-23000
050024,旺宏元大94購09  ,0,0,0,0,0,0,0,0,0,-23000,0,0,0,12000,35000,-23000,-23000
053869,嘉澤元大96購02  ,0,0,0,0,0,0,0,0,0,-23000,0,0,0,2000,25000,-23000,-23000
053378,台積電元大98購02,0,0,0,0,0,0,0,0,0,-23000,0,0,0,102000,125000,-23000,-23000
053245,全新國票97購01  ,0,0,0,0,0,0,0,0,0,-23000,0,0,0,18000,41000,-23000,-23000
06486P,麗豐元大98售02  ,0,0,0,0,0,0,0,0,0,-23000,0,0,0,3000,26000,-23000,-23000
06646P,國巨元大98售16  ,0,0,0,0,0,0,0,0,0,-23000,0,0,0,28000,51000,-23000,-23000
1256,鮮活果汁-KY     ,4000,27000,-23000,0,0,0,0,0,0,0,0,0,0,0,0,0,-23000
2034,允強            ,54000,77000,-23000,0,0,0,0,0,0,0,0,0,0,0,0,0,-23000
3305,昇貿            ,2000,25000,-23000,0,0,0,0,0,0,0,0,0,0,0,0,0,-23000
4164,承業醫          ,13000,36000,-23000,0,0,0,0,0,0,0,0,0,0,0,0,0,-23000
9941,裕融            ,48000,8000,40000,0,0,0,0,63000,-63000,0,0,0,0,0,0,0,-23000
057216,聯發科群益99購01,0,0,0,0,0,0,0,0,0,-24000,0,0,0,31000,55000,-24000,-24000
057480,技嘉元大98購03  ,0,0,0,0,0,0,0,0,0,-24000,0,0,0,35000,59000,-24000,-24000
057367,技嘉元大98購02  ,0,0,0,0,0,0,0,0,0,-24000,0,0,0,38000,62000,-24000,-24000
056609,楠梓電永豐98購02,0,0,0,0,0,0,0,0,0,-24000,0,0,0,77000,101000,-24000,-24000
05657P,樺漢統一97售01  ,0,0,0,0,0,0,0,0,0,-24000,0,0,0,0,24000,-24000,-24000
057172,南亞科元大98購03,0,0,0,0,0,0,0,0,0,-24000,0,0,0,110000,134000,-24000,-24000
057091,華新科元富9A購01,0,0,0,0,0,0,0,0,0,-24000,0,0,0,278000,302000,-24000,-24000
056083,億光統一97購03  ,0,0,0,0,0,0,0,0,0,-24000,0,0,0,129000,153000,-24000,-24000
056161,康控凱基98購02  ,0,0,0,0,0,0,0,0,0,-24000,0,0,0,41000,65000,-24000,-24000
056503,楠梓電永豐98購01,0,0,0,0,0,0,0,0,0,-24000,0,0,0,111000,135000,-24000,-24000
055323,貿聯國票98購01  ,0,0,0,0,0,0,0,0,0,-24000,0,0,0,10000,34000,-24000,-24000
055662,上銀中信99購01  ,0,0,0,0,0,0,0,0,0,-24000,0,0,0,151000,175000,-24000,-24000
047393,景碩元大93購02  ,0,0,0,0,0,0,0,0,0,-24000,0,0,0,0,24000,-24000,-24000
048098,嘉澤凱基93購04  ,0,0,0,0,0,0,0,0,0,-24000,0,0,0,0,24000,-24000,-24000
050375,矽創元大94購02  ,0,0,0,0,0,0,0,0,0,-24000,0,0,0,44000,68000,-24000,-24000
044928,玉晶光國泰93購01,0,0,0,0,0,0,0,0,0,-24000,0,0,0,0,24000,-24000,-24000
046345,世紀鋼國票93購01,0,0,0,0,0,0,0,0,0,-24000,0,0,0,0,24000,-24000,-24000
049772,臺股指元富94購01,0,0,0,0,0,0,0,0,0,-24000,0,0,0,0,24000,-24000,-24000
048980,嘉澤元大94購02  ,0,0,0,0,0,0,0,0,0,-24000,0,0,0,9000,33000,-24000,-24000
049038,高鐵兆豐94購01  ,0,0,0,0,0,0,0,0,0,-24000,0,0,0,0,24000,-24000,-24000
050906,臺股指元大95購13,0,0,0,0,0,0,0,0,0,-24000,0,0,0,0,24000,-24000,-24000
051512,超眾麥證95購01  ,0,0,0,6000,30000,-24000,0,0,0,-24000,0,0,0,6000,30000,-24000,-24000
050443,復盛凱基94購02  ,0,0,0,0,0,0,0,0,0,-24000,0,0,0,16000,40000,-24000,-24000
051089,旺宏元大96購04  ,0,0,0,0,0,0,0,0,0,-24000,0,0,0,50000,74000,-24000,-24000
051780,矽力群益95購01  ,0,0,0,0,0,0,0,0,0,-24000,0,0,0,34000,58000,-24000,-24000
052990,超眾元大97購01  ,0,0,0,0,0,0,0,0,0,-24000,0,0,0,24000,48000,-24000,-24000
052322,力成元大96購01  ,0,1000,-1000,0,0,0,0,0,0,-23000,0,0,0,93000,116000,-23000,-24000
055277,旺宏元大97購04  ,0,0,0,0,0,0,0,0,0,-24000,0,0,0,54000,78000,-24000,-24000
054775,復盛國票98購01  ,0,0,0,0,0,0,0,0,0,-24000,0,0,0,77000,101000,-24000,-24000
054801,康友群益97購02  ,0,0,0,0,0,0,0,0,0,-24000,0,0,0,35000,59000,-24000,-24000
8341,日友            ,279000,309000,-30000,0,0,0,0,0,0,6000,6000,0,6000,0,0,0,-24000
1723,中碳            ,12000,36000,-24000,0,0,0,0,0,0,0,0,0,0,0,0,0,-24000
1760,寶齡富錦        ,6000,28000,-22000,0,0,0,0,0,0,-2000,0,0,0,0,2000,-2000,-24000
1507,永大            ,6000,30000,-24000,0,0,0,0,0,0,0,0,0,0,0,0,0,-24000
06273P,台表科凱基97售04,0,0,0,0,0,0,0,0,0,-24000,0,0,0,12000,36000,-24000,-24000
06330P,南亞科群益97售03,0,0,0,0,0,0,0,0,0,-24000,0,0,0,0,24000,-24000,-24000
6415,矽力-KY         ,428000,282635,145365,0,0,0,9000,176000,-167000,-3000,0,1000,-1000,4000,6000,-2000,-24635
055721,聯詠元大97購04  ,0,0,0,0,0,0,0,0,0,-25000,0,0,0,2000,27000,-25000,-25000
056287,亞光永豐97購02  ,0,0,0,0,0,0,0,0,0,-25000,0,0,0,45000,70000,-25000,-25000
056566,臻鼎群益98購01  ,0,0,0,0,0,0,0,0,0,-25000,0,0,0,99000,124000,-25000,-25000
056681,鴻海統一98購09  ,0,0,0,0,0,0,0,0,0,-25000,0,0,0,53000,78000,-25000,-25000
057427,華通兆豐99購01  ,0,0,0,0,0,0,0,0,0,-25000,0,0,0,0,25000,-25000,-25000
06044P,同欣電永豐96售03,0,0,0,0,0,0,0,0,0,-25000,0,0,0,0,25000,-25000,-25000
05951P,台積電國票97售05,0,0,0,0,0,0,0,0,0,-25000,0,0,0,5000,30000,-25000,-25000
045106,玉晶光群益95購01,0,0,0,0,0,0,0,0,0,-25000,0,0,0,8000,33000,-25000,-25000
04590P,元石油元大97售01,0,0,0,0,0,0,0,0,0,-25000,0,0,0,0,25000,-25000,-25000
043396,世紀鋼元大93購01,0,0,0,0,0,0,0,0,0,-25000,0,0,0,4000,29000,-25000,-25000
050344,鴻海元富96購01  ,0,0,0,0,0,0,0,0,0,-25000,0,0,0,0,25000,-25000,-25000
051424,緯穎國票97購01  ,0,0,0,0,0,0,0,0,0,-25000,0,0,0,9000,34000,-25000,-25000
049211,昇陽半群益94購03,0,0,0,0,0,0,0,0,0,-25000,0,0,0,25000,50000,-25000,-25000
046956,矽力國票93購01  ,0,0,0,0,0,0,0,0,0,-25000,0,0,0,0,25000,-25000,-25000
048367,華邦電統一93購01,0,0,0,0,0,0,0,0,0,-25000,0,0,0,0,25000,-25000,-25000
047653,上銀兆豐94購01  ,0,0,0,0,0,0,0,0,0,-25000,0,0,0,0,25000,-25000,-25000
05115P,T50反1群益95售02,0,0,0,0,0,0,0,0,0,-25000,0,0,0,0,25000,-25000,-25000
051280,台積電兆豐95購04,0,0,0,0,0,0,0,0,0,-25000,0,0,0,0,25000,-25000,-25000
051253,緯創元大95購02  ,0,0,0,0,0,0,0,0,0,-25000,0,0,0,13000,38000,-25000,-25000
051946,健策統一98購01  ,0,0,0,0,0,0,0,0,0,-25000,0,0,0,128000,153000,-25000,-25000
052033,臺股指群益95購06,0,0,0,0,0,0,0,0,0,-25000,0,0,0,0,25000,-25000,-25000
05047P,強茂永豐95售02  ,0,0,0,0,0,0,0,0,0,-25000,0,0,0,0,25000,-25000,-25000
051355,聯發科元大96購01,0,0,0,0,0,0,0,0,0,-25000,0,0,0,150000,175000,-25000,-25000
04999P,南電永豐95售01  ,0,0,0,0,0,0,0,0,0,-25000,0,0,0,0,25000,-25000,-25000
053045,國巨中信97購01  ,0,0,0,0,0,0,0,0,0,-25000,0,0,0,97000,122000,-25000,-25000
054703,聯發科第一97購01,0,0,0,0,0,0,0,0,0,-25000,0,0,0,0,25000,-25000,-25000
054916,聯發科凱基98購04,0,0,0,0,0,0,0,0,0,-25000,0,0,0,0,25000,-25000,-25000
054969,亞翔元大97購01  ,0,0,0,0,0,0,0,0,0,-25000,0,0,0,3000,28000,-25000,-25000
054508,臺股指永豐96購04,0,0,0,0,0,0,0,0,0,-25000,0,0,0,0,25000,-25000,-25000
054545,奇力新中信98購01,0,0,0,0,0,0,0,0,0,-25000,0,0,0,160000,185000,-25000,-25000
054561,奇力新群益97購03,0,0,0,0,0,0,0,0,0,-25000,0,0,0,0,25000,-25000,-25000
053138,華邦電富邦96購01,0,0,0,0,0,0,0,0,0,-25000,0,0,0,85000,110000,-25000,-25000
053075,欣興永豐96購01  ,0,0,0,0,0,0,0,0,0,-25000,0,0,0,23000,48000,-25000,-25000
053718,全新凱基97購02  ,0,0,0,0,0,0,0,0,0,-25000,0,0,0,15000,40000,-25000,-25000
053769,香港反元大99購01,0,0,0,0,0,0,0,0,0,-25000,0,0,0,0,25000,-25000,-25000
053757,聯發科國泰96購04,0,0,0,0,0,0,0,0,0,-25000,0,0,0,20000,45000,-25000,-25000
6533,晶心科          ,31000,56000,-25000,0,0,0,0,0,0,0,0,0,0,0,0,0,-25000
3679,新至陞          ,1000,26000,-25000,0,0,0,0,0,0,0,0,0,0,0,0,0,-25000
3060,銘異            ,5000,30000,-25000,0,0,0,0,0,0,0,0,0,0,0,0,0,-25000
3055,蔚華科          ,15000,41000,-26000,0,0,0,0,0,0,1000,2000,1000,1000,0,0,0,-25000
2444,兆勁            ,8000,33000,-25000,0,0,0,0,0,0,0,0,0,0,0,0,0,-25000
2421,建準            ,122000,243000,-121000,0,0,0,0,0,0,96000,90000,0,90000,10000,4000,6000,-25000
06520P,元油2X元大98售04,0,0,0,0,0,0,0,0,0,-25000,0,0,0,0,25000,-25000,-25000
1707,葡萄王          ,68000,93000,-25000,0,0,0,0,0,0,0,0,0,0,0,0,0,-25000
057313,聯發科麥證99購01,0,0,0,0,26000,-26000,0,0,0,-26000,0,0,0,0,26000,-26000,-26000
056702,欣興國泰9A購01  ,0,0,0,0,0,0,0,0,0,-26000,0,0,0,9000,35000,-26000,-26000
056862,聯發科群益98購03,0,0,0,0,0,0,0,0,0,-26000,0,0,0,23000,49000,-26000,-26000
056730,元油2X凱基9A購04,0,0,0,0,0,0,0,0,0,-26000,0,0,0,10000,36000,-26000,-26000
056432,鴻海凱基98購08  ,0,0,0,0,0,0,0,0,0,-26000,0,0,0,7000,33000,-26000,-26000
055820,矽力國票98購02  ,0,0,0,0,0,0,0,0,0,-26000,0,0,0,36000,62000,-26000,-26000
05558P,鴻海麥證96售01  ,0,0,0,42000,68000,-26000,0,0,0,-26000,0,0,0,42000,68000,-26000,-26000
051453,智伸科元大95購02,0,0,0,0,0,0,0,0,0,-26000,0,0,0,4000,30000,-26000,-26000
00666R,富邦恒生國企反1 ,0,0,0,0,0,0,0,0,0,-26000,0,0,0,80000,106000,-26000,-26000
00713,元大台灣高息低波,0,0,0,0,0,0,0,0,0,-26000,0,0,0,0,26000,-26000,-26000
043921,台表科凱基93購01,0,0,0,0,0,0,0,0,0,-26000,0,0,0,0,26000,-26000,-26000
047930,嘉澤凱基93購03  ,0,0,0,0,0,0,0,0,0,-26000,0,0,0,10000,36000,-26000,-26000
046415,嘉晶元大92購03  ,0,0,0,0,0,0,0,0,0,-26000,0,0,0,0,26000,-26000,-26000
051570,和碩富邦97購01  ,0,0,0,0,0,0,0,0,0,-26000,0,0,0,180000,206000,-26000,-26000
050445,鴻海元大94購21  ,0,0,0,0,0,0,0,0,0,-26000,0,0,0,1159000,1185000,-26000,-26000
05116P,台積電群益95售03,0,0,0,0,0,0,0,0,0,-26000,0,0,0,0,26000,-26000,-26000
051730,為升國票96購02  ,0,0,0,0,0,0,0,0,0,-26000,0,0,0,37000,63000,-26000,-26000
053450,同欣電凱基96購02,0,0,0,0,0,0,0,0,0,-26000,0,0,0,10000,36000,-26000,-26000
053459,康控國泰97購01  ,0,0,0,0,0,0,0,0,0,-26000,0,0,0,72000,98000,-26000,-26000
053604,臺股指元大96購21,0,0,0,0,0,0,0,0,0,-26000,0,0,0,0,26000,-26000,-26000
052937,國巨兆豐97購01  ,0,0,0,0,0,0,0,0,0,-26000,0,0,0,549000,575000,-26000,-26000
05456P,鴻海凱基95售19  ,0,0,0,0,0,0,0,0,0,-26000,0,0,0,5000,31000,-26000,-26000
054433,南亞科台新96購02,0,0,0,0,0,0,0,0,0,-26000,0,0,0,12000,38000,-26000,-26000
1446,宏和            ,1000,27000,-26000,0,0,0,0,0,0,0,0,0,0,0,0,0,-26000
06189P,華新科永豐97售03,0,0,0,0,0,0,0,0,0,-26000,0,0,0,150000,176000,-26000,-26000
6283,淳安            ,10000,36000,-26000,0,0,0,0,0,0,0,0,0,0,0,0,0,-26000
9924,福興            ,0,26000,-26000,0,0,0,0,0,0,0,0,0,0,0,0,0,-26000
055594,華新科元大98購02,0,0,0,0,0,0,0,0,0,-27000,0,0,0,18000,45000,-27000,-27000
055774,台光電凱基97購02,0,0,0,0,0,0,0,0,0,-27000,0,0,0,23000,50000,-27000,-27000
055734,奇力新元富97購02,0,0,0,0,0,0,0,0,0,-27000,0,0,0,1000,28000,-27000,-27000
055640,鴻海元富97購03  ,0,0,0,0,0,0,0,0,0,-27000,0,0,0,0,27000,-27000,-27000
056018,旺宏群益97購02  ,0,0,0,0,0,0,0,0,0,-27000,0,0,0,11000,38000,-27000,-27000
056691,元油2X群益9B購01,0,0,0,0,0,0,0,0,0,-27000,0,0,0,7000,34000,-27000,-27000
052216,康友元大96購01  ,0,0,0,0,0,0,0,0,0,-27000,0,0,0,56000,83000,-27000,-27000
06022P,緯穎永豐96售03  ,0,0,0,0,0,0,0,0,0,-27000,0,0,0,0,27000,-27000,-27000
045472,嘉聯益元大93購02,0,0,0,0,0,0,0,0,0,-27000,0,0,0,10000,37000,-27000,-27000
047774,台表科元大95購01,0,0,0,0,0,0,0,0,0,-27000,0,0,0,20000,47000,-27000,-27000
044405,材料凱基93購01  ,0,0,0,0,0,0,0,0,0,-27000,0,0,0,10000,37000,-27000,-27000
047028,新日興元大93購02,0,0,0,0,0,0,0,0,0,-27000,0,0,0,28000,55000,-27000,-27000
04851P,創意永豐94售02  ,0,0,0,0,0,0,0,0,0,-27000,0,0,0,89000,116000,-27000,-27000
046939,燿華元大96購01  ,0,0,0,0,0,0,0,0,0,-27000,0,0,0,66000,93000,-27000,-27000
05025P,聯發科群益95售02,0,0,0,0,0,0,0,0,0,-27000,0,0,0,13000,40000,-27000,-27000
050447,廣達元大94購01  ,0,0,0,0,0,0,0,0,0,-27000,0,0,0,0,27000,-27000,-27000
052597,茂林群益96購01  ,0,0,0,0,0,0,0,0,0,-27000,0,0,0,366000,393000,-27000,-27000
054543,元金2X中信01購01,0,0,0,0,0,0,0,0,0,-27000,0,0,0,0,27000,-27000,-27000
055271,鴻海元大98購03  ,0,0,0,0,0,0,0,0,0,-27000,0,0,0,319000,346000,-27000,-27000
055300,緯穎元大98購01  ,0,0,0,0,0,0,0,0,0,-27000,0,0,0,497000,524000,-27000,-27000
053539,智易永豐96購01  ,0,0,0,0,0,0,0,0,0,-27000,0,0,0,0,27000,-27000,-27000
053319,可成群益96購04  ,0,0,0,0,0,0,0,0,0,-27000,0,0,0,72000,99000,-27000,-27000
5225,東科-KY         ,17000,44000,-27000,0,0,0,0,0,0,0,0,0,0,0,0,0,-27000
2457,飛宏            ,27000,58000,-31000,0,0,0,0,0,0,4000,4000,0,4000,0,0,0,-27000
06227P,大立光群益97售04,0,0,0,0,0,0,0,0,0,-27000,0,0,0,7000,34000,-27000,-27000
06354P,大立光永豐97售04,0,0,0,0,0,0,0,0,0,-27000,0,0,0,222000,249000,-27000,-27000
06553P,訊芯元大98售05  ,0,0,0,0,0,0,0,0,0,-27000,0,0,0,15000,42000,-27000,-27000
06450P,聯發科元大98售03,0,0,0,0,0,0,0,0,0,-27000,0,0,0,78000,105000,-27000,-27000
06598P,奇力新永豐98售02,0,0,0,0,0,0,0,0,0,-27000,0,0,0,0,27000,-27000,-27000
05654P,台光電統一96售01,0,0,0,0,0,0,0,0,0,-28000,0,0,0,10000,38000,-28000,-28000
056070,新日興元大97購04,0,0,0,0,0,0,0,0,0,-28000,0,0,0,112000,140000,-28000,-28000
056111,力成永豐97購01  ,0,0,0,0,0,0,0,0,0,-28000,0,0,0,45000,73000,-28000,-28000
047526,可成元大93購08  ,0,0,0,0,0,0,0,0,0,-28000,0,0,0,32000,60000,-28000,-28000
048261,鴻海元富95購01  ,0,0,0,0,0,0,0,0,0,-28000,0,0,0,40000,68000,-28000,-28000
044465,元油2X群益97購01,0,0,0,0,0,0,0,0,0,-28000,0,0,0,183000,211000,-28000,-28000
04340P,易華電元大94售02,0,0,0,0,0,0,0,0,0,-28000,0,0,0,0,28000,-28000,-28000
050866,景碩永豐95購01  ,0,0,0,0,0,0,0,0,0,-28000,0,0,0,22000,50000,-28000,-28000
051603,深中小群益99購03,0,0,0,0,0,0,0,0,0,-28000,0,0,0,370000,398000,-28000,-28000
050791,聯發科富邦96購01,0,0,0,0,0,0,0,0,0,-28000,0,0,0,73000,101000,-28000,-28000
053866,景碩元大97購02  ,0,0,0,0,0,0,0,0,0,-28000,0,0,0,98000,126000,-28000,-28000
053964,上銀元大96購05  ,0,0,0,0,0,0,0,0,0,-28000,0,0,0,72000,100000,-28000,-28000
053091,同欣電元大96購01,0,0,0,0,0,0,0,0,0,-28000,0,0,0,100000,128000,-28000,-28000
054736,南亞科凱基98購01,0,0,0,0,0,0,0,0,0,-28000,0,0,0,25000,53000,-28000,-28000
054572,國巨元大98購03  ,0,0,0,0,0,0,0,0,0,-28000,0,0,0,200000,228000,-28000,-28000
054128,台積電元大97購10,0,0,0,0,0,0,0,0,0,-28000,0,0,0,13000,41000,-28000,-28000
1522,堤維西          ,18000,46000,-28000,0,0,0,0,0,0,0,0,0,0,0,0,0,-28000
06177P,玉晶光元大98售07,0,0,0,0,0,0,0,0,0,-28000,0,0,0,25000,53000,-28000,-28000
6183,關貿            ,20000,8000,12000,0,0,0,0,0,0,-40000,0,40000,-40000,0,0,0,-28000
6165,捷泰            ,31000,59000,-28000,0,0,0,0,0,0,0,0,0,0,0,0,0,-28000
056515,燿華兆豐99購01  ,0,0,0,0,0,0,0,0,0,-29000,0,0,0,219000,248000,-29000,-29000
055745,臻鼎元富97購01  ,0,0,0,0,0,0,0,0,0,-29000,0,0,0,49000,78000,-29000,-29000
055459,建準永豐97購03  ,0,0,0,0,0,0,0,0,0,-29000,0,0,0,1000,30000,-29000,-29000
056565,欣興群益98購03  ,0,0,0,0,0,0,0,0,0,-29000,0,0,0,54000,83000,-29000,-29000
056742,玉晶光凱基9A購01,0,0,0,0,0,0,0,0,0,-29000,0,0,0,1000,30000,-29000,-29000
06102P,智邦凱基97售03  ,0,0,0,0,0,0,0,0,0,-29000,0,0,0,40000,69000,-29000,-29000
04470P,為升元大94售01  ,0,0,0,0,0,0,0,0,0,-29000,0,0,0,0,29000,-29000,-29000
047981,南亞科群益93購02,0,0,0,0,0,0,0,0,0,-29000,0,0,0,11000,40000,-29000,-29000
04652P,臺股指凱基94售11,0,0,0,0,0,0,0,0,0,-29000,0,0,0,10000,39000,-29000,-29000
047676,臺股指元富99購01,0,0,0,0,0,0,0,0,0,-29000,0,0,0,0,29000,-29000,-29000
051120,南亞科群益95購01,0,0,0,0,0,0,0,0,0,-29000,0,0,0,125000,154000,-29000,-29000
051196,喬山麥證95購01  ,0,0,0,0,29000,-29000,0,0,0,-29000,0,0,0,0,29000,-29000,-29000
050842,旺宏國票97購01  ,0,0,0,0,0,0,0,0,0,-29000,0,0,0,11000,40000,-29000,-29000
04971P,矽力元富94售02  ,0,0,0,0,0,0,0,0,0,-29000,0,0,0,10000,39000,-29000,-29000
04958P,和大凱基94售04  ,0,0,0,0,0,0,0,0,0,-29000,0,0,0,18000,47000,-29000,-29000
049680,臺股指國票94購13,0,0,0,0,0,0,0,0,0,-29000,0,0,0,1000,30000,-29000,-29000
054858,台肥群益97購01  ,0,0,0,0,0,0,0,0,0,-29000,0,0,0,21000,50000,-29000,-29000
055108,智邦凱基98購01  ,0,0,0,0,0,0,0,0,0,-29000,0,0,0,15000,44000,-29000,-29000
053090,新唐元大96購01  ,0,0,0,0,0,0,0,0,0,-29000,0,0,0,70000,99000,-29000,-29000
052945,嘉晶國票97購01  ,0,0,0,0,0,0,0,0,0,-29000,0,0,0,19000,48000,-29000,-29000
052918,智易富邦97購02  ,0,0,0,0,0,0,0,0,0,-29000,0,0,0,6000,35000,-29000,-29000
053773,上銀元大96購04  ,0,0,0,0,0,0,0,0,0,-29000,0,0,0,153000,182000,-29000,-29000
2488,漢平            ,13000,43000,-30000,0,0,0,0,0,0,1000,1000,0,1000,0,0,0,-29000
2348,海悅            ,2000,31000,-29000,0,0,0,0,0,0,0,0,0,0,0,0,0,-29000
06461P,玉晶光國泰9A售01,0,0,0,0,0,0,0,0,0,-29000,0,0,0,62000,91000,-29000,-29000
1463,強盛            ,1000,30000,-29000,0,0,0,0,0,0,0,0,0,0,0,0,0,-29000
2103,台橡            ,177000,206000,-29000,0,0,0,0,0,0,0,0,0,0,0,0,0,-29000
06065P,大立光台新97售01,0,0,0,0,0,0,0,0,0,-30000,0,0,0,0,30000,-30000,-30000
05834P,臺股指元富96售06,0,0,0,0,0,0,0,0,0,-30000,0,0,0,0,30000,-30000,-30000
057312,美律麥證98購01  ,0,0,0,0,30000,-30000,0,0,0,-30000,0,0,0,0,30000,-30000,-30000
057341,技嘉台新98購01  ,0,0,0,0,0,0,0,0,0,-30000,0,0,0,5000,35000,-30000,-30000
05715P,創意元富96售05  ,0,0,0,0,0,0,0,0,0,-30000,0,0,0,0,30000,-30000,-30000
055350,聯發科凱基97購02,0,0,0,0,0,0,0,0,0,-30000,0,0,0,0,30000,-30000,-30000
055413,全新富邦98購01  ,0,0,0,0,0,0,0,0,0,-30000,0,0,0,0,30000,-30000,-30000
055435,佳世達中信99購01,0,0,0,0,0,0,0,0,0,-30000,0,0,0,70000,100000,-30000,-30000
055826,中石化元大97購01,0,0,0,0,0,0,0,0,0,-30000,0,0,0,0,30000,-30000,-30000
055810,T50反1國票99購01,0,0,0,0,0,0,0,0,0,-30000,0,0,0,0,30000,-30000,-30000
056529,中環凱基98購01  ,0,0,0,0,0,0,0,0,0,-30000,0,0,0,0,30000,-30000,-30000
056425,聯發科日盛9A購01,0,0,0,0,0,0,0,0,0,-30000,0,0,0,0,30000,-30000,-30000
056283,鴻海永豐97購03  ,0,0,0,0,0,0,0,0,0,-30000,0,0,0,0,30000,-30000,-30000
056314,力成元大97購01  ,0,0,0,0,0,0,0,0,0,-30000,0,0,0,0,30000,-30000,-30000
056109,彩晶永豐98購01  ,0,0,0,0,0,0,0,0,0,-30000,0,0,0,0,30000,-30000,-30000
056106,晶相光永豐97購02,0,0,0,0,0,0,0,0,0,-30000,0,0,0,0,30000,-30000,-30000
056178,嘉澤元富97購02  ,0,0,0,0,0,0,0,0,0,-30000,0,0,0,0,30000,-30000,-30000
056040,亞光凱基98購01  ,0,0,0,0,0,0,0,0,0,-30000,0,0,0,0,30000,-30000,-30000
055943,瑞昱麥證97購01  ,0,0,0,35000,73000,-38000,0,0,0,-30000,0,0,0,58000,88000,-30000,-30000
048315,聯發科凱基93購32,0,0,0,0,0,0,0,0,0,-30000,0,0,0,0,30000,-30000,-30000
046591,康舒元大92購01  ,0,0,0,0,0,0,0,0,0,-30000,0,0,0,0,30000,-30000,-30000
048029,聯發科凱基93購26,0,0,0,0,0,0,0,0,0,-30000,0,0,0,100000,130000,-30000,-30000
046699,臻鼎凱基93購03  ,0,0,0,0,0,0,0,0,0,-30000,0,0,0,29000,59000,-30000,-30000
047035,華邦電群益94購02,0,0,0,0,0,0,0,0,0,-30000,0,0,0,0,30000,-30000,-30000
047219,美律麥證94購01  ,0,0,0,61000,116000,-55000,0,0,0,-30000,0,0,0,107000,137000,-30000,-30000
047332,訊芯元大93購04  ,0,0,0,0,0,0,0,0,0,-30000,0,0,0,0,30000,-30000,-30000
048755,志超元富96購01  ,0,0,0,0,0,0,0,0,0,-30000,0,0,0,0,30000,-30000,-30000
051466,玉晶光富邦97購01,0,0,0,0,0,0,0,0,0,-30000,0,0,0,0,30000,-30000,-30000
049205,聯發科群益94購05,0,0,0,0,0,0,0,0,0,-30000,0,0,0,0,30000,-30000,-30000
047923,聯發科凱基94購02,0,0,0,0,0,0,0,0,0,-30000,0,0,0,0,30000,-30000,-30000
047785,嘉聯益第一93購01,0,0,0,0,0,0,0,0,0,-30000,0,0,0,0,30000,-30000,-30000
047797,臺股指群益93購08,0,0,0,0,0,0,0,0,0,-30000,0,0,0,10000,40000,-30000,-30000
045101,玉晶光中信94購01,0,0,0,0,0,0,0,0,0,-30000,0,0,0,246000,276000,-30000,-30000
045662,華邦電統一94購02,0,0,0,0,0,0,0,0,0,-30000,0,0,0,0,30000,-30000,-30000
040160,SP黃豆元富95購01,0,0,0,0,0,0,0,0,0,-30000,0,0,0,0,30000,-30000,-30000
04084P,台表科統一93售01,0,0,0,0,0,0,0,0,0,-30000,0,0,0,0,30000,-30000,-30000
04259P,滬深2X群益93售03,0,0,0,0,0,0,0,0,0,-30000,0,0,0,0,30000,-30000,-30000
049646,旺宏凱基94購01  ,0,0,0,0,0,0,0,0,0,-30000,0,0,0,5000,35000,-30000,-30000
051381,玉晶光群益98購01,0,0,0,0,0,0,0,0,0,-30000,0,0,0,2000,32000,-30000,-30000
04993P,上銀兆豐96售01  ,0,0,0,0,0,0,0,0,0,-30000,0,0,0,100000,130000,-30000,-30000
049759,元黃金富邦9A購01,0,0,0,0,0,0,0,0,0,-30000,0,0,0,10000,40000,-30000,-30000
051007,台光電麥證95購01,0,0,0,10000,41000,-31000,0,0,0,-30000,0,0,0,11000,41000,-30000,-30000
049054,禾伸堂永豐94購01,0,0,0,0,0,0,0,0,0,-30000,0,0,0,20000,50000,-30000,-30000
048987,崇越元大94購01  ,0,0,0,0,0,0,0,0,0,-30000,0,0,0,0,30000,-30000,-30000
048910,和鑫富邦98購01  ,0,0,0,0,0,0,0,0,0,-30000,0,0,0,0,30000,-30000,-30000
048962,宏全康和94購01  ,0,0,0,0,0,0,0,0,0,-30000,0,0,0,0,30000,-30000,-30000
052567,台積電凱基96購05,0,0,0,0,0,0,0,0,0,-30000,0,0,0,5000,35000,-30000,-30000
052389,聯發科群益95購05,0,0,0,0,0,0,0,0,0,-30000,0,0,0,98000,128000,-30000,-30000
052499,合勤控永豐95購01,0,0,0,0,0,0,0,0,0,-30000,0,0,0,0,30000,-30000,-30000
053047,寶成中信97購01  ,0,0,0,0,0,0,0,0,0,-30000,0,0,0,0,30000,-30000,-30000
049831,日月光凱基94購01,0,0,0,0,0,0,0,0,0,-30000,0,0,0,0,30000,-30000,-30000
051175,國巨凱基95購04  ,0,0,0,0,0,0,0,0,0,-30000,0,0,0,21000,51000,-30000,-30000
05124P,華新科富邦97售02,0,0,0,0,0,0,0,0,0,-30000,0,0,0,0,30000,-30000,-30000
05175P,TPK富邦99售01   ,0,0,0,0,0,0,0,0,0,-30000,0,0,0,0,30000,-30000,-30000
050740,旺宏永豐94購03  ,0,0,0,0,0,0,0,0,0,-30000,0,0,0,74000,104000,-30000,-30000
050296,亞光凱基94購03  ,0,0,0,0,0,0,0,0,0,-30000,0,0,0,35000,65000,-30000,-30000
050663,麗豐元大96購03  ,0,0,0,0,0,0,0,0,0,-30000,0,0,0,0,30000,-30000,-30000
049436,義隆國泰96購02  ,0,0,0,0,0,0,0,0,0,-30000,0,0,0,0,30000,-30000,-30000
051569,緯創富邦95購02  ,0,0,0,0,0,0,0,0,0,-30000,0,0,0,0,30000,-30000,-30000
051564,和碩國泰96購01  ,0,0,0,0,0,0,0,0,0,-30000,0,0,0,0,30000,-30000,-30000
050603,致新國泰96購01  ,0,0,0,0,0,0,0,0,0,-30000,0,0,0,10000,40000,-30000,-30000
050114,群創元大95購01  ,0,0,0,0,0,0,0,0,0,-30000,0,0,0,37000,67000,-30000,-30000
050477,矽力永豐94購01  ,0,0,0,0,0,0,0,0,0,-30000,0,0,0,37000,67000,-30000,-30000
05152P,玉晶光群益96售05,0,0,0,0,0,0,0,0,0,-30000,0,0,0,0,30000,-30000,-30000
053819,大立光群益96購04,0,0,0,0,0,0,0,0,0,-30000,0,0,0,0,30000,-30000,-30000
053982,臻鼎元大96購05  ,0,0,0,0,0,0,0,0,0,-30000,0,0,0,71000,101000,-30000,-30000
054002,GIS群益96購03   ,0,0,0,0,0,0,0,0,0,-30000,0,0,0,0,30000,-30000,-30000
053885,全新兆豐96購01  ,0,0,0,0,0,0,0,0,0,-30000,0,0,0,100000,130000,-30000,-30000
053881,南亞科中信97購01,0,0,0,0,0,0,0,0,0,-30000,0,0,0,2000,32000,-30000,-30000
05333P,臺股指國票95售02,0,0,0,0,0,0,0,0,0,-30000,0,0,0,10000,40000,-30000,-30000
053388,群創元大9C購02  ,0,0,0,0,0,0,0,0,0,-30000,0,0,0,5000,35000,-30000,-30000
053430,樺漢永豐96購01  ,0,0,0,0,0,0,0,0,0,-30000,0,0,0,0,30000,-30000,-30000
053533,光罩永豐96購03  ,0,0,0,0,0,0,0,0,0,-30000,0,0,0,0,30000,-30000,-30000
053603,臺股指元大96購20,0,0,0,0,0,0,0,0,0,-30000,0,0,0,0,30000,-30000,-30000
052794,群創兆豐97購01  ,0,0,0,0,0,0,0,0,0,-30000,0,0,0,0,30000,-30000,-30000
053107,旺宏兆豐97購01  ,0,0,0,0,0,0,0,0,0,-30000,0,0,0,0,30000,-30000,-30000
05295P,緯創凱基95售01  ,0,0,0,0,0,0,0,0,0,-30000,0,0,0,0,30000,-30000,-30000
05325P,臺股指凱基95售09,0,0,0,0,0,0,0,0,0,-30000,0,0,0,10000,40000,-30000,-30000
053238,麗豐永豐96購01  ,0,0,0,0,0,0,0,0,0,-30000,0,0,0,104000,134000,-30000,-30000
053226,國巨台新97購02  ,0,0,0,0,0,0,0,0,0,-30000,0,0,0,0,30000,-30000,-30000
055158,亞光元大99購01  ,0,0,0,0,0,0,0,0,0,-30000,0,0,0,0,30000,-30000,-30000
055290,玉晶光元大98購08,0,0,0,0,0,0,0,0,0,-30000,0,0,0,0,30000,-30000,-30000
054727,台積電日盛97購02,0,0,0,0,0,0,0,0,0,-30000,0,0,0,250000,280000,-30000,-30000
054921,文曄凱基97購01  ,0,0,0,0,0,0,0,0,0,-30000,0,0,0,0,30000,-30000,-30000
054060,晶技國票97購02  ,0,0,0,0,0,0,0,0,0,-30000,0,0,0,180000,210000,-30000,-30000
054038,T50反1元大98購04,0,0,0,0,0,0,0,0,0,-30000,0,0,0,10000,40000,-30000,-30000
054289,聯發科元大97購11,0,0,0,0,0,0,0,0,0,-30000,0,0,0,77000,107000,-30000,-30000
054272,華通中信98購01  ,0,0,0,0,0,0,0,0,0,-30000,0,0,0,0,30000,-30000,-30000
054562,亞光群益98購01  ,0,0,0,0,0,0,0,0,0,-30000,0,0,0,10000,40000,-30000,-30000
054560,全新群益98購03  ,0,0,0,0,0,0,0,0,0,-30000,0,0,0,10000,40000,-30000,-30000
1339,昭輝            ,40000,55000,-15000,0,0,0,0,0,0,-15000,0,15000,-15000,0,0,0,-30000
06515P,國巨凱基98售06  ,0,0,0,0,0,0,0,0,0,-30000,0,0,0,0,30000,-30000,-30000
3047,訊舟            ,5000,36000,-31000,0,0,0,0,0,0,1000,1000,0,1000,0,0,0,-30000
056466,臺股指凱基99購08,0,0,0,0,0,0,0,0,0,-31000,0,0,0,0,31000,-31000,-31000
055794,聯發科國泰99購01,0,0,0,0,0,0,0,0,0,-31000,0,0,0,0,31000,-31000,-31000
055357,欣興凱基97購04  ,0,0,0,0,0,0,0,0,0,-31000,0,0,0,11000,42000,-31000,-31000
055375,京鼎元大97購03  ,0,0,0,0,0,0,0,0,0,-31000,0,0,0,405000,436000,-31000,-31000
05700P,臻鼎凱基96售02  ,0,0,0,0,0,0,0,0,0,-31000,0,0,0,0,31000,-31000,-31000
06071P,大立光永豐97售01,0,0,0,0,0,0,0,0,0,-31000,0,0,0,9000,40000,-31000,-31000
050391,大立光統一94購07,0,0,0,0,0,0,0,0,0,-31000,0,0,0,0,31000,-31000,-31000
050590,晶技永豐95購01  ,0,0,0,0,0,0,0,0,0,-31000,0,0,0,79000,110000,-31000,-31000
051033,台積電兆豐95購03,0,0,0,0,0,0,0,0,0,-31000,0,0,0,0,31000,-31000,-31000
05402P,台郡永豐95售02  ,0,0,0,0,0,0,0,0,0,-31000,0,0,0,10000,41000,-31000,-31000
054981,國巨元富97購02  ,0,0,0,0,0,0,0,0,0,-31000,0,0,0,178000,209000,-31000,-31000
05297P,臻鼎凱基95售04  ,0,0,0,0,0,0,0,0,0,-31000,0,0,0,0,31000,-31000,-31000
052896,宏達電群益96購01,0,0,0,0,0,0,0,0,0,-31000,0,0,0,29000,60000,-31000,-31000
052826,嘉聯益永豐96購01,0,0,0,0,0,0,0,0,0,-31000,0,0,0,37000,68000,-31000,-31000
053639,禾伸堂永豐96購01,0,0,0,0,0,0,0,0,0,-31000,0,0,0,9000,40000,-31000,-31000
053588,聯發科元大97購07,0,0,0,0,0,0,0,0,0,-31000,0,0,0,222000,253000,-31000,-31000
06625P,華新科統一98售03,0,0,0,0,0,0,0,0,0,-31000,0,0,0,26000,57000,-31000,-31000
06669P,緯穎凱基98售05  ,0,0,0,0,0,0,0,0,0,-31000,0,0,0,0,31000,-31000,-31000
2030,彰源            ,8000,39000,-31000,0,0,0,0,0,0,0,0,0,0,0,0,0,-31000
06091P,華新科統一97售01,0,0,0,0,0,0,0,0,0,-32000,0,0,0,0,32000,-32000,-32000
06034P,世芯凱基96售03  ,0,0,0,0,0,0,0,0,0,-32000,0,0,0,96000,128000,-32000,-32000
057193,力成元大98購02  ,0,0,0,0,0,0,0,0,0,-32000,0,0,0,0,32000,-32000,-32000
057372,華新科元大99購10,0,0,0,0,0,0,0,0,0,-32000,0,0,0,1000,33000,-32000,-32000
056614,智邦永豐98購01  ,0,0,0,0,0,0,0,0,0,-32000,0,0,0,118000,150000,-32000,-32000
055313,南電群益97購01  ,0,0,0,0,0,0,0,0,0,-32000,0,0,0,69000,101000,-32000,-32000
055595,宏達電元大98購02,0,0,0,0,0,0,0,0,0,-32000,0,0,0,19000,51000,-32000,-32000
056327,樺漢兆豐98購01  ,0,0,0,0,0,0,0,0,0,-32000,0,0,0,8000,40000,-32000,-32000
048453,嘉澤凱基93購05  ,0,0,0,0,0,0,0,0,0,-32000,0,0,0,1000,33000,-32000,-32000
047556,群創凱基95購01  ,0,0,0,0,0,0,0,0,0,-32000,0,0,0,18000,50000,-32000,-32000
04600P,可成凱基94售07  ,0,0,0,0,0,0,0,0,0,-32000,0,0,0,36000,68000,-32000,-32000
052432,康友永豐95購04  ,0,0,0,0,0,0,0,0,0,-32000,0,0,0,19000,51000,-32000,-32000
050013,淘帝國泰95購01  ,0,0,0,0,0,0,0,0,0,-32000,0,0,0,15000,47000,-32000,-32000
049739,大立光群益94購05,0,0,0,0,0,0,0,0,0,-32000,0,0,0,0,32000,-32000,-32000
05055P,台表科群益95售01,0,0,0,0,0,0,0,0,0,-32000,0,0,0,11000,43000,-32000,-32000
049366,聯發科元大94購05,0,0,0,0,0,0,0,0,0,-32000,0,0,0,68000,100000,-32000,-32000
051729,華新國票96購01  ,0,0,0,0,0,0,0,0,0,-32000,0,0,0,0,32000,-32000,-32000
053584,友達元大9B購02  ,0,0,0,0,0,0,0,0,0,-32000,0,0,0,162000,194000,-32000,-32000
053650,華邦電凱基98購01,0,0,0,0,0,0,0,0,0,-32000,0,0,0,6000,38000,-32000,-32000
055084,國巨第一97購01  ,0,0,0,0,0,0,0,0,0,-32000,0,0,0,3000,35000,-32000,-32000
05420P,大立光國泰97售03,0,0,0,0,0,0,0,0,0,-32000,0,0,0,324000,356000,-32000,-32000
1592,英瑞-KY         ,20000,52000,-32000,0,0,0,0,0,0,0,0,0,0,0,0,0,-32000
06378P,國巨統一97售08  ,0,0,0,0,0,0,0,0,0,-32000,0,0,0,52000,84000,-32000,-32000
4306,炎洲            ,3000,35000,-32000,0,0,0,0,0,0,0,0,0,0,0,0,0,-32000
00771,元大US高息特別股,0,0,0,0,0,0,0,0,0,-32232,0,0,0,0,32232,-32232,-32232
055967,臻鼎元大97購01  ,0,0,0,0,0,0,0,0,0,-33000,0,0,0,256000,289000,-33000,-33000
055620,樺漢國票98購01  ,0,0,0,0,0,0,0,0,0,-33000,0,0,0,0,33000,-33000,-33000
055325,佐登國票98購01  ,0,0,0,0,0,0,0,0,0,-33000,0,0,0,93000,126000,-33000,-33000
05805P,義隆永豐96售02  ,0,0,0,0,0,0,0,0,0,-33000,0,0,0,507000,540000,-33000,-33000
06079P,燿華群益98售02  ,0,0,0,0,0,0,0,0,0,-33000,0,0,0,0,33000,-33000,-33000
04272P,元上證凱基94售01,0,0,0,0,0,0,0,0,0,-33000,0,0,0,5000,38000,-33000,-33000
04450P,京元電凱基94售01,0,0,0,0,0,0,0,0,0,-33000,0,0,0,4000,37000,-33000,-33000
044563,亞德客凱基92購01,0,0,0,0,0,0,0,0,0,-33000,0,0,0,17000,50000,-33000,-33000
051704,智邦群益95購02  ,0,0,0,0,0,0,0,0,0,-33000,0,0,0,12000,45000,-33000,-33000
049415,智邦凱基94購02  ,0,0,0,0,0,0,0,0,0,-33000,0,0,0,60000,93000,-33000,-33000
052014,光罩永豐95購01  ,0,0,0,0,0,0,0,0,0,-33000,0,0,0,11000,44000,-33000,-33000
049740,禾伸堂群益94購01,0,0,0,0,0,0,0,0,0,-33000,0,0,0,192000,225000,-33000,-33000
049153,大立光元大96購02,0,0,0,0,0,0,0,0,0,-33000,0,0,0,4000,37000,-33000,-33000
053923,亞光國票97購01  ,0,0,0,0,0,0,0,0,0,-33000,0,0,0,22000,55000,-33000,-33000
053741,漢唐國票97購03  ,0,0,0,0,0,0,0,0,0,-33000,0,0,0,0,33000,-33000,-33000
052254,康友永豐95購03  ,0,0,0,0,0,0,0,0,0,-33000,0,0,0,19000,52000,-33000,-33000
2538,基泰            ,20000,53000,-33000,0,0,0,0,0,0,0,0,0,0,0,0,0,-33000
9136,巨騰-DR         ,1000,34000,-33000,0,0,0,0,0,0,0,0,0,0,0,0,0,-33000
06018P,康控凱基96售03  ,0,0,0,0,0,0,0,0,0,-34000,0,0,0,10000,44000,-34000,-34000
06113P,台積電群益97售01,0,0,0,0,0,0,0,0,0,-34000,0,0,0,289000,323000,-34000,-34000
056726,友達日盛9A購01  ,0,0,0,0,0,0,0,0,0,-34000,0,0,0,114000,148000,-34000,-34000
056754,智易兆豐99購01  ,0,0,0,0,0,0,0,0,0,-34000,0,0,0,16000,50000,-34000,-34000
057159,晶技永豐98購01  ,0,0,0,0,0,0,0,0,0,-34000,0,0,0,89000,123000,-34000,-34000
057166,國巨元大99購06  ,0,0,0,0,0,0,0,0,0,-34000,0,0,0,66000,100000,-34000,-34000
055461,TPK永豐97購01   ,0,0,0,0,0,0,0,0,0,-34000,0,0,0,40000,74000,-34000,-34000
056325,群創兆豐9A購01  ,0,0,0,0,0,0,0,0,0,-34000,0,0,0,6000,40000,-34000,-34000
05637P,聯電元大96售04  ,0,0,0,0,0,0,0,0,0,-34000,0,0,0,66000,100000,-34000,-34000
044184,南亞科國泰93購01,0,0,0,0,0,0,0,0,0,-34000,0,0,0,5000,39000,-34000,-34000
047965,景碩中信93購01  ,0,0,0,0,0,0,0,0,0,-34000,0,0,0,0,34000,-34000,-34000
00851,台新全球AI      ,0,0,0,0,0,0,0,0,0,-34000,0,0,0,2000,36000,-34000,-34000
00674R,元大S&P黃金反1  ,0,0,0,0,0,0,0,0,0,-34000,0,0,0,1000,35000,-34000,-34000
051426,道瓊反統一95購02,0,0,0,0,0,0,0,0,0,-34000,0,0,0,0,34000,-34000,-34000
052387,台積電群益95購08,0,0,0,0,0,0,0,0,0,-34000,0,0,0,667000,701000,-34000,-34000
052605,聯發科元大96購06,0,0,0,0,0,0,0,0,0,-34000,0,0,0,0,34000,-34000,-34000
052661,奇力新國票97購03,0,0,0,0,0,0,0,0,0,-34000,0,0,0,40000,74000,-34000,-34000
048979,晶相光元大94購03,0,0,0,0,0,0,0,0,0,-34000,0,0,0,34000,68000,-34000,-34000
052065,臺股指國票95購12,0,0,0,0,0,0,0,0,0,-34000,0,0,0,0,34000,-34000,-34000
049386,嘉聯益元大95購01,0,0,0,0,0,0,0,0,0,-34000,0,0,0,1000,35000,-34000,-34000
052250,光磊永豐95購01  ,0,0,0,0,0,0,0,0,0,-34000,0,0,0,10000,44000,-34000,-34000
052704,TPK國票97購01   ,0,0,0,0,0,0,0,0,0,-34000,0,0,0,105000,139000,-34000,-34000
052297,旭富國票96購01  ,0,0,0,0,0,0,0,0,0,-34000,0,0,0,73000,107000,-34000,-34000
052993,欣興台新97購01  ,0,0,0,0,0,0,0,0,0,-34000,0,0,0,0,34000,-34000,-34000
05306P,泰碩國泰97售01  ,0,0,0,0,0,0,0,0,0,-34000,0,0,0,4000,38000,-34000,-34000
05428P,滬深2X統一95售01,0,0,0,0,0,0,0,0,0,-34000,0,0,0,13000,47000,-34000,-34000
054776,矽創國票98購01  ,0,0,0,0,0,0,0,0,0,-34000,0,0,0,11000,45000,-34000,-34000
056056,旺宏元大97購06  ,0,0,0,0,0,0,0,0,0,-35000,0,0,0,335000,370000,-35000,-35000
056177,嘉澤元富97購01  ,0,0,0,0,0,0,0,0,0,-35000,0,0,0,37000,72000,-35000,-35000
055867,臺股指元大97購05,0,0,0,0,0,0,0,0,0,-35000,0,0,0,0,35000,-35000,-35000
056571,燿華元大98購02  ,0,0,0,0,0,0,0,0,0,-35000,0,0,0,33000,68000,-35000,-35000
050396,欣興元富94購02  ,0,0,0,0,0,0,0,0,0,-35000,0,0,0,320000,355000,-35000,-35000
04767P,台積電國泰95售04,0,0,0,0,0,0,0,0,0,-35000,0,0,0,21000,56000,-35000,-35000
047789,景碩群益93購01  ,0,0,0,0,0,0,0,0,0,-35000,0,0,0,0,35000,-35000,-35000
052076,可成元富98購01  ,0,0,0,0,0,0,0,0,0,-35000,0,0,0,60000,95000,-35000,-35000
050978,鴻海元富95購03  ,0,0,0,0,0,0,0,0,0,-35000,0,0,0,0,35000,-35000,-35000
049134,為升元大95購01  ,0,0,0,0,0,0,0,0,0,-35000,0,0,0,0,35000,-35000,-35000
054972,聯茂元大97購02  ,0,0,0,0,0,0,0,0,0,-35000,0,0,0,67000,102000,-35000,-35000
055228,聯發科國票98購03,0,0,0,0,0,0,0,0,0,-35000,0,0,0,0,35000,-35000,-35000
054035,聯詠麥證96購01  ,0,0,0,15000,50000,-35000,0,0,0,-35000,0,0,0,15000,50000,-35000,-35000
054539,欣興國票98購01  ,0,0,0,0,0,0,0,0,0,-35000,0,0,0,115000,150000,-35000,-35000
054522,康友元大96購07  ,0,0,0,0,0,0,0,0,0,-35000,0,0,0,70000,105000,-35000,-35000
054641,祥碩中信98購01  ,0,0,0,0,0,0,0,0,0,-35000,0,0,0,0,35000,-35000,-35000
054495,滬深2X永豐97購02,0,0,0,0,0,0,0,0,0,-35000,0,0,0,0,35000,-35000,-35000
054362,亞光凱基96購03  ,0,0,0,0,0,0,0,0,0,-35000,0,0,0,0,35000,-35000,-35000
05313P,臺股指群益95售12,0,0,0,0,0,0,0,0,0,-35000,0,0,0,15000,50000,-35000,-35000
053210,華邦電凱基97購02,0,0,0,0,0,0,0,0,0,-35000,0,0,0,0,35000,-35000,-35000
052923,台積電永豐96購02,0,0,0,0,0,0,0,0,0,-35000,0,0,0,0,35000,-35000,-35000
053439,台積電凱基96購11,0,0,0,0,0,0,0,0,0,-35000,0,0,0,25000,60000,-35000,-35000
3038,全台            ,44000,98000,-54000,0,0,0,0,0,0,19000,19000,0,19000,0,0,0,-35000
2484,希華            ,15000,50000,-35000,0,0,0,0,0,0,0,0,0,0,0,0,0,-35000
1476,儒鴻            ,153000,184000,-31000,0,0,0,0,540,-540,-4000,6000,15000,-9000,5000,0,5000,-35540
057143,台郡兆豐98購01  ,0,0,0,0,0,0,0,0,0,-36000,0,0,0,100000,136000,-36000,-36000
055801,景碩永豐97購02  ,0,0,0,0,0,0,0,0,0,-36000,0,0,0,16000,52000,-36000,-36000
055471,聯發科凱基97購04,0,0,0,0,0,0,0,0,0,-36000,0,0,0,49000,85000,-36000,-36000
056014,上銀群益97購02  ,0,0,0,0,0,0,0,0,0,-36000,0,0,0,6000,42000,-36000,-36000
047822,臺股指凱基93購16,0,0,0,0,0,0,0,0,0,-36000,0,0,0,0,36000,-36000,-36000
050964,晶技永豐95購02  ,0,0,0,0,0,0,0,0,0,-36000,0,0,0,120000,156000,-36000,-36000
048869,光罩國票94購01  ,0,0,0,0,0,0,0,0,0,-36000,0,0,0,23000,59000,-36000,-36000
049718,南亞科凱基94購04,0,0,0,0,0,0,0,0,0,-36000,0,0,0,0,36000,-36000,-36000
050760,矽力元富94購03  ,0,0,0,0,0,0,0,0,0,-36000,0,0,0,0,36000,-36000,-36000
053836,亞光永豐96購02  ,0,0,0,0,0,0,0,0,0,-36000,0,0,0,43000,79000,-36000,-36000
052313,聯電元大98購01  ,0,0,0,0,0,0,0,0,0,-36000,0,0,0,53000,89000,-36000,-36000
1558,伸興            ,9000,18000,-9000,0,0,0,0,0,0,-27000,0,27000,-27000,0,0,0,-36000
06247P,同欣電元富97售02,0,0,0,0,0,0,0,0,0,-36000,0,0,0,2000,38000,-36000,-36000
2496,卓越            ,3000,39000,-36000,0,0,0,0,0,0,0,0,0,0,0,0,0,-36000
4552,力達-KY         ,8000,44000,-36000,0,0,0,0,0,0,0,0,0,0,0,0,0,-36000
056475,宏達電元大99購02,0,0,0,0,0,0,0,0,0,-37000,0,0,0,42000,79000,-37000,-37000
055773,瑞昱凱基97購03  ,0,0,0,0,0,0,0,0,0,-37000,0,0,0,78000,115000,-37000,-37000
056764,友達元大9A購03  ,0,0,0,0,0,0,0,0,0,-37000,0,0,0,225000,262000,-37000,-37000
057174,南亞科元大98購05,0,0,0,0,0,0,0,0,0,-37000,0,0,0,15000,52000,-37000,-37000
03875P,滬深2X國票05售01,0,0,0,0,0,0,0,0,0,-37000,0,0,0,0,37000,-37000,-37000
048498,嘉澤元大94購01  ,0,0,0,0,0,0,0,0,0,-37000,0,0,0,9000,46000,-37000,-37000
047548,友達凱基99購03  ,0,0,0,0,0,0,0,0,0,-37000,0,0,0,14000,51000,-37000,-37000
051699,世紀鋼麥證95購01,0,0,0,0,37000,-37000,0,0,0,-37000,0,0,0,0,37000,-37000,-37000
049933,GIS元大95購01   ,0,0,0,0,0,0,0,0,0,-37000,0,0,0,49000,86000,-37000,-37000
052107,台積電統一95購06,0,0,0,0,0,0,0,0,0,-37000,0,0,0,136000,173000,-37000,-37000
052464,大立光統一95購05,0,0,0,0,0,0,0,0,0,-37000,0,0,0,55000,92000,-37000,-37000
053165,大立光群益96購03,0,0,0,0,0,0,0,0,0,-37000,0,0,0,27000,64000,-37000,-37000
053559,台積電國泰98購01,0,0,0,0,0,0,0,0,0,-37000,0,0,0,33000,70000,-37000,-37000
054354,技嘉富邦97購01  ,0,0,0,0,0,0,0,0,0,-37000,0,0,0,289000,326000,-37000,-37000
054927,帆宣凱基97購01  ,0,0,0,0,0,0,0,0,0,-37000,0,0,0,348000,385000,-37000,-37000
5258,虹堡            ,15000,52000,-37000,0,0,0,0,0,0,0,0,0,0,0,0,0,-37000
2351,順德            ,28000,59000,-31000,0,0,0,0,0,0,-6000,0,0,0,0,6000,-6000,-37000
2499,東貝            ,24000,62000,-38000,0,0,0,0,0,0,1000,1000,0,1000,0,0,0,-37000
056579,麗豐元大99購01  ,0,0,0,0,0,0,0,0,0,-38000,0,0,0,22000,60000,-38000,-38000
05589P,大立光中信9A售01,0,0,0,0,0,0,0,0,0,-38000,0,0,0,0,38000,-38000,-38000
055597,禾伸堂元大98購02,0,0,0,0,0,0,0,0,0,-38000,0,0,0,23000,61000,-38000,-38000
056175,可成元富97購03  ,0,0,0,0,0,0,0,0,0,-38000,0,0,0,27000,65000,-38000,-38000
056141,聯茂元大97購05  ,0,0,0,0,0,0,0,0,0,-38000,0,0,0,14000,52000,-38000,-38000
051870,台郡凱基95購04  ,0,0,0,0,0,0,0,0,0,-38000,0,0,0,42000,80000,-38000,-38000
048631,遠東新元大93購01,0,0,0,0,0,0,0,0,0,-38000,0,0,0,30000,68000,-38000,-38000
048657,大成鋼統一93購04,0,0,0,0,0,0,0,0,0,-38000,0,0,0,2000,40000,-38000,-38000
046369,同欣電日盛92購01,0,0,0,0,0,0,0,0,0,-38000,0,0,0,94000,132000,-38000,-38000
043641,深中小國票94購01,0,0,0,0,0,0,0,0,0,-38000,0,0,0,4000,42000,-38000,-38000
052379,鈺齊元大95購04  ,0,0,0,0,0,0,0,0,0,-38000,0,0,0,120000,158000,-38000,-38000
052337,臺股指日盛95購02,0,0,0,0,0,0,0,0,0,-38000,0,0,0,2000,40000,-38000,-38000
051634,大立光國票96購03,0,0,0,0,0,0,0,0,0,-38000,0,0,0,30000,68000,-38000,-38000
050270,景碩元大94購01  ,0,0,0,0,0,0,0,0,0,-38000,0,0,0,64000,102000,-38000,-38000
054851,樺漢兆豐97購01  ,0,0,0,0,0,0,0,0,0,-38000,0,0,0,2000,40000,-38000,-38000
054390,智邦元富96購03  ,0,0,0,0,0,0,0,0,0,-38000,0,0,0,8000,46000,-38000,-38000
054547,鴻海凱基98購02  ,0,0,0,0,0,0,0,0,0,-38000,0,0,0,30000,68000,-38000,-38000
054320,國喬台新96購01  ,0,0,0,0,0,0,0,0,0,-38000,0,0,0,0,38000,-38000,-38000
053919,可成國票97購02  ,0,0,0,0,0,0,0,0,0,-38000,0,0,0,47000,85000,-38000,-38000
053209,台積電凱基96購07,0,0,0,0,0,0,0,0,0,-38000,0,0,0,0,38000,-38000,-38000
052294,創意國票96購03  ,0,0,0,0,0,0,0,0,0,-38000,0,0,0,0,38000,-38000,-38000
06591P,大立光元大98售14,0,0,0,0,0,0,0,0,0,-38000,0,0,0,5000,43000,-38000,-38000
1321,大洋            ,1000,39000,-38000,0,0,0,0,0,0,0,0,0,0,0,0,0,-38000
056162,祥碩凱基97購03  ,0,0,0,0,0,0,0,0,0,-39000,0,0,0,8000,47000,-39000,-39000
05616P,台光電永豐96售01,0,0,0,0,0,0,0,0,0,-39000,0,0,0,30000,69000,-39000,-39000
055861,矽力元大97購03  ,0,0,0,0,0,0,0,0,0,-39000,0,0,0,29000,68000,-39000,-39000
055710,亞德客元大97購03,0,0,0,0,0,0,0,0,0,-39000,0,0,0,243000,282000,-39000,-39000
056553,啟碁凱基98購02  ,0,0,0,0,0,0,0,0,0,-39000,0,0,0,21000,60000,-39000,-39000
05732P,臺股指統一96售02,0,0,0,0,0,0,0,0,0,-39000,0,0,0,11000,50000,-39000,-39000
057277,可成元大98購05  ,0,0,0,0,0,0,0,0,0,-39000,0,0,0,18000,57000,-39000,-39000
0052,富邦科技        ,1000,1000,0,0,0,0,0,0,0,-39000,0,0,0,108000,147000,-39000,-39000
048630,南亞元大93購01  ,0,0,0,0,0,0,0,0,0,-39000,0,0,0,0,39000,-39000,-39000
051861,鴻海凱基98購01  ,0,0,0,0,0,0,0,0,0,-39000,0,0,0,50000,89000,-39000,-39000
048154,旺宏兆豐94購01  ,0,0,0,0,0,0,0,0,0,-39000,0,0,0,118000,157000,-39000,-39000
048281,矽力永豐93購02  ,0,0,0,0,0,0,0,0,0,-39000,0,0,0,31000,70000,-39000,-39000
052078,大立光元富95購10,0,0,0,0,0,0,0,0,0,-39000,0,0,0,1000,40000,-39000,-39000
050880,大立光元富95購03,0,0,0,0,0,0,0,0,0,-39000,0,0,0,14000,53000,-39000,-39000
053199,旺宏日盛96購01  ,0,0,0,0,0,0,0,0,0,-39000,0,0,0,10000,49000,-39000,-39000
053343,宏達電國票97購02,0,0,0,0,0,0,0,0,0,-39000,0,0,0,54000,93000,-39000,-39000
054043,漢唐元大97購01  ,0,0,0,0,0,0,0,0,0,-39000,0,0,0,25000,64000,-39000,-39000
054488,禾伸堂台新96購01,0,0,0,0,0,0,0,0,0,-39000,0,0,0,59000,98000,-39000,-39000
054865,可成群益97購01  ,0,0,0,0,0,0,0,0,0,-39000,0,0,0,254000,293000,-39000,-39000
054836,勤誠中信97購01  ,0,0,0,0,0,0,0,0,0,-39000,0,0,0,11000,50000,-39000,-39000
1589,永冠-KY         ,27000,64000,-37000,0,0,0,0,0,0,-2000,13000,15000,-2000,0,0,0,-39000
6525,捷敏-KY         ,5000,14000,-9000,0,0,0,0,30000,-30000,0,0,0,0,0,0,0,-39000
057286,群創元大9B購05  ,0,0,0,0,0,0,0,0,0,-40000,0,0,0,3000,43000,-40000,-40000
057183,玉晶光元大99購07,0,0,0,0,0,0,0,0,0,-40000,0,0,0,140000,180000,-40000,-40000
057203,麗豐元富98購02  ,0,0,0,0,0,0,0,0,0,-40000,0,0,0,0,40000,-40000,-40000
05764P,世紀鋼永豐96售03,0,0,0,0,0,0,0,0,0,-40000,0,0,0,0,40000,-40000,-40000
056904,大立光元大99購05,0,0,0,0,0,0,0,0,0,-40000,0,0,0,0,40000,-40000,-40000
055706,大立光永豐97購03,0,0,0,0,0,0,0,0,0,-40000,0,0,0,60000,100000,-40000,-40000
055653,聯詠元富01購02  ,0,0,0,0,0,0,0,0,0,-40000,0,0,0,0,40000,-40000,-40000
055906,大立光兆豐97購03,0,0,0,0,0,0,0,0,0,-40000,0,0,0,0,40000,-40000,-40000
055780,禾伸堂凱基99購01,0,0,0,0,0,0,0,0,0,-40000,0,0,0,53000,93000,-40000,-40000
055366,國巨元大98購05  ,0,0,0,0,0,0,0,0,0,-40000,0,0,0,217000,257000,-40000,-40000
056129,義隆麥證97購01  ,0,0,0,10000,50000,-40000,0,0,0,-40000,0,0,0,10000,50000,-40000,-40000
056122,勤誠群益97購02  ,0,0,0,0,0,0,0,0,0,-40000,0,0,0,0,40000,-40000,-40000
055939,GIS群益97購01   ,0,0,0,0,0,0,0,0,0,-40000,0,0,0,0,40000,-40000,-40000
056479,玉晶光元大99購05,0,0,0,0,0,0,0,0,0,-40000,0,0,0,12000,52000,-40000,-40000
056363,華新科元大99購04,0,0,0,0,0,0,0,0,0,-40000,0,0,0,37000,77000,-40000,-40000
047386,南亞科元大93購01,0,0,0,0,0,0,0,0,0,-40000,0,0,0,20000,60000,-40000,-40000
048533,景碩國票94購01  ,0,0,0,0,0,0,0,0,0,-40000,0,0,0,0,40000,-40000,-40000
047598,深中小統一94購01,0,0,0,0,0,0,0,0,0,-40000,0,0,0,30000,70000,-40000,-40000
051846,S&P反1中信96購02,0,0,0,0,0,0,0,0,0,-40000,0,0,0,0,40000,-40000,-40000
051900,臻鼎富邦95購01  ,0,0,0,0,0,0,0,0,0,-40000,0,0,0,0,40000,-40000,-40000
051810,欣興凱基95購03  ,0,0,0,0,0,0,0,0,0,-40000,0,0,0,0,40000,-40000,-40000
051784,國巨兆豐95購01  ,0,0,0,0,0,0,0,0,0,-40000,0,0,0,10000,50000,-40000,-40000
049206,大立光群益94購04,0,0,0,0,0,0,0,0,0,-40000,0,0,0,0,40000,-40000,-40000
048705,GIS國票95購01   ,0,0,0,0,0,0,0,0,0,-40000,0,0,0,10000,50000,-40000,-40000
048771,嘉澤凱基94購01  ,0,0,0,0,0,0,0,0,0,-40000,0,0,0,8000,48000,-40000,-40000
03102P,臺股指凱基03售08,0,0,0,0,0,0,0,0,0,-40000,0,0,0,0,40000,-40000,-40000
04597P,為升凱基94售02  ,0,0,0,0,0,0,0,0,0,-40000,0,0,0,0,40000,-40000,-40000
04383P,泰鼎國泰95售01  ,0,0,0,0,0,0,0,0,0,-40000,0,0,0,522000,562000,-40000,-40000
045021,臺股指中信94購02,0,0,0,0,0,0,0,0,0,-40000,0,0,0,0,40000,-40000,-40000
04638P,臺股指群益94售13,0,0,0,0,0,0,0,0,0,-40000,0,0,0,10000,50000,-40000,-40000
050870,旭富永豐95購01  ,0,0,0,0,0,0,0,0,0,-40000,0,0,0,0,40000,-40000,-40000
049695,新光金元大9A購01,0,0,0,0,0,0,0,0,0,-40000,0,0,0,0,40000,-40000,-40000
049547,新光金群益94購01,0,0,0,0,0,0,0,0,0,-40000,0,0,0,0,40000,-40000,-40000
049056,玉晶光永豐95購03,0,0,0,0,0,0,0,0,0,-40000,0,0,0,0,40000,-40000,-40000
049033,大成鋼兆豐94購01,0,0,0,0,0,0,0,0,0,-40000,0,0,0,0,40000,-40000,-40000
051009,緯創麥證95購01  ,0,0,0,10000,50000,-40000,0,0,0,-40000,0,0,0,10000,50000,-40000,-40000
049979,美律凱基94購07  ,0,0,0,0,0,0,0,0,0,-40000,0,0,0,0,40000,-40000,-40000
052521,友達元大9B購01  ,0,0,0,0,0,0,0,0,0,-40000,0,0,0,320000,360000,-40000,-40000
052118,鴻海國票96購04  ,0,0,0,0,0,0,0,0,0,-40000,0,0,0,0,40000,-40000,-40000
051017,聯發科凱基95購04,0,0,0,0,0,0,0,0,0,-40000,0,0,0,20000,60000,-40000,-40000
049849,欣興群益94購04  ,0,0,0,0,0,0,0,0,0,-40000,0,0,0,0,40000,-40000,-40000
051972,廣達凱基95購02  ,0,0,0,0,0,0,0,0,0,-40000,0,0,0,0,40000,-40000,-40000
051515,聯發科凱基95購10,0,0,0,0,0,0,0,0,0,-40000,0,0,0,50000,90000,-40000,-40000
050433,華新科凱基94購11,0,0,0,0,0,0,0,0,0,-40000,0,0,0,22000,62000,-40000,-40000
050577,美律國票94購03  ,0,0,0,0,0,0,0,0,0,-40000,0,0,0,0,40000,-40000,-40000
050133,鈺齊凱基94購01  ,0,0,0,0,0,0,0,0,0,-40000,0,0,0,0,40000,-40000,-40000
050322,世紀鋼國票95購01,0,0,0,0,0,0,0,0,0,-40000,0,0,0,0,40000,-40000,-40000
050315,和碩兆豐95購01  ,0,0,0,0,0,0,0,0,0,-40000,0,0,0,0,40000,-40000,-40000
05018P,臺股指元大95售09,0,0,0,0,0,0,0,0,0,-40000,0,0,0,85000,125000,-40000,-40000
051163,鴻海元大95購04  ,0,0,0,0,0,0,0,0,0,-40000,0,0,0,491000,531000,-40000,-40000
055076,福懋科永豐97購01,0,0,0,0,0,0,0,0,0,-40000,0,0,0,275000,315000,-40000,-40000
055060,聯陽永豐97購01  ,0,0,0,0,0,0,0,0,0,-40000,0,0,0,0,40000,-40000,-40000
05439P,聯發科國票95售06,0,0,0,0,0,0,0,0,0,-40000,0,0,0,10000,50000,-40000,-40000
054112,台積電麥證96購02,0,0,0,0,40000,-40000,0,0,0,-40000,0,0,0,0,40000,-40000,-40000
054103,T50反1凱基99購04,0,0,0,0,0,0,0,0,0,-40000,0,0,0,35000,75000,-40000,-40000
053591,大立光元大99購03,0,0,0,0,0,0,0,0,0,-40000,0,0,0,10000,50000,-40000,-40000
05323P,瑞昱凱基96售02  ,0,0,0,0,0,0,0,0,0,-40000,0,0,0,0,40000,-40000,-40000
053229,南電台新97購01  ,0,0,0,0,0,0,0,0,0,-40000,0,0,0,0,40000,-40000,-40000
053304,可成凱基96購03  ,0,0,0,0,0,0,0,0,0,-40000,0,0,0,17000,57000,-40000,-40000
053286,臺股指元大96購14,0,0,0,0,0,0,0,0,0,-40000,0,0,0,0,40000,-40000,-40000
053112,中磊兆豐97購01  ,0,0,0,0,0,0,0,0,0,-40000,0,0,0,10000,50000,-40000,-40000
052985,美律元大96購02  ,0,0,0,0,0,0,0,0,0,-40000,0,0,0,9000,49000,-40000,-40000
052982,鴻海元大97購06  ,0,0,0,0,0,0,0,0,0,-40000,0,0,0,0,40000,-40000,-40000
052964,台表科凱基96購03,0,0,0,0,0,0,0,0,0,-40000,0,0,0,0,40000,-40000,-40000
052256,台泥國泰96購01  ,0,0,0,0,0,0,0,0,0,-40000,0,0,0,0,40000,-40000,-40000
052198,鴻海統一95購10  ,0,0,0,0,0,0,0,0,0,-40000,0,0,0,0,40000,-40000,-40000
056364,亞光元大99購02  ,0,0,0,0,0,0,0,0,0,-41000,0,0,0,31000,72000,-41000,-41000
056033,T50正2凱基99購02,0,0,0,0,0,0,0,0,0,-41000,0,0,0,110000,151000,-41000,-41000
056135,緯創元大98購01  ,0,0,0,0,0,0,0,0,0,-41000,0,0,0,9000,50000,-41000,-41000
06111P,上銀兆豐98售01  ,0,0,0,0,0,0,0,0,0,-41000,0,0,0,4000,45000,-41000,-41000
05877P,大立光群益96售06,0,0,0,0,0,0,0,0,0,-41000,0,0,0,64000,105000,-41000,-41000
044411,A50正2統一93購01,0,0,0,0,0,0,0,0,0,-41000,0,0,0,0,41000,-41000,-41000
044853,亞光國泰93購01  ,0,0,0,0,0,0,0,0,0,-41000,0,0,0,20000,61000,-41000,-41000
00714,群益道瓊美國地產,0,0,0,0,0,0,0,0,0,-41000,0,0,0,120000,161000,-41000,-41000
051127,同欣電群益95購01,0,0,0,0,0,0,0,0,0,-41000,0,0,0,471000,512000,-41000,-41000
050613,台光電元大94購09,0,0,0,0,0,0,0,0,0,-41000,0,0,0,68000,109000,-41000,-41000
050518,台積電元大94購28,0,0,0,0,0,0,0,0,0,-41000,0,0,0,205000,246000,-41000,-41000
052514,嘉澤凱基96購01  ,0,0,0,0,0,0,0,0,0,-41000,0,0,0,10000,51000,-41000,-41000
051006,中磊中信95購01  ,0,0,0,0,0,0,0,0,0,-41000,0,0,0,79000,120000,-41000,-41000
052767,智伸科群益98購01,0,0,0,0,0,0,0,0,0,-41000,0,0,0,0,41000,-41000,-41000
053780,南亞科元大96購03,0,0,0,0,0,0,0,0,0,-41000,0,0,0,95000,136000,-41000,-41000
053701,台積電兆豐96購05,0,0,0,0,0,0,0,0,0,-41000,0,0,0,194000,235000,-41000,-41000
054198,台積電永昌96購08,0,0,0,0,0,0,0,0,0,-41000,0,0,0,295000,336000,-41000,-41000
3052,夆典            ,0,41000,-41000,0,0,0,0,0,0,0,0,0,0,0,0,0,-41000
1460,宏遠            ,2000,43000,-41000,0,0,0,0,0,0,0,0,0,0,0,0,0,-41000
06594P,立積元大98售01  ,0,0,0,0,0,0,0,0,0,-41000,0,0,0,100000,141000,-41000,-41000
06058P,玉晶光凱基97售04,0,0,0,0,0,0,0,0,0,-42000,0,0,0,101000,143000,-42000,-42000
05632P,大立光群益96售02,0,0,0,0,0,0,0,0,0,-42000,0,0,0,5000,47000,-42000,-42000
055324,TPK國票98購03   ,0,0,0,0,0,0,0,0,0,-42000,0,0,0,0,42000,-42000,-42000
047781,上銀國泰94購02  ,0,0,0,0,0,0,0,0,0,-42000,0,0,0,0,42000,-42000,-42000
048937,玉晶光永豐95購01,0,0,0,0,0,0,0,0,0,-42000,0,0,0,339000,381000,-42000,-42000
050117,麗豐元大96購02  ,0,0,0,0,0,0,0,0,0,-42000,0,0,0,0,42000,-42000,-42000
051241,台積電元大95購13,0,0,0,0,0,0,0,0,0,-42000,0,0,0,176000,218000,-42000,-42000
051674,臻鼎元大95購02  ,0,0,0,0,0,0,0,0,0,-42000,0,0,0,30000,72000,-42000,-42000
054233,聯發科群益96購04,0,0,0,0,0,0,0,0,0,-42000,0,0,0,91000,133000,-42000,-42000
054319,世紀鋼凱基96購02,0,0,0,0,0,0,0,0,0,-42000,0,0,0,0,42000,-42000,-42000
053665,臺股指凱基96購26,0,0,0,0,0,0,0,0,0,-42000,0,0,0,0,42000,-42000,-42000
053681,臺股指富邦96購02,0,0,0,0,0,0,0,0,0,-42000,0,0,0,20000,62000,-42000,-42000
053424,欣興永豐96購02  ,0,0,0,0,0,0,0,0,0,-42000,0,0,0,7000,49000,-42000,-42000
052955,國巨日盛96購01  ,0,0,0,0,0,0,0,0,0,-42000,0,0,0,60000,102000,-42000,-42000
053164,台光電群益96購02,0,0,0,0,0,0,0,0,0,-42000,0,0,0,30000,72000,-42000,-42000
8016,矽創            ,366000,380000,-14000,0,0,0,0,18000,-18000,-10000,6000,0,6000,0,16000,-16000,-42000
2467,志聖            ,1000,43000,-42000,0,0,0,0,0,0,0,0,0,0,0,0,0,-42000
057429,華新科兆豐98購03,0,0,0,0,0,0,0,0,0,-43000,0,0,0,0,43000,-43000,-43000
056963,建準永豐98購01  ,0,0,0,0,0,0,0,0,0,-43000,0,0,0,0,43000,-43000,-43000
03591P,台積電國票03售10,0,0,0,0,0,0,0,0,0,-43000,0,0,0,0,43000,-43000,-43000
03651C,臺股指凱基97牛17,0,0,0,0,0,0,0,0,0,-43000,0,0,0,52000,95000,-43000,-43000
047418,智邦富邦97購01  ,0,0,0,0,0,0,0,0,0,-43000,0,0,0,101000,144000,-43000,-43000
051741,可成國票97購01  ,0,0,0,0,0,0,0,0,0,-43000,0,0,0,4000,47000,-43000,-43000
051617,台積電凱基95購14,0,0,0,0,0,0,0,0,0,-43000,0,0,0,0,43000,-43000,-43000
050517,台積電元大94購27,0,0,0,0,0,0,0,0,0,-43000,0,0,0,129000,172000,-43000,-43000
051937,廣達群益95購01  ,0,0,0,0,0,0,0,0,0,-43000,0,0,0,22000,65000,-43000,-43000
050801,元金2X群益98購01,0,0,0,0,0,0,0,0,0,-43000,0,0,0,30000,73000,-43000,-43000
049877,南亞科永豐94購01,0,0,0,0,0,0,0,0,0,-43000,0,0,0,76000,119000,-43000,-43000
052907,嘉澤國票97購01  ,0,0,0,0,0,0,0,0,0,-43000,0,0,0,10000,53000,-43000,-43000
052934,中磊元大96購01  ,0,0,0,0,0,0,0,0,0,-43000,0,0,0,142000,185000,-43000,-43000
053750,致伸永豐96購02  ,0,0,0,0,0,0,0,0,0,-43000,0,0,0,0,43000,-43000,-43000
054152,漢唐國泰98購02  ,0,0,0,0,0,0,0,0,0,-43000,0,0,0,30000,73000,-43000,-43000
054744,晶相光凱基99購01,0,0,0,0,0,0,0,0,0,-43000,0,0,0,13000,56000,-43000,-43000
6288,聯嘉            ,116000,160000,-44000,0,0,0,0,0,0,1000,2000,1000,1000,0,0,0,-43000
06230P,亞德客永豐97售03,0,0,0,0,0,0,0,0,0,-43000,0,0,0,0,43000,-43000,-43000
06428P,國巨元大97售17  ,0,0,0,0,0,0,0,0,0,-43000,0,0,0,64000,107000,-43000,-43000
056615,燿華永豐98購02  ,0,0,0,0,0,0,0,0,0,-44000,0,0,0,13000,57000,-44000,-44000
056712,京鼎永豐98購01  ,0,0,0,0,0,0,0,0,0,-44000,0,0,0,216000,260000,-44000,-44000
056828,國巨富邦9A購03  ,0,0,0,0,0,0,0,0,0,-44000,0,0,0,16000,60000,-44000,-44000
057478,智邦元大99購01  ,0,0,0,0,0,0,0,0,0,-44000,0,0,0,35000,79000,-44000,-44000
05556P,全新國票96售04  ,0,0,0,0,0,0,0,0,0,-44000,0,0,0,120000,164000,-44000,-44000
055736,宏達電元富99購01,0,0,0,0,0,0,0,0,0,-44000,0,0,0,6000,50000,-44000,-44000
045454,上銀元大93購01  ,0,0,0,0,0,0,0,0,0,-44000,0,0,0,11000,55000,-44000,-44000
049949,燿華群益96購01  ,0,0,0,0,0,0,0,0,0,-44000,0,0,0,0,44000,-44000,-44000
051931,美律國票96購02  ,0,0,0,0,0,0,0,0,0,-44000,0,0,0,5000,49000,-44000,-44000
052045,瑞昱凱基96購01  ,0,0,0,0,0,0,0,0,0,-44000,0,0,0,118000,162000,-44000,-44000
050454,嘉澤元大94購04  ,0,0,0,0,0,0,0,0,0,-44000,0,0,0,23000,67000,-44000,-44000
051600,新日興兆豐96購02,0,0,0,0,0,0,0,0,0,-44000,0,0,0,149000,193000,-44000,-44000
051325,台光電台新96購01,0,0,0,0,0,0,0,0,0,-44000,0,0,0,0,44000,-44000,-44000
050168,緯創富邦95購01  ,0,0,0,0,0,0,0,0,0,-44000,0,0,0,0,44000,-44000,-44000
054123,易華電永豐96購03,0,0,0,0,0,0,0,0,0,-44000,0,0,0,22000,66000,-44000,-44000
05284P,鴻海兆豐95售04  ,0,0,0,0,0,0,0,0,0,-44000,0,0,0,59000,103000,-44000,-44000
06675P,國巨國票99售02  ,0,0,0,0,0,0,0,0,0,-44000,0,0,0,0,44000,-44000,-44000
4720,德淵            ,18000,21000,-3000,0,0,0,0,0,0,-41000,14000,55000,-41000,0,0,0,-44000
055648,可成元富97購01  ,0,0,0,0,0,0,0,0,0,-45000,0,0,0,30000,75000,-45000,-45000
055678,上銀凱基97購02  ,0,0,0,0,0,0,0,0,0,-45000,0,0,0,6000,51000,-45000,-45000
04542P,致伸永豐94售01  ,0,0,0,0,0,0,0,0,0,-45000,0,0,0,0,45000,-45000,-45000
047975,緯創兆豐93購01  ,0,0,0,0,0,0,0,0,0,-45000,0,0,0,30000,75000,-45000,-45000
04116P,京元電元大94售02,0,0,0,0,0,0,0,0,0,-45000,0,0,0,0,45000,-45000,-45000
042317,台灣50永豐96購01,0,0,0,0,0,0,0,0,0,-45000,0,0,0,26000,71000,-45000,-45000
048246,京元電兆豐93購02,0,0,0,0,0,0,0,0,0,-45000,0,0,0,0,45000,-45000,-45000
049696,欣興元大95購02  ,0,0,0,0,0,0,0,0,0,-45000,0,0,0,11000,56000,-45000,-45000
05300P,健策元大95售02  ,0,0,0,0,0,0,0,0,0,-45000,0,0,0,0,45000,-45000,-45000
052414,聯電麥證95購01  ,0,0,0,10000,55000,-45000,0,0,0,-45000,0,0,0,10000,55000,-45000,-45000
052642,滬深2X永豐96購03,0,0,0,0,0,0,0,0,0,-45000,0,0,0,20000,65000,-45000,-45000
052226,旺宏凱基95購06  ,0,0,0,0,0,0,0,0,0,-45000,0,0,0,0,45000,-45000,-45000
053863,聯發科元大96購18,0,0,0,0,0,0,0,0,0,-45000,0,0,0,45000,90000,-45000,-45000
054124,達方永豐96購02  ,0,0,0,0,0,0,0,0,0,-45000,0,0,0,0,45000,-45000,-45000
054555,欣興凱基98購01  ,0,0,0,0,0,0,0,0,0,-45000,0,0,0,199000,244000,-45000,-45000
2855,統一證          ,59000,104000,-45000,0,0,0,0,0,0,0,0,0,0,0,0,0,-45000
055785,祥碩凱基97購02  ,0,0,0,0,0,0,0,0,0,-46000,0,0,0,10000,56000,-46000,-46000
055828,上銀元大97購05  ,0,0,0,0,0,0,0,0,0,-46000,0,0,0,146000,192000,-46000,-46000
055582,亞德客元大97購01,0,0,0,0,0,0,0,0,0,-46000,0,0,0,189000,235000,-46000,-46000
055319,國巨國票98購03  ,0,0,0,0,0,0,0,0,0,-46000,0,0,0,10000,56000,-46000,-46000
048405,嘉晶群益93購03  ,0,0,0,0,0,0,0,0,0,-46000,0,0,0,20000,66000,-46000,-46000
047629,深中小元大96購01,0,0,0,0,0,0,0,0,0,-46000,0,0,0,210000,256000,-46000,-46000
052530,台郡元大96購04  ,0,0,0,0,0,0,0,0,0,-46000,0,0,0,14000,60000,-46000,-46000
053056,同欣電國票97購01,0,0,0,0,0,0,0,0,0,-46000,0,0,0,52000,98000,-46000,-46000
049899,台積電元富94購05,0,0,0,0,0,0,0,0,0,-46000,0,0,0,65000,111000,-46000,-46000
049018,光罩群益94購01  ,0,0,0,0,0,0,0,0,0,-46000,0,0,0,176000,222000,-46000,-46000
05377P,鴻海凱基95售18  ,0,0,0,0,0,0,0,0,0,-46000,0,0,0,4000,50000,-46000,-46000
052490,禾伸堂國票95購01,0,0,0,0,0,0,0,0,0,-46000,0,0,0,10000,56000,-46000,-46000
053197,超眾元富96購02  ,0,0,0,0,0,0,0,0,0,-46000,0,0,0,63000,109000,-46000,-46000
06614P,祥碩永豐98售03  ,0,0,0,0,0,0,0,0,0,-46000,0,0,0,16000,62000,-46000,-46000
1451,年興            ,9000,55000,-46000,0,0,0,0,0,0,0,0,0,0,0,0,0,-46000
06382P,大毅元富97售02  ,0,0,0,0,0,0,0,0,0,-46000,0,0,0,243000,289000,-46000,-46000
055485,國巨元大97購09  ,0,0,0,0,0,0,0,0,0,-47000,0,0,0,220000,267000,-47000,-47000
055955,微星元大97購01  ,0,0,0,0,0,0,0,0,0,-47000,0,0,0,59000,106000,-47000,-47000
05861P,瀚宇博永豐96售02,0,0,0,0,0,0,0,0,0,-47000,0,0,0,0,47000,-47000,-47000
056576,晶技元大99購02  ,0,0,0,0,0,0,0,0,0,-47000,0,0,0,171000,218000,-47000,-47000
056969,智易永豐98購01  ,0,0,0,0,0,0,0,0,0,-47000,0,0,0,11000,58000,-47000,-47000
049213,滬深2X國票94購02,0,0,0,0,0,0,0,0,0,-47000,0,0,0,0,47000,-47000,-47000
00737,國泰AI+Robo     ,0,100000,-100000,0,0,0,0,0,0,53000,0,0,0,153000,100000,53000,-47000
049062,華新科日盛94購01,0,0,0,0,0,0,0,0,0,-47000,0,0,0,40000,87000,-47000,-47000
052526,智伸科元大96購02,0,0,0,0,0,0,0,0,0,-47000,0,0,0,21000,68000,-47000,-47000
052391,瑞儀群益95購01  ,0,0,0,0,0,0,0,0,0,-47000,0,0,0,108000,155000,-47000,-47000
04933P,中石化中信96售01,0,0,0,0,0,0,0,0,0,-47000,0,0,0,0,47000,-47000,-47000
052099,臺股指富邦95購02,0,0,0,0,0,0,0,0,0,-47000,0,0,0,10000,57000,-47000,-47000
052700,奇鋐國票97購02  ,0,0,0,0,0,0,0,0,0,-47000,0,0,0,0,47000,-47000,-47000
053766,友達富邦97購01  ,0,0,0,0,0,0,0,0,0,-47000,0,0,0,310000,357000,-47000,-47000
053850,嘉澤元富96購03  ,0,0,0,0,0,0,0,0,0,-47000,0,0,0,23000,70000,-47000,-47000
054926,神達凱基98購01  ,0,0,0,0,0,0,0,0,0,-47000,0,0,0,12000,59000,-47000,-47000
055151,台積電元大98購05,0,0,0,0,0,0,0,0,0,-47000,0,0,0,21000,68000,-47000,-47000
2637,慧洋-KY         ,127000,195000,-68000,0,0,0,0,0,0,21000,21000,0,21000,0,0,0,-47000
2228,劍麟            ,13000,59000,-46000,0,0,0,0,0,0,-1000,0,0,0,0,1000,-1000,-47000
9914,美利達          ,230000,147000,83000,0,0,0,0,115000,-115000,-15000,8000,16000,-8000,0,7000,-7000,-47000
057104,康友中信99購01  ,0,0,0,0,0,0,0,0,0,-48000,0,0,0,56000,104000,-48000,-48000
05885P,牧德統一96售01  ,0,0,0,0,0,0,0,0,0,-48000,0,0,0,175000,223000,-48000,-48000
06120P,大立光凱基98售05,0,0,0,0,0,0,0,0,0,-48000,0,0,0,10000,58000,-48000,-48000
055964,正文元大97購02  ,0,0,0,0,0,0,0,0,0,-48000,0,0,0,2000,50000,-48000,-48000
056091,百和統一97購01  ,0,0,0,0,0,0,0,0,0,-48000,0,0,0,0,48000,-48000,-48000
056274,彩晶統一98購02  ,0,0,0,0,0,0,0,0,0,-48000,0,0,0,0,48000,-48000,-48000
055600,致伸元大97購02  ,0,0,0,0,0,0,0,0,0,-48000,0,0,0,0,48000,-48000,-48000
055570,華通統一98購03  ,0,0,0,0,0,0,0,0,0,-48000,0,0,0,0,48000,-48000,-48000
055830,上銀元大97購07  ,0,0,0,0,0,0,0,0,0,-48000,0,0,0,207000,255000,-48000,-48000
055890,鴻海統一99購01  ,0,0,0,0,0,0,0,0,0,-48000,0,0,0,0,48000,-48000,-48000
043236,台灣50兆豐93購02,0,0,0,0,0,0,0,0,0,-48000,0,0,0,7000,55000,-48000,-48000
048483,可成國泰95購01  ,0,0,0,0,0,0,0,0,0,-48000,0,0,0,550000,598000,-48000,-48000
051947,矽力統一95購01  ,0,0,0,0,0,0,0,0,0,-48000,0,0,0,0,48000,-48000,-48000
051131,玉山金台新95購01,0,0,0,0,0,0,0,0,0,-48000,0,0,0,0,48000,-48000,-48000
051111,可成統一95購02  ,0,0,0,0,0,0,0,0,0,-48000,0,0,0,0,48000,-48000,-48000
049005,可成中信95購01  ,0,0,0,0,0,0,0,0,0,-48000,0,0,0,0,48000,-48000,-48000
051005,緯創中信95購02  ,0,0,0,0,0,0,0,0,0,-48000,0,0,0,0,48000,-48000,-48000
050988,廣達富邦95購01  ,0,0,0,0,0,0,0,0,0,-48000,0,0,0,72000,120000,-48000,-48000
055184,群創統一98購02  ,0,0,0,0,0,0,0,0,0,-48000,0,0,0,0,48000,-48000,-48000
054932,台肥元大97購01  ,0,0,0,0,0,0,0,0,0,-48000,0,0,0,30000,78000,-48000,-48000
053842,聯發科統一96購08,0,0,0,0,0,0,0,0,0,-48000,0,0,0,0,48000,-48000,-48000
053878,台表科亞東96購01,0,0,0,0,0,0,0,0,0,-48000,0,0,0,0,48000,-48000,-48000
053731,矽創凱基96購03  ,0,0,0,0,0,0,0,0,0,-48000,0,0,0,12000,60000,-48000,-48000
053667,鴻海統一96購12  ,0,0,0,0,0,0,0,0,0,-48000,0,0,0,0,48000,-48000,-48000
053177,華邦電統一96購01,0,0,0,0,0,0,0,0,0,-48000,0,0,0,0,48000,-48000,-48000
2208,台船            ,42000,90000,-48000,0,0,0,0,0,0,0,0,0,0,0,0,0,-48000
06455P,上銀統一99售03  ,0,0,0,0,0,0,0,0,0,-48000,0,0,0,0,48000,-48000,-48000
05591P,義隆群益96售03  ,0,0,0,0,0,0,0,0,0,-49000,0,0,0,0,49000,-49000,-49000
055520,矽力中信97購02  ,0,0,0,0,0,0,0,0,0,-49000,0,0,0,168000,217000,-49000,-49000
056277,上銀富邦99購02  ,0,0,0,0,0,0,0,0,0,-49000,0,0,0,17000,66000,-49000,-49000
056021,興富發群益97購01,0,0,0,0,0,0,0,0,0,-49000,0,0,0,1000,50000,-49000,-49000
055989,矽力元富9A購01  ,0,0,0,0,0,0,0,0,0,-49000,0,0,0,30000,79000,-49000,-49000
057362,元油2X元大98購12,0,0,0,0,0,0,0,0,0,-49000,0,0,0,15000,64000,-49000,-49000
057330,台積電國票99購03,0,0,0,0,0,0,0,0,0,-49000,0,0,0,0,49000,-49000,-49000
046782,建準永豐93購01  ,0,0,0,0,0,0,0,0,0,-49000,0,0,0,0,49000,-49000,-49000
04554P,可成中信94售01  ,0,0,0,0,0,0,0,0,0,-49000,0,0,0,0,49000,-49000,-49000
049636,上証反凱基9A購01,0,0,0,0,0,0,0,0,0,-49000,0,0,0,0,49000,-49000,-49000
051395,聯詠兆豐95購01  ,0,0,0,0,0,0,0,0,0,-49000,0,0,0,17000,66000,-49000,-49000
052170,台積電元大95購20,0,0,0,0,0,0,0,0,0,-49000,0,0,0,222000,271000,-49000,-49000
05251P,喬山台新95售02  ,0,0,0,0,0,0,0,0,0,-49000,0,0,0,51000,100000,-49000,-49000
052560,康舒國票97購01  ,0,0,0,0,0,0,0,0,0,-49000,0,0,0,40000,89000,-49000,-49000
053017,世紀鋼統一96購02,0,0,0,0,0,0,0,0,0,-49000,0,0,0,134000,183000,-49000,-49000
053027,玉晶光富邦98購01,0,0,0,0,0,0,0,0,0,-49000,0,0,0,0,49000,-49000,-49000
051322,國泰金國票96購01,0,0,0,0,0,0,0,0,0,-49000,0,0,0,149000,198000,-49000,-49000
05005P,台表科統一95售01,0,0,0,0,0,0,0,0,0,-49000,0,0,0,30000,79000,-49000,-49000
052980,上銀元大96購03  ,0,0,0,0,0,0,0,0,0,-49000,0,0,0,66000,115000,-49000,-49000
05276P,GIS永豐95售02   ,0,0,0,0,0,0,0,0,0,-49000,0,0,0,1000,50000,-49000,-49000
053409,和碩兆豐96購02  ,0,0,0,0,0,0,0,0,0,-49000,0,0,0,34000,83000,-49000,-49000
053601,台表科元大98購01,0,0,0,0,0,0,0,0,0,-49000,0,0,0,52000,101000,-49000,-49000
054540,泰鼎國票99購01  ,20000,0,20000,0,0,0,0,0,0,-69000,0,0,0,43000,112000,-69000,-49000
054333,茂林永豐96購03  ,0,0,0,0,0,0,0,0,0,-49000,0,0,0,46000,95000,-49000,-49000
06239P,奇力新元大97售08,0,0,0,0,0,0,0,0,0,-49000,0,0,0,0,49000,-49000,-49000
1734,杏輝            ,28000,86000,-58000,0,0,0,0,0,0,9000,9000,0,9000,0,0,0,-49000
1736,喬山            ,150000,399000,-249000,0,0,0,0,0,0,200000,50000,5000,45000,158000,3000,155000,-49000
2485,兆赫            ,16000,67000,-51000,0,0,0,0,0,0,2000,2000,0,2000,0,0,0,-49000
9939,宏全            ,122000,147000,-25000,0,0,0,0,0,0,-24000,6000,22000,-16000,0,8000,-8000,-49000
1101B,台泥乙特        ,0,50790,-50790,0,0,0,0,0,0,1000,1000,0,1000,0,0,0,-49790
057386,聯發科永豐98購04,0,0,0,0,0,0,0,0,0,-50000,0,0,0,0,50000,-50000,-50000
057416,T50反1凱基9C購01,0,0,0,0,0,0,0,0,0,-50000,0,0,0,0,50000,-50000,-50000
06042P,華新科永豐96售04,0,0,0,0,0,0,0,0,0,-50000,0,0,0,0,50000,-50000,-50000
06108P,奇力新群益97售05,0,0,0,0,0,0,0,0,0,-50000,0,0,0,125000,175000,-50000,-50000
05833P,臺股指元富96售05,0,0,0,0,0,0,0,0,0,-50000,0,0,0,0,50000,-50000,-50000
05940P,聯發科凱基96售21,0,0,0,0,0,0,0,0,0,-50000,0,0,0,3000,53000,-50000,-50000
056590,樺漢統一9A購01  ,0,0,0,0,0,0,0,0,0,-50000,0,0,0,50000,100000,-50000,-50000
056687,元大金統一98購01,0,0,0,0,0,0,0,0,0,-50000,0,0,0,20000,70000,-50000,-50000
05668P,滬深2X永豐96售04,0,0,0,0,0,0,0,0,0,-50000,0,0,0,0,50000,-50000,-50000
056072,群創元大97購01  ,0,0,0,0,0,0,0,0,0,-50000,0,0,0,182000,232000,-50000,-50000
056448,全新凱基99購01  ,0,0,0,0,0,0,0,0,0,-50000,0,0,0,2000,52000,-50000,-50000
055343,國巨凱基97購03  ,0,0,0,0,0,0,0,0,0,-50000,0,0,0,14000,64000,-50000,-50000
055841,南亞科元大97購04,0,0,0,0,0,0,0,0,0,-50000,0,0,0,26000,76000,-50000,-50000
047826,台泥元大93購01  ,0,0,0,0,0,0,0,0,0,-50000,0,0,0,70000,120000,-50000,-50000
045115,玉晶光永豐94購01,0,0,0,0,0,0,0,0,0,-50000,0,0,0,0,50000,-50000,-50000
046486,樺漢國泰94購01  ,0,0,0,0,0,0,0,0,0,-50000,0,0,0,75000,125000,-50000,-50000
044602,大立光國泰93購01,0,0,0,0,0,0,0,0,0,-50000,0,0,0,63000,113000,-50000,-50000
04358P,TPK永豐94售01   ,0,0,0,0,0,0,0,0,0,-50000,0,0,0,0,50000,-50000,-50000
04558P,瑞昱日盛94售01  ,0,0,0,0,0,0,0,0,0,-50000,0,0,0,0,50000,-50000,-50000
045567,滬深2X富邦93購01,0,0,0,0,0,0,0,0,0,-50000,0,0,0,10000,60000,-50000,-50000
048219,為升凱基93購06  ,0,0,0,0,0,0,0,0,0,-50000,0,0,0,0,50000,-50000,-50000
048284,臺股指中信95購04,0,0,0,0,0,0,0,0,0,-50000,0,0,0,0,50000,-50000,-50000
048139,南電國票94購02  ,0,0,0,0,0,0,0,0,0,-50000,0,0,0,0,50000,-50000,-50000
04841P,群創元大94售04  ,0,0,0,0,0,0,0,0,0,-50000,0,0,0,0,50000,-50000,-50000
047483,新光金凱基99購04,0,0,0,0,0,0,0,0,0,-50000,0,0,0,0,50000,-50000,-50000
051896,柏文元富95購01  ,0,0,0,0,0,0,0,0,0,-50000,0,0,0,10000,60000,-50000,-50000
04880P,GIS永豐94售02   ,0,0,0,0,0,0,0,0,0,-50000,0,0,0,0,50000,-50000,-50000
048662,京元電統一93購04,0,0,0,0,0,0,0,0,0,-50000,0,0,0,0,50000,-50000,-50000
048656,大立光元富93購05,0,0,0,0,0,0,0,0,0,-50000,0,0,0,18000,68000,-50000,-50000
047304,元油2X元大96購02,0,0,0,0,0,0,0,0,0,-50000,0,0,0,50000,100000,-50000,-50000
050042,台表科亞東94購01,0,0,0,0,0,0,0,0,0,-50000,0,0,0,0,50000,-50000,-50000
049371,可成元大94購04  ,0,0,0,0,0,0,0,0,0,-50000,0,0,0,0,50000,-50000,-50000
051929,GIS中信96購01   ,0,0,0,0,0,0,0,0,0,-50000,0,0,0,0,50000,-50000,-50000
052091,緯創元大95購04  ,0,0,0,0,0,0,0,0,0,-50000,0,0,0,50000,100000,-50000,-50000
052084,台泥元大95購01  ,0,0,0,0,0,0,0,0,0,-50000,0,0,0,43000,93000,-50000,-50000
051304,緯創凱基96購01  ,0,0,0,0,0,0,0,0,0,-50000,0,0,0,10000,60000,-50000,-50000
051121,裕民群益97購01  ,0,0,0,0,0,0,0,0,0,-50000,0,0,0,0,50000,-50000,-50000
051670,欣興元大95購06  ,0,0,0,0,0,0,0,0,0,-50000,0,0,0,4000,54000,-50000,-50000
049491,聯發科元大95購01,0,0,0,0,0,0,0,0,0,-50000,0,0,0,22000,72000,-50000,-50000
052108,鴻海元富95購11  ,0,0,0,0,0,0,0,0,0,-50000,0,0,0,0,50000,-50000,-50000
04987P,昇陽半永豐94售04,0,0,0,0,0,0,0,0,0,-50000,0,0,0,0,50000,-50000,-50000
051018,可成凱基95購03  ,0,0,0,0,0,0,0,0,0,-50000,0,0,0,0,50000,-50000,-50000
052608,欣興元大97購01  ,0,0,0,0,0,0,0,0,0,-50000,0,0,0,101000,151000,-50000,-50000
052617,景碩國泰98購01  ,0,0,0,0,0,0,0,0,0,-50000,0,0,0,31000,81000,-50000,-50000
052399,台光電凱基95購03,0,0,0,0,0,0,0,0,0,-50000,0,0,0,27000,77000,-50000,-50000
051413,富邦金國票96購02,0,0,0,0,0,0,0,0,0,-50000,0,0,0,0,50000,-50000,-50000
049644,台積電凱基94購21,0,0,0,0,0,0,0,0,0,-50000,0,0,0,50000,100000,-50000,-50000
049609,全新兆豐95購01  ,0,0,0,0,0,0,0,0,0,-50000,0,0,0,0,50000,-50000,-50000
050918,南亞科日盛95購01,0,0,0,0,0,0,0,0,0,-50000,0,0,0,0,50000,-50000,-50000
049736,宏達電群益95購03,0,0,0,0,0,0,0,0,0,-50000,0,0,0,100000,150000,-50000,-50000
049731,A50正2群益94購02,0,0,0,0,0,0,0,0,0,-50000,0,0,0,0,50000,-50000,-50000
048893,南電元富94購01  ,0,0,0,0,0,0,0,0,0,-50000,0,0,0,0,50000,-50000,-50000
048844,訊芯凱基94購02  ,0,0,0,0,0,0,0,0,0,-50000,0,0,0,10000,60000,-50000,-50000
054253,宏達電元大97購03,0,0,0,0,0,0,0,0,0,-50000,0,0,0,2000,52000,-50000,-50000
054127,台積電元大96購21,0,0,0,0,0,0,0,0,0,-50000,0,0,0,0,50000,-50000,-50000
054113,奇力新台新97購01,0,0,0,0,0,0,0,0,0,-50000,0,0,0,0,50000,-50000,-50000
054156,聯電亞東98購01  ,0,0,0,0,0,0,0,0,0,-50000,0,0,0,0,50000,-50000,-50000
054537,南亞科亞東97購01,0,0,0,0,0,0,0,0,0,-50000,0,0,0,0,50000,-50000,-50000
054957,興富發元大97購01,0,0,0,0,0,0,0,0,0,-50000,0,0,0,1000,51000,-50000,-50000
054734,燿華凱基97購03  ,0,0,0,0,0,0,0,0,0,-50000,0,0,0,0,50000,-50000,-50000
054740,強茂凱基99購01  ,0,0,0,0,0,0,0,0,0,-50000,0,0,0,0,50000,-50000,-50000
054837,欣興第一97購01  ,0,0,0,0,0,0,0,0,0,-50000,0,0,0,0,50000,-50000,-50000
055270,上銀元大97購03  ,0,0,0,0,0,0,0,0,0,-50000,0,0,0,40000,90000,-50000,-50000
055265,玉晶光永豐98購03,0,0,0,0,0,0,0,0,0,-50000,0,0,0,10000,60000,-50000,-50000
053495,聯發科兆豐96購02,0,0,0,0,0,0,0,0,0,-50000,0,0,0,10000,60000,-50000,-50000
053470,華邦電元大96購02,0,0,0,0,0,0,0,0,0,-50000,0,0,0,1058000,1108000,-50000,-50000
053389,彩晶元大98購01  ,0,0,0,0,0,0,0,0,0,-50000,0,0,0,0,50000,-50000,-50000
053685,台積電元大96購18,0,0,0,0,0,0,0,0,0,-50000,0,0,0,124000,174000,-50000,-50000
053708,道瓊反凱基98購01,0,0,0,0,0,0,0,0,0,-50000,0,0,0,0,50000,-50000,-50000
053792,百和元大96購01  ,0,0,0,0,0,0,0,0,0,-50000,0,0,0,0,50000,-50000,-50000
053830,台積電台新96購02,0,0,0,0,0,0,0,0,0,-50000,0,0,0,0,50000,-50000,-50000
052753,電子類元大96購02,0,0,0,0,0,0,0,0,0,-50000,0,0,0,0,50000,-50000,-50000
052718,新唐凱基96購01  ,0,0,0,0,0,0,0,0,0,-50000,0,0,0,0,50000,-50000,-50000
052910,鴻海統一96購10  ,0,0,0,0,0,0,0,0,0,-50000,0,0,0,48000,98000,-50000,-50000
053124,聯發科凱基96購12,0,0,0,0,0,0,0,0,0,-50000,0,0,0,45000,95000,-50000,-50000
053147,楠梓電元大98購01,0,0,0,0,0,0,0,0,0,-50000,0,0,0,0,50000,-50000,-50000
053221,彩晶凱基98購01  ,0,0,0,0,0,0,0,0,0,-50000,0,0,0,0,50000,-50000,-50000
053275,燿華元大97購01  ,0,0,0,0,0,0,0,0,0,-50000,0,0,0,90000,140000,-50000,-50000
1201,味全            ,417000,610000,-193000,0,0,0,0,0,0,143000,0,0,0,143000,0,143000,-50000
06576P,台光電群益98售03,0,0,0,0,0,0,0,0,0,-50000,0,0,0,0,50000,-50000,-50000
055445,旺宏統一99購01  ,0,0,0,0,0,0,0,0,0,-51000,0,0,0,10000,61000,-51000,-51000
055472,大立光凱基97購07,0,0,0,0,0,0,0,0,0,-51000,0,0,0,0,51000,-51000,-51000
056215,華新科國票97購03,0,0,0,0,0,0,0,0,0,-51000,0,0,0,6000,57000,-51000,-51000
056618,京元電永豐98購01,0,0,0,0,0,0,0,0,0,-51000,0,0,0,37000,88000,-51000,-51000
057073,康控永豐98購01  ,0,0,0,0,0,0,0,0,0,-51000,0,0,0,110000,161000,-51000,-51000
056899,可成元大98購01  ,0,0,0,0,0,0,0,0,0,-51000,0,0,0,21000,72000,-51000,-51000
05887P,友達元富99售03  ,0,0,0,0,0,0,0,0,0,-51000,0,0,0,10000,61000,-51000,-51000
06060P,玉晶光元大97售03,0,0,0,0,0,0,0,0,0,-51000,0,0,0,112000,163000,-51000,-51000
047075,群創兆豐93購01  ,0,0,0,0,0,0,0,0,0,-51000,0,0,0,0,51000,-51000,-51000
051480,大立光凱基97購01,0,0,0,0,0,0,0,0,0,-51000,0,0,0,0,51000,-51000,-51000
04164P,滬深2X元富93售03,0,0,0,0,0,0,0,0,0,-51000,0,0,0,16000,67000,-51000,-51000
044221,群創凱基93購03  ,0,0,0,0,0,0,0,0,0,-51000,0,0,0,83000,134000,-51000,-51000
045055,聯發科元富98購03,0,0,0,0,0,0,0,0,0,-51000,0,0,0,50000,101000,-51000,-51000
050890,南電富邦99購01  ,0,0,0,0,0,0,0,0,0,-51000,0,0,0,0,51000,-51000,-51000
052621,台郡富邦97購01  ,10000,0,10000,0,0,0,0,0,0,-61000,0,0,0,5000,66000,-61000,-51000
050620,和碩元大94購04  ,0,0,0,0,0,0,0,0,0,-51000,0,0,0,0,51000,-51000,-51000
053291,旺宏中信9A購01  ,0,0,0,0,0,0,0,0,0,-51000,0,0,0,0,51000,-51000,-51000
052328,台表科中信99購01,0,0,0,0,0,0,0,0,0,-51000,0,0,0,49000,100000,-51000,-51000
053337,聯電國票97購01  ,0,0,0,0,0,0,0,0,0,-51000,0,0,0,18000,69000,-51000,-51000
053596,嘉澤元大96購01  ,0,0,0,0,0,0,0,0,0,-51000,0,0,0,2000,53000,-51000,-51000
05517P,臻鼎元大96售01  ,0,0,0,0,0,0,0,0,0,-51000,0,0,0,3000,54000,-51000,-51000
055248,可成統一97購02  ,0,0,0,0,0,0,0,0,0,-51000,0,0,0,59000,110000,-51000,-51000
054201,聯詠富邦97購02  ,0,0,0,0,0,0,0,0,0,-51000,0,0,0,20000,71000,-51000,-51000
9188,精熙-DR         ,0,51000,-51000,0,0,0,0,0,0,0,0,0,0,0,0,0,-51000
05946P,和碩中信96售01  ,0,0,0,0,0,0,0,0,0,-52000,0,0,0,8000,60000,-52000,-52000
057185,群創元大98購06  ,0,0,0,0,0,0,0,0,0,-52000,0,0,0,31000,83000,-52000,-52000
056077,矽力元大97購07  ,0,0,0,0,0,0,0,0,0,-52000,0,0,0,233000,285000,-52000,-52000
056019,燿華群益97購02  ,0,0,0,0,0,0,0,0,0,-52000,0,0,0,0,52000,-52000,-52000
055575,華新科統一98購01,0,0,0,0,0,0,0,0,0,-52000,0,0,0,96000,148000,-52000,-52000
055716,致茂元大97購01  ,0,0,0,0,0,0,0,0,0,-52000,0,0,0,5000,57000,-52000,-52000
04474P,聯發科元大94售03,0,0,0,0,0,0,0,0,0,-52000,0,0,0,60000,112000,-52000,-52000
04733P,康控兆豐95售01  ,0,0,0,0,0,0,0,0,0,-52000,0,0,0,20000,72000,-52000,-52000
047696,聯發科國票94購02,0,0,0,0,0,0,0,0,0,-52000,0,0,0,126000,178000,-52000,-52000
048291,台積電群益93購09,0,0,0,0,0,0,0,0,0,-52000,0,0,0,30000,82000,-52000,-52000
04931P,臻鼎元富94售09  ,0,0,0,0,0,0,0,0,0,-52000,0,0,0,10000,62000,-52000,-52000
050945,致茂群益95購01  ,0,0,0,0,0,0,0,0,0,-52000,0,0,0,0,52000,-52000,-52000
049692,可成元大94購07  ,0,0,0,0,0,0,0,0,0,-52000,0,0,0,101000,153000,-52000,-52000
050937,可成國票96購02  ,0,0,0,0,0,0,0,0,0,-52000,0,0,0,80000,132000,-52000,-52000
054295,世芯元大96購03  ,0,0,0,0,0,0,0,0,0,-52000,0,0,0,60000,112000,-52000,-52000
053493,智邦兆豐97購02  ,0,0,0,0,0,0,0,0,0,-52000,0,0,0,65000,117000,-52000,-52000
053440,台積電凱基96購12,0,0,0,0,0,0,0,0,0,-52000,0,0,0,0,52000,-52000,-52000
05312P,臺股指群益95售11,0,0,0,0,0,0,0,0,0,-52000,0,0,0,37000,89000,-52000,-52000
05571P,大立光統一96售03,0,0,0,0,0,0,0,0,0,-53000,0,0,0,0,53000,-53000,-53000
055739,健鼎元富97購01  ,0,0,0,0,0,0,0,0,0,-53000,0,0,0,0,53000,-53000,-53000
055650,華新科元富98購01,0,0,0,0,0,0,0,0,0,-53000,0,0,0,144000,197000,-53000,-53000
055619,同欣電國票98購02,0,0,0,0,0,0,0,0,0,-53000,0,0,0,181000,234000,-53000,-53000
056184,南亞科統一97購03,0,0,0,0,0,0,0,0,0,-53000,0,0,0,0,53000,-53000,-53000
056766,義隆元大98購01  ,0,0,0,0,0,0,0,0,0,-53000,0,0,0,25000,78000,-53000,-53000
052670,茂林群益96購02  ,0,0,0,0,0,0,0,0,0,-53000,0,0,0,285000,338000,-53000,-53000
050768,聯發科元大94購16,0,0,0,0,0,0,0,0,0,-53000,0,0,0,110000,163000,-53000,-53000
051230,聯詠群益95購01  ,0,0,0,0,0,0,0,0,0,-53000,0,0,0,42000,95000,-53000,-53000
050260,鴻海元大94購15  ,0,0,0,0,0,0,0,0,0,-53000,0,0,0,202000,255000,-53000,-53000
050521,聯發科元大94購15,0,0,0,0,0,0,0,0,0,-53000,0,0,0,148000,201000,-53000,-53000
053259,卜蜂群益97購01  ,0,0,0,0,0,0,0,0,0,-53000,0,0,0,0,53000,-53000,-53000
054640,健策中信9B購01  ,0,0,0,0,0,0,0,0,0,-53000,0,0,0,77000,130000,-53000,-53000
055157,晶豪科元大97購01,0,0,0,0,0,0,0,0,0,-53000,0,0,0,34000,87000,-53000,-53000
05487P,台表科凱基95售02,0,0,0,0,0,0,0,0,0,-53000,0,0,0,40000,93000,-53000,-53000
1104,環泥            ,12000,65000,-53000,0,0,0,0,0,0,0,0,0,0,0,0,0,-53000
056677,智伸科元富98購01,0,0,0,0,0,0,0,0,0,-54000,0,0,0,8000,62000,-54000,-54000
048320,聯詠凱基93購08  ,0,0,0,0,0,0,0,0,0,-54000,0,0,0,0,54000,-54000,-54000
048018,南亞科麥證93購01,0,0,0,30000,84000,-54000,0,0,0,-54000,0,0,0,30000,84000,-54000,-54000
05118P,超眾元大96售04  ,0,0,0,0,0,0,0,0,0,-54000,0,0,0,0,54000,-54000,-54000
049008,傳奇中信95購01  ,0,0,0,0,0,0,0,0,0,-54000,0,0,0,0,54000,-54000,-54000
054871,明泰群益98購01  ,0,0,0,0,0,0,0,0,0,-54000,0,0,0,44000,98000,-54000,-54000
05433P,智原元富95售02  ,0,0,0,0,0,0,0,0,0,-54000,0,0,0,0,54000,-54000,-54000
053247,麗豐國票97購01  ,0,0,0,0,0,0,0,0,0,-54000,0,0,0,20000,74000,-54000,-54000
052894,國巨群益96購03  ,0,0,0,0,0,0,0,0,0,-54000,0,0,0,2000,56000,-54000,-54000
05384P,大立光永豐95售02,0,0,0,0,0,0,0,0,0,-54000,0,0,0,5000,59000,-54000,-54000
06690P,玉晶光群益9A售05,0,0,0,0,0,0,0,0,0,-54000,0,0,0,0,54000,-54000,-54000
06249P,億光統一97售02  ,0,0,0,0,0,0,0,0,0,-54000,0,0,0,0,54000,-54000,-54000
2748,雲品            ,0,16000,-16000,0,0,0,0,38000,-38000,0,0,0,0,0,0,0,-54000
6504,南六            ,161000,232000,-71000,0,0,0,0,0,0,17000,27000,10000,17000,0,0,0,-54000
5519,隆大            ,1000,55000,-54000,0,0,0,0,0,0,0,0,0,0,0,0,0,-54000
8462,柏文            ,9000,63000,-54000,0,0,0,0,0,0,-548,0,0,0,0,548,-548,-54548
056907,群創元大9C購04  ,0,0,0,0,0,0,0,0,0,-55000,0,0,0,23000,78000,-55000,-55000
057142,力成兆豐98購01  ,0,0,0,0,0,0,0,0,0,-55000,0,0,0,20000,75000,-55000,-55000
056189,樺漢統一97購02  ,0,0,0,0,0,0,0,0,0,-55000,0,0,0,155000,210000,-55000,-55000
056464,臺股指凱基99購06,0,0,0,0,0,0,0,0,0,-55000,0,0,0,0,55000,-55000,-55000
055328,鈺齊國票98購01  ,0,0,0,0,0,0,0,0,0,-55000,0,0,0,24000,79000,-55000,-55000
055797,華通富邦98購01  ,0,0,0,0,0,0,0,0,0,-55000,0,0,0,0,55000,-55000,-55000
055805,矽力永豐97購01  ,0,0,0,0,0,0,0,0,0,-55000,0,0,0,0,55000,-55000,-55000
050342,華通元富94購02  ,0,0,0,0,0,0,0,0,0,-55000,0,0,0,4000,59000,-55000,-55000
050376,百和元大95購01  ,0,0,0,0,0,0,0,0,0,-55000,0,0,0,0,55000,-55000,-55000
04394P,臻鼎凱基94售01  ,0,0,0,0,0,0,0,0,0,-55000,0,0,0,0,55000,-55000,-55000
046385,群創凱基98購03  ,0,0,0,0,0,0,0,0,0,-55000,0,0,0,0,55000,-55000,-55000
048872,玉晶光國票94購02,0,0,0,0,0,0,0,0,0,-55000,0,0,0,153000,208000,-55000,-55000
050956,鈺齊群益95購01  ,0,0,0,0,0,0,0,0,0,-55000,0,0,0,10000,65000,-55000,-55000
049966,旺宏國票95購02  ,0,0,0,0,0,0,0,0,0,-55000,0,0,0,5000,60000,-55000,-55000
052421,元油反國票9B購01,0,0,0,0,0,0,0,0,0,-55000,0,0,0,0,55000,-55000,-55000
049836,矽創凱基94購02  ,0,0,0,0,0,0,0,0,0,-55000,0,0,0,13000,68000,-55000,-55000
051182,旺宏永豐95購01  ,0,0,0,0,0,0,0,0,0,-55000,0,0,0,78000,133000,-55000,-55000
050470,智邦台新94購01  ,0,0,0,0,0,0,0,0,0,-55000,0,0,0,171000,226000,-55000,-55000
053966,旺宏元大96購08  ,0,0,0,0,0,0,0,0,0,-55000,0,0,0,382000,437000,-55000,-55000
053463,可成富邦98購01  ,0,0,0,0,0,0,0,0,0,-55000,0,0,0,5000,60000,-55000,-55000
053183,大立光元富96購03,0,0,0,0,0,0,0,0,0,-55000,0,0,0,0,55000,-55000,-55000
054301,楠梓電凱基98購01,0,0,0,0,0,0,0,0,0,-55000,0,0,0,6000,61000,-55000,-55000
054614,玉晶光永豐97購03,0,0,0,0,0,0,0,0,0,-55000,0,0,0,37000,92000,-55000,-55000
054414,全新元大97購02  ,0,0,0,0,0,0,0,0,0,-55000,0,0,0,0,55000,-55000,-55000
054410,國巨元大96購14  ,0,0,0,0,0,0,0,0,0,-55000,0,0,0,131000,186000,-55000,-55000
4916,事欣科          ,1000,56000,-55000,0,0,0,0,0,0,0,0,0,0,0,0,0,-55000
06431P,新日興元大97售05,0,0,0,0,0,0,0,0,0,-55000,0,0,0,0,55000,-55000,-55000
06668P,祥碩凱基98售02  ,0,0,0,0,0,0,0,0,0,-55000,0,0,0,0,55000,-55000,-55000
055380,智易元大98購02  ,0,0,0,0,0,0,0,0,0,-56000,0,0,0,13000,69000,-56000,-56000
055577,晶技統一97購02  ,0,0,0,0,0,0,0,0,0,-56000,0,0,0,20000,76000,-56000,-56000
047839,景碩元大93購03  ,0,0,0,0,0,0,0,0,0,-56000,0,0,0,0,56000,-56000,-56000
03932P,欣興統一93售01  ,0,0,0,0,0,0,0,0,0,-56000,0,0,0,16000,72000,-56000,-56000
048689,台光電群益94購01,0,0,0,0,0,0,0,0,0,-56000,0,0,0,0,56000,-56000,-56000
046722,智邦元大93購02  ,0,0,0,0,0,0,0,0,0,-56000,0,0,0,36000,92000,-56000,-56000
051534,景碩國票97購01  ,0,0,0,0,0,0,0,0,0,-56000,0,0,0,0,56000,-56000,-56000
049286,美律兆豐94購01  ,0,0,0,0,0,0,0,0,0,-56000,0,0,0,10000,66000,-56000,-56000
050661,景碩元大94購02  ,0,0,0,0,0,0,0,0,0,-56000,0,0,0,77000,133000,-56000,-56000
050686,欣興兆豐96購01  ,0,0,0,0,0,0,0,0,0,-56000,0,0,0,4000,60000,-56000,-56000
054687,建準永豐97購02  ,0,0,0,0,0,0,0,0,0,-56000,0,0,0,0,56000,-56000,-56000
054049,亞光元大96購03  ,0,0,0,0,0,0,0,0,0,-56000,0,0,0,41000,97000,-56000,-56000
06465P,國巨統一98售04  ,0,0,0,0,0,0,0,0,0,-56000,0,0,0,0,56000,-56000,-56000
5531,鄉林            ,45000,101000,-56000,0,0,0,0,0,0,0,0,0,0,0,0,0,-56000
056419,欣興元富98購02  ,0,0,0,0,0,0,0,0,0,-57000,0,0,0,19000,76000,-57000,-57000
056275,國巨國泰98購04  ,0,0,0,0,0,0,0,0,0,-57000,0,0,0,258000,315000,-57000,-57000
056193,聯發科富邦99購08,0,0,0,0,0,0,0,0,0,-57000,0,0,0,40000,97000,-57000,-57000
056010,力成中信97購01  ,0,0,0,0,0,0,0,0,0,-57000,0,0,0,86000,143000,-57000,-57000
057349,聯發科統一98購04,0,0,0,0,0,0,0,0,0,-57000,0,0,0,0,57000,-57000,-57000
05767P,國巨凱基96售11  ,0,0,0,0,0,0,0,0,0,-57000,0,0,0,13000,70000,-57000,-57000
047004,台積電統一99購01,0,0,0,0,0,0,0,0,0,-57000,0,0,0,54000,111000,-57000,-57000
044963,台積電中信96購01,0,0,0,0,0,0,0,0,0,-57000,0,0,0,4000,61000,-57000,-57000
050779,超眾元大96購03  ,0,0,0,0,0,0,0,0,0,-57000,0,0,0,20000,77000,-57000,-57000
049593,群創元大9A購01  ,0,0,0,0,0,0,0,0,0,-57000,0,0,0,247000,304000,-57000,-57000
055169,光罩統一99購01  ,0,0,0,0,0,0,0,0,0,-57000,0,0,0,8000,65000,-57000,-57000
053904,漢唐凱基97購01  ,0,0,0,0,0,0,0,0,0,-57000,0,0,0,133000,190000,-57000,-57000
5285,界霖            ,11000,68000,-57000,0,0,0,0,0,0,0,0,0,0,0,0,0,-57000
9934,成霖            ,15000,72000,-57000,0,0,0,0,0,0,0,0,0,0,0,0,0,-57000
05909P,康友元富96售02  ,0,0,0,0,0,0,0,0,0,-58000,0,0,0,0,58000,-58000,-58000
057043,台積電元大99購02,0,0,0,0,0,0,0,0,0,-58000,0,0,0,13000,71000,-58000,-58000
056971,麗豐永豐98購01  ,0,0,0,0,0,0,0,0,0,-58000,0,0,0,105000,163000,-58000,-58000
057000,亞德客國票99購01,0,0,0,0,0,0,0,0,0,-58000,0,0,0,17000,75000,-58000,-58000
056202,國揚永豐97購01  ,0,0,0,0,0,0,0,0,0,-58000,0,0,0,0,58000,-58000,-58000
056264,聯發科統一98購02,0,0,0,0,0,0,0,0,0,-58000,0,0,0,0,58000,-58000,-58000
056380,麗豐元富98購01  ,0,0,0,0,0,0,0,0,0,-58000,0,0,0,0,58000,-58000,-58000
056493,晶技國泰99購01  ,0,0,0,0,0,0,0,0,0,-58000,0,0,0,334000,392000,-58000,-58000
055573,國巨統一97購06  ,0,0,0,0,0,0,0,0,0,-58000,0,0,0,20000,78000,-58000,-58000
044049,元金2X元大94購03,0,0,0,0,0,0,0,0,0,-58000,0,0,0,32000,90000,-58000,-58000
046293,聯發科統一94購01,0,0,0,0,0,0,0,0,0,-58000,0,0,0,0,58000,-58000,-58000
042953,鴻海台新01購01  ,0,0,0,0,0,0,0,0,0,-58000,0,0,0,0,58000,-58000,-58000
051487,健策凱基96購03  ,0,0,0,0,0,0,0,0,0,-58000,0,0,0,0,58000,-58000,-58000
051842,大成鋼富邦97購01,0,0,0,0,0,0,0,0,0,-58000,0,0,0,252000,310000,-58000,-58000
049689,正崴元大94購02  ,0,0,0,0,0,0,0,0,0,-58000,0,0,0,10000,68000,-58000,-58000
04990P,臻鼎元大94售04  ,0,0,0,0,0,0,0,0,0,-58000,0,0,0,10000,68000,-58000,-58000
05238P,禾伸堂永豐95售01,0,0,0,0,0,0,0,0,0,-58000,0,0,0,0,58000,-58000,-58000
051100,同欣電元大95購01,0,0,0,0,0,0,0,0,0,-58000,0,0,0,8000,66000,-58000,-58000
053153,大立光元大99購02,0,0,0,0,0,0,0,0,0,-58000,0,0,0,51000,109000,-58000,-58000
052931,麗豐元大97購01  ,0,0,0,0,0,0,0,0,0,-58000,0,0,0,0,58000,-58000,-58000
054700,致新永豐97購01  ,0,0,0,0,0,0,0,0,0,-58000,0,0,0,0,58000,-58000,-58000
054330,世芯永豐96購02  ,0,0,0,0,0,0,0,0,0,-58000,0,0,0,0,58000,-58000,-58000
054361,技嘉凱基96購01  ,0,0,0,0,0,0,0,0,0,-58000,0,0,0,367000,425000,-58000,-58000
6706,惠特            ,54000,110000,-56000,0,0,0,0,0,0,-2000,28000,30000,-2000,0,0,0,-58000
055714,智邦元大97購03  ,0,0,0,0,0,0,0,0,0,-59000,0,0,0,3000,62000,-59000,-59000
056154,宏達電凱基97購03,0,0,0,0,0,0,0,0,0,-59000,0,0,0,18000,77000,-59000,-59000
056960,光罩永豐98購01  ,0,0,0,0,0,0,0,0,0,-59000,0,0,0,128000,187000,-59000,-59000
057173,南亞科元大98購04,0,0,0,0,0,0,0,0,0,-59000,0,0,0,16000,75000,-59000,-59000
05759P,智邦永豐96售02  ,0,0,0,0,0,0,0,0,0,-59000,0,0,0,0,59000,-59000,-59000
04806P,臻鼎元富94售06  ,0,0,0,0,0,0,0,0,0,-59000,0,0,0,4000,63000,-59000,-59000
048514,嘉澤凱基93購06  ,0,0,0,0,0,0,0,0,0,-59000,0,0,0,8000,67000,-59000,-59000
03958P,嘉聯益統一93售01,0,0,0,0,0,0,0,0,0,-59000,0,0,0,1000,60000,-59000,-59000
04150P,燿華康和93售01  ,0,0,0,0,0,0,0,0,0,-59000,0,0,0,0,59000,-59000,-59000
052005,矽力國泰97購02  ,0,0,0,0,0,0,0,0,0,-59000,0,0,0,31000,90000,-59000,-59000
049586,正崴元大94購01  ,0,0,0,0,0,0,0,0,0,-59000,0,0,0,28000,87000,-59000,-59000
054008,大立光元富96購06,0,0,0,0,0,0,0,0,0,-59000,0,0,0,0,59000,-59000,-59000
052948,景碩國票97購02  ,0,0,0,0,0,0,0,0,0,-59000,0,0,0,14000,73000,-59000,-59000
4763,材料-KY         ,28000,87000,-59000,0,0,0,0,0,0,0,0,0,0,0,0,0,-59000
06452P,大立光元大98售08,0,0,0,0,0,0,0,0,0,-59000,0,0,0,15000,74000,-59000,-59000
1712,興農            ,116000,164000,-48000,0,0,0,0,0,0,-11000,2000,13000,-11000,0,0,0,-59000
05762P,昇陽半永豐96售04,0,0,0,0,0,0,0,0,0,-60000,0,0,0,0,60000,-60000,-60000
057283,欣興元大98購07  ,0,0,0,0,0,0,0,0,0,-60000,0,0,0,23000,83000,-60000,-60000
057279,國揚元大98購01  ,0,0,0,0,0,0,0,0,0,-60000,0,0,0,0,60000,-60000,-60000
06075P,智邦凱基97售02  ,0,0,0,0,0,0,0,0,0,-60000,0,0,0,0,60000,-60000,-60000
06127P,泰碩元富97售01  ,0,0,0,0,0,0,0,0,0,-60000,0,0,0,0,60000,-60000,-60000
05708P,奇力新國票97售04,0,0,0,0,0,0,0,0,0,-60000,0,0,0,0,60000,-60000,-60000
056753,群創兆豐98購02  ,0,0,0,0,0,0,0,0,0,-60000,0,0,0,0,60000,-60000,-60000
056123,鈺齊群益97購01  ,0,0,0,0,0,0,0,0,0,-60000,0,0,0,0,60000,-60000,-60000
056132,台光電元大97購03,0,0,0,0,0,0,0,0,0,-60000,0,0,0,0,60000,-60000,-60000
05640P,旺宏元富96售03  ,0,0,0,0,0,0,0,0,0,-60000,0,0,0,0,60000,-60000,-60000
055776,宏達電凱基98購02,0,0,0,0,0,0,0,0,0,-60000,0,0,0,18000,78000,-60000,-60000
055868,臺股指元大97購07,0,0,0,0,0,0,0,0,0,-60000,0,0,0,0,60000,-60000,-60000
041546,群創統一93購01  ,0,0,0,0,0,0,0,0,0,-60000,0,0,0,0,60000,-60000,-60000
03007X,元展07          ,0,0,0,0,0,0,0,0,0,-60000,0,0,0,0,60000,-60000,-60000
04341P,美律永豐93售03  ,0,0,0,0,0,0,0,0,0,-60000,0,0,0,0,60000,-60000,-60000
04432P,昇陽半元大94售04,0,0,0,0,0,0,0,0,0,-60000,0,0,0,0,60000,-60000,-60000
04457P,同欣電統一94售01,0,0,0,0,0,0,0,0,0,-60000,0,0,0,0,60000,-60000,-60000
045087,玉晶光元大95購01,0,0,0,0,0,0,0,0,0,-60000,0,0,0,27000,87000,-60000,-60000
045428,彩晶凱基94購01  ,0,0,0,0,0,0,0,0,0,-60000,0,0,0,0,60000,-60000,-60000
046344,超眾國票94購01  ,0,0,0,0,0,0,0,0,0,-60000,0,0,0,0,60000,-60000,-60000
047996,華邦電元大93購04,0,0,0,0,0,0,0,0,0,-60000,0,0,0,0,60000,-60000,-60000
047360,鴻海群益95購02  ,0,0,0,0,0,0,0,0,0,-60000,0,0,0,0,60000,-60000,-60000
04808P,訊芯永豐94售02  ,0,0,0,0,0,0,0,0,0,-60000,0,0,0,0,60000,-60000,-60000
048227,亞光凱基93購05  ,0,0,0,0,0,0,0,0,0,-60000,0,0,0,35000,95000,-60000,-60000
046792,京元電元富96購01,0,0,0,0,0,0,0,0,0,-60000,0,0,0,0,60000,-60000,-60000
046828,聯發科群益94購01,0,0,0,0,0,0,0,0,0,-60000,0,0,0,0,60000,-60000,-60000
049191,元油2X永豐95購01,0,0,0,0,0,0,0,0,0,-60000,0,0,0,0,60000,-60000,-60000
049635,臺股指群益94購08,0,0,0,0,0,0,0,0,0,-60000,0,0,0,0,60000,-60000,-60000
050940,嘉澤國票95購01  ,0,0,0,0,0,0,0,0,0,-60000,0,0,0,0,60000,-60000,-60000
050839,楠梓電國票96購01,0,0,0,0,0,0,0,0,0,-60000,0,0,0,0,60000,-60000,-60000
049579,鴻海元大94購06  ,0,0,0,0,0,0,0,0,0,-60000,0,0,0,0,60000,-60000,-60000
052664,麗豐國票96購02  ,0,0,0,0,0,0,0,0,0,-60000,0,0,0,20000,80000,-60000,-60000
052569,聯發科凱基96購08,0,0,0,0,0,0,0,0,0,-60000,0,0,0,50000,110000,-60000,-60000
049111,元油2X統一94購03,0,0,0,0,0,0,0,0,0,-60000,0,0,0,0,60000,-60000,-60000
049292,鴻海群益94購04  ,0,0,0,0,0,0,0,0,0,-60000,0,0,0,0,60000,-60000,-60000
049312,亞光凱基94購02  ,0,0,0,0,0,0,0,0,0,-60000,0,0,0,41000,101000,-60000,-60000
050429,漢唐凱基94購04  ,0,0,0,0,0,0,0,0,0,-60000,0,0,0,0,60000,-60000,-60000
049414,台積電凱基94購18,0,0,0,0,0,0,0,0,0,-60000,0,0,0,0,60000,-60000,-60000
050484,世紀鋼國票95購02,0,0,0,0,0,0,0,0,0,-60000,0,0,0,0,60000,-60000,-60000
051093,聯詠元大95購01  ,0,0,0,0,0,0,0,0,0,-60000,0,0,0,0,60000,-60000,-60000
051735,台積電國票96購06,0,0,0,0,0,0,0,0,0,-60000,0,0,0,0,60000,-60000,-60000
049495,欣興元大94購06  ,0,0,0,0,0,0,0,0,0,-60000,0,0,0,1000,61000,-60000,-60000
053220,瀚宇博凱基98購01,0,0,0,0,0,0,0,0,0,-60000,0,0,0,0,60000,-60000,-60000
053287,臺股指元大96購15,0,0,0,0,0,0,0,0,0,-60000,0,0,0,0,60000,-60000,-60000
05294P,亞光凱基95售02  ,0,0,0,0,0,0,0,0,0,-60000,0,0,0,0,60000,-60000,-60000
05390P,康友群益95售04  ,0,0,0,0,0,0,0,0,0,-60000,0,0,0,0,60000,-60000,-60000
054258,牧德元大97購01  ,0,0,0,0,0,0,0,0,0,-60000,0,0,0,35000,95000,-60000,-60000
054542,台表科國票98購01,0,0,0,0,0,0,0,0,0,-60000,0,0,0,0,60000,-60000,-60000
05493P,華新科富邦99售02,0,0,0,0,0,0,0,0,0,-60000,0,0,0,20000,80000,-60000,-60000
054947,興勤元大97購01  ,0,0,0,0,0,0,0,0,0,-60000,0,0,0,3000,63000,-60000,-60000
05505P,聯發科凱基96售09,0,0,0,0,0,0,0,0,0,-60000,0,0,0,0,60000,-60000,-60000
055050,敬鵬永豐97購01  ,0,0,0,0,0,0,0,0,0,-60000,0,0,0,0,60000,-60000,-60000
06607P,友達台新98售02  ,0,0,0,0,0,0,0,0,0,-60000,0,0,0,11000,71000,-60000,-60000
06564P,國巨富邦9A售04  ,0,0,0,0,0,0,0,0,0,-60000,0,0,0,0,60000,-60000,-60000
06187P,國巨統一97售05  ,0,0,0,0,0,0,0,0,0,-60000,0,0,0,0,60000,-60000,-60000
056678,力成元富98購01  ,0,0,0,0,0,0,0,0,0,-61000,0,0,0,124000,185000,-61000,-61000
057088,上銀元富98購01  ,0,0,0,0,0,0,0,0,0,-61000,0,0,0,10000,71000,-61000,-61000
057291,國巨國泰9A購01  ,0,0,0,0,0,0,0,0,0,-61000,0,0,0,69000,130000,-61000,-61000
057317,技嘉凱基98購02  ,0,0,0,0,0,0,0,0,0,-61000,0,0,0,22000,83000,-61000,-61000
05182P,嘉晶統一95售03  ,0,0,0,0,0,0,0,0,0,-61000,0,0,0,1000,62000,-61000,-61000
053004,燿華永豐96購01  ,0,0,0,0,0,0,0,0,0,-61000,0,0,0,0,61000,-61000,-61000
052640,台表科凱基97購01,0,0,0,0,0,0,0,0,0,-61000,0,0,0,36000,97000,-61000,-61000
049661,喬山永豐94購01  ,0,0,0,0,0,0,0,0,0,-61000,0,0,0,0,61000,-61000,-61000
054845,智邦兆豐98購01  ,0,0,0,0,0,0,0,0,0,-61000,0,0,0,98000,159000,-61000,-61000
06550P,健策元大99售01  ,0,0,0,0,0,0,0,0,0,-61000,0,0,0,15000,76000,-61000,-61000
2702,華園            ,4000,65000,-61000,0,0,0,0,0,0,0,0,0,0,0,0,0,-61000
06048P,大立光富邦96售05,0,0,0,0,0,0,0,0,0,-62000,0,0,0,5000,67000,-62000,-62000
05555P,健策群益98售01  ,0,0,0,0,0,0,0,0,0,-62000,0,0,0,0,62000,-62000,-62000
049721,晶技凱基94購02  ,0,0,0,0,0,0,0,0,0,-62000,0,0,0,14000,76000,-62000,-62000
049055,聯詠永豐94購01  ,0,0,0,0,0,0,0,0,0,-62000,0,0,0,79000,141000,-62000,-62000
05257P,欣興凱基95售04  ,0,0,0,0,0,0,0,0,0,-62000,0,0,0,59000,121000,-62000,-62000
050101,台積電永昌96購03,0,0,0,0,0,0,0,0,0,-62000,0,0,0,127000,189000,-62000,-62000
054032,上銀中信96購01  ,0,0,0,0,0,0,0,0,0,-62000,0,0,0,27000,89000,-62000,-62000
053111,緯創兆豐97購01  ,0,0,0,0,0,0,0,0,0,-62000,0,0,0,0,62000,-62000,-62000
053227,晶技台新96購01  ,0,0,0,0,0,0,0,0,0,-62000,0,0,0,232000,294000,-62000,-62000
8021,尖點            ,134000,197000,-63000,0,0,0,0,0,0,1000,1000,0,1000,0,0,0,-62000
06479P,聯發科中信99售02,0,0,0,0,0,0,0,0,0,-62000,0,0,0,63000,125000,-62000,-62000
056768,宏達電元大99購03,0,0,0,0,0,0,0,0,0,-63000,0,0,0,3000,66000,-63000,-63000
050166,彩晶國泰95購01  ,0,0,0,0,0,0,0,0,0,-63000,0,0,0,100000,163000,-63000,-63000
050752,美律統一94購05  ,0,0,0,0,0,0,0,0,0,-63000,0,0,0,80000,143000,-63000,-63000
056966,嘉晶永豐98購01  ,0,0,0,0,0,0,0,0,0,-64000,0,0,0,194000,258000,-64000,-64000
057481,技嘉元大98購04  ,0,0,0,0,0,0,0,0,0,-64000,0,0,0,2000,66000,-64000,-64000
048781,臺股指凱基96購01,0,0,0,0,0,0,0,0,0,-64000,0,0,0,0,64000,-64000,-64000
00762,元大全球AI      ,0,0,0,0,0,0,0,0,0,-64000,0,0,0,74000,138000,-64000,-64000
051192,緯創兆豐96購01  ,0,0,0,0,0,0,0,0,0,-64000,0,0,0,0,64000,-64000,-64000
053052,旺宏國票97購02  ,0,0,0,0,0,0,0,0,0,-64000,0,0,0,50000,114000,-64000,-64000
051039,台表科康和95購01,0,0,0,0,0,0,0,0,0,-64000,0,0,0,373000,437000,-64000,-64000
053968,華邦電元大97購01,0,0,0,0,0,0,0,0,0,-64000,0,0,0,14000,78000,-64000,-64000
053561,玉晶光國泰98購01,0,0,0,0,0,0,0,0,0,-64000,0,0,0,312000,376000,-64000,-64000
054406,旺宏國票98購01  ,0,0,0,0,0,0,0,0,0,-64000,0,0,0,0,64000,-64000,-64000
054843,中環兆豐97購01  ,0,0,0,0,0,0,0,0,0,-64000,0,0,0,0,64000,-64000,-64000
06505P,康控國票99售02  ,0,0,0,0,0,0,0,0,0,-64000,0,0,0,42000,106000,-64000,-64000
055930,可成群益98購01  ,0,0,0,0,0,0,0,0,0,-65000,0,0,0,181000,246000,-65000,-65000
047191,同欣電元大93購02,0,0,0,0,0,0,0,0,0,-65000,0,0,0,3000,68000,-65000,-65000
048422,瑞昱元富96購02  ,0,0,0,0,0,0,0,0,0,-65000,0,0,0,120000,185000,-65000,-65000
051058,景碩群益96購01  ,0,0,0,0,0,0,0,0,0,-65000,0,0,0,101000,166000,-65000,-65000
052532,台積電國泰96購07,0,0,0,0,0,0,0,0,0,-65000,0,0,0,0,65000,-65000,-65000
051124,創意群益95購01  ,0,0,0,0,0,0,0,0,0,-65000,0,0,0,15000,80000,-65000,-65000
050192,康控元大97購01  ,0,0,0,0,0,0,0,0,0,-65000,0,0,0,286000,351000,-65000,-65000
054893,帆宣統一99購01  ,0,0,0,0,0,0,0,0,0,-65000,0,0,0,10000,75000,-65000,-65000
054005,旺宏統一97購04  ,0,0,0,0,0,0,0,0,0,-65000,0,0,0,10000,75000,-65000,-65000
053896,麗豐群益97購01  ,0,0,0,0,0,0,0,0,0,-65000,0,0,0,22000,87000,-65000,-65000
053841,美律統一96購01  ,0,0,0,0,0,0,0,0,0,-65000,0,0,0,221000,286000,-65000,-65000
3437,榮創            ,24000,89000,-65000,0,0,0,0,0,0,0,0,0,0,0,0,0,-65000
055905,可成兆豐97購03  ,0,0,0,0,0,0,0,0,0,-66000,0,0,0,138000,204000,-66000,-66000
055782,新日興凱基99購01,0,0,0,0,0,0,0,0,0,-66000,0,0,0,108000,174000,-66000,-66000
056453,禾伸堂凱基99購02,0,0,0,0,0,0,0,0,0,-66000,0,0,0,125000,191000,-66000,-66000
052206,燿華中信95購02  ,0,0,0,0,0,0,0,0,0,-66000,0,0,0,5000,71000,-66000,-66000
046383,群創凱基98購01  ,0,0,0,0,0,0,0,0,0,-66000,0,0,0,6000,72000,-66000,-66000
050504,全新凱基94購03  ,0,0,0,0,0,0,0,0,0,-66000,0,0,0,116000,182000,-66000,-66000
049911,智邦元大94購05  ,0,0,0,0,0,0,0,0,0,-66000,0,0,0,3000,69000,-66000,-66000
049697,群創元大98購01  ,0,0,0,0,0,0,0,0,0,-66000,0,0,0,247000,313000,-66000,-66000
053581,台積電元大96購14,0,0,0,0,0,0,0,0,0,-66000,0,0,0,129000,195000,-66000,-66000
055045,台肥永豐97購01  ,0,0,0,0,0,0,0,0,0,-66000,0,0,0,1000,67000,-66000,-66000
055085,大毅國票97購01  ,0,0,0,0,0,0,0,0,0,-66000,0,0,0,78000,144000,-66000,-66000
055132,台虹康和97購01  ,0,0,0,0,0,0,0,0,0,-66000,0,0,0,40000,106000,-66000,-66000
6257,矽格            ,282000,142000,140000,0,0,0,0,317,-317,-206000,30000,0,30000,5000,241000,-236000,-66317
056964,聯發科永豐98購03,0,0,0,0,0,0,0,0,0,-67000,0,0,0,2000,69000,-67000,-67000
056744,麗豐凱基9A購01  ,0,0,0,0,0,0,0,0,0,-67000,0,0,0,2000,69000,-67000,-67000
056625,致伸永豐98購01  ,0,0,0,0,0,0,0,0,0,-67000,0,0,0,0,67000,-67000,-67000
06088P,建準永豐97售01  ,0,0,0,0,0,0,0,0,0,-67000,0,0,0,1000,68000,-67000,-67000
056245,嘉澤群益97購01  ,0,0,0,0,0,0,0,0,0,-67000,0,0,0,39000,106000,-67000,-67000
05631P,國巨富邦9A售01  ,0,0,0,0,0,0,0,0,0,-67000,0,0,0,3000,70000,-67000,-67000
045293,鴻海元大94購01  ,0,0,0,0,0,0,0,0,0,-67000,0,0,0,41000,108000,-67000,-67000
04227P,滬深2X永豐94售04,0,0,0,0,0,0,0,0,0,-67000,0,0,0,0,67000,-67000,-67000
052622,貿聯兆豐97購01  ,0,0,0,0,0,0,0,0,0,-67000,0,0,0,100000,167000,-67000,-67000
051962,晶相光永豐95購02,0,0,0,0,0,0,0,0,0,-67000,0,0,0,47000,114000,-67000,-67000
053549,南亞科凱基96購02,0,0,0,0,0,0,0,0,0,-67000,0,0,0,8000,75000,-67000,-67000
053160,台表科元大96購03,0,0,0,0,0,0,0,0,0,-67000,0,0,0,0,67000,-67000,-67000
052989,麗豐元大98購01  ,0,0,0,0,0,0,0,0,0,-67000,0,0,0,1000,68000,-67000,-67000
056393,精元永豐98購01  ,0,0,0,0,0,0,0,0,0,-68000,0,0,0,0,68000,-68000,-68000
056436,台積電凱基98購10,0,0,0,0,0,0,0,0,0,-68000,0,0,0,0,68000,-68000,-68000
056223,華邦電凱基97購04,0,0,0,0,0,0,0,0,0,-68000,0,0,0,3000,71000,-68000,-68000
056058,建準元大97購02  ,0,0,0,0,0,0,0,0,0,-68000,0,0,0,3000,71000,-68000,-68000
06125P,楠梓電元富99售01,0,0,0,0,0,0,0,0,0,-68000,0,0,0,0,68000,-68000,-68000
057180,華新科元大99購08,0,0,0,0,0,0,0,0,0,-68000,0,0,0,17000,85000,-68000,-68000
056619,強茂永豐98購01  ,0,0,0,0,0,0,0,0,0,-68000,0,0,0,0,68000,-68000,-68000
056650,彩晶凱基9A購01  ,0,0,0,0,0,0,0,0,0,-68000,0,0,0,0,68000,-68000,-68000
056972,祥碩永豐98購02  ,0,0,0,0,0,0,0,0,0,-68000,0,0,0,13000,81000,-68000,-68000
047224,台光電凱基94購01,0,0,0,0,0,0,0,0,0,-68000,0,0,0,0,68000,-68000,-68000
048602,上緯控國票96購01,0,0,0,0,0,0,0,0,0,-68000,0,0,0,0,68000,-68000,-68000
051890,智邦元富95購03  ,0,0,0,0,0,0,0,0,0,-68000,0,0,0,110000,178000,-68000,-68000
052015,漢唐永豐95購02  ,0,0,0,0,0,0,0,0,0,-68000,0,0,0,0,68000,-68000,-68000
050422,鴻海凱基96購01  ,0,0,0,0,0,0,0,0,0,-68000,0,0,0,0,68000,-68000,-68000
051518,富邦金凱基95購01,0,0,0,0,0,0,0,0,0,-68000,0,0,0,0,68000,-68000,-68000
050505,可成凱基94購12  ,0,0,0,0,0,0,0,0,0,-68000,0,0,0,0,68000,-68000,-68000
051593,和碩元大95購01  ,0,0,0,0,0,0,0,0,0,-68000,0,0,0,0,68000,-68000,-68000
050181,富邦金元大94購02,0,0,0,0,0,0,0,0,0,-68000,0,0,0,0,68000,-68000,-68000
050276,百和元大94購03  ,0,0,0,0,0,0,0,0,0,-68000,0,0,0,0,68000,-68000,-68000
051761,富邦金元大96購01,0,0,0,0,0,0,0,0,0,-68000,0,0,0,0,68000,-68000,-68000
051145,台積電凱基95購05,0,0,0,0,0,0,0,0,0,-68000,0,0,0,0,68000,-68000,-68000
052634,華邦電凱基96購01,0,0,0,0,0,0,0,0,0,-68000,0,0,0,0,68000,-68000,-68000
052372,台泥元大95購02  ,0,0,0,0,0,0,0,0,0,-68000,0,0,0,0,68000,-68000,-68000
052358,台表科永豐95購02,0,0,0,0,0,0,0,0,0,-68000,0,0,0,0,68000,-68000,-68000
049819,百和元大94購02  ,0,0,0,0,0,0,0,0,0,-68000,0,0,0,0,68000,-68000,-68000
050999,瀚宇博元大95購04,0,0,0,0,0,0,0,0,0,-68000,0,0,0,0,68000,-68000,-68000
053648,台積電凱基97購04,0,0,0,0,0,0,0,0,0,-68000,0,0,0,0,68000,-68000,-68000
053546,台積電凱基96購13,0,0,0,0,0,0,0,0,0,-68000,0,0,0,0,68000,-68000,-68000
053445,可成凱基96購04  ,0,0,0,0,0,0,0,0,0,-68000,0,0,0,13000,81000,-68000,-68000
053363,旺宏國泰98購02  ,0,0,0,0,0,0,0,0,0,-68000,0,0,0,29000,97000,-68000,-68000
055064,碩天永豐97購01  ,0,0,0,0,0,0,0,0,0,-68000,0,0,0,0,68000,-68000,-68000
055083,康友中信97購01  ,0,0,0,0,0,0,0,0,0,-68000,0,0,0,0,68000,-68000,-68000
054966,貿聯元大98購02  ,0,0,0,0,0,0,0,0,0,-68000,0,0,0,12000,80000,-68000,-68000
054393,漢唐永豐96購01  ,0,0,0,0,0,0,0,0,0,-68000,0,0,0,0,68000,-68000,-68000
054549,台積電凱基98購01,0,0,0,0,0,0,0,0,0,-68000,0,0,0,0,68000,-68000,-68000
054243,國喬元大96購01  ,0,0,0,0,0,0,0,0,0,-68000,0,0,0,0,68000,-68000,-68000
9921,巨大            ,145000,213000,-68000,0,0,0,0,0,0,0,0,0,0,0,0,0,-68000
057408,台郡群益98購01  ,0,0,0,0,0,0,0,0,0,-69000,0,0,0,8000,77000,-69000,-69000
05880P,創意康和96售01  ,0,0,0,0,0,0,0,0,0,-69000,0,0,0,0,69000,-69000,-69000
048121,亞德客元大93購05,0,0,0,0,0,0,0,0,0,-69000,0,0,0,37000,106000,-69000,-69000
051353,聯發科元大95購08,0,0,0,0,0,0,0,0,0,-69000,0,0,0,0,69000,-69000,-69000
049903,大立光元富94購06,0,0,0,0,0,0,0,0,0,-69000,0,0,0,53000,122000,-69000,-69000
049294,南亞科群益94購01,0,0,0,0,0,0,0,0,0,-69000,0,0,0,173000,242000,-69000,-69000
9955,佳龍            ,4000,73000,-69000,0,0,0,0,0,0,0,5000,5000,0,0,0,0,-69000
057305,南亞科兆豐98購02,0,0,0,0,0,0,0,0,0,-70000,0,0,0,0,70000,-70000,-70000
057350,全新統一98購03  ,0,0,0,0,0,0,0,0,0,-70000,0,0,0,0,70000,-70000,-70000
056920,友達兆豐98購02  ,0,0,0,0,0,0,0,0,0,-70000,0,0,0,50000,120000,-70000,-70000
055969,彩晶元大99購02  ,0,0,0,0,0,0,0,0,0,-70000,0,0,0,0,70000,-70000,-70000
055355,大立光凱基97購05,0,0,0,0,0,0,0,0,0,-70000,0,0,0,1000,71000,-70000,-70000
055370,旺宏元大97購05  ,0,0,0,0,0,0,0,0,0,-70000,0,0,0,0,70000,-70000,-70000
048287,嘉晶兆豐94購01  ,0,0,0,0,0,0,0,0,0,-70000,0,0,0,331000,401000,-70000,-70000
048452,緯創凱基93購04  ,0,0,0,0,0,0,0,0,0,-70000,0,0,0,0,70000,-70000,-70000
03497P,金像電凱基02售06,0,0,0,0,0,0,0,0,0,-70000,0,0,0,0,70000,-70000,-70000
045161,玉晶光國泰94購03,0,0,0,0,0,0,0,0,0,-70000,0,0,0,2000,72000,-70000,-70000
044819,新日興兆豐93購02,0,0,0,0,0,0,0,0,0,-70000,0,0,0,0,70000,-70000,-70000
044255,群創元大93購01  ,0,0,0,0,0,0,0,0,0,-70000,0,0,0,20000,90000,-70000,-70000
052052,嘉澤凱基95購02  ,0,0,0,0,0,0,0,0,0,-70000,0,0,0,10000,80000,-70000,-70000
049890,嘉澤國泰95購01  ,0,0,0,0,0,0,0,0,0,-70000,0,0,0,0,70000,-70000,-70000
052531,台積電國泰96購06,0,0,0,0,0,0,0,0,0,-70000,0,0,0,0,70000,-70000,-70000
05263P,台積電元大96售09,0,0,0,0,0,0,0,0,0,-70000,0,0,0,0,70000,-70000,-70000
052588,玉晶光永豐98購01,0,0,0,0,0,0,0,0,0,-70000,0,0,0,0,70000,-70000,-70000
049776,全新統一95購02  ,0,0,0,0,0,0,0,0,0,-70000,0,0,0,0,70000,-70000,-70000
054548,鴻海凱基98購03  ,0,0,0,0,0,0,0,0,0,-70000,0,0,0,0,70000,-70000,-70000
054567,拓凱群益98購01  ,0,0,0,0,0,0,0,0,0,-70000,0,0,0,0,70000,-70000,-70000
054557,臻鼎凱基98購01  ,0,0,0,0,0,0,0,0,0,-70000,0,0,0,43000,113000,-70000,-70000
054374,信邦中信96購01  ,0,0,0,0,0,0,0,0,0,-70000,0,0,0,0,70000,-70000,-70000
055074,台虹永豐97購01  ,0,0,0,0,0,0,0,0,0,-70000,0,0,0,0,70000,-70000,-70000
053399,創意中信96購01  ,0,0,0,0,0,0,0,0,0,-70000,0,0,0,0,70000,-70000,-70000
053753,啟碁永豐96購01  ,0,0,0,0,0,0,0,0,0,-70000,0,0,0,0,70000,-70000,-70000
052317,台積電元大96購11,0,0,0,0,0,0,0,0,0,-70000,0,0,0,10000,80000,-70000,-70000
053294,聯發科中信9C購01,0,0,0,0,0,0,0,0,0,-70000,0,0,0,30000,100000,-70000,-70000
052797,樺漢兆豐96購01  ,0,0,0,0,0,0,0,0,0,-70000,0,0,0,0,70000,-70000,-70000
05219P,鴻海元大95售17  ,0,0,0,0,0,0,0,0,0,-70000,0,0,0,68000,138000,-70000,-70000
2314,台揚            ,51000,121000,-70000,0,0,0,0,0,0,0,0,0,0,0,0,0,-70000
06566P,華通永豐98售03  ,0,0,0,0,0,0,0,0,0,-70000,0,0,0,0,70000,-70000,-70000
06463P,大立光富邦9A售01,0,0,0,0,0,0,0,0,0,-70000,0,0,0,5000,75000,-70000,-70000
2104,國際中橡        ,1241000,1329000,-88000,0,0,0,0,0,0,18000,17000,0,17000,1000,0,1000,-70000
1319,東陽            ,175722,247000,-71278,0,0,0,0,0,0,1000,1000,0,1000,0,0,0,-70278
055527,旺宏群益99購03  ,0,0,0,0,0,0,0,0,0,-71000,0,0,0,0,71000,-71000,-71000
057105,致茂群益9A購01  ,0,0,0,0,0,0,0,0,0,-71000,0,0,0,22000,93000,-71000,-71000
056602,嘉澤國泰99購01  ,0,0,0,0,0,0,0,0,0,-71000,0,0,0,16000,87000,-71000,-71000
057314,全新麥證98購01  ,0,0,0,0,71000,-71000,0,0,0,-71000,0,0,0,0,71000,-71000,-71000
04833P,鴻海元大94售16  ,0,0,0,0,0,0,0,0,0,-71000,0,0,0,0,71000,-71000,-71000
046960,台新金中信95購01,0,0,0,0,0,0,0,0,0,-71000,0,0,0,0,71000,-71000,-71000
05000P,臺股指永豐95售01,0,0,0,0,0,0,0,0,0,-71000,0,0,0,267000,338000,-71000,-71000
05237P,為升永豐95售01  ,0,0,0,0,0,0,0,0,0,-71000,0,0,0,0,71000,-71000,-71000
052030,GIS群益95購04   ,0,0,0,0,0,0,0,0,0,-71000,0,0,0,87000,158000,-71000,-71000
051967,康友永豐95購02  ,0,0,0,0,0,0,0,0,0,-71000,0,0,0,0,71000,-71000,-71000
052970,美律群益96購01  ,0,0,0,0,0,0,0,0,0,-71000,0,0,0,44000,115000,-71000,-71000
053756,亞光元富96購02  ,0,0,0,0,0,0,0,0,0,-71000,0,0,0,0,71000,-71000,-71000
053914,國巨國票96購08  ,0,0,0,0,0,0,0,0,0,-71000,0,0,0,46000,117000,-71000,-71000
053377,台積電元大98購01,0,0,0,0,0,0,0,0,0,-71000,0,0,0,143000,214000,-71000,-71000
053640,上緯控永豐96購01,0,0,0,0,0,0,0,0,0,-71000,0,0,0,5000,76000,-71000,-71000
054870,新日興群益98購01,0,0,0,0,0,0,0,0,0,-71000,0,0,0,63000,134000,-71000,-71000
054625,旺宏凱基98購03  ,0,0,0,0,0,0,0,0,0,-71000,0,0,0,5000,76000,-71000,-71000
06613P,華新科富邦9A售03,0,0,0,0,0,0,0,0,0,-71000,0,0,0,0,71000,-71000,-71000
06521P,矽力元大98售01  ,0,0,0,0,0,0,0,0,0,-71000,0,0,0,23000,94000,-71000,-71000
1527,鑽全            ,18000,89764,-71764,0,0,0,0,0,0,0,0,0,0,0,0,0,-71764
057461,國巨永豐98購07  ,0,0,0,0,0,0,0,0,0,-72000,0,0,0,0,72000,-72000,-72000
06007P,世芯永豐96售01  ,0,0,0,0,0,0,0,0,0,-72000,0,0,0,276000,348000,-72000,-72000
06087P,國巨永豐97售01  ,0,0,0,0,0,0,0,0,0,-72000,0,0,0,0,72000,-72000,-72000
04801P,矽力元大94售02  ,0,0,0,0,0,0,0,0,0,-72000,0,0,0,3000,75000,-72000,-72000
00670L,富邦NASDAQ正2   ,0,0,0,0,0,0,0,0,0,-72000,681000,0,681000,58000,811000,-753000,-72000
050118,臻鼎元大94購01  ,0,0,0,0,0,0,0,0,0,-72000,0,0,0,30000,102000,-72000,-72000
050687,上銀日盛94購01  ,0,0,0,0,0,0,0,0,0,-72000,0,0,0,330000,402000,-72000,-72000
052417,聯發科兆豐9B購01,0,0,0,0,0,0,0,0,0,-72000,0,0,0,93000,165000,-72000,-72000
055150,台積電元大98購04,0,0,0,0,0,0,0,0,0,-72000,0,0,0,91000,163000,-72000,-72000
055269,和大元大97購02  ,0,0,0,0,0,0,0,0,0,-72000,0,0,0,16000,88000,-72000,-72000
053518,聯茂群益96購03  ,0,0,0,0,0,0,0,0,0,-72000,0,0,0,45000,117000,-72000,-72000
053178,南亞科統一98購01,0,0,0,0,0,0,0,0,0,-72000,0,0,0,5000,77000,-72000,-72000
1459,聯發            ,0,72000,-72000,0,0,0,0,0,0,0,0,0,0,0,0,0,-72000
06341P,大立光統一97售08,0,0,0,0,0,0,0,0,0,-72000,0,0,0,0,72000,-72000,-72000
057215,友達群益98購03  ,0,0,0,0,0,0,0,0,0,-73000,0,0,0,10000,83000,-73000,-73000
055553,聯發科凱基97購05,0,0,0,0,0,0,0,0,0,-73000,0,0,0,50000,123000,-73000,-73000
055902,同欣電中信99購01,0,0,0,0,0,0,0,0,0,-73000,0,0,0,819000,892000,-73000,-73000
049733,旺宏群益94購03  ,0,0,0,0,0,0,0,0,0,-73000,0,0,0,7000,80000,-73000,-73000
051668,智邦元大95購02  ,0,0,0,0,0,0,0,0,0,-73000,0,0,0,72000,145000,-73000,-73000
051138,訊連永豐95購01  ,0,0,0,0,0,0,0,0,0,-73000,0,0,0,0,73000,-73000,-73000
053175,矽力群益96購01  ,0,0,0,0,0,0,0,0,0,-73000,0,0,0,35000,108000,-73000,-73000
053474,聯發科元大97購06,0,0,0,0,0,0,0,0,0,-73000,0,0,0,50000,123000,-73000,-73000
054722,傳奇永豐97購01  ,0,0,0,0,0,0,0,0,0,-73000,0,0,0,58000,131000,-73000,-73000
054132,聯發科元大97購10,0,0,0,0,0,0,0,0,0,-73000,0,0,0,34000,107000,-73000,-73000
06406P,可成元富97售04  ,0,0,0,0,0,0,0,0,0,-73000,0,0,0,0,73000,-73000,-73000
1902,台紙            ,19000,92000,-73000,0,0,0,0,0,0,0,0,0,0,0,0,0,-73000
3024,憶聲            ,1000,75000,-74000,0,0,0,0,0,0,1000,1000,0,1000,0,0,0,-73000
5471,松翰            ,75000,148000,-73000,0,0,0,0,0,0,0,0,0,0,0,0,0,-73000
055919,景碩凱基98購02  ,0,0,0,0,0,0,0,0,0,-74000,0,0,0,13000,87000,-74000,-74000
057226,上銀凱基98購06  ,0,0,0,0,0,0,0,0,0,-74000,0,0,0,20000,94000,-74000,-74000
056820,欣興永豐98購02  ,0,0,0,0,0,0,0,0,0,-74000,0,0,0,21000,95000,-74000,-74000
048698,宏達電國票95購01,0,0,0,0,0,0,0,0,0,-74000,0,0,0,36000,110000,-74000,-74000
054079,鴻海中信98購02  ,0,0,0,0,0,0,0,0,0,-74000,0,0,0,0,74000,-74000,-74000
054584,貿聯元富97購01  ,0,0,0,0,0,0,0,0,0,-74000,0,0,0,11000,85000,-74000,-74000
054426,國泰金富邦97購02,0,0,0,0,0,0,0,0,0,-74000,0,0,0,230000,304000,-74000,-74000
055049,智邦永豐97購01  ,0,0,0,0,0,0,0,0,0,-74000,0,0,0,71000,145000,-74000,-74000
053899,矽創群益96購02  ,0,0,0,0,0,0,0,0,0,-74000,0,0,0,24000,98000,-74000,-74000
2867,三商壽          ,446000,420000,26000,0,0,0,0,0,0,-100000,0,100000,-100000,0,0,0,-74000
1308,亞聚            ,32000,106000,-74000,0,0,0,0,0,0,0,0,0,0,0,0,0,-74000
057254,友達麥證98購01  ,0,0,0,10000,85000,-75000,0,0,0,-75000,0,0,0,10000,85000,-75000,-75000
057371,可成元大98購08  ,0,0,0,0,0,0,0,0,0,-75000,0,0,0,1000,76000,-75000,-75000
056075,瀚宇博元大97購03,0,0,0,0,0,0,0,0,0,-75000,0,0,0,43000,118000,-75000,-75000
051850,臻鼎中信96購01  ,0,0,0,0,0,0,0,0,0,-75000,0,0,0,45000,120000,-75000,-75000
050704,復盛凱基94購03  ,0,0,0,0,0,0,0,0,0,-75000,0,0,0,52000,127000,-75000,-75000
050717,京鼎群益96購01  ,0,0,0,0,0,0,0,0,0,-75000,0,0,0,273000,348000,-75000,-75000
051624,智邦麥證95購02  ,0,0,0,55000,130000,-75000,0,0,0,-75000,0,0,0,55000,130000,-75000,-75000
050512,台泥元大94購01  ,0,0,0,0,0,0,0,0,0,-75000,0,0,0,0,75000,-75000,-75000
052029,矽力群益95購02  ,0,0,0,0,0,0,0,0,0,-75000,0,0,0,15000,90000,-75000,-75000
049052,台積電永豐94購02,0,0,0,0,0,0,0,0,0,-75000,0,0,0,0,75000,-75000,-75000
048945,訊連永豐94購01  ,0,0,0,0,0,0,0,0,0,-75000,0,0,0,37000,112000,-75000,-75000
052373,鴻海元大95購22  ,0,0,0,0,0,0,0,0,0,-75000,0,0,0,2000,77000,-75000,-75000
051074,矽力國票96購01  ,0,0,0,0,0,0,0,0,0,-75000,0,0,0,0,75000,-75000,-75000
053414,臻鼎國票97購01  ,0,0,0,0,0,0,0,0,0,-75000,0,0,0,30000,105000,-75000,-75000
052863,友達凱基98購02  ,0,0,0,0,0,0,0,0,0,-75000,0,0,0,7000,82000,-75000,-75000
052822,泰碩永豐97購01  ,0,0,0,0,0,0,0,0,0,-75000,0,0,0,0,75000,-75000,-75000
054459,鈺齊群益96購01  ,0,0,0,0,0,0,0,0,0,-75000,0,0,0,118000,193000,-75000,-75000
054607,台積電永豐97購03,0,0,0,0,0,0,0,0,0,-75000,0,0,0,0,75000,-75000,-75000
4725,信昌化          ,37000,113000,-76000,0,0,0,0,0,0,1000,1000,0,1000,0,0,0,-75000
2903,遠百            ,255945,342000,-86055,0,0,0,0,0,0,11000,11000,0,11000,0,0,0,-75055
055886,上銀統一97購02  ,0,0,0,0,0,0,0,0,0,-76000,0,0,0,17000,93000,-76000,-76000
055414,奇力新富邦9B購01,0,0,0,0,0,0,0,0,0,-76000,0,0,0,4000,80000,-76000,-76000
055451,台積電元富97購02,0,0,0,0,0,0,0,0,0,-76000,0,0,0,0,76000,-76000,-76000
057370,可成元大98購07  ,0,0,0,0,0,0,0,0,0,-76000,0,0,0,130000,206000,-76000,-76000
056847,佐登元富98購01  ,0,200000,-200000,0,0,0,0,0,0,124000,0,0,0,227000,103000,124000,-76000
048049,滬深反中信96購01,0,0,0,0,0,0,0,0,0,-76000,0,0,0,0,76000,-76000,-76000
04131P,裕隆群益93售01  ,0,0,0,0,0,0,0,0,0,-76000,0,0,0,6000,82000,-76000,-76000
043748,漢唐元大93購01  ,0,0,0,0,0,0,0,0,0,-76000,0,0,0,20000,96000,-76000,-76000
04916P,大立光永昌96售02,0,0,0,0,0,0,0,0,0,-76000,0,0,0,5000,81000,-76000,-76000
051558,元金2X國泰97購01,0,0,0,0,0,0,0,0,0,-76000,0,0,0,10000,86000,-76000,-76000
04949P,致新元大94售04  ,0,0,0,0,0,0,0,0,0,-76000,0,0,0,100000,176000,-76000,-76000
051099,台郡元大95購03  ,0,0,0,0,0,0,0,0,0,-76000,0,0,0,59000,135000,-76000,-76000
054674,台光電台新97購01,0,0,0,0,0,0,0,0,0,-76000,0,0,0,0,76000,-76000,-76000
054088,華新群益98購02  ,0,0,0,0,0,0,0,0,0,-76000,0,0,0,22000,98000,-76000,-76000
052903,致茂國票97購01  ,0,0,0,0,0,0,0,0,0,-76000,0,0,0,4000,80000,-76000,-76000
052305,GIS永豐95購03   ,0,0,0,0,0,0,0,0,0,-76000,0,0,0,63000,139000,-76000,-76000
052719,致新凱基96購01  ,0,0,0,0,0,0,0,0,0,-76000,0,0,0,0,76000,-76000,-76000
6005,群益證          ,25000,101000,-76000,0,0,0,0,0,0,0,0,0,0,0,0,0,-76000
6451,訊芯-KY         ,43000,128000,-85000,0,0,0,0,0,0,9000,2000,2000,0,32000,23000,9000,-76000
06267P,大立光凱基97售12,0,0,0,0,0,0,0,0,0,-76000,0,0,0,469000,545000,-76000,-76000
056717,康友永豐98購01  ,0,0,0,0,0,0,0,0,0,-77000,0,0,0,22000,99000,-77000,-77000
05678P,群創群益97售01  ,0,0,0,0,0,0,0,0,0,-77000,0,0,0,0,77000,-77000,-77000
042501,台灣50凱基96購06,0,0,0,0,0,0,0,0,0,-77000,0,0,0,0,77000,-77000,-77000
00656R,國泰中國A50反1  ,2010000,1000,2009000,0,0,0,0,0,0,-2086000,0,0,0,1129000,3215000,-2086000,-77000
047444,晶技元大93購03  ,0,0,0,0,0,0,0,0,0,-77000,0,0,0,61000,138000,-77000,-77000
049259,聯發科元大94購04,0,0,0,0,0,0,0,0,0,-77000,0,0,0,138000,215000,-77000,-77000
05078P,義隆永豐95售01  ,0,0,0,0,0,0,0,0,0,-77000,0,0,0,0,77000,-77000,-77000
050175,台光電元大94購08,0,0,0,0,0,0,0,0,0,-77000,0,0,0,61000,138000,-77000,-77000
053083,中環元大99購01  ,0,0,0,0,0,0,0,0,0,-77000,0,0,0,0,77000,-77000,-77000
053698,中磊元大96購02  ,0,0,0,0,0,0,0,0,0,-77000,0,0,0,110000,187000,-77000,-77000
056959,鴻海永豐98購03  ,0,0,0,0,0,0,0,0,0,-78000,0,0,0,0,78000,-78000,-78000
06142P,台虹康和97售02  ,0,0,0,0,0,0,0,0,0,-78000,0,0,0,0,78000,-78000,-78000
055928,南亞科群益97購02,0,0,0,0,0,0,0,0,0,-78000,0,0,0,8000,86000,-78000,-78000
056124,華通國票98購02  ,0,0,0,0,0,0,0,0,0,-78000,0,0,0,17000,95000,-78000,-78000
047787,正崴群益93購01  ,0,0,0,0,0,0,0,0,0,-78000,0,0,0,22000,100000,-78000,-78000
050200,致新元大94購01  ,0,0,0,0,0,0,0,0,0,-78000,0,0,0,20000,98000,-78000,-78000
05054P,臻鼎群益95售02  ,0,0,0,0,0,0,0,0,0,-78000,0,0,0,30000,108000,-78000,-78000
052722,群創統一97購02  ,0,0,0,0,0,0,0,0,0,-78000,0,0,0,0,78000,-78000,-78000
06597P,國巨富邦9A售05  ,0,0,0,0,0,0,0,0,0,-78000,0,0,0,20000,98000,-78000,-78000
056134,可成元大97購06  ,0,0,0,0,0,0,0,0,0,-79000,0,0,0,76000,155000,-79000,-79000
055799,致茂永豐97購02  ,0,0,0,0,0,0,0,0,0,-79000,0,0,0,0,79000,-79000,-79000
06089P,矽創永豐97售01  ,0,0,0,0,0,0,0,0,0,-79000,0,0,0,0,79000,-79000,-79000
056773,晶技元大99購03  ,0,0,0,0,0,0,0,0,0,-79000,0,0,0,213000,292000,-79000,-79000
056600,聯茂元富98購01  ,0,0,0,0,0,0,0,0,0,-79000,0,0,0,388000,467000,-79000,-79000
045522,滬深2X永豐94購01,0,0,0,0,0,0,0,0,0,-79000,0,0,0,20000,99000,-79000,-79000
04714P,上海銀元大94售01,0,0,0,0,0,0,0,0,0,-79000,0,0,0,0,79000,-79000,-79000
048128,超眾元大95購01  ,0,0,0,0,0,0,0,0,0,-79000,0,0,0,21000,100000,-79000,-79000
051091,聯發科元大95購07,0,0,0,0,0,0,0,0,0,-79000,0,0,0,0,79000,-79000,-79000
053517,崇越群益97購01  ,0,0,0,0,0,0,0,0,0,-79000,0,0,0,15000,94000,-79000,-79000
054305,光磊凱基98購01  ,0,0,0,0,0,0,0,0,0,-79000,0,0,0,127000,206000,-79000,-79000
054299,南電元大96購03  ,0,0,0,0,0,0,0,0,0,-79000,0,0,0,13000,92000,-79000,-79000
05447P,臺股指元大95售24,0,0,0,0,0,0,0,0,0,-79000,0,0,0,30000,109000,-79000,-79000
1802,台玻            ,20000,99000,-79000,0,0,0,0,0,0,0,0,0,0,0,0,0,-79000
05957P,友達國票97售04  ,0,0,0,0,0,0,0,0,0,-80000,0,0,0,30000,110000,-80000,-80000
05853P,欣興群益96售05  ,0,0,0,0,0,0,0,0,0,-80000,0,0,0,35000,115000,-80000,-80000
057269,鈺齊兆豐98購01  ,0,0,0,0,0,0,0,0,0,-80000,0,0,0,20000,100000,-80000,-80000
055934,景碩群益98購03  ,0,0,0,0,0,0,0,0,0,-80000,0,0,0,157000,237000,-80000,-80000
05593P,鴻海國票97售03  ,0,0,0,0,0,0,0,0,0,-80000,0,0,0,0,80000,-80000,-80000
048312,致茂凱基93購02  ,0,0,0,0,0,0,0,0,0,-80000,0,0,0,0,80000,-80000,-80000
048502,百和元大93購01  ,0,0,0,0,0,0,0,0,0,-80000,0,0,0,20000,100000,-80000,-80000
050374,上緯控元大95購01,0,0,0,0,0,0,0,0,0,-80000,0,0,0,0,80000,-80000,-80000
044862,台表科兆豐93購01,0,0,0,0,0,0,0,0,0,-80000,0,0,0,0,80000,-80000,-80000
044935,玉晶光元大93購03,0,0,0,0,0,0,0,0,0,-80000,0,0,0,0,80000,-80000,-80000
051573,鴻海元大95購15  ,0,0,0,0,0,0,0,0,0,-80000,0,0,0,0,80000,-80000,-80000
049118,元油2X元富94購03,0,0,0,0,0,0,0,0,0,-80000,0,0,0,50000,130000,-80000,-80000
052422,聯電國票96購03  ,0,0,0,0,0,0,0,0,0,-80000,0,0,0,14000,94000,-80000,-80000
052550,鴻海國票97購02  ,0,0,0,0,0,0,0,0,0,-80000,0,0,0,0,80000,-80000,-80000
050005,京鼎永豐94購01  ,0,0,0,0,0,0,0,0,0,-80000,0,0,0,91000,171000,-80000,-80000
051004,台新金中信95購02,0,0,0,0,0,0,0,0,0,-80000,0,0,0,0,80000,-80000,-80000
050929,中磊凱基95購01  ,0,0,0,0,0,0,0,0,0,-80000,0,0,0,276000,356000,-80000,-80000
055179,大立光統一97購04,0,0,0,0,0,0,0,0,0,-80000,0,0,0,31000,111000,-80000,-80000
054894,GIS統一97購01   ,0,0,0,0,0,0,0,0,0,-80000,0,0,0,0,80000,-80000,-80000
053627,宏碁兆豐97購01  ,0,0,0,0,0,0,0,0,0,-80000,0,0,0,20000,100000,-80000,-80000
053748,燿華永豐96購04  ,0,0,0,0,0,0,0,0,0,-80000,0,0,0,0,80000,-80000,-80000
053803,聯發科凱基96購18,0,0,0,0,0,0,0,0,0,-80000,0,0,0,20000,100000,-80000,-80000
053947,義隆富邦97購01  ,0,0,0,0,0,0,0,0,0,-80000,0,0,0,18000,98000,-80000,-80000
052471,華固亞東95購01  ,0,0,0,0,0,0,0,0,0,-80000,0,0,0,0,80000,-80000,-80000
053179,大立光統一96購04,0,0,0,0,0,0,0,0,0,-80000,0,0,0,0,80000,-80000,-80000
06458P,玉晶光統一9A售02,0,0,0,0,0,0,0,0,0,-80000,0,0,0,3000,83000,-80000,-80000
056335,微星凱基98購01  ,0,0,0,0,0,0,0,0,0,-81000,0,0,0,28000,109000,-81000,-81000
056695,景碩群益99購01  ,0,0,0,0,0,0,0,0,0,-81000,0,0,0,81000,162000,-81000,-81000
056784,南亞科群益98購01,0,0,0,0,0,0,0,0,0,-81000,0,0,0,124000,205000,-81000,-81000
057010,景碩中信98購01  ,0,0,0,0,0,0,0,0,0,-81000,0,0,0,21000,102000,-81000,-81000
051463,世芯國泰97購02  ,0,0,0,0,0,0,0,0,0,-81000,0,0,0,54000,135000,-81000,-81000
04852P,臻鼎永豐94售02  ,0,0,0,0,0,0,0,0,0,-81000,0,0,0,0,81000,-81000,-81000
05148P,臻鼎元大95售01  ,0,0,0,0,0,0,0,0,0,-81000,0,0,0,10000,91000,-81000,-81000
051703,台積電群益95購04,0,0,0,0,0,0,0,0,0,-81000,0,0,0,67000,148000,-81000,-81000
2031,新光鋼          ,90000,166000,-76000,0,0,0,0,0,0,-5000,1000,0,1000,0,6000,-6000,-81000
056543,京鼎凱基98購01  ,0,0,0,0,0,0,0,0,0,-82000,0,0,0,226000,308000,-82000,-82000
047652,滬深2X兆豐94購03,0,0,0,0,0,0,0,0,0,-82000,0,0,0,0,82000,-82000,-82000
050735,亞光台新94購01  ,0,0,0,0,0,0,0,0,0,-82000,0,0,0,0,82000,-82000,-82000
051324,康友國票96購01  ,0,0,0,0,0,0,0,0,0,-82000,0,0,0,10000,92000,-82000,-82000
052006,康友富邦98購01  ,0,0,0,0,0,0,0,0,0,-82000,0,0,0,75000,157000,-82000,-82000
05261P,鴻海元大95售20  ,0,0,0,0,0,0,0,0,0,-82000,0,0,0,129000,211000,-82000,-82000
052363,廣達國票96購01  ,0,0,0,0,0,0,0,0,0,-82000,0,0,0,120000,202000,-82000,-82000
052194,旺宏元富95購04  ,0,0,0,0,0,0,0,0,0,-82000,0,0,0,10000,92000,-82000,-82000
055129,鈺齊兆豐97購01  ,0,0,0,0,0,0,0,0,0,-82000,0,0,0,30000,112000,-82000,-82000
054017,茂林永豐96購02  ,0,0,0,0,0,0,0,0,0,-82000,0,0,0,6000,88000,-82000,-82000
06674P,祥碩群益98售02  ,0,0,0,0,0,0,0,0,0,-82000,0,0,0,10000,92000,-82000,-82000
06338P,亞德客統一97售02,0,0,0,0,0,0,0,0,0,-82000,0,0,0,167000,249000,-82000,-82000
6206,飛捷            ,75000,157000,-82000,0,0,0,0,0,0,0,0,0,0,0,0,0,-82000
055417,健策富邦98購02  ,0,0,0,0,0,0,0,0,0,-83000,0,0,0,144000,227000,-83000,-83000
055345,國巨凱基98購01  ,0,0,0,0,0,0,0,0,0,-83000,0,0,0,0,83000,-83000,-83000
05683P,矽創元大96售01  ,0,0,0,0,0,0,0,0,0,-83000,0,0,0,0,83000,-83000,-83000
056591,S&P正2元富9A購01,0,0,0,0,0,0,0,0,0,-83000,0,0,0,0,83000,-83000,-83000
052105,南亞科兆豐95購01,0,0,0,0,0,0,0,0,0,-83000,0,0,0,1000,84000,-83000,-83000
049086,晶相光凱基94購01,0,0,0,0,0,0,0,0,0,-83000,0,0,0,31000,114000,-83000,-83000
052280,聯發科凱基95購11,0,0,0,0,0,0,0,0,0,-83000,0,0,0,30000,113000,-83000,-83000
052861,台光電凱基96購03,0,0,0,0,0,0,0,0,0,-83000,0,0,0,93000,176000,-83000,-83000
053818,富邦金群益98購01,0,0,0,0,0,0,0,0,0,-83000,0,0,0,60000,143000,-83000,-83000
053342,全新國票99購01  ,0,0,0,0,0,0,0,0,0,-83000,0,0,0,27000,110000,-83000,-83000
5522,遠雄            ,185000,169000,16000,0,0,0,0,0,0,-99000,1000,100000,-99000,0,0,0,-83000
2464,盟立            ,17000,100000,-83000,0,0,0,0,0,0,0,0,0,0,0,0,0,-83000
06680P,智邦元大98售06  ,0,0,0,0,0,0,0,0,0,-83000,0,0,0,0,83000,-83000,-83000
910322,康師傅-DR       ,0,83000,-83000,0,0,0,0,0,0,0,0,0,0,0,0,0,-83000
056864,新日興群益99購01,0,0,0,0,0,0,0,0,0,-84000,0,0,0,114000,198000,-84000,-84000
052211,台積電元大95購22,0,0,0,0,0,0,0,0,0,-84000,0,0,0,110000,194000,-84000,-84000
057458,TPK富邦9A購01   ,0,0,0,0,0,0,0,0,0,-84000,0,0,0,71000,155000,-84000,-84000
055837,致茂元大97購02  ,0,0,0,0,0,0,0,0,0,-84000,0,0,0,0,84000,-84000,-84000
050442,復盛凱基94購01  ,0,0,0,0,0,0,0,0,0,-84000,0,0,0,56000,140000,-84000,-84000
2375,凱美            ,174000,232000,-58000,0,0,0,0,0,0,-26000,0,0,0,36000,62000,-26000,-84000
055679,華通凱基99購01  ,0,0,0,0,0,0,0,0,0,-85000,0,0,0,190000,275000,-85000,-85000
056198,台光電永豐97購02,0,0,0,0,0,0,0,0,0,-85000,0,0,0,41000,126000,-85000,-85000
057466,泰鼎永豐98購01  ,0,0,0,0,0,0,0,0,0,-85000,0,0,0,0,85000,-85000,-85000
06004P,奇力新永豐96售02,0,0,0,0,0,0,0,0,0,-85000,0,0,0,30000,115000,-85000,-85000
05966P,矽力凱基96售03  ,0,0,0,0,0,0,0,0,0,-85000,0,0,0,5000,90000,-85000,-85000
047688,亞德客富邦95購01,0,0,0,0,0,0,0,0,0,-85000,0,0,0,18000,103000,-85000,-85000
050365,中石化元大94購02,0,0,0,0,0,0,0,0,0,-85000,0,0,0,0,85000,-85000,-85000
049209,GIS群益94購03   ,0,0,0,0,0,0,0,0,0,-85000,0,0,0,0,85000,-85000,-85000
050417,喬山凱基94購01  ,0,0,0,0,0,0,0,0,0,-85000,0,0,0,34000,119000,-85000,-85000
049287,可成兆豐95購01  ,0,0,0,0,0,0,0,0,0,-85000,0,0,0,10000,95000,-85000,-85000
051545,裕隆康和95購01  ,0,0,0,0,0,0,0,0,0,-85000,0,0,0,45000,130000,-85000,-85000
051526,超眾凱基95購02  ,0,0,0,0,0,0,0,0,0,-85000,0,0,0,28000,113000,-85000,-85000
05155P,聯發科兆豐95售03,0,0,0,0,0,0,0,0,0,-85000,0,0,0,0,85000,-85000,-85000
053413,台積電國票99購01,0,0,0,0,0,0,0,0,0,-85000,0,0,0,55000,140000,-85000,-85000
05293P,廣達凱基95售01  ,0,0,0,0,0,0,0,0,0,-85000,0,0,0,0,85000,-85000,-85000
049226,元石油富邦95購01,0,0,0,0,0,0,0,0,0,-86000,0,0,0,14000,100000,-86000,-86000
052447,聯發科元大96購04,0,0,0,0,0,0,0,0,0,-86000,0,0,0,4000,90000,-86000,-86000
051050,鴻海群益95購03  ,0,0,0,0,0,0,0,0,0,-86000,0,0,0,28000,114000,-86000,-86000
052838,新唐國泰98購01  ,0,0,0,0,0,0,0,0,0,-86000,0,0,0,0,86000,-86000,-86000
052749,日月光元大96購02,0,0,0,0,0,0,0,0,0,-86000,0,0,0,14000,100000,-86000,-86000
053620,臺股指群益96購06,0,0,0,0,0,0,0,0,0,-86000,0,0,0,8000,94000,-86000,-86000
053602,台虹元大96購01  ,0,0,0,0,0,0,0,0,0,-86000,0,0,0,249000,335000,-86000,-86000
054121,奇鋐永豐96購02  ,0,0,0,0,0,0,0,0,0,-86000,0,0,0,15000,101000,-86000,-86000
2329,華泰            ,305000,181000,124000,0,0,0,0,0,0,-210000,0,0,0,0,210000,-210000,-86000
06156P,大立光統一97售05,0,0,0,0,0,0,0,0,0,-87000,0,0,0,1000,88000,-87000,-87000
055971,矽力元大97購05  ,0,0,0,0,0,0,0,0,0,-87000,0,0,0,1000,88000,-87000,-87000
055604,訊芯元大98購02  ,0,0,0,0,0,0,0,0,0,-87000,0,0,0,10000,97000,-87000,-87000
048002,景碩元大93購04  ,0,0,0,0,0,0,0,0,0,-87000,0,0,0,14000,101000,-87000,-87000
03567P,可成凱基02售06  ,0,0,0,0,0,0,0,0,0,-87000,0,0,0,31000,118000,-87000,-87000
049410,統一凱基94購02  ,0,0,0,0,0,0,0,0,0,-87000,0,0,0,86000,173000,-87000,-87000
051490,世芯凱基96購01  ,0,0,0,0,0,0,0,0,0,-87000,0,0,0,55000,142000,-87000,-87000
052046,漢唐凱基96購01  ,0,0,0,0,0,0,0,0,0,-87000,0,0,0,0,87000,-87000,-87000
051178,大立光凱基95購10,0,0,0,0,0,0,0,0,0,-87000,0,0,0,2000,89000,-87000,-87000
054250,漢唐元大96購04  ,0,0,0,0,0,0,0,0,0,-87000,0,0,0,15000,102000,-87000,-87000
054790,禾伸堂群益98購01,0,0,0,0,0,0,0,0,0,-87000,0,0,0,85000,172000,-87000,-87000
06233P,訊芯永豐97售03  ,0,0,0,0,0,0,0,0,0,-87000,0,0,0,0,87000,-87000,-87000
055617,TPK國票98購04   ,0,0,0,0,0,0,0,0,0,-88000,0,0,0,0,88000,-88000,-88000
055463,國喬凱基97購01  ,0,0,0,0,0,0,0,0,0,-88000,0,0,0,0,88000,-88000,-88000
056271,嘉澤統一97購01  ,0,0,0,0,0,0,0,0,0,-88000,0,0,0,48000,136000,-88000,-88000
06032P,健策群益97售03  ,0,0,0,0,0,0,0,0,0,-88000,0,0,0,1000,89000,-88000,-88000
056671,台灣50元富9A購01,0,0,0,0,0,0,0,0,0,-88000,0,0,0,451000,539000,-88000,-88000
047699,亞德客凱基93購04,0,0,0,0,0,0,0,0,0,-88000,0,0,0,9000,97000,-88000,-88000
049219,聯發科國票95購01,0,0,0,0,0,0,0,0,0,-88000,0,0,0,0,88000,-88000,-88000
050730,復盛國票94購01  ,0,0,0,0,0,0,0,0,0,-88000,0,0,0,38000,126000,-88000,-88000
054624,台積電凱基98購03,0,0,0,0,0,0,0,0,0,-88000,0,0,0,0,88000,-88000,-88000
06422P,勤誠統一98售01  ,0,0,0,0,0,0,0,0,0,-88000,0,0,0,20000,108000,-88000,-88000
056799,群創麥證98購01  ,0,0,0,0,89000,-89000,0,0,0,-89000,0,0,0,0,89000,-89000,-89000
057018,亞德客凱基98購01,0,0,0,0,0,0,0,0,0,-89000,0,0,0,19000,108000,-89000,-89000
056446,聯發科凱基98購08,0,0,0,0,0,0,0,0,0,-89000,0,0,0,10000,99000,-89000,-89000
051636,嘉晶國票95購02  ,0,0,0,0,0,0,0,0,0,-89000,0,0,0,70000,159000,-89000,-89000
050252,聯發科國泰95購01,0,0,0,0,0,0,0,0,0,-89000,0,0,0,110000,199000,-89000,-89000
054950,奇力新元大98購02,0,0,0,0,0,0,0,0,0,-89000,0,0,0,6000,95000,-89000,-89000
056328,訊芯兆豐98購01  ,0,0,0,0,0,0,0,0,0,-90000,0,0,0,84000,174000,-90000,-90000
056324,南亞科兆豐98購01,0,0,0,0,0,0,0,0,0,-90000,0,0,0,10000,100000,-90000,-90000
055503,健策元大98購05  ,0,0,0,0,0,0,0,0,0,-90000,0,0,0,247000,337000,-90000,-90000
056652,上証反元大9B購01,0,0,0,0,0,0,0,0,0,-90000,0,0,0,0,90000,-90000,-90000
051789,嘉澤國票96購01  ,0,0,0,0,0,0,0,0,0,-90000,0,0,0,0,90000,-90000,-90000
048443,旺宏凱基93購08  ,0,0,0,0,0,0,0,0,0,-90000,0,0,0,0,90000,-90000,-90000
046645,技嘉國泰94購01  ,0,0,0,0,0,0,0,0,0,-90000,0,0,0,711000,801000,-90000,-90000
04214P,美利達凱基93售04,0,0,0,0,0,0,0,0,0,-90000,0,0,0,0,90000,-90000,-90000
04260P,亞德客群益93售01,0,0,0,0,0,0,0,0,0,-90000,0,0,0,0,90000,-90000,-90000
04794P,友達元大96售03  ,0,0,0,0,0,0,0,0,0,-90000,0,0,0,0,90000,-90000,-90000
05130P,聯發科統一95售03,0,0,0,0,0,0,0,0,0,-90000,0,0,0,0,90000,-90000,-90000
050833,台郡凱基95購01  ,0,0,0,0,0,0,0,0,0,-90000,0,0,0,27000,117000,-90000,-90000
054861,智邦群益97購01  ,0,0,0,0,0,0,0,0,0,-90000,0,0,0,312000,402000,-90000,-90000
054535,旺宏富邦97購02  ,0,0,0,0,0,0,0,0,0,-90000,0,0,0,0,90000,-90000,-90000
054474,鴻海中信96購03  ,0,0,0,0,0,0,0,0,0,-90000,0,0,0,0,90000,-90000,-90000
054178,中磊台新97購01  ,0,0,0,0,0,0,0,0,0,-90000,0,0,0,27000,117000,-90000,-90000
054144,康控元大97購02  ,0,0,0,0,0,0,0,0,0,-90000,0,0,0,78000,168000,-90000,-90000
053433,友達日盛99購06  ,0,0,0,0,0,0,0,0,0,-90000,0,0,0,10000,100000,-90000,-90000
053191,奇鋐統一96購01  ,0,0,0,0,0,0,0,0,0,-90000,0,0,0,0,90000,-90000,-90000
06303P,臺股指元大97售09,0,0,0,0,0,0,0,0,0,-90000,0,0,0,0,90000,-90000,-90000
2233,宇隆            ,1000,83000,-82000,0,0,0,0,0,0,-8000,0,8000,-8000,0,0,0,-90000
5880,合庫金          ,832000,924000,-92000,0,0,0,2000,0,2000,0,0,0,0,0,0,0,-90000
6239,力成            ,927000,1049000,-122000,0,0,0,39000,0,39000,-7000,12000,10000,2000,3000,12000,-9000,-90000
055758,旺宏群益97購01  ,0,0,0,0,0,0,0,0,0,-91000,0,0,0,46000,137000,-91000,-91000
056404,嘉聯益群益9A購01,0,0,0,0,0,0,0,0,0,-91000,0,0,0,24000,115000,-91000,-91000
00648R,元大S&P500反1   ,0,0,0,0,0,0,0,0,0,-91000,0,0,0,0,91000,-91000,-91000
03765P,大立光元富96售01,0,0,0,0,0,0,0,0,0,-91000,0,0,0,10000,101000,-91000,-91000
051073,同欣電國票96購01,35000,0,35000,0,0,0,0,0,0,-126000,0,0,0,27000,153000,-126000,-91000
050173,旺宏元大96購02  ,0,0,0,0,0,0,0,0,0,-91000,0,0,0,5000,96000,-91000,-91000
053827,漢唐麥證9A購01  ,0,0,0,30000,121000,-91000,0,0,0,-91000,0,0,0,30000,121000,-91000,-91000
054371,台積電中信9C購01,0,0,0,0,0,0,0,0,0,-91000,0,0,0,16000,107000,-91000,-91000
054637,智邦中信98購01  ,0,0,0,0,0,0,0,0,0,-91000,0,0,0,40000,131000,-91000,-91000
06339P,上銀統一97售06  ,0,0,0,0,0,0,0,0,0,-91000,0,0,0,62000,153000,-91000,-91000
056586,光罩統一98購02  ,0,0,0,0,0,0,0,0,0,-92000,0,0,0,104000,196000,-92000,-92000
056860,正崴群益98購01  ,0,0,0,0,0,0,0,0,0,-92000,0,0,0,6000,98000,-92000,-92000
047046,台積電國票94購01,0,0,0,0,0,0,0,0,0,-92000,0,0,0,26000,118000,-92000,-92000
050777,臻鼎元大94購05  ,0,0,0,0,0,0,0,0,0,-92000,0,0,0,0,92000,-92000,-92000
049267,瀚宇博元大95購02,0,0,0,0,0,0,0,0,0,-92000,0,0,0,1000,93000,-92000,-92000
053013,台積電統一97購01,0,0,0,0,0,0,0,0,0,-92000,0,0,0,10000,102000,-92000,-92000
052582,喬山台新96購01  ,0,0,0,0,0,0,0,0,0,-92000,0,0,0,0,92000,-92000,-92000
049950,南亞科群益94購02,0,0,0,0,0,0,0,0,0,-92000,0,0,0,104000,196000,-92000,-92000
054346,世芯國票97購01  ,0,0,0,0,0,0,0,0,0,-92000,0,0,0,50000,142000,-92000,-92000
055126,嘉澤兆豐97購01  ,0,0,0,0,0,0,0,0,0,-92000,0,0,0,76000,168000,-92000,-92000
057387,奇力新永豐98購03,0,0,0,0,0,0,0,0,0,-93000,0,0,0,9000,102000,-93000,-93000
056068,欣興元大97購05  ,0,0,0,0,0,0,0,0,0,-93000,0,0,0,20000,113000,-93000,-93000
055738,玉山金元富97購01,0,0,0,0,0,0,0,0,0,-93000,0,0,0,10000,103000,-93000,-93000
055462,華邦電日盛97購01,0,0,0,0,0,0,0,0,0,-93000,0,0,0,100000,193000,-93000,-93000
051862,旺宏凱基95購05  ,0,0,0,0,0,0,0,0,0,-93000,0,0,0,0,93000,-93000,-93000
049246,大成鋼元大94購02,0,0,0,0,0,0,0,0,0,-93000,0,0,0,0,93000,-93000,-93000
04102P,臺股指國票93售09,0,0,0,0,0,0,0,0,0,-93000,0,0,0,7000,100000,-93000,-93000
04433P,上証2X國票95售01,0,0,0,0,0,0,0,0,0,-93000,0,0,0,1330000,1423000,-93000,-93000
054142,致伸元大97購01  ,0,0,0,0,0,0,0,0,0,-93000,0,0,0,3000,96000,-93000,-93000
054246,國巨元大96購12  ,0,0,0,0,0,0,0,0,0,-93000,0,0,0,222000,315000,-93000,-93000
053419,光罩永豐96購01  ,0,0,0,0,0,0,0,0,0,-93000,0,0,0,0,93000,-93000,-93000
6226,光鼎            ,41000,135000,-94000,0,0,0,0,0,0,1000,1000,0,1000,0,0,0,-93000
2545,皇翔            ,9000,102000,-93000,0,0,0,0,0,0,0,0,0,0,0,0,0,-93000
056081,T50反1統一99購02,0,0,0,0,0,0,0,0,0,-94000,0,0,0,0,94000,-94000,-94000
06159P,牧德元富97售02  ,0,0,0,0,0,0,0,0,0,-94000,0,0,0,5000,99000,-94000,-94000
056839,台光電元富98購02,0,0,0,0,0,0,0,0,0,-94000,0,0,0,9000,103000,-94000,-94000
057024,義隆凱基99購01  ,0,0,0,0,0,0,0,0,0,-94000,0,0,0,0,94000,-94000,-94000
045235,致茂中信93購01  ,0,0,0,0,0,0,0,0,0,-94000,0,0,0,0,94000,-94000,-94000
048218,上銀凱基93購07  ,0,0,0,0,0,0,0,0,0,-94000,0,0,0,121000,215000,-94000,-94000
047497,聯發科康和93購01,0,0,0,0,0,0,0,0,0,-94000,0,0,0,0,94000,-94000,-94000
051415,晶技國票96購01  ,0,0,0,0,0,0,0,0,0,-94000,0,0,0,30000,124000,-94000,-94000
049285,宏碁兆豐94購01  ,0,0,0,0,0,0,0,0,0,-94000,0,0,0,10000,104000,-94000,-94000
053271,喬山元大97購01  ,0,0,0,0,0,0,0,0,0,-94000,0,0,0,6000,100000,-94000,-94000
054671,國巨國泰98購01  ,0,0,0,0,0,0,0,0,0,-94000,0,0,0,361000,455000,-94000,-94000
057113,祥碩群益98購01  ,0,0,0,0,0,0,0,0,0,-95000,0,0,0,14000,109000,-95000,-95000
056260,鴻海統一98購07  ,0,0,0,0,0,0,0,0,0,-95000,0,0,0,0,95000,-95000,-95000
055406,大毅國泰99購01  ,0,0,0,0,0,0,0,0,0,-95000,0,0,0,153000,248000,-95000,-95000
04348P,燿華國票94售01  ,0,0,0,0,0,0,0,0,0,-95000,0,0,0,0,95000,-95000,-95000
051615,華通凱基96購01  ,0,0,0,0,0,0,0,0,0,-95000,0,0,0,10000,105000,-95000,-95000
050115,群創元大96購01  ,0,0,0,0,0,0,0,0,0,-95000,0,0,0,398000,493000,-95000,-95000
051198,鴻海麥證95購02  ,0,0,0,0,95000,-95000,0,0,0,-95000,0,0,0,0,95000,-95000,-95000
049585,旺宏元大95購02  ,0,0,0,0,0,0,0,0,0,-95000,0,0,0,5000,100000,-95000,-95000
054987,凱美元富97購01  ,0,0,0,0,0,0,0,0,0,-95000,0,0,0,49000,144000,-95000,-95000
1464,得力            ,12000,85000,-73000,0,0,0,0,0,0,-22000,0,0,0,0,22000,-22000,-95000
057064,華新科富邦9B購01,0,0,0,0,0,0,0,0,0,-96000,0,0,0,36000,132000,-96000,-96000
056655,旺宏元大99購02  ,0,0,0,0,0,0,0,0,0,-96000,0,0,0,30000,126000,-96000,-96000
04964P,鴻海元大94售26  ,0,0,0,0,0,0,0,0,0,-96000,0,0,0,4000,100000,-96000,-96000
048978,晶相光元大94購02,0,0,0,0,0,0,0,0,0,-96000,0,0,0,9000,105000,-96000,-96000
051979,群創凱基97購01  ,0,0,0,0,0,0,0,0,0,-96000,0,0,0,11000,107000,-96000,-96000
053931,楠梓電統一96購01,0,0,0,0,0,0,0,0,0,-96000,0,0,0,48000,144000,-96000,-96000
053852,南亞科國泰98購01,0,0,0,0,0,0,0,0,0,-96000,0,0,0,126000,222000,-96000,-96000
06182P,群創兆豐97售03  ,0,0,0,0,0,0,0,0,0,-96000,0,0,0,6000,102000,-96000,-96000
047450,南茂元大93購05  ,0,0,0,0,0,0,0,0,0,-97000,0,0,0,0,97000,-97000,-97000
051470,玉晶光日盛95購01,0,0,0,0,0,0,0,0,0,-97000,0,0,0,25000,122000,-97000,-97000
050891,喬山元大95購01  ,0,0,0,0,0,0,0,0,0,-97000,0,0,0,105000,202000,-97000,-97000
053457,旺宏國泰98購03  ,0,0,0,0,0,0,0,0,0,-97000,0,0,0,38000,135000,-97000,-97000
4564,元翎            ,28000,125000,-97000,0,0,0,0,0,0,0,0,0,0,0,0,0,-97000
056585,台積電統一9A購01,0,0,0,0,0,0,0,0,0,-98000,0,0,0,15000,113000,-98000,-98000
06172P,台虹永豐97售02  ,0,0,0,0,0,0,0,0,0,-98000,0,0,0,5000,103000,-98000,-98000
055931,冠德群益97購02  ,0,0,0,0,0,0,0,0,0,-98000,0,0,0,0,98000,-98000,-98000
055889,鴻海統一97購05  ,0,0,0,0,0,0,0,0,0,-98000,0,0,0,0,98000,-98000,-98000
056490,台積電國泰99購01,0,0,0,0,0,0,0,0,0,-98000,0,0,0,0,98000,-98000,-98000
051892,台光電元富95購03,0,0,0,0,0,0,0,0,0,-98000,0,0,0,0,98000,-98000,-98000
050989,台表科富邦95購01,0,0,0,0,0,0,0,0,0,-98000,0,0,0,0,98000,-98000,-98000
05151P,台光電群益95售02,0,0,0,0,0,0,0,0,0,-98000,0,0,0,0,98000,-98000,-98000
051161,喬山元大95購02  ,0,0,0,0,0,0,0,0,0,-98000,0,0,0,2000,100000,-98000,-98000
053061,GIS富邦97購01   ,0,0,0,0,0,0,0,0,0,-98000,0,0,0,0,98000,-98000,-98000
054960,新日興元大97購02,0,0,0,0,0,0,0,0,0,-98000,0,0,0,102000,200000,-98000,-98000
055188,亞翔統一97購01  ,0,0,0,0,0,0,0,0,0,-98000,0,0,0,56000,154000,-98000,-98000
054457,強茂群益96購01  ,0,0,0,0,0,0,0,0,0,-98000,0,0,0,0,98000,-98000,-98000
05587P,鴻海凱基96售12  ,0,0,0,0,0,0,0,0,0,-99000,0,0,0,1000,100000,-99000,-99000
055614,華新科國票97購02,0,0,0,0,0,0,0,0,0,-99000,0,0,0,258000,357000,-99000,-99000
05703P,矽力群益96售03  ,0,0,0,0,0,0,0,0,0,-99000,0,0,0,0,99000,-99000,-99000
048768,景碩凱基94購02  ,0,0,0,0,0,0,0,0,0,-99000,0,0,0,5000,104000,-99000,-99000
050420,鴻海凱基95購03  ,0,0,0,0,0,0,0,0,0,-99000,0,0,0,1000,100000,-99000,-99000
052568,漢唐凱基96購02  ,0,0,0,0,0,0,0,0,0,-99000,0,0,0,1000,100000,-99000,-99000
054179,上海銀台新97購01,0,0,0,0,0,0,0,0,0,-99000,0,0,0,38000,137000,-99000,-99000
4551,智伸科          ,32000,18000,14000,0,0,0,0,104000,-104000,-9000,4000,8000,-4000,3000,8000,-5000,-99000
1304,台聚            ,97000,196000,-99000,0,0,0,0,0,0,0,0,0,0,0,0,0,-99000
057025,華新科凱基98購04,0,0,0,0,0,0,0,0,0,-100000,0,0,0,0,100000,-100000,-100000
05701P,彩晶凱基96售01  ,0,0,0,0,0,0,0,0,0,-100000,0,0,0,0,100000,-100000,-100000
057168,旺宏元大99購03  ,0,0,0,0,0,0,0,0,0,-100000,0,0,0,0,100000,-100000,-100000
05714P,群創統一97售03  ,0,0,0,0,0,0,0,0,0,-100000,0,0,0,0,100000,-100000,-100000
057357,超眾統一98購01  ,0,0,0,0,0,0,0,0,0,-100000,0,0,0,0,100000,-100000,-100000
057188,佐登元大98購01  ,0,231000,-231000,0,0,0,0,0,0,131000,0,0,0,255000,124000,131000,-100000
055306,燿華群益97購01  ,0,0,0,0,0,0,0,0,0,-100000,0,0,0,0,100000,-100000,-100000
055977,南亞科統一97購01,0,0,0,0,0,0,0,0,0,-100000,0,0,0,0,100000,-100000,-100000
055975,鴻海統一98購05  ,0,0,0,0,0,0,0,0,0,-100000,0,0,0,0,100000,-100000,-100000
04881P,高股息凱基96售01,0,0,0,0,0,0,0,0,0,-100000,0,0,0,0,100000,-100000,-100000
047266,嘉聯益國票94購02,0,0,0,0,0,0,0,0,0,-100000,0,0,0,0,100000,-100000,-100000
047248,奇鋐群益95購01  ,0,0,0,0,0,0,0,0,0,-100000,0,0,0,0,100000,-100000,-100000
048603,中磊國票94購02  ,0,0,0,0,0,0,0,0,0,-100000,0,0,0,17000,117000,-100000,-100000
048714,巨大康和94購01  ,0,0,0,0,0,0,0,0,0,-100000,0,0,0,0,100000,-100000,-100000
050357,南電群益94購02  ,0,0,0,0,0,0,0,0,0,-100000,0,0,0,0,100000,-100000,-100000
05037P,華新科元大95售09,0,0,0,0,0,0,0,0,0,-100000,0,0,0,50000,150000,-100000,-100000
048084,華通凱基93購05  ,0,0,0,0,0,0,0,0,0,-100000,0,0,0,0,100000,-100000,-100000
048086,鴻海凱基93購33  ,0,0,0,0,0,0,0,0,0,-100000,0,0,0,0,100000,-100000,-100000
046697,麗豐凱基94購01  ,0,0,0,0,0,0,0,0,0,-100000,0,0,0,0,100000,-100000,-100000
042993,葡萄王元大94購01,0,0,0,0,0,0,0,0,0,-100000,0,0,0,0,100000,-100000,-100000
03860P,群創元富97售01  ,0,0,0,0,0,0,0,0,0,-100000,0,0,0,50000,150000,-100000,-100000
04168P,元金2X凱基99售01,0,0,0,0,0,0,0,0,0,-100000,0,0,0,0,100000,-100000,-100000
045371,元石油元大95購01,0,0,0,0,0,0,0,0,0,-100000,0,0,0,0,100000,-100000,-100000
046499,技嘉元大92購02  ,0,0,0,0,0,0,0,0,0,-100000,0,0,0,0,100000,-100000,-100000
044354,奇鋐元大93購02  ,0,0,0,0,0,0,0,0,0,-100000,0,0,0,0,100000,-100000,-100000
044493,京元電元大92購02,0,0,0,0,0,0,0,0,0,-100000,0,0,0,0,100000,-100000,-100000
052438,瑞儀富邦95購01  ,0,0,0,0,0,0,0,0,0,-100000,0,0,0,0,100000,-100000,-100000
052141,百和凱基95購02  ,0,0,0,0,0,0,0,0,0,-100000,0,0,0,0,100000,-100000,-100000
052147,上緯控群益95購01,0,0,0,0,0,0,0,0,0,-100000,0,0,0,0,100000,-100000,-100000
052616,鴻海國泰98購02  ,0,0,0,0,0,0,0,0,0,-100000,0,0,0,118000,218000,-100000,-100000
052463,聯電統一96購01  ,0,0,0,0,0,0,0,0,0,-100000,0,0,0,0,100000,-100000,-100000
052122,新光金國票96購01,0,0,0,0,0,0,0,0,0,-100000,0,0,0,0,100000,-100000,-100000
049888,智邦國泰96購01  ,0,0,0,0,0,0,0,0,0,-100000,0,0,0,64000,164000,-100000,-100000
050975,楠梓電統一95購01,0,0,0,0,0,0,0,0,0,-100000,0,0,0,310000,410000,-100000,-100000
049765,上証2X元富94購01,0,0,0,0,0,0,0,0,0,-100000,0,0,0,0,100000,-100000,-100000
048994,南電元大94購03  ,0,0,0,0,0,0,0,0,0,-100000,0,0,0,0,100000,-100000,-100000
05079P,可成永豐95售01  ,0,0,0,0,0,0,0,0,0,-100000,0,0,0,0,100000,-100000,-100000
051959,台郡台新95購03  ,0,0,0,0,0,0,0,0,0,-100000,0,0,0,10000,110000,-100000,-100000
052079,康友元富98購01  ,0,0,0,0,0,0,0,0,0,-100000,0,0,0,42000,142000,-100000,-100000
051184,聯發科永豐95購03,0,0,0,0,0,0,0,0,0,-100000,0,0,0,0,100000,-100000,-100000
051220,大立光元富95購08,0,0,0,0,0,0,0,0,0,-100000,0,0,0,0,100000,-100000,-100000
051651,易華電永豐95購01,0,0,0,0,0,0,0,0,0,-100000,0,0,0,0,100000,-100000,-100000
054169,上緯控凱基98購01,0,0,0,0,0,0,0,0,0,-100000,0,0,0,1000,101000,-100000,-100000
054164,強茂凱基98購01  ,0,0,0,0,0,0,0,0,0,-100000,0,0,0,0,100000,-100000,-100000
054024,中鋼康和96購01  ,0,0,0,0,0,0,0,0,0,-100000,0,0,0,0,100000,-100000,-100000
05424P,台達電亞東96售02,0,0,0,0,0,0,0,0,0,-100000,0,0,0,0,100000,-100000,-100000
05507P,聯茂凱基96售02  ,0,0,0,0,0,0,0,0,0,-100000,0,0,0,0,100000,-100000,-100000
054996,聯陽元富97購01  ,0,0,0,0,0,0,0,0,0,-100000,0,0,0,10000,110000,-100000,-100000
054997,文曄元富97購01  ,0,0,0,0,0,0,0,0,0,-100000,0,0,0,0,100000,-100000,-100000
053282,彩晶元大9C購01  ,0,0,0,0,0,0,0,0,0,-100000,0,0,0,0,100000,-100000,-100000
052777,燿華國票98購01  ,0,0,0,0,0,0,0,0,0,-100000,0,0,0,24000,124000,-100000,-100000
053346,群創國票97購04  ,0,0,0,0,0,0,0,0,0,-100000,0,0,0,0,100000,-100000,-100000
053366,樺漢國泰98購01  ,0,0,0,0,0,0,0,0,0,-100000,0,0,0,0,100000,-100000,-100000
053735,矽力中信97購01  ,0,0,0,0,0,0,0,0,0,-100000,0,0,0,40000,140000,-100000,-100000
00646,元大S&P500      ,0,0,0,0,0,0,0,0,0,-101000,0,0,0,0,101000,-101000,-101000
051243,微星元大95購01  ,0,0,0,0,0,0,0,0,0,-101000,0,0,0,108000,209000,-101000,-101000
049023,玉晶光群益96購04,0,0,0,0,0,0,0,0,0,-101000,0,0,0,34000,135000,-101000,-101000
048905,旺宏富邦96購01  ,0,0,0,0,0,0,0,0,0,-101000,0,0,0,98000,199000,-101000,-101000
052178,台郡元大96購03  ,0,0,0,0,0,0,0,0,0,-101000,0,0,0,91000,192000,-101000,-101000
055285,華新科元大99購03,0,0,0,0,0,0,0,0,0,-101000,0,0,0,16000,117000,-101000,-101000
3062,建漢            ,74000,176000,-102000,0,0,0,0,0,0,1000,1000,0,1000,0,0,0,-101000
056221,鴻海凱基99購01  ,0,0,0,0,0,0,0,0,0,-102000,0,0,0,0,102000,-102000,-102000
055308,聯發科群益97購04,0,0,0,0,0,0,0,0,0,-102000,0,0,0,103000,205000,-102000,-102000
057133,京鼎凱基98購02  ,0,0,0,0,0,0,0,0,0,-102000,0,0,0,74000,176000,-102000,-102000
056554,GIS凱基99購01   ,0,0,0,0,0,0,0,0,0,-102000,0,0,0,36000,138000,-102000,-102000
04420P,奇鋐永豐94售01  ,0,0,0,0,0,0,0,0,0,-102000,0,0,0,21000,123000,-102000,-102000
04410P,大立光統一94售05,0,0,0,0,0,0,0,0,0,-102000,0,0,0,13000,115000,-102000,-102000
046590,同欣電元大92購02,0,0,0,0,0,0,0,0,0,-102000,0,0,0,0,102000,-102000,-102000
049524,可成兆豐95購02  ,0,0,0,0,0,0,0,0,0,-102000,0,0,0,5000,107000,-102000,-102000
051623,和碩凱基96購02  ,0,0,0,0,0,0,0,0,0,-102000,0,0,0,0,102000,-102000,-102000
053169,貿聯群益97購01  ,0,0,0,0,0,0,0,0,0,-102000,0,0,0,134000,236000,-102000,-102000
055628,旺宏永豐97購01  ,0,0,0,0,0,0,0,0,0,-103000,0,0,0,10000,113000,-103000,-103000
05652P,臻鼎群益96售01  ,0,0,0,0,0,0,0,0,0,-103000,0,0,0,56000,159000,-103000,-103000
056359,旺宏元大9A購01  ,0,0,0,0,0,0,0,0,0,-103000,0,0,0,29000,132000,-103000,-103000
01010T,京城樂富R1      ,0,0,0,0,0,0,0,0,0,-103000,0,103000,-103000,0,0,0,-103000
042994,葡萄王元大94購02,0,0,0,0,0,0,0,0,0,-103000,0,0,0,0,103000,-103000,-103000
051559,宏達電國泰96購01,0,0,0,0,0,0,0,0,0,-103000,0,0,0,112000,215000,-103000,-103000
053358,晶技統一98購01  ,0,0,0,0,0,0,0,0,0,-103000,0,0,0,50000,153000,-103000,-103000
054481,鎧勝中信96購01  ,0,0,0,0,0,0,0,0,0,-103000,0,0,0,17000,120000,-103000,-103000
056460,同欣電凱基99購01,0,0,0,0,0,0,0,0,0,-104000,0,0,0,10000,114000,-104000,-104000
055836,華邦電元大97購04,0,0,0,0,0,0,0,0,0,-104000,0,0,0,46000,150000,-104000,-104000
045883,元油2X元大95購07,0,0,0,0,0,0,0,0,0,-104000,0,0,0,0,104000,-104000,-104000
04726P,TPK凱基94售04   ,0,0,0,0,0,0,0,0,0,-104000,0,0,0,10000,114000,-104000,-104000
049154,玉晶光元大95購02,0,0,0,0,0,0,0,0,0,-104000,0,0,0,9000,113000,-104000,-104000
050825,嘉澤凱基95購01  ,0,0,0,0,0,0,0,0,0,-104000,0,0,0,20000,124000,-104000,-104000
055784,TPK凱基97購02   ,0,0,0,0,0,0,0,0,0,-105000,0,0,0,0,105000,-105000,-105000
055748,GIS元富97購01   ,0,0,0,0,0,0,0,0,0,-105000,0,0,0,2000,107000,-105000,-105000
055450,台積電元富97購01,0,0,0,0,0,0,0,0,0,-105000,0,0,0,98000,203000,-105000,-105000
056672,元油2X元富98購10,0,0,0,0,0,0,0,0,0,-105000,0,0,0,22000,127000,-105000,-105000
046480,群創元富96購01  ,0,0,0,0,0,0,0,0,0,-105000,0,0,0,60000,165000,-105000,-105000
046384,群創凱基98購02  ,0,0,0,0,0,0,0,0,0,-105000,0,0,0,52000,157000,-105000,-105000
052637,欣興凱基97購01  ,0,0,0,0,0,0,0,0,0,-105000,0,0,0,70000,175000,-105000,-105000
051504,TPK統一95購01   ,0,0,0,0,0,0,0,0,0,-105000,0,0,0,0,105000,-105000,-105000
054518,亞光元大97購01  ,0,0,0,0,0,0,0,0,0,-105000,0,0,0,0,105000,-105000,-105000
05370P,矽創元富95售01  ,0,0,0,0,0,0,0,0,0,-105000,0,0,0,6000,111000,-105000,-105000
052962,台積電凱基97購03,0,0,0,0,0,0,0,0,0,-105000,0,0,0,0,105000,-105000,-105000
4919,新唐            ,22000,89000,-67000,0,0,0,0,0,0,-38000,1000,0,1000,0,39000,-39000,-105000
2102,泰豐            ,11000,116000,-105000,0,0,0,0,0,0,0,0,0,0,0,0,0,-105000
1907,永豐餘          ,152000,257000,-105000,0,0,0,0,0,0,0,0,0,0,0,0,0,-105000
8046,南電            ,663000,1004000,-341000,0,0,0,201000,0,201000,35000,117000,8000,109000,28000,102000,-74000,-105000
05796P,臺股指群益96售10,0,0,0,0,0,0,0,0,0,-106000,0,0,0,21000,127000,-106000,-106000
055768,臺股指群益97購06,0,0,0,0,0,0,0,0,0,-106000,0,0,0,44000,150000,-106000,-106000
05583P,訊芯凱基96售01  ,0,0,0,0,0,0,0,0,0,-106000,0,0,0,0,106000,-106000,-106000
055927,南亞科群益97購01,0,0,0,0,0,0,0,0,0,-106000,0,0,0,14000,120000,-106000,-106000
056320,京鼎群益99購01  ,0,0,0,0,0,0,0,0,0,-106000,0,0,0,113000,219000,-106000,-106000
048940,晶相光永豐94購01,0,0,0,0,0,0,0,0,0,-106000,0,0,0,0,106000,-106000,-106000
052283,TPK凱基97購01   ,0,0,0,0,0,0,0,0,0,-106000,0,0,0,0,106000,-106000,-106000
053612,T50反1群益96購01,0,0,0,0,0,0,0,0,0,-106000,0,0,0,1000,107000,-106000,-106000
054277,亞光群益97購01  ,0,0,0,0,0,0,0,0,0,-106000,0,0,0,38000,144000,-106000,-106000
6120,達運            ,52000,159000,-107000,0,0,0,0,0,0,1000,1000,0,1000,0,0,0,-106000
2425,承啟            ,355000,461000,-106000,0,0,0,0,0,0,0,0,0,0,0,0,0,-106000
047325,材料元大93購01  ,0,0,0,0,0,0,0,0,0,-107000,0,0,0,0,107000,-107000,-107000
052423,宏達電國票96購02,0,0,0,0,0,0,0,0,0,-107000,0,0,0,14000,121000,-107000,-107000
051649,中磊永豐95購02  ,0,0,0,0,0,0,0,0,0,-107000,0,0,0,0,107000,-107000,-107000
051718,上証2X永豐95購01,0,0,0,0,0,0,0,0,0,-107000,0,0,0,55000,162000,-107000,-107000
053686,台積電元大97購08,0,0,0,0,0,0,0,0,0,-107000,0,0,0,10000,117000,-107000,-107000
9945,潤泰新          ,139000,224000,-85000,0,0,0,0,0,0,-22000,5000,0,5000,0,27000,-27000,-107000
056308,TPK元大97購02   ,0,0,0,0,0,0,0,0,0,-108000,0,0,0,60000,168000,-108000,-108000
055892,國巨統一99購01  ,0,0,0,0,0,0,0,0,0,-108000,0,0,0,21000,129000,-108000,-108000
05540P,亞德客凱基96售01,0,0,0,0,0,0,0,0,0,-108000,0,0,0,320000,428000,-108000,-108000
055474,欣興凱基97購05  ,0,0,0,0,0,0,0,0,0,-108000,0,0,0,185000,293000,-108000,-108000
046804,群創元大94購01  ,0,0,0,0,0,0,0,0,0,-108000,0,0,0,156000,264000,-108000,-108000
048496,南亞科元大93購05,0,0,0,0,0,0,0,0,0,-108000,0,0,0,60000,168000,-108000,-108000
047973,華通兆豐94購01  ,0,0,0,0,0,0,0,0,0,-108000,0,0,0,70000,178000,-108000,-108000
052577,台積電統一96購01,0,0,0,0,0,0,0,0,0,-108000,0,0,0,0,108000,-108000,-108000
052660,京元電國票97購01,0,0,0,0,0,0,0,0,0,-108000,0,0,0,10000,118000,-108000,-108000
049725,台郡國票94購03  ,0,0,0,0,0,0,0,0,0,-108000,0,0,0,31000,139000,-108000,-108000
052721,友達統一96購01  ,0,0,0,0,0,0,0,0,0,-108000,0,0,0,0,108000,-108000,-108000
049125,禾伸堂元富94購01,0,0,0,0,0,0,0,0,0,-109000,0,0,0,11000,120000,-109000,-109000
051139,康友永豐95購01  ,0,0,0,0,0,0,0,0,0,-109000,0,0,0,0,109000,-109000,-109000
050280,國巨日盛94購01  ,0,0,0,0,0,0,0,0,0,-109000,0,0,0,1000,110000,-109000,-109000
05521P,創意永豐96售01  ,0,0,0,0,0,0,0,0,0,-109000,0,0,0,71000,180000,-109000,-109000
6505,台塑化          ,281000,335000,-54000,0,0,0,0,56000,-56000,1000,1000,0,1000,35000,35000,0,-109000
06459P,亞德客元富98售01,0,0,0,0,0,0,0,0,0,-109000,0,0,0,60000,169000,-109000,-109000
06447P,上銀元大98售01  ,0,0,0,0,0,0,0,0,0,-109000,0,0,0,0,109000,-109000,-109000
055817,京鼎國票99購01  ,0,0,0,0,0,0,0,0,0,-110000,0,0,0,66000,176000,-110000,-110000
056656,華邦電元大98購02,0,0,0,0,0,0,0,0,0,-110000,0,0,0,150000,260000,-110000,-110000
047846,滬深2X統一93購04,0,0,0,0,0,0,0,0,0,-110000,0,0,0,0,110000,-110000,-110000
00675L,富邦臺灣加權正2 ,0,0,0,0,0,0,0,0,0,-110000,0,0,0,5000,115000,-110000,-110000
03146P,台灣50群益03售01,0,0,0,0,0,0,0,0,0,-110000,0,0,0,0,110000,-110000,-110000
046724,聯發科元大93購02,0,0,0,0,0,0,0,0,0,-110000,0,0,0,0,110000,-110000,-110000
050333,鴻海國泰96購06  ,0,0,0,0,0,0,0,0,0,-110000,0,0,0,1000,111000,-110000,-110000
051434,中磊元富95購02  ,0,0,0,0,0,0,0,0,0,-110000,0,0,0,153000,263000,-110000,-110000
051256,中磊元大95購01  ,0,0,0,0,0,0,0,0,0,-110000,0,0,0,20000,130000,-110000,-110000
050947,聯發科群益95購01,0,0,0,0,0,0,0,0,0,-110000,0,0,0,0,110000,-110000,-110000
052113,漢唐中信98購01  ,0,0,0,0,0,0,0,0,0,-110000,0,0,0,10000,120000,-110000,-110000
049902,大立光元富94購05,0,0,0,0,0,0,0,0,0,-110000,0,0,0,0,110000,-110000,-110000
051391,聯發科兆豐95購02,0,0,0,0,0,0,0,0,0,-110000,0,0,0,100000,210000,-110000,-110000
050994,欣興元大96購03  ,0,0,0,0,0,0,0,0,0,-110000,0,0,0,2000,112000,-110000,-110000
055257,景碩統一97購01  ,0,0,0,0,0,0,0,0,0,-110000,0,0,0,6000,116000,-110000,-110000
055214,聯電凱基97購02  ,0,0,0,0,0,0,0,0,0,-110000,0,0,0,173000,283000,-110000,-110000
055010,佐登元富97購01  ,0,350000,-350000,0,0,0,0,0,0,240000,0,0,0,390000,150000,240000,-110000
053548,旺宏凱基96購04  ,0,0,0,0,0,0,0,0,0,-110000,0,0,0,163000,273000,-110000,-110000
1313,聯成            ,151000,261000,-110000,0,0,0,0,0,0,0,0,0,0,0,0,0,-110000
6715,嘉基            ,39000,95000,-56000,0,0,0,0,0,0,-54000,6000,60000,-54000,0,0,0,-110000
055857,嘉聯益元大97購04,0,0,0,0,0,0,0,0,0,-111000,0,0,0,0,111000,-111000,-111000
055673,旺宏日盛97購01  ,0,0,0,0,0,0,0,0,0,-111000,0,0,0,3000,114000,-111000,-111000
056391,大立光富邦9C購01,0,0,0,0,0,0,0,0,0,-111000,0,0,0,0,111000,-111000,-111000
055998,臺股指富邦99購01,0,0,0,0,0,0,0,0,0,-111000,0,0,0,0,111000,-111000,-111000
048217,亞德客凱基93購06,0,0,0,0,0,0,0,0,0,-111000,0,0,0,38000,149000,-111000,-111000
049843,康友中信95購01  ,0,0,0,0,0,0,0,0,0,-111000,0,0,0,14000,125000,-111000,-111000
051307,康舒凱基95購01  ,0,0,0,0,0,0,0,0,0,-111000,0,0,0,249000,360000,-111000,-111000
051676,康舒元大95購01  ,0,0,0,0,0,0,0,0,0,-111000,0,0,0,417000,528000,-111000,-111000
055202,神達群益97購01  ,0,0,0,0,0,0,0,0,0,-111000,0,0,0,241000,352000,-111000,-111000
3018,同開            ,106000,217000,-111000,0,0,0,0,0,0,0,0,0,0,0,0,0,-111000
051907,台積電元大97購05,0,0,0,0,0,0,0,0,0,-112000,0,0,0,10000,122000,-112000,-112000
044487,元油2X元大94購01,0,0,0,0,0,0,0,0,0,-112000,0,0,0,10000,122000,-112000,-112000
051268,創意富邦97購01  ,0,0,0,0,0,0,0,0,0,-112000,0,0,0,53000,165000,-112000,-112000
052153,GIS富邦96購02   ,0,0,0,0,0,0,0,0,0,-112000,0,0,0,0,112000,-112000,-112000
051012,台積電凱基95購04,0,0,0,0,0,0,0,0,0,-112000,0,0,0,100000,212000,-112000,-112000
054478,可成中信97購01  ,0,0,0,0,0,0,0,0,0,-112000,0,0,0,16000,128000,-112000,-112000
3661,世芯-KY         ,1095000,737000,358000,0,0,0,0,509000,-509000,39000,5000,10000,-5000,57000,13000,44000,-112000
057295,可成永豐98購02  ,0,0,0,0,0,0,0,0,0,-113000,0,0,0,15000,128000,-113000,-113000
00728,第一金工業30    ,0,0,0,0,0,0,0,0,0,-113000,0,0,0,534000,647000,-113000,-113000
049240,華通元富94購01  ,0,0,0,0,0,0,0,0,0,-113000,0,0,0,28000,141000,-113000,-113000
047495,新日興元富96購01,0,0,0,0,0,0,0,0,0,-113000,0,0,0,126000,239000,-113000,-113000
049913,微星元大94購01  ,0,0,0,0,0,0,0,0,0,-113000,0,0,0,85000,198000,-113000,-113000
052929,可成元大96購02  ,0,0,0,0,0,0,0,0,0,-113000,0,0,0,0,113000,-113000,-113000
056675,聯發科元富02購01,0,0,0,0,0,0,0,0,0,-114000,0,0,0,0,114000,-114000,-114000
055675,亞德客凱基97購02,0,0,0,0,0,0,0,0,0,-114000,0,0,0,44000,158000,-114000,-114000
055576,嘉晶統一98購01  ,0,0,0,0,0,0,0,0,0,-114000,0,0,0,220000,334000,-114000,-114000
048268,長榮航中信95購01,0,0,0,0,0,0,0,0,0,-114000,0,0,0,0,114000,-114000,-114000
049848,聯發科群益94購06,0,0,0,0,0,0,0,0,0,-114000,0,0,0,165000,279000,-114000,-114000
053387,緯創元大97購01  ,0,0,0,0,0,0,0,0,0,-114000,0,0,0,86000,200000,-114000,-114000
056945,鴻海統一98購12  ,0,0,0,0,0,0,0,0,0,-115000,0,0,0,132000,247000,-115000,-115000
06174P,國巨元大97售07  ,0,0,0,0,0,0,0,0,0,-115000,0,0,0,6000,121000,-115000,-115000
06073P,健策永豐97售01  ,0,0,0,0,0,0,0,0,0,-115000,0,0,0,0,115000,-115000,-115000
048744,儒鴻元富97購01  ,0,0,0,0,0,0,0,0,0,-115000,0,0,0,95000,210000,-115000,-115000
043916,群創凱基93購01  ,0,0,0,0,0,0,0,0,0,-115000,0,0,0,35000,150000,-115000,-115000
051293,鴻海元富95購05  ,0,0,0,0,0,0,0,0,0,-115000,0,0,0,0,115000,-115000,-115000
049392,臺股指麥證94購01,0,0,0,105000,220000,-115000,0,0,0,-115000,0,0,0,105000,220000,-115000,-115000
054469,同欣電凱基97購01,0,0,0,0,0,0,0,0,0,-115000,0,0,0,0,115000,-115000,-115000
06008P,燿華統一96售04  ,0,0,0,0,0,0,0,0,0,-116000,0,0,0,0,116000,-116000,-116000
055667,致茂群益98購01  ,0,0,0,0,0,0,0,0,0,-116000,0,0,0,0,116000,-116000,-116000
00640L,富邦日本正2     ,0,0,0,0,0,0,0,0,0,-116000,0,0,0,408000,524000,-116000,-116000
051840,康友國泰97購02  ,0,0,0,0,0,0,0,0,0,-116000,0,0,0,38000,154000,-116000,-116000
051734,台積電國票95購04,0,0,0,0,0,0,0,0,0,-116000,0,0,0,87000,203000,-116000,-116000
051343,鴻海元大95購07  ,0,0,0,0,0,0,0,0,0,-116000,0,0,0,0,116000,-116000,-116000
1762,中化生          ,110000,233000,-123000,0,0,0,0,0,0,7000,7000,0,7000,0,0,0,-116000
056594,台積電元富98購03,0,0,0,0,0,0,0,0,0,-117000,0,0,0,335000,452000,-117000,-117000
050030,嘉晶元大94購03  ,0,0,0,0,0,0,0,0,0,-117000,0,0,0,483000,600000,-117000,-117000
052428,嘉晶永豐95購01  ,0,0,0,0,0,0,0,0,0,-117000,0,0,0,325000,442000,-117000,-117000
8101,華冠            ,30000,147000,-117000,0,0,0,0,0,0,0,0,0,0,0,0,0,-117000
056962,技嘉永豐98購01  ,0,0,0,0,0,0,0,0,0,-118000,0,0,0,189000,307000,-118000,-118000
055772,致茂凱基97購01  ,0,0,0,0,0,0,0,0,0,-118000,0,0,0,0,118000,-118000,-118000
056267,文曄統一97購02  ,0,0,0,0,0,0,0,0,0,-118000,0,0,0,0,118000,-118000,-118000
051357,可成元大95購05  ,0,0,0,0,0,0,0,0,0,-118000,0,0,0,22000,140000,-118000,-118000
055260,晶相光統一98購01,0,0,0,0,0,0,0,0,0,-118000,0,0,0,20000,138000,-118000,-118000
052766,玉晶光群益9A購01,0,0,0,0,0,0,0,0,0,-118000,0,0,0,21000,139000,-118000,-118000
053081,上銀元大97購02  ,0,0,0,0,0,0,0,0,0,-118000,0,0,0,216000,334000,-118000,-118000
05890P,彩晶元大99售01  ,0,0,0,0,0,0,0,0,0,-119000,0,0,0,22000,141000,-119000,-119000
044934,玉晶光元大93購01,0,0,0,0,0,0,0,0,0,-119000,0,0,0,24000,143000,-119000,-119000
05049P,矽創永豐95售01  ,0,0,0,0,0,0,0,0,0,-119000,0,0,0,0,119000,-119000,-119000
052066,華邦電兆豐96購01,0,0,0,0,0,0,0,0,0,-119000,0,0,0,60000,179000,-119000,-119000
055287,日電貿元大97購01,0,0,0,0,0,0,0,0,0,-119000,0,0,0,262000,381000,-119000,-119000
06658P,台灣50富邦9C售01,0,0,0,0,0,0,0,0,0,-119000,0,0,0,41000,160000,-119000,-119000
2342,茂矽            ,93000,212000,-119000,0,0,0,0,0,0,0,0,0,0,0,0,0,-119000
056797,台積電麥證98購01,0,0,0,10000,130000,-120000,0,0,0,-120000,0,0,0,10000,130000,-120000,-120000
045213,A50正2元大95購01,0,0,0,0,0,0,0,0,0,-120000,0,0,0,30000,150000,-120000,-120000
048503,百和元大93購02  ,0,0,0,0,0,0,0,0,0,-120000,0,0,0,30000,150000,-120000,-120000
049424,中石化兆豐94購01,0,0,0,0,0,0,0,0,0,-120000,0,0,0,0,120000,-120000,-120000
051411,聯發科國票95購05,0,0,0,0,0,0,0,0,0,-120000,0,0,0,50000,170000,-120000,-120000
049155,同欣電元大94購01,0,0,0,0,0,0,0,0,0,-120000,0,0,0,30000,150000,-120000,-120000
052726,鴻海元富96購03  ,0,0,0,0,0,0,0,0,0,-120000,0,0,0,10000,130000,-120000,-120000
054675,美律台新98購01  ,0,0,0,0,0,0,0,0,0,-120000,0,0,0,0,120000,-120000,-120000
054069,亞光國泰98購01  ,0,0,0,0,0,0,0,0,0,-120000,0,0,0,41000,161000,-120000,-120000
053200,華邦電日盛96購01,0,0,0,0,0,0,0,0,0,-120000,0,0,0,0,120000,-120000,-120000
052906,緯創國票97購01  ,0,0,0,0,0,0,0,0,0,-120000,0,0,0,10000,130000,-120000,-120000
053918,美律國票97購01  ,0,0,0,0,0,0,0,0,0,-120000,0,0,0,0,120000,-120000,-120000
1701,中化            ,13000,141000,-128000,0,0,0,0,0,0,8000,8000,0,8000,0,0,0,-120000
057294,台灣50永豐99購01,0,0,0,0,0,0,0,0,0,-121000,0,0,0,0,121000,-121000,-121000
056085,聯發科統一97購01,0,0,0,0,0,0,0,0,0,-121000,0,0,0,0,121000,-121000,-121000
055542,亞德客凱基97購01,0,0,0,0,0,0,0,0,0,-121000,0,0,0,20000,141000,-121000,-121000
047576,技嘉群益94購01  ,0,0,0,0,0,0,0,0,0,-121000,0,0,0,29000,150000,-121000,-121000
046896,臻鼎群益94購01  ,0,0,0,0,0,0,0,0,0,-121000,0,0,0,36000,157000,-121000,-121000
048012,嘉晶國票94購01  ,0,0,0,0,0,0,0,0,0,-121000,0,0,0,16000,137000,-121000,-121000
05089P,亞德客元大95售01,0,0,0,0,0,0,0,0,0,-121000,0,0,0,247000,368000,-121000,-121000
054345,世芯國票96購02  ,0,0,0,0,0,0,0,0,0,-121000,0,0,0,20000,141000,-121000,-121000
056616,台光電永豐98購01,0,0,0,0,0,0,0,0,0,-122000,0,0,0,41000,163000,-122000,-122000
04296P,技嘉元大93售01  ,0,0,0,0,0,0,0,0,0,-122000,0,0,0,700000,822000,-122000,-122000
03635C,滬深2X元富99牛01,0,0,0,0,0,0,0,0,0,-122000,0,0,0,208000,330000,-122000,-122000
054873,帆宣群益99購01  ,0,0,0,0,0,0,0,0,0,-122000,0,0,0,38000,160000,-122000,-122000
054874,帆宣群益99購02  ,0,0,0,0,0,0,0,0,0,-122000,0,0,0,15000,137000,-122000,-122000
06569P,可成永豐98售01  ,0,0,0,0,0,0,0,0,0,-122000,0,0,0,0,122000,-122000,-122000
3338,泰碩            ,70000,183000,-113000,0,0,0,0,0,0,-9000,2000,0,2000,5000,16000,-11000,-122000
056978,技嘉群益99購01  ,0,0,0,0,0,0,0,0,0,-123000,0,0,0,71000,194000,-123000,-123000
056204,嘉澤永豐97購01  ,0,0,0,0,0,0,0,0,0,-123000,0,0,0,0,123000,-123000,-123000
049596,智伸科元大95購01,0,0,0,0,0,0,0,0,0,-123000,0,0,0,0,123000,-123000,-123000
04893P,創意元大94售03  ,0,0,0,0,0,0,0,0,0,-123000,0,0,0,10000,133000,-123000,-123000
053029,國巨第一96購01  ,0,0,0,0,0,0,0,0,0,-123000,0,0,0,162000,285000,-123000,-123000
052533,聯發科國泰96購03,0,0,0,0,0,0,0,0,0,-123000,0,0,0,16000,139000,-123000,-123000
051279,喬山兆豐96購01  ,0,0,0,0,0,0,0,0,0,-123000,0,0,0,0,123000,-123000,-123000
053292,美律中信98購01  ,0,0,0,0,0,0,0,0,0,-123000,0,0,0,43000,166000,-123000,-123000
056291,聯茂永豐97購03  ,0,0,0,0,0,0,0,0,0,-124000,0,0,0,133000,257000,-124000,-124000
05697P,友達凱基96售01  ,0,0,0,0,0,0,0,0,0,-124000,0,0,0,180000,304000,-124000,-124000
051987,廣達元大95購01  ,0,0,0,0,0,0,0,0,0,-124000,0,0,0,0,124000,-124000,-124000
053048,同欣電麥證96購01,0,0,0,254000,378000,-124000,0,0,0,-124000,0,0,0,254000,378000,-124000,-124000
052796,和碩兆豐96購01  ,0,0,0,0,0,0,0,0,0,-124000,0,0,0,48000,172000,-124000,-124000
053324,康舒群益96購01  ,0,0,0,0,0,0,0,0,0,-124000,0,0,0,331000,455000,-124000,-124000
06376P,上銀統一99售01  ,0,0,0,0,0,0,0,0,0,-124000,0,0,0,29000,153000,-124000,-124000
056082,旺宏統一99購02  ,0,0,0,0,0,0,0,0,0,-125000,0,0,0,0,125000,-125000,-125000
052437,聯發科富邦99購02,0,0,0,0,0,0,0,0,0,-125000,0,0,0,0,125000,-125000,-125000
052652,台虹永豐96購01  ,0,0,0,0,0,0,0,0,0,-125000,0,0,0,0,125000,-125000,-125000
053314,A50正2群益9A購01,0,0,0,0,0,0,0,0,0,-125000,0,0,0,499000,624000,-125000,-125000
053840,燿華統一96購02  ,0,0,0,0,0,0,0,0,0,-125000,0,0,0,0,125000,-125000,-125000
06225P,華新科元富97售04,0,0,0,0,0,0,0,0,0,-125000,0,0,0,110000,235000,-125000,-125000
06269P,群創凱基98售10  ,0,0,0,0,0,0,0,0,0,-125000,0,0,0,1000,126000,-125000,-125000
05611P,康控群益96售02  ,0,0,0,0,0,0,0,0,0,-126000,0,0,0,0,126000,-126000,-126000
057107,華新科群益98購06,0,0,0,0,0,0,0,0,0,-126000,0,0,0,655000,781000,-126000,-126000
04412P,欣興元富94售01  ,0,0,0,0,0,0,0,0,0,-126000,0,0,0,25000,151000,-126000,-126000
048351,旺宏台新94購02  ,0,0,0,0,0,0,0,0,0,-126000,0,0,0,10000,136000,-126000,-126000
052572,群創凱基99購01  ,0,0,0,0,0,0,0,0,0,-126000,0,0,0,25000,151000,-126000,-126000
05398P,康控國票96售03  ,0,0,0,0,0,0,0,0,0,-126000,0,0,0,0,126000,-126000,-126000
052231,景碩凱基96購01  ,0,0,0,0,0,0,0,0,0,-126000,0,0,0,4000,130000,-126000,-126000
054834,帆宣中信97購01  ,0,0,0,0,0,0,0,0,0,-126000,0,0,0,0,126000,-126000,-126000
055293,晶相光元大97購01,0,0,0,0,0,0,0,0,0,-126000,0,0,0,13000,139000,-126000,-126000
055107,旺宏凱基98購04  ,0,0,0,0,0,0,0,0,0,-126000,0,0,0,24000,150000,-126000,-126000
055072,康友永豐97購02  ,0,0,0,0,0,0,0,0,0,-127000,0,0,0,0,127000,-127000,-127000
055180,文曄統一97購01  ,0,0,0,0,0,0,0,0,0,-127000,0,0,0,0,127000,-127000,-127000
057325,可成群益9A購01  ,0,0,0,0,0,0,0,0,0,-128000,0,0,0,39000,167000,-128000,-128000
05985P,燿華統一96售03  ,0,0,0,0,0,0,0,0,0,-128000,0,0,0,1000,129000,-128000,-128000
055765,臺股指群益97購03,0,0,0,0,0,0,0,0,0,-128000,0,0,0,15000,143000,-128000,-128000
055697,牧德國票98購01  ,0,0,0,0,0,0,0,0,0,-128000,0,0,0,20000,148000,-128000,-128000
05569P,漢唐統一97售01  ,0,0,0,0,0,0,0,0,0,-128000,0,0,0,0,128000,-128000,-128000
051866,聯發科凱基96購05,0,0,0,0,0,0,0,0,0,-128000,0,0,0,74000,202000,-128000,-128000
050411,聯發科永豐94購05,0,0,0,0,0,0,0,0,0,-128000,0,0,0,0,128000,-128000,-128000
051723,嘉澤永豐95購01  ,0,0,0,0,0,0,0,0,0,-128000,0,0,0,84000,212000,-128000,-128000
6141,柏承            ,80000,208000,-128000,0,0,0,0,0,0,0,0,0,0,0,0,0,-128000
8422,可寧衛          ,58000,186000,-128000,0,0,0,0,0,0,0,0,0,0,0,0,0,-128000
057354,聯鈞統一99購03  ,0,0,0,0,0,0,0,0,0,-129000,0,0,0,46000,175000,-129000,-129000
03959P,義隆元富96售01  ,0,0,0,0,0,0,0,0,0,-129000,0,0,0,30000,159000,-129000,-129000
051419,麗豐國票96購01  ,0,0,0,0,0,0,0,0,0,-129000,0,0,0,0,129000,-129000,-129000
3682,亞太電          ,0,129000,-129000,0,0,0,0,0,0,0,0,0,0,0,0,0,-129000
057328,京鼎群益99購02  ,0,0,0,0,0,0,0,0,0,-130000,0,0,0,42000,172000,-130000,-130000
056994,緯穎兆豐98購02  ,0,0,0,0,0,0,0,0,0,-130000,0,0,0,49000,179000,-130000,-130000
056541,智原凱基98購03  ,0,0,0,0,0,0,0,0,0,-130000,0,0,0,0,130000,-130000,-130000
04475P,欣興元大94售03  ,0,0,0,0,0,0,0,0,0,-130000,0,0,0,55000,185000,-130000,-130000
046954,同欣電國票93購01,0,0,0,0,0,0,0,0,0,-130000,0,0,0,0,130000,-130000,-130000
046793,聯發科元富99購01,0,0,0,0,0,0,0,0,0,-130000,0,0,0,15000,145000,-130000,-130000
048898,晶相光國泰96購01,0,0,0,0,0,0,0,0,0,-130000,0,0,0,188000,318000,-130000,-130000
052446,聯發科元大96購03,0,0,0,0,0,0,0,0,0,-130000,0,0,0,0,130000,-130000,-130000
052444,友訊元大95購01  ,0,0,0,0,0,0,0,0,0,-130000,0,0,0,18000,148000,-130000,-130000
055155,奇力新元大99購01,0,0,0,0,0,0,0,0,0,-130000,0,0,0,11000,141000,-130000,-130000
054794,貿聯群益98購01  ,0,0,0,0,0,0,0,0,0,-130000,0,0,0,180000,310000,-130000,-130000
05409P,京元電元富95售05,0,0,0,0,0,0,0,0,0,-130000,0,0,0,10000,140000,-130000,-130000
052224,楠梓電凱基97購01,0,0,0,0,0,0,0,0,0,-130000,0,0,0,0,130000,-130000,-130000
053696,日月光元大96購05,0,0,0,0,0,0,0,0,0,-130000,0,0,0,0,130000,-130000,-130000
053444,奇力新凱基96購03,0,0,0,0,0,0,0,0,0,-130000,0,0,0,176000,306000,-130000,-130000
03896P,長榮航凱基95售01,0,0,0,0,0,0,0,0,0,-131000,0,0,0,18000,149000,-131000,-131000
054440,TPK台新98購01   ,0,0,0,0,0,0,0,0,0,-131000,0,0,0,0,131000,-131000,-131000
055130,京鼎康和97購01  ,0,0,0,0,0,0,0,0,0,-132000,0,0,0,41000,173000,-132000,-132000
06532P,友達元富98售04  ,0,0,0,0,0,0,0,0,0,-132000,0,0,0,32000,164000,-132000,-132000
055398,超眾統一97購03  ,0,0,0,0,0,0,0,0,0,-133000,0,0,0,65000,198000,-133000,-133000
056762,亞德客元大98購01,0,0,0,0,0,0,0,0,0,-133000,0,0,0,248000,381000,-133000,-133000
04676P,彩晶統一94售03  ,0,0,0,0,0,0,0,0,0,-133000,0,0,0,60000,193000,-133000,-133000
047187,亞光元大94購01  ,0,0,0,0,0,0,0,0,0,-133000,0,0,0,109000,242000,-133000,-133000
051227,技嘉群益97購01  ,0,0,0,0,0,0,0,0,0,-133000,0,0,0,68000,201000,-133000,-133000
051507,彩晶元富95購01  ,0,0,0,0,0,0,0,0,0,-133000,0,0,0,17000,150000,-133000,-133000
050129,聯發科凱基94購11,0,0,0,0,0,0,0,0,0,-133000,0,0,0,134000,267000,-133000,-133000
054082,楠梓電元富96購01,0,0,0,0,0,0,0,0,0,-133000,0,0,0,39000,172000,-133000,-133000
06666P,台積電日盛9A售02,0,0,0,0,0,0,0,0,0,-133000,0,0,0,0,133000,-133000,-133000
057417,國巨凱基9A購03  ,0,0,0,0,0,0,0,0,0,-134000,0,0,0,0,134000,-134000,-134000
055840,南亞科元大97購03,0,0,0,0,0,0,0,0,0,-134000,0,0,0,255000,389000,-134000,-134000
050035,聯茂元大94購07  ,0,0,0,0,0,0,0,0,0,-134000,0,0,0,79000,213000,-134000,-134000
052702,群創國票97購03  ,0,0,0,0,0,0,0,0,0,-134000,0,0,0,0,134000,-134000,-134000
4190,佐登-KY         ,88000,174000,-86000,0,0,0,0,0,0,-48000,2000,0,2000,3000,53000,-50000,-134000
055863,緯穎元大97購05  ,0,0,0,0,0,0,0,0,0,-135000,0,0,0,537000,672000,-135000,-135000
055596,新光金元大9B購02,0,0,0,0,0,0,0,0,0,-135000,0,0,0,0,135000,-135000,-135000
047929,景碩凱基93購03  ,0,0,0,0,0,0,0,0,0,-135000,0,0,0,0,135000,-135000,-135000
046568,臻鼎元富95購01  ,0,0,0,0,0,0,0,0,0,-135000,0,0,0,89000,224000,-135000,-135000
050611,鴻海元大95購02  ,0,0,0,0,0,0,0,0,0,-135000,0,0,0,566000,701000,-135000,-135000
052439,寶成富邦97購01  ,0,0,0,0,0,0,0,0,0,-135000,0,0,0,73000,208000,-135000,-135000
053599,崇越元大96購01  ,0,0,0,0,0,0,0,0,0,-135000,0,0,0,0,135000,-135000,-135000
054853,TPK國票98購02   ,0,0,0,0,0,0,0,0,0,-135000,0,0,0,20000,155000,-135000,-135000
055759,技嘉群益98購02  ,0,0,0,0,0,0,0,0,0,-136000,0,0,0,586000,722000,-136000,-136000
05331P,上証2X國票96售01,0,0,0,0,0,0,0,0,0,-136000,0,0,0,5000,141000,-136000,-136000
055798,聯茂富邦98購01  ,0,0,0,0,0,0,0,0,0,-137000,0,0,0,0,137000,-137000,-137000
056201,華新科永豐98購01,0,0,0,0,0,0,0,0,0,-137000,0,0,0,38000,175000,-137000,-137000
00669R,國泰美國道瓊反1 ,0,0,0,0,0,0,0,0,0,-137000,0,0,0,341000,478000,-137000,-137000
05272P,臻鼎中信97售03  ,0,0,0,0,0,0,0,0,0,-137000,0,0,0,10000,147000,-137000,-137000
054107,上銀凱基97購01  ,0,0,0,0,0,0,0,0,0,-137000,0,0,0,173000,310000,-137000,-137000
6416,瑞祺電通        ,152000,299000,-147000,0,0,0,20000,0,20000,-10000,0,10000,-10000,0,0,0,-137000
057237,群創凱基9B購02  ,0,0,0,0,0,0,0,0,0,-138000,0,0,0,0,138000,-138000,-138000
049812,致伸元大94購03  ,0,0,0,0,0,0,0,0,0,-138000,0,0,0,100000,238000,-138000,-138000
051028,台光電元富95購02,0,0,0,0,0,0,0,0,0,-138000,0,0,0,76000,214000,-138000,-138000
051633,可成國票96購03  ,0,0,0,0,0,0,0,0,0,-138000,0,0,0,108000,246000,-138000,-138000
049515,同欣電凱基94購01,0,0,0,0,0,0,0,0,0,-138000,0,0,0,36000,174000,-138000,-138000
054797,臻鼎群益97購01  ,0,0,0,0,0,0,0,0,0,-138000,0,0,0,21000,159000,-138000,-138000
1560,中砂            ,44000,183000,-139000,0,0,0,0,0,0,1000,1000,0,1000,0,0,0,-138000
06470P,臺股指凱基99售10,0,0,0,0,0,0,0,0,0,-138000,0,0,0,13000,151000,-138000,-138000
055746,同欣電元富97購01,0,0,0,0,0,0,0,0,0,-139000,0,0,0,716000,855000,-139000,-139000
055696,華新科國票98購01,35000,0,35000,0,0,0,0,0,0,-174000,0,0,0,51000,225000,-174000,-139000
048179,臻鼎富邦97購01  ,0,0,0,0,0,0,0,0,0,-139000,0,0,0,0,139000,-139000,-139000
051031,康友元富95購02  ,0,0,0,0,0,0,0,0,0,-139000,0,0,0,9000,148000,-139000,-139000
054138,晶技元大98購02  ,0,0,0,0,0,0,0,0,0,-139000,0,0,0,11000,150000,-139000,-139000
054230,上銀群益96購03  ,0,0,0,0,0,0,0,0,0,-139000,0,0,0,259000,398000,-139000,-139000
4994,傳奇            ,57000,237000,-180000,0,0,0,0,0,0,41000,17000,1000,16000,29000,4000,25000,-139000
056095,臻鼎元富9A購01  ,0,0,0,0,0,0,0,0,0,-140000,0,0,0,0,140000,-140000,-140000
056044,同欣電凱基97購03,0,0,0,0,0,0,0,0,0,-140000,0,0,0,23000,163000,-140000,-140000
056837,國巨元富98購02  ,0,0,0,0,0,0,0,0,0,-140000,0,0,0,2000,142000,-140000,-140000
050350,全新群益94購04  ,0,0,0,0,0,0,0,0,0,-140000,0,0,0,13000,153000,-140000,-140000
053035,台表科兆豐97購01,0,0,0,0,0,0,0,0,0,-140000,0,0,0,134000,274000,-140000,-140000
054349,同欣電國票97購02,0,0,0,0,0,0,0,0,0,-140000,0,0,0,12000,152000,-140000,-140000
054975,福懋科元大97購01,0,0,0,0,0,0,0,0,0,-140000,0,0,0,486000,626000,-140000,-140000
053311,同欣電凱基96購01,0,0,0,0,0,0,0,0,0,-140000,0,0,0,90000,230000,-140000,-140000
5264,鎧勝-KY         ,105000,230000,-125000,0,0,0,0,0,0,-15000,0,7000,-7000,0,8000,-8000,-140000
2489,瑞軒            ,124000,266000,-142000,0,0,0,0,0,0,2000,2000,0,2000,0,0,0,-140000
1604,聲寶            ,12000,153000,-141000,0,0,0,0,0,0,1000,1000,0,1000,0,0,0,-140000
055938,矽力群益97購01  ,0,0,0,0,0,0,0,0,0,-141000,0,0,0,309000,450000,-141000,-141000
043231,鴻海中信95購01  ,0,0,0,0,0,0,0,0,0,-141000,0,0,0,0,141000,-141000,-141000
053641,正文永豐96購01  ,0,0,0,0,0,0,0,0,0,-141000,0,0,0,0,141000,-141000,-141000
054925,神達凱基97購01  ,0,0,0,0,0,0,0,0,0,-141000,0,0,0,43000,184000,-141000,-141000
054528,台光電統一96購02,0,0,0,0,0,0,0,0,0,-141000,0,0,0,73000,214000,-141000,-141000
055910,瑞昱凱基98購01  ,0,0,0,0,0,0,0,0,0,-142000,0,0,0,116000,258000,-142000,-142000
046196,欣興凱基92購04  ,0,0,0,0,0,0,0,0,0,-142000,0,0,0,8000,150000,-142000,-142000
052595,奇力新群益96購01,0,0,0,0,0,0,0,0,0,-142000,0,0,0,292000,434000,-142000,-142000
05418P,瑞昱永豐95售02  ,0,0,0,0,0,0,0,0,0,-142000,0,0,0,0,142000,-142000,-142000
053532,台積電永豐96購03,0,0,0,0,0,0,0,0,0,-142000,0,0,0,0,142000,-142000,-142000
056054,亞德客元大97購05,0,0,0,0,0,0,0,0,0,-143000,0,0,0,71000,214000,-143000,-143000
055973,亞德客統一97購01,0,0,0,0,0,0,0,0,0,-143000,0,0,0,86000,229000,-143000,-143000
055942,臺股指群益9C購01,0,0,0,0,0,0,0,0,0,-143000,0,0,0,12000,155000,-143000,-143000
056935,華新科元富98購02,0,0,0,0,0,0,0,0,0,-143000,0,0,0,155000,298000,-143000,-143000
044850,南亞科統一94購01,0,0,0,0,0,0,0,0,0,-143000,0,0,0,0,143000,-143000,-143000
051843,聯發科富邦99購01,0,0,0,0,0,0,0,0,0,-143000,0,0,0,414000,557000,-143000,-143000
053993,旺宏群益98購02  ,0,0,0,0,0,0,0,0,0,-143000,0,0,0,109000,252000,-143000,-143000
047968,南電國泰94購01  ,0,0,0,0,0,0,0,0,0,-144000,0,0,0,50000,194000,-144000,-144000
053567,群創富邦97購01  ,0,0,0,0,0,0,0,0,0,-144000,0,0,0,10000,154000,-144000,-144000
052942,聯發科中信97購04,0,0,0,0,0,0,0,0,0,-144000,0,0,0,17000,161000,-144000,-144000
055495,長榮航元大97購01,0,0,0,0,0,0,0,0,0,-145000,0,0,0,15000,160000,-145000,-145000
04496P,國巨國泰96售02  ,0,0,0,0,0,0,0,0,0,-145000,0,0,0,0,145000,-145000,-145000
054280,牧德群益98購01  ,0,0,0,0,0,0,0,0,0,-145000,0,0,0,48000,193000,-145000,-145000
054532,強茂國泰98購01  ,0,0,0,0,0,0,0,0,0,-145000,0,0,0,48000,193000,-145000,-145000
9911,櫻花            ,116000,261000,-145000,0,0,0,0,0,0,0,0,0,0,0,0,0,-145000
048059,欣興國泰95購01  ,0,0,0,0,0,0,0,0,0,-146000,0,0,0,82000,228000,-146000,-146000
053384,聯發科元大96購13,0,0,0,0,0,0,0,0,0,-146000,0,0,0,696000,842000,-146000,-146000
053851,鴻海國泰98購03  ,0,0,0,0,0,0,0,0,0,-146000,0,0,0,10000,156000,-146000,-146000
053917,友達國票97購03  ,0,0,0,0,0,0,0,0,0,-146000,0,0,0,3000,149000,-146000,-146000
03638C,T50反1元大94牛03,0,0,0,0,0,0,0,0,0,-147000,0,0,0,171000,318000,-147000,-147000
053614,台積電群益96購08,0,0,0,0,0,0,0,0,0,-147000,0,0,0,0,147000,-147000,-147000
053283,同欣電元大96購03,0,0,0,0,0,0,0,0,0,-147000,0,0,0,127000,274000,-147000,-147000
052979,上銀元大96購02  ,0,0,0,0,0,0,0,0,0,-147000,0,0,0,196000,343000,-147000,-147000
055171,凱美統一97購01  ,0,0,0,0,0,0,0,0,0,-147000,0,0,0,30000,177000,-147000,-147000
6213,聯茂            ,635000,585000,50000,0,0,0,47000,250000,-203000,6000,125000,18000,107000,37000,138000,-101000,-147000
054986,藍天元富97購01  ,0,0,0,0,0,0,0,0,0,-148000,0,0,0,0,148000,-148000,-148000
054402,康控永豐96購03  ,0,0,0,0,0,0,0,0,0,-148000,0,0,0,190000,338000,-148000,-148000
050558,台積電統一94購14,0,0,0,0,0,0,0,0,0,-149000,0,0,0,0,149000,-149000,-149000
055851,智原元大98購01  ,0,0,0,0,0,0,0,0,0,-150000,0,0,0,0,150000,-150000,-150000
056125,旺宏國票98購02  ,0,0,0,0,0,0,0,0,0,-150000,0,0,0,52000,202000,-150000,-150000
056791,嘉聯益群益98購01,0,0,0,0,0,0,0,0,0,-150000,0,0,0,42000,192000,-150000,-150000
056782,鴻海群益98購04  ,0,0,0,0,0,0,0,0,0,-150000,0,0,0,27000,177000,-150000,-150000
04534P,臻鼎元富94售03  ,0,0,0,0,0,0,0,0,0,-150000,0,0,0,0,150000,-150000,-150000
04750P,臺股指元大94售26,0,0,0,0,0,0,0,0,0,-150000,0,0,0,150000,300000,-150000,-150000
047379,元油2X元大96購03,0,0,0,0,0,0,0,0,0,-150000,0,0,0,0,150000,-150000,-150000
047642,宏達電元大93購08,0,0,0,0,0,0,0,0,0,-150000,0,0,0,0,150000,-150000,-150000
051981,南茂凱基96購01  ,0,0,0,0,0,0,0,0,0,-150000,0,0,0,0,150000,-150000,-150000
049935,南電元大94購08  ,0,0,0,0,0,0,0,0,0,-150000,0,0,0,4000,154000,-150000,-150000
051372,樺漢富邦96購01  ,0,0,0,0,0,0,0,0,0,-150000,0,0,0,0,150000,-150000,-150000
054081,聯電元富96購01  ,50000,0,50000,0,0,0,0,0,0,-200000,0,0,0,175000,375000,-200000,-150000
054923,晶技凱基98購01  ,0,0,0,0,0,0,0,0,0,-150000,0,0,0,0,150000,-150000,-150000
055242,道瓊銀統一98購01,0,0,0,0,0,0,0,0,0,-150000,0,0,0,0,150000,-150000,-150000
053298,SP黃豆凱基99購01,0,0,0,0,0,0,0,0,0,-150000,0,0,0,0,150000,-150000,-150000
052860,旺宏凱基96購03  ,0,0,0,0,0,0,0,0,0,-150000,0,0,0,0,150000,-150000,-150000
052762,欣興群益96購01  ,0,0,0,0,0,0,0,0,0,-150000,0,0,0,2000,152000,-150000,-150000
047207,晶技國泰94購01  ,0,0,0,0,0,0,0,0,0,-151000,0,0,0,29000,180000,-151000,-151000
047897,可成群益94購01  ,0,0,0,0,0,0,0,0,0,-151000,0,0,0,101000,252000,-151000,-151000
045053,聯發科元富98購01,0,0,0,0,0,0,0,0,0,-151000,0,0,0,520000,671000,-151000,-151000
050091,喬山永豐94購02  ,0,0,0,0,0,0,0,0,0,-151000,0,0,0,0,151000,-151000,-151000
054577,世芯元大98購01  ,0,0,0,0,0,0,0,0,0,-151000,0,0,0,30000,181000,-151000,-151000
06457P,玉晶光統一98售02,0,0,0,0,0,0,0,0,0,-151000,0,0,0,0,151000,-151000,-151000
00730,富邦臺灣優質高息,0,0,0,0,0,0,0,0,0,-152000,0,0,0,154000,306000,-152000,-152000
051598,瑞昱兆豐95購01  ,0,0,0,0,0,0,0,0,0,-152000,0,0,0,0,152000,-152000,-152000
054232,台積電群益96購12,0,0,0,0,0,0,0,0,0,-152000,0,0,0,10000,162000,-152000,-152000
057131,奇力新凱基98購05,0,0,0,0,0,0,0,0,0,-153000,0,0,0,62000,215000,-153000,-153000
048276,旺宏永豐94購01  ,0,0,0,0,0,0,0,0,0,-153000,0,0,0,25000,178000,-153000,-153000
056057,華邦電元大97購05,0,0,0,0,0,0,0,0,0,-154000,0,0,0,0,154000,-154000,-154000
048178,上銀富邦95購02  ,0,0,0,0,0,0,0,0,0,-154000,0,0,0,36000,190000,-154000,-154000
046934,智邦元富96購01  ,0,0,0,0,0,0,0,0,0,-154000,0,0,0,0,154000,-154000,-154000
051845,世紀鋼富邦96購01,0,0,0,0,0,0,0,0,0,-154000,0,0,0,106000,260000,-154000,-154000
054971,帆宣元大97購02  ,0,0,0,0,0,0,0,0,0,-154000,0,0,0,162000,316000,-154000,-154000
053464,喬山元大96購01  ,0,0,0,0,0,0,0,0,0,-154000,0,0,0,95000,249000,-154000,-154000
06629P,台灣50第一98售01,0,0,0,0,0,0,0,0,0,-154000,0,0,0,89000,243000,-154000,-154000
8482,商億-KY         ,31000,185000,-154000,0,0,0,0,0,0,0,0,0,0,0,0,0,-154000
8213,志超            ,49000,198000,-149000,0,0,0,0,0,0,-5000,0,0,0,0,5000,-5000,-154000
055792,臺股指凱基97購15,0,0,0,0,0,0,0,0,0,-156000,0,0,0,0,156000,-156000,-156000
046968,台積電群益94購03,0,0,0,0,0,0,0,0,0,-156000,0,0,0,21000,177000,-156000,-156000
048595,儒鴻國票96購01  ,0,0,0,0,0,0,0,0,0,-156000,0,0,0,28000,184000,-156000,-156000
04162P,南亞科統一94售02,0,0,0,0,0,0,0,0,0,-156000,0,0,0,0,156000,-156000,-156000
050451,嘉晶元大95購01  ,0,0,0,0,0,0,0,0,0,-156000,0,0,0,785000,941000,-156000,-156000
052669,群創群益98購06  ,0,0,0,0,0,0,0,0,0,-156000,0,0,0,38000,194000,-156000,-156000
053670,台積電統一96購09,0,0,0,0,0,0,0,0,0,-156000,0,0,0,0,156000,-156000,-156000
06641P,智邦兆豐99售01  ,0,0,0,0,0,0,0,0,0,-156000,0,0,0,0,156000,-156000,-156000
1315,達新            ,203000,343000,-140000,0,0,0,0,0,0,-16000,0,16000,-16000,0,0,0,-156000
5215,科嘉-KY         ,25000,72000,-47000,0,0,0,0,109000,-109000,0,0,0,0,0,0,0,-156000
048062,南亞科統一93購05,0,0,0,0,0,0,0,0,0,-157000,0,0,0,5000,162000,-157000,-157000
052343,同欣電凱基95購03,0,0,0,0,0,0,0,0,0,-157000,0,0,0,124000,281000,-157000,-157000
055434,樺漢群益97購01  ,0,0,0,0,0,0,0,0,0,-158000,0,0,0,104000,262000,-158000,-158000
053677,同欣電國泰97購01,0,0,0,0,0,0,0,0,0,-158000,0,0,0,0,158000,-158000,-158000
053761,健策國泰98購01  ,0,0,0,0,0,0,0,0,0,-158000,0,0,0,933000,1091000,-158000,-158000
055348,旺宏凱基97購01  ,0,0,0,0,0,0,0,0,0,-159000,0,0,0,1000,160000,-159000,-159000
050205,牧德群益94購02  ,0,0,0,0,0,0,0,0,0,-159000,0,0,0,13000,172000,-159000,-159000
054571,楠梓電元大99購01,0,0,0,0,0,0,0,0,0,-159000,0,0,0,439000,598000,-159000,-159000
056007,上銀中信97購02  ,0,0,0,0,0,0,0,0,0,-160000,0,0,0,120000,280000,-160000,-160000
047514,亞光國票94購01  ,0,0,0,0,0,0,0,0,0,-160000,0,0,0,40000,200000,-160000,-160000
047788,欣興群益93購05  ,0,0,0,0,0,0,0,0,0,-160000,0,0,0,499000,659000,-160000,-160000
051916,和碩元大95購02  ,0,0,0,0,0,0,0,0,0,-160000,0,0,0,20000,180000,-160000,-160000
054733,鴻海凱基98購04  ,0,0,0,0,0,0,0,0,0,-160000,0,0,0,0,160000,-160000,-160000
053452,臺股指凱基97購01,0,0,0,0,0,0,0,0,0,-160000,0,0,0,6000,166000,-160000,-160000
053513,義隆群益96購05  ,0,0,0,0,0,0,0,0,0,-160000,0,0,0,0,160000,-160000,-160000
052200,台光電統一95購02,0,0,0,0,0,0,0,0,0,-160000,0,0,0,0,160000,-160000,-160000
053190,聯發科統一99購01,0,0,0,0,0,0,0,0,0,-160000,0,0,0,50000,210000,-160000,-160000
056896,南亞科元大98購01,0,0,0,0,0,0,0,0,0,-161000,0,0,0,33000,194000,-161000,-161000
05766P,A50正2凱基99售01,0,0,0,0,0,0,0,0,0,-161000,0,0,0,101000,262000,-161000,-161000
051473,台積電凱基95購10,0,0,0,0,0,0,0,0,0,-161000,0,0,0,0,161000,-161000,-161000
052676,聯發科永昌98購01,0,0,0,0,0,0,0,0,0,-161000,0,0,0,127000,288000,-161000,-161000
053587,京元電元大98購01,0,0,0,0,0,0,0,0,0,-161000,0,0,0,17000,178000,-161000,-161000
053813,友達群益9A購03  ,0,0,0,0,0,0,0,0,0,-161000,0,0,0,165000,326000,-161000,-161000
054967,神達元大97購01  ,0,0,0,0,0,0,0,0,0,-161000,0,0,0,332000,493000,-161000,-161000
1215,卜蜂            ,63000,227000,-164000,0,0,0,0,0,0,3000,0,0,0,3000,0,3000,-161000
053039,聯發科凱基96購11,0,0,0,0,0,0,0,0,0,-162000,0,0,0,25000,187000,-162000,-162000
051315,同欣電麥證95購01,0,0,0,414000,576000,-162000,0,0,0,-162000,0,0,0,414000,576000,-162000,-162000
050765,鴻海元大96購02  ,0,0,0,0,0,0,0,0,0,-162000,0,0,0,713000,875000,-162000,-162000
2505,國揚            ,125000,246000,-121000,0,0,0,0,0,0,-41000,0,0,0,2000,43000,-41000,-162000
056050,晶技國票98購01  ,0,0,0,0,0,0,0,0,0,-163000,0,0,0,31000,194000,-163000,-163000
054544,統一中信97購01  ,0,0,0,0,0,0,0,0,0,-163000,0,0,0,6000,169000,-163000,-163000
054818,奇力新元大97購05,0,0,0,0,0,0,0,0,0,-164000,0,0,0,18000,182000,-164000,-164000
2537,聯上發          ,10000,174000,-164000,0,0,0,0,0,0,0,0,0,0,0,0,0,-164000
2419,仲琦            ,47000,212000,-165000,0,0,0,0,0,0,1000,1000,0,1000,0,0,0,-164000
3380,明泰            ,151000,188000,-37000,0,0,0,0,0,0,-127000,53000,0,53000,4000,184000,-180000,-164000
06410P,祥碩統一97售01  ,0,0,0,0,0,0,0,0,0,-164000,0,0,0,216000,380000,-164000,-164000
055940,致新群益98購01  ,0,0,0,0,0,0,0,0,0,-165000,0,0,0,8000,173000,-165000,-165000
056279,新日興富邦99購01,0,0,0,0,0,0,0,0,0,-165000,0,0,0,88000,253000,-165000,-165000
057240,茂林凱基9A購01  ,0,0,0,0,0,0,0,0,0,-165000,0,0,0,1000,166000,-165000,-165000
051871,同欣電凱基95購02,0,0,0,0,0,0,0,0,0,-165000,0,0,0,26000,191000,-165000,-165000
04782P,智伸科統一96售01,0,0,0,0,0,0,0,0,0,-165000,0,0,0,13000,178000,-165000,-165000
042168,台灣50凱基96購01,0,0,0,0,0,0,0,0,0,-165000,0,0,0,0,165000,-165000,-165000
04235P,鴻海群益93售08  ,0,0,0,0,0,0,0,0,0,-165000,0,0,0,60000,225000,-165000,-165000
052114,華固中信95購01  ,0,0,0,0,0,0,0,0,0,-165000,0,0,0,0,165000,-165000,-165000
052103,台積電兆豐95購06,0,0,0,0,0,0,0,0,0,-165000,0,0,0,4000,169000,-165000,-165000
049782,世紀鋼統一94購01,0,0,0,0,0,0,0,0,0,-165000,0,0,0,0,165000,-165000,-165000
054684,裕隆永豐97購01  ,0,0,0,0,0,0,0,0,0,-165000,0,0,0,84000,249000,-165000,-165000
053106,鴻海兆豐98購01  ,0,0,0,0,0,0,0,0,0,-165000,0,0,0,0,165000,-165000,-165000
052731,宏達電國泰98購01,0,0,0,0,0,0,0,0,0,-165000,0,0,0,59000,224000,-165000,-165000
06030P,友達兆豐96售02  ,0,0,0,0,0,0,0,0,0,-166000,0,0,0,25000,191000,-166000,-166000
056846,晶相光元富98購01,0,0,0,0,0,0,0,0,0,-166000,0,0,0,120000,286000,-166000,-166000
056545,TPK凱基98購02   ,0,0,0,0,0,0,0,0,0,-166000,0,0,0,72000,238000,-166000,-166000
05301P,矽力元大95售02  ,0,0,0,0,0,0,0,0,0,-166000,0,0,0,0,166000,-166000,-166000
052867,晶技凱基96購01  ,0,0,0,0,0,0,0,0,0,-166000,0,0,0,145000,311000,-166000,-166000
055391,光罩統一97購02  ,0,0,0,0,0,0,0,0,0,-167000,0,0,0,562000,729000,-167000,-167000
053057,聯電國泰97購02  ,0,0,0,0,0,0,0,0,0,-167000,0,0,0,13000,180000,-167000,-167000
052132,旺宏凱基9B購01  ,0,0,0,0,0,0,0,0,0,-167000,0,0,0,73000,240000,-167000,-167000
048935,玉晶光永豐94購04,0,0,0,0,0,0,0,0,0,-167000,0,0,0,64000,231000,-167000,-167000
053187,國巨統一96購05  ,0,0,0,0,0,0,0,0,0,-167000,0,0,0,72000,239000,-167000,-167000
052130,國巨凱基9B購01  ,0,0,0,0,0,0,0,0,0,-168000,0,0,0,50000,218000,-168000,-168000
055046,上銀永豐97購01  ,0,0,0,0,0,0,0,0,0,-168000,0,0,0,82000,250000,-168000,-168000
6230,超眾            ,57000,190000,-133000,0,0,0,0,64000,-64000,29000,23000,1000,22000,22000,15000,7000,-168000
2838,聯邦銀          ,218000,386000,-168000,0,0,0,0,0,0,0,0,0,0,0,0,0,-168000
056637,台光電日盛9A購01,0,0,0,0,0,0,0,0,0,-169000,0,0,0,216000,385000,-169000,-169000
054122,康友永豐96購01  ,0,0,0,0,0,0,0,0,0,-169000,0,0,0,9000,178000,-169000,-169000
03888P,大立光元富93售03,0,0,0,0,0,0,0,0,0,-170000,0,0,0,0,170000,-170000,-170000
054155,美律第一96購01  ,0,0,0,0,0,0,0,0,0,-170000,0,0,0,0,170000,-170000,-170000
054350,美律國泰98購01  ,0,0,0,0,0,0,0,0,0,-170000,0,0,0,0,170000,-170000,-170000
053228,康友台新97購01  ,0,0,0,0,0,0,0,0,0,-170000,0,0,0,0,170000,-170000,-170000
048640,南亞科元大93購06,0,0,0,0,0,0,0,0,0,-171000,0,0,0,0,171000,-171000,-171000
052936,華通兆豐98購01  ,0,0,0,0,0,0,0,0,0,-171000,0,0,0,14000,185000,-171000,-171000
054661,嘉聯益元大97購03,0,0,0,0,0,0,0,0,0,-171000,0,0,0,82000,253000,-171000,-171000
055684,京鼎凱基97購01  ,0,0,0,0,0,0,0,0,0,-172000,0,0,0,62000,234000,-172000,-172000
051222,世紀鋼元富95購01,0,0,0,0,0,0,0,0,0,-172000,0,0,0,197000,369000,-172000,-172000
054992,南亞科元富97購02,0,0,0,0,0,0,0,0,0,-172000,0,0,0,86000,258000,-172000,-172000
052233,台郡凱基96購01  ,0,0,0,0,0,0,0,0,0,-172000,0,0,0,373000,545000,-172000,-172000
053557,聯茂凱基96購04  ,0,0,0,0,0,0,0,0,0,-172000,0,0,0,0,172000,-172000,-172000
056536,義隆凱基98購04  ,0,0,0,0,0,0,0,0,0,-173000,0,0,0,47000,220000,-173000,-173000
052013,台積電永豐95購04,0,0,0,0,0,0,0,0,0,-173000,0,0,0,440000,613000,-173000,-173000
055362,GIS凱基97購03   ,0,0,0,0,0,0,0,0,0,-174000,0,0,0,18000,192000,-174000,-174000
053051,楠梓電國票97購01,0,0,0,0,0,0,0,0,0,-174000,0,0,0,22000,196000,-174000,-174000
053619,和碩群益96購01  ,0,0,0,0,0,0,0,0,0,-174000,0,0,0,226000,400000,-174000,-174000
06157P,聯鈞統一97售02  ,0,0,0,0,0,0,0,0,0,-175000,0,0,0,28000,203000,-175000,-175000
04935P,鴻海中信96售01  ,0,0,0,0,0,0,0,0,0,-175000,0,0,0,0,175000,-175000,-175000
053976,亞光元大96購02  ,0,0,0,0,0,0,0,0,0,-175000,0,0,0,100000,275000,-175000,-175000
052764,景碩群益98購01  ,0,0,0,0,0,0,0,0,0,-175000,0,0,0,38000,213000,-175000,-175000
054633,臺股指凱基9A購02,0,0,0,0,0,0,0,0,0,-175000,0,0,0,16000,191000,-175000,-175000
056483,TPK元大98購01   ,0,0,0,0,0,0,0,0,0,-176000,0,0,0,45000,221000,-176000,-176000
053610,矽力中信98購01  ,0,0,0,0,0,0,0,0,0,-176000,0,0,0,90000,266000,-176000,-176000
06304P,臺股指元大97售10,0,0,0,0,0,0,0,0,0,-176000,0,0,0,0,176000,-176000,-176000
048666,康控統一93購01  ,0,0,0,0,0,0,0,0,0,-177000,0,0,0,5000,182000,-177000,-177000
051240,台積電元大95購12,0,0,0,0,0,0,0,0,0,-177000,0,0,0,323000,500000,-177000,-177000
1303,南亞            ,652000,829000,-177000,0,0,0,1000,0,1000,-1000,1000,2000,-1000,0,0,0,-177000
6669,緯穎            ,371800,417000,-45200,0,0,0,4000,18000,-14000,-118000,3000,6000,-3000,35000,150000,-115000,-177200
055392,凱美統一97購03  ,0,0,0,0,0,0,0,0,0,-178000,0,0,0,157000,335000,-178000,-178000
055421,玉晶光永豐98購04,0,0,0,0,0,0,0,0,0,-178000,0,0,0,184000,362000,-178000,-178000
056901,華新科元大98購03,0,0,0,0,0,0,0,0,0,-178000,0,0,0,10000,188000,-178000,-178000
051297,台積電凱基95購07,0,0,0,0,0,0,0,0,0,-178000,0,0,0,57000,235000,-178000,-178000
055048,台積電永豐97購04,0,0,0,0,0,0,0,0,0,-178000,0,0,0,79000,257000,-178000,-178000
3044,健鼎            ,162000,380000,-218000,0,0,0,0,0,0,40000,74000,4000,70000,0,30000,-30000,-178000
053251,世紀鋼國票97購02,0,0,0,0,0,0,0,0,0,-179000,0,0,0,80000,259000,-179000,-179000
2101,南港            ,352000,477000,-125000,0,0,0,0,0,0,-54000,0,41000,-41000,3000,16000,-13000,-179000
05718P,國巨元大96售09  ,0,0,0,0,0,0,0,0,0,-180000,0,0,0,40000,220000,-180000,-180000
04950P,上証2X中信96售02,0,0,0,0,0,0,0,0,0,-180000,0,0,0,100000,280000,-180000,-180000
049774,元油2X統一94購05,0,0,0,0,0,0,0,0,0,-180000,0,0,0,0,180000,-180000,-180000
053217,群創凱基99購02  ,0,0,0,0,0,0,0,0,0,-180000,0,0,0,0,180000,-180000,-180000
054704,玉晶光第一97購01,0,0,0,0,0,0,0,0,0,-180000,0,0,0,20000,200000,-180000,-180000
4137,麗豐-KY         ,105000,287000,-182000,0,0,0,0,0,0,2000,0,0,0,2000,0,2000,-180000
056165,矽力凱基98購02  ,0,0,0,0,0,0,0,0,0,-181000,0,0,0,208000,389000,-181000,-181000
046972,同欣電群益93購01,0,0,0,0,0,0,0,0,0,-181000,0,0,0,0,181000,-181000,-181000
045086,玉晶光元大94購02,0,0,0,0,0,0,0,0,0,-181000,0,0,0,7000,188000,-181000,-181000
055005,晶相光元富97購01,0,0,0,0,0,0,0,0,0,-181000,0,0,0,10000,191000,-181000,-181000
052917,大立光富邦99購02,0,0,0,0,0,0,0,0,0,-182000,0,0,0,52000,234000,-182000,-182000
06379P,群創統一97售05  ,0,0,0,0,0,0,0,0,0,-182000,0,0,0,404000,586000,-182000,-182000
057348,台積電統一98購09,0,0,0,0,0,0,0,0,0,-183000,0,0,0,0,183000,-183000,-183000
049744,亞德客永豐94購01,0,0,0,0,0,0,0,0,0,-183000,0,0,0,112000,295000,-183000,-183000
00662,富邦NASDAQ      ,1000,24000,-23000,0,0,0,0,0,0,-161000,0,0,0,1000,162000,-161000,-184000
055154,聯發科元大98購01,0,0,0,0,0,0,0,0,0,-184000,0,0,0,264000,448000,-184000,-184000
6558,興能高          ,48000,72000,-24000,0,0,0,0,160000,-160000,0,0,0,0,0,0,0,-184000
049655,臺股指凱基94購16,0,0,0,0,0,0,0,0,0,-185000,0,0,0,5000,190000,-185000,-185000
049079,聯發科凱基94購04,0,0,0,0,0,0,0,0,0,-185000,0,0,0,200000,385000,-185000,-185000
051911,大立光元大98購02,0,0,0,0,0,0,0,0,0,-185000,0,0,0,253000,438000,-185000,-185000
054681,味全永豐97購01  ,0,0,0,0,0,0,0,0,0,-185000,0,0,0,0,185000,-185000,-185000
057202,TPK元富98購02   ,0,0,0,0,0,0,0,0,0,-186000,0,0,0,10000,196000,-186000,-186000
055638,上銀元富97購01  ,0,0,0,0,0,0,0,0,0,-186000,0,0,0,103000,289000,-186000,-186000
04792P,智邦元大94售06  ,0,0,0,0,0,0,0,0,0,-186000,0,0,0,123000,309000,-186000,-186000
051438,喬山元大95購03  ,0,0,0,0,0,0,0,0,0,-186000,0,0,0,3000,189000,-186000,-186000
051939,同欣電群益97購01,0,0,0,0,0,0,0,0,0,-186000,0,0,0,293000,479000,-186000,-186000
054372,南亞科中信96購01,0,0,0,0,0,0,0,0,0,-186000,0,0,0,5000,191000,-186000,-186000
055008,隆達元富97購01  ,0,0,0,0,0,0,0,0,0,-186000,0,0,0,134000,320000,-186000,-186000
053074,嘉晶永豐96購02  ,0,0,0,0,0,0,0,0,0,-186000,0,0,0,160000,346000,-186000,-186000
05347P,滬深2X元富9B售02,0,0,0,0,0,0,0,0,0,-186000,0,0,0,539000,725000,-186000,-186000
053373,台泥元大96購01  ,0,0,0,0,0,0,0,0,0,-186000,0,0,0,0,186000,-186000,-186000
053978,創意元大96購05  ,0,0,0,0,0,0,0,0,0,-186000,0,0,0,200000,386000,-186000,-186000
04703P,樺漢統一95售01  ,0,0,0,0,0,0,0,0,0,-188000,0,0,0,0,188000,-188000,-188000
047663,亞德客永豐93購03,0,0,0,0,0,0,0,0,0,-188000,0,0,0,72000,260000,-188000,-188000
049108,玉晶光富邦96購02,0,0,0,0,0,0,0,0,0,-188000,0,0,0,85000,273000,-188000,-188000
050792,可成富邦96購01  ,0,0,0,0,0,0,0,0,0,-188000,0,0,0,77000,265000,-188000,-188000
049576,元油2X元大94購06,0,0,0,0,0,0,0,0,0,-188000,0,0,0,2000,190000,-188000,-188000
053915,光罩國票96購02  ,0,0,0,0,0,0,0,0,0,-188000,0,0,0,10000,198000,-188000,-188000
054970,帆宣元大97購01  ,0,0,0,0,0,0,0,0,0,-188000,0,0,0,94000,282000,-188000,-188000
054141,TPK元大96購02   ,0,0,0,0,0,0,0,0,0,-188000,0,0,0,0,188000,-188000,-188000
051923,聯發科日盛95購02,0,0,0,0,0,0,0,0,0,-189000,0,0,0,61000,250000,-189000,-189000
8028,昇陽半導體      ,126000,181000,-55000,0,0,0,0,0,0,-134000,2000,1000,1000,16000,151000,-135000,-189000
05749P,臺股指群益99售03,0,0,0,0,0,0,0,0,0,-190000,0,0,0,105000,295000,-190000,-190000
2915,潤泰全          ,185000,289000,-104000,0,0,0,0,0,0,-86000,2000,12000,-10000,6000,82000,-76000,-190000
06150P,奇力新元大97售06,0,0,0,0,0,0,0,0,0,-191000,0,0,0,0,191000,-191000,-191000
056997,台灣50康和9A購02,0,0,0,0,0,0,0,0,0,-191000,0,0,0,0,191000,-191000,-191000
053483,嘉澤第一96購01  ,0,0,0,0,0,0,0,0,0,-191000,0,0,0,20000,211000,-191000,-191000
1609,大亞            ,348000,539000,-191000,0,0,0,0,0,0,0,0,0,0,0,0,0,-191000
051149,可成凱基95購04  ,0,0,0,0,0,0,0,0,0,-192000,0,0,0,10000,202000,-192000,-192000
054629,華新科凱基98購01,0,0,0,0,0,0,0,0,0,-192000,0,0,0,10000,202000,-192000,-192000
9935,慶豐富          ,137000,329000,-192000,0,0,0,0,0,0,0,0,0,0,0,0,0,-192000
05889P,群創元大98售02  ,0,0,0,0,0,0,0,0,0,-193000,0,0,0,10000,203000,-193000,-193000
056099,上銀永豐97購02  ,0,0,0,0,0,0,0,0,0,-193000,0,0,0,607000,800000,-193000,-193000
047194,世紀鋼元大96購01,0,0,0,0,0,0,0,0,0,-193000,0,0,0,20000,213000,-193000,-193000
050589,昇陽半國票94購02,0,0,0,0,0,0,0,0,0,-193000,0,0,0,0,193000,-193000,-193000
1795,美時            ,104000,297000,-193000,0,0,0,0,0,0,0,0,0,0,0,0,0,-193000
2387,精元            ,36000,229000,-193000,0,0,0,0,0,0,0,2000,0,2000,4000,6000,-2000,-193000
047245,聯發科群益94購03,0,0,0,0,0,0,0,0,0,-194000,0,0,0,12000,206000,-194000,-194000
047799,技嘉兆豐93購01  ,0,0,0,0,0,0,0,0,0,-194000,0,0,0,62000,256000,-194000,-194000
1717,長興            ,116000,310000,-194000,0,0,0,0,0,0,0,0,0,0,0,0,0,-194000
056993,GIS兆豐99購01   ,0,0,0,0,0,0,0,0,0,-195000,0,0,0,110000,305000,-195000,-195000
047285,鴻海統一95購02  ,0,0,0,0,0,0,0,0,0,-195000,0,0,0,200000,395000,-195000,-195000
048384,遠東新國票94購01,0,0,0,0,0,0,0,0,0,-195000,0,0,0,10000,205000,-195000,-195000
05174P,元金2X富邦9B售01,0,0,0,0,0,0,0,0,0,-195000,0,0,0,0,195000,-195000,-195000
4942,嘉彰            ,8000,205000,-197000,0,0,0,0,0,0,2000,2000,0,2000,0,0,0,-195000
048471,旭富永豐93購01  ,0,0,0,0,0,0,0,0,0,-196000,0,0,0,20000,216000,-196000,-196000
051160,亞德客元大95購02,0,0,0,0,0,0,0,0,0,-196000,0,0,0,103000,299000,-196000,-196000
050049,華通群益96購01  ,0,0,0,0,0,0,0,0,0,-196000,0,0,0,134000,330000,-196000,-196000
046409,富邦金元大92購02,0,0,0,0,0,0,0,0,0,-197000,0,0,0,3000,200000,-197000,-197000
053159,同欣電元大96購02,0,0,0,0,0,0,0,0,0,-197000,0,0,0,51000,248000,-197000,-197000
055985,聯鈞元富97購01  ,0,0,0,0,0,0,0,0,0,-198000,0,0,0,568000,766000,-198000,-198000
048476,同欣電永豐93購01,0,0,0,0,0,0,0,0,0,-198000,0,0,0,287000,485000,-198000,-198000
053649,台積電凱基97購05,0,0,0,0,0,0,0,0,0,-198000,0,0,0,25000,223000,-198000,-198000
052844,台積電統一96購02,0,0,0,0,0,0,0,0,0,-199000,0,0,0,0,199000,-199000,-199000
052712,旺宏凱基96購02  ,0,0,0,0,0,0,0,0,0,-199000,0,0,0,140000,339000,-199000,-199000
056478,晶技元大99購01  ,0,0,0,0,0,0,0,0,0,-200000,0,0,0,0,200000,-200000,-200000
056348,S&P反1元大9A購01,0,0,0,0,0,0,0,0,0,-200000,0,0,0,0,200000,-200000,-200000
055838,致茂元大97購03  ,0,0,0,0,0,0,0,0,0,-200000,0,0,0,25000,225000,-200000,-200000
055862,矽力元大97購04  ,0,0,0,0,0,0,0,0,0,-200000,0,0,0,1000,201000,-200000,-200000
056882,華邦電康和98購01,0,0,0,0,0,0,0,0,0,-200000,0,0,0,0,200000,-200000,-200000
056706,元油2X富邦9B購01,0,0,0,0,0,0,0,0,0,-200000,0,0,0,0,200000,-200000,-200000
05748P,臺股指群益99售02,0,0,0,0,0,0,0,0,0,-200000,0,0,0,82000,282000,-200000,-200000
057463,華邦電永豐98購01,0,0,0,0,0,0,0,0,0,-200000,0,0,0,0,200000,-200000,-200000
057432,T50反1國票9B購01,0,0,0,0,0,0,0,0,0,-200000,0,0,0,0,200000,-200000,-200000
047680,上証反中信96購01,0,0,0,0,0,0,0,0,0,-200000,0,0,0,0,200000,-200000,-200000
047723,廣宇群益94購01  ,0,0,0,0,0,0,0,0,0,-200000,0,0,0,0,200000,-200000,-200000
047505,元金2X國票9B購01,0,0,0,0,0,0,0,0,0,-200000,0,0,0,0,200000,-200000,-200000
044408,聯茂凱基93購02  ,0,0,0,0,0,0,0,0,0,-200000,0,0,0,10000,210000,-200000,-200000
043832,SP黃豆國票95購01,0,0,0,0,0,0,0,0,0,-200000,0,0,0,0,200000,-200000,-200000
045937,臻鼎群益93購02  ,0,0,0,0,0,0,0,0,0,-200000,0,0,0,0,200000,-200000,-200000
051595,康控元大95購04  ,0,0,0,0,0,0,0,0,0,-200000,0,0,0,0,200000,-200000,-200000
050284,台泥凱基94購01  ,0,0,0,0,0,0,0,0,0,-200000,0,0,0,0,200000,-200000,-200000
049991,臺股指凱基96購04,0,0,0,0,0,0,0,0,0,-200000,0,0,0,0,200000,-200000,-200000
052140,鈺齊凱基95購02  ,0,0,0,0,0,0,0,0,0,-200000,0,0,0,0,200000,-200000,-200000
052606,聯發科元大97購04,0,0,0,0,0,0,0,0,0,-200000,0,0,0,75000,275000,-200000,-200000
052876,GIS凱基96購03   ,0,0,0,0,0,0,0,0,0,-200000,0,0,0,4000,204000,-200000,-200000
053088,奇鋐元大98購01  ,0,0,0,0,0,0,0,0,0,-200000,0,0,0,0,200000,-200000,-200000
053351,A50正2兆豐97購01,0,0,0,0,0,0,0,0,0,-200000,0,0,0,0,200000,-200000,-200000
053824,樺漢群益96購02  ,0,0,0,0,0,0,0,0,0,-200000,0,0,0,0,200000,-200000,-200000
057298,旭富永豐98購01  ,0,0,0,0,0,0,0,0,0,-201000,0,0,0,11000,212000,-201000,-201000
05922P,京元電兆豐96售01,0,0,0,0,0,0,0,0,0,-201000,0,0,0,5000,206000,-201000,-201000
054521,TPK元大96購03   ,0,0,0,0,0,0,0,0,0,-201000,0,0,0,0,201000,-201000,-201000
055281,台光電元大98購03,0,0,0,0,0,0,0,0,0,-201000,0,0,0,20000,221000,-201000,-201000
056718,GIS永豐98購01   ,0,0,0,0,0,0,0,0,0,-202000,0,0,0,30000,232000,-202000,-202000
051451,世芯元大95購03  ,0,0,0,0,0,0,0,0,0,-202000,0,0,0,65000,267000,-202000,-202000
051513,台積電凱基95購13,0,0,0,0,0,0,0,0,0,-202000,0,0,0,68000,270000,-202000,-202000
055239,帆宣台新97購01  ,0,0,0,0,0,0,0,0,0,-202000,0,0,0,22000,224000,-202000,-202000
054158,國巨日盛99購01  ,0,0,0,0,0,0,0,0,0,-202000,0,0,0,3403000,3605000,-202000,-202000
056398,南茂永豐98購01  ,0,0,0,0,0,0,0,0,0,-203000,0,0,0,47000,250000,-203000,-203000
055387,世紀鋼元大97購01,0,0,0,0,0,0,0,0,0,-204000,0,0,0,60000,264000,-204000,-204000
051462,世芯國泰97購01  ,3000,0,3000,0,0,0,0,0,0,-207000,0,0,0,6000,213000,-207000,-204000
3019,亞光            ,529000,777000,-248000,0,0,0,0,0,0,44000,72000,102000,-30000,90000,16000,74000,-204000
057162,上銀元大98購03  ,0,0,0,0,0,0,0,0,0,-205000,0,0,0,150000,355000,-205000,-205000
1309,台達化          ,8000,213140,-205140,0,0,0,0,0,0,0,0,0,0,0,0,0,-205140
057161,亞德客元大98購02,0,0,0,0,0,0,0,0,0,-206000,0,0,0,187000,393000,-206000,-206000
05881P,彩晶康和96售01  ,0,0,0,0,0,0,0,0,0,-206000,0,0,0,35000,241000,-206000,-206000
055369,友訊元大97購01  ,0,0,0,0,0,0,0,0,0,-206000,0,0,0,53000,259000,-206000,-206000
052658,友達元富9C購01  ,0,0,0,0,0,0,0,0,0,-206000,0,0,0,0,206000,-206000,-206000
057278,可成元大98購06  ,0,0,0,0,0,0,0,0,0,-207000,0,0,0,15000,222000,-207000,-207000
1514,亞力            ,96000,305000,-209000,0,0,0,0,0,0,2000,2000,0,2000,0,0,0,-207000
054720,禾伸堂永豐97購01,0,0,0,0,0,0,0,0,0,-208000,0,0,0,2000,210000,-208000,-208000
051813,GIS凱基96購02   ,0,0,0,0,0,0,0,0,0,-210000,0,0,0,90000,300000,-210000,-210000
04862P,台積電元大94售26,0,0,0,0,0,0,0,0,0,-210000,0,0,0,0,210000,-210000,-210000
053038,華邦電凱基97購01,0,0,0,0,0,0,0,0,0,-210000,0,0,0,0,210000,-210000,-210000
049595,麗豐元大95購01  ,0,0,0,0,0,0,0,0,0,-210000,0,0,0,207000,417000,-210000,-210000
051574,鴻海元大96購06  ,0,0,0,0,0,0,0,0,0,-210000,0,0,0,0,210000,-210000,-210000
050218,世紀鋼統一94購02,0,0,0,0,0,0,0,0,0,-210000,0,0,0,200000,410000,-210000,-210000
053098,國巨元富96購04  ,0,0,0,0,0,0,0,0,0,-210000,0,0,0,41000,251000,-210000,-210000
06213P,大立光元大98售07,0,0,0,0,0,0,0,0,0,-210000,0,0,0,120000,330000,-210000,-210000
056276,同欣電國泰98購01,0,0,0,0,0,0,0,0,0,-211000,0,0,0,0,211000,-211000,-211000
050241,聯發科凱基94購14,0,0,0,0,0,0,0,0,0,-211000,0,0,0,100000,311000,-211000,-211000
05011P,南電國泰96售01  ,0,0,0,0,0,0,0,0,0,-211000,0,0,0,0,211000,-211000,-211000
049762,華邦電國泰95購01,0,0,0,0,0,0,0,0,0,-211000,0,0,0,30000,241000,-211000,-211000
054288,華邦電元大96購05,0,0,0,0,0,0,0,0,0,-211000,0,0,0,26000,237000,-211000,-211000
054663,同欣電元大97購03,0,0,0,0,0,0,0,0,0,-211000,0,0,0,134000,345000,-211000,-211000
055980,祥碩統一98購01  ,0,0,0,0,0,0,0,0,0,-212000,0,0,0,212000,424000,-212000,-212000
054185,喬山永豐96購02  ,0,0,0,0,0,0,0,0,0,-212000,0,0,0,21000,233000,-212000,-212000
053699,臺股指元大96購22,0,0,0,0,0,0,0,0,0,-212000,0,0,0,105000,317000,-212000,-212000
053911,臺股指凱基96購31,0,0,0,0,0,0,0,0,0,-212000,0,0,0,0,212000,-212000,-212000
053330,燿華永豐96購03  ,0,0,0,0,0,0,0,0,0,-212000,0,0,0,0,212000,-212000,-212000
056970,TPK永豐98購01   ,0,0,0,0,0,0,0,0,0,-213000,0,0,0,42000,255000,-213000,-213000
048968,可成元大94購02  ,0,0,0,0,0,0,0,0,0,-213000,0,0,0,20000,233000,-213000,-213000
055122,國巨兆豐98購01  ,0,0,0,0,0,0,0,0,0,-214000,0,0,0,149000,363000,-214000,-214000
2606,裕民            ,199000,413000,-214000,0,0,0,0,0,0,0,0,0,0,0,0,0,-214000
3596,智易            ,91000,327000,-236000,0,0,0,7000,0,7000,15000,27000,4000,23000,8000,16000,-8000,-214000
6176,瑞儀            ,376000,561000,-185000,0,0,0,0,0,0,-29000,23000,16000,7000,15000,51000,-36000,-214000
051392,玉山金兆豐95購01,0,0,0,0,0,0,0,0,0,-215000,0,0,0,37000,252000,-215000,-215000
050716,可成群益96購01  ,0,0,0,0,0,0,0,0,0,-216000,0,0,0,22000,238000,-216000,-216000
054046,義隆元大96購02  ,0,0,0,0,0,0,0,0,0,-216000,0,0,0,378000,594000,-216000,-216000
050883,嘉聯益國泰96購01,0,0,0,0,0,0,0,0,0,-217000,0,0,0,0,217000,-217000,-217000
054962,玉晶光元大99購02,0,0,0,0,0,0,0,0,0,-217000,0,0,0,43000,260000,-217000,-217000
2890,永豐金          ,1004000,1223000,-219000,0,0,0,2000,0,2000,0,2000,2000,0,0,0,0,-217000
057326,景碩群益99購02  ,0,0,0,0,0,0,0,0,0,-218000,0,0,0,16000,234000,-218000,-218000
051538,和碩國票96購01  ,0,0,0,0,0,0,0,0,0,-218000,0,0,0,0,218000,-218000,-218000
052244,廣達康和95購01  ,0,0,0,0,0,0,0,0,0,-219000,0,0,0,0,219000,-219000,-219000
047416,台泥富邦94購01  ,0,0,0,0,0,0,0,0,0,-220000,0,0,0,0,220000,-220000,-220000
054222,大立光統一98購03,0,0,0,0,0,0,0,0,0,-220000,0,0,0,0,220000,-220000,-220000
2404,漢唐            ,85000,222000,-137000,0,0,0,0,0,0,-83000,1000,30000,-29000,5000,59000,-54000,-220000
056312,茂林元大98購01  ,0,0,0,0,0,0,0,0,0,-221000,0,0,0,634000,855000,-221000,-221000
054368,鴻海中信9A購02  ,0,0,0,0,0,0,0,0,0,-221000,0,0,0,48000,269000,-221000,-221000
03427P,聯電元大02售11  ,0,0,0,0,0,0,0,0,0,-222000,0,0,0,170000,392000,-222000,-222000
056840,友達元富98購02  ,0,0,0,0,0,0,0,0,0,-223000,0,0,0,9000,232000,-223000,-223000
055207,致新中信99購01  ,0,0,0,0,0,0,0,0,0,-223000,0,0,0,0,223000,-223000,-223000
053432,世紀鋼永豐96購02,0,0,0,0,0,0,0,0,0,-223000,0,0,0,119000,342000,-223000,-223000
057006,國巨中信98購03  ,0,0,0,0,0,0,0,0,0,-225000,0,0,0,110000,335000,-225000,-225000
043650,喬山國泰93購02  ,0,0,0,0,0,0,0,0,0,-225000,0,0,0,0,225000,-225000,-225000
049216,華邦電國票95購01,0,0,0,0,0,0,0,0,0,-225000,0,0,0,0,225000,-225000,-225000
051317,亞德客國票96購01,0,0,0,0,0,0,0,0,0,-225000,0,0,0,61000,286000,-225000,-225000
053654,聯發科凱基98購01,0,0,0,0,0,0,0,0,0,-225000,0,0,0,0,225000,-225000,-225000
2379,瑞昱            ,251000,370000,-119000,0,0,0,88000,3000,85000,-191000,13000,73000,-60000,31000,162000,-131000,-225000
049747,嘉晶永豐94購02  ,0,0,0,0,0,0,0,0,0,-226000,0,0,0,0,226000,-226000,-226000
054670,康友元富97購01  ,0,0,0,0,0,0,0,0,0,-226000,0,0,0,0,226000,-226000,-226000
05419P,矽力永豐95售02  ,0,0,0,0,0,0,0,0,0,-226000,0,0,0,0,226000,-226000,-226000
049272,世紀鋼元大96購02,0,0,0,0,0,0,0,0,0,-227000,0,0,0,80000,307000,-227000,-227000
3653,健策            ,151000,300000,-149000,0,0,0,124000,196000,-72000,-6000,13000,5000,8000,82000,96000,-14000,-227000
1477,聚陽            ,183203,380000,-196797,0,0,0,0,0,0,-31000,2000,4000,-2000,0,29000,-29000,-227797
056236,台積電群益97購06,0,0,0,0,0,0,0,0,0,-228000,0,0,0,0,228000,-228000,-228000
054726,台積電日盛97購01,0,0,0,0,0,0,0,0,0,-228000,0,0,0,125000,353000,-228000,-228000
8011,台通            ,51000,279000,-228000,0,0,0,0,0,0,0,0,0,0,0,0,0,-228000
056182,台光電統一97購03,0,0,0,0,0,0,0,0,0,-229000,0,0,0,76000,305000,-229000,-229000
057315,台灣50康和9A購03,0,0,0,0,0,0,0,0,0,-229000,0,0,0,0,229000,-229000,-229000
047410,上銀元富96購01  ,0,0,0,0,0,0,0,0,0,-229000,0,0,0,107000,336000,-229000,-229000
051237,鴻海元大97購01  ,0,0,0,0,0,0,0,0,0,-229000,0,0,0,732000,961000,-229000,-229000
048628,T50反1元大96購03,0,0,0,0,0,0,0,0,0,-230000,0,0,0,0,230000,-230000,-230000
1409,新纖            ,210000,473000,-263000,0,0,0,0,0,0,32000,32000,0,32000,0,0,0,-231000
05655P,南亞科統一96售01,0,0,0,0,0,0,0,0,0,-232000,0,0,0,2000,234000,-232000,-232000
057139,華新科兆豐98購02,0,0,0,0,0,0,0,0,0,-233000,0,0,0,101000,334000,-233000,-233000
056390,台積電富邦9B購01,0,0,0,0,0,0,0,0,0,-233000,0,0,0,12000,245000,-233000,-233000
051938,旭富群益95購01  ,0,0,0,0,0,0,0,0,0,-233000,0,0,0,21000,254000,-233000,-233000
054323,旺宏台新96購02  ,0,0,0,0,0,0,0,0,0,-233000,0,0,0,0,233000,-233000,-233000
054662,同欣電元大97購02,0,0,0,0,0,0,0,0,0,-233000,0,0,0,17000,250000,-233000,-233000
055230,大毅國票98購01  ,0,0,0,0,0,0,0,0,0,-234000,0,0,0,69000,303000,-234000,-234000
3042,晶技            ,253000,1517000,-1264000,0,0,0,300000,0,300000,729000,493000,18000,475000,431000,177000,254000,-235000
055718,可成元大97購02  ,0,0,0,0,0,0,0,0,0,-236000,0,0,0,165000,401000,-236000,-236000
04547P,高鐵元大94售01  ,0,0,0,0,0,0,0,0,0,-236000,0,0,0,17000,253000,-236000,-236000
054377,臺股指中信99購09,0,0,0,0,0,0,0,0,0,-236000,0,0,0,11000,247000,-236000,-236000
4119,旭富            ,407000,684000,-277000,0,0,0,20000,0,20000,21000,0,0,0,22000,1000,21000,-236000
053845,和大元富96購01  ,0,0,0,0,0,0,0,0,0,-237000,0,0,0,258000,495000,-237000,-237000
06320P,上銀統一97售04  ,0,0,0,0,0,0,0,0,0,-237000,0,0,0,0,237000,-237000,-237000
056407,嘉晶國票99購01  ,0,0,0,0,0,0,0,0,0,-238000,0,0,0,79000,317000,-238000,-238000
053269,同欣電群益96購01,0,0,0,0,0,0,0,0,0,-239000,0,0,0,297000,536000,-239000,-239000
055013,訊連元富97購01  ,0,0,0,0,0,0,0,0,0,-239000,0,0,0,414000,653000,-239000,-239000
051157,華新科富邦98購01,0,0,0,0,0,0,0,0,0,-240000,0,0,0,209000,449000,-240000,-240000
051155,聯發科國泰96購01,0,0,0,0,0,0,0,0,0,-240000,0,0,0,97000,337000,-240000,-240000
054980,國巨元富97購01  ,0,0,0,0,0,0,0,0,0,-241000,0,0,0,537000,778000,-241000,-241000
051036,喬山台新95購01  ,0,0,0,0,0,0,0,0,0,-242000,0,0,0,0,242000,-242000,-242000
053265,南亞科群益96購02,0,0,0,0,0,0,0,0,0,-242000,0,0,0,222000,464000,-242000,-242000
048350,世紀鋼元大95購01,0,0,0,0,0,0,0,0,0,-243000,0,0,0,0,243000,-243000,-243000
05028P,康控永豐95售02  ,0,0,0,0,0,0,0,0,0,-244000,0,0,0,54000,298000,-244000,-244000
054343,世紀鋼元富96購02,0,0,0,0,0,0,0,0,0,-244000,0,0,0,0,244000,-244000,-244000
046011,欣興元富95購01  ,0,0,0,0,0,0,0,0,0,-245000,0,0,0,55000,300000,-245000,-245000
055378,晶相光元大97購02,0,0,0,0,0,0,0,0,0,-246000,0,0,0,95000,341000,-246000,-246000
055486,國巨元大98購06  ,0,0,0,0,0,0,0,0,0,-246000,0,0,0,36000,282000,-246000,-246000
06595P,祥碩元大98售03  ,0,0,0,0,0,0,0,0,0,-246000,0,0,0,105000,351000,-246000,-246000
045054,聯發科元富98購02,0,0,0,0,0,0,0,0,0,-247000,0,0,0,16000,263000,-247000,-247000
047848,可成統一93購01  ,0,0,0,0,0,0,0,0,0,-247000,0,0,0,133000,380000,-247000,-247000
044269,群創中信95購01  ,0,0,0,0,0,0,0,0,0,-248000,0,0,0,845000,1093000,-248000,-248000
056386,TPK國泰99購01   ,0,0,0,0,0,0,0,0,0,-249000,0,0,0,179000,428000,-249000,-249000
045478,世紀鋼元大93購02,0,0,0,0,0,0,0,0,0,-249000,0,0,0,0,249000,-249000,-249000
049271,百和元大94購01  ,0,0,0,0,0,0,0,0,0,-249000,0,0,0,0,249000,-249000,-249000
052614,聯電國泰97購01  ,0,0,0,0,0,0,0,0,0,-249000,0,0,0,0,249000,-249000,-249000
056438,旺宏凱基98購05  ,0,0,0,0,0,0,0,0,0,-250000,0,0,0,5000,255000,-250000,-250000
048359,奇鋐永豐93購02  ,0,0,0,0,0,0,0,0,0,-250000,0,0,0,0,250000,-250000,-250000
048936,玉晶光永豐94購05,0,0,0,0,0,0,0,0,0,-250000,0,0,0,57000,307000,-250000,-250000
050714,深中小群益98購01,0,0,0,0,0,0,0,0,0,-250000,0,0,0,125000,375000,-250000,-250000
054429,中石化台新97購01,0,0,0,0,0,0,0,0,0,-250000,0,0,0,0,250000,-250000,-250000
050465,神基中信94購01  ,0,0,0,0,0,0,0,0,0,-251000,0,0,0,48000,299000,-251000,-251000
053394,鴻海中信9A購01  ,0,0,0,0,0,0,0,0,0,-251000,0,0,0,48000,299000,-251000,-251000
050142,聯發科元富9A購01,0,0,0,0,0,0,0,0,0,-252000,0,0,0,65000,317000,-252000,-252000
050708,臺股指凱基96購06,0,0,0,0,0,0,0,0,0,-252000,0,0,0,15000,267000,-252000,-252000
057066,緯穎富邦99購01  ,0,0,0,0,0,0,0,0,0,-253000,0,0,0,187000,440000,-253000,-253000
054973,台郡元大98購02  ,0,0,0,0,0,0,0,0,0,-253000,0,0,0,32000,285000,-253000,-253000
056783,國巨群益99購01  ,0,0,0,0,0,0,0,0,0,-254000,0,0,0,46000,300000,-254000,-254000
047485,景碩凱基94購01  ,0,0,0,0,0,0,0,0,0,-254000,0,0,0,0,254000,-254000,-254000
053344,嘉晶國票97購02  ,0,0,0,0,0,0,0,0,0,-254000,0,0,0,39000,293000,-254000,-254000
04692P,大立光群益94售06,0,0,0,0,0,0,0,0,0,-255000,0,0,0,0,255000,-255000,-255000
043656,上証反元大94購01,0,0,0,0,0,0,0,0,0,-255000,0,0,0,0,255000,-255000,-255000
050751,聯電統一94購05  ,0,0,0,0,0,0,0,0,0,-255000,0,0,0,0,255000,-255000,-255000
3005,神基            ,334000,453000,-119000,0,0,0,0,0,0,-137000,1000,0,1000,3000,141000,-138000,-256000
050325,台積電永豐94購05,0,0,0,0,0,0,0,0,0,-257000,0,0,0,55000,312000,-257000,-257000
050614,聯發科元大95購04,0,0,0,0,0,0,0,0,0,-258000,0,0,0,212000,470000,-258000,-258000
054924,景碩凱基98購01  ,0,0,0,0,0,0,0,0,0,-258000,0,0,0,87000,345000,-258000,-258000
054367,鴻海中信98購03  ,0,0,0,0,0,0,0,0,0,-258000,0,0,0,0,258000,-258000,-258000
050719,世紀鋼群益96購01,0,0,0,0,0,0,0,0,0,-259000,0,0,0,0,259000,-259000,-259000
053671,可成統一96購03  ,0,0,0,0,0,0,0,0,0,-259000,0,0,0,13000,272000,-259000,-259000
056646,奇鋐凱基99購02  ,0,0,0,0,0,0,0,0,0,-260000,0,0,0,10000,270000,-260000,-260000
045870,元油2X元富96購02,0,0,0,0,0,0,0,0,0,-260000,0,0,0,240000,500000,-260000,-260000
042280,元石油富邦96購01,0,0,0,0,0,0,0,0,0,-260000,0,0,0,0,260000,-260000,-260000
051822,和碩元富95購01  ,0,0,0,0,0,0,0,0,0,-260000,0,0,0,0,260000,-260000,-260000
3563,牧德            ,82000,317000,-235000,0,0,0,59000,0,59000,-84000,1000,95000,-94000,26000,16000,10000,-260000
053481,同欣電元大97購01,0,0,0,0,0,0,0,0,0,-261000,0,0,0,266000,527000,-261000,-261000
06375P,矽力元大97售06  ,0,0,0,0,0,0,0,0,0,-261000,0,0,0,10000,271000,-261000,-261000
2439,美律            ,340000,662000,-322000,0,0,0,0,40000,-40000,100000,139000,15000,124000,18000,42000,-24000,-262000
2615,萬海            ,466000,560527,-94527,0,0,0,0,170000,-170000,1000,1000,0,1000,0,0,0,-263527
046248,技嘉群益93購02  ,0,0,0,0,0,0,0,0,0,-264000,0,0,0,209000,473000,-264000,-264000
055808,世紀鋼永豐97購01,0,0,0,0,0,0,0,0,0,-265000,0,0,0,273000,538000,-265000,-265000
050579,聯發科國票95購04,0,0,0,0,0,0,0,0,0,-265000,0,0,0,0,265000,-265000,-265000
1789,神隆            ,74000,339000,-265000,0,0,0,0,0,0,0,0,0,0,0,0,0,-265000
056347,GIS凱基9A購01   ,0,0,0,0,0,0,0,0,0,-266000,0,0,0,119000,385000,-266000,-266000
05867P,友達兆豐97售02  ,0,0,0,0,0,0,0,0,0,-266000,0,0,0,20000,286000,-266000,-266000
046241,聯發科中信94購02,0,0,0,0,0,0,0,0,0,-266000,0,0,0,10000,276000,-266000,-266000
048271,可成富邦95購02  ,0,0,0,0,0,0,0,0,0,-266000,0,0,0,136000,402000,-266000,-266000
049159,同欣電中信96購01,0,0,0,0,0,0,0,0,0,-266000,0,0,0,360000,626000,-266000,-266000
04172P,大立光凱基93售34,0,0,0,0,0,0,0,0,0,-267000,0,0,0,0,267000,-267000,-267000
052612,康舒元大97購01  ,0,0,0,0,0,0,0,0,0,-267000,0,0,0,217000,484000,-267000,-267000
052849,可成統一97購01  ,0,0,0,0,0,0,0,0,0,-268000,0,0,0,134000,402000,-268000,-268000
051429,智邦元富95購01  ,0,0,0,0,0,0,0,0,0,-269000,0,0,0,71000,340000,-269000,-269000
046142,康舒統一93購01  ,0,0,0,0,0,0,0,0,0,-270000,0,0,0,30000,300000,-270000,-270000
054432,台積電台新96購05,0,0,0,0,0,0,0,0,0,-270000,0,0,0,0,270000,-270000,-270000
055030,帆宣國泰99購02  ,0,0,0,0,0,0,0,0,0,-270000,0,0,0,204000,474000,-270000,-270000
048573,世紀鋼元大93購05,0,0,0,0,0,0,0,0,0,-271000,0,0,0,0,271000,-271000,-271000
052832,益航群益96購01  ,0,0,0,0,0,0,0,0,0,-271000,0,0,0,100000,371000,-271000,-271000
049331,元石油統一94購01,0,0,0,0,0,0,0,0,0,-272000,0,0,0,25000,297000,-272000,-272000
051126,訊連群益95購01  ,0,0,0,0,0,0,0,0,0,-272000,0,0,0,251000,523000,-272000,-272000
054680,華新科康和97購02,0,0,0,0,0,0,0,0,0,-273000,0,0,0,105000,378000,-273000,-273000
9105,泰金寶-DR       ,0,273000,-273000,0,0,0,0,0,0,0,0,0,0,0,0,0,-273000
3045,台灣大          ,181000,415000,-234000,0,0,0,1000,0,1000,-41000,9000,50000,-41000,0,0,0,-274000
052296,TPK國票96購01   ,0,0,0,0,0,0,0,0,0,-275000,0,0,0,70000,345000,-275000,-275000
051173,元油2X凱基98購01,0,0,0,0,0,0,0,0,0,-276000,0,0,0,0,276000,-276000,-276000
055550,華邦電凱基97購03,0,0,0,0,0,0,0,0,0,-277000,0,0,0,10000,287000,-277000,-277000
048894,光罩國泰94購01  ,0,0,0,0,0,0,0,0,0,-278000,0,0,0,217000,495000,-278000,-278000
055192,世芯元富97購01  ,0,0,0,0,0,0,0,0,0,-278000,0,0,0,299000,577000,-278000,-278000
057300,訊連永豐98購01  ,0,0,0,0,0,0,0,0,0,-279000,0,0,0,0,279000,-279000,-279000
047141,宏達電兆豐94購01,0,0,0,0,0,0,0,0,0,-279000,0,0,0,41000,320000,-279000,-279000
053028,康控富邦98購01  ,0,0,0,0,0,0,0,0,0,-279000,0,0,0,410000,689000,-279000,-279000
05201P,玉晶光國泰97售02,0,0,0,0,0,0,0,0,0,-279000,0,0,0,21000,300000,-279000,-279000
056976,喬山群益98購01  ,0,0,0,0,0,0,0,0,0,-280000,0,0,0,17000,297000,-280000,-280000
055661,亞德客中信98購01,0,0,0,0,0,0,0,0,0,-280000,0,0,0,24000,304000,-280000,-280000
051618,智邦凱基95購06  ,0,0,0,0,0,0,0,0,0,-280000,0,0,0,119000,399000,-280000,-280000
051278,臻鼎中信97購02  ,0,0,0,0,0,0,0,0,0,-280000,0,0,0,0,280000,-280000,-280000
052048,景碩凱基95購01  ,0,0,0,0,0,0,0,0,0,-282000,0,0,0,0,282000,-282000,-282000
054802,高股息元大97購01,0,0,0,0,0,0,0,0,0,-283000,0,0,0,25000,308000,-283000,-283000
2881,富邦金          ,949000,1244000,-295000,0,0,0,2000,0,2000,9000,6000,0,6000,11000,8000,3000,-284000
054811,裕隆元大9A購01  ,0,0,0,0,0,0,0,0,0,-285000,0,0,0,0,285000,-285000,-285000
054312,TPK凱基98購01   ,0,0,0,0,0,0,0,0,0,-287000,0,0,0,25000,312000,-287000,-287000
044996,嘉晶國泰95購01  ,0,0,0,0,0,0,0,0,0,-288000,0,0,0,346000,634000,-288000,-288000
048127,麗豐元大94購01  ,0,0,0,0,0,0,0,0,0,-290000,0,0,0,100000,390000,-290000,-290000
051235,鴻海元大95購06  ,0,0,0,0,0,0,0,0,0,-290000,0,0,0,0,290000,-290000,-290000
055098,臺股指群益97購01,0,0,0,0,0,0,0,0,0,-290000,0,0,0,10000,300000,-290000,-290000
053925,群創國票98購01  ,0,0,0,0,0,0,0,0,0,-290000,0,0,0,0,290000,-290000,-290000
044805,旭富凱基93購01  ,0,0,0,0,0,0,0,0,0,-291000,0,0,0,1000,292000,-291000,-291000
053525,台積電中信96購04,0,0,0,0,0,0,0,0,0,-291000,0,0,0,0,291000,-291000,-291000
055812,台積電國票99購02,0,0,0,0,0,0,0,0,0,-292000,0,0,0,0,292000,-292000,-292000
044270,群創中信95購02  ,0,0,0,0,0,0,0,0,0,-292000,0,0,0,3000,295000,-292000,-292000
2340,光磊            ,315000,387000,-72000,0,0,0,0,0,0,-220000,2000,44000,-42000,2000,180000,-178000,-292000
2105,正新            ,345000,643000,-298000,0,0,0,0,0,0,6000,8000,2000,6000,0,0,0,-292000
051604,喬山群益95購01  ,0,0,0,0,0,0,0,0,0,-293000,0,0,0,0,293000,-293000,-293000
054364,智伸科凱基96購01,0,0,0,0,0,0,0,0,0,-293000,0,0,0,0,293000,-293000,-293000
00671R,富邦NASDAQ反1   ,0,0,0,0,0,0,0,0,0,-295000,0,0,0,140000,435000,-295000,-295000
052392,台表科群益96購02,0,0,0,0,0,0,0,0,0,-295000,0,0,0,136000,431000,-295000,-295000
053882,聯發科中信98購02,0,0,0,0,0,0,0,0,0,-295000,0,0,0,0,295000,-295000,-295000
056155,嘉晶凱基97購01  ,0,0,0,0,0,0,0,0,0,-296000,0,0,0,247000,543000,-296000,-296000
055029,帆宣國泰99購01  ,0,0,0,0,0,0,0,0,0,-296000,0,0,0,304000,600000,-296000,-296000
056009,奇力新中信98購03,0,0,0,0,0,0,0,0,0,-297000,0,0,0,324000,621000,-297000,-297000
05763P,致新永豐96售01  ,0,0,0,0,0,0,0,0,0,-298000,0,0,0,116000,414000,-298000,-298000
048442,友訊凱基94購01  ,0,0,0,0,0,0,0,0,0,-298000,0,0,0,284000,582000,-298000,-298000
048432,全新國票95購01  ,0,0,0,0,0,0,0,0,0,-299000,0,0,0,40000,339000,-299000,-299000
050680,上銀元富94購01  ,0,0,0,0,0,0,0,0,0,-299000,0,0,0,497000,796000,-299000,-299000
2312,金寶            ,308000,334000,-26000,0,0,0,0,0,0,-273000,35000,0,35000,64000,372000,-308000,-299000
057447,智邦元富02購01  ,0,0,0,0,0,0,0,0,0,-300000,0,0,0,0,300000,-300000,-300000
03016P,滬深2X群益01售09,0,0,0,0,0,0,0,0,0,-300000,0,0,0,0,300000,-300000,-300000
050462,寶成元大94購01  ,0,0,0,0,0,0,0,0,0,-300000,0,0,0,0,300000,-300000,-300000
05422P,大立光中信97售02,0,0,0,0,0,0,0,0,0,-300000,0,0,0,0,300000,-300000,-300000
056605,台積電富邦9B購02,0,0,0,0,0,0,0,0,0,-301000,0,0,0,0,301000,-301000,-301000
049532,同欣電台新94購01,0,0,0,0,0,0,0,0,0,-301000,0,0,0,211000,512000,-301000,-301000
8210,勤誠            ,119000,347000,-228000,0,0,0,0,0,0,-73000,13000,0,13000,4000,90000,-86000,-301000
056657,華邦電元大99購01,0,0,0,0,0,0,0,0,0,-302000,0,0,0,0,302000,-302000,-302000
050675,奇鋐富邦96購01  ,0,0,0,0,0,0,0,0,0,-302000,0,0,0,0,302000,-302000,-302000
06190P,玉晶光永豐97售05,0,0,0,0,0,0,0,0,0,-302000,0,0,0,0,302000,-302000,-302000
05613P,臻鼎台新96售01  ,0,0,0,0,0,0,0,0,0,-303000,0,0,0,3000,306000,-303000,-303000
055314,華邦電中信99購01,0,0,0,0,0,0,0,0,0,-303000,0,0,0,0,303000,-303000,-303000
057058,祥碩元大98購04  ,0,0,0,0,0,0,0,0,0,-304000,0,0,0,55000,359000,-304000,-304000
046146,南亞科第一92購01,0,0,0,0,0,0,0,0,0,-305000,0,0,0,94000,399000,-305000,-305000
047824,臺股指凱基93購18,0,0,0,0,0,0,0,0,0,-305000,0,0,0,0,305000,-305000,-305000
051733,中環國票96購02  ,0,0,0,0,0,0,0,0,0,-305000,0,0,0,0,305000,-305000,-305000
052163,康舒永豐95購02  ,0,0,0,0,0,0,0,0,0,-305000,0,0,0,275000,580000,-305000,-305000
054228,貿聯元富96購03  ,0,0,0,0,0,0,0,0,0,-305000,0,0,0,51000,356000,-305000,-305000
9904,寶成            ,547000,831000,-284000,0,0,0,1000,0,1000,-22000,4000,36000,-32000,10000,0,10000,-305000
056220,上証2X凱基99購01,0,0,0,0,0,0,0,0,0,-306000,0,0,0,0,306000,-306000,-306000
050797,聯發科中信99購01,0,0,0,0,0,0,0,0,0,-306000,0,0,0,20000,326000,-306000,-306000
08218P,滬深2X凱基96售01,0,0,0,0,0,0,0,0,0,-307000,0,0,0,90000,397000,-307000,-307000
00710B,FH彭博高收益債  ,0,0,0,0,0,0,0,0,0,-308000,0,0,0,0,308000,-308000,-308000
054803,味全元大9A購01  ,0,0,0,0,0,0,0,0,0,-308000,0,0,0,14000,322000,-308000,-308000
053860,台積電元大98購03,0,0,0,0,0,0,0,0,0,-308000,0,0,0,23000,331000,-308000,-308000
050778,瑞儀元大96購01  ,0,0,0,0,0,0,0,0,0,-309000,0,0,0,0,309000,-309000,-309000
056234,GIS麥證97購01   ,0,0,0,12000,341000,-329000,0,0,0,-310000,0,0,0,33000,343000,-310000,-310000
055783,群創凱基99購03  ,0,0,0,0,0,0,0,0,0,-310000,0,0,0,20000,330000,-310000,-310000
044340,TPK統一93購01   ,0,0,0,0,0,0,0,0,0,-310000,0,0,0,0,310000,-310000,-310000
048249,嘉澤兆豐94購01  ,0,0,0,0,0,0,0,0,0,-310000,0,0,0,0,310000,-310000,-310000
049185,南電凱基94購03  ,0,0,0,0,0,0,0,0,0,-310000,0,0,0,0,310000,-310000,-310000
054556,世芯凱基99購01  ,0,0,0,0,0,0,0,0,0,-310000,0,0,0,0,310000,-310000,-310000
045683,泰鼎元大93購03  ,0,0,0,0,0,0,0,0,0,-311000,0,0,0,15000,326000,-311000,-311000
051943,台積電麥證95購03,0,0,0,0,311000,-311000,0,0,0,-311000,0,0,0,0,311000,-311000,-311000
056865,樺漢群益98購01  ,0,0,0,0,0,0,0,0,0,-312000,0,0,0,63000,375000,-312000,-312000
055006,晶相光元富9A購01,0,0,0,0,0,0,0,0,0,-312000,0,0,0,30000,342000,-312000,-312000
054884,友達統一99購01  ,0,0,0,0,0,0,0,0,0,-313000,0,0,0,87000,400000,-313000,-313000
051997,康友元大95購02  ,0,0,0,0,0,0,0,0,0,-314000,0,0,0,188000,502000,-314000,-314000
048880,昇陽半國票94購01,0,0,0,0,0,0,0,0,0,-314000,0,0,0,36000,350000,-314000,-314000
055599,TPK元大97購01   ,0,0,0,0,0,0,0,0,0,-315000,0,0,0,37000,352000,-315000,-315000
044290,群創凱基93購05  ,0,0,0,0,0,0,0,0,0,-315000,0,0,0,0,315000,-315000,-315000
055492,華新科元大97購08,0,0,0,0,0,0,0,0,0,-316000,0,0,0,56000,372000,-316000,-316000
052124,京鼎國票95購01  ,0,0,0,0,0,0,0,0,0,-316000,0,0,0,139000,455000,-316000,-316000
5521,工信            ,117230,434000,-316770,0,0,0,0,0,0,0,0,0,0,0,0,0,-316770
048319,嘉晶凱基93購04  ,0,0,0,0,0,0,0,0,0,-317000,0,0,0,0,317000,-317000,-317000
050600,瑞儀國泰95購01  ,0,0,0,0,0,0,0,0,0,-317000,0,0,0,2000,319000,-317000,-317000
4977,眾達-KY         ,111000,449000,-338000,0,0,0,0,0,0,20000,20000,0,20000,0,0,0,-318000
049444,元石油統一94購03,0,0,0,0,0,0,0,0,0,-319000,0,0,0,5000,324000,-319000,-319000
054407,美律國票97購02  ,0,0,0,0,0,0,0,0,0,-319000,0,0,0,0,319000,-319000,-319000
055286,晶技元大98購03  ,0,0,0,0,0,0,0,0,0,-320000,0,0,0,100000,420000,-320000,-320000
05269P,臻鼎元大95售05  ,0,0,0,0,0,0,0,0,0,-320000,0,0,0,51000,371000,-320000,-320000
051457,寶成元大95購01  ,0,0,0,0,0,0,0,0,0,-321000,0,0,0,0,321000,-321000,-321000
049393,世紀鋼第一94購01,0,0,0,0,0,0,0,0,0,-321000,0,0,0,0,321000,-321000,-321000
06195P,台積電元富97售06,0,0,0,0,0,0,0,0,0,-321000,0,0,0,1366000,1687000,-321000,-321000
048237,致茂國票94購01  ,0,0,0,0,0,0,0,0,0,-322000,0,0,0,10000,332000,-322000,-322000
052814,上証2X永豐96購02,0,0,0,0,0,0,0,0,0,-322000,0,0,0,270000,592000,-322000,-322000
055566,台表科凱基97購03,0,0,0,0,0,0,0,0,0,-323000,0,0,0,0,323000,-323000,-323000
052672,世紀鋼群益96購02,0,0,0,0,0,0,0,0,0,-326000,0,0,0,10000,336000,-326000,-326000
06603P,立積統一99售01  ,0,0,0,0,0,0,0,0,0,-326000,0,0,0,0,326000,-326000,-326000
055601,茂林元大97購03  ,0,0,0,0,0,0,0,0,0,-327000,0,0,0,391000,718000,-327000,-327000
055416,欣興富邦98購01  ,0,0,0,0,0,0,0,0,0,-327000,0,0,0,5000,332000,-327000,-327000
05704P,矽力群益96售04  ,0,0,0,0,0,0,0,0,0,-327000,0,0,0,5000,332000,-327000,-327000
051863,技嘉凱基95購01  ,0,0,0,0,0,0,0,0,0,-327000,0,0,0,119000,446000,-327000,-327000
049425,喬山兆豐95購01  ,0,0,0,0,0,0,0,0,0,-327000,0,0,0,41000,368000,-327000,-327000
052972,義隆群益96購04  ,0,0,0,0,0,0,0,0,0,-327000,0,0,0,0,327000,-327000,-327000
055272,國巨元大98購04  ,0,0,0,0,0,0,0,0,0,-327000,0,0,0,101000,428000,-327000,-327000
00830,國泰費城半導體  ,2000,492000,-490000,0,0,0,0,0,0,162000,0,0,0,342000,180000,162000,-328000
049799,旺宏元大96購01  ,0,0,0,0,0,0,0,0,0,-330000,0,0,0,6000,336000,-330000,-330000
2324,仁寶            ,3700000,4265000,-565000,0,0,0,0,0,0,235000,453000,8000,445000,1000,211000,-210000,-330000
9946,三發地產        ,76000,410000,-334000,0,0,0,0,0,0,3000,3000,0,3000,0,0,0,-331000
00632R,元大台灣50反1   ,0,245000,-245000,0,0,0,0,0,0,-87000,4909000,4021000,888000,5719000,6694000,-975000,-332000
053798,台積電中信98購02,0,0,0,0,0,0,0,0,0,-332000,0,0,0,0,332000,-332000,-332000
06123P,玉晶光元大97售04,0,0,0,0,0,0,0,0,0,-333000,0,0,0,16000,349000,-333000,-333000
051969,世紀鋼永豐95購01,0,0,0,0,0,0,0,0,0,-333000,0,0,0,10000,343000,-333000,-333000
00651R,FH香港反1       ,0,0,0,0,0,0,0,0,0,-334000,0,0,0,106000,440000,-334000,-334000
054907,帆宣康和97購01  ,0,0,0,0,0,0,0,0,0,-334000,0,0,0,1000,335000,-334000,-334000
055097,福懋科群益97購01,0,0,0,0,0,0,0,0,0,-335000,0,0,0,303000,638000,-335000,-335000
052269,T50反1日盛9B購01,0,0,0,0,0,0,0,0,0,-335000,0,0,0,15000,350000,-335000,-335000
6108,競國            ,8000,344000,-336000,0,0,0,0,0,0,0,0,0,0,0,0,0,-336000
050528,瑞儀元大94購02  ,0,0,0,0,0,0,0,0,0,-337000,0,0,0,30000,367000,-337000,-337000
5434,崇越            ,34090,309657,-275567,0,0,0,0,0,0,-64000,23000,100000,-77000,17000,4000,13000,-339567
2357,華碩            ,106375,411000,-304625,0,0,0,1000,25000,-24000,-11000,5000,0,5000,0,16000,-16000,-339625
056588,聯發科統一9A購02,0,0,0,0,0,0,0,0,0,-340000,0,0,0,57000,397000,-340000,-340000
053738,群創麥證96購01  ,0,0,0,10000,350000,-340000,0,0,0,-340000,0,0,0,10000,350000,-340000,-340000
056306,晶相光元大98購01,0,0,0,0,0,0,0,0,0,-341000,0,0,0,48000,389000,-341000,-341000
050934,喬山國票96購01  ,0,0,0,0,0,0,0,0,0,-341000,0,0,0,33000,374000,-341000,-341000
053180,同欣電統一96購01,0,0,0,0,0,0,0,0,0,-343000,0,0,0,94000,437000,-343000,-343000
2352,佳世達          ,386916,490906,-103990,0,0,0,0,250000,-250000,10000,10000,0,10000,0,0,0,-343990
052251,台光電永豐95購03,0,0,0,0,0,0,0,0,0,-344000,0,0,0,13000,357000,-344000,-344000
054552,聯發科凱基98購03,0,0,0,0,0,0,0,0,0,-344000,0,0,0,338000,682000,-344000,-344000
056720,世紀鋼永豐98購01,0,0,0,0,0,0,0,0,0,-345000,0,0,0,103000,448000,-345000,-345000
06077P,GIS凱基97售02   ,0,0,0,0,0,0,0,0,0,-345000,0,0,0,18000,363000,-345000,-345000
056552,台表科凱基99購01,0,0,0,0,0,0,0,0,0,-348000,0,0,0,9000,357000,-348000,-348000
054606,台積電永豐97購02,0,0,0,0,0,0,0,0,0,-348000,0,0,0,0,348000,-348000,-348000
053465,聯電元大96購05  ,0,0,0,0,0,0,0,0,0,-348000,0,0,0,50000,398000,-348000,-348000
051479,兆豐金凱基95購01,0,0,0,0,0,0,0,0,0,-349000,0,0,0,0,349000,-349000,-349000
046798,元油2X元大96購01,0,0,0,0,0,0,0,0,0,-350000,0,0,0,0,350000,-350000,-350000
053252,華邦電國泰98購01,0,0,0,0,0,0,0,0,0,-350000,0,0,0,0,350000,-350000,-350000
057249,華邦電統一9A購01,0,0,0,0,0,0,0,0,0,-351000,0,0,0,0,351000,-351000,-351000
051602,南茂兆豐96購01  ,0,0,0,0,0,0,0,0,0,-352000,0,0,0,176000,528000,-352000,-352000
055148,鴻海元大98購02  ,0,0,0,0,0,0,0,0,0,-352000,0,0,0,155000,507000,-352000,-352000
056086,奇力新統一98購01,0,0,0,0,0,0,0,0,0,-353000,0,0,0,64000,417000,-353000,-353000
053069,同欣電群益98購01,0,0,0,0,0,0,0,0,0,-353000,0,0,0,127000,480000,-353000,-353000
049545,台積電群益94購09,0,0,0,0,0,0,0,0,0,-355000,0,0,0,0,355000,-355000,-355000
056194,聯發科富邦9B購01,0,0,0,0,0,0,0,0,0,-356000,0,0,0,19000,375000,-356000,-356000
055654,景碩元富97購01  ,0,0,0,0,0,0,0,0,0,-356000,0,0,0,71000,427000,-356000,-356000
053563,台積電富邦97購01,0,0,0,0,0,0,0,0,0,-356000,0,0,0,243000,599000,-356000,-356000
053820,大立光群益96購05,0,0,0,0,0,0,0,0,0,-356000,0,0,0,131000,487000,-356000,-356000
056305,群創元大9A購03  ,0,0,0,0,0,0,0,0,0,-359000,0,0,0,305000,664000,-359000,-359000
05989P,健策元富96售01  ,0,0,0,0,0,0,0,0,0,-360000,0,0,0,12000,372000,-360000,-360000
06215P,康控永豐97售02  ,0,0,0,0,0,0,0,0,0,-360000,0,0,0,0,360000,-360000,-360000
052196,TPK元富95購01   ,0,0,0,0,0,0,0,0,0,-362000,0,0,0,200000,562000,-362000,-362000
052771,GIS群益96購01   ,0,0,0,0,0,0,0,0,0,-362000,0,0,0,115000,477000,-362000,-362000
055978,大立光統一98購05,0,0,0,0,0,0,0,0,0,-364000,0,0,0,0,364000,-364000,-364000
054762,奇力新國票99購01,0,0,0,0,0,0,0,0,0,-365000,0,0,0,38000,403000,-365000,-365000
3443,創意            ,201000,336000,-135000,0,0,0,75000,271000,-196000,-35000,2000,16000,-14000,5000,26000,-21000,-366000
054425,聯發科富邦99購03,0,0,0,0,0,0,0,0,0,-367000,0,0,0,5000,372000,-367000,-367000
053996,晶相光群益97購01,0,0,0,0,0,0,0,0,0,-368000,0,0,0,98000,466000,-368000,-368000
9933,中鼎            ,279000,647000,-368000,0,0,0,0,0,0,0,0,0,0,0,0,0,-368000
056047,台積電兆豐97購02,0,0,0,0,0,0,0,0,0,-369000,0,0,0,125000,494000,-369000,-369000
04267P,康控元富93售04  ,0,0,0,0,0,0,0,0,0,-369000,0,0,0,30000,399000,-369000,-369000
056232,瑞儀凱基98購01  ,0,0,0,0,0,0,0,0,0,-370000,0,0,0,0,370000,-370000,-370000
055880,神達元富97購02  ,0,0,0,0,0,0,0,0,0,-370000,0,0,0,50000,420000,-370000,-370000
053455,台光電元富96購02,0,0,0,0,0,0,0,0,0,-370000,0,0,0,7000,377000,-370000,-370000
055224,鴻海國票99購02  ,0,0,0,0,0,0,0,0,0,-370000,0,0,0,0,370000,-370000,-370000
056721,台灣50永昌9A購01,0,0,0,0,0,0,0,0,0,-371000,0,0,0,41000,412000,-371000,-371000
055360,台表科凱基97購02,0,0,0,0,0,0,0,0,0,-372000,0,0,0,20000,392000,-372000,-372000
052347,GIS凱基95購05   ,0,0,0,0,0,0,0,0,0,-374000,0,0,0,8000,382000,-374000,-374000
05999P,世芯元大96售01  ,0,0,0,0,0,0,0,0,0,-375000,0,0,0,237000,612000,-375000,-375000
052498,台積電永豐95購06,0,0,0,0,0,0,0,0,0,-377000,0,0,0,10000,387000,-377000,-377000
053734,友達中信98購02  ,0,0,0,0,0,0,0,0,0,-377000,0,0,0,186000,563000,-377000,-377000
057095,祥碩元富98購02  ,0,0,0,0,0,0,0,0,0,-378000,0,0,0,96000,474000,-378000,-378000
048612,嘉晶凱基93購05  ,0,0,0,0,0,0,0,0,0,-378000,0,0,0,0,378000,-378000,-378000
051109,美律統一95購02  ,0,0,0,0,0,0,0,0,0,-378000,0,0,0,5000,383000,-378000,-378000
051051,鴻海群益95購04  ,0,0,0,0,0,0,0,0,0,-380000,0,0,0,0,380000,-380000,-380000
2834,臺企銀          ,1333000,1717000,-384000,0,0,0,0,0,0,1000,2000,0,2000,0,1000,-1000,-383000
050525,嘉晶元大95購02  ,0,0,0,0,0,0,0,0,0,-385000,0,0,0,315000,700000,-385000,-385000
050314,晶技兆豐94購01  ,0,0,0,0,0,0,0,0,0,-386000,0,0,0,101000,487000,-386000,-386000
053380,南亞科元大97購01,0,0,0,0,0,0,0,0,0,-388000,0,0,0,36000,424000,-388000,-388000
048495,南亞科元大93購04,0,0,0,0,0,0,0,0,0,-390000,0,0,0,60000,450000,-390000,-390000
054983,國巨元富97購04  ,0,0,0,0,0,0,0,0,0,-390000,0,0,0,645000,1035000,-390000,-390000
053926,晶相光國票97購01,0,0,0,0,0,0,0,0,0,-391000,0,0,0,101000,492000,-391000,-391000
056505,聯發科永豐98購01,0,0,0,0,0,0,0,0,0,-392000,0,0,0,116000,508000,-392000,-392000
054841,亞德客兆豐97購01,0,0,0,0,0,0,0,0,0,-392000,0,0,0,111000,503000,-392000,-392000
3006,晶豪科          ,105000,246000,-141000,0,0,0,0,0,0,-251000,4000,72000,-68000,47000,230000,-183000,-392000
03639C,元油2X元大9B牛01,0,0,0,0,0,0,0,0,0,-395000,0,0,0,98000,493000,-395000,-395000
052133,華邦電凱基9B購01,0,0,0,0,0,0,0,0,0,-395000,0,0,0,17000,412000,-395000,-395000
055152,旺宏元大98購04  ,0,0,0,0,0,0,0,0,0,-395000,0,0,0,569000,964000,-395000,-395000
05255P,義隆凱基95售01  ,0,0,0,0,0,0,0,0,0,-396000,0,0,0,86000,482000,-396000,-396000
2376,技嘉            ,1829000,2057000,-228000,0,0,0,469000,0,469000,-640000,70000,290000,-220000,262000,682000,-420000,-399000
056055,國巨元大97購15  ,0,0,0,0,0,0,0,0,0,-400000,0,0,0,20000,420000,-400000,-400000
053181,滬深2X元富99購02,0,0,0,0,0,0,0,0,0,-405000,0,0,0,5000,410000,-405000,-405000
2634,漢翔            ,31000,446000,-415000,0,0,0,0,0,0,10000,10000,0,10000,0,0,0,-405000
2356,英業達          ,1942000,2179000,-237000,0,0,0,0,0,0,-169000,10000,2000,8000,47000,224000,-177000,-406000
055953,上銀元大97購09  ,0,0,0,0,0,0,0,0,0,-407000,0,0,0,262000,669000,-407000,-407000
051408,台積電國票95購03,0,0,0,0,0,0,0,0,0,-408000,0,0,0,10000,418000,-408000,-408000
051431,群創元富99購02  ,0,0,0,0,0,0,0,0,0,-410000,0,0,0,20000,430000,-410000,-410000
051023,S&P反1統一95購02,0,0,0,0,0,0,0,0,0,-410000,0,0,0,0,410000,-410000,-410000
051750,華通富邦96購01  ,0,0,0,0,0,0,0,0,0,-410000,0,0,0,0,410000,-410000,-410000
054016,嘉晶永豐96購04  ,0,0,0,0,0,0,0,0,0,-412000,0,0,0,88000,500000,-412000,-412000
054108,台積電凱基96購22,0,0,0,0,0,0,0,0,0,-413000,0,0,0,68000,481000,-413000,-413000
051940,康舒群益95購01  ,0,0,0,0,0,0,0,0,0,-414000,0,0,0,122000,536000,-414000,-414000
051913,緯創元大96購01  ,0,0,0,0,0,0,0,0,0,-414000,0,0,0,42000,456000,-414000,-414000
049652,GIS凱基94購05   ,0,0,0,0,0,0,0,0,0,-414000,0,0,0,3000,417000,-414000,-414000
054774,同欣電國票98購01,0,0,0,0,0,0,0,0,0,-414000,0,0,0,330000,744000,-414000,-414000
057163,上銀元大98購04  ,0,0,0,0,0,0,0,0,0,-419000,0,0,0,254000,673000,-419000,-419000
2354,鴻準            ,228000,646000,-418000,0,0,0,0,0,0,-3000,3000,6000,-3000,0,0,0,-421000
056294,上銀元大97購11  ,0,0,0,0,0,0,0,0,0,-422000,0,0,0,231000,653000,-422000,-422000
047885,元金2X富邦99購01,0,0,0,0,0,0,0,0,0,-429000,0,0,0,70000,499000,-429000,-429000
054131,南亞科元大96購04,0,0,0,0,0,0,0,0,0,-429000,0,0,0,48000,477000,-429000,-429000
054275,華通群益97購03  ,0,0,0,0,0,0,0,0,0,-430000,0,0,0,0,430000,-430000,-430000
2520,冠德            ,127000,335000,-208000,0,0,0,0,216000,-216000,-6000,1000,0,1000,0,7000,-7000,-430000
046855,嘉晶元大94購01  ,0,0,0,0,0,0,0,0,0,-431000,0,0,0,15000,446000,-431000,-431000
051277,聯發科中信9A購01,0,0,0,0,0,0,0,0,0,-432000,0,0,0,224000,656000,-432000,-432000
053600,同欣電元大96購04,0,0,0,0,0,0,0,0,0,-434000,0,0,0,66000,500000,-434000,-434000
3014,聯陽            ,48000,484000,-436000,0,0,0,0,0,0,2000,2000,0,2000,0,0,0,-434000
046717,世紀鋼國泰94購01,0,0,0,0,0,0,0,0,0,-435000,0,0,0,0,435000,-435000,-435000
053759,晶相光國泰98購01,0,0,0,0,0,0,0,0,0,-435000,0,0,0,61000,496000,-435000,-435000
056315,同欣電元大97購05,0,0,0,0,0,0,0,0,0,-436000,0,0,0,617000,1053000,-436000,-436000
050970,康舒永豐95購01  ,0,0,0,0,0,0,0,0,0,-437000,0,0,0,60000,497000,-437000,-437000
056158,新日興凱基98購02,0,0,0,0,0,0,0,0,0,-439000,0,0,0,79000,518000,-439000,-439000
006208,富邦台50        ,0,0,0,0,0,0,0,0,0,-440000,0,0,0,231000,671000,-440000,-440000
053971,聯發科元大97購09,0,0,0,0,0,0,0,0,0,-440000,0,0,0,0,440000,-440000,-440000
6271,同欣電          ,2426032,3307000,-880968,0,0,0,662000,700000,-38000,478000,238000,219000,19000,512000,53000,459000,-440968
047946,南亞科統一93購04,0,0,0,0,0,0,0,0,0,-442000,0,0,0,10000,452000,-442000,-442000
051802,同欣電永豐95購02,0,0,0,0,0,0,0,0,0,-442000,0,0,0,181000,623000,-442000,-442000
053184,世紀鋼元富96購01,0,0,0,0,0,0,0,0,0,-443000,0,0,0,312000,755000,-443000,-443000
057266,TPK兆豐98購02   ,0,0,0,0,0,0,0,0,0,-446000,0,0,0,10000,456000,-446000,-446000
052032,臺股指群益95購05,0,0,0,0,0,0,0,0,0,-448000,0,0,0,2000,450000,-448000,-448000
06337P,祥碩元大97售05  ,0,0,0,0,0,0,0,0,0,-450000,0,0,0,165000,615000,-450000,-450000
04744P,臻鼎元富94售04  ,0,0,0,0,0,0,0,0,0,-455000,0,0,0,0,455000,-455000,-455000
055102,上銀凱基98購01  ,0,0,0,0,0,0,0,0,0,-455000,0,0,0,382000,837000,-455000,-455000
052740,聯發科元大96購07,0,0,0,0,0,0,0,0,0,-459000,0,0,0,100000,559000,-459000,-459000
06440P,台積電凱基98售07,0,0,0,0,0,0,0,0,0,-459000,0,0,0,203000,662000,-459000,-459000
056915,上銀兆豐99購01  ,0,0,0,0,0,0,0,0,0,-460000,0,0,0,54000,514000,-460000,-460000
04479P,同欣電中信96售02,0,0,0,0,0,0,0,0,0,-460000,0,0,0,0,460000,-460000,-460000
052001,寶成元大95購02  ,0,0,0,0,0,0,0,0,0,-460000,0,0,0,50000,510000,-460000,-460000
055855,牧德元大99購02  ,0,0,0,0,0,0,0,0,0,-461000,0,0,0,2000,463000,-461000,-461000
6452,康友-KY         ,124000,561000,-437000,0,0,0,0,0,0,-26000,0,10000,-10000,27000,43000,-16000,-463000
053043,嘉晶凱基96購01  ,0,0,0,0,0,0,0,0,0,-465000,0,0,0,512000,977000,-465000,-465000
055263,華新科富邦9A購01,0,0,0,0,0,0,0,0,0,-467000,0,0,0,31000,498000,-467000,-467000
057308,同欣電兆豐99購01,0,0,0,0,0,0,0,0,0,-469000,0,0,0,0,469000,-469000,-469000
050214,嘉晶台新94購01  ,0,0,0,0,0,0,0,0,0,-469000,0,0,0,36000,505000,-469000,-469000
054073,群創富邦96購03  ,0,0,0,0,0,0,0,0,0,-470000,0,0,0,40000,510000,-470000,-470000
057213,華邦電群益98購01,0,0,0,0,0,0,0,0,0,-472000,0,0,0,92000,564000,-472000,-472000
055649,華新科元富97購03,0,0,0,0,0,0,0,0,0,-472000,0,0,0,152000,624000,-472000,-472000
055663,崇越中信97購01  ,0,0,0,0,0,0,0,0,0,-473000,0,0,0,210000,683000,-473000,-473000
054353,世紀鋼國泰98購01,0,0,0,0,0,0,0,0,0,-474000,0,0,0,330000,804000,-474000,-474000
044200,群創國票93購01  ,0,0,0,0,0,0,0,0,0,-475000,0,0,0,0,475000,-475000,-475000
00752,中信中國50      ,0,0,0,0,0,0,0,0,0,-477000,0,0,0,641000,1118000,-477000,-477000
053626,台積電兆豐96購03,0,0,0,0,0,0,0,0,0,-477000,0,0,0,93000,570000,-477000,-477000
052036,臺股指群益95購09,0,0,0,0,0,0,0,0,0,-480000,0,0,0,0,480000,-480000,-480000
053691,聯發科元大96購16,0,0,0,0,0,0,0,0,0,-480000,0,0,0,20000,500000,-480000,-480000
050715,台積電群益96購01,0,0,0,0,0,0,0,0,0,-482000,0,0,0,565000,1047000,-482000,-482000
054695,世芯永豐98購01  ,0,0,0,0,0,0,0,0,0,-483000,0,0,0,52000,535000,-483000,-483000
2385,群光            ,263000,762549,-499549,0,0,0,44000,0,44000,-28000,31000,0,31000,1000,60000,-59000,-483549
049049,玉晶光康和94購02,0,0,0,0,0,0,0,0,0,-484000,0,0,0,15000,499000,-484000,-484000
2347,聯強            ,432000,819000,-387000,0,0,0,0,0,0,-102000,7000,4000,3000,0,105000,-105000,-489000
5607,遠雄港          ,77000,568000,-491000,0,0,0,0,0,0,1000,1000,0,1000,0,0,0,-490000
056958,喬山永豐98購01  ,0,0,0,0,0,0,0,0,0,-491000,0,0,0,0,491000,-491000,-491000
049046,同欣電兆豐94購01,0,0,0,0,0,0,0,0,0,-493000,0,0,0,47000,540000,-493000,-493000
051075,智邦國泰97購01  ,0,0,0,0,0,0,0,0,0,-493000,0,0,0,63000,556000,-493000,-493000
051749,矽力國泰97購01  ,0,0,0,0,0,0,0,0,0,-494000,0,0,0,12000,506000,-494000,-494000
056002,嘉晶永豐97購01  ,0,0,0,0,0,0,0,0,0,-495000,0,0,0,0,495000,-495000,-495000
048774,麗豐凱基94購04  ,0,0,0,0,0,0,0,0,0,-499000,0,0,0,0,499000,-499000,-499000
050271,上緯控元大96購01,0,0,0,0,0,0,0,0,0,-499000,0,0,0,0,499000,-499000,-499000
055019,福懋科元富97購01,0,0,0,0,0,0,0,0,0,-502000,0,0,0,220000,722000,-502000,-502000
055229,大毅國票97購02  ,0,0,0,0,0,0,0,0,0,-503000,0,0,0,75000,578000,-503000,-503000
053001,力山永豐96購01  ,0,0,0,0,0,0,0,0,0,-504000,0,0,0,0,504000,-504000,-504000
050581,美食國票94購02  ,0,0,0,0,0,0,0,0,0,-510000,0,0,0,0,510000,-510000,-510000
052212,可成元大95購11  ,0,0,0,0,0,0,0,0,0,-512000,0,0,0,0,512000,-512000,-512000
054237,茂林群益97購01  ,0,0,0,0,0,0,0,0,0,-512000,0,0,0,372000,884000,-512000,-512000
054715,中橡康和97購01  ,0,0,0,0,0,0,0,0,0,-513000,0,0,0,20000,533000,-513000,-513000
049406,T50反1日盛97購01,0,0,0,0,0,0,0,0,0,-516000,0,0,0,0,516000,-516000,-516000
057303,喬山兆豐99購01  ,0,0,0,0,0,0,0,0,0,-517000,0,0,0,0,517000,-517000,-517000
047470,聯發科中信94購03,0,0,0,0,0,0,0,0,0,-520000,0,0,0,0,520000,-520000,-520000
049922,禾伸堂元大95購01,0,0,0,0,0,0,0,0,0,-520000,0,0,0,192000,712000,-520000,-520000
044201,群創國票95購01  ,0,0,0,0,0,0,0,0,0,-522000,0,0,0,193000,715000,-522000,-522000
052451,旭富元大95購02  ,0,0,0,0,0,0,0,0,0,-522000,0,0,0,130000,652000,-522000,-522000
051068,台積電國票97購01,0,0,0,0,0,0,0,0,0,-522000,0,0,0,25000,547000,-522000,-522000
4968,立積            ,141000,623000,-482000,0,0,0,0,0,0,-40000,50000,70000,-20000,6000,26000,-20000,-522000
056491,南亞科國泰99購01,0,0,0,0,0,0,0,0,0,-525000,0,0,0,3000,528000,-525000,-525000
047408,嘉晶統一95購01  ,0,0,0,0,0,0,0,0,0,-525000,0,0,0,65000,590000,-525000,-525000
06152P,玉晶光元大98售06,0,0,0,0,0,0,0,0,0,-527000,0,0,0,84000,611000,-527000,-527000
046685,世紀鋼群益93購02,0,0,0,0,0,0,0,0,0,-528000,0,0,0,0,528000,-528000,-528000
3665,貿聯-KY         ,23000,416000,-393000,0,0,0,0,147000,-147000,11000,6000,0,6000,36000,31000,5000,-529000
046869,聯發科統一95購01,0,0,0,0,0,0,0,0,0,-536000,0,0,0,55000,591000,-536000,-536000
054332,世芯永豐97購01  ,0,0,0,0,0,0,0,0,0,-536000,0,0,0,0,536000,-536000,-536000
052282,宏達電凱基95購05,0,0,0,0,0,0,0,0,0,-536000,0,0,0,27000,563000,-536000,-536000
8996,高力            ,94000,594000,-500000,0,0,0,0,0,0,-36000,0,36000,-36000,0,0,0,-536000
055639,上銀元富97購02  ,0,0,0,0,0,0,0,0,0,-539000,0,0,0,453000,992000,-539000,-539000
8271,宇瞻            ,257000,796000,-539000,0,0,0,0,0,0,0,0,0,0,0,0,0,-539000
051732,華通國票97購01  ,0,0,0,0,0,0,0,0,0,-540000,0,0,0,0,540000,-540000,-540000
052205,台積電中信95購09,0,0,0,0,0,0,0,0,0,-541000,0,0,0,22000,563000,-541000,-541000
04437P,滬深2X群益98售03,0,0,0,0,0,0,0,0,0,-544000,0,0,0,600000,1144000,-544000,-544000
03314P,台積電元大02售16,0,0,0,0,0,0,0,0,0,-552000,0,0,0,1134000,1686000,-552000,-552000
056188,晶相光統一99購01,0,0,0,0,0,0,0,0,0,-553000,0,0,0,159000,712000,-553000,-553000
052924,旺宏永豐96購01  ,0,0,0,0,0,0,0,0,0,-553000,0,0,0,200000,753000,-553000,-553000
053255,貿聯國泰97購01  ,0,0,0,0,0,0,0,0,0,-555000,0,0,0,180000,735000,-555000,-555000
051747,貿聯國泰96購01  ,0,0,0,0,0,0,0,0,0,-562000,0,0,0,291000,853000,-562000,-562000
6251,定穎            ,65000,676000,-611000,0,0,0,0,0,0,42000,52000,10000,42000,0,0,0,-569000
056092,亞德客元富97購02,0,0,0,0,0,0,0,0,0,-570000,0,0,0,75000,645000,-570000,-570000
00715L,街口布蘭特油正2 ,0,0,0,0,0,0,0,0,0,-573000,0,0,0,15000,588000,-573000,-573000
055993,致茂國泰99購01  ,0,0,0,0,0,0,0,0,0,-577000,0,0,0,0,577000,-577000,-577000
056326,TPK兆豐98購01   ,0,0,0,0,0,0,0,0,0,-578000,0,0,0,0,578000,-578000,-578000
00664R,國泰臺灣加權反1 ,0,0,0,0,0,0,0,0,0,-580000,0,0,0,261000,841000,-580000,-580000
055160,玉晶光元大99購03,0,0,0,0,0,0,0,0,0,-580000,0,0,0,127000,707000,-580000,-580000
055671,世紀鋼群益97購01,0,0,0,0,0,0,0,0,0,-586000,0,0,0,59000,645000,-586000,-586000
04373P,滬深2X元大97售01,0,0,0,0,0,0,0,0,0,-588000,0,0,0,741000,1329000,-588000,-588000
054793,牧德群益9A購01  ,0,0,0,0,0,0,0,0,0,-590000,0,0,0,71000,661000,-590000,-590000
047047,旺宏國票95購01  ,0,0,0,0,0,0,0,0,0,-591000,0,0,0,48000,639000,-591000,-591000
054578,世芯元大99購01  ,0,0,0,0,0,0,0,0,0,-591000,0,0,0,10000,601000,-591000,-591000
056767,大毅元大99購01  ,0,0,0,0,0,0,0,0,0,-593000,0,0,0,709000,1302000,-593000,-593000
049007,玉晶光中信96購01,0,0,0,0,0,0,0,0,0,-599000,0,0,0,158000,757000,-599000,-599000
057455,景碩國泰99購01  ,0,0,0,0,0,0,0,0,0,-600000,0,0,0,0,600000,-600000,-600000
057472,T50正2元大9B購03,0,0,0,0,0,0,0,0,0,-600000,0,0,0,0,600000,-600000,-600000
3049,和鑫            ,73000,543000,-470000,0,0,0,0,0,0,-134000,1000,0,1000,0,135000,-135000,-604000
055296,康舒元大97購02  ,0,0,0,0,0,0,0,0,0,-605000,0,0,0,667000,1272000,-605000,-605000
049480,同欣電永豐94購01,0,0,0,0,0,0,0,0,0,-608000,0,0,0,15000,623000,-608000,-608000
052804,淘帝元大96購01  ,0,0,0,0,0,0,0,0,0,-608000,0,0,0,20000,628000,-608000,-608000
056982,華新科群益98購05,0,0,0,0,0,0,0,0,0,-609000,0,0,0,617000,1226000,-609000,-609000
053341,聯發科國票97購03,0,0,0,0,0,0,0,0,0,-616000,0,0,0,39000,655000,-616000,-616000
1310,台苯            ,278000,895000,-617000,0,0,0,0,0,0,0,0,0,0,0,0,0,-617000
057138,亞德客兆豐98購01,0,0,0,0,0,0,0,0,0,-620000,0,0,0,156000,776000,-620000,-620000
052688,新日興元大96購01,0,0,0,0,0,0,0,0,0,-620000,0,0,0,76000,696000,-620000,-620000
052135,聯發科凱基9B購01,0,0,0,0,0,0,0,0,0,-628000,0,0,0,52000,680000,-628000,-628000
053625,國巨兆豐96購03  ,0,0,0,0,0,0,0,0,0,-632000,0,0,0,193000,825000,-632000,-632000
057071,華擎永豐98購02  ,0,0,0,0,0,0,0,0,0,-635000,0,0,0,438000,1073000,-635000,-635000
8215,明基材          ,87000,724000,-637000,0,0,0,0,0,0,2000,2000,0,2000,0,0,0,-635000
2882,國泰金          ,1015000,1659000,-644000,0,0,0,109000,101000,8000,-1000,0,0,0,9000,10000,-1000,-637000
00717,富邦美國特別股  ,0,0,0,0,0,0,0,0,0,-640000,0,0,0,458000,1098000,-640000,-640000
056635,亞德客日盛99購01,0,0,0,0,0,0,0,0,0,-641000,0,0,0,183000,824000,-641000,-641000
2382,廣達            ,1654855,2278000,-623145,0,0,0,101000,12000,89000,-108000,29000,73000,-44000,14000,78000,-64000,-642145
055249,大毅統一99購01  ,0,0,0,0,0,0,0,0,0,-644000,0,0,0,502000,1146000,-644000,-644000
2455,全新            ,363000,623000,-260000,0,0,0,0,374000,-374000,-16000,63000,44000,19000,44000,79000,-35000,-650000
044289,群創凱基93購04  ,0,0,0,0,0,0,0,0,0,-651000,0,0,0,0,651000,-651000,-651000
050899,旭富元大95購01  ,0,0,0,0,0,0,0,0,0,-652000,0,0,0,125000,777000,-652000,-652000
047753,景碩元富93購01  ,0,0,0,0,0,0,0,0,0,-657000,0,0,0,20000,677000,-657000,-657000
055007,晶相光元富9A購02,0,0,0,0,0,0,0,0,0,-659000,0,0,0,78000,737000,-659000,-659000
055743,TPK元富98購01   ,0,0,0,0,0,0,0,0,0,-660000,0,0,0,167000,827000,-660000,-660000
049123,可成元富94購01  ,0,0,0,0,0,0,0,0,0,-660000,0,0,0,0,660000,-660000,-660000
053512,台積電群益96購06,0,0,0,0,0,0,0,0,0,-664000,0,0,0,70000,734000,-664000,-664000
056874,友達凱基98購08  ,0,0,0,0,0,0,0,0,0,-670000,0,0,0,30000,700000,-670000,-670000
2332,友訊            ,113000,800000,-687000,0,0,0,0,0,0,10000,79000,14000,65000,0,55000,-55000,-677000
055701,亞德客富邦99購01,0,0,0,0,0,0,0,0,0,-684000,0,0,0,270000,954000,-684000,-684000
051935,味全群益95購01  ,0,0,0,0,0,0,0,0,0,-685000,0,0,0,1000,686000,-685000,-685000
057434,國巨國票99購03  ,0,0,0,0,0,0,0,0,0,-688000,0,0,0,0,688000,-688000,-688000
055778,美食凱基97購01  ,0,0,0,0,0,0,0,0,0,-700000,0,0,0,10000,710000,-700000,-700000
043958,臻鼎元富94購01  ,0,0,0,0,0,0,0,0,0,-700000,0,0,0,41000,741000,-700000,-700000
054197,台積電永昌96購07,0,0,0,0,0,0,0,0,0,-702000,0,0,0,752000,1454000,-702000,-702000
048177,臺指反富邦99購01,0,0,0,0,0,0,0,0,0,-703000,0,0,0,0,703000,-703000,-703000
057334,技嘉國票98購02  ,0,0,0,0,0,0,0,0,0,-709000,0,0,0,4000,713000,-709000,-709000
041973,台灣50中信94購01,0,0,0,0,0,0,0,0,0,-712000,0,0,0,43000,755000,-712000,-712000
049730,滬深2X群益94購02,0,0,0,0,0,0,0,0,0,-713000,0,0,0,345000,1058000,-713000,-713000
055747,康舒元富97購01  ,0,0,0,0,0,0,0,0,0,-722000,0,0,0,159000,881000,-722000,-722000
045572,元油2X元大98購01,0,0,0,0,0,0,0,0,0,-727000,0,0,0,270000,997000,-727000,-727000
055166,台積電統一97購05,0,0,0,0,0,0,0,0,0,-731000,0,0,0,230000,961000,-731000,-731000
055039,神達富邦99購01  ,0,0,0,0,0,0,0,0,0,-734000,0,0,0,320000,1054000,-734000,-734000
1326,台化            ,479510,1169000,-689490,0,0,0,1000,0,1000,-53000,0,0,0,0,53000,-53000,-741490
053198,亞德客日盛96購01,0,0,0,0,0,0,0,0,0,-748000,0,0,0,105000,853000,-748000,-748000
2308,台達電          ,1305000,2036000,-731000,0,0,0,0,0,0,-22000,7000,4000,3000,7000,32000,-25000,-753000
05480P,滬深2X凱基96售05,0,0,0,0,0,0,0,0,0,-767000,0,0,0,336000,1103000,-767000,-767000
052644,聯發科永豐96購01,0,0,0,0,0,0,0,0,0,-770000,0,0,0,0,770000,-770000,-770000
056439,華邦電凱基98購02,0,0,0,0,0,0,0,0,0,-771000,0,0,0,255000,1026000,-771000,-771000
055015,帆宣元富97購01  ,0,0,0,0,0,0,0,0,0,-774000,0,0,0,45000,819000,-774000,-774000
4935,茂林-KY         ,146000,993000,-847000,0,0,0,486000,0,486000,-420000,52000,68000,-16000,17000,421000,-404000,-781000
056632,鴻海永昌98購01  ,0,0,0,0,0,0,0,0,0,-793000,0,0,0,154000,947000,-793000,-793000
06098P,T50反1日盛97售02,0,0,0,0,0,0,0,0,0,-800000,0,0,0,0,800000,-800000,-800000
047618,義隆凱基94購02  ,0,0,0,0,0,0,0,0,0,-800000,0,0,0,0,800000,-800000,-800000
050319,康控國票95購04  ,0,0,0,0,0,0,0,0,0,-800000,0,0,0,190000,990000,-800000,-800000
054685,國巨永豐97購02  ,0,0,0,0,0,0,0,0,0,-805000,0,0,0,43000,848000,-805000,-805000
044104,鴻海中信95購03  ,0,0,0,0,0,0,0,0,0,-806000,0,0,0,0,806000,-806000,-806000
4943,康控-KY         ,336000,1025000,-689000,0,0,0,0,0,0,-118000,0,0,0,28000,146000,-118000,-807000
055223,和大國票98購01  ,0,0,0,0,0,0,0,0,0,-810000,0,0,0,222000,1032000,-810000,-810000
056048,同欣電兆豐97購01,0,0,0,0,0,0,0,0,0,-814000,0,0,0,177000,991000,-814000,-814000
052225,台積電凱基96購03,0,0,0,0,0,0,0,0,0,-814000,0,0,0,10000,824000,-814000,-814000
056093,大毅元富97購01  ,0,0,0,0,0,0,0,0,0,-839000,0,0,0,665000,1504000,-839000,-839000
054011,旺宏永豐96購05  ,0,0,0,0,0,0,0,0,0,-844000,0,0,0,0,844000,-844000,-844000
056955,台灣50永豐98購01,0,0,0,0,0,0,0,0,0,-855000,0,0,0,78000,933000,-855000,-855000
049970,康控國票95購03  ,0,0,0,0,0,0,0,0,0,-875000,0,0,0,45000,920000,-875000,-875000
054037,T50反1元大96購09,0,0,0,0,0,0,0,0,0,-879000,0,0,0,5000,884000,-879000,-879000
052314,鴻海元大96購11  ,0,0,0,0,0,0,0,0,0,-883000,0,0,0,130000,1013000,-883000,-883000
056344,嘉晶凱基98購02  ,0,0,0,0,0,0,0,0,0,-885000,0,0,0,534000,1419000,-885000,-885000
00693U,街口S&P黃豆     ,0,392000,-392000,0,0,0,0,0,0,-501000,0,0,0,29000,530000,-501000,-893000
047681,滬深反中信95購01,0,0,0,0,0,0,0,0,0,-894000,0,0,0,197000,1091000,-894000,-894000
050400,臻鼎中信97購01  ,0,0,0,0,0,0,0,0,0,-896000,0,0,0,0,896000,-896000,-896000
053148,華邦電元大96購01,0,0,0,0,0,0,0,0,0,-905000,0,0,0,43000,948000,-905000,-905000
055518,華新科中信99購01,0,0,0,0,0,0,0,0,0,-907000,0,0,0,1000,908000,-907000,-907000
048891,傳奇元富97購02  ,0,0,0,0,0,0,0,0,0,-923000,0,0,0,2000,925000,-923000,-923000
054206,鴻海國票99購01  ,0,0,0,0,0,0,0,0,0,-932000,0,0,0,470000,1402000,-932000,-932000
047972,康控富邦95購01  ,0,0,0,0,0,0,0,0,0,-947000,0,0,0,40000,987000,-947000,-947000
048470,神基永豐93購01  ,0,0,0,0,0,0,0,0,0,-950000,0,0,0,0,950000,-950000,-950000
056052,T50反1元大97購06,0,0,0,0,0,0,0,0,0,-953000,0,0,0,0,953000,-953000,-953000
06069P,台積電永豐97售01,0,0,0,0,0,0,0,0,0,-970000,0,0,0,52000,1022000,-970000,-970000
2458,義隆            ,458410,634000,-175590,0,0,0,0,750000,-750000,-49000,12000,66000,-54000,64000,59000,5000,-974590
048889,牧德元富94購03  ,0,0,0,0,0,0,0,0,0,-978000,0,0,0,24000,1002000,-978000,-978000
050885,T50反1富邦95購01,0,0,0,0,0,0,0,0,0,-990000,0,0,0,0,990000,-990000,-990000
047920,南亞科凱基93購04,0,0,0,0,0,0,0,0,0,-999000,0,0,0,0,999000,-999000,-999000
054403,同欣電永豐96購02,0,0,0,0,0,0,0,0,0,-999000,0,0,0,2000,1001000,-999000,-999000
2823,中壽            ,999000,1996000,-997000,0,0,0,1000,0,1000,-9000,0,0,0,16000,25000,-9000,-1005000
4904,遠傳            ,489784,1511000,-1021216,0,0,0,0,0,0,9000,9000,0,9000,0,0,0,-1012216
04511P,臺股指元大94售06,0,0,0,0,0,0,0,0,0,-1013000,0,0,0,430000,1443000,-1013000,-1013000
2504,國產            ,336000,1277000,-941000,0,0,0,0,0,0,-73000,0,0,0,0,73000,-73000,-1014000
053945,國巨富邦98購02  ,10000,0,10000,0,0,0,0,0,0,-1029000,0,0,0,692000,1721000,-1029000,-1019000
3406,玉晶光          ,234000,1113000,-879000,0,0,0,0,120000,-120000,-22000,76000,81000,-5000,14000,31000,-17000,-1021000
2392,正崴            ,177000,449000,-272000,0,0,0,0,668000,-668000,-108000,4000,2000,2000,0,110000,-110000,-1048000
06652P,長榮航元大98售01,0,0,0,0,0,0,0,0,0,-1062000,0,0,0,2000,1064000,-1062000,-1062000
00638R,元大滬深300反1  ,21000,42000,-21000,0,0,0,0,0,0,-1047000,0,15000,-15000,336000,1368000,-1032000,-1068000
054477,聯發科中信9C購02,0,0,0,0,0,0,0,0,0,-1077000,0,0,0,13000,1090000,-1077000,-1077000
049875,台積電永豐94購04,0,0,0,0,0,0,0,0,0,-1139000,0,0,0,115000,1254000,-1139000,-1139000
9938,百和            ,99000,855000,-756000,0,0,0,0,401000,-401000,-13000,1000,0,1000,0,14000,-14000,-1170000
2317,鴻海            ,4743415,5910551,-1167136,0,0,0,2000,0,2000,-14000,21000,14000,7000,345000,366000,-21000,-1179136
4958,臻鼎-KY         ,2945000,3100000,-155000,0,0,0,0,1050000,-1050000,13000,118000,62000,56000,2000,45000,-43000,-1192000
4967,十銓            ,819000,2211000,-1392000,0,0,0,0,0,0,178000,200000,35000,165000,13000,0,13000,-1214000
3515,華擎            ,247000,1517000,-1270000,0,0,0,0,0,0,55000,122000,29000,93000,52000,90000,-38000,-1215000
2801,彰銀            ,706000,1517000,-811000,0,0,0,2000,399000,-397000,-18000,1000,1000,0,0,18000,-18000,-1226000
2327,國巨            ,458000,2009000,-1551000,0,0,0,187000,0,187000,115000,177000,41000,136000,213000,234000,-21000,-1249000
4915,致伸            ,203000,1478000,-1275000,0,0,0,0,0,0,14000,0,0,0,17000,3000,14000,-1261000
3035,智原            ,160000,828000,-668000,0,0,0,0,500000,-500000,-107000,20000,28000,-8000,0,99000,-99000,-1275000
2338,光罩            ,333000,1434000,-1101000,0,0,0,0,0,0,-179000,1000,200000,-199000,227000,207000,20000,-1280000
052986,聯發科元大97購05,0,0,0,0,0,0,0,0,0,-1290000,0,0,0,67000,1357000,-1290000,-1290000
054072,台積電富邦98購02,0,0,0,0,0,0,0,0,0,-1315000,0,0,0,367000,1682000,-1315000,-1315000
4141,龍燈-KY         ,28000,1344000,-1316000,0,0,0,0,0,0,0,0,0,0,0,0,0,-1316000
2337,旺宏            ,4775000,5829000,-1054000,0,0,0,0,1439000,-1439000,1160000,501000,343000,158000,1136000,134000,1002000,-1333000
00692,富邦公司治理    ,0,0,0,0,0,0,0,0,0,-1362000,0,0,0,1201000,2563000,-1362000,-1362000
056829,台積電富邦9A購01,0,0,0,0,0,0,0,0,0,-1388000,0,0,0,466000,1854000,-1388000,-1388000
03021P,玉晶光群益02售25,0,0,0,0,0,0,0,0,0,-1489000,0,0,0,151000,1640000,-1489000,-1489000
055144,T50反1元大97購03,0,0,0,0,0,0,0,0,0,-1498000,0,0,0,366000,1864000,-1498000,-1498000
8039,台虹            ,113000,1498000,-1385000,0,0,0,380000,0,380000,-503000,67000,434000,-367000,12000,148000,-136000,-1508000
2492,華新科          ,610000,2241000,-1631000,0,0,0,76000,190000,-114000,188000,273000,54000,219000,147000,178000,-31000,-1557000
1402,遠東新          ,788000,2398000,-1610000,0,0,0,1000,0,1000,22000,26000,0,26000,0,4000,-4000,-1587000
00701,國泰股利精選30  ,2000,0,2000,0,0,0,0,0,0,-1631000,0,0,0,110000,1741000,-1631000,-1629000
2454,聯發科          ,2520000,3859840,-1339840,0,0,0,1000,328000,-327000,19000,62000,27000,35000,94000,110000,-16000,-1647840
056005,臺股指永豐97購04,0,0,0,0,0,0,0,0,0,-1665000,0,0,0,50000,1715000,-1665000,-1665000
050363,臺指反元大98購04,0,0,0,0,0,0,0,0,0,-1671000,0,0,0,832000,2503000,-1671000,-1671000
00850,元大臺灣ESG永續 ,4000,16000,-12000,0,0,0,0,0,0,-1717000,0,0,0,134000,1851000,-1717000,-1729000
00631L,元大台灣50正2   ,0,503000,-503000,0,0,0,0,0,0,-1258000,0,0,0,77000,1335000,-1258000,-1761000
00634R,富邦上証反1     ,50000,153000,-103000,0,0,0,0,0,0,-1733000,0,1405000,-1405000,792000,1120000,-328000,-1836000
053949,康控富邦9A購01  ,0,0,0,0,0,0,0,0,0,-1847000,0,0,0,15000,1862000,-1847000,-1847000
4927,泰鼎-KY         ,1649000,2005000,-356000,0,0,0,120000,80000,40000,-1536000,6000,59000,-53000,191000,1674000,-1483000,-1852000
052150,台積電富邦95購07,0,0,0,0,0,0,0,0,0,-1865000,0,0,0,350000,2215000,-1865000,-1865000
051405,世芯永豐95購01  ,0,0,0,0,0,0,0,0,0,-1884000,0,0,0,198000,2082000,-1884000,-1884000
055145,T50反1元大97購04,0,0,0,0,0,0,0,0,0,-1918000,0,0,0,0,1918000,-1918000,-1918000
051133,台積電永豐95購02,0,0,0,0,0,0,0,0,0,-1952000,0,0,0,1478000,3430000,-1952000,-1952000
049900,台積電元富94購06,0,0,0,0,0,0,0,0,0,-1984000,0,0,0,605000,2589000,-1984000,-1984000
03033P,微星國票03售01  ,20000,0,20000,0,0,0,0,0,0,-2040000,0,0,0,0,2040000,-2040000,-2020000
1301,台塑            ,433427,2457000,-2023573,0,0,0,1000,0,1000,-8000,3000,4000,-1000,0,7000,-7000,-2030573
2367,燿華            ,1233000,3247000,-2014000,0,0,0,0,0,0,-19000,2000,28000,-26000,78000,71000,7000,-2033000
055655,群創元富99購07  ,0,0,0,0,0,0,0,0,0,-2038000,0,0,0,770000,2808000,-2038000,-2038000
2478,大毅            ,290000,2428000,-2138000,0,0,0,0,0,0,73000,0,45000,-45000,463000,345000,118000,-2065000
2344,華邦電          ,3465000,7679000,-4214000,0,0,0,1036000,0,1036000,1011000,19000,40000,-21000,1107000,75000,1032000,-2167000
044291,群創凱基93購06  ,0,0,0,0,0,0,0,0,0,-2174000,0,0,0,0,2174000,-2174000,-2174000
3450,聯鈞            ,117000,2443000,-2326000,0,0,0,569000,0,569000,-499000,151000,0,151000,103000,753000,-650000,-2256000
2883,開發金          ,766000,2860000,-2094000,0,0,0,3000,0,3000,-268000,2000,0,2000,2000,272000,-270000,-2359000
06118P,上証2X凱基98售03,0,0,0,0,0,0,0,0,0,-2387000,0,0,0,0,2387000,-2387000,-2387000
056270,群創統一98購04  ,0,0,0,0,0,0,0,0,0,-2487000,0,0,0,106000,2593000,-2487000,-2487000
054810,中橡元大9A購01  ,0,0,0,0,0,0,0,0,0,-2518000,0,0,0,176000,2694000,-2518000,-2518000
00641R,富邦日本反1     ,0,1059000,-1059000,0,0,0,0,0,0,-1467000,0,0,0,101000,1568000,-1467000,-2526000
053675,臺股指元富96購02,0,0,0,0,0,0,0,0,0,-2682000,0,0,0,0,2682000,-2682000,-2682000
1714,和桐            ,244000,2944000,-2700000,0,0,0,0,0,0,16000,16000,0,16000,0,0,0,-2684000
051505,台積電元富95購05,0,0,0,0,0,0,0,0,0,-2739000,0,0,0,2191000,4930000,-2739000,-2739000
03648C,T50反1元大96牛07,0,0,0,0,0,0,0,0,0,-2773000,0,0,0,0,2773000,-2773000,-2773000
054400,健策永豐96購02  ,0,0,0,0,0,0,0,0,0,-2805000,0,0,0,424000,3229000,-2805000,-2805000
056293,上銀元大97購10  ,0,0,0,0,0,0,0,0,0,-2869000,0,0,0,77000,2946000,-2869000,-2869000
056350,上銀元大98購02  ,0,0,0,0,0,0,0,0,0,-2928000,0,0,0,112000,3040000,-2928000,-2928000
050256,臺指反元大98購03,0,0,0,0,0,0,0,0,0,-2946000,0,0,0,0,2946000,-2946000,-2946000
2448,晶電            ,642000,2376000,-1734000,0,0,0,0,1242000,-1242000,-17000,166000,183000,-17000,0,0,0,-2993000
056051,T50反1元大97購05,0,0,0,0,0,0,0,0,0,-3079000,0,0,0,10000,3089000,-3079000,-3079000
1101,台泥            ,1412000,4654000,-3242000,0,0,0,1000,0,1000,161000,659000,400000,259000,38000,136000,-98000,-3080000
00642U,元大S&P石油     ,954000,2000,952000,0,0,0,0,0,0,-4034000,0,0,0,945000,4979000,-4034000,-3082000
0050,元大台灣50      ,4000,3351000,-3347000,0,0,0,422000,0,422000,-223000,135000,280000,-145000,661000,739000,-78000,-3148000
2449,京元電子        ,1673000,4110000,-2437000,0,0,0,0,717000,-717000,-61000,305000,124000,181000,11000,253000,-242000,-3215000
2456,奇力新          ,388000,2389000,-2001000,0,0,0,0,1477000,-1477000,-86000,107000,45000,62000,19000,167000,-148000,-3564000
3231,緯創            ,1328000,4838000,-3510000,0,0,0,0,0,0,-153000,7000,4000,3000,50000,206000,-156000,-3663000
1605,華新            ,552000,4301000,-3749000,0,0,0,0,0,0,-384000,2000,10000,-8000,9000,385000,-376000,-4133000
053564,台積電富邦99購01,0,0,0,0,0,0,0,0,0,-4627000,0,0,0,83000,4710000,-4627000,-4627000
051858,上銀凱基95購01  ,0,0,0,0,0,0,0,0,0,-4700000,0,0,0,99000,4799000,-4700000,-4700000
2409,友達            ,14036000,11464952,2571048,0,0,0,0,2800000,-2800000,-4638000,937000,3620000,-2683000,188000,2143000,-1955000,-4866952
053856,台積電富邦98購01,0,0,0,0,0,0,0,0,0,-5602000,0,0,0,0,5602000,-5602000,-5602000
2330,台積電          ,5485531,11006066,-5520535,0,0,0,5000,307000,-302000,52000,409000,350000,59000,67000,74000,-7000,-5770535
2303,聯電            ,15347000,22864000,-7517000,0,0,0,2851000,950000,1901000,-340000,217000,119000,98000,389000,827000,-438000,-5956000
2603,長榮            ,1724010,9027000,-7302990,0,0,0,330000,0,330000,-122000,4000,126000,-122000,0,0,0,-7094990
1314,中石化          ,175000,7505000,-7330000,0,0,0,0,0,0,55000,57000,32000,25000,92000,62000,30000,-7275000
3481,群創            ,43358000,38087000,5271000,0,0,0,0,12576000,-12576000,-1508000,1778000,3515000,-1737000,1400000,1171000,229000,-8813000
00677U,富邦VIX         ,430000,11748000,-11318000,0,0,0,0,0,0,-9283000,0,500000,-500000,499000,9282000,-8783000,-20601000
