證券代號,證券名稱,外陸資買進股數(不含外資自營商),外陸資賣出股數(不含外資自營商),外陸資買賣超股數(不含外資自營商),外資自營商買進股數,外資自營商賣出股數,外資自營商買賣超股數,投信買進股數,投信賣出股數,投信買賣超股數,自營商買賣超股數,自營商買進股數(自行買賣),自營商賣出股數(自行買賣),自營商買賣超股數(自行買賣),自營商買進股數(避險),自營商賣出股數(避險),自營商買賣超股數(避險),三大法人買賣超股數
00677U,富邦VIX         ,45022000,5152000,39870000,0,0,0,0,0,0,7938000,400000,600000,-200000,17924000,9786000,8138000,47808000
2337,旺宏            ,25794000,6142670,19651330,0,0,0,765000,0,765000,3429000,2538000,785000,1753000,1885000,209000,1676000,23845330
2330,台積電          ,35350715,13727404,21623311,0,0,0,374000,169000,205000,-254000,347000,990000,-643000,608000,219000,389000,21574311
3037,欣興            ,17591541,7384000,10207541,0,0,0,4689000,97000,4592000,1189000,1285000,543000,742000,519000,72000,447000,15988541
00708L,元大S&P黃金正2  ,0,211000,-211000,0,0,0,0,0,0,12673000,0,0,0,14001000,1328000,12673000,12462000
00852L,國泰美國道瓊正2 ,5181000,2236000,2945000,0,0,0,0,0,0,8084000,0,0,0,14063000,5979000,8084000,11029000
00875,國泰網路資安    ,1081000,7000,1074000,0,0,0,0,0,0,7692000,0,0,0,8843000,1151000,7692000,8766000
2409,友達            ,30302000,32661000,-2359000,0,0,0,10500000,0,10500000,-819000,3000,954000,-951000,437000,305000,132000,7322000
2884,玉山金          ,19743450,12707555,7035895,0,0,0,0,0,0,45000,0,8000,-8000,101000,48000,53000,7080895
2371,大同            ,6984000,2448000,4536000,0,0,0,0,0,0,440000,421000,69000,352000,88000,0,88000,4976000
3042,晶技            ,4110000,1417000,2693000,0,0,0,898000,0,898000,215000,249000,56000,193000,137000,115000,22000,3806000
6116,彩晶            ,5273000,1833790,3439210,0,0,0,0,0,0,5000,30000,13000,17000,43000,55000,-12000,3444210
00635U,元大S&P黃金     ,1271000,6000,1265000,0,0,0,0,0,0,1738000,0,0,0,1974000,236000,1738000,3003000
2345,智邦            ,5191877,2387259,2804618,0,0,0,484000,461000,23000,36000,164000,110000,54000,26000,44000,-18000,2863618
00861,元大全球未來通訊,0,0,0,0,0,0,0,0,0,2836000,0,0,0,3788000,952000,2836000,2836000
052150,台積電富邦95購07,0,0,0,0,0,0,0,0,0,2679000,0,0,0,2679000,0,2679000,2679000
2603,長榮            ,6024561,4289139,1735422,0,0,0,589000,0,589000,230000,234000,5000,229000,1000,0,1000,2554422
2201,裕隆            ,3690000,1825000,1865000,0,0,0,650000,0,650000,8000,7000,1000,6000,2000,0,2000,2523000
1101,台泥            ,9702786,8130158,1572628,0,0,0,1092000,0,1092000,-467000,65000,520000,-455000,29000,41000,-12000,2197628
00634R,富邦上証反1     ,705000,52000,653000,0,0,0,0,0,0,1457000,0,0,0,1710000,253000,1457000,2110000
2408,南亞科          ,7692000,9427000,-1735000,0,0,0,3645000,672000,2973000,694000,761000,393000,368000,409000,83000,326000,1932000
059869,友達凱基99購07  ,0,0,0,0,0,0,0,0,0,1913000,0,0,0,2067000,154000,1913000,1913000
2323,中環            ,2740000,923000,1817000,0,0,0,5000,0,5000,50000,0,14000,-14000,64000,0,64000,1872000
6176,瑞儀            ,2867000,1849958,1017042,0,0,0,1098000,0,1098000,-260000,52000,406000,-354000,112000,18000,94000,1855042
056138,群創元大9B購01  ,0,0,0,0,0,0,0,0,0,1844000,0,0,0,1845000,1000,1844000,1844000
2449,京元電子        ,5016000,3686084,1329916,0,0,0,0,0,0,431000,61000,23000,38000,442000,49000,393000,1760916
3711,日月光投控      ,5265000,4871000,394000,0,0,0,1134000,0,1134000,205000,286000,201000,85000,139000,19000,120000,1733000
060055,宏達電凱基99購06,0,0,0,0,0,0,0,0,0,1612000,0,0,0,1677000,65000,1612000,1612000
2890,永豐金          ,13864000,12298210,1565790,0,0,0,0,0,0,1000,1000,0,1000,0,0,0,1566790
3189,景碩            ,1934000,691000,1243000,0,0,0,391000,0,391000,-69000,22000,90000,-68000,29000,30000,-1000,1565000
054556,世芯凱基99購01  ,0,0,0,0,0,0,0,0,0,1546000,0,0,0,1546000,0,1546000,1546000
4927,泰鼎-KY         ,1542000,1076000,466000,0,0,0,1395000,549000,846000,219000,82000,0,82000,203000,66000,137000,1531000
00673R,元大S&P原油反1  ,81000,81000,0,0,0,0,0,0,0,1504000,0,0,0,3154000,1650000,1504000,1504000
2375,凱美            ,1661000,214000,1447000,0,0,0,0,0,0,46000,0,0,0,46000,0,46000,1493000
057850,上銀兆豐99購02  ,0,0,0,0,0,0,0,0,0,1485000,0,0,0,2250000,765000,1485000,1485000
2456,奇力新          ,1782000,1331000,451000,0,0,0,885000,0,885000,148000,60000,86000,-26000,178000,4000,174000,1484000
2324,仁寶            ,11435289,10194519,1240770,0,0,0,0,0,0,241000,338000,121000,217000,98000,74000,24000,1481770
2349,錸德            ,1578000,104000,1474000,0,0,0,4000,0,4000,0,0,0,0,0,0,0,1478000
2368,金像電          ,7672000,2984000,4688000,0,0,0,150000,2475000,-2325000,-925000,10000,935000,-925000,0,0,0,1438000
6153,嘉聯益          ,1908000,942000,966000,0,0,0,0,0,0,416000,317000,161000,156000,261000,1000,260000,1382000
00647L,元大S&P500正2   ,25000,21000,4000,0,0,0,0,0,0,1376000,0,0,0,2142000,766000,1376000,1380000
00670L,富邦NASDAQ正2   ,190000,190000,0,0,0,0,0,0,0,1365000,0,0,0,2335000,970000,1365000,1365000
053856,台積電富邦98購01,0,0,0,0,0,0,0,0,0,1351000,0,0,0,1351000,0,1351000,1351000
3682,亞太電          ,1960000,646000,1314000,0,0,0,0,0,0,0,0,0,0,0,0,0,1314000
1536,和大            ,2066000,233000,1833000,0,0,0,0,717000,-717000,167000,134000,8000,126000,41000,0,41000,1283000
056325,群創兆豐9A購01  ,0,0,0,0,0,0,0,0,0,1267000,0,0,0,1277000,10000,1267000,1267000
051107,鴻海統一95購05  ,0,0,0,0,0,0,0,0,0,1248000,0,0,0,1248000,0,1248000,1248000
054560,全新群益98購03  ,0,0,0,0,0,0,0,0,0,1207000,0,0,0,1207000,0,1207000,1207000
2504,國產            ,1991000,810000,1181000,0,0,0,0,0,0,10000,0,3000,-3000,13000,0,13000,1191000
056829,台積電富邦9A購01,0,0,0,0,0,0,0,0,0,1183000,0,0,0,1541000,358000,1183000,1183000
053925,群創國票98購01  ,0,0,0,0,0,0,0,0,0,1181000,0,0,0,1181000,0,1181000,1181000
059680,台積電國泰9A購03,0,0,0,0,0,0,0,0,0,1128000,0,0,0,1314000,186000,1128000,1128000
3545,敦泰            ,2135000,1042000,1093000,0,0,0,0,0,0,19000,20000,1000,19000,0,0,0,1112000
6278,台表科          ,2103000,2481000,-378000,0,0,0,1365000,0,1365000,125000,0,27000,-27000,158000,6000,152000,1112000
2338,光罩            ,1348000,310000,1038000,0,0,0,0,0,0,70000,0,0,0,70000,0,70000,1108000
07142P,台灣50元大01售01,0,0,0,0,0,0,0,0,0,1108000,0,0,0,1108000,0,1108000,1108000
6202,盛群            ,1346000,258000,1088000,0,0,0,0,0,0,-10000,0,10000,-10000,0,0,0,1078000
059128,友達中信99購02  ,0,0,0,0,0,0,0,0,0,1063000,0,0,0,1631000,568000,1063000,1063000
3515,華擎            ,2031000,1009000,1022000,0,0,0,0,16000,-16000,51000,44000,39000,5000,96000,50000,46000,1057000
056329,上銀國票98購02  ,0,0,0,0,0,0,0,0,0,1027000,0,0,0,1027000,0,1027000,1027000
2104,國際中橡        ,2095000,1082158,1012842,0,0,0,0,0,0,-1000,0,1000,-1000,0,0,0,1011842
2363,矽統            ,2311000,1300000,1011000,0,0,0,0,0,0,-6000,0,6000,-6000,0,0,0,1005000
060099,宏達電元大99購09,0,0,0,0,0,0,0,0,0,1003000,0,0,0,1028000,25000,1003000,1003000
050437,聯詠凱基94購04  ,0,0,0,0,0,0,0,0,0,997000,0,0,0,997000,0,997000,997000
057855,晶技國票99購01  ,0,0,0,0,0,0,0,0,0,990000,0,0,0,990000,0,990000,990000
5876,上海商銀        ,3658540,2666919,991621,0,0,0,0,0,0,-10000,0,11000,-11000,1000,0,1000,981621
00638R,元大滬深300反1  ,606000,0,606000,0,0,0,0,0,0,358000,0,0,0,389000,31000,358000,964000
3576,聯合再生        ,1166000,204000,962000,0,0,0,0,0,0,0,0,0,0,0,0,0,962000
051280,台積電兆豐95購04,0,0,0,0,0,0,0,0,0,950000,0,0,0,950000,0,950000,950000
053654,聯發科凱基98購01,0,0,0,0,0,0,0,0,0,940000,0,0,0,940000,0,940000,940000
056270,群創統一98購04  ,0,0,0,0,0,0,0,0,0,939000,0,0,0,939000,0,939000,939000
9938,百和            ,984000,594000,390000,0,0,0,450000,0,450000,97000,91000,24000,67000,48000,18000,30000,937000
056774,和鑫元大98購01  ,0,0,0,0,0,0,0,0,0,936000,0,0,0,966000,30000,936000,936000
2809,京城銀          ,3134000,1904000,1230000,0,0,0,0,300000,-300000,5000,6000,1000,5000,0,0,0,935000
00830,國泰費城半導體  ,794000,15000,779000,0,0,0,0,0,0,148000,0,0,0,515000,367000,148000,927000
059307,T50反1元大99購06,0,0,0,0,0,0,0,0,0,916000,0,0,0,1581000,665000,916000,916000
059640,聯詠凱基99購04  ,0,0,0,0,0,0,0,0,0,909000,0,0,0,1283000,374000,909000,909000
051721,玉晶光永豐96購02,0,0,0,0,0,0,0,0,0,908000,0,0,0,1332000,424000,908000,908000
3596,智易            ,1183000,323000,860000,0,0,0,0,0,0,15000,5000,2000,3000,15000,3000,12000,875000
055881,康控元富97購01  ,0,0,0,0,0,0,0,0,0,858000,0,0,0,858000,0,858000,858000
5871,中租-KY         ,7887000,7091357,795643,0,0,0,0,0,0,56000,30000,26000,4000,52000,0,52000,851643
051133,台積電永豐95購02,0,0,0,0,0,0,0,0,0,846000,0,0,0,846000,0,846000,846000
051277,聯發科中信9A購01,0,6000,-6000,0,0,0,0,0,0,849000,0,0,0,849000,0,849000,843000
058920,SGBR2X元富99購06,0,0,0,0,0,0,0,0,0,835000,0,0,0,1360000,525000,835000,835000
9958,世紀鋼          ,1397000,675000,722000,0,0,0,0,5000,-5000,118000,3000,2000,1000,169000,52000,117000,835000
059628,智邦凱基99購04  ,0,110000,-110000,0,0,0,0,0,0,937000,0,0,0,1149000,212000,937000,827000
059343,宏達電凱基99購04,0,0,0,0,0,0,0,0,0,823000,0,0,0,831000,8000,823000,823000
058203,信邦凱基99購01  ,0,0,0,0,0,0,0,0,0,817000,0,0,0,895000,78000,817000,817000
2880,華南金          ,6383000,5544742,838258,0,0,0,0,0,0,-27000,0,53000,-53000,26000,0,26000,811258
051614,元金2X凱基97購01,0,0,0,0,0,0,0,0,0,810000,0,0,0,810000,0,810000,810000
4935,茂林-KY         ,514000,433000,81000,0,0,0,481000,15000,466000,261000,229000,0,229000,69000,37000,32000,808000
052863,友達凱基98購02  ,0,0,0,0,0,0,0,0,0,799000,0,0,0,799000,0,799000,799000
03016P,滬深2X群益01售09,0,0,0,0,0,0,0,0,0,795000,0,0,0,795000,0,795000,795000
050410,燿華永豐95購03  ,0,0,0,0,0,0,0,0,0,794000,0,0,0,794000,0,794000,794000
052775,滬深2X國票99購02,0,0,0,0,0,0,0,0,0,791000,0,0,0,1022000,231000,791000,791000
2356,英業達          ,8177000,7411000,766000,0,0,0,0,0,0,16000,240000,320000,-80000,165000,69000,96000,782000
3661,世芯-KY         ,1161000,824000,337000,0,0,0,368000,0,368000,75000,68000,33000,35000,54000,14000,40000,780000
2478,大毅            ,1235000,532000,703000,0,0,0,0,0,0,74000,0,1000,-1000,80000,5000,75000,777000
057960,聯鈞元大98購02  ,0,0,0,0,0,0,0,0,0,776000,0,0,0,944000,168000,776000,776000
059286,S&P正2元富01購03,0,0,0,0,0,0,0,0,0,770000,0,0,0,825000,55000,770000,770000
8039,台虹            ,1225000,642000,583000,0,0,0,0,0,0,175000,72000,10000,62000,123000,10000,113000,758000
049595,麗豐元大95購01  ,0,0,0,0,0,0,0,0,0,757000,0,0,0,757000,0,757000,757000
051405,世芯永豐95購01  ,0,0,0,0,0,0,0,0,0,736000,0,0,0,736000,0,736000,736000
055166,台積電統一97購05,0,0,0,0,0,0,0,0,0,735000,0,0,0,735000,0,735000,735000
0056,元大高股息      ,39000,42000,-3000,0,0,0,149000,0,149000,587000,275000,200000,75000,2365000,1853000,512000,733000
058134,信邦元大99購01  ,0,0,0,0,0,0,0,0,0,729000,0,0,0,729000,0,729000,729000
059859,國巨群益9A購03  ,0,0,0,0,0,0,0,0,0,726000,0,0,0,785000,59000,726000,726000
046942,友達元大99購01  ,0,0,0,0,0,0,0,0,0,719000,0,0,0,907000,188000,719000,719000
6269,台郡            ,2185000,976000,1209000,0,0,0,469000,982000,-513000,22000,96000,142000,-46000,70000,2000,68000,718000
054204,元金2X國票9B購02,0,0,0,0,0,0,0,0,0,717000,0,0,0,717000,0,717000,717000
049108,玉晶光富邦96購02,0,0,0,0,0,0,0,0,0,715000,0,0,0,718000,3000,715000,715000
053563,台積電富邦97購01,0,0,0,0,0,0,0,0,0,712000,0,0,0,712000,0,712000,712000
3044,健鼎            ,1600000,1118581,481419,0,0,0,223000,0,223000,4000,6000,9000,-3000,8000,1000,7000,708419
2383,台光電          ,1298020,1154000,144020,0,0,0,591000,0,591000,-29000,21000,46000,-25000,13000,17000,-4000,706020
052587,景碩永豐97購01  ,0,0,0,0,0,0,0,0,0,700000,0,0,0,700000,0,700000,700000
053027,玉晶光富邦98購01,0,0,0,0,0,0,0,0,0,699000,0,0,0,699000,0,699000,699000
2723,美食-KY         ,491000,309000,182000,0,0,0,523000,0,523000,-11000,0,3000,-3000,2000,10000,-8000,694000
059907,道瓊指元大99購03,0,0,0,0,0,0,0,0,0,692000,0,0,0,797000,105000,692000,692000
1325,恆大            ,1899000,1198000,701000,0,0,0,0,0,0,-10000,0,10000,-10000,0,0,0,691000
03412P,滬深2X群益98售01,0,0,0,0,0,0,0,0,0,690000,0,0,0,690000,0,690000,690000
057043,台積電元大99購02,0,0,0,0,0,0,0,0,0,689000,0,0,0,689000,0,689000,689000
059153,臺股指國票99購16,0,0,0,0,0,0,0,0,0,684000,0,0,0,1118000,434000,684000,684000
2392,正崴            ,2050000,1924000,126000,0,0,0,631000,0,631000,-75000,0,22000,-22000,2000,55000,-53000,682000
5469,瀚宇博          ,1439000,1478000,-39000,0,0,0,529000,0,529000,191000,29000,4000,25000,188000,22000,166000,681000
2404,漢唐            ,1366000,746000,620000,0,0,0,1000,0,1000,50000,27000,6000,21000,47000,18000,29000,671000
3673,TPK-KY          ,1802000,1120000,682000,0,0,0,0,0,0,-14000,88000,132000,-44000,62000,32000,30000,668000
044429,元金2X元大94購04,0,0,0,0,0,0,0,0,0,668000,0,0,0,738000,70000,668000,668000
2834,臺企銀          ,11735000,11225060,509940,0,0,0,0,0,0,158000,46000,6000,40000,128000,10000,118000,667940
051971,元金2X凱基97購02,0,0,0,0,0,0,0,0,0,666000,0,0,0,666000,0,666000,666000
057207,立積元富98購02  ,25000,0,25000,0,0,0,0,0,0,640000,0,0,0,1263000,623000,640000,665000
057206,立積元富98購01  ,0,0,0,0,0,0,0,0,0,664000,0,0,0,1531000,867000,664000,664000
057697,國巨群益98購09  ,0,0,0,0,0,0,0,0,0,653000,0,0,0,653000,0,653000,653000
3035,智原            ,1075000,440450,634550,0,0,0,1000,0,1000,14000,4000,4000,0,21000,7000,14000,649550
06142P,台虹康和97售02  ,0,0,0,0,0,0,0,0,0,646000,0,0,0,695000,49000,646000,646000
2367,燿華            ,3860000,3264000,596000,0,0,0,0,0,0,47000,0,0,0,54000,7000,47000,643000
3026,禾伸堂          ,861000,304000,557000,0,0,0,0,0,0,80000,6000,0,6000,83000,9000,74000,637000
07280P,FBVIX凱基99售01 ,0,0,0,0,0,0,0,0,0,636000,0,0,0,666000,30000,636000,636000
05446P,緯穎元大95售04  ,0,0,0,0,0,0,0,0,0,635000,0,0,0,655000,20000,635000,635000
2882,國泰金          ,8412000,7843744,568256,0,0,0,0,0,0,57000,0,16000,-16000,73000,0,73000,625256
2439,美律            ,962000,334000,628000,0,0,0,2000,0,2000,-6000,0,9000,-9000,64000,61000,3000,624000
03440B,臺股指元大9B熊02,0,0,0,0,0,0,0,0,0,623000,0,0,0,1016000,393000,623000,623000
057730,聯鈞國泰9A購01  ,0,0,0,0,0,0,0,0,0,620000,0,0,0,1034000,414000,620000,620000
3704,合勤控          ,828000,226000,602000,0,0,0,0,0,0,17000,0,0,0,17000,0,17000,619000
056916,台達電兆豐98購02,0,0,0,0,0,0,0,0,0,618000,0,0,0,623000,5000,618000,618000
054987,凱美元富97購01  ,0,0,0,0,0,0,0,0,0,615000,0,0,0,615000,0,615000,615000
06889P,臺股指元大98售13,0,0,0,0,0,0,0,0,0,610000,0,0,0,634000,24000,610000,610000
2883,開發金          ,10834753,10250095,584658,0,0,0,0,0,0,23000,1000,7000,-6000,61000,32000,29000,607658
058486,大立光國票9A購01,0,0,0,0,0,0,0,0,0,606000,0,0,0,606000,0,606000,606000
053978,創意元大96購05  ,0,0,0,0,0,0,0,0,0,603000,0,0,0,623000,20000,603000,603000
07121P,華新科凱基99售03,0,0,0,0,0,0,0,0,0,600000,0,0,0,600000,0,600000,600000
3019,亞光            ,1206000,868000,338000,0,0,0,0,0,0,255000,268000,127000,141000,125000,11000,114000,593000
059051,和大凱基9A購01  ,0,0,0,0,0,0,0,0,0,592000,0,0,0,683000,91000,592000,592000
3665,貿聯-KY         ,909000,498000,411000,0,0,0,104000,2000,102000,73000,78000,29000,49000,25000,1000,24000,586000
056505,聯發科永豐98購01,0,0,0,0,0,0,0,0,0,578000,0,0,0,648000,70000,578000,578000
00640L,富邦日本正2     ,79000,78000,1000,0,0,0,0,0,0,571000,0,0,0,1613000,1042000,571000,572000
059730,晶相光元大9C購02,0,0,0,0,0,0,0,0,0,569000,0,0,0,710000,141000,569000,569000
2105,正新            ,3291000,2749227,541773,0,0,0,0,0,0,22000,34000,39000,-5000,27000,0,27000,563773
2314,台揚            ,678000,112000,566000,0,0,0,0,0,0,-9000,0,0,0,0,9000,-9000,557000
059842,台積電富邦9C購05,0,0,0,0,0,0,0,0,0,553000,0,0,0,588000,35000,553000,553000
059255,臺股指凱基99購33,0,0,0,0,0,0,0,0,0,552000,0,0,0,714000,162000,552000,552000
054533,泰碩國泰98購01  ,0,0,0,0,0,0,0,0,0,552000,0,0,0,1217000,665000,552000,552000
07319P,台積電凱基01售02,0,0,0,0,0,0,0,0,0,551000,0,0,0,788000,237000,551000,551000
056211,南港國票98購01  ,0,0,0,0,0,0,0,0,0,550000,0,0,0,560000,10000,550000,550000
059878,聯茂凱基99購07  ,0,0,0,0,0,0,0,0,0,548000,0,0,0,777000,229000,548000,548000
4943,康控-KY         ,849000,318000,531000,0,0,0,0,0,0,14000,0,0,0,27000,13000,14000,545000
058405,訊連元大99購02  ,0,0,0,0,0,0,0,0,0,545000,0,0,0,555000,10000,545000,545000
057820,華擎元大98購02  ,2000,0,2000,0,0,0,0,0,0,542000,0,0,0,800000,258000,542000,544000
050791,聯發科富邦96購01,0,0,0,0,0,0,0,0,0,544000,0,0,0,544000,0,544000,544000
058531,華通元富99購01  ,0,0,0,0,0,0,0,0,0,543000,0,0,0,1196000,653000,543000,543000
058426,旺宏元富99購02  ,0,0,0,0,0,0,0,0,0,542000,0,0,0,542000,0,542000,542000
052135,聯發科凱基9B購01,0,0,0,0,0,0,0,0,0,541000,0,0,0,541000,0,541000,541000
059213,國巨元大99購19  ,0,0,0,0,0,0,0,0,0,541000,0,0,0,576000,35000,541000,541000
057822,牧德元大9A購01  ,0,0,0,0,0,0,0,0,0,537000,0,0,0,537000,0,537000,537000
06025P,臺股指元大99售02,0,0,0,0,0,0,0,0,0,532000,0,0,0,752000,220000,532000,532000
053167,欣興群益96購03  ,0,0,0,0,0,0,0,0,0,528000,0,0,0,528000,0,528000,528000
2448,晶電            ,3325000,3345000,-20000,0,0,0,600000,0,600000,-53000,446000,533000,-87000,46000,12000,34000,527000
00672L,元大S&P原油正2  ,56000,64000,-8000,0,0,0,0,0,0,535000,0,0,0,1655000,1120000,535000,527000
3653,健策            ,433000,338000,95000,0,0,0,210000,0,210000,220000,124000,22000,102000,168000,50000,118000,525000
054988,凱美元富97購02  ,0,0,0,0,0,0,0,0,0,520000,0,0,0,520000,0,520000,520000
056926,日月光兆豐98購01,0,0,0,0,0,0,0,0,0,508000,0,0,0,580000,72000,508000,508000
059606,上銀富邦9B購02  ,0,0,0,0,0,0,0,0,0,506000,0,0,0,574000,68000,506000,506000
2369,菱生            ,835000,331000,504000,0,0,0,0,0,0,0,0,0,0,0,0,0,504000
049007,玉晶光中信96購01,0,0,0,0,0,0,0,0,0,504000,0,0,0,504000,0,504000,504000
052093,麗豐元大96購04  ,0,0,0,0,0,0,0,0,0,500000,0,0,0,500000,0,500000,500000
053971,聯發科元大97購09,0,0,0,0,0,0,0,0,0,500000,0,0,0,500000,0,500000,500000
056643,奇力新凱基99購01,0,0,0,0,0,0,0,0,0,500000,0,0,0,500000,0,500000,500000
055024,興勤國泰98購01  ,0,0,0,0,0,0,0,0,0,500000,0,0,0,500000,0,500000,500000
051790,貿聯國票95購03  ,0,0,0,0,0,0,0,0,0,499000,0,0,0,499000,0,499000,499000
058688,矽創凱基9A購01  ,0,0,0,0,0,0,0,0,0,495000,0,0,0,1033000,538000,495000,495000
054477,聯發科中信9C購02,0,0,0,0,0,0,0,0,0,493000,0,0,0,493000,0,493000,493000
055061,聯詠永豐97購01  ,0,0,0,0,0,0,0,0,0,492000,0,0,0,492000,0,492000,492000
060171,宏達電台新9A購01,0,0,0,0,0,0,0,0,0,487000,0,0,0,487000,0,487000,487000
5215,科嘉-KY         ,183000,212000,-29000,0,0,0,515000,0,515000,0,0,0,0,0,0,0,486000
058283,世紀鋼中信99購01,0,0,0,0,0,0,0,0,0,486000,0,0,0,830000,344000,486000,486000
055733,奇力新元富97購01,0,0,0,0,0,0,0,0,0,475000,0,0,0,525000,50000,475000,475000
053077,同欣電永豐96購01,0,0,0,0,0,0,0,0,0,464000,0,0,0,464000,0,464000,464000
054862,群光群益97購01  ,0,0,0,0,0,0,0,0,0,460000,0,0,0,610000,150000,460000,460000
6669,緯穎            ,708000,270080,437920,0,0,0,41000,30000,11000,11000,20000,19000,1000,17000,7000,10000,459920
2329,華泰            ,1338000,903000,435000,0,0,0,0,0,0,15000,1000,2000,-1000,16000,0,16000,450000
053672,嘉澤元富96購02  ,0,0,0,0,0,0,0,0,0,443000,0,0,0,580000,137000,443000,443000
048527,鴻海國票94購02  ,0,0,0,0,0,0,0,0,0,441000,0,0,0,441000,0,441000,441000
020012,富邦行動通訊N   ,0,0,0,0,0,0,0,0,0,441000,0,0,0,562000,121000,441000,441000
045053,聯發科元富98購01,0,0,0,0,0,0,0,0,0,441000,0,0,0,441000,0,441000,441000
1736,喬山            ,552000,186000,366000,0,0,0,0,0,0,74000,48000,1000,47000,38000,11000,27000,440000
053631,欣興兆豐97購01  ,0,0,0,0,0,0,0,0,0,433000,0,0,0,467000,34000,433000,433000
059689,南亞科永豐99購02,0,0,0,0,0,0,0,0,0,432000,0,0,0,762000,330000,432000,432000
8112,至上            ,1316000,1734000,-418000,0,0,0,3000,0,3000,846000,434000,13000,421000,425000,0,425000,431000
050615,奇力新元大95購03,0,0,0,0,0,0,0,0,0,429000,0,0,0,555000,126000,429000,429000
059468,智邦元大99購02  ,0,0,0,0,0,0,0,0,0,428000,0,0,0,468000,40000,428000,428000
048748,國巨元富96購01  ,0,0,0,0,0,0,0,0,0,428000,0,0,0,776000,348000,428000,428000
3041,揚智            ,840000,414000,426000,0,0,0,0,0,0,0,0,0,0,0,0,0,426000
050116,嘉澤元大94購03  ,0,0,0,0,0,0,0,0,0,425000,0,0,0,495000,70000,425000,425000
2601,益航            ,819000,398000,421000,0,0,0,0,0,0,0,0,0,0,0,0,0,421000
056027,樺漢群益97購02  ,0,0,0,0,0,0,0,0,0,420000,0,0,0,420000,0,420000,420000
2328,廣宇            ,737000,428000,309000,0,0,0,0,0,0,109000,126000,32000,94000,15000,0,15000,418000
047505,元金2X國票9B購01,0,0,0,0,0,0,0,0,0,418000,0,0,0,418000,0,418000,418000
057173,南亞科元大98購04,0,0,0,0,0,0,0,0,0,415000,0,0,0,415000,0,415000,415000
6552,易華電          ,570000,159000,411000,0,0,0,0,0,0,3000,0,5000,-5000,10000,2000,8000,414000
6251,定穎            ,1040000,1167000,-127000,0,0,0,0,0,0,540000,580000,40000,540000,0,0,0,413000
3016,嘉晶            ,786000,379000,407000,0,0,0,0,0,0,6000,0,0,0,12000,6000,6000,413000
056392,玉晶光富邦9C購01,0,0,0,0,0,0,0,0,0,411000,0,0,0,411000,0,411000,411000
06869P,金融類元大99售01,0,0,0,0,0,0,0,0,0,410000,0,0,0,410000,0,410000,410000
8271,宇瞻            ,584000,176000,408000,0,0,0,0,0,0,0,0,0,0,0,0,0,408000
3006,晶豪科          ,782000,365000,417000,0,0,0,0,0,0,-10000,44000,54000,-10000,0,0,0,407000
1303,南亞            ,3234000,2862513,371487,0,0,0,44000,0,44000,-9000,10000,21000,-11000,2000,0,2000,406487
059822,聯發科凱基99購19,0,0,0,0,0,0,0,0,0,404000,0,0,0,524000,120000,404000,404000
3029,零壹            ,514000,176000,338000,0,0,0,0,0,0,64000,64000,0,64000,0,0,0,402000
047885,元金2X富邦99購01,0,0,0,0,0,0,0,0,0,402000,0,0,0,402000,0,402000,402000
051231,健策群益97購01  ,0,0,0,0,0,0,0,0,0,401000,0,0,0,401000,0,401000,401000
050877,美律統一95購01  ,0,0,0,0,0,0,0,0,0,400000,0,0,0,400000,0,400000,400000
051058,景碩群益96購01  ,0,0,0,0,0,0,0,0,0,400000,0,0,0,400000,0,400000,400000
050691,楠梓電凱基96購01,0,0,0,0,0,0,0,0,0,400000,0,0,0,400000,0,400000,400000
056479,玉晶光元大99購05,0,0,0,0,0,0,0,0,0,400000,0,0,0,576000,176000,400000,400000
055677,喬山凱基97購01  ,0,0,0,0,0,0,0,0,0,400000,0,0,0,400000,0,400000,400000
054662,同欣電元大97購02,0,0,0,0,0,0,0,0,0,400000,0,0,0,400000,0,400000,400000
059574,台表科凱基99購02,0,0,0,0,0,0,0,0,0,399000,0,0,0,411000,12000,399000,399000
059135,臺股指群益99購10,0,0,0,0,0,0,0,0,0,399000,0,0,0,418000,19000,399000,399000
6456,GIS-KY          ,1076000,689000,387000,0,0,0,0,0,0,10000,0,0,0,13000,3000,10000,397000
056473,奇力新元大99購02,0,0,0,0,0,0,0,0,0,396000,0,0,0,518000,122000,396000,396000
2360,致茂            ,639609,271000,368609,0,0,0,0,0,0,27000,18000,8000,10000,17000,0,17000,395609
1216,統一            ,9159000,9462313,-303313,0,0,0,733000,0,733000,-37000,6000,43000,-37000,0,0,0,392687
9802,鈺齊-KY         ,852000,362000,490000,0,0,0,0,100000,-100000,1000,0,0,0,1000,0,1000,391000
059370,玉晶光元富99購02,0,0,0,0,0,0,0,0,0,387000,0,0,0,1388000,1001000,387000,387000
059819,台積電凱基99購17,0,0,0,0,0,0,0,0,0,386000,0,0,0,433000,47000,386000,386000
057475,聯電元大9A購01  ,0,0,0,0,0,0,0,0,0,386000,0,0,0,1200000,814000,386000,386000
050754,元金2X元富9B購01,0,0,0,0,0,0,0,0,0,382000,0,0,0,382000,0,382000,382000
052994,群創台新99購01  ,0,0,0,0,0,0,0,0,0,382000,0,0,0,382000,0,382000,382000
058204,世芯凱基9A購01  ,0,0,0,0,0,0,0,0,0,380000,0,0,0,686000,306000,380000,380000
056523,光寶科中信98購01,0,0,0,0,0,0,0,0,0,378000,0,0,0,378000,0,378000,378000
057300,訊連永豐98購01  ,0,0,0,0,0,0,0,0,0,378000,0,0,0,380000,2000,378000,378000
059387,華通凱基9A購03  ,0,0,0,0,0,0,0,0,0,377000,0,0,0,438000,61000,377000,377000
056925,群創兆豐98購03  ,0,0,0,0,0,0,0,0,0,377000,0,0,0,387000,10000,377000,377000
6141,柏承            ,471000,96000,375000,0,0,0,0,0,0,0,0,0,0,0,0,0,375000
058026,上銀富邦9A購01  ,0,0,0,0,0,0,0,0,0,374000,0,0,0,374000,0,374000,374000
00692,富邦公司治理    ,6245,2000,4245,0,0,0,0,0,0,369000,0,0,0,1930000,1561000,369000,373245
059871,義隆凱基99購03  ,0,0,0,0,0,0,0,0,0,373000,0,0,0,422000,49000,373000,373000
058456,京鼎永豐99購01  ,0,0,0,0,0,0,0,0,0,373000,0,0,0,483000,110000,373000,373000
059514,嘉澤永豐99購02  ,0,0,0,0,0,0,0,0,0,371000,0,0,0,566000,195000,371000,371000
059614,致新永豐99購01  ,0,0,0,0,0,0,0,0,0,370000,0,0,0,623000,253000,370000,370000
054072,台積電富邦98購02,0,0,0,0,0,0,0,0,0,370000,0,0,0,370000,0,370000,370000
055286,晶技元大98購03  ,0,0,0,0,0,0,0,0,0,370000,0,0,0,370000,0,370000,370000
2406,國碩            ,445000,78000,367000,0,0,0,0,0,0,0,0,0,0,0,0,0,367000
8028,昇陽半導體      ,722000,368000,354000,0,0,0,0,0,0,13000,3000,0,3000,18000,8000,10000,367000
058836,FBVIX中信03購05 ,0,0,0,0,0,0,0,0,0,366000,0,0,0,508000,142000,366000,366000
055863,緯穎元大97購05  ,0,0,0,0,0,0,0,0,0,365000,0,0,0,374000,9000,365000,365000
051403,玉晶光永豐95購05,0,0,0,0,0,0,0,0,0,363000,0,0,0,611000,248000,363000,363000
058985,可成凱基99購03  ,0,0,0,0,0,0,0,0,0,361000,0,0,0,395000,34000,361000,361000
054999,玉晶光元富97購03,0,0,0,0,0,0,0,0,0,360000,0,0,0,360000,0,360000,360000
055448,健策統一97購02  ,0,0,0,0,0,0,0,0,0,360000,0,0,0,360000,0,360000,360000
1592,英瑞-KY         ,497000,138000,359000,0,0,0,0,0,0,0,0,0,0,0,0,0,359000
00631L,元大台灣50正2   ,335000,312000,23000,0,0,0,0,0,0,333000,0,0,0,4920000,4587000,333000,356000
057815,信邦元大98購01  ,0,0,0,0,0,0,0,0,0,356000,0,0,0,457000,101000,356000,356000
058684,健策凱基99購02  ,0,0,0,0,0,0,0,0,0,355000,0,0,0,867000,512000,355000,355000
052936,華通兆豐98購01  ,0,0,0,0,0,0,0,0,0,354000,0,0,0,364000,10000,354000,354000
2454,聯發科          ,5825550,6008725,-183175,0,0,0,380000,3000,377000,158000,252000,109000,143000,64000,49000,15000,351825
056488,致新元大99購01  ,0,0,0,0,0,0,0,0,0,351000,0,0,0,665000,314000,351000,351000
058245,訊連元大99購01  ,0,0,0,0,0,0,0,0,0,351000,0,0,0,351000,0,351000,351000
058730,玉晶光永豐9A購01,0,0,0,0,0,0,0,0,0,351000,0,0,0,632000,281000,351000,351000
053064,國巨群益96購04  ,0,0,0,0,0,0,0,0,0,350000,0,0,0,387000,37000,350000,350000
054947,興勤元大97購01  ,0,0,0,0,0,0,0,0,0,350000,0,0,0,350000,0,350000,350000
059578,智邦元富99購02  ,0,0,0,0,0,0,0,0,0,347000,0,0,0,555000,208000,347000,347000
059528,華新科凱基99購06,0,0,0,0,0,0,0,0,0,347000,0,0,0,417000,70000,347000,347000
054842,台達電兆豐98購01,0,0,0,0,0,0,0,0,0,346000,0,0,0,346000,0,346000,346000
059451,國巨永豐99購05  ,0,0,0,0,0,0,0,0,0,344000,0,0,0,456000,112000,344000,344000
058661,臺股指中信9C購01,0,0,0,0,0,0,0,0,0,344000,0,0,0,344000,0,344000,344000
8081,致新            ,328000,573000,-245000,0,0,0,607000,0,607000,-18000,0,46000,-46000,67000,39000,28000,344000
056588,聯發科統一9A購02,0,0,0,0,0,0,0,0,0,342000,0,0,0,342000,0,342000,342000
3048,益登            ,361000,46000,315000,0,0,0,0,0,0,25000,69000,44000,25000,0,0,0,340000
053073,技嘉康和96購01  ,0,230000,-230000,0,0,0,0,0,0,570000,0,0,0,746000,176000,570000,340000
052816,上銀永豐96購01  ,0,0,0,0,0,0,0,0,0,340000,0,0,0,340000,0,340000,340000
058435,旺宏統一9B購02  ,0,0,0,0,0,0,0,0,0,340000,0,0,0,340000,0,340000,340000
2534,宏盛            ,659000,320000,339000,0,0,0,0,0,0,-1000,0,1000,-1000,0,0,0,338000
4119,旭富            ,1147000,566092,580908,0,0,0,0,239000,-239000,-10000,0,7000,-7000,14000,17000,-3000,331908
2481,強茂            ,1092000,766000,326000,0,0,0,0,0,0,4000,0,0,0,4000,0,4000,330000
1605,華新            ,2609000,2159000,450000,0,0,0,0,0,0,-121000,20000,82000,-62000,85000,144000,-59000,329000
060186,義隆元富9A購01  ,0,0,0,0,0,0,0,0,0,329000,0,0,0,384000,55000,329000,329000
053638,信邦永豐96購01  ,0,0,0,0,0,0,0,0,0,329000,0,0,0,366000,37000,329000,329000
053761,健策國泰98購01  ,0,0,0,0,0,0,0,0,0,327000,0,0,0,327000,0,327000,327000
060031,旭富永豐99購02  ,0,0,0,0,0,0,0,0,0,326000,0,0,0,459000,133000,326000,326000
053440,台積電凱基96購12,0,0,0,0,0,0,0,0,0,325000,0,0,0,325000,0,325000,325000
057427,華通兆豐99購01  ,0,0,0,0,0,0,0,0,0,325000,0,0,0,335000,10000,325000,325000
059322,晶技元大99購06  ,0,0,0,0,0,0,0,0,0,324000,0,0,0,432000,108000,324000,324000
055849,聯詠元大97購05  ,0,0,0,0,0,0,0,0,0,323000,0,0,0,348000,25000,323000,323000
058746,華通凱基9A購02  ,0,0,0,0,0,0,0,0,0,322000,0,0,0,390000,68000,322000,322000
2548,華固            ,1098000,538000,560000,0,0,0,0,0,0,-240000,0,240000,-240000,0,0,0,320000
055026,健和興國泰98購01,0,0,0,0,0,0,0,0,0,320000,0,0,0,320000,0,320000,320000
057198,智伸科統一9B購01,0,0,0,0,0,0,0,0,0,320000,0,0,0,340000,20000,320000,320000
060005,上銀群益99購03  ,0,0,0,0,0,0,0,0,0,318000,0,0,0,318000,0,318000,318000
059361,玉晶光永豐99購04,0,0,0,0,0,0,0,0,0,315000,0,0,0,398000,83000,315000,315000
059755,宏達電國泰9A購01,0,0,0,0,0,0,0,0,0,315000,0,0,0,548000,233000,315000,315000
060120,聯電富邦9B購01  ,0,0,0,0,0,0,0,0,0,314000,0,0,0,324000,10000,314000,314000
050944,智邦群益95購01  ,0,0,0,0,0,0,0,0,0,314000,0,0,0,314000,0,314000,314000
060033,臻鼎永豐99購01  ,0,0,0,0,0,0,0,0,0,311000,0,0,0,567000,256000,311000,311000
052931,麗豐元大97購01  ,0,0,0,0,0,0,0,0,0,310000,0,0,0,310000,0,310000,310000
055775,友達凱基9A購01  ,0,0,0,0,0,0,0,0,0,306000,0,0,0,306000,0,306000,306000
2905,三商            ,695000,390000,305000,0,0,0,0,0,0,0,0,0,0,0,0,0,305000
051895,聯茂元富95購02  ,0,0,0,0,0,0,0,0,0,304000,0,0,0,304000,0,304000,304000
056011,矽力中信99購01  ,0,0,0,0,0,0,0,0,0,304000,0,0,0,304000,0,304000,304000
051644,聯茂康和95購01  ,0,0,0,0,0,0,0,0,0,303000,0,0,0,303000,0,303000,303000
053565,台光電富邦98購01,0,0,0,0,0,0,0,0,0,302000,0,0,0,302000,0,302000,302000
052399,台光電凱基95購03,0,0,0,0,0,0,0,0,0,300000,0,0,0,300000,0,300000,300000
052937,國巨兆豐97購01  ,0,0,0,0,0,0,0,0,0,300000,0,0,0,300000,0,300000,300000
050230,聯發科麥證94購02,0,0,0,300000,0,300000,0,0,0,300000,0,0,0,300000,0,300000,300000
049735,台光電群益94購03,0,0,0,0,0,0,0,0,0,300000,0,0,0,300000,0,300000,300000
051033,台積電兆豐95購03,0,0,0,0,0,0,0,0,0,300000,0,0,0,300000,0,300000,300000
054824,同欣電元大97購04,0,0,0,0,0,0,0,0,0,300000,0,0,0,300000,0,300000,300000
057405,麗豐群益98購01  ,0,0,0,0,0,0,0,0,0,300000,0,0,0,300000,0,300000,300000
056458,日月光凱基98購02,0,0,0,0,0,0,0,0,0,300000,0,0,0,300000,0,300000,300000
056284,台積電永豐97購06,0,0,0,0,0,0,0,0,0,300000,0,0,0,300000,0,300000,300000
059191,茂林富邦9B購01  ,0,0,0,0,0,0,0,0,0,300000,0,0,0,411000,111000,300000,300000
048059,欣興國泰95購01  ,0,0,0,0,0,0,0,0,0,299000,0,0,0,299000,0,299000,299000
046703,瑞昱元富95購01  ,0,0,0,0,0,0,0,0,0,299000,0,0,0,299000,0,299000,299000
051589,健鼎元大95購02  ,0,0,0,0,0,0,0,0,0,296000,0,0,0,300000,4000,296000,296000
059455,玉晶光永豐99購05,0,0,0,0,0,0,0,0,0,295000,0,0,0,523000,228000,295000,295000
056742,玉晶光凱基9A購01,0,0,0,0,0,0,0,0,0,295000,0,0,0,295000,0,295000,295000
059572,華新科凱基99購08,0,0,0,0,0,0,0,0,0,294000,0,0,0,447000,153000,294000,294000
048588,世紀鋼中信94購01,0,0,0,0,0,0,0,0,0,293000,0,0,0,313000,20000,293000,293000
052406,力成凱基95購03  ,0,0,0,0,0,0,0,0,0,291000,0,0,0,346000,55000,291000,291000
048633,台達電元大94購02,0,0,0,0,0,0,0,0,0,290000,0,0,0,290000,0,290000,290000
059658,國巨元大9A購03  ,0,0,0,0,0,0,0,0,0,289000,0,0,0,305000,16000,289000,289000
059835,聯發科國泰9B購01,0,0,0,0,0,0,0,0,0,289000,0,0,0,300000,11000,289000,289000
050117,麗豐元大96購02  ,0,0,0,0,0,0,0,0,0,288000,0,0,0,309000,21000,288000,288000
07276P,臺股指群益99售19,0,0,0,0,0,0,0,0,0,286000,0,0,0,709000,423000,286000,286000
1515,力山            ,997000,720000,277000,0,0,0,0,0,0,8000,0,9000,-9000,17000,0,17000,285000
3535,晶彩科          ,355000,70000,285000,0,0,0,0,0,0,0,0,0,0,0,0,0,285000
059133,臺股指群益99購08,0,0,0,0,0,0,0,0,0,285000,0,0,0,823000,538000,285000,285000
057123,上銀凱基98購05  ,0,0,0,0,0,0,0,0,0,285000,0,0,0,295000,10000,285000,285000
059610,上銀永豐99購02  ,0,0,0,0,0,0,0,0,0,284000,0,0,0,297000,13000,284000,284000
052832,益航群益96購01  ,0,0,0,0,0,0,0,0,0,280000,0,0,0,280000,0,280000,280000
056059,美律元大98購02  ,10000,0,10000,0,0,0,0,0,0,270000,0,0,0,270000,0,270000,280000
059993,上銀元富99購01  ,0,0,0,0,0,0,0,0,0,279000,0,0,0,296000,17000,279000,279000
052926,旺宏元大98購02  ,0,0,0,0,0,0,0,0,0,279000,0,0,0,279000,0,279000,279000
057566,欣興富邦99購01  ,0,0,0,0,0,0,0,0,0,278000,0,0,0,278000,0,278000,278000
052822,泰碩永豐97購01  ,0,15000,-15000,0,0,0,0,0,0,292000,0,0,0,297000,5000,292000,277000
058964,群創兆豐99購01  ,0,0,0,0,0,0,0,0,0,277000,0,0,0,287000,10000,277000,277000
2316,楠梓電          ,975000,773000,202000,0,0,0,0,0,0,74000,0,0,0,74000,0,74000,276000
054376,聯茂中信97購01  ,0,0,0,0,0,0,0,0,0,275000,0,0,0,363000,88000,275000,275000
053155,晶技元大97購02  ,0,0,0,0,0,0,0,0,0,271000,0,0,0,271000,0,271000,271000
056616,台光電永豐98購01,0,0,0,0,0,0,0,0,0,271000,0,0,0,386000,115000,271000,271000
048564,智易元大94購01  ,0,0,0,0,0,0,0,0,0,270000,0,0,0,270000,0,270000,270000
00676R,富邦臺灣加權反1 ,0,1000,-1000,0,0,0,0,0,0,271000,0,0,0,1720000,1449000,271000,270000
051490,世芯凱基96購01  ,0,0,0,0,0,0,0,0,0,269000,0,0,0,269000,0,269000,269000
057775,南亞科群益98購02,0,0,0,0,0,0,0,0,0,268000,0,0,0,419000,151000,268000,268000
059513,揚明光永豐99購01,0,0,0,0,0,0,0,0,0,267000,0,0,0,329000,62000,267000,267000
059411,臺股指國票99購17,0,0,0,0,0,0,0,0,0,267000,0,0,0,283000,16000,267000,267000
042929,台積電中信95購02,0,0,0,0,0,0,0,0,0,266000,0,0,0,266000,0,266000,266000
059943,信邦永豐99購01  ,0,0,0,0,0,0,0,0,0,262000,0,0,0,322000,60000,262000,262000
07361P,聯發科元大99售34,0,0,0,0,0,0,0,0,0,262000,0,0,0,274000,12000,262000,262000
5388,中磊            ,643000,428000,215000,0,0,0,2000,0,2000,45000,55000,0,55000,3000,13000,-10000,262000
5471,松翰            ,1483000,1191000,292000,0,0,0,0,0,0,-32000,0,32000,-32000,0,0,0,260000
049776,全新統一95購02  ,0,0,0,0,0,0,0,0,0,260000,0,0,0,260000,0,260000,260000
057471,昇陽半永豐98購02,0,0,0,0,0,0,0,0,0,258000,0,0,0,340000,82000,258000,258000
057576,南亞科第一9C購01,0,0,0,0,0,0,0,0,0,258000,0,0,0,258000,0,258000,258000
053006,玉晶光永豐96購03,0,0,0,0,0,0,0,0,0,257000,0,0,0,336000,79000,257000,257000
055744,茂林元富97購02  ,0,0,0,0,0,0,0,0,0,255000,0,0,0,255000,0,255000,255000
058281,奇力新中信99購01,0,0,0,0,0,0,0,0,0,255000,0,0,0,255000,0,255000,255000
8404,百和興業-KY     ,490000,235000,255000,0,0,0,0,0,0,0,0,0,0,0,0,0,255000
053860,台積電元大98購03,0,0,0,0,0,0,0,0,0,253000,0,0,0,263000,10000,253000,253000
057950,T50正2元大9B購04,0,0,0,0,0,0,0,0,0,253000,0,0,0,253000,0,253000,253000
060090,台積電元大99購55,0,0,0,0,0,0,0,0,0,252000,0,0,0,253000,1000,252000,252000
00739,元大MSCI A股    ,1000,6000,-5000,0,0,0,0,0,0,256000,0,0,0,332000,76000,256000,251000
056994,緯穎兆豐98購02  ,0,0,0,0,0,0,0,0,0,251000,0,0,0,251000,0,251000,251000
054502,泰碩永豐96購01  ,0,0,0,0,0,0,0,0,0,251000,0,0,0,306000,55000,251000,251000
050869,健策永豐95購01  ,0,0,0,0,0,0,0,0,0,250000,0,0,0,250000,0,250000,250000
049056,玉晶光永豐95購03,0,0,0,0,0,0,0,0,0,250000,0,0,0,250000,0,250000,250000
055684,京鼎凱基97購01  ,0,0,0,0,0,0,0,0,0,250000,0,0,0,292000,42000,250000,250000
054539,欣興國票98購01  ,0,0,0,0,0,0,0,0,0,250000,0,0,0,250000,0,250000,250000
059692,聯詠永豐99購01  ,0,0,0,0,0,0,0,0,0,246000,0,0,0,490000,244000,246000,246000
059341,台積電凱基99購15,0,0,0,0,0,0,0,0,0,246000,0,0,0,246000,0,246000,246000
058510,全新元大9B購02  ,0,0,0,0,0,0,0,0,0,246000,0,0,0,286000,40000,246000,246000
059340,鴻海凱基9A購12  ,0,0,0,0,0,0,0,0,0,245000,0,0,0,773000,528000,245000,245000
056104,義隆永豐97購01  ,0,0,0,0,0,0,0,0,0,245000,0,0,0,250000,5000,245000,245000
057813,京元電元大98購03,0,0,0,0,0,0,0,0,0,244000,0,0,0,244000,0,244000,244000
059605,臺股指元大9A購42,0,0,0,0,0,0,0,0,0,243000,0,0,0,244000,1000,243000,243000
055812,台積電國票99購02,0,0,0,0,0,0,0,0,0,242000,0,0,0,245000,3000,242000,242000
059386,上銀凱基99購07  ,0,0,0,0,0,0,0,0,0,241000,0,0,0,266000,25000,241000,241000
2399,映泰            ,266000,26000,240000,0,0,0,0,0,0,0,0,0,0,0,0,0,240000
045189,大立光元富98購01,0,0,0,0,0,0,0,0,0,240000,0,0,0,240000,0,240000,240000
052246,超眾康和95購01  ,0,0,0,0,0,0,0,0,0,240000,0,0,0,250000,10000,240000,240000
056196,聯茂富邦98購02  ,0,0,0,0,0,0,0,0,0,240000,0,0,0,608000,368000,240000,240000
2484,希華            ,299000,60000,239000,0,0,0,0,0,0,0,0,0,0,0,0,0,239000
3003,健和興          ,391000,131000,260000,0,0,0,0,0,0,-21000,0,16000,-16000,2000,7000,-5000,239000
047298,聯茂元富96購01  ,0,0,0,0,0,0,0,0,0,239000,0,0,0,252000,13000,239000,239000
053770,元金2X元大98購01,0,0,0,0,0,0,0,0,0,238000,0,0,0,238000,0,238000,238000
059204,台灣50元大01購02,0,0,0,0,0,0,0,0,0,238000,0,0,0,246000,8000,238000,238000
6443,元晶            ,316000,79000,237000,0,0,0,0,0,0,0,0,0,0,0,0,0,237000
057549,台光電凱基98購05,0,0,0,0,0,0,0,0,0,237000,0,0,0,237000,0,237000,237000
058115,台光電中信99購01,0,0,0,0,0,0,0,0,0,237000,0,0,0,247000,10000,237000,237000
056418,台光電元富98購01,0,0,0,0,0,0,0,0,0,237000,0,0,0,546000,309000,237000,237000
2014,中鴻            ,1183000,948000,235000,0,0,0,0,0,0,0,0,0,0,0,0,0,235000
057128,台光電凱基98購03,0,0,0,0,0,0,0,0,0,235000,0,0,0,245000,10000,235000,235000
055771,台積電日盛97購04,0,0,0,0,0,0,0,0,0,235000,0,0,0,235000,0,235000,235000
3698,隆達            ,372000,211000,161000,0,0,0,0,0,0,72000,78000,28000,50000,22000,0,22000,233000
059646,聯茂凱基99購06  ,0,0,0,0,0,0,0,0,0,233000,0,0,0,513000,280000,233000,233000
06983P,台積電國泰9A售02,0,0,0,0,0,0,0,0,0,232000,0,0,0,232000,0,232000,232000
059102,聯鈞元富99購01  ,0,0,0,0,0,0,0,0,0,232000,0,0,0,302000,70000,232000,232000
052354,健策群益96購02  ,0,0,0,0,0,0,0,0,0,230000,0,0,0,230000,0,230000,230000
047895,台積電群益94購04,0,0,0,0,0,0,0,0,0,230000,0,0,0,230000,0,230000,230000
051128,台表科群益95購02,0,0,0,0,0,0,0,0,0,230000,0,0,0,230000,0,230000,230000
04915P,鴻海永昌96售02  ,0,0,0,0,0,0,0,0,0,230000,0,0,0,230000,0,230000,230000
055277,旺宏元大97購04  ,0,0,0,0,0,0,0,0,0,230000,0,0,0,230000,0,230000,230000
059438,群創元大99購06  ,0,0,0,0,0,0,0,0,0,229000,0,0,0,229000,0,229000,229000
3380,明泰            ,512000,254000,258000,0,0,0,0,0,0,-29000,0,53000,-53000,30000,6000,24000,229000
058570,臻鼎凱基9A購01  ,0,0,0,0,0,0,0,0,0,229000,0,0,0,248000,19000,229000,229000
058297,茂林凱基9A購02  ,0,0,0,0,0,0,0,0,0,228000,0,0,0,341000,113000,228000,228000
058470,台灣50日盛9B購02,0,0,0,0,0,0,0,0,0,228000,0,0,0,228000,0,228000,228000
1310,台苯            ,668000,413000,255000,0,0,0,0,0,0,-28000,0,28000,-28000,0,0,0,227000
059703,旺宏凱基99購11  ,0,0,0,0,0,0,0,0,0,227000,0,0,0,227000,0,227000,227000
058468,聯茂中信99購02  ,0,0,0,0,0,0,0,0,0,226000,0,0,0,242000,16000,226000,226000
055859,啟碁元大97購03  ,0,0,0,0,0,0,0,0,0,226000,0,0,0,296000,70000,226000,226000
059864,亞德客凱基99購01,0,0,0,0,0,0,0,0,0,225000,0,0,0,298000,73000,225000,225000
054383,傳奇群益97購01  ,0,0,0,0,0,0,0,0,0,225000,0,0,0,225000,0,225000,225000
051531,國巨國票96購04  ,0,0,0,0,0,0,0,0,0,225000,0,0,0,376000,151000,225000,225000
057897,華通富邦99購01  ,0,0,0,0,0,0,0,0,0,225000,0,0,0,225000,0,225000,225000
05601P,鴻海元大97售04  ,0,0,0,0,0,0,0,0,0,225000,0,0,0,225000,0,225000,225000
3708,上緯投控        ,259000,36000,223000,0,0,0,0,0,0,0,0,0,0,0,0,0,223000
058116,正崴中信99購02  ,0,0,0,0,0,0,0,0,0,223000,0,0,0,352000,129000,223000,223000
049597,泰鼎元大96購01  ,0,0,0,0,0,0,0,0,0,222000,0,0,0,352000,130000,222000,222000
6592,和潤企業        ,269000,47000,222000,0,0,0,0,0,0,0,0,0,0,0,0,0,222000
047937,元金2X國票97購02,0,0,0,0,0,0,0,0,0,220000,0,0,0,220000,0,220000,220000
055276,台積電元大97購20,0,0,0,0,0,0,0,0,0,218000,0,0,0,218000,0,218000,218000
05507P,聯茂凱基96售02  ,0,0,0,0,0,0,0,0,0,218000,0,0,0,218000,0,218000,218000
052049,緯創凱基97購01  ,0,0,0,0,0,0,0,0,0,217000,0,0,0,217000,0,217000,217000
057315,台灣50康和9A購03,0,0,0,0,0,0,0,0,0,217000,0,0,0,217000,0,217000,217000
6239,力成            ,3228000,3488000,-260000,0,0,0,396000,0,396000,80000,94000,38000,56000,31000,7000,24000,216000
058469,臺股指中信9A購05,0,0,0,0,0,0,0,0,0,215000,0,0,0,215000,0,215000,215000
6209,今國光          ,294000,92000,202000,0,0,0,0,0,0,12000,12000,0,12000,0,0,0,214000
3413,京鼎            ,407000,267000,140000,0,0,0,44000,0,44000,30000,14000,0,14000,20000,4000,16000,214000
051505,台積電元富95購05,0,0,0,0,0,0,0,0,0,214000,0,0,0,214000,0,214000,214000
055409,元黃金富邦01購01,0,0,0,0,0,0,0,0,0,214000,0,0,0,214000,0,214000,214000
07407P,欣興凱基99售07  ,0,0,0,0,0,0,0,0,0,212000,0,0,0,321000,109000,212000,212000
07245P,台積電凱基99售16,0,0,0,0,0,0,0,0,0,212000,0,0,0,325000,113000,212000,212000
057659,台表科兆豐98購01,0,0,0,0,0,0,0,0,0,212000,0,0,0,222000,10000,212000,212000
8105,凌巨            ,427000,216000,211000,0,0,0,0,0,0,0,0,0,0,0,0,0,211000
056470,旺宏元大99購01  ,0,0,0,0,0,0,0,0,0,210000,0,0,0,210000,0,210000,210000
07147P,高鐵元大99售01  ,0,0,0,0,0,0,0,0,0,209000,0,0,0,220000,11000,209000,209000
057303,喬山兆豐99購01  ,0,0,0,0,0,0,0,0,0,209000,0,0,0,240000,31000,209000,209000
2031,新光鋼          ,376000,126000,250000,0,0,0,0,50000,-50000,8000,16000,8000,8000,0,0,0,208000
6668,中揚光          ,270000,54000,216000,0,0,0,0,0,0,-8000,0,8000,-8000,0,0,0,208000
4919,新唐            ,292000,120000,172000,0,0,0,0,0,0,34000,0,0,0,34000,0,34000,206000
058994,道瓊指元大99購01,0,0,0,0,0,0,0,0,0,206000,0,0,0,360000,154000,206000,206000
050895,聯發科元大97購01,0,0,0,0,0,0,0,0,0,205000,0,0,0,205000,0,205000,205000
056067,智原元大97購01  ,0,0,0,0,0,0,0,0,0,205000,0,0,0,212000,7000,205000,205000
1513,中興電          ,892000,681000,211000,0,0,0,0,0,0,-7000,0,7000,-7000,0,0,0,204000
052740,聯發科元大96購07,0,0,0,0,0,0,0,0,0,204000,0,0,0,204000,0,204000,204000
053889,致茂群益97購01  ,0,0,0,0,0,0,0,0,0,204000,0,0,0,204000,0,204000,204000
058443,T50正2富邦01購01,0,0,0,0,0,0,0,0,0,204000,0,0,0,204000,0,204000,204000
056810,群創統一9A購01  ,0,0,0,0,0,0,0,0,0,204000,0,0,0,280000,76000,204000,204000
049795,華通元大96購02  ,0,0,0,0,0,0,0,0,0,203000,0,0,0,203000,0,203000,203000
048396,奇力新國票94購02,0,0,0,0,0,0,0,0,0,202000,0,0,0,205000,3000,202000,202000
054144,康控元大97購02  ,0,0,0,0,0,0,0,0,0,202000,0,0,0,202000,0,202000,202000
00656R,國泰中國A50反1  ,1000,44000,-43000,0,0,0,0,0,0,245000,0,0,0,261000,16000,245000,202000
059065,南電凱基9A購01  ,0,0,0,0,0,0,0,0,0,202000,0,0,0,870000,668000,202000,202000
055300,緯穎元大98購01  ,0,0,0,0,0,0,0,0,0,202000,0,0,0,202000,0,202000,202000
051346,仁寶元大95購01  ,0,0,0,0,0,0,0,0,0,201000,0,0,0,301000,100000,201000,201000
058982,台積電凱基99購08,0,0,0,0,0,0,0,0,0,201000,0,0,0,201000,0,201000,201000
00643,群益深証中小    ,6000,7000,-1000,0,0,0,0,0,0,201000,0,0,0,297000,96000,201000,200000
052942,聯發科中信97購04,0,0,0,0,0,0,0,0,0,200000,0,0,0,200000,0,200000,200000
052852,國巨元富96購02  ,0,0,0,0,0,0,0,0,0,200000,0,0,0,200000,0,200000,200000
049667,大立光國泰96購01,0,0,0,0,0,0,0,0,0,200000,0,0,0,200000,0,200000,200000
058225,旺宏元富99購01  ,0,0,0,0,0,0,0,0,0,200000,0,0,0,200000,0,200000,200000
058350,T50正2凱基9B購01,0,0,0,0,0,0,0,0,0,200000,0,0,0,200000,0,200000,200000
054236,貿聯群益96購01  ,0,0,0,0,0,0,0,0,0,200000,0,0,0,200000,0,200000,200000
053150,聯發科元大96購11,0,0,0,0,0,0,0,0,0,200000,0,0,0,200000,0,200000,200000
054640,健策中信9B購01  ,0,0,0,0,0,0,0,0,0,200000,0,0,0,200000,0,200000,200000
057540,緯穎日盛99購01  ,0,0,0,0,0,0,0,0,0,200000,0,0,0,250000,50000,200000,200000
055548,旺宏凱基97購02  ,0,0,0,0,0,0,0,0,0,200000,0,0,0,200000,0,200000,200000
07334P,臺股指國票99售19,0,0,0,0,0,0,0,0,0,199000,0,0,0,331000,132000,199000,199000
059525,上銀凱基99購08  ,0,0,0,0,0,0,0,0,0,199000,0,0,0,203000,4000,199000,199000
060078,旺宏台新99購03  ,0,0,0,0,0,0,0,0,0,199000,0,0,0,241000,42000,199000,199000
060119,上銀富邦9B購03  ,0,0,0,0,0,0,0,0,0,199000,0,0,0,313000,114000,199000,199000
052325,高股息中信99購01,0,0,0,0,0,0,0,0,0,198000,0,0,0,198000,0,198000,198000
05529P,臺股指群益96售02,0,0,0,0,0,0,0,0,0,198000,0,0,0,318000,120000,198000,198000
059123,訊芯永豐99購03  ,0,0,0,0,0,0,0,0,0,198000,0,0,0,396000,198000,198000,198000
00737,國泰AI+Robo     ,5000,5000,0,0,0,0,0,0,0,197000,0,0,0,221000,24000,197000,197000
056600,聯茂元富98購01  ,0,0,0,0,0,0,0,0,0,197000,0,0,0,202000,5000,197000,197000
056578,智易元大99購02  ,0,0,0,0,0,0,0,0,0,197000,0,0,0,210000,13000,197000,197000
049293,友訊群益95購01  ,0,0,0,0,0,0,0,0,0,196000,0,0,0,196000,0,196000,196000
058587,台積電中信9C購03,0,0,0,0,0,0,0,0,0,196000,0,0,0,206000,10000,196000,196000
2841,台開            ,585000,390000,195000,0,0,0,0,0,0,0,0,0,0,0,0,0,195000
052764,景碩群益98購01  ,0,0,0,0,0,0,0,0,0,195000,0,0,0,195000,0,195000,195000
051506,台積電元富95購06,0,0,0,0,0,0,0,0,0,195000,0,0,0,195000,0,195000,195000
053291,旺宏中信9A購01  ,0,0,0,0,0,0,0,0,0,195000,0,0,0,195000,0,195000,195000
057201,華擎元富98購01  ,0,0,0,0,0,0,0,0,0,195000,0,0,0,283000,88000,195000,195000
2395,研華            ,672000,511595,160405,0,0,0,51000,12000,39000,-5000,0,5000,-5000,0,0,0,194405
2107,厚生            ,206190,76000,130190,0,0,0,0,0,0,64000,65000,1000,64000,0,0,0,194190
6285,啟碁            ,690000,1234184,-544184,0,0,0,780000,0,780000,-42000,18000,76000,-58000,23000,7000,16000,193816
6196,帆宣            ,435000,245000,190000,0,0,0,0,0,0,3000,0,0,0,3000,0,3000,193000
059918,華新科元大99購20,0,0,0,0,0,0,0,0,0,192000,0,0,0,201000,9000,192000,192000
059664,立積元大9C購01  ,0,0,0,0,0,0,0,0,0,192000,0,0,0,213000,21000,192000,192000
059217,台積電元大99購30,0,0,0,0,0,0,0,0,0,191000,0,0,0,191000,0,191000,191000
059955,美食康和99購01  ,0,0,0,0,0,0,0,0,0,190000,0,0,0,190000,0,190000,190000
052071,臺股指兆豐95購01,0,0,0,0,0,0,0,0,0,190000,0,0,0,190000,0,190000,190000
054329,華新科永豐96購02,0,0,0,0,0,0,0,0,0,190000,0,0,0,190000,0,190000,190000
051431,群創元富99購02  ,0,0,0,0,0,0,0,0,0,190000,0,0,0,190000,0,190000,190000
058939,台積電中信9B購01,0,0,0,0,0,0,0,0,0,190000,0,0,0,190000,0,190000,190000
060072,國巨元富99購04  ,0,0,0,0,0,0,0,0,0,189000,0,0,0,194000,5000,189000,189000
050049,華通群益96購01  ,0,0,0,0,0,0,0,0,0,189000,0,0,0,189000,0,189000,189000
058595,T50正2元富99購01,0,0,0,0,0,0,0,0,0,189000,0,0,0,189000,0,189000,189000
048350,世紀鋼元大95購01,0,0,0,0,0,0,0,0,0,188000,0,0,0,511000,323000,188000,188000
053112,中磊兆豐97購01  ,0,0,0,0,0,0,0,0,0,188000,0,0,0,249000,61000,188000,188000
3530,晶相光          ,458000,297000,161000,0,0,0,0,0,0,26000,0,0,0,37000,11000,26000,187000
053386,聯詠元大96購03  ,0,0,0,0,0,0,0,0,0,187000,0,0,0,390000,203000,187000,187000
059218,台積電元大99購31,0,0,0,0,0,0,0,0,0,187000,0,0,0,187000,0,187000,187000
057275,友達元大9A購04  ,0,0,0,0,0,0,0,0,0,187000,0,0,0,189000,2000,187000,187000
059886,可成國票99購04  ,0,0,0,0,0,0,0,0,0,185000,0,0,0,255000,70000,185000,185000
059627,旺宏凱基99購10  ,0,0,0,0,0,0,0,0,0,184000,0,0,0,207000,23000,184000,184000
1451,年興            ,239000,54000,185000,0,0,0,0,0,0,-1000,0,1000,-1000,0,0,0,184000
058238,奇鋐元大99購02  ,0,0,0,0,0,0,0,0,0,184000,0,0,0,223000,39000,184000,184000
059006,樺漢元大99購01  ,0,0,0,0,0,0,0,0,0,184000,0,0,0,277000,93000,184000,184000
054848,群創兆豐98購01  ,0,0,0,0,0,0,0,0,0,184000,0,0,0,194000,10000,184000,184000
051743,揚明光國票96購02,0,0,0,0,0,0,0,0,0,182000,0,0,0,182000,0,182000,182000
051014,智邦凱基95購01  ,0,0,0,0,0,0,0,0,0,182000,0,0,0,198000,16000,182000,182000
054577,世芯元大98購01  ,0,0,0,0,0,0,0,0,0,182000,0,0,0,182000,0,182000,182000
059931,緯穎富邦9A購01  ,0,0,0,0,0,0,0,0,0,181000,0,0,0,234000,53000,181000,181000
056297,台光電元大97購04,0,0,0,0,0,0,0,0,0,181000,0,0,0,244000,63000,181000,181000
059990,健策元大9A購01  ,0,0,0,0,0,0,0,0,0,180000,0,0,0,255000,75000,180000,180000
2390,云辰            ,238000,58000,180000,0,0,0,0,0,0,0,0,0,0,0,0,0,180000
053204,旺宏麥證96購01  ,0,0,0,180000,0,180000,0,0,0,180000,0,0,0,180000,0,180000,180000
053522,臺股指群益99購01,0,0,0,0,0,0,0,0,0,180000,0,0,0,180000,0,180000,180000
056192,智邦富邦98購01  ,0,0,0,0,0,0,0,0,0,180000,0,0,0,180000,0,180000,180000
054656,深中小元大97購01,0,0,0,0,0,0,0,0,0,180000,0,0,0,300000,120000,180000,180000
2347,聯強            ,1810000,1618150,191850,0,0,0,0,0,0,-12000,14000,16000,-2000,25000,35000,-10000,179850
3443,創意            ,480000,291560,188440,0,0,0,9000,65000,-56000,47000,2000,2000,0,54000,7000,47000,179440
053186,健策中信9C購01  ,0,0,0,0,0,0,0,0,0,179000,0,0,0,179000,0,179000,179000
057467,祥碩永豐98購04  ,0,0,0,0,0,0,0,0,0,179000,0,0,0,179000,0,179000,179000
058375,群創凱基9B購04  ,0,0,0,0,0,0,0,0,0,178000,0,0,0,200000,22000,178000,178000
043442,大立光台新01購01,0,0,0,0,0,0,0,0,0,178000,0,0,0,178000,0,178000,178000
054845,智邦兆豐98購01  ,0,0,0,0,0,0,0,0,0,178000,0,0,0,179000,1000,178000,178000
059388,國巨凱基99購13  ,0,0,0,0,0,0,0,0,0,177000,0,0,0,194000,17000,177000,177000
059568,台積電凱基9A購13,0,0,0,0,0,0,0,0,0,176000,0,0,0,188000,12000,176000,176000
053494,南亞科兆豐96購02,0,0,0,0,0,0,0,0,0,175000,0,0,0,185000,10000,175000,175000
056008,全新中信9B購01  ,0,0,0,0,0,0,0,0,0,175000,0,0,0,175000,0,175000,175000
056897,南亞科元大98購02,0,0,0,0,0,0,0,0,0,174000,0,0,0,196000,22000,174000,174000
057977,台光電永豐98購02,0,0,0,0,0,0,0,0,0,173000,0,0,0,173000,0,173000,173000
054053,聯茂元大96購01  ,0,0,0,0,0,0,0,0,0,173000,0,0,0,179000,6000,173000,173000
054036,T50反1元大96購08,0,0,0,0,0,0,0,0,0,172000,0,0,0,202000,30000,172000,172000
057709,電子類群益98購01,0,0,0,0,0,0,0,0,0,172000,0,0,0,172000,0,172000,172000
059264,台光電中信99購02,0,0,0,0,0,0,0,0,0,172000,0,0,0,299000,127000,172000,172000
08795P,聯發科凱基01售11,0,0,0,0,0,0,0,0,0,171000,0,0,0,171000,0,171000,171000
050805,光寶科日盛95購01,0,0,0,0,0,0,0,0,0,171000,0,0,0,171000,0,171000,171000
054412,智邦元大96購03  ,0,0,0,0,0,0,0,0,0,171000,0,0,0,172000,1000,171000,171000
051907,台積電元大97購05,0,0,0,0,0,0,0,0,0,171000,0,0,0,188000,17000,171000,171000
059851,晶相光永豐99購02,0,0,0,0,0,0,0,0,0,170000,0,0,0,206000,36000,170000,170000
053863,聯發科元大96購18,0,0,0,0,0,0,0,0,0,170000,0,0,0,170000,0,170000,170000
053466,華通元大98購01  ,0,0,0,0,0,0,0,0,0,170000,0,0,0,170000,0,170000,170000
052809,訊芯元大97購01  ,0,0,0,0,0,0,0,0,0,170000,0,0,0,170000,0,170000,170000
052884,台積電兆豐96購01,0,0,0,0,0,0,0,0,0,170000,0,0,0,170000,0,170000,170000
057533,晶相光元大98購02,0,0,0,0,0,0,0,0,0,170000,0,0,0,262000,92000,170000,170000
056572,義隆元大99購01  ,0,0,0,0,0,0,0,0,0,170000,0,0,0,226000,56000,170000,170000
059848,智邦永豐99購01  ,0,0,0,0,0,0,0,0,0,169000,0,0,0,216000,47000,169000,169000
052052,嘉澤凱基95購02  ,0,0,0,0,0,0,0,0,0,169000,0,0,0,310000,141000,169000,169000
054197,台積電永昌96購07,0,0,0,0,0,0,0,0,0,169000,0,0,0,169000,0,169000,169000
055538,鴻海日盛97購04  ,0,0,0,0,0,0,0,0,0,169000,0,0,0,169000,0,169000,169000
059009,世紀鋼元大99購04,0,0,0,0,0,0,0,0,0,169000,0,0,0,362000,193000,169000,169000
05271P,國巨富邦97售01  ,0,0,0,0,0,0,0,0,0,168000,0,0,0,168000,0,168000,168000
059642,健策凱基99購04  ,0,0,0,0,0,0,0,0,0,167000,0,0,0,192000,25000,167000,167000
8110,華東            ,454000,277000,177000,0,0,0,0,0,0,-10000,0,10000,-10000,0,0,0,167000
052295,揚明光國票96購03,0,0,0,0,0,0,0,0,0,166000,0,0,0,166000,0,166000,166000
4976,佳凌            ,279000,103000,176000,0,0,0,0,0,0,-11000,0,11000,-11000,0,0,0,165000
3033,威健            ,182000,17000,165000,0,0,0,0,0,0,0,0,0,0,0,0,0,165000
050227,大立光中信96購01,0,0,0,0,0,0,0,0,0,165000,0,0,0,165000,0,165000,165000
2458,義隆            ,1987000,1534400,452600,0,0,0,1379000,1477000,-98000,-190000,210000,478000,-268000,90000,12000,78000,164600
059397,T50反1元富99購05,0,0,0,0,0,0,0,0,0,164000,0,0,0,400000,236000,164000,164000
052371,元金2X元大95購01,0,0,0,0,0,0,0,0,0,164000,0,0,0,164000,0,164000,164000
057074,立積永豐98購01  ,0,0,0,0,0,0,0,0,0,164000,0,0,0,387000,223000,164000,164000
060103,聯詠元大99購01  ,0,0,0,0,0,0,0,0,0,163000,0,0,0,448000,285000,163000,163000
1527,鑽全            ,187000,24000,163000,0,0,0,0,0,0,0,0,0,0,0,0,0,163000
057134,茂林凱基98購02  ,0,0,0,0,0,0,0,0,0,163000,0,0,0,215000,52000,163000,163000
059391,立積凱基9A購01  ,0,0,0,0,0,0,0,0,0,162000,0,0,0,184000,22000,162000,162000
057916,國巨凱基98購13  ,0,0,0,0,0,0,0,0,0,162000,0,0,0,213000,51000,162000,162000
058910,泰鼎元大99購03  ,0,0,0,0,0,0,0,0,0,162000,0,0,0,363000,201000,162000,162000
056054,亞德客元大97購05,0,0,0,0,0,0,0,0,0,162000,0,0,0,162000,0,162000,162000
059868,台光電凱基99購03,0,0,0,0,0,0,0,0,0,161000,0,0,0,177000,16000,161000,161000
053777,台積電元大96購20,0,0,0,0,0,0,0,0,0,161000,0,0,0,161000,0,161000,161000
059259,FBVIX中信03購06 ,0,0,0,0,0,0,0,0,0,161000,0,0,0,482000,321000,161000,161000
053918,美律國票97購01  ,0,0,0,0,0,0,0,0,0,160000,0,0,0,160000,0,160000,160000
051491,貿聯凱基95購01  ,0,0,0,0,0,0,0,0,0,160000,0,0,0,160000,0,160000,160000
052880,台積電凱基96購06,0,0,0,0,0,0,0,0,0,160000,0,0,0,160000,0,160000,160000
00645,富邦日本        ,0,0,0,0,0,0,0,0,0,160000,0,0,0,235000,75000,160000,160000
056678,力成元富98購01  ,0,0,0,0,0,0,0,0,0,160000,0,0,0,160000,0,160000,160000
057664,台積電元大9A購03,0,0,0,0,0,0,0,0,0,159000,0,0,0,159000,0,159000,159000
059378,台光電群益9B購01,0,0,0,0,0,0,0,0,0,158000,0,0,0,175000,17000,158000,158000
1714,和桐            ,518000,361000,157000,0,0,0,0,0,0,1000,1000,0,1000,0,0,0,158000
055806,致新永豐97購02  ,0,0,0,0,0,0,0,0,0,158000,0,0,0,236000,78000,158000,158000
055063,玉晶光永豐99購01,0,0,0,0,0,0,0,0,0,158000,0,0,0,158000,0,158000,158000
2617,台航            ,183000,26000,157000,0,0,0,0,0,0,0,0,0,0,0,0,0,157000
059316,國巨元大99購23  ,0,0,0,0,0,0,0,0,0,157000,0,0,0,273000,116000,157000,157000
00675L,富邦臺灣加權正2 ,63000,96000,-33000,0,0,0,0,0,0,190000,0,0,0,521000,331000,190000,157000
049153,大立光元大96購02,0,0,0,0,0,0,0,0,0,157000,0,0,0,157000,0,157000,157000
053584,友達元大9B購02  ,0,0,0,0,0,0,0,0,0,157000,0,0,0,313000,156000,157000,157000
053915,光罩國票96購02  ,0,0,0,0,0,0,0,0,0,157000,0,0,0,429000,272000,157000,157000
058464,矽創兆豐9A購01  ,0,0,0,0,0,0,0,0,0,157000,0,0,0,167000,10000,157000,157000
9105,泰金寶-DR       ,248000,91000,157000,0,0,0,0,0,0,0,0,0,0,0,0,0,157000
048983,牧德元大95購01  ,0,0,0,0,0,0,0,0,0,156000,0,0,0,156000,0,156000,156000
056882,華邦電康和98購01,0,0,0,0,0,0,0,0,0,156000,0,0,0,224000,68000,156000,156000
056269,新日興統一98購01,0,0,0,0,0,0,0,0,0,156000,0,0,0,156000,0,156000,156000
054499,台光電永豐96購02,0,0,0,0,0,0,0,0,0,156000,0,0,0,232000,76000,156000,156000
054819,裕民元大9A購01  ,0,0,0,0,0,0,0,0,0,156000,0,0,0,176000,20000,156000,156000
056515,燿華兆豐99購01  ,0,0,0,0,0,0,0,0,0,156000,0,0,0,165000,9000,156000,156000
2388,威盛            ,232000,76040,155960,0,0,0,0,0,0,0,0,0,0,0,0,0,155960
6415,矽力-KY         ,528000,378000,150000,0,0,0,0,0,0,5000,1000,0,1000,5000,1000,4000,155000
6230,超眾            ,308000,185000,123000,0,0,0,0,0,0,32000,0,0,0,37000,5000,32000,155000
046208,滬深2X元富95購03,0,0,0,0,0,0,0,0,0,155000,0,0,0,155000,0,155000,155000
051619,智邦凱基95購07  ,0,0,0,0,0,0,0,0,0,155000,0,0,0,167000,12000,155000,155000
059246,奇力新凱基9A購02,0,0,0,0,0,0,0,0,0,155000,0,0,0,207000,52000,155000,155000
053962,聯茂永豐96購01  ,0,0,0,0,0,0,0,0,0,154000,0,0,0,159000,5000,154000,154000
052575,茂林凱基96購04  ,10000,0,10000,0,0,0,0,0,0,144000,0,0,0,344000,200000,144000,154000
054544,統一中信97購01  ,0,0,0,0,0,0,0,0,0,154000,0,0,0,154000,0,154000,154000
059529,華新科凱基9A購04,0,0,0,0,0,0,0,0,0,153000,0,0,0,305000,152000,153000,153000
057526,智邦元大98購10  ,0,0,0,0,0,0,0,0,0,153000,0,0,0,157000,4000,153000,153000
055917,禾伸堂凱基98購02,0,0,0,0,0,0,0,0,0,152000,0,0,0,152000,0,152000,152000
4967,十銓            ,558000,418000,140000,0,0,0,0,0,0,11000,11000,0,11000,0,0,0,151000
07306P,台灣50凱基9A售09,0,0,0,0,0,0,0,0,0,151000,0,0,0,379000,228000,151000,151000
056500,大立光富邦9B購02,0,0,0,0,0,0,0,0,0,151000,0,0,0,151000,0,151000,151000
059252,聯詠凱基99購03  ,0,0,0,0,0,0,0,0,0,151000,0,0,0,193000,42000,151000,151000
07224P,鴻海元大9A售02  ,0,0,0,0,0,0,0,0,0,150000,0,0,0,150000,0,150000,150000
6191,精成科          ,525000,375000,150000,0,0,0,0,0,0,0,0,1000,-1000,1000,0,1000,150000
052125,群創國票95購02  ,0,0,0,0,0,0,0,0,0,150000,0,0,0,150000,0,150000,150000
053495,聯發科兆豐96購02,0,0,0,0,0,0,0,0,0,150000,0,0,0,150000,0,150000,150000
046626,台光電統一94購01,0,0,0,0,0,0,0,0,0,150000,0,0,0,150000,0,150000,150000
050517,台積電元大94購27,0,0,0,0,0,0,0,0,0,150000,0,0,0,150000,0,150000,150000
057655,奇力新中信98購05,0,0,0,0,0,0,0,0,0,150000,0,0,0,150000,0,150000,150000
05693P,滬深2X凱基98售02,0,0,0,0,0,0,0,0,0,150000,0,0,0,150000,0,150000,150000
055362,GIS凱基97購03   ,0,0,0,0,0,0,0,0,0,150000,0,0,0,150000,0,150000,150000
055592,奇力新元大97購07,0,0,0,0,0,0,0,0,0,150000,0,0,0,150000,0,150000,150000
055067,禾聯碩永豐97購01,0,0,0,0,0,0,0,0,0,150000,0,0,0,150000,0,150000,150000
049675,台光電國票95購01,0,0,0,0,0,0,0,0,0,149000,0,0,0,149000,0,149000,149000
046159,群創群益98購04  ,0,0,0,0,0,0,0,0,0,149000,0,0,0,149000,0,149000,149000
055736,宏達電元富99購01,0,0,0,0,0,0,0,0,0,149000,0,0,0,280000,131000,149000,149000
053625,國巨兆豐96購03  ,0,0,0,0,0,0,0,0,0,147000,0,0,0,157000,10000,147000,147000
054932,台肥元大97購01  ,0,0,0,0,0,0,0,0,0,147000,0,0,0,192000,45000,147000,147000
00663L,國泰臺灣加權正2 ,0,0,0,0,0,0,0,0,0,146000,0,0,0,255000,109000,146000,146000
051066,台積電國票96購02,0,0,0,0,0,0,0,0,0,146000,0,0,0,146000,0,146000,146000
050171,臺指反元大97購03,0,0,0,0,0,0,0,0,0,146000,0,0,0,400000,254000,146000,146000
056308,TPK元大97購02   ,0,0,0,0,0,0,0,0,0,146000,0,0,0,211000,65000,146000,146000
057525,光磊元大99購01  ,0,0,0,0,0,0,0,0,0,146000,0,0,0,146000,0,146000,146000
056766,義隆元大98購01  ,1000,0,1000,0,0,0,0,0,0,145000,0,0,0,199000,54000,145000,146000
07301P,臺股指元大9A售34,0,0,0,0,0,0,0,0,0,145000,0,0,0,333000,188000,145000,145000
00668,國泰美國道瓊    ,0,0,0,0,0,0,0,0,0,145000,0,0,0,258000,113000,145000,145000
057793,群創統一99購02  ,0,0,0,0,0,0,0,0,0,145000,0,0,0,145000,0,145000,145000
053283,同欣電元大96購03,0,0,0,0,0,0,0,0,0,144000,0,0,0,144000,0,144000,144000
059136,臺股指群益99購11,0,0,0,0,0,0,0,0,0,144000,0,0,0,156000,12000,144000,144000
057226,上銀凱基98購06  ,0,0,0,0,0,0,0,0,0,144000,0,0,0,198000,54000,144000,144000
053122,美律凱基98購01  ,0,0,0,0,0,0,0,0,0,143000,0,0,0,143000,0,143000,143000
058533,玉晶光元富99購01,0,0,0,0,0,0,0,0,0,143000,0,0,0,179000,36000,143000,143000
058271,訊連永豐99購01  ,0,0,0,0,0,0,0,0,0,143000,0,0,0,170000,27000,143000,143000
07243P,台灣50凱基9A售04,0,0,0,0,0,0,0,0,0,142000,0,0,0,155000,13000,142000,142000
2461,光群雷          ,241000,99000,142000,0,0,0,0,0,0,0,0,0,0,0,0,0,142000
050223,聯茂元富94購02  ,0,0,0,0,0,0,0,0,0,142000,0,0,0,142000,0,142000,142000
059480,美律群益9A購01  ,0,0,0,0,0,0,0,0,0,141000,0,0,0,178000,37000,141000,141000
05268P,玉晶光元大98售01,0,0,0,0,0,0,0,0,0,141000,0,0,0,151000,10000,141000,141000
057774,台光電群益99購02,0,0,0,0,0,0,0,0,0,141000,0,0,0,141000,0,141000,141000
058949,上銀群益99購02  ,0,0,0,0,0,0,0,0,0,141000,0,0,0,141000,0,141000,141000
2480,敦陽科          ,169000,91000,78000,0,0,0,0,0,0,62000,63000,1000,62000,0,0,0,140000
052848,聯發科統一96購03,0,0,0,0,0,0,0,0,0,140000,0,0,0,140000,0,140000,140000
050744,健策永豐94購04  ,0,0,0,0,0,0,0,0,0,140000,0,0,0,140000,0,140000,140000
052223,聯電凱基96購02  ,0,0,0,0,0,0,0,0,0,140000,0,0,0,140000,0,140000,140000
053955,華通永豐96購04  ,0,0,0,0,0,0,0,0,0,140000,0,0,0,166000,26000,140000,140000
055703,緯穎富邦98購01  ,0,0,0,0,0,0,0,0,0,140000,0,0,0,142000,2000,140000,140000
056621,宏達電永豐98購01,0,0,0,0,0,0,0,0,0,140000,0,0,0,140000,0,140000,140000
3022,威強電          ,176000,37000,139000,0,0,0,0,0,0,0,0,0,0,0,0,0,139000
3617,碩天            ,142000,63000,79000,0,0,0,60000,0,60000,0,0,0,0,0,0,0,139000
06898P,FBVIX群益9C售03 ,0,0,0,0,0,0,0,0,0,139000,0,0,0,139000,0,139000,139000
059840,鴻海富邦9A購02  ,0,0,0,0,0,0,0,0,0,138000,0,0,0,162000,24000,138000,138000
2634,漢翔            ,437000,298000,139000,0,0,0,0,0,0,-1000,0,1000,-1000,0,0,0,138000
054057,晶豪科國票97購01,0,0,0,0,0,0,0,0,0,138000,0,0,0,153000,15000,138000,138000
058187,泰碩永豐99購01  ,0,0,0,0,0,0,0,0,0,137000,0,0,0,178000,41000,137000,137000
057873,義隆元大98購03  ,0,0,0,0,0,0,0,0,0,137000,0,0,0,147000,10000,137000,137000
054405,樺漢康和96購01  ,0,0,0,0,0,0,0,0,0,137000,0,0,0,137000,0,137000,137000
057587,微星國票99購01  ,0,0,0,0,0,0,0,0,0,137000,0,0,0,137000,0,137000,137000
07303P,臺股指元大9A售36,0,0,0,0,0,0,0,0,0,136000,0,0,0,278000,142000,136000,136000
053305,聯詠凱基96購02  ,0,0,0,0,0,0,0,0,0,136000,0,0,0,193000,57000,136000,136000
056579,麗豐元大99購01  ,0,0,0,0,0,0,0,0,0,136000,0,0,0,175000,39000,136000,136000
1526,日馳            ,189000,54000,135000,0,0,0,0,0,0,0,0,0,0,0,0,0,135000
051999,勤誠元大95購01  ,0,0,0,0,0,0,0,0,0,135000,0,0,0,135000,0,135000,135000
058614,台郡元大9A購01  ,0,0,0,0,0,0,0,0,0,135000,0,0,0,135000,0,135000,135000
056893,智邦元大98購02  ,0,0,0,0,0,0,0,0,0,135000,0,0,0,164000,29000,135000,135000
059038,健策群益9A購02  ,0,0,0,0,0,0,0,0,0,135000,0,0,0,135000,0,135000,135000
058814,南亞科台新99購01,0,0,0,0,0,0,0,0,0,134000,0,0,0,134000,0,134000,134000
054578,世芯元大99購01  ,0,0,0,0,0,0,0,0,0,133000,0,0,0,133000,0,133000,133000
3014,聯陽            ,296000,165000,131000,0,0,0,0,0,0,1000,0,0,0,3000,2000,1000,132000
051809,義隆凱基96購01  ,0,0,0,0,0,0,0,0,0,132000,0,0,0,186000,54000,132000,132000
05232P,緯穎群益95售01  ,0,0,0,0,0,0,0,0,0,132000,0,0,0,132000,0,132000,132000
048431,瑞昱國票94購01  ,0,0,0,0,0,0,0,0,0,132000,0,0,0,132000,0,132000,132000
2614,東森            ,259000,128000,131000,0,0,0,0,0,0,0,0,0,0,0,0,0,131000
4961,天鈺            ,194000,70000,124000,0,0,0,0,0,0,7000,7000,0,7000,0,0,0,131000
053627,宏碁兆豐97購01  ,0,0,0,0,0,0,0,0,0,131000,0,0,0,138000,7000,131000,131000
051970,元黃金凱基98購01,0,0,0,0,0,0,0,0,0,131000,0,0,0,131000,0,131000,131000
058763,和碩群益99購01  ,0,0,0,0,0,0,0,0,0,131000,0,0,0,143000,12000,131000,131000
055054,群光永豐97購01  ,0,0,0,0,0,0,0,0,0,131000,0,0,0,175000,44000,131000,131000
054253,宏達電元大97購03,0,0,0,0,0,0,0,0,0,130000,0,0,0,152000,22000,130000,130000
051339,智易永豐95購02  ,0,0,0,0,0,0,0,0,0,130000,0,0,0,130000,0,130000,130000
055184,群創統一98購02  ,0,0,0,0,0,0,0,0,0,130000,0,0,0,170000,40000,130000,130000
056157,聯詠凱基97購03  ,0,0,0,0,0,0,0,0,0,130000,0,0,0,196000,66000,130000,130000
058687,聯茂凱基9A購01  ,0,0,0,0,0,0,0,0,0,129000,0,0,0,177000,48000,129000,129000
051501,康友群益95購02  ,0,0,0,0,0,0,0,0,0,128000,0,0,0,128000,0,128000,128000
052068,瑞儀兆豐96購01  ,0,0,0,0,0,0,0,0,0,128000,0,0,0,150000,22000,128000,128000
056446,聯發科凱基98購08,0,0,0,0,0,0,0,0,0,128000,0,0,0,128000,0,128000,128000
8011,台通            ,136000,8000,128000,0,0,0,0,0,0,0,0,0,0,0,0,0,128000
07233P,台灣50元大99售04,0,0,0,0,0,0,0,0,0,126000,0,0,0,200000,74000,126000,126000
056176,創意元富97購01  ,0,0,0,0,0,0,0,0,0,126000,0,0,0,281000,155000,126000,126000
059260,國巨中信99購05  ,0,0,0,0,0,0,0,0,0,126000,0,0,0,144000,18000,126000,126000
056915,上銀兆豐99購01  ,0,0,0,0,0,0,0,0,0,126000,0,0,0,168000,42000,126000,126000
052092,貿聯元大96購02  ,0,0,0,0,0,0,0,0,0,125000,0,0,0,125000,0,125000,125000
054265,GIS元大96購03   ,0,0,0,0,0,0,0,0,0,125000,0,0,0,554000,429000,125000,125000
053392,致新元大96購01  ,0,0,0,0,0,0,0,0,0,125000,0,0,0,125000,0,125000,125000
047219,美律麥證94購01  ,0,0,0,125000,0,125000,0,0,0,125000,0,0,0,125000,0,125000,125000
048847,A50群益98購01   ,0,0,0,0,0,0,0,0,0,125000,0,0,0,135000,10000,125000,125000
5264,鎧勝-KY         ,393000,319000,74000,0,0,0,0,0,0,50000,48000,0,48000,2000,0,2000,124000
6166,凌華            ,310000,181000,129000,0,0,0,0,0,0,-5000,0,5000,-5000,0,0,0,124000
3563,牧德            ,246000,247000,-1000,0,0,0,29000,0,29000,96000,62000,2000,60000,38000,2000,36000,124000
053251,世紀鋼國票97購02,0,0,0,0,0,0,0,0,0,124000,0,0,0,124000,0,124000,124000
054965,健策元大98購04  ,0,0,0,0,0,0,0,0,0,124000,0,0,0,124000,0,124000,124000
058067,台積電第一9C購01,0,0,0,0,0,0,0,0,0,124000,0,0,0,124000,0,124000,124000
07207P,台積電凱基99售13,0,0,0,0,0,0,0,0,0,123000,0,0,0,123000,0,123000,123000
051643,瑞昱康和95購01  ,0,0,0,0,0,0,0,0,0,123000,0,0,0,124000,1000,123000,123000
053729,聯茂凱基96購05  ,0,0,0,0,0,0,0,0,0,123000,0,0,0,174000,51000,123000,123000
058612,健策元大99購02  ,0,0,0,0,0,0,0,0,0,123000,0,0,0,123000,0,123000,123000
057517,矽創元富98購02  ,0,0,0,0,0,0,0,0,0,123000,0,0,0,360000,237000,123000,123000
3209,全科            ,122000,1000,121000,0,0,0,0,0,0,1000,1000,0,1000,0,0,0,122000
054353,世紀鋼國泰98購01,0,0,0,0,0,0,0,0,0,122000,0,0,0,122000,0,122000,122000
051315,同欣電麥證95購01,0,0,0,122000,0,122000,0,0,0,122000,0,0,0,122000,0,122000,122000
050801,元金2X群益98購01,0,0,0,0,0,0,0,0,0,122000,0,0,0,122000,0,122000,122000
03050X,元展47          ,0,0,0,0,0,0,0,0,0,122000,0,0,0,122000,0,122000,122000
059460,GIS永豐99購02   ,0,0,0,0,0,0,0,0,0,121000,0,0,0,170000,49000,121000,121000
06912P,台光電元大99售02,0,0,0,0,0,0,0,0,0,121000,0,0,0,121000,0,121000,121000
04405P,牧德國票95售01  ,0,0,0,0,0,0,0,0,0,121000,0,0,0,121000,0,121000,121000
051259,鴻海永昌96購03  ,0,0,0,0,0,0,0,0,0,121000,0,0,0,121000,0,121000,121000
049439,牧德國泰96購01  ,0,0,0,0,0,0,0,0,0,121000,0,0,0,121000,0,121000,121000
051961,泰碩永豐95購01  ,0,0,0,0,0,0,0,0,0,121000,0,0,0,291000,170000,121000,121000
057956,全新元大99購04  ,0,0,0,0,0,0,0,0,0,121000,0,0,0,173000,52000,121000,121000
055456,上銀富邦99購01  ,0,0,0,0,0,0,0,0,0,121000,0,0,0,121000,0,121000,121000
058060,貿聯元富98購01  ,0,0,0,0,0,0,0,0,0,120000,0,0,0,190000,70000,120000,120000
053667,鴻海統一96購12  ,0,0,0,0,0,0,0,0,0,120000,0,0,0,120000,0,120000,120000
053270,台塑元大96購01  ,0,0,0,0,0,0,0,0,0,120000,0,0,0,120000,0,120000,120000
051562,玉晶光國泰97購05,0,0,0,0,0,0,0,0,0,120000,0,0,0,120000,0,120000,120000
052210,華夏元大95購01  ,0,0,0,0,0,0,0,0,0,120000,0,0,0,120000,0,120000,120000
052288,敦南統一95購01  ,0,0,0,0,0,0,0,0,0,120000,0,0,0,120000,0,120000,120000
054208,台積電國票97購07,0,0,0,0,0,0,0,0,0,120000,0,0,0,120000,0,120000,120000
048186,元黃金元大96購01,0,0,0,0,0,0,0,0,0,120000,0,0,0,120000,0,120000,120000
048070,聯發科元富99購03,0,0,0,0,0,0,0,0,0,120000,0,0,0,120000,0,120000,120000
058138,晶相光元大9C購01,0,0,0,0,0,0,0,0,0,120000,0,0,0,120000,0,120000,120000
056942,昇陽半元富98購01,0,0,0,0,0,0,0,0,0,120000,0,0,0,120000,0,120000,120000
056607,貿聯富邦99購02  ,0,0,0,0,0,0,0,0,0,120000,0,0,0,130000,10000,120000,120000
055827,中石化元大98購01,0,0,0,0,0,0,0,0,0,120000,0,0,0,120000,0,120000,120000
059439,健策元大9B購01  ,0,0,0,0,0,0,0,0,0,119000,0,0,0,129000,10000,119000,119000
059563,鴻海凱基9A購14  ,0,0,0,0,0,0,0,0,0,119000,0,0,0,268000,149000,119000,119000
059830,台郡凱基99購05  ,0,0,0,0,0,0,0,0,0,119000,0,0,0,128000,9000,119000,119000
047194,世紀鋼元大96購01,0,0,0,0,0,0,0,0,0,119000,0,0,0,130000,11000,119000,119000
057568,友訊永豐99購01  ,0,0,0,0,0,0,0,0,0,119000,0,0,0,120000,1000,119000,119000
056391,大立光富邦9C購01,0,0,0,0,0,0,0,0,0,119000,0,0,0,119000,0,119000,119000
056501,貿聯富邦99購01  ,0,0,0,0,0,0,0,0,0,119000,0,0,0,119000,0,119000,119000
058669,上銀群益99購01  ,0,0,0,0,0,0,0,0,0,119000,0,0,0,119000,0,119000,119000
057929,上銀群益98購02  ,0,0,0,0,0,0,0,0,0,118000,0,0,0,118000,0,118000,118000
058850,華新科群益99購03,0,0,0,0,0,0,0,0,0,118000,0,0,0,324000,206000,118000,118000
059294,宏達電元富9B購02,0,0,0,0,0,0,0,0,0,117000,0,0,0,117000,0,117000,117000
07290P,台灣50凱基9A售08,0,0,0,0,0,0,0,0,0,117000,0,0,0,134000,17000,117000,117000
051300,台光電凱基96購02,0,0,0,0,0,0,0,0,0,117000,0,0,0,153000,36000,117000,117000
058604,華邦電元大99購03,0,0,0,0,0,0,0,0,0,117000,0,0,0,142000,25000,117000,117000
059346,新日興凱基99購03,0,0,0,0,0,0,0,0,0,116000,0,0,0,116000,0,116000,116000
059431,旺宏元大99購14  ,0,0,0,0,0,0,0,0,0,116000,0,0,0,323000,207000,116000,116000
059831,聯詠康和99購01  ,0,0,0,0,0,0,0,0,0,116000,0,0,0,140000,24000,116000,116000
053451,致新凱基96購02  ,0,0,0,0,0,0,0,0,0,116000,0,0,0,172000,56000,116000,116000
056065,奇鋐元大97購01  ,0,0,0,0,0,0,0,0,0,116000,0,0,0,133000,17000,116000,116000
059442,祥碩元大99購03  ,0,0,0,0,0,0,0,0,0,115000,0,0,0,672000,557000,115000,115000
059533,富邦金凱基99購01,0,0,0,0,0,0,0,0,0,115000,0,0,0,217000,102000,115000,115000
054774,同欣電國票98購01,0,0,0,0,0,0,0,0,0,115000,0,0,0,115000,0,115000,115000
059650,緯穎凱基99購04  ,0,0,0,0,0,0,0,0,0,114000,0,0,0,149000,35000,114000,114000
06154P,超眾元大98售01  ,0,0,0,0,0,0,0,0,0,114000,0,0,0,115000,1000,114000,114000
07146P,瑞昱元大99售02  ,0,0,0,0,0,0,0,0,0,114000,0,0,0,114000,0,114000,114000
053804,富邦金凱基96購01,0,0,0,0,0,0,0,0,0,114000,0,0,0,118000,4000,114000,114000
058267,奇鋐永豐99購01  ,0,0,0,0,0,0,0,0,0,114000,0,0,0,114000,0,114000,114000
5243,乙盛-KY         ,126000,50000,76000,0,0,0,0,0,0,37000,37000,0,37000,0,0,0,113000
3052,夆典            ,188000,75000,113000,0,0,0,0,0,0,0,0,0,0,0,0,0,113000
06890P,金融類元大98售02,0,0,0,0,0,0,0,0,0,113000,0,0,0,113000,0,113000,113000
060088,國巨元大99購30  ,0,0,0,0,0,0,0,0,0,113000,0,0,0,251000,138000,113000,113000
058830,健策永豐99購02  ,0,0,0,0,0,0,0,0,0,113000,0,0,0,113000,0,113000,113000
058523,聯茂元大99購08  ,0,0,0,0,0,0,0,0,0,113000,0,0,0,113000,0,113000,113000
054417,牧德元大96購01  ,0,0,0,0,0,0,0,0,0,112000,0,0,0,112000,0,112000,112000
051771,上銀中信95購01  ,0,0,0,0,0,0,0,0,0,112000,0,0,0,112000,0,112000,112000
047063,漢唐凱基95購01  ,0,0,0,0,0,0,0,0,0,112000,0,0,0,121000,9000,112000,112000
057288,聯茂元大98購03  ,0,0,0,0,0,0,0,0,0,112000,0,0,0,138000,26000,112000,112000
057161,亞德客元大98購02,0,0,0,0,0,0,0,0,0,112000,0,0,0,128000,16000,112000,112000
057053,立積元大98購02  ,0,0,0,0,0,0,0,0,0,112000,0,0,0,200000,88000,112000,112000
055829,上銀元大97購06  ,0,0,0,0,0,0,0,0,0,112000,0,0,0,132000,20000,112000,112000
055714,智邦元大97購03  ,0,0,0,0,0,0,0,0,0,112000,0,0,0,135000,23000,112000,112000
059161,鴻海凱基9A購09  ,0,0,0,0,0,0,0,0,0,112000,0,0,0,173000,61000,112000,112000
060087,鴻海元大99購43  ,0,0,0,0,0,0,0,0,0,111000,0,0,0,208000,97000,111000,111000
059786,全新元大99購06  ,0,0,0,0,0,0,0,0,0,111000,0,0,0,225000,114000,111000,111000
059352,台灣50富邦01購01,0,0,0,0,0,0,0,0,0,111000,0,0,0,130000,19000,111000,111000
1417,嘉裕            ,114000,3000,111000,0,0,0,0,0,0,0,0,0,0,0,0,0,111000
04993P,上銀兆豐96售01  ,0,0,0,0,0,0,0,0,0,111000,0,0,0,111000,0,111000,111000
051911,大立光元大98購02,0,0,0,0,0,0,0,0,0,111000,0,0,0,124000,13000,111000,111000
6108,競國            ,163000,53000,110000,0,0,0,0,0,0,0,0,0,0,0,0,0,110000
06300P,緯穎元大97售04  ,0,0,0,0,0,0,0,0,0,110000,0,0,0,311000,201000,110000,110000
05221P,玉晶光元大95售04,0,0,0,0,0,0,0,0,0,110000,0,0,0,120000,10000,110000,110000
052167,亞泥元大96購01  ,0,0,0,0,0,0,0,0,0,110000,0,0,0,110000,0,110000,110000
053446,欣興凱基96購02  ,0,0,0,0,0,0,0,0,0,110000,0,0,0,220000,110000,110000,110000
053441,旺宏凱基98購01  ,0,0,0,0,0,0,0,0,0,110000,0,0,0,110000,0,110000,110000
053375,鴻海元大96購18  ,0,0,0,0,0,0,0,0,0,110000,0,0,0,110000,0,110000,110000
058398,中環元大99購02  ,0,0,0,0,0,0,0,0,0,110000,0,0,0,110000,0,110000,110000
050188,貿聯元大96購01  ,0,0,0,0,0,0,0,0,0,110000,0,0,0,110000,0,110000,110000
054177,牧德台新97購01  ,0,0,0,0,0,0,0,0,0,110000,0,0,0,140000,30000,110000,110000
051218,聯發科元富9B購02,0,0,0,0,0,0,0,0,0,110000,0,0,0,110000,0,110000,110000
059210,鴻海元大99購26  ,0,0,0,0,0,0,0,0,0,110000,0,0,0,110000,0,110000,110000
059134,臺股指群益99購09,0,0,0,0,0,0,0,0,0,110000,0,0,0,123000,13000,110000,110000
057455,景碩國泰99購01  ,0,0,0,0,0,0,0,0,0,110000,0,0,0,110000,0,110000,110000
056359,旺宏元大9A購01  ,0,0,0,0,0,0,0,0,0,110000,0,0,0,110000,0,110000,110000
6672,騰輝電子-KY     ,142000,32000,110000,0,0,0,0,0,0,0,0,0,0,0,0,0,110000
5234,達興材料        ,147000,65000,82000,0,0,0,0,0,0,27000,31000,4000,27000,0,0,0,109000
052855,群創日盛99購01  ,0,0,0,0,0,0,0,0,0,109000,0,0,0,649000,540000,109000,109000
057817,景碩元大98購01  ,0,0,0,0,0,0,0,0,0,109000,0,0,0,119000,10000,109000,109000
052934,中磊元大96購01  ,0,0,0,0,0,0,0,0,0,108000,0,0,0,243000,135000,108000,108000
4725,信昌化          ,180000,73000,107000,0,0,0,0,0,0,0,0,0,0,0,0,0,107000
060060,台積電兆豐99購05,0,0,0,0,0,0,0,0,0,107000,0,0,0,115000,8000,107000,107000
054316,矽創凱基97購01  ,0,0,0,0,0,0,0,0,0,107000,0,0,0,347000,240000,107000,107000
051848,元金2X中信98購02,0,0,0,0,0,0,0,0,0,107000,0,0,0,107000,0,107000,107000
054404,新日興康和96購01,0,0,0,0,0,0,0,0,0,107000,0,0,0,107000,0,107000,107000
2501,國建            ,243000,195000,48000,0,0,0,0,0,0,58000,58000,0,58000,0,0,0,106000
2208,台船            ,295000,189000,106000,0,0,0,0,0,0,0,0,0,0,0,0,0,106000
055215,智邦凱基98購02  ,0,0,0,0,0,0,0,0,0,106000,0,0,0,156000,50000,106000,106000
054944,精元元大97購01  ,0,0,0,0,0,0,0,0,0,106000,0,0,0,106000,0,106000,106000
055974,上銀統一97購05  ,0,0,0,0,0,0,0,0,0,106000,0,0,0,107000,1000,106000,106000
055949,亞德客元大97購04,0,0,0,0,0,0,0,0,0,106000,0,0,0,122000,16000,106000,106000
058758,台積電群益99購05,0,0,0,0,0,0,0,0,0,106000,0,0,0,106000,0,106000,106000
1339,昭輝            ,154000,74000,80000,0,0,0,0,0,0,25000,25000,0,25000,0,0,0,105000
2485,兆赫            ,224000,113000,111000,0,0,0,0,0,0,-6000,6000,10000,-4000,0,2000,-2000,105000
059359,精元永豐99購01  ,0,0,0,0,0,0,0,0,0,105000,0,0,0,252000,147000,105000,105000
059562,上銀凱基99購09  ,0,0,0,0,0,0,0,0,0,105000,0,0,0,126000,21000,105000,105000
053614,台積電群益96購08,0,0,0,0,0,0,0,0,0,105000,0,0,0,105000,0,105000,105000
052523,奇力新元大97購01,0,0,0,0,0,0,0,0,0,105000,0,0,0,105000,0,105000,105000
053891,欣興群益98購01  ,0,0,0,0,0,0,0,0,0,105000,0,0,0,105000,0,105000,105000
052693,微星中信96購01  ,0,0,0,0,0,0,0,0,0,104000,0,0,0,104000,0,104000,104000
059273,臺指反元大9C購03,0,0,0,0,0,0,0,0,0,104000,0,0,0,363000,259000,104000,104000
3437,榮創            ,182000,79000,103000,0,0,0,0,0,0,0,0,0,0,0,0,0,103000
5225,東科-KY         ,122000,19000,103000,0,0,0,0,0,0,0,0,0,0,0,0,0,103000
052674,智邦國泰98購01  ,0,0,0,0,0,0,0,0,0,103000,0,0,0,229000,126000,103000,103000
052606,聯發科元大97購04,0,0,0,0,0,0,0,0,0,103000,0,0,0,103000,0,103000,103000
057154,易華電國泰99購01,0,0,0,0,0,0,0,0,0,103000,0,0,0,103000,0,103000,103000
058568,宏達電凱基9A購02,0,0,0,0,0,0,0,0,0,103000,0,0,0,106000,3000,103000,103000
07292P,臺股指凱基99售44,0,0,0,0,0,0,0,0,0,102000,0,0,0,997000,895000,102000,102000
053062,緯穎富邦97購01  ,0,0,0,0,0,0,0,0,0,102000,0,0,0,218000,116000,102000,102000
058397,大成鋼元大99購02,0,0,0,0,0,0,0,0,0,102000,0,0,0,320000,218000,102000,102000
058670,鴻海群益9A購03  ,0,0,0,0,0,0,0,0,0,102000,0,0,0,102000,0,102000,102000
057162,上銀元大98購03  ,0,0,0,0,0,0,0,0,0,102000,0,0,0,110000,8000,102000,102000
8429,金麗-KY         ,114000,12000,102000,0,0,0,0,0,0,0,0,0,0,0,0,0,102000
1589,永冠-KY         ,173000,41000,132000,0,0,0,0,0,0,-31000,0,31000,-31000,0,0,0,101000
059566,台積電凱基9A購11,0,0,0,0,0,0,0,0,0,101000,0,0,0,171000,70000,101000,101000
053583,漢唐元大96購03  ,0,0,0,0,0,0,0,0,0,101000,0,0,0,131000,30000,101000,101000
057316,國巨凱基99購04  ,0,0,0,0,0,0,0,0,0,101000,0,0,0,101000,0,101000,101000
057642,南亞科元大98購07,0,0,0,0,0,0,0,0,0,101000,0,0,0,131000,30000,101000,101000
059239,台積電凱基99購12,0,0,0,0,0,0,0,0,0,101000,0,0,0,101000,0,101000,101000
05464P,華通康和95售02  ,0,0,0,0,0,0,0,0,0,101000,0,0,0,152000,51000,101000,101000
057491,美食元大98購03  ,0,0,0,0,0,0,0,0,0,101000,0,0,0,240000,139000,101000,101000
059900,上証反元大99購03,0,0,0,0,0,0,0,0,0,100000,0,0,0,100000,0,100000,100000
06667P,鴻海凱基98售11  ,0,0,0,0,0,0,0,0,0,100000,0,0,0,100000,0,100000,100000
07353P,大立光國票99售02,0,0,0,0,0,0,0,0,0,100000,0,0,0,100000,0,100000,100000
6120,達運            ,254000,154000,100000,0,0,0,0,0,0,0,0,0,0,0,0,0,100000
054432,台積電台新96購05,0,0,0,0,0,0,0,0,0,100000,0,0,0,100000,0,100000,100000
052546,友達中信98購01  ,0,0,0,0,0,0,0,0,0,100000,0,0,0,100000,0,100000,100000
052378,矽力元大96購01  ,0,0,0,0,0,0,0,0,0,100000,0,0,0,100000,0,100000,100000
054199,大立光永昌96購07,0,0,0,0,0,0,0,0,0,100000,0,0,0,100000,0,100000,100000
051458,臺股指元大95購18,0,0,0,0,0,0,0,0,0,100000,0,0,0,126000,26000,100000,100000
052152,創意富邦98購01  ,0,0,0,0,0,0,0,0,0,100000,0,0,0,100000,0,100000,100000
052190,創意群益95購03  ,0,0,0,0,0,0,0,0,0,100000,0,0,0,100000,0,100000,100000
058380,臺股指凱基99購15,0,0,0,0,0,0,0,0,0,100000,0,0,0,100000,0,100000,100000
058211,國巨群益9A購02  ,0,0,0,0,0,0,0,0,0,100000,0,0,0,100000,0,100000,100000
057945,京鼎國票99購03  ,0,0,0,0,0,0,0,0,0,100000,0,0,0,100000,0,100000,100000
048698,宏達電國票95購01,0,0,0,0,0,0,0,0,0,100000,0,0,0,100000,0,100000,100000
048402,聯茂兆豐95購01  ,0,0,0,0,0,0,0,0,0,100000,0,0,0,100000,0,100000,100000
052851,滬深2X元富96購02,0,0,0,0,0,0,0,0,0,100000,0,0,0,100000,0,100000,100000
054132,聯發科元大97購10,0,0,0,0,0,0,0,0,0,100000,0,0,0,100000,0,100000,100000
052828,滬深2X群益9A購02,0,0,0,0,0,0,0,0,0,100000,0,0,0,100000,0,100000,100000
049585,旺宏元大95購02  ,0,0,0,0,0,0,0,0,0,100000,0,0,0,100000,0,100000,100000
049606,可成第一94購01  ,0,0,0,0,0,0,0,0,0,100000,0,0,0,100000,0,100000,100000
049870,南電兆豐94購01  ,0,0,0,0,0,0,0,0,0,100000,0,0,0,100000,0,100000,100000
04810P,亞德客元大94售01,0,0,0,0,0,0,0,0,0,100000,0,0,0,100000,0,100000,100000
050503,聯發科凱基94購22,0,0,0,0,0,0,0,0,0,100000,0,0,0,100000,0,100000,100000
05125P,鴻海群益95售06  ,0,0,0,0,0,0,0,0,0,100000,0,0,0,100000,0,100000,100000
051226,英業達群益95購01,0,0,0,0,0,0,0,0,0,100000,0,0,0,100000,0,100000,100000
048010,嘉聯益富邦97購01,0,0,0,0,0,0,0,0,0,100000,0,0,0,100000,0,100000,100000
047285,鴻海統一95購02  ,0,0,0,0,0,0,0,0,0,100000,0,0,0,100000,0,100000,100000
045872,元油2X元富98購03,100000,0,100000,0,0,0,0,0,0,0,0,0,0,0,0,0,100000
04592P,台積電元大94售10,0,0,0,0,0,0,0,0,0,100000,0,0,0,100000,0,100000,100000
055484,華通元大97購04  ,0,0,0,0,0,0,0,0,0,100000,0,0,0,100000,0,100000,100000
057782,台積電國票99購07,0,0,0,0,0,0,0,0,0,100000,0,0,0,100000,0,100000,100000
058159,健策台新9A購01  ,0,0,0,0,0,0,0,0,0,100000,0,0,0,100000,0,100000,100000
055317,金寶國票98購01  ,0,0,0,0,0,0,0,0,0,100000,0,0,0,100000,0,100000,100000
056072,群創元大97購01  ,0,0,0,0,0,0,0,0,0,100000,0,0,0,100000,0,100000,100000
056115,奇力新群益97購06,0,0,0,0,0,0,0,0,0,100000,0,0,0,100000,0,100000,100000
054676,牧德台新98購01  ,0,0,0,0,0,0,0,0,0,100000,0,0,0,100000,0,100000,100000
055691,訊芯凱基97購02  ,0,0,0,0,0,0,0,0,0,100000,0,0,0,100000,0,100000,100000
055739,健鼎元富97購01  ,0,0,0,0,0,0,0,0,0,100000,0,0,0,100000,0,100000,100000
056753,群創兆豐98購02  ,0,0,0,0,0,0,0,0,0,100000,0,0,0,110000,10000,100000,100000
059159,上銀凱基99購05  ,0,0,0,0,0,0,0,0,0,100000,0,0,0,100000,0,100000,100000
059186,華通富邦9A購01  ,0,0,0,0,0,0,0,0,0,100000,0,0,0,100000,0,100000,100000
058997,鴻海元大99購21  ,0,0,0,0,0,0,0,0,0,100000,0,0,0,100000,0,100000,100000
057711,台積電統一9A購03,0,0,0,0,0,0,0,0,0,100000,0,0,0,100000,0,100000,100000
9911,櫻花            ,255000,253000,2000,0,0,0,0,1000,-1000,99000,100000,1000,99000,0,0,0,100000
059285,台灣50元富01購02,0,0,0,0,0,0,0,0,0,99000,0,0,0,105000,6000,99000,99000
043642,元金2X國票97購01,0,0,0,0,0,0,0,0,0,99000,0,0,0,99000,0,99000,99000
050580,強茂國票95購01  ,0,0,0,0,0,0,0,0,0,99000,0,0,0,99000,0,99000,99000
058030,國巨永豐98購08  ,0,0,0,0,0,0,0,0,0,99000,0,0,0,99000,0,99000,99000
052261,台泥第一95購01  ,0,0,0,0,0,0,0,0,0,99000,0,0,0,99000,0,99000,99000
057252,牧德元富98購01  ,0,0,0,0,0,0,0,0,0,99000,0,0,0,190000,91000,99000,99000
059103,旭富元富99購03  ,0,0,0,0,0,0,0,0,0,99000,0,0,0,273000,174000,99000,99000
058261,大立光富邦03購01,0,0,0,0,0,0,0,0,0,99000,0,0,0,99000,0,99000,99000
058293,光寶科凱基9A購01,0,0,0,0,0,0,0,0,0,99000,0,0,0,167000,68000,99000,99000
059319,台光電元大99購04,0,0,0,0,0,0,0,0,0,98000,0,0,0,181000,83000,98000,98000
053171,中磊群益96購01  ,0,0,0,0,0,0,0,0,0,98000,0,0,0,98000,0,98000,98000
057914,日月光日盛9A購01,0,0,0,0,0,0,0,0,0,98000,0,0,0,100000,2000,98000,98000
045055,聯發科元富98購03,0,0,0,0,0,0,0,0,0,98000,0,0,0,98000,0,98000,98000
04693P,超眾群益95售01  ,0,0,0,0,0,0,0,0,0,98000,0,0,0,99000,1000,98000,98000
058803,世紀鋼元大99購03,0,0,0,0,0,0,0,0,0,98000,0,0,0,147000,49000,98000,98000
059825,嘉晶凱基99購02  ,0,0,0,0,0,0,0,0,0,97000,0,0,0,215000,118000,97000,97000
1905,華紙            ,286000,189000,97000,0,0,0,0,0,0,0,0,0,0,0,0,0,97000
051623,和碩凱基96購02  ,0,0,0,0,0,0,0,0,0,97000,0,0,0,97000,0,97000,97000
058484,元金2X國票04購01,0,0,0,0,0,0,0,0,0,97000,0,0,0,97000,0,97000,97000
1809,中釉            ,153000,57000,96000,0,0,0,0,0,0,0,0,0,0,0,0,0,96000
3645,達邁            ,131000,35000,96000,0,0,0,0,0,0,0,0,0,0,0,0,0,96000
2929,淘帝-KY         ,217000,137000,80000,0,0,0,0,0,0,16000,16000,0,16000,0,0,0,96000
059926,世紀鋼國泰9B購01,0,0,0,0,0,0,0,0,0,96000,0,0,0,131000,35000,96000,96000
057829,臺股指元大98購12,0,0,0,0,0,0,0,0,0,96000,0,0,0,96000,0,96000,96000
0061,元大寶滬深      ,7000,7000,0,0,0,0,0,0,0,96000,90000,10000,80000,34000,18000,16000,96000
058600,國巨元大99購15  ,0,0,0,0,0,0,0,0,0,96000,0,0,0,96000,0,96000,96000
9955,佳龍            ,131000,35000,96000,0,0,0,0,0,0,0,0,0,0,0,0,0,96000
6591,動力-KY         ,160000,64000,96000,0,0,0,0,0,0,0,0,0,0,0,0,0,96000
059573,健策凱基9A購02  ,0,0,0,0,0,0,0,0,0,95000,0,0,0,192000,97000,95000,95000
06307P,聚陽元富97售02  ,0,0,0,0,0,0,0,0,0,95000,0,0,0,95000,0,95000,95000
3605,宏致            ,186000,91000,95000,0,0,0,0,0,0,0,0,0,0,0,0,0,95000
07275P,FBVIX群益99售02 ,0,0,0,0,0,0,0,0,0,95000,0,0,0,95000,0,95000,95000
051157,華新科富邦98購01,0,0,0,0,0,0,0,0,0,95000,0,0,0,95000,0,95000,95000
053683,上証2X元大96購03,0,0,0,0,0,0,0,0,0,95000,0,0,0,100000,5000,95000,95000
053751,康控永豐96購02  ,0,0,0,0,0,0,0,0,0,95000,0,0,0,95000,0,95000,95000
052418,玉晶光兆豐96購01,0,0,0,0,0,0,0,0,0,95000,0,0,0,805000,710000,95000,95000
051452,貿聯元大95購04  ,0,0,0,0,0,0,0,0,0,95000,0,0,0,95000,0,95000,95000
056212,台光電國票98購03,0,0,0,0,0,0,0,0,0,95000,0,0,0,128000,33000,95000,95000
055833,華通元大98購05  ,0,0,0,0,0,0,0,0,0,95000,0,0,0,95000,0,95000,95000
6288,聯嘉            ,735000,638000,97000,0,0,0,0,0,0,-3000,0,3000,-3000,0,0,0,94000
6533,晶心科          ,184000,90000,94000,0,0,0,0,0,0,0,0,0,0,0,0,0,94000
050233,香港2X凱基96購01,0,0,0,0,0,0,0,0,0,94000,0,0,0,94000,0,94000,94000
056477,欣興元大98購02  ,0,0,0,0,0,0,0,0,0,94000,0,0,0,174000,80000,94000,94000
4739,康普            ,169000,66000,103000,0,0,0,0,0,0,-10000,0,10000,-10000,0,0,0,93000
06605P,玉晶光元富98售03,0,0,0,0,0,0,0,0,0,93000,0,0,0,100000,7000,93000,93000
051432,群創元富99購03  ,0,0,0,0,0,0,0,0,0,93000,0,0,0,93000,0,93000,93000
053718,全新凱基97購02  ,0,0,0,0,0,0,0,0,0,93000,0,0,0,145000,52000,93000,93000
055856,新唐元大97購03  ,0,0,0,0,0,0,0,0,0,93000,0,0,0,279000,186000,93000,93000
056938,泰碩元富98購01  ,0,0,0,0,0,0,0,0,0,93000,0,0,0,93000,0,93000,93000
059630,美律凱基99購07  ,0,0,0,0,0,0,0,0,0,92000,0,0,0,167000,75000,92000,92000
3712,永崴投控        ,119000,27000,92000,0,0,0,0,0,0,0,0,0,0,0,0,0,92000
3356,奇偶            ,120000,28000,92000,0,0,0,0,0,0,0,0,0,0,0,0,0,92000
1440,南紡            ,301000,208000,93000,0,0,0,0,0,0,-1000,0,1000,-1000,0,0,0,92000
051808,美律凱基96購02  ,0,0,0,0,0,0,0,0,0,92000,0,0,0,138000,46000,92000,92000
00639,富邦深100       ,1000,1000,0,0,0,0,0,0,0,92000,0,0,0,914000,822000,92000,92000
047421,聯茂富邦97購01  ,0,0,0,0,0,0,0,0,0,92000,0,0,0,92000,0,92000,92000
057702,同欣電群益99購01,0,0,0,0,0,0,0,0,0,92000,0,0,0,92000,0,92000,92000
058986,華新科凱基9A購03,0,0,0,0,0,0,0,0,0,92000,0,0,0,107000,15000,92000,92000
059283,康友永豐99購02  ,0,0,0,0,0,0,0,0,0,92000,0,0,0,159000,67000,92000,92000
3038,全台            ,818000,807000,11000,0,0,0,0,0,0,80000,91000,11000,80000,0,0,0,91000
2486,一詮            ,128000,37000,91000,0,0,0,0,0,0,0,0,0,0,0,0,0,91000
06038P,國泰金台新96售01,0,0,0,0,0,0,0,0,0,91000,0,0,0,91000,0,91000,91000
04637P,臺股指群益94售12,0,0,0,0,0,0,0,0,0,91000,0,0,0,93000,2000,91000,91000
054222,大立光統一98購03,0,0,0,0,0,0,0,0,0,91000,0,0,0,91000,0,91000,91000
054538,台光電國票98購01,0,0,0,0,0,0,0,0,0,91000,0,0,0,91000,0,91000,91000
060220,華新科凱基9A購08,0,0,0,0,0,0,0,0,0,90000,0,0,0,105000,15000,90000,90000
4564,元翎            ,188000,98000,90000,0,0,0,0,0,0,0,0,0,0,0,0,0,90000
052103,台積電兆豐95購06,0,0,0,0,0,0,0,0,0,90000,0,0,0,90000,0,90000,90000
054425,聯發科富邦99購03,0,0,0,0,0,0,0,0,0,90000,0,0,0,90000,0,90000,90000
053316,友達群益9A購01  ,0,0,0,0,0,0,0,0,0,90000,0,0,0,90000,0,90000,90000
053331,玉晶光永豐97購02,0,0,0,0,0,0,0,0,0,90000,0,0,0,90000,0,90000,90000
047629,深中小元大96購01,0,0,0,0,0,0,0,0,0,90000,0,0,0,200000,110000,90000,90000
051181,鴻海永豐95購03  ,0,0,0,0,0,0,0,0,0,90000,0,0,0,90000,0,90000,90000
050998,訊連元大95購01  ,0,0,0,0,0,0,0,0,0,90000,0,0,0,90000,0,90000,90000
03765P,大立光元富96售01,0,0,0,0,0,0,0,0,0,90000,0,0,0,90000,0,90000,90000
049491,聯發科元大95購01,0,0,0,0,0,0,0,0,0,90000,0,0,0,90000,0,90000,90000
049784,台積電兆豐94購05,0,0,0,0,0,0,0,0,0,90000,0,0,0,90000,0,90000,90000
054127,台積電元大96購21,0,0,0,0,0,0,0,0,0,90000,0,0,0,90000,0,90000,90000
054690,新興永豐97購01  ,0,0,0,0,0,0,0,0,0,90000,0,0,0,90000,0,90000,90000
057609,友訊元富98購01  ,0,0,0,0,0,0,0,0,0,90000,0,0,0,150000,60000,90000,90000
058285,牧德群益9A購02  ,0,0,0,0,0,0,0,0,0,90000,0,0,0,90000,0,90000,90000
058603,台積電元大99購12,0,0,0,0,0,0,0,0,0,90000,0,0,0,100000,10000,90000,90000
056165,矽力凱基98購02  ,0,0,0,0,0,0,0,0,0,90000,0,0,0,90000,0,90000,90000
055000,玉晶光元富97購04,0,0,0,0,0,0,0,0,0,90000,0,0,0,90000,0,90000,90000
2351,順德            ,293000,154000,139000,0,0,0,0,50000,-50000,0,0,0,0,0,0,0,89000
059437,京鼎元大99購02  ,0,0,0,0,0,0,0,0,0,89000,0,0,0,94000,5000,89000,89000
053312,緯穎凱基96購02  ,0,0,0,0,0,0,0,0,0,89000,0,0,0,89000,0,89000,89000
053834,卜蜂永豐96購01  ,0,0,0,0,0,0,0,0,0,89000,0,0,0,89000,0,89000,89000
054203,滬深2X國票96購03,0,0,0,0,0,0,0,0,0,89000,0,0,0,150000,61000,89000,89000
056175,可成元富97購03  ,0,0,0,0,0,0,0,0,0,89000,0,0,0,98000,9000,89000,89000
058636,亞光兆豐9A購01  ,0,0,0,0,0,0,0,0,0,89000,0,0,0,89000,0,89000,89000
059214,國巨元大99購20  ,0,0,0,0,0,0,0,0,0,89000,0,0,0,141000,52000,89000,89000
059569,旺宏凱基99購09  ,0,0,0,0,0,0,0,0,0,88000,0,0,0,231000,143000,88000,88000
052818,智邦永豐96購01  ,0,0,0,0,0,0,0,0,0,88000,0,0,0,188000,100000,88000,88000
048576,義隆國泰95購01  ,0,0,0,0,0,0,0,0,0,88000,0,0,0,94000,6000,88000,88000
050173,旺宏元大96購02  ,0,0,0,0,0,0,0,0,0,88000,0,0,0,88000,0,88000,88000
059000,台積電元大99購25,0,0,0,0,0,0,0,0,0,88000,0,0,0,88000,0,88000,88000
057558,致新凱基98購01  ,0,0,0,0,0,0,0,0,0,88000,0,0,0,210000,122000,88000,88000
057323,智邦群益98購01  ,0,0,0,0,0,0,0,0,0,88000,0,0,0,177000,89000,88000,88000
058564,元金2X凱基9C購01,0,0,0,0,0,0,0,0,0,88000,0,0,0,88000,0,88000,88000
8261,富鼎            ,120000,32000,88000,0,0,0,0,0,0,0,0,0,0,0,0,0,88000
060097,華新科元大99購23,0,0,0,0,0,0,0,0,0,87000,0,0,0,110000,23000,87000,87000
059383,台灣50凱基99購03,0,0,0,0,0,0,0,0,0,86000,0,0,0,87000,1000,86000,86000
059654,T50反1元大99購09,0,0,0,0,0,0,0,0,0,86000,0,0,0,131000,45000,86000,86000
3406,玉晶光          ,942000,894000,48000,0,0,0,120000,22000,98000,-60000,110000,51000,59000,52000,171000,-119000,86000
03670C,元油2X元富99牛01,0,0,0,0,0,0,0,0,0,86000,0,0,0,90000,4000,86000,86000
048049,滬深反中信96購01,0,0,0,0,0,0,0,0,0,86000,0,0,0,86000,0,86000,86000
051240,台積電元大95購12,0,0,0,0,0,0,0,0,0,86000,0,0,0,86000,0,86000,86000
051271,華新科群益95購04,0,0,0,0,0,0,0,0,0,86000,0,0,0,187000,101000,86000,86000
058622,國巨國票99購07  ,0,0,0,0,0,0,0,0,0,86000,0,0,0,170000,84000,86000,86000
055520,矽力中信97購02  ,0,0,0,0,0,0,0,0,0,86000,0,0,0,86000,0,86000,86000
054632,緯穎凱基9A購01  ,0,0,0,0,0,0,0,0,0,86000,0,0,0,86000,0,86000,86000
059659,旺宏元大9A購03  ,0,0,0,0,0,0,0,0,0,85000,0,0,0,107000,22000,85000,85000
059696,立積永豐99購03  ,0,0,0,0,0,0,0,0,0,85000,0,0,0,169000,84000,85000,85000
060098,華新科元大99購24,0,0,0,0,0,0,0,0,0,85000,0,0,0,94000,9000,85000,85000
04294P,台積電元大95售01,0,0,0,0,0,0,0,0,0,85000,0,0,0,85000,0,85000,85000
048248,聯發科兆豐95購01,0,0,0,0,0,0,0,0,0,85000,0,0,0,95000,10000,85000,85000
048732,台勝科麥證95購01,0,0,0,85000,0,85000,0,0,0,85000,0,0,0,85000,0,85000,85000
054148,矽創元大96購03  ,0,0,0,0,0,0,0,0,0,85000,0,0,0,112000,27000,85000,85000
054331,世芯永豐96購03  ,0,0,0,0,0,0,0,0,0,85000,0,0,0,85000,0,85000,85000
053142,緯穎永豐96購01  ,0,0,0,0,0,0,0,0,0,85000,0,0,0,85000,0,85000,85000
058334,鴻海元富99購05  ,0,0,0,0,0,0,0,0,0,85000,0,0,0,98000,13000,85000,85000
054506,矽格永豐96購01  ,0,0,0,0,0,0,0,0,0,85000,0,0,0,90000,5000,85000,85000
055004,群創元富99購06  ,0,0,0,0,0,0,0,0,0,85000,0,0,0,85000,0,85000,85000
060008,華邦電群益9A購01,0,0,0,0,0,0,0,0,0,84000,0,0,0,146000,62000,84000,84000
059875,信邦凱基99購02  ,0,0,0,0,0,0,0,0,0,84000,0,0,0,126000,42000,84000,84000
051591,玉晶光元大97購01,0,0,0,0,0,0,0,0,0,84000,0,0,0,84000,0,84000,84000
053306,晶技凱基97購01  ,0,0,0,0,0,0,0,0,0,84000,0,0,0,84000,0,84000,84000
04797P,華新科元大94售04,0,0,0,0,0,0,0,0,0,84000,0,0,0,87000,3000,84000,84000
055152,旺宏元大98購04  ,0,0,0,0,0,0,0,0,0,84000,0,0,0,84000,0,84000,84000
056017,台積電群益97購04,0,0,0,0,0,0,0,0,0,84000,0,0,0,84000,0,84000,84000
058103,台積電永豐98購06,0,0,0,0,0,0,0,0,0,84000,0,0,0,84000,0,84000,84000
058483,道瓊指國票9A購01,0,0,0,0,0,0,0,0,0,84000,0,0,0,84000,0,84000,84000
059025,台灣50台新9B購02,0,0,0,0,0,0,0,0,0,84000,0,0,0,84000,0,84000,84000
059082,華通元大99購06  ,0,0,0,0,0,0,0,0,0,84000,0,0,0,120000,36000,84000,84000
059958,鎧勝康和99購01  ,0,0,0,0,0,0,0,0,0,83000,0,0,0,83000,0,83000,83000
058761,欣興群益99購02  ,0,0,0,0,0,0,0,0,0,83000,0,0,0,106000,23000,83000,83000
055655,群創元富99購07  ,0,0,0,0,0,0,0,0,0,83000,0,0,0,83000,0,83000,83000
055377,揚明光元大98購01,0,0,0,0,0,0,0,0,0,83000,0,0,0,307000,224000,83000,83000
056423,奇鋐統一98購01  ,0,0,0,0,0,0,0,0,0,83000,0,0,0,83000,0,83000,83000
059541,T50正2康和99購01,0,0,0,0,0,0,0,0,0,82000,0,0,0,97000,15000,82000,82000
060106,旭富元大99購02  ,0,0,0,0,0,0,0,0,0,82000,0,0,0,89000,7000,82000,82000
2426,鼎元            ,280000,198000,82000,0,0,0,0,0,0,0,0,0,0,0,0,0,82000
00728,第一金工業30    ,0,0,0,0,0,0,0,0,0,82000,0,0,0,708000,626000,82000,82000
056563,華新科群益98購04,0,0,0,0,0,0,0,0,0,82000,0,0,0,91000,9000,82000,82000
1604,聲寶            ,175000,94000,81000,0,0,0,0,0,0,0,0,0,0,0,0,0,81000
2233,宇隆            ,100000,19000,81000,0,0,0,0,0,0,0,0,0,0,0,0,0,81000
059764,健策永豐99購04  ,0,0,0,0,0,0,0,0,0,81000,0,0,0,256000,175000,81000,81000
056193,聯發科富邦99購08,0,0,0,0,0,0,0,0,0,81000,0,0,0,81000,0,81000,81000
058676,聯茂群益99購01  ,0,0,0,0,0,0,0,0,0,81000,0,0,0,81000,0,81000,81000
059912,國巨元大99購28  ,0,0,0,0,0,0,0,0,0,80000,0,0,0,597000,517000,80000,80000
059883,T50反1國票99購02,0,0,0,0,0,0,0,0,0,80000,0,0,0,130000,50000,80000,80000
059591,台積電元大9A購04,0,0,0,0,0,0,0,0,0,80000,0,0,0,83000,3000,80000,80000
059469,智邦元大99購03  ,0,0,0,0,0,0,0,0,0,80000,0,0,0,112000,32000,80000,80000
060115,南電元大99購06  ,0,0,0,0,0,0,0,0,0,80000,0,0,0,221000,141000,80000,80000
6155,鈞寶            ,176000,95000,81000,0,0,0,0,0,0,-1000,0,1000,-1000,0,0,0,80000
5285,界霖            ,100000,20000,80000,0,0,0,0,0,0,0,0,0,0,0,0,0,80000
047439,漢唐元大95購01  ,0,0,0,0,0,0,0,0,0,80000,0,0,0,109000,29000,80000,80000
041870,A50正2凱基96購01,0,0,0,0,0,0,0,0,0,80000,0,0,0,80000,0,80000,80000
052905,潤泰全國票97購01,0,0,0,0,0,0,0,0,0,80000,0,0,0,80000,0,80000,80000
048192,華通元大96購01  ,0,0,0,0,0,0,0,0,0,80000,0,0,0,80000,0,80000,80000
049843,康友中信95購01  ,0,0,0,0,0,0,0,0,0,80000,0,0,0,80000,0,80000,80000
058406,聯茂元大99購06  ,0,0,0,0,0,0,0,0,0,80000,0,0,0,82000,2000,80000,80000
053537,玉晶光永豐98購02,0,0,0,0,0,0,0,0,0,80000,0,0,0,80000,0,80000,80000
057516,和鑫元富98購01  ,0,0,0,0,0,0,0,0,0,80000,0,0,0,80000,0,80000,80000
056395,玉晶光永豐9B購01,0,0,0,0,0,0,0,0,0,80000,0,0,0,80000,0,80000,80000
055416,欣興富邦98購01  ,0,0,0,0,0,0,0,0,0,80000,0,0,0,80000,0,80000,80000
056386,TPK國泰99購01   ,0,0,0,0,0,0,0,0,0,80000,0,0,0,88000,8000,80000,80000
055989,矽力元富9A購01  ,0,0,0,0,0,0,0,0,0,80000,0,0,0,81000,1000,80000,80000
055079,台光電中信97購01,0,0,0,0,0,0,0,0,0,80000,0,0,0,80000,0,80000,80000
5269,祥碩            ,226000,115000,111000,0,0,0,40000,56000,-16000,-16000,56000,69000,-13000,14000,17000,-3000,79000
6226,光鼎            ,111000,32000,79000,0,0,0,0,0,0,0,0,0,0,0,0,0,79000
07270P,台灣50元大01售09,0,0,0,0,0,0,0,0,0,79000,0,0,0,100000,21000,79000,79000
051522,玉晶光凱基95購05,0,0,0,0,0,0,0,0,0,79000,0,0,0,79000,0,79000,79000
057893,亞德客元富98購03,0,0,0,0,0,0,0,0,0,79000,0,0,0,84000,5000,79000,79000
052751,臺股指元大96購05,0,0,0,0,0,0,0,0,0,79000,0,0,0,79000,0,79000,79000
056207,茂林永豐97購03  ,0,0,0,0,0,0,0,0,0,79000,0,0,0,79000,0,79000,79000
055387,世紀鋼元大97購01,0,0,0,0,0,0,0,0,0,79000,0,0,0,114000,35000,79000,79000
059202,禾聯碩永豐99購01,0,0,0,0,0,0,0,0,0,79000,0,0,0,79000,0,79000,79000
056907,群創元大9C購04  ,0,0,0,0,0,0,0,0,0,79000,0,0,0,84000,5000,79000,79000
057555,玉晶光凱基9A購02,0,0,0,0,0,0,0,0,0,79000,0,0,0,79000,0,79000,79000
4566,時碩工業        ,85000,7000,78000,0,0,0,0,0,0,0,0,0,0,0,0,0,78000
4766,南寶            ,238000,160000,78000,0,0,0,0,0,0,0,0,0,0,0,0,0,78000
053924,京鼎國票97購01  ,0,0,0,0,0,0,0,0,0,78000,0,0,0,99000,21000,78000,78000
057176,全新元大99購02  ,0,0,0,0,0,0,0,0,0,78000,0,0,0,126000,48000,78000,78000
058979,上銀凱基99購04  ,0,0,0,0,0,0,0,0,0,78000,0,0,0,78000,0,78000,78000
056393,精元永豐98購01  ,0,0,0,0,0,0,0,0,0,78000,0,0,0,80000,2000,78000,78000
054788,華新科群益98購02,0,0,0,0,0,0,0,0,0,78000,0,0,0,78000,0,78000,78000
3062,建漢            ,519000,442000,77000,0,0,0,0,0,0,0,0,0,0,0,0,0,77000
1733,五鼎            ,79000,84000,-5000,0,0,0,0,0,0,82000,83000,1000,82000,0,0,0,77000
059704,聯發科凱基9A購08,0,0,0,0,0,0,0,0,0,77000,0,0,0,77000,0,77000,77000
053092,台表科元大97購02,0,0,0,0,0,0,0,0,0,77000,0,0,0,113000,36000,77000,77000
054743,聯鈞凱基99購01  ,0,0,0,0,0,0,0,0,0,77000,0,0,0,77000,0,77000,77000
055958,台光電元大97購02,0,0,0,0,0,0,0,0,0,77000,0,0,0,77000,0,77000,77000
055378,晶相光元大97購02,0,0,0,0,0,0,0,0,0,77000,0,0,0,77000,0,77000,77000
055368,台積電元大97購24,0,0,0,0,0,0,0,0,0,77000,0,0,0,77000,0,77000,77000
059049,元油2X凱基9A購12,0,0,0,0,0,0,0,0,0,77000,0,0,0,77000,0,77000,77000
056266,開發金統一9A購01,0,0,0,0,0,0,0,0,0,77000,0,0,0,209000,132000,77000,77000
1308,亞聚            ,181000,104000,77000,0,0,0,0,0,0,-1000,0,1000,-1000,0,0,0,76000
1104,環泥            ,4153000,4077000,76000,0,0,0,0,0,0,0,0,0,0,0,0,0,76000
07404P,華新科凱基99售10,0,0,0,0,0,0,0,0,0,76000,0,0,0,77000,1000,76000,76000
6271,同欣電          ,401000,963000,-562000,0,0,0,852000,268000,584000,54000,36000,63000,-27000,85000,4000,81000,76000
053438,玉晶光麥證97購02,0,0,0,56000,0,56000,0,0,0,76000,0,0,0,76000,0,76000,76000
050853,南電國票96購01  ,0,0,0,0,0,0,0,0,0,76000,0,0,0,76000,0,76000,76000
00683L,元大美元指數正2 ,0,0,0,0,0,0,0,0,0,76000,0,0,0,213000,137000,76000,76000
057691,健策凱基99購01  ,0,0,0,0,0,0,0,0,0,76000,0,0,0,325000,249000,76000,76000
054702,智邦第一97購01  ,0,0,0,0,0,0,0,0,0,76000,0,0,0,114000,38000,76000,76000
2359,所羅門          ,129000,54000,75000,0,0,0,0,0,0,0,0,0,0,0,0,0,75000
059920,宏達電元大99購07,0,0,0,0,0,0,0,0,0,75000,0,0,0,242000,167000,75000,75000
059570,全新凱基99購04  ,0,0,0,0,0,0,0,0,0,75000,0,0,0,75000,0,75000,75000
04894P,世紀鋼元大94售02,0,0,0,0,0,0,0,0,0,75000,0,0,0,80000,5000,75000,75000
050441,和碩凱基94購01  ,0,0,0,0,0,0,0,0,0,75000,0,0,0,125000,50000,75000,75000
053792,百和元大96購01  ,0,0,0,0,0,0,0,0,0,75000,0,0,0,75000,0,75000,75000
058051,同欣電元大98購03,0,0,0,0,0,0,0,0,0,75000,0,0,0,166000,91000,75000,75000
057821,晶相光元大98購03,0,0,0,0,0,0,0,0,0,75000,0,0,0,107000,32000,75000,75000
053549,南亞科凱基96購02,0,0,0,0,0,0,0,0,0,75000,0,0,0,75000,0,75000,75000
053586,建準元大96購01  ,0,0,0,0,0,0,0,0,0,75000,0,0,0,75000,0,75000,75000
056533,友達凱基9A購02  ,0,0,0,0,0,0,0,0,0,75000,0,0,0,75000,0,75000,75000
8215,明基材          ,355000,280000,75000,0,0,0,0,0,0,0,0,0,0,0,0,0,75000
060116,世紀鋼元大99購07,0,0,0,0,0,0,0,0,0,74000,0,0,0,327000,253000,74000,74000
07263P,台積電元大99售37,0,0,0,0,0,0,0,0,0,74000,0,0,0,253000,179000,74000,74000
1519,華城            ,247000,147000,100000,0,0,0,0,100000,-100000,74000,75000,1000,74000,0,0,0,74000
054411,光磊元大97購02  ,0,0,0,0,0,0,0,0,0,74000,0,0,0,85000,11000,74000,74000
051774,聯茂中信96購01  ,0,0,0,0,0,0,0,0,0,74000,0,0,0,74000,0,74000,74000
052316,台積電元大96購10,0,0,0,0,0,0,0,0,0,74000,0,0,0,74000,0,74000,74000
05145P,道瓊反元大98售01,0,0,0,0,0,0,0,0,0,74000,0,0,0,74000,0,74000,74000
054962,玉晶光元大99購02,0,0,0,0,0,0,0,0,0,74000,0,0,0,74000,0,74000,74000
058252,臺股指元大9A購16,0,0,0,0,0,0,0,0,0,74000,0,0,0,74000,0,74000,74000
058241,景碩元大99購05  ,0,0,0,0,0,0,0,0,0,74000,0,0,0,160000,86000,74000,74000
058565,鴻海凱基9A購07  ,0,0,0,0,0,0,0,0,0,74000,0,0,0,86000,12000,74000,74000
058615,矽創元大99購01  ,0,0,0,0,0,0,0,0,0,74000,0,0,0,74000,0,74000,74000
07277P,臺股指群益99售20,0,0,0,0,0,0,0,0,0,73000,0,0,0,75000,2000,73000,73000
3049,和鑫            ,2298000,2224000,74000,0,0,0,0,0,0,-1000,0,1000,-1000,0,0,0,73000
3047,訊舟            ,133000,54000,79000,0,0,0,0,0,0,-6000,0,6000,-6000,0,0,0,73000
059301,華新科群益99購04,0,0,0,0,0,0,0,0,0,73000,0,0,0,295000,222000,73000,73000
049700,瀚宇博元大97購01,0,0,0,0,0,0,0,0,0,73000,0,0,0,516000,443000,73000,73000
050124,元金2X凱基95購01,0,0,0,0,0,0,0,0,0,73000,0,0,0,73000,0,73000,73000
052846,智邦統一97購01  ,0,0,0,0,0,0,0,0,0,73000,0,0,0,73000,0,73000,73000
051000,台郡元大96購01  ,0,0,0,0,0,0,0,0,0,73000,0,0,0,73000,0,73000,73000
054891,聯鈞統一99購02  ,0,0,0,0,0,0,0,0,0,73000,0,0,0,73000,0,73000,73000
059073,元油2X元大9C購14,0,0,0,0,0,0,0,0,0,73000,0,0,0,95000,22000,73000,73000
059850,日電貿永豐99購01,0,0,0,0,0,0,0,0,0,72000,0,0,0,230000,158000,72000,72000
059662,旭富元大9C購01  ,0,0,0,0,0,0,0,0,0,72000,0,0,0,100000,28000,72000,72000
1323,永裕            ,87000,8000,79000,0,0,0,0,0,0,-7000,0,7000,-7000,0,0,0,72000
1608,華榮            ,134000,62000,72000,0,0,0,0,0,0,0,0,0,0,0,0,0,72000
051266,國巨富邦99購01  ,0,0,0,0,0,0,0,0,0,72000,0,0,0,72000,0,72000,72000
006207,FH滬深          ,34000,13000,21000,0,0,0,0,0,0,51000,0,0,0,184000,133000,51000,72000
052963,智邦凱基96購02  ,0,0,0,0,0,0,0,0,0,72000,0,0,0,75000,3000,72000,72000
057980,聯詠永豐98購01  ,0,0,0,0,0,0,0,0,0,72000,0,0,0,169000,97000,72000,72000
055820,矽力國票98購02  ,0,0,0,0,0,0,0,0,0,72000,0,0,0,72000,0,72000,72000
05660P,玉晶光第一96售01,0,0,0,0,0,0,0,0,0,72000,0,0,0,100000,28000,72000,72000
056636,台積電日盛9A購01,0,0,0,0,0,0,0,0,0,72000,0,0,0,72000,0,72000,72000
05493P,華新科富邦99售02,0,0,0,0,0,0,0,0,0,72000,0,0,0,72000,0,72000,72000
060246,晶相光元大9C購03,0,0,0,0,0,0,0,0,0,71000,0,0,0,86000,15000,71000,71000
06766P,玉晶光元大99售10,0,0,0,0,0,0,0,0,0,71000,0,0,0,71000,0,71000,71000
058169,國巨凱基9A購05  ,0,0,0,0,0,0,0,0,0,71000,0,0,0,71000,0,71000,71000
053694,創意元大96購03  ,0,0,0,0,0,0,0,0,0,71000,0,0,0,121000,50000,71000,71000
053684,台積電元大96購17,0,0,0,0,0,0,0,0,0,71000,0,0,0,71000,0,71000,71000
049582,台積電元大95購03,0,0,0,0,0,0,0,0,0,71000,0,0,0,71000,0,71000,71000
049583,台積電元大95購04,0,0,0,0,0,0,0,0,0,71000,0,0,0,71000,0,71000,71000
058707,泰鼎元大99購02  ,0,0,0,0,0,0,0,0,0,71000,0,0,0,107000,36000,71000,71000
057095,祥碩元富98購02  ,0,0,0,0,0,0,0,0,0,71000,0,0,0,71000,0,71000,71000
058908,貿聯元大99購03  ,0,0,0,0,0,0,0,0,0,71000,0,0,0,440000,369000,71000,71000
059841,國巨富邦9C購01  ,0,0,0,0,0,0,0,0,0,70000,0,0,0,127000,57000,70000,70000
059430,台積電元大99購36,0,0,0,0,0,0,0,0,0,70000,0,0,0,76000,6000,70000,70000
4942,嘉彰            ,133000,77000,56000,0,0,0,0,0,0,14000,32000,18000,14000,0,0,0,70000
051272,嘉晶群益95購01  ,0,0,0,0,0,0,0,0,0,70000,0,0,0,70000,0,70000,70000
050911,光磊中信98購01  ,0,0,0,0,0,0,0,0,0,70000,0,0,0,70000,0,70000,70000
053768,S&P反1元大99購01,0,0,0,0,0,0,0,0,0,70000,0,0,0,70000,0,70000,70000
058335,鴻海元富99購06  ,0,0,0,0,0,0,0,0,0,70000,0,0,0,98000,28000,70000,70000
058408,華通兆豐99購02  ,0,0,0,0,0,0,0,0,0,70000,0,0,0,70000,0,70000,70000
056709,華通永豐98購01  ,0,0,0,0,0,0,0,0,0,70000,0,0,0,177000,107000,70000,70000
059074,元油2X元大9C購15,0,0,0,0,0,0,0,0,0,70000,0,0,0,70000,0,70000,70000
057547,技嘉凱基99購01  ,0,0,0,0,0,0,0,0,0,70000,0,0,0,100000,30000,70000,70000
056920,友達兆豐98購02  ,0,0,0,0,0,0,0,0,0,70000,0,0,0,70000,0,70000,70000
057328,京鼎群益99購02  ,0,0,0,0,0,0,0,0,0,70000,0,0,0,70000,0,70000,70000
056366,玉晶光元大99購04,0,0,0,0,0,0,0,0,0,70000,0,0,0,70000,0,70000,70000
058144,聯茂元大99購02  ,0,0,0,0,0,0,0,0,0,70000,0,0,0,82000,12000,70000,70000
054924,景碩凱基98購01  ,0,0,0,0,0,0,0,0,0,70000,0,0,0,70000,0,70000,70000
055290,玉晶光元大98購08,0,0,0,0,0,0,0,0,0,70000,0,0,0,70000,0,70000,70000
056063,大立光元大97購13,0,0,0,0,0,0,0,0,0,70000,0,0,0,70000,0,70000,70000
4190,佐登-KY         ,125000,65000,60000,0,0,0,0,0,0,9000,0,1000,-1000,10000,0,10000,69000
059296,大立光元富99購06,0,0,0,0,0,0,0,0,0,69000,0,0,0,146000,77000,69000,69000
059526,鴻海凱基99購12  ,0,0,0,0,0,0,0,0,0,69000,0,0,0,112000,43000,69000,69000
050955,達方群益97購01  ,0,0,0,0,0,0,0,0,0,69000,0,0,0,157000,88000,69000,69000
047004,台積電統一99購01,0,0,0,0,0,0,0,0,0,69000,0,0,0,69000,0,69000,69000
056079,世紀鋼元大97購02,0,0,0,0,0,0,0,0,0,69000,0,0,0,69000,0,69000,69000
056584,鴻海統一9B購01  ,0,0,0,0,0,0,0,0,0,69000,0,0,0,69000,0,69000,69000
059452,全新永豐99購03  ,0,0,0,0,0,0,0,0,0,68000,0,0,0,124000,56000,68000,68000
058230,國巨元大99購11  ,0,0,0,0,0,0,0,0,0,68000,0,0,0,75000,7000,68000,68000
058210,臺股指凱基9C購04,0,0,0,0,0,0,0,0,0,68000,0,0,0,68000,0,68000,68000
057965,臺股指元大98購14,0,0,0,0,0,0,0,0,0,68000,0,0,0,68000,0,68000,68000
058647,華新科永豐99購03,0,0,0,0,0,0,0,0,0,68000,0,0,0,68000,0,68000,68000
057017,和大凱基98購01  ,0,0,0,0,0,0,0,0,0,68000,0,0,0,98000,30000,68000,68000
059198,華新科永豐99購06,0,0,0,0,0,0,0,0,0,68000,0,0,0,68000,0,68000,68000
059248,華新科凱基99購04,0,0,0,0,0,0,0,0,0,68000,0,0,0,77000,9000,68000,68000
056820,欣興永豐98購02  ,0,0,0,0,0,0,0,0,0,68000,0,0,0,70000,2000,68000,68000
058863,可成凱基99購02  ,0,0,0,0,0,0,0,0,0,68000,0,0,0,72000,4000,68000,68000
059517,茂林永豐99購02  ,0,0,0,0,0,0,0,0,0,67000,0,0,0,72000,5000,67000,67000
5258,虹堡            ,108000,121000,-13000,0,0,0,0,0,0,80000,80000,0,80000,0,0,0,67000
1442,名軒            ,72000,5000,67000,0,0,0,0,0,0,0,0,0,0,0,0,0,67000
07349P,大立光凱基99售16,0,0,0,0,0,0,0,0,0,67000,0,0,0,88000,21000,67000,67000
058382,S&P500中信99購01,0,0,0,0,0,0,0,0,0,67000,0,0,0,67000,0,67000,67000
058848,台積電群益99購07,0,0,0,0,0,0,0,0,0,67000,0,0,0,67000,0,67000,67000
5305,敦南            ,117000,40000,77000,0,0,0,0,0,0,-11000,0,0,0,0,11000,-11000,66000
2606,裕民            ,523000,518000,5000,0,0,0,0,0,0,61000,61000,0,61000,0,0,0,66000
059364,昇陽半永豐99購02,0,0,0,0,0,0,0,0,0,66000,0,0,0,85000,19000,66000,66000
059702,台積電凱基9A購14,0,0,0,0,0,0,0,0,0,66000,0,0,0,110000,44000,66000,66000
057918,旺宏凱基99購01  ,0,0,0,0,0,0,0,0,0,66000,0,0,0,66000,0,66000,66000
053780,南亞科元大96購03,0,0,0,0,0,0,0,0,0,66000,0,0,0,196000,130000,66000,66000
054535,旺宏富邦97購02  ,0,0,0,0,0,0,0,0,0,66000,0,0,0,706000,640000,66000,66000
057057,立積元大9A購01  ,0,0,0,0,0,0,0,0,0,66000,0,0,0,93000,27000,66000,66000
056914,臺股指元大99購09,0,0,0,0,0,0,0,0,0,66000,0,0,0,66000,0,66000,66000
058673,華新科群益9A購02,0,0,0,0,0,0,0,0,0,66000,0,0,0,98000,32000,66000,66000
057811,南亞科元大98購08,0,0,0,0,0,0,0,0,0,66000,0,0,0,66000,0,66000,66000
055923,矽力凱基98購01  ,0,0,0,0,0,0,0,0,0,66000,0,0,0,122000,56000,66000,66000
05479P,華新科台新96售01,0,0,0,0,0,0,0,0,0,66000,0,0,0,66000,0,66000,66000
8462,柏文            ,78000,12000,66000,0,0,0,0,0,0,0,0,0,0,0,0,0,66000
046570,旺宏國泰94購01  ,0,0,0,0,0,0,0,0,0,65000,0,0,0,65000,0,65000,65000
055197,致新元富97購02  ,0,0,0,0,0,0,0,0,0,65000,0,0,0,673000,608000,65000,65000
058413,義隆兆豐99購01  ,0,0,0,0,0,0,0,0,0,65000,0,0,0,138000,73000,65000,65000
057058,祥碩元大98購04  ,0,0,0,0,0,0,0,0,0,65000,0,0,0,65000,0,65000,65000
057003,立積國票98購01  ,0,0,0,0,0,0,0,0,0,65000,0,0,0,65000,0,65000,65000
4977,眾達-KY         ,392000,381000,11000,0,0,0,47000,0,47000,6000,9000,0,9000,0,3000,-3000,64000
045054,聯發科元富98購02,0,0,0,0,0,0,0,0,0,64000,0,0,0,64000,0,64000,64000
053293,聯發科中信9B購01,0,0,0,0,0,0,0,0,0,64000,0,0,0,64000,0,64000,64000
056481,創意元大98購01  ,0,0,0,0,0,0,0,0,0,64000,0,0,0,64000,0,64000,64000
059629,友達凱基99購06  ,0,0,0,0,0,0,0,0,0,63000,0,0,0,152000,89000,63000,63000
060160,聯陽永豐9A購01  ,0,0,0,0,0,0,0,0,0,63000,0,0,0,115000,52000,63000,63000
053557,聯茂凱基96購04  ,0,0,0,0,0,0,0,0,0,63000,0,0,0,63000,0,63000,63000
04618P,電子類群益94售02,0,0,0,0,0,0,0,0,0,63000,0,0,0,63000,0,63000,63000
057056,立積元大99購02  ,0,0,0,0,0,0,0,0,0,63000,0,0,0,123000,60000,63000,63000
057701,嘉聯益群益98購02,0,0,0,0,0,0,0,0,0,63000,0,0,0,126000,63000,63000,63000
058775,台積電國票9A購02,0,0,0,0,0,0,0,0,0,63000,0,0,0,91000,28000,63000,63000
3454,晶睿            ,93000,31000,62000,0,0,0,0,0,0,0,0,0,0,0,0,0,62000
1541,錩泰            ,5000,1000,4000,0,0,0,0,0,0,58000,58000,0,58000,0,0,0,62000
020000,富邦特選蘋果N   ,0,0,0,0,0,0,0,0,0,62000,0,0,0,77000,15000,62000,62000
04471P,華通元大95售03  ,0,0,0,0,0,0,0,0,0,62000,0,0,0,62000,0,62000,62000
053610,矽力中信98購01  ,0,0,0,0,0,0,0,0,0,62000,0,0,0,62000,0,62000,62000
051488,健策凱基96購04  ,0,0,0,0,0,0,0,0,0,62000,0,0,0,62000,0,62000,62000
05161P,華新科國票96售01,0,0,0,0,0,0,0,0,0,62000,0,0,0,66000,4000,62000,62000
056836,國巨元富98購01  ,0,0,0,0,0,0,0,0,0,62000,0,0,0,62000,0,62000,62000
056534,京元電凱基98購01,0,0,0,0,0,0,0,0,0,62000,0,0,0,154000,92000,62000,62000
6414,樺漢            ,37000,24570,12430,0,0,0,0,0,0,49000,53000,2000,51000,2000,4000,-2000,61430
6451,訊芯-KY         ,577000,523000,54000,0,0,0,0,0,0,7000,2000,5000,-3000,16000,6000,10000,61000
059434,全新元大99購05  ,0,0,0,0,0,0,0,0,0,61000,0,0,0,119000,58000,61000,61000
053176,矽力群益96購02  ,0,0,0,0,0,0,0,0,0,61000,0,0,0,61000,0,61000,61000
050846,緯創國票96購01  ,0,0,0,0,0,0,0,0,0,61000,0,0,0,61000,0,61000,61000
059113,群光永豐99購01  ,0,0,0,0,0,0,0,0,0,61000,0,0,0,61000,0,61000,61000
057109,信邦群益98購01  ,0,0,0,0,0,0,0,0,0,61000,0,0,0,81000,20000,61000,61000
059457,立積永豐99購02  ,0,0,0,0,0,0,0,0,0,60000,0,0,0,113000,53000,60000,60000
059639,大立光凱基9A購06,0,0,0,0,0,0,0,0,0,60000,0,0,0,64000,4000,60000,60000
059985,華新科元大99購22,0,0,0,0,0,0,0,0,0,60000,0,0,0,239000,179000,60000,60000
060023,T50反1國泰9A購03,0,0,0,0,0,0,0,0,0,60000,0,0,0,60000,0,60000,60000
6282,康舒            ,736000,695000,41000,0,0,0,0,0,0,19000,0,18000,-18000,37000,0,37000,60000
3018,同開            ,109000,49000,60000,0,0,0,0,0,0,0,0,0,0,0,0,0,60000
050769,聯發科元大94購17,0,0,0,0,0,0,0,0,0,60000,0,0,0,60000,0,60000,60000
03418B,臺股指元大95熊20,0,0,0,0,0,0,0,0,0,60000,0,0,0,60000,0,60000,60000
046793,聯發科元富99購01,0,0,0,0,0,0,0,0,0,60000,0,0,0,60000,0,60000,60000
047684,景碩國泰94購01  ,0,0,0,0,0,0,0,0,0,60000,0,0,0,60000,0,60000,60000
049946,智邦兆豐95購01  ,0,0,0,0,0,0,0,0,0,60000,0,0,0,60000,0,60000,60000
050212,瀚宇博國票95購02,0,0,0,0,0,0,0,0,0,60000,0,0,0,86000,26000,60000,60000
050543,聯發科凱基95購01,0,0,0,0,0,0,0,0,0,60000,0,0,0,60000,0,60000,60000
049137,華通元大95購02  ,0,0,0,0,0,0,0,0,0,60000,0,0,0,60000,0,60000,60000
04837P,華新科元大94售05,0,0,0,0,0,0,0,0,0,60000,0,0,0,60000,0,60000,60000
051776,上証2X群益99購01,0,0,0,0,0,0,0,0,0,60000,0,0,0,60000,0,60000,60000
05297P,臻鼎凱基95售04  ,0,0,0,0,0,0,0,0,0,60000,0,0,0,60000,0,60000,60000
052980,上銀元大96購03  ,0,0,0,0,0,0,0,0,0,60000,0,0,0,60000,0,60000,60000
054347,上緯控國票96購02,0,0,0,0,0,0,0,0,0,60000,0,0,0,60000,0,60000,60000
052070,GIS兆豐95購03   ,0,0,0,0,0,0,0,0,0,60000,0,0,0,60000,0,60000,60000
052077,可成元富98購02  ,0,0,0,0,0,0,0,0,0,60000,0,0,0,177000,117000,60000,60000
052066,華邦電兆豐96購01,0,0,0,0,0,0,0,0,0,60000,0,0,0,632000,572000,60000,60000
052309,健策國泰97購01  ,0,0,0,0,0,0,0,0,0,60000,0,0,0,60000,0,60000,60000
051699,世紀鋼麥證95購01,0,0,0,60000,0,60000,0,0,0,60000,0,0,0,60000,0,60000,60000
058360,台光電凱基9A購02,0,0,0,0,0,0,0,0,0,60000,0,0,0,60000,0,60000,60000
057826,祥碩元大98購08  ,0,0,0,0,0,0,0,0,0,60000,0,0,0,62000,2000,60000,60000
055794,聯發科國泰99購01,0,0,0,0,0,0,0,0,0,60000,0,0,0,70000,10000,60000,60000
056762,亞德客元大98購01,0,0,0,0,0,0,0,0,0,60000,0,0,0,106000,46000,60000,60000
055694,光罩國票98購01  ,0,0,0,0,0,0,0,0,0,60000,0,0,0,60000,0,60000,60000
055628,旺宏永豐97購01  ,0,0,0,0,0,0,0,0,0,60000,0,0,0,60000,0,60000,60000
057440,台積電統一98購10,0,0,0,0,0,0,0,0,0,60000,0,0,0,60000,0,60000,60000
057770,亞德客群益98購01,0,0,0,0,0,0,0,0,0,60000,0,0,0,60000,0,60000,60000
057748,華通國票98購04  ,0,0,0,0,0,0,0,0,0,60000,0,0,0,60000,0,60000,60000
056312,茂林元大98購01  ,0,0,0,0,0,0,0,0,0,60000,0,0,0,60000,0,60000,60000
2444,兆勁            ,62000,3000,59000,0,0,0,0,0,0,0,0,0,0,0,0,0,59000
06739P,聯詠兆豐98售02  ,0,0,0,0,0,0,0,0,0,59000,0,0,0,117000,58000,59000,59000
059833,緯穎康和99購01  ,0,0,0,0,0,0,0,0,0,59000,0,0,0,100000,41000,59000,59000
00730,富邦臺灣優質高息,0,0,0,0,0,0,0,0,0,59000,0,0,0,665000,606000,59000,59000
058906,晶相光元大99購01,0,0,0,0,0,0,0,0,0,59000,0,0,0,77000,18000,59000,59000
059942,全新永豐99購04  ,0,0,0,0,0,0,0,0,0,58000,0,0,0,125000,67000,58000,58000
2520,冠德            ,355000,291000,64000,0,0,0,0,0,0,-6000,0,6000,-6000,0,0,0,58000
3028,增你強          ,69000,11000,58000,0,0,0,0,0,0,0,0,0,0,0,0,0,58000
4155,訊映            ,74000,16000,58000,0,0,0,0,0,0,0,0,0,0,0,0,0,58000
050256,臺指反元大98購03,0,0,0,0,0,0,0,0,0,58000,0,0,0,58000,0,58000,58000
057904,矽力永豐98購01  ,0,0,0,0,0,0,0,0,0,58000,0,0,0,58000,0,58000,58000
053686,台積電元大97購08,0,0,0,0,0,0,0,0,0,58000,0,0,0,58000,0,58000,58000
052453,崇越元大95購01  ,0,0,0,0,0,0,0,0,0,58000,0,0,0,58000,0,58000,58000
053553,聯詠凱基96購03  ,0,0,0,0,0,0,0,0,0,58000,0,0,0,146000,88000,58000,58000
059053,鴻海凱基99購07  ,0,0,0,0,0,0,0,0,0,58000,0,0,0,102000,44000,58000,58000
059231,華通國票9A購04  ,0,0,0,0,0,0,0,0,0,58000,0,0,0,143000,85000,58000,58000
057486,美律元大98購04  ,0,0,0,0,0,0,0,0,0,58000,0,0,0,116000,58000,58000,58000
056571,燿華元大98購02  ,0,0,0,0,0,0,0,0,0,58000,0,0,0,58000,0,58000,58000
059537,大立光凱基99購09,0,0,0,0,0,0,0,0,0,57000,0,0,0,60000,3000,57000,57000
053145,元黃金元大96購02,0,0,0,0,0,0,0,0,0,57000,0,0,0,57000,0,57000,57000
053787,健策元大97購02  ,0,0,0,0,0,0,0,0,0,57000,0,0,0,57000,0,57000,57000
046906,新光金凱基99購02,0,0,0,0,0,0,0,0,0,57000,0,0,0,170000,113000,57000,57000
056504,國巨永豐98購02  ,0,0,0,0,0,0,0,0,0,57000,0,0,0,69000,12000,57000,57000
054989,精元元富97購01  ,0,0,0,0,0,0,0,0,0,57000,0,0,0,161000,104000,57000,57000
055808,世紀鋼永豐97購01,0,0,0,0,0,0,0,0,0,57000,0,0,0,77000,20000,57000,57000
056605,台積電富邦9B購02,0,0,0,0,0,0,0,0,0,57000,0,0,0,57000,0,57000,57000
056906,玉晶光元大9B購01,0,0,0,0,0,0,0,0,0,57000,0,0,0,77000,20000,57000,57000
059527,聯發科凱基99購16,0,0,0,0,0,0,0,0,0,56000,0,0,0,56000,0,56000,56000
053157,日月光元大96購03,0,0,0,0,0,0,0,0,0,56000,0,0,0,56000,0,56000,56000
054210,台光電國票97購03,0,0,0,0,0,0,0,0,0,56000,0,0,0,58000,2000,56000,56000
056305,群創元大9A購03  ,0,0,0,0,0,0,0,0,0,56000,0,0,0,56000,0,56000,56000
056349,道瓊銀元大9B購01,0,0,0,0,0,0,0,0,0,56000,0,0,0,56000,0,56000,56000
06738P,瑞昱兆豐98售02  ,0,0,0,0,0,0,0,0,0,55000,0,0,0,55000,0,55000,55000
060051,台積電凱基9B購01,0,0,0,0,0,0,0,0,0,55000,0,0,0,55000,0,55000,55000
3346,麗清            ,64000,9000,55000,0,0,0,0,0,0,0,0,0,0,0,0,0,55000
051829,玉晶光元大98購02,0,0,0,0,0,0,0,0,0,55000,0,0,0,55000,0,55000,55000
053648,台積電凱基97購04,0,0,0,0,0,0,0,0,0,55000,0,0,0,55000,0,55000,55000
051347,國巨元大95購06  ,0,0,0,0,0,0,0,0,0,55000,0,0,0,135000,80000,55000,55000
054015,晶豪科永豐96購03,0,0,0,0,0,0,0,0,0,55000,0,0,0,55000,0,55000,55000
052736,T50反1元大96購05,0,0,0,0,0,0,0,0,0,55000,0,0,0,58000,3000,55000,55000
057415,和碩日盛98購01  ,0,0,0,0,0,0,0,0,0,55000,0,0,0,55000,0,55000,55000
055011,元翎元富97購01  ,0,0,0,0,0,0,0,0,0,55000,0,0,0,55000,0,55000,55000
055071,群電永豐97購01  ,0,0,0,0,0,0,0,0,0,55000,0,0,0,55000,0,55000,55000
05564P,玉晶光元大97售02,0,0,0,0,0,0,0,0,0,55000,0,0,0,55000,0,55000,55000
056077,矽力元大97購07  ,0,0,0,0,0,0,0,0,0,55000,0,0,0,55000,0,55000,55000
056854,友達中信9A購01  ,55000,0,55000,0,0,0,0,0,0,0,0,0,0,0,0,0,55000
058956,健策國票9A購02  ,0,23000,-23000,0,0,0,0,0,0,78000,0,0,0,121000,43000,78000,55000
3588,通嘉            ,59000,5000,54000,0,0,0,0,0,0,0,0,0,0,0,0,0,54000
2464,盟立            ,171000,117000,54000,0,0,0,0,0,0,0,0,0,0,0,0,0,54000
2428,興勤            ,160000,148000,12000,0,0,0,0,0,0,42000,44000,0,44000,6000,8000,-2000,54000
059633,聯發科凱基9A購07,0,0,0,0,0,0,0,0,0,54000,0,0,0,54000,0,54000,54000
059599,健策元大9B購02  ,0,0,0,0,0,0,0,0,0,54000,0,0,0,75000,21000,54000,54000
059291,華新科元富9B購01,0,0,0,0,0,0,0,0,0,54000,0,0,0,90000,36000,54000,54000
059728,聯鈞元大99購01  ,0,0,0,0,0,0,0,0,0,54000,0,0,0,86000,32000,54000,54000
054029,瀚宇博凱基96購02,0,0,0,0,0,0,0,0,0,54000,0,0,0,54000,0,54000,54000
050270,景碩元大94購01  ,0,0,0,0,0,0,0,0,0,54000,0,0,0,54000,0,54000,54000
035277,景碩台新97購01  ,0,0,0,0,0,0,0,0,0,54000,0,0,0,56000,2000,54000,54000
053630,奇鋐兆豐97購01  ,0,0,0,0,0,0,0,0,0,54000,0,0,0,458000,404000,54000,54000
059115,美食永豐99購01  ,0,0,0,0,0,0,0,0,0,54000,0,0,0,136000,82000,54000,54000
059116,晶豪科永豐99購01,0,0,0,0,0,0,0,0,0,54000,0,0,0,54000,0,54000,54000
054593,滬深2X永昌9A購01,0,0,0,0,0,0,0,0,0,54000,0,0,0,54000,0,54000,54000
057063,立積國泰9A購01  ,0,0,0,0,0,0,0,0,0,54000,0,0,0,54000,0,54000,54000
2539,櫻花建          ,42000,27000,15000,0,0,0,0,0,0,38000,60000,0,60000,0,22000,-22000,53000
4106,雃博            ,264000,211000,53000,0,0,0,0,0,0,0,0,0,0,0,0,0,53000
07370P,南亞科凱基99售08,0,0,0,0,0,0,0,0,0,53000,0,0,0,53000,0,53000,53000
05254P,瑞昱凱基95售04  ,0,0,0,0,0,0,0,0,0,53000,0,0,0,53000,0,53000,53000
03648C,T50反1元大96牛07,0,0,0,0,0,0,0,0,0,53000,0,0,0,55000,2000,53000,53000
047202,欣興元富96購01  ,0,0,0,0,0,0,0,0,0,53000,0,0,0,53000,0,53000,53000
054161,友訊凱基98購01  ,0,0,0,0,0,0,0,0,0,53000,0,0,0,53000,0,53000,53000
04845P,台積電凱基94售33,0,0,0,0,0,0,0,0,0,53000,0,0,0,53000,0,53000,53000
057024,義隆凱基99購01  ,0,0,0,0,0,0,0,0,0,53000,0,0,0,93000,40000,53000,53000
057556,智易凱基99購01  ,0,0,0,0,0,0,0,0,0,53000,0,0,0,124000,71000,53000,53000
056047,台積電兆豐97購02,0,0,0,0,0,0,0,0,0,53000,0,0,0,63000,10000,53000,53000
055590,聯發科元大98購02,0,0,0,0,0,0,0,0,0,53000,0,0,0,53000,0,53000,53000
054864,聯發科群益97購02,0,0,0,0,0,0,0,0,0,53000,0,0,0,53000,0,53000,53000
055157,晶豪科元大97購01,0,0,0,0,0,0,0,0,0,53000,0,0,0,53000,0,53000,53000
058451,智邦永豐9A購01  ,0,0,0,0,0,0,0,0,0,53000,0,0,0,53000,0,53000,53000
055320,建準國票98購01  ,0,0,0,0,0,0,0,0,0,53000,0,0,0,55000,2000,53000,53000
056495,泰鼎國泰99購01  ,0,0,0,0,0,0,0,0,0,53000,0,0,0,180000,127000,53000,53000
058265,奇力新永豐9A購01,0,0,0,0,0,0,0,0,0,53000,0,0,0,53000,0,53000,53000
058305,華邦電元大99購02,0,0,0,0,0,0,0,0,0,53000,0,0,0,53000,0,53000,53000
4552,力達-KY         ,30000,10000,20000,0,0,0,0,0,0,32000,32000,0,32000,0,0,0,52000
2488,漢平            ,65000,13000,52000,0,0,0,0,0,0,0,0,0,0,0,0,0,52000
054046,義隆元大96購02  ,0,0,0,0,0,0,0,0,0,52000,0,0,0,52000,0,52000,52000
050842,旺宏國票97購01  ,0,0,0,0,0,0,0,0,0,52000,0,0,0,52000,0,52000,52000
053003,國巨永豐96購02  ,0,0,0,0,0,0,0,0,0,52000,0,0,0,60000,8000,52000,52000
054272,華通中信98購01  ,0,0,0,0,0,0,0,0,0,52000,0,0,0,52000,0,52000,52000
053430,樺漢永豐96購01  ,0,0,0,0,0,0,0,0,0,52000,0,0,0,146000,94000,52000,52000
058031,旺宏永豐98購04  ,0,0,0,0,0,0,0,0,0,52000,0,0,0,186000,134000,52000,52000
058322,玉晶光永豐99購02,0,0,0,0,0,0,0,0,0,52000,0,0,0,52000,0,52000,52000
058654,鴻海中信03購01  ,0,0,0,0,0,0,0,0,0,52000,0,0,0,82000,30000,52000,52000
057348,台積電統一98購09,0,0,0,0,0,0,0,0,0,52000,0,0,0,52000,0,52000,52000
054767,日電貿國票98購01,0,0,0,0,0,0,0,0,0,52000,0,0,0,85000,33000,52000,52000
055060,聯陽永豐97購01  ,0,0,0,0,0,0,0,0,0,52000,0,0,0,52000,0,52000,52000
056954,聯詠富邦9A購01  ,0,0,0,0,0,0,0,0,0,52000,0,0,0,368000,316000,52000,52000
058873,美律國票9A購02  ,0,0,0,0,0,0,0,0,0,52000,0,0,0,52000,0,52000,52000
8104,錸寶            ,57000,5000,52000,0,0,0,0,0,0,0,0,0,0,0,0,0,52000
3149,正達            ,51000,0,51000,0,0,0,0,0,0,0,0,0,0,0,0,0,51000
059586,上銀元大9A購02  ,0,0,0,0,0,0,0,0,0,51000,0,0,0,68000,17000,51000,51000
057828,緯穎元大99購02  ,0,0,0,0,0,0,0,0,0,51000,0,0,0,85000,34000,51000,51000
053705,滬深2X凱基99購01,0,0,0,0,0,0,0,0,0,51000,0,0,0,51000,0,51000,51000
052682,上銀元大97購01  ,0,0,0,0,0,0,0,0,0,51000,0,0,0,51000,0,51000,51000
055662,上銀中信99購01  ,0,0,0,0,0,0,0,0,0,51000,0,0,0,51000,0,51000,51000
057048,新日興元大98購01,0,0,0,0,0,0,0,0,0,51000,0,0,0,51000,0,51000,51000
057527,億光元大98購01  ,0,0,0,0,0,0,0,0,0,51000,0,0,0,51000,0,51000,51000
056256,聯茂元富97購03  ,0,0,0,0,0,0,0,0,0,51000,0,0,0,292000,241000,51000,51000
054731,S&P反1凱基98購01,0,0,0,0,0,0,0,0,0,51000,0,0,0,68000,17000,51000,51000
055966,茂林元大99購01  ,0,0,0,0,0,0,0,0,0,51000,0,0,0,51000,0,51000,51000
059567,台積電凱基9A購12,0,0,0,0,0,0,0,0,0,50000,0,0,0,69000,19000,50000,50000
059915,聯發科元大99購32,0,0,0,0,0,0,0,0,0,50000,0,0,0,121000,71000,50000,50000
059909,鴻海元大99購36  ,0,0,0,0,0,0,0,0,0,50000,0,0,0,81000,31000,50000,50000
060173,台灣50元富02購01,0,0,0,0,0,0,0,0,0,50000,0,0,0,50000,0,50000,50000
060236,精元元大9C購01  ,0,0,0,0,0,0,0,0,0,50000,0,0,0,50000,0,50000,50000
06901P,亞德客凱基98售02,0,0,0,0,0,0,0,0,0,50000,0,0,0,50000,0,50000,50000
06151P,華新科元大97售07,0,0,0,0,0,0,0,0,0,50000,0,0,0,50000,0,50000,50000
2362,藍天            ,206000,156000,50000,0,0,0,0,0,0,0,0,0,0,0,0,0,50000
6491,晶碩            ,92000,42000,50000,0,0,0,0,0,0,0,0,0,0,0,0,0,50000
07259P,滬深2X國票01售01,0,0,0,0,0,0,0,0,0,50000,0,0,0,50000,0,50000,50000
049023,玉晶光群益96購04,0,0,0,0,0,0,0,0,0,50000,0,0,0,50000,0,50000,50000
049024,玉晶光群益97購01,0,0,0,0,0,0,0,0,0,50000,0,0,0,50000,0,50000,50000
052756,國巨群益96購02  ,0,0,0,0,0,0,0,0,0,50000,0,0,0,68000,18000,50000,50000
048391,友訊國票94購01  ,0,0,0,0,0,0,0,0,0,50000,0,0,0,50000,0,50000,50000
048998,玉晶光國票95購03,0,0,0,0,0,0,0,0,0,50000,0,0,0,50000,0,50000,50000
052857,大成鋼凱基96購01,0,0,0,0,0,0,0,0,0,50000,0,0,0,50000,0,50000,50000
049587,美律元大95購01  ,0,0,0,0,0,0,0,0,0,50000,0,0,0,50000,0,50000,50000
050919,台積電凱基95購03,0,0,0,0,0,0,0,0,0,50000,0,0,0,50000,0,50000,50000
050926,禾伸堂凱基95購01,0,0,0,0,0,0,0,0,0,50000,0,0,0,50000,0,50000,50000
051354,聯發科元大95購09,0,0,0,0,0,0,0,0,0,50000,0,0,0,50000,0,50000,50000
051254,健策元大96購04  ,0,0,0,0,0,0,0,0,0,50000,0,0,0,50000,0,50000,50000
051088,台積電元大95購09,0,0,0,0,0,0,0,0,0,50000,0,0,0,50000,0,50000,50000
043513,台灣50元大96購05,0,0,0,0,0,0,0,0,0,50000,0,0,0,50000,0,50000,50000
047389,義隆元大94購01  ,0,0,0,0,0,0,0,0,0,50000,0,0,0,50000,0,50000,50000
047689,瑞昱富邦97購01  ,0,0,0,0,0,0,0,0,0,50000,0,0,0,50000,0,50000,50000
053688,燿華元大96購05  ,0,0,0,0,0,0,0,0,0,50000,0,0,0,50000,0,50000,50000
053384,聯發科元大96購13,0,0,0,0,0,0,0,0,0,50000,0,0,0,50000,0,50000,50000
053314,A50正2群益9A購01,0,0,0,0,0,0,0,0,0,50000,0,0,0,50000,0,50000,50000
051684,瑞昱凱基95購02  ,0,0,0,0,0,0,0,0,0,50000,0,0,0,52000,2000,50000,50000
051610,GIS群益95購02   ,0,0,0,0,0,0,0,0,0,50000,0,0,0,50000,0,50000,50000
051600,新日興兆豐96購02,0,0,0,0,0,0,0,0,0,50000,0,0,0,50000,0,50000,50000
053421,南亞科永豐96購01,0,0,0,0,0,0,0,0,0,50000,0,0,0,50000,0,50000,50000
054000,訊芯群益96購02  ,0,0,0,0,0,0,0,0,0,50000,0,0,0,50000,0,50000,50000
053750,致伸永豐96購02  ,0,0,0,0,0,0,0,0,0,50000,0,0,0,50000,0,50000,50000
058338,康友元富99購01  ,0,0,0,0,0,0,0,0,0,50000,0,0,0,50000,0,50000,50000
058037,台灣50元大9B購02,0,0,0,0,0,0,0,0,0,50000,0,0,0,50000,0,50000,50000
057884,華邦電群益98購02,0,0,0,0,0,0,0,0,0,50000,0,0,0,50000,0,50000,50000
057931,正崴群益98購02  ,0,0,0,0,0,0,0,0,0,50000,0,0,0,50000,0,50000,50000
054375,貿聯中信99購01  ,0,0,0,0,0,0,0,0,0,50000,0,0,0,50000,0,50000,50000
052532,台積電國泰96購07,0,0,0,0,0,0,0,0,0,50000,0,0,0,50000,0,50000,50000
052353,高鐵群益97購01  ,0,0,0,0,0,0,0,0,0,50000,0,0,0,50000,0,50000,50000
052619,茂林國泰99購01  ,0,0,0,0,0,0,0,0,0,50000,0,0,0,50000,0,50000,50000
051570,和碩富邦97購01  ,0,0,0,0,0,0,0,0,0,50000,0,0,0,50000,0,50000,50000
053579,華通元大97購01  ,0,0,0,0,0,0,0,0,0,50000,0,0,0,50000,0,50000,50000
053540,健策永豐96購01  ,0,0,0,0,0,0,0,0,0,50000,0,0,0,50000,0,50000,50000
051962,晶相光永豐95購02,0,0,0,0,0,0,0,0,0,50000,0,0,0,50000,0,50000,50000
056201,華新科永豐98購01,0,0,0,0,0,0,0,0,0,50000,0,0,0,50000,0,50000,50000
055926,國巨群益98購06  ,0,0,0,0,0,0,0,0,0,50000,0,0,0,50000,0,50000,50000
055109,正崴凱基98購01  ,0,0,0,0,0,0,0,0,0,50000,0,0,0,50000,0,50000,50000
054964,智易元大99購01  ,0,0,0,0,0,0,0,0,0,50000,0,0,0,50000,0,50000,50000
057749,華新科國票99購01,0,0,0,0,0,0,0,0,0,50000,0,0,0,50000,0,50000,50000
058276,道瓊指中信9C購01,0,0,0,0,0,0,0,0,0,50000,0,0,0,50000,0,50000,50000
056233,超眾凱基97購02  ,0,0,0,0,0,0,0,0,0,50000,0,0,0,50000,0,50000,50000
055790,南電凱基97購01  ,0,0,0,0,0,0,0,0,0,50000,0,0,0,50000,0,50000,50000
055819,晶相光國票98購01,0,0,0,0,0,0,0,0,0,50000,0,0,0,50000,0,50000,50000
057171,台光電元大9B購01,0,0,0,0,0,0,0,0,0,50000,0,0,0,50000,0,50000,50000
056955,台灣50永豐98購01,0,0,0,0,0,0,0,0,0,50000,0,0,0,50000,0,50000,50000
057270,遠東新元大98購01,0,0,0,0,0,0,0,0,0,50000,0,0,0,50000,0,50000,50000
055705,微星永豐97購01  ,0,0,0,0,0,0,0,0,0,50000,0,0,0,50000,0,50000,50000
054681,味全永豐97購01  ,0,0,0,0,0,0,0,0,0,50000,0,0,0,50000,0,50000,50000
059652,台灣50元大99購07,0,0,0,0,0,0,0,0,0,49000,0,0,0,50000,1000,49000,49000
059620,聯發科日盛99購02,0,0,0,0,0,0,0,0,0,49000,0,0,0,50000,1000,49000,49000
059293,宏達電元富9B購01,0,0,0,0,0,0,0,0,0,49000,0,0,0,49000,0,49000,49000
053969,瑞昱元大97購01  ,0,0,0,0,0,0,0,0,0,49000,0,0,0,49000,0,49000,49000
054063,聯茂國票97購02  ,0,0,0,0,0,0,0,0,0,49000,0,0,0,103000,54000,49000,49000
054739,義隆凱基98購02  ,0,0,0,0,0,0,0,0,0,49000,0,0,0,49000,0,49000,49000
056548,瀚宇博凱基98購02,0,0,0,0,0,0,0,0,0,49000,0,0,0,49000,0,49000,49000
059611,台積電永豐99購05,0,0,0,0,0,0,0,0,0,48000,0,0,0,153000,105000,48000,48000
059746,聯鈞元富99購03  ,0,0,0,0,0,0,0,0,0,48000,0,0,0,63000,15000,48000,48000
2401,凌陽            ,311000,259000,52000,0,0,0,0,0,0,-4000,8000,12000,-4000,0,0,0,48000
052684,旺宏元大98購01  ,0,0,0,0,0,0,0,0,0,48000,0,0,0,48000,0,48000,48000
053671,可成統一96購03  ,0,0,0,0,0,0,0,0,0,48000,0,0,0,48000,0,48000,48000
056552,台表科凱基99購01,0,0,0,0,0,0,0,0,0,48000,0,0,0,48000,0,48000,48000
056518,美律國票99購01  ,0,0,0,0,0,0,0,0,0,48000,0,0,0,48000,0,48000,48000
056449,義隆凱基98購03  ,0,0,0,0,0,0,0,0,0,48000,0,0,0,80000,32000,48000,48000
055324,TPK國票98購03   ,0,0,0,0,0,0,0,0,0,48000,0,0,0,50000,2000,48000,48000
057111,立積群益98購02  ,0,0,0,0,0,0,0,0,0,48000,0,0,0,48000,0,48000,48000
057086,立積統一9C購01  ,0,0,0,0,0,0,0,0,0,48000,0,0,0,48000,0,48000,48000
8341,日友            ,143000,95000,48000,0,0,0,0,0,0,0,0,0,0,0,0,0,48000
2612,中航            ,58000,11000,47000,0,0,0,0,0,0,0,0,0,0,0,0,0,47000
1626,艾美特-KY       ,52000,5000,47000,0,0,0,0,0,0,0,0,0,0,0,0,0,47000
059740,瑞昱元富99購02  ,0,0,0,0,0,0,0,0,0,47000,0,0,0,182000,135000,47000,47000
059657,華通元大99購09  ,0,0,0,0,0,0,0,0,0,47000,0,0,0,126000,79000,47000,47000
059977,鴻海元大99購40  ,0,0,0,0,0,0,0,0,0,47000,0,0,0,64000,17000,47000,47000
053712,台光電凱基96購04,0,0,0,0,0,0,0,0,0,47000,0,0,0,57000,10000,47000,47000
050451,嘉晶元大95購01  ,0,0,0,0,0,0,0,0,0,47000,0,0,0,47000,0,47000,47000
055776,宏達電凱基98購02,0,0,0,0,0,0,0,0,0,47000,0,0,0,49000,2000,47000,47000
055715,智邦元大97購04  ,0,0,0,0,0,0,0,0,0,47000,0,0,0,63000,16000,47000,47000
058447,玉晶光富邦9A購02,0,0,0,0,0,0,0,0,0,47000,0,0,0,99000,52000,47000,47000
058110,光寶科元富98購01,0,0,0,0,0,0,0,0,0,47000,0,0,0,47000,0,47000,47000
056362,聯發科元大99購01,0,0,0,0,0,0,0,0,0,47000,0,0,0,47000,0,47000,47000
058264,瑞昱永豐99購01  ,0,0,0,0,0,0,0,0,0,47000,0,0,0,57000,10000,47000,47000
058708,臺股指元大9A購21,0,0,0,0,0,0,0,0,0,47000,0,0,0,47000,0,47000,47000
056039,宏達電凱基97購02,0,0,0,0,0,0,0,0,0,47000,0,0,0,98000,51000,47000,47000
06957P,FBVIX凱基01售01 ,0,0,0,0,0,0,0,0,0,46000,0,0,0,46000,0,46000,46000
049602,南電元大95購01  ,0,0,0,0,0,0,0,0,0,46000,0,0,0,46000,0,46000,46000
05301P,矽力元大95售02  ,0,0,0,0,0,0,0,0,0,46000,0,0,0,46000,0,46000,46000
057763,康控凱基99購02  ,0,0,0,0,0,0,0,0,0,46000,0,0,0,46000,0,46000,46000
059276,可成元大99購06  ,0,0,0,0,0,0,0,0,0,46000,0,0,0,104000,58000,46000,46000
056596,光磊元富98購01  ,0,0,0,0,0,0,0,0,0,46000,0,0,0,46000,0,46000,46000
06617P,智邦元大98售03  ,0,0,0,0,0,0,0,0,0,45000,0,0,0,55000,10000,45000,45000
054293,健策元大98購02  ,0,0,0,0,0,0,0,0,0,45000,0,0,0,45000,0,45000,45000
052171,台積電元大95購21,0,0,0,0,0,0,0,0,0,45000,0,0,0,45000,0,45000,45000
053223,台郡凱基96購02  ,0,0,0,0,0,0,0,0,0,45000,0,0,0,50000,5000,45000,45000
058019,美律凱基99購04  ,0,0,0,0,0,0,0,0,0,45000,0,0,0,122000,77000,45000,45000
050261,國巨元大95購04  ,0,0,0,0,0,0,0,0,0,45000,0,0,0,45000,0,45000,45000
00771,元大US高息特別股,0,0,0,0,0,0,0,0,0,45000,0,0,0,51000,6000,45000,45000
048061,鴻海統一95購03  ,0,0,0,0,0,0,0,0,0,45000,0,0,0,45000,0,45000,45000
057125,國巨凱基98購12  ,0,0,0,0,0,0,0,0,0,45000,0,0,0,45000,0,45000,45000
056989,鴻海兆豐98購02  ,0,0,0,0,0,0,0,0,0,45000,0,0,0,45000,0,45000,45000
059235,鴻海凱基99購08  ,0,0,0,0,0,0,0,0,0,45000,0,0,0,148000,103000,45000,45000
055680,美律凱基99購01  ,0,0,0,0,0,0,0,0,0,45000,0,0,0,45000,0,45000,45000
056133,可成元大97購05  ,0,0,0,0,0,0,0,0,0,45000,0,0,0,50000,5000,45000,45000
055280,智邦元大97購01  ,0,0,0,0,0,0,0,0,0,45000,0,0,0,45000,0,45000,45000
060030,晶相光永豐99購03,0,0,0,0,0,0,0,0,0,44000,0,0,0,54000,10000,44000,44000
060216,鴻海凱基9A購17  ,0,0,0,0,0,0,0,0,0,44000,0,0,0,70000,26000,44000,44000
059622,上銀凱基99購10  ,0,0,0,0,0,0,0,0,0,44000,0,0,0,139000,95000,44000,44000
1810,和成            ,44000,0,44000,0,0,0,0,0,0,0,0,0,0,0,0,0,44000
07103P,南電元大99售04  ,0,0,0,0,0,0,0,0,0,44000,0,0,0,44000,0,44000,44000
07359P,台積電元大99售45,0,0,0,0,0,0,0,0,0,44000,0,0,0,87000,43000,44000,44000
050774,健策元大96購02  ,0,0,0,0,0,0,0,0,0,44000,0,0,0,44000,0,44000,44000
0055,元大MSCI金融    ,0,0,0,0,0,0,0,0,0,44000,0,0,0,49000,5000,44000,44000
04884P,聯發科凱基94售20,0,0,0,0,0,0,0,0,0,44000,0,0,0,44000,0,44000,44000
054052,日月光元大96購06,0,0,0,0,0,0,0,0,0,44000,0,0,0,44000,0,44000,44000
053597,牧德元大99購01  ,0,0,0,0,0,0,0,0,0,44000,0,0,0,75000,31000,44000,44000
055209,勤誠康和97購01  ,0,0,0,0,0,0,0,0,0,44000,0,0,0,44000,0,44000,44000
055970,聯茂元大97購04  ,0,0,0,0,0,0,0,0,0,44000,0,0,0,48000,4000,44000,44000
055587,智邦元大97購02  ,0,0,0,0,0,0,0,0,0,44000,0,0,0,59000,15000,44000,44000
057388,奇鋐永豐98購02  ,0,0,0,0,0,0,0,0,0,44000,0,0,0,48000,4000,44000,44000
056304,創意元大97購03  ,0,0,0,0,0,0,0,0,0,44000,0,0,0,54000,10000,44000,44000
057445,華通元富02購01  ,0,0,0,0,0,0,0,0,0,44000,0,0,0,44000,0,44000,44000
058969,亞德客永豐99購01,0,0,0,0,0,0,0,0,0,44000,0,0,0,57000,13000,44000,44000
056674,華邦電元富98購01,0,0,0,0,0,0,0,0,0,44000,0,0,0,44000,0,44000,44000
056651,聯茂凱基98購04  ,0,0,0,0,0,0,0,0,0,44000,0,0,0,78000,34000,44000,44000
07371P,滬深2X元大99售07,0,0,0,0,0,0,0,0,0,43000,0,0,0,43000,0,43000,43000
07242P,台灣50凱基9A售03,0,0,0,0,0,0,0,0,0,43000,0,0,0,105000,62000,43000,43000
4989,榮科            ,57000,15000,42000,0,0,0,0,0,0,1000,1000,0,1000,0,0,0,43000
059612,奇鋐永豐99購02  ,0,0,0,0,0,0,0,0,0,43000,0,0,0,159000,116000,43000,43000
060252,緯穎元大9A購02  ,0,0,0,0,0,0,0,0,0,43000,0,0,0,200000,157000,43000,43000
06431P,新日興元大97售05,0,0,0,0,0,0,0,0,0,43000,0,0,0,53000,10000,43000,43000
052307,潤泰全國泰96購01,0,0,0,0,0,0,0,0,0,43000,0,0,0,63000,20000,43000,43000
057954,宏碁元大99購01  ,0,0,0,0,0,0,0,0,0,43000,0,0,0,43000,0,43000,43000
052696,玉晶光麥證97購01,0,0,0,63000,2000,61000,0,0,0,43000,0,0,0,63000,20000,43000,43000
049702,台表科元大95購03,0,0,0,0,0,0,0,0,0,43000,0,0,0,43000,0,43000,43000
03674C,臺股指元富9C牛02,0,0,0,0,0,0,0,0,0,43000,0,0,0,43000,0,43000,43000
057630,茂林永豐98購01  ,0,0,0,0,0,0,0,0,0,43000,0,0,0,115000,72000,43000,43000
056754,智易兆豐99購01  ,0,0,0,0,0,0,0,0,0,43000,0,0,0,43000,0,43000,43000
058286,道瓊指國票9B購01,0,0,0,0,0,0,0,0,0,43000,0,0,0,43000,0,43000,43000
055909,大成鋼凱基98購02,0,0,0,0,0,0,0,0,0,43000,0,0,0,48000,5000,43000,43000
06172P,台虹永豐97售02  ,0,0,0,0,0,0,0,0,0,42000,0,0,0,54000,12000,42000,42000
06851P,鈺齊元大98售01  ,0,0,0,0,0,0,0,0,0,42000,0,0,0,46000,4000,42000,42000
06680P,智邦元大98售06  ,0,0,0,0,0,0,0,0,0,42000,0,0,0,42000,0,42000,42000
059994,國巨元富99購01  ,0,0,0,0,0,0,0,0,0,42000,0,0,0,46000,4000,42000,42000
2538,基泰            ,64000,22000,42000,0,0,0,0,0,0,0,0,0,0,0,0,0,42000
2013,中鋼構          ,58000,16000,42000,0,0,0,0,0,0,0,0,0,0,0,0,0,42000
035275,台積電台新97購01,0,0,0,0,0,0,0,0,0,42000,0,0,0,42000,0,42000,42000
050648,全新凱基96購01  ,0,0,0,0,0,0,0,0,0,42000,0,0,0,42000,0,42000,42000
00678,群益NBI生技     ,0,0,0,0,0,0,0,0,0,42000,0,0,0,343000,301000,42000,42000
00738U,元大道瓊白銀    ,122000,86000,36000,0,0,0,0,0,0,6000,0,0,0,2005000,1999000,6000,42000
058058,大立光元富9B購02,0,0,0,0,0,0,0,0,0,42000,0,0,0,42000,0,42000,42000
056098,矽創元富97購02  ,0,0,0,0,0,0,0,0,0,42000,0,0,0,334000,292000,42000,42000
056155,嘉晶凱基97購01  ,0,0,0,0,0,0,0,0,0,42000,0,0,0,42000,0,42000,42000
05528P,臺股指群益96售01,0,0,0,0,0,0,0,0,0,42000,0,0,0,181000,139000,42000,42000
057365,智邦元大98購07  ,0,0,0,0,0,0,0,0,0,42000,0,0,0,74000,32000,42000,42000
056736,國巨凱基99購03  ,0,0,0,0,0,0,0,0,0,42000,0,0,0,56000,14000,42000,42000
055728,緯穎元大97購03  ,0,0,0,0,0,0,0,0,0,42000,0,0,0,42000,0,42000,42000
058894,元油2X元大9C購11,0,0,0,0,0,0,0,0,0,42000,0,0,0,42000,0,42000,42000
059081,和大元大99購01  ,0,0,0,0,0,0,0,0,0,42000,0,0,0,42000,0,42000,42000
056921,京元電兆豐98購01,0,0,0,0,0,0,0,0,0,42000,0,0,0,142000,100000,42000,42000
057265,聯詠兆豐98購01  ,0,0,0,0,0,0,0,0,0,42000,0,0,0,52000,10000,42000,42000
057530,奇鋐元大99購01  ,0,0,0,0,0,0,0,0,0,42000,0,0,0,67000,25000,42000,42000
055779,國泰金凱基97購02,0,0,0,0,0,0,0,0,0,42000,0,0,0,51000,9000,42000,42000
1316,上曜            ,75000,34000,41000,0,0,0,0,0,0,0,0,0,0,0,0,0,41000
1338,廣華-KY         ,224000,204000,20000,0,0,0,0,0,0,21000,21000,0,21000,0,0,0,41000
07026P,超眾凱基99售03  ,0,0,0,0,0,0,0,0,0,41000,0,0,0,41000,0,41000,41000
060100,新光金元大9C購01,0,0,0,0,0,0,0,0,0,41000,0,0,0,52000,11000,41000,41000
06668P,祥碩凱基98售02  ,0,0,0,0,0,0,0,0,0,41000,0,0,0,41000,0,41000,41000
06544P,鴻海元大98售09  ,0,0,0,0,0,0,0,0,0,41000,0,0,0,41000,0,41000,41000
057862,智邦凱基99購01  ,0,0,0,0,0,0,0,0,0,41000,0,0,0,41000,0,41000,41000
051888,國巨元富95購05  ,0,0,0,0,0,0,0,0,0,41000,0,0,0,41000,0,41000,41000
049200,元黃金群益98購01,0,0,0,0,0,0,0,0,0,41000,0,0,0,41000,0,41000,41000
048867,台積電兆豐95購01,0,0,0,0,0,0,0,0,0,41000,0,0,0,51000,10000,41000,41000
057090,奇力新元富98購02,0,0,0,0,0,0,0,0,0,41000,0,0,0,95000,54000,41000,41000
059062,群創凱基99購05  ,0,0,0,0,0,0,0,0,0,41000,0,0,0,222000,181000,41000,41000
058855,台積電兆豐99購02,0,0,0,0,0,0,0,0,0,41000,0,0,0,51000,10000,41000,41000
057803,上銀元大98購08  ,0,0,0,0,0,0,0,0,0,41000,0,0,0,72000,31000,41000,41000
055205,京鼎中信99購01  ,0,0,0,0,0,0,0,0,0,41000,0,0,0,41000,0,41000,41000
06454P,緯穎元大98售04  ,0,0,0,0,0,0,0,0,0,40000,0,0,0,40000,0,40000,40000
06398P,禾伸堂凱基97售02,0,0,0,0,0,0,0,0,0,40000,0,0,0,40000,0,40000,40000
059297,大立光元富9C購01,0,0,0,0,0,0,0,0,0,40000,0,0,0,57000,17000,40000,40000
059828,健策凱基99購05  ,0,0,0,0,0,0,0,0,0,40000,0,0,0,108000,68000,40000,40000
07410P,鴻海元大99售44  ,0,0,0,0,0,0,0,0,0,40000,0,0,0,47000,7000,40000,40000
07283P,華新科凱基99售07,0,0,0,0,0,0,0,0,0,40000,0,0,0,545000,505000,40000,40000
07317P,T50正2凱基9B售02,0,0,0,0,0,0,0,0,0,40000,0,0,0,107000,67000,40000,40000
2340,光磊            ,313000,302000,11000,0,0,0,0,0,0,29000,8000,6000,2000,37000,10000,27000,40000
4994,傳奇            ,104000,164000,-60000,0,0,0,0,0,0,100000,101000,1000,100000,0,0,0,40000
048911,玉晶光富邦96購01,0,0,0,0,0,0,0,0,0,40000,0,0,0,40000,0,40000,40000
048482,柏文中信94購01  ,0,0,0,0,0,0,0,0,0,40000,0,0,0,40000,0,40000,40000
050626,A50正2中信96購02,0,0,0,0,0,0,0,0,0,40000,0,0,0,40000,0,40000,40000
048261,鴻海元富95購01  ,0,0,0,0,0,0,0,0,0,40000,0,0,0,40000,0,40000,40000
049463,華新科富邦97購01,0,0,0,0,0,0,0,0,0,40000,0,0,0,40000,0,40000,40000
049766,滬深2X元富94購02,0,0,0,0,0,0,0,0,0,40000,0,0,0,40000,0,40000,40000
050339,鴻海統一94購06  ,0,0,0,0,0,0,0,0,0,40000,0,0,0,40000,0,40000,40000
050250,台郡凱基94購03  ,0,0,0,0,0,0,0,0,0,40000,0,0,0,40000,0,40000,40000
050220,台積電元富96購01,0,0,0,0,0,0,0,0,0,40000,0,0,0,40000,0,40000,40000
050183,奇鋐元大96購01  ,0,0,0,0,0,0,0,0,0,40000,0,0,0,40000,0,40000,40000
046148,友達中信94購01  ,0,0,0,0,0,0,0,0,0,40000,0,0,0,40000,0,40000,40000
047468,為升中信95購01  ,0,0,0,0,0,0,0,0,0,40000,0,0,0,40000,0,40000,40000
046937,聯電元大99購01  ,0,0,0,0,0,0,0,0,0,40000,0,0,0,99000,59000,40000,40000
044694,道瓊反元大94購02,0,0,0,0,0,0,0,0,0,40000,0,0,0,40000,0,40000,40000
03595P,聯發科凱基02售11,0,0,0,0,0,0,0,0,0,40000,0,0,0,40000,0,40000,40000
050855,華通台新95購01  ,0,0,0,0,0,0,0,0,0,40000,0,0,0,40000,0,40000,40000
051098,矽格元大95購01  ,0,0,0,0,0,0,0,0,0,40000,0,0,0,40000,0,40000,40000
051213,華新科統一95購01,0,0,0,0,0,0,0,0,0,40000,0,0,0,40000,0,40000,40000
052520,南亞科元大95購06,0,0,0,0,0,0,0,0,0,40000,0,0,0,40000,0,40000,40000
052557,群創國票97購02  ,0,0,0,0,0,0,0,0,0,40000,0,0,0,40000,0,40000,40000
052320,緯創元大95購05  ,0,0,0,0,0,0,0,0,0,40000,0,0,0,40000,0,40000,40000
052446,聯發科元大96購03,0,0,0,0,0,0,0,0,0,40000,0,0,0,40000,0,40000,40000
052176,景碩元大96購01  ,0,0,0,0,0,0,0,0,0,40000,0,0,0,40000,0,40000,40000
053029,國巨第一96購01  ,0,0,0,0,0,0,0,0,0,40000,0,0,0,40000,0,40000,40000
054216,聯茂國票97購03  ,0,0,0,0,0,0,0,0,0,40000,0,0,0,40000,0,40000,40000
058166,鴻海凱基9A購01  ,0,0,0,0,0,0,0,0,0,40000,0,0,0,66000,26000,40000,40000
053669,台積電統一96購08,0,0,0,0,0,0,0,0,0,40000,0,0,0,40000,0,40000,40000
053859,台積電元大97購09,0,0,0,0,0,0,0,0,0,40000,0,0,0,40000,0,40000,40000
055150,台積電元大98購04,0,0,0,0,0,0,0,0,0,40000,0,0,0,40000,0,40000,40000
055298,啟碁元大97購02  ,0,0,0,0,0,0,0,0,0,40000,0,0,0,40000,0,40000,40000
055022,精元國泰99購01  ,0,0,0,0,0,0,0,0,0,40000,0,0,0,40000,0,40000,40000
055609,旺宏國票99購01  ,0,0,0,0,0,0,0,0,0,40000,0,0,0,40000,0,40000,40000
058242,玉晶光元大9A購01,0,0,0,0,0,0,0,0,0,40000,0,0,0,40000,0,40000,40000
056351,鴻海元大98購06  ,0,0,0,0,0,0,0,0,0,40000,0,0,0,50000,10000,40000,40000
055406,大毅國泰99購01  ,0,0,0,0,0,0,0,0,0,40000,0,0,0,40000,0,40000,40000
058270,上緯控永豐99購01,0,0,0,0,0,0,0,0,0,40000,0,0,0,40000,0,40000,40000
057431,京鼎兆豐98購02  ,0,0,0,0,0,0,0,0,0,40000,0,0,0,40000,0,40000,40000
055451,台積電元富97購02,0,0,0,0,0,0,0,0,0,40000,0,0,0,40000,0,40000,40000
055466,台達電凱基97購03,0,0,0,0,0,0,0,0,0,40000,0,0,0,40000,0,40000,40000
056469,國巨元大99購01  ,0,0,0,0,0,0,0,0,0,40000,0,0,0,110000,70000,40000,40000
058853,日月光群益99購01,0,0,0,0,0,0,0,0,0,40000,0,0,0,40000,0,40000,40000
05882P,華新科永豐96售01,0,0,0,0,0,0,0,0,0,40000,0,0,0,40000,0,40000,40000
058786,元黃金元大99購01,0,0,0,0,0,0,0,0,0,40000,0,0,0,40000,0,40000,40000
054564,玉晶光群益99購01,0,0,0,0,0,0,0,0,0,40000,0,0,0,40000,0,40000,40000
059092,聯陽元大99購01  ,0,0,0,0,0,0,0,0,0,40000,0,0,0,40000,0,40000,40000
058966,元油2X日盛99購03,0,0,0,0,0,0,0,0,0,40000,0,0,0,61000,21000,40000,40000
057054,立積元大98購03  ,0,0,0,0,0,0,0,0,0,40000,0,0,0,121000,81000,40000,40000
05699P,茂林凱基96售05  ,0,0,0,0,0,0,0,0,0,40000,0,0,0,40000,0,40000,40000
057241,超眾凱基99購02  ,0,0,0,0,0,0,0,0,0,40000,0,0,0,50000,10000,40000,40000
057227,台積電凱基98購15,0,0,0,0,0,0,0,0,0,40000,0,0,0,40000,0,40000,40000
054484,仁寶台新96購01  ,0,0,0,0,0,0,0,0,0,40000,0,0,0,40000,0,40000,40000
6235,華孚            ,63000,24000,39000,0,0,0,0,0,0,0,0,0,0,0,0,0,39000
2472,立隆電          ,120000,81000,39000,0,0,0,0,0,0,0,0,0,0,0,0,0,39000
07047P,S&P500中信9B售02,0,0,0,0,0,0,0,0,0,39000,0,0,0,39000,0,39000,39000
059678,鴻海國泰9A購03  ,0,0,0,0,0,0,0,0,0,39000,0,0,0,80000,41000,39000,39000
06736P,新日興凱基98售03,0,0,0,0,0,0,0,0,0,39000,0,0,0,40000,1000,39000,39000
060086,鴻海元大99購42  ,0,0,0,0,0,0,0,0,0,39000,0,0,0,85000,46000,39000,39000
060022,勤誠康和99購01  ,0,0,0,0,0,0,0,0,0,39000,0,0,0,138000,99000,39000,39000
053815,聯發科群益96購01,0,0,0,0,0,0,0,0,0,39000,0,0,0,39000,0,39000,39000
053687,智邦元大96購02  ,0,0,0,0,0,0,0,0,0,39000,0,0,0,39000,0,39000,39000
057917,台積電凱基98購17,0,0,0,0,0,0,0,0,0,39000,0,0,0,39000,0,39000,39000
054252,奇力新元大96購04,0,0,0,0,0,0,0,0,0,39000,0,0,0,42000,3000,39000,39000
054268,健策第一96購01  ,0,0,0,0,0,0,0,0,0,39000,0,0,0,39000,0,39000,39000
054371,台積電中信9C購01,0,0,0,0,0,0,0,0,0,39000,0,0,0,56000,17000,39000,39000
052588,玉晶光永豐98購01,0,0,0,0,0,0,0,0,0,39000,0,0,0,39000,0,39000,39000
054043,漢唐元大97購01  ,0,0,0,0,0,0,0,0,0,39000,0,0,0,52000,13000,39000,39000
054128,台積電元大97購10,0,0,0,0,0,0,0,0,0,39000,0,0,0,39000,0,39000,39000
058308,全新元大9B購01  ,0,0,0,0,0,0,0,0,0,39000,0,0,0,44000,5000,39000,39000
058703,台積電元大99購16,0,0,0,0,0,0,0,0,0,39000,0,0,0,43000,4000,39000,39000
05492P,聯茂元大95售02  ,0,0,0,0,0,0,0,0,0,39000,0,0,0,39000,0,39000,39000
3004,豐達科          ,50000,12000,38000,0,0,0,0,0,0,0,0,0,0,0,0,0,38000
04839P,大立光元大94售17,0,0,0,0,0,0,0,0,0,38000,0,0,0,44000,6000,38000,38000
052703,貿聯國票97購01  ,27000,0,27000,0,0,0,0,0,0,11000,0,0,0,38000,27000,11000,38000
050351,華新科群益95購02,0,0,0,0,0,0,0,0,0,38000,0,0,0,88000,50000,38000,38000
050574,微星國票94購01  ,0,0,0,0,0,0,0,0,0,38000,0,0,0,38000,0,38000,38000
04923P,GIS凱基94售06   ,0,0,0,0,0,0,0,0,0,38000,0,0,0,38000,0,38000,38000
03828P,致茂中信95售01  ,0,0,0,0,0,0,0,0,0,38000,0,0,0,38000,0,38000,38000
054295,世芯元大96購03  ,0,0,0,0,0,0,0,0,0,38000,0,0,0,38000,0,38000,38000
055019,福懋科元富97購01,0,0,0,0,0,0,0,0,0,38000,0,0,0,66000,28000,38000,38000
055217,緯創凱基97購02  ,0,0,0,0,0,0,0,0,0,38000,0,0,0,85000,47000,38000,38000
055624,聯發科富邦99購07,0,0,0,0,0,0,0,0,0,38000,0,0,0,38000,0,38000,38000
057462,光磊永豐98購02  ,0,0,0,0,0,0,0,0,0,38000,0,0,0,99000,61000,38000,38000
054461,台積電凱基97購09,0,0,0,0,0,0,0,0,0,38000,0,0,0,38000,0,38000,38000
057143,台郡兆豐98購01  ,0,0,0,0,0,0,0,0,0,38000,0,0,0,38000,0,38000,38000
055681,奇鋐凱基98購03  ,0,0,0,0,0,0,0,0,0,38000,0,0,0,38000,0,38000,38000
058884,世紀鋼永豐99購02,0,0,0,0,0,0,0,0,0,38000,0,0,0,53000,15000,38000,38000
059978,國巨元大99購29  ,0,0,0,0,0,0,0,0,0,37000,0,0,0,329000,292000,37000,37000
06134P,緯穎元富97售03  ,0,0,0,0,0,0,0,0,0,37000,0,0,0,40000,3000,37000,37000
053984,康友元大96購05  ,0,0,0,0,0,0,0,0,0,37000,0,0,0,37000,0,37000,37000
053407,台積電兆豐96購02,0,0,0,0,0,0,0,0,0,37000,0,0,0,40000,3000,37000,37000
050667,國巨永豐94購06  ,0,0,0,0,0,0,0,0,0,37000,0,0,0,65000,28000,37000,37000
046011,欣興元富95購01  ,0,0,0,0,0,0,0,0,0,37000,0,0,0,37000,0,37000,37000
058424,滬深2X元富99購04,0,0,0,0,0,0,0,0,0,37000,0,0,0,37000,0,37000,37000
057366,智邦元大98購08  ,0,0,0,0,0,0,0,0,0,37000,0,0,0,84000,47000,37000,37000
055589,台光電元大98購04,0,0,0,0,0,0,0,0,0,37000,0,0,0,37000,0,37000,37000
06662P,玉晶光中信9A售01,0,0,0,0,0,0,0,0,0,36000,0,0,0,51000,15000,36000,36000
06015P,大立光富邦98售04,0,0,0,0,0,0,0,0,0,36000,0,0,0,36000,0,36000,36000
059589,國巨元大9A購02  ,0,0,0,0,0,0,0,0,0,36000,0,0,0,42000,6000,36000,36000
1449,佳和            ,44000,8000,36000,0,0,0,0,0,0,0,0,0,0,0,0,0,36000
050694,國巨凱基96購03  ,0,0,0,0,0,0,0,0,0,36000,0,0,0,82000,46000,36000,36000
050959,元金2X永豐95購02,0,0,0,0,0,0,0,0,0,36000,0,0,0,36000,0,36000,36000
049251,國巨元大95購02  ,0,0,0,0,0,0,0,0,0,36000,0,0,0,226000,190000,36000,36000
054187,亞光永豐96購03  ,0,0,0,0,0,0,0,0,0,36000,0,0,0,36000,0,36000,36000
053782,京元電元大98購02,0,0,0,0,0,0,0,0,0,36000,0,0,0,36000,0,36000,36000
058343,台積電群益99購02,0,0,0,0,0,0,0,0,0,36000,0,0,0,36000,0,36000,36000
052343,同欣電凱基95購03,0,0,0,0,0,0,0,0,0,36000,0,0,0,36000,0,36000,36000
056141,聯茂元大97購05  ,0,0,0,0,0,0,0,0,0,36000,0,0,0,149000,113000,36000,36000
056198,台光電永豐97購02,0,0,0,0,0,0,0,0,0,36000,0,0,0,136000,100000,36000,36000
056087,世芯統一97購01  ,0,0,0,0,0,0,0,0,0,36000,0,0,0,36000,0,36000,36000
055468,智邦凱基97購04  ,0,0,0,0,0,0,0,0,0,36000,0,0,0,86000,50000,36000,36000
055516,上銀中信97購01  ,0,0,0,0,0,0,0,0,0,36000,0,0,0,36000,0,36000,36000
057042,台積電元大98購10,0,0,0,0,0,0,0,0,0,36000,0,0,0,36000,0,36000,36000
057248,台積電統一98購08,0,0,0,0,0,0,0,0,0,36000,0,0,0,36000,0,36000,36000
059024,大立光統一9B購04,0,0,0,0,0,0,0,0,0,36000,0,0,0,36000,0,36000,36000
059132,臺股指群益99購07,0,0,0,0,0,0,0,0,0,36000,0,0,0,140000,104000,36000,36000
059149,臺股指國票99購12,0,0,0,0,0,0,0,0,0,36000,0,0,0,40000,4000,36000,36000
1473,台南            ,53000,18000,35000,0,0,0,0,0,0,0,0,0,0,0,0,0,35000
2636,台驊投控        ,39000,4000,35000,0,0,0,0,0,0,0,0,0,0,0,0,0,35000
3607,谷崧            ,38000,3000,35000,0,0,0,0,0,0,0,0,0,0,0,0,0,35000
059635,華新科凱基9A購06,0,0,0,0,0,0,0,0,0,35000,0,0,0,189000,154000,35000,35000
059474,元石油群益99購01,0,0,0,0,0,0,0,0,0,35000,0,0,0,53000,18000,35000,35000
059752,國巨群益9B購01  ,0,0,0,0,0,0,0,0,0,35000,0,0,0,53000,18000,35000,35000
059873,華新科凱基99購09,0,0,0,0,0,0,0,0,0,35000,0,0,0,182000,147000,35000,35000
059910,鴻海元大99購37  ,0,0,0,0,0,0,0,0,0,35000,0,0,0,94000,59000,35000,35000
06726P,欣興元富98售04  ,0,0,0,0,0,0,0,0,0,35000,0,0,0,40000,5000,35000,35000
06731P,聯茂元大98售05  ,0,0,0,0,0,0,0,0,0,35000,0,0,0,35000,0,35000,35000
051843,聯發科富邦99購01,0,0,0,0,0,0,0,0,0,35000,0,0,0,35000,0,35000,35000
053081,上銀元大97購02  ,0,0,0,0,0,0,0,0,0,35000,0,0,0,35000,0,35000,35000
051503,玉晶光統一97購01,0,0,0,0,0,0,0,0,0,35000,0,0,0,101000,66000,35000,35000
052193,國巨元富95購06  ,0,0,0,0,0,0,0,0,0,35000,0,0,0,35000,0,35000,35000
051673,玉晶光元大96購04,0,0,0,0,0,0,0,0,0,35000,0,0,0,35000,0,35000,35000
05294P,亞光凱基95售02  ,0,0,0,0,0,0,0,0,0,35000,0,0,0,35000,0,35000,35000
05406P,台光電凱基95售02,0,0,0,0,0,0,0,0,0,35000,0,0,0,35000,0,35000,35000
049436,義隆國泰96購02  ,0,0,0,0,0,0,0,0,0,35000,0,0,0,36000,1000,35000,35000
04980P,臺股指凱基96售08,0,0,0,0,0,0,0,0,0,35000,0,0,0,46000,11000,35000,35000
050661,景碩元大94購02  ,0,0,0,0,0,0,0,0,0,35000,0,0,0,35000,0,35000,35000
059109,台積電富邦9C購03,0,0,0,0,0,0,0,0,0,35000,0,0,0,35000,0,35000,35000
055735,宏達電元富98購01,0,0,0,0,0,0,0,0,0,35000,0,0,0,35000,0,35000,35000
057272,台積電元大98購14,0,0,0,0,0,0,0,0,0,35000,0,0,0,35000,0,35000,35000
056856,華通群益9A購01  ,0,0,0,0,0,0,0,0,0,35000,0,0,0,35000,0,35000,35000
058432,台積電統一9B購03,0,0,0,0,0,0,0,0,0,35000,0,0,0,35000,0,35000,35000
056250,瑞昱兆豐97購02  ,0,0,0,0,0,0,0,0,0,35000,0,0,0,35000,0,35000,35000
055192,世芯元富97購01  ,0,0,0,0,0,0,0,0,0,35000,0,0,0,35000,0,35000,35000
054817,聯發科元大97購13,0,0,0,0,0,0,0,0,0,35000,0,0,0,35000,0,35000,35000
8499,鼎炫-KY         ,51000,16000,35000,0,0,0,0,0,0,0,0,0,0,0,0,0,35000
6168,宏齊            ,57000,23000,34000,0,0,0,0,0,0,0,0,0,0,0,0,0,34000
2413,環科            ,52000,18000,34000,0,0,0,0,0,0,0,0,0,0,0,0,0,34000
1708,東鹼            ,84000,36000,48000,0,0,0,0,0,0,-14000,0,14000,-14000,0,0,0,34000
051257,光寶科國泰96購01,0,0,0,0,0,0,0,0,0,34000,0,0,0,54000,20000,34000,34000
052874,超眾凱基96購01  ,0,0,0,0,0,0,0,0,0,34000,0,0,0,46000,12000,34000,34000
048628,T50反1元大96購03,0,0,0,0,0,0,0,0,0,34000,0,0,0,108000,74000,34000,34000
04863P,技嘉元大94售02  ,0,0,0,0,0,0,0,0,0,34000,0,0,0,34000,0,34000,34000
053954,貿聯康和96購01  ,0,0,0,0,0,0,0,0,0,34000,0,0,0,68000,34000,34000,34000
058389,聯茂國票9A購01  ,0,0,0,0,0,0,0,0,0,34000,0,0,0,47000,13000,34000,34000
052308,大立光國泰97購02,0,0,0,0,0,0,0,0,0,34000,0,0,0,34000,0,34000,34000
054302,鴻海凱基96購18  ,0,0,0,0,0,0,0,0,0,34000,0,0,0,75000,41000,34000,34000
056189,樺漢統一97購02  ,0,0,0,0,0,0,0,0,0,34000,0,0,0,68000,34000,34000,34000
058648,聯陽永豐99購01  ,0,0,0,0,0,0,0,0,0,34000,0,0,0,34000,0,34000,34000
057534,旭富元大98購01  ,0,0,0,0,0,0,0,0,0,34000,0,0,0,34000,0,34000,34000
057055,立積元大99購01  ,0,0,0,0,0,0,0,0,0,34000,0,0,0,425000,391000,34000,34000
057638,上銀元大99購01  ,0,0,0,0,0,0,0,0,0,34000,0,0,0,34000,0,34000,34000
07124P,台積電元大99售21,0,0,0,0,0,0,0,0,0,33000,0,0,0,33000,0,33000,33000
07208P,台積電凱基99售14,0,0,0,0,0,0,0,0,0,33000,0,0,0,46000,13000,33000,33000
3311,閎暉            ,38000,2000,36000,0,0,0,0,0,0,-3000,0,3000,-3000,0,0,0,33000
052515,矽力凱基95購02  ,0,0,0,0,0,0,0,0,0,33000,0,0,0,115000,82000,33000,33000
053127,貿聯凱基97購01  ,0,0,0,0,0,0,0,0,0,33000,0,0,0,46000,13000,33000,33000
051360,緯創元大95購03  ,0,0,0,0,0,0,0,0,0,33000,0,0,0,33000,0,33000,33000
00651R,FH香港反1       ,0,127000,-127000,0,0,0,0,0,0,160000,0,0,0,225000,65000,160000,33000
059067,上銀國票9A購02  ,0,0,0,0,0,0,0,0,0,33000,0,0,0,43000,10000,33000,33000
059033,元油2X群益9C購05,0,0,0,0,0,0,0,0,0,33000,0,0,0,33000,0,33000,33000
05536P,奇力新元大96售03,0,0,0,0,0,0,0,0,0,33000,0,0,0,33000,0,33000,33000
055160,玉晶光元大99購03,0,0,0,0,0,0,0,0,0,33000,0,0,0,33000,0,33000,33000
3312,弘憶股          ,89000,57000,32000,0,0,0,0,0,0,0,0,0,0,0,0,0,32000
2387,精元            ,874000,870000,4000,0,0,0,0,0,0,28000,0,0,0,31000,3000,28000,32000
2524,京城            ,86000,53000,33000,0,0,0,0,0,0,-1000,0,1000,-1000,0,0,0,32000
07029P,緯穎群益99售02  ,0,0,0,0,0,0,0,0,0,32000,0,0,0,32000,0,32000,32000
1795,美時            ,356000,324000,32000,0,0,0,0,0,0,0,0,0,0,0,0,0,32000
1737,臺鹽            ,15000,43000,-28000,0,0,0,0,0,0,60000,60000,0,60000,0,0,0,32000
1722,台肥            ,564000,531000,33000,0,0,0,0,0,0,-1000,0,1000,-1000,0,0,0,32000
06914P,南茂元大98售03  ,0,0,0,0,0,0,0,0,0,32000,0,0,0,32000,0,32000,32000
059885,台積電國票99購12,0,0,0,0,0,0,0,0,0,32000,0,0,0,51000,19000,32000,32000
059876,智易凱基99購02  ,0,0,0,0,0,0,0,0,0,32000,0,0,0,91000,59000,32000,32000
059784,台光電元大9A購01,0,0,0,0,0,0,0,0,0,32000,0,0,0,33000,1000,32000,32000
047418,智邦富邦97購01  ,0,0,0,0,0,0,0,0,0,32000,0,0,0,40000,8000,32000,32000
04177P,富邦金元大94售01,0,0,0,0,0,0,0,0,0,32000,0,0,0,32000,0,32000,32000
048801,漢唐富邦96購02  ,0,0,0,0,0,0,0,0,0,32000,0,0,0,459000,427000,32000,32000
050092,鴻海永豐94購04  ,0,0,0,0,0,0,0,0,0,32000,0,0,0,32000,0,32000,32000
052159,瑞昱永豐95購01  ,0,0,0,0,0,0,0,0,0,32000,0,0,0,84000,52000,32000,32000
057875,京鼎元大98購03  ,0,0,0,0,0,0,0,0,0,32000,0,0,0,37000,5000,32000,32000
055315,晶技麥證97購01  ,0,0,0,32000,0,32000,0,0,0,32000,0,0,0,32000,0,32000,32000
058046,國巨元大9A購01  ,0,0,0,0,0,0,0,0,0,32000,0,0,0,32000,0,32000,32000
058069,美律凱基99購05  ,0,0,0,0,0,0,0,0,0,32000,0,0,0,32000,0,32000,32000
058691,友訊國票9A購01  ,0,0,0,0,0,0,0,0,0,32000,0,0,0,70000,38000,32000,32000
056459,茂林凱基99購01  ,0,0,0,0,0,0,0,0,0,32000,0,0,0,256000,224000,32000,32000
059029,旺宏兆豐99購01  ,0,0,0,0,0,0,0,0,0,32000,0,0,0,32000,0,32000,32000
057052,華擎元大98購01  ,0,0,0,0,0,0,0,0,0,32000,0,0,0,32000,0,32000,32000
059358,旺宏永豐99購02  ,0,0,0,0,0,0,0,0,0,31000,0,0,0,169000,138000,31000,31000
06717P,可成元大98售09  ,0,0,0,0,0,0,0,0,0,31000,0,0,0,50000,19000,31000,31000
06124P,超眾元大97售03  ,0,0,0,0,0,0,0,0,0,31000,0,0,0,31000,0,31000,31000
06051P,嘉聯益國票97售04,0,0,0,0,0,0,0,0,0,31000,0,0,0,37000,6000,31000,31000
06584P,欣興凱基98售03  ,0,0,0,0,0,0,0,0,0,31000,0,0,0,31000,0,31000,31000
057927,勤誠凱基98購01  ,0,0,0,0,0,0,0,0,0,31000,0,0,0,191000,160000,31000,31000
053179,大立光統一96購04,0,0,0,0,0,0,0,0,0,31000,0,0,0,31000,0,31000,31000
050420,鴻海凱基95購03  ,0,0,0,0,0,0,0,0,0,31000,0,0,0,106000,75000,31000,31000
050553,緯穎凱基94購06  ,0,0,0,0,0,0,0,0,0,31000,0,0,0,50000,19000,31000,31000
048733,台勝科麥證95購02,0,0,0,33000,2000,31000,0,0,0,31000,0,0,0,33000,2000,31000,31000
048422,瑞昱元富96購02  ,0,0,0,0,0,0,0,0,0,31000,0,0,0,146000,115000,31000,31000
051291,聯詠統一95購01  ,0,0,0,0,0,0,0,0,0,31000,0,0,0,31000,0,31000,31000
056667,上銀國票99購01  ,0,0,0,0,0,0,0,0,0,31000,0,0,0,31000,0,31000,31000
056597,宏碁元富98購01  ,0,0,0,0,0,0,0,0,0,31000,0,0,0,31000,0,31000,31000
056637,台光電日盛9A購01,0,0,0,0,0,0,0,0,0,31000,0,0,0,31000,0,31000,31000
059224,大立光元大99購15,0,0,0,0,0,0,0,0,0,31000,0,0,0,42000,11000,31000,31000
059277,群創元大99購05  ,0,0,0,0,0,0,0,0,0,31000,0,0,0,31000,0,31000,31000
055503,健策元大98購05  ,0,0,0,0,0,0,0,0,0,31000,0,0,0,31000,0,31000,31000
058295,欣興凱基99購02  ,0,0,0,0,0,0,0,0,0,31000,0,0,0,31000,0,31000,31000
055318,華通國票98購01  ,0,0,0,0,0,0,0,0,0,31000,0,0,0,32000,1000,31000,31000
055007,晶相光元富9A購02,0,0,0,0,0,0,0,0,0,31000,0,0,0,31000,0,31000,31000
06308P,國巨元富97售06  ,0,0,0,0,0,0,0,0,0,30000,0,0,0,30000,0,30000,30000
06079P,燿華群益98售02  ,0,0,0,0,0,0,0,0,0,30000,0,0,0,30000,0,30000,30000
06228P,亞德客凱基97售04,0,0,0,0,0,0,0,0,0,30000,0,0,0,30000,0,30000,30000
06737P,台郡凱基98售07  ,0,0,0,0,0,0,0,0,0,30000,0,0,0,30000,0,30000,30000
060015,國巨康和99購03  ,0,0,0,0,0,0,0,0,0,30000,0,0,0,135000,105000,30000,30000
059458,鎧勝永豐99購01  ,0,0,0,0,0,0,0,0,0,30000,0,0,0,30000,0,30000,30000
059936,台積電永豐99購06,0,0,0,0,0,0,0,0,0,30000,0,0,0,30000,0,30000,30000
1615,大山            ,0,5000,-5000,0,0,0,0,0,0,35000,35000,0,35000,0,0,0,30000
08966P,臺指反元大04售07,0,0,0,0,0,0,0,0,0,30000,0,0,0,30000,0,30000,30000
07094P,華通國票9A售03  ,0,0,0,0,0,0,0,0,0,30000,0,0,0,31000,1000,30000,30000
3055,蔚華科          ,32000,2000,30000,0,0,0,0,0,0,0,0,0,0,0,0,0,30000
051348,國巨元大95購07  ,0,0,0,0,0,0,0,0,0,30000,0,0,0,30000,0,30000,30000
051146,旺宏凱基95購04  ,0,0,0,0,0,0,0,0,0,30000,0,0,0,30000,0,30000,30000
050783,旺宏國泰96購02  ,0,0,0,0,0,0,0,0,0,30000,0,0,0,30000,0,30000,30000
04316P,華新科國票94售05,0,0,0,0,0,0,0,0,0,30000,0,0,0,30000,0,30000,30000
04293P,滬深2X元大96售02,0,0,0,0,0,0,0,0,0,30000,0,0,0,30000,0,30000,30000
044530,台積電富邦94購01,0,0,0,0,0,0,0,0,0,30000,0,0,0,30000,0,30000,30000
046340,滬深2X國票96購01,0,0,0,0,0,0,0,0,0,30000,0,0,0,130000,100000,30000,30000
048392,宏碁國票94購01  ,0,0,0,0,0,0,0,0,0,30000,0,0,0,130000,100000,30000,30000
049008,傳奇中信95購01  ,0,0,0,0,0,0,0,0,0,30000,0,0,0,30000,0,30000,30000
052753,電子類元大96購02,0,0,0,0,0,0,0,0,0,30000,0,0,0,30000,0,30000,30000
054012,廣達永豐96購01  ,0,0,0,0,0,0,0,0,0,30000,0,0,0,30000,0,30000,30000
050518,台積電元大94購28,0,0,0,0,0,0,0,0,0,30000,0,0,0,30000,0,30000,30000
049220,聯發科國票95購02,0,0,0,0,0,0,0,0,0,30000,0,0,0,30000,0,30000,30000
04925P,和碩元大94售03  ,0,0,0,0,0,0,0,0,0,30000,0,0,0,30000,0,30000,30000
04824P,亞泥中信94售02  ,0,0,0,0,0,0,0,0,0,30000,0,0,0,30000,0,30000,30000
050093,國巨永豐94購05  ,0,0,0,0,0,0,0,0,0,30000,0,0,0,30000,0,30000,30000
050369,台積電元大94購23,0,0,0,0,0,0,0,0,0,30000,0,0,0,30000,0,30000,30000
050318,景碩國票94購02  ,0,0,0,0,0,0,0,0,0,30000,0,0,0,80000,50000,30000,30000
049569,光磊統一94購02  ,0,0,0,0,0,0,0,0,0,30000,0,0,0,30000,0,30000,30000
053161,康友元大96購04  ,0,0,0,0,0,0,0,0,0,30000,0,0,0,30000,0,30000,30000
054398,牧德永豐96購03  ,0,0,0,0,0,0,0,0,0,30000,0,0,0,30000,0,30000,30000
054439,健策台新96購03  ,0,0,0,0,0,0,0,0,0,30000,0,0,0,30000,0,30000,30000
052508,矽力日盛95購02  ,0,0,0,0,0,0,0,0,0,30000,0,0,0,30000,0,30000,30000
051826,智邦元大95購03  ,0,0,0,0,0,0,0,0,0,30000,0,0,0,30000,0,30000,30000
051817,元金2X統一95購01,0,0,0,0,0,0,0,0,0,30000,0,0,0,30000,0,30000,30000
051977,泰碩凱基95購01  ,0,0,0,0,0,0,0,0,0,30000,0,0,0,30000,0,30000,30000
051466,玉晶光富邦97購01,0,0,0,0,0,0,0,0,0,30000,0,0,0,30000,0,30000,30000
051450,世芯元大95購02  ,0,0,0,0,0,0,0,0,0,30000,0,0,0,30000,0,30000,30000
054250,漢唐元大96購04  ,0,0,0,0,0,0,0,0,0,30000,0,0,0,30000,0,30000,30000
054229,超眾元富96購05  ,0,0,0,0,0,0,0,0,0,30000,0,0,0,30000,0,30000,30000
05422P,大立光中信97售02,0,0,0,0,0,0,0,0,0,30000,0,0,0,30000,0,30000,30000
054289,聯發科元大97購11,0,0,0,0,0,0,0,0,0,30000,0,0,0,30000,0,30000,30000
054276,國巨群益96購07  ,0,0,0,0,0,0,0,0,0,30000,0,0,0,30000,0,30000,30000
05152P,玉晶光群益96售05,0,0,0,0,0,0,0,0,0,30000,0,0,0,30000,0,30000,30000
058162,上銀日盛9B購01  ,0,0,0,0,0,0,0,0,0,30000,0,0,0,70000,40000,30000,30000
053799,矽創中信9A購01  ,0,0,0,0,0,0,0,0,0,30000,0,0,0,30000,0,30000,30000
053868,群創元大99購02  ,0,0,0,0,0,0,0,0,0,30000,0,0,0,30000,0,30000,30000
051582,聯發科元大97購02,0,0,0,0,0,0,0,0,0,30000,0,0,0,30000,0,30000,30000
053281,茂林元大96購02  ,0,0,0,0,0,0,0,0,0,30000,0,0,0,30000,0,30000,30000
055008,隆達元富97購01  ,0,0,0,0,0,0,0,0,0,30000,0,0,0,30000,0,30000,30000
054851,樺漢兆豐97購01  ,0,0,0,0,0,0,0,0,0,30000,0,0,0,30000,0,30000,30000
058735,南茂永豐99購01  ,0,0,0,0,0,0,0,0,0,30000,0,0,0,30000,0,30000,30000
055294,智易元大98購01  ,0,0,0,0,0,0,0,0,0,30000,0,0,0,30000,0,30000,30000
055561,奇鋐凱基97購01  ,0,0,0,0,0,0,0,0,0,30000,0,0,0,30000,0,30000,30000
056555,矽創凱基98購01  ,0,0,0,0,0,0,0,0,0,30000,0,0,0,30000,0,30000,30000
058086,鴻海元大98購14  ,0,0,0,0,0,0,0,0,0,30000,0,0,0,85000,55000,30000,30000
057331,台積電國票99購04,0,0,0,0,0,0,0,0,0,30000,0,0,0,30000,0,30000,30000
057792,群創統一99購01  ,0,0,0,0,0,0,0,0,0,30000,0,0,0,30000,0,30000,30000
055497,開發金元大97購01,0,0,0,0,0,0,0,0,0,30000,0,0,0,30000,0,30000,30000
058699,楠梓電元大99購02,0,0,0,0,0,0,0,0,0,30000,0,0,0,30000,0,30000,30000
05863P,滬深2X元大96售09,0,0,0,0,0,0,0,0,0,30000,0,0,0,30000,0,30000,30000
057502,訊芯群益98購02  ,0,0,0,0,0,0,0,0,0,30000,0,0,0,30000,0,30000,30000
059249,大立光凱基99購05,0,0,0,0,0,0,0,0,0,30000,0,0,0,35000,5000,30000,30000
056765,友達元大9B購05  ,0,0,0,0,0,0,0,0,0,30000,0,0,0,30000,0,30000,30000
054543,元金2X中信01購01,0,0,0,0,0,0,0,0,0,30000,0,0,0,30000,0,30000,30000
055729,金寶元富99購01  ,0,0,0,0,0,0,0,0,0,30000,0,0,0,30000,0,30000,30000
054573,漢唐元大98購01  ,0,0,0,0,0,0,0,0,0,30000,0,0,0,30000,0,30000,30000
057656,大成鋼兆豐98購01,0,0,0,0,0,0,0,0,0,30000,0,0,0,30000,0,30000,30000
057628,旺宏永豐98購02  ,0,0,0,0,0,0,0,0,0,30000,0,0,0,134000,104000,30000,30000
058527,世紀鋼元大99購01,0,0,0,0,0,0,0,0,0,30000,0,0,0,30000,0,30000,30000
056845,揚明光元富98購01,0,0,0,0,0,0,0,0,0,30000,0,0,0,30000,0,30000,30000
057221,華通國票98購03  ,0,0,0,0,0,0,0,0,0,30000,0,0,0,30000,0,30000,30000
057187,群創元大9B購04  ,0,0,0,0,0,0,0,0,0,30000,0,0,0,30000,0,30000,30000
1227,佳格            ,834000,805711,28289,0,0,0,0,0,0,1000,1000,0,1000,0,0,0,29289
1457,宜進            ,107000,78000,29000,0,0,0,0,0,0,0,0,0,0,0,0,0,29000
07174P,臺股指國票99售11,0,0,0,0,0,0,0,0,0,29000,0,0,0,65000,36000,29000,29000
059493,國巨國票9B購01  ,0,0,0,0,0,0,0,0,0,29000,0,0,0,84000,55000,29000,29000
060020,康控康和99購01  ,0,0,0,0,0,0,0,0,0,29000,0,0,0,171000,142000,29000,29000
06937P,GIS元大98售03   ,0,0,0,0,0,0,0,0,0,29000,0,0,0,29000,0,29000,29000
053945,國巨富邦98購02  ,0,0,0,0,0,0,0,0,0,29000,0,0,0,29000,0,29000,29000
058227,台灣50元大9C購01,0,0,0,0,0,0,0,0,0,29000,0,0,0,29000,0,29000,29000
058354,台積電凱基9A購06,0,0,0,0,0,0,0,0,0,29000,0,0,0,29000,0,29000,29000
053093,緯穎元大96購06  ,0,0,0,0,0,0,0,0,0,29000,0,0,0,29000,0,29000,29000
052003,泰碩國泰97購02  ,0,0,0,0,0,0,0,0,0,29000,0,0,0,29000,0,29000,29000
052454,力成元大95購02  ,0,0,0,0,0,0,0,0,0,29000,0,0,0,29000,0,29000,29000
053129,緯穎凱基96購01  ,0,0,0,0,0,0,0,0,0,29000,0,0,0,32000,3000,29000,29000
04949P,致新元大94售04  ,0,0,0,0,0,0,0,0,0,29000,0,0,0,29000,0,29000,29000
058473,上銀凱基9A購03  ,0,0,0,0,0,0,0,0,0,29000,0,0,0,29000,0,29000,29000
057658,玉晶光兆豐99購02,0,0,0,0,0,0,0,0,0,29000,0,0,0,29000,0,29000,29000
055796,南電國泰98購01  ,0,0,0,0,0,0,0,0,0,29000,0,0,0,216000,187000,29000,29000
058831,茂林永豐99購01  ,0,0,0,0,0,0,0,0,0,29000,0,0,0,147000,118000,29000,29000
057766,矽力凱基98購03  ,0,0,0,0,0,0,0,0,0,29000,0,0,0,47000,18000,29000,29000
058091,欣興元大99購03  ,0,0,0,0,0,0,0,0,0,29000,0,0,0,33000,4000,29000,29000
06618P,智邦元大98售04  ,0,0,0,0,0,0,0,0,0,28000,0,0,0,28000,0,28000,28000
059427,國巨元大99購24  ,0,0,0,0,0,0,0,0,0,28000,0,0,0,63000,35000,28000,28000
059428,國巨元大99購25  ,0,0,0,0,0,0,0,0,0,28000,0,0,0,68000,40000,28000,28000
059693,智原永豐99購01  ,0,0,0,0,0,0,0,0,0,28000,0,0,0,73000,45000,28000,28000
3024,憶聲            ,38000,10000,28000,0,0,0,0,0,0,0,0,0,0,0,0,0,28000
2459,敦吉            ,39000,11000,28000,0,0,0,0,0,0,0,0,0,0,0,0,0,28000
2423,固緯            ,54000,26000,28000,0,0,0,0,0,0,0,0,0,0,0,0,0,28000
6112,聚碩            ,104000,76000,28000,0,0,0,0,0,0,0,0,0,0,0,0,0,28000
050590,晶技永豐95購01  ,0,0,0,0,0,0,0,0,0,28000,0,0,0,271000,243000,28000,28000
045516,聯茂統一94購01  ,0,0,0,0,0,0,0,0,0,28000,0,0,0,28000,0,28000,28000
00665L,富邦恒生國企正2 ,28000,12000,16000,0,0,0,0,0,0,12000,0,0,0,13000,1000,12000,28000
020016,統一MSCI美科技N ,0,0,0,0,0,0,0,0,0,28000,0,0,0,28000,0,28000,28000
050992,台積電元大97購01,0,0,0,0,0,0,0,0,0,28000,0,0,0,28000,0,28000,28000
058403,玉晶光元大99購12,0,0,0,0,0,0,0,0,0,28000,0,0,0,38000,10000,28000,28000
057961,茂林元大9A購01  ,0,0,0,0,0,0,0,0,0,28000,0,0,0,28000,0,28000,28000
055431,和鑫群益98購01  ,0,0,0,0,0,0,0,0,0,28000,0,0,0,30000,2000,28000,28000
057330,台積電國票99購03,0,0,0,0,0,0,0,0,0,28000,0,0,0,28000,0,28000,28000
056361,美律元大99購02  ,0,0,0,0,0,0,0,0,0,28000,0,0,0,28000,0,28000,28000
057478,智邦元大99購01  ,0,0,0,0,0,0,0,0,0,28000,0,0,0,28000,0,28000,28000
05620P,大立光富邦9B售01,0,0,0,0,0,0,0,0,0,28000,0,0,0,28000,0,28000,28000
054546,玉晶光中信9B購01,0,0,0,0,0,0,0,0,0,28000,0,0,0,28000,0,28000,28000
2455,全新            ,432000,697000,-265000,0,0,0,128000,0,128000,164000,162000,104000,58000,145000,39000,106000,27000
07050P,宏達電中信9B售01,0,0,0,0,0,0,0,0,0,27000,0,0,0,29000,2000,27000,27000
2231,為升            ,53000,35000,18000,0,0,0,0,0,0,9000,10000,3000,7000,3000,1000,2000,27000
060130,瀚宇博永豐99購02,0,0,0,0,0,0,0,0,0,27000,0,0,0,100000,73000,27000,27000
054427,潤泰全富邦97購01,0,0,0,0,0,0,0,0,0,27000,0,0,0,120000,93000,27000,27000
051831,緯穎元大96購04  ,0,0,0,0,0,0,0,0,0,27000,0,0,0,27000,0,27000,27000
00762,元大全球AI      ,1000,1000,0,0,0,0,0,0,0,27000,0,0,0,56000,29000,27000,27000
050184,信邦元大94購01  ,0,0,0,0,0,0,0,0,0,27000,0,0,0,27000,0,27000,27000
052916,華新科富邦96購01,0,0,0,0,0,0,0,0,0,27000,0,0,0,27000,0,27000,27000
048874,玉晶光國票96購01,0,0,0,0,0,0,0,0,0,27000,0,0,0,27000,0,27000,27000
059137,電子類群益99購01,0,0,0,0,0,0,0,0,0,27000,0,0,0,27000,0,27000,27000
055962,晶豪科元大97購02,0,0,0,0,0,0,0,0,0,27000,0,0,0,27000,0,27000,27000
055955,微星元大97購01  ,0,0,0,0,0,0,0,0,0,27000,0,0,0,40000,13000,27000,27000
056508,揚明光永豐98購01,0,0,0,0,0,0,0,0,0,27000,0,0,0,27000,0,27000,27000
055193,世芯元富97購02  ,0,0,0,0,0,0,0,0,0,27000,0,0,0,27000,0,27000,27000
055018,緯穎元富97購02  ,0,0,0,0,0,0,0,0,0,27000,0,0,0,27000,0,27000,27000
055475,臻鼎凱基97購02  ,0,0,0,0,0,0,0,0,0,27000,0,0,0,33000,6000,27000,27000
056484,聯茂元大98購02  ,0,0,0,0,0,0,0,0,0,27000,0,0,0,33000,6000,27000,27000
055373,聯詠元大97購03  ,0,0,0,0,0,0,0,0,0,27000,0,0,0,35000,8000,27000,27000
2302,麗正            ,26000,0,26000,0,0,0,0,0,0,0,0,0,0,0,0,0,26000
07219P,臺股指凱基99售32,0,0,0,0,0,0,0,0,0,26000,0,0,0,34000,8000,26000,26000
04834P,鴻海元大94售17  ,0,0,0,0,0,0,0,0,0,26000,0,0,0,26000,0,26000,26000
00763U,街口道瓊銅      ,0,0,0,0,0,0,0,0,0,26000,0,0,0,26000,0,26000,26000
047406,香港反統一94購01,0,0,0,0,0,0,0,0,0,26000,0,0,0,26000,0,26000,26000
053249,致伸國票97購02  ,0,0,0,0,0,0,0,0,0,26000,0,0,0,64000,38000,26000,26000
058190,貿聯永豐99購01  ,0,0,0,0,0,0,0,0,0,26000,0,0,0,48000,22000,26000,26000
053499,禾伸堂兆豐96購01,0,0,0,0,0,0,0,0,0,26000,0,0,0,100000,74000,26000,26000
053443,智邦凱基97購01  ,0,0,0,0,0,0,0,0,0,26000,0,0,0,26000,0,26000,26000
056293,上銀元大97購10  ,0,0,0,0,0,0,0,0,0,26000,0,0,0,26000,0,26000,26000
058096,南電元大98購04  ,0,0,0,0,0,0,0,0,0,26000,0,0,0,43000,17000,26000,26000
058545,義隆富邦9C購01  ,0,0,0,0,0,0,0,0,0,26000,0,0,0,26000,0,26000,26000
058606,聯發科元大99購13,0,0,0,0,0,0,0,0,0,26000,0,0,0,30000,4000,26000,26000
056000,佳世達永豐97購01,0,0,0,0,0,0,0,0,0,26000,0,0,0,94000,68000,26000,26000
059118,晶技永豐9A購01  ,0,0,0,0,0,0,0,0,0,26000,0,0,0,30000,4000,26000,26000
058905,京鼎元大99購01  ,0,0,0,0,0,0,0,0,0,26000,0,0,0,26000,0,26000,26000
056894,佳世達元大99購01,0,0,0,0,0,0,0,0,0,26000,0,0,0,346000,320000,26000,26000
07251P,台灣50元富01售04,0,0,0,0,0,0,0,0,0,25000,0,0,0,25000,0,25000,25000
07324P,台積電元大99售40,0,0,0,0,0,0,0,0,0,25000,0,0,0,614000,589000,25000,25000
07356P,臺股指國票99售24,0,0,0,0,0,0,0,0,0,25000,0,0,0,60000,35000,25000,25000
1540,喬福            ,27000,2000,25000,0,0,0,0,0,0,0,0,0,0,0,0,0,25000
2419,仲琦            ,138000,113000,25000,0,0,0,0,0,0,0,0,0,0,0,0,0,25000
3032,偉訓            ,28000,3000,25000,0,0,0,0,0,0,0,0,0,0,0,0,0,25000
3501,維熹            ,50000,25000,25000,0,0,0,0,0,0,0,0,0,0,0,0,0,25000
4956,光鋐            ,34000,9000,25000,0,0,0,0,0,0,0,0,0,0,0,0,0,25000
060071,國巨元富99購03  ,0,0,0,0,0,0,0,0,0,25000,0,0,0,37000,12000,25000,25000
05999P,世芯元大96售01  ,0,0,0,0,0,0,0,0,0,25000,0,0,0,25000,0,25000,25000
060182,旺宏元富9A購01  ,0,0,0,0,0,0,0,0,0,25000,0,0,0,200000,175000,25000,25000
060257,臺股指元大9B購08,0,0,0,0,0,0,0,0,0,25000,0,0,0,30000,5000,25000,25000
059716,鴻海元大99購35  ,0,0,0,0,0,0,0,0,0,25000,0,0,0,76000,51000,25000,25000
059808,創意元富99購01  ,0,0,0,0,0,0,0,0,0,25000,0,0,0,52000,27000,25000,25000
053280,群創元大9C購01  ,0,0,0,0,0,0,0,0,0,25000,0,0,0,25000,0,25000,25000
051605,奇力新群益95購02,0,0,0,0,0,0,0,0,0,25000,0,0,0,55000,30000,25000,25000
057847,聯茂永豐98購01  ,0,0,0,0,0,0,0,0,0,25000,0,0,0,25000,0,25000,25000
058388,健策國票9A購01  ,0,0,0,0,0,0,0,0,0,25000,0,0,0,25000,0,25000,25000
057922,華新科凱基99購01,0,0,0,0,0,0,0,0,0,25000,0,0,0,25000,0,25000,25000
052324,康友元大96購02  ,0,0,0,0,0,0,0,0,0,25000,0,0,0,25000,0,25000,25000
054291,高鐵元大97購01  ,0,0,0,0,0,0,0,0,0,25000,0,0,0,25000,0,25000,25000
045535,A50正2群益94購01,0,0,0,0,0,0,0,0,0,25000,0,0,0,25000,0,25000,25000
045106,玉晶光群益95購01,0,0,0,0,0,0,0,0,0,25000,0,0,0,25000,0,25000,25000
046298,聯發科富邦94購01,0,0,0,0,0,0,0,0,0,25000,0,0,0,25000,0,25000,25000
00866,新光Shiller CAPE,0,0,0,0,0,0,0,0,0,25000,0,0,0,52000,27000,25000,25000
048012,嘉晶國票94購01  ,0,0,0,0,0,0,0,0,0,25000,0,0,0,25000,0,25000,25000
050818,華新科凱基95購02,0,0,0,0,0,0,0,0,0,25000,0,0,0,65000,40000,25000,25000
05118P,超眾元大96售04  ,0,0,0,0,0,0,0,0,0,25000,0,0,0,25000,0,25000,25000
042752,台灣50元大96購03,0,0,0,0,0,0,0,0,0,25000,0,0,0,25000,0,25000,25000
050197,矽格元大94購04  ,0,0,0,0,0,0,0,0,0,25000,0,0,0,25000,0,25000,25000
049759,元黃金富邦9A購01,0,0,0,0,0,0,0,0,0,25000,0,0,0,25000,0,25000,25000
052731,宏達電國泰98購01,0,0,0,0,0,0,0,0,0,25000,0,0,0,25000,0,25000,25000
052690,台表科元大97購01,0,0,0,0,0,0,0,0,0,25000,0,0,0,25000,0,25000,25000
054041,鴻海元大96購22  ,0,0,0,0,0,0,0,0,0,25000,0,0,0,25000,0,25000,25000
057175,美律元大98購03  ,0,0,0,0,0,0,0,0,0,25000,0,0,0,25000,0,25000,25000
057182,禾伸堂元大99購02,0,0,0,0,0,0,0,0,0,25000,0,0,0,25000,0,25000,25000
057257,台泥兆豐99購01  ,0,0,0,0,0,0,0,0,0,25000,0,0,0,25000,0,25000,25000
058514,潤泰全元大99購01,0,0,0,0,0,0,0,0,0,25000,0,0,0,113000,88000,25000,25000
055772,致茂凱基97購01  ,0,0,0,0,0,0,0,0,0,25000,0,0,0,25000,0,25000,25000
054668,傳奇元富97購03  ,0,0,0,0,0,0,0,0,0,25000,0,0,0,25000,0,25000,25000
058944,元石油群益9C購02,0,0,0,0,0,0,0,0,0,25000,0,0,0,25000,0,25000,25000
056524,欣興中信98購02  ,0,0,0,0,0,0,0,0,0,25000,0,0,0,25000,0,25000,25000
055584,國巨元大97購11  ,0,0,0,0,0,0,0,0,0,25000,0,0,0,140000,115000,25000,25000
055275,台積電元大97購19,0,0,0,0,0,0,0,0,0,25000,0,0,0,25000,0,25000,25000
057489,奇力新元大99購06,0,0,0,0,0,0,0,0,0,25000,0,0,0,25000,0,25000,25000
055485,國巨元大97購09  ,0,0,0,0,0,0,0,0,0,25000,0,0,0,105000,80000,25000,25000
058148,百和元大99購01  ,0,0,0,0,0,0,0,0,0,25000,0,0,0,48000,23000,25000,25000
056294,上銀元大97購11  ,0,0,0,0,0,0,0,0,0,25000,0,0,0,25000,0,25000,25000
055383,GIS元大97購02   ,0,0,0,0,0,0,0,0,0,25000,0,0,0,25000,0,25000,25000
057403,亞光群益98購04  ,0,0,0,0,0,0,0,0,0,25000,0,0,0,102000,77000,25000,25000
057411,臺股指群益99購05,0,0,0,0,0,0,0,0,0,25000,0,0,0,25000,0,25000,25000
057802,卜蜂元大98購01  ,0,0,0,0,0,0,0,0,0,25000,0,0,0,25000,0,25000,25000
059687,卜蜂永豐99購01  ,0,0,0,0,0,0,0,0,0,24000,0,0,0,24000,0,24000,24000
06135P,志超元富97售01  ,0,0,0,0,0,0,0,0,0,24000,0,0,0,36000,12000,24000,24000
06845P,億光元大98售02  ,0,0,0,0,0,0,0,0,0,24000,0,0,0,49000,25000,24000,24000
5706,鳳凰            ,26000,2000,24000,0,0,0,0,0,0,0,0,0,0,0,0,0,24000
1315,達新            ,152000,127000,25000,0,0,0,0,0,0,-1000,0,1000,-1000,0,0,0,24000
07074P,FBVIX凱基9A售01 ,0,0,0,0,0,0,0,0,0,24000,0,0,0,24000,0,24000,24000
052648,茂林永豐96購01  ,0,0,0,0,0,0,0,0,0,24000,0,0,0,24000,0,24000,24000
049017,旺宏群益96購03  ,0,0,0,0,0,0,0,0,0,24000,0,0,0,24000,0,24000,24000
049505,臺股指元大94購16,0,0,0,0,0,0,0,0,0,24000,0,0,0,24000,0,24000,24000
00690,兆豐藍籌30      ,0,0,0,0,0,0,0,0,0,24000,0,0,0,195000,171000,24000,24000
047383,鴻海元大95購01  ,0,0,0,0,0,0,0,0,0,24000,0,0,0,24000,0,24000,24000
051995,矽力元大95購03  ,0,0,0,0,0,0,0,0,0,24000,0,0,0,24000,0,24000,24000
052451,旭富元大95購02  ,0,0,0,0,0,0,0,0,0,24000,0,0,0,24000,0,24000,24000
053256,上銀富邦98購01  ,0,0,0,0,0,0,0,0,0,24000,0,0,0,24000,0,24000,24000
053644,台表科國票97購03,0,0,0,0,0,0,0,0,0,24000,0,0,0,24000,0,24000,24000
055352,奇力新凱基97購01,0,0,0,0,0,0,0,0,0,24000,0,0,0,50000,26000,24000,24000
058656,燿華中信99購01  ,0,0,0,0,0,0,0,0,0,24000,0,0,0,24000,0,24000,24000
054870,新日興群益98購01,0,0,0,0,0,0,0,0,0,24000,0,0,0,24000,0,24000,24000
055631,創意永豐98購01  ,0,0,0,0,0,0,0,0,0,24000,0,0,0,110000,86000,24000,24000
056546,致伸凱基98購01  ,0,0,0,0,0,0,0,0,0,24000,0,0,0,24000,0,24000,24000
058998,鴻海元大99購22  ,0,0,0,0,0,0,0,0,0,24000,0,0,0,65000,41000,24000,24000
059048,元油2X凱基9A購11,0,0,0,0,0,0,0,0,0,24000,0,0,0,24000,0,24000,24000
056723,國巨中信9A購01  ,0,0,0,0,0,0,0,0,0,24000,0,0,0,24000,0,24000,24000
057132,華新科凱基98購05,0,0,0,0,0,0,0,0,0,24000,0,0,0,69000,45000,24000,24000
057172,南亞科元大98購03,0,0,0,0,0,0,0,0,0,24000,0,0,0,131000,107000,24000,24000
057678,臺股指元大98購08,0,0,0,0,0,0,0,0,0,24000,0,0,0,24000,0,24000,24000
057174,南亞科元大98購05,0,0,0,0,0,0,0,0,0,24000,0,0,0,174000,150000,24000,24000
06595P,祥碩元大98售03  ,0,0,0,0,0,0,0,0,0,23000,0,0,0,191000,168000,23000,23000
059811,高股息凱基99購02,0,0,0,0,0,0,0,0,0,23000,0,0,0,23000,0,23000,23000
059625,國巨凱基99購17  ,0,0,0,0,0,0,0,0,0,23000,0,0,0,29000,6000,23000,23000
054420,緯穎元大96購08  ,0,0,0,0,0,0,0,0,0,23000,0,0,0,79000,56000,23000,23000
053559,台積電國泰98購01,0,0,0,0,0,0,0,0,0,23000,0,0,0,23000,0,23000,23000
053091,同欣電元大96購01,0,0,0,0,0,0,0,0,0,23000,0,0,0,23000,0,23000,23000
03009X,元展09          ,0,0,0,0,0,0,0,0,0,23000,0,0,0,23000,0,23000,23000
042692,台灣50凱基96購09,0,0,0,0,0,0,0,0,0,23000,0,0,0,23000,0,23000,23000
050228,中磊中信96購01  ,0,0,0,0,0,0,0,0,0,23000,0,0,0,23000,0,23000,23000
052712,旺宏凱基96購02  ,0,0,0,0,0,0,0,0,0,23000,0,0,0,23000,0,23000,23000
057715,聯發科統一99購03,0,0,0,0,0,0,0,0,0,23000,0,0,0,23000,0,23000,23000
054638,國泰金中信99購01,0,0,0,0,0,0,0,0,0,23000,0,0,0,53000,30000,23000,23000
059075,FBVIX元大99購01 ,0,0,0,0,0,0,0,0,0,23000,0,0,0,35000,12000,23000,23000
059265,美律中信01購01  ,0,0,0,0,0,0,0,0,0,23000,0,0,0,63000,40000,23000,23000
056561,台光電群益98購02,0,0,0,0,0,0,0,0,0,23000,0,0,0,109000,86000,23000,23000
056140,康控元大98購01  ,0,0,0,0,0,0,0,0,0,23000,0,0,0,23000,0,23000,23000
056486,樺漢元大98購04  ,0,0,0,0,0,0,0,0,0,23000,0,0,0,42000,19000,23000,23000
05744P,台表科元大96售04,0,0,0,0,0,0,0,0,0,23000,0,0,0,23000,0,23000,23000
058088,鴻海元大9A購01  ,0,0,0,0,0,0,0,0,0,23000,0,0,0,23000,0,23000,23000
056356,台積電元大99購01,0,0,0,0,0,0,0,0,0,23000,0,0,0,23000,0,23000,23000
06900P,FBVIX國票12售01 ,0,0,0,0,0,0,0,0,0,22000,0,0,0,102000,80000,22000,22000
050353,華擎群益95購01  ,0,0,0,0,0,0,0,0,0,22000,0,0,0,22000,0,22000,22000
049601,矽創元大95購02  ,0,0,0,0,0,0,0,0,0,22000,0,0,0,22000,0,22000,22000
00685L,群益臺灣加權正2 ,0,0,0,0,0,0,0,0,0,22000,0,0,0,42000,20000,22000,22000
054296,世芯元大97購01  ,0,0,0,0,0,0,0,0,0,22000,0,0,0,22000,0,22000,22000
051451,世芯元大95購03  ,0,0,0,0,0,0,0,0,0,22000,0,0,0,22000,0,22000,22000
052107,台積電統一95購06,0,0,0,0,0,0,0,0,0,22000,0,0,0,22000,0,22000,22000
052234,GIS凱基97購01   ,0,0,0,0,0,0,0,0,0,22000,0,0,0,55000,33000,22000,22000
051578,智邦元大96購01  ,0,0,0,0,0,0,0,0,0,22000,0,0,0,22000,0,22000,22000
058062,上銀中信98購01  ,0,0,0,0,0,0,0,0,0,22000,0,0,0,22000,0,22000,22000
057871,國巨元大99購09  ,0,0,0,0,0,0,0,0,0,22000,0,0,0,22000,0,22000,22000
058177,華新科凱基99購02,0,0,0,0,0,0,0,0,0,22000,0,0,0,112000,90000,22000,22000
058167,鴻海凱基9A購03  ,0,0,0,0,0,0,0,0,0,22000,0,0,0,58000,36000,22000,22000
057818,泰碩元大9A購01  ,0,0,0,0,0,0,0,0,0,22000,0,0,0,22000,0,22000,22000
058243,華擎元大99購01  ,0,0,0,0,0,0,0,0,0,22000,0,0,0,888000,866000,22000,22000
056485,同欣電元大98購01,0,0,0,0,0,0,0,0,0,22000,0,0,0,22000,0,22000,22000
055216,友達凱基98購05  ,0,0,0,0,0,0,0,0,0,22000,0,0,0,39000,17000,22000,22000
057183,玉晶光元大99購07,0,0,0,0,0,0,0,0,0,22000,0,0,0,22000,0,22000,22000
06347P,祥碩元富97售02  ,0,0,0,0,0,0,0,0,0,21000,0,0,0,23000,2000,21000,21000
060084,聯電元大99購02  ,0,0,0,0,0,0,0,0,0,21000,0,0,0,77000,56000,21000,21000
059535,玉山金凱基99購01,0,0,0,0,0,0,0,0,0,21000,0,0,0,268000,247000,21000,21000
059465,台灣50元大9C購09,0,0,0,0,0,0,0,0,0,21000,0,0,0,21000,0,21000,21000
059350,樺漢凱基9A購01  ,0,0,0,0,0,0,0,0,0,21000,0,0,0,21000,0,21000,21000
07082P,美律元大99售06  ,0,0,0,0,0,0,0,0,0,21000,0,0,0,21000,0,21000,21000
08714P,華碩元富01售03  ,0,0,0,0,0,0,0,0,0,21000,0,0,0,21000,0,21000,21000
058024,台積電國泰9A購01,0,0,0,0,0,0,0,0,0,21000,0,0,0,21000,0,21000,21000
057941,聯電國票99購01  ,0,0,0,0,0,0,0,0,0,21000,0,0,0,63000,42000,21000,21000
053948,大立光富邦99購04,0,0,0,0,0,0,0,0,0,21000,0,0,0,21000,0,21000,21000
052006,康友富邦98購01  ,0,0,0,0,0,0,0,0,0,21000,0,0,0,21000,0,21000,21000
053601,台表科元大98購01,0,0,0,0,0,0,0,0,0,21000,0,0,0,21000,0,21000,21000
053245,全新國票97購01  ,0,0,0,0,0,0,0,0,0,21000,0,0,0,21000,0,21000,21000
052511,聯發科凱基95購14,0,0,0,0,0,0,0,0,0,21000,0,0,0,31000,10000,21000,21000
00710B,FH彭博高收益債  ,0,0,0,0,0,0,0,0,0,21000,0,0,0,135000,114000,21000,21000
03840P,台積電統一99售02,0,0,0,0,0,0,0,0,0,21000,0,0,0,22000,1000,21000,21000
050784,美律國泰96購01  ,0,0,0,0,0,0,0,0,0,21000,0,0,0,21000,0,21000,21000
05090P,國巨元大95售05  ,0,0,0,0,0,0,0,0,0,21000,0,0,0,21000,0,21000,21000
058433,台積電統一9B購04,0,0,0,0,0,0,0,0,0,21000,0,0,0,21000,0,21000,21000
057091,華新科元富9A購01,0,0,0,0,0,0,0,0,0,21000,0,0,0,21000,0,21000,21000
055755,禾伸堂兆豐97購02,0,0,0,0,0,0,0,0,0,21000,0,0,0,78000,57000,21000,21000
056675,聯發科元富02購01,0,0,0,0,0,0,0,0,0,21000,0,0,0,21000,0,21000,21000
059012,臺股指元大9A購31,0,0,0,0,0,0,0,0,0,21000,0,0,0,21000,0,21000,21000
058937,仁寶中信99購01  ,0,0,0,0,0,0,0,0,0,21000,0,0,0,66000,45000,21000,21000
058968,T50正2永豐99購01,0,0,0,0,0,0,0,0,0,21000,0,0,0,21000,0,21000,21000
058739,喬山中信99購01  ,0,0,0,0,0,0,0,0,0,21000,0,0,0,21000,0,21000,21000
054943,群光元大97購01  ,0,0,0,0,0,0,0,0,0,21000,0,0,0,506000,485000,21000,21000
055915,大立光凱基98購07,0,0,0,0,0,0,0,0,0,21000,0,0,0,21000,0,21000,21000
05483P,國巨凱基95售07  ,0,0,0,0,0,0,0,0,0,21000,0,0,0,21000,0,21000,21000
057428,正崴兆豐98購01  ,0,0,0,0,0,0,0,0,0,21000,0,0,0,21000,0,21000,21000
07322P,鴻海元大99售33  ,0,0,0,0,0,0,0,0,0,20000,0,0,0,26000,6000,20000,20000
6177,達麗            ,49000,29000,20000,0,0,0,0,0,0,0,0,0,0,0,0,0,20000
6183,關貿            ,31000,14000,17000,0,0,0,0,0,0,3000,3000,0,3000,0,0,0,20000
4572,駐龍            ,30000,10000,20000,0,0,0,0,0,0,0,0,0,0,0,0,0,20000
059466,國巨元大99購26  ,0,0,0,0,0,0,0,0,0,20000,0,0,0,111000,91000,20000,20000
059408,台灣50國票9B購02,0,0,0,0,0,0,0,0,0,20000,0,0,0,20000,0,20000,20000
059384,上証2X凱基9B購01,0,0,0,0,0,0,0,0,0,20000,0,0,0,20000,0,20000,20000
059507,鴻海永豐99購03  ,0,0,0,0,0,0,0,0,0,20000,0,0,0,85000,65000,20000,20000
059492,國巨國票9A購06  ,0,0,0,0,0,0,0,0,0,20000,0,0,0,54000,34000,20000,20000
059792,台灣50國票9A購09,0,0,0,0,0,0,0,0,0,20000,0,0,0,20000,0,20000,20000
059941,聯發科永豐99購04,0,0,0,0,0,0,0,0,0,20000,0,0,0,30000,10000,20000,20000
060189,宏達電元富9B購03,0,0,0,0,0,0,0,0,0,20000,0,0,0,20000,0,20000,20000
06366P,鴻海凱基97售10  ,0,0,0,0,0,0,0,0,0,20000,0,0,0,20000,0,20000,20000
06974P,臺股指元大9A售12,0,0,0,0,0,0,0,0,0,20000,0,0,0,20000,0,20000,20000
06644P,亞德客元大98售03,0,0,0,0,0,0,0,0,0,20000,0,0,0,20000,0,20000,20000
06651P,華新科元大99售09,0,0,0,0,0,0,0,0,0,20000,0,0,0,20000,0,20000,20000
06801P,技嘉群益99售02  ,0,0,0,0,0,0,0,0,0,20000,0,0,0,26000,6000,20000,20000
050809,鴻海凱基95購08  ,0,0,0,0,0,0,0,0,0,20000,0,0,0,30000,10000,20000,20000
05124P,華新科富邦97售02,0,0,0,0,0,0,0,0,0,20000,0,0,0,20000,0,20000,20000
051109,美律統一95購02  ,0,0,0,0,0,0,0,0,0,20000,0,0,0,20000,0,20000,20000
051089,旺宏元大96購04  ,0,0,0,0,0,0,0,0,0,20000,0,0,0,20000,0,20000,20000
051363,矽創元大95購03  ,0,0,0,0,0,0,0,0,0,20000,0,0,0,20000,0,20000,20000
043784,鴻海凱基94購01  ,0,0,0,0,0,0,0,0,0,20000,0,0,0,20000,0,20000,20000
00703,台新MSCI中國    ,5000,5000,0,0,0,0,0,0,0,20000,0,0,0,126000,106000,20000,20000
020015,統一MSCI美低波N ,0,0,0,0,0,0,0,0,0,20000,0,0,0,20000,0,20000,20000
00851,台新全球AI      ,0,0,0,0,0,0,0,0,0,20000,0,0,0,49000,29000,20000,20000
047521,台積電元大94購03,0,0,0,0,0,0,0,0,0,20000,0,0,0,20000,0,20000,20000
046944,奇力新元大96購01,0,0,0,0,0,0,0,0,0,20000,0,0,0,20000,0,20000,20000
04595P,臺股指元大94售13,0,0,0,0,0,0,0,0,0,20000,0,0,0,20000,0,20000,20000
049544,台積電群益94購08,0,0,0,0,0,0,0,0,0,20000,0,0,0,20000,0,20000,20000
049559,香港反統一94購02,0,0,0,0,0,0,0,0,0,20000,0,0,0,20000,0,20000,20000
049780,智易統一94購02  ,0,0,0,0,0,0,0,0,0,20000,0,0,0,20000,0,20000,20000
049915,瑞昱元大94購07  ,0,0,0,0,0,0,0,0,0,20000,0,0,0,20000,0,20000,20000
049898,緯穎統一95購01  ,0,0,0,0,0,0,0,0,0,20000,0,0,0,20000,0,20000,20000
050370,台積電元大94購24,0,0,0,0,0,0,0,0,0,20000,0,0,0,20000,0,20000,20000
050163,群創國泰95購01  ,0,0,0,0,0,0,0,0,0,20000,0,0,0,20000,0,20000,20000
050006,華擎永豐94購03  ,0,0,0,0,0,0,0,0,0,20000,0,0,0,20000,0,20000,20000
04936P,大立光中信95售03,0,0,0,0,0,0,0,0,0,20000,0,0,0,20000,0,20000,20000
049297,日電貿群益95購01,0,0,0,0,0,0,0,0,0,20000,0,0,0,20000,0,20000,20000
051413,富邦金國票96購02,0,0,0,0,0,0,0,0,0,20000,0,0,0,20000,0,20000,20000
050601,台表科國泰96購01,0,0,0,0,0,0,0,0,0,20000,0,0,0,20000,0,20000,20000
050460,GIS元大95購03   ,0,0,0,0,0,0,0,0,0,20000,0,0,0,20000,0,20000,20000
052744,聯詠元大97購01  ,0,0,0,0,0,0,0,0,0,20000,0,0,0,20000,0,20000,20000
052745,欣興元大96購04  ,0,0,0,0,0,0,0,0,0,20000,0,0,0,20000,0,20000,20000
052698,深中小國票99購01,0,0,0,0,0,0,0,0,0,20000,0,0,0,20000,0,20000,20000
05266P,華新科元大95售11,0,0,0,0,0,0,0,0,0,20000,0,0,0,20000,0,20000,20000
052811,玉晶光台新96購03,0,0,0,0,0,0,0,0,0,20000,0,0,0,20000,0,20000,20000
052805,晶技元大97購01  ,0,0,0,0,0,0,0,0,0,20000,0,0,0,20000,0,20000,20000
052861,台光電凱基96購03,0,0,0,0,0,0,0,0,0,20000,0,0,0,20000,0,20000,20000
052885,高鐵兆豐98購01  ,0,0,0,0,0,0,0,0,0,20000,0,0,0,30000,10000,20000,20000
052961,國巨凱基97購02  ,0,0,0,0,0,0,0,0,0,20000,0,0,0,20000,0,20000,20000
054166,日電貿凱基98購01,0,0,0,0,0,0,0,0,0,20000,0,0,0,20000,0,20000,20000
052443,台積電元大95購23,0,0,0,0,0,0,0,0,0,20000,0,0,0,20000,0,20000,20000
052476,台光電群益98購01,0,0,0,0,0,0,0,0,0,20000,0,0,0,20000,0,20000,20000
052322,力成元大96購01  ,0,0,0,0,0,0,0,0,0,20000,0,0,0,20000,0,20000,20000
052363,廣達國票96購01  ,0,0,0,0,0,0,0,0,0,20000,0,0,0,20000,0,20000,20000
052377,景碩元大96購02  ,0,0,0,0,0,0,0,0,0,20000,0,0,0,20000,0,20000,20000
051827,智邦元大95購04  ,0,0,0,0,0,0,0,0,0,20000,0,0,0,20000,0,20000,20000
051929,GIS中信96購01   ,0,0,0,0,0,0,0,0,0,20000,0,0,0,20000,0,20000,20000
052598,滬深2X元大96購05,0,0,0,0,0,0,0,0,0,20000,0,0,0,20000,0,20000,20000
051905,道瓊銀元大95購01,0,0,0,0,0,0,0,0,0,20000,0,0,0,20000,0,20000,20000
053168,晶技群益98購01  ,0,0,0,0,0,0,0,0,0,20000,0,0,0,20000,0,20000,20000
05350P,可成元富98售04  ,0,0,0,0,0,0,0,0,0,20000,0,0,0,20000,0,20000,20000
054319,世紀鋼凱基96購02,0,0,0,0,0,0,0,0,0,20000,0,0,0,20000,0,20000,20000
054387,台積電統一98購02,0,0,0,0,0,0,0,0,0,20000,0,0,0,20000,0,20000,20000
054390,智邦元富96購03  ,0,0,0,0,0,0,0,0,0,20000,0,0,0,20000,0,20000,20000
052228,聯發科凱基96購06,0,0,0,0,0,0,0,0,0,20000,0,0,0,20000,0,20000,20000
054232,台積電群益96購12,0,0,0,0,0,0,0,0,0,20000,0,0,0,20000,0,20000,20000
054259,健策元大97購03  ,0,0,0,0,0,0,0,0,0,20000,0,0,0,20000,0,20000,20000
054205,華新國票97購02  ,0,0,0,0,0,0,0,0,0,20000,0,0,0,20000,0,20000,20000
054201,聯詠富邦97購02  ,0,0,0,0,0,0,0,0,0,20000,0,0,0,20000,0,20000,20000
051526,超眾凱基95購02  ,0,0,0,0,0,0,0,0,0,20000,0,0,0,20000,0,20000,20000
053021,國巨國泰97購04  ,0,0,0,0,0,0,0,0,0,20000,0,0,0,20000,0,20000,20000
053985,矽創元大96購02  ,0,0,0,0,0,0,0,0,0,20000,0,0,0,20000,0,20000,20000
053890,華新科群益98購01,0,0,0,0,0,0,0,0,0,20000,0,0,0,20000,0,20000,20000
053771,華新元大97購01  ,0,0,0,0,0,0,0,0,0,20000,0,0,0,20000,0,20000,20000
051670,欣興元大95購06  ,0,0,0,0,0,0,0,0,0,20000,0,0,0,20000,0,20000,20000
051654,致新永豐95購01  ,0,0,0,0,0,0,0,0,0,20000,0,0,0,120000,100000,20000,20000
053266,全新群益98購01  ,0,0,0,0,0,0,0,0,0,20000,0,0,0,20000,0,20000,20000
053703,緯穎兆豐96購01  ,0,0,0,0,0,0,0,0,0,20000,0,0,0,20000,0,20000,20000
053732,S&P反1中信9C購01,0,0,0,0,0,0,0,0,0,20000,0,0,0,20000,0,20000,20000
053344,嘉晶國票97購02  ,0,0,0,0,0,0,0,0,0,20000,0,0,0,20000,0,20000,20000
053381,友達元大9A購02  ,0,0,0,0,0,0,0,0,0,20000,0,0,0,20000,0,20000,20000
058023,南電凱基98購02  ,0,0,0,0,0,0,0,0,0,20000,0,0,0,20000,0,20000,20000
058365,奇力新凱基9A購01,0,0,0,0,0,0,0,0,0,20000,0,0,0,20000,0,20000,20000
057406,茂林群益98購03  ,0,0,0,0,0,0,0,0,0,20000,0,0,0,20000,0,20000,20000
057333,智邦國票99購01  ,0,0,0,0,0,0,0,0,0,20000,0,0,0,20000,0,20000,20000
057767,緯穎凱基98購06  ,0,0,0,0,0,0,0,0,0,20000,0,0,0,20000,0,20000,20000
057764,台表科凱基9A購01,0,0,0,0,0,0,0,0,0,20000,0,0,0,20000,0,20000,20000
058097,台灣50國泰99購01,0,0,0,0,0,0,0,0,0,20000,0,0,0,20000,0,20000,20000
055358,臻鼎凱基97購01  ,0,0,0,0,0,0,0,0,0,20000,0,0,0,20000,0,20000,20000
056303,亞光元大97購04  ,0,0,0,0,0,0,0,0,0,20000,0,0,0,20000,0,20000,20000
056316,訊芯元大98購03  ,0,0,0,0,0,0,0,0,0,20000,0,0,0,20000,0,20000,20000
055526,台積電群益97購02,0,0,0,0,0,0,0,0,0,20000,0,0,0,20000,0,20000,20000
055535,緯創群益98購01  ,0,0,0,0,0,0,0,0,0,20000,0,0,0,20000,0,20000,20000
056402,智易群益98購02  ,0,0,0,0,0,0,0,0,0,20000,0,0,0,20000,0,20000,20000
055489,瑞昱元大97購02  ,0,0,0,0,0,0,0,0,0,20000,0,0,0,20000,0,20000,20000
055446,奇力新統一9A購01,0,0,0,0,0,0,0,0,0,20000,0,0,0,20000,0,20000,20000
055461,TPK永豐97購01   ,0,0,0,0,0,0,0,0,0,20000,0,0,0,20000,0,20000,20000
058269,世芯永豐9A購01  ,0,0,0,0,0,0,0,0,0,20000,0,0,0,20000,0,20000,20000
057511,健策統一98購02  ,0,0,0,0,0,0,0,0,0,20000,0,0,0,20000,0,20000,20000
058701,鴻海元大99購16  ,0,0,0,0,0,0,0,0,0,20000,0,0,0,20000,0,20000,20000
055906,大立光兆豐97購03,0,0,0,0,0,0,0,0,0,20000,0,0,0,30000,10000,20000,20000
056137,聯鈞元大9A購01  ,0,0,0,0,0,0,0,0,0,20000,0,0,0,20000,0,20000,20000
056161,康控凱基98購02  ,0,0,0,0,0,0,0,0,0,20000,0,0,0,20000,0,20000,20000
056111,力成永豐97購01  ,0,0,0,0,0,0,0,0,0,20000,0,0,0,20000,0,20000,20000
056205,貿聯永豐97購01  ,0,0,0,0,0,0,0,0,0,20000,0,0,0,20000,0,20000,20000
055971,矽力元大97購05  ,0,0,0,0,0,0,0,0,0,20000,0,0,0,20000,0,20000,20000
056061,國泰金元大97購02,0,0,0,0,0,0,0,0,0,20000,0,0,0,20000,0,20000,20000
055021,亞德客國泰98購01,0,0,0,0,0,0,0,0,0,20000,0,0,0,20000,0,20000,20000
058710,臺股指元大9A購23,0,0,0,0,0,0,0,0,0,20000,0,0,0,20000,0,20000,20000
054917,聯發科凱基98購05,0,0,0,0,0,0,0,0,0,20000,0,0,0,20000,0,20000,20000
055183,聯鈞統一97購01  ,0,0,0,0,0,0,0,0,0,20000,0,0,0,20000,0,20000,20000
055155,奇力新元大99購01,0,0,0,0,0,0,0,0,0,20000,0,0,0,20000,0,20000,20000
055302,達方元大97購01  ,0,0,0,0,0,0,0,0,0,20000,0,0,0,48000,28000,20000,20000
055307,瑞昱群益97購02  ,0,0,0,0,0,0,0,0,0,20000,0,0,0,20000,0,20000,20000
055308,聯發科群益97購04,0,0,0,0,0,0,0,0,0,20000,0,0,0,20000,0,20000,20000
058976,元油2X凱基9A購09,0,0,0,0,0,0,0,0,0,20000,0,0,0,20000,0,20000,20000
059086,國巨元大99購18  ,0,0,0,0,0,0,0,0,0,20000,0,0,0,20000,0,20000,20000
059091,中信金元大99購01,0,0,0,0,0,0,0,0,0,20000,0,0,0,20000,0,20000,20000
059234,台灣50凱基9C購03,0,0,0,0,0,0,0,0,0,20000,0,0,0,20000,0,20000,20000
059195,國巨永豐99購04  ,0,0,0,0,0,0,0,0,0,20000,0,0,0,37000,17000,20000,20000
054574,美律元大99購01  ,0,0,0,0,0,0,0,0,0,20000,0,0,0,20000,0,20000,20000
058896,中環元大99購03  ,0,0,0,0,0,0,0,0,0,20000,0,0,0,73000,53000,20000,20000
055725,嘉聯益元大98購03,0,0,0,0,0,0,0,0,0,20000,0,0,0,32000,12000,20000,20000
055701,亞德客富邦99購01,0,0,0,0,0,0,0,0,0,20000,0,0,0,20000,0,20000,20000
054532,強茂國泰98購01  ,0,0,0,0,0,0,0,0,0,20000,0,0,0,20000,0,20000,20000
056604,鴻海富邦9A購01  ,0,0,0,0,0,0,0,0,0,20000,0,0,0,20000,0,20000,20000
056592,台積電元富98購01,0,0,0,0,0,0,0,0,0,20000,0,0,0,20000,0,20000,20000
058418,台積電麥證99購01,0,0,0,0,0,0,0,0,0,20000,0,0,0,20000,0,20000,20000
056253,京鼎兆豐98購01  ,0,0,0,0,0,0,0,0,0,20000,0,0,0,20000,0,20000,20000
055795,茂林國泰98購01  ,0,0,0,0,0,0,0,0,0,20000,0,0,0,20000,0,20000,20000
057170,瑞昱元大98購01  ,0,0,0,0,0,0,0,0,0,20000,0,0,0,20000,0,20000,20000
056993,GIS兆豐99購01   ,0,0,0,0,0,0,0,0,0,20000,0,0,0,20000,0,20000,20000
056987,南茂群益98購01  ,0,0,0,0,0,0,0,0,0,20000,0,0,0,20000,0,20000,20000
058436,聯發科統一9B購03,0,0,0,0,0,0,0,0,0,20000,0,0,0,20000,0,20000,20000
057177,奇力新元大99購04,0,0,0,0,0,0,0,0,0,20000,0,0,0,20000,0,20000,20000
057192,力成元大98購01  ,0,0,0,0,0,0,0,0,0,20000,0,0,0,20000,0,20000,20000
057686,中50凱基99購01  ,0,0,0,0,0,0,0,0,0,20000,0,0,0,20000,0,20000,20000
058509,聯發科元大99購12,0,0,0,0,0,0,0,0,0,20000,0,0,0,20000,0,20000,20000
058528,世紀鋼元大99購02,0,0,0,0,0,0,0,0,0,20000,0,0,0,20000,0,20000,20000
057732,牧德國泰9A購01  ,0,0,0,0,0,0,0,0,0,20000,0,0,0,20000,0,20000,20000
057733,嘉聯益國泰99購01,0,0,0,0,0,0,0,0,0,20000,0,0,0,73000,53000,20000,20000
057734,訊芯國泰9A購01  ,0,0,0,0,0,0,0,0,0,20000,0,0,0,20000,0,20000,20000
057741,超眾富邦98購01  ,0,0,0,0,0,0,0,0,0,20000,0,0,0,20000,0,20000,20000
06857P,超眾永豐98售02  ,0,0,0,0,0,0,0,0,0,19000,0,0,0,19000,0,19000,19000
06501P,臺股指元大9A售06,0,0,0,0,0,0,0,0,0,19000,0,0,0,28000,9000,19000,19000
059336,台灣50凱基9A購02,0,0,0,0,0,0,0,0,0,19000,0,0,0,20000,1000,19000,19000
4560,強信-KY         ,82000,63000,19000,0,0,0,0,0,0,0,0,0,0,0,0,0,19000
6152,百一            ,20000,1000,19000,0,0,0,0,0,0,0,0,0,0,0,0,0,19000
2852,第一保          ,22000,3000,19000,0,0,0,0,0,0,0,0,0,0,0,0,0,19000
2471,資通            ,35000,16000,19000,0,0,0,0,0,0,0,0,0,0,0,0,0,19000
07330P,台灣50群益9A售08,0,0,0,0,0,0,0,0,0,19000,0,0,0,20000,1000,19000,19000
1806,冠軍            ,23000,4000,19000,0,0,0,0,0,0,0,0,0,0,0,0,0,19000
058052,南電元大98購02  ,0,0,0,0,0,0,0,0,0,19000,0,0,0,19000,0,19000,19000
053773,上銀元大96購04  ,0,0,0,0,0,0,0,0,0,19000,0,0,0,19000,0,19000,19000
053916,漢唐國票97購04  ,0,0,0,0,0,0,0,0,0,19000,0,0,0,19000,0,19000,19000
051462,世芯國泰97購01  ,0,6000,-6000,0,0,0,0,0,0,25000,0,0,0,25000,0,25000,19000
054111,緯穎凱基97購01  ,0,0,0,0,0,0,0,0,0,19000,0,0,0,39000,20000,19000,19000
050135,禾伸堂兆豐95購01,0,0,0,0,0,0,0,0,0,19000,0,0,0,19000,0,19000,19000
050383,超眾兆豐95購01  ,0,0,0,0,0,0,0,0,0,19000,0,0,0,39000,20000,19000,19000
040760,T50反1凱基95購01,0,0,0,0,0,0,0,0,0,19000,0,0,0,19000,0,19000,19000
044639,京元電元富94購01,0,0,0,0,0,0,0,0,0,19000,0,0,0,19000,0,19000,19000
058477,億光凱基9A購01  ,0,0,0,0,0,0,0,0,0,19000,0,0,0,19000,0,19000,19000
057731,華擎國泰9A購02  ,0,0,0,0,0,0,0,0,0,19000,0,0,0,188000,169000,19000,19000
057224,和碩日盛9A購01  ,0,0,0,0,0,0,0,0,0,19000,0,0,0,19000,0,19000,19000
057536,康控元大99購03  ,0,0,0,0,0,0,0,0,0,19000,0,0,0,34000,15000,19000,19000
056776,聯茂元大99購01  ,0,0,0,0,0,0,0,0,0,19000,0,0,0,47000,28000,19000,19000
058849,奇力新群益99購02,0,0,0,0,0,0,0,0,0,19000,0,0,0,19000,0,19000,19000
054715,中橡康和97購01  ,0,0,0,0,0,0,0,0,0,19000,0,0,0,19000,0,19000,19000
058744,FBVIX凱基9C購03 ,0,0,0,0,0,0,0,0,0,19000,0,0,0,20000,1000,19000,19000
055012,茂林元富97購01  ,0,0,0,0,0,0,0,0,0,19000,0,0,0,19000,0,19000,19000
9927,泰銘            ,36000,17000,19000,0,0,0,0,0,0,0,0,0,0,0,0,0,19000
2308,台達電          ,5225980,5206887,19093,0,0,0,0,0,0,-1000,14000,9000,5000,8000,14000,-6000,18093
1533,車王電          ,20000,2000,18000,0,0,0,0,0,0,0,0,0,0,0,0,0,18000
1603,華電            ,33000,15000,18000,0,0,0,0,0,0,0,0,0,0,0,0,0,18000
07461P,臺股指元大9B售04,0,0,0,0,0,0,0,0,0,18000,0,0,0,18000,0,18000,18000
1410,南染            ,19000,1000,18000,0,0,0,0,0,0,0,0,0,0,0,0,0,18000
07102P,南電元大99售03  ,0,0,0,0,0,0,0,0,0,18000,0,0,0,76000,58000,18000,18000
2491,吉祥全          ,20000,2000,18000,0,0,0,0,0,0,0,0,0,0,0,0,0,18000
2642,宅配通          ,62000,44000,18000,0,0,0,0,0,0,0,0,0,0,0,0,0,18000
5525,順天            ,32000,14000,18000,0,0,0,0,0,0,0,0,0,0,0,0,0,18000
6477,安集            ,36000,9000,27000,0,0,0,0,0,0,-9000,0,9000,-9000,0,0,0,18000
059684,台灣50永豐99購09,0,0,0,0,0,0,0,0,0,18000,0,0,0,18000,0,18000,18000
06327P,台積電中信01售01,0,0,0,0,0,0,0,0,0,18000,0,0,0,18000,0,18000,18000
06682P,玉晶光元大99售08,0,0,0,0,0,0,0,0,0,18000,0,0,0,18000,0,18000,18000
00650L,FH香港正2       ,1000,0,1000,0,0,0,0,0,0,17000,0,0,0,165000,148000,17000,18000
048177,臺指反富邦99購01,0,0,0,0,0,0,0,0,0,18000,0,0,0,18000,0,18000,18000
04929P,同欣電凱基95售01,0,0,0,0,0,0,0,0,0,18000,0,0,0,18000,0,18000,18000
048785,台積電元大96購01,0,0,0,0,0,0,0,0,0,18000,0,0,0,18000,0,18000,18000
053043,嘉晶凱基96購01  ,0,0,0,0,0,0,0,0,0,18000,0,0,0,18000,0,18000,18000
052595,奇力新群益96購01,0,0,0,0,0,0,0,0,0,18000,0,0,0,18000,0,18000,18000
053477,大立光元大97購03,0,0,0,0,0,0,0,0,0,18000,0,0,0,18000,0,18000,18000
051601,群創兆豐95購02  ,0,0,0,0,0,0,0,0,0,18000,0,0,0,28000,10000,18000,18000
057946,晶相光國票99購01,0,0,0,0,0,0,0,0,0,18000,0,0,0,32000,14000,18000,18000
057962,超眾元大99購03  ,0,0,0,0,0,0,0,0,0,18000,0,0,0,20000,2000,18000,18000
054858,台肥群益97購01  ,0,0,0,0,0,0,0,0,0,18000,0,0,0,18000,0,18000,18000
055153,台光電元大98購02,0,0,0,0,0,0,0,0,0,18000,0,0,0,18000,0,18000,18000
055557,華新科凱基97購01,0,0,0,0,0,0,0,0,0,18000,0,0,0,70000,52000,18000,18000
058874,聯鈞國票9A購01  ,0,0,0,0,0,0,0,0,0,18000,0,0,0,51000,33000,18000,18000
058893,元油2X元大9C購10,0,0,0,0,0,0,0,0,0,18000,0,0,0,18000,0,18000,18000
055726,台表科元大98購03,0,0,0,0,0,0,0,0,0,18000,0,0,0,28000,10000,18000,18000
058476,旺宏凱基9A購01  ,0,0,0,0,0,0,0,0,0,18000,0,0,0,18000,0,18000,18000
059667,矽力元大99購01  ,0,0,0,0,0,0,0,0,0,17000,0,0,0,22000,5000,17000,17000
059548,台積電群益99購10,0,0,0,0,0,0,0,0,0,17000,0,0,0,17000,0,17000,17000
059576,臺股指凱基99購42,0,0,0,0,0,0,0,0,0,17000,0,0,0,32000,15000,17000,17000
6192,巨路            ,35000,18000,17000,0,0,0,0,0,0,0,0,0,0,0,0,0,17000
3060,銘異            ,64000,47000,17000,0,0,0,0,0,0,0,0,0,0,0,0,0,17000
2495,普安            ,27000,9000,18000,0,0,0,0,0,0,-1000,0,1000,-1000,0,0,0,17000
2365,昆盈            ,42000,25000,17000,0,0,0,0,0,0,0,0,0,0,0,0,0,17000
2358,廷鑫            ,24000,7000,17000,0,0,0,0,0,0,0,0,0,0,0,0,0,17000
1321,大洋            ,120000,103000,17000,0,0,0,0,0,0,0,0,0,0,0,0,0,17000
051666,旺宏元大96購05  ,0,0,0,0,0,0,0,0,0,17000,0,0,0,20000,3000,17000,17000
052321,華擎元大95購01  ,0,0,0,0,0,0,0,0,0,17000,0,0,0,17000,0,17000,17000
05253P,智邦凱基95售08  ,0,0,0,0,0,0,0,0,0,17000,0,0,0,17000,0,17000,17000
051577,台積電元大97購03,0,0,0,0,0,0,0,0,0,17000,0,0,0,17000,0,17000,17000
05421P,鴻海元大96售12  ,0,0,0,0,0,0,0,0,0,17000,0,0,0,17000,0,17000,17000
036630,玉山金台新99購01,0,0,0,0,0,0,0,0,0,17000,0,0,0,17000,0,17000,17000
054579,聯茂元大97購01  ,0,0,0,0,0,0,0,0,0,17000,0,0,0,52000,35000,17000,17000
058802,矽創元大99購02  ,0,0,0,0,0,0,0,0,0,17000,0,0,0,41000,24000,17000,17000
059178,臺股指凱基99購30,0,0,0,0,0,0,0,0,0,17000,0,0,0,60000,43000,17000,17000
059144,嘉晶國票9A購02  ,0,0,0,0,0,0,0,0,0,17000,0,0,0,18000,1000,17000,17000
059267,群創中信01購02  ,0,0,0,0,0,0,0,0,0,17000,0,0,0,18000,1000,17000,17000
058960,臺股指國票99購05,0,0,0,0,0,0,0,0,0,17000,0,0,0,17000,0,17000,17000
056509,晶相光永豐98購01,0,0,0,0,0,0,0,0,0,17000,0,0,0,82000,65000,17000,17000
055098,臺股指群益97購01,0,0,0,0,0,0,0,0,0,17000,0,0,0,17000,0,17000,17000
058553,合勤控永豐99購01,0,0,0,0,0,0,0,0,0,17000,0,0,0,20000,3000,17000,17000
6605,帝寶            ,32000,38000,-6000,0,0,0,0,0,0,23000,23000,0,23000,0,0,0,17000
07057P,大立光康和9B售02,0,0,0,0,0,0,0,0,0,16000,0,0,0,406000,390000,16000,16000
07307P,上証2X凱基9A售02,0,0,0,0,0,0,0,0,0,16000,0,0,0,16000,0,16000,16000
2882B,國泰金乙特      ,0,0,0,0,0,0,0,0,0,16000,16000,0,16000,0,0,0,16000
05941P,聯發科凱基96售22,0,0,0,0,0,0,0,0,0,16000,0,0,0,21000,5000,16000,16000
06928P,鴻海元大99售10  ,0,0,0,0,0,0,0,0,0,16000,0,0,0,16000,0,16000,16000
052741,聯發科元大96購08,0,0,0,0,0,0,0,0,0,16000,0,0,0,16000,0,16000,16000
050603,致新國泰96購01  ,0,0,0,0,0,0,0,0,0,16000,0,0,0,16000,0,16000,16000
053134,南亞科國票97購01,0,0,0,0,0,0,0,0,0,16000,0,0,0,16000,0,16000,16000
053175,矽力群益96購01  ,0,0,0,0,0,0,0,0,0,16000,0,0,0,16000,0,16000,16000
05192P,玉晶光台新96售02,0,0,0,0,0,0,0,0,0,16000,0,0,0,31000,15000,16000,16000
051931,美律國票96購02  ,0,0,0,0,0,0,0,0,0,16000,0,0,0,16000,0,16000,16000
051792,泰鼎國票96購02  ,0,0,0,0,0,0,0,0,0,16000,0,0,0,16000,0,16000,16000
053383,京元電元大97購01,0,0,0,0,0,0,0,0,0,16000,0,0,0,16000,0,16000,16000
053970,聯發科元大97購08,0,0,0,0,0,0,0,0,0,16000,0,0,0,28000,12000,16000,16000
057968,可成國泰9A購01  ,0,0,0,0,0,0,0,0,0,16000,0,0,0,16000,0,16000,16000
057824,日月光元大98購01,0,0,0,0,0,0,0,0,0,16000,0,0,0,30000,14000,16000,16000
058638,矽力兆豐99購01  ,0,0,0,0,0,0,0,0,0,16000,0,0,0,16000,0,16000,16000
055440,矽力國票98購01  ,0,0,0,0,0,0,0,0,0,16000,0,0,0,16000,0,16000,16000
058077,超眾凱基98購02  ,0,0,0,0,0,0,0,0,0,16000,0,0,0,68000,52000,16000,16000
057376,新日興元大98購04,0,0,0,0,0,0,0,0,0,16000,0,0,0,16000,0,16000,16000
055271,鴻海元大98購03  ,0,0,0,0,0,0,0,0,0,16000,0,0,0,16000,0,16000,16000
054840,T50反1兆豐98購01,0,0,0,0,0,0,0,0,0,16000,0,0,0,16000,0,16000,16000
055586,旺宏元大98購06  ,0,0,0,0,0,0,0,0,0,16000,0,0,0,65000,49000,16000,16000
056213,建準國票98購02  ,0,0,0,0,0,0,0,0,0,16000,0,0,0,18000,2000,16000,16000
059007,南電元大99購05  ,0,0,0,0,0,0,0,0,0,16000,0,0,0,36000,20000,16000,16000
059258,台灣50群益99購01,0,0,0,0,0,0,0,0,0,16000,0,0,0,17000,1000,16000,16000
058932,FBVIX台新99購01 ,0,0,0,0,0,0,0,0,0,16000,0,0,0,45000,29000,16000,16000
054565,玉晶光群益99購02,0,0,0,0,0,0,0,0,0,16000,0,0,0,16000,0,16000,16000
055861,矽力元大97購03  ,0,0,0,0,0,0,0,0,0,16000,0,0,0,16000,0,16000,16000
056980,建準群益98購02  ,0,0,0,0,0,0,0,0,0,16000,0,0,0,16000,0,16000,16000
057118,欣興日盛9A購01  ,0,0,0,0,0,0,0,0,0,16000,0,0,0,16000,0,16000,16000
8021,尖點            ,146000,129000,17000,0,0,0,0,0,0,-1000,0,1000,-1000,0,0,0,16000
8473,山林水          ,16000,5000,11000,0,0,0,0,0,0,5000,5000,0,5000,0,0,0,16000
9908,大台北          ,16000,35000,-19000,0,0,0,0,0,0,35000,35000,0,35000,0,0,0,16000
06860P,台灣50兆豐98售01,0,0,0,0,0,0,0,0,0,15000,0,0,0,25000,10000,15000,15000
06657P,寶成元大98售01  ,0,0,0,0,0,0,0,0,0,15000,0,0,0,31000,16000,15000,15000
060107,旭富元大99購03  ,0,0,0,0,0,0,0,0,0,15000,0,0,0,134000,119000,15000,15000
060040,康控國票99購04  ,0,0,0,0,0,0,0,0,0,15000,0,0,0,15000,0,15000,15000
059417,上証反元大9C購01,0,0,0,0,0,0,0,0,0,15000,0,0,0,15000,0,15000,15000
059575,臺股指凱基99購41,0,0,0,0,0,0,0,0,0,15000,0,0,0,75000,60000,15000,15000
059608,聯發科富邦9B購04,0,0,0,0,0,0,0,0,0,15000,0,0,0,15000,0,15000,15000
059485,台灣50兆豐99購02,0,0,0,0,0,0,0,0,0,15000,0,0,0,29000,14000,15000,15000
059688,燿華永豐99購01  ,0,0,0,0,0,0,0,0,0,15000,0,0,0,100000,85000,15000,15000
059718,國巨元大9A購04  ,0,0,0,0,0,0,0,0,0,15000,0,0,0,27000,12000,15000,15000
059719,台積電元大99購42,0,0,0,0,0,0,0,0,0,15000,0,0,0,15000,0,15000,15000
3094,聯傑            ,21000,6000,15000,0,0,0,0,0,0,0,0,0,0,0,0,0,15000
2430,燦坤            ,18000,3000,15000,0,0,0,0,0,0,0,0,0,0,0,0,0,15000
5007,三星            ,18000,3000,15000,0,0,0,0,0,0,0,0,0,0,0,0,0,15000
3419,譁裕            ,54000,42000,12000,0,0,0,0,0,0,3000,3000,0,3000,0,0,0,15000
07379P,大立光元大99售30,0,0,0,0,0,0,0,0,0,15000,0,0,0,15000,0,15000,15000
07001P,國巨元大99售12  ,0,0,0,0,0,0,0,0,0,15000,0,0,0,295000,280000,15000,15000
08218P,滬深2X凱基96售01,0,0,0,0,0,0,0,0,0,15000,0,0,0,15000,0,15000,15000
057827,康友元大98購03  ,0,0,0,0,0,0,0,0,0,15000,0,0,0,36000,21000,15000,15000
058377,茂林凱基9A購03  ,0,0,0,0,0,0,0,0,0,15000,0,0,0,15000,0,15000,15000
058174,台積電凱基9A購05,0,0,0,0,0,0,0,0,0,15000,0,0,0,15000,0,15000,15000
053503,臻鼎兆豐97購01  ,0,0,0,0,0,0,0,0,0,15000,0,0,0,15000,0,15000,15000
057891,華新科統一9A購01,0,0,0,0,0,0,0,0,0,15000,0,0,0,15000,0,15000,15000
053798,台積電中信98購02,0,0,0,0,0,0,0,0,0,15000,0,0,0,15000,0,15000,15000
053279,景碩元大97購01  ,0,0,0,0,0,0,0,0,0,15000,0,0,0,15000,0,15000,15000
052362,瑞昱國票96購02  ,0,0,0,0,0,0,0,0,0,15000,0,0,0,15000,0,15000,15000
05444P,大立光元大95售10,0,0,0,0,0,0,0,0,0,15000,0,0,0,22000,7000,15000,15000
053513,義隆群益96購05  ,0,0,0,0,0,0,0,0,0,15000,0,0,0,37000,22000,15000,15000
052967,智邦群益96購01  ,0,0,0,0,0,0,0,0,0,15000,0,0,0,15000,0,15000,15000
053061,GIS富邦97購01   ,0,0,0,0,0,0,0,0,0,15000,0,0,0,15000,0,15000,15000
052216,康友元大96購01  ,0,0,0,0,0,0,0,0,0,15000,0,0,0,15000,0,15000,15000
052173,廣達元大95購02  ,0,0,0,0,0,0,0,0,0,15000,0,0,0,15000,0,15000,15000
054317,昇陽半凱基98購01,0,0,0,0,0,0,0,0,0,15000,0,0,0,15000,0,15000,15000
050522,聯發科元大95購03,0,0,0,0,0,0,0,0,0,15000,0,0,0,20000,5000,15000,15000
048346,智易元大95購01  ,0,0,0,0,0,0,0,0,0,15000,0,0,0,15000,0,15000,15000
050155,華新科群益95購01,0,0,0,0,0,0,0,0,0,15000,0,0,0,15000,0,15000,15000
050192,康控元大97購01  ,0,0,0,0,0,0,0,0,0,15000,0,0,0,15000,0,15000,15000
049670,鈺齊國泰96購01  ,0,0,0,0,0,0,0,0,0,15000,0,0,0,15000,0,15000,15000
052709,光寶科日盛96購01,0,0,0,0,0,0,0,0,0,15000,0,0,0,15000,0,15000,15000
054005,旺宏統一97購04  ,0,0,0,0,0,0,0,0,0,15000,0,0,0,15000,0,15000,15000
048385,亞德客國票94購01,0,0,0,0,0,0,0,0,0,15000,0,0,0,15000,0,15000,15000
052844,台積電統一96購02,0,0,0,0,0,0,0,0,0,15000,0,0,0,15000,0,15000,15000
052917,大立光富邦99購02,0,0,0,0,0,0,0,0,0,15000,0,0,0,15000,0,15000,15000
051242,台積電元大96購06,0,0,0,0,0,0,0,0,0,15000,0,0,0,15000,0,15000,15000
050887,台積電富邦95購05,0,0,0,0,0,0,0,0,0,15000,0,0,0,15000,0,15000,15000
050914,健鼎中信95購01  ,0,0,0,0,0,0,0,0,0,15000,0,0,0,15000,0,15000,15000
00680L,元大美債20正2   ,1000,0,1000,0,0,0,0,0,0,14000,0,0,0,30000,16000,14000,15000
04604P,華新科國票95售01,0,0,0,0,0,0,0,0,0,15000,0,0,0,146000,131000,15000,15000
047903,滬深2X元大96購01,0,0,0,0,0,0,0,0,0,15000,0,0,0,15000,0,15000,15000
047470,聯發科中信94購03,0,0,0,0,0,0,0,0,0,15000,0,0,0,15000,0,15000,15000
047420,全新富邦97購01  ,0,0,0,0,0,0,0,0,0,15000,0,0,0,15000,0,15000,15000
057094,祥碩元富98購01  ,0,0,0,0,0,0,0,0,0,15000,0,0,0,15000,0,15000,15000
057597,華通群益9A購02  ,0,0,0,0,0,0,0,0,0,15000,0,0,0,15000,0,15000,15000
055852,聯鈞元大98購01  ,0,0,0,0,0,0,0,0,0,15000,0,0,0,15000,0,15000,15000
055801,景碩永豐97購02  ,0,0,0,0,0,0,0,0,0,15000,0,0,0,30000,15000,15000,15000
055650,華新科元富98購01,0,0,0,0,0,0,0,0,0,15000,0,0,0,15000,0,15000,15000
057640,台積電元大98購16,0,0,0,0,0,0,0,0,0,15000,0,0,0,15000,0,15000,15000
054630,聯鈞凱基98購01  ,0,0,0,0,0,0,0,0,0,15000,0,0,0,15000,0,15000,15000
056048,同欣電兆豐97購01,0,0,0,0,0,0,0,0,0,15000,0,0,0,15000,0,15000,15000
056049,奇力新國票98購01,0,0,0,0,0,0,0,0,0,15000,0,0,0,15000,0,15000,15000
055994,聯發科國泰99購02,0,0,0,0,0,0,0,0,0,15000,0,0,0,15000,0,15000,15000
055144,T50反1元大97購03,0,0,0,0,0,0,0,0,0,15000,0,0,0,15000,0,15000,15000
054756,世紀鋼凱基99購01,0,0,0,0,0,0,0,0,0,15000,0,0,0,15000,0,15000,15000
054855,得力群益98購01  ,0,0,0,0,0,0,0,0,0,15000,0,0,0,15000,0,15000,15000
054896,聯茂日盛97購01  ,0,0,0,0,0,0,0,0,0,15000,0,0,0,15000,0,15000,15000
056381,台虹元富98購01  ,0,0,0,0,0,0,0,0,0,15000,0,0,0,15000,0,15000,15000
058254,臺股指元大9A購18,0,0,0,0,0,0,0,0,0,15000,0,0,0,15000,0,15000,15000
058075,貿聯凱基99購02  ,0,0,0,0,0,0,0,0,0,15000,0,0,0,15000,0,15000,15000
055371,正崴元大97購02  ,0,0,0,0,0,0,0,0,0,15000,0,0,0,15000,0,15000,15000
055501,創意元大97購01  ,0,0,0,0,0,0,0,0,0,15000,0,0,0,41000,26000,15000,15000
056420,台表科元富98購01,0,0,0,0,0,0,0,0,0,15000,0,0,0,15000,0,15000,15000
058591,台灣50統一9B購02,0,0,0,0,0,0,0,0,0,15000,0,0,0,15000,0,15000,15000
057458,TPK富邦9A購01   ,0,0,0,0,0,0,0,0,0,15000,0,0,0,15000,0,15000,15000
2017,官田鋼          ,14000,0,14000,0,0,0,0,0,0,0,0,0,0,0,0,0,14000
07368P,國巨凱基99售19  ,0,0,0,0,0,0,0,0,0,14000,0,0,0,438000,424000,14000,14000
07377P,聯發科元大99售40,0,0,0,0,0,0,0,0,0,14000,0,0,0,14000,0,14000,14000
3057,喬鼎            ,23000,9000,14000,0,0,0,0,0,0,0,0,0,0,0,0,0,14000
059862,全新群益99購04  ,0,0,0,0,0,0,0,0,0,14000,0,0,0,91000,77000,14000,14000
05956P,漢唐國票96售02  ,0,0,0,0,0,0,0,0,0,14000,0,0,0,14000,0,14000,14000
06000P,GIS元大96售04   ,0,0,0,0,0,0,0,0,0,14000,0,0,0,14000,0,14000,14000
06010P,國泰金元富96售01,0,0,0,0,0,0,0,0,0,14000,0,0,0,14000,0,14000,14000
06655P,TPK元大98售02   ,0,0,0,0,0,0,0,0,0,14000,0,0,0,85000,71000,14000,14000
06509P,鴻海群益98售03  ,0,0,0,0,0,0,0,0,0,14000,0,0,0,14000,0,14000,14000
04759P,台積電凱基94售27,0,0,0,0,0,0,0,0,0,14000,0,0,0,14000,0,14000,14000
048007,明基材元大96購01,0,0,0,0,0,0,0,0,0,14000,0,0,0,14000,0,14000,14000
03094X,大立光元大68展08,0,0,0,0,0,0,0,0,0,14000,0,0,0,14000,0,14000,14000
052854,聯詠日盛96購01  ,0,0,0,0,0,0,0,0,0,14000,0,0,0,14000,0,14000,14000
052962,台積電凱基97購03,0,0,0,0,0,0,0,0,0,14000,0,0,0,14000,0,14000,14000
054133,奇力新元大97購04,0,0,0,0,0,0,0,0,0,14000,0,0,0,14000,0,14000,14000
04953P,台積電群益94售13,0,0,0,0,0,0,0,0,0,14000,0,0,0,14000,0,14000,14000
053137,旺宏富邦98購01  ,0,0,0,0,0,0,0,0,0,14000,0,0,0,14000,0,14000,14000
051731,聯電國票96購02  ,0,0,0,0,0,0,0,0,0,14000,0,0,0,22000,8000,14000,14000
053755,亞光元富96購01  ,0,0,0,0,0,0,0,0,0,14000,0,0,0,14000,0,14000,14000
058376,貿聯凱基9A購01  ,0,0,0,0,0,0,0,0,0,14000,0,0,0,14000,0,14000,14000
058400,聯發科元大99購09,0,0,0,0,0,0,0,0,0,14000,0,0,0,31000,17000,14000,14000
058248,聯茂元大99購05  ,0,0,0,0,0,0,0,0,0,14000,0,0,0,17000,3000,14000,14000
058718,台灣50元富03購01,0,0,0,0,0,0,0,0,0,14000,0,0,0,14000,0,14000,14000
055159,玉晶光元大98購05,0,0,0,0,0,0,0,0,0,14000,0,0,0,14000,0,14000,14000
055901,超眾中信97購01  ,0,0,0,0,0,0,0,0,0,14000,0,0,0,14000,0,14000,14000
054697,凌華永豐97購01  ,0,0,0,0,0,0,0,0,0,14000,0,0,0,24000,10000,14000,14000
054530,台光電國泰97購03,0,0,0,0,0,0,0,0,0,14000,0,0,0,14000,0,14000,14000
059145,創意國票99購02  ,0,0,0,0,0,0,0,0,0,14000,0,0,0,14000,0,14000,14000
059064,緯穎凱基99購02  ,0,0,0,0,0,0,0,0,0,14000,0,0,0,74000,60000,14000,14000
057185,群創元大98購06  ,0,0,0,0,0,0,0,0,0,14000,0,0,0,14000,0,14000,14000
057320,玉晶光凱基98購01,0,0,0,0,0,0,0,0,0,14000,0,0,0,161000,147000,14000,14000
05580P,美律凱基96售03  ,0,0,0,0,0,0,0,0,0,14000,0,0,0,14000,0,14000,14000
055830,上銀元大97購07  ,0,0,0,0,0,0,0,0,0,14000,0,0,0,94000,80000,14000,14000
05710P,禾伸堂國票97售02,0,0,0,0,0,0,0,0,0,14000,0,0,0,14000,0,14000,14000
2888,新光金          ,12931422,13186342,-254920,0,0,0,0,0,0,268000,0,0,0,368000,100000,268000,13080
2704,國賓            ,23000,10000,13000,0,0,0,0,0,0,0,0,0,0,0,0,0,13000
3591,艾笛森          ,13000,0,13000,0,0,0,0,0,0,0,0,0,0,0,0,0,13000
3583,辛耘            ,96000,83000,13000,0,0,0,0,0,0,0,0,0,0,0,0,0,13000
4916,事欣科          ,40000,27000,13000,0,0,0,0,0,0,0,0,0,0,0,0,0,13000
4737,華廣            ,15000,2000,13000,0,0,0,0,0,0,0,0,0,0,0,0,0,13000
07374P,鴻海元大99售41  ,0,0,0,0,0,0,0,0,0,13000,0,0,0,13000,0,13000,13000
07271P,台灣50元大9C售04,0,0,0,0,0,0,0,0,0,13000,0,0,0,13000,0,13000,13000
07012P,智邦群益9A售01  ,0,0,0,0,0,0,0,0,0,13000,0,0,0,13000,0,13000,13000
07128P,大毅元大99售04  ,0,0,0,0,0,0,0,0,0,13000,0,0,0,37000,24000,13000,13000
07231P,台灣50元大01售06,0,0,0,0,0,0,0,0,0,13000,0,0,0,14000,1000,13000,13000
07163P,臺股指群益99售14,0,0,0,0,0,0,0,0,0,13000,0,0,0,39000,26000,13000,13000
2029,盛餘            ,17000,4000,13000,0,0,0,0,0,0,0,0,0,0,0,0,0,13000
06185P,台表科元大97售05,0,0,0,0,0,0,0,0,0,13000,0,0,0,28000,15000,13000,13000
059634,可成凱基99購07  ,0,0,0,0,0,0,0,0,0,13000,0,0,0,35000,22000,13000,13000
059901,滬深2X元大9C購07,0,0,0,0,0,0,0,0,0,13000,0,0,0,14000,1000,13000,13000
053653,京元電凱基96購02,0,0,0,0,0,0,0,0,0,13000,0,0,0,50000,37000,13000,13000
053562,玉晶光國泰98購02,0,0,0,0,0,0,0,0,0,13000,0,0,0,13000,0,13000,13000
054262,瀚宇博元大96購03,0,0,0,0,0,0,0,0,0,13000,0,0,0,13000,0,13000,13000
048433,聯詠國票94購01  ,0,0,0,0,0,0,0,0,0,13000,0,0,0,40000,27000,13000,13000
03430B,臺股指元大9B熊01,0,0,0,0,0,0,0,0,0,13000,0,0,0,13000,0,13000,13000
058458,牧德永豐9A購01  ,0,0,0,0,0,0,0,0,0,13000,0,0,0,13000,0,13000,13000
058916,SGBR2X元富99購02,0,0,0,0,0,0,0,0,0,13000,0,0,0,17000,4000,13000,13000
055579,健策統一9A購01  ,0,0,0,0,0,0,0,0,0,13000,0,0,0,13000,0,13000,13000
05527P,聯茂群益96售01  ,0,0,0,0,0,0,0,0,0,13000,0,0,0,18000,5000,13000,13000
054961,玉晶光元大99購01,0,0,0,0,0,0,0,0,0,13000,0,0,0,13000,0,13000,13000
058139,臻鼎元大99購01  ,0,0,0,0,0,0,0,0,0,13000,0,0,0,16000,3000,13000,13000
057477,智邦元大98購09  ,0,0,0,0,0,0,0,0,0,13000,0,0,0,23000,10000,13000,13000
056408,奇鋐國票99購01  ,0,0,0,0,0,0,0,0,0,13000,0,0,0,24000,11000,13000,13000
056455,群創凱基9A購01  ,0,0,0,0,0,0,0,0,0,13000,0,0,0,13000,0,13000,13000
057433,上銀國票98購04  ,0,0,0,0,0,0,0,0,0,13000,0,0,0,18000,5000,13000,13000
059491,國巨國票9A購05  ,0,0,0,0,0,0,0,0,0,12000,0,0,0,73000,61000,12000,12000
059467,旺宏元大99購15  ,0,0,0,0,0,0,0,0,0,12000,0,0,0,55000,43000,12000,12000
059342,聯發科凱基9A購05,0,0,0,0,0,0,0,0,0,12000,0,0,0,12000,0,12000,12000
07480P,FBVIX凱基94售01 ,0,0,0,0,0,0,0,0,0,12000,0,0,0,12000,0,12000,12000
07209P,台積電凱基9A售10,0,0,0,0,0,0,0,0,0,12000,0,0,0,12000,0,12000,12000
07325P,台積電元大99售41,0,0,0,0,0,0,0,0,0,12000,0,0,0,765000,753000,12000,12000
03039X,元展36          ,0,0,0,0,0,0,0,0,0,12000,0,0,0,26000,14000,12000,12000
04479P,同欣電中信96售02,0,0,0,0,0,0,0,0,0,12000,0,0,0,14000,2000,12000,12000
051013,旺宏凱基95購03  ,0,0,0,0,0,0,0,0,0,12000,0,0,0,12000,0,12000,12000
04634P,臺股指群益94售09,0,0,0,0,0,0,0,0,0,12000,0,0,0,14000,2000,12000,12000
049527,國巨中信95購01  ,0,0,0,0,0,0,0,0,0,12000,0,0,0,12000,0,12000,12000
050613,台光電元大94購09,0,0,0,0,0,0,0,0,0,12000,0,0,0,12000,0,12000,12000
04994P,大成鋼凱基95售01,0,0,0,0,0,0,0,0,0,12000,0,0,0,12000,0,12000,12000
049973,T50反1日盛9A購01,0,0,0,0,0,0,0,0,0,12000,0,0,0,12000,0,12000,12000
051484,玉晶光凱基97購01,0,0,0,0,0,0,0,0,0,12000,0,0,0,12000,0,12000,12000
052983,國巨元大96購07  ,0,0,0,0,0,0,0,0,0,12000,0,0,0,12000,0,12000,12000
052088,漢唐元大95購02  ,0,0,0,0,0,0,0,0,0,12000,0,0,0,52000,40000,12000,12000
053602,台虹元大96購01  ,0,0,0,0,0,0,0,0,0,12000,0,0,0,12000,0,12000,12000
053534,微星永豐96購02  ,0,0,0,0,0,0,0,0,0,12000,0,0,0,20000,8000,12000,12000
053391,嘉聯益元大99購01,0,0,0,0,0,0,0,0,0,12000,0,0,0,12000,0,12000,12000
057835,華擎元富9B購01  ,0,0,0,0,0,0,0,0,0,12000,0,0,0,538000,526000,12000,12000
058196,台塑中信99購01  ,0,0,0,0,0,0,0,0,0,12000,0,0,0,12000,0,12000,12000
058709,臺股指元大9A購22,0,0,0,0,0,0,0,0,0,12000,0,0,0,12000,0,12000,12000
055330,上銀兆豐98購02  ,0,0,0,0,0,0,0,0,0,12000,0,0,0,13000,1000,12000,12000
057757,鴻海凱基98購13  ,0,0,0,0,0,0,0,0,0,12000,0,0,0,44000,32000,12000,12000
058743,可成康和99購01  ,0,0,0,0,0,0,0,0,0,12000,0,0,0,80000,68000,12000,12000
054738,聯發科凱基97購01,0,0,0,0,0,0,0,0,0,12000,0,0,0,26000,14000,12000,12000
056720,世紀鋼永豐98購01,0,0,0,0,0,0,0,0,0,12000,0,0,0,92000,80000,12000,12000
059187,國巨富邦9B購02  ,0,0,0,0,0,0,0,0,0,12000,0,0,0,24000,12000,12000,12000
057672,茂林元大98購02  ,0,0,0,0,0,0,0,0,0,12000,0,0,0,12000,0,12000,12000
058498,世紀鋼群益99購01,0,0,0,0,0,0,0,0,0,12000,0,0,0,12000,0,12000,12000
057062,立積國泰99購01  ,0,0,0,0,0,0,0,0,0,12000,0,0,0,412000,400000,12000,12000
8463,潤泰材          ,37000,25000,12000,0,0,0,0,0,0,0,0,0,0,0,0,0,12000
8103,瀚荃            ,13000,1000,12000,0,0,0,0,0,0,0,0,0,0,0,0,0,12000
07075P,FBVIX凱基9C售04 ,0,0,0,0,0,0,0,0,0,11000,0,0,0,11000,0,11000,11000
2009,第一銅          ,23000,12000,11000,0,0,0,0,0,0,0,0,0,0,0,0,0,11000
1618,合機            ,29000,18000,11000,0,0,0,0,0,0,0,0,0,0,0,0,0,11000
4557,永新-KY         ,11000,0,11000,0,0,0,0,0,0,0,0,0,0,0,0,0,11000
3305,昇貿            ,38000,27000,11000,0,0,0,0,0,0,0,0,0,0,0,0,0,11000
2881B,富邦金乙特      ,0,0,0,0,0,0,0,0,0,11000,11000,0,11000,0,0,0,11000
059332,台灣50國票9A購07,0,0,0,0,0,0,0,0,0,11000,0,0,0,11000,0,11000,11000
059298,大立光元富9C購02,0,0,0,0,0,0,0,0,0,11000,0,0,0,16000,5000,11000,11000
059594,奇力新元大9B購01,0,0,0,0,0,0,0,0,0,11000,0,0,0,56000,45000,11000,11000
059604,臺股指元大9A購41,0,0,0,0,0,0,0,0,0,11000,0,0,0,11000,0,11000,11000
059966,台積電凱基99購19,0,0,0,0,0,0,0,0,0,11000,0,0,0,21000,10000,11000,11000
059972,S&P正2元大99購03,0,0,0,0,0,0,0,0,0,11000,0,0,0,11000,0,11000,11000
060131,GIS永豐99購03   ,0,0,0,0,0,0,0,0,0,11000,0,0,0,65000,54000,11000,11000
056292,統一元大97購01  ,0,0,0,0,0,0,0,0,0,11000,0,0,0,11000,0,11000,11000
057870,大立光凱基99購02,0,0,0,0,0,0,0,0,0,11000,0,0,0,21000,10000,11000,11000
053184,世紀鋼元富96購01,0,0,0,0,0,0,0,0,0,11000,0,0,0,16000,5000,11000,11000
05238P,禾伸堂永豐95售01,0,0,0,0,0,0,0,0,0,11000,0,0,0,11000,0,11000,11000
052516,臺股指凱基95購20,11000,0,11000,0,0,0,0,0,0,0,0,0,0,0,0,0,11000
052282,宏達電凱基95購05,0,0,0,0,0,0,0,0,0,11000,0,0,0,16000,5000,11000,11000
052005,矽力國泰97購02  ,0,0,0,0,0,0,0,0,0,11000,0,0,0,11000,0,11000,11000
053035,台表科兆豐97購01,0,0,0,0,0,0,0,0,0,11000,0,0,0,11000,0,11000,11000
053032,國巨兆豐97購02  ,0,0,0,0,0,0,0,0,0,11000,0,0,0,11000,0,11000,11000
050099,台積電永昌96購01,0,0,0,0,0,0,0,0,0,11000,0,0,0,11000,0,11000,11000
049589,奇力新元大95購02,0,0,0,0,0,0,0,0,0,11000,0,0,0,11000,0,11000,11000
049630,臺股指群益94購03,0,0,0,0,0,0,0,0,0,11000,0,0,0,21000,10000,11000,11000
049434,茂林國票95購01  ,0,0,0,0,0,0,0,0,0,11000,0,0,0,11000,0,11000,11000
048905,旺宏富邦96購01  ,0,0,0,0,0,0,0,0,0,11000,0,0,0,11000,0,11000,11000
054106,元油反凱基9C購01,0,0,0,0,0,0,0,0,0,11000,0,0,0,11000,0,11000,11000
045443,群創元富98購01  ,0,0,0,0,0,0,0,0,0,11000,0,0,0,11000,0,11000,11000
04770P,鴻海元大94售09  ,0,0,0,0,0,0,0,0,0,11000,0,0,0,11000,0,11000,11000
036628,統一台新99購01  ,0,0,0,0,0,0,0,0,0,11000,0,0,0,11000,0,11000,11000
056659,泰碩元大99購01  ,0,0,0,0,0,0,0,0,0,11000,0,0,0,11000,0,11000,11000
056620,華新科永豐98購02,0,0,0,0,0,0,0,0,0,11000,0,0,0,11000,0,11000,11000
057253,高股息中信99購02,0,0,0,0,0,0,0,0,0,11000,0,0,0,11000,0,11000,11000
059263,瑞昱中信01購01  ,0,0,0,0,0,0,0,0,0,11000,0,0,0,65000,54000,11000,11000
055727,矽力元大97購02  ,0,0,0,0,0,0,0,0,0,11000,0,0,0,15000,4000,11000,11000
054534,台積電富邦98購03,0,0,0,0,0,0,0,0,0,11000,0,0,0,11000,0,11000,11000
055679,華通凱基99購01  ,0,0,0,0,0,0,0,0,0,11000,0,0,0,11000,0,11000,11000
054805,台苯元大9A購01  ,0,0,0,0,0,0,0,0,0,11000,0,0,0,11000,0,11000,11000
054929,群電凱基97購01  ,0,0,0,0,0,0,0,0,0,11000,0,0,0,71000,60000,11000,11000
055645,技嘉元富97購01  ,0,0,0,0,0,0,0,0,0,11000,0,0,0,11000,0,11000,11000
057819,新日興元大99購01,0,0,0,0,0,0,0,0,0,11000,0,0,0,22000,11000,11000,11000
055341,台達電凱基97購02,0,0,0,0,0,0,0,0,0,11000,0,0,0,11000,0,11000,11000
056412,上証2X中信9A購02,0,0,0,0,0,0,0,0,0,11000,0,0,0,11000,0,11000,11000
060167,禾聯碩永豐9A購01,0,0,0,0,0,0,0,0,0,10000,0,0,0,40000,30000,10000,10000
06207P,聯發科凱基97售07,0,0,0,0,0,0,0,0,0,10000,0,0,0,10000,0,10000,10000
06128P,玉晶光元富97售05,0,0,0,0,0,0,0,0,0,10000,0,0,0,14000,4000,10000,10000
06147P,國巨元大97售05  ,0,0,0,0,0,0,0,0,0,10000,0,0,0,10000,0,10000,10000
06046P,健策統一96售03  ,0,0,0,0,0,0,0,0,0,10000,0,0,0,10000,0,10000,10000
06548P,大立光元大98售10,0,0,0,0,0,0,0,0,0,10000,0,0,0,10000,0,10000,10000
06576P,台光電群益98售03,0,0,0,0,0,0,0,0,0,10000,0,0,0,10000,0,10000,10000
06392P,T50反1元大9A售01,0,0,0,0,0,0,0,0,0,10000,0,0,0,10000,0,10000,10000
06418P,T50反1統一9A售02,0,0,0,0,0,0,0,0,0,10000,0,0,0,10000,0,10000,10000
06649P,聯發科元大98售08,0,0,0,0,0,0,0,0,0,10000,0,0,0,10000,0,10000,10000
06646P,國巨元大98售16  ,0,0,0,0,0,0,0,0,0,10000,0,0,0,90000,80000,10000,10000
06673P,大立光群益98售01,0,0,0,0,0,0,0,0,0,10000,0,0,0,10000,0,10000,10000
06759P,台積電元大98售17,0,0,0,0,0,0,0,0,0,10000,0,0,0,10000,0,10000,10000
06761P,台積電元大99售05,0,0,0,0,0,0,0,0,0,10000,0,0,0,10000,0,10000,10000
06894P,鈺齊元富98售03  ,0,0,0,0,0,0,0,0,0,10000,0,0,0,10000,0,10000,10000
06933P,禾伸堂元大98售03,0,0,0,0,0,0,0,0,0,10000,0,0,0,10000,0,10000,10000
06935P,神達元大98售02  ,0,0,0,0,0,0,0,0,0,10000,0,0,0,10000,0,10000,10000
06962P,華新科永豐99售01,0,0,0,0,0,0,0,0,0,10000,0,0,0,10000,0,10000,10000
06993P,鴻海凱基99售05  ,0,0,0,0,0,0,0,0,0,10000,0,0,0,10000,0,10000,10000
059890,大立光國票99購03,0,0,0,0,0,0,0,0,0,10000,0,0,0,10000,0,10000,10000
059670,T50正2元富99購04,0,0,0,0,0,0,0,0,0,10000,0,0,0,10000,0,10000,10000
059790,立積元大9C購02  ,0,0,0,0,0,0,0,0,0,10000,0,0,0,10000,0,10000,10000
059638,大立光凱基99購11,0,0,0,0,0,0,0,0,0,10000,0,0,0,10000,0,10000,10000
059615,台灣50群益99購05,0,0,0,0,0,0,0,0,0,10000,0,0,0,10000,0,10000,10000
059484,臺股指群益99購18,0,0,0,0,0,0,0,0,0,10000,0,0,0,10000,0,10000,10000
059502,台灣50台新9B購04,0,0,0,0,0,0,0,0,0,10000,0,0,0,10000,0,10000,10000
059543,可成亞東99購02  ,0,0,0,0,0,0,0,0,0,10000,0,0,0,10000,0,10000,10000
059550,台灣50日盛99購02,0,0,0,0,0,0,0,0,0,10000,0,0,0,10000,0,10000,10000
059532,華新科凱基9B購03,0,0,0,0,0,0,0,0,0,10000,0,0,0,35000,25000,10000,10000
2457,飛宏            ,138000,128000,10000,0,0,0,0,0,0,0,0,0,0,0,0,0,10000
08447P,緯穎永豐9C售02  ,0,0,0,0,0,0,0,0,0,10000,0,0,0,10000,0,10000,10000
1109,信大            ,80000,70000,10000,0,0,0,0,0,0,0,0,0,0,0,0,0,10000
1337,再生-KY         ,15000,5000,10000,0,0,0,0,0,0,0,0,0,0,0,0,0,10000
07003P,聯發科兆豐99售02,0,0,0,0,0,0,0,0,0,10000,0,0,0,10000,0,10000,10000
06997P,台灣50中信03售01,0,0,0,0,0,0,0,0,0,10000,0,0,0,10000,0,10000,10000
07138P,台灣50群益9B售04,0,0,0,0,0,0,0,0,0,10000,0,0,0,10000,0,10000,10000
07126P,台積電元大99售23,0,0,0,0,0,0,0,0,0,10000,0,0,0,10000,0,10000,10000
07089P,臺指2X中信01售01,0,0,0,0,0,0,0,0,0,10000,0,0,0,10000,0,10000,10000
07108P,FBVIX台新99售02 ,0,0,0,0,0,0,0,0,0,10000,0,0,0,10000,0,10000,10000
07221P,臺股指中信9B售04,0,0,0,0,0,0,0,0,0,10000,0,0,0,10000,0,10000,10000
07310P,大立光凱基99售12,0,0,0,0,0,0,0,0,0,10000,0,0,0,10000,0,10000,10000
07314P,T50正2元大9C售03,0,0,0,0,0,0,0,0,0,10000,0,0,0,10000,0,10000,10000
04006P,滬深2X國票9B售01,0,0,0,0,0,0,0,0,0,10000,0,0,0,10000,0,10000,10000
03162P,泰碩元大01售02  ,0,0,0,0,0,0,0,0,0,10000,0,0,0,10000,0,10000,10000
03314P,台積電元大02售16,0,0,0,0,0,0,0,0,0,10000,0,0,0,10000,0,10000,10000
03436B,臺股指元富99熊13,0,0,0,0,0,0,0,0,0,10000,0,0,0,20000,10000,10000,10000
03437B,臺股指元富9C熊01,0,0,0,0,0,0,0,0,0,10000,0,0,0,14000,4000,10000,10000
044927,聯詠國泰94購01  ,0,0,0,0,0,0,0,0,0,10000,0,0,0,10000,0,10000,10000
050633,義隆群益96購02  ,0,0,0,0,0,0,0,0,0,10000,0,0,0,10000,0,10000,10000
050660,欣興元大96購02  ,0,0,0,0,0,0,0,0,0,10000,0,0,0,10000,0,10000,10000
050695,台積電凱基94購40,0,0,0,0,0,0,0,0,0,10000,0,0,0,30000,20000,10000,10000
041900,元油2X富邦96購01,10000,0,10000,0,0,0,0,0,0,0,0,0,0,0,0,0,10000
04287P,A50正2中信96售01,0,0,0,0,0,0,0,0,0,10000,0,0,0,10000,0,10000,10000
050972,台虹永豐95購01  ,0,0,0,0,0,0,0,0,0,10000,0,0,0,30000,20000,10000,10000
050849,智伸科國票95購01,0,0,0,0,0,0,0,0,0,10000,0,0,0,10000,0,10000,10000
051251,信邦元大95購01  ,0,0,0,0,0,0,0,0,0,10000,0,0,0,10000,0,10000,10000
051232,貿聯群益95購02  ,0,0,0,0,0,0,0,0,0,10000,0,0,0,10000,0,10000,10000
051094,健策元大96購03  ,0,0,0,0,0,0,0,0,0,10000,0,0,0,10000,0,10000,10000
051378,奇力新群益95購01,0,0,0,0,0,0,0,0,0,10000,0,0,0,10000,0,10000,10000
051340,健策永豐95購03  ,0,0,0,0,0,0,0,0,0,10000,0,0,0,10000,0,10000,10000
051281,健策兆豐96購01  ,0,0,0,0,0,0,0,0,0,10000,0,0,0,10000,0,10000,10000
045437,大立光統一94購02,0,0,0,0,0,0,0,0,0,10000,0,0,0,10000,0,10000,10000
04635P,臺股指群益94售10,0,0,0,0,0,0,0,0,0,10000,0,0,0,10000,0,10000,10000
04605P,台積電兆豐94售03,0,0,0,0,0,0,0,0,0,10000,0,0,0,20000,10000,10000,10000
045795,瀚宇博兆豐94購01,0,0,0,0,0,0,0,0,0,10000,0,0,0,10000,0,10000,10000
045836,群創群益98購01  ,0,0,0,0,0,0,0,0,0,10000,0,0,0,10000,0,10000,10000
045856,南亞科國泰94購01,0,0,0,0,0,0,0,0,0,10000,0,0,0,10000,0,10000,10000
045866,南茂統一94購01  ,0,0,0,0,0,0,0,0,0,10000,0,0,0,10000,0,10000,10000
047674,群創元富96購02  ,0,0,0,0,0,0,0,0,0,10000,0,0,0,10000,0,10000,10000
047541,深中小凱基94購01,0,0,0,0,0,0,0,0,0,10000,0,0,0,10000,0,10000,10000
047395,聯茂元大94購01  ,0,0,0,0,0,0,0,0,0,10000,0,0,0,10000,0,10000,10000
046934,智邦元富96購01  ,0,0,0,0,0,0,0,0,0,10000,0,0,0,10000,0,10000,10000
04683P,南亞科元大94售04,0,0,0,0,0,0,0,0,0,10000,0,0,0,10000,0,10000,10000
046628,大立光統一98購01,0,0,0,0,0,0,0,0,0,10000,0,0,0,10000,0,10000,10000
03010X,元展10          ,0,0,0,0,0,0,0,0,0,10000,0,0,0,10000,0,10000,10000
054112,台積電麥證96購02,0,0,0,0,0,0,0,0,0,10000,0,0,0,10000,0,10000,10000
052807,貿聯元大98購01  ,0,0,0,0,0,0,0,0,0,10000,0,0,0,10000,0,10000,10000
054139,揚明光元大96購01,0,0,0,0,0,0,0,0,0,10000,0,0,0,19000,9000,10000,10000
05295P,緯創凱基95售01  ,0,0,0,0,0,0,0,0,0,10000,0,0,0,10000,0,10000,10000
054178,中磊台新97購01  ,0,0,0,0,0,0,0,0,0,10000,0,0,0,10000,0,10000,10000
048866,滬深2X兆豐95購01,0,0,0,0,0,0,0,0,0,10000,0,0,0,10000,0,10000,10000
04892P,聯發科元大94售14,0,0,0,0,0,0,0,0,0,10000,0,0,0,10000,0,10000,10000
048937,玉晶光永豐95購01,0,0,0,0,0,0,0,0,0,10000,0,0,0,10000,0,10000,10000
04888P,臺股指凱基95售03,0,0,0,0,0,0,0,0,0,10000,0,0,0,10000,0,10000,10000
04870P,大立光元富94售11,0,0,0,0,0,0,0,0,0,10000,0,0,0,10000,0,10000,10000
048653,巨大元大96購02  ,0,0,0,0,0,0,0,0,0,10000,0,0,0,10000,0,10000,10000
048629,滬深2X元大96購04,0,0,0,0,0,0,0,0,0,10000,0,0,0,10000,0,10000,10000
048638,台光電元大94購01,0,0,0,0,0,0,0,0,0,10000,0,0,0,10000,0,10000,10000
052770,聯茂群益96購02  ,0,0,0,0,0,0,0,0,0,10000,0,0,0,10000,0,10000,10000
052765,新日興群益97購01,0,0,0,0,0,0,0,0,0,10000,0,0,0,10000,0,10000,10000
049042,玉晶光兆豐95購01,0,0,0,0,0,0,0,0,0,10000,0,0,0,10000,0,10000,10000
049408,旺宏日盛94購01  ,0,0,0,0,0,0,0,0,0,10000,0,0,0,10000,0,10000,10000
049341,旺宏統一95購01  ,0,0,0,0,0,0,0,0,0,10000,0,0,0,10000,0,10000,10000
049517,台光電國票94購02,0,0,0,0,0,0,0,0,0,10000,0,0,0,10000,0,10000,10000
049485,台積電元大96購03,0,0,0,0,0,0,0,0,0,10000,0,0,0,10000,0,10000,10000
048249,嘉澤兆豐94購01  ,0,0,0,0,0,0,0,0,0,10000,0,0,0,10000,0,10000,10000
050495,大立光永昌96購01,0,0,0,0,0,0,0,0,0,10000,0,0,0,10000,0,10000,10000
050484,世紀鋼國票95購02,0,0,0,0,0,0,0,0,0,10000,0,0,0,10000,0,10000,10000
049659,旺宏台新95購01  ,0,0,0,0,0,0,0,0,0,10000,0,0,0,10000,0,10000,10000
049584,台積電元大96購04,0,0,0,0,0,0,0,0,0,10000,0,0,0,10000,0,10000,10000
049864,聯發科兆豐94購01,0,0,0,0,0,0,0,0,0,10000,0,0,0,10000,0,10000,10000
050168,緯創富邦95購01  ,0,0,0,0,0,0,0,0,0,10000,0,0,0,10000,0,10000,10000
050252,聯發科國泰95購01,0,0,0,0,0,0,0,0,0,10000,0,0,0,10000,0,10000,10000
05300P,健策元大95售02  ,0,0,0,0,0,0,0,0,0,10000,0,0,0,10000,0,10000,10000
052984,漢唐元大96購01  ,0,0,0,0,0,0,0,0,0,10000,0,0,0,10000,0,10000,10000
052969,建準群益97購01  ,0,0,0,0,0,0,0,0,0,10000,0,0,0,10000,0,10000,10000
053034,上海銀兆豐96購01,0,0,0,0,0,0,0,0,0,10000,0,0,0,10000,0,10000,10000
054264,超眾元大97購02  ,0,0,0,0,0,0,0,0,0,10000,0,0,0,10000,0,10000,10000
051500,聯茂群益95購01  ,0,0,0,0,0,0,0,0,0,10000,0,0,0,10000,0,10000,10000
051536,玉晶光國票97購01,0,0,0,0,0,0,0,0,0,10000,0,0,0,10000,0,10000,10000
051463,世芯國泰97購02  ,0,0,0,0,0,0,0,0,0,10000,0,0,0,10000,0,10000,10000
051468,智邦日盛95購01  ,0,0,0,0,0,0,0,0,0,10000,0,0,0,10000,0,10000,10000
054385,矽創群益98購01  ,0,0,0,0,0,0,0,0,0,10000,0,0,0,10000,0,10000,10000
05204P,TPK元大95售03   ,0,0,0,0,0,0,0,0,0,10000,0,0,0,10000,0,10000,10000
052058,臺股指凱基95購16,0,0,0,0,0,0,0,0,0,10000,0,0,0,10000,0,10000,10000
054337,智邦統一96購01  ,0,0,0,0,0,0,0,0,0,10000,0,0,0,12000,2000,10000,10000
052120,友達國票96購01  ,0,0,0,0,0,0,0,0,0,10000,0,0,0,10000,0,10000,10000
052182,鴻海群益96購01  ,0,0,0,0,0,0,0,0,0,10000,0,0,0,10000,0,10000,10000
052450,嘉澤元大95購03  ,0,0,0,0,0,0,0,0,0,10000,0,0,0,10000,0,10000,10000
052417,聯發科兆豐9B購01,0,0,0,0,0,0,0,0,0,10000,0,0,0,20000,10000,10000,10000
052317,台積電元大96購11,0,0,0,0,0,0,0,0,0,10000,0,0,0,10000,0,10000,10000
052331,漢唐亞東97購01  ,0,0,0,0,0,0,0,0,0,10000,0,0,0,10000,0,10000,10000
05234P,美食康和95售01  ,0,0,0,0,0,0,0,0,0,10000,0,0,0,10000,0,10000,10000
051799,台積電永豐96購01,0,0,0,0,0,0,0,0,0,10000,0,0,0,10000,0,10000,10000
051912,健鼎元大96購01  ,0,0,0,0,0,0,0,0,0,10000,0,0,0,10000,0,10000,10000
051915,日月光元大96購01,0,0,0,0,0,0,0,0,0,10000,0,0,0,10000,0,10000,10000
051872,矽力凱基96購01  ,0,0,0,0,0,0,0,0,0,10000,0,0,0,10000,0,10000,10000
052565,上銀凱基96購01  ,0,0,0,0,0,0,0,0,0,10000,0,0,0,10000,0,10000,10000
051769,矽力元大95購01  ,0,0,0,0,0,0,0,0,0,10000,0,0,0,10000,0,10000,10000
051785,臻鼎兆豐96購01  ,0,0,0,0,0,0,0,0,0,10000,0,0,0,10000,0,10000,10000
053190,聯發科統一99購01,0,0,0,0,0,0,0,0,0,10000,0,0,0,10000,0,10000,10000
053216,京鼎凱基96購02  ,0,0,0,0,0,0,0,0,0,10000,0,0,0,10000,0,10000,10000
053205,台光電麥證96購01,0,0,0,10000,0,10000,0,0,0,10000,0,0,0,10000,0,10000,10000
053229,南電台新97購01  ,0,0,0,0,0,0,0,0,0,10000,0,0,0,10000,0,10000,10000
054410,國巨元大96購14  ,0,0,0,0,0,0,0,0,0,10000,0,0,0,10000,0,10000,10000
054421,臺股指元大99購03,0,0,0,0,0,0,0,0,0,10000,0,0,0,10000,0,10000,10000
054433,南亞科台新96購02,0,0,0,0,0,0,0,0,0,10000,0,0,0,10000,0,10000,10000
053603,臺股指元大96購20,0,0,0,0,0,0,0,0,0,10000,0,0,0,10000,0,10000,10000
05360P,健策元大95售03  ,0,0,0,0,0,0,0,0,0,10000,0,0,0,10000,0,10000,10000
053545,上銀凱基96購03  ,0,0,0,0,0,0,0,0,0,10000,0,0,0,10000,0,10000,10000
053582,英業達元大97購01,0,0,0,0,0,0,0,0,0,10000,0,0,0,10000,0,10000,10000
057887,智原群益98購04  ,0,0,0,0,0,0,0,0,0,10000,0,0,0,10000,0,10000,10000
057932,美律群益98購04  ,0,0,0,0,0,0,0,0,0,10000,0,0,0,10000,0,10000,10000
057966,金融類元大98購01,0,0,0,0,0,0,0,0,0,10000,0,0,0,60000,50000,10000,10000
057981,臻鼎永豐98購01  ,0,0,0,0,0,0,0,0,0,10000,0,0,0,10000,0,10000,10000
058064,華邦電亞東99購01,0,0,0,0,0,0,0,0,0,10000,0,0,0,10000,0,10000,10000
058016,智邦凱基98購06  ,0,0,0,0,0,0,0,0,0,10000,0,0,0,10000,0,10000,10000
053490,為升兆豐97購01  ,0,0,0,0,0,0,0,0,0,10000,0,0,0,10000,0,10000,10000
058328,世紀鋼統一9B購01,0,0,0,0,0,0,0,0,0,10000,0,0,0,10000,0,10000,10000
058232,聯發科元大99購05,0,0,0,0,0,0,0,0,0,10000,0,0,0,10000,0,10000,10000
057844,新日興永豐99購01,0,0,0,0,0,0,0,0,0,10000,0,0,0,10000,0,10000,10000
058345,台光電群益99購03,0,0,0,0,0,0,0,0,0,10000,0,0,0,108000,98000,10000,10000
058357,智邦凱基99購02  ,0,0,0,0,0,0,0,0,0,10000,0,0,0,10000,0,10000,10000
053471,正崴元大96購01  ,0,0,0,0,0,0,0,0,0,10000,0,0,0,10000,0,10000,10000
053458,聯詠國泰97購01  ,0,0,0,0,0,0,0,0,0,10000,0,0,0,10000,0,10000,10000
053439,台積電凱基96購11,0,0,0,0,0,0,0,0,0,10000,0,0,0,10000,0,10000,10000
053765,智邦富邦96購01  ,0,0,0,0,0,0,0,0,0,10000,0,0,0,10000,0,10000,10000
053742,創意國票97購01  ,0,0,0,0,0,0,0,0,0,10000,0,0,0,10000,0,10000,10000
053745,康友國票97購01  ,0,0,0,0,0,0,0,0,0,10000,0,0,0,70000,60000,10000,10000
053905,華新科凱基96購10,0,0,0,0,0,0,0,0,0,10000,0,0,0,20000,10000,10000,10000
053802,南亞科凱基96購04,0,0,0,0,0,0,0,0,0,10000,0,0,0,10000,0,10000,10000
053848,聯發科元富96購03,0,0,0,0,0,0,0,0,0,10000,0,0,0,10000,0,10000,10000
053850,嘉澤元富96購03  ,0,0,0,0,0,0,0,0,0,10000,0,0,0,10000,0,10000,10000
053353,玉晶光兆豐97購03,0,0,0,0,0,0,0,0,0,10000,0,0,0,10000,0,10000,10000
053735,矽力中信97購01  ,0,0,0,0,0,0,0,0,0,10000,0,0,0,10000,0,10000,10000
053678,南亞科富邦97購01,0,0,0,0,0,0,0,0,0,10000,0,0,0,10000,0,10000,10000
053250,百和國票97購02  ,0,0,0,0,0,0,0,0,0,10000,0,0,0,10000,0,10000,10000
053282,彩晶元大9C購01  ,0,0,0,0,0,0,0,0,0,10000,0,0,0,10000,0,10000,10000
051624,智邦麥證95購02  ,0,0,0,10000,0,10000,0,0,0,10000,0,0,0,10000,0,10000,10000
051636,嘉晶國票95購02  ,0,0,0,0,0,0,0,0,0,10000,0,0,0,10000,0,10000,10000
056398,南茂永豐98購01  ,0,0,0,0,0,0,0,0,0,10000,0,0,0,10000,0,10000,10000
056436,台積電凱基98購10,0,0,0,0,0,0,0,0,0,10000,0,0,0,10000,0,10000,10000
056404,嘉聯益群益9A購01,0,0,0,0,0,0,0,0,0,10000,0,0,0,10000,0,10000,10000
055491,奇力新元大98購03,0,0,0,0,0,0,0,0,0,10000,0,0,0,10000,0,10000,10000
057447,智邦元富02購01  ,0,0,0,0,0,0,0,0,0,10000,0,0,0,10000,0,10000,10000
056462,訊芯凱基98購03  ,0,0,0,0,0,0,0,0,0,10000,0,0,0,10000,0,10000,10000
056467,上証2X元大98購02,0,0,0,0,0,0,0,0,0,10000,0,0,0,10000,0,10000,10000
058598,T50反1元大99購04,0,0,0,0,0,0,0,0,0,10000,0,0,0,10000,0,10000,10000
057498,台郡元大98購04  ,0,0,0,0,0,0,0,0,0,10000,0,0,0,10000,0,10000,10000
057495,牧德元大99購04  ,0,0,0,0,0,0,0,0,0,10000,0,0,0,10000,0,10000,10000
058576,南亞科群益99購01,0,0,0,0,0,0,0,0,0,10000,0,0,0,10000,0,10000,10000
055386,致新元大97購02  ,0,0,0,0,0,0,0,0,0,10000,0,0,0,10000,0,10000,10000
056333,台積電日盛9B購01,0,0,0,0,0,0,0,0,0,10000,0,0,0,10000,0,10000,10000
056338,聯發科凱基99購01,0,0,0,0,0,0,0,0,0,10000,0,0,0,10000,0,10000,10000
056307,貿聯元大97購05  ,0,0,0,0,0,0,0,0,0,10000,0,0,0,10000,0,10000,10000
055332,奇力新兆豐98購01,0,0,0,0,0,0,0,0,0,10000,0,0,0,10000,0,10000,10000
055326,緯穎國票97購06  ,0,0,0,0,0,0,0,0,0,10000,0,0,0,10000,0,10000,10000
058601,台積電元大99購10,0,0,0,0,0,0,0,0,0,10000,0,0,0,10000,0,10000,10000
057786,聯發科國票98購05,0,0,0,0,0,0,0,0,0,10000,0,0,0,10000,0,10000,10000
057783,台積電國票9A購01,0,0,0,0,0,0,0,0,0,10000,0,0,0,10000,0,10000,10000
056385,創意國泰99購01  ,0,0,0,0,0,0,0,0,0,10000,0,0,0,10000,0,10000,10000
056357,台積電元大9A購01,0,0,0,0,0,0,0,0,0,10000,0,0,0,10000,0,10000,10000
056363,華新科元大99購04,0,0,0,0,0,0,0,0,0,10000,0,0,0,10000,0,10000,10000
057335,技嘉國票99購01  ,0,0,0,0,0,0,0,0,0,10000,0,0,0,10000,0,10000,10000
057342,玉晶光台新98購01,0,0,0,0,0,0,0,0,0,10000,0,0,0,10000,0,10000,10000
057372,華新科元大99購10,0,0,0,0,0,0,0,0,0,10000,0,0,0,10000,0,10000,10000
057369,奇力新元大99購05,0,0,0,0,0,0,0,0,0,10000,0,0,0,18000,8000,10000,10000
057402,嘉晶群益98購02  ,0,0,0,0,0,0,0,0,0,10000,0,0,0,10000,0,10000,10000
055594,華新科元大98購02,0,0,0,0,0,0,0,0,0,10000,0,0,0,20000,10000,10000,10000
055564,茂林凱基98購01  ,0,0,0,0,0,0,0,0,0,10000,0,0,0,10000,0,10000,10000
055892,國巨統一99購01  ,0,0,0,0,0,0,0,0,0,10000,0,0,0,10000,0,10000,10000
056542,緯創凱基98購01  ,0,0,0,0,0,0,0,0,0,10000,0,0,0,10000,0,10000,10000
055959,美律元大97購03  ,0,0,0,0,0,0,0,0,0,10000,0,0,0,10000,0,10000,10000
056043,力成凱基97購01  ,0,0,0,0,0,0,0,0,0,10000,0,0,0,10000,0,10000,10000
056053,和大元大97購05  ,0,0,0,0,0,0,0,0,0,10000,0,0,0,10000,0,10000,10000
056090,康舒統一97購01  ,0,0,0,0,0,0,0,0,0,10000,0,0,0,10000,0,10000,10000
054876,群電群益97購02  ,0,0,0,0,0,0,0,0,0,10000,0,0,0,10000,0,10000,10000
054945,正崴元大97購01  ,0,0,0,0,0,0,0,0,0,10000,0,0,0,10000,0,10000,10000
054937,國巨元大97購03  ,0,0,0,0,0,0,0,0,0,10000,0,0,0,10000,0,10000,10000
055088,聯詠亞東97購01  ,0,0,0,0,0,0,0,0,0,10000,0,0,0,10000,0,10000,10000
055039,神達富邦99購01  ,0,0,0,0,0,0,0,0,0,10000,0,0,0,10000,0,10000,10000
055043,中砂永豐97購01  ,0,0,0,0,0,0,0,0,0,10000,0,0,0,10000,0,10000,10000
054814,台積電元大97購13,0,0,0,0,0,0,0,0,0,10000,0,0,0,10000,0,10000,10000
054740,強茂凱基99購01  ,0,0,0,0,0,0,0,0,0,10000,0,0,0,10000,0,10000,10000
055292,聯鈞元大97購02  ,0,0,0,0,0,0,0,0,0,10000,0,0,0,10000,0,10000,10000
055201,興勤群益98購01  ,0,0,0,0,0,0,0,0,0,10000,0,0,0,10000,0,10000,10000
055151,台積電元大98購05,0,0,0,0,0,0,0,0,0,10000,0,0,0,10000,0,10000,10000
055161,貿聯元大98購03  ,0,0,0,0,0,0,0,0,0,10000,0,0,0,10000,0,10000,10000
055186,正文統一97購01  ,0,0,0,0,0,0,0,0,0,10000,0,0,0,10000,0,10000,10000
055188,亞翔統一97購01  ,0,0,0,0,0,0,0,0,0,10000,0,0,0,10000,0,10000,10000
055657,超眾元富97購02  ,0,0,0,0,0,0,0,0,0,10000,0,0,0,10000,0,10000,10000
056707,鴻海富邦99購03  ,0,0,0,0,0,0,0,0,0,10000,0,0,0,10000,0,10000,10000
056710,漢唐永豐98購01  ,0,0,0,0,0,0,0,0,0,10000,0,0,0,86000,76000,10000,10000
055704,亞德客永豐97購04,0,0,0,0,0,0,0,0,0,10000,0,0,0,10000,0,10000,10000
055712,金寶元大97購02  ,0,0,0,0,0,0,0,0,0,10000,0,0,0,10000,0,10000,10000
054571,楠梓電元大99購01,0,0,0,0,0,0,0,0,0,10000,0,0,0,10000,0,10000,10000
054545,奇力新中信98購01,0,0,0,0,0,0,0,0,0,10000,0,0,0,10000,0,10000,10000
056749,滬深2X兆豐99購01,0,0,0,0,0,0,0,0,0,10000,0,0,0,20000,10000,10000,10000
058909,神達元大99購03  ,0,0,0,0,0,0,0,0,0,10000,0,0,0,30000,20000,10000,10000
054649,聯茂群益97購01  ,0,0,0,0,0,0,0,0,0,10000,0,0,0,10000,0,10000,10000
058811,台積電統一9A購05,0,0,0,0,0,0,0,0,0,10000,0,0,0,10000,0,10000,10000
058816,祥碩台新99購02  ,0,0,0,0,0,0,0,0,0,10000,0,0,0,10000,0,10000,10000
054694,聯鈞永豐97購01  ,0,0,0,0,0,0,0,0,0,10000,0,0,0,10000,0,10000,10000
05924P,超眾元富96售04  ,0,0,0,0,0,0,0,0,0,10000,0,0,0,10000,0,10000,10000
059098,元油2X統一9B購03,0,0,0,0,0,0,0,0,0,10000,0,0,0,10000,0,10000,10000
057307,瀚宇博兆豐99購01,0,0,0,0,0,0,0,0,0,10000,0,0,0,10000,0,10000,10000
056858,國巨群益99購03  ,0,0,0,0,0,0,0,0,0,10000,0,0,0,10000,0,10000,10000
05688P,臺股指元大96售13,0,0,0,0,0,0,0,0,0,10000,0,0,0,10000,0,10000,10000
058504,台積電元大99購07,0,0,0,0,0,0,0,0,0,10000,0,0,0,10000,0,10000,10000
058505,台積電元大99購08,0,0,0,0,0,0,0,0,0,10000,0,0,0,10000,0,10000,10000
058539,聯發科台新99購01,0,0,0,0,0,0,0,0,0,10000,0,0,0,10000,0,10000,10000
056663,臺股指元大9A購10,0,0,0,0,0,0,0,0,0,10000,0,0,0,10000,0,10000,10000
056697,緯穎群益98購01  ,0,0,0,0,0,0,0,0,0,10000,0,0,0,10000,0,10000,10000
05583P,訊芯凱基96售01  ,0,0,0,0,0,0,0,0,0,10000,0,0,0,10000,0,10000,10000
056595,台積電元富98購04,0,0,0,0,0,0,0,0,0,10000,0,0,0,10000,0,10000,10000
056638,臺股指日盛98購01,0,0,0,0,0,0,0,0,0,10000,0,0,0,10000,0,10000,10000
05579P,友達凱基98售03  ,0,0,0,0,0,0,0,0,0,10000,0,0,0,10000,0,10000,10000
055756,臺股指兆豐97購01,0,0,0,0,0,0,0,0,0,10000,0,0,0,10000,0,10000,10000
057110,立積群益98購01  ,0,0,0,0,0,0,0,0,0,10000,0,0,0,10000,0,10000,10000
057141,嘉聯益兆豐99購01,0,0,0,0,0,0,0,0,0,10000,0,0,0,10000,0,10000,10000
057595,健鼎兆豐98購01  ,0,0,0,0,0,0,0,0,0,10000,0,0,0,10000,0,10000,10000
057582,亞光中信9A購02  ,0,0,0,0,0,0,0,0,0,10000,0,0,0,10000,0,10000,10000
057006,國巨中信98購03  ,0,0,0,0,0,0,0,0,0,10000,0,0,0,10000,0,10000,10000
8033,雷虎            ,10000,0,10000,0,0,0,0,0,0,0,0,0,0,0,0,0,10000
6666,羅麗芬-KY       ,15000,5000,10000,0,0,0,0,0,0,0,0,0,0,0,0,0,10000
8454,富邦媒          ,81900,70000,11900,0,0,0,0,0,0,-2000,1000,3000,-2000,0,0,0,9900
2633,台灣高鐵        ,3275000,3354164,-79164,0,0,0,0,0,0,89000,4000,19000,-15000,104000,0,104000,9836
2433,互盛電          ,15000,6000,9000,0,0,0,0,0,0,0,0,0,0,0,0,0,9000
4141,龍燈-KY         ,29000,20000,9000,0,0,0,0,0,0,0,0,0,0,0,0,0,9000
07420P,可成元大99售07  ,0,0,0,0,0,0,0,0,0,9000,0,0,0,30000,21000,9000,9000
07202P,台灣50凱基9C售04,0,0,0,0,0,0,0,0,0,9000,0,0,0,21000,12000,9000,9000
07078P,鴻海群益99售02  ,0,0,0,0,0,0,0,0,0,9000,0,0,0,9000,0,9000,9000
2305,全友            ,13000,4000,9000,0,0,0,0,0,0,0,0,0,0,0,0,0,9000
059475,元石油群益99購02,0,0,0,0,0,0,0,0,0,9000,0,0,0,44000,35000,9000,9000
059798,臺股指國票99購21,0,0,0,0,0,0,0,0,0,9000,0,0,0,11000,2000,9000,9000
059669,台灣50元富9B購05,0,0,0,0,0,0,0,0,0,9000,0,0,0,109000,100000,9000,9000
059940,微星永豐99購01  ,0,0,0,0,0,0,0,0,0,9000,0,0,0,19000,10000,9000,9000
06986P,台積電台新9A售01,0,0,0,0,0,0,0,0,0,9000,0,0,0,9000,0,9000,9000
06958P,FBVIX凱基9C售02 ,0,0,0,0,0,0,0,0,0,9000,0,0,0,9000,0,9000,9000
06950P,鴻海統一9B售02  ,0,0,0,0,0,0,0,0,0,9000,0,0,0,9000,0,9000,9000
06205P,台積電群益97售03,0,0,0,0,0,0,0,0,0,9000,0,0,0,9000,0,9000,9000
06306P,臺股指元大97售12,0,0,0,0,0,0,0,0,0,9000,0,0,0,9000,0,9000,9000
06007P,世芯永豐96售01  ,0,0,0,0,0,0,0,0,0,9000,0,0,0,9000,0,9000,9000
053268,日月光群益96購01,0,0,0,0,0,0,0,0,0,9000,0,0,0,9000,0,9000,9000
058390,樺漢國票9A購01  ,0,0,0,0,0,0,0,0,0,9000,0,0,0,21000,12000,9000,9000
057874,可成元大99購02  ,0,0,0,0,0,0,0,0,0,9000,0,0,0,15000,6000,9000,9000
052596,群創群益98購05  ,0,0,0,0,0,0,0,0,0,9000,0,0,0,9000,0,9000,9000
051879,健策台新96購01  ,0,0,0,0,0,0,0,0,0,9000,0,0,0,9000,0,9000,9000
051946,健策統一98購01  ,0,0,0,0,0,0,0,0,0,9000,0,0,0,9000,0,9000,9000
052375,奇力新元大96購02,0,0,0,0,0,0,0,0,0,9000,0,0,0,9000,0,9000,9000
051487,健策凱基96購03  ,0,0,0,0,0,0,0,0,0,9000,0,0,0,9000,0,9000,9000
049926,智易元大95購02  ,0,0,0,0,0,0,0,0,0,9000,0,0,0,9000,0,9000,9000
052681,T50反1元大98購02,0,0,0,0,0,0,0,0,0,9000,0,0,0,11000,2000,9000,9000
048533,景碩國票94購01  ,0,0,0,0,0,0,0,0,0,9000,0,0,0,58000,49000,9000,9000
052925,日電貿永豐96購01,0,0,0,0,0,0,0,0,0,9000,0,0,0,9000,0,9000,9000
00702,國泰標普低波高息,0,0,0,0,0,0,0,0,0,9000,0,0,0,12000,3000,9000,9000
04768P,大立光國泰96售03,0,0,0,0,0,0,0,0,0,9000,0,0,0,9000,0,9000,9000
050915,健策中信98購01  ,0,0,0,0,0,0,0,0,0,9000,0,0,0,9000,0,9000,9000
04288P,台積電中信95售06,0,0,0,0,0,0,0,0,0,9000,0,0,0,9000,0,9000,9000
03618C,高股息凱基95牛01,0,0,0,0,0,0,0,0,0,9000,0,0,0,9000,0,9000,9000
057028,台郡凱基99購02  ,0,0,0,0,0,0,0,0,0,9000,0,0,0,51000,42000,9000,9000
056702,欣興國泰9A購01  ,0,0,0,0,0,0,0,0,0,9000,0,0,0,9000,0,9000,9000
05764P,世紀鋼永豐96售03,0,0,0,0,0,0,0,0,0,9000,0,0,0,29000,20000,9000,9000
056923,奇力新兆豐99購02,0,0,0,0,0,0,0,0,0,9000,0,0,0,9000,0,9000,9000
056896,南亞科元大98購01,0,0,0,0,0,0,0,0,0,9000,0,0,0,9000,0,9000,9000
056913,臺股指元大99購05,0,0,0,0,0,0,0,0,0,9000,0,0,0,9000,0,9000,9000
058957,貿聯國票9A購01  ,0,0,0,0,0,0,0,0,0,9000,0,0,0,40000,31000,9000,9000
055660,台光電兆豐97購01,0,0,0,0,0,0,0,0,0,9000,0,0,0,9000,0,9000,9000
054707,聯茂亞東97購01  ,0,0,0,0,0,0,0,0,0,9000,0,0,0,146000,137000,9000,9000
05860P,旺宏康和96售01  ,0,0,0,0,0,0,0,0,0,9000,0,0,0,10000,1000,9000,9000
054803,味全元大9A購01  ,0,0,0,0,0,0,0,0,0,9000,0,0,0,9000,0,9000,9000
057413,臺股指群益9C購04,0,0,0,0,0,0,0,0,0,9000,0,0,0,10000,1000,9000,9000
058455,玉晶光永豐99購03,0,0,0,0,0,0,0,0,0,9000,0,0,0,57000,48000,9000,9000
058131,義隆元大99購02  ,0,0,0,0,0,0,0,0,0,9000,0,0,0,102000,93000,9000,9000
058653,光寶科中信9A購01,0,0,0,0,0,0,0,0,0,9000,0,0,0,21000,12000,9000,9000
056471,台光電元大99購01,0,0,0,0,0,0,0,0,0,9000,0,0,0,9000,0,9000,9000
056443,南亞科凱基98購03,0,0,0,0,0,0,0,0,0,9000,0,0,0,9000,0,9000,9000
06150P,奇力新元大97售06,0,0,0,0,0,0,0,0,0,8000,0,0,0,20000,12000,8000,8000
06873P,嘉晶元富98售02  ,0,0,0,0,0,0,0,0,0,8000,0,0,0,8000,0,8000,8000
059742,富邦金元富99購01,0,0,0,0,0,0,0,0,0,8000,0,0,0,129000,121000,8000,8000
1312A,國喬特          ,0,0,0,0,0,0,0,0,0,8000,8000,0,8000,0,0,0,8000
1234,黑松            ,12000,4000,8000,0,0,0,0,0,0,0,0,0,0,0,0,0,8000
08484P,台灣50中信96售01,0,0,0,0,0,0,0,0,0,8000,0,0,0,8000,0,8000,8000
07357P,鴻海元大99售38  ,0,0,0,0,0,0,0,0,0,8000,0,0,0,13000,5000,8000,8000
07309P,聯發科凱基99售18,0,0,0,0,0,0,0,0,0,8000,0,0,0,8000,0,8000,8000
07328P,FBVIX國泰9B售01 ,0,0,0,0,0,0,0,0,0,8000,0,0,0,8000,0,8000,8000
2516,新建            ,9000,1000,8000,0,0,0,0,0,0,0,0,0,0,0,0,0,8000
2727,王品            ,74000,66000,8000,0,0,0,0,0,0,0,0,0,0,0,0,0,8000
03896P,長榮航凱基95售01,0,0,0,0,0,0,0,0,0,8000,0,0,0,8000,0,8000,8000
050724,國巨國票96購01  ,0,0,0,0,0,0,0,0,0,8000,0,0,0,8000,0,8000,8000
051103,緯穎元大96購03  ,0,0,0,0,0,0,0,0,0,8000,0,0,0,8000,0,8000,8000
051176,聯發科凱基95購07,0,0,0,0,0,0,0,0,0,8000,0,0,0,8000,0,8000,8000
04769P,高股息元大94售01,0,0,0,0,0,0,0,0,0,8000,0,0,0,8000,0,8000,8000
046492,旺宏富邦94購02  ,0,0,0,0,0,0,0,0,0,8000,0,0,0,8000,0,8000,8000
052882,南電凱基96購02  ,0,0,0,0,0,0,0,0,0,8000,0,0,0,8000,0,8000,8000
051401,華新科永豐95購01,0,0,0,0,0,0,0,0,0,8000,0,0,0,10000,2000,8000,8000
049267,瀚宇博元大95購02,0,0,0,0,0,0,0,0,0,8000,0,0,0,13000,5000,8000,8000
053022,欣興國泰98購01  ,0,0,0,0,0,0,0,0,0,8000,0,0,0,8000,0,8000,8000
057856,聯鈞國票99購03  ,0,0,0,0,0,0,0,0,0,8000,0,0,0,37000,29000,8000,8000
057831,聯發科元富02購04,0,0,0,0,0,0,0,0,0,8000,0,0,0,8000,0,8000,8000
057452,新日興元富98購01,0,0,0,0,0,0,0,0,0,8000,0,0,0,31000,23000,8000,8000
057443,臺股指統一99購04,0,0,0,0,0,0,0,0,0,8000,0,0,0,8000,0,8000,8000
055471,聯發科凱基97購04,0,0,0,0,0,0,0,0,0,8000,0,0,0,10000,2000,8000,8000
056299,友達元大9B購04  ,0,0,0,0,0,0,0,0,0,8000,0,0,0,8000,0,8000,8000
057368,微星元大98購02  ,0,0,0,0,0,0,0,0,0,8000,0,0,0,8000,0,8000,8000
054755,世紀鋼凱基98購01,0,0,0,0,0,0,0,0,0,8000,0,0,0,8000,0,8000,8000
054773,台郡國票98購01  ,0,0,0,0,0,0,0,0,0,8000,0,0,0,38000,30000,8000,8000
056214,義隆國票99購01  ,0,0,0,0,0,0,0,0,0,8000,0,0,0,8000,0,8000,8000
056536,義隆凱基98購04  ,0,0,0,0,0,0,0,0,0,8000,0,0,0,92000,84000,8000,8000
05682P,大立光元大98售03,0,0,0,0,0,0,0,0,0,8000,0,0,0,8000,0,8000,8000
059256,臺股指凱基99購34,0,0,0,0,0,0,0,0,0,8000,0,0,0,141000,133000,8000,8000
057261,瑞昱兆豐98購01  ,0,0,0,0,0,0,0,0,0,8000,0,0,0,8000,0,8000,8000
056602,嘉澤國泰99購01  ,0,0,0,0,0,0,0,0,0,8000,0,0,0,8000,0,8000,8000
057528,南亞科元大99購01,0,0,0,0,0,0,0,0,0,8000,0,0,0,8000,0,8000,8000
057537,聯茂元大98購04  ,0,0,0,0,0,0,0,0,0,8000,0,0,0,10000,2000,8000,8000
2904,匯僑            ,9000,2000,7000,0,0,0,0,0,0,0,0,0,0,0,0,0,7000
07305P,T50正2群益99售02,0,0,0,0,0,0,0,0,0,7000,0,0,0,40000,33000,7000,7000
07298P,台灣50元大9C售12,0,0,0,0,0,0,0,0,0,7000,0,0,0,9000,2000,7000,7000
07348P,滬深2X凱基9A售04,0,0,0,0,0,0,0,0,0,7000,0,0,0,10000,3000,7000,7000
07220P,台灣50中信03售05,0,0,0,0,0,0,0,0,0,7000,0,0,0,35000,28000,7000,7000
059695,聯鈞永豐99購02  ,0,0,0,0,0,0,0,0,0,7000,0,0,0,43000,36000,7000,7000
059440,康控元大9B購01  ,0,0,0,0,0,0,0,0,0,7000,0,0,0,27000,20000,7000,7000
059613,泰鼎永豐99購02  ,0,0,0,0,0,0,0,0,0,7000,0,0,0,7000,0,7000,7000
06578P,華新科國票98售02,0,0,0,0,0,0,0,0,0,7000,0,0,0,7000,0,7000,7000
060059,鴻海兆豐99購06  ,0,0,0,0,0,0,0,0,0,7000,0,0,0,34000,27000,7000,7000
060224,台灣50元大9A購09,0,0,0,0,0,0,0,0,0,7000,0,0,0,72000,65000,7000,7000
053713,漢唐凱基96購04  ,0,0,0,0,0,0,0,0,0,7000,0,0,0,12000,5000,7000,7000
053327,彩晶台新97購01  ,0,0,0,0,0,0,0,0,0,7000,0,0,0,7000,0,7000,7000
053852,南亞科國泰98購01,0,0,0,0,0,0,0,0,0,7000,0,0,0,7000,0,7000,7000
051449,玉晶光元大96購01,0,0,0,0,0,0,0,0,0,7000,0,0,0,68000,61000,7000,7000
05419P,矽力永豐95售02  ,0,0,0,0,0,0,0,0,0,7000,0,0,0,12000,5000,7000,7000
052185,奇力新群益95購03,0,0,0,0,0,0,0,0,0,7000,0,0,0,55000,48000,7000,7000
054334,超眾永豐96購04  ,0,0,0,0,0,0,0,0,0,7000,0,0,0,7000,0,7000,7000
052028,健策群益95購02  ,0,0,0,0,0,0,0,0,0,7000,0,0,0,7000,0,7000,7000
051568,智邦富邦95購01  ,0,0,0,0,0,0,0,0,0,7000,0,0,0,9000,2000,7000,7000
053153,大立光元大99購02,0,0,0,0,0,0,0,0,0,7000,0,0,0,7000,0,7000,7000
049141,旺宏元大95購01  ,0,0,0,0,0,0,0,0,0,7000,0,0,0,12000,5000,7000,7000
04912P,可成元富94售06  ,0,0,0,0,0,0,0,0,0,7000,0,0,0,15000,8000,7000,7000
049706,世紀鋼元大95購02,0,0,0,0,0,0,0,0,0,7000,0,0,0,37000,30000,7000,7000
049927,健策元大94購02  ,0,0,0,0,0,0,0,0,0,7000,0,0,0,7000,0,7000,7000
049820,世紀鋼元大96購03,0,0,0,0,0,0,0,0,0,7000,0,0,0,462000,455000,7000,7000
050242,義隆凱基94購04  ,0,0,0,0,0,0,0,0,0,7000,0,0,0,7000,0,7000,7000
050335,正崴國泰96購01  ,0,0,0,0,0,0,0,0,0,7000,0,0,0,7000,0,7000,7000
048831,玉晶光凱基95購01,0,0,0,0,0,0,0,0,0,7000,0,0,0,7000,0,7000,7000
052689,玉晶光元大98購03,0,0,0,0,0,0,0,0,0,7000,0,0,0,150000,143000,7000,7000
046949,群創元大99購01  ,0,0,0,0,0,0,0,0,0,7000,0,0,0,7000,0,7000,7000
047769,大立光元大96購01,0,0,0,0,0,0,0,0,0,7000,0,0,0,7000,0,7000,7000
045759,T50反1統一94購02,0,0,0,0,0,0,0,0,0,7000,0,0,0,7000,0,7000,7000
04578P,微星富邦96售01  ,0,0,0,0,0,0,0,0,0,7000,0,0,0,7000,0,7000,7000
00733,富邦臺灣中小    ,0,0,0,0,0,0,0,0,0,7000,0,0,0,208000,201000,7000,7000
055788,緯穎凱基97購04  ,0,0,0,0,0,0,0,0,0,7000,0,0,0,7000,0,7000,7000
057029,緯穎凱基98購04  ,0,0,0,0,0,0,0,0,0,7000,0,0,0,19000,12000,7000,7000
057060,緯穎元大98購05  ,0,0,0,0,0,0,0,0,0,7000,0,0,0,7000,0,7000,7000
057626,技嘉富邦9A購01  ,0,0,0,0,0,0,0,0,0,7000,0,0,0,106000,99000,7000,7000
057641,旺宏元大98購10  ,0,0,0,0,0,0,0,0,0,7000,0,0,0,7000,0,7000,7000
058457,創意永豐99購01  ,0,0,0,0,0,0,0,0,0,7000,0,0,0,7000,0,7000,7000
059085,鴻海元大99購25  ,0,0,0,0,0,0,0,0,0,7000,0,0,0,64000,57000,7000,7000
056818,正崴永豐98購01  ,0,0,0,0,0,0,0,0,0,7000,0,0,0,107000,100000,7000,7000
056768,宏達電元大99購03,0,0,0,0,0,0,0,0,0,7000,0,0,0,71000,64000,7000,7000
054523,GIS元大96購05   ,0,0,0,0,0,0,0,0,0,7000,0,0,0,36000,29000,7000,7000
054584,貿聯元富97購01  ,0,0,0,0,0,0,0,0,0,7000,0,0,0,8000,1000,7000,7000
055642,廣宇元富97購01  ,0,0,0,0,0,0,0,0,0,7000,0,0,0,7000,0,7000,7000
055136,聯發科富邦99購06,0,0,0,0,0,0,0,0,0,7000,0,0,0,7000,0,7000,7000
055282,聯發科元大97購15,0,0,0,0,0,0,0,0,0,7000,0,0,0,7000,0,7000,7000
057784,台積電國票9B購01,0,0,0,0,0,0,0,0,0,7000,0,0,0,7000,0,7000,7000
056315,同欣電元大97購05,0,0,0,0,0,0,0,0,0,7000,0,0,0,7000,0,7000,7000
055385,昇陽半元大98購01,0,0,0,0,0,0,0,0,0,7000,0,0,0,7000,0,7000,7000
05858P,矽力中信96售01  ,0,0,0,0,0,0,0,0,0,7000,0,0,0,7000,0,7000,7000
058644,元黃金富邦03購01,0,0,0,0,0,0,0,0,0,7000,0,0,0,7000,0,7000,7000
058571,緯穎凱基9A購02  ,0,0,0,0,0,0,0,0,0,7000,0,0,0,7000,0,7000,7000
060240,富邦金元大9A購01,0,0,0,0,0,0,0,0,0,6000,0,0,0,10000,4000,6000,6000
06525P,上証2X國泰99售01,0,0,0,0,0,0,0,0,0,6000,0,0,0,6000,0,6000,6000
06374P,台表科元大97售06,0,0,0,0,0,0,0,0,0,6000,0,0,0,6000,0,6000,6000
06975P,臺股指元大9A售13,0,0,0,0,0,0,0,0,0,6000,0,0,0,8000,2000,6000,6000
059521,南電永豐99購03  ,0,0,0,0,0,0,0,0,0,6000,0,0,0,30000,24000,6000,6000
07145P,為升元大99售03  ,0,0,0,0,0,0,0,0,0,6000,0,0,0,6000,0,6000,6000
07123P,鴻海元大99售23  ,0,0,0,0,0,0,0,0,0,6000,0,0,0,9000,3000,6000,6000
07011P,宏達電凱基99售02,0,0,0,0,0,0,0,0,0,6000,0,0,0,6000,0,6000,6000
07351P,鴻海國票99售08  ,0,0,0,0,0,0,0,0,0,6000,0,0,0,20000,14000,6000,6000
07423P,大立光元大99售33,0,0,0,0,0,0,0,0,0,6000,0,0,0,6000,0,6000,6000
1452,宏益            ,33000,27000,6000,0,0,0,0,0,0,0,0,0,0,0,0,0,6000
1437,勤益控          ,41000,35000,6000,0,0,0,0,0,0,0,0,0,0,0,0,0,6000
3013,晟銘電          ,11000,5000,6000,0,0,0,0,0,0,0,0,0,0,0,0,0,6000
4722,國精化          ,10000,3000,7000,0,0,0,0,0,0,-1000,0,1000,-1000,0,0,0,6000
4999,鑫禾            ,7000,1000,6000,0,0,0,0,0,0,0,0,0,0,0,0,0,6000
5608,四維航          ,26000,20000,6000,0,0,0,0,0,0,0,0,0,0,0,0,0,6000
6115,鎰勝            ,37000,31000,6000,0,0,0,0,0,0,0,0,0,0,0,0,0,6000
6442,光聖            ,6000,0,6000,0,0,0,0,0,0,0,0,0,0,0,0,0,6000
6449,鈺邦            ,58000,52000,6000,0,0,0,0,0,0,0,0,0,0,0,0,0,6000
006204,永豐臺灣加權    ,0,0,0,0,0,0,0,0,0,6000,0,0,0,6000,0,6000,6000
04796P,聯發科元大94售10,0,0,0,0,0,0,0,0,0,6000,0,0,0,6000,0,6000,6000
04714P,上海銀元大94售01,0,0,0,0,0,0,0,0,0,6000,0,0,0,6000,0,6000,6000
050797,聯發科中信99購01,0,0,0,0,0,0,0,0,0,6000,0,0,0,6000,0,6000,6000
043735,元金2X元大94購01,0,0,0,0,0,0,0,0,0,6000,0,0,0,6000,0,6000,6000
03422B,臺股指凱基96熊28,0,0,0,0,0,0,0,0,0,6000,0,0,0,6000,0,6000,6000
05284P,鴻海兆豐95售04  ,0,0,0,0,0,0,0,0,0,6000,0,0,0,6000,0,6000,6000
054138,晶技元大98購02  ,0,0,0,0,0,0,0,0,0,6000,0,0,0,6000,0,6000,6000
052819,義隆永豐96購01  ,0,0,0,0,0,0,0,0,0,6000,0,0,0,145000,139000,6000,6000
050189,旭富元大94購01  ,0,0,0,0,0,0,0,0,0,6000,0,0,0,6000,0,6000,6000
049967,華新科國票94購07,0,0,0,0,0,0,0,0,0,6000,0,0,0,6000,0,6000,6000
049593,群創元大9A購01  ,0,0,0,0,0,0,0,0,0,6000,0,0,0,6000,0,6000,6000
048269,瀚宇博國泰95購01,0,0,0,0,0,0,0,0,0,6000,0,0,0,6000,0,6000,6000
048287,嘉晶兆豐94購01  ,0,0,0,0,0,0,0,0,0,6000,0,0,0,6000,0,6000,6000
053573,臺股指統一99購01,0,0,0,0,0,0,0,0,0,6000,0,0,0,6000,0,6000,6000
052329,台積電亞東96購01,0,0,0,0,0,0,0,0,0,6000,0,0,0,6000,0,6000,6000
051840,康友國泰97購02  ,0,0,0,0,0,0,0,0,0,6000,0,0,0,6000,0,6000,6000
052568,漢唐凱基96購02  ,0,0,0,0,0,0,0,0,0,6000,0,0,0,6000,0,6000,6000
052617,景碩國泰98購01  ,0,0,0,0,0,0,0,0,0,6000,0,0,0,6000,0,6000,6000
051777,聯發科群益95購04,0,0,0,0,0,0,0,0,0,6000,0,0,0,6000,0,6000,6000
052042,台積電日盛95購02,0,0,0,0,0,0,0,0,0,6000,0,0,0,6000,0,6000,6000
05230P,京元電群益95售01,0,0,0,0,0,0,0,0,0,6000,0,0,0,6000,0,6000,6000
053861,台光電元大98購01,0,0,0,0,0,0,0,0,0,6000,0,0,0,6000,0,6000,6000
053474,聯發科元大97購06,0,0,0,0,0,0,0,0,0,6000,0,0,0,6000,0,6000,6000
053964,上銀元大96購05  ,0,0,0,0,0,0,0,0,0,6000,0,0,0,6000,0,6000,6000
053664,臺股指凱基96購25,0,0,0,0,0,0,0,0,0,6000,0,0,0,6000,0,6000,6000
058358,技嘉凱基9A購01  ,0,0,0,0,0,0,0,0,0,6000,0,0,0,26000,20000,6000,6000
058233,聯發科元大99購06,0,0,0,0,0,0,0,0,0,6000,0,0,0,33000,27000,6000,6000
058217,新唐群益99購01  ,0,0,0,0,0,0,0,0,0,6000,0,0,0,6000,0,6000,6000
058186,聯發科永豐99購01,0,0,0,0,0,0,0,0,0,6000,0,0,0,6000,0,6000,6000
057994,技嘉中信98購01  ,0,0,0,0,0,0,0,0,0,6000,0,0,0,20000,14000,6000,6000
057879,電子類元大99購02,0,0,0,0,0,0,0,0,0,6000,0,0,0,6000,0,6000,6000
058698,華通元大99購05  ,0,0,0,0,0,0,0,0,0,6000,0,0,0,18000,12000,6000,6000
055444,致新台新97購01  ,0,0,0,0,0,0,0,0,0,6000,0,0,0,6000,0,6000,6000
057429,華新科兆豐98購03,0,0,0,0,0,0,0,0,0,6000,0,0,0,16000,10000,6000,6000
056355,台積電元大98購08,0,0,0,0,0,0,0,0,0,6000,0,0,0,6000,0,6000,6000
054769,創意國票98購01  ,0,0,0,0,0,0,0,0,0,6000,0,0,0,6000,0,6000,6000
054829,亞光國泰99購01  ,0,0,0,0,0,0,0,0,0,6000,0,0,0,6000,0,6000,6000
054928,帆宣凱基98購01  ,0,0,0,0,0,0,0,0,0,6000,0,0,0,50000,44000,6000,6000
058736,鈺齊永豐99購02  ,0,0,0,0,0,0,0,0,0,6000,0,0,0,16000,10000,6000,6000
055640,鴻海元富97購03  ,0,0,0,0,0,0,0,0,0,6000,0,0,0,6000,0,6000,6000
056222,台積電凱基9A購01,0,0,0,0,0,0,0,0,0,6000,0,0,0,6000,0,6000,6000
055979,聯鈞統一97購03  ,0,0,0,0,0,0,0,0,0,6000,0,0,0,6000,0,6000,6000
054661,嘉聯益元大97購03,0,0,0,0,0,0,0,0,0,6000,0,0,0,6000,0,6000,6000
055711,上銀元大97購04  ,0,0,0,0,0,0,0,0,0,6000,0,0,0,6000,0,6000,6000
058490,元黃金群益9B購01,0,0,0,0,0,0,0,0,0,6000,0,0,0,6000,0,6000,6000
055770,欣興麥證97購01  ,0,0,0,6000,0,6000,0,0,0,6000,0,0,0,6000,0,6000,6000
056236,台積電群益97購06,0,0,0,0,0,0,0,0,0,6000,0,0,0,6000,0,6000,6000
6172,互億            ,20000,15000,5000,0,0,0,0,0,0,0,0,0,0,0,0,0,5000
5284,jpp-KY          ,6000,1000,5000,0,0,0,0,0,0,0,0,0,0,0,0,0,5000
3557,嘉威            ,48000,43000,5000,0,0,0,0,0,0,0,0,0,0,0,0,0,5000
2906,高林            ,6000,1000,5000,0,0,0,0,0,0,0,0,0,0,0,0,0,5000
2462,良得電          ,5000,0,5000,0,0,0,0,0,0,0,0,0,0,0,0,0,5000
2468,華經            ,5000,0,5000,0,0,0,0,0,0,0,0,0,0,0,0,0,5000
2427,三商電          ,9000,4000,5000,0,0,0,0,0,0,0,0,0,0,0,0,0,5000
1463,強盛            ,6000,1000,5000,0,0,0,0,0,0,0,0,0,0,0,0,0,5000
1517,利奇            ,9000,4000,5000,0,0,0,0,0,0,0,0,0,0,0,0,0,5000
08570P,台灣50凱基96售03,0,0,0,0,0,0,0,0,0,5000,0,0,0,5000,0,5000,5000
1220,台榮            ,5000,0,5000,0,0,0,0,0,0,0,0,0,0,0,0,0,5000
2243,宏旭-KY         ,5000,0,5000,0,0,0,0,0,0,0,0,0,0,0,0,0,5000
2069,運錩            ,4000,1000,3000,0,0,0,0,0,0,2000,2000,0,2000,0,0,0,5000
1568,倉佑            ,7000,2000,5000,0,0,0,0,0,0,0,0,0,0,0,0,0,5000
07381P,鴻海群益99售05  ,0,0,0,0,0,0,0,0,0,5000,0,0,0,8000,3000,5000,5000
07323P,鴻海元大99售34  ,0,0,0,0,0,0,0,0,0,5000,0,0,0,5000,0,5000,5000
07080P,健策群益9A售01  ,0,0,0,0,0,0,0,0,0,5000,0,0,0,5000,0,5000,5000
07101P,台郡元大99售06  ,0,0,0,0,0,0,0,0,0,5000,0,0,0,5000,0,5000,5000
07249P,T50正2富邦03售02,0,0,0,0,0,0,0,0,0,5000,0,0,0,5000,0,5000,5000
07193P,聯發科元大99售24,0,0,0,0,0,0,0,0,0,5000,0,0,0,5000,0,5000,5000
059512,晶豪科永豐99購02,0,0,0,0,0,0,0,0,0,5000,0,0,0,12000,7000,5000,5000
059490,國巨國票99購09  ,0,0,0,0,0,0,0,0,0,5000,0,0,0,5000,0,5000,5000
059435,大立光元大99購17,0,0,0,0,0,0,0,0,0,5000,0,0,0,5000,0,5000,5000
059318,旺宏元大99購13  ,0,0,0,0,0,0,0,0,0,5000,0,0,0,5000,0,5000,5000
059824,大立光凱基99購13,0,0,0,0,0,0,0,0,0,5000,0,0,0,5000,0,5000,5000
059800,T50反1元富99購09,0,0,0,0,0,0,0,0,0,5000,0,0,0,5000,0,5000,5000
06959P,鴻海凱基9A售02  ,0,0,0,0,0,0,0,0,0,5000,0,0,0,5000,0,5000,5000
06850P,聯茂元大98售06  ,0,0,0,0,0,0,0,0,0,5000,0,0,0,5000,0,5000,5000
06921P,台光電凱基98售06,0,0,0,0,0,0,0,0,0,5000,0,0,0,27000,22000,5000,5000
06886P,旺宏元大99售07  ,0,0,0,0,0,0,0,0,0,5000,0,0,0,5000,0,5000,5000
06884P,台郡群益98售03  ,0,0,0,0,0,0,0,0,0,5000,0,0,0,5000,0,5000,5000
06772P,國巨中信99售01  ,0,0,0,0,0,0,0,0,0,5000,0,0,0,5000,0,5000,5000
06410P,祥碩統一97售01  ,0,0,0,0,0,0,0,0,0,5000,0,0,0,5000,0,5000,5000
06495P,華新科亞東9A售01,0,0,0,0,0,0,0,0,0,5000,0,0,0,5000,0,5000,5000
06121P,同欣電凱基97售02,0,0,0,0,0,0,0,0,0,5000,0,0,0,5000,0,5000,5000
057901,大立光永豐98購04,0,0,0,0,0,0,0,0,0,5000,0,0,0,10000,5000,5000,5000
057938,台表科群益98購02,0,0,0,0,0,0,0,0,0,5000,0,0,0,21000,16000,5000,5000
058014,上銀凱基99購02  ,0,0,0,0,0,0,0,0,0,5000,0,0,0,11000,6000,5000,5000
053483,嘉澤第一96購01  ,0,0,0,0,0,0,0,0,0,5000,0,0,0,5000,0,5000,5000
057843,晶技永豐98購02  ,0,0,0,0,0,0,0,0,0,5000,0,0,0,13000,8000,5000,5000
053717,聯發科凱基96購17,0,0,0,0,0,0,0,0,0,5000,0,0,0,5000,0,5000,5000
053359,矽力統一96購02  ,0,0,0,0,0,0,0,0,0,5000,0,0,0,5000,0,5000,5000
053378,台積電元大98購02,0,0,0,0,0,0,0,0,0,5000,0,0,0,5000,0,5000,5000
053269,同欣電群益96購01,0,0,0,0,0,0,0,0,0,5000,0,0,0,5000,0,5000,5000
051677,達方元大95購01  ,0,0,0,0,0,0,0,0,0,5000,0,0,0,5000,0,5000,5000
051590,玉晶光元大96購02,0,0,0,0,0,0,0,0,0,5000,0,0,0,5000,0,5000,5000
053976,亞光元大96購02  ,0,0,0,0,0,0,0,0,0,5000,0,0,0,5000,0,5000,5000
053479,達興元大96購01  ,0,0,0,0,0,0,0,0,0,5000,0,0,0,5000,0,5000,5000
053869,嘉澤元大96購02  ,0,0,0,0,0,0,0,0,0,5000,0,0,0,5000,0,5000,5000
053825,南電群益96購02  ,0,0,0,0,0,0,0,0,0,5000,0,0,0,5000,0,5000,5000
053880,智邦中信96購01  ,0,0,0,0,0,0,0,0,0,5000,0,0,0,5000,0,5000,5000
053791,同欣電元大96購05,0,0,0,0,0,0,0,0,0,5000,0,0,0,5000,0,5000,5000
052256,台泥國泰96購01  ,0,0,0,0,0,0,0,0,0,5000,0,0,0,5000,0,5000,5000
052278,國巨凱基95購06  ,0,0,0,0,0,0,0,0,0,5000,0,0,0,5000,0,5000,5000
052096,力成元大95購01  ,0,0,0,0,0,0,0,0,0,5000,0,0,0,5000,0,5000,5000
051978,泰碩凱基96購01  ,0,0,0,0,0,0,0,0,0,5000,0,0,0,5000,0,5000,5000
054217,台表科國票97購05,0,0,0,0,0,0,0,0,0,5000,0,0,0,5000,0,5000,5000
051459,臺股指元大95購19,0,0,0,0,0,0,0,0,0,5000,0,0,0,5000,0,5000,5000
051481,聯詠凱基95購02  ,0,0,0,0,0,0,0,0,0,5000,0,0,0,5000,0,5000,5000
053033,智易兆豐97購01  ,0,0,0,0,0,0,0,0,0,5000,0,0,0,5000,0,5000,5000
052972,義隆群益96購04  ,0,0,0,0,0,0,0,0,0,5000,0,0,0,5000,0,5000,5000
051528,亞泥國票96購01  ,0,0,0,0,0,0,0,0,0,5000,0,0,0,5000,0,5000,5000
05307P,光寶科中信95售01,0,0,0,0,0,0,0,0,0,5000,0,0,0,5000,0,5000,5000
051805,元黃金凱基97購02,0,0,0,0,0,0,0,0,0,5000,0,0,0,10000,5000,5000,5000
052374,瑞昱元大95購02  ,0,0,0,0,0,0,0,0,0,5000,0,0,0,5000,0,5000,5000
052386,鴻海群益96購02  ,0,0,0,0,0,0,0,0,0,5000,0,0,0,5000,0,5000,5000
052434,茂林國泰97購01  ,0,0,0,0,0,0,0,0,0,5000,0,0,0,5000,0,5000,5000
05246P,南電元大95售04  ,0,0,0,0,0,0,0,0,0,5000,0,0,0,5000,0,5000,5000
053580,國巨元大96購10  ,0,0,0,0,0,0,0,0,0,5000,0,0,0,75000,70000,5000,5000
054419,嘉聯益元大98購02,0,0,0,0,0,0,0,0,0,5000,0,0,0,5000,0,5000,5000
053146,滬深2X元大96購08,0,0,0,0,0,0,0,0,0,5000,0,0,0,5000,0,5000,5000
053130,聯發科麥證96購01,0,0,0,5000,0,5000,0,0,0,5000,0,0,0,5000,0,5000,5000
053163,上証2X群益9A購02,0,0,0,0,0,0,0,0,0,5000,0,0,0,5000,0,5000,5000
048328,滬深2X永昌94購01,0,0,0,0,0,0,0,0,0,5000,0,0,0,5000,0,5000,5000
049129,S&P反1元大97購01,0,0,0,0,0,0,0,0,0,5000,0,0,0,5000,0,5000,5000
049369,義隆元大95購01  ,0,0,0,0,0,0,0,0,0,5000,0,0,0,5000,0,5000,5000
050491,旺宏國泰96購01  ,0,0,0,0,0,0,0,0,0,5000,0,0,0,5000,0,5000,5000
050540,台積電凱基94購38,0,0,0,0,0,0,0,0,0,5000,0,0,0,5000,0,5000,5000
049554,禾伸堂富邦96購01,0,0,0,0,0,0,0,0,0,5000,0,0,0,5000,0,5000,5000
04999P,南電永豐95售01  ,0,0,0,0,0,0,0,0,0,5000,0,0,0,5000,0,5000,5000
050100,台積電永昌96購02,0,0,0,0,0,0,0,0,0,5000,0,0,0,5000,0,5000,5000
050101,台積電永昌96購03,0,0,0,0,0,0,0,0,0,5000,0,0,0,5000,0,5000,5000
050142,聯發科元富9A購01,0,0,0,0,0,0,0,0,0,5000,0,0,0,5000,0,5000,5000
050123,群臺反凱基96購01,0,0,0,0,0,0,0,0,0,5000,0,0,0,5000,0,5000,5000
052785,滬深2X中信99購03,0,0,0,0,0,0,0,0,0,5000,0,0,0,5000,0,5000,5000
054140,智易元大97購03  ,0,0,0,0,0,0,0,0,0,5000,0,0,0,5000,0,5000,5000
054104,T50反1凱基9A購02,0,0,0,0,0,0,0,0,0,5000,0,0,0,7000,2000,5000,5000
054180,亞泥康和96購01  ,0,0,0,0,0,0,0,0,0,5000,0,0,0,78000,73000,5000,5000
052743,華新科元大97購01,0,0,0,0,0,0,0,0,0,5000,0,0,0,5000,0,5000,5000
052766,玉晶光群益9A購01,0,0,0,0,0,0,0,0,0,5000,0,0,0,5000,0,5000,5000
048509,上証反凱基99購02,0,0,0,0,0,0,0,0,0,5000,0,0,0,5000,0,5000,5000
048602,上緯控國票96購01,0,0,0,0,0,0,0,0,0,5000,0,0,0,5000,0,5000,5000
04843P,致新元大94售02  ,0,0,0,0,0,0,0,0,0,5000,0,0,0,5000,0,5000,5000
048417,國巨統一94購01  ,0,0,0,0,0,0,0,0,0,5000,0,0,0,5000,0,5000,5000
03267P,台灣50元大02售06,0,0,0,0,0,0,0,0,0,5000,0,0,0,5000,0,5000,5000
03650C,T50反1元大98牛05,0,0,0,0,0,0,0,0,0,5000,0,0,0,5000,0,5000,5000
04383P,泰鼎國泰95售01  ,0,0,0,0,0,0,0,0,0,5000,0,0,0,5000,0,5000,5000
050710,元黃金中信96購01,0,0,0,0,0,0,0,0,0,5000,0,0,0,5000,0,5000,5000
050651,大立光凱基96購02,0,0,0,0,0,0,0,0,0,5000,0,0,0,5000,0,5000,5000
044972,元金2X國票96購01,0,0,0,0,0,0,0,0,0,5000,0,0,0,5000,0,5000,5000
044088,國巨元富95購01  ,0,0,0,0,0,0,0,0,0,5000,0,0,0,5000,0,5000,5000
050811,國巨凱基95購02  ,0,0,0,0,0,0,0,0,0,5000,0,0,0,5000,0,5000,5000
050982,台積電國泰96購04,0,0,0,0,0,0,0,0,0,5000,0,0,0,5000,0,5000,5000
051245,南亞科元大95購01,0,0,0,0,0,0,0,0,0,5000,0,0,0,5000,0,5000,5000
051039,台表科康和95購01,0,0,0,0,0,0,0,0,0,5000,0,0,0,5000,0,5000,5000
051380,禾伸堂群益95購01,0,0,0,0,0,0,0,0,0,5000,0,0,0,5000,0,5000,5000
047774,台表科元大95購01,0,0,0,0,0,0,0,0,0,5000,0,0,0,5000,0,5000,5000
047768,大立光元大95購01,0,0,0,0,0,0,0,0,0,5000,0,0,0,5000,0,5000,5000
04798P,牧德元大95售02  ,0,0,0,0,0,0,0,0,0,5000,0,0,0,5000,0,5000,5000
04627P,聯發科元大94售08,0,0,0,0,0,0,0,0,0,5000,0,0,0,5000,0,5000,5000
055758,旺宏群益97購01  ,0,0,0,0,0,0,0,0,0,5000,0,0,0,5000,0,5000,5000
058419,聯發科麥證99購02,0,0,0,0,0,0,0,0,0,5000,0,0,0,5000,0,5000,5000
055781,聯詠凱基98購01  ,0,0,0,0,0,0,0,0,0,5000,0,0,0,5000,0,5000,5000
056664,上証反中信9B購01,0,0,0,0,0,0,0,0,0,5000,0,0,0,10000,5000,5000,5000
056632,鴻海永昌98購01  ,0,0,0,0,0,0,0,0,0,5000,0,0,0,5000,0,5000,5000
057084,立積統一9B購01  ,0,0,0,0,0,0,0,0,0,5000,0,0,0,5000,0,5000,5000
057146,技嘉國票98購01  ,0,0,0,0,0,0,0,0,0,5000,0,0,0,5000,0,5000,5000
056964,聯發科永豐98購03,0,0,0,0,0,0,0,0,0,5000,0,0,0,5000,0,5000,5000
057611,技嘉元富98購02  ,0,0,0,0,0,0,0,0,0,5000,0,0,0,5000,0,5000,5000
057613,瑞昱元富02購02  ,0,0,0,0,0,0,0,0,0,5000,0,0,0,5000,0,5000,5000
057696,聯電群益9A購01  ,0,0,0,0,0,0,0,0,0,5000,0,0,0,30000,25000,5000,5000
057627,和大永豐98購01  ,0,0,0,0,0,0,0,0,0,5000,0,0,0,5000,0,5000,5000
057326,景碩群益99購02  ,0,0,0,0,0,0,0,0,0,5000,0,0,0,5000,0,5000,5000
05683P,矽創元大96售01  ,0,0,0,0,0,0,0,0,0,5000,0,0,0,5000,0,5000,5000
057299,立積永豐98購02  ,0,0,0,0,0,0,0,0,0,5000,0,0,0,30000,25000,5000,5000
056890,國巨元大98購11  ,0,0,0,0,0,0,0,0,0,5000,0,0,0,11000,6000,5000,5000
054557,臻鼎凱基98購01  ,0,0,0,0,0,0,0,0,0,5000,0,0,0,5000,0,5000,5000
054594,國巨麥證97購01  ,0,0,0,0,0,0,0,0,0,5000,0,0,0,5000,0,5000,5000
054696,嘉聯益永豐97購01,0,0,0,0,0,0,0,0,0,5000,0,0,0,5000,0,5000,5000
058776,台積電國票9A購03,0,0,0,0,0,0,0,0,0,5000,0,0,0,5000,0,5000,5000
058773,和碩兆豐99購01  ,0,0,0,0,0,0,0,0,0,5000,0,0,0,5000,0,5000,5000
058783,臺股指國票99購02,0,0,0,0,0,0,0,0,0,5000,0,0,0,5000,0,5000,5000
058785,臺股指國票99購04,0,0,0,0,0,0,0,0,0,5000,0,0,0,5000,0,5000,5000
058817,嘉聯益台新99購01,0,0,0,0,0,0,0,0,0,5000,0,0,0,55000,50000,5000,5000
058799,晶技元大99購04  ,0,0,0,0,0,0,0,0,0,5000,0,0,0,11000,6000,5000,5000
058825,同欣電富邦9A購01,0,0,0,0,0,0,0,0,0,5000,0,0,0,5000,0,5000,5000
059003,中壽元大99購01  ,0,0,0,0,0,0,0,0,0,5000,0,0,0,5000,0,5000,5000
059166,友達凱基99購05  ,0,0,0,0,0,0,0,0,0,5000,0,0,0,5000,0,5000,5000
059242,南亞科凱基99購06,0,0,0,0,0,0,0,0,0,5000,0,0,0,5000,0,5000,5000
059226,臺股指元大99購19,0,0,0,0,0,0,0,0,0,5000,0,0,0,5000,0,5000,5000
059190,欣興富邦9A購01  ,0,0,0,0,0,0,0,0,0,5000,0,0,0,5000,0,5000,5000
05603P,聯發科元大96售09,0,0,0,0,0,0,0,0,0,5000,0,0,0,5000,0,5000,5000
056056,旺宏元大97購06  ,0,0,0,0,0,0,0,0,0,5000,0,0,0,5000,0,5000,5000
056194,聯發科富邦9B購01,0,0,0,0,0,0,0,0,0,5000,0,0,0,5000,0,5000,5000
056116,義隆群益97購02  ,0,0,0,0,0,0,0,0,0,5000,0,0,0,135000,130000,5000,5000
056132,台光電元大97購03,0,0,0,0,0,0,0,0,0,5000,0,0,0,5000,0,5000,5000
056516,晶豪科兆豐98購01,0,0,0,0,0,0,0,0,0,5000,0,0,0,5000,0,5000,5000
056570,旺宏元大98購07  ,0,0,0,0,0,0,0,0,0,5000,0,0,0,5000,0,5000,5000
055934,景碩群益98購03  ,0,0,0,0,0,0,0,0,0,5000,0,0,0,5000,0,5000,5000
055942,臺股指群益9C購01,0,0,0,0,0,0,0,0,0,5000,0,0,0,5000,0,5000,5000
058713,國巨統一9B購02  ,0,0,0,0,0,0,0,0,0,5000,0,0,0,5000,0,5000,5000
054846,瑞昱兆豐97購01  ,0,0,0,0,0,0,0,0,0,5000,0,0,0,5000,0,5000,5000
055029,帆宣國泰99購01  ,0,0,0,0,0,0,0,0,0,5000,0,0,0,5000,0,5000,5000
055035,興勤富邦98購01  ,0,0,0,0,0,0,0,0,0,5000,0,0,0,5000,0,5000,5000
05511P,T50反1台新06售01,0,0,0,0,0,0,0,0,0,5000,0,0,0,5000,0,5000,5000
054955,宏達電元大98購01,0,0,0,0,0,0,0,0,0,5000,0,0,0,5000,0,5000,5000
055268,和大元大97購01  ,0,0,0,0,0,0,0,0,0,5000,0,0,0,5000,0,5000,5000
055176,大毅統一98購02  ,0,0,0,0,0,0,0,0,0,5000,0,0,0,5000,0,5000,5000
056368,祥碩元大98購02  ,0,0,0,0,0,0,0,0,0,5000,0,0,0,5000,0,5000,5000
057417,國巨凱基9A購03  ,0,0,0,0,0,0,0,0,0,5000,0,0,0,5000,0,5000,5000
057394,台積電中信9C購02,0,0,0,0,0,0,0,0,0,5000,0,0,0,5000,0,5000,5000
057378,康友元大98購02  ,0,0,0,0,0,0,0,0,0,5000,0,0,0,10000,5000,5000,5000
057776,京元電群益98購02,0,0,0,0,0,0,0,0,0,5000,0,0,0,5000,0,5000,5000
055375,京鼎元大97購03  ,0,0,0,0,0,0,0,0,0,5000,0,0,0,5000,0,5000,5000
055360,台表科凱基97購02,0,0,0,0,0,0,0,0,0,5000,0,0,0,5000,0,5000,5000
058149,百和元大99購02  ,0,0,0,0,0,0,0,0,0,5000,0,0,0,28000,23000,5000,5000
055460,華擎永豐97購01  ,0,0,0,0,0,0,0,0,0,5000,0,0,0,5000,0,5000,5000
056426,上証2X凱基9A購01,0,0,0,0,0,0,0,0,0,5000,0,0,0,5000,0,5000,5000
058567,華新科凱基9A購02,0,0,0,0,0,0,0,0,0,5000,0,0,0,10000,5000,5000,5000
058581,大立光群益99購05,0,0,0,0,0,0,0,0,0,5000,0,0,0,12000,7000,5000,5000
8374,羅昇            ,6000,1000,5000,0,0,0,0,0,0,0,0,0,0,0,0,0,5000
9930,中聯資源        ,30000,25000,5000,0,0,0,0,0,0,0,0,0,0,0,0,0,5000
06274P,臺股指凱基97售06,0,0,0,0,0,0,0,0,0,4000,0,0,0,4000,0,4000,4000
06447P,上銀元大98售01  ,0,0,0,0,0,0,0,0,0,4000,0,0,0,4000,0,4000,4000
06704P,玉晶光元富98售05,0,0,0,0,0,0,0,0,0,4000,0,0,0,9000,5000,4000,4000
06821P,臺股指元富98售10,0,0,0,0,0,0,0,0,0,4000,0,0,0,6000,2000,4000,4000
06016P,京元電凱基96售03,0,0,0,0,0,0,0,0,0,4000,0,0,0,5000,1000,4000,4000
059785,美律元大9A購03  ,0,0,0,0,0,0,0,0,0,4000,0,0,0,41000,37000,4000,4000
059973,A50正2元大99購02,0,0,0,0,0,0,0,0,0,4000,0,0,0,4000,0,4000,4000
059369,滬深2X元富9C購01,0,0,0,0,0,0,0,0,0,4000,0,0,0,108000,104000,4000,4000
059426,鴻海元大99購31  ,0,0,0,0,0,0,0,0,0,4000,0,0,0,7000,3000,4000,4000
059600,緯穎元大99購07  ,0,0,0,0,0,0,0,0,0,4000,0,0,0,4000,0,4000,4000
059595,華新科元大9A購03,0,0,0,0,0,0,0,0,0,4000,0,0,0,54000,50000,4000,4000
07098P,台積電元大99售18,0,0,0,0,0,0,0,0,0,4000,0,0,0,64000,60000,4000,4000
07099P,台積電元大99售19,0,0,0,0,0,0,0,0,0,4000,0,0,0,4000,0,4000,4000
07274P,上証2X群益01售01,0,0,0,0,0,0,0,0,0,4000,0,0,0,12000,8000,4000,4000
1537,廣隆            ,37000,33000,4000,0,0,0,0,0,0,0,0,0,0,0,0,0,4000
1529,樂士            ,3000,2000,1000,0,0,0,0,0,0,3000,3000,0,3000,0,0,0,4000
1465,偉全            ,4000,0,4000,0,0,0,0,0,0,0,0,0,0,0,0,0,4000
1340,勝悅-KY         ,13000,9000,4000,0,0,0,0,0,0,0,0,0,0,0,0,0,4000
2891C,中信金丙特      ,0,0,0,0,0,0,0,0,0,4000,4000,0,4000,0,0,0,4000
2706,第一店          ,6000,2000,4000,0,0,0,0,0,0,0,0,0,0,0,0,0,4000
3686,達能            ,4000,0,4000,0,0,0,0,0,0,0,0,0,0,0,0,0,4000
6581,鋼聯            ,8000,4000,4000,0,0,0,0,0,0,0,0,0,0,0,0,0,4000
00689R,國泰20年美債反1 ,0,0,0,0,0,0,0,0,0,4000,0,0,0,104000,100000,4000,4000
00757,統一FANG+       ,0,0,0,0,0,0,144000,0,144000,-140000,0,0,0,200000,340000,-140000,4000
050807,群臺反凱基95購01,0,0,0,0,0,0,0,0,0,4000,0,0,0,4000,0,4000,4000
050727,華新科國票94購09,0,0,0,0,0,0,0,0,0,4000,0,0,0,4000,0,4000,4000
050867,聯鈞永豐95購01  ,0,0,0,0,0,0,0,0,0,4000,0,0,0,4000,0,4000,4000
050645,台積電凱基94購39,0,0,0,0,0,0,0,0,0,4000,0,0,0,24000,20000,4000,4000
050685,緯穎元富94購02  ,0,0,0,0,0,0,0,0,0,4000,0,0,0,4000,0,4000,4000
042953,鴻海台新01購01  ,0,0,0,0,0,0,0,0,0,4000,0,0,0,4000,0,4000,4000
04047P,華邦電元大94售03,0,0,0,0,0,0,0,0,0,4000,0,0,0,4000,0,4000,4000
048506,華通群益94購03  ,0,0,0,0,0,0,0,0,0,4000,0,0,0,4000,0,4000,4000
048707,南電國票95購01  ,0,0,0,0,0,0,0,0,0,4000,0,0,0,70000,66000,4000,4000
05401P,聯茂永豐95售03  ,0,0,0,0,0,0,0,0,0,4000,0,0,0,4000,0,4000,4000
052715,可成凱基96購01  ,0,0,0,0,0,0,0,0,0,4000,0,0,0,45000,41000,4000,4000
052886,世紀鋼兆豐96購01,0,0,0,0,0,0,0,0,0,4000,0,0,0,8000,4000,4000,4000
054137,聯詠元大97購02  ,0,0,0,0,0,0,0,0,0,4000,0,0,0,4000,0,4000,4000
052789,台積電麥證96購01,0,0,0,1000,0,1000,0,0,0,4000,0,0,0,4000,0,4000,4000
052800,國巨元大96購05  ,0,0,0,0,0,0,0,0,0,4000,0,0,0,4000,0,4000,4000
052831,華固群益96購01  ,0,0,0,0,0,0,0,0,0,4000,0,0,0,4000,0,4000,4000
04976P,中磊凱基94售01  ,0,0,0,0,0,0,0,0,0,4000,0,0,0,4000,0,4000,4000
050486,可成元富94購05  ,0,0,0,0,0,0,0,0,0,4000,0,0,0,4000,0,4000,4000
049270,台表科元大95購02,0,0,0,0,0,0,0,0,0,4000,0,0,0,4000,0,4000,4000
054299,南電元大96購03  ,0,0,0,0,0,0,0,0,0,4000,0,0,0,4000,0,4000,4000
051471,國巨凱基97購01  ,0,0,0,0,0,0,0,0,0,4000,0,0,0,4000,0,4000,4000
054211,奇鋐國票97購03  ,0,0,0,0,0,0,0,0,0,4000,0,0,0,70000,66000,4000,4000
054255,亞光元大96購05  ,0,0,0,0,0,0,0,0,0,4000,0,0,0,10000,6000,4000,4000
051990,泰碩元大95購01  ,0,0,0,0,0,0,0,0,0,4000,0,0,0,4000,0,4000,4000
052132,旺宏凱基9B購01  ,0,0,0,0,0,0,0,0,0,4000,0,0,0,4000,0,4000,4000
051672,玉晶光元大96購03,0,0,0,0,0,0,0,0,0,4000,0,0,0,54000,50000,4000,4000
051749,矽力國泰97購01  ,0,0,0,0,0,0,0,0,0,4000,0,0,0,4000,0,4000,4000
051756,台積電元大97購04,0,0,0,0,0,0,0,0,0,4000,0,0,0,4000,0,4000,4000
053355,超眾兆豐97購01  ,0,0,0,0,0,0,0,0,0,4000,0,0,0,4000,0,4000,4000
053330,燿華永豐96購03  ,0,0,0,0,0,0,0,0,0,4000,0,0,0,4000,0,4000,4000
053338,台光電國票97購01,0,0,0,0,0,0,0,0,0,4000,0,0,0,4000,0,4000,4000
058004,大立光群益98購03,0,0,0,0,0,0,0,0,0,4000,0,0,0,4000,0,4000,4000
057923,晶豪科凱基98購02,0,0,0,0,0,0,0,0,0,4000,0,0,0,4000,0,4000,4000
057503,世紀鋼群益98購02,0,0,0,0,0,0,0,0,0,4000,0,0,0,4000,0,4000,4000
058639,南電兆豐99購01  ,0,0,0,0,0,0,0,0,0,4000,0,0,0,4000,0,4000,4000
055477,同欣電凱基98購01,0,0,0,0,0,0,0,0,0,4000,0,0,0,4000,0,4000,4000
05549P,臺股指元大96售03,0,0,0,0,0,0,0,0,0,4000,0,0,0,5000,1000,4000,4000
058089,聯發科元大98購15,0,0,0,0,0,0,0,0,0,4000,0,0,0,4000,0,4000,4000
055221,矽創凱基97購02  ,0,0,0,0,0,0,0,0,0,4000,0,0,0,4000,0,4000,4000
054778,世紀鋼國票99購01,0,0,0,0,0,0,0,0,0,4000,0,0,0,4000,0,4000,4000
05473P,聯詠統一97售02  ,0,0,0,0,0,0,0,0,0,4000,0,0,0,4000,0,4000,4000
055931,冠德群益97購02  ,0,0,0,0,0,0,0,0,0,4000,0,0,0,4000,0,4000,4000
059257,臺股指凱基99購35,0,0,0,0,0,0,0,0,0,4000,0,0,0,10000,6000,4000,4000
058995,台達電元大99購01,0,0,0,0,0,0,0,0,0,4000,0,0,0,4000,0,4000,4000
058992,上証反元大99購02,0,0,0,0,0,0,0,0,0,4000,0,0,0,200000,196000,4000,4000
059042,世紀鋼群益99購02,0,0,0,0,0,0,0,0,0,4000,0,0,0,4000,0,4000,4000
058858,元油2X凱基9A購07,0,0,0,0,0,0,0,0,0,4000,0,0,0,4000,0,4000,4000
058800,健策元大99購03  ,0,0,0,0,0,0,0,0,0,4000,0,0,0,4000,0,4000,4000
05877P,大立光群益96售06,0,0,0,0,0,0,0,0,0,4000,0,0,0,4000,0,4000,4000
057194,南電元大98購01  ,0,0,0,0,0,0,0,0,0,4000,0,0,0,21000,17000,4000,4000
058515,健鼎元大99購01  ,0,0,0,0,0,0,0,0,0,4000,0,0,0,4000,0,4000,4000
056639,國產康和98購01  ,0,0,0,0,0,0,0,0,0,4000,0,0,0,72000,68000,4000,4000
056622,高鐵永豐98購01  ,0,0,0,0,0,0,0,0,0,4000,0,0,0,72000,68000,4000,4000
6698,旭暉應材        ,15000,13000,2000,0,0,0,0,0,0,2000,2000,0,2000,0,0,0,4000
3528,安馳            ,3000,0,3000,0,0,0,0,0,0,0,0,0,0,0,0,0,3000
4148,全宇生技-KY     ,12000,9000,3000,0,0,0,0,0,0,0,0,0,0,0,0,0,3000
2748,雲品            ,27000,0,27000,0,0,0,0,10000,-10000,-14000,0,14000,-14000,0,0,0,3000
2613,中櫃            ,8000,5000,3000,0,0,0,0,0,0,0,0,0,0,0,0,0,3000
2482,連宇            ,3000,0,3000,0,0,0,0,0,0,0,0,0,0,0,0,0,3000
1521,大億            ,5000,2000,3000,0,0,0,0,0,0,0,0,0,0,0,0,0,3000
1233,天仁            ,3000,0,3000,0,0,0,0,0,0,0,0,0,0,0,0,0,3000
2115,六暉-KY         ,3000,0,3000,0,0,0,0,0,0,0,0,0,0,0,0,0,3000
2239,英利-KY         ,11000,8000,3000,0,0,0,0,0,0,0,0,0,0,0,0,0,3000
1906,寶隆            ,56000,53000,3000,0,0,0,0,0,0,0,0,0,0,0,0,0,3000
07039P,南電台新99售01  ,0,0,0,0,0,0,0,0,0,3000,0,0,0,10000,7000,3000,3000
07169P,臺股指國票99售06,0,0,0,0,0,0,0,0,0,3000,0,0,0,508000,505000,3000,3000
059463,台灣50元大9C購07,0,0,0,0,0,0,0,0,0,3000,0,0,0,3000,0,3000,3000
059551,T50正2康和99購02,0,0,0,0,0,0,0,0,0,3000,0,0,0,3000,0,3000,3000
059392,臺股指凱基99購38,0,0,0,0,0,0,0,0,0,3000,0,0,0,4000,1000,3000,3000
059443,嘉聯益元大9B購01,0,0,0,0,0,0,0,0,0,3000,0,0,0,34000,31000,3000,3000
059471,華新科元大99購17,0,0,0,0,0,0,0,0,0,3000,0,0,0,60000,57000,3000,3000
059303,國巨兆豐99購04  ,0,0,0,0,0,0,0,0,0,3000,0,0,0,3000,0,3000,3000
059769,滬深2X群益9C購01,0,0,0,0,0,0,0,0,0,3000,0,0,0,3000,0,3000,3000
05966P,矽力凱基96售03  ,0,0,0,0,0,0,0,0,0,3000,0,0,0,3000,0,3000,3000
060004,臺指反群益9A購01,0,0,0,0,0,0,0,0,0,3000,0,0,0,15000,12000,3000,3000
06988P,鴻海元富99售09  ,0,0,0,0,0,0,0,0,0,3000,0,0,0,3000,0,3000,3000
06585P,鴻海元大99售04  ,0,0,0,0,0,0,0,0,0,3000,0,0,0,3000,0,3000,3000
06247P,同欣電元富97售02,0,0,0,0,0,0,0,0,0,3000,0,0,0,3000,0,3000,3000
06101P,聯發科日盛97售03,0,0,0,0,0,0,0,0,0,3000,0,0,0,3000,0,3000,3000
06152P,玉晶光元大98售06,0,0,0,0,0,0,0,0,0,3000,0,0,0,3000,0,3000,3000
057947,和碩國票99購01  ,0,0,0,0,0,0,0,0,0,3000,0,0,0,3000,0,3000,3000
05800P,台積電兆豐96售04,0,0,0,0,0,0,0,0,0,3000,0,0,0,3000,0,3000,3000
057842,緯穎富邦99購02  ,0,0,0,0,0,0,0,0,0,3000,0,0,0,3000,0,3000,3000
057840,健策富邦99購01  ,0,0,0,0,0,0,0,0,0,3000,0,0,0,3000,0,3000,3000
058385,創意中信99購01  ,0,0,0,0,0,0,0,0,0,3000,0,0,0,3000,0,3000,3000
053489,上銀兆豐97購01  ,0,0,0,0,0,0,0,0,0,3000,0,0,0,12000,9000,3000,3000
058163,道瓊反凱基9B購01,0,0,0,0,0,0,0,0,0,3000,0,0,0,3000,0,3000,3000
058231,技嘉元大99購02  ,0,0,0,0,0,0,0,0,0,3000,0,0,0,3000,0,3000,3000
053380,南亞科元大97購01,0,0,0,0,0,0,0,0,0,3000,0,0,0,3000,0,3000,3000
051606,華新科群益95購05,0,0,0,0,0,0,0,0,0,3000,0,0,0,3000,0,3000,3000
053481,同欣電元大97購01,0,0,0,0,0,0,0,0,0,3000,0,0,0,3000,0,3000,3000
054380,世芯群益97購02  ,0,0,0,0,0,0,0,0,0,3000,0,0,0,3000,0,3000,3000
054370,台積電中信9A購01,0,0,0,0,0,0,0,0,0,3000,0,0,0,3000,0,3000,3000
051544,T50反1康和98購01,0,0,0,0,0,0,0,0,0,3000,0,0,0,3000,0,3000,3000
054292,欣興元大96購06  ,0,0,0,0,0,0,0,0,0,3000,0,0,0,3000,0,3000,3000
054294,世芯元大96購02  ,0,0,0,0,0,0,0,0,0,3000,0,0,0,3000,0,3000,3000
052974,瀚宇博群益96購01,0,0,0,0,0,0,0,0,0,3000,0,0,0,3000,0,3000,3000
052979,上銀元大96購02  ,0,0,0,0,0,0,0,0,0,3000,0,0,0,3000,0,3000,3000
051560,玉晶光國泰97購03,0,0,0,0,0,0,0,0,0,3000,0,0,0,3000,0,3000,3000
053026,奇力新富邦98購01,0,0,0,0,0,0,0,0,0,3000,0,0,0,3000,0,3000,3000
053505,瑞儀兆豐97購01  ,0,0,0,0,0,0,0,0,0,3000,0,0,0,144000,141000,3000,3000
053581,台積電元大96購14,0,0,0,0,0,0,0,0,0,3000,0,0,0,3000,0,3000,3000
052300,力成台新95購01  ,0,0,0,0,0,0,0,0,0,3000,0,0,0,3000,0,3000,3000
05140P,台表科國票96售01,0,0,0,0,0,0,0,0,0,3000,0,0,0,13000,10000,3000,3000
048179,臻鼎富邦97購01  ,0,0,0,0,0,0,0,0,0,3000,0,0,0,3000,0,3000,3000
049611,緯穎兆豐95購02  ,0,0,0,0,0,0,0,0,0,3000,0,0,0,7000,4000,3000,3000
050059,旺宏凱基94購03  ,0,0,0,0,0,0,0,0,0,3000,0,0,0,3000,0,3000,3000
05013P,台積電元大96售05,0,0,0,0,0,0,0,0,0,3000,0,0,0,233000,230000,3000,3000
050218,世紀鋼統一94購02,0,0,0,0,0,0,0,0,0,3000,0,0,0,3000,0,3000,3000
052795,健策兆豐97購01  ,0,0,0,0,0,0,0,0,0,3000,0,0,0,3000,0,3000,3000
054060,晶技國票97購02  ,0,0,0,0,0,0,0,0,0,3000,0,0,0,3000,0,3000,3000
05291P,鴻海凱基95售16  ,0,0,0,0,0,0,0,0,0,3000,0,0,0,23000,20000,3000,3000
052827,昇陽半永豐97購01,0,0,0,0,0,0,0,0,0,3000,0,0,0,3000,0,3000,3000
04875P,台積電中信94售04,0,0,0,0,0,0,0,0,0,3000,0,0,0,3000,0,3000,3000
048897,日電貿國泰95購01,0,0,0,0,0,0,0,0,0,3000,0,0,0,3000,0,3000,3000
044475,國巨元富95購02  ,0,0,0,0,0,0,0,0,0,3000,0,0,0,3000,0,3000,3000
050894,旺宏元大96購03  ,0,0,0,0,0,0,0,0,0,3000,0,0,0,3000,0,3000,3000
04638P,臺股指群益94售13,0,0,0,0,0,0,0,0,0,3000,0,0,0,3000,0,3000,3000
03007X,元展07          ,0,0,0,0,0,0,0,0,0,3000,0,0,0,3000,0,3000,3000
04596P,臺股指元大94售14,0,0,0,0,0,0,0,0,0,3000,0,0,0,3000,0,3000,3000
044988,玉晶光統一95購01,0,0,0,0,0,0,0,0,0,3000,0,0,0,4000,1000,3000,3000
05841P,華通元大96售04  ,0,0,0,0,0,0,0,0,0,3000,0,0,0,3000,0,3000,3000
057548,微星凱基99購01  ,0,0,0,0,0,0,0,0,0,3000,0,0,0,3000,0,3000,3000
057009,信邦中信99購01  ,0,0,0,0,0,0,0,0,0,3000,0,0,0,3000,0,3000,3000
056996,矽力日盛99購01  ,0,0,0,0,0,0,0,0,0,3000,0,0,0,4000,1000,3000,3000
057129,聯發科凱基99購03,0,0,0,0,0,0,0,0,0,3000,0,0,0,3000,0,3000,3000
057085,立積統一9B購02  ,0,0,0,0,0,0,0,0,0,3000,0,0,0,3000,0,3000,3000
058414,大立光兆豐99購02,0,0,0,0,0,0,0,0,0,3000,0,0,0,3000,0,3000,3000
058536,群創統一9B購01  ,0,0,0,0,0,0,0,0,0,3000,0,0,0,3000,0,3000,3000
057692,臺股指凱基98購10,0,0,0,0,0,0,0,0,0,3000,0,0,0,3000,0,3000,3000
057200,技嘉元富98購01  ,0,0,0,0,0,0,0,0,0,3000,0,0,0,3000,0,3000,3000
057193,力成元大98購02  ,0,0,0,0,0,0,0,0,0,3000,0,0,0,3000,0,3000,3000
057259,台積電兆豐98購03,0,0,0,0,0,0,0,0,0,3000,0,0,0,3000,0,3000,3000
056849,瀚宇博元富98購01,0,0,0,0,0,0,0,0,0,3000,0,0,0,3000,0,3000,3000
058434,旺宏統一9B購01  ,0,0,0,0,0,0,0,0,0,3000,0,0,0,3000,0,3000,3000
058847,國巨群益99購05  ,0,0,0,0,0,0,0,0,0,3000,0,0,0,3000,0,3000,3000
056816,華通永豐98購02  ,0,0,0,0,0,0,0,0,0,3000,0,0,0,3000,0,3000,3000
059220,聯發科元大99購20,0,0,0,0,0,0,0,0,0,3000,0,0,0,3000,0,3000,3000
056560,旺宏群益98購03  ,0,0,0,0,0,0,0,0,0,3000,0,0,0,3000,0,3000,3000
056540,聯詠凱基98購02  ,0,0,0,0,0,0,0,0,0,3000,0,0,0,3000,0,3000,3000
056507,創意永豐98購02  ,0,0,0,0,0,0,0,0,0,3000,0,0,0,3000,0,3000,3000
056163,嘉聯益凱基98購03,0,0,0,0,0,0,0,0,0,3000,0,0,0,18000,15000,3000,3000
056145,緯穎元大98購03  ,0,0,0,0,0,0,0,0,0,3000,0,0,0,63000,60000,3000,3000
056188,晶相光統一99購01,0,0,0,0,0,0,0,0,0,3000,0,0,0,3000,0,3000,3000
056066,奇鋐元大98購02  ,0,0,0,0,0,0,0,0,0,3000,0,0,0,3000,0,3000,3000
056026,智易群益97購01  ,0,0,0,0,0,0,0,0,0,3000,0,0,0,3000,0,3000,3000
055996,矽力國泰99購01  ,0,0,0,0,0,0,0,0,0,3000,0,0,0,3000,0,3000,3000
05477P,華新科群益95售06,0,0,0,0,0,0,0,0,0,3000,0,0,0,3000,0,3000,3000
055241,T50反1統一99購01,0,0,0,0,0,0,0,0,0,3000,0,0,0,3000,0,3000,3000
055278,旺宏元大98購05  ,0,0,0,0,0,0,0,0,0,3000,0,0,0,3000,0,3000,3000
058717,南電台新99購02  ,0,0,0,0,0,0,0,0,0,3000,0,0,0,3000,0,3000,3000
058706,聯鈞元大9C購01  ,0,0,0,0,0,0,0,0,0,3000,0,0,0,3000,0,3000,3000
05487P,台表科凱基95售02,0,0,0,0,0,0,0,0,0,3000,0,0,0,3000,0,3000,3000
058090,聯發科元大98購16,0,0,0,0,0,0,0,0,0,3000,0,0,0,3000,0,3000,3000
055363,緯穎凱基98購03  ,0,0,0,0,0,0,0,0,0,3000,0,0,0,3000,0,3000,3000
057743,華擎永豐98購03  ,0,0,0,0,0,0,0,0,0,3000,0,0,0,3000,0,3000,3000
057418,台光電凱基98購04,0,0,0,0,0,0,0,0,0,3000,0,0,0,3000,0,3000,3000
057334,技嘉國票98購02  ,0,0,0,0,0,0,0,0,0,3000,0,0,0,3000,0,3000,3000
056394,晶豪科永豐98購01,0,0,0,0,0,0,0,0,0,3000,0,0,0,3000,0,3000,3000
058257,聯陽國泰9B購01  ,0,0,0,0,0,0,0,0,0,3000,0,0,0,3000,0,3000,3000
056440,智邦凱基98購03  ,0,0,0,0,0,0,0,0,0,3000,0,0,0,10000,7000,3000,3000
055515,聚陽中信9A購01  ,0,0,0,0,0,0,0,0,0,3000,0,0,0,3000,0,3000,3000
056503,楠梓電永豐98購01,0,0,0,0,0,0,0,0,0,3000,0,0,0,3000,0,3000,3000
056498,A50正2富邦9B購01,0,0,0,0,0,0,0,0,0,3000,0,0,0,3000,0,3000,3000
05865P,大立光元大96售09,0,0,0,0,0,0,0,0,0,3000,0,0,0,3000,0,3000,3000
05748P,臺股指群益99售02,0,0,0,0,0,0,0,0,0,3000,0,0,0,3000,0,3000,3000
9937,全國            ,8000,2000,6000,0,0,0,0,0,0,-3000,0,3000,-3000,0,0,0,3000
06177P,玉晶光元大98售07,0,0,0,0,0,0,0,0,0,2000,0,0,0,22000,20000,2000,2000
06232P,智易永豐97售01  ,0,0,0,0,0,0,0,0,0,2000,0,0,0,2000,0,2000,2000
06304P,臺股指元大97售10,0,0,0,0,0,0,0,0,0,2000,0,0,0,2000,0,2000,2000
06200P,聯發科元大97售18,0,0,0,0,0,0,0,0,0,2000,0,0,0,2000,0,2000,2000
06609P,元油2X凱基9B售06,0,0,0,0,0,0,0,0,0,2000,0,0,0,2000,0,2000,2000
06568P,國巨永豐98售05  ,0,0,0,0,0,0,0,0,0,2000,0,0,0,5000,3000,2000,2000
06330P,南亞科群益97售03,0,0,0,0,0,0,0,0,0,2000,0,0,0,2000,0,2000,2000
06976P,臺股指元大9A售14,0,0,0,0,0,0,0,0,0,2000,0,0,0,2000,0,2000,2000
06880P,鈺齊凱基98售03  ,0,0,0,0,0,0,0,0,0,2000,0,0,0,2000,0,2000,2000
060143,台積電國票9B購03,0,0,0,0,0,0,0,0,0,2000,0,0,0,26000,24000,2000,2000
060192,欣興元富9A購01  ,0,0,0,0,0,0,0,0,0,2000,0,0,0,13000,11000,2000,2000
059691,大立光永豐99購02,0,0,0,0,0,0,0,0,0,2000,0,0,0,5000,3000,2000,2000
059727,大立光元大9A購01,0,0,0,0,0,0,0,0,0,2000,0,0,0,2000,0,2000,2000
059957,中信金康和99購01,0,0,0,0,0,0,0,0,0,2000,0,0,0,2000,0,2000,2000
059321,欣興元大99購07  ,0,0,0,0,0,0,0,0,0,2000,0,0,0,14000,12000,2000,2000
059446,臺股指元大99購27,0,0,0,0,0,0,0,0,0,2000,0,0,0,2000,0,2000,2000
059603,臺股指元大9A購40,0,0,0,0,0,0,0,0,0,2000,0,0,0,10000,8000,2000,2000
059585,台灣50元大9C購10,0,0,0,0,0,0,0,0,0,2000,0,0,0,2000,0,2000,2000
059636,宏達電凱基99購05,0,0,0,0,0,0,0,0,0,2000,0,0,0,4000,2000,2000,2000
07177P,臺股指凱基99售19,0,0,0,0,0,0,0,0,0,2000,0,0,0,2000,0,2000,2000
07148P,富邦金元大99售01,0,0,0,0,0,0,0,0,0,2000,0,0,0,136000,134000,2000,2000
07217P,大立光凱基9A售05,0,0,0,0,0,0,0,0,0,2000,0,0,0,7000,5000,2000,2000
07034P,大立光元富99售03,0,0,0,0,0,0,0,0,0,2000,0,0,0,2000,0,2000,2000
07061P,台積電元大99售14,0,0,0,0,0,0,0,0,0,2000,0,0,0,2000,0,2000,2000
07021P,台積電富邦9C售02,0,0,0,0,0,0,0,0,0,2000,0,0,0,2000,0,2000,2000
07085P,超眾元富9C售01  ,0,0,0,0,0,0,0,0,0,2000,0,0,0,2000,0,2000,2000
07125P,台積電元大99售22,0,0,0,0,0,0,0,0,0,2000,0,0,0,2000,0,2000,2000
2062,橋椿            ,44000,42000,2000,0,0,0,0,0,0,0,0,0,0,0,0,0,2000
1614,三洋電          ,9000,7000,2000,0,0,0,0,0,0,0,0,0,0,0,0,0,2000
08602P,台灣50凱基96售04,0,0,0,0,0,0,0,0,0,2000,0,0,0,2000,0,2000,2000
1528,恩德            ,5000,3000,2000,0,0,0,0,0,0,0,0,0,0,0,0,0,2000
1414,東和            ,6000,4000,2000,0,0,0,0,0,0,0,0,0,0,0,0,0,2000
6283,淳安            ,57000,55000,2000,0,0,0,0,0,0,0,0,0,0,0,0,0,2000
04787P,台積電永昌96售04,0,0,0,0,0,0,0,0,0,2000,0,0,0,2000,0,2000,2000
045996,南電富邦94購01  ,0,0,0,0,0,0,0,0,0,2000,0,0,0,2000,0,2000,2000
046574,泰鼎國泰94購01  ,0,0,0,0,0,0,0,0,0,2000,0,0,0,2000,0,2000,2000
047579,大立光群益94購02,0,0,0,0,0,0,0,0,0,2000,0,0,0,2000,0,2000,2000
046476,鴻海統一96購01  ,0,0,0,0,0,0,0,0,0,2000,0,0,0,2000,0,2000,2000
03016X,元展16          ,0,0,0,0,0,0,0,0,0,2000,0,0,0,2000,0,2000,2000
00743,國泰中國A150    ,0,0,0,0,0,0,0,0,0,2000,0,0,0,2000,0,2000,2000
051074,矽力國票96購01  ,0,0,0,0,0,0,0,0,0,2000,0,0,0,2000,0,2000,2000
051075,智邦國泰97購01  ,0,0,0,0,0,0,0,0,0,2000,0,0,0,2000,0,2000,2000
051362,台郡元大95購04  ,0,0,0,0,0,0,0,0,0,2000,0,0,0,2000,0,2000,2000
051318,上銀國票96購01  ,0,0,0,0,0,0,0,0,0,2000,0,0,0,2000,0,2000,2000
04452P,超眾國泰95售01  ,0,0,0,0,0,0,0,0,0,2000,0,0,0,2000,0,2000,2000
040381,元金2X元富95購01,0,0,0,0,0,0,0,0,0,2000,0,0,0,2000,0,2000,2000
042501,台灣50凱基96購06,0,0,0,0,0,0,0,0,0,2000,0,0,0,2000,0,2000,2000
03763P,聯發科元富96售01,0,0,0,0,0,0,0,0,0,2000,0,0,0,2000,0,2000,2000
048747,華通元富97購01  ,0,0,0,0,0,0,0,0,0,2000,0,0,0,2000,0,2000,2000
048505,滬深2X群益99購03,0,0,0,0,0,0,0,0,0,2000,0,0,0,2000,0,2000,2000
05269P,臻鼎元大95售05  ,0,0,0,0,0,0,0,0,0,2000,0,0,0,2000,0,2000,2000
052867,晶技凱基96購01  ,0,0,0,0,0,0,0,0,0,2000,0,0,0,2000,0,2000,2000
052894,國巨群益96購03  ,0,0,0,0,0,0,0,0,0,2000,0,0,0,2000,0,2000,2000
052928,美律元大98購01  ,0,0,0,0,0,0,0,0,0,2000,0,0,0,2000,0,2000,2000
052799,上銀元大96購01  ,0,0,0,0,0,0,0,0,0,2000,0,0,0,2000,0,2000,2000
052821,晶技永豐96購01  ,0,0,0,0,0,0,0,0,0,2000,0,0,0,2000,0,2000,2000
050056,國巨凱基94購04  ,0,0,0,0,0,0,0,0,0,2000,0,0,0,2000,0,2000,2000
04957P,上証2X凱基96售02,0,0,0,0,0,0,0,0,0,2000,0,0,0,2000,0,2000,2000
049777,華新科統一94購06,0,0,0,0,0,0,0,0,0,2000,0,0,0,2000,0,2000,2000
048124,大立光元大95購03,0,0,0,0,0,0,0,0,0,2000,0,0,0,2000,0,2000,2000
051412,奇力新國票96購01,0,0,0,0,0,0,0,0,0,2000,0,0,0,2000,0,2000,2000
049497,茂林元大94購04  ,0,0,0,0,0,0,0,0,0,2000,0,0,0,2000,0,2000,2000
050406,台積電台新95購02,0,0,0,0,0,0,0,0,0,2000,0,0,0,2000,0,2000,2000
05050P,華通群益96售02  ,0,0,0,0,0,0,0,0,0,2000,0,0,0,2000,0,2000,2000
049254,台積電元大96購02,0,0,0,0,0,0,0,0,0,2000,0,0,0,2000,0,2000,2000
05060P,台達電富邦97售02,0,0,0,0,0,0,0,0,0,2000,0,0,0,2000,0,2000,2000
052385,滬深2X群益99購05,0,0,0,0,0,0,0,0,0,2000,0,0,0,2000,0,2000,2000
052552,智邦國票97購01  ,0,0,0,0,0,0,0,0,0,2000,0,0,0,2000,0,2000,2000
05182P,嘉晶統一95售03  ,0,0,0,0,0,0,0,0,0,2000,0,0,0,2000,0,2000,2000
051873,緯穎凱基95購02  ,0,0,0,0,0,0,0,0,0,2000,0,0,0,10000,8000,2000,2000
05255P,義隆凱基95售01  ,0,0,0,0,0,0,0,0,0,2000,0,0,0,2000,0,2000,2000
053528,南電中信9A購01  ,0,0,0,0,0,0,0,0,0,2000,0,0,0,2000,0,2000,2000
053195,玉晶光元富96購02,0,0,0,0,0,0,0,0,0,2000,0,0,0,38000,36000,2000,2000
053115,滬深2X中信97購01,0,0,0,0,0,0,0,0,0,2000,0,0,0,2000,0,2000,2000
051953,矽力元富95購03  ,0,0,0,0,0,0,0,0,0,2000,0,0,0,2000,0,2000,2000
053005,微星永豐96購01  ,0,0,0,0,0,0,0,0,0,2000,0,0,0,2000,0,2000,2000
053089,貿聯元大97購02  ,0,0,0,0,0,0,0,0,0,2000,0,0,0,2000,0,2000,2000
051461,聯詠國泰96購01  ,0,0,0,0,0,0,0,0,0,2000,0,0,0,2000,0,2000,2000
054249,技嘉元大96購03  ,0,0,0,0,0,0,0,0,0,2000,0,0,0,2000,0,2000,2000
054391,宏達電元富96購04,0,0,0,0,0,0,0,0,0,2000,0,0,0,205000,203000,2000,2000
051979,群創凱基97購01  ,0,0,0,0,0,0,0,0,0,2000,0,0,0,2000,0,2000,2000
052151,義隆富邦96購01  ,0,0,0,0,0,0,0,0,0,2000,0,0,0,2000,0,2000,2000
053972,華新科元大96購06,0,0,0,0,0,0,0,0,0,2000,0,0,0,63000,61000,2000,2000
053944,亞泥富邦97購01  ,0,0,0,0,0,0,0,0,0,2000,0,0,0,2000,0,2000,2000
051594,和碩元大96購01  ,0,0,0,0,0,0,0,0,0,2000,0,0,0,2000,0,2000,2000
051598,瑞昱兆豐95購01  ,0,0,0,0,0,0,0,0,0,2000,0,0,0,2000,0,2000,2000
051701,華通群益97購01  ,0,0,0,0,0,0,0,0,0,2000,0,0,0,2000,0,2000,2000
053272,鴻海元大96購17  ,0,0,0,0,0,0,0,0,0,2000,0,0,0,2000,0,2000,2000
053297,鎧勝中信98購01  ,0,0,0,0,0,0,0,0,0,2000,0,0,0,58000,56000,2000,2000
058340,高股息群益99購01,0,0,0,0,0,0,0,0,0,2000,0,0,0,2000,0,2000,2000
05349P,可成元富98售03  ,0,0,0,0,0,0,0,0,0,2000,0,0,0,2000,0,2000,2000
057832,聯發科元富02購05,0,0,0,0,0,0,0,0,0,2000,0,0,0,18000,16000,2000,2000
057933,聯發科群益98購06,0,0,0,0,0,0,0,0,0,2000,0,0,0,2000,0,2000,2000
058618,南電元大99購02  ,0,0,0,0,0,0,0,0,0,2000,0,0,0,10000,8000,2000,2000
056472,美律元大99購03  ,0,0,0,0,0,0,0,0,0,2000,0,0,0,2000,0,2000,2000
055522,道瓊反群益01購01,0,0,0,0,0,0,0,0,0,2000,0,0,0,2000,0,2000,2000
056444,南亞科凱基99購01,0,0,0,0,0,0,0,0,0,2000,0,0,0,2000,0,2000,2000
057364,國巨元大98購18  ,0,0,0,0,0,0,0,0,0,2000,0,0,0,2000,0,2000,2000
056367,祥碩元大98購01  ,0,0,0,0,0,0,0,0,0,2000,0,0,0,2000,0,2000,2000
056384,玉晶光國泰9A購02,0,0,0,0,0,0,0,0,0,2000,0,0,0,2000,0,2000,2000
056358,友訊元大99購01  ,0,0,0,0,0,0,0,0,0,2000,0,0,0,2000,0,2000,2000
057756,瑞昱日盛99購01  ,0,0,0,0,0,0,0,0,0,2000,0,0,0,2000,0,2000,2000
057789,上銀統一9A購01  ,0,0,0,0,0,0,0,0,0,2000,0,0,0,2000,0,2000,2000
058157,華通台新99購01  ,0,0,0,0,0,0,0,0,0,2000,0,0,0,2000,0,2000,2000
055264,國巨永豐98購01  ,0,0,0,0,0,0,0,0,0,2000,0,0,0,2000,0,2000,2000
055287,日電貿元大97購01,0,0,0,0,0,0,0,0,0,2000,0,0,0,2000,0,2000,2000
055995,華擎國泰99購01  ,0,0,0,0,0,0,0,0,0,2000,0,0,0,2000,0,2000,2000
055980,祥碩統一98購01  ,0,0,0,0,0,0,0,0,0,2000,0,0,0,2000,0,2000,2000
055977,南亞科統一97購01,0,0,0,0,0,0,0,0,0,2000,0,0,0,2000,0,2000,2000
056071,創意元大97購02  ,0,0,0,0,0,0,0,0,0,2000,0,0,0,2000,0,2000,2000
056195,群創富邦98購01  ,0,0,0,0,0,0,0,0,0,2000,0,0,0,2000,0,2000,2000
055613,全新國票98購01  ,0,0,0,0,0,0,0,0,0,2000,0,0,0,2000,0,2000,2000
056556,南電凱基98購01  ,0,0,0,0,0,0,0,0,0,2000,0,0,0,2000,0,2000,2000
055865,臺股指元大97購02,0,0,0,0,0,0,0,0,0,2000,0,0,0,2000,0,2000,2000
059269,臺股指中信9B購03,0,0,0,0,0,0,0,0,0,2000,0,0,0,2000,0,2000,2000
059057,聯發科凱基99購10,0,0,0,0,0,0,0,0,0,2000,0,0,0,2000,0,2000,2000
059138,台積電兆豐99購04,0,0,0,0,0,0,0,0,0,2000,0,0,0,2000,0,2000,2000
054559,台光電群益99購01,0,0,0,0,0,0,0,0,0,2000,0,0,0,2000,0,2000,2000
056825,深中小富邦9B購01,0,0,0,0,0,0,0,0,0,2000,0,0,0,2000,0,2000,2000
055722,聯鈞元大97購03  ,0,0,0,0,0,0,0,0,0,2000,0,0,0,2000,0,2000,2000
058875,台表科國票9A購02,0,0,0,0,0,0,0,0,0,2000,0,0,0,2000,0,2000,2000
058794,旺宏元大99購09  ,0,0,0,0,0,0,0,0,0,2000,0,0,0,2000,0,2000,2000
054576,健策元大98購03  ,0,0,0,0,0,0,0,0,0,2000,0,0,0,2000,0,2000,2000
054628,可成凱基98購01  ,0,0,0,0,0,0,0,0,0,2000,0,0,0,2000,0,2000,2000
057306,玉晶光兆豐99購01,0,0,0,0,0,0,0,0,0,2000,0,0,0,2000,0,2000,2000
056862,聯發科群益98購03,0,0,0,0,0,0,0,0,0,2000,0,0,0,2000,0,2000,2000
057197,立積台新98購01  ,0,0,0,0,0,0,0,0,0,2000,0,0,0,2000,0,2000,2000
058462,台積電兆豐99購01,0,0,0,0,0,0,0,0,0,2000,0,0,0,2000,0,2000,2000
056949,義隆統一98購01  ,0,0,0,0,0,0,0,0,0,2000,0,0,0,2000,0,2000,2000
057739,新日興富邦9B購01,0,0,0,0,0,0,0,0,0,2000,0,0,0,2000,0,2000,2000
054489,牧德台新97購02  ,0,0,0,0,0,0,0,0,0,2000,0,0,0,12000,10000,2000,2000
054491,瀚宇博台新96購02,0,0,0,0,0,0,0,0,0,2000,0,0,0,2000,0,2000,2000
057046,奇力新元大99購03,0,0,0,0,0,0,0,0,0,2000,0,0,0,2000,0,2000,2000
055862,矽力元大97購04  ,0,0,0,0,0,0,0,0,0,2000,0,0,0,2000,0,2000,2000
056685,光罩統一98購03  ,0,0,0,0,0,0,0,0,0,2000,0,0,0,2000,0,2000,2000
9905,大華            ,13000,11000,2000,0,0,0,0,0,0,0,0,0,0,0,0,0,2000
6205,詮欣            ,0,0,0,0,0,0,0,0,0,1000,1000,0,1000,0,0,0,1000
6117,迎廣            ,1000,0,1000,0,0,0,0,0,0,0,0,0,0,0,0,0,1000
4764,雙鍵            ,4000,3000,1000,0,0,0,0,0,0,0,0,0,0,0,0,0,1000
4906,正文            ,386000,395000,-9000,0,0,0,0,0,0,10000,5000,20000,-15000,25000,0,25000,1000
3550,聯穎            ,3000,3000,0,0,0,0,0,0,0,1000,1000,0,1000,0,0,0,1000
3593,力銘            ,1000,0,1000,0,0,0,0,0,0,0,0,0,0,0,0,0,1000
3694,海華            ,4000,4000,0,0,0,0,0,0,0,1000,1000,0,1000,0,0,0,1000
3167,大量            ,2000,1000,1000,0,0,0,0,0,0,0,0,0,0,0,0,0,1000
2527,宏璟            ,21000,20000,1000,0,0,0,0,0,0,0,0,0,0,0,0,0,1000
2936,客思達-KY       ,1000,0,1000,0,0,0,0,0,0,0,0,0,0,0,0,0,1000
1525,江申            ,2000,1000,1000,0,0,0,0,0,0,0,0,0,0,0,0,0,1000
1808,潤隆            ,95000,94000,1000,0,0,0,0,0,0,0,0,0,0,0,0,0,1000
1817,凱撒衛          ,5000,5000,0,0,0,0,0,0,0,1000,1000,0,1000,0,0,0,1000
1783,和康生          ,29000,28000,1000,0,0,0,0,0,0,0,0,0,0,0,0,0,1000
1718,中纖            ,799000,799000,0,0,0,0,0,0,0,1000,1000,0,1000,0,0,0,1000
2010,春源            ,35000,34000,1000,0,0,0,0,0,0,0,0,0,0,0,0,0,1000
2002A,中鋼特          ,0,0,0,0,0,0,0,0,0,1000,1000,0,1000,0,0,0,1000
07000P,T50反1元大99售03,0,0,0,0,0,0,0,0,0,1000,0,0,0,1000,0,1000,1000
07043P,國巨元大99售14  ,0,0,0,0,0,0,0,0,0,1000,0,0,0,1000,0,1000,1000
07216P,大立光凱基99售08,0,0,0,0,0,0,0,0,0,1000,0,0,0,1000,0,1000,1000
07239P,台灣50國票9A售04,0,0,0,0,0,0,0,0,0,1000,0,0,0,12000,11000,1000,1000
07158P,FBVIX國泰9C售01 ,0,0,0,0,0,0,0,0,0,1000,0,0,0,1000,0,1000,1000
07201P,臺股指元大99售17,0,0,0,0,0,0,0,0,0,1000,0,0,0,1000,0,1000,1000
07346P,FBVIX群益99售04 ,0,0,0,0,0,0,0,0,0,1000,0,0,0,1000,0,1000,1000
07385P,緯穎群益99售04  ,0,0,0,0,0,0,0,0,0,1000,0,0,0,6000,5000,1000,1000
059644,茂林凱基99購03  ,0,0,0,0,0,0,0,0,0,1000,0,0,0,1000,0,1000,1000
059561,滬深2X凱基9C購05,0,0,0,0,0,0,0,0,0,1000,0,0,0,1000,0,1000,1000
059495,台灣50元富9C購02,0,0,0,0,0,0,0,0,0,1000,0,0,0,25000,24000,1000,1000
059393,臺股指凱基99購39,0,0,0,0,0,0,0,0,0,1000,0,0,0,2000,1000,1000,1000
059412,臺股指國票99購18,0,0,0,0,0,0,0,0,0,1000,0,0,0,1000,0,1000,1000
059367,台灣50元富01購03,0,0,0,0,0,0,0,0,0,1000,0,0,0,1000,0,1000,1000
059877,康控凱基99購05  ,0,0,0,0,0,0,0,0,0,1000,0,0,0,49000,48000,1000,1000
059776,台灣50元大9C購17,0,0,0,0,0,0,0,0,0,1000,0,0,0,3000,2000,1000,1000
059761,國巨永豐99購06  ,0,0,0,0,0,0,0,0,0,1000,0,0,0,8000,7000,1000,1000
059710,上証2X元大9C購02,0,0,0,0,0,0,0,0,0,1000,0,0,0,1000,0,1000,1000
059661,大立光元大99購22,0,0,0,0,0,0,0,0,0,1000,0,0,0,1000,0,1000,1000
059653,台灣50元大99購08,0,0,0,0,0,0,0,0,0,1000,0,0,0,1000,0,1000,1000
060151,旺宏富邦9A購02  ,0,0,0,0,0,0,0,0,0,1000,0,0,0,40000,39000,1000,1000
060036,上証2X國票99購03,0,0,0,0,0,0,0,0,0,1000,0,0,0,2000,1000,1000,1000
060070,國巨元富99購02  ,0,0,0,0,0,0,0,0,0,1000,0,0,0,35000,34000,1000,1000
060076,台灣50台新9B購05,0,0,0,0,0,0,0,0,0,1000,0,0,0,1000,0,1000,1000
060113,祥碩元大9B購01  ,0,0,0,0,0,0,0,0,0,1000,0,0,0,4000,3000,1000,1000
06855P,聯發科富邦9A售01,0,0,0,0,0,0,0,0,0,1000,0,0,0,1000,0,1000,1000
06977P,臺股指元大9A售15,0,0,0,0,0,0,0,0,0,1000,0,0,0,1000,0,1000,1000
06995P,臺股指凱基99售16,0,0,0,0,0,0,0,0,0,1000,0,0,0,1000,0,1000,1000
06954P,大立光元富99售01,0,0,0,0,0,0,0,0,0,1000,0,0,0,23000,22000,1000,1000
06846P,美律元大98售05  ,0,0,0,0,0,0,0,0,0,1000,0,0,0,1000,0,1000,1000
06760P,台積電元大98售18,0,0,0,0,0,0,0,0,0,1000,0,0,0,1000,0,1000,1000
06730P,祥碩元大98售07  ,0,0,0,0,0,0,0,0,0,1000,0,0,0,2000,1000,1000,1000
06434P,超眾群益98售02  ,0,0,0,0,0,0,0,0,0,1000,0,0,0,1000,0,1000,1000
06550P,健策元大99售01  ,0,0,0,0,0,0,0,0,0,1000,0,0,0,1000,0,1000,1000
06500P,臺股指元大9A售05,0,0,0,0,0,0,0,0,0,1000,0,0,0,3000,2000,1000,1000
06573P,台積電永昌99售02,0,0,0,0,0,0,0,0,0,1000,0,0,0,1000,0,1000,1000
06303P,臺股指元大97售09,0,0,0,0,0,0,0,0,0,1000,0,0,0,2000,1000,1000,1000
06119P,大立光凱基98售04,0,0,0,0,0,0,0,0,0,1000,0,0,0,1000,0,1000,1000
057903,聯鈞永豐99購01  ,0,0,0,0,0,0,0,0,0,1000,0,0,0,1000,0,1000,1000
057912,美律日盛99購01  ,0,0,0,0,0,0,0,0,0,1000,0,0,0,4000,3000,1000,1000
057989,旺宏統一99購04  ,0,0,0,0,0,0,0,0,0,1000,0,0,0,20000,19000,1000,1000
058034,神達永豐98購02  ,0,0,0,0,0,0,0,0,0,1000,0,0,0,1000,0,1000,1000
058383,道瓊指中信9C購02,0,0,0,0,0,0,0,0,0,1000,0,0,0,1000,0,1000,1000
058370,聯詠凱基99購01  ,0,0,0,0,0,0,0,0,0,1000,0,0,0,1000,0,1000,1000
058198,瑞昱亞東99購01  ,0,0,0,0,0,0,0,0,0,1000,0,0,0,1000,0,1000,1000
058191,祥碩永豐99購01  ,0,0,0,0,0,0,0,0,0,1000,0,0,0,1000,0,1000,1000
053307,泰碩凱基97購01  ,0,0,0,0,0,0,0,0,0,1000,0,0,0,1000,0,1000,1000
051640,GIS國票96購03   ,0,0,0,0,0,0,0,0,0,1000,0,0,0,1000,0,1000,1000
053323,群創群益98購07  ,0,0,0,0,0,0,0,0,0,1000,0,0,0,1000,0,1000,1000
053706,S&P反1凱基99購01,0,0,0,0,0,0,0,0,0,1000,0,0,0,1000,0,1000,1000
05395P,旺宏元大96售06  ,0,0,0,0,0,0,0,0,0,1000,0,0,0,1000,0,1000,1000
053960,晶技永豐96購02  ,0,0,0,0,0,0,0,0,0,1000,0,0,0,1000,0,1000,1000
053928,智易國票97購03  ,0,0,0,0,0,0,0,0,0,1000,0,0,0,1000,0,1000,1000
053973,晶豪科元大96購01,0,0,0,0,0,0,0,0,0,1000,0,0,0,1000,0,1000,1000
053979,健策元大98購01  ,0,0,0,0,0,0,0,0,0,1000,0,0,0,1000,0,1000,1000
053396,漢唐中信9A購01  ,0,0,0,0,0,0,0,0,0,1000,0,0,0,1000,0,1000,1000
053436,聯茂日盛96購01  ,0,0,0,0,0,0,0,0,0,1000,0,0,0,15000,14000,1000,1000
053816,聯發科群益96購02,0,0,0,0,0,0,0,0,0,1000,0,0,0,1000,0,1000,1000
053817,華新科群益97購02,0,0,0,0,0,0,0,0,0,1000,0,0,0,1000,0,1000,1000
053760,牧德國泰98購01  ,0,0,0,0,0,0,0,0,0,1000,0,0,0,1000,0,1000,1000
053884,緯穎第一96購01  ,0,0,0,0,0,0,0,0,0,1000,0,0,0,1000,0,1000,1000
052119,漢唐國票96購01  ,0,0,0,0,0,0,0,0,0,1000,0,0,0,1000,0,1000,1000
052109,可成元富95購01  ,0,0,0,0,0,0,0,0,0,1000,0,0,0,1000,0,1000,1000
052097,GIS元大95購05   ,0,0,0,0,0,0,0,0,0,1000,0,0,0,1000,0,1000,1000
052204,台泥中信96購01  ,0,0,0,0,0,0,0,0,0,1000,0,0,0,1000,0,1000,1000
052032,臺股指群益95購05,0,0,0,0,0,0,0,0,0,1000,0,0,0,1000,0,1000,1000
052067,中磊兆豐96購01  ,0,0,0,0,0,0,0,0,0,1000,0,0,0,50000,49000,1000,1000
054345,世芯國票96購02  ,0,0,0,0,0,0,0,0,0,1000,0,0,0,1000,0,1000,1000
054320,國喬台新96購01  ,0,0,0,0,0,0,0,0,0,1000,0,0,0,1000,0,1000,1000
054195,亞泥國泰98購01  ,0,0,0,0,0,0,0,0,0,1000,0,0,0,1000,0,1000,1000
051513,台積電凱基95購13,0,0,0,0,0,0,0,0,0,1000,0,0,0,1000,0,1000,1000
051486,玉晶光凱基97購03,0,0,0,0,0,0,0,0,0,1000,0,0,0,1000,0,1000,1000
051954,矽力元富95購04  ,0,0,0,0,0,0,0,0,0,1000,0,0,0,1000,0,1000,1000
054446,美食兆豐97購01  ,0,0,0,0,0,0,0,0,0,1000,0,0,0,1000,0,1000,1000
053521,緯穎群益96購02  ,0,0,0,0,0,0,0,0,0,1000,0,0,0,1000,0,1000,1000
05443P,宏達電元大95售05,0,0,0,0,0,0,0,0,0,1000,0,0,0,11000,10000,1000,1000
053629,玉山金兆豐96購01,0,0,0,0,0,0,0,0,0,1000,0,0,0,1000,0,1000,1000
052605,聯發科元大96購06,0,0,0,0,0,0,0,0,0,1000,0,0,0,1000,0,1000,1000
051948,滬深2X元富9B購01,0,0,0,0,0,0,0,0,0,1000,0,0,0,1000,0,1000,1000
05251P,喬山台新95售02  ,0,0,0,0,0,0,0,0,0,1000,0,0,0,1000,0,1000,1000
052456,滬深2X元富9B購03,0,0,0,0,0,0,0,0,0,1000,0,0,0,1000,0,1000,1000
05062P,大立光富邦98售03,0,0,0,0,0,0,0,0,0,1000,0,0,0,1000,0,1000,1000
049154,玉晶光元大95購02,0,0,0,0,0,0,0,0,0,1000,0,0,0,1000,0,1000,1000
050523,義隆元大94購05  ,0,0,0,0,0,0,0,0,0,1000,0,0,0,1000,0,1000,1000
050572,大立光中信97購01,0,0,0,0,0,0,0,0,0,1000,0,0,0,1000,0,1000,1000
049383,健策元大95購01  ,0,0,0,0,0,0,0,0,0,1000,0,0,0,1000,0,1000,1000
051424,緯穎國票97購01  ,0,0,0,0,0,0,0,0,0,1000,0,0,0,5000,4000,1000,1000
048263,台積電元富95購01,0,0,0,0,0,0,0,0,0,1000,0,0,0,1000,0,1000,1000
048221,鴻海凱基95購01  ,0,0,0,0,0,0,0,0,0,1000,0,0,0,1000,0,1000,1000
049724,南電第一94購01  ,0,0,0,0,0,0,0,0,0,1000,0,0,0,1000,0,1000,1000
049816,緯穎元大94購07  ,0,0,0,0,0,0,0,0,0,1000,0,0,0,1000,0,1000,1000
049885,緯穎永豐94購01  ,0,0,0,0,0,0,0,0,0,1000,0,0,0,1000,0,1000,1000
049939,臺股指元大94購20,0,0,0,0,0,0,0,0,0,1000,0,0,0,1000,0,1000,1000
050012,台積電國泰95購03,0,0,0,0,0,0,0,0,0,1000,0,0,0,1000,0,1000,1000
049980,奇力新凱基94購04,0,0,0,0,0,0,0,0,0,1000,0,0,0,1000,0,1000,1000
049985,華擎凱基94購01  ,0,0,0,0,0,0,0,0,0,1000,0,0,0,1000,0,1000,1000
050174,技嘉元大94購01  ,0,0,0,0,0,0,0,0,0,1000,0,0,0,1000,0,1000,1000
050115,群創元大96購01  ,0,0,0,0,0,0,0,0,0,1000,0,0,0,1000,0,1000,1000
052802,華新科元大97購02,0,0,0,0,0,0,0,0,0,1000,0,0,0,1000,0,1000,1000
054074,健策富邦98購01  ,0,0,0,0,0,0,0,0,0,1000,0,0,0,1000,0,1000,1000
05292P,台積電凱基95售16,0,0,0,0,0,0,0,0,0,1000,0,0,0,101000,100000,1000,1000
05415P,台積電台新95售04,0,0,0,0,0,0,0,0,0,1000,0,0,0,1000,0,1000,1000
052662,華新科國票97購01,0,0,0,0,0,0,0,0,0,1000,0,0,0,1000,0,1000,1000
052780,玉晶光國票96購04,0,0,0,0,0,0,0,0,0,1000,0,0,0,1000,0,1000,1000
052755,滬深2X群益9A購01,0,0,0,0,0,0,0,0,0,1000,0,0,0,1000,0,1000,1000
048681,漢唐富邦96購01  ,0,0,0,0,0,0,0,0,0,1000,0,0,0,31000,30000,1000,1000
036084,台灣50台新98購01,0,0,0,0,0,0,0,0,0,1000,0,0,0,1000,0,1000,1000
03038X,元展35          ,0,0,0,0,0,0,0,0,0,1000,0,0,0,1000,0,1000,1000
042793,台積電台新9C購01,0,0,0,0,0,0,0,0,0,1000,0,0,0,1000,0,1000,1000
04041P,大立光統一94售03,0,0,0,0,0,0,0,0,0,1000,0,0,0,1000,0,1000,1000
050714,深中小群益98購01,0,0,0,0,0,0,0,0,0,1000,0,0,0,1000,0,1000,1000
04807P,聯茂元富94售01  ,0,0,0,0,0,0,0,0,0,1000,0,0,0,1000,0,1000,1000
051222,世紀鋼元富95購01,0,0,0,0,0,0,0,0,0,1000,0,0,0,1000,0,1000,1000
050729,聯鈞國票94購01  ,0,0,0,0,0,0,0,0,0,1000,0,0,0,1000,0,1000,1000
050786,健策國泰96購01  ,0,0,0,0,0,0,0,0,0,1000,0,0,0,1000,0,1000,1000
050782,台積電國泰96購03,0,0,0,0,0,0,0,0,0,1000,0,0,0,1000,0,1000,1000
00742,新光內需收益    ,0,0,0,0,0,0,0,0,0,1000,0,0,0,101000,100000,1000,1000
020011,統一微波高息20N ,0,0,0,0,0,0,0,0,0,1000,0,0,0,1000,0,1000,1000
00767,FH美國金融股    ,0,0,0,0,0,0,0,0,0,1000,0,0,0,1000,0,1000,1000
047687,元金2X富邦96購01,0,0,0,0,0,0,0,0,0,1000,0,0,0,1000,0,1000,1000
047402,T50反1統一94購03,0,0,0,0,0,0,0,0,0,1000,0,0,0,1000,0,1000,1000
04715P,聯茂元大94售06  ,0,0,0,0,0,0,0,0,0,1000,0,0,0,1000,0,1000,1000
04695P,正崴康和94售01  ,0,0,0,0,0,0,0,0,0,1000,0,0,0,1000,0,1000,1000
046928,奇鋐富邦97購01  ,0,0,0,0,0,0,0,0,0,1000,0,0,0,1000,0,1000,1000
045992,鴻海富邦94購01  ,0,0,0,0,0,0,0,0,0,1000,0,0,0,1000,0,1000,1000
045768,大立光元富95購02,0,0,0,0,0,0,0,0,0,1000,0,0,0,1000,0,1000,1000
04617P,臺股指群益95售03,0,0,0,0,0,0,0,0,0,1000,0,0,0,1000,0,1000,1000
04776P,聯發科凱基94售06,0,0,0,0,0,0,0,0,0,1000,0,0,0,1000,0,1000,1000
056645,大立光凱基98購12,0,0,0,0,0,0,0,0,0,1000,0,0,0,1000,0,1000,1000
056603,嘉聯益國泰9A購01,0,0,0,0,0,0,0,0,0,1000,0,0,0,21000,20000,1000,1000
058420,聯發科麥證99購03,0,0,0,0,0,0,0,0,0,1000,0,0,0,1000,0,1000,1000
056275,國巨國泰98購04  ,0,0,0,0,0,0,0,0,0,1000,0,0,0,1000,0,1000,1000
056272,嘉澤統一99購01  ,0,0,0,0,0,0,0,0,0,1000,0,0,0,1000,0,1000,1000
057152,緯穎國票99購03  ,0,0,0,0,0,0,0,0,0,1000,0,0,0,1000,0,1000,1000
057153,祥碩國泰99購01  ,0,0,0,0,0,0,0,0,0,1000,0,0,0,1000,0,1000,1000
057169,微星元大98購01  ,0,0,0,0,0,0,0,0,0,1000,0,0,0,9000,8000,1000,1000
056992,祥碩兆豐98購01  ,0,0,0,0,0,0,0,0,0,1000,0,0,0,1000,0,1000,1000
057602,聯茂群益98購02  ,0,0,0,0,0,0,0,0,0,1000,0,0,0,1000,0,1000,1000
057596,聯茂兆豐99購01  ,0,0,0,0,0,0,0,0,0,1000,0,0,0,1000,0,1000,1000
057735,台灣50富邦9C購02,0,0,0,0,0,0,0,0,0,1000,0,0,0,1000,0,1000,1000
058487,晶技國票9A購01  ,0,0,0,0,0,0,0,0,0,1000,0,0,0,1000,0,1000,1000
057665,技嘉元大99購01  ,0,0,0,0,0,0,0,0,0,1000,0,0,0,10000,9000,1000,1000
057684,聯茂日盛99購01  ,0,0,0,0,0,0,0,0,0,1000,0,0,0,1000,0,1000,1000
057219,群創群益98購10  ,0,0,0,0,0,0,0,0,0,1000,0,0,0,1000,0,1000,1000
057190,立積元大9A購02  ,0,0,0,0,0,0,0,0,0,1000,0,0,0,1000,0,1000,1000
057260,微星兆豐98購01  ,0,0,0,0,0,0,0,0,0,1000,0,0,0,1000,0,1000,1000
056918,台積電兆豐98購01,0,0,0,0,0,0,0,0,0,1000,0,0,0,2000,1000,1000,1000
058798,大立光元大99購11,0,0,0,0,0,0,0,0,0,1000,0,0,0,1000,0,1000,1000
058846,鴻海群益99購03  ,0,0,0,0,0,0,0,0,0,1000,0,0,0,1000,0,1000,1000
058903,聯發科元大99購16,0,0,0,0,0,0,0,0,0,1000,0,0,0,1000,0,1000,1000
058900,旺宏元大99購11  ,0,0,0,0,0,0,0,0,0,1000,0,0,0,1000,0,1000,1000
05888P,友達元大97售01  ,40000,0,40000,0,0,0,0,0,0,-39000,0,0,0,184000,223000,-39000,1000
058891,元油2X元大9C購07,0,0,0,0,0,0,0,0,0,1000,0,0,0,1000,0,1000,1000
058918,SGBR2X元富99購04,0,0,0,0,0,0,0,0,0,1000,0,0,0,1000,0,1000,1000
058933,FBVIX台新9B購01 ,0,0,0,0,0,0,0,0,0,1000,0,0,0,5000,4000,1000,1000
055724,祥碩元大97購03  ,0,0,0,0,0,0,0,0,0,1000,0,0,0,1000,0,1000,1000
056713,華擎永豐98購01  ,0,0,0,0,0,0,0,0,0,1000,0,0,0,1000,0,1000,1000
056721,台灣50永昌9A購01,0,0,0,0,0,0,0,0,0,1000,0,0,0,1000,0,1000,1000
054522,康友元大96購07  ,0,0,0,0,0,0,0,0,0,1000,0,0,0,1000,0,1000,1000
05565P,鎧勝元大96售01  ,0,0,0,0,0,0,0,0,0,1000,0,0,0,1000,0,1000,1000
055671,世紀鋼群益97購01,0,0,0,0,0,0,0,0,0,1000,0,0,0,11000,10000,1000,1000
05567P,致伸群益96售01  ,0,0,0,0,0,0,0,0,0,1000,0,0,0,1000,0,1000,1000
055683,晶技凱基99購01  ,0,0,0,0,0,0,0,0,0,1000,0,0,0,1000,0,1000,1000
055687,瀚宇博凱基97購01,0,0,0,0,0,0,0,0,0,1000,0,0,0,31000,30000,1000,1000
055688,力成凱基98購02  ,0,0,0,0,0,0,0,0,0,1000,0,0,0,1000,0,1000,1000
056773,晶技元大99購03  ,0,0,0,0,0,0,0,0,0,1000,0,0,0,1000,0,1000,1000
056751,和大兆豐98購01  ,0,0,0,0,0,0,0,0,0,1000,0,0,0,1000,0,1000,1000
056747,致新凱基99購01  ,0,0,0,0,0,0,0,0,0,1000,0,0,0,1000,0,1000,1000
059117,禾伸堂永豐99購01,0,0,0,0,0,0,0,0,0,1000,0,0,0,40000,39000,1000,1000
058999,台積電元大99購24,0,0,0,0,0,0,0,0,0,1000,0,0,0,1000,0,1000,1000
059001,聯發科元大99購17,0,0,0,0,0,0,0,0,0,1000,0,0,0,1000,0,1000,1000
058990,GIS凱基99購02   ,0,0,0,0,0,0,0,0,0,1000,0,0,0,1000,0,1000,1000
058954,元油2X國票9A購07,0,0,0,0,0,0,0,0,0,1000,0,0,0,1000,0,1000,1000
059271,台灣50元大01購05,0,0,0,0,0,0,0,0,0,1000,0,0,0,1000,0,1000,1000
059275,可成元大99購05  ,0,0,0,0,0,0,0,0,0,1000,0,0,0,10000,9000,1000,1000
059211,鴻海元大99購27  ,0,0,0,0,0,0,0,0,0,1000,0,0,0,1000,0,1000,1000
059142,道瓊指國票9B購02,0,0,0,0,0,0,0,0,0,1000,0,0,0,1000,0,1000,1000
059143,國巨國票9A購04  ,0,0,0,0,0,0,0,0,0,1000,0,0,0,33000,32000,1000,1000
05918P,大立光元大96售11,0,0,0,0,0,0,0,0,0,1000,0,0,0,1000,0,1000,1000
056553,啟碁凱基98購02  ,0,0,0,0,0,0,0,0,0,1000,0,0,0,1000,0,1000,1000
054822,祥碩元大97購01  ,0,0,0,0,0,0,0,0,0,1000,0,0,0,1000,0,1000,1000
055606,矽創元大97購01  ,0,0,0,0,0,0,0,0,0,1000,0,0,0,1000,0,1000,1000
055582,亞德客元大97購01,0,0,0,0,0,0,0,0,0,1000,0,0,0,1000,0,1000,1000
056168,鴻海元富97購07  ,0,0,0,0,0,0,0,0,0,1000,0,0,0,108000,107000,1000,1000
056127,致新國票98購02  ,0,0,0,0,0,0,0,0,0,1000,0,0,0,1000,0,1000,1000
056135,緯創元大98購01  ,0,0,0,0,0,0,0,0,0,1000,0,0,0,1000,0,1000,1000
05608P,聯發科凱基96售10,0,0,0,0,0,0,0,0,0,1000,0,0,0,1000,0,1000,1000
055982,T50反1元富97購01,0,0,0,0,0,0,0,0,0,1000,0,0,0,5000,4000,1000,1000
056029,國巨麥證98購01  ,0,0,0,1000,0,1000,0,0,0,1000,0,0,0,1000,0,1000,1000
055246,美律統一98購01  ,0,0,0,0,0,0,0,0,0,1000,0,0,0,1000,0,1000,1000
055181,日電貿統一97購01,0,0,0,0,0,0,0,0,0,1000,0,0,0,1000,0,1000,1000
054791,泰碩群益99購02  ,0,0,0,0,0,0,0,0,0,1000,0,0,0,1000,0,1000,1000
054831,緯穎國泰98購01  ,0,0,0,0,0,0,0,0,0,1000,0,0,0,1000,0,1000,1000
054758,南亞國票9A購01  ,0,0,0,0,0,0,0,0,0,1000,0,0,0,1000,0,1000,1000
055313,南電群益97購01  ,0,0,0,0,0,0,0,0,0,1000,0,0,0,1000,0,1000,1000
054909,福懋科康和97購01,0,0,0,0,0,0,0,0,0,1000,0,0,0,1000,0,1000,1000
054931,緯穎凱基98購01  ,0,0,0,0,0,0,0,0,0,1000,0,0,0,1000,0,1000,1000
054926,神達凱基98購01  ,0,0,0,0,0,0,0,0,0,1000,0,0,0,1000,0,1000,1000
058738,FBVIX中信03購04 ,0,0,0,0,0,0,0,0,0,1000,0,0,0,1000,0,1000,1000
054844,華邦電兆豐98購01,0,0,0,0,0,0,0,0,0,1000,0,0,0,1000,0,1000,1000
054963,牧德元大97購02  ,0,0,0,0,0,0,0,0,0,1000,0,0,0,1000,0,1000,1000
058152,聯發科統一9B購02,0,0,0,0,0,0,0,0,0,1000,0,0,0,1000,0,1000,1000
055327,致新國票98購01  ,0,0,0,0,0,0,0,0,0,1000,0,0,0,1000,0,1000,1000
058080,台積電群益98購06,0,0,0,0,0,0,0,0,0,1000,0,0,0,1000,0,1000,1000
055388,華通統一97購03  ,0,0,0,0,0,0,0,0,0,1000,0,0,0,1000,0,1000,1000
056334,台積電凱基98購06,0,0,0,0,0,0,0,0,0,1000,0,0,0,1000,0,1000,1000
057772,台積電群益99購01,0,0,0,0,0,0,0,0,0,1000,0,0,0,1000,0,1000,1000
057760,聯發科凱基98購18,0,0,0,0,0,0,0,0,0,1000,0,0,0,1000,0,1000,1000
058240,景碩元大99購04  ,0,0,0,0,0,0,0,0,0,1000,0,0,0,1000,0,1000,1000
057341,技嘉台新98購01  ,0,0,0,0,0,0,0,0,0,1000,0,0,0,1000,0,1000,1000
057409,台虹群益98購02  ,0,0,0,0,0,0,0,0,0,1000,0,0,0,1000,0,1000,1000
055500,京鼎元大97購04  ,0,0,0,0,0,0,0,0,0,1000,0,0,0,1000,0,1000,1000
055502,群創元大9C購03  ,0,0,0,0,0,0,0,0,0,1000,0,0,0,1000,0,1000,1000
058630,日月光國票9A購01,0,0,0,0,0,0,0,0,0,1000,0,0,0,8000,7000,1000,1000
058625,旺宏國票9A購01  ,0,0,0,0,0,0,0,0,0,1000,0,0,0,5000,4000,1000,1000
058664,百和兆豐99購01  ,0,0,0,0,0,0,0,0,0,1000,0,0,0,1000,0,1000,1000
058693,旭富國票9A購01  ,0,0,0,0,0,0,0,0,0,1000,0,0,0,1000,0,1000,1000
058574,台積電群益99購03,0,0,0,0,0,0,0,0,0,1000,0,0,0,1000,0,1000,1000
058578,聯發科群益99購03,0,0,0,0,0,0,0,0,0,1000,0,0,0,1000,0,1000,1000
058569,健策凱基9A購01  ,0,0,0,0,0,0,0,0,0,1000,0,0,0,1000,0,1000,1000
9931,欣高            ,3000,2000,1000,0,0,0,0,0,0,0,0,0,0,0,0,0,1000
6671,三能-KY         ,3000,2000,1000,0,0,0,0,0,0,0,0,0,0,0,0,0,1000
8072,陞泰            ,2000,1000,1000,0,0,0,0,0,0,0,0,0,0,0,0,0,1000
910322,康師傅-DR       ,1000,0,1000,0,0,0,0,0,0,0,0,0,0,0,0,0,1000
2888A,新光金甲特      ,91,0,91,0,0,0,0,0,0,0,0,0,0,0,0,0,91
2882A,國泰特          ,0,0,0,0,0,0,0,0,0,0,4000,4000,0,0,0,0,0
2901,欣欣            ,1000,1000,0,0,0,0,0,0,0,0,0,0,0,0,0,0,0
2373,震旦行          ,9000,9000,0,0,0,0,0,0,0,0,0,0,0,0,0,0,0
3257,虹冠電          ,16000,16000,0,0,0,0,0,0,0,0,0,0,0,0,0,0,0
4807,日成-KY         ,1000,1000,0,0,0,0,0,0,0,0,0,0,0,0,0,0,0
4144,康聯-KY         ,8000,8000,0,0,0,0,0,0,0,0,0,0,0,0,0,0,0
4576,大銀微系統      ,22000,22000,0,0,0,0,0,0,0,0,0,0,0,0,0,0,0
5906,台南-KY         ,1000,1000,0,0,0,0,0,0,0,0,0,0,0,0,0,0,0
6243,迅杰            ,1000,1000,0,0,0,0,0,0,0,0,0,0,0,0,0,0,0
07440P,臺股指麥證9B售02,0,0,0,1000,1000,0,0,0,0,0,0,0,0,1000,1000,0,0
07295P,滬深2X元富9C售09,0,0,0,0,0,0,0,0,0,0,0,0,0,10000,10000,0,0
07076P,鴻海凱基9A售08  ,0,0,0,0,0,0,0,0,0,0,0,0,0,53000,53000,0,0
07077P,緯穎凱基99售01  ,0,0,0,0,0,0,0,0,0,0,0,0,0,66000,66000,0,0
07041P,T50反1元大9C售01,0,0,0,0,0,0,0,0,0,0,0,0,0,170000,170000,0,0
07042P,T50反1元大9C售02,0,0,0,0,0,0,0,0,0,0,0,0,0,1569000,1569000,0,0
06999P,玉晶光國票9B售01,0,0,0,0,0,0,0,0,0,0,0,0,0,1000,1000,0,0
07113P,台積電兆豐99售03,0,0,0,0,0,0,0,0,0,0,0,0,0,10000,10000,0,0
2038,海光            ,2000,2000,0,0,0,0,0,0,0,0,0,0,0,0,0,0,0
1721,三晃            ,8000,7000,1000,0,0,0,0,0,0,-1000,0,1000,-1000,0,0,0,0
1727,中華化          ,1000,1000,0,0,0,0,0,0,0,0,0,0,0,0,0,0,0
1524,耿鼎            ,9000,9000,0,0,0,0,0,0,0,0,0,0,0,0,0,0,0
07445P,大立光凱基9A售08,0,0,0,0,0,0,0,0,0,0,0,0,0,2000,2000,0,0
06106P,國巨群益97售02  ,0,0,0,0,0,0,0,0,0,0,0,0,0,1000000,1000000,0,0
06179P,國巨群益97售04  ,0,0,0,0,0,0,0,0,0,0,0,0,0,600000,600000,0,0
06180P,禾伸堂群益97售01,0,0,0,0,0,0,0,0,0,0,0,0,0,10000,10000,0,0
06295P,國巨元大97售14  ,0,0,0,0,0,0,0,0,0,0,0,0,0,8000,8000,0,0
06236P,台積電元大97售25,0,0,0,0,0,0,0,0,0,0,0,0,0,15000,15000,0,0
06262P,國巨凱基97售07  ,0,0,0,0,0,0,0,0,0,0,0,0,0,100000,100000,0,0
06219P,國巨元富97售05  ,0,0,0,0,0,0,0,0,0,0,0,0,0,499000,499000,0,0
06195P,台積電元富97售06,0,0,0,0,0,0,0,0,0,0,0,0,0,615000,615000,0,0
06196P,元上證元大97售01,0,0,0,0,0,0,0,0,0,0,0,0,0,50000,50000,0,0
06174P,國巨元大97售07  ,0,0,0,0,0,0,0,0,0,0,0,0,0,200000,200000,0,0
06498P,臺股指元大9A售03,0,0,0,0,0,0,0,0,0,0,0,0,0,1000,1000,0,0
06562P,台積電國泰99售02,0,0,0,0,0,0,0,0,0,0,0,0,0,10000,10000,0,0
06419P,國巨統一97售09  ,0,0,0,0,0,0,0,0,0,0,0,0,0,1996000,1996000,0,0
06428P,國巨元大97售17  ,0,0,0,0,0,0,0,0,0,0,0,0,0,150000,150000,0,0
06804P,臺股指群益98售10,0,0,0,0,0,0,0,0,0,0,0,0,0,6000,6000,0,0
06758P,鴻海元大98售10  ,0,0,0,0,0,0,0,0,0,0,0,0,0,16000,16000,0,0
06790P,台積電凱基9A售04,0,0,0,0,0,0,0,0,0,0,0,0,0,361000,361000,0,0
06648P,華邦電元大98售03,0,0,0,0,0,0,0,0,0,0,0,0,0,5000,5000,0,0
06616P,國巨元大98售15  ,0,0,0,0,0,0,0,0,0,0,0,0,0,20000,20000,0,0
06630P,國巨群益98售08  ,0,0,0,0,0,0,0,0,0,0,0,0,0,1500000,1500000,0,0
06938P,南電元大98售03  ,0,0,0,0,0,0,0,0,0,0,0,0,0,1000,1000,0,0
06945P,國巨群益99售04  ,0,0,0,0,0,0,0,0,0,0,0,0,0,500000,500000,0,0
06932P,大立光元大98售21,0,0,0,0,0,0,0,0,0,0,0,0,0,140000,140000,0,0
06973P,臺股指元大9A售11,0,0,0,0,0,0,0,0,0,0,0,0,0,6000,6000,0,0
06970P,旺宏元大99售08  ,0,0,0,0,0,0,0,0,0,0,0,0,0,59000,59000,0,0
06881P,國巨群益98售10  ,0,0,0,0,0,0,0,0,0,0,0,0,0,897000,897000,0,0
060104,新日興元大99購03,0,0,0,0,0,0,0,0,0,0,0,0,0,16000,16000,0,0
060077,台積電台新9B購01,0,0,0,0,0,0,0,0,0,0,0,0,0,10000,10000,0,0
060092,瑞昱元大99購03  ,0,0,0,0,0,0,0,0,0,0,0,0,0,489000,489000,0,0
060037,鴻海國票99購10  ,0,0,0,0,0,0,0,0,0,0,0,0,0,38000,38000,0,0
060024,T50反1國泰9B購02,0,0,0,0,0,0,0,0,0,0,0,0,0,5000,5000,0,0
060042,台積電群益99購12,0,0,0,0,0,0,0,0,0,0,0,0,0,10000,10000,0,0
060007,鴻海群益99購04  ,0,0,0,0,0,0,0,0,0,0,0,0,0,36000,36000,0,0
060145,牧德國票9A購02  ,0,0,0,0,0,0,0,0,0,0,0,0,0,8000,8000,0,0
060230,台積電元大9A購07,0,0,0,0,0,0,0,0,0,0,0,0,0,5000,5000,0,0
060235,瑞昱元大9A購01  ,0,0,0,0,0,0,0,0,0,0,0,0,0,25000,25000,0,0
060294,嘉澤元大9A購01  ,0,0,0,0,0,0,0,0,0,0,0,0,0,75000,75000,0,0
060303,宏達電富邦9B購01,0,0,0,0,0,0,0,0,0,0,0,0,0,2000,2000,0,0
060310,瑞昱永豐9A購01  ,0,0,0,0,0,0,0,0,0,0,0,0,0,1000,1000,0,0
060324,台積電群益9B購02,0,0,0,0,0,0,0,0,0,0,0,0,0,8000,8000,0,0
060325,旺宏群益9A購02  ,0,0,0,0,0,0,0,0,0,0,0,0,0,26000,26000,0,0
059701,國巨凱基9A購09  ,0,0,0,0,0,0,0,0,0,0,0,0,0,7000,7000,0,0
059773,康控群益99購01  ,0,0,0,0,0,0,0,0,0,0,0,0,0,6000,6000,0,0
059795,鴻海國票99購07  ,0,0,0,0,0,0,0,0,0,0,0,0,0,27000,27000,0,0
059797,大立光國票99購01,30000,15000,15000,0,0,0,0,0,0,-15000,0,0,0,15000,30000,-15000,0
05993P,國巨元大96售13  ,0,0,0,0,0,0,0,0,0,0,0,0,0,180000,180000,0,0
059929,華新科富邦9C購03,0,0,0,0,0,0,0,0,0,0,0,0,0,21000,21000,0,0
059917,華新科元大99購19,0,0,0,0,0,0,0,0,0,0,0,0,0,10000,10000,0,0
059374,A50正2群益01購01,0,0,0,0,0,0,0,0,0,0,0,0,0,3000,3000,0,0
059330,台灣50國票99購10,0,0,0,0,0,0,0,0,0,0,0,0,0,2000,2000,0,0
059398,滬深2X元富9C購02,0,0,0,0,0,0,0,0,0,0,0,0,0,3000,3000,0,0
059444,臺股指元大99購25,0,0,0,0,0,0,0,0,0,0,0,0,0,1000,1000,0,0
059470,華新科元大99購16,0,0,0,0,0,0,0,0,0,0,0,0,0,8000,8000,0,0
059461,鈺齊永豐99購03  ,0,0,0,0,0,0,0,0,0,0,0,0,0,2000,2000,0,0
059511,宏達電永豐99購02,0,0,0,0,0,0,0,0,0,0,0,0,0,68000,68000,0,0
059518,康控永豐99購01  ,0,0,0,0,0,0,0,0,0,0,0,0,0,6000,6000,0,0
059516,TPK永豐99購01   ,0,0,0,0,0,0,0,0,0,0,0,0,0,152000,152000,0,0
059564,鴻海凱基9A購15  ,0,0,0,0,0,0,0,0,0,0,0,0,0,8000,8000,0,0
059556,台灣50凱基9A購07,0,0,0,0,0,0,0,0,0,0,0,0,0,2000,2000,0,0
059542,聯發科亞東99購01,0,0,0,0,0,0,0,0,0,0,0,0,0,670000,670000,0,0
059596,大立光元大99購20,0,0,0,0,0,0,0,0,0,0,0,0,0,3000,3000,0,0
04622P,臺股指統一94售01,0,0,0,0,0,0,0,0,0,0,0,0,0,1000,1000,0,0
047024,奇力新元大95購01,0,0,0,0,0,0,0,0,0,0,0,0,0,7000,7000,0,0
04664P,臺股指國票94售03,0,0,0,0,0,0,0,0,0,0,0,0,0,31000,31000,0,0
046905,新光金凱基99購01,0,0,0,0,0,0,0,0,0,0,0,0,0,20000,20000,0,0
046715,美律國泰94購01  ,0,0,0,0,0,0,0,0,0,0,0,0,0,849000,849000,0,0
047212,宏達電富邦97購01,0,0,0,0,0,0,0,0,0,0,0,0,0,49000,49000,0,0
04750P,臺股指元大94售26,0,0,0,0,0,0,0,0,0,0,0,0,0,1000,1000,0,0
00774B,新光中國政金綠債,0,0,0,0,0,0,0,0,0,0,0,0,0,2000,2000,0,0
00775B,新光投等債15+   ,0,0,0,0,0,0,0,0,0,0,0,0,0,2000,2000,0,0
00732,國泰RMB短期報酬 ,0,0,0,0,0,0,0,0,0,0,0,0,0,100000,100000,0,0
00700,富邦恒生國企    ,0,0,0,0,0,0,0,0,0,0,0,0,0,100000,100000,0,0
00625K,富邦上証+R      ,0,0,0,0,0,0,0,0,0,0,0,0,0,50000,50000,0,0
00636K,國泰中國A50+U   ,0,0,0,0,0,0,0,0,0,0,0,0,0,100,100,0,0
00668K,國泰美國道瓊+U  ,0,0,0,0,0,0,0,0,0,0,0,0,0,100,100,0,0
00657,國泰日經225     ,0,0,0,0,0,0,0,0,0,0,0,0,0,100000,100000,0,0
00657K,國泰日經225+U   ,0,0,0,0,0,0,0,0,0,0,0,0,0,100,100,0,0
051239,國巨元大96購02  ,0,0,0,0,0,0,0,0,0,0,0,0,0,43000,43000,0,0
051113,聯電元富95購01  ,0,0,0,0,0,0,0,0,0,0,0,0,0,400000,400000,0,0
050634,華新科群益96購01,0,0,0,0,0,0,0,0,0,0,0,0,0,57000,57000,0,0
03821P,上海銀統一95售01,0,0,0,0,0,0,0,0,0,0,0,0,0,5000,5000,0,0
03826P,瀚宇博元大95售01,0,0,0,0,0,0,0,0,0,0,0,0,0,180000,180000,0,0
03935P,可成富邦95售01  ,0,0,0,0,0,0,0,0,0,0,0,0,0,2000,2000,0,0
048460,盛群凱基94購01  ,0,0,0,0,0,0,0,0,0,0,0,0,0,2000,2000,0,0
052739,國巨元大96購04  ,0,0,0,0,0,0,0,0,0,0,0,0,0,80000,80000,0,0
05273P,國巨群益95售02  ,0,0,0,0,0,0,0,0,0,0,0,0,0,40000,40000,0,0
054004,鴻海統一96購14  ,0,0,0,0,0,0,0,0,0,0,0,0,0,20000,20000,0,0
052907,嘉澤國票97購01  ,0,0,0,0,0,0,0,0,0,0,0,0,0,9000,9000,0,0
054158,國巨日盛99購01  ,0,0,0,0,0,0,0,0,0,0,0,0,0,40000,40000,0,0
054090,瑞昱群益97購01  ,0,0,0,0,0,0,0,0,0,0,0,0,0,21000,21000,0,0
054081,聯電元富96購01  ,0,0,0,0,0,0,0,0,0,0,0,0,0,398000,398000,0,0
054152,漢唐國泰98購02  ,0,0,0,0,0,0,0,0,0,0,0,0,0,10000,10000,0,0
050109,國巨元大94購13  ,0,0,0,0,0,0,0,0,0,0,0,0,0,190000,190000,0,0
05032P,台積電國泰96售05,0,0,0,0,0,0,0,0,0,0,0,0,0,10000,10000,0,0
049687,國巨元大94購09  ,0,0,0,0,0,0,0,0,0,0,0,0,0,80000,80000,0,0
04973P,台積電凱基94售41,0,0,0,0,0,0,0,0,0,0,0,0,0,100000,100000,0,0
049808,聯詠元大94購03  ,0,0,0,0,0,0,0,0,0,0,0,0,0,30000,30000,0,0
049809,聯詠元大94購04  ,0,0,0,0,0,0,0,0,0,0,0,0,0,10000,10000,0,0
049580,國巨元大94購07  ,0,0,0,0,0,0,0,0,0,0,0,0,0,90000,90000,0,0
049581,國巨元大94購08  ,0,0,0,0,0,0,0,0,0,0,0,0,0,90000,90000,0,0
049668,大立光國泰96購02,0,0,0,0,0,0,0,0,0,0,0,0,0,10000,10000,0,0
048139,南電國票94購02  ,0,0,0,0,0,0,0,0,0,0,0,0,0,80000,80000,0,0
051408,台積電國票95購03,0,0,0,0,0,0,0,0,0,0,0,0,0,2000,2000,0,0
049482,國巨元大94購06  ,0,0,0,0,0,0,0,0,0,0,0,0,0,110000,110000,0,0
050573,光寶科國票94購01,0,0,0,0,0,0,0,0,0,0,0,0,0,38000,38000,0,0
050500,台積電凱基94購36,0,0,0,0,0,0,0,0,0,0,0,0,0,30000,30000,0,0
050514,聯電元大94購01  ,0,0,0,0,0,0,0,0,0,0,0,0,0,210000,210000,0,0
052502,瀚宇博永豐95購02,0,0,0,0,0,0,0,0,0,0,0,0,0,5000,5000,0,0
052332,美律亞東96購01  ,0,0,0,0,0,0,0,0,0,0,0,0,0,200000,200000,0,0
051823,矽力元富95購02  ,0,0,0,0,0,0,0,0,0,0,0,0,0,10000,10000,0,0
052589,群創永豐97購01  ,0,0,0,0,0,0,0,0,0,0,0,0,0,450000,450000,0,0
052614,聯電國泰97購01  ,0,0,0,0,0,0,0,0,0,0,0,0,0,30000,30000,0,0
053598,日月光元大96購04,0,0,0,0,0,0,0,0,0,0,0,0,0,370000,370000,0,0
054444,緯穎台新97購01  ,0,0,0,0,0,0,0,0,0,0,0,0,0,80000,80000,0,0
054451,上銀亞東98購01  ,0,0,0,0,0,0,0,0,0,0,0,0,0,390000,390000,0,0
053560,漢唐國泰98購01  ,0,0,0,0,0,0,0,0,0,0,0,0,0,2000,2000,0,0
051906,國巨元大95購09  ,0,0,0,0,0,0,0,0,0,0,0,0,0,84000,84000,0,0
053177,華邦電統一96購01,0,5000,-5000,0,0,0,0,0,0,5000,0,0,0,5000,0,5000,0
053236,群創永豐97購02  ,0,0,0,0,0,0,0,0,0,0,0,0,0,100000,100000,0,0
051550,日電貿永豐95購01,0,0,0,0,0,0,0,0,0,0,0,0,0,7000,7000,0,0
054227,宏達電元富96購02,0,0,0,0,0,0,0,0,0,0,0,0,0,60000,60000,0,0
05427P,聯發科凱基96售07,0,0,0,0,0,0,0,0,0,0,0,0,0,6000,6000,0,0
05305P,華新科國泰97售01,0,0,0,0,0,0,0,0,0,0,0,0,0,50000,50000,0,0
054378,楠梓電群益98購01,0,0,0,0,0,0,0,0,0,0,0,0,0,15000,15000,0,0
052029,矽力群益95購02  ,0,0,0,0,0,0,0,0,0,0,0,0,0,2000,2000,0,0
052189,玉晶光群益96購06,0,0,0,0,0,0,0,0,0,0,0,0,0,50000,50000,0,0
052313,聯電元大98購01  ,0,0,0,0,0,0,0,0,0,0,0,0,0,65000,65000,0,0
053867,創意元大96購04  ,0,0,0,0,0,0,0,0,0,0,0,0,0,10000,10000,0,0
05341P,臺股指兆豐95售02,0,0,0,0,0,0,0,0,0,0,0,0,0,10000,10000,0,0
054003,鴻海統一96購13  ,0,0,0,0,0,0,0,0,0,0,0,0,0,17000,17000,0,0
053701,台積電兆豐96購05,0,0,0,0,0,0,0,0,0,0,0,0,0,10000,10000,0,0
053287,臺股指元大96購15,0,0,0,0,0,0,0,0,0,0,0,0,0,2000,2000,0,0
051635,大立光國票96購04,0,0,0,0,0,0,0,0,0,0,0,0,0,6000,6000,0,0
051746,玉晶光國泰97購07,0,0,0,0,0,0,0,0,0,0,0,0,0,475000,475000,0,0
053488,中石化兆豐97購01,0,0,0,0,0,0,0,0,0,0,0,0,0,100000,100000,0,0
058342,鴻海群益9A購01  ,0,0,0,0,0,0,0,0,0,0,0,0,0,27000,27000,0,0
058361,美律凱基99購06  ,0,0,0,0,0,0,0,0,0,0,0,0,0,1000,1000,0,0
058027,鴻海富邦98購04  ,0,0,0,0,0,0,0,0,0,0,0,0,0,50000,50000,0,0
058044,鴻海元大99購07  ,0,0,0,0,0,0,0,0,0,0,0,0,0,10000,10000,0,0
058065,南亞科亞東99購01,0,0,0,0,0,0,0,0,0,0,0,0,0,260000,260000,0,0
057992,大立光日盛98購01,0,0,0,0,0,0,0,0,0,0,0,0,0,540000,540000,0,0
057974,上銀永豐98購02  ,0,0,0,0,0,0,0,0,0,0,0,0,0,10000,10000,0,0
057948,嘉聯益國票99購02,0,0,0,0,0,0,0,0,0,0,0,0,0,29000,29000,0,0
057963,緯穎元大98購08  ,0,0,0,0,0,0,0,0,0,0,0,0,0,17000,17000,0,0
057492,大立光元大98購18,0,0,0,0,0,0,0,0,0,0,0,0,0,30000,30000,0,0
057513,智邦台新98購01  ,0,0,0,0,0,0,0,0,0,0,0,0,0,27000,27000,0,0
058678,南亞科日盛99購01,0,0,0,0,0,0,0,0,0,0,0,0,0,190000,190000,0,0
058681,大立光康和9B購01,0,0,0,0,0,0,0,0,0,0,0,0,0,140000,140000,0,0
058597,瑞昱台新99購01  ,0,0,0,0,0,0,0,0,0,0,0,0,0,880000,880000,0,0
055480,元上證元大97購02,0,0,0,0,0,0,0,0,0,0,0,0,0,10000,10000,0,0
05548P,臺股指元大96售02,0,0,0,0,0,0,0,0,0,0,0,0,0,1000,1000,0,0
055486,國巨元大98購06  ,0,0,0,0,0,0,0,0,0,0,0,0,0,60000,60000,0,0
055487,國巨元大98購07  ,0,0,0,0,0,0,0,0,0,0,0,0,0,30000,30000,0,0
058298,聯茂凱基99購05  ,0,0,0,0,0,0,0,0,0,0,0,0,0,4000,4000,0,0
05642P,玉晶光兆豐97售02,0,0,0,0,0,0,0,0,0,0,0,0,0,10000,10000,0,0
056497,GIS國泰99購01   ,0,0,0,0,0,0,0,0,0,0,0,0,0,10000,10000,0,0
057370,可成元大98購07  ,0,0,0,0,0,0,0,0,0,0,0,0,0,3000,3000,0,0
057377,康控元大99購02  ,0,0,0,0,0,0,0,0,0,0,0,0,0,6000,6000,0,0
057808,旺宏元大99購05  ,0,0,0,0,0,0,0,0,0,0,0,0,0,13000,13000,0,0
057758,鴻海凱基99購03  ,0,0,0,0,0,0,0,0,0,0,0,0,0,81000,81000,0,0
057788,嘉聯益國票99購01,0,0,0,0,0,0,0,0,0,0,0,0,0,28000,28000,0,0
057777,可成群益9A購03  ,0,0,0,0,0,0,0,0,0,0,0,0,0,5000,5000,0,0
056321,創意群益98購02  ,0,0,0,0,0,0,0,0,0,0,0,0,0,23000,23000,0,0
058066,可成亞東99購01  ,0,0,0,0,0,0,0,0,0,0,0,0,0,670000,670000,0,0
058085,景碩群益9A購01  ,0,0,0,0,0,0,0,0,0,0,0,0,0,28000,28000,0,0
05844P,旺宏元大96售07  ,0,0,0,0,0,0,0,0,0,0,0,0,0,16000,16000,0,0
055017,緯穎元富97購01  ,0,0,0,0,0,0,0,0,0,0,0,0,0,4000,4000,0,0
054968,佐登元大97購01  ,0,0,0,0,0,0,0,0,0,0,0,0,0,109000,109000,0,0
054974,台表科元大98購02,0,0,0,0,0,0,0,0,0,0,0,0,0,10000,10000,0,0
05504P,台積電凱基96售04,0,0,0,0,0,0,0,0,0,0,0,0,0,60000,60000,0,0
058742,鴻海康和99購01  ,0,0,0,0,0,0,0,0,0,0,0,0,0,36000,36000,0,0
058712,鴻海統一9B購03  ,0,0,0,0,0,0,0,0,0,0,0,0,0,21000,21000,0,0
05470P,康控元大95售05  ,0,0,0,0,0,0,0,0,0,0,0,0,0,1000,1000,0,0
054720,禾伸堂永豐97購01,0,0,0,0,0,0,0,0,0,0,0,0,0,29000,29000,0,0
055127,台虹兆豐97購01  ,0,0,0,0,0,0,0,0,0,0,0,0,0,20000,20000,0,0
056036,鴻海凱基97購07  ,0,0,0,0,0,0,0,0,0,0,0,0,0,61000,61000,0,0
056120,聯茂群益97購02  ,0,0,0,0,0,0,0,0,0,0,0,0,0,4000,4000,0,0
056122,勤誠群益97購02  ,0,0,0,0,0,0,0,0,0,0,0,0,0,78000,78000,0,0
05610P,國巨群益98售01  ,0,0,0,0,0,0,0,0,0,0,0,0,0,893000,893000,0,0
056162,祥碩凱基97購03  ,0,0,0,0,0,0,0,0,0,0,0,0,0,4000,4000,0,0
056182,台光電統一97購03,0,0,0,0,0,0,0,0,0,0,0,0,0,50000,50000,0,0
05621P,聯電中信96售01  ,0,0,0,0,0,0,0,0,0,0,0,0,0,60000,60000,0,0
055572,鴻海統一98購04  ,0,0,0,0,0,0,0,0,0,0,0,0,0,5000,5000,0,0
055585,國巨元大98購08  ,0,0,0,0,0,0,0,0,0,0,0,0,0,10000,10000,0,0
055632,群創永豐98購01  ,0,0,0,0,0,0,0,0,0,0,0,0,0,180000,180000,0,0
055646,漢唐元富97購01  ,0,0,0,0,0,0,0,0,0,0,0,0,0,5000,5000,0,0
056545,TPK凱基98購02   ,0,0,0,0,0,0,0,0,0,0,0,0,0,20000,20000,0,0
056567,瀚宇博群益98購02,0,0,0,0,0,0,0,0,0,0,0,0,0,10000,10000,0,0
05919P,京鼎元大96售03  ,0,0,0,0,0,0,0,0,0,0,0,0,0,166000,166000,0,0
059230,滬深2X國票9B購02,0,0,0,0,0,0,0,0,0,0,0,0,0,10000,10000,0,0
058967,可成麥證99購01  ,0,0,0,42000,0,42000,0,0,0,0,0,0,0,42000,42000,0,0
058974,臺股指永豐99購03,0,0,0,0,0,0,0,0,0,0,0,0,0,10000,10000,0,0
059028,嘉聯益台新99購02,0,0,0,0,0,0,0,0,0,0,0,0,0,110000,110000,0,0
059030,奇力新兆豐99購03,0,0,0,0,0,0,0,0,0,0,0,0,0,87000,87000,0,0
059031,元石油中信03購01,0,0,0,0,0,0,0,0,0,0,0,0,0,10000,10000,0,0
05898P,旺宏凱基96售06  ,0,0,0,0,0,0,0,0,0,0,0,0,0,1000,1000,0,0
05913P,國巨元大96售11  ,0,0,0,0,0,0,0,0,0,0,0,0,0,190000,190000,0,0
059131,國巨群益99購07  ,0,0,0,0,0,0,0,0,0,0,0,0,0,24000,24000,0,0
059072,元油2X元大9C購13,0,0,0,0,0,0,0,0,0,0,0,0,0,5000,5000,0,0
056732,國巨凱基98購07  ,0,0,0,0,0,0,0,0,0,0,0,0,0,5000,5000,0,0
056796,國巨麥證98購02  ,0,0,0,3000,3000,0,0,0,0,0,0,0,0,6000,6000,0,0
056835,聯電元富99購01  ,0,0,0,0,0,0,0,0,0,0,0,0,0,10000,10000,0,0
054547,鴻海凱基98購02  ,0,0,0,0,0,0,0,0,0,0,0,0,0,16000,16000,0,0
055673,旺宏日盛97購01  ,0,0,0,0,0,0,0,0,0,0,0,0,0,1150000,1150000,0,0
055675,亞德客凱基97購02,0,0,0,0,0,0,0,0,0,0,0,0,0,17000,17000,0,0
055720,宏達電元大97購05,0,0,0,0,0,0,0,0,0,0,0,0,0,2000,2000,0,0
058934,台灣50中信03購03,0,0,0,0,0,0,0,0,0,0,0,0,0,10000,10000,0,0
058764,康友群益99購01  ,0,0,0,0,0,0,0,0,0,0,0,0,0,130000,130000,0,0
058812,台積電統一9B購06,0,0,0,0,0,0,0,0,0,0,0,0,0,7000,7000,0,0
054615,牧德永豐98購01  ,0,0,0,0,0,0,0,0,0,0,0,0,0,10000,10000,0,0
056903,大立光元大99購04,0,0,0,0,0,0,0,0,0,0,0,0,0,43000,43000,0,0
056867,華通麥證98購01  ,0,0,0,0,110000,-110000,0,0,0,0,0,0,0,110000,110000,0,0
05684P,臺股指元大96售09,0,0,0,0,0,0,0,0,0,0,0,0,0,280000,280000,0,0
057231,美律凱基98購05  ,0,0,0,0,0,0,0,0,0,0,0,0,0,27000,27000,0,0
057277,可成元大98購05  ,0,0,0,0,0,0,0,0,0,0,0,0,0,3000,3000,0,0
057296,智原永豐98購01  ,0,0,0,0,0,0,0,0,0,0,0,0,0,19000,19000,0,0
057178,可成元大98購03  ,0,0,0,0,0,0,0,0,0,0,0,0,0,2000,2000,0,0
057213,華邦電群益98購01,0,0,0,0,0,0,0,0,0,0,0,0,0,3288000,3288000,0,0
057214,瑞昱群益98購01  ,0,0,0,0,0,0,0,0,0,0,0,0,0,19000,19000,0,0
057689,南亞科凱基99購02,0,0,0,0,0,0,0,0,0,0,0,0,0,223000,223000,0,0
057699,可成群益9A購02  ,0,0,0,0,0,0,0,0,0,0,0,0,0,5000,5000,0,0
057667,可成元大99購01  ,0,0,0,0,0,0,0,0,0,0,0,0,0,2000,2000,0,0
057648,和碩元大98購01  ,0,0,0,0,0,0,0,0,0,0,0,0,0,27000,27000,0,0
056944,鴻海統一98購11  ,0,0,0,0,0,0,0,0,0,0,0,0,0,27000,27000,0,0
057736,鴻海富邦99購04  ,0,0,0,0,0,0,0,0,0,0,0,0,0,31000,31000,0,0
057575,世紀鋼永豐98購02,0,0,0,0,0,0,0,0,0,0,0,0,0,179000,179000,0,0
057040,國巨元大98購12  ,0,0,0,0,0,0,0,0,0,0,0,0,0,15000,15000,0,0
057041,國巨元大99購04  ,0,0,0,0,0,0,0,0,0,0,0,0,0,10000,10000,0,0
057608,南亞科台新98購01,0,0,0,0,0,0,0,0,0,0,0,0,0,500000,500000,0,0
057164,國巨元大98購14  ,0,0,0,0,0,0,0,0,0,0,0,0,0,7000,7000,0,0
057165,國巨元大99購05  ,0,0,0,0,0,0,0,0,0,0,0,0,0,12000,12000,0,0
057158,義隆永豐99購01  ,0,0,0,0,0,0,0,0,0,0,0,0,0,2000,2000,0,0
057044,旺宏元大98購08  ,0,0,0,0,0,0,0,0,0,0,0,0,0,14000,14000,0,0
056237,智邦群益97購02  ,0,0,0,0,0,0,0,0,0,0,0,0,0,9000,9000,0,0
056230,可成凱基98購03  ,0,0,0,0,0,0,0,0,0,0,0,0,0,17000,17000,0,0
058416,鴻海麥證99購01  ,0,0,0,17000,9000,8000,0,0,0,0,0,0,0,26000,26000,0,0
05581P,華新科凱基96售07,0,0,0,0,0,0,0,0,0,0,0,0,0,336000,336000,0,0
055847,大立光元大97購10,0,0,0,0,0,0,0,0,0,0,0,0,0,23000,23000,0,0
056681,鴻海統一98購09  ,0,0,0,0,0,0,0,0,0,0,0,0,0,34000,34000,0,0
05669P,嘉晶永豐96售03  ,0,0,0,0,0,0,0,0,0,0,0,0,0,20000,20000,0,0
8411,福貞-KY         ,8000,8000,0,0,0,0,0,0,0,0,0,0,0,0,0,0,0
6625,必應            ,2000,2000,0,0,0,0,0,0,0,0,0,0,0,0,0,0,0
6641,基士德-KY       ,2000,2000,0,0,0,0,0,0,0,0,0,0,0,0,0,0,0
059597,大立光元大99購21,0,0,0,0,0,0,0,0,0,-1000,0,0,0,0,1000,-1000,-1000
059616,滬深2X群益01購04,0,0,0,0,0,0,0,0,0,-1000,0,0,0,0,1000,-1000,-1000
059546,FBVIX群益99購03 ,0,0,0,0,0,0,0,0,0,-1000,0,0,0,0,1000,-1000,-1000
059477,FBVIX群益99購01 ,0,0,0,0,0,0,0,0,0,-1000,0,0,0,0,1000,-1000,-1000
059932,世紀鋼富邦9A購02,0,0,0,0,0,0,0,0,0,-1000,0,0,0,115000,116000,-1000,-1000
059768,上証2X群益9C購02,0,0,0,0,0,0,0,0,0,-1000,0,0,0,2000,3000,-1000,-1000
059672,滬深2X元富99購06,0,0,0,0,0,0,0,0,0,-1000,0,0,0,0,1000,-1000,-1000
059971,台灣50元大9B購08,0,0,0,0,0,0,0,0,0,-1000,0,0,0,0,1000,-1000,-1000
059988,大立光元大9A購02,0,0,0,0,0,0,0,0,0,-1000,0,0,0,0,1000,-1000,-1000
060056,大立光凱基9B購01,0,0,0,0,0,0,0,0,0,-1000,0,0,0,0,1000,-1000,-1000
060061,旺宏兆豐99購02  ,0,0,0,0,0,0,0,0,0,-1000,0,0,0,112000,113000,-1000,-1000
06878P,台灣50日盛9B售01,0,0,0,0,0,0,0,0,0,-1000,0,0,0,0,1000,-1000,-1000
06947P,FBVIX元大01售01 ,0,0,0,0,0,0,0,0,0,-1000,0,0,0,0,1000,-1000,-1000
06783P,亞光元大98售03  ,0,0,0,0,0,0,0,0,0,-1000,0,0,0,0,1000,-1000,-1000
06748P,智邦台新98售02  ,0,0,0,0,0,0,0,0,0,-1000,0,0,0,1000,2000,-1000,-1000
06448P,華通元大99售01  ,0,0,0,0,0,0,0,0,0,-1000,0,0,0,0,1000,-1000,-1000
06457P,玉晶光統一98售02,0,0,0,0,0,0,0,0,0,-1000,0,0,0,0,1000,-1000,-1000
06611P,祥碩國票98售01  ,0,0,0,0,0,0,0,0,0,-1000,0,0,0,0,1000,-1000,-1000
06206P,台積電凱基97售11,0,0,0,0,0,0,0,0,0,-1000,0,0,0,0,1000,-1000,-1000
06230P,亞德客永豐97售03,0,0,0,0,0,0,0,0,0,-1000,0,0,0,0,1000,-1000,-1000
06301P,臺股指元大97售04,0,0,0,0,0,0,0,0,0,-1000,0,0,0,4000,5000,-1000,-1000
08671P,友訊國票01售01  ,0,0,0,0,0,0,0,0,0,-1000,0,0,0,0,1000,-1000,-1000
1219,福壽            ,2000,3000,-1000,0,0,0,0,0,0,0,0,0,0,0,0,0,-1000
1470,大統新創        ,0,1000,-1000,0,0,0,0,0,0,0,0,0,0,0,0,0,-1000
1446,宏和            ,9000,10000,-1000,0,0,0,0,0,0,0,0,0,0,0,0,0,-1000
1453,大將            ,2000,3000,-1000,0,0,0,0,0,0,0,0,0,0,0,0,0,-1000
1726,永記            ,2000,2000,0,0,0,0,0,0,0,-1000,0,1000,-1000,0,0,0,-1000
1583,程泰            ,0,1000,-1000,0,0,0,0,0,0,0,0,0,0,0,0,0,-1000
1587,吉茂            ,0,1000,-1000,0,0,0,0,0,0,0,0,0,0,0,0,0,-1000
2033,佳大            ,0,1000,-1000,0,0,0,0,0,0,0,0,0,0,0,0,0,-1000
1903,士紙            ,0,1000,-1000,0,0,0,0,0,0,0,0,0,0,0,0,0,-1000
2236,百達-KY         ,0,1000,-1000,0,0,0,0,0,0,0,0,0,0,0,0,0,-1000
07052P,臺股指中信9C售02,0,0,0,0,0,0,0,0,0,-1000,0,0,0,0,1000,-1000,-1000
07065P,臺股指元大9A售26,0,0,0,0,0,0,0,0,0,-1000,0,0,0,0,1000,-1000,-1000
07200P,臺股指元大99售16,0,0,0,0,0,0,0,0,0,-1000,0,0,0,0,1000,-1000,-1000
07171P,臺股指國票99售08,0,0,0,0,0,0,0,0,0,-1000,0,0,0,0,1000,-1000,-1000
07257P,臺股指凱基99售37,0,0,0,0,0,0,0,0,0,-1000,0,0,0,311000,312000,-1000,-1000
07236P,台灣50國票99售05,0,0,0,0,0,0,0,0,0,-1000,0,0,0,7000,8000,-1000,-1000
07326P,大立光元大99售23,0,0,0,0,0,0,0,0,0,-1000,0,0,0,5000,6000,-1000,-1000
07268P,臺股指元大99售24,0,0,0,0,0,0,0,0,0,-1000,0,0,0,0,1000,-1000,-1000
07411P,國巨元大99售31  ,0,0,0,0,0,0,0,0,0,-1000,0,0,0,10000,11000,-1000,-1000
07398P,鴻海凱基99售18  ,0,0,0,0,0,0,0,0,0,-1000,0,0,0,0,1000,-1000,-1000
07360P,台積電元大99售46,0,0,0,0,0,0,0,0,0,-1000,0,0,0,0,1000,-1000,-1000
6464,台數科          ,0,1000,-1000,0,0,0,0,0,0,0,0,0,0,0,0,0,-1000
6184,大豐電          ,20000,21000,-1000,0,0,0,0,0,0,0,0,0,0,0,0,0,-1000
5484,慧友            ,0,1000,-1000,0,0,0,0,0,0,0,0,0,0,0,0,0,-1000
4562,穎漢            ,0,1000,-1000,0,0,0,0,0,0,0,0,0,0,0,0,0,-1000
4439,冠星-KY         ,0,1000,-1000,0,0,0,0,0,0,0,0,0,0,0,0,0,-1000
3432,台端            ,0,1000,-1000,0,0,0,0,0,0,0,0,0,0,0,0,0,-1000
3494,誠研            ,7000,8000,-1000,0,0,0,0,0,0,0,0,0,0,0,0,0,-1000
2380,虹光            ,0,1000,-1000,0,0,0,0,0,0,0,0,0,0,0,0,0,-1000
2460,建通            ,5000,6000,-1000,0,0,0,0,0,0,0,0,0,0,0,0,0,-1000
2438,翔耀            ,0,1000,-1000,0,0,0,0,0,0,0,0,0,0,0,0,0,-1000
3002,歐格            ,0,1000,-1000,0,0,0,0,0,0,0,0,0,0,0,0,0,-1000
2910,統領            ,1000,2000,-1000,0,0,0,0,0,0,0,0,0,0,0,0,0,-1000
3058,立德            ,2000,4000,-2000,0,0,0,0,0,0,1000,1000,0,1000,0,0,0,-1000
2851,中再保          ,17000,18000,-1000,0,0,0,0,0,0,0,0,0,0,0,0,0,-1000
2891B,中信金乙特      ,0,4000,-4000,0,0,0,0,0,0,3000,3000,0,3000,0,0,0,-1000
058012,鈺齊國票99購01  ,0,0,0,0,0,0,0,0,0,-1000,0,0,0,60000,61000,-1000,-1000
057329,緯穎群益98購02  ,0,0,0,0,0,0,0,0,0,-1000,0,0,0,0,1000,-1000,-1000
051700,深中小群益99購04,0,0,0,0,0,0,0,0,0,-1000,0,0,0,0,1000,-1000,-1000
05331P,上証2X國票96售01,0,0,0,0,0,0,0,0,0,-1000,0,0,0,0,1000,-1000,-1000
054001,康友群益96購02  ,0,0,0,0,0,0,0,0,0,-1000,0,0,0,0,1000,-1000,-1000
053480,祥碩元大96購02  ,0,0,0,0,0,0,0,0,0,-1000,0,0,0,4000,5000,-1000,-1000
053741,漢唐國票97購03  ,0,0,0,0,0,0,0,0,0,-1000,0,0,0,5000,6000,-1000,-1000
053004,燿華永豐96購01  ,0,0,0,0,0,0,0,0,0,-1000,0,0,0,0,1000,-1000,-1000
05439P,聯發科國票95售06,0,0,0,0,0,0,0,0,0,-1000,0,0,0,0,1000,-1000,-1000
053599,崇越元大96購01  ,0,0,0,0,0,0,0,0,0,-1000,0,0,0,0,1000,-1000,-1000
052543,聯詠元富95購01  ,0,0,0,0,0,0,0,0,0,-1000,0,0,0,0,1000,-1000,-1000
04910P,台積電統一94售12,0,0,0,0,0,0,0,0,0,-1000,0,0,0,0,1000,-1000,-1000
04811P,上銀元大94售02  ,0,0,0,0,0,0,0,0,0,-1000,0,0,0,0,1000,-1000,-1000
049557,南電元富94購02  ,0,0,0,0,0,0,0,0,0,-1000,0,0,0,0,1000,-1000,-1000
04981P,華新科亞東94售01,0,0,0,0,0,0,0,0,0,-1000,0,0,0,0,1000,-1000,-1000
049969,泰鼎國票95購01  ,0,0,0,0,0,0,0,0,0,-1000,0,0,0,8000,9000,-1000,-1000
052672,世紀鋼群益96購02,0,0,0,0,0,0,0,0,0,-1000,0,0,0,0,1000,-1000,-1000
03959P,義隆元富96售01  ,0,0,0,0,0,0,0,0,0,-1000,0,0,0,0,1000,-1000,-1000
03060X,元展55          ,0,0,0,0,0,0,0,0,0,-1000,0,0,0,0,1000,-1000,-1000
04249P,大立光統一94售04,0,0,0,0,0,0,0,0,0,-1000,0,0,0,0,1000,-1000,-1000
04805P,創意元富94售01  ,0,0,0,0,0,0,0,0,0,-1000,0,0,0,0,1000,-1000,-1000
00688L,國泰20年美債正2 ,0,0,0,0,0,0,0,0,0,-1000,0,0,0,103000,104000,-1000,-1000
00776,新光ICE美國權值 ,0,0,0,0,0,0,0,0,0,-1000,0,0,0,2000,3000,-1000,-1000
01004T,土銀富邦R2      ,0,1000,-1000,0,0,0,0,0,0,0,0,0,0,0,0,0,-1000
04684P,欣興元大94售07  ,0,0,0,0,0,0,0,0,0,-1000,0,0,0,0,1000,-1000,-1000
057604,鴻海統一9C購01  ,0,0,0,0,0,0,0,0,0,-1000,0,0,0,31000,32000,-1000,-1000
054487,京元電台新97購01,0,0,0,0,0,0,0,0,0,-1000,0,0,0,0,1000,-1000,-1000
058488,華擎國票9A購01  ,0,0,0,0,0,0,0,0,0,-1000,0,0,0,49000,50000,-1000,-1000
058512,宏達電元大99購04,0,0,0,0,0,0,0,0,0,-1000,0,0,0,3000,4000,-1000,-1000
057189,康控元大98購02  ,0,0,0,0,0,0,0,0,0,-1000,0,0,0,16000,17000,-1000,-1000
054698,同欣電永豐97購01,0,0,0,0,0,0,0,0,0,-1000,0,0,0,0,1000,-1000,-1000
05467P,聯電元大95售02  ,0,0,0,0,0,0,0,0,0,-1000,0,0,0,35000,36000,-1000,-1000
05454P,奇鋐群益95售04  ,0,0,0,0,0,0,0,0,0,-1000,0,0,0,1000,2000,-1000,-1000
056745,聯茂凱基99購03  ,0,0,0,0,0,0,0,0,0,-1000,0,0,0,20000,21000,-1000,-1000
058963,華新科兆豐99購05,0,0,0,0,0,0,0,0,0,-1000,0,0,0,0,1000,-1000,-1000
059279,台灣50富邦9C購03,0,0,0,0,0,0,0,0,0,-1000,0,0,0,0,1000,-1000,-1000
059223,大立光元大99購14,0,0,0,0,0,0,0,0,0,-1000,0,0,0,0,1000,-1000,-1000
059228,臺股指元大99購21,0,0,0,0,0,0,0,0,0,-1000,0,0,0,12000,13000,-1000,-1000
055904,貿聯亞東99購01  ,0,0,0,0,0,0,0,0,0,-1000,0,0,0,0,1000,-1000,-1000
05559P,臺股指麥證96售01,0,0,0,0,1000,-1000,0,0,0,-1000,0,0,0,0,1000,-1000,-1000
055556,奇力新凱基98購03,0,0,0,0,0,0,0,0,0,-1000,0,0,0,0,1000,-1000,-1000
056038,可成凱基97購01  ,0,0,0,0,0,0,0,0,0,-1000,0,0,0,0,1000,-1000,-1000
056032,勤誠康和97購03  ,0,0,0,0,0,0,0,0,0,-1000,0,0,0,0,1000,-1000,-1000
055963,欣興元大97購04  ,0,0,0,0,0,0,0,0,0,-1000,0,0,0,0,1000,-1000,-1000
05605P,嘉聯益元大97售02,0,0,0,0,0,0,0,0,0,-1000,0,0,0,0,1000,-1000,-1000
054890,聯鈞統一99購01  ,0,0,0,0,0,0,0,0,0,-1000,0,0,0,13000,14000,-1000,-1000
054935,華通元大98購03  ,0,0,0,0,0,0,0,0,0,-1000,0,0,0,17000,18000,-1000,-1000
055087,瑞昱亞東97購01  ,0,0,0,0,0,0,0,0,0,-1000,0,0,0,160000,161000,-1000,-1000
055351,聯發科凱基97購03,0,0,0,0,0,0,0,0,0,-1000,0,0,0,0,1000,-1000,-1000
055354,宏達電凱基98購01,0,0,0,0,0,0,0,0,0,-1000,0,0,0,0,1000,-1000,-1000
057785,智邦國票99購02  ,0,0,0,0,0,0,0,0,0,-1000,0,0,0,3000,4000,-1000,-1000
058583,臻鼎群益99購01  ,0,0,0,0,0,0,0,0,0,-1000,0,0,0,0,1000,-1000,-1000
058613,茂林元大99購03  ,0,0,0,0,0,0,0,0,0,-1000,0,0,0,97000,98000,-1000,-1000
058677,矽格群益99購01  ,0,0,0,0,0,0,0,0,0,-1000,0,0,0,0,1000,-1000,-1000
058697,亞德客元大99購01,0,0,0,0,0,0,0,0,0,-1000,0,0,0,0,1000,-1000,-1000
057480,技嘉元大98購03  ,0,0,0,0,0,0,0,0,0,-1000,0,0,0,24000,25000,-1000,-1000
6674,鋐寶科技        ,3000,4000,-1000,0,0,0,0,0,0,0,0,0,0,0,0,0,-1000
8201,無敵            ,0,1000,-1000,0,0,0,0,0,0,0,0,0,0,0,0,0,-1000
8481,政伸            ,0,1000,-1000,0,0,0,0,0,0,0,0,0,0,0,0,0,-1000
8443,阿瘦            ,0,1000,-1000,0,0,0,0,0,0,0,0,0,0,0,0,0,-1000
8478,東哥遊艇        ,4000,2000,2000,0,0,0,0,0,0,-3000,0,3000,-3000,0,0,0,-1000
8466,美吉吉-KY       ,0,1000,-1000,0,0,0,0,0,0,0,0,0,0,0,0,0,-1000
2816,旺旺保          ,18000,20000,-2000,0,0,0,0,0,0,0,0,0,0,0,0,0,-2000
2540,愛山林          ,0,2000,-2000,0,0,0,0,0,0,0,0,0,0,0,0,0,-2000
2701,萬企            ,6000,8000,-2000,0,0,0,0,0,0,0,0,0,0,0,0,0,-2000
3296,勝德            ,0,2000,-2000,0,0,0,0,0,0,0,0,0,0,0,0,0,-2000
3229,晟鈦            ,0,2000,-2000,0,0,0,0,0,0,0,0,0,0,0,0,0,-2000
4438,廣越            ,6000,16000,-10000,0,0,0,0,0,0,8000,8000,0,8000,0,0,0,-2000
6128,上福            ,5000,7000,-2000,0,0,0,0,0,0,0,0,0,0,0,0,0,-2000
6133,金橋            ,0,2000,-2000,0,0,0,0,0,0,0,0,0,0,0,0,0,-2000
6164,華興            ,4000,7000,-3000,0,0,0,0,0,0,1000,1000,0,1000,0,0,0,-2000
6573,虹揚-KY         ,1000,3000,-2000,0,0,0,0,0,0,0,0,0,0,0,0,0,-2000
07376P,聯發科元大99售39,0,0,0,0,0,0,0,0,0,-2000,0,0,0,49000,51000,-2000,-2000
07006P,旺宏統一9B售03  ,0,0,0,0,0,0,0,0,0,-2000,0,0,0,0,2000,-2000,-2000
07008P,台郡中信99售02  ,0,0,0,0,0,0,0,0,0,-2000,0,0,0,0,2000,-2000,-2000
2102,泰豐            ,81000,83000,-2000,0,0,0,0,0,0,0,0,0,0,0,0,0,-2000
1776,展宇            ,0,2000,-2000,0,0,0,0,0,0,0,0,0,0,0,0,0,-2000
2024,志聯            ,0,2000,-2000,0,0,0,0,0,0,0,0,0,0,0,0,0,-2000
1539,巨庭            ,1000,3000,-2000,0,0,0,0,0,0,0,0,0,0,0,0,0,-2000
1616,億泰            ,0,2000,-2000,0,0,0,0,0,0,0,0,0,0,0,0,0,-2000
1445,大宇            ,0,2000,-2000,0,0,0,0,0,0,0,0,0,0,0,0,0,-2000
1468,昶和            ,0,2000,-2000,0,0,0,0,0,0,0,0,0,0,0,0,0,-2000
1516,川飛            ,0,2000,-2000,0,0,0,0,0,0,0,0,0,0,0,0,0,-2000
1236,宏亞            ,0,2000,-2000,0,0,0,0,0,0,0,0,0,0,0,0,0,-2000
06255P,臺股指群益97售08,0,0,0,0,0,0,0,0,0,-2000,0,0,0,0,2000,-2000,-2000
06094P,台達電中信97售01,0,0,0,0,0,0,0,0,0,-2000,0,0,0,0,2000,-2000,-2000
06506P,台郡國票99售02  ,0,0,0,0,0,0,0,0,0,-2000,0,0,0,21000,23000,-2000,-2000
06480P,上銀凱基98售04  ,0,0,0,0,0,0,0,0,0,-2000,0,0,0,0,2000,-2000,-2000
06803P,臺股指群益98售09,0,0,0,0,0,0,0,0,0,-2000,0,0,0,0,2000,-2000,-2000
06599P,宏達電永豐98售02,0,0,0,0,0,0,0,0,0,-2000,0,0,0,0,2000,-2000,-2000
06923P,鴻海群益98售09  ,0,0,0,0,0,0,0,0,0,-2000,0,0,0,3000,5000,-2000,-2000
06849P,欣興元大98售12  ,0,0,0,0,0,0,0,0,0,-2000,0,0,0,0,2000,-2000,-2000
060053,聯發科凱基9B購02,0,0,0,0,0,0,0,0,0,-2000,0,0,0,0,2000,-2000,-2000
06003P,亞光康和96售02  ,0,0,0,0,0,0,0,0,0,-2000,0,0,0,0,2000,-2000,-2000
059989,嘉晶元大9A購01  ,0,0,0,0,0,0,0,0,0,-2000,0,0,0,1000,3000,-2000,-2000
059997,華航元富99購01  ,0,0,0,0,0,0,0,0,0,-2000,0,0,0,0,2000,-2000,-2000
060012,電子類群益99購02,0,0,0,0,0,0,0,0,0,-2000,0,0,0,0,2000,-2000,-2000
060297,和碩元大9A購02  ,0,0,0,0,0,0,0,0,0,-2000,0,0,0,0,2000,-2000,-2000
059655,T50反1元大99購10,0,0,0,0,0,0,0,0,0,-2000,0,0,0,0,2000,-2000,-2000
059697,上証2X凱基9A購03,0,0,0,0,0,0,0,0,0,-2000,0,0,0,3000,5000,-2000,-2000
059722,南亞科元大99購02,0,0,0,0,0,0,0,0,0,-2000,0,0,0,26000,28000,-2000,-2000
059801,T50反1元富99購10,0,0,0,0,0,0,0,0,0,-2000,0,0,0,0,2000,-2000,-2000
059899,上証2X元大9C購04,0,0,0,0,0,0,0,0,0,-2000,0,0,0,0,2000,-2000,-2000
059405,台灣50國票01購01,0,0,0,0,0,0,0,0,0,-2000,0,0,0,3000,5000,-2000,-2000
059353,滬深2X富邦9A購02,0,0,0,0,0,0,0,0,0,-2000,0,0,0,1000,3000,-2000,-2000
059555,台灣50凱基9A購06,0,0,0,0,0,0,0,0,0,-2000,0,0,0,0,2000,-2000,-2000
059621,T50正2凱基9C購04,0,0,0,0,0,0,0,0,0,-2000,0,0,0,0,2000,-2000,-2000
04636P,臺股指群益94售11,0,0,0,0,0,0,0,0,0,-2000,0,0,0,0,2000,-2000,-2000
04116P,京元電元大94售02,0,0,0,0,0,0,0,0,0,-2000,0,0,0,88000,90000,-2000,-2000
050658,台郡麥證96購01  ,0,0,0,18000,20000,-2000,0,0,0,-2000,0,0,0,18000,20000,-2000,-2000
04904P,奇力新永豐94售05,0,0,0,0,0,0,0,0,0,-2000,0,0,0,0,2000,-2000,-2000
052706,台虹國票97購01  ,0,0,0,0,0,0,0,0,0,-2000,0,0,0,0,2000,-2000,-2000
052825,TPK永豐96購01   ,0,0,0,0,0,0,0,0,0,-2000,0,0,0,0,2000,-2000,-2000
05407P,超眾凱基95售04  ,0,0,0,0,0,0,0,0,0,-2000,0,0,0,18000,20000,-2000,-2000
050003,景碩永豐94購01  ,0,0,0,0,0,0,0,0,0,-2000,0,0,0,0,2000,-2000,-2000
050322,世紀鋼國票95購01,0,0,0,0,0,0,0,0,0,-2000,0,0,0,0,2000,-2000,-2000
050254,大立光富邦96購02,0,0,0,0,0,0,0,0,0,-2000,0,0,0,0,2000,-2000,-2000
049252,國巨元大96購01  ,0,0,0,0,0,0,0,0,0,-2000,0,0,0,18000,20000,-2000,-2000
050412,全新永豐94購04  ,0,0,0,0,0,0,0,0,0,-2000,0,0,0,0,2000,-2000,-2000
051789,嘉澤國票96購01  ,0,0,0,0,0,0,0,0,0,-2000,0,0,0,15000,17000,-2000,-2000
052519,旺宏元大95購05  ,0,0,0,0,0,0,0,0,0,-2000,0,0,0,10000,12000,-2000,-2000
052076,可成元富98購01  ,0,0,0,0,0,0,0,0,0,-2000,0,0,0,193000,195000,-2000,-2000
053875,GIS元大97購01   ,0,0,0,0,0,0,0,0,0,-2000,0,0,0,70000,72000,-2000,-2000
053417,上銀永豐96購02  ,0,0,0,0,0,0,0,0,0,-2000,0,0,0,0,2000,-2000,-2000
05817P,可成凱基96售07  ,0,0,0,0,0,0,0,0,0,-2000,0,0,0,0,2000,-2000,-2000
058369,亞光凱基99購02  ,0,0,0,0,0,0,0,0,0,-2000,0,0,0,137000,139000,-2000,-2000
05786P,臺股指永昌96售03,0,0,0,0,0,0,0,0,0,-2000,0,0,0,0,2000,-2000,-2000
05647P,聯發科國票97售02,0,0,0,0,0,0,0,0,0,-2000,0,0,0,3000,5000,-2000,-2000
055459,建準永豐97購03  ,0,0,0,0,0,0,0,0,0,-2000,0,0,0,38000,40000,-2000,-2000
055381,茂林元大97購02  ,0,0,0,0,0,0,0,0,0,-2000,0,0,0,45000,47000,-2000,-2000
058101,台積電富邦9C購01,0,0,0,0,0,0,0,0,0,-2000,0,0,0,0,2000,-2000,-2000
05520P,聯詠凱基96售01  ,0,0,0,0,0,0,0,0,0,-2000,0,0,0,0,2000,-2000,-2000
056153,華新科凱基97購02,0,0,0,0,0,0,0,0,0,-2000,0,0,0,6000,8000,-2000,-2000
05594P,旺宏國票96售04  ,0,0,0,0,0,0,0,0,0,-2000,0,0,0,0,2000,-2000,-2000
055954,南港元大97購02  ,0,0,0,0,0,0,0,0,0,-2000,0,0,0,0,2000,-2000,-2000
056568,台表科群益98購01,0,0,0,0,0,0,0,0,0,-2000,0,0,0,6000,8000,-2000,-2000
058993,滬深反元大9C購01,0,0,0,0,0,0,0,0,0,-2000,0,0,0,12000,14000,-2000,-2000
059140,大立光兆豐9A購02,0,0,0,0,0,0,0,0,0,-2000,0,0,0,0,2000,-2000,-2000
059008,鈺齊元大99購03  ,0,0,0,0,0,0,0,0,0,-2000,0,0,0,0,2000,-2000,-2000
05887P,友達元富99售03  ,0,0,0,0,0,0,0,0,0,-2000,0,0,0,0,2000,-2000,-2000
056860,正崴群益98購01  ,0,0,0,0,0,0,0,0,0,-2000,0,0,0,0,2000,-2000,-2000
054512,元油反元大99購03,0,0,0,0,0,0,0,0,0,-2000,0,0,0,0,2000,-2000,-2000
057651,矽力元大98購03  ,0,0,0,0,0,0,0,0,0,-2000,0,0,0,13000,15000,-2000,-2000
055834,國巨元大97購13  ,0,0,0,0,0,0,0,0,0,-2000,0,0,0,12000,14000,-2000,-2000
055753,貿聯第一98購01  ,0,0,0,0,0,0,0,0,0,-2000,0,0,0,0,2000,-2000,-2000
8467,波力-KY         ,0,2000,-2000,0,0,0,0,0,0,0,0,0,0,0,0,0,-2000
6655,科定            ,0,2000,-2000,0,0,0,0,0,0,0,0,0,0,0,0,0,-2000
9906,欣巴巴          ,0,2000,-2000,0,0,0,0,0,0,0,0,0,0,0,0,0,-2000
9110,越南控-DR       ,0,2000,-2000,0,0,0,0,0,0,0,0,0,0,0,0,0,-2000
059314,上銀元大99購03  ,0,0,0,0,0,0,0,0,0,-3000,0,0,0,237000,240000,-3000,-3000
059919,宏達電元大99購06,0,0,0,0,0,0,0,0,0,-3000,0,0,0,25000,28000,-3000,-3000
059953,聯發科康和99購01,0,0,0,0,0,0,0,0,0,-3000,0,0,0,0,3000,-3000,-3000
059892,台灣50台新9A購02,0,0,0,0,0,0,0,0,0,-3000,0,0,0,10000,13000,-3000,-3000
059725,聯發科元大99購31,0,0,0,0,0,0,0,0,0,-3000,0,0,0,3000,6000,-3000,-3000
059711,滬深2X元大9C購02,0,0,0,0,0,0,0,0,0,-3000,0,0,0,3000,6000,-3000,-3000
060331,台積電麥證9A購01,0,0,0,0,13000,-13000,0,0,0,-3000,0,0,0,10000,13000,-3000,-3000
060158,廣達永豐9A購01  ,0,0,0,0,0,0,0,0,0,-3000,0,0,0,22000,25000,-3000,-3000
060110,茂林元大99購06  ,0,0,0,0,0,0,0,0,0,-3000,0,0,0,43000,46000,-3000,-3000
06876P,台灣50兆豐9B售01,0,0,0,0,0,0,0,0,0,-3000,0,0,0,0,3000,-3000,-3000
06779P,智邦元大98售12  ,0,0,0,0,0,0,0,0,0,-3000,0,0,0,2000,5000,-3000,-3000
06408P,聯茂元富97售02  ,0,0,0,0,0,0,0,0,0,-3000,0,0,0,0,3000,-3000,-3000
06515P,國巨凱基98售06  ,0,0,0,0,0,0,0,0,0,-3000,0,0,0,0,3000,-3000,-3000
06559P,玉晶光元富98售02,0,0,0,0,0,0,0,0,0,-3000,0,0,0,0,3000,-3000,-3000
1225,福懋油          ,16000,19000,-3000,0,0,0,0,0,0,0,0,0,0,0,0,0,-3000
07452P,國巨元大9A售05  ,0,0,0,0,0,0,0,0,0,-3000,0,0,0,0,3000,-3000,-3000
1467,南緯            ,15000,18000,-3000,0,0,0,0,0,0,0,0,0,0,0,0,0,-3000
1456,怡華            ,0,3000,-3000,0,0,0,0,0,0,0,0,0,0,0,0,0,-3000
1436,華友聯          ,0,2000,-2000,0,0,0,0,0,0,-1000,0,1000,-1000,0,0,0,-3000
1612,宏泰            ,39000,42000,-3000,0,0,0,0,0,0,0,0,0,0,0,0,0,-3000
1724,台硝            ,0,3000,-3000,0,0,0,0,0,0,0,0,0,0,0,0,0,-3000
1725,元禎            ,0,3000,-3000,0,0,0,0,0,0,0,0,0,0,0,0,0,-3000
2114,鑫永銓          ,1000,4000,-3000,0,0,0,0,0,0,0,0,0,0,0,0,0,-3000
07020P,玉晶光台新99售02,0,0,0,0,0,0,0,0,0,-3000,0,0,0,0,3000,-3000,-3000
07100P,華航元大99售01  ,0,0,0,0,0,0,0,0,0,-3000,0,0,0,79000,82000,-3000,-3000
07194P,聯發科元大99售25,0,0,0,0,0,0,0,0,0,-3000,0,0,0,0,3000,-3000,-3000
6579,研揚            ,0,3000,-3000,0,0,0,0,0,0,0,0,0,0,0,0,0,-3000
5288,豐祥-KY         ,251000,252000,-1000,0,0,0,0,0,0,-2000,0,2000,-2000,0,0,0,-3000
4164,承業醫          ,71000,72000,-1000,0,0,0,0,0,0,-2000,0,2000,-2000,0,0,0,-3000
4720,德淵            ,9000,16000,-7000,0,0,0,0,0,0,4000,4000,0,4000,0,0,0,-3000
4746,台耀            ,30000,34000,-4000,0,0,0,0,0,0,1000,2000,1000,1000,0,0,0,-3000
3416,融程電          ,1000,4000,-3000,0,0,0,0,0,0,0,0,0,0,0,0,0,-3000
2420,新巨            ,22000,25000,-3000,0,0,0,0,0,0,0,0,0,0,0,0,0,-3000
2374,佳能            ,37000,40000,-3000,0,0,0,0,0,0,0,0,0,0,0,0,0,-3000
058237,嘉晶元大99購04  ,0,0,0,0,0,0,0,0,0,-3000,0,0,0,15000,18000,-3000,-3000
058040,FBVIX元大98購01 ,0,0,0,0,0,0,0,0,0,-3000,0,0,0,0,3000,-3000,-3000
05787P,臺股指永昌96售04,0,0,0,0,0,0,0,0,0,-3000,0,0,0,0,3000,-3000,-3000
053922,亞光國票96購01  ,0,0,0,0,0,0,0,0,0,-3000,0,0,0,0,3000,-3000,-3000
053696,日月光元大96購05,0,0,0,0,0,0,0,0,0,-3000,0,0,0,0,3000,-3000,-3000
053710,華通凱基96購05  ,0,0,0,0,0,0,0,0,0,-3000,0,0,0,37000,40000,-3000,-3000
051986,燿華元大96購04  ,0,0,0,0,0,0,0,0,0,-3000,0,0,0,0,3000,-3000,-3000
054306,聯發科凱基96購23,0,0,0,0,0,0,0,0,0,-3000,0,0,0,0,3000,-3000,-3000
052239,泰鼎國票97購01  ,0,0,0,0,0,0,0,0,0,-3000,0,0,0,0,3000,-3000,-3000
053040,全新凱基98購01  ,0,0,0,0,0,0,0,0,0,-3000,0,0,0,0,3000,-3000,-3000
052327,聯詠中信95購03  ,0,0,0,0,0,0,0,0,0,-3000,0,0,0,0,3000,-3000,-3000
051807,瑞昱凱基95購03  ,0,0,0,0,0,0,0,0,0,-3000,0,0,0,0,3000,-3000,-3000
053238,麗豐永豐96購01  ,0,0,0,0,0,0,0,0,0,-3000,0,0,0,0,3000,-3000,-3000
04922P,日月光凱基94售02,0,0,0,0,0,0,0,0,0,-3000,0,0,0,4000,7000,-3000,-3000
05059P,大立光國票96售02,0,0,0,0,0,0,0,0,0,-3000,0,0,0,48000,51000,-3000,-3000
050547,華新科凱基95購01,0,0,0,0,0,0,0,0,0,-3000,0,0,0,93000,96000,-3000,-3000
052908,大成鋼統一96購01,0,0,0,0,0,0,0,0,0,-3000,0,0,0,12000,15000,-3000,-3000
05265P,正崴元大95售03  ,0,0,0,0,0,0,0,0,0,-3000,0,0,0,0,3000,-3000,-3000
03052X,元展49          ,0,0,0,0,0,0,0,0,0,-3000,0,0,0,2000,5000,-3000,-3000
03647C,T50反1元富99牛02,0,0,0,0,0,0,0,0,0,-3000,0,0,0,7000,10000,-3000,-3000
051096,日月光元大95購01,0,0,0,0,0,0,0,0,0,-3000,0,0,0,0,3000,-3000,-3000
03033X,元展30          ,0,0,0,0,0,0,0,0,0,-3000,0,0,0,0,3000,-3000,-3000
046528,聯詠中信94購01  ,0,0,0,0,0,0,0,0,0,-3000,0,0,0,0,3000,-3000,-3000
056271,嘉澤統一97購01  ,0,0,0,0,0,0,0,0,0,-3000,0,0,0,22000,25000,-3000,-3000
05662P,景碩元富96售01  ,0,0,0,0,0,0,0,0,0,-3000,0,0,0,0,3000,-3000,-3000
057619,玉晶光凱基98購02,0,0,0,0,0,0,0,0,0,-3000,0,0,0,138000,141000,-3000,-3000
057649,嘉聯益元大99購04,0,0,0,0,0,0,0,0,0,-3000,0,0,0,28000,31000,-3000,-3000
056898,全新元大98購02  ,0,0,0,0,0,0,0,0,0,-3000,0,0,0,48000,51000,-3000,-3000
057228,友達凱基9B購01  ,0,0,0,0,0,0,0,0,0,-3000,0,0,0,17000,20000,-3000,-3000
058882,晶相光永豐99購01,0,0,0,0,0,0,0,0,0,-3000,0,0,0,18000,21000,-3000,-3000
05573P,仁寶元富96售02  ,0,0,0,0,0,0,0,0,0,-3000,0,0,0,0,3000,-3000,-3000
059107,南茂國泰9A購01  ,0,0,0,0,0,0,0,0,0,-3000,0,0,0,77000,80000,-3000,-3000
059207,臺指反元大9C購02,0,0,0,0,0,0,0,0,0,-3000,0,0,0,21000,24000,-3000,-3000
059175,臺股指凱基99購26,0,0,0,0,0,0,0,0,0,-3000,0,0,0,0,3000,-3000,-3000
055617,TPK國票98購04   ,0,0,0,0,0,0,0,0,0,-3000,0,0,0,0,3000,-3000,-3000
05600P,玉晶光台新96售04,0,0,0,0,0,0,0,0,0,-3000,0,0,0,39000,42000,-3000,-3000
058442,玉晶光台新99購01,0,0,0,0,0,0,0,0,0,-3000,0,0,0,150000,153000,-3000,-3000
055339,緯穎兆豐98購01  ,0,0,0,0,0,0,0,0,0,-3000,0,0,0,0,3000,-3000,-3000
057798,貿聯兆豐99購01  ,0,0,0,0,0,0,0,0,0,-3000,0,0,0,1000,4000,-3000,-3000
058249,緯穎元大99購04  ,0,0,0,0,0,0,0,0,0,-3000,0,0,0,5000,8000,-3000,-3000
055441,緯穎國票98購01  ,0,0,0,0,0,0,0,0,0,-3000,0,0,0,0,3000,-3000,-3000
058277,FBVIX中信03購01 ,0,0,0,0,0,0,0,0,0,-3000,0,0,0,0,3000,-3000,-3000
058561,T50反1凱基9A購05,0,0,0,0,0,0,0,0,0,-3000,0,0,0,0,3000,-3000,-3000
057523,大成鋼元大99購01,0,0,0,0,0,0,0,0,0,-3000,0,0,0,22000,25000,-3000,-3000
058672,可成群益9B購02  ,0,0,0,0,0,0,0,0,0,-3000,0,0,0,10000,13000,-3000,-3000
9902,台火            ,7000,9000,-2000,0,0,0,0,0,0,-1000,0,1000,-1000,0,0,0,-3000
9918,欣天然          ,0,3000,-3000,0,0,0,0,0,0,0,0,0,0,0,0,0,-3000
8427,基勝-KY         ,0,3000,-3000,0,0,0,0,0,0,0,0,0,0,0,0,0,-3000
8482,商億-KY         ,10000,13000,-3000,0,0,0,0,0,0,0,0,0,0,0,0,0,-3000
2415,錩新            ,3000,2000,1000,0,0,0,0,0,0,-5000,0,5000,-5000,0,0,0,-4000
2497,怡利電          ,4000,8000,-4000,0,0,0,0,0,0,0,0,0,0,0,0,0,-4000
2630,亞航            ,0,4000,-4000,0,0,0,0,0,0,0,0,0,0,0,0,0,-4000
3164,景岳            ,5000,9000,-4000,0,0,0,0,0,0,0,0,0,0,0,0,0,-4000
3040,遠見            ,0,4000,-4000,0,0,0,0,0,0,0,0,0,0,0,0,0,-4000
2911,麗嬰房          ,0,4000,-4000,0,0,0,0,0,0,0,0,0,0,0,0,0,-4000
3266,昇陽            ,0,4000,-4000,0,0,0,0,0,0,0,0,0,0,0,0,0,-4000
07114P,旺宏兆豐9A售01  ,0,0,0,0,0,0,0,0,0,-4000,0,0,0,0,4000,-4000,-4000
07015P,國巨元大99售13  ,0,0,0,0,0,0,0,0,0,-4000,0,0,0,0,4000,-4000,-4000
07267P,臺股指元大99售23,0,0,0,0,0,0,0,0,0,-4000,0,0,0,0,4000,-4000,-4000
2007,燁興            ,0,4000,-4000,0,0,0,0,0,0,0,0,0,0,0,0,0,-4000
1530,亞崴            ,0,3000,-3000,0,0,0,0,0,0,-1000,0,1000,-1000,0,0,0,-4000
06486P,麗豐元大98售02  ,0,0,0,0,0,0,0,0,0,-4000,0,0,0,0,4000,-4000,-4000
06715P,台積電元大99售04,0,0,0,0,0,0,0,0,0,-4000,0,0,0,0,4000,-4000,-4000
060011,臺股指群益9C購06,0,0,0,0,0,0,0,0,0,-4000,0,0,0,16000,20000,-4000,-4000
060218,台積電凱基9A購15,0,0,0,0,0,0,0,0,0,-4000,0,0,0,227000,231000,-4000,-4000
060210,上銀康和9A購01  ,0,0,0,0,0,0,0,0,0,-4000,0,0,0,0,4000,-4000,-4000
060269,台灣50元大9C購21,0,0,0,0,0,0,0,0,0,-4000,0,0,0,0,4000,-4000,-4000
059699,華通凱基99購04  ,0,0,0,0,0,0,0,0,0,-4000,0,0,0,6000,10000,-4000,-4000
059783,旺宏元大99購17  ,0,0,0,0,0,0,0,0,0,-4000,0,0,0,29000,33000,-4000,-4000
059799,台灣50元富01購05,0,0,0,0,0,0,0,0,0,-4000,0,0,0,0,4000,-4000,-4000
059381,TPK亞東99購01   ,0,0,0,0,0,0,0,0,0,-4000,0,0,0,0,4000,-4000,-4000
059479,國巨群益99購10  ,0,0,0,0,0,0,0,0,0,-4000,0,0,0,31000,35000,-4000,-4000
045842,T50反1台新98購01,0,0,0,0,0,0,0,0,0,-4000,0,0,0,0,4000,-4000,-4000
047737,義隆麥證94購01  ,0,0,0,0,4000,-4000,0,0,0,-4000,0,0,0,0,4000,-4000,-4000
03006X,元展06          ,0,0,0,0,0,0,0,0,0,-4000,0,0,0,0,4000,-4000,-4000
00666R,富邦恒生國企反1 ,1000,0,1000,0,0,0,0,0,0,-5000,0,0,0,80000,85000,-5000,-4000
0054,元大台商50      ,0,0,0,0,0,0,0,0,0,-4000,0,0,0,0,4000,-4000,-4000
0051,元大中型100     ,0,0,0,0,0,0,0,0,0,-4000,0,0,0,18000,22000,-4000,-4000
03737P,臺股指中信95售01,0,4000,-4000,0,0,0,0,0,0,0,0,0,0,0,0,0,-4000
03427B,臺股指元大9A熊02,0,0,0,0,0,0,0,0,0,-4000,0,0,0,2000,6000,-4000,-4000
04344P,台達電國泰94售01,0,0,0,0,0,0,0,0,0,-4000,0,0,0,0,4000,-4000,-4000
053642,瀚宇博永豐96購01,0,0,0,0,0,0,0,0,0,-4000,0,0,0,94000,98000,-4000,-4000
058055,華擎統一9A購01  ,0,0,0,0,0,0,0,0,0,-4000,0,0,0,31000,35000,-4000,-4000
058650,台虹永豐9A購01  ,0,0,0,0,0,0,0,0,0,-4000,0,0,0,0,4000,-4000,-4000
058579,聯發科群益99購04,0,0,0,0,0,0,0,0,0,-4000,0,0,0,0,4000,-4000,-4000
057446,旺宏元富02購01  ,0,0,0,0,0,0,0,0,0,-4000,0,0,0,424000,428000,-4000,-4000
057422,欣興凱基98購04  ,0,0,0,0,0,0,0,0,0,-4000,0,0,0,2000,6000,-4000,-4000
05619P,創意元富96售02  ,0,0,0,0,0,0,0,0,0,-4000,0,0,0,0,4000,-4000,-4000
055615,宏達電國票99購02,0,0,0,0,0,0,0,0,0,-4000,0,0,0,50000,54000,-4000,-4000
058935,元油2X中信9C購03,0,0,0,0,0,0,0,0,0,-4000,0,0,0,0,4000,-4000,-4000
057308,同欣電兆豐99購01,0,0,0,0,0,0,0,0,0,-4000,0,0,0,0,4000,-4000,-4000
056274,彩晶統一98購02  ,0,0,0,0,0,0,0,0,0,-4000,0,0,0,0,4000,-4000,-4000
8497,格威傳媒        ,8000,12000,-4000,0,0,0,0,0,0,0,0,0,0,0,0,0,-4000
059385,滬深2X凱基9C購03,0,0,0,0,0,0,0,0,0,-5000,0,0,0,10000,15000,-5000,-5000
059583,台灣50元大01購10,0,0,0,0,0,0,0,0,0,-5000,0,0,0,10000,15000,-5000,-5000
059663,旭富元大9C購02  ,0,0,0,0,0,0,0,0,0,-5000,0,0,0,130000,135000,-5000,-5000
059970,台灣50元大9B購07,0,0,0,0,0,0,0,0,0,-5000,0,0,0,0,5000,-5000,-5000
060341,國巨統一9C購02  ,0,0,0,0,0,0,0,0,0,-5000,0,0,0,0,5000,-5000,-5000
06035P,同欣電凱基96售03,0,0,0,0,0,0,0,0,0,-5000,0,0,0,10000,15000,-5000,-5000
060159,健和興永豐9A購01,0,0,0,0,0,0,0,0,0,-5000,0,0,0,0,5000,-5000,-5000
060155,友訊永豐9A購01  ,0,0,0,0,0,0,0,0,0,-5000,0,0,0,15000,20000,-5000,-5000
060178,T50反1元富04購05,0,0,0,0,0,0,0,0,0,-5000,0,0,0,0,5000,-5000,-5000
060002,T50反1群益9A購01,0,0,0,0,0,0,0,0,0,-5000,0,0,0,0,5000,-5000,-5000
06867P,訊芯元大98售08  ,0,0,0,0,0,0,0,0,0,-5000,0,0,0,0,5000,-5000,-5000
06328P,台積電中信01售02,0,0,0,0,0,0,0,0,0,-5000,0,0,0,0,5000,-5000,-5000
1324,地球            ,0,5000,-5000,0,0,0,0,0,0,0,0,0,0,0,0,0,-5000
07447P,台灣50元大9A售07,0,0,0,0,0,0,0,0,0,-5000,0,0,0,0,5000,-5000,-5000
1203,味王            ,1000,6000,-5000,0,0,0,0,0,0,0,0,0,0,0,0,0,-5000
1617,榮星            ,0,5000,-5000,0,0,0,0,0,0,0,0,0,0,0,0,0,-5000
07364P,大立光元大99售27,0,0,0,0,0,0,0,0,0,-5000,0,0,0,0,5000,-5000,-5000
07418P,聯發科元大99售45,0,0,0,0,0,0,0,0,0,-5000,0,0,0,0,5000,-5000,-5000
07212P,聯發科凱基99售14,0,0,0,0,0,0,0,0,0,-5000,0,0,0,0,5000,-5000,-5000
3679,新至陞          ,5000,10000,-5000,0,0,0,0,0,0,0,0,0,0,0,0,0,-5000
4551,智伸科          ,197000,305000,-108000,0,0,0,0,0,0,103000,104000,4000,100000,5000,2000,3000,-5000
3011,今皓            ,0,5000,-5000,0,0,0,0,0,0,0,0,0,0,0,0,0,-5000
2616,山隆            ,9000,14000,-5000,0,0,0,0,0,0,0,0,0,0,0,0,0,-5000
2731,雄獅            ,20000,25000,-5000,0,0,0,0,0,0,0,0,0,0,0,0,0,-5000
2611,志信            ,2000,7000,-5000,0,0,0,0,0,0,0,0,0,0,0,0,0,-5000
2838A,聯邦銀甲特      ,13000,0,13000,0,0,0,0,0,0,-18000,2000,20000,-18000,0,0,0,-5000
2887E,台新戊特        ,0,5000,-5000,0,0,0,0,0,0,0,0,0,0,0,0,0,-5000
2421,建準            ,631000,773000,-142000,0,0,0,0,0,0,137000,57000,0,57000,84000,4000,80000,-5000
058224,世芯統一9B購02  ,0,0,0,0,0,0,0,0,0,-5000,0,0,0,0,5000,-5000,-5000
053111,緯創兆豐97購01  ,0,0,0,0,0,0,0,0,0,-5000,0,0,0,0,5000,-5000,-5000
052174,聯發科元大95購13,0,0,0,0,0,0,0,0,0,-5000,0,0,0,10000,15000,-5000,-5000
054352,世芯國泰98購01  ,0,0,0,0,0,0,0,0,0,-5000,0,0,0,0,5000,-5000,-5000
05104P,智邦台新95售02  ,0,0,0,0,0,0,0,0,0,-5000,0,0,0,0,5000,-5000,-5000
051356,全新元大96購04  ,0,0,0,0,0,0,0,0,0,-5000,0,0,0,50000,55000,-5000,-5000
050836,緯穎凱基95購01  ,0,0,0,0,0,0,0,0,0,-5000,0,0,0,1000,6000,-5000,-5000
01002T,土銀國泰R1      ,0,5000,-5000,0,0,0,0,0,0,0,0,0,0,0,0,0,-5000
047993,鑽全元大96購01  ,0,0,0,0,0,0,0,0,0,-5000,0,0,0,0,5000,-5000,-5000
045753,大立光國泰94購02,0,0,0,0,0,0,0,0,0,-5000,0,0,0,5000,10000,-5000,-5000
048590,貿聯兆豐94購02  ,0,0,0,0,0,0,0,0,0,-5000,0,0,0,0,5000,-5000,-5000
05416P,喬山永豐95售04  ,0,0,0,0,0,0,0,0,0,-5000,0,0,0,0,5000,-5000,-5000
054103,T50反1凱基99購04,0,0,0,0,0,0,0,0,0,-5000,0,0,0,0,5000,-5000,-5000
054115,台塑康和96購01  ,0,0,0,0,0,0,0,0,0,-5000,0,0,0,0,5000,-5000,-5000
050542,宏碁凱基95購01  ,0,0,0,0,0,0,0,0,0,-5000,0,0,0,0,5000,-5000,-5000
048298,華通麥證94購01  ,0,0,0,0,5000,-5000,0,0,0,-5000,0,0,0,0,5000,-5000,-5000
049871,T50反1台新9A購02,0,0,0,0,0,0,0,0,0,-5000,0,0,0,0,5000,-5000,-5000
055841,南亞科元大97購04,0,0,0,0,0,0,0,0,0,-5000,0,0,0,20000,25000,-5000,-5000
057601,中磊群益98購01  ,0,0,0,0,0,0,0,0,0,-5000,0,0,0,0,5000,-5000,-5000
057605,旺宏統一99購03  ,0,0,0,0,0,0,0,0,0,-5000,0,0,0,45000,50000,-5000,-5000
057205,元翎元富98購01  ,0,0,0,0,0,0,0,0,0,-5000,0,0,0,0,5000,-5000,-5000
057674,台郡元大99購03  ,0,0,0,0,0,0,0,0,0,-5000,0,0,0,1000,6000,-5000,-5000
057713,美律統一99購01  ,0,0,0,0,0,0,0,0,0,-5000,0,0,0,60000,65000,-5000,-5000
058517,景碩元大99購06  ,0,0,0,0,0,0,0,0,0,-5000,0,0,0,4000,9000,-5000,-5000
058844,元油2X群益9C購03,0,0,0,0,0,0,0,0,0,-5000,0,0,0,0,5000,-5000,-5000
058770,貿聯兆豐9A購01  ,0,0,0,0,0,0,0,0,0,-5000,0,0,0,0,5000,-5000,-5000
056819,奇力新永豐98購01,0,0,0,0,0,0,0,0,0,-5000,0,0,0,30000,35000,-5000,-5000
056817,國巨永豐98購04  ,0,0,0,0,0,0,0,0,0,-5000,0,0,0,0,5000,-5000,-5000
059148,百和國票9A購01  ,0,0,0,0,0,0,0,0,0,-5000,0,0,0,6000,11000,-5000,-5000
058980,鴻海凱基99購06  ,0,0,0,0,0,0,0,0,0,-5000,0,0,0,34000,39000,-5000,-5000
058962,元油2X兆豐9A購02,5000,10000,-5000,0,0,0,0,0,0,0,0,0,0,0,0,0,-5000
05611P,康控群益96售02  ,0,0,0,0,0,0,0,0,0,-5000,0,0,0,0,5000,-5000,-5000
05598P,國巨元富96售03  ,0,0,0,0,0,0,0,0,0,-5000,0,0,0,0,5000,-5000,-5000
055299,康友元大97購02  ,0,0,0,0,0,0,0,0,0,-5000,0,0,0,0,5000,-5000,-5000
056375,玉晶光統一01購01,0,0,0,0,0,0,0,0,0,-5000,0,0,0,0,5000,-5000,-5000
056343,高鐵凱基98購02  ,0,0,0,0,0,0,0,0,0,-5000,0,0,0,50000,55000,-5000,-5000
058099,鴻海國泰9A購02  ,0,0,0,0,0,0,0,0,0,-5000,0,0,0,5000,10000,-5000,-5000
058279,FBVIX中信03購03 ,0,0,0,0,0,0,0,0,0,-5000,0,0,0,0,5000,-5000,-5000
057518,世紀鋼元富98購01,0,0,0,0,0,0,0,0,0,-5000,0,0,0,10000,15000,-5000,-5000
9912,偉聯            ,0,5000,-5000,0,0,0,0,0,0,0,0,0,0,0,0,0,-5000
9926,新海            ,0,5000,-5000,0,0,0,0,0,0,0,0,0,0,0,0,0,-5000
2429,銘旺科          ,7000,13000,-6000,0,0,0,0,0,0,0,0,0,0,0,0,0,-6000
2348,海悅            ,24000,63000,-39000,0,0,0,0,0,0,33000,39000,6000,33000,0,0,0,-6000
2506,太設            ,0,6000,-6000,0,0,0,0,0,0,0,0,0,0,0,0,0,-6000
2483,百容            ,3000,9000,-6000,0,0,0,0,0,0,0,0,0,0,0,0,0,-6000
2705,六福            ,0,6000,-6000,0,0,0,0,0,0,0,0,0,0,0,0,0,-6000
3021,鴻名            ,0,7000,-7000,0,0,0,0,0,0,1000,1000,0,1000,0,0,0,-6000
2939,凱羿-KY         ,6000,12000,-6000,0,0,0,0,0,0,0,0,0,0,0,0,0,-6000
5533,皇鼎            ,15000,21000,-6000,0,0,0,0,0,0,0,0,0,0,0,0,0,-6000
6215,和椿            ,6000,12000,-6000,0,0,0,0,0,0,0,0,0,0,0,0,0,-6000
6201,亞弘電          ,2000,8000,-6000,0,0,0,0,0,0,0,0,0,0,0,0,0,-6000
07226P,貿聯富邦9B售01  ,0,0,0,0,0,0,0,0,0,-6000,0,0,0,10000,16000,-6000,-6000
07165P,臺股指群益99售16,0,0,0,0,0,0,0,0,0,-6000,0,0,0,0,6000,-6000,-6000
07362P,聯發科元大99售35,0,0,0,0,0,0,0,0,0,-6000,0,0,0,6000,12000,-6000,-6000
07278P,台灣50元富9C售03,0,0,0,0,0,0,0,0,0,-6000,0,0,0,0,6000,-6000,-6000
1423,利華            ,0,6000,-6000,0,0,0,0,0,0,0,0,0,0,0,0,0,-6000
06582P,可成凱基98售06  ,0,0,0,0,0,0,0,0,0,-6000,0,0,0,9000,15000,-6000,-6000
06674P,祥碩群益98售02  ,0,0,0,0,0,0,0,0,0,-6000,0,0,0,36000,42000,-6000,-6000
06729P,聯詠元大98售03  ,0,0,0,0,0,0,0,0,0,-6000,0,0,0,0,6000,-6000,-6000
059782,A50正2元大9C購04,0,0,0,0,0,0,0,0,0,-6000,0,0,0,0,6000,-6000,-6000
052915,創意元富96購01  ,0,0,0,0,0,0,0,0,0,-6000,0,0,0,228000,234000,-6000,-6000
006203,元大MSCI台灣    ,0,0,0,0,0,0,0,0,0,-6000,0,0,0,2000,8000,-6000,-6000
050921,旺宏凱基95購02  ,0,0,0,0,0,0,0,0,0,-6000,0,0,0,0,6000,-6000,-6000
05116P,台積電群益95售03,0,0,0,0,0,0,0,0,0,-6000,0,0,0,99000,105000,-6000,-6000
05063P,聯電元大96售03  ,0,0,0,0,0,0,0,0,0,-6000,0,0,0,5000,11000,-6000,-6000
03421B,臺股指元大99熊01,0,0,0,0,0,0,0,0,0,-6000,0,0,0,40000,46000,-6000,-6000
058311,緯穎元大99購05  ,0,0,0,0,0,0,0,0,0,-6000,0,0,0,49000,55000,-6000,-6000
058043,鴻海元大98購13  ,0,0,0,0,0,0,0,0,0,-6000,0,0,0,36000,42000,-6000,-6000
057957,嘉晶元大98購01  ,0,0,0,0,0,0,0,0,0,-6000,0,0,0,0,6000,-6000,-6000
055449,超眾統一9A購01  ,0,0,0,0,0,0,0,0,0,-6000,0,0,0,0,6000,-6000,-6000
058729,國巨永豐99購03  ,0,0,0,0,0,0,0,0,0,-6000,0,0,0,13000,19000,-6000,-6000
056199,美律永豐97購01  ,0,0,0,0,0,0,0,0,0,-6000,0,0,0,0,6000,-6000,-6000
059078,FBVIX元大99購06 ,0,0,0,0,0,0,0,0,0,-6000,0,0,0,0,6000,-6000,-6000
056767,大毅元大99購01  ,0,0,0,0,0,0,0,0,0,-6000,0,0,0,4000,10000,-6000,-6000
056735,國巨凱基99購02  ,0,0,0,0,0,0,0,0,0,-6000,0,0,0,0,6000,-6000,-6000
058781,康友國票9A購01  ,0,0,0,0,0,0,0,0,0,-6000,0,0,0,118000,124000,-6000,-6000
058835,元油2X中信9C購02,0,0,0,0,0,0,0,0,0,-6000,0,0,0,0,6000,-6000,-6000
057216,聯發科群益99購01,0,0,0,0,0,0,0,0,0,-6000,0,0,0,31000,37000,-6000,-6000
910861,神州-DR         ,3000,9000,-6000,0,0,0,0,0,0,0,0,0,0,0,0,0,-6000
2477,美隆電          ,18000,24295,-6295,0,0,0,0,0,0,0,0,0,0,0,0,0,-6295
6281,全國電          ,5000,11467,-6467,0,0,0,0,0,0,0,0,0,0,0,0,0,-6467
4755,三福化          ,1000,8000,-7000,0,0,0,0,0,0,0,0,0,0,0,0,0,-7000
3054,立萬利          ,1000,8000,-7000,0,0,0,0,0,0,0,0,0,0,0,0,0,-7000
2109,華豐            ,0,7000,-7000,0,0,0,0,0,0,0,0,0,0,0,0,0,-7000
07388P,臺股指群益9C售07,0,0,0,0,0,0,0,0,0,-7000,0,0,0,0,7000,-7000,-7000
07417P,聯發科元大99售44,0,0,0,0,0,0,0,0,0,-7000,0,0,0,0,7000,-7000,-7000
07071P,立積元富99售01  ,0,0,0,0,0,0,0,0,0,-7000,0,0,0,0,7000,-7000,-7000
059967,聯發科凱基99購20,0,0,0,0,0,0,0,0,0,-7000,0,0,0,13000,20000,-7000,-7000
059855,緯穎永豐99購04  ,0,0,0,0,0,0,0,0,0,-7000,0,0,0,10000,17000,-7000,-7000
06622P,牧德元大98售01  ,0,0,0,0,0,0,0,0,0,-7000,0,0,0,3000,10000,-7000,-7000
06074P,台積電凱基98售04,0,0,0,0,0,0,0,0,0,-7000,0,0,0,2000,9000,-7000,-7000
060136,T50反1國票9A購01,0,0,0,0,0,0,0,0,0,-7000,0,0,0,0,7000,-7000,-7000
060169,群電永豐9A購01  ,0,0,0,0,0,0,0,0,0,-7000,0,0,0,0,7000,-7000,-7000
060228,亞德客元大9A購01,0,0,0,0,0,0,0,0,0,-7000,0,0,0,20000,27000,-7000,-7000
060281,卜蜂元大9C購01  ,0,0,0,0,0,0,0,0,0,-7000,0,0,0,0,7000,-7000,-7000
058234,華新科元大99購12,0,0,0,0,0,0,0,0,0,-7000,0,0,0,1000,8000,-7000,-7000
051690,超眾凱基95購03  ,0,0,0,0,0,0,0,0,0,-7000,0,0,0,0,7000,-7000,-7000
052269,T50反1日盛9B購01,0,0,0,0,0,0,0,0,0,-7000,0,0,0,0,7000,-7000,-7000
035276,南亞科台新97購01,0,0,0,0,0,0,0,0,0,-7000,0,0,0,8000,15000,-7000,-7000
03424B,臺股指元大96熊26,0,0,0,0,0,0,0,0,0,-7000,0,0,0,0,7000,-7000,-7000
03420B,臺股指元大95熊31,0,0,0,0,0,0,0,0,0,-7000,0,0,0,0,7000,-7000,-7000
03658C,T50反1元大9A牛02,0,1000,-1000,0,0,0,0,0,0,-6000,0,0,0,3000,9000,-6000,-7000
0057,富邦摩台        ,0,0,0,0,0,0,0,0,0,-7000,0,0,0,24000,31000,-7000,-7000
00661,元大日經225     ,0,0,0,0,0,0,0,0,0,-7000,0,0,0,0,7000,-7000,-7000
052647,晶技永豐97購01  ,0,0,0,0,0,0,0,0,0,-7000,0,0,0,31000,38000,-7000,-7000
057313,聯發科麥證99購01,0,0,0,0,7000,-7000,0,0,0,-7000,0,0,0,0,7000,-7000,-7000
057589,超眾國票9A購01  ,0,0,0,0,0,0,0,0,0,-7000,0,0,0,0,7000,-7000,-7000
057097,致新元富98購01  ,0,0,0,0,0,0,0,0,0,-7000,0,0,0,23000,30000,-7000,-7000
057529,嘉晶元大99購02  ,0,0,0,0,0,0,0,0,0,-7000,0,0,0,0,7000,-7000,-7000
056693,國產群益98購01  ,0,0,0,0,0,0,0,0,0,-7000,0,0,0,98000,105000,-7000,-7000
05459P,聯詠凱基95售03  ,0,0,0,0,0,0,0,0,0,-7000,0,0,0,0,7000,-7000,-7000
059066,道瓊指國票04購01,0,0,0,0,0,0,0,0,0,-7000,0,0,0,1000,8000,-7000,-7000
056186,智原統一97購01  ,0,0,0,0,0,0,0,0,0,-7000,0,0,0,0,7000,-7000,-7000
058575,智邦群益99購01  ,0,0,0,0,0,0,0,0,0,-7000,0,0,0,139000,146000,-7000,-7000
058078,景碩國票99購01  ,0,0,0,0,0,0,0,0,0,-7000,0,0,0,68000,75000,-7000,-7000
8222,寶一            ,0,7000,-7000,0,0,0,0,0,0,0,0,0,0,0,0,0,-7000
8367,建新國際        ,0,7000,-7000,0,0,0,0,0,0,0,0,0,0,0,0,0,-7000
1598,岱宇            ,49000,46197,2803,0,0,0,0,0,0,-10000,0,10000,-10000,0,0,0,-7197
07479P,A50正2元富9A售03,0,0,0,0,0,0,0,0,0,-8000,0,0,0,0,8000,-8000,-8000
07197P,臺股指元大99售13,0,0,0,0,0,0,0,0,0,-8000,0,0,0,2000,10000,-8000,-8000
07198P,臺股指元大99售14,0,0,0,0,0,0,0,0,0,-8000,0,0,0,4000,12000,-8000,-8000
07419P,聯發科元大99售46,0,0,0,0,0,0,0,0,0,-8000,0,0,0,0,8000,-8000,-8000
07383P,聯發科群益99售06,0,0,0,0,0,0,0,0,0,-8000,0,0,0,4000,12000,-8000,-8000
2597,潤弘            ,6000,16000,-10000,0,0,0,0,0,0,2000,2000,0,2000,0,0,0,-8000
2543,皇昌            ,0,8000,-8000,0,0,0,0,0,0,0,0,0,0,0,0,0,-8000
4930,燦星網          ,15000,23000,-8000,0,0,0,0,0,0,0,0,0,0,0,0,0,-8000
4581,光隆精密-KY     ,1000,9000,-8000,0,0,0,0,0,0,0,0,0,0,0,0,0,-8000
060211,智邦康和9A購01  ,0,0,0,0,0,0,0,0,0,-8000,0,0,0,0,8000,-8000,-8000
060091,技嘉元大99購03  ,0,0,0,0,0,0,0,0,0,-8000,0,0,0,36000,44000,-8000,-8000
06859P,元金2X中信9C售01,0,0,0,0,0,0,0,0,0,-8000,0,0,0,0,8000,-8000,-8000
059870,全新凱基99購05  ,0,0,0,0,0,0,0,0,0,-8000,0,0,0,244000,252000,-8000,-8000
059806,聯發科元富99購08,0,0,0,0,0,0,0,0,0,-8000,0,0,0,0,8000,-8000,-8000
059707,健策凱基9A購03  ,0,0,0,0,0,0,0,0,0,-8000,0,0,0,17000,25000,-8000,-8000
059721,旺宏元大99購16  ,0,0,0,0,0,0,0,0,0,-8000,0,0,0,38000,46000,-8000,-8000
059320,華新科元大99購15,0,0,0,0,0,0,0,0,0,-8000,0,0,0,33000,41000,-8000,-8000
059306,台灣50元大99購03,0,0,0,0,0,0,0,0,0,-8000,0,0,0,32000,40000,-8000,-8000
059357,華通永豐99購01  ,0,0,0,0,0,0,0,0,0,-8000,0,0,0,120000,128000,-8000,-8000
059348,日月光凱基99購01,0,0,0,0,0,0,0,0,0,-8000,0,0,0,39000,47000,-8000,-8000
048166,滬深2X永豐96購02,0,0,0,0,0,0,0,0,0,-8000,0,0,0,12000,20000,-8000,-8000
047970,鴻海富邦95購01  ,0,0,0,0,0,0,0,0,0,-8000,0,0,0,163000,171000,-8000,-8000
03669C,滬深2X元富09牛01,0,0,0,0,0,0,0,0,0,-8000,0,0,0,4000,12000,-8000,-8000
054311,世芯凱基96購02  ,0,0,0,0,0,0,0,0,0,-8000,0,0,0,242000,250000,-8000,-8000
051572,上銀元大95購01  ,0,0,0,0,0,0,0,0,0,-8000,0,0,0,1000,9000,-8000,-8000
053473,聯發科元大96購15,0,0,0,0,0,0,0,0,0,-8000,0,0,0,0,8000,-8000,-8000
058129,國巨元大99購10  ,0,0,0,0,0,0,0,0,0,-8000,0,0,0,22000,30000,-8000,-8000
058705,長榮航元大99購01,0,0,0,0,0,0,0,0,0,-8000,0,0,0,287000,295000,-8000,-8000
056179,康友元富97購02  ,0,0,0,0,0,0,0,0,0,-8000,0,0,0,0,8000,-8000,-8000
055619,同欣電國票98購02,0,0,0,0,0,0,0,0,0,-8000,0,0,0,0,8000,-8000,-8000
055938,矽力群益97購01  ,0,0,0,0,0,0,0,0,0,-8000,0,0,0,2000,10000,-8000,-8000
059126,臺指反中信9B購01,0,0,0,0,0,0,0,0,0,-8000,0,0,0,0,8000,-8000,-8000
057147,新日興國票99購01,0,0,0,0,0,0,0,0,0,-8000,0,0,0,0,8000,-8000,-8000
056905,欣興元大98購03  ,0,0,0,0,0,0,0,0,0,-8000,0,0,0,1000,9000,-8000,-8000
057671,群創元大9B購06  ,0,0,0,0,0,0,0,0,0,-8000,0,0,0,0,8000,-8000,-8000
059363,超眾永豐99購02  ,0,0,0,0,0,0,0,0,0,-9000,0,0,0,38000,47000,-9000,-9000
059829,超眾凱基99購05  ,0,0,0,0,0,0,0,0,0,-9000,0,0,0,101000,110000,-9000,-9000
059933,台灣50永豐99購11,0,0,0,0,0,0,0,0,0,-9000,0,0,0,63000,72000,-9000,-9000
06868P,電子類元大99售01,0,0,0,0,0,0,0,0,0,-9000,0,0,0,1000,10000,-9000,-9000
06885P,國巨國票99售06  ,0,0,0,0,0,0,0,0,0,-9000,0,0,0,1000,10000,-9000,-9000
06310P,精元元富97售02  ,0,0,0,0,0,0,0,0,0,-9000,0,0,0,7000,16000,-9000,-9000
6224,聚鼎            ,80000,57000,23000,0,0,0,0,65000,-65000,33000,33000,0,33000,0,0,0,-9000
07474P,滬深2X群益9C售03,0,0,0,0,0,0,0,0,0,-9000,0,0,0,0,9000,-9000,-9000
2020,美亞            ,6000,14000,-8000,0,0,0,0,0,0,-1000,0,1000,-1000,0,0,0,-9000
058363,全新凱基9A購02  ,0,0,0,0,0,0,0,0,0,-9000,0,0,0,283000,292000,-9000,-9000
03676C,臺股指元大04牛03,0,0,0,0,0,0,0,0,0,-9000,0,0,0,1000,10000,-9000,-9000
050904,臺股指元大95購11,0,0,0,0,0,0,0,0,0,-9000,0,0,0,24000,33000,-9000,-9000
049156,緯穎元大96購01  ,0,0,0,0,0,0,0,0,0,-9000,0,0,0,0,9000,-9000,-9000
04971P,矽力元富94售02  ,0,0,0,0,0,0,0,0,0,-9000,0,0,0,1000,10000,-9000,-9000
04840P,大立光元大94售18,0,0,0,0,0,0,0,0,0,-9000,0,0,0,21000,30000,-9000,-9000
052794,群創兆豐97購01  ,0,0,0,0,0,0,0,0,0,-9000,0,0,0,1000,10000,-9000,-9000
057191,祥碩元大98購05  ,0,0,0,0,0,0,0,0,0,-9000,0,0,0,26000,35000,-9000,-9000
05663P,創意元富96售04  ,0,0,0,0,0,0,0,0,0,-9000,0,0,0,0,9000,-9000,-9000
059084,鴻海元大99購24  ,0,0,0,0,0,0,0,0,0,-9000,0,0,0,0,9000,-9000,-9000
054852,奇鋐國票98購01  ,0,0,0,0,0,0,0,0,0,-9000,0,0,0,89000,98000,-9000,-9000
058611,欣興元大99購06  ,0,0,0,0,0,0,0,0,0,-9000,0,0,0,20000,29000,-9000,-9000
055173,瑞昱統一97購01  ,0,0,0,0,0,0,0,0,0,-9000,0,0,0,71000,80000,-9000,-9000
058626,瑞昱國票9A購01  ,0,0,0,0,0,0,0,0,0,-9000,0,0,0,12000,21000,-9000,-9000
058310,大立光元大99購10,0,0,0,0,0,0,0,0,0,-9000,0,0,0,0,9000,-9000,-9000
057332,旺宏國票99購03  ,0,0,0,0,0,0,0,0,0,-9000,0,0,0,16000,25000,-9000,-9000
057386,聯發科永豐98購04,0,0,0,0,0,0,0,0,0,-9000,0,0,0,0,9000,-9000,-9000
2012,春雨            ,0,10000,-10000,0,0,0,0,0,0,0,0,0,0,0,0,0,-10000
2227,裕日車          ,10000,11000,-1000,0,0,0,0,0,0,-9000,0,9000,-9000,0,0,0,-10000
1535,中宇            ,3000,12000,-9000,0,0,0,0,0,0,-1000,0,1000,-1000,0,0,0,-10000
07448P,台灣50元大9A售08,0,0,0,0,0,0,0,0,0,-10000,0,0,0,0,10000,-10000,-10000
07446P,台灣50元大9A售06,0,0,0,0,0,0,0,0,0,-10000,0,0,0,0,10000,-10000,-10000
08852P,台灣50台新01售01,0,0,0,0,0,0,0,0,0,-10000,0,0,0,0,10000,-10000,-10000
07422P,大立光元大99售32,0,0,0,0,0,0,0,0,0,-10000,0,0,0,0,10000,-10000,-10000
07395P,台積電群益99售13,0,0,0,0,0,0,0,0,0,-10000,0,0,0,0,10000,-10000,-10000
07299P,台灣50元大9C售13,0,0,0,0,0,0,0,0,0,-10000,0,0,0,0,10000,-10000,-10000
07327P,台灣50群益9A售06,0,0,0,0,0,0,0,0,0,-10000,0,0,0,0,10000,-10000,-10000
07343P,高鐵康和99售01  ,0,0,0,0,0,0,0,0,0,-10000,0,0,0,0,10000,-10000,-10000
07206P,鴻海凱基9A售11  ,0,0,0,0,0,0,0,0,0,-10000,0,0,0,0,10000,-10000,-10000
07160P,台灣50中信03售04,0,0,0,0,0,0,0,0,0,-10000,0,0,0,20000,30000,-10000,-10000
07254P,台灣50凱基9C售06,0,0,0,0,0,0,0,0,0,-10000,0,0,0,0,10000,-10000,-10000
07247P,聯發科凱基9A售06,0,0,0,0,0,0,0,0,0,-10000,0,0,0,0,10000,-10000,-10000
07068P,欣興台新99售01  ,0,0,0,0,0,0,0,0,0,-10000,0,0,0,0,10000,-10000,-10000
06992P,玉晶光日盛9B售01,0,0,0,0,0,0,0,0,0,-10000,0,0,0,0,10000,-10000,-10000
6541,泰福-KY         ,54000,64000,-10000,0,0,0,0,0,0,0,0,0,0,0,0,0,-10000
5907,大洋-KY         ,33000,43000,-10000,0,0,0,0,0,0,0,0,0,0,0,0,0,-10000
3622,洋華            ,19000,29000,-10000,0,0,0,0,0,0,0,0,0,0,0,0,0,-10000
2608,嘉里大榮        ,40000,65000,-25000,0,0,0,0,0,0,15000,15000,0,15000,0,0,0,-10000
06473P,鴻海元大99售03  ,0,0,0,0,0,0,0,0,0,-10000,0,0,0,0,10000,-10000,-10000
06424P,大成鋼永豐97售01,0,0,0,0,0,0,0,0,0,-10000,0,0,0,0,10000,-10000,-10000
06579P,臺股指麥證98售03,0,0,0,0,10000,-10000,0,0,0,-10000,0,0,0,0,10000,-10000,-10000
06592P,欣興元大98售04  ,0,0,0,0,0,0,0,0,0,-10000,0,0,0,0,10000,-10000,-10000
06076P,大立光凱基98售03,0,0,0,0,0,0,0,0,0,-10000,0,0,0,0,10000,-10000,-10000
06107P,美律群益98售02  ,0,0,0,0,0,0,0,0,0,-10000,0,0,0,0,10000,-10000,-10000
06087P,國巨永豐97售01  ,0,0,0,0,0,0,0,0,0,-10000,0,0,0,0,10000,-10000,-10000
06162P,大立光群益97售02,0,0,0,0,0,0,0,0,0,-10000,0,0,0,0,10000,-10000,-10000
06282P,聯鈞永豐97售02  ,0,0,0,0,0,0,0,0,0,-10000,0,0,0,0,10000,-10000,-10000
06888P,日月光元大98售02,0,0,0,0,0,0,0,0,0,-10000,0,0,0,6000,16000,-10000,-10000
06902P,聯電凱基98售02  ,0,0,0,0,0,0,0,0,0,-10000,0,0,0,0,10000,-10000,-10000
06948P,FBVIX元大01售02 ,0,0,0,0,0,0,0,0,0,-10000,0,0,0,0,10000,-10000,-10000
06773P,台灣50兆豐9A售01,0,0,0,0,0,0,0,0,0,-10000,0,0,0,0,10000,-10000,-10000
060054,華新科凱基9B購04,0,0,0,0,0,0,0,0,0,-10000,0,0,0,5000,15000,-10000,-10000
060063,可成兆豐9B購01  ,0,0,0,0,0,0,0,0,0,-10000,0,0,0,5000,15000,-10000,-10000
060003,上証2X群益9B購02,0,0,0,0,0,0,0,0,0,-10000,0,0,0,0,10000,-10000,-10000
059998,華航元富99購02  ,0,0,0,0,0,0,0,0,0,-10000,0,0,0,10000,20000,-10000,-10000
059986,宏達電元大99購08,0,0,0,0,0,0,0,0,0,-10000,0,0,0,38000,48000,-10000,-10000
060045,嘉晶群益99購02  ,0,0,0,0,0,0,0,0,0,-10000,0,0,0,0,10000,-10000,-10000
060048,元金2X凱基99購03,0,0,0,0,0,0,0,0,0,-10000,0,0,0,0,10000,-10000,-10000
060215,柏文康和9A購01  ,0,0,0,0,0,0,0,0,0,-10000,0,0,0,0,10000,-10000,-10000
060154,堤維西永豐9A購01,0,0,0,0,0,0,0,0,0,-10000,0,0,0,0,10000,-10000,-10000
060345,聯發科統一9B購05,0,0,0,0,0,0,0,0,0,-10000,0,0,0,0,10000,-10000,-10000
060346,華新科統一01購01,0,0,0,0,0,0,0,0,0,-10000,0,0,0,0,10000,-10000,-10000
060356,上銀元富9A購01  ,0,0,0,0,0,0,0,0,0,-10000,0,0,0,0,10000,-10000,-10000
059908,元金2X元大99購01,0,0,0,0,0,0,0,0,0,-10000,0,0,0,0,10000,-10000,-10000
059832,超眾康和99購01  ,0,0,0,0,0,0,0,0,0,-10000,0,0,0,0,10000,-10000,-10000
05983P,聯詠國票96售02  ,0,0,0,0,0,0,0,0,0,-10000,0,0,0,0,10000,-10000,-10000
059860,台積電群益9A購02,0,0,0,0,0,0,0,0,0,-10000,0,0,0,12000,22000,-10000,-10000
059726,華新科元大99購18,0,0,0,0,0,0,0,0,0,-10000,0,0,0,15000,25000,-10000,-10000
059787,奇力新元大9A購02,0,0,0,0,0,0,0,0,0,-10000,0,0,0,57000,67000,-10000,-10000
059735,T50反1元富99購06,0,0,0,0,0,0,0,0,0,-10000,0,0,0,0,10000,-10000,-10000
059339,上銀凱基99購06  ,0,0,0,0,0,0,0,0,0,-10000,0,0,0,39000,49000,-10000,-10000
059324,智易元大99購04  ,0,0,0,0,0,0,0,0,0,-10000,0,0,0,157000,167000,-10000,-10000
059400,滬深2X元富9C購04,0,0,0,0,0,0,0,0,0,-10000,0,0,0,0,10000,-10000,-10000
059449,滬深2X永豐99購03,0,0,0,0,0,0,0,0,0,-10000,0,0,0,0,10000,-10000,-10000
059617,A50正2群益01購02,0,0,0,0,0,0,0,0,0,-10000,0,0,0,0,10000,-10000,-10000
059544,創意亞東99購01  ,0,0,0,0,0,0,0,0,0,-10000,0,0,0,0,10000,-10000,-10000
059558,T50正2凱基9C購03,0,0,0,0,0,0,0,0,0,-10000,0,0,0,24000,34000,-10000,-10000
052791,友達兆豐97購01  ,0,0,0,0,0,0,0,0,0,-10000,0,0,0,0,10000,-10000,-10000
054050,創意元大96購06  ,0,0,0,0,0,0,0,0,0,-10000,0,0,0,0,10000,-10000,-10000
05418P,瑞昱永豐95售02  ,0,0,0,0,0,0,0,0,0,-10000,0,0,0,0,10000,-10000,-10000
052941,康控兆豐97購01  ,0,0,0,0,0,0,0,0,0,-10000,0,0,0,0,10000,-10000,-10000
04961P,貿聯凱基94售03  ,0,0,0,0,0,0,0,0,0,-10000,0,0,0,0,10000,-10000,-10000
049789,世紀鋼兆豐94購01,0,0,0,0,0,0,0,0,0,-10000,0,0,0,0,10000,-10000,-10000
050107,鴻海元大94購12  ,0,0,0,0,0,0,0,0,0,-10000,0,0,0,0,10000,-10000,-10000
050121,南電元大95購02  ,0,0,0,0,0,0,0,0,0,-10000,0,0,0,33000,43000,-10000,-10000
05058P,燿華國票97售01  ,0,0,0,0,0,0,0,0,0,-10000,0,0,0,0,10000,-10000,-10000
05046P,台光電永豐95售02,0,0,0,0,0,0,0,0,0,-10000,0,0,0,0,10000,-10000,-10000
048158,大立光兆豐95購01,0,0,0,0,0,0,0,0,0,-10000,0,0,0,0,10000,-10000,-10000
04948P,瑞儀元大94售03  ,0,0,0,0,0,0,0,0,0,-10000,0,0,0,0,10000,-10000,-10000
049478,祥碩永豐94購02  ,0,0,0,0,0,0,0,0,0,-10000,0,0,0,0,10000,-10000,-10000
049447,聯電統一94購01  ,0,0,0,0,0,0,0,0,0,-10000,0,0,0,0,10000,-10000,-10000
049352,泰鼎永豐95購01  ,0,0,0,0,0,0,0,0,0,-10000,0,0,0,0,10000,-10000,-10000
051003,中環中信97購01  ,0,0,0,0,0,0,0,0,0,-10000,0,0,0,0,10000,-10000,-10000
050948,華固群益95購01  ,0,0,0,0,0,0,0,0,0,-10000,0,0,0,0,10000,-10000,-10000
050832,力成凱基95購01  ,0,0,0,0,0,0,0,0,0,-10000,0,0,0,0,10000,-10000,-10000
050808,台達電凱基96購02,0,0,0,0,0,0,0,0,0,-10000,0,0,0,0,10000,-10000,-10000
051249,潤泰全元大95購01,0,0,0,0,0,0,0,0,0,-10000,0,0,0,0,10000,-10000,-10000
051189,鴻海兆豐96購01  ,0,0,0,0,0,0,0,0,0,-10000,0,0,0,0,10000,-10000,-10000
051341,訊連永豐95購02  ,0,0,0,0,0,0,0,0,0,-10000,0,0,0,0,10000,-10000,-10000
05133P,臺股指日盛95售01,0,0,0,0,0,0,0,0,0,-10000,0,0,0,10000,20000,-10000,-10000
051392,玉山金兆豐95購01,0,0,0,0,0,0,0,0,0,-10000,0,0,0,0,10000,-10000,-10000
051393,新光金兆豐96購01,0,0,0,0,0,0,0,0,0,-10000,0,0,0,0,10000,-10000,-10000
051321,建準國票96購01  ,0,0,0,0,0,0,0,0,0,-10000,0,0,0,0,10000,-10000,-10000
03686P,大立光統一98售02,0,0,0,0,0,0,0,0,0,-10000,0,0,0,0,10000,-10000,-10000
04400P,台積電兆豐95售02,0,0,0,0,0,0,0,0,0,-10000,0,0,0,0,10000,-10000,-10000
04327P,台積電國泰95售01,0,0,0,0,0,0,0,0,0,-10000,0,0,0,0,10000,-10000,-10000
04189P,台積電兆豐94售02,0,0,0,0,0,0,0,0,0,-10000,0,0,0,0,10000,-10000,-10000
047733,友達兆豐95購01  ,0,0,0,0,0,0,0,0,0,-10000,0,0,0,0,10000,-10000,-10000
045572,元油2X元大98購01,0,0,0,0,0,0,0,0,0,-10000,0,0,0,0,10000,-10000,-10000
03035X,元展32          ,0,0,0,0,0,0,0,0,0,-10000,0,0,0,0,10000,-10000,-10000
04727P,臺股指凱基96售03,0,0,0,0,0,0,0,0,0,-10000,0,0,0,0,10000,-10000,-10000
047417,台塑富邦97購01  ,0,0,0,0,0,0,0,0,0,-10000,0,0,0,0,10000,-10000,-10000
058372,欣興凱基99購03  ,0,0,0,0,0,0,0,0,0,-10000,0,0,0,1000,11000,-10000,-10000
058327,大毅統一9B購01  ,0,0,0,0,0,0,0,0,0,-10000,0,0,0,0,10000,-10000,-10000
057858,T50正2康和98購01,0,0,0,0,0,0,0,0,0,-10000,0,0,0,0,10000,-10000,-10000
058319,大毅永豐9A購01  ,0,0,0,0,0,0,0,0,0,-10000,0,0,0,0,10000,-10000,-10000
058165,FBVIX凱基9C購01 ,0,0,0,0,0,0,0,0,0,-10000,0,0,0,0,10000,-10000,-10000
053497,新光金兆豐97購01,0,0,0,0,0,0,0,0,0,-10000,0,0,0,0,10000,-10000,-10000
05803P,臺股指兆豐96售03,0,0,0,0,0,0,0,0,0,-10000,0,0,0,0,10000,-10000,-10000
058032,大立光永豐98購05,0,0,0,0,0,0,0,0,0,-10000,0,0,0,0,10000,-10000,-10000
053408,友達兆豐98購01  ,0,0,0,0,0,0,0,0,0,-10000,0,0,0,0,10000,-10000,-10000
053432,世紀鋼永豐96購02,0,0,0,0,0,0,0,0,0,-10000,0,0,0,0,10000,-10000,-10000
053285,臺股指元大96購08,0,0,0,0,0,0,0,0,0,-10000,0,0,0,0,10000,-10000,-10000
053351,A50正2兆豐97購01,0,0,0,0,0,0,0,0,0,-10000,0,0,0,0,10000,-10000,-10000
053736,友達麥證96購01  ,0,0,0,0,10000,-10000,0,0,0,-10000,0,0,0,0,10000,-10000,-10000
054396,日電貿永豐96購02,0,0,0,0,0,0,0,0,0,-10000,0,0,0,0,10000,-10000,-10000
052624,微星亞東97購01  ,0,0,0,0,0,0,0,0,0,-10000,0,0,0,0,10000,-10000,-10000
052465,聯詠統一95購02  ,0,0,0,0,0,0,0,0,0,-10000,0,0,0,0,10000,-10000,-10000
053105,鴻海兆豐97購01  ,0,0,0,0,0,0,0,0,0,-10000,0,0,0,0,10000,-10000,-10000
05424P,台達電亞東96售02,0,0,0,0,0,0,0,0,0,-10000,0,0,0,0,10000,-10000,-10000
05149P,緯穎國泰96售01  ,0,0,0,0,0,0,0,0,0,-10000,0,0,0,0,10000,-10000,-10000
057430,富邦金兆豐98購01,0,0,0,0,0,0,0,0,0,-10000,0,0,0,0,10000,-10000,-10000
057816,欣興元大98購13  ,0,0,0,0,0,0,0,0,0,-10000,0,0,0,0,10000,-10000,-10000
057794,T50反1兆豐99購02,0,0,0,0,0,0,0,0,0,-10000,0,0,0,0,10000,-10000,-10000
057796,鴻海兆豐99購03  ,0,0,0,0,0,0,0,0,0,-10000,0,0,0,0,10000,-10000,-10000
055335,健策兆豐98購01  ,0,0,0,0,0,0,0,0,0,-10000,0,0,0,0,10000,-10000,-10000
055337,超眾兆豐98購01  ,0,0,0,0,0,0,0,0,0,-10000,0,0,0,0,10000,-10000,-10000
055479,GIS凱基97購04   ,0,0,0,0,0,0,0,0,0,-10000,0,0,0,0,10000,-10000,-10000
055507,樺漢元大98購02  ,0,0,0,0,0,0,0,0,0,-10000,0,0,0,0,10000,-10000,-10000
05649P,矽創國票97售03  ,0,0,0,0,0,0,0,0,0,-10000,0,0,0,0,10000,-10000,-10000
058599,T50反1元大99購05,0,0,0,0,0,0,0,0,0,-10000,0,0,0,0,10000,-10000,-10000
058633,台灣50兆豐99購01,0,0,0,0,0,0,0,0,0,-10000,0,0,0,0,10000,-10000,-10000
055194,昇陽半元富97購01,0,0,0,0,0,0,0,0,0,-10000,0,0,0,0,10000,-10000,-10000
055195,昇陽半元富97購02,0,0,0,0,0,0,0,0,0,-10000,0,0,0,0,10000,-10000,-10000
055145,T50反1元大97購04,0,0,0,0,0,0,0,0,0,-10000,0,0,0,0,10000,-10000,-10000
054722,傳奇永豐97購01  ,0,0,0,0,0,0,0,0,0,-10000,0,0,0,0,10000,-10000,-10000
054843,中環兆豐97購01  ,0,0,0,0,0,0,0,0,0,-10000,0,0,0,0,10000,-10000,-10000
054861,智邦群益97購01  ,0,0,0,0,0,0,0,0,0,-10000,0,0,0,10000,20000,-10000,-10000
054950,奇力新元大98購02,0,0,0,0,0,0,0,0,0,-10000,0,0,0,10000,20000,-10000,-10000
055907,台虹兆豐98購01  ,0,0,0,0,0,0,0,0,0,-10000,0,0,0,0,10000,-10000,-10000
056564,亞光群益98購02  ,0,0,0,0,0,0,0,0,0,-10000,0,0,0,15000,25000,-10000,-10000
056535,全新凱基99購02  ,0,0,0,0,0,0,0,0,0,-10000,0,0,0,32000,42000,-10000,-10000
056106,晶相光永豐97購02,0,0,0,0,0,0,0,0,0,-10000,0,0,0,5000,15000,-10000,-10000
059090,台新金元大99購01,0,0,0,0,0,0,0,0,0,-10000,0,0,0,0,10000,-10000,-10000
05905P,晶技統一97售01  ,0,0,0,0,0,0,0,0,0,-10000,0,0,0,0,10000,-10000,-10000
058961,台灣50兆豐9C購01,0,0,0,0,0,0,0,0,0,-10000,0,0,0,0,10000,-10000,-10000
059147,矽創國票99購01  ,0,0,0,0,0,0,0,0,0,-10000,0,0,0,10000,20000,-10000,-10000
059162,國巨凱基99購12  ,0,0,0,0,0,0,0,0,0,-10000,0,0,0,88000,98000,-10000,-10000
059227,臺股指元大99購20,0,0,0,0,0,0,0,0,0,-10000,0,0,0,0,10000,-10000,-10000
05921P,同欣電元大96售06,0,0,0,0,0,0,0,0,0,-10000,0,0,0,0,10000,-10000,-10000
05925P,晶技永豐96售03  ,0,0,0,0,0,0,0,0,0,-10000,0,0,0,0,10000,-10000,-10000
054621,華新科兆豐98購01,0,0,0,0,0,0,0,0,0,-10000,0,0,0,0,10000,-10000,-10000
054622,漢唐第一97購01  ,0,0,0,0,0,0,0,0,0,-10000,0,0,0,0,10000,-10000,-10000
058768,南港兆豐99購01  ,0,0,0,0,0,0,0,0,0,-10000,0,0,0,0,10000,-10000,-10000
058854,樺漢群益9B購01  ,0,0,0,0,0,0,0,0,0,-10000,0,0,0,0,10000,-10000,-10000
056752,國巨兆豐98購02  ,0,0,0,0,0,0,0,0,0,-10000,0,0,0,0,10000,-10000,-10000
055663,崇越中信97購01  ,0,0,0,0,0,0,0,0,0,-10000,0,0,0,10000,20000,-10000,-10000
055858,聯茂元大97購03  ,0,0,0,0,0,0,0,0,0,-10000,0,0,0,52000,62000,-10000,-10000
05666P,聯發科凱基96售14,0,0,0,0,0,0,0,0,0,-10000,0,0,0,0,10000,-10000,-10000
056586,光罩統一98購02  ,0,0,0,0,0,0,0,0,0,-10000,0,0,0,0,10000,-10000,-10000
057142,力成兆豐98購01  ,0,0,0,0,0,0,0,0,0,-10000,0,0,0,0,10000,-10000,-10000
057139,華新科兆豐98購02,0,0,0,0,0,0,0,0,0,-10000,0,0,0,0,10000,-10000,-10000
057045,美律元大99購04  ,0,0,0,0,0,0,0,0,0,-10000,0,0,0,27000,37000,-10000,-10000
057563,旭富國泰9A購01  ,0,0,0,0,0,0,0,0,0,-10000,0,0,0,0,10000,-10000,-10000
057573,京鼎永豐98購02  ,0,0,0,0,0,0,0,0,0,-10000,0,0,0,0,10000,-10000,-10000
057574,中磊永豐98購01  ,0,0,0,0,0,0,0,0,0,-10000,0,0,0,0,10000,-10000,-10000
056988,聚陽兆豐98購01  ,0,0,0,0,0,0,0,0,0,-10000,0,0,0,0,10000,-10000,-10000
057254,友達麥證98購01  ,0,0,0,0,10000,-10000,0,0,0,-10000,0,0,0,0,10000,-10000,-10000
057284,新日興元大98購03,0,0,0,0,0,0,0,0,0,-10000,0,0,0,0,10000,-10000,-10000
057262,友達兆豐98購03  ,0,0,0,0,0,0,0,0,0,-10000,0,0,0,0,10000,-10000,-10000
057263,可成兆豐99購01  ,0,0,0,0,0,0,0,0,0,-10000,0,0,0,0,10000,-10000,-10000
056917,國巨兆豐98購03  ,0,0,0,0,0,0,0,0,0,-10000,0,0,0,0,10000,-10000,-10000
056850,彩晶元富99購01  ,0,0,0,0,0,0,0,0,0,-10000,0,0,0,0,10000,-10000,-10000
057304,為升兆豐99購02  ,0,0,0,0,0,0,0,0,0,-10000,0,0,0,0,10000,-10000,-10000
057305,南亞科兆豐98購02,0,0,0,0,0,0,0,0,0,-10000,0,0,0,0,10000,-10000,-10000
057312,美律麥證98購01  ,0,0,0,25000,35000,-10000,0,0,0,-10000,0,0,0,25000,35000,-10000,-10000
057677,臺股指元大98購07,0,0,0,0,0,0,0,0,0,-10000,0,0,0,0,10000,-10000,-10000
058463,宏達電兆豐99購02,0,0,0,0,0,0,0,0,0,-10000,0,0,0,0,10000,-10000,-10000
057657,國巨兆豐98購04  ,0,0,0,0,0,0,0,0,0,-10000,0,0,0,0,10000,-10000,-10000
058513,宏達電元大99購05,0,0,0,0,0,0,0,0,0,-10000,0,0,0,3000,13000,-10000,-10000
05848P,臺股指元大96售24,0,0,0,0,0,0,0,0,0,-10000,0,0,0,0,10000,-10000,-10000
058415,祥碩兆豐99購01  ,0,0,0,0,0,0,0,0,0,-10000,0,0,0,0,10000,-10000,-10000
912000,晨訊科-DR       ,0,10000,-10000,0,0,0,0,0,0,0,0,0,0,0,0,0,-10000
059334,A50正2國票9A購02,0,7000,-7000,0,0,0,0,0,0,-4000,0,0,0,19000,23000,-4000,-11000
059751,華通群益9B購03  ,0,0,0,0,0,0,0,0,0,-11000,0,0,0,52000,63000,-11000,-11000
059788,華新科元大9A購05,0,0,0,0,0,0,0,0,0,-11000,0,0,0,22000,33000,-11000,-11000
059677,大立光台新99購01,0,0,0,0,0,0,0,0,0,-11000,0,0,0,0,11000,-11000,-11000
059648,台表科凱基99購03,0,0,0,0,0,0,0,0,0,-11000,0,0,0,39000,50000,-11000,-11000
05995P,T50正2中信9C售01,0,0,0,0,0,0,0,0,0,-11000,0,0,0,0,11000,-11000,-11000
060347,大立光統一02購01,0,0,0,0,0,0,0,0,0,-11000,0,0,0,0,11000,-11000,-11000
060282,聚陽元大9A購01  ,0,0,0,0,0,0,0,0,0,-11000,0,0,0,0,11000,-11000,-11000
060172,智原台新9A購01  ,0,0,0,0,0,0,0,0,0,-11000,0,0,0,0,11000,-11000,-11000
060229,楠梓電元大9C購01,0,0,0,0,0,0,0,0,0,-11000,0,0,0,0,11000,-11000,-11000
060062,聯發科兆豐99購04,0,0,0,0,0,0,0,0,0,-11000,0,0,0,0,11000,-11000,-11000
06192P,高股息中信98售01,0,0,0,0,0,0,0,0,0,-11000,0,0,0,0,11000,-11000,-11000
06624P,訊芯元大98售06  ,0,0,0,0,0,0,0,0,0,-11000,0,0,0,0,11000,-11000,-11000
06421P,嘉澤統一97售02  ,0,0,0,0,0,0,0,0,0,-11000,0,0,0,0,11000,-11000,-11000
06466P,台積電統一9B售01,0,0,0,0,0,0,0,0,0,-11000,0,0,0,0,11000,-11000,-11000
3321,同泰            ,0,11000,-11000,0,0,0,0,0,0,0,0,0,0,0,0,0,-11000
07238P,台灣50國票99售07,0,0,0,0,0,0,0,0,0,-11000,0,0,0,5000,16000,-11000,-11000
07313P,台灣50元大99售11,0,0,0,0,0,0,0,0,0,-11000,0,0,0,0,11000,-11000,-11000
07302P,臺股指元大9A售35,0,0,0,0,0,0,0,0,0,-11000,0,0,0,15000,26000,-11000,-11000
08679P,台灣50元大01售15,0,0,0,0,0,0,0,0,0,-11000,0,0,0,0,11000,-11000,-11000
1110,東泥            ,0,11000,-11000,0,0,0,0,0,0,0,0,0,0,0,0,0,-11000
1416,廣豐            ,1000,12000,-11000,0,0,0,0,0,0,0,0,0,0,0,0,0,-11000
05394P,聯詠中信95售02  ,0,0,0,0,0,0,0,0,0,-11000,0,0,0,27000,38000,-11000,-11000
03434B,臺股指元大99熊10,0,0,0,0,0,0,0,0,0,-11000,0,0,0,2000,13000,-11000,-11000
051399,玉晶光台新96購01,0,0,0,0,0,0,0,0,0,-11000,0,0,0,0,11000,-11000,-11000
04974P,聯發科凱基96售02,0,0,0,0,0,0,0,0,0,-11000,0,0,0,0,11000,-11000,-11000
054470,緯穎國票97購04  ,0,0,0,0,0,0,0,0,0,-11000,0,0,0,0,11000,-11000,-11000
059068,台虹國票9A購01  ,0,0,0,0,0,0,0,0,0,-11000,0,0,0,0,11000,-11000,-11000
058694,鈺齊國票9A購02  ,0,0,0,0,0,0,0,0,0,-11000,0,0,0,0,11000,-11000,-11000
057436,義隆國票99購02  ,0,0,0,0,0,0,0,0,0,-11000,0,0,0,6000,17000,-11000,-11000
8101,華冠            ,0,11000,-11000,0,0,0,0,0,0,0,0,0,0,0,0,0,-11000
1435,中福            ,2000,14000,-12000,0,0,0,0,0,0,0,0,0,0,0,0,0,-12000
1514,亞力            ,116000,128000,-12000,0,0,0,0,0,0,0,0,0,0,0,0,0,-12000
08163P,T50正2中信95售01,0,0,0,0,0,0,0,0,0,-12000,0,0,0,0,12000,-12000,-12000
1558,伸興            ,9000,21000,-12000,0,0,0,0,0,0,0,0,0,0,0,0,0,-12000
2431,聯昌            ,16000,30000,-14000,0,0,0,0,0,0,2000,2000,0,2000,0,0,0,-12000
060052,宏碁凱基99購01  ,0,0,0,0,0,0,0,0,0,-12000,0,0,0,417000,429000,-12000,-12000
060226,道瓊反元大9A購01,0,0,0,0,0,0,0,0,0,-12000,0,0,0,202000,214000,-12000,-12000
060213,牧德康和9A購01  ,0,0,0,0,0,0,0,0,0,-12000,0,0,0,211000,223000,-12000,-12000
059944,欣興永豐99購03  ,0,0,0,0,0,0,0,0,0,-12000,0,0,0,32000,44000,-12000,-12000
059753,貿聯群益99購06  ,0,0,0,0,0,0,0,0,0,-12000,0,0,0,0,12000,-12000,-12000
049564,聯電統一94購03  ,0,0,0,0,0,0,0,0,0,-12000,0,0,0,0,12000,-12000,-12000
050866,景碩永豐95購01  ,0,0,0,0,0,0,0,0,0,-12000,0,0,0,0,12000,-12000,-12000
047214,啟碁富邦97購01  ,0,0,0,0,0,0,0,0,0,-12000,0,0,0,0,12000,-12000,-12000
046390,旺宏統一94購02  ,0,0,0,0,0,0,0,0,0,-12000,0,0,0,68000,80000,-12000,-12000
054258,牧德元大97購01  ,0,0,0,0,0,0,0,0,0,-12000,0,0,0,11000,23000,-12000,-12000
053041,可成凱基96購02  ,0,0,0,0,0,0,0,0,0,-12000,0,0,0,0,12000,-12000,-12000
055469,台光電凱基97購01,0,0,0,0,0,0,0,0,0,-12000,0,0,0,38000,50000,-12000,-12000
058632,世紀鋼國票9A購01,0,0,0,0,0,0,0,0,0,-12000,0,0,0,0,12000,-12000,-12000
055344,國巨凱基97購04  ,0,0,0,0,0,0,0,0,0,-12000,0,0,0,10000,22000,-12000,-12000
058081,技嘉群益9A購03  ,0,0,0,0,0,0,0,0,0,-12000,0,0,0,0,12000,-12000,-12000
058239,景碩元大99購03  ,0,0,0,0,0,0,0,0,0,-12000,0,0,0,14000,26000,-12000,-12000
057773,技嘉群益9A購02  ,0,0,0,0,0,0,0,0,0,-12000,0,0,0,0,12000,-12000,-12000
056365,欣興元大98購01  ,0,0,0,0,0,0,0,0,0,-12000,0,0,0,30000,42000,-12000,-12000
055075,南電永豐97購01  ,0,0,0,0,0,0,0,0,0,-12000,0,0,0,0,12000,-12000,-12000
054718,可成永豐97購01  ,0,0,0,0,0,0,0,0,0,-12000,0,0,0,51000,63000,-12000,-12000
05675P,美律群益97售01  ,0,0,0,0,0,0,0,0,0,-12000,0,0,0,0,12000,-12000,-12000
058876,南電國票9A購02  ,0,0,0,0,0,0,0,0,0,-12000,0,0,0,7000,19000,-12000,-12000
058796,可成元大99購04  ,0,0,0,0,0,0,0,0,0,-12000,0,0,0,25000,37000,-12000,-12000
058479,亞光凱基9A購01  ,0,0,0,0,0,0,0,0,0,-12000,0,0,0,0,12000,-12000,-12000
05719P,可成元大96售03  ,0,0,0,0,0,0,0,0,0,-12000,0,0,0,0,12000,-12000,-12000
059666,台表科元大9B購01,0,0,0,0,0,0,0,0,0,-13000,0,0,0,24000,37000,-13000,-13000
060025,台積電富邦9C購06,0,120000,-120000,0,0,0,0,0,0,107000,0,0,0,172000,65000,107000,-13000
060066,欣興兆豐9B購01  ,0,0,0,0,0,0,0,0,0,-13000,0,0,0,17000,30000,-13000,-13000
06765P,欣興元大98售11  ,0,0,0,0,0,0,0,0,0,-13000,0,0,0,0,13000,-13000,-13000
2476,鉅祥            ,9000,22000,-13000,0,0,0,0,0,0,0,0,0,0,0,0,0,-13000
2545,皇翔            ,51000,64000,-13000,0,0,0,0,0,0,0,0,0,0,0,0,0,-13000
3027,盛達            ,1000,14000,-13000,0,0,0,0,0,0,0,0,0,0,0,0,0,-13000
4545,銘鈺            ,1000,14000,-13000,0,0,0,0,0,0,0,0,0,0,0,0,0,-13000
5283,禾聯碩          ,11000,20000,-9000,0,0,0,0,0,0,-4000,0,0,0,0,4000,-4000,-13000
1419,新紡            ,1000,14000,-13000,0,0,0,0,0,0,0,0,0,0,0,0,0,-13000
07294P,滬深2X元富9C售08,0,0,0,0,0,0,0,0,0,-13000,0,0,0,106000,119000,-13000,-13000
07337P,台灣50凱基99售09,0,0,0,0,0,0,0,0,0,-13000,0,0,0,0,13000,-13000,-13000
07401P,台積電凱基99售21,0,0,0,0,0,0,0,0,0,-13000,0,0,0,23000,36000,-13000,-13000
053643,漢唐國票97購02  ,0,0,0,0,0,0,0,0,0,-13000,0,0,0,44000,57000,-13000,-13000
05171P,臺股指元大95售15,0,0,0,0,0,0,0,0,0,-13000,0,0,0,0,13000,-13000,-13000
044105,聯詠中信95購01  ,0,0,0,0,0,0,0,0,0,-13000,0,0,0,5000,18000,-13000,-13000
057676,臺股指元大98購06,0,0,0,0,0,0,0,0,0,-13000,0,0,0,0,13000,-13000,-13000
056981,全新群益99購03  ,0,0,0,0,0,0,0,0,0,-13000,0,0,0,25000,38000,-13000,-13000
059172,台郡凱基99購03  ,0,0,0,0,0,0,0,0,0,-13000,0,0,0,1000,14000,-13000,-13000
055172,凱美統一97購02  ,0,0,0,0,0,0,0,0,0,-13000,0,0,0,0,13000,-13000,-13000
056142,超眾元大97購06  ,0,0,0,0,0,0,0,0,0,-13000,0,0,0,20000,33000,-13000,-13000
056051,T50反1元大97購05,0,0,0,0,0,0,0,0,0,-13000,0,0,0,0,13000,-13000,-13000
056549,嘉聯益凱基98購04,0,0,0,0,0,0,0,0,0,-13000,0,0,0,120000,133000,-13000,-13000
07192P,聯發科元大99售23,0,0,0,0,0,0,0,0,0,-14000,0,0,0,0,14000,-14000,-14000
1507,永大            ,2000,16000,-14000,0,0,0,0,0,0,0,0,0,0,0,0,0,-14000
07456P,華新科元大9A售06,0,0,0,0,0,0,0,0,0,-14000,0,0,0,0,14000,-14000,-14000
6136,富爾特          ,17000,31000,-14000,0,0,0,0,0,0,0,0,0,0,0,0,0,-14000
2489,瑞軒            ,419000,434000,-15000,0,0,0,0,0,0,1000,5000,4000,1000,0,0,0,-14000
06718P,聯詠元大98售01  ,0,0,0,0,0,0,0,0,0,-14000,0,0,0,10000,24000,-14000,-14000
060014,中鋼康和99購01  ,0,0,0,0,0,0,0,0,0,-14000,0,0,0,0,14000,-14000,-14000
05990P,台積電群益96售13,0,0,0,0,0,0,0,0,0,-14000,0,0,0,2000,16000,-14000,-14000
059887,華新科國票99購02,0,0,0,0,0,0,0,0,0,-14000,0,0,0,0,14000,-14000,-14000
059390,華新科凱基99購05,0,0,0,0,0,0,0,0,0,-14000,0,0,0,120000,134000,-14000,-14000
059415,台灣50元大9A購03,0,0,0,0,0,0,0,0,0,-14000,0,0,0,5000,19000,-14000,-14000
059641,群創凱基99購06  ,0,0,0,0,0,0,0,0,0,-14000,0,0,0,93000,107000,-14000,-14000
03433B,臺股指元大9C熊01,0,0,0,0,0,0,0,0,0,-14000,0,0,0,38000,52000,-14000,-14000
054135,大立光元大97購04,0,0,0,0,0,0,0,0,0,-14000,0,0,0,22000,36000,-14000,-14000
057998,玉晶光麥證9A購01,0,0,0,0,14000,-14000,0,0,0,-14000,0,0,0,0,14000,-14000,-14000
054875,群電群益97購01  ,0,0,0,0,0,0,0,0,0,-14000,0,0,0,0,14000,-14000,-14000
056777,矽力元大98購02  ,0,0,0,0,0,0,0,0,0,-14000,0,0,0,0,14000,-14000,-14000
057000,亞德客國票99購01,0,0,0,0,0,0,0,0,0,-14000,0,0,0,1000,15000,-14000,-14000
059360,全新永豐99購02  ,0,0,0,0,0,0,0,0,0,-15000,0,0,0,29000,44000,-15000,-15000
059956,玉山金康和99購01,0,0,0,0,0,0,0,0,0,-15000,0,0,0,212000,227000,-15000,-15000
059717,國巨元大99購21  ,0,0,0,0,0,0,0,0,0,-15000,0,0,0,12000,27000,-15000,-15000
059733,緯穎元大99購08  ,0,0,0,0,0,0,0,0,0,-15000,0,0,0,0,15000,-15000,-15000
060069,T50反1元富99購13,0,0,0,0,0,0,0,0,0,-15000,0,0,0,0,15000,-15000,-15000
060134,鈺齊群益9A購01  ,0,0,0,0,0,0,0,0,0,-15000,0,0,0,0,15000,-15000,-15000
060351,滬深2X元富9A購01,0,0,0,0,0,0,0,0,0,-15000,0,0,0,0,15000,-15000,-15000
06697P,台積電國票99售05,0,0,0,0,0,0,0,0,0,-15000,0,0,0,10000,25000,-15000,-15000
06641P,智邦兆豐99售01  ,0,0,0,0,0,0,0,0,0,-15000,0,0,0,0,15000,-15000,-15000
06742P,可成富邦99售02  ,0,0,0,0,0,0,0,0,0,-15000,0,0,0,0,15000,-15000,-15000
06844P,智邦元大98售13  ,0,0,0,0,0,0,0,0,0,-15000,0,0,0,0,15000,-15000,-15000
06160P,台達電群益97售01,0,0,0,0,0,0,0,0,0,-15000,0,0,0,10000,25000,-15000,-15000
2453,凌群            ,87000,102000,-15000,0,0,0,0,0,0,0,0,0,0,0,0,0,-15000
3015,全漢            ,29000,41000,-12000,0,0,0,0,0,0,-3000,0,3000,-3000,0,0,0,-15000
2707,晶華            ,69000,104000,-35000,0,0,0,20000,0,20000,0,0,0,0,0,0,0,-15000
6165,捷泰            ,18000,33000,-15000,0,0,0,0,0,0,0,0,0,0,0,0,0,-15000
1235,興泰            ,0,14000,-14000,0,0,0,0,0,0,-1000,0,1000,-1000,0,0,0,-15000
07022P,嘉晶永豐99售02  ,0,0,0,0,0,0,0,0,0,-15000,0,0,0,0,15000,-15000,-15000
07412P,國巨元大99售32  ,0,0,0,0,0,0,0,0,0,-15000,0,0,0,0,15000,-15000,-15000
07350P,台灣50國票99售11,0,0,0,0,0,0,0,0,0,-15000,0,0,0,0,15000,-15000,-15000
057900,南亞科永豐98購01,0,0,0,0,0,0,0,0,0,-15000,0,0,0,52000,67000,-15000,-15000
053337,聯電國票97購01  ,0,0,0,0,0,0,0,0,0,-15000,0,0,0,73000,88000,-15000,-15000
053660,群創凱基98購08  ,0,0,0,0,0,0,0,0,0,-15000,0,0,0,0,15000,-15000,-15000
052247,深中小永豐95購01,0,0,0,0,0,0,0,0,0,-15000,0,0,0,0,15000,-15000,-15000
053206,聯發科麥證96購02,0,0,0,0,15000,-15000,0,0,0,-15000,0,0,0,0,15000,-15000,-15000
052685,技嘉元大96購01  ,0,0,0,0,0,0,0,0,0,-15000,0,0,0,10000,25000,-15000,-15000
050481,泰鼎國票96購01  ,0,0,0,0,0,0,0,0,0,-15000,0,0,0,3000,18000,-15000,-15000
050870,旭富永豐95購01  ,0,0,0,0,0,0,0,0,0,-15000,0,0,0,30000,45000,-15000,-15000
056978,技嘉群益99購01  ,0,0,0,0,0,0,0,0,0,-15000,0,0,0,0,15000,-15000,-15000
05576P,群創日盛99售02  ,0,0,0,0,0,0,0,0,0,-15000,0,0,0,200000,215000,-15000,-15000
055813,聯發科國票98購04,0,0,0,0,0,0,0,0,0,-15000,0,0,0,0,15000,-15000,-15000
056731,國巨凱基98購04  ,0,0,0,0,0,0,0,0,0,-15000,0,0,0,0,15000,-15000,-15000
058772,茂林兆豐9A購01  ,0,0,0,0,0,0,0,0,0,-15000,0,0,0,31000,46000,-15000,-15000
059180,祥碩元富9A購01  ,0,0,0,0,0,0,0,0,0,-15000,0,0,0,180000,195000,-15000,-15000
059059,宏達電凱基99購03,0,0,0,0,0,0,0,0,0,-15000,0,0,0,76000,91000,-15000,-15000
05912P,和大元大96售01  ,0,0,0,0,0,0,0,0,0,-15000,0,0,0,0,15000,-15000,-15000
059011,臺股指元大9A購30,0,0,0,0,0,0,0,0,0,-15000,0,0,0,16000,31000,-15000,-15000
054860,台積電群益98購01,0,0,0,0,0,0,0,0,0,-15000,0,0,0,0,15000,-15000,-15000
055304,瑞昱第一98購01  ,0,0,0,0,0,0,0,0,0,-15000,0,0,0,0,15000,-15000,-15000
055620,樺漢國票98購01  ,0,0,0,0,0,0,0,0,0,-15000,0,0,0,0,15000,-15000,-15000
055612,台光電國票97購04,0,0,0,0,0,0,0,0,0,-15000,0,0,0,45000,60000,-15000,-15000
056295,國巨元大97購16  ,0,0,0,0,0,0,0,0,0,-15000,0,0,0,11000,26000,-15000,-15000
058702,國巨元大99購16  ,0,0,0,0,0,0,0,0,0,-15000,0,0,0,0,15000,-15000,-15000
057466,泰鼎永豐98購01  ,0,0,0,0,0,0,0,0,0,-15000,0,0,0,20000,35000,-15000,-15000
07405P,大立光凱基99售17,0,0,0,0,0,0,0,0,0,-16000,0,0,0,0,16000,-16000,-16000
07394P,國巨群益99售12  ,0,0,0,0,0,0,0,0,0,-16000,0,0,0,0,16000,-16000,-16000
07311P,台灣50元大99售09,0,0,0,0,0,0,0,0,0,-16000,0,0,0,32000,48000,-16000,-16000
07084P,S&P正2元富9B售02,0,0,0,0,0,0,0,0,0,-16000,0,0,0,1000,17000,-16000,-16000
1313,聯成            ,335000,350000,-15000,0,0,0,0,0,0,-1000,0,1000,-1000,0,0,0,-16000
1103,嘉泥            ,473000,488000,-15000,0,0,0,0,0,0,-1000,0,1000,-1000,0,0,0,-16000
4952,凌通            ,28000,44000,-16000,0,0,0,0,0,0,0,0,0,0,0,0,0,-16000
2832,台產            ,19000,35000,-16000,0,0,0,0,0,0,0,0,0,0,0,0,0,-16000
060333,金寶康和9A購01  ,0,0,0,0,0,0,0,0,0,-16000,0,0,0,0,16000,-16000,-16000
060162,碩天永豐9A購01  ,0,0,0,0,0,0,0,0,0,-16000,0,0,0,1000,17000,-16000,-16000
060074,台積電元富99購04,0,0,0,0,0,0,0,0,0,-16000,0,0,0,0,16000,-16000,-16000
060112,祥碩元大99購04  ,0,0,0,0,0,0,0,0,0,-16000,0,0,0,74000,90000,-16000,-16000
059939,技嘉永豐99購01  ,0,0,0,0,0,0,0,0,0,-16000,0,0,0,15000,31000,-16000,-16000
059300,國巨群益99購08  ,0,0,0,0,0,0,0,0,0,-16000,0,0,0,36000,52000,-16000,-16000
00711B,FH彭博新興債    ,0,0,0,0,0,0,0,0,0,-16000,0,0,0,1000,17000,-16000,-16000
00731,FH富時高息低波  ,0,0,0,0,0,0,0,0,0,-16000,0,0,0,421000,437000,-16000,-16000
03026X,元展23          ,0,0,0,0,0,0,0,0,0,-16000,0,0,0,0,16000,-16000,-16000
054123,易華電永豐96購03,0,0,0,0,0,0,0,0,0,-16000,0,0,0,0,16000,-16000,-16000
051902,T50反1元大97購01,0,0,0,0,0,0,0,0,0,-16000,0,0,0,30000,46000,-16000,-16000
053442,光罩凱基96購01  ,0,0,0,0,0,0,0,0,0,-16000,0,0,0,0,16000,-16000,-16000
058061,貿聯元富9B購01  ,0,0,0,0,0,0,0,0,0,-16000,0,0,0,10000,26000,-16000,-16000
058355,旺宏凱基99購04  ,0,0,0,0,0,0,0,0,0,-16000,0,0,0,150000,166000,-16000,-16000
058551,義隆永豐99購03  ,0,0,0,0,0,0,0,0,0,-16000,0,0,0,26000,42000,-16000,-16000
058290,南電國票9A購01  ,0,0,0,0,0,0,0,0,0,-16000,0,0,0,1000,17000,-16000,-16000
055400,緯穎統一97購01  ,0,0,0,0,0,0,0,0,0,-16000,0,0,0,17000,33000,-16000,-16000
058255,臺股指元大9A購19,0,0,0,0,0,0,0,0,0,-16000,0,0,0,1000,17000,-16000,-16000
055563,智易凱基97購02  ,0,0,0,0,0,0,0,0,0,-16000,0,0,0,4000,20000,-16000,-16000
054751,GIS凱基98購01   ,0,0,0,0,0,0,0,0,0,-16000,0,0,0,21000,37000,-16000,-16000
059262,致茂中信01購01  ,0,0,0,0,0,0,0,0,0,-16000,0,0,0,0,16000,-16000,-16000
8249,菱光            ,15000,31000,-16000,0,0,0,0,0,0,0,0,0,0,0,0,0,-16000
6409,旭隼            ,50000,66233,-16233,0,0,0,0,0,0,0,0,0,0,0,0,0,-16233
6213,聯茂            ,1232475,1279000,-46525,0,0,0,1101000,653000,448000,-418000,153000,549000,-396000,52000,74000,-22000,-16525
3025,星通            ,0,17000,-17000,0,0,0,0,0,0,0,0,0,0,0,0,0,-17000
2923,鼎固-KY         ,0,17000,-17000,0,0,0,0,0,0,0,0,0,0,0,0,0,-17000
3050,鈺德            ,55000,72000,-17000,0,0,0,0,0,0,0,0,0,0,0,0,0,-17000
2414,精技            ,13000,29000,-16000,0,0,0,0,0,0,-1000,0,1000,-1000,0,0,0,-17000
07010P,T50正2凱基9C售01,0,0,0,0,0,0,0,0,0,-17000,0,0,0,0,17000,-17000,-17000
07400P,國巨凱基99售20  ,0,0,0,0,0,0,0,0,0,-17000,0,0,0,11000,28000,-17000,-17000
059623,聯電凱基99購02  ,0,0,0,0,0,0,0,0,0,-17000,0,0,0,74000,91000,-17000,-17000
060118,臺指反富邦9C購01,0,0,0,0,0,0,0,0,0,-17000,0,0,0,3000,20000,-17000,-17000
059987,大立光元大99購28,0,0,0,0,0,0,0,0,0,-17000,0,0,0,6000,23000,-17000,-17000
060016,廣達康和99購01  ,0,0,0,0,0,0,0,0,0,-17000,0,0,0,0,17000,-17000,-17000
060214,茂林康和9A購01  ,0,0,0,0,0,0,0,0,0,-17000,0,0,0,0,17000,-17000,-17000
058182,日電貿國泰9A購01,0,0,0,0,0,0,0,0,0,-17000,0,0,0,59000,76000,-17000,-17000
052490,禾伸堂國票95購01,0,0,0,0,0,0,0,0,0,-17000,0,0,0,0,17000,-17000,-17000
052010,兆豐金中信95購01,0,0,0,0,0,0,0,0,0,-17000,0,0,0,3000,20000,-17000,-17000
054189,貿聯永豐96購03  ,0,0,0,0,0,0,0,0,0,-17000,0,0,0,50000,67000,-17000,-17000
03441B,臺股指凱基9A熊05,0,0,0,0,0,0,0,0,0,-17000,0,0,0,0,17000,-17000,-17000
05920P,力成元大96售04  ,0,0,0,0,0,0,0,0,0,-17000,0,0,0,0,17000,-17000,-17000
056772,欣興元大99購01  ,0,0,0,0,0,0,0,0,0,-17000,0,0,0,1000,18000,-17000,-17000
057131,奇力新凱基98購05,0,0,0,0,0,0,0,0,0,-17000,0,0,0,6000,23000,-17000,-17000
056576,晶技元大99購02  ,0,0,0,0,0,0,0,0,0,-17000,0,0,0,38000,55000,-17000,-17000
060323,華通群益9C購01  ,0,0,0,0,0,0,0,0,0,-18000,0,0,0,37000,55000,-18000,-18000
060368,緯穎元富9A購03  ,0,0,0,0,0,0,0,0,0,-18000,0,0,0,0,18000,-18000,-18000
060095,聯發科元大99購42,0,0,0,0,0,0,0,0,0,-18000,0,0,0,0,18000,-18000,-18000
06753P,智邦富邦98售03  ,0,0,0,0,0,0,0,0,0,-18000,0,0,0,20000,38000,-18000,-18000
059553,台灣50凱基99購05,0,0,0,0,0,0,0,0,0,-18000,0,0,0,12000,30000,-18000,-18000
059489,上証2X國票9A購01,0,0,0,0,0,0,0,0,0,-18000,0,0,0,12000,30000,-18000,-18000
059836,大立光國泰9B購02,0,0,0,0,0,0,0,0,0,-18000,0,0,0,10000,28000,-18000,-18000
2528,皇普            ,2000,19000,-17000,0,0,0,0,0,0,-1000,0,1000,-1000,0,0,0,-18000
2913,農林            ,436000,455000,-19000,0,0,0,0,0,0,1000,1000,0,1000,0,0,0,-18000
03022X,富展01          ,0,0,0,0,0,0,0,0,0,-18000,0,0,0,0,18000,-18000,-18000
00766L,台新MSCI中國正2 ,0,0,0,0,0,0,0,0,0,-18000,0,0,0,87000,105000,-18000,-18000
052738,聯電元大98購02  ,0,0,0,0,0,0,0,0,0,-18000,0,0,0,6000,24000,-18000,-18000
058011,台虹國票99購01  ,0,0,0,0,0,0,0,0,0,-18000,0,0,0,0,18000,-18000,-18000
051766,泰鼎元大95購02  ,0,0,0,0,0,0,0,0,0,-18000,0,0,0,0,18000,-18000,-18000
056119,欣興群益97購02  ,0,0,0,0,0,0,0,0,0,-18000,0,0,0,95000,113000,-18000,-18000
056206,泰鼎永豐97購01  ,0,0,0,0,0,0,0,0,0,-18000,0,0,0,12000,30000,-18000,-18000
057762,全新凱基99購03  ,0,0,0,0,0,0,0,0,0,-18000,0,0,0,0,18000,-18000,-18000
055443,台虹國票98購01  ,0,0,0,0,0,0,0,0,0,-18000,0,0,0,0,18000,-18000,-18000
056961,凱美永豐98購01  ,0,0,0,0,0,0,0,0,0,-18000,0,0,0,2000,20000,-18000,-18000
056668,光磊國票99購01  ,0,0,0,0,0,0,0,0,0,-18000,0,0,0,20000,38000,-18000,-18000
2546,根基            ,48000,67000,-19000,0,0,0,0,0,0,0,0,0,0,0,0,0,-19000
6216,居易            ,6000,26000,-20000,0,0,0,0,0,0,1000,1000,0,1000,0,0,0,-19000
07344P,鴻海富邦9A售03  ,0,0,0,0,0,0,0,0,0,-19000,0,0,0,66000,85000,-19000,-19000
2228,劍麟            ,119000,133000,-14000,0,0,0,0,0,0,-5000,0,5000,-5000,0,0,0,-19000
059292,華新科元富9B購02,0,0,0,0,0,0,0,0,0,-19000,0,0,0,22000,41000,-19000,-19000
059456,智易永豐99購01  ,0,0,0,0,0,0,0,0,0,-19000,0,0,0,7000,26000,-19000,-19000
06656P,GIS元大98售02   ,0,0,0,0,0,0,0,0,0,-19000,0,0,0,34000,53000,-19000,-19000
060146,健策國票9A購03  ,0,0,0,0,0,0,0,0,0,-19000,0,0,0,0,19000,-19000,-19000
060185,聯發科元富04購01,0,0,0,0,0,0,0,0,0,-19000,0,0,0,0,19000,-19000,-19000
05205P,緯穎元大95售03  ,0,0,0,0,0,0,0,0,0,-19000,0,0,0,1000,20000,-19000,-19000
051555,聯茂永豐95購01  ,0,0,0,0,0,0,0,0,0,-19000,0,0,0,31000,50000,-19000,-19000
049690,義隆元大95購02  ,0,0,0,0,0,0,0,0,0,-19000,0,0,0,80000,99000,-19000,-19000
00753L,中信中國50正2   ,0,0,0,0,0,0,0,0,0,-19000,0,0,0,189000,208000,-19000,-19000
055780,禾伸堂凱基99購01,0,0,0,0,0,0,0,0,0,-19000,0,0,0,0,19000,-19000,-19000
056877,群創凱基99購04  ,0,0,0,0,0,0,0,0,0,-19000,0,0,0,0,19000,-19000,-19000
05922P,京元電兆豐96售01,0,0,0,0,0,0,0,0,0,-19000,0,0,0,16000,35000,-19000,-19000
056573,華新科元大99購06,0,0,0,0,0,0,0,0,0,-19000,0,0,0,7000,26000,-19000,-19000
055288,日電貿元大97購02,0,0,0,0,0,0,0,0,0,-19000,0,0,0,0,19000,-19000,-19000
9942,茂順            ,9000,23000,-14000,0,0,0,0,0,0,-5000,0,5000,-5000,0,0,0,-19000
060221,大立光凱基9A購07,0,0,0,0,0,0,0,0,0,-20000,0,0,0,3000,23000,-20000,-20000
060254,世紀鋼元大9A購01,0,0,0,0,0,0,0,0,0,-20000,0,0,0,18000,38000,-20000,-20000
060244,大立光元大9B購02,0,0,0,0,0,0,0,0,0,-20000,0,0,0,0,20000,-20000,-20000
060239,國揚元大9C購01  ,0,0,0,0,0,0,0,0,0,-20000,0,0,0,0,20000,-20000,-20000
060027,元金2X永豐99購02,0,0,0,0,0,0,0,0,0,-20000,0,0,0,0,20000,-20000,-20000
06922P,元上證群益9C售01,0,0,0,0,0,0,0,0,0,-20000,0,0,0,60000,80000,-20000,-20000
06991P,矽創群益99售01  ,0,0,0,0,0,0,0,0,0,-20000,0,0,0,0,20000,-20000,-20000
06173P,華通元大97售02  ,0,0,0,0,0,0,0,0,0,-20000,0,0,0,5000,25000,-20000,-20000
06270P,致伸凱基97售03  ,0,0,0,0,0,0,0,0,0,-20000,0,0,0,0,20000,-20000,-20000
06504P,麗豐國票99售02  ,0,0,0,0,0,0,0,0,0,-20000,0,0,0,0,20000,-20000,-20000
059441,祥碩元大99購02  ,0,0,0,0,0,0,0,0,0,-20000,0,0,0,704000,724000,-20000,-20000
059587,華通元大9A購01  ,0,0,0,0,0,0,0,0,0,-20000,0,0,0,72000,92000,-20000,-20000
059812,上証2X凱基9A購04,0,0,0,0,0,0,0,0,0,-20000,0,0,0,0,20000,-20000,-20000
07291P,臺股指凱基99售43,0,0,0,0,0,0,0,0,0,-20000,0,0,0,184000,204000,-20000,-20000
07118P,台積電凱基99售09,0,0,0,0,0,0,0,0,0,-20000,0,0,0,0,20000,-20000,-20000
07140P,台灣50日盛99售01,0,0,0,0,0,0,0,0,0,-20000,0,0,0,0,20000,-20000,-20000
07166P,台灣50兆豐03售01,0,0,0,0,0,0,0,0,0,-20000,0,0,0,0,20000,-20000,-20000
07196P,大立光元大99售13,0,0,0,0,0,0,0,0,0,-20000,0,0,0,7000,27000,-20000,-20000
07235P,T50正2元大9C售02,0,0,0,0,0,0,0,0,0,-20000,0,0,0,2000,22000,-20000,-20000
6525,捷敏-KY         ,27000,147000,-120000,0,0,0,100000,0,100000,0,0,0,0,0,0,0,-20000
2402,毅嘉            ,271000,291000,-20000,0,0,0,0,0,0,0,0,0,0,0,0,0,-20000
047123,中石化中信95購01,0,0,0,0,0,0,0,0,0,-20000,0,0,0,0,20000,-20000,-20000
03064X,元展59          ,0,0,0,0,0,0,0,0,0,-20000,0,0,0,140000,160000,-20000,-20000
050673,旺宏富邦96購02  ,0,0,0,0,0,0,0,0,0,-20000,0,0,0,0,20000,-20000,-20000
051299,致茂凱基95購01  ,0,0,0,0,0,0,0,0,0,-20000,0,0,0,0,20000,-20000,-20000
04977P,力成凱基96售01  ,0,0,0,0,0,0,0,0,0,-20000,0,0,0,0,20000,-20000,-20000
054184,A50正2永豐96購01,0,0,0,0,0,0,0,0,0,-20000,0,0,0,0,20000,-20000,-20000
052875,樺漢凱基96購02  ,0,0,0,0,0,0,0,0,0,-20000,0,0,0,0,20000,-20000,-20000
054309,禾伸堂凱基98購01,0,0,0,0,0,0,0,0,0,-20000,0,0,0,51000,71000,-20000,-20000
054373,富邦金中信97購01,0,0,0,0,0,0,0,0,0,-20000,0,0,0,0,20000,-20000,-20000
054393,漢唐永豐96購01  ,0,0,0,0,0,0,0,0,0,-20000,0,0,0,30000,50000,-20000,-20000
052244,廣達康和95購01  ,0,0,0,0,0,0,0,0,0,-20000,0,0,0,0,20000,-20000,-20000
052192,SP黃豆元富95購04,0,0,0,0,0,0,0,0,0,-20000,0,0,0,0,20000,-20000,-20000
052117,鴻海國票96購03  ,0,0,0,0,0,0,0,0,0,-20000,0,0,0,0,20000,-20000,-20000
052356,聯詠永豐95購03  ,0,0,0,0,0,0,0,0,0,-20000,0,0,0,0,20000,-20000,-20000
054403,同欣電永豐96購02,0,0,0,0,0,0,0,0,0,-20000,0,0,0,0,20000,-20000,-20000
05316P,台積電永昌96售06,0,0,0,0,0,0,0,0,0,-20000,0,0,0,10000,30000,-20000,-20000
053510,聯電群益97購01  ,0,0,0,0,0,0,0,0,0,-20000,0,0,0,0,20000,-20000,-20000
053983,樺漢元大97購02  ,0,0,0,0,0,0,0,0,0,-20000,0,0,0,0,20000,-20000,-20000
053835,南亞科永豐96購02,0,0,0,0,0,0,0,0,0,-20000,0,0,0,0,20000,-20000,-20000
058228,為升元大99購01  ,0,0,0,0,0,0,0,0,0,-20000,0,0,0,0,20000,-20000,-20000
055245,凱美統一99購01  ,0,0,0,0,0,0,0,0,0,-20000,0,0,0,0,20000,-20000,-20000
054838,京鼎第一97購01  ,0,0,0,0,0,0,0,0,0,-20000,0,0,0,0,20000,-20000,-20000
054721,揚明光永豐97購03,0,0,0,0,0,0,0,0,0,-20000,0,0,0,0,20000,-20000,-20000
054887,大毅統一98購01  ,0,0,0,0,0,0,0,0,0,-20000,0,0,0,100000,120000,-20000,-20000
054986,藍天元富97購01  ,0,0,0,0,0,0,0,0,0,-20000,0,0,0,0,20000,-20000,-20000
055898,訊芯第一97購01  ,0,0,0,0,0,0,0,0,0,-20000,0,0,0,0,20000,-20000,-20000
055608,華邦電康和97購01,0,0,0,0,0,0,0,0,0,-20000,0,0,0,0,20000,-20000,-20000
055633,牧德永豐97購02  ,0,0,0,0,0,0,0,0,0,-20000,0,0,0,0,20000,-20000,-20000
056050,晶技國票98購01  ,0,0,0,0,0,0,0,0,0,-20000,0,0,0,0,20000,-20000,-20000
055968,祥碩元大97購04  ,0,0,0,0,0,0,0,0,0,-20000,0,0,0,6000,26000,-20000,-20000
058274,世紀鋼永豐99購01,0,0,0,0,0,0,0,0,0,-20000,0,0,0,0,20000,-20000,-20000
058560,T50反1凱基9A購04,0,0,0,0,0,0,0,0,0,-20000,0,0,0,0,20000,-20000,-20000
057496,佐登元大98購02  ,0,0,0,0,0,0,0,0,0,-20000,0,0,0,0,20000,-20000,-20000
057507,貿聯國票98購02  ,0,0,0,0,0,0,0,0,0,-20000,0,0,0,0,20000,-20000,-20000
057387,奇力新永豐98購03,0,0,0,0,0,0,0,0,0,-20000,0,0,0,0,20000,-20000,-20000
058119,華新亞東99購01  ,0,0,0,0,0,0,0,0,0,-20000,0,0,0,0,20000,-20000,-20000
059165,南亞科凱基99購04,0,0,0,0,0,0,0,0,0,-20000,0,0,0,179000,199000,-20000,-20000
059040,訊芯群益99購03  ,0,0,0,0,0,0,0,0,0,-20000,0,0,0,0,20000,-20000,-20000
059119,華擎永豐99購02  ,0,0,0,0,0,0,0,0,0,-20000,0,0,0,0,20000,-20000,-20000
055667,致茂群益98購01  ,0,0,0,0,0,0,0,0,0,-20000,0,0,0,30000,50000,-20000,-20000
056257,聯茂元富97購04  ,0,0,0,0,0,0,0,0,0,-20000,0,0,0,0,20000,-20000,-20000
9188,精熙-DR         ,0,20000,-20000,0,0,0,0,0,0,0,0,0,0,0,0,0,-20000
3705,永信            ,130000,159000,-29000,0,0,0,0,0,0,8000,8000,0,8000,0,0,0,-21000
07127P,精元元大99售01  ,0,0,0,0,0,0,0,0,0,-21000,0,0,0,0,21000,-21000,-21000
07287P,全新群益9B售01  ,0,0,0,0,0,0,0,0,0,-21000,0,0,0,4000,25000,-21000,-21000
1232,大統益          ,12000,41000,-29000,0,0,0,0,0,0,8000,8000,0,8000,0,0,0,-21000
059590,台積電元大99購39,0,0,0,0,0,0,0,0,0,-21000,0,0,0,18000,39000,-21000,-21000
059579,聯發科元富99購06,0,0,0,0,0,0,0,0,0,-21000,0,0,0,2000,23000,-21000,-21000
059626,台積電凱基01購01,0,0,0,0,0,0,0,0,0,-21000,0,0,0,173000,194000,-21000,-21000
06982P,義隆凱基99售02  ,0,0,0,0,0,0,0,0,0,-21000,0,0,0,29000,50000,-21000,-21000
053352,義隆兆豐96購01  ,0,0,0,0,0,0,0,0,0,-21000,0,0,0,105000,126000,-21000,-21000
053149,京元電元大96購02,0,0,0,0,0,0,0,0,0,-21000,0,0,0,0,21000,-21000,-21000
050478,致新永豐94購02  ,0,0,0,0,0,0,0,0,0,-21000,0,0,0,0,21000,-21000,-21000
03439B,臺股指元大99熊29,0,0,0,0,0,0,0,0,0,-21000,0,0,0,81000,102000,-21000,-21000
056075,瀚宇博元大97購03,0,0,0,0,0,0,0,0,0,-21000,0,0,0,15000,36000,-21000,-21000
055066,佐登永豐97購01  ,0,0,0,0,0,0,0,0,0,-21000,0,0,0,0,21000,-21000,-21000
054889,京鼎統一99購01  ,0,0,0,0,0,0,0,0,0,-21000,0,0,0,0,21000,-21000,-21000
055295,瀚宇博元大97購02,0,0,0,0,0,0,0,0,0,-21000,0,0,0,54000,75000,-21000,-21000
06749P,技嘉元富98售03  ,0,0,0,0,0,0,0,0,0,-22000,0,0,0,12000,34000,-22000,-22000
059984,華新科元大99購21,0,0,0,0,0,0,0,0,0,-22000,0,0,0,9000,31000,-22000,-22000
059571,奇力新凱基99購06,0,0,0,0,0,0,0,0,0,-22000,0,0,0,22000,44000,-22000,-22000
1441,大東            ,17000,39000,-22000,0,0,0,0,0,0,0,0,0,0,0,0,0,-22000
07250P,台灣50永豐99售07,0,0,0,0,0,0,0,0,0,-22000,0,0,0,0,22000,-22000,-22000
4133,亞諾法          ,99000,121000,-22000,0,0,0,0,0,0,0,0,0,0,0,0,0,-22000
2509,全坤建          ,2000,24000,-22000,0,0,0,0,0,0,0,0,0,0,0,0,0,-22000
047990,臺指反元大96購02,0,0,0,0,0,0,0,0,0,-22000,0,0,0,8000,30000,-22000,-22000
00660,元大歐洲50      ,0,0,0,0,0,0,0,0,0,-22000,0,0,0,88000,110000,-22000,-22000
053542,超眾永豐96購01  ,0,0,0,0,0,0,0,0,0,-22000,0,0,0,0,22000,-22000,-22000
051641,矽創國票96購01  ,0,0,0,0,0,0,0,0,0,-22000,0,0,0,355000,377000,-22000,-22000
054886,大毅統一97購01  ,0,0,0,0,0,0,0,0,0,-22000,0,0,0,0,22000,-22000,-22000
056520,鴻海日盛99購01  ,0,0,0,0,0,0,0,0,0,-22000,0,0,0,218000,240000,-22000,-22000
056551,台郡凱基98購04  ,0,0,0,0,0,0,0,0,0,-22000,0,0,0,2000,24000,-22000,-22000
056529,中環凱基98購01  ,0,0,0,0,0,0,0,0,0,-22000,0,0,0,6000,28000,-22000,-22000
057465,智易永豐98購02  ,0,0,0,0,0,0,0,0,0,-22000,0,0,0,0,22000,-22000,-22000
058422,百和麥證99購01  ,0,0,0,0,22000,-22000,0,0,0,-22000,0,0,0,0,22000,-22000,-22000
2466,冠西電          ,4000,28000,-24000,0,0,0,0,0,0,1000,1000,0,1000,0,0,0,-23000
07218P,臺股指凱基99售31,0,0,0,0,0,0,0,0,0,-23000,0,0,0,20000,43000,-23000,-23000
07161P,臺股指群益99售12,0,0,0,0,0,0,0,0,0,-23000,0,0,0,14000,37000,-23000,-23000
1439,中和            ,102000,125000,-23000,0,0,0,0,0,0,0,0,0,0,0,0,0,-23000
07471P,南亞科元大9A售01,0,0,0,0,0,0,0,0,0,-23000,0,0,0,0,23000,-23000,-23000
1731,美吾華          ,43000,66000,-23000,0,0,0,0,0,0,0,0,0,0,0,0,0,-23000
059509,奇力新永豐99購02,0,0,0,0,0,0,0,0,0,-23000,0,0,0,25000,48000,-23000,-23000
059731,康控元大99購04  ,0,0,0,0,0,0,0,0,0,-23000,0,0,0,23000,46000,-23000,-23000
060065,大立光兆豐9B購01,0,0,0,0,0,0,0,0,0,-23000,0,0,0,10000,33000,-23000,-23000
06223P,漢唐元富97售02  ,0,0,0,0,0,0,0,0,0,-23000,0,0,0,0,23000,-23000,-23000
057976,旺宏永豐98購03  ,0,0,0,0,0,0,0,0,0,-23000,0,0,0,72000,95000,-23000,-23000
053611,聯茂麥證96購01  ,0,0,0,0,23000,-23000,0,0,0,-23000,0,0,0,0,23000,-23000,-23000
052555,漢唐國票97購01  ,0,0,0,0,0,0,0,0,0,-23000,0,0,0,45000,68000,-23000,-23000
052188,欣興群益95購03  ,0,0,0,0,0,0,0,0,0,-23000,0,0,0,2000,25000,-23000,-23000
00736,國泰新興市場    ,0,0,0,0,0,0,0,0,0,-23000,0,0,0,126000,149000,-23000,-23000
00783,富邦中証500     ,0,0,0,0,0,0,0,0,0,-23000,0,0,0,815000,838000,-23000,-23000
03418P,大毅群益02售03  ,0,0,0,0,0,0,0,0,0,-23000,0,0,0,0,23000,-23000,-23000
044963,台積電中信96購01,0,0,0,0,0,0,0,0,0,-23000,0,0,0,1000,24000,-23000,-23000
05286P,矽力統一95售02  ,0,0,0,0,0,0,0,0,0,-23000,0,0,0,0,23000,-23000,-23000
052946,智原國票97購02  ,0,0,0,0,0,0,0,0,0,-23000,0,0,0,26000,49000,-23000,-23000
054020,技嘉台新97購01  ,0,0,0,0,0,0,0,0,0,-23000,0,0,0,0,23000,-23000,-23000
057116,鴻海日盛9A購01  ,0,0,0,0,0,0,0,0,0,-23000,0,0,0,217000,240000,-23000,-23000
059058,可成凱基9B購01  ,0,0,0,0,0,0,0,0,0,-23000,0,0,0,55000,78000,-23000,-23000
059151,臺股指國票99購14,0,0,0,0,0,0,0,0,0,-23000,0,0,0,13000,36000,-23000,-23000
055419,國巨永豐97購03  ,0,0,0,0,0,0,0,0,0,-23000,0,0,0,0,23000,-23000,-23000
06523P,台積電麥證98售02,0,0,0,0,24000,-24000,0,0,0,-24000,0,0,0,0,24000,-24000,-24000
06971P,台光電元大99售03,0,0,0,0,0,0,0,0,0,-24000,0,0,0,78000,102000,-24000,-24000
06896P,信邦中信98售01  ,0,0,0,0,0,0,0,0,0,-24000,0,0,0,2000,26000,-24000,-24000
059453,奇力新永豐99購01,0,0,0,0,0,0,0,0,0,-24000,0,0,0,45000,69000,-24000,-24000
1231,聯華食          ,26000,100000,-74000,0,0,0,0,0,0,50000,50000,0,50000,0,0,0,-24000
1307,三芳            ,29000,47000,-18000,0,0,0,0,0,0,-6000,0,6000,-6000,0,0,0,-24000
07149P,健鼎元大99售03  ,0,0,0,0,0,0,0,0,0,-24000,0,0,0,3000,27000,-24000,-24000
6531,愛普            ,382000,439000,-57000,0,0,0,0,0,0,33000,33000,0,33000,0,0,0,-24000
050480,健策國票95購04  ,0,0,0,0,0,0,0,0,0,-24000,0,0,0,41000,65000,-24000,-24000
00681R,元大美債20反1   ,0,0,0,0,0,0,0,0,0,-24000,0,0,0,7000,31000,-24000,-24000
0053,元大電子        ,0,0,0,0,0,0,0,0,0,-24000,0,0,0,2000,26000,-24000,-24000
052576,聯茂凱基96購01  ,0,0,0,0,0,0,0,0,0,-24000,0,0,0,9000,33000,-24000,-24000
057964,緯穎元大99購03  ,0,0,0,0,0,0,0,0,0,-24000,0,0,0,33000,57000,-24000,-24000
053500,新日興兆豐97購01,0,0,0,0,0,0,0,0,0,-24000,0,0,0,3000,27000,-24000,-24000
053800,華通凱基97購03  ,0,0,0,0,0,0,0,0,0,-24000,0,0,0,103000,127000,-24000,-24000
053424,欣興永豐96購02  ,0,0,0,0,0,0,0,0,0,-24000,0,0,0,1000,25000,-24000,-24000
058070,華新科凱基98購07,0,0,0,0,0,0,0,0,0,-24000,0,0,0,44000,68000,-24000,-24000
058160,奇鋐元富99購01  ,0,0,0,0,0,0,0,0,0,-24000,0,0,0,161000,185000,-24000,-24000
058671,旺宏群益9A購01  ,0,0,0,0,0,0,0,0,0,-24000,0,0,0,114000,138000,-24000,-24000
055627,亞德客永豐97購02,0,0,0,0,0,0,0,0,0,-24000,0,0,0,35000,59000,-24000,-24000
059023,可成統一9B購02  ,0,0,0,0,0,0,0,0,0,-24000,0,0,0,65000,89000,-24000,-24000
057001,華邦電國票99購02,0,0,0,0,0,0,0,0,0,-24000,0,0,0,94000,118000,-24000,-24000
057557,聯茂凱基99購04  ,0,0,0,0,0,0,0,0,0,-24000,0,0,0,41000,65000,-24000,-24000
4532,瑞智            ,84000,108000,-24000,0,0,0,0,0,0,-1000,0,1000,-1000,0,0,0,-25000
07180P,臺股指凱基99售22,0,0,0,0,0,0,0,0,0,-25000,0,0,0,0,25000,-25000,-25000
059762,禾伸堂永豐99購02,0,0,0,0,0,0,0,0,0,-25000,0,0,0,58000,83000,-25000,-25000
059682,可成富邦9A購01  ,50000,0,50000,0,0,0,0,0,0,-75000,0,0,0,21000,96000,-75000,-25000
059934,華通永豐99購02  ,0,0,0,0,0,0,0,0,0,-25000,0,0,0,104000,129000,-25000,-25000
06891P,緯穎富邦99售03  ,0,0,0,0,0,0,0,0,0,-25000,0,0,0,0,25000,-25000,-25000
060028,國揚永豐99購01  ,0,0,0,0,0,0,0,0,0,-25000,0,0,0,0,25000,-25000,-25000
060144,全新國票9B購01  ,0,0,0,0,0,0,0,0,0,-25000,0,0,0,0,25000,-25000,-25000
058213,欣興群益99購01  ,0,0,0,0,0,0,0,0,0,-25000,0,0,0,101000,126000,-25000,-25000
05194P,玉晶光康和95售01,0,0,0,0,0,0,0,0,0,-25000,0,0,0,5000,30000,-25000,-25000
052474,T50反1群益95購04,0,0,0,0,0,0,0,0,0,-25000,0,0,0,0,25000,-25000,-25000
044254,深中小元大94購01,0,0,0,0,0,0,0,0,0,-25000,0,0,0,0,25000,-25000,-25000
03662C,FBVIX凱基03牛01 ,0,0,0,0,0,0,0,0,0,-25000,0,0,0,1000,26000,-25000,-25000
051087,國巨元大97購01  ,0,0,0,0,0,0,0,0,0,-25000,0,0,0,0,25000,-25000,-25000
059203,勤誠永豐99購02  ,0,0,0,0,0,0,0,0,0,-25000,0,0,0,116000,141000,-25000,-25000
055545,國巨凱基97購06  ,0,0,0,0,0,0,0,0,0,-25000,0,0,0,90000,115000,-25000,-25000
056575,禾伸堂元大99購01,0,0,0,0,0,0,0,0,0,-25000,0,0,0,0,25000,-25000,-25000
058549,藍天永豐99購01  ,0,0,0,0,0,0,0,0,0,-25000,0,0,0,9000,34000,-25000,-25000
056314,力成元大97購01  ,0,0,0,0,0,0,0,0,0,-25000,0,0,0,291000,316000,-25000,-25000
9136,巨騰-DR         ,7000,32000,-25000,0,0,0,0,0,0,0,0,0,0,0,0,0,-25000
3481,群創            ,59288357,57184406,2103951,0,0,0,100000,0,100000,-2229000,421000,1861000,-1440000,438000,1227000,-789000,-25049
1256,鮮活果汁-KY     ,15000,12000,3000,0,0,0,0,28460,-28460,0,0,0,0,0,0,0,-25460
059946,健策永豐99購05  ,0,0,0,0,0,0,0,0,0,-26000,0,0,0,52000,78000,-26000,-26000
059807,大立光元富99購09,0,0,0,0,0,0,0,0,0,-26000,0,0,0,75000,101000,-26000,-26000
054130,漢唐元大97購02  ,0,0,0,0,0,0,0,0,0,-26000,0,0,0,2000,28000,-26000,-26000
058140,臻鼎元大99購02  ,0,0,0,0,0,0,0,0,0,-26000,0,0,0,30000,56000,-26000,-26000
057421,智原凱基98購04  ,0,0,0,0,0,0,0,0,0,-26000,0,0,0,26000,52000,-26000,-26000
056557,世紀鋼凱基98購02,0,0,0,0,0,0,0,0,0,-26000,0,0,0,24000,50000,-26000,-26000
054799,超眾群益98購01  ,0,0,0,0,0,0,0,0,0,-26000,0,0,0,0,26000,-26000,-26000
3008,大立光          ,349577,406000,-56423,0,0,0,14000,0,14000,16000,17000,2000,15000,4000,3000,1000,-26423
3669,圓展            ,0,27000,-27000,0,0,0,0,0,0,0,0,0,0,0,0,0,-27000
059853,超眾永豐99購03  ,0,0,0,0,0,0,0,0,0,-27000,0,0,0,0,27000,-27000,-27000
049904,矽力元富94購01  ,0,0,0,0,0,0,0,0,0,-27000,0,0,0,3000,30000,-27000,-27000
00735,國泰臺韓科技    ,0,0,0,0,0,0,0,0,0,-27000,0,0,0,111000,138000,-27000,-27000
053593,晶技元大98購01  ,0,0,0,0,0,0,0,0,0,-27000,0,0,0,175000,202000,-27000,-27000
058036,南電永豐98購01  ,0,0,0,0,0,0,0,0,0,-27000,0,0,0,1000,28000,-27000,-27000
056203,興富發永豐97購01,0,0,0,0,0,0,0,0,0,-27000,0,0,0,27000,54000,-27000,-27000
055652,聯詠元富01購01  ,0,0,0,0,0,0,0,0,0,-27000,0,0,0,263000,290000,-27000,-27000
057567,嘉聯益富邦9A購01,0,0,0,0,0,0,0,0,0,-27000,0,0,0,160000,187000,-27000,-27000
059754,訊芯群益9A購01  ,0,0,0,0,0,0,0,0,0,-28000,0,0,0,144000,172000,-28000,-28000
060287,燿華元大9A購01  ,0,0,0,0,0,0,0,0,0,-28000,0,0,0,0,28000,-28000,-28000
060350,元黃金元富9B購01,0,0,0,0,0,0,0,0,0,-28000,0,0,0,0,28000,-28000,-28000
060049,華通凱基99購06  ,0,0,0,0,0,0,0,0,0,-28000,0,0,0,30000,58000,-28000,-28000
060137,T50反1國票9A購02,0,0,0,0,0,0,0,0,0,-28000,0,0,0,0,28000,-28000,-28000
06572P,台積電永昌99售01,0,0,0,0,0,0,0,0,0,-28000,0,0,0,0,28000,-28000,-28000
06059P,泰碩元大97售02  ,0,0,0,0,0,0,0,0,0,-28000,0,0,0,0,28000,-28000,-28000
2530,華建            ,0,28000,-28000,0,0,0,0,0,0,0,0,0,0,0,0,0,-28000
07258P,台灣50台新9A售01,0,0,0,0,0,0,0,0,0,-28000,0,0,0,5000,33000,-28000,-28000
07340P,鴻海凱基99售15  ,0,0,0,0,0,0,0,0,0,-28000,0,0,0,26000,54000,-28000,-28000
07387P,臺股指群益99售25,0,0,0,0,0,0,0,0,0,-28000,0,0,0,10000,38000,-28000,-28000
058033,景碩永豐98購02  ,0,0,0,0,0,0,0,0,0,-28000,0,0,0,33000,61000,-28000,-28000
054418,茂林元大97購01  ,0,0,0,0,0,0,0,0,0,-28000,0,0,0,0,28000,-28000,-28000
050902,南電元大96購01  ,0,0,0,0,0,0,0,0,0,-28000,0,0,0,163000,191000,-28000,-28000
054064,台郡國票97購04  ,0,0,0,0,0,0,0,0,0,-28000,0,0,0,0,28000,-28000,-28000
05574P,英業達元富96售01,0,0,0,0,0,0,0,0,0,-28000,0,0,0,0,28000,-28000,-28000
056919,英業達兆豐98購01,0,0,0,0,0,0,0,0,0,-28000,0,0,0,50000,78000,-28000,-28000
057670,欣興元大99購02  ,0,0,0,0,0,0,0,0,0,-28000,0,0,0,21000,49000,-28000,-28000
055732,全新元富9A購01  ,0,0,0,0,0,0,0,0,0,-28000,0,0,0,140000,168000,-28000,-28000
059240,台積電凱基9A購09,0,0,0,0,0,0,0,0,0,-28000,0,0,0,44000,72000,-28000,-28000
8070,長華*           ,20000,22000,-2000,0,0,0,0,0,0,-26000,0,26000,-26000,0,0,0,-28000
2514,龍邦            ,118000,160260,-42260,0,0,0,0,0,0,14000,15000,1000,14000,0,0,0,-28260
2467,志聖            ,68000,97000,-29000,0,0,0,0,0,0,0,0,0,0,0,0,0,-29000
07109P,聯發科中信9B售02,0,0,0,0,0,0,0,0,0,-29000,0,0,0,2000,31000,-29000,-29000
060339,國巨統一01購01  ,0,0,0,0,0,0,0,0,0,-29000,0,0,0,1000,30000,-29000,-29000
059671,滬深2X元富99購05,0,0,0,0,0,0,0,0,0,-29000,0,0,0,41000,70000,-29000,-29000
059660,華新科元大9A購04,0,0,0,0,0,0,0,0,0,-29000,0,0,0,16000,45000,-29000,-29000
059937,旺宏永豐99購03  ,0,0,0,0,0,0,0,0,0,-29000,0,0,0,28000,57000,-29000,-29000
059404,鴻海台新99購03  ,0,0,0,0,0,0,0,0,0,-29000,0,0,0,107000,136000,-29000,-29000
03677C,臺股指元大05牛02,0,0,0,0,0,0,0,0,0,-29000,0,0,0,44000,73000,-29000,-29000
047673,瑞昱元富96購01  ,0,0,0,0,0,0,0,0,0,-29000,0,0,0,35000,64000,-29000,-29000
056045,勤誠凱基97購01  ,0,0,0,0,0,0,0,0,0,-29000,0,0,0,122000,151000,-29000,-29000
055558,大立光凱基97購08,0,0,0,0,0,0,0,0,0,-29000,0,0,0,2000,31000,-29000,-29000
058141,嘉聯益元大99購05,0,0,0,0,0,0,0,0,0,-29000,0,0,0,33000,62000,-29000,-29000
059584,台灣50元大01購11,0,0,0,0,0,0,0,0,0,-30000,0,0,0,10000,40000,-30000,-30000
059938,凱美永豐99購01  ,0,0,0,0,0,0,0,0,0,-30000,0,0,0,4000,34000,-30000,-30000
059925,可成國泰9B購01  ,0,0,0,0,0,0,0,0,0,-30000,0,0,0,7000,37000,-30000,-30000
059902,滬深2X元大9C購08,0,0,0,0,0,0,0,0,0,-30000,0,0,0,100000,130000,-30000,-30000
060336,南電康和9A購01  ,0,0,0,0,0,0,0,0,0,-30000,0,0,0,18000,48000,-30000,-30000
060313,淘帝永豐9A購01  ,0,0,0,0,0,0,0,0,0,-30000,0,0,0,0,30000,-30000,-30000
060358,國巨元富9A購01  ,0,0,0,0,0,0,0,0,0,-30000,0,0,0,0,30000,-30000,-30000
060292,聯詠元大9A購01  ,0,0,0,0,0,0,0,0,0,-30000,0,0,0,46000,76000,-30000,-30000
060046,S&P反1凱基99購02,0,0,0,0,0,0,0,0,0,-30000,0,0,0,60000,90000,-30000,-30000
060041,T50反1群益99購04,0,0,0,0,0,0,0,0,0,-30000,0,0,0,0,30000,-30000,-30000
060018,國產康和99購01  ,0,0,0,0,0,0,0,0,0,-30000,0,0,0,0,30000,-30000,-30000
06053P,緯穎國票97售05  ,0,0,0,0,0,0,0,0,0,-30000,0,0,0,0,30000,-30000,-30000
06980P,緯穎永豐99售02  ,0,0,0,0,0,0,0,0,0,-30000,0,0,0,0,30000,-30000,-30000
06720P,智邦亞東99售01  ,0,0,0,0,0,0,0,0,0,-30000,0,0,0,0,30000,-30000,-30000
07329P,台灣50群益9A售07,0,0,0,0,0,0,0,0,0,-30000,0,0,0,0,30000,-30000,-30000
07281P,鴻海凱基99售13  ,0,0,0,0,0,0,0,0,0,-30000,0,0,0,120000,150000,-30000,-30000
07264P,台積電元大99售38,0,0,0,0,0,0,0,0,0,-30000,0,0,0,10000,40000,-30000,-30000
4763,材料-KY         ,25000,55000,-30000,0,0,0,0,0,0,0,6000,6000,0,0,0,0,-30000
03017X,元展17          ,0,0,0,0,0,0,0,0,0,-30000,0,0,0,0,30000,-30000,-30000
03416B,臺股指凱基95熊05,0,0,0,0,0,0,0,0,0,-30000,0,0,0,30000,60000,-30000,-30000
03428B,臺股指凱基97熊18,0,0,0,0,0,0,0,0,0,-30000,0,0,0,5000,35000,-30000,-30000
04403P,景碩國票95售01  ,0,0,0,0,0,0,0,0,0,-30000,0,0,0,0,30000,-30000,-30000
052820,宏達電永豐96購01,0,0,0,0,0,0,0,0,0,-30000,0,0,0,0,30000,-30000,-30000
054163,燿華凱基97購02  ,0,0,0,0,0,0,0,0,0,-30000,0,0,0,0,30000,-30000,-30000
049065,T50反1凱基96購04,0,0,0,0,0,0,0,0,0,-30000,0,0,0,0,30000,-30000,-30000
048522,A50正2元富95購02,0,0,0,0,0,0,0,0,0,-30000,0,0,0,0,30000,-30000,-30000
049600,緯穎元大95購02  ,0,0,0,0,0,0,0,0,0,-30000,0,0,0,20000,50000,-30000,-30000
050346,康友元富94購03  ,0,0,0,0,0,0,0,0,0,-30000,0,0,0,0,30000,-30000,-30000
049472,楠梓電永豐95購01,0,0,0,0,0,0,0,0,0,-30000,0,0,0,0,30000,-30000,-30000
05320P,華通凱基96售03  ,0,0,0,0,0,0,0,0,0,-30000,0,0,0,0,30000,-30000,-30000
053154,聯詠元大96購01  ,0,0,0,0,0,0,0,0,0,-30000,0,0,0,0,30000,-30000,-30000
052488,旺宏國票96購03  ,0,0,0,0,0,0,0,0,0,-30000,0,0,0,0,30000,-30000,-30000
052542,友達元富98購01  ,0,0,0,0,0,0,0,0,0,-30000,0,0,0,0,30000,-30000,-30000
052194,旺宏元富95購04  ,0,0,0,0,0,0,0,0,0,-30000,0,0,0,0,30000,-30000,-30000
05425P,華邦電亞東96售02,0,0,0,0,0,0,0,0,0,-30000,0,0,0,0,30000,-30000,-30000
054200,美律富邦97購02  ,0,0,0,0,0,0,0,0,0,-30000,0,0,0,0,30000,-30000,-30000
058206,祥碩凱基99購01  ,0,0,0,0,0,0,0,0,0,-30000,0,0,0,6000,36000,-30000,-30000
058333,鴻海元富99購04  ,0,0,0,0,0,0,0,0,0,-30000,0,0,0,113000,143000,-30000,-30000
053308,智易凱基96購02  ,0,0,0,0,0,0,0,0,0,-30000,0,0,0,0,30000,-30000,-30000
058244,神達元大99購02  ,0,0,0,0,0,0,0,0,0,-30000,0,0,0,50000,80000,-30000,-30000
057810,技嘉元大98購06  ,0,0,0,0,0,0,0,0,0,-30000,0,0,0,0,30000,-30000,-30000
055568,緯穎凱基97購02  ,0,0,0,0,0,0,0,0,0,-30000,0,0,0,48000,78000,-30000,-30000
055249,大毅統一99購01  ,0,0,0,0,0,0,0,0,0,-30000,0,0,0,2000,32000,-30000,-30000
054933,南港元大97購01  ,0,0,0,0,0,0,0,0,0,-30000,0,0,0,0,30000,-30000,-30000
056770,國產元大98購02  ,0,0,0,0,0,0,0,0,0,-30000,0,0,0,0,30000,-30000,-30000
05852P,嘉晶群益96售01  ,0,0,0,0,0,0,0,0,0,-30000,0,0,0,98000,128000,-30000,-30000
057276,全新元大99購03  ,0,0,0,0,0,0,0,0,0,-30000,0,0,0,10000,40000,-30000,-30000
9941,裕融            ,155000,187000,-32000,0,0,0,0,0,0,2000,2000,0,2000,0,0,0,-30000
2442,新美齊          ,248000,280000,-32000,0,0,0,0,0,0,1000,1000,0,1000,0,0,0,-31000
2450,神腦            ,19000,50000,-31000,0,0,0,0,0,0,0,0,0,0,0,0,0,-31000
07266P,大立光元大99售19,0,0,0,0,0,0,0,0,0,-31000,0,0,0,8000,39000,-31000,-31000
07434P,臺股指國票9A售06,0,0,0,0,0,0,0,0,0,-31000,0,0,0,0,31000,-31000,-31000
06955P,臻鼎元富99售01  ,0,0,0,0,0,0,0,0,0,-31000,0,0,0,0,31000,-31000,-31000
06593P,欣興元大98售05  ,0,0,0,0,0,0,0,0,0,-31000,0,0,0,0,31000,-31000,-31000
06332P,世紀鋼群益98售01,0,0,0,0,0,0,0,0,0,-31000,0,0,0,8000,39000,-31000,-31000
059982,聯發科元大99購37,0,0,0,0,0,0,0,0,0,-31000,0,0,0,414000,445000,-31000,-31000
060275,元黃金元大9A購01,0,0,0,0,0,0,0,0,0,-31000,0,0,0,0,31000,-31000,-31000
059837,健策國泰9B購01  ,0,0,0,0,0,0,0,0,0,-31000,0,0,0,85000,116000,-31000,-31000
059580,大立光元富99購07,0,0,0,0,0,0,0,0,0,-31000,0,0,0,0,31000,-31000,-31000
053728,茂林凱基97購01  ,0,0,0,0,0,0,0,0,0,-31000,0,0,0,171000,202000,-31000,-31000
051406,泰鼎永豐96購01  ,0,0,0,0,0,0,0,0,0,-31000,0,0,0,1000,32000,-31000,-31000
059243,聯發科凱基99購12,0,0,0,0,0,0,0,0,0,-31000,0,0,0,29000,60000,-31000,-31000
056559,華通群益98購02  ,0,0,0,0,0,0,0,0,0,-31000,0,0,0,0,31000,-31000,-31000
8480,泰昇-KY         ,8000,37000,-29000,0,0,0,0,0,0,-2000,0,2000,-2000,0,0,0,-31000
059945,嘉澤永豐99購03  ,0,0,0,0,0,0,0,0,0,-32000,0,0,0,238000,270000,-32000,-32000
059743,開發金元富99購01,0,0,0,0,0,0,0,0,0,-32000,0,0,0,90000,122000,-32000,-32000
060258,T50反1凱基9A購06,0,0,0,0,0,0,0,0,0,-32000,0,0,0,0,32000,-32000,-32000
060342,台積電統一02購01,0,0,0,0,0,0,0,0,0,-32000,0,0,0,14000,46000,-32000,-32000
060010,義隆群益99購02  ,0,0,0,0,0,0,0,0,0,-32000,0,0,0,45000,77000,-32000,-32000
06936P,瑞儀元大98售01  ,0,0,0,0,0,0,0,0,0,-32000,0,0,0,43000,75000,-32000,-32000
06684P,緯穎元大98售06  ,0,0,0,0,0,0,0,0,0,-32000,0,0,0,119000,151000,-32000,-32000
07355P,臺股指國票99售23,0,0,0,0,0,0,0,0,0,-32000,0,0,0,35000,67000,-32000,-32000
2609,陽明            ,189000,221000,-32000,0,0,0,0,0,0,0,0,0,0,0,0,0,-32000
03049X,元展46          ,0,0,0,0,0,0,0,0,0,-32000,0,0,0,0,32000,-32000,-32000
053492,華邦電兆豐97購01,0,0,0,0,0,0,0,0,0,-32000,0,0,0,130000,162000,-32000,-32000
058188,華擎永豐99購01  ,0,0,0,0,0,0,0,0,0,-32000,0,0,0,10000,42000,-32000,-32000
057853,旺宏國票99購05  ,0,0,0,0,0,0,0,0,0,-32000,0,0,0,14000,46000,-32000,-32000
052272,T50反1群益95購03,0,0,0,0,0,0,0,0,0,-32000,0,0,0,0,32000,-32000,-32000
057357,超眾統一98購01  ,0,0,0,0,0,0,0,0,0,-32000,0,0,0,0,32000,-32000,-32000
058955,台積電國票9A購04,0,0,0,0,0,0,0,0,0,-32000,0,0,0,255000,287000,-32000,-32000
057268,臻鼎兆豐99購01  ,0,0,0,0,0,0,0,0,0,-32000,0,0,0,0,32000,-32000,-32000
057239,貿聯凱基98購05  ,0,0,0,0,0,0,0,0,0,-32000,0,0,0,0,32000,-32000,-32000
2397,友通            ,13000,46000,-33000,0,0,0,0,0,0,0,0,0,0,0,0,0,-33000
05947P,大成鋼元大96售03,0,0,0,0,0,0,0,0,0,-33000,0,0,0,22000,55000,-33000,-33000
053099,正崴元富96購01  ,0,0,0,0,0,0,0,0,0,-33000,0,0,0,0,33000,-33000,-33000
053725,晶相光凱基96購01,0,0,0,0,0,0,0,0,0,-33000,0,0,0,342000,375000,-33000,-33000
00850,元大臺灣ESG永續 ,2000,0,2000,0,0,0,0,0,0,-35000,0,0,0,979000,1014000,-35000,-33000
04663P,臺股指國票94售02,0,0,0,0,0,0,0,0,0,-33000,0,0,0,30000,63000,-33000,-33000
050385,貿聯國票95購02  ,0,0,0,0,0,0,0,0,0,-33000,0,0,0,5000,38000,-33000,-33000
052933,祥碩元大96購01  ,0,0,0,0,0,0,0,0,0,-33000,0,0,0,3000,36000,-33000,-33000
055138,大毅永豐97購02  ,0,0,0,0,0,0,0,0,0,-33000,0,0,0,40000,73000,-33000,-33000
054745,智易凱基97購01  ,0,0,0,0,0,0,0,0,0,-33000,0,0,0,3000,36000,-33000,-33000
059436,大立光元大99購18,0,0,0,0,0,0,0,0,0,-34000,0,0,0,14000,48000,-34000,-34000
059539,緯穎凱基99購03  ,0,0,0,0,0,0,0,0,0,-34000,0,0,0,69000,103000,-34000,-34000
060026,聯發科富邦9B購05,0,0,0,0,0,0,0,0,0,-34000,0,0,0,4000,38000,-34000,-34000
060190,國泰金元富9A購01,0,0,0,0,0,0,0,0,0,-34000,0,0,0,0,34000,-34000,-34000
07462P,臺股指元大9B售05,0,0,0,0,0,0,0,0,0,-34000,0,0,0,2000,36000,-34000,-34000
052220,T50反1凱基98購01,0,0,0,0,0,0,0,0,0,-34000,0,0,0,0,34000,-34000,-34000
057375,欣興元大98購09  ,0,0,0,0,0,0,0,0,0,-34000,0,0,0,4000,38000,-34000,-34000
055334,禾伸堂兆豐97購01,0,0,0,0,0,0,0,0,0,-34000,0,0,0,0,34000,-34000,-34000
058520,智易元大99購03  ,0,0,0,0,0,0,0,0,0,-34000,0,0,0,59000,93000,-34000,-34000
055815,亞光國票99購01  ,0,0,0,0,0,0,0,0,0,-34000,0,0,0,0,34000,-34000,-34000
059150,臺股指國票99購13,0,0,0,0,0,0,0,0,0,-34000,0,0,0,67000,101000,-34000,-34000
5521,工信            ,302000,336000,-34000,0,0,0,0,0,0,-1000,0,1000,-1000,0,0,0,-35000
060188,華新科元富9A購03,0,0,0,0,0,0,0,0,0,-35000,0,0,0,12000,47000,-35000,-35000
059486,A50正2兆豐9A購01,0,0,0,0,0,0,0,0,0,-35000,0,0,0,15000,50000,-35000,-35000
059880,世紀鋼凱基99購02,0,0,0,0,0,0,0,0,0,-35000,0,0,0,86000,121000,-35000,-35000
059881,臺股指凱基99購46,0,0,0,0,0,0,0,0,0,-35000,0,0,0,10000,45000,-35000,-35000
052229,奇力新凱基96購01,0,0,0,0,0,0,0,0,0,-35000,0,0,0,455000,490000,-35000,-35000
058041,FBVIX元大98購02 ,0,0,0,0,0,0,0,0,0,-35000,0,0,0,0,35000,-35000,-35000
052790,智邦兆豐97購01  ,0,0,0,0,0,0,0,0,0,-35000,0,0,0,0,35000,-35000,-35000
049255,旺宏元大97購02  ,0,0,0,0,0,0,0,0,0,-35000,0,0,0,69000,104000,-35000,-35000
049260,華新科元大96購01,0,0,0,0,0,0,0,0,0,-35000,0,0,0,0,35000,-35000,-35000
050760,矽力元富94購03  ,0,0,0,0,0,0,0,0,0,-35000,0,0,0,5000,40000,-35000,-35000
059254,台表科凱基9A購02,0,0,0,0,0,0,0,0,0,-35000,0,0,0,403000,438000,-35000,-35000
059096,百和元大99購04  ,0,0,0,0,0,0,0,0,0,-35000,0,0,0,38000,73000,-35000,-35000
057599,技嘉群益9A購01  ,0,0,0,0,0,0,0,0,0,-35000,0,0,0,0,35000,-35000,-35000
058538,智邦台新99購02  ,0,0,0,0,0,0,0,0,0,-35000,0,0,0,143000,178000,-35000,-35000
05807P,泰鼎永豐96售03  ,0,0,0,0,0,0,0,0,0,-35000,0,0,0,76000,111000,-35000,-35000
057780,台郡群益98購02  ,0,0,0,0,0,0,0,0,0,-35000,0,0,0,23000,58000,-35000,-35000
058582,禾伸堂群益99購02,0,0,0,0,0,0,0,0,0,-35000,0,0,0,46000,81000,-35000,-35000
058663,瑞儀兆豐9A購01  ,0,0,0,0,0,0,0,0,0,-35000,0,0,0,5000,40000,-35000,-35000
055131,茂林康和97購01  ,0,0,0,0,0,0,0,0,0,-35000,0,0,0,329000,364000,-35000,-35000
056583,昇陽半元大98購02,0,0,0,0,0,0,0,0,0,-35000,0,0,0,0,35000,-35000,-35000
056105,智原永豐97購01  ,0,0,0,0,0,0,0,0,0,-35000,0,0,0,0,35000,-35000,-35000
059866,國巨凱基99購18  ,0,0,0,0,0,0,0,0,0,-36000,0,0,0,5000,41000,-36000,-36000
059772,可成群益9A購05  ,0,0,0,0,0,0,0,0,0,-36000,0,0,0,6000,42000,-36000,-36000
060231,台積電元大9A購08,0,0,0,0,0,0,0,0,0,-36000,0,0,0,4000,40000,-36000,-36000
060193,群創元富9A購01  ,0,0,0,0,0,0,0,0,0,-36000,0,0,0,0,36000,-36000,-36000
060302,台積電富邦02購01,0,0,0,0,0,0,0,0,0,-36000,0,0,0,0,36000,-36000,-36000
06654P,欣興元大98售08  ,0,0,0,0,0,0,0,0,0,-36000,0,0,0,5000,41000,-36000,-36000
08674P,嘉晶元富07售02  ,0,0,0,0,0,0,0,0,0,-36000,0,0,0,0,36000,-36000,-36000
1720,生達            ,126000,162000,-36000,0,0,0,0,0,0,0,0,0,0,0,0,0,-36000
1802,台玻            ,684000,720000,-36000,0,0,0,0,0,0,0,0,0,0,0,0,0,-36000
07347P,上証2X凱基99售02,0,0,0,0,0,0,0,0,0,-36000,0,0,0,0,36000,-36000,-36000
056076,超眾元大97購05  ,0,0,0,0,0,0,0,0,0,-36000,0,0,0,78000,114000,-36000,-36000
054760,台化國票9A購01  ,0,0,0,0,0,0,0,0,0,-36000,0,0,0,15000,51000,-36000,-36000
057188,佐登元大98購01  ,0,0,0,0,0,0,0,0,0,-36000,0,0,0,9000,45000,-36000,-36000
059014,SGBR2X元富03購01,0,0,0,0,0,0,0,0,0,-36000,0,0,0,38000,74000,-36000,-36000
07272P,台灣50元大9C售05,0,0,0,0,0,0,0,0,0,-37000,0,0,0,0,37000,-37000,-37000
1773,勝一            ,15000,52000,-37000,0,0,0,0,0,0,0,0,0,0,0,0,0,-37000
1702,南僑            ,100000,137000,-37000,0,0,0,0,0,0,0,0,0,0,0,0,0,-37000
2493,揚博            ,20000,57000,-37000,0,0,0,0,0,0,0,0,0,0,0,0,0,-37000
06728P,全新元大98售03  ,0,0,0,0,0,0,0,0,0,-37000,0,0,0,65000,102000,-37000,-37000
060343,台積電統一9C購02,0,0,0,0,0,0,0,0,0,-37000,0,0,0,16000,53000,-37000,-37000
060181,華通元富9A購01  ,0,0,0,0,0,0,0,0,0,-37000,0,0,0,0,37000,-37000,-37000
060157,致茂永豐9A購02  ,0,0,0,0,0,0,0,0,0,-37000,0,0,0,0,37000,-37000,-37000
059844,大立光富邦9C購04,0,0,0,0,0,0,0,0,0,-37000,0,0,0,27000,64000,-37000,-37000
052102,台泥兆豐96購01  ,0,0,0,0,0,0,0,0,0,-37000,0,0,0,0,37000,-37000,-37000
057298,旭富永豐98購01  ,0,0,0,0,0,0,0,0,0,-37000,0,0,0,0,37000,-37000,-37000
054742,京鼎凱基99購01  ,0,0,0,0,0,0,0,0,0,-37000,0,0,0,287000,324000,-37000,-37000
059796,台積電國票99購10,0,0,0,0,0,0,0,0,0,-38000,0,0,0,21000,59000,-38000,-38000
059534,國泰金凱基99購01,0,0,0,0,0,0,0,0,0,-38000,0,0,0,74000,112000,-38000,-38000
060365,京鼎元富9A購01  ,0,0,0,0,0,0,0,0,0,-38000,0,0,0,0,38000,-38000,-38000
060141,T50反1國票9B購02,0,0,0,0,0,0,0,0,0,-38000,0,0,0,0,38000,-38000,-38000
060105,牧德元大9B購01  ,0,0,0,0,0,0,0,0,0,-38000,0,0,0,38000,76000,-38000,-38000
07389P,臺股指群益9C售08,0,0,0,0,0,0,0,0,0,-38000,0,0,0,4000,42000,-38000,-38000
052558,新唐國票97購01  ,0,0,0,0,0,0,0,0,0,-38000,0,0,0,0,38000,-38000,-38000
057952,元油2X元大98購21,0,0,0,0,0,0,0,0,0,-38000,0,0,0,0,38000,-38000,-38000
051637,嘉聯益國票96購01,0,0,0,0,0,0,0,0,0,-38000,0,0,0,0,38000,-38000,-38000
053719,可成凱基96購08  ,0,0,0,0,0,0,0,0,0,-38000,0,0,0,11000,49000,-38000,-38000
050845,奇鋐國票95購02  ,0,0,0,0,0,0,0,0,0,-38000,0,0,0,0,38000,-38000,-38000
051160,亞德客元大95購02,0,0,0,0,0,0,0,0,0,-38000,0,0,0,12000,50000,-38000,-38000
050725,光磊國票96購01  ,0,0,0,0,0,0,0,0,0,-38000,0,0,0,0,38000,-38000,-38000
051422,超眾國票96購01  ,0,0,0,0,0,0,0,0,0,-38000,0,0,0,0,38000,-38000,-38000
048273,南電富邦97購01  ,0,0,0,0,0,0,0,0,0,-38000,0,0,0,23000,61000,-38000,-38000
050320,台表科國票94購01,0,0,0,0,0,0,0,0,0,-38000,0,0,0,0,38000,-38000,-38000
054169,上緯控凱基98購01,0,0,0,0,0,0,0,0,0,-38000,0,0,0,2000,40000,-38000,-38000
054772,康控國票98購02  ,0,0,0,0,0,0,0,0,0,-38000,0,0,0,0,38000,-38000,-38000
056410,康控國票99購01  ,0,0,0,0,0,0,0,0,0,-38000,0,0,0,0,38000,-38000,-38000
056397,彩晶永豐99購01  ,0,0,0,0,0,0,0,0,0,-38000,0,0,0,0,38000,-38000,-38000
055802,新日興永豐97購01,0,0,0,0,0,0,0,0,0,-38000,0,0,0,0,38000,-38000,-38000
03619C,臺股指元大95牛02,0,0,0,0,0,0,0,0,0,-39000,0,0,0,58000,97000,-39000,-39000
057949,南電國票99購01  ,0,0,0,0,0,0,0,0,0,-39000,0,0,0,14000,53000,-39000,-39000
057975,台積電永豐98購05,0,0,0,0,0,0,0,0,0,-39000,0,0,0,32000,71000,-39000,-39000
058208,百和凱基99購01  ,0,0,0,0,0,0,0,0,0,-39000,0,0,0,23000,62000,-39000,-39000
053506,南茂兆豐97購01  ,0,0,0,0,0,0,0,0,0,-39000,0,0,0,0,39000,-39000,-39000
052294,創意國票96購03  ,0,0,0,0,0,0,0,0,0,-39000,0,0,0,60000,99000,-39000,-39000
057181,亞光元大98購02  ,0,0,0,0,0,0,0,0,0,-39000,0,0,0,178000,217000,-39000,-39000
059237,鴻海凱基9A購10  ,0,0,0,0,0,0,0,0,0,-39000,0,0,0,34000,73000,-39000,-39000
058137,玉晶光元大99購11,0,0,0,0,0,0,0,0,0,-39000,0,0,0,40000,79000,-39000,-39000
055231,大毅國票98購02  ,0,0,0,0,0,0,0,0,0,-39000,0,0,0,4000,43000,-39000,-39000
056151,建準凱基97購01  ,0,0,0,0,0,0,0,0,0,-39000,0,0,0,0,39000,-39000,-39000
07129P,華新科元大99售14,0,0,0,0,0,0,0,0,0,-40000,0,0,0,26000,66000,-40000,-40000
2032,新鋼            ,2000,42000,-40000,0,0,0,0,0,0,0,0,0,0,0,0,0,-40000
07460P,臺股指元大9B售03,0,0,0,0,0,0,0,0,0,-40000,0,0,0,0,40000,-40000,-40000
4104,佳醫            ,20000,59000,-39000,0,0,0,0,0,0,-1000,0,1000,-1000,0,0,0,-40000
060260,京鼎凱基9C購01  ,0,0,0,0,0,0,0,0,0,-40000,0,0,0,0,40000,-40000,-40000
060295,貿聯元大9A購03  ,0,0,0,0,0,0,0,0,0,-40000,0,0,0,0,40000,-40000,-40000
059540,新光金日盛99購01,0,0,0,0,0,0,0,0,0,-40000,0,0,0,10000,50000,-40000,-40000
059598,欣興元大99購08  ,0,0,0,0,0,0,0,0,0,-40000,0,0,0,54000,94000,-40000,-40000
052094,瀚宇博元大96購02,0,0,0,0,0,0,0,0,0,-40000,0,0,0,0,40000,-40000,-40000
053752,超眾永豐96購02  ,0,0,0,0,0,0,0,0,0,-40000,0,0,0,0,40000,-40000,-40000
050922,南亞科凱基95購02,0,0,0,0,0,0,0,0,0,-40000,0,0,0,0,40000,-40000,-40000
05402P,台郡永豐95售02  ,0,0,0,0,0,0,0,0,0,-40000,0,0,0,16000,56000,-40000,-40000
055924,深中小群益9B購01,0,0,0,0,0,0,0,0,0,-40000,0,0,0,10000,50000,-40000,-40000
054717,亞德客永豐97購01,0,0,0,0,0,0,0,0,0,-40000,0,0,0,43000,83000,-40000,-40000
054922,文曄凱基98購01  ,0,0,0,0,0,0,0,0,0,-40000,0,0,0,10000,50000,-40000,-40000
058452,義隆永豐99購02  ,0,0,0,0,0,0,0,0,0,-40000,0,0,0,0,40000,-40000,-40000
057390,台表科永豐98購01,0,0,0,0,0,0,0,0,0,-40000,0,0,0,0,40000,-40000,-40000
059183,T50反1台新03購02,0,0,0,0,0,0,0,0,0,-40000,0,0,0,36000,76000,-40000,-40000
056757,T50反1元大98購07,0,0,0,0,0,0,0,0,0,-40000,0,0,0,70000,110000,-40000,-40000
057650,力成元大98購04  ,0,0,0,0,0,0,0,0,0,-40000,0,0,0,30000,70000,-40000,-40000
057106,美律群益98購03  ,0,0,0,0,0,0,0,0,0,-40000,0,0,0,0,40000,-40000,-40000
059308,T50反1元大99購07,0,0,0,0,0,0,0,0,0,-41000,0,0,0,19000,60000,-41000,-41000
1786,科妍            ,15000,57000,-42000,0,0,0,0,0,0,1000,1000,0,1000,0,0,0,-41000
048859,玉晶光群益96購02,0,0,0,0,0,0,0,0,0,-41000,0,0,0,250000,291000,-41000,-41000
057543,華通凱基99購02  ,0,0,0,0,0,0,0,0,0,-41000,0,0,0,26000,67000,-41000,-41000
059215,台積電元大99購28,0,0,0,0,0,0,0,0,0,-41000,0,0,0,41000,82000,-41000,-41000
058262,大立光富邦9C購02,0,0,0,0,0,0,0,0,0,-41000,0,0,0,0,41000,-41000,-41000
055291,京鼎元大97購02  ,0,0,0,0,0,0,0,0,0,-41000,0,0,0,217000,258000,-41000,-41000
9934,成霖            ,92000,120000,-28000,0,0,0,0,0,0,-13000,0,13000,-13000,0,0,0,-41000
6189,豐藝            ,47000,89000,-42000,0,0,0,0,0,0,0,0,0,0,0,0,0,-42000
059766,同欣電永豐99購03,0,0,0,0,0,0,0,0,0,-42000,0,0,0,156000,198000,-42000,-42000
060128,健策永豐99購06  ,0,0,0,0,0,0,0,0,0,-42000,0,0,0,50000,92000,-42000,-42000
04831P,聯詠富邦96售01  ,0,0,0,0,0,0,0,0,0,-42000,0,0,0,64000,106000,-42000,-42000
056139,貿聯元大97購04  ,0,0,0,0,0,0,0,0,0,-42000,0,0,0,0,42000,-42000,-42000
059146,貿聯國票9A購02  ,0,0,0,0,0,0,0,0,0,-42000,0,0,0,2000,44000,-42000,-42000
054612,慧洋永豐97購01  ,0,0,0,0,0,0,0,0,0,-42000,0,0,0,0,42000,-42000,-42000
6582,申豐            ,35000,77000,-42000,0,0,0,0,0,0,0,3000,3000,0,0,0,0,-42000
060096,聯發科元大99購43,0,0,0,0,0,0,0,0,0,-43000,0,0,0,10000,53000,-43000,-43000
060021,立積康和99購01  ,0,0,0,0,0,0,0,0,0,-43000,0,0,0,178000,221000,-43000,-43000
06934P,聯鈞元大98售03  ,0,0,0,0,0,0,0,0,0,-43000,0,0,0,33000,76000,-43000,-43000
3376,新日興          ,474000,669000,-195000,0,0,0,126000,22000,104000,48000,93000,63000,30000,26000,8000,18000,-43000
2496,卓越            ,6000,48000,-42000,0,0,0,0,0,0,-1000,0,1000,-1000,0,0,0,-43000
2331,精英            ,104000,144000,-40000,0,0,0,0,0,0,-3000,0,5000,-5000,2000,0,2000,-43000
2908,特力            ,6000,49000,-43000,0,0,0,0,0,0,0,0,0,0,0,0,0,-43000
07396P,聯發科群益9B售01,0,0,0,0,0,0,0,0,0,-43000,0,0,0,0,43000,-43000,-43000
049931,矽力元大94購01  ,0,0,0,0,0,0,0,0,0,-43000,0,0,0,7000,50000,-43000,-43000
053913,華新國票97購01  ,0,0,0,0,0,0,0,0,0,-43000,0,0,0,0,43000,-43000,-43000
053398,和鑫中信99購01  ,0,0,0,0,0,0,0,0,0,-43000,0,0,0,0,43000,-43000,-43000
053405,台達電兆豐96購01,0,0,0,0,0,0,0,0,0,-43000,0,0,0,0,43000,-43000,-43000
058378,南電凱基99購01  ,0,0,0,0,0,0,0,0,0,-43000,0,0,0,9000,52000,-43000,-43000
053082,聯電元大98購03  ,0,0,0,0,0,0,0,0,0,-43000,0,0,0,10000,53000,-43000,-43000
053535,宏達電永豐96購02,0,0,0,0,0,0,0,0,0,-43000,0,0,0,25000,68000,-43000,-43000
056438,旺宏凱基98購05  ,0,0,0,0,0,0,0,0,0,-43000,0,0,0,101000,144000,-43000,-43000
060064,華新科兆豐99購07,0,0,0,0,0,0,0,0,0,-44000,0,0,0,0,44000,-44000,-44000
053244,光磊國票97購01  ,0,0,0,0,0,0,0,0,0,-44000,0,0,0,102000,146000,-44000,-44000
057448,致茂元富98購01  ,0,0,0,0,0,0,0,0,0,-44000,0,0,0,0,44000,-44000,-44000
058246,帆宣元大99購01  ,0,0,0,0,0,0,0,0,0,-44000,0,0,0,0,44000,-44000,-44000
057809,英業達元大98購01,0,0,0,0,0,0,0,0,0,-44000,0,0,0,2000,46000,-44000,-44000
056041,禾伸堂凱基98購03,0,0,0,0,0,0,0,0,0,-44000,0,0,0,0,44000,-44000,-44000
059266,緯創中信01購01  ,0,0,0,0,0,0,0,0,0,-44000,0,0,0,36000,80000,-44000,-44000
056876,群創凱基98購11  ,0,0,0,0,0,0,0,0,0,-44000,0,0,0,0,44000,-44000,-44000
6715,嘉基            ,17000,80000,-63000,0,0,0,0,0,0,19000,19000,0,19000,0,0,0,-44000
9907,統一實          ,262000,306000,-44000,0,0,0,0,0,0,0,0,0,0,0,0,0,-44000
06189P,華新科永豐97售03,0,0,0,0,0,0,0,0,0,-45000,0,0,0,0,45000,-45000,-45000
059333,滬深2X國票9A購03,0,0,0,0,0,0,0,0,0,-45000,0,0,0,1000,46000,-45000,-45000
07081P,南電群益9A售01  ,0,0,0,0,0,0,0,0,0,-45000,0,0,0,6000,51000,-45000,-45000
1762,中化生          ,108000,153000,-45000,0,0,0,0,0,0,0,0,0,0,0,0,0,-45000
2425,承啟            ,4932000,4972000,-40000,0,0,0,0,0,0,-5000,0,5000,-5000,0,0,0,-45000
057882,華通群益9A購03  ,0,0,0,0,0,0,0,0,0,-45000,0,0,0,47000,92000,-45000,-45000
058025,聯茂國泰99購01  ,0,0,0,0,0,0,0,0,0,-45000,0,0,0,1000,46000,-45000,-45000
053389,彩晶元大98購01  ,0,0,0,0,0,0,0,0,0,-45000,0,0,0,0,45000,-45000,-45000
00706L,元大S&P日圓正2  ,0,0,0,0,0,0,0,0,0,-45000,0,0,0,216000,261000,-45000,-45000
057616,聯電凱基99購01  ,0,0,0,0,0,0,0,0,0,-45000,0,0,0,49000,94000,-45000,-45000
054735,漢唐凱基98購01  ,0,0,0,0,0,0,0,0,0,-45000,0,0,0,59000,104000,-45000,-45000
054912,群光凱基97購01  ,0,0,0,0,0,0,0,0,0,-45000,0,0,0,429000,474000,-45000,-45000
058450,旺宏永豐99購01  ,0,0,0,0,0,0,0,0,0,-45000,0,0,0,138000,183000,-45000,-45000
055413,全新富邦98購01  ,0,0,0,0,0,0,0,0,0,-45000,0,0,0,0,45000,-45000,-45000
05546P,全新元大97售01  ,0,0,0,0,0,0,0,0,0,-45000,0,0,0,60000,105000,-45000,-45000
4137,麗豐-KY         ,103000,158000,-55000,0,0,0,0,0,0,9000,0,0,0,11000,2000,9000,-46000
06254P,臺股指群益97售07,0,0,0,0,0,0,0,0,0,-46000,0,0,0,0,46000,-46000,-46000
06691P,臺股指群益9C售05,0,0,0,0,0,0,0,0,0,-46000,0,0,0,0,46000,-46000,-46000
060114,緯穎元大99購10  ,0,0,0,0,0,0,0,0,0,-46000,0,0,0,46000,92000,-46000,-46000
006206,元大上證50      ,6000,6000,0,0,0,0,0,0,0,-46000,0,0,0,8000,54000,-46000,-46000
053721,國泰金凱基97購01,0,0,0,0,0,0,0,0,0,-46000,0,0,0,24000,70000,-46000,-46000
055512,聯詠兆豐97購01  ,0,0,0,0,0,0,0,0,0,-46000,0,0,0,637000,683000,-46000,-46000
058550,南亞科永豐99購01,0,0,0,0,0,0,0,0,0,-46000,0,0,0,35000,81000,-46000,-46000
055359,超眾凱基97購01  ,0,0,0,0,0,0,0,0,0,-46000,0,0,0,2000,48000,-46000,-46000
054863,億光群益97購01  ,0,0,0,0,0,0,0,0,0,-46000,0,0,0,0,46000,-46000,-46000
060203,緯穎元富9A購01  ,0,0,0,0,0,0,0,0,0,-47000,0,0,0,63000,110000,-47000,-47000
6139,亞翔            ,140000,187000,-47000,0,0,0,0,0,0,0,0,0,0,0,0,0,-47000
07133P,臺股指元大9A售27,0,0,0,0,0,0,0,0,0,-47000,0,0,0,10000,57000,-47000,-47000
058170,國巨凱基9A購06  ,0,0,0,0,0,0,0,0,0,-47000,0,0,0,128000,175000,-47000,-47000
052572,群創凱基99購01  ,0,0,0,0,0,0,0,0,0,-47000,0,0,0,60000,107000,-47000,-47000
03425B,臺股指元大9A熊01,0,0,0,0,0,0,0,0,0,-47000,0,0,0,0,47000,-47000,-47000
050424,鴻海凱基96購03  ,0,0,0,0,0,0,0,0,0,-47000,0,0,0,120000,167000,-47000,-47000
054076,義隆第一96購01  ,0,0,0,0,0,0,0,0,0,-47000,0,0,0,3000,50000,-47000,-47000
057419,奇力新凱基98購06,0,0,0,0,0,0,0,0,0,-47000,0,0,0,0,47000,-47000,-47000
057690,美律凱基99購03  ,0,0,0,0,0,0,0,0,0,-47000,0,0,0,0,47000,-47000,-47000
058480,新日興凱基9A購01,0,0,0,0,0,0,0,0,0,-47000,0,0,0,5000,52000,-47000,-47000
00709,富邦歐洲        ,0,136,-136,0,0,0,0,0,0,-47000,0,0,0,100000,147000,-47000,-47136
07365P,超眾元大99售07  ,0,0,0,0,0,0,0,0,0,-48000,0,0,0,40000,88000,-48000,-48000
059647,超眾凱基99購04  ,0,0,0,0,0,0,0,0,0,-48000,0,0,0,120000,168000,-48000,-48000
059500,鴻海元富99購11  ,0,0,0,0,0,0,0,0,0,-48000,0,0,0,300000,348000,-48000,-48000
050384,嘉澤國票94購02  ,0,0,0,0,0,0,0,0,0,-48000,0,0,0,20000,68000,-48000,-48000
051828,微星元大95購03  ,0,0,0,0,0,0,0,0,0,-48000,0,0,0,52000,100000,-48000,-48000
056911,緯穎元大99購01  ,0,0,0,0,0,0,0,0,0,-48000,0,0,0,2000,50000,-48000,-48000
059813,滬深2X凱基9B購01,0,0,0,0,0,0,0,0,0,-49000,0,0,0,1000,50000,-49000,-49000
060093,友達元大03購01  ,0,0,0,0,0,0,0,0,0,-49000,0,0,0,67000,116000,-49000,-49000
06780P,義隆元大98售02  ,0,0,0,0,0,0,0,0,0,-49000,0,0,0,296000,345000,-49000,-49000
07032P,聯發科統一9C售02,0,0,0,0,0,0,0,0,0,-49000,0,0,0,1000,50000,-49000,-49000
053482,矽力元大96購03  ,0,0,0,0,0,0,0,0,0,-49000,0,0,0,10000,59000,-49000,-49000
057524,旺宏元大99購04  ,0,0,0,0,0,0,0,0,0,-49000,0,0,0,64000,113000,-49000,-49000
054807,台化元大9A購02  ,0,0,0,0,0,0,0,0,0,-49000,0,0,0,11000,60000,-49000,-49000
056143,訊芯元大97購04  ,0,0,0,0,0,0,0,0,0,-49000,0,0,0,51000,100000,-49000,-49000
4414,如興            ,677000,726000,-49000,0,0,0,0,0,0,-1000,0,1000,-1000,0,0,0,-50000
4526,東台            ,170000,220000,-50000,0,0,0,0,0,0,0,0,0,0,0,0,0,-50000
4934,太極            ,190000,240000,-50000,0,0,0,0,0,0,0,0,0,0,0,0,0,-50000
06212P,華新科元大97售11,0,0,0,0,0,0,0,0,0,-50000,0,0,0,60000,110000,-50000,-50000
060129,祥碩永豐99購03  ,0,0,0,0,0,0,0,0,0,-50000,0,0,0,14000,64000,-50000,-50000
059893,台積電台新9A購02,0,0,0,0,0,0,0,0,0,-50000,0,0,0,23000,73000,-50000,-50000
059963,臺指反凱基99購01,0,0,0,0,0,0,0,0,0,-50000,0,0,0,0,50000,-50000,-50000
059531,華新科凱基9B購02,0,0,0,0,0,0,0,0,0,-50000,0,0,0,16000,66000,-50000,-50000
059619,台積電日盛9A購04,0,0,0,0,0,0,0,0,0,-50000,0,0,0,117000,167000,-50000,-50000
053453,新光金統一98購01,0,0,0,0,0,0,0,0,0,-50000,0,0,0,0,50000,-50000,-50000
057881,SP黃豆群益9A購01,0,0,0,0,0,0,0,0,0,-50000,0,0,0,0,50000,-50000,-50000
052483,超眾群益95購03  ,0,0,0,0,0,0,0,0,0,-50000,0,0,0,0,50000,-50000,-50000
053147,楠梓電元大98購01,0,0,0,0,0,0,0,0,0,-50000,0,0,0,0,50000,-50000,-50000
05432P,國巨元富95售07  ,0,0,0,0,0,0,0,0,0,-50000,0,0,0,0,50000,-50000,-50000
050362,深中小元大94購04,0,0,0,0,0,0,0,0,0,-50000,0,0,0,0,50000,-50000,-50000
054160,華泰凱基98購01  ,0,0,0,0,0,0,0,0,0,-50000,0,0,0,0,50000,-50000,-50000
04838P,宏達電元大95售02,0,0,0,0,0,0,0,0,0,-50000,0,0,0,0,50000,-50000,-50000
054025,鴻海凱基96購17  ,0,0,0,0,0,0,0,0,0,-50000,0,0,0,0,50000,-50000,-50000
047854,滬深2X國票96購02,0,0,0,0,0,0,0,0,0,-50000,0,0,0,0,50000,-50000,-50000
050968,超眾永豐95購01  ,0,0,0,0,0,0,0,0,0,-50000,0,0,0,0,50000,-50000,-50000
055945,上証2X元大97購04,0,0,0,0,0,0,0,0,0,-50000,0,0,0,0,50000,-50000,-50000
055604,訊芯元大98購02  ,0,0,0,0,0,0,0,0,0,-50000,0,0,0,0,50000,-50000,-50000
055162,新唐元大97購01  ,0,0,0,0,0,0,0,0,0,-50000,0,0,0,60000,110000,-50000,-50000
058726,宏達電富邦9A購01,0,0,0,0,0,0,0,0,0,-50000,0,0,0,0,50000,-50000,-50000
054906,神達康和97購01  ,0,0,0,0,0,0,0,0,0,-50000,0,0,0,0,50000,-50000,-50000
057353,玉晶光統一99購01,0,0,0,0,0,0,0,0,0,-50000,0,0,0,0,50000,-50000,-50000
055336,茂林兆豐98購01  ,0,0,0,0,0,0,0,0,0,-50000,0,0,0,0,50000,-50000,-50000
056881,台灣50康和9A購01,0,0,0,0,0,0,0,0,0,-50000,0,0,0,0,50000,-50000,-50000
058535,玉晶光統一9A購06,0,0,0,0,0,0,0,0,0,-50000,0,0,0,50000,100000,-50000,-50000
057662,上銀元大9A購01  ,0,0,0,0,0,0,0,0,0,-50000,0,0,0,0,50000,-50000,-50000
056682,鴻海統一98購10  ,0,0,0,0,0,0,0,0,0,-50000,0,0,0,23000,73000,-50000,-50000
056613,旺宏永豐98購01  ,0,0,0,0,0,0,0,0,0,-50000,0,0,0,31000,81000,-50000,-50000
058852,貿聯群益99購04  ,0,0,0,0,0,0,0,0,0,-50000,0,0,0,0,50000,-50000,-50000
056763,國巨元大99購02  ,0,0,0,0,0,0,0,0,0,-50000,0,0,0,5000,55000,-50000,-50000
055713,國巨元大98購09  ,0,0,0,0,0,0,0,0,0,-50000,0,0,0,68000,118000,-50000,-50000
059325,超眾元大99購05  ,0,0,0,0,0,0,0,0,0,-51000,0,0,0,1000,52000,-51000,-51000
060227,和大元大9A購01  ,0,0,0,0,0,0,0,0,0,-51000,0,0,0,0,51000,-51000,-51000
060361,南亞科元富9A購03,0,0,0,0,0,0,0,0,0,-51000,0,0,0,0,51000,-51000,-51000
06492P,上銀永豐98售01  ,0,0,0,0,0,0,0,0,0,-51000,0,0,0,0,51000,-51000,-51000
06847P,奇力新元大98售05,0,0,0,0,0,0,0,0,0,-51000,0,0,0,0,51000,-51000,-51000
054045,奇力新元大97購03,0,0,0,0,0,0,0,0,0,-51000,0,0,0,10000,61000,-51000,-51000
053422,可成永豐96購01  ,0,0,0,0,0,0,0,0,0,-51000,0,0,0,0,51000,-51000,-51000
056963,建準永豐98購01  ,0,0,0,0,0,0,0,0,0,-51000,0,0,0,0,51000,-51000,-51000
057321,台泥群益98購01  ,0,0,0,0,0,0,0,0,0,-51000,0,0,0,0,51000,-51000,-51000
057805,華通元大98購06  ,0,0,0,0,0,0,0,0,0,-51000,0,0,0,98000,149000,-51000,-51000
054892,彩晶統一99購01  ,0,0,0,0,0,0,0,0,0,-51000,0,0,0,0,51000,-51000,-51000
054930,群電凱基98購01  ,0,0,0,0,0,0,0,0,0,-51000,0,0,0,4000,55000,-51000,-51000
055911,可成凱基98購02  ,0,0,0,0,0,0,0,0,0,-51000,0,0,0,4000,55000,-51000,-51000
060198,祥碩元富9A購02  ,0,0,0,0,0,0,0,0,0,-52000,0,0,0,0,52000,-52000,-52000
059473,T50反1群益99購03,0,0,0,0,0,0,0,0,0,-52000,0,0,0,51000,103000,-52000,-52000
059694,創意永豐99購03  ,0,0,0,0,0,0,0,0,0,-52000,0,0,0,177000,229000,-52000,-52000
5531,鄉林            ,149000,201000,-52000,0,0,0,0,0,0,0,0,0,0,0,0,0,-52000
1503,士電            ,21000,73000,-52000,0,0,0,0,0,0,0,0,0,0,0,0,0,-52000
053871,臻鼎元大96購03  ,0,0,0,0,0,0,0,0,0,-52000,0,0,0,0,52000,-52000,-52000
058015,旺宏凱基99購02  ,0,0,0,0,0,0,0,0,0,-52000,0,0,0,78000,130000,-52000,-52000
03603P,群創凱基98售04  ,0,0,0,0,0,0,0,0,0,-52000,0,0,0,88000,140000,-52000,-52000
046384,群創凱基98購02  ,0,0,0,0,0,0,0,0,0,-52000,0,0,0,80000,132000,-52000,-52000
058124,玉晶光國票9A購01,0,0,0,0,0,0,0,0,0,-52000,0,0,0,167000,219000,-52000,-52000
057211,鴻海群益98購05  ,0,0,0,0,0,0,0,0,0,-52000,0,0,0,104000,156000,-52000,-52000
056748,T50反1兆豐99購01,0,0,0,0,0,0,0,0,0,-52000,0,0,0,0,52000,-52000,-52000
058915,SGBR2X元富99購01,0,0,0,0,0,0,0,0,0,-52000,0,0,0,0,52000,-52000,-52000
058981,國巨凱基99購10  ,0,0,0,0,0,0,0,0,0,-52000,0,0,0,6000,58000,-52000,-52000
2030,彰源            ,49000,101000,-52000,0,0,0,0,0,0,-1000,0,1000,-1000,0,0,0,-53000
07424P,大立光元大9B售01,0,0,0,0,0,0,0,0,0,-53000,0,0,0,10000,63000,-53000,-53000
6142,友勁            ,8000,61000,-53000,0,0,0,0,0,0,0,0,0,0,0,0,0,-53000
060212,華航康和9A購01  ,0,0,0,0,0,0,0,0,0,-53000,0,0,0,2000,55000,-53000,-53000
06023P,超眾國票96售03  ,0,0,0,0,0,0,0,0,0,-53000,0,0,0,159000,212000,-53000,-53000
058050,台郡元大99購05  ,0,0,0,0,0,0,0,0,0,-53000,0,0,0,60000,113000,-53000,-53000
058223,世芯統一9B購01  ,0,0,0,0,0,0,0,0,0,-53000,0,0,0,10000,63000,-53000,-53000
058996,台達電元大99購02,0,0,0,0,0,0,0,0,0,-53000,0,0,0,183000,236000,-53000,-53000
054609,正崴永豐97購01  ,0,0,0,0,0,0,0,0,0,-53000,0,0,0,35000,88000,-53000,-53000
057121,立積康和98購01  ,0,0,0,0,0,0,0,0,0,-53000,0,0,0,0,53000,-53000,-53000
055233,康友國票98購01  ,0,0,0,0,0,0,0,0,0,-53000,0,0,0,0,53000,-53000,-53000
054766,智原國票98購01  ,0,0,0,0,0,0,0,0,0,-53000,0,0,0,0,53000,-53000,-53000
059924,世紀鋼元大99購06,0,0,0,0,0,0,0,0,0,-54000,0,0,0,7000,61000,-54000,-54000
4108,懷特            ,3000,57000,-54000,0,0,0,0,0,0,0,0,0,0,0,0,0,-54000
057120,茂林康和98購01  ,0,0,0,0,0,0,0,0,0,-54000,0,0,0,153000,207000,-54000,-54000
059152,臺股指國票99購15,0,0,0,0,0,0,0,0,0,-54000,0,0,0,86000,140000,-54000,-54000
05994P,奇鋐元大96售02  ,0,0,0,0,0,0,0,0,0,-55000,0,0,0,5000,60000,-55000,-55000
059552,台灣50凱基99購04,0,0,0,0,0,0,0,0,0,-55000,0,0,0,0,55000,-55000,-55000
053956,旺宏永豐96購04  ,0,0,0,0,0,0,0,0,0,-55000,0,0,0,0,55000,-55000,-55000
053635,技嘉永豐96購01  ,0,0,0,0,0,0,0,0,0,-55000,0,0,0,48000,103000,-55000,-55000
053158,茂林元大96購01  ,0,0,0,0,0,0,0,0,0,-55000,0,0,0,5000,60000,-55000,-55000
050940,嘉澤國票95購01  ,0,0,0,0,0,0,0,0,0,-55000,0,0,0,0,55000,-55000,-55000
050588,矽創國票95購01  ,0,0,0,0,0,0,0,0,0,-55000,0,0,0,0,55000,-55000,-55000
059199,欣興永豐99購02  ,0,0,0,0,0,0,0,0,0,-55000,0,0,0,6000,61000,-55000,-55000
059077,FBVIX元大99購05 ,0,0,0,0,0,0,0,0,0,-55000,0,0,0,0,55000,-55000,-55000
058459,南電永豐99購01  ,0,0,0,0,0,0,0,0,0,-55000,0,0,0,7000,62000,-55000,-55000
056511,超眾永豐98購01  ,0,0,0,0,0,0,0,0,0,-55000,0,0,0,0,55000,-55000,-55000
058558,鴻海日盛9A購02  ,0,0,0,0,0,0,0,0,0,-55000,0,0,0,185000,240000,-55000,-55000
057479,致茂元大98購03  ,0,0,0,0,0,0,0,0,0,-55000,0,0,0,0,55000,-55000,-55000
055510,GIS元大97購03   ,0,0,0,0,0,0,0,0,0,-55000,0,0,0,25000,80000,-55000,-55000
058282,聯茂中信99購01  ,0,0,0,0,0,0,0,0,0,-55000,0,0,0,249000,304000,-55000,-55000
059501,可成元富99購01  ,0,0,0,0,0,0,0,0,0,-56000,0,0,0,208000,264000,-56000,-56000
2702,華園            ,8000,64000,-56000,0,0,0,0,0,0,0,0,0,0,0,0,0,-56000
1460,宏遠            ,20000,76000,-56000,0,0,0,0,0,0,0,0,0,0,0,0,0,-56000
053234,奇鋐永豐96購01  ,0,0,0,0,0,0,0,0,0,-56000,0,0,0,0,56000,-56000,-56000
058194,勤誠永豐99購01  ,0,0,0,0,0,0,0,0,0,-56000,0,0,0,48000,104000,-56000,-56000
05609P,國泰金凱基96售01,0,0,0,0,0,0,0,0,0,-56000,0,0,0,10000,66000,-56000,-56000
057721,華擎元富98購02  ,0,0,0,0,0,0,0,0,0,-56000,0,0,0,29000,85000,-56000,-56000
8114,振樺電          ,13000,69000,-56000,0,0,0,0,0,0,0,0,0,0,0,0,0,-56000
07392P,台積電國泰02售01,0,0,0,0,0,0,0,0,0,-57000,0,0,0,88000,145000,-57000,-57000
07234P,台灣50元大9B售04,0,0,0,0,0,0,0,0,0,-57000,0,0,0,3000,60000,-57000,-57000
060150,華通富邦9B購01  ,0,0,0,0,0,0,0,0,0,-57000,0,0,0,15000,72000,-57000,-57000
060111,臻鼎元大99購04  ,0,0,0,0,0,0,0,0,0,-57000,0,0,0,20000,77000,-57000,-57000
058201,華通凱基9A購01  ,0,0,0,0,0,0,0,0,0,-57000,0,0,0,68000,125000,-57000,-57000
056617,美律永豐98購01  ,0,0,0,0,0,0,0,0,0,-57000,0,0,0,38000,95000,-57000,-57000
056170,鴻海元富97購09  ,0,0,0,0,0,0,0,0,0,-57000,0,0,0,50000,107000,-57000,-57000
06242P,大立光元富9A售02,0,0,0,0,0,0,0,0,0,-58000,0,0,0,0,58000,-58000,-58000
059974,臺指反元大9C購05,0,0,0,0,0,0,0,0,0,-58000,0,0,0,0,58000,-58000,-58000
047694,SP黃豆國票9B購01,0,0,0,0,0,0,0,0,0,-58000,0,0,0,0,58000,-58000,-58000
056641,華通凱基98購03  ,0,0,0,0,0,0,0,0,0,-58000,0,0,0,16000,74000,-58000,-58000
058790,楠梓電元大99購03,0,0,0,0,0,0,0,0,0,-58000,0,0,0,47000,105000,-58000,-58000
059923,緯穎元大99購09  ,0,0,0,0,0,0,0,0,0,-59000,0,0,0,37000,96000,-59000,-59000
059685,T50正2永豐99購02,0,0,0,0,0,0,0,0,0,-59000,0,0,0,61000,120000,-59000,-59000
059814,SP黃豆凱基9A購02,0,0,0,0,0,0,0,0,0,-59000,0,0,0,100000,159000,-59000,-59000
059410,滬深2X國票9A購04,0,0,0,0,0,0,0,0,0,-59000,0,0,0,20000,79000,-59000,-59000
060301,國巨富邦9C購02  ,0,0,0,0,0,0,0,0,0,-59000,0,0,0,0,59000,-59000,-59000
07190P,臺股指富邦9C售02,0,0,0,0,0,0,0,0,0,-59000,0,0,0,11000,70000,-59000,-59000
1532,勤美            ,58000,117000,-59000,0,0,0,0,0,0,0,0,0,0,0,0,0,-59000
057972,群創富邦9C購01  ,0,0,0,0,0,0,0,0,0,-59000,0,0,0,182000,241000,-59000,-59000
059168,奇力新凱基99購05,0,0,0,0,0,0,0,0,0,-59000,0,0,0,58000,117000,-59000,-59000
056124,華通國票98購02  ,0,0,0,0,0,0,0,0,0,-59000,0,0,0,35000,94000,-59000,-59000
1474,弘裕            ,37000,97000,-60000,0,0,0,0,0,0,0,0,0,0,0,0,0,-60000
1701,中化            ,147000,208000,-61000,0,0,0,0,0,0,1000,1000,0,1000,0,0,0,-60000
060355,元金2X元富9C購01,0,0,0,0,0,0,0,0,0,-60000,0,0,0,0,60000,-60000,-60000
060276,S&P反1元大9A購03,0,0,0,0,0,0,0,0,0,-60000,0,0,0,0,60000,-60000,-60000
060083,和大元大99購02  ,0,0,0,0,0,0,0,0,0,-60000,0,0,0,60000,120000,-60000,-60000
06163P,聯詠群益97售01  ,0,0,0,0,0,0,0,0,0,-60000,0,0,0,0,60000,-60000,-60000
05938P,旺宏凱基96售07  ,0,0,0,0,0,0,0,0,0,-60000,0,0,0,16000,76000,-60000,-60000
059538,健策凱基99購03  ,0,0,0,0,0,0,0,0,0,-60000,0,0,0,10000,70000,-60000,-60000
053502,智伸科兆豐97購01,0,0,0,0,0,0,0,0,0,-60000,0,0,0,170000,230000,-60000,-60000
05089P,亞德客元大95售01,0,0,0,0,0,0,0,0,0,-60000,0,0,0,2000,62000,-60000,-60000
055912,宏達電凱基98購03,0,0,0,0,0,0,0,0,0,-60000,0,0,0,2000,62000,-60000,-60000
054921,文曄凱基97購01  ,0,0,0,0,0,0,0,0,0,-60000,0,0,0,0,60000,-60000,-60000
055052,凱美永豐97購01  ,0,0,0,0,0,0,0,0,0,-60000,0,0,0,0,60000,-60000,-60000
055047,南港永豐97購01  ,0,0,0,0,0,0,0,0,0,-60000,0,0,0,0,60000,-60000,-60000
05901P,臺股指凱基9C售01,0,0,0,0,0,0,0,0,0,-60000,0,0,0,0,60000,-60000,-60000
059351,台虹凱基99購01  ,0,0,0,0,0,0,0,0,0,-61000,0,0,0,0,61000,-61000,-61000
06551P,貿聯元大98售05  ,0,0,0,0,0,0,0,0,0,-61000,0,0,0,6000,67000,-61000,-61000
060094,聯發科元大99購41,0,0,0,0,0,0,0,0,0,-61000,0,0,0,45000,106000,-61000,-61000
060248,日月光元大9A購01,0,0,0,0,0,0,0,0,0,-61000,0,0,0,0,61000,-61000,-61000
2355,敬鵬            ,778000,851000,-73000,0,0,0,0,0,0,12000,2000,0,2000,10000,0,10000,-61000
4540,全球傳動        ,55000,116000,-61000,0,0,0,0,0,0,0,0,0,0,0,0,0,-61000
4555,氣立            ,2000,63000,-61000,0,0,0,0,0,0,0,0,0,0,0,0,0,-61000
058315,TPK富邦9C購01   ,0,0,0,0,0,0,0,0,0,-61000,0,0,0,399000,460000,-61000,-61000
053428,中磊永豐96購02  ,0,0,0,0,0,0,0,0,0,-61000,0,0,0,0,61000,-61000,-61000
059274,國巨元大99購22  ,0,0,0,0,0,0,0,0,0,-61000,0,0,0,62000,123000,-61000,-61000
055301,台虹元大97購01  ,0,0,0,0,0,0,0,0,0,-61000,0,0,0,8000,69000,-61000,-61000
3031,佰鴻            ,54000,116000,-62000,0,0,0,0,0,0,0,0,0,0,0,0,0,-62000
059429,台積電元大99購35,0,0,0,0,0,0,0,0,0,-62000,0,0,0,33000,95000,-62000,-62000
054416,禾伸堂元大97購01,0,0,0,0,0,0,0,0,0,-62000,0,0,0,54000,116000,-62000,-62000
046630,京元電元富95購03,0,0,0,0,0,0,0,0,0,-62000,0,0,0,104000,166000,-62000,-62000
04763P,臺股指凱基96售05,0,0,0,0,0,0,0,0,0,-62000,0,0,0,35000,97000,-62000,-62000
050482,台郡國票94購04  ,0,0,0,0,0,0,0,0,0,-62000,0,0,0,0,62000,-62000,-62000
054042,華泰元大96購01  ,0,0,0,0,0,0,0,0,0,-62000,0,0,0,0,62000,-62000,-62000
054170,泰鼎凱基98購01  ,0,0,0,0,0,0,0,0,0,-62000,0,0,0,1000,63000,-62000,-62000
056581,超眾元大99購01  ,0,0,0,0,0,0,0,0,0,-62000,0,0,0,68000,130000,-62000,-62000
060117,國巨國泰9B購04  ,0,0,0,0,0,0,0,0,0,-63000,0,0,0,111000,174000,-63000,-63000
06050P,玉晶光國票98售01,0,0,0,0,0,0,0,0,0,-63000,0,0,0,0,63000,-63000,-63000
052020,聯茂永豐95購02  ,0,0,0,0,0,0,0,0,0,-63000,0,0,0,0,63000,-63000,-63000
058977,SGBR2X凱基03購01,0,0,0,0,0,0,0,0,0,-63000,0,0,0,1000,64000,-63000,-63000
05976P,國巨凱基96售14  ,0,0,0,0,0,0,0,0,0,-64000,0,0,0,54000,118000,-64000,-64000
1732,毛寶            ,189000,250000,-61000,0,0,0,0,0,0,-3000,1000,4000,-3000,0,0,0,-64000
054358,矽創兆豐96購01  ,0,0,0,0,0,0,0,0,0,-64000,0,0,0,268000,332000,-64000,-64000
052254,康友永豐95購03  ,0,0,0,0,0,0,0,0,0,-64000,0,0,0,0,64000,-64000,-64000
00752,中信中國50      ,7000,7000,0,0,0,0,0,0,0,-64000,0,0,0,476000,540000,-64000,-64000
055118,嘉聯益凱基98購02,0,0,0,0,0,0,0,0,0,-64000,0,0,0,1000,65000,-64000,-64000
058686,祥碩凱基99購03  ,0,0,0,0,0,0,0,0,0,-64000,0,0,0,6000,70000,-64000,-64000
058095,昇陽半元大98購03,0,0,0,0,0,0,0,0,0,-64000,0,0,0,20000,84000,-64000,-64000
3702A,大聯大甲特      ,15000,0,15000,0,0,0,0,0,0,-80000,0,80000,-80000,0,0,0,-65000
020008,元大特股高息N   ,0,0,0,0,0,0,0,0,0,-65000,0,0,0,1000,66000,-65000,-65000
053723,奇鋐凱基98購01  ,0,0,0,0,0,0,0,0,0,-65000,0,0,0,20000,85000,-65000,-65000
055458,燿華永豐98購01  ,0,0,0,0,0,0,0,0,0,-65000,0,0,0,15000,80000,-65000,-65000
055648,可成元富97購01  ,0,0,0,0,0,0,0,0,0,-65000,0,0,0,94000,159000,-65000,-65000
059129,麗豐中信99購01  ,0,0,0,0,0,0,0,0,0,-65000,0,0,0,3000,68000,-65000,-65000
058822,樺漢國泰9B購01  ,0,0,0,0,0,0,0,0,0,-65000,0,0,0,30000,95000,-65000,-65000
056281,深中小永豐97購01,0,0,0,0,0,0,0,0,0,-65000,0,0,0,20000,85000,-65000,-65000
06848P,聯詠元大98售04  ,0,0,0,0,0,0,0,0,0,-66000,0,0,0,0,66000,-66000,-66000
053292,美律中信98購01  ,0,0,0,0,0,0,0,0,0,-66000,0,0,0,38000,104000,-66000,-66000
053950,緯穎富邦97購02  ,0,0,0,0,0,0,0,0,0,-66000,0,0,0,43000,109000,-66000,-66000
054027,欣興凱基96購04  ,0,0,0,0,0,0,0,0,0,-66000,0,0,0,0,66000,-66000,-66000
059063,康控凱基99購04  ,0,0,0,0,0,0,0,0,0,-66000,0,0,0,32000,98000,-66000,-66000
056330,玉晶光國票99購03,0,0,0,0,0,0,0,0,0,-66000,0,0,0,108000,174000,-66000,-66000
060109,茂林元大99購05  ,0,0,0,0,0,0,0,0,0,-67000,0,0,0,19000,86000,-67000,-67000
060253,昇陽半元大9C購01,0,0,0,0,0,0,0,0,0,-67000,0,0,0,0,67000,-67000,-67000
059424,SGBR2X元大9A購01,0,0,0,0,0,0,0,0,0,-67000,0,0,0,68000,135000,-67000,-67000
059337,台灣50凱基9C購05,0,0,0,0,0,0,0,0,0,-67000,0,0,0,0,67000,-67000,-67000
6277,宏正            ,7000,74000,-67000,0,0,0,0,0,0,0,0,0,0,0,0,0,-67000
1730,花仙子          ,69000,136000,-67000,0,0,0,0,0,0,0,0,0,0,0,0,0,-67000
050794,大立光富邦96購04,0,0,0,0,0,0,0,0,0,-67000,0,0,0,0,67000,-67000,-67000
052160,美律永豐95購03  ,0,0,0,0,0,0,0,0,0,-67000,0,0,0,0,67000,-67000,-67000
058605,華邦電元大99購04,0,0,0,0,0,0,0,0,0,-67000,0,0,0,34000,101000,-67000,-67000
057606,健策統一98購03  ,0,0,0,0,0,0,0,0,0,-67000,0,0,0,182000,249000,-67000,-67000
059345,禾伸堂凱基99購03,0,0,0,0,0,0,0,0,0,-68000,0,0,0,10000,78000,-68000,-68000
059964,元金2X凱基99購02,0,0,0,0,0,0,0,0,0,-68000,0,0,0,1000,69000,-68000,-68000
06355P,聯茂永豐97售02  ,0,0,0,0,0,0,0,0,0,-68000,0,0,0,20000,88000,-68000,-68000
053374,台達電元大96購03,0,0,0,0,0,0,0,0,0,-68000,0,0,0,0,68000,-68000,-68000
0052,富邦科技        ,0,0,0,0,0,0,47000,0,47000,-115000,0,0,0,104000,219000,-115000,-68000
048187,臺指反元大96購04,0,0,0,0,0,0,0,0,0,-68000,0,0,0,22000,90000,-68000,-68000
056655,旺宏元大99購02  ,0,0,0,0,0,0,0,0,0,-68000,0,0,0,20000,88000,-68000,-68000
058958,台表科國票9A購03,0,0,0,0,0,0,0,0,0,-68000,0,0,0,90000,158000,-68000,-68000
054785,建準群益98購01  ,0,0,0,0,0,0,0,0,0,-68000,0,0,0,0,68000,-68000,-68000
054957,興富發元大97購01,0,0,0,0,0,0,0,0,0,-68000,0,0,0,23000,91000,-68000,-68000
056517,茂林兆豐99購01  ,0,0,0,0,0,0,0,0,0,-68000,0,0,0,0,68000,-68000,-68000
056380,麗豐元富98購01  ,0,0,0,0,0,0,0,0,0,-68000,0,0,0,50000,118000,-68000,-68000
060043,全新群益9B購02  ,0,0,0,0,0,0,0,0,0,-69000,0,0,0,75000,144000,-69000,-69000
052858,華通凱基97購02  ,0,0,0,0,0,0,0,0,0,-69000,0,0,0,0,69000,-69000,-69000
051918,聯茂元大95購01  ,0,0,0,0,0,0,0,0,0,-69000,0,0,0,171000,240000,-69000,-69000
057787,TPK國票99購01   ,0,0,0,0,0,0,0,0,0,-69000,0,0,0,0,69000,-69000,-69000
055357,欣興凱基97購04  ,0,0,0,0,0,0,0,0,0,-69000,0,0,0,81000,150000,-69000,-69000
058266,宏達電永豐99購01,0,0,0,0,0,0,0,0,0,-69000,0,0,0,0,69000,-69000,-69000
6558,興能高          ,143000,212200,-69200,0,0,0,0,0,0,0,0,0,0,0,0,0,-69200
07354P,臺股指國票99售22,0,0,0,0,0,0,0,0,0,-70000,0,0,0,60000,130000,-70000,-70000
060050,鴻海凱基9B購01  ,0,0,0,0,0,0,0,0,0,-70000,0,0,0,86000,156000,-70000,-70000
060305,得力永豐9A購01  ,0,0,0,0,0,0,0,0,0,-70000,0,0,0,0,70000,-70000,-70000
06058P,玉晶光凱基97售04,0,0,0,0,0,0,0,0,0,-70000,0,0,0,10000,80000,-70000,-70000
059872,華新科凱基01購01,0,0,0,0,0,0,0,0,0,-70000,0,0,0,43000,113000,-70000,-70000
053931,楠梓電統一96購01,0,0,0,0,0,0,0,0,0,-70000,0,0,0,0,70000,-70000,-70000
057863,美律凱基9A購01  ,0,0,0,0,0,0,0,0,0,-70000,0,0,0,10000,80000,-70000,-70000
048001,中工元大96購01  ,0,0,0,0,0,0,0,0,0,-70000,0,0,0,0,70000,-70000,-70000
056328,訊芯兆豐98購01  ,0,0,0,0,0,0,0,0,0,-70000,0,0,0,0,70000,-70000,-70000
055659,百和元富97購01  ,0,0,0,0,0,0,0,0,0,-70000,0,0,0,0,70000,-70000,-70000
057577,廣宇中信9A購01  ,0,0,0,0,0,0,0,0,0,-70000,0,0,0,8000,78000,-70000,-70000
057157,群創富邦98購02  ,0,0,0,0,0,0,0,0,0,-70000,0,0,0,0,70000,-70000,-70000
057324,億光群益98購01  ,0,0,0,0,0,0,0,0,0,-70000,0,0,0,0,70000,-70000,-70000
6452,康友-KY         ,241000,359609,-118609,0,0,0,0,0,0,48000,0,0,0,49000,1000,48000,-70609
059911,國巨元大99購27  ,0,0,0,0,0,0,0,0,0,-71000,0,0,0,26000,97000,-71000,-71000
059347,京鼎凱基99購02  ,0,0,0,0,0,0,0,0,0,-71000,0,0,0,331000,402000,-71000,-71000
059510,華新科永豐99購07,0,0,0,0,0,0,0,0,0,-71000,0,0,0,137000,208000,-71000,-71000
060000,國巨台新99購01  ,0,0,0,0,0,0,0,0,0,-71000,0,0,0,57000,128000,-71000,-71000
057920,奇力新凱基98購08,0,0,0,0,0,0,0,0,0,-71000,0,0,0,48000,119000,-71000,-71000
053151,華新科元大96購04,0,0,0,0,0,0,0,0,0,-71000,0,0,0,10000,81000,-71000,-71000
059055,旺宏凱基9B購02  ,0,0,0,0,0,0,0,0,0,-71000,0,0,0,22000,93000,-71000,-71000
059179,祥碩元富99購01  ,0,0,0,0,0,0,0,0,0,-71000,0,0,0,0,71000,-71000,-71000
058728,SP黃豆永豐99購01,0,0,0,0,0,0,0,0,0,-71000,0,0,0,0,71000,-71000,-71000
059821,美律凱基99購08  ,0,0,0,0,0,0,0,0,0,-72000,0,0,0,128000,200000,-72000,-72000
1444,力麗            ,395000,466000,-71000,0,0,0,0,0,0,-1000,0,1000,-1000,0,0,0,-72000
07459P,緯穎元大9A售01  ,0,0,0,0,0,0,0,0,0,-72000,0,0,0,0,72000,-72000,-72000
08818P,台灣50凱基01售18,0,0,0,0,0,0,0,0,0,-72000,0,0,0,0,72000,-72000,-72000
050690,台達電凱基96購01,0,0,0,0,0,0,0,0,0,-72000,0,0,0,36000,108000,-72000,-72000
058610,欣興元大99購05  ,0,0,0,0,0,0,0,0,0,-72000,0,0,0,15000,87000,-72000,-72000
058645,康控富邦01購01  ,0,0,0,0,0,0,0,0,0,-72000,0,0,0,0,72000,-72000,-72000
058927,勤誠元富99購02  ,0,0,0,0,0,0,0,0,0,-72000,0,0,0,299000,371000,-72000,-72000
057707,臺股指群益98購07,0,0,0,0,0,0,0,0,0,-72000,0,0,0,89000,161000,-72000,-72000
059723,美律元大9A購02  ,0,0,0,0,0,0,0,0,0,-73000,0,0,0,109000,182000,-73000,-73000
057499,奇鋐群益98購01  ,0,0,0,0,0,0,0,0,0,-73000,0,0,0,28000,101000,-73000,-73000
9940,信義            ,80000,150000,-70000,0,0,0,0,0,0,-3000,0,3000,-3000,0,0,0,-73000
059368,T50正2元富99購02,0,0,0,0,0,0,0,0,0,-74000,0,0,0,13000,87000,-74000,-74000
059999,緯穎元富99購01  ,0,0,0,0,0,0,0,0,0,-74000,0,0,0,52000,126000,-74000,-74000
060124,奇力新永豐99購03,0,0,0,0,0,0,0,0,0,-74000,0,0,0,0,74000,-74000,-74000
06496P,台灣50日盛98售01,0,0,0,0,0,0,0,0,0,-74000,0,0,0,2000,76000,-74000,-74000
00686R,群益臺灣加權反1 ,0,0,0,0,0,0,0,0,0,-74000,0,0,0,336000,410000,-74000,-74000
052657,友達元富96購01  ,0,0,0,0,0,0,0,0,0,-74000,0,0,0,0,74000,-74000,-74000
051402,玉晶光永豐95購04,0,0,0,0,0,0,0,0,0,-74000,0,0,0,0,74000,-74000,-74000
057481,技嘉元大98購04  ,0,0,0,0,0,0,0,0,0,-74000,0,0,0,1000,75000,-74000,-74000
055597,禾伸堂元大98購02,0,0,0,0,0,0,0,0,0,-74000,0,0,0,40000,114000,-74000,-74000
056231,嘉聯益凱基97購02,0,0,0,0,0,0,0,0,0,-74000,0,0,0,105000,179000,-74000,-74000
059095,訊芯元大99購01  ,0,0,0,0,0,0,0,0,0,-74000,0,0,0,132000,206000,-74000,-74000
060029,嘉晶永豐99購03  ,0,0,0,0,0,0,0,0,0,-75000,0,0,0,0,75000,-75000,-75000
059827,晶技凱基99購03  ,0,0,0,0,0,0,0,0,0,-75000,0,0,0,340000,415000,-75000,-75000
053536,明泰永豐96購01  ,0,0,0,0,0,0,0,0,0,-75000,0,0,0,15000,90000,-75000,-75000
058972,新日興永豐9A購01,0,0,0,0,0,0,0,0,0,-75000,0,0,0,57000,132000,-75000,-75000
058973,麗豐永豐99購01  ,0,0,0,0,0,0,0,0,0,-75000,0,0,0,13000,88000,-75000,-75000
057203,麗豐元富98購02  ,0,0,0,0,0,0,0,0,0,-75000,0,0,0,95000,170000,-75000,-75000
057230,建準凱基98購02  ,0,0,0,0,0,0,0,0,0,-75000,0,0,0,40000,115000,-75000,-75000
058573,鴻海群益9A購02  ,0,0,0,0,0,0,0,0,0,-75000,0,0,0,26000,101000,-75000,-75000
6197,佳必琪          ,92000,168000,-76000,0,0,0,0,0,0,0,0,0,0,0,0,0,-76000
3518,柏騰            ,33000,109000,-76000,0,0,0,0,0,0,0,0,0,0,0,0,0,-76000
054221,華新科統一96購05,0,0,0,0,0,0,0,0,0,-76000,0,0,0,0,76000,-76000,-76000
053361,友達元富99購01  ,0,0,0,0,0,0,0,0,0,-76000,0,0,0,477000,553000,-76000,-76000
052887,華通中信96購01  ,0,0,0,0,0,0,0,0,0,-76000,0,0,0,0,76000,-76000,-76000
055380,智易元大98購02  ,0,0,0,0,0,0,0,0,0,-76000,0,0,0,21000,97000,-76000,-76000
055618,麗豐國票98購01  ,0,0,0,0,0,0,0,0,0,-76000,0,0,0,0,76000,-76000,-76000
057287,彩晶元大9C購03  ,0,0,0,0,0,0,0,0,0,-76000,0,0,0,11000,87000,-76000,-76000
07416P,台積電元大99售53,0,0,0,0,0,0,0,0,0,-77000,0,0,0,10000,87000,-77000,-77000
07172P,臺股指國票99售09,0,0,0,0,0,0,0,0,0,-77000,0,0,0,30000,107000,-77000,-77000
059962,S&P正2凱基99購02,0,0,0,0,0,0,0,0,0,-77000,0,0,0,0,77000,-77000,-77000
060200,同欣電元富9A購01,0,0,0,0,0,0,0,0,0,-77000,0,0,0,50000,127000,-77000,-77000
053910,嘉聯益凱基98購01,0,0,0,0,0,0,0,0,0,-77000,0,0,0,20000,97000,-77000,-77000
058175,旺宏凱基99購03  ,0,0,0,0,0,0,0,0,0,-77000,0,0,0,1000,78000,-77000,-77000
058521,日月光元大99購01,0,0,0,0,0,0,0,0,0,-77000,0,0,0,9000,86000,-77000,-77000
057531,禾伸堂元大99購04,0,0,0,0,0,0,0,0,0,-77000,0,0,0,40000,117000,-77000,-77000
059247,可成凱基99購05  ,0,0,0,0,0,0,0,0,0,-77000,0,0,0,72000,149000,-77000,-77000
055716,致茂元大97購01  ,0,0,0,0,0,0,0,0,0,-77000,0,0,0,0,77000,-77000,-77000
058826,台積電永豐99購02,0,0,0,0,0,0,0,0,0,-77000,0,0,0,0,77000,-77000,-77000
058662,禾伸堂兆豐99購01,0,0,0,0,0,0,0,0,0,-77000,0,0,0,0,77000,-77000,-77000
059515,牧德永豐99購01  ,0,0,0,0,0,0,0,0,0,-78000,0,0,0,70000,148000,-78000,-78000
1464,得力            ,177000,269000,-92000,0,0,0,0,0,0,14000,0,0,0,14000,0,14000,-78000
051483,玉晶光凱基96購02,0,0,0,0,0,0,0,0,0,-78000,0,0,0,309000,387000,-78000,-78000
057243,樺漢凱基99購01  ,0,0,0,0,0,0,0,0,0,-78000,0,0,0,50000,128000,-78000,-78000
3023,信邦            ,608000,775000,-167000,0,0,0,22000,16000,6000,82000,116000,20000,96000,0,14000,-14000,-79000
059097,世紀鋼元大99購05,0,0,0,0,0,0,0,0,0,-79000,0,0,0,2000,81000,-79000,-79000
058074,欣興凱基99購01  ,0,0,0,0,0,0,0,0,0,-79000,0,0,0,60000,139000,-79000,-79000
054872,瀚宇博群益98購01,0,0,0,0,0,0,0,0,0,-79000,0,0,0,40000,119000,-79000,-79000
07164P,臺股指群益99售15,0,0,0,0,0,0,0,0,0,-80000,0,0,0,5000,85000,-80000,-80000
059674,玉山金元富99購02,0,0,0,0,0,0,0,0,0,-80000,0,0,0,0,80000,-80000,-80000
059804,台積電元富99購01,0,0,0,0,0,0,0,0,0,-80000,0,0,0,144000,224000,-80000,-80000
059747,台達電台新99購01,0,0,0,0,0,0,0,0,0,-80000,0,0,0,0,80000,-80000,-80000
060247,牧德元大9A購02  ,0,0,0,0,0,0,0,0,0,-80000,0,0,0,20000,100000,-80000,-80000
052279,旺宏凱基95購07  ,0,0,0,0,0,0,0,0,0,-80000,0,0,0,5000,85000,-80000,-80000
053211,漢唐凱基96購03  ,0,0,0,0,0,0,0,0,0,-80000,0,0,0,49000,129000,-80000,-80000
04728P,美律亞東94售02  ,0,0,0,0,0,0,0,0,0,-80000,0,0,0,0,80000,-80000,-80000
04665P,臺股指國票94售04,0,0,0,0,0,0,0,0,0,-80000,0,0,0,20000,100000,-80000,-80000
055015,帆宣元富97購01  ,0,0,0,0,0,0,0,0,0,-80000,0,0,0,0,80000,-80000,-80000
055920,智伸科凱基97購02,0,0,0,0,0,0,0,0,0,-80000,0,0,0,0,80000,-80000,-80000
057470,易華電永豐98購02,0,0,0,0,0,0,0,0,0,-80000,0,0,0,0,80000,-80000,-80000
054699,復盛永豐97購01  ,0,0,0,0,0,0,0,0,0,-80000,0,0,0,0,80000,-80000,-80000
057319,奇力新凱基99購02,0,0,0,0,0,0,0,0,0,-80000,0,0,0,0,80000,-80000,-80000
059637,大立光凱基01購01,0,0,0,0,0,0,0,0,0,-81000,0,0,0,72000,153000,-81000,-81000
07256P,臺股指凱基99售36,0,0,0,0,0,0,0,0,0,-81000,0,0,0,72000,153000,-81000,-81000
052062,臺股指國票95購09,0,0,0,0,0,0,0,0,0,-81000,0,0,0,10000,91000,-81000,-81000
052075,旺宏元富95購03  ,0,0,0,0,0,0,0,0,0,-81000,0,0,0,128000,209000,-81000,-81000
056160,智易凱基97購03  ,0,0,0,0,0,0,0,0,0,-81000,0,0,0,2000,83000,-81000,-81000
5519,隆大            ,201000,362000,-161000,0,0,0,0,0,0,79000,79000,0,79000,0,0,0,-82000
055525,國巨群益98購05  ,0,0,0,0,0,0,0,0,0,-82000,0,0,0,43000,125000,-82000,-82000
057744,健策永豐98購02  ,0,0,0,0,0,0,0,0,0,-82000,0,0,0,0,82000,-82000,-82000
057407,超眾群益99購01  ,0,0,0,0,0,0,0,0,0,-82000,0,0,0,40000,122000,-82000,-82000
056719,台虹永豐98購01  ,0,0,0,0,0,0,0,0,0,-82000,0,0,0,1000,83000,-82000,-82000
059278,群創元大9A購04  ,0,0,0,0,0,0,0,0,0,-82000,0,0,0,62000,144000,-82000,-82000
2912,統一超          ,941270,996453,-55183,0,0,0,0,26000,-26000,-1000,0,1000,-1000,0,0,0,-82183
07435P,台積電富邦9C售07,0,0,0,0,0,0,0,0,0,-83000,0,0,0,0,83000,-83000,-83000
060222,貿聯凱基9A購02  ,0,0,0,0,0,0,0,0,0,-83000,0,0,0,0,83000,-83000,-83000
054231,國巨群益98購03  ,0,0,0,0,0,0,0,0,0,-83000,0,0,0,25000,108000,-83000,-83000
051675,瑞儀元大96購02  ,0,0,0,0,0,0,0,0,0,-83000,0,0,0,17000,100000,-83000,-83000
057075,嘉聯益永豐98購01,0,0,0,0,0,0,0,0,0,-83000,0,0,0,30000,113000,-83000,-83000
056110,嘉聯益永豐97購02,0,0,0,0,0,0,0,0,0,-83000,0,0,0,3000,86000,-83000,-83000
9917,中保科          ,56000,153000,-97000,0,0,0,14000,0,14000,0,0,0,0,0,0,0,-83000
060122,亞德客永豐99購02,0,0,0,0,0,0,0,0,0,-84000,0,0,0,60000,144000,-84000,-84000
06653P,美食元大98售02  ,0,0,0,0,0,0,0,0,0,-84000,0,0,0,56000,140000,-84000,-84000
059947,貿聯永豐99購03  ,0,0,0,0,0,0,0,0,0,-84000,0,0,0,0,84000,-84000,-84000
059913,台積電元大99購44,0,0,0,0,0,0,0,0,0,-84000,0,0,0,14000,98000,-84000,-84000
058263,大成鋼永豐99購01,0,0,0,0,0,0,0,0,0,-84000,0,0,0,0,84000,-84000,-84000
056354,國巨元大98購10  ,0,0,0,0,0,0,0,0,0,-84000,0,0,0,29000,113000,-84000,-84000
057311,玉晶光日盛9A購01,0,0,0,0,0,0,0,0,0,-84000,0,0,0,6000,90000,-84000,-84000
055710,亞德客元大97購03,0,0,0,0,0,0,0,0,0,-84000,0,0,0,21000,105000,-84000,-84000
06852P,臺股指元大98售11,0,0,0,0,0,0,0,0,0,-85000,0,0,0,1003000,1088000,-85000,-85000
07265P,大立光元大99售16,0,0,0,0,0,0,0,0,0,-85000,0,0,0,123000,208000,-85000,-85000
4960,誠美材          ,256000,341000,-85000,0,0,0,0,0,0,0,0,0,0,0,0,0,-85000
057301,嘉聯益永豐98購02,0,0,0,0,0,0,0,0,0,-85000,0,0,0,30000,115000,-85000,-85000
3059,華晶科          ,68000,154000,-86000,0,0,0,0,0,0,0,0,0,0,0,0,0,-86000
059980,台積電元大99購50,0,0,0,0,0,0,0,0,0,-86000,0,0,0,6000,92000,-86000,-86000
059624,鴻海凱基01購01  ,0,0,0,0,0,0,0,0,0,-86000,0,0,0,8000,94000,-86000,-86000
059520,台表科永豐99購02,0,0,0,0,0,0,0,0,0,-86000,0,0,0,114000,200000,-86000,-86000
059317,台積電元大99購34,0,0,0,0,0,0,0,0,0,-86000,0,0,0,29000,115000,-86000,-86000
048754,瀚宇博元富97購01,0,0,0,0,0,0,0,0,0,-86000,0,0,0,7000,93000,-86000,-86000
058752,鈺齊凱基9A購01  ,0,0,0,0,0,0,0,0,0,-86000,0,0,0,0,86000,-86000,-86000
059039,致伸群益99購01  ,0,0,0,0,0,0,0,0,0,-86000,0,0,0,11000,97000,-86000,-86000
056453,禾伸堂凱基99購02,0,0,0,0,0,0,0,0,0,-86000,0,0,0,2000,88000,-86000,-86000
059845,欣興富邦9A購02  ,0,0,0,0,0,0,0,0,0,-87000,0,0,0,172000,259000,-87000,-87000
5203,訊連            ,47000,129000,-82000,0,0,0,0,0,0,-5000,15000,8000,7000,0,12000,-12000,-87000
054164,強茂凱基98購01  ,0,0,0,0,0,0,0,0,0,-87000,0,0,0,44000,131000,-87000,-87000
053662,矽力凱基97購01  ,0,0,0,0,0,0,0,0,0,-87000,0,0,0,18000,105000,-87000,-87000
054941,凱美元大97購01  ,0,0,0,0,0,0,0,0,0,-87000,0,0,0,0,87000,-87000,-87000
054652,裕隆麥證97購01  ,0,0,0,0,87000,-87000,0,0,0,-87000,0,0,0,0,87000,-87000,-87000
3532,台勝科          ,182000,231000,-49000,0,0,0,0,15000,-15000,-24000,0,20000,-20000,12000,16000,-4000,-88000
2637,慧洋-KY         ,229000,321000,-92000,0,0,0,0,0,0,4000,45000,41000,4000,0,0,0,-88000
059922,大立光元大99購25,0,0,0,0,0,0,0,0,0,-88000,0,0,0,24000,112000,-88000,-88000
057859,神達康和98購01  ,0,0,0,0,0,0,0,0,0,-89000,0,0,0,0,89000,-89000,-89000
057925,貿聯凱基99購01  ,0,0,0,0,0,0,0,0,0,-89000,0,0,0,81000,170000,-89000,-89000
056146,台虹元大98購01  ,0,0,0,0,0,0,0,0,0,-89000,0,0,0,0,89000,-89000,-89000
056298,億光元大97購02  ,0,0,0,0,0,0,0,0,0,-89000,0,0,0,1000,90000,-89000,-89000
059858,台灣50群益9A購09,0,0,0,0,0,0,0,0,0,-90000,0,0,0,0,90000,-90000,-90000
059588,鴻海元大99購32  ,0,0,0,0,0,0,0,0,0,-90000,0,0,0,157000,247000,-90000,-90000
060298,鎧勝元大9C購01  ,0,0,0,0,0,0,0,0,0,-90000,0,0,0,0,90000,-90000,-90000
2393,億光            ,980000,1094000,-114000,0,0,0,0,0,0,24000,0,18000,-18000,42000,0,42000,-90000
07466P,亞德客元大9A售02,0,0,0,0,0,0,0,0,0,-90000,0,0,0,0,90000,-90000,-90000
051969,世紀鋼永豐95購01,0,0,0,0,0,0,0,0,0,-90000,0,0,0,0,90000,-90000,-90000
053617,宏達電群益96購02,0,0,0,0,0,0,0,0,0,-90000,0,0,0,0,90000,-90000,-90000
054809,大成鋼元大97購01,0,0,0,0,0,0,0,0,0,-90000,0,0,0,0,90000,-90000,-90000
055232,泰碩國票98購01  ,0,0,0,0,0,0,0,0,0,-90000,0,0,0,0,90000,-90000,-90000
058828,大毅永豐99購01  ,0,0,0,0,0,0,0,0,0,-90000,0,0,0,0,90000,-90000,-90000
059282,嘉聯益永豐99購01,0,0,0,0,0,0,0,0,0,-90000,0,0,0,21000,111000,-90000,-90000
059173,矽力凱基99購01  ,0,0,0,0,0,0,0,0,0,-90000,0,0,0,40000,130000,-90000,-90000
057072,日月光永豐98購01,0,0,0,0,0,0,0,0,0,-90000,0,0,0,24000,114000,-90000,-90000
5534,長虹            ,101000,221440,-120440,0,0,0,2000,0,2000,28000,28000,0,28000,0,0,0,-90440
2059,川湖            ,112000,191000,-79000,0,0,0,0,10000,-10000,-2000,0,2000,-2000,0,0,0,-91000
060126,創意永豐99購04  ,0,0,0,0,0,0,0,0,0,-91000,0,0,0,69000,160000,-91000,-91000
059122,超眾永豐99購01  ,0,0,0,0,0,0,0,0,0,-91000,0,0,0,0,91000,-91000,-91000
049629,臺股指群益94購02,0,0,0,0,0,0,0,0,0,-92000,0,0,0,30000,122000,-92000,-92000
06734P,智邦凱基98售05  ,0,0,0,0,0,0,0,0,0,-93000,0,0,0,0,93000,-93000,-93000
6206,飛捷            ,127000,220000,-93000,0,0,0,0,0,0,0,0,0,0,0,0,0,-93000
054212,聯詠國票97購03  ,0,0,0,0,0,0,0,0,0,-93000,0,0,0,18000,111000,-93000,-93000
058797,大毅元大99購03  ,0,0,0,0,0,0,0,0,0,-93000,0,0,0,13000,106000,-93000,-93000
06123P,玉晶光元大97售04,0,0,0,0,0,0,0,0,0,-94000,0,0,0,10000,104000,-94000,-94000
055919,景碩凱基98購02  ,0,0,0,0,0,0,0,0,0,-94000,0,0,0,26000,120000,-94000,-94000
059815,SP黃豆凱基9A購03,0,0,0,0,0,0,0,0,0,-95000,0,0,0,0,95000,-95000,-95000
1760,寶齡富錦        ,240000,353000,-113000,0,0,0,0,0,0,18000,18000,0,18000,0,0,0,-95000
053748,燿華永豐96購04  ,0,0,0,0,0,0,0,0,0,-95000,0,0,0,10000,105000,-95000,-95000
054149,達方元大96購01  ,0,0,0,0,0,0,0,0,0,-95000,0,0,0,0,95000,-95000,-95000
059197,可成永豐99購02  ,0,0,0,0,0,0,0,0,0,-95000,0,0,0,5000,100000,-95000,-95000
2615,萬海            ,1105000,1195101,-90101,0,0,0,0,0,0,-5000,3000,8000,-5000,0,0,0,-95101
07289P,台灣50凱基99售07,0,0,0,0,0,0,0,0,0,-96000,0,0,0,70000,166000,-96000,-96000
042315,T50反1台新96購01,0,0,0,0,0,0,0,0,0,-96000,0,0,0,50000,146000,-96000,-96000
058010,帆宣國票98購01  ,0,0,0,0,0,0,0,0,0,-96000,0,0,0,0,96000,-96000,-96000
057327,玉晶光群益9A購04,0,0,0,0,0,0,0,0,0,-96000,0,0,0,67000,163000,-96000,-96000
8131,福懋科          ,184000,278000,-94000,0,0,0,0,0,0,-2000,0,1000,-1000,0,1000,-1000,-96000
5515,建國            ,23000,120000,-97000,0,0,0,0,0,0,0,0,0,0,0,0,0,-97000
059295,大立光元富99購05,0,0,0,0,0,0,0,0,0,-97000,0,0,0,139000,236000,-97000,-97000
059888,華新科國票99購03,0,0,0,0,0,0,0,0,0,-98000,0,0,0,0,98000,-98000,-98000
060315,易華電永豐9A購01,0,0,0,0,0,0,0,0,0,-98000,0,0,0,0,98000,-98000,-98000
2417,圓剛            ,370000,468000,-98000,0,0,0,0,0,0,0,0,0,0,0,0,0,-98000
053810,台達電群益96購01,0,0,0,0,0,0,0,0,0,-98000,0,0,0,0,98000,-98000,-98000
053827,漢唐麥證9A購01  ,0,0,0,0,98000,-98000,0,0,0,-98000,0,0,0,0,98000,-98000,-98000
053516,茂林群益96購05  ,0,0,0,0,0,0,0,0,0,-98000,0,0,0,114000,212000,-98000,-98000
052390,聯詠群益95購03  ,0,0,0,0,0,0,0,0,0,-98000,0,0,0,0,98000,-98000,-98000
056239,宏達電群益98購01,0,0,0,0,0,0,0,0,0,-98000,0,0,0,0,98000,-98000,-98000
056558,台達電群益98購01,0,0,0,0,0,0,0,0,0,-98000,0,0,0,0,98000,-98000,-98000
07414P,台積電元大99售51,0,0,0,0,0,0,0,0,0,-99000,0,0,0,1000,100000,-99000,-99000
060251,易華電元大9C購01,0,0,0,0,0,0,0,0,0,-99000,0,0,0,0,99000,-99000,-99000
060233,宏碁元大9A購01  ,0,0,0,0,0,0,0,0,0,-99000,0,0,0,0,99000,-99000,-99000
06296P,燿華元大98售01  ,0,0,0,0,0,0,0,0,0,-99000,0,0,0,0,99000,-99000,-99000
052611,力成元大96購02  ,0,0,0,0,0,0,0,0,0,-99000,0,0,0,271000,370000,-99000,-99000
058402,欣興元大99購04  ,0,0,0,0,0,0,0,0,0,-99000,0,0,0,1000,100000,-99000,-99000
055603,超眾元大97購04  ,0,0,0,0,0,0,0,0,0,-99000,0,0,0,68000,167000,-99000,-99000
055305,旺宏群益99購01  ,0,0,0,0,0,0,0,0,0,-99000,0,0,0,141000,240000,-99000,-99000
055382,台郡元大99購01  ,0,0,0,0,0,0,0,0,0,-99000,0,0,0,24000,123000,-99000,-99000
057504,技嘉麥證98購01  ,0,0,0,1000,100000,-99000,0,0,0,-99000,0,0,0,1000,100000,-99000,-99000
059037,宏達電群益99購02,0,0,0,0,0,0,0,0,0,-99000,0,0,0,3000,102000,-99000,-99000
058975,台灣50凱基01購02,0,0,0,0,0,0,0,0,0,-99000,0,0,0,13000,112000,-99000,-99000
9946,三發地產        ,63190,163000,-99810,0,0,0,0,0,0,0,0,0,0,0,0,0,-99810
060089,台積電元大99購54,0,0,0,0,0,0,0,0,0,-100000,0,0,0,0,100000,-100000,-100000
07382P,台積電群益9B售01,0,0,0,0,0,0,0,0,0,-100000,0,0,0,0,100000,-100000,-100000
07293P,臺股指凱基99售45,0,0,0,0,0,0,0,0,0,-100000,0,0,0,274000,374000,-100000,-100000
1101B,台泥乙特        ,0,0,0,0,0,0,0,0,0,-100000,0,100000,-100000,0,0,0,-100000
053769,香港反元大99購01,0,0,0,0,0,0,0,0,0,-100000,0,0,0,0,100000,-100000,-100000
053934,A50正2元富96購02,0,0,0,0,0,0,0,0,0,-100000,0,0,0,0,100000,-100000,-100000
053539,智易永豐96購01  ,0,0,0,0,0,0,0,0,0,-100000,0,0,0,1000,101000,-100000,-100000
053248,智伸科國票97購01,0,0,0,0,0,0,0,0,0,-100000,0,0,0,0,100000,-100000,-100000
053053,京元電國票97購02,0,0,0,0,0,0,0,0,0,-100000,0,0,0,0,100000,-100000,-100000
052678,群創富邦96購01  ,0,0,0,0,0,0,0,0,0,-100000,0,0,0,0,100000,-100000,-100000
049462,康友元富94購01  ,0,0,0,0,0,0,0,0,0,-100000,0,0,0,0,100000,-100000,-100000
054525,奇鋐元富96購01  ,0,0,0,0,0,0,0,0,0,-100000,0,0,0,8000,108000,-100000,-100000
056788,日月光群益98購01,0,0,0,0,0,0,0,0,0,-100000,0,0,0,0,100000,-100000,-100000
056970,TPK永豐98購01   ,0,0,0,0,0,0,0,0,0,-100000,0,0,0,0,100000,-100000,-100000
054459,鈺齊群益96購01  ,0,0,0,0,0,0,0,0,0,-100000,0,0,0,0,100000,-100000,-100000
057400,全新群益9A購01  ,0,0,0,0,0,0,0,0,0,-100000,0,0,0,0,100000,-100000,-100000
057351,奇力新統一98購02,0,0,0,0,0,0,0,0,0,-100000,0,0,0,0,100000,-100000,-100000
055900,瀚宇博中信97購01,0,0,0,0,0,0,0,0,0,-100000,0,0,0,10000,110000,-100000,-100000
00717,富邦美國特別股  ,0,3000,-3000,0,0,0,0,0,0,-97119,0,0,0,742000,839119,-97119,-100119
060320,元金2X群益02購01,0,0,0,0,0,0,0,0,0,-101000,0,0,0,0,101000,-101000,-101000
060364,奇力新元富9A購01,0,0,0,0,0,0,0,0,0,-101000,0,0,0,0,101000,-101000,-101000
06640P,國巨兆豐99售02  ,0,0,0,0,0,0,0,0,0,-101000,0,0,0,10000,111000,-101000,-101000
058481,玉晶光凱基9A購04,0,0,0,0,0,0,0,0,0,-101000,0,0,0,79000,180000,-101000,-101000
059120,致伸永豐99購01  ,0,0,0,0,0,0,0,0,0,-101000,0,0,0,22000,123000,-101000,-101000
9944,新麗            ,172000,274000,-102000,0,0,0,0,0,0,1000,1000,0,1000,0,0,0,-101000
060366,健策元富9A購01  ,0,0,0,0,0,0,0,0,0,-102000,0,0,0,0,102000,-102000,-102000
060079,台郡台新99購03  ,0,0,0,0,0,0,0,0,0,-102000,0,0,0,0,102000,-102000,-102000
059843,華新科富邦9B購03,0,0,0,0,0,0,0,0,0,-102000,0,0,0,64000,166000,-102000,-102000
057163,上銀元大98購04  ,0,0,0,0,0,0,0,0,0,-102000,0,0,0,33000,135000,-102000,-102000
057374,禾伸堂元大99購03,0,0,0,0,0,0,0,0,0,-102000,0,0,0,40000,142000,-102000,-102000
055407,祥碩國泰98購01  ,0,0,0,0,0,0,0,0,0,-102000,0,0,0,24000,126000,-102000,-102000
060337,FBVIX統一9A購01 ,0,0,0,0,0,0,0,0,0,-103000,0,0,0,0,103000,-103000,-103000
07279P,台灣50台新99售02,4000,0,4000,0,0,0,0,0,0,-107000,0,0,0,1000,108000,-107000,-103000
055536,嘉聯益群益99購02,0,0,0,0,0,0,0,0,0,-103000,0,0,0,31000,134000,-103000,-103000
056422,全新統一98購02  ,0,0,0,0,0,0,0,0,0,-103000,0,0,0,88000,191000,-103000,-103000
056615,燿華永豐98購02  ,0,0,0,0,0,0,0,0,0,-103000,0,0,0,68000,171000,-103000,-103000
059160,華通凱基99購03  ,0,0,0,0,0,0,0,0,0,-103000,0,0,0,40000,143000,-103000,-103000
07282P,聯發科凱基99售17,0,0,0,0,0,0,0,0,0,-104000,0,0,0,40000,144000,-104000,-104000
048793,超眾元大95購02  ,0,0,0,0,0,0,0,0,0,-104000,0,0,0,0,104000,-104000,-104000
054498,燿華永豐96購06  ,0,0,0,0,0,0,0,0,0,-104000,0,0,0,0,104000,-104000,-104000
056846,晶相光元富98購01,0,0,0,0,0,0,0,0,0,-104000,0,0,0,255000,359000,-104000,-104000
056200,大毅永豐98購01  ,0,0,0,0,0,0,0,0,0,-104000,0,0,0,26000,130000,-104000,-104000
2377,微星            ,2154975,2183000,-28025,0,0,0,462000,377000,85000,-161000,29000,205000,-176000,39000,24000,15000,-104025
060196,泰鼎元富9A購01  ,0,0,0,0,0,0,0,0,0,-105000,0,0,0,0,105000,-105000,-105000
059959,訊芯康和99購01  ,0,0,0,0,0,0,0,0,0,-105000,0,0,0,13000,118000,-105000,-105000
047211,華新科富邦99購01,0,0,0,0,0,0,0,0,0,-105000,0,0,0,41000,146000,-105000,-105000
056599,臻鼎元富98購01  ,0,0,0,0,0,0,0,0,0,-105000,0,0,0,230000,335000,-105000,-105000
058911,茂林元大99購04  ,0,0,0,0,0,0,0,0,0,-105000,0,0,0,405000,510000,-105000,-105000
059867,華邦電凱基99購02,0,0,0,0,0,0,0,0,0,-106000,0,0,0,634000,740000,-106000,-106000
059709,上証2X元大9C購01,0,0,0,0,0,0,0,0,0,-106000,0,0,0,4000,110000,-106000,-106000
059323,新日興元大99購02,0,0,0,0,0,0,0,0,0,-106000,0,0,0,15000,121000,-106000,-106000
060006,華通群益9A購04  ,0,0,0,0,0,0,0,0,0,-106000,0,0,0,62000,168000,-106000,-106000
052939,富邦金兆豐96購01,0,0,0,0,0,0,0,0,0,-106000,0,0,0,0,106000,-106000,-106000
053940,康友元富96購01  ,0,0,0,0,0,0,0,0,0,-106000,0,0,0,0,106000,-106000,-106000
059268,鎧勝中信01購01  ,0,0,0,0,0,0,0,0,0,-106000,0,0,0,0,106000,-106000,-106000
054951,大毅元大97購01  ,0,0,0,0,0,0,0,0,0,-106000,0,0,0,12000,118000,-106000,-106000
059338,滬深2X凱基9C購02,0,0,0,0,0,0,0,0,0,-107000,0,0,0,0,107000,-107000,-107000
07358P,鴻海元大99售39  ,0,0,0,0,0,0,0,0,0,-107000,0,0,0,0,107000,-107000,-107000
050575,南亞科國票94購01,0,0,0,0,0,0,0,0,0,-107000,0,0,0,38000,145000,-107000,-107000
00770,國泰北美科技    ,0,0,0,0,0,0,0,0,0,-107000,0,0,0,131000,238000,-107000,-107000
058145,聯茂元大99購03  ,0,0,0,0,0,0,0,0,0,-107000,0,0,0,26000,133000,-107000,-107000
057423,台郡凱基98購06  ,0,0,0,0,0,0,0,0,0,-107000,0,0,0,0,107000,-107000,-107000
07312P,台灣50元大99售10,0,0,0,0,0,0,0,0,0,-108000,0,0,0,136000,244000,-108000,-108000
060047,道瓊反凱基99購01,0,30000,-30000,0,0,0,0,0,0,-78000,0,0,0,191000,269000,-78000,-108000
058309,大毅元大99購02  ,0,0,0,0,0,0,0,0,0,-108000,0,0,0,0,108000,-108000,-108000
055476,台郡凱基97購02  ,0,0,0,0,0,0,0,0,0,-108000,0,0,0,1000,109000,-108000,-108000
057108,潤泰全群益98購01,0,0,0,0,0,0,0,0,0,-108000,0,0,0,0,108000,-108000,-108000
056872,旺宏凱基98購08  ,0,0,0,0,0,0,0,0,0,-108000,0,0,0,63000,171000,-108000,-108000
058522,聯茂元大99購07  ,0,0,0,0,0,0,0,0,0,-108000,0,0,0,34000,142000,-108000,-108000
07421P,國泰金元大99售01,0,0,0,0,0,0,0,0,0,-109000,0,0,0,77000,186000,-109000,-109000
2342,茂矽            ,839000,948000,-109000,0,0,0,0,0,0,0,0,0,0,0,0,0,-109000
055748,GIS元富97購01   ,0,0,0,0,0,0,0,0,0,-109000,0,0,0,0,109000,-109000,-109000
07273P,台灣50群益99售03,0,0,0,0,0,0,0,0,0,-110000,0,0,0,0,110000,-110000,-110000
1459,聯發            ,5000,115000,-110000,0,0,0,0,0,0,0,0,0,0,0,0,0,-110000
1734,杏輝            ,23000,133000,-110000,0,0,0,0,0,0,0,0,0,0,0,0,0,-110000
060277,道瓊反元大9A購02,0,0,0,0,0,0,0,0,0,-110000,0,0,0,0,110000,-110000,-110000
059954,華新科康和99購01,0,0,0,0,0,0,0,0,0,-110000,0,0,0,73000,183000,-110000,-110000
052860,旺宏凱基96購03  ,0,0,0,0,0,0,0,0,0,-110000,0,0,0,0,110000,-110000,-110000
048832,玉晶光凱基95購02,0,0,0,0,0,0,0,0,0,-110000,0,0,0,94000,204000,-110000,-110000
057232,京元電凱基98購02,0,0,0,0,0,0,0,0,0,-110000,0,0,0,58000,168000,-110000,-110000
9943,好樂迪          ,54000,164000,-110000,0,0,0,0,0,0,0,0,0,0,0,0,0,-110000
07363P,大立光元大99售26,0,0,0,0,0,0,0,0,0,-111000,0,0,0,2000,113000,-111000,-111000
07210P,智邦凱基99售03  ,0,0,0,0,0,0,0,0,0,-111000,0,0,0,0,111000,-111000,-111000
2537,聯上發          ,344000,455000,-111000,0,0,0,0,0,0,0,0,0,0,0,0,0,-111000
055647,義隆元富97購01  ,0,0,0,0,0,0,0,0,0,-111000,0,0,0,16000,127000,-111000,-111000
07261P,台灣50元大9A售04,0,0,0,0,0,0,0,0,0,-112000,0,0,0,0,112000,-112000,-112000
1611,中電            ,42000,178000,-136000,0,0,0,0,0,0,24000,25000,1000,24000,0,0,0,-112000
059748,聯發科台新99購03,0,0,0,0,0,0,0,0,0,-112000,0,0,0,13000,125000,-112000,-112000
052231,景碩凱基96購01  ,0,0,0,0,0,0,0,0,0,-112000,0,0,0,56000,168000,-112000,-112000
9924,福興            ,31000,49000,-18000,0,0,0,0,94000,-94000,0,0,0,0,0,0,0,-112000
8996,高力            ,327000,826000,-499000,0,0,0,357000,0,357000,30000,30000,0,30000,0,0,0,-112000
059856,昇陽半永豐99購03,0,0,0,0,0,0,0,0,0,-113000,0,0,0,22000,135000,-113000,-113000
060133,牧德群益9B購01  ,0,0,0,0,0,0,0,0,0,-113000,0,0,0,135000,248000,-113000,-113000
06763P,技嘉元大98售05  ,0,0,0,0,0,0,0,0,0,-113000,0,0,0,8000,121000,-113000,-113000
055404,超眾元富97購01  ,0,0,0,0,0,0,0,0,0,-113000,0,0,0,38000,151000,-113000,-113000
8464,億豐            ,461000,616000,-155000,0,0,0,118000,30000,88000,-46000,8000,54000,-46000,0,0,0,-113000
1108,幸福            ,6000,120000,-114000,0,0,0,0,0,0,0,0,0,0,0,0,0,-114000
055933,欣興群益98購02  ,0,0,0,0,0,0,0,0,0,-114000,0,0,0,104000,218000,-114000,-114000
059879,GIS凱基99購03   ,0,0,0,0,0,0,0,0,0,-115000,0,0,0,97000,212000,-115000,-115000
052104,英業達兆豐96購01,0,0,0,0,0,0,0,0,0,-115000,0,0,0,0,115000,-115000,-115000
057130,全新凱基98購03  ,0,0,0,0,0,0,0,0,0,-115000,0,0,0,21000,136000,-115000,-115000
059791,超眾元大99購06  ,0,0,0,0,0,0,0,0,0,-116000,0,0,0,20000,136000,-116000,-116000
07241P,台灣50國票9A售05,0,0,0,0,0,0,0,0,0,-116000,0,0,0,0,116000,-116000,-116000
057724,亞德客國泰99購01,0,0,0,0,0,0,0,0,0,-116000,0,0,0,66000,182000,-116000,-116000
056202,國揚永豐97購01  ,0,0,0,0,0,0,0,0,0,-116000,0,0,0,0,116000,-116000,-116000
056178,嘉澤元富97購02  ,0,0,0,0,0,0,0,0,0,-116000,0,0,0,207000,323000,-116000,-116000
054923,晶技凱基98購01  ,0,0,0,0,0,0,0,0,0,-117000,0,0,0,29000,146000,-117000,-117000
057562,奇鋐兆豐98購01  ,0,0,0,0,0,0,0,0,0,-117000,0,0,0,451000,568000,-117000,-117000
051653,南電永豐95購02  ,0,0,0,0,0,0,0,0,0,-118000,0,0,0,106000,224000,-118000,-118000
058391,T50反1元大99購02,0,0,0,0,0,0,0,0,0,-118000,0,0,0,30000,148000,-118000,-118000
052625,南電亞東97購01  ,0,0,0,0,0,0,0,0,0,-118000,0,0,0,2000,120000,-118000,-118000
052777,燿華國票98購01  ,0,0,0,0,0,0,0,0,0,-118000,0,0,0,26000,144000,-118000,-118000
03675C,臺股指元大04牛02,0,0,0,0,0,0,0,0,0,-118000,0,0,0,56000,174000,-118000,-118000
03980P,群創凱基95售02  ,0,0,0,0,0,0,0,0,0,-118000,0,0,0,0,118000,-118000,-118000
057570,技嘉永豐98購02  ,0,0,0,0,0,0,0,0,0,-118000,0,0,0,13000,131000,-118000,-118000
057093,臻鼎元富98購02  ,0,0,0,0,0,0,0,0,0,-118000,0,0,0,0,118000,-118000,-118000
07288P,台灣50凱基99售06,0,0,0,0,0,0,0,0,0,-119000,0,0,0,43000,162000,-119000,-119000
06130P,玉晶光元富97售07,0,0,0,0,0,0,0,0,0,-119000,0,0,0,0,119000,-119000,-119000
052781,瀚宇博國票97購03,0,0,0,0,0,0,0,0,0,-119000,0,0,0,26000,145000,-119000,-119000
057936,健策群益99購01  ,0,0,0,0,0,0,0,0,0,-119000,0,0,0,13000,132000,-119000,-119000
057059,易華電元大99購01,0,0,0,0,0,0,0,0,0,-119000,0,0,0,11000,130000,-119000,-119000
058904,晶技元大99購05  ,0,0,0,0,0,0,0,0,0,-119000,0,0,0,16000,135000,-119000,-119000
059432,聯發科元大99購26,0,0,0,0,0,0,0,0,0,-120000,0,0,0,0,120000,-120000,-120000
053309,泰鼎凱基96購03  ,0,0,0,0,0,0,0,0,0,-120000,0,0,0,9000,129000,-120000,-120000
045479,T50反1中信95購01,0,0,0,0,0,0,0,0,0,-120000,0,0,0,0,120000,-120000,-120000
056058,建準元大97購02  ,0,0,0,0,0,0,0,0,0,-120000,0,0,0,270000,390000,-120000,-120000
060009,南亞科群益99購03,0,0,0,0,0,0,0,0,0,-121000,0,0,0,116000,237000,-121000,-121000
060183,南亞科元富9A購01,0,0,0,0,0,0,0,0,0,-121000,0,0,0,14000,135000,-121000,-121000
058216,TPK群益99購01   ,0,0,0,0,0,0,0,0,0,-121000,0,0,0,172000,293000,-121000,-121000
056190,昇陽半統一97購01,0,0,0,0,0,0,0,0,0,-121000,0,0,0,0,121000,-121000,-121000
058832,立積永豐99購01  ,0,0,0,0,0,0,0,0,0,-121000,0,0,0,82000,203000,-121000,-121000
1902,台紙            ,141000,323000,-182000,0,0,0,0,0,0,60000,60000,0,60000,0,0,0,-122000
055555,全新凱基9A購01  ,0,0,0,0,0,0,0,0,0,-122000,0,0,0,80000,202000,-122000,-122000
055058,大毅永豐97購01  ,0,0,0,0,0,0,0,0,0,-122000,0,0,0,0,122000,-122000,-122000
6504,南六            ,63000,194000,-131000,0,0,0,0,0,0,8000,8000,0,8000,0,0,0,-123000
06337P,祥碩元大97售05  ,0,0,0,0,0,0,0,0,0,-123000,0,0,0,38000,161000,-123000,-123000
059816,聯電凱基99購03  ,0,0,0,0,0,0,0,0,0,-123000,0,0,0,29000,152000,-123000,-123000
053123,京元電凱基96購01,0,0,0,0,0,0,0,0,0,-123000,0,0,0,125000,248000,-123000,-123000
058572,百和凱基9A購01  ,0,0,0,0,0,0,0,0,0,-123000,0,0,0,22000,145000,-123000,-123000
059004,嘉晶元大99購05  ,0,0,0,0,0,0,0,0,0,-123000,0,0,0,18000,141000,-123000,-123000
1560,中砂            ,75000,198188,-123188,0,0,0,0,0,0,0,0,0,0,0,0,0,-123188
2405,浩鑫            ,62000,185000,-123000,0,0,0,0,0,0,-1000,0,1000,-1000,0,0,0,-124000
2850,新產            ,22000,166000,-144000,0,0,0,0,0,0,20000,20000,0,20000,0,0,0,-124000
2881A,富邦特          ,0,12000,-12000,0,0,0,0,0,0,-112000,6000,118000,-112000,0,0,0,-124000
057926,帆宣凱基98購02  ,0,0,0,0,0,0,0,0,0,-124000,0,0,0,0,124000,-124000,-124000
052727,仁寶元富96購01  ,0,0,0,0,0,0,0,0,0,-124000,0,0,0,268000,392000,-124000,-124000
058751,南茂凱基9A購01  ,0,0,0,0,0,0,0,0,0,-124000,0,0,0,0,124000,-124000,-124000
05551P,電子類元大96售01,0,0,0,0,0,0,0,0,0,-124000,0,0,0,0,124000,-124000,-124000
059846,力山永豐99購01  ,0,0,0,0,0,0,0,0,0,-125000,0,0,0,0,125000,-125000,-125000
00714,群益道瓊美國地產,0,0,0,0,0,0,0,0,0,-125000,0,0,0,2000,127000,-125000,-125000
053347,茂林國票98購01  ,0,0,0,0,0,0,0,0,0,-125000,0,0,0,25000,150000,-125000,-125000
053818,富邦金群益98購01,0,0,0,0,0,0,0,0,0,-125000,0,0,0,25000,150000,-125000,-125000
054683,川湖永豐97購01  ,0,0,0,0,0,0,0,0,0,-125000,0,0,0,0,125000,-125000,-125000
057631,康控永豐98購02  ,0,0,0,0,0,0,0,0,0,-125000,0,0,0,0,125000,-125000,-125000
060123,光罩永豐99購02  ,0,0,0,0,0,0,0,0,0,-126000,0,0,0,210000,336000,-126000,-126000
060108,泰鼎元大99購04  ,0,0,0,0,0,0,0,0,0,-126000,0,0,0,0,126000,-126000,-126000
058984,全新凱基9A購03  ,0,0,0,0,0,0,0,0,0,-126000,0,0,0,133000,259000,-126000,-126000
059069,臺指反元大9C購01,0,0,0,0,0,0,0,0,0,-126000,0,0,0,50000,176000,-126000,-126000
059083,華通元大99購07  ,0,0,0,0,0,0,0,0,0,-126000,0,0,0,15000,141000,-126000,-126000
059389,國巨凱基99購14  ,0,0,0,0,0,0,0,0,0,-127000,0,0,0,69000,196000,-127000,-127000
07260P,台灣50元大9A售01,0,0,0,0,0,0,0,0,0,-127000,0,0,0,54000,181000,-127000,-127000
050202,建準群益95購01  ,0,0,0,0,0,0,0,0,0,-127000,0,0,0,7000,134000,-127000,-127000
056657,華邦電元大99購01,0,0,0,0,0,0,0,0,0,-127000,0,0,0,53000,180000,-127000,-127000
056287,亞光永豐97購02  ,0,0,0,0,0,0,0,0,0,-127000,0,0,0,70000,197000,-127000,-127000
055132,台虹康和97購01  ,0,0,0,0,0,0,0,0,0,-127000,0,0,0,0,127000,-127000,-127000
2022,聚亨            ,46000,134000,-88000,0,0,0,0,0,0,-40000,0,40000,-40000,0,0,0,-128000
060264,華新科國票9A購02,0,0,0,0,0,0,0,0,0,-128000,0,0,0,0,128000,-128000,-128000
00713,元大台灣高息低波,0,118000,-118000,0,0,0,0,0,0,-10000,0,0,0,2000,12000,-10000,-128000
056169,鴻海元富97購08  ,0,0,0,0,0,0,0,0,0,-128000,0,0,0,20000,148000,-128000,-128000
059459,訊芯永豐99購04  ,0,0,0,0,0,0,0,0,0,-129000,0,0,0,94000,223000,-129000,-129000
1215,卜蜂            ,138000,265000,-127000,0,0,0,0,0,0,-2000,0,0,0,0,2000,-2000,-129000
07442P,華航康和9A售02  ,0,0,0,0,0,0,0,0,0,-129000,0,0,0,40000,169000,-129000,-129000
050343,鴻海元富94購01  ,0,0,0,0,0,0,0,0,0,-129000,0,0,0,475000,604000,-129000,-129000
054304,台積電凱基96購23,0,0,0,0,0,0,0,0,0,-130000,0,0,0,94000,224000,-130000,-130000
058674,宏達電群益99購01,0,0,0,0,0,0,0,0,0,-130000,0,0,0,3000,133000,-130000,-130000
058685,TPK凱基99購01   ,0,0,0,0,0,0,0,0,0,-130000,0,0,0,171000,301000,-130000,-130000
057592,美律兆豐99購01  ,0,0,0,0,0,0,0,0,0,-130000,0,0,0,41000,171000,-130000,-130000
059171,祥碩凱基99購04  ,0,0,0,0,0,0,0,0,0,-130000,0,0,0,11000,141000,-130000,-130000
055745,臻鼎元富97購01  ,0,0,0,0,0,0,0,0,0,-130000,0,0,0,0,130000,-130000,-130000
059454,亞光永豐99購01  ,0,0,0,0,0,0,0,0,0,-131000,0,0,0,20000,151000,-131000,-131000
060163,健策永豐9B購01  ,0,0,0,0,0,0,0,0,0,-131000,0,0,0,14000,145000,-131000,-131000
054298,台表科元大97購03,0,0,0,0,0,0,0,0,0,-131000,0,0,0,93000,224000,-131000,-131000
058584,百和群益9A購01  ,0,0,0,0,0,0,0,0,0,-131000,0,0,0,0,131000,-131000,-131000
07335P,臺股指國票99售20,0,0,0,0,0,0,0,0,0,-132000,0,0,0,10000,142000,-132000,-132000
053519,力成群益96購02  ,0,0,0,0,0,0,0,0,0,-132000,0,0,0,97000,229000,-132000,-132000
07246P,旺宏凱基99售08  ,0,0,0,0,0,0,0,0,0,-133000,0,0,0,194000,327000,-133000,-133000
057420,美食凱基98購01  ,0,0,0,0,0,0,0,0,0,-133000,0,0,0,165000,298000,-133000,-133000
058878,旭富國泰9B購01  ,0,0,0,0,0,0,0,0,0,-133000,0,0,0,40000,173000,-133000,-133000
059005,嘉晶元大99購06  ,0,0,0,0,0,0,0,0,0,-133000,0,0,0,72000,205000,-133000,-133000
060127,牧德永豐99購02  ,0,0,0,0,0,0,0,0,0,-134000,0,0,0,0,134000,-134000,-134000
059201,祥碩永豐99購02  ,0,0,0,0,0,0,0,0,0,-134000,0,0,0,509000,643000,-134000,-134000
055654,景碩元富97購01  ,0,0,0,0,0,0,0,0,0,-134000,0,0,0,12000,146000,-134000,-134000
056288,健鼎永豐97購01  ,0,0,0,0,0,0,0,0,0,-134000,0,0,0,1000,135000,-134000,-134000
055762,智伸科群益97購01,0,0,0,0,0,0,0,0,0,-134000,0,0,0,0,134000,-134000,-134000
059494,國巨國票9C購01  ,0,0,0,0,0,0,0,0,0,-135000,0,0,0,84000,219000,-135000,-135000
057915,台泥凱基98購01  ,0,0,0,0,0,0,0,0,0,-135000,0,0,0,4000,139000,-135000,-135000
058507,美律元大9A購01  ,0,0,0,0,0,0,0,0,0,-135000,0,0,0,170000,305000,-135000,-135000
058250,台虹元大99購01  ,0,0,0,0,0,0,0,0,0,-135000,0,0,0,4000,139000,-135000,-135000
059961,T50反1凱基99購09,0,0,0,0,0,0,0,0,0,-136000,0,0,0,20000,156000,-136000,-136000
059765,嘉聯益永豐99購02,0,0,0,0,0,0,0,0,0,-136000,0,0,0,78000,214000,-136000,-136000
07014P,華通元大99售04  ,0,0,0,0,0,0,0,0,0,-136000,0,0,0,86000,222000,-136000,-136000
4915,致伸            ,954000,1121000,-167000,0,0,0,4000,0,4000,27000,0,16000,-16000,44000,1000,43000,-136000
03435B,臺股指凱基99熊29,0,0,0,0,0,0,0,0,0,-136000,0,0,0,379000,515000,-136000,-136000
056842,全新元富98購01  ,0,0,0,0,0,0,0,0,0,-136000,0,0,0,188000,324000,-136000,-136000
056260,鴻海統一98購07  ,0,0,0,0,0,0,0,0,0,-136000,0,0,0,0,136000,-136000,-136000
07225P,台積電元大99售33,0,0,0,0,0,0,0,0,0,-137000,0,0,0,63000,200000,-137000,-137000
054466,欣興凱基97購03  ,0,0,0,0,0,0,0,0,0,-137000,0,0,0,0,137000,-137000,-137000
058556,百和永豐99購01  ,0,0,0,0,0,0,0,0,0,-137000,0,0,0,26000,163000,-137000,-137000
059767,矽力永豐99購01  ,0,0,0,0,0,0,0,0,0,-138000,0,0,0,40000,178000,-138000,-138000
060278,道瓊反元大9A購03,0,0,0,0,0,0,0,0,0,-138000,0,0,0,0,138000,-138000,-138000
054384,瀚宇博群益96購02,0,0,0,0,0,0,0,0,0,-138000,0,0,0,20000,158000,-138000,-138000
057383,玉晶光富邦9A購01,0,0,0,0,0,0,0,0,0,-138000,0,0,0,314000,452000,-138000,-138000
058749,康控凱基99購03  ,0,0,0,0,0,0,0,0,0,-138000,0,0,0,22000,160000,-138000,-138000
8016,矽創            ,377000,764299,-387299,0,0,0,151000,0,151000,98000,64000,20000,44000,65000,11000,54000,-138299
060168,台表科永豐9A購01,0,0,0,0,0,0,0,0,0,-139000,0,0,0,2000,141000,-139000,-139000
059789,貿聯元大9A購02  ,0,0,0,0,0,0,0,0,0,-139000,0,0,0,80000,219000,-139000,-139000
03414B,臺股指凱基99熊01,0,0,0,0,0,0,0,0,0,-139000,0,0,0,213000,352000,-139000,-139000
059253,康控凱基9B購02  ,0,0,0,0,0,0,0,0,0,-139000,0,0,0,61000,200000,-139000,-139000
057747,致新永豐98購01  ,0,0,0,0,0,0,0,0,0,-139000,0,0,0,134000,273000,-139000,-139000
054919,興富發凱基97購01,0,0,0,0,0,0,0,0,0,-139000,0,0,0,47000,186000,-139000,-139000
059673,玉山金元富99購01,0,0,0,0,0,0,0,0,0,-140000,0,0,0,103000,243000,-140000,-140000
2206,三陽工業        ,40000,179000,-139000,0,0,0,0,0,0,-1000,0,1000,-1000,0,0,0,-140000
050414,泰鼎永豐94購04  ,0,0,0,0,0,0,0,0,0,-140000,0,0,0,10000,150000,-140000,-140000
054226,燿華元富96購02  ,0,0,0,0,0,0,0,0,0,-140000,0,0,0,0,140000,-140000,-140000
053349,台郡國票97購02  ,0,0,0,0,0,0,0,0,0,-140000,0,0,0,1000,141000,-140000,-140000
056187,京鼎統一97購01  ,0,0,0,0,0,0,0,0,0,-140000,0,0,0,0,140000,-140000,-140000
059035,旺宏群益99購06  ,0,0,0,0,0,0,0,0,0,-140000,0,0,0,139000,279000,-140000,-140000
058924,晶相光元富99購02,0,0,0,0,0,0,0,0,0,-140000,0,0,0,43000,183000,-140000,-140000
056243,創意群益97購03  ,0,0,0,0,0,0,0,0,0,-140000,0,0,0,0,140000,-140000,-140000
055785,祥碩凱基97購02  ,0,0,0,0,0,0,0,0,0,-140000,0,0,0,5000,145000,-140000,-140000
1326,台化            ,2996000,3156417,-160417,0,0,0,36000,0,36000,-17000,1000,15000,-14000,9000,12000,-3000,-141417
054343,世紀鋼元富96購02,0,0,0,0,0,0,0,0,0,-142000,0,0,0,187000,329000,-142000,-142000
057070,美律永豐98購02  ,0,0,0,0,0,0,0,0,0,-142000,0,0,0,68000,210000,-142000,-142000
059834,友達國泰9B購01  ,0,0,0,0,0,0,0,0,0,-143000,0,0,0,17000,160000,-143000,-143000
058555,矽創永豐9A購01  ,0,0,0,0,0,0,0,0,0,-143000,0,0,0,240000,383000,-143000,-143000
2312,金寶            ,677000,852000,-175000,0,0,0,0,0,0,31000,0,2000,-2000,33000,0,33000,-144000
1907,永豐餘          ,418000,645000,-227000,0,0,0,0,0,0,82000,85000,3000,82000,0,0,0,-145000
055983,全新元富9A購02  ,0,0,0,0,0,0,0,0,0,-145000,0,0,0,61000,206000,-145000,-145000
059536,新光金凱基99購05,0,0,0,0,0,0,0,0,0,-146000,0,0,0,147000,293000,-146000,-146000
055658,南電元富97購01  ,0,0,0,0,0,0,0,0,0,-146000,0,0,0,20000,166000,-146000,-146000
055740,智易元富97購01  ,0,0,0,0,0,0,0,0,0,-146000,0,0,0,2000,148000,-146000,-146000
059991,超眾元大9A購02  ,0,0,0,0,0,0,0,0,0,-147000,0,0,0,0,147000,-147000,-147000
053486,T50反1兆豐96購01,0,0,0,0,0,0,0,0,0,-147000,0,0,0,0,147000,-147000,-147000
056939,康控元富98購01  ,0,0,0,0,0,0,0,0,0,-147000,0,0,0,350000,497000,-147000,-147000
055133,致新康和97購01  ,0,0,0,0,0,0,0,0,0,-147000,0,0,0,110000,257000,-147000,-147000
059823,奇力新凱基99購07,0,0,0,0,0,0,0,0,0,-148000,0,0,0,15000,163000,-148000,-148000
06594P,立積元大98售01  ,0,0,0,0,0,0,0,0,0,-149000,0,0,0,42000,191000,-149000,-149000
051800,旺宏永豐95購02  ,0,0,0,0,0,0,0,0,0,-149000,0,0,0,90000,239000,-149000,-149000
048651,美利達元大96購05,0,0,0,0,0,0,0,0,0,-149000,0,0,0,51000,200000,-149000,-149000
04712P,國泰金元大94售01,0,0,0,0,0,0,0,0,0,-149000,0,0,0,2000,151000,-149000,-149000
055457,聚陽永豐97購01  ,0,0,0,0,0,0,0,0,0,-149000,0,0,0,211000,360000,-149000,-149000
6257,矽格            ,1395000,1805956,-410956,0,0,0,0,0,0,261000,280000,23000,257000,4000,0,4000,-149956
052560,康舒國票97購01  ,0,0,0,0,0,0,0,0,0,-150000,0,0,0,0,150000,-150000,-150000
05509P,智邦元富96售02  ,0,0,0,0,0,0,0,0,0,-150000,0,0,0,1000,151000,-150000,-150000
056084,漢唐統一97購03  ,0,0,0,0,0,0,0,0,0,-150000,0,0,0,8000,158000,-150000,-150000
056717,康友永豐98購01  ,0,0,0,0,0,0,0,0,0,-150000,0,0,0,0,150000,-150000,-150000
2535,達欣工          ,167000,218000,-51000,0,0,0,0,0,0,-100000,0,100000,-100000,0,0,0,-151000
2515,中工            ,698000,848000,-150000,0,0,0,0,0,0,-1000,0,4000,-4000,3000,0,3000,-151000
057935,晶技群益98購02  ,0,0,0,0,0,0,0,0,0,-151000,0,0,0,0,151000,-151000,-151000
057460,楠梓電永豐98購03,0,0,0,0,0,0,0,0,0,-151000,0,0,0,88000,239000,-151000,-151000
3045,台灣大          ,3936000,4074599,-138599,0,0,0,21000,0,21000,-34000,23000,57000,-34000,0,0,0,-151599
060184,建準元富9A購01  ,0,0,0,0,0,0,0,0,0,-152000,0,0,0,25000,177000,-152000,-152000
053947,義隆富邦97購01  ,0,0,0,0,0,0,0,0,0,-152000,0,0,0,33000,185000,-152000,-152000
058547,世紀鋼富邦9A購01,0,0,0,0,0,0,0,0,0,-152000,0,0,0,384000,536000,-152000,-152000
058616,台虹元大9A購01  ,0,0,0,0,0,0,0,0,0,-152000,0,0,0,25000,177000,-152000,-152000
1477,聚陽            ,1147000,1503223,-356223,0,0,0,198000,0,198000,6000,8000,6000,2000,4000,0,4000,-152223
055093,京鼎群益98購01  ,0,0,0,0,0,0,0,0,0,-153000,0,0,0,0,153000,-153000,-153000
059847,喬山永豐99購01  ,0,0,0,0,0,0,0,0,0,-154000,0,0,0,0,154000,-154000,-154000
056223,華邦電凱基97購04,0,0,0,0,0,0,0,0,0,-154000,0,0,0,204000,358000,-154000,-154000
058864,欣興凱基99購04  ,0,0,0,0,0,0,0,0,0,-154000,0,0,0,11000,165000,-154000,-154000
059016,晶相光元富99購03,0,0,0,0,0,0,0,0,0,-154000,0,0,0,24000,178000,-154000,-154000
059375,道瓊反群益9C購02,0,20000,-20000,0,0,0,0,0,0,-135000,0,0,0,5000,140000,-135000,-155000
07378P,大立光元大99售29,0,0,0,0,0,0,0,0,0,-155000,0,0,0,10000,165000,-155000,-155000
056809,旺宏統一98購03  ,0,0,0,0,0,0,0,0,0,-155000,0,0,0,3000,158000,-155000,-155000
055882,嘉聯益元富97購01,0,0,0,0,0,0,0,0,0,-155000,0,0,0,1000,156000,-155000,-155000
056320,京鼎群益99購01  ,0,0,0,0,0,0,0,0,0,-155000,0,0,0,0,155000,-155000,-155000
07134P,臺股指元大9A售28,0,0,0,0,0,0,0,0,0,-156000,0,0,0,16000,172000,-156000,-156000
6416,瑞祺電通        ,132000,338000,-206000,0,0,0,0,0,0,50000,68000,18000,50000,0,0,0,-156000
059287,華通元富99購03  ,0,0,0,0,0,0,0,0,0,-156000,0,0,0,138000,294000,-156000,-156000
060164,合勤控永豐9A購01,0,0,0,0,0,0,0,0,0,-156000,0,0,0,0,156000,-156000,-156000
060197,臻鼎元富9A購02  ,0,0,0,0,0,0,0,0,0,-156000,0,0,0,0,156000,-156000,-156000
053113,瀚宇博兆豐97購01,0,0,0,0,0,0,0,0,0,-156000,0,0,0,148000,304000,-156000,-156000
9939,宏全            ,176000,533153,-357153,0,0,0,198000,0,198000,3000,49000,46000,3000,0,0,0,-156153
059838,茂林國泰9B購01  ,0,0,0,0,0,0,0,0,0,-157000,0,0,0,22000,179000,-157000,-157000
054109,南亞科凱基96購05,0,0,0,0,0,0,0,0,0,-157000,0,0,0,220000,377000,-157000,-157000
049199,茂林永豐95購01  ,0,0,0,0,0,0,0,0,0,-157000,0,0,0,172000,329000,-157000,-157000
056191,世紀鋼統一97購01,0,0,0,0,0,0,0,0,0,-157000,0,0,0,22000,179000,-157000,-157000
058440,玉晶光統一99購02,10000,0,10000,0,0,0,0,0,0,-167000,0,0,0,0,167000,-167000,-157000
6214,精誠            ,102000,260000,-158000,0,0,0,0,0,0,0,0,0,0,0,0,0,-158000
2511,太子            ,187000,345000,-158000,0,0,0,0,0,0,0,0,0,0,0,0,0,-158000
053340,建準國票97購01  ,0,0,0,0,0,0,0,0,0,-158000,0,0,0,24000,182000,-158000,-158000
055230,大毅國票98購01  ,0,0,0,0,0,0,0,0,0,-158000,0,0,0,15000,173000,-158000,-158000
057746,同欣電永豐98購02,0,0,0,0,0,0,0,0,0,-158000,0,0,0,40000,198000,-158000,-158000
6670,復盛應用        ,150000,262000,-112000,0,0,0,0,60000,-60000,14000,13000,0,13000,1000,0,1000,-158000
058983,旺宏凱基99購05  ,0,0,0,0,0,0,0,0,0,-159000,0,0,0,69000,228000,-159000,-159000
1590,亞德客-KY       ,1171247,1262000,-90753,0,0,0,3000,144000,-141000,72000,74000,14000,60000,14000,2000,12000,-159753
05212P,台積電國票96售04,0,0,0,0,0,0,0,0,0,-160000,0,0,0,30000,190000,-160000,-160000
059174,訊芯凱基99購01  ,0,0,0,0,0,0,0,0,0,-160000,0,0,0,298000,458000,-160000,-160000
056364,亞光元大99購02  ,0,0,0,0,0,0,0,0,0,-160000,0,0,0,4000,164000,-160000,-160000
05634P,玉晶光台新97售01,0,0,0,0,0,0,0,0,0,-160000,0,0,0,0,160000,-160000,-160000
2332,友訊            ,460000,639000,-179000,0,0,0,0,0,0,17000,12000,11000,1000,28000,12000,16000,-162000
3504,揚明光          ,41000,200000,-159000,0,0,0,0,0,0,-3000,0,3000,-3000,0,0,0,-162000
058324,嘉聯益永豐9A購01,0,0,0,0,0,0,0,0,0,-162000,0,0,0,21000,183000,-162000,-162000
006205,富邦上証        ,0,36000,-36000,0,0,0,0,0,0,-126000,30000,30000,0,926000,1052000,-126000,-162000
059164,旺宏凱基99購06  ,0,0,0,0,0,0,0,0,0,-162000,0,0,0,52000,214000,-162000,-162000
059741,聯發科元富99購07,0,0,0,0,0,0,0,0,0,-163000,0,0,0,1000,164000,-163000,-163000
059729,群創元大9C購05  ,0,0,0,0,0,0,0,0,0,-163000,0,0,0,110000,273000,-163000,-163000
060085,華通元大99購10  ,0,0,0,0,0,0,0,0,0,-164000,0,0,0,124000,288000,-164000,-164000
07458P,長榮航元大9A售01,0,0,0,0,0,0,0,0,0,-164000,0,0,0,1000,165000,-164000,-164000
050545,奇力新凱基95購01,0,0,0,0,0,0,0,0,0,-164000,0,0,0,37000,201000,-164000,-164000
058821,泰鼎國泰9B購01  ,0,0,0,0,0,0,0,0,0,-164000,0,0,0,432000,596000,-164000,-164000
1218,泰山            ,170000,335000,-165000,0,0,0,0,0,0,0,0,0,0,0,0,0,-165000
07059P,華通國票9A售02  ,0,0,0,0,0,0,0,0,0,-165000,0,0,0,5000,170000,-165000,-165000
040761,T50反1凱基95購02,0,0,0,0,0,0,0,0,0,-165000,0,0,0,0,165000,-165000,-165000
058017,漢唐凱基99購01  ,0,0,0,0,0,0,0,0,0,-165000,0,0,0,25000,190000,-165000,-165000
051818,國巨統一95購02  ,0,0,0,0,0,0,0,0,0,-165000,0,0,0,0,165000,-165000,-165000
5434,崇越            ,317000,489000,-172000,0,0,0,0,0,0,6000,7000,1000,6000,0,0,0,-166000
06067P,華新科康和97售01,0,0,0,0,0,0,0,0,0,-166000,0,0,0,223000,389000,-166000,-166000
059928,道瓊銀富邦03購01,0,0,0,0,0,0,0,0,0,-166000,0,0,0,25000,191000,-166000,-166000
049744,亞德客永豐94購01,0,0,0,0,0,0,0,0,0,-166000,0,0,0,0,166000,-166000,-166000
055104,台達電凱基98購01,0,0,0,0,0,0,0,0,0,-166000,0,0,0,2000,168000,-166000,-166000
058722,台郡元富99購01  ,0,0,0,0,0,0,0,0,0,-166000,0,0,0,110000,276000,-166000,-166000
059849,興勤永豐99購01  ,0,0,0,0,0,0,0,0,0,-167000,0,0,0,0,167000,-167000,-167000
059763,華擎永豐99購03  ,0,0,0,0,0,0,0,0,0,-167000,0,0,0,227000,394000,-167000,-167000
07173P,臺股指國票99售10,0,0,0,0,0,0,0,0,0,-167000,0,0,0,9000,176000,-167000,-167000
07304P,臺股指元大9A售37,0,0,0,0,0,0,0,0,0,-167000,0,0,0,61000,228000,-167000,-167000
051489,世芯凱基95購01  ,0,0,0,0,0,0,0,0,0,-167000,0,0,0,178000,345000,-167000,-167000
056454,欣興凱基98購02  ,0,0,0,0,0,0,0,0,0,-167000,0,0,0,26000,193000,-167000,-167000
057096,緯穎元富98購01  ,0,0,0,0,0,0,0,0,0,-167000,0,0,0,169000,336000,-167000,-167000
9935,慶豐富          ,282000,449000,-167000,0,0,0,0,0,0,0,0,0,0,0,0,0,-167000
07391P,台灣50國泰02售01,0,0,0,0,0,0,0,0,0,-168000,0,0,0,22000,190000,-168000,-168000
052529,力成元大95購03  ,0,0,0,0,0,0,0,0,0,-168000,0,0,0,32000,200000,-168000,-168000
052492,易華電國票96購02,0,0,0,0,0,0,0,0,0,-168000,0,0,0,0,168000,-168000,-168000
059177,臺股指凱基99購28,0,0,0,0,0,0,0,0,0,-168000,0,0,0,0,168000,-168000,-168000
057449,華新科元富99購02,0,0,0,0,0,0,0,0,0,-168000,0,0,0,0,168000,-168000,-168000
059665,嘉聯益元大99購06,0,0,0,0,0,0,0,0,0,-169000,0,0,0,39000,208000,-169000,-169000
053840,燿華統一96購02  ,0,0,0,0,0,0,0,0,0,-169000,0,0,0,0,169000,-169000,-169000
050138,台表科國票95購02,0,0,0,0,0,0,0,0,0,-169000,0,0,0,214000,383000,-169000,-169000
04023P,臺股指元富99售02,0,0,0,0,0,0,0,0,0,-169000,0,0,0,0,169000,-169000,-169000
051390,京元電兆豐95購01,0,0,0,0,0,0,0,0,0,-169000,0,0,0,0,169000,-169000,-169000
055686,致伸凱基97購02  ,0,0,0,0,0,0,0,0,0,-169000,0,0,0,68000,237000,-169000,-169000
9925,新保            ,110000,279000,-169000,0,0,0,0,0,0,0,0,0,0,0,0,0,-169000
1319,東陽            ,279179,454000,-174821,0,0,0,0,0,0,5000,7000,2000,5000,0,0,0,-169821
07478P,南電康和9A售02  ,0,0,0,0,0,0,0,0,0,-170000,0,0,0,0,170000,-170000,-170000
059948,正文永豐99購01  ,0,0,0,0,0,0,0,0,0,-170000,0,0,0,25000,195000,-170000,-170000
055702,美律富邦98購01  ,0,0,0,0,0,0,0,0,0,-170000,0,0,0,10000,180000,-170000,-170000
056093,大毅元富97購01  ,0,0,0,0,0,0,0,0,0,-170000,0,0,0,70000,240000,-170000,-170000
055562,欣興凱基97購06  ,0,0,0,0,0,0,0,0,0,-170000,0,0,0,72000,242000,-170000,-170000
059450,和大永豐99購01  ,0,0,0,0,0,0,0,0,0,-171000,0,0,0,31000,202000,-171000,-171000
1609,大亞            ,435000,606000,-171000,0,0,0,0,0,0,0,0,0,0,0,0,0,-171000
2547,日勝生          ,510000,680000,-170000,0,0,0,0,0,0,-1000,0,1000,-1000,0,0,0,-171000
052990,超眾元大97購01  ,0,0,0,0,0,0,0,0,0,-171000,0,0,0,23000,194000,-171000,-171000
1455,集盛            ,147000,319000,-172000,0,0,0,0,0,0,0,0,0,0,0,0,0,-172000
059219,旺宏元大99購12  ,0,0,0,0,0,0,0,0,0,-172000,0,0,0,123000,295000,-172000,-172000
4306,炎洲            ,35000,218000,-183000,0,0,0,0,0,0,10000,10000,0,10000,0,0,0,-173000
056684,旺宏統一98購02  ,0,0,0,0,0,0,0,0,0,-173000,0,0,0,29000,202000,-173000,-173000
058123,亞光國票9A購01  ,0,0,0,0,0,0,0,0,0,-173000,0,0,0,0,173000,-173000,-173000
07369P,台積電凱基99售20,0,0,0,0,0,0,0,0,0,-174000,0,0,0,98000,272000,-174000,-174000
06208P,台郡凱基97售03  ,0,0,0,0,0,0,0,0,0,-174000,0,0,0,0,174000,-174000,-174000
05306P,泰碩國泰97售01  ,0,0,0,0,0,0,0,0,0,-174000,0,0,0,0,174000,-174000,-174000
050392,群創統一96購01  ,0,0,0,0,0,0,0,0,0,-174000,0,0,0,0,174000,-174000,-174000
06614P,祥碩永豐98售03  ,0,0,0,0,0,0,0,0,0,-175000,0,0,0,23000,198000,-175000,-175000
2023,燁輝            ,235000,410000,-175000,0,0,0,0,0,0,0,0,0,0,0,0,0,-175000
052581,訊芯元富98購01  ,0,0,0,0,0,0,0,0,0,-175000,0,0,0,19000,194000,-175000,-175000
057878,台郡元大99購04  ,0,0,0,0,0,0,0,0,0,-175000,0,0,0,70000,245000,-175000,-175000
056255,華新科元富97購05,0,0,0,0,0,0,0,0,0,-175000,0,0,0,2000,177000,-175000,-175000
059170,康控凱基9B購01  ,0,0,0,0,0,0,0,0,0,-175000,0,0,0,36000,211000,-175000,-175000
058247,聯茂元大99購04  ,0,0,0,0,0,0,0,0,0,-176000,0,0,0,102000,278000,-176000,-176000
1304,台聚            ,564000,741000,-177000,0,0,0,0,0,0,0,0,0,0,0,0,0,-177000
055191,牧德元富97購01  ,0,0,0,0,0,0,0,0,0,-177000,0,0,0,0,177000,-177000,-177000
3030,德律            ,79000,257000,-178000,0,0,0,0,0,0,0,0,0,0,0,0,0,-178000
054915,興勤凱基97購01  ,0,0,0,0,0,0,0,0,0,-178000,0,0,0,0,178000,-178000,-178000
059209,華通元大99購08  ,0,0,0,0,0,0,0,0,0,-178000,0,0,0,181000,359000,-178000,-178000
056715,瀚宇博永豐98購01,0,0,0,0,0,0,0,0,0,-179000,0,0,0,185000,364000,-179000,-179000
058833,台表科永豐99購01,0,0,0,0,0,0,0,0,0,-179000,0,0,0,59000,238000,-179000,-179000
058912,祥碩元大99購01  ,0,0,0,0,0,0,0,0,0,-180000,0,0,0,442000,622000,-180000,-180000
054700,致新永豐97購01  ,0,0,0,0,0,0,0,0,0,-180000,0,0,0,0,180000,-180000,-180000
1707,葡萄王          ,294000,393000,-99000,0,0,0,0,92000,-92000,10000,10000,0,10000,0,0,0,-181000
04616P,臺股指群益95售02,0,0,0,0,0,0,0,0,0,-181000,0,0,0,3000,184000,-181000,-181000
057572,明泰永豐98購01  ,0,0,0,0,0,0,0,0,0,-181000,0,0,0,7000,188000,-181000,-181000
058516,健鼎元大99購02  ,0,0,0,0,0,0,0,0,0,-181000,0,0,0,86000,267000,-181000,-181000
059530,華新科凱基9A購05,0,0,0,0,0,0,0,0,0,-182000,0,0,0,68000,250000,-182000,-182000
052180,緯穎元大96購05  ,0,0,0,0,0,0,0,0,0,-183000,0,0,0,156000,339000,-183000,-183000
059706,嘉晶凱基99購01  ,0,0,0,0,0,0,0,0,0,-184000,0,0,0,110000,294000,-184000,-184000
1447,力鵬            ,100000,284000,-184000,0,0,0,0,0,0,0,0,0,0,0,0,0,-184000
052489,義隆國票96購02  ,0,0,0,0,0,0,0,0,0,-184000,0,0,0,116000,300000,-184000,-184000
057924,健策凱基98購02  ,0,0,0,0,0,0,0,0,0,-184000,0,0,0,4000,188000,-184000,-184000
006208,富邦台50        ,5000,4000,1000,0,0,0,0,0,0,-185000,0,0,0,571000,756000,-185000,-184000
055798,聯茂富邦98購01  ,0,0,0,0,0,0,0,0,0,-184000,0,0,0,6000,190000,-184000,-184000
00636,國泰中國A50     ,19000,530000,-511000,0,0,0,0,0,0,326000,0,15000,-15000,787000,446000,341000,-185000
058022,樺漢凱基99購02  ,0,0,0,0,0,0,0,0,0,-185000,0,0,0,128000,313000,-185000,-185000
058959,南茂國票9A購01  ,0,0,0,0,0,0,0,0,0,-185000,0,0,0,0,185000,-185000,-185000
058725,美律富邦9A購01  ,0,0,0,0,0,0,0,0,0,-185000,0,0,0,436000,621000,-185000,-185000
058646,聯茂富邦9A購01  ,0,0,0,0,0,0,0,0,0,-185000,0,0,0,0,185000,-185000,-185000
9914,美利達          ,626000,1419013,-793013,0,0,0,615000,0,615000,-7000,1000,8000,-7000,0,0,0,-185013
059581,日月光元富99購02,0,0,0,0,0,0,0,0,0,-186000,0,0,0,270000,456000,-186000,-186000
056406,建準國票99購01  ,0,0,0,0,0,0,0,0,0,-186000,0,0,0,134000,320000,-186000,-186000
058532,禾伸堂元富99購01,0,0,0,0,0,0,0,0,0,-186000,0,0,0,0,186000,-186000,-186000
052183,華邦電群益95購01,0,0,0,0,0,0,0,0,0,-187000,0,0,0,0,187000,-187000,-187000
060340,國巨統一01購02  ,0,0,0,0,0,0,0,0,0,-188000,0,0,0,1000,189000,-188000,-188000
059070,道瓊指元大99購02,0,0,0,0,0,0,0,0,0,-188000,0,0,0,2000,190000,-188000,-188000
056711,亞光永豐98購01  ,0,0,0,0,0,0,0,0,0,-188000,0,0,0,1000,189000,-188000,-188000
06652P,長榮航元大98售01,0,0,0,0,0,0,0,0,0,-189000,0,0,0,0,189000,-189000,-189000
059401,牧德元富99購01  ,0,0,0,0,0,0,0,0,0,-189000,0,0,0,162000,351000,-189000,-189000
2836,高雄銀          ,50000,236000,-186000,0,0,0,0,0,0,-3000,0,3000,-3000,0,0,0,-189000
054363,世芯凱基97購01  ,0,0,0,0,0,0,0,0,0,-189000,0,0,0,116000,305000,-189000,-189000
051722,玉晶光永豐97購01,5000,6000,-1000,0,0,0,0,0,0,-188000,0,0,0,1125000,1313000,-188000,-189000
049501,台郡元大95購01  ,0,0,0,0,0,0,0,0,0,-189000,0,0,0,55000,244000,-189000,-189000
055874,中環元富9A購01  ,0,0,0,0,0,0,0,0,0,-189000,0,0,0,105000,294000,-189000,-189000
059952,旺宏康和99購01  ,0,0,0,0,0,0,0,0,0,-190000,0,0,0,15000,205000,-190000,-190000
060250,台表科元大9A購01,0,0,0,0,0,0,0,0,0,-190000,0,0,0,18000,208000,-190000,-190000
060161,牧德永豐9A購02  ,0,0,0,0,0,0,0,0,0,-190000,0,0,0,40000,230000,-190000,-190000
07318P,鴻海凱基01售02  ,0,0,0,0,0,0,0,0,0,-192000,0,0,0,1000,193000,-192000,-192000
057532,智原元大98購03  ,0,0,0,0,0,0,0,0,0,-192000,0,0,0,90000,282000,-192000,-192000
059326,康友元大99購01  ,0,0,0,0,0,0,0,0,0,-193000,0,0,0,189000,382000,-193000,-193000
059975,元金2X元大99購02,0,0,0,0,0,0,0,0,0,-194000,0,0,0,202000,396000,-194000,-194000
059884,鴻海國票99購09  ,0,0,0,0,0,0,0,0,0,-194000,0,0,0,151000,345000,-194000,-194000
059760,楠梓電永豐99購01,0,0,0,0,0,0,0,0,0,-194000,0,0,0,55000,249000,-194000,-194000
07366P,國巨康和99售02  ,0,0,0,0,0,0,0,0,0,-194000,0,0,0,488000,682000,-194000,-194000
052938,華新科兆豐96購01,0,0,0,0,0,0,0,0,0,-194000,0,0,0,23000,217000,-194000,-194000
07341P,台積電凱基99售18,0,0,0,0,0,0,0,0,0,-195000,0,0,0,116000,311000,-195000,-195000
059882,臺股指凱基9C購06,0,0,0,0,0,0,0,0,0,-195000,0,0,0,113000,308000,-195000,-195000
059565,國巨凱基99購16  ,0,0,0,0,0,0,0,0,0,-195000,0,0,0,98000,293000,-195000,-195000
060057,欣興凱基9B購01  ,0,0,0,0,0,0,0,0,0,-195000,0,0,0,12000,207000,-195000,-195000
057236,聯詠凱基98購03  ,0,0,0,0,0,0,0,0,0,-195000,0,0,0,5000,200000,-195000,-195000
060017,全新康和99購01  ,0,0,0,0,0,0,0,0,0,-196000,0,0,0,61000,257000,-196000,-196000
057322,旺宏群益98購04  ,0,0,0,0,0,0,0,0,0,-196000,0,0,0,139000,335000,-196000,-196000
053814,美律群益97購02  ,0,0,0,0,0,0,0,0,0,-197000,0,0,0,0,197000,-197000,-197000
05264P,微星元大95售02  ,0,0,0,0,0,0,0,0,0,-198000,0,0,0,60000,258000,-198000,-198000
056823,智伸科永豐98購01,0,0,0,0,0,0,0,0,0,-198000,0,0,0,0,198000,-198000,-198000
058929,可成統一9C購01  ,0,0,0,0,0,0,0,0,0,-198000,0,0,0,66000,264000,-198000,-198000
059914,台積電元大99購47,0,0,0,0,0,0,0,0,0,-199000,0,0,0,37000,236000,-199000,-199000
052298,易華電國票96購01,0,0,0,0,0,0,0,0,0,-199000,0,0,0,0,199000,-199000,-199000
9933,中鼎            ,745000,984735,-239735,0,0,0,0,0,0,40000,42000,2000,40000,0,0,0,-199735
059935,國巨永豐99購07  ,0,0,0,0,0,0,0,0,0,-200000,0,0,0,1000,201000,-200000,-200000
07450P,鴻海元大9A售03  ,0,0,0,0,0,0,0,0,0,-200000,0,0,0,0,200000,-200000,-200000
05236P,緯穎康和95售01  ,0,0,0,0,0,0,0,0,0,-200000,0,0,0,0,200000,-200000,-200000
05381P,聯詠群益95售02  ,0,0,0,0,0,0,0,0,0,-200000,0,0,0,0,200000,-200000,-200000
058411,技嘉兆豐99購01  ,0,0,0,0,0,0,0,0,0,-200000,0,0,0,0,200000,-200000,-200000
052959,聯電凱基97購01  ,0,0,0,0,0,0,0,0,0,-200000,0,0,0,0,200000,-200000,-200000
03555P,聯電元大02售24  ,0,200000,-200000,0,0,0,0,0,0,0,0,0,0,0,0,0,-200000
057065,牧德富邦99購01  ,0,0,0,0,0,0,0,0,0,-200000,0,0,0,0,200000,-200000,-200000
054910,信錦凱基97購01  ,0,0,0,0,0,0,0,0,0,-200000,0,0,0,0,200000,-200000,-200000
2207,和泰車          ,203000,377795,-174795,0,0,0,2000,30000,-28000,1000,1000,0,1000,0,0,0,-201795
058496,文曄群益99購01  ,0,0,0,0,0,0,0,0,0,-202000,0,0,0,0,202000,-202000,-202000
07342P,大立光凱基99售14,0,0,0,0,0,0,0,0,0,-203000,0,0,0,266000,469000,-203000,-203000
052714,義隆凱基96購02  ,0,0,0,0,0,0,0,0,0,-203000,0,0,0,10000,213000,-203000,-203000
055844,大毅元大98購01  ,0,0,0,0,0,0,0,0,0,-203000,0,0,0,26000,229000,-203000,-203000
058923,華新科元富99購06,0,0,0,0,0,0,0,0,0,-203000,0,0,0,0,203000,-203000,-203000
6024,群益期          ,55000,70000,-15000,0,0,0,0,0,0,-189000,0,189000,-189000,0,0,0,-204000
059863,和大凱基99購01  ,0,0,0,0,0,0,0,0,0,-204000,0,0,0,200000,404000,-204000,-204000
057061,華擎國泰9A購01  ,0,0,0,0,0,0,0,0,0,-204000,0,0,0,116000,320000,-204000,-204000
055566,台表科凱基97購03,0,0,0,0,0,0,0,0,0,-204000,0,0,0,33000,237000,-204000,-204000
055349,京元電凱基97購02,0,0,0,0,0,0,0,0,0,-204000,0,0,0,49000,253000,-204000,-204000
052274,大立光群益95購03,0,0,0,0,0,0,0,0,0,-205000,0,0,0,0,205000,-205000,-205000
056958,喬山永豐98購01  ,0,0,0,0,0,0,0,0,0,-205000,0,0,0,0,205000,-205000,-205000
07191P,台積電元大99售32,0,0,0,0,0,0,0,0,0,-206000,0,0,0,0,206000,-206000,-206000
06864P,健策凱基98售01  ,0,0,0,0,0,0,0,0,0,-207000,0,0,0,27000,234000,-207000,-207000
07316P,長榮航康和99售01,0,0,0,0,0,0,0,0,0,-208000,0,0,0,80000,288000,-208000,-208000
07408P,台積電兆豐99售06,0,0,0,0,0,0,0,0,0,-208000,0,0,0,2000,210000,-208000,-208000
1522,堤維西          ,15000,224000,-209000,0,0,0,0,0,0,0,0,0,0,0,0,0,-209000
048850,聯電群益96購01  ,0,0,0,0,0,0,0,0,0,-209000,0,0,0,157000,366000,-209000,-209000
058146,勤誠元大99購01  ,0,0,0,0,0,0,0,0,0,-209000,0,0,0,244000,453000,-209000,-209000
056441,燿華凱基98購01  ,0,0,0,0,0,0,0,0,0,-209000,0,0,0,23000,232000,-209000,-209000
059403,T50反1台新03購03,0,0,0,0,0,0,0,0,0,-211000,0,0,0,0,211000,-211000,-211000
049130,臺指反元大98購01,0,0,0,0,0,0,0,0,0,-211000,0,0,0,0,211000,-211000,-211000
056177,嘉澤元富97購01  ,0,0,0,0,0,0,0,0,0,-211000,0,0,0,177000,388000,-211000,-211000
2034,允強            ,146000,343000,-197000,0,0,0,0,0,0,-15000,0,15000,-15000,0,0,0,-212000
055196,致新元富97購01  ,0,0,0,0,0,0,0,0,0,-212000,0,0,0,500000,712000,-212000,-212000
055297,啟碁元大97購01  ,0,0,0,0,0,0,0,0,0,-212000,0,0,0,15000,227000,-212000,-212000
057720,日電貿元富98購01,0,0,0,0,0,0,0,0,0,-212000,0,0,0,139000,351000,-212000,-212000
054300,華通凱基96購07  ,0,0,0,0,0,0,0,0,0,-213000,0,0,0,7000,220000,-213000,-213000
07409P,台積電台新99售07,0,0,0,0,0,0,0,0,0,-214000,0,0,0,6000,220000,-214000,-214000
055070,聯茂永豐97購01  ,0,0,0,0,0,0,0,0,0,-214000,0,0,0,17000,231000,-214000,-214000
1712,興農            ,808000,623000,185000,0,0,0,0,0,0,-400000,0,400000,-400000,0,0,0,-215000
1309,台達化          ,112000,327000,-215000,0,0,0,0,0,0,0,0,0,0,0,0,0,-215000
059700,鴻海凱基9A購16  ,0,0,0,0,0,0,0,0,0,-215000,0,0,0,7000,222000,-215000,-215000
060223,台灣50元大9A購05,0,0,0,0,0,0,0,0,0,-215000,0,0,0,0,215000,-215000,-215000
057969,緯穎國泰99購01  ,0,0,0,0,0,0,0,0,0,-215000,0,0,0,5000,220000,-215000,-215000
055513,旺宏亞東98購01  ,0,0,0,0,0,0,0,0,0,-215000,0,0,0,2689000,2904000,-215000,-215000
058704,台積電元大99購17,0,0,0,0,0,0,0,0,0,-215000,0,0,0,0,215000,-215000,-215000
058919,SGBR2X元富99購05,0,0,0,0,0,0,0,0,0,-216000,0,0,0,4000,220000,-216000,-216000
055731,美律元富97購01  ,0,0,0,0,0,0,0,0,0,-216000,0,0,0,0,216000,-216000,-216000
058337,日月光元富99購01,0,0,0,0,0,0,0,0,0,-217000,0,0,0,50000,267000,-217000,-217000
060204,矽創元富9A購01  ,0,0,0,0,0,0,0,0,0,-218000,0,0,0,175000,393000,-218000,-218000
059732,超眾元大9A購01  ,0,0,0,0,0,0,0,0,0,-220000,0,0,0,1000,221000,-220000,-220000
07135P,臺股指元大9A售29,0,0,0,0,0,0,0,0,0,-220000,0,0,0,0,220000,-220000,-220000
052893,聯電群益98購01  ,0,0,0,0,0,0,0,0,0,-220000,0,0,0,99000,319000,-220000,-220000
058819,華通國泰9B購01  ,0,0,0,0,0,0,0,0,0,-220000,0,0,0,107000,327000,-220000,-220000
2354,鴻準            ,1472115,1688750,-216635,0,0,0,0,0,0,-4000,7000,11000,-4000,0,0,0,-220635
053935,華通元富96購02  ,0,0,0,0,0,0,0,0,0,-221000,0,0,0,0,221000,-221000,-221000
060102,禾伸堂元大99購06,0,0,0,0,0,0,0,0,0,-222000,0,0,0,51000,273000,-222000,-222000
054625,旺宏凱基98購03  ,0,0,0,0,0,0,0,0,0,-222000,0,0,0,0,222000,-222000,-222000
058750,緯穎凱基9A購03  ,0,0,0,0,0,0,0,0,0,-222000,0,0,0,66000,288000,-222000,-222000
059852,康控永豐99購02  ,0,0,0,0,0,0,0,0,0,-223000,0,0,0,14000,237000,-223000,-223000
058111,健鼎元富98購01  ,0,0,0,0,0,0,0,0,0,-223000,0,0,0,12000,235000,-223000,-223000
057457,華邦電富邦98購01,0,0,0,0,0,0,0,0,0,-224000,0,0,0,511000,735000,-224000,-224000
059200,京鼎永豐99購02  ,0,0,0,0,0,0,0,0,0,-224000,0,0,0,354000,578000,-224000,-224000
053101,創意元富96購03  ,0,0,0,0,0,0,0,0,0,-225000,0,0,0,183000,408000,-225000,-225000
057514,華新科元富99購03,0,0,0,0,0,0,0,0,0,-225000,0,0,0,0,225000,-225000,-225000
055395,泰鼎統一97購01  ,0,0,0,0,0,0,0,0,0,-225000,0,0,0,81000,306000,-225000,-225000
059676,台積電台新99購05,0,0,0,0,0,0,0,0,0,-227000,0,0,0,595000,822000,-227000,-227000
057985,華通元富02購03  ,0,0,0,0,0,0,0,0,0,-227000,0,0,0,84000,311000,-227000,-227000
059705,華新科凱基9A購07,0,0,0,0,0,0,0,0,0,-228000,0,0,0,35000,263000,-228000,-228000
2441,超豐            ,84000,336000,-252000,0,0,0,0,0,0,24000,25000,1000,24000,0,0,0,-228000
049064,T50反1凱基96購03,0,0,0,0,0,0,0,0,0,-228000,0,0,0,50000,278000,-228000,-228000
055689,台郡凱基99購01  ,0,0,0,0,0,0,0,0,0,-228000,0,0,0,91000,319000,-228000,-228000
8163,達方            ,455000,673000,-218000,0,0,0,0,0,0,-10000,0,8000,-8000,0,2000,-2000,-228000
1717,長興            ,128000,355000,-227000,0,0,0,0,0,0,-2000,0,2000,-2000,0,0,0,-229000
056967,奇鋐永豐98購01  ,0,0,0,0,0,0,0,0,0,-229000,0,0,0,11000,240000,-229000,-229000
060360,南亞科元富9A購02,0,0,0,0,0,0,0,0,0,-230000,0,0,0,50000,280000,-230000,-230000
06802P,緯穎群益98售03  ,0,0,0,0,0,0,0,0,0,-230000,0,0,0,0,230000,-230000,-230000
051552,牧德永豐95購03  ,0,0,0,0,0,0,0,0,0,-231000,0,0,0,0,231000,-231000,-231000
07470P,國巨元大9A售06  ,0,0,0,0,0,0,0,0,0,-233000,0,0,0,0,233000,-233000,-233000
058989,茂林凱基99購02  ,0,0,0,0,0,0,0,0,0,-233000,0,0,0,288000,521000,-233000,-233000
059690,建準永豐99購01  ,0,0,0,0,0,0,0,0,0,-234000,0,0,0,80000,314000,-234000,-234000
057841,茂林富邦9A購02  ,0,0,0,0,0,0,0,0,0,-234000,0,0,0,339000,573000,-234000,-234000
059371,聯鈞元富99購02  ,0,0,0,0,0,0,0,0,0,-235000,0,0,0,25000,260000,-235000,-235000
053066,欣興群益96購02  ,0,0,0,0,0,0,0,0,0,-235000,0,0,0,0,235000,-235000,-235000
1711,永光            ,159000,395000,-236000,0,0,0,0,0,0,-1000,0,1000,-1000,0,0,0,-237000
07352P,台積電國票99售11,0,0,0,0,0,0,0,0,0,-237000,0,0,0,261000,498000,-237000,-237000
052705,超眾國票97購01  ,0,0,0,0,0,0,0,0,0,-237000,0,0,0,10000,247000,-237000,-237000
058892,元油2X元大9C購08,0,0,0,0,0,0,0,0,0,-238000,0,0,0,6000,244000,-238000,-238000
055433,嘉聯益群益99購01,0,0,0,0,0,0,0,0,0,-238000,0,0,0,35000,273000,-238000,-238000
055240,京元電元富97購01,0,0,0,0,0,0,0,0,0,-238000,0,0,0,210000,448000,-238000,-238000
059675,大立光元富99購08,0,0,0,0,0,0,0,0,0,-239000,0,0,0,34000,273000,-239000,-239000
055137,GIS富邦98購01   ,0,0,0,0,0,0,0,0,0,-239000,0,0,0,11000,250000,-239000,-239000
054744,晶相光凱基99購01,0,0,0,0,0,0,0,0,0,-239000,0,0,0,44000,283000,-239000,-239000
056582,易華電元大98購01,0,0,0,0,0,0,0,0,0,-240000,0,0,0,2000,242000,-240000,-240000
1476,儒鴻            ,1182000,1453453,-271453,0,0,0,20000,0,20000,11000,20000,8000,12000,0,1000,-1000,-240453
059996,美律元富99購01  ,0,0,0,0,0,0,0,0,0,-241000,0,0,0,67000,308000,-241000,-241000
058021,牧德凱基98購02  ,0,0,0,0,0,0,0,0,0,-241000,0,0,0,9000,250000,-241000,-241000
057799,世紀鋼兆豐98購01,0,0,0,0,0,0,0,0,0,-241000,0,0,0,104000,345000,-241000,-241000
2015,豐興            ,293000,483000,-190000,0,0,0,0,45000,-45000,-7000,1000,8000,-7000,0,0,0,-242000
058580,華新科群益99購02,0,0,0,0,0,0,0,0,0,-242000,0,0,0,98000,340000,-242000,-242000
059127,國巨中信99購04  ,0,0,0,0,0,0,0,0,0,-242000,0,0,0,29000,271000,-242000,-242000
058637,晶技兆豐99購01  ,0,0,0,0,0,0,0,0,0,-243000,0,0,0,20000,263000,-243000,-243000
057895,全新元富9B購01  ,0,0,0,0,0,0,0,0,0,-244000,0,0,0,0,244000,-244000,-244000
053496,義隆兆豐96購02  ,0,0,0,0,0,0,0,0,0,-244000,0,0,0,23000,267000,-244000,-244000
053427,鎧勝永豐96購02  ,0,0,0,0,0,0,0,0,0,-244000,0,0,0,0,244000,-244000,-244000
07130P,台郡元大9B售01  ,0,0,0,0,0,0,0,0,0,-245000,0,0,0,234000,479000,-245000,-245000
6412,群電            ,96000,764000,-668000,0,0,0,423000,0,423000,0,0,0,0,0,0,0,-245000
054215,創意國票97購02  ,0,0,0,0,0,0,0,0,0,-245000,0,0,0,13000,258000,-245000,-245000
054952,大毅元大97購02  ,0,0,0,0,0,0,0,0,0,-246000,0,0,0,20000,266000,-246000,-246000
059820,南亞科凱基99購07,0,0,0,0,0,0,0,0,0,-247000,0,0,0,286000,533000,-247000,-247000
053958,京元電永豐96購01,0,0,0,0,0,0,0,0,0,-247000,0,0,0,0,247000,-247000,-247000
055789,台虹凱基97購01  ,0,0,0,0,0,0,0,0,0,-247000,0,0,0,0,247000,-247000,-247000
059889,華新科國票99購04,0,0,0,0,0,0,0,0,0,-248000,0,0,0,10000,258000,-248000,-248000
2605,新興            ,590000,833000,-243000,0,0,0,0,0,0,-5000,0,5000,-5000,0,0,0,-248000
07162P,臺股指群益99售13,0,0,0,0,0,0,0,0,0,-248000,0,0,0,155000,403000,-248000,-248000
053036,聯電凱基98購01  ,0,0,0,0,0,0,0,0,0,-248000,0,0,0,0,248000,-248000,-248000
050515,聯電元大96購01  ,0,0,0,0,0,0,0,0,0,-248000,0,0,0,128000,376000,-248000,-248000
051329,智邦永豐95購01  ,0,0,0,0,0,0,0,0,0,-250000,0,0,0,0,250000,-250000,-250000
060121,新光金富邦99購01,0,0,0,0,0,0,0,0,0,-251000,0,0,0,0,251000,-251000,-251000
00684R,元大美元指數反1 ,0,0,0,0,0,0,0,0,0,-251000,0,0,0,0,251000,-251000,-251000
058525,台虹元大99購02  ,0,0,0,0,0,0,0,0,0,-251000,0,0,0,7000,258000,-251000,-251000
059362,健策永豐99購03  ,0,0,0,0,0,0,0,0,0,-252000,0,0,0,52000,304000,-252000,-252000
00654R,富邦印度反1     ,0,0,0,0,0,0,0,0,0,-252000,0,0,0,184000,436000,-252000,-252000
053784,奇力新元大97購02,0,0,0,0,0,0,0,0,0,-252000,0,0,0,79000,331000,-252000,-252000
8422,可寧衛          ,85000,337000,-252000,0,0,0,0,0,0,0,0,0,0,0,0,0,-252000
03657C,T50反1元大99牛01,0,0,0,0,0,0,0,0,0,-253000,0,0,0,55000,308000,-253000,-253000
057494,玉晶光元大99購09,0,0,0,0,0,0,0,0,0,-253000,0,0,0,158000,411000,-253000,-253000
06396P,新日興康和97售01,0,0,0,0,0,0,0,0,0,-255000,0,0,0,0,255000,-255000,-255000
059854,台表科永豐99購03,0,0,0,0,0,0,0,0,0,-256000,0,0,0,94000,350000,-256000,-256000
03438B,臺股指元大96熊27,0,0,0,0,0,0,0,0,0,-259000,0,0,0,735000,994000,-259000,-259000
047564,滬深2X國票99購01,0,0,0,0,0,0,0,0,0,-260000,0,0,0,0,260000,-260000,-260000
059524,FBVIX凱基9A購02 ,0,0,0,0,0,0,0,0,0,-261000,0,0,0,145000,406000,-261000,-261000
060199,台郡元富9A購01  ,0,0,0,0,0,0,0,0,0,-262000,0,0,0,8000,270000,-262000,-262000
051603,深中小群益99購03,0,0,0,0,0,0,0,0,0,-262000,0,0,0,7000,269000,-262000,-262000
056962,技嘉永豐98購01  ,0,0,0,0,0,0,0,0,0,-263000,0,0,0,40000,303000,-263000,-263000
060237,友達元大9A購06  ,0,0,0,0,0,0,0,0,0,-264000,0,0,0,310000,574000,-264000,-264000
053103,瀚宇博元富96購01,0,0,0,0,0,0,0,0,0,-265000,0,0,0,27000,292000,-265000,-265000
054235,欣興群益96購06  ,0,0,0,0,0,0,0,0,0,-265000,0,0,0,149000,414000,-265000,-265000
057614,華新科元富99購04,0,0,0,0,0,0,0,0,0,-266000,0,0,0,10000,276000,-266000,-266000
056519,創意國票99購01  ,0,0,0,0,0,0,0,0,0,-266000,0,0,0,3000,269000,-266000,-266000
059995,南亞科元富99購01,0,0,0,0,0,0,0,0,0,-268000,0,0,0,347000,615000,-268000,-268000
057812,友達元大9A購05  ,0,0,0,0,0,0,0,0,0,-268000,0,0,0,35000,303000,-268000,-268000
059745,欣興元富99購04  ,0,0,0,0,0,0,0,0,0,-269000,0,0,0,99000,368000,-269000,-269000
1582,信錦            ,173000,470000,-297000,0,0,0,0,0,0,28000,28000,0,28000,0,0,0,-269000
059299,欣興元富99購03  ,0,0,0,0,0,0,0,0,0,-270000,0,0,0,4000,274000,-270000,-270000
055470,南亞科凱基97購01,0,0,0,0,0,0,0,0,0,-270000,0,0,0,48000,318000,-270000,-270000
056452,亞光凱基98購02  ,0,0,0,0,0,0,0,0,0,-272000,0,0,0,0,272000,-272000,-272000
057286,群創元大9B購05  ,0,0,0,0,0,0,0,0,0,-275000,0,0,0,32000,307000,-275000,-275000
059826,欣興凱基99購06  ,0,0,0,0,0,0,0,0,0,-276000,0,0,0,369000,645000,-276000,-276000
059976,道瓊銀元大99購01,0,0,0,0,0,0,0,0,0,-276000,0,0,0,1000,277000,-276000,-276000
057894,華通元富02購02  ,0,0,0,0,0,0,0,0,0,-276000,0,0,0,50000,326000,-276000,-276000
059519,台郡永豐99購01  ,0,0,0,0,0,0,0,0,0,-277000,0,0,0,60000,337000,-277000,-277000
053864,義隆元大96購01  ,0,0,0,0,0,0,0,0,0,-277000,0,0,0,81000,358000,-277000,-277000
06371P,茂林國票98售04  ,0,0,0,0,0,0,0,0,0,-278000,0,0,0,10000,288000,-278000,-278000
2820,華票            ,82000,357000,-275000,0,0,0,0,0,0,-3000,0,3000,-3000,0,0,0,-278000
055403,泰鼎元富97購01  ,0,0,0,0,0,0,0,0,0,-278000,0,0,0,19000,297000,-278000,-278000
07315P,台積電台新99售06,0,0,0,0,0,0,0,0,0,-280000,0,0,0,10000,290000,-280000,-280000
059683,康控富邦9C購01  ,0,0,0,0,0,0,0,0,0,-280000,0,0,0,145000,425000,-280000,-280000
054271,中石化中信99購01,0,0,0,0,0,0,0,0,0,-280000,0,0,0,0,280000,-280000,-280000
05440P,緯穎國票96售02  ,0,0,0,0,0,0,0,0,0,-280000,0,0,0,10000,290000,-280000,-280000
03638C,T50反1元大94牛03,0,0,0,0,0,0,0,0,0,-280000,0,0,0,75000,355000,-280000,-280000
056526,力山凱基98購01  ,0,0,0,0,0,0,0,0,0,-280000,0,0,0,0,280000,-280000,-280000
055935,創意群益97購02  ,0,0,0,0,0,0,0,0,0,-280000,0,0,0,13000,293000,-280000,-280000
058931,玉晶光統一9C購01,0,0,0,0,0,0,0,0,0,-283000,0,0,0,60000,343000,-283000,-283000
053900,T50反1日盛99購01,0,0,0,0,0,0,0,0,0,-285000,0,0,0,83000,368000,-285000,-285000
059949,啟碁永豐99購01  ,0,0,0,0,0,0,0,0,0,-286000,0,0,0,1000,287000,-286000,-286000
057283,欣興元大98購07  ,0,0,0,0,0,0,0,0,0,-287000,0,0,0,7000,294000,-287000,-287000
060289,京元電元大9A購01,0,0,0,0,0,0,0,0,0,-288000,0,0,0,0,288000,-288000,-288000
058788,喬山元大99購01  ,0,0,0,0,0,0,0,0,0,-288000,0,0,0,99000,387000,-288000,-288000
07300P,臺股指元大9A售33,0,0,0,0,0,0,0,0,0,-290000,0,0,0,20000,310000,-290000,-290000
058312,大毅國泰9B購01  ,0,0,0,0,0,0,0,0,0,-291000,0,0,0,199000,490000,-291000,-291000
8926,台汽電          ,64000,452000,-388000,0,0,0,0,0,0,97000,97000,0,97000,0,0,0,-291000
3036,文曄            ,135000,419128,-284128,0,0,0,0,0,0,-7000,0,7000,-7000,0,0,0,-291128
2106,建大            ,54000,346000,-292000,0,0,0,0,0,0,0,0,0,0,0,0,0,-292000
2204,中華            ,225000,517200,-292200,0,0,0,0,0,0,0,0,0,0,0,0,0,-292200
059503,大立光富邦9B購04,0,0,0,0,0,0,0,0,0,-293000,0,0,0,108000,401000,-293000,-293000
057944,新日興國票99購02,0,0,0,0,0,0,0,0,0,-293000,0,0,0,7000,300000,-293000,-293000
00671R,富邦NASDAQ反1   ,0,0,0,0,0,0,0,0,0,-293000,0,0,0,793000,1086000,-293000,-293000
5522,遠雄            ,256000,559000,-303000,0,0,0,0,0,0,9000,71000,62000,9000,0,0,0,-294000
059313,元石油元大99購06,0,0,0,0,0,0,0,0,0,-295000,0,0,0,479000,774000,-295000,-295000
056083,億光統一97購03  ,0,0,0,0,0,0,0,0,0,-296000,0,0,0,70000,366000,-296000,-296000
059577,旺宏元富99購04  ,0,0,0,0,0,0,0,0,0,-298000,0,0,0,36000,334000,-298000,-298000
048873,玉晶光國票95購02,0,0,0,0,0,0,0,0,0,-298000,0,0,0,459000,757000,-298000,-298000
058035,旭富永豐98購02  ,0,0,0,0,0,0,0,0,0,-299000,0,0,0,15000,314000,-299000,-299000
060261,臺股指凱基9A購04,0,0,0,0,0,0,0,0,0,-300000,0,0,0,0,300000,-300000,-300000
07472P,和碩元大9A售03  ,0,0,0,0,0,0,0,0,0,-300000,0,0,0,0,300000,-300000,-300000
055140,晶相光永豐97購01,0,0,0,0,0,0,0,0,0,-300000,0,0,0,5000,305000,-300000,-300000
1709,和益            ,140000,440000,-300000,0,0,0,0,0,0,-1000,0,1000,-1000,0,0,0,-301000
059425,SGBR2X元大9A購02,0,0,0,0,0,0,0,0,0,-301000,0,0,0,0,301000,-301000,-301000
056936,禾伸堂元富98購01,0,0,0,0,0,0,0,0,0,-302000,0,0,0,15000,317000,-302000,-302000
059756,奇力新富邦9C購01,0,0,0,0,0,0,0,0,0,-303000,0,0,0,59000,362000,-303000,-303000
05036P,義隆元大95售03  ,0,0,0,0,0,0,0,0,0,-304000,0,0,0,32000,336000,-304000,-304000
056435,台積電凱基98購09,0,0,0,0,0,0,0,0,0,-304000,0,0,0,14000,318000,-304000,-304000
060234,凱美元大9C購01  ,0,0,0,0,0,0,0,0,0,-305000,0,0,0,70000,375000,-305000,-305000
058901,美律元大99購07  ,0,0,0,0,0,0,0,0,0,-305000,0,0,0,47000,352000,-305000,-305000
3017,奇鋐            ,1704000,2012000,-308000,0,0,0,0,0,0,1000,11000,71000,-60000,190000,129000,61000,-307000
07386P,臺股指群益99售24,0,0,0,0,0,0,0,0,0,-308000,0,0,0,14000,322000,-308000,-308000
3056,總太            ,136000,444500,-308500,0,0,0,0,0,0,0,0,0,0,0,0,0,-308500
2607,榮運            ,5000,315000,-310000,0,0,0,0,0,0,0,0,0,0,0,0,0,-310000
053894,創意群益96購01  ,0,0,0,0,0,0,0,0,0,-310000,0,0,0,2000,312000,-310000,-310000
047410,上銀元富96購01  ,0,0,0,0,0,0,0,0,0,-311000,0,0,0,564000,875000,-311000,-311000
055041,致新富邦97購01  ,0,0,0,0,0,0,0,0,0,-313000,0,0,0,222000,535000,-313000,-313000
059951,台塑康和99購01  ,0,0,0,0,0,0,0,0,0,-314000,0,0,0,4000,318000,-314000,-314000
3533,嘉澤            ,269000,654000,-385000,0,0,0,103000,8000,95000,-27000,32000,47000,-15000,11000,23000,-12000,-317000
2108,南帝            ,76000,392000,-316000,0,0,0,0,0,0,-1000,0,1000,-1000,0,0,0,-317000
055872,亞泥元富97購01  ,0,0,0,0,0,0,0,0,0,-319000,0,0,0,148000,467000,-319000,-319000
053083,中環元大99購01  ,0,0,0,0,0,0,0,0,0,-320000,0,0,0,605000,925000,-320000,-320000
055653,聯詠元富01購02  ,0,0,0,0,0,0,0,0,0,-321000,0,0,0,0,321000,-321000,-321000
059979,台積電元大99購49,0,0,0,0,0,0,0,0,0,-323000,0,0,0,17000,340000,-323000,-323000
057222,鴻海國票99購04  ,0,0,0,0,0,0,0,0,0,-324000,0,0,0,55000,379000,-324000,-324000
060034,立積永豐99購04  ,0,0,0,0,0,0,0,0,0,-325000,0,0,0,139000,464000,-325000,-325000
059960,健策國票99購01  ,0,0,0,0,0,0,0,0,0,-326000,0,0,0,318000,644000,-326000,-326000
059327,南茂元大99購01  ,0,0,0,0,0,0,0,0,0,-326000,0,0,0,30000,356000,-326000,-326000
2505,國揚            ,71000,413000,-342000,0,0,0,0,0,0,15000,0,0,0,15000,0,15000,-327000
4536,拓凱            ,136000,461000,-325000,0,0,0,0,0,0,-3000,0,0,0,1000,4000,-3000,-328000
051880,健策康和95購01  ,0,0,0,0,0,0,0,0,0,-328000,0,0,0,82000,410000,-328000,-328000
059681,華新科國泰9B購02,0,0,0,0,0,0,0,0,0,-330000,0,0,0,104000,434000,-330000,-330000
057742,喬山永豐98購02  ,0,0,0,0,0,0,0,0,0,-330000,0,0,0,30000,360000,-330000,-330000
052561,矽創國票97購01  ,0,0,0,0,0,0,0,0,0,-333000,0,0,0,38000,371000,-333000,-333000
057987,大立光元富98購02,0,0,0,0,0,0,0,0,0,-333000,0,0,0,39000,372000,-333000,-333000
056107,智易永豐97購02  ,0,0,0,0,0,0,0,0,0,-333000,0,0,0,3000,336000,-333000,-333000
057092,健策元富98購01  ,0,0,0,0,0,0,0,0,0,-335000,0,0,0,98000,433000,-335000,-335000
053754,英業達元富96購02,0,0,0,0,0,0,0,0,0,-337000,0,0,0,283000,620000,-337000,-337000
06068P,玉晶光康和97售01,0,0,0,0,0,0,0,0,0,-343000,0,0,0,1738000,2081000,-343000,-343000
058132,義隆元大99購03  ,0,0,0,0,0,0,0,0,0,-343000,0,0,0,347000,690000,-343000,-343000
057278,可成元大98購06  ,0,0,0,0,0,0,0,0,0,-346000,0,0,0,77000,423000,-346000,-346000
053836,亞光永豐96購02  ,0,0,0,0,0,0,0,0,0,-348000,0,0,0,0,348000,-348000,-348000
059968,世紀鋼凱基99購03,0,0,0,0,0,0,0,0,0,-349000,0,0,0,19000,368000,-349000,-349000
055747,康舒元富97購01  ,0,0,0,0,0,0,0,0,0,-350000,0,0,0,0,350000,-350000,-350000
3702,大聯大          ,2234000,2573440,-339440,0,0,0,0,0,0,-12000,3000,2000,1000,27000,40000,-13000,-351440
056677,智伸科元富98購01,0,0,0,0,0,0,0,0,0,-353000,0,0,0,10000,363000,-353000,-353000
2451,創見            ,240000,660710,-420710,0,0,0,63000,0,63000,4000,9000,0,9000,12000,17000,-5000,-353710
4912,聯德控股-KY     ,51000,404000,-353000,0,0,0,0,0,0,-2000,0,2000,-2000,0,0,0,-355000
059643,日月光凱基99購02,0,0,0,0,0,0,0,0,0,-356000,0,0,0,295000,651000,-356000,-356000
3703,欣陸            ,189000,545000,-356000,0,0,0,0,0,0,-1000,0,1000,-1000,0,0,0,-357000
049272,世紀鋼元大96購02,0,0,0,0,0,0,0,0,0,-358000,0,0,0,551000,909000,-358000,-358000
060187,華新科元富9A購02,0,0,0,0,0,0,0,0,0,-359000,0,0,0,0,359000,-359000,-359000
3010,華立            ,69000,431000,-362000,0,0,0,0,0,0,-1000,0,1000,-1000,0,0,0,-363000
051845,世紀鋼富邦96購01,0,0,0,0,0,0,0,0,0,-363000,0,0,0,182000,545000,-363000,-363000
9103,美德醫療-DR     ,154000,517000,-363000,0,0,0,0,0,0,0,0,0,0,0,0,0,-363000
059618,台積電日盛99購01,0,0,0,0,0,0,0,0,0,-365000,0,0,0,142000,507000,-365000,-365000
059645,祥碩凱基99購05  ,0,0,0,0,0,0,0,0,0,-366000,0,0,0,1627000,1993000,-366000,-366000
059950,百和永豐99購02  ,0,0,0,0,0,0,0,0,0,-366000,0,0,0,22000,388000,-366000,-366000
056733,國巨凱基98購10  ,0,0,0,0,0,0,0,0,0,-373000,0,0,0,0,373000,-373000,-373000
05359P,嘉澤元大95售02  ,0,0,0,0,0,0,0,0,0,-374000,0,0,0,323000,697000,-374000,-374000
054082,楠梓電元富96購01,0,0,0,0,0,0,0,0,0,-375000,0,0,0,0,375000,-375000,-375000
059281,創意永豐99購02  ,0,0,0,0,0,0,0,0,0,-375000,0,0,0,242000,617000,-375000,-375000
1723,中碳            ,128000,505000,-377000,0,0,0,0,0,0,1000,1000,0,1000,0,0,0,-376000
056838,旺宏元富98購01  ,0,0,0,0,0,0,0,0,0,-377000,0,0,0,124000,501000,-377000,-377000
059181,世紀鋼元富9C購01,0,0,0,0,0,0,0,0,0,-378000,0,0,0,592000,970000,-378000,-378000
06853P,華擎元富98售03  ,0,0,0,0,0,0,0,0,0,-380000,0,0,0,0,380000,-380000,-380000
4904,遠傳            ,2350000,2707634,-357634,0,0,0,0,0,0,-24000,1000,25000,-24000,0,0,0,-381634
059121,瑞儀永豐99購01  ,0,0,0,0,0,0,0,0,0,-382000,0,0,0,163000,545000,-382000,-382000
3338,泰碩            ,863000,1320000,-457000,0,0,0,361000,253000,108000,-35000,148000,124000,24000,42000,101000,-59000,-384000
057725,台達電國泰9A購01,0,0,0,0,0,0,0,0,0,-384000,0,0,0,6000,390000,-384000,-384000
059744,禾伸堂元富99購02,0,0,0,0,0,0,0,0,0,-387000,0,0,0,105000,492000,-387000,-387000
057071,華擎永豐98購02  ,0,0,0,0,0,0,0,0,0,-387000,0,0,0,114000,501000,-387000,-387000
058113,百和元富98購01  ,0,0,0,0,0,0,0,0,0,-389000,0,0,0,0,389000,-389000,-389000
2897,王道銀行        ,246000,636000,-390000,0,0,0,0,0,0,0,0,0,0,0,0,0,-390000
056618,京元電永豐98購01,0,0,0,0,0,0,0,0,0,-393000,0,0,0,57000,450000,-393000,-393000
057483,微星元大98購04  ,0,0,0,0,0,0,0,0,0,-394000,0,0,0,73000,467000,-394000,-394000
05538P,玉晶光國票97售02,0,0,0,0,0,0,0,0,0,-399000,0,0,0,229000,628000,-399000,-399000
057886,聯詠群益98購01  ,0,0,0,0,0,0,0,0,0,-400000,0,0,0,0,400000,-400000,-400000
058839,瑞儀中信99購02  ,0,0,0,0,0,0,0,0,0,-402000,0,0,0,472000,874000,-402000,-402000
059805,台積電元富99購02,0,0,0,0,0,0,0,0,0,-403000,0,0,0,85000,488000,-403000,-403000
04878P,國巨康和94售02  ,0,0,0,0,0,0,0,0,0,-406000,0,0,0,182000,588000,-406000,-406000
053170,茂林群益96購04  ,0,0,0,0,0,0,0,0,0,-416000,0,0,0,173000,589000,-416000,-416000
054582,致新元大97購01  ,0,0,0,0,0,0,0,0,0,-417000,0,0,0,82000,499000,-417000,-417000
058082,美律群益98購05  ,0,0,0,0,0,0,0,0,0,-417000,0,0,0,32000,449000,-417000,-417000
058013,SP黃豆凱基9A購01,0,0,0,0,0,0,0,0,0,-418000,0,0,0,0,418000,-418000,-418000
8210,勤誠            ,241000,924000,-683000,0,0,0,102000,0,102000,161000,133000,1000,132000,50000,21000,29000,-420000
053658,亞光凱基96購01  ,0,0,0,0,0,0,0,0,0,-421000,0,0,0,0,421000,-421000,-421000
060201,台表科元富9A購01,0,0,0,0,0,0,0,0,0,-422000,0,0,0,0,422000,-422000,-422000
058926,勤誠元富99購01  ,25000,0,25000,0,0,0,0,0,0,-448000,0,0,0,399000,847000,-448000,-423000
1301,台塑            ,6133000,7420713,-1287713,0,0,0,857000,0,857000,7000,22000,35000,-13000,23000,3000,20000,-423713
056626,同欣電永豐98購01,0,0,0,0,0,0,0,0,0,-424000,0,0,0,42000,466000,-424000,-424000
057849,南茂永豐98購02  ,0,0,0,0,0,0,0,0,0,-425000,0,0,0,0,425000,-425000,-425000
055746,同欣電元富97購01,0,0,0,0,0,0,0,0,0,-425000,0,0,0,170000,595000,-425000,-425000
055120,南港兆豐97購01  ,0,0,0,0,0,0,0,0,0,-425000,0,0,0,0,425000,-425000,-425000
059809,貿聯元富99購01  ,0,0,0,0,0,0,0,0,0,-426000,0,0,0,21000,447000,-426000,-426000
00701,國泰股利精選30  ,0,15000,-15000,0,0,0,0,0,0,-413000,0,0,0,988000,1401000,-413000,-428000
1434,福懋            ,524000,955000,-431000,0,0,0,0,0,0,2000,2000,0,2000,0,0,0,-429000
2006,東和鋼鐵        ,214000,586000,-372000,0,0,0,0,102000,-102000,45000,60000,15000,45000,0,0,0,-429000
052895,台積電群益96購04,0,0,0,0,0,0,0,0,0,-429000,0,0,0,67000,496000,-429000,-429000
060058,牧德凱基9B購01  ,0,0,0,0,0,0,0,0,0,-431000,0,0,0,218000,649000,-431000,-431000
052759,京元電群益96購01,0,0,0,0,0,0,0,0,0,-432000,0,0,0,0,432000,-432000,-432000
2838,聯邦銀          ,261000,702000,-441000,0,0,0,0,0,0,0,0,0,0,0,0,0,-441000
058658,瑞儀中信99購01  ,0,0,0,0,0,0,0,0,0,-441000,0,0,0,5000,446000,-441000,-441000
059739,華通元富99購04  ,0,0,0,0,0,0,0,0,0,-445000,0,0,0,16000,461000,-445000,-445000
059930,健策富邦9B購01  ,0,0,0,0,0,0,0,0,0,-445000,0,0,0,325000,770000,-445000,-445000
5607,遠雄港          ,84000,530000,-446000,0,0,0,0,0,0,0,0,0,0,0,0,0,-446000
00652,富邦印度        ,0,0,0,0,0,0,0,0,0,-446000,0,0,0,0,446000,-446000,-446000
056574,亞光元大99購03  ,0,0,0,0,0,0,0,0,0,-447000,0,0,0,104000,551000,-447000,-447000
058721,立積元富9C購01  ,0,0,0,0,0,0,0,0,0,-450000,0,0,0,264000,714000,-450000,-450000
2436,偉詮電          ,156000,612000,-456000,0,0,0,0,0,0,0,0,0,0,0,0,0,-456000
056940,嘉聯益元富98購01,0,0,0,0,0,0,0,0,0,-456000,0,0,0,2000,458000,-456000,-456000
055875,光罩元富97購02  ,0,0,0,0,0,0,0,0,0,-458000,0,0,0,57000,515000,-458000,-458000
9921,巨大            ,1161000,1693152,-532152,0,0,0,74000,0,74000,0,0,0,0,0,0,0,-458152
056705,超眾國泰99購01  ,0,0,0,0,0,0,0,0,0,-460000,0,0,0,0,460000,-460000,-460000
059817,華通凱基99購05  ,0,0,0,0,0,0,0,0,0,-461000,0,0,0,125000,586000,-461000,-461000
2536,宏普            ,69000,352000,-283000,0,0,0,0,178000,-178000,-1000,0,1000,-1000,0,0,0,-462000
056378,欣興元富98購01  ,0,0,0,0,0,0,0,0,0,-469000,0,0,0,0,469000,-469000,-469000
055040,台虹富邦99購01  ,0,0,0,0,0,0,0,0,0,-470000,0,0,0,0,470000,-470000,-470000
058399,美律元大99購05  ,0,0,0,0,0,0,0,0,0,-471000,0,0,0,81000,552000,-471000,-471000
058801,致伸元大99購01  ,0,0,0,0,0,0,0,0,0,-471000,0,0,0,185000,656000,-471000,-471000
2101,南港            ,586000,1081000,-495000,0,0,0,0,0,0,20000,0,11000,-11000,31000,0,31000,-475000
4426,利勤            ,404000,882000,-478000,0,0,0,0,0,0,0,0,0,0,0,0,0,-478000
046813,聯電凱基96購01  ,0,0,0,0,0,0,0,0,0,-481000,0,0,0,0,481000,-481000,-481000
059349,台郡凱基99購04  ,0,0,0,0,0,0,0,0,0,-482000,0,0,0,286000,768000,-482000,-482000
052826,嘉聯益永豐96購01,0,0,0,0,0,0,0,0,0,-485000,0,0,0,0,485000,-485000,-485000
059047,元油2X凱基9A購10,0,0,0,0,0,0,0,0,0,-485000,0,0,0,106000,591000,-485000,-485000
055583,國巨元大97購10  ,0,0,0,0,0,0,0,0,0,-487000,0,0,0,19000,506000,-487000,-487000
058273,同欣電永豐99購01,0,0,0,0,0,0,0,0,0,-487000,0,0,0,20000,507000,-487000,-487000
00641R,富邦日本反1     ,12000,702000,-690000,0,0,0,0,0,0,200900,0,0,0,912000,711100,200900,-489100
07284P,大立光凱基99售10,0,0,0,0,0,0,0,0,0,-500000,0,0,0,90000,590000,-500000,-500000
051404,牧德永豐96購01  ,0,0,0,0,0,0,0,0,0,-500000,0,0,0,0,500000,-500000,-500000
8442,威宏-KY         ,3000,504000,-501000,0,0,0,0,0,0,0,0,0,0,0,0,0,-501000
059080,亞泥元大99購01  ,0,0,0,0,0,0,0,0,0,-508000,0,0,0,272000,780000,-508000,-508000
058215,貿聯群益99購02  ,0,0,0,0,0,0,0,0,0,-512000,0,0,0,0,512000,-512000,-512000
059250,大立光凱基99購06,0,0,0,0,0,0,0,0,0,-519000,0,0,0,15000,534000,-519000,-519000
058467,日月光中信9A購01,0,0,0,0,0,0,0,0,0,-522000,0,0,0,0,522000,-522000,-522000
07131P,緯穎元大99售06  ,0,0,0,0,0,0,0,0,0,-523000,0,0,0,140000,663000,-523000,-523000
00632R,元大台灣50反1   ,780000,1089000,-309000,0,0,0,0,210000,-210000,-6963,2935000,3707000,-772000,40745000,39979963,765037,-525963
059396,T50反1元富99購04,0,0,0,0,0,0,0,0,0,-533000,0,0,0,529000,1062000,-533000,-533000
07415P,台積電元大99售52,0,0,0,0,0,0,0,0,0,-534000,0,0,0,0,534000,-534000,-534000
07255P,國巨凱基99售15  ,10000,0,10000,0,0,0,0,0,0,-546000,0,0,0,217000,763000,-546000,-536000
059290,全新元富99購01  ,0,0,0,0,0,0,0,0,0,-537000,0,0,0,83000,620000,-537000,-537000
057393,台積電中信02購01,0,0,0,0,0,0,0,0,0,-541000,0,0,0,37000,578000,-541000,-541000
07467P,上銀元大9A售03  ,0,0,0,0,0,0,0,0,0,-550000,0,0,0,0,550000,-550000,-550000
6706,惠特            ,115000,615000,-500000,0,0,0,0,0,0,-50000,0,50000,-50000,0,0,0,-550000
6005,群益證          ,529000,1080000,-551000,0,0,0,0,0,0,0,0,0,0,0,0,0,-551000
2915,潤泰全          ,513000,1013000,-500000,0,0,0,0,0,0,-51000,0,44000,-44000,17000,24000,-7000,-551000
059188,京元電富邦9B購01,0,0,0,0,0,0,0,0,0,-557000,0,0,0,313000,870000,-557000,-557000
057740,茂林富邦9A購01  ,0,0,0,0,0,0,0,0,0,-558000,0,0,0,612000,1170000,-558000,-558000
053159,同欣電元大96購02,0,0,0,0,0,0,0,0,0,-559000,0,0,0,0,559000,-559000,-559000
060191,亞光元富9A購02  ,0,0,0,0,0,0,0,0,0,-561000,0,0,0,150000,711000,-561000,-561000
059288,旺宏元富99購03  ,0,0,0,0,0,0,0,0,0,-563000,0,0,0,48000,611000,-563000,-563000
055639,上銀元富97購02  ,0,0,0,0,0,0,0,0,0,-566000,0,0,0,424000,990000,-566000,-566000
059906,臺指反元大9C購04,0,0,0,0,0,0,0,0,0,-575000,0,0,0,110000,685000,-575000,-575000
059013,臺股指元大9A購32,0,0,0,0,0,0,0,0,0,-578000,0,0,0,0,578000,-578000,-578000
1409,新纖            ,297000,874000,-577000,0,0,0,0,0,0,-2000,0,2000,-2000,0,0,0,-579000
058427,大毅元富99購01  ,0,0,0,0,0,0,0,0,0,-579000,0,0,0,71000,650000,-579000,-579000
05591P,義隆群益96售03  ,0,0,0,0,0,0,0,0,0,-587000,0,0,0,0,587000,-587000,-587000
058445,旺宏富邦9C購01  ,0,0,0,0,0,0,0,0,0,-587000,0,0,0,425000,1012000,-587000,-587000
059036,可成群益9B購03  ,0,0,0,0,0,0,0,0,0,-596000,0,0,0,1000,597000,-596000,-596000
058970,鴻海永豐99購02  ,0,0,0,0,0,0,0,0,0,-596000,0,0,0,15000,611000,-596000,-596000
055707,聯鈞永豐98購01  ,0,0,0,0,0,0,0,0,0,-599000,0,0,0,136000,735000,-599000,-599000
3090,日電貿          ,405000,1027000,-622000,0,0,0,0,0,0,18000,0,0,0,36000,18000,18000,-604000
2357,華碩            ,1219000,1818000,-599000,0,0,0,0,0,0,-5000,2000,6000,-4000,4000,5000,-1000,-604000
6505,台塑化          ,1659000,2287384,-628384,0,0,0,22000,0,22000,0,0,0,0,0,0,0,-606384
059656,T50反1元大99購11,0,0,0,0,0,0,0,0,0,-608000,0,0,0,227000,835000,-608000,-608000
8213,志超            ,443000,724000,-281000,0,0,0,0,0,0,-333000,0,333000,-333000,0,0,0,-614000
059607,台積電富邦9C購04,0,0,0,0,0,0,0,0,0,-640000,0,0,0,1104000,1744000,-640000,-640000
03678C,臺股指凱基01牛02,0,0,0,0,0,0,0,0,0,-641000,0,0,0,5000,646000,-641000,-641000
057202,TPK元富98購02   ,0,0,0,0,0,0,0,0,0,-641000,0,0,0,196000,837000,-641000,-641000
052085,聯電元大95購01  ,0,0,0,0,0,0,0,0,0,-650000,0,0,0,50000,700000,-650000,-650000
1710,東聯            ,970000,1240000,-270000,0,0,0,0,0,0,-381000,0,381000,-381000,0,0,0,-651000
2542,興富發          ,1005000,1687533,-682533,0,0,0,0,0,0,20000,23000,8000,15000,5000,0,5000,-662533
3450,聯鈞            ,498000,1164000,-666000,0,0,0,0,0,0,-1000,8000,54000,-46000,86000,41000,45000,-667000
057539,南茂元大98購02  ,0,0,0,0,0,0,0,0,0,-668000,0,0,0,0,668000,-668000,-668000
056851,瑞儀元富98購01  ,0,0,0,0,0,0,0,0,0,-672000,0,0,0,15000,687000,-672000,-672000
058733,同欣電永豐99購02,0,0,0,0,0,0,0,0,0,-674000,0,0,0,85000,759000,-674000,-674000
03033P,微星國票03售01  ,0,0,0,0,0,0,0,0,0,-676000,0,0,0,0,676000,-676000,-676000
059679,國巨國泰9B購03  ,0,0,0,0,0,0,0,0,0,-692000,0,0,0,109000,801000,-692000,-692000
059631,京元電凱基99購02,0,0,0,0,0,0,0,0,0,-693000,0,0,0,64000,757000,-693000,-693000
2049,上銀            ,1339000,1691191,-352191,0,0,0,20000,360000,-340000,-2000,43000,59000,-16000,31000,17000,14000,-694191
4938,和碩            ,4033000,5697150,-1664150,0,0,0,1039000,0,1039000,-71000,9000,88000,-79000,30000,22000,8000,-696150
1201,味全            ,352000,1056000,-704000,0,0,0,0,0,0,0,0,0,0,0,0,0,-704000
2376,技嘉            ,1080000,1697000,-617000,0,0,0,140000,253000,-113000,18000,80000,73000,7000,119000,108000,11000,-712000
052544,牧德元富95購01  ,0,0,0,0,0,0,0,0,0,-714000,0,0,0,55000,769000,-714000,-714000
06477P,緯穎國票99售02  ,0,0,0,0,0,0,0,0,0,-720000,0,0,0,0,720000,-720000,-720000
9919,康那香          ,961000,1684000,-723000,0,0,0,0,0,0,-1000,0,1000,-1000,0,0,0,-724000
07402P,瑞昱凱基99售02  ,0,0,0,0,0,0,0,0,0,-728000,0,0,0,93000,821000,-728000,-728000
056822,佐登永豐98購01  ,0,0,0,0,0,0,0,0,0,-730000,0,0,0,0,730000,-730000,-730000
052943,奇力新國票96購02,0,0,0,0,0,0,0,0,0,-740000,0,0,0,10000,750000,-740000,-740000
5880,合庫金          ,9763870,10506305,-742435,0,0,0,0,0,0,0,0,0,0,0,0,0,-742435
2855,統一證          ,252000,999000,-747000,0,0,0,0,0,0,0,0,0,0,0,0,0,-747000
050892,聯電元大96購02  ,0,0,0,0,0,0,0,0,0,-754000,0,0,0,204000,958000,-754000,-754000
2867,三商壽          ,1202000,1957000,-755000,0,0,0,0,0,0,-2000,0,2000,-2000,0,0,0,-757000
06836P,玉晶光國票99售06,0,0,0,0,0,0,0,0,0,-773000,0,0,0,212000,985000,-773000,-773000
4142,國光生          ,454000,1235000,-781000,0,0,0,0,0,0,0,0,0,0,0,0,0,-781000
2327,國巨            ,2491000,3420900,-929900,0,0,0,123000,10000,113000,19000,120000,215000,-95000,377000,263000,114000,-797900
052430,泰碩永豐95購02  ,0,0,0,0,0,0,0,0,0,-800000,0,0,0,100000,900000,-800000,-800000
058200,世芯康和99購01  ,0,0,0,0,0,0,0,0,0,-802000,0,0,0,629000,1431000,-802000,-802000
00646,元大S&P500      ,9000,1000,8000,0,0,0,0,0,0,-810000,0,0,0,1028000,1838000,-810000,-802000
9910,豐泰            ,775000,1677137,-902137,0,0,0,99000,4000,95000,5000,5000,0,5000,0,0,0,-802137
4968,立積            ,679000,1527000,-848000,0,0,0,40000,0,40000,5000,15000,0,15000,69000,79000,-10000,-803000
00662,富邦NASDAQ      ,2000,2000,0,0,0,0,0,0,0,-803000,0,0,0,152000,955000,-803000,-803000
059559,T50反1凱基99購07,0,0,0,0,0,0,0,0,0,-806000,0,0,0,52000,858000,-806000,-806000
057473,T50反1元大98購08,0,0,0,0,0,0,0,0,0,-810000,0,0,0,0,810000,-810000,-810000
9945,潤泰新          ,1649260,2441073,-791813,0,0,0,0,0,0,-21000,1000,13000,-12000,0,9000,-9000,-812813
060038,台積電國票99購13,0,0,0,0,0,0,0,0,0,-823000,0,0,0,18000,841000,-823000,-823000
059771,台積電群益99購11,0,0,0,0,0,0,0,0,0,-826000,0,0,0,52000,878000,-826000,-826000
1305,華夏            ,242000,939000,-697000,0,0,0,0,152000,-152000,19000,70000,51000,19000,0,0,0,-830000
057872,旺宏元大99購06  ,0,0,0,0,0,0,0,0,0,-832000,0,0,0,196000,1028000,-832000,-832000
0050,元大台灣50      ,65100,2208000,-2142900,0,0,0,129000,557000,-428000,1737000,100000,15000,85000,3302000,1650000,1652000,-833900
07413P,國巨元大99售33  ,0,0,0,0,0,0,0,0,0,-839000,0,0,0,151000,990000,-839000,-839000
053018,旺宏元富96購02  ,0,0,0,0,0,0,0,0,0,-841000,0,0,0,142000,983000,-841000,-841000
054716,緯穎康和97購01  ,0,0,0,0,0,0,0,0,0,-848000,0,0,0,284000,1132000,-848000,-848000
2845,遠東銀          ,338000,1178431,-840431,0,0,0,0,0,0,-8000,0,8000,-8000,0,0,0,-848431
060202,康友元富9A購01  ,0,0,0,0,0,0,0,0,0,-859000,0,0,0,0,859000,-859000,-859000
1210,大成            ,256000,1128922,-872922,0,0,0,0,0,0,2000,2000,0,2000,0,0,0,-870922
1217,愛之味          ,147000,1032000,-885000,0,0,0,0,0,0,0,0,0,0,0,0,0,-885000
060288,群光元大9C購01  ,0,0,0,0,0,0,0,0,0,-910000,0,0,0,0,910000,-910000,-910000
1229,聯華            ,650000,1572000,-922000,0,0,0,0,0,0,-1000,0,1000,-1000,0,0,0,-923000
05170P,世芯元大95售01  ,0,0,0,0,0,0,0,0,0,-959000,0,0,0,289000,1248000,-959000,-959000
8150,南茂            ,3359000,4632649,-1273649,0,0,0,0,0,0,312000,36000,0,36000,290000,14000,276000,-961649
1789,神隆            ,326000,1290000,-964000,0,0,0,0,0,0,0,0,0,0,0,0,0,-964000
1102,亞泥            ,4548000,6829014,-2281014,0,0,0,1104000,0,1104000,208000,104000,4000,100000,148000,40000,108000,-969014
052965,廣宇群益97購01  ,0,0,0,0,0,0,0,0,0,-975000,0,0,0,0,975000,-975000,-975000
2903,遠百            ,330000,1328572,-998572,0,0,0,0,0,0,10000,12000,2000,10000,0,0,0,-988572
058143,瑞儀元大99購02  ,0,0,0,0,0,0,0,0,0,-992000,0,0,0,241000,1233000,-992000,-992000
00712,FH富時不動產    ,0,0,0,0,0,0,0,0,0,-1000000,0,0,0,13000,1013000,-1000000,-1000000
055505,新唐元大97購02  ,0,0,0,0,0,0,0,0,0,-1005000,0,0,0,160000,1165000,-1005000,-1005000
058421,國泰金麥證01購01,0,0,0,0,1007000,-1007000,0,0,0,-1007000,0,0,0,0,1007000,-1007000,-1007000
2889,國票金          ,566000,1580000,-1014000,0,0,0,0,0,0,-3000,0,3000,-3000,0,0,0,-1017000
2027,大成鋼          ,1120000,2140029,-1020029,0,0,0,0,0,0,-14000,0,17000,-17000,57000,54000,3000,-1034029
059865,國巨凱基01購01  ,0,0,0,0,0,0,0,0,0,-1039000,0,0,0,620000,1659000,-1039000,-1039000
3034,聯詠            ,1739000,2958000,-1219000,0,0,0,284000,18000,266000,-101000,22000,120000,-98000,28000,31000,-3000,-1054000
057195,南茂元大98購01  ,0,0,0,0,0,0,0,0,0,-1088000,0,0,0,26000,1114000,-1088000,-1088000
2379,瑞昱            ,1487000,2592030,-1105030,0,0,0,59000,10000,49000,-44000,58000,86000,-28000,23000,39000,-16000,-1100030
1904,正隆            ,604000,1205000,-601000,0,0,0,0,500000,-500000,-2000,0,2000,-2000,0,0,0,-1103000
054567,拓凱群益98購01  ,0,0,0,0,0,0,0,0,0,-1130000,0,0,0,0,1130000,-1130000,-1130000
060217,國巨凱基9A購10  ,0,0,0,0,0,0,0,0,0,-1152000,0,0,0,2092000,3244000,-1152000,-1152000
058142,瑞儀元大99購01  ,0,0,0,0,0,0,0,0,0,-1161000,0,0,0,243000,1404000,-1161000,-1161000
2492,華新科          ,1671000,2825000,-1154000,0,0,0,0,0,0,-37000,46000,123000,-77000,132000,92000,40000,-1191000
2385,群光            ,848000,2055165,-1207165,0,0,0,7000,50000,-43000,52000,1000,0,1000,73000,22000,51000,-1198165
00674R,元大S&P黃金反1  ,0,0,0,0,0,0,0,0,0,-1247000,0,0,0,560000,1807000,-1247000,-1247000
4958,臻鼎-KY         ,3286000,5608215,-2322215,0,0,0,952000,137000,815000,233000,240000,26000,214000,20000,1000,19000,-1274215
1314,中石化          ,2824000,4151450,-1327450,0,0,0,0,0,0,33000,2000,12000,-10000,71000,28000,43000,-1294450
3005,神基            ,514000,1882000,-1368000,0,0,0,4000,0,4000,49000,28000,0,28000,21000,0,21000,-1315000
2498,宏達電          ,1119000,2407000,-1288000,0,0,0,0,0,0,-48000,126000,54000,72000,63000,183000,-120000,-1336000
050170,臺指反元大97購02,0,0,0,0,0,0,0,0,0,-1339000,0,0,0,460000,1799000,-1339000,-1339000
2103,台橡            ,1638000,3047220,-1409220,0,0,0,0,0,0,-1000,0,1000,-1000,0,0,0,-1410220
1312,國喬            ,371000,1727000,-1356000,0,0,0,0,0,0,-78000,4000,82000,-78000,0,0,0,-1434000
2412,中華電          ,4118000,5250144,-1132144,0,0,0,0,330000,-330000,10000,23000,10000,13000,0,3000,-3000,-1452144
059395,T50反1元富99購03,0,0,0,0,0,0,0,0,0,-1465000,0,0,0,221000,1686000,-1465000,-1465000
2002,中鋼            ,7387000,8865667,-1478667,0,0,0,0,0,0,-63000,0,63000,-63000,0,0,0,-1541667
00655L,國泰中國A50正2  ,104000,181000,-77000,0,0,0,0,0,0,-1596000,0,0,0,3886000,5482000,-1596000,-1673000
2382,廣達            ,4358000,5948000,-1590000,0,0,0,0,0,0,-99000,4000,94000,-90000,15000,24000,-9000,-1689000
00648R,元大S&P500反1   ,520000,92000,428000,0,0,0,0,180000,-180000,-1969000,0,0,0,513000,2482000,-1969000,-1721000
057940,和大國票99購01  ,0,0,0,0,0,0,0,0,0,-1730000,0,0,0,616000,2346000,-1730000,-1730000
2313,華通            ,3206000,10662000,-7456000,0,0,0,2902000,0,2902000,2750000,2230000,131000,2099000,805000,154000,651000,-1804000
3706,神達            ,795000,2356529,-1561529,0,0,0,0,260000,-260000,-31000,0,52000,-52000,21000,0,21000,-1852529
2618,長榮航          ,5502786,7623139,-2120353,0,0,0,0,0,0,222000,115000,77000,38000,273000,89000,184000,-1898353
2474,可成            ,1369030,3435000,-2065970,0,0,0,10000,0,10000,131000,134000,38000,96000,39000,4000,35000,-1924970
059560,T50反1凱基99購08,0,0,0,0,0,0,0,0,0,-2078000,0,0,0,330000,2408000,-2078000,-2078000
1504,東元            ,701000,2854082,-2153082,0,0,0,0,0,0,17000,33000,16000,17000,0,0,0,-2136082
3231,緯創            ,5544000,7749984,-2205984,0,0,0,0,0,0,52000,415000,334000,81000,51000,80000,-29000,-2153984
00664R,國泰臺灣加權反1 ,0,60000,-60000,0,0,0,0,0,0,-2173000,0,0,0,1376000,3549000,-2173000,-2233000
060142,臺指反國票9B購01,0,0,0,0,0,0,0,0,0,-2413000,0,0,0,0,2413000,-2413000,-2413000
8046,南電            ,2027000,3181000,-1154000,0,0,0,626000,2253000,-1627000,293000,135000,15000,120000,273000,100000,173000,-2488000
2812,台中銀          ,388000,2871348,-2483348,0,0,0,0,0,0,-6000,0,6000,-6000,0,0,0,-2489348
2892,第一金          ,8725000,11239333,-2514333,0,0,0,0,0,0,-8000,1000,1000,0,0,8000,-8000,-2522333
2801,彰銀            ,5041000,6396720,-1355720,0,0,0,0,0,0,-1192000,11000,138000,-127000,0,1065000,-1065000,-2547720
00653L,富邦印度正2     ,6000,0,6000,0,0,0,0,0,0,-2664000,0,0,0,56000,2720000,-2664000,-2658000
00642U,元大S&P石油     ,26000,159000,-133000,0,0,0,0,0,0,-2618000,0,145000,-145000,1587000,4060000,-2473000,-2751000
1909,榮成            ,665000,3362000,-2697000,0,0,0,6000,0,6000,-69000,0,69000,-69000,0,0,0,-2760000
057675,同欣電元大98購02,0,0,0,0,0,0,0,0,0,-2800000,0,0,0,150000,2950000,-2800000,-2800000
2301,光寶科          ,3345000,6314692,-2969692,0,0,0,0,0,0,164000,181000,8000,173000,19000,28000,-9000,-2805692
2885,元大金          ,9537000,12814490,-3277490,0,0,0,0,0,0,238646,150000,10000,140000,99000,354,98646,-3038844
038489,T50反1台新9A購01,0,0,0,0,0,0,0,0,0,-3185000,0,0,0,0,3185000,-3185000,-3185000
2317,鴻海            ,16310000,19428212,-3118212,0,0,0,0,1078000,-1078000,739000,272000,82000,190000,698000,149000,549000,-3457212
00693U,街口S&P黃豆     ,0,0,0,0,0,0,0,0,0,-3511000,0,0,0,0,3511000,-3511000,-3511000
2352,佳世達          ,551000,4047000,-3496000,0,0,0,0,0,0,-51000,4000,55000,-51000,0,0,0,-3547000
00633L,富邦上証正2     ,2367000,3826000,-1459000,0,0,0,0,0,0,-2621000,139000,0,139000,2452000,5212000,-2760000,-4080000
2887,台新金          ,6938000,11183353,-4245353,0,0,0,0,350000,-350000,25000,17000,0,17000,8000,0,8000,-4570353
2353,宏碁            ,5646040,9709468,-4063428,0,0,0,0,0,0,-537000,136000,615000,-479000,0,58000,-58000,-4600428
9904,寶成            ,3570000,8205963,-4635963,0,0,0,0,0,0,-3000,3000,4000,-1000,0,2000,-2000,-4638963
1402,遠東新          ,3078000,8560840,-5482840,0,0,0,925000,0,925000,-278000,0,278000,-278000,0,0,0,-4835840
2881,富邦金          ,7869000,12838000,-4969000,0,0,0,0,87000,-87000,32000,5000,1000,4000,28000,0,28000,-5024000
2610,華航            ,3631000,9344000,-5713000,0,0,0,0,0,0,74000,4000,0,4000,70000,0,70000,-5639000
2823,中壽            ,4143000,9877296,-5734296,0,0,0,0,0,0,57000,4000,5000,-1000,123000,65000,58000,-5677296
2344,華邦電          ,9268000,15758771,-6490771,0,0,0,0,0,0,653000,504000,205000,299000,904000,550000,354000,-5837771
2891,中信金          ,15067000,24383825,-9316825,0,0,0,141000,0,141000,1000,5000,6000,-1000,2000,0,2000,-9174825
2303,聯電            ,86729526,97675763,-10946237,0,0,0,0,1507000,-1507000,1476000,1255000,259000,996000,556000,76000,480000,-10977237
00669R,國泰美國道瓊反1 ,207000,208000,-1000,0,0,0,0,0,0,-14077000,0,0,0,2155000,16232000,-14077000,-14078000
2886,兆豐金          ,8249320,19660362,-11411042,0,0,0,143000,3713000,-3570000,-32000,24000,44000,-20000,27000,39000,-12000,-15013042
00715L,街口布蘭特油正2 ,47000,11000,36000,0,0,0,0,0,0,-16334000,0,0,0,222000,16556000,-16334000,-16298000
00637L,元大滬深300正2  ,6932000,28356000,-21424000,0,0,0,0,0,0,-5752000,180000,0,180000,17496000,23428000,-5932000,-27176000
