證券代號,證券名稱,外陸資買進股數(不含外資自營商),外陸資賣出股數(不含外資自營商),外陸資買賣超股數(不含外資自營商),外資自營商買進股數,外資自營商賣出股數,外資自營商買賣超股數,投信買進股數,投信賣出股數,投信買賣超股數,自營商買賣超股數,自營商買進股數(自行買賣),自營商賣出股數(自行買賣),自營商買賣超股數(自行買賣),自營商買進股數(避險),自營商賣出股數(避險),自營商買賣超股數(避險),三大法人買賣超股數
00637L,元大滬深300正2  ,11755000,5065000,6690000,0,0,0,0,0,0,12659000,0,0,0,29494000,16835000,12659000,19349000
2317,鴻海            ,20653000,9672209,10980791,0,0,0,317000,0,317000,-358000,374000,587000,-213000,343000,488000,-145000,10939791
00852L,國泰美國道瓊正2 ,40000,764000,-724000,0,0,0,0,0,0,9651000,0,0,0,10893000,1242000,9651000,8927000
3037,欣興            ,12310000,6230000,6080000,0,0,0,2570000,0,2570000,72000,1071000,527000,544000,249000,721000,-472000,8722000
4142,國光生          ,12571000,5085000,7486000,0,0,0,0,0,0,-35000,0,35000,-35000,0,0,0,7451000
6213,聯茂            ,6303400,1133000,5170400,0,0,0,1250000,182000,1068000,1044000,779000,131000,648000,497000,101000,396000,7282400
00632R,元大台灣50反1   ,7890000,0,7890000,0,0,0,0,0,0,-1073762,550000,3400000,-2850000,19671238,17895000,1776238,6816238
8150,南茂            ,6370000,710541,5659459,0,0,0,0,0,0,233000,0,40000,-40000,302000,29000,273000,5892459
0056,元大高股息      ,14100,8000,6100,0,0,0,46000,0,46000,4363000,15000,20000,-5000,5418000,1050000,4368000,4415100
2883,開發金          ,10455000,6848400,3606600,0,0,0,20000,0,20000,-28000,8000,3000,5000,0,33000,-33000,3598600
00633L,富邦上証正2     ,2630000,1517000,1113000,0,0,0,0,0,0,2424000,0,0,0,5723000,3299000,2424000,3537000
2344,華邦電          ,5409000,1971000,3438000,0,0,0,0,0,0,-96000,156000,70000,86000,138000,320000,-182000,3342000
00861,元大全球未來通訊,1133000,0,1133000,0,0,0,0,0,0,2095000,0,0,0,2658000,563000,2095000,3228000
2383,台光電          ,2513000,1241050,1271950,0,0,0,863000,0,863000,975000,701000,37000,664000,375000,64000,311000,3109950
2421,建準            ,4338000,1597000,2741000,0,0,0,420000,0,420000,-186000,21000,179000,-158000,116000,144000,-28000,2975000
2382,廣達            ,3650000,1528333,2121667,0,0,0,617000,3000,614000,238000,230000,2000,228000,82000,72000,10000,2973667
2504,國產            ,3665000,1066000,2599000,0,0,0,0,0,0,169000,344000,0,344000,1000,176000,-175000,2768000
056664,上証反中信9B購01,0,0,0,0,0,0,0,0,0,2730000,0,0,0,2750000,20000,2730000,2730000
2412,中華電          ,5250462,2037000,3213462,0,0,0,5000,572000,-567000,2000,31000,16000,15000,0,13000,-13000,2648462
3711,日月光投控      ,4705752,2407000,2298752,0,0,0,5000,4000,1000,-85000,20000,40000,-20000,0,65000,-65000,2214752
2882,國泰金          ,6740000,4524716,2215284,0,0,0,11000,0,11000,-135000,0,167000,-167000,92000,60000,32000,2091284
057475,聯電元大9A購01  ,0,0,0,0,0,0,0,0,0,2012000,0,0,0,2122000,110000,2012000,2012000
4938,和碩            ,3904000,2312000,1592000,0,0,0,503000,3000,500000,-105000,1000,44000,-43000,28000,90000,-62000,1987000
055564,茂林凱基98購01  ,0,0,0,0,0,0,0,0,0,1930000,0,0,0,1930000,0,1930000,1930000
2614,東森            ,2353000,539000,1814000,0,0,0,0,0,0,0,0,0,0,0,0,0,1814000
054633,臺股指凱基9A購02,0,0,0,0,0,0,0,0,0,1798000,0,0,0,1798000,0,1798000,1798000
053675,臺股指元富96購02,0,0,0,0,0,0,0,0,0,1733000,0,0,0,1733000,0,1733000,1733000
00875,國泰網路資安    ,1298000,10000,1288000,0,0,0,0,0,0,432000,0,0,0,1196000,764000,432000,1720000
2301,光寶科          ,4657408,3584234,1073174,0,0,0,503000,0,503000,83000,157000,0,157000,0,74000,-74000,1659174
2455,全新            ,1981000,1118000,863000,0,0,0,265000,0,265000,524000,112000,2000,110000,430000,16000,414000,1652000
1210,大成            ,1205000,520000,685000,0,0,0,800000,0,800000,164000,176000,12000,164000,0,0,0,1649000
3006,晶豪科          ,2873000,797000,2076000,0,0,0,0,235000,-235000,-393000,12000,15000,-3000,142000,532000,-390000,1448000
1714,和桐            ,2869000,1425000,1444000,0,0,0,0,0,0,0,0,0,0,0,0,0,1444000
2363,矽統            ,1719000,309000,1410000,0,0,0,0,0,0,0,0,0,0,0,0,0,1410000
6239,力成            ,2773000,2123500,649500,0,0,0,458000,0,458000,296000,84000,26000,58000,246000,8000,238000,1403500
056559,華通群益98購02  ,0,0,0,0,0,0,0,0,0,1403000,0,0,0,1757000,354000,1403000,1403000
2368,金像電          ,5327000,3707000,1620000,0,0,0,100000,0,100000,-332000,640000,804000,-164000,19000,187000,-168000,1388000
053935,華通元富96購02  ,0,0,0,0,0,0,0,0,0,1371000,0,0,0,1383000,12000,1371000,1371000
054377,臺股指中信99購09,0,0,0,0,0,0,0,0,0,1348000,0,0,0,1348000,0,1348000,1348000
2353,宏碁            ,5693664,3581000,2112664,0,0,0,0,0,0,-783000,74000,483000,-409000,12000,386000,-374000,1329664
06852P,臺股指元大98售11,0,0,0,0,0,0,0,0,0,1296000,0,0,0,2361000,1065000,1296000,1296000
056240,嘉晶群益97購02  ,0,0,0,0,0,0,0,0,0,1295000,0,0,0,1409000,114000,1295000,1295000
055644,致茂元富97購01  ,0,0,0,0,0,0,0,0,0,1279000,0,0,0,1279000,0,1279000,1279000
058327,大毅統一9B購01  ,0,0,0,0,0,0,0,0,0,1247000,0,0,0,1343000,96000,1247000,1247000
2474,可成            ,2661000,1836261,824739,0,0,0,301000,0,301000,120000,103000,68000,35000,116000,31000,85000,1245739
061118,GIS富邦9A購01   ,0,0,0,0,0,0,0,0,0,1244000,0,0,0,1277000,33000,1244000,1244000
8046,南電            ,2489000,1628158,860842,0,0,0,506000,220000,286000,93000,162000,72000,90000,78000,75000,3000,1239842
6706,惠特            ,396000,94000,302000,0,0,0,1071000,0,1071000,-147000,41000,188000,-147000,0,0,0,1226000
060191,亞光元富9A購02  ,0,0,0,0,0,0,0,0,0,1225000,0,0,0,1303000,78000,1225000,1225000
059155,台表科日盛99購01,0,0,0,0,0,0,0,0,0,1160000,0,0,0,1770000,610000,1160000,1160000
2103,台橡            ,1654000,497000,1157000,0,0,0,0,0,0,0,0,0,0,0,0,0,1157000
3596,智易            ,317000,616000,-299000,0,0,0,1377000,0,1377000,78000,0,9000,-9000,193000,106000,87000,1156000
060917,台表科國泰9B購01,0,0,0,0,0,0,0,0,0,1147000,0,0,0,1450000,303000,1147000,1147000
053939,台表科元富96購03,0,0,0,0,0,0,0,0,0,1085000,0,0,0,1135000,50000,1085000,1085000
2867,三商壽          ,2123000,1044000,1079000,0,0,0,0,0,0,0,0,0,0,0,0,0,1079000
058105,旺宏統一9A購02  ,0,0,0,0,0,0,0,0,0,1046000,0,0,0,1087000,41000,1046000,1046000
2823,中壽            ,4420000,3513300,906700,0,0,0,5000,0,5000,128000,242000,2000,240000,2000,114000,-112000,1039700
2379,瑞昱            ,2532000,1408553,1123447,0,0,0,0,10000,-10000,-85000,31000,60000,-29000,17000,73000,-56000,1028447
3189,景碩            ,1120000,513000,607000,0,0,0,0,0,0,411000,214000,0,214000,302000,105000,197000,1018000
6412,群電            ,1283000,261100,1021900,0,0,0,0,0,0,-9000,0,0,0,0,9000,-9000,1012900
057467,祥碩永豐98購04  ,0,0,0,0,0,0,0,0,0,1012000,0,0,0,1022000,10000,1012000,1012000
051356,全新元大96購04  ,0,0,0,0,0,0,0,0,0,1000000,0,0,0,1000000,0,1000000,1000000
051259,鴻海永昌96購03  ,0,0,0,0,0,0,0,0,0,998000,0,0,0,998000,0,998000,998000
00655L,國泰中國A50正2  ,539000,109000,430000,0,0,0,0,0,0,562000,0,0,0,2037000,1475000,562000,992000
00712,FH富時不動產    ,827000,0,827000,0,0,0,0,0,0,152000,0,0,0,247000,95000,152000,979000
053431,志超永豐96購01  ,0,0,0,0,0,0,0,0,0,964000,0,0,0,964000,0,964000,964000
057527,億光元大98購01  ,0,0,0,0,0,0,0,0,0,963000,0,0,0,1056000,93000,963000,963000
044201,群創國票95購01  ,0,0,0,0,0,0,0,0,0,943000,0,0,0,943000,0,943000,943000
00738U,元大道瓊白銀    ,23000,19000,4000,0,0,0,0,0,0,927000,0,0,0,1459000,532000,927000,931000
2338,光罩            ,1437000,605000,832000,0,0,0,0,0,0,99000,10000,15000,-5000,333000,229000,104000,931000
1325,恆大            ,310000,6000,304000,0,0,0,0,0,0,585000,45000,0,45000,540000,0,540000,889000
6251,定穎            ,4904000,4057000,847000,0,0,0,0,0,0,40000,40000,0,40000,0,0,0,887000
047564,滬深2X國票99購01,0,0,0,0,0,0,0,0,0,877000,0,0,0,1442000,565000,877000,877000
058312,大毅國泰9B購01  ,0,0,0,0,0,0,0,0,0,858000,0,0,0,858000,0,858000,858000
0050,元大台灣50      ,614000,820035,-206035,0,0,0,42000,205000,-163000,1217000,26000,60000,-34000,2161000,910000,1251000,847965
060431,復盛永豐9A購01  ,0,0,0,0,0,0,0,0,0,842000,0,0,0,842000,0,842000,842000
4956,光鋐            ,0,63000,-63000,0,0,0,0,0,0,883000,0,0,0,883000,0,883000,820000
3406,玉晶光          ,1024000,674792,349208,0,0,0,53000,0,53000,395000,425000,142000,283000,193000,81000,112000,797208
6112,聚碩            ,823000,90000,733000,0,0,0,0,0,0,62000,62000,0,62000,0,0,0,795000
2102,泰豐            ,1283000,490000,793000,0,0,0,0,0,0,0,0,0,0,0,0,0,793000
060434,台汽電永豐9A購01,0,0,0,0,0,0,0,0,0,792000,0,0,0,812000,20000,792000,792000
061159,同欣電群益9A購01,0,0,0,0,0,0,0,0,0,792000,0,0,0,2129000,1337000,792000,792000
6257,矽格            ,1034000,478000,556000,0,0,0,0,0,0,229000,212000,20000,192000,39000,2000,37000,785000
020012,富邦行動通訊N   ,0,0,0,0,0,0,0,0,0,774000,0,0,0,777000,3000,774000,774000
055420,欣興永豐98購01  ,0,0,0,0,0,0,0,0,0,764000,0,0,0,825000,61000,764000,764000
052738,聯電元大98購02  ,0,0,0,0,0,0,0,0,0,763000,0,0,0,763000,0,763000,763000
6116,彩晶            ,2169000,855000,1314000,0,0,0,0,0,0,-561000,0,8000,-8000,74000,627000,-553000,753000
061708,同欣電國票9A購02,0,0,0,0,0,0,0,0,0,752000,0,0,0,1275000,523000,752000,752000
058576,南亞科群益99購01,0,0,0,0,0,0,0,0,0,749000,0,0,0,847000,98000,749000,749000
055657,超眾元富97購02  ,0,0,0,0,0,0,0,0,0,748000,0,0,0,1013000,265000,748000,748000
057202,TPK元富98購02   ,0,0,0,0,0,0,0,0,0,735000,0,0,0,735000,0,735000,735000
057723,臺股指元富98購02,0,0,0,0,0,0,0,0,0,727000,0,0,0,727000,0,727000,727000
061915,T50反1凱基02購02,0,0,0,0,0,0,0,0,0,718000,0,0,0,880000,162000,718000,718000
060422,台勝科永豐9A購01,0,0,0,0,0,0,0,0,0,714000,0,0,0,756000,42000,714000,714000
053398,和鑫中信99購01  ,0,0,0,0,0,0,0,0,0,708000,0,0,0,738000,30000,708000,708000
00647L,元大S&P500正2   ,8000,8000,0,0,0,0,0,0,0,699000,18000,0,18000,1070000,389000,681000,699000
061371,嘉澤國泰9C購01  ,0,0,0,0,0,0,0,0,0,697000,0,0,0,774000,77000,697000,697000
00830,國泰費城半導體  ,1063000,3000,1060000,0,0,0,0,0,0,-364000,0,0,0,296000,660000,-364000,696000
050571,美食中信95購01  ,0,0,0,0,0,0,0,0,0,680000,0,0,0,680000,0,680000,680000
3481,群創            ,13587000,12152000,1435000,0,0,0,0,0,0,-763000,114000,40000,74000,223000,1060000,-837000,672000
8039,台虹            ,791000,191000,600000,0,0,0,0,0,0,67000,6000,0,6000,141000,80000,61000,667000
062020,智伸科永豐9B購01,0,0,0,0,0,0,0,0,0,664000,0,0,0,810000,146000,664000,664000
055509,訊芯元大97購03  ,0,0,0,0,0,0,0,0,0,663000,0,0,0,663000,0,663000,663000
1215,卜蜂            ,719000,315000,404000,0,0,0,160000,0,160000,95000,0,0,0,129000,34000,95000,659000
00646,元大S&P500      ,232000,0,232000,0,0,0,0,0,0,418000,0,0,0,537000,119000,418000,650000
055041,致新富邦97購01  ,0,0,0,0,0,0,0,0,0,649000,0,0,0,649000,0,649000,649000
3034,聯詠            ,2672000,1981000,691000,0,0,0,23000,0,23000,-65000,82000,106000,-24000,37000,78000,-41000,649000
1101,台泥            ,4965663,4373331,592332,0,0,0,7000,0,7000,48000,160000,0,160000,31000,143000,-112000,647332
056177,嘉澤元富97購01  ,0,0,0,0,0,0,0,0,0,644000,0,0,0,694000,50000,644000,644000
055419,國巨永豐97購03  ,0,0,0,0,0,0,0,0,0,639000,0,0,0,639000,0,639000,639000
061437,燿華凱基9A購01  ,0,0,0,0,0,0,0,0,0,634000,0,0,0,644000,10000,634000,634000
048595,儒鴻國票96購01  ,0,0,0,0,0,0,0,0,0,625000,0,0,0,625000,0,625000,625000
057972,群創富邦9C購01  ,0,0,0,0,0,0,0,0,0,623000,0,0,0,853000,230000,623000,623000
061589,世紀鋼富邦9B購01,0,0,0,0,0,0,0,0,0,618000,0,0,0,714000,96000,618000,618000
056138,群創元大9B購01  ,0,0,0,0,0,0,0,0,0,602000,0,0,0,602000,0,602000,602000
060784,鴻海富邦9C購01  ,0,0,0,0,0,0,0,0,0,599000,0,0,0,672000,73000,599000,599000
07162P,臺股指群益99售13,0,0,0,0,0,0,0,0,0,597000,0,0,0,844000,247000,597000,597000
061146,台表科中信9A購02,0,0,0,0,0,0,0,0,0,596000,0,0,0,749000,153000,596000,596000
062012,燿華富邦9C購01  ,0,0,0,0,0,0,0,0,0,595000,0,0,0,608000,13000,595000,595000
058497,新日興群益9B購01,0,0,0,0,0,0,0,0,0,592000,0,0,0,616000,24000,592000,592000
057324,億光群益98購01  ,0,0,0,0,0,0,0,0,0,592000,0,0,0,601000,9000,592000,592000
053403,彩晶群益98購01  ,0,0,0,0,0,0,0,0,0,591000,0,0,0,687000,96000,591000,591000
2889,國票金          ,812000,222000,590000,0,0,0,0,0,0,0,0,0,0,0,0,0,590000
061659,信邦永豐9A購01  ,0,0,0,0,0,0,0,0,0,587000,0,0,0,670000,83000,587000,587000
00631L,元大台灣50正2   ,271000,259000,12000,0,0,0,0,0,0,575000,0,200000,-200000,3922000,3147000,775000,587000
00737,國泰AI+Robo     ,310000,0,310000,0,0,0,0,0,0,277000,0,0,0,531000,254000,277000,587000
060684,同欣電元大9A購01,0,0,0,0,0,0,0,0,0,585000,0,0,0,1129000,544000,585000,585000
054533,泰碩國泰98購01  ,0,0,0,0,0,0,0,0,0,582000,0,0,0,772000,190000,582000,582000
061269,嘉澤凱基9A購01  ,0,0,0,0,0,0,0,0,0,578000,0,0,0,588000,10000,578000,578000
057096,緯穎元富98購01  ,0,0,0,0,0,0,0,0,0,572000,0,0,0,572000,0,572000,572000
056420,台表科元富98購01,0,0,0,0,0,0,0,0,0,567000,0,0,0,697000,130000,567000,567000
059400,滬深2X元富9C購04,0,0,0,0,0,0,0,0,0,565000,0,0,0,804000,239000,565000,565000
059005,嘉晶元大99購06  ,0,0,0,0,0,0,0,0,0,561000,0,0,0,711000,150000,561000,561000
00640L,富邦日本正2     ,0,0,0,0,0,0,0,0,0,556000,0,0,0,971000,415000,556000,556000
061856,台郡國票9B購02  ,0,0,0,0,0,0,0,0,0,553000,0,0,0,553000,0,553000,553000
061145,臻鼎中信9A購02  ,0,0,0,0,0,0,0,0,0,553000,0,0,0,825000,272000,553000,553000
055051,藍天永豐97購01  ,0,0,0,0,0,0,0,0,0,549000,0,0,0,549000,0,549000,549000
049007,玉晶光中信96購01,0,0,0,0,0,0,0,0,0,546000,0,0,0,1306000,760000,546000,546000
061366,台勝科國票9A購01,0,0,0,0,0,0,0,0,0,544000,0,0,0,629000,85000,544000,544000
061634,遠東新元大9A購01,0,0,0,0,0,0,0,0,0,544000,0,0,0,944000,400000,544000,544000
060547,瑞昱凱基9A購01  ,0,0,0,0,0,0,0,0,0,543000,0,0,0,566000,23000,543000,543000
059943,信邦永豐99購01  ,0,0,0,0,0,0,0,0,0,540000,0,0,0,595000,55000,540000,540000
052777,燿華國票98購01  ,0,0,0,0,0,0,0,0,0,536000,0,0,0,536000,0,536000,536000
060416,神隆永豐9A購01  ,0,0,0,0,0,0,0,0,0,535000,0,0,0,551000,16000,535000,535000
07342P,大立光凱基99售14,0,0,0,0,0,0,0,0,0,535000,0,0,0,895000,360000,535000,535000
059945,嘉澤永豐99購03  ,0,0,0,0,0,0,0,0,0,534000,0,0,0,643000,109000,534000,534000
058910,泰鼎元大99購03  ,0,0,0,0,0,0,0,0,0,533000,0,0,0,608000,75000,533000,533000
057940,和大國票99購01  ,0,0,0,0,0,0,0,0,0,533000,0,0,0,573000,40000,533000,533000
056189,樺漢統一97購02  ,0,0,0,0,0,0,0,0,0,526000,0,0,0,526000,0,526000,526000
058156,超眾統一9A購02  ,0,0,0,0,0,0,0,0,0,522000,0,0,0,744000,222000,522000,522000
061164,燿華兆豐9B購01  ,0,0,0,0,0,0,0,0,0,519000,0,0,0,834000,315000,519000,519000
049236,元油2X元富96購06,0,0,0,0,0,0,0,0,0,519000,0,0,0,519000,0,519000,519000
061640,智原元大9A購01  ,0,0,0,0,0,0,0,0,0,513000,0,0,0,569000,56000,513000,513000
060008,華邦電群益9A購01,0,0,0,0,0,0,0,0,0,513000,0,0,0,625000,112000,513000,513000
041527,T50反1中信96購01,0,0,0,0,0,0,0,0,0,511000,0,0,0,511000,0,511000,511000
9136,巨騰-DR         ,508000,0,508000,0,0,0,0,0,0,0,0,0,0,0,0,0,508000
2395,研華            ,1336000,830227,505773,0,0,0,0,0,0,0,0,0,0,0,0,0,505773
1477,聚陽            ,486000,377000,109000,0,0,0,366000,0,366000,29000,5000,1000,4000,25000,0,25000,504000
00635U,元大S&P黃金     ,318000,1000,317000,0,0,0,0,0,0,185000,0,50000,-50000,429000,194000,235000,502000
052752,臺股指元大96購06,0,0,0,0,0,0,0,0,0,499000,0,0,0,499000,0,499000,499000
055000,玉晶光元富97購04,0,0,0,0,0,0,0,0,0,499000,0,0,0,499000,0,499000,499000
053971,聯發科元大97購09,0,0,0,0,0,0,0,0,0,499000,0,0,0,499000,0,499000,499000
061567,華通元大9A購11  ,0,0,0,0,0,0,0,0,0,498000,0,0,0,599000,101000,498000,498000
062096,神隆永豐9B購01  ,0,0,0,0,0,0,0,0,0,493000,0,0,0,499000,6000,493000,493000
055026,健和興國泰98購01,0,0,0,0,0,0,0,0,0,493000,0,0,0,493000,0,493000,493000
056786,亞光群益98購03  ,0,0,0,0,0,0,0,0,0,493000,0,0,0,526000,33000,493000,493000
060616,宏碁元大9A購02  ,0,0,0,0,0,0,0,0,0,491000,0,0,0,501000,10000,491000,491000
05966P,矽力凱基96售03  ,0,0,0,0,0,0,0,0,0,490000,0,0,0,730000,240000,490000,490000
1762,中化生          ,1028000,1045000,-17000,0,0,0,485000,0,485000,21000,22000,1000,21000,0,0,0,489000
056882,華邦電康和98購01,0,0,0,0,0,0,0,0,0,486000,0,0,0,486000,0,486000,486000
045189,大立光元富98購01,0,0,0,0,0,0,0,0,0,485000,0,0,0,485000,0,485000,485000
058209,臺股指凱基01購01,0,0,0,0,0,0,0,0,0,485000,0,0,0,485000,0,485000,485000
057356,彩晶統一98購04  ,0,0,0,0,0,0,0,0,0,483000,0,0,0,483000,0,483000,483000
053625,國巨兆豐96購03  ,0,0,0,0,0,0,0,0,0,482000,0,0,0,482000,0,482000,482000
060654,大毅群益9B購01  ,0,0,0,0,0,0,0,0,0,480000,0,0,0,512000,32000,480000,480000
060857,旭富富邦9B購01  ,0,0,0,0,0,0,0,0,0,480000,0,0,0,876000,396000,480000,480000
07470P,國巨元大9A售06  ,0,0,0,0,0,0,0,0,0,479000,0,0,0,481000,2000,479000,479000
061477,晶豪科元大9A購01,0,0,0,0,0,0,0,0,0,477000,0,0,0,676000,199000,477000,477000
00850,元大臺灣ESG永續 ,0,2000,-2000,0,0,0,0,0,0,476000,50000,0,50000,687000,261000,426000,474000
058727,嘉晶富邦9A購01  ,0,0,0,0,0,0,0,0,0,474000,0,0,0,524000,50000,474000,474000
056638,臺股指日盛98購01,0,0,0,0,0,0,0,0,0,473000,0,0,0,1034000,561000,473000,473000
060934,台汽電永豐9A購02,0,0,0,0,0,0,0,0,0,471000,0,0,0,471000,0,471000,471000
059581,日月光元富99購02,0,0,0,0,0,0,0,0,0,471000,0,0,0,703000,232000,471000,471000
053357,可成統一96購02  ,0,0,0,0,0,0,0,0,0,467000,0,0,0,467000,0,467000,467000
060489,世紀鋼群益9A購01,0,0,0,0,0,0,0,0,0,465000,0,0,0,547000,82000,465000,465000
059095,訊芯元大99購01  ,0,0,0,0,0,0,0,0,0,465000,0,0,0,522000,57000,465000,465000
1201,味全            ,738000,297000,441000,0,0,0,0,0,0,24000,0,0,0,73000,49000,24000,465000
059395,T50反1元富99購03,0,0,0,0,0,0,0,0,0,463000,0,0,0,764000,301000,463000,463000
060896,晶技凱基9A購02  ,0,0,0,0,0,0,0,0,0,462000,0,0,0,643000,181000,462000,462000
2231,為升            ,537000,105247,431753,0,0,0,0,0,0,29000,7000,0,7000,43000,21000,22000,460753
059781,A50正2元大9C購03,0,0,0,0,0,0,0,0,0,460000,0,0,0,468000,8000,460000,460000
054808,東元元大9A購01  ,0,0,0,0,0,0,0,0,0,459000,0,0,0,527000,68000,459000,459000
060995,泰鼎元大9A購03  ,0,0,0,0,0,0,0,0,0,456000,0,0,0,551000,95000,456000,456000
051630,力山國票96購01  ,0,0,0,0,0,0,0,0,0,456000,0,0,0,456000,0,456000,456000
049153,大立光元大96購02,0,0,0,0,0,0,0,0,0,455000,0,0,0,455000,0,455000,455000
9919,康那香          ,171000,0,171000,0,0,0,0,0,0,284000,175000,0,175000,109000,0,109000,455000
053029,國巨第一96購01  ,0,0,0,0,0,0,0,0,0,450000,0,0,0,450000,0,450000,450000
056012,勤誠中信99購01  ,0,0,0,0,0,0,0,0,0,450000,0,0,0,510000,60000,450000,450000
057300,訊連永豐98購01  ,0,0,0,0,0,0,0,0,0,449000,0,0,0,449000,0,449000,449000
054913,億光凱基97購01  ,0,0,0,0,0,0,0,0,0,445000,0,0,0,445000,0,445000,445000
059884,鴻海國票99購09  ,0,0,0,0,0,0,0,0,0,444000,0,0,0,514000,70000,444000,444000
056178,嘉澤元富97購02  ,0,0,0,0,0,0,0,0,0,442000,0,0,0,442000,0,442000,442000
8016,矽創            ,777000,417000,360000,0,0,0,0,0,0,80000,0,1000,-1000,104000,23000,81000,440000
060233,宏碁元大9A購01  ,0,0,0,0,0,0,0,0,0,437000,0,0,0,593000,156000,437000,437000
059004,嘉晶元大99購05  ,0,0,0,0,0,0,0,0,0,437000,0,0,0,472000,35000,437000,437000
061065,神基凱基9A購01  ,0,0,0,0,0,0,0,0,0,434000,0,0,0,591000,157000,434000,434000
048383,元金2X國票99購01,0,0,0,0,0,0,0,0,0,434000,0,0,0,457000,23000,434000,434000
2347,聯強            ,1238000,926159,311841,0,0,0,230000,0,230000,-109000,0,14000,-14000,0,95000,-95000,432841
3008,大立光          ,808969,404000,404969,0,0,0,29000,1000,28000,-1000,3000,8000,-5000,9000,5000,4000,431969
03678C,臺股指凱基01牛02,0,0,0,0,0,0,0,0,0,431000,0,0,0,511000,80000,431000,431000
061430,致新元大9A購01  ,0,0,0,0,0,0,0,0,0,429000,0,0,0,606000,177000,429000,429000
061483,TPK元大9A購01   ,0,0,0,0,0,0,0,0,0,429000,0,0,0,429000,0,429000,429000
061511,緯穎富邦9B購02  ,0,0,0,0,0,0,0,0,0,429000,0,0,0,634000,205000,429000,429000
060907,金像電元大9A購02,0,0,0,0,0,0,0,0,0,427000,0,0,0,461000,34000,427000,427000
060758,台積電元大9A購19,0,0,0,0,0,0,0,0,0,424000,0,0,0,653000,229000,424000,424000
062018,台勝科永豐9B購01,0,0,0,0,0,0,0,0,0,424000,0,0,0,479000,55000,424000,424000
055444,致新台新97購01  ,0,0,0,0,0,0,0,0,0,424000,0,0,0,434000,10000,424000,424000
053973,晶豪科元大96購01,0,0,0,0,0,0,0,0,0,424000,0,0,0,452000,28000,424000,424000
061351,智伸科元大9A購01,0,0,0,0,0,0,0,0,0,423000,0,0,0,541000,118000,423000,423000
06864P,健策凱基98售01  ,0,0,0,0,0,0,0,0,0,422000,0,0,0,544000,122000,422000,422000
055101,台肥凱基97購01  ,0,0,0,0,0,0,0,0,0,420000,0,0,0,420000,0,420000,420000
1732,毛寶            ,693000,327000,366000,0,0,0,0,0,0,54000,0,0,0,54000,0,54000,420000
1303,南亞            ,2248000,1917600,330400,0,0,0,45000,0,45000,44000,58000,14000,44000,0,0,0,419400
057288,聯茂元大98購03  ,0,0,0,0,0,0,0,0,0,418000,0,0,0,444000,26000,418000,418000
00680L,元大美債20正2   ,0,0,0,0,0,0,0,0,0,417000,0,0,0,428000,11000,417000,417000
060698,旺宏國泰9C購01  ,0,0,0,0,0,0,0,0,0,414000,0,0,0,439000,25000,414000,414000
060788,嘉晶富邦9B購01  ,0,0,0,0,0,0,0,0,0,413000,0,0,0,803000,390000,413000,413000
051721,玉晶光永豐96購02,0,0,0,0,0,0,0,0,0,413000,0,0,0,418000,5000,413000,413000
055874,中環元富9A購01  ,0,0,0,0,0,0,0,0,0,412000,0,0,0,627000,215000,412000,412000
054229,超眾元富96購05  ,0,0,0,0,0,0,0,0,0,410000,0,0,0,548000,138000,410000,410000
051544,T50反1康和98購01,0,0,0,0,0,0,0,0,0,409000,0,0,0,410000,1000,409000,409000
061874,義隆元大9B購02  ,0,0,0,0,0,0,0,0,0,408000,0,0,0,417000,9000,408000,408000
8271,宇瞻            ,711000,304000,407000,0,0,0,0,0,0,0,0,0,0,0,0,0,407000
059706,嘉晶凱基99購01  ,0,0,0,0,0,0,0,0,0,406000,0,0,0,736000,330000,406000,406000
061660,禾伸堂永豐9A購01,0,0,0,0,0,0,0,0,0,404000,0,0,0,698000,294000,404000,404000
054943,群光元大97購01  ,0,0,0,0,0,0,0,0,0,401000,0,0,0,401000,0,401000,401000
061639,晶豪科元大9A購02,1000,0,1000,0,0,0,0,0,0,399000,0,0,0,707000,308000,399000,400000
053401,臺股指中信99購01,0,0,0,0,0,0,0,0,0,400000,0,0,0,400000,0,400000,400000
051904,深100元大95購01 ,0,0,0,0,0,0,0,0,0,399000,0,0,0,400000,1000,399000,399000
2887,台新金          ,4935000,4550056,384944,0,0,0,15000,0,15000,-1000,2000,3000,-1000,4000,4000,0,398944
060706,群創富邦9A購01  ,0,0,0,0,0,0,0,0,0,397000,0,0,0,407000,10000,397000,397000
061283,智邦統一9A購01  ,0,0,0,0,0,0,0,0,0,395000,0,0,0,400000,5000,395000,395000
07354P,臺股指國票99售22,0,0,0,0,0,0,0,0,0,395000,0,0,0,540000,145000,395000,395000
061457,TPK凱基9A購01   ,0,0,0,0,0,0,0,0,0,391000,0,0,0,457000,66000,391000,391000
1710,東聯            ,701000,310000,391000,0,0,0,0,0,0,0,0,0,0,0,0,0,391000
060160,聯陽永豐9A購01  ,0,0,0,0,0,0,0,0,0,390000,0,0,0,396000,6000,390000,390000
060734,華通統一9C購01  ,0,0,0,0,0,0,0,0,0,389000,0,0,0,448000,59000,389000,389000
00701,國泰股利精選30  ,25000,1000,24000,0,0,0,0,0,0,365000,0,0,0,812000,447000,365000,389000
9921,巨大            ,1244050,843000,401050,0,0,0,0,0,0,-13000,0,12000,-12000,0,1000,-1000,388050
058185,國巨永豐99購01  ,0,0,0,0,0,0,0,0,0,385000,0,0,0,435000,50000,385000,385000
060362,建準元富9A購02  ,0,0,0,0,0,0,0,0,0,384000,0,0,0,492000,108000,384000,384000
056028,GIS群益97購02   ,0,0,0,0,0,0,0,0,0,384000,0,0,0,384000,0,384000,384000
057721,華擎元富98購02  ,0,0,0,0,0,0,0,0,0,384000,0,0,0,579000,195000,384000,384000
061749,群創統一9C購02  ,0,0,0,0,0,0,0,0,0,382000,0,0,0,382000,0,382000,382000
054228,貿聯元富96購03  ,0,0,0,0,0,0,0,0,0,382000,0,0,0,382000,0,382000,382000
056582,易華電元大98購01,0,0,0,0,0,0,0,0,0,382000,0,0,0,382000,0,382000,382000
061603,瑞昱凱基9A購02  ,0,0,0,0,0,0,0,0,0,381000,0,0,0,459000,78000,381000,381000
058369,亞光凱基99購02  ,0,0,0,0,0,0,0,0,0,381000,0,0,0,381000,0,381000,381000
061372,世紀鋼國泰9C購01,0,0,0,0,0,0,0,0,0,377000,0,0,0,602000,225000,377000,377000
058050,台郡元大99購05  ,0,0,0,0,0,0,0,0,0,375000,0,0,0,438000,63000,375000,375000
054304,台積電凱基96購23,0,0,0,0,0,0,0,0,0,374000,0,0,0,444000,70000,374000,374000
053501,明泰兆豐96購01  ,0,0,0,0,0,0,0,0,0,373000,0,0,0,374000,1000,373000,373000
058261,大立光富邦03購01,0,0,0,0,0,0,0,0,0,371000,0,0,0,371000,0,371000,371000
055330,上銀兆豐98購02  ,0,0,0,0,0,0,0,0,0,370000,0,0,0,415000,45000,370000,370000
060962,義隆凱基9B購01  ,0,0,0,0,0,0,0,0,0,369000,0,0,0,447000,78000,369000,369000
061149,華通群益9A購05  ,0,0,0,0,0,0,0,0,0,369000,0,0,0,428000,59000,369000,369000
053355,超眾兆豐97購01  ,0,0,0,0,0,0,0,0,0,369000,0,0,0,369000,0,369000,369000
060203,緯穎元富9A購01  ,0,0,0,0,0,0,0,0,0,367000,0,0,0,402000,35000,367000,367000
061021,聯電國泰9B購01  ,0,0,0,0,0,0,0,0,0,365000,0,0,0,375000,10000,365000,365000
060908,金像電元大9A購03,0,0,0,0,0,0,0,0,0,363000,0,0,0,394000,31000,363000,363000
061510,嘉澤富邦9C購01  ,0,0,0,0,0,0,0,0,0,363000,0,0,0,473000,110000,363000,363000
061034,晶豪科永豐9A購01,0,0,0,0,0,0,0,0,0,362000,0,0,0,494000,132000,362000,362000
057824,日月光元大98購01,0,0,0,0,0,0,0,0,0,361000,0,0,0,371000,10000,361000,361000
052704,TPK國票97購01   ,0,0,0,0,0,0,0,0,0,359000,0,0,0,359000,0,359000,359000
006206,元大上證50      ,410000,0,410000,0,0,0,0,0,0,-52000,0,0,0,152000,204000,-52000,358000
055077,臺股指永豐97購02,0,0,0,0,0,0,0,0,0,358000,0,0,0,358000,0,358000,358000
061263,微星凱基9A購01  ,0,0,0,0,0,0,0,0,0,356000,0,0,0,356000,0,356000,356000
059454,亞光永豐99購01  ,0,0,0,0,0,0,0,0,0,356000,0,0,0,463000,107000,356000,356000
061213,群創元大9A購05  ,0,0,0,0,0,0,0,0,0,355000,0,0,0,365000,10000,355000,355000
054383,傳奇群益97購01  ,0,0,0,0,0,0,0,0,0,355000,0,0,0,465000,110000,355000,355000
056980,建準群益98購02  ,0,0,0,0,0,0,0,0,0,354000,0,0,0,374000,20000,354000,354000
059832,超眾康和99購01  ,0,0,0,0,0,0,0,0,0,353000,0,0,0,353000,0,353000,353000
059174,訊芯凱基99購01  ,0,0,0,0,0,0,0,0,0,352000,0,0,0,385000,33000,352000,352000
056680,華通統一98購04  ,0,0,0,0,0,0,0,0,0,352000,0,0,0,352000,0,352000,352000
061132,志超永豐9A購01  ,0,0,0,0,0,0,0,0,0,351000,0,0,0,575000,224000,351000,351000
059637,大立光凱基01購01,0,0,0,0,0,0,0,0,0,351000,0,0,0,353000,2000,351000,351000
054033,欣興中信96購02  ,0,0,0,0,0,0,0,0,0,350000,0,0,0,350000,0,350000,350000
053368,京元電富邦98購01,0,0,0,0,0,0,0,0,0,350000,0,0,0,350000,0,350000,350000
058131,義隆元大99購02  ,0,15000,-15000,0,0,0,0,0,0,365000,0,0,0,598000,233000,365000,350000
058531,華通元富99購01  ,0,0,0,0,0,0,0,0,0,349000,0,0,0,386000,37000,349000,349000
059100,元油2X統一9C購02,0,0,0,0,0,0,0,0,0,348000,0,0,0,348000,0,348000,348000
059675,大立光元富99購08,0,0,0,0,0,0,0,0,0,348000,0,0,0,360000,12000,348000,348000
5471,松翰            ,2748000,2908000,-160000,0,0,0,473000,0,473000,35000,65000,30000,35000,0,0,0,348000
00762,元大全球AI      ,0,0,0,0,0,0,0,0,0,347000,0,0,0,353000,6000,347000,347000
2376,技嘉            ,1018000,599000,419000,0,0,0,60000,272000,-212000,138000,0,6000,-6000,321000,177000,144000,345000
053632,新唐兆豐96購01  ,0,0,0,0,0,0,0,0,0,344000,0,0,0,344000,0,344000,344000
05711P,茂林國票97售03  ,0,0,0,0,0,0,0,0,0,344000,0,0,0,432000,88000,344000,344000
07685P,玉晶光凱基9B售03,0,0,0,0,0,0,0,0,0,344000,0,0,0,404000,60000,344000,344000
060851,國巨國泰9C購01  ,0,0,0,0,0,0,0,0,0,343000,0,0,0,437000,94000,343000,343000
5876,上海商銀        ,1935000,1599954,335046,0,0,0,5000,0,5000,2000,0,0,0,2000,0,2000,342046
3413,京鼎            ,537000,744000,-207000,0,0,0,410000,0,410000,139000,76000,22000,54000,106000,21000,85000,342000
057299,立積永豐98購02  ,0,0,0,0,0,0,0,0,0,341000,0,0,0,369000,28000,341000,341000
056417,欣興中信98購01  ,0,0,0,0,0,0,0,0,0,341000,0,0,0,401000,60000,341000,341000
060449,元金2X元大9A購02,0,0,0,0,0,0,0,0,0,340000,0,0,0,350000,10000,340000,340000
055053,瑞昱永豐97購01  ,0,0,0,0,0,0,0,0,0,340000,0,0,0,340000,0,340000,340000
054771,茂林國票98購02  ,0,0,0,0,0,0,0,0,0,340000,0,0,0,368000,28000,340000,340000
054064,台郡國票97購04  ,0,0,0,0,0,0,0,0,0,340000,0,0,0,340000,0,340000,340000
060150,華通富邦9B購01  ,0,0,0,0,0,0,0,0,0,339000,0,0,0,383000,44000,339000,339000
052779,欣興國票97購01  ,0,0,0,0,0,0,0,0,0,339000,0,0,0,430000,91000,339000,339000
057719,欣興元富02購01  ,0,0,0,0,0,0,0,0,0,338000,0,0,0,365000,27000,338000,338000
061273,臺股指凱基9A購23,0,0,0,0,0,0,0,0,0,337000,0,0,0,347000,10000,337000,337000
053055,聯詠國票97購01  ,0,0,0,0,0,0,0,0,0,337000,0,0,0,401000,64000,337000,337000
055856,新唐元大97購03  ,0,0,0,0,0,0,0,0,0,337000,0,0,0,347000,10000,337000,337000
061373,華通富邦9A購02  ,0,0,0,0,0,0,0,0,0,336000,0,0,0,456000,120000,336000,336000
8081,致新            ,655000,340000,315000,0,0,0,0,0,0,21000,99000,30000,69000,55000,103000,-48000,336000
061002,瑞昱兆豐9B購01  ,0,0,0,0,0,0,0,0,0,335000,0,0,0,345000,10000,335000,335000
059568,台積電凱基9A購13,0,0,0,0,0,0,0,0,0,334000,0,0,0,370000,36000,334000,334000
056989,鴻海兆豐98購02  ,0,0,0,0,0,0,0,0,0,334000,0,0,0,334000,0,334000,334000
060634,矽創富邦9B購01  ,0,0,0,0,0,0,0,0,0,333000,0,0,0,688000,355000,333000,333000
054058,晶豪科國票98購01,0,0,0,0,0,0,0,0,0,333000,0,0,0,420000,87000,333000,333000
053538,京鼎永豐96購03  ,0,0,0,0,0,0,0,0,0,333000,0,0,0,333000,0,333000,333000
060671,亞德客元大9A購03,0,0,0,0,0,0,0,0,0,332000,0,0,0,358000,26000,332000,332000
057207,立積元富98購02  ,0,0,0,0,0,0,0,0,0,332000,0,0,0,371000,39000,332000,332000
1720,生達            ,698000,325000,373000,0,0,0,0,0,0,-41000,0,41000,-41000,0,0,0,332000
052937,國巨兆豐97購01  ,0,0,0,0,0,0,0,0,0,331000,0,0,0,602000,271000,331000,331000
058750,緯穎凱基9A購03  ,0,0,0,0,0,0,0,0,0,330000,0,0,0,330000,0,330000,330000
058833,台表科永豐99購01,0,0,0,0,0,0,0,0,0,330000,0,0,0,362000,32000,330000,330000
056298,億光元大97購02  ,0,0,0,0,0,0,0,0,0,330000,0,0,0,330000,0,330000,330000
061035,亞光永豐9A購01  ,0,0,0,0,0,0,0,0,0,329000,0,0,0,359000,30000,329000,329000
00730,富邦臺灣優質高息,0,0,0,0,0,0,0,0,0,329000,0,0,0,559000,230000,329000,329000
059964,元金2X凱基99購02,0,0,0,0,0,0,0,0,0,328000,0,0,0,450000,122000,328000,328000
060915,旭富元大9A購01  ,0,0,0,0,0,0,0,0,0,327000,0,0,0,562000,235000,327000,327000
0061,元大寶滬深      ,0,0,0,0,0,0,0,0,0,327000,50000,30000,20000,337000,30000,307000,327000
061590,金寶永豐9A購01  ,0,0,0,0,0,0,0,0,0,326000,0,0,0,575000,249000,326000,326000
061718,GIS凱基9B購01   ,0,0,0,0,0,0,0,0,0,326000,0,0,0,326000,0,326000,326000
061843,億豐凱基9C購01  ,0,0,0,0,0,0,0,0,0,326000,0,0,0,336000,10000,326000,326000
061585,台積電富邦9B購06,0,0,0,0,0,0,0,0,0,325000,0,0,0,374000,49000,325000,325000
061238,晶技元大9A購02  ,0,0,0,0,0,0,0,0,0,325000,0,0,0,353000,28000,325000,325000
053638,信邦永豐96購01  ,0,0,0,0,0,0,0,0,0,325000,0,0,0,359000,34000,325000,325000
053452,臺股指凱基97購01,0,0,0,0,0,0,0,0,0,325000,0,0,0,325000,0,325000,325000
056855,祥碩中信98購02  ,0,0,0,0,0,0,0,0,0,324000,0,0,0,436000,112000,324000,324000
054405,樺漢康和96購01  ,0,0,0,0,0,0,0,0,0,323000,0,0,0,323000,0,323000,323000
061947,旺宏群益9B購02  ,0,0,0,0,0,0,0,0,0,320000,0,0,0,385000,65000,320000,320000
08714P,華碩元富01售03  ,0,0,0,0,0,0,0,0,0,320000,0,0,0,380000,60000,320000,320000
3049,和鑫            ,628000,305000,323000,0,0,0,0,0,0,-4000,0,0,0,27000,31000,-4000,319000
060352,滬深2X元富9A購02,0,0,0,0,0,0,0,0,0,317000,0,0,0,451000,134000,317000,317000
057730,聯鈞國泰9A購01  ,0,0,0,0,0,0,0,0,0,317000,0,0,0,357000,40000,317000,317000
055921,新唐凱基98購01  ,0,0,0,0,0,0,0,0,0,317000,0,0,0,347000,30000,317000,317000
07821P,臺股指國票9A售12,0,0,0,0,0,0,0,0,0,317000,0,0,0,342000,25000,317000,317000
06836P,玉晶光國票99售06,0,0,0,0,0,0,0,0,0,316000,0,0,0,556000,240000,316000,316000
055619,同欣電國票98購02,0,0,0,0,0,0,0,0,0,316000,0,0,0,440000,124000,316000,316000
056519,創意國票99購01  ,0,0,0,0,0,0,0,0,0,316000,0,0,0,465000,149000,316000,316000
057308,同欣電兆豐99購01,0,0,0,0,0,0,0,0,0,316000,0,0,0,404000,88000,316000,316000
060079,台郡台新99購03  ,0,0,0,0,0,0,0,0,0,315000,0,0,0,509000,194000,315000,315000
061186,牧德國泰9C購01  ,0,0,0,0,0,0,0,0,0,313000,0,0,0,1020000,707000,313000,313000
055987,台表科元富97購01,0,0,0,0,0,0,0,0,0,313000,0,0,0,345000,32000,313000,313000
1440,南紡            ,401000,90000,311000,0,0,0,0,0,0,0,0,0,0,0,0,0,311000
060856,健策富邦9B購02  ,0,0,0,0,0,0,0,0,0,310000,0,0,0,345000,35000,310000,310000
07673P,電子類元大9A售01,0,0,0,0,0,0,0,0,0,309000,0,0,0,321000,12000,309000,309000
056509,晶相光永豐98購01,0,0,0,0,0,0,0,0,0,308000,0,0,0,308000,0,308000,308000
057169,微星元大98購01  ,0,0,0,0,0,0,0,0,0,307000,0,0,0,307000,0,307000,307000
055936,彩晶群益98購02  ,0,0,0,0,0,0,0,0,0,306000,0,0,0,404000,98000,306000,306000
056844,欣興元富98購03  ,0,0,0,0,0,0,0,0,0,306000,0,0,0,326000,20000,306000,306000
06102P,智邦凱基97售03  ,0,0,0,0,0,0,0,0,0,305000,0,0,0,305000,0,305000,305000
060467,神基元大9A購01  ,0,0,0,0,0,0,0,0,0,305000,0,0,0,353000,48000,305000,305000
057836,南亞科國泰9A購01,0,0,0,0,0,0,0,0,0,305000,0,0,0,305000,0,305000,305000
056711,亞光永豐98購01  ,0,0,0,0,0,0,0,0,0,304000,0,0,0,337000,33000,304000,304000
07643P,禾伸堂凱基9A售02,0,0,0,0,0,0,0,0,0,304000,0,0,0,343000,39000,304000,304000
059064,緯穎凱基99購02  ,0,0,0,0,0,0,0,0,0,303000,0,0,0,303000,0,303000,303000
03603P,群創凱基98售04  ,0,0,0,0,0,0,0,0,0,303000,0,0,0,390000,87000,303000,303000
054863,億光群益97購01  ,0,0,0,0,0,0,0,0,0,302000,0,0,0,302000,0,302000,302000
059629,友達凱基99購06  ,0,0,0,0,0,0,0,0,0,302000,0,0,0,304000,2000,302000,302000
06603P,立積統一99售01  ,0,0,0,0,0,0,0,0,0,301000,0,0,0,396000,95000,301000,301000
00670L,富邦NASDAQ正2   ,14000,149000,-135000,0,0,0,0,0,0,436000,30000,0,30000,726000,320000,406000,301000
05306P,泰碩國泰97售01  ,0,0,0,0,0,0,0,0,0,301000,0,0,0,319000,18000,301000,301000
050335,正崴國泰96購01  ,0,0,0,0,0,0,0,0,0,300000,0,0,0,300000,0,300000,300000
048373,A50正2元富95購01,0,0,0,0,0,0,0,0,0,300000,0,0,0,300000,0,300000,300000
053001,力山永豐96購01  ,0,0,0,0,0,0,0,0,0,300000,0,0,0,300000,0,300000,300000
055311,健策群益98購02  ,0,0,0,0,0,0,0,0,0,300000,0,0,0,300000,0,300000,300000
056676,國產元富98購01  ,0,0,0,0,0,0,0,0,0,300000,0,0,0,435000,135000,300000,300000
07546P,玉晶光凱基9A售09,0,0,0,0,0,0,0,0,0,300000,0,0,0,874000,574000,300000,300000
047571,滬深2X群益99購01,0,0,0,0,0,0,0,0,0,299000,0,0,0,299000,0,299000,299000
056083,億光統一97購03  ,0,0,0,0,0,0,0,0,0,299000,0,0,0,347000,48000,299000,299000
061535,群創統一9C購01  ,0,0,0,0,0,0,0,0,0,298000,0,0,0,346000,48000,298000,298000
049684,彩晶統一95購01  ,0,0,0,0,0,0,0,0,0,298000,0,0,0,298000,0,298000,298000
054090,瑞昱群益97購01  ,0,0,0,0,0,0,0,0,0,298000,0,0,0,362000,64000,298000,298000
061481,嘉澤元大9A購03  ,0,0,0,0,0,0,0,0,0,297000,0,0,0,376000,79000,297000,297000
059879,GIS凱基99購03   ,0,0,0,0,0,0,0,0,0,295000,0,0,0,295000,0,295000,295000
060966,台表科凱基9B購01,0,0,0,0,0,0,0,0,0,294000,0,0,0,521000,227000,294000,294000
051486,玉晶光凱基97購03,0,0,0,0,0,0,0,0,0,293000,0,0,0,593000,300000,293000,293000
057533,晶相光元大98購02,0,0,0,0,0,0,0,0,0,292000,0,0,0,296000,4000,292000,292000
4977,眾達-KY         ,580000,255000,325000,0,0,0,27000,59000,-32000,-2000,0,0,0,0,2000,-2000,291000
060447,A50正2元大9A購02,0,0,0,0,0,0,0,0,0,290000,0,0,0,290000,0,290000,290000
061649,緯穎元大9A購06  ,0,0,0,0,0,0,0,0,0,290000,0,0,0,301000,11000,290000,290000
061226,台積電中信9A購05,0,0,0,0,0,0,0,0,0,289000,0,0,0,310000,21000,289000,289000
060696,道瓊反國泰9C購01,0,0,0,0,0,0,0,0,0,288000,0,0,0,333000,45000,288000,288000
056571,燿華元大98購02  ,0,0,0,0,0,0,0,0,0,288000,0,0,0,288000,0,288000,288000
061111,台表科元大9A購02,0,0,0,0,0,0,0,0,0,287000,0,0,0,471000,184000,287000,287000
061125,億光永豐9A購01  ,0,0,0,0,0,0,0,0,0,286000,0,0,0,340000,54000,286000,286000
060511,群創元大9B購08  ,0,0,0,0,0,0,0,0,0,286000,0,0,0,296000,10000,286000,286000
05443P,宏達電元大95售05,0,0,0,0,0,0,0,0,0,286000,0,0,0,288000,2000,286000,286000
057887,智原群益98購04  ,0,0,0,0,0,0,0,0,0,285000,0,0,0,285000,0,285000,285000
050170,臺指反元大97購02,0,0,0,0,0,0,0,0,0,284000,0,0,0,365000,81000,284000,284000
6153,嘉聯益          ,1290528,884030,406498,0,0,0,0,0,0,-123000,124000,176000,-52000,7000,78000,-71000,283498
059015,華通元富99購02  ,0,0,0,0,0,0,0,0,0,283000,0,0,0,283000,0,283000,283000
061886,力山國泰01購01  ,0,0,0,0,0,0,0,0,0,282000,0,0,0,446000,164000,282000,282000
059560,T50反1凱基99購08,0,0,0,0,0,0,0,0,0,282000,0,0,0,474000,192000,282000,282000
060642,華擎永豐9A購02  ,0,0,0,0,0,0,0,0,0,281000,0,0,0,311000,30000,281000,281000
055359,超眾凱基97購01  ,0,0,0,0,0,0,0,0,0,281000,0,0,0,283000,2000,281000,281000
05880P,創意康和96售01  ,0,0,0,0,0,0,0,0,0,281000,0,0,0,287000,6000,281000,281000
00636,國泰中國A50     ,15000,22000,-7000,0,0,0,0,0,0,287905,0,0,0,550000,262095,287905,280905
059904,A50正2元大9C購05,0,0,0,0,0,0,0,0,0,280000,0,0,0,280000,0,280000,280000
052451,旭富元大95購02  ,0,0,0,0,0,0,0,0,0,280000,0,0,0,280000,0,280000,280000
056151,建準凱基97購01  ,0,0,0,0,0,0,0,0,0,280000,0,0,0,308000,28000,280000,280000
056641,華通凱基98購03  ,0,0,0,0,0,0,0,0,0,279000,0,0,0,289000,10000,279000,279000
056419,欣興元富98購02  ,0,0,0,0,0,0,0,0,0,278000,0,0,0,453000,175000,278000,278000
058337,日月光元富99購01,0,0,0,0,0,0,0,0,0,278000,0,0,0,575000,297000,278000,278000
059931,緯穎富邦9A購01  ,0,0,0,0,0,0,0,0,0,277000,0,0,0,290000,13000,277000,277000
061066,嘉晶凱基9B購01  ,0,0,0,0,0,0,0,0,0,277000,0,0,0,305000,28000,277000,277000
052898,樺漢群益96購01  ,0,0,0,0,0,0,0,0,0,275000,0,0,0,275000,0,275000,275000
052847,漢唐統一99購01  ,0,0,0,0,0,0,0,0,0,274000,0,0,0,357000,83000,274000,274000
055318,華通國票98購01  ,0,0,0,0,0,0,0,0,0,274000,0,0,0,276000,2000,274000,274000
057181,亞光元大98購02  ,0,0,0,0,0,0,0,0,0,274000,0,0,0,325000,51000,274000,274000
057613,瑞昱元富02購02  ,0,0,0,0,0,0,0,0,0,273000,0,0,0,321000,48000,273000,273000
055726,台表科元大98購03,0,0,0,0,0,0,0,0,0,271000,0,0,0,339000,68000,271000,271000
054602,聯詠台新97購01  ,0,0,0,0,0,0,0,0,0,270000,0,0,0,270000,0,270000,270000
060259,潤泰全凱基9C購01,0,0,0,0,0,0,0,0,0,269000,0,0,0,269000,0,269000,269000
060252,緯穎元大9A購02  ,0,0,0,0,0,0,0,0,0,268000,0,0,0,283000,15000,268000,268000
061476,大毅元大9A購02  ,0,0,0,0,0,0,0,0,0,268000,0,0,0,288000,20000,268000,268000
058537,彩晶統一9B購01  ,0,0,0,0,0,0,0,0,0,267000,0,0,0,426000,159000,267000,267000
061971,力山元大9C購02  ,0,0,0,0,0,0,0,0,0,266000,0,0,0,288000,22000,266000,266000
058820,致茂國泰9B購01  ,0,0,0,0,0,0,0,0,0,266000,0,0,0,266000,0,266000,266000
057973,神達富邦9A購01  ,0,0,0,0,0,0,0,0,0,266000,0,0,0,306000,40000,266000,266000
060109,茂林元大99購05  ,0,0,0,0,0,0,0,0,0,265000,0,0,0,373000,108000,265000,265000
057437,可成國票99購01  ,0,0,0,0,0,0,0,0,0,265000,0,0,0,265000,0,265000,265000
07086P,力成元富9C售01  ,0,0,0,0,0,0,0,0,0,265000,0,0,0,559000,294000,265000,265000
061517,瑞祺永豐9A購03  ,0,0,0,0,0,0,0,0,0,263000,0,0,0,312000,49000,263000,263000
056352,鴻海元大99購01  ,0,0,0,0,0,0,0,0,0,263000,0,0,0,313000,50000,263000,263000
058025,聯茂國泰99購01  ,0,0,0,0,0,0,0,0,0,263000,0,0,0,263000,0,263000,263000
1319,東陽            ,345148,84000,261148,0,0,0,0,0,0,0,0,0,0,0,0,0,261148
054744,晶相光凱基99購01,0,0,0,0,0,0,0,0,0,261000,0,0,0,261000,0,261000,261000
061689,國巨群益9A購12  ,0,0,0,0,0,0,0,0,0,260000,0,0,0,400000,140000,260000,260000
057403,亞光群益98購04  ,0,0,0,0,0,0,0,0,0,260000,0,0,0,369000,109000,260000,260000
9933,中鼎            ,1164000,901000,263000,0,0,0,0,0,0,-3000,0,3000,-3000,0,0,0,260000
057357,超眾統一98購01  ,0,0,0,0,0,0,0,0,0,259000,0,0,0,342000,83000,259000,259000
059949,啟碁永豐99購01  ,0,0,0,0,0,0,0,0,0,258000,0,0,0,313000,55000,258000,258000
058518,玉晶光元大99購13,0,0,0,0,0,0,0,0,0,258000,0,0,0,584000,326000,258000,258000
060826,牧德元大9B購02  ,0,0,0,0,0,0,0,0,0,257000,0,0,0,498000,241000,257000,257000
061706,旭富國票9A購02  ,0,0,0,0,0,0,0,0,0,257000,0,0,0,487000,230000,257000,257000
062094,台積電富邦9C購12,0,0,0,0,0,0,0,0,0,257000,0,0,0,400000,143000,257000,257000
058479,亞光凱基9A購01  ,0,0,0,0,0,0,0,0,0,257000,0,0,0,273000,16000,257000,257000
056567,瀚宇博群益98購02,0,0,0,0,0,0,0,0,0,257000,0,0,0,258000,1000,257000,257000
057085,立積統一9B購02  ,0,0,0,0,0,0,0,0,0,257000,0,0,0,937000,680000,257000,257000
061524,華通凱基9A購07  ,0,0,0,0,0,0,0,0,0,256000,0,0,0,256000,0,256000,256000
058264,瑞昱永豐99購01  ,0,0,0,0,0,0,0,0,0,255000,0,0,0,296000,41000,255000,255000
053760,牧德國泰98購01  ,0,0,0,0,0,0,0,0,0,254000,0,0,0,274000,20000,254000,254000
055972,GIS元大97購04   ,0,0,0,0,0,0,0,0,0,254000,0,0,0,279000,25000,254000,254000
058053,上銀統一9B購01  ,0,0,0,0,0,0,0,0,0,254000,0,0,0,265000,11000,254000,254000
061566,華通元大9A購10  ,0,0,0,0,0,0,0,0,0,253000,0,0,0,401000,148000,253000,253000
061307,和潤永豐9A購02  ,0,0,0,0,0,0,0,0,0,253000,0,0,0,254000,1000,253000,253000
061112,台表科元大9A購03,0,0,0,0,0,0,0,0,0,253000,0,0,0,311000,58000,253000,253000
053864,義隆元大96購01  ,0,0,0,0,0,0,0,0,0,253000,0,0,0,363000,110000,253000,253000
057249,華邦電統一9A購01,0,0,0,0,0,0,0,0,0,252000,0,0,0,266000,14000,252000,252000
060693,台積電麥證9A購02,0,0,0,250000,0,250000,0,0,0,250000,0,0,0,250000,0,250000,250000
061379,鈺齊永豐9A購02  ,0,0,0,0,0,0,0,0,0,250000,0,0,0,260000,10000,250000,250000
053947,義隆富邦97購01  ,0,0,0,0,0,0,0,0,0,250000,0,0,0,278000,28000,250000,250000
052146,泰碩群益95購01  ,0,0,0,0,0,0,0,0,0,250000,0,0,0,250000,0,250000,250000
060262,臺股指凱基9B購02,0,0,0,0,0,0,0,0,0,249000,0,0,0,335000,86000,249000,249000
060667,力成凱基9A購01  ,0,0,0,0,0,0,0,0,0,248000,0,0,0,585000,337000,248000,248000
054163,燿華凱基97購02  ,0,0,0,0,0,0,0,0,0,248000,0,0,0,248000,0,248000,248000
060287,燿華元大9A購01  ,0,0,0,0,0,0,0,0,0,247000,0,0,0,262000,15000,247000,247000
1783,和康生          ,323000,76000,247000,0,0,0,0,0,0,0,0,0,0,0,0,0,247000
061847,力山國票9B購01  ,0,0,0,0,0,0,0,0,0,246000,0,0,0,246000,0,246000,246000
05758P,光罩永豐96售02  ,0,0,0,0,0,0,0,0,0,246000,0,0,0,246000,0,246000,246000
8011,台通            ,353000,107000,246000,0,0,0,0,0,0,0,0,0,0,0,0,0,246000
061038,TPK永豐9A購01   ,0,0,0,0,0,0,0,0,0,244000,0,0,0,244000,0,244000,244000
052908,大成鋼統一96購01,0,0,0,0,0,0,0,0,0,244000,0,0,0,294000,50000,244000,244000
057731,華擎國泰9A購02  ,0,0,0,0,0,0,0,0,0,243000,0,0,0,267000,24000,243000,243000
056267,文曄統一97購02  ,0,0,0,0,0,0,0,0,0,243000,0,0,0,262000,19000,243000,243000
07210P,智邦凱基99售03  ,0,0,0,0,0,0,0,0,0,242000,0,0,0,246000,4000,242000,242000
057812,友達元大9A購05  ,0,0,0,0,0,0,0,0,0,240000,0,0,0,300000,60000,240000,240000
053092,台表科元大97購02,0,0,0,0,0,0,0,0,0,239000,0,0,0,275000,36000,239000,239000
061611,南六統一01購01  ,0,0,0,0,0,0,0,0,0,238000,0,0,0,301000,63000,238000,238000
057389,玉晶光永豐98購06,0,0,0,0,0,0,0,0,0,238000,0,0,0,253000,15000,238000,238000
058318,致茂永豐9A購01  ,0,0,0,0,0,0,0,0,0,238000,0,0,0,238000,0,238000,238000
2855,統一證          ,305000,67000,238000,0,0,0,0,0,0,0,0,0,0,0,0,0,238000
061707,超眾國票9B購01  ,0,0,0,0,0,0,0,0,0,237000,0,0,0,259000,22000,237000,237000
061081,宏碁兆豐9A購01  ,0,0,0,0,0,0,0,0,0,237000,0,0,0,347000,110000,237000,237000
052099,臺股指富邦95購02,0,0,0,0,0,0,0,0,0,237000,0,0,0,237000,0,237000,237000
052719,致新凱基96購01  ,0,0,0,0,0,0,0,0,0,237000,0,0,0,307000,70000,237000,237000
059073,元油2X元大9C購14,0,0,0,0,0,0,0,0,0,237000,0,0,0,287000,50000,237000,237000
060930,超眾永豐9A購03  ,0,0,0,0,0,0,0,0,0,236000,0,0,0,236000,0,236000,236000
060931,GIS永豐9A購01   ,0,0,0,0,0,0,0,0,0,236000,0,0,0,241000,5000,236000,236000
060804,T50反1群益9A購02,0,0,0,0,0,0,0,0,0,236000,0,0,0,477000,241000,236000,236000
058429,欣興元富99購01  ,0,0,0,0,0,0,0,0,0,236000,0,0,0,428000,192000,236000,236000
058385,創意中信99購01  ,0,0,0,0,0,0,0,0,0,236000,0,0,0,261000,25000,236000,236000
057770,亞德客群益98購01,0,0,0,0,0,0,0,0,0,236000,0,0,0,247000,11000,236000,236000
05910P,力山永豐96售02  ,0,0,0,0,0,0,0,0,0,236000,0,0,0,257000,21000,236000,236000
060583,南亞科元富9A購05,0,0,0,0,0,0,0,0,0,235000,0,0,0,285000,50000,235000,235000
060463,台積電元大9A購10,0,0,0,0,0,0,0,0,0,235000,0,0,0,235000,0,235000,235000
055030,帆宣國泰99購02  ,0,0,0,0,0,0,0,0,0,235000,0,0,0,288000,53000,235000,235000
054826,復盛元大9A購01  ,0,0,0,0,0,0,0,0,0,235000,0,0,0,235000,0,235000,235000
057071,華擎永豐98購02  ,0,0,0,0,0,0,0,0,0,235000,0,0,0,238000,3000,235000,235000
057482,微星元大98購03  ,0,0,0,0,0,0,0,0,0,235000,0,0,0,235000,0,235000,235000
059539,緯穎凱基99購03  ,0,0,0,0,0,0,0,0,0,235000,0,0,0,235000,0,235000,235000
059695,聯鈞永豐99購02  ,0,0,0,0,0,0,0,0,0,235000,0,0,0,239000,4000,235000,235000
07863P,華新科凱基9B售07,0,0,0,0,0,0,0,0,0,235000,0,0,0,419000,184000,235000,235000
061615,鴻海群益9A購06  ,0,0,0,0,0,0,0,0,0,234000,0,0,0,263000,29000,234000,234000
058079,鴻海群益98購08  ,0,0,0,0,0,0,0,0,0,234000,0,0,0,320000,86000,234000,234000
056142,超眾元大97購06  ,0,0,0,0,0,0,0,0,0,234000,0,0,0,284000,50000,234000,234000
058299,同欣電凱基9A購01,0,0,0,0,0,0,0,0,0,233000,0,0,0,233000,0,233000,233000
058245,訊連元大99購01  ,0,0,0,0,0,0,0,0,0,233000,0,0,0,245000,12000,233000,233000
4536,拓凱            ,99000,53000,46000,0,0,0,229000,35000,194000,-7000,0,7000,-7000,0,0,0,233000
3090,日電貿          ,655000,505000,150000,0,0,0,0,0,0,82440,0,0,0,121000,38560,82440,232440
060420,神基永豐9A購01  ,0,0,0,0,0,0,0,0,0,232000,0,0,0,237000,5000,232000,232000
060397,群創國票9A購01  ,0,0,0,0,0,0,0,0,0,232000,0,0,0,232000,0,232000,232000
061008,群創兆豐9A購02  ,0,0,0,0,0,0,0,0,0,232000,0,0,0,242000,10000,232000,232000
059771,台積電群益99購11,0,0,0,0,0,0,0,0,0,232000,0,0,0,345000,113000,232000,232000
056574,亞光元大99購03  ,0,0,0,0,0,0,0,0,0,232000,0,0,0,272000,40000,232000,232000
060960,金像電凱基9B購01,0,0,0,0,0,0,0,0,0,230000,0,0,0,534000,304000,230000,230000
048178,上銀富邦95購02  ,0,0,0,0,0,0,0,0,0,230000,0,0,0,230000,0,230000,230000
059819,台積電凱基99購17,0,0,0,0,0,0,0,0,0,229000,0,0,0,360000,131000,229000,229000
058216,TPK群益99購01   ,0,0,0,0,0,0,0,0,0,229000,0,0,0,229000,0,229000,229000
061866,力山元大9C購01  ,0,0,0,0,0,0,0,0,0,228000,0,0,0,276000,48000,228000,228000
047421,聯茂富邦97購01  ,0,0,0,0,0,0,0,0,0,228000,0,0,0,516000,288000,228000,228000
053112,中磊兆豐97購01  ,0,0,0,0,0,0,0,0,0,228000,0,0,0,228000,0,228000,228000
054504,聯鈞永豐96購01  ,0,0,0,0,0,0,0,0,0,228000,0,0,0,255000,27000,228000,228000
059503,大立光富邦9B購04,0,0,0,0,0,0,0,0,0,228000,0,0,0,891000,663000,228000,228000
2449,京元電子        ,2056000,1583000,473000,0,0,0,0,0,0,-245000,14000,140000,-126000,43000,162000,-119000,228000
054298,台表科元大97購03,0,0,0,0,0,0,0,0,0,227000,0,0,0,227000,0,227000,227000
1789,神隆            ,1379000,1097000,282000,0,0,0,0,0,0,-55000,0,0,0,54000,109000,-55000,227000
07634P,金像電元大9A售01,0,0,0,0,0,0,0,0,0,227000,0,0,0,432000,205000,227000,227000
06900P,FBVIX國票12售01 ,0,0,0,0,0,0,0,0,0,226000,0,0,0,228000,2000,226000,226000
057061,華擎國泰9A購01  ,0,0,0,0,0,0,0,0,0,226000,0,0,0,272000,46000,226000,226000
058698,華通元大99購05  ,0,0,0,0,0,0,0,0,0,226000,0,0,0,265000,39000,226000,226000
2888,新光金          ,14348652,14120000,228652,0,0,0,17000,0,17000,-20000,60000,98000,-38000,142000,124000,18000,225652
062006,瑞昱國泰9C購01  ,0,0,0,0,0,0,0,0,0,225000,0,0,0,273000,48000,225000,225000
061349,嘉澤元大9A購02  ,0,0,0,0,0,0,0,0,0,225000,0,0,0,290000,65000,225000,225000
060045,嘉晶群益99購02  ,0,0,0,0,0,0,0,0,0,225000,0,0,0,454000,229000,225000,225000
054683,川湖永豐97購01  ,0,0,0,0,0,0,0,0,0,225000,0,0,0,235000,10000,225000,225000
055254,聯詠統一97購03  ,0,0,0,0,0,0,0,0,0,225000,0,0,0,810000,585000,225000,225000
055197,致新元富97購02  ,0,0,0,0,0,0,0,0,0,225000,0,0,0,604000,379000,225000,225000
020015,統一MSCI美低波N ,0,0,0,0,0,0,0,0,0,225000,0,0,0,231000,6000,225000,225000
056406,建準國票99購01  ,0,0,0,0,0,0,0,0,0,225000,0,0,0,292000,67000,225000,225000
057009,信邦中信99購01  ,0,0,0,0,0,0,0,0,0,225000,0,0,0,326000,101000,225000,225000
056010,力成中信97購01  ,0,0,0,0,0,0,0,0,0,225000,0,0,0,275000,50000,225000,225000
3532,台勝科          ,572000,281000,291000,0,0,0,0,0,0,-66000,18000,12000,6000,16000,88000,-72000,225000
054974,台表科元大98購02,0,0,0,0,0,0,0,0,0,224000,0,0,0,228000,4000,224000,224000
055196,致新元富97購01  ,0,0,0,0,0,0,0,0,0,223000,0,0,0,610000,387000,223000,223000
051644,聯茂康和95購01  ,0,0,0,0,0,0,0,0,0,223000,0,0,0,223000,0,223000,223000
054590,嘉聯益國泰98購01,0,0,0,0,0,0,0,0,0,223000,0,0,0,223000,0,223000,223000
052123,泰碩國票95購01  ,0,0,0,0,0,0,0,0,0,223000,0,0,0,223000,0,223000,223000
056749,滬深2X兆豐99購01,0,0,0,0,0,0,0,0,0,223000,0,0,0,223000,0,223000,223000
2489,瑞軒            ,559000,331000,228000,0,0,0,0,0,0,-6000,0,6000,-6000,0,0,0,222000
2481,強茂            ,793000,471000,322000,0,0,0,0,0,0,-101000,50000,129000,-79000,8000,30000,-22000,221000
061029,力山永豐9A購01  ,0,0,0,0,0,0,0,0,0,220000,0,0,0,257000,37000,220000,220000
061227,日月光中信9B購01,0,0,0,0,0,0,0,0,0,220000,0,0,0,451000,231000,220000,220000
061913,宏碁中信9B購01  ,0,0,0,0,0,0,0,0,0,220000,0,0,0,220000,0,220000,220000
053913,華新國票97購01  ,0,0,0,0,0,0,0,0,0,220000,0,0,0,220000,0,220000,220000
05600P,玉晶光台新96售04,0,0,0,0,0,0,0,0,0,220000,0,0,0,220000,0,220000,220000
057873,義隆元大98購03  ,0,0,0,0,0,0,0,0,0,219000,0,0,0,427000,208000,219000,219000
061026,南電富邦9B購01  ,0,0,0,0,0,0,0,0,0,218000,0,0,0,356000,138000,218000,218000
057776,京元電群益98購02,0,0,0,0,0,0,0,0,0,218000,0,0,0,218000,0,218000,218000
061188,大成鋼富邦9B購01,0,0,0,0,0,0,0,0,0,217000,0,0,0,401000,184000,217000,217000
056710,漢唐永豐98購01  ,0,0,0,0,0,0,0,0,0,217000,0,0,0,217000,0,217000,217000
055841,南亞科元大97購04,0,0,0,0,0,0,0,0,0,217000,0,0,0,217000,0,217000,217000
058180,華新科國泰9A購01,0,0,0,0,0,0,0,0,0,217000,0,0,0,232000,15000,217000,217000
1434,福懋            ,775000,558000,217000,0,0,0,0,0,0,0,0,0,0,0,0,0,217000
061975,華通元大9B購01  ,0,0,0,0,0,0,0,0,0,216000,0,0,0,336000,120000,216000,216000
054091,晶豪科群益96購01,0,0,0,0,0,0,0,0,0,216000,0,0,0,358000,142000,216000,216000
006205,富邦上証        ,344000,500000,-156000,0,0,0,0,0,0,372000,0,0,0,1436000,1064000,372000,216000
059370,玉晶光元富99購02,0,0,0,0,0,0,0,0,0,216000,0,0,0,467000,251000,216000,216000
061141,臻鼎統一9A購01  ,0,0,0,0,0,0,0,0,0,215000,0,0,0,215000,0,215000,215000
060114,緯穎元大99購10  ,0,0,0,0,0,0,0,0,0,215000,0,0,0,217000,2000,215000,215000
6166,凌華            ,248000,33000,215000,0,0,0,0,0,0,0,0,0,0,0,0,0,215000
060193,群創元富9A購01  ,0,0,0,0,0,0,0,0,0,214000,0,0,0,234000,20000,214000,214000
060628,和大富邦9B購01  ,0,0,0,0,0,0,0,0,0,214000,0,0,0,227000,13000,214000,214000
061891,力山永豐9B購01  ,0,0,0,0,0,0,0,0,0,214000,0,0,0,216000,2000,214000,214000
060030,晶相光永豐99購03,0,0,0,0,0,0,0,0,0,213000,0,0,0,213000,0,213000,213000
058977,SGBR2X凱基03購01,0,0,0,0,0,0,0,0,0,213000,0,0,0,290000,77000,213000,213000
058218,緯穎群益99購01  ,0,50000,-50000,0,0,0,0,0,0,263000,0,0,0,287000,24000,263000,213000
061668,信邦中信9B購01  ,0,0,0,0,0,0,0,0,0,212000,0,0,0,270000,58000,212000,212000
058403,玉晶光元大99購12,0,0,0,0,0,0,0,0,0,212000,0,0,0,444000,232000,212000,212000
07292P,臺股指凱基99售44,0,0,0,0,0,0,0,0,0,212000,0,0,0,222000,10000,212000,212000
061162,南電群益9A購02  ,0,0,0,0,0,0,0,0,0,211000,0,0,0,279000,68000,211000,211000
058144,聯茂元大99購02  ,0,0,0,0,0,0,0,0,0,211000,0,0,0,225000,14000,211000,211000
057612,瑞昱元富02購01  ,0,0,0,0,0,0,0,0,0,211000,0,0,0,562000,351000,211000,211000
07469P,台達電元大9A售01,0,0,0,0,0,0,0,0,0,211000,0,0,0,225000,14000,211000,211000
061789,群創群益9B購01  ,0,0,0,0,0,0,0,0,0,210000,0,0,0,210000,0,210000,210000
00678,群益NBI生技     ,201000,0,201000,0,0,0,0,0,0,9000,0,0,0,309000,300000,9000,210000
052003,泰碩國泰97購02  ,0,0,0,0,0,0,0,0,0,210000,0,0,0,268000,58000,210000,210000
07595P,台灣50中信03售07,0,0,0,0,0,0,0,0,0,210000,0,0,0,210000,0,210000,210000
061473,台積電元大9A購33,0,0,0,0,0,0,0,0,0,209000,0,0,0,230000,21000,209000,209000
060468,聯鈞元大9A購02  ,0,0,0,0,0,0,0,0,0,209000,0,0,0,210000,1000,209000,209000
07535P,上銀元富9A售03  ,0,0,0,0,0,0,0,0,0,209000,0,0,0,243000,34000,209000,209000
061448,旺宏中信9A購02  ,0,0,0,0,0,0,0,0,0,208000,0,0,0,219000,11000,208000,208000
051738,全新國票96購02  ,0,0,0,0,0,0,0,0,0,208000,0,0,0,208000,0,208000,208000
051277,聯發科中信9A購01,0,0,0,0,0,0,0,0,0,208000,0,0,0,208000,0,208000,208000
056769,國產元大98購01  ,0,0,0,0,0,0,0,0,0,208000,0,0,0,214000,6000,208000,208000
061532,和大統一9C購02  ,0,0,0,0,0,0,0,0,0,207000,0,0,0,218000,11000,207000,207000
054282,泰鼎群益98購02  ,0,0,0,0,0,0,0,0,0,207000,0,0,0,213000,6000,207000,207000
056124,華通國票98購02  ,0,0,0,0,0,0,0,0,0,207000,0,0,0,207000,0,207000,207000
057142,力成兆豐98購01  ,0,0,0,0,0,0,0,0,0,207000,0,0,0,207000,0,207000,207000
059257,臺股指凱基99購35,0,0,0,0,0,0,0,0,0,207000,0,0,0,208000,1000,207000,207000
061413,台勝科群益9A購01,0,0,0,0,0,0,0,0,0,206000,0,0,0,540000,334000,206000,206000
00766L,台新MSCI中國正2 ,0,0,0,0,0,0,0,0,0,206000,0,0,0,394000,188000,206000,206000
056823,智伸科永豐98購01,0,0,0,0,0,0,0,0,0,206000,0,0,0,441000,235000,206000,206000
2905,三商            ,362000,156000,206000,0,0,0,0,0,0,0,0,0,0,0,0,0,206000
060793,微星永豐9A購01  ,0,0,0,0,0,0,0,0,0,205000,0,0,0,343000,138000,205000,205000
8215,明基材          ,428000,223000,205000,0,0,0,0,0,0,0,0,0,0,0,0,0,205000
061102,台積電元大9A購22,0,0,0,0,0,0,0,0,0,204000,0,0,0,204000,0,204000,204000
060373,元金2X元富9A購01,0,0,0,0,0,0,0,0,0,204000,0,0,0,325000,121000,204000,204000
054130,漢唐元大97購02  ,0,0,0,0,0,0,0,0,0,204000,0,0,0,204000,0,204000,204000
058819,華通國泰9B購01  ,0,0,0,0,0,0,0,0,0,204000,0,0,0,345000,141000,204000,204000
057368,微星元大98購02  ,0,0,0,0,0,0,0,0,0,204000,0,0,0,348000,144000,204000,204000
057283,欣興元大98購07  ,0,0,0,0,0,0,0,0,0,204000,0,0,0,205000,1000,204000,204000
061095,台積電台新9B購03,0,0,0,0,0,0,0,0,0,203000,0,0,0,394000,191000,203000,203000
058266,宏達電永豐99購01,0,0,0,0,0,0,0,0,0,203000,0,0,0,203000,0,203000,203000
055940,致新群益98購01  ,0,0,0,0,0,0,0,0,0,203000,0,0,0,709000,506000,203000,203000
061150,國巨群益9A購09  ,0,0,0,0,0,0,0,0,0,202000,0,0,0,368000,166000,202000,202000
04434P,玉晶光國票96售02,0,0,0,0,0,0,0,0,0,202000,0,0,0,202000,0,202000,202000
07507P,國巨國票9B售02  ,0,0,0,0,0,0,0,0,0,202000,0,0,0,202000,0,202000,202000
060367,緯穎元富9A購02  ,0,0,0,0,0,0,0,0,0,201000,0,0,0,206000,5000,201000,201000
058604,華邦電元大99購03,0,0,0,0,0,0,0,0,0,201000,0,0,0,201000,0,201000,201000
1536,和大            ,527000,302000,225000,0,0,0,0,0,0,-24000,18000,26000,-8000,4000,20000,-16000,201000
060155,友訊永豐9A購01  ,0,0,0,0,0,0,0,0,0,200000,0,0,0,258000,58000,200000,200000
059882,臺股指凱基9C購06,0,0,0,0,0,0,0,0,0,200000,0,0,0,273000,73000,200000,200000
061460,FBVIX群益9A購02 ,0,0,0,0,0,0,0,0,0,200000,0,0,0,200000,0,200000,200000
061484,華通兆豐9B購01  ,0,0,0,0,0,0,0,0,0,200000,0,0,0,200000,0,200000,200000
06802P,緯穎群益98售03  ,0,0,0,0,0,0,0,0,0,200000,0,0,0,200000,0,200000,200000
048271,可成富邦95購02  ,0,0,0,0,0,0,0,0,0,200000,0,0,0,200000,0,200000,200000
054567,拓凱群益98購01  ,0,0,0,0,0,0,0,0,0,200000,0,0,0,565000,365000,200000,200000
058736,鈺齊永豐99購02  ,0,0,0,0,0,0,0,0,0,200000,0,0,0,200000,0,200000,200000
054147,GIS元大96購02   ,0,0,0,0,0,0,0,0,0,200000,0,0,0,200000,0,200000,200000
053780,南亞科元大96購03,0,0,0,0,0,0,0,0,0,200000,0,0,0,200000,0,200000,200000
054903,億光康和97購02  ,0,0,0,0,0,0,0,0,0,200000,0,0,0,200000,0,200000,200000
054824,同欣電元大97購04,0,0,0,0,0,0,0,0,0,200000,0,0,0,200000,0,200000,200000
058713,國巨統一9B購02  ,0,0,0,0,0,0,0,0,0,200000,0,0,0,200000,0,200000,200000
056634,為升兆豐99購01  ,0,0,0,0,0,0,0,0,0,200000,0,0,0,200000,0,200000,200000
057469,康友永豐98購02  ,0,0,0,0,0,0,0,0,0,200000,0,0,0,200000,0,200000,200000
057968,可成國泰9A購01  ,0,0,0,0,0,0,0,0,0,200000,0,0,0,200000,0,200000,200000
059006,樺漢元大99購01  ,0,0,0,0,0,0,0,0,0,199000,0,0,0,199000,0,199000,199000
056715,瀚宇博永豐98購01,0,0,0,0,0,0,0,0,0,199000,0,0,0,249000,50000,199000,199000
2314,台揚            ,357000,158000,199000,0,0,0,0,0,0,0,0,0,0,0,0,0,199000
07468P,聯電元大9A售02  ,0,0,0,0,0,0,0,0,0,199000,0,0,0,310000,111000,199000,199000
06889P,臺股指元大98售13,0,0,0,0,0,0,0,0,0,198000,0,0,0,305000,107000,198000,198000
058729,國巨永豐99購03  ,0,0,0,0,0,0,0,0,0,198000,0,0,0,198000,0,198000,198000
061521,亞光兆豐9A購02  ,0,0,0,0,0,0,0,0,0,197000,0,0,0,452000,255000,197000,197000
061469,瑞祺群益9A購02  ,0,0,0,0,0,0,0,0,0,197000,0,0,0,262000,65000,197000,197000
060036,上証2X國票99購03,0,0,0,0,0,0,0,0,0,197000,0,0,0,200000,3000,197000,197000
060404,台勝科國泰9B購01,0,0,0,0,0,0,0,0,0,197000,0,0,0,197000,0,197000,197000
060922,金像電永豐9A購01,0,0,0,0,0,0,0,0,0,197000,0,0,0,269000,72000,197000,197000
058739,喬山中信99購01  ,0,0,0,0,0,0,0,0,0,197000,0,0,0,215000,18000,197000,197000
057819,新日興元大99購01,0,0,0,0,0,0,0,0,0,197000,0,0,0,215000,18000,197000,197000
07368P,國巨凱基99售19  ,0,0,0,0,0,0,0,0,0,197000,0,0,0,207000,10000,197000,197000
061374,力山永豐9A購04  ,0,0,0,0,0,0,0,0,0,196000,0,0,0,233000,37000,196000,196000
054792,揚明光群益97購01,0,0,0,0,0,0,0,0,0,196000,0,0,0,196000,0,196000,196000
054406,旺宏國票98購01  ,0,0,0,0,0,0,0,0,0,196000,0,0,0,208000,12000,196000,196000
058725,美律富邦9A購01  ,0,0,0,0,0,0,0,0,0,196000,0,0,0,196000,0,196000,196000
061169,GIS兆豐9A購01   ,0,0,0,0,0,0,0,0,0,195000,0,0,0,214000,19000,195000,195000
058908,貿聯元大99購03  ,0,0,0,0,0,0,0,0,0,195000,0,0,0,240000,45000,195000,195000
061468,神達群益9A購01  ,0,0,0,0,0,0,0,0,0,193000,0,0,0,354000,161000,193000,193000
061427,旭富元大9A購02  ,0,0,0,0,0,0,0,0,0,193000,0,0,0,407000,214000,193000,193000
060392,華擎群益9C購02  ,0,0,0,0,0,0,0,0,0,193000,0,0,0,631000,438000,193000,193000
2049,上銀            ,875000,656000,219000,0,0,0,0,20000,-20000,-6000,72000,76000,-4000,11000,13000,-2000,193000
6415,矽力-KY         ,612300,459500,152800,0,0,0,15000,0,15000,25000,9000,0,9000,19000,3000,16000,192800
061020,超眾國票9A購02  ,0,0,0,0,0,0,0,0,0,192000,0,0,0,196000,4000,192000,192000
060792,信錦永豐9A購01  ,0,0,0,0,0,0,0,0,0,192000,0,0,0,197000,5000,192000,192000
049700,瀚宇博元大97購01,0,0,0,0,0,0,0,0,0,192000,0,0,0,192000,0,192000,192000
056788,日月光群益98購01,0,0,0,0,0,0,0,0,0,192000,0,0,0,290000,98000,192000,192000
058334,鴻海元富99購05  ,0,0,0,0,0,0,0,0,0,192000,0,0,0,212000,20000,192000,192000
07842P,力成元大9A售01  ,0,0,0,0,0,0,0,0,0,192000,0,0,0,213000,21000,192000,192000
060885,世紀鋼中信9A購01,0,0,0,0,0,0,0,0,0,191000,0,0,0,211000,20000,191000,191000
061190,力山永豐9A購02  ,0,0,0,0,0,0,0,0,0,191000,0,0,0,256000,65000,191000,191000
054450,聯茂第一96購01  ,0,0,0,0,0,0,0,0,0,191000,0,0,0,191000,0,191000,191000
052106,明泰兆豐95購01  ,0,0,0,0,0,0,0,0,0,191000,0,0,0,191000,0,191000,191000
057470,易華電永豐98購02,0,0,0,0,0,0,0,0,0,191000,0,0,0,191000,0,191000,191000
060131,GIS永豐99購03   ,0,0,0,0,0,0,0,0,0,190000,0,0,0,190000,0,190000,190000
056822,佐登永豐98購01  ,0,0,0,0,0,0,0,0,0,190000,0,0,0,190000,0,190000,190000
057727,華邦電國泰9A購01,0,0,0,0,0,0,0,0,0,190000,0,0,0,471000,281000,190000,190000
055962,晶豪科元大97購02,0,0,0,0,0,0,0,0,0,190000,0,0,0,235000,45000,190000,190000
057543,華通凱基99購02  ,0,0,0,0,0,0,0,0,0,190000,0,0,0,218000,28000,190000,190000
059289,瑞昱元富99購01  ,0,0,0,0,0,0,0,0,0,190000,0,0,0,267000,77000,190000,190000
059729,群創元大9C購05  ,0,0,0,0,0,0,0,0,0,190000,0,0,0,273000,83000,190000,190000
059173,矽力凱基99購01  ,0,0,0,0,0,0,0,0,0,189000,0,0,0,214000,25000,189000,189000
060556,緯穎凱基9A購04  ,0,0,0,0,0,0,0,0,0,189000,0,0,0,314000,125000,189000,189000
00739,元大MSCI A股    ,4000,3000,1000,0,0,0,0,0,0,188000,0,0,0,402000,214000,188000,189000
054767,日電貿國票98購01,0,0,0,0,0,0,0,0,0,189000,0,0,0,199000,10000,189000,189000
059326,康友元大99購01  ,0,0,0,0,0,0,0,0,0,189000,0,0,0,236000,47000,189000,189000
058721,立積元富9C購01  ,0,0,0,0,0,0,0,0,0,189000,0,0,0,398000,209000,189000,189000
061039,台表科永豐9A購03,0,0,0,0,0,0,0,0,0,188000,0,0,0,194000,6000,188000,188000
059840,鴻海富邦9A購02  ,0,0,0,0,0,0,0,0,0,188000,0,0,0,265000,77000,188000,188000
006207,FH滬深          ,2000,2000,0,0,0,0,0,0,0,188000,0,0,0,193000,5000,188000,188000
050605,上証2X元大97購02,0,0,0,0,0,0,0,0,0,188000,0,0,0,188000,0,188000,188000
05983P,聯詠國票96售02  ,0,0,0,0,0,0,0,0,0,187000,0,0,0,197000,10000,187000,187000
054745,智易凱基97購01  ,0,0,0,0,0,0,0,0,0,187000,0,0,0,187000,0,187000,187000
058595,T50正2元富99購01,0,0,0,0,0,0,0,0,0,187000,0,0,0,187000,0,187000,187000
057674,台郡元大99購03  ,0,0,0,0,0,0,0,0,0,187000,0,0,0,514000,327000,187000,187000
059438,群創元大99購06  ,0,0,0,0,0,0,0,0,0,187000,0,0,0,679000,492000,187000,187000
054065,樺漢國票97購01  ,0,0,0,0,0,0,0,0,0,186000,0,0,0,186000,0,186000,186000
058990,GIS凱基99購02   ,0,0,0,0,0,0,0,0,0,186000,0,0,0,300000,114000,186000,186000
056174,億光元富97購01  ,0,0,0,0,0,0,0,0,0,186000,0,0,0,191000,5000,186000,186000
056955,台灣50永豐98購01,0,0,0,0,0,0,0,0,0,186000,0,0,0,186000,0,186000,186000
06067P,華新科康和97售01,0,0,0,0,0,0,0,0,0,185000,0,0,0,265000,80000,185000,185000
057878,台郡元大99購04  ,0,0,0,0,0,0,0,0,0,185000,0,0,0,185000,0,185000,185000
057206,立積元富98購01  ,0,0,0,0,0,0,0,0,0,185000,0,0,0,224000,39000,185000,185000
059175,臺股指凱基99購26,0,0,0,0,0,0,0,0,0,184000,0,0,0,184000,0,184000,184000
061160,瑞祺群益9A購01  ,0,0,0,0,0,0,0,0,0,184000,0,0,0,269000,85000,184000,184000
060194,旭富元富9A購01  ,0,0,0,0,0,0,0,0,0,183000,0,0,0,228000,45000,183000,183000
060284,南港元大01購01  ,0,0,0,0,0,0,0,0,0,183000,0,0,0,193000,10000,183000,183000
054921,文曄凱基97購01  ,0,0,0,0,0,0,0,0,0,183000,0,0,0,183000,0,183000,183000
04838P,宏達電元大95售02,0,0,0,0,0,0,0,0,0,183000,0,0,0,183000,0,183000,183000
056144,GIS元大98購01   ,0,0,0,0,0,0,0,0,0,183000,0,0,0,216000,33000,183000,183000
061106,群創元大9B購09  ,0,0,0,0,0,0,0,0,0,182000,0,0,0,192000,10000,182000,182000
06903P,技嘉凱基98售04  ,0,0,0,0,0,0,0,0,0,182000,0,0,0,187000,5000,182000,182000
059999,緯穎元富99購01  ,0,0,0,0,0,0,0,0,0,181000,0,0,0,181000,0,181000,181000
058406,聯茂元大99購06  ,0,0,0,0,0,0,0,0,0,181000,0,0,0,311000,130000,181000,181000
07124P,台積電元大99售21,0,0,0,0,0,0,0,0,0,181000,0,0,0,181000,0,181000,181000
060321,元金2X群益9B購01,0,0,0,0,0,0,0,0,0,180000,0,0,0,200000,20000,180000,180000
061750,台達電台新9B購01,0,0,0,0,0,0,0,0,0,180000,0,0,0,195000,15000,180000,180000
054222,大立光統一98購03,0,0,0,0,0,0,0,0,0,180000,0,0,0,180000,0,180000,180000
058822,樺漢國泰9B購01  ,0,0,0,0,0,0,0,0,0,180000,0,0,0,219000,39000,180000,180000
059628,智邦凱基99購04  ,0,0,0,0,0,0,0,0,0,180000,0,0,0,210000,30000,180000,180000
057316,國巨凱基99購04  ,0,0,0,0,0,0,0,0,0,180000,0,0,0,200000,20000,180000,180000
056351,鴻海元大98購06  ,0,0,0,0,0,0,0,0,0,180000,0,0,0,180000,0,180000,180000
061643,嘉澤元大9A購05  ,0,0,0,0,0,0,0,0,0,179000,0,0,0,252000,73000,179000,179000
062019,嘉澤永豐9B購01  ,0,0,0,0,0,0,0,0,0,179000,0,0,0,414000,235000,179000,179000
058892,元油2X元大9C購08,0,0,0,0,0,0,0,0,0,178000,0,0,0,180000,2000,178000,178000
055398,超眾統一97購03  ,0,0,0,0,0,0,0,0,0,178000,0,0,0,178000,0,178000,178000
052067,中磊兆豐96購01  ,0,0,0,0,0,0,0,0,0,178000,0,0,0,178000,0,178000,178000
061648,緯穎元大9A購04  ,0,0,0,0,0,0,0,0,0,177000,0,0,0,177000,0,177000,177000
060023,T50反1國泰9A購03,0,0,0,0,0,0,0,0,0,177000,0,0,0,177000,0,177000,177000
050601,台表科國泰96購01,0,0,0,0,0,0,0,0,0,177000,0,0,0,233000,56000,177000,177000
056693,國產群益98購01  ,0,0,0,0,0,0,0,0,0,177000,0,0,0,376000,199000,177000,177000
059312,元石油元大99購05,0,0,0,0,0,0,0,0,0,177000,0,0,0,202000,25000,177000,177000
058379,臺股指凱基99購14,0,0,0,0,0,0,0,0,0,177000,0,0,0,177000,0,177000,177000
061850,國巨國票9C購02  ,0,0,0,0,0,0,0,0,0,176000,0,0,0,200000,24000,176000,176000
058282,聯茂中信99購01  ,0,0,0,0,0,0,0,0,0,176000,0,0,0,622000,446000,176000,176000
1590,亞德客-KY       ,733000,565000,168000,0,0,0,0,1000,-1000,9000,16000,7000,9000,4000,4000,0,176000
060028,國揚永豐99購01  ,0,0,0,0,0,0,0,0,0,175000,0,0,0,180000,5000,175000,175000
060300,佐登國泰9B購01  ,0,0,0,0,0,0,0,0,0,175000,0,0,0,229000,54000,175000,175000
058834,GIS永豐99購01   ,0,0,0,0,0,0,0,0,0,175000,0,0,0,185000,10000,175000,175000
054203,滬深2X國票96購03,0,0,0,0,0,0,0,0,0,175000,0,0,0,225000,50000,175000,175000
055203,建準中信97購01  ,0,0,0,0,0,0,0,0,0,175000,0,0,0,200000,25000,175000,175000
060436,巨大永豐9A購01  ,0,0,0,0,0,0,0,0,0,174000,0,0,0,261000,87000,174000,174000
058217,新唐群益99購01  ,0,0,0,0,0,0,0,0,0,174000,0,0,0,175000,1000,174000,174000
056850,彩晶元富99購01  ,0,0,0,0,0,0,0,0,0,174000,0,0,0,272000,98000,174000,174000
056378,欣興元富98購01  ,0,0,0,0,0,0,0,0,0,174000,0,0,0,314000,140000,174000,174000
056321,創意群益98購02  ,0,0,0,0,0,0,0,0,0,174000,0,0,0,174000,0,174000,174000
060763,聯鈞元大9A購03  ,0,0,0,0,0,0,0,0,0,173000,0,0,0,205000,32000,173000,173000
058761,欣興群益99購02  ,0,0,0,0,0,0,0,0,0,173000,0,0,0,344000,171000,173000,173000
058958,台表科國票9A購03,0,0,0,0,0,0,0,0,0,173000,0,0,0,282000,109000,173000,173000
059536,新光金凱基99購05,0,0,0,0,0,0,0,0,0,173000,0,0,0,220000,47000,173000,173000
061114,南電元大9A購04  ,0,0,0,0,0,0,0,0,0,172000,0,0,0,224000,52000,172000,172000
061037,嘉澤永豐9A購01  ,0,0,0,0,0,0,0,0,0,172000,0,0,0,291000,119000,172000,172000
05625P,國巨國票97售01  ,0,0,0,0,0,0,0,0,0,172000,0,0,0,256000,84000,172000,172000
053569,漢唐統一98購01  ,0,0,0,0,0,0,0,0,0,171000,0,0,0,271000,100000,171000,171000
054467,隆達凱基97購01  ,0,0,0,0,0,0,0,0,0,171000,0,0,0,271000,100000,171000,171000
058596,旺宏台新99購01  ,0,0,0,0,0,0,0,0,0,171000,0,0,0,176000,5000,171000,171000
055744,茂林元富97購02  ,0,0,0,0,0,0,0,0,0,171000,0,0,0,335000,164000,171000,171000
057230,建準凱基98購02  ,0,0,0,0,0,0,0,0,0,171000,0,0,0,188000,17000,171000,171000
062086,瑞祺元大9B購01  ,0,0,0,0,0,0,0,0,0,170000,0,0,0,181000,11000,170000,170000
052386,鴻海群益96購02  ,0,0,0,0,0,0,0,0,0,170000,0,0,0,170000,0,170000,170000
054935,華通元大98購03  ,0,0,0,0,0,0,0,0,0,170000,0,0,0,200000,30000,170000,170000
056277,上銀富邦99購02  ,0,0,0,0,0,0,0,0,0,170000,0,0,0,170000,0,170000,170000
061774,T50反1國票9B購06,0,0,0,0,0,0,0,0,0,169000,0,0,0,200000,31000,169000,169000
052819,義隆永豐96購01  ,0,0,0,0,0,0,0,0,0,169000,0,0,0,199000,30000,169000,169000
056835,聯電元富99購01  ,0,0,0,0,0,0,0,0,0,169000,0,0,0,254000,85000,169000,169000
058521,日月光元大99購01,0,0,0,0,0,0,0,0,0,169000,0,0,0,169000,0,169000,169000
3563,牧德            ,258000,352000,-94000,0,0,0,97000,0,97000,166000,127000,8000,119000,93000,46000,47000,169000
06971P,台光電元大99售03,0,0,0,0,0,0,0,0,0,169000,0,0,0,224000,55000,169000,169000
058877,T50反1國泰9B購01,0,0,0,0,0,0,0,0,0,168000,0,0,0,277000,109000,168000,168000
061767,信邦元大9B購01  ,0,0,0,0,0,0,0,0,0,167000,0,0,0,233000,66000,167000,167000
055798,聯茂富邦98購01  ,0,0,0,0,0,0,0,0,0,167000,0,0,0,341000,174000,167000,167000
060092,瑞昱元大99購03  ,0,0,0,0,0,0,0,0,0,166000,0,0,0,226000,60000,166000,166000
058149,百和元大99購02  ,0,0,0,0,0,0,0,0,0,166000,0,0,0,166000,0,166000,166000
059507,鴻海永豐99購03  ,0,0,0,0,0,0,0,0,0,166000,0,0,0,166000,0,166000,166000
07825P,健策國泰9B售04  ,0,0,0,0,0,0,0,0,0,166000,0,0,0,241000,75000,166000,166000
5269,祥碩            ,314200,164000,150200,0,0,0,0,16000,-16000,31000,37000,4000,33000,3000,5000,-2000,165200
058498,世紀鋼群益99購01,0,0,0,0,0,0,0,0,0,165000,0,0,0,278000,113000,165000,165000
052522,聯發科元大96購05,0,0,0,0,0,0,0,0,0,165000,0,0,0,165000,0,165000,165000
6142,友勁            ,9000,14000,-5000,0,0,0,0,0,0,170000,170000,0,170000,0,0,0,165000
07617P,聯發科中信9C售04,0,0,0,0,0,0,0,0,0,165000,0,0,0,185000,20000,165000,165000
058720,旭富元富99購01  ,0,0,0,0,0,0,0,0,0,164000,0,0,0,164000,0,164000,164000
2838,聯邦銀          ,221000,57000,164000,0,0,0,0,0,0,0,0,0,0,0,0,0,164000
059908,元金2X元大99購01,0,0,0,0,0,0,0,0,0,163000,0,0,0,254000,91000,163000,163000
060624,玉晶光元大9C購02,0,0,0,0,0,0,0,0,0,163000,0,0,0,269000,106000,163000,163000
061375,華通永豐9A購02  ,0,0,0,0,0,0,0,0,0,163000,0,0,0,164000,1000,163000,163000
054582,致新元大97購01  ,0,0,0,0,0,0,0,0,0,163000,0,0,0,163000,0,163000,163000
00641R,富邦日本反1     ,2000,2000,0,0,0,0,0,0,0,163000,0,0,0,400000,237000,163000,163000
059671,滬深2X元富99購05,0,0,0,0,0,0,0,0,0,163000,0,0,0,163000,0,163000,163000
057529,嘉晶元大99購02  ,0,0,0,0,0,0,0,0,0,163000,0,0,0,185000,22000,163000,163000
2520,冠德            ,413000,310000,103000,0,0,0,0,0,0,60000,62000,2000,60000,0,0,0,163000
060870,旭富群益9A購01  ,0,0,0,0,0,0,0,0,0,162000,0,0,0,275000,113000,162000,162000
060084,聯電元大99購02  ,0,0,0,0,0,0,0,0,0,162000,0,0,0,162000,0,162000,162000
058864,欣興凱基99購04  ,0,0,0,0,0,0,0,0,0,162000,0,0,0,222000,60000,162000,162000
057717,友訊元富98購02  ,0,0,0,0,0,0,0,0,0,162000,0,0,0,184000,22000,162000,162000
059807,大立光元富99購09,0,44000,-44000,0,0,0,0,0,0,205000,0,0,0,223000,18000,205000,161000
061212,聯鈞元大9A購04  ,0,0,0,0,0,0,0,0,0,161000,0,0,0,176000,15000,161000,161000
061880,台郡元大9B購02  ,0,0,0,0,0,0,0,0,0,161000,0,0,0,202000,41000,161000,161000
05564P,玉晶光元大97售02,0,0,0,0,0,0,0,0,0,161000,0,0,0,203000,42000,161000,161000
053889,致茂群益97購01  ,0,0,0,0,0,0,0,0,0,161000,0,0,0,161000,0,161000,161000
051078,力山富邦97購01  ,0,0,0,0,0,0,0,0,0,161000,0,0,0,161000,0,161000,161000
052732,新唐國泰97購01  ,0,0,0,0,0,0,0,0,0,161000,0,0,0,161000,0,161000,161000
057160,佐登永豐98購02  ,0,0,0,0,0,0,0,0,0,161000,0,0,0,161000,0,161000,161000
061470,鈺齊群益9A購02  ,0,0,0,0,0,0,0,0,0,160000,0,0,0,160000,0,160000,160000
061455,京元電凱基9B購01,0,0,0,0,0,0,0,0,0,160000,0,0,0,160000,0,160000,160000
060959,金像電凱基9A購01,0,5000,-5000,0,0,0,0,0,0,165000,0,0,0,199000,34000,165000,160000
056770,國產元大98購02  ,0,0,0,0,0,0,0,0,0,160000,0,0,0,208000,48000,160000,160000
059847,喬山永豐99購01  ,0,0,0,0,0,0,0,0,0,159000,0,0,0,159000,0,159000,159000
047420,全新富邦97購01  ,0,0,0,0,0,0,0,0,0,159000,0,0,0,239000,80000,159000,159000
047962,T50反1中信96購02,0,0,0,0,0,0,0,0,0,159000,0,0,0,766000,607000,159000,159000
055716,致茂元大97購01  ,0,0,0,0,0,0,0,0,0,159000,0,0,0,159000,0,159000,159000
057298,旭富永豐98購01  ,0,0,0,0,0,0,0,0,0,159000,0,0,0,309000,150000,159000,159000
057960,聯鈞元大98購02  ,0,0,0,0,0,0,0,0,0,159000,0,0,0,230000,71000,159000,159000
061423,廣達元大9A購01  ,0,0,0,0,0,0,0,0,0,158000,0,0,0,474000,316000,158000,158000
061986,晶豪科元大9B購01,0,0,0,0,0,0,0,0,0,158000,0,0,0,540000,382000,158000,158000
00673R,元大S&P原油反1  ,0,0,0,0,0,0,0,0,0,158000,0,0,0,376000,218000,158000,158000
054061,晶技國票97購03  ,0,0,0,0,0,0,0,0,0,158000,0,0,0,158000,0,158000,158000
058841,深中小群益01購01,0,0,0,0,0,0,0,0,0,158000,0,0,0,710000,552000,158000,158000
057507,貿聯國票98購02  ,0,0,0,0,0,0,0,0,0,158000,0,0,0,415000,257000,158000,158000
056911,緯穎元大99購01  ,0,0,0,0,0,0,0,0,0,158000,0,0,0,178000,20000,158000,158000
061297,台積電富邦9C購09,0,0,0,0,0,0,0,0,0,157000,0,0,0,157000,0,157000,157000
057516,和鑫元富98購01  ,0,0,0,0,0,0,0,0,0,157000,0,0,0,267000,110000,157000,157000
2316,楠梓電          ,644000,497000,147000,0,0,0,0,0,0,10000,0,0,0,56000,46000,10000,157000
057532,智原元大98購03  ,0,0,0,0,0,0,0,0,0,156000,0,0,0,232000,76000,156000,156000
060049,華通凱基99購06  ,0,0,0,0,0,0,0,0,0,155000,0,0,0,155000,0,155000,155000
054799,超眾群益98購01  ,0,0,0,0,0,0,0,0,0,155000,0,0,0,253000,98000,155000,155000
054693,神基永豐97購01  ,0,0,0,0,0,0,0,0,0,155000,0,0,0,315000,160000,155000,155000
053113,瀚宇博兆豐97購01,0,0,0,0,0,0,0,0,0,155000,0,0,0,155000,0,155000,155000
058132,義隆元大99購03  ,0,0,0,0,0,0,0,0,0,155000,0,0,0,174000,19000,155000,155000
056937,智原元富98購01  ,0,0,0,0,0,0,0,0,0,155000,0,0,0,165000,10000,155000,155000
060247,牧德元大9A購02  ,0,0,0,0,0,0,0,0,0,154000,0,0,0,154000,0,154000,154000
060248,日月光元大9A購01,0,0,0,0,0,0,0,0,0,154000,0,0,0,158000,4000,154000,154000
060781,台郡國泰9B購01  ,0,0,0,0,0,0,0,0,0,154000,0,0,0,154000,0,154000,154000
050515,聯電元大96購01  ,0,0,0,0,0,0,0,0,0,154000,0,0,0,179000,25000,154000,154000
055091,微星群益97購01  ,0,0,0,0,0,0,0,0,0,154000,0,0,0,154000,0,154000,154000
058496,文曄群益99購01  ,0,0,0,0,0,0,0,0,0,154000,0,0,0,154000,0,154000,154000
059200,京鼎永豐99購02  ,0,0,0,0,0,0,0,0,0,154000,0,0,0,154000,0,154000,154000
06021P,世紀鋼元富96售03,0,0,0,0,0,0,0,0,0,153000,0,0,0,193000,40000,153000,153000
060355,元金2X元富9C購01,0,0,0,0,0,0,0,0,0,153000,0,0,0,419000,266000,153000,153000
6669,緯穎            ,474000,308800,165200,0,0,0,20000,1000,19000,-32000,1000,3000,-2000,1000,31000,-30000,152200
035274,華新台新97購01  ,0,0,0,0,0,0,0,0,0,152000,0,0,0,152000,0,152000,152000
058283,世紀鋼中信99購01,0,0,0,0,0,0,0,0,0,152000,0,0,0,152000,0,152000,152000
056480,京鼎元大98購02  ,0,0,0,0,0,0,0,0,0,152000,0,0,0,300000,148000,152000,152000
060183,南亞科元富9A購01,0,0,0,0,0,0,0,0,0,151000,0,0,0,151000,0,151000,151000
060437,宏全永豐9A購01  ,0,0,0,0,0,0,0,0,0,150000,0,0,0,150000,0,150000,150000
061394,FBVIX統一9B購01 ,0,0,0,0,0,0,0,0,0,150000,0,0,0,150000,0,150000,150000
05140P,台表科國票96售01,0,0,0,0,0,0,0,0,0,150000,0,0,0,150000,0,150000,150000
054169,上緯控凱基98購01,0,0,0,0,0,0,0,0,0,150000,0,0,0,210000,60000,150000,150000
058242,玉晶光元大9A購01,0,0,0,0,0,0,0,0,0,150000,0,0,0,150000,0,150000,150000
056007,上銀中信97購02  ,0,0,0,0,0,0,0,0,0,150000,0,0,0,150000,0,150000,150000
059650,緯穎凱基99購04  ,0,0,0,0,0,0,0,0,0,150000,0,0,0,150000,0,150000,150000
061348,聯鈞元大9A購05  ,0,0,0,0,0,0,0,0,0,149000,0,0,0,149000,0,149000,149000
061542,旺宏群益9A購04  ,0,0,0,0,0,0,0,0,0,149000,0,0,0,149000,0,149000,149000
054963,牧德元大97購02  ,0,0,0,0,0,0,0,0,0,149000,0,0,0,159000,10000,149000,149000
057141,嘉聯益兆豐99購01,0,0,0,0,0,0,0,0,0,149000,0,0,0,151000,2000,149000,149000
058201,華通凱基9A購01  ,0,0,0,0,0,0,0,0,0,149000,0,0,0,208000,59000,149000,149000
057199,台達電元富02購01,0,0,0,0,0,0,0,0,0,149000,0,0,0,355000,206000,149000,149000
055686,致伸凱基97購02  ,0,0,0,0,0,0,0,0,0,149000,0,0,0,179000,30000,149000,149000
06654P,欣興元大98售08  ,0,0,0,0,0,0,0,0,0,148000,0,0,0,200000,52000,148000,148000
053724,聯詠凱基96購04  ,0,0,0,0,0,0,0,0,0,148000,0,0,0,206000,58000,148000,148000
056524,欣興中信98購02  ,0,0,0,0,0,0,0,0,0,148000,0,0,0,168000,20000,148000,148000
056114,台達電群益97購02,0,0,0,0,0,0,0,0,0,148000,0,0,0,158000,10000,148000,148000
6531,愛普            ,176000,28000,148000,0,0,0,0,0,0,0,0,0,0,0,0,0,148000
2809,京城銀          ,531000,383000,148000,0,0,0,0,0,0,0,0,0,0,0,0,0,148000
056984,嘉晶群益98購01  ,0,0,0,0,0,0,0,0,0,147000,0,0,0,257000,110000,147000,147000
056678,力成元富98購01  ,0,0,0,0,0,0,0,0,0,147000,0,0,0,147000,0,147000,147000
2515,中工            ,441000,298000,143000,0,0,0,0,0,0,4000,0,0,0,4000,0,4000,147000
061024,南電國泰9B購01  ,0,0,0,0,0,0,0,0,0,146000,0,0,0,146000,0,146000,146000
058926,勤誠元富99購01  ,0,0,0,0,0,0,0,0,0,146000,0,0,0,178000,32000,146000,146000
056091,百和統一97購01  ,0,0,0,0,0,0,0,0,0,146000,0,0,0,199000,53000,146000,146000
060747,聯鈞國票9A購02  ,0,0,0,0,0,0,0,0,0,145000,0,0,0,148000,3000,145000,145000
060379,T50反1凱基9A購07,0,0,0,0,0,0,0,0,0,145000,0,0,0,145000,0,145000,145000
055354,宏達電凱基98購01,0,0,0,0,0,0,0,0,0,145000,0,0,0,145000,0,145000,145000
053710,華通凱基96購05  ,0,0,0,0,0,0,0,0,0,145000,0,0,0,145000,0,145000,145000
053153,大立光元大99購02,0,0,0,0,0,0,0,0,0,145000,0,0,0,145000,0,145000,145000
057170,瑞昱元大98購01  ,0,0,0,0,0,0,0,0,0,145000,0,0,0,181000,36000,145000,145000
056908,牧德元大99購03  ,0,0,0,0,0,0,0,0,0,145000,0,0,0,145000,0,145000,145000
060861,漢唐永豐9A購01  ,0,0,0,0,0,0,0,0,0,144000,0,0,0,177000,33000,144000,144000
061865,力山元大9B購01  ,0,0,0,0,0,0,0,0,0,144000,0,0,0,244000,100000,144000,144000
053118,大立光中信9C購01,0,0,0,0,0,0,0,0,0,144000,0,0,0,170000,26000,144000,144000
053810,台達電群益96購01,0,0,0,0,0,0,0,0,0,144000,0,0,0,242000,98000,144000,144000
058905,京鼎元大99購01  ,0,0,0,0,0,0,0,0,0,144000,0,0,0,266000,122000,144000,144000
057287,彩晶元大9C購03  ,0,0,0,0,0,0,0,0,0,144000,0,0,0,144000,0,144000,144000
059340,鴻海凱基9A購12  ,0,0,0,0,0,0,0,0,0,144000,0,0,0,144000,0,144000,144000
2535,達欣工          ,43000,108000,-65000,0,0,0,0,0,0,209000,209000,0,209000,0,0,0,144000
06454P,緯穎元大98售04  ,0,0,0,0,0,0,0,0,0,143000,0,0,0,182000,39000,143000,143000
061580,華擎元大9A購06  ,0,0,0,0,0,0,0,0,0,143000,0,0,0,143000,0,143000,143000
061899,復盛永豐9B購01  ,0,0,0,0,0,0,0,0,0,142000,0,0,0,142000,0,142000,142000
055955,微星元大97購01  ,0,0,0,0,0,0,0,0,0,142000,0,0,0,220000,78000,142000,142000
056116,義隆群益97購02  ,0,0,0,0,0,0,0,0,0,142000,0,0,0,176000,34000,142000,142000
058495,元大金群益9B購01,0,0,0,0,0,0,0,0,0,142000,0,0,0,194000,52000,142000,142000
2441,超豐            ,169000,65000,104000,0,0,0,40000,0,40000,-2000,3000,5000,-2000,0,0,0,142000
061474,瑞昱元大9A購04  ,0,0,0,0,0,0,0,0,0,141000,0,0,0,186000,45000,141000,141000
061241,晶技兆豐9A購01  ,0,0,0,0,0,0,0,0,0,141000,0,0,0,186000,45000,141000,141000
060940,國巨國票9B購03  ,0,0,0,0,0,0,0,0,0,141000,0,0,0,143000,2000,141000,141000
060230,台積電元大9A購07,0,0,0,0,0,0,0,0,0,141000,0,0,0,141000,0,141000,141000
059981,聯發科元大99購36,0,0,0,0,0,0,0,0,0,141000,0,0,0,146000,5000,141000,141000
056350,上銀元大98購02  ,0,0,0,0,0,0,0,0,0,141000,0,0,0,141000,0,141000,141000
059989,嘉晶元大9A購01  ,0,0,0,0,0,0,0,0,0,140000,0,0,0,201000,61000,140000,140000
060085,華通元大99購10  ,0,0,0,0,0,0,0,0,0,140000,0,0,0,190000,50000,140000,140000
060805,國巨群益9A購06  ,0,0,0,0,0,0,0,0,0,140000,0,0,0,156000,16000,140000,140000
058849,奇力新群益99購02,0,0,0,0,0,0,0,0,0,140000,0,0,0,241000,101000,140000,140000
054689,華新科永豐97購01,0,0,0,0,0,0,0,0,0,140000,0,0,0,140000,0,140000,140000
052968,燿華群益98購01  ,0,0,0,0,0,0,0,0,0,140000,0,0,0,270000,130000,140000,140000
05759P,智邦永豐96售02  ,0,0,0,0,0,0,0,0,0,140000,0,0,0,140000,0,140000,140000
057705,臺股指群益98購05,0,0,0,0,0,0,0,0,0,140000,0,0,0,177000,37000,140000,140000
058370,聯詠凱基99購01  ,0,0,0,0,0,0,0,0,0,139000,0,0,0,179000,40000,139000,139000
2897,王道銀行        ,241000,102000,139000,0,0,0,0,0,0,0,0,0,0,0,0,0,139000
07800P,華新科國泰9B售04,0,0,0,0,0,0,0,0,0,139000,0,0,0,158000,19000,139000,139000
07767P,華新科群益9A售07,0,0,0,0,0,0,0,0,0,139000,0,0,0,139000,0,139000,139000
061270,彩晶凱基9A購02  ,0,0,0,0,0,0,0,0,0,138000,0,0,0,138000,0,138000,138000
061466,創意群益9A購01  ,0,0,0,0,0,0,0,0,0,138000,0,0,0,138000,0,138000,138000
061536,華擎統一9C購02  ,0,0,0,0,0,0,0,0,0,138000,0,0,0,430000,292000,138000,138000
06594P,立積元大98售01  ,0,0,0,0,0,0,0,0,0,138000,0,0,0,355000,217000,138000,138000
054883,億光統一97購01  ,0,0,0,0,0,0,0,0,0,138000,0,0,0,178000,40000,138000,138000
058514,潤泰全元大99購01,0,0,0,0,0,0,0,0,0,138000,0,0,0,163000,25000,138000,138000
2536,宏普            ,235000,97000,138000,0,0,0,0,0,0,0,0,0,0,0,0,0,138000
060641,聯鈞永豐9A購01  ,0,0,0,0,0,0,0,0,0,137000,0,0,0,145000,8000,137000,137000
060031,旭富永豐99購02  ,0,0,0,0,0,0,0,0,0,137000,0,0,0,156000,19000,137000,137000
060184,建準元富9A購01  ,0,0,0,0,0,0,0,0,0,137000,0,0,0,137000,0,137000,137000
060383,葡萄王凱基9A購01,0,0,0,0,0,0,0,0,0,137000,0,0,0,472000,335000,137000,137000
056617,美律永豐98購01  ,0,0,0,0,0,0,0,0,0,137000,0,0,0,137000,0,137000,137000
059688,燿華永豐99購01  ,0,0,0,0,0,0,0,0,0,137000,0,0,0,157000,20000,137000,137000
2359,所羅門          ,159000,22000,137000,0,0,0,0,0,0,0,0,0,0,0,0,0,137000
055245,凱美統一99購01  ,0,0,0,0,0,0,0,0,0,136000,0,0,0,185000,49000,136000,136000
054374,信邦中信96購01  ,0,0,0,0,0,0,0,0,0,136000,0,0,0,206000,70000,136000,136000
054119,燿華永豐96購05  ,0,0,0,0,0,0,0,0,0,136000,0,0,0,136000,0,136000,136000
060888,金像電統一9C購01,0,0,0,0,0,0,0,0,0,135000,0,0,0,181000,46000,135000,135000
057998,玉晶光麥證9A購01,0,0,0,140000,5000,135000,0,0,0,135000,0,0,0,140000,5000,135000,135000
060513,緯穎元大9B購01  ,0,0,0,0,0,0,0,0,0,134000,0,0,0,136000,2000,134000,134000
060380,T50反1凱基9A購08,0,0,0,0,0,0,0,0,0,134000,0,0,0,355000,221000,134000,134000
053534,微星永豐96購02  ,0,0,0,0,0,0,0,0,0,134000,0,0,0,178000,44000,134000,134000
048187,臺指反元大96購04,0,0,0,0,0,0,0,0,0,134000,0,0,0,134000,0,134000,134000
052696,玉晶光麥證97購01,0,0,0,228000,90000,138000,0,0,0,134000,0,0,0,269000,135000,134000,134000
052533,聯發科國泰96購03,0,0,0,0,0,0,0,0,0,134000,0,0,0,134000,0,134000,134000
8163,達方            ,365000,222000,143000,0,0,0,0,0,0,-9000,0,0,0,2000,11000,-9000,134000
060572,景碩永豐9A購01  ,0,0,0,0,0,0,0,0,0,133000,0,0,0,162000,29000,133000,133000
043442,大立光台新01購01,0,0,0,0,0,0,0,0,0,133000,0,0,0,133000,0,133000,133000
055989,矽力元富9A購01  ,0,0,0,0,0,0,0,0,0,133000,0,0,0,135000,2000,133000,133000
6108,競國            ,180000,47000,133000,0,0,0,0,0,0,0,0,0,0,0,0,0,133000
07700P,臺股指元大9A售53,0,0,0,0,0,0,0,0,0,133000,0,0,0,151000,18000,133000,133000
054053,聯茂元大96購01  ,0,0,0,0,0,0,0,0,0,132000,0,0,0,165000,33000,132000,132000
054151,瑞昱國泰97購01  ,0,0,0,0,0,0,0,0,0,132000,0,0,0,189000,57000,132000,132000
058852,貿聯群益99購04  ,0,0,0,0,0,0,0,0,0,132000,0,0,0,202000,70000,132000,132000
058854,樺漢群益9B購01  ,0,0,0,0,0,0,0,0,0,132000,0,0,0,132000,0,132000,132000
057214,瑞昱群益98購01  ,0,0,0,0,0,0,0,0,0,132000,0,0,0,285000,153000,132000,132000
6505,台塑化          ,2261000,1958000,303000,0,0,0,2000,0,2000,-173000,44000,217000,-173000,0,0,0,132000
060307,南港永豐9A購01  ,0,0,0,0,0,0,0,0,0,131000,0,0,0,131000,0,131000,131000
057059,易華電元大99購01,0,0,0,0,0,0,0,0,0,131000,0,0,0,141000,10000,131000,131000
058705,長榮航元大99購01,0,0,0,0,0,0,0,0,0,131000,0,0,0,131000,0,131000,131000
057798,貿聯兆豐99購01  ,0,0,0,0,0,0,0,0,0,131000,0,0,0,308000,177000,131000,131000
059185,臺股指台新99購12,0,0,0,0,0,0,0,0,0,130000,0,0,0,130000,0,130000,130000
060608,玉晶光凱基9A購08,0,0,0,0,0,0,0,0,0,130000,0,0,0,148000,18000,130000,130000
060520,臺指2X中信01購02,0,0,0,0,0,0,0,0,0,130000,0,0,0,130000,0,130000,130000
061110,超眾元大9A購03  ,0,0,0,0,0,0,0,0,0,130000,0,0,0,150000,20000,130000,130000
061295,台積電國泰9B購02,0,0,0,0,0,0,0,0,0,130000,0,0,0,180000,50000,130000,130000
055320,建準國票98購01  ,0,0,0,0,0,0,0,0,0,130000,0,0,0,130000,0,130000,130000
055064,碩天永豐97購01  ,0,0,0,0,0,0,0,0,0,130000,0,0,0,130000,0,130000,130000
053955,華通永豐96購04  ,0,0,0,0,0,0,0,0,0,130000,0,0,0,130000,0,130000,130000
054378,楠梓電群益98購01,0,0,0,0,0,0,0,0,0,130000,0,0,0,130000,0,130000,130000
057738,旺宏富邦9A購01  ,0,0,0,0,0,0,0,0,0,130000,0,0,0,170000,40000,130000,130000
058642,旺宏麥證9A購01  ,0,0,0,130000,0,130000,0,0,0,130000,0,0,0,130000,0,130000,130000
057574,中磊永豐98購01  ,0,0,0,0,0,0,0,0,0,130000,0,0,0,130000,0,130000,130000
3708,上緯投控        ,268000,105000,163000,0,0,0,0,0,0,-33000,0,0,0,1000,34000,-33000,130000
060289,京元電元大9A購01,0,0,0,0,0,0,0,0,0,129000,0,0,0,129000,0,129000,129000
060391,華擎群益9C購01  ,0,0,0,0,0,0,0,0,0,129000,0,0,0,154000,25000,129000,129000
047769,大立光元大96購01,0,0,0,0,0,0,0,0,0,129000,0,0,0,149000,20000,129000,129000
056415,聯發科中信98購04,0,0,0,0,0,0,0,0,0,129000,0,0,0,129000,0,129000,129000
057408,台郡群益98購01  ,0,0,0,0,0,0,0,0,0,129000,0,0,0,215000,86000,129000,129000
060361,南亞科元富9A購03,0,0,0,0,0,0,0,0,0,128000,0,0,0,170000,42000,128000,128000
059791,超眾元大99購06  ,0,0,0,0,0,0,0,0,0,128000,0,0,0,157000,29000,128000,128000
060807,新光金群益9A購01,0,0,0,0,0,0,0,0,0,128000,0,0,0,172000,44000,128000,128000
057048,新日興元大98購01,0,0,0,0,0,0,0,0,0,128000,0,0,0,134000,6000,128000,128000
07561P,玉晶光永豐9A售02,0,0,0,0,0,0,0,0,0,128000,0,0,0,158000,30000,128000,128000
5288,豐祥-KY         ,140000,12000,128000,0,0,0,0,0,0,0,0,0,0,0,0,0,128000
061808,聯發科統一01購02,0,0,0,0,0,0,0,0,0,127000,0,0,0,164000,37000,127000,127000
058100,聯茂國泰99購02  ,0,0,0,0,0,0,0,0,0,127000,0,0,0,153000,26000,127000,127000
060498,華通元大9A購03  ,0,0,0,0,0,0,0,0,0,126000,0,0,0,176000,50000,126000,126000
060868,致伸永豐9A購01  ,0,0,0,0,0,0,0,0,0,126000,0,0,0,170000,44000,126000,126000
052695,台表科中信98購01,0,0,0,0,0,0,0,0,0,126000,0,0,0,292000,166000,126000,126000
051918,聯茂元大95購01  ,0,0,0,0,0,0,0,0,0,126000,0,0,0,126000,0,126000,126000
060027,元金2X永豐99購02,0,0,0,0,0,0,0,0,0,125000,0,0,0,125000,0,125000,125000
060368,緯穎元富9A購03  ,0,0,0,0,0,0,0,0,0,125000,0,0,0,130000,5000,125000,125000
06686P,麗豐永豐98售02  ,0,0,0,0,0,0,0,0,0,125000,0,0,0,162000,37000,125000,125000
055996,矽力國泰99購01  ,0,0,0,0,0,0,0,0,0,125000,0,0,0,125000,0,125000,125000
058322,玉晶光永豐99購02,30000,0,30000,0,0,0,0,0,0,95000,0,0,0,1851000,1756000,95000,125000
059103,旭富元富99購03  ,0,0,0,0,0,0,0,0,0,125000,0,0,0,125000,0,125000,125000
07420P,可成元大99售07  ,0,0,0,0,0,0,0,0,0,125000,0,0,0,145000,20000,125000,125000
06486P,麗豐元大98售02  ,0,0,0,0,0,0,0,0,0,124000,0,0,0,314000,190000,124000,124000
061729,祥碩麥證9A購02  ,0,0,0,200000,76000,124000,0,0,0,124000,0,0,0,200000,76000,124000,124000
061211,玉晶光元大9A購12,0,0,0,0,0,0,0,0,0,124000,0,0,0,316000,192000,124000,124000
056845,揚明光元富98購01,0,0,0,0,0,0,0,0,0,124000,0,0,0,124000,0,124000,124000
056846,晶相光元富98購01,0,0,0,0,0,0,0,0,0,124000,0,0,0,124000,0,124000,124000
056276,同欣電國泰98購01,0,0,0,0,0,0,0,0,0,124000,0,0,0,130000,6000,124000,124000
5522,遠雄            ,258000,134000,124000,0,0,0,0,0,0,0,0,0,0,0,0,0,124000
061719,緯穎凱基9A購06  ,0,0,0,0,0,0,0,0,0,123000,0,0,0,123000,0,123000,123000
05978P,麗豐永豐96售02  ,0,0,0,0,0,0,0,0,0,123000,0,0,0,160000,37000,123000,123000
054051,貿聯元大97購03  ,0,0,0,0,0,0,0,0,0,123000,0,0,0,123000,0,123000,123000
055901,超眾中信97購01  ,0,0,0,0,0,0,0,0,0,123000,0,0,0,123000,0,123000,123000
07452P,國巨元大9A售05  ,0,0,0,0,0,0,0,0,0,123000,0,0,0,184000,61000,123000,123000
2404,漢唐            ,267000,102000,165000,0,0,0,0,1000,-1000,-41000,0,2000,-2000,0,39000,-39000,123000
061902,百和永豐9B購01  ,0,0,0,0,0,0,0,0,0,122000,0,0,0,122000,0,122000,122000
061823,勤誠群益9B購01  ,0,0,0,0,0,0,0,0,0,122000,0,0,0,134000,12000,122000,122000
051697,康友中信95購02  ,0,0,0,0,0,0,0,0,0,122000,0,0,0,122000,0,122000,122000
055667,致茂群益98購01  ,0,0,0,0,0,0,0,0,0,122000,0,0,0,122000,0,122000,122000
061401,華擎兆豐9B購01  ,0,0,0,0,0,0,0,0,0,121000,0,0,0,185000,64000,121000,121000
060460,鴻海元大9A購08  ,0,0,0,0,0,0,0,0,0,121000,0,0,0,214000,93000,121000,121000
060621,玉晶光元大9A購05,0,0,0,0,0,0,0,0,0,121000,0,0,0,284000,163000,121000,121000
053672,嘉澤元富96購02  ,0,0,0,0,0,0,0,0,0,121000,0,0,0,311000,190000,121000,121000
055598,欣興元大97購03  ,0,0,0,0,0,0,0,0,0,121000,0,0,0,121000,0,121000,121000
055565,祥碩凱基97購01  ,0,0,0,0,0,0,0,0,0,121000,0,0,0,121000,0,121000,121000
055859,啟碁元大97購03  ,0,0,0,0,0,0,0,0,0,121000,0,0,0,131000,10000,121000,121000
057765,康舒凱基98購01  ,0,0,0,0,0,0,0,0,0,121000,0,0,0,131000,10000,121000,121000
060430,和潤永豐9A購01  ,0,0,0,0,0,0,0,0,0,120000,0,0,0,120000,0,120000,120000
059934,華通永豐99購02  ,0,0,0,0,0,0,0,0,0,120000,0,0,0,125000,5000,120000,120000
059189,國泰金富邦9B購01,0,0,0,0,0,0,0,0,0,120000,0,0,0,120000,0,120000,120000
055116,康控凱基98購01  ,0,0,0,0,0,0,0,0,0,120000,0,0,0,120000,0,120000,120000
054347,上緯控國票96購02,299000,200000,99000,0,0,0,0,0,0,21000,0,0,0,320000,299000,21000,120000
054386,鴻海統一98購03  ,0,0,0,0,0,0,0,0,0,120000,0,0,0,120000,0,120000,120000
048745,儒鴻元富97購02  ,0,0,0,0,0,0,0,0,0,120000,0,0,0,120000,0,120000,120000
052981,鴻海元大97購05  ,0,0,0,0,0,0,0,0,0,120000,0,0,0,120000,0,120000,120000
056919,英業達兆豐98購01,0,0,0,0,0,0,0,0,0,120000,0,0,0,174000,54000,120000,120000
057930,旺宏群益99購04  ,0,0,0,0,0,0,0,0,0,120000,0,0,0,125000,5000,120000,120000
058348,台表科群益99購01,0,0,0,0,0,0,0,0,0,120000,0,0,0,233000,113000,120000,120000
059281,創意永豐99購02  ,0,0,0,0,0,0,0,0,0,120000,0,0,0,141000,21000,120000,120000
050686,欣興兆豐96購01  ,0,0,0,0,0,0,0,0,0,119000,0,0,0,119000,0,119000,119000
05528P,臺股指群益96售01,0,0,0,0,0,0,0,0,0,119000,0,0,0,135000,16000,119000,119000
059647,超眾凱基99購04  ,0,0,0,0,0,0,0,0,0,119000,0,0,0,121000,2000,119000,119000
058237,嘉晶元大99購04  ,0,0,0,0,0,0,0,0,0,119000,0,0,0,172000,53000,119000,119000
059030,奇力新兆豐99購03,0,0,0,0,0,0,0,0,0,119000,0,0,0,174000,55000,119000,119000
07366P,國巨康和99售02  ,0,0,0,0,0,0,0,0,0,119000,0,0,0,545000,426000,119000,119000
06042P,華新科永豐96售04,0,0,0,0,0,0,0,0,0,118000,0,0,0,118000,0,118000,118000
061472,台積電元大9A購32,0,0,0,0,0,0,0,0,0,118000,0,0,0,118000,0,118000,118000
061876,明泰元大9B購01  ,0,0,0,0,0,0,0,0,0,118000,0,0,0,186000,68000,118000,118000
052894,國巨群益96購03  ,0,0,0,0,0,0,0,0,0,118000,0,0,0,118000,0,118000,118000
057698,奇力新群益98購02,0,0,0,0,0,0,0,0,0,118000,0,0,0,118000,0,118000,118000
056449,義隆凱基98購03  ,0,0,0,0,0,0,0,0,0,118000,0,0,0,173000,55000,118000,118000
061889,祥碩富邦9B購01  ,0,0,0,0,0,0,0,0,0,117000,0,0,0,200000,83000,117000,117000
053950,緯穎富邦97購02  ,0,0,0,0,0,0,0,0,0,117000,0,0,0,117000,0,117000,117000
054890,聯鈞統一99購01  ,0,0,0,0,0,0,0,0,0,117000,0,0,0,117000,0,117000,117000
059460,GIS永豐99購02   ,0,0,0,0,0,0,0,0,0,117000,0,0,0,117000,0,117000,117000
061475,漢唐元大9A購01  ,0,0,0,0,0,0,0,0,0,116000,0,0,0,226000,110000,116000,116000
060635,義隆永豐9A購01  ,0,0,0,0,0,0,0,0,0,116000,0,0,0,141000,25000,116000,116000
060476,瑞祺元大9A購02  ,0,0,0,0,0,0,0,0,0,116000,0,0,0,149000,33000,116000,116000
057154,易華電國泰99購01,0,0,0,0,0,0,0,0,0,116000,0,0,0,141000,25000,116000,116000
3376,新日興          ,338000,324000,14000,0,0,0,41000,0,41000,61000,91000,30000,61000,16000,16000,0,116000
2480,敦陽科          ,143000,27000,116000,0,0,0,0,0,0,0,0,0,0,0,0,0,116000
4943,康控-KY         ,235000,142000,93000,0,0,0,0,0,0,23000,0,3000,-3000,30000,4000,26000,116000
060983,南亞科元大9A購06,0,0,0,0,0,0,0,0,0,115000,0,0,0,115000,0,115000,115000
061049,奇力新中信9A購02,0,0,0,0,0,0,0,0,0,115000,0,0,0,115000,0,115000,115000
060228,亞德客元大9A購01,0,0,0,0,0,0,0,0,0,115000,0,0,0,140000,25000,115000,115000
061586,智邦富邦9A購02  ,0,0,0,0,0,0,0,0,0,115000,0,0,0,115000,0,115000,115000
061562,群創國票9B購01  ,0,0,0,0,0,0,0,0,0,115000,0,0,0,120000,5000,115000,115000
059348,日月光凱基99購01,0,0,0,0,0,0,0,0,0,115000,0,0,0,122000,7000,115000,115000
056497,GIS國泰99購01   ,0,0,0,0,0,0,0,0,0,115000,0,0,0,115000,0,115000,115000
057787,TPK國票99購01   ,0,0,0,0,0,0,0,0,0,115000,0,0,0,115000,0,115000,115000
056408,奇鋐國票99購01  ,0,0,0,0,0,0,0,0,0,115000,0,0,0,140000,25000,115000,115000
057872,旺宏元大99購06  ,0,0,0,0,0,0,0,0,0,115000,0,0,0,125000,10000,115000,115000
07263P,台積電元大99售37,0,0,0,0,0,0,0,0,0,115000,0,0,0,560000,445000,115000,115000
053744,台郡國票97購03  ,0,0,0,0,0,0,0,0,0,114000,0,0,0,157000,43000,114000,114000
05699P,茂林凱基96售05  ,0,0,0,0,0,0,0,0,0,114000,0,0,0,114000,0,114000,114000
057498,台郡元大98購04  ,0,0,0,0,0,0,0,0,0,114000,0,0,0,114000,0,114000,114000
057502,訊芯群益98購02  ,0,0,0,0,0,0,0,0,0,114000,0,0,0,222000,108000,114000,114000
061617,微星群益9A購02  ,0,0,0,0,0,0,0,0,0,113000,0,0,0,113000,0,113000,113000
061931,力山國票9B購02  ,0,0,0,0,0,0,0,0,0,113000,0,0,0,193000,80000,113000,113000
060107,旭富元大99購03  ,0,0,0,0,0,0,0,0,0,113000,0,0,0,133000,20000,113000,113000
053500,新日興兆豐97購01,0,0,0,0,0,0,0,0,0,113000,0,0,0,141000,28000,113000,113000
054710,東元元富97購01  ,0,0,0,0,0,0,0,0,0,113000,0,0,0,213000,100000,113000,113000
058909,神達元大99購03  ,0,0,0,0,0,0,0,0,0,113000,0,0,0,119000,6000,113000,113000
00728,第一金工業30    ,0,0,0,0,0,0,0,0,0,113000,0,0,0,352000,239000,113000,113000
058137,玉晶光元大99購11,0,0,0,0,0,0,0,0,0,113000,0,0,0,163000,50000,113000,113000
056271,嘉澤統一97購01  ,0,0,0,0,0,0,0,0,0,113000,0,0,0,130000,17000,113000,113000
055688,力成凱基98購02  ,0,0,0,0,0,0,0,0,0,113000,0,0,0,113000,0,113000,113000
07782P,寶成凱基9A售02  ,0,0,0,0,0,0,0,0,0,113000,0,0,0,132000,19000,113000,113000
6456,GIS-KY          ,668000,624000,44000,0,0,0,120000,0,120000,-51000,41000,33000,8000,27000,86000,-59000,113000
060433,億豐永豐9A購01  ,0,0,0,0,0,0,0,0,0,112000,0,0,0,112000,0,112000,112000
060315,易華電永豐9A購01,0,0,0,0,0,0,0,0,0,112000,0,0,0,112000,0,112000,112000
060869,超眾永豐9A購02  ,0,0,0,0,0,0,0,0,0,112000,0,0,0,117000,5000,112000,112000
060890,大立光統一01購01,0,0,0,0,0,0,0,0,0,112000,0,0,0,167000,55000,112000,112000
052045,瑞昱凱基96購01  ,0,0,0,0,0,0,0,0,0,112000,0,0,0,122000,10000,112000,112000
055433,嘉聯益群益99購01,0,0,0,0,0,0,0,0,0,112000,0,0,0,212000,100000,112000,112000
07686P,祥碩凱基9A售02  ,0,0,0,0,0,0,0,0,0,112000,0,0,0,132000,20000,112000,112000
060911,大毅元大9A購01  ,0,0,0,0,0,0,0,0,0,111000,0,0,0,114000,3000,111000,111000
060475,瑞祺元大9A購01  ,0,0,0,0,0,0,0,0,0,111000,0,0,0,124000,13000,111000,111000
060164,合勤控永豐9A購01,0,0,0,0,0,0,0,0,0,111000,0,0,0,211000,100000,111000,111000
061933,光寶科國票9B購01,0,0,0,0,0,0,0,0,0,111000,0,0,0,111000,0,111000,111000
061544,大毅群益9B購02  ,0,0,0,0,0,0,0,0,0,111000,0,0,0,278000,167000,111000,111000
058999,台積電元大99購24,0,0,0,0,0,0,0,0,0,111000,0,0,0,225000,114000,111000,111000
054716,緯穎康和97購01  ,0,0,0,0,0,0,0,0,0,111000,0,0,0,111000,0,111000,111000
057748,華通國票98購04  ,0,0,0,0,0,0,0,0,0,111000,0,0,0,153000,42000,111000,111000
059252,聯詠凱基99購03  ,0,0,0,0,0,0,0,0,0,111000,0,0,0,135000,24000,111000,111000
061552,南六群益9A購02  ,0,0,0,0,0,0,0,0,0,110000,0,0,0,280000,170000,110000,110000
061309,鴻海統一9C購05  ,0,0,0,0,0,0,0,0,0,110000,0,0,0,110000,0,110000,110000
060154,堤維西永豐9A購01,0,0,0,0,0,0,0,0,0,110000,0,0,0,110000,0,110000,110000
052558,新唐國票97購01  ,0,0,0,0,0,0,0,0,0,110000,0,0,0,110000,0,110000,110000
047292,台光電元富96購01,0,0,0,0,0,0,0,0,0,110000,0,0,0,110000,0,110000,110000
059160,華通凱基99購03  ,0,0,0,0,0,0,0,0,0,110000,0,0,0,116000,6000,110000,110000
059485,台灣50兆豐99購02,0,0,0,0,0,0,0,0,0,110000,0,0,0,110000,0,110000,110000
058013,SP黃豆凱基9A購01,0,0,0,0,0,0,0,0,0,110000,0,0,0,110000,0,110000,110000
057168,旺宏元大99購03  ,0,0,0,0,0,0,0,0,0,110000,0,0,0,116000,6000,110000,110000
056139,貿聯元大97購04  ,0,0,0,0,0,0,0,0,0,110000,0,0,0,150000,40000,110000,110000
057842,緯穎富邦99購02  ,0,0,0,0,0,0,0,0,0,110000,0,0,0,110000,0,110000,110000
056949,義隆統一98購01  ,0,0,0,0,0,0,0,0,0,110000,0,0,0,119000,9000,110000,110000
056629,昇陽半永豐98購01,0,0,0,0,0,0,0,0,0,110000,0,0,0,167000,57000,110000,110000
07238P,台灣50國票99售07,0,0,0,0,0,0,0,0,0,110000,0,0,0,110000,0,110000,110000
06025P,臺股指元大99售02,0,0,0,0,0,0,0,0,0,109000,0,0,0,111000,2000,109000,109000
060577,玉晶光中信9A購02,0,0,0,0,0,0,0,0,0,109000,0,0,0,124000,15000,109000,109000
060989,國泰金元大9A購02,0,0,0,0,0,0,0,0,0,109000,0,0,0,109000,0,109000,109000
06705P,臻鼎元富98售03  ,0,0,0,0,0,0,0,0,0,109000,0,0,0,129000,20000,109000,109000
058995,台達電元大99購01,0,0,0,0,0,0,0,0,0,109000,0,0,0,109000,0,109000,109000
057221,華通國票98購03  ,0,0,0,0,0,0,0,0,0,109000,0,0,0,152000,43000,109000,109000
058102,楠梓電永豐98購04,0,0,0,0,0,0,0,0,0,109000,0,0,0,149000,40000,109000,109000
061763,聯電元大9C購02  ,0,0,0,0,0,0,0,0,0,108000,0,0,0,128000,20000,108000,108000
060849,力成國票9A購01  ,0,0,0,0,0,0,0,0,0,108000,0,0,0,254000,146000,108000,108000
060817,華邦電台新9A購01,0,0,0,0,0,0,0,0,0,108000,0,0,0,249000,141000,108000,108000
055510,GIS元大97購03   ,0,0,0,0,0,0,0,0,0,108000,0,0,0,125000,17000,108000,108000
053473,聯發科元大96購15,0,0,0,0,0,0,0,0,0,108000,0,0,0,108000,0,108000,108000
050283,T50反1凱基9A購01,0,0,0,0,0,0,0,0,0,108000,0,0,0,108000,0,108000,108000
052723,新唐統一97購01  ,0,0,0,0,0,0,0,0,0,108000,0,0,0,108000,0,108000,108000
059567,台積電凱基9A購12,0,0,0,0,0,0,0,0,0,108000,0,0,0,113000,5000,108000,108000
059614,致新永豐99購01  ,0,0,0,0,0,0,0,0,0,108000,0,0,0,191000,83000,108000,108000
056084,漢唐統一97購03  ,0,0,0,0,0,0,0,0,0,108000,0,0,0,138000,30000,108000,108000
056852,矽格元富98購01  ,0,0,0,0,0,0,0,0,0,108000,0,0,0,144000,36000,108000,108000
058692,華邦電國票9B購01,0,0,0,0,0,0,0,0,0,108000,0,0,0,240000,132000,108000,108000
059109,台積電富邦9C購03,0,0,0,0,0,0,0,0,0,108000,0,0,0,150000,42000,108000,108000
057454,上銀國泰99購02  ,0,0,0,0,0,0,0,0,0,108000,0,0,0,120000,12000,108000,108000
056549,嘉聯益凱基98購04,0,0,0,0,0,0,0,0,0,108000,0,0,0,108000,0,108000,108000
059830,台郡凱基99購05  ,0,0,0,0,0,0,0,0,0,107000,0,0,0,107000,0,107000,107000
053405,台達電兆豐96購01,0,0,0,0,0,0,0,0,0,107000,0,0,0,107000,0,107000,107000
055131,茂林康和97購01  ,0,0,0,0,0,0,0,0,0,107000,0,0,0,689000,582000,107000,107000
058760,嘉晶群益9A購01  ,0,0,0,0,0,0,0,0,0,107000,0,0,0,207000,100000,107000,107000
057164,國巨元大98購14  ,0,0,0,0,0,0,0,0,0,107000,0,0,0,176000,69000,107000,107000
058055,華擎統一9A購01  ,0,0,0,0,0,0,0,0,0,107000,0,0,0,711000,604000,107000,107000
056190,昇陽半統一97購01,0,0,0,0,0,0,0,0,0,107000,0,0,0,178000,71000,107000,107000
059878,聯茂凱基99購07  ,0,0,0,0,0,0,0,0,0,106000,0,0,0,297000,191000,106000,106000
060745,京元電國票9A購01,0,0,0,0,0,0,0,0,0,106000,0,0,0,172000,66000,106000,106000
061551,GIS群益9A購01   ,0,0,0,0,0,0,0,0,0,106000,0,0,0,142000,36000,106000,106000
061627,台表科群益9A購01,0,0,0,0,0,0,0,0,0,106000,0,0,0,136000,30000,106000,106000
06848P,聯詠元大98售04  ,0,0,0,0,0,0,0,0,0,106000,0,0,0,118000,12000,106000,106000
06748P,智邦台新98售02  ,0,0,0,0,0,0,0,0,0,106000,0,0,0,116000,10000,106000,106000
055132,台虹康和97購01  ,0,0,0,0,0,0,0,0,0,106000,0,0,0,106000,0,106000,106000
00668,國泰美國道瓊    ,66000,0,66000,0,0,0,0,0,0,40000,0,0,0,132000,92000,40000,106000
059016,晶相光元富99購03,0,0,0,0,0,0,0,0,0,106000,0,0,0,110000,4000,106000,106000
061480,泰碩元大9B購01  ,0,0,0,0,0,0,0,0,0,105000,0,0,0,169000,64000,105000,105000
061043,百和永豐9A購01  ,0,0,0,0,0,0,0,0,0,105000,0,0,0,107000,2000,105000,105000
060458,華通元大9A購02  ,0,0,0,0,0,0,0,0,0,105000,0,0,0,118000,13000,105000,105000
061134,大成鋼統一9C購01,0,0,0,0,0,0,0,0,0,104000,0,0,0,159000,55000,104000,104000
061663,南六永豐9A購05  ,0,0,0,0,0,0,0,0,0,104000,0,0,0,183000,79000,104000,104000
052969,建準群益97購01  ,0,0,0,0,0,0,0,0,0,104000,0,0,0,115000,11000,104000,104000
053921,嘉晶國票97購03  ,0,0,0,0,0,0,0,0,0,104000,0,0,0,173000,69000,104000,104000
056784,南亞科群益98購01,0,0,0,0,0,0,0,0,0,104000,0,0,0,104000,0,104000,104000
059732,超眾元大9A購01  ,0,0,0,0,0,0,0,0,0,104000,0,0,0,133000,29000,104000,104000
07875P,祥碩群益9B售01  ,0,0,0,0,0,0,0,0,0,104000,0,0,0,124000,20000,104000,104000
06844P,智邦元大98售13  ,0,0,0,0,0,0,0,0,0,103000,0,0,0,103000,0,103000,103000
060712,建準永豐9A購01  ,0,0,0,0,0,0,0,0,0,103000,0,0,0,183000,80000,103000,103000
060369,滬深2X元富01購01,0,0,0,0,0,0,0,0,0,103000,0,0,0,115000,12000,103000,103000
03050X,元展47          ,0,0,0,0,0,0,0,0,0,103000,0,0,0,109000,6000,103000,103000
057805,華通元大98購06  ,0,0,0,0,0,0,0,0,0,103000,0,0,0,203000,100000,103000,103000
057390,台表科永豐98購01,0,0,0,0,0,0,0,0,0,103000,0,0,0,103000,0,103000,103000
060764,華擎元大9A購03  ,0,0,0,0,0,0,0,0,0,102000,0,0,0,142000,40000,102000,102000
061742,奇鋐凱基9B購01  ,0,0,0,0,0,0,0,0,0,102000,0,0,0,138000,36000,102000,102000
061801,祥碩永豐9B購01  ,0,0,0,0,0,0,0,0,0,102000,0,0,0,217000,115000,102000,102000
050372,全新元大96購03  ,0,0,0,0,0,0,0,0,0,102000,0,0,0,102000,0,102000,102000
052692,滬深2X中信99購02,0,0,0,0,0,0,0,0,0,102000,0,0,0,102000,0,102000,102000
052606,聯發科元大97購04,0,0,0,0,0,0,0,0,0,102000,0,0,0,102000,0,102000,102000
054928,帆宣凱基98購01  ,0,0,0,0,0,0,0,0,0,102000,0,0,0,102000,0,102000,102000
053565,台光電富邦98購01,0,0,0,0,0,0,0,0,0,102000,0,0,0,102000,0,102000,102000
058966,元油2X日盛99購03,0,0,0,0,0,0,0,0,0,102000,0,0,0,112000,10000,102000,102000
057282,大立光元大99購06,0,0,0,0,0,0,0,0,0,102000,0,0,0,110000,8000,102000,102000
059639,大立光凱基9A購06,0,0,0,0,0,0,0,0,0,102000,0,0,0,132000,30000,102000,102000
059515,牧德永豐99購01  ,0,0,0,0,0,0,0,0,0,102000,0,0,0,139000,37000,102000,102000
058027,鴻海富邦98購04  ,0,0,0,0,0,0,0,0,0,102000,0,0,0,102000,0,102000,102000
057982,帆宣永豐98購01  ,0,0,0,0,0,0,0,0,0,102000,0,0,0,102000,0,102000,102000
07208P,台積電凱基99售14,0,0,0,0,0,0,0,0,0,102000,0,0,0,112000,10000,102000,102000
061929,嘉澤凱基9B購01  ,0,0,0,0,0,0,0,0,0,101000,0,0,0,147000,46000,101000,101000
060841,宏達電國票9B購01,0,0,0,0,0,0,0,0,0,101000,0,0,0,101000,0,101000,101000
06091P,華新科統一97售01,0,0,0,0,0,0,0,0,0,101000,0,0,0,101000,0,101000,101000
020000,富邦特選蘋果N   ,0,0,0,0,0,0,0,0,0,101000,0,0,0,104000,3000,101000,101000
057257,台泥兆豐99購01  ,0,0,0,0,0,0,0,0,0,101000,0,0,0,196000,95000,101000,101000
059096,百和元大99購04  ,0,0,0,0,0,0,0,0,0,101000,0,0,0,101000,0,101000,101000
07832P,台積電群益9A售08,0,0,0,0,0,0,0,0,0,101000,0,0,0,150000,49000,101000,101000
4414,如興            ,406000,305000,101000,0,0,0,0,0,0,0,0,0,0,0,0,0,101000
060910,聯發科元大9A購05,0,0,0,0,0,0,0,0,0,100000,0,0,0,105000,5000,100000,100000
060681,華擎元大9A購02  ,0,0,0,0,0,0,0,0,0,100000,0,0,0,100000,0,100000,100000
061972,華新元大9B購01  ,0,0,0,0,0,0,0,0,0,100000,0,0,0,100000,0,100000,100000
06853P,華擎元富98售03  ,0,0,0,0,0,0,0,0,0,100000,0,0,0,160000,60000,100000,100000
061673,仁寶元大9B購01  ,0,0,0,0,0,0,0,0,0,100000,0,0,0,100000,0,100000,100000
061279,鴻海統一9C購04  ,0,0,0,0,0,0,0,0,0,100000,0,0,0,100000,0,100000,100000
04126P,滬深2X國票95售02,0,0,0,0,0,0,0,0,0,100000,0,0,0,100000,0,100000,100000
050700,健策凱基96購01  ,0,0,0,0,0,0,0,0,0,100000,0,0,0,100000,0,100000,100000
05118P,超眾元大96售04  ,0,0,0,0,0,0,0,0,0,100000,0,0,0,100000,0,100000,100000
052565,上銀凱基96購01  ,0,0,0,0,0,0,0,0,0,100000,0,0,0,100000,0,100000,100000
052453,崇越元大95購01  ,0,0,0,0,0,0,0,0,0,100000,0,0,0,100000,0,100000,100000
05152P,玉晶光群益96售05,0,0,0,0,0,0,0,0,0,100000,0,0,0,220000,120000,100000,100000
054424,大成鋼富邦97購02,0,0,0,0,0,0,0,0,0,100000,0,0,0,100000,0,100000,100000
058922,聯發科元富03購02,0,0,0,0,0,0,0,0,0,100000,0,0,0,100000,0,100000,100000
05895P,奇力新群益96售03,0,0,0,0,0,0,0,0,0,100000,0,0,0,100000,0,100000,100000
058745,元金2X凱基9C購02,0,0,0,0,0,0,0,0,0,100000,0,0,0,100000,0,100000,100000
055271,鴻海元大98購03  ,0,0,0,0,0,0,0,0,0,100000,0,0,0,100000,0,100000,100000
055133,致新康和97購01  ,0,0,0,0,0,0,0,0,0,100000,0,0,0,100000,0,100000,100000
055528,華邦電群益97購01,0,0,0,0,0,0,0,0,0,100000,0,0,0,100000,0,100000,100000
054902,億光康和97購01  ,0,0,0,0,0,0,0,0,0,100000,0,0,0,100000,0,100000,100000
053875,GIS元大97購01   ,0,0,0,0,0,0,0,0,0,100000,0,0,0,208000,108000,100000,100000
053374,台達電元大96購03,0,0,0,0,0,0,0,0,0,100000,0,0,0,100000,0,100000,100000
056619,強茂永豐98購01  ,0,0,0,0,0,0,0,0,0,100000,0,0,0,100000,0,100000,100000
055835,華邦電元大97購03,0,0,0,0,0,0,0,0,0,100000,0,0,0,100000,0,100000,100000
055708,茂林永豐97購02  ,0,0,0,0,0,0,0,0,0,100000,0,0,0,100000,0,100000,100000
055665,亞德客群益97購01,0,0,0,0,0,0,0,0,0,100000,0,0,0,101000,1000,100000,100000
057671,群創元大9B購06  ,0,0,0,0,0,0,0,0,0,100000,0,0,0,100000,0,100000,100000
058685,TPK凱基99購01   ,0,0,0,0,0,0,0,0,0,100000,0,0,0,100000,0,100000,100000
057431,京鼎兆豐98購02  ,0,0,0,0,0,0,0,0,0,100000,0,0,0,110000,10000,100000,100000
056057,華邦電元大97購05,0,0,0,0,0,0,0,0,0,100000,0,0,0,100000,0,100000,100000
058308,全新元大9B購01  ,0,0,0,0,0,0,0,0,0,100000,0,0,0,118000,18000,100000,100000
057102,亞光中信9A購01  ,0,0,0,0,0,0,0,0,0,100000,0,0,0,100000,0,100000,100000
061294,奇力新麥證9A購01,0,0,0,109000,10000,99000,0,0,0,99000,0,0,0,109000,10000,99000,99000
061593,智原永豐9A購01  ,0,0,0,0,0,0,0,0,0,99000,0,0,0,99000,0,99000,99000
06516P,國巨凱基98售08  ,0,0,0,0,0,0,0,0,0,99000,0,0,0,135000,36000,99000,99000
061990,台勝科元大9C購01,0,0,0,0,0,0,0,0,0,99000,0,0,0,176000,77000,99000,99000
061003,南亞科兆豐9A購01,0,0,0,0,0,0,0,0,0,99000,0,0,0,111000,12000,99000,99000
054343,世紀鋼元富96購02,0,0,0,0,0,0,0,0,0,99000,0,0,0,286000,187000,99000,99000
055415,禾伸堂富邦9B購01,0,0,0,0,0,0,0,0,0,99000,0,0,0,99000,0,99000,99000
058944,元石油群益9C購02,0,0,0,0,0,0,0,0,0,99000,0,0,0,99000,0,99000,99000
053067,牧德群益96購01  ,0,0,0,0,0,0,0,0,0,99000,0,0,0,179000,80000,99000,99000
052796,和碩兆豐96購01  ,0,0,0,0,0,0,0,0,0,99000,0,0,0,172000,73000,99000,99000
049237,元油2X元富96購07,0,0,0,0,0,0,0,0,0,99000,0,0,0,99000,0,99000,99000
056067,智原元大97購01  ,0,0,0,0,0,0,0,0,0,99000,0,0,0,100000,1000,99000,99000
057255,聯發科麥證98購02,0,0,0,99000,0,99000,0,0,0,99000,0,0,0,99000,0,99000,99000
058148,百和元大99購01  ,0,0,0,0,0,0,0,0,0,99000,0,0,0,104000,5000,99000,99000
057833,聯發科元富02購06,0,0,0,0,0,0,0,0,0,99000,0,0,0,103000,4000,99000,99000
061022,健策國泰9B購03  ,0,0,0,0,0,0,0,0,0,98000,0,0,0,204000,106000,98000,98000
060195,旭富元富9A購02  ,0,0,0,0,0,0,0,0,0,98000,0,0,0,98000,0,98000,98000
062098,億光永豐9B購01  ,0,0,0,0,0,0,0,0,0,98000,0,0,0,100000,2000,98000,98000
052447,聯發科元大96購04,0,0,0,0,0,0,0,0,0,98000,0,0,0,103000,5000,98000,98000
054426,國泰金富邦97購02,0,0,0,0,0,0,0,0,0,98000,0,0,0,108000,10000,98000,98000
058972,新日興永豐9A購01,0,0,0,0,0,0,0,0,0,98000,0,0,0,98000,0,98000,98000
058803,世紀鋼元大99購03,0,0,0,0,0,0,0,0,0,98000,0,0,0,227000,129000,98000,98000
055536,嘉聯益群益99購02,0,0,0,0,0,0,0,0,0,98000,0,0,0,98000,0,98000,98000
054384,瀚宇博群益96購02,0,0,0,0,0,0,0,0,0,98000,0,0,0,98000,0,98000,98000
053996,晶相光群益97購01,0,0,0,0,0,0,0,0,0,98000,0,0,0,98000,0,98000,98000
054856,得力群益99購01  ,0,0,0,0,0,0,0,0,0,98000,0,0,0,98000,0,98000,98000
056243,創意群益97購03  ,0,0,0,0,0,0,0,0,0,98000,0,0,0,98000,0,98000,98000
058049,帆宣元大98購01  ,0,0,0,0,0,0,0,0,0,98000,0,0,0,100000,2000,98000,98000
2816,旺旺保          ,102000,4000,98000,0,0,0,0,0,0,0,0,0,0,0,0,0,98000
3533,嘉澤            ,366000,174000,192000,0,0,0,0,145000,-145000,51000,86000,12000,74000,13000,36000,-23000,98000
059851,晶相光永豐99購02,0,0,0,0,0,0,0,0,0,97000,0,0,0,103000,6000,97000,97000
054897,信錦康和97購01  ,0,0,0,0,0,0,0,0,0,97000,0,0,0,97000,0,97000,97000
07545P,玉晶光凱基9A售07,0,0,0,0,0,0,0,0,0,97000,0,0,0,130000,33000,97000,97000
061032,金像電永豐9A購03,0,0,0,0,0,0,0,0,0,96000,0,0,0,217000,121000,96000,96000
061296,台積電國泰9C購01,0,0,0,0,0,0,0,0,0,96000,0,0,0,103000,7000,96000,96000
054874,帆宣群益99購02  ,0,0,0,0,0,0,0,0,0,96000,0,0,0,96000,0,96000,96000
054909,福懋科康和97購01,0,0,0,0,0,0,0,0,0,96000,0,0,0,96000,0,96000,96000
054481,鎧勝中信96購01  ,0,0,0,0,0,0,0,0,0,96000,0,0,0,101000,5000,96000,96000
050892,聯電元大96購02  ,0,0,0,0,0,0,0,0,0,96000,0,0,0,100000,4000,96000,96000
058035,旭富永豐98購02  ,0,0,0,0,0,0,0,0,0,96000,0,0,0,411000,315000,96000,96000
057265,聯詠兆豐98購01  ,0,0,0,0,0,0,0,0,0,96000,0,0,0,96000,0,96000,96000
058669,上銀群益99購01  ,0,0,0,0,0,0,0,0,0,96000,0,0,0,98000,2000,96000,96000
059923,緯穎元大99購09  ,0,0,0,0,0,0,0,0,0,95000,0,0,0,95000,0,95000,95000
060239,國揚元大9C購01  ,0,0,0,0,0,0,0,0,0,95000,0,0,0,147000,52000,95000,95000
053281,茂林元大96購02  ,0,0,0,0,0,0,0,0,0,95000,0,0,0,105000,10000,95000,95000
053424,欣興永豐96購02  ,0,0,0,0,0,0,0,0,0,95000,0,0,0,134000,39000,95000,95000
054265,GIS元大96購03   ,0,0,0,0,0,0,0,0,0,95000,0,0,0,269000,174000,95000,95000
054950,奇力新元大98購02,0,0,0,0,0,0,0,0,0,95000,0,0,0,100000,5000,95000,95000
057736,鴻海富邦99購04  ,0,0,0,0,0,0,0,0,0,95000,0,0,0,95000,0,95000,95000
056397,彩晶永豐99購01  ,0,0,0,0,0,0,0,0,0,95000,0,0,0,153000,58000,95000,95000
058170,國巨凱基9A購06  ,0,0,0,0,0,0,0,0,0,95000,0,0,0,285000,190000,95000,95000
057000,亞德客國票99購01,0,0,0,0,0,0,0,0,0,95000,0,0,0,102000,7000,95000,95000
058225,旺宏元富99購01  ,0,0,0,0,0,0,0,0,0,95000,0,0,0,105000,10000,95000,95000
07891P,臺股指國票9B售01,0,0,0,0,0,0,0,0,0,95000,0,0,0,95000,0,95000,95000
060275,元黃金元大9A購01,0,0,0,0,0,0,0,0,0,94000,0,0,0,107000,13000,94000,94000
059059,宏達電凱基99購03,0,0,0,0,0,0,0,0,0,94000,0,0,0,94000,0,94000,94000
051000,台郡元大96購01  ,0,0,0,0,0,0,0,0,0,94000,0,0,0,94000,0,94000,94000
056747,致新凱基99購01  ,0,0,0,0,0,0,0,0,0,94000,0,0,0,144000,50000,94000,94000
060029,嘉晶永豐99購03  ,0,0,0,0,0,0,0,0,0,93000,0,0,0,103000,10000,93000,93000
060813,高鐵凱基9A購01  ,0,0,0,0,0,0,0,0,0,93000,0,0,0,161000,68000,93000,93000
061155,華新科群益9A購06,0,0,0,0,0,0,0,0,0,93000,0,0,0,100000,7000,93000,93000
06212P,華新科元大97售11,0,0,0,0,0,0,0,0,0,93000,0,0,0,109000,16000,93000,93000
054318,台虹凱基98購01  ,0,0,0,0,0,0,0,0,0,93000,0,0,0,168000,75000,93000,93000
053784,奇力新元大97購02,0,0,0,0,0,0,0,0,0,93000,0,0,0,98000,5000,93000,93000
059514,嘉澤永豐99購02  ,0,0,0,0,0,0,0,0,0,93000,0,0,0,123000,30000,93000,93000
059228,臺股指元大99購21,0,0,0,0,0,0,0,0,0,93000,0,0,0,93000,0,93000,93000
059283,康友永豐99購02  ,0,0,0,0,0,0,0,0,0,93000,0,0,0,93000,0,93000,93000
061157,聯鈞群益9A購02  ,0,0,0,0,0,0,0,0,0,92000,0,0,0,125000,33000,92000,92000
061265,富邦金凱基9B購01,0,0,0,0,0,0,0,0,0,92000,0,0,0,174000,82000,92000,92000
060916,金像電國泰9C購01,0,0,0,0,0,0,0,0,0,92000,0,0,0,184000,92000,92000,92000
061063,國巨凱基9A購14  ,0,0,0,0,0,0,0,0,0,92000,0,0,0,232000,140000,92000,92000
061135,聯發科統一9C購03,0,0,0,0,0,0,0,0,0,92000,0,0,0,92000,0,92000,92000
061082,台光電兆豐9A購01,0,0,0,0,0,0,0,0,0,92000,0,0,0,314000,222000,92000,92000
060761,南亞科元大9A購05,0,0,0,0,0,0,0,0,0,92000,0,0,0,100000,8000,92000,92000
060506,京元電元大9A購02,0,0,0,0,0,0,0,0,0,92000,0,0,0,97000,5000,92000,92000
054873,帆宣群益99購01  ,0,0,0,0,0,0,0,0,0,92000,0,0,0,92000,0,92000,92000
059008,鈺齊元大99購03  ,0,0,0,0,0,0,0,0,0,92000,0,0,0,112000,20000,92000,92000
058405,訊連元大99購02  ,0,0,0,0,0,0,0,0,0,92000,0,0,0,201000,109000,92000,92000
056847,佐登元富98購01  ,0,0,0,0,0,0,0,0,0,92000,0,0,0,389000,297000,92000,92000
056501,貿聯富邦99購01  ,0,0,0,0,0,0,0,0,0,92000,0,0,0,92000,0,92000,92000
060569,台積電永豐9A購01,0,0,0,0,0,0,0,0,0,91000,0,0,0,91000,0,91000,91000
060984,南亞科元大9A購07,0,0,0,0,0,0,0,0,0,91000,0,0,0,100000,9000,91000,91000
060055,宏達電凱基99購06,0,0,0,0,0,0,0,0,0,91000,0,0,0,91000,0,91000,91000
061491,嘉聯益兆豐9B購01,0,0,0,0,0,0,0,0,0,91000,0,0,0,91000,0,91000,91000
054766,智原國票98購01  ,0,0,0,0,0,0,0,0,0,91000,0,0,0,91000,0,91000,91000
052177,京鼎元大95購02  ,0,0,0,0,0,0,0,0,0,91000,0,0,0,91000,0,91000,91000
056488,致新元大99購01  ,0,0,0,0,0,0,0,0,0,91000,0,0,0,313000,222000,91000,91000
058457,創意永豐99購01  ,0,0,0,0,0,0,0,0,0,91000,0,0,0,143000,52000,91000,91000
059661,大立光元大99購22,0,0,0,0,0,0,0,0,0,91000,0,0,0,91000,0,91000,91000
059377,台積電群益99購09,0,0,0,0,0,0,0,0,0,91000,0,0,0,91000,0,91000,91000
2608,嘉里大榮        ,138000,75000,63000,0,0,0,0,0,0,28000,28000,0,28000,0,0,0,91000
061754,晶技麥證9B購01  ,0,0,0,90000,0,90000,0,0,0,90000,0,0,0,90000,0,90000,90000
061450,嘉晶中信9A購01  ,0,0,0,0,0,0,0,0,0,90000,0,0,0,260000,170000,90000,90000
062068,滬深2X元大9B購02,0,0,0,0,0,0,0,0,0,90000,0,0,0,90000,0,90000,90000
06939P,國巨永豐98售09  ,0,0,0,0,0,0,0,0,0,90000,0,0,0,90000,0,90000,90000
059834,友達國泰9B購01  ,0,0,0,0,0,0,0,0,0,90000,0,0,0,140000,50000,90000,90000
060312,潤泰全永豐9A購01,0,0,0,0,0,0,0,0,0,90000,0,0,0,98000,8000,90000,90000
060245,聯陽元大9C購01  ,0,0,0,0,0,0,0,0,0,90000,0,0,0,185000,95000,90000,90000
060349,上証2X元富9A購04,0,0,0,0,0,0,0,0,0,90000,0,0,0,90000,0,90000,90000
052492,易華電國票96購02,0,0,0,0,0,0,0,0,0,90000,0,0,0,90000,0,90000,90000
052014,光罩永豐95購01  ,0,0,0,0,0,0,0,0,0,90000,0,0,0,90000,0,90000,90000
054482,大成鋼台新96購01,0,0,0,0,0,0,0,0,0,90000,0,0,0,90000,0,90000,90000
045767,大立光元富95購01,0,0,0,0,0,0,0,0,0,90000,0,0,0,98000,8000,90000,90000
049972,南電國票95購02  ,0,0,0,0,0,0,0,0,0,90000,0,0,0,130000,40000,90000,90000
053440,台積電凱基96購12,0,0,0,0,0,0,0,0,0,90000,0,0,0,90000,0,90000,90000
053697,臻鼎元大96購02  ,0,0,0,0,0,0,0,0,0,90000,0,0,0,90000,0,90000,90000
054021,義隆台新96購01  ,0,0,0,0,0,0,0,0,0,90000,0,0,0,90000,0,90000,90000
05414P,台表科國票96售02,0,0,0,0,0,0,0,0,0,90000,0,0,0,110000,20000,90000,90000
059563,鴻海凱基9A購14  ,0,0,0,0,0,0,0,0,0,90000,0,0,0,90000,0,90000,90000
056020,義隆群益97購01  ,0,0,0,0,0,0,0,0,0,90000,0,0,0,114000,24000,90000,90000
057537,聯茂元大98購04  ,0,0,0,0,0,0,0,0,0,90000,0,0,0,104000,14000,90000,90000
055719,可成元大97購03  ,0,0,0,0,0,0,0,0,0,90000,0,0,0,90000,0,90000,90000
055829,上銀元大97購06  ,0,0,0,0,0,0,0,0,0,90000,0,0,0,90000,0,90000,90000
058558,鴻海日盛9A購02  ,0,0,0,0,0,0,0,0,0,90000,0,0,0,90000,0,90000,90000
056921,京元電兆豐98購01,0,0,0,0,0,0,0,0,0,90000,0,0,0,110000,20000,90000,90000
060214,茂林康和9A購01  ,0,0,0,0,0,0,0,0,0,89000,0,0,0,140000,51000,89000,89000
059910,鴻海元大99購37  ,0,0,0,0,0,0,0,0,0,89000,0,0,0,110000,21000,89000,89000
060928,明泰永豐9A購01  ,0,0,0,0,0,0,0,0,0,89000,0,0,0,89000,0,89000,89000
051591,玉晶光元大97購01,0,0,0,0,0,0,0,0,0,89000,0,0,0,89000,0,89000,89000
057886,聯詠群益98購01  ,0,0,0,0,0,0,0,0,0,89000,0,0,0,142000,53000,89000,89000
056568,台表科群益98購01,0,0,0,0,0,0,0,0,0,89000,0,0,0,201000,112000,89000,89000
05683P,矽創元大96售01  ,0,0,0,0,0,0,0,0,0,89000,0,0,0,89000,0,89000,89000
057198,智伸科統一9B購01,0,0,0,0,0,0,0,0,0,89000,0,0,0,89000,0,89000,89000
057258,中環兆豐98購01  ,0,0,0,0,0,0,0,0,0,89000,0,0,0,154000,65000,89000,89000
058249,緯穎元大99購04  ,0,0,0,0,0,0,0,0,0,89000,0,0,0,101000,12000,89000,89000
059516,TPK永豐99購01   ,0,0,0,0,0,0,0,0,0,89000,0,0,0,89000,0,89000,89000
058110,光寶科元富98購01,0,0,0,0,0,0,0,0,0,89000,0,0,0,89000,0,89000,89000
058093,神達元大9A購01  ,0,0,0,0,0,0,0,0,0,89000,0,0,0,379000,290000,89000,89000
057114,台虹群益98購01  ,0,0,0,0,0,0,0,0,0,89000,0,0,0,151000,62000,89000,89000
07884P,華新科凱基9B售08,0,0,0,0,0,0,0,0,0,89000,0,0,0,89000,0,89000,89000
059816,聯電凱基99購03  ,0,0,0,0,0,0,0,0,0,88000,0,0,0,94000,6000,88000,88000
059995,南亞科元富99購01,0,0,0,0,0,0,0,0,0,88000,0,0,0,196000,108000,88000,88000
061278,和大統一9A購01  ,0,0,0,0,0,0,0,0,0,88000,0,0,0,88000,0,88000,88000
061596,健策永豐9A購03  ,0,0,0,0,0,0,0,0,0,88000,0,0,0,88000,0,88000,88000
052054,台表科凱基96購01,0,0,0,0,0,0,0,0,0,88000,0,0,0,88000,0,88000,88000
053259,卜蜂群益97購01  ,0,0,0,0,0,0,0,0,0,88000,0,0,0,179000,91000,88000,88000
05463P,創意國票96售04  ,0,0,0,0,0,0,0,0,0,88000,0,0,0,90000,2000,88000,88000
055172,凱美統一97購02  ,0,0,0,0,0,0,0,0,0,88000,0,0,0,152000,64000,88000,88000
055069,帆宣永豐97購01  ,0,0,0,0,0,0,0,0,0,88000,0,0,0,88000,0,88000,88000
059235,鴻海凱基99購08  ,0,0,0,0,0,0,0,0,0,88000,0,0,0,88000,0,88000,88000
056986,超眾群益98購03  ,0,0,0,0,0,0,0,0,0,88000,0,0,0,198000,110000,88000,88000
058693,旭富國票9A購01  ,0,0,0,0,0,0,0,0,0,88000,0,0,0,102000,14000,88000,88000
058700,鴻海元大99購15  ,0,0,0,0,0,0,0,0,0,88000,0,0,0,88000,0,88000,88000
055707,聯鈞永豐98購01  ,0,0,0,0,0,0,0,0,0,88000,0,0,0,89000,1000,88000,88000
3257,虹冠電          ,85000,53000,32000,0,0,0,56000,0,56000,0,0,0,0,0,0,0,88000
061485,鴻海兆豐9A購01  ,0,0,0,0,0,0,0,0,0,87000,0,0,0,87000,0,87000,87000
061765,義隆元大9B購01  ,0,0,0,0,0,0,0,0,0,87000,0,0,0,134000,47000,87000,87000
06936P,瑞儀元大98售01  ,0,0,0,0,0,0,0,0,0,87000,0,0,0,92000,5000,87000,87000
053863,聯發科元大96購18,0,0,0,0,0,0,0,0,0,87000,0,0,0,87000,0,87000,87000
052602,聯電元大97購01  ,0,0,0,0,0,0,0,0,0,87000,0,0,0,348000,261000,87000,87000
058549,藍天永豐99購01  ,0,0,0,0,0,0,0,0,0,87000,0,0,0,87000,0,87000,87000
057016,中石化凱基9B購01,0,0,0,0,0,0,0,0,0,87000,0,0,0,100000,13000,87000,87000
059534,國泰金凱基99購01,0,0,0,0,0,0,0,0,0,87000,0,0,0,179000,92000,87000,87000
07675P,全新永豐9A售02  ,0,0,0,0,0,0,0,0,0,87000,0,0,0,100000,13000,87000,87000
062008,南亞科國泰9C購01,0,0,0,0,0,0,0,0,0,86000,0,0,0,209000,123000,86000,86000
061998,緯穎元大9B購03  ,0,0,0,0,0,0,0,0,0,86000,0,0,0,97000,11000,86000,86000
061871,瑞昱元大9B購01  ,0,0,0,0,0,0,0,0,0,86000,0,0,0,120000,34000,86000,86000
061367,瑞祺國票9A購01  ,0,0,0,0,0,0,0,0,0,86000,0,0,0,317000,231000,86000,86000
060126,創意永豐99購04  ,0,0,0,0,0,0,0,0,0,86000,0,0,0,144000,58000,86000,86000
060459,鴻海元大9A購07  ,0,0,0,0,0,0,0,0,0,86000,0,0,0,98000,12000,86000,86000
052727,仁寶元富96購01  ,0,0,0,0,0,0,0,0,0,86000,0,0,0,299000,213000,86000,86000
049667,大立光國泰96購01,0,0,0,0,0,0,0,0,0,86000,0,0,0,86000,0,86000,86000
054941,凱美元大97購01  ,0,0,0,0,0,0,0,0,0,86000,0,0,0,96000,10000,86000,86000
053597,牧德元大99購01  ,0,0,0,0,0,0,0,0,0,86000,0,0,0,86000,0,86000,86000
056107,智易永豐97購02  ,0,0,0,0,0,0,0,0,0,86000,0,0,0,280000,194000,86000,86000
057725,台達電國泰9A購01,0,0,0,0,0,0,0,0,0,86000,0,0,0,86000,0,86000,86000
057733,嘉聯益國泰99購01,0,0,0,0,0,0,0,0,0,86000,0,0,0,86000,0,86000,86000
057460,楠梓電永豐98購03,0,0,0,0,0,0,0,0,0,86000,0,0,0,166000,80000,86000,86000
1217,愛之味          ,185000,99000,86000,0,0,0,0,0,0,0,0,0,0,0,0,0,86000
6416,瑞祺電通        ,211000,139000,72000,0,0,0,0,0,0,14000,65000,49000,16000,15000,17000,-2000,86000
060344,聯發科統一01購01,0,0,0,0,0,0,0,0,0,85000,0,0,0,101000,16000,85000,85000
060947,台積電統一9C購03,0,0,0,0,0,0,0,0,0,85000,0,0,0,133000,48000,85000,85000
060810,滬深2X凱基9B購03,0,0,0,0,0,0,0,0,0,85000,0,0,0,85000,0,85000,85000
061050,康友中信9A購01  ,0,0,0,0,0,0,0,0,0,85000,0,0,0,85000,0,85000,85000
061732,智邦中信9B購01  ,0,0,0,0,0,0,0,0,0,85000,0,0,0,85000,0,85000,85000
055617,TPK國票98購04   ,0,0,0,0,0,0,0,0,0,85000,0,0,0,85000,0,85000,85000
054111,緯穎凱基97購01  ,0,0,0,0,0,0,0,0,0,85000,0,0,0,88000,3000,85000,85000
052750,臺股指元大96購04,0,0,0,0,0,0,0,0,0,85000,0,0,0,85000,0,85000,85000
052588,玉晶光永豐98購01,0,0,0,0,0,0,0,0,0,85000,0,0,0,85000,0,85000,85000
052599,S&P反1元大96購01,0,0,0,0,0,0,0,0,0,85000,0,0,0,100000,15000,85000,85000
052413,上証反中信97購01,0,0,0,0,0,0,0,0,0,85000,0,0,0,85000,0,85000,85000
058605,華邦電元大99購04,0,0,0,0,0,0,0,0,0,85000,0,0,0,100000,15000,85000,85000
06598P,奇力新永豐98售02,0,0,0,0,0,0,0,0,0,84000,0,0,0,105000,21000,84000,84000
059932,世紀鋼富邦9A購02,0,0,0,0,0,0,0,0,0,84000,0,0,0,115000,31000,84000,84000
054497,國巨永豐96購05  ,0,0,0,0,0,0,0,0,0,84000,0,0,0,84000,0,84000,84000
056969,智易永豐98購01  ,0,0,0,0,0,0,0,0,0,84000,0,0,0,164000,80000,84000,84000
057509,聯發科統一9A購03,0,0,0,0,0,0,0,0,0,84000,0,0,0,84000,0,84000,84000
060825,聯詠元大9A購05  ,0,15000,-15000,0,0,0,0,0,0,98000,0,0,0,252000,154000,98000,83000
060790,日月光富邦9A購01,0,0,0,0,0,0,0,0,0,83000,0,0,0,123000,40000,83000,83000
060716,新唐永豐9A購01  ,0,0,0,0,0,0,0,0,0,83000,0,0,0,169000,86000,83000,83000
061266,國泰金凱基9B購01,0,0,0,0,0,0,0,0,0,83000,0,0,0,83000,0,83000,83000
055045,台肥永豐97購01  ,0,0,0,0,0,0,0,0,0,83000,0,0,0,83000,0,83000,83000
053844,GIS統一96購01   ,0,0,0,0,0,0,0,0,0,83000,0,0,0,83000,0,83000,83000
05530P,臺股指群益96售03,0,0,0,0,0,0,0,0,0,83000,0,0,0,83000,0,83000,83000
056160,智易凱基97購03  ,0,0,0,0,0,0,0,0,0,83000,0,0,0,236000,153000,83000,83000
057985,華通元富02購03  ,0,0,0,0,0,0,0,0,0,83000,0,0,0,140000,57000,83000,83000
056746,超眾凱基99購01  ,0,0,0,0,0,0,0,0,0,83000,0,0,0,90000,7000,83000,83000
055704,亞德客永豐97購04,0,0,0,0,0,0,0,0,0,83000,0,0,0,83000,0,83000,83000
2472,立隆電          ,135000,62000,73000,0,0,0,0,0,0,10000,10000,0,10000,0,0,0,83000
9917,中保科          ,247100,165000,82100,0,0,0,0,0,0,0,0,0,0,0,0,0,82100
060598,鴻海凱基9A購20  ,0,0,0,0,0,0,0,0,0,82000,0,0,0,150000,68000,82000,82000
059841,國巨富邦9C購01  ,0,0,0,0,0,0,0,0,0,82000,0,0,0,106000,24000,82000,82000
060425,凌華永豐9A購01  ,0,0,0,0,0,0,0,0,0,82000,0,0,0,149000,67000,82000,82000
054250,漢唐元大96購04  ,0,0,0,0,0,0,0,0,0,82000,0,0,0,82000,0,82000,82000
053871,臻鼎元大96購03  ,0,0,0,0,0,0,0,0,0,82000,0,0,0,100000,18000,82000,82000
057601,中磊群益98購01  ,0,0,0,0,0,0,0,0,0,82000,0,0,0,82000,0,82000,82000
056455,群創凱基9A購01  ,0,0,0,0,0,0,0,0,0,82000,0,0,0,82000,0,82000,82000
056166,微星台新97購01  ,0,0,0,0,0,0,0,0,0,82000,0,0,0,82000,0,82000,82000
058422,百和麥證99購01  ,0,0,0,82000,0,82000,0,0,0,82000,0,0,0,82000,0,82000,82000
060388,世紀鋼凱基9B購01,0,0,0,0,0,0,0,0,0,81000,0,0,0,118000,37000,81000,81000
060250,台表科元大9A購01,0,0,0,0,0,0,0,0,0,81000,0,0,0,112000,31000,81000,81000
060625,華擎元大9A購01  ,0,0,0,0,0,0,0,0,0,81000,0,0,0,154000,73000,81000,81000
060892,超眾統一9C購01  ,0,0,0,0,0,0,0,0,0,81000,0,0,0,100000,19000,81000,81000
061094,彩晶統一9B購02  ,0,0,0,0,0,0,0,0,0,81000,0,0,0,182000,101000,81000,81000
061743,祥碩凱基9B購02  ,0,0,0,0,0,0,0,0,0,81000,0,0,0,200000,119000,81000,81000
061935,台積電國票9B購07,0,0,0,0,0,0,0,0,0,81000,0,0,0,141000,60000,81000,81000
06240P,奇力新元富97售03,0,0,0,0,0,0,0,0,0,81000,0,0,0,94000,13000,81000,81000
053559,台積電國泰98購01,0,0,0,0,0,0,0,0,0,81000,0,0,0,81000,0,81000,81000
055591,全新元大98購01  ,0,0,0,0,0,0,0,0,0,81000,0,0,0,140000,59000,81000,81000
054634,FB上証中信99購01,0,0,0,0,0,0,0,0,0,81000,0,0,0,103000,22000,81000,81000
049335,聯電統一97購01  ,0,0,0,0,0,0,0,0,0,81000,0,0,0,125000,44000,81000,81000
058077,超眾凱基98購02  ,0,0,0,0,0,0,0,0,0,81000,0,0,0,90000,9000,81000,81000
059019,元石油統一9B購03,0,0,0,0,0,0,0,0,0,81000,0,0,0,91000,10000,81000,81000
058584,百和群益9A購01  ,0,0,0,0,0,0,0,0,0,81000,0,0,0,81000,0,81000,81000
07849P,大立光群益9A售06,0,0,0,0,0,0,0,0,0,81000,0,0,0,82000,1000,81000,81000
07191P,台積電元大99售32,0,0,0,0,0,0,0,0,0,81000,0,0,0,81000,0,81000,81000
07082P,美律元大99售06  ,0,0,0,0,0,0,0,0,0,81000,0,0,0,88000,7000,81000,81000
06282P,聯鈞永豐97售02  ,0,0,0,0,0,0,0,0,0,80000,0,0,0,150000,70000,80000,80000
061362,台塑國票9B購01  ,0,0,0,0,0,0,0,0,0,80000,0,0,0,88000,8000,80000,80000
061462,國巨群益9A購11  ,0,0,0,0,0,0,0,0,0,80000,0,0,0,203000,123000,80000,80000
061129,文曄永豐9A購01  ,0,0,0,0,0,0,0,0,0,80000,0,0,0,80000,0,80000,80000
061130,牧德永豐9A購04  ,0,0,0,0,0,0,0,0,0,80000,0,0,0,326000,246000,80000,80000
060823,旺宏元大9A購05  ,0,0,0,0,0,0,0,0,0,80000,0,0,0,110000,30000,80000,80000
060660,國巨凱基9B購04  ,0,0,0,0,0,0,0,0,0,80000,0,0,0,260000,180000,80000,80000
060398,立積國票9B購01  ,0,0,0,0,0,0,0,0,0,80000,0,0,0,80000,0,80000,80000
059957,中信金康和99購01,0,0,0,0,0,0,0,0,0,80000,0,0,0,80000,0,80000,80000
049491,聯發科元大95購01,0,0,0,0,0,0,0,0,0,80000,0,0,0,80000,0,80000,80000
00753L,中信中國50正2   ,104000,77000,27000,0,0,0,0,0,0,53000,0,0,0,227000,174000,53000,80000
054560,全新群益98購03  ,0,0,0,0,0,0,0,0,0,80000,0,0,0,80000,0,80000,80000
053171,中磊群益96購01  ,0,0,0,0,0,0,0,0,0,80000,0,0,0,80000,0,80000,80000
052305,GIS永豐95購03   ,0,0,0,0,0,0,0,0,0,80000,0,0,0,80000,0,80000,80000
052112,滬深2X中信99購01,0,0,0,0,0,0,0,0,0,80000,0,0,0,80000,0,80000,80000
052085,聯電元大95購01  ,0,0,0,0,0,0,0,0,0,80000,0,0,0,80000,0,80000,80000
051488,健策凱基96購04  ,0,0,0,0,0,0,0,0,0,80000,0,0,0,80000,0,80000,80000
055499,大立光元大98購05,0,0,0,0,0,0,0,0,0,80000,0,0,0,80000,0,80000,80000
054780,中石化群益99購01,0,0,0,0,0,0,0,0,0,80000,0,0,0,80000,0,80000,80000
055218,彩晶凱基99購01  ,0,0,0,0,0,0,0,0,0,80000,0,0,0,80000,0,80000,80000
053956,旺宏永豐96購04  ,0,0,0,0,0,0,0,0,0,80000,0,0,0,80000,0,80000,80000
053806,鎧勝凱基96購02  ,0,0,0,0,0,0,0,0,0,80000,0,0,0,80000,0,80000,80000
057642,南亞科元大98購07,0,0,0,0,0,0,0,0,0,80000,0,0,0,80000,0,80000,80000
055661,亞德客中信98購01,0,0,0,0,0,0,0,0,0,80000,0,0,0,91000,11000,80000,80000
056657,華邦電元大99購01,0,0,0,0,0,0,0,0,0,80000,0,0,0,88000,8000,80000,80000
056205,貿聯永豐97購01  ,0,0,0,0,0,0,0,0,0,80000,0,0,0,84000,4000,80000,80000
057821,晶相光元大98購03,0,0,0,0,0,0,0,0,0,80000,0,0,0,100000,20000,80000,80000
056234,GIS麥證97購01   ,0,0,0,80000,0,80000,0,0,0,80000,0,0,0,80000,0,80000,80000
059470,華新科元大99購16,0,0,0,0,0,0,0,0,0,80000,0,0,0,80000,0,80000,80000
059612,奇鋐永豐99購02  ,0,0,0,0,0,0,0,0,0,80000,0,0,0,80000,0,80000,80000
059866,國巨凱基99購18  ,0,0,0,0,0,0,0,0,0,79000,0,0,0,101000,22000,79000,79000
061703,信邦國票9A購01  ,0,0,0,0,0,0,0,0,0,79000,0,0,0,99000,20000,79000,79000
055620,樺漢國票98購01  ,0,0,0,0,0,0,0,0,0,79000,0,0,0,79000,0,79000,79000
058082,美律群益98購05  ,0,0,0,0,0,0,0,0,0,79000,0,0,0,79000,0,79000,79000
057957,嘉晶元大98購01  ,0,0,0,0,0,0,0,0,0,79000,0,0,0,124000,45000,79000,79000
057815,信邦元大98購01  ,0,0,0,0,0,0,0,0,0,79000,0,0,0,104000,25000,79000,79000
061344,禾伸堂元大9A購02,0,0,0,0,0,0,0,0,0,78000,0,0,0,146000,68000,78000,78000
060710,上銀永豐9A購01  ,0,0,0,0,0,0,0,0,0,78000,0,0,0,88000,10000,78000,78000
053571,奇鋐統一96購02  ,0,0,0,0,0,0,0,0,0,78000,0,0,0,88000,10000,78000,78000
054235,欣興群益96購06  ,0,0,0,0,0,0,0,0,0,78000,0,0,0,108000,30000,78000,78000
054239,台郡群益96購02  ,0,0,0,0,0,0,0,0,0,78000,0,0,0,108000,30000,78000,78000
055173,瑞昱統一97購01  ,0,0,0,0,0,0,0,0,0,78000,0,0,0,99000,21000,78000,78000
056441,燿華凱基98購01  ,0,0,0,0,0,0,0,0,0,78000,0,0,0,273000,195000,78000,78000
056308,TPK元大97購02   ,0,0,0,0,0,0,0,0,0,78000,0,0,0,78000,0,78000,78000
056709,華通永豐98購01  ,0,0,0,0,0,0,0,0,0,78000,0,0,0,80000,2000,78000,78000
058342,鴻海群益9A購01  ,0,0,0,0,0,0,0,0,0,78000,0,0,0,144000,66000,78000,78000
058031,旺宏永豐98購04  ,0,0,0,0,0,0,0,0,0,78000,0,0,0,78000,0,78000,78000
057090,奇力新元富98購02,0,0,0,0,0,0,0,0,0,78000,0,0,0,98000,20000,78000,78000
056165,矽力凱基98購02  ,0,0,0,0,0,0,0,0,0,78000,0,0,0,79000,1000,78000,78000
059588,鴻海元大99購32  ,0,0,0,0,0,0,0,0,0,78000,0,0,0,81000,3000,78000,78000
059278,群創元大9A購04  ,0,0,0,0,0,0,0,0,0,78000,0,0,0,218000,140000,78000,78000
07129P,華新科元大99售14,0,0,0,0,0,0,0,0,0,78000,0,0,0,263000,185000,78000,78000
060909,金像電元大9B購01,0,0,0,0,0,0,0,0,0,77000,0,0,0,77000,0,77000,77000
060034,立積永豐99購04  ,0,0,0,0,0,0,0,0,0,77000,0,0,0,122000,45000,77000,77000
060251,易華電元大9C購01,0,0,0,0,0,0,0,0,0,77000,0,0,0,82000,5000,77000,77000
060212,華航康和9A購01  ,0,0,0,0,0,0,0,0,0,77000,0,0,0,97000,20000,77000,77000
053396,漢唐中信9A購01  ,0,0,0,0,0,0,0,0,0,77000,0,0,0,77000,0,77000,77000
054828,正崴國泰99購01  ,0,0,0,0,0,0,0,0,0,77000,0,0,0,77000,0,77000,77000
058925,旭富元富99購02  ,0,0,0,0,0,0,0,0,0,77000,0,0,0,106000,29000,77000,77000
057481,技嘉元大98購04  ,0,0,0,0,0,0,0,0,0,77000,0,0,0,121000,44000,77000,77000
056458,日月光凱基98購02,0,0,0,0,0,0,0,0,0,77000,0,0,0,87000,10000,77000,77000
057445,華通元富02購01  ,0,0,0,0,0,0,0,0,0,77000,0,0,0,85000,8000,77000,77000
07715P,台灣50群益9A售14,0,0,0,0,0,0,0,0,0,77000,0,0,0,77000,0,77000,77000
6226,光鼎            ,122000,45000,77000,0,0,0,0,0,0,0,0,0,0,0,0,0,77000
061996,矽格元大9B購01  ,0,0,0,0,0,0,0,0,0,76000,0,0,0,206000,130000,76000,76000
055572,鴻海統一98購04  ,0,0,0,0,0,0,0,0,0,76000,0,0,0,89000,13000,76000,76000
055360,台表科凱基97購02,0,0,0,0,0,0,0,0,0,76000,0,0,0,76000,0,76000,76000
051643,瑞昱康和95購01  ,0,0,0,0,0,0,0,0,0,76000,0,0,0,76000,0,76000,76000
052637,欣興凱基97購01  ,0,0,0,0,0,0,0,0,0,76000,0,0,0,76000,0,76000,76000
057834,聯發科元富02購07,0,0,0,0,0,0,0,0,0,76000,0,0,0,80000,4000,76000,76000
058731,貿聯永豐99購02  ,0,0,0,0,0,0,0,0,0,76000,0,0,0,87000,11000,76000,76000
057173,南亞科元大98購04,0,0,0,0,0,0,0,0,0,76000,0,0,0,78000,2000,76000,76000
058409,鴻海兆豐99購05  ,0,0,0,0,0,0,0,0,0,76000,0,0,0,186000,110000,76000,76000
056103,聯發科永豐97購03,0,0,0,0,0,0,0,0,0,76000,0,0,0,76000,0,76000,76000
057076,緯穎永豐98購01  ,0,0,0,0,0,0,0,0,0,76000,0,0,0,76000,0,76000,76000
059266,緯創中信01購01  ,0,0,0,0,0,0,0,0,0,76000,0,0,0,76000,0,76000,76000
058118,瑞昱群益99購01  ,0,0,0,0,0,0,0,0,0,76000,0,0,0,94000,18000,76000,76000
07428P,華新科國票9A售01,0,0,0,0,0,0,0,0,0,76000,0,0,0,76000,0,76000,76000
061897,泰碩永豐9B購01  ,0,0,0,0,0,0,0,0,0,75000,0,0,0,87000,12000,75000,75000
061314,滬深2X凱基9B購06,0,0,0,0,0,0,0,0,0,75000,0,0,0,85000,10000,75000,75000
060116,世紀鋼元大99購07,0,0,0,0,0,0,0,0,0,75000,0,0,0,80000,5000,75000,75000
059855,緯穎永豐99購04  ,0,0,0,0,0,0,0,0,0,75000,0,0,0,85000,10000,75000,75000
061070,超眾凱基9C購01  ,0,0,0,0,0,0,0,0,0,75000,0,0,0,75000,0,75000,75000
053315,漢唐群益96購02  ,0,0,0,0,0,0,0,0,0,75000,0,0,0,75000,0,75000,75000
054233,聯發科群益96購04,0,0,0,0,0,0,0,0,0,75000,0,0,0,75000,0,75000,75000
054109,南亞科凱基96購05,0,0,0,0,0,0,0,0,0,75000,0,0,0,75000,0,75000,75000
058519,嘉澤元大99購01  ,0,0,0,0,0,0,0,0,0,75000,0,0,0,140000,65000,75000,75000
05628P,茂林國票97售02  ,0,0,0,0,0,0,0,0,0,75000,0,0,0,75000,0,75000,75000
07264P,台積電元大99售38,0,0,0,0,0,0,0,0,0,75000,0,0,0,100000,25000,75000,75000
061007,聯詠兆豐9A購01  ,0,0,0,0,0,0,0,0,0,74000,0,0,0,235000,161000,74000,74000
055562,欣興凱基97購06  ,0,0,0,0,0,0,0,0,0,74000,0,0,0,113000,39000,74000,74000
058901,美律元大99購07  ,0,0,0,0,0,0,0,0,0,74000,0,0,0,86000,12000,74000,74000
058765,緯穎群益99購03  ,0,0,0,0,0,0,0,0,0,74000,0,0,0,75000,1000,74000,74000
054674,台光電台新97購01,0,0,0,0,0,0,0,0,0,74000,0,0,0,198000,124000,74000,74000
058017,漢唐凱基99購01  ,0,0,0,0,0,0,0,0,0,74000,0,0,0,74000,0,74000,74000
059338,滬深2X凱基9C購02,0,0,0,0,0,0,0,0,0,74000,0,0,0,80000,6000,74000,74000
057483,微星元大98購04  ,0,0,0,0,0,0,0,0,0,74000,0,0,0,194000,120000,74000,74000
057969,緯穎國泰99購01  ,0,0,0,0,0,0,0,0,0,74000,0,0,0,218000,144000,74000,74000
058146,勤誠元大99購01  ,0,0,0,0,0,0,0,0,0,74000,0,0,0,101000,27000,74000,74000
059812,上証2X凱基9A購04,0,0,0,0,0,0,0,0,0,73000,0,0,0,73000,0,73000,73000
053149,京元電元大96購02,0,0,0,0,0,0,0,0,0,73000,0,0,0,93000,20000,73000,73000
00634R,富邦上証反1     ,0,105000,-105000,0,0,0,0,0,0,178000,0,0,0,531000,353000,178000,73000
057401,晶豪科群益99購01,0,0,0,0,0,0,0,0,0,73000,0,0,0,73000,0,73000,73000
058628,宏達電國票9A購01,0,0,0,0,0,0,0,0,0,73000,0,0,0,111000,38000,73000,73000
056615,燿華永豐98購02  ,0,0,0,0,0,0,0,0,0,73000,0,0,0,73000,0,73000,73000
07256P,臺股指凱基99售36,0,0,0,0,0,0,0,0,0,73000,0,0,0,79000,6000,73000,73000
07172P,臺股指國票99售09,0,0,0,0,0,0,0,0,0,73000,0,0,0,145000,72000,73000,73000
07741P,滬深2X凱基9B售04,0,0,0,0,0,0,0,0,0,73000,0,0,0,73000,0,73000,73000
060927,嘉晶永豐9A購01  ,0,0,0,0,0,0,0,0,0,72000,0,0,0,146000,74000,72000,72000
060675,南亞科元大9A購02,0,0,0,0,0,0,0,0,0,72000,0,0,0,72000,0,72000,72000
061695,群創群益9A購01  ,0,0,0,0,0,0,0,0,0,72000,0,0,0,170000,98000,72000,72000
061621,健策群益9A購05  ,0,0,0,0,0,0,0,0,0,72000,0,0,0,72000,0,72000,72000
061956,和大統一01購01  ,0,0,0,0,0,0,0,0,0,72000,0,0,0,84000,12000,72000,72000
052417,聯發科兆豐9B購01,0,0,0,0,0,0,0,0,0,72000,0,0,0,72000,0,72000,72000
051570,和碩富邦97購01  ,0,0,0,0,0,0,0,0,0,72000,0,0,0,72000,0,72000,72000
058920,SGBR2X元富99購06,0,0,0,0,0,0,0,0,0,72000,0,0,0,79000,7000,72000,72000
055563,智易凱基97購02  ,0,0,0,0,0,0,0,0,0,72000,0,0,0,165000,93000,72000,72000
053566,大立光富邦99購03,0,0,0,0,0,0,0,0,0,72000,0,0,0,72000,0,72000,72000
055232,泰碩國票98購01  ,0,0,0,0,0,0,0,0,0,72000,0,0,0,105000,33000,72000,72000
057376,新日興元大98購04,0,0,0,0,0,0,0,0,0,72000,0,0,0,82000,10000,72000,72000
05912P,和大元大96售01  ,0,0,0,0,0,0,0,0,0,72000,0,0,0,72000,0,72000,72000
061326,新日興凱基9B購01,0,0,0,0,0,0,0,0,0,71000,0,0,0,215000,144000,71000,71000
061467,嘉澤群益9A購01  ,0,0,0,0,0,0,0,0,0,71000,0,0,0,171000,100000,71000,71000
061421,台積電元大9A購29,0,0,0,0,0,0,0,0,0,71000,0,0,0,71000,0,71000,71000
061165,美律兆豐9A購01  ,0,0,0,0,0,0,0,0,0,71000,0,0,0,76000,5000,71000,71000
061062,和大凱基9A購02  ,0,0,0,0,0,0,0,0,0,71000,0,0,0,71000,0,71000,71000
055421,玉晶光永豐98購04,0,0,0,0,0,0,0,0,0,71000,0,0,0,136000,65000,71000,71000
051503,玉晶光統一97購01,0,0,0,0,0,0,0,0,0,71000,0,0,0,71000,0,71000,71000
047675,群創元富96購03  ,0,0,0,0,0,0,0,0,0,71000,0,0,0,211000,140000,71000,71000
058074,欣興凱基99購01  ,0,0,0,0,0,0,0,0,0,71000,0,0,0,170000,99000,71000,71000
059526,鴻海凱基99購12  ,0,0,0,0,0,0,0,0,0,71000,0,0,0,125000,54000,71000,71000
057276,全新元大99購03  ,0,0,0,0,0,0,0,0,0,71000,0,0,0,140000,69000,71000,71000
07364P,大立光元大99售27,0,0,0,0,0,0,0,0,0,71000,0,0,0,75000,4000,71000,71000
059833,緯穎康和99購01  ,0,0,0,0,0,0,0,0,0,70000,0,0,0,70000,0,70000,70000
059944,欣興永豐99購03  ,0,0,0,0,0,0,0,0,0,70000,0,0,0,160000,90000,70000,70000
060285,聯電元大9C購01  ,0,0,0,0,0,0,0,0,0,70000,0,0,0,195000,125000,70000,70000
061319,聯發科凱基9A購16,0,0,0,0,0,0,0,0,0,70000,0,0,0,70000,0,70000,70000
061713,華邦電凱基9A購01,0,0,0,0,0,0,0,0,0,70000,0,0,0,70000,0,70000,70000
06332P,世紀鋼群益98售01,0,0,0,0,0,0,0,0,0,70000,0,0,0,100000,30000,70000,70000
052431,茂林永豐95購03  ,0,0,0,0,0,0,0,0,0,70000,0,0,0,70000,0,70000,70000
052542,友達元富98購01  ,0,0,0,0,0,0,0,0,0,70000,0,0,0,70000,0,70000,70000
054644,A50正2群益9B購01,0,0,0,0,0,0,0,0,0,70000,0,0,0,70000,0,70000,70000
054541,康控國票98購01  ,0,0,0,0,0,0,0,0,0,70000,0,0,0,70000,0,70000,70000
055425,聚陽群益99購01  ,0,0,0,0,0,0,0,0,0,70000,0,0,0,70000,0,70000,70000
053441,旺宏凱基98購01  ,0,0,0,0,0,0,0,0,0,70000,0,0,0,70000,0,70000,70000
053836,亞光永豐96購02  ,0,0,0,0,0,0,0,0,0,70000,0,0,0,70000,0,70000,70000
057816,欣興元大98購13  ,0,0,0,0,0,0,0,0,0,70000,0,0,0,137000,67000,70000,70000
057621,崇越凱基98購01  ,0,0,0,0,0,0,0,0,0,70000,0,0,0,140000,70000,70000,70000
07660P,聯茂凱基9A售03  ,0,0,0,0,0,0,0,0,0,70000,0,0,0,168000,98000,70000,70000
06456P,聯發科統一98售03,0,0,0,0,0,0,0,0,0,69000,0,0,0,203000,134000,69000,69000
06883P,聯茂群益98售03  ,0,0,0,0,0,0,0,0,0,69000,0,0,0,70000,1000,69000,69000
061308,元金2X中信9A購01,0,0,0,0,0,0,0,0,0,69000,0,0,0,95000,26000,69000,69000
060130,瀚宇博永豐99購02,0,0,0,0,0,0,0,0,0,69000,0,0,0,69000,0,69000,69000
061152,微星群益9A購01  ,0,0,0,0,0,0,0,0,0,69000,0,0,0,83000,14000,69000,69000
060730,台積電群益9A購03,0,0,0,0,0,0,0,0,0,69000,0,0,0,69000,0,69000,69000
060904,臺指反元大9C購07,0,0,0,0,0,0,0,0,0,68000,0,0,0,70000,2000,68000,68000
060052,宏碁凱基99購01  ,0,0,0,0,0,0,0,0,0,68000,0,0,0,71000,3000,68000,68000
054929,群電凱基97購01  ,0,0,0,0,0,0,0,0,0,68000,0,0,0,88000,20000,68000,68000
053492,華邦電兆豐97購01,0,0,0,0,0,0,0,0,0,68000,0,0,0,202000,134000,68000,68000
055449,超眾統一9A購01  ,0,0,0,0,0,0,0,0,0,68000,0,0,0,121000,53000,68000,68000
053630,奇鋐兆豐97購01  ,0,0,0,0,0,0,0,0,0,68000,0,0,0,83000,15000,68000,68000
058752,鈺齊凱基9A購01  ,0,0,0,0,0,0,0,0,0,68000,0,0,0,68000,0,68000,68000
052693,微星中信96購01  ,0,0,0,0,0,0,0,0,0,68000,0,0,0,76000,8000,68000,68000
03566P,臺股指日盛03售01,0,0,0,0,0,0,0,0,0,68000,0,0,0,80000,12000,68000,68000
056625,致伸永豐98購01  ,0,0,0,0,0,0,0,0,0,68000,0,0,0,68000,0,68000,68000
059713,滬深2X元大9C購04,0,0,0,0,0,0,0,0,0,68000,0,0,0,68000,0,68000,68000
059469,智邦元大99購03  ,0,0,0,0,0,0,0,0,0,68000,0,0,0,88000,20000,68000,68000
057906,福懋科中信99購01,0,0,0,0,0,0,0,0,0,68000,0,0,0,68000,0,68000,68000
07303P,臺股指元大9A售36,0,0,0,0,0,0,0,0,0,68000,0,0,0,160000,92000,68000,68000
060749,祥碩國票9A購01  ,0,0,0,0,0,0,0,0,0,67000,0,0,0,91000,24000,67000,67000
046629,群創統一98購01  ,0,0,0,0,0,0,0,0,0,67000,0,0,0,67000,0,67000,67000
053631,欣興兆豐97購01  ,0,0,0,0,0,0,0,0,0,67000,0,0,0,72000,5000,67000,67000
053915,光罩國票96購02  ,0,0,0,0,0,0,0,0,0,67000,0,0,0,127000,60000,67000,67000
054925,神達凱基97購01  ,0,0,0,0,0,0,0,0,0,67000,0,0,0,105000,38000,67000,67000
055687,瀚宇博凱基97購01,0,0,0,0,0,0,0,0,0,67000,0,0,0,67000,0,67000,67000
058536,群創統一9B購01  ,0,0,0,0,0,0,0,0,0,67000,0,0,0,115000,48000,67000,67000
057449,華新科元富99購02,0,0,0,0,0,0,0,0,0,67000,0,0,0,68000,1000,67000,67000
056533,友達凱基9A購02  ,0,0,0,0,0,0,0,0,0,67000,0,0,0,67000,0,67000,67000
07456P,華新科元大9A售06,0,0,0,0,0,0,0,0,0,67000,0,0,0,140000,73000,67000,67000
2731,雄獅            ,85000,18000,67000,0,0,0,0,0,0,0,0,0,0,0,0,0,67000
060920,超眾富邦9B購01  ,0,0,0,0,0,0,0,0,0,66000,0,0,0,463000,397000,66000,66000
061091,奇力新統一9C購02,0,0,0,0,0,0,0,0,0,66000,0,0,0,290000,224000,66000,66000
060059,鴻海兆豐99購06  ,0,0,0,0,0,0,0,0,0,66000,0,0,0,66000,0,66000,66000
061280,國巨統一9C購06  ,0,0,0,0,0,0,0,0,0,66000,0,0,0,81000,15000,66000,66000
061225,台積電中信9A購04,0,0,0,0,0,0,0,0,0,66000,0,0,0,96000,30000,66000,66000
00675L,富邦臺灣加權正2 ,172000,105000,67000,0,0,0,0,0,0,-1000,0,0,0,33000,34000,-1000,66000
056486,樺漢元大98購04  ,0,0,0,0,0,0,0,0,0,66000,0,0,0,66000,0,66000,66000
057964,緯穎元大99購03  ,0,0,0,0,0,0,0,0,0,66000,0,0,0,78000,12000,66000,66000
058184,鴻海永豐99購01  ,0,0,0,0,0,0,0,0,0,66000,0,0,0,86000,20000,66000,66000
058346,嘉晶群益99購01  ,0,0,0,0,0,0,0,0,0,66000,0,0,0,137000,71000,66000,66000
057993,中環中信98購01  ,0,0,0,0,0,0,0,0,0,66000,0,0,0,66000,0,66000,66000
1337,再生-KY         ,134000,68000,66000,0,0,0,0,0,0,0,0,0,0,0,0,0,66000
9944,新麗            ,68000,2000,66000,0,0,0,0,0,0,0,0,0,0,0,0,0,66000
06151P,華新科元大97售07,0,0,0,0,0,0,0,0,0,65000,0,0,0,66000,1000,65000,65000
06938P,南電元大98售03  ,0,0,0,0,0,0,0,0,0,65000,0,0,0,105000,40000,65000,65000
061892,亞德客永豐9B購01,0,0,0,0,0,0,0,0,0,65000,0,0,0,65000,0,65000,65000
060042,台積電群益99購12,0,0,0,0,0,0,0,0,0,65000,0,0,0,219000,154000,65000,65000
051317,亞德客國票96購01,0,0,0,0,0,0,0,0,0,65000,0,0,0,67000,2000,65000,65000
052426,國巨台新96購01  ,0,0,0,0,0,0,0,0,0,65000,0,0,0,65000,0,65000,65000
05161P,華新科國票96售01,0,0,0,0,0,0,0,0,0,65000,0,0,0,65000,0,65000,65000
051953,矽力元富95購03  ,0,0,0,0,0,0,0,0,0,65000,0,0,0,65000,0,65000,65000
054499,台光電永豐96購02,0,0,0,0,0,0,0,0,0,65000,0,0,0,75000,10000,65000,65000
054205,華新國票97購02  ,0,0,0,0,0,0,0,0,0,65000,0,0,0,75000,10000,65000,65000
057552,禾伸堂凱基98購05,0,0,0,0,0,0,0,0,0,65000,0,0,0,65000,0,65000,65000
056563,華新科群益98購04,0,0,0,0,0,0,0,0,0,65000,0,0,0,98000,33000,65000,65000
056319,智原群益98購02  ,0,0,0,0,0,0,0,0,0,65000,0,0,0,80000,15000,65000,65000
057689,南亞科凱基99購02,0,0,0,0,0,0,0,0,0,65000,0,0,0,65000,0,65000,65000
5305,敦南            ,138000,73000,65000,0,0,0,0,0,0,0,0,0,0,0,0,0,65000
1808,潤隆            ,86000,21000,65000,0,0,0,0,0,0,0,0,0,0,0,0,0,65000
08637P,台灣50中信96售03,0,0,0,0,0,0,0,0,0,65000,0,0,0,65000,0,65000,65000
060231,台積電元大9A購08,0,0,0,0,0,0,0,0,0,64000,0,0,0,86000,22000,64000,64000
060754,華通元大9A購04  ,0,0,0,0,0,0,0,0,0,64000,0,0,0,114000,50000,64000,64000
061339,京元電元大9A購05,0,0,0,0,0,0,0,0,0,64000,0,0,0,74000,10000,64000,64000
053410,啟碁兆豐96購01  ,0,0,0,0,0,0,0,0,0,64000,0,0,0,64000,0,64000,64000
052806,玉晶光元大98購04,0,0,0,0,0,0,0,0,0,64000,0,0,0,65000,1000,64000,64000
050788,台郡國泰96購01  ,0,0,0,0,0,0,0,0,0,64000,0,0,0,64000,0,64000,64000
058638,矽力兆豐99購01  ,0,0,0,0,0,0,0,0,0,64000,0,0,0,64000,0,64000,64000
056365,欣興元大98購01  ,0,0,0,0,0,0,0,0,0,64000,0,0,0,80000,16000,64000,64000
057387,奇力新永豐98購03,0,0,0,0,0,0,0,0,0,64000,0,0,0,64000,0,64000,64000
059254,台表科凱基9A購02,0,0,0,0,0,0,0,0,0,64000,0,0,0,100000,36000,64000,64000
1527,鑽全            ,137000,73700,63300,0,0,0,0,0,0,0,0,0,0,0,0,0,63300
061533,友達統一9C購02  ,0,0,0,0,0,0,0,0,0,63000,0,0,0,63000,0,63000,63000
052374,瑞昱元大95購02  ,0,0,0,0,0,0,0,0,0,63000,0,0,0,63000,0,63000,63000
051753,華通元大96購03  ,0,0,0,0,0,0,0,0,0,63000,0,0,0,63000,0,63000,63000
054661,嘉聯益元大97購03,0,0,0,0,0,0,0,0,0,63000,0,0,0,63000,0,63000,63000
058951,南電群益99購01  ,0,0,0,0,0,0,0,0,0,63000,0,0,0,97000,34000,63000,63000
057151,易華電國票99購01,0,0,0,0,0,0,0,0,0,63000,0,0,0,63000,0,63000,63000
057820,華擎元大98購02  ,0,0,0,0,0,0,0,0,0,63000,0,0,0,240000,177000,63000,63000
058588,致茂中信9B購01  ,0,0,0,0,0,0,0,0,0,63000,0,0,0,74000,11000,63000,63000
2939,凱羿-KY         ,164000,101000,63000,0,0,0,0,0,0,0,0,0,0,0,0,0,63000
07644P,南電凱基9A售03  ,0,0,0,0,0,0,0,0,0,63000,0,0,0,128000,65000,63000,63000
07228P,台灣50群益9B售06,0,0,0,0,0,0,0,0,0,63000,0,0,0,63000,0,63000,63000
061745,南電凱基9B購02  ,0,0,0,0,0,0,0,0,0,62000,0,0,0,294000,232000,62000,62000
060166,佐登永豐9A購01  ,0,0,0,0,0,0,0,0,0,62000,0,0,0,77000,15000,62000,62000
060007,鴻海群益99購04  ,0,0,0,0,0,0,0,0,0,62000,0,0,0,62000,0,62000,62000
060086,鴻海元大99購42  ,0,0,0,0,0,0,0,0,0,62000,0,0,0,62000,0,62000,62000
058883,旭富永豐99購01  ,0,0,0,0,0,0,0,0,0,62000,0,0,0,157000,95000,62000,62000
055653,聯詠元富01購02  ,0,0,0,0,0,0,0,0,0,62000,0,0,0,154000,92000,62000,62000
055295,瀚宇博元大97購02,0,0,0,0,0,0,0,0,0,62000,0,0,0,62000,0,62000,62000
053400,緯穎中信9A購01  ,0,0,0,0,0,0,0,0,0,62000,0,0,0,75000,13000,62000,62000
053147,楠梓電元大98購01,0,0,0,0,0,0,0,0,0,62000,0,0,0,62000,0,62000,62000
056245,嘉澤群益97購01  ,0,0,0,0,0,0,0,0,0,62000,0,0,0,113000,51000,62000,62000
056928,旺宏台新98購01  ,0,0,0,0,0,0,0,0,0,62000,0,0,0,82000,20000,62000,62000
057747,致新永豐98購01  ,0,0,0,0,0,0,0,0,0,62000,0,0,0,152000,90000,62000,62000
057742,喬山永豐98購02  ,0,0,0,0,0,0,0,0,0,62000,0,0,0,62000,0,62000,62000
057958,禾伸堂元大99購05,0,0,0,0,0,0,0,0,0,62000,0,0,0,94000,32000,62000,62000
07462P,臺股指元大9B售05,0,0,0,0,0,0,0,0,0,62000,0,0,0,68000,6000,62000,62000
07620P,國巨統一9B售07  ,0,0,0,0,0,0,0,0,0,62000,0,0,0,62000,0,62000,62000
6224,聚鼎            ,103000,46000,57000,0,0,0,0,0,0,5000,6000,1000,5000,0,0,0,62000
060432,達方永豐9A購01  ,0,0,0,0,0,0,0,0,0,61000,0,0,0,175000,114000,61000,61000
060674,瑞昱元大9A購03  ,0,0,0,0,0,0,0,0,0,61000,0,0,0,182000,121000,61000,61000
060500,鴻海元大9A購12  ,0,0,0,0,0,0,0,0,0,61000,0,0,0,62000,1000,61000,61000
061340,義隆元大9A購01  ,0,0,0,0,0,0,0,0,0,61000,0,0,0,97000,36000,61000,61000
061184,大立光國泰9C購01,0,0,0,0,0,0,0,0,0,61000,0,0,0,164000,103000,61000,61000
061825,聯發科麥證9B購01,0,0,0,61000,0,61000,0,0,0,61000,0,0,0,61000,0,61000,61000
061855,台郡國票9B購01  ,0,0,0,0,0,0,0,0,0,61000,0,0,0,71000,10000,61000,61000
061944,聯電群益9B購01  ,0,0,0,0,0,0,0,0,0,61000,0,0,0,61000,0,61000,61000
054002,GIS群益96購03   ,0,0,0,0,0,0,0,0,0,61000,0,0,0,121000,60000,61000,61000
053752,超眾永豐96購02  ,0,0,0,0,0,0,0,0,0,61000,0,0,0,61000,0,61000,61000
058145,聯茂元大99購03  ,0,0,0,0,0,0,0,0,0,61000,0,0,0,188000,127000,61000,61000
058257,聯陽國泰9B購01  ,0,0,0,0,0,0,0,0,0,61000,0,0,0,77000,16000,61000,61000
057105,致茂群益9A購01  ,0,0,0,0,0,0,0,0,0,61000,0,0,0,75000,14000,61000,61000
059662,旭富元大9C購01  ,0,0,0,0,0,0,0,0,0,61000,0,0,0,73000,12000,61000,61000
056742,玉晶光凱基9A購01,0,0,0,0,0,0,0,0,0,61000,0,0,0,61000,0,61000,61000
056623,禾伸堂永豐98購01,0,0,0,0,0,0,0,0,0,61000,0,0,0,71000,10000,61000,61000
08679P,台灣50元大01售15,0,0,0,0,0,0,0,0,0,61000,0,0,0,61000,0,61000,61000
06337P,祥碩元大97售05  ,0,0,0,0,0,0,0,0,0,60000,0,0,0,125000,65000,60000,60000
06216P,上銀元富97售03  ,0,0,0,0,0,0,0,0,0,60000,0,0,0,60000,0,60000,60000
061387,鴻海群益9A購05  ,0,0,0,0,0,0,0,0,0,60000,0,0,0,142000,82000,60000,60000
060470,台勝科元大9A購03,0,0,0,0,0,0,0,0,0,60000,0,0,0,60000,0,60000,60000
060597,華通凱基9A購04  ,0,0,0,0,0,0,0,0,0,60000,0,0,0,60000,0,60000,60000
061154,可成群益9B購04  ,0,0,0,0,0,0,0,0,0,60000,0,0,0,239000,179000,60000,60000
060828,高股息國票9A購01,0,0,0,0,0,0,0,0,0,60000,0,0,0,60000,0,60000,60000
060364,奇力新元富9A購01,0,0,0,0,0,0,0,0,0,60000,0,0,0,60000,0,60000,60000
060024,T50反1國泰9B購02,0,0,0,0,0,0,0,0,0,60000,0,0,0,60000,0,60000,60000
053316,友達群益9A購01  ,0,0,0,0,0,0,0,0,0,60000,0,0,0,60000,0,60000,60000
055255,欣興統一97購02  ,0,0,0,0,0,0,0,0,0,60000,0,0,0,60000,0,60000,60000
053898,康友群益97購01  ,0,0,0,0,0,0,0,0,0,60000,0,0,0,60000,0,60000,60000
053591,大立光元大99購03,0,0,0,0,0,0,0,0,0,60000,0,0,0,60000,0,60000,60000
055170,光磊統一97購01  ,0,0,0,0,0,0,0,0,0,60000,0,0,0,60000,0,60000,60000
054459,鈺齊群益96購01  ,0,0,0,0,0,0,0,0,0,60000,0,0,0,60000,0,60000,60000
052313,聯電元大98購01  ,0,0,0,0,0,0,0,0,0,60000,0,0,0,266000,206000,60000,60000
052181,南茂元大95購05  ,0,0,0,0,0,0,0,0,0,60000,0,0,0,60000,0,60000,60000
052200,台光電統一95購02,0,0,0,0,0,0,0,0,0,60000,0,0,0,62000,2000,60000,60000
052607,大立光元大96購03,0,0,0,0,0,0,0,0,0,60000,0,0,0,60000,0,60000,60000
051559,宏達電國泰96購01,0,0,0,0,0,0,0,0,0,60000,0,0,0,60000,0,60000,60000
052061,樺漢國票96購01  ,0,0,0,0,0,0,0,0,0,60000,0,0,0,60000,0,60000,60000
05138P,嘉聯益凱基96售02,0,0,0,0,0,0,0,0,0,60000,0,0,0,60000,0,60000,60000
050138,台表科國票95購02,0,0,0,0,0,0,0,0,0,60000,0,0,0,60000,0,60000,60000
05574P,英業達元富96售01,0,0,0,0,0,0,0,0,0,60000,0,0,0,60000,0,60000,60000
055779,國泰金凱基97購02,0,0,0,0,0,0,0,0,0,60000,0,0,0,60000,0,60000,60000
058483,道瓊指國票9A購01,0,0,0,0,0,0,0,0,0,60000,0,0,0,60000,0,60000,60000
058573,鴻海群益9A購02  ,0,0,0,0,0,0,0,0,0,60000,0,0,0,95000,35000,60000,60000
056327,樺漢兆豐98購01  ,0,0,0,0,0,0,0,0,0,60000,0,0,0,60000,0,60000,60000
056510,正文永豐98購02  ,0,0,0,0,0,0,0,0,0,60000,0,0,0,60000,0,60000,60000
059323,新日興元大99購02,0,0,0,0,0,0,0,0,0,60000,0,0,0,66000,6000,60000,60000
058022,樺漢凱基99購02  ,0,0,0,0,0,0,0,0,0,60000,0,0,0,60000,0,60000,60000
1308,亞聚            ,493000,433000,60000,0,0,0,0,0,0,0,0,0,0,0,0,0,60000
06007P,世芯永豐96售01  ,0,0,0,0,0,0,0,0,0,59000,0,0,0,59000,0,59000,59000
060394,欣興麥證9A購01  ,0,0,0,59000,0,59000,0,0,0,59000,0,0,0,59000,0,59000,59000
060571,京元電永豐9A購01,0,0,0,0,0,0,0,0,0,59000,0,0,0,138000,79000,59000,59000
060733,和大統一9C購01  ,0,0,0,0,0,0,0,0,0,59000,0,0,0,89000,30000,59000,59000
061274,臺股指凱基9A購24,0,0,0,0,0,0,0,0,0,59000,0,0,0,61000,2000,59000,59000
061249,億豐群益9A購01  ,0,0,0,0,0,0,0,0,0,59000,0,0,0,59000,0,59000,59000
06676P,華新科國票98售03,0,0,0,0,0,0,0,0,0,59000,0,0,0,59000,0,59000,59000
01003T,兆豐新光R1      ,62000,3000,59000,0,0,0,0,0,0,0,0,0,0,0,0,0,59000
055171,凱美統一97購01  ,0,0,0,0,0,0,0,0,0,59000,0,0,0,60000,1000,59000,59000
053888,和大群益97購01  ,0,0,0,0,0,0,0,0,0,59000,0,0,0,59000,0,59000,59000
056036,鴻海凱基97購07  ,0,0,0,0,0,0,0,0,0,59000,0,0,0,76000,17000,59000,59000
057961,茂林元大9A購01  ,0,0,0,0,0,0,0,0,0,59000,0,0,0,73000,14000,59000,59000
056954,聯詠富邦9A購01  ,0,0,0,0,0,0,0,0,0,59000,0,0,0,269000,210000,59000,59000
061995,超眾元大01購01  ,0,0,0,0,0,0,0,0,0,58000,0,0,0,68000,10000,58000,58000
060596,元黃金凱基9A購02,0,0,0,0,0,0,0,0,0,58000,0,0,0,64000,6000,58000,58000
060852,京鼎國泰9B購01  ,0,0,0,0,0,0,0,0,0,58000,0,0,0,58000,0,58000,58000
059874,大立光凱基99購15,0,0,0,0,0,0,0,0,0,58000,0,0,0,68000,10000,58000,58000
052781,瀚宇博國票97購03,0,0,0,0,0,0,0,0,0,58000,0,0,0,58000,0,58000,58000
052946,智原國票97購02  ,0,0,0,0,0,0,0,0,0,58000,0,0,0,58000,0,58000,58000
057647,欣興元大98購10  ,0,0,0,0,0,0,0,0,0,58000,0,0,0,138000,80000,58000,58000
057926,帆宣凱基98購02  ,0,0,0,0,0,0,0,0,0,58000,0,0,0,58000,0,58000,58000
058208,百和凱基99購01  ,0,0,0,0,0,0,0,0,0,58000,0,0,0,58000,0,58000,58000
058359,瑞昱凱基99購01  ,0,0,0,0,0,0,0,0,0,58000,0,0,0,60000,2000,58000,58000
057981,臻鼎永豐98購01  ,0,0,0,0,0,0,0,0,0,58000,0,0,0,120000,62000,58000,58000
059926,世紀鋼國泰9B購01,0,0,0,0,0,0,0,0,0,57000,0,0,0,61000,4000,57000,57000
047202,欣興元富96購01  ,0,0,0,0,0,0,0,0,0,57000,0,0,0,57000,0,57000,57000
051461,聯詠國泰96購01  ,0,0,0,0,0,0,0,0,0,57000,0,0,0,57000,0,57000,57000
052316,台積電元大96購10,0,0,0,0,0,0,0,0,0,57000,0,0,0,57000,0,57000,57000
053183,大立光元富96購03,0,0,0,0,0,0,0,0,0,57000,0,0,0,57000,0,57000,57000
051729,華新國票96購01  ,0,0,0,0,0,0,0,0,0,57000,0,0,0,57000,0,57000,57000
05830P,滬深2X元富99售03,0,0,0,0,0,0,0,0,0,57000,0,0,0,112000,55000,57000,57000
055963,欣興元大97購04  ,0,0,0,0,0,0,0,0,0,57000,0,0,0,91000,34000,57000,57000
058435,旺宏統一9B購02  ,0,0,0,0,0,0,0,0,0,57000,0,0,0,62000,5000,57000,57000
07728P,臺股指凱基9A售20,0,0,0,0,0,0,0,0,0,57000,0,0,0,120000,63000,57000,57000
07400P,國巨凱基99售20  ,0,0,0,0,0,0,0,0,0,57000,0,0,0,59000,2000,57000,57000
060246,晶相光元大9C購03,0,0,0,0,0,0,0,0,0,56000,0,0,0,102000,46000,56000,56000
061819,茂林群益9B購01  ,0,0,0,0,0,0,0,0,0,56000,0,0,0,78000,22000,56000,56000
06447P,上銀元大98售01  ,0,0,0,0,0,0,0,0,0,56000,0,0,0,114000,58000,56000,56000
06721P,臺股指中信9A售03,0,0,0,0,0,0,0,0,0,56000,0,0,0,115000,59000,56000,56000
061338,台積電元大9A購28,0,0,0,0,0,0,0,0,0,56000,0,0,0,56000,0,56000,56000
052459,道瓊反統一95購04,0,0,0,0,0,0,0,0,0,56000,0,0,0,57000,1000,56000,56000
00662,富邦NASDAQ      ,9000,1000,8000,0,0,0,0,0,0,48000,0,0,0,150000,102000,48000,56000
056856,華通群益9A購01  ,0,0,0,0,0,0,0,0,0,56000,0,0,0,76000,20000,56000,56000
058052,南電元大98購02  ,0,0,0,0,0,0,0,0,0,56000,0,0,0,56000,0,56000,56000
07010P,T50正2凱基9C售01,0,0,0,0,0,0,0,0,0,56000,0,0,0,56000,0,56000,56000
2524,京城            ,104000,48000,56000,0,0,0,0,0,0,0,0,0,0,0,0,0,56000
061315,滬深2X凱基9C購06,0,0,0,0,0,0,0,0,0,55000,0,0,0,85000,30000,55000,55000
061395,健策統一9C購02  ,0,0,0,0,0,0,0,0,0,55000,0,0,0,103000,48000,55000,55000
060363,美律元富9A購01  ,0,0,0,0,0,0,0,0,0,55000,0,0,0,204000,149000,55000,55000
061069,嘉聯益凱基9A購01,0,0,0,0,0,0,0,0,0,55000,0,0,0,70000,15000,55000,55000
060473,中租元大9A購03  ,0,0,0,0,0,0,0,0,0,55000,0,0,0,60000,5000,55000,55000
052920,景碩台新96購02  ,0,0,0,0,0,0,0,0,0,55000,0,0,0,55000,0,55000,55000
054761,台光電國票98購02,0,0,0,0,0,0,0,0,0,55000,0,0,0,80000,25000,55000,55000
055052,凱美永豐97購01  ,0,0,0,0,0,0,0,0,0,55000,0,0,0,55000,0,55000,55000
055333,晶豪科兆豐97購01,0,0,0,0,0,0,0,0,0,55000,0,0,0,139000,84000,55000,55000
055127,台虹兆豐97購01  ,0,0,0,0,0,0,0,0,0,55000,0,0,0,206000,151000,55000,55000
058271,訊連永豐99購01  ,0,0,0,0,0,0,0,0,0,55000,0,0,0,55000,0,55000,55000
056048,同欣電兆豐97購01,0,0,0,0,0,0,0,0,0,55000,0,0,0,55000,0,55000,55000
056364,亞光元大99購02  ,0,0,0,0,0,0,0,0,0,55000,0,0,0,63000,8000,55000,55000
056970,TPK永豐98購01   ,0,0,0,0,0,0,0,0,0,55000,0,0,0,81000,26000,55000,55000
057877,神達元大99購01  ,0,0,0,0,0,0,0,0,0,55000,0,0,0,55000,0,55000,55000
056610,鴻海永豐98購01  ,0,0,0,0,0,0,0,0,0,55000,0,0,0,67000,12000,55000,55000
056782,鴻海群益98購04  ,0,0,0,0,0,0,0,0,0,55000,0,0,0,55000,0,55000,55000
056762,亞德客元大98購01,0,0,0,0,0,0,0,0,0,55000,0,0,0,96000,41000,55000,55000
057716,神達統一98購01  ,0,0,0,0,0,0,0,0,0,55000,0,0,0,55000,0,55000,55000
6283,淳安            ,60000,5000,55000,0,0,0,0,0,0,0,0,0,0,0,0,0,55000
060396,友達國票9A購01  ,0,0,0,0,0,0,0,0,0,54000,0,0,0,54000,0,54000,54000
061974,光寶科元大9B購01,0,0,0,0,0,0,0,0,0,54000,0,0,0,59000,5000,54000,54000
062015,喬山永豐9B購01  ,0,0,0,0,0,0,0,0,0,54000,0,0,0,54000,0,54000,54000
055071,群電永豐97購01  ,0,0,0,0,0,0,0,0,0,54000,0,0,0,54000,0,54000,54000
054001,康友群益96購02  ,0,0,0,0,0,0,0,0,0,54000,0,0,0,54000,0,54000,54000
052004,泰碩國泰97購03  ,0,0,0,0,0,0,0,0,0,54000,0,0,0,126000,72000,54000,54000
054593,滬深2X永昌9A購01,0,0,0,0,0,0,0,0,0,54000,0,0,0,569000,515000,54000,54000
057835,華擎元富9B購01  ,0,0,0,0,0,0,0,0,0,54000,0,0,0,314000,260000,54000,54000
056548,瀚宇博凱基98購02,0,0,0,0,0,0,0,0,0,54000,0,0,0,55000,1000,54000,54000
056207,茂林永豐97購03  ,0,0,0,0,0,0,0,0,0,54000,0,0,0,54000,0,54000,54000
056075,瀚宇博元大97購03,0,0,0,0,0,0,0,0,0,54000,0,0,0,75000,21000,54000,54000
058398,中環元大99購02  ,0,0,0,0,0,0,0,0,0,54000,0,0,0,165000,111000,54000,54000
059742,富邦金元富99購01,0,0,0,0,0,0,0,0,0,54000,0,0,0,84000,30000,54000,54000
4766,南寶            ,81000,27000,54000,0,0,0,0,0,0,0,0,0,0,0,0,0,54000
07757P,國巨國票9B售04  ,0,0,0,0,0,0,0,0,0,54000,0,0,0,54000,0,54000,54000
061284,友達統一9C購01  ,0,0,0,0,0,0,0,0,0,53000,0,0,0,53000,0,53000,53000
061215,健策元大9A購06  ,0,0,0,0,0,0,0,0,0,53000,0,0,0,72000,19000,53000,53000
060720,嘉聯益永豐9A購02,0,0,0,0,0,0,0,0,0,53000,0,0,0,53000,0,53000,53000
060835,亞德客國票9A購01,0,0,0,0,0,0,0,0,0,53000,0,0,0,56000,3000,53000,53000
053152,大立光元大99購01,0,0,0,0,0,0,0,0,0,53000,0,0,0,53000,0,53000,53000
00683L,元大美元指數正2 ,0,0,0,0,0,0,0,0,0,53000,0,0,0,65000,12000,53000,53000
058771,神達兆豐99購01  ,0,0,0,0,0,0,0,0,0,53000,0,0,0,93000,40000,53000,53000
058812,台積電統一9B購06,0,0,0,0,0,0,0,0,0,53000,0,0,0,101000,48000,53000,53000
059636,宏達電凱基99購05,0,0,0,0,0,0,0,0,0,53000,0,0,0,53000,0,53000,53000
056960,光罩永豐98購01  ,0,0,0,0,0,0,0,0,0,53000,0,0,0,184000,131000,53000,53000
07648P,祥碩國票9B售01  ,0,0,0,0,0,0,0,0,0,53000,0,0,0,58000,5000,53000,53000
060780,祥碩國泰9B購01  ,0,0,0,0,0,0,0,0,0,52000,0,0,0,111000,59000,52000,52000
060496,滬深2X元大9A購05,0,0,0,0,0,0,0,0,0,52000,0,0,0,102000,50000,52000,52000
060539,道瓊反凱基9A購01,0,0,0,0,0,0,0,0,0,52000,0,0,0,99000,47000,52000,52000
060636,大毅永豐9A購02  ,0,0,0,0,0,0,0,0,0,52000,0,0,0,52000,0,52000,52000
060426,盛群永豐9A購01  ,0,0,0,0,0,0,0,0,0,52000,0,0,0,67000,15000,52000,52000
060417,正隆永豐9A購01  ,0,0,0,0,0,0,0,0,0,52000,0,0,0,52000,0,52000,52000
060065,大立光兆豐9B購01,0,0,0,0,0,0,0,0,0,52000,0,0,0,55000,3000,52000,52000
061210,玉山金元大9A購02,0,0,0,0,0,0,0,0,0,52000,0,0,0,108000,56000,52000,52000
061376,瑞昱永豐9A購02  ,0,0,0,0,0,0,0,0,0,52000,0,0,0,83000,31000,52000,52000
048192,華通元大96購01  ,0,0,0,0,0,0,0,0,0,52000,0,0,0,59000,7000,52000,52000
052857,大成鋼凱基96購01,0,0,0,0,0,0,0,0,0,52000,0,0,0,82000,30000,52000,52000
057409,台虹群益98購02  ,0,0,0,0,0,0,0,0,0,52000,0,0,0,52000,0,52000,52000
055660,台光電兆豐97購01,0,0,0,0,0,0,0,0,0,52000,0,0,0,52000,0,52000,52000
059631,京元電凱基99購02,0,0,0,0,0,0,0,0,0,52000,0,0,0,75000,23000,52000,52000
057109,信邦群益98購01  ,0,0,0,0,0,0,0,0,0,52000,0,0,0,240000,188000,52000,52000
057935,晶技群益98購02  ,0,0,0,0,0,0,0,0,0,52000,0,0,0,53000,1000,52000,52000
061464,瑞昱群益9A購01  ,0,0,0,0,0,0,0,0,0,51000,0,0,0,98000,47000,51000,51000
061543,南亞科群益9A購01,0,0,0,0,0,0,0,0,0,51000,0,0,0,62000,11000,51000,51000
06458P,玉晶光統一9A售02,0,0,0,0,0,0,0,0,0,51000,0,0,0,65000,14000,51000,51000
060197,臻鼎元富9A購02  ,0,0,0,0,0,0,0,0,0,51000,0,0,0,373000,322000,51000,51000
053155,晶技元大97購02  ,0,0,0,0,0,0,0,0,0,51000,0,0,0,51000,0,51000,51000
048166,滬深2X永豐96購02,0,0,0,0,0,0,0,0,0,51000,0,0,0,51000,0,51000,51000
054785,建準群益98購01  ,0,0,0,0,0,0,0,0,0,51000,0,0,0,52000,1000,51000,51000
058248,聯茂元大99購05  ,0,0,0,0,0,0,0,0,0,51000,0,0,0,216000,165000,51000,51000
058251,百和元大99購03  ,0,0,0,0,0,0,0,0,0,51000,0,0,0,51000,0,51000,51000
057894,華通元富02購02  ,0,0,0,0,0,0,0,0,0,51000,0,0,0,57000,6000,51000,51000
056898,全新元大98購02  ,0,0,0,0,0,0,0,0,0,51000,0,0,0,114000,63000,51000,51000
057775,南亞科群益98購02,0,0,0,0,0,0,0,0,0,51000,0,0,0,51000,0,51000,51000
1314,中石化          ,1549000,1488000,61000,0,0,0,0,0,0,-10000,0,6000,-6000,0,4000,-4000,51000
07788P,華新科群益9A售08,0,0,0,0,0,0,0,0,0,51000,0,0,0,63000,12000,51000,51000
060267,上緯控國票9C購01,0,0,0,0,0,0,0,0,0,50000,0,0,0,50000,0,50000,50000
06000P,GIS元大96售04   ,0,0,0,0,0,0,0,0,0,50000,0,0,0,50000,0,50000,50000
060735,鴻海統一9C購03  ,0,0,0,0,0,0,0,0,0,50000,0,0,0,50000,0,50000,50000
06411P,晶相光永豐97售03,0,0,0,0,0,0,0,0,0,50000,0,0,0,50000,0,50000,50000
06618P,智邦元大98售04  ,0,0,0,0,0,0,0,0,0,50000,0,0,0,50000,0,50000,50000
061848,國巨國票9B購07  ,0,0,0,0,0,0,0,0,0,50000,0,0,0,180000,130000,50000,50000
061872,友達元大9C購06  ,0,0,0,0,0,0,0,0,0,50000,0,0,0,50000,0,50000,50000
061353,康控元大9A購01  ,0,0,0,0,0,0,0,0,0,50000,0,0,0,50000,0,50000,50000
061260,台積電凱基9A購23,0,0,0,0,0,0,0,0,0,50000,0,0,0,50000,0,50000,50000
054738,聯發科凱基97購01,0,0,0,0,0,0,0,0,0,50000,0,0,0,50000,0,50000,50000
053415,聯茂國票97購01  ,0,0,0,0,0,0,0,0,0,50000,0,0,0,50000,0,50000,50000
053371,滬深2X元大99購01,0,0,0,0,0,0,0,0,0,50000,0,0,0,306000,256000,50000,50000
055227,聯發科國票98購02,0,0,0,0,0,0,0,0,0,50000,0,0,0,53000,3000,50000,50000
053886,亞光兆豐96購01  ,0,0,0,0,0,0,0,0,0,50000,0,0,0,100000,50000,50000,50000
054859,鴻海群益97購02  ,0,0,0,0,0,0,0,0,0,50000,0,0,0,50000,0,50000,50000
053799,矽創中信9A購01  ,0,0,0,0,0,0,0,0,0,50000,0,0,0,50000,0,50000,50000
053800,華通凱基97購03  ,0,0,0,0,0,0,0,0,0,50000,0,0,0,50000,0,50000,50000
053689,台光電元大96購01,0,0,0,0,0,0,0,0,0,50000,0,0,0,50000,0,50000,50000
058790,楠梓電元大99購03,0,0,0,0,0,0,0,0,0,50000,0,0,0,66000,16000,50000,50000
055097,福懋科群益97購01,0,0,0,0,0,0,0,0,0,50000,0,0,0,62000,12000,50000,50000
055130,京鼎康和97購01  ,0,0,0,0,0,0,0,0,0,50000,0,0,0,50000,0,50000,50000
055476,台郡凱基97購02  ,0,0,0,0,0,0,0,0,0,50000,0,0,0,50000,0,50000,50000
047825,道瓊反元大96購01,0,0,0,0,0,0,0,0,0,50000,0,0,0,50000,0,50000,50000
050894,旺宏元大96購03  ,0,0,0,0,0,0,0,0,0,50000,0,0,0,50000,0,50000,50000
053025,燿華富邦98購02  ,0,0,0,0,0,0,0,0,0,50000,0,0,0,51000,1000,50000,50000
050097,可成國泰96購02  ,0,0,0,0,0,0,0,0,0,50000,0,0,0,50000,0,50000,50000
050353,華擎群益95購01  ,0,0,0,0,0,0,0,0,0,50000,0,0,0,50000,0,50000,50000
050494,可成永昌96購01  ,0,0,0,0,0,0,0,0,0,50000,0,0,0,50000,0,50000,50000
051888,國巨元富95購05  ,0,0,0,0,0,0,0,0,0,50000,0,0,0,50000,0,50000,50000
052707,景碩台新96購01  ,0,0,0,0,0,0,0,0,0,50000,0,0,0,50000,0,50000,50000
05207P,高股息中信97售03,0,0,0,0,0,0,0,0,0,50000,0,0,0,50000,0,50000,50000
052290,鴻海元富97購01  ,0,0,0,0,0,0,0,0,0,50000,0,0,0,50000,0,50000,50000
052212,可成元大95購11  ,0,0,0,0,0,0,0,0,0,50000,0,0,0,50000,0,50000,50000
052376,聯詠元大95購04  ,0,0,0,0,0,0,0,0,0,50000,0,0,0,50000,0,50000,50000
056393,精元永豐98購01  ,0,0,0,0,0,0,0,0,0,50000,0,0,0,50000,0,50000,50000
057885,台光電群益98購04,0,0,0,0,0,0,0,0,0,50000,0,0,0,50000,0,50000,50000
055701,亞德客富邦99購01,0,0,0,0,0,0,0,0,0,50000,0,0,0,50000,0,50000,50000
056683,台積電統一98購05,0,0,0,0,0,0,0,0,0,50000,0,0,0,98000,48000,50000,50000
055747,康舒元富97購01  ,0,0,0,0,0,0,0,0,0,50000,0,0,0,80000,30000,50000,50000
057672,茂林元大98購02  ,0,0,0,0,0,0,0,0,0,50000,0,0,0,50000,0,50000,50000
057693,臺股指凱基98購11,0,0,0,0,0,0,0,0,0,50000,0,0,0,50000,0,50000,50000
058244,神達元大99購02  ,0,0,0,0,0,0,0,0,0,50000,0,0,0,180000,130000,50000,50000
058397,大成鋼元大99購02,0,0,0,0,0,0,0,0,0,50000,0,0,0,63000,13000,50000,50000
056137,聯鈞元大9A購01  ,0,0,0,0,0,0,0,0,0,50000,0,0,0,50000,0,50000,50000
057949,南電國票99購01  ,0,0,0,0,0,0,0,0,0,50000,0,0,0,77000,27000,50000,50000
07769P,國巨國票9A售10  ,0,0,0,0,0,0,0,0,0,50000,0,0,0,50000,0,50000,50000
07907P,台灣50台新9B售08,0,0,0,0,0,0,0,0,0,50000,0,0,0,50000,0,50000,50000
07707P,玉山金元大9A售03,0,0,0,0,0,0,0,0,0,50000,0,0,0,50000,0,50000,50000
07531P,大立光國泰9B售03,0,0,0,0,0,0,0,0,0,50000,0,0,0,174000,124000,50000,50000
07147P,高鐵元大99售01  ,0,0,0,0,0,0,0,0,0,50000,0,0,0,50000,0,50000,50000
07501P,華新科元大9A售07,0,0,0,0,0,0,0,0,0,50000,0,0,0,50000,0,50000,50000
061368,南六國票9A購01  ,0,0,0,0,0,0,0,0,0,49000,0,0,0,196000,147000,49000,49000
060905,台積電元大9A購20,0,0,0,0,0,0,0,0,0,49000,0,0,0,99000,50000,49000,49000
052647,晶技永豐97購01  ,0,0,0,0,0,0,0,0,0,49000,0,0,0,49000,0,49000,49000
053170,茂林群益96購04  ,0,0,0,0,0,0,0,0,0,49000,0,0,0,49000,0,49000,49000
050794,大立光富邦96購04,0,0,0,0,0,0,0,0,0,49000,0,0,0,49000,0,49000,49000
051055,友達群益98購01  ,0,0,0,0,0,0,0,0,0,49000,0,0,0,49000,0,49000,49000
047673,瑞昱元富96購01  ,0,0,0,0,0,0,0,0,0,49000,0,0,0,68000,19000,49000,49000
055647,義隆元富97購01  ,0,0,0,0,0,0,0,0,0,49000,0,0,0,178000,129000,49000,49000
058741,欣興日盛99購01  ,0,0,0,0,0,0,0,0,0,49000,0,0,0,147000,98000,49000,49000
058875,台表科國票9A購02,0,0,0,0,0,0,0,0,0,49000,0,0,0,89000,40000,49000,49000
058911,茂林元大99購04  ,0,0,0,0,0,0,0,0,0,49000,0,0,0,66000,17000,49000,49000
053849,聯發科元富96購04,0,0,0,0,0,0,0,0,0,49000,0,0,0,49000,0,49000,49000
056085,聯發科統一97購01,0,0,0,0,0,0,0,0,0,49000,0,0,0,50000,1000,49000,49000
057843,晶技永豐98購02  ,0,0,0,0,0,0,0,0,0,49000,0,0,0,49000,0,49000,49000
056250,瑞昱兆豐97購02  ,0,0,0,0,0,0,0,0,0,49000,0,0,0,69000,20000,49000,49000
07877P,晶技永豐9B售01  ,0,0,0,0,0,0,0,0,0,49000,0,0,0,194000,145000,49000,49000
2239,英利-KY         ,48000,3000,45000,0,0,0,0,0,0,4000,4000,0,4000,0,0,0,49000
060844,大立光國票9A購07,0,0,0,0,0,0,0,0,0,48000,0,0,0,63000,15000,48000,48000
060677,京元電元大9A購04,0,0,0,0,0,0,0,0,0,48000,0,0,0,48000,0,48000,48000
059937,旺宏永豐99購03  ,0,0,0,0,0,0,0,0,0,48000,0,0,0,148000,100000,48000,48000
061182,南六凱基9A購01  ,0,0,0,0,0,0,0,0,0,48000,0,0,0,50000,2000,48000,48000
061570,瑞昱元大9A購05  ,0,0,0,0,0,0,0,0,0,48000,0,0,0,252000,204000,48000,48000
061690,旺宏群益9A購05  ,0,0,0,0,0,0,0,0,0,48000,0,0,0,48000,0,48000,48000
06674P,祥碩群益98售02  ,0,0,0,0,0,0,0,0,0,48000,0,0,0,140000,92000,48000,48000
054922,文曄凱基98購01  ,0,0,0,0,0,0,0,0,0,48000,0,0,0,48000,0,48000,48000
00783,富邦中証500     ,36000,16000,20000,0,0,0,0,0,0,28000,0,0,0,1046000,1018000,28000,48000
056958,喬山永豐98購01  ,0,0,0,0,0,0,0,0,0,48000,0,0,0,51000,3000,48000,48000
057810,技嘉元大98購06  ,0,0,0,0,0,0,0,0,0,48000,0,0,0,100000,52000,48000,48000
058524,超眾元大99購04  ,0,0,0,0,0,0,0,0,0,48000,0,0,0,94000,46000,48000,48000
055772,致茂凱基97購01  ,0,0,0,0,0,0,0,0,0,48000,0,0,0,48000,0,48000,48000
058203,信邦凱基99購01  ,0,0,0,0,0,0,0,0,0,48000,0,0,0,48000,0,48000,48000
059690,建準永豐99購01  ,0,0,0,0,0,0,0,0,0,48000,0,0,0,48000,0,48000,48000
07050P,宏達電中信9B售01,0,0,0,0,0,0,0,0,0,48000,0,0,0,48000,0,48000,48000
061997,台郡元大9B購03  ,0,0,0,0,0,0,0,0,0,47000,0,0,0,82000,35000,47000,47000
06347P,祥碩元富97售02  ,0,0,0,0,0,0,0,0,0,47000,0,0,0,50000,3000,47000,47000
061638,國泰金元大9A購03,0,0,0,0,0,0,0,0,0,47000,0,0,0,96000,49000,47000,47000
061560,友達國票9B購01  ,0,0,0,0,0,0,0,0,0,47000,0,0,0,47000,0,47000,47000
061236,台積電元大9A購24,0,0,0,0,0,0,0,0,0,47000,0,0,0,47000,0,47000,47000
060235,瑞昱元大9A購01  ,0,0,0,0,0,0,0,0,0,47000,0,0,0,127000,80000,47000,47000
050254,大立光富邦96購02,0,0,0,0,0,0,0,0,0,47000,0,0,0,93000,46000,47000,47000
059341,台積電凱基99購15,0,0,0,0,0,0,0,0,0,47000,0,0,0,47000,0,47000,47000
057147,新日興國票99購01,0,0,0,0,0,0,0,0,0,47000,0,0,0,85000,38000,47000,47000
057962,超眾元大99購03  ,0,0,0,0,0,0,0,0,0,47000,0,0,0,55000,8000,47000,47000
055814,晶豪科國票97購02,0,0,0,0,0,0,0,0,0,47000,0,0,0,47000,0,47000,47000
060115,南電元大99購06  ,0,0,0,0,0,0,0,0,0,46000,0,0,0,47000,1000,46000,46000
061946,鴻海群益9B購03  ,0,0,0,0,0,0,0,0,0,46000,0,0,0,46000,0,46000,46000
00681R,元大美債20反1   ,0,0,0,0,0,0,0,0,0,46000,0,0,0,46000,0,46000,46000
052625,南電亞東97購01  ,0,0,0,0,0,0,0,0,0,46000,0,0,0,66000,20000,46000,46000
055586,旺宏元大98購06  ,0,0,0,0,0,0,0,0,0,46000,0,0,0,46000,0,46000,46000
058589,群創中信01購01  ,0,0,0,0,0,0,0,0,0,46000,0,0,0,46000,0,46000,46000
056604,鴻海富邦9A購01  ,0,0,0,0,0,0,0,0,0,46000,0,0,0,46000,0,46000,46000
057479,致茂元大98購03  ,0,0,0,0,0,0,0,0,0,46000,0,0,0,50000,4000,46000,46000
07258P,台灣50台新9A售01,0,0,0,0,0,0,0,0,0,46000,0,0,0,100000,54000,46000,46000
07674P,金融類元大9A售01,0,0,0,0,0,0,0,0,0,46000,0,0,0,50000,4000,46000,46000
2912,統一超          ,602000,538000,64000,0,0,0,0,18000,-18000,0,0,0,0,0,0,0,46000
062050,亞德客統一9C購01,0,0,0,0,0,0,0,0,0,45000,0,0,0,45000,0,45000,45000
06680P,智邦元大98售06  ,0,0,0,0,0,0,0,0,0,45000,0,0,0,45000,0,45000,45000
06468P,華新科統一98售02,0,0,0,0,0,0,0,0,0,45000,0,0,0,45000,0,45000,45000
06766P,玉晶光元大99售10,0,0,0,0,0,0,0,0,0,45000,0,0,0,55000,10000,45000,45000
061202,和大元大9A購02  ,0,0,0,0,0,0,0,0,0,45000,0,0,0,55000,10000,45000,45000
061773,和潤元大9B購01  ,0,0,0,0,0,0,0,0,0,45000,0,0,0,51000,6000,45000,45000
060087,鴻海元大99購43  ,0,0,0,0,0,0,0,0,0,45000,0,0,0,45000,0,45000,45000
059961,T50反1凱基99購09,0,0,0,0,0,0,0,0,0,45000,0,0,0,260000,215000,45000,45000
05979P,華新科中信96售02,0,0,0,0,0,0,0,0,0,45000,0,0,0,45000,0,45000,45000
060216,鴻海凱基9A購17  ,0,0,0,0,0,0,0,0,0,45000,0,0,0,50000,5000,45000,45000
060456,正隆元大9A購01  ,0,0,0,0,0,0,0,0,0,45000,0,0,0,50000,5000,45000,45000
060610,玉晶光凱基9B購02,0,0,0,0,0,0,0,0,0,45000,0,0,0,95000,50000,45000,45000
060548,友達凱基9B購03  ,0,0,0,0,0,0,0,0,0,45000,0,0,0,113000,68000,45000,45000
053642,瀚宇博永豐96購01,0,0,0,0,0,0,0,0,0,45000,0,0,0,45000,0,45000,45000
053653,京元電凱基96購02,0,0,0,0,0,0,0,0,0,45000,0,0,0,50000,5000,45000,45000
054358,矽創兆豐96購01  ,0,0,0,0,0,0,0,0,0,45000,0,0,0,112000,67000,45000,45000
052424,泰碩國票97購01  ,0,0,0,0,0,0,0,0,0,45000,0,0,0,176000,131000,45000,45000
056994,緯穎兆豐98購02  ,0,0,0,0,0,0,0,0,0,45000,0,0,0,45000,0,45000,45000
058265,奇力新永豐9A購01,0,0,0,0,0,0,0,0,0,45000,0,0,0,65000,20000,45000,45000
059313,元石油元大99購06,0,0,0,0,0,0,0,0,0,45000,0,0,0,61000,16000,45000,45000
056209,超眾永豐97購02  ,0,0,0,0,0,0,0,0,0,45000,0,0,0,135000,90000,45000,45000
056748,T50反1兆豐99購01,0,0,0,0,0,0,0,0,0,45000,0,0,0,45000,0,45000,45000
058455,玉晶光永豐99購03,0,0,0,0,0,0,0,0,0,45000,0,0,0,76000,31000,45000,45000
057627,和大永豐98購01  ,0,0,0,0,0,0,0,0,0,45000,0,0,0,45000,0,45000,45000
057623,友訊國泰99購01  ,0,0,0,0,0,0,0,0,0,45000,0,0,0,45000,0,45000,45000
07536P,華新科元富9A售04,0,0,0,0,0,0,0,0,0,45000,0,0,0,72000,27000,45000,45000
060501,鴻海元大9A購13  ,0,0,0,0,0,0,0,0,0,44000,0,0,0,105000,61000,44000,44000
060704,台積電富邦01購01,0,0,0,0,0,0,0,0,0,44000,0,0,0,248000,204000,44000,44000
060240,富邦金元大9A購01,0,0,0,0,0,0,0,0,0,44000,0,0,0,65000,21000,44000,44000
059789,貿聯元大9A購02  ,0,0,0,0,0,0,0,0,0,44000,0,0,0,44000,0,44000,44000
059856,昇陽半永豐99購03,0,0,0,0,0,0,0,0,0,44000,0,0,0,64000,20000,44000,44000
059991,超眾元大9A購02  ,0,0,0,0,0,0,0,0,0,44000,0,0,0,78000,34000,44000,44000
061744,超眾凱基9B購02  ,0,0,0,0,0,0,0,0,0,44000,0,0,0,44000,0,44000,44000
061674,聯發科元大9A購12,0,0,0,0,0,0,0,0,0,44000,0,0,0,44000,0,44000,44000
06123P,玉晶光元大97售04,0,0,0,0,0,0,0,0,0,44000,0,0,0,150000,106000,44000,44000
06622P,牧德元大98售01  ,0,0,0,0,0,0,0,0,0,44000,0,0,0,54000,10000,44000,44000
00851,台新全球AI      ,0,0,0,0,0,0,0,0,0,44000,0,0,0,67000,23000,44000,44000
053704,國巨群益96購06  ,0,0,0,0,0,0,0,0,0,44000,0,0,0,44000,0,44000,44000
055138,大毅永豐97購02  ,0,0,0,0,0,0,0,0,0,44000,0,0,0,95000,51000,44000,44000
059086,國巨元大99購18  ,0,0,0,0,0,0,0,0,0,44000,0,0,0,150000,106000,44000,44000
055703,緯穎富邦98購01  ,0,0,0,0,0,0,0,0,0,44000,0,0,0,54000,10000,44000,44000
055733,奇力新元富97購01,0,0,0,0,0,0,0,0,0,44000,0,0,0,98000,54000,44000,44000
058579,聯發科群益99購04,0,0,0,0,0,0,0,0,0,44000,0,0,0,44000,0,44000,44000
059267,群創中信01購02  ,0,0,0,0,0,0,0,0,0,44000,0,0,0,44000,0,44000,44000
059358,旺宏永豐99購02  ,0,0,0,0,0,0,0,0,0,44000,0,0,0,44000,0,44000,44000
058246,帆宣元大99購01  ,0,0,0,0,0,0,0,0,0,44000,0,0,0,98000,54000,44000,44000
061239,聯發科兆豐9A購01,0,0,0,0,0,0,0,0,0,43000,0,0,0,47000,4000,43000,43000
061252,臺股指群益9A購03,0,0,0,0,0,0,0,0,0,43000,0,0,0,48000,5000,43000,43000
061316,台積電凱基9A購24,0,0,0,0,0,0,0,0,0,43000,0,0,0,43000,0,43000,43000
06140P,華新科群益97售06,0,0,0,0,0,0,0,0,0,43000,0,0,0,48000,5000,43000,43000
060161,牧德永豐9A購02  ,0,0,0,0,0,0,0,0,0,43000,0,0,0,100000,57000,43000,43000
055458,燿華永豐98購01  ,0,0,0,0,0,0,0,0,0,43000,0,0,0,43000,0,43000,43000
053924,京鼎國票97購01  ,0,0,0,0,0,0,0,0,0,43000,0,0,0,43000,0,43000,43000
053494,南亞科兆豐96購02,0,0,0,0,0,0,0,0,0,43000,0,0,0,50000,7000,43000,43000
053446,欣興凱基96購02  ,0,0,0,0,0,0,0,0,0,43000,0,0,0,43000,0,43000,43000
051422,超眾國票96購01  ,0,0,0,0,0,0,0,0,0,43000,0,0,0,143000,100000,43000,43000
052434,茂林國泰97購01  ,0,0,0,0,0,0,0,0,0,43000,0,0,0,44000,1000,43000,43000
053173,矽格群益97購01  ,0,0,0,0,0,0,0,0,0,43000,0,0,0,187000,144000,43000,43000
058243,華擎元大99購01  ,0,0,0,0,0,0,0,0,0,43000,0,0,0,269000,226000,43000,43000
057110,立積群益98購01  ,0,0,0,0,0,0,0,0,0,43000,0,0,0,43000,0,43000,43000
059678,鴻海國泰9A購03  ,0,0,0,0,0,0,0,0,0,43000,0,0,0,46000,3000,43000,43000
057591,鴻海兆豐99購01  ,0,0,0,0,0,0,0,0,0,43000,0,0,0,43000,0,43000,43000
057369,奇力新元大99購05,0,0,0,0,0,0,0,0,0,43000,0,0,0,45000,2000,43000,43000
056286,奇鋐永豐97購01  ,0,0,0,0,0,0,0,0,0,43000,0,0,0,63000,20000,43000,43000
07593P,臺股指凱基9A售08,0,0,0,0,0,0,0,0,0,43000,0,0,0,104000,61000,43000,43000
07856P,力成凱基9A售02  ,0,0,0,0,0,0,0,0,0,43000,0,0,0,148000,105000,43000,43000
1514,亞力            ,175000,132000,43000,0,0,0,0,0,0,0,0,0,0,0,0,0,43000
6277,宏正            ,86000,43000,43000,0,0,0,0,0,0,0,0,0,0,0,0,0,43000
06109P,華新科群益97售05,0,0,0,0,0,0,0,0,0,42000,0,0,0,52000,10000,42000,42000
060998,華通兆豐9A購01  ,0,0,0,0,0,0,0,0,0,42000,0,0,0,47000,5000,42000,42000
061011,華通麥證9A購02  ,0,0,0,42000,0,42000,0,0,0,42000,0,0,0,42000,0,42000,42000
061300,臺股指富邦9A購02,0,0,0,0,0,0,0,0,0,42000,0,0,0,60000,18000,42000,42000
06375P,矽力元大97售06  ,0,0,0,0,0,0,0,0,0,42000,0,0,0,42000,0,42000,42000
06729P,聯詠元大98售03  ,0,0,0,0,0,0,0,0,0,42000,0,0,0,42000,0,42000,42000
051553,牧德永豐96購02  ,0,0,0,0,0,0,0,0,0,42000,0,0,0,195000,153000,42000,42000
053876,可成永昌98購01  ,0,0,0,0,0,0,0,0,0,42000,0,0,0,42000,0,42000,42000
053331,玉晶光永豐97購02,0,0,0,0,0,0,0,0,0,42000,0,0,0,83000,41000,42000,42000
053340,建準國票97購01  ,0,0,0,0,0,0,0,0,0,42000,0,0,0,57000,15000,42000,42000
058957,貿聯國票9A購01  ,0,0,0,0,0,0,0,0,0,42000,0,0,0,105000,63000,42000,42000
056905,欣興元大98購03  ,0,0,0,0,0,0,0,0,0,42000,0,0,0,59000,17000,42000,42000
057571,泰碩永豐98購01  ,0,0,0,0,0,0,0,0,0,42000,0,0,0,57000,15000,42000,42000
058293,光寶科凱基9A購01,0,0,0,0,0,0,0,0,0,42000,0,0,0,107000,65000,42000,42000
058402,欣興元大99購04  ,0,0,0,0,0,0,0,0,0,42000,0,0,0,59000,17000,42000,42000
061531,奇鋐台新9A購01  ,0,0,0,0,0,0,0,0,0,41000,0,0,0,41000,0,41000,41000
060450,南亞元大9A購02  ,0,0,0,0,0,0,0,0,0,41000,0,0,0,66000,25000,41000,41000
060327,美律群益9A購02  ,0,0,0,0,0,0,0,0,0,41000,0,0,0,41000,0,41000,41000
060333,金寶康和9A購01  ,0,0,0,0,0,0,0,0,0,41000,0,0,0,61000,20000,41000,41000
05995P,T50正2中信9C售01,0,0,0,0,0,0,0,0,0,41000,0,0,0,41000,0,41000,41000
055146,華通元大98購04  ,0,0,0,0,0,0,0,0,0,41000,0,0,0,41000,0,41000,41000
055603,超眾元大97購04  ,0,0,0,0,0,0,0,0,0,41000,0,0,0,41000,0,41000,41000
055228,聯發科國票98購03,0,0,0,0,0,0,0,0,0,41000,0,0,0,41000,0,41000,41000
053483,嘉澤第一96購01  ,0,0,0,0,0,0,0,0,0,41000,0,0,0,41000,0,41000,41000
054302,鴻海凱基96購18  ,0,0,0,0,0,0,0,0,0,41000,0,0,0,91000,50000,41000,41000
056167,力成台新97購01  ,0,0,0,0,0,0,0,0,0,41000,0,0,0,41000,0,41000,41000
055755,禾伸堂兆豐97購02,0,0,0,0,0,0,0,0,0,41000,0,0,0,41000,0,41000,41000
055789,台虹凱基97購01  ,0,0,0,0,0,0,0,0,0,41000,0,0,0,41000,0,41000,41000
058503,鴻海元大99購14  ,0,0,0,0,0,0,0,0,0,41000,0,0,0,41000,0,41000,41000
2020,美亞            ,62000,21000,41000,0,0,0,0,0,0,0,0,0,0,0,0,0,41000
07184P,台灣50元富01售01,0,0,0,0,0,0,0,0,0,41000,0,0,0,71000,30000,41000,41000
059909,鴻海元大99購36  ,0,0,0,0,0,0,0,0,0,40000,0,0,0,50000,10000,40000,40000
060108,泰鼎元大99購04  ,0,0,0,0,0,0,0,0,0,40000,0,0,0,42000,2000,40000,40000
060169,群電永豐9A購01  ,0,0,0,0,0,0,0,0,0,40000,0,0,0,76000,36000,40000,40000
060190,國泰金元富9A購01,0,0,0,0,0,0,0,0,0,40000,0,0,0,226000,186000,40000,40000
061083,京元電兆豐9A購01,0,0,0,0,0,0,0,0,0,40000,0,0,0,50000,10000,40000,40000
060645,台表科永豐9A購02,0,0,0,0,0,0,0,0,0,40000,0,0,0,121000,81000,40000,40000
060527,台積電中信9C購04,0,0,0,0,0,0,0,0,0,40000,0,0,0,40000,0,40000,40000
061678,玉晶光元大9B購04,0,0,0,0,0,0,0,0,0,40000,0,0,0,146000,106000,40000,40000
061702,奇鋐國票9A購02  ,0,0,0,0,0,0,0,0,0,40000,0,0,0,40000,0,40000,40000
061183,友達國泰9B購02  ,0,0,0,0,0,0,0,0,0,40000,0,0,0,40000,0,40000,40000
061187,瀚宇博國泰9C購01,0,0,0,0,0,0,0,0,0,40000,0,0,0,40000,0,40000,40000
061383,高股息群益9A購01,0,0,0,0,0,0,0,0,0,40000,0,0,0,40000,0,40000,40000
062002,鴻海國泰01購01  ,0,0,0,0,0,0,0,0,0,40000,0,0,0,46000,6000,40000,40000
06338P,亞德客統一97售02,0,0,0,0,0,0,0,0,0,40000,0,0,0,40000,0,40000,40000
061958,鴻海統一01購01  ,0,0,0,0,0,0,0,0,0,40000,0,0,0,44000,4000,40000,40000
061895,旺宏永豐9B購01  ,0,0,0,0,0,0,0,0,0,40000,0,0,0,40000,0,40000,40000
054825,康友元大97購01  ,0,0,0,0,0,0,0,0,0,40000,0,0,0,40000,0,40000,40000
054740,強茂凱基99購01  ,0,0,0,0,0,0,0,0,0,40000,0,0,0,40000,0,40000,40000
055613,全新國票98購01  ,0,0,0,0,0,0,0,0,0,40000,0,0,0,40000,0,40000,40000
055505,新唐元大97購02  ,0,0,0,0,0,0,0,0,0,40000,0,0,0,50000,10000,40000,40000
055493,華新科元大97購09,0,0,0,0,0,0,0,0,0,40000,0,0,0,40000,0,40000,40000
055511,大立光兆豐97購02,0,0,0,0,0,0,0,0,0,40000,0,0,0,100000,60000,40000,40000
05536P,奇力新元大96售03,0,0,0,0,0,0,0,0,0,40000,0,0,0,40000,0,40000,40000
053628,微星兆豐96購01  ,0,0,0,0,0,0,0,0,0,40000,0,0,0,40000,0,40000,40000
052229,奇力新凱基96購01,0,0,0,0,0,0,0,0,0,40000,0,0,0,40000,0,40000,40000
052234,GIS凱基97購01   ,0,0,0,0,0,0,0,0,0,40000,0,0,0,50000,10000,40000,40000
052483,超眾群益95購03  ,0,0,0,0,0,0,0,0,0,40000,0,0,0,40000,0,40000,40000
054614,玉晶光永豐97購03,0,0,0,0,0,0,0,0,0,40000,0,0,0,40000,0,40000,40000
051889,智邦元富95購02  ,0,0,0,0,0,0,0,0,0,40000,0,0,0,40000,0,40000,40000
053050,華通國票97購02  ,0,0,0,0,0,0,0,0,0,40000,0,0,0,40000,0,40000,40000
052980,上銀元大96購03  ,0,0,0,0,0,0,0,0,0,40000,0,0,0,40000,0,40000,40000
046020,滬深2X元大95購02,0,0,0,0,0,0,0,0,0,40000,0,0,0,40000,0,40000,40000
048663,聯發科統一96購01,0,0,0,0,0,0,0,0,0,40000,0,0,0,40000,0,40000,40000
049102,智伸科國泰96購01,0,0,0,0,0,0,0,0,0,40000,0,0,0,40000,0,40000,40000
049947,S&P反1中信97購01,0,0,0,0,0,0,0,0,0,40000,0,0,0,40000,0,40000,40000
050316,上証2X國票98購01,0,0,0,0,0,0,0,0,0,40000,0,0,0,40000,0,40000,40000
056699,光罩國泰99購01  ,0,0,0,0,0,0,0,0,0,40000,0,0,0,40000,0,40000,40000
057284,新日興元大98購03,0,0,0,0,0,0,0,0,0,40000,0,0,0,48000,8000,40000,40000
057438,禾伸堂國票99購01,0,0,0,0,0,0,0,0,0,40000,0,0,0,50000,10000,40000,40000
057766,矽力凱基98購03  ,0,0,0,0,0,0,0,0,0,40000,0,0,0,54000,14000,40000,40000
057754,臺股指國票98購10,0,0,0,0,0,0,0,0,0,40000,0,0,0,40000,0,40000,40000
057066,緯穎富邦99購01  ,0,0,0,0,0,0,0,0,0,40000,0,0,0,40000,0,40000,40000
057007,奇力新中信98購04,0,0,0,0,0,0,0,0,0,40000,0,0,0,50000,10000,40000,40000
056033,T50正2凱基99購02,0,0,0,0,0,0,0,0,0,40000,0,0,0,40000,0,40000,40000
057963,緯穎元大98購08  ,0,0,0,0,0,0,0,0,0,40000,0,0,0,115000,75000,40000,40000
057903,聯鈞永豐99購01  ,0,0,0,0,0,0,0,0,0,40000,0,0,0,50000,10000,40000,40000
057243,樺漢凱基99購01  ,0,0,0,0,0,0,0,0,0,40000,0,0,0,40000,0,40000,40000
059357,華通永豐99購01  ,0,0,0,0,0,0,0,0,0,40000,0,0,0,40000,0,40000,40000
059561,滬深2X凱基9C購05,0,0,0,0,0,0,0,0,0,40000,0,0,0,45000,5000,40000,40000
058072,大立光凱基98購20,0,0,0,0,0,0,0,0,0,40000,0,0,0,100000,60000,40000,40000
05805P,義隆永豐96售02  ,0,0,0,0,0,0,0,0,0,40000,0,0,0,40000,0,40000,40000
059196,聯發科永豐99購02,0,0,0,0,0,0,0,0,0,40000,0,0,0,40000,0,40000,40000
058115,台光電中信99購01,0,0,0,0,0,0,0,0,0,40000,0,0,0,40000,0,40000,40000
07178P,臺股指凱基99售20,0,0,0,0,0,0,0,0,0,40000,0,0,0,40000,0,40000,40000
07130P,台郡元大9B售01  ,0,0,0,0,0,0,0,0,0,40000,0,0,0,71000,31000,40000,40000
07230P,滬深2X群益01售02,0,0,0,0,0,0,0,0,0,40000,0,0,0,40000,0,40000,40000
07109P,聯發科中信9B售02,0,0,0,0,0,0,0,0,0,40000,0,0,0,40000,0,40000,40000
07387P,臺股指群益99售25,0,0,0,0,0,0,0,0,0,40000,0,0,0,50000,10000,40000,40000
07796P,聯發科國票9A售03,0,0,0,0,0,0,0,0,0,40000,0,0,0,40000,0,40000,40000
07592P,台灣50元大9A售17,0,0,0,0,0,0,0,0,0,40000,0,0,0,100000,60000,40000,40000
061903,宏全永豐9B購01  ,0,0,0,0,0,0,0,0,0,39000,0,0,0,39000,0,39000,39000
06668P,祥碩凱基98售02  ,0,0,0,0,0,0,0,0,0,39000,0,0,0,39000,0,39000,39000
061452,大成鋼凱基9A購01,0,0,0,0,0,0,0,0,0,39000,0,0,0,149000,110000,39000,39000
060528,友達中信9C購01  ,0,0,0,0,0,0,0,0,0,39000,0,0,0,56000,17000,39000,39000
061068,祥碩凱基9B購01  ,0,0,0,0,0,0,0,0,0,39000,0,0,0,238000,199000,39000,39000
060222,貿聯凱基9A購02  ,0,0,0,0,0,0,0,0,0,39000,0,0,0,39000,0,39000,39000
060446,A50正2元大9A購01,0,0,0,0,0,0,0,0,0,39000,0,0,0,39000,0,39000,39000
060039,大立光國票99購04,0,0,0,0,0,0,0,0,0,39000,0,0,0,39000,0,39000,39000
045768,大立光元富95購02,0,0,0,0,0,0,0,0,0,39000,0,0,0,39000,0,39000,39000
055645,技嘉元富97購01  ,0,0,0,0,0,0,0,0,0,39000,0,0,0,40000,1000,39000,39000
059040,訊芯群益99購03  ,0,0,0,0,0,0,0,0,0,39000,0,0,0,232000,193000,39000,39000
055183,聯鈞統一97購01  ,0,0,0,0,0,0,0,0,0,39000,0,0,0,97000,58000,39000,39000
056682,鴻海統一98購10  ,0,0,0,0,0,0,0,0,0,39000,0,0,0,48000,9000,39000,39000
05571P,大立光統一96售03,0,0,0,0,0,0,0,0,0,39000,0,0,0,39000,0,39000,39000
07326P,大立光元大99售23,0,0,0,0,0,0,0,0,0,39000,0,0,0,54000,15000,39000,39000
6409,旭隼            ,92000,52000,40000,0,0,0,0,0,0,-1000,0,1000,-1000,0,0,0,39000
060454,葡萄王元大9A購01,0,0,0,0,0,0,0,0,0,38000,0,0,0,100000,62000,38000,38000
060899,超眾凱基9A購01  ,0,0,0,0,0,0,0,0,0,38000,0,0,0,38000,0,38000,38000
060565,大立光富邦01購01,0,0,0,0,0,0,0,0,0,38000,0,0,0,63000,25000,38000,38000
061671,台灣50元大9A購21,0,0,0,0,0,0,0,0,0,38000,0,0,0,38000,0,38000,38000
061963,台積電統一01購04,0,0,0,0,0,0,0,0,0,38000,0,0,0,71000,33000,38000,38000
053337,聯電國票97購01  ,0,0,0,0,0,0,0,0,0,38000,0,0,0,38000,0,38000,38000
053887,聯茂兆豐97購02  ,0,0,0,0,0,0,0,0,0,38000,0,0,0,315000,277000,38000,38000
058846,鴻海群益99購03  ,0,0,0,0,0,0,0,0,0,38000,0,0,0,48000,10000,38000,38000
055126,嘉澤兆豐97購01  ,0,0,0,0,0,0,0,0,0,38000,0,0,0,48000,10000,38000,38000
055093,京鼎群益98購01  ,0,0,0,0,0,0,0,0,0,38000,0,0,0,194000,156000,38000,38000
050537,鴻海凱基95購05  ,0,0,0,0,0,0,0,0,0,38000,0,0,0,38000,0,38000,38000
051958,貿聯台新95購01  ,0,0,0,0,0,0,0,0,0,38000,0,0,0,38000,0,38000,38000
053189,聯發科統一96購05,0,0,0,0,0,0,0,0,0,38000,0,0,0,38000,0,38000,38000
053104,台表科元富96購02,0,0,0,0,0,0,0,0,0,38000,0,0,0,38000,0,38000,38000
055662,上銀中信99購01  ,0,0,0,0,0,0,0,0,0,38000,0,0,0,38000,0,38000,38000
058535,玉晶光統一9A購06,0,0,0,0,0,0,0,0,0,38000,0,0,0,76000,38000,38000,38000
056384,玉晶光國泰9A購02,0,0,0,0,0,0,0,0,0,38000,0,0,0,38000,0,38000,38000
056183,南亞科統一97購02,0,0,0,0,0,0,0,0,0,38000,0,0,0,38000,0,38000,38000
056179,康友元富97購02  ,0,0,0,0,0,0,0,0,0,38000,0,0,0,38000,0,38000,38000
055906,大立光兆豐97購03,0,0,0,0,0,0,0,0,0,38000,0,0,0,38000,0,38000,38000
056122,勤誠群益97購02  ,0,0,0,0,0,0,0,0,0,38000,0,0,0,38000,0,38000,38000
9908,大台北          ,51000,13000,38000,0,0,0,0,0,0,0,0,0,0,0,0,0,38000
07330P,台灣50群益9A售08,0,0,0,0,0,0,0,0,0,38000,0,0,0,38000,0,38000,38000
07579P,聯茂元大9A售01  ,0,0,0,0,0,0,0,0,0,38000,0,0,0,226000,188000,38000,38000
2109,華豐            ,82000,44000,38000,0,0,0,0,0,0,0,0,0,0,0,0,0,38000
061817,高鐵群益9B購01  ,0,0,0,0,0,0,0,0,0,37000,0,0,0,37000,0,37000,37000
06682P,玉晶光元大99售08,0,0,0,0,0,0,0,0,0,37000,0,0,0,47000,10000,37000,37000
061438,牧德凱基9B購02  ,0,0,0,0,0,0,0,0,0,37000,0,0,0,147000,110000,37000,37000
061233,國巨元大9A購17  ,0,0,0,0,0,0,0,0,0,37000,0,0,0,50000,13000,37000,37000
060967,鈺齊凱基9A購02  ,0,0,0,0,0,0,0,0,0,37000,0,0,0,168000,131000,37000,37000
059876,智易凱基99購02  ,0,0,0,0,0,0,0,0,0,37000,0,0,0,171000,134000,37000,37000
051928,大立光中信96購03,0,0,0,0,0,0,0,0,0,37000,0,0,0,37000,0,37000,37000
054531,聯發科國泰97購02,0,0,0,0,0,0,0,0,0,37000,0,0,0,77000,40000,37000,37000
051192,緯創兆豐96購01  ,0,0,0,0,0,0,0,0,0,37000,0,0,0,37000,0,37000,37000
055157,晶豪科元大97購01,0,0,0,0,0,0,0,0,0,37000,0,0,0,170000,133000,37000,37000
057054,立積元大98購03  ,0,0,0,0,0,0,0,0,0,37000,0,0,0,37000,0,37000,37000
058396,力山元大99購01  ,0,0,0,0,0,0,0,0,0,37000,0,0,0,50000,13000,37000,37000
055970,聯茂元大97購04  ,0,0,0,0,0,0,0,0,0,37000,0,0,0,50000,13000,37000,37000
057912,美律日盛99購01  ,0,0,0,0,0,0,0,0,0,37000,0,0,0,117000,80000,37000,37000
05943P,欣興凱基96售03  ,0,0,0,0,0,0,0,0,0,37000,0,0,0,37000,0,37000,37000
057651,矽力元大98購03  ,0,0,0,0,0,0,0,0,0,37000,0,0,0,59000,22000,37000,37000
07708P,玉晶光元大9A售13,0,0,0,0,0,0,0,0,0,37000,0,0,0,58000,21000,37000,37000
059955,美食康和99購01  ,0,0,0,0,0,0,0,0,0,36000,0,0,0,77000,41000,36000,36000
060707,台郡富邦9A購01  ,0,0,0,0,0,0,0,0,0,36000,0,0,0,267000,231000,36000,36000
06822P,上銀富邦99售03  ,0,0,0,0,0,0,0,0,0,36000,0,0,0,56000,20000,36000,36000
06339P,上銀統一97售06  ,0,0,0,0,0,0,0,0,0,36000,0,0,0,61000,25000,36000,36000
062087,瑞祺元大9B購02  ,0,0,0,0,0,0,0,0,0,36000,0,0,0,41000,5000,36000,36000
055416,欣興富邦98購01  ,0,0,0,0,0,0,0,0,0,36000,0,0,0,36000,0,36000,36000
050451,嘉晶元大95購01  ,0,0,0,0,0,0,0,0,0,36000,0,0,0,56000,20000,36000,36000
049894,嘉聯益富邦98購01,0,0,0,0,0,0,0,0,0,36000,0,0,0,36000,0,36000,36000
057670,欣興元大99購02  ,0,0,0,0,0,0,0,0,0,36000,0,0,0,68000,32000,36000,36000
055668,欣興群益97購01  ,0,0,0,0,0,0,0,0,0,36000,0,0,0,51000,15000,36000,36000
059194,元金2X永豐99購01,0,0,0,0,0,0,0,0,0,36000,0,0,0,53000,17000,36000,36000
058091,欣興元大99購03  ,0,0,0,0,0,0,0,0,0,36000,0,0,0,62000,26000,36000,36000
058191,祥碩永豐99購01  ,0,0,0,0,0,0,0,0,0,36000,0,0,0,84000,48000,36000,36000
056110,嘉聯益永豐97購02,0,0,0,0,0,0,0,0,0,36000,0,0,0,46000,10000,36000,36000
056995,華新科日盛99購01,0,0,0,0,0,0,0,0,0,36000,0,0,0,50000,14000,36000,36000
07080P,健策群益9A售01  ,0,0,0,0,0,0,0,0,0,36000,0,0,0,36000,0,36000,36000
2414,精技            ,53000,17000,36000,0,0,0,0,0,0,0,0,0,0,0,0,0,36000
1711,永光            ,655000,619000,36000,0,0,0,0,0,0,0,0,0,0,0,0,0,36000
061652,T50反1國票9C購01,0,0,0,0,0,0,0,0,0,35000,0,0,0,35000,0,35000,35000
060762,長榮航元大9A購02,0,0,0,0,0,0,0,0,0,35000,0,0,0,35000,0,35000,35000
060469,台勝科元大9A購02,0,0,0,0,0,0,0,0,0,35000,0,0,0,79000,44000,35000,35000
060236,精元元大9C購01  ,0,0,0,0,0,0,0,0,0,35000,0,0,0,36000,1000,35000,35000
060283,台肥元大9C購01  ,0,0,0,0,0,0,0,0,0,35000,0,0,0,101000,66000,35000,35000
04230P,臺股指中信95售06,0,0,0,0,0,0,0,0,0,35000,0,0,0,35000,0,35000,35000
054437,欣興台新97購02  ,0,0,0,0,0,0,0,0,0,35000,0,0,0,37000,2000,35000,35000
051688,大立光凱基97購02,0,0,0,0,0,0,0,0,0,35000,0,0,0,35000,0,35000,35000
053294,聯發科中信9C購01,0,0,0,0,0,0,0,0,0,35000,0,0,0,55000,20000,35000,35000
052117,鴻海國票96購03  ,0,0,0,0,0,0,0,0,0,35000,0,0,0,40000,5000,35000,35000
051991,泰碩元大95購02  ,0,0,0,0,0,0,0,0,0,35000,0,0,0,35000,0,35000,35000
055159,玉晶光元大98購05,0,0,0,0,0,0,0,0,0,35000,0,0,0,35000,0,35000,35000
054831,緯穎國泰98購01  ,0,0,0,0,0,0,0,0,0,35000,0,0,0,35000,0,35000,35000
053507,百和兆豐96購01  ,0,0,0,0,0,0,0,0,0,35000,0,0,0,35000,0,35000,35000
053458,聯詠國泰97購01  ,0,0,0,0,0,0,0,0,0,35000,0,0,0,51000,16000,35000,35000
056063,大立光元大97購13,0,0,0,0,0,0,0,0,0,35000,0,0,0,35000,0,35000,35000
057239,貿聯凱基98購05  ,0,0,0,0,0,0,0,0,0,35000,0,0,0,40000,5000,35000,35000
057937,神達群益98購02  ,0,0,0,0,0,0,0,0,0,35000,0,0,0,143000,108000,35000,35000
057480,技嘉元大98購03  ,0,0,0,0,0,0,0,0,0,35000,0,0,0,70000,35000,35000,35000
058046,國巨元大9A購01  ,0,0,0,0,0,0,0,0,0,35000,0,0,0,40000,5000,35000,35000
059513,揚明光永豐99購01,0,0,0,0,0,0,0,0,0,35000,0,0,0,35000,0,35000,35000
059767,矽力永豐99購01  ,0,0,0,0,0,0,0,0,0,35000,0,0,0,412000,377000,35000,35000
055679,華通凱基99購01  ,0,0,0,0,0,0,0,0,0,35000,0,0,0,35000,0,35000,35000
056820,欣興永豐98購02  ,0,0,0,0,0,0,0,0,0,35000,0,0,0,38000,3000,35000,35000
056313,聯茂元大98購01  ,0,0,0,0,0,0,0,0,0,35000,0,0,0,35000,0,35000,35000
056507,創意永豐98購02  ,0,0,0,0,0,0,0,0,0,35000,0,0,0,55000,20000,35000,35000
057392,福懋科永豐98購01,0,0,0,0,0,0,0,0,0,35000,0,0,0,103000,68000,35000,35000
07074P,FBVIX凱基9A售01 ,0,0,0,0,0,0,0,0,0,35000,0,0,0,35000,0,35000,35000
07250P,台灣50永豐99售07,0,0,0,0,0,0,0,0,0,35000,0,0,0,35000,0,35000,35000
4720,德淵            ,174000,130000,44000,0,0,0,0,0,0,-9000,10000,19000,-9000,0,0,0,35000
060168,台表科永豐9A購01,0,0,0,0,0,0,0,0,0,34000,0,0,0,73000,39000,34000,34000
060019,彰銀康和99購01  ,0,0,0,0,0,0,0,0,0,34000,0,0,0,44000,10000,34000,34000
061724,訊芯永豐9A購01  ,0,0,0,0,0,0,0,0,0,34000,0,0,0,102000,68000,34000,34000
061769,晶技元大9B購03  ,0,0,0,0,0,0,0,0,0,34000,0,0,0,81000,47000,34000,34000
061555,聯電國票9B購01  ,0,0,0,0,0,0,0,0,0,34000,0,0,0,56000,22000,34000,34000
061822,和潤群益9B購01  ,0,0,0,0,0,0,0,0,0,34000,0,0,0,39000,5000,34000,34000
053352,義隆兆豐96購01  ,0,0,0,0,0,0,0,0,0,34000,0,0,0,54000,20000,34000,34000
054217,台表科國票97購05,0,0,0,0,0,0,0,0,0,34000,0,0,0,54000,20000,34000,34000
053742,創意國票97購01  ,0,0,0,0,0,0,0,0,0,34000,0,0,0,36000,2000,34000,34000
055382,台郡元大99購01  ,0,0,0,0,0,0,0,0,0,34000,0,0,0,34000,0,34000,34000
055442,矽創國票98購02  ,0,0,0,0,0,0,0,0,0,34000,0,0,0,51000,17000,34000,34000
057572,明泰永豐98購01  ,0,0,0,0,0,0,0,0,0,34000,0,0,0,34000,0,34000,34000
059238,台積電凱基99購11,0,0,0,0,0,0,0,0,0,34000,0,0,0,34000,0,34000,34000
058043,鴻海元大98購13  ,0,0,0,0,0,0,0,0,0,34000,0,0,0,34000,0,34000,34000
07170P,臺股指國票99售07,0,0,0,0,0,0,0,0,0,34000,0,0,0,1505000,1471000,34000,34000
061700,瑞昱國票9A購02  ,0,0,0,0,0,0,0,0,0,33000,0,0,0,77000,44000,33000,33000
060163,健策永豐9B購01  ,0,0,0,0,0,0,0,0,0,33000,0,0,0,37000,4000,33000,33000
060462,鴻海元大9A購10  ,0,0,0,0,0,0,0,0,0,33000,0,0,0,79000,46000,33000,33000
061042,致新永豐9A購02  ,0,0,0,0,0,0,0,0,0,33000,0,0,0,156000,123000,33000,33000
053176,矽力群益96購02  ,0,0,0,0,0,0,0,0,0,33000,0,0,0,55000,22000,33000,33000
051777,聯發科群益95購04,0,0,0,0,0,0,0,0,0,33000,0,0,0,33000,0,33000,33000
052975,嘉聯益群益96購01,0,0,0,0,0,0,0,0,0,33000,0,0,0,33000,0,33000,33000
00713,元大台灣高息低波,25000,0,25000,0,0,0,0,0,0,8000,0,0,0,10000,2000,8000,33000
05923P,旺宏元富96售05  ,0,0,0,0,0,0,0,0,0,33000,0,0,0,33000,0,33000,33000
057959,欣興元大98購14  ,0,0,0,0,0,0,0,0,0,33000,0,0,0,75000,42000,33000,33000
057075,嘉聯益永豐98購01,0,0,0,0,0,0,0,0,0,33000,0,0,0,101000,68000,33000,33000
058231,技嘉元大99購02  ,0,0,0,0,0,0,0,0,0,33000,0,0,0,314000,281000,33000,33000
057388,奇鋐永豐98購02  ,0,0,0,0,0,0,0,0,0,33000,0,0,0,70000,37000,33000,33000
056944,鴻海統一98購11  ,0,0,0,0,0,0,0,0,0,33000,0,0,0,38000,5000,33000,33000
056506,晶豪科永豐98購02,0,0,0,0,0,0,0,0,0,33000,0,0,0,63000,30000,33000,33000
056290,正文永豐98購01  ,0,0,0,0,0,0,0,0,0,33000,0,0,0,33000,0,33000,33000
2486,一詮            ,43000,12000,31000,0,0,0,0,0,0,2000,2000,0,2000,0,0,0,33000
910861,神州-DR         ,33000,0,33000,0,0,0,0,0,0,0,0,0,0,0,0,0,33000
060170,世紀鋼永豐9A購01,0,0,0,0,0,0,0,0,0,32000,0,0,0,32000,0,32000,32000
06765P,欣興元大98售11  ,0,0,0,0,0,0,0,0,0,32000,0,0,0,166000,134000,32000,32000
06467P,旺宏統一98售01  ,0,0,0,0,0,0,0,0,0,32000,0,0,0,48000,16000,32000,32000
020008,元大特股高息N   ,0,0,0,0,0,0,0,0,0,32000,0,0,0,49000,17000,32000,32000
00654R,富邦印度反1     ,0,73000,-73000,0,0,0,0,0,0,105000,0,0,0,117000,12000,105000,32000
050660,欣興元大96購02  ,0,0,0,0,0,0,0,0,0,32000,0,0,0,32000,0,32000,32000
046011,欣興元富95購01  ,0,0,0,0,0,0,0,0,0,32000,0,0,0,32000,0,32000,32000
052923,台積電永豐96購02,0,0,0,0,0,0,0,0,0,32000,0,0,0,32000,0,32000,32000
052135,聯發科凱基9B購01,0,0,0,0,0,0,0,0,0,32000,0,0,0,32000,0,32000,32000
054076,義隆第一96購01  ,0,0,0,0,0,0,0,0,0,32000,0,0,0,80000,48000,32000,32000
058507,美律元大9A購01  ,0,0,0,0,0,0,0,0,0,32000,0,0,0,92000,60000,32000,32000
059209,華通元大99購08  ,0,0,0,0,0,0,0,0,0,32000,0,0,0,147000,115000,32000,32000
059743,開發金元富99購01,0,0,0,0,0,0,0,0,0,32000,0,0,0,62000,30000,32000,32000
058006,台郡群益98購04  ,0,0,0,0,0,0,0,0,0,32000,0,0,0,32000,0,32000,32000
058108,台郡台新99購01  ,0,0,0,0,0,0,0,0,0,32000,0,0,0,117000,85000,32000,32000
059421,滬深2X元大99購05,0,0,0,0,0,0,0,0,0,32000,0,0,0,32000,0,32000,32000
3543,州巧            ,39000,7000,32000,0,0,0,0,0,0,0,0,0,0,0,0,0,32000
1315,達新            ,64000,32000,32000,0,0,0,0,0,0,0,0,0,0,0,0,0,32000
1321,大洋            ,36000,4000,32000,0,0,0,0,0,0,0,0,0,0,0,0,0,32000
061528,超眾凱基9A購04  ,0,0,0,0,0,0,0,0,0,31000,0,0,0,31000,0,31000,31000
060093,友達元大03購01  ,0,0,0,0,0,0,0,0,0,31000,0,0,0,212000,181000,31000,31000
061025,創意富邦9B購01  ,0,0,0,0,0,0,0,0,0,31000,0,0,0,105000,74000,31000,31000
060914,健策元大9A購03  ,0,0,0,0,0,0,0,0,0,31000,0,0,0,59000,28000,31000,31000
060709,緯穎富邦9B購01  ,0,0,0,0,0,0,0,0,0,31000,0,0,0,46000,15000,31000,31000
060499,鴻海元大9A購11  ,0,0,0,0,0,0,0,0,0,31000,0,0,0,31000,0,31000,31000
058775,台積電國票9A購02,0,0,0,0,0,0,0,0,0,31000,0,0,0,93000,62000,31000,31000
059007,南電元大99購05  ,0,0,0,0,0,0,0,0,0,31000,0,0,0,31000,0,31000,31000
054455,楠梓電群益98購02,0,0,0,0,0,0,0,0,0,31000,0,0,0,31000,0,31000,31000
059346,新日興凱基99購03,0,0,0,0,0,0,0,0,0,31000,0,0,0,31000,0,31000,31000
057517,矽創元富98購02  ,0,0,0,0,0,0,0,0,0,31000,0,0,0,129000,98000,31000,31000
055964,正文元大97購02  ,0,0,0,0,0,0,0,0,0,31000,0,0,0,31000,0,31000,31000
056849,瀚宇博元富98購01,0,0,0,0,0,0,0,0,0,31000,0,0,0,31000,0,31000,31000
056213,建準國票98購02  ,0,0,0,0,0,0,0,0,0,31000,0,0,0,31000,0,31000,31000
056963,建準永豐98購01  ,0,0,0,0,0,0,0,0,0,31000,0,0,0,80000,49000,31000,31000
057875,京鼎元大98購03  ,0,0,0,0,0,0,0,0,0,31000,0,0,0,100000,69000,31000,31000
07867P,晶技元大9B售01  ,0,0,0,0,0,0,0,0,0,31000,0,0,0,182000,151000,31000,31000
3679,新至陞          ,46000,15000,31000,0,0,0,0,0,0,0,0,0,0,0,0,0,31000
060606,玉晶光凱基9A購05,0,0,0,0,0,0,0,0,0,30000,0,0,0,30000,0,30000,30000
060964,日月光凱基9A購01,0,0,0,0,0,0,0,0,0,30000,0,0,0,254000,224000,30000,30000
061086,FBVIX統一01購01 ,0,0,0,0,0,0,0,0,0,30000,0,0,0,30000,0,30000,30000
059187,國巨富邦9B購02  ,0,0,0,0,0,0,0,0,0,30000,0,0,0,156000,126000,30000,30000
05996P,華新科群益96售03,0,0,0,0,0,0,0,0,0,30000,0,0,0,30000,0,30000,30000
059821,美律凱基99購08  ,0,0,0,0,0,0,0,0,0,30000,0,0,0,30000,0,30000,30000
060172,智原台新9A購01  ,0,0,0,0,0,0,0,0,0,30000,0,0,0,32000,2000,30000,30000
060411,達新永豐9A購01  ,0,0,0,0,0,0,0,0,0,30000,0,0,0,36000,6000,30000,30000
061815,奇力新群益9B購02,0,0,0,0,0,0,0,0,0,30000,0,0,0,30000,0,30000,30000
061198,世紀鋼永豐9A購03,0,0,0,0,0,0,0,0,0,30000,0,0,0,30000,0,30000,30000
06387P,緯穎永豐97售02  ,0,0,0,0,0,0,0,0,0,30000,0,0,0,30000,0,30000,30000
06617P,智邦元大98售03  ,0,0,0,0,0,0,0,0,0,30000,0,0,0,39000,9000,30000,30000
06283P,祥碩永豐97售01  ,0,0,0,0,0,0,0,0,0,30000,0,0,0,30000,0,30000,30000
054490,臻鼎台新96購02  ,0,0,0,0,0,0,0,0,0,30000,0,0,0,30000,0,30000,30000
054550,旺宏凱基98購02  ,0,0,0,0,0,0,0,0,0,30000,0,0,0,70000,40000,30000,30000
052153,GIS富邦96購02   ,0,0,0,0,0,0,0,0,0,30000,0,0,0,30000,0,30000,30000
052852,國巨元富96購02  ,0,0,0,0,0,0,0,0,0,30000,0,0,0,40000,10000,30000,30000
052807,貿聯元大98購01  ,0,0,0,0,0,0,0,0,0,30000,0,0,0,30000,0,30000,30000
052745,欣興元大96購04  ,0,0,0,0,0,0,0,0,0,30000,0,0,0,30000,0,30000,30000
052740,聯發科元大96購07,0,0,0,0,0,0,0,0,0,30000,0,0,0,230000,200000,30000,30000
052511,聯發科凱基95購14,0,0,0,0,0,0,0,0,0,30000,0,0,0,40000,10000,30000,30000
052554,正崴國票97購01  ,0,0,0,0,0,0,0,0,0,30000,0,0,0,30000,0,30000,30000
052530,台郡元大96購04  ,0,0,0,0,0,0,0,0,0,30000,0,0,0,30000,0,30000,30000
052626,上証2X中信9A購01,0,0,0,0,0,0,0,0,0,30000,0,0,0,50000,20000,30000,30000
052629,訊芯中信99購01  ,0,0,0,0,0,0,0,0,0,30000,0,0,0,30000,0,30000,30000
052312,美律富邦96購02  ,0,0,0,0,0,0,0,0,0,30000,0,0,0,60000,30000,30000,30000
046942,友達元大99購01  ,0,0,0,0,0,0,0,0,0,30000,0,0,0,30000,0,30000,30000
050952,健策群益96購01  ,0,0,0,0,0,0,0,0,0,30000,0,0,0,30000,0,30000,30000
049117,矽格統一96購01  ,0,0,0,0,0,0,0,0,0,30000,0,0,0,30000,0,30000,30000
050135,禾伸堂兆豐95購01,0,0,0,0,0,0,0,0,0,30000,0,0,0,30000,0,30000,30000
050307,欣興中信95購01  ,0,0,0,0,0,0,0,0,0,30000,0,0,0,30000,0,30000,30000
03604P,群創凱基98售05  ,0,0,0,0,0,0,0,0,0,30000,0,0,0,86000,56000,30000,30000
058987,華新科凱基9B購01,0,0,0,0,0,0,0,0,0,30000,0,0,0,30000,0,30000,30000
058791,鴻海元大99購17  ,0,0,0,0,0,0,0,0,0,30000,0,0,0,40000,10000,30000,30000
055426,旺宏群益99購02  ,0,0,0,0,0,0,0,0,0,30000,0,0,0,30000,0,30000,30000
055456,上銀富邦99購01  ,0,0,0,0,0,0,0,0,0,30000,0,0,0,30000,0,30000,30000
055477,同欣電凱基98購01,0,0,0,0,0,0,0,0,0,30000,0,0,0,30000,0,30000,30000
055607,華通康和97購01  ,0,0,0,0,0,0,0,0,0,30000,0,0,0,30000,0,30000,30000
055549,旺宏凱基97購03  ,0,0,0,0,0,0,0,0,0,30000,0,0,0,30000,0,30000,30000
055551,致茂凱基98購01  ,0,0,0,0,0,0,0,0,0,30000,0,0,0,30000,0,30000,30000
055098,臺股指群益97購01,0,0,0,0,0,0,0,0,0,30000,0,0,0,30000,0,30000,30000
053640,上緯控永豐96購01,0,499000,-499000,0,0,0,0,0,0,529000,0,0,0,534000,5000,529000,30000
055065,神達永豐97購01  ,0,0,0,0,0,0,0,0,0,30000,0,0,0,30000,0,30000,30000
054082,楠梓電元富96購01,0,0,0,0,0,0,0,0,0,30000,0,0,0,249000,219000,30000,30000
054019,燿華台新96購01  ,0,0,0,0,0,0,0,0,0,30000,0,0,0,30000,0,30000,30000
054279,揚明光群益98購01,0,0,0,0,0,0,0,0,0,30000,0,0,0,80000,50000,30000,30000
054256,創意元大96購07  ,0,0,0,0,0,0,0,0,0,30000,0,0,0,30000,0,30000,30000
053698,中磊元大96購02  ,0,0,0,0,0,0,0,0,0,30000,0,0,0,30000,0,30000,30000
054334,超眾永豐96購04  ,0,0,0,0,0,0,0,0,0,30000,0,0,0,30000,0,30000,30000
053313,世紀鋼凱基96購01,0,0,0,0,0,0,0,0,0,30000,0,0,0,30000,0,30000,30000
054717,亞德客永豐97購01,0,0,0,0,0,0,0,0,0,30000,0,0,0,31000,1000,30000,30000
053411,深中小國票9B購01,0,0,0,0,0,0,0,0,0,30000,0,0,0,30000,0,30000,30000
057863,美律凱基9A購01  ,0,0,0,0,0,0,0,0,0,30000,0,0,0,30000,0,30000,30000
056266,開發金統一9A購01,0,0,0,0,0,0,0,0,0,30000,0,0,0,154000,124000,30000,30000
056910,超眾元大99購02  ,0,0,0,0,0,0,0,0,0,30000,0,0,0,33000,3000,30000,30000
057446,旺宏元富02購01  ,0,0,0,0,0,0,0,0,0,30000,0,0,0,30000,0,30000,30000
056346,聯茂凱基99購02  ,0,0,0,0,0,0,0,0,0,30000,0,0,0,30000,0,30000,30000
056875,亞光凱基98購03  ,0,0,0,0,0,0,0,0,0,30000,0,0,0,30000,0,30000,30000
056544,貿聯凱基98購03  ,0,0,0,0,0,0,0,0,0,30000,0,0,0,30000,0,30000,30000
058661,臺股指中信9C購01,0,0,0,0,0,0,0,0,0,30000,0,0,0,30000,0,30000,30000
057703,矽力群益98購01  ,0,0,0,0,0,0,0,0,0,30000,0,0,0,30000,0,30000,30000
05763P,致新永豐96售01  ,0,0,0,0,0,0,0,0,0,30000,0,0,0,30000,0,30000,30000
058442,玉晶光台新99購01,0,0,0,0,0,0,0,0,0,30000,0,0,0,30000,0,30000,30000
058470,台灣50日盛9B購02,0,0,0,0,0,0,0,0,0,30000,0,0,0,30000,0,30000,30000
055748,GIS元富97購01   ,0,0,0,0,0,0,0,0,0,30000,0,0,0,30000,0,30000,30000
056145,緯穎元大98購03  ,0,0,0,0,0,0,0,0,0,30000,0,0,0,49000,19000,30000,30000
057029,緯穎凱基98購04  ,0,0,0,0,0,0,0,0,0,30000,0,0,0,30000,0,30000,30000
059711,滬深2X元大9C購02,0,0,0,0,0,0,0,0,0,30000,0,0,0,30000,0,30000,30000
059728,聯鈞元大99購01  ,0,0,0,0,0,0,0,0,0,30000,0,0,0,32000,2000,30000,30000
059211,鴻海元大99購27  ,0,0,0,0,0,0,0,0,0,30000,0,0,0,32000,2000,30000,30000
058122,美律國票9A購01  ,0,0,0,0,0,0,0,0,0,30000,0,0,0,30000,0,30000,30000
058018,南亞科凱基99購03,0,0,0,0,0,0,0,0,0,30000,0,0,0,30000,0,30000,30000
057983,緯穎永豐98購03  ,0,0,0,0,0,0,0,0,0,30000,0,0,0,30000,0,30000,30000
2539,櫻花建          ,76000,46000,30000,0,0,0,0,0,0,0,0,0,0,0,0,0,30000
07893P,臺股指國票9B售03,0,0,0,0,0,0,0,0,0,30000,0,0,0,30000,0,30000,30000
07830P,牧德凱基9A售03  ,0,0,0,0,0,0,0,0,0,30000,0,0,0,30000,0,30000,30000
07713P,台郡元大9A售03  ,0,0,0,0,0,0,0,0,0,30000,0,0,0,43000,13000,30000,30000
07578P,高鐵元大9A售02  ,0,0,0,0,0,0,0,0,0,30000,0,0,0,30000,0,30000,30000
07165P,臺股指群益99售16,0,0,0,0,0,0,0,0,0,30000,0,0,0,40000,10000,30000,30000
07288P,台灣50凱基99售06,0,0,0,0,0,0,0,0,0,30000,0,0,0,30000,0,30000,30000
07481P,大立光台新9A售01,0,0,0,0,0,0,0,0,0,30000,0,0,0,30000,0,30000,30000
07410P,鴻海元大99售44  ,0,0,0,0,0,0,0,0,0,30000,0,0,0,80000,50000,30000,30000
061857,康友國票9B購01  ,0,0,0,0,0,0,0,0,0,29000,0,0,0,40000,11000,29000,29000
061896,景碩永豐9B購01  ,0,0,0,0,0,0,0,0,0,29000,0,0,0,239000,210000,29000,29000
060026,聯發科富邦9B購05,0,0,0,0,0,0,0,0,0,29000,0,0,0,29000,0,29000,29000
060051,台積電凱基9B購01,0,0,0,0,0,0,0,0,0,29000,0,0,0,82000,53000,29000,29000
060643,牧德永豐9A購03  ,0,0,0,0,0,0,0,0,0,29000,0,0,0,248000,219000,29000,29000
053721,國泰金凱基97購01,0,0,0,0,0,0,0,0,0,29000,0,0,0,79000,50000,29000,29000
055034,建準富邦99購01  ,0,0,0,0,0,0,0,0,0,29000,0,0,0,30000,1000,29000,29000
053612,T50反1群益96購01,0,0,0,0,0,0,0,0,0,29000,0,0,0,29000,0,29000,29000
059116,晶豪科永豐99購01,0,0,0,0,0,0,0,0,0,29000,0,0,0,110000,81000,29000,29000
052586,晶豪科永豐96購01,0,0,0,0,0,0,0,0,0,29000,0,0,0,64000,35000,29000,29000
059665,嘉聯益元大99購06,0,0,0,0,0,0,0,0,0,29000,0,0,0,29000,0,29000,29000
059693,智原永豐99購01  ,0,0,0,0,0,0,0,0,0,29000,0,0,0,66000,37000,29000,29000
059236,鴻海凱基99購09  ,0,0,0,0,0,0,0,0,0,29000,0,0,0,102000,73000,29000,29000
057010,景碩中信98購01  ,0,0,0,0,0,0,0,0,0,29000,0,0,0,50000,21000,29000,29000
056026,智易群益97購01  ,0,0,0,0,0,0,0,0,0,29000,0,0,0,50000,21000,29000,29000
056170,鴻海元富97購09  ,0,0,0,0,0,0,0,0,0,29000,0,0,0,49000,20000,29000,29000
057547,技嘉凱基99購01  ,0,0,0,0,0,0,0,0,0,29000,0,0,0,100000,71000,29000,29000
057946,晶相光國票99購01,0,0,0,0,0,0,0,0,0,29000,0,0,0,29000,0,29000,29000
055697,牧德國票98購01  ,0,0,0,0,0,0,0,0,0,29000,0,0,0,29000,0,29000,29000
056287,亞光永豐97購02  ,0,0,0,0,0,0,0,0,0,29000,0,0,0,59000,30000,29000,29000
057421,智原凱基98購04  ,0,0,0,0,0,0,0,0,0,29000,0,0,0,29000,0,29000,29000
06962P,華新科永豐99售01,0,0,0,0,0,0,0,0,0,29000,0,0,0,39000,10000,29000,29000
3029,零壹            ,222000,194000,28000,0,0,0,0,0,0,1000,1000,0,1000,0,0,0,29000
060713,聯詠永豐9A購01  ,0,0,0,0,0,0,0,0,0,28000,0,0,0,48000,20000,28000,28000
060760,南亞科元大9A購04,0,0,0,0,0,0,0,0,0,28000,0,0,0,38000,10000,28000,28000
059885,台積電國票99購12,0,0,0,0,0,0,0,0,0,28000,0,0,0,39000,11000,28000,28000
06926P,可成群益9A售04  ,0,0,0,0,0,0,0,0,0,28000,0,0,0,28000,0,28000,28000
061518,達方永豐9A購02  ,0,0,0,0,0,0,0,0,0,28000,0,0,0,30000,2000,28000,28000
053249,致伸國票97購02  ,0,0,0,0,0,0,0,0,0,28000,0,0,0,28000,0,28000,28000
053091,同欣電元大96購01,0,0,0,0,0,0,0,0,0,28000,0,0,0,28000,0,28000,28000
03679C,臺股指元大04牛04,0,0,0,0,0,0,0,0,0,28000,0,0,0,28000,0,28000,28000
00710B,FH彭博高收益債  ,0,0,0,0,0,0,0,0,0,28000,0,0,0,41000,13000,28000,28000
059070,道瓊指元大99購02,0,0,0,0,0,0,0,0,0,28000,0,0,0,30000,2000,28000,28000
053747,滬深2X永豐96購05,0,0,0,0,0,0,0,0,0,28000,0,0,0,28000,0,28000,28000
054035,聯詠麥證96購01  ,0,0,0,28000,0,28000,0,0,0,28000,0,0,0,28000,0,28000,28000
05348P,美律元富98售01  ,0,0,0,0,0,0,0,0,0,28000,0,0,0,28000,0,28000,28000
056907,群創元大9C購04  ,0,0,0,0,0,0,0,0,0,28000,0,0,0,28000,0,28000,28000
055700,緯穎國泰98購02  ,0,0,0,0,0,0,0,0,0,28000,0,0,0,34000,6000,28000,28000
058453,可成永豐99購01  ,0,0,0,0,0,0,0,0,0,28000,0,0,0,38000,10000,28000,28000
056809,旺宏統一98購03  ,0,0,0,0,0,0,0,0,0,28000,0,0,0,28000,0,28000,28000
058629,嘉晶國票9A購01  ,0,0,0,0,0,0,0,0,0,28000,0,0,0,80000,52000,28000,28000
056088,台郡統一97購02  ,0,0,0,0,0,0,0,0,0,28000,0,0,0,76000,48000,28000,28000
2492,華新科          ,1526000,1213000,313000,0,0,0,133000,360000,-227000,-58000,27000,23000,4000,7000,69000,-62000,28000
06983P,台積電國泰9A售02,0,0,0,0,0,0,0,0,0,28000,0,0,0,105000,77000,28000,28000
07159P,台積電永豐99售04,0,0,0,0,0,0,0,0,0,28000,0,0,0,28000,0,28000,28000
6177,達麗            ,45000,17000,28000,0,0,0,0,0,0,0,0,0,0,0,0,0,28000
06155P,智邦統一97售02  ,0,0,0,0,0,0,0,0,0,27000,0,0,0,27000,0,27000,27000
061737,南亞科凱基9B購01,0,0,0,0,0,0,0,0,0,27000,0,0,0,27000,0,27000,27000
061463,智邦群益9A購02  ,0,0,0,0,0,0,0,0,0,27000,0,0,0,101000,74000,27000,27000
06614P,祥碩永豐98售03  ,0,0,0,0,0,0,0,0,0,27000,0,0,0,36000,9000,27000,27000
06428P,國巨元大97售17  ,0,0,0,0,0,0,0,0,0,27000,0,0,0,43000,16000,27000,27000
060323,華通群益9C購01  ,0,0,0,0,0,0,0,0,0,27000,0,0,0,55000,28000,27000,27000
060611,同欣電凱基9A購02,0,0,0,0,0,0,0,0,0,27000,0,0,0,729000,702000,27000,27000
053893,京鼎群益97購02  ,0,0,0,0,0,0,0,0,0,27000,0,0,0,167000,140000,27000,27000
054100,致伸國票97購03  ,0,0,0,0,0,0,0,0,0,27000,0,0,0,27000,0,27000,27000
00663L,國泰臺灣加權正2 ,0,0,0,0,0,0,0,0,0,27000,0,0,0,187000,160000,27000,27000
052895,台積電群益96購04,0,0,0,0,0,0,0,0,0,27000,0,0,0,126000,99000,27000,27000
053194,緯穎統一99購01  ,0,0,0,0,0,0,0,0,0,27000,0,0,0,27000,0,27000,27000
053269,同欣電群益96購01,0,0,0,0,0,0,0,0,0,27000,0,0,0,27000,0,27000,27000
057055,立積元大99購01  ,0,0,0,0,0,0,0,0,0,27000,0,0,0,41000,14000,27000,27000
058378,南電凱基99購01  ,0,0,0,0,0,0,0,0,0,27000,0,0,0,27000,0,27000,27000
055863,緯穎元大97購05  ,0,0,0,0,0,0,0,0,0,27000,0,0,0,27000,0,27000,27000
05920P,力成元大96售04  ,0,0,0,0,0,0,0,0,0,27000,0,0,0,62000,35000,27000,27000
059453,奇力新永豐99購01,0,0,0,0,0,0,0,0,0,27000,0,0,0,27000,0,27000,27000
059696,立積永豐99購03  ,0,0,0,0,0,0,0,0,0,27000,0,0,0,27000,0,27000,27000
058616,台虹元大9A購01  ,0,0,0,0,0,0,0,0,0,27000,0,0,0,125000,98000,27000,27000
058660,樺漢中信9A購01  ,0,0,0,0,0,0,0,0,0,27000,0,0,0,27000,0,27000,27000
055731,美律元富97購01  ,0,0,0,0,0,0,0,0,0,27000,0,0,0,27000,0,27000,27000
057296,智原永豐98購01  ,0,0,0,0,0,0,0,0,0,27000,0,0,0,27000,0,27000,27000
057737,國巨富邦99購02  ,0,0,0,0,0,0,0,0,0,27000,0,0,0,27000,0,27000,27000
056603,嘉聯益國泰9A購01,0,0,0,0,0,0,0,0,0,27000,0,0,0,29000,2000,27000,27000
6573,虹揚-KY         ,27000,0,27000,0,0,0,0,0,0,0,0,0,0,0,0,0,27000
1507,永大            ,43000,16000,27000,0,0,0,0,0,0,0,0,0,0,0,0,0,27000
060400,南電國票9A購03  ,0,0,0,0,0,0,0,0,0,26000,0,0,0,28000,2000,26000,26000
060134,鈺齊群益9A購01  ,0,0,0,0,0,0,0,0,0,26000,0,0,0,35000,9000,26000,26000
06728P,全新元大98售03  ,0,0,0,0,0,0,0,0,0,26000,0,0,0,150000,124000,26000,26000
062052,華通統一01購01  ,0,0,0,0,0,0,0,0,0,26000,0,0,0,78000,52000,26000,26000
061688,華通群益9A購07  ,0,0,0,0,0,0,0,0,0,26000,0,0,0,31000,5000,26000,26000
06163P,聯詠群益97售01  ,0,0,0,0,0,0,0,0,0,26000,0,0,0,120000,94000,26000,26000
053187,國巨統一96購05  ,0,0,0,0,0,0,0,0,0,26000,0,0,0,36000,10000,26000,26000
053115,滬深2X中信97購01,0,0,0,0,0,0,0,0,0,26000,0,0,0,30000,4000,26000,26000
048859,玉晶光群益96購02,0,0,0,0,0,0,0,0,0,26000,0,0,0,49000,23000,26000,26000
058937,仁寶中信99購01  ,0,0,0,0,0,0,0,0,0,26000,0,0,0,43000,17000,26000,26000
053651,台光電凱基98購01,0,0,0,0,0,0,0,0,0,26000,0,0,0,28000,2000,26000,26000
055400,緯穎統一97購01  ,0,0,0,0,0,0,0,0,0,26000,0,0,0,26000,0,26000,26000
056199,美律永豐97購01  ,0,0,0,0,0,0,0,0,0,26000,0,0,0,26000,0,26000,26000
057455,景碩國泰99購01  ,0,0,0,0,0,0,0,0,0,26000,0,0,0,26000,0,26000,26000
058554,瀚宇博永豐99購01,0,0,0,0,0,0,0,0,0,26000,0,0,0,26000,0,26000,26000
056751,和大兆豐98購01  ,0,0,0,0,0,0,0,0,0,26000,0,0,0,26000,0,26000,26000
056755,聯茂兆豐98購01  ,0,0,0,0,0,0,0,0,0,26000,0,0,0,114000,88000,26000,26000
059450,和大永豐99購01  ,0,0,0,0,0,0,0,0,0,26000,0,0,0,26000,0,26000,26000
056186,智原統一97購01  ,0,0,0,0,0,0,0,0,0,26000,0,0,0,26000,0,26000,26000
059142,道瓊指國票9B購02,0,0,0,0,0,0,0,0,0,26000,0,0,0,27000,1000,26000,26000
057119,微星康和98購01  ,0,0,0,0,0,0,0,0,0,26000,0,0,0,26000,0,26000,26000
059307,T50反1元大99購06,0,0,0,0,0,0,0,0,0,26000,0,0,0,138000,112000,26000,26000
059748,聯發科台新99購03,0,0,0,0,0,0,0,0,0,26000,0,0,0,26000,0,26000,26000
055877,奇鋐元富97購01  ,0,0,0,0,0,0,0,0,0,26000,0,0,0,210000,184000,26000,26000
056076,超眾元大97購05  ,0,0,0,0,0,0,0,0,0,26000,0,0,0,26000,0,26000,26000
07731P,臺股指凱基9A售28,0,0,0,0,0,0,0,0,0,26000,0,0,0,199000,173000,26000,26000
07771P,義隆國票9A售01  ,0,0,0,0,0,0,0,0,0,26000,0,0,0,50000,24000,26000,26000
061734,全新中信9B購02  ,0,0,0,0,0,0,0,0,0,25000,0,0,0,134000,109000,25000,25000
061501,嘉澤國票9A購01  ,0,0,0,0,0,0,0,0,0,25000,0,0,0,47000,22000,25000,25000
061534,聯發科統一9C購04,0,0,0,0,0,0,0,0,0,25000,0,0,0,25000,0,25000,25000
061192,奇鋐永豐9A購01  ,0,0,0,0,0,0,0,0,0,25000,0,0,0,126000,101000,25000,25000
061175,台積電凱基9A購19,0,0,0,0,0,0,0,0,0,25000,0,0,0,30000,5000,25000,25000
06307P,聚陽元富97售02  ,0,0,0,0,0,0,0,0,0,25000,0,0,0,44000,19000,25000,25000
060136,T50反1國票9A購01,0,0,0,0,0,0,0,0,0,25000,0,0,0,25000,0,25000,25000
060399,康友國票9A購02  ,0,0,0,0,0,0,0,0,0,25000,0,0,0,25000,0,25000,25000
060339,國巨統一01購01  ,0,0,0,0,0,0,0,0,0,25000,0,0,0,172000,147000,25000,25000
059958,鎧勝康和99購01  ,0,0,0,0,0,0,0,0,0,25000,0,0,0,25000,0,25000,25000
059796,台積電國票99購10,0,0,0,0,0,0,0,0,0,25000,0,0,0,98000,73000,25000,25000
060816,世紀鋼凱基9C購02,0,0,0,0,0,0,0,0,0,25000,0,0,0,103000,78000,25000,25000
055386,致新元大97購02  ,0,0,0,0,0,0,0,0,0,25000,0,0,0,100000,75000,25000,25000
055291,京鼎元大97購02  ,0,0,0,0,0,0,0,0,0,25000,0,0,0,219000,194000,25000,25000
058785,臺股指國票99購04,0,0,0,0,0,0,0,0,0,25000,0,0,0,30000,5000,25000,25000
058759,義隆群益99購01  ,0,0,0,0,0,0,0,0,0,25000,0,0,0,53000,28000,25000,25000
054062,TPK國票96購02   ,0,0,0,0,0,0,0,0,0,25000,0,0,0,235000,210000,25000,25000
054275,華通群益97購03  ,0,0,0,0,0,0,0,0,0,25000,0,0,0,25000,0,25000,25000
053749,揚明光永豐97購01,0,0,0,0,0,0,0,0,0,25000,0,0,0,45000,20000,25000,25000
054865,可成群益97購01  ,0,0,0,0,0,0,0,0,0,25000,0,0,0,25000,0,25000,25000
054861,智邦群益97購01  ,0,0,0,0,0,0,0,0,0,25000,0,0,0,27000,2000,25000,25000
048652,巨大元大96購01  ,0,0,0,0,0,0,0,0,0,25000,0,0,0,30000,5000,25000,25000
047969,台達電富邦97購01,0,0,0,0,0,0,0,0,0,25000,0,0,0,25000,0,25000,25000
03686P,大立光統一98售02,0,0,0,0,0,0,0,0,0,25000,0,0,0,42000,17000,25000,25000
05318P,臺股指永昌95售03,0,0,0,0,0,0,0,0,0,25000,5000,0,5000,20000,0,20000,25000
053244,光磊國票97購01  ,0,0,0,0,0,0,0,0,0,25000,0,0,0,25000,0,25000,25000
052700,奇鋐國票97購02  ,0,0,0,0,0,0,0,0,0,25000,0,0,0,95000,70000,25000,25000
058222,玉晶光統一9B購01,0,0,0,0,0,0,0,0,0,25000,0,0,0,370000,345000,25000,25000
059315,鴻海元大99購30  ,0,0,0,0,0,0,0,0,0,25000,0,0,0,44000,19000,25000,25000
059502,台灣50台新9B購04,0,0,0,0,0,0,0,0,0,25000,0,0,0,25000,0,25000,25000
056176,創意元富97購01  ,0,0,0,0,0,0,0,0,0,25000,0,0,0,25000,0,25000,25000
058086,鴻海元大98購14  ,0,0,0,0,0,0,0,0,0,25000,0,0,0,46000,21000,25000,25000
059123,訊芯永豐99購03  ,0,0,0,0,0,0,0,0,0,25000,0,0,0,193000,168000,25000,25000
056757,T50反1元大98購07,0,0,0,0,0,0,0,0,0,25000,0,0,0,40000,15000,25000,25000
056778,元石油群益9B購01,0,0,0,0,0,0,0,0,0,25000,0,0,0,25000,0,25000,25000
058580,華新科群益99購02,0,0,0,0,0,0,0,0,0,25000,0,0,0,30000,5000,25000,25000
058577,南亞科群益99購02,0,0,0,0,0,0,0,0,0,25000,0,0,0,143000,118000,25000,25000
058699,楠梓電元大99購02,0,0,0,0,0,0,0,0,0,25000,0,0,0,25000,0,25000,25000
058626,瑞昱國票9A購01  ,0,0,0,0,0,0,0,0,0,25000,0,0,0,28000,3000,25000,25000
059102,聯鈞元富99購01  ,0,0,0,0,0,0,0,0,0,25000,0,0,0,45000,20000,25000,25000
055663,崇越中信97購01  ,0,0,0,0,0,0,0,0,0,25000,0,0,0,25000,0,25000,25000
057263,可成兆豐99購01  ,0,0,0,0,0,0,0,0,0,25000,0,0,0,25000,0,25000,25000
057327,玉晶光群益9A購04,0,0,0,0,0,0,0,0,0,25000,0,0,0,45000,20000,25000,25000
056581,超眾元大99購01  ,0,0,0,0,0,0,0,0,0,25000,0,0,0,71000,46000,25000,25000
07760P,力山永豐9A售03  ,0,0,0,0,0,0,0,0,0,25000,0,0,0,41000,16000,25000,25000
06949P,台表科元大99售01,0,0,0,0,0,0,0,0,0,25000,0,0,0,25000,0,25000,25000
07402P,瑞昱凱基99售02  ,0,0,0,0,0,0,0,0,0,25000,0,0,0,25000,0,25000,25000
07489P,國巨國票9A售07  ,0,0,0,0,0,0,0,0,0,25000,0,0,0,25000,0,25000,25000
07391P,台灣50國泰02售01,0,0,0,0,0,0,0,0,0,25000,0,0,0,25000,0,25000,25000
07386P,臺股指群益99售24,0,0,0,0,0,0,0,0,0,25000,0,0,0,35000,10000,25000,25000
2340,光磊            ,285000,246000,39000,0,0,0,0,0,0,-14000,2000,4000,-2000,0,12000,-12000,25000
4566,時碩工業        ,48000,20000,28000,0,0,0,0,0,0,-3000,0,3000,-3000,0,0,0,25000
060862,美律永豐9A購01  ,0,0,0,0,0,0,0,0,0,24000,0,0,0,24000,0,24000,24000
060708,康友富邦9B購01  ,0,0,0,0,0,0,0,0,0,24000,0,0,0,166000,142000,24000,24000
059854,台表科永豐99購03,0,0,0,0,0,0,0,0,0,24000,0,0,0,31000,7000,24000,24000
059996,美律元富99購01  ,0,0,0,0,0,0,0,0,0,24000,0,0,0,60000,36000,24000,24000
060374,儒鴻元富9A購01  ,0,0,0,0,0,0,0,0,0,24000,0,0,0,69000,45000,24000,24000
060199,台郡元富9A購01  ,0,0,0,0,0,0,0,0,0,24000,0,0,0,205000,181000,24000,24000
06376P,上銀統一99售01  ,0,0,0,0,0,0,0,0,0,24000,0,0,0,34000,10000,24000,24000
061378,南六永豐9A購03  ,0,0,0,0,0,0,0,0,0,24000,0,0,0,180000,156000,24000,24000
049463,華新科富邦97購01,0,0,0,0,0,0,0,0,0,24000,0,0,0,26000,2000,24000,24000
044457,滬深2X國票97購01,0,0,0,0,0,0,0,0,0,24000,0,0,0,24000,0,24000,24000
048847,A50群益98購01   ,0,0,0,0,0,0,0,0,0,24000,0,0,0,24000,0,24000,24000
054835,致新中信97購01  ,0,0,0,0,0,0,0,0,0,24000,0,0,0,190000,166000,24000,24000
054215,創意國票97購02  ,0,0,0,0,0,0,0,0,0,24000,0,0,0,24000,0,24000,24000
053998,泰鼎群益98購01  ,0,0,0,0,0,0,0,0,0,24000,0,0,0,24000,0,24000,24000
056315,同欣電元大97購05,0,0,0,0,0,0,0,0,0,24000,0,0,0,24000,0,24000,24000
056310,神達元大97購02  ,0,0,0,0,0,0,0,0,0,24000,0,0,0,30000,6000,24000,24000
056231,嘉聯益凱基97購02,0,0,0,0,0,0,0,0,0,24000,0,0,0,69000,45000,24000,24000
055692,緯穎凱基97購03  ,0,0,0,0,0,0,0,0,0,24000,0,0,0,24000,0,24000,24000
056658,美食元大98購01  ,0,0,0,0,0,0,0,0,0,24000,0,0,0,24000,0,24000,24000
059765,嘉聯益永豐99購02,0,0,0,0,0,0,0,0,0,24000,0,0,0,50000,26000,24000,24000
059685,T50正2永豐99購02,0,0,0,0,0,0,0,0,0,24000,0,0,0,27000,3000,24000,24000
057944,新日興國票99購02,0,0,0,0,0,0,0,0,0,24000,0,0,0,30000,6000,24000,24000
057172,南亞科元大98購03,0,0,0,0,0,0,0,0,0,24000,0,0,0,24000,0,24000,24000
058354,台積電凱基9A購06,0,0,0,0,0,0,0,0,0,24000,0,0,0,24000,0,24000,24000
07094P,華通國票9A售03  ,0,0,0,0,0,0,0,0,0,24000,0,0,0,40000,16000,24000,24000
07647P,健策國票9A售04  ,0,0,0,0,0,0,0,0,0,24000,0,0,0,24000,0,24000,24000
06125P,楠梓電元富99售01,0,0,0,0,0,0,0,0,0,23000,0,0,0,25000,2000,23000,23000
061654,旺宏國票9A購02  ,0,0,0,0,0,0,0,0,0,23000,0,0,0,28000,5000,23000,23000
060187,華新科元富9A購02,0,0,0,0,0,0,0,0,0,23000,0,0,0,43000,20000,23000,23000
060006,華通群益9A購04  ,0,0,0,0,0,0,0,0,0,23000,0,0,0,23000,0,23000,23000
060091,技嘉元大99購03  ,0,0,0,0,0,0,0,0,0,23000,0,0,0,119000,96000,23000,23000
059953,聯發科康和99購01,0,0,0,0,0,0,0,0,0,23000,0,0,0,23000,0,23000,23000
060945,緯穎國票9A購02  ,0,0,0,0,0,0,0,0,0,23000,0,0,0,27000,4000,23000,23000
060900,超眾凱基9B購01  ,0,0,0,0,0,0,0,0,0,23000,0,0,0,23000,0,23000,23000
061107,世芯元大9A購05  ,0,0,0,0,0,0,0,0,0,23000,0,0,0,149000,126000,23000,23000
054970,帆宣元大97購01  ,0,0,0,0,0,0,0,0,0,23000,0,0,0,23000,0,23000,23000
058960,臺股指國票99購05,0,0,0,0,0,0,0,0,0,23000,0,0,0,23000,0,23000,23000
050644,國巨凱基96購01  ,0,0,0,0,0,0,0,0,0,23000,0,0,0,35000,12000,23000,23000
00757,統一FANG+       ,0,0,0,0,0,0,0,0,0,23000,0,0,0,224000,201000,23000,23000
052739,國巨元大96購04  ,0,0,0,0,0,0,0,0,0,23000,0,0,0,23000,0,23000,23000
052238,智易國票96購01  ,0,0,0,0,0,0,0,0,0,23000,0,0,0,100000,77000,23000,23000
053248,智伸科國票97購01,0,0,0,0,0,0,0,0,0,23000,0,0,0,133000,110000,23000,23000
054445,技嘉兆豐96購01  ,0,0,0,0,0,0,0,0,0,23000,0,0,0,32000,9000,23000,23000
051924,聯茂日盛95購01  ,0,0,0,0,0,0,0,0,0,23000,0,0,0,25000,2000,23000,23000
058114,台積電第一01購01,0,0,0,0,0,0,0,0,0,23000,0,0,0,23000,0,23000,23000
058058,大立光元富9B購02,0,0,0,0,0,0,0,0,0,23000,0,0,0,123000,100000,23000,23000
058042,鴻海元大98購12  ,0,0,0,0,0,0,0,0,0,23000,0,0,0,38000,15000,23000,23000
055752,臺股指永昌97購01,0,0,0,0,0,0,0,0,0,23000,0,0,0,23000,0,23000,23000
058617,南電元大99購01  ,0,0,0,0,0,0,0,0,0,23000,0,0,0,23000,0,23000,23000
058611,欣興元大99購06  ,0,0,0,0,0,0,0,0,0,23000,0,0,0,79000,56000,23000,23000
057827,康友元大98購03  ,0,0,0,0,0,0,0,0,0,23000,0,0,0,33000,10000,23000,23000
057472,T50正2元大9B購03,0,0,0,0,0,0,0,0,0,23000,0,0,0,23000,0,23000,23000
057386,聯發科永豐98購04,0,0,0,0,0,0,0,0,0,23000,0,0,0,23000,0,23000,23000
056529,中環凱基98購01  ,0,0,0,0,0,0,0,0,0,23000,0,0,0,23000,0,23000,23000
07717P,臺股指群益9A售06,0,0,0,0,0,0,0,0,0,23000,0,0,0,24000,1000,23000,23000
07850P,健策群益9A售06  ,0,0,0,0,0,0,0,0,0,23000,0,0,0,23000,0,23000,23000
1203,味王            ,27000,4000,23000,0,0,0,0,0,0,0,0,0,0,0,0,0,23000
2233,宇隆            ,73000,80000,-7000,0,0,0,30000,0,30000,0,0,0,0,0,0,0,23000
1806,冠軍            ,33000,10000,23000,0,0,0,0,0,0,0,0,0,0,0,0,0,23000
1718,中纖            ,658000,629000,29000,0,0,0,0,0,0,-6000,0,6000,-6000,0,0,0,23000
3617,碩天            ,35000,12000,23000,0,0,0,0,0,0,0,0,0,0,0,0,0,23000
061075,亞德客兆豐9A購01,0,0,0,0,0,0,0,0,0,22000,0,0,0,22000,0,22000,22000
060202,康友元富9A購01  ,0,0,0,0,0,0,0,0,0,22000,0,0,0,40000,18000,22000,22000
061641,玉晶光元大9A購17,0,0,0,0,0,0,0,0,0,22000,0,0,0,197000,175000,22000,22000
061816,長榮航群益9B購02,0,0,0,0,0,0,0,0,0,22000,0,0,0,22000,0,22000,22000
061803,巨大永豐9B購01  ,0,0,0,0,0,0,0,0,0,22000,0,0,0,22000,0,22000,22000
061370,晶技國泰9C購01  ,0,0,0,0,0,0,0,0,0,22000,0,0,0,64000,42000,22000,22000
06137P,玉晶光永豐97售04,0,0,0,0,0,0,0,0,0,22000,0,0,0,55000,33000,22000,22000
061426,玉晶光元大9A購15,0,0,0,0,0,0,0,0,0,22000,0,0,0,41000,19000,22000,22000
06857P,超眾永豐98售02  ,0,0,0,0,0,0,0,0,0,22000,0,0,0,28000,6000,22000,22000
061939,中租國票9B購01  ,0,0,0,0,0,0,0,0,0,22000,0,0,0,22000,0,22000,22000
053072,國巨台新97購01  ,0,0,0,0,0,0,0,0,0,22000,0,0,0,165000,143000,22000,22000
052587,景碩永豐97購01  ,0,0,0,0,0,0,0,0,0,22000,0,0,0,158000,136000,22000,22000
052476,台光電群益98購01,0,0,0,0,0,0,0,0,0,22000,0,0,0,22000,0,22000,22000
00665L,富邦恒生國企正2 ,50000,0,50000,0,0,0,0,0,0,-28000,0,0,0,32000,60000,-28000,22000
048651,美利達元大96購05,0,0,0,0,0,0,0,0,0,22000,0,0,0,62000,40000,22000,22000
052874,超眾凱基96購01  ,0,0,0,0,0,0,0,0,0,22000,0,0,0,22000,0,22000,22000
059078,FBVIX元大99購06 ,0,0,0,0,0,0,0,0,0,22000,0,0,0,25000,3000,22000,22000
055576,嘉晶統一98購01  ,0,0,0,0,0,0,0,0,0,22000,0,0,0,62000,40000,22000,22000
054057,晶豪科國票97購01,0,0,0,0,0,0,0,0,0,22000,0,0,0,94000,72000,22000,22000
054272,華通中信98購01  ,0,0,0,0,0,0,0,0,0,22000,0,0,0,22000,0,22000,22000
053865,欣興元大97購02  ,0,0,0,0,0,0,0,0,0,22000,0,0,0,36000,14000,22000,22000
055208,京鼎康和97購02  ,0,0,0,0,0,0,0,0,0,22000,0,0,0,22000,0,22000,22000
057260,微星兆豐98購01  ,0,0,0,0,0,0,0,0,0,22000,0,0,0,22000,0,22000,22000
057632,傳奇永豐98購01  ,0,0,0,0,0,0,0,0,0,22000,0,0,0,32000,10000,22000,22000
059511,宏達電永豐99購02,0,0,0,0,0,0,0,0,0,22000,0,0,0,22000,0,22000,22000
058267,奇鋐永豐99購01  ,0,0,0,0,0,0,0,0,0,22000,0,0,0,22000,0,22000,22000
056100,楠梓電永豐97購02,0,0,0,0,0,0,0,0,0,22000,0,0,0,37000,15000,22000,22000
057534,旭富元大98購01  ,0,0,0,0,0,0,0,0,0,22000,0,0,0,22000,0,22000,22000
2443,億麗            ,25000,3000,22000,0,0,0,0,0,0,0,0,0,0,0,0,0,22000
2351,順德            ,76000,54000,22000,0,0,0,0,0,0,0,0,0,0,0,0,0,22000
07161P,臺股指群益99售12,0,0,0,0,0,0,0,0,0,22000,0,0,0,27000,5000,22000,22000
9925,新保            ,34000,12000,22000,0,0,0,0,0,0,0,0,0,0,0,0,0,22000
061594,玉晶光永豐9A購08,0,0,0,0,0,0,0,0,0,21000,0,0,0,26000,5000,21000,21000
060351,滬深2X元富9A購01,0,0,0,0,0,0,0,0,0,21000,0,0,0,50000,29000,21000,21000
060326,群光群益9A購01  ,0,0,0,0,0,0,0,0,0,21000,0,0,0,33000,12000,21000,21000
060435,鈺齊永豐9A購01  ,0,0,0,0,0,0,0,0,0,21000,0,0,0,21000,0,21000,21000
059871,義隆凱基99購03  ,0,0,0,0,0,0,0,0,0,21000,0,0,0,61000,40000,21000,21000
060836,上銀國票9A購03  ,0,0,0,0,0,0,0,0,0,21000,0,0,0,21000,0,21000,21000
060676,京元電元大9A購03,0,0,0,0,0,0,0,0,0,21000,0,0,0,35000,14000,21000,21000
060672,鴻海元大9A購14  ,0,0,0,0,0,0,0,0,0,21000,0,0,0,21000,0,21000,21000
060794,景碩永豐9A購02  ,0,0,0,0,0,0,0,0,0,21000,0,0,0,31000,10000,21000,21000
053477,大立光元大97購03,0,0,0,0,0,0,0,0,0,21000,0,0,0,41000,20000,21000,21000
054015,晶豪科永豐96購03,0,0,0,0,0,0,0,0,0,21000,0,0,0,21000,0,21000,21000
053957,瑞昱永豐96購01  ,0,0,0,0,0,0,0,0,0,21000,0,0,0,71000,50000,21000,21000
055324,TPK國票98購03   ,0,0,0,0,0,0,0,0,0,21000,0,0,0,21000,0,21000,21000
058499,滬深2X元大9C購01,0,0,0,0,0,0,0,0,0,21000,0,0,0,21000,0,21000,21000
00706L,元大S&P日圓正2  ,2000,0,2000,0,0,0,0,0,0,19000,0,0,0,31000,12000,19000,21000
052622,貿聯兆豐97購01  ,0,0,0,0,0,0,0,0,0,21000,0,0,0,22000,1000,21000,21000
051988,台光電元大95購01,0,0,0,0,0,0,0,0,0,21000,0,0,0,21000,0,21000,21000
053250,百和國票97購02  ,0,0,0,0,0,0,0,0,0,21000,0,0,0,21000,0,21000,21000
058290,南電國票9A購01  ,0,0,0,0,0,0,0,0,0,21000,0,0,0,97000,76000,21000,21000
058019,美律凱基99購04  ,0,0,0,0,0,0,0,0,0,21000,0,0,0,30000,9000,21000,21000
059125,台積電第一03購02,0,0,0,0,0,0,0,0,0,21000,0,0,0,21000,0,21000,21000
059143,國巨國票9A購04  ,0,0,0,0,0,0,0,0,0,21000,0,0,0,33000,12000,21000,21000
057592,美律兆豐99購01  ,0,0,0,0,0,0,0,0,0,21000,0,0,0,21000,0,21000,21000
055813,聯發科國票98購04,0,0,0,0,0,0,0,0,0,21000,0,0,0,36000,15000,21000,21000
057876,隆達元大98購01  ,0,0,0,0,0,0,0,0,0,21000,0,0,0,22000,1000,21000,21000
4137,麗豐-KY         ,106000,60000,46000,0,0,0,0,0,0,-25000,0,27000,-27000,5000,3000,2000,21000
1108,幸福            ,23000,2000,21000,0,0,0,0,0,0,0,0,0,0,0,0,0,21000
07806P,健策永豐9A售02  ,0,0,0,0,0,0,0,0,0,21000,0,0,0,21000,0,21000,21000
1506,正道            ,43000,22000,21000,0,0,0,0,0,0,0,0,0,0,0,0,0,21000
3015,全漢            ,81000,60000,21000,0,0,0,0,0,0,0,0,0,0,0,0,0,21000
3059,華晶科          ,121000,100000,21000,0,0,0,0,0,0,0,0,0,0,0,0,0,21000
060772,FBVIX凱基9A購03 ,0,0,0,0,0,0,0,0,0,20000,0,0,0,80000,60000,20000,20000
060472,中租元大9A購02  ,0,0,0,0,0,0,0,0,0,20000,0,0,0,36000,16000,20000,20000
060824,旺宏元大9A購06  ,0,0,0,0,0,0,0,0,0,20000,0,0,0,24000,4000,20000,20000
061090,奇力新統一9C購01,0,0,0,0,0,0,0,0,0,20000,0,0,0,106000,86000,20000,20000
061127,美食永豐9A購01  ,0,0,0,0,0,0,0,0,0,20000,0,0,0,40000,20000,20000,20000
059916,聯發科元大99購33,0,0,0,0,0,0,0,0,0,20000,0,0,0,20000,0,20000,20000
059845,欣興富邦9A購02  ,0,0,0,0,0,0,0,0,0,20000,0,0,0,20000,0,20000,20000
060062,聯發科兆豐99購04,0,0,0,0,0,0,0,0,0,20000,0,0,0,24000,4000,20000,20000
059998,華航元富99購02  ,0,0,0,0,0,0,0,0,0,20000,0,0,0,20000,0,20000,20000
060025,台積電富邦9C購06,0,0,0,0,0,0,0,0,0,20000,0,0,0,21000,1000,20000,20000
060413,東元永豐9A購01  ,0,0,0,0,0,0,0,0,0,20000,0,0,0,20000,0,20000,20000
060382,儒鴻凱基9A購01  ,0,0,0,0,0,0,0,0,0,20000,0,0,0,150000,130000,20000,20000
060371,A50正2元富01購01,0,0,0,0,0,0,0,0,0,20000,0,0,0,20000,0,20000,20000
061525,華新科凱基9A購13,0,0,0,0,0,0,0,0,0,20000,0,0,0,20000,0,20000,20000
061514,泰碩永豐9A購02  ,0,0,0,0,0,0,0,0,0,20000,0,0,0,62000,42000,20000,20000
061304,創意永豐9A購02  ,0,0,0,0,0,0,0,0,0,20000,0,0,0,24000,4000,20000,20000
061282,台積電統一9C購06,0,0,0,0,0,0,0,0,0,20000,0,0,0,20000,0,20000,20000
061205,旺宏元大9A購11  ,0,0,0,0,0,0,0,0,0,20000,0,0,0,25000,5000,20000,20000
061969,大立光統一01購02,0,0,0,0,0,0,0,0,0,20000,0,0,0,70000,50000,20000,20000
061877,貿聯元大9B購01  ,0,0,0,0,0,0,0,0,0,20000,0,0,0,28000,8000,20000,20000
06248P,國巨統一97售07  ,0,0,0,0,0,0,0,0,0,20000,0,0,0,200000,180000,20000,20000
06382P,大毅元富97售02  ,0,0,0,0,0,0,0,0,0,20000,0,0,0,20000,0,20000,20000
06491P,台積電富邦99售02,0,0,0,0,0,0,0,0,0,20000,0,0,0,167000,147000,20000,20000
06573P,台積電永昌99售02,0,0,0,0,0,0,0,0,0,20000,0,0,0,20000,0,20000,20000
053127,貿聯凱基97購01  ,0,0,0,0,0,0,0,0,0,20000,0,0,0,20000,0,20000,20000
054555,欣興凱基98購01  ,0,0,0,0,0,0,0,0,0,20000,0,0,0,20000,0,20000,20000
053283,同欣電元大96購03,0,0,0,0,0,0,0,0,0,20000,0,0,0,20000,0,20000,20000
054617,超眾永豐97購01  ,0,0,0,0,0,0,0,0,0,20000,0,0,0,20000,0,20000,20000
051891,智邦元富95購04  ,0,0,0,0,0,0,0,0,0,20000,0,0,0,20000,0,20000,20000
051897,台光電國泰97購01,0,0,0,0,0,0,0,0,0,20000,0,0,0,20000,0,20000,20000
051758,瑞昱元大95購01  ,0,0,0,0,0,0,0,0,0,20000,0,0,0,20000,0,20000,20000
054403,同欣電永豐96購02,0,0,0,0,0,0,0,0,0,20000,0,0,0,20000,0,20000,20000
054428,禾伸堂富邦98購01,0,0,0,0,0,0,0,0,0,20000,0,0,0,20000,0,20000,20000
052760,盟立群益96購01  ,0,0,0,0,0,0,0,0,0,20000,0,0,0,20000,0,20000,20000
052736,T50反1元大96購05,0,0,0,0,0,0,0,0,0,20000,0,0,0,20000,0,20000,20000
052049,緯創凱基97購01  ,0,0,0,0,0,0,0,0,0,20000,0,0,0,46000,26000,20000,20000
051537,牧德國票96購01  ,0,0,0,0,0,0,0,0,0,20000,0,0,0,40000,20000,20000,20000
051552,牧德永豐95購03  ,0,0,0,0,0,0,0,0,0,20000,0,0,0,20000,0,20000,20000
051582,聯發科元大97購02,0,0,0,0,0,0,0,0,0,20000,0,0,0,30000,10000,20000,20000
051562,玉晶光國泰97購05,0,0,0,0,0,0,0,0,0,20000,0,0,0,20000,0,20000,20000
052642,滬深2X永豐96購03,0,0,0,0,0,0,0,0,0,20000,0,0,0,20000,0,20000,20000
052644,聯發科永豐96購01,0,0,0,0,0,0,0,0,0,20000,0,0,0,20000,0,20000,20000
052691,GIS元大96購01   ,0,0,0,0,0,0,0,0,0,20000,0,0,0,186000,166000,20000,20000
052568,漢唐凱基96購02  ,0,0,0,0,0,0,0,0,0,20000,0,0,0,20000,0,20000,20000
052242,台達電台新96購01,0,0,0,0,0,0,0,0,0,20000,0,0,0,20000,0,20000,20000
052188,欣興群益95購03  ,0,0,0,0,0,0,0,0,0,20000,0,0,0,20000,0,20000,20000
05237P,為升永豐95售01  ,0,0,0,0,0,0,0,0,0,20000,0,0,0,20000,0,20000,20000
049799,旺宏元大96購01  ,0,0,0,0,0,0,0,0,0,20000,0,0,0,20000,0,20000,20000
052878,台虹凱基96購01  ,0,0,0,0,0,0,0,0,0,20000,0,0,0,20000,0,20000,20000
052916,華新科富邦96購01,0,0,0,0,0,0,0,0,0,20000,0,0,0,20000,0,20000,20000
052943,奇力新國票96購02,0,0,0,0,0,0,0,0,0,20000,0,0,0,20000,0,20000,20000
048653,巨大元大96購02  ,0,0,0,0,0,0,0,0,0,20000,0,0,0,20000,0,20000,20000
048414,滬深2X統一98購01,0,0,0,0,0,0,0,0,0,20000,0,0,0,20000,0,20000,20000
048696,台達電國票96購01,0,0,0,0,0,0,0,0,0,20000,0,0,0,20000,0,20000,20000
048860,玉晶光群益96購03,0,0,0,0,0,0,0,0,0,20000,0,0,0,20000,0,20000,20000
048890,傳奇元富97購01  ,0,0,0,0,0,0,0,0,0,20000,0,0,0,20000,0,20000,20000
044963,台積電中信96購01,0,0,0,0,0,0,0,0,0,20000,0,0,0,20000,0,20000,20000
048248,聯發科兆豐95購01,0,0,0,0,0,0,0,0,0,20000,0,0,0,20000,0,20000,20000
047903,滬深2X元大96購01,0,0,0,0,0,0,0,0,0,20000,0,0,0,20000,0,20000,20000
05060P,台達電富邦97售02,0,0,0,0,0,0,0,0,0,20000,0,0,0,20000,0,20000,20000
053024,國巨富邦97購02  ,0,0,0,0,0,0,0,0,0,20000,0,0,0,20000,0,20000,20000
053035,台表科兆豐97購01,0,0,0,0,0,0,0,0,0,20000,0,0,0,40000,20000,20000,20000
051172,鴻海第一96購01  ,0,0,0,0,0,0,0,0,0,20000,0,0,0,20000,0,20000,20000
059092,聯陽元大99購01  ,0,0,0,0,0,0,0,0,0,20000,0,0,0,20000,0,20000,20000
059119,華擎永豐99購02  ,0,0,0,0,0,0,0,0,0,20000,0,0,0,40000,20000,20000,20000
059090,台新金元大99購01,0,0,0,0,0,0,0,0,0,20000,0,0,0,20000,0,20000,20000
05875P,旺宏群益98售01  ,0,0,0,0,0,0,0,0,0,20000,0,0,0,20000,0,20000,20000
058773,和碩兆豐99購01  ,0,0,0,0,0,0,0,0,0,20000,0,0,0,50000,30000,20000,20000
058847,國巨群益99購05  ,0,0,0,0,0,0,0,0,0,20000,0,0,0,147000,127000,20000,20000
058853,日月光群益99購01,0,0,0,0,0,0,0,0,0,20000,0,0,0,20000,0,20000,20000
055306,燿華群益97購01  ,0,0,0,0,0,0,0,0,0,20000,0,0,0,20000,0,20000,20000
055268,和大元大97購01  ,0,0,0,0,0,0,0,0,0,20000,0,0,0,35000,15000,20000,20000
053562,玉晶光國泰98購02,0,0,0,0,0,0,0,0,0,20000,0,0,0,21000,1000,20000,20000
053580,國巨元大96購10  ,0,0,0,0,0,0,0,0,0,20000,0,0,0,20000,0,20000,20000
055110,美律凱基98購02  ,0,0,0,0,0,0,0,0,0,20000,0,0,0,20000,0,20000,20000
055114,新日興凱基98購01,0,0,0,0,0,0,0,0,0,20000,0,0,0,20000,0,20000,20000
055575,華新科統一98購01,0,0,0,0,0,0,0,0,0,20000,0,0,0,20000,0,20000,20000
053970,聯發科元大97購08,0,0,0,0,0,0,0,0,0,20000,0,0,0,20000,0,20000,20000
053963,百和永豐96購01  ,0,0,0,0,0,0,0,0,0,20000,0,0,0,20000,0,20000,20000
054162,光罩凱基98購01  ,0,0,0,0,0,0,0,0,0,20000,0,0,0,20000,0,20000,20000
054338,全新統一96購01  ,0,0,0,0,0,0,0,0,0,20000,0,0,0,20000,0,20000,20000
053755,亞光元富96購01  ,0,0,0,0,0,0,0,0,0,20000,0,0,0,20000,0,20000,20000
053850,嘉澤元富96購03  ,0,0,0,0,0,0,0,0,0,20000,0,0,0,20000,0,20000,20000
055023,億光國泰98購01  ,0,0,0,0,0,0,0,0,0,20000,0,0,0,20000,0,20000,20000
053707,A50正2凱基99購02,0,0,0,0,0,0,0,0,0,20000,0,0,0,20000,0,20000,20000
053482,矽力元大96購03  ,0,0,0,0,0,0,0,0,0,20000,0,0,0,20000,0,20000,20000
055222,臺股指凱基97購05,0,0,0,0,0,0,0,0,0,20000,0,0,0,20000,0,20000,20000
057828,緯穎元大99購02  ,0,0,0,0,0,0,0,0,0,20000,0,0,0,20000,0,20000,20000
056972,祥碩永豐98購02  ,0,0,0,0,0,0,0,0,0,20000,0,0,0,20000,0,20000,20000
056977,國巨群益9A購01  ,0,0,0,0,0,0,0,0,0,20000,0,0,0,20000,0,20000,20000
056275,國巨國泰98購04  ,0,0,0,0,0,0,0,0,0,20000,0,0,0,20000,0,20000,20000
057418,台光電凱基98購04,0,0,0,0,0,0,0,0,0,20000,0,0,0,20000,0,20000,20000
057391,樺漢永豐98購01  ,0,0,0,0,0,0,0,0,0,20000,0,0,0,20000,0,20000,20000
057268,臻鼎兆豐99購01  ,0,0,0,0,0,0,0,0,0,20000,0,0,0,30000,10000,20000,20000
056551,台郡凱基98購04  ,0,0,0,0,0,0,0,0,0,20000,0,0,0,20000,0,20000,20000
056206,泰鼎永豐97購01  ,0,0,0,0,0,0,0,0,0,20000,0,0,0,20000,0,20000,20000
056484,聯茂元大98購02  ,0,0,0,0,0,0,0,0,0,20000,0,0,0,42000,22000,20000,20000
056295,國巨元大97購16  ,0,0,0,0,0,0,0,0,0,20000,0,0,0,61000,41000,20000,20000
056392,玉晶光富邦9C購01,0,0,0,0,0,0,0,0,0,20000,0,0,0,20000,0,20000,20000
056376,玉晶光統一98購01,0,0,0,0,0,0,0,0,0,20000,0,0,0,20000,0,20000,20000
056885,元油2X元大99購03,0,0,0,0,0,0,0,0,0,20000,0,0,0,20000,0,20000,20000
055858,聯茂元大97購03  ,0,0,0,0,0,0,0,0,0,20000,0,0,0,160000,140000,20000,20000
055736,宏達電元富99購01,0,0,0,0,0,0,0,0,0,20000,0,0,0,20000,0,20000,20000
056621,宏達電永豐98購01,0,0,0,0,0,0,0,0,0,20000,0,0,0,20000,0,20000,20000
057618,台光電凱基99購01,0,0,0,0,0,0,0,0,0,20000,0,0,0,20000,0,20000,20000
058480,新日興凱基9A購01,0,0,0,0,0,0,0,0,0,20000,0,0,0,66000,46000,20000,20000
058637,晶技兆豐99購01  ,0,0,0,0,0,0,0,0,0,20000,0,0,0,31000,11000,20000,20000
056817,國巨永豐98購04  ,0,0,0,0,0,0,0,0,0,20000,0,0,0,20000,0,20000,20000
056804,T50反1統一9A購03,0,0,0,0,0,0,0,0,0,20000,0,0,0,20000,0,20000,20000
056828,國巨富邦9A購03  ,0,0,0,0,0,0,0,0,0,20000,0,0,0,20000,0,20000,20000
056718,GIS永豐98購01   ,0,0,0,0,0,0,0,0,0,20000,0,0,0,20000,0,20000,20000
056722,滬深反中信9B購01,0,0,0,0,0,0,0,0,0,20000,0,0,0,20000,0,20000,20000
059133,臺股指群益99購08,0,0,0,0,0,0,0,0,0,20000,0,0,0,23000,3000,20000,20000
058121,國巨國票9A購01  ,0,0,0,0,0,0,0,0,0,20000,0,0,0,20000,0,20000,20000
056184,南亞科統一97購03,0,0,0,0,0,0,0,0,0,20000,0,0,0,20000,0,20000,20000
057140,宏達電兆豐98購01,0,0,0,0,0,0,0,0,0,20000,0,0,0,20000,0,20000,20000
059284,緯穎永豐99購03  ,0,0,0,0,0,0,0,0,0,20000,0,0,0,66000,46000,20000,20000
059262,致茂中信01購01  ,0,0,0,0,0,0,0,0,0,20000,0,0,0,20000,0,20000,20000
059623,聯電凱基99購02  ,0,0,0,0,0,0,0,0,0,20000,0,0,0,40000,20000,20000,20000
058221,上銀統一99購04  ,0,0,0,0,0,0,0,0,0,20000,0,0,0,20000,0,20000,20000
058338,康友元富99購01  ,0,0,0,0,0,0,0,0,0,20000,0,0,0,30000,10000,20000,20000
057062,立積國泰99購01  ,0,0,0,0,0,0,0,0,0,20000,0,0,0,20000,0,20000,20000
057064,華新科富邦9B購01,0,0,0,0,0,0,0,0,0,20000,0,0,0,20000,0,20000,20000
056168,鴻海元富97購07  ,0,0,0,0,0,0,0,0,0,20000,0,0,0,40000,20000,20000,20000
057023,美律凱基99購02  ,0,0,0,0,0,0,0,0,0,20000,0,0,0,20000,0,20000,20000
057161,亞德客元大98購02,0,0,0,0,0,0,0,0,0,20000,0,0,0,31000,11000,20000,20000
3702A,大聯大甲特      ,2000,0,2000,0,0,0,0,0,0,18000,0,0,0,18000,0,18000,20000
2465,麗臺            ,29000,9000,20000,0,0,0,0,0,0,0,0,0,0,0,0,0,20000
1445,大宇            ,22000,2000,20000,0,0,0,0,0,0,0,0,0,0,0,0,0,20000
07744P,奇力新凱基9A售05,0,0,0,0,0,0,0,0,0,20000,0,0,0,20000,0,20000,20000
07569P,國巨凱基9A售13  ,0,0,0,0,0,0,0,0,0,20000,0,0,0,20000,0,20000,20000
07524P,臺股指中信9B售06,0,0,0,0,0,0,0,0,0,20000,0,0,0,20000,0,20000,20000
07084P,S&P正2元富9B售02,0,0,0,0,0,0,0,0,0,20000,0,0,0,20000,0,20000,20000
07409P,台積電台新99售07,0,0,0,0,0,0,0,0,0,20000,0,0,0,20000,0,20000,20000
07463P,台積電國票9A售05,0,0,0,0,0,0,0,0,0,20000,0,0,0,20000,0,20000,20000
060393,泰鼎群益9A購01  ,0,0,0,0,0,0,0,0,0,19000,0,0,0,19000,0,19000,19000
061119,國巨永豐9A購03  ,0,0,0,0,0,0,0,0,0,19000,0,0,0,64000,45000,19000,19000
060744,鴻海國票9A購04  ,0,0,0,0,0,0,0,0,0,19000,0,0,0,63000,44000,19000,19000
055007,晶相光元富9A購02,0,0,0,0,0,0,0,0,0,19000,0,0,0,29000,10000,19000,19000
053027,玉晶光富邦98購01,0,0,0,0,0,0,0,0,0,19000,0,0,0,253000,234000,19000,19000
047004,台積電統一99購01,0,0,0,0,0,0,0,0,0,19000,0,0,0,19000,0,19000,19000
046881,智原富邦99購01  ,0,0,0,0,0,0,0,0,0,19000,0,0,0,100000,81000,19000,19000
049892,國巨富邦96購01  ,0,0,0,0,0,0,0,0,0,19000,0,0,0,51000,32000,19000,19000
04916P,大立光永昌96售02,0,0,0,0,0,0,0,0,0,19000,0,0,0,27000,8000,19000,19000
00651R,FH香港反1       ,0,7000,-7000,0,0,0,0,0,0,26000,0,0,0,351000,325000,26000,19000
052308,大立光國泰97購02,0,0,0,0,0,0,0,0,0,19000,0,0,0,29000,10000,19000,19000
052590,祥碩永豐96購01  ,0,0,0,0,0,0,0,0,0,19000,0,0,0,182000,163000,19000,19000
054463,瑞昱凱基97購01  ,0,0,0,0,0,0,0,0,0,19000,0,0,0,19000,0,19000,19000
051788,奇力新國票97購02,0,0,0,0,0,0,0,0,0,19000,0,0,0,19000,0,19000,19000
057093,臻鼎元富98購02  ,0,0,0,0,0,0,0,0,0,19000,0,0,0,19000,0,19000,19000
057724,亞德客國泰99購01,0,0,0,0,0,0,0,0,0,19000,0,0,0,25000,6000,19000,19000
056694,欣興群益98購04  ,0,0,0,0,0,0,0,0,0,19000,0,0,0,92000,73000,19000,19000
056614,智邦永豐98購01  ,0,0,0,0,0,0,0,0,0,19000,0,0,0,21000,2000,19000,19000
07316P,長榮航康和99售01,0,0,0,0,0,0,0,0,0,19000,0,0,0,20000,1000,19000,19000
07053P,台灣50兆豐01售01,0,0,0,0,0,0,0,0,0,19000,0,0,0,19000,0,19000,19000
1615,大山            ,36000,16000,20000,0,0,0,0,0,0,-1000,0,1000,-1000,0,0,0,19000
2466,冠西電          ,20000,1000,19000,0,0,0,0,0,0,0,0,0,0,0,0,0,19000
4906,正文            ,799000,907000,-108000,0,0,0,0,0,0,127000,0,19000,-19000,182000,36000,146000,19000
9940,信義            ,88000,69000,19000,0,0,0,0,0,0,0,0,0,0,0,0,0,19000
8454,富邦媒          ,175695,280620,-104925,0,0,0,109000,0,109000,14000,15000,1000,14000,0,0,0,18075
060986,聯發科元大9A購07,0,0,0,0,0,0,0,0,0,18000,0,0,0,46000,28000,18000,18000
060329,鎧勝群益9B購01  ,0,0,0,0,0,0,0,0,0,18000,0,0,0,27000,9000,18000,18000
060071,國巨元富99購03  ,0,0,0,0,0,0,0,0,0,18000,0,0,0,18000,0,18000,18000
06736P,新日興凱基98售03,0,0,0,0,0,0,0,0,0,18000,0,0,0,18000,0,18000,18000
06214P,國巨國票98售04  ,0,0,0,0,0,0,0,0,0,18000,0,0,0,19000,1000,18000,18000
061194,聯鈞永豐9A購02  ,0,0,0,0,0,0,0,0,0,18000,0,0,0,18000,0,18000,18000
061232,和大元大9A購03  ,0,0,0,0,0,0,0,0,0,18000,0,0,0,18000,0,18000,18000
061456,玉晶光凱基9B購05,0,0,0,0,0,0,0,0,0,18000,0,0,0,50000,32000,18000,18000
061574,大毅元大9B購01  ,0,0,0,0,0,0,0,0,0,18000,0,0,0,18000,0,18000,18000
061569,旺宏元大9A購14  ,0,0,0,0,0,0,0,0,0,18000,0,0,0,18000,0,18000,18000
061800,泰鼎永豐9B購01  ,0,0,0,0,0,0,0,0,0,18000,0,0,0,19000,1000,18000,18000
051650,矽力永豐95購01  ,0,0,0,0,0,0,0,0,0,18000,0,0,0,18000,0,18000,18000
053123,京元電凱基96購01,0,0,0,0,0,0,0,0,0,18000,0,0,0,67000,49000,18000,18000
052387,台積電群益95購08,0,0,0,0,0,0,0,0,0,18000,0,0,0,18000,0,18000,18000
00690,兆豐藍籌30      ,0,0,0,0,0,0,0,0,0,18000,0,0,0,213000,195000,18000,18000
03875P,滬深2X國票05售01,0,0,0,0,0,0,0,0,0,18000,0,0,0,18000,0,18000,18000
050915,健策中信98購01  ,0,0,0,0,0,0,0,0,0,18000,0,0,0,175000,157000,18000,18000
054881,光罩統一97購01  ,0,0,0,0,0,0,0,0,0,18000,0,0,0,18000,0,18000,18000
059083,華通元大99購07  ,0,0,0,0,0,0,0,0,0,18000,0,0,0,137000,119000,18000,18000
056639,國產康和98購01  ,0,0,0,0,0,0,0,0,0,18000,0,0,0,28000,10000,18000,18000
057589,超眾國票9A購01  ,0,0,0,0,0,0,0,0,0,18000,0,0,0,18000,0,18000,18000
058467,日月光中信9A購01,0,0,0,0,0,0,0,0,0,18000,0,0,0,18000,0,18000,18000
058603,台積電元大99購12,0,0,0,0,0,0,0,0,0,18000,0,0,0,18000,0,18000,18000
056586,光罩統一98購02  ,0,0,0,0,0,0,0,0,0,18000,0,0,0,892000,874000,18000,18000
056536,義隆凱基98購04  ,0,0,0,0,0,0,0,0,0,18000,0,0,0,65000,47000,18000,18000
056554,GIS凱基99購01   ,0,0,0,0,0,0,0,0,0,18000,0,0,0,18000,0,18000,18000
056897,南亞科元大98購02,0,0,0,0,0,0,0,0,0,18000,0,0,0,18000,0,18000,18000
058044,鴻海元大99購07  ,0,0,0,0,0,0,0,0,0,18000,0,0,0,18000,0,18000,18000
058033,景碩永豐98購02  ,0,0,0,0,0,0,0,0,0,18000,0,0,0,38000,20000,18000,18000
058061,貿聯元富9B購01  ,0,0,0,0,0,0,0,0,0,18000,0,0,0,50000,32000,18000,18000
059120,致伸永豐99購01  ,0,0,0,0,0,0,0,0,0,18000,0,0,0,18000,0,18000,18000
059205,元石油元大99購01,0,0,0,0,0,0,0,0,0,18000,0,0,0,100000,82000,18000,18000
059461,鈺齊永豐99購03  ,0,0,0,0,0,0,0,0,0,18000,0,0,0,18000,0,18000,18000
057556,智易凱基99購01  ,0,0,0,0,0,0,0,0,0,18000,0,0,0,293000,275000,18000,18000
2903,遠百            ,386000,395000,-9000,0,0,0,0,0,0,27000,27000,0,27000,0,0,0,18000
061881,緯穎元大9B購02  ,0,0,0,0,0,0,0,0,0,17000,0,0,0,29000,12000,17000,17000
06937P,GIS元大98售03   ,0,0,0,0,0,0,0,0,0,17000,0,0,0,85000,68000,17000,17000
06941P,國巨統一98售07  ,0,0,0,0,0,0,0,0,0,17000,0,0,0,23000,6000,17000,17000
06625P,華新科統一98售03,0,0,0,0,0,0,0,0,0,17000,0,0,0,27000,10000,17000,17000
059790,立積元大9C購02  ,0,0,0,0,0,0,0,0,0,17000,0,0,0,17000,0,17000,17000
060457,中橡元大9A購02  ,0,0,0,0,0,0,0,0,0,17000,0,0,0,67000,50000,17000,17000
060679,聯詠元大9A購04  ,0,0,0,0,0,0,0,0,0,17000,0,0,0,45000,28000,17000,17000
060521,鴻海中信01購03  ,0,0,0,0,0,0,0,0,0,17000,0,0,0,20000,3000,17000,17000
059054,國巨凱基99購11  ,0,0,0,0,0,0,0,0,0,17000,0,0,0,140000,123000,17000,17000
055063,玉晶光永豐99購01,0,0,0,0,0,0,0,0,0,17000,0,0,0,17000,0,17000,17000
053054,禾伸堂國票97購01,0,0,0,0,0,0,0,0,0,17000,0,0,0,17000,0,17000,17000
03810P,大立光富邦98售01,0,0,0,0,0,0,0,0,0,17000,0,0,0,37000,20000,17000,17000
058189,嘉澤永豐99購01  ,0,0,0,0,0,0,0,0,0,17000,0,0,0,29000,12000,17000,17000
056987,南茂群益98購01  ,0,0,0,0,0,0,0,0,0,17000,0,0,0,57000,40000,17000,17000
057056,立積元大99購02  ,0,0,0,0,0,0,0,0,0,17000,0,0,0,17000,0,17000,17000
058654,鴻海中信03購01  ,0,0,0,0,0,0,0,0,0,17000,0,0,0,22000,5000,17000,17000
059144,嘉晶國票9A購02  ,0,0,0,0,0,0,0,0,0,17000,0,0,0,44000,27000,17000,17000
059672,滬深2X元富99購06,0,0,0,0,0,0,0,0,0,17000,0,0,0,27000,10000,17000,17000
05743P,創意元大96售01  ,0,0,0,0,0,0,0,0,0,17000,0,0,0,17000,0,17000,17000
056662,臺股指元大9A購09,0,0,0,0,0,0,0,0,0,17000,0,0,0,17000,0,17000,17000
2207,和泰車          ,231000,202000,29000,0,0,0,1000,5000,-4000,-8000,0,7000,-7000,0,1000,-1000,17000
2017,官田鋼          ,22000,5000,17000,0,0,0,0,0,0,0,0,0,0,0,0,0,17000
06946P,T50正2元大9C售01,0,0,0,0,0,0,0,0,0,17000,0,0,0,39000,22000,17000,17000
07653P,華新科群益9A售05,0,0,0,0,0,0,0,0,0,17000,0,0,0,27000,10000,17000,17000
8374,羅昇            ,31000,14000,17000,0,0,0,0,0,0,0,0,0,0,0,0,0,17000
061004,友達兆豐9A購01  ,0,0,0,0,0,0,0,0,0,16000,0,0,0,16000,0,16000,16000
060839,聯發科國票9A購02,0,0,0,0,0,0,0,0,0,16000,0,0,0,16000,0,16000,16000
060878,奇力新中信9C購01,0,0,0,0,0,0,0,0,0,16000,0,0,0,110000,94000,16000,16000
060209,喬山康和9A購01  ,0,0,0,0,0,0,0,0,0,16000,0,0,0,16000,0,16000,16000
060218,台積電凱基9A購15,0,0,0,0,0,0,0,0,0,16000,0,0,0,110000,94000,16000,16000
060310,瑞昱永豐9A購01  ,0,0,0,0,0,0,0,0,0,16000,0,0,0,200000,184000,16000,16000
059938,凱美永豐99購01  ,0,0,0,0,0,0,0,0,0,16000,0,0,0,26000,10000,16000,16000
060060,台積電兆豐99購05,0,0,0,0,0,0,0,0,0,16000,0,0,0,60000,44000,16000,16000
059181,世紀鋼元富9C購01,0,0,0,0,0,0,0,0,0,16000,0,0,0,244000,228000,16000,16000
060014,中鋼康和99購01  ,0,0,0,0,0,0,0,0,0,16000,0,0,0,20000,4000,16000,16000
06886P,旺宏元大99售07  ,0,0,0,0,0,0,0,0,0,16000,0,0,0,30000,14000,16000,16000
061723,嘉聯益永豐9A購03,0,0,0,0,0,0,0,0,0,16000,0,0,0,16000,0,16000,16000
061628,緯穎群益9A購04  ,0,0,0,0,0,0,0,0,0,16000,0,0,0,115000,99000,16000,16000
03414B,臺股指凱基99熊01,20000,20000,0,0,0,0,0,0,0,16000,0,0,0,504000,488000,16000,16000
050902,南電元大96購01  ,0,0,0,0,0,0,0,0,0,16000,0,0,0,44000,28000,16000,16000
053066,欣興群益96購02  ,0,0,0,0,0,0,0,0,0,16000,0,0,0,83000,67000,16000,16000
054846,瑞昱兆豐97購01  ,0,0,0,0,0,0,0,0,0,16000,0,0,0,36000,20000,16000,16000
053487,台泥兆豐97購01  ,0,0,0,0,0,0,0,0,0,16000,0,0,0,38000,22000,16000,16000
053741,漢唐國票97購03  ,0,0,0,0,0,0,0,0,0,16000,0,0,0,16000,0,16000,16000
055261,帆宣統一98購01  ,0,0,0,0,0,0,0,0,0,16000,0,0,0,16000,0,16000,16000
055713,國巨元大98購09  ,0,0,0,0,0,0,0,0,0,16000,0,0,0,27000,11000,16000,16000
058451,智邦永豐9A購01  ,0,0,0,0,0,0,0,0,0,16000,0,0,0,16000,0,16000,16000
059014,SGBR2X元富03購01,0,0,0,0,0,0,0,0,0,16000,0,0,0,31000,15000,16000,16000
056485,同欣電元大98購01,0,0,0,0,0,0,0,0,0,16000,0,0,0,16000,0,16000,16000
057795,鴻海兆豐99購02  ,0,0,0,0,0,0,0,0,0,16000,0,0,0,21000,5000,16000,16000
056326,TPK兆豐98購01   ,0,0,0,0,0,0,0,0,0,16000,0,0,0,16000,0,16000,16000
059704,聯發科凱基9A購08,0,0,0,0,0,0,0,0,0,16000,0,0,0,16000,0,16000,16000
059319,台光電元大99購04,0,0,0,0,0,0,0,0,0,16000,0,0,0,28000,12000,16000,16000
059458,鎧勝永豐99購01  ,0,0,0,0,0,0,0,0,0,16000,0,0,0,16000,0,16000,16000
059424,SGBR2X元大9A購01,0,0,0,0,0,0,0,0,0,16000,0,0,0,714000,698000,16000,16000
07574P,國巨元大9A售12  ,0,0,0,0,0,0,0,0,0,16000,0,0,0,19000,3000,16000,16000
2850,新產            ,67000,199000,-132000,0,0,0,0,0,0,148000,148000,0,148000,0,0,0,16000
061550,聯鈞群益9A購03  ,0,0,0,0,0,0,0,0,0,15000,0,0,0,38000,23000,15000,15000
061676,新光金元大9A購03,0,0,0,0,0,0,0,0,0,15000,0,0,0,15000,0,15000,15000
06742P,可成富邦99售02  ,0,0,0,0,0,0,0,0,0,15000,0,0,0,15000,0,15000,15000
06548P,大立光元大98售10,0,0,0,0,0,0,0,0,0,15000,0,0,0,15000,0,15000,15000
061868,旺宏元大9B購03  ,0,0,0,0,0,0,0,0,0,15000,0,0,0,24000,9000,15000,15000
061966,旺宏統一01購03  ,0,0,0,0,0,0,0,0,0,15000,0,0,0,15000,0,15000,15000
06005P,晶豪科永豐96售04,0,0,0,0,0,0,0,0,0,15000,0,0,0,16000,1000,15000,15000
060061,旺宏兆豐99購02  ,0,0,0,0,0,0,0,0,0,15000,0,0,0,15000,0,15000,15000
060157,致茂永豐9A購02  ,0,0,0,0,0,0,0,0,0,15000,0,0,0,15000,0,15000,15000
060802,道瓊指中信9C購03,0,0,0,0,0,0,0,0,0,15000,0,0,0,15000,0,15000,15000
060814,健策凱基9B購01  ,0,0,0,0,0,0,0,0,0,15000,0,0,0,15000,0,15000,15000
061054,台積電群益9A購04,0,0,0,0,0,0,0,0,0,15000,0,0,0,155000,140000,15000,15000
061140,華擎統一9C購01  ,0,0,0,0,0,0,0,0,0,15000,0,0,0,18000,3000,15000,15000
060557,南電凱基9A購02  ,0,0,0,0,0,0,0,0,0,15000,0,0,0,40000,25000,15000,15000
060503,技嘉元大9A購01  ,0,0,0,0,0,0,0,0,0,15000,0,0,0,60000,45000,15000,15000
06060P,玉晶光元大97售03,0,0,0,0,0,0,0,0,0,15000,0,0,0,20000,5000,15000,15000
060686,康友元大9A購02  ,0,0,0,0,0,0,0,0,0,15000,0,0,0,20000,5000,15000,15000
060717,康控永豐9A購01  ,0,0,0,0,0,0,0,0,0,15000,0,0,0,15000,0,15000,15000
060755,鴻海元大9A購15  ,0,0,0,0,0,0,0,0,0,15000,0,0,0,50000,35000,15000,15000
054335,緯穎永豐96購02  ,0,0,0,0,0,0,0,0,0,15000,0,0,0,15000,0,15000,15000
053931,楠梓電統一96購01,0,0,0,0,0,0,0,0,0,15000,0,0,0,15000,0,15000,15000
05395P,旺宏元大96售06  ,0,0,0,0,0,0,0,0,0,15000,0,0,0,19000,4000,15000,15000
055248,可成統一97購02  ,0,0,0,0,0,0,0,0,0,15000,0,0,0,15000,0,15000,15000
053583,漢唐元大96購03  ,0,0,0,0,0,0,0,0,0,15000,0,0,0,15000,0,15000,15000
055470,南亞科凱基97購01,0,0,0,0,0,0,0,0,0,15000,0,0,0,15000,0,15000,15000
059051,和大凱基9A購01  ,0,0,0,0,0,0,0,0,0,15000,0,0,0,80000,65000,15000,15000
059068,台虹國票9A購01  ,0,0,0,0,0,0,0,0,0,15000,0,0,0,15000,0,15000,15000
059033,元油2X群益9C購05,0,0,0,0,0,0,0,0,0,15000,0,0,0,50000,35000,15000,15000
058808,大成鋼統一9B購01,0,0,0,0,0,0,0,0,0,15000,0,0,0,108000,93000,15000,15000
058902,聯發科元大99購15,0,0,0,0,0,0,0,0,0,15000,0,0,0,15000,0,15000,15000
058897,國巨元大99購17  ,0,0,0,0,0,0,0,0,0,15000,0,0,0,16000,1000,15000,15000
051636,嘉晶國票95購02  ,0,0,0,0,0,0,0,0,0,15000,0,0,0,15000,0,15000,15000
051801,牧德永豐95購04  ,0,0,0,0,0,0,0,0,0,15000,0,0,0,15000,0,15000,15000
054670,康友元富97購01  ,0,0,0,0,0,0,0,0,0,15000,0,0,0,15000,0,15000,15000
054681,味全永豐97購01  ,0,0,0,0,0,0,0,0,0,15000,0,0,0,15000,0,15000,15000
052378,矽力元大96購01  ,0,0,0,0,0,0,0,0,0,15000,0,0,0,50000,35000,15000,15000
05242P,群創國泰97售01  ,0,0,0,0,0,0,0,0,0,15000,0,0,0,15000,0,15000,15000
052414,聯電麥證95購01  ,0,0,0,15000,0,15000,0,0,0,15000,0,0,0,15000,0,15000,15000
050705,南電凱基96購01  ,0,0,0,0,0,0,0,0,0,15000,0,0,0,16000,1000,15000,15000
03618C,高股息凱基95牛01,0,0,0,0,0,0,0,0,0,15000,0,0,0,15000,0,15000,15000
049842,道瓊反中信98購01,0,0,0,0,0,0,0,0,0,15000,0,0,0,15000,0,15000,15000
050031,嘉澤元大95購01  ,0,0,0,0,0,0,0,0,0,15000,0,0,0,15000,0,15000,15000
050124,元金2X凱基95購01,0,0,0,0,0,0,0,0,0,15000,0,0,0,15000,0,15000,15000
00714,群益道瓊美國地產,0,0,0,0,0,0,0,0,0,15000,0,0,0,20000,5000,15000,15000
059546,FBVIX群益99購03 ,0,0,0,0,0,0,0,0,0,15000,0,0,0,15000,0,15000,15000
059149,臺股指國票99購12,0,0,0,0,0,0,0,0,0,15000,0,0,0,15000,0,15000,15000
058113,百和元富98購01  ,0,0,0,0,0,0,0,0,0,15000,0,0,0,15000,0,15000,15000
058030,國巨永豐98購08  ,0,0,0,0,0,0,0,0,0,15000,0,0,0,15000,0,15000,15000
059305,台灣50元大99購02,0,0,0,0,0,0,0,0,0,15000,0,0,0,15000,0,15000,15000
059554,台灣50凱基99購08,0,0,0,0,0,0,0,0,0,15000,0,0,0,15000,0,15000,15000
059682,可成富邦9A購01  ,0,0,0,0,0,0,0,0,0,15000,0,0,0,15000,0,15000,15000
056104,義隆永豐97購01  ,0,0,0,0,0,0,0,0,0,15000,0,0,0,22000,7000,15000,15000
057043,台積電元大99購02,0,0,0,0,0,0,0,0,0,15000,0,0,0,15000,0,15000,15000
055988,矽力元富97購01  ,0,0,0,0,0,0,0,0,0,15000,0,0,0,20000,5000,15000,15000
056411,緯穎國票99購01  ,0,0,0,0,0,0,0,0,0,15000,0,0,0,15000,0,15000,15000
057803,上銀元大98購08  ,0,0,0,0,0,0,0,0,0,15000,0,0,0,15000,0,15000,15000
056564,亞光群益98購02  ,0,0,0,0,0,0,0,0,0,15000,0,0,0,15000,0,15000,15000
056233,超眾凱基97購02  ,0,0,0,0,0,0,0,0,0,15000,0,0,0,15000,0,15000,15000
056210,矽創永豐97購02  ,0,0,0,0,0,0,0,0,0,15000,0,0,0,15000,0,15000,15000
057869,大立光凱基99購01,0,0,0,0,0,0,0,0,0,15000,0,0,0,15000,0,15000,15000
058484,元金2X國票04購01,0,0,0,0,0,0,0,0,0,15000,0,0,0,15000,0,15000,15000
058711,鴻海統一9A購02  ,0,0,0,0,0,0,0,0,0,15000,0,0,0,44000,29000,15000,15000
058502,鴻海元大99購13  ,0,0,0,0,0,0,0,0,0,15000,0,0,0,21000,6000,15000,15000
056776,聯茂元大99購01  ,0,0,0,0,0,0,0,0,0,15000,0,0,0,70000,55000,15000,15000
056754,智易兆豐99購01  ,0,0,0,0,0,0,0,0,0,15000,0,0,0,15000,0,15000,15000
057662,上銀元大9A購01  ,0,0,0,0,0,0,0,0,0,15000,0,0,0,15000,0,15000,15000
3033,威健            ,71000,56000,15000,0,0,0,0,0,0,0,0,0,0,0,0,0,15000
2397,友通            ,30000,15000,15000,0,0,0,0,0,0,0,0,0,0,0,0,0,15000
07844P,可成國票9A售01  ,0,0,0,0,0,0,0,0,0,15000,0,0,0,15000,0,15000,15000
07133P,臺股指元大9A售27,0,0,0,0,0,0,0,0,0,15000,0,0,0,50000,35000,15000,15000
6216,居易            ,17000,2000,15000,0,0,0,0,0,0,0,0,0,0,0,0,0,15000
060719,瀚宇博永豐9A購01,0,0,0,0,0,0,0,0,0,14000,0,0,0,23000,9000,14000,14000
060570,南亞科永豐9A購01,0,0,0,0,0,0,0,0,0,14000,0,0,0,14000,0,14000,14000
060534,友達麥證9A購01  ,0,0,0,14000,0,14000,0,0,0,14000,0,0,0,14000,0,14000,14000
060855,華新科富邦01購01,0,0,0,0,0,0,0,0,0,14000,0,0,0,52000,38000,14000,14000
060200,同欣電元富9A購01,0,0,0,0,0,0,0,0,0,14000,0,0,0,464000,450000,14000,14000
060242,潤泰全元大9C購01,0,0,0,0,0,0,0,0,0,14000,0,0,0,112000,98000,14000,14000
060018,國產康和99購01  ,0,0,0,0,0,0,0,0,0,14000,0,0,0,14000,0,14000,14000
06616P,國巨元大98售15  ,0,0,0,0,0,0,0,0,0,14000,0,0,0,24000,10000,14000,14000
06595P,祥碩元大98售03  ,0,0,0,0,0,0,0,0,0,14000,0,0,0,148000,134000,14000,14000
061681,南電元大9A購08  ,0,0,0,0,0,0,0,0,0,14000,0,0,0,96000,82000,14000,14000
061564,華擎國票9A購02  ,0,0,0,0,0,0,0,0,0,14000,0,0,0,62000,48000,14000,14000
061325,晶技凱基9A購03  ,0,0,0,0,0,0,0,0,0,14000,0,0,0,14000,0,14000,14000
04436P,聯發科中信96售02,0,0,0,0,0,0,0,0,0,14000,0,0,0,14000,0,14000,14000
048576,義隆國泰95購01  ,0,0,0,0,0,0,0,0,0,14000,0,0,0,33000,19000,14000,14000
052206,燿華中信95購02  ,0,0,0,0,0,0,0,0,0,14000,0,0,0,14000,0,14000,14000
053074,嘉晶永豐96購02  ,0,0,0,0,0,0,0,0,0,14000,0,0,0,34000,20000,14000,14000
053243,楠梓電國票97購02,0,0,0,0,0,0,0,0,0,14000,0,0,0,14000,0,14000,14000
058895,鴻海元大99購20  ,0,0,0,0,0,0,0,0,0,14000,0,0,0,14000,0,14000,14000
058783,臺股指國票99購02,0,0,0,0,0,0,0,0,0,14000,0,0,0,14000,0,14000,14000
059094,臻鼎元大99購03  ,0,0,0,0,0,0,0,0,0,14000,0,0,0,14000,0,14000,14000
054930,群電凱基98購01  ,0,0,0,0,0,0,0,0,0,14000,0,0,0,33000,19000,14000,14000
056713,華擎永豐98購01  ,0,0,0,0,0,0,0,0,0,14000,0,0,0,94000,80000,14000,14000
055822,臺股指國票97購09,0,0,0,0,0,0,0,0,0,14000,0,0,0,146000,132000,14000,14000
057856,聯鈞國票99購03  ,0,0,0,0,0,0,0,0,0,14000,0,0,0,19000,5000,14000,14000
056518,美律國票99購01  ,0,0,0,0,0,0,0,0,0,14000,0,0,0,14000,0,14000,14000
056879,旺宏國票99購02  ,0,0,0,0,0,0,0,0,0,14000,0,0,0,14000,0,14000,14000
058309,大毅元大99購02  ,0,0,0,0,0,0,0,0,0,14000,0,0,0,16000,2000,14000,14000
057003,立積國票98購01  ,0,0,0,0,0,0,0,0,0,14000,0,0,0,14000,0,14000,14000
056055,國巨元大97購15  ,0,0,0,0,0,0,0,0,0,14000,0,0,0,14000,0,14000,14000
057954,宏碁元大99購01  ,0,0,0,0,0,0,0,0,0,14000,0,0,0,14000,0,14000,14000
057496,佐登元大98購02  ,0,0,0,0,0,0,0,0,0,14000,0,0,0,18000,4000,14000,14000
059541,T50正2康和99購01,0,0,0,0,0,0,0,0,0,14000,0,0,0,16000,2000,14000,14000
059344,長榮航凱基99購01,0,0,0,0,0,0,0,0,0,14000,0,0,0,19000,5000,14000,14000
058010,帆宣國票98購01  ,0,0,0,0,0,0,0,0,0,14000,0,0,0,14000,0,14000,14000
057088,上銀元富98購01  ,0,0,0,0,0,0,0,0,0,14000,0,0,0,114000,100000,14000,14000
056192,智邦富邦98購01  ,0,0,0,0,0,0,0,0,0,14000,0,0,0,14000,0,14000,14000
911868,同方友友-DR     ,14000,0,14000,0,0,0,0,0,0,0,0,0,0,0,0,0,14000
07853P,國巨凱基9A售19  ,0,0,0,0,0,0,0,0,0,14000,0,0,0,19000,5000,14000,14000
07833P,大立光群益9B售02,0,0,0,0,0,0,0,0,0,14000,0,0,0,15000,1000,14000,14000
3058,立德            ,19000,5000,14000,0,0,0,0,0,0,0,0,0,0,0,0,0,14000
2832,台產            ,32000,18000,14000,0,0,0,0,0,0,0,0,0,0,0,0,0,14000
061178,晶技凱基9B購01  ,0,0,0,0,0,0,0,0,0,13000,0,0,0,22000,9000,13000,13000
061499,嘉晶國票9A購03  ,0,0,0,0,0,0,0,0,0,13000,0,0,0,21000,8000,13000,13000
059988,大立光元大9A購02,0,0,0,0,0,0,0,0,0,13000,0,0,0,13000,0,13000,13000
059940,微星永豐99購01  ,0,0,0,0,0,0,0,0,0,13000,0,0,0,13000,0,13000,13000
059820,南亞科凱基99購07,0,0,0,0,0,0,0,0,0,13000,0,0,0,18000,5000,13000,13000
061123,燿華永豐9A購01  ,0,0,0,0,0,0,0,0,0,13000,0,0,0,13000,0,13000,13000
061052,和大群益9A購01  ,0,0,0,0,0,0,0,0,0,13000,0,0,0,13000,0,13000,13000
060639,玉晶光永豐9A購05,0,0,0,0,0,0,0,0,0,13000,0,0,0,434000,421000,13000,13000
054996,聯陽元富97購01  ,0,0,0,0,0,0,0,0,0,13000,0,0,0,13000,0,13000,13000
054331,世芯永豐96購03  ,0,0,0,0,0,0,0,0,0,13000,0,0,0,20000,7000,13000,13000
058781,康友國票9A購01  ,0,0,0,0,0,0,0,0,0,13000,0,0,0,29000,16000,13000,13000
058915,SGBR2X元富99購01,0,0,0,0,0,0,0,0,0,13000,0,0,0,13000,0,13000,13000
055411,國巨富邦9A購02  ,0,0,0,0,0,0,0,0,0,13000,0,0,0,16000,3000,13000,13000
055566,台表科凱基97購03,0,0,0,0,0,0,0,0,0,13000,0,0,0,23000,10000,13000,13000
055310,聯詠群益97購02  ,0,0,0,0,0,0,0,0,0,13000,0,0,0,13000,0,13000,13000
053658,亞光凱基96購01  ,0,0,0,0,0,0,0,0,0,13000,0,0,0,13000,0,13000,13000
053643,漢唐國票97購02  ,0,0,0,0,0,0,0,0,0,13000,0,0,0,13000,0,13000,13000
053137,旺宏富邦98購01  ,0,0,0,0,0,0,0,0,0,13000,0,0,0,15000,2000,13000,13000
054471,T50反1中信9C購01,0,0,0,0,0,0,0,0,0,13000,0,0,0,143000,130000,13000,13000
05212P,台積電國票96售04,0,0,0,0,0,0,0,0,0,13000,0,0,0,25000,12000,13000,13000
00645,富邦日本        ,0,0,0,0,0,0,0,0,0,13000,0,0,0,81000,68000,13000,13000
058041,FBVIX元大98購02 ,0,0,0,0,0,0,0,0,0,13000,0,0,0,30000,17000,13000,13000
058037,台灣50元大9B購02,0,0,0,0,0,0,0,0,0,13000,0,0,0,14000,1000,13000,13000
057484,南亞科元大98購06,0,0,0,0,0,0,0,0,0,13000,0,0,0,13000,0,13000,13000
057024,義隆凱基99購01  ,0,0,0,0,0,0,0,0,0,13000,0,0,0,81000,68000,13000,13000
056156,禾伸堂凱基98購04,0,0,0,0,0,0,0,0,0,13000,0,0,0,52000,39000,13000,13000
059021,台積電統一9B購07,0,0,0,0,0,0,0,0,0,13000,0,0,0,20000,7000,13000,13000
05858P,矽力中信96售01  ,0,0,0,0,0,0,0,0,0,13000,0,0,0,13000,0,13000,13000
3043,科風            ,13000,0,13000,0,0,0,0,0,0,0,0,0,0,0,0,0,13000
07795P,美律國票9A售03  ,0,0,0,0,0,0,0,0,0,13000,0,0,0,13000,0,13000,13000
1231,聯華食          ,25000,12000,13000,0,0,0,0,0,0,0,0,0,0,0,0,0,13000
08671P,友訊國票01售01  ,0,0,0,0,0,0,0,0,0,13000,0,0,0,13000,0,13000,13000
07104P,聯發科元富99售04,0,0,0,0,0,0,0,0,0,13000,0,0,0,13000,0,13000,13000
07459P,緯穎元大9A售01  ,0,0,0,0,0,0,0,0,0,13000,0,0,0,190000,177000,13000,13000
07435P,台積電富邦9C售07,0,0,0,0,0,0,0,0,0,13000,0,0,0,13000,0,13000,13000
6655,科定            ,15000,2000,13000,0,0,0,0,0,0,0,0,0,0,0,0,0,13000
4994,傳奇            ,84000,73000,11000,0,0,0,0,0,0,2000,0,1000,-1000,3000,0,3000,13000
4526,東台            ,39000,26000,13000,0,0,0,0,0,0,0,0,0,0,0,0,0,13000
060477,和潤元大9A購01  ,0,0,0,0,0,0,0,0,0,12000,0,0,0,42000,30000,12000,12000
060479,億豐元大9A購01  ,0,0,0,0,0,0,0,0,0,12000,0,0,0,12000,0,12000,12000
060752,上銀元大9A購04  ,0,0,0,0,0,0,0,0,0,12000,0,0,0,12000,0,12000,12000
059853,超眾永豐99購03  ,0,0,0,0,0,0,0,0,0,12000,0,0,0,12000,0,12000,12000
059939,技嘉永豐99購01  ,0,0,0,0,0,0,0,0,0,12000,0,0,0,242000,230000,12000,12000
059178,臺股指凱基99購30,0,0,0,0,0,0,0,0,0,12000,0,0,0,15000,3000,12000,12000
060185,聯發科元富04購01,0,0,0,0,0,0,0,0,0,12000,0,0,0,26000,14000,12000,12000
060386,台勝科凱基9B購01,0,0,0,0,0,0,0,0,0,12000,0,0,0,211000,199000,12000,12000
061751,華通台新9B購01  ,0,0,0,0,0,0,0,0,0,12000,0,0,0,12000,0,12000,12000
061768,晶技元大9B購02  ,0,0,0,0,0,0,0,0,0,12000,0,0,0,30000,18000,12000,12000
061346,玉晶光元大9B購03,0,0,0,0,0,0,0,0,0,12000,0,0,0,80000,68000,12000,12000
06395P,台積電元大97售29,0,0,0,0,0,0,0,0,0,12000,0,0,0,12000,0,12000,12000
06439P,上銀凱基98售02  ,0,0,0,0,0,0,0,0,0,12000,0,0,0,20000,8000,12000,12000
06743P,創意永豐98售03  ,0,0,0,0,0,0,0,0,0,12000,0,0,0,201000,189000,12000,12000
06859P,元金2X中信9C售01,0,0,0,0,0,0,0,0,0,12000,0,0,0,13000,1000,12000,12000
053051,楠梓電國票97購01,0,0,0,0,0,0,0,0,0,12000,0,0,0,12000,0,12000,12000
051449,玉晶光元大96購01,0,0,0,0,0,0,0,0,0,12000,0,0,0,33000,21000,12000,12000
051460,S&P反1國泰97購01,0,0,0,0,0,0,0,0,0,12000,0,0,0,12000,0,12000,12000
052132,旺宏凱基9B購01  ,0,0,0,0,0,0,0,0,0,12000,0,0,0,12000,0,12000,12000
052775,滬深2X國票99購02,0,0,0,0,0,0,0,0,0,12000,0,0,0,30000,18000,12000,12000
052406,力成凱基95購03  ,0,0,0,0,0,0,0,0,0,12000,0,0,0,12000,0,12000,12000
051749,矽力國泰97購01  ,0,0,0,0,0,0,0,0,0,12000,0,0,0,12000,0,12000,12000
051731,聯電國票96購02  ,0,0,0,0,0,0,0,0,0,12000,0,0,0,12000,0,12000,12000
053174,同欣電群益98購02,0,0,0,0,0,0,0,0,0,12000,0,0,0,12000,0,12000,12000
053164,台光電群益96購02,0,0,0,0,0,0,0,0,0,12000,0,0,0,12000,0,12000,12000
054632,緯穎凱基9A購01  ,0,0,0,0,0,0,0,0,0,12000,0,0,0,12000,0,12000,12000
055282,聯發科元大97購15,0,0,0,0,0,0,0,0,0,12000,0,0,0,12000,0,12000,12000
055631,創意永豐98購01  ,0,0,0,0,0,0,0,0,0,12000,0,0,0,12000,0,12000,12000
058984,全新凱基9A購03  ,0,0,0,0,0,0,0,0,0,12000,0,0,0,131000,119000,12000,12000
058777,台光電國票9A購01,0,0,0,0,0,0,0,0,0,12000,0,0,0,22000,10000,12000,12000
058817,嘉聯益台新99購01,0,0,0,0,0,0,0,0,0,12000,0,0,0,12000,0,12000,12000
058797,大毅元大99購03  ,0,0,0,0,0,0,0,0,0,12000,0,0,0,13000,1000,12000,12000
053770,元金2X元大98購01,0,0,0,0,0,0,0,0,0,12000,0,0,0,12000,0,12000,12000
054213,欣興國票97購04  ,0,0,0,0,0,0,0,0,0,12000,0,0,0,21000,9000,12000,12000
05475P,聯茂亞東95售01  ,0,0,0,0,0,0,0,0,0,12000,0,0,0,12000,0,12000,12000
053442,光罩凱基96購01  ,0,0,0,0,0,0,0,0,0,12000,0,0,0,58000,46000,12000,12000
058477,億光凱基9A購01  ,0,0,0,0,0,0,0,0,0,12000,0,0,0,12000,0,12000,12000
056394,晶豪科永豐98購01,0,0,0,0,0,0,0,0,0,12000,0,0,0,70000,58000,12000,12000
056500,大立光富邦9B購02,0,0,0,0,0,0,0,0,0,12000,0,0,0,13000,1000,12000,12000
056946,國巨統一98購05  ,0,0,0,0,0,0,0,0,0,12000,0,0,0,146000,134000,12000,12000
057428,正崴兆豐98購01  ,0,0,0,0,0,0,0,0,0,12000,0,0,0,144000,132000,12000,12000
057375,欣興元大98購09  ,0,0,0,0,0,0,0,0,0,12000,0,0,0,85000,73000,12000,12000
057045,美律元大99購04  ,0,0,0,0,0,0,0,0,0,12000,0,0,0,12000,0,12000,12000
058213,欣興群益99購01  ,0,0,0,0,0,0,0,0,0,12000,0,0,0,135000,123000,12000,12000
059272,台灣50元大99購01,0,0,0,0,0,0,0,0,0,12000,0,0,0,22000,10000,12000,12000
059694,創意永豐99購03  ,0,0,0,0,0,0,0,0,0,12000,0,0,0,16000,4000,12000,12000
6414,樺漢            ,105000,80000,25000,0,0,0,0,0,0,-13000,10000,5000,5000,1000,19000,-18000,12000
07118P,台積電凱基99售09,0,0,0,0,0,0,0,0,0,12000,0,0,0,12000,0,12000,12000
07774P,台灣50群益9A售16,0,0,0,0,0,0,0,0,0,12000,0,0,0,12000,0,12000,12000
07847P,國巨群益9A售13  ,0,0,0,0,0,0,0,0,0,12000,0,0,0,20000,8000,12000,12000
06718P,聯詠元大98售01  ,0,0,0,0,0,0,0,0,0,11000,0,0,0,13000,2000,11000,11000
06244P,智易元富97售02  ,0,0,0,0,0,0,0,0,0,11000,0,0,0,13000,2000,11000,11000
062065,台灣50元大9B購14,0,0,0,0,0,0,0,0,0,11000,0,0,0,11000,0,11000,11000
060124,奇力新永豐99購03,0,0,0,0,0,0,0,0,0,11000,0,0,0,41000,30000,11000,11000
05994P,奇鋐元大96售02  ,0,0,0,0,0,0,0,0,0,11000,0,0,0,41000,30000,11000,11000
059177,臺股指凱基99購28,0,0,0,0,0,0,0,0,0,11000,0,0,0,52000,41000,11000,11000
059803,S&P正2元富9B購03,0,0,0,0,0,0,0,0,0,11000,0,0,0,12000,1000,11000,11000
060474,中租元大9B購01  ,0,0,0,0,0,0,0,0,0,11000,0,0,0,11000,0,11000,11000
060560,欣興國泰9C購01  ,0,0,0,0,0,0,0,0,0,11000,0,0,0,11000,0,11000,11000
060990,新光金元大9B購03,0,0,0,0,0,0,0,0,0,11000,0,0,0,11000,0,11000,11000
060848,聯茂國票9A購02  ,0,0,0,0,0,0,0,0,0,11000,0,0,0,38000,27000,11000,11000
060946,世紀鋼國票9A購02,0,0,0,0,0,0,0,0,0,11000,0,0,0,46000,35000,11000,11000
055027,牧德國泰99購01  ,0,0,0,0,0,0,0,0,0,11000,0,0,0,61000,50000,11000,11000
059062,群創凱基99購05  ,0,0,0,0,0,0,0,0,0,11000,0,0,0,11000,0,11000,11000
055545,國巨凱基97購06  ,0,0,0,0,0,0,0,0,0,11000,0,0,0,145000,134000,11000,11000
055368,台積電元大97購24,0,0,0,0,0,0,0,0,0,11000,0,0,0,12000,1000,11000,11000
055374,明泰元大97購01  ,0,0,0,0,0,0,0,0,0,11000,0,0,0,11000,0,11000,11000
053635,技嘉永豐96購01  ,0,0,0,0,0,0,0,0,0,11000,0,0,0,33000,22000,11000,11000
055079,台光電中信97購01,0,0,0,0,0,0,0,0,0,11000,0,0,0,11000,0,11000,11000
052191,超眾群益96購01  ,0,0,0,0,0,0,0,0,0,11000,0,0,0,11000,0,11000,11000
052202,矽力統一96購01  ,0,0,0,0,0,0,0,0,0,11000,0,0,0,11000,0,11000,11000
052497,楠梓電永豐96購01,0,0,0,0,0,0,0,0,0,11000,0,0,0,11000,0,11000,11000
052907,嘉澤國票97購01  ,0,0,0,0,0,0,0,0,0,11000,0,0,0,13000,2000,11000,11000
04786P,鴻海永昌96售01  ,0,0,0,0,0,0,0,0,0,11000,0,0,0,11000,0,11000,11000
057086,立積統一9C購01  ,0,0,0,0,0,0,0,0,0,11000,0,0,0,11000,0,11000,11000
057121,立積康和98購01  ,0,0,0,0,0,0,0,0,0,11000,0,0,0,11000,0,11000,11000
059415,台灣50元大9A購03,0,0,0,0,0,0,0,0,0,11000,0,0,0,13000,2000,11000,11000
057494,玉晶光元大99購09,0,0,0,0,0,0,0,0,0,11000,0,0,0,98000,87000,11000,11000
057503,世紀鋼群益98購02,0,0,0,0,0,0,0,0,0,11000,0,0,0,11000,0,11000,11000
056136,京鼎元大98購01  ,0,0,0,0,0,0,0,0,0,11000,0,0,0,11000,0,11000,11000
058333,鴻海元富99購04  ,0,0,0,0,0,0,0,0,0,11000,0,0,0,43000,32000,11000,11000
057458,TPK富邦9A購01   ,0,0,0,0,0,0,0,0,0,11000,0,0,0,11000,0,11000,11000
056508,揚明光永豐98購01,0,0,0,0,0,0,0,0,0,11000,0,0,0,11000,0,11000,11000
056452,亞光凱基98購02  ,0,0,0,0,0,0,0,0,0,11000,0,0,0,11000,0,11000,11000
057597,華通群益9A購02  ,0,0,0,0,0,0,0,0,0,11000,0,0,0,11000,0,11000,11000
057609,友訊元富98購01  ,0,0,0,0,0,0,0,0,0,11000,0,0,0,173000,162000,11000,11000
056767,大毅元大99購01  ,0,0,0,0,0,0,0,0,0,11000,0,0,0,11000,0,11000,11000
07217P,大立光凱基9A售05,0,0,0,0,0,0,0,0,0,11000,0,0,0,95000,84000,11000,11000
07421P,國泰金元大99售01,0,0,0,0,0,0,0,0,0,11000,0,0,0,28000,17000,11000,11000
3062,建漢            ,101000,90000,11000,0,0,0,0,0,0,0,0,0,0,0,0,0,11000
2348,海悅            ,24000,13000,11000,0,0,0,0,0,0,0,0,0,0,0,0,0,11000
1414,東和            ,12000,1000,11000,0,0,0,0,0,0,0,0,0,0,0,0,0,11000
1459,聯發            ,13000,2000,11000,0,0,0,0,0,0,0,0,0,0,0,0,0,11000
8114,振樺電          ,13000,2000,11000,0,0,0,0,0,0,0,0,0,0,0,0,0,11000
4438,廣越            ,14000,3000,11000,0,0,0,0,0,0,0,0,0,0,0,0,0,11000
5285,界霖            ,38000,27000,11000,0,0,0,0,0,0,0,0,0,0,0,0,0,11000
060985,聯發科元大9A購06,0,0,0,0,0,0,0,0,0,10000,0,0,0,10000,0,10000,10000
060875,華通中信02購01  ,0,0,0,0,0,0,0,0,0,10000,0,0,0,10000,0,10000,10000
06100P,台積電日盛97售03,0,0,0,0,0,0,0,0,0,10000,0,0,0,30000,20000,10000,10000
060575,大立光中信9B購02,0,0,0,0,0,0,0,0,0,10000,0,0,0,20000,10000,10000,10000
060587,牧德元富9A購01  ,0,0,0,0,0,0,0,0,0,10000,0,0,0,10000,0,10000,10000
060649,國巨第一9A購01  ,0,0,0,0,0,0,0,0,0,10000,0,0,0,130000,120000,10000,10000
06055P,華通凱基97售04  ,0,0,0,0,0,0,0,0,0,10000,0,0,0,10000,0,10000,10000
060750,高股息元大9A購01,0,0,0,0,0,0,0,0,0,10000,0,0,0,10000,0,10000,10000
060783,亞德客富邦9B購01,0,0,0,0,0,0,0,0,0,10000,0,0,0,10000,0,10000,10000
060688,世紀鋼元大9C購01,0,0,0,0,0,0,0,0,0,10000,0,0,0,60000,50000,10000,10000
060658,台灣50凱基01購04,0,0,0,0,0,0,0,0,0,10000,0,0,0,54000,44000,10000,10000
059823,奇力新凱基99購07,0,0,0,0,0,0,0,0,0,10000,0,0,0,10000,0,10000,10000
059782,A50正2元大9C購04,0,0,0,0,0,0,0,0,0,10000,0,0,0,36000,26000,10000,10000
059863,和大凱基99購01  ,0,0,0,0,0,0,0,0,0,10000,0,0,0,10000,0,10000,10000
059864,亞德客凱基99購01,0,0,0,0,0,0,0,0,0,10000,0,0,0,10000,0,10000,10000
059935,國巨永豐99購07  ,0,0,0,0,0,0,0,0,0,10000,0,0,0,20000,10000,10000,10000
059920,宏達電元大99購07,0,0,0,0,0,0,0,0,0,10000,0,0,0,12000,2000,10000,10000
06009P,宏達電元富96售03,0,0,0,0,0,0,0,0,0,10000,0,0,0,10000,0,10000,10000
060075,台積電元富99購05,0,0,0,0,0,0,0,0,0,10000,0,0,0,10000,0,10000,10000
060089,台積電元大99購54,0,0,0,0,0,0,0,0,0,10000,0,0,0,20000,10000,10000,10000
059978,國巨元大99購29  ,0,0,0,0,0,0,0,0,0,10000,0,0,0,10000,0,10000,10000
060009,南亞科群益99購03,0,0,0,0,0,0,0,0,0,10000,0,0,0,20000,10000,10000,10000
060354,A50正2元富9A購02,0,0,0,0,0,0,0,0,0,10000,0,0,0,11000,1000,10000,10000
060359,國巨元富9A購02  ,0,0,0,0,0,0,0,0,0,10000,0,0,0,10000,0,10000,10000
060341,國巨統一9C購02  ,0,0,0,0,0,0,0,0,0,10000,0,0,0,10000,0,10000,10000
060328,可成群益9A購06  ,0,0,0,0,0,0,0,0,0,10000,0,0,0,13000,3000,10000,10000
060461,鴻海元大9A購09  ,0,0,0,0,0,0,0,0,0,10000,0,0,0,10000,0,10000,10000
060188,華新科元富9A購03,0,0,0,0,0,0,0,0,0,10000,0,0,0,10000,0,10000,10000
060156,光磊永豐9A購01  ,0,0,0,0,0,0,0,0,0,10000,0,0,0,10000,0,10000,10000
060305,得力永豐9A購01  ,0,0,0,0,0,0,0,0,0,10000,0,0,0,10000,0,10000,10000
060291,高鐵元大9A購01  ,0,0,0,0,0,0,0,0,0,10000,0,0,0,10000,0,10000,10000
062047,緯穎凱基9B購01  ,0,0,0,0,0,0,0,0,0,10000,0,0,0,51000,41000,10000,10000
062004,國巨國泰9C購03  ,0,0,0,0,0,0,0,0,0,10000,0,0,0,138000,128000,10000,10000
06256P,臺股指群益97售09,0,0,0,0,0,0,0,0,0,10000,0,0,0,10000,0,10000,10000
06342P,世芯統一98售01  ,0,0,0,0,0,0,0,0,0,10000,0,0,0,10000,0,10000,10000
061830,元金2X凱基01購01,0,0,0,0,0,0,0,0,0,10000,0,0,0,30000,20000,10000,10000
06679P,旺宏元大98售09  ,0,0,0,0,0,0,0,0,0,10000,0,0,0,10000,0,10000,10000
06584P,欣興凱基98售03  ,0,0,0,0,0,0,0,0,0,10000,0,0,0,10000,0,10000,10000
06570P,大立光永豐98售01,0,0,0,0,0,0,0,0,0,10000,0,0,0,10000,0,10000,10000
06801P,技嘉群益99售02  ,0,0,0,0,0,0,0,0,0,10000,0,0,0,16000,6000,10000,10000
06763P,技嘉元大98售05  ,0,0,0,0,0,0,0,0,0,10000,0,0,0,23000,13000,10000,10000
06891P,緯穎富邦99售03  ,0,0,0,0,0,0,0,0,0,10000,0,0,0,60000,50000,10000,10000
061380,巨大永豐9A購02  ,0,0,0,0,0,0,0,0,0,10000,0,0,0,41000,31000,10000,10000
061377,聯發科永豐9A購04,0,0,0,0,0,0,0,0,0,10000,0,0,0,10000,0,10000,10000
061396,台灣50台新9C購03,0,0,0,0,0,0,0,0,0,10000,0,0,0,10000,0,10000,10000
061461,元金2X群益9A購01,0,0,0,0,0,0,0,0,0,10000,0,0,0,10000,0,10000,10000
061240,華新科兆豐9A購01,0,0,0,0,0,0,0,0,0,10000,0,0,0,10000,0,10000,10000
061782,智邦群益9B購01  ,0,0,0,0,0,0,0,0,0,10000,0,0,0,10000,0,10000,10000
06152P,玉晶光元大98售06,0,0,0,0,0,0,0,0,0,10000,0,0,0,10000,0,10000,10000
061537,SP黃豆群益9A購02,0,0,0,0,0,0,0,0,0,10000,0,0,0,10000,0,10000,10000
061635,台積電元大9A購34,0,0,0,0,0,0,0,0,0,10000,0,0,0,10000,0,10000,10000
047572,深中小群益95購01,0,0,0,0,0,0,0,0,0,10000,0,0,0,10000,0,10000,10000
047211,華新科富邦99購01,0,0,0,0,0,0,0,0,0,10000,0,0,0,15000,5000,10000,10000
04731P,臺股指中信96售03,0,0,0,0,0,0,0,0,0,10000,0,0,0,45000,35000,10000,10000
042752,台灣50元大96購03,0,0,0,0,0,0,0,0,0,10000,0,0,0,10000,0,10000,10000
04604P,華新科國票95售01,0,0,0,0,0,0,0,0,0,10000,0,0,0,10000,0,10000,10000
052929,可成元大96購02  ,0,0,0,0,0,0,0,0,0,10000,0,0,0,10000,0,10000,10000
048350,世紀鋼元大95購01,0,0,0,0,0,0,0,0,0,10000,0,0,0,70000,60000,10000,10000
048905,旺宏富邦96購01  ,0,0,0,0,0,0,0,0,0,10000,0,0,0,10000,0,10000,10000
048852,旺宏群益96購02  ,0,0,0,0,0,0,0,0,0,10000,0,0,0,10000,0,10000,10000
05123P,鴻海永昌96售07  ,0,0,0,0,0,0,0,0,0,10000,0,0,0,10000,0,10000,10000
051266,國巨富邦99購01  ,3000,0,3000,0,0,0,0,0,0,7000,0,0,0,18000,11000,7000,10000
050808,台達電凱基96購02,0,0,0,0,0,0,0,0,0,10000,0,0,0,10000,0,10000,10000
052972,義隆群益96購04  ,0,0,0,0,0,0,0,0,0,10000,0,0,0,10000,0,10000,10000
05298P,上銀元大95售03  ,0,0,0,0,0,0,0,0,0,10000,0,0,0,10000,0,10000,10000
050792,可成富邦96購01  ,0,0,0,0,0,0,0,0,0,10000,0,0,0,10000,0,10000,10000
050767,京元電元大96購01,0,0,0,0,0,0,0,0,0,10000,0,0,0,10000,0,10000,10000
050785,全新國泰96購01  ,0,0,0,0,0,0,0,0,0,10000,0,0,0,10000,0,10000,10000
050787,致伸國泰96購01  ,0,0,0,0,0,0,0,0,0,10000,0,0,0,10000,0,10000,10000
050600,瑞儀國泰95購01  ,0,0,0,0,0,0,0,0,0,10000,0,0,0,10000,0,10000,10000
050634,華新科群益96購01,0,0,0,0,0,0,0,0,0,10000,0,0,0,30000,20000,10000,10000
050496,鴻海富邦96購01  ,0,0,0,0,0,0,0,0,0,10000,0,0,0,10000,0,10000,10000
05024P,華通國票96售01  ,0,0,0,0,0,0,0,0,0,10000,0,0,0,10000,0,10000,10000
050014,國巨富邦98購01  ,0,0,0,0,0,0,0,0,0,10000,0,0,0,10000,0,10000,10000
049909,國巨元大95購01  ,0,0,0,0,0,0,0,0,0,10000,0,0,0,10000,0,10000,10000
049230,台達電富邦96購01,0,0,0,0,0,0,0,0,0,10000,0,0,0,10000,0,10000,10000
049437,可成國泰96購01  ,0,0,0,0,0,0,0,0,0,10000,0,0,0,10000,0,10000,10000
049554,禾伸堂富邦96購01,0,0,0,0,0,0,0,0,0,10000,0,0,0,10000,0,10000,10000
049668,大立光國泰96購02,0,0,0,0,0,0,0,0,0,10000,0,0,0,10000,0,10000,10000
049706,世紀鋼元大95購02,0,0,0,0,0,0,0,0,0,10000,0,0,0,136000,126000,10000,10000
049726,道瓊反中信96購01,0,0,0,0,0,0,0,0,0,10000,0,0,0,10000,0,10000,10000
03445B,臺股指元大02熊01,0,0,0,0,0,0,0,0,0,10000,0,0,0,10000,0,10000,10000
03421B,臺股指元大99熊01,0,0,0,0,0,0,0,0,0,10000,0,0,0,110000,100000,10000,10000
050402,緯穎中信96購01  ,0,0,0,0,0,0,0,0,0,10000,0,0,0,10000,0,10000,10000
050420,鴻海凱基95購03  ,0,0,0,0,0,0,0,0,0,10000,0,0,0,10000,0,10000,10000
05250P,臻鼎國票96售01  ,0,0,0,0,0,0,0,0,0,10000,0,0,0,10000,0,10000,10000
052576,聯茂凱基96購01  ,0,0,0,0,0,0,0,0,0,10000,0,0,0,10000,0,10000,10000
052555,漢唐國票97購01  ,0,0,0,0,0,0,0,0,0,10000,0,0,0,10000,0,10000,10000
052604,建準元大97購01  ,0,0,0,0,0,0,0,0,0,10000,0,0,0,10000,0,10000,10000
052667,漢唐群益96購01  ,0,0,0,0,0,0,0,0,0,10000,0,0,0,10000,0,10000,10000
052210,華夏元大95購01  ,0,0,0,0,0,0,0,0,0,10000,0,0,0,10000,0,10000,10000
052217,台光電日盛95購01,0,0,0,0,0,0,0,0,0,10000,0,0,0,10000,0,10000,10000
052399,台光電凱基95購03,0,0,0,0,0,0,0,0,0,10000,0,0,0,10000,0,10000,10000
052345,矽力凱基95購01  ,0,0,0,0,0,0,0,0,0,10000,0,0,0,10000,0,10000,10000
052429,禾伸堂永豐95購02,0,0,0,0,0,0,0,0,0,10000,0,0,0,10000,0,10000,10000
052011,欣興中信96購01  ,0,0,0,0,0,0,0,0,0,10000,0,0,0,10000,0,10000,10000
052737,滬深2X元大96購06,0,0,0,0,0,0,0,0,0,10000,0,0,0,10000,0,10000,10000
052734,台表科國泰98購02,0,0,0,0,0,0,0,0,0,10000,0,0,0,10000,0,10000,10000
052780,玉晶光國票96購04,0,0,0,0,0,0,0,0,0,10000,0,0,0,10000,0,10000,10000
052770,聯茂群益96購02  ,0,0,0,0,0,0,0,0,0,10000,0,0,0,10000,0,10000,10000
052072,健策統一95購02  ,0,0,0,0,0,0,0,0,0,10000,0,0,0,10000,0,10000,10000
055163,訊芯元大98購01  ,0,0,0,0,0,0,0,0,0,10000,0,0,0,10000,0,10000,10000
054556,世芯凱基99購01  ,0,0,0,0,0,0,0,0,0,10000,0,0,0,10000,0,10000,10000
053188,旺宏統一97購03  ,0,0,0,0,0,0,0,0,0,10000,0,0,0,10000,0,10000,10000
053097,超眾統一96購03  ,0,0,0,0,0,0,0,0,0,10000,0,0,0,10000,0,10000,10000
054494,訊芯台新96購01  ,0,0,0,0,0,0,0,0,0,10000,0,0,0,10000,0,10000,10000
055319,國巨國票98購03  ,0,0,0,0,0,0,0,0,0,10000,0,0,0,10000,0,10000,10000
053561,玉晶光國泰98購01,0,0,0,0,0,0,0,0,0,10000,0,0,0,10000,0,10000,10000
055137,GIS富邦98購01   ,0,0,0,0,0,0,0,0,0,10000,0,0,0,10000,0,10000,10000
055404,超眾元富97購01  ,0,0,0,0,0,0,0,0,0,10000,0,0,0,60000,50000,10000,10000
055445,旺宏統一99購01  ,0,0,0,0,0,0,0,0,0,10000,0,0,0,10000,0,10000,10000
055590,聯發科元大98購02,0,0,0,0,0,0,0,0,0,10000,0,0,0,10000,0,10000,10000
055605,緯穎元大97購02  ,0,0,0,0,0,0,0,0,0,10000,0,0,0,30000,20000,10000,10000
055638,上銀元富97購01  ,0,0,0,0,0,0,0,0,0,10000,0,0,0,10000,0,10000,10000
055623,貿聯國泰99購01  ,0,0,0,0,0,0,0,0,0,10000,0,0,0,20000,10000,10000,10000
059043,聯電日盛99購01  ,0,0,0,0,0,0,0,0,0,10000,0,0,0,95000,85000,10000,10000
059081,和大元大99購01  ,0,0,0,0,0,0,0,0,0,10000,0,0,0,10000,0,10000,10000
058794,旺宏元大99購09  ,0,0,0,0,0,0,0,0,0,10000,0,0,0,10000,0,10000,10000
055015,帆宣元富97購01  ,0,0,0,0,0,0,0,0,0,10000,0,0,0,10000,0,10000,10000
055017,緯穎元富97購01  ,0,0,0,0,0,0,0,0,0,10000,0,0,0,10000,0,10000,10000
055019,福懋科元富97購01,0,0,0,0,0,0,0,0,0,10000,0,0,0,20000,10000,10000,10000
053761,健策國泰98購01  ,0,0,0,0,0,0,0,0,0,10000,0,0,0,10000,0,10000,10000
053827,漢唐麥證9A購01  ,0,0,0,10000,0,10000,0,0,0,10000,0,0,0,10000,0,10000,10000
054323,旺宏台新96購02  ,0,0,0,0,0,0,0,0,0,10000,0,0,0,10000,0,10000,10000
054333,茂林永豐96購03  ,0,0,0,0,0,0,0,0,0,10000,0,0,0,10000,0,10000,10000
054938,國巨元大97購04  ,0,0,0,0,0,0,0,0,0,10000,0,0,0,10000,0,10000,10000
054159,T50正2凱基99購01,0,0,0,0,0,0,0,0,0,10000,0,0,0,10000,0,10000,10000
054285,國巨元大98購02  ,0,0,0,0,0,0,0,0,0,10000,0,0,0,20000,10000,10000,10000
054260,貿聯元大96購03  ,0,0,0,0,0,0,0,0,0,10000,0,0,0,10000,0,10000,10000
054264,超眾元大97購02  ,0,0,0,0,0,0,0,0,0,10000,0,0,0,10000,0,10000,10000
054241,深中小元大98購01,0,0,0,0,0,0,0,0,0,10000,0,0,0,250000,240000,10000,10000
053982,臻鼎元大96購05  ,0,0,0,0,0,0,0,0,0,10000,0,0,0,10000,0,10000,10000
053453,新光金統一98購01,0,0,0,0,0,0,0,0,0,10000,0,0,0,10000,0,10000,10000
053498,大立光兆豐96購03,0,0,0,0,0,0,0,0,0,10000,0,0,0,10000,0,10000,10000
053499,禾伸堂兆豐96購01,0,0,0,0,0,0,0,0,0,10000,0,0,0,10000,0,10000,10000
053463,可成富邦98購01  ,0,0,0,0,0,0,0,0,0,10000,0,0,0,10000,0,10000,10000
053554,欣興凱基97購02  ,0,0,0,0,0,0,0,0,0,10000,0,0,0,10000,0,10000,10000
054843,中環兆豐97購01  ,0,0,0,0,0,0,0,0,0,10000,0,0,0,50000,40000,10000,10000
05491P,茂林元大95售04  ,0,0,0,0,0,0,0,0,0,10000,0,0,0,10000,0,10000,10000
054916,聯發科凱基98購04,0,0,0,0,0,0,0,0,0,10000,0,0,0,10000,0,10000,10000
053904,漢唐凱基97購01  ,0,0,0,0,0,0,0,0,0,10000,0,0,0,10000,0,10000,10000
054757,南亞國票98購01  ,0,0,0,0,0,0,0,0,0,10000,0,0,0,10000,0,10000,10000
053383,京元電元大97購01,0,0,0,0,0,0,0,0,0,10000,0,0,0,10000,0,10000,10000
053416,光磊台新97購01  ,0,0,0,0,0,0,0,0,0,10000,0,0,0,10000,0,10000,10000
053427,鎧勝永豐96購02  ,0,0,0,0,0,0,0,0,0,10000,0,0,0,10000,0,10000,10000
053347,茂林國票98購01  ,0,0,0,0,0,0,0,0,0,10000,0,0,0,10000,0,10000,10000
053363,旺宏國泰98購02  ,0,0,0,0,0,0,0,0,0,10000,0,0,0,10000,0,10000,10000
053369,T50反1元大96購06,0,0,0,0,0,0,0,0,0,10000,0,0,0,10000,0,10000,10000
055236,建準台新98購01  ,0,0,0,0,0,0,0,0,0,10000,0,0,0,10000,0,10000,10000
05519P,上証2X凱基98售01,0,0,0,0,0,0,0,0,0,10000,0,0,0,10000,0,10000,10000
057654,A50正2中信98購01,0,0,0,0,0,0,0,0,0,10000,0,0,0,10000,0,10000,10000
058550,南亞科永豐99購01,0,0,0,0,0,0,0,0,0,10000,0,0,0,10000,0,10000,10000
058702,國巨元大99購16  ,0,0,0,0,0,0,0,0,0,10000,0,0,0,35000,25000,10000,10000
058675,康控群益9B購01  ,0,0,0,0,0,0,0,0,0,10000,0,0,0,10000,0,10000,10000
058619,台灣50國票99購04,0,0,0,0,0,0,0,0,0,10000,0,0,0,10000,0,10000,10000
058635,華新科兆豐99購03,0,0,0,0,0,0,0,0,0,10000,0,0,0,10000,0,10000,10000
057602,聯茂群益98購02  ,0,0,0,0,0,0,0,0,0,10000,0,0,0,10000,0,10000,10000
059031,元石油中信03購01,0,0,0,0,0,0,0,0,0,10000,0,0,0,10000,0,10000,10000
055812,台積電國票99購02,0,0,0,0,0,0,0,0,0,10000,0,0,0,10000,0,10000,10000
055773,瑞昱凱基97購03  ,0,0,0,0,0,0,0,0,0,10000,0,0,0,10000,0,10000,10000
055710,亞德客元大97購03,0,0,0,0,0,0,0,0,0,10000,0,0,0,12000,2000,10000,10000
056460,同欣電凱基99購01,0,0,0,0,0,0,0,0,0,10000,0,0,0,10000,0,10000,10000
056528,為升凱基98購01  ,0,0,0,0,0,0,0,0,0,10000,0,0,0,10000,0,10000,10000
056580,泰鼎元大9A購01  ,0,0,0,0,0,0,0,0,0,10000,0,0,0,10000,0,10000,10000
056396,祥碩永豐98購01  ,0,0,0,0,0,0,0,0,0,10000,0,0,0,10000,0,10000,10000
056362,聯發科元大99購01,0,0,0,0,0,0,0,0,0,10000,0,0,0,10000,0,10000,10000
057732,牧德國泰9A購01  ,0,0,0,0,0,0,0,0,0,10000,0,0,0,120000,110000,10000,10000
057763,康控凱基99購02  ,0,0,0,0,0,0,0,0,0,10000,0,0,0,10000,0,10000,10000
05740P,宏達電元富96售01,0,0,0,0,0,0,0,0,0,10000,0,0,0,10000,0,10000,10000
057297,新日興永豐98購01,0,0,0,0,0,0,0,0,0,10000,0,0,0,20000,10000,10000,10000
056926,日月光兆豐98購01,0,0,0,0,0,0,0,0,0,10000,0,0,0,10000,0,10000,10000
056223,華邦電凱基97購04,0,0,0,0,0,0,0,0,0,10000,0,0,0,10000,0,10000,10000
057858,T50正2康和98購01,0,0,0,0,0,0,0,0,0,10000,0,0,0,10000,0,10000,10000
056961,凱美永豐98購01  ,0,0,0,0,0,0,0,0,0,10000,0,0,0,10000,0,10000,10000
058335,鴻海元富99購06  ,0,0,0,0,0,0,0,0,0,10000,0,0,0,10000,0,10000,10000
058292,上銀凱基9A購01  ,0,0,0,0,0,0,0,0,0,10000,0,0,0,10000,0,10000,10000
057008,華新科中信99購02,0,0,0,0,0,0,0,0,0,10000,0,0,0,20000,10000,10000,10000
056082,旺宏統一99購02  ,0,0,0,0,0,0,0,0,0,10000,0,0,0,10000,0,10000,10000
056089,同欣電統一98購01,0,0,0,0,0,0,0,0,0,10000,0,0,0,10000,0,10000,10000
057491,美食元大98購03  ,0,0,0,0,0,0,0,0,0,10000,0,0,0,10000,0,10000,10000
057536,康控元大99購03  ,0,0,0,0,0,0,0,0,0,10000,0,0,0,10000,0,10000,10000
055872,亞泥元富97購01  ,0,0,0,0,0,0,0,0,0,10000,0,0,0,10000,0,10000,10000
057167,台積電元大99購03,0,0,0,0,0,0,0,0,0,10000,0,0,0,10000,0,10000,10000
055949,亞德客元大97購04,0,0,0,0,0,0,0,0,0,10000,0,0,0,11000,1000,10000,10000
058188,華擎永豐99購01  ,0,0,0,0,0,0,0,0,0,10000,0,0,0,10000,0,10000,10000
058193,緯穎永豐99購01  ,0,0,0,0,0,0,0,0,0,10000,0,0,0,10000,0,10000,10000
058141,嘉聯益元大99購05,0,0,0,0,0,0,0,0,0,10000,0,0,0,10000,0,10000,10000
058138,晶相光元大9C購01,0,0,0,0,0,0,0,0,0,10000,0,0,0,10000,0,10000,10000
057942,可成國票99購02  ,0,0,0,0,0,0,0,0,0,10000,0,0,0,10000,0,10000,10000
057916,國巨凱基98購13  ,0,0,0,0,0,0,0,0,0,10000,0,0,0,20000,10000,10000,10000
059436,大立光元大99購18,0,0,0,0,0,0,0,0,0,10000,0,0,0,10000,0,10000,10000
059486,A50正2兆豐9A購01,0,0,0,0,0,0,0,0,0,10000,0,0,0,10000,0,10000,10000
059380,鴻海亞東99購01  ,0,0,0,0,0,0,0,0,0,10000,0,0,0,10000,0,10000,10000
057143,台郡兆豐98購01  ,0,0,0,0,0,0,0,0,0,10000,0,0,0,10000,0,10000,10000
057991,健策統一9C購01  ,0,0,0,0,0,0,0,0,0,10000,0,0,0,18000,8000,10000,10000
059263,瑞昱中信01購01  ,0,0,0,0,0,0,0,0,0,10000,0,0,0,10000,0,10000,10000
059246,奇力新凱基9A購02,0,0,0,0,0,0,0,0,0,10000,0,0,0,10000,0,10000,10000
059508,聯發科永豐99購03,0,0,0,0,0,0,0,0,0,10000,0,0,0,10000,0,10000,10000
05950P,台積電國票97售04,0,0,0,0,0,0,0,0,0,10000,0,0,0,10000,0,10000,10000
059597,大立光元大99購21,0,0,0,0,0,0,0,0,0,10000,0,0,0,10000,0,10000,10000
5007,三星            ,11000,1000,10000,0,0,0,0,0,0,0,0,0,0,0,0,0,10000
1419,新紡            ,10000,0,10000,0,0,0,0,0,0,0,0,0,0,0,0,0,10000
2007,燁興            ,10000,0,10000,0,0,0,0,0,0,0,0,0,0,0,0,0,10000
3010,華立            ,25000,15000,10000,0,0,0,0,0,0,0,0,0,0,0,0,0,10000
2616,山隆            ,17000,7000,10000,0,0,0,0,0,0,0,0,0,0,0,0,0,10000
2468,華經            ,12000,2000,10000,0,0,0,0,0,0,0,0,0,0,0,0,0,10000
07479P,A50正2元富9A售03,0,0,0,0,0,0,0,0,0,10000,0,0,0,10000,0,10000,10000
07309P,聯發科凱基99售18,0,0,0,0,0,0,0,0,0,10000,0,0,0,10000,0,10000,10000
07281P,鴻海凱基99售13  ,0,0,0,0,0,0,0,0,0,10000,0,0,0,20000,10000,10000,10000
07370P,南亞科凱基99售08,0,0,0,0,0,0,0,0,0,10000,0,0,0,10000,0,10000,10000
07197P,臺股指元大99售13,0,0,0,0,0,0,0,0,0,10000,0,0,0,10000,0,10000,10000
07164P,臺股指群益99售15,0,0,0,0,0,0,0,0,0,10000,0,0,0,40000,30000,10000,10000
06969P,上銀元大99售02  ,0,0,0,0,0,0,0,0,0,10000,0,0,0,10000,0,10000,10000
07784P,華新科富邦9B售04,0,0,0,0,0,0,0,0,0,10000,0,0,0,10000,0,10000,10000
07805P,義隆永豐9A售02  ,0,0,0,0,0,0,0,0,0,10000,0,0,0,20000,10000,10000,10000
07573P,國巨元大9A售11  ,0,0,0,0,0,0,0,0,0,10000,0,0,0,10000,0,10000,10000
07611P,大立光國票9A售05,0,0,0,0,0,0,0,0,0,10000,0,0,0,10000,0,10000,10000
07613P,國巨永豐9A售01  ,0,0,0,0,0,0,0,0,0,10000,0,0,0,10000,0,10000,10000
07656P,國巨凱基9A售15  ,0,0,0,0,0,0,0,0,0,10000,0,0,0,10000,0,10000,10000
07657P,技嘉凱基9A售03  ,0,0,0,0,0,0,0,0,0,10000,0,0,0,20000,10000,10000,10000
07687P,上銀元大9A售06  ,0,0,0,0,0,0,0,0,0,10000,0,0,0,12000,2000,10000,10000
061728,華新科麥證9A購02,0,0,0,9000,0,9000,0,0,0,9000,0,0,0,9000,0,9000,9000
06779P,智邦元大98售12  ,0,0,0,0,0,0,0,0,0,9000,0,0,0,9000,0,9000,9000
06790P,台積電凱基9A售04,0,0,0,0,0,0,0,0,0,9000,0,0,0,9000,0,9000,9000
06190P,玉晶光永豐97售05,0,0,0,0,0,0,0,0,0,9000,0,0,0,68000,59000,9000,9000
060646,南電永豐9A購01  ,0,0,0,0,0,0,0,0,0,9000,0,0,0,26000,17000,9000,9000
060626,貿聯元大9A購04  ,0,0,0,0,0,0,0,0,0,9000,0,0,0,52000,43000,9000,9000
061000,旺宏兆豐9A購02  ,0,0,0,0,0,0,0,0,0,9000,0,0,0,9000,0,9000,9000
060882,大立光中信9A購05,0,0,0,0,0,0,0,0,0,9000,0,0,0,10000,1000,9000,9000
054773,台郡國票98購01  ,0,0,0,0,0,0,0,0,0,9000,0,0,0,9000,0,9000,9000
054240,訊芯群益96購03  ,0,0,0,0,0,0,0,0,0,9000,0,0,0,85000,76000,9000,9000
055006,晶相光元富9A購01,0,0,0,0,0,0,0,0,0,9000,0,0,0,9000,0,9000,9000
053713,漢唐凱基96購04  ,0,0,0,0,0,0,0,0,0,9000,0,0,0,9000,0,9000,9000
059084,鴻海元大99購24  ,0,0,0,0,0,0,0,0,0,9000,0,0,0,9000,0,9000,9000
058963,華新科兆豐99購05,0,0,0,0,0,0,0,0,0,9000,0,0,0,9000,0,9000,9000
055409,元黃金富邦01購01,0,0,0,0,0,0,0,0,0,9000,0,0,0,9000,0,9000,9000
051789,嘉澤國票96購01  ,0,0,0,0,0,0,0,0,0,9000,0,0,0,9000,0,9000,9000
054554,大立光凱基98購02,0,0,0,0,0,0,0,0,0,9000,0,0,0,9000,0,9000,9000
052766,玉晶光群益9A購01,0,0,0,0,0,0,0,0,0,9000,0,0,0,15000,6000,9000,9000
03033X,元展30          ,0,0,0,0,0,0,0,0,0,9000,0,0,0,14000,5000,9000,9000
03677C,臺股指元大05牛02,0,0,0,0,0,0,0,0,0,9000,0,0,0,9000,0,9000,9000
00763U,街口道瓊銅      ,0,0,0,0,0,0,0,0,0,9000,0,0,0,41000,32000,9000,9000
053003,國巨永豐96購02  ,0,0,0,0,0,0,0,0,0,9000,0,0,0,13000,4000,9000,9000
045685,康控元大95購01  ,0,0,0,0,0,0,0,0,0,9000,0,0,0,9000,0,9000,9000
059571,奇力新凱基99購06,0,0,0,0,0,0,0,0,0,9000,0,0,0,10000,1000,9000,9000
059231,華通國票9A購04  ,0,0,0,0,0,0,0,0,0,9000,0,0,0,9000,0,9000,9000
059667,矽力元大99購01  ,0,0,0,0,0,0,0,0,0,9000,0,0,0,34000,25000,9000,9000
056909,嘉聯益元大99購03,0,0,0,0,0,0,0,0,0,9000,0,0,0,30000,21000,9000,9000
057318,台光電凱基9A購01,0,0,0,0,0,0,0,0,0,9000,0,0,0,9000,0,9000,9000
056382,道瓊反國泰9A購01,0,0,0,0,0,0,0,0,0,9000,0,0,0,9000,0,9000,9000
056512,易華電永豐98購01,0,0,0,0,0,0,0,0,0,9000,0,0,0,10000,1000,9000,9000
05669P,嘉晶永豐96售03  ,0,0,0,0,0,0,0,0,0,9000,0,0,0,9000,0,9000,9000
05845P,大立光元大96售06,0,0,0,0,0,0,0,0,0,9000,0,0,0,10000,1000,9000,9000
058621,華通國票9A購01  ,0,0,0,0,0,0,0,0,0,9000,0,0,0,44000,35000,9000,9000
058666,上証反群益01購01,0,0,0,0,0,0,0,0,0,9000,0,0,0,15000,6000,9000,9000
058691,友訊國票9A購01  ,0,0,0,0,0,0,0,0,0,9000,0,0,0,59000,50000,9000,9000
057691,健策凱基99購01  ,0,0,0,0,0,0,0,0,0,9000,0,0,0,9000,0,9000,9000
056766,義隆元大98購01  ,0,0,0,0,0,0,0,0,0,9000,0,0,0,10000,1000,9000,9000
07886P,國巨國票9B售06  ,0,0,0,0,0,0,0,0,0,9000,0,0,0,12000,3000,9000,9000
07873P,華新科群益9B售03,0,0,0,0,0,0,0,0,0,9000,0,0,0,33000,24000,9000,9000
07279P,台灣50台新99售02,0,0,0,0,0,0,0,0,0,9000,0,0,0,9000,0,9000,9000
07304P,臺股指元大9A售37,0,0,0,0,0,0,0,0,0,9000,0,0,0,150000,141000,9000,9000
07508P,華新科國票9A售03,0,0,0,0,0,0,0,0,0,9000,0,0,0,9000,0,9000,9000
2852,第一保          ,19000,10000,9000,0,0,0,0,0,0,0,0,0,0,0,0,0,9000
8367,建新國際        ,9000,0,9000,0,0,0,0,0,0,0,0,0,0,0,0,0,9000
060850,康友國票9A購03  ,0,0,0,0,0,0,0,0,0,8000,0,0,0,8000,0,8000,8000
060818,上銀統一9C購01  ,0,0,0,0,0,0,0,0,0,8000,0,0,0,33000,25000,8000,8000
060941,台積電國票9B購04,0,0,0,0,0,0,0,0,0,8000,0,0,0,8000,0,8000,8000
060554,中租凱基9A購01  ,0,0,0,0,0,0,0,0,0,8000,0,0,0,16000,8000,8000,8000
060292,聯詠元大9A購01  ,0,0,0,0,0,0,0,0,0,8000,0,0,0,27000,19000,8000,8000
060189,宏達電元富9B購03,0,0,0,0,0,0,0,0,0,8000,0,0,0,8000,0,8000,8000
059858,台灣50群益9A購09,0,0,0,0,0,0,0,0,0,8000,0,0,0,8000,0,8000,8000
061955,FANG+統一9B購01 ,0,0,0,0,0,0,0,0,0,8000,0,0,0,8000,0,8000,8000
06328P,台積電中信01售02,0,0,0,0,0,0,0,0,0,8000,0,0,0,8000,0,8000,8000
06513P,鴻海凱基98售10  ,0,0,0,0,0,0,0,0,0,8000,0,0,0,8000,0,8000,8000
061677,泰碩元大9A購05  ,0,0,0,0,0,0,0,0,0,8000,0,0,0,8000,0,8000,8000
046813,聯電凱基96購01  ,0,0,0,0,0,0,0,0,0,8000,0,0,0,10000,2000,8000,8000
052998,拓凱康和96購01  ,0,0,0,0,0,0,0,0,0,8000,0,0,0,8000,0,8000,8000
050842,旺宏國票97購01  ,0,0,0,0,0,0,0,0,0,8000,0,0,0,8000,0,8000,8000
051087,國巨元大97購01  ,0,0,0,0,0,0,0,0,0,8000,0,0,0,8000,0,8000,8000
00709,富邦歐洲        ,0,0,0,0,0,0,0,0,0,8000,0,0,0,109000,101000,8000,8000
00733,富邦臺灣中小    ,0,0,0,0,0,0,0,0,0,8000,0,0,0,208000,200000,8000,8000
04932P,香港2X中信96售01,0,0,0,0,0,0,0,0,0,8000,0,0,0,8000,0,8000,8000
054577,世芯元大98購01  ,0,0,0,0,0,0,0,0,0,8000,0,0,0,10000,2000,8000,8000
054479,緯創中信98購01  ,0,0,0,0,0,0,0,0,0,8000,0,0,0,48000,40000,8000,8000
055322,欣興國票97購06  ,0,0,0,0,0,0,0,0,0,8000,0,0,0,8000,0,8000,8000
059085,鴻海元大99購25  ,0,0,0,0,0,0,0,0,0,8000,0,0,0,31000,23000,8000,8000
053731,矽創凱基96購03  ,0,0,0,0,0,0,0,0,0,8000,0,0,0,8000,0,8000,8000
057712,南亞科統一9A購01,0,0,0,0,0,0,0,0,0,8000,0,0,0,56000,48000,8000,8000
055785,祥碩凱基97購02  ,0,0,0,0,0,0,0,0,0,8000,0,0,0,145000,137000,8000,8000
057788,嘉聯益國票99購01,0,0,0,0,0,0,0,0,0,8000,0,0,0,8000,0,8000,8000
057334,技嘉國票98購02  ,0,0,0,0,0,0,0,0,0,8000,0,0,0,18000,10000,8000,8000
059382,台灣50凱基99購02,0,0,0,0,0,0,0,0,0,8000,0,0,0,9000,1000,8000,8000
059121,瑞儀永豐99購01  ,0,0,0,0,0,0,0,0,0,8000,0,0,0,184000,176000,8000,8000
058196,台塑中信99購01  ,0,0,0,0,0,0,0,0,0,8000,0,0,0,157000,149000,8000,8000
057563,旭富國泰9A購01  ,0,0,0,0,0,0,0,0,0,8000,0,0,0,10000,2000,8000,8000
057524,旺宏元大99購04  ,0,0,0,0,0,0,0,0,0,8000,0,0,0,8000,0,8000,8000
057077,國巨統一98購06  ,0,0,0,0,0,0,0,0,0,8000,0,0,0,10000,2000,8000,8000
057072,日月光永豐98購01,0,0,0,0,0,0,0,0,0,8000,0,0,0,11000,3000,8000,8000
058324,嘉聯益永豐9A購01,0,0,0,0,0,0,0,0,0,8000,0,0,0,9000,1000,8000,8000
058352,鴻海凱基9A購05  ,0,0,0,0,0,0,0,0,0,8000,0,0,0,13000,5000,8000,8000
8480,泰昇-KY         ,18000,10000,8000,0,0,0,0,0,0,0,0,0,0,0,0,0,8000
6184,大豐電          ,15000,7000,8000,0,0,0,0,0,0,0,0,0,0,0,0,0,8000
9943,好樂迪          ,15000,7000,8000,0,0,0,0,0,0,0,0,0,0,0,0,0,8000
2887E,台新戊特        ,0,0,0,0,0,0,0,0,0,8000,8000,0,8000,0,0,0,8000
2506,太設            ,9000,1000,8000,0,0,0,0,0,0,0,0,0,0,0,0,0,8000
3032,偉訓            ,36000,28000,8000,0,0,0,0,0,0,0,0,0,0,0,0,0,8000
3494,誠研            ,11000,3000,8000,0,0,0,0,0,0,0,0,0,0,0,0,0,8000
07088P,訊芯永豐99售02  ,0,0,0,0,0,0,0,0,0,8000,0,0,0,8000,0,8000,8000
061764,旺宏元大9B購01  ,0,0,0,0,0,0,0,0,0,7000,0,0,0,13000,6000,7000,7000
061799,奇鋐永豐9B購01  ,0,0,0,0,0,0,0,0,0,7000,0,0,0,17000,10000,7000,7000
061556,台積電國票9A購08,0,0,0,0,0,0,0,0,0,7000,0,0,0,7000,0,7000,7000
061540,台積電群益9A購07,0,0,0,0,0,0,0,0,0,7000,0,0,0,114000,107000,7000,7000
061504,祥碩國票9A購02  ,0,0,0,0,0,0,0,0,0,7000,0,0,0,7000,0,7000,7000
061189,可成富邦9B購02  ,0,0,0,0,0,0,0,0,0,7000,0,0,0,31000,24000,7000,7000
06897P,FBVIX群益01售01 ,0,0,0,0,0,0,0,0,0,7000,0,0,0,7000,0,7000,7000
062115,臺股指國票9B購09,0,0,0,0,0,0,0,0,0,7000,0,0,0,8000,1000,7000,7000
062030,旭富群益9B購01  ,0,0,0,0,0,0,0,0,0,7000,0,0,0,113000,106000,7000,7000
06187P,國巨統一97售05  ,0,0,0,0,0,0,0,0,0,7000,0,0,0,12000,5000,7000,7000
059824,大立光凱基99購13,0,0,0,0,0,0,0,0,0,7000,0,0,0,7000,0,7000,7000
060429,南六永豐9A購01  ,0,0,0,0,0,0,0,0,0,7000,0,0,0,7000,0,7000,7000
060486,中租富邦9A購01  ,0,0,0,0,0,0,0,0,0,7000,0,0,0,7000,0,7000,7000
060514,南電元大9A購02  ,0,0,0,0,0,0,0,0,0,7000,0,0,0,7000,0,7000,7000
060808,欣興群益9A購01  ,0,0,0,0,0,0,0,0,0,7000,0,0,0,7000,0,7000,7000
06096P,全新永豐97售02  ,0,0,0,0,0,0,0,0,0,7000,0,0,0,7000,0,7000,7000
060918,康友國泰9C購01  ,0,0,0,0,0,0,0,0,0,7000,0,0,0,129000,122000,7000,7000
061018,台積電國票9B購05,0,0,0,0,0,0,0,0,0,7000,0,0,0,8000,1000,7000,7000
061046,上銀第一9A購01  ,0,0,0,0,0,0,0,0,0,7000,0,0,0,8000,1000,7000,7000
054180,亞泥康和96購01  ,0,0,0,0,0,0,0,0,0,7000,0,0,0,15000,8000,7000,7000
054043,漢唐元大97購01  ,0,0,0,0,0,0,0,0,0,7000,0,0,0,7000,0,7000,7000
054720,禾伸堂永豐97購01,0,0,0,0,0,0,0,0,0,7000,0,0,0,114000,107000,7000,7000
055179,大立光統一97購04,0,0,0,0,0,0,0,0,0,7000,0,0,0,7000,0,7000,7000
055627,亞德客永豐97購02,0,0,0,0,0,0,0,0,0,7000,0,0,0,8000,1000,7000,7000
058940,聯發科中信9A購03,0,0,0,0,0,0,0,0,0,7000,0,0,0,17000,10000,7000,7000
058938,台積電中信01購03,0,0,0,0,0,0,0,0,0,7000,0,0,0,7000,0,7000,7000
055336,茂林兆豐98購01  ,0,0,0,0,0,0,0,0,0,7000,0,0,0,9000,2000,7000,7000
055272,國巨元大98購04  ,0,0,0,0,0,0,0,0,0,7000,0,0,0,8000,1000,7000,7000
055264,國巨永豐98購01  ,0,0,0,0,0,0,0,0,0,7000,0,0,0,10000,3000,7000,7000
055344,國巨凱基97購04  ,0,0,0,0,0,0,0,0,0,7000,0,0,0,128000,121000,7000,7000
053579,華通元大97購01  ,0,0,0,0,0,0,0,0,0,7000,0,0,0,7000,0,7000,7000
05535P,台積電元大97售06,0,0,0,0,0,0,0,0,0,7000,0,0,0,7000,0,7000,7000
055508,矽力元大97購01  ,0,0,0,0,0,0,0,0,0,7000,0,0,0,7000,0,7000,7000
053304,可成凱基96購03  ,0,0,0,0,0,0,0,0,0,7000,0,0,0,51000,44000,7000,7000
052239,泰鼎國票97購01  ,0,0,0,0,0,0,0,0,0,7000,0,0,0,25000,18000,7000,7000
00657,國泰日經225     ,0,0,0,0,0,0,0,0,0,7000,0,0,0,125000,118000,7000,7000
048058,大立光國泰95購01,0,0,0,0,0,0,0,0,0,7000,0,0,0,7000,0,7000,7000
058289,奇鋐國票9A購01  ,0,0,0,0,0,0,0,0,0,7000,0,0,0,7000,0,7000,7000
057506,聯鈞國票99購02  ,0,0,0,0,0,0,0,0,0,7000,0,0,0,8000,1000,7000,7000
05818P,大立光凱基96售14,0,0,0,0,0,0,0,0,0,7000,0,0,0,7000,0,7000,7000
057975,台積電永豐98購05,0,0,0,0,0,0,0,0,0,7000,0,0,0,83000,76000,7000,7000
056191,世紀鋼統一97購01,0,0,0,0,0,0,0,0,0,7000,0,0,0,10000,3000,7000,7000
059397,T50反1元富99購05,0,0,0,0,0,0,0,0,0,7000,0,0,0,19000,12000,7000,7000
059199,欣興永豐99購02  ,0,0,0,0,0,0,0,0,0,7000,0,0,0,83000,76000,7000,7000
059616,滬深2X群益01購04,0,0,0,0,0,0,0,0,0,7000,0,0,0,7000,0,7000,7000
057366,智邦元大98購08  ,0,0,0,0,0,0,0,0,0,7000,0,0,0,8000,1000,7000,7000
057786,聯發科國票98購05,0,0,0,0,0,0,0,0,0,7000,0,0,0,7000,0,7000,7000
056505,聯發科永豐98購01,0,0,0,0,0,0,0,0,0,7000,0,0,0,7000,0,7000,7000
056532,技嘉凱基98購01  ,0,0,0,0,0,0,0,0,0,7000,0,0,0,7000,0,7000,7000
056681,鴻海統一98購09  ,0,0,0,0,0,0,0,0,0,7000,0,0,0,10000,3000,7000,7000
057649,嘉聯益元大99購04,0,0,0,0,0,0,0,0,0,7000,0,0,0,29000,22000,7000,7000
3266,昇陽            ,10000,3000,7000,0,0,0,0,0,0,0,0,0,0,0,0,0,7000
2227,裕日車          ,13000,6000,7000,0,0,0,0,0,0,0,0,0,0,0,0,0,7000
2206,三陽工業        ,137000,130000,7000,0,0,0,0,0,0,0,0,0,0,0,0,0,7000
6192,巨路            ,16000,9000,7000,0,0,0,0,0,0,0,0,0,0,0,0,0,7000
5283,禾聯碩          ,14000,7000,7000,0,0,0,0,0,0,0,0,0,0,0,0,0,7000
6698,旭暉應材        ,18000,18000,0,0,0,0,0,0,0,7000,7000,0,7000,0,0,0,7000
6504,南六            ,511049,430000,81049,0,0,0,0,112000,-112000,37000,35000,1000,34000,50000,47000,3000,6049
060523,鴻海中信9C購03  ,0,0,0,0,0,0,0,0,0,6000,0,0,0,9000,3000,6000,6000
060622,玉晶光元大9B購02,0,0,0,0,0,0,0,0,0,6000,0,0,0,83000,77000,6000,6000
060418,中橡永豐9A購01  ,0,0,0,0,0,0,0,0,0,6000,0,0,0,87000,81000,6000,6000
060442,滬深2X元大9A購02,0,0,0,0,0,0,0,0,0,6000,0,0,0,6000,0,6000,6000
060330,台灣50麥證9A購03,0,0,0,6000,0,6000,0,0,0,6000,0,0,0,6000,0,6000,6000
060294,嘉澤元大9A購01  ,0,0,0,0,0,0,0,0,0,6000,0,0,0,138000,132000,6000,6000
059822,聯發科凱基99購19,0,0,0,0,0,0,0,0,0,6000,0,0,0,6000,0,6000,6000
059997,華航元富99購01  ,0,0,0,0,0,0,0,0,0,6000,0,0,0,10000,4000,6000,6000
062074,旺宏元大9B購04  ,0,0,0,0,0,0,0,0,0,6000,0,0,0,8000,2000,6000,6000
06578P,華新科國票98售02,0,0,0,0,0,0,0,0,0,6000,0,0,0,6000,0,6000,6000
06582P,可成凱基98售06  ,0,0,0,0,0,0,0,0,0,6000,0,0,0,6000,0,6000,6000
06630P,國巨群益98售08  ,0,0,0,0,0,0,0,0,0,6000,0,0,0,12000,6000,6000,6000
06703P,新日興元富98售02,0,0,0,0,0,0,0,0,0,6000,0,0,0,6000,0,6000,6000
06673P,大立光群益98售01,0,0,0,0,0,0,0,0,0,6000,0,0,0,37000,31000,6000,6000
06667P,鴻海凱基98售11  ,0,0,0,0,0,0,0,0,0,6000,0,0,0,16000,10000,6000,6000
06656P,GIS元大98售02   ,0,0,0,0,0,0,0,0,0,6000,0,0,0,136000,130000,6000,6000
06141P,大立光日盛97售01,0,0,0,0,0,0,0,0,0,6000,0,0,0,6000,0,6000,6000
061342,華新科元大9A購17,0,0,0,0,0,0,0,0,0,6000,0,0,0,6000,0,6000,6000
061515,泰碩永豐9A購03  ,0,0,0,0,0,0,0,0,0,6000,0,0,0,6000,0,6000,6000
061602,旺宏凱基9A購06  ,0,0,0,0,0,0,0,0,0,6000,0,0,0,15000,9000,6000,6000
051089,旺宏元大96購04  ,0,0,0,0,0,0,0,0,0,6000,0,0,0,10000,4000,6000,6000
051250,大立光元大98購01,0,0,0,0,0,0,0,0,0,6000,0,0,0,6000,0,6000,6000
050548,華固凱基95購01  ,0,0,0,0,0,0,0,0,0,6000,0,0,0,6000,0,6000,6000
050614,聯發科元大95購04,0,0,0,0,0,0,0,0,0,6000,0,0,0,6000,0,6000,6000
049430,國巨國票95購02  ,0,0,0,0,0,0,0,0,0,6000,0,0,0,6000,0,6000,6000
049803,華新科元大95購07,0,0,0,0,0,0,0,0,0,6000,0,0,0,6000,0,6000,6000
050179,全新元大96購02  ,0,0,0,0,0,0,0,0,0,6000,0,0,0,6000,0,6000,6000
054636,華通中信97購01  ,0,0,0,0,0,0,0,0,0,6000,0,0,0,6000,0,6000,6000
055600,致伸元大97購02  ,0,0,0,0,0,0,0,0,0,6000,0,0,0,6000,0,6000,6000
058933,FBVIX台新9B購01 ,0,0,0,0,0,0,0,0,0,6000,0,0,0,6000,0,6000,6000
058985,可成凱基99購03  ,0,0,0,0,0,0,0,0,0,6000,0,0,0,10000,4000,6000,6000
058983,旺宏凱基99購05  ,0,0,0,0,0,0,0,0,0,6000,0,0,0,17000,11000,6000,6000
055234,昇陽半國票98購02,0,0,0,0,0,0,0,0,0,6000,0,0,0,90000,84000,6000,6000
055240,京元電元富97購01,0,0,0,0,0,0,0,0,0,6000,0,0,0,113000,107000,6000,6000
053496,義隆兆豐96購02  ,0,0,0,0,0,0,0,0,0,6000,0,0,0,20000,14000,6000,6000
053785,聯詠元大96購05  ,0,0,0,0,0,0,0,0,0,6000,0,0,0,6000,0,6000,6000
054968,佐登元大97購01  ,0,0,0,0,0,0,0,0,0,6000,0,0,0,6000,0,6000,6000
058556,百和永豐99購01  ,0,0,0,0,0,0,0,0,0,6000,0,0,0,6000,0,6000,6000
056785,可成群益99購01  ,0,0,0,0,0,0,0,0,0,6000,0,0,0,6000,0,6000,6000
058476,旺宏凱基9A購01  ,0,0,0,0,0,0,0,0,0,6000,0,0,0,6000,0,6000,6000
056429,華通凱基98購02  ,0,0,0,0,0,0,0,0,0,6000,0,0,0,6000,0,6000,6000
056360,智邦元大98購01  ,0,0,0,0,0,0,0,0,0,6000,0,0,0,7000,1000,6000,6000
057266,TPK兆豐98購02   ,0,0,0,0,0,0,0,0,0,6000,0,0,0,6000,0,6000,6000
057468,台郡永豐98購01  ,0,0,0,0,0,0,0,0,0,6000,0,0,0,6000,0,6000,6000
056940,嘉聯益元富98購01,0,0,0,0,0,0,0,0,0,6000,0,0,0,6000,0,6000,6000
059223,大立光元大99購14,0,0,0,0,0,0,0,0,0,6000,0,0,0,10000,4000,6000,6000
058028,國巨富邦99購04  ,0,0,0,0,0,0,0,0,0,6000,0,0,0,6000,0,6000,6000
058011,台虹國票99購01  ,0,0,0,0,0,0,0,0,0,6000,0,0,0,6000,0,6000,6000
058020,大立光凱基99購03,0,0,0,0,0,0,0,0,0,6000,0,0,0,6000,0,6000,6000
058101,台積電富邦9C購01,0,0,0,0,0,0,0,0,0,6000,0,0,0,6000,0,6000,6000
055930,可成群益98購01  ,0,0,0,0,0,0,0,0,0,6000,0,0,0,6000,0,6000,6000
058310,大立光元大99購10,0,0,0,0,0,0,0,0,0,6000,0,0,0,6000,0,6000,6000
058315,TPK富邦9C購01   ,0,0,0,0,0,0,0,0,0,6000,0,0,0,26000,20000,6000,6000
6581,鋼聯            ,9000,3000,6000,0,0,0,0,0,0,0,0,0,0,0,0,0,6000
6136,富爾特          ,6000,0,6000,0,0,0,0,0,0,0,0,0,0,0,0,0,6000
4722,國精化          ,20000,14000,6000,0,0,0,0,0,0,0,0,0,0,0,0,0,6000
2228,劍麟            ,71000,65000,6000,0,0,0,0,0,0,0,0,0,0,0,0,0,6000
2028,威致            ,10000,4000,6000,0,0,0,0,0,0,0,0,0,0,0,0,0,6000
1454,台富            ,6000,0,6000,0,0,0,0,0,0,0,0,0,0,0,0,0,6000
1529,樂士            ,0,1000,-1000,0,0,0,0,0,0,7000,7000,0,7000,0,0,0,6000
3694,海華            ,12000,6000,6000,0,0,0,0,0,0,0,0,0,0,0,0,0,6000
3665,貿聯-KY         ,114000,152000,-38000,0,0,0,0,0,0,44000,25000,0,25000,27000,8000,19000,6000
3056,總太            ,60000,54000,6000,0,0,0,0,0,0,0,0,0,0,0,0,0,6000
07059P,華通國票9A售02  ,0,0,0,0,0,0,0,0,0,6000,0,0,0,16000,10000,6000,6000
07158P,FBVIX國泰9C售01 ,0,0,0,0,0,0,0,0,0,6000,0,0,0,6000,0,6000,6000
07249P,T50正2富邦03售02,0,0,0,0,0,0,0,0,0,6000,0,0,0,6000,0,6000,6000
07490P,大立光國票9A售03,0,0,0,0,0,0,0,0,0,6000,0,0,0,10000,4000,6000,6000
07865P,可成元大9B售02  ,0,0,0,0,0,0,0,0,0,6000,0,0,0,6000,0,6000,6000
07799P,南電國票9A售04  ,0,0,0,0,0,0,0,0,0,6000,0,0,0,6000,0,6000,6000
07710P,華擎元大9A售05  ,0,0,0,0,0,0,0,0,0,6000,0,0,0,11000,5000,6000,6000
061599,元金反中信9C購01,0,0,0,0,0,0,0,0,0,5000,0,0,0,10000,5000,5000,5000
061731,旺宏統一9B購06  ,0,0,0,0,0,0,0,0,0,5000,0,0,0,57000,52000,5000,5000
06649P,聯發科元大98售08,0,0,0,0,0,0,0,0,0,5000,0,0,0,5000,0,5000,5000
06600P,貿聯永豐98售01  ,0,0,0,0,0,0,0,0,0,5000,0,0,0,15000,10000,5000,5000
06509P,鴻海群益98售03  ,0,0,0,0,0,0,0,0,0,5000,0,0,0,5000,0,5000,5000
06492P,上銀永豐98售01  ,0,0,0,0,0,0,0,0,0,5000,0,0,0,5000,0,5000,5000
06887P,華新科元大98售04,0,0,0,0,0,0,0,0,0,5000,0,0,0,5000,0,5000,5000
06738P,瑞昱兆豐98售02  ,0,0,0,0,0,0,0,0,0,5000,0,0,0,5000,0,5000,5000
06850P,聯茂元大98售06  ,0,0,0,0,0,0,0,0,0,5000,0,0,0,10000,5000,5000,5000
062028,晶技群益9B購01  ,0,0,0,0,0,0,0,0,0,5000,0,0,0,41000,36000,5000,5000
061918,上銀凱基9B購02  ,0,0,0,0,0,0,0,0,0,5000,0,0,0,5000,0,5000,5000
061932,上銀國票9B購01  ,0,0,0,0,0,0,0,0,0,5000,0,0,0,5000,0,5000,5000
061973,上銀元大9B購01  ,0,0,0,0,0,0,0,0,0,5000,0,0,0,5000,0,5000,5000
061961,台積電統一01購02,0,0,0,0,0,0,0,0,0,5000,0,0,0,5000,0,5000,5000
061957,上銀統一01購01  ,0,0,0,0,0,0,0,0,0,5000,0,0,0,10000,5000,5000,5000
059972,S&P正2元大99購03,0,0,0,0,0,0,0,0,0,5000,0,0,0,5000,0,5000,5000
059966,台積電凱基99購19,0,0,0,0,0,0,0,0,0,5000,0,0,0,5000,0,5000,5000
060063,可成兆豐9B購01  ,0,0,0,0,0,0,0,0,0,5000,0,0,0,5000,0,5000,5000
059176,臺股指凱基99購27,0,0,0,0,0,0,0,0,0,5000,0,0,0,38000,33000,5000,5000
059903,S&P正2元大99購02,0,0,0,0,0,0,0,0,0,5000,0,0,0,5000,0,5000,5000
059883,T50反1國票99購02,0,0,0,0,0,0,0,0,0,5000,0,0,0,30000,25000,5000,5000
060286,佳世達元大9C購01,0,0,0,0,0,0,0,0,0,5000,0,0,0,10000,5000,5000,5000
060302,台積電富邦02購01,0,0,0,0,0,0,0,0,0,5000,0,0,0,167000,162000,5000,5000
060201,台表科元富9A購01,0,0,0,0,0,0,0,0,0,5000,0,0,0,5000,0,5000,5000
06035P,同欣電凱基96售03,0,0,0,0,0,0,0,0,0,5000,0,0,0,10000,5000,5000,5000
060389,世紀鋼凱基9B購02,0,0,0,0,0,0,0,0,0,5000,0,0,0,5000,0,5000,5000
060452,儒鴻元大9A購01  ,0,0,0,0,0,0,0,0,0,5000,0,0,0,10000,5000,5000,5000
060428,瑞祺永豐9A購01  ,0,0,0,0,0,0,0,0,0,5000,0,0,0,315000,310000,5000,5000
060564,南亞科富邦9C購01,0,0,0,0,0,0,0,0,0,5000,0,0,0,5000,0,5000,5000
060532,欣興中信9A購01  ,0,0,0,0,0,0,0,0,0,5000,0,0,0,48000,43000,5000,5000
060541,正隆凱基9A購01  ,0,0,0,0,0,0,0,0,0,5000,0,0,0,5000,0,5000,5000
06050P,玉晶光國票98售01,0,0,0,0,0,0,0,0,0,5000,0,0,0,5000,0,5000,5000
060662,旺宏凱基9A購03  ,0,0,0,0,0,0,0,0,0,5000,0,0,0,5000,0,5000,5000
060682,牧德元大9A購03  ,0,0,0,0,0,0,0,0,0,5000,0,0,0,629000,624000,5000,5000
061015,旺宏麥證9A購03  ,0,0,0,5000,0,5000,0,0,0,5000,0,0,0,5000,0,5000,5000
06089P,矽創永豐97售01  ,0,0,0,0,0,0,0,0,0,5000,0,0,0,5000,0,5000,5000
053969,瑞昱元大97購01  ,0,0,0,0,0,0,0,0,0,5000,0,0,0,5000,0,5000,5000
054128,台積電元大97購10,0,0,0,0,0,0,0,0,0,5000,0,0,0,5000,0,5000,5000
054266,緯穎元大96購07  ,0,0,0,0,0,0,0,0,0,5000,0,0,0,10000,5000,5000,5000
054294,世芯元大96購02  ,0,0,0,0,0,0,0,0,0,5000,0,0,0,5000,0,5000,5000
054790,禾伸堂群益98購01,0,0,0,0,0,0,0,0,0,5000,0,0,0,5000,0,5000,5000
053524,聯電中信97購02  ,0,0,0,0,0,0,0,0,0,5000,0,0,0,5000,0,5000,5000
054857,信錦群益97購01  ,0,0,0,0,0,0,0,0,0,5000,0,0,0,5000,0,5000,5000
054866,宏盛群益98購01  ,0,0,0,0,0,0,0,0,0,5000,0,0,0,5000,0,5000,5000
053370,上証2X元大97購03,0,0,0,0,0,0,0,0,0,5000,0,0,0,5000,0,5000,5000
055220,緯穎凱基98購02  ,0,0,0,0,0,0,0,0,0,5000,0,0,0,5000,0,5000,5000
053392,致新元大96購01  ,0,0,0,0,0,0,0,0,0,5000,0,0,0,5000,0,5000,5000
053404,致新群益96購01  ,0,0,0,0,0,0,0,0,0,5000,0,0,0,5000,0,5000,5000
058968,T50正2永豐99購01,0,0,0,0,0,0,0,0,0,5000,0,0,0,10000,5000,5000,5000
058924,晶相光元富99購02,0,0,0,0,0,0,0,0,0,5000,0,0,0,5000,0,5000,5000
058793,鴻海元大99購19  ,0,0,0,0,0,0,0,0,0,5000,0,0,0,5000,0,5000,5000
055552,瑞昱凱基97購02  ,0,0,0,0,0,0,0,0,0,5000,0,0,0,5000,0,5000,5000
055143,臻鼎永豐97購01  ,0,0,0,0,0,0,0,0,0,5000,0,0,0,5000,0,5000,5000
055384,緯穎元大98購02  ,0,0,0,0,0,0,0,0,0,5000,0,0,0,5000,0,5000,5000
055471,聯發科凱基97購04,0,0,0,0,0,0,0,0,0,5000,0,0,0,5000,0,5000,5000
05529P,臺股指群益96售02,0,0,0,0,0,0,0,0,0,5000,0,0,0,10000,5000,5000,5000
055120,南港兆豐97購01  ,0,0,0,0,0,0,0,0,0,5000,0,0,0,5000,0,5000,5000
055139,欣興永豐97購01  ,0,0,0,0,0,0,0,0,0,5000,0,0,0,5000,0,5000,5000
053621,臺股指群益96購07,0,0,0,0,0,0,0,0,0,5000,0,0,0,10000,5000,5000,5000
054641,祥碩中信98購01  ,0,0,0,0,0,0,0,0,0,5000,0,0,0,20000,15000,5000,5000
054589,聯鈞國泰99購01  ,0,0,0,0,0,0,0,0,0,5000,0,0,0,5000,0,5000,5000
05454P,奇鋐群益95售04  ,0,0,0,0,0,0,0,0,0,5000,0,0,0,5000,0,5000,5000
053184,世紀鋼元富96購01,0,0,0,0,0,0,0,0,0,5000,0,0,0,5000,0,5000,5000
053168,晶技群益98購01  ,0,0,0,0,0,0,0,0,0,5000,0,0,0,5000,0,5000,5000
051987,廣達元大95購01  ,0,0,0,0,0,0,0,0,0,5000,0,0,0,5000,0,5000,5000
051673,玉晶光元大96購04,0,0,0,0,0,0,0,0,0,5000,0,0,0,5000,0,5000,5000
051956,滬深2X台新96購01,0,0,0,0,0,0,0,0,0,5000,0,0,0,5000,0,5000,5000
052184,台光電群益95購03,0,0,0,0,0,0,0,0,0,5000,0,0,0,5000,0,5000,5000
052418,玉晶光兆豐96購01,0,0,0,0,0,0,0,0,0,5000,0,0,0,5000,0,5000,5000
052690,台表科元大97購01,0,0,0,0,0,0,0,0,0,5000,0,0,0,5000,0,5000,5000
052488,旺宏國票96購03  ,0,0,0,0,0,0,0,0,0,5000,0,0,0,5000,0,5000,5000
052741,聯發科元大96購08,0,0,0,0,0,0,0,0,0,5000,0,0,0,5000,0,5000,5000
052759,京元電群益96購01,0,0,0,0,0,0,0,0,0,5000,0,0,0,5000,0,5000,5000
051995,矽力元大95購03  ,0,0,0,0,0,0,0,0,0,5000,0,0,0,5000,0,5000,5000
052816,上銀永豐96購01  ,0,0,0,0,0,0,0,0,0,5000,0,0,0,5000,0,5000,5000
052060,旺宏國票96購02  ,0,0,0,0,0,0,0,0,0,5000,0,0,0,5000,0,5000,5000
049527,國巨中信95購01  ,0,0,0,0,0,0,0,0,0,5000,0,0,0,5000,0,5000,5000
050460,GIS元大95購03   ,0,0,0,0,0,0,0,0,0,5000,0,0,0,5000,0,5000,5000
0054,元大台商50      ,0,0,0,0,0,0,0,0,0,5000,0,0,0,31000,26000,5000,5000
051103,緯穎元大96購03  ,0,0,0,0,0,0,0,0,0,5000,0,0,0,5000,0,5000,5000
047196,上銀統一97購01  ,0,0,0,0,0,0,0,0,0,5000,0,0,0,5000,0,5000,5000
052893,聯電群益98購01  ,0,0,0,0,0,0,0,0,0,5000,0,0,0,71000,66000,5000,5000
058314,欣興富邦9B購01  ,0,0,0,0,0,0,0,0,0,5000,0,0,0,7000,2000,5000,5000
058311,緯穎元大99購05  ,0,0,0,0,0,0,0,0,0,5000,0,0,0,5000,0,5000,5000
058304,鴻海元大99購12  ,0,0,0,0,0,0,0,0,0,5000,0,0,0,10000,5000,5000,5000
058305,華邦電元大99購02,0,0,0,0,0,0,0,0,0,5000,0,0,0,5000,0,5000,5000
058256,臺股指元大9A購20,0,0,0,0,0,0,0,0,0,5000,0,0,0,5000,0,5000,5000
058380,臺股指凱基99購15,0,0,0,0,0,0,0,0,0,5000,0,0,0,5000,0,5000,5000
058364,奇力新凱基99購04,0,0,0,0,0,0,0,0,0,5000,0,0,0,5000,0,5000,5000
056135,緯創元大98購01  ,0,0,0,0,0,0,0,0,0,5000,0,0,0,5000,0,5000,5000
056113,新日興兆豐98購01,0,0,0,0,0,0,0,0,0,5000,0,0,0,5000,0,5000,5000
05614P,臺股指康和96售03,0,0,0,0,0,0,0,0,0,5000,0,0,0,5000,0,5000,5000
056074,茂林元大97購04  ,0,0,0,0,0,0,0,0,0,5000,0,0,0,5000,0,5000,5000
057918,旺宏凱基99購01  ,0,0,0,0,0,0,0,0,0,5000,0,0,0,46000,41000,5000,5000
057233,聯發科凱基98購14,0,0,0,0,0,0,0,0,0,5000,0,0,0,5000,0,5000,5000
058164,FBVIX凱基03購02 ,0,0,0,0,0,0,0,0,0,5000,0,0,0,10000,5000,5000,5000
058084,大立光群益98購04,0,0,0,0,0,0,0,0,0,5000,0,0,0,5000,0,5000,5000
058023,南電凱基98購02  ,0,0,0,0,0,0,0,0,0,5000,0,0,0,18000,13000,5000,5000
059385,滬深2X凱基9C購03,0,0,0,0,0,0,0,0,0,5000,0,0,0,5000,0,5000,5000
059164,旺宏凱基99購06  ,0,0,0,0,0,0,0,0,0,5000,0,0,0,5000,0,5000,5000
059255,臺股指凱基99購33,0,0,0,0,0,0,0,0,0,5000,0,0,0,10000,5000,5000,5000
059287,華通元富99購03  ,0,0,0,0,0,0,0,0,0,5000,0,0,0,5000,0,5000,5000
059361,玉晶光永豐99購04,0,0,0,0,0,0,0,0,0,5000,0,0,0,6000,1000,5000,5000
059364,昇陽半永豐99購02,0,0,0,0,0,0,0,0,0,5000,0,0,0,45000,40000,5000,5000
059596,大立光元大99購20,0,0,0,0,0,0,0,0,0,5000,0,0,0,5000,0,5000,5000
059530,華新科凱基9A購05,0,0,0,0,0,0,0,0,0,5000,0,0,0,5000,0,5000,5000
059617,A50正2群益01購02,0,0,0,0,0,0,0,0,0,5000,0,0,0,5000,0,5000,5000
059716,鴻海元大99購35  ,0,0,0,0,0,0,0,0,0,5000,0,0,0,10000,5000,5000,5000
056936,禾伸堂元富98購01,0,0,0,0,0,0,0,0,0,5000,0,0,0,5000,0,5000,5000
057853,旺宏國票99購05  ,0,0,0,0,0,0,0,0,0,5000,0,0,0,5000,0,5000,5000
057341,技嘉台新98購01  ,0,0,0,0,0,0,0,0,0,5000,0,0,0,43000,38000,5000,5000
056347,GIS凱基9A購01   ,0,0,0,0,0,0,0,0,0,5000,0,0,0,5000,0,5000,5000
056343,高鐵凱基98購02  ,0,0,0,0,0,0,0,0,0,5000,0,0,0,5000,0,5000,5000
05632P,大立光群益96售02,0,0,0,0,0,0,0,0,0,5000,0,0,0,5000,0,5000,5000
056311,泰鼎元大98購01  ,0,0,0,0,0,0,0,0,0,5000,0,0,0,5000,0,5000,5000
057806,國巨元大98購20  ,0,0,0,0,0,0,0,0,0,5000,0,0,0,5000,0,5000,5000
056644,宏達電凱基98購04,0,0,0,0,0,0,0,0,0,5000,0,0,0,50000,45000,5000,5000
055714,智邦元大97購03  ,0,0,0,0,0,0,0,0,0,5000,0,0,0,6000,1000,5000,5000
056622,高鐵永豐98購01  ,0,0,0,0,0,0,0,0,0,5000,0,0,0,73000,68000,5000,5000
055758,旺宏群益97購01  ,0,0,0,0,0,0,0,0,0,5000,0,0,0,5000,0,5000,5000
05861P,瀚宇博永豐96售02,0,0,0,0,0,0,0,0,0,5000,0,0,0,5000,0,5000,5000
058708,臺股指元大9A購21,0,0,0,0,0,0,0,0,0,5000,0,0,0,5000,0,5000,5000
058585,S&P正2中信9B購02,0,0,0,0,0,0,0,0,0,5000,0,0,0,5000,0,5000,5000
058600,國巨元大99購15  ,0,0,0,0,0,0,0,0,0,5000,0,0,0,5000,0,5000,5000
058540,嘉聯益國泰9A購02,0,0,0,0,0,0,0,0,0,5000,0,0,0,29000,24000,5000,5000
07719P,臺股指群益9A售08,0,0,0,0,0,0,0,0,0,5000,0,0,0,10000,5000,5000,5000
07761P,智邦永豐9A售03  ,0,0,0,0,0,0,0,0,0,5000,0,0,0,5000,0,5000,5000
07619P,鴻海統一9A售03  ,0,0,0,0,0,0,0,0,0,5000,0,0,0,5000,0,5000,5000
07559P,祥碩元大9A售03  ,0,0,0,0,0,0,0,0,0,5000,0,0,0,35000,30000,5000,5000
07529P,國巨凱基9A售11  ,0,0,0,0,0,0,0,0,0,5000,0,0,0,15000,10000,5000,5000
07539P,玉山金台新9A售01,0,0,0,0,0,0,0,0,0,5000,0,0,0,5000,0,5000,5000
07547P,緯穎凱基9A售05  ,0,0,0,0,0,0,0,0,0,5000,0,0,0,5000,0,5000,5000
07439P,臺股指麥證9B售01,0,0,0,10000,5000,5000,0,0,0,5000,0,0,0,10000,5000,5000,5000
07257P,臺股指凱基99售37,0,0,0,0,0,0,0,0,0,5000,0,0,0,15000,10000,5000,5000
07362P,聯發科元大99售35,0,0,0,0,0,0,0,0,0,5000,0,0,0,5000,0,5000,5000
07333P,台灣50國票9B售03,0,0,0,0,0,0,0,0,0,5000,0,0,0,5000,0,5000,5000
07233P,台灣50元大99售04,0,0,0,0,0,0,0,0,0,5000,0,0,0,15000,10000,5000,5000
07049P,聯發科中信99售03,0,0,0,0,0,0,0,0,0,5000,0,0,0,71000,66000,5000,5000
3167,大量            ,8000,3000,5000,0,0,0,0,0,0,0,0,0,0,0,0,0,5000
2460,建通            ,7000,2000,5000,0,0,0,0,0,0,0,0,0,0,0,0,0,5000
2882A,國泰特          ,0,5000,-5000,0,0,0,0,0,0,10000,10000,0,10000,0,0,0,5000
1513,中興電          ,350000,371000,-21000,0,0,0,0,0,0,26000,0,0,0,26000,0,26000,5000
1521,大億            ,5000,0,5000,0,0,0,0,0,0,0,0,0,0,0,0,0,5000
1436,華友聯          ,6000,1000,5000,0,0,0,0,0,0,0,0,0,0,0,0,0,5000
1616,億泰            ,7000,2000,5000,0,0,0,0,0,0,0,0,0,0,0,0,0,5000
2305,全友            ,12000,7000,5000,0,0,0,0,0,0,0,0,0,0,0,0,0,5000
060877,華邦電中信02購01,0,0,0,0,0,0,0,0,0,4000,0,0,0,10000,6000,4000,4000
060295,貿聯元大9A購03  ,0,0,0,0,0,0,0,0,0,4000,0,0,0,9000,5000,4000,4000
06869P,金融類元大99售01,0,0,0,0,0,0,0,0,0,4000,0,0,0,5000,1000,4000,4000
06528P,台積電富邦99售03,0,0,0,0,0,0,0,0,0,4000,0,0,0,4000,0,4000,4000
061792,和大永豐9B購01  ,0,0,0,0,0,0,0,0,0,4000,0,0,0,4000,0,4000,4000
061489,高鐵兆豐9A購01  ,0,0,0,0,0,0,0,0,0,4000,0,0,0,4000,0,4000,4000
048509,上証反凱基99購02,0,0,0,0,0,0,0,0,0,4000,0,0,0,4000,0,4000,4000
049252,國巨元大96購01  ,0,0,0,0,0,0,0,0,0,4000,0,0,0,4000,0,4000,4000
050049,華通群益96購01  ,0,0,0,0,0,0,0,0,0,4000,0,0,0,4000,0,4000,4000
052784,緯穎國票97購02  ,0,0,0,0,0,0,0,0,0,4000,0,0,0,4000,0,4000,4000
052456,滬深2X元富9B購03,0,0,0,0,0,0,0,0,0,4000,0,0,0,4000,0,4000,4000
052527,泰鼎元大96購02  ,0,0,0,0,0,0,0,0,0,4000,0,0,0,4000,0,4000,4000
052529,力成元大95購03  ,0,0,0,0,0,0,0,0,0,4000,0,0,0,21000,17000,4000,4000
051483,玉晶光凱基96購02,0,0,0,0,0,0,0,0,0,4000,0,0,0,31000,27000,4000,4000
052252,大立光永豐95購03,0,0,0,0,0,0,0,0,0,4000,0,0,0,4000,0,4000,4000
053132,國巨國票97購02  ,0,0,0,0,0,0,0,0,0,4000,0,0,0,27000,23000,4000,4000
053063,力山群益98購01  ,0,0,0,0,0,0,0,0,0,4000,0,0,0,74000,70000,4000,4000
055090,國巨群益97購03  ,0,0,0,0,0,0,0,0,0,4000,0,0,0,125000,121000,4000,4000
055357,欣興凱基97購04  ,0,0,0,0,0,0,0,0,0,4000,0,0,0,4000,0,4000,4000
058813,旺宏統一9B購04  ,0,0,0,0,0,0,0,0,0,4000,0,0,0,40000,36000,4000,4000
058923,華新科元富99購06,0,0,0,0,0,0,0,0,0,4000,0,0,0,4000,0,4000,4000
058855,台積電兆豐99購02,0,0,0,0,0,0,0,0,0,4000,0,0,0,4000,0,4000,4000
054768,泰碩國票99購02  ,0,0,0,0,0,0,0,0,0,4000,0,0,0,26000,22000,4000,4000
053356,聯發科統一96購07,0,0,0,0,0,0,0,0,0,4000,0,0,0,4000,0,4000,4000
053361,友達元富99購01  ,0,0,0,0,0,0,0,0,0,4000,0,0,0,4000,0,4000,4000
055230,大毅國票98購01  ,0,0,0,0,0,0,0,0,0,4000,0,0,0,6000,2000,4000,4000
054837,欣興第一97購01  ,0,0,0,0,0,0,0,0,0,4000,0,0,0,4000,0,4000,4000
053450,同欣電凱基96購02,0,0,0,0,0,0,0,0,0,4000,0,0,0,4000,0,4000,4000
053466,華通元大98購01  ,0,0,0,0,0,0,0,0,0,4000,0,0,0,4000,0,4000,4000
054158,國巨日盛99購01  ,0,0,0,0,0,0,0,0,0,4000,0,0,0,8000,4000,4000,4000
055790,南電凱基97購01  ,0,0,0,0,0,0,0,0,0,4000,0,0,0,4000,0,4000,4000
056611,國巨永豐98購03  ,0,0,0,0,0,0,0,0,0,4000,0,0,0,127000,123000,4000,4000
057600,大立光群益99購03,0,0,0,0,0,0,0,0,0,4000,0,0,0,5000,1000,4000,4000
057626,技嘉富邦9A購01  ,0,0,0,0,0,0,0,0,0,4000,0,0,0,4000,0,4000,4000
056292,統一元大97購01  ,0,0,0,0,0,0,0,0,0,4000,0,0,0,4000,0,4000,4000
056470,旺宏元大99購01  ,0,0,0,0,0,0,0,0,0,4000,0,0,0,7000,3000,4000,4000
056496,康控國泰99購01  ,0,0,0,0,0,0,0,0,0,4000,0,0,0,5000,1000,4000,4000
056576,晶技元大99購02  ,0,0,0,0,0,0,0,0,0,4000,0,0,0,5000,1000,4000,4000
057427,華通兆豐99購01  ,0,0,0,0,0,0,0,0,0,4000,0,0,0,4000,0,4000,4000
059640,聯詠凱基99購04  ,0,0,0,0,0,0,0,0,0,4000,0,0,0,101000,97000,4000,4000
059663,旭富元大9C購02  ,0,0,0,0,0,0,0,0,0,4000,0,0,0,14000,10000,4000,4000
059747,台達電台新99購01,0,0,0,0,0,0,0,0,0,4000,0,0,0,48000,44000,4000,4000
059537,大立光凱基99購09,0,0,0,0,0,0,0,0,0,4000,0,0,0,50000,46000,4000,4000
059292,華新科元富9B購02,0,0,0,0,0,0,0,0,0,4000,0,0,0,7000,3000,4000,4000
059137,電子類群益99購01,0,0,0,0,0,0,0,0,0,4000,0,0,0,4000,0,4000,4000
055658,南電元富97購01  ,0,0,0,0,0,0,0,0,0,4000,0,0,0,7000,3000,4000,4000
059399,滬深2X元富9C購03,0,0,0,0,0,0,0,0,0,4000,0,0,0,4000,0,4000,4000
059212,鴻海元大99購28  ,0,0,0,0,0,0,0,0,0,4000,0,0,0,29000,25000,4000,4000
057531,禾伸堂元大99購04,0,0,0,0,0,0,0,0,0,4000,0,0,0,10000,6000,4000,4000
05706P,TPK永豐96售02   ,0,0,0,0,0,0,0,0,0,4000,0,0,0,4000,0,4000,4000
1726,永記            ,4000,0,4000,0,0,0,0,0,0,0,0,0,0,0,0,0,4000
1442,名軒            ,21000,17000,4000,0,0,0,0,0,0,0,0,0,0,0,0,0,4000
1528,恩德            ,8000,4000,4000,0,0,0,0,0,0,0,0,0,0,0,0,0,4000
2497,怡利電          ,4000,0,4000,0,0,0,0,0,0,0,0,0,0,0,0,0,4000
3024,憶聲            ,11000,7000,4000,0,0,0,0,0,0,0,0,0,0,0,0,0,4000
07121P,華新科凱基99售03,0,0,0,0,0,0,0,0,0,4000,0,0,0,4000,0,4000,4000
07280P,FBVIX凱基99售01 ,0,0,0,0,0,0,0,0,0,4000,0,0,0,4000,0,4000,4000
07901P,臺股指凱基9B售04,0,0,0,0,0,0,0,0,0,4000,0,0,0,4000,0,4000,4000
5525,順天            ,7000,3000,4000,0,0,0,0,0,0,0,0,0,0,0,0,0,4000
6115,鎰勝            ,22000,18000,4000,0,0,0,0,0,0,0,0,0,0,0,0,0,4000
6281,全國電          ,6000,2000,4000,0,0,0,0,0,0,0,0,0,0,0,0,0,4000
8499,鼎炫-KY         ,9000,12000,-3000,0,0,0,7000,0,7000,0,0,0,0,0,0,0,4000
9911,櫻花            ,66000,62000,4000,0,0,0,0,0,0,0,0,0,0,0,0,0,4000
061502,嘉澤國票9A購02  ,0,0,0,0,0,0,0,0,0,3000,0,0,0,3000,0,3000,3000
061568,國巨元大9A購25  ,0,0,0,0,0,0,0,0,0,3000,0,0,0,40000,37000,3000,3000
061795,智邦永豐9B購01  ,0,0,0,0,0,0,0,0,0,3000,0,0,0,13000,10000,3000,3000
061355,康友元大9A購03  ,0,0,0,0,0,0,0,0,0,3000,0,0,0,23000,20000,3000,3000
061403,滬深2X國票9A購06,0,0,0,0,0,0,0,0,0,3000,0,0,0,3000,0,3000,3000
061422,台積電元大9A購30,0,0,0,0,0,0,0,0,0,3000,0,0,0,30000,27000,3000,3000
061207,美律元大9A購04  ,0,0,0,0,0,0,0,0,0,3000,0,0,0,75000,72000,3000,3000
061217,臺股指元大9A購54,0,0,0,0,0,0,0,0,0,3000,0,0,0,3000,0,3000,3000
06912P,台光電元大99售02,0,0,0,0,0,0,0,0,0,3000,0,0,0,3000,0,3000,3000
061945,華通群益9B購04  ,0,0,0,0,0,0,0,0,0,3000,0,0,0,3000,0,3000,3000
060219,聯發科凱基9A購09,0,0,0,0,0,0,0,0,0,3000,0,0,0,3000,0,3000,3000
060353,A50正2元富9A購01,0,0,0,0,0,0,0,0,0,3000,0,0,0,3000,0,3000,3000
059993,上銀元富99購01  ,0,0,0,0,0,0,0,0,0,3000,0,0,0,3000,0,3000,3000
060846,欣興國票9A購02  ,0,0,0,0,0,0,0,0,0,3000,0,0,0,95000,92000,3000,3000
061040,康友永豐9A購01  ,0,0,0,0,0,0,0,0,0,3000,0,0,0,10000,7000,3000,3000
060801,滬深2X中信01購01,0,0,0,0,0,0,0,0,0,3000,0,0,0,3000,0,3000,3000
060773,FBVIX凱基9A購04 ,0,0,0,0,0,0,0,0,0,3000,0,0,0,5000,2000,3000,3000
060508,聯發科元大9A購04,0,0,0,0,0,0,0,0,0,3000,0,0,0,3000,0,3000,3000
060481,巨大元大9A購01  ,0,0,0,0,0,0,0,0,0,3000,0,0,0,23000,20000,3000,3000
060533,臺股指中信9B購05,0,0,0,0,0,0,0,0,0,3000,0,0,0,3000,0,3000,3000
060589,台灣50台新9B購06,0,0,0,0,0,0,0,0,0,3000,0,0,0,3000,0,3000,3000
054170,泰鼎凱基98購01  ,0,0,0,0,0,0,0,0,0,3000,0,0,0,3000,0,3000,3000
053791,同欣電元大96購05,0,0,0,0,0,0,0,0,0,3000,0,0,0,3000,0,3000,3000
055039,神達富邦99購01  ,0,0,0,0,0,0,0,0,0,3000,0,0,0,3000,0,3000,3000
053523,T50反1中信9A購01,0,0,0,0,0,0,0,0,0,3000,0,0,0,3000,0,3000,3000
054908,群電康和97購01  ,0,0,0,0,0,0,0,0,0,3000,0,0,0,3000,0,3000,3000
058865,群創凱基01購01  ,0,0,0,0,0,0,0,0,0,3000,0,0,0,71000,68000,3000,3000
055652,聯詠元富01購01  ,0,0,0,0,0,0,0,0,0,3000,0,0,0,72000,69000,3000,3000
05533P,滬深2X富邦97售01,0,0,0,0,0,0,0,0,0,3000,0,0,0,3000,0,3000,3000
055326,緯穎國票97購06  ,0,0,0,0,0,0,0,0,0,3000,0,0,0,3000,0,3000,3000
053624,A50正2兆豐97購02,0,0,0,0,0,0,0,0,0,3000,0,0,0,8000,5000,3000,3000
055474,欣興凱基97購05  ,0,0,0,0,0,0,0,0,0,3000,0,0,0,3000,0,3000,3000
055418,華通永豐97購01  ,0,0,0,0,0,0,0,0,0,3000,0,0,0,3000,0,3000,3000
055407,祥碩國泰98購01  ,0,0,0,0,0,0,0,0,0,3000,0,0,0,3000,0,3000,3000
051982,深中小元大95購01,0,0,0,0,0,0,0,0,0,3000,0,0,0,3000,0,3000,3000
051775,旺宏亞東95購01  ,0,0,0,0,0,0,0,0,0,3000,0,0,0,102000,99000,3000,3000
051736,旺宏國票96購01  ,0,0,0,0,0,0,0,0,0,3000,0,0,0,3000,0,3000,3000
054565,玉晶光群益99購02,0,0,0,0,0,0,0,0,0,3000,0,0,0,3000,0,3000,3000
052385,滬深2X群益99購05,0,0,0,0,0,0,0,0,0,3000,0,0,0,3000,0,3000,3000
052113,漢唐中信98購01  ,0,0,0,0,0,0,0,0,0,3000,0,0,0,3000,0,3000,3000
050096,國巨國泰95購05  ,0,0,0,0,0,0,0,0,0,3000,0,0,0,3000,0,3000,3000
049955,崇越群益95購01  ,0,0,0,0,0,0,0,0,0,3000,0,0,0,3000,0,3000,3000
049501,台郡元大95購01  ,0,0,0,0,0,0,0,0,0,3000,0,0,0,3000,0,3000,3000
03425B,臺股指元大9A熊01,0,0,0,0,0,0,0,0,0,3000,0,0,0,3000,0,3000,3000
00742,新光內需收益    ,0,0,0,0,0,0,0,0,0,3000,0,0,0,103000,100000,3000,3000
00666R,富邦恒生國企反1 ,0,32000,-32000,0,0,0,0,0,0,35000,0,0,0,115000,80000,35000,3000
00865B,國泰US短期公債  ,0,0,0,0,0,0,0,0,0,3000,0,0,0,103000,100000,3000,3000
0053,元大電子        ,0,0,0,0,0,0,0,0,0,3000,0,0,0,7000,4000,3000,3000
048655,A50正2元富96購01,0,0,0,0,0,0,0,0,0,3000,0,0,0,3000,0,3000,3000
048059,欣興國泰95購01  ,0,0,0,0,0,0,0,0,0,3000,0,0,0,3000,0,3000,3000
045053,聯發科元富98購01,0,0,0,0,0,0,0,0,0,3000,0,0,0,3000,0,3000,3000
050853,南電國票96購01  ,0,0,0,0,0,0,0,0,0,3000,0,0,0,3000,0,3000,3000
050793,大立光富邦96購03,0,0,0,0,0,0,0,0,0,3000,0,0,0,3000,0,3000,3000
050694,國巨凱基96購03  ,0,0,0,0,0,0,0,0,0,3000,0,0,0,3000,0,3000,3000
057057,立積元大9A購01  ,0,0,0,0,0,0,0,0,0,3000,0,0,0,3000,0,3000,3000
057028,台郡凱基99購02  ,0,0,0,0,0,0,0,0,0,3000,0,0,0,3000,0,3000,3000
058390,樺漢國票9A購01  ,0,0,0,0,0,0,0,0,0,3000,0,0,0,3000,0,3000,3000
058355,旺宏凱基99購04  ,0,0,0,0,0,0,0,0,0,3000,0,0,0,4000,1000,3000,3000
058210,臺股指凱基9C購04,0,0,0,0,0,0,0,0,0,3000,0,0,0,15000,12000,3000,3000
059145,創意國票99購02  ,0,0,0,0,0,0,0,0,0,3000,0,0,0,3000,0,3000,3000
059146,貿聯國票9A購02  ,0,0,0,0,0,0,0,0,0,3000,0,0,0,17000,14000,3000,3000
059286,S&P正2元富01購03,0,0,0,0,0,0,0,0,0,3000,0,0,0,3000,0,3000,3000
059268,鎧勝中信01購01  ,0,0,0,0,0,0,0,0,0,3000,0,0,0,3000,0,3000,3000
059520,台表科永豐99購02,0,0,0,0,0,0,0,0,0,3000,0,0,0,8000,5000,3000,3000
057326,景碩群益99購02  ,0,0,0,0,0,0,0,0,0,3000,0,0,0,3000,0,3000,3000
057882,華通群益9A購03  ,0,0,0,0,0,0,0,0,0,3000,0,0,0,3000,0,3000,3000
056602,嘉澤國泰99購01  ,0,0,0,0,0,0,0,0,0,3000,0,0,0,3000,0,3000,3000
056193,聯發科富邦99購08,0,0,0,0,0,0,0,0,0,3000,0,0,0,3000,0,3000,3000
056445,聯發科凱基98購07,0,0,0,0,0,0,0,0,0,3000,0,0,0,3000,0,3000,3000
056381,台虹元富98購01  ,0,0,0,0,0,0,0,0,0,3000,0,0,0,3000,0,3000,3000
056669,貿聯國票99購01  ,0,0,0,0,0,0,0,0,0,3000,0,0,0,66000,63000,3000,3000
056684,旺宏統一98購02  ,0,0,0,0,0,0,0,0,0,3000,0,0,0,3000,0,3000,3000
055770,欣興麥證97購01  ,0,0,0,3000,0,3000,0,0,0,3000,0,0,0,3000,0,3000,3000
055855,牧德元大99購02  ,0,0,0,0,0,0,0,0,0,3000,0,0,0,3000,0,3000,3000
058553,合勤控永豐99購01,0,0,0,0,0,0,0,0,0,3000,0,0,0,16000,13000,3000,3000
056772,欣興元大99購01  ,0,0,0,0,0,0,0,0,0,3000,0,0,0,29000,26000,3000,3000
058710,臺股指元大9A購23,0,0,0,0,0,0,0,0,0,3000,0,0,0,3000,0,3000,3000
912000,晨訊科-DR       ,3000,0,3000,0,0,0,0,0,0,0,0,0,0,0,0,0,3000
9918,欣天然          ,4000,1000,3000,0,0,0,0,0,0,0,0,0,0,0,0,0,3000
8411,福貞-KY         ,3000,0,3000,0,0,0,0,0,0,0,0,0,0,0,0,0,3000
6579,研揚            ,4000,1000,3000,0,0,0,0,0,0,0,0,0,0,0,0,0,3000
5607,遠雄港          ,73000,70000,3000,0,0,0,0,0,0,0,0,0,0,0,0,0,3000
4571,鈞興-KY         ,3000,0,3000,0,0,0,0,0,0,0,0,0,0,0,0,0,3000
1236,宏亞            ,3000,0,3000,0,0,0,0,0,0,0,0,0,0,0,0,0,3000
07814P,華通群益9A售06  ,0,0,0,0,0,0,0,0,0,3000,0,0,0,4000,1000,3000,3000
07868P,健策元大9B售05  ,0,0,0,0,0,0,0,0,0,3000,0,0,0,14000,11000,3000,3000
07890P,南電國票9B售01  ,0,0,0,0,0,0,0,0,0,3000,0,0,0,24000,21000,3000,3000
07655P,台灣50凱基01售09,0,0,0,0,0,0,0,0,0,3000,0,0,0,3000,0,3000,3000
07407P,欣興凱基99售07  ,0,0,0,0,0,0,0,0,0,3000,0,0,0,145000,142000,3000,3000
07033P,大立光統一9B售03,0,0,0,0,0,0,0,0,0,3000,0,0,0,5000,2000,3000,3000
07176P,臺股指凱基99售18,0,0,0,0,0,0,0,0,0,3000,0,0,0,3000,0,3000,3000
07126P,台積電元大99售23,0,0,0,0,0,0,0,0,0,3000,0,0,0,3000,0,3000,3000
3057,喬鼎            ,4000,1000,3000,0,0,0,0,0,0,0,0,0,0,0,0,0,3000
2527,宏璟            ,24000,21000,3000,0,0,0,0,0,0,0,0,0,0,0,0,0,3000
2543,皇昌            ,3000,0,3000,0,0,0,0,0,0,0,0,0,0,0,0,0,3000
2891C,中信金丙特      ,0,0,0,0,0,0,0,0,0,3000,3000,0,3000,0,0,0,3000
2838A,聯邦銀甲特      ,0,0,0,0,0,0,0,0,0,3000,10000,7000,3000,0,0,0,3000
2611,志信            ,4000,1000,3000,0,0,0,0,0,0,0,0,0,0,0,0,0,3000
1451,年興            ,29000,26000,3000,0,0,0,0,0,0,0,0,0,0,0,0,0,3000
1341,富林-KY         ,3000,0,3000,0,0,0,0,0,0,0,0,0,0,0,0,0,3000
1618,合機            ,5000,2000,3000,0,0,0,0,0,0,0,0,0,0,0,0,0,3000
1713,國化            ,3000,0,3000,0,0,0,0,0,0,0,0,0,0,0,0,0,3000
2373,震旦行          ,3000,0,3000,0,0,0,0,0,0,0,0,0,0,0,0,0,3000
008201,BP上證50        ,0,0,0,0,0,0,0,0,0,2400,0,0,0,2400,0,2400,2400
060484,聯發科富邦9C購02,0,0,0,0,0,0,0,0,0,2000,0,0,0,2000,0,2000,2000
060757,台積電元大9A購18,0,0,0,0,0,0,0,0,0,2000,0,0,0,2000,0,2000,2000
060759,南亞科元大9A購03,0,0,0,0,0,0,0,0,0,2000,0,0,0,2000,0,2000,2000
06074P,台積電凱基98售04,0,0,0,0,0,0,0,0,0,2000,0,0,0,2000,0,2000,2000
060722,矽格永豐9A購01  ,0,0,0,0,0,0,0,0,0,2000,0,0,0,118000,116000,2000,2000
061058,健策國票9A購05  ,0,0,0,0,0,0,0,0,0,2000,0,0,0,6000,4000,2000,2000
060975,滬深2X元大01購02,0,0,0,0,0,0,0,0,0,2000,0,0,0,4000,2000,2000,2000
060956,超眾群益9A購01  ,0,0,0,0,0,0,0,0,0,2000,0,0,0,12000,10000,2000,2000
059973,A50正2元大99購02,0,0,0,0,0,0,0,0,0,2000,0,0,0,2000,0,2000,2000
059979,台積電元大99購49,0,0,0,0,0,0,0,0,0,2000,0,0,0,12000,10000,2000,2000
059772,可成群益9A購05  ,0,0,0,0,0,0,0,0,0,2000,0,0,0,131000,129000,2000,2000
060288,群光元大9C購01  ,0,0,0,0,0,0,0,0,0,2000,0,0,0,10000,8000,2000,2000
060293,緯創元大9A購01  ,0,0,0,0,0,0,0,0,0,2000,0,0,0,7000,5000,2000,2000
060298,鎧勝元大9C購01  ,0,0,0,0,0,0,0,0,0,2000,0,0,0,9000,7000,2000,2000
06804P,臺股指群益98售10,0,0,0,0,0,0,0,0,0,2000,0,0,0,2000,0,2000,2000
06627P,華新科元富99售01,0,0,0,0,0,0,0,0,0,2000,0,0,0,2000,0,2000,2000
06693P,臺股指凱基98售01,0,0,0,0,0,0,0,0,0,2000,0,0,0,2000,0,2000,2000
06698P,玉晶光國票99售05,0,0,0,0,0,0,0,0,0,2000,0,0,0,2000,0,2000,2000
061419,國巨元大9A購21  ,0,0,0,0,0,0,0,0,0,2000,0,0,0,49000,47000,2000,2000
061720,智邦國泰9C購01  ,0,0,0,0,0,0,0,0,0,2000,0,0,0,66000,64000,2000,2000
00866,新光Shiller CAPE,0,0,0,0,0,0,0,0,0,2000,0,0,0,32000,30000,2000,2000
00776,新光ICE美國權值 ,0,0,0,0,0,0,0,0,0,2000,0,0,0,102000,100000,2000,2000
0051,元大中型100     ,0,0,0,0,0,0,0,0,0,2000,0,0,0,10000,8000,2000,2000
020004,兆豐電菁英30N   ,0,0,0,0,0,0,0,0,0,2000,0,0,0,2000,0,2000,2000
00650L,FH香港正2       ,5000,2000,3000,0,0,0,0,0,0,-1000,0,0,0,187000,188000,-1000,2000
00688L,國泰20年美債正2 ,0,4000,-4000,0,0,0,0,0,0,6000,0,0,0,106000,100000,6000,2000
00684R,元大美元指數反1 ,0,0,0,0,0,0,0,0,0,2000,0,0,0,2000,0,2000,2000
039212,台達電台新9A購01,0,0,0,0,0,0,0,0,0,2000,0,0,0,3000,1000,2000,2000
03959P,義隆元富96售01  ,0,0,0,0,0,0,0,0,0,2000,0,0,0,2000,0,2000,2000
03619C,臺股指元大95牛02,0,0,0,0,0,0,0,0,0,2000,0,0,0,2000,0,2000,2000
036084,台灣50台新98購01,0,0,0,0,0,0,0,0,0,2000,0,0,0,2000,0,2000,2000
049485,台積電元大96購03,0,0,0,0,0,0,0,0,0,2000,0,0,0,10000,8000,2000,2000
050783,旺宏國泰96購02  ,0,0,0,0,0,0,0,0,0,2000,0,0,0,2000,0,2000,2000
051424,緯穎國票97購01  ,0,0,0,0,0,0,0,0,0,2000,0,0,0,2000,0,2000,2000
045055,聯發科元富98購03,0,0,0,0,0,0,0,0,0,2000,0,0,0,2000,0,2000,2000
046476,鴻海統一96購01  ,0,0,0,0,0,0,0,0,0,2000,0,0,0,2000,0,2000,2000
048911,玉晶光富邦96購01,0,0,0,0,0,0,0,0,0,2000,0,0,0,2000,0,2000,2000
052861,台光電凱基96購03,0,0,0,0,0,0,0,0,0,2000,0,0,0,2000,0,2000,2000
052319,可成元大95購12  ,0,0,0,0,0,0,0,0,0,2000,0,0,0,2000,0,2000,2000
052235,聯發科國票96購02,0,0,0,0,0,0,0,0,0,2000,0,0,0,12000,10000,2000,2000
053073,技嘉康和96購01  ,0,0,0,0,0,0,0,0,0,2000,0,0,0,2000,0,2000,2000
051948,滬深2X元富9B購01,0,0,0,0,0,0,0,0,0,2000,0,0,0,2000,0,2000,2000
051898,富邦金國泰97購01,0,0,0,0,0,0,0,0,0,2000,0,0,0,2000,0,2000,2000
051899,欣興國泰97購01  ,0,0,0,0,0,0,0,0,0,2000,0,0,0,2000,0,2000,2000
053062,緯穎富邦97購01  ,0,0,0,0,0,0,0,0,0,2000,0,0,0,2000,0,2000,2000
054425,聯發科富邦99購03,0,0,0,0,0,0,0,0,0,2000,0,0,0,2000,0,2000,2000
054420,緯穎元大96購08  ,0,0,0,0,0,0,0,0,0,2000,0,0,0,3000,1000,2000,2000
05445P,聯詠元大95售05  ,0,0,0,0,0,0,0,0,0,2000,0,0,0,2000,0,2000,2000
055480,元上證元大97購02,0,0,0,0,0,0,0,0,0,2000,0,0,0,2000,0,2000,2000
055459,建準永豐97購03  ,0,0,0,0,0,0,0,0,0,2000,0,0,0,14000,12000,2000,2000
055556,奇力新凱基98購03,0,0,0,0,0,0,0,0,0,2000,0,0,0,2000,0,2000,2000
055611,燿華國票98購02  ,0,0,0,0,0,0,0,0,0,2000,0,0,0,12000,10000,2000,2000
053660,群創凱基98購08  ,0,0,0,0,0,0,0,0,0,2000,0,0,0,2000,0,2000,2000
059067,上銀國票9A購02  ,0,0,0,0,0,0,0,0,0,2000,0,0,0,2000,0,2000,2000
05882P,華新科永豐96售01,0,0,0,0,0,0,0,0,0,2000,0,0,0,2000,0,2000,2000
058772,茂林兆豐9A購01  ,0,0,0,0,0,0,0,0,0,2000,0,0,0,2000,0,2000,2000
058934,台灣50中信03購03,0,0,0,0,0,0,0,0,0,2000,0,0,0,2000,0,2000,2000
054850,上海銀兆豐97購01,0,0,0,0,0,0,0,0,0,2000,0,0,0,2000,0,2000,2000
053542,超眾永豐96購01  ,0,0,0,0,0,0,0,0,0,2000,0,0,0,35000,33000,2000,2000
053489,上銀兆豐97購01  ,0,0,0,0,0,0,0,0,0,2000,0,0,0,5000,3000,2000,2000
054791,泰碩群益99購02  ,0,0,0,0,0,0,0,0,0,2000,0,0,0,10000,8000,2000,2000
053314,A50正2群益9A購01,0,0,0,0,0,0,0,0,0,2000,0,0,0,643000,641000,2000,2000
053332,創意永豐96購03  ,0,0,0,0,0,0,0,0,0,2000,0,0,0,77000,75000,2000,2000
054936,鴻海元大97購10  ,0,0,0,0,0,0,0,0,0,2000,0,0,0,2000,0,2000,2000
054195,亞泥國泰98購01  ,0,0,0,0,0,0,0,0,0,2000,0,0,0,2000,0,2000,2000
054292,欣興元大96購06  ,0,0,0,0,0,0,0,0,0,2000,0,0,0,2000,0,2000,2000
054066,緯穎國票97購03  ,0,0,0,0,0,0,0,0,0,2000,0,0,0,3000,1000,2000,2000
053997,健策群益97購02  ,0,0,0,0,0,0,0,0,0,2000,0,0,0,2000,0,2000,2000
058719,智邦元富99購01  ,0,0,0,0,0,0,0,0,0,2000,0,0,0,2000,0,2000,2000
058694,鈺齊國票9A購02  ,0,0,0,0,0,0,0,0,0,2000,0,0,0,2000,0,2000,2000
058625,旺宏國票9A購01  ,0,0,0,0,0,0,0,0,0,2000,0,0,0,2000,0,2000,2000
058632,世紀鋼國票9A購01,0,0,0,0,0,0,0,0,0,2000,0,0,0,8000,6000,2000,2000
056800,臺股指麥證98購01,0,0,0,2000,0,2000,0,0,0,2000,0,0,0,2000,0,2000,2000
055834,國巨元大97購13  ,0,0,0,0,0,0,0,0,0,2000,0,0,0,36000,34000,2000,2000
055840,南亞科元大97購03,0,0,0,0,0,0,0,0,0,2000,0,0,0,2000,0,2000,2000
056696,茂林群益98購02  ,0,0,0,0,0,0,0,0,0,2000,0,0,0,42000,40000,2000,2000
05757P,旺宏永豐96售03  ,0,0,0,0,0,0,0,0,0,2000,0,0,0,2000,0,2000,2000
059017,台灣50統一9B購03,0,0,0,0,0,0,0,0,0,2000,0,0,0,2000,0,2000,2000
058448,滬深2X永豐9A購01,0,0,0,0,0,0,0,0,0,2000,0,0,0,2000,0,2000,2000
056332,台郡國票99購01  ,0,0,0,0,0,0,0,0,0,2000,0,0,0,10000,8000,2000,2000
056583,昇陽半元大98購02,0,0,0,0,0,0,0,0,0,2000,0,0,0,107000,105000,2000,2000
057261,瑞昱兆豐98購01  ,0,0,0,0,0,0,0,0,0,2000,0,0,0,2000,0,2000,2000
056236,台積電群益97購06,0,0,0,0,0,0,0,0,0,2000,0,0,0,2000,0,2000,2000
057396,健鼎中信99購01  ,0,0,0,0,0,0,0,0,0,2000,0,0,0,26000,24000,2000,2000
059363,超眾永豐99購02  ,0,0,0,0,0,0,0,0,0,2000,0,0,0,32000,30000,2000,2000
059334,A50正2國票9A購02,0,0,0,0,0,0,0,0,0,2000,0,0,0,13000,11000,2000,2000
059253,康控凱基9B購02  ,0,0,0,0,0,0,0,0,0,2000,0,0,0,36000,34000,2000,2000
059763,華擎永豐99購03  ,0,0,0,0,0,0,0,0,0,2000,0,0,0,92000,90000,2000,2000
059430,台積電元大99購36,0,0,0,0,0,0,0,0,0,2000,0,0,0,3000,1000,2000,2000
059410,滬深2X國票9A購04,0,0,0,0,0,0,0,0,0,2000,0,0,0,2000,0,2000,2000
058181,華新科國泰9B購01,0,0,0,0,0,0,0,0,0,2000,0,0,0,41000,39000,2000,2000
057190,立積元大9A購02  ,0,0,0,0,0,0,0,0,0,2000,0,0,0,10000,8000,2000,2000
056011,矽力中信99購01  ,0,0,0,0,0,0,0,0,0,2000,0,0,0,2000,0,2000,2000
056066,奇鋐元大98購02  ,0,0,0,0,0,0,0,0,0,2000,0,0,0,2000,0,2000,2000
056034,華通凱基98購01  ,0,0,0,0,0,0,0,0,0,2000,0,0,0,2000,0,2000,2000
056129,義隆麥證97購01  ,0,0,0,48000,46000,2000,0,0,0,2000,0,0,0,48000,46000,2000,2000
2032,新鋼            ,2000,0,2000,0,0,0,0,0,0,0,0,0,0,0,0,0,2000
2012,春雨            ,2000,0,2000,0,0,0,0,0,0,0,0,0,0,0,0,0,2000
1535,中宇            ,2000,0,2000,0,0,0,0,0,0,0,0,0,0,0,0,0,2000
1443,立益            ,2000,0,2000,0,0,0,0,0,0,0,0,0,0,0,0,0,2000
1530,亞崴            ,3000,1000,2000,0,0,0,0,0,0,0,0,0,0,0,0,0,2000
1466,聚隆            ,3000,1000,2000,0,0,0,0,0,0,0,0,0,0,0,0,0,2000
2597,潤弘            ,6000,4000,2000,0,0,0,0,0,0,0,0,0,0,0,0,0,2000
2936,客思達-KY       ,2000,0,2000,0,0,0,0,0,0,0,0,0,0,0,0,0,2000
3305,昇貿            ,8000,6000,2000,0,0,0,0,0,0,0,0,0,0,0,0,0,2000
3416,融程電          ,2000,0,2000,0,0,0,0,0,0,0,0,0,0,0,0,0,2000
07219P,臺股指凱基99售32,0,0,0,0,0,0,0,0,0,2000,0,0,0,200000,198000,2000,2000
07044P,台積電元大99售13,0,0,0,0,0,0,0,0,0,2000,0,0,0,2000,0,2000,2000
06960P,國巨凱基99售08  ,0,0,0,0,0,0,0,0,0,2000,0,0,0,12000,10000,2000,2000
07346P,FBVIX群益99售04 ,0,0,0,0,0,0,0,0,0,2000,0,0,0,2000,0,2000,2000
07783P,聯發科富邦9C售03,0,0,0,0,0,0,0,0,0,2000,0,0,0,2000,0,2000,2000
4930,燦星網          ,3000,1000,2000,0,0,0,0,0,0,0,0,0,0,0,0,0,2000
6128,上福            ,2000,0,2000,0,0,0,0,0,0,0,0,0,0,0,0,0,2000
6152,百一            ,4000,2000,2000,0,0,0,0,0,0,0,0,0,0,0,0,0,2000
6172,互億            ,41000,37000,4000,0,0,0,0,0,0,-2000,0,2000,-2000,0,0,0,2000
6641,基士德-KY       ,3000,1000,2000,0,0,0,0,0,0,0,0,0,0,0,0,0,2000
9931,欣高            ,2000,0,2000,0,0,0,0,0,0,0,0,0,0,0,0,0,2000
061753,南亞科台新9B購01,0,0,0,0,0,0,0,0,0,1000,0,0,0,3000,2000,1000,1000
06167P,欣興國票97售05  ,0,0,0,0,0,0,0,0,0,1000,0,0,0,1000,0,1000,1000
06166P,大立光國票98售01,0,0,0,0,0,0,0,0,0,1000,0,0,0,1000,0,1000,1000
061487,聯發科兆豐9B購02,0,0,0,0,0,0,0,0,0,1000,0,0,0,7000,6000,1000,1000
06153P,健策元大97售04  ,0,0,0,0,0,0,0,0,0,1000,0,0,0,26000,25000,1000,1000
061548,聯詠群益9A購02  ,0,0,0,0,0,0,0,0,0,1000,0,0,0,17000,16000,1000,1000
061317,旺宏凱基9A購05  ,0,0,0,0,0,0,0,0,0,1000,0,0,0,24000,23000,1000,1000
061312,滬深2X凱基9A購05,0,0,0,0,0,0,0,0,0,1000,0,0,0,1000,0,1000,1000
061224,道瓊反中信01購01,0,0,0,0,0,0,0,0,0,1000,0,0,0,4000,3000,1000,1000
061180,華擎凱基9B購01  ,0,0,0,0,0,0,0,0,0,1000,0,0,0,1000,0,1000,1000
06690P,玉晶光群益9A售05,0,0,0,0,0,0,0,0,0,1000,0,0,0,1000,0,1000,1000
06477P,緯穎國票99售02  ,0,0,0,0,0,0,0,0,0,1000,0,0,0,1000,0,1000,1000
06849P,欣興元大98售12  ,0,0,0,0,0,0,0,0,0,1000,0,0,0,2000,1000,1000,1000
061934,台積電國票9B購06,0,0,0,0,0,0,0,0,0,1000,0,0,0,1000,0,1000,1000
06320P,上銀統一97售04  ,0,0,0,0,0,0,0,0,0,1000,0,0,0,18000,17000,1000,1000
060299,友訊國泰9B購01  ,0,0,0,0,0,0,0,0,0,1000,0,0,0,9000,8000,1000,1000
060335,明泰康和9A購01  ,0,0,0,0,0,0,0,0,0,1000,0,0,0,1000,0,1000,1000
060316,福懋科永豐9A購01,0,0,0,0,0,0,0,0,0,1000,0,0,0,1000,0,1000,1000
059787,奇力新元大9A購02,0,0,0,0,0,0,0,0,0,1000,0,0,0,1000,0,1000,1000
059831,聯詠康和99購01  ,0,0,0,0,0,0,0,0,0,1000,0,0,0,3000,2000,1000,1000
059806,聯發科元富99購08,0,0,0,0,0,0,0,0,0,1000,0,0,0,6000,5000,1000,1000
059889,華新科國票99購04,0,0,0,0,0,0,0,0,0,1000,0,0,0,3000,2000,1000,1000
059921,大立光元大99購24,0,0,0,0,0,0,0,0,0,1000,0,0,0,6000,5000,1000,1000
059922,大立光元大99購25,0,0,0,0,0,0,0,0,0,1000,0,0,0,79000,78000,1000,1000
059913,台積電元大99購44,0,0,0,0,0,0,0,0,0,1000,0,0,0,50000,49000,1000,1000
059956,玉山金康和99購01,0,0,0,0,0,0,0,0,0,1000,0,0,0,31000,30000,1000,1000
060000,國巨台新99購01  ,0,0,0,0,0,0,0,0,0,1000,0,0,0,1000,0,1000,1000
060129,祥碩永豐99購03  ,0,0,0,0,0,0,0,0,0,1000,0,0,0,6000,5000,1000,1000
060921,中橡永豐9A購02  ,0,0,0,0,0,0,0,0,0,1000,0,0,0,78000,77000,1000,1000
060738,矽格統一9C購01  ,0,0,0,0,0,0,0,0,0,1000,0,0,0,1000,0,1000,1000
054946,億光元大97購01  ,0,0,0,0,0,0,0,0,0,1000,0,0,0,1000,0,1000,1000
054924,景碩凱基98購01  ,0,0,0,0,0,0,0,0,0,1000,0,0,0,1000,0,1000,1000
054346,世芯國票97購01  ,0,0,0,0,0,0,0,0,0,1000,0,0,0,1000,0,1000,1000
055229,大毅國票97購02  ,0,0,0,0,0,0,0,0,0,1000,0,0,0,1000,0,1000,1000
054778,世紀鋼國票99購01,0,0,0,0,0,0,0,0,0,1000,0,0,0,7000,6000,1000,1000
05338P,臺股指國票95售07,0,0,0,0,0,0,0,0,0,1000,0,0,0,1000,0,1000,1000
053474,聯發科元大97購06,0,0,0,0,0,0,0,0,0,1000,0,0,0,1000,0,1000,1000
053550,聯發科凱基96購15,0,0,0,0,0,0,0,0,0,1000,0,0,0,1000,0,1000,1000
05353P,臺股指元富95售07,0,0,0,0,0,0,0,0,0,1000,0,0,0,1000,0,1000,1000
053530,聯發科康和96購01,0,0,0,0,0,0,0,0,0,1000,0,0,0,1000,0,1000,1000
05486P,大立光凱基95售14,0,0,0,0,0,0,0,0,0,1000,0,0,0,1000,0,1000,1000
058917,SGBR2X元富99購03,0,0,0,0,0,0,0,0,0,1000,0,0,0,1000,0,1000,1000
058888,元油2X元大99購16,0,0,0,0,0,0,0,0,0,1000,0,0,0,1000,0,1000,1000
059002,聯發科元大99購18,0,0,0,0,0,0,0,0,0,1000,0,0,0,1000,0,1000,1000
059013,臺股指元大9A購32,0,0,0,0,0,0,0,0,0,1000,0,0,0,1000,0,1000,1000
055060,聯陽永豐97購01  ,0,0,0,0,0,0,0,0,0,1000,0,0,0,56000,55000,1000,1000
055280,智邦元大97購01  ,0,0,0,0,0,0,0,0,0,1000,0,0,0,1000,0,1000,1000
055294,智易元大98購01  ,0,0,0,0,0,0,0,0,0,1000,0,0,0,1000,0,1000,1000
055583,國巨元大97購10  ,0,0,0,0,0,0,0,0,0,1000,0,0,0,58000,57000,1000,1000
055500,京鼎元大97購04  ,0,0,0,0,0,0,0,0,0,1000,0,0,0,1000,0,1000,1000
055363,緯穎凱基98購03  ,0,0,0,0,0,0,0,0,0,1000,0,0,0,1000,0,1000,1000
054493,同欣電台新96購01,0,0,0,0,0,0,0,0,0,1000,0,0,0,1000,0,1000,1000
051951,聯發科元富95購02,0,0,0,0,0,0,0,0,0,1000,0,0,0,1000,0,1000,1000
051944,智邦統一95購02  ,0,0,0,0,0,0,0,0,0,1000,0,0,0,1000,0,1000,1000
053121,上証2X凱基9C購01,0,0,0,0,0,0,0,0,0,1000,0,0,0,1000,0,1000,1000
053181,滬深2X元富99購02,0,0,0,0,0,0,0,0,0,1000,0,0,0,1000,0,1000,1000
055160,玉晶光元大99購03,0,0,0,0,0,0,0,0,0,1000,0,0,0,1000,0,1000,1000
052325,高股息中信99購01,0,0,0,0,0,0,0,0,0,1000,0,0,0,1000,0,1000,1000
052362,瑞昱國票96購02  ,0,0,0,0,0,0,0,0,0,1000,0,0,0,23000,22000,1000,1000
052416,滬深2X兆豐96購02,0,0,0,0,0,0,0,0,0,1000,0,0,0,1000,0,1000,1000
052676,聯發科永昌98購01,0,0,0,0,0,0,0,0,0,1000,0,0,0,1000,0,1000,1000
051606,華新科群益95購05,0,0,0,0,0,0,0,0,0,1000,0,0,0,1000,0,1000,1000
051560,玉晶光國泰97購03,0,0,0,0,0,0,0,0,0,1000,0,0,0,1000,0,1000,1000
052708,楠梓電永豐97購01,0,0,0,0,0,0,0,0,0,1000,0,0,0,1000,0,1000,1000
052940,玉晶光兆豐97購01,0,0,0,0,0,0,0,0,0,1000,0,0,0,1000,0,1000,1000
048637,鴻海元大96購01  ,0,0,0,0,0,0,0,0,0,1000,0,0,0,1000,0,1000,1000
04617P,臺股指群益95售03,0,0,0,0,0,0,0,0,0,1000,0,0,0,1000,0,1000,1000
04373P,滬深2X元大97售01,0,0,0,0,0,0,0,0,0,1000,0,0,0,1000,0,1000,1000
04437P,滬深2X群益98售03,0,0,0,0,0,0,0,0,0,1000,0,0,0,1000,0,1000,1000
047630,元油反元大96購02,0,0,0,0,0,0,0,0,0,1000,0,0,0,1000,0,1000,1000
051415,晶技國票96購01  ,0,0,0,0,0,0,0,0,0,1000,0,0,0,4000,3000,1000,1000
051471,國巨凱基97購01  ,0,0,0,0,0,0,0,0,0,1000,0,0,0,1000,0,1000,1000
051239,國巨元大96購02  ,0,0,0,0,0,0,0,0,0,1000,0,0,0,1000,0,1000,1000
051323,康控國票96購01  ,0,0,0,0,0,0,0,0,0,1000,0,0,0,1000,0,1000,1000
050890,南電富邦99購01  ,0,0,0,0,0,0,0,0,0,1000,0,0,0,1000,0,1000,1000
051158,嘉晶富邦96購01  ,0,0,0,0,0,0,0,0,0,1000,0,0,0,1000,0,1000,1000
050791,聯發科富邦96購01,0,0,0,0,0,0,0,0,0,1000,0,0,0,1000,0,1000,1000
050590,晶技永豐95購01  ,0,0,0,0,0,0,0,0,0,1000,0,0,0,1000,0,1000,1000
052992,冠德台新96購01  ,0,0,0,0,0,0,0,0,0,1000,0,0,0,1000,0,1000,1000
049611,緯穎兆豐95購02  ,0,0,0,0,0,0,0,0,0,1000,0,0,0,1000,0,1000,1000
049260,華新科元大96購01,0,0,0,0,0,0,0,0,0,1000,0,0,0,1000,0,1000,1000
050202,建準群益95購01  ,0,0,0,0,0,0,0,0,0,1000,0,0,0,1000,0,1000,1000
050173,旺宏元大96購02  ,0,0,0,0,0,0,0,0,0,1000,0,0,0,1000,0,1000,1000
035277,景碩台新97購01  ,0,0,0,0,0,0,0,0,0,1000,0,0,0,1000,0,1000,1000
00689R,國泰20年美債反1 ,0,0,0,0,0,0,0,0,0,1000,0,0,0,101000,100000,1000,1000
00700,富邦恒生國企    ,0,0,0,0,0,0,0,0,0,1000,0,0,0,103000,102000,1000,1000
00702,國泰標普低波高息,0,0,0,0,0,0,0,0,0,1000,0,0,0,1000,0,1000,1000
00661,元大日經225     ,0,0,0,0,0,0,0,0,0,1000,0,0,0,1000,0,1000,1000
058321,大立光永豐99購01,0,0,0,0,0,0,0,0,0,1000,0,0,0,1000,0,1000,1000
058270,上緯控永豐99購01,0,0,0,0,0,0,0,0,0,1000,0,0,0,3000,2000,1000,1000
055956,瑞昱元大97購05  ,0,0,0,0,0,0,0,0,0,1000,0,0,0,1000,0,1000,1000
055953,上銀元大97購09  ,0,0,0,0,0,0,0,0,0,1000,0,0,0,1000,0,1000,1000
057559,可成兆豐99購02  ,0,0,0,0,0,0,0,0,0,1000,0,0,0,1000,0,1000,1000
058171,國巨凱基9A購07  ,0,0,0,0,0,0,0,0,0,1000,0,0,0,121000,120000,1000,1000
05938P,旺宏凱基96售07  ,0,0,0,0,0,0,0,0,0,1000,0,0,0,1000,0,1000,1000
057159,晶技永豐98購01  ,0,0,0,0,0,0,0,0,0,1000,0,0,0,1000,0,1000,1000
059148,百和國票9A購01  ,0,0,0,0,0,0,0,0,0,1000,0,0,0,1000,0,1000,1000
058063,旺宏中信98購04  ,0,0,0,0,0,0,0,0,0,1000,0,0,0,21000,20000,1000,1000
057087,台郡統一99購01  ,0,0,0,0,0,0,0,0,0,1000,0,0,0,1000,0,1000,1000
059641,群創凱基99購06  ,0,0,0,0,0,0,0,0,0,1000,0,0,0,1000,0,1000,1000
059632,聯發科凱基01購01,0,0,0,0,0,0,0,0,0,1000,0,0,0,1000,0,1000,1000
057422,欣興凱基98購04  ,0,0,0,0,0,0,0,0,0,1000,0,0,0,5000,4000,1000,1000
057365,智邦元大98購07  ,0,0,0,0,0,0,0,0,0,1000,0,0,0,2000,1000,1000,1000
057277,可成元大98購05  ,0,0,0,0,0,0,0,0,0,1000,0,0,0,9000,8000,1000,1000
056194,聯發科富邦9B購01,0,0,0,0,0,0,0,0,0,1000,0,0,0,1000,0,1000,1000
056467,上証2X元大98購02,0,0,0,0,0,0,0,0,0,1000,0,0,0,1000,0,1000,1000
056324,南亞科兆豐98購01,0,0,0,0,0,0,0,0,0,1000,0,0,0,1000,0,1000,1000
058491,滬深2X群益01購01,0,0,0,0,0,0,0,0,0,1000,0,0,0,500000,499000,1000,1000
055676,亞德客凱基97購03,0,0,0,0,0,0,0,0,0,1000,0,0,0,1000,0,1000,1000
058437,可成統一9B購01  ,0,0,0,0,0,0,0,0,0,1000,0,0,0,1000,0,1000,1000
056697,緯穎群益98購01  ,0,0,0,0,0,0,0,0,0,1000,0,0,0,5000,4000,1000,1000
056825,深中小富邦9B購01,0,0,0,0,0,0,0,0,0,1000,0,0,0,1000,0,1000,1000
058644,元黃金富邦03購01,0,0,0,0,0,0,0,0,0,1000,0,0,0,1000,0,1000,1000
058615,矽創元大99購01  ,0,0,0,0,0,0,0,0,0,1000,0,0,0,1000,0,1000,1000
058601,台積電元大99購10,0,0,0,0,0,0,0,0,0,1000,0,0,0,1000,0,1000,1000
057646,玉山金元大98購01,0,0,0,0,0,0,0,0,0,1000,0,0,0,58000,57000,1000,1000
058546,玉晶光富邦9B購01,0,0,0,0,0,0,0,0,0,1000,0,0,0,1000,0,1000,1000
057697,國巨群益98購09  ,0,0,0,0,0,0,0,0,0,1000,0,0,0,1000,0,1000,1000
910322,康師傅-DR       ,1000,0,1000,0,0,0,0,0,0,0,0,0,0,0,0,0,1000
9906,欣巴巴          ,1000,0,1000,0,0,0,0,0,0,0,0,0,0,0,0,0,1000
8443,阿瘦            ,1000,0,1000,0,0,0,0,0,0,0,0,0,0,0,0,0,1000
8488,吉源-KY         ,1000,0,1000,0,0,0,0,0,0,0,0,0,0,0,0,0,1000
8473,山林水          ,3000,2000,1000,0,0,0,0,0,0,0,0,0,0,0,0,0,1000
8478,東哥遊艇        ,1000,0,1000,0,0,0,0,0,0,0,0,0,0,0,0,0,1000
6164,華興            ,2000,1000,1000,0,0,0,0,0,0,0,0,0,0,0,0,0,1000
6133,金橋            ,1000,0,1000,0,0,0,0,0,0,0,0,0,0,0,0,0,1000
5906,台南-KY         ,1000,0,1000,0,0,0,0,0,0,0,0,0,0,0,0,0,1000
4755,三福化          ,1000,0,1000,0,0,0,0,0,0,0,0,0,0,0,0,0,1000
4572,駐龍            ,5000,4000,1000,0,0,0,0,0,0,0,0,0,0,0,0,0,1000
4739,康普            ,57000,56000,1000,0,0,0,0,0,0,0,0,0,0,0,0,0,1000
07775P,國巨群益9A售10  ,0,0,0,0,0,0,0,0,0,1000,0,0,0,11000,10000,1000,1000
07848P,旺宏群益9B售01  ,0,0,0,0,0,0,0,0,0,1000,0,0,0,13000,12000,1000,1000
1235,興泰            ,1000,0,1000,0,0,0,0,0,0,0,0,0,0,0,0,0,1000
1101B,台泥乙特        ,0,0,0,0,0,0,0,0,0,1000,1000,0,1000,0,0,0,1000
07928P,國巨統一9B售09  ,0,0,0,0,0,0,0,0,0,1000,0,0,0,1000,0,1000,1000
07668P,旺宏元大9A售10  ,0,0,0,0,0,0,0,0,0,1000,0,0,0,1000,0,1000,1000
07689P,旺宏元大9A售13  ,0,0,0,0,0,0,0,0,0,1000,0,0,0,1000,0,1000,1000
07690P,華新科元大9A售15,0,0,0,0,0,0,0,0,0,1000,0,0,0,1000,0,1000,1000
07738P,玉晶光永豐9A售06,0,0,0,0,0,0,0,0,0,1000,0,0,0,3000,2000,1000,1000
07487P,鴻海國票9A售01  ,0,0,0,0,0,0,0,0,0,1000,0,0,0,4000,3000,1000,1000
07114P,旺宏兆豐9A售01  ,0,0,0,0,0,0,0,0,0,1000,0,0,0,1000,0,1000,1000
07221P,臺股指中信9B售04,0,0,0,0,0,0,0,0,0,1000,0,0,0,1000,0,1000,1000
07245P,台積電凱基99售16,0,0,0,0,0,0,0,0,0,1000,0,0,0,7000,6000,1000,1000
07139P,元油2X群益9C售06,0,0,0,0,0,0,0,0,0,1000,0,0,0,1000,0,1000,1000
3054,立萬利          ,3000,2000,1000,0,0,0,0,0,0,0,0,0,0,0,0,0,1000
2540,愛山林          ,3000,2000,1000,0,0,0,0,0,0,0,0,0,0,0,0,0,1000
2509,全坤建          ,1000,0,1000,0,0,0,0,0,0,0,0,0,0,0,0,0,1000
2440,太空梭          ,2000,1000,1000,0,0,0,0,0,0,0,0,0,0,0,0,0,1000
2630,亞航            ,2000,1000,1000,0,0,0,0,0,0,0,0,0,0,0,0,0,1000
2613,中櫃            ,1000,0,1000,0,0,0,0,0,0,0,0,0,0,0,0,0,1000
2739,寒舍            ,1000,0,1000,0,0,0,0,0,0,0,0,0,0,0,0,0,1000
2704,國賓            ,18000,17000,1000,0,0,0,0,0,0,0,0,0,0,0,0,0,1000
2706,第一店          ,5000,4000,1000,0,0,0,0,0,0,0,0,0,0,0,0,0,1000
2891B,中信金乙特      ,0,0,0,0,0,0,0,0,0,1000,1000,0,1000,0,0,0,1000
1456,怡華            ,1000,0,1000,0,0,0,0,0,0,0,0,0,0,0,0,0,1000
1468,昶和            ,2000,1000,1000,0,0,0,0,0,0,0,0,0,0,0,0,0,1000
1441,大東            ,4000,3000,1000,0,0,0,0,0,0,0,0,0,0,0,0,0,1000
1583,程泰            ,1000,0,1000,0,0,0,0,0,0,0,0,0,0,0,0,0,1000
1724,台硝            ,1000,0,1000,0,0,0,0,0,0,0,0,0,0,0,0,0,1000
2002A,中鋼特          ,0,0,0,0,0,0,0,0,0,1000,1000,0,1000,0,0,0,1000
2115,六暉-KY         ,1000,0,1000,0,0,0,0,0,0,0,0,0,0,0,0,0,1000
060751,高股息元大9B購01,0,0,0,0,0,0,0,0,0,0,0,0,0,1000,1000,0,0
06077P,GIS凱基97售02   ,0,0,0,0,0,0,0,0,0,0,0,0,0,33000,33000,0,0
060796,世芯永豐9A購03  ,0,0,0,0,0,0,0,0,0,0,0,0,0,99000,99000,0,0
060685,康友元大9A購01  ,0,0,0,0,0,0,0,0,0,0,0,0,0,8000,8000,0,0
060524,國巨中信9A購03  ,0,0,0,0,0,0,0,0,0,0,0,0,0,5000,5000,0,0
060544,國巨凱基9B購03  ,0,0,0,0,0,0,0,0,0,0,0,0,0,124000,124000,0,0
060559,世紀鋼凱基9C購01,0,0,0,0,0,0,0,0,0,0,0,0,0,10000,10000,0,0
060607,玉晶光凱基9A購06,0,0,0,0,0,0,0,0,0,0,0,0,0,2000,2000,0,0
060612,世紀鋼凱基9A購01,0,0,0,0,0,0,0,0,0,0,0,0,0,3000,3000,0,0
060650,奇力新中信9A購01,0,0,0,0,0,0,0,0,0,0,0,0,0,85000,85000,0,0
060893,台灣50凱基01購07,0,0,0,0,0,0,0,0,0,0,0,0,0,1000,1000,0,0
060944,國泰金國票9A購01,0,0,0,0,0,0,0,0,0,0,0,0,0,38000,38000,0,0
060977,亞德客元大9A購04,0,0,0,0,0,0,0,0,0,0,0,0,0,2000,2000,0,0
060979,國巨元大9A購14  ,0,0,0,0,0,0,0,0,0,0,0,0,0,14000,14000,0,0
060837,上銀國票9A購04  ,0,0,0,0,0,0,0,0,0,0,0,0,0,4000,4000,0,0
060822,華通元大9A購05  ,0,0,0,0,0,0,0,0,0,0,0,0,0,1000,1000,0,0
060827,健策元大9A購02  ,0,0,0,0,0,0,0,0,0,0,0,0,0,3000,3000,0,0
060860,國巨永豐9A購02  ,0,0,0,0,0,0,0,0,0,0,0,0,0,120000,120000,0,0
061055,康控群益9A購01  ,0,0,0,0,0,0,0,0,0,0,0,0,0,183000,183000,0,0
060992,健策元大9A購05  ,0,0,0,0,0,0,0,0,0,0,0,0,0,11000,11000,0,0
060993,健策元大9B購03  ,0,0,0,0,0,0,0,0,0,0,0,0,0,19000,19000,0,0
059990,健策元大9A購01  ,0,0,0,0,0,0,0,0,0,0,0,0,0,15000,15000,0,0
059959,訊芯康和99購01  ,0,0,0,0,0,0,0,0,0,0,0,0,0,68000,68000,0,0
059930,健策富邦9B購01  ,0,0,0,0,0,0,0,0,0,0,0,0,0,52000,52000,0,0
059919,宏達電元大99購06,0,0,0,0,0,0,0,0,0,0,0,0,0,5000,5000,0,0
059805,台積電元富99購02,0,0,0,0,0,0,0,0,0,0,0,0,0,60000,60000,0,0
059799,台灣50元富01購05,0,0,0,0,0,0,0,0,0,0,0,0,0,1000,1000,0,0
060241,國泰金元大9A購01,0,0,0,0,0,0,0,0,0,0,0,0,0,100000,100000,0,0
060266,潤泰全國票9A購01,0,0,0,0,0,0,0,0,0,0,0,0,0,5000,5000,0,0
060128,健策永豐99購06  ,0,0,0,0,0,0,0,0,0,0,0,0,0,5000,5000,0,0
060151,旺宏富邦9A購02  ,0,0,0,0,0,0,0,0,0,0,0,0,0,10000,10000,0,0
060148,臺股指國票9A購08,0,0,0,0,0,0,0,0,0,0,0,0,0,21000,21000,0,0
06329P,大立光兆豐97售04,0,0,0,0,0,0,0,0,0,0,0,0,0,31000,31000,0,0
062125,嘉晶統一9B購01  ,0,0,0,0,0,0,0,0,0,0,0,0,0,2000,2000,0,0
062189,康控元大9B購02  ,0,0,0,0,0,0,0,0,0,0,0,0,0,9000,9000,0,0
06235P,國巨元大97售12  ,0,0,0,0,0,0,0,0,0,0,0,0,0,342000,342000,0,0
062038,鴻海凱基9B購05  ,0,0,0,0,0,0,0,0,0,0,0,0,0,16000,16000,0,0
062075,智邦元大9B購03  ,0,0,0,0,0,0,0,0,0,0,0,0,0,1000,1000,0,0
062077,聯發科元大9B購04,0,0,0,0,0,0,0,0,0,0,0,0,0,2000,2000,0,0
062083,健策元大9C購03  ,0,0,0,0,0,0,0,0,0,0,0,0,0,3000,3000,0,0
062073,國巨元大9B購06  ,0,0,0,0,0,0,0,0,0,0,0,0,0,40000,40000,0,0
062055,鴻海統一9C購07  ,0,0,0,0,0,0,0,0,0,0,0,0,0,1000,1000,0,0
061928,群創凱基9B購06  ,0,0,0,0,0,0,0,0,0,0,0,0,0,9000,9000,0,0
061942,亞德客群益9B購01,0,0,0,0,0,0,0,0,0,0,0,0,0,3000,3000,0,0
061964,台積電統一01購05,0,0,0,0,0,0,0,0,0,0,0,0,0,1000,1000,0,0
061967,旺宏統一01購04  ,0,0,0,0,0,0,0,0,0,0,0,0,0,10000,10000,0,0
061977,國巨元大9B購02  ,0,0,0,0,0,0,0,0,0,0,0,0,0,30000,30000,0,0
06197P,國巨元大97售08  ,0,0,0,0,0,0,0,0,0,0,0,0,0,10000,10000,0,0
061869,智邦元大9B購01  ,0,0,0,0,0,0,0,0,0,0,0,0,0,1000,1000,0,0
061849,國巨國票9B購08  ,0,0,0,0,0,0,0,0,0,0,0,0,0,120000,120000,0,0
06846P,美律元大98售05  ,0,0,0,0,0,0,0,0,0,0,0,0,0,5000,5000,0,0
06843P,鴻海元大98售11  ,0,0,0,0,0,0,0,0,0,0,0,0,0,88000,88000,0,0
06741P,台積電富邦98售04,0,0,0,0,0,0,0,0,0,0,0,0,0,80000,80000,0,0
06737P,台郡凱基98售07  ,0,0,0,0,0,0,0,0,0,0,0,0,0,50000,50000,0,0
06730P,祥碩元大98售07  ,0,0,0,0,0,0,0,0,0,0,0,0,0,10000,10000,0,0
06905P,上証2X國泰99售02,0,0,0,0,0,0,0,0,0,0,0,0,0,5000,5000,0,0
06911P,鴻海元大99售09  ,0,0,0,0,0,0,0,0,0,0,0,0,0,157000,157000,0,0
06928P,鴻海元大99售10  ,0,0,0,0,0,0,0,0,0,0,0,0,0,30000,30000,0,0
06919P,臺股指日盛98售02,0,0,0,0,0,0,0,0,0,0,0,0,0,10000,10000,0,0
06920P,台灣50凱基9A售01,0,0,0,0,0,0,0,0,0,0,0,0,0,20000,20000,0,0
06482P,台積電凱基98售13,0,0,0,0,0,0,0,0,0,0,0,0,0,300000,300000,0,0
06543P,鴻海元大98售08  ,0,0,0,0,0,0,0,0,0,0,0,0,0,188000,188000,0,0
06473P,鴻海元大99售03  ,0,0,0,0,0,0,0,0,0,0,0,0,0,31000,31000,0,0
06427P,鴻海元大97售13  ,0,0,0,0,0,0,0,0,0,0,0,0,0,86000,86000,0,0
06412P,南亞科日盛97售01,0,0,0,0,0,0,0,0,0,0,0,0,0,10000,10000,0,0
06378P,國巨統一97售08  ,0,0,0,0,0,0,0,0,0,0,0,0,0,55000,55000,0,0
06637P,大立光凱基98售15,0,0,0,0,0,0,0,0,0,0,0,0,0,10000,10000,0,0
06655P,TPK元大98售02   ,0,0,0,0,0,0,0,0,0,0,0,0,0,2000,2000,0,0
06646P,國巨元大98售16  ,0,0,0,0,0,0,0,0,0,0,0,0,0,2000,2000,0,0
06568P,國巨永豐98售05  ,0,0,0,0,0,0,0,0,0,0,0,0,0,21000,21000,0,0
06117P,臺股指日盛97售02,0,0,0,0,0,0,0,0,0,0,0,0,0,100000,100000,0,0
061195,健策永豐9B購02  ,0,0,0,0,0,0,0,0,0,0,0,0,0,5000,5000,0,0
061203,國巨元大9A購15  ,0,0,0,0,0,0,0,0,0,0,0,0,0,64000,64000,0,0
061248,健策群益9A購03  ,0,0,0,0,0,0,0,0,0,0,0,0,0,41000,41000,0,0
061335,國巨元大9A購19  ,0,0,0,0,0,0,0,0,0,0,0,0,0,10000,10000,0,0
061407,鴻海國票9A購07  ,0,0,0,0,0,0,0,0,0,0,0,0,0,40000,40000,0,0
061412,儒鴻群益9A購01  ,0,0,0,0,0,0,0,0,0,0,0,0,0,25000,25000,0,0
061541,旺宏群益9A購03  ,0,0,0,0,0,0,0,0,0,0,0,0,0,1000,1000,0,0
061482,健策元大9C購01  ,0,0,0,0,0,0,0,0,0,0,0,0,0,12000,12000,0,0
06149P,台積電元大97售18,0,0,0,0,0,0,0,0,0,0,0,0,0,170000,170000,0,0
061512,國巨永豐9A購04  ,0,0,0,0,0,0,0,0,0,0,0,0,0,114000,114000,0,0
061679,健策元大9B購04  ,0,0,0,0,0,0,0,0,0,0,0,0,0,3000,3000,0,0
061712,旺宏凱基9A購08  ,0,0,0,0,0,0,0,0,0,0,0,0,0,9000,9000,0,0
061644,健策元大9C購02  ,0,0,0,0,0,0,0,0,0,0,0,0,0,3000,3000,0,0
06174P,國巨元大97售07  ,0,0,0,0,0,0,0,0,0,0,0,0,0,25000,25000,0,0
061722,健策永豐9B購03  ,0,0,0,0,0,0,0,0,0,0,0,0,0,5000,5000,0,0
061791,康友群益9B購01  ,0,0,0,0,0,0,0,0,0,0,0,0,0,16000,16000,0,0
061813,鴻海群益9B購02  ,0,0,0,0,0,0,0,0,0,0,0,0,0,80000,80000,0,0
06177P,玉晶光元大98售07,0,0,0,0,0,0,0,0,0,0,0,0,0,10000,10000,0,0
061770,泰碩元大9B購02  ,0,0,0,0,0,0,0,0,0,0,0,0,0,2000,2000,0,0
00668K,國泰美國道瓊+U  ,0,0,0,0,0,0,0,0,0,0,0,0,0,100,100,0,0
00657K,國泰日經225+U   ,0,0,0,0,0,0,0,0,0,0,0,0,0,100,100,0,0
00682U,元大美元指數    ,0,0,0,0,0,0,0,0,0,0,0,0,0,2000,2000,0,0
049255,旺宏元大97購02  ,0,0,0,0,0,0,0,0,0,0,0,0,0,62000,62000,0,0
00732,國泰RMB短期報酬 ,0,0,0,0,0,0,0,0,0,0,0,0,0,100000,100000,0,0
0057,富邦摩台        ,0,0,0,0,0,0,0,0,0,0,0,0,0,201000,201000,0,0
006204,永豐臺灣加權    ,0,0,0,0,0,0,0,0,0,0,0,0,0,511000,511000,0,0
00636K,國泰中國A50+U   ,0,0,0,0,0,0,0,0,0,0,0,0,0,100,100,0,0
00625K,富邦上証+R      ,0,0,0,0,0,0,0,0,0,0,0,0,0,50000,50000,0,0
020016,統一MSCI美科技N ,0,0,0,0,0,0,0,0,0,0,0,0,0,29000,29000,0,0
00774B,新光中國政金綠債,0,0,0,0,0,0,0,0,0,0,0,0,0,2000,2000,0,0
00775B,新光投等債15+   ,0,0,0,0,0,0,0,0,0,0,0,0,0,2000,2000,0,0
050485,國巨統一96購01  ,0,0,0,0,0,0,0,0,0,0,0,0,0,260000,260000,0,0
050406,台積電台新95購02,0,0,0,0,0,0,0,0,0,0,0,0,0,1000,1000,0,0
050100,台積電永昌96購02,0,0,0,0,0,0,0,0,0,0,0,0,0,5000,5000,0,0
049429,國巨國票95購01  ,0,0,0,0,0,0,0,0,0,0,0,0,0,10000,10000,0,0
049751,牧德永豐95購01  ,0,0,0,0,0,0,0,0,0,0,0,0,0,1000,1000,0,0
053021,國巨國泰97購04  ,0,0,0,0,0,0,0,0,0,0,0,0,0,20000,20000,0,0
050495,大立光永昌96購01,0,0,0,0,0,0,0,0,0,0,0,0,0,20000,20000,0,0
050979,鴻海元富96購02  ,0,0,0,0,0,0,0,0,0,0,0,0,0,346000,346000,0,0
050984,大立光國泰97購01,0,0,0,0,0,0,0,0,0,0,0,0,0,10000,10000,0,0
047212,宏達電富邦97購01,0,0,0,0,0,0,0,0,0,0,0,0,0,100000,100000,0,0
046061,中石化凱基98購01,0,0,0,0,0,0,0,0,0,0,0,0,0,7000,7000,0,0
049004,聯發科中信96購01,0,0,0,0,0,0,0,0,0,0,0,0,0,1000,1000,0,0
052882,南電凱基96購02  ,0,0,0,0,0,0,0,0,0,0,0,0,0,200000,200000,0,0
052798,滬深2X元大96購07,0,0,0,0,0,0,0,0,0,0,0,0,0,10000,10000,0,0
051490,世芯凱基96購01  ,0,0,0,0,0,0,0,0,0,0,0,0,0,10000,10000,0,0
051531,國巨國票96購04  ,0,0,0,0,0,0,0,0,0,0,0,0,0,3000,3000,0,0
051596,超眾元大95購05  ,0,0,0,0,0,0,0,0,0,0,0,0,0,40000,40000,0,0
05215P,台積電台新95售03,0,0,0,0,0,0,0,0,0,0,0,0,0,17000,17000,0,0
052025,國巨群益96購01  ,0,0,0,0,0,0,0,0,0,0,0,0,0,13000,13000,0,0
052029,矽力群益95購02  ,0,0,0,0,0,0,0,0,0,0,0,0,0,10000,10000,0,0
052078,大立光元富95購10,0,0,0,0,0,0,0,0,0,0,0,0,0,100000,100000,0,0
05261P,鴻海元大95售20  ,0,0,0,0,0,0,0,0,0,0,0,0,0,20000,20000,0,0
052614,聯電國泰97購01  ,0,0,0,0,0,0,0,0,0,0,0,0,0,80000,80000,0,0
052504,鴻海日盛95購03  ,0,0,0,0,0,0,0,0,0,0,0,0,0,400000,400000,0,0
052548,旺宏亞東96購01  ,0,0,0,0,0,0,0,0,0,0,0,0,0,75000,75000,0,0
052423,宏達電國票96購02,0,0,0,0,0,0,0,0,0,0,0,0,0,5000,5000,0,0
052443,台積電元大95購23,0,0,0,0,0,0,0,0,0,0,0,0,0,10000,10000,0,0
05244P,台積電元大95售17,0,0,0,0,0,0,0,0,0,0,0,0,0,170000,170000,0,0
052454,力成元大95購02  ,0,0,0,0,0,0,0,0,0,0,0,0,0,4000,4000,0,0
052336,矽力日盛95購01  ,0,0,0,0,0,0,0,0,0,0,0,0,0,10000,10000,0,0
054571,楠梓電元大99購01,0,0,0,0,0,0,0,0,0,0,0,0,0,4000,4000,0,0
05325P,臺股指凱基95售09,0,0,0,0,0,0,0,0,0,0,10000,0,10000,0,10000,-10000,0
053226,國巨台新97購02  ,0,0,0,0,0,0,0,0,0,0,0,0,0,540000,540000,0,0
053129,緯穎凱基96購01  ,0,0,0,0,0,0,0,0,0,0,0,0,0,17000,17000,0,0
051926,聯電中信97購01  ,0,0,0,0,0,0,0,0,0,0,0,0,0,20000,20000,0,0
051922,鴻海亞東96購02  ,0,0,0,0,0,0,0,0,0,0,0,0,0,100000,100000,0,0
05449P,臺股指元大95售26,0,0,0,0,0,0,0,0,0,0,0,0,0,9000,9000,0,0
053064,國巨群益96購04  ,0,0,0,0,0,0,0,0,0,0,0,0,0,258000,258000,0,0
054470,緯穎國票97購04  ,0,0,0,0,0,0,0,0,0,0,0,0,0,1000,1000,0,0
055389,國巨統一98購02  ,0,0,0,0,0,0,0,0,0,0,0,0,0,108000,108000,0,0
055417,健策富邦98購02  ,0,0,0,0,0,0,0,0,0,0,0,0,0,50000,50000,0,0
055568,緯穎凱基97購02  ,0,0,0,0,0,0,0,0,0,0,0,0,0,27000,27000,0,0
055300,緯穎元大98購01  ,0,0,0,0,0,0,0,0,0,0,0,0,0,5000,5000,0,0
055258,玉晶光統一97購03,0,0,0,0,0,0,0,0,0,0,0,0,0,996000,996000,0,0
055337,超眾兆豐98購01  ,0,0,0,0,0,0,0,0,0,0,0,0,0,60000,60000,0,0
055305,旺宏群益99購01  ,0,0,0,0,0,0,0,0,0,0,0,0,0,1000,1000,0,0
055142,健策永豐98購01  ,0,0,0,0,0,0,0,0,0,0,0,0,0,5000,5000,0,0
055122,國巨兆豐98購01  ,0,0,0,0,0,0,0,0,0,0,0,0,0,53000,53000,0,0
058967,可成麥證99購01  ,0,0,0,6000,6000,0,0,0,0,0,0,0,0,8000,8000,0,0
058980,鴻海凱基99購06  ,0,0,0,0,0,0,0,0,0,0,0,0,0,29000,29000,0,0
058873,美律國票9A購02  ,0,0,0,0,0,0,0,0,0,0,0,0,0,17000,17000,0,0
058907,健策元大99購04  ,0,0,0,0,0,0,0,0,0,0,0,0,0,8000,8000,0,0
058936,國喬中信99購01  ,0,0,0,0,0,0,0,0,0,0,0,0,0,68000,68000,0,0
058939,台積電中信9B購01,0,0,0,0,0,0,0,0,0,0,0,0,0,190000,190000,0,0
058758,台積電群益99購05,0,0,0,0,0,0,0,0,0,0,0,0,0,1000,1000,0,0
059066,道瓊指國票04購01,0,0,0,0,0,0,0,0,0,0,0,0,0,49000,49000,0,0
054877,百和群益98購01  ,0,0,0,0,0,0,0,0,0,0,0,0,0,240000,240000,0,0
054886,大毅統一97購01  ,0,0,0,0,0,0,0,0,0,0,0,0,0,1000,1000,0,0
054905,國揚康和97購01  ,0,0,0,0,0,0,0,0,0,0,0,0,0,50000,50000,0,0
053859,台積電元大97購09,0,0,0,0,0,0,0,0,0,0,0,0,0,10000,10000,0,0
053528,南電中信9A購01  ,0,0,0,0,0,0,0,0,0,0,0,0,0,20000,20000,0,0
053529,國巨麥證96購01  ,0,0,0,0,70000,-70000,0,0,0,0,0,0,0,70000,70000,0,0
053443,智邦凱基97購01  ,0,0,0,0,0,0,0,0,0,0,0,0,0,1000,1000,0,0
05480P,滬深2X凱基96售05,0,0,0,0,0,0,0,0,0,0,0,0,0,409000,409000,0,0
053406,國巨兆豐96購02  ,0,0,0,0,0,0,0,0,0,0,0,0,0,10000,10000,0,0
054725,國巨日盛97購01  ,0,0,0,0,0,0,0,0,0,0,0,0,0,20000,20000,0,0
053353,玉晶光兆豐97購03,0,0,0,0,0,0,0,0,0,0,0,0,0,100000,100000,0,0
054951,大毅元大97購01  ,0,0,0,0,0,0,0,0,0,0,0,0,0,2000,2000,0,0
05378P,台積電凱基96售02,0,0,0,0,0,0,0,0,0,0,0,0,0,300000,300000,0,0
054246,國巨元大96購12  ,0,0,0,0,0,0,0,0,0,0,0,0,0,30000,30000,0,0
054196,台光電國泰97購02,0,0,0,0,0,0,0,0,0,0,0,0,0,10000,10000,0,0
054194,國巨麥證96購02  ,0,0,0,0,10000,-10000,0,0,0,0,0,0,0,10000,10000,0,0
058575,智邦群益99購01  ,0,0,0,0,0,0,0,0,0,0,0,0,0,1000,1000,0,0
056731,國巨凱基98購04  ,0,0,0,0,0,0,0,0,0,0,0,0,0,120000,120000,0,0
056732,國巨凱基98購07  ,0,0,0,0,0,0,0,0,0,0,0,0,0,120000,120000,0,0
056735,國巨凱基99購02  ,0,0,0,0,0,0,0,0,0,0,0,0,0,122000,122000,0,0
056736,國巨凱基99購03  ,0,0,0,0,0,0,0,0,0,0,0,0,0,122000,122000,0,0
058590,南電中信9A購02  ,0,0,0,0,0,0,0,0,0,0,0,0,0,20000,20000,0,0
058722,台郡元富99購01  ,0,0,0,0,0,0,0,0,0,0,0,0,0,98000,98000,0,0
058703,台積電元大99購16,0,0,0,0,0,0,0,0,0,0,0,0,0,15000,15000,0,0
058704,台積電元大99購17,0,0,0,0,0,0,0,0,0,0,0,0,0,50000,50000,0,0
058674,宏達電群益99購01,0,0,0,0,0,0,0,0,0,0,0,0,0,98000,98000,0,0
058612,健策元大99購02  ,0,0,0,0,0,0,0,0,0,0,0,0,0,55000,55000,0,0
057728,瑞昱國泰99購01  ,0,0,0,0,0,0,0,0,0,0,0,0,0,10000,10000,0,0
056791,嘉聯益群益98購01,0,0,0,0,0,0,0,0,0,0,0,0,0,84000,84000,0,0
056836,國巨元富98購01  ,0,0,0,0,0,0,0,0,0,0,0,0,0,10000,10000,0,0
055788,緯穎凱基97購04  ,0,0,0,0,0,0,0,0,0,0,0,0,0,61000,61000,0,0
055844,大毅元大98購01  ,0,0,0,0,0,0,0,0,0,0,0,0,0,100000,100000,0,0
056688,聯詠統一98購01  ,0,0,0,0,0,0,0,0,0,0,0,0,0,20000,20000,0,0
05842P,台積電元大96售15,0,0,0,0,0,0,0,0,0,0,0,0,0,243000,243000,0,0
057633,緯穎永豐98購02  ,0,0,0,0,0,0,0,0,0,0,0,0,0,5000,5000,0,0
057619,玉晶光凱基98購02,0,0,0,0,0,0,0,0,0,0,0,0,0,7000,7000,0,0
057604,鴻海統一9C購01  ,0,0,0,0,0,0,0,0,0,0,0,0,0,3000,3000,0,0
05760P,京鼎永豐96售02  ,0,0,0,0,0,0,0,0,0,0,0,0,0,24000,24000,0,0
05756P,臺股指中信99售05,0,0,0,0,0,0,0,0,0,0,0,0,0,1000,1000,0,0
057598,鴻海群益98購07  ,0,0,0,0,0,0,0,0,0,0,0,0,0,3000,3000,0,0
05848P,臺股指元大96售24,0,0,0,0,0,0,0,0,0,0,0,0,0,30000,30000,0,0
055683,晶技凱基99購01  ,0,0,0,0,0,0,0,0,0,0,0,0,0,29000,29000,0,0
058432,台積電統一9B購03,0,0,0,0,0,0,0,0,0,0,0,0,0,5000,5000,0,0
056330,玉晶光國票99購03,0,0,0,0,0,0,0,0,0,0,0,0,0,5000,5000,0,0
05630P,大立光永昌96售06,0,0,0,0,0,0,0,0,0,0,0,0,0,150000,150000,0,0
056354,國巨元大98購10  ,0,0,0,0,0,0,0,0,0,0,0,0,0,42000,42000,0,0
05779P,台積電統一96售06,0,0,0,0,0,0,0,0,0,0,0,0,0,80000,80000,0,0
057790,台積電統一99購04,0,0,0,0,0,0,0,0,0,0,0,0,0,1000,1000,0,0
057789,上銀統一9A購01  ,0,0,0,0,0,0,0,0,0,0,0,0,0,48000,48000,0,0
057757,鴻海凱基98購13  ,0,0,0,0,0,0,0,0,0,0,0,0,0,5000,5000,0,0
057758,鴻海凱基99購03  ,0,0,0,0,0,0,0,0,0,0,0,0,0,1000,1000,0,0
05773P,臺股指凱基99售03,0,0,0,0,0,0,0,0,0,0,10000,0,10000,0,10000,-10000,0
057741,超眾富邦98購01  ,0,0,0,0,0,0,0,0,0,0,0,0,0,10000,10000,0,0
056421,鴻海統一98購08  ,0,0,0,0,0,0,0,0,0,0,0,0,0,10000,10000,0,0
056511,超眾永豐98購01  ,0,0,0,0,0,0,0,0,0,0,0,0,0,66000,66000,0,0
057273,智邦元大98購05  ,0,0,0,0,0,0,0,0,0,0,0,0,0,1000,1000,0,0
057370,可成元大98購07  ,0,0,0,0,0,0,0,0,0,0,0,0,0,4000,4000,0,0
057363,華通元大99購02  ,0,0,0,0,0,0,0,0,0,0,0,0,0,2000,2000,0,0
057364,國巨元大98購18  ,0,0,0,0,0,0,0,0,0,0,0,0,0,50000,50000,0,0
057471,昇陽半永豐98購02,0,0,0,0,0,0,0,0,0,0,0,0,0,60000,60000,0,0
057477,智邦元大98購09  ,0,0,0,0,0,0,0,0,0,0,0,0,0,1000,1000,0,0
056237,智邦群益97購02  ,0,0,0,0,0,0,0,0,0,0,0,0,0,13000,13000,0,0
056260,鴻海統一98購07  ,0,0,0,0,0,0,0,0,0,0,0,0,0,5000,5000,0,0
056262,台積電統一98購04,0,0,0,0,0,0,0,0,0,0,0,0,0,5000,5000,0,0
056265,國泰金統一97購01,0,0,0,0,0,0,0,0,0,0,0,0,0,9000,9000,0,0
057831,聯發科元富02購04,0,0,0,0,0,0,0,0,0,0,0,0,0,5000,5000,0,0
059630,美律凱基99購07  ,0,0,0,0,0,0,0,0,0,0,0,0,0,10000,10000,0,0
059645,祥碩凱基99購05  ,0,0,0,0,0,0,0,0,0,0,0,0,0,22000,22000,0,0
059717,國巨元大99購21  ,0,0,0,0,0,0,0,0,0,0,0,0,0,3000,3000,0,0
059668,台灣50元富9B購04,0,0,0,0,0,0,0,0,0,0,0,0,0,1000,1000,0,0
059761,國巨永豐99購06  ,0,0,0,0,0,0,0,0,0,0,0,0,0,120000,120000,0,0
059721,旺宏元大99購16  ,0,0,0,0,0,0,0,0,0,0,0,0,0,30000,30000,0,0
05924P,超眾元富96售04  ,0,0,0,0,0,0,0,0,0,0,0,0,0,99000,99000,0,0
05925P,晶技永豐96售03  ,0,0,0,0,0,0,0,0,0,0,0,0,0,160000,160000,0,0
059237,鴻海凱基9A購10  ,0,0,0,0,0,0,0,0,0,0,0,0,0,1000,1000,0,0
059275,可成元大99購05  ,0,0,0,0,0,0,0,0,0,0,0,0,0,4000,4000,0,0
059352,台灣50富邦01購01,0,0,0,0,0,0,0,0,0,0,0,0,0,1000,1000,0,0
059355,國巨富邦9B購03  ,0,0,0,0,0,0,0,0,0,0,0,0,0,120000,120000,0,0
059366,台積電台新99購04,0,0,0,0,0,0,0,0,0,0,0,0,0,1000,1000,0,0
05954P,旺宏國票97售03  ,0,0,0,0,0,0,0,0,0,0,0,0,0,1000,1000,0,0
059495,台灣50元富9C購02,0,0,0,0,0,0,0,0,0,0,0,0,0,1000,1000,0,0
057089,奇力新元富98購01,0,0,0,0,0,0,0,0,0,0,0,0,0,128000,128000,0,0
057996,臻鼎中信98購01  ,0,0,0,0,0,0,0,0,0,0,0,0,0,20000,20000,0,0
057994,技嘉中信98購01  ,0,0,0,0,0,0,0,0,0,0,0,0,0,20000,20000,0,0
058085,景碩群益9A購01  ,0,0,0,0,0,0,0,0,0,0,0,0,0,100000,100000,0,0
058095,昇陽半元大98購03,0,0,0,0,0,0,0,0,0,0,0,0,0,110000,110000,0,0
058036,南電永豐98購01  ,0,0,0,0,0,0,0,0,0,0,0,0,0,20000,20000,0,0
059156,台灣50凱基01購03,0,0,0,0,0,0,0,0,0,0,0,0,0,1000,1000,0,0
059159,上銀凱基99購05  ,0,0,0,0,0,0,0,0,0,0,0,0,0,1000,1000,0,0
059162,國巨凱基99購12  ,0,0,0,0,0,0,0,0,0,0,0,0,0,120000,120000,0,0
058124,玉晶光國票9A購01,0,0,0,0,0,0,0,0,0,0,0,0,0,5000,5000,0,0
058119,華新亞東99購01  ,0,0,0,0,0,0,0,0,0,0,0,0,0,48000,48000,0,0
05937P,台積電凱基96售21,0,0,0,0,0,0,0,0,0,0,0,0,0,110000,110000,0,0
059404,鴻海台新99購03  ,0,0,0,0,0,0,0,0,0,0,0,0,0,5000,5000,0,0
059698,滬深2X凱基9A購02,0,0,0,0,0,0,0,0,0,0,0,0,0,15000,15000,0,0
059451,國巨永豐99購05  ,0,0,0,0,0,0,0,0,0,0,0,0,0,120000,120000,0,0
05919P,京鼎元大96售03  ,0,0,0,0,0,0,0,0,0,0,0,0,0,188000,188000,0,0
058168,國巨凱基9A購04  ,0,0,0,0,0,0,0,0,0,0,0,0,0,10000,10000,0,0
058163,道瓊反凱基9B購01,0,0,0,0,0,0,0,0,0,0,0,0,0,10000,10000,0,0
058199,國巨康和99購01  ,0,0,0,0,0,0,0,0,0,0,0,0,0,120000,120000,0,0
05790P,臺股指永昌96售07,0,0,0,0,0,0,0,0,0,0,0,0,0,14000,14000,0,0
057941,聯電國票99購01  ,0,0,0,0,0,0,0,0,0,0,0,0,0,25000,25000,0,0
057526,智邦元大98購10  ,0,0,0,0,0,0,0,0,0,0,0,0,0,1000,1000,0,0
057530,奇鋐元大99購01  ,0,0,0,0,0,0,0,0,0,0,0,0,0,6000,6000,0,0
057504,技嘉麥證98購01  ,0,0,0,50000,59000,-9000,0,0,0,0,0,0,0,59000,59000,0,0
055926,國巨群益98購06  ,0,0,0,0,0,0,0,0,0,0,0,0,0,120000,120000,0,0
055951,大成鋼元大97購02,8000,0,8000,0,0,0,0,0,0,-8000,0,0,0,0,8000,-8000,0
055960,義隆元大97購01  ,0,0,0,0,0,0,0,0,0,0,0,0,0,10000,10000,0,0
055911,可成凱基98購02  ,0,0,0,0,0,0,0,0,0,0,0,0,0,2000,2000,0,0
055915,大立光凱基98購07,0,0,0,0,0,0,0,0,0,0,0,0,0,10000,10000,0,0
057201,華擎元富98購01  ,0,0,0,0,0,0,0,0,0,0,0,0,0,30000,30000,0,0
057165,國巨元大99購05  ,0,0,0,0,0,0,0,0,0,0,0,0,0,10000,10000,0,0
05824P,臺股指凱基96售21,0,0,0,0,0,0,0,0,0,0,10000,0,10000,0,10000,-10000,0
05822P,臺股指凱基96售19,0,0,0,0,0,0,0,0,0,0,10000,0,10000,0,10000,-10000,0
058230,國巨元大99購11  ,0,0,0,0,0,0,0,0,0,0,0,0,0,60000,60000,0,0
058306,聯發科元大99購07,0,0,0,0,0,0,0,0,0,0,0,0,0,10000,10000,0,0
05827P,台積電統一96售10,0,0,0,0,0,0,0,0,0,0,0,0,0,30000,30000,0,0
058319,大毅永豐9A購01  ,0,0,0,0,0,0,0,0,0,0,0,0,0,102000,102000,0,0
058410,國巨兆豐99購03  ,0,0,0,0,0,0,0,0,0,0,0,0,0,75000,75000,0,0
058414,大立光兆豐99購02,0,0,0,0,0,0,0,0,0,0,0,0,0,142000,142000,0,0
056039,宏達電凱基97購02,0,0,0,0,0,0,0,0,0,0,0,0,0,200000,200000,0,0
056054,亞德客元大97購05,0,0,0,0,0,0,0,0,0,0,0,0,0,2000,2000,0,0
057017,和大凱基98購01  ,0,0,0,0,0,0,0,0,0,0,0,0,0,20000,20000,0,0
057040,國巨元大98購12  ,0,0,0,0,0,0,0,0,0,0,0,0,0,70000,70000,0,0
056990,聯發科兆豐98購01,114000,0,114000,0,0,0,0,0,0,-114000,0,0,0,0,114000,-114000,0
2069,運錩            ,2000,2000,0,0,0,0,0,0,0,0,0,0,0,0,0,0,0
2433,互盛電          ,6000,6000,0,0,0,0,0,0,0,0,0,0,0,0,0,0,0
1817,凱撒衛          ,1000,1000,0,0,0,0,0,0,0,0,0,0,0,0,0,0,0
1614,三洋電          ,10000,10000,0,0,0,0,0,0,0,0,0,0,0,0,0,0,0
1453,大將            ,2000,2000,0,0,0,0,0,0,0,0,0,0,0,0,0,0,0
1416,廣豐            ,3000,3000,0,0,0,0,0,0,0,0,0,0,0,0,0,0,0
1410,南染            ,1000,1000,0,0,0,0,0,0,0,0,0,0,0,0,0,0,0
1524,耿鼎            ,5000,5000,0,0,0,0,0,0,0,0,0,0,0,0,0,0,0
2849,安泰銀          ,6000,6000,0,0,0,0,0,0,0,0,0,0,0,0,0,0,0
2701,萬企            ,3000,3000,0,0,0,0,0,0,0,0,0,0,0,0,0,0,0
2462,良得電          ,2000,2000,0,0,0,0,0,0,0,0,0,0,0,0,0,0,0
2546,根基            ,24000,24000,0,0,0,0,0,0,0,0,0,0,0,0,0,0,0
3013,晟銘電          ,3000,3000,0,0,0,0,0,0,0,0,0,0,0,0,0,0,0
2910,統領            ,1000,1000,0,0,0,0,0,0,0,0,0,0,0,0,0,0,0
3296,勝德            ,1000,1000,0,0,0,0,0,0,0,0,0,0,0,0,0,0,0
3528,安馳            ,1000,1000,0,0,0,0,0,0,0,0,0,0,0,0,0,0,0
3550,聯穎            ,5000,5000,0,0,0,0,0,0,0,0,0,0,0,0,0,0,0
3622,洋華            ,10000,10000,0,0,0,0,0,0,0,0,0,0,0,0,0,0,0
07223P,鴻海元大99售29  ,0,0,0,0,0,0,0,0,0,0,0,0,0,74000,74000,0,0
07198P,臺股指元大99售14,0,0,0,0,0,0,0,0,0,0,0,0,0,19000,19000,0,0
07083P,台積電統一9A售06,0,0,0,0,0,0,0,0,0,0,0,0,0,60000,60000,0,0
07005P,台積電統一9B售05,0,0,0,0,0,0,0,0,0,0,0,0,0,70000,70000,0,0
07477P,國巨群益9A售04  ,0,0,0,0,0,0,0,0,0,0,0,0,0,10000,10000,0,0
07504P,聯詠元大9A售02  ,0,0,0,0,0,0,0,0,0,0,0,0,0,50000,50000,0,0
07497P,鴻海元大9A售06  ,0,0,0,0,0,0,0,0,0,0,0,0,0,50000,50000,0,0
07450P,鴻海元大9A售03  ,0,0,0,0,0,0,0,0,0,0,0,0,0,129000,129000,0,0
07451P,鴻海元大9B售01  ,0,0,0,0,0,0,0,0,0,0,0,0,0,49000,49000,0,0
07357P,鴻海元大99售38  ,0,0,0,0,0,0,0,0,0,0,0,0,0,100000,100000,0,0
07291P,臺股指凱基99售43,0,0,0,0,0,0,0,0,0,0,0,0,0,15000,15000,0,0
07374P,鴻海元大99售41  ,0,0,0,0,0,0,0,0,0,0,0,0,0,100000,100000,0,0
07383P,聯發科群益99售06,0,0,0,0,0,0,0,0,0,0,0,0,0,20000,20000,0,0
07311P,台灣50元大99售09,0,0,0,0,0,0,0,0,0,0,0,0,0,2000,2000,0,0
07322P,鴻海元大99售33  ,0,0,0,0,0,0,0,0,0,0,0,0,0,95000,95000,0,0
07693P,群創元大9B售10  ,0,0,0,0,0,0,0,0,0,0,0,0,0,12000,12000,0,0
07695P,台郡元大9A售02  ,0,0,0,0,0,0,0,0,0,0,0,0,0,24000,24000,0,0
07576P,可成元大9A售01  ,0,0,0,0,0,0,0,0,0,0,0,0,0,60000,60000,0,0
07895P,美律元大9B售01  ,0,0,0,0,0,0,0,0,0,0,0,0,0,5000,5000,0,0
1234,黑松            ,3000,3000,0,0,0,0,0,0,0,0,0,0,0,0,0,0,0
07780P,美律凱基9A售02  ,0,0,0,0,0,0,0,0,0,0,0,0,0,6000,6000,0,0
07816P,聯發科群益9A售02,0,0,0,0,0,0,0,0,0,0,0,0,0,38000,38000,0,0
6024,群益期          ,49000,49000,0,0,0,0,0,0,0,0,0,0,0,0,0,0,0
5284,jpp-KY          ,3000,3000,0,0,0,0,0,0,0,0,0,0,0,0,0,0,0
8442,威宏-KY         ,1000,1000,0,0,0,0,0,0,0,0,0,0,0,0,0,0,0
8481,政伸            ,1000,1000,0,0,0,0,0,0,0,0,0,0,0,0,0,0,0
6674,鋐寶科技        ,1000,1000,0,0,0,0,0,0,0,0,0,0,0,0,0,0,0
06176P,台積電元大97售22,0,0,0,0,0,0,0,0,0,-1000,0,0,0,0,1000,-1000,-1000
061738,聯發科凱基9B購04,0,0,0,0,0,0,0,0,0,-1000,0,0,0,10000,11000,-1000,-1000
061739,奇力新凱基9C購01,0,0,0,0,0,0,0,0,0,-1000,0,0,0,0,1000,-1000,-1000
061710,國巨凱基9A購18  ,0,0,0,0,0,0,0,0,0,-1000,0,0,0,120000,121000,-1000,-1000
061400,可成兆豐9B購02  ,0,0,0,0,0,0,0,0,0,-1000,0,0,0,0,1000,-1000,-1000
061255,道瓊反凱基9C購01,0,0,0,0,0,0,0,0,0,-1000,0,0,0,0,1000,-1000,-1000
06631P,玉晶光群益9A售03,0,0,0,0,0,0,0,0,0,-1000,0,0,0,0,1000,-1000,-1000
06619P,聯發科元大98售06,0,0,0,0,0,0,0,0,0,-1000,0,0,0,0,1000,-1000,-1000
06659P,T50正2富邦9A售01,0,0,0,0,0,0,0,0,0,-1000,0,0,0,0,1000,-1000,-1000
06527P,T50正2富邦9C售01,0,0,0,0,0,0,0,0,0,-1000,0,0,0,0,1000,-1000,-1000
06564P,國巨富邦9A售04  ,0,0,0,0,0,0,0,0,0,-1000,0,0,0,0,1000,-1000,-1000
06751P,旺宏凱基98售10  ,0,0,0,0,0,0,0,0,0,-1000,0,0,0,1000,2000,-1000,-1000
06767P,台積電永昌99售03,0,0,0,0,0,0,0,0,0,-1000,0,0,0,15000,16000,-1000,-1000
06771P,台灣50中信02售01,0,0,0,0,0,0,0,0,0,-1000,0,0,0,1000,2000,-1000,-1000
06865P,亞德客元大98售04,0,0,0,0,0,0,0,0,0,-1000,0,0,0,47000,48000,-1000,-1000
061851,智邦國票9B購01  ,0,0,0,0,0,0,0,0,0,-1000,0,0,0,0,1000,-1000,-1000
061854,祥碩國票9B購02  ,0,0,0,0,0,0,0,0,0,-1000,0,0,0,45000,46000,-1000,-1000
061905,上証反中信03購01,0,0,0,0,0,0,0,0,0,-1000,0,0,0,0,1000,-1000,-1000
061981,聯發科元大9B購02,0,0,0,0,0,0,0,0,0,-1000,0,0,0,0,1000,-1000,-1000
061982,聯發科元大9B購03,0,0,0,0,0,0,0,0,0,-1000,0,0,0,0,1000,-1000,-1000
06204P,鴻海群益97售04  ,0,0,0,0,0,0,0,0,0,-1000,0,0,0,0,1000,-1000,-1000
062176,元金2X元大9B購01,0,0,0,0,0,0,0,0,0,-1000,0,0,0,0,1000,-1000,-1000
06213P,大立光元大98售07,0,0,0,0,0,0,0,0,0,-1000,0,0,0,0,1000,-1000,-1000
06273P,台表科凱基97售04,0,0,0,0,0,0,0,0,0,-1000,0,0,0,0,1000,-1000,-1000
06274P,臺股指凱基97售06,0,0,0,0,0,0,0,0,0,-1000,0,0,0,0,1000,-1000,-1000
06295P,國巨元大97售14  ,0,0,0,0,0,0,0,0,0,-1000,0,0,0,0,1000,-1000,-1000
06233P,訊芯永豐97售03  ,0,0,0,0,0,0,0,0,0,-1000,0,0,0,3000,4000,-1000,-1000
060135,台灣50國票9C購02,0,0,0,0,0,0,0,0,0,-1000,0,0,0,1000,2000,-1000,-1000
060276,S&P反1元大9A購03,0,0,0,0,0,0,0,0,0,-1000,0,0,0,0,1000,-1000,-1000
060370,滬深2X元富04購01,0,0,0,0,0,0,0,0,0,-1000,0,0,0,4000,5000,-1000,-1000
059848,智邦永豐99購01  ,0,0,0,0,0,0,0,0,0,-1000,0,0,0,15000,16000,-1000,-1000
059899,上証2X元大9C購04,0,0,0,0,0,0,0,0,0,-1000,0,0,0,0,1000,-1000,-1000
05999P,世芯元大96售01  ,0,0,0,0,0,0,0,0,0,-1000,0,0,0,0,1000,-1000,-1000
060988,華新科元大9A購12,0,0,0,0,0,0,0,0,0,-1000,0,0,0,0,1000,-1000,-1000
061067,貿聯凱基9A購03  ,0,0,0,0,0,0,0,0,0,-1000,0,0,0,0,1000,-1000,-1000
061122,敬鵬永豐9A購01  ,0,0,0,0,0,0,0,0,0,-1000,0,0,0,0,1000,-1000,-1000
061079,台積電兆豐9A購02,0,0,0,0,0,0,0,0,0,-1000,0,0,0,10000,11000,-1000,-1000
060879,華新科中信9A購02,0,0,0,0,0,0,0,0,0,-1000,0,0,0,0,1000,-1000,-1000
06087P,國巨永豐97售01  ,0,0,0,0,0,0,0,0,0,-1000,0,0,0,0,1000,-1000,-1000
060833,道瓊反國票9A購01,0,0,0,0,0,0,0,0,0,-1000,0,0,0,0,1000,-1000,-1000
060834,道瓊反國票9C購01,0,0,0,0,0,0,0,0,0,-1000,0,0,0,0,1000,-1000,-1000
060895,華新科凱基9B購05,0,0,0,0,0,0,0,0,0,-1000,0,0,0,0,1000,-1000,-1000
06053P,緯穎國票97售05  ,0,0,0,0,0,0,0,0,0,-1000,0,0,0,0,1000,-1000,-1000
060519,S&P500中信01購01,0,0,0,0,0,0,0,0,0,-1000,0,0,0,0,1000,-1000,-1000
060478,南電元大9A購01  ,0,0,0,0,0,0,0,0,0,-1000,0,0,0,30000,31000,-1000,-1000
060491,台灣50元富04購01,0,0,0,0,0,0,0,0,0,-1000,0,0,0,0,1000,-1000,-1000
060673,旺宏元大9A購04  ,0,0,0,0,0,0,0,0,0,-1000,0,0,0,0,1000,-1000,-1000
060669,上証2X元大9A購03,0,0,0,0,0,0,0,0,0,-1000,0,0,0,0,1000,-1000,-1000
060695,同欣電麥證9A購01,0,0,0,104000,105000,-1000,0,0,0,-1000,0,0,0,104000,105000,-1000,-1000
060743,鴻海國票9A購03  ,0,0,0,0,0,0,0,0,0,-1000,0,0,0,0,1000,-1000,-1000
054231,國巨群益98購03  ,0,0,0,0,0,0,0,0,0,-1000,0,0,0,109000,110000,-1000,-1000
05411P,台積電國票96售08,0,0,0,0,0,0,0,0,0,-1000,0,0,0,0,1000,-1000,-1000
054962,玉晶光元大99購02,0,0,0,0,0,0,0,0,0,-1000,0,0,0,0,1000,-1000,-1000
054990,凌陽元富97購01  ,0,0,0,0,0,0,0,0,0,-1000,0,0,0,0,1000,-1000,-1000
054361,技嘉凱基96購01  ,0,0,0,0,0,0,0,0,0,-1000,0,0,0,0,1000,-1000,-1000
054370,台積電中信9A購01,0,0,0,0,0,0,0,0,0,-1000,0,0,0,4000,5000,-1000,-1000
053349,台郡國票97購02  ,0,0,0,0,0,0,0,0,0,-1000,0,0,0,0,1000,-1000,-1000
054713,國巨中信9B購01  ,0,0,0,0,0,0,0,0,0,-1000,0,0,0,0,1000,-1000,-1000
05337P,臺股指國票95售06,0,0,0,0,0,0,0,0,0,-1000,0,0,0,0,1000,-1000,-1000
054900,金寶康和97購01  ,0,0,0,0,0,0,0,0,0,-1000,0,0,0,0,1000,-1000,-1000
054885,建準統一98購01  ,0,0,0,0,0,0,0,0,0,-1000,0,0,0,0,1000,-1000,-1000
058835,元油2X中信9C購02,0,0,0,0,0,0,0,0,0,-1000,0,0,0,8000,9000,-1000,-1000
058942,南茂中信99購01  ,0,0,0,0,0,0,0,0,0,-1000,0,0,0,10000,11000,-1000,-1000
05361P,聯發科富邦97售01,0,0,0,0,0,0,0,0,0,-1000,0,0,0,0,1000,-1000,-1000
053629,玉山金兆豐96購01,0,0,0,0,0,0,0,0,0,-1000,0,0,0,0,1000,-1000,-1000
053627,宏碁兆豐97購01  ,0,0,0,0,0,0,0,0,0,-1000,0,0,0,0,1000,-1000,-1000
05551P,電子類元大96售01,0,0,0,0,0,0,0,0,0,-1000,0,0,0,0,1000,-1000,-1000
05559P,臺股指麥證96售01,0,0,0,0,1000,-1000,0,0,0,-1000,0,0,0,0,1000,-1000,-1000
054480,和碩中信98購01  ,0,0,0,0,0,0,0,0,0,-1000,0,0,0,59000,60000,-1000,-1000
051971,元金2X凱基97購02,0,0,0,0,0,0,0,0,0,-1000,0,0,0,0,1000,-1000,-1000
051624,智邦麥證95購02  ,0,0,0,0,1000,-1000,0,0,0,-1000,0,0,0,0,1000,-1000,-1000
054578,世芯元大99購01  ,0,0,0,0,0,0,0,0,0,-1000,0,0,0,0,1000,-1000,-1000
054586,健鼎國泰99購01  ,0,0,0,0,0,0,0,0,0,-1000,0,0,0,0,1000,-1000,-1000
052400,聯詠凱基97購01  ,0,0,0,0,0,0,0,0,0,-1000,0,0,0,0,1000,-1000,-1000
051469,友達日盛9B購01  ,0,0,0,0,0,0,0,0,0,-1000,0,0,0,0,1000,-1000,-1000
052856,滬深2X凱基98購01,0,0,0,0,0,0,0,0,0,-1000,0,0,0,0,1000,-1000,-1000
052747,京鼎元大97購01  ,0,0,0,0,0,0,0,0,0,-1000,0,0,0,0,1000,-1000,-1000
052955,國巨日盛96購01  ,0,0,0,0,0,0,0,0,0,-1000,0,0,0,0,1000,-1000,-1000
04869P,鴻海元富95售02  ,0,0,0,0,0,0,0,0,0,-1000,0,0,0,0,1000,-1000,-1000
051001,緯穎元大96購02  ,0,0,0,0,0,0,0,0,0,-1000,0,0,0,0,1000,-1000,-1000
03427B,臺股指元大9A熊02,0,0,0,0,0,0,0,0,0,-1000,0,0,0,0,1000,-1000,-1000
03424B,臺股指元大96熊26,0,0,0,0,0,0,0,0,0,-1000,0,0,0,0,1000,-1000,-1000
03022X,富展01          ,0,0,0,0,0,0,0,0,0,-1000,0,0,0,0,1000,-1000,-1000
03026X,元展23          ,0,0,0,0,0,0,0,0,0,-1000,0,0,0,0,1000,-1000,-1000
03049X,元展46          ,0,0,0,0,0,0,0,0,0,-1000,0,0,0,0,1000,-1000,-1000
006203,元大MSCI台灣    ,0,0,0,0,0,0,0,0,0,-1000,0,0,0,2000,3000,-1000,-1000
00736,國泰新興市場    ,106000,0,106000,0,0,0,0,0,0,-107000,0,0,0,102000,209000,-107000,-1000
057193,力成元大98購02  ,0,0,0,0,0,0,0,0,0,-1000,0,0,0,0,1000,-1000,-1000
057492,大立光元大98購18,0,0,0,0,0,0,0,0,0,-1000,0,0,0,5000,6000,-1000,-1000
057540,緯穎日盛99購01  ,0,0,0,0,0,0,0,0,0,-1000,0,0,0,0,1000,-1000,-1000
057929,上銀群益98購02  ,0,0,0,0,0,0,0,0,0,-1000,0,0,0,1000,2000,-1000,-1000
057943,可成國票99購03  ,0,0,0,0,0,0,0,0,0,-1000,0,0,0,45000,46000,-1000,-1000
05813P,臺股指國票96售06,0,0,0,0,0,0,0,0,0,-1000,0,0,0,0,1000,-1000,-1000
059151,臺股指國票99購14,0,0,0,0,0,0,0,0,0,-1000,0,0,0,26000,27000,-1000,-1000
058088,鴻海元大9A購01  ,0,0,0,0,0,0,0,0,0,-1000,0,0,0,17000,18000,-1000,-1000
058078,景碩國票99購01  ,0,0,0,0,0,0,0,0,0,-1000,0,0,0,14000,15000,-1000,-1000
057079,台積電統一9A購02,0,0,0,0,0,0,0,0,0,-1000,0,0,0,0,1000,-1000,-1000
057117,開發金日盛9B購01,0,0,0,0,0,0,0,0,0,-1000,0,0,0,0,1000,-1000,-1000
059524,FBVIX凱基9A購02 ,0,0,0,0,0,0,0,0,0,-1000,0,0,0,41000,42000,-1000,-1000
059333,滬深2X國票9A購03,0,0,0,0,0,0,0,0,0,-1000,0,0,0,0,1000,-1000,-1000
057281,大立光元大98購16,0,0,0,0,0,0,0,0,0,-1000,0,0,0,0,1000,-1000,-1000
05730P,臺股指凱基97售03,0,0,0,0,0,0,0,0,0,-1000,0,0,0,0,1000,-1000,-1000
056479,玉晶光元大99購05,0,0,0,0,0,0,0,0,0,-1000,0,0,0,97000,98000,-1000,-1000
05647P,聯發科國票97售02,0,0,0,0,0,0,0,0,0,-1000,0,0,0,20000,21000,-1000,-1000
059113,群光永豐99購01  ,0,0,0,0,0,0,0,0,0,-1000,0,0,0,0,1000,-1000,-1000
056534,京元電凱基98購01,0,0,0,0,0,0,0,0,0,-1000,0,0,0,2000,3000,-1000,-1000
056870,全新日盛9A購01  ,0,0,0,0,0,0,0,0,0,-1000,0,0,0,0,1000,-1000,-1000
05778P,台積電統一96售05,0,0,0,0,0,0,0,0,0,-1000,0,0,0,0,1000,-1000,-1000
056307,貿聯元大97購05  ,0,0,0,0,0,0,0,0,0,-1000,0,0,0,0,1000,-1000,-1000
056296,旺宏元大97購07  ,0,0,0,0,0,0,0,0,0,-1000,0,0,0,0,1000,-1000,-1000
058487,晶技國票9A購01  ,0,0,0,0,0,0,0,0,0,-1000,0,0,0,0,1000,-1000,-1000
05902P,華通國票96售02  ,0,0,0,0,0,0,0,0,0,-1000,0,0,0,3000,4000,-1000,-1000
05668P,滬深2X永豐96售04,0,0,0,0,0,0,0,0,0,-1000,0,0,0,0,1000,-1000,-1000
05666P,聯發科凱基96售14,0,0,0,0,0,0,0,0,0,-1000,0,0,0,0,1000,-1000,-1000
057641,旺宏元大98購10  ,0,0,0,0,0,0,0,0,0,-1000,0,0,0,3000,4000,-1000,-1000
059099,元油2X統一9C購01,0,0,0,0,0,0,0,0,0,-1000,0,0,0,0,1000,-1000,-1000
05682P,大立光元大98售03,0,0,0,0,0,0,0,0,0,-1000,0,0,0,0,1000,-1000,-1000
05677P,玉晶光群益98售03,0,0,0,0,0,0,0,0,0,-1000,0,0,0,70000,71000,-1000,-1000
6671,三能-KY         ,3000,4000,-1000,0,0,0,0,0,0,0,0,0,0,0,0,0,-1000
8940,新天地          ,0,1000,-1000,0,0,0,0,0,0,0,0,0,0,0,0,0,-1000
911622,泰聚亨-DR       ,0,0,0,0,0,0,0,0,0,-1000,0,1000,-1000,0,0,0,-1000
9929,秋雨            ,0,1000,-1000,0,0,0,0,0,0,0,0,0,0,0,0,0,-1000
6205,詮欣            ,0,1000,-1000,0,0,0,0,0,0,0,0,0,0,0,0,0,-1000
1219,福壽            ,2000,3000,-1000,0,0,0,0,0,0,0,0,0,0,0,0,0,-1000
1312A,國喬特          ,0,0,0,0,0,0,0,0,0,-1000,0,1000,-1000,0,0,0,-1000
07589P,玉晶光國票9A售02,0,0,0,0,0,0,0,0,0,-1000,0,0,0,0,1000,-1000,-1000
07603P,台積電統一9B售08,0,0,0,0,0,0,0,0,0,-1000,0,0,0,0,1000,-1000,-1000
07734P,台積電富邦9C售10,0,0,0,0,0,0,0,0,0,-1000,0,0,0,0,1000,-1000,-1000
07737P,華通永豐9A售01  ,0,0,0,0,0,0,0,0,0,-1000,0,0,0,0,1000,-1000,-1000
07692P,玉晶光元大9A售11,0,0,0,0,0,0,0,0,0,-1000,0,0,0,0,1000,-1000,-1000
07444P,聯發科凱基9A售10,0,0,0,0,0,0,0,0,0,-1000,0,0,0,0,1000,-1000,-1000
07411P,國巨元大99售31  ,0,0,0,0,0,0,0,0,0,-1000,0,0,0,0,1000,-1000,-1000
07429P,臺股指國票9A售01,0,0,0,0,0,0,0,0,0,-1000,0,0,0,0,1000,-1000,-1000
06972P,聯發科元大99售04,0,0,0,0,0,0,0,0,0,-1000,0,0,0,0,1000,-1000,-1000
07013P,玉晶光群益9A售06,0,0,0,0,0,0,0,0,0,-1000,0,0,0,0,1000,-1000,-1000
07090P,台灣50凱基01售01,0,0,0,0,0,0,0,0,0,-1000,0,0,0,0,1000,-1000,-1000
07065P,臺股指元大9A售26,0,0,0,0,0,0,0,0,0,-1000,0,0,0,0,1000,-1000,-1000
07058P,台積電凱基9A售07,0,0,0,0,0,0,0,0,0,-1000,0,0,0,0,1000,-1000,-1000
07202P,台灣50凱基9C售04,0,0,0,0,0,0,0,0,0,-1000,0,0,0,0,1000,-1000,-1000
07194P,聯發科元大99售25,0,0,0,0,0,0,0,0,0,-1000,0,0,0,0,1000,-1000,-1000
07222P,台灣50元大01售04,0,0,0,0,0,0,0,0,0,-1000,0,0,0,0,1000,-1000,-1000
3591,艾笛森          ,2000,3000,-1000,0,0,0,0,0,0,0,0,0,0,0,0,0,-1000
3229,晟鈦            ,0,1000,-1000,0,0,0,0,0,0,0,0,0,0,0,0,0,-1000
2904,匯僑            ,0,1000,-1000,0,0,0,0,0,0,0,0,0,0,0,0,0,-1000
3002,歐格            ,0,1000,-1000,0,0,0,0,0,0,0,0,0,0,0,0,0,-1000
3025,星通            ,1000,2000,-1000,0,0,0,0,0,0,0,0,0,0,0,0,0,-1000
3028,增你強          ,28000,29000,-1000,0,0,0,0,0,0,0,0,0,0,0,0,0,-1000
2528,皇普            ,12000,13000,-1000,0,0,0,0,0,0,0,0,0,0,0,0,0,-1000
2491,吉祥全          ,1000,2000,-1000,0,0,0,0,0,0,0,0,0,0,0,0,0,-1000
2482,連宇            ,0,1000,-1000,0,0,0,0,0,0,0,0,0,0,0,0,0,-1000
2712,遠雄來          ,2000,3000,-1000,0,0,0,0,0,0,0,0,0,0,0,0,0,-1000
1465,偉全            ,2000,3000,-1000,0,0,0,0,0,0,0,0,0,0,0,0,0,-1000
1737,臺鹽            ,8000,9000,-1000,0,0,0,0,0,0,0,0,0,0,0,0,0,-1000
2038,海光            ,1000,2000,-1000,0,0,0,0,0,0,0,0,0,0,0,0,0,-1000
2033,佳大            ,0,1000,-1000,0,0,0,0,0,0,0,0,0,0,0,0,0,-1000
2243,宏旭-KY         ,0,1000,-1000,0,0,0,0,0,0,0,0,0,0,0,0,0,-1000
2302,麗正            ,3000,4000,-1000,0,0,0,0,0,0,0,0,0,0,0,0,0,-1000
3501,維熹            ,18500,20000,-1500,0,0,0,0,0,0,0,0,0,0,0,0,0,-1500
060980,台積電元大9A購21,0,0,0,0,0,0,0,0,0,-2000,0,0,0,0,2000,-2000,-2000
061089,台積電統一9C購04,0,0,0,0,0,0,0,0,0,-2000,0,0,0,0,2000,-2000,-2000
059977,鴻海元大99購40  ,0,0,0,0,0,0,0,0,0,-2000,0,0,0,60000,62000,-2000,-2000
060020,康控康和99購01  ,0,0,0,0,0,0,0,0,0,-2000,0,0,0,0,2000,-2000,-2000
060395,儒鴻國票9A購01  ,0,0,0,0,0,0,0,0,0,-2000,0,0,0,10000,12000,-2000,-2000
060280,元金2X元大9A購01,0,0,0,0,0,0,0,0,0,-2000,0,0,0,210000,212000,-2000,-2000
060261,臺股指凱基9A購04,0,0,0,0,0,0,0,0,0,-2000,0,0,0,3000,5000,-2000,-2000
060220,華新科凱基9A購08,0,0,0,0,0,0,0,0,0,-2000,0,0,0,0,2000,-2000,-2000
06356P,啟碁永豐97售01  ,0,0,0,0,0,0,0,0,0,-2000,0,0,0,0,2000,-2000,-2000
062132,神隆群益9B購01  ,0,0,0,0,0,0,0,0,0,-2000,0,0,0,0,2000,-2000,-2000
06206P,台積電凱基97售11,0,0,0,0,0,0,0,0,0,-2000,0,0,0,0,2000,-2000,-2000
062072,國巨元大9B購05  ,0,0,0,0,0,0,0,0,0,-2000,0,0,0,67000,69000,-2000,-2000
061907,裕隆中信9B購01  ,0,0,0,0,0,0,0,0,0,-2000,0,0,0,0,2000,-2000,-2000
061839,華新科凱基05購04,0,0,0,0,0,0,0,0,0,-2000,0,0,0,0,2000,-2000,-2000
06867P,訊芯元大98售08  ,0,0,0,0,0,0,0,0,0,-2000,0,0,0,8000,10000,-2000,-2000
06756P,臺股指永豐98售05,0,0,0,0,0,0,0,0,0,-2000,0,0,0,0,2000,-2000,-2000
06724P,台灣50國票98售01,0,0,0,0,0,0,0,0,0,-2000,0,0,0,0,2000,-2000,-2000
06921P,台光電凱基98售06,0,0,0,0,0,0,0,0,0,-2000,0,0,0,0,2000,-2000,-2000
06497P,大立光凱基98售11,0,0,0,0,0,0,0,0,0,-2000,0,0,0,0,2000,-2000,-2000
06461P,玉晶光國泰9A售01,0,0,0,0,0,0,0,0,0,-2000,0,0,0,0,2000,-2000,-2000
06611P,祥碩國票98售01  ,0,0,0,0,0,0,0,0,0,-2000,0,0,0,5000,7000,-2000,-2000
06634P,欣興國票98售02  ,0,0,0,0,0,0,0,0,0,-2000,0,0,0,3000,5000,-2000,-2000
061684,T50反1群益9A購06,0,0,0,0,0,0,0,0,0,-2000,0,0,0,0,2000,-2000,-2000
06178P,大立光第一99售01,0,0,0,0,0,0,0,0,0,-2000,0,0,0,0,2000,-2000,-2000
061545,華新科群益9A購09,0,0,0,0,0,0,0,0,0,-2000,0,0,0,0,2000,-2000,-2000
061539,國巨群益9B購03  ,0,0,0,0,0,0,0,0,0,-2000,0,0,0,0,2000,-2000,-2000
00731,FH富時高息低波  ,2000,3000,-1000,0,0,0,0,0,0,-1000,0,0,0,427000,428000,-1000,-2000
00707R,元大S&P日圓反1  ,0,0,0,0,0,0,0,0,0,-2000,0,0,0,1000,3000,-2000,-2000
035275,台積電台新97購01,0,0,0,0,0,0,0,0,0,-2000,0,0,0,0,2000,-2000,-2000
03006X,元展06          ,0,0,0,0,0,0,0,0,0,-2000,0,0,0,0,2000,-2000,-2000
051321,建準國票96購01  ,0,0,0,0,0,0,0,0,0,-2000,0,0,0,98000,100000,-2000,-2000
051292,牧德統一97購01  ,0,0,0,0,0,0,0,0,0,-2000,0,0,0,144000,146000,-2000,-2000
051463,世芯國泰97購02  ,0,0,0,0,0,0,0,0,0,-2000,0,0,0,2000,4000,-2000,-2000
044247,道瓊反元富97購01,0,0,0,0,0,0,0,0,0,-2000,0,0,0,0,2000,-2000,-2000
051614,元金2X凱基97購01,0,0,0,0,0,0,0,0,0,-2000,0,0,0,0,2000,-2000,-2000
05228P,大立光元富95售09,0,0,0,0,0,0,0,0,0,-2000,0,0,0,0,2000,-2000,-2000
053273,國巨元大96購08  ,0,0,0,0,0,0,0,0,0,-2000,0,0,0,0,2000,-2000,-2000
053069,同欣電群益98購01,0,0,0,0,0,0,0,0,0,-2000,0,0,0,0,2000,-2000,-2000
05320P,華通凱基96售03  ,0,0,0,0,0,0,0,0,0,-2000,0,0,0,0,2000,-2000,-2000
05189P,新光金凱基97售02,0,0,0,0,0,0,0,0,0,-2000,0,0,0,0,2000,-2000,-2000
053599,崇越元大96購01  ,0,0,0,0,0,0,0,0,0,-2000,0,0,0,0,2000,-2000,-2000
058806,道瓊銀統一9B購01,0,0,0,0,0,0,0,0,0,-2000,0,0,0,0,2000,-2000,-2000
059042,世紀鋼群益99購02,0,0,0,0,0,0,0,0,0,-2000,0,0,0,0,2000,-2000,-2000
059077,FBVIX元大99購05 ,0,0,0,0,0,0,0,0,0,-2000,0,0,0,0,2000,-2000,-2000
053407,台積電兆豐96購02,0,0,0,0,0,0,0,0,0,-2000,0,0,0,0,2000,-2000,-2000
055176,大毅統一98購02  ,0,0,0,0,0,0,0,0,0,-2000,0,0,0,0,2000,-2000,-2000
054367,鴻海中信98購03  ,0,0,0,0,0,0,0,0,0,-2000,0,0,0,0,2000,-2000,-2000
05427P,聯發科凱基96售07,0,0,0,0,0,0,0,0,0,-2000,0,0,0,6000,8000,-2000,-2000
054278,晶技群益97購02  ,0,0,0,0,0,0,0,0,0,-2000,0,0,0,0,2000,-2000,-2000
056763,國巨元大99購02  ,0,0,0,0,0,0,0,0,0,-2000,0,0,0,13000,15000,-2000,-2000
056719,台虹永豐98購01  ,0,0,0,0,0,0,0,0,0,-2000,0,0,0,119000,121000,-2000,-2000
057702,同欣電群益99購01,0,0,0,0,0,0,0,0,0,-2000,0,0,0,0,2000,-2000,-2000
05584P,臺股指凱基96售13,0,0,0,0,0,0,0,0,0,-2000,0,0,0,0,2000,-2000,-2000
05901P,臺股指凱基9C售01,0,0,0,0,0,0,0,0,0,-2000,0,0,0,0,2000,-2000,-2000
056385,創意國泰99購01  ,0,0,0,0,0,0,0,0,0,-2000,0,0,0,0,2000,-2000,-2000
056527,大成鋼凱基98購03,0,0,0,0,0,0,0,0,0,-2000,0,0,0,0,2000,-2000,-2000
056495,泰鼎國泰99購01  ,0,0,0,0,0,0,0,0,0,-2000,0,0,0,0,2000,-2000,-2000
057353,玉晶光統一99購01,0,0,0,0,0,0,0,0,0,-2000,0,0,0,36000,38000,-2000,-2000
057399,滬深反群益9C購01,0,0,0,0,0,0,0,0,0,-2000,0,0,0,1000,3000,-2000,-2000
05786P,臺股指永昌96售03,0,0,0,0,0,0,0,0,0,-2000,0,0,0,0,2000,-2000,-2000
057868,大立光凱基98購18,0,0,0,0,0,0,0,0,0,-2000,0,0,0,0,2000,-2000,-2000
057864,奇力新凱基99購03,0,0,0,0,0,0,0,0,0,-2000,0,0,0,0,2000,-2000,-2000
056229,可成凱基97購04  ,0,0,0,0,0,0,0,0,0,-2000,0,0,0,0,2000,-2000,-2000
059493,國巨國票9B購01  ,0,0,0,0,0,0,0,0,0,-2000,0,0,0,3000,5000,-2000,-2000
05960P,欣興統一96售01  ,0,0,0,0,0,0,0,0,0,-2000,0,0,0,0,2000,-2000,-2000
059738,上証2X元富99購01,0,0,0,0,0,0,0,0,0,-2000,0,0,0,2000,4000,-2000,-2000
059700,鴻海凱基9A購16  ,0,0,0,0,0,0,0,0,0,-2000,0,0,0,0,2000,-2000,-2000
059664,立積元大9C購01  ,0,0,0,0,0,0,0,0,0,-2000,0,0,0,0,2000,-2000,-2000
059167,聯發科凱基99購11,0,0,0,0,0,0,0,0,0,-2000,0,0,0,0,2000,-2000,-2000
05811P,臺股指國票96售04,0,0,0,0,0,0,0,0,0,-2000,0,0,0,0,2000,-2000,-2000
057196,茂林台新98購01  ,0,0,0,0,0,0,0,0,0,-2000,0,0,0,10000,12000,-2000,-2000
05722P,玉晶光國票97售03,0,0,0,0,0,0,0,0,0,-2000,0,0,0,0,2000,-2000,-2000
058356,華邦電凱基99購01,0,0,0,0,0,0,0,0,0,-2000,0,0,0,10000,12000,-2000,-2000
2881B,富邦金乙特      ,0,2000,-2000,0,0,0,0,0,0,0,0,0,0,0,0,0,-2000
2514,龍邦            ,35000,37000,-2000,0,0,0,0,0,0,0,0,0,0,0,0,0,-2000
2236,百達-KY         ,0,2000,-2000,0,0,0,0,0,0,0,0,0,0,0,0,0,-2000
1541,錩泰            ,13000,7000,6000,0,0,0,0,0,0,-8000,0,8000,-8000,0,0,0,-2000
1413,宏洲            ,2000,4000,-2000,0,0,0,0,0,0,0,0,0,0,0,0,0,-2000
07009P,臺股指中信9B售01,0,0,0,0,0,0,0,0,0,-2000,0,0,0,0,2000,-2000,-2000
07021P,台積電富邦9C售02,0,0,0,0,0,0,0,0,0,-2000,0,0,0,0,2000,-2000,-2000
07027P,台積電群益99售04,0,0,0,0,0,0,0,0,0,-2000,0,0,0,42000,44000,-2000,-2000
06984P,上銀富邦9B售01  ,0,0,0,0,0,0,0,0,0,-2000,0,0,0,0,2000,-2000,-2000
07422P,大立光元大99售32,0,0,0,0,0,0,0,0,0,-2000,0,0,0,0,2000,-2000,-2000
07519P,臺股指元大9B售10,0,0,0,0,0,0,0,0,0,-2000,0,0,0,0,2000,-2000,-2000
07922P,大立光群益9B售05,0,0,0,0,0,0,0,0,0,-2000,0,0,0,0,2000,-2000,-2000
07941P,國巨凱基9B售07  ,0,0,0,0,0,0,0,0,0,-2000,0,0,0,0,2000,-2000,-2000
07888P,大立光國票9B售01,0,0,0,0,0,0,0,0,0,-2000,0,0,0,6000,8000,-2000,-2000
8482,商億-KY         ,9000,11000,-2000,0,0,0,0,0,0,0,0,0,0,0,0,0,-2000
8201,無敵            ,1000,3000,-2000,0,0,0,0,0,0,0,0,0,0,0,0,0,-2000
8222,寶一            ,1000,3000,-2000,0,0,0,0,0,0,0,0,0,0,0,0,0,-2000
8070,長華*           ,4000,6000,-2000,0,0,0,0,0,0,0,0,0,0,0,0,0,-2000
061494,聯發科國票9A購04,0,0,0,0,0,0,0,0,0,-3000,0,0,0,1000,4000,-3000,-3000
061658,聯茂富邦9A購03  ,0,0,0,0,0,0,0,0,0,-3000,0,0,0,318000,321000,-3000,-3000
061301,華新科永豐9A購03,0,0,0,0,0,0,0,0,0,-3000,0,0,0,0,3000,-3000,-3000
061161,南六群益9A購01  ,0,0,0,0,0,0,0,0,0,-3000,0,0,0,0,3000,-3000,-3000
061434,國巨麥證9A購04  ,0,0,0,0,3000,-3000,0,0,0,-3000,0,0,0,0,3000,-3000,-3000
061454,國巨凱基9A購16  ,0,0,0,0,0,0,0,0,0,-3000,0,0,0,1000,4000,-3000,-3000
06624P,訊芯元大98售06  ,0,0,0,0,0,0,0,0,0,-3000,0,0,0,11000,14000,-3000,-3000
06553P,訊芯元大98售05  ,0,0,0,0,0,0,0,0,0,-3000,0,0,0,8000,11000,-3000,-3000
06784P,臺股指元大98售01,0,0,0,0,0,0,0,0,0,-3000,0,0,0,0,3000,-3000,-3000
06782P,大立光元大99售07,0,0,0,0,0,0,0,0,0,-3000,0,0,0,0,3000,-3000,-3000
06827P,臺股指國票98售03,0,0,0,0,0,0,0,0,0,-3000,0,0,0,2000,5000,-3000,-3000
062066,元黃金元大9B購01,0,0,0,0,0,0,0,0,0,-3000,0,0,0,0,3000,-3000,-3000
062088,緯穎元大9B購04  ,0,0,0,0,0,0,0,0,0,-3000,0,0,0,41000,44000,-3000,-3000
062124,大立光統一9B購09,0,0,0,0,0,0,0,0,0,-3000,0,0,0,0,3000,-3000,-3000
060119,上銀富邦9B購03  ,0,0,0,0,0,0,0,0,0,-3000,0,0,0,0,3000,-3000,-3000
061088,國巨統一9C購05  ,0,0,0,0,0,0,0,0,0,-3000,0,0,0,0,3000,-3000,-3000
060951,元黃金群益9A購01,0,0,0,0,0,0,0,0,0,-3000,0,0,0,0,3000,-3000,-3000
060736,旺宏統一01購01  ,0,0,0,0,0,0,0,0,0,-3000,0,0,0,8000,11000,-3000,-3000
060661,台積電凱基9A購18,0,0,0,0,0,0,0,0,0,-3000,0,0,0,28000,31000,-3000,-3000
060537,台灣50凱基9B購01,0,0,0,0,0,0,0,0,0,-3000,0,0,0,40000,43000,-3000,-3000
060619,玉晶光元大9A購03,0,0,0,0,0,0,0,0,0,-3000,0,0,0,85000,88000,-3000,-3000
060620,玉晶光元大9A購04,0,0,0,0,0,0,0,0,0,-3000,0,0,0,121000,124000,-3000,-3000
060602,京元電凱基9A購01,0,0,0,0,0,0,0,0,0,-3000,0,0,0,0,3000,-3000,-3000
060581,玉晶光群益9B購02,0,0,0,0,0,0,0,0,0,-3000,0,0,0,89000,92000,-3000,-3000
054276,國巨群益96購07  ,0,0,0,0,0,0,0,0,0,-3000,0,0,0,58000,61000,-3000,-3000
054987,凱美元富97購01  ,0,0,0,0,0,0,0,0,0,-3000,0,0,0,0,3000,-3000,-3000
054937,國巨元大97購03  ,0,0,0,0,0,0,0,0,0,-3000,0,0,0,0,3000,-3000,-3000
05523P,聯發科國票96售04,0,0,0,0,0,0,0,0,0,-3000,0,0,0,0,3000,-3000,-3000
053855,康友國泰98購01  ,0,0,0,0,0,0,0,0,0,-3000,0,0,0,0,3000,-3000,-3000
058763,和碩群益99購01  ,0,0,0,0,0,0,0,0,0,-3000,0,0,0,22000,25000,-3000,-3000
055334,禾伸堂兆豐97購01,0,0,0,0,0,0,0,0,0,-3000,0,0,0,18000,21000,-3000,-3000
055109,正崴凱基98購01  ,0,0,0,0,0,0,0,0,0,-3000,0,0,0,0,3000,-3000,-3000
054466,欣興凱基97購03  ,0,0,0,0,0,0,0,0,0,-3000,0,0,0,60000,63000,-3000,-3000
054413,台光電元大96購03,0,0,0,0,0,0,0,0,0,-3000,0,0,0,18000,21000,-3000,-3000
052297,旭富國票96購01  ,0,0,0,0,0,0,0,0,0,-3000,0,0,0,0,3000,-3000,-3000
052489,義隆國票96購02  ,0,0,0,0,0,0,0,0,0,-3000,0,0,0,9000,12000,-3000,-3000
052102,台泥兆豐96購01  ,0,0,0,0,0,0,0,0,0,-3000,0,0,0,94000,97000,-3000,-3000
048122,台達電元大96購02,0,0,0,0,0,0,0,0,0,-3000,0,0,0,0,3000,-3000,-3000
052917,大立光富邦99購02,0,0,0,0,0,0,0,0,0,-3000,0,0,0,47000,50000,-3000,-3000
052886,世紀鋼兆豐96購01,0,0,0,0,0,0,0,0,0,-3000,0,0,0,0,3000,-3000,-3000
051105,台光電國票96購01,0,0,0,0,0,0,0,0,0,-3000,0,0,0,25000,28000,-3000,-3000
053042,大立光凱基97購03,0,0,0,0,0,0,0,0,0,-3000,0,0,0,0,3000,-3000,-3000
050547,華新科凱基95購01,0,0,0,0,0,0,0,0,0,-3000,0,0,0,0,3000,-3000,-3000
03046X,元展43          ,0,0,0,0,0,0,0,0,0,-3000,0,0,0,0,3000,-3000,-3000
03657C,T50反1元大99牛01,0,0,0,0,0,0,0,0,0,-3000,0,0,0,15000,18000,-3000,-3000
056065,奇鋐元大97購01  ,0,0,0,0,0,0,0,0,0,-3000,0,0,0,10000,13000,-3000,-3000
056058,建準元大97購02  ,0,0,0,0,0,0,0,0,0,-3000,0,0,0,33000,36000,-3000,-3000
055907,台虹兆豐98購01  ,0,0,0,0,0,0,0,0,0,-3000,0,0,0,7000,10000,-3000,-3000
055892,國巨統一99購01  ,0,0,0,0,0,0,0,0,0,-3000,0,0,0,0,3000,-3000,-3000
057240,茂林凱基9A購01  ,0,0,0,0,0,0,0,0,0,-3000,0,0,0,257000,260000,-3000,-3000
059140,大立光兆豐9A購02,0,0,0,0,0,0,0,0,0,-3000,0,0,0,2000,5000,-3000,-3000
059135,臺股指群益99購10,0,0,0,0,0,0,0,0,0,-3000,0,0,0,0,3000,-3000,-3000
059705,華新科凱基9A購07,0,0,0,0,0,0,0,0,0,-3000,0,0,0,0,3000,-3000,-3000
059723,美律元大9A購02  ,0,0,0,0,0,0,0,0,0,-3000,0,0,0,24000,27000,-3000,-3000
057832,聯發科元富02購05,0,0,0,0,0,0,0,0,0,-3000,0,0,0,6000,9000,-3000,-3000
056517,茂林兆豐99購01  ,0,0,0,0,0,0,0,0,0,-3000,0,0,0,2000,5000,-3000,-3000
056469,國巨元大99購01  ,0,0,0,0,0,0,0,0,0,-3000,0,0,0,0,3000,-3000,-3000
058445,旺宏富邦9C購01  ,0,0,0,0,0,0,0,0,0,-3000,0,0,0,0,3000,-3000,-3000
056668,光磊國票99購01  ,0,0,0,0,0,0,0,0,0,-3000,0,0,0,7000,10000,-3000,-3000
6215,和椿            ,0,3000,-3000,0,0,0,0,0,0,0,0,0,0,0,0,0,-3000
07730P,臺股指凱基9A售22,0,0,0,0,0,0,0,0,0,-3000,0,0,0,18000,21000,-3000,-3000
07609P,台灣50國票9C售04,0,0,0,0,0,0,0,0,0,-3000,0,0,0,0,3000,-3000,-3000
07475P,A50正2群益9C售02,0,0,0,0,0,0,0,0,0,-3000,0,0,0,0,3000,-3000,-3000
07025P,玉晶光凱基99售01,0,0,0,0,0,0,0,0,0,-3000,0,0,0,0,3000,-3000,-3000
07089P,臺指2X中信01售01,0,0,0,0,0,0,0,0,0,-3000,0,0,0,7000,10000,-3000,-3000
07252P,台灣50凱基99售01,0,0,0,0,0,0,0,0,0,-3000,0,0,0,18000,21000,-3000,-3000
1517,利奇            ,7000,10000,-3000,0,0,0,0,0,0,0,0,0,0,0,0,0,-3000
1587,吉茂            ,1000,4000,-3000,0,0,0,0,0,0,0,0,0,0,0,0,0,-3000
3701,大眾控          ,0,3000,-3000,0,0,0,0,0,0,0,0,0,0,0,0,0,-3000
3011,今皓            ,3000,6000,-3000,0,0,0,0,0,0,0,0,0,0,0,0,0,-3000
06083P,華通統一98售02  ,0,0,0,0,0,0,0,0,0,-4000,0,0,0,0,4000,-4000,-4000
060996,臻鼎元大9A購01  ,0,0,0,0,0,0,0,0,0,-4000,0,0,0,5000,9000,-4000,-4000
059857,台灣50群益99購06,0,0,0,0,0,0,0,0,0,-4000,0,0,0,0,4000,-4000,-4000
059788,華新科元大9A購05,0,0,0,0,0,0,0,0,0,-4000,0,0,0,0,4000,-4000,-4000
059829,超眾凱基99購05  ,0,0,0,0,0,0,0,0,0,-4000,0,0,0,65000,69000,-4000,-4000
060314,元翎永豐9A購01  ,0,0,0,0,0,0,0,0,0,-4000,0,0,0,100000,104000,-4000,-4000
061818,富邦金群益9C購01,0,0,0,0,0,0,0,0,0,-4000,0,0,0,122000,126000,-4000,-4000
061984,華新科元大9B購05,0,0,0,0,0,0,0,0,0,-4000,0,0,0,6000,10000,-4000,-4000
06781P,大立光元大98售19,0,0,0,0,0,0,0,0,0,-4000,0,0,0,1000,5000,-4000,-4000
06464P,台光電亞東99售01,0,0,0,0,0,0,0,0,0,-4000,0,0,0,0,4000,-4000,-4000
06593P,欣興元大98售05  ,0,0,0,0,0,0,0,0,0,-4000,0,0,0,9000,13000,-4000,-4000
06608P,立積群益99售02  ,0,0,0,0,0,0,0,0,0,-4000,0,0,0,626000,630000,-4000,-4000
061465,聯詠群益9A購01  ,0,0,0,0,0,0,0,0,0,-4000,0,0,0,127000,131000,-4000,-4000
061364,國巨國票9A購09  ,0,0,0,0,0,0,0,0,0,-4000,0,0,0,120000,124000,-4000,-4000
061277,智邦台新9A購01  ,0,0,0,0,0,0,0,0,0,-4000,0,0,0,1000,5000,-4000,-4000
06157P,聯鈞統一97售02  ,0,0,0,0,0,0,0,0,0,-4000,0,0,0,0,4000,-4000,-4000
03052X,元展49          ,0,0,0,0,0,0,0,0,0,-4000,0,0,0,0,4000,-4000,-4000
020011,統一微波高息20N ,0,0,0,0,0,0,0,0,0,-4000,0,0,0,0,4000,-4000,-4000
051268,創意富邦97購01  ,0,0,0,0,0,0,0,0,0,-4000,0,0,0,0,4000,-4000,-4000
047687,元金2X富邦96購01,0,0,0,0,0,0,0,0,0,-4000,0,0,0,15000,19000,-4000,-4000
052713,智邦凱基96購01  ,0,0,0,0,0,0,0,0,0,-4000,0,0,0,6000,10000,-4000,-4000
052818,智邦永豐96購01  ,0,0,0,0,0,0,0,0,0,-4000,0,0,0,30000,34000,-4000,-4000
051653,南電永豐95購02  ,0,0,0,0,0,0,0,0,0,-4000,0,0,0,4000,8000,-4000,-4000
055606,矽創元大97購01  ,0,0,0,0,0,0,0,0,0,-4000,0,0,0,0,4000,-4000,-4000
055521,S&P反1群益01購01,0,0,0,0,0,0,0,0,0,-4000,0,0,0,0,4000,-4000,-4000
054063,聯茂國票97購02  ,0,0,0,0,0,0,0,0,0,-4000,0,0,0,0,4000,-4000,-4000
056700,華新科國泰99購03,0,0,0,0,0,0,0,0,0,-4000,0,0,0,0,4000,-4000,-4000
059020,元油2X統一9B購02,0,0,0,0,0,0,0,0,0,-4000,0,0,0,0,4000,-4000,-4000
058631,鈺齊國票9A購01  ,0,0,0,0,0,0,0,0,0,-4000,0,0,0,0,4000,-4000,-4000
058707,泰鼎元大99購02  ,0,0,0,0,0,0,0,0,0,-4000,0,0,0,5000,9000,-4000,-4000
058587,台積電中信9C購03,0,0,0,0,0,0,0,0,0,-4000,0,0,0,0,4000,-4000,-4000
058599,T50反1元大99購05,0,0,0,0,0,0,0,0,0,-4000,0,0,0,1000,5000,-4000,-4000
056356,台積電元大99購01,0,0,0,0,0,0,0,0,0,-4000,0,0,0,0,4000,-4000,-4000
056943,華通統一99購01  ,0,0,0,0,0,0,0,0,0,-4000,0,0,0,131000,135000,-4000,-4000
059754,訊芯群益9A購01  ,0,0,0,0,0,0,0,0,0,-4000,0,0,0,26000,30000,-4000,-4000
059216,台積電元大99購29,0,0,0,0,0,0,0,0,0,-4000,0,0,0,3000,7000,-4000,-4000
059425,SGBR2X元大9A購02,0,0,0,0,0,0,0,0,0,-4000,0,0,0,38000,42000,-4000,-4000
057097,致新元富98購01  ,0,0,0,0,0,0,0,0,0,-4000,0,0,0,4000,8000,-4000,-4000
057501,超眾群益98購04  ,0,0,0,0,0,0,0,0,0,-4000,0,0,0,1000,5000,-4000,-4000
058347,玉晶光群益9B購01,0,0,0,0,0,0,0,0,0,-4000,0,0,0,77000,81000,-4000,-4000
058330,鴻海元富99購01  ,0,0,0,0,0,0,0,0,0,-4000,0,0,0,1000,5000,-4000,-4000
056004,南電永豐97購02  ,0,0,0,0,0,0,0,0,0,-4000,0,0,0,77000,81000,-4000,-4000
058269,世芯永豐9A購01  ,0,0,0,0,0,0,0,0,0,-4000,0,0,0,2000,6000,-4000,-4000
3027,盛達            ,5000,11000,-6000,0,0,0,0,0,0,2000,2000,0,2000,0,0,0,-4000
2483,百容            ,3000,7000,-4000,0,0,0,0,0,0,0,0,0,0,0,0,0,-4000
1339,昭輝            ,15000,19000,-4000,0,0,0,0,0,0,0,0,0,0,0,0,0,-4000
2413,環科            ,22000,26000,-4000,0,0,0,0,0,0,0,0,0,0,0,0,0,-4000
07239P,台灣50國票9A售04,0,0,0,0,0,0,0,0,0,-4000,0,0,0,0,4000,-4000,-4000
07028P,大立光群益99售06,0,0,0,0,0,0,0,0,0,-4000,0,0,0,0,4000,-4000,-4000
06997P,台灣50中信03售01,0,0,0,0,0,0,0,0,0,-4000,0,0,0,0,4000,-4000,-4000
07312P,台灣50元大99售10,0,0,0,0,0,0,0,0,0,-4000,0,0,0,50000,54000,-4000,-4000
07317P,T50正2凱基9B售02,0,0,0,0,0,0,0,0,0,-4000,0,0,0,4000,8000,-4000,-4000
07293P,臺股指凱基99售45,0,0,0,0,0,0,0,0,0,-4000,0,0,0,16000,20000,-4000,-4000
07340P,鴻海凱基99售15  ,0,0,0,0,0,0,0,0,0,-4000,0,0,0,0,4000,-4000,-4000
07616P,瑞昱中信02售01  ,0,0,0,0,0,0,0,0,0,-4000,0,0,0,1000,5000,-4000,-4000
1232,大統益          ,2000,6000,-4000,0,0,0,0,0,0,0,0,0,0,0,0,0,-4000
6117,迎廣            ,2000,6000,-4000,0,0,0,0,0,0,0,0,0,0,0,0,0,-4000
4562,穎漢            ,0,4000,-4000,0,0,0,0,0,0,0,0,0,0,0,0,0,-4000
9902,台火            ,12000,16000,-4000,0,0,0,0,0,0,0,0,0,0,0,0,0,-4000
061672,臺指反元大01購05,0,0,0,0,0,0,0,0,0,-5000,0,0,0,0,5000,-5000,-5000
06179P,國巨群益97售04  ,0,0,0,0,0,0,0,0,0,-5000,0,0,0,6000,11000,-5000,-5000
061245,晶技群益9A購01  ,0,0,0,0,0,0,0,0,0,-5000,0,0,0,9000,14000,-5000,-5000
061176,聯發科凱基9A購14,0,0,0,0,0,0,0,0,0,-5000,0,0,0,0,5000,-5000,-5000
061185,嘉晶國泰9B購01  ,0,0,0,0,0,0,0,0,0,-5000,0,0,0,132000,137000,-5000,-5000
061199,道瓊反元大9A購05,0,0,0,0,0,0,0,0,0,-5000,0,0,0,0,5000,-5000,-5000
061471,台積電元大9A購31,0,0,0,0,0,0,0,0,0,-5000,0,0,0,20000,25000,-5000,-5000
06144P,台光電永豐97售01,0,0,0,0,0,0,0,0,0,-5000,0,0,0,5000,10000,-5000,-5000
06692P,瑞昱凱基98售03  ,0,0,0,0,0,0,0,0,0,-5000,0,0,0,0,5000,-5000,-5000
06452P,大立光元大98售08,0,0,0,0,0,0,0,0,0,-5000,0,0,0,0,5000,-5000,-5000
06414P,矽力凱基97售03  ,0,0,0,0,0,0,0,0,0,-5000,0,0,0,5000,10000,-5000,-5000
06558P,旺宏元富98售02  ,0,0,0,0,0,0,0,0,0,-5000,0,0,0,0,5000,-5000,-5000
06479P,聯發科中信99售02,0,0,0,0,0,0,0,0,0,-5000,0,0,0,0,5000,-5000,-5000
06793P,臺股指凱基98售03,0,0,0,0,0,0,0,0,0,-5000,0,0,0,0,5000,-5000,-5000
06727P,台光電元大98售05,0,0,0,0,0,0,0,0,0,-5000,0,0,0,128000,133000,-5000,-5000
06749P,技嘉元富98售03  ,0,0,0,0,0,0,0,0,0,-5000,0,0,0,0,5000,-5000,-5000
06806P,臺股指群益98售12,0,0,0,0,0,0,0,0,0,-5000,0,0,0,0,5000,-5000,-5000
06863P,欣興凱基98售05  ,0,0,0,0,0,0,0,0,0,-5000,0,0,0,0,5000,-5000,-5000
06888P,日月光元大98售02,0,0,0,0,0,0,0,0,0,-5000,0,0,0,5000,10000,-5000,-5000
061940,世紀鋼國票9C購01,0,0,0,0,0,0,0,0,0,-5000,0,0,0,0,5000,-5000,-5000
061832,聯發科凱基9B購06,0,0,0,0,0,0,0,0,0,-5000,0,0,0,0,5000,-5000,-5000
062153,智邦麥證9B購01  ,0,0,0,0,5000,-5000,0,0,0,-5000,0,0,0,0,5000,-5000,-5000
062180,瑞昱元大9B購03  ,0,0,0,0,0,0,0,0,0,-5000,0,0,0,18000,23000,-5000,-5000
062181,義隆元大9B購03  ,0,0,0,0,0,0,0,0,0,-5000,0,0,0,11000,16000,-5000,-5000
06353P,電子類富邦99售02,0,0,0,0,0,0,0,0,0,-5000,0,0,0,0,5000,-5000,-5000
062048,義隆台新9B購01  ,0,0,0,0,0,0,0,0,0,-5000,0,0,0,0,5000,-5000,-5000
062027,國泰金群益9B購01,0,0,0,0,0,0,0,0,0,-5000,0,0,0,0,5000,-5000,-5000
062003,國巨國泰01購01  ,0,0,0,0,0,0,0,0,0,-5000,0,0,0,21000,26000,-5000,-5000
060320,元金2X群益02購01,0,0,0,0,0,0,0,0,0,-5000,0,0,0,1000,6000,-5000,-5000
060348,上証2X元富9A購03,0,0,0,0,0,0,0,0,0,-5000,0,0,0,0,5000,-5000,-5000
060331,台積電麥證9A購01,0,0,0,0,5000,-5000,0,0,0,-5000,0,0,0,0,5000,-5000,-5000
06018P,康控凱基96售03  ,0,0,0,0,0,0,0,0,0,-5000,0,0,0,5000,10000,-5000,-5000
060229,楠梓電元大9C購01,0,0,0,0,0,0,0,0,0,-5000,0,0,0,18000,23000,-5000,-5000
059873,華新科凱基99購09,0,0,0,0,0,0,0,0,0,-5000,0,0,0,0,5000,-5000,-5000
060102,禾伸堂元大99購06,0,0,0,0,0,0,0,0,0,-5000,0,0,0,0,5000,-5000,-5000
061010,上銀麥證9A購02  ,0,0,0,0,5000,-5000,0,0,0,-5000,0,0,0,0,5000,-5000,-5000
061045,儒鴻第一9A購01  ,0,0,0,0,0,0,0,0,0,-5000,0,0,0,0,5000,-5000,-5000
061053,國巨群益9A購08  ,0,0,0,0,0,0,0,0,0,-5000,0,0,0,120000,125000,-5000,-5000
061115,電子類元大9A購02,0,0,0,0,0,0,0,0,0,-5000,0,0,0,0,5000,-5000,-5000
060657,旺宏統一9B購05  ,0,0,0,0,0,0,0,0,0,-5000,0,0,0,0,5000,-5000,-5000
060700,華新科國泰9C購01,0,0,0,0,0,0,0,0,0,-5000,0,0,0,10000,15000,-5000,-5000
060779,臺股指凱基9A購07,0,0,0,0,0,0,0,0,0,-5000,0,0,0,75000,80000,-5000,-5000
054139,揚明光元大96購01,0,0,0,0,0,0,0,0,0,-5000,0,0,0,0,5000,-5000,-5000
054296,世芯元大97購01  ,0,0,0,0,0,0,0,0,0,-5000,0,0,0,0,5000,-5000,-5000
054934,金寶元大97購01  ,0,0,0,0,0,0,0,0,0,-5000,0,0,0,0,5000,-5000,-5000
054957,興富發元大97購01,0,0,0,0,0,0,0,0,0,-5000,0,0,0,25000,30000,-5000,-5000
054341,燿華元富96購03  ,0,0,0,0,0,0,0,0,0,-5000,0,0,0,0,5000,-5000,-5000
053759,晶相光國泰98購01,0,0,0,0,0,0,0,0,0,-5000,0,0,0,50000,55000,-5000,-5000
054841,亞德客兆豐97購01,0,0,0,0,0,0,0,0,0,-5000,0,0,0,0,5000,-5000,-5000
05331P,上証2X國票96售01,0,0,0,0,0,0,0,0,0,-5000,0,0,0,0,5000,-5000,-5000
054700,致新永豐97購01  ,0,0,0,0,0,0,0,0,0,-5000,0,0,0,106000,111000,-5000,-5000
055487,國巨元大98購07  ,0,0,0,0,0,0,0,0,0,-5000,0,0,0,0,5000,-5000,-5000
053648,台積電凱基97購04,0,0,0,0,0,0,0,0,0,-5000,0,0,0,25000,30000,-5000,-5000
055276,台積電元大97購20,0,0,0,0,0,0,0,0,0,-5000,0,0,0,0,5000,-5000,-5000
055342,鴻海凱基97購04  ,0,0,0,0,0,0,0,0,0,-5000,0,0,0,0,5000,-5000,-5000
055356,大立光凱基97購06,0,0,0,0,0,0,0,0,0,-5000,0,0,0,10000,15000,-5000,-5000
058746,華通凱基9A購02  ,0,0,0,0,0,0,0,0,0,-5000,0,0,0,44000,49000,-5000,-5000
058768,南港兆豐99購01  ,0,0,0,0,0,0,0,0,0,-5000,0,0,0,10000,15000,-5000,-5000
058800,健策元大99購03  ,0,0,0,0,0,0,0,0,0,-5000,0,0,0,12000,17000,-5000,-5000
058742,鴻海康和99購01  ,0,0,0,0,0,0,0,0,0,-5000,0,0,0,3000,8000,-5000,-5000
059088,台積電元大99購27,0,0,0,0,0,0,0,0,0,-5000,0,0,0,3000,8000,-5000,-5000
059050,元油2X凱基9B購08,0,0,0,0,0,0,0,0,0,-5000,0,0,0,250000,255000,-5000,-5000
058904,晶技元大99購05  ,0,0,0,0,0,0,0,0,0,-5000,0,0,0,0,5000,-5000,-5000
054516,國巨元大97購02  ,0,0,0,0,0,0,0,0,0,-5000,0,0,0,0,5000,-5000,-5000
052839,上海銀國泰97購01,0,0,0,0,0,0,0,0,0,-5000,0,0,0,0,5000,-5000,-5000
052068,瑞儀兆豐96購01  ,0,0,0,0,0,0,0,0,0,-5000,0,0,0,0,5000,-5000,-5000
051575,國巨元大96購03  ,0,0,0,0,0,0,0,0,0,-5000,0,0,0,60000,65000,-5000,-5000
04454P,大立光富邦98售02,0,0,0,0,0,0,0,0,0,-5000,0,0,0,0,5000,-5000,-5000
050651,大立光凱基96購02,0,0,0,0,0,0,0,0,0,-5000,0,0,0,5000,10000,-5000,-5000
01004T,土銀富邦R2      ,0,5000,-5000,0,0,0,0,0,0,0,0,0,0,0,0,0,-5000
049129,S&P反1元大97購01,0,0,0,0,0,0,0,0,0,-5000,0,0,0,0,5000,-5000,-5000
03669C,滬深2X元富09牛01,0,0,0,0,0,0,0,0,0,-5000,0,0,0,10000,15000,-5000,-5000
04928P,大立光凱基95售07,0,0,0,0,0,0,0,0,0,-5000,0,0,0,0,5000,-5000,-5000
058413,義隆兆豐99購01  ,0,0,0,0,0,0,0,0,0,-5000,0,0,0,15000,20000,-5000,-5000
058389,聯茂國票9A購01  ,0,0,0,0,0,0,0,0,0,-5000,0,0,0,14000,19000,-5000,-5000
058366,元大金凱基99購01,0,0,0,0,0,0,0,0,0,-5000,0,0,0,0,5000,-5000,-5000
056092,亞德客元富97購02,0,0,0,0,0,0,0,0,0,-5000,0,0,0,10000,15000,-5000,-5000
056171,鴻海元富97購10  ,0,0,0,0,0,0,0,0,0,-5000,0,0,0,0,5000,-5000,-5000
05793P,臺股指中信99售08,0,0,0,0,0,0,0,0,0,-5000,0,0,0,0,5000,-5000,-5000
057136,立積凱基98購02  ,0,0,0,0,0,0,0,0,0,-5000,0,0,0,82000,87000,-5000,-5000
057125,國巨凱基98購12  ,0,0,0,0,0,0,0,0,0,-5000,0,0,0,0,5000,-5000,-5000
05712P,友達統一97售03  ,0,0,0,0,0,0,0,0,0,-5000,0,0,0,0,5000,-5000,-5000
059373,滬深2X群益01購03,0,0,0,0,0,0,0,0,0,-5000,0,0,0,0,5000,-5000,-5000
059251,大立光凱基9A購04,0,0,0,0,0,0,0,0,0,-5000,0,0,0,0,5000,-5000,-5000
05921P,同欣電元大96售06,0,0,0,0,0,0,0,0,0,-5000,0,0,0,0,5000,-5000,-5000
059288,旺宏元富99購03  ,0,0,0,0,0,0,0,0,0,-5000,0,0,0,3000,8000,-5000,-5000
059298,大立光元富9C購02,0,0,0,0,0,0,0,0,0,-5000,0,0,0,132000,137000,-5000,-5000
05951P,台積電國票97售05,0,0,0,0,0,0,0,0,0,-5000,0,0,0,0,5000,-5000,-5000
059758,滬深2X永豐99購05,0,0,0,0,0,0,0,0,0,-5000,0,0,0,0,5000,-5000,-5000
059635,華新科凱基9A購06,0,0,0,0,0,0,0,0,0,-5000,0,0,0,0,5000,-5000,-5000
057462,光磊永豐98購02  ,0,0,0,0,0,0,0,0,0,-5000,0,0,0,0,5000,-5000,-5000
056375,玉晶光統一01購01,0,0,0,0,0,0,0,0,0,-5000,0,0,0,0,5000,-5000,-5000
05631P,國巨富邦9A售01  ,0,0,0,0,0,0,0,0,0,-5000,0,0,0,0,5000,-5000,-5000
056483,TPK元大98購01   ,0,0,0,0,0,0,0,0,0,-5000,0,0,0,0,5000,-5000,-5000
05681P,大立光元大96售05,0,0,0,0,0,0,0,0,0,-5000,0,0,0,0,5000,-5000,-5000
056797,台積電麥證98購01,0,0,0,0,5000,-5000,0,0,0,-5000,0,0,0,0,5000,-5000,-5000
058526,鈺齊元大99購02  ,0,0,0,0,0,0,0,0,0,-5000,0,0,0,0,5000,-5000,-5000
056737,國巨凱基9A購01  ,0,0,0,0,0,0,0,0,0,-5000,0,0,0,123000,128000,-5000,-5000
057583,啟碁中信9A購01  ,0,0,0,0,0,0,0,0,0,-5000,0,0,0,121000,126000,-5000,-5000
057581,元大金中信9A購01,0,0,0,0,0,0,0,0,0,-5000,0,0,0,0,5000,-5000,-5000
057638,上銀元大99購01  ,0,0,0,0,0,0,0,0,0,-5000,0,0,0,5000,10000,-5000,-5000
055777,冠德凱基97購01  ,0,0,0,0,0,0,0,0,0,-5000,0,0,0,0,5000,-5000,-5000
056637,台光電日盛9A購01,0,0,0,0,0,0,0,0,0,-5000,0,0,0,5000,10000,-5000,-5000
1220,台榮            ,0,5000,-5000,0,0,0,0,0,0,0,0,0,0,0,0,0,-5000
07942P,健策凱基9B售03  ,0,0,0,0,0,0,0,0,0,-5000,0,0,0,0,5000,-5000,-5000
07926P,上銀統一9B售02  ,0,0,0,0,0,0,0,0,0,-5000,0,0,0,0,5000,-5000,-5000
07794P,智邦國票9A售03  ,0,0,0,0,0,0,0,0,0,-5000,0,0,0,60000,65000,-5000,-5000
07585P,台灣50中信03售06,0,0,0,0,0,0,0,0,0,-5000,0,0,0,0,5000,-5000,-5000
07752P,台灣50元大9C售33,0,0,0,0,0,0,0,0,0,-5000,0,0,0,0,5000,-5000,-5000
07396P,聯發科群益9B售01,0,0,0,0,0,0,0,0,0,-5000,0,0,0,0,5000,-5000,-5000
07306P,台灣50凱基9A售09,0,0,0,0,0,0,0,0,0,-5000,0,0,0,0,5000,-5000,-5000
07413P,國巨元大99售33  ,0,0,0,0,0,0,0,0,0,-5000,0,0,0,0,5000,-5000,-5000
07465P,台灣50元大9C售24,0,0,0,0,0,0,0,0,0,-5000,0,0,0,0,5000,-5000,-5000
07063P,臺股指元大9A售24,0,0,0,0,0,0,0,0,0,-5000,0,0,0,0,5000,-5000,-5000
07067P,旺宏台新99售02  ,0,0,0,0,0,0,0,0,0,-5000,0,0,0,0,5000,-5000,-5000
07251P,台灣50元富01售04,0,0,0,0,0,0,0,0,0,-5000,0,0,0,0,5000,-5000,-5000
07247P,聯發科凱基9A售06,0,0,0,0,0,0,0,0,0,-5000,0,0,0,105000,110000,-5000,-5000
07145P,為升元大99售03  ,0,0,0,0,0,0,0,0,0,-5000,0,0,0,30000,35000,-5000,-5000
07181P,臺股指凱基99售23,0,0,0,0,0,0,0,0,0,-5000,0,0,0,0,5000,-5000,-5000
07189P,聯發科富邦9B售03,0,0,0,0,0,0,0,0,0,-5000,0,0,0,15000,20000,-5000,-5000
2022,聚亨            ,9000,14000,-5000,0,0,0,0,0,0,0,0,0,0,0,0,0,-5000
1423,利華            ,0,5000,-5000,0,0,0,0,0,0,0,0,0,0,0,0,0,-5000
1516,川飛            ,0,5000,-5000,0,0,0,0,0,0,0,0,0,0,0,0,0,-5000
1805,寶徠            ,0,5000,-5000,0,0,0,0,0,0,0,0,0,0,0,0,0,-5000
2459,敦吉            ,14000,19000,-5000,0,0,0,0,0,0,0,0,0,0,0,0,0,-5000
3312,弘憶股          ,21000,26000,-5000,0,0,0,0,0,0,0,0,0,0,0,0,0,-5000
060471,台勝科元大9B購01,0,0,0,0,0,0,0,0,0,-6000,0,0,0,54000,60000,-6000,-6000
060012,電子類群益99購02,0,0,0,0,0,0,0,0,0,-6000,0,0,0,5000,11000,-6000,-6000
060013,S&P正2康和99購01,0,0,0,0,0,0,0,0,0,-6000,0,0,0,0,6000,-6000,-6000
060040,康控國票99購04  ,0,0,0,0,0,0,0,0,0,-6000,0,0,0,3000,9000,-6000,-6000
059950,百和永豐99購02  ,0,0,0,0,0,0,0,0,0,-6000,0,0,0,12000,18000,-6000,-6000
059954,華新科康和99購01,0,0,0,0,0,0,0,0,0,-6000,0,0,0,15000,21000,-6000,-6000
061853,晶技國票9B購02  ,0,0,0,0,0,0,0,0,0,-6000,0,0,0,4000,10000,-6000,-6000
061989,晶技元大9B購04  ,0,0,0,0,0,0,0,0,0,-6000,0,0,0,14000,20000,-6000,-6000
06735P,奇力新凱基98售07,0,0,0,0,0,0,0,0,0,-6000,0,0,0,0,6000,-6000,-6000
06636P,可成凱基98售08  ,0,0,0,0,0,0,0,0,0,-6000,0,0,0,0,6000,-6000,-6000
06633P,國巨國票99售01  ,0,0,0,0,0,0,0,0,0,-6000,0,0,0,5000,11000,-6000,-6000
061336,國巨元大9A購20  ,0,0,0,0,0,0,0,0,0,-6000,0,0,0,16000,22000,-6000,-6000
061682,南電元大9B購01  ,0,0,0,0,0,0,0,0,0,-6000,0,0,0,191000,197000,-6000,-6000
049272,世紀鋼元大96購02,0,0,0,0,0,0,0,0,0,-6000,0,0,0,15000,21000,-6000,-6000
052885,高鐵兆豐98購01  ,0,0,0,0,0,0,0,0,0,-6000,0,0,0,0,6000,-6000,-6000
05258P,臺股指凱基96售11,0,0,0,0,0,0,0,0,0,-6000,4000,0,4000,0,10000,-10000,-6000
052681,T50反1元大98購02,0,0,0,0,0,0,0,0,0,-6000,0,0,0,8000,14000,-6000,-6000
051847,香港反中信99購01,0,0,0,0,0,0,0,0,0,-6000,0,0,0,15000,21000,-6000,-6000
05886P,華通元富96售01  ,0,0,0,0,0,0,0,0,0,-6000,0,0,0,3000,9000,-6000,-6000
058949,上銀群益99購02  ,0,0,0,0,0,0,0,0,0,-6000,0,0,0,4000,10000,-6000,-6000
058792,鴻海元大99購18  ,0,0,0,0,0,0,0,0,0,-6000,0,0,0,19000,25000,-6000,-6000
055032,億光富邦99購01  ,0,0,0,0,0,0,0,0,0,-6000,0,0,0,2000,8000,-6000,-6000
054095,同欣電群益98購03,0,0,0,0,0,0,0,0,0,-6000,0,0,0,0,6000,-6000,-6000
056818,正崴永豐98購01  ,0,0,0,0,0,0,0,0,0,-6000,0,0,0,0,6000,-6000,-6000
058672,可成群益9B購02  ,0,0,0,0,0,0,0,0,0,-6000,0,0,0,40000,46000,-6000,-6000
058572,百和凱基9A購01  ,0,0,0,0,0,0,0,0,0,-6000,0,0,0,24000,30000,-6000,-6000
056202,國揚永豐97購01  ,0,0,0,0,0,0,0,0,0,-6000,0,0,0,114000,120000,-6000,-6000
056320,京鼎群益99購01  ,0,0,0,0,0,0,0,0,0,-6000,0,0,0,356000,362000,-6000,-6000
057463,華邦電永豐98購01,0,0,0,0,0,0,0,0,0,-6000,0,0,0,0,6000,-6000,-6000
057436,義隆國票99購02  ,0,0,0,0,0,0,0,0,0,-6000,0,0,0,0,6000,-6000,-6000
059234,台灣50凱基9C購03,0,0,0,0,0,0,0,0,0,-6000,0,0,0,0,6000,-6000,-6000
058004,大立光群益98購03,0,0,0,0,0,0,0,0,0,-6000,0,0,0,0,6000,-6000,-6000
058096,南電元大98購04  ,0,0,0,0,0,0,0,0,0,-6000,0,0,0,1000,7000,-6000,-6000
058034,神達永豐98購02  ,0,0,0,0,0,0,0,0,0,-6000,0,0,0,0,6000,-6000,-6000
057900,南亞科永豐98購01,0,0,0,0,0,0,0,0,0,-6000,0,0,0,62000,68000,-6000,-6000
058147,鈺齊元大99購01  ,0,0,0,0,0,0,0,0,0,-6000,0,0,0,0,6000,-6000,-6000
057554,新日興凱基99購02,0,0,0,0,0,0,0,0,0,-6000,0,0,0,20000,26000,-6000,-6000
056029,國巨麥證98購01  ,0,0,0,0,6000,-6000,0,0,0,-6000,0,0,0,0,6000,-6000,-6000
2545,皇翔            ,7000,13000,-6000,0,0,0,0,0,0,0,0,0,0,0,0,0,-6000
07206P,鴻海凱基9A售11  ,0,0,0,0,0,0,0,0,0,-6000,0,0,0,0,6000,-6000,-6000
07625P,台灣50凱基01售06,0,0,0,0,0,0,0,0,0,-6000,0,0,0,5000,11000,-6000,-6000
07871P,台積電群益9C售02,0,0,0,0,0,0,0,0,0,-6000,0,0,0,0,6000,-6000,-6000
07938P,國巨統一9B售10  ,0,0,0,0,0,0,0,0,0,-6000,0,0,0,0,6000,-6000,-6000
6672,騰輝電子-KY     ,300000,306000,-6000,0,0,0,0,0,0,0,0,0,0,0,0,0,-6000
6189,豐藝            ,9000,15000,-6000,0,0,0,0,0,0,0,0,0,0,0,0,0,-6000
06772P,國巨中信99售01  ,0,0,0,0,0,0,0,0,0,-7000,0,0,0,1000,8000,-7000,-7000
06893P,致新元富98售02  ,0,0,0,0,0,0,0,0,0,-7000,0,0,0,3000,10000,-7000,-7000
062049,亞德客統一01購01,0,0,0,0,0,0,0,0,0,-7000,0,0,0,0,7000,-7000,-7000
06239P,奇力新元大97售08,0,0,0,0,0,0,0,0,0,-7000,0,0,0,0,7000,-7000,-7000
059968,世紀鋼凱基99購03,0,0,0,0,0,0,0,0,0,-7000,0,0,0,0,7000,-7000,-7000
060227,和大元大9A購01  ,0,0,0,0,0,0,0,0,0,-7000,0,0,0,20000,27000,-7000,-7000
060215,柏文康和9A購01  ,0,0,0,0,0,0,0,0,0,-7000,0,0,0,49000,56000,-7000,-7000
060453,儒鴻元大9A購02  ,0,0,0,0,0,0,0,0,0,-7000,0,0,0,5000,12000,-7000,-7000
060778,臺股指凱基9A購06,0,0,0,0,0,0,0,0,0,-7000,0,0,0,29000,36000,-7000,-7000
060663,聯發科凱基9A購13,0,0,0,0,0,0,0,0,0,-7000,0,0,0,2000,9000,-7000,-7000
061023,茂林國泰9B購02  ,0,0,0,0,0,0,0,0,0,-7000,0,0,0,3000,10000,-7000,-7000
053338,台光電國票97購01,0,0,0,0,0,0,0,0,0,-7000,0,0,0,0,7000,-7000,-7000
053195,玉晶光元富96購02,0,0,0,0,0,0,0,0,0,-7000,0,0,0,39000,46000,-7000,-7000
052223,聯電凱基96購02  ,0,0,0,0,0,0,0,0,0,-7000,0,0,0,488000,495000,-7000,-7000
047774,台表科元大95購01,0,0,0,0,0,0,0,0,0,-7000,0,0,0,5000,12000,-7000,-7000
050641,上証反凱基96購01,0,0,0,0,0,0,0,0,0,-7000,0,0,0,10000,17000,-7000,-7000
00711B,FH彭博新興債    ,1000,0,1000,0,0,0,0,0,0,-8000,0,0,0,100000,108000,-8000,-7000
00685L,群益臺灣加權正2 ,0,0,0,0,0,0,0,0,0,-7000,0,0,0,5000,12000,-7000,-7000
0055,元大MSCI金融    ,0,0,0,0,0,0,0,0,0,-7000,0,0,0,9000,16000,-7000,-7000
057558,致新凱基98購01  ,0,0,0,0,0,0,0,0,0,-7000,0,0,0,48000,55000,-7000,-7000
057490,可成元大98購10  ,0,0,0,0,0,0,0,0,0,-7000,0,0,0,0,7000,-7000,-7000
058005,茂林群益98購04  ,80000,0,80000,0,0,0,0,0,0,-87000,0,0,0,8000,95000,-87000,-7000
059449,滬深2X永豐99購03,0,0,0,0,0,0,0,0,0,-7000,0,0,0,0,7000,-7000,-7000
059455,玉晶光永豐99購05,0,0,0,0,0,0,0,0,0,-7000,0,0,0,37000,44000,-7000,-7000
059317,台積電元大99購34,0,0,0,0,0,0,0,0,0,-7000,0,0,0,0,7000,-7000,-7000
059669,台灣50元富9B購05,0,0,0,0,0,0,0,0,0,-7000,0,0,0,9000,16000,-7000,-7000
056618,京元電永豐98購01,0,0,0,0,0,0,0,0,0,-7000,0,0,0,28000,35000,-7000,-7000
056707,鴻海富邦99購03  ,0,0,0,0,0,0,0,0,0,-7000,0,0,0,8000,15000,-7000,-7000
055675,亞德客凱基97購02,0,0,0,0,0,0,0,0,0,-7000,0,0,0,1000,8000,-7000,-7000
5706,鳳凰            ,17000,24000,-7000,0,0,0,0,0,0,0,0,0,0,0,0,0,-7000
5519,隆大            ,59000,66000,-7000,0,0,0,0,0,0,0,0,0,0,0,0,0,-7000
1307,三芳            ,0,7000,-7000,0,0,0,0,0,0,0,0,0,0,0,0,0,-7000
1256,鮮活果汁-KY     ,2000,9000,-7000,0,0,0,0,0,0,0,0,0,0,0,0,0,-7000
07641P,上銀凱基9A售05  ,0,0,0,0,0,0,0,0,0,-7000,0,0,0,0,7000,-7000,-7000
07552P,技嘉元大9A售03  ,0,0,0,0,0,0,0,0,0,-7000,0,0,0,14000,21000,-7000,-7000
07434P,臺股指國票9A售06,0,0,0,0,0,0,0,0,0,-7000,0,0,0,21000,28000,-7000,-7000
3432,台端            ,11000,18000,-7000,0,0,0,0,0,0,0,0,0,0,0,0,0,-7000
060901,臺股指凱基9A購13,0,0,0,0,0,0,0,0,0,-8000,0,0,0,13000,21000,-8000,-8000
06073P,健策永豐97售01  ,0,0,0,0,0,0,0,0,0,-8000,0,0,0,95000,103000,-8000,-8000
060623,玉晶光元大9C購01,0,0,0,0,0,0,0,0,0,-8000,0,0,0,15000,23000,-8000,-8000
060340,國巨統一01購02  ,0,0,0,0,0,0,0,0,0,-8000,0,0,0,29000,37000,-8000,-8000
060162,碩天永豐9A購01  ,0,0,0,0,0,0,0,0,0,-8000,0,0,0,0,8000,-8000,-8000
059797,大立光國票99購01,0,0,0,0,0,0,0,0,0,-8000,0,0,0,0,8000,-8000,-8000
06241P,大立光元富9A售01,0,0,0,0,0,0,0,0,0,-8000,0,0,0,10000,18000,-8000,-8000
06825P,臺股指國票98售01,0,0,0,0,0,0,0,0,0,-8000,0,0,0,0,8000,-8000,-8000
06592P,欣興元大98售04  ,0,0,0,0,0,0,0,0,0,-8000,0,0,0,4000,12000,-8000,-8000
06501P,臺股指元大9A售06,0,0,0,0,0,0,0,0,0,-8000,0,0,0,0,8000,-8000,-8000
061806,元黃金統一9B購01,0,0,0,0,0,0,0,0,0,-8000,0,0,0,0,8000,-8000,-8000
061507,南電國票9A購05  ,0,0,0,0,0,0,0,0,0,-8000,0,0,0,0,8000,-8000,-8000
061391,晶技群益9A購02  ,0,0,0,0,0,0,0,0,0,-8000,0,0,0,0,8000,-8000,-8000
061218,臺股指元大9A購55,0,0,0,0,0,0,0,0,0,-8000,0,0,0,22000,30000,-8000,-8000
050183,奇鋐元大96購01  ,0,0,0,0,0,0,0,0,0,-8000,0,0,0,0,8000,-8000,-8000
053080,力山元大96購02  ,0,0,0,0,0,0,0,0,0,-8000,0,0,0,10000,18000,-8000,-8000
054543,元金2X中信01購01,0,0,0,0,0,0,0,0,0,-8000,0,0,0,0,8000,-8000,-8000
051769,矽力元大95購01  ,0,0,0,0,0,0,0,0,0,-8000,0,0,0,1000,9000,-8000,-8000
051780,矽力群益95購01  ,0,0,0,0,0,0,0,0,0,-8000,0,0,0,10000,18000,-8000,-8000
055727,矽力元大97購02  ,0,0,0,0,0,0,0,0,0,-8000,0,0,0,0,8000,-8000,-8000
055738,玉山金元富97購01,0,0,0,0,0,0,0,0,0,-8000,0,0,0,0,8000,-8000,-8000
056843,冠德元富98購01  ,0,0,0,0,0,0,0,0,0,-8000,0,0,0,0,8000,-8000,-8000
058547,世紀鋼富邦9A購01,0,0,0,0,0,0,0,0,0,-8000,0,0,0,89000,97000,-8000,-8000
058545,義隆富邦9C購01  ,0,0,0,0,0,0,0,0,0,-8000,0,0,0,15000,23000,-8000,-8000
057407,超眾群益99購01  ,0,0,0,0,0,0,0,0,0,-8000,0,0,0,2000,10000,-8000,-8000
056893,智邦元大98購02  ,0,0,0,0,0,0,0,0,0,-8000,0,0,0,5000,13000,-8000,-8000
05639P,欣興統一97售01  ,0,0,0,0,0,0,0,0,0,-8000,0,0,0,2000,10000,-8000,-8000
059702,台積電凱基9A購14,0,0,0,0,0,0,0,0,0,-8000,0,0,0,13000,21000,-8000,-8000
05935P,台積電凱基96售19,0,0,0,0,0,0,0,0,0,-8000,0,0,0,0,8000,-8000,-8000
059442,祥碩元大99購03  ,0,0,0,0,0,0,0,0,0,-8000,0,0,0,2000,10000,-8000,-8000
059169,可成凱基99購04  ,0,0,0,0,0,0,0,0,0,-8000,0,0,0,0,8000,-8000,-8000
058008,禾伸堂國票99購02,0,0,0,0,0,0,0,0,0,-8000,0,0,0,7000,15000,-8000,-8000
057971,華新科富邦9B購02,0,0,0,0,0,0,0,0,0,-8000,0,0,0,0,8000,-8000,-8000
058325,昇陽半永豐99購01,0,0,0,0,0,0,0,0,0,-8000,0,0,0,0,8000,-8000,-8000
1452,宏益            ,3000,11000,-8000,0,0,0,0,0,0,0,0,0,0,0,0,0,-8000
1473,台南            ,16000,24000,-8000,0,0,0,0,0,0,0,0,0,0,0,0,0,-8000
2438,翔耀            ,1000,9000,-8000,0,0,0,0,0,0,0,0,0,0,0,0,0,-8000
2429,銘旺科          ,0,8000,-8000,0,0,0,0,0,0,0,0,0,0,0,0,0,-8000
07079P,台積電群益99售06,0,0,0,0,0,0,0,0,0,-8000,0,0,0,0,8000,-8000,-8000
07628P,臺股指凱基9A售09,0,0,0,0,0,0,0,0,0,-8000,0,0,0,0,8000,-8000,-8000
07793P,同欣電元大9A售02,0,0,0,0,0,0,0,0,0,-8000,0,0,0,0,8000,-8000,-8000
9188,精熙-DR         ,0,8000,-8000,0,0,0,0,0,0,0,0,0,0,0,0,0,-8000
06841P,臺股指統一9A售02,0,0,0,0,0,0,0,0,0,-9000,0,0,0,0,9000,-9000,-9000
06800P,台灣50群益9A售02,0,0,0,0,0,0,0,0,0,-9000,0,0,0,0,9000,-9000,-9000
06896P,信邦中信98售01  ,0,0,0,0,0,0,0,0,0,-9000,0,0,0,10000,19000,-9000,-9000
06355P,聯茂永豐97售02  ,0,0,0,0,0,0,0,0,0,-9000,0,0,0,5000,14000,-9000,-9000
062138,力成群益9B購01  ,0,0,0,0,0,0,0,0,0,-9000,0,0,0,0,9000,-9000,-9000
059965,鴻海凱基99購16  ,0,0,0,0,0,0,0,0,0,-9000,0,0,0,14000,23000,-9000,-9000
060011,臺股指群益9C購06,0,0,0,0,0,0,0,0,0,-9000,0,0,0,0,9000,-9000,-9000
060122,亞德客永豐99購02,0,0,0,0,0,0,0,0,0,-9000,0,0,0,11000,20000,-9000,-9000
060253,昇陽半元大9C購01,0,0,0,0,0,0,0,0,0,-9000,0,0,0,54000,63000,-9000,-9000
060480,億豐元大9A購02  ,0,0,0,0,0,0,0,0,0,-9000,0,0,0,11000,20000,-9000,-9000
060718,中磊永豐9A購01  ,0,0,0,0,0,0,0,0,0,-9000,0,0,0,21000,30000,-9000,-9000
060906,旺宏元大9A購07  ,0,0,0,0,0,0,0,0,0,-9000,0,0,0,12000,21000,-9000,-9000
060865,創意永豐9A購01  ,0,0,0,0,0,0,0,0,0,-9000,0,0,0,16000,25000,-9000,-9000
061019,大毅國票9A購01  ,0,0,0,0,0,0,0,0,0,-9000,0,0,0,8000,17000,-9000,-9000
061001,智邦兆豐9B購01  ,0,0,0,0,0,0,0,0,0,-9000,0,0,0,174000,183000,-9000,-9000
061076,台達電兆豐9A購01,0,0,0,0,0,0,0,0,0,-9000,0,0,0,223000,232000,-9000,-9000
054408,義隆國票98購01  ,0,0,0,0,0,0,0,0,0,-9000,0,0,0,33000,42000,-9000,-9000
054649,聯茂群益97購01  ,0,0,0,0,0,0,0,0,0,-9000,0,0,0,0,9000,-9000,-9000
052151,義隆富邦96購01  ,0,0,0,0,0,0,0,0,0,-9000,0,0,0,1000,10000,-9000,-9000
04906P,欣興國票95售01  ,0,0,0,0,0,0,0,0,0,-9000,0,0,0,21000,30000,-9000,-9000
050714,深中小群益98購01,0,0,0,0,0,0,0,0,0,-9000,0,0,0,1000,10000,-9000,-9000
053919,可成國票97購02  ,0,0,0,0,0,0,0,0,0,-9000,0,0,0,7000,16000,-9000,-9000
054328,台化康和96購01  ,0,0,0,0,0,0,0,0,0,-9000,0,0,0,0,9000,-9000,-9000
055626,力山永豐97購01  ,0,0,0,0,0,0,0,0,0,-9000,0,0,0,20000,29000,-9000,-9000
058235,大立光元大99購08,0,0,0,0,0,0,0,0,0,-9000,0,0,0,134000,143000,-9000,-9000
057980,聯詠永豐98購01  ,0,0,0,0,0,0,0,0,0,-9000,0,0,0,0,9000,-9000,-9000
056993,GIS兆豐99購01   ,0,0,0,0,0,0,0,0,0,-9000,0,0,0,1000,10000,-9000,-9000
055923,矽力凱基98購01  ,0,0,0,0,0,0,0,0,0,-9000,0,0,0,0,9000,-9000,-9000
055938,矽力群益97購01  ,0,0,0,0,0,0,0,0,0,-9000,0,0,0,116000,125000,-9000,-9000
058117,元石油群益9B購02,0,0,0,0,0,0,0,0,0,-9000,0,0,0,0,9000,-9000,-9000
059350,樺漢凱基9A購01  ,0,0,0,0,0,0,0,0,0,-9000,0,0,0,51000,60000,-9000,-9000
059259,FBVIX中信03購06 ,0,0,0,0,0,0,0,0,0,-9000,0,0,0,56000,65000,-9000,-9000
059769,滬深2X群益9C購01,0,0,0,0,0,0,0,0,0,-9000,0,0,0,1000,10000,-9000,-9000
056876,群創凱基98購11  ,0,0,0,0,0,0,0,0,0,-9000,0,0,0,0,9000,-9000,-9000
056860,正崴群益98購01  ,0,0,0,0,0,0,0,0,0,-9000,0,0,0,42000,51000,-9000,-9000
056526,力山凱基98購01  ,0,0,0,0,0,0,0,0,0,-9000,0,0,0,94000,103000,-9000,-9000
056914,臺股指元大99購09,0,0,0,0,0,0,0,0,0,-9000,0,0,0,1000,10000,-9000,-9000
058520,智易元大99購03  ,0,0,0,0,0,0,0,0,0,-9000,0,0,0,154000,163000,-9000,-9000
8105,凌巨            ,132000,141000,-9000,0,0,0,0,0,0,0,0,0,0,0,0,0,-9000
4912,聯德控股-KY     ,2000,11000,-9000,0,0,0,0,0,0,0,0,0,0,0,0,0,-9000
5225,東科-KY         ,86000,95000,-9000,0,0,0,0,0,0,0,0,0,0,0,0,0,-9000
07772P,華新科國票9A售05,0,0,0,0,0,0,0,0,0,-9000,0,0,0,11000,20000,-9000,-9000
07637P,國巨國票9A售08  ,0,0,0,0,0,0,0,0,0,-9000,0,0,0,50000,59000,-9000,-9000
07590P,玉晶光國票9A售03,0,0,0,0,0,0,0,0,0,-9000,0,0,0,3000,12000,-9000,-9000
07754P,日月光元大9A售02,0,0,0,0,0,0,0,0,0,-9000,0,0,0,10000,19000,-9000,-9000
07672P,南電元大9A售05  ,0,0,0,0,0,0,0,0,0,-9000,0,0,0,5000,14000,-9000,-9000
07300P,臺股指元大9A售33,0,0,0,0,0,0,0,0,0,-9000,0,0,0,75000,84000,-9000,-9000
07301P,臺股指元大9A售34,0,0,0,0,0,0,0,0,0,-9000,0,0,0,7000,16000,-9000,-9000
07270P,台灣50元大01售09,0,0,0,0,0,0,0,0,0,-9000,0,0,0,1000,10000,-9000,-9000
2923,鼎固-KY         ,1000,10000,-9000,0,0,0,0,0,0,0,0,0,0,0,0,0,-9000
061128,大立光永豐9A購02,0,0,0,0,0,0,0,0,0,-10000,0,0,0,0,10000,-10000,-10000
061044,世紀鋼永豐9A購02,0,0,0,0,0,0,0,0,0,-10000,0,0,0,0,10000,-10000,-10000
060768,鴻海麥證9A購02  ,0,0,0,0,10000,-10000,0,0,0,-10000,0,0,0,0,10000,-10000,-10000
060545,台積電凱基9B購02,0,0,0,0,0,0,0,0,0,-10000,0,0,0,68000,78000,-10000,-10000
060555,台表科凱基9A購03,0,0,0,0,0,0,0,0,0,-10000,0,0,0,0,10000,-10000,-10000
060260,京鼎凱基9C購01  ,0,0,0,0,0,0,0,0,0,-10000,0,0,0,30000,40000,-10000,-10000
060234,凱美元大9C購01  ,0,0,0,0,0,0,0,0,0,-10000,0,0,0,57000,67000,-10000,-10000
06016P,京元電凱基96售03,0,0,0,0,0,0,0,0,0,-10000,0,0,0,0,10000,-10000,-10000
060149,元金2X富邦04購01,0,0,0,0,0,0,0,0,0,-10000,0,0,0,0,10000,-10000,-10000
060350,元黃金元富9B購01,0,0,0,0,0,0,0,0,0,-10000,0,0,0,0,10000,-10000,-10000
060319,臺指反群益9A購02,0,0,0,0,0,0,0,0,0,-10000,0,0,0,0,10000,-10000,-10000
060366,健策元富9A購01  ,0,0,0,0,0,0,0,0,0,-10000,0,0,0,10000,20000,-10000,-10000
060360,南亞科元富9A購02,0,0,0,0,0,0,0,0,0,-10000,0,0,0,50000,60000,-10000,-10000
060104,新日興元大99購03,0,0,0,0,0,0,0,0,0,-10000,0,0,0,101000,111000,-10000,-10000
060054,華新科凱基9B購04,0,0,0,0,0,0,0,0,0,-10000,0,0,0,0,10000,-10000,-10000
059967,聯發科凱基99購20,0,0,0,0,0,0,0,0,0,-10000,0,0,0,0,10000,-10000,-10000
059980,台積電元大99購50,0,0,0,0,0,0,0,0,0,-10000,0,0,0,30000,40000,-10000,-10000
059912,國巨元大99購28  ,0,0,0,0,0,0,0,0,0,-10000,0,0,0,10000,20000,-10000,-10000
059875,信邦凱基99購02  ,0,0,0,0,0,0,0,0,0,-10000,0,0,0,47000,57000,-10000,-10000
059890,大立光國票99購03,0,0,0,0,0,0,0,0,0,-10000,0,0,0,0,10000,-10000,-10000
059881,臺股指凱基99購46,0,0,0,0,0,0,0,0,0,-10000,0,0,0,12000,22000,-10000,-10000
059780,滬深2X元大9C購06,0,0,0,0,0,0,0,0,0,-10000,0,0,0,0,10000,-10000,-10000
05986P,大立光統一97售03,0,0,0,0,0,0,0,0,0,-10000,0,0,0,0,10000,-10000,-10000
06230P,亞德客永豐97售03,0,0,0,0,0,0,0,0,0,-10000,0,0,0,38000,48000,-10000,-10000
062137,華新科群益9B購04,0,0,0,0,0,0,0,0,0,-10000,0,0,0,0,10000,-10000,-10000
06299P,可成元大97售04  ,0,0,0,0,0,0,0,0,0,-10000,0,0,0,0,10000,-10000,-10000
062026,華邦電群益9B購01,0,0,0,0,0,0,0,0,0,-10000,0,0,0,51000,61000,-10000,-10000
061978,旺宏元大9C購01  ,0,0,0,0,0,0,0,0,0,-10000,0,0,0,92000,102000,-10000,-10000
061962,台積電統一01購03,0,0,0,0,0,0,0,0,0,-10000,0,0,0,0,10000,-10000,-10000
061926,晶技凱基9B購02  ,0,0,0,0,0,0,0,0,0,-10000,0,0,0,0,10000,-10000,-10000
061845,SP黃豆國票9B購02,0,0,0,0,0,0,0,0,0,-10000,0,0,0,0,10000,-10000,-10000
061833,華新科凱基02購01,0,0,0,0,0,0,0,0,0,-10000,0,0,0,0,10000,-10000,-10000
061879,超眾元大9C購01  ,0,0,0,0,0,0,0,0,0,-10000,0,0,0,379000,389000,-10000,-10000
06934P,聯鈞元大98售03  ,0,0,0,0,0,0,0,0,0,-10000,0,0,0,60000,70000,-10000,-10000
06734P,智邦凱基98售05  ,0,0,0,0,0,0,0,0,0,-10000,0,0,0,0,10000,-10000,-10000
06840P,臺股指統一98售04,0,0,0,0,0,0,0,0,0,-10000,0,0,0,0,10000,-10000,-10000
06866P,聯發科元大98售13,0,0,0,0,0,0,0,0,0,-10000,0,0,0,0,10000,-10000,-10000
06496P,台灣50日盛98售01,0,0,0,0,0,0,0,0,0,-10000,0,0,0,0,10000,-10000,-10000
06554P,臺股指元大99售06,0,0,0,0,0,0,0,0,0,-10000,0,0,0,0,10000,-10000,-10000
06529P,貿聯富邦99售03  ,0,0,0,0,0,0,0,0,0,-10000,0,0,0,0,10000,-10000,-10000
06370P,貿聯凱基97售03  ,0,0,0,0,0,0,0,0,0,-10000,0,0,0,0,10000,-10000,-10000
06394P,台積電元大97售28,0,0,0,0,0,0,0,0,0,-10000,0,0,0,0,10000,-10000,-10000
06432P,上銀群益98售01  ,0,0,0,0,0,0,0,0,0,-10000,0,0,0,0,10000,-10000,-10000
06569P,可成永豐98售01  ,0,0,0,0,0,0,0,0,0,-10000,0,0,0,20000,30000,-10000,-10000
06691P,臺股指群益9C售05,0,0,0,0,0,0,0,0,0,-10000,0,0,0,2000,12000,-10000,-10000
06685P,鴻海國泰9A售01  ,0,0,0,0,0,0,0,0,0,-10000,0,0,0,0,10000,-10000,-10000
06660P,大立光富邦9B售03,0,0,0,0,0,0,0,0,0,-10000,0,0,0,0,10000,-10000,-10000
061223,T50反1中信01購01,0,0,0,0,0,0,0,0,0,-10000,0,0,0,0,10000,-10000,-10000
061173,T50反1凱基04購01,0,0,0,0,0,0,0,0,0,-10000,0,0,0,0,10000,-10000,-10000
06129P,玉晶光元富97售06,0,0,0,0,0,0,0,0,0,-10000,0,0,0,0,10000,-10000,-10000
061365,國巨國票9B購05  ,0,0,0,0,0,0,0,0,0,-10000,0,0,0,120000,130000,-10000,-10000
061369,T50反1國泰9B購03,0,0,0,0,0,0,0,0,0,-10000,0,0,0,50000,60000,-10000,-10000
06134P,緯穎元富97售03  ,0,0,0,0,0,0,0,0,0,-10000,0,0,0,0,10000,-10000,-10000
06145P,華新科永豐97售02,0,0,0,0,0,0,0,0,0,-10000,0,0,0,0,10000,-10000,-10000
061497,大立光國票9A購09,0,0,0,0,0,0,0,0,0,-10000,0,0,0,0,10000,-10000,-10000
061490,茂林兆豐9B購01  ,0,0,0,0,0,0,0,0,0,-10000,0,0,0,0,10000,-10000,-10000
061486,國巨兆豐9B購02  ,0,0,0,0,0,0,0,0,0,-10000,0,0,0,49000,59000,-10000,-10000
061559,南亞科國票9A購02,0,0,0,0,0,0,0,0,0,-10000,0,0,0,0,10000,-10000,-10000
06180P,禾伸堂群益97售01,0,0,0,0,0,0,0,0,0,-10000,0,0,0,0,10000,-10000,-10000
061730,旺宏統一01購02  ,0,0,0,0,0,0,0,0,0,-10000,0,0,0,0,10000,-10000,-10000
061766,華新科元大9B購02,0,0,0,0,0,0,0,0,0,-10000,0,0,0,0,10000,-10000,-10000
061657,智原國票9A購01  ,0,0,0,0,0,0,0,0,0,-10000,0,0,0,13000,23000,-10000,-10000
061653,上証2X國票9A購02,0,0,0,0,0,0,0,0,0,-10000,0,0,0,0,10000,-10000,-10000
055622,群創國泰99購01  ,0,0,0,0,0,0,0,0,0,-10000,0,0,0,0,10000,-10000,-10000
055512,聯詠兆豐97購01  ,0,0,0,0,0,0,0,0,0,-10000,0,0,0,5000,15000,-10000,-10000
05553P,智原群益96售01  ,0,0,0,0,0,0,0,0,0,-10000,0,0,0,0,10000,-10000,-10000
055489,瑞昱元大97購02  ,0,0,0,0,0,0,0,0,0,-10000,0,0,0,0,10000,-10000,-10000
055457,聚陽永豐97購01  ,0,0,0,0,0,0,0,0,0,-10000,0,0,0,0,10000,-10000,-10000
055436,晶豪科中信99購01,0,0,0,0,0,0,0,0,0,-10000,0,0,0,20000,30000,-10000,-10000
055437,禾伸堂中信99購01,0,0,0,0,0,0,0,0,0,-10000,0,0,0,10000,20000,-10000,-10000
055348,旺宏凱基97購01  ,0,0,0,0,0,0,0,0,0,-10000,0,0,0,10000,20000,-10000,-10000
053557,聯茂凱基96購04  ,0,0,0,0,0,0,0,0,0,-10000,0,0,0,0,10000,-10000,-10000
05358P,大立光元大95售09,0,0,0,0,0,0,0,0,0,-10000,0,0,0,0,10000,-10000,-10000
053641,正文永豐96購01  ,0,0,0,0,0,0,0,0,0,-10000,0,0,0,0,10000,-10000,-10000
053688,燿華元大96購05  ,0,0,0,0,0,0,0,0,0,-10000,0,0,0,0,10000,-10000,-10000
055104,台達電凱基98購01,0,0,0,0,0,0,0,0,0,-10000,0,0,0,20000,30000,-10000,-10000
058795,可成元大99購03  ,0,0,0,0,0,0,0,0,0,-10000,0,0,0,35000,45000,-10000,-10000
058840,T50反1群益99購02,0,0,0,0,0,0,0,0,0,-10000,0,0,0,0,10000,-10000,-10000
059091,中信金元大99購01,0,0,0,0,0,0,0,0,0,-10000,0,0,0,0,10000,-10000,-10000
059080,亞泥元大99購01  ,0,0,0,0,0,0,0,0,0,-10000,0,0,0,9000,19000,-10000,-10000
05911P,南亞科永豐96售03,0,0,0,0,0,0,0,0,0,-10000,0,0,0,0,10000,-10000,-10000
058916,SGBR2X元富99購02,0,0,0,0,0,0,0,0,0,-10000,0,0,0,20000,30000,-10000,-10000
058986,華新科凱基9A購03,0,0,0,0,0,0,0,0,0,-10000,0,0,0,0,10000,-10000,-10000
058959,南茂國票9A購01  ,0,0,0,0,0,0,0,0,0,-10000,0,0,0,0,10000,-10000,-10000
05900P,臺股指凱基99售05,0,0,0,0,0,0,0,0,0,-10000,0,0,0,0,10000,-10000,-10000
059003,中壽元大99購01  ,0,0,0,0,0,0,0,0,0,-10000,0,0,0,0,10000,-10000,-10000
055005,晶相光元富97購01,0,0,0,0,0,0,0,0,0,-10000,0,0,0,10000,20000,-10000,-10000
055036,中工富邦9B購01  ,0,0,0,0,0,0,0,0,0,-10000,0,0,0,0,10000,-10000,-10000
053728,茂林凱基97購01  ,0,0,0,0,0,0,0,0,0,-10000,0,0,0,10000,20000,-10000,-10000
053777,台積電元大96購20,0,0,0,0,0,0,0,0,0,-10000,0,0,0,0,10000,-10000,-10000
053834,卜蜂永豐96購01  ,0,0,0,0,0,0,0,0,0,-10000,0,0,0,10000,20000,-10000,-10000
053851,鴻海國泰98購03  ,0,0,0,0,0,0,0,0,0,-10000,0,0,0,0,10000,-10000,-10000
054269,台光電亞東98購01,0,0,0,0,0,0,0,0,0,-10000,0,0,0,0,10000,-10000,-10000
054153,宏達電國泰97購01,0,0,0,0,0,0,0,0,0,-10000,0,0,0,0,10000,-10000,-10000
054872,瀚宇博群益98購01,0,0,0,0,0,0,0,0,0,-10000,0,0,0,0,10000,-10000,-10000
054806,台化元大9A購01  ,0,0,0,0,0,0,0,0,0,-10000,0,0,0,0,10000,-10000,-10000
054797,臻鼎群益97購01  ,0,0,0,0,0,0,0,0,0,-10000,0,0,0,0,10000,-10000,-10000
053339,友達國票97購02  ,0,0,0,0,0,0,0,0,0,-10000,0,0,0,0,10000,-10000,-10000
053305,聯詠凱基96購02  ,0,0,0,0,0,0,0,0,0,-10000,0,0,0,0,10000,-10000,-10000
054712,上証2X中信98購02,0,0,0,0,0,0,0,0,0,-10000,0,0,0,0,10000,-10000,-10000
05478P,智伸科國票96售02,0,0,0,0,0,0,0,0,0,-10000,0,0,0,0,10000,-10000,-10000
054756,世紀鋼凱基99購01,0,0,0,0,0,0,0,0,0,-10000,0,0,0,0,10000,-10000,-10000
050566,高股息中信97購02,0,0,0,0,0,0,0,0,0,-10000,0,0,0,0,10000,-10000,-10000
050545,奇力新凱基95購01,0,0,0,0,0,0,0,0,0,-10000,0,0,0,0,10000,-10000,-10000
052994,群創台新99購01  ,0,0,0,0,0,0,0,0,0,-10000,0,0,0,0,10000,-10000,-10000
051281,健策兆豐96購01  ,0,0,0,0,0,0,0,0,0,-10000,0,0,0,0,10000,-10000,-10000
047937,元金2X國票97購02,0,0,0,0,0,0,0,0,0,-10000,0,0,0,0,10000,-10000,-10000
047298,聯茂元富96購01  ,0,0,0,0,0,0,0,0,0,-10000,0,0,0,0,10000,-10000,-10000
046384,群創凱基98購02  ,0,0,0,0,0,0,0,0,0,-10000,0,0,0,30000,40000,-10000,-10000
04713P,創意元大95售01  ,0,0,0,0,0,0,0,0,0,-10000,0,0,0,0,10000,-10000,-10000
052884,台積電兆豐96購01,0,0,0,0,0,0,0,0,0,-10000,0,0,0,0,10000,-10000,-10000
052865,大立光凱基96購11,0,0,0,0,0,0,0,0,0,-10000,0,0,0,0,10000,-10000,-10000
052945,嘉晶國票97購01  ,0,0,0,0,0,0,0,0,0,-10000,0,0,0,38000,48000,-10000,-10000
048682,奇力新富邦96購01,0,0,0,0,0,0,0,0,0,-10000,0,0,0,0,10000,-10000,-10000
048602,上緯控國票96購01,0,0,0,0,0,0,0,0,0,-10000,0,0,0,0,10000,-10000,-10000
050261,國巨元大95購04  ,0,0,0,0,0,0,0,0,0,-10000,0,0,0,0,10000,-10000,-10000
050167,T50反1富邦96購01,0,0,0,0,0,0,0,0,0,-10000,0,0,0,138000,148000,-10000,-10000
050171,臺指反元大97購03,0,0,0,0,0,0,0,0,0,-10000,0,0,0,0,10000,-10000,-10000
049922,禾伸堂元大95購01,0,0,0,0,0,0,0,0,0,-10000,0,0,0,0,10000,-10000,-10000
049946,智邦兆豐95購01  ,0,0,0,0,0,0,0,0,0,-10000,0,0,0,0,10000,-10000,-10000
049498,茂林元大95購01  ,0,0,0,0,0,0,0,0,0,-10000,0,0,0,0,10000,-10000,-10000
041870,A50正2凱基96購01,0,0,0,0,0,0,0,0,0,-10000,0,0,0,0,10000,-10000,-10000
03035X,元展32          ,0,0,0,0,0,0,0,0,0,-10000,0,0,0,0,10000,-10000,-10000
03039X,元展36          ,0,0,0,0,0,0,0,0,0,-10000,0,0,0,0,10000,-10000,-10000
052066,華邦電兆豐96購01,0,0,0,0,0,0,0,0,0,-10000,0,0,0,0,10000,-10000,-10000
051567,台積電富邦95購06,0,0,0,0,0,0,0,0,0,-10000,0,0,0,0,10000,-10000,-10000
051572,上銀元大95購01  ,0,0,0,0,0,0,0,0,0,-10000,0,0,0,0,10000,-10000,-10000
052791,友達兆豐97購01  ,0,0,0,0,0,0,0,0,0,-10000,0,0,0,0,10000,-10000,-10000
052792,大立光兆豐96購01,0,0,0,0,0,0,0,0,0,-10000,0,0,0,0,10000,-10000,-10000
052860,旺宏凱基96購03  ,0,0,0,0,0,0,0,0,0,-10000,0,0,0,0,10000,-10000,-10000
052022,南電永豐95購03  ,0,0,0,0,0,0,0,0,0,-10000,0,0,0,0,10000,-10000,-10000
05201P,玉晶光國泰97售02,0,0,0,0,0,0,0,0,0,-10000,0,0,0,0,10000,-10000,-10000
05271P,國巨富邦97售01  ,0,0,0,0,0,0,0,0,0,-10000,0,0,0,0,10000,-10000,-10000
052728,上証2X國泰97購01,0,0,0,0,0,0,0,0,0,-10000,0,0,0,0,10000,-10000,-10000
051484,玉晶光凱基97購01,0,0,0,0,0,0,0,0,0,-10000,0,0,0,10000,20000,-10000,-10000
052342,茂林凱基96購01  ,0,0,0,0,0,0,0,0,0,-10000,0,0,0,0,10000,-10000,-10000
05265P,正崴元大95售03  ,0,0,0,0,0,0,0,0,0,-10000,0,0,0,0,10000,-10000,-10000
052618,群創國泰98購01  ,0,0,0,0,0,0,0,0,0,-10000,0,0,0,0,10000,-10000,-10000
052612,康舒元大97購01  ,0,0,0,0,0,0,0,0,0,-10000,0,0,0,10000,20000,-10000,-10000
052491,泰碩國票99購01  ,0,0,0,0,0,0,0,0,0,-10000,0,0,0,0,10000,-10000,-10000
052575,茂林凱基96購04  ,0,0,0,0,0,0,0,0,0,-10000,0,0,0,0,10000,-10000,-10000
054592,美律永昌9A購01  ,0,0,0,0,0,0,0,0,0,-10000,0,0,0,0,10000,-10000,-10000
054573,漢唐元大98購01  ,0,0,0,0,0,0,0,0,0,-10000,0,0,0,0,10000,-10000,-10000
053144,上証2X元大96購01,0,0,0,0,0,0,0,0,0,-10000,0,0,0,0,10000,-10000,-10000
053209,台積電凱基96購07,0,0,0,0,0,0,0,0,0,-10000,0,0,0,0,10000,-10000,-10000
053213,建準凱基96購02  ,0,0,0,0,0,0,0,0,0,-10000,0,0,0,0,10000,-10000,-10000
053246,聯詠國票97購02  ,0,0,0,0,0,0,0,0,0,-10000,0,0,0,0,10000,-10000,-10000
053254,群創國泰98購02  ,0,0,0,0,0,0,0,0,0,-10000,0,0,0,0,10000,-10000,-10000
054396,日電貿永豐96購02,0,0,0,0,0,0,0,0,0,-10000,0,0,0,15000,25000,-10000,-10000
054477,聯發科中信9C購02,0,0,0,0,0,0,0,0,0,-10000,0,0,0,0,10000,-10000,-10000
051694,A50正2中信96購03,0,0,0,0,0,0,0,0,0,-10000,0,0,0,10000,20000,-10000,-10000
051696,新日興中信96購01,0,0,0,0,0,0,0,0,0,-10000,0,0,0,0,10000,-10000,-10000
056743,貿聯凱基98購04  ,0,0,0,0,0,0,0,0,0,-10000,0,0,0,0,10000,-10000,-10000
05673P,台積電群益96售05,0,0,0,0,0,0,0,0,0,-10000,0,0,0,0,10000,-10000,-10000
057648,和碩元大98購01  ,0,0,0,0,0,0,0,0,0,-10000,0,0,0,0,10000,-10000,-10000
057657,國巨兆豐98購04  ,0,0,0,0,0,0,0,0,0,-10000,0,0,0,0,10000,-10000,-10000
057690,美律凱基99購03  ,0,0,0,0,0,0,0,0,0,-10000,0,0,0,0,10000,-10000,-10000
056645,大立光凱基98購12,0,0,0,0,0,0,0,0,0,-10000,0,0,0,0,10000,-10000,-10000
055797,華通富邦98購01  ,0,0,0,0,0,0,0,0,0,-10000,0,0,0,0,10000,-10000,-10000
05579P,友達凱基98售03  ,0,0,0,0,0,0,0,0,0,-10000,0,0,0,0,10000,-10000,-10000
055671,世紀鋼群益97購01,0,0,0,0,0,0,0,0,0,-10000,0,0,0,0,10000,-10000,-10000
058444,國巨富邦9B購01  ,0,0,0,0,0,0,0,0,0,-10000,0,0,0,0,10000,-10000,-10000
058462,台積電兆豐99購01,0,0,0,0,0,0,0,0,0,-10000,0,0,0,0,10000,-10000,-10000
057637,上銀元大98購07  ,0,0,0,0,0,0,0,0,0,-10000,0,0,0,0,10000,-10000,-10000
057625,泰鼎國泰9A購01  ,0,0,0,0,0,0,0,0,0,-10000,0,0,0,0,10000,-10000,-10000
057823,神達元大98購01  ,0,0,0,0,0,0,0,0,0,-10000,0,0,0,0,10000,-10000,-10000
057889,致新群益99購01  ,0,0,0,0,0,0,0,0,0,-10000,0,0,0,0,10000,-10000,-10000
057424,訊芯凱基98購04  ,0,0,0,0,0,0,0,0,0,-10000,0,0,0,0,10000,-10000,-10000
057379,寶成元大98購02  ,0,0,0,0,0,0,0,0,0,-10000,0,0,0,0,10000,-10000,-10000
057343,道瓊反統一9A購01,0,0,0,0,0,0,0,0,0,-10000,0,0,0,0,10000,-10000,-10000
057328,京鼎群益99購02  ,0,0,0,0,0,0,0,0,0,-10000,0,0,0,93000,103000,-10000,-10000
057303,喬山兆豐99購01  ,0,0,0,0,0,0,0,0,0,-10000,0,0,0,0,10000,-10000,-10000
056474,華新科元大99購05,0,0,0,0,0,0,0,0,0,-10000,0,0,0,0,10000,-10000,-10000
056596,光磊元富98購01  ,0,0,0,0,0,0,0,0,0,-10000,0,0,0,10000,20000,-10000,-10000
056530,旺宏凱基98購06  ,0,0,0,0,0,0,0,0,0,-10000,0,0,0,0,10000,-10000,-10000
056547,臻鼎凱基99購01  ,0,0,0,0,0,0,0,0,0,-10000,0,0,0,0,10000,-10000,-10000
056562,奇力新群益98購01,0,0,0,0,0,0,0,0,0,-10000,0,0,0,0,10000,-10000,-10000
057729,華新科國泰99購04,0,0,0,0,0,0,0,0,0,-10000,0,0,0,10000,20000,-10000,-10000
056866,矽創群益98購03  ,0,0,0,0,0,0,0,0,0,-10000,0,0,0,0,10000,-10000,-10000
057772,台積電群益99購01,0,0,0,0,0,0,0,0,0,-10000,0,0,0,0,10000,-10000,-10000
056304,創意元大97購03  ,0,0,0,0,0,0,0,0,0,-10000,0,0,0,0,10000,-10000,-10000
059753,貿聯群益99購06  ,0,0,0,0,0,0,0,0,0,-10000,0,0,0,0,10000,-10000,-10000
059722,南亞科元大99購02,0,0,0,0,0,0,0,0,0,-10000,0,0,0,0,10000,-10000,-10000
059735,T50反1元富99購06,0,0,0,0,0,0,0,0,0,-10000,0,0,0,0,10000,-10000,-10000
059692,聯詠永豐99購01  ,0,0,0,0,0,0,0,0,0,-10000,0,0,0,6000,16000,-10000,-10000
059673,玉山金元富99購01,0,0,0,0,0,0,0,0,0,-10000,0,0,0,10000,20000,-10000,-10000
059240,台積電凱基9A購09,0,0,0,0,0,0,0,0,0,-10000,0,0,0,14000,24000,-10000,-10000
059265,美律中信01購01  ,0,0,0,0,0,0,0,0,0,-10000,0,0,0,0,10000,-10000,-10000
05955P,台光電國票97售02,0,0,0,0,0,0,0,0,0,-10000,0,0,0,0,10000,-10000,-10000
059519,台郡永豐99購01  ,0,0,0,0,0,0,0,0,0,-10000,0,0,0,5000,15000,-10000,-10000
059611,台積電永豐99購05,0,0,0,0,0,0,0,0,0,-10000,0,0,0,0,10000,-10000,-10000
059500,鴻海元富99購11  ,0,0,0,0,0,0,0,0,0,-10000,0,0,0,0,10000,-10000,-10000
059489,上証2X國票9A購01,0,0,0,0,0,0,0,0,0,-10000,0,0,0,0,10000,-10000,-10000
058123,亞光國票9A購01  ,0,0,0,0,0,0,0,0,0,-10000,0,0,0,0,10000,-10000,-10000
055654,景碩元富97購01  ,0,0,0,0,0,0,0,0,0,-10000,0,0,0,10000,20000,-10000,-10000
059161,鴻海凱基9A購09  ,0,0,0,0,0,0,0,0,0,-10000,0,0,0,0,10000,-10000,-10000
059398,滬深2X元富9C購02,0,0,0,0,0,0,0,0,0,-10000,0,0,0,0,10000,-10000,-10000
059201,祥碩永豐99購02  ,0,0,0,0,0,0,0,0,0,-10000,0,0,0,48000,58000,-10000,-10000
059203,勤誠永豐99購02  ,0,0,0,0,0,0,0,0,0,-10000,0,0,0,0,10000,-10000,-10000
058098,T50反1國泰9A購02,0,0,0,0,0,0,0,0,0,-10000,0,0,0,0,10000,-10000,-10000
058099,鴻海國泰9A購02  ,0,0,0,0,0,0,0,0,0,-10000,0,0,0,0,10000,-10000,-10000
057988,鈺齊元富98購02  ,0,0,0,0,0,0,0,0,0,-10000,0,0,0,0,10000,-10000,-10000
057153,祥碩國泰99購01  ,0,0,0,0,0,0,0,0,0,-10000,0,0,0,1000,11000,-10000,-10000
057134,茂林凱基98購02  ,0,0,0,0,0,0,0,0,0,-10000,0,0,0,0,10000,-10000,-10000
05710P,禾伸堂國票97售02,0,0,0,0,0,0,0,0,0,-10000,0,0,0,161000,171000,-10000,-10000
057078,國巨統一9A購02  ,0,0,0,0,0,0,0,0,0,-10000,0,0,0,10000,20000,-10000,-10000
05589P,大立光中信9A售01,0,0,0,0,0,0,0,0,0,-10000,0,0,0,0,10000,-10000,-10000
057178,可成元大98購03  ,0,0,0,0,0,0,0,0,0,-10000,0,0,0,26000,36000,-10000,-10000
057555,玉晶光凱基9A購02,0,0,0,0,0,0,0,0,0,-10000,0,0,0,0,10000,-10000,-10000
057566,欣興富邦99購01  ,0,0,0,0,0,0,0,0,0,-10000,0,0,0,6000,16000,-10000,-10000
057232,京元電凱基98購02,0,0,0,0,0,0,0,0,0,-10000,0,0,0,40000,50000,-10000,-10000
057896,嘉晶元富98購01  ,0,0,0,0,0,0,0,0,0,-10000,0,0,0,20000,30000,-10000,-10000
058187,泰碩永豐99購01  ,0,0,0,0,0,0,0,0,0,-10000,0,0,0,0,10000,-10000,-10000
058192,訊芯永豐99購01  ,0,0,0,0,0,0,0,0,0,-10000,0,0,0,0,10000,-10000,-10000
056049,奇力新國票98購01,0,0,0,0,0,0,0,0,0,-10000,0,0,0,0,10000,-10000,-10000
056169,鴻海元富97購08  ,0,0,0,0,0,0,0,0,0,-10000,0,0,0,30000,40000,-10000,-10000
05610P,國巨群益98售01  ,0,0,0,0,0,0,0,0,0,-10000,0,0,0,0,10000,-10000,-10000
058332,鴻海元富99購03  ,0,0,0,0,0,0,0,0,0,-10000,0,0,0,0,10000,-10000,-10000
05829P,臺股指統一96售08,0,0,0,0,0,0,0,0,0,-10000,0,0,0,0,10000,-10000,-10000
2881A,富邦特          ,0,10000,-10000,0,0,0,0,0,0,0,0,0,0,0,0,0,-10000
1463,強盛            ,1000,11000,-10000,0,0,0,0,0,0,0,0,0,0,0,0,0,-10000
07329P,台灣50群益9A售07,0,0,0,0,0,0,0,0,0,-10000,0,0,0,0,10000,-10000,-10000
07359P,台積電元大99售45,0,0,0,0,0,0,0,0,0,-10000,0,0,0,0,10000,-10000,-10000
07352P,台積電國票99售11,0,0,0,0,0,0,0,0,0,-10000,0,0,0,10000,20000,-10000,-10000
07423P,大立光元大99售33,0,0,0,0,0,0,0,0,0,-10000,0,0,0,0,10000,-10000,-10000
07418P,聯發科元大99售45,0,0,0,0,0,0,0,0,0,-10000,0,0,0,0,10000,-10000,-10000
07076P,鴻海凱基9A售08  ,0,0,0,0,0,0,0,0,0,-10000,0,0,0,0,10000,-10000,-10000
06993P,鴻海凱基99售05  ,0,0,0,0,0,0,0,0,0,-10000,0,0,0,0,10000,-10000,-10000
07211P,南亞科凱基99售05,0,0,0,0,0,0,0,0,0,-10000,0,0,0,0,10000,-10000,-10000
07185P,臺股指統一9C售01,0,0,0,0,0,0,0,0,0,-10000,0,0,0,0,10000,-10000,-10000
07149P,健鼎元大99售03  ,0,0,0,0,0,0,0,0,0,-10000,0,0,0,0,10000,-10000,-10000
07131P,緯穎元大99售06  ,0,0,0,0,0,0,0,0,0,-10000,0,0,0,0,10000,-10000,-10000
07664P,台灣50元大9C售30,0,0,0,0,0,0,0,0,0,-10000,0,0,0,0,10000,-10000,-10000
07758P,台積電國票9A售06,0,0,0,0,0,0,0,0,0,-10000,0,0,0,0,10000,-10000,-10000
07601P,國巨統一9A售05  ,0,0,0,0,0,0,0,0,0,-10000,0,0,0,0,10000,-10000,-10000
07626P,台灣50凱基04售07,0,0,0,0,0,0,0,0,0,-10000,0,0,0,0,10000,-10000,-10000
07553P,嘉晶元大9A售02  ,0,0,0,0,0,0,0,0,0,-10000,0,0,0,133000,143000,-10000,-10000
07518P,臺股指元大9B售09,0,0,0,0,0,0,0,0,0,-10000,0,0,0,0,10000,-10000,-10000
07582P,臺股指元大9A售45,0,0,0,0,0,0,0,0,0,-10000,0,0,0,0,10000,-10000,-10000
07768P,緯穎群益9A售02  ,0,0,0,0,0,0,0,0,0,-10000,0,0,0,0,10000,-10000,-10000
07812P,大立光統一9A售06,0,0,0,0,0,0,0,0,0,-10000,0,0,0,0,10000,-10000,-10000
07883P,可成凱基9B售03  ,0,0,0,0,0,0,0,0,0,-10000,0,0,0,0,10000,-10000,-10000
1109,信大            ,18000,16000,2000,0,0,0,0,0,0,-12000,0,12000,-12000,0,0,0,-10000
07913P,友達元大01售01  ,0,0,0,0,0,0,0,0,0,-10000,0,0,0,0,10000,-10000,-10000
07896P,臺股指元大9B售16,0,0,0,0,0,0,0,0,0,-10000,0,0,0,0,10000,-10000,-10000
07897P,臺股指元大9B售17,0,0,0,0,0,0,0,0,0,-10000,0,0,0,0,10000,-10000,-10000
061578,玉晶光元大9A購16,0,0,0,0,0,0,0,0,0,-11000,0,0,0,136000,147000,-11000,-11000
061498,大立光國票9A購10,0,0,0,0,0,0,0,0,0,-11000,0,0,0,4000,15000,-11000,-11000
06521P,矽力元大98售01  ,0,0,0,0,0,0,0,0,0,-11000,0,0,0,10000,21000,-11000,-11000
061898,茂林永豐9B購01  ,0,0,0,0,0,0,0,0,0,-11000,0,0,0,1000,12000,-11000,-11000
061894,台積電永豐9B購01,0,0,0,0,0,0,0,0,0,-11000,0,0,0,34000,45000,-11000,-11000
061858,南電國票9B購02  ,0,0,0,0,0,0,0,0,0,-11000,0,0,0,0,11000,-11000,-11000
061930,臺股指凱基9B購05,0,0,0,0,0,0,0,0,0,-11000,0,0,0,10000,21000,-11000,-11000
061985,富邦金元大9B購01,0,0,0,0,0,0,0,0,0,-11000,0,0,0,12000,23000,-11000,-11000
060106,旭富元大99購02  ,0,0,0,0,0,0,0,0,0,-11000,0,0,0,17000,28000,-11000,-11000
061078,台積電兆豐9A購01,0,0,0,0,0,0,0,0,0,-11000,0,0,0,0,11000,-11000,-11000
060876,國巨中信9A購04  ,0,0,0,0,0,0,0,0,0,-11000,0,0,0,93000,104000,-11000,-11000
054456,華泰群益99購01  ,0,0,0,0,0,0,0,0,0,-11000,0,0,0,0,11000,-11000,-11000
00660,元大歐洲50      ,0,0,0,0,0,0,0,0,0,-11000,0,0,0,3000,14000,-11000,-11000
0052,富邦科技        ,0,0,0,0,0,0,0,0,0,-11000,0,0,0,111000,122000,-11000,-11000
04831P,聯詠富邦96售01  ,0,0,0,0,0,0,0,0,0,-11000,0,0,0,1000,12000,-11000,-11000
052999,臺股指康和96購01,0,0,0,0,0,0,0,0,0,-11000,0,0,0,0,11000,-11000,-11000
054758,南亞國票9A購01  ,0,0,0,0,0,0,0,0,0,-11000,0,0,0,22000,33000,-11000,-11000
054896,聯茂日盛97購01  ,0,0,0,0,0,0,0,0,0,-11000,0,0,0,70000,81000,-11000,-11000
058874,聯鈞國票9A購01  ,0,0,0,0,0,0,0,0,0,-11000,0,0,0,30000,41000,-11000,-11000
059036,可成群益9B購03  ,0,0,0,0,0,0,0,0,0,-11000,0,0,0,52000,63000,-11000,-11000
058770,貿聯兆豐9A購01  ,0,0,0,0,0,0,0,0,0,-11000,0,0,0,0,11000,-11000,-11000
055934,景碩群益98購03  ,0,0,0,0,0,0,0,0,0,-11000,0,0,0,6000,17000,-11000,-11000
058032,大立光永豐98購05,0,0,0,0,0,0,0,0,0,-11000,0,0,0,0,11000,-11000,-11000
059213,國巨元大99購19  ,0,0,0,0,0,0,0,0,0,-11000,0,0,0,25000,36000,-11000,-11000
059166,友達凱基99購05  ,0,0,0,0,0,0,0,0,0,-11000,0,0,0,0,11000,-11000,-11000
05971P,世紀鋼永豐96售04,0,0,0,0,0,0,0,0,0,-11000,0,0,0,1000,12000,-11000,-11000
059731,康控元大99購04  ,0,0,0,0,0,0,0,0,0,-11000,0,0,0,0,11000,-11000,-11000
056863,義隆群益98購01  ,0,0,0,0,0,0,0,0,0,-11000,0,0,0,87000,98000,-11000,-11000
056477,欣興元大98購02  ,0,0,0,0,0,0,0,0,0,-11000,0,0,0,77000,88000,-11000,-11000
057606,健策統一98購03  ,0,0,0,0,0,0,0,0,0,-11000,0,0,0,0,11000,-11000,-11000
058459,南電永豐99購01  ,0,0,0,0,0,0,0,0,0,-11000,0,0,0,0,11000,-11000,-11000
056716,康舒永豐98購01  ,0,0,0,0,0,0,0,0,0,-11000,0,0,0,57000,68000,-11000,-11000
07944P,華新科元大9B售08,0,0,0,0,0,0,0,0,0,-11000,0,0,0,0,11000,-11000,-11000
07803P,南亞科永豐9A售02,0,0,0,0,0,0,0,0,0,-11000,0,0,0,15000,26000,-11000,-11000
07122P,欣興凱基99售05  ,0,0,0,0,0,0,0,0,0,-11000,0,0,0,131000,142000,-11000,-11000
07353P,大立光國票99售02,0,0,0,0,0,0,0,0,0,-11000,0,0,0,0,11000,-11000,-11000
2009,第一銅          ,13000,24000,-11000,0,0,0,0,0,0,0,0,0,0,0,0,0,-11000
3593,力銘            ,2000,13000,-11000,0,0,0,0,0,0,0,0,0,0,0,0,0,-11000
4764,雙鍵            ,2000,13000,-11000,0,0,0,0,0,0,0,0,0,0,0,0,0,-11000
06090P,旺宏統一97售06  ,0,0,0,0,0,0,0,0,0,-12000,0,0,0,2000,14000,-12000,-12000
060515,臺股指元大9B購12,0,0,0,0,0,0,0,0,0,-12000,0,0,0,12000,24000,-12000,-12000
060578,臺股指中信9C購03,0,0,0,0,0,0,0,0,0,-12000,0,0,0,3000,15000,-12000,-12000
06008P,燿華統一96售04  ,0,0,0,0,0,0,0,0,0,-12000,0,0,0,8000,20000,-12000,-12000
060346,華新科統一01購01,0,0,0,0,0,0,0,0,0,-12000,0,0,0,13000,25000,-12000,-12000
060147,臺股指國票9A購07,0,0,0,0,0,0,0,0,0,-12000,0,0,0,20000,32000,-12000,-12000
062013,奇鋐富邦9B購01  ,0,0,0,0,0,0,0,0,0,-12000,0,0,0,0,12000,-12000,-12000
062165,聯茂國泰01購01  ,0,0,0,0,0,0,0,0,0,-12000,0,0,0,150000,162000,-12000,-12000
06534P,聯發科群益98售04,0,0,0,0,0,0,0,0,0,-12000,0,0,0,0,12000,-12000,-12000
06602P,國巨統一99售02  ,0,0,0,0,0,0,0,0,0,-12000,0,0,0,0,12000,-12000,-12000
06847P,奇力新元大98售05,0,0,0,0,0,0,0,0,0,-12000,0,0,0,0,12000,-12000,-12000
061786,義隆群益9B購01  ,0,0,0,0,0,0,0,0,0,-12000,0,0,0,88000,100000,-12000,-12000
061237,晶技元大9A購01  ,0,0,0,0,0,0,0,0,0,-12000,0,0,0,39000,51000,-12000,-12000
061222,台灣50中信9A購02,0,0,0,0,0,0,0,0,0,-12000,0,0,0,0,12000,-12000,-12000
055067,禾聯碩永豐97購01,0,0,0,0,0,0,0,0,0,-12000,0,0,0,0,12000,-12000,-12000
054898,台肥康和97購01  ,0,0,0,0,0,0,0,0,0,-12000,0,0,0,0,12000,-12000,-12000
053539,智易永豐96購01  ,0,0,0,0,0,0,0,0,0,-12000,0,0,0,51000,63000,-12000,-12000
055022,精元國泰99購01  ,0,0,0,0,0,0,0,0,0,-12000,0,0,0,8000,20000,-12000,-12000
054478,可成中信97購01  ,0,0,0,0,0,0,0,0,0,-12000,0,0,0,0,12000,-12000,-12000
055816,新日興國票98購01,0,0,0,0,0,0,0,0,0,-12000,0,0,0,15000,27000,-12000,-12000
055724,祥碩元大97購03  ,0,0,0,0,0,0,0,0,0,-12000,0,0,0,3000,15000,-12000,-12000
057656,大成鋼兆豐98購01,0,0,0,0,0,0,0,0,0,-12000,0,0,0,0,12000,-12000,-12000
058639,南電兆豐99購01  ,0,0,0,0,0,0,0,0,0,-12000,0,0,0,10000,22000,-12000,-12000
058622,國巨國票99購07  ,0,0,0,0,0,0,0,0,0,-12000,0,0,0,241000,253000,-12000,-12000
056579,麗豐元大99購01  ,0,0,0,0,0,0,0,0,0,-12000,0,0,0,88000,100000,-12000,-12000
056535,全新凱基99購02  ,0,0,0,0,0,0,0,0,0,-12000,0,0,0,77000,89000,-12000,-12000
05727P,新光金日盛96售02,0,0,0,0,0,0,0,0,0,-12000,0,0,0,0,12000,-12000,-12000
057380,技嘉國泰9A購01  ,0,0,0,0,0,0,0,0,0,-12000,0,0,0,0,12000,-12000,-12000
057433,上銀國票98購04  ,0,0,0,0,0,0,0,0,0,-12000,0,0,0,26000,38000,-12000,-12000
058116,正崴中信99購02  ,0,0,0,0,0,0,0,0,0,-12000,0,0,0,6000,18000,-12000,-12000
059432,聯發科元大99購26,0,0,0,0,0,0,0,0,0,-12000,0,0,0,0,12000,-12000,-12000
058016,智邦凱基98購06  ,0,0,0,0,0,0,0,0,0,-12000,0,0,0,4000,16000,-12000,-12000
057250,大立光統一98購08,0,0,0,0,0,0,0,0,0,-12000,0,0,0,0,12000,-12000,-12000
056119,欣興群益97購02  ,0,0,0,0,0,0,0,0,0,-12000,0,0,0,117000,129000,-12000,-12000
056173,廣達元富97購01  ,0,0,0,0,0,0,0,0,0,-12000,0,0,0,8000,20000,-12000,-12000
05609P,國泰金凱基96售01,0,0,0,0,0,0,0,0,0,-12000,0,0,0,66000,78000,-12000,-12000
057012,康控中信98購01  ,0,0,0,0,0,0,0,0,0,-12000,0,0,0,0,12000,-12000,-12000
6491,晶碩            ,5000,17000,-12000,0,0,0,0,0,0,0,0,0,0,0,0,0,-12000
2705,六福            ,0,12000,-12000,0,0,0,0,0,0,0,0,0,0,0,0,0,-12000
2496,卓越            ,3000,15000,-12000,0,0,0,0,0,0,0,0,0,0,0,0,0,-12000
2015,豐興            ,107000,119000,-12000,0,0,0,0,0,0,0,0,0,0,0,0,0,-12000
1603,華電            ,3000,15000,-12000,0,0,0,0,0,0,0,0,0,0,0,0,0,-12000
07265P,大立光元大99售16,0,0,0,0,0,0,0,0,0,-12000,0,0,0,55000,67000,-12000,-12000
07284P,大立光凱基99售10,0,0,0,0,0,0,0,0,0,-12000,0,0,0,20000,32000,-12000,-12000
07105P,大毅元富99售02  ,0,0,0,0,0,0,0,0,0,-12000,0,0,0,43000,55000,-12000,-12000
07243P,台灣50凱基9A售04,0,0,0,0,0,0,0,0,0,-12000,0,0,0,2000,14000,-12000,-12000
07235P,T50正2元大9C售02,0,0,0,0,0,0,0,0,0,-12000,0,0,0,11000,23000,-12000,-12000
07932P,國巨元大9B售04  ,0,0,0,0,0,0,0,0,0,-12000,0,0,0,0,12000,-12000,-12000
07916P,臺股指元大9B售22,0,0,0,0,0,0,0,0,0,-12000,0,0,0,0,12000,-12000,-12000
061171,大立光麥證9A購01,0,0,0,0,13000,-13000,0,0,0,-13000,0,0,0,0,13000,-13000,-13000
06150P,奇力新元大97售06,0,0,0,0,0,0,0,0,0,-13000,0,0,0,0,13000,-13000,-13000
060165,上緯控永豐9A購01,0,0,0,0,0,0,0,0,0,-13000,0,0,0,80000,93000,-13000,-13000
060265,宏達電國票9A購02,0,0,0,0,0,0,0,0,0,-13000,0,0,0,0,13000,-13000,-13000
060101,大立光元大99購31,0,0,0,0,0,0,0,0,0,-13000,0,0,0,0,13000,-13000,-13000
061048,國巨中信9A購05  ,0,0,0,0,0,0,0,0,0,-13000,0,0,0,0,13000,-13000,-13000
060982,旺宏元大9A購09  ,0,0,0,0,0,0,0,0,0,-13000,0,0,0,26000,39000,-13000,-13000
051638,聯茂國票96購01  ,0,0,0,0,0,0,0,0,0,-13000,0,0,0,0,13000,-13000,-13000
051798,國巨永豐95購03  ,0,0,0,0,0,0,0,0,0,-13000,0,0,0,7000,20000,-13000,-13000
052038,國巨永昌96購01  ,0,0,0,0,0,0,0,0,0,-13000,0,0,0,2000,15000,-13000,-13000
053513,義隆群益96購05  ,0,0,0,0,0,0,0,0,0,-13000,0,0,0,21000,34000,-13000,-13000
055178,晶豪科統一97購01,0,0,0,0,0,0,0,0,0,-13000,0,0,0,166000,179000,-13000,-13000
055403,泰鼎元富97購01  ,0,0,0,0,0,0,0,0,0,-13000,0,0,0,0,13000,-13000,-13000
055610,光磊國票98購01  ,0,0,0,0,0,0,0,0,0,-13000,0,0,0,25000,38000,-13000,-13000
058798,大立光元大99購11,0,0,0,0,0,0,0,0,0,-13000,0,0,0,1000,14000,-13000,-13000
056162,祥碩凱基97購03  ,0,0,0,0,0,0,0,0,0,-13000,0,0,0,0,13000,-13000,-13000
055933,欣興群益98購02  ,0,0,0,0,0,0,0,0,0,-13000,0,0,0,120000,133000,-13000,-13000
058090,聯發科元大98購16,0,0,0,0,0,0,0,0,0,-13000,0,0,0,2000,15000,-13000,-13000
056241,緯創群益97購01  ,0,0,0,0,0,0,0,0,0,-13000,0,0,0,83000,96000,-13000,-13000
058488,華擎國票9A購01  ,0,0,0,0,0,0,0,0,0,-13000,0,0,0,22000,35000,-13000,-13000
055739,健鼎元富97購01  ,0,0,0,0,0,0,0,0,0,-13000,0,0,0,7000,20000,-13000,-13000
07714P,世紀鋼元大9A售03,0,0,0,0,0,0,0,0,0,-13000,0,0,0,22000,35000,-13000,-13000
07358P,鴻海元大99售39  ,0,0,0,0,0,0,0,0,0,-13000,0,0,0,92000,105000,-13000,-13000
1721,三晃            ,3000,16000,-13000,0,0,0,0,0,0,0,0,0,0,0,0,0,-13000
2029,盛餘            ,8000,21000,-13000,0,0,0,0,0,0,0,0,0,0,0,0,0,-13000
2538,基泰            ,36000,49000,-13000,0,0,0,0,0,0,0,0,0,0,0,0,0,-13000
3164,景岳            ,3000,16000,-13000,0,0,0,0,0,0,0,0,0,0,0,0,0,-13000
6183,關貿            ,4000,17000,-13000,0,0,0,0,0,0,0,0,0,0,0,0,0,-13000
060540,南亞凱基9A購01  ,0,0,0,0,0,0,0,0,0,-14000,0,0,0,154000,168000,-14000,-14000
060680,玉晶光元大9C購03,0,0,0,0,0,0,0,0,0,-14000,0,0,0,143000,157000,-14000,-14000
061642,創意元大9A購04  ,0,0,0,0,0,0,0,0,0,-14000,0,0,0,35000,49000,-14000,-14000
061228,聯茂中信9A購01  ,0,0,0,0,0,0,0,0,0,-14000,0,0,0,110000,124000,-14000,-14000
061334,華通元大9A購09  ,0,0,0,0,0,0,0,0,0,-14000,0,0,0,273000,287000,-14000,-14000
06837P,上銀統一9A售02  ,0,0,0,0,0,0,0,0,0,-14000,0,0,0,0,14000,-14000,-14000
06935P,神達元大98售02  ,0,0,0,0,0,0,0,0,0,-14000,0,0,0,0,14000,-14000,-14000
059069,臺指反元大9C購01,0,0,0,0,0,0,0,0,0,-14000,0,0,0,0,14000,-14000,-14000
058738,FBVIX中信03購04 ,0,0,0,0,0,0,0,0,0,-14000,0,0,0,0,14000,-14000,-14000
055388,華通統一97購03  ,0,0,0,0,0,0,0,0,0,-14000,0,0,0,72000,86000,-14000,-14000
055123,億光兆豐97購01  ,0,0,0,0,0,0,0,0,0,-14000,0,0,0,0,14000,-14000,-14000
054656,深中小元大97購01,0,0,0,0,0,0,0,0,0,-14000,0,0,0,20000,34000,-14000,-14000
054682,東元永豐97購01  ,0,0,0,0,0,0,0,0,0,-14000,0,0,0,54000,68000,-14000,-14000
051635,大立光國票96購04,0,0,0,0,0,0,0,0,0,-14000,0,0,0,0,14000,-14000,-14000
054416,禾伸堂元大97購01,0,0,0,0,0,0,0,0,0,-14000,0,0,0,31000,45000,-14000,-14000
058454,嘉晶永豐99購01  ,0,0,0,0,0,0,0,0,0,-14000,0,0,0,98000,112000,-14000,-14000
058438,大立光統一9B購01,0,0,0,0,0,0,0,0,0,-14000,0,0,0,118000,132000,-14000,-14000
058636,亞光兆豐9A購01  ,0,0,0,0,0,0,0,0,0,-14000,0,0,0,16000,30000,-14000,-14000
058732,矽格永豐99購01  ,0,0,0,0,0,0,0,0,0,-14000,0,0,0,43000,57000,-14000,-14000
057349,聯發科統一98購04,0,0,0,0,0,0,0,0,0,-14000,0,0,0,146000,160000,-14000,-14000
059256,臺股指凱基99購34,0,0,0,0,0,0,0,0,0,-14000,0,0,0,21000,35000,-14000,-14000
057191,祥碩元大98購05  ,0,0,0,0,0,0,0,0,0,-14000,0,0,0,10000,24000,-14000,-14000
05701P,彩晶凱基96售01  ,0,0,0,0,0,0,0,0,0,-14000,0,0,0,0,14000,-14000,-14000
057053,立積元大98購02  ,0,0,0,0,0,0,0,0,0,-14000,0,0,0,4000,18000,-14000,-14000
05606P,TPK國票97售02   ,0,0,0,0,0,0,0,0,0,-14000,0,0,0,22000,36000,-14000,-14000
6582,申豐            ,40000,49000,-9000,0,0,0,0,0,0,-5000,0,4000,-4000,0,1000,-1000,-14000
3321,同泰            ,21000,35000,-14000,0,0,0,0,0,0,0,0,0,0,0,0,0,-14000
1533,車王電          ,5000,19000,-14000,0,0,0,0,0,0,0,0,0,0,0,0,0,-14000
1537,廣隆            ,2000,16000,-14000,0,0,0,0,0,0,0,0,0,0,0,0,0,-14000
07034P,大立光元富99售03,0,0,0,0,0,0,0,0,0,-14000,0,0,0,6000,20000,-14000,-14000
07635P,世芯永豐9A售05  ,0,0,0,0,0,0,0,0,0,-14000,0,0,0,40000,54000,-14000,-14000
07615P,華通中信02售02  ,0,0,0,0,0,0,0,0,0,-14000,0,0,0,0,14000,-14000,-14000
07919P,創意永豐9B售01  ,0,0,0,0,0,0,0,0,0,-14000,0,0,0,21000,35000,-14000,-14000
07929P,旺宏統一9B售07  ,0,0,0,0,0,0,0,0,0,-14000,0,0,0,10000,24000,-14000,-14000
1323,永裕            ,1000,15000,-14000,0,0,0,0,0,0,0,0,0,0,0,0,0,-14000
06901P,亞德客凱基98售02,0,0,0,0,0,0,0,0,0,-15000,0,0,0,0,15000,-15000,-15000
06810P,國巨統一99售03  ,0,0,0,0,0,0,0,0,0,-15000,0,0,0,8000,23000,-15000,-15000
06803P,臺股指群益98售09,0,0,0,0,0,0,0,0,0,-15000,0,0,0,0,15000,-15000,-15000
06487P,聯發科統一99售02,0,0,0,0,0,0,0,0,0,-15000,0,0,0,0,15000,-15000,-15000
062104,上証2X國票9B購03,0,0,0,0,0,0,0,0,0,-15000,0,0,0,0,15000,-15000,-15000
062114,GIS國票9C購01   ,0,0,0,0,0,0,0,0,0,-15000,0,0,0,0,15000,-15000,-15000
061268,玉晶光凱基9B購04,0,0,0,0,0,0,0,0,0,-15000,0,0,0,0,15000,-15000,-15000
061582,麗豐元大9A購01  ,0,0,0,0,0,0,0,0,0,-15000,0,0,0,78000,93000,-15000,-15000
060659,鴻海凱基9B購03  ,0,0,0,0,0,0,0,0,0,-15000,0,0,0,0,15000,-15000,-15000
060785,國巨富邦9B購04  ,0,0,0,0,0,0,0,0,0,-15000,0,0,0,10000,25000,-15000,-15000
060978,國巨元大9A購13  ,0,0,0,0,0,0,0,0,0,-15000,0,0,0,60000,75000,-15000,-15000
060881,玉山金中信02購01,0,0,0,0,0,0,0,0,0,-15000,0,0,0,18000,33000,-15000,-15000
060847,康控國票9A購01  ,0,0,0,0,0,0,0,0,0,-15000,0,0,0,38000,53000,-15000,-15000
060838,華通國票9A購05  ,0,0,0,0,0,0,0,0,0,-15000,0,0,0,27000,42000,-15000,-15000
060815,茂林凱基9B購01  ,0,0,0,0,0,0,0,0,0,-15000,0,0,0,0,15000,-15000,-15000
060015,國巨康和99購03  ,0,0,0,0,0,0,0,0,0,-15000,0,0,0,1000,16000,-15000,-15000
060308,劍麟永豐9A購01  ,0,0,0,0,0,0,0,0,0,-15000,0,0,0,0,15000,-15000,-15000
054422,T50反1富邦9A購01,0,0,0,0,0,0,0,0,0,-15000,0,0,0,0,15000,-15000,-15000
052077,可成元富98購02  ,0,0,0,0,0,0,0,0,0,-15000,0,0,0,5000,20000,-15000,-15000
051597,T50反1中信99購02,0,0,0,0,0,0,0,0,0,-15000,0,0,0,0,15000,-15000,-15000
051495,玉晶光第一95購02,0,0,0,0,0,0,0,0,0,-15000,0,0,0,0,15000,-15000,-15000
052659,上証2X國票99購01,0,0,0,0,0,0,0,0,0,-15000,0,0,0,10000,25000,-15000,-15000
05268P,玉晶光元大98售01,0,0,0,0,0,0,0,0,0,-15000,0,0,0,5000,20000,-15000,-15000
053018,旺宏元富96購02  ,0,0,0,0,0,0,0,0,0,-15000,0,0,0,0,15000,-15000,-15000
053032,國巨兆豐97購02  ,0,0,0,0,0,0,0,0,0,-15000,0,0,0,0,15000,-15000,-15000
051466,玉晶光富邦97購01,0,0,0,0,0,0,0,0,0,-15000,0,0,0,0,15000,-15000,-15000
05119P,聯發科國泰96售02,0,0,0,0,0,0,0,0,0,-15000,0,0,0,0,15000,-15000,-15000
03437B,臺股指元富9C熊01,0,0,0,0,0,0,0,0,0,-15000,0,0,0,0,15000,-15000,-15000
03446B,臺股指元大9B熊26,0,0,0,0,0,0,0,0,0,-15000,0,0,0,5000,20000,-15000,-15000
055191,牧德元富97購01  ,0,0,0,0,0,0,0,0,0,-15000,0,0,0,10000,25000,-15000,-15000
055214,聯電凱基97購02  ,0,0,0,0,0,0,0,0,0,-15000,0,0,0,130000,145000,-15000,-15000
054811,裕隆元大9A購01  ,0,0,0,0,0,0,0,0,0,-15000,0,0,0,0,15000,-15000,-15000
054807,台化元大9A購02  ,0,0,0,0,0,0,0,0,0,-15000,0,0,0,85000,100000,-15000,-15000
05485P,旺宏凱基95售08  ,0,0,0,0,0,0,0,0,0,-15000,0,0,0,0,15000,-15000,-15000
054003,鴻海統一96購13  ,0,0,0,0,0,0,0,0,0,-15000,0,0,0,48000,63000,-15000,-15000
054028,臻鼎凱基96購03  ,0,0,0,0,0,0,0,0,0,-15000,0,0,0,0,15000,-15000,-15000
055377,揚明光元大98購01,0,0,0,0,0,0,0,0,0,-15000,0,0,0,0,15000,-15000,-15000
055589,台光電元大98購04,0,0,0,0,0,0,0,0,0,-15000,0,0,0,12000,27000,-15000,-15000
058816,祥碩台新99購02  ,0,0,0,0,0,0,0,0,0,-15000,0,0,0,0,15000,-15000,-15000
058950,國巨群益99購06  ,0,0,0,0,0,0,0,0,0,-15000,0,0,0,57000,72000,-15000,-15000
058955,台積電國票9A購04,0,0,0,0,0,0,0,0,0,-15000,0,0,0,70000,85000,-15000,-15000
058919,SGBR2X元富99購05,0,0,0,0,0,0,0,0,0,-15000,0,0,0,5000,20000,-15000,-15000
056101,光磊永豐98購01  ,0,0,0,0,0,0,0,0,0,-15000,0,0,0,40000,55000,-15000,-15000
058277,FBVIX中信03購01 ,0,0,0,0,0,0,0,0,0,-15000,0,0,0,0,15000,-15000,-15000
058279,FBVIX中信03購03 ,0,0,0,0,0,0,0,0,0,-15000,0,0,0,0,15000,-15000,-15000
057567,嘉聯益富邦9A購01,0,0,0,0,0,0,0,0,0,-15000,0,0,0,0,15000,-15000,-15000
058190,貿聯永豐99購01  ,0,0,0,0,0,0,0,0,0,-15000,0,0,0,68000,83000,-15000,-15000
058128,FBVIX元大9C購02 ,0,0,0,0,0,0,0,0,0,-15000,0,0,0,0,15000,-15000,-15000
056953,智邦富邦98購02  ,0,0,0,0,0,0,0,0,0,-15000,0,0,0,20000,35000,-15000,-15000
056585,台積電統一9A購01,0,0,0,0,0,0,0,0,0,-15000,0,0,0,0,15000,-15000,-15000
05646P,聯發科國票96售05,0,0,0,0,0,0,0,0,0,-15000,0,0,0,0,15000,-15000,-15000
056883,美食康和98購01  ,0,0,0,0,0,0,0,0,0,-15000,0,0,0,0,15000,-15000,-15000
058527,世紀鋼元大99購01,0,0,0,0,0,0,0,0,0,-15000,0,0,0,0,15000,-15000,-15000
07630P,臺股指凱基9A售11,0,0,0,0,0,0,0,0,0,-15000,0,0,0,28000,43000,-15000,-15000
07750P,台表科凱基9A售04,0,0,0,0,0,0,0,0,0,-15000,0,0,0,0,15000,-15000,-15000
07242P,台灣50凱基9A售03,0,0,0,0,0,0,0,0,0,-15000,0,0,0,10000,25000,-15000,-15000
07134P,臺股指元大9A售28,0,0,0,0,0,0,0,0,0,-15000,0,0,0,11000,26000,-15000,-15000
07509P,牧德國票9A售03  ,0,0,0,0,0,0,0,0,0,-15000,0,0,0,0,15000,-15000,-15000
3055,蔚華科          ,13000,28000,-15000,0,0,0,0,0,0,0,0,0,0,0,0,0,-15000
3046,建碁            ,0,15000,-15000,0,0,0,0,0,0,0,0,0,0,0,0,0,-15000
5907,大洋-KY         ,26000,41000,-15000,0,0,0,0,0,0,0,0,0,0,0,0,0,-15000
06054P,臺股指中信9A售01,0,0,0,0,0,0,0,0,0,-16000,0,0,0,0,16000,-16000,-16000
061812,臺指反群益9B購02,0,0,0,0,0,0,0,0,0,-16000,0,0,0,0,16000,-16000,-16000
061285,大立光統一9A購04,0,0,0,0,0,0,0,0,0,-16000,0,0,0,0,16000,-16000,-16000
06359P,上銀群益97售03  ,0,0,0,0,0,0,0,0,0,-16000,0,0,0,6000,22000,-16000,-16000
06832P,玉晶光凱基98售03,0,0,0,0,0,0,0,0,0,-16000,0,0,0,10000,26000,-16000,-16000
058796,可成元大99購04  ,0,0,0,0,0,0,0,0,0,-16000,0,0,0,54000,70000,-16000,-16000
054098,嘉晶國票97購04  ,0,0,0,0,0,0,0,0,0,-16000,0,0,0,20000,36000,-16000,-16000
054932,台肥元大97購01  ,0,0,0,0,0,0,0,0,0,-16000,0,0,0,47000,63000,-16000,-16000
054352,世芯國泰98購01  ,0,0,0,0,0,0,0,0,0,-16000,0,0,0,17000,33000,-16000,-16000
00771,元大US高息特別股,0,0,0,0,0,0,0,0,0,-16000,0,0,0,0,16000,-16000,-16000
058446,新光金富邦9C購01,0,0,0,0,0,0,0,0,0,-16000,0,0,0,0,16000,-16000,-16000
056462,訊芯凱基98購03  ,0,0,0,0,0,0,0,0,0,-16000,0,0,0,30000,46000,-16000,-16000
057846,神達永豐98購01  ,0,0,0,0,0,0,0,0,0,-16000,0,0,0,10000,26000,-16000,-16000
057967,聯發科國泰9A購02,0,0,0,0,0,0,0,0,0,-16000,0,0,0,10000,26000,-16000,-16000
058648,聯陽永豐99購01  ,0,0,0,0,0,0,0,0,0,-16000,0,0,0,45000,61000,-16000,-16000
059302,大立光群益99購08,0,0,0,0,0,0,0,0,0,-16000,0,0,0,3000,19000,-16000,-16000
059504,台灣50永豐99購08,0,0,0,0,0,0,0,0,0,-16000,0,0,0,0,16000,-16000,-16000
1568,倉佑            ,0,16000,-16000,0,0,0,0,0,0,0,0,0,0,0,0,0,-16000
07275P,FBVIX群益99售02 ,0,0,0,0,0,0,0,0,0,-16000,0,0,0,0,16000,-16000,-16000
07614P,華新科群益9A售04,0,0,0,0,0,0,0,0,0,-16000,0,0,0,0,16000,-16000,-16000
061571,奇力新元大9A購03,0,0,0,0,0,0,0,0,0,-17000,0,0,0,83000,100000,-17000,-17000
061622,臻鼎群益9A購01  ,0,0,0,0,0,0,0,0,0,-17000,0,0,0,20000,37000,-17000,-17000
060576,欣興中信9B購01  ,0,0,0,0,0,0,0,0,0,-17000,0,0,0,60000,77000,-17000,-17000
060777,茂林凱基9C購01  ,0,0,0,0,0,0,0,0,0,-17000,0,0,0,5000,22000,-17000,-17000
052822,泰碩永豐97購01  ,0,0,0,0,0,0,0,0,0,-17000,0,0,0,3000,20000,-17000,-17000
053505,瑞儀兆豐97購01  ,0,0,0,0,0,0,0,0,0,-17000,0,0,0,6000,23000,-17000,-17000
058007,南電群益98購02  ,0,0,0,0,0,0,0,0,0,-17000,0,0,0,23000,40000,-17000,-17000
059130,台灣50群益9B購05,0,0,0,0,0,0,0,0,0,-17000,0,0,0,0,17000,-17000,-17000
058274,世紀鋼永豐99購01,0,0,0,0,0,0,0,0,0,-17000,0,0,0,18000,35000,-17000,-17000
05723P,華通永豐96售03  ,0,0,0,0,0,0,0,0,0,-17000,0,0,0,0,17000,-17000,-17000
057374,禾伸堂元大99購03,0,0,0,0,0,0,0,0,0,-17000,0,0,0,8000,25000,-17000,-17000
057406,茂林群益98購03  ,0,0,0,0,0,0,0,0,0,-17000,0,0,0,145000,162000,-17000,-17000
057419,奇力新凱基98購06,0,0,0,0,0,0,0,0,0,-17000,0,0,0,30000,47000,-17000,-17000
056358,友訊元大99購01  ,0,0,0,0,0,0,0,0,0,-17000,0,0,0,0,17000,-17000,-17000
07335P,臺股指國票99售20,0,0,0,0,0,0,0,0,0,-17000,0,0,0,6000,23000,-17000,-17000
07187P,臺股指台新99售10,0,0,0,0,0,0,0,0,0,-17000,0,0,0,3000,20000,-17000,-17000
1626,艾美特-KY       ,18000,35000,-17000,0,0,0,0,0,0,0,0,0,0,0,0,0,-17000
2358,廷鑫            ,0,17000,-17000,0,0,0,0,0,0,0,0,0,0,0,0,0,-17000
060146,健策國票9A購03  ,0,0,0,0,0,0,0,0,0,-18000,0,0,0,0,18000,-18000,-18000
059865,國巨凱基01購01  ,0,0,0,0,0,0,0,0,0,-18000,0,0,0,608000,626000,-18000,-18000
05990P,台積電群益96售13,0,0,0,0,0,0,0,0,0,-18000,0,0,0,1000,19000,-18000,-18000
061636,聯發科元大9A購11,0,0,0,0,0,0,0,0,0,-18000,0,0,0,0,18000,-18000,-18000
061172,大立光麥證9A購02,0,0,0,4000,22000,-18000,0,0,0,-18000,0,0,0,4000,22000,-18000,-18000
061174,鴻海凱基9A購23  ,0,0,0,0,0,0,0,0,0,-18000,0,0,0,0,18000,-18000,-18000
06621P,欣興元大98售06  ,0,0,0,0,0,0,0,0,0,-18000,0,0,0,3000,21000,-18000,-18000
062122,國巨統一02購01  ,0,0,0,0,0,0,0,0,0,-18000,0,0,0,0,18000,-18000,-18000
055119,力成凱基98購01  ,0,0,0,0,0,0,0,0,0,-18000,0,0,0,0,18000,-18000,-18000
052137,台表科凱基96購02,0,0,0,0,0,0,0,0,0,-18000,0,0,0,2000,20000,-18000,-18000
052323,矽力元大95購04  ,0,0,0,0,0,0,0,0,0,-18000,0,0,0,19000,37000,-18000,-18000
03047X,元展44          ,0,0,0,0,0,0,0,0,0,-18000,0,0,0,0,18000,-18000,-18000
049675,台光電國票95購01,0,0,0,0,0,0,0,0,0,-18000,0,0,0,0,18000,-18000,-18000
058214,世芯群益9A購01  ,0,0,0,0,0,0,0,0,0,-18000,0,0,0,39000,57000,-18000,-18000
058220,世芯國票9A購01  ,0,0,0,0,0,0,0,0,0,-18000,0,0,0,62000,80000,-18000,-18000
057499,奇鋐群益98購01  ,0,0,0,0,0,0,0,0,0,-18000,0,0,0,14000,32000,-18000,-18000
056087,世芯統一97購01  ,0,0,0,0,0,0,0,0,0,-18000,0,0,0,20000,38000,-18000,-18000
059401,牧德元富99購01  ,0,0,0,0,0,0,0,0,0,-18000,0,0,0,4000,22000,-18000,-18000
057113,祥碩群益98購01  ,0,0,0,0,0,0,0,0,0,-18000,0,0,0,2000,20000,-18000,-18000
057150,貿聯國票99購02  ,0,0,0,0,0,0,0,0,0,-18000,0,0,0,38000,56000,-18000,-18000
1432,大魯閣          ,9000,27000,-18000,0,0,0,0,0,0,0,0,0,0,0,0,0,-18000
3038,全台            ,181000,199000,-18000,0,0,0,0,0,0,0,0,0,0,0,0,0,-18000
3607,谷崧            ,70000,88000,-18000,0,0,0,0,0,0,0,0,0,0,0,0,0,-18000
06967P,台郡台新99售02  ,0,0,0,0,0,0,0,0,0,-18000,0,0,0,15000,33000,-18000,-18000
07551P,國巨元大9A售10  ,0,0,0,0,0,0,0,0,0,-18000,0,0,0,0,18000,-18000,-18000
07765P,台積電群益9A售06,0,0,0,0,0,0,0,0,0,-18000,0,0,0,0,18000,-18000,-18000
06599P,宏達電永豐98售02,0,0,0,0,0,0,0,0,0,-19000,0,0,0,28000,47000,-19000,-19000
06405P,億光元富97售02  ,0,0,0,0,0,0,0,0,0,-19000,0,0,0,0,19000,-19000,-19000
06156P,大立光統一97售05,0,0,0,0,0,0,0,0,0,-19000,0,0,0,50000,69000,-19000,-19000
059868,台光電凱基99購03,0,0,0,0,0,0,0,0,0,-19000,0,0,0,11000,30000,-19000,-19000
05982P,漢唐國票96售03  ,0,0,0,0,0,0,0,0,0,-19000,0,0,0,0,19000,-19000,-19000
060077,台積電台新9B購01,0,0,0,0,0,0,0,0,0,-19000,0,0,0,40000,59000,-19000,-19000
060729,國巨群益9A購05  ,0,0,0,0,0,0,0,0,0,-19000,0,0,0,123000,142000,-19000,-19000
05059P,大立光國票96售02,0,0,0,0,0,0,0,0,0,-19000,0,0,0,1000,20000,-19000,-19000
055618,麗豐國票98購01  ,0,0,0,0,0,0,0,0,0,-19000,0,0,0,0,19000,-19000,-19000
058236,大立光元大99購09,0,0,0,0,0,0,0,0,0,-19000,0,0,0,0,19000,-19000,-19000
057280,大立光元大98購15,0,0,0,0,0,0,0,0,0,-19000,0,0,0,0,19000,-19000,-19000
055763,鎧勝群益97購01  ,0,0,0,0,0,0,0,0,0,-19000,0,0,0,111000,130000,-19000,-19000
058676,聯茂群益99購01  ,0,0,0,0,0,0,0,0,0,-19000,0,0,0,244000,263000,-19000,-19000
07712P,茂林元大9A售03  ,0,0,0,0,0,0,0,0,0,-19000,0,0,0,0,19000,-19000,-19000
1104,環泥            ,31000,50000,-19000,0,0,0,0,0,0,0,0,0,0,0,0,0,-19000
07855P,旺宏凱基9A售09  ,0,0,0,0,0,0,0,0,0,-19000,0,0,0,0,19000,-19000,-19000
1446,宏和            ,10000,29000,-19000,0,0,0,0,0,0,0,0,0,0,0,0,0,-19000
4560,強信-KY         ,120000,139000,-19000,0,0,0,0,0,0,0,0,0,0,0,0,0,-19000
8103,瀚荃            ,1000,20000,-19000,0,0,0,0,0,0,0,0,0,0,0,0,0,-19000
9927,泰銘            ,23000,42000,-19000,0,0,0,0,0,0,0,0,0,0,0,0,0,-19000
9955,佳龍            ,11000,30000,-19000,0,0,0,0,0,0,0,0,0,0,0,0,0,-19000
060731,奇力新群益9A購01,0,0,0,0,0,0,0,0,0,-20000,0,0,0,0,20000,-20000,-20000
060809,康友群益9A購01  ,0,0,0,0,0,0,0,0,0,-20000,0,0,0,31000,51000,-20000,-20000
060563,智邦富邦9A購01  ,0,0,0,0,0,0,0,0,0,-20000,0,0,0,0,20000,-20000,-20000
060525,台積電中信01購04,0,0,0,0,0,0,0,0,0,-20000,0,0,0,0,20000,-20000,-20000
061080,華邦電兆豐9B購01,0,0,0,0,0,0,0,0,0,-20000,0,0,0,0,20000,-20000,-20000
060083,和大元大99購02  ,0,0,0,0,0,0,0,0,0,-20000,0,0,0,14000,34000,-20000,-20000
059179,祥碩元富99購01  ,0,0,0,0,0,0,0,0,0,-20000,0,0,0,30000,50000,-20000,-20000
06012P,世芯國票96售01  ,0,0,0,0,0,0,0,0,0,-20000,0,0,0,0,20000,-20000,-20000
060022,勤誠康和99購01  ,0,0,0,0,0,0,0,0,0,-20000,0,0,0,0,20000,-20000,-20000
060038,台積電國票99購13,0,0,0,0,0,0,0,0,0,-20000,0,0,0,36000,56000,-20000,-20000
059986,宏達電元大99購08,0,0,0,0,0,0,0,0,0,-20000,0,0,0,0,20000,-20000,-20000
059898,T50反1元大99購15,0,0,0,0,0,0,0,0,0,-20000,0,0,0,0,20000,-20000,-20000
059936,台積電永豐99購06,0,0,0,0,0,0,0,0,0,-20000,0,0,0,0,20000,-20000,-20000
060405,中租國泰9C購01  ,0,0,0,0,0,0,0,0,0,-20000,0,0,0,0,20000,-20000,-20000
061736,國巨凱基9B購05  ,0,0,0,0,0,0,0,0,0,-20000,0,0,0,0,20000,-20000,-20000
061741,新光金凱基9B購01,0,0,0,0,0,0,0,0,0,-20000,0,0,0,0,20000,-20000,-20000
061327,台郡凱基9A購02  ,0,0,0,0,0,0,0,0,0,-20000,0,0,0,0,20000,-20000,-20000
061386,道瓊銀群益9A購03,0,0,0,0,0,0,0,0,0,-20000,0,0,0,0,20000,-20000,-20000
061402,矽創兆豐9B購01  ,0,0,0,0,0,0,0,0,0,-20000,0,0,0,111000,131000,-20000,-20000
06517P,國巨凱基98售09  ,0,0,0,0,0,0,0,0,0,-20000,0,0,0,0,20000,-20000,-20000
06638P,鴻海統一99售02  ,0,0,0,0,0,0,0,0,0,-20000,0,0,0,0,20000,-20000,-20000
06653P,美食元大98售02  ,0,0,0,0,0,0,0,0,0,-20000,0,0,0,0,20000,-20000,-20000
06845P,億光元大98售02  ,0,0,0,0,0,0,0,0,0,-20000,0,0,0,0,20000,-20000,-20000
06862P,大立光凱基98售16,0,0,0,0,0,0,0,0,0,-20000,0,0,0,0,20000,-20000,-20000
062127,台勝科統一01購02,0,0,0,0,0,0,0,0,0,-20000,0,0,0,0,20000,-20000,-20000
062167,燿華永豐9B購01  ,0,0,0,0,0,0,0,0,0,-20000,0,0,0,0,20000,-20000,-20000
062190,瀚宇博元大9B購01,0,0,0,0,0,0,0,0,0,-20000,0,0,0,0,20000,-20000,-20000
06340P,鴻海統一98售06  ,0,0,0,0,0,0,0,0,0,-20000,0,0,0,0,20000,-20000,-20000
061909,台積電中信05購02,0,0,0,0,0,0,0,0,0,-20000,0,0,0,0,20000,-20000,-20000
06185P,台表科元大97售05,0,0,0,0,0,0,0,0,0,-20000,0,0,0,0,20000,-20000,-20000
055515,聚陽中信9A購01  ,0,0,0,0,0,0,0,0,0,-20000,0,0,0,0,20000,-20000,-20000
055531,華新科群益98購03,0,0,0,0,0,0,0,0,0,-20000,0,0,0,0,20000,-20000,-20000
055492,華新科元大97購08,0,0,0,0,0,0,0,0,0,-20000,0,0,0,0,20000,-20000,-20000
055304,瑞昱第一98購01  ,0,0,0,0,0,0,0,0,0,-20000,0,0,0,0,20000,-20000,-20000
058757,道瓊銀群益9A購02,0,0,0,0,0,0,0,0,0,-20000,0,0,0,0,20000,-20000,-20000
058930,華新科統一9B購01,0,0,0,0,0,0,0,0,0,-20000,0,0,0,0,20000,-20000,-20000
059000,台積電元大99購25,0,0,0,0,0,0,0,0,0,-20000,0,0,0,0,20000,-20000,-20000
053516,茂林群益96購05  ,0,0,0,0,0,0,0,0,0,-20000,0,0,0,0,20000,-20000,-20000
054867,華航群益99購01  ,0,0,0,0,0,0,0,0,0,-20000,0,0,0,0,20000,-20000,-20000
053883,大立光中信98購02,0,0,0,0,0,0,0,0,0,-20000,0,0,0,0,20000,-20000,-20000
055217,緯創凱基97購02  ,0,0,0,0,0,0,0,0,0,-20000,0,0,0,0,20000,-20000,-20000
055207,致新中信99購01  ,0,0,0,0,0,0,0,0,0,-20000,0,0,0,36000,56000,-20000,-20000
05524P,瀚宇博國票97售02,0,0,0,0,0,0,0,0,0,-20000,0,0,0,0,20000,-20000,-20000
054772,康控國票98購02  ,0,0,0,0,0,0,0,0,0,-20000,0,0,0,137000,157000,-20000,-20000
055024,興勤國泰98購01  ,0,0,0,0,0,0,0,0,0,-20000,0,0,0,0,20000,-20000,-20000
053708,道瓊反凱基98購01,0,0,0,0,0,0,0,0,0,-20000,0,0,0,0,20000,-20000,-20000
050698,明泰凱基96購01  ,0,0,0,0,0,0,0,0,0,-20000,0,0,0,0,20000,-20000,-20000
050699,京鼎凱基96購01  ,0,0,0,0,0,0,0,0,0,-20000,0,0,0,0,20000,-20000,-20000
052963,智邦凱基96購02  ,0,0,0,0,0,0,0,0,0,-20000,0,0,0,10000,30000,-20000,-20000
05124P,華新科富邦97售02,0,0,0,0,0,0,0,0,0,-20000,0,0,0,0,20000,-20000,-20000
048874,玉晶光國票96購01,0,0,0,0,0,0,0,0,0,-20000,0,0,0,0,20000,-20000,-20000
042792,T50反1台新9C購01,0,0,0,0,0,0,0,0,0,-20000,0,0,0,0,20000,-20000,-20000
04950P,上証2X中信96售02,0,0,0,0,0,0,0,0,0,-20000,0,0,0,0,20000,-20000,-20000
049434,茂林國票95購01  ,0,0,0,0,0,0,0,0,0,-20000,0,0,0,0,20000,-20000,-20000
049438,嘉晶國泰96購01  ,0,0,0,0,0,0,0,0,0,-20000,0,0,0,0,20000,-20000,-20000
03658C,T50反1元大9A牛02,0,0,0,0,0,0,0,0,0,-20000,0,0,0,0,20000,-20000,-20000
04049P,大立光元大95售02,0,0,0,0,0,0,0,0,0,-20000,0,0,0,0,20000,-20000,-20000
052597,茂林群益96購01  ,0,0,0,0,0,0,0,0,0,-20000,0,0,0,0,20000,-20000,-20000
052167,亞泥元大96購01  ,0,0,0,0,0,0,0,0,0,-20000,0,0,0,0,20000,-20000,-20000
051510,新光金中信97購01,0,0,0,0,0,0,0,0,0,-20000,0,0,0,0,20000,-20000,-20000
051577,台積電元大97購03,0,0,0,0,0,0,0,0,0,-20000,0,0,0,0,20000,-20000,-20000
052772,台虹群益96購01  ,0,0,0,0,0,0,0,0,0,-20000,0,0,0,0,20000,-20000,-20000
054472,道瓊反中信9A購01,0,0,0,0,0,0,0,0,0,-20000,0,0,0,0,20000,-20000,-20000
053141,景碩永豐96購02  ,0,0,0,0,0,0,0,0,0,-20000,0,0,0,0,20000,-20000,-20000
053158,茂林元大96購01  ,0,0,0,0,0,0,0,0,0,-20000,0,0,0,0,20000,-20000,-20000
054547,鴻海凱基98購02  ,0,0,0,0,0,0,0,0,0,-20000,0,0,0,0,20000,-20000,-20000
05464P,華通康和95售02  ,0,0,0,0,0,0,0,0,0,-20000,0,0,0,0,20000,-20000,-20000
054652,裕隆麥證97購01  ,0,0,0,0,20000,-20000,0,0,0,-20000,0,0,0,0,20000,-20000,-20000
054642,訊芯中信9A購01  ,0,0,0,0,0,0,0,0,0,-20000,0,0,0,0,20000,-20000,-20000
054662,同欣電元大97購02,0,0,0,0,0,0,0,0,0,-20000,0,0,0,20000,40000,-20000,-20000
058593,大立光統一9B購02,0,0,0,0,0,0,0,0,0,-20000,0,0,0,0,20000,-20000,-20000
056838,旺宏元富98購01  ,0,0,0,0,0,0,0,0,0,-20000,0,0,0,5000,25000,-20000,-20000
055775,友達凱基9A購01  ,0,0,0,0,0,0,0,0,0,-20000,0,0,0,0,20000,-20000,-20000
055815,亞光國票99購01  ,0,0,0,0,0,0,0,0,0,-20000,0,0,0,0,20000,-20000,-20000
055842,建準元大98購01  ,0,0,0,0,0,0,0,0,0,-20000,0,0,0,118000,138000,-20000,-20000
056712,京鼎永豐98購01  ,0,0,0,0,0,0,0,0,0,-20000,0,0,0,0,20000,-20000,-20000
055740,智易元富97購01  ,0,0,0,0,0,0,0,0,0,-20000,0,0,0,0,20000,-20000,-20000
058450,旺宏永豐99購01  ,0,0,0,0,0,0,0,0,0,-20000,0,0,0,0,20000,-20000,-20000
057578,可成中信99購01  ,0,0,0,0,0,0,0,0,0,-20000,0,0,0,0,20000,-20000,-20000
057570,技嘉永豐98購02  ,0,0,0,0,0,0,0,0,0,-20000,0,0,0,0,20000,-20000,-20000
057325,可成群益9A購01  ,0,0,0,0,0,0,0,0,0,-20000,0,0,0,173000,193000,-20000,-20000
057892,上証2X元富02購01,0,0,0,0,0,0,0,0,0,-20000,0,0,0,0,20000,-20000,-20000
056230,可成凱基98購03  ,0,0,0,0,0,0,0,0,0,-20000,0,0,0,0,20000,-20000,-20000
056368,祥碩元大98購02  ,0,0,0,0,0,0,0,0,0,-20000,0,0,0,0,20000,-20000,-20000
056402,智易群益98購02  ,0,0,0,0,0,0,0,0,0,-20000,0,0,0,0,20000,-20000,-20000
056323,旺宏兆豐98購01  ,0,0,0,0,0,0,0,0,0,-20000,0,0,0,0,20000,-20000,-20000
056872,旺宏凱基98購08  ,0,0,0,0,0,0,0,0,0,-20000,0,0,0,0,20000,-20000,-20000
057791,可成統一99購01  ,0,0,0,0,0,0,0,0,0,-20000,0,0,0,0,20000,-20000,-20000
056481,創意元大98購01  ,0,0,0,0,0,0,0,0,0,-20000,0,0,0,0,20000,-20000,-20000
056523,光寶科中信98購01,0,0,0,0,0,0,0,0,0,-20000,0,0,0,0,20000,-20000,-20000
056546,致伸凱基98購01  ,0,0,0,0,0,0,0,0,0,-20000,0,0,0,0,20000,-20000,-20000
058326,祥碩台新99購01  ,0,0,0,0,0,0,0,0,0,-20000,0,0,0,0,20000,-20000,-20000
058313,台積電富邦9B購04,0,0,0,0,0,0,0,0,0,-20000,0,0,0,0,20000,-20000,-20000
058427,大毅元富99購01  ,0,0,0,0,0,0,0,0,0,-20000,0,0,0,0,20000,-20000,-20000
058399,美律元大99購05  ,0,0,0,0,0,0,0,0,0,-20000,0,0,0,13000,33000,-20000,-20000
057225,華新凱基98購01  ,0,0,0,0,0,0,0,0,0,-20000,0,0,0,0,20000,-20000,-20000
05720P,可成中信98售01  ,0,0,0,0,0,0,0,0,0,-20000,0,0,0,0,20000,-20000,-20000
058211,國巨群益9A購02  ,0,0,0,0,0,0,0,0,0,-20000,0,0,0,0,20000,-20000,-20000
057248,台積電統一98購08,0,0,0,0,0,0,0,0,0,-20000,0,0,0,0,20000,-20000,-20000
058015,旺宏凱基99購02  ,0,0,0,0,0,0,0,0,0,-20000,0,0,0,30000,50000,-20000,-20000
058040,FBVIX元大98購01 ,0,0,0,0,0,0,0,0,0,-20000,0,0,0,0,20000,-20000,-20000
058080,台積電群益98購06,0,0,0,0,0,0,0,0,0,-20000,0,0,0,12000,32000,-20000,-20000
059544,創意亞東99購01  ,0,0,0,0,0,0,0,0,0,-20000,0,0,0,0,20000,-20000,-20000
059434,全新元大99購05  ,0,0,0,0,0,0,0,0,0,-20000,0,0,0,0,20000,-20000,-20000
059501,可成元富99購01  ,0,0,0,0,0,0,0,0,0,-20000,0,0,0,10000,30000,-20000,-20000
059245,聯發科凱基9A購03,0,0,0,0,0,0,0,0,0,-20000,0,0,0,0,20000,-20000,-20000
059676,台積電台新99購05,0,0,0,0,0,0,0,0,0,-20000,0,0,0,10000,30000,-20000,-20000
059613,泰鼎永豐99購02  ,0,0,0,0,0,0,0,0,0,-20000,0,0,0,1000,21000,-20000,-20000
9930,中聯資源        ,12000,32000,-20000,0,0,0,0,0,0,0,0,0,0,0,0,0,-20000
8033,雷虎            ,0,20000,-20000,0,0,0,0,0,0,0,0,0,0,0,0,0,-20000
1503,士電            ,16000,36000,-20000,0,0,0,0,0,0,0,0,0,0,0,0,0,-20000
2114,鑫永銓          ,13000,33000,-20000,0,0,0,0,0,0,0,0,0,0,0,0,0,-20000
07817P,同欣電群益9A售02,0,0,0,0,0,0,0,0,0,-20000,0,0,0,0,20000,-20000,-20000
07740P,臺股指永豐9A售01,0,0,0,0,0,0,0,0,0,-20000,0,0,0,0,20000,-20000,-20000
07669P,華新科元大9A售14,0,0,0,0,0,0,0,0,0,-20000,0,0,0,3000,23000,-20000,-20000
07530P,聯發科凱基9A售11,0,0,0,0,0,0,0,0,0,-20000,0,0,0,0,20000,-20000,-20000
07588P,滬深2X國票9C售01,0,0,0,0,0,0,0,0,0,-20000,0,0,0,0,20000,-20000,-20000
07623P,大立光統一9B售05,0,0,0,0,0,0,0,0,0,-20000,0,0,0,10000,30000,-20000,-20000
07031P,台灣50中信03售02,0,0,0,0,0,0,0,0,0,-20000,0,0,0,0,20000,-20000,-20000
07064P,臺股指元大9A售25,0,0,0,0,0,0,0,0,0,-20000,0,0,0,0,20000,-20000,-20000
07140P,台灣50日盛99售01,0,0,0,0,0,0,0,0,0,-20000,0,0,0,0,20000,-20000,-20000
07218P,臺股指凱基99售31,0,0,0,0,0,0,0,0,0,-20000,0,0,0,0,20000,-20000,-20000
07365P,超眾元大99售07  ,0,0,0,0,0,0,0,0,0,-20000,0,0,0,0,20000,-20000,-20000
07290P,台灣50凱基9A售08,0,0,0,0,0,0,0,0,0,-20000,0,0,0,0,20000,-20000,-20000
061831,智邦凱基9B購02  ,0,0,0,0,0,0,0,0,0,-21000,0,0,0,45000,66000,-21000,-21000
062186,晶技元大9B購05  ,0,0,0,0,0,0,0,0,0,-21000,0,0,0,0,21000,-21000,-21000
061561,義隆國票9A購02  ,0,0,0,0,0,0,0,0,0,-21000,0,0,0,48000,69000,-21000,-21000
060303,宏達電富邦9B購01,0,0,0,0,0,0,0,0,0,-21000,0,0,0,0,21000,-21000,-21000
059784,台光電元大9A購01,0,0,0,0,0,0,0,0,0,-21000,0,0,0,76000,97000,-21000,-21000
052152,創意富邦98購01  ,0,0,0,0,0,0,0,0,0,-21000,0,0,0,4000,25000,-21000,-21000
052619,茂林國泰99購01  ,0,0,0,0,0,0,0,0,0,-21000,0,0,0,124000,145000,-21000,-21000
03647C,T50反1元富99牛02,0,0,0,0,0,0,0,0,0,-21000,0,0,0,20000,41000,-21000,-21000
03444B,臺股指元大9C熊02,0,0,0,0,0,0,0,0,0,-21000,0,0,0,0,21000,-21000,-21000
00770,國泰北美科技    ,0,0,0,0,0,0,0,0,0,-21000,0,0,0,36000,57000,-21000,-21000
053754,英業達元富96購02,0,0,0,0,0,0,0,0,0,-21000,0,0,0,83000,104000,-21000,-21000
054311,世芯凱基96購02  ,0,0,0,0,0,0,0,0,0,-21000,0,0,0,95000,116000,-21000,-21000
059041,南茂群益99購02  ,0,0,0,0,0,0,0,0,0,-21000,0,0,0,99000,120000,-21000,-21000
057568,友訊永豐99購01  ,0,0,0,0,0,0,0,0,0,-21000,0,0,0,10000,31000,-21000,-21000
055473,禾伸堂凱基97購01,0,0,0,0,0,0,0,0,0,-21000,0,0,0,10000,31000,-21000,-21000
058182,日電貿國泰9A購01,0,0,0,0,0,0,0,0,0,-21000,0,0,0,202000,223000,-21000,-21000
056457,嘉澤凱基98購01  ,0,0,0,0,0,0,0,0,0,-21000,0,0,0,13000,34000,-21000,-21000
055729,金寶元富99購01  ,0,0,0,0,0,0,0,0,0,-21000,0,0,0,0,21000,-21000,-21000
056821,日電貿永豐98購01,0,0,0,0,0,0,0,0,0,-21000,0,0,0,6000,27000,-21000,-21000
07259P,滬深2X國票01售01,0,0,0,0,0,0,0,0,0,-21000,0,0,0,0,21000,-21000,-21000
07416P,台積電元大99售53,0,0,0,0,0,0,0,0,0,-21000,0,0,0,35000,56000,-21000,-21000
07081P,南電群益9A售01  ,0,0,0,0,0,0,0,0,0,-21000,0,0,0,19000,40000,-21000,-21000
07558P,玉晶光元大9A售10,0,0,0,0,0,0,0,0,0,-21000,0,0,0,0,21000,-21000,-21000
1531,高林股          ,0,21000,-21000,0,0,0,0,0,0,0,0,0,0,0,0,0,-21000
6243,迅杰            ,2000,23000,-21000,0,0,0,0,0,0,0,0,0,0,0,0,0,-21000
9905,大華            ,3000,24000,-21000,0,0,0,0,0,0,0,0,0,0,0,0,0,-21000
4545,銘鈺            ,12000,33000,-21000,0,0,0,0,0,0,0,0,0,0,0,0,0,-21000
4999,鑫禾            ,2000,23000,-21000,0,0,0,0,0,0,0,0,0,0,0,0,0,-21000
5533,皇鼎            ,5000,26000,-21000,0,0,0,0,0,0,0,0,0,0,0,0,0,-21000
060586,玉晶光元富9A購03,0,0,0,0,0,0,0,0,0,-22000,0,0,0,26000,48000,-22000,-22000
06161P,聯發科群益97售03,0,0,0,0,0,0,0,0,0,-22000,0,0,0,0,22000,-22000,-22000
061693,華新科群益9B購02,0,0,0,0,0,0,0,0,0,-22000,0,0,0,0,22000,-22000,-22000
061479,泰碩元大9A購02  ,0,0,0,0,0,0,0,0,0,-22000,0,0,0,6000,28000,-22000,-22000
061333,華通元大9A購08  ,0,0,0,0,0,0,0,0,0,-22000,0,0,0,204000,226000,-22000,-22000
061311,元黃金凱基9A購03,0,0,0,0,0,0,0,0,0,-22000,0,0,0,0,22000,-22000,-22000
06120P,大立光凱基98售05,0,0,0,0,0,0,0,0,0,-22000,0,0,0,0,22000,-22000,-22000
061214,華擎元大9A購04  ,0,0,0,0,0,0,0,0,0,-22000,0,0,0,168000,190000,-22000,-22000
06247P,同欣電元富97售02,0,0,0,0,0,0,0,0,0,-22000,0,0,0,2000,24000,-22000,-22000
055124,建準兆豐97購01  ,0,0,0,0,0,0,0,0,0,-22000,0,0,0,40000,62000,-22000,-22000
059009,世紀鋼元大99購04,0,0,0,0,0,0,0,0,0,-22000,0,0,0,232000,254000,-22000,-22000
058850,華新科群益99購03,0,0,0,0,0,0,0,0,0,-22000,0,0,0,20000,42000,-22000,-22000
053484,國巨國票97購03  ,0,0,0,0,0,0,0,0,0,-22000,0,0,0,0,22000,-22000,-22000
046906,新光金凱基99購02,0,0,0,0,0,0,0,0,0,-22000,0,0,0,0,22000,-22000,-22000
054468,台郡凱基98購01  ,0,0,0,0,0,0,0,0,0,-22000,0,0,0,0,22000,-22000,-22000
055845,大立光元大97購08,0,0,0,0,0,0,0,0,0,-22000,0,0,0,16000,38000,-22000,-22000
057605,旺宏統一99購03  ,0,0,0,0,0,0,0,0,0,-22000,0,0,0,8000,30000,-22000,-22000
05634P,玉晶光台新97售01,0,0,0,0,0,0,0,0,0,-22000,0,0,0,182000,204000,-22000,-22000
057188,佐登元大98購01  ,0,0,0,0,0,0,0,0,0,-22000,0,0,0,24000,46000,-22000,-22000
055893,大立光統一97購07,0,0,0,0,0,0,0,0,0,-22000,0,0,0,0,22000,-22000,-22000
055891,鴻海統一9A購01  ,0,0,0,0,0,0,0,0,0,-22000,0,0,0,5000,27000,-22000,-22000
058408,華通兆豐99購02  ,0,0,0,0,0,0,0,0,0,-22000,0,0,0,60000,82000,-22000,-22000
058295,欣興凱基99購02  ,0,0,0,0,0,0,0,0,0,-22000,0,0,0,209000,231000,-22000,-22000
059219,旺宏元大99購12  ,0,0,0,0,0,0,0,0,0,-22000,0,0,0,6000,28000,-22000,-22000
059368,T50正2元富99購02,0,0,0,0,0,0,0,0,0,-22000,0,0,0,20000,42000,-22000,-22000
059475,元石油群益99購02,0,0,0,0,0,0,0,0,0,-22000,0,0,0,0,22000,-22000,-22000
6196,帆宣            ,303000,309000,-6000,0,0,0,0,0,0,-16000,0,0,0,9000,25000,-16000,-22000
1474,弘裕            ,27000,49000,-22000,0,0,0,0,0,0,0,0,0,0,0,0,0,-22000
2477,美隆電          ,35000,57000,-22000,0,0,0,0,0,0,0,0,0,0,0,0,0,-22000
07046P,大立光富邦9C售03,0,0,0,0,0,0,0,0,0,-22000,0,0,0,0,22000,-22000,-22000
07474P,滬深2X群益9C售03,0,0,0,0,0,0,0,0,0,-22000,0,0,0,0,22000,-22000,-22000
062057,華邦電統一01購01,0,0,0,0,0,0,0,0,0,-23000,0,0,0,0,23000,-23000,-23000
06677P,牧德國票98售02  ,0,0,0,0,0,0,0,0,0,-23000,0,0,0,5000,28000,-23000,-23000
061357,寶成元大9A購01  ,0,0,0,0,0,0,0,0,0,-23000,0,0,0,33000,56000,-23000,-23000
06056P,台積電凱基98售02,0,0,0,0,0,0,0,0,0,-23000,0,0,0,0,23000,-23000,-23000
059872,華新科凱基01購01,0,0,0,0,0,0,0,0,0,-23000,0,0,0,39000,62000,-23000,-23000
051939,同欣電群益97購01,0,0,0,0,0,0,0,0,0,-23000,0,0,0,0,23000,-23000,-23000
052173,廣達元大95購02  ,0,0,0,0,0,0,0,0,0,-23000,0,0,0,0,23000,-23000,-23000
05416P,喬山永豐95售04  ,0,0,0,0,0,0,0,0,0,-23000,0,0,0,0,23000,-23000,-23000
054994,建準元富97購01  ,0,0,0,0,0,0,0,0,0,-23000,0,0,0,40000,63000,-23000,-23000
058748,景碩凱基9A購01  ,0,0,0,0,0,0,0,0,0,-23000,0,0,0,114000,137000,-23000,-23000
055327,致新國票98購01  ,0,0,0,0,0,0,0,0,0,-23000,0,0,0,62000,85000,-23000,-23000
057525,光磊元大99購01  ,0,0,0,0,0,0,0,0,0,-23000,0,0,0,0,23000,-23000,-23000
057740,茂林富邦9A購01  ,0,0,0,0,0,0,0,0,0,-23000,0,0,0,243000,266000,-23000,-23000
057278,可成元大98購06  ,0,0,0,0,0,0,0,0,0,-23000,0,0,0,12000,35000,-23000,-23000
057596,聯茂兆豐99購01  ,0,0,0,0,0,0,0,0,0,-23000,0,0,0,57000,80000,-23000,-23000
1435,中福            ,4000,27000,-23000,0,0,0,0,0,0,0,0,0,0,0,0,0,-23000
1773,勝一            ,19000,42000,-23000,0,0,0,0,0,0,0,0,0,0,0,0,0,-23000
5234,達興材料        ,11000,33000,-22000,0,0,0,0,0,0,-1000,0,1000,-1000,0,0,0,-23000
9912,偉聯            ,0,23000,-23000,0,0,0,0,0,0,0,0,0,0,0,0,0,-23000
6285,啟碁            ,249000,252000,-3000,0,0,0,0,0,0,-20000,5000,2000,3000,0,23000,-23000,-23000
060243,潤泰全元大9C購02,0,0,0,0,0,0,0,0,0,-24000,0,0,0,10000,34000,-24000,-24000
060198,祥碩元富9A購02  ,0,0,0,0,0,0,0,0,0,-24000,0,0,0,0,24000,-24000,-24000
06043P,創意永豐96售06  ,0,0,0,0,0,0,0,0,0,-24000,0,0,0,16000,40000,-24000,-24000
060770,宏達電麥證9A購01,0,0,0,26000,50000,-24000,0,0,0,-24000,0,0,0,26000,50000,-24000,-24000
061656,華新科國票9A購08,0,0,0,0,0,0,0,0,0,-24000,0,0,0,2000,26000,-24000,-24000
061616,鴻海群益9A購07  ,0,0,0,0,0,0,0,0,0,-24000,0,0,0,217000,241000,-24000,-24000
06448P,華通元大99售01  ,0,0,0,0,0,0,0,0,0,-24000,0,0,0,0,24000,-24000,-24000
053609,華新中信9A購01  ,0,0,0,0,0,0,0,0,0,-24000,0,0,0,5000,29000,-24000,-24000
055391,光罩統一97購02  ,0,0,0,0,0,0,0,0,0,-24000,0,0,0,6000,30000,-24000,-24000
058896,中環元大99購03  ,0,0,0,0,0,0,0,0,0,-24000,0,0,0,31000,55000,-24000,-24000
054739,義隆凱基98購02  ,0,0,0,0,0,0,0,0,0,-24000,0,0,0,5000,29000,-24000,-24000
053423,亞光永豐96購01  ,0,0,0,0,0,0,0,0,0,-24000,0,0,0,48000,72000,-24000,-24000
051516,全新凱基96購02  ,0,0,0,0,0,0,0,0,0,-24000,0,0,0,0,24000,-24000,-24000
055780,禾伸堂凱基99購01,0,0,0,0,0,0,0,0,0,-24000,0,0,0,10000,34000,-24000,-24000
057329,緯穎群益98購02  ,0,0,0,0,0,0,0,0,0,-24000,0,0,0,56000,80000,-24000,-24000
056434,國巨凱基98購03  ,0,0,0,0,0,0,0,0,0,-24000,0,0,0,134000,158000,-24000,-24000
8131,福懋科          ,26000,48000,-22000,0,0,0,0,0,0,-2000,0,0,0,9000,11000,-2000,-24000
4141,龍燈-KY         ,6000,30000,-24000,0,0,0,0,0,0,0,0,0,0,0,0,0,-24000
1525,江申            ,2000,1000,1000,0,0,0,0,25000,-25000,0,0,0,0,0,0,0,-24000
07310P,大立光凱基99售12,0,0,0,0,0,0,0,0,0,-24000,0,0,0,126000,150000,-24000,-24000
07103P,南電元大99售04  ,0,0,0,0,0,0,0,0,0,-24000,0,0,0,13000,37000,-24000,-24000
07564P,臺股指中信01售01,0,0,0,0,0,0,0,0,0,-24000,0,0,0,0,24000,-24000,-24000
07618P,大立光中信9A售06,0,0,0,0,0,0,0,0,0,-24000,0,0,0,16000,40000,-24000,-24000
07834P,聯詠群益9A售03  ,0,0,0,0,0,0,0,0,0,-24000,0,0,0,0,24000,-24000,-24000
06833P,矽力群益99售01  ,0,0,0,0,0,0,0,0,0,-25000,0,0,0,0,25000,-25000,-25000
061797,聯發科永豐9B購01,0,0,0,0,0,0,0,0,0,-25000,0,0,0,5000,30000,-25000,-25000
061435,元金2X凱基9C購03,0,0,0,0,0,0,0,0,0,-25000,0,0,0,0,25000,-25000,-25000
060767,世紀鋼元大9A購02,0,0,0,0,0,0,0,0,0,-25000,0,0,0,118000,143000,-25000,-25000
060670,臺指反元大01購03,0,0,0,0,0,0,0,0,0,-25000,0,0,0,0,25000,-25000,-25000
060678,聯詠元大9A購03  ,0,0,0,0,0,0,0,0,0,-25000,0,0,0,29000,54000,-25000,-25000
060898,世芯凱基9A購03  ,0,0,0,0,0,0,0,0,0,-25000,0,0,0,0,25000,-25000,-25000
06037P,超眾國票98售02  ,0,0,0,0,0,0,0,0,0,-25000,0,0,0,0,25000,-25000,-25000
05160P,國巨國票96售03  ,0,0,0,0,0,0,0,0,0,-25000,0,0,0,0,25000,-25000,-25000
053134,南亞科國票97購01,0,0,0,0,0,0,0,0,0,-25000,0,0,0,61000,86000,-25000,-25000
053175,矽力群益96購01  ,0,0,0,0,0,0,0,0,0,-25000,0,0,0,0,25000,-25000,-25000
046928,奇鋐富邦97購01  ,0,0,0,0,0,0,0,0,0,-25000,0,0,0,46000,71000,-25000,-25000
053006,玉晶光永豐96購03,0,0,0,0,0,0,0,0,0,-25000,0,0,0,250000,275000,-25000,-25000
055049,智邦永豐97購01  ,0,0,0,0,0,0,0,0,0,-25000,0,0,0,2000,27000,-25000,-25000
058856,新光金兆豐99購01,0,0,0,0,0,0,0,0,0,-25000,0,0,0,10000,35000,-25000,-25000
055497,開發金元大97購01,0,0,0,0,0,0,0,0,0,-25000,0,0,0,0,25000,-25000,-25000
056426,上証2X凱基9A購01,0,0,0,0,0,0,0,0,0,-25000,0,0,0,5000,30000,-25000,-25000
056454,欣興凱基98購02  ,0,0,0,0,0,0,0,0,0,-25000,0,0,0,1000,26000,-25000,-25000
056900,可成元大98購02  ,0,0,0,0,0,0,0,0,0,-25000,0,0,0,9000,34000,-25000,-25000
056655,旺宏元大99購02  ,0,0,0,0,0,0,0,0,0,-25000,0,0,0,5000,30000,-25000,-25000
056674,華邦電元富98購01,0,0,0,0,0,0,0,0,0,-25000,0,0,0,75000,100000,-25000,-25000
058677,矽格群益99購01  ,0,0,0,0,0,0,0,0,0,-25000,0,0,0,75000,100000,-25000,-25000
057667,可成元大99購01  ,0,0,0,0,0,0,0,0,0,-25000,0,0,0,0,25000,-25000,-25000
058068,旺宏凱基98購11  ,0,0,0,0,0,0,0,0,0,-25000,0,0,0,35000,60000,-25000,-25000
07903P,台積電群益9B售03,0,0,0,0,0,0,0,0,0,-25000,0,0,0,0,25000,-25000,-25000
07764P,世紀鋼永豐9A售04,0,0,0,0,0,0,0,0,0,-25000,0,0,0,0,25000,-25000,-25000
07127P,精元元大99售01  ,0,0,0,0,0,0,0,0,0,-25000,0,0,0,10000,35000,-25000,-25000
07163P,臺股指群益99售14,0,0,0,0,0,0,0,0,0,-25000,0,0,0,9000,34000,-25000,-25000
07385P,緯穎群益99售04  ,0,0,0,0,0,0,0,0,0,-25000,0,0,0,0,25000,-25000,-25000
1338,廣華-KY         ,82000,107000,-25000,0,0,0,0,0,0,0,0,0,0,0,0,0,-25000
2062,橋椿            ,22000,47000,-25000,0,0,0,0,0,0,0,0,0,0,0,0,0,-25000
2450,神腦            ,46000,71000,-25000,0,0,0,0,0,0,0,0,0,0,0,0,0,-25000
3346,麗清            ,66000,91000,-25000,0,0,0,0,0,0,0,0,0,0,0,0,0,-25000
4552,力達-KY         ,3000,28000,-25000,0,0,0,0,0,0,0,0,0,0,0,0,0,-25000
5515,建國            ,11000,36000,-25000,0,0,0,0,0,0,0,0,0,0,0,0,0,-25000
6666,羅麗芬-KY       ,2000,27000,-25000,0,0,0,0,0,0,0,0,0,0,0,0,0,-25000
8341,日友            ,10000,37000,-27000,0,0,0,0,0,0,2000,2000,0,2000,0,0,0,-25000
060046,S&P反1凱基99購02,0,0,0,0,0,0,0,0,0,-26000,0,0,0,0,26000,-26000,-26000
061453,台達電凱基9B購01,0,0,0,0,0,0,0,0,0,-26000,0,0,0,40000,66000,-26000,-26000
061605,華新科凱基9A購14,0,0,0,0,0,0,0,0,0,-26000,0,0,0,85000,111000,-26000,-26000
06670P,鴻海群益98售06  ,0,0,0,0,0,0,0,0,0,-26000,0,0,0,0,26000,-26000,-26000
061827,台灣50凱基02購01,0,0,0,0,0,0,0,0,0,-26000,0,0,0,0,26000,-26000,-26000
061938,大立光國票9B購03,0,0,0,0,0,0,0,0,0,-26000,0,0,0,0,26000,-26000,-26000
053563,台積電富邦97購01,0,0,0,0,0,0,0,0,0,-26000,0,0,0,0,26000,-26000,-26000
053124,聯發科凱基96購12,0,0,0,0,0,0,0,0,0,-26000,0,0,0,31000,57000,-26000,-26000
054525,奇鋐元富96購01  ,0,0,0,0,0,0,0,0,0,-26000,0,0,0,0,26000,-26000,-26000
051561,玉晶光國泰97購04,0,0,0,0,0,0,0,0,0,-26000,0,0,0,694000,720000,-26000,-26000
057235,亞光凱基98購04  ,0,0,0,0,0,0,0,0,0,-26000,0,0,0,0,26000,-26000,-26000
058532,禾伸堂元富99購01,0,0,0,0,0,0,0,0,0,-26000,0,0,0,0,26000,-26000,-26000
057718,旺宏元富02購02  ,0,0,0,0,0,0,0,0,0,-26000,0,0,0,5000,31000,-26000,-26000
058658,瑞儀中信99購01  ,0,0,0,0,0,0,0,0,0,-26000,0,0,0,0,26000,-26000,-26000
057417,國巨凱基9A購03  ,0,0,0,0,0,0,0,0,0,-26000,0,0,0,10000,36000,-26000,-26000
3383,新世紀          ,9000,35000,-26000,0,0,0,0,0,0,0,0,0,0,0,0,0,-26000
2467,志聖            ,53000,79000,-26000,0,0,0,0,0,0,0,0,0,0,0,0,0,-26000
1110,東泥            ,5000,31000,-26000,0,0,0,0,0,0,0,0,0,0,0,0,0,-26000
062009,聯發科國泰01購01,0,0,0,0,0,0,0,0,0,-27000,0,0,0,67000,94000,-27000,-27000
061692,聯發科群益9A購04,0,0,0,0,0,0,0,0,0,-27000,0,0,0,70000,97000,-27000,-27000
060105,牧德元大9B購01  ,0,0,0,0,0,0,0,0,0,-27000,0,0,0,30000,57000,-27000,-27000
060387,盛群凱基9A購01  ,0,0,0,0,0,0,0,0,0,-27000,0,0,0,35000,62000,-27000,-27000
061100,SP黃豆元大9A購04,0,0,0,0,0,0,0,0,0,-27000,0,0,0,43000,70000,-27000,-27000
060687,GIS元大9A購01   ,0,0,0,0,0,0,0,0,0,-27000,0,0,0,173000,200000,-27000,-27000
060629,鴻海富邦9B購01  ,0,0,0,0,0,0,0,0,0,-27000,0,0,0,505000,532000,-27000,-27000
054654,全新麥證99購01  ,0,0,0,0,27000,-27000,0,0,0,-27000,0,0,0,0,27000,-27000,-27000
057289,力成元大98購03  ,0,0,0,0,0,0,0,0,0,-27000,0,0,0,235000,262000,-27000,-27000
056200,大毅永豐98購01  ,0,0,0,0,0,0,0,0,0,-27000,0,0,0,0,27000,-27000,-27000
057785,智邦國票99購02  ,0,0,0,0,0,0,0,0,0,-27000,0,0,0,1000,28000,-27000,-27000
056366,玉晶光元大99購04,0,0,0,0,0,0,0,0,0,-27000,0,0,0,98000,125000,-27000,-27000
058047,可成元大98購11  ,0,0,0,0,0,0,0,0,0,-27000,0,0,0,38000,65000,-27000,-27000
059689,南亞科永豐99購02,0,0,0,0,0,0,0,0,0,-27000,0,0,0,27000,54000,-27000,-27000
2748,雲品            ,3000,5000,-2000,0,0,0,0,25000,-25000,0,0,0,0,0,0,0,-27000
2913,農林            ,205000,228000,-23000,0,0,0,0,0,0,-4000,0,4000,-4000,0,0,0,-27000
4144,康聯-KY         ,6000,33000,-27000,0,0,0,0,0,0,0,0,0,0,0,0,0,-27000
061071,復盛凱基9A購01  ,0,0,0,0,0,0,0,0,0,-28000,0,0,0,172000,200000,-28000,-28000
060936,T50反1國票9A購09,0,0,0,0,0,0,0,0,0,-28000,0,0,0,0,28000,-28000,-28000
060103,聯詠元大99購01  ,0,0,0,0,0,0,0,0,0,-28000,0,0,0,66000,94000,-28000,-28000
061503,臻鼎國票9B購01  ,0,0,0,0,0,0,0,0,0,-28000,0,0,0,16000,44000,-28000,-28000
062091,世紀鋼元大9B購01,0,0,0,0,0,0,0,0,0,-28000,0,0,0,27000,55000,-28000,-28000
051829,玉晶光元大98購02,0,0,0,0,0,0,0,0,0,-28000,0,0,0,2000,30000,-28000,-28000
00672L,元大S&P原油正2  ,0,38000,-38000,0,0,0,0,0,0,10000,0,0,0,90000,80000,10000,-28000
055358,臻鼎凱基97購01  ,0,0,0,0,0,0,0,0,0,-28000,0,0,0,20000,48000,-28000,-28000
059075,FBVIX元大99購01 ,0,0,0,0,0,0,0,0,0,-28000,0,0,0,0,28000,-28000,-28000
055029,帆宣國泰99購01  ,0,0,0,0,0,0,0,0,0,-28000,0,0,0,0,28000,-28000,-28000
055175,建準統一97購01  ,0,0,0,0,0,0,0,0,0,-28000,0,0,0,128000,156000,-28000,-28000
059719,台積電元大99購42,0,0,0,0,0,0,0,0,0,-28000,0,0,0,18000,46000,-28000,-28000
058026,上銀富邦9A購01  ,0,0,0,0,0,0,0,0,0,-28000,0,0,0,70000,98000,-28000,-28000
056023,晶豪科群益97購01,0,0,0,0,0,0,0,0,0,-28000,0,0,0,79000,107000,-28000,-28000
056288,健鼎永豐97購01  ,0,0,0,0,0,0,0,0,0,-28000,0,0,0,145000,173000,-28000,-28000
058630,日月光國票9A購01,0,0,0,0,0,0,0,0,0,-28000,0,0,0,14000,42000,-28000,-28000
055776,宏達電凱基98購02,0,0,0,0,0,0,0,0,0,-28000,0,0,0,20000,48000,-28000,-28000
4916,事欣科          ,16000,44000,-28000,0,0,0,0,0,0,0,0,0,0,0,0,0,-28000
6120,達運            ,170000,198000,-28000,0,0,0,0,0,0,0,0,0,0,0,0,0,-28000
6533,晶心科          ,30000,58000,-28000,0,0,0,0,0,0,0,0,0,0,0,0,0,-28000
2908,特力            ,3000,31000,-28000,0,0,0,0,0,0,0,0,0,0,0,0,0,-28000
07878P,智邦群益9C售01  ,0,0,0,0,0,0,0,0,0,-28000,0,0,0,10000,38000,-28000,-28000
07658P,國泰金凱基9A售01,0,0,0,0,0,0,0,0,0,-28000,0,0,0,0,28000,-28000,-28000
062113,瑞祺國票9B購01  ,0,0,0,0,0,0,0,0,0,-29000,0,0,0,2000,31000,-29000,-29000
061492,超眾兆豐9B購01  ,0,0,0,0,0,0,0,0,0,-29000,0,0,0,31000,60000,-29000,-29000
061683,台灣50群益9B購09,0,0,0,0,0,0,0,0,0,-29000,0,0,0,0,29000,-29000,-29000
059947,貿聯永豐99購03  ,0,0,0,0,0,0,0,0,0,-29000,0,0,0,13000,42000,-29000,-29000
061137,晶技統一9B購01  ,0,0,0,0,0,0,0,0,0,-29000,0,0,0,37000,66000,-29000,-29000
059117,禾伸堂永豐99購01,0,0,0,0,0,0,0,0,0,-29000,0,0,0,1000,30000,-29000,-29000
00752,中信中國50      ,2000,0,2000,0,0,0,0,0,0,-31000,0,0,0,278000,309000,-31000,-29000
056774,和鑫元大98購01  ,0,0,0,0,0,0,0,0,0,-29000,0,0,0,133000,162000,-29000,-29000
056379,玉晶光元富98購01,0,0,0,0,0,0,0,0,0,-29000,0,0,0,0,29000,-29000,-29000
060937,T50反1國票9A購10,0,0,0,0,0,0,0,0,0,-30000,0,0,0,140000,170000,-30000,-30000
060819,國巨統一9C購04  ,0,0,0,0,0,0,0,0,0,-30000,0,0,0,90000,120000,-30000,-30000
060631,微星富邦9B購01  ,0,0,0,0,0,0,0,0,0,-30000,0,0,0,10000,40000,-30000,-30000
060618,玉晶光元大9A購02,0,0,0,0,0,0,0,0,0,-30000,0,0,0,4000,34000,-30000,-30000
060774,南亞科凱基9A購01,0,0,0,0,0,0,0,0,0,-30000,0,0,0,10000,40000,-30000,-30000
059924,世紀鋼元大99購06,0,0,0,0,0,0,0,0,0,-30000,0,0,0,52000,82000,-30000,-30000
06022P,緯穎永豐96售03  ,0,0,0,0,0,0,0,0,0,-30000,0,0,0,0,30000,-30000,-30000
061553,南電群益9A購03  ,0,0,0,0,0,0,0,0,0,-30000,0,0,0,90000,120000,-30000,-30000
061592,義隆永豐9A購03  ,0,0,0,0,0,0,0,0,0,-30000,0,0,0,65000,95000,-30000,-30000
061206,旺宏元大9A購12  ,0,0,0,0,0,0,0,0,0,-30000,0,0,0,17000,47000,-30000,-30000
062177,上銀元大9B購02  ,0,0,0,0,0,0,0,0,0,-30000,0,0,0,0,30000,-30000,-30000
06632P,創意群益98售03  ,0,0,0,0,0,0,0,0,0,-30000,0,0,0,10000,40000,-30000,-30000
06549P,大立光元大98售11,0,0,0,0,0,0,0,0,0,-30000,0,0,0,0,30000,-30000,-30000
06490P,鴻海富邦99售02  ,0,0,0,0,0,0,0,0,0,-30000,0,0,0,0,30000,-30000,-30000
06880P,鈺齊凱基98售03  ,0,0,0,0,0,0,0,0,0,-30000,0,0,0,0,30000,-30000,-30000
04980P,臺股指凱基96售08,0,0,0,0,0,0,0,0,0,-30000,0,0,0,0,30000,-30000,-30000
050169,臺指反元大97購01,0,0,0,0,0,0,0,0,0,-30000,0,0,0,0,30000,-30000,-30000
048751,京鼎元富96購01  ,0,0,0,0,0,0,0,0,0,-30000,0,0,0,0,30000,-30000,-30000
05289P,鴻海永豐95售05  ,0,0,0,0,0,0,0,0,0,-30000,0,0,0,0,30000,-30000,-30000
05163P,聯發科統一96售02,0,0,0,0,0,0,0,0,0,-30000,0,0,0,0,30000,-30000,-30000
054640,健策中信9B購01  ,0,0,0,0,0,0,0,0,0,-30000,0,0,0,0,30000,-30000,-30000
053223,台郡凱基96購02  ,0,0,0,0,0,0,0,0,0,-30000,0,0,0,0,30000,-30000,-30000
052095,彩晶元大97購01  ,0,0,0,0,0,0,0,0,0,-30000,0,0,0,122000,152000,-30000,-30000
051999,勤誠元大95購01  ,0,0,0,0,0,0,0,0,0,-30000,0,0,0,0,30000,-30000,-30000
052515,矽力凱基95購02  ,0,0,0,0,0,0,0,0,0,-30000,0,0,0,10000,40000,-30000,-30000
058782,臺股指國票99購01,0,0,0,0,0,0,0,0,0,-30000,0,0,0,10000,40000,-30000,-30000
058784,臺股指國票99購03,0,0,0,0,0,0,0,0,0,-30000,0,0,0,0,30000,-30000,-30000
058884,世紀鋼永豐99購02,0,0,0,0,0,0,0,0,0,-30000,0,0,0,0,30000,-30000,-30000
055648,可成元富97購01  ,0,0,0,0,0,0,0,0,0,-30000,0,0,0,30000,60000,-30000,-30000
055597,禾伸堂元大98購02,0,0,0,0,0,0,0,0,0,-30000,0,0,0,0,30000,-30000,-30000
055397,超眾統一97購02  ,0,0,0,0,0,0,0,0,0,-30000,0,0,0,30000,60000,-30000,-30000
055435,佳世達中信99購01,0,0,0,0,0,0,0,0,0,-30000,0,0,0,0,30000,-30000,-30000
055460,華擎永豐97購01  ,0,0,0,0,0,0,0,0,0,-30000,0,0,0,30000,60000,-30000,-30000
055481,聚陽元大97購01  ,0,0,0,0,0,0,0,0,0,-30000,0,0,0,0,30000,-30000,-30000
053928,智易國票97購03  ,0,0,0,0,0,0,0,0,0,-30000,0,0,0,23000,53000,-30000,-30000
054332,世芯永豐97購01  ,0,0,0,0,0,0,0,0,0,-30000,0,0,0,0,30000,-30000,-30000
054244,華新元大96購01  ,0,0,0,0,0,0,0,0,0,-30000,0,0,0,38000,68000,-30000,-30000
053999,台表科群益96購06,0,0,0,0,0,0,0,0,0,-30000,0,0,0,98000,128000,-30000,-30000
056395,玉晶光永豐9B購01,0,0,0,0,0,0,0,0,0,-30000,0,0,0,10000,40000,-30000,-30000
057735,台灣50富邦9C購02,0,0,0,0,0,0,0,0,0,-30000,0,0,0,0,30000,-30000,-30000
056197,友訊永豐97購01  ,0,0,0,0,0,0,0,0,0,-30000,0,0,0,0,30000,-30000,-30000
056538,國泰金凱基98購01,0,0,0,0,0,0,0,0,0,-30000,0,0,0,42000,72000,-30000,-30000
056491,南亞科國泰99購01,0,0,0,0,0,0,0,0,0,-30000,0,0,0,0,30000,-30000,-30000
057434,國巨國票99購03  ,0,0,0,0,0,0,0,0,0,-30000,0,0,0,0,30000,-30000,-30000
057442,玉晶光統一98購03,0,0,0,0,0,0,0,0,0,-30000,0,0,0,0,30000,-30000,-30000
057456,道瓊銀富邦9C購01,0,0,0,0,0,0,0,0,0,-30000,0,0,0,0,30000,-30000,-30000
057669,嘉晶元大99購03  ,0,0,0,0,0,0,0,0,0,-30000,0,0,0,50000,80000,-30000,-30000
057665,技嘉元大99購01  ,0,0,0,0,0,0,0,0,0,-30000,0,0,0,63000,93000,-30000,-30000
058517,景碩元大99購06  ,0,0,0,0,0,0,0,0,0,-30000,0,0,0,33000,63000,-30000,-30000
056795,鴻海麥證98購01  ,0,0,0,0,30000,-30000,0,0,0,-30000,0,0,0,0,30000,-30000,-30000
058592,聯發科統一9C購01,0,0,0,0,0,0,0,0,0,-30000,0,0,0,0,30000,-30000,-30000
058481,玉晶光凱基9A購04,0,0,0,0,0,0,0,0,0,-30000,0,0,0,23000,53000,-30000,-30000
056175,可成元富97購03  ,0,0,0,0,0,0,0,0,0,-30000,0,0,0,20000,50000,-30000,-30000
057974,上銀永豐98購02  ,0,0,0,0,0,0,0,0,0,-30000,0,0,0,0,30000,-30000,-30000
058150,中502X統一9B購01,0,0,0,0,0,0,0,0,0,-30000,0,0,0,0,30000,-30000,-30000
05590P,臺股指中信96售05,0,0,0,0,0,0,0,0,0,-30000,0,0,0,24000,54000,-30000,-30000
059420,滬深2X元大99購04,0,0,0,0,0,0,0,0,0,-30000,0,0,0,0,30000,-30000,-30000
059129,麗豐中信99購01  ,0,0,0,0,0,0,0,0,0,-30000,0,0,0,10000,40000,-30000,-30000
059648,台表科凱基99購03,0,0,0,0,0,0,0,0,0,-30000,0,0,0,0,30000,-30000,-30000
059229,臺股指元大99購22,0,0,0,0,0,0,0,0,0,-30000,0,0,0,0,30000,-30000,-30000
07720P,臺股指群益9A售09,0,0,0,0,0,0,0,0,0,-30000,0,0,0,30000,60000,-30000,-30000
07646P,世芯元大9A售04  ,0,0,0,0,0,0,0,0,0,-30000,0,0,0,203000,233000,-30000,-30000
07568P,鴻海凱基9A售22  ,0,0,0,0,0,0,0,0,0,-30000,0,0,0,0,30000,-30000,-30000
07575P,瑞昱元大9A售02  ,0,0,0,0,0,0,0,0,0,-30000,0,0,0,0,30000,-30000,-30000
07527P,台灣50凱基9B售02,0,0,0,0,0,0,0,0,0,-30000,0,0,0,33000,63000,-30000,-30000
07841P,臻鼎元大9A售04  ,0,0,0,0,0,0,0,0,0,-30000,0,0,0,0,30000,-30000,-30000
07373P,A50正2元大99售01,0,0,0,0,0,0,0,0,0,-30000,0,0,0,0,30000,-30000,-30000
07344P,鴻海富邦9A售03  ,0,0,0,0,0,0,0,0,0,-30000,0,0,0,0,30000,-30000,-30000
07520P,臺股指元大9B售11,0,0,0,0,0,0,0,0,0,-30000,0,0,0,0,30000,-30000,-30000
07408P,台積電兆豐99售06,0,0,0,0,0,0,0,0,0,-30000,0,0,0,0,30000,-30000,-30000
07190P,臺股指富邦9C售02,0,0,0,0,0,0,0,0,0,-30000,0,0,0,0,30000,-30000,-30000
07085P,超眾元富9C售01  ,0,0,0,0,0,0,0,0,0,-30000,0,0,0,10000,40000,-30000,-30000
2402,毅嘉            ,115000,145000,-30000,0,0,0,0,0,0,0,0,0,0,0,0,0,-30000
1903,士紙            ,14000,44000,-30000,0,0,0,0,0,0,0,0,0,0,0,0,0,-30000
6715,嘉基            ,8000,43000,-35000,0,0,0,0,0,0,5000,5000,0,5000,0,0,0,-30000
6214,精誠            ,220000,294000,-74000,0,0,0,0,0,0,44000,44000,0,44000,0,0,0,-30000
06701P,臺股指統一99售06,0,0,0,0,0,0,0,0,0,-31000,0,0,0,108000,139000,-31000,-31000
061927,玉晶光凱基9C購01,0,0,0,0,0,0,0,0,0,-31000,0,0,0,60000,91000,-31000,-31000
061478,奇鋐元大9A購01  ,0,0,0,0,0,0,0,0,0,-31000,0,0,0,145000,176000,-31000,-31000
061694,玉山金群益9A購01,0,0,0,0,0,0,0,0,0,-31000,0,0,0,121000,152000,-31000,-31000
061775,臺指反國票9B購04,0,0,0,0,0,0,0,0,0,-31000,0,0,0,0,31000,-31000,-31000
060692,鴻海麥證9A購01  ,0,0,0,19000,50000,-31000,0,0,0,-31000,0,0,0,19000,50000,-31000,-31000
060812,智邦凱基9A購01  ,0,0,0,0,0,0,0,0,0,-31000,0,0,0,12000,43000,-31000,-31000
061124,微星永豐9A購02  ,0,0,0,0,0,0,0,0,0,-31000,0,0,0,19000,50000,-31000,-31000
061056,臺指反國票02購01,0,0,0,0,0,0,0,0,0,-31000,0,0,0,0,31000,-31000,-31000
05283P,健鼎元大95售04  ,0,0,0,0,0,0,0,0,0,-31000,0,0,0,0,31000,-31000,-31000
051745,玉晶光國泰97購06,0,0,0,0,0,0,0,0,0,-31000,0,0,0,329000,360000,-31000,-31000
059570,全新凱基99購04  ,0,0,0,0,0,0,0,0,0,-31000,0,0,0,30000,61000,-31000,-31000
059168,奇力新凱基99購05,0,0,0,0,0,0,0,0,0,-31000,0,0,0,19000,50000,-31000,-31000
056537,冠德凱基98購01  ,0,0,0,0,0,0,0,0,0,-31000,0,0,0,9000,40000,-31000,-31000
4576,大銀微系統      ,8000,39000,-31000,0,0,0,0,0,0,0,0,0,0,0,0,0,-31000
6605,帝寶            ,12000,43000,-31000,0,0,0,0,0,0,0,0,0,0,0,0,0,-31000
2488,漢平            ,5000,36000,-31000,0,0,0,0,0,0,0,0,0,0,0,0,0,-31000
07683P,宏達電凱基9A售03,0,0,0,0,0,0,0,0,0,-31000,0,0,0,258000,289000,-31000,-31000
061431,鈺齊元大9A購01  ,0,0,0,0,0,0,0,0,0,-32000,0,0,0,12000,44000,-32000,-32000
05248P,矽創群益96售01  ,0,0,0,0,0,0,0,0,0,-32000,0,0,0,0,32000,-32000,-32000
054300,華通凱基96購07  ,0,0,0,0,0,0,0,0,0,-32000,0,0,0,0,32000,-32000,-32000
053735,矽力中信97購01  ,0,0,0,0,0,0,0,0,0,-32000,0,0,0,60000,92000,-32000,-32000
053409,和碩兆豐96購02  ,0,0,0,0,0,0,0,0,0,-32000,0,0,0,25000,57000,-32000,-32000
058878,旭富國泰9B購01  ,0,0,0,0,0,0,0,0,0,-32000,0,0,0,28000,60000,-32000,-32000
059053,鴻海凱基99購07  ,0,0,0,0,0,0,0,0,0,-32000,0,0,0,2000,34000,-32000,-32000
056450,可成凱基98購05  ,0,0,0,0,0,0,0,0,0,-32000,0,0,0,10000,42000,-32000,-32000
057413,臺股指群益9C購04,0,0,0,0,0,0,0,0,0,-32000,0,0,0,10000,42000,-32000,-32000
057321,台泥群益98購01  ,0,0,0,0,0,0,0,0,0,-32000,0,0,0,0,32000,-32000,-32000
058614,台郡元大9A購01  ,0,0,0,0,0,0,0,0,0,-32000,0,0,0,71000,103000,-32000,-32000
058570,臻鼎凱基9A購01  ,0,0,0,0,0,0,0,0,0,-32000,0,0,0,20000,52000,-32000,-32000
059250,大立光凱基99購06,0,0,0,0,0,0,0,0,0,-32000,0,0,0,21000,53000,-32000,-32000
058159,健策台新9A購01  ,0,0,0,0,0,0,0,0,0,-32000,0,0,0,15000,47000,-32000,-32000
07583P,台積電富邦9B售05,0,0,0,0,0,0,0,0,0,-32000,0,0,0,27000,59000,-32000,-32000
07627P,超眾凱基9A售02  ,0,0,0,0,0,0,0,0,0,-32000,0,0,0,0,32000,-32000,-32000
2451,創見            ,375000,452000,-77000,0,0,0,90000,0,90000,-45000,0,0,0,0,45000,-45000,-32000
3518,柏騰            ,287000,319000,-32000,0,0,0,0,0,0,0,0,0,0,0,0,0,-32000
1809,中釉            ,23000,55000,-32000,0,0,0,0,0,0,0,0,0,0,0,0,0,-32000
061163,台灣50兆豐9A購04,0,0,0,0,0,0,0,0,0,-33000,0,0,0,0,33000,-33000,-33000
061305,帆宣永豐9A購01  ,0,0,0,0,0,0,0,0,0,-33000,0,0,0,267000,300000,-33000,-33000
061650,南電元大9A購07  ,0,0,0,0,0,0,0,0,0,-33000,0,0,0,466000,499000,-33000,-33000
062109,聯詠國票9C購01  ,0,0,0,0,0,0,0,0,0,-33000,0,0,0,4000,37000,-33000,-33000
06466P,台積電統一9B售01,0,0,0,0,0,0,0,0,0,-33000,0,0,0,0,33000,-33000,-33000
061108,臻鼎元大9A購02  ,0,0,0,0,0,0,0,0,0,-33000,0,0,0,9000,42000,-33000,-33000
06052P,台郡國票97售06  ,0,0,0,0,0,0,0,0,0,-33000,0,0,0,97000,130000,-33000,-33000
059793,滬深2X國票99購03,0,0,0,0,0,0,0,0,0,-33000,0,0,0,5000,38000,-33000,-33000
060127,牧德永豐99購02  ,0,0,0,0,0,0,0,0,0,-33000,0,0,0,205000,238000,-33000,-33000
058411,技嘉兆豐99購01  ,0,0,0,0,0,0,0,0,0,-33000,0,0,0,271000,304000,-33000,-33000
059274,國巨元大99購22  ,0,0,0,0,0,0,0,0,0,-33000,0,0,0,122000,155000,-33000,-33000
058107,全新台新99購01  ,0,0,0,0,0,0,0,0,0,-33000,0,0,0,0,33000,-33000,-33000
059122,超眾永豐99購01  ,0,0,0,0,0,0,0,0,0,-33000,0,0,0,0,33000,-33000,-33000
059190,欣興富邦9A購01  ,0,0,0,0,0,0,0,0,0,-33000,0,0,0,0,33000,-33000,-33000
058569,健策凱基9A購01  ,0,0,0,0,0,0,0,0,0,-33000,0,0,0,30000,63000,-33000,-33000
056212,台光電國票98購03,0,0,0,0,0,0,0,0,0,-33000,0,0,0,41000,74000,-33000,-33000
057826,祥碩元大98購08  ,0,0,0,0,0,0,0,0,0,-33000,0,0,0,10000,43000,-33000,-33000
2204,中華            ,264000,392000,-128000,0,0,0,0,0,0,95000,95000,0,95000,0,0,0,-33000
07319P,台積電凱基01售02,0,0,0,0,0,0,0,0,0,-33000,0,0,0,17000,50000,-33000,-33000
4555,氣立            ,24000,37000,-13000,0,0,0,0,0,0,-20000,0,20000,-20000,0,0,0,-33000
4564,元翎            ,115000,148000,-33000,0,0,0,0,0,0,0,0,0,0,0,0,0,-33000
4952,凌通            ,26000,59000,-33000,0,0,0,0,0,0,0,0,0,0,0,0,0,-33000
060050,鴻海凱基9B購01  ,0,0,0,0,0,0,0,0,0,-34000,0,0,0,80000,114000,-34000,-34000
060699,華新科國泰9B購03,0,0,0,0,0,0,0,0,0,-34000,0,0,0,6000,40000,-34000,-34000
062005,旺宏國泰01購01  ,0,0,0,0,0,0,0,0,0,-34000,0,0,0,0,34000,-34000,-34000
061665,旺宏中信9C購01  ,0,0,0,0,0,0,0,0,0,-34000,0,0,0,36000,70000,-34000,-34000
061771,玉晶光元大9C購04,0,0,0,0,0,0,0,0,0,-34000,0,0,0,200000,234000,-34000,-34000
061546,大立光群益9A購05,0,0,0,0,0,0,0,0,0,-34000,0,0,0,0,34000,-34000,-34000
061287,大立光統一9B購06,0,0,0,0,0,0,0,0,0,-34000,0,0,0,41000,75000,-34000,-34000
054059,欣興國票97購03  ,0,0,0,0,0,0,0,0,0,-34000,0,0,0,62000,96000,-34000,-34000
052062,臺股指國票95購09,0,0,0,0,0,0,0,0,0,-34000,0,0,0,1000,35000,-34000,-34000
054530,台光電國泰97購03,0,0,0,0,0,0,0,0,0,-34000,0,0,0,5000,39000,-34000,-34000
053234,奇鋐永豐96購01  ,0,0,0,0,0,0,0,0,0,-34000,0,0,0,0,34000,-34000,-34000
052936,華通兆豐98購01  ,0,0,0,0,0,0,0,0,0,-34000,0,0,0,0,34000,-34000,-34000
050227,大立光中信96購01,0,0,0,0,0,0,0,0,0,-34000,0,0,0,0,34000,-34000,-34000
057447,智邦元富02購01  ,0,0,0,0,0,0,0,0,0,-34000,0,0,0,26000,60000,-34000,-34000
056741,大立光凱基98購14,0,0,0,0,0,0,0,0,0,-34000,0,0,0,0,34000,-34000,-34000
057135,立積凱基98購01  ,0,0,0,0,0,0,0,0,0,-34000,0,0,0,82000,116000,-34000,-34000
057112,立積群益99購01  ,0,0,0,0,0,0,0,0,0,-34000,0,0,0,64000,98000,-34000,-34000
056157,聯詠凱基97購03  ,0,0,0,0,0,0,0,0,0,-34000,0,0,0,0,34000,-34000,-34000
057252,牧德元富98購01  ,0,0,0,0,0,0,0,0,0,-34000,0,0,0,15000,49000,-34000,-34000
8422,可寧衛          ,117000,151000,-34000,0,0,0,0,0,0,0,0,0,0,0,0,0,-34000
1316,上曜            ,90000,124000,-34000,0,0,0,0,0,0,0,0,0,0,0,0,0,-34000
2607,榮運            ,57000,91000,-34000,0,0,0,0,0,0,0,0,0,0,0,0,0,-34000
061581,貿聯元大9A購05  ,0,0,0,0,0,0,0,0,0,-35000,0,0,0,0,35000,-35000,-35000
061600,聯電凱基9B購01  ,0,0,0,0,0,0,0,0,0,-35000,0,0,0,88000,123000,-35000,-35000
06566P,華通永豐98售03  ,0,0,0,0,0,0,0,0,0,-35000,0,0,0,5000,40000,-35000,-35000
06626P,大立光統一9A售01,0,0,0,0,0,0,0,0,0,-35000,0,0,0,0,35000,-35000,-35000
060756,鴻海元大9A購16  ,0,0,0,0,0,0,0,0,0,-35000,0,0,0,40000,75000,-35000,-35000
06047P,聯發科富邦99售04,0,0,0,0,0,0,0,0,0,-35000,0,0,0,11000,46000,-35000,-35000
060599,國巨凱基9C購01  ,0,0,0,0,0,0,0,0,0,-35000,0,0,0,120000,155000,-35000,-35000
059850,日電貿永豐99購01,0,0,0,0,0,0,0,0,0,-35000,0,0,0,15000,50000,-35000,-35000
060313,淘帝永豐9A購01  ,0,0,0,0,0,0,0,0,0,-35000,0,0,0,50000,85000,-35000,-35000
060226,道瓊反元大9A購01,0,0,0,0,0,0,0,0,0,-35000,0,0,0,19000,54000,-35000,-35000
060143,台積電國票9B購03,0,0,0,0,0,0,0,0,0,-35000,0,0,0,0,35000,-35000,-35000
060338,鴻海統一9C購02  ,0,0,0,0,0,0,0,0,0,-35000,0,0,0,0,35000,-35000,-35000
050561,上証2X元富97購01,0,0,0,0,0,0,0,0,0,-35000,0,0,0,0,35000,-35000,-35000
051047,深中小群益99購01,0,0,0,0,0,0,0,0,0,-35000,0,0,0,0,35000,-35000,-35000
051849,旺宏中信98購01  ,0,0,0,0,0,0,0,0,0,-35000,0,0,0,0,35000,-35000,-35000
058912,祥碩元大99購01  ,0,0,0,0,0,0,0,0,0,-35000,0,0,0,22000,57000,-35000,-35000
055584,國巨元大97購11  ,0,0,0,0,0,0,0,0,0,-35000,0,0,0,2000,37000,-35000,-35000
055054,群光永豐97購01  ,0,0,0,0,0,0,0,0,0,-35000,0,0,0,0,35000,-35000,-35000
057511,健策統一98購02  ,0,0,0,0,0,0,0,0,0,-35000,0,0,0,11000,46000,-35000,-35000
056132,台光電元大97購03,0,0,0,0,0,0,0,0,0,-35000,0,0,0,62000,97000,-35000,-35000
056021,興富發群益97購01,0,0,0,0,0,0,0,0,0,-35000,0,0,0,0,35000,-35000,-35000
059170,康控凱基9B購01  ,0,0,0,0,0,0,0,0,0,-35000,0,0,0,50000,85000,-35000,-35000
059476,道瓊指群益9C購01,0,0,0,0,0,0,0,0,0,-35000,0,0,0,5000,40000,-35000,-35000
057444,台泥元富98購01  ,0,0,0,0,0,0,0,0,0,-35000,0,0,0,5000,40000,-35000,-35000
056459,茂林凱基99購01  ,0,0,0,0,0,0,0,0,0,-35000,0,0,0,72000,107000,-35000,-35000
1437,勤益控          ,8000,43000,-35000,0,0,0,0,0,0,0,0,0,0,0,0,0,-35000
07931P,國巨元大9B售03  ,0,0,0,0,0,0,0,0,0,-35000,0,0,0,0,35000,-35000,-35000
07789P,緯穎群益9A售03  ,0,0,0,0,0,0,0,0,0,-35000,0,0,0,50000,85000,-35000,-35000
07544P,大立光凱基9A售09,0,0,0,0,0,0,0,0,0,-35000,0,0,0,0,35000,-35000,-35000
07460P,臺股指元大9B售03,0,0,0,0,0,0,0,0,0,-35000,0,0,0,0,35000,-35000,-35000
06955P,臻鼎元富99售01  ,0,0,0,0,0,0,0,0,0,-35000,0,0,0,0,35000,-35000,-35000
8249,菱光            ,14000,49000,-35000,0,0,0,0,0,0,0,0,0,0,0,0,0,-35000
9942,茂順            ,13000,48000,-35000,0,0,0,0,0,0,0,0,0,0,0,0,0,-35000
060296,和碩元大9A購01  ,0,0,0,0,0,0,0,0,0,-36000,0,0,0,23000,59000,-36000,-36000
061041,南電永豐9A購03  ,0,0,0,0,0,0,0,0,0,-36000,0,0,0,27000,63000,-36000,-36000
061925,禾伸堂凱基9C購01,0,0,0,0,0,0,0,0,0,-36000,0,0,0,76000,112000,-36000,-36000
061687,大成鋼群益9A購01,0,0,0,0,0,0,0,0,0,-36000,0,0,0,62000,98000,-36000,-36000
061389,華新科群益9B購01,0,0,0,0,0,0,0,0,0,-36000,0,0,0,57000,93000,-36000,-36000
061345,玉晶光元大9A購14,0,0,0,0,0,0,0,0,0,-36000,0,0,0,4000,40000,-36000,-36000
054626,建準凱基98購01  ,0,0,0,0,0,0,0,0,0,-36000,0,0,0,0,36000,-36000,-36000
052020,聯茂永豐95購02  ,0,0,0,0,0,0,0,0,0,-36000,0,0,0,8000,44000,-36000,-36000
056783,國巨群益99購01  ,0,0,0,0,0,0,0,0,0,-36000,0,0,0,172000,208000,-36000,-36000
058657,大立光中信99購01,0,0,0,0,0,0,0,0,0,-36000,0,0,0,0,36000,-36000,-36000
058464,矽創兆豐9A購01  ,0,0,0,0,0,0,0,0,0,-36000,0,0,0,107000,143000,-36000,-36000
059127,國巨中信99購04  ,0,0,0,0,0,0,0,0,0,-36000,0,0,0,45000,81000,-36000,-36000
057123,上銀凱基98購05  ,0,0,0,0,0,0,0,0,0,-36000,0,0,0,0,36000,-36000,-36000
059566,台積電凱基9A購11,0,0,0,0,0,0,0,0,0,-36000,0,0,0,3000,39000,-36000,-36000
06982P,義隆凱基99售02  ,0,0,0,0,0,0,0,0,0,-36000,0,0,0,0,36000,-36000,-36000
07241P,台灣50國票9A售05,0,0,0,0,0,0,0,0,0,-36000,0,0,0,0,36000,-36000,-36000
3050,鈺德            ,14000,50000,-36000,0,0,0,0,0,0,0,0,0,0,0,0,0,-36000
3702,大聯大          ,701000,635715,65285,0,0,0,0,0,0,-102000,6000,0,6000,0,108000,-108000,-36715
06699P,台積電統一98售11,0,0,0,0,0,0,0,0,0,-37000,0,0,0,0,37000,-37000,-37000
060258,T50反1凱基9A購06,0,0,0,0,0,0,0,0,0,-37000,0,0,0,150000,187000,-37000,-37000
060421,華擎永豐9A購01  ,0,0,0,0,0,0,0,0,0,-37000,0,0,0,296000,333000,-37000,-37000
059987,大立光元大99購28,0,0,0,0,0,0,0,0,0,-37000,0,0,0,13000,50000,-37000,-37000
060056,大立光凱基9B購01,0,0,0,0,0,0,0,0,0,-37000,0,0,0,6000,43000,-37000,-37000
058881,全新永豐99購01  ,0,0,0,0,0,0,0,0,0,-37000,0,0,0,0,37000,-37000,-37000
058851,大立光群益99購07,0,0,0,0,0,0,0,0,0,-37000,0,0,0,91000,128000,-37000,-37000
054161,友訊凱基98購01  ,0,0,0,0,0,0,0,0,0,-37000,0,0,0,20000,57000,-37000,-37000
053712,台光電凱基96購04,0,0,0,0,0,0,0,0,0,-37000,0,0,0,10000,47000,-37000,-37000
054947,興勤元大97購01  ,0,0,0,0,0,0,0,0,0,-37000,0,0,0,0,37000,-37000,-37000
058009,智易國票99購01  ,0,0,0,0,0,0,0,0,0,-37000,0,0,0,22000,59000,-37000,-37000
055910,瑞昱凱基98購01  ,0,0,0,0,0,0,0,0,0,-37000,0,0,0,11000,48000,-37000,-37000
057739,新日興富邦9B購01,0,0,0,0,0,0,0,0,0,-37000,0,0,0,233000,270000,-37000,-37000
2612,中航            ,12000,49000,-37000,0,0,0,0,0,0,0,0,0,0,0,0,0,-37000
1460,宏遠            ,632000,669000,-37000,0,0,0,0,0,0,0,0,0,0,0,0,0,-37000
1447,力鵬            ,51000,88230,-37230,0,0,0,0,0,0,0,0,0,0,0,0,0,-37230
00743,國泰中國A150    ,275000,0,275000,0,0,0,0,0,0,-312383,0,0,0,23000,335383,-312383,-37383
060843,大立光國票9A購06,0,0,0,0,0,0,0,0,0,-38000,0,0,0,0,38000,-38000,-38000
060488,台灣50群益9C購01,0,0,0,0,0,0,0,0,0,-38000,0,0,0,0,38000,-38000,-38000
06515P,國巨凱基98售06  ,0,0,0,0,0,0,0,0,0,-38000,0,0,0,17000,55000,-38000,-38000
06453P,群創元大9B售02  ,0,0,0,0,0,0,0,0,0,-38000,0,0,0,0,38000,-38000,-38000
03840P,台積電統一99售02,0,0,0,0,0,0,0,0,0,-38000,0,0,0,0,38000,-38000,-38000
03432B,臺股指凱基98熊13,0,0,0,0,0,0,0,0,0,-38000,0,0,0,0,38000,-38000,-38000
05052P,友達群益97售01  ,0,0,0,0,0,0,0,0,0,-38000,0,0,0,85000,123000,-38000,-38000
051534,景碩國票97購01  ,0,0,0,0,0,0,0,0,0,-38000,0,0,0,0,38000,-38000,-38000
054844,華邦電兆豐98購01,0,0,0,0,0,0,0,0,0,-38000,0,0,0,0,38000,-38000,-38000
058906,晶相光元大99購01,0,0,0,0,0,0,0,0,0,-38000,0,0,0,22000,60000,-38000,-38000
053582,英業達元大97購01,0,0,0,0,0,0,0,0,0,-38000,0,0,0,113000,151000,-38000,-38000
056404,嘉聯益群益9A購01,0,0,0,0,0,0,0,0,0,-38000,0,0,0,307000,345000,-38000,-38000
058557,健策第一01購01  ,0,0,0,0,0,0,0,0,0,-38000,0,0,0,13000,51000,-38000,-38000
2030,彰源            ,6000,44000,-38000,0,0,0,0,0,0,0,0,0,0,0,0,0,-38000
06702P,智邦元富98售01  ,0,0,0,0,0,0,0,0,0,-39000,0,0,0,102000,141000,-39000,-39000
061922,瑞昱凱基9B購01  ,0,0,0,0,0,0,0,0,0,-39000,0,0,0,47000,86000,-39000,-39000
061281,台積電統一9C購05,0,0,0,0,0,0,0,0,0,-39000,0,0,0,6000,45000,-39000,-39000
055287,日電貿元大97購01,0,0,0,0,0,0,0,0,0,-39000,0,0,0,174000,213000,-39000,-39000
054923,晶技凱基98購01  ,0,0,0,0,0,0,0,0,0,-39000,0,0,0,12000,51000,-39000,-39000
054121,奇鋐永豐96購02  ,0,0,0,0,0,0,0,0,0,-39000,0,0,0,37000,76000,-39000,-39000
00735,國泰臺韓科技    ,0,0,0,0,0,0,0,0,0,-39000,0,0,0,186000,225000,-39000,-39000
01001T,土銀富邦R1      ,0,0,0,0,0,0,0,0,0,-39000,0,39000,-39000,0,0,0,-39000
055698,茂林國票98購03  ,0,0,0,0,0,0,0,0,0,-39000,0,0,0,21000,60000,-39000,-39000
056605,台積電富邦9B購02,0,0,0,0,0,0,0,0,0,-39000,0,0,0,0,39000,-39000,-39000
057917,台積電凱基98購17,0,0,0,0,0,0,0,0,0,-39000,0,0,0,10000,49000,-39000,-39000
056126,台郡國票98購02  ,0,0,0,0,0,0,0,0,0,-39000,0,0,0,7000,46000,-39000,-39000
058247,聯茂元大99購04  ,0,0,0,0,0,0,0,0,0,-39000,0,0,0,215000,254000,-39000,-39000
059730,晶相光元大9C購02,0,0,0,0,0,0,0,0,0,-39000,0,0,0,169000,208000,-39000,-39000
2360,致茂            ,424000,444000,-20000,0,0,0,0,0,0,-19000,6000,2000,4000,0,23000,-23000,-39000
1560,中砂            ,37000,80000,-43000,0,0,0,0,0,0,4000,4000,0,4000,0,0,0,-39000
3583,辛耘            ,32000,71000,-39000,0,0,0,0,0,0,0,0,0,0,0,0,0,-39000
4737,華廣            ,2000,41000,-39000,0,0,0,0,0,0,0,0,0,0,0,0,0,-39000
061234,國巨元大9A購18  ,0,0,0,0,0,0,0,0,0,-40000,0,0,0,47000,87000,-40000,-40000
06115P,台積電統一97售04,0,0,0,0,0,0,0,0,0,-40000,0,0,0,0,40000,-40000,-40000
061432,世紀鋼元大9A購05,0,0,0,0,0,0,0,0,0,-40000,0,0,0,77000,117000,-40000,-40000
061631,SP黃豆元大9A購05,0,0,0,0,0,0,0,0,0,-40000,0,0,0,0,40000,-40000,-40000
060609,玉晶光凱基9B購01,0,0,0,0,0,0,0,0,0,-40000,0,0,0,4000,44000,-40000,-40000
06076P,大立光凱基98售03,0,0,0,0,0,0,0,0,0,-40000,0,0,0,0,40000,-40000,-40000
060121,新光金富邦99購01,0,0,0,0,0,0,0,0,0,-40000,0,0,0,5000,45000,-40000,-40000
059901,滬深2X元大9C購07,0,0,0,0,0,0,0,0,0,-40000,0,0,0,16000,56000,-40000,-40000
04938P,亞德客國票95售01,0,0,0,0,0,0,0,0,0,-40000,0,0,0,0,40000,-40000,-40000
052965,廣宇群益97購01  ,0,0,0,0,0,0,0,0,0,-40000,0,0,0,0,40000,-40000,-40000
052104,英業達兆豐96購01,0,0,0,0,0,0,0,0,0,-40000,0,0,0,10000,50000,-40000,-40000
052581,訊芯元富98購01  ,0,0,0,0,0,0,0,0,0,-40000,0,0,0,20000,60000,-40000,-40000
054189,貿聯永豐96購03  ,0,0,0,0,0,0,0,0,0,-40000,0,0,0,0,40000,-40000,-40000
054245,鴻海元大96購23  ,0,0,0,0,0,0,0,0,0,-40000,0,0,0,100000,140000,-40000,-40000
054357,可成兆豐97購02  ,0,0,0,0,0,0,0,0,0,-40000,0,0,0,0,40000,-40000,-40000
054819,裕民元大9A購01  ,0,0,0,0,0,0,0,0,0,-40000,0,0,0,100000,140000,-40000,-40000
055205,京鼎中信99購01  ,0,0,0,0,0,0,0,0,0,-40000,0,0,0,0,40000,-40000,-40000
055349,京元電凱基97購02,0,0,0,0,0,0,0,0,0,-40000,0,0,0,10000,50000,-40000,-40000
055475,臻鼎凱基97購02  ,0,0,0,0,0,0,0,0,0,-40000,0,0,0,0,40000,-40000,-40000
059072,元油2X元大9C購13,0,0,0,0,0,0,0,0,0,-40000,0,0,0,28000,68000,-40000,-40000
059311,元石油元大99購04,0,0,0,0,0,0,0,0,0,-40000,0,0,0,42000,82000,-40000,-40000
059456,智易永豐99購01  ,0,0,0,0,0,0,0,0,0,-40000,0,0,0,47000,87000,-40000,-40000
058339,康友元富99購02  ,0,0,0,0,0,0,0,0,0,-40000,0,0,0,70000,110000,-40000,-40000
057033,A50反1元大9B購02,0,0,0,0,0,0,0,0,0,-40000,0,0,0,0,40000,-40000,-40000
057231,美律凱基98購05  ,0,0,0,0,0,0,0,0,0,-40000,0,0,0,0,40000,-40000,-40000
058177,華新科凱基99購02,0,0,0,0,0,0,0,0,0,-40000,0,0,0,8000,48000,-40000,-40000
055918,和鑫凱基97購01  ,0,0,0,0,0,0,0,0,0,-40000,0,0,0,0,40000,-40000,-40000
05593P,鴻海國票97售03  ,0,0,0,0,0,0,0,0,0,-40000,0,0,0,0,40000,-40000,-40000
057211,鴻海群益98購05  ,0,0,0,0,0,0,0,0,0,-40000,0,0,0,235000,275000,-40000,-40000
056520,鴻海日盛99購01  ,0,0,0,0,0,0,0,0,0,-40000,0,0,0,0,40000,-40000,-40000
056318,鴻海群益98購02  ,0,0,0,0,0,0,0,0,0,-40000,0,0,0,0,40000,-40000,-40000
057320,玉晶光凱基98購01,0,0,0,0,0,0,0,0,0,-40000,0,0,0,3000,43000,-40000,-40000
057371,可成元大98購08  ,0,0,0,0,0,0,0,0,0,-40000,0,0,0,8000,48000,-40000,-40000
057883,中環群益98購01  ,0,0,0,0,0,0,0,0,0,-40000,0,0,0,80000,120000,-40000,-40000
056609,楠梓電永豐98購02,0,0,0,0,0,0,0,0,0,-40000,0,0,0,24000,64000,-40000,-40000
058561,T50反1凱基9A購05,0,0,0,0,0,0,0,0,0,-40000,0,0,0,0,40000,-40000,-40000
058510,全新元大9B購02  ,0,0,0,0,0,0,0,0,0,-40000,0,0,0,10000,50000,-40000,-40000
058734,康友永豐99購01  ,0,0,0,0,0,0,0,0,0,-40000,0,0,0,0,40000,-40000,-40000
9924,福興            ,6000,46000,-40000,0,0,0,0,0,0,0,0,0,0,0,0,0,-40000
1558,伸興            ,11000,51000,-40000,0,0,0,0,0,0,0,0,0,0,0,0,0,-40000
1522,堤維西          ,26000,57000,-31000,0,0,0,0,0,0,-9000,0,0,0,0,9000,-9000,-40000
07216P,大立光凱基99售08,0,0,0,0,0,0,0,0,0,-40000,0,0,0,0,40000,-40000,-40000
07294P,滬深2X元富9C售08,0,0,0,0,0,0,0,0,0,-40000,0,0,0,75000,115000,-40000,-40000
07748P,茂林凱基9A售04  ,0,0,0,0,0,0,0,0,0,-40000,0,0,0,0,40000,-40000,-40000
060001,台灣50群益9A購10,0,0,0,0,0,0,0,0,0,-41000,0,0,0,2000,43000,-41000,-41000
060322,卜蜂群益9A購01  ,0,0,0,0,0,0,0,0,0,-41000,0,0,0,103000,144000,-41000,-41000
060965,中租凱基9B購01  ,0,0,0,0,0,0,0,0,0,-41000,0,0,0,122000,163000,-41000,-41000
061138,晶技統一9C購01  ,0,0,0,0,0,0,0,0,0,-41000,0,0,0,9000,50000,-41000,-41000
061558,旺宏國票9B購02  ,0,0,0,0,0,0,0,0,0,-41000,0,0,0,9000,50000,-41000,-41000
061347,創意元大9A購02  ,0,0,0,0,0,0,0,0,0,-41000,0,0,0,40000,81000,-41000,-41000
062116,元金2X第一9B購01,0,0,0,0,0,0,0,0,0,-41000,0,0,0,0,41000,-41000,-41000
054882,台光電統一97購02,0,0,0,0,0,0,0,0,0,-41000,0,0,0,220000,261000,-41000,-41000
053959,晶豪科永豐96購02,0,0,0,0,0,0,0,0,0,-41000,0,0,0,0,41000,-41000,-41000
03442B,臺股指元大9A熊48,0,0,0,0,0,0,0,0,0,-41000,0,0,0,163000,204000,-41000,-41000
056309,合勤控元大97購01,0,0,0,0,0,0,0,0,0,-41000,0,0,0,0,41000,-41000,-41000
056558,台達電群益98購01,0,0,0,0,0,0,0,0,0,-41000,0,0,0,168000,209000,-41000,-41000
07729P,臺股指凱基9A售21,0,0,0,0,0,0,0,0,0,-41000,0,0,0,8000,49000,-41000,-41000
07608P,台灣50國票9C售03,0,0,0,0,0,0,0,0,0,-41000,0,0,0,0,41000,-41000,-41000
4426,利勤            ,71000,120000,-49000,0,0,0,0,0,0,8000,0,0,0,8000,0,8000,-41000
061447,鴻海中信04購02  ,0,0,0,0,0,0,0,0,0,-42000,0,0,0,3000,45000,-42000,-42000
060742,臺指反國票9B購02,0,0,0,0,0,0,0,0,0,-42000,0,0,0,30000,72000,-42000,-42000
060145,牧德國票9A購02  ,0,0,0,0,0,0,0,0,0,-42000,0,0,0,34000,76000,-42000,-42000
060113,祥碩元大9B購01  ,0,0,0,0,0,0,0,0,0,-42000,0,0,0,0,42000,-42000,-42000
059886,可成國票99購04  ,0,0,0,0,0,0,0,0,0,-42000,0,0,0,33000,75000,-42000,-42000
051985,智邦元大95購05  ,0,0,0,0,0,0,0,0,0,-42000,0,0,0,0,42000,-42000,-42000
055243,國巨統一97購04  ,0,0,0,0,0,0,0,0,0,-42000,0,0,0,0,42000,-42000,-42000
059082,華通元大99購06  ,0,0,0,0,0,0,0,0,0,-42000,0,0,0,58000,100000,-42000,-42000
055117,臻鼎凱基98購02  ,0,0,0,0,0,0,0,0,0,-42000,0,0,0,0,42000,-42000,-42000
056403,茂林群益98購01  ,0,0,0,0,0,0,0,0,0,-42000,0,0,0,56000,98000,-42000,-42000
056895,技嘉元大98購01  ,0,0,0,0,0,0,0,0,0,-42000,0,0,0,45000,87000,-42000,-42000
057335,技嘉國票99購01  ,0,0,0,0,0,0,0,0,0,-42000,0,0,0,0,42000,-42000,-42000
056738,國巨凱基9A購02  ,0,0,0,0,0,0,0,0,0,-42000,0,0,0,13000,55000,-42000,-42000
057073,康控永豐98購01  ,0,0,0,0,0,0,0,0,0,-42000,0,0,0,0,42000,-42000,-42000
058391,T50反1元大99購02,0,0,0,0,0,0,0,0,0,-42000,0,0,0,0,42000,-42000,-42000
055984,大立光元富97購02,0,0,0,0,0,0,0,0,0,-42000,0,0,0,0,42000,-42000,-42000
058104,國巨統一9A購04  ,0,0,0,0,0,0,0,0,0,-42000,0,0,0,0,42000,-42000,-42000
2405,浩鑫            ,45000,87000,-42000,0,0,0,0,0,0,0,0,0,0,0,0,0,-42000
060655,國巨統一9B購06  ,0,0,0,0,0,0,0,0,0,-43000,0,0,0,0,43000,-43000,-43000
060504,技嘉元大9A購02  ,0,0,0,0,0,0,0,0,0,-43000,0,0,0,189000,232000,-43000,-43000
060529,聯發科中信9A購04,0,0,0,0,0,0,0,0,0,-43000,0,0,0,63000,106000,-43000,-43000
06505P,康控國票99售02  ,0,0,0,0,0,0,0,0,0,-43000,0,0,0,10000,53000,-43000,-43000
059118,晶技永豐9A購01  ,0,0,0,0,0,0,0,0,0,-43000,0,0,0,25000,68000,-43000,-43000
058932,FBVIX台新99購01 ,0,0,0,0,0,0,0,0,0,-43000,0,0,0,0,43000,-43000,-43000
05915P,聯發科元大96售19,0,0,0,0,0,0,0,0,0,-43000,0,0,0,0,43000,-43000,-43000
055905,可成兆豐97購03  ,0,0,0,0,0,0,0,0,0,-43000,0,0,0,0,43000,-43000,-43000
058160,奇鋐元富99購01  ,0,0,0,0,0,0,0,0,0,-43000,0,0,0,20000,63000,-43000,-43000
058664,百和兆豐99購01  ,0,0,0,0,0,0,0,0,0,-43000,0,0,0,70000,113000,-43000,-43000
058681,大立光康和9B購01,0,0,0,0,0,0,0,0,0,-43000,0,0,0,0,43000,-43000,-43000
055745,臻鼎元富97購01  ,0,0,0,0,0,0,0,0,0,-43000,0,0,0,151000,194000,-43000,-43000
059024,大立光統一9B購04,0,0,0,0,0,0,0,0,0,-43000,0,0,0,18000,61000,-43000,-43000
05649P,矽創國票97售03  ,0,0,0,0,0,0,0,0,0,-43000,0,0,0,4000,47000,-43000,-43000
1225,福懋油          ,11000,54000,-43000,0,0,0,0,0,0,0,0,0,0,0,0,0,-43000
5608,四維航          ,48000,91000,-43000,0,0,0,0,0,0,0,0,0,0,0,0,0,-43000
061392,泰鼎群益9A購02  ,0,0,0,0,0,0,0,0,0,-44000,0,0,0,173000,217000,-44000,-44000
061358,世紀鋼元大9A購04,0,0,0,0,0,0,0,0,0,-44000,0,0,0,26000,70000,-44000,-44000
061201,FBVIX元大01購03 ,0,0,0,0,0,0,0,0,0,-44000,0,0,0,0,44000,-44000,-44000
061292,玉晶光統一01購06,0,0,0,0,0,0,0,0,0,-44000,0,0,0,208000,252000,-44000,-44000
060048,元金2X凱基99購03,0,0,0,0,0,0,0,0,0,-44000,0,0,0,10000,54000,-44000,-44000
060221,大立光凱基9A購07,0,0,0,0,0,0,0,0,0,-44000,0,0,0,30000,74000,-44000,-44000
055085,大毅國票97購01  ,0,0,0,0,0,0,0,0,0,-44000,0,0,0,0,44000,-44000,-44000
05521P,創意永豐96售01  ,0,0,0,0,0,0,0,0,0,-44000,0,0,0,41000,85000,-44000,-44000
051641,矽創國票96購01  ,0,0,0,0,0,0,0,0,0,-44000,0,0,0,0,44000,-44000,-44000
056777,矽力元大98購02  ,0,0,0,0,0,0,0,0,0,-44000,0,0,0,35000,79000,-44000,-44000
058272,超眾永豐9A購01  ,0,0,0,0,0,0,0,0,0,-44000,0,0,0,31000,75000,-44000,-44000
2023,燁輝            ,268000,312000,-44000,0,0,0,0,0,0,0,0,0,0,0,0,0,-44000
1722,台肥            ,1144000,1197000,-53000,0,0,0,0,0,0,9000,12000,0,12000,0,3000,-3000,-44000
060324,台積電群益9B購02,0,0,0,0,0,0,0,0,0,-45000,0,0,0,35000,80000,-45000,-45000
060732,玉晶光群益9C購02,0,0,0,0,0,0,0,0,0,-45000,0,0,0,110000,155000,-45000,-45000
060800,華新科第一9A購01,0,0,0,0,0,0,0,0,0,-45000,0,0,0,30000,75000,-45000,-45000
061573,義隆元大9A購02  ,0,0,0,0,0,0,0,0,0,-45000,0,0,0,13000,58000,-45000,-45000
061776,晶技國票9B購01  ,0,0,0,0,0,0,0,0,0,-45000,0,0,0,10000,55000,-45000,-45000
061747,南亞科統一01購01,0,0,0,0,0,0,0,0,0,-45000,0,0,0,40000,85000,-45000,-45000
06434P,超眾群益98售02  ,0,0,0,0,0,0,0,0,0,-45000,0,0,0,44000,89000,-45000,-45000
062084,台郡元大9B購04  ,0,0,0,0,0,0,0,0,0,-45000,0,0,0,65000,110000,-45000,-45000
062060,奇鋐統一9C購01  ,0,0,0,0,0,0,0,0,0,-45000,0,0,0,0,45000,-45000,-45000
051603,深中小群益99購03,0,0,0,0,0,0,0,0,0,-45000,0,0,0,0,45000,-45000,-45000
053892,景碩群益96購02  ,0,0,0,0,0,0,0,0,0,-45000,0,0,0,0,45000,-45000,-45000
055312,台虹群益99購01  ,0,0,0,0,0,0,0,0,0,-45000,0,0,0,88000,133000,-45000,-45000
057931,正崴群益98購02  ,0,0,0,0,0,0,0,0,0,-45000,0,0,0,3000,48000,-45000,-45000
058062,上銀中信98購01  ,0,0,0,0,0,0,0,0,0,-45000,0,0,0,0,45000,-45000,-45000
057081,大立光統一98購07,0,0,0,0,0,0,0,0,0,-45000,0,0,0,10000,55000,-45000,-45000
059308,T50反1元大99購07,0,0,0,0,0,0,0,0,0,-45000,0,0,0,15000,60000,-45000,-45000
057644,奇力新元大98購04,0,0,0,0,0,0,0,0,0,-45000,0,0,0,0,45000,-45000,-45000
057569,光磊永豐98購03  ,0,0,0,0,0,0,0,0,0,-45000,0,0,0,1000,46000,-45000,-45000
056471,台光電元大99購01,0,0,0,0,0,0,0,0,0,-45000,0,0,0,33000,78000,-45000,-45000
056281,深中小永豐97購01,0,0,0,0,0,0,0,0,0,-45000,0,0,0,86000,131000,-45000,-45000
057322,旺宏群益98購04  ,0,0,0,0,0,0,0,0,0,-45000,0,0,0,0,45000,-45000,-45000
057435,旺宏國票99購04  ,0,0,0,0,0,0,0,0,0,-45000,0,0,0,0,45000,-45000,-45000
07823P,國巨元大9A售23  ,0,0,0,0,0,0,0,0,0,-45000,0,0,0,28000,73000,-45000,-45000
07557P,玉晶光元大9A售09,0,0,0,0,0,0,0,0,0,-45000,0,0,0,5000,50000,-45000,-45000
07248P,可成凱基99售06  ,0,0,0,0,0,0,0,0,0,-45000,0,0,0,0,45000,-45000,-45000
062046,矽格凱基9B購01  ,0,0,0,0,0,0,0,0,0,-46000,0,0,0,0,46000,-46000,-46000
061508,南六國泰9C購02  ,0,0,0,0,0,0,0,0,0,-46000,0,0,0,94000,140000,-46000,-46000
061443,大立光統一9C購02,0,0,0,0,0,0,0,0,0,-46000,0,0,0,5000,51000,-46000,-46000
060806,華新科群益9A購03,0,0,0,0,0,0,0,0,0,-46000,0,0,0,5000,51000,-46000,-46000
060981,旺宏元大9A購08  ,0,0,0,0,0,0,0,0,0,-46000,0,0,0,14000,60000,-46000,-46000
060317,台灣50群益02購01,0,0,0,0,0,0,0,0,0,-46000,0,0,0,1000,47000,-46000,-46000
060196,泰鼎元富9A購01  ,0,0,0,0,0,0,0,0,0,-46000,0,0,0,22000,68000,-46000,-46000
055014,達興元富97購01  ,0,0,0,0,0,0,0,0,0,-46000,0,0,0,48000,94000,-46000,-46000
052230,大立光凱基96購09,0,0,0,0,0,0,0,0,0,-46000,0,0,0,0,46000,-46000,-46000
057367,技嘉元大98購02  ,0,0,0,0,0,0,0,0,0,-46000,0,0,0,36000,82000,-46000,-46000
056552,台表科凱基99購01,0,0,0,0,0,0,0,0,0,-46000,0,0,0,9000,55000,-46000,-46000
058456,京鼎永豐99購01  ,0,0,0,0,0,0,0,0,0,-46000,0,0,0,107000,153000,-46000,-46000
059124,台積電第一03購01,0,0,0,0,0,0,0,0,0,-46000,0,0,0,4000,50000,-46000,-46000
058226,世芯元富99購01  ,0,0,0,0,0,0,0,0,0,-46000,0,0,0,6000,52000,-46000,-46000
056146,台虹元大98購01  ,0,0,0,0,0,0,0,0,0,-46000,0,0,0,203000,249000,-46000,-46000
07910P,台積電統一9C售07,0,0,0,0,0,0,0,0,0,-46000,0,0,0,2000,48000,-46000,-46000
2495,普安            ,16000,62000,-46000,0,0,0,0,0,0,0,0,0,0,0,0,0,-46000
2428,興勤            ,27000,75668,-48668,0,0,0,0,0,0,2000,0,0,0,2000,0,2000,-46668
059951,台塑康和99購01  ,0,0,0,0,0,0,0,0,0,-47000,0,0,0,36000,83000,-47000,-47000
061036,晶技永豐9A購03  ,0,0,0,0,0,0,0,0,0,-47000,0,0,0,23000,70000,-47000,-47000
061291,玉晶光統一01購05,0,0,0,0,0,0,0,0,0,-47000,0,0,0,39000,86000,-47000,-47000
061912,台積電中信05購05,0,0,0,0,0,0,0,0,0,-47000,0,0,0,3000,50000,-47000,-47000
05310P,智原永豐95售04  ,0,0,0,0,0,0,0,0,0,-47000,0,0,0,0,47000,-47000,-47000
05908P,大立光元富96售05,0,0,0,0,0,0,0,0,0,-47000,0,0,0,0,47000,-47000,-47000
058381,元石油中信9C購01,0,0,0,0,0,0,0,0,0,-47000,0,0,0,0,47000,-47000,-47000
059349,台郡凱基99購04  ,0,0,0,0,0,0,0,0,0,-47000,0,0,0,20000,67000,-47000,-47000
2534,宏盛            ,586000,633000,-47000,0,0,0,0,0,0,0,0,0,0,0,0,0,-47000
07445P,大立光凱基9A售08,0,0,0,0,0,0,0,0,0,-47000,0,0,0,3000,50000,-47000,-47000
5531,鄉林            ,60000,107000,-47000,0,0,0,0,0,0,0,0,0,0,0,0,0,-47000
4551,智伸科          ,157000,345000,-188000,0,0,0,0,0,0,141000,134000,3000,131000,27000,17000,10000,-47000
062071,華通元大9B購02  ,0,0,0,0,0,0,0,0,0,-48000,0,0,0,90000,138000,-48000,-48000
060724,台灣50第一9A購02,0,0,0,0,0,0,0,0,0,-48000,0,0,0,0,48000,-48000,-48000
060044,大立光群益99購09,0,0,0,0,0,0,0,0,0,-48000,0,0,0,4000,52000,-48000,-48000
058965,祥碩兆豐99購02  ,0,0,0,0,0,0,0,0,0,-48000,0,0,0,10000,58000,-48000,-48000
058931,玉晶光統一9C購01,0,0,0,0,0,0,0,0,0,-48000,0,0,0,307000,355000,-48000,-48000
055323,貿聯國票98購01  ,0,0,0,0,0,0,0,0,0,-48000,0,0,0,0,48000,-48000,-48000
055579,健策統一9A購01  ,0,0,0,0,0,0,0,0,0,-48000,0,0,0,88000,136000,-48000,-48000
055557,華新科凱基97購01,0,0,0,0,0,0,0,0,0,-48000,0,0,0,0,48000,-48000,-48000
054339,聯詠統一96購02  ,0,0,0,0,0,0,0,0,0,-48000,0,0,0,0,48000,-48000,-48000
052369,矽力國票96購02  ,0,0,0,0,0,0,0,0,0,-48000,0,0,0,39000,87000,-48000,-48000
05272P,臻鼎中信97售03  ,0,0,0,0,0,0,0,0,0,-48000,0,0,0,0,48000,-48000,-48000
059224,大立光元大99購15,0,0,0,0,0,0,0,0,0,-48000,0,0,0,39000,87000,-48000,-48000
059197,可成永豐99購02  ,0,0,0,0,0,0,0,0,0,-48000,0,0,0,4000,52000,-48000,-48000
057346,鴻海統一98購13  ,0,0,0,0,0,0,0,0,0,-48000,0,0,0,3000,51000,-48000,-48000
5243,乙盛-KY         ,45000,93000,-48000,0,0,0,0,0,0,0,0,0,0,0,0,0,-48000
6191,精成科          ,89000,137000,-48000,0,0,0,0,0,0,0,0,0,0,0,0,0,-48000
07406P,大立光凱基99售18,0,0,0,0,0,0,0,0,0,-48000,0,0,0,0,48000,-48000,-48000
07612P,國巨國泰9B售06  ,0,0,0,0,0,0,0,0,0,-48000,0,0,0,37000,85000,-48000,-48000
059860,台積電群益9A購02,0,0,0,0,0,0,0,0,0,-49000,0,0,0,71000,120000,-49000,-49000
060381,元黃金凱基9A購01,0,0,0,0,0,0,0,0,0,-49000,0,0,0,31000,80000,-49000,-49000
06645P,上銀元大98售05  ,0,0,0,0,0,0,0,0,0,-49000,0,0,0,21000,70000,-49000,-49000
061318,智邦凱基9B購01  ,0,0,0,0,0,0,0,0,0,-49000,0,0,0,38000,87000,-49000,-49000
061651,世紀鋼元大9C購02,0,0,0,0,0,0,0,0,0,-49000,0,0,0,1000,50000,-49000,-49000
053958,京元電永豐96購01,0,0,0,0,0,0,0,0,0,-49000,0,0,0,0,49000,-49000,-49000
055352,奇力新凱基97購01,0,0,0,0,0,0,0,0,0,-49000,0,0,0,0,49000,-49000,-49000
058743,可成康和99購01  ,0,0,0,0,0,0,0,0,0,-49000,0,0,0,3000,52000,-49000,-49000
057837,康控國泰99購02  ,0,0,0,0,0,0,0,0,0,-49000,0,0,0,0,49000,-49000,-49000
057743,華擎永豐98購03  ,0,0,0,0,0,0,0,0,0,-49000,0,0,0,30000,79000,-49000,-49000
059029,旺宏兆豐99購01  ,0,0,0,0,0,0,0,0,0,-49000,0,0,0,10000,59000,-49000,-49000
055741,健策元富97購01  ,0,0,0,0,0,0,0,0,0,-49000,0,0,0,4000,53000,-49000,-49000
056673,中石化元富9B購01,0,0,0,0,0,0,0,0,0,-49000,0,0,0,10000,59000,-49000,-49000
056771,嘉晶元大99購01  ,0,0,0,0,0,0,0,0,0,-49000,0,0,0,11000,60000,-49000,-49000
058684,健策凱基99購02  ,0,0,0,0,0,0,0,0,0,-49000,0,0,0,25000,74000,-49000,-49000
059369,滬深2X元富9C購01,0,0,0,0,0,0,0,0,0,-49000,0,0,0,320000,369000,-49000,-49000
059488,大立光兆豐99購03,0,0,0,0,0,0,0,0,0,-49000,0,0,0,2000,51000,-49000,-49000
058424,滬深2X元富99購04,0,0,0,0,0,0,0,0,0,-49000,0,0,0,15000,64000,-49000,-49000
056127,致新國票98購02  ,0,0,0,0,0,0,0,0,0,-49000,0,0,0,104000,153000,-49000,-49000
057915,台泥凱基98購01  ,0,0,0,0,0,0,0,0,0,-49000,0,0,0,81000,130000,-49000,-49000
061549,泰碩群益9A購01  ,0,0,0,0,0,0,0,0,0,-50000,0,0,0,7000,57000,-50000,-50000
061587,美律富邦9A購02  ,0,0,0,0,0,0,0,0,0,-50000,0,0,0,0,50000,-50000,-50000
061352,茂林元大9A購04  ,0,0,0,0,0,0,0,0,0,-50000,0,0,0,16000,66000,-50000,-50000
061310,華新科麥證9A購01,0,0,0,0,50000,-50000,0,0,0,-50000,0,0,0,0,50000,-50000,-50000
061220,臺股指元大9A購57,0,0,0,0,0,0,0,0,0,-50000,0,0,0,0,50000,-50000,-50000
06236P,台積電元大97售25,0,0,0,0,0,0,0,0,0,-50000,0,0,0,30000,80000,-50000,-50000
061992,祥碩元大9B購02  ,0,0,0,0,0,0,0,0,0,-50000,0,0,0,0,50000,-50000,-50000
059869,友達凱基99購07  ,0,0,0,0,0,0,0,0,0,-50000,0,0,0,3000,53000,-50000,-50000
060510,大立光元大9A購03,0,0,0,0,0,0,0,0,0,-50000,0,0,0,0,50000,-50000,-50000
060487,盛群富邦9B購01  ,0,0,0,0,0,0,0,0,0,-50000,0,0,0,20000,70000,-50000,-50000
060830,T50反1國票9A購07,0,0,0,0,0,0,0,0,0,-50000,0,0,0,0,50000,-50000,-50000
058735,南茂永豐99購01  ,0,0,0,0,0,0,0,0,0,-50000,0,0,0,0,50000,-50000,-50000
058844,元油2X群益9C購03,0,0,0,0,0,0,0,0,0,-50000,0,0,0,0,50000,-50000,-50000
05889P,群創元大98售02  ,0,0,0,0,0,0,0,0,0,-50000,0,0,0,28000,78000,-50000,-50000
055136,聯發科富邦99購06,0,0,0,0,0,0,0,0,0,-50000,0,0,0,102000,152000,-50000,-50000
055518,華新科中信99購01,0,0,0,0,0,0,0,0,0,-50000,0,0,0,0,50000,-50000,-50000
055392,凱美統一97購03  ,0,0,0,0,0,0,0,0,0,-50000,0,0,0,4000,54000,-50000,-50000
054253,宏達電元大97購03,0,0,0,0,0,0,0,0,0,-50000,0,0,0,0,50000,-50000,-50000
054207,國巨國票98購01  ,0,0,0,0,0,0,0,0,0,-50000,0,0,0,0,50000,-50000,-50000
054363,世芯凱基97購01  ,0,0,0,0,0,0,0,0,0,-50000,0,0,0,10000,60000,-50000,-50000
053553,聯詠凱基96購03  ,0,0,0,0,0,0,0,0,0,-50000,0,0,0,0,50000,-50000,-50000
052420,道瓊反國票9B購01,0,0,0,0,0,0,0,0,0,-50000,0,0,0,0,50000,-50000,-50000
052231,景碩凱基96購01  ,0,0,0,0,0,0,0,0,0,-50000,0,0,0,0,50000,-50000,-50000
054625,旺宏凱基98購03  ,0,0,0,0,0,0,0,0,0,-50000,0,0,0,0,50000,-50000,-50000
054484,仁寶台新96購01  ,0,0,0,0,0,0,0,0,0,-50000,0,0,0,38000,88000,-50000,-50000
054446,美食兆豐97購01  ,0,0,0,0,0,0,0,0,0,-50000,0,0,0,0,50000,-50000,-50000
03670C,元油2X元富99牛01,0,0,0,0,0,0,0,0,0,-50000,0,0,0,0,50000,-50000,-50000
02001R,富邦蘋果反一N   ,0,0,0,0,0,0,0,0,0,-50000,0,0,0,10000,60000,-50000,-50000
053036,聯電凱基98購01  ,0,0,0,0,0,0,0,0,0,-50000,0,0,0,0,50000,-50000,-50000
051101,台表科元大96購02,0,0,0,0,0,0,0,0,0,-50000,0,0,0,0,50000,-50000,-50000
052890,FB上証群益9B購01,0,0,0,0,0,0,0,0,0,-50000,0,0,0,0,50000,-50000,-50000
048848,滬深2X群益98購02,0,0,0,0,0,0,0,0,0,-50000,0,0,0,0,50000,-50000,-50000
048422,瑞昱元富96購02  ,0,0,0,0,0,0,0,0,0,-50000,0,0,0,52000,102000,-50000,-50000
057925,貿聯凱基99購01  ,0,0,0,0,0,0,0,0,0,-50000,0,0,0,0,50000,-50000,-50000
058179,國巨國泰9B購02  ,0,0,0,0,0,0,0,0,0,-50000,0,0,0,0,50000,-50000,-50000
056130,新日興麥證97購01,0,0,0,0,50000,-50000,0,0,0,-50000,0,0,0,0,50000,-50000,-50000
056133,可成元大97購05  ,0,0,0,0,0,0,0,0,0,-50000,0,0,0,0,50000,-50000,-50000
059371,聯鈞元富99購02  ,0,0,0,0,0,0,0,0,0,-50000,0,0,0,0,50000,-50000,-50000
05862P,大立光國泰98售01,0,0,0,0,0,0,0,0,0,-50000,0,0,0,5000,55000,-50000,-50000
056794,上銀麥證98購01  ,0,0,0,0,50000,-50000,0,0,0,-50000,0,0,0,0,50000,-50000,-50000
055821,勤誠國票98購01  ,0,0,0,0,0,0,0,0,0,-50000,0,0,0,0,50000,-50000,-50000
058433,台積電統一9B購04,0,0,0,0,0,0,0,0,0,-50000,0,0,0,0,50000,-50000,-50000
056600,聯茂元富98購01  ,0,0,0,0,0,0,0,0,0,-50000,0,0,0,10000,60000,-50000,-50000
057865,富邦金凱基98購01,0,0,0,0,0,0,0,0,0,-50000,0,0,0,18000,68000,-50000,-50000
07684P,大立光凱基9A售11,0,0,0,0,0,0,0,0,0,-50000,0,0,0,0,50000,-50000,-50000
07414P,台積電元大99售51,0,0,0,0,0,0,0,0,0,-50000,0,0,0,0,50000,-50000,-50000
07506P,中租元大9A售01  ,0,0,0,0,0,0,0,0,0,-50000,0,0,0,60000,110000,-50000,-50000
07516P,台積電元大9A售16,0,0,0,0,0,0,0,0,0,-50000,0,0,0,0,50000,-50000,-50000
07146P,瑞昱元大99售02  ,0,0,0,0,0,0,0,0,0,-50000,0,0,0,0,50000,-50000,-50000
07014P,華通元大99售04  ,0,0,0,0,0,0,0,0,0,-50000,0,0,0,8000,58000,-50000,-50000
2476,鉅祥            ,17000,67000,-50000,0,0,0,0,0,0,0,0,0,0,0,0,0,-50000
3209,全科            ,13000,63000,-50000,0,0,0,0,0,0,0,0,0,0,0,0,0,-50000
3031,佰鴻            ,8000,58000,-50000,0,0,0,0,0,0,0,0,0,0,0,0,0,-50000
2423,固緯            ,7000,57000,-50000,0,0,0,0,0,0,0,0,0,0,0,0,0,-50000
2425,承啟            ,81000,131532,-50532,0,0,0,0,0,0,0,0,0,0,0,0,0,-50532
060536,祥碩麥證9A購01  ,0,0,0,0,51000,-51000,0,0,0,-51000,0,0,0,0,51000,-51000,-51000
060765,世芯元大9A購01  ,0,0,0,0,0,0,0,0,0,-51000,0,0,0,25000,76000,-51000,-51000
059849,興勤永豐99購01  ,0,0,0,0,0,0,0,0,0,-51000,0,0,0,0,51000,-51000,-51000
060297,和碩元大9A購02  ,0,0,0,0,0,0,0,0,0,-51000,0,0,0,13000,64000,-51000,-51000
061821,祥碩群益9B購02  ,0,0,0,0,0,0,0,0,0,-51000,0,0,0,33000,84000,-51000,-51000
06750P,聯發科元富02售03,0,0,0,0,0,0,0,0,0,-51000,0,0,0,0,51000,-51000,-51000
06175P,台積電元大97售21,0,0,0,0,0,0,0,0,0,-51000,0,0,0,0,51000,-51000,-51000
058129,國巨元大99購10  ,0,0,0,0,0,0,0,0,0,-51000,0,0,0,80000,131000,-51000,-51000
2034,允強            ,30000,81000,-51000,0,0,0,0,0,0,0,0,0,0,0,0,0,-51000
2836,高雄銀          ,97000,148000,-51000,0,0,0,0,0,0,0,0,0,0,0,0,0,-51000
061229,緯穎中信9B購01  ,0,0,0,0,0,0,0,0,0,-52000,0,0,0,33000,85000,-52000,-52000
060073,台積電元富99購03,0,0,0,0,0,0,0,0,0,-52000,0,0,0,31000,83000,-52000,-52000
03012X,元展12          ,0,0,0,0,0,0,0,0,0,-52000,0,0,0,0,52000,-52000,-52000
059087,台積電元大99購26,0,0,0,0,0,0,0,0,0,-52000,0,0,0,128000,180000,-52000,-52000
055862,矽力元大97購04  ,0,0,0,0,0,0,0,0,0,-52000,0,0,0,22000,74000,-52000,-52000
058372,欣興凱基99購03  ,0,0,0,0,0,0,0,0,0,-52000,0,0,0,10000,62000,-52000,-52000
057841,茂林富邦9A購02  ,0,0,0,0,0,0,0,0,0,-52000,0,0,0,10000,62000,-52000,-52000
057323,智邦群益98購01  ,0,0,0,0,0,0,0,0,0,-52000,0,0,0,0,52000,-52000,-52000
057659,台表科兆豐98購01,0,0,0,0,0,0,0,0,0,-52000,0,0,0,537000,589000,-52000,-52000
1540,喬福            ,8000,60000,-52000,0,0,0,0,0,0,0,0,0,0,0,0,0,-52000
07225P,台積電元大99售33,0,0,0,0,0,0,0,0,0,-52000,0,0,0,18000,70000,-52000,-52000
061139,玉晶光統一9C購02,0,0,0,0,0,0,0,0,0,-53000,0,0,0,10000,63000,-53000,-53000
061322,華新科凱基9A購12,0,0,0,0,0,0,0,0,0,-53000,0,0,0,15000,68000,-53000,-53000
062099,牧德永豐9B購01  ,0,0,0,0,0,0,0,0,0,-53000,0,0,0,1000,54000,-53000,-53000
055256,日電貿統一99購01,0,0,0,0,0,0,0,0,0,-53000,0,0,0,102000,155000,-53000,-53000
050913,全新中信97購01  ,0,0,0,0,0,0,0,0,0,-53000,0,0,0,0,53000,-53000,-53000
051809,義隆凱基96購01  ,0,0,0,0,0,0,0,0,0,-53000,0,0,0,45000,98000,-53000,-53000
055804,祥碩永豐97購02  ,0,0,0,0,0,0,0,0,0,-53000,0,0,0,36000,89000,-53000,-53000
056966,嘉晶永豐98購01  ,0,0,0,0,0,0,0,0,0,-53000,0,0,0,169000,222000,-53000,-53000
059282,嘉聯益永豐99購01,0,0,0,0,0,0,0,0,0,-53000,0,0,0,15000,68000,-53000,-53000
059634,可成凱基99購07  ,0,0,0,0,0,0,0,0,0,-53000,0,0,0,0,53000,-53000,-53000
07351P,鴻海國票99售08  ,0,0,0,0,0,0,0,0,0,-53000,0,0,0,25000,78000,-53000,-53000
1103,嘉泥            ,52000,104000,-52000,0,0,0,0,0,0,-1000,0,1000,-1000,0,0,0,-53000
07843P,緯穎元大9A售05  ,0,0,0,0,0,0,0,0,0,-53000,0,0,0,0,53000,-53000,-53000
1472,三洋紡          ,0,53000,-53000,0,0,0,0,0,0,0,0,0,0,0,0,0,-53000
3356,奇偶            ,17000,70000,-53000,0,0,0,0,0,0,0,0,0,0,0,0,0,-53000
055168,光罩統一98購01  ,0,0,0,0,0,0,0,0,0,-54000,0,0,0,84000,138000,-54000,-54000
052685,技嘉元大96購01  ,0,0,0,0,0,0,0,0,0,-54000,0,0,0,70000,124000,-54000,-54000
052076,可成元富98購01  ,0,0,0,0,0,0,0,0,0,-54000,0,0,0,15000,69000,-54000,-54000
056025,嘉晶群益97購01  ,0,0,0,0,0,0,0,0,0,-54000,0,0,0,29000,83000,-54000,-54000
05724P,致茂永豐96售01  ,0,0,0,0,0,0,0,0,0,-54000,0,0,0,0,54000,-54000,-54000
1702,南僑            ,25000,79000,-54000,0,0,0,0,0,0,0,0,0,0,0,0,0,-54000
07055P,景碩群益9A售02  ,0,0,0,0,0,0,0,0,0,-54000,0,0,0,11000,65000,-54000,-54000
062129,世紀鋼統一02購01,0,0,0,0,0,0,0,0,0,-55000,0,0,0,0,55000,-55000,-55000
06184P,大立光元大97售06,0,0,0,0,0,0,0,0,0,-55000,0,0,0,0,55000,-55000,-55000
061916,元金2X凱基02購01,0,0,0,0,0,0,0,0,0,-55000,0,0,0,0,55000,-55000,-55000
061647,南六元大9A購03  ,0,0,0,0,0,0,0,0,0,-55000,0,0,0,28000,83000,-55000,-55000
061669,崇越中信9A購01  ,0,0,0,0,0,0,0,0,0,-55000,0,0,0,0,55000,-55000,-55000
061126,京元電永豐9A購02,0,0,0,0,0,0,0,0,0,-55000,0,0,0,17000,72000,-55000,-55000
060798,旭富永豐9A購01  ,0,0,0,0,0,0,0,0,0,-55000,0,0,0,34000,89000,-55000,-55000
059188,京元電富邦9B購01,0,0,0,0,0,0,0,0,0,-55000,0,0,0,104000,159000,-55000,-55000
060244,大立光元大9B購02,0,0,0,0,0,0,0,0,0,-55000,0,0,0,119000,174000,-55000,-55000
054502,泰碩永豐96購01  ,0,0,0,0,0,0,0,0,0,-55000,0,0,0,40000,95000,-55000,-55000
055525,國巨群益98購05  ,0,0,0,0,0,0,0,0,0,-55000,0,0,0,62000,117000,-55000,-55000
055612,台光電國票97購04,0,0,0,0,0,0,0,0,0,-55000,0,0,0,0,55000,-55000,-55000
057493,聯詠元大98購02  ,0,0,0,0,0,0,0,0,0,-55000,0,0,0,0,55000,-55000,-55000
057060,緯穎元大98購05  ,0,0,0,0,0,0,0,0,0,-55000,0,0,0,17000,72000,-55000,-55000
056890,國巨元大98購11  ,0,0,0,0,0,0,0,0,0,-55000,0,0,0,129000,184000,-55000,-55000
056473,奇力新元大99購02,0,0,0,0,0,0,0,0,0,-55000,0,0,0,0,55000,-55000,-55000
055762,智伸科群益97購01,0,0,0,0,0,0,0,0,0,-55000,0,0,0,0,55000,-55000,-55000
1340,勝悅-KY         ,13000,68000,-55000,0,0,0,0,0,0,0,0,0,0,0,0,0,-55000
1906,寶隆            ,21000,76000,-55000,0,0,0,0,0,0,0,0,0,0,0,0,0,-55000
055540,京鼎台新97購01  ,0,0,0,0,0,0,0,0,0,-56000,0,0,0,0,56000,-56000,-56000
058801,致伸元大99購01  ,0,0,0,0,0,0,0,0,0,-56000,0,0,0,328000,384000,-56000,-56000
054258,牧德元大97購01  ,0,0,0,0,0,0,0,0,0,-56000,0,0,0,152000,208000,-56000,-56000
050378,上証2X群益98購02,0,0,0,0,0,0,0,0,0,-56000,0,0,0,0,56000,-56000,-56000
056829,台積電富邦9A購01,0,0,0,0,0,0,0,0,0,-56000,0,0,0,0,56000,-56000,-56000
058591,台灣50統一9B購02,0,0,0,0,0,0,0,0,0,-56000,0,0,0,0,56000,-56000,-56000
057279,國揚元大98購01  ,0,0,0,0,0,0,0,0,0,-56000,0,0,0,4000,60000,-56000,-56000
055919,景碩凱基98購02  ,0,0,0,0,0,0,0,0,0,-56000,0,0,0,10000,66000,-56000,-56000
07415P,台積電元大99售52,0,0,0,0,0,0,0,0,0,-56000,0,0,0,1000,57000,-56000,-56000
07442P,華航康和9A售02  ,0,0,0,0,0,0,0,0,0,-56000,0,0,0,13000,69000,-56000,-56000
07826P,台積電富邦9B售07,0,0,0,0,0,0,0,0,0,-56000,0,0,0,0,56000,-56000,-56000
07777P,創意元大9A售03  ,0,0,0,0,0,0,0,0,0,-56000,0,0,0,57000,113000,-56000,-56000
060795,世芯永豐9A購02  ,0,0,0,0,0,0,0,0,0,-57000,0,0,0,66000,123000,-57000,-57000
06254P,臺股指群益97售07,0,0,0,0,0,0,0,0,0,-57000,0,0,0,37000,94000,-57000,-57000
051233,力成群益97購01  ,0,0,0,0,0,0,0,0,0,-57000,0,0,0,0,57000,-57000,-57000
054274,智易中信96購02  ,0,0,0,0,0,0,0,0,0,-57000,0,0,0,38000,95000,-57000,-57000
055252,新光金統一98購02,0,0,0,0,0,0,0,0,0,-57000,0,0,0,0,57000,-57000,-57000
058947,SGBR2X群益9B購02,0,0,0,0,0,0,0,0,0,-57000,0,0,0,158000,215000,-57000,-57000
055472,大立光凱基97購07,0,0,0,0,0,0,0,0,0,-57000,0,0,0,0,57000,-57000,-57000
05783P,嘉澤元富96售01  ,0,0,0,0,0,0,0,0,0,-57000,0,0,0,83000,140000,-57000,-57000
056899,可成元大98購01  ,0,0,0,0,0,0,0,0,0,-57000,0,0,0,1000,58000,-57000,-57000
05627P,致伸國票97售01  ,0,0,0,0,0,0,0,0,0,-57000,0,0,0,0,57000,-57000,-57000
07838P,泰碩元大9A售04  ,0,0,0,0,0,0,0,0,0,-57000,0,0,0,43000,100000,-57000,-57000
07276P,臺股指群益99售19,0,0,0,0,0,0,0,0,0,-57000,0,0,0,53000,110000,-57000,-57000
07026P,超眾凱基99售03  ,0,0,0,0,0,0,0,0,0,-57000,0,0,0,20000,77000,-57000,-57000
062082,嘉晶元大9B購01  ,0,0,0,0,0,0,0,0,0,-58000,0,0,0,21000,79000,-58000,-58000
061428,南六元大9A購01  ,0,0,0,0,0,0,0,0,0,-58000,0,0,0,23000,81000,-58000,-58000
060949,祥碩中信9A購01  ,0,0,0,0,0,0,0,0,0,-58000,0,0,0,14000,72000,-58000,-58000
060929,健策永豐9A購01  ,0,0,0,0,0,0,0,0,0,-58000,0,0,0,6000,64000,-58000,-58000
055533,大立光群益97購03,0,0,0,0,0,0,0,0,0,-58000,0,0,0,0,58000,-58000,-58000
054055,全新國票99購02  ,0,0,0,0,0,0,0,0,0,-58000,0,0,0,0,58000,-58000,-58000
054538,台光電國票98購01,0,0,0,0,0,0,0,0,0,-58000,0,0,0,0,58000,-58000,-58000
057306,玉晶光兆豐99購01,0,0,0,0,0,0,0,0,0,-58000,0,0,0,12000,70000,-58000,-58000
056540,聯詠凱基98購02  ,0,0,0,0,0,0,0,0,0,-58000,0,0,0,2000,60000,-58000,-58000
057696,聯電群益9A購01  ,0,0,0,0,0,0,0,0,0,-58000,0,0,0,0,58000,-58000,-58000
05596P,可成統一96售01  ,0,0,0,0,0,0,0,0,0,-58000,0,0,0,0,58000,-58000,-58000
057177,奇力新元大99購04,0,0,0,0,0,0,0,0,0,-58000,0,0,0,10000,68000,-58000,-58000
057924,健策凱基98購02  ,0,0,0,0,0,0,0,0,0,-58000,0,0,0,0,58000,-58000,-58000
057938,台表科群益98購02,0,0,0,0,0,0,0,0,0,-58000,0,0,0,158000,216000,-58000,-58000
058360,台光電凱基9A購02,0,0,0,0,0,0,0,0,0,-58000,0,0,0,40000,98000,-58000,-58000
07904P,聯發科群益9B售05,0,0,0,0,0,0,0,0,0,-58000,0,0,0,0,58000,-58000,-58000
3686,達能            ,11000,69000,-58000,0,0,0,0,0,0,0,0,0,0,0,0,0,-58000
061077,國巨兆豐9B購01  ,0,0,0,0,0,0,0,0,0,-59000,0,0,0,163000,222000,-59000,-59000
060584,玉晶光元富9A購01,0,0,0,0,0,0,0,0,0,-59000,0,0,0,43000,102000,-59000,-59000
06242P,大立光元富9A售02,0,0,0,0,0,0,0,0,0,-59000,0,0,0,4000,63000,-59000,-59000
061852,大立光國票9B購02,0,0,0,0,0,0,0,0,0,-59000,0,0,0,0,59000,-59000,-59000
052203,T50反1中信99購03,0,0,0,0,0,0,0,0,0,-59000,0,0,0,150000,209000,-59000,-59000
055262,台虹國泰98購01  ,0,0,0,0,0,0,0,0,0,-59000,0,0,0,0,59000,-59000,-59000
055221,矽創凱基97購02  ,0,0,0,0,0,0,0,0,0,-59000,0,0,0,60000,119000,-59000,-59000
056478,晶技元大99購01  ,0,0,0,0,0,0,0,0,0,-59000,0,0,0,10000,69000,-59000,-59000
057352,大立光統一9A購02,0,0,0,0,0,0,0,0,0,-59000,0,0,0,0,59000,-59000,-59000
07349P,大立光凱基99售16,0,0,0,0,0,0,0,0,0,-59000,0,0,0,1000,60000,-59000,-59000
9934,成霖            ,17000,76000,-59000,0,0,0,0,0,0,0,0,0,0,0,0,0,-59000
061949,大立光群益9B購03,0,0,0,0,0,0,0,0,0,-60000,0,0,0,0,60000,-60000,-60000
061290,玉晶光統一01購04,0,0,0,0,0,0,0,0,0,-60000,0,0,0,21000,81000,-60000,-60000
060522,鴻海中信9A購03  ,0,15000,-15000,0,0,0,0,0,0,-45000,0,0,0,100000,145000,-45000,-60000
060502,國巨元大9A購07  ,0,0,0,0,0,0,0,0,0,-60000,0,0,0,0,60000,-60000,-60000
061084,京元電兆豐9A購02,0,0,0,0,0,0,0,0,0,-60000,0,0,0,10000,70000,-60000,-60000
060994,世芯元大9A購03  ,0,0,0,0,0,0,0,0,0,-60000,0,0,0,22000,82000,-60000,-60000
060991,京鼎元大9A購01  ,0,0,0,0,0,0,0,0,0,-60000,0,0,0,108000,168000,-60000,-60000
054742,京鼎凱基99購01  ,0,0,0,0,0,0,0,0,0,-60000,0,0,0,0,60000,-60000,-60000
054075,GIS富邦97購02   ,0,0,0,0,0,0,0,0,0,-60000,0,0,0,0,60000,-60000,-60000
055058,大毅永豐97購01  ,0,0,0,0,0,0,0,0,0,-60000,0,0,0,5000,65000,-60000,-60000
052276,力成群益96購01  ,0,0,0,0,0,0,0,0,0,-60000,0,0,0,0,60000,-60000,-60000
054457,強茂群益96購01  ,0,0,0,0,0,0,0,0,0,-60000,0,0,0,98000,158000,-60000,-60000
046791,台郡統一96購01  ,0,0,0,0,0,0,0,0,0,-60000,0,0,0,0,60000,-60000,-60000
03428B,臺股指凱基97熊18,0,0,0,0,0,0,0,0,0,-60000,0,0,0,0,60000,-60000,-60000
04908P,南電國票95售03  ,0,0,0,0,0,0,0,0,0,-60000,0,0,0,40000,100000,-60000,-60000
056208,崇越永豐97購01  ,0,0,0,0,0,0,0,0,0,-60000,0,0,0,0,60000,-60000,-60000
057778,大立光群益98購02,0,0,0,0,0,0,0,0,0,-60000,0,0,0,0,60000,-60000,-60000
057699,可成群益9A購02  ,0,0,0,0,0,0,0,0,0,-60000,0,0,0,106000,166000,-60000,-60000
058421,國泰金麥證01購01,0,0,0,61000,121000,-60000,0,0,0,-60000,0,0,0,61000,121000,-60000,-60000
056097,訊芯元富97購02  ,0,0,0,0,0,0,0,0,0,-60000,0,0,0,0,60000,-60000,-60000
057001,華邦電國票99購02,0,0,0,0,0,0,0,0,0,-60000,0,0,0,0,60000,-60000,-60000
058178,國巨國泰9A購02  ,0,0,0,0,0,0,0,0,0,-60000,0,0,0,21000,81000,-60000,-60000
058204,世芯凱基9A購01  ,0,0,0,0,0,0,0,0,0,-60000,0,0,0,55000,115000,-60000,-60000
058206,祥碩凱基99購01  ,0,0,0,0,0,0,0,0,0,-60000,0,0,0,28000,88000,-60000,-60000
058212,華新科群益9A購01,0,0,0,0,0,0,0,0,0,-60000,0,0,0,40000,100000,-60000,-60000
057514,華新科元富99購03,0,0,0,0,0,0,0,0,0,-60000,0,0,0,0,60000,-60000,-60000
059755,宏達電國泰9A購01,0,0,0,0,0,0,0,0,0,-60000,0,0,0,5000,65000,-60000,-60000
058021,牧德凱基98購02  ,0,0,0,0,0,0,0,0,0,-60000,0,0,0,151000,211000,-60000,-60000
07023P,南電永豐99售02  ,0,0,0,0,0,0,0,0,0,-60000,0,0,0,0,60000,-60000,-60000
3030,德律            ,48000,108000,-60000,0,0,0,0,0,0,0,0,0,0,0,0,0,-60000
061072,南電凱基9B購01  ,0,0,0,0,0,0,0,0,0,-61000,0,0,0,52000,113000,-61000,-61000
061204,國巨元大9A購16  ,0,0,0,0,0,0,0,0,0,-61000,0,0,0,42000,103000,-61000,-61000
061381,台灣50群益9B購07,0,0,0,0,0,0,0,0,0,-61000,0,0,0,1000,62000,-61000,-61000
061506,瑞祺國票9A購02  ,0,0,0,0,0,0,0,0,0,-61000,0,0,0,152000,213000,-61000,-61000
048236,A50正2國票97購02,0,0,0,0,0,0,0,0,0,-61000,0,0,0,25000,86000,-61000,-61000
051482,玉晶光凱基96購01,0,0,0,0,0,0,0,0,0,-61000,0,0,0,20000,81000,-61000,-61000
054559,台光電群益99購01,0,0,0,0,0,0,0,0,0,-61000,0,0,0,197000,258000,-61000,-61000
055408,力成國泰98購01  ,0,0,0,0,0,0,0,0,0,-61000,0,0,0,0,61000,-61000,-61000
058762,貿聯群益99購03  ,0,0,0,0,0,0,0,0,0,-61000,0,0,0,0,61000,-61000,-61000
053537,玉晶光永豐98購02,0,0,0,0,0,0,0,0,0,-61000,0,0,0,40000,101000,-61000,-61000
057402,嘉晶群益98購02  ,0,0,0,0,0,0,0,0,0,-61000,0,0,0,216000,277000,-61000,-61000
056268,新日興統一97購01,0,0,0,0,0,0,0,0,0,-61000,0,0,0,0,61000,-61000,-61000
2530,華建            ,0,61000,-61000,0,0,0,0,0,0,0,0,0,0,0,0,0,-61000
1592,英瑞-KY         ,18000,79000,-61000,0,0,0,0,0,0,0,0,0,0,0,0,0,-61000
1810,和成            ,12000,73000,-61000,0,0,0,0,0,0,0,0,0,0,0,0,0,-61000
06991P,矽創群益99售01  ,0,0,0,0,0,0,0,0,0,-61000,0,0,0,57000,118000,-61000,-61000
07325P,台積電元大99售41,0,0,0,0,0,0,0,0,0,-61000,0,0,0,0,61000,-61000,-61000
07651P,道瓊指中信01售01,0,0,0,0,0,0,0,0,0,-61000,0,0,0,0,61000,-61000,-61000
061796,興勤永豐9B購01  ,0,0,0,0,0,0,0,0,0,-62000,0,0,0,0,62000,-62000,-62000
06780P,義隆元大98售02  ,0,0,0,0,0,0,0,0,0,-62000,0,0,0,111000,173000,-62000,-62000
060558,億豐凱基9A購01  ,0,0,0,0,0,0,0,0,0,-62000,0,0,0,25000,87000,-62000,-62000
06034P,世芯凱基96售03  ,0,0,0,0,0,0,0,0,0,-62000,0,0,0,10000,72000,-62000,-62000
060466,玉山金元大9A購01,0,0,0,0,0,0,0,0,0,-62000,0,0,0,62000,124000,-62000,-62000
05905P,晶技統一97售01  ,0,0,0,0,0,0,0,0,0,-62000,0,0,0,43000,105000,-62000,-62000
050955,達方群益97購01  ,0,0,0,0,0,0,0,0,0,-62000,0,0,0,8000,70000,-62000,-62000
048499,達運元大96購01  ,0,0,0,0,0,0,0,0,0,-62000,0,0,0,0,62000,-62000,-62000
056428,台達電凱基99購01,0,0,0,0,0,0,0,0,0,-62000,0,0,0,30000,92000,-62000,-62000
1519,華城            ,19000,81000,-62000,0,0,0,0,0,0,0,0,0,0,0,0,0,-62000
2010,春源            ,19000,81000,-62000,0,0,0,0,0,0,0,0,0,0,0,0,0,-62000
2493,揚博            ,145000,207000,-62000,0,0,0,0,0,0,0,0,0,0,0,0,0,-62000
060424,中租永豐9A購01  ,0,0,0,0,0,0,0,0,0,-63000,0,0,0,9000,72000,-63000,-63000
060125,強茂永豐99購01  ,0,0,0,0,0,0,0,0,0,-63000,0,0,0,0,63000,-63000,-63000
06525P,上証2X國泰99售01,0,0,0,0,0,0,0,0,0,-63000,0,0,0,30000,93000,-63000,-63000
061698,智邦國票9A購04  ,0,0,0,0,0,0,0,0,0,-63000,0,0,0,5000,68000,-63000,-63000
061356,南電元大9A購06  ,0,0,0,0,0,0,0,0,0,-63000,0,0,0,38000,101000,-63000,-63000
058861,國巨凱基9A購08  ,0,0,0,0,0,0,0,0,0,-63000,0,0,0,7000,70000,-63000,-63000
055469,台光電凱基97購01,0,0,0,0,0,0,0,0,0,-63000,0,0,0,0,63000,-63000,-63000
055490,台光電元大97購01,0,0,0,0,0,0,0,0,0,-63000,0,0,0,0,63000,-63000,-63000
056939,康控元富98購01  ,0,0,0,0,0,0,0,0,0,-63000,0,0,0,98000,161000,-63000,-63000
057452,新日興元富98購01,0,0,0,0,0,0,0,0,0,-63000,0,0,0,50000,113000,-63000,-63000
059360,全新永豐99購02  ,0,0,0,0,0,0,0,0,0,-63000,0,0,0,9000,72000,-63000,-63000
2390,云辰            ,44000,107000,-63000,0,0,0,0,0,0,0,0,0,0,0,0,0,-63000
07705P,台積電元大9A售26,0,0,0,0,0,0,0,0,0,-63000,0,0,0,0,63000,-63000,-63000
07909P,台積電統一9B售12,0,0,0,0,0,0,0,0,0,-63000,0,0,0,0,63000,-63000,-63000
4164,承業醫          ,38000,103000,-65000,0,0,0,0,0,0,2000,2000,0,2000,0,0,0,-63000
06142P,台虹康和97售02  ,0,0,0,0,0,0,0,0,0,-64000,0,0,0,12000,76000,-64000,-64000
061699,燿華國票9A購01  ,0,0,0,0,0,0,0,0,0,-64000,0,0,0,301000,365000,-64000,-64000
060582,玉晶光群益9C購01,0,0,0,0,0,0,0,0,0,-64000,0,0,0,3000,67000,-64000,-64000
058928,國巨統一9C購01  ,0,0,0,0,0,0,0,0,0,-64000,0,0,0,0,64000,-64000,-64000
05976P,國巨凱基96售14  ,0,0,0,0,0,0,0,0,0,-64000,0,0,0,61000,125000,-64000,-64000
056214,義隆國票99購01  ,0,0,0,0,0,0,0,0,0,-64000,0,0,0,2000,66000,-64000,-64000
056971,麗豐永豐98購01  ,0,0,0,0,0,0,0,0,0,-64000,0,0,0,14000,78000,-64000,-64000
056572,義隆元大99購01  ,0,0,0,0,0,0,0,0,0,-64000,0,0,0,60000,124000,-64000,-64000
057614,華新科元富99購04,0,0,0,0,0,0,0,0,0,-64000,0,0,0,0,64000,-64000,-64000
5258,虹堡            ,78000,137000,-59000,0,0,0,0,0,0,-5000,0,5000,-5000,0,0,0,-64000
07751P,世紀鋼凱基9A售02,0,0,0,0,0,0,0,0,0,-64000,0,0,0,17000,81000,-64000,-64000
07494P,葡萄王元大9A售03,0,0,0,0,0,0,0,0,0,-64000,0,0,0,9000,73000,-64000,-64000
2453,凌群            ,15000,79000,-64000,0,0,0,0,0,0,0,0,0,0,0,0,0,-64000
6670,復盛應用        ,38000,97754,-59754,0,0,0,9000,0,9000,-14000,2000,5000,-3000,0,11000,-11000,-64754
060530,聯發科中信9C購03,0,0,0,0,0,0,0,0,0,-65000,0,0,0,0,65000,-65000,-65000
061117,美律國泰9C購01  ,0,0,0,0,0,0,0,0,0,-65000,0,0,0,53000,118000,-65000,-65000
061013,台積電麥證9A購03,0,0,0,8000,73000,-65000,0,0,0,-65000,0,0,0,8000,73000,-65000,-65000
060932,南六永豐9A購02  ,0,0,0,0,0,0,0,0,0,-65000,0,0,0,222000,287000,-65000,-65000
060464,台積電元大9A購11,0,0,0,0,0,0,0,0,0,-65000,0,0,0,5000,70000,-65000,-65000
061488,奇力新兆豐9A購01,0,0,0,0,0,0,0,0,0,-65000,0,0,0,10000,75000,-65000,-65000
061619,大立光群益9B購01,0,0,0,0,0,0,0,0,0,-65000,0,0,0,0,65000,-65000,-65000
061987,大立光元大9B購03,0,0,0,0,0,0,0,0,0,-65000,0,0,0,35000,100000,-65000,-65000
055659,百和元富97購01  ,0,0,0,0,0,0,0,0,0,-65000,0,0,0,72000,137000,-65000,-65000
054786,全新群益99購02  ,0,0,0,0,0,0,0,0,0,-65000,0,0,0,0,65000,-65000,-65000
054185,喬山永豐96購02  ,0,0,0,0,0,0,0,0,0,-65000,0,0,0,10000,75000,-65000,-65000
053033,智易兆豐97購01  ,0,0,0,0,0,0,0,0,0,-65000,0,0,0,35000,100000,-65000,-65000
052328,台表科中信99購01,0,0,0,0,0,0,0,0,0,-65000,0,0,0,738000,803000,-65000,-65000
052005,矽力國泰97購02  ,0,0,0,0,0,0,0,0,0,-65000,0,0,0,16000,81000,-65000,-65000
055782,新日興凱基99購01,0,0,0,0,0,0,0,0,0,-65000,0,0,0,35000,100000,-65000,-65000
059115,美食永豐99購01  ,0,0,0,0,0,0,0,0,0,-65000,0,0,0,23000,88000,-65000,-65000
057495,牧德元大99購04  ,0,0,0,0,0,0,0,0,0,-65000,0,0,0,101000,166000,-65000,-65000
058250,台虹元大99購01  ,0,0,0,0,0,0,0,0,0,-65000,0,0,0,184000,249000,-65000,-65000
2461,光群雷          ,63000,128000,-65000,0,0,0,0,0,0,0,0,0,0,0,0,0,-65000
3094,聯傑            ,25000,90000,-65000,0,0,0,0,0,0,0,0,0,0,0,0,0,-65000
1582,信錦            ,71000,257000,-186000,0,0,0,0,0,0,121000,130000,2000,128000,0,7000,-7000,-65000
07743P,智邦凱基9A售03  ,0,0,0,0,0,0,0,0,0,-65000,0,0,0,40000,105000,-65000,-65000
062042,台勝科凱基9C購01,0,0,0,0,0,0,0,0,0,-66000,0,0,0,20000,86000,-66000,-66000
059171,祥碩凱基99購04  ,0,0,0,0,0,0,0,0,0,-66000,0,0,0,2000,68000,-66000,-66000
059039,致伸群益99購01  ,0,0,0,0,0,0,0,0,0,-66000,0,0,0,190000,256000,-66000,-66000
058650,台虹永豐9A購01  ,0,0,0,0,0,0,0,0,0,-66000,0,0,0,80000,146000,-66000,-66000
056182,台光電統一97購03,0,0,0,0,0,0,0,0,0,-66000,0,0,0,0,66000,-66000,-66000
058494,可成群益9B購01  ,0,0,0,0,0,0,0,0,0,-66000,0,0,0,11000,77000,-66000,-66000
061166,玉晶光兆豐9B購01,0,0,0,0,0,0,0,0,0,-67000,0,0,0,369000,436000,-67000,-67000
054017,茂林永豐96購02  ,0,0,0,0,0,0,0,0,0,-67000,0,0,0,0,67000,-67000,-67000
07839P,嘉澤元大9A售04  ,0,0,0,0,0,0,0,0,0,-67000,0,0,0,5000,72000,-67000,-67000
07347P,上証2X凱基99售02,0,0,0,0,0,0,0,0,0,-67000,0,0,0,13000,80000,-67000,-67000
3530,晶相光          ,142000,150000,-8000,0,0,0,0,0,0,-59000,0,0,0,0,59000,-59000,-67000
8101,華冠            ,15000,82000,-67000,0,0,0,0,0,0,0,0,0,0,0,0,0,-67000
4989,榮科            ,60000,127000,-67000,0,0,0,0,0,0,0,0,0,0,0,0,0,-67000
4190,佐登-KY         ,87000,236000,-149000,0,0,0,106000,0,106000,-24000,6000,21000,-15000,11000,20000,-9000,-67000
061179,華擎凱基9A購01  ,0,0,0,0,0,0,0,0,0,-68000,0,0,0,0,68000,-68000,-68000
061243,麗豐兆豐9A購01  ,0,0,0,0,0,0,0,0,0,-68000,0,0,0,50000,118000,-68000,-68000
061526,宏達電凱基9A購04,0,0,0,0,0,0,0,0,0,-68000,0,0,0,0,68000,-68000,-68000
061714,華新科凱基9A購15,0,0,0,0,0,0,0,0,0,-68000,0,0,0,0,68000,-68000,-68000
062022,緯穎永豐9B購01  ,0,0,0,0,0,0,0,0,0,-68000,0,0,0,0,68000,-68000,-68000
061840,長榮航凱基9C購01,0,0,0,0,0,0,0,0,0,-68000,0,0,0,12000,80000,-68000,-68000
06914P,南茂元大98售03  ,0,0,0,0,0,0,0,0,0,-68000,0,0,0,82000,150000,-68000,-68000
060926,宏達電永豐9A購01,0,0,0,0,0,0,0,0,0,-68000,0,0,0,0,68000,-68000,-68000
060604,宏達電凱基9B購01,0,0,0,0,0,0,0,0,0,-68000,0,0,0,0,68000,-68000,-68000
060799,茂林永豐9A購01  ,0,0,0,0,0,0,0,0,0,-68000,0,0,0,0,68000,-68000,-68000
060664,聯詠凱基9A購01  ,0,0,0,0,0,0,0,0,0,-68000,0,0,0,0,68000,-68000,-68000
058802,矽創元大99購02  ,0,0,0,0,0,0,0,0,0,-68000,0,0,0,105000,173000,-68000,-68000
058826,台積電永豐99購02,0,0,0,0,0,0,0,0,0,-68000,0,0,0,0,68000,-68000,-68000
053186,健策中信9C購01  ,0,0,0,0,0,0,0,0,0,-68000,0,0,0,100000,168000,-68000,-68000
057631,康控永豐98購02  ,0,0,0,0,0,0,0,0,0,-68000,0,0,0,0,68000,-68000,-68000
055732,全新元富9A購01  ,0,0,0,0,0,0,0,0,0,-68000,0,0,0,32000,100000,-68000,-68000
057744,健策永豐98購02  ,0,0,0,0,0,0,0,0,0,-68000,0,0,0,0,68000,-68000,-68000
1449,佳和            ,76000,144000,-68000,0,0,0,0,0,0,0,0,0,0,0,0,0,-68000
06783P,亞光元大98售03  ,0,0,0,0,0,0,0,0,0,-69000,0,0,0,15000,84000,-69000,-69000
06424P,大成鋼永豐97售01,0,0,0,0,0,0,0,0,0,-69000,0,0,0,0,69000,-69000,-69000
051600,新日興兆豐96購02,0,0,0,0,0,0,0,0,0,-69000,0,0,0,0,69000,-69000,-69000
058774,台郡兆豐9A購01  ,0,0,0,0,0,0,0,0,0,-69000,0,0,0,114000,183000,-69000,-69000
055558,大立光凱基97購08,0,0,0,0,0,0,0,0,0,-69000,0,0,0,0,69000,-69000,-69000
053602,台虹元大96購01  ,0,0,0,0,0,0,0,0,0,-69000,0,0,0,15000,84000,-69000,-69000
054007,貿聯統一96購01  ,0,0,0,0,0,0,0,0,0,-69000,0,0,0,0,69000,-69000,-69000
058051,同欣電元大98購03,0,0,0,0,0,0,0,0,0,-69000,0,0,0,52000,121000,-69000,-69000
05947P,大成鋼元大96售03,0,0,0,0,0,0,0,0,0,-69000,0,0,0,12000,81000,-69000,-69000
059626,台積電凱基01購01,0,0,0,0,0,0,0,0,0,-69000,0,0,0,0,69000,-69000,-69000
058224,世芯統一9B購02  ,0,0,0,0,0,0,0,0,0,-69000,0,0,0,10000,79000,-69000,-69000
061715,牧德凱基9B購03  ,0,0,0,0,0,0,0,0,0,-70000,0,0,0,123000,193000,-70000,-70000
06051P,嘉聯益國票97售04,0,0,0,0,0,0,0,0,0,-70000,0,0,0,0,70000,-70000,-70000
059902,滬深2X元大9C購08,0,0,0,0,0,0,0,0,0,-70000,0,0,0,0,70000,-70000,-70000
060088,國巨元大99購30  ,0,0,0,0,0,0,0,0,0,-70000,0,0,0,0,70000,-70000,-70000
060033,臻鼎永豐99購01  ,0,0,0,0,0,0,0,0,0,-70000,0,0,0,20000,90000,-70000,-70000
054167,揚明光凱基98購01,0,0,0,0,0,0,0,0,0,-70000,0,0,0,0,70000,-70000,-70000
053729,聯茂凱基96購05  ,0,0,0,0,0,0,0,0,0,-70000,0,0,0,0,70000,-70000,-70000
055443,台虹國票98購01  ,0,0,0,0,0,0,0,0,0,-70000,0,0,0,0,70000,-70000,-70000
055413,全新富邦98購01  ,0,0,0,0,0,0,0,0,0,-70000,0,0,0,0,70000,-70000,-70000
05878P,創意群益98售01  ,0,0,0,0,0,0,0,0,0,-70000,0,0,0,71000,141000,-70000,-70000
058997,鴻海元大99購21  ,0,0,0,0,0,0,0,0,0,-70000,0,0,0,13000,83000,-70000,-70000
052849,可成統一97購01  ,0,0,0,0,0,0,0,0,0,-70000,0,0,0,324000,394000,-70000,-70000
053255,貿聯國泰97購01  ,0,0,0,0,0,0,0,0,0,-70000,0,0,0,0,70000,-70000,-70000
054409,亞光國票97購02  ,0,0,0,0,0,0,0,0,0,-70000,0,0,0,0,70000,-70000,-70000
051842,大成鋼富邦97購01,0,0,0,0,0,0,0,0,0,-70000,0,0,0,0,70000,-70000,-70000
048189,臺指反元大96購06,0,0,0,0,0,0,0,0,0,-70000,0,0,0,20000,90000,-70000,-70000
050424,鴻海凱基96購03  ,0,0,0,0,0,0,0,0,0,-70000,0,0,0,5000,75000,-70000,-70000
055875,光罩元富97購02  ,0,0,0,0,0,0,0,0,0,-70000,0,0,0,172000,242000,-70000,-70000
059559,T50反1凱基99購07,0,0,0,0,0,0,0,0,0,-70000,0,0,0,0,70000,-70000,-70000
059297,大立光元富9C購01,0,0,0,0,0,0,0,0,0,-70000,0,0,0,269000,339000,-70000,-70000
057130,全新凱基98購03  ,0,0,0,0,0,0,0,0,0,-70000,0,0,0,0,70000,-70000,-70000
057275,友達元大9A購04  ,0,0,0,0,0,0,0,0,0,-70000,0,0,0,0,70000,-70000,-70000
057639,國巨元大99購07  ,0,0,0,0,0,0,0,0,0,-70000,0,0,0,100000,170000,-70000,-70000
058482,祥碩凱基99購02  ,0,0,0,0,0,0,0,0,0,-70000,0,0,0,110000,180000,-70000,-70000
057707,臺股指群益98購07,0,0,0,0,0,0,0,0,0,-70000,0,0,0,164000,234000,-70000,-70000
07580P,緯穎元大9A售03  ,0,0,0,0,0,0,0,0,0,-70000,0,0,0,0,70000,-70000,-70000
6541,泰福-KY         ,33000,103000,-70000,0,0,0,0,0,0,0,0,0,0,0,0,0,-70000
6525,捷敏-KY         ,6000,76000,-70000,0,0,0,0,0,0,0,0,0,0,0,0,0,-70000
6235,華孚            ,9000,79000,-70000,0,0,0,0,0,0,0,0,0,0,0,0,0,-70000
060290,興富發元大9C購01,0,0,0,0,0,0,0,0,0,-71000,0,0,0,50000,121000,-71000,-71000
06058P,玉晶光凱基97售04,0,0,0,0,0,0,0,0,0,-71000,0,0,0,65000,136000,-71000,-71000
061113,南電元大9A購03  ,0,0,0,0,0,0,0,0,0,-71000,0,0,0,19000,90000,-71000,-71000
061390,大立光群益9A購04,0,0,0,0,0,0,0,0,0,-71000,0,0,0,5000,76000,-71000,-71000
04960P,大立光凱基96售04,0,0,0,0,0,0,0,0,0,-71000,0,0,0,0,71000,-71000,-71000
052888,台表科中信9A購01,0,0,0,0,0,0,0,0,0,-71000,0,0,0,306000,377000,-71000,-71000
058780,牧德國票9A購01  ,8000,0,8000,0,0,0,0,0,0,-79000,0,0,0,67000,146000,-79000,-71000
054216,聯茂國票97購03  ,0,0,0,0,0,0,0,0,0,-71000,0,0,0,6000,77000,-71000,-71000
055725,嘉聯益元大98購03,0,0,0,0,0,0,0,0,0,-71000,0,0,0,74000,145000,-71000,-71000
057465,智易永豐98購02  ,0,0,0,0,0,0,0,0,0,-71000,0,0,0,93000,164000,-71000,-71000
056566,臻鼎群益98購01  ,0,0,0,0,0,0,0,0,0,-71000,0,0,0,50000,121000,-71000,-71000
059740,瑞昱元富99購02  ,0,0,0,0,0,0,0,0,0,-71000,0,0,0,15000,86000,-71000,-71000
061244,和碩兆豐9A購01  ,0,0,0,0,0,0,0,0,0,-72000,0,0,0,214000,286000,-72000,-72000
053481,同欣電元大97購01,0,0,0,0,0,0,0,0,0,-72000,0,0,0,0,72000,-72000,-72000
058788,喬山元大99購01  ,0,0,0,0,0,0,0,0,0,-72000,0,0,0,163000,235000,-72000,-72000
051382,玉晶光群益98購02,0,0,0,0,0,0,0,0,0,-72000,0,0,0,140000,212000,-72000,-72000
05729P,臺股指凱基97售02,0,0,0,0,0,0,0,0,0,-72000,0,0,0,68000,140000,-72000,-72000
058568,宏達電凱基9A購02,0,0,0,0,0,0,0,0,0,-72000,0,0,0,120000,192000,-72000,-72000
07920P,大立光中信01售01,0,0,0,0,0,0,0,0,0,-72000,0,0,0,0,72000,-72000,-72000
06954P,大立光元富99售01,0,0,0,0,0,0,0,0,0,-72000,0,0,0,94000,166000,-72000,-72000
061451,南電中信9A購03  ,0,0,0,0,0,0,0,0,0,-73000,0,0,0,44000,117000,-73000,-73000
06560P,台積電統一98售07,0,0,0,0,0,0,0,0,0,-73000,0,0,0,0,73000,-73000,-73000
06261P,上銀凱基97售03  ,0,0,0,0,0,0,0,0,0,-73000,0,0,0,0,73000,-73000,-73000
062110,華擎國票9B購01  ,0,0,0,0,0,0,0,0,0,-73000,0,0,0,20000,93000,-73000,-73000
060791,聯茂富邦9A購02  ,0,0,0,0,0,0,0,0,0,-73000,0,0,0,425000,498000,-73000,-73000
03648C,T50反1元大96牛07,0,0,0,0,0,0,0,0,0,-73000,0,0,0,29000,102000,-73000,-73000
058831,茂林永豐99購01  ,0,0,0,0,0,0,0,0,0,-73000,0,0,0,199000,272000,-73000,-73000
060886,國巨統一01購03  ,0,0,0,0,0,0,0,0,0,-74000,0,0,0,6000,80000,-74000,-74000
054088,華新群益98購02  ,0,0,0,0,0,0,0,0,0,-74000,0,0,0,0,74000,-74000,-74000
054319,世紀鋼凱基96購02,0,0,0,0,0,0,0,0,0,-74000,0,0,0,26000,100000,-74000,-74000
03433B,臺股指元大9C熊01,0,0,0,0,0,0,0,0,0,-74000,0,0,0,155000,229000,-74000,-74000
058505,台積電元大99購08,0,0,0,0,0,0,0,0,0,-74000,0,0,0,30000,104000,-74000,-74000
055916,奇鋐凱基99購01  ,0,0,0,0,0,0,0,0,0,-74000,0,0,0,229000,303000,-74000,-74000
07039P,南電台新99售01  ,0,0,0,0,0,0,0,0,0,-74000,0,0,0,10000,84000,-74000,-74000
07807P,聯茂永豐9A售02  ,0,0,0,0,0,0,0,0,0,-74000,0,0,0,0,74000,-74000,-74000
6165,捷泰            ,52000,126000,-74000,0,0,0,0,0,0,0,0,0,0,0,0,0,-74000
060775,世芯凱基9A購02  ,0,0,0,0,0,0,0,0,0,-75000,0,0,0,0,75000,-75000,-75000
060451,中石化元大9C購02,0,0,0,0,0,0,0,0,0,-75000,0,0,0,23000,98000,-75000,-75000
060342,台積電統一02購01,0,0,0,0,0,0,0,0,0,-75000,0,0,0,0,75000,-75000,-75000
061867,旺宏元大9B購02  ,0,0,0,0,0,0,0,0,0,-75000,0,0,0,8000,83000,-75000,-75000
061950,日月光群益9B購01,0,0,0,0,0,0,0,0,0,-75000,0,0,0,10000,85000,-75000,-75000
050854,世紀鋼國票97購01,0,0,0,0,0,0,0,0,0,-75000,0,0,0,0,75000,-75000,-75000
058152,聯發科統一9B購02,0,0,0,0,0,0,0,0,0,-75000,0,0,0,0,75000,-75000,-75000
059619,台積電日盛9A購04,0,0,0,0,0,0,0,0,0,-75000,0,0,0,20000,95000,-75000,-75000
055849,聯詠元大97購05  ,0,0,0,0,0,0,0,0,0,-75000,0,0,0,100000,175000,-75000,-75000
4725,信昌化          ,71000,146000,-75000,0,0,0,0,0,0,0,0,0,0,0,0,0,-75000
07214P,聯發科凱基9A售04,0,0,0,0,0,0,0,0,0,-75000,0,0,0,0,75000,-75000,-75000
1612,宏泰            ,21000,96000,-75000,0,0,0,0,0,0,0,0,0,0,0,0,0,-75000
051300,台光電凱基96購02,0,0,0,0,0,0,0,0,0,-76000,0,0,0,30000,106000,-76000,-76000
03074X,元展69          ,0,0,0,0,0,0,0,0,0,-76000,0,0,0,0,76000,-76000,-76000
053114,聯茂兆豐97購01  ,0,0,0,0,0,0,0,0,0,-76000,0,0,0,0,76000,-76000,-76000
2107,厚生            ,34000,110000,-76000,0,0,0,0,0,0,0,0,0,0,0,0,0,-76000
8463,潤泰材          ,20000,96000,-76000,0,0,0,0,0,0,0,0,0,0,0,0,0,-76000
06188P,大立光元富97售01,0,0,0,0,0,0,0,0,0,-77000,0,0,0,9000,86000,-77000,-77000
061017,國泰金麥證9A購01,0,0,0,21000,98000,-77000,0,0,0,-77000,0,0,0,21000,98000,-77000,-77000
052703,貿聯國票97購01  ,0,0,0,0,0,0,0,0,0,-77000,0,0,0,7000,84000,-77000,-77000
053451,致新凱基96購02  ,0,0,0,0,0,0,0,0,0,-77000,0,0,0,40000,117000,-77000,-77000
058821,泰鼎國泰9B購01  ,0,0,0,0,0,0,0,0,0,-77000,0,0,0,27000,104000,-77000,-77000
059215,台積電元大99購28,0,0,0,0,0,0,0,0,0,-77000,0,0,0,10000,87000,-77000,-77000
9941,裕融            ,32000,109000,-77000,0,0,0,0,0,0,0,0,0,0,0,0,0,-77000
1786,科妍            ,17000,96000,-79000,0,0,0,0,0,0,2000,2000,0,2000,0,0,0,-77000
061262,智邦凱基9A購02  ,0,0,0,0,0,0,0,0,0,-78000,0,0,0,10000,88000,-78000,-78000
058610,欣興元大99購05  ,0,0,0,0,0,0,0,0,0,-78000,0,0,0,39000,117000,-78000,-78000
056255,華新科元富97購05,0,0,0,0,0,0,0,0,0,-78000,0,0,0,148000,226000,-78000,-78000
07798P,同欣電國票9A售01,0,0,0,0,0,0,0,0,0,-78000,0,0,0,10000,88000,-78000,-78000
061900,志超永豐9B購01  ,0,0,0,0,0,0,0,0,0,-79000,0,0,0,0,79000,-79000,-79000
061121,智邦永豐9A購02  ,0,0,0,0,0,0,0,0,0,-79000,0,0,0,69000,148000,-79000,-79000
060633,玉晶光富邦02購01,0,0,0,0,0,0,0,0,0,-79000,0,0,0,299000,378000,-79000,-79000
060401,世紀鋼國票9B購01,0,0,0,0,0,0,0,0,0,-79000,0,0,0,1000,80000,-79000,-79000
060232,友訊元大9C購01  ,0,0,0,0,0,0,0,0,0,-79000,0,0,0,0,79000,-79000,-79000
054134,強茂元大96購01  ,0,0,0,0,0,0,0,0,0,-79000,0,0,0,5000,84000,-79000,-79000
047690,美律富邦97購01  ,0,0,0,0,0,0,0,0,0,-79000,0,0,0,0,79000,-79000,-79000
057989,旺宏統一99購04  ,0,0,0,0,0,0,0,0,0,-79000,0,0,0,23000,102000,-79000,-79000
057063,立積國泰9A購01  ,0,0,0,0,0,0,0,0,0,-79000,0,0,0,41000,120000,-79000,-79000
058258,世芯國泰9A購01  ,0,0,0,0,0,0,0,0,0,-79000,0,0,0,15000,94000,-79000,-79000
058358,技嘉凱基9A購01  ,0,0,0,0,0,0,0,0,0,-79000,0,0,0,60000,139000,-79000,-79000
07227P,聯發科元富99售05,0,0,0,0,0,0,0,0,0,-79000,0,0,0,0,79000,-79000,-79000
2636,台驊投控        ,26000,105000,-79000,0,0,0,0,0,0,0,0,0,0,0,0,0,-79000
8429,金麗-KY         ,10000,89000,-79000,0,0,0,0,0,0,0,0,0,0,0,0,0,-79000
2357,華碩            ,943492,910333,33159,0,0,0,1000,100000,-99000,-14000,0,0,0,0,14000,-14000,-79841
2354,鴻準            ,1328000,1405919,-77919,0,0,0,0,0,0,-2000,0,2000,-2000,0,0,0,-79919
060402,神隆國泰9B購01  ,0,1000,-1000,0,0,0,0,0,0,-79000,0,0,0,135000,214000,-79000,-80000
059907,道瓊指元大99購03,0,0,0,0,0,0,0,0,0,-80000,0,0,0,0,80000,-80000,-80000
060585,玉晶光元富9A購02,0,0,0,0,0,0,0,0,0,-80000,0,0,0,20000,100000,-80000,-80000
060871,台灣50中信01購03,0,0,0,0,0,0,0,0,0,-80000,0,0,0,29000,109000,-80000,-80000
060923,全新永豐9A購01  ,0,0,0,0,0,0,0,0,0,-80000,0,0,0,10000,90000,-80000,-80000
060955,大立光群益9A購02,0,0,0,0,0,0,0,0,0,-80000,0,0,0,22000,102000,-80000,-80000
054563,泰碩群益99購01  ,0,0,0,0,0,0,0,0,0,-80000,0,0,0,7000,87000,-80000,-80000
053695,智易元大97購02  ,0,0,0,0,0,0,0,0,0,-80000,0,0,0,0,80000,-80000,-80000
054834,帆宣中信97購01  ,0,0,0,0,0,0,0,0,0,-80000,0,0,0,0,80000,-80000,-80000
056003,智伸科永豐97購02,0,0,0,0,0,0,0,0,0,-80000,0,0,0,0,80000,-80000,-80000
058297,茂林凱基9A購02  ,0,0,0,0,0,0,0,0,0,-80000,0,0,0,0,80000,-80000,-80000
056077,矽力元大97購07  ,0,0,0,0,0,0,0,0,0,-80000,0,0,0,96000,176000,-80000,-80000
058195,鈺齊永豐99購01  ,0,0,0,0,0,0,0,0,0,-80000,0,0,0,20000,100000,-80000,-80000
059359,精元永豐99購01  ,0,0,0,0,0,0,0,0,0,-80000,0,0,0,0,80000,-80000,-80000
056916,台達電兆豐98購02,0,0,0,0,0,0,0,0,0,-80000,0,0,0,20000,100000,-80000,-80000
056588,聯發科統一9A購02,0,0,0,0,0,0,0,0,0,-80000,0,0,0,41000,121000,-80000,-80000
056515,燿華兆豐99購01  ,0,0,0,0,0,0,0,0,0,-80000,0,0,0,20000,100000,-80000,-80000
1467,南緯            ,30000,110000,-80000,0,0,0,0,0,0,0,0,0,0,0,0,0,-80000
2484,希華            ,20000,100000,-80000,0,0,0,0,0,0,0,0,0,0,0,0,0,-80000
3018,同開            ,108000,188000,-80000,0,0,0,0,0,0,0,0,0,0,0,0,0,-80000
07032P,聯發科統一9C售02,0,0,0,0,0,0,0,0,0,-80000,0,0,0,3000,83000,-80000,-80000
07640P,國巨群益9A售07  ,0,0,0,0,0,0,0,0,0,-80000,0,0,0,4000,84000,-80000,-80000
060100,新光金元大9C購01,0,0,0,0,0,0,0,0,0,-81000,0,0,0,20000,101000,-81000,-81000
061343,大立光元大9A購04,0,0,0,0,0,0,0,0,0,-81000,0,0,0,0,81000,-81000,-81000
054381,世芯群益98購01  ,0,0,0,0,0,0,0,0,0,-81000,0,0,0,15000,96000,-81000,-81000
054214,京鼎國票97購02  ,0,0,0,0,0,0,0,0,0,-81000,0,0,0,17000,98000,-81000,-81000
054579,聯茂元大97購01  ,0,0,0,0,0,0,0,0,0,-81000,0,0,0,60000,141000,-81000,-81000
052096,力成元大95購01  ,0,0,0,0,0,0,0,0,0,-81000,0,0,0,0,81000,-81000,-81000
051404,牧德永豐96購01  ,0,0,0,0,0,0,0,0,0,-81000,0,0,0,119000,200000,-81000,-81000
2374,佳能            ,11000,92000,-81000,0,0,0,0,0,0,0,0,0,0,0,0,0,-81000
2431,聯昌            ,3000,84000,-81000,0,0,0,0,0,0,0,0,0,0,0,0,0,-81000
9946,三發地產        ,0,81000,-81000,0,0,0,0,0,0,0,0,0,0,0,0,0,-81000
061388,台積電群益9A購05,0,0,0,0,0,0,0,0,0,-82000,0,0,0,0,82000,-82000,-82000
06457P,玉晶光統一98售02,0,0,0,0,0,0,0,0,0,-82000,0,0,0,181000,263000,-82000,-82000
052764,景碩群益98購01  ,0,0,0,0,0,0,0,0,0,-82000,0,0,0,107000,189000,-82000,-82000
054919,興富發凱基97購01,0,0,0,0,0,0,0,0,0,-82000,0,0,0,120000,202000,-82000,-82000
054707,聯茂亞東97購01  ,0,0,0,0,0,0,0,0,0,-82000,0,0,0,0,82000,-82000,-82000
058996,台達電元大99購02,0,0,0,0,0,0,0,0,0,-82000,0,0,0,147000,229000,-82000,-82000
058645,康控富邦01購01  ,0,0,0,0,0,0,0,0,0,-82000,0,0,0,50000,132000,-82000,-82000
055808,世紀鋼永豐97購01,0,0,0,0,0,0,0,0,0,-82000,0,0,0,10000,92000,-82000,-82000
1604,聲寶            ,6000,88000,-82000,0,0,0,0,0,0,0,0,0,0,0,0,0,-82000
061306,瑞祺永豐9A購02  ,0,0,0,0,0,0,0,0,0,-83000,0,0,0,0,83000,-83000,-83000
060281,卜蜂元大9C購01  ,0,0,0,0,0,0,0,0,0,-83000,0,0,0,165000,248000,-83000,-83000
056463,台虹凱基98購02  ,0,0,0,0,0,0,0,0,0,-83000,0,0,0,317000,400000,-83000,-83000
3004,豐達科          ,10000,93000,-83000,0,0,0,0,0,0,0,0,0,0,0,0,0,-83000
4108,懷特            ,23000,106000,-83000,0,0,0,0,0,0,0,0,0,0,0,0,0,-83000
06421P,嘉澤統一97售02  ,0,0,0,0,0,0,0,0,0,-84000,0,0,0,0,84000,-84000,-84000
062107,台光電國票9B購01,0,0,0,0,0,0,0,0,0,-84000,0,0,0,0,84000,-84000,-84000
062031,臻鼎群益9B購01  ,0,0,0,0,0,0,0,0,0,-84000,0,0,0,42000,126000,-84000,-84000
056503,楠梓電永豐98購01,0,0,0,0,0,0,0,0,0,-84000,0,0,0,0,84000,-84000,-84000
059097,世紀鋼元大99購05,0,0,0,0,0,0,0,0,0,-84000,0,0,0,107000,191000,-84000,-84000
057650,力成元大98購04  ,0,0,0,0,0,0,0,0,0,-84000,0,0,0,0,84000,-84000,-84000
055920,智伸科凱基97購02,0,0,0,0,0,0,0,0,0,-84000,0,0,0,0,84000,-84000,-84000
6591,動力-KY         ,33000,118000,-85000,0,0,0,0,0,0,1000,1000,0,1000,0,0,0,-84000
3003,健和興          ,196000,412000,-216000,0,0,0,154000,0,154000,-22000,75000,88000,-13000,19000,28000,-9000,-84000
3454,晶睿            ,7000,91000,-84000,0,0,0,0,0,0,0,0,0,0,0,0,0,-84000
1589,永冠-KY         ,81000,115000,-34000,0,0,0,0,0,0,-50000,15000,65000,-50000,0,0,0,-84000
2013,中鋼構          ,21000,105000,-84000,0,0,0,0,0,0,0,0,0,0,0,0,0,-84000
07171P,臺股指國票99售08,0,0,0,0,0,0,0,0,0,-84000,0,0,0,1000,85000,-84000,-84000
07361P,聯發科元大99售34,0,0,0,0,0,0,0,0,0,-84000,0,0,0,76000,160000,-84000,-84000
1611,中電            ,51000,135500,-84500,0,0,0,0,0,0,0,0,0,0,0,0,0,-84500
061826,台郡麥證9B購01  ,0,0,0,0,85000,-85000,0,0,0,-85000,0,0,0,0,85000,-85000,-85000
061820,康控群益9B購02  ,0,0,0,0,0,0,0,0,0,-85000,0,0,0,0,85000,-85000,-85000
061976,國巨元大9B購01  ,0,0,0,0,0,0,0,0,0,-85000,0,0,0,0,85000,-85000,-85000
060254,世紀鋼元大9A購01,0,0,0,0,0,0,0,0,0,-85000,0,0,0,60000,145000,-85000,-85000
061151,友訊群益9A購01  ,0,0,0,0,0,0,0,0,0,-85000,0,0,0,90000,175000,-85000,-85000
054301,楠梓電凱基98購01,0,0,0,0,0,0,0,0,0,-85000,0,0,0,45000,130000,-85000,-85000
054027,欣興凱基96購04  ,0,0,0,0,0,0,0,0,0,-85000,0,0,0,15000,100000,-85000,-85000
05304P,國巨國泰97售02  ,0,0,0,0,0,0,0,0,0,-85000,0,0,0,0,85000,-85000,-85000
057904,矽力永豐98購01  ,0,0,0,0,0,0,0,0,0,-85000,0,0,0,646000,731000,-85000,-85000
058298,聯茂凱基99購05  ,0,0,0,0,0,0,0,0,0,-85000,0,0,0,0,85000,-85000,-85000
057777,可成群益9A購03  ,0,0,0,0,0,0,0,0,0,-85000,0,0,0,0,85000,-85000,-85000
057451,大立光元富9B購01,0,0,0,0,0,0,0,0,0,-85000,0,0,0,116000,201000,-85000,-85000
4540,全球傳動        ,19000,77000,-58000,0,0,0,0,0,0,-27000,0,27000,-27000,0,0,0,-85000
060766,世芯元大9A購02  ,0,0,0,0,0,0,0,0,0,-86000,0,0,0,44000,130000,-86000,-86000
062112,祥碩國票9C購01  ,0,0,0,0,0,0,0,0,0,-86000,0,0,0,0,86000,-86000,-86000
061253,臺股指群益9A購04,0,0,0,0,0,0,0,0,0,-86000,0,0,0,0,86000,-86000,-86000
061626,超眾群益9A購02  ,0,0,0,0,0,0,0,0,0,-86000,0,0,0,22000,108000,-86000,-86000
061618,友達群益9A購04  ,0,0,0,0,0,0,0,0,0,-86000,0,0,0,12000,98000,-86000,-86000
053718,全新凱基97購02  ,0,0,0,0,0,0,0,0,0,-86000,0,0,0,0,86000,-86000,-86000
055381,茂林元大97購02  ,0,0,0,0,0,0,0,0,0,-86000,0,0,0,22000,108000,-86000,-86000
056979,微星群益98購01  ,0,0,0,0,0,0,0,0,0,-86000,0,0,0,152000,238000,-86000,-86000
057704,台虹群益98購03  ,0,0,0,0,0,0,0,0,0,-86000,0,0,0,488000,574000,-86000,-86000
3588,通嘉            ,62000,147000,-85000,0,0,0,0,0,0,-1000,0,1000,-1000,0,0,0,-86000
07341P,台積電凱基99售18,0,0,0,0,0,0,0,0,0,-86000,0,0,0,4000,90000,-86000,-86000
061842,牧德凱基9C購01  ,0,0,0,0,0,0,0,0,0,-87000,0,0,0,47000,134000,-87000,-87000
060306,台肥永豐9A購01  ,0,0,0,0,0,0,0,0,0,-87000,0,0,0,40000,127000,-87000,-87000
055297,啟碁元大97購01  ,0,0,0,0,0,0,0,0,0,-87000,0,0,0,13000,100000,-87000,-87000
054188,欣興永豐96購03  ,0,0,0,0,0,0,0,0,0,-87000,0,0,0,69000,156000,-87000,-87000
057405,麗豐群益98購01  ,0,0,0,0,0,0,0,0,0,-87000,0,0,0,11000,98000,-87000,-87000
05755P,臺股指中信99售04,0,0,0,0,0,0,0,0,0,-87000,0,0,0,41000,128000,-87000,-87000
057148,玉晶光國票99購04,0,0,0,0,0,0,0,0,0,-87000,0,0,0,33000,120000,-87000,-87000
3535,晶彩科          ,237000,324000,-87000,0,0,0,0,0,0,0,0,0,0,0,0,0,-87000
060159,健和興永豐9A購01,0,0,0,0,0,0,0,0,0,-88000,0,0,0,5000,93000,-88000,-88000
060566,聯詠富邦9C購01  ,0,0,0,0,0,0,0,0,0,-88000,0,0,0,304000,392000,-88000,-88000
061951,南電群益9B購01  ,0,0,0,0,0,0,0,0,0,-88000,0,0,0,60000,148000,-88000,-88000
056962,技嘉永豐98購01  ,0,0,0,0,0,0,0,0,0,-88000,0,0,0,12000,100000,-88000,-88000
056247,台郡群益97購01  ,0,0,0,0,0,0,0,0,0,-88000,0,0,0,10000,98000,-88000,-88000
057809,英業達元大98購01,0,0,0,0,0,0,0,0,0,-88000,0,0,0,36000,124000,-88000,-88000
058581,大立光群益99購05,0,0,0,0,0,0,0,0,0,-88000,0,0,0,11000,99000,-88000,-88000
2031,新光鋼          ,72000,170000,-98000,0,0,0,0,0,0,10000,17000,7000,10000,0,0,0,-88000
06885P,國巨國票99售06  ,0,0,0,0,0,0,0,0,0,-89000,0,0,0,0,89000,-89000,-89000
061433,華通麥證9A購03  ,0,0,0,121000,210000,-89000,0,0,0,-89000,0,0,0,121000,210000,-89000,-89000
053219,祥碩凱基96購01  ,0,0,0,0,0,0,0,0,0,-89000,0,0,0,0,89000,-89000,-89000
056745,聯茂凱基99購03  ,0,0,0,0,0,0,0,0,0,-89000,0,0,0,10000,99000,-89000,-89000
058623,國巨國票99購08  ,0,0,0,0,0,0,0,0,0,-89000,0,0,0,10000,99000,-89000,-89000
058670,鴻海群益9A購03  ,0,0,0,0,0,0,0,0,0,-89000,0,0,0,20000,109000,-89000,-89000
057270,遠東新元大98購01,0,0,0,0,0,0,0,0,0,-89000,0,0,0,1000,90000,-89000,-89000
059638,大立光凱基99購11,0,0,0,0,0,0,0,0,0,-89000,0,0,0,5000,94000,-89000,-89000
057523,大成鋼元大99購01,0,0,0,0,0,0,0,0,0,-89000,0,0,0,61000,150000,-89000,-89000
2436,偉詮電          ,145000,234000,-89000,0,0,0,0,0,0,0,0,0,0,0,0,0,-89000
061200,道瓊反元大9A購06,0,0,0,0,0,0,0,0,0,-90000,0,0,0,10000,100000,-90000,-90000
061645,超眾元大9A購06  ,0,0,0,0,0,0,0,0,0,-90000,0,0,0,125000,215000,-90000,-90000
06839P,玉晶光統一9A售05,0,0,0,0,0,0,0,0,0,-90000,0,0,0,1090000,1180000,-90000,-90000
051594,和碩元大96購01  ,0,0,0,0,0,0,0,0,0,-90000,0,0,0,10000,100000,-90000,-90000
051462,世芯國泰97購01  ,0,0,0,0,0,0,0,0,0,-90000,0,0,0,0,90000,-90000,-90000
048504,A50正2中信95購01,0,0,0,0,0,0,0,0,0,-90000,0,0,0,0,90000,-90000,-90000
053804,富邦金凱基96購01,0,0,0,0,0,0,0,0,0,-90000,0,0,0,10000,100000,-90000,-90000
054708,華通統一97購02  ,0,0,0,0,0,0,0,0,0,-90000,0,0,0,40000,130000,-90000,-90000
054795,合勤控群益98購01,0,0,0,0,0,0,0,0,0,-90000,0,0,0,98000,188000,-90000,-90000
055121,鴻海兆豐97購03  ,0,0,0,0,0,0,0,0,0,-90000,0,0,0,10000,100000,-90000,-90000
058989,茂林凱基99購02  ,0,0,0,0,0,0,0,0,0,-90000,0,0,0,15000,105000,-90000,-90000
058259,訊連國泰9B購01  ,0,0,0,0,0,0,0,0,0,-90000,0,0,0,10000,100000,-90000,-90000
057149,京鼎國票99購02  ,0,0,0,0,0,0,0,0,0,-90000,0,0,0,6000,96000,-90000,-90000
2727,王品            ,54000,144000,-90000,0,0,0,0,0,0,0,0,0,0,0,0,0,-90000
5534,長虹            ,32000,120000,-88000,0,0,0,0,0,0,-2000,0,2000,-2000,0,0,0,-90000
3661,世芯-KY         ,831295,874000,-42705,0,0,0,56000,0,56000,-104000,67000,212000,-145000,53000,12000,41000,-90705
06465P,國巨統一98售04  ,0,0,0,0,0,0,0,0,0,-91000,0,0,0,83000,174000,-91000,-91000
060376,瑞祺元富9A購01  ,0,0,0,0,0,0,0,0,0,-91000,0,0,0,202000,293000,-91000,-91000
053768,S&P反1元大99購01,0,0,0,0,0,0,0,0,0,-91000,0,0,0,0,91000,-91000,-91000
03680C,臺股指凱基9A牛26,0,0,0,0,0,0,0,0,0,-91000,0,0,0,358000,449000,-91000,-91000
057675,同欣電元大98購02,0,0,0,0,0,0,0,0,0,-91000,0,0,0,443000,534000,-91000,-91000
060419,漢翔永豐9A購01  ,0,0,0,0,0,0,0,0,0,-92000,0,0,0,53000,145000,-92000,-92000
060158,廣達永豐9A購01  ,0,0,0,0,0,0,0,0,0,-92000,0,0,0,218000,310000,-92000,-92000
060238,強茂元大9C購01  ,0,0,0,0,0,0,0,0,0,-92000,0,0,0,8000,100000,-92000,-92000
060493,美律元富01購01  ,0,0,0,0,0,0,0,0,0,-92000,0,0,0,102000,194000,-92000,-92000
062053,華通統一9C購02  ,0,0,0,0,0,0,0,0,0,-92000,0,0,0,102000,194000,-92000,-92000
061624,中租群益9A購01  ,0,0,0,0,0,0,0,0,0,-92000,0,0,0,6000,98000,-92000,-92000
055817,京鼎國票99購01  ,0,0,0,0,0,0,0,0,0,-92000,0,0,0,5000,97000,-92000,-92000
05744P,台表科元大96售04,0,0,0,0,0,0,0,0,0,-92000,0,0,0,4000,96000,-92000,-92000
056906,玉晶光元大9B購01,0,0,0,0,0,0,0,0,0,-92000,0,0,0,125000,217000,-92000,-92000
057158,義隆永豐99購01  ,0,0,0,0,0,0,0,0,0,-92000,0,0,0,63000,155000,-92000,-92000
057901,大立光永豐98購04,0,0,0,0,0,0,0,0,0,-92000,0,0,0,0,92000,-92000,-92000
061267,玉山金凱基9B購01,0,0,0,0,0,0,0,0,0,-93000,0,0,0,50000,143000,-93000,-93000
061409,力成國票9A購02  ,0,0,0,0,0,0,0,0,0,-93000,0,0,0,15000,108000,-93000,-93000
060845,欣興國票9A購01  ,0,0,0,0,0,0,0,0,0,-93000,0,0,0,62000,155000,-93000,-93000
059038,健策群益9A購02  ,0,0,0,0,0,0,0,0,0,-93000,0,0,0,22000,115000,-93000,-93000
057111,立積群益98購02  ,0,0,0,0,0,0,0,0,0,-93000,0,0,0,23000,116000,-93000,-93000
057267,康控兆豐99購01  ,0,0,0,0,0,0,0,0,0,-93000,0,0,0,0,93000,-93000,-93000
07315P,台積電台新99售06,0,0,0,0,0,0,0,0,0,-93000,0,0,0,0,93000,-93000,-93000
8462,柏文            ,8000,87000,-79000,0,0,0,0,14000,-14000,0,0,0,0,0,0,0,-93000
060714,晶技永豐9A購02  ,0,0,0,0,0,0,0,0,0,-94000,0,0,0,3000,97000,-94000,-94000
060694,旺宏麥證9A購02  ,0,0,0,6000,100000,-94000,0,0,0,-94000,0,0,0,6000,100000,-94000,-94000
060058,牧德凱基9B購01  ,0,0,0,0,0,0,0,0,0,-94000,0,0,0,452000,546000,-94000,-94000
061906,統一中信9B購01  ,0,0,0,0,0,0,0,0,0,-94000,0,0,0,15000,109000,-94000,-94000
054212,聯詠國票97購03  ,0,0,0,0,0,0,0,0,0,-94000,0,0,0,0,94000,-94000,-94000
052995,上銀康和96購01  ,0,0,0,0,0,0,0,0,0,-94000,0,0,0,0,94000,-94000,-94000
051536,玉晶光國票97購01,0,0,0,0,0,0,0,0,0,-94000,0,0,0,79000,173000,-94000,-94000
053077,同欣電永豐96購01,0,0,0,0,0,0,0,0,0,-94000,0,0,0,46000,140000,-94000,-94000
054439,健策台新96購03  ,0,0,0,0,0,0,0,0,0,-94000,0,0,0,0,94000,-94000,-94000
058701,鴻海元大99購16  ,0,0,0,0,0,0,0,0,0,-94000,0,0,0,0,94000,-94000,-94000
07173P,臺股指國票99售10,0,0,0,0,0,0,0,0,0,-94000,0,0,0,31000,125000,-94000,-94000
061196,世芯永豐9A購06  ,0,0,0,0,0,0,0,0,0,-95000,0,0,0,101000,196000,-95000,-95000
060336,南電康和9A購01  ,0,0,0,0,0,0,0,0,0,-95000,0,0,0,42000,137000,-95000,-95000
060605,大立光凱基9C購01,0,0,0,0,0,0,0,0,0,-95000,0,0,0,10000,105000,-95000,-95000
053854,聯茂國泰97購02  ,0,0,0,0,0,0,0,0,0,-95000,0,0,0,37000,132000,-95000,-95000
055209,勤誠康和97購01  ,0,0,0,0,0,0,0,0,0,-95000,0,0,0,5000,100000,-95000,-95000
05570P,聯發科統一96售04,0,0,0,0,0,0,0,0,0,-95000,0,0,0,0,95000,-95000,-95000
05626P,景碩國票97售03  ,0,0,0,0,0,0,0,0,0,-95000,0,0,0,12000,107000,-95000,-95000
057128,台光電凱基98購03,0,0,0,0,0,0,0,0,0,-95000,0,0,0,21000,116000,-95000,-95000
059535,玉山金凱基99購01,0,0,0,0,0,0,0,0,0,-95000,0,0,0,17000,112000,-95000,-95000
07467P,上銀元大9A售03  ,0,0,0,0,0,0,0,0,0,-95000,0,0,0,22000,117000,-95000,-95000
3605,宏致            ,161000,256000,-95000,0,0,0,0,0,0,0,0,0,0,0,0,0,-95000
1731,美吾華          ,58000,153000,-95000,0,0,0,0,0,0,0,0,0,0,0,0,0,-95000
8104,錸寶            ,544000,639000,-95000,0,0,0,0,0,0,0,0,0,0,0,0,0,-95000
060144,全新國票9B購01  ,0,0,0,0,0,0,0,0,0,-96000,0,0,0,8000,104000,-96000,-96000
060021,立積康和99購01  ,0,0,0,0,0,0,0,0,0,-96000,0,0,0,0,96000,-96000,-96000
054575,聯鈞元大97購01  ,0,0,0,0,0,0,0,0,0,-96000,0,0,0,0,96000,-96000,-96000
2106,建大            ,51000,147000,-96000,0,0,0,0,0,0,0,0,0,0,0,0,0,-96000
07100P,華航元大99售01  ,0,0,0,0,0,0,0,0,0,-96000,0,0,0,77000,173000,-96000,-96000
061520,健策中信9A購01  ,0,0,0,0,0,0,0,0,0,-97000,0,0,0,10000,107000,-97000,-97000
059643,日月光凱基99購02,0,0,0,0,0,0,0,0,0,-97000,0,0,0,144000,241000,-97000,-97000
056314,力成元大97購01  ,0,0,0,0,0,0,0,0,0,-97000,0,0,0,8000,105000,-97000,-97000
056398,南茂永豐98購01  ,0,0,0,0,0,0,0,0,0,-97000,0,0,0,113000,210000,-97000,-97000
07709P,創意元大9A售01  ,0,0,0,0,0,0,0,0,0,-97000,0,0,0,10000,107000,-97000,-97000
3504,揚明光          ,64000,155000,-91000,0,0,0,0,0,0,-6000,0,0,0,0,6000,-6000,-97000
1532,勤美            ,16000,113400,-97400,0,0,0,0,0,0,0,0,0,0,0,0,0,-97400
061415,健策群益9A購04  ,0,0,0,0,0,0,0,0,0,-98000,0,0,0,0,98000,-98000,-98000
06507P,台表科國票99售01,0,0,0,0,0,0,0,0,0,-98000,0,0,0,65000,163000,-98000,-98000
060408,和潤國泰9C購01  ,0,0,0,0,0,0,0,0,0,-98000,0,0,0,52000,150000,-98000,-98000
061153,奇力新群益9A購02,0,0,0,0,0,0,0,0,0,-98000,0,0,0,0,98000,-98000,-98000
053819,大立光群益96購04,0,0,0,0,0,0,0,0,0,-98000,0,0,0,0,98000,-98000,-98000
059037,宏達電群益99購02,0,0,0,0,0,0,0,0,0,-98000,0,0,0,0,98000,-98000,-98000
055301,台虹元大97購01  ,0,0,0,0,0,0,0,0,0,-98000,0,0,0,116000,214000,-98000,-98000
053593,晶技元大98購01  ,0,0,0,0,0,0,0,0,0,-98000,0,0,0,75000,173000,-98000,-98000
057888,貿聯群益98購02  ,0,0,0,0,0,0,0,0,0,-98000,0,0,0,60000,158000,-98000,-98000
058567,華新科凱基9A購02,0,0,0,0,0,0,0,0,0,-98000,0,0,0,10000,108000,-98000,-98000
057701,嘉聯益群益98購02,0,0,0,0,0,0,0,0,0,-98000,0,0,0,0,98000,-98000,-98000
057107,華新科群益98購06,0,0,0,0,0,0,0,0,0,-98000,0,0,0,0,98000,-98000,-98000
2420,新巨            ,69000,167000,-98000,0,0,0,0,0,0,0,0,0,0,0,0,0,-98000
2851,中再保          ,42000,140000,-98000,0,0,0,0,0,0,0,0,0,0,0,0,0,-98000
061097,上証2X元大9A購07,0,0,0,0,0,0,0,0,0,-99000,0,0,0,0,99000,-99000,-99000
06374P,台表科元大97售06,0,0,0,0,0,0,0,0,0,-99000,0,0,0,0,99000,-99000,-99000
061613,南六統一9C購01  ,0,0,0,0,0,0,0,0,0,-99000,0,0,0,305000,404000,-99000,-99000
055440,矽力國票98購01  ,0,0,0,0,0,0,0,0,0,-99000,0,0,0,11000,110000,-99000,-99000
051058,景碩群益96購01  ,0,0,0,0,0,0,0,0,0,-99000,0,0,0,0,99000,-99000,-99000
057557,聯茂凱基99購04  ,0,0,0,0,0,0,0,0,0,-99000,0,0,0,4000,103000,-99000,-99000
058239,景碩元大99購03  ,0,0,0,0,0,0,0,0,0,-99000,0,0,0,92000,191000,-99000,-99000
1733,五鼎            ,79000,184000,-105000,0,0,0,0,0,0,6000,6000,0,6000,0,0,0,-99000
060665,康控凱基9A購01  ,0,0,0,0,0,0,0,0,0,-100000,0,0,0,0,100000,-100000,-100000
060002,T50反1群益9A購01,0,0,0,0,0,0,0,0,0,-100000,0,0,0,0,100000,-100000,-100000
050846,緯創國票96購01  ,0,0,0,0,0,0,0,0,0,-100000,0,0,0,0,100000,-100000,-100000
051375,道瓊反群益9A購01,0,0,0,0,0,0,0,0,0,-100000,0,0,0,0,100000,-100000,-100000
052927,友達元大98購02  ,0,0,0,0,0,0,0,0,0,-100000,0,0,0,0,100000,-100000,-100000
00656R,國泰中國A50反1  ,0,109000,-109000,0,0,0,0,0,0,9000,0,0,0,75000,66000,9000,-100000
052817,楠梓電永豐96購02,0,0,0,0,0,0,0,0,0,-100000,0,0,0,0,100000,-100000,-100000
05240P,玉晶光永豐96售01,0,0,0,0,0,0,0,0,0,-100000,0,0,0,0,100000,-100000,-100000
052512,全新凱基96購03  ,0,0,0,0,0,0,0,0,0,-100000,0,0,0,0,100000,-100000,-100000
054201,聯詠富邦97購02  ,0,0,0,0,0,0,0,0,0,-100000,0,0,0,0,100000,-100000,-100000
053518,聯茂群益96購03  ,0,0,0,0,0,0,0,0,0,-100000,0,0,0,0,100000,-100000,-100000
054858,台肥群益97購01  ,0,0,0,0,0,0,0,0,0,-100000,0,0,0,0,100000,-100000,-100000
058393,元油2X元大99購13,0,0,0,0,0,0,0,0,0,-100000,0,0,0,0,100000,-100000,-100000
055909,大成鋼凱基98購02,0,0,0,0,0,0,0,0,0,-100000,0,0,0,28000,128000,-100000,-100000
057195,南茂元大98購01  ,0,0,0,0,0,0,0,0,0,-100000,0,0,0,181000,281000,-100000,-100000
059191,茂林富邦9B購01  ,0,0,0,0,0,0,0,0,0,-100000,0,0,0,0,100000,-100000,-100000
05565P,鎧勝元大96售01  ,0,0,0,0,0,0,0,0,0,-100000,0,0,0,10000,110000,-100000,-100000
057603,樺漢群益98購02  ,0,0,0,0,0,0,0,0,0,-100000,0,0,0,0,100000,-100000,-100000
05697P,友達凱基96售01  ,0,0,0,0,0,0,0,0,0,-100000,0,0,0,0,100000,-100000,-100000
056232,瑞儀凱基98購01  ,0,0,0,0,0,0,0,0,0,-100000,0,0,0,0,100000,-100000,-100000
057269,鈺齊兆豐98購01  ,0,0,0,0,0,0,0,0,0,-100000,0,0,0,0,100000,-100000,-100000
057377,康控元大99購02  ,0,0,0,0,0,0,0,0,0,-100000,0,0,0,126000,226000,-100000,-100000
056494,緯創國泰99購01  ,0,0,0,0,0,0,0,0,0,-100000,0,0,0,0,100000,-100000,-100000
07642P,華通凱基9A售05  ,0,0,0,0,0,0,0,0,0,-100000,0,0,0,0,100000,-100000,-100000
07811P,華新科統一9A售02,0,0,0,0,0,0,0,0,0,-100000,0,0,0,30000,130000,-100000,-100000
07933P,大立光富邦9C售06,0,0,0,0,0,0,0,0,0,-100000,0,0,0,0,100000,-100000,-100000
07446P,台灣50元大9A售06,0,0,0,0,0,0,0,0,0,-100000,0,0,0,0,100000,-100000,-100000
07412P,國巨元大99售32  ,0,0,0,0,0,0,0,0,0,-100000,0,0,0,0,100000,-100000,-100000
07379P,大立光元大99售30,0,0,0,0,0,0,0,0,0,-100000,0,0,0,0,100000,-100000,-100000
061785,奇力新群益9B購01,0,0,0,0,0,0,0,0,0,-101000,0,0,0,20000,121000,-101000,-101000
07473P,祥碩元大9A售01  ,0,0,0,0,0,0,0,0,0,-101000,0,0,0,50000,151000,-101000,-101000
2444,兆勁            ,46000,147000,-101000,0,0,0,0,0,0,0,0,0,0,0,0,0,-101000
061772,健策元大9B購06  ,0,0,0,0,0,0,0,0,0,-102000,0,0,0,15000,117000,-102000,-102000
061354,瑞儀元大9A購01  ,5000,0,5000,0,0,0,0,0,0,-107000,0,0,0,10000,117000,-107000,-102000
054148,矽創元大96購03  ,0,0,0,0,0,0,0,0,0,-102000,0,0,0,0,102000,-102000,-102000
006208,富邦台50        ,2000,2000,0,0,0,0,0,0,0,-102000,0,0,0,788000,890000,-102000,-102000
057084,立積統一9B購01  ,0,0,0,0,0,0,0,0,0,-102000,0,0,0,47000,149000,-102000,-102000
057203,麗豐元富98購02  ,0,0,0,0,0,0,0,0,0,-102000,0,0,0,85000,187000,-102000,-102000
06657P,寶成元大98售01  ,0,0,0,0,0,0,0,0,0,-103000,0,0,0,51000,154000,-103000,-103000
052536,聯茂國泰97購01  ,0,0,0,0,0,0,0,0,0,-103000,0,0,0,275000,378000,-103000,-103000
053506,南茂兆豐97購01  ,0,0,0,0,0,0,0,0,0,-103000,0,0,0,0,103000,-103000,-103000
057171,台光電元大9B購01,0,0,0,0,0,0,0,0,0,-103000,0,0,0,183000,286000,-103000,-103000
058134,信邦元大99購01  ,0,0,0,0,0,0,0,0,0,-103000,0,0,0,191000,294000,-103000,-103000
061924,聯發科凱基9C購01,0,0,0,0,0,0,0,0,0,-104000,0,0,0,0,104000,-104000,-104000
060889,國泰金統一9C購01,0,0,0,0,0,0,0,0,0,-104000,0,0,0,138000,242000,-104000,-104000
07466P,亞德客元大9A售02,0,0,0,0,0,0,0,0,0,-104000,0,0,0,60000,164000,-104000,-104000
2365,昆盈            ,8000,112501,-104501,0,0,0,0,0,0,0,0,0,0,0,0,0,-104501
061087,國巨統一01購04  ,0,0,0,0,0,0,0,0,0,-105000,0,0,0,178000,283000,-105000,-105000
060110,茂林元大99購06  ,0,0,0,0,0,0,0,0,0,-105000,0,0,0,45000,150000,-105000,-105000
051903,T50反1元大97購02,0,0,0,0,0,0,0,0,0,-105000,0,0,0,45000,150000,-105000,-105000
057977,台光電永豐98購02,0,0,0,0,0,0,0,0,0,-105000,0,0,0,97000,202000,-105000,-105000
058439,玉晶光統一01購02,0,0,0,0,0,0,0,0,0,-105000,0,0,0,147000,252000,-105000,-105000
2430,燦坤            ,5000,110000,-105000,0,0,0,0,0,0,0,0,0,0,0,0,0,-105000
1439,中和            ,51000,156000,-105000,0,0,0,0,0,0,0,0,0,0,0,0,0,-105000
07011P,宏達電凱基99售02,0,0,0,0,0,0,0,0,0,-105000,0,0,0,28000,133000,-105000,-105000
4532,瑞智            ,113000,218000,-105000,0,0,0,0,0,0,0,0,0,0,0,0,0,-105000
061547,禾伸堂群益9A購01,0,0,0,0,0,0,0,0,0,-106000,0,0,0,69000,175000,-106000,-106000
051406,泰鼎永豐96購01  ,0,0,0,0,0,0,0,0,0,-106000,0,0,0,20000,126000,-106000,-106000
057508,康控國票99購03  ,0,0,0,0,0,0,0,0,0,-106000,0,0,0,0,106000,-106000,-106000
056141,聯茂元大97購05  ,0,0,0,0,0,0,0,0,0,-106000,0,0,0,74000,180000,-106000,-106000
07671P,超眾元大9A售04  ,0,0,0,0,0,0,0,0,0,-106000,0,0,0,0,106000,-106000,-106000
07763P,嘉澤永豐9A售02  ,0,0,0,0,0,0,0,0,0,-106000,0,0,0,0,106000,-106000,-106000
3045,台灣大          ,905266,1254400,-349134,0,0,0,2000,0,2000,241000,252000,11000,241000,0,0,0,-106134
05305P,華新科國泰97售01,0,0,0,0,0,0,0,0,0,-107000,0,0,0,0,107000,-107000,-107000
058956,健策國票9A購02  ,0,0,0,0,0,0,0,0,0,-107000,0,0,0,25000,132000,-107000,-107000
058863,可成凱基99購02  ,0,0,0,0,0,0,0,0,0,-107000,0,0,0,4000,111000,-107000,-107000
059239,台積電凱基99購12,0,0,0,0,0,0,0,0,0,-107000,0,0,0,15000,122000,-107000,-107000
4976,佳凌            ,25000,132000,-107000,0,0,0,0,0,0,0,0,0,0,0,0,0,-107000
061577,泰碩元大9A購03  ,0,0,0,0,0,0,0,0,0,-108000,0,0,0,0,108000,-108000,-108000
049775,旺宏統一95購02  ,0,0,0,0,0,0,0,0,0,-108000,0,0,0,108000,216000,-108000,-108000
058136,景碩元大99購02  ,0,0,0,0,0,0,0,0,0,-108000,0,0,0,48000,156000,-108000,-108000
059814,SP黃豆凱基9A購02,0,0,0,0,0,0,0,0,0,-109000,0,0,0,36000,145000,-109000,-109000
060512,祥碩元大9A購02  ,0,0,0,0,0,0,0,0,0,-109000,0,0,0,58000,167000,-109000,-109000
055112,晶豪科凱基98購01,0,0,0,0,0,0,0,0,0,-109000,0,0,0,81000,190000,-109000,-109000
055182,京鼎統一98購01  ,0,0,0,0,0,0,0,0,0,-109000,0,0,0,0,109000,-109000,-109000
057629,泰碩永豐98購02  ,0,0,0,0,0,0,0,0,0,-109000,0,0,0,0,109000,-109000,-109000
055684,京鼎凱基97購01  ,0,0,0,0,0,0,0,0,0,-109000,0,0,0,20000,129000,-109000,-109000
056689,玉晶光統一9A購03,0,0,0,0,0,0,0,0,0,-109000,0,0,0,186000,295000,-109000,-109000
057802,卜蜂元大98購01  ,0,0,0,0,0,0,0,0,0,-109000,0,0,0,202000,311000,-109000,-109000
4934,太極            ,354000,463000,-109000,0,0,0,0,0,0,0,0,0,0,0,0,0,-109000
1907,永豐餘          ,97000,206000,-109000,0,0,0,0,0,0,0,0,0,0,0,0,0,-109000
060347,大立光統一02購01,0,0,0,0,0,0,0,0,0,-110000,0,0,0,108000,218000,-110000,-110000
053745,康友國票97購01  ,0,0,0,0,0,0,0,0,0,-110000,0,0,0,0,110000,-110000,-110000
056589,康控統一98購01  ,0,0,0,0,0,0,0,0,0,-110000,0,0,0,0,110000,-110000,-110000
055693,南茂凱基97購01  ,0,0,0,0,0,0,0,0,0,-110000,0,0,0,0,110000,-110000,-110000
058468,聯茂中信99購02  ,0,0,0,0,0,0,0,0,0,-110000,0,0,0,269000,379000,-110000,-110000
055935,創意群益97購02  ,0,0,0,0,0,0,0,0,0,-110000,0,0,0,0,110000,-110000,-110000
2929,淘帝-KY         ,52000,165000,-113000,0,0,0,0,0,0,3000,0,0,0,3000,0,3000,-110000
2915,潤泰全          ,858000,922529,-64529,0,0,0,0,0,0,-46000,8000,0,8000,0,54000,-54000,-110529
1526,日馳            ,2000,112550,-110550,0,0,0,0,0,0,0,0,0,0,0,0,0,-110550
06739P,聯詠兆豐98售02  ,0,0,0,0,0,0,0,0,0,-111000,0,0,0,4000,115000,-111000,-111000
058613,茂林元大99購03  ,45000,0,45000,0,0,0,0,0,0,-156000,0,0,0,130000,286000,-156000,-111000
061246,玉晶光群益9A購08,0,0,0,0,0,0,0,0,0,-112000,0,0,0,76000,188000,-112000,-112000
059852,康控永豐99購02  ,0,0,0,0,0,0,0,0,0,-112000,0,0,0,85000,197000,-112000,-112000
057713,美律統一99購01  ,0,0,0,0,0,0,0,0,0,-112000,0,0,0,0,112000,-112000,-112000
057295,可成永豐98購02  ,0,0,0,0,0,0,0,0,0,-112000,0,0,0,90000,202000,-112000,-112000
057553,景碩凱基98購03  ,0,0,0,0,0,0,0,0,0,-112000,0,0,0,18000,130000,-112000,-112000
059607,台積電富邦9C購04,0,0,0,0,0,0,0,0,0,-112000,0,0,0,20000,132000,-112000,-112000
059452,全新永豐99購03  ,0,0,0,0,0,0,0,0,0,-112000,0,0,0,40000,152000,-112000,-112000
061216,世芯元大9A購06  ,0,0,0,0,0,0,0,0,0,-113000,0,0,0,12000,125000,-113000,-113000
061361,世紀鋼兆豐9A購01,0,0,0,0,0,0,0,0,0,-113000,0,0,0,57000,170000,-113000,-113000
061384,T50反1群益9A購04,0,0,0,0,0,0,0,0,0,-113000,0,0,0,0,113000,-113000,-113000
062045,崇越凱基9B購01  ,0,0,0,0,0,0,0,0,0,-113000,0,0,0,0,113000,-113000,-113000
051947,矽力統一95購01  ,0,0,0,0,0,0,0,0,0,-113000,0,0,0,0,113000,-113000,-113000
059264,台光電中信99購02,0,0,0,0,0,0,0,0,0,-113000,0,0,0,67000,180000,-113000,-113000
056978,技嘉群益99購01  ,0,0,0,0,0,0,0,0,0,-113000,0,0,0,191000,304000,-113000,-113000
057779,禾伸堂群益98購02,0,0,0,0,0,0,0,0,0,-113000,0,0,0,12000,125000,-113000,-113000
061988,大立光元大9B購04,0,0,0,0,0,0,0,0,0,-114000,0,0,0,5000,119000,-114000,-114000
059351,台虹凱基99購01  ,0,0,0,0,0,0,0,0,0,-114000,0,0,0,62000,176000,-114000,-114000
8028,昇陽半導體      ,217000,310000,-93000,0,0,0,0,0,0,-21000,0,0,0,4000,25000,-21000,-114000
6449,鈺邦            ,41000,109000,-68000,0,0,0,0,0,0,-46000,12000,58000,-46000,0,0,0,-114000
6197,佳必琪          ,51000,165500,-114500,0,0,0,0,0,0,0,0,0,0,0,0,0,-114500
062014,牧德富邦9C購01  ,0,0,0,0,0,0,0,0,0,-115000,0,0,0,218000,333000,-115000,-115000
054506,矽格永豐96購01  ,0,0,0,0,0,0,0,0,0,-115000,0,0,0,0,115000,-115000,-115000
058764,康友群益99購01  ,0,0,0,0,0,0,0,0,0,-115000,0,0,0,1000,116000,-115000,-115000
059296,大立光元富99購06,0,0,0,0,0,0,0,0,0,-115000,0,0,0,135000,250000,-115000,-115000
062100,矽格永豐9B購01  ,0,0,0,0,0,0,0,0,0,-116000,0,0,0,0,116000,-116000,-116000
061704,景碩國票9A購01  ,0,0,0,0,0,0,0,0,0,-116000,0,0,0,45000,161000,-116000,-116000
060880,中壽中信9C購01  ,0,0,0,0,0,0,0,0,0,-116000,0,0,0,58000,174000,-116000,-116000
060864,可成永豐9A購01  ,0,0,0,0,0,0,0,0,0,-116000,0,0,0,29000,145000,-116000,-116000
060948,可成第一9A購01  ,0,0,0,0,0,0,0,0,0,-116000,0,0,0,105000,221000,-116000,-116000
058807,和大統一9B購01  ,0,0,0,0,0,0,0,0,0,-116000,0,0,0,0,116000,-116000,-116000
058969,亞德客永豐99購01,0,0,0,0,0,0,0,0,0,-116000,0,0,0,2000,118000,-116000,-116000
054356,可成兆豐97購01  ,0,0,0,0,0,0,0,0,0,-116000,0,0,0,40000,156000,-116000,-116000
6451,訊芯-KY         ,107000,218000,-111000,0,0,0,0,0,0,-5000,1000,1000,0,5000,10000,-5000,-116000
060423,智易永豐9A購01  ,0,0,0,0,0,0,0,0,0,-117000,0,0,0,179000,296000,-117000,-117000
055519,茂林中信99購01  ,0,0,0,0,0,0,0,0,0,-117000,0,0,0,40000,157000,-117000,-117000
06423P,亞光台新97售01  ,0,0,0,0,0,0,0,0,0,-118000,0,0,0,0,118000,-118000,-118000
052367,聯茂國票96購02  ,0,0,0,0,0,0,0,0,0,-118000,0,0,0,12000,130000,-118000,-118000
059760,楠梓電永豐99購01,0,0,0,0,0,0,0,0,0,-118000,0,0,0,50000,168000,-118000,-118000
056164,聯茂凱基98購03  ,0,0,0,0,0,0,0,0,0,-118000,0,0,0,0,118000,-118000,-118000
1902,台紙            ,171000,289000,-118000,0,0,0,0,0,0,0,0,0,0,0,0,0,-118000
07071P,立積元富99售01  ,0,0,0,0,0,0,0,0,0,-118000,0,0,0,143000,261000,-118000,-118000
06706P,智原台新98售02  ,0,0,0,0,0,0,0,0,0,-119000,0,0,0,66000,185000,-119000,-119000
059867,華邦電凱基99購02,0,0,0,0,0,0,0,0,0,-119000,0,0,0,90000,209000,-119000,-119000
061005,可成兆豐9A購01  ,0,0,0,0,0,0,0,0,0,-119000,0,0,0,11000,130000,-119000,-119000
047410,上銀元富96購01  ,0,0,0,0,0,0,0,0,0,-119000,0,0,0,162000,281000,-119000,-119000
055639,上銀元富97購02  ,0,0,0,0,0,0,0,0,0,-119000,0,0,0,116000,235000,-119000,-119000
054042,華泰元大96購01  ,0,0,0,0,0,0,0,0,0,-119000,0,0,0,0,119000,-119000,-119000
058240,景碩元大99購04  ,0,0,0,0,0,0,0,0,0,-119000,0,0,0,104000,223000,-119000,-119000
058135,景碩元大99購01  ,0,0,0,0,0,0,0,0,0,-119000,0,0,0,90000,209000,-119000,-119000
059540,新光金日盛99購01,0,0,0,0,0,0,0,0,0,-119000,0,0,0,17000,136000,-119000,-119000
059347,京鼎凱基99購02  ,0,0,0,0,0,0,0,0,0,-119000,0,0,0,11000,130000,-119000,-119000
2442,新美齊          ,37000,156000,-119000,0,0,0,0,0,0,0,0,0,0,0,0,0,-119000
2617,台航            ,19000,138000,-119000,0,0,0,0,0,0,0,0,0,0,0,0,0,-119000
060651,瑞儀中信9B購01  ,0,0,0,0,0,0,0,0,0,-120000,0,0,0,0,120000,-120000,-120000
059976,道瓊銀元大99購01,0,0,0,0,0,0,0,0,0,-120000,0,0,0,80000,200000,-120000,-120000
061609,華新科統一9C購01,0,0,0,0,0,0,0,0,0,-120000,0,0,0,150000,270000,-120000,-120000
061523,SP黃豆凱基9B購01,0,0,0,0,0,0,0,0,0,-120000,0,0,0,0,120000,-120000,-120000
1709,和益            ,67000,187000,-120000,0,0,0,0,0,0,0,0,0,0,0,0,0,-120000
07030P,鈺齊群益99售01  ,0,0,0,0,0,0,0,0,0,-120000,0,0,0,0,120000,-120000,-120000
07174P,臺股指國票99售11,0,0,0,0,0,0,0,0,0,-120000,0,0,0,19000,139000,-120000,-120000
061191,可成永豐9A購02  ,0,0,0,0,0,0,0,0,0,-121000,0,0,0,0,121000,-121000,-121000
052561,矽創國票97購01  ,0,0,0,0,0,0,0,0,0,-121000,0,0,0,141000,262000,-121000,-121000
057092,健策元富98購01  ,0,0,0,0,0,0,0,0,0,-121000,0,0,0,2000,123000,-121000,-121000
056685,光罩統一98購03  ,0,0,0,0,0,0,0,0,0,-121000,0,0,0,0,121000,-121000,-121000
1229,聯華            ,640000,761000,-121000,0,0,0,0,0,0,0,0,0,0,0,0,0,-121000
059056,技嘉凱基99購02  ,0,0,0,0,0,0,0,0,0,-122000,0,0,0,30000,152000,-122000,-122000
055820,矽力國票98購02  ,0,0,0,0,0,0,0,0,0,-122000,0,0,0,4000,126000,-122000,-122000
057995,華新科中信98購02,0,0,0,0,0,0,0,0,0,-122000,0,0,0,65000,187000,-122000,-122000
059147,矽創國票99購01  ,0,0,0,0,0,0,0,0,0,-122000,0,0,0,19000,141000,-122000,-122000
059618,台積電日盛99購01,0,0,0,0,0,0,0,0,0,-122000,0,0,0,434000,556000,-122000,-122000
061633,統一元大9A購01  ,0,0,0,0,0,0,0,0,0,-123000,0,0,0,103000,226000,-123000,-123000
06044P,同欣電永豐96售03,0,0,0,0,0,0,0,0,0,-123000,0,0,0,0,123000,-123000,-123000
05970P,超眾永豐96售03  ,0,0,0,0,0,0,0,0,0,-123000,0,0,0,5000,128000,-123000,-123000
2331,精英            ,75000,204000,-129000,0,0,0,0,0,0,6000,6000,0,6000,0,0,0,-123000
3048,益登            ,16000,139000,-123000,0,0,0,0,0,0,0,0,0,0,0,0,0,-123000
8261,富鼎            ,41000,164000,-123000,0,0,0,0,0,0,0,0,0,0,0,0,0,-123000
060037,鴻海國票99購10  ,0,0,0,0,0,0,0,0,0,-124000,0,0,0,10000,134000,-124000,-124000
060573,力成永豐9A購01  ,0,0,0,0,0,0,0,0,0,-124000,0,0,0,163000,287000,-124000,-124000
060526,台積電中信9A購02,0,0,0,0,0,0,0,0,0,-124000,0,0,0,41000,165000,-124000,-124000
061612,南六統一9A購01  ,0,0,0,0,0,0,0,0,0,-124000,0,0,0,147000,271000,-124000,-124000
061798,晶豪科永豐9B購01,0,0,0,0,0,0,0,0,0,-124000,0,0,0,24000,148000,-124000,-124000
1730,花仙子          ,21000,145000,-124000,0,0,0,0,0,0,0,0,0,0,0,0,0,-124000
07505P,台勝科元大9A售01,0,0,0,0,0,0,0,0,0,-124000,0,0,0,56000,180000,-124000,-124000
2324,仁寶            ,4474000,4621894,-147894,0,0,0,0,0,0,23000,200000,0,200000,13000,190000,-177000,-124894
061231,聚陽元大9A購02  ,0,0,0,0,0,0,0,0,0,-125000,0,0,0,166000,291000,-125000,-125000
060601,技嘉凱基9A購02  ,0,0,0,0,0,0,0,0,0,-125000,0,0,0,105000,230000,-125000,-125000
060390,聯鈞群益9A購01  ,0,0,0,0,0,0,0,0,0,-125000,0,0,0,148000,273000,-125000,-125000
058766,力山兆豐99購01  ,0,0,0,0,0,0,0,0,0,-125000,0,0,0,289000,414000,-125000,-125000
059242,南亞科凱基99購06,0,0,0,0,0,0,0,0,0,-125000,0,0,0,0,125000,-125000,-125000
059154,可成日盛99購02  ,0,0,0,0,0,0,0,0,0,-125000,0,0,0,20000,145000,-125000,-125000
058683,可成凱基9A購01  ,0,0,0,0,0,0,0,0,0,-125000,0,0,0,4000,129000,-125000,-125000
056203,興富發永豐97購01,0,0,0,0,0,0,0,0,0,-125000,0,0,0,0,125000,-125000,-125000
3149,正達            ,7000,132000,-125000,0,0,0,0,0,0,0,0,0,0,0,0,0,-125000
060032,利勤永豐99購01  ,0,0,0,0,0,0,0,0,0,-126000,0,0,0,0,126000,-126000,-126000
056801,國巨台新98購01  ,0,0,0,0,0,0,0,0,0,-126000,0,0,0,26000,152000,-126000,-126000
058428,大立光元富99購02,0,0,0,0,0,0,0,0,0,-126000,0,0,0,81000,207000,-126000,-126000
051325,台光電台新96購01,0,0,0,0,0,0,0,0,0,-127000,0,0,0,36000,163000,-127000,-127000
062035,瑞祺群益9B購01  ,0,0,0,0,0,0,0,0,0,-128000,0,0,0,16000,144000,-128000,-128000
1304,台聚            ,145000,273000,-128000,0,0,0,0,0,0,0,0,0,0,0,0,0,-128000
061606,景碩凱基9A購02  ,0,0,0,0,0,0,0,0,0,-129000,0,0,0,149000,278000,-129000,-129000
061620,禾伸堂群益9A購02,0,0,0,0,0,0,0,0,0,-129000,0,0,0,433000,562000,-129000,-129000
059836,大立光國泰9B購02,0,0,0,0,0,0,0,0,0,-129000,0,0,0,40000,169000,-129000,-129000
061144,玉晶光中信9B購02,0,0,0,0,0,0,0,0,0,-129000,0,0,0,335000,464000,-129000,-129000
053048,同欣電麥證96購01,0,0,0,1000,130000,-129000,0,0,0,-129000,0,0,0,1000,130000,-129000,-129000
055958,台光電元大97購02,0,0,0,0,0,0,0,0,0,-129000,0,0,0,118000,247000,-129000,-129000
058663,瑞儀兆豐9A購01  ,0,0,0,0,0,0,0,0,0,-129000,0,0,0,0,129000,-129000,-129000
07894P,燿華元大9B售01  ,0,0,0,0,0,0,0,0,0,-129000,0,0,0,50000,179000,-129000,-129000
3311,閎暉            ,15000,144000,-129000,0,0,0,0,0,0,0,0,0,0,0,0,0,-129000
6141,柏承            ,99000,228000,-129000,0,0,0,0,0,0,0,0,0,0,0,0,0,-129000
059928,道瓊銀富邦03購01,0,0,0,0,0,0,0,0,0,-130000,0,0,0,13000,143000,-130000,-130000
060365,京鼎元富9A購01  ,0,0,0,0,0,0,0,0,0,-130000,0,0,0,10000,140000,-130000,-130000
062090,南電元大9B購02  ,0,0,0,0,0,0,0,0,0,-130000,0,0,0,7000,137000,-130000,-130000
052939,富邦金兆豐96購01,0,0,0,0,0,0,0,0,0,-130000,0,0,0,0,130000,-130000,-130000
057573,京鼎永豐98購02  ,0,0,0,0,0,0,0,0,0,-130000,0,0,0,4000,134000,-130000,-130000
058394,元油2X元大99購14,0,0,0,0,0,0,0,0,0,-130000,0,0,0,0,130000,-130000,-130000
059248,華新科凱基99購04,0,0,0,0,0,0,0,0,0,-130000,0,0,0,0,130000,-130000,-130000
6269,台郡            ,655000,733000,-78000,0,0,0,197000,480000,-283000,231000,266000,13000,253000,14000,36000,-22000,-130000
2511,太子            ,82000,212000,-130000,0,0,0,0,0,0,0,0,0,0,0,0,0,-130000
057074,立積永豐98購01  ,0,0,0,0,0,0,0,0,0,-131000,0,0,0,82000,213000,-131000,-131000
057599,技嘉群益9A購01  ,0,0,0,0,0,0,0,0,0,-131000,0,0,0,98000,229000,-131000,-131000
07667P,亞德客元大9A售05,0,0,0,0,0,0,0,0,0,-131000,0,0,0,0,131000,-131000,-131000
06243P,亞光元富97售01  ,0,0,0,0,0,0,0,0,0,-132000,0,0,0,5000,137000,-132000,-132000
060683,泰鼎元大9A購02  ,0,0,0,0,0,0,0,0,0,-132000,0,0,0,50000,182000,-132000,-132000
049439,牧德國泰96購01  ,0,0,0,0,0,0,0,0,0,-132000,0,0,0,0,132000,-132000,-132000
07677P,祥碩永豐9A售01  ,0,0,0,0,0,0,0,0,0,-132000,0,0,0,110000,242000,-132000,-132000
07885P,長榮航凱基9B售01,0,0,0,0,0,0,0,0,0,-132000,0,0,0,0,132000,-132000,-132000
07835P,台表科群益9A售02,0,0,0,0,0,0,0,0,0,-132000,0,0,0,3000,135000,-132000,-132000
07905P,大立光群益9B售04,57000,0,57000,0,0,0,0,0,0,-189000,0,0,0,0,189000,-189000,-132000
2501,國建            ,29000,161000,-132000,0,0,0,0,0,0,0,0,0,0,0,0,0,-132000
3052,夆典            ,23000,155000,-132000,0,0,0,0,0,0,0,0,0,0,0,0,0,-132000
6477,安集            ,20000,152000,-132000,0,0,0,0,0,0,0,0,0,0,0,0,0,-132000
062061,台勝科統一01購01,2000,0,2000,0,0,0,0,0,0,-135000,0,0,0,256000,391000,-135000,-133000
061505,力成國票9A購03  ,0,0,0,0,0,0,0,0,0,-133000,0,0,0,38000,171000,-133000,-133000
057660,訊芯兆豐98購02  ,0,0,0,0,0,0,0,0,0,-133000,0,0,0,0,133000,-133000,-133000
2702,華園            ,12000,145000,-133000,0,0,0,0,0,0,0,0,0,0,0,0,0,-133000
2388,威盛            ,57000,190000,-133000,0,0,0,0,0,0,0,0,0,0,0,0,0,-133000
060953,富邦金群益9A購01,0,0,0,0,0,0,0,0,0,-134000,0,0,0,0,134000,-134000,-134000
060406,瑞祺國泰9B購01  ,0,0,0,0,0,0,0,0,0,-134000,0,0,0,114000,248000,-134000,-134000
060829,T50反1國票9A購06,0,0,0,0,0,0,0,0,0,-135000,0,0,0,5000,140000,-135000,-135000
06072P,牧德永豐97售01  ,0,0,0,0,0,0,0,0,0,-135000,0,0,0,40000,175000,-135000,-135000
061579,京鼎元大9A購02  ,0,0,0,0,0,0,0,0,0,-135000,0,0,0,72000,207000,-135000,-135000
00703,台新MSCI中國    ,1000,1000,0,0,0,0,0,0,0,-135000,0,0,0,114000,249000,-135000,-135000
059061,晶技凱基9A購01  ,0,0,0,0,0,0,0,0,0,-135000,0,0,0,94000,229000,-135000,-135000
053677,同欣電國泰97購01,0,0,0,0,0,0,0,0,0,-135000,0,0,0,0,135000,-135000,-135000
056584,鴻海統一9B購01  ,0,0,0,0,0,0,0,0,0,-135000,0,0,0,4000,139000,-135000,-135000
059468,智邦元大99購02  ,0,0,0,0,0,0,0,0,0,-135000,0,0,0,0,135000,-135000,-135000
3419,譁裕            ,25000,160000,-135000,0,0,0,0,0,0,0,0,0,0,0,0,0,-135000
07898P,國巨國泰9C售02  ,0,0,0,0,0,0,0,0,0,-135000,0,0,0,110000,245000,-135000,-135000
061887,祥碩國泰9C購01  ,0,0,0,0,0,0,0,0,0,-136000,0,0,0,13000,149000,-136000,-136000
03443B,臺股指凱基9A熊27,0,0,0,0,0,0,0,0,0,-136000,0,0,0,524000,660000,-136000,-136000
046937,聯電元大99購01  ,0,0,0,0,0,0,0,0,0,-136000,0,0,0,119000,255000,-136000,-136000
058686,祥碩凱基99購03  ,0,0,0,0,0,0,0,0,0,-136000,0,0,0,303000,439000,-136000,-136000
055730,建準元富97購02  ,0,0,0,0,0,0,0,0,0,-136000,0,0,0,191000,327000,-136000,-136000
6155,鈞寶            ,221000,357000,-136000,0,0,0,0,0,0,0,0,0,0,0,0,0,-136000
07649P,金像電永豐9A售02,0,0,0,0,0,0,0,0,0,-137000,0,0,0,209000,346000,-137000,-137000
06371P,茂林國票98售04  ,0,0,0,0,0,0,0,0,0,-138000,0,0,0,48000,186000,-138000,-138000
061109,臻鼎元大9A購03  ,0,0,0,0,0,0,0,0,0,-138000,0,0,0,73000,211000,-138000,-138000
060409,味全永豐9A購01  ,0,0,0,0,0,0,0,0,0,-138000,0,0,0,384000,522000,-138000,-138000
060375,葡萄王元富9A購01,0,0,0,0,0,0,0,0,0,-138000,0,0,0,388000,526000,-138000,-138000
050322,世紀鋼國票95購01,0,0,0,0,0,0,0,0,0,-138000,0,0,0,10000,148000,-138000,-138000
056121,勤誠群益97購01  ,0,0,0,0,0,0,0,0,0,-138000,0,0,0,18000,156000,-138000,-138000
2723,美食-KY         ,121000,259312,-138312,0,0,0,0,0,0,0,7000,7000,0,0,0,0,-138312
059844,大立光富邦9C購04,0,0,0,0,0,0,0,0,0,-139000,0,0,0,52000,191000,-139000,-139000
060942,智邦國票9A購02  ,0,0,0,0,0,0,0,0,0,-139000,0,0,0,251000,390000,-139000,-139000
061286,大立光統一9A購05,0,0,0,0,0,0,0,0,0,-139000,0,0,0,12000,151000,-139000,-139000
051872,矽力凱基96購01  ,0,0,0,0,0,0,0,0,0,-139000,0,0,0,10000,149000,-139000,-139000
053094,聯電統一97購02  ,0,0,0,0,0,0,0,0,0,-139000,0,0,0,60000,199000,-139000,-139000
055861,矽力元大97購03  ,0,0,0,0,0,0,0,0,0,-139000,0,0,0,34000,173000,-139000,-139000
061991,牧德元大9C購01  ,0,0,0,0,0,0,0,0,0,-140000,0,0,0,268000,408000,-140000,-140000
059911,國巨元大99購27  ,0,0,0,0,0,0,0,0,0,-140000,0,0,0,36000,176000,-140000,-140000
051722,玉晶光永豐97購01,0,0,0,0,0,0,0,0,0,-140000,0,0,0,168000,308000,-140000,-140000
056405,聯茂群益98購01  ,0,0,0,0,0,0,0,0,0,-140000,0,0,0,65000,205000,-140000,-140000
2637,慧洋-KY         ,48000,188000,-140000,0,0,0,0,0,0,0,0,0,0,0,0,0,-140000
060282,聚陽元大9A購01  ,0,0,0,0,0,0,0,0,0,-141000,0,0,0,64000,205000,-141000,-141000
062040,玉晶光凱基01購01,0,0,0,0,0,0,0,0,0,-141000,0,0,0,5000,146000,-141000,-141000
059065,南電凱基9A購01  ,0,0,0,0,0,0,0,0,0,-141000,0,0,0,122000,263000,-141000,-141000
057106,美律群益98購03  ,0,0,0,0,0,0,0,0,0,-141000,0,0,0,3000,144000,-141000,-141000
3014,聯陽            ,607000,684000,-77000,0,0,0,0,0,0,-64000,0,0,0,4000,68000,-64000,-141000
3022,威強電          ,96000,237000,-141000,0,0,0,0,0,0,0,0,0,0,0,0,0,-141000
1218,泰山            ,219000,360423,-141423,0,0,0,0,0,0,0,0,0,0,0,0,0,-141423
055288,日電貿元大97購02,0,0,0,0,0,0,0,0,0,-142000,0,0,0,110000,252000,-142000,-142000
046630,京元電元富95購03,0,0,0,0,0,0,0,0,0,-142000,0,0,0,50000,192000,-142000,-142000
057849,南茂永豐98購02  ,0,0,0,0,0,0,0,0,0,-142000,0,0,0,20000,162000,-142000,-142000
07711P,世芯元大9A售07  ,0,0,0,0,0,0,0,0,0,-142000,0,0,0,50000,192000,-142000,-142000
061597,南六永豐9A購04  ,0,0,0,0,0,0,0,0,0,-143000,0,0,0,116000,259000,-143000,-143000
057582,亞光中信9A購02  ,0,0,0,0,0,0,0,0,0,-143000,0,0,0,135000,278000,-143000,-143000
2605,新興            ,204000,368000,-164000,0,0,0,0,0,0,20000,20000,0,20000,0,0,0,-144000
061994,瑞儀元大9B購01  ,0,0,0,0,0,0,0,0,0,-145000,0,0,0,0,145000,-145000,-145000
060384,葡萄王凱基9B購01,0,0,0,0,0,0,0,0,0,-145000,0,0,0,58000,203000,-145000,-145000
053056,同欣電國票97購01,0,0,0,0,0,0,0,0,0,-145000,0,0,0,275000,420000,-145000,-145000
8464,億豐            ,170000,314900,-144900,0,0,0,0,0,0,-1000,0,1000,-1000,0,0,0,-145900
060414,中興電永豐9A購01,10000,0,10000,0,0,0,0,0,0,-156000,0,0,0,108000,264000,-156000,-146000
061993,祥碩元大9C購01  ,1000,0,1000,0,0,0,0,0,0,-147000,0,0,0,0,147000,-147000,-146000
057700,新日興群益9A購01,0,0,0,0,0,0,0,0,0,-146000,0,0,0,186000,332000,-146000,-146000
8213,志超            ,415000,498000,-83000,0,0,0,0,0,0,-63000,70000,0,70000,18000,151000,-133000,-146000
4104,佳醫            ,29000,175000,-146000,0,0,0,0,0,0,0,0,0,0,0,0,0,-146000
2415,錩新            ,1000,147000,-146000,0,0,0,0,0,0,0,0,0,0,0,0,0,-146000
061970,大立光統一9C購03,0,0,0,0,0,0,0,0,0,-147000,0,0,0,0,147000,-147000,-147000
053502,智伸科兆豐97購01,0,0,0,0,0,0,0,0,0,-147000,0,0,0,0,147000,-147000,-147000
057103,禾伸堂中信9A購01,0,0,0,0,0,0,0,0,0,-147000,0,0,0,21000,168000,-147000,-147000
056922,全新兆豐99購01  ,0,0,0,0,0,0,0,0,0,-148000,0,0,0,0,148000,-148000,-148000
1464,得力            ,62000,208000,-146000,0,0,0,0,0,0,-2000,0,0,0,0,2000,-2000,-148000
07106P,國巨統一9B售05  ,0,0,0,0,0,0,0,0,0,-148000,0,0,0,13000,161000,-148000,-148000
052326,滬深反中信99購01,0,0,0,0,0,0,0,0,0,-149000,0,0,0,0,149000,-149000,-149000
052654,友達統一97購01  ,0,0,0,0,0,0,0,0,0,-150000,0,0,0,0,150000,-150000,-150000
055174,精元統一97購01  ,0,0,0,0,0,0,0,0,0,-150000,0,0,0,865000,1015000,-150000,-150000
055265,玉晶光永豐98購03,0,0,0,0,0,0,0,0,0,-150000,0,0,0,10000,160000,-150000,-150000
056951,牧德統一99購01  ,0,0,0,0,0,0,0,0,0,-150000,0,0,0,173000,323000,-150000,-150000
057425,臺股指凱基9C購02,0,0,0,0,0,0,0,0,0,-150000,0,0,0,0,150000,-150000,-150000
4155,訊映            ,8000,158000,-150000,0,0,0,0,0,0,0,0,0,0,0,0,0,-150000
05538P,玉晶光國票97售02,0,0,0,0,0,0,0,0,0,-151000,0,0,0,310000,461000,-151000,-151000
051911,大立光元大98購02,0,0,0,0,0,0,0,0,0,-152000,0,0,0,91000,243000,-152000,-152000
02001L,富邦蘋果正二N   ,0,0,0,0,0,0,0,0,0,-152000,0,0,0,2000,154000,-152000,-152000
059107,南茂國泰9A購01  ,0,0,0,0,0,0,0,0,0,-152000,0,0,0,31000,183000,-152000,-152000
9907,統一實          ,234000,386000,-152000,0,0,0,0,0,0,0,0,0,0,0,0,0,-152000
061033,台光電永豐9A購01,0,0,0,0,0,0,0,0,0,-153000,0,0,0,691000,844000,-153000,-153000
055887,上銀統一97購03  ,0,0,0,0,0,0,0,0,0,-153000,0,0,0,0,153000,-153000,-153000
07482P,南亞科元富9A售04,0,0,0,0,0,0,0,0,0,-153000,0,0,0,13000,166000,-153000,-153000
05088P,大立光富邦99售01,0,0,0,0,0,0,0,0,0,-154000,0,0,0,0,154000,-154000,-154000
055432,臻鼎群益97購02  ,0,0,0,0,0,0,0,0,0,-154000,0,0,0,0,154000,-154000,-154000
055824,臺股指國票97購11,0,0,0,0,0,0,0,0,0,-154000,0,0,0,100000,254000,-154000,-154000
07513P,台積電元大9A售13,0,0,0,0,0,0,0,0,0,-154000,0,0,0,0,154000,-154000,-154000
5215,科嘉-KY         ,64000,218000,-154000,0,0,0,0,0,0,0,10000,10000,0,0,0,0,-154000
058970,鴻海永豐99購02  ,0,0,0,0,0,0,0,0,0,-155000,0,0,0,340000,495000,-155000,-155000
053551,可成凱基96購05  ,0,0,0,0,0,0,0,0,0,-155000,0,0,0,0,155000,-155000,-155000
050884,聯茂國泰96購01  ,0,0,0,0,0,0,0,0,0,-155000,0,0,0,0,155000,-155000,-155000
00652,富邦印度        ,4000,0,4000,0,0,0,0,0,0,-159000,0,0,0,30000,189000,-159000,-155000
060782,道瓊指富邦9C購01,0,0,0,0,0,0,0,0,0,-156000,0,0,0,54000,210000,-156000,-156000
059786,全新元大99購06  ,0,0,0,0,0,0,0,0,0,-156000,0,0,0,97000,253000,-156000,-156000
060043,全新群益9B購02  ,0,0,0,0,0,0,0,0,0,-156000,0,0,0,90000,246000,-156000,-156000
056787,健鼎群益98購01  ,0,0,0,0,0,0,0,0,0,-156000,0,0,0,53000,209000,-156000,-156000
056335,微星凱基98購01  ,0,0,0,0,0,0,0,0,0,-156000,0,0,0,4000,160000,-156000,-156000
056991,牧德兆豐98購01  ,0,0,0,0,0,0,0,0,0,-156000,0,0,0,126000,282000,-156000,-156000
058328,世紀鋼統一9B購01,0,20000,-20000,0,0,0,0,0,0,-136000,0,0,0,241000,377000,-136000,-156000
054079,鴻海中信98購02  ,0,0,0,0,0,0,0,0,0,-157000,0,0,0,0,157000,-157000,-157000
057575,世紀鋼永豐98購02,0,0,0,0,0,0,0,0,0,-157000,0,0,0,19000,176000,-157000,-157000
4968,立積            ,125000,438000,-313000,0,0,0,220000,30000,190000,-34000,0,25000,-25000,29000,38000,-9000,-157000
5203,訊連            ,95000,245000,-150000,0,0,0,0,0,0,-7000,4000,0,4000,2000,13000,-11000,-157000
2371,大同            ,1760000,2010000,-250000,0,0,0,0,0,0,93000,151000,58000,93000,0,0,0,-157000
060204,矽創元富9A購01  ,0,0,0,0,0,0,0,0,0,-158000,0,0,0,83000,241000,-158000,-158000
060632,可成富邦9B購01  ,0,0,0,0,0,0,0,0,0,-158000,0,0,0,357000,515000,-158000,-158000
061074,儒鴻兆豐9B購01  ,0,0,0,0,0,0,0,0,0,-158000,0,0,0,22000,180000,-158000,-158000
061598,南電永豐9A購04  ,0,0,0,0,0,0,0,0,0,-158000,0,0,0,9000,167000,-158000,-158000
061177,大立光凱基9A購10,0,0,0,0,0,0,0,0,0,-158000,0,0,0,0,158000,-158000,-158000
057176,全新元大99購02  ,0,0,0,0,0,0,0,0,0,-158000,0,0,0,106000,264000,-158000,-158000
6209,今國光          ,44000,202000,-158000,0,0,0,0,0,0,0,0,0,0,0,0,0,-158000
062029,牧德群益9B購03  ,0,0,0,0,0,0,0,0,0,-159000,0,0,0,14000,173000,-159000,-159000
060455,葡萄王元大9A購02,0,0,0,0,0,0,0,0,0,-159000,0,0,0,216000,375000,-159000,-159000
056228,可成凱基97購03  ,0,0,0,0,0,0,0,0,0,-159000,0,0,0,44000,203000,-159000,-159000
6288,聯嘉            ,123000,282000,-159000,0,0,0,0,0,0,0,0,0,0,0,0,0,-159000
07006P,旺宏統一9B售03  ,0,0,0,0,0,0,0,0,0,-159000,0,0,0,10000,169000,-159000,-159000
062011,上銀富邦9C購01  ,0,0,0,0,0,0,0,0,0,-160000,0,0,0,0,160000,-160000,-160000
053422,可成永豐96購01  ,0,0,0,0,0,0,0,0,0,-160000,0,0,0,49000,209000,-160000,-160000
055080,正崴中信99購01  ,0,0,0,0,0,0,0,0,0,-160000,0,0,0,0,160000,-160000,-160000
04936P,大立光中信95售03,0,0,0,0,0,0,0,0,0,-160000,0,0,0,0,160000,-160000,-160000
056744,麗豐凱基9A購01  ,0,0,0,0,0,0,0,0,0,-160000,0,0,0,0,160000,-160000,-160000
059195,國巨永豐99購04  ,0,0,0,0,0,0,0,0,0,-160000,0,0,0,0,160000,-160000,-160000
3515,華擎            ,206000,398000,-192000,0,0,0,0,0,0,32000,65000,0,65000,33000,66000,-33000,-160000
06068P,玉晶光康和97售01,0,0,0,0,0,0,0,0,0,-161000,0,0,0,71000,232000,-161000,-161000
2006,東和鋼鐵        ,27000,123000,-96000,0,0,0,0,0,0,-65000,0,65000,-65000,0,0,0,-161000
2101,南港            ,416000,545000,-129000,0,0,0,0,0,0,-32000,0,0,0,26000,58000,-32000,-161000
07560P,台積電國泰9B售01,0,0,0,0,0,0,0,0,0,-161000,0,0,0,0,161000,-161000,-161000
06899P,嘉澤群益98售01  ,0,0,0,0,0,0,0,0,0,-162000,0,0,0,0,162000,-162000,-162000
057549,台光電凱基98購05,0,0,0,0,0,0,0,0,0,-162000,0,0,0,10000,172000,-162000,-162000
057774,台光電群益99購02,0,0,0,0,0,0,0,0,0,-162000,0,0,0,106000,268000,-162000,-162000
6230,超眾            ,130000,181000,-51000,0,0,0,0,0,0,-111000,0,33000,-33000,21000,99000,-78000,-162000
4960,誠美材          ,148000,310000,-162000,0,0,0,0,0,0,0,0,0,0,0,0,0,-162000
06170P,禾伸堂元富97售02,0,0,0,0,0,0,0,0,0,-163000,0,0,0,0,163000,-163000,-163000
06023P,超眾國票96售03  ,0,0,0,0,0,0,0,0,0,-163000,0,0,0,7000,170000,-163000,-163000
054750,聯茂凱基98購02  ,0,0,0,0,0,0,0,0,0,-163000,0,0,0,6000,169000,-163000,-163000
4763,材料-KY         ,7000,174000,-167000,0,0,0,0,0,0,4000,17000,13000,4000,0,0,0,-163000
8110,華東            ,153000,324000,-171000,0,0,0,0,0,0,8000,8000,0,8000,0,0,0,-163000
1598,岱宇            ,316000,479002,-163002,0,0,0,0,0,0,0,0,0,0,0,0,0,-163002
06744P,嘉聯益永豐98售03,0,0,0,0,0,0,0,0,0,-164000,0,0,0,0,164000,-164000,-164000
06725P,聯電元富98售01  ,0,0,0,0,0,0,0,0,0,-164000,0,0,0,95000,259000,-164000,-164000
059656,T50反1元大99購11,0,0,0,0,0,0,0,0,0,-164000,0,0,0,7000,171000,-164000,-164000
9802,鈺齊-KY         ,230000,276000,-46000,0,0,0,0,57000,-57000,-61000,0,30000,-30000,1000,32000,-31000,-164000
06010P,國泰金元富96售01,0,0,0,0,0,0,0,0,0,-165000,0,0,0,8000,173000,-165000,-165000
05545P,台表科國泰98售01,0,0,0,0,0,0,0,0,0,-165000,0,0,0,7000,172000,-165000,-165000
4904,遠傳            ,951000,1107000,-156000,0,0,0,2000,0,2000,-11000,2000,6000,-4000,0,7000,-7000,-165000
060072,國巨元富99購04  ,0,0,0,0,0,0,0,0,0,-166000,0,0,0,0,166000,-166000,-166000
061047,大立光第一9A購01,0,0,0,0,0,0,0,0,0,-166000,0,0,0,0,166000,-166000,-166000
1608,華榮            ,43000,209000,-166000,0,0,0,0,0,0,0,0,0,0,0,0,0,-166000
3060,銘異            ,101000,267000,-166000,0,0,0,0,0,0,0,0,0,0,0,0,0,-166000
061242,玉晶光兆豐9B購02,0,0,0,0,0,0,0,0,0,-167000,0,0,0,30000,197000,-167000,-167000
055555,全新凱基9A購01  ,0,0,0,0,0,0,0,0,0,-167000,0,0,0,2000,169000,-167000,-167000
2615,萬海            ,80000,246000,-166000,0,0,0,0,0,0,-1000,0,1000,-1000,0,0,0,-167000
2369,菱生            ,371000,538000,-167000,0,0,0,0,0,0,0,0,0,0,0,0,0,-167000
07060P,台表科國票9A售01,0,0,0,0,0,0,0,0,0,-167000,0,0,0,40000,207000,-167000,-167000
061780,國巨群益9C購01  ,0,0,0,0,0,0,0,0,0,-168000,0,0,0,120000,288000,-168000,-168000
053662,矽力凱基97購01  ,0,0,0,0,0,0,0,0,0,-168000,0,0,0,6000,174000,-168000,-168000
2380,虹光            ,44000,212000,-168000,0,0,0,0,0,0,0,0,0,0,0,0,0,-168000
061696,南茂群益9A購01  ,0,0,0,0,0,0,0,0,0,-169000,0,0,0,95000,264000,-169000,-169000
060550,可成凱基9A購02  ,0,0,0,0,0,0,0,0,0,-169000,0,0,0,4000,173000,-169000,-169000
060112,祥碩元大99購04  ,0,0,0,0,0,0,0,0,0,-169000,0,0,0,142000,311000,-169000,-169000
055402,正文元富97購02  ,0,0,0,0,0,0,0,0,0,-169000,0,0,0,25000,194000,-169000,-169000
00717,富邦美國特別股  ,0,0,0,0,0,0,0,0,0,-169000,0,0,0,476000,645000,-169000,-169000
056577,玉晶光元大99購06,0,0,0,0,0,0,0,0,0,-169000,0,0,0,278000,447000,-169000,-169000
2208,台船            ,203000,372000,-169000,0,0,0,0,0,0,0,0,0,0,0,0,0,-169000
055056,億光永豐97購01  ,0,0,0,0,0,0,0,0,0,-170000,0,0,0,0,170000,-170000,-170000
059480,美律群益9A購01  ,0,0,0,0,0,0,0,0,0,-170000,0,0,0,0,170000,-170000,-170000
060867,智伸科永豐9A購01,0,0,0,0,0,0,0,0,0,-171000,0,0,0,322000,493000,-171000,-171000
054912,群光凱基97購01  ,0,0,0,0,0,0,0,0,0,-171000,0,0,0,0,171000,-171000,-171000
057450,國泰金元富98購01,0,0,0,0,0,0,0,0,0,-171000,0,0,0,185000,356000,-171000,-171000
07652P,臺股指中信9A售07,0,0,0,0,0,0,0,0,0,-171000,0,0,0,220000,391000,-171000,-171000
056448,全新凱基99購01  ,0,0,0,0,0,0,0,0,0,-172000,0,0,0,40000,212000,-172000,-172000
054776,矽創國票98購01  ,0,0,0,0,0,0,0,0,0,-173000,0,0,0,0,173000,-173000,-173000
061181,牧德凱基9A購01  ,0,0,0,0,0,0,0,0,0,-175000,0,0,0,208000,383000,-175000,-175000
6139,亞翔            ,35000,210000,-175000,0,0,0,0,0,0,0,0,0,0,0,0,0,-175000
8404,百和興業-KY     ,135000,310000,-175000,0,0,0,0,0,0,0,0,0,0,0,0,0,-175000
057385,光罩永豐99購01  ,0,0,0,0,0,0,0,0,0,-176000,0,0,0,67000,243000,-176000,-176000
057955,技嘉元大98購07  ,0,0,0,0,0,0,0,0,0,-176000,0,0,0,132000,308000,-176000,-176000
061595,智易永豐9A購02  ,0,0,0,0,0,0,0,0,0,-177000,0,0,0,60000,237000,-177000,-177000
058431,國巨統一9B購01  ,0,0,0,0,0,0,0,0,0,-178000,0,0,0,160000,338000,-178000,-178000
9945,潤泰新          ,397000,572111,-175111,0,0,0,0,0,0,-3000,0,0,0,0,3000,-3000,-178111
00643,群益深証中小    ,46000,264000,-218000,0,0,0,0,0,0,39000,0,0,0,115000,76000,39000,-179000
060551,大立光凱基9B購02,0,0,0,0,0,0,0,0,0,-180000,0,0,0,0,180000,-180000,-180000
060552,群創凱基9B購05  ,0,0,0,0,0,0,0,0,0,-180000,0,0,0,6000,186000,-180000,-180000
053723,奇鋐凱基98購01  ,0,0,0,0,0,0,0,0,0,-180000,0,0,0,40000,220000,-180000,-180000
056256,聯茂元富97購03  ,0,0,0,0,0,0,0,0,0,-180000,0,0,0,50000,230000,-180000,-180000
07591P,台灣50元大9A售16,0,0,0,0,0,0,0,0,0,-180000,0,0,0,0,180000,-180000,-180000
059870,全新凱基99購05  ,0,0,0,0,0,0,0,0,0,-181000,0,0,0,231000,412000,-181000,-181000
06017P,亞光凱基96售04  ,0,0,0,0,0,0,0,0,0,-181000,0,0,0,0,181000,-181000,-181000
059153,臺股指國票99購16,0,0,0,0,0,0,0,0,0,-181000,0,0,0,42000,223000,-181000,-181000
3047,訊舟            ,25000,206000,-181000,0,0,0,0,0,0,0,0,0,0,0,0,0,-181000
6558,興能高          ,116000,297000,-181000,0,0,0,0,0,0,0,0,0,0,0,0,0,-181000
060715,日電貿永豐9A購01,0,0,0,0,0,0,0,0,0,-182000,0,0,0,68000,250000,-182000,-182000
061131,崇越永豐9A購01  ,0,0,0,0,0,0,0,0,0,-182000,0,0,0,0,182000,-182000,-182000
059273,臺指反元大9C購03,0,0,0,0,0,0,0,0,0,-182000,0,0,0,0,182000,-182000,-182000
056942,昇陽半元富98購01,0,0,0,0,0,0,0,0,0,-182000,0,0,0,11000,193000,-182000,-182000
1905,華紙            ,82000,264000,-182000,0,0,0,0,0,0,0,0,0,0,0,0,0,-182000
054749,聯茂凱基98購01  ,0,0,0,0,0,0,0,0,0,-183000,0,0,0,11000,194000,-183000,-183000
07457P,宏達電元大9A售01,0,0,0,0,0,0,0,0,0,-183000,0,0,0,0,183000,-183000,-183000
062145,億光國票9B購01  ,0,0,0,0,0,0,0,0,0,-184000,0,0,0,0,184000,-184000,-184000
058973,麗豐永豐99購01  ,0,0,0,0,0,0,0,0,0,-184000,0,0,0,75000,259000,-184000,-184000
054627,義隆凱基98購01  ,0,0,0,0,0,0,0,0,0,-184000,0,0,0,18000,202000,-184000,-184000
059249,大立光凱基99購05,0,0,0,0,0,0,0,0,0,-184000,0,0,0,3000,187000,-184000,-184000
9935,慶豐富          ,105000,289000,-184000,0,0,0,0,0,0,0,0,0,0,0,0,0,-184000
061908,台積電中信05購01,0,0,0,0,0,0,0,0,0,-185000,0,0,0,48000,233000,-185000,-185000
061289,玉晶光統一01購03,0,0,0,0,0,0,0,0,0,-185000,0,0,0,142000,327000,-185000,-185000
060415,葡萄王永豐9A購01,0,0,0,0,0,0,0,0,0,-185000,0,0,0,130000,315000,-185000,-185000
058153,景碩統一9B購01  ,0,0,0,0,0,0,0,0,0,-185000,0,0,0,307000,492000,-185000,-185000
058374,玉晶光凱基9A購03,0,0,0,0,0,0,0,0,0,-185000,0,0,0,31000,216000,-185000,-185000
056451,可成凱基99購01  ,0,0,0,0,0,0,0,0,0,-185000,0,0,0,16000,201000,-185000,-185000
058994,道瓊指元大99購01,0,0,0,0,0,0,0,0,0,-186000,0,0,0,14000,200000,-186000,-186000
059580,大立光元富99購07,0,0,0,0,0,0,0,0,0,-186000,0,0,0,61000,247000,-186000,-186000
052959,聯電凱基97購01  ,0,0,0,0,0,0,0,0,0,-187000,0,0,0,4000,191000,-187000,-187000
057146,技嘉國票98購01  ,0,0,0,0,0,0,0,0,0,-187000,0,0,0,169000,356000,-187000,-187000
056981,全新群益99購03  ,0,0,0,0,0,0,0,0,0,-187000,0,0,0,79000,266000,-187000,-187000
4961,天鈺            ,32000,219000,-187000,0,0,0,0,0,0,0,0,0,0,0,0,0,-187000
07334P,臺股指國票99售19,0,0,0,0,0,0,0,0,0,-187000,0,0,0,147000,334000,-187000,-187000
060721,瑞儀永豐9A購01  ,0,0,0,0,0,0,0,0,0,-188000,0,0,0,0,188000,-188000,-188000
054803,味全元大9A購01  ,0,0,0,0,0,0,0,0,0,-188000,0,0,0,1000,189000,-188000,-188000
061584,勤誠元大9A購01  ,0,0,0,0,0,0,0,0,0,-189000,0,0,0,536000,725000,-189000,-189000
061411,T50反1群益9A購05,0,0,0,0,0,0,0,0,0,-190000,0,0,0,152000,342000,-190000,-190000
055233,康友國票98購01  ,0,0,0,0,0,0,0,0,0,-190000,0,0,0,0,190000,-190000,-190000
051774,聯茂中信96購01  ,0,0,0,0,0,0,0,0,0,-190000,0,0,0,290000,480000,-190000,-190000
054540,泰鼎國票99購01  ,0,0,0,0,0,0,0,0,0,-191000,0,0,0,19000,210000,-191000,-191000
056599,臻鼎元富98購01  ,0,0,0,0,0,0,0,0,0,-191000,0,0,0,20000,211000,-191000,-191000
2485,兆赫            ,93000,293000,-200000,0,0,0,0,0,0,8000,16000,8000,8000,0,0,0,-192000
061662,瑞儀永豐9A購02  ,0,0,0,0,0,0,0,0,0,-193000,0,0,0,0,193000,-193000,-193000
057340,玉晶光元富98購04,0,0,0,0,0,0,0,0,0,-193000,0,0,0,23000,216000,-193000,-193000
058126,元油2X元大9C購02,0,0,0,0,0,0,0,0,0,-193000,0,0,0,0,193000,-193000,-193000
2537,聯上發          ,186000,379000,-193000,0,0,0,0,0,0,0,0,0,0,0,0,0,-193000
2362,藍天            ,77000,253000,-176000,0,0,0,0,0,0,-17000,0,0,0,0,17000,-17000,-193000
056819,奇力新永豐98購01,0,0,0,0,0,0,0,0,0,-194000,0,0,0,0,194000,-194000,-194000
060590,台積電台新9C購02,0,0,0,0,0,0,0,0,0,-195000,0,0,0,5000,200000,-195000,-195000
057683,技嘉日盛98購01  ,0,0,0,0,0,0,0,0,0,-196000,0,0,0,46000,242000,-196000,-196000
057847,聯茂永豐98購01  ,0,0,0,0,0,0,0,0,0,-196000,0,0,0,53000,249000,-196000,-196000
056219,T50反1日盛02購01,0,0,0,0,0,0,0,0,0,-196000,0,0,0,0,196000,-196000,-196000
059375,道瓊反群益9C購02,0,0,0,0,0,0,0,0,0,-196000,0,0,0,10000,206000,-196000,-196000
057182,禾伸堂元大99購02,0,0,0,0,0,0,0,0,0,-196000,0,0,0,77000,273000,-196000,-196000
4306,炎洲            ,25000,226000,-201000,0,0,0,0,0,0,5000,8000,3000,5000,0,0,0,-196000
060311,盟立永豐9A購01  ,0,0,0,0,0,0,0,0,0,-197000,0,0,0,39000,236000,-197000,-197000
051791,智伸科國票96購01,0,0,0,0,0,0,0,0,0,-197000,0,0,0,0,197000,-197000,-197000
3380,明泰            ,887000,1535305,-648305,0,0,0,0,0,0,451000,775000,2000,773000,8000,330000,-322000,-197305
055257,景碩統一97購01  ,0,0,0,0,0,0,0,0,0,-198000,0,0,0,107000,305000,-198000,-198000
053671,可成統一96購03  ,0,0,0,0,0,0,0,0,0,-198000,0,0,0,40000,238000,-198000,-198000
056561,台光電群益98購02,0,0,0,0,0,0,0,0,0,-198000,0,0,0,28000,226000,-198000,-198000
3645,達邁            ,130000,328000,-198000,0,0,0,0,0,0,0,0,0,0,0,0,0,-198000
06506P,台郡國票99售02  ,0,0,0,0,0,0,0,0,0,-199000,0,0,0,0,199000,-199000,-199000
057830,T50反1台新02購02,0,0,0,0,0,0,0,0,0,-199000,0,0,0,0,199000,-199000,-199000
058434,旺宏統一9B購01  ,0,0,0,0,0,0,0,0,0,-199000,0,0,0,0,199000,-199000,-199000
2426,鼎元            ,326000,525000,-199000,0,0,0,0,0,0,0,0,0,0,0,0,0,-199000
061965,台積電統一02購02,0,0,0,0,0,0,0,0,0,-200000,0,0,0,0,200000,-200000,-200000
061557,台積電國票9C購02,0,0,0,0,0,0,0,0,0,-200000,0,0,0,0,200000,-200000,-200000
060789,禾伸堂富邦9B購02,0,0,0,0,0,0,0,0,0,-200000,0,0,0,8000,208000,-200000,-200000
053573,臺股指統一99購01,0,0,0,0,0,0,0,0,0,-200000,0,0,0,0,200000,-200000,-200000
053517,崇越群益97購01  ,0,0,0,0,0,0,0,0,0,-200000,0,0,0,0,200000,-200000,-200000
054558,劍麟群益99購01  ,0,0,0,0,0,0,0,0,0,-200000,0,0,0,0,200000,-200000,-200000
056487,康友元大98購01  ,0,0,0,0,0,0,0,0,0,-200000,0,0,0,0,200000,-200000,-200000
2399,映泰            ,216000,416000,-200000,0,0,0,0,0,0,0,0,0,0,0,0,0,-200000
060933,南電永豐9A購02  ,0,0,0,0,0,0,0,0,0,-201000,0,0,0,32000,233000,-201000,-201000
055746,同欣電元富97購01,0,0,0,0,0,0,0,0,0,-201000,0,0,0,194000,395000,-201000,-201000
059295,大立光元富99購05,0,0,0,0,0,0,0,0,0,-201000,0,0,0,105000,306000,-201000,-201000
058555,矽創永豐9A購01  ,0,0,0,0,0,0,0,0,0,-202000,0,0,0,232000,434000,-202000,-202000
046628,大立光統一98購01,0,0,0,0,0,0,0,0,0,-203000,0,0,0,458000,661000,-203000,-203000
054376,聯茂中信97購01  ,0,0,0,0,0,0,0,0,0,-203000,0,0,0,70000,273000,-203000,-203000
057773,技嘉群益9A購02  ,0,0,0,0,0,0,0,0,0,-203000,0,0,0,10000,213000,-203000,-203000
060561,台積電富邦04購01,0,0,0,0,0,0,0,0,0,-204000,0,0,0,446000,650000,-204000,-204000
060337,FBVIX統一9A購01 ,0,0,0,0,0,0,0,0,0,-204000,0,0,0,46000,250000,-204000,-204000
059975,元金2X元大99購02,0,0,0,0,0,0,0,0,0,-204000,0,0,0,152000,356000,-204000,-204000
1717,長興            ,548000,752000,-204000,0,0,0,0,0,0,0,0,0,0,0,0,0,-204000
06046P,健策統一96售03  ,0,0,0,0,0,0,0,0,0,-205000,0,0,0,129000,334000,-205000,-205000
057857,牧德國票99購01  ,0,0,0,0,0,0,0,0,0,-205000,0,0,0,161000,366000,-205000,-205000
060638,玉晶光永豐9A購04,0,0,0,0,0,0,0,0,0,-206000,0,0,0,18000,224000,-206000,-206000
056187,京鼎統一97購01  ,0,0,0,0,0,0,0,0,0,-206000,0,0,0,91000,297000,-206000,-206000
07503P,禾伸堂元大9A售01,0,0,0,0,0,0,0,0,0,-206000,0,0,0,5000,211000,-206000,-206000
054210,台光電國票97購03,0,0,0,0,0,0,0,0,0,-207000,0,0,0,0,207000,-207000,-207000
060666,聯茂凱基9A購02  ,0,0,0,0,0,0,0,0,0,-208000,0,0,0,109000,317000,-208000,-208000
061716,瑞儀凱基9B購01  ,0,0,0,0,0,0,0,0,0,-208000,0,0,0,0,208000,-208000,-208000
055144,T50反1元大97購03,0,0,0,0,0,0,0,0,0,-208000,0,0,0,0,208000,-208000,-208000
056670,樺漢國票99購01  ,0,0,0,0,0,0,0,0,0,-208000,0,0,0,26000,234000,-208000,-208000
057624,新日興國泰99購01,0,0,0,0,0,0,0,0,0,-208000,0,0,0,10000,218000,-208000,-208000
061446,鴻海中信04購01  ,0,0,0,0,0,0,0,0,0,-209000,0,0,0,42000,251000,-209000,-209000
057577,廣宇中信9A購01  ,0,0,0,0,0,0,0,0,0,-209000,0,0,0,199000,408000,-209000,-209000
057684,聯茂日盛99購01  ,0,0,0,0,0,0,0,0,0,-209000,0,0,0,154000,363000,-209000,-209000
1723,中碳            ,33000,242000,-209000,0,0,0,0,0,0,0,0,0,0,0,0,0,-209000
2332,友訊            ,294000,456000,-162000,0,0,0,0,0,0,-47000,4000,2000,2000,16000,65000,-49000,-209000
060963,禾伸堂凱基9A購01,0,0,0,0,0,0,0,0,0,-210000,0,0,0,18000,228000,-210000,-210000
054316,矽創凱基97購01  ,0,0,0,0,0,0,0,0,0,-210000,0,0,0,0,210000,-210000,-210000
053519,力成群益96購02  ,0,0,0,0,0,0,0,0,0,-210000,0,0,0,0,210000,-210000,-210000
053895,智易群益96購02  ,0,0,0,0,0,0,0,0,0,-211000,0,0,0,0,211000,-211000,-211000
059687,卜蜂永豐99購01  ,0,0,0,0,0,0,0,0,0,-211000,0,0,0,162000,373000,-211000,-211000
07899P,和大凱基9B售01  ,0,0,0,0,0,0,0,0,0,-211000,0,0,0,0,211000,-211000,-211000
060958,儒鴻凱基9A購02  ,0,0,0,0,0,0,0,0,0,-212000,0,0,0,13000,225000,-212000,-212000
062058,瑞昱統一01購01  ,0,0,0,0,0,0,0,0,0,-212000,0,0,0,0,212000,-212000,-212000
056297,台光電元大97購04,0,0,0,0,0,0,0,0,0,-215000,0,0,0,94000,309000,-215000,-215000
056418,台光電元富98購01,0,0,0,0,0,0,0,0,0,-215000,0,0,0,455000,670000,-215000,-215000
07307P,上証2X凱基9A售02,0,0,0,0,0,0,0,0,0,-215000,0,0,0,0,215000,-215000,-215000
055153,台光電元大98購02,0,0,0,0,0,0,0,0,0,-216000,0,0,0,318000,534000,-216000,-216000
062025,台達電群益9B購01,0,0,0,0,0,0,0,0,0,-217000,0,0,0,30000,247000,-217000,-217000
07255P,國巨凱基99售15  ,0,0,0,0,0,0,0,0,0,-217000,0,0,0,92000,309000,-217000,-217000
2458,義隆            ,1135000,1699400,-564400,0,0,0,500000,249000,251000,96000,201000,116000,85000,48000,37000,11000,-217400
054527,國巨統一97購03  ,0,0,0,0,0,0,0,0,0,-218000,0,0,0,142000,360000,-218000,-218000
058345,台光電群益99購03,0,0,0,0,0,0,0,0,0,-218000,0,0,0,306000,524000,-218000,-218000
2387,精元            ,181000,375000,-194000,0,0,0,0,0,0,-24000,0,0,0,98000,122000,-24000,-218000
07722P,玉晶光凱基9A售10,0,0,0,0,0,0,0,0,0,-218000,0,0,0,10000,228000,-218000,-218000
060553,祥碩凱基9A購01  ,0,0,0,0,0,0,0,0,0,-219000,0,0,0,0,219000,-219000,-219000
060249,正文元大9C購01  ,0,0,0,0,0,0,0,0,0,-219000,0,0,0,170000,389000,-219000,-219000
048870,義隆國票96購01  ,0,0,0,0,0,0,0,0,0,-219000,0,0,0,0,219000,-219000,-219000
056044,同欣電凱基97購03,0,0,0,0,0,0,0,0,0,-219000,0,0,0,96000,315000,-219000,-219000
058659,力成中信99購01  ,0,0,0,0,0,0,0,0,0,-219000,0,0,0,239000,458000,-219000,-219000
061442,玉晶光永豐9A購07,0,0,0,0,0,0,0,0,0,-220000,0,0,0,3000,223000,-220000,-220000
1305,華夏            ,313000,625000,-312000,0,0,0,0,0,0,90000,90000,0,90000,0,0,0,-222000
05692P,聯發科中信9A售02,0,0,0,0,0,0,0,0,0,-223000,0,0,0,0,223000,-223000,-223000
057404,貿聯群益99購01  ,0,0,0,0,0,0,0,0,0,-223000,0,0,0,0,223000,-223000,-223000
2439,美律            ,321000,499000,-178000,0,0,0,0,0,0,-45000,0,8000,-8000,12000,49000,-37000,-223000
2104,國際中橡        ,539000,724000,-185000,0,0,0,0,0,0,-39000,0,46000,-46000,7000,0,7000,-224000
058836,FBVIX中信03購05 ,0,0,0,0,0,0,0,0,0,-225000,0,0,0,83000,308000,-225000,-225000
059646,聯茂凱基99購06  ,0,0,0,0,0,0,0,0,0,-225000,0,0,0,242000,467000,-225000,-225000
2457,飛宏            ,62000,287000,-225000,0,0,0,0,0,0,0,0,0,0,0,0,0,-225000
053095,台光電統一98購01,0,0,0,0,0,0,0,0,0,-227000,0,0,0,224000,451000,-227000,-227000
058143,瑞儀元大99購02  ,0,0,0,0,0,0,0,0,0,-227000,0,0,0,10000,237000,-227000,-227000
3041,揚智            ,243000,470000,-227000,0,0,0,0,0,0,0,0,0,0,0,0,0,-227000
060891,世芯統一9A購01  ,0,0,0,0,0,0,0,0,0,-228000,0,0,0,70000,298000,-228000,-228000
056387,智伸科國泰99購01,0,0,0,0,0,0,0,0,0,-228000,0,0,0,0,228000,-228000,-228000
2891,中信金          ,8372000,8556320,-184320,0,0,0,26000,12000,14000,-58000,0,48000,-48000,0,10000,-10000,-228320
2548,華固            ,143587,392000,-248413,0,0,0,0,0,0,20000,20000,0,20000,0,0,0,-228413
049159,同欣電中信96購01,0,0,0,0,0,0,0,0,0,-230000,0,0,0,0,230000,-230000,-230000
053564,台積電富邦99購01,0,0,0,0,0,0,0,0,0,-230000,0,0,0,0,230000,-230000,-230000
1417,嘉裕            ,12000,243000,-231000,0,0,0,0,0,0,0,0,0,0,0,0,0,-231000
05546P,全新元大97售01  ,0,0,0,0,0,0,0,0,0,-232000,0,0,0,0,232000,-232000,-232000
054709,宏達電統一97購01,0,0,0,0,0,0,0,0,0,-233000,0,0,0,616000,849000,-233000,-233000
055181,日電貿統一97購01,0,0,0,0,0,0,0,0,0,-237000,0,0,0,0,237000,-237000,-237000
056842,全新元富98購01  ,0,0,0,0,0,0,0,0,0,-237000,0,0,0,40000,277000,-237000,-237000
1708,東鹼            ,18000,108000,-90000,0,0,0,0,0,0,-147000,0,147000,-147000,0,0,0,-237000
07212P,聯發科凱基99售14,0,0,0,0,0,0,0,0,0,-238000,0,0,0,0,238000,-238000,-238000
3653,健策            ,109000,181000,-72000,0,0,0,0,126000,-126000,-40424,2000,18000,-16000,16000,40424,-24424,-238424
056651,聯茂凱基98購04  ,0,0,0,0,0,0,0,0,0,-239000,0,0,0,20000,259000,-239000,-239000
062034,同欣電群益9B購01,0,0,0,0,0,0,0,0,0,-240000,0,0,0,144000,384000,-240000,-240000
053297,鎧勝中信98購01  ,0,0,0,0,0,0,0,0,0,-240000,0,0,0,0,240000,-240000,-240000
05930P,景碩康和96售01  ,0,0,0,0,0,0,0,0,0,-240000,0,0,0,20000,260000,-240000,-240000
060277,道瓊反元大9A購02,0,0,0,0,0,0,0,0,0,-241000,0,0,0,0,241000,-241000,-241000
2516,新建            ,5000,246000,-241000,0,0,0,0,0,0,0,0,0,0,0,0,0,-241000
059180,祥碩元富9A購01  ,0,0,0,0,0,0,0,0,0,-242000,0,0,0,66000,308000,-242000,-242000
06246P,茂林元富97售03  ,0,0,0,0,0,0,0,0,0,-242000,0,0,0,245000,487000,-242000,-242000
058751,南茂凱基9A購01  ,0,0,0,0,0,0,0,0,0,-242000,0,0,0,0,242000,-242000,-242000
058952,南茂群益99購01  ,0,0,0,0,0,0,0,0,0,-242000,0,0,0,20000,262000,-242000,-242000
056813,聯茂統一99購01  ,0,0,0,0,0,0,0,0,0,-242000,0,0,0,6000,248000,-242000,-242000
05731P,創意統一96售03  ,0,0,0,0,0,0,0,0,0,-242000,0,0,0,353000,595000,-242000,-242000
06933P,禾伸堂元大98售03,0,0,0,0,0,0,0,0,0,-243000,0,0,0,73000,316000,-243000,-243000
052611,力成元大96購02  ,0,0,0,0,0,0,0,0,0,-243000,0,0,0,66000,309000,-243000,-243000
1216,統一            ,4283821,4568814,-284993,0,0,0,27000,0,27000,14000,4000,13000,-9000,23000,0,23000,-243993
061303,玉晶光永豐9B購03,0,0,0,0,0,0,0,0,0,-244000,0,0,0,108000,352000,-244000,-244000
060656,國巨統一9C購03  ,0,0,0,0,0,0,0,0,0,-244000,0,0,0,112000,356000,-244000,-244000
055206,台虹中信97購01  ,0,0,0,0,0,0,0,0,0,-245000,0,0,0,5000,250000,-245000,-245000
060010,義隆群益99購02  ,0,0,0,0,0,0,0,0,0,-247000,0,0,0,86000,333000,-247000,-247000
06851P,鈺齊元大98售01  ,0,0,0,0,0,0,0,0,0,-247000,0,0,0,0,247000,-247000,-247000
2841,台開            ,264000,511000,-247000,0,0,0,0,0,0,0,0,0,0,0,0,0,-247000
1734,杏輝            ,39000,286000,-247000,0,0,0,0,0,0,0,0,0,0,0,0,0,-247000
2059,川湖            ,75000,334000,-259000,0,0,0,0,0,0,12000,13000,0,13000,0,1000,-1000,-247000
2401,凌陽            ,109000,359000,-250000,0,0,0,0,0,0,2000,4000,2000,2000,0,0,0,-248000
6452,康友-KY         ,63000,284000,-221000,0,0,0,0,0,0,-27000,0,0,0,1000,28000,-27000,-248000
1313,聯成            ,198000,446576,-248576,0,0,0,0,0,0,0,0,0,0,0,0,0,-248576
062036,致新群益9B購01  ,0,0,0,0,0,0,0,0,0,-249000,0,0,0,50000,299000,-249000,-249000
060640,京鼎永豐9A購01  ,0,0,0,0,0,0,0,0,0,-249000,0,0,0,142000,391000,-249000,-249000
058200,世芯康和99購01  ,0,0,0,0,0,0,0,0,0,-249000,0,0,0,968000,1217000,-249000,-249000
1444,力麗            ,228000,477000,-249000,0,0,0,0,0,0,0,0,0,0,0,0,0,-249000
6206,飛捷            ,93000,342705,-249705,0,0,0,0,0,0,0,0,0,0,0,0,0,-249705
052858,華通凱基97購02  ,0,0,0,0,0,0,0,0,0,-250000,0,0,0,155000,405000,-250000,-250000
6168,宏齊            ,17000,267000,-250000,0,0,0,0,0,0,0,0,0,0,0,0,0,-250000
4106,雃博            ,143000,373000,-230000,0,0,0,0,0,0,-20000,0,20000,-20000,0,0,0,-250000
060821,SP黃豆元大9A購02,0,0,0,0,0,0,0,0,0,-251000,0,0,0,75000,326000,-251000,-251000
052578,大立光統一97購01,0,0,0,0,0,0,0,0,0,-251000,0,0,0,11000,262000,-251000,-251000
059880,世紀鋼凱基99購02,0,0,0,0,0,0,0,0,0,-252000,0,0,0,28000,280000,-252000,-252000
057919,技嘉凱基98購03  ,0,0,0,0,0,0,0,0,0,-252000,0,0,0,78000,330000,-252000,-252000
2707,晶華            ,23000,325000,-302000,0,0,0,50000,0,50000,0,0,0,0,0,0,0,-252000
057720,日電貿元富98購01,0,0,0,0,0,0,0,0,0,-253000,0,0,0,96000,349000,-253000,-253000
057630,茂林永豐98購01  ,0,0,0,0,0,0,0,0,0,-253000,0,0,0,0,253000,-253000,-253000
062089,矽創元大9B購02  ,0,0,0,0,0,0,0,0,0,-255000,0,0,0,46000,301000,-255000,-255000
053601,台表科元大98購01,0,0,0,0,0,0,0,0,0,-255000,0,0,0,0,255000,-255000,-255000
056851,瑞儀元富98購01  ,0,0,0,0,0,0,0,0,0,-255000,0,0,0,98000,353000,-255000,-255000
060208,卜蜂康和9A購01  ,0,0,0,0,0,0,0,0,0,-257000,0,0,0,17000,274000,-257000,-257000
061064,可成凱基9B購02  ,0,0,0,0,0,0,0,0,0,-257000,0,0,0,0,257000,-257000,-257000
054164,強茂凱基98購01  ,0,0,0,0,0,0,0,0,0,-257000,0,0,0,9000,266000,-257000,-257000
00676R,富邦臺灣加權反1 ,0,0,0,0,0,0,0,0,0,-259000,0,0,0,364000,623000,-259000,-259000
07500P,微星元大9A售01  ,0,0,0,0,0,0,0,0,0,-259000,0,0,0,8000,267000,-259000,-259000
061824,聯電麥證9B購01  ,0,0,0,85000,345000,-260000,0,0,0,-260000,0,0,0,85000,345000,-260000,-260000
056717,康友永豐98購01  ,0,0,0,0,0,0,0,0,0,-260000,0,0,0,0,260000,-260000,-260000
057104,康友中信99購01  ,0,0,0,0,0,0,0,0,0,-260000,0,0,0,40000,300000,-260000,-260000
07786P,南電中信9C售01  ,0,0,0,0,0,0,0,0,0,-260000,0,0,0,100000,360000,-260000,-260000
058714,美律統一9B購01  ,0,0,0,0,0,0,0,0,0,-261000,0,0,0,5000,266000,-261000,-261000
05851P,力山群益97售01  ,0,0,0,0,0,0,0,0,0,-261000,0,0,0,68000,329000,-261000,-261000
4927,泰鼎-KY         ,1237000,826000,411000,0,0,0,53000,562000,-509000,-163000,0,83000,-83000,31000,111000,-80000,-261000
053436,聯茂日盛96購01  ,0,0,0,0,0,0,0,0,0,-262000,0,0,0,238000,500000,-262000,-262000
060427,聯茂永豐9A購01  ,0,0,0,0,0,0,0,0,0,-263000,0,0,0,237000,500000,-263000,-263000
056052,T50反1元大97購06,0,0,0,0,0,0,0,0,0,-263000,0,0,0,0,263000,-263000,-263000
06088P,建準永豐97售01  ,0,0,0,0,0,0,0,0,0,-264000,0,0,0,0,264000,-264000,-264000
062007,台光電國泰9C購01,0,0,0,0,0,0,0,0,0,-264000,0,0,0,20000,284000,-264000,-264000
061726,台積電麥證9A購05,0,0,0,113000,380000,-267000,0,0,0,-267000,0,0,0,113000,380000,-267000,-267000
061516,力成永豐9A購02  ,0,0,0,0,0,0,0,0,0,-267000,0,0,0,96000,363000,-267000,-267000
061092,可成統一9C購02  ,0,0,0,0,0,0,0,0,0,-267000,0,0,0,240000,507000,-267000,-267000
07478P,南電康和9A售02  ,0,0,0,0,0,0,0,0,0,-267000,0,0,0,290000,557000,-267000,-267000
060412,儒鴻永豐9A購01  ,0,0,0,0,0,0,0,0,0,-268000,0,0,0,0,268000,-268000,-268000
056578,智易元大99購02  ,0,0,0,0,0,0,0,0,0,-268000,0,0,0,292000,560000,-268000,-268000
058377,茂林凱基9A購03  ,0,0,0,0,0,0,0,0,0,-269000,0,0,0,48000,317000,-269000,-269000
061360,智邦兆豐9B購02  ,0,0,0,0,0,0,0,0,0,-270000,0,0,0,3000,273000,-270000,-270000
058730,玉晶光永豐9A購01,0,0,0,0,0,0,0,0,0,-270000,0,0,0,68000,338000,-270000,-270000
2454,聯發科          ,3268386,3519414,-251028,0,0,0,3000,6000,-3000,-17000,59000,47000,12000,13000,42000,-29000,-271028
060637,玉晶光永豐9A購03,0,0,0,0,0,0,0,0,0,-272000,0,0,0,7000,279000,-272000,-272000
04479P,同欣電中信96售02,0,0,0,0,0,0,0,0,0,-272000,0,0,0,0,272000,-272000,-272000
056649,智易凱基98購01  ,0,0,0,0,0,0,0,0,0,-272000,0,0,0,157000,429000,-272000,-272000
1310,台苯            ,72000,344000,-272000,0,0,0,0,0,0,0,0,0,0,0,0,0,-272000
4746,台耀            ,1518000,1834000,-316000,0,0,0,0,0,0,44000,56000,12000,44000,0,0,0,-272000
055235,金寶台新98購01  ,0,0,0,0,0,0,0,0,0,-274000,0,0,0,128000,402000,-274000,-274000
056665,上証2X國票99購02,0,0,0,0,0,0,0,0,0,-275000,0,0,0,14000,289000,-275000,-275000
058515,健鼎元大99購01  ,0,0,0,0,0,0,0,0,0,-276000,0,0,0,235000,511000,-276000,-276000
057347,國巨統一9A購03  ,0,0,0,0,0,0,0,0,0,-276000,0,0,0,482000,758000,-276000,-276000
055670,矽創群益98購02  ,0,0,0,0,0,0,0,0,0,-277000,0,0,0,470000,747000,-277000,-277000
2419,仲琦            ,20000,297000,-277000,0,0,0,0,0,0,0,0,0,0,0,0,0,-277000
03662C,FBVIX凱基03牛01 ,0,0,0,0,0,0,0,0,0,-279000,0,0,0,0,279000,-279000,-279000
061133,玉晶光第一9A購01,0,0,0,0,0,0,0,0,0,-280000,0,0,0,0,280000,-280000,-280000
049296,義隆群益96購01  ,0,0,0,0,0,0,0,0,0,-280000,0,0,0,0,280000,-280000,-280000
052124,京鼎國票95購01  ,0,0,0,0,0,0,0,0,0,-280000,0,0,0,19000,299000,-280000,-280000
057539,南茂元大98購02  ,0,0,0,0,0,0,0,0,0,-280000,0,0,0,29000,309000,-280000,-280000
6592,和潤企業        ,70000,342000,-272000,0,0,0,0,0,0,-8000,0,0,0,11000,19000,-8000,-280000
057658,玉晶光兆豐99購02,0,0,0,0,0,0,0,0,0,-281000,0,0,0,55000,336000,-281000,-281000
061193,玉晶光永豐9B購02,0,0,0,0,0,0,0,0,0,-282000,0,0,0,410000,692000,-282000,-282000
061721,道瓊反富邦9B購01,0,0,0,0,0,0,0,0,0,-282000,0,0,0,20000,302000,-282000,-282000
056380,麗豐元富98購01  ,0,0,0,0,0,0,0,0,0,-282000,0,0,0,0,282000,-282000,-282000
059139,全新兆豐9A購01  ,0,0,0,0,0,0,0,0,0,-282000,0,0,0,107000,389000,-282000,-282000
061882,矽創元大9B購01  ,0,0,0,0,0,0,0,0,0,-284000,0,0,0,67000,351000,-284000,-284000
00692,富邦公司治理    ,0,0,0,0,0,0,0,0,0,-284000,15000,0,15000,1111000,1410000,-299000,-284000
053040,全新凱基98購01  ,0,0,0,0,0,0,0,0,0,-285000,0,0,0,0,285000,-285000,-285000
057752,臺股指國票98購08,0,0,0,0,0,0,0,0,0,-285000,0,0,0,20000,305000,-285000,-285000
2392,正崴            ,532000,332000,200000,0,0,0,0,458000,-458000,-27000,20000,26000,-6000,12000,33000,-21000,-285000
059047,元油2X凱基9A購10,0,0,0,0,0,0,0,0,0,-286000,0,0,0,304000,590000,-286000,-286000
058081,技嘉群益9A購03  ,0,0,0,0,0,0,0,0,0,-286000,0,0,0,232000,518000,-286000,-286000
6668,中揚光          ,38000,324000,-286000,0,0,0,0,0,0,0,0,0,0,0,0,0,-286000
060237,友達元大9A購06  ,0,0,0,0,0,0,0,0,0,-287000,0,0,0,67000,354000,-287000,-287000
2355,敬鵬            ,105000,390000,-285000,0,0,0,0,0,0,-2000,0,0,0,0,2000,-2000,-287000
3703,欣陸            ,53000,340000,-287000,0,0,0,0,0,0,0,0,0,0,0,0,0,-287000
2642,宅配通          ,100000,388000,-288000,0,0,0,0,0,0,0,0,0,0,0,0,0,-288000
059914,台積電元大99購47,0,0,0,0,0,0,0,0,0,-289000,0,0,0,14000,303000,-289000,-289000
061788,信邦群益9B購01  ,0,0,0,0,0,0,0,0,0,-289000,0,0,0,10000,299000,-289000,-289000
2014,中鴻            ,310000,599000,-289000,0,0,0,0,0,0,0,0,0,0,0,0,0,-289000
2471,資通            ,24000,314000,-290000,0,0,0,0,0,0,0,0,0,0,0,0,0,-290000
2342,茂矽            ,694000,985000,-291000,0,0,0,0,0,0,0,0,0,0,0,0,0,-291000
4119,旭富            ,172180,394000,-221820,0,0,0,0,0,0,-70000,0,16000,-16000,28000,82000,-54000,-291820
3023,信邦            ,126000,347824,-221824,0,0,0,0,45000,-45000,-27000,6000,0,6000,1000,34000,-33000,-293824
1309,台達化          ,212000,507000,-295000,0,0,0,0,0,0,0,0,0,0,0,0,0,-295000
3673,TPK-KY          ,157000,371000,-214000,0,0,0,0,0,0,-82000,1000,44000,-43000,2000,41000,-39000,-296000
8021,尖點            ,90000,387000,-297000,0,0,0,0,0,0,0,0,0,0,0,0,0,-297000
055795,茂林國泰98購01  ,0,0,0,0,0,0,0,0,0,-298000,0,0,0,160000,458000,-298000,-298000
3026,禾伸堂          ,846000,787000,59000,0,0,0,0,363000,-363000,6000,85000,72000,13000,17000,24000,-7000,-298000
05624P,同欣電中信98售01,0,0,0,0,0,0,0,0,0,-299000,0,0,0,43000,342000,-299000,-299000
07492P,臺股指國票9A售10,0,0,0,0,0,0,0,0,0,-299000,0,0,0,0,299000,-299000,-299000
062070,金寶元大9B購01  ,0,0,0,0,0,0,0,0,0,-300000,0,0,0,20000,320000,-300000,-300000
054879,大成鋼統一97購01,0,0,0,0,0,0,0,0,0,-300000,0,0,0,200000,500000,-300000,-300000
053303,建準凱基96購03  ,0,0,0,0,0,0,0,0,0,-300000,0,0,0,0,300000,-300000,-300000
057393,台積電中信02購01,0,0,0,0,0,0,0,0,0,-300000,0,0,0,0,300000,-300000,-300000
055983,全新元富9A購02  ,0,0,0,0,0,0,0,0,0,-300000,0,0,0,0,300000,-300000,-300000
058241,景碩元大99購05  ,0,0,0,0,0,0,0,0,0,-300000,0,0,0,105000,405000,-300000,-300000
058111,健鼎元富98購01  ,0,0,0,0,0,0,0,0,0,-301000,0,0,0,108000,409000,-301000,-301000
3669,圓展            ,130000,431000,-301000,0,0,0,0,0,0,0,0,0,0,0,0,0,-301000
6005,群益證          ,760000,1061000,-301000,0,0,0,0,0,0,0,0,0,0,0,0,0,-301000
054349,同欣電國票97購02,0,0,0,0,0,0,0,0,0,-302000,0,0,0,408000,710000,-302000,-302000
057956,全新元大99購04  ,0,0,0,0,0,0,0,0,0,-303000,0,0,0,115000,418000,-303000,-303000
058139,臻鼎元大99購01  ,0,0,0,0,0,0,0,0,0,-305000,0,0,0,28000,333000,-305000,-305000
3682,亞太電          ,368000,673578,-305578,0,0,0,0,0,0,0,0,0,0,0,0,0,-305578
061247,玉晶光群益9A購09,0,0,0,0,0,0,0,0,0,-306000,0,0,0,200000,506000,-306000,-306000
058929,可成統一9C購01  ,0,0,0,0,0,0,0,0,0,-306000,0,0,0,35000,341000,-306000,-306000
061271,聯茂凱基9A購04  ,0,0,0,0,0,0,0,0,0,-308000,0,0,0,0,308000,-308000,-308000
059942,全新永豐99購04  ,0,0,0,0,0,0,0,0,0,-308000,0,0,0,49000,357000,-308000,-308000
053929,正文國票97購01  ,0,0,0,0,0,0,0,0,0,-309000,0,0,0,55000,364000,-309000,-309000
07670P,茂林元大9A售02  ,0,0,0,0,0,0,0,0,0,-309000,0,0,0,29000,338000,-309000,-309000
054365,遠東新中信96購01,0,0,0,0,0,0,0,0,0,-311000,0,0,0,89000,400000,-311000,-311000
054160,華泰凱基98購01  ,0,0,0,0,0,0,0,0,0,-311000,0,0,0,106000,417000,-311000,-311000
055806,致新永豐97購02  ,0,0,0,0,0,0,0,0,0,-311000,0,0,0,98000,409000,-311000,-311000
058688,矽創凱基9A購01  ,0,0,0,0,0,0,0,0,0,-312000,0,0,0,50000,362000,-312000,-312000
060017,全新康和99購01  ,0,0,0,0,0,0,0,0,0,-314000,0,0,0,0,314000,-314000,-314000
057082,玉晶光統一9A購04,0,0,0,0,0,0,0,0,0,-314000,0,0,0,50000,364000,-314000,-314000
6552,易華電          ,90000,366000,-276000,0,0,0,0,0,0,-38000,6000,0,6000,0,44000,-44000,-314000
061429,南六元大9A購02  ,0,0,0,0,0,0,0,0,0,-315000,0,0,0,225000,540000,-315000,-315000
056120,聯茂群益97購02  ,0,0,0,0,0,0,0,0,0,-315000,0,0,0,8000,323000,-315000,-315000
061288,大立光統一9C購01,0,0,0,0,0,0,0,0,0,-316000,0,0,0,20000,336000,-316000,-316000
058140,臻鼎元大99購02  ,0,0,0,0,0,0,0,0,0,-316000,0,0,0,87000,403000,-316000,-316000
057817,景碩元大98購01  ,0,0,0,0,0,0,0,0,0,-317000,0,0,0,163000,480000,-317000,-317000
6443,元晶            ,325000,642000,-317000,0,0,0,0,0,0,0,0,0,0,0,0,0,-317000
061031,神隆永豐9A購02  ,0,0,0,0,0,0,0,0,0,-318000,0,0,0,342000,660000,-318000,-318000
00674R,元大S&P黃金反1  ,30000,0,30000,0,0,0,0,0,0,-348000,0,0,0,152000,500000,-348000,-318000
058583,臻鼎群益99購01  ,0,0,0,0,0,0,0,0,0,-318000,0,0,0,2000,320000,-318000,-318000
059183,T50反1台新03購02,0,0,0,0,0,0,0,0,0,-320000,0,0,0,0,320000,-320000,-320000
2345,智邦            ,2101000,1956409,144591,0,0,0,118000,600000,-482000,17000,28000,32000,-4000,60000,39000,21000,-320409
061414,牧德群益9B購02  ,0,0,0,0,0,0,0,0,0,-321000,0,0,0,598000,919000,-321000,-321000
07633P,台灣50元大9A售18,0,0,0,0,0,0,0,0,0,-321000,0,0,0,0,321000,-321000,-321000
8210,勤誠            ,256000,473000,-217000,0,0,0,0,30000,-30000,-76000,0,63000,-63000,8000,21000,-13000,-323000
060776,世芯凱基9B購01  ,0,0,0,0,0,0,0,0,0,-324000,0,0,0,114000,438000,-324000,-324000
058273,同欣電永豐99購01,0,0,0,0,0,0,0,0,0,-326000,0,0,0,596000,922000,-326000,-326000
060737,瑞儀統一9C購01  ,0,0,0,0,0,0,0,0,0,-327000,0,0,0,0,327000,-327000,-327000
055380,智易元大98購02  ,0,0,0,0,0,0,0,0,0,-327000,0,0,0,252000,579000,-327000,-327000
058142,瑞儀元大99購01  ,0,0,0,0,0,0,0,0,0,-327000,0,0,0,0,327000,-327000,-327000
059691,大立光永豐99購02,0,0,0,0,0,0,0,0,0,-327000,0,0,0,0,327000,-327000,-327000
4915,致伸            ,815000,1157000,-342000,0,0,0,0,0,0,15000,0,0,0,35000,20000,15000,-327000
057909,台光電兆豐98購01,0,0,0,0,0,0,0,0,0,-328000,0,0,0,207000,535000,-328000,-328000
057038,元油2X元大9B購06,0,0,0,0,0,0,0,0,0,-330000,0,0,0,0,330000,-330000,-330000
058523,聯茂元大99購08  ,0,0,0,0,0,0,0,0,0,-330000,0,0,0,144000,474000,-330000,-330000
057616,聯電凱基99購01  ,0,0,0,0,0,0,0,0,0,-330000,0,0,0,118000,448000,-330000,-330000
00639,富邦深100       ,65000,121000,-56000,0,0,0,0,0,0,-276000,0,0,0,775000,1051000,-276000,-332000
057307,瀚宇博兆豐99購01,0,0,0,0,0,0,0,0,0,-332000,0,0,0,103000,435000,-332000,-332000
056196,聯茂富邦98購02  ,0,0,0,0,0,0,0,0,0,-333000,0,0,0,591000,924000,-333000,-333000
058262,大立光富邦9C購02,0,0,0,0,0,0,0,0,0,-334000,0,0,0,0,334000,-334000,-334000
00664R,國泰臺灣加權反1 ,0,0,0,0,0,0,0,0,0,-335000,0,0,0,724000,1059000,-335000,-335000
3705,永信            ,138000,474000,-336000,0,0,0,0,0,0,0,0,0,0,0,0,0,-336000
3035,智原            ,218000,473000,-255000,0,0,0,0,0,0,-82000,30000,48000,-18000,3000,67000,-64000,-337000
052069,聯茂兆豐96購01  ,0,0,0,0,0,0,0,0,0,-339000,0,0,0,144000,483000,-339000,-339000
058054,台積電統一9C購01,0,0,0,0,0,0,0,0,0,-339000,0,0,0,50000,389000,-339000,-339000
5388,中磊            ,39000,349000,-310000,0,0,0,0,0,0,-30000,0,0,0,1000,31000,-30000,-340000
057595,健鼎兆豐98購01  ,0,0,0,0,0,0,0,0,0,-341000,0,0,0,176000,517000,-341000,-341000
2820,華票            ,207000,548000,-341000,0,0,0,0,0,0,0,0,0,0,0,0,0,-341000
060016,廣達康和99購01  ,0,0,0,0,0,0,0,0,0,-342000,0,0,0,15000,357000,-342000,-342000
062043,牧德凱基9B購04  ,0,0,0,0,0,0,0,0,0,-342000,0,0,0,25000,367000,-342000,-342000
060385,台勝科凱基9A購01,0,0,0,0,0,0,0,0,0,-343000,0,0,0,251000,594000,-343000,-343000
061416,聯茂群益9A購01  ,0,0,0,0,0,0,0,0,0,-344000,0,0,0,249000,593000,-344000,-344000
00686R,群益臺灣加權反1 ,0,0,0,0,0,0,0,0,0,-344000,0,0,0,125000,469000,-344000,-344000
1802,台玻            ,175000,519000,-344000,0,0,0,0,0,0,0,0,0,0,0,0,0,-344000
07491P,臺股指國票9A售09,0,0,0,0,0,0,0,0,0,-344000,0,0,0,10000,354000,-344000,-344000
053485,矽創國票97購04  ,0,0,0,0,0,0,0,0,0,-345000,0,0,0,97000,442000,-345000,-345000
061914,台光電中信9B購01,0,0,0,0,0,0,0,0,0,-347000,0,0,0,65000,412000,-347000,-347000
058656,燿華中信99購01  ,0,0,0,0,0,0,0,0,0,-348000,0,0,0,368000,716000,-348000,-348000
058207,南茂凱基99購01  ,0,0,0,0,0,0,0,0,0,-348000,0,0,0,50000,398000,-348000,-348000
055094,智易群益98購01  ,0,0,0,0,0,0,0,0,0,-350000,0,0,0,106000,456000,-350000,-350000
057395,旺宏中信98購03  ,0,0,0,0,0,0,0,0,0,-350000,0,0,0,80000,430000,-350000,-350000
062108,晶豪科國票9B購01,0,0,0,0,0,0,0,0,0,-352000,0,0,0,2000,354000,-352000,-352000
060723,致新永豐9A購01  ,0,0,0,0,0,0,0,0,0,-354000,0,0,0,229000,583000,-354000,-354000
053611,聯茂麥證96購01  ,0,0,0,0,354000,-354000,0,0,0,-354000,0,0,0,0,354000,-354000,-354000
061960,國巨統一01購05  ,0,0,0,0,0,0,0,0,0,-357000,0,0,0,3000,360000,-357000,-357000
058516,健鼎元大99購02  ,0,0,0,0,0,0,0,0,0,-357000,0,0,0,20000,377000,-357000,-357000
07747P,晶技凱基9A售04  ,0,0,0,0,0,0,0,0,0,-357000,0,0,0,123000,480000,-357000,-357000
00638R,元大滬深300反1  ,26000,600000,-574000,0,0,0,0,0,0,216000,0,0,0,296000,80000,216000,-358000
3016,嘉晶            ,788000,969000,-181000,0,0,0,0,0,0,-177000,0,35000,-35000,53000,195000,-142000,-358000
061142,南電統一9A購01  ,0,0,0,0,0,0,0,0,0,-359000,0,0,0,144000,503000,-359000,-359000
054673,京鼎國泰98購01  ,0,0,0,0,0,0,0,0,0,-360000,0,0,0,60000,420000,-360000,-360000
2845,遠東銀          ,81000,439000,-358000,0,0,0,0,0,0,-2000,0,0,0,0,2000,-2000,-360000
062085,同欣電元大9B購01,0,0,0,0,0,0,0,0,0,-363000,0,0,0,76000,439000,-363000,-363000
056607,貿聯富邦99購02  ,0,0,0,0,0,0,0,0,0,-363000,0,0,0,1000,364000,-363000,-363000
07889P,旭富國票9B售01  ,0,0,0,0,0,0,0,0,0,-363000,0,0,0,13000,376000,-363000,-363000
058687,聯茂凱基9A購01  ,0,0,0,0,0,0,0,0,0,-365000,0,0,0,60000,425000,-365000,-365000
2464,盟立            ,204000,494000,-290000,0,0,0,0,0,0,-77000,0,100000,-100000,24000,1000,23000,-367000
060111,臻鼎元大99購04  ,0,0,0,0,0,0,0,0,0,-368000,0,0,0,6000,374000,-368000,-368000
061762,台塑元大9B購01  ,0,0,0,0,0,0,0,0,0,-371000,0,0,0,159000,530000,-371000,-371000
061680,崇越元大9A購01  ,0,0,0,0,0,0,0,0,0,-372000,0,0,0,6000,378000,-372000,-372000
1904,正隆            ,78000,449000,-371000,0,0,0,0,0,0,-1000,0,0,0,0,1000,-1000,-372000
060874,中鋼中信02購01  ,0,0,0,0,0,0,0,0,0,-373000,0,0,0,20000,393000,-373000,-373000
061625,聯茂群益9A購02  ,0,0,0,0,0,0,0,0,0,-374000,0,0,0,490000,864000,-374000,-374000
061156,玉晶光群益9A購07,0,0,0,0,0,0,0,0,0,-375000,0,0,0,180000,555000,-375000,-375000
062062,貿聯統一01購01  ,0,0,0,0,0,0,0,0,0,-376000,0,0,0,0,376000,-376000,-376000
9914,美利達          ,376000,755000,-379000,0,0,0,0,0,0,2000,6000,4000,2000,0,0,0,-377000
061661,京鼎永豐9A購02  ,0,0,0,0,0,0,0,0,0,-378000,0,0,0,150000,528000,-378000,-378000
059992,S&P正2元富9B購04,0,0,0,0,0,0,0,0,0,-378000,0,0,0,3000,381000,-378000,-378000
062023,寶成永豐9B購01  ,0,0,0,0,0,0,0,0,0,-382000,0,0,0,0,382000,-382000,-382000
4942,嘉彰            ,23000,406000,-383000,0,0,0,0,0,0,0,0,0,0,0,0,0,-383000
9910,豐泰            ,789464,1158500,-369036,0,0,0,1000,0,1000,-18000,0,18000,-18000,0,0,0,-386036
057314,全新麥證98購01  ,0,0,0,4000,391000,-387000,0,0,0,-387000,0,0,0,4000,391000,-387000,-387000
2911,麗嬰房          ,7000,394000,-387000,0,0,0,0,0,0,0,0,0,0,0,0,0,-387000
056839,台光電元富98購02,0,0,0,0,0,0,0,0,0,-389000,0,0,0,18000,407000,-389000,-389000
2812,台中銀          ,267000,806000,-539000,0,0,0,0,0,0,150000,150000,0,150000,0,0,0,-389000
2105,正新            ,757000,1090000,-333000,0,0,0,2000,50000,-48000,-9000,1000,8000,-7000,0,2000,-2000,-390000
3036,文曄            ,138000,377000,-239000,0,0,0,0,0,0,-153000,50000,150000,-100000,1000,54000,-53000,-392000
056211,南港國票98購01  ,0,0,0,0,0,0,0,0,0,-394000,0,0,0,72000,466000,-394000,-394000
054166,日電貿凱基98購01,0,0,0,0,0,0,0,0,0,-397000,0,0,0,0,397000,-397000,-397000
1457,宜進            ,64000,461000,-397000,0,0,0,0,0,0,0,0,0,0,0,0,0,-397000
052941,康控兆豐97購01  ,0,0,0,0,0,0,0,0,0,-400000,0,0,0,0,400000,-400000,-400000
057036,元油2X元大9B購04,0,0,0,0,0,0,0,0,0,-400000,0,0,0,0,400000,-400000,-400000
07458P,長榮航元大9A售01,0,0,0,0,0,0,0,0,0,-400000,0,0,0,13000,413000,-400000,-400000
059023,可成統一9B購02  ,0,0,0,0,0,0,0,0,0,-402000,0,0,0,183000,585000,-402000,-402000
058440,玉晶光統一99購02,0,0,0,0,0,0,0,0,0,-402000,0,0,0,63000,465000,-402000,-402000
053205,台光電麥證96購01,0,0,0,60000,463000,-403000,0,0,0,-403000,0,0,0,60000,463000,-403000,-403000
1712,興農            ,83000,486000,-403000,0,0,0,0,0,0,0,0,0,0,0,0,0,-403000
053568,智伸科富邦98購01,0,0,0,0,0,0,0,0,0,-404000,0,0,0,1000,405000,-404000,-404000
056492,全新國泰9A購01  ,0,0,0,0,0,0,0,0,0,-405000,0,0,0,115000,520000,-405000,-405000
056677,智伸科元富98購01,0,0,0,0,0,0,0,0,0,-406000,0,0,0,379000,785000,-406000,-406000
061398,力成中信9A購01  ,0,0,0,0,0,0,0,0,0,-408000,0,0,0,168000,576000,-408000,-408000
053159,同欣電元大96購02,0,0,0,0,0,0,0,0,0,-410000,0,0,0,0,410000,-410000,-410000
056686,可成統一98購01  ,0,0,0,0,0,0,0,0,0,-412000,0,0,0,13000,425000,-412000,-412000
059766,同欣電永豐99購03,0,0,0,0,0,0,0,0,0,-413000,0,0,0,239000,652000,-413000,-413000
07874P,長榮航群益9B售01,0,0,0,0,0,0,0,0,0,-414000,0,0,0,0,414000,-414000,-414000
061604,台光電凱基9B購01,0,0,0,0,0,0,0,0,0,-417000,0,0,0,46000,463000,-417000,-417000
058525,台虹元大99購02  ,0,0,0,0,0,0,0,0,0,-417000,0,0,0,173000,590000,-417000,-417000
2801,彰銀            ,2679000,3137000,-458000,0,0,0,9000,0,9000,28000,0,0,0,28000,0,28000,-421000
2328,廣宇            ,377000,783000,-406000,0,0,0,0,0,0,-16000,10000,2000,8000,0,24000,-24000,-422000
056616,台光電永豐98購01,0,0,0,0,0,0,0,0,0,-428000,0,0,0,176000,604000,-428000,-428000
057895,全新元富9B購01  ,0,0,0,0,0,0,0,0,0,-429000,0,0,0,12000,441000,-429000,-429000
060123,光罩永豐99購02  ,0,0,0,0,0,0,0,0,0,-431000,0,0,0,207000,638000,-431000,-431000
07691P,宏達電元大9A售05,0,0,0,0,0,0,0,0,0,-435000,0,0,0,72000,507000,-435000,-435000
07836P,大成鋼元大9A售01,0,0,0,0,0,0,0,0,0,-436000,0,0,0,0,436000,-436000,-436000
061293,聯茂統一9A購01  ,0,0,0,0,0,0,0,0,0,-437000,0,0,0,88000,525000,-437000,-437000
058839,瑞儀中信99購02  ,0,0,0,0,0,0,0,0,0,-439000,0,0,0,10000,449000,-439000,-439000
055894,欣興統一97購03  ,0,0,0,0,0,0,0,0,0,-439000,0,0,0,530000,969000,-439000,-439000
2323,中環            ,1154000,1551000,-397000,0,0,0,0,0,0,-42000,20000,6000,14000,32000,88000,-56000,-439000
057945,京鼎國票99購03  ,0,0,0,0,0,0,0,0,0,-441000,0,0,0,25000,466000,-441000,-441000
058646,聯茂富邦9A購01  ,0,0,0,0,0,0,0,0,0,-442000,0,0,0,179000,621000,-442000,-442000
056094,大立光元富97購03,0,0,0,0,0,0,0,0,0,-443000,0,0,0,0,443000,-443000,-443000
3712,永崴投控        ,74000,517000,-443000,0,0,0,0,0,0,0,0,0,0,0,0,0,-443000
054805,台苯元大9A購01  ,0,0,0,0,0,0,0,0,0,-445000,0,0,0,144000,589000,-445000,-445000
054528,台光電統一96購02,0,0,0,0,0,0,0,0,0,-449000,0,0,0,0,449000,-449000,-449000
061028,聚陽永豐9A購01  ,0,0,0,0,0,0,0,0,0,-451000,0,0,0,103000,554000,-451000,-451000
058522,聯茂元大99購07  ,0,0,0,0,0,0,0,0,0,-451000,0,0,0,478000,929000,-451000,-451000
2609,陽明            ,143000,596000,-453000,0,0,0,0,0,0,0,0,0,0,0,0,0,-453000
3437,榮創            ,457000,912000,-455000,0,0,0,0,0,0,0,0,0,0,0,0,0,-455000
4967,十銓            ,713000,1170553,-457553,0,0,0,0,0,0,0,0,0,0,0,0,0,-457553
061458,臻鼎凱基9A購02  ,0,0,0,0,0,0,0,0,0,-458000,0,0,0,80000,538000,-458000,-458000
049690,義隆元大95購02  ,0,0,0,0,0,0,0,0,0,-459000,0,0,0,0,459000,-459000,-459000
060957,SP黃豆凱基9A購04,0,0,0,0,0,0,0,0,0,-462000,0,0,0,15000,477000,-462000,-462000
056098,矽創元富97購02  ,0,0,0,0,0,0,0,0,0,-462000,0,0,0,100000,562000,-462000,-462000
05991P,聯茂群益96售05  ,0,0,0,0,0,0,0,0,0,-466000,0,0,0,0,466000,-466000,-466000
051428,玉晶光統一96購01,0,0,0,0,0,0,0,0,0,-477000,0,0,0,886000,1363000,-477000,-477000
060701,玉晶光國泰9C購01,0,0,0,0,0,0,0,0,0,-478000,0,0,0,297000,775000,-478000,-478000
061717,力成凱基9B購01  ,0,0,0,0,0,0,0,0,0,-488000,0,0,0,5000,493000,-488000,-488000
056198,台光電永豐97購02,0,0,0,0,0,0,0,0,0,-488000,0,0,0,39000,527000,-488000,-488000
061418,世紀鋼群益9A購02,0,0,0,0,0,0,0,0,0,-489000,0,0,0,733000,1222000,-489000,-489000
054698,同欣電永豐97購01,0,0,0,0,0,0,0,0,0,-489000,0,0,0,0,489000,-489000,-489000
057065,牧德富邦99購01  ,0,0,0,0,0,0,0,0,0,-489000,0,0,0,0,489000,-489000,-489000
2547,日勝生          ,73000,533712,-460712,0,0,0,0,0,0,-29000,0,29000,-29000,0,0,0,-489712
061337,台積電元大9A購27,0,0,0,0,0,0,0,0,0,-490000,0,0,0,0,490000,-490000,-490000
058363,全新凱基9A購02  ,0,0,0,0,0,0,0,0,0,-490000,0,0,0,5000,495000,-490000,-490000
057133,京鼎凱基98購02  ,0,0,0,0,0,0,0,0,0,-490000,0,0,0,0,490000,-490000,-490000
056543,京鼎凱基98購01  ,0,0,0,0,0,0,0,0,0,-490000,0,0,0,20000,510000,-490000,-490000
057383,玉晶光富邦9A購01,0,0,0,0,0,0,0,0,0,-490000,0,0,0,54000,544000,-490000,-490000
059818,鴻海凱基99購14  ,0,0,0,0,0,0,0,0,0,-494000,0,0,0,5000,499000,-494000,-494000
061170,南茂兆豐9B購01  ,0,0,0,0,0,0,0,0,0,-496000,0,0,0,17000,513000,-496000,-496000
060047,道瓊反凱基99購01,0,0,0,0,0,0,0,0,0,-498000,0,0,0,49000,547000,-498000,-498000
060142,臺指反國票9B購01,0,0,0,0,0,0,0,0,0,-499000,0,0,0,0,499000,-499000,-499000
00708L,元大S&P黃金正2  ,0,1000,-1000,0,0,0,0,0,0,-498000,0,0,0,2628000,3126000,-498000,-499000
058500,元石油元大9C購01,0,0,0,0,0,0,0,0,0,-500000,0,0,0,0,500000,-500000,-500000
060961,台光電凱基9A購03,1000,0,1000,0,0,0,0,0,0,-502000,0,0,0,143000,645000,-502000,-501000
1609,大亞            ,54000,557000,-503000,0,0,0,0,0,0,0,0,0,0,0,0,0,-503000
2478,大毅            ,516000,947000,-431000,0,0,0,0,0,0,-76000,30000,0,30000,6000,112000,-106000,-507000
056945,鴻海統一98購12  ,0,0,0,0,0,0,0,0,0,-512000,0,0,0,0,512000,-512000,-512000
056291,聯茂永豐97購03  ,0,0,0,0,0,0,0,0,0,-516000,0,0,0,75000,591000,-516000,-516000
061509,SP黃豆富邦9C購01,0,0,0,0,0,0,0,0,0,-520000,0,0,0,0,520000,-520000,-520000
3450,聯鈞            ,234000,645000,-411000,0,0,0,0,0,0,-109000,0,40000,-40000,1000,70000,-69000,-520000
2417,圓剛            ,253000,798000,-545000,0,0,0,0,0,0,18000,18000,0,18000,0,0,0,-527000
5434,崇越            ,352000,992000,-640000,0,0,0,10000,0,10000,103000,110000,14000,96000,7000,0,7000,-527000
061607,台表科凱基9B購02,0,0,0,0,0,0,0,0,0,-528000,0,0,0,550000,1078000,-528000,-528000
055902,同欣電中信99購01,0,0,0,0,0,0,0,0,0,-533000,0,0,0,110000,643000,-533000,-533000
3005,神基            ,342000,751000,-409000,0,0,0,0,0,0,-125000,0,0,0,8000,133000,-125000,-534000
061646,力成元大9A購02  ,0,0,0,0,0,0,0,0,0,-539000,0,0,0,140000,679000,-539000,-539000
060653,全新群益9A購02  ,0,0,0,0,0,0,0,0,0,-547000,0,0,0,78000,625000,-547000,-547000
051381,玉晶光群益98購01,0,0,0,0,0,0,0,0,0,-549000,0,0,0,118000,667000,-549000,-549000
07363P,大立光元大99售26,0,0,0,0,0,0,0,0,0,-551000,0,0,0,1000,552000,-551000,-551000
060133,牧德群益9B購01  ,0,0,0,0,0,0,0,0,0,-552000,0,0,0,418000,970000,-552000,-552000
060304,大立光富邦9C購05,0,0,0,0,0,0,0,0,0,-553000,0,0,0,0,553000,-553000,-553000
060186,義隆元富9A購01  ,0,0,0,0,0,0,0,0,0,-554000,0,0,0,57000,611000,-554000,-554000
049795,華通元大96購02  ,0,0,0,0,0,0,0,0,0,-555000,0,0,0,0,555000,-555000,-555000
061264,全新凱基9B購01  ,0,0,0,0,0,0,0,0,0,-560000,0,0,0,172000,732000,-560000,-560000
2393,億光            ,344000,659000,-315000,0,0,0,0,0,0,-251000,46000,0,46000,18000,315000,-297000,-566000
3338,泰碩            ,394000,368000,26000,0,0,0,0,328000,-328000,-269000,4000,215000,-211000,5000,63000,-58000,-571000
8926,台汽電          ,287000,729000,-442000,0,0,0,0,0,0,-129000,0,0,0,0,129000,-129000,-571000
6202,盛群            ,64000,648000,-584000,0,0,0,0,0,0,7000,4000,0,4000,5000,2000,3000,-577000
2634,漢翔            ,63000,643000,-580000,0,0,0,0,0,0,3000,0,0,0,3000,0,3000,-577000
061417,力成群益9A購01  ,30000,0,30000,0,0,0,0,0,0,-611000,0,0,0,90000,701000,-611000,-581000
061085,聯茂兆豐9A購01  ,0,0,0,0,0,0,0,0,0,-587000,0,0,0,311000,898000,-587000,-587000
1301,台塑            ,1961000,2595000,-634000,0,0,0,7000,0,7000,39000,4000,16000,-12000,51000,0,51000,-588000
061527,牧德凱基9A購02  ,0,0,0,0,0,0,0,0,0,-590000,0,0,0,397000,987000,-590000,-590000
051728,道瓊反國票97購01,0,0,0,0,0,0,0,0,0,-594000,0,0,0,20000,614000,-594000,-594000
056996,矽力日盛99購01  ,0,0,0,0,0,0,0,0,0,-597000,0,0,0,238000,835000,-597000,-597000
054880,華泰統一97購01  ,0,0,0,0,0,0,0,0,0,-598000,0,0,0,0,598000,-598000,-598000
07791P,奇鋐元大9A售02  ,0,0,0,0,0,0,0,0,0,-602000,0,0,0,30000,632000,-602000,-602000
06015P,大立光富邦98售04,0,0,0,0,0,0,0,0,0,-603000,0,0,0,26000,629000,-603000,-603000
00715L,街口布蘭特油正2 ,0,14000,-14000,0,0,0,0,0,0,-596000,0,0,0,0,596000,-596000,-610000
061059,世芯國票9B購01  ,0,0,0,0,0,0,0,0,0,-611000,0,0,0,12000,623000,-611000,-611000
049024,玉晶光群益97購01,0,0,0,0,0,0,0,0,0,-613000,0,0,0,89000,702000,-613000,-613000
061439,寶成凱基9A購01  ,0,0,0,0,0,0,0,0,0,-615000,0,0,0,0,615000,-615000,-615000
062097,台光電永豐9B購01,0,0,0,0,0,0,0,0,0,-615000,0,0,0,12000,627000,-615000,-615000
3704,合勤控          ,300000,880000,-580000,0,0,0,0,0,0,-36000,0,0,0,0,36000,-36000,-616000
054354,技嘉富邦97購01  ,0,0,0,0,0,0,0,0,0,-621000,0,0,0,0,621000,-621000,-621000
2542,興富發          ,1792000,2426000,-634000,0,0,0,0,0,0,12000,2000,2000,0,12000,0,12000,-622000
059948,正文永豐99購01  ,0,0,0,0,0,0,0,0,0,-623000,0,0,0,342000,965000,-623000,-623000
056724,臻鼎中信9A購01  ,0,0,0,0,0,0,0,0,0,-623000,0,0,0,5000,628000,-623000,-623000
1795,美時            ,182000,807000,-625000,0,0,0,0,0,0,0,0,0,0,0,0,0,-625000
1707,葡萄王          ,268000,611000,-343000,0,0,0,0,193000,-193000,-92000,0,100000,-100000,10000,2000,8000,-628000
059403,T50反1台新03購03,0,0,0,0,0,0,0,0,0,-629000,0,0,0,0,629000,-629000,-629000
07128P,大毅元大99售04  ,0,0,0,0,0,0,0,0,0,-629000,0,0,0,85000,714000,-629000,-629000
059101,康控統一9A購01  ,0,0,0,0,0,0,0,0,0,-630000,0,0,0,10000,640000,-630000,-630000
061623,祥碩群益9A購01  ,0,0,0,0,0,0,0,0,0,-635000,0,0,0,78000,713000,-635000,-635000
1701,中化            ,442000,980000,-538000,0,0,0,0,0,0,-100000,0,100000,-100000,0,0,0,-638000
038489,T50反1台新9A購01,0,0,0,0,0,0,0,0,0,-640000,0,0,0,0,640000,-640000,-640000
053107,旺宏兆豐97購01  ,0,0,0,0,0,0,0,0,0,-642000,0,0,0,20000,662000,-642000,-642000
1515,力山            ,451000,1094000,-643000,0,0,0,71000,0,71000,-70000,251000,174000,77000,51000,198000,-147000,-642000
056422,全新統一98購02  ,0,0,0,0,0,0,0,0,0,-646000,0,0,0,12000,658000,-646000,-646000
8996,高力            ,171000,824000,-653000,0,0,0,0,0,0,5000,5000,0,5000,0,0,0,-648000
9939,宏全            ,82000,726000,-644000,0,0,0,0,0,0,-8000,0,2000,-2000,1000,7000,-6000,-652000
055805,矽力永豐97購01  ,0,0,0,0,0,0,0,0,0,-655000,0,0,0,99000,754000,-655000,-655000
2406,國碩            ,284000,955000,-671000,0,0,0,0,0,0,0,0,0,0,0,0,0,-671000
061275,臺股指凱基9A購25,0,0,0,0,0,0,0,0,0,-673000,0,0,0,165000,838000,-673000,-673000
05644P,大立光中信9A售03,0,0,0,0,0,0,0,0,0,-682000,0,0,0,714000,1396000,-682000,-682000
059680,台積電國泰9A購03,0,0,0,0,0,0,0,0,0,-682000,0,0,0,618000,1300000,-682000,-682000
2385,群光            ,2104000,1602976,501024,0,0,0,0,1108000,-1108000,-80000,0,1000,-1000,0,79000,-79000,-686976
2456,奇力新          ,1020100,1063000,-42900,0,0,0,0,563000,-563000,-88000,6000,40000,-34000,17000,71000,-54000,-693900
057987,大立光元富98購02,0,0,0,0,0,0,0,0,0,-696000,0,0,0,538000,1234000,-696000,-696000
2886,兆豐金          ,5513000,6126000,-613000,0,0,0,16000,0,16000,-99000,8000,2000,6000,0,105000,-105000,-696000
2375,凱美            ,378000,977000,-599000,0,0,0,0,0,0,-99000,0,0,0,4000,103000,-99000,-698000
059290,全新元富99購01  ,0,0,0,0,0,0,0,0,0,-699000,0,0,0,58000,757000,-699000,-699000
062017,京鼎永豐9B購01  ,0,0,0,0,0,0,0,0,0,-709000,0,0,0,28000,737000,-709000,-709000
1455,集盛            ,64000,780000,-716000,0,0,0,0,0,0,0,0,0,0,0,0,0,-716000
061583,矽創元大9A購01  ,0,0,0,0,0,0,0,0,0,-720000,0,0,0,79000,799000,-720000,-720000
2108,南帝            ,893000,1613750,-720750,0,0,0,0,0,0,-1000,0,1000,-1000,0,0,0,-721750
2633,台灣高鐵        ,665000,1412000,-747000,0,0,0,3000,0,3000,18000,20000,7000,13000,5000,0,5000,-726000
059825,嘉晶凱基99購02  ,0,0,0,0,0,0,0,0,0,-730000,0,0,0,492000,1222000,-730000,-730000
07287P,全新群益9B售01  ,0,0,0,0,0,0,0,0,0,-735000,0,0,0,100000,835000,-735000,-735000
2601,益航            ,126000,875000,-749000,0,0,0,0,0,0,0,0,0,0,0,0,0,-749000
2356,英業達          ,9026000,9663204,-637204,0,0,0,0,0,0,-117000,32000,0,32000,63000,212000,-149000,-754204
2027,大成鋼          ,628000,1279000,-651000,0,0,0,0,0,0,-108000,38000,0,38000,145000,291000,-146000,-759000
5469,瀚宇博          ,599000,368000,231000,0,0,0,0,1036000,-1036000,34000,240000,120000,120000,38000,124000,-86000,-771000
061197,矽創永豐9A購02  ,0,0,0,0,0,0,0,0,0,-773000,0,0,0,291000,1064000,-773000,-773000
4133,亞諾法          ,291000,1065000,-774000,0,0,0,0,0,0,0,0,0,0,0,0,0,-774000
3545,敦泰            ,3578000,4382750,-804750,0,0,0,0,0,0,27000,30000,3000,27000,0,0,0,-777750
00693U,街口S&P黃豆     ,180000,1000,179000,0,0,0,0,0,0,-960000,0,0,0,355000,1315000,-960000,-781000
9938,百和            ,313000,591448,-278448,0,0,0,0,379000,-379000,-135000,8000,124000,-116000,4000,23000,-19000,-792448
060702,玉晶光國泰9C購02,0,0,0,0,0,0,0,0,0,-794000,0,0,0,332000,1126000,-794000,-794000
056626,同欣電永豐98購01,0,0,0,0,0,0,0,0,0,-797000,0,0,0,78000,875000,-797000,-797000
8112,至上            ,1020000,1821100,-801100,0,0,0,0,0,0,0,0,0,0,0,0,0,-801100
058832,立積永豐99購01  ,0,0,0,0,0,0,0,0,0,-802000,0,0,0,3000,805000,-802000,-802000
5521,工信            ,1077000,1880000,-803000,0,0,0,0,0,0,0,0,0,0,0,0,0,-803000
2881,富邦金          ,5184000,6021000,-837000,0,0,0,10000,0,10000,14000,14000,0,14000,11000,11000,0,-813000
056894,佳世達元大99購01,0,0,0,0,0,0,0,0,0,-831000,0,0,0,30000,861000,-831000,-831000
059533,富邦金凱基99購01,0,0,0,0,0,0,0,0,0,-845000,0,0,0,8000,853000,-845000,-845000
059862,全新群益99購04  ,0,0,0,0,0,0,0,0,0,-856000,0,0,0,74000,930000,-856000,-856000
060748,臻鼎國票9A購01  ,0,0,0,0,0,0,0,0,0,-859000,0,0,0,64000,923000,-859000,-859000
2498,宏達電          ,287000,1100000,-813000,0,0,0,0,0,0,-53000,2000,18000,-16000,66000,103000,-37000,-866000
057746,同欣電永豐98購02,0,0,0,0,0,0,0,0,0,-867000,0,0,0,32000,899000,-867000,-867000
2377,微星            ,693741,776812,-83071,0,0,0,0,728000,-728000,-60000,20000,0,20000,21000,101000,-80000,-871071
5871,中租-KY         ,756000,1699130,-943130,0,0,0,12000,0,12000,40000,20000,2000,18000,27000,5000,22000,-891130
9958,世紀鋼          ,297000,942000,-645000,0,0,0,0,30000,-30000,-219000,4000,233000,-229000,77000,67000,10000,-894000
1736,喬山            ,203000,874000,-671000,0,0,0,0,200000,-200000,-26000,2000,5000,-3000,0,23000,-23000,-897000
00653L,富邦印度正2     ,801000,260000,541000,0,0,0,0,0,0,-1442000,0,0,0,1076000,2518000,-1442000,-901000
055885,大成鋼統一97購02,0,0,0,0,0,0,0,0,0,-904000,0,0,0,0,904000,-904000,-904000
5264,鎧勝-KY         ,135000,642000,-507000,0,0,0,0,400000,-400000,-2000,0,0,0,0,2000,-2000,-909000
4935,茂林-KY         ,235000,1037000,-802000,0,0,0,18000,80000,-62000,-46000,374000,357000,17000,65000,128000,-63000,-910000
2313,華通            ,1292000,4749000,-3457000,0,0,0,3249000,194000,3055000,-508000,917000,840000,77000,257000,842000,-585000,-910000
059128,友達中信99購02  ,0,0,0,0,0,0,0,0,0,-926000,0,0,0,414000,1340000,-926000,-926000
3576,聯合再生        ,1655000,2595000,-940000,0,0,0,0,0,0,0,0,0,0,0,0,0,-940000
054261,智伸科元大96購03,0,0,0,0,0,0,0,0,0,-943000,0,0,0,29000,972000,-943000,-943000
2352,佳世達          ,755000,1692000,-937000,0,0,0,0,0,0,-9000,68000,77000,-9000,0,0,0,-946000
2329,華泰            ,1044000,2247000,-1203000,0,0,0,0,0,0,250000,0,0,0,257000,7000,250000,-953000
053082,聯電元大98購03  ,0,0,0,0,0,0,0,0,0,-964000,0,0,0,0,964000,-964000,-964000
053454,創意統一96購02  ,0,0,0,0,0,0,0,0,0,-973000,0,0,0,25000,998000,-973000,-973000
061168,力成兆豐9A購01  ,0,0,0,0,0,0,0,0,0,-974000,0,0,0,195000,1169000,-974000,-974000
07597P,臺股指中信01售02,0,0,0,0,0,0,0,0,0,-992000,0,0,0,57000,1049000,-992000,-992000
3443,創意            ,136756,655000,-518244,0,0,0,0,442000,-442000,-48000,4000,34000,-30000,9000,27000,-18000,-1008244
1227,佳格            ,1430170,2539116,-1108946,0,0,0,0,0,0,73000,73000,0,73000,0,0,0,-1035946
2603,長榮            ,1757000,2304000,-547000,0,0,0,0,300000,-300000,-211000,0,211000,-211000,0,0,0,-1058000
1409,新纖            ,267000,1363000,-1096000,0,0,0,0,0,0,0,0,0,0,0,0,0,-1096000
060448,道瓊反元大9A購04,0,0,0,0,0,0,0,0,0,-1116000,0,0,0,0,1116000,-1116000,-1116000
061350,牧德元大9B購03  ,0,0,0,0,0,0,0,0,0,-1119000,0,0,0,231000,1350000,-1119000,-1119000
058733,同欣電永豐99購02,0,0,0,0,0,0,0,0,0,-1144000,0,0,0,168000,1312000,-1144000,-1144000
1504,東元            ,315000,1395000,-1080000,0,0,0,0,0,0,-67000,6000,8000,-2000,0,65000,-65000,-1147000
1476,儒鴻            ,636000,1464000,-828000,0,0,0,0,322000,-322000,-19000,0,17000,-17000,4000,6000,-2000,-1169000
2505,國揚            ,1655000,2649000,-994000,0,0,0,0,0,0,-202000,0,0,0,77000,279000,-202000,-1196000
3044,健鼎            ,1618000,2827039,-1209039,0,0,0,73000,0,73000,-62000,140000,255000,-115000,61000,8000,53000,-1198039
3698,隆達            ,492000,1629000,-1137000,0,0,0,0,0,0,-106000,4000,110000,-106000,0,0,0,-1243000
060746,玉晶光國票9B購02,0,0,0,0,0,0,0,0,0,-1254000,0,0,0,19000,1273000,-1254000,-1254000
061953,台積電台新9B購04,0,0,0,0,0,0,0,0,0,-1255000,0,0,0,50000,1305000,-1255000,-1255000
060705,台光電富邦9B購01,0,0,0,0,0,0,0,0,0,-1267000,0,0,0,704000,1971000,-1267000,-1267000
6176,瑞儀            ,881000,2157000,-1276000,0,0,0,0,106000,-106000,85000,90000,2000,88000,42000,45000,-3000,-1297000
2002,中鋼            ,6178000,7437701,-1259701,0,0,0,17000,0,17000,-76000,0,68000,-68000,0,8000,-8000,-1318701
2606,裕民            ,113000,1426800,-1313800,0,0,0,0,0,0,-18000,0,18000,-18000,0,0,0,-1331800
4919,新唐            ,394000,1683000,-1289000,0,0,0,0,0,0,-58000,0,0,0,0,58000,-58000,-1347000
1326,台化            ,1530000,2840000,-1310000,0,0,0,4000,0,4000,-49000,1000,17000,-16000,0,33000,-33000,-1355000
1312,國喬            ,766000,2115000,-1349000,0,0,0,0,0,0,-16000,12000,28000,-16000,0,0,0,-1365000
054546,玉晶光中信9B購01,0,0,0,0,0,0,0,0,0,-1382000,0,0,0,969000,2351000,-1382000,-1382000
3706,神達            ,517000,767000,-250000,0,0,0,0,1098000,-1098000,-52000,0,0,0,5000,57000,-52000,-1400000
06662P,玉晶光中信9A售01,0,0,0,0,0,0,0,0,0,-1555000,0,0,0,231000,1786000,-1555000,-1555000
6282,康舒            ,419000,1977000,-1558000,0,0,0,0,0,0,-2000,12000,10000,2000,4000,8000,-4000,-1560000
057804,為升元大98購01  ,0,0,0,0,0,0,0,0,0,-1581000,0,0,0,143000,1724000,-1581000,-1581000
2201,裕隆            ,620000,1486000,-866000,0,0,0,0,766000,-766000,0,0,0,0,0,0,0,-1632000
2880,華南金          ,2893000,4571667,-1678667,0,0,0,13000,0,13000,28000,28000,0,28000,0,0,0,-1637667
6271,同欣電          ,1810000,4376000,-2566000,0,0,0,627000,0,627000,295000,194000,2000,192000,145000,42000,103000,-1644000
9904,寶成            ,4168000,6972605,-2804605,0,0,0,1003000,0,1003000,154000,104000,50000,54000,104000,4000,100000,-1647605
2308,台達電          ,1665000,3320000,-1655000,0,0,0,3000,0,3000,-11000,15000,6000,9000,6000,26000,-20000,-1663000
1909,榮成            ,2766000,4490000,-1724000,0,0,0,0,0,0,-26000,0,26000,-26000,0,0,0,-1750000
6278,台表科          ,1057000,4654000,-3597000,0,0,0,1806000,0,1806000,-103000,226000,20000,206000,56000,365000,-309000,-1894000
00648R,元大S&P500反1   ,0,150000,-150000,0,0,0,0,0,0,-1796000,0,0,0,140000,1936000,-1796000,-1946000
4958,臻鼎-KY         ,1469000,3836594,-2367594,0,0,0,167000,0,167000,107000,66000,61000,5000,135000,33000,102000,-2093594
2890,永豐金          ,4847000,6972000,-2125000,0,0,0,15000,0,15000,10000,5000,0,5000,5000,0,5000,-2100000
2312,金寶            ,1409000,3518000,-2109000,0,0,0,0,0,0,-95000,0,0,0,88000,183000,-95000,-2204000
00671R,富邦NASDAQ反1   ,0,0,0,0,0,0,0,0,0,-2211000,0,0,0,943000,3154000,-2211000,-2211000
2367,燿華            ,774000,2725000,-1951000,0,0,0,0,0,0,-260000,0,0,0,86000,346000,-260000,-2211000
061610,力成統一9C購01  ,0,0,0,0,0,0,0,0,0,-2233000,0,0,0,214000,2447000,-2233000,-2233000
1402,遠東新          ,2072000,5418000,-3346000,0,0,0,825000,0,825000,168000,331000,56000,275000,0,107000,-107000,-2353000
2408,南亞科          ,2160000,3825000,-1665000,0,0,0,1000,850000,-849000,126000,302000,36000,266000,41000,181000,-140000,-2388000
5880,合庫金          ,3373000,5800620,-2427620,0,0,0,13000,0,13000,-21000,15000,44000,-29000,8000,0,8000,-2435620
2327,國巨            ,2816608,4850716,-2034108,0,0,0,0,378000,-378000,-246000,123000,271000,-148000,85000,183000,-98000,-2658108
3019,亞光            ,300000,2791000,-2491000,0,0,0,0,0,0,-277000,60000,180000,-120000,33000,190000,-157000,-2768000
00642U,元大S&P石油     ,64000,3000,61000,0,0,0,0,0,0,-2835000,0,0,0,136000,2971000,-2835000,-2774000
1760,寶齡富錦        ,842000,4097000,-3255000,0,0,0,262000,0,262000,88000,93000,5000,88000,0,0,0,-2905000
2834,臺企銀          ,1106000,4402577,-3296577,0,0,0,0,0,0,195000,252000,57000,195000,2000,2000,0,-3101577
1605,華新            ,350000,3125000,-2775000,0,0,0,0,0,0,-352000,2000,4000,-2000,0,350000,-350000,-3127000
2349,錸德            ,557640,3964000,-3406360,0,0,0,0,0,0,0,0,0,0,0,0,0,-3406360
2409,友達            ,11905000,17319445,-5414445,0,0,0,0,0,0,1895000,2070000,90000,1980000,5000,90000,-85000,-3519445
00669R,國泰美國道瓊反1 ,6000,2811000,-2805000,0,0,0,0,0,0,-779000,0,0,0,3055000,3834000,-779000,-3584000
2892,第一金          ,4609000,8420333,-3811333,0,0,0,14000,0,14000,19000,23000,10000,13000,6000,0,6000,-3778333
3017,奇鋐            ,2512000,3307000,-795000,0,0,0,0,2604000,-2604000,-413000,598000,973000,-375000,59000,97000,-38000,-3812000
1102,亞泥            ,1606000,5358218,-3752218,0,0,0,3000,0,3000,-90000,13000,8000,5000,0,95000,-95000,-3839218
2884,玉山金          ,8270898,12233280,-3962382,0,0,0,16000,0,16000,57000,16000,0,16000,43000,2000,41000,-3889382
2448,晶電            ,3826000,9593000,-5767000,0,0,0,0,30000,-30000,1770000,2202000,492000,1710000,60000,0,60000,-4027000
2610,華航            ,2416000,6707330,-4291330,0,0,0,0,0,0,-40000,0,0,0,0,40000,-40000,-4331330
3042,晶技            ,2150000,4112188,-1962188,0,0,0,150000,1603000,-1453000,-936000,97000,1009000,-912000,43000,67000,-24000,-4351188
2303,聯電            ,15896000,20737266,-4841266,0,0,0,15000,12000,3000,-656000,4000,112000,-108000,359000,907000,-548000,-5494266
2618,長榮航          ,3226000,9667728,-6441728,0,0,0,0,0,0,-43000,256000,237000,19000,41000,103000,-62000,-6484728
3231,緯創            ,4573000,9552000,-4979000,0,0,0,0,1842000,-1842000,-68000,140000,48000,92000,10000,170000,-160000,-6889000
2330,台積電          ,17180678,27839938,-10659260,0,0,0,50000,101000,-51000,476000,493000,125000,368000,253000,145000,108000,-10234260
2337,旺宏            ,4120000,13858000,-9738000,0,0,0,874000,450000,424000,-1302000,105000,1336000,-1231000,290000,361000,-71000,-10616000
2885,元大金          ,9147000,38490000,-29343000,0,0,0,15000,0,15000,824000,844000,20000,824000,4000,4000,0,-28504000
00677U,富邦VIX         ,371000,74071000,-73700000,0,0,0,0,0,0,-39840000,0,5080000,-5080000,1146000,35906000,-34760000,-113540000
