證券代號,證券名稱,外陸資買進股數(不含外資自營商),外陸資賣出股數(不含外資自營商),外陸資買賣超股數(不含外資自營商),外資自營商買進股數,外資自營商賣出股數,外資自營商買賣超股數,投信買進股數,投信賣出股數,投信買賣超股數,自營商買賣超股數,自營商買進股數(自行買賣),自營商賣出股數(自行買賣),自營商買賣超股數(自行買賣),自營商買進股數(避險),自營商賣出股數(避險),自營商買賣超股數(避險),三大法人買賣超股數
3481,群創            ,102244000,23411876,78832124,0,0,0,0,30000,-30000,10171000,1067000,348000,719000,9874000,422000,9452000,88973124
2409,友達            ,81862000,25035000,56827000,0,0,0,535000,4168000,-3633000,12990000,3115000,418000,2697000,10658000,365000,10293000,66184000
2303,聯電            ,30157792,5285642,24872150,0,0,0,126000,54000,72000,1324000,1480000,70000,1410000,92000,178000,-86000,26268150
0056,元大高股息      ,5105,11000,-5895,0,0,0,0,150000,-150000,20494000,50000,0,50000,20444000,0,20444000,20338105
2883,開發金          ,24069619,6725000,17344619,0,0,0,0,43000,-43000,2937000,1784000,32000,1752000,1391000,206000,1185000,20238619
2330,台積電          ,42710984,28057503,14653481,0,0,0,471000,95000,376000,4470000,4081000,42000,4039000,581000,150000,431000,19499481
2888,新光金          ,23406518,5036019,18370499,0,0,0,0,36000,-36000,-54000,67000,320000,-253000,404000,205000,199000,18280499
2882,國泰金          ,18639503,4482034,14157469,0,0,0,0,27000,-27000,2024000,1496000,30000,1466000,638000,80000,558000,16154469
2887,台新金          ,16287465,4408000,11879465,0,0,0,0,32000,-32000,1341000,1349000,8000,1341000,0,0,0,13188465
2002,中鋼            ,17222871,5993000,11229871,0,0,0,0,39000,-39000,1821000,1822000,14000,1808000,24000,11000,13000,13011871
2317,鴻海            ,19228909,9180287,10048622,0,0,0,764000,36000,728000,1983000,1792000,21000,1771000,1114000,902000,212000,12759622
0050,元大台灣50      ,7065000,552001,6512999,0,0,0,0,100000,-100000,5561000,1989000,200000,1789000,5220000,1448000,3772000,11973999
1605,華新            ,16209000,4109000,12100000,0,0,0,0,1000,-1000,-1382000,40000,6000,34000,262000,1678000,-1416000,10717000
2834,臺企銀          ,11928312,3498358,8429954,0,0,0,0,15000,-15000,2154000,1949000,0,1949000,205000,0,205000,10568954
00861,元大全球未來通訊,2591000,3000,2588000,0,0,0,0,0,0,7927000,1043000,0,1043000,7039000,155000,6884000,10515000
2891,中信金          ,19352274,10346831,9005443,0,0,0,0,1017000,-1017000,2258000,2285000,21000,2264000,0,6000,-6000,10246443
5880,合庫金          ,11692417,4205809,7486608,0,0,0,0,30000,-30000,1526000,1536000,10000,1526000,0,0,0,8982608
2886,兆豐金          ,12673913,6286000,6387913,0,0,0,893000,35000,858000,1462000,1971000,21000,1950000,0,488000,-488000,8707913
6116,彩晶            ,12018000,5913000,6105000,0,0,0,0,0,0,2150000,427000,126000,301000,2123000,274000,1849000,8255000
2881,富邦金          ,9304622,2978000,6326622,0,0,0,0,23000,-23000,1493000,1279000,2000,1277000,224000,8000,216000,7796622
1314,中石化          ,7894000,2407000,5487000,0,0,0,0,0,0,1725000,1737000,66000,1671000,192000,138000,54000,7212000
1301,台塑            ,6761159,2486695,4274464,0,0,0,1245000,11000,1234000,1025000,978000,12000,966000,59000,0,59000,6533464
4938,和碩            ,7471872,3276220,4195652,0,0,0,635000,11000,624000,1563000,1735000,16000,1719000,95000,251000,-156000,6382652
2880,華南金          ,8915573,4139000,4776573,0,0,0,0,29000,-29000,1442000,1461000,19000,1442000,0,0,0,6189573
2823,中壽            ,7044871,1988000,5056871,0,0,0,0,9000,-9000,1077000,1293000,9000,1284000,100000,307000,-207000,6124871
2308,台達電          ,7370911,2363000,5007911,0,0,0,529000,11000,518000,567000,482000,75000,407000,177000,17000,160000,6092911
1303,南亞            ,7687544,2732904,4954640,0,0,0,0,33000,-33000,967000,965000,9000,956000,11000,0,11000,5888640
5876,上海商銀        ,6024070,1005801,5018269,0,0,0,0,0,0,578000,533000,3000,530000,114000,66000,48000,5596269
9904,寶成            ,6599938,1773000,4826938,0,0,0,0,8000,-8000,764000,654000,73000,581000,193000,10000,183000,5582938
6505,台塑化          ,6215155,1876577,4338578,0,0,0,0,73000,-73000,1293000,1313000,20000,1293000,0,0,0,5558578
1309,台達化          ,6225000,1159000,5066000,0,0,0,0,0,0,4000,74000,70000,4000,0,0,0,5070000
2408,南亞科          ,10258221,5923000,4335221,0,0,0,0,82000,-82000,795000,777000,100000,677000,373000,255000,118000,5048221
2324,仁寶            ,8812213,4238500,4573713,0,0,0,0,12000,-12000,438000,1049000,0,1049000,266000,877000,-611000,4999713
2801,彰銀            ,6906260,2160020,4746240,0,0,0,0,21000,-21000,237000,121000,6000,115000,122000,0,122000,4962240
1402,遠東新          ,6352168,2352000,4000168,0,0,0,0,13000,-13000,922000,631000,28000,603000,320000,1000,319000,4909168
2356,英業達          ,6140693,2716253,3424440,0,0,0,1478000,9000,1469000,-8000,630000,0,630000,143000,781000,-638000,4885440
2382,廣達            ,6939904,2868823,4071081,0,0,0,642000,15000,627000,153000,603000,213000,390000,26000,263000,-237000,4851081
2610,華航            ,5300453,674100,4626353,0,0,0,0,9000,-9000,172000,65000,2000,63000,109000,0,109000,4789353
2412,中華電          ,6138026,2897000,3241026,0,0,0,0,13000,-13000,950000,960000,10000,950000,0,0,0,4178026
1326,台化            ,5797817,2328000,3469817,0,0,0,0,22000,-22000,571000,723000,1000,722000,3000,154000,-151000,4018817
00637L,元大滬深300正2  ,4266000,3033000,1233000,0,0,0,0,0,0,2657000,0,0,0,32463000,29806000,2657000,3890000
2027,大成鋼          ,3953000,957000,2996000,0,0,0,0,0,0,638000,395000,49000,346000,962000,670000,292000,3634000
2104,國際中橡        ,3954000,1104000,2850000,0,0,0,0,0,0,667000,202000,0,202000,465000,0,465000,3517000
03443B,臺股指凱基9A熊27,88000,0,88000,0,0,0,0,0,0,3296000,0,0,0,4172000,876000,3296000,3384000
2618,長榮航          ,8795475,3391800,5403675,0,0,0,0,3215000,-3215000,1190000,875000,92000,783000,407000,0,407000,3378675
6213,聯茂            ,2891000,568000,2323000,0,0,0,473000,0,473000,546000,118000,13000,105000,451000,10000,441000,3342000
1101,台泥            ,9511171,6874212,2636959,0,0,0,0,14000,-14000,611000,641000,262000,379000,726000,494000,232000,3233959
2481,強茂            ,4933100,6649000,-1715900,0,0,0,4825000,0,4825000,99000,693000,545000,148000,118000,167000,-49000,3208100
2812,台中銀          ,2604000,515016,2088984,0,0,0,0,0,0,1085000,1085000,0,1085000,0,0,0,3173984
6269,台郡            ,1809900,761000,1048900,0,0,0,1961000,0,1961000,18000,131000,65000,66000,27000,75000,-48000,3027900
2105,正新            ,3610793,1110000,2500793,0,0,0,0,6000,-6000,508000,493000,1000,492000,16000,0,16000,3002793
2892,第一金          ,13272440,11686042,1586398,0,0,0,0,32000,-32000,1445000,1465000,20000,1445000,0,0,0,2999398
2201,裕隆            ,2695000,468000,2227000,0,0,0,0,0,0,748000,555000,0,555000,272000,79000,193000,2975000
2867,三商壽          ,2523000,249000,2274000,0,0,0,0,0,0,695000,695000,0,695000,0,0,0,2969000
2353,宏碁            ,4796773,2203000,2593773,0,0,0,0,8000,-8000,349000,530000,2000,528000,47000,226000,-179000,2934773
2312,金寶            ,4286000,1550000,2736000,0,0,0,0,0,0,194000,11000,0,11000,183000,0,183000,2930000
2845,遠東銀          ,2002000,118000,1884000,0,0,0,0,6000,-6000,987000,987000,0,987000,0,0,0,2865000
3045,台灣大          ,2759859,297748,2462111,0,0,0,0,12000,-12000,398000,421000,23000,398000,0,0,0,2848111
2454,聯發科          ,6068423,3592075,2476348,0,0,0,83000,7000,76000,291000,239000,4000,235000,80000,24000,56000,2843348
054377,臺股指中信99購09,0,0,0,0,0,0,0,0,0,2730000,0,0,0,2730000,0,2730000,2730000
052959,聯電凱基97購01  ,0,0,0,0,0,0,0,0,0,2673000,0,0,0,2673000,0,2673000,2673000
2603,長榮            ,4366443,4345500,20943,0,0,0,175000,9000,166000,2445000,2796000,350000,2446000,0,1000,-1000,2631943
2371,大同            ,3426310,1281000,2145310,0,0,0,0,0,0,459000,459000,0,459000,0,0,0,2604310
1312,國喬            ,3236000,611000,2625000,0,0,0,0,0,0,-45000,10000,83000,-73000,32000,4000,28000,2580000
2313,華通            ,4377000,2989000,1388000,0,0,0,423000,3000,420000,735000,1025000,453000,572000,531000,368000,163000,2543000
3661,世芯-KY         ,3075000,865200,2209800,0,0,0,80000,105000,-25000,356000,269000,69000,200000,189000,33000,156000,2540800
2492,華新科          ,3468407,1506589,1961818,0,0,0,220000,1000,219000,335000,61000,9000,52000,491000,208000,283000,2515818
2633,台灣高鐵        ,3708247,1822582,1885665,0,0,0,0,6000,-6000,579000,466000,1000,465000,174000,60000,114000,2458665
5871,中租-KY         ,3676799,1433821,2242978,0,0,0,0,4000,-4000,199000,183000,10000,173000,31000,5000,26000,2437978
3006,晶豪科          ,2661360,728000,1933360,0,0,0,0,0,0,488000,67000,1000,66000,609000,187000,422000,2421360
6251,定穎            ,2946000,604000,2342000,0,0,0,0,0,0,3000,3000,0,3000,0,0,0,2345000
3231,緯創            ,8162542,6709000,1453542,0,0,0,1576000,1008000,568000,304000,778000,0,778000,34000,508000,-474000,2325542
2301,光寶科          ,5337420,4212000,1125420,0,0,0,750000,7000,743000,382000,777000,84000,693000,5000,316000,-311000,2250420
052602,聯電元大97購01  ,0,0,0,0,0,0,0,0,0,2231000,0,0,0,3879000,1648000,2231000,2231000
07546P,玉晶光凱基9A售09,0,0,0,0,0,0,0,0,0,2225000,0,0,0,2342000,117000,2225000,2225000
00648R,元大S&P500反1   ,0,0,0,0,0,0,0,0,0,2223000,0,0,0,2759000,536000,2223000,2223000
2327,國巨            ,4022433,2421000,1601433,0,0,0,0,0,0,588000,428000,31000,397000,277000,86000,191000,2189433
2323,中環            ,2747000,888000,1859000,0,0,0,0,0,0,292000,211000,0,211000,82000,1000,81000,2151000
2515,中工            ,2447000,363000,2084000,0,0,0,0,0,0,60000,22000,0,22000,46000,8000,38000,2144000
059503,大立光富邦9B購04,0,0,0,0,0,0,0,0,0,2126000,0,0,0,2346000,220000,2126000,2126000
00651R,FH香港反1       ,148000,121000,27000,0,0,0,0,0,0,2064000,0,0,0,3222000,1158000,2064000,2091000
5469,瀚宇博          ,2027057,396000,1631057,0,0,0,0,74865,-74865,442000,4000,38000,-34000,484000,8000,476000,1998192
053798,台積電中信98購02,0,0,0,0,0,0,0,0,0,1957000,0,0,0,1977000,20000,1957000,1957000
2347,聯強            ,3460529,2064000,1396529,0,0,0,302000,0,302000,232000,1087000,421000,666000,0,434000,-434000,1930529
5471,松翰            ,3596000,1676000,1920000,0,0,0,0,0,0,2000,2000,0,2000,0,0,0,1922000
2542,興富發          ,2659946,936000,1723946,0,0,0,0,0,0,186000,377000,139000,238000,91000,143000,-52000,1909946
00669R,國泰美國道瓊反1 ,0,0,0,0,0,0,0,0,0,1864000,0,0,0,2377000,513000,1864000,1864000
00850,元大臺灣ESG永續 ,1000,11000,-10000,0,0,0,0,0,0,1810000,0,0,0,2006000,196000,1810000,1800000
1216,統一            ,8557390,7766008,791382,0,0,0,350000,28000,322000,674000,695000,18000,677000,1000,4000,-3000,1787382
2838,聯邦銀          ,1175000,261000,914000,0,0,0,0,0,0,846000,846000,0,846000,0,0,0,1760000
057987,大立光元富98購02,0,0,0,0,0,0,0,0,0,1734000,0,0,0,2196000,462000,1734000,1734000
3682,亞太電          ,2098169,371554,1726615,0,0,0,0,0,0,0,0,0,0,0,0,0,1726615
047962,T50反1中信96購02,0,0,0,0,0,0,0,0,0,1711000,0,0,0,2638000,927000,1711000,1711000
1718,中纖            ,1899000,249000,1650000,0,0,0,0,0,0,31000,31000,0,31000,0,0,0,1681000
1609,大亞            ,564000,39000,525000,0,0,0,0,1000,-1000,1152000,1152000,0,1152000,0,0,0,1676000
1409,新纖            ,1686000,408000,1278000,0,0,0,0,0,0,394000,394000,0,394000,0,0,0,1672000
060702,玉晶光國泰9C購02,0,0,0,0,0,0,0,0,0,1638000,0,0,0,1943000,305000,1638000,1638000
060046,S&P反1凱基99購02,0,0,0,0,0,0,0,0,0,1546000,0,0,0,1550000,4000,1546000,1546000
063346,TPK統一9C購01   ,0,0,0,0,0,0,0,0,0,1506000,0,0,0,1562000,56000,1506000,1506000
058315,TPK富邦9C購01   ,0,0,0,0,0,0,0,0,0,1491000,0,0,0,1507000,16000,1491000,1491000
056138,群創元大9B購01  ,0,0,0,0,0,0,0,0,0,1488000,0,0,0,1488000,0,1488000,1488000
00692,富邦公司治理    ,0,0,0,0,0,0,0,0,0,1482000,0,0,0,3410000,1928000,1482000,1482000
00631L,元大台灣50正2   ,538000,563000,-25000,0,0,0,0,0,0,1507000,599000,55000,544000,2027000,1064000,963000,1482000
00752,中信中國50      ,9000,10000,-1000,0,0,0,0,0,0,1480000,0,0,0,2303000,823000,1480000,1479000
07981P,上銀群益9B售04  ,0,0,0,0,0,0,0,0,0,1477000,0,0,0,1497000,20000,1477000,1477000
2103,台橡            ,1363000,105000,1258000,0,0,0,0,0,0,130000,130000,0,130000,0,0,0,1388000
1802,台玻            ,1286000,390000,896000,0,0,0,0,0,0,476000,476000,0,476000,0,0,0,1372000
2520,冠德            ,1611000,724000,887000,0,0,0,61000,0,61000,350000,336000,20000,316000,34000,0,34000,1298000
2809,京城銀          ,1184000,220863,963137,0,0,0,0,3000,-3000,328000,328000,0,328000,0,0,0,1288137
03657C,T50反1元大99牛01,0,0,0,0,0,0,0,0,0,1286000,0,0,0,1440000,154000,1286000,1286000
2897,王道銀行        ,684000,150000,534000,0,0,0,0,0,0,709000,711000,2000,709000,0,0,0,1243000
1434,福懋            ,1634100,955000,679100,0,0,0,0,3000,-3000,563000,563000,0,563000,0,0,0,1239100
1305,華夏            ,1526000,292000,1234000,0,0,0,0,0,0,3000,6000,3000,3000,0,0,0,1237000
2889,國票金          ,1264000,864000,400000,0,0,0,0,0,0,833000,838000,5000,833000,0,0,0,1233000
06822P,上銀富邦99售03  ,0,0,0,0,0,0,0,0,0,1228000,0,0,0,1332000,104000,1228000,1228000
4904,遠傳            ,1873837,1136000,737837,0,0,0,0,6000,-6000,459000,482000,19000,463000,0,4000,-4000,1190837
5264,鎧勝-KY         ,2307000,1458000,849000,0,0,0,0,0,0,327000,76000,59000,17000,363000,53000,310000,1176000
1536,和大            ,1009000,263000,746000,0,0,0,50000,41000,9000,406000,95000,0,95000,336000,25000,311000,1161000
060191,亞光元富9A購02  ,0,0,0,0,0,0,0,0,0,1160000,0,0,0,1183000,23000,1160000,1160000
063583,GIS國泰01購01   ,0,0,0,0,0,0,0,0,0,1127000,0,0,0,1251000,124000,1127000,1127000
063672,GIS統一9C購01   ,0,0,0,0,0,0,0,0,0,1126000,0,0,0,1664000,538000,1126000,1126000
2332,友訊            ,796000,47000,749000,0,0,0,0,0,0,376000,39000,0,39000,337000,0,337000,1125000
049153,大立光元大96購02,0,0,0,0,0,0,0,0,0,1116000,0,0,0,1116000,0,1116000,1116000
1710,東聯            ,962000,46000,916000,0,0,0,0,2000,-2000,194000,194000,0,194000,0,0,0,1108000
1304,台聚            ,1492000,101000,1391000,0,0,0,0,553000,-553000,265000,265000,0,265000,0,0,0,1103000
07743P,智邦凱基9A售03  ,0,0,0,0,0,0,0,0,0,1099000,0,0,0,1104000,5000,1099000,1099000
047564,滬深2X國票99購01,0,0,0,0,0,0,0,0,0,1091000,0,0,0,1286000,195000,1091000,1091000
2884,玉山金          ,16057505,16120000,-62495,0,0,0,0,34000,-34000,1182000,1373000,60000,1313000,219000,350000,-131000,1085505
1319,東陽            ,928000,153000,775000,0,0,0,0,0,0,310000,350000,40000,310000,0,0,0,1085000
07210P,智邦凱基99售03  ,0,0,0,0,0,0,0,0,0,1075000,0,0,0,1076000,1000,1075000,1075000
4142,國光生          ,1152000,73000,1079000,0,0,0,0,100000,-100000,72000,3000,0,3000,89000,20000,69000,1051000
057087,台郡統一99購01  ,0,0,0,0,0,0,0,0,0,1043000,0,0,0,1103000,60000,1043000,1043000
07800P,華新科國泰9B售04,0,0,0,0,0,0,0,0,0,1027000,0,0,0,1027000,0,1027000,1027000
059395,T50反1元富99購03,0,0,0,0,0,0,0,0,0,1027000,0,0,0,1091000,64000,1027000,1027000
1907,永豐餘          ,906000,153000,753000,0,0,0,0,0,0,273000,273000,0,273000,0,0,0,1026000
061081,宏碁兆豐9A購01  ,0,0,0,0,0,0,0,0,0,1019000,0,0,0,1290000,271000,1019000,1019000
057202,TPK元富98購02   ,0,0,0,0,0,0,0,0,0,1016000,0,0,0,1036000,20000,1016000,1016000
2357,華碩            ,1093668,557165,536503,0,0,0,236000,2000,234000,236000,356000,57000,299000,0,63000,-63000,1006503
062215,華通統一9B購01  ,0,0,0,0,0,0,0,0,0,996000,0,0,0,1361000,365000,996000,996000
1909,榮成            ,4654000,3725000,929000,0,0,0,0,2000,-2000,61000,355000,294000,61000,0,0,0,988000
07788P,華新科群益9A售08,0,0,0,0,0,0,0,0,0,977000,0,0,0,998000,21000,977000,977000
08094P,華新科元富9B售05,0,0,0,0,0,0,0,0,0,969000,0,0,0,1000000,31000,969000,969000
060935,T50反1國票9A購08,0,0,0,0,0,0,0,0,0,966000,0,0,0,998000,32000,966000,966000
059307,T50反1元大99購06,0,0,0,0,0,0,0,0,0,962000,0,0,0,1032000,70000,962000,962000
063111,TPK兆豐9B購01   ,0,0,0,0,0,0,0,0,0,936000,0,0,0,956000,20000,936000,936000
06984P,上銀富邦9B售01  ,0,0,0,0,0,0,0,0,0,933000,0,0,0,954000,21000,933000,933000
049023,玉晶光群益96購04,0,0,0,0,0,0,0,0,0,933000,0,0,0,933000,0,933000,933000
062087,瑞祺元大9B購02  ,0,0,0,0,0,0,0,0,0,929000,0,0,0,1246000,317000,929000,929000
06680P,智邦元大98售06  ,0,0,0,0,0,0,0,0,0,927000,0,0,0,937000,10000,927000,927000
08183P,聯發科永豐9B售04,0,0,0,0,0,0,0,0,0,926000,0,0,0,926000,0,926000,926000
2723,美食-KY         ,714000,564918,149082,0,0,0,514000,0,514000,250000,3000,2000,1000,270000,21000,249000,913082
2606,裕民            ,817000,167000,650000,0,0,0,0,1000,-1000,260000,255000,2000,253000,7000,0,7000,909000
062395,台表科富邦9C購01,0,0,0,0,0,0,0,0,0,908000,0,0,0,962000,54000,908000,908000
058647,華新科永豐99購03,0,0,0,0,0,0,0,0,0,900000,0,0,0,900000,0,900000,900000
3515,華擎            ,953000,608000,345000,0,0,0,40000,0,40000,511000,79000,5000,74000,469000,32000,437000,896000
2615,萬海            ,713000,212000,501000,0,0,0,0,2000,-2000,392000,404000,12000,392000,0,0,0,891000
056671,台灣50元富9A購01,0,0,0,0,0,0,0,0,0,886000,0,0,0,1029000,143000,886000,886000
060390,聯鈞群益9A購01  ,0,0,0,0,0,0,0,0,0,885000,0,0,0,983000,98000,885000,885000
2014,中鴻            ,717000,186000,531000,0,0,0,0,0,0,353000,353000,0,353000,0,0,0,884000
062975,京鼎元富9B購01  ,0,0,0,0,0,0,0,0,0,872000,0,0,0,1099000,227000,872000,872000
059396,T50反1元富99購04,0,0,0,0,0,0,0,0,0,871000,0,0,0,998000,127000,871000,871000
07641P,上銀凱基9A售05  ,0,0,0,0,0,0,0,0,0,869000,0,0,0,870000,1000,869000,869000
062219,燿華統一9B購01  ,0,0,0,0,0,0,0,0,0,868000,0,0,0,1074000,206000,868000,868000
059560,T50反1凱基99購08,0,0,0,0,0,0,0,0,0,863000,0,0,0,977000,114000,863000,863000
2601,益航            ,938000,88000,850000,0,0,0,0,0,0,11000,11000,0,11000,0,0,0,861000
062392,國巨富邦02購01  ,0,0,0,0,0,0,0,0,0,854000,0,0,0,1202000,348000,854000,854000
056829,台積電富邦9A購01,0,0,0,0,0,0,0,0,0,843000,0,0,0,973000,130000,843000,843000
00671R,富邦NASDAQ反1   ,512000,46000,466000,0,0,0,0,0,0,375000,0,0,0,626000,251000,375000,841000
055063,玉晶光永豐99購01,0,0,0,0,0,0,0,0,0,837000,0,0,0,870000,33000,837000,837000
054633,臺股指凱基9A購02,0,0,0,0,0,0,0,0,0,836000,0,0,0,836000,0,836000,836000
08170P,緯穎群益9B售03  ,0,0,0,0,0,0,0,0,0,831000,0,0,0,849000,18000,831000,831000
054244,華新元大96購01  ,0,0,0,0,0,0,0,0,0,830000,0,0,0,900000,70000,830000,830000
057389,玉晶光永豐98購06,0,0,0,0,0,0,0,0,0,829000,0,0,0,850000,21000,829000,829000
08205P,智邦凱基9B售03  ,0,0,0,0,0,0,0,0,0,828000,0,0,0,874000,46000,828000,828000
061123,燿華永豐9A購01  ,0,0,0,0,0,0,0,0,0,813000,0,0,0,814000,1000,813000,813000
07990P,緯穎凱基9B售02  ,0,0,0,0,0,0,0,0,0,810000,0,0,0,1080000,270000,810000,810000
07774P,台灣50群益9A售16,0,0,0,0,0,0,0,0,0,808000,0,0,0,932000,124000,808000,808000
059559,T50反1凱基99購07,0,0,0,0,0,0,0,0,0,805000,0,0,0,1005000,200000,805000,805000
08506P,台灣50中信96售02,0,0,0,0,0,0,0,0,0,800000,0,0,0,800000,0,800000,800000
052978,貿聯麥證97購01  ,0,0,0,800000,0,800000,0,0,0,800000,0,0,0,800000,0,800000,800000
060225,S&P反1元大9A購02,0,0,0,0,0,0,0,0,0,799000,0,0,0,799000,0,799000,799000
063774,GIS富邦9B購02   ,0,0,0,0,0,0,0,0,0,795000,0,0,0,962000,167000,795000,795000
9921,巨大            ,1063363,641574,421789,0,0,0,261000,1000,260000,111000,87000,6000,81000,40000,10000,30000,792789
1103,嘉泥            ,366000,29000,337000,0,0,0,0,0,0,455000,455000,0,455000,0,0,0,792000
07658P,國泰金凱基9A售01,0,0,0,0,0,0,0,0,0,780000,0,0,0,780000,0,780000,780000
063671,GIS統一01購01   ,0,0,0,0,0,0,0,0,0,780000,0,0,0,1181000,401000,780000,780000
3042,晶技            ,1433000,1009000,424000,0,0,0,378000,40000,338000,15000,225000,231000,-6000,84000,63000,21000,777000
4915,致伸            ,1122000,964230,157770,0,0,0,379000,1000,378000,241000,86000,0,86000,240000,85000,155000,776770
07825P,健策國泰9B售04  ,0,0,0,0,0,0,0,0,0,770000,0,0,0,770000,0,770000,770000
06844P,智邦元大98售13  ,0,0,0,0,0,0,0,0,0,767000,0,0,0,777000,10000,767000,767000
061035,亞光永豐9A購01  ,0,0,0,0,0,0,0,0,0,767000,0,0,0,770000,3000,767000,767000
057763,康控凱基99購02  ,0,0,0,0,0,0,0,0,0,760000,0,0,0,800000,40000,760000,760000
062910,亞光元大9B購01  ,0,0,0,0,0,0,0,0,0,760000,0,0,0,827000,67000,760000,760000
3702,大聯大          ,1849958,731760,1118198,0,0,0,0,1000,-1000,-364000,282000,150000,132000,0,496000,-496000,753198
2478,大毅            ,1163000,814000,349000,0,0,0,144000,0,144000,260000,39000,0,39000,255000,34000,221000,753000
07878P,智邦群益9C售01  ,0,0,0,0,0,0,0,0,0,751000,0,0,0,761000,10000,751000,751000
07976P,聯發科群益9C售02,0,0,0,0,0,0,0,0,0,749000,0,0,0,881000,132000,749000,749000
055670,矽創群益98購02  ,0,0,0,0,0,0,0,0,0,744000,0,0,0,810000,66000,744000,744000
3711,日月光投控      ,5787575,6039123,-251548,0,0,0,0,17000,-17000,1009000,862000,184000,678000,340000,9000,331000,740452
061306,瑞祺永豐9A購02  ,0,0,0,0,0,0,0,0,0,736000,0,0,0,765000,29000,736000,736000
054962,玉晶光元大99購02,0,0,0,0,0,0,0,0,0,731000,0,0,0,731000,0,731000,731000
3049,和鑫            ,1470000,1116000,354000,0,0,0,0,0,0,377000,8000,0,8000,414000,45000,369000,731000
06604P,聯發科元富02售02,0,0,0,0,0,0,0,0,0,729000,0,0,0,1027000,298000,729000,729000
2489,瑞軒            ,678000,127000,551000,0,0,0,0,0,0,175000,176000,1000,175000,0,0,0,726000
063332,矽格國票9B購01  ,0,0,0,0,0,0,0,0,0,725000,0,0,0,907000,182000,725000,725000
2511,太子            ,792000,69000,723000,0,0,0,0,0,0,1000,28000,27000,1000,0,0,0,724000
1795,美時            ,877000,145000,732000,0,0,0,0,0,0,-9000,1000,10000,-9000,0,0,0,723000
9907,統一實          ,807000,115000,692000,0,0,0,0,0,0,29000,29000,0,29000,0,0,0,721000
061594,玉晶光永豐9A購08,0,0,0,0,0,0,0,0,0,720000,0,0,0,871000,151000,720000,720000
2107,厚生            ,890000,176000,714000,0,0,0,0,0,0,5000,5000,0,5000,0,0,0,719000
042315,T50反1台新96購01,0,0,0,0,0,0,0,0,0,719000,0,0,0,719000,0,719000,719000
2354,鴻準            ,1392232,911000,481232,0,0,0,0,0,0,237000,241000,4000,237000,0,0,0,718232
07816P,聯發科群益9A售02,0,0,0,0,0,0,0,0,0,717000,0,0,0,772000,55000,717000,717000
08125P,聯茂群益9B售02  ,0,0,0,0,0,0,0,0,0,716000,0,0,0,716000,0,716000,716000
061915,T50反1凱基02購02,0,0,0,0,0,0,0,0,0,716000,0,0,0,1041000,325000,716000,716000
2820,華票            ,474000,161000,313000,0,0,0,0,0,0,393000,393000,0,393000,0,0,0,706000
063850,玉晶光元大9C購07,0,0,0,0,0,0,0,0,0,706000,0,0,0,1010000,304000,706000,706000
2204,中華            ,596000,79000,517000,0,0,0,0,1000,-1000,187000,197000,10000,187000,0,0,0,703000
3443,創意            ,637000,132000,505000,0,0,0,0,0,0,193000,99000,5000,94000,102000,3000,99000,698000
058661,臺股指中信9C購01,0,0,0,0,0,0,0,0,0,695000,0,0,0,695000,0,695000,695000
07608P,台灣50國票9C售03,0,0,0,0,0,0,0,0,0,694000,0,0,0,694000,0,694000,694000
07010P,T50正2凱基9C售01,0,0,0,0,0,0,0,0,0,691000,0,0,0,692000,1000,691000,691000
056394,晶豪科永豐98購01,0,0,0,0,0,0,0,0,0,688000,0,0,0,833000,145000,688000,688000
1440,南紡            ,757000,94000,663000,0,0,0,0,0,0,24000,24000,0,24000,0,0,0,687000
057740,茂林富邦9A購01  ,0,0,0,0,0,0,0,0,0,687000,0,0,0,692000,5000,687000,687000
3698,隆達            ,863000,281000,582000,0,0,0,0,0,0,104000,96000,0,96000,8000,0,8000,686000
07963P,智邦統一9B售01  ,0,0,0,0,0,0,0,0,0,682000,0,0,0,838000,156000,682000,682000
00830,國泰費城半導體  ,497000,8000,489000,0,0,0,0,0,0,193000,50000,0,50000,504000,361000,143000,682000
006205,富邦上証        ,391000,7000,384000,0,0,0,0,0,0,296000,0,0,0,1464000,1168000,296000,680000
054983,國巨元富97購04  ,0,0,0,0,0,0,0,0,0,677000,0,0,0,677000,0,677000,677000
6456,GIS-KY          ,1686000,2132000,-446000,0,0,0,1379000,0,1379000,-256000,137000,21000,116000,56000,428000,-372000,677000
1714,和桐            ,825000,163000,662000,0,0,0,0,0,0,13000,13000,0,13000,0,0,0,675000
054546,玉晶光中信9B購01,0,0,0,0,0,0,0,0,0,675000,0,0,0,4490000,3815000,675000,675000
062885,臻鼎兆豐9C購01  ,0,0,0,0,0,0,0,0,0,672000,0,0,0,763000,91000,672000,672000
08036P,嘉澤群益9B售03  ,0,0,0,0,0,0,0,0,0,670000,0,0,0,670000,0,670000,670000
062828,聯詠群益9B購02  ,0,0,0,0,0,0,0,0,0,670000,0,0,0,700000,30000,670000,670000
6531,愛普            ,1693000,1128000,565000,0,0,0,105000,0,105000,-3000,2000,5000,-3000,0,0,0,667000
062498,華通群益9C購04  ,0,0,0,0,0,0,0,0,0,662000,0,0,0,746000,84000,662000,662000
061742,奇鋐凱基9B購01  ,0,0,0,0,0,0,0,0,0,657000,0,0,0,657000,0,657000,657000
057567,嘉聯益富邦9A購01,0,0,0,0,0,0,0,0,0,648000,0,0,0,1034000,386000,648000,648000
057266,TPK兆豐98購02   ,0,0,0,0,0,0,0,0,0,641000,0,0,0,928000,287000,641000,641000
3023,信邦            ,760000,291000,469000,0,0,0,75000,18000,57000,113000,89000,27000,62000,55000,4000,51000,639000
063268,GIS中信9B購01   ,0,0,0,0,0,0,0,0,0,637000,0,0,0,835000,198000,637000,637000
059932,世紀鋼富邦9A購02,0,0,0,0,0,0,0,0,0,635000,0,0,0,639000,4000,635000,635000
059631,京元電凱基99購02,0,0,0,0,0,0,0,0,0,633000,0,0,0,1169000,536000,633000,633000
08074P,緯穎元富9B售02  ,0,0,0,0,0,0,0,0,0,630000,0,0,0,870000,240000,630000,630000
6120,達運            ,637000,129000,508000,0,0,0,0,0,0,121000,121000,0,121000,0,0,0,629000
4551,智伸科          ,386000,282000,104000,0,0,0,360000,0,360000,160000,61000,7000,54000,108000,2000,106000,624000
063586,燿華永豐9B購02  ,0,0,0,0,0,0,0,0,0,623000,0,0,0,653000,30000,623000,623000
058677,矽格群益99購01  ,0,0,0,0,0,0,0,0,0,623000,0,0,0,628000,5000,623000,623000
06684P,緯穎元大98售06  ,0,0,0,0,0,0,0,0,0,620000,0,0,0,650000,30000,620000,620000
2101,南港            ,641000,251000,390000,0,0,0,0,0,0,230000,130000,0,130000,102000,2000,100000,620000
07850P,健策群益9A售06  ,0,0,0,0,0,0,0,0,0,618000,0,0,0,618000,0,618000,618000
1313,聯成            ,755000,137000,618000,0,0,0,0,0,0,-7000,19000,26000,-7000,0,0,0,611000
063673,GIS統一9C購02   ,0,0,0,0,0,0,0,0,0,610000,0,0,0,747000,137000,610000,610000
063615,瑞祺群益9B購03  ,0,0,0,0,0,0,0,0,0,609000,0,0,0,620000,11000,609000,609000
2841,台開            ,831000,234000,597000,0,0,0,0,0,0,12000,12000,0,12000,0,0,0,609000
2534,宏盛            ,792000,197000,595000,0,0,0,0,0,0,8000,8000,0,8000,0,0,0,603000
062386,京鼎國泰9C購01  ,0,0,0,0,0,0,0,0,0,603000,0,0,0,649000,46000,603000,603000
06486P,麗豐元大98售02  ,0,0,0,0,0,0,0,0,0,600000,0,0,0,890000,290000,600000,600000
4919,新唐            ,676000,91000,585000,0,0,0,0,0,0,15000,3000,10000,-7000,22000,0,22000,600000
4958,臻鼎-KY         ,1551160,2036000,-484840,0,0,0,966000,1000,965000,118000,280000,145000,135000,26000,43000,-17000,598160
061292,玉晶光統一01購06,0,0,0,0,0,0,0,0,0,598000,0,0,0,609000,11000,598000,598000
060561,台積電富邦04購01,0,0,0,0,0,0,0,0,0,598000,0,0,0,824000,226000,598000,598000
054533,泰碩國泰98購01  ,0,0,0,0,0,0,0,0,0,597000,0,0,0,1021000,424000,597000,597000
057730,聯鈞國泰9A購01  ,0,0,0,0,0,0,0,0,0,593000,0,0,0,816000,223000,593000,593000
6285,啟碁            ,287000,67000,220000,0,0,0,0,0,0,371000,378000,2000,376000,6000,11000,-5000,591000
00639,富邦深100       ,170000,8000,162000,0,0,0,0,0,0,428000,0,0,0,1453000,1025000,428000,590000
062819,奇鋐兆豐9B購01  ,0,0,0,0,0,0,0,0,0,590000,0,0,0,883000,293000,590000,590000
2049,上銀            ,854253,431000,423253,0,0,0,0,58000,-58000,223000,209000,2000,207000,31000,15000,16000,588253
2340,光磊            ,902000,404000,498000,0,0,0,0,0,0,88000,72000,0,72000,39000,23000,16000,586000
062220,台光電統一01購01,0,0,0,0,0,0,0,0,0,585000,0,0,0,681000,96000,585000,585000
058324,嘉聯益永豐9A購01,0,0,0,0,0,0,0,0,0,584000,0,0,0,671000,87000,584000,584000
062903,燿華元大9B購04  ,0,0,0,0,0,0,0,0,0,578000,0,0,0,598000,20000,578000,578000
060804,T50反1群益9A購02,0,0,0,0,0,0,0,0,0,578000,0,0,0,578000,0,578000,578000
059370,玉晶光元富99購02,0,0,0,0,0,0,0,0,0,574000,0,0,0,574000,0,574000,574000
07997P,上銀凱基9B售04  ,0,0,0,0,0,0,0,0,0,573000,0,0,0,573000,0,573000,573000
6177,達麗            ,580000,15000,565000,0,0,0,0,0,0,5000,5000,0,5000,0,0,0,570000
061055,康控群益9A購01  ,0,0,0,0,0,0,0,0,0,567000,0,0,0,876000,309000,567000,567000
00730,富邦臺灣優質高息,0,0,0,0,0,0,0,0,0,565000,0,0,0,1157000,592000,565000,565000
058200,世芯康和99購01  ,0,0,0,0,0,0,0,0,0,563000,0,0,0,1621000,1058000,563000,563000
2485,兆赫            ,690000,210000,480000,0,0,0,0,0,0,75000,77000,2000,75000,0,0,0,555000
2231,為升            ,604000,108000,496000,0,0,0,8000,0,8000,49000,19000,2000,17000,32000,0,32000,553000
061457,TPK凱基9A購01   ,0,0,0,0,0,0,0,0,0,553000,0,0,0,649000,96000,553000,553000
06855P,聯發科富邦9A售01,0,0,0,0,0,0,0,0,0,552000,0,0,0,578000,26000,552000,552000
06914P,南茂元大98售03  ,0,0,0,0,0,0,0,0,0,551000,0,0,0,571000,20000,551000,551000
061038,TPK永豐9A購01   ,0,0,0,0,0,0,0,0,0,551000,0,0,0,569000,18000,551000,551000
2474,可成            ,1145748,742000,403748,0,0,0,62000,5000,57000,90000,136000,18000,118000,3000,31000,-28000,550748
06576P,台光電群益98售03,0,0,0,0,0,0,0,0,0,549000,0,0,0,554000,5000,549000,549000
058495,元大金群益9B購01,0,0,0,0,0,0,0,0,0,548000,0,0,0,607000,59000,548000,548000
055639,上銀元富97購02  ,0,0,0,0,0,0,0,0,0,547000,0,0,0,568000,21000,547000,547000
055786,彩晶凱基99購02  ,0,0,0,0,0,0,0,0,0,546000,0,0,0,546000,0,546000,546000
062532,聯詠統一9C購01  ,0,0,0,0,0,0,0,0,0,546000,0,0,0,596000,50000,546000,546000
1736,喬山            ,481000,205000,276000,0,0,0,200000,0,200000,68000,3000,0,3000,69000,4000,65000,544000
062590,亞光統一9B購01  ,0,0,0,0,0,0,0,0,0,544000,0,0,0,560000,16000,544000,544000
061164,燿華兆豐9B購01  ,0,0,0,0,0,0,0,0,0,544000,0,0,0,581000,37000,544000,544000
058822,樺漢國泰9B購01  ,0,0,0,0,0,0,0,0,0,541000,0,0,0,966000,425000,541000,541000
2501,國建            ,346000,150000,196000,0,0,0,0,0,0,343000,353000,10000,343000,0,0,0,539000
062546,新日興永豐9B購01,0,0,0,0,0,0,0,0,0,539000,0,0,0,651000,112000,539000,539000
063383,億豐永豐9B購02  ,0,0,0,0,0,0,0,0,0,537000,0,0,0,723000,186000,537000,537000
055288,日電貿元大97購02,0,0,0,0,0,0,0,0,0,534000,0,0,0,661000,127000,534000,534000
2637,慧洋-KY         ,1040000,326000,714000,0,0,0,0,0,0,-181000,119000,0,119000,0,300000,-300000,533000
2442,新美齊          ,529000,41000,488000,0,0,0,0,0,0,42000,42000,0,42000,0,0,0,530000
08121P,聯發科國票9B售05,0,0,0,0,0,0,0,0,0,530000,0,0,0,564000,34000,530000,530000
062455,鴻海群益9C購01  ,0,0,0,0,0,0,0,0,0,529000,0,0,0,535000,6000,529000,529000
062325,鴻海統一9B購05  ,0,0,0,0,0,0,0,0,0,528000,0,0,0,528000,0,528000,528000
2905,三商            ,614000,99000,515000,0,0,0,0,0,0,12000,12000,0,12000,0,0,0,527000
07817P,同欣電群益9A售02,0,0,0,0,0,0,0,0,0,526000,0,0,0,556000,30000,526000,526000
056364,亞光元大99購02  ,0,0,0,0,0,0,0,0,0,525000,0,0,0,525000,0,525000,525000
07536P,華新科元富9A售04,0,0,0,0,0,0,0,0,0,524000,0,0,0,800000,276000,524000,524000
057633,緯穎永豐98購02  ,0,0,0,0,0,0,0,0,0,524000,0,0,0,525000,1000,524000,524000
061469,瑞祺群益9A購02  ,0,0,0,0,0,0,0,0,0,524000,0,0,0,685000,161000,524000,524000
2023,燁輝            ,626000,125000,501000,0,0,0,0,0,0,22000,22000,0,22000,0,0,0,523000
061798,晶豪科永豐9B購01,0,0,0,0,0,0,0,0,0,518000,0,0,0,523000,5000,518000,518000
063658,瑞祺元富9B購01  ,0,0,0,0,0,0,0,0,0,517000,0,0,0,640000,123000,517000,517000
052313,聯電元大98購01  ,0,0,0,0,0,0,0,0,0,514000,0,0,0,514000,0,514000,514000
053844,GIS統一96購01   ,0,0,0,0,0,0,0,0,0,513000,0,0,0,513000,0,513000,513000
056189,樺漢統一97購02  ,0,0,0,0,0,0,0,0,0,513000,0,0,0,707000,194000,513000,513000
2505,國揚            ,823000,340000,483000,0,0,0,0,0,0,28000,11000,0,11000,85000,68000,17000,511000
2634,漢翔            ,335000,211000,124000,0,0,0,0,1000,-1000,387000,321000,0,321000,67000,1000,66000,510000
052986,聯發科元大97購05,0,0,0,0,0,0,0,0,0,508000,0,0,0,508000,0,508000,508000
055338,GIS兆豐97購01   ,0,0,0,0,0,0,0,0,0,507000,0,0,0,707000,200000,507000,507000
062583,鴻海統一9C購12  ,0,0,0,0,0,0,0,0,0,507000,0,0,0,532000,25000,507000,507000
059454,亞光永豐99購01  ,0,0,0,0,0,0,0,0,0,502000,0,0,0,529000,27000,502000,502000
08210P,健策元富9B售02  ,0,0,0,0,0,0,0,0,0,501000,0,0,0,551000,50000,501000,501000
07575P,瑞昱元大9A售02  ,0,0,0,0,0,0,0,0,0,500000,0,0,0,530000,30000,500000,500000
056638,臺股指日盛98購01,0,0,0,0,0,0,0,0,0,500000,0,0,0,842000,342000,500000,500000
08181P,華新科國泰9C售02,0,0,0,0,0,0,0,0,0,499000,0,0,0,499000,0,499000,499000
2498,宏達電          ,1090000,796000,294000,0,0,0,0,0,0,205000,222000,38000,184000,104000,83000,21000,499000
06978P,聯發科富邦9B售02,0,0,0,0,0,0,0,0,0,499000,0,0,0,499000,0,499000,499000
055679,華通凱基99購01  ,0,0,0,0,0,0,0,0,0,499000,0,0,0,499000,0,499000,499000
051534,景碩國票97購01  ,0,0,0,0,0,0,0,0,0,499000,0,0,0,499000,0,499000,499000
061538,SP黃豆群益9A購03,0,0,0,0,0,0,0,0,0,499000,0,0,0,499000,0,499000,499000
061137,晶技統一9B購01  ,0,0,0,0,0,0,0,0,0,499000,0,0,0,521000,22000,499000,499000
06852P,臺股指元大98售11,0,0,0,0,0,0,0,0,0,498000,0,0,0,1247000,749000,498000,498000
054708,華通統一97購02  ,0,0,0,0,0,0,0,0,0,498000,0,0,0,498000,0,498000,498000
2338,光罩            ,590000,185000,405000,0,0,0,0,0,0,88000,1000,0,1000,119000,32000,87000,493000
050101,台積電永昌96購03,0,0,0,0,0,0,0,0,0,492000,0,0,0,492000,0,492000,492000
00634R,富邦上証反1     ,149000,386000,-237000,0,0,0,0,0,0,728891,0,0,0,1360000,631109,728891,491891
060376,瑞祺元富9A購01  ,0,0,0,0,0,0,0,0,0,491000,0,0,0,614000,123000,491000,491000
063226,康控群益9B購03  ,0,0,0,0,0,0,0,0,0,491000,0,0,0,792000,301000,491000,491000
059796,台積電國票99購10,0,0,0,0,0,0,0,0,0,489000,0,0,0,499000,10000,489000,489000
3665,貿聯-KY         ,395000,134000,261000,0,0,0,83000,0,83000,145000,25000,25000,0,152000,7000,145000,489000
2377,微星            ,4039316,3728015,311301,0,0,0,177000,2000,175000,2000,174000,20000,154000,92000,244000,-152000,488301
059375,道瓊反群益9C購02,0,0,0,0,0,0,0,0,0,488000,0,0,0,688000,200000,488000,488000
063312,台積電群益9B購07,0,0,0,0,0,0,0,0,0,487000,0,0,0,567000,80000,487000,487000
9136,巨騰-DR         ,155000,28000,127000,0,0,0,0,0,0,360000,360000,0,360000,0,0,0,487000
059976,道瓊銀元大99購01,0,0,0,0,0,0,0,0,0,485000,0,0,0,499000,14000,485000,485000
058622,國巨國票99購07  ,0,0,0,0,0,0,0,0,0,485000,0,0,0,494000,9000,485000,485000
07715P,台灣50群益9A售14,0,0,0,0,0,0,0,0,0,482000,0,0,0,644000,162000,482000,482000
063766,南茂元富9B購01  ,0,0,0,0,0,0,0,0,0,479000,0,0,0,539000,60000,479000,479000
06980P,緯穎永豐99售02  ,0,0,0,0,0,0,0,0,0,479000,0,0,0,509000,30000,479000,479000
055227,聯發科國票98購02,0,0,0,0,0,0,0,0,0,476000,0,0,0,476000,0,476000,476000
07951P,智邦元大9B售05  ,0,0,0,0,0,0,0,0,0,475000,0,0,0,571000,96000,475000,475000
053401,臺股指中信99購01,0,0,0,0,0,0,0,0,0,475000,0,0,0,475000,0,475000,475000
058154,泰碩統一9A購01  ,0,0,0,0,0,0,0,0,0,475000,0,0,0,668000,193000,475000,475000
057923,晶豪科凱基98購02,0,0,0,0,0,0,0,0,0,473000,0,0,0,495000,22000,473000,473000
1460,宏遠            ,522000,56000,466000,0,0,0,0,0,0,5000,5000,0,5000,0,0,0,471000
6282,康舒            ,618000,241000,377000,0,0,0,0,0,0,94000,99000,0,99000,0,5000,-5000,471000
063575,矽格元大9B購02  ,0,0,0,0,0,0,0,0,0,470000,0,0,0,559000,89000,470000,470000
055693,南茂凱基97購01  ,0,0,0,0,0,0,0,0,0,467000,0,0,0,467000,0,467000,467000
063079,儒鴻凱基9B購01  ,0,0,0,0,0,0,0,0,0,467000,0,0,0,547000,80000,467000,467000
047675,群創元富96購03  ,0,0,0,0,0,0,0,0,0,465000,0,0,0,465000,0,465000,465000
4906,正文            ,662000,311000,351000,0,0,0,0,0,0,114000,3000,7000,-4000,119000,1000,118000,465000
062647,南電國泰9C購02  ,0,0,0,0,0,0,0,0,0,464000,0,0,0,583000,119000,464000,464000
060566,聯詠富邦9C購01  ,0,0,0,0,0,0,0,0,0,464000,0,0,0,586000,122000,464000,464000
057306,玉晶光兆豐99購01,0,0,0,0,0,0,0,0,0,463000,0,0,0,483000,20000,463000,463000
062351,瑞祺群益9C購01  ,0,0,0,0,0,0,0,0,0,463000,0,0,0,614000,151000,463000,463000
057357,超眾統一98購01  ,0,0,0,0,0,0,0,0,0,462000,0,0,0,631000,169000,462000,462000
063535,聯發科統一9B購13,0,0,0,0,0,0,0,0,0,461000,0,0,0,502000,41000,461000,461000
061589,世紀鋼富邦9B購01,0,0,0,0,0,0,0,0,0,460000,0,0,0,475000,15000,460000,460000
07501P,華新科元大9A售07,0,0,0,0,0,0,0,0,0,459000,0,0,0,459000,0,459000,459000
052702,群創國票97購03  ,0,0,0,0,0,0,0,0,0,459000,0,0,0,459000,0,459000,459000
060395,儒鴻國票9A購01  ,0,0,0,0,0,0,0,0,0,459000,0,0,0,459000,0,459000,459000
05361P,聯發科富邦97售01,0,0,0,0,0,0,0,0,0,457000,0,0,0,482000,25000,457000,457000
057181,亞光元大98購02  ,0,0,0,0,0,0,0,0,0,456000,0,0,0,523000,67000,456000,456000
2006,東和鋼鐵        ,472000,266000,206000,0,0,0,0,1000,-1000,248000,248000,0,248000,0,0,0,453000
061024,南電國泰9B購01  ,0,0,0,0,0,0,0,0,0,453000,0,0,0,785000,332000,453000,453000
062989,鴻海群益9B購07  ,0,0,0,0,0,0,0,0,0,453000,0,0,0,455000,2000,453000,453000
07456P,華新科元大9A售06,0,0,0,0,0,0,0,0,0,451000,0,0,0,451000,0,451000,451000
057696,聯電群益9A購01  ,0,0,0,0,0,0,0,0,0,451000,0,0,0,488000,37000,451000,451000
058546,玉晶光富邦9B購01,0,0,0,0,0,0,0,0,0,450000,0,0,0,958000,508000,450000,450000
057347,國巨統一9A購03  ,0,0,0,0,0,0,0,0,0,448000,0,0,0,671000,223000,448000,448000
00675L,富邦臺灣加權正2 ,44000,55000,-11000,0,0,0,0,0,0,458000,0,0,0,490000,32000,458000,447000
062382,燿華國泰9C購01  ,0,0,0,0,0,0,0,0,0,446000,0,0,0,466000,20000,446000,446000
063127,TPK元大9B購02   ,0,0,0,0,0,0,0,0,0,444000,0,0,0,586000,142000,444000,444000
061723,嘉聯益永豐9A購03,0,0,0,0,0,0,0,0,0,444000,0,0,0,484000,40000,444000,444000
07771P,義隆國票9A售01  ,0,0,0,0,0,0,0,0,0,443000,0,0,0,556000,113000,443000,443000
4746,台耀            ,718873,255000,463873,0,0,0,0,0,0,-23000,3000,26000,-23000,0,0,0,440873
07948P,大成鋼凱基9B售01,0,0,0,0,0,0,0,0,0,440000,0,0,0,460000,20000,440000,440000
060522,鴻海中信9A購03  ,0,0,0,0,0,0,0,0,0,440000,0,0,0,440000,0,440000,440000
057102,亞光中信9A購01  ,0,0,0,0,0,0,0,0,0,437000,0,0,0,462000,25000,437000,437000
060890,大立光統一01購01,0,0,0,0,0,0,0,0,0,437000,0,0,0,439000,2000,437000,437000
063265,瑞祺永豐9B購01  ,0,0,0,0,0,0,0,0,0,436000,0,0,0,468000,32000,436000,436000
056852,矽格元富98購01  ,0,0,0,0,0,0,0,0,0,435000,0,0,0,692000,257000,435000,435000
056404,嘉聯益群益9A購01,0,0,0,0,0,0,0,0,0,434000,0,0,0,914000,480000,434000,434000
07011P,宏達電凱基99售02,0,0,0,0,0,0,0,0,0,433000,0,0,0,433000,0,433000,433000
07421P,國泰金元大99售01,0,0,0,0,0,0,0,0,0,433000,0,0,0,433000,0,433000,433000
062035,瑞祺群益9B購01  ,0,0,0,0,0,0,0,0,0,432000,0,0,0,934000,502000,432000,432000
055908,GIS日盛97購01   ,0,0,0,0,0,0,0,0,0,431000,0,0,0,431000,0,431000,431000
062858,微星國票9B購01  ,0,0,0,0,0,0,0,0,0,431000,0,0,0,455000,24000,431000,431000
1720,生達            ,476000,50000,426000,0,0,0,0,0,0,2000,2000,0,2000,0,0,0,428000
2605,新興            ,832000,413000,419000,0,0,0,0,0,0,8000,8000,0,8000,0,0,0,427000
056496,康控國泰99購01  ,0,0,0,0,0,0,0,0,0,426000,0,0,0,426000,0,426000,426000
051847,香港反中信99購01,0,0,0,0,0,0,0,0,0,426000,0,0,0,768000,342000,426000,426000
058688,矽創凱基9A購01  ,0,0,0,0,0,0,0,0,0,425000,0,0,0,425000,0,425000,425000
2402,毅嘉            ,444000,25000,419000,0,0,0,0,0,0,4000,4000,0,4000,0,0,0,423000
056603,嘉聯益國泰9A購01,0,0,0,0,0,0,0,0,0,423000,0,0,0,775000,352000,423000,423000
6153,嘉聯益          ,2347000,1951000,396000,0,0,0,0,0,0,26000,507000,326000,181000,458000,613000,-155000,422000
3062,建漢            ,549000,206000,343000,0,0,0,0,0,0,75000,75000,0,75000,0,0,0,418000
053353,玉晶光兆豐97購03,0,0,0,0,0,0,0,0,0,417000,0,0,0,459000,42000,417000,417000
1467,南緯            ,632000,220000,412000,0,0,0,0,0,0,4000,4000,0,4000,0,0,0,416000
053331,玉晶光永豐97購02,0,0,0,0,0,0,0,0,0,416000,0,0,0,426000,10000,416000,416000
060632,可成富邦9B購01  ,0,0,0,0,0,0,0,0,0,415000,0,0,0,469000,54000,415000,415000
057517,矽創元富98購02  ,0,0,0,0,0,0,0,0,0,414000,0,0,0,444000,30000,414000,414000
061521,亞光兆豐9A購02  ,0,0,0,0,0,0,0,0,0,413000,0,0,0,503000,90000,413000,413000
5305,敦南            ,520000,114000,406000,0,0,0,0,0,0,2000,2000,0,2000,0,0,0,408000
051530,鴻海國票97購01  ,0,0,0,0,0,0,0,0,0,406000,0,0,0,406000,0,406000,406000
062539,可成國泰01購01  ,0,0,0,0,0,0,0,0,0,406000,0,0,0,547000,141000,406000,406000
058535,玉晶光統一9A購06,0,0,0,0,0,0,0,0,0,405000,0,0,0,509000,104000,405000,405000
062012,燿華富邦9C購01  ,0,0,0,0,0,0,0,0,0,404000,0,0,0,538000,134000,404000,404000
060637,玉晶光永豐9A購03,0,0,0,0,0,0,0,0,0,404000,0,0,0,529000,125000,404000,404000
061363,儒鴻國票9B購01  ,0,0,0,0,0,0,0,0,0,403000,0,0,0,795000,392000,403000,403000
062031,臻鼎群益9B購01  ,0,0,0,0,0,0,0,0,0,403000,0,0,0,484000,81000,403000,403000
063165,泰碩永豐9B購02  ,0,0,0,0,0,0,0,0,0,403000,0,0,0,418000,15000,403000,403000
5522,遠雄            ,592000,514000,78000,0,0,0,0,0,0,324000,324000,0,324000,0,0,0,402000
1464,得力            ,382000,12000,370000,0,0,0,0,0,0,31000,5000,0,5000,28000,2000,26000,401000
1217,愛之味          ,585000,185000,400000,0,0,0,0,0,0,0,0,0,0,0,0,0,400000
044457,滬深2X國票97購01,0,0,0,0,0,0,0,0,0,400000,0,0,0,400000,0,400000,400000
055396,瑞儀統一97購01  ,0,0,0,0,0,0,0,0,0,400000,0,0,0,400000,0,400000,400000
055747,康舒元富97購01  ,0,0,0,0,0,0,0,0,0,400000,0,0,0,400000,0,400000,400000
060475,瑞祺元大9A購01  ,0,0,0,0,0,0,0,0,0,399000,0,0,0,467000,68000,399000,399000
1904,正隆            ,1058000,887000,171000,0,0,0,60000,200000,-140000,365000,181000,0,181000,184000,0,184000,396000
055160,玉晶光元大99購03,0,0,0,0,0,0,0,0,0,396000,0,0,0,396000,0,396000,396000
061944,聯電群益9B購01  ,0,0,0,0,0,0,0,0,0,395000,0,0,0,465000,70000,395000,395000
6452,康友-KY         ,329000,55000,274000,0,0,0,0,0,0,120000,43000,0,43000,79000,2000,77000,394000
6504,南六            ,572000,440045,131955,0,0,0,39000,0,39000,223000,253000,6000,247000,64000,88000,-24000,393955
2207,和泰車          ,562363,233000,329363,0,0,0,0,0,0,63000,65000,2000,63000,0,0,0,392363
061820,康控群益9B購02  ,0,0,0,0,0,0,0,0,0,392000,0,0,0,689000,297000,392000,392000
063151,奇鋐元富9B購01  ,0,0,0,0,0,0,0,0,0,392000,0,0,0,505000,113000,392000,392000
00766L,台新MSCI中國正2 ,0,0,0,0,0,0,0,0,0,390000,0,0,0,544000,154000,390000,390000
057322,旺宏群益98購04  ,0,0,0,0,0,0,0,0,0,389000,0,0,0,389000,0,389000,389000
055256,日電貿統一99購01,0,0,0,0,0,0,0,0,0,388000,0,0,0,388000,0,388000,388000
063188,TPK凱基9B購01   ,0,0,0,0,0,0,0,0,0,388000,0,0,0,599000,211000,388000,388000
00636,國泰中國A50     ,255000,253000,2000,0,0,0,0,0,0,385000,60000,50000,10000,443000,68000,375000,387000
058210,臺股指凱基9C購04,0,0,0,0,0,0,0,0,0,387000,0,0,0,639000,252000,387000,387000
063126,TPK元大9B購01   ,0,0,0,0,0,0,0,0,0,387000,0,0,0,443000,56000,387000,387000
2608,嘉里大榮        ,357000,54000,303000,0,0,0,0,0,0,83000,83000,0,83000,0,0,0,386000
057705,臺股指群益98購05,0,0,0,0,0,0,0,0,0,384000,0,0,0,452000,68000,384000,384000
07194P,聯發科元大99售25,0,0,0,0,0,0,0,0,0,383000,0,0,0,405000,22000,383000,383000
6288,聯嘉            ,564000,184000,380000,0,0,0,0,0,0,3000,5000,2000,3000,0,0,0,383000
4960,誠美材          ,712000,329000,383000,0,0,0,0,0,0,0,1000,1000,0,0,0,0,383000
2392,正崴            ,409309,333000,76309,0,0,0,0,0,0,305000,159000,4000,155000,160000,10000,150000,381309
1730,花仙子          ,463000,84000,379000,0,0,0,0,0,0,0,0,0,0,0,0,0,379000
063666,京元電統一9C購01,0,0,0,0,0,0,0,0,0,379000,0,0,0,389000,10000,379000,379000
056954,聯詠富邦9A購01  ,0,0,0,0,0,0,0,0,0,379000,0,0,0,518000,139000,379000,379000
060956,超眾群益9A購01  ,0,0,0,0,0,0,0,0,0,378000,0,0,0,509000,131000,378000,378000
062363,燿華元大9B購03  ,0,0,0,0,0,0,0,0,0,378000,0,0,0,435000,57000,378000,378000
062292,旭富永豐9B購01  ,0,0,0,0,0,0,0,0,0,378000,0,0,0,644000,266000,378000,378000
4414,如興            ,476000,112000,364000,0,0,0,0,0,0,13000,13000,0,13000,0,0,0,377000
063175,燿華兆豐9C購01  ,0,0,0,0,0,0,0,0,0,375000,0,0,0,375000,0,375000,375000
062297,億豐永豐9B購01  ,0,0,0,0,0,0,0,0,0,374000,0,0,0,442000,68000,374000,374000
063305,亞光凱基9B購01  ,0,0,0,0,0,0,0,0,0,373000,0,0,0,393000,20000,373000,373000
8996,高力            ,606000,264000,342000,0,0,0,0,0,0,31000,31000,0,31000,0,0,0,373000
2362,藍天            ,300000,39000,261000,0,0,0,0,0,0,111000,112000,1000,111000,0,0,0,372000
060290,興富發元大9C購01,0,0,0,0,0,0,0,0,0,372000,0,0,0,695000,323000,372000,372000
055450,台積電元富97購01,0,0,0,0,0,0,0,0,0,370000,0,0,0,370000,0,370000,370000
05947P,大成鋼元大96售03,0,0,0,0,0,0,0,0,0,370000,0,0,0,375000,5000,370000,370000
055287,日電貿元大97購01,0,0,0,0,0,0,0,0,0,368000,0,0,0,368000,0,368000,368000
056574,亞光元大99購03  ,0,0,0,0,0,0,0,0,0,366000,0,0,0,515000,149000,366000,366000
061517,瑞祺永豐9A購03  ,0,0,0,0,0,0,0,0,0,366000,0,0,0,377000,11000,366000,366000
07983P,茂林群益9B售03  ,0,0,0,0,0,0,0,0,0,365000,0,0,0,480000,115000,365000,365000
055891,鴻海統一9A購01  ,0,0,0,0,0,0,0,0,0,365000,0,0,0,610000,245000,365000,365000
059778,上証2X元大9C購03,0,0,0,0,0,0,0,0,0,365000,0,0,0,370000,5000,365000,365000
020012,富邦行動通訊N   ,0,0,0,0,0,0,0,0,0,364000,0,0,0,367000,3000,364000,364000
9933,中鼎            ,601000,418000,183000,0,0,0,0,0,0,181000,181000,0,181000,0,0,0,364000
6230,超眾            ,413000,129000,284000,0,0,0,6000,0,6000,74000,13000,3000,10000,135000,71000,64000,364000
062184,奇鋐元大9B購02  ,0,0,0,0,0,0,0,0,0,363000,0,0,0,421000,58000,363000,363000
6412,群電            ,477000,143000,334000,0,0,0,0,0,0,29000,15000,0,15000,15000,1000,14000,363000
060466,玉山金元大9A購01,0,0,0,0,0,0,0,0,0,362000,0,0,0,388000,26000,362000,362000
062808,祥碩統一9C購01  ,0,0,0,0,0,0,0,0,0,362000,0,0,0,916000,554000,362000,362000
06734P,智邦凱基98售05  ,0,0,0,0,0,0,0,0,0,361000,0,0,0,362000,1000,361000,361000
07746P,華新科凱基9A售11,0,0,0,0,0,0,0,0,0,360000,0,0,0,360000,0,360000,360000
2349,錸德            ,1270000,710000,560000,0,0,0,0,200000,-200000,0,0,0,0,0,0,0,360000
059516,TPK永豐99購01   ,0,0,0,0,0,0,0,0,0,360000,0,0,0,368000,8000,360000,360000
055159,玉晶光元大98購05,0,0,0,0,0,0,0,0,0,360000,0,0,0,360000,0,360000,360000
060380,T50反1凱基9A購08,0,0,0,0,0,0,0,0,0,359000,0,0,0,499000,140000,359000,359000
1102,亞泥            ,5571519,5375940,195579,0,0,0,80000,7000,73000,90000,495000,70000,425000,95000,430000,-335000,358579
054894,GIS統一97購01   ,0,0,0,0,0,0,0,0,0,358000,0,0,0,786000,428000,358000,358000
057206,立積元富98購01  ,0,0,0,0,0,0,0,0,0,358000,0,0,0,554000,196000,358000,358000
050227,大立光中信96購01,0,0,0,0,0,0,0,0,0,356000,0,0,0,356000,0,356000,356000
061694,玉山金群益9A購01,0,0,0,0,0,0,0,0,0,356000,0,0,0,569000,213000,356000,356000
3535,晶彩科          ,397000,44000,353000,0,0,0,0,0,0,3000,3000,0,3000,0,0,0,356000
053452,臺股指凱基97購01,0,0,0,0,0,0,0,0,0,355000,0,0,0,355000,0,355000,355000
3041,揚智            ,1097000,745000,352000,0,0,0,0,0,0,3000,38000,35000,3000,0,0,0,355000
1701,中化            ,453000,101000,352000,0,0,0,0,0,0,2000,3000,1000,2000,0,0,0,354000
059688,燿華永豐99購01  ,0,0,0,0,0,0,0,0,0,354000,0,0,0,359000,5000,354000,354000
060238,強茂元大9C購01  ,0,0,0,0,0,0,0,0,0,354000,0,0,0,615000,261000,354000,354000
2206,三陽工業        ,414000,68000,346000,0,0,0,0,0,0,7000,15000,8000,7000,0,0,0,353000
058523,聯茂元大99購08  ,0,0,0,0,0,0,0,0,0,353000,0,0,0,994000,641000,353000,353000
2609,陽明            ,493000,142000,351000,0,0,0,0,0,0,0,0,0,0,0,0,0,351000
07104P,聯發科元富99售04,0,0,0,0,0,0,0,0,0,349000,0,0,0,358000,9000,349000,349000
08089P,嘉澤凱基9B售03  ,0,0,0,0,0,0,0,0,0,348000,0,0,0,453000,105000,348000,348000
051003,中環中信97購01  ,0,0,0,0,0,0,0,0,0,348000,0,0,0,348000,0,348000,348000
062633,亞光國票9B購01  ,0,0,0,0,0,0,0,0,0,348000,0,0,0,545000,197000,348000,348000
00655L,國泰中國A50正2  ,194000,276000,-82000,0,0,0,0,0,0,429001,0,0,0,2043001,1614000,429001,347001
063290,GIS元大9B購02   ,0,0,0,0,0,0,0,0,0,347000,0,0,0,378000,31000,347000,347000
056376,玉晶光統一98購01,0,0,0,0,0,0,0,0,0,347000,0,0,0,587000,240000,347000,347000
058322,玉晶光永豐99購02,0,0,0,0,0,0,0,0,0,346000,0,0,0,358000,12000,346000,346000
060639,玉晶光永豐9A購05,0,0,0,0,0,0,0,0,0,346000,0,0,0,348000,2000,346000,346000
052988,智易元大96購02  ,0,0,0,0,0,0,0,0,0,343000,0,0,0,343000,0,343000,343000
052981,鴻海元大97購05  ,0,0,0,0,0,0,0,0,0,343000,0,0,0,343000,0,343000,343000
06516P,國巨凱基98售08  ,0,0,0,0,0,0,0,0,0,340000,0,0,0,400000,60000,340000,340000
059500,鴻海元富99購11  ,0,0,0,0,0,0,0,0,0,340000,0,0,0,340000,0,340000,340000
060025,台積電富邦9C購06,0,0,0,0,0,0,0,0,0,340000,0,0,0,352000,12000,340000,340000
07767P,華新科群益9A售07,0,0,0,0,0,0,0,0,0,339000,0,0,0,339000,0,339000,339000
055214,聯電凱基97購02  ,0,0,0,0,0,0,0,0,0,339000,0,0,0,529000,190000,339000,339000
057624,新日興國泰99購01,0,0,0,0,0,0,0,0,0,339000,0,0,0,379000,40000,339000,339000
062057,華邦電統一01購01,0,0,0,0,0,0,0,0,0,339000,0,0,0,749000,410000,339000,339000
063341,燿華統一9C購01  ,0,0,0,0,0,0,0,0,0,338000,0,0,0,393000,55000,338000,338000
060715,日電貿永豐9A購01,0,0,0,0,0,0,0,0,0,338000,0,0,0,410000,72000,338000,338000
058379,臺股指凱基99購14,0,0,0,0,0,0,0,0,0,337000,0,0,0,1032000,695000,337000,337000
061550,聯鈞群益9A購03  ,0,0,0,0,0,0,0,0,0,337000,0,0,0,472000,135000,337000,337000
07683P,宏達電凱基9A售03,0,0,0,0,0,0,0,0,0,335000,0,0,0,335000,0,335000,335000
061170,南茂兆豐9B購01  ,0,0,0,0,0,0,0,0,0,334000,0,0,0,473000,139000,334000,334000
063690,健鼎永豐9B購01  ,0,0,0,0,0,0,0,0,0,332000,0,0,0,813000,481000,332000,332000
059424,SGBR2X元大9A購01,0,0,0,0,0,0,0,0,0,332000,0,0,0,379000,47000,332000,332000
063579,GIS元大9C購01   ,0,0,0,0,0,0,0,0,0,331000,0,0,0,347000,16000,331000,331000
08072P,祥碩永豐9B售03  ,0,0,0,0,0,0,0,0,0,331000,0,0,0,354000,23000,331000,331000
07633P,台灣50元大9A售18,0,0,0,0,0,0,0,0,0,329000,0,0,0,339000,10000,329000,329000
063118,中鋼元大9C購01  ,0,0,0,0,0,0,0,0,0,329000,0,0,0,481000,152000,329000,329000
07950P,智邦元大9B售04  ,0,0,0,0,0,0,0,0,0,327000,0,0,0,327000,0,327000,327000
059661,大立光元大99購22,0,0,0,0,0,0,0,0,0,326000,0,0,0,326000,0,326000,326000
058878,旭富國泰9B購01  ,0,0,0,0,0,0,0,0,0,325000,0,0,0,459000,134000,325000,325000
062805,台勝科統一9C購01,0,0,0,0,0,0,0,0,0,324000,0,0,0,451000,127000,324000,324000
063738,奇鋐元大9B購03  ,0,0,0,0,0,0,0,0,0,323000,0,0,0,334000,11000,323000,323000
058730,玉晶光永豐9A購01,0,0,0,0,0,0,0,0,0,323000,0,0,0,386000,63000,323000,323000
056395,玉晶光永豐9B購01,0,0,0,0,0,0,0,0,0,322000,0,0,0,427000,105000,322000,322000
057475,聯電元大9A購01  ,0,0,0,0,0,0,0,0,0,322000,0,0,0,667000,345000,322000,322000
3034,聯詠            ,1431471,1450218,-18747,0,0,0,44000,4000,40000,300000,344000,17000,327000,75000,102000,-27000,321253
056707,鴻海富邦99購03  ,0,0,0,0,0,0,0,0,0,320000,0,0,0,320000,0,320000,320000
061353,康控元大9A購01  ,0,0,0,0,0,0,0,0,0,320000,0,0,0,462000,142000,320000,320000
07836P,大成鋼元大9A售01,0,0,0,0,0,0,0,0,0,319000,0,0,0,383000,64000,319000,319000
062183,奇鋐元大9B購01  ,0,0,0,0,0,0,0,0,0,319000,0,0,0,442000,123000,319000,319000
07898P,國巨國泰9C售02  ,0,0,0,0,0,0,0,0,0,318000,0,0,0,404000,86000,318000,318000
061267,玉山金凱基9B購01,0,0,0,0,0,0,0,0,0,318000,0,0,0,328000,10000,318000,318000
2228,劍麟            ,274000,236000,38000,0,0,0,221000,0,221000,58000,7000,0,7000,51000,0,51000,317000
061661,京鼎永豐9A購02  ,0,0,0,0,0,0,0,0,0,317000,0,0,0,332000,15000,317000,317000
059125,台積電第一03購02,0,0,0,0,0,0,0,0,0,316000,0,0,0,327000,11000,316000,316000
057981,臻鼎永豐98購01  ,0,0,0,0,0,0,0,0,0,315000,0,0,0,331000,16000,315000,315000
061433,華通麥證9A購03  ,0,0,0,313000,0,313000,0,0,0,313000,0,0,0,313000,0,313000,313000
06439P,上銀凱基98售02  ,0,0,0,0,0,0,0,0,0,311000,0,0,0,311000,0,311000,311000
059656,T50反1元大99購11,0,0,0,0,0,0,0,0,0,311000,0,0,0,355000,44000,311000,311000
057646,玉山金元大98購01,0,0,0,0,0,0,0,0,0,311000,0,0,0,333000,22000,311000,311000
062602,華通麥證9C購01  ,0,0,0,311000,0,311000,0,0,0,311000,0,0,0,311000,0,311000,311000
3008,大立光          ,490114,282205,207909,0,0,0,88000,0,88000,14000,28000,15000,13000,5000,4000,1000,309909
058480,新日興凱基9A購01,0,0,0,0,0,0,0,0,0,309000,0,0,0,432000,123000,309000,309000
06012P,世芯國票96售01  ,0,0,0,0,0,0,0,0,0,308000,0,0,0,308000,0,308000,308000
060720,嘉聯益永豐9A購02,0,0,0,0,0,0,0,0,0,307000,0,0,0,606000,299000,307000,307000
3703,欣陸            ,417000,107000,310000,0,0,0,0,0,0,-4000,1000,5000,-4000,0,0,0,306000
061005,可成兆豐9A購01  ,0,0,0,0,0,0,0,0,0,305000,0,0,0,321000,16000,305000,305000
051055,友達群益98購01  ,0,0,0,0,0,0,0,0,0,304000,0,0,0,369000,65000,304000,304000
058568,宏達電凱基9A購02,0,0,0,0,0,0,0,0,0,304000,0,0,0,323000,19000,304000,304000
046949,群創元大99購01  ,0,0,0,0,0,0,0,0,0,303000,0,0,0,304000,1000,303000,303000
08160P,茂林元富9B售03  ,0,0,0,0,0,0,0,0,0,301000,0,0,0,479000,178000,301000,301000
052945,嘉晶國票97購01  ,0,0,0,0,0,0,0,0,0,301000,0,0,0,301000,0,301000,301000
061011,華通麥證9A購02  ,0,0,0,301000,0,301000,0,0,0,301000,0,0,0,301000,0,301000,301000
063571,TPK元大9B購03   ,0,0,0,0,0,0,0,0,0,300000,0,0,0,625000,325000,300000,300000
06332P,世紀鋼群益98售01,0,0,0,0,0,0,0,0,0,300000,0,0,0,300000,0,300000,300000
063392,聯電群益9B購02  ,0,0,0,0,0,0,0,0,0,300000,0,0,0,300000,0,300000,300000
053476,冠德元大96購03  ,0,0,0,0,0,0,0,0,0,300000,0,0,0,300000,0,300000,300000
049820,世紀鋼元大96購03,0,0,0,0,0,0,0,0,0,300000,0,0,0,300000,0,300000,300000
061631,SP黃豆元大9A購05,0,0,0,0,0,0,0,0,0,300000,0,0,0,300000,0,300000,300000
063035,燿華凱基9B購02  ,0,0,0,0,0,0,0,0,0,300000,0,0,0,402000,102000,300000,300000
03422B,臺股指凱基96熊28,0,0,0,0,0,0,0,0,0,299000,0,0,0,299000,0,299000,299000
059654,T50反1元大99購09,0,0,0,0,0,0,0,0,0,299000,0,0,0,299000,0,299000,299000
062547,玉晶光永豐9B購05,0,0,0,0,0,0,0,0,0,299000,0,0,0,370000,71000,299000,299000
3257,虹冠電          ,248000,50000,198000,0,0,0,98000,0,98000,1000,1000,0,1000,0,0,0,297000
062699,台積電元大01購02,0,0,0,0,0,0,0,0,0,296000,0,0,0,301000,5000,296000,296000
4564,元翎            ,315000,22000,293000,0,0,0,0,0,0,3000,3000,0,3000,0,0,0,296000
063363,鴻海富邦9B購02  ,0,0,0,0,0,0,0,0,0,295000,0,0,0,471000,176000,295000,295000
08103P,台灣50元大9B售23,0,0,0,0,0,0,0,0,0,295000,0,0,0,295000,0,295000,295000
1522,堤維西          ,327000,38000,289000,0,0,0,0,0,0,6000,6000,0,6000,0,0,0,295000
057998,玉晶光麥證9A購01,0,0,0,327000,33000,294000,0,0,0,294000,0,0,0,327000,33000,294000,294000
2365,昆盈            ,304000,16000,288000,0,0,0,0,0,0,5000,5000,0,5000,0,0,0,293000
053646,臺股指國票96購09,0,0,0,0,0,0,0,0,0,293000,0,0,0,293000,0,293000,293000
061428,南六元大9A購01  ,0,0,0,0,0,0,0,0,0,293000,0,0,0,352000,59000,293000,293000
062578,超眾群益9B購01  ,0,0,0,0,0,0,0,0,0,292000,0,0,0,456000,164000,292000,292000
07248P,可成凱基99售06  ,0,0,0,0,0,0,0,0,0,290000,0,0,0,290000,0,290000,290000
06899P,嘉澤群益98售01  ,0,0,0,0,0,0,0,0,0,290000,0,0,0,330000,40000,290000,290000
052653,臺股指永豐97購01,0,0,0,0,0,0,0,0,0,290000,0,0,0,290000,0,290000,290000
051485,玉晶光凱基97購02,0,0,0,0,0,0,0,0,0,290000,0,0,0,314000,24000,290000,290000
00672L,元大S&P原油正2  ,0,0,0,0,0,0,0,0,0,290000,0,0,0,785000,495000,290000,290000
2352,佳世達          ,1181000,1622000,-441000,0,0,0,0,0,0,730000,408000,0,408000,322000,0,322000,289000
056268,新日興統一97購01,0,0,0,0,0,0,0,0,0,289000,0,0,0,827000,538000,289000,289000
07669P,華新科元大9A售14,0,0,0,0,0,0,0,0,0,288000,0,0,0,288000,0,288000,288000
059865,國巨凱基01購01  ,0,0,0,0,0,0,0,0,0,288000,0,0,0,609000,321000,288000,288000
061927,玉晶光凱基9C購01,0,0,0,0,0,0,0,0,0,287000,0,0,0,353000,66000,287000,287000
2375,凱美            ,460000,200000,260000,0,0,0,0,0,0,26000,2000,0,2000,25000,1000,24000,286000
063347,祥碩統一01購03  ,0,0,0,0,0,0,0,0,0,286000,0,0,0,286000,0,286000,286000
059535,玉山金凱基99購01,0,0,0,0,0,0,0,0,0,286000,0,0,0,338000,52000,286000,286000
058391,T50反1元大99購02,0,0,0,0,0,0,0,0,0,285000,0,0,0,285000,0,285000,285000
2836,高雄銀          ,296000,24000,272000,0,0,0,0,0,0,12000,12000,0,12000,0,0,0,284000
061662,瑞儀永豐9A購02  ,0,0,0,0,0,0,0,0,0,283000,0,0,0,286000,3000,283000,283000
061136,可成統一9A購01  ,0,0,0,0,0,0,0,0,0,283000,0,0,0,317000,34000,283000,283000
063152,健策元富9C購01  ,0,0,0,0,0,0,0,0,0,283000,0,0,0,288000,5000,283000,283000
061856,台郡國票9B購02  ,0,0,0,0,0,0,0,0,0,282000,0,0,0,366000,84000,282000,282000
057527,億光元大98購01  ,0,0,0,0,0,0,0,0,0,281000,0,0,0,492000,211000,281000,281000
060323,華通群益9C購01  ,0,0,0,0,0,0,0,0,0,281000,0,0,0,281000,0,281000,281000
6224,聚鼎            ,418000,177000,241000,0,0,0,0,0,0,40000,41000,1000,40000,0,0,0,281000
063773,可成富邦9C購01  ,0,0,0,0,0,0,0,0,0,280000,0,0,0,302000,22000,280000,280000
060512,祥碩元大9A購02  ,0,0,0,0,0,0,0,0,0,280000,0,0,0,300000,20000,280000,280000
06068P,玉晶光康和97售01,0,0,0,0,0,0,0,0,0,279000,0,0,0,499000,220000,279000,279000
00646,元大S&P500      ,5000,5000,0,0,0,0,0,0,0,278000,188000,0,188000,516000,426000,90000,278000
060629,鴻海富邦9B購01  ,0,0,0,0,0,0,0,0,0,278000,0,0,0,366000,88000,278000,278000
056083,億光統一97購03  ,0,0,0,0,0,0,0,0,0,277000,0,0,0,325000,48000,277000,277000
057195,南茂元大98購01  ,0,0,0,0,0,0,0,0,0,277000,0,0,0,505000,228000,277000,277000
063011,台積電元大9C購01,0,0,0,0,0,0,0,0,0,277000,0,0,0,306000,29000,277000,277000
062327,燿華統一9B購02  ,0,0,0,0,0,0,0,0,0,276000,0,0,0,276000,0,276000,276000
1227,佳格            ,821561,763300,58261,0,0,0,0,0,0,217000,217000,0,217000,0,0,0,275261
059040,訊芯群益99購03  ,0,0,0,0,0,0,0,0,0,272000,0,0,0,272000,0,272000,272000
052997,國巨康和96購01  ,0,0,0,0,0,0,0,0,0,272000,0,0,0,272000,0,272000,272000
056786,亞光群益98購03  ,0,0,0,0,0,0,0,0,0,272000,0,0,0,272000,0,272000,272000
061615,鴻海群益9A購06  ,0,0,0,0,0,0,0,0,0,272000,0,0,0,293000,21000,272000,272000
061483,TPK元大9A購01   ,0,0,0,0,0,0,0,0,0,271000,0,0,0,446000,175000,271000,271000
060633,玉晶光富邦02購01,0,0,0,0,0,0,0,0,0,271000,0,0,0,477000,206000,271000,271000
2102,泰豐            ,418000,154000,264000,0,0,0,0,0,0,6000,6000,0,6000,0,0,0,270000
2108,南帝            ,868000,773000,95000,0,0,0,100000,0,100000,75000,76000,1000,75000,0,0,0,270000
08154P,上銀元富9B售04  ,0,0,0,0,0,0,0,0,0,270000,0,0,0,441000,171000,270000,270000
056203,興富發永豐97購01,0,0,0,0,0,0,0,0,0,270000,0,0,0,273000,3000,270000,270000
054698,同欣電永豐97購01,0,0,0,0,0,0,0,0,0,270000,0,0,0,270000,0,270000,270000
054590,嘉聯益國泰98購01,0,0,0,0,0,0,0,0,0,270000,0,0,0,330000,60000,270000,270000
062197,聯發科中信01購03,0,0,0,0,0,0,0,0,0,270000,0,0,0,270000,0,270000,270000
06216P,上銀元富97售03  ,0,0,0,0,0,0,0,0,0,270000,0,0,0,270000,0,270000,270000
07660P,聯茂凱基9A售03  ,0,0,0,0,0,0,0,0,0,268000,0,0,0,288000,20000,268000,268000
059295,大立光元富99購05,0,0,0,0,0,0,0,0,0,268000,0,0,0,485000,217000,268000,268000
061900,志超永豐9B購01  ,0,0,0,0,0,0,0,0,0,268000,0,0,0,271000,3000,268000,268000
07899P,和大凱基9B售01  ,0,0,0,0,0,0,0,0,0,266000,0,0,0,286000,20000,266000,266000
052927,友達元大98購02  ,0,0,0,0,0,0,0,0,0,266000,0,0,0,271000,5000,266000,266000
07807P,聯茂永豐9A售02  ,0,0,0,0,0,0,0,0,0,265000,0,0,0,305000,40000,265000,265000
2390,云辰            ,382000,120000,262000,0,0,0,0,0,0,3000,4000,1000,3000,0,0,0,265000
063272,GIS兆豐9C購01   ,0,0,0,0,0,0,0,0,0,265000,0,0,0,317000,52000,265000,265000
06047P,聯發科富邦99售04,0,0,0,0,0,0,0,0,0,265000,0,0,0,265000,0,265000,265000
3605,宏致            ,376000,135000,241000,0,0,0,0,0,0,24000,24000,0,24000,0,0,0,265000
059128,友達中信99購02  ,0,0,0,0,0,0,0,0,0,264000,0,0,0,332000,68000,264000,264000
061242,玉晶光兆豐9B購02,0,0,0,0,0,0,0,0,0,264000,0,0,0,466000,202000,264000,264000
061210,玉山金元大9A購02,0,0,0,0,0,0,0,0,0,263000,0,0,0,421000,158000,263000,263000
061166,玉晶光兆豐9B購01,0,0,0,0,0,0,0,0,0,263000,0,0,0,288000,25000,263000,263000
062890,祥碩群益9B購04  ,0,0,0,0,0,0,0,0,0,263000,0,0,0,313000,50000,263000,263000
062994,祥碩群益9B購05  ,0,0,0,0,0,0,0,0,0,262000,0,0,0,262000,0,262000,262000
6112,聚碩            ,341000,81000,260000,0,0,0,0,0,0,2000,2000,0,2000,0,0,0,262000
063480,南六元大9C購01  ,0,0,0,0,0,0,0,0,0,261000,0,0,0,328000,67000,261000,261000
2456,奇力新          ,970000,760000,210000,0,0,0,30000,124000,-94000,144000,58000,5000,53000,93000,2000,91000,260000
07643P,禾伸堂凱基9A售02,0,0,0,0,0,0,0,0,0,260000,0,0,0,260000,0,260000,260000
4961,天鈺            ,330000,73000,257000,0,0,0,0,0,0,3000,3000,0,3000,0,0,0,260000
07614P,華新科群益9A售04,0,0,0,0,0,0,0,0,0,259000,0,0,0,264000,5000,259000,259000
051381,玉晶光群益98購01,0,0,0,0,0,0,0,0,0,259000,0,0,0,261000,2000,259000,259000
06246P,茂林元富97售03  ,0,0,0,0,0,0,0,0,0,259000,0,0,0,259000,0,259000,259000
061718,GIS凱基9B購01   ,0,0,0,0,0,0,0,0,0,258000,0,0,0,343000,85000,258000,258000
063356,台表科元富02購01,0,0,0,0,0,0,0,0,0,257000,0,0,0,506000,249000,257000,257000
00643,群益深証中小    ,361000,74000,287000,0,0,0,0,0,0,-30000,0,0,0,95000,125000,-30000,257000
060920,超眾富邦9B購01  ,0,0,0,0,0,0,0,0,0,257000,0,0,0,675000,418000,257000,257000
062203,燿華國票9C購01  ,0,0,0,0,0,0,0,0,0,257000,0,0,0,400000,143000,257000,257000
4927,泰鼎-KY         ,659000,458000,201000,0,0,0,0,0,0,56000,36000,13000,23000,44000,11000,33000,257000
3056,總太            ,563000,377000,186000,0,0,0,0,0,0,71000,72000,1000,71000,0,0,0,257000
07100P,華航元大99售01  ,0,0,0,0,0,0,0,0,0,256000,0,0,0,266000,10000,256000,256000
054791,泰碩群益99購02  ,0,0,0,0,0,0,0,0,0,256000,0,0,0,261000,5000,256000,256000
060732,玉晶光群益9C購02,0,0,0,0,0,0,0,0,0,256000,0,0,0,434000,178000,256000,256000
060565,大立光富邦01購01,0,0,0,0,0,0,0,0,0,255000,0,0,0,255000,0,255000,255000
2360,致茂            ,604000,195000,409000,0,0,0,0,260000,-260000,105000,98000,0,98000,7000,0,7000,254000
1762,中化生          ,1472000,1216000,256000,0,0,0,0,0,0,-2000,1000,3000,-2000,0,0,0,254000
062601,富邦金台新9B購01,0,0,0,0,0,0,0,0,0,254000,0,0,0,274000,20000,254000,254000
3705,永信            ,291000,40000,251000,0,0,0,0,0,0,3000,3000,0,3000,0,0,0,254000
8028,昇陽半導體      ,381000,127000,254000,0,0,0,0,0,0,0,0,0,0,0,0,0,254000
020015,統一MSCI美低波N ,0,0,0,0,0,0,0,0,0,253000,0,0,0,280000,27000,253000,253000
2328,廣宇            ,323000,172000,151000,0,0,0,0,0,0,101000,101000,0,101000,0,0,0,252000
2908,特力            ,324000,79000,245000,0,0,0,0,0,0,6000,6000,0,6000,0,0,0,251000
2472,立隆電          ,365000,133000,232000,0,0,0,0,0,0,18000,26000,8000,18000,0,0,0,250000
051152,鴻海國泰97購01  ,0,0,0,0,0,0,0,0,0,250000,0,0,0,250000,0,250000,250000
05375P,健策國票96售02  ,0,0,0,0,0,0,0,0,0,250000,0,0,0,449000,199000,250000,250000
060195,旭富元富9A購02  ,0,0,0,0,0,0,0,0,0,250000,0,0,0,438000,188000,250000,250000
056870,全新日盛9A購01  ,0,0,0,0,0,0,0,0,0,250000,0,0,0,250000,0,250000,250000
07577P,華新科元大9A售09,0,0,0,0,0,0,0,0,0,249000,0,0,0,249000,0,249000,249000
060031,旭富永豐99購02  ,0,0,0,0,0,0,0,0,0,249000,0,0,0,324000,75000,249000,249000
063048,聯詠兆豐9B購01  ,0,0,0,0,0,0,0,0,0,249000,0,0,0,313000,64000,249000,249000
062830,玉晶光群益01購05,0,0,0,0,0,0,0,0,0,247000,0,0,0,267000,20000,247000,247000
062414,臻鼎中信01購01  ,0,0,0,0,0,0,0,0,0,247000,0,0,0,290000,43000,247000,247000
1711,永光            ,512000,273000,239000,0,0,0,0,0,0,7000,7000,0,7000,0,0,0,246000
053294,聯發科中信9C購01,0,0,0,0,0,0,0,0,0,246000,0,0,0,260000,14000,246000,246000
057582,亞光中信9A購02  ,0,0,0,0,0,0,0,0,0,246000,0,0,0,246000,0,246000,246000
054229,超眾元富96購05  ,0,0,0,0,0,0,0,0,0,245000,0,0,0,359000,114000,245000,245000
056699,光罩國泰99購01  ,0,0,0,0,0,0,0,0,0,245000,0,0,0,365000,120000,245000,245000
063115,台積電麥證9B購02,0,0,0,320000,75000,245000,0,0,0,245000,0,0,0,320000,75000,245000,245000
061663,南六永豐9A購05  ,0,0,0,0,0,0,0,0,0,244000,0,0,0,360000,116000,244000,244000
9940,信義            ,106000,27000,79000,0,0,0,0,0,0,165000,165000,0,165000,0,0,0,244000
063367,GIS富邦9B購01   ,0,0,0,0,0,0,0,0,0,243000,0,0,0,253000,10000,243000,243000
046628,大立光統一98購01,0,0,0,0,0,0,0,0,0,243000,0,0,0,512000,269000,243000,243000
054768,泰碩國票99購02  ,0,0,0,0,0,0,0,0,0,243000,0,0,0,367000,124000,243000,243000
061841,晶技凱基9C購01  ,0,0,0,0,0,0,0,0,0,243000,0,0,0,253000,10000,243000,243000
07928P,國巨統一9B售09  ,0,0,0,0,0,0,0,0,0,241000,0,0,0,241000,0,241000,241000
048847,A50群益98購01   ,0,0,0,0,0,0,0,0,0,241000,0,0,0,241000,0,241000,241000
058369,亞光凱基99購02  ,0,0,0,0,0,0,0,0,0,241000,0,0,0,241000,0,241000,241000
2903,遠百            ,357000,358000,-1000,0,0,0,0,0,0,241000,268000,27000,241000,0,0,0,240000
060746,玉晶光國票9B購02,0,0,0,0,0,0,0,0,0,240000,0,0,0,495000,255000,240000,240000
063348,祥碩統一01購04  ,0,0,0,0,0,0,0,0,0,239000,0,0,0,240000,1000,239000,239000
060712,建準永豐9A購01  ,0,0,0,0,0,0,0,0,0,238000,0,0,0,247000,9000,238000,238000
063343,美律統一9C購01  ,0,0,0,0,0,0,0,0,0,237000,0,0,0,292000,55000,237000,237000
047004,台積電統一99購01,0,0,0,0,0,0,0,0,0,237000,0,0,0,249000,12000,237000,237000
062708,立積元大9B購01  ,0,0,0,0,0,0,0,0,0,237000,0,0,0,281000,44000,237000,237000
07843P,緯穎元大9A售05  ,0,0,0,0,0,0,0,0,0,236000,0,0,0,338000,102000,236000,236000
057324,億光群益98購01  ,0,0,0,0,0,0,0,0,0,236000,0,0,0,730000,494000,236000,236000
061303,玉晶光永豐9B購03,0,0,0,0,0,0,0,0,0,236000,0,0,0,316000,80000,236000,236000
07839P,嘉澤元大9A售04  ,0,0,0,0,0,0,0,0,0,235000,0,0,0,235000,0,235000,235000
061724,訊芯永豐9A購01  ,0,0,0,0,0,0,0,0,0,235000,0,0,0,235000,0,235000,235000
056386,TPK國泰99購01   ,0,0,0,0,0,0,0,0,0,234000,0,0,0,334000,100000,234000,234000
08171P,嘉澤國票9C售01  ,0,0,0,0,0,0,0,0,0,233000,0,0,0,235000,2000,233000,233000
063532,GIS凱基9B購03   ,0,0,0,0,0,0,0,0,0,233000,0,0,0,267000,34000,233000,233000
060433,億豐永豐9A購01  ,0,0,0,0,0,0,0,0,0,233000,0,0,0,246000,13000,233000,233000
058479,亞光凱基9A購01  ,0,0,0,0,0,0,0,0,0,233000,0,0,0,233000,0,233000,233000
2707,晶華            ,180000,88000,92000,0,0,0,50000,0,50000,90000,90000,0,90000,0,0,0,232000
056028,GIS群益97購02   ,0,0,0,0,0,0,0,0,0,232000,0,0,0,237000,5000,232000,232000
061157,聯鈞群益9A購02  ,0,0,0,0,0,0,0,0,0,232000,0,0,0,232000,0,232000,232000
061069,嘉聯益凱基9A購01,0,0,0,0,0,0,0,0,0,232000,0,0,0,455000,223000,232000,232000
060909,金像電元大9B購01,0,0,0,0,0,0,0,0,0,232000,0,0,0,232000,0,232000,232000
062017,京鼎永豐9B購01  ,0,0,0,0,0,0,0,0,0,232000,0,0,0,252000,20000,232000,232000
08184P,可成永豐9B售03  ,0,0,0,0,0,0,0,0,0,231000,0,0,0,269000,38000,231000,231000
06962P,華新科永豐99售01,0,0,0,0,0,0,0,0,0,231000,0,0,0,231000,0,231000,231000
063057,祥碩統一03購01  ,0,0,0,0,0,0,0,0,0,231000,0,0,0,241000,10000,231000,231000
061007,聯詠兆豐9A購01  ,0,0,0,0,0,0,0,0,0,231000,0,0,0,271000,40000,231000,231000
061590,金寶永豐9A購01  ,0,0,0,0,0,0,0,0,0,231000,0,0,0,231000,0,231000,231000
8464,億豐            ,327209,90751,236458,0,0,0,0,5000,-5000,-1000,4000,0,4000,10000,15000,-5000,230458
06935P,神達元大98售02  ,0,0,0,0,0,0,0,0,0,230000,0,0,0,280000,50000,230000,230000
08169P,台光電群益9B售04,0,0,0,0,0,0,0,0,0,230000,0,0,0,342000,112000,230000,230000
07533P,臺股指中信9C售04,0,0,0,0,0,0,0,0,0,230000,0,0,0,230000,0,230000,230000
06151P,華新科元大97售07,0,0,0,0,0,0,0,0,0,230000,0,0,0,240000,10000,230000,230000
056602,嘉澤國泰99購01  ,0,0,0,0,0,0,0,0,0,229000,0,0,0,250000,21000,229000,229000
057381,微星國泰9A購01  ,0,0,0,0,0,0,0,0,0,229000,0,0,0,293000,64000,229000,229000
062388,旭富國泰01購01  ,0,0,0,0,0,0,0,0,0,229000,0,0,0,350000,121000,229000,229000
1513,中興電          ,356000,240000,116000,0,0,0,0,0,0,112000,114000,23000,91000,29000,8000,21000,228000
063327,燿華國票9C購02  ,0,0,0,0,0,0,0,0,0,228000,0,0,0,266000,38000,228000,228000
062912,新日興元大9B購01,0,0,0,0,0,0,0,0,0,228000,0,0,0,346000,118000,228000,228000
04633P,旺宏群益96售04  ,0,0,0,0,0,0,0,0,0,227000,0,0,0,227000,0,227000,227000
061437,燿華凱基9A購01  ,0,0,0,0,0,0,0,0,0,227000,0,0,0,227000,0,227000,227000
9938,百和            ,467000,120000,347000,0,0,0,0,302000,-302000,182000,73000,3000,70000,112000,0,112000,227000
06672P,聯發科群益98售05,0,0,0,0,0,0,0,0,0,226000,0,0,0,398000,172000,226000,226000
2855,統一證          ,763000,537000,226000,0,0,0,0,0,0,0,0,0,0,0,0,0,226000
053117,大立光中信9A購02,0,0,0,0,0,0,0,0,0,226000,0,0,0,386000,160000,226000,226000
5388,中磊            ,291000,114000,177000,0,0,0,0,0,0,49000,58000,0,58000,1000,10000,-9000,226000
061813,鴻海群益9B購02  ,0,0,0,0,0,0,0,0,0,224000,0,0,0,238000,14000,224000,224000
2727,王品            ,318000,95000,223000,0,0,0,0,0,0,0,0,0,0,0,0,0,223000
063578,瑞祺元大9B購03  ,0,0,0,0,0,0,0,0,0,223000,0,0,0,225000,2000,223000,223000
062880,大立光兆豐9B購02,0,0,0,0,0,0,0,0,0,223000,0,0,0,387000,164000,223000,223000
6592,和潤企業        ,385000,178000,207000,0,0,0,0,0,0,16000,6000,0,6000,10000,0,10000,223000
063741,GIS元大9B購04   ,0,0,0,0,0,0,0,0,0,222000,0,0,0,354000,132000,222000,222000
06622P,牧德元大98售01  ,0,0,0,0,0,0,0,0,0,222000,0,0,0,262000,40000,222000,222000
1592,英瑞-KY         ,387000,165000,222000,0,0,0,0,0,0,0,0,0,0,0,0,0,222000
056589,康控統一98購01  ,0,0,0,0,0,0,0,0,0,222000,0,0,0,222000,0,222000,222000
055916,奇鋐凱基99購01  ,0,0,0,0,0,0,0,0,0,222000,0,0,0,292000,70000,222000,222000
055318,華通國票98購01  ,0,0,0,0,0,0,0,0,0,222000,0,0,0,257000,35000,222000,222000
055675,亞德客凱基97購02,0,0,0,0,0,0,0,0,0,221000,0,0,0,231000,10000,221000,221000
00737,國泰AI+Robo     ,95000,0,95000,0,0,0,0,0,0,126000,0,0,0,176000,50000,126000,221000
058455,玉晶光永豐99購03,0,0,0,0,0,0,0,0,0,221000,0,0,0,264000,43000,221000,221000
061291,玉晶光統一01購05,0,0,0,0,0,0,0,0,0,221000,0,0,0,223000,2000,221000,221000
060862,美律永豐9A購01  ,0,0,0,0,0,0,0,0,0,221000,0,0,0,221000,0,221000,221000
060763,聯鈞元大9A購03  ,0,0,0,0,0,0,0,0,0,221000,0,0,0,291000,70000,221000,221000
059005,嘉晶元大99購06  ,0,0,0,0,0,0,0,0,0,220000,0,0,0,370000,150000,220000,220000
058930,華新科統一9B購01,0,0,0,0,0,0,0,0,0,220000,0,0,0,390000,170000,220000,220000
3003,健和興          ,235000,53000,182000,0,0,0,0,0,0,38000,36000,0,36000,2000,0,2000,220000
052738,聯電元大98購02  ,0,0,0,0,0,0,0,0,0,219000,0,0,0,544000,325000,219000,219000
07768P,緯穎群益9A售02  ,0,0,0,0,0,0,0,0,0,218000,0,0,0,218000,0,218000,218000
08061P,大毅國票9B售04  ,0,0,0,0,0,0,0,0,0,218000,0,0,0,244000,26000,218000,218000
063554,GIS國票9C購03   ,0,0,0,0,0,0,0,0,0,218000,0,0,0,259000,41000,218000,218000
052004,泰碩國泰97購03  ,0,0,0,0,0,0,0,0,0,218000,0,0,0,218000,0,218000,218000
057603,樺漢群益98購02  ,0,0,0,0,0,0,0,0,0,218000,0,0,0,218000,0,218000,218000
06879P,長榮航凱基98售02,0,0,0,0,0,0,0,0,0,217000,0,0,0,253000,36000,217000,217000
1308,亞聚            ,677000,366000,311000,0,0,0,0,0,0,-95000,6000,101000,-95000,0,0,0,216000
055850,聯詠元大97購06  ,0,0,0,0,0,0,0,0,0,216000,0,0,0,294000,78000,216000,216000
8131,福懋科          ,198000,86000,112000,0,0,0,0,0,0,104000,85000,0,85000,26000,7000,19000,216000
08117P,聯發科元富9B售04,0,0,0,0,0,0,0,0,0,215000,0,0,0,367000,152000,215000,215000
061268,玉晶光凱基9B購04,0,0,0,0,0,0,0,0,0,215000,0,0,0,228000,13000,215000,215000
2448,晶電            ,3281000,3008000,273000,0,0,0,0,609000,-609000,550000,861000,322000,539000,11000,0,11000,214000
063280,燿華元大9B購05  ,0,0,0,0,0,0,0,0,0,214000,0,0,0,223000,9000,214000,214000
063393,華通群益9C購05  ,0,0,0,0,0,0,0,0,0,214000,0,0,0,443000,229000,214000,214000
055257,景碩統一97購01  ,0,0,0,0,0,0,0,0,0,214000,0,0,0,214000,0,214000,214000
054164,強茂凱基98購01  ,0,0,0,0,0,0,0,0,0,214000,0,0,0,420000,206000,214000,214000
060630,國巨富邦9C購03  ,0,0,0,0,0,0,0,0,0,214000,0,0,0,224000,10000,214000,214000
062881,緯創兆豐9C購01  ,0,0,0,0,0,0,0,0,0,214000,0,0,0,466000,252000,214000,214000
063655,華通元富9B購01  ,0,0,0,0,0,0,0,0,0,213000,0,0,0,451000,238000,213000,213000
054201,聯詠富邦97購02  ,0,0,0,0,0,0,0,0,0,213000,0,0,0,250000,37000,213000,213000
060965,中租凱基9B購01  ,0,0,0,0,0,0,0,0,0,213000,0,0,0,433000,220000,213000,213000
056986,超眾群益98購03  ,0,0,0,0,0,0,0,0,0,213000,0,0,0,239000,26000,213000,213000
8163,達方            ,462000,402000,60000,0,0,0,0,0,0,153000,60000,6000,54000,110000,11000,99000,213000
063402,GIS群益9B購02   ,0,0,0,0,0,0,0,0,0,212000,0,0,0,240000,28000,212000,212000
060287,燿華元大9A購01  ,0,0,0,0,0,0,0,0,0,212000,0,0,0,238000,26000,212000,212000
062086,瑞祺元大9B購01  ,0,0,0,0,0,0,0,0,0,212000,0,0,0,214000,2000,212000,212000
3645,達邁            ,216000,29000,187000,0,0,0,0,0,0,25000,25000,0,25000,0,0,0,212000
062093,台積電富邦9C購11,0,0,0,0,0,0,0,0,0,211000,0,0,0,230000,19000,211000,211000
062038,鴻海凱基9B購05  ,0,0,0,0,0,0,0,0,0,211000,0,0,0,232000,21000,211000,211000
07043P,國巨元大99售14  ,0,0,0,0,0,0,0,0,0,210000,0,0,0,210000,0,210000,210000
046147,道瓊指中信96購02,0,0,0,0,0,0,0,0,0,210000,0,0,0,210000,0,210000,210000
060610,玉晶光凱基9B購02,0,0,0,0,0,0,0,0,0,210000,0,0,0,232000,22000,210000,210000
08209P,上銀元富9B售06  ,0,0,0,0,0,0,0,0,0,209000,0,0,0,328000,119000,209000,209000
046793,聯發科元富99購01,0,0,0,0,0,0,0,0,0,209000,0,0,0,209000,0,209000,209000
3026,禾伸堂          ,453000,281000,172000,0,0,0,297000,300000,-3000,40000,30000,0,30000,27000,17000,10000,209000
2504,國產            ,427000,145000,282000,0,0,0,0,0,0,-74000,17000,0,17000,190000,281000,-91000,208000
051503,玉晶光統一97購01,0,0,0,0,0,0,0,0,0,208000,0,0,0,281000,73000,208000,208000
057505,健策麥證98購01  ,0,0,0,208000,0,208000,0,0,0,208000,0,0,0,208000,0,208000,208000
062460,京鼎群益9C購01  ,0,0,0,0,0,0,0,0,0,208000,0,0,0,246000,38000,208000,208000
08130P,義隆元大9B售05  ,0,0,0,0,0,0,0,0,0,207000,0,0,0,368000,161000,207000,207000
07385P,緯穎群益99售04  ,0,0,0,0,0,0,0,0,0,207000,0,0,0,217000,10000,207000,207000
063478,GIS元大9B購03   ,0,0,0,0,0,0,0,0,0,207000,0,0,0,258000,51000,207000,207000
01003T,兆豐新光R1      ,208000,1000,207000,0,0,0,0,0,0,0,0,0,0,0,0,0,207000
056144,GIS元大98購01   ,0,0,0,0,0,0,0,0,0,207000,0,0,0,253000,46000,207000,207000
062541,臻鼎國泰01購01  ,0,0,0,0,0,0,0,0,0,207000,0,0,0,267000,60000,207000,207000
062387,健策國泰01購01  ,0,0,0,0,0,0,0,0,0,207000,0,0,0,238000,31000,207000,207000
061514,泰碩永豐9A購02  ,0,0,0,0,0,0,0,0,0,207000,0,0,0,217000,10000,207000,207000
00770,國泰北美科技    ,91000,1000,90000,0,0,0,0,0,0,116000,0,0,0,146000,30000,116000,206000
057467,祥碩永豐98購04  ,0,0,0,0,0,0,0,0,0,206000,0,0,0,206000,0,206000,206000
059268,鎧勝中信01購01  ,0,0,0,0,0,0,0,0,0,206000,0,0,0,442000,236000,206000,206000
4137,麗豐-KY         ,142000,31000,111000,0,0,0,0,0,0,95000,42000,0,42000,58000,5000,53000,206000
050077,臺股指凱基99購02,0,0,0,0,0,0,0,0,0,205000,0,0,0,205000,0,205000,205000
055877,奇鋐元富97購01  ,0,0,0,0,0,0,0,0,0,205000,0,0,0,245000,40000,205000,205000
060283,台肥元大9C購01  ,0,0,0,0,0,0,0,0,0,205000,0,0,0,215000,10000,205000,205000
062209,台積電台新9B購05,0,0,0,0,0,0,0,0,0,205000,0,0,0,295000,90000,205000,205000
062214,金寶統一01購01  ,0,0,0,0,0,0,0,0,0,205000,0,0,0,287000,82000,205000,205000
062113,瑞祺國票9B購01  ,0,0,0,0,0,0,0,0,0,205000,0,0,0,231000,26000,205000,205000
06189P,華新科永豐97售03,0,0,0,0,0,0,0,0,0,204000,0,0,0,218000,14000,204000,204000
06743P,創意永豐98售03  ,0,0,0,0,0,0,0,0,0,203000,0,0,0,218000,15000,203000,203000
07883P,可成凱基9B售03  ,0,0,0,0,0,0,0,0,0,203000,0,0,0,326000,123000,203000,203000
055741,健策元富97購01  ,0,0,0,0,0,0,0,0,0,203000,0,0,0,203000,0,203000,203000
060640,京鼎永豐9A購01  ,0,0,0,0,0,0,0,0,0,203000,0,0,0,233000,30000,203000,203000
062980,康控元富9B購01  ,0,0,0,0,0,0,0,0,0,203000,0,0,0,369000,166000,203000,203000
9934,成霖            ,213000,15000,198000,0,0,0,0,0,0,5000,5000,0,5000,0,0,0,203000
06933P,禾伸堂元大98售03,0,0,0,0,0,0,0,0,0,202000,0,0,0,253000,51000,202000,202000
045189,大立光元富98購01,0,0,0,0,0,0,0,0,0,202000,0,0,0,202000,0,202000,202000
3016,嘉晶            ,826000,727000,99000,0,0,0,0,0,0,103000,13000,3000,10000,197000,104000,93000,202000
07117P,SGBR2X凱基9C售01,0,0,0,0,0,0,0,0,0,200000,0,0,0,200000,0,200000,200000
07213P,聯發科凱基99售15,0,0,0,0,0,0,0,0,0,200000,0,0,0,200000,0,200000,200000
06683P,訊芯元大98售07  ,0,0,0,0,0,0,0,0,0,200000,0,0,0,200000,0,200000,200000
06359P,上銀群益97售03  ,0,0,0,0,0,0,0,0,0,200000,0,0,0,200000,0,200000,200000
07357P,鴻海元大99售38  ,0,0,0,0,0,0,0,0,0,200000,0,0,0,200000,0,200000,200000
07442P,華航康和9A售02  ,0,0,0,0,0,0,0,0,0,200000,0,0,0,200000,0,200000,200000
053314,A50正2群益9A購01,0,0,0,0,0,0,0,0,0,200000,0,0,0,200000,0,200000,200000
057821,晶相光元大98購03,0,0,0,0,0,0,0,0,0,200000,0,0,0,200000,0,200000,200000
059655,T50反1元大99購10,0,0,0,0,0,0,0,0,0,200000,0,0,0,200000,0,200000,200000
056857,國巨群益99購02  ,0,0,0,0,0,0,0,0,0,200000,0,0,0,200000,0,200000,200000
062463,世紀鋼麥證9B購01,0,0,0,200000,0,200000,0,0,0,200000,0,0,0,200000,0,200000,200000
062466,FBVIX凱基9B購01 ,0,0,0,0,0,0,0,0,0,200000,0,0,0,200000,0,200000,200000
060758,台積電元大9A購19,0,0,0,0,0,0,0,0,0,200000,0,0,0,291000,91000,200000,200000
061660,禾伸堂永豐9A購01,0,0,0,0,0,0,0,0,0,200000,0,0,0,200000,0,200000,200000
057340,玉晶光元富98購04,0,0,0,0,0,0,0,0,0,199000,0,0,0,354000,155000,199000,199000
063622,健策兆豐9B購01  ,0,0,0,0,0,0,0,0,0,198000,0,0,0,198000,0,198000,198000
06529P,貿聯富邦99售03  ,0,0,0,0,0,0,0,0,0,198000,0,0,0,198000,0,198000,198000
057353,玉晶光統一99購01,0,0,0,0,0,0,0,0,0,198000,0,0,0,515000,317000,198000,198000
057109,信邦群益98購01  ,0,0,0,0,0,0,0,0,0,198000,0,0,0,271000,73000,198000,198000
07502P,美食元大9A售01  ,0,0,0,0,0,0,0,0,0,197000,0,0,0,441000,244000,197000,197000
1104,環泥            ,195000,0,195000,0,0,0,0,0,0,2000,2000,0,2000,0,0,0,197000
058883,旭富永豐99購01  ,0,0,0,0,0,0,0,0,0,197000,0,0,0,242000,45000,197000,197000
1709,和益            ,214000,23000,191000,0,0,0,0,0,0,5000,5000,0,5000,0,0,0,196000
07341P,台積電凱基99售18,0,0,0,0,0,0,0,0,0,196000,0,0,0,214000,18000,196000,196000
08168P,金像電群益9B售03,0,0,0,0,0,0,0,0,0,195000,0,0,0,475000,280000,195000,195000
06746P,聯發科群益99售02,0,0,0,0,0,0,0,0,0,195000,0,0,0,237000,42000,195000,195000
054079,鴻海中信98購02  ,0,0,0,0,0,0,0,0,0,195000,0,0,0,195000,0,195000,195000
056209,超眾永豐97購02  ,0,0,0,0,0,0,0,0,0,195000,0,0,0,309000,114000,195000,195000
055987,台表科元富97購01,0,0,0,0,0,0,0,0,0,195000,0,0,0,426000,231000,195000,195000
060476,瑞祺元大9A購02  ,0,0,0,0,0,0,0,0,0,195000,0,0,0,300000,105000,195000,195000
061367,瑞祺國票9A購01  ,0,0,0,0,0,0,0,0,0,195000,0,0,0,221000,26000,195000,195000
062457,京元電群益9B購01,0,0,0,0,0,0,0,0,0,195000,0,0,0,552000,357000,195000,195000
2428,興勤            ,176000,61000,115000,0,0,0,0,0,0,79000,25000,0,25000,57000,3000,54000,194000
057282,大立光元大99購06,0,0,0,0,0,0,0,0,0,194000,0,0,0,196000,2000,194000,194000
062013,奇鋐富邦9B購01  ,0,0,0,0,0,0,0,0,0,194000,0,0,0,201000,7000,194000,194000
062639,臻鼎國票9C購01  ,0,0,0,0,0,0,0,0,0,194000,0,0,0,205000,11000,194000,194000
061808,聯發科統一01購02,0,0,0,0,0,0,0,0,0,194000,0,0,0,246000,52000,194000,194000
2015,豐興            ,148000,98000,50000,0,0,0,0,0,0,143000,143000,0,143000,0,0,0,193000
06475P,牧德永豐98售03  ,0,0,0,0,0,0,0,0,0,193000,0,0,0,214000,21000,193000,193000
057787,TPK國票99購01   ,0,0,0,0,0,0,0,0,0,193000,0,0,0,222000,29000,193000,193000
057739,新日興富邦9B購01,0,0,0,0,0,0,0,0,0,193000,0,0,0,508000,315000,193000,193000
058735,南茂永豐99購01  ,0,0,0,0,0,0,0,0,0,193000,0,0,0,423000,230000,193000,193000
060880,中壽中信9C購01  ,0,0,0,0,0,0,0,0,0,193000,0,0,0,511000,318000,193000,193000
062338,鴻海麥證9B購01  ,0,0,0,196000,3000,193000,0,0,0,193000,0,0,0,196000,3000,193000,193000
1201,味全            ,226000,34000,192000,0,0,0,0,0,0,0,0,0,0,0,0,0,192000
2461,光群雷          ,264000,73000,191000,0,0,0,0,0,0,1000,1000,0,1000,0,0,0,192000
058984,全新凱基9A購03  ,0,0,0,0,0,0,0,0,0,192000,0,0,0,222000,30000,192000,192000
056683,台積電統一98購05,0,0,0,0,0,0,0,0,0,192000,0,0,0,255000,63000,192000,192000
062981,祥碩元富9B購01  ,0,0,0,0,0,0,0,0,0,192000,0,0,0,222000,30000,192000,192000
061442,玉晶光永豐9A購07,0,0,0,0,0,0,0,0,0,192000,0,0,0,304000,112000,192000,192000
07088P,訊芯永豐99售02  ,0,0,0,0,0,0,0,0,0,191000,0,0,0,191000,0,191000,191000
055222,臺股指凱基97購05,0,0,0,0,0,0,0,0,0,191000,0,0,0,191000,0,191000,191000
060034,立積永豐99購04  ,0,0,0,0,0,0,0,0,0,191000,0,0,0,215000,24000,191000,191000
061880,台郡元大9B購02  ,0,0,0,0,0,0,0,0,0,191000,0,0,0,224000,33000,191000,191000
08203P,同欣電永豐9B售04,0,0,0,0,0,0,0,0,0,190000,0,0,0,190000,0,190000,190000
08118P,嘉澤元富9B售02  ,0,0,0,0,0,0,0,0,0,190000,0,0,0,216000,26000,190000,190000
054550,旺宏凱基98購02  ,0,0,0,0,0,0,0,0,0,190000,0,0,0,190000,0,190000,190000
057375,欣興元大98購09  ,0,0,0,0,0,0,0,0,0,190000,0,0,0,201000,11000,190000,190000
058440,玉晶光統一99購02,0,0,0,0,0,0,0,0,0,190000,0,0,0,356000,166000,190000,190000
061886,力山國泰01購01  ,0,0,0,0,0,0,0,0,0,190000,0,0,0,258000,68000,190000,190000
061254,道瓊反凱基9A購02,0,0,0,0,0,0,0,0,0,190000,0,0,0,190000,0,190000,190000
060631,微星富邦9B購01  ,0,0,0,0,0,0,0,0,0,190000,0,0,0,225000,35000,190000,190000
062610,啟碁凱基9B購01  ,0,0,0,0,0,0,0,0,0,190000,0,0,0,235000,45000,190000,190000
07457P,宏達電元大9A售01,0,0,0,0,0,0,0,0,0,189000,0,0,0,207000,18000,189000,189000
8105,凌巨            ,242000,142000,100000,0,0,0,0,0,0,88000,88000,0,88000,0,0,0,188000
07955P,大成鋼群益9B售02,0,0,0,0,0,0,0,0,0,187000,0,0,0,199000,12000,187000,187000
1519,華城            ,256000,132000,124000,0,0,0,0,0,0,63000,63000,0,63000,0,0,0,187000
06624P,訊芯元大98售06  ,0,0,0,0,0,0,0,0,0,187000,0,0,0,249000,62000,187000,187000
054614,玉晶光永豐97購03,0,0,0,0,0,0,0,0,0,187000,0,0,0,189000,2000,187000,187000
07635P,世芯永豐9A售05  ,0,0,0,0,0,0,0,0,0,186000,0,0,0,240000,54000,186000,186000
00783,富邦中証500     ,35000,23000,12000,0,0,0,0,0,0,174000,0,0,0,1123000,949000,174000,186000
054198,台積電永昌96購08,0,0,0,0,0,0,0,0,0,186000,0,0,0,186000,0,186000,186000
062401,信邦永豐9B購01  ,0,0,0,0,0,0,0,0,0,186000,0,0,0,344000,158000,186000,186000
062246,力山元大9B購02  ,0,0,0,0,0,0,0,0,0,186000,0,0,0,234000,48000,186000,186000
062272,鴻海群益9B購05  ,0,0,0,0,0,0,0,0,0,186000,0,0,0,204000,18000,186000,186000
061553,南電群益9A購03  ,0,0,0,0,0,0,0,0,0,186000,0,0,0,186000,0,186000,186000
07391P,台灣50國泰02售01,0,0,0,0,0,0,0,0,0,185000,0,0,0,210000,25000,185000,185000
056998,麗豐康和98購01  ,0,0,0,0,0,0,0,0,0,185000,0,0,0,200000,15000,185000,185000
060692,鴻海麥證9A購01  ,0,0,0,185000,0,185000,0,0,0,185000,0,0,0,185000,0,185000,185000
061192,奇鋐永豐9A購01  ,0,0,0,0,0,0,0,0,0,185000,0,0,0,195000,10000,185000,185000
062503,玉晶光群益01購03,0,0,0,0,0,0,0,0,0,185000,0,0,0,219000,34000,185000,185000
063701,燿華群益9B購02  ,0,0,0,0,0,0,0,0,0,184000,0,0,0,211000,27000,184000,184000
058143,瑞儀元大99購02  ,0,0,0,0,0,0,0,0,0,184000,0,0,0,294000,110000,184000,184000
056751,和大兆豐98購01  ,0,0,0,0,0,0,0,0,0,184000,0,0,0,184000,0,184000,184000
059931,緯穎富邦9A購01  ,0,0,0,0,0,0,0,0,0,184000,0,0,0,253000,69000,184000,184000
06025P,臺股指元大99售02,0,0,0,0,0,0,0,0,0,184000,0,0,0,258000,74000,184000,184000
063760,聯詠統一9C購02  ,0,0,0,0,0,0,0,0,0,183000,0,0,0,251000,68000,183000,183000
063477,訊芯元大9B購01  ,0,0,0,0,0,0,0,0,0,183000,0,0,0,183000,0,183000,183000
057077,國巨統一98購06  ,0,0,0,0,0,0,0,0,0,183000,0,0,0,300000,117000,183000,183000
8110,華東            ,211000,25000,186000,0,0,0,0,0,0,-3000,5000,8000,-3000,0,0,0,183000
07284P,大立光凱基99售10,0,0,0,0,0,0,0,0,0,182000,0,0,0,183000,1000,182000,182000
061193,玉晶光永豐9B購02,0,0,0,0,0,0,0,0,0,182000,0,0,0,243000,61000,182000,182000
07026P,超眾凱基99售03  ,0,0,0,0,0,0,0,0,0,181000,0,0,0,353000,172000,181000,181000
06600P,貿聯永豐98售01  ,0,0,0,0,0,0,0,0,0,181000,0,0,0,201000,20000,181000,181000
056288,健鼎永豐97購01  ,0,0,0,0,0,0,0,0,0,181000,0,0,0,302000,121000,181000,181000
059807,大立光元富99購09,0,0,0,0,0,0,0,0,0,181000,0,0,0,238000,57000,181000,181000
062955,立積永豐9B購02  ,0,0,0,0,0,0,0,0,0,181000,0,0,0,252000,71000,181000,181000
07133P,臺股指元大9A售27,0,0,0,0,0,0,0,0,0,180000,0,0,0,190000,10000,180000,180000
06355P,聯茂永豐97售02  ,0,0,0,0,0,0,0,0,0,180000,0,0,0,210000,30000,180000,180000
055681,奇鋐凱基98購03  ,0,0,0,0,0,0,0,0,0,180000,0,0,0,197000,17000,180000,180000
053730,樺漢凱基98購01  ,0,0,0,0,0,0,0,0,0,180000,0,0,0,180000,0,180000,180000
05859P,台表科國票97售04,0,0,0,0,0,0,0,0,0,180000,0,0,0,180000,0,180000,180000
061246,玉晶光群益9A購08,0,0,0,0,0,0,0,0,0,180000,0,0,0,194000,14000,180000,180000
1417,嘉裕            ,183000,8000,175000,0,0,0,0,0,0,4000,4000,0,4000,0,0,0,179000
056978,技嘉群益99購01  ,0,0,0,0,0,0,0,0,0,179000,0,0,0,179000,0,179000,179000
060747,聯鈞國票9A購02  ,0,0,0,0,0,0,0,0,0,179000,0,0,0,184000,5000,179000,179000
062296,南六永豐9B購02  ,0,0,0,0,0,0,0,0,0,179000,0,0,0,262000,83000,179000,179000
2607,榮運            ,287000,128000,159000,0,0,0,0,0,0,19000,19000,0,19000,0,0,0,178000
07128P,大毅元大99售04  ,0,0,0,0,0,0,0,0,0,178000,0,0,0,190000,12000,178000,178000
060887,台積電統一01購01,0,0,0,0,0,0,0,0,0,178000,0,0,0,180000,2000,178000,178000
4536,拓凱            ,190000,13000,177000,0,0,0,0,0,0,1000,1000,0,1000,0,0,0,178000
060033,臻鼎永豐99購01  ,0,0,0,0,0,0,0,0,0,177000,0,0,0,197000,20000,177000,177000
057383,玉晶光富邦9A購01,0,0,0,0,0,0,0,0,0,177000,0,0,0,183000,6000,177000,177000
058182,日電貿國泰9A購01,0,0,0,0,0,0,0,0,0,177000,0,0,0,222000,45000,177000,177000
5285,界霖            ,295000,140000,155000,0,0,0,0,0,0,22000,22000,0,22000,0,0,0,177000
058456,京鼎永豐99購01  ,0,0,0,0,0,0,0,0,0,176000,0,0,0,188000,12000,176000,176000
060278,道瓊反元大9A購03,0,0,0,0,0,0,0,0,0,176000,0,0,0,236000,60000,176000,176000
06044P,同欣電永豐96售03,0,0,0,0,0,0,0,0,0,176000,0,0,0,176000,0,176000,176000
060007,鴻海群益99購04  ,0,0,0,0,0,0,0,0,0,176000,0,0,0,178000,2000,176000,176000
055782,新日興凱基99購01,0,0,0,0,0,0,0,0,0,175000,0,0,0,175000,0,175000,175000
07112P,聯發科群益99售05,0,0,0,0,0,0,0,0,0,174000,0,0,0,249000,75000,174000,174000
062265,南茂元大9B購01  ,0,0,0,0,0,0,0,0,0,174000,0,0,0,343000,169000,174000,174000
059350,樺漢凱基9A購01  ,0,0,0,0,0,0,0,0,0,173000,0,0,0,232000,59000,173000,173000
060079,台郡台新99購03  ,0,0,0,0,0,0,0,0,0,173000,0,0,0,251000,78000,173000,173000
060606,玉晶光凱基9A購05,0,0,0,0,0,0,0,0,0,173000,0,0,0,196000,23000,173000,173000
07880P,可成群益9B售05  ,0,0,0,0,0,0,0,0,0,172000,0,0,0,172000,0,172000,172000
055859,啟碁元大97購03  ,0,0,0,0,0,0,0,0,0,172000,0,0,0,240000,68000,172000,172000
053537,玉晶光永豐98購02,0,0,0,0,0,0,0,0,0,172000,0,0,0,573000,401000,172000,172000
060874,中鋼中信02購01  ,0,0,0,0,0,0,0,0,0,172000,0,0,0,242000,70000,172000,172000
056970,TPK永豐98購01   ,0,0,0,0,0,0,0,0,0,171000,0,0,0,224000,53000,171000,171000
056287,亞光永豐97購02  ,0,0,0,0,0,0,0,0,0,170000,0,0,0,170000,0,170000,170000
059882,臺股指凱基9C購06,0,0,0,0,0,0,0,0,0,170000,0,0,0,200000,30000,170000,170000
058714,美律統一9B購01  ,0,0,0,0,0,0,0,0,0,170000,0,0,0,242000,72000,170000,170000
061523,SP黃豆凱基9B購01,0,0,0,0,0,0,0,0,0,170000,0,0,0,170000,0,170000,170000
3596,智易            ,274000,181000,93000,0,0,0,0,0,0,77000,47000,4000,43000,49000,15000,34000,170000
06652P,長榮航元大98售01,0,0,0,0,0,0,0,0,0,169000,0,0,0,169000,0,169000,169000
056178,嘉澤元富97購02  ,0,0,0,0,0,0,0,0,0,169000,0,0,0,225000,56000,169000,169000
054890,聯鈞統一99購01  ,0,0,0,0,0,0,0,0,0,169000,0,0,0,169000,0,169000,169000
060199,台郡元富9A購01  ,0,0,0,0,0,0,0,0,0,169000,0,0,0,189000,20000,169000,169000
061544,大毅群益9B購02  ,0,0,0,0,0,0,0,0,0,169000,0,0,0,358000,189000,169000,169000
061696,南茂群益9A購01  ,0,0,0,0,0,0,0,0,0,169000,0,0,0,307000,138000,169000,169000
3530,晶相光          ,245000,103000,142000,0,0,0,0,0,0,27000,2000,0,2000,25000,0,25000,169000
056791,嘉聯益群益98購01,0,0,0,0,0,0,0,0,0,168000,0,0,0,476000,308000,168000,168000
061429,南六元大9A購02  ,0,0,0,0,0,0,0,0,0,168000,0,0,0,185000,17000,168000,168000
060608,玉晶光凱基9A購08,0,0,0,0,0,0,0,0,0,168000,0,0,0,214000,46000,168000,168000
062212,臻鼎台新9B購01  ,0,0,0,0,0,0,0,0,0,168000,0,0,0,231000,63000,168000,168000
07792P,牧德元大9A售04  ,0,0,0,0,0,0,0,0,0,167000,0,0,0,167000,0,167000,167000
07579P,聯茂元大9A售01  ,0,0,0,0,0,0,0,0,0,167000,0,0,0,262000,95000,167000,167000
058095,昇陽半元大98購03,0,0,0,0,0,0,0,0,0,167000,0,0,0,267000,100000,167000,167000
061144,玉晶光中信9B購02,0,0,0,0,0,0,0,0,0,167000,0,0,0,520000,353000,167000,167000
020000,富邦特選蘋果N   ,0,0,0,0,0,0,0,0,0,166000,0,0,0,185000,19000,166000,166000
060425,凌華永豐9A購01  ,0,0,0,0,0,0,0,0,0,166000,0,0,0,285000,119000,166000,166000
057720,日電貿元富98購01,0,0,0,0,0,0,0,0,0,166000,0,0,0,231000,65000,166000,166000
061647,南六元大9A購03  ,0,0,0,0,0,0,0,0,0,166000,0,0,0,224000,58000,166000,166000
2227,裕日車          ,46000,10000,36000,0,0,0,85000,0,85000,44000,44000,0,44000,0,0,0,165000
051423,GIS國票97購01   ,0,0,0,0,0,0,0,0,0,165000,0,0,0,165000,0,165000,165000
058763,和碩群益99購01  ,0,0,0,0,0,0,0,0,0,165000,0,0,0,339000,174000,165000,165000
057992,大立光日盛98購01,0,0,0,0,0,0,0,0,0,165000,0,0,0,286000,121000,165000,165000
062435,國巨元大9B購13  ,0,0,0,0,0,0,0,0,0,165000,0,0,0,300000,135000,165000,165000
03680C,臺股指凱基9A牛26,0,0,0,0,0,0,0,0,0,164000,0,0,0,378000,214000,164000,164000
058416,鴻海麥證99購01  ,0,0,0,164000,0,164000,0,0,0,164000,0,0,0,164000,0,164000,164000
058573,鴻海群益9A購02  ,0,0,0,0,0,0,0,0,0,164000,0,0,0,191000,27000,164000,164000
062253,燿華元大9B購02  ,0,0,0,0,0,0,0,0,0,164000,0,0,0,234000,70000,164000,164000
061824,聯電麥證9B購01  ,0,0,0,164000,0,164000,0,0,0,164000,0,0,0,164000,0,164000,164000
2059,川湖            ,346000,193000,153000,0,0,0,0,0,0,10000,20000,10000,10000,0,0,0,163000
060104,新日興元大99購03,0,5000,-5000,0,0,0,0,0,0,168000,0,0,0,230000,62000,168000,163000
1604,聲寶            ,216000,59000,157000,0,0,0,0,0,0,5000,6000,1000,5000,0,0,0,162000
08216P,聯發科群益9C售05,0,0,0,0,0,0,0,0,0,162000,0,0,0,182000,20000,162000,162000
06465P,國巨統一98售04  ,0,0,0,0,0,0,0,0,0,162000,0,0,0,177000,15000,162000,162000
00762,元大全球AI      ,0,0,0,0,0,0,0,0,0,162000,0,0,0,173000,11000,162000,162000
060954,國泰金群益9A購02,0,0,0,0,0,0,0,0,0,162000,0,0,0,296000,134000,162000,162000
057265,聯詠兆豐98購01  ,0,0,0,0,0,0,0,0,0,162000,0,0,0,459000,297000,162000,162000
057960,聯鈞元大98購02  ,0,0,0,0,0,0,0,0,0,162000,0,0,0,201000,39000,162000,162000
060593,華通麥證9A購01  ,0,0,0,166000,4000,162000,0,0,0,162000,0,0,0,166000,4000,162000,162000
060713,聯詠永豐9A購01  ,0,0,0,0,0,0,0,0,0,162000,0,0,0,162000,0,162000,162000
062884,康控兆豐9C購01  ,0,0,0,0,0,0,0,0,0,162000,0,0,0,209000,47000,162000,162000
5225,東科-KY         ,173000,11000,162000,0,0,0,0,0,0,0,0,0,0,0,0,0,162000
07256P,臺股指凱基99售36,0,0,0,0,0,0,0,0,0,161000,0,0,0,161000,0,161000,161000
2484,希華            ,207000,47000,160000,0,0,0,0,0,0,1000,1000,0,1000,0,0,0,161000
00753L,中信中國50正2   ,364000,83000,281000,0,0,0,0,0,0,-120000,0,0,0,360000,480000,-120000,161000
055579,健策統一9A購01  ,0,0,0,0,0,0,0,0,0,161000,0,0,0,536000,375000,161000,161000
063089,巨大凱基9C購01  ,0,0,0,0,0,0,0,0,0,161000,0,0,0,256000,95000,161000,161000
2208,台船            ,216000,63000,153000,0,0,0,0,0,0,7000,7000,0,7000,0,0,0,160000
2405,浩鑫            ,212000,52000,160000,0,0,0,0,0,0,0,0,0,0,0,0,0,160000
06619P,聯發科元大98售06,0,0,0,0,0,0,0,0,0,160000,0,0,0,935000,775000,160000,160000
054868,國泰金群益9A購01,0,10000,-10000,0,0,0,0,0,0,170000,0,0,0,170000,0,170000,160000
051157,華新科富邦98購01,0,0,0,0,0,0,0,0,0,160000,0,0,0,160000,0,160000,160000
049255,旺宏元大97購02  ,0,0,0,0,0,0,0,0,0,160000,0,0,0,160000,0,160000,160000
052696,玉晶光麥證97購01,0,0,0,160000,0,160000,0,0,0,160000,0,0,0,160000,0,160000,160000
060337,FBVIX統一9A購01 ,0,0,0,0,0,0,0,0,0,160000,0,0,0,190000,30000,160000,160000
060125,強茂永豐99購01  ,0,0,0,0,0,0,0,0,0,160000,0,0,0,296000,136000,160000,160000
06243P,亞光元富97售01  ,0,0,0,0,0,0,0,0,0,160000,0,0,0,160000,0,160000,160000
060829,T50反1國票9A購06,0,0,0,0,0,0,0,0,0,160000,0,0,0,160000,0,160000,160000
061612,南六統一9A購01  ,0,0,0,0,0,0,0,0,0,160000,0,0,0,709000,549000,160000,160000
03434B,臺股指元大99熊10,0,0,0,0,0,0,0,0,0,159000,0,0,0,192000,33000,159000,159000
055894,欣興統一97購03  ,0,0,0,0,0,0,0,0,0,158000,0,0,0,190000,32000,158000,158000
057504,技嘉麥證98購01  ,0,0,0,158000,0,158000,0,0,0,158000,0,0,0,158000,0,158000,158000
1503,士電            ,60000,0,60000,0,0,0,0,0,0,97000,97000,0,97000,0,0,0,157000
056711,亞光永豐98購01  ,0,0,0,0,0,0,0,0,0,157000,0,0,0,157000,0,157000,157000
062025,台達電群益9B購01,0,0,0,0,0,0,0,0,0,157000,0,0,0,268000,111000,157000,157000
062002,鴻海國泰01購01  ,0,0,0,0,0,0,0,0,0,157000,0,0,0,159000,2000,157000,157000
063501,旭富永豐9B購02  ,0,0,0,0,0,0,0,0,0,156000,0,0,0,245000,89000,156000,156000
060197,臻鼎元富9A購02  ,0,0,0,0,0,0,0,0,0,156000,0,0,0,294000,138000,156000,156000
061896,景碩永豐9B購01  ,0,0,0,0,0,0,0,0,0,156000,0,0,0,211000,55000,156000,156000
061411,T50反1群益9A購05,0,0,0,0,0,0,0,0,0,156000,0,0,0,200000,44000,156000,156000
061249,億豐群益9A購01  ,0,0,0,0,0,0,0,0,0,156000,0,0,0,247000,91000,156000,156000
5521,工信            ,318000,169000,149000,0,0,0,0,0,0,7000,7000,0,7000,0,0,0,156000
06901P,亞德客凱基98售02,0,0,0,0,0,0,0,0,0,155000,0,0,0,155000,0,155000,155000
060042,台積電群益99購12,0,0,0,0,0,0,0,0,0,155000,0,0,0,201000,46000,155000,155000
059235,鴻海凱基99購08  ,0,0,0,0,0,0,0,0,0,155000,0,0,0,157000,2000,155000,155000
060707,台郡富邦9A購01  ,0,0,0,0,0,0,0,0,0,155000,0,0,0,383000,228000,155000,155000
055873,聚陽元富97購01  ,0,0,0,0,0,0,0,0,0,154000,0,0,0,154000,0,154000,154000
053591,大立光元大99購03,0,0,0,0,0,0,0,0,0,154000,0,0,0,154000,0,154000,154000
061374,力山永豐9A購04  ,0,0,0,0,0,0,0,0,0,154000,0,0,0,216000,62000,154000,154000
063691,聯鈞永豐9B購01  ,0,0,0,0,0,0,0,0,0,153000,0,0,0,153000,0,153000,153000
059041,南茂群益99購02  ,0,0,0,0,0,0,0,0,0,153000,0,0,0,266000,113000,153000,153000
061451,南電中信9A購03  ,0,0,0,0,0,0,0,0,0,153000,0,0,0,604000,451000,153000,153000
5534,長虹            ,140000,134000,6000,0,0,0,0,0,0,147000,145000,2000,143000,4000,0,4000,153000
07820P,臺股指國票9A售11,0,0,0,0,0,0,0,0,0,152000,0,0,0,224000,72000,152000,152000
053377,台積電元大98購01,0,0,0,0,0,0,0,0,0,152000,0,0,0,152000,0,152000,152000
050915,健策中信98購01  ,0,0,0,0,0,0,0,0,0,152000,0,0,0,152000,0,152000,152000
060624,玉晶光元大9C購02,0,0,0,0,0,0,0,0,0,152000,0,0,0,237000,85000,152000,152000
08062P,華擎國票9B售03  ,0,0,0,0,0,0,0,0,0,151000,0,0,0,214000,63000,151000,151000
063597,健策中信9B購02  ,0,0,0,0,0,0,0,0,0,151000,0,0,0,161000,10000,151000,151000
07071P,立積元富99售01  ,0,0,0,0,0,0,0,0,0,151000,0,0,0,299000,148000,151000,151000
00733,富邦臺灣中小    ,0,0,0,0,0,0,0,0,0,151000,0,0,0,352000,201000,151000,151000
055817,京鼎國票99購01  ,0,0,0,0,0,0,0,0,0,151000,0,0,0,173000,22000,151000,151000
058964,群創兆豐99購01  ,0,0,0,0,0,0,0,0,0,151000,0,0,0,231000,80000,151000,151000
056787,健鼎群益98購01  ,0,0,0,0,0,0,0,0,0,151000,0,0,0,271000,120000,151000,151000
07258P,台灣50台新9A售01,0,0,0,0,0,0,0,0,0,150000,0,0,0,160000,10000,150000,150000
06753P,智邦富邦98售03  ,0,0,0,0,0,0,0,0,0,150000,0,0,0,150000,0,150000,150000
063606,TPK凱基9C購01   ,0,0,0,0,0,0,0,0,0,150000,0,0,0,243000,93000,150000,150000
07953P,健策元大9B售07  ,0,0,0,0,0,0,0,0,0,150000,0,0,0,150000,0,150000,150000
055763,鎧勝群益97購01  ,0,0,0,0,0,0,0,0,0,150000,0,0,0,510000,360000,150000,150000
051594,和碩元大96購01  ,0,0,0,0,0,0,0,0,0,150000,0,0,0,150000,0,150000,150000
057286,群創元大9B購05  ,0,0,0,0,0,0,0,0,0,150000,0,0,0,160000,10000,150000,150000
058660,樺漢中信9A購01  ,0,0,0,0,0,0,0,0,0,150000,0,0,0,552000,402000,150000,150000
062283,玉晶光群益01購01,0,0,0,0,0,0,0,0,0,150000,0,0,0,166000,16000,150000,150000
1808,潤隆            ,98000,47000,51000,0,0,0,0,0,0,98000,98000,0,98000,0,0,0,149000
047571,滬深2X群益99購01,0,0,0,0,0,0,0,0,0,149000,0,0,0,149000,0,149000,149000
060701,玉晶光國泰9C購01,0,0,0,0,0,0,0,0,0,149000,0,0,0,273000,124000,149000,149000
08136P,祥碩國泰01售01  ,0,0,0,0,0,0,0,0,0,148000,0,0,0,688000,540000,148000,148000
00674R,元大S&P黃金反1  ,0,0,0,0,0,0,0,0,0,148000,0,0,0,262000,114000,148000,148000
07863P,華新科凱基9B售07,0,0,0,0,0,0,0,0,0,147000,0,0,0,150000,3000,147000,147000
2031,新光鋼          ,141000,69000,72000,0,0,0,0,0,0,75000,76000,1000,75000,0,0,0,147000
054932,台肥元大97購01  ,0,0,0,0,0,0,0,0,0,147000,0,0,0,250000,103000,147000,147000
054547,鴻海凱基98購02  ,0,0,0,0,0,0,0,0,0,147000,0,0,0,149000,2000,147000,147000
056461,樺漢凱基98購02  ,0,0,0,0,0,0,0,0,0,147000,0,0,0,297000,150000,147000,147000
057580,玉山金中信9A購01,0,0,0,0,0,0,0,0,0,147000,0,0,0,217000,70000,147000,147000
062314,玉晶光凱基9B購06,0,0,0,0,0,0,0,0,0,147000,0,0,0,299000,152000,147000,147000
051486,玉晶光凱基97購03,0,0,0,0,0,0,0,0,0,146000,0,0,0,284000,138000,146000,146000
053186,健策中信9C購01  ,0,0,0,0,0,0,0,0,0,146000,0,0,0,193000,47000,146000,146000
056379,玉晶光元富98購01,0,0,0,0,0,0,0,0,0,146000,0,0,0,242000,96000,146000,146000
1337,再生-KY         ,163000,24000,139000,0,0,0,0,0,0,6000,6000,0,6000,0,0,0,145000
2426,鼎元            ,220000,127000,93000,0,0,0,0,0,0,52000,52000,0,52000,0,0,0,145000
08190P,宏達電元富9B售04,0,0,0,0,0,0,0,0,0,145000,0,0,0,230000,85000,145000,145000
063631,燿華元大9B購06  ,0,0,0,0,0,0,0,0,0,145000,0,0,0,145000,0,145000,145000
055232,泰碩國票98購01  ,0,0,0,0,0,0,0,0,0,145000,0,0,0,145000,0,145000,145000
057553,景碩凱基98購03  ,0,0,0,0,0,0,0,0,0,145000,0,0,0,145000,0,145000,145000
059844,大立光富邦9C購04,0,0,0,0,0,0,0,0,0,145000,0,0,0,145000,0,145000,145000
063161,祥碩富邦9B購02  ,0,0,0,0,0,0,0,0,0,145000,0,0,0,150000,5000,145000,145000
062906,全新元大9B購03  ,0,0,0,0,0,0,0,0,0,145000,0,0,0,338000,193000,145000,145000
054563,泰碩群益99購01  ,0,0,0,0,0,0,0,0,0,144000,0,0,0,216000,72000,144000,144000
058809,國巨統一9B購03  ,0,0,0,0,0,0,0,0,0,144000,0,0,0,260000,116000,144000,144000
062970,智邦元富9B購01  ,0,0,0,0,0,0,0,0,0,144000,0,0,0,165000,21000,144000,144000
07580P,緯穎元大9A售03  ,0,0,0,0,0,0,0,0,0,143000,0,0,0,314000,171000,143000,143000
1338,廣華-KY         ,175000,38000,137000,0,0,0,0,0,0,6000,6000,0,6000,0,0,0,143000
056935,華新科元富98購02,0,0,0,0,0,0,0,0,0,143000,0,0,0,163000,20000,143000,143000
058685,TPK凱基99購01   ,0,0,0,0,0,0,0,0,0,143000,0,0,0,153000,10000,143000,143000
2374,佳能            ,296000,157000,139000,0,0,0,0,0,0,3000,3000,0,3000,0,0,0,142000
06834P,訊芯群益99售02  ,0,0,0,0,0,0,0,0,0,142000,0,0,0,142000,0,142000,142000
056332,台郡國票99購01  ,0,0,0,0,0,0,0,0,0,142000,0,0,0,202000,60000,142000,142000
061113,南電元大9A購03  ,0,0,0,0,0,0,0,0,0,142000,0,0,0,147000,5000,142000,142000
061478,奇鋐元大9A購01  ,0,0,0,0,0,0,0,0,0,142000,0,0,0,316000,174000,142000,142000
056845,揚明光元富98購01,0,0,0,0,0,0,0,0,0,141000,0,0,0,239000,98000,141000,141000
06802P,緯穎群益98售03  ,0,0,0,0,0,0,0,0,0,140000,0,0,0,140000,0,140000,140000
051929,GIS中信96購01   ,0,0,0,0,0,0,0,0,0,140000,0,0,0,150000,10000,140000,140000
055093,京鼎群益98購01  ,0,0,0,0,0,0,0,0,0,140000,0,0,0,140000,0,140000,140000
056988,聚陽兆豐98購01  ,0,0,0,0,0,0,0,0,0,140000,0,0,0,140000,0,140000,140000
05731P,創意統一96售03  ,0,0,0,0,0,0,0,0,0,140000,0,0,0,140000,0,140000,140000
061142,南電統一9A購01  ,0,0,0,0,0,0,0,0,0,140000,0,0,0,140000,0,140000,140000
07142P,台灣50元大01售01,0,0,0,0,0,0,0,0,0,139000,0,0,0,140000,1000,139000,139000
063674,力山國泰01購02  ,0,0,0,0,0,0,0,0,0,139000,0,0,0,235000,96000,139000,139000
00728,第一金工業30    ,0,0,0,0,0,0,0,0,0,139000,0,0,0,344000,205000,139000,139000
060586,玉晶光元富9A購03,0,0,0,0,0,0,0,0,0,139000,0,0,0,206000,67000,139000,139000
061897,泰碩永豐9B購01  ,0,0,0,0,0,0,0,0,0,139000,0,0,0,200000,61000,139000,139000
061788,信邦群益9B購01  ,0,0,0,0,0,0,0,0,0,139000,0,0,0,235000,96000,139000,139000
063103,技嘉群益9B購01  ,0,0,0,0,0,0,0,0,0,139000,0,0,0,139000,0,139000,139000
6168,宏齊            ,117000,16000,101000,0,0,0,0,0,0,38000,38000,0,38000,0,0,0,139000
3712,永崴投控        ,157000,23000,134000,0,0,0,0,0,0,5000,5000,0,5000,0,0,0,139000
059200,京鼎永豐99購02  ,0,0,0,0,0,0,0,0,0,138000,0,0,0,167000,29000,138000,138000
058141,嘉聯益元大99購05,0,0,0,0,0,0,0,0,0,138000,0,0,0,290000,152000,138000,138000
058854,樺漢群益9B購01  ,0,0,0,0,0,0,0,0,0,138000,0,0,0,719000,581000,138000,138000
063012,技嘉元大9B購01  ,0,0,0,0,0,0,0,0,0,138000,0,0,0,192000,54000,138000,138000
061606,景碩凱基9A購02  ,0,0,0,0,0,0,0,0,0,138000,0,0,0,148000,10000,138000,138000
3060,銘異            ,193000,79000,114000,0,0,0,0,0,0,24000,24000,0,24000,0,0,0,138000
07131P,緯穎元大99售06  ,0,0,0,0,0,0,0,0,0,137000,0,0,0,228000,91000,137000,137000
07172P,臺股指國票99售09,0,0,0,0,0,0,0,0,0,137000,0,0,0,300000,163000,137000,137000
07919P,創意永豐9B售01  ,0,0,0,0,0,0,0,0,0,137000,0,0,0,147000,10000,137000,137000
055652,聯詠元富01購01  ,0,0,0,0,0,0,0,0,0,137000,0,0,0,187000,50000,137000,137000
056420,台表科元富98購01,0,0,0,0,0,0,0,0,0,137000,0,0,0,360000,223000,137000,137000
061057,華新科國票9A購04,0,0,0,0,0,0,0,0,0,137000,0,0,0,150000,13000,137000,137000
5234,達興材料        ,149000,58000,91000,0,0,0,28000,0,28000,18000,18000,0,18000,0,0,0,137000
4532,瑞智            ,205000,76000,129000,0,0,0,0,0,0,8000,8000,0,8000,0,0,0,137000
6541,泰福-KY         ,156000,21000,135000,0,0,0,0,0,0,2000,4000,2000,2000,0,0,0,137000
08009P,華擎統一9B售02  ,0,0,0,0,0,0,0,0,0,136000,0,0,0,144000,8000,136000,136000
07102P,南電元大99售03  ,0,0,0,0,0,0,0,0,0,136000,0,0,0,161000,25000,136000,136000
00666R,富邦恒生國企反1 ,2000,25000,-23000,0,0,0,0,0,0,159000,0,0,0,260000,101000,159000,136000
055297,啟碁元大97購01  ,0,0,0,0,0,0,0,0,0,136000,0,0,0,204000,68000,136000,136000
056919,英業達兆豐98購01,0,0,0,0,0,0,0,0,0,136000,0,0,0,142000,6000,136000,136000
061141,臻鼎統一9A購01  ,0,0,0,0,0,0,0,0,0,136000,0,0,0,146000,10000,136000,136000
06320P,上銀統一97售04  ,0,0,0,0,0,0,0,0,0,136000,0,0,0,136000,0,136000,136000
2419,仲琦            ,90000,6000,84000,0,0,0,0,0,0,51000,51000,0,51000,0,0,0,135000
055153,台光電元大98購02,0,0,0,0,0,0,0,0,0,135000,0,0,0,136000,1000,135000,135000
056497,GIS國泰99購01   ,0,0,0,0,0,0,0,0,0,135000,0,0,0,143000,8000,135000,135000
00739,元大MSCI A股    ,5000,5000,0,0,0,0,0,0,0,135000,0,0,0,632000,497000,135000,135000
051317,亞德客國票96購01,0,0,0,0,0,0,0,0,0,135000,0,0,0,135000,0,135000,135000
053768,S&P反1元大99購01,0,0,0,0,0,0,0,0,0,135000,0,0,0,255000,120000,135000,135000
059961,T50反1凱基99購09,0,0,0,0,0,0,0,0,0,135000,0,0,0,150000,15000,135000,135000
057391,樺漢永豐98購01  ,0,0,0,0,0,0,0,0,0,135000,0,0,0,135000,0,135000,135000
057886,聯詠群益98購01  ,0,0,0,0,0,0,0,0,0,135000,0,0,0,270000,135000,135000,135000
05758P,光罩永豐96售02  ,0,0,0,0,0,0,0,0,0,135000,0,0,0,135000,0,135000,135000
060297,和碩元大9A購02  ,0,0,0,0,0,0,0,0,0,135000,0,0,0,400000,265000,135000,135000
060412,儒鴻永豐9A購01  ,0,0,0,0,0,0,0,0,0,135000,0,0,0,202000,67000,135000,135000
062411,玉晶光第一9B購01,0,0,0,0,0,0,0,0,0,135000,0,0,0,359000,224000,135000,135000
062263,康控元大9B購03  ,0,0,0,0,0,0,0,0,0,135000,0,0,0,163000,28000,135000,135000
061819,茂林群益9B購01  ,0,0,0,0,0,0,0,0,0,135000,0,0,0,321000,186000,135000,135000
056470,旺宏元大99購01  ,0,0,0,0,0,0,0,0,0,134000,0,0,0,141000,7000,134000,134000
060260,京鼎凱基9C購01  ,0,0,0,0,0,0,0,0,0,134000,0,0,0,134000,0,134000,134000
057081,大立光統一98購07,0,0,0,0,0,0,0,0,0,134000,0,0,0,140000,6000,134000,134000
061074,儒鴻兆豐9B購01  ,0,0,0,0,0,0,0,0,0,134000,0,0,0,160000,26000,134000,134000
8404,百和興業-KY     ,287000,157000,130000,0,0,0,0,0,0,4000,5000,1000,4000,0,0,0,134000
056689,玉晶光統一9A購03,0,0,0,0,0,0,0,0,0,133000,0,0,0,290000,157000,133000,133000
056981,全新群益99購03  ,0,0,0,0,0,0,0,0,0,133000,0,0,0,133000,0,133000,133000
056918,台積電兆豐98購01,0,0,0,0,0,0,0,0,0,133000,0,0,0,133000,0,133000,133000
2316,楠梓電          ,216000,170000,46000,0,0,0,0,0,0,86000,86000,0,86000,0,0,0,132000
07659P,中租凱基9A售02  ,0,0,0,0,0,0,0,0,0,132000,0,0,0,450000,318000,132000,132000
06657P,寶成元大98售01  ,0,0,0,0,0,0,0,0,0,132000,0,0,0,254000,122000,132000,132000
06454P,緯穎元大98售04  ,0,0,0,0,0,0,0,0,0,132000,0,0,0,190000,58000,132000,132000
063634,台光電元大9B購09,0,0,0,0,0,0,0,0,0,132000,0,0,0,133000,1000,132000,132000
056571,燿華元大98購02  ,0,0,0,0,0,0,0,0,0,132000,0,0,0,137000,5000,132000,132000
060460,鴻海元大9A購08  ,0,0,0,0,0,0,0,0,0,132000,0,0,0,156000,24000,132000,132000
058398,中環元大99購02  ,0,0,0,0,0,0,0,0,0,132000,0,0,0,177000,45000,132000,132000
061485,鴻海兆豐9A購01  ,0,0,0,0,0,0,0,0,0,132000,0,0,0,143000,11000,132000,132000
063624,GIS兆豐9B購01   ,0,0,0,0,0,0,0,0,0,131000,0,0,0,220000,89000,131000,131000
059023,可成統一9B購02  ,0,0,0,0,0,0,0,0,0,131000,0,0,0,153000,22000,131000,131000
056088,台郡統一97購02  ,0,0,0,0,0,0,0,0,0,131000,0,0,0,231000,100000,131000,131000
050171,臺指反元大97購03,0,0,0,0,0,0,0,0,0,131000,0,0,0,131000,0,131000,131000
061949,大立光群益9B購03,0,0,0,0,0,0,0,0,0,131000,0,0,0,131000,0,131000,131000
07626P,台灣50凱基04售07,0,0,0,0,0,0,0,0,0,130000,0,0,0,150000,20000,130000,130000
07750P,台表科凱基9A售04,0,0,0,0,0,0,0,0,0,130000,0,0,0,130000,0,130000,130000
054137,聯詠元大97購02  ,0,0,0,0,0,0,0,0,0,130000,0,0,0,130000,0,130000,130000
051732,華通國票97購01  ,0,0,0,0,0,0,0,0,0,130000,0,0,0,130000,0,130000,130000
051263,深中小富邦96購01,0,0,0,0,0,0,0,0,0,130000,0,0,0,130000,0,130000,130000
061456,玉晶光凱基9B購05,0,0,0,0,0,0,0,0,0,130000,0,0,0,145000,15000,130000,130000
08010P,大成鋼元大9B售01,0,0,0,0,0,0,0,0,0,129000,0,0,0,150000,21000,129000,129000
08015P,可成凱基9B售05  ,0,0,0,0,0,0,0,0,0,129000,0,0,0,129000,0,129000,129000
062766,台郡凱基9B購02  ,0,0,0,0,0,0,0,0,0,129000,0,0,0,301000,172000,129000,129000
8021,尖點            ,294000,192000,102000,0,0,0,0,0,0,27000,27000,0,27000,0,0,0,129000
07793P,同欣電元大9A售02,0,0,0,0,0,0,0,0,0,128000,0,0,0,265000,137000,128000,128000
055553,聯發科凱基97購05,0,0,0,0,0,0,0,0,0,128000,0,0,0,132000,4000,128000,128000
055958,台光電元大97購02,0,0,0,0,0,0,0,0,0,128000,0,0,0,135000,7000,128000,128000
058616,台虹元大9A購01  ,0,0,0,0,0,0,0,0,0,128000,0,0,0,205000,77000,128000,128000
060406,瑞祺國泰9B購01  ,0,0,0,0,0,0,0,0,0,128000,0,0,0,170000,42000,128000,128000
058085,景碩群益9A購01  ,0,0,0,0,0,0,0,0,0,128000,0,0,0,144000,16000,128000,128000
058033,景碩永豐98購02  ,0,0,0,0,0,0,0,0,0,128000,0,0,0,158000,30000,128000,128000
3033,威健            ,124000,5000,119000,0,0,0,0,0,0,9000,9000,0,9000,0,0,0,128000
059665,嘉聯益元大99購06,0,0,0,0,0,0,0,0,0,127000,0,0,0,173000,46000,127000,127000
061770,泰碩元大9B購02  ,0,0,0,0,0,0,0,0,0,127000,0,0,0,202000,75000,127000,127000
06783P,亞光元大98售03  ,0,0,0,0,0,0,0,0,0,126000,0,0,0,127000,1000,126000,126000
062710,盛群元大9B購01  ,0,0,0,0,0,0,0,0,0,126000,0,0,0,181000,55000,126000,126000
07851P,聯發科國票9A售05,0,0,0,0,0,0,0,0,0,125000,0,0,0,209000,84000,125000,125000
07867P,晶技元大9B售01  ,0,0,0,0,0,0,0,0,0,125000,0,0,0,198000,73000,125000,125000
07977P,華新科群益01售01,0,0,0,0,0,0,0,0,0,125000,0,0,0,212000,87000,125000,125000
08187P,大毅群益9B售04  ,0,0,0,0,0,0,0,0,0,125000,0,0,0,125000,0,125000,125000
07303P,臺股指元大9A售36,0,0,0,0,0,0,0,0,0,125000,0,0,0,171000,46000,125000,125000
048273,南電富邦97購01  ,0,0,0,0,0,0,0,0,0,125000,0,0,0,137000,12000,125000,125000
062560,奇鋐凱基9B購02  ,0,0,0,0,0,0,0,0,0,125000,0,0,0,136000,11000,125000,125000
6139,亞翔            ,457000,369000,88000,0,0,0,0,0,0,37000,38000,1000,37000,0,0,0,125000
1307,三芳            ,152000,33000,119000,0,0,0,0,0,0,5000,5000,0,5000,0,0,0,124000
056065,奇鋐元大97購01  ,0,0,0,0,0,0,0,0,0,124000,0,0,0,149000,25000,124000,124000
058972,新日興永豐9A購01,0,0,0,0,0,0,0,0,0,124000,0,0,0,207000,83000,124000,124000
057455,景碩國泰99購01  ,0,0,0,0,0,0,0,0,0,124000,0,0,0,124000,0,124000,124000
062384,聯詠國泰9C購01  ,0,0,0,0,0,0,0,0,0,124000,0,0,0,124000,0,124000,124000
062229,南六統一9B購01  ,0,0,0,0,0,0,0,0,0,124000,0,0,0,460000,336000,124000,124000
061274,臺股指凱基9A購24,0,0,0,0,0,0,0,0,0,124000,0,0,0,202000,78000,124000,124000
060825,聯詠元大9A購05  ,0,0,0,0,0,0,0,0,0,124000,0,0,0,266000,142000,124000,124000
5907,大洋-KY         ,150000,29000,121000,0,0,0,0,0,0,3000,3000,0,3000,0,0,0,124000
2331,精英            ,162000,45000,117000,0,0,0,0,0,0,6000,6000,0,6000,0,0,0,123000
059082,華通元大99購06  ,0,0,0,0,0,0,0,0,0,123000,0,0,0,134000,11000,123000,123000
054739,義隆凱基98購02  ,0,0,0,0,0,0,0,0,0,123000,0,0,0,145000,22000,123000,123000
060180,上証2X元富9A購02,0,0,0,0,0,0,0,0,0,123000,0,0,0,123000,0,123000,123000
057837,康控國泰99購02  ,0,0,0,0,0,0,0,0,0,123000,0,0,0,133000,10000,123000,123000
059700,鴻海凱基9A購16  ,0,0,0,0,0,0,0,0,0,123000,0,0,0,123000,0,123000,123000
061174,鴻海凱基9A購23  ,0,0,0,0,0,0,0,0,0,123000,0,0,0,135000,12000,123000,123000
061506,瑞祺國票9A購02  ,0,0,0,0,0,0,0,0,0,123000,0,0,0,140000,17000,123000,123000
08143P,聯發科凱基9C售05,0,0,0,0,0,0,0,0,0,122000,0,0,0,122000,0,122000,122000
047213,新日興富邦97購01,0,0,0,0,0,0,0,0,0,122000,0,0,0,146000,24000,122000,122000
056855,祥碩中信98購02  ,0,0,0,0,0,0,0,0,0,122000,0,0,0,158000,36000,122000,122000
060428,瑞祺永豐9A購01  ,0,0,0,0,0,0,0,0,0,122000,0,0,0,329000,207000,122000,122000
060087,鴻海元大99購43  ,0,0,0,0,0,0,0,0,0,122000,0,0,0,130000,8000,122000,122000
062084,台郡元大9B購04  ,0,0,0,0,0,0,0,0,0,122000,0,0,0,186000,64000,122000,122000
07687P,上銀元大9A售06  ,0,0,0,0,0,0,0,0,0,121000,0,0,0,121000,0,121000,121000
2493,揚博            ,196000,76000,120000,0,0,0,0,0,0,1000,1000,0,1000,0,0,0,121000
1477,聚陽            ,620000,1183000,-563000,0,0,0,623000,106000,517000,167000,53000,43000,10000,163000,6000,157000,121000
06645P,上銀元大98售05  ,0,0,0,0,0,0,0,0,0,121000,0,0,0,135000,14000,121000,121000
059124,台積電第一03購01,0,0,0,0,0,0,0,0,0,121000,0,0,0,121000,0,121000,121000
055874,中環元富9A購01  ,0,0,0,0,0,0,0,0,0,121000,0,0,0,541000,420000,121000,121000
057606,健策統一98購03  ,0,0,0,0,0,0,0,0,0,121000,0,0,0,121000,0,121000,121000
063318,京鼎群益9C購02  ,0,0,0,0,0,0,0,0,0,120000,0,0,0,243000,123000,120000,120000
2388,威盛            ,143000,23000,120000,0,0,0,0,0,0,0,0,0,0,0,0,0,120000
07375P,台積電元大99售48,0,0,0,0,0,0,0,0,0,120000,0,0,0,120000,0,120000,120000
055417,健策富邦98購02  ,0,0,0,0,0,0,0,0,0,120000,0,0,0,120000,0,120000,120000
056308,TPK元大97購02   ,0,0,0,0,0,0,0,0,0,120000,0,0,0,138000,18000,120000,120000
052944,宏達電國票97購01,0,0,0,0,0,0,0,0,0,120000,0,0,0,120000,0,120000,120000
059913,台積電元大99購44,0,0,0,0,0,0,0,0,0,120000,0,0,0,125000,5000,120000,120000
057945,京鼎國票99購03  ,0,0,0,0,0,0,0,0,0,120000,0,0,0,131000,11000,120000,120000
057956,全新元大99購04  ,0,0,0,0,0,0,0,0,0,120000,0,0,0,120000,0,120000,120000
060931,GIS永豐9A購01   ,0,0,0,0,0,0,0,0,0,120000,0,0,0,120000,0,120000,120000
062893,元金2X元大9C購01,0,0,0,0,0,0,0,0,0,120000,0,0,0,120000,0,120000,120000
063086,祥碩凱基9C購01  ,0,0,0,0,0,0,0,0,0,120000,0,0,0,123000,3000,120000,120000
061326,新日興凱基9B購01,0,0,0,0,0,0,0,0,0,120000,0,0,0,335000,215000,120000,120000
061002,瑞昱兆豐9B購01  ,0,0,0,0,0,0,0,0,0,120000,0,0,0,120000,0,120000,120000
060687,GIS元大9A購01   ,0,0,0,0,0,0,0,0,0,120000,0,0,0,120000,0,120000,120000
3028,增你強          ,118000,1000,117000,0,0,0,0,0,0,3000,3000,0,3000,0,0,0,120000
057539,南茂元大98購02  ,0,0,0,0,0,0,0,0,0,119000,0,0,0,248000,129000,119000,119000
058873,美律國票9A購02  ,0,0,0,0,0,0,0,0,0,119000,0,0,0,119000,0,119000,119000
057629,泰碩永豐98購02  ,0,0,0,0,0,0,0,0,0,119000,0,0,0,139000,20000,119000,119000
061699,燿華國票9A購01  ,0,0,0,0,0,0,0,0,0,119000,0,0,0,209000,90000,119000,119000
063031,鴻海凱基9C購01  ,0,0,0,0,0,0,0,0,0,119000,0,0,0,121000,2000,119000,119000
062061,台勝科統一01購01,0,0,0,0,0,0,0,0,0,119000,0,0,0,319000,200000,119000,119000
9802,鈺齊-KY         ,323000,138000,185000,0,0,0,0,100000,-100000,34000,38000,5000,33000,7000,6000,1000,119000
08207P,金像電群益9B售05,0,0,0,0,0,0,0,0,0,118000,0,0,0,328000,210000,118000,118000
056320,京鼎群益99購01  ,0,0,0,0,0,0,0,0,0,118000,0,0,0,184000,66000,118000,118000
00713,元大台灣高息低波,50000,1000,49000,0,0,0,0,0,0,69000,0,0,0,69000,0,69000,118000
055725,嘉聯益元大98購03,0,0,0,0,0,0,0,0,0,118000,0,0,0,216000,98000,118000,118000
057642,南亞科元大98購07,0,0,0,0,0,0,0,0,0,118000,0,0,0,118000,0,118000,118000
056702,欣興國泰9A購01  ,0,0,0,0,0,0,0,0,0,118000,0,0,0,118000,0,118000,118000
057408,台郡群益98購01  ,0,0,0,0,0,0,0,0,0,118000,0,0,0,134000,16000,118000,118000
060164,合勤控永豐9A購01,0,0,0,0,0,0,0,0,0,118000,0,0,0,300000,182000,118000,118000
062896,中興電元大9B購01,0,0,0,0,0,0,0,0,0,118000,0,0,0,371000,253000,118000,118000
3504,揚明光          ,160000,55000,105000,0,0,0,0,0,0,13000,21000,0,21000,0,8000,-8000,118000
07527P,台灣50凱基9B售02,0,0,0,0,0,0,0,0,0,117000,0,0,0,205000,88000,117000,117000
07837P,華邦電元大9A售01,0,0,0,0,0,0,0,0,0,117000,0,0,0,143000,26000,117000,117000
053297,鎧勝中信98購01  ,0,0,0,0,0,0,0,0,0,117000,0,0,0,397000,280000,117000,117000
059977,鴻海元大99購40  ,0,0,0,0,0,0,0,0,0,117000,0,0,0,119000,2000,117000,117000
062048,義隆台新9B購01  ,0,0,0,0,0,0,0,0,0,117000,0,0,0,123000,6000,117000,117000
06240P,奇力新元富97售03,0,0,0,0,0,0,0,0,0,117000,0,0,0,122000,5000,117000,117000
062566,嘉晶中信9C購01  ,0,0,0,0,0,0,0,0,0,117000,0,0,0,137000,20000,117000,117000
6283,淳安            ,160000,46000,114000,0,0,0,0,0,0,3000,3000,0,3000,0,0,0,117000
052424,泰碩國票97購01  ,0,0,0,0,0,0,0,0,0,116000,0,0,0,136000,20000,116000,116000
052766,玉晶光群益9A購01,0,0,0,0,0,0,0,0,0,116000,0,0,0,120000,4000,116000,116000
056577,玉晶光元大99購06,0,0,0,0,0,0,0,0,0,116000,0,0,0,116000,0,116000,116000
057320,玉晶光凱基98購01,0,0,0,0,0,0,0,0,0,116000,0,0,0,207000,91000,116000,116000
060327,美律群益9A購02  ,0,0,0,0,0,0,0,0,0,116000,0,0,0,120000,4000,116000,116000
057499,奇鋐群益98購01  ,0,0,0,0,0,0,0,0,0,116000,0,0,0,116000,0,116000,116000
061470,鈺齊群益9A購02  ,0,0,0,0,0,0,0,0,0,116000,0,0,0,116000,0,116000,116000
1598,岱宇            ,303000,224000,79000,0,0,0,0,0,0,36000,36000,0,36000,0,0,0,115000
063752,瑞祺國票9C購01  ,0,0,0,0,0,0,0,0,0,115000,0,0,0,125000,10000,115000,115000
06551P,貿聯元大98售05  ,0,0,0,0,0,0,0,0,0,115000,0,0,0,115000,0,115000,115000
056127,致新國票98購02  ,0,0,0,0,0,0,0,0,0,115000,0,0,0,115000,0,115000,115000
060387,盛群凱基9A購01  ,0,0,0,0,0,0,0,0,0,115000,0,0,0,155000,40000,115000,115000
061641,玉晶光元大9A購17,0,0,0,0,0,0,0,0,0,115000,0,0,0,115000,0,115000,115000
060991,京鼎元大9A購01  ,0,0,0,0,0,0,0,0,0,115000,0,0,0,140000,25000,115000,115000
8011,台通            ,247000,133000,114000,0,0,0,0,0,0,1000,1000,0,1000,0,0,0,115000
063479,南六元大9B購06  ,0,0,0,0,0,0,0,0,0,114000,0,0,0,179000,65000,114000,114000
054935,華通元大98購03  ,0,0,0,0,0,0,0,0,0,114000,0,0,0,134000,20000,114000,114000
058494,可成群益9B購01  ,0,0,0,0,0,0,0,0,0,114000,0,0,0,114000,0,114000,114000
062936,鴻海凱基9B購07  ,0,0,0,0,0,0,0,0,0,114000,0,0,0,116000,2000,114000,114000
3018,同開            ,117000,3000,114000,0,0,0,0,0,0,0,0,0,0,0,0,0,114000
6166,凌華            ,152000,39000,113000,0,0,0,0,0,0,1000,3000,0,3000,0,2000,-2000,114000
2433,互盛電          ,35000,0,35000,0,0,0,0,0,0,78000,78000,0,78000,0,0,0,113000
057502,訊芯群益98購02  ,0,0,0,0,0,0,0,0,0,113000,0,0,0,211000,98000,113000,113000
057327,玉晶光群益9A購04,0,0,0,0,0,0,0,0,0,113000,0,0,0,159000,46000,113000,113000
059261,華邦電中信01購01,0,0,0,0,0,0,0,0,0,113000,0,0,0,260000,147000,113000,113000
060847,康控國票9A購01  ,0,0,0,0,0,0,0,0,0,113000,0,0,0,122000,9000,113000,113000
2239,英利-KY         ,152000,187000,-35000,0,0,0,145000,0,145000,2000,2000,0,2000,0,0,0,112000
1321,大洋            ,112000,4000,108000,0,0,0,0,0,0,4000,4000,0,4000,0,0,0,112000
07649P,金像電永豐9A售02,0,0,0,0,0,0,0,0,0,112000,0,0,0,172000,60000,112000,112000
06686P,麗豐永豐98售02  ,0,0,0,0,0,0,0,0,0,112000,0,0,0,112000,0,112000,112000
07190P,臺股指富邦9C售02,0,0,0,0,0,0,0,0,0,112000,0,0,0,118000,6000,112000,112000
054564,玉晶光群益99購01,30000,0,30000,0,0,0,0,0,0,82000,0,0,0,243000,161000,82000,112000
056586,光罩統一98購02  ,0,0,0,0,0,0,0,0,0,112000,0,0,0,317000,205000,112000,112000
053244,光磊國票97購01  ,0,0,0,0,0,0,0,0,0,112000,0,0,0,150000,38000,112000,112000
056668,光磊國票99購01  ,0,0,0,0,0,0,0,0,0,112000,0,0,0,153000,41000,112000,112000
051591,玉晶光元大97購01,0,0,0,0,0,0,0,0,0,112000,0,0,0,112000,0,112000,112000
058184,鴻海永豐99購01  ,0,0,0,0,0,0,0,0,0,112000,0,0,0,112000,0,112000,112000
060103,聯詠元大99購01  ,0,0,0,0,0,0,0,0,0,111000,0,0,0,139000,28000,111000,111000
058841,深中小群益01購01,0,0,0,0,0,0,0,0,0,111000,0,0,0,1030000,919000,111000,111000
056945,鴻海統一98購12  ,0,0,0,0,0,0,0,0,0,111000,0,0,0,146000,35000,111000,111000
061021,聯電國泰9B購01  ,0,0,0,0,0,0,0,0,0,111000,0,0,0,141000,30000,111000,111000
062745,聯詠永豐9B購01  ,0,0,0,0,0,0,0,0,0,111000,0,0,0,111000,0,111000,111000
2383,台光電          ,950900,1206000,-255100,0,0,0,162000,1000,161000,205000,191000,16000,175000,43000,13000,30000,110900
07174P,臺股指國票99售11,0,0,0,0,0,0,0,0,0,110000,0,0,0,549000,439000,110000,110000
06867P,訊芯元大98售08  ,0,0,0,0,0,0,0,0,0,110000,0,0,0,160000,50000,110000,110000
06553P,訊芯元大98售05  ,0,0,0,0,0,0,0,0,0,110000,0,0,0,110000,0,110000,110000
051073,同欣電國票96購01,0,0,0,0,0,0,0,0,0,110000,0,0,0,110000,0,110000,110000
054158,國巨日盛99購01  ,0,0,0,0,0,0,0,0,0,110000,0,0,0,110000,0,110000,110000
05600P,玉晶光台新96售04,0,0,0,0,0,0,0,0,0,110000,0,0,0,110000,0,110000,110000
056146,台虹元大98購01  ,0,0,0,0,0,0,0,0,0,110000,0,0,0,110000,0,110000,110000
059176,臺股指凱基99購27,0,0,0,0,0,0,0,0,0,110000,0,0,0,159000,49000,110000,110000
055648,可成元富97購01  ,0,0,0,0,0,0,0,0,0,110000,0,0,0,110000,0,110000,110000
056569,T50正2元大9B購02,0,0,0,0,0,0,0,0,0,110000,0,0,0,110000,0,110000,110000
054937,國巨元大97購03  ,0,0,0,0,0,0,0,0,0,110000,0,0,0,110000,0,110000,110000
057092,健策元富98購01  ,0,0,0,0,0,0,0,0,0,110000,0,0,0,181000,71000,110000,110000
061628,緯穎群益9A購04  ,0,0,0,0,0,0,0,0,0,110000,0,0,0,110000,0,110000,110000
061387,鴻海群益9A購05  ,0,0,0,0,0,0,0,0,0,110000,0,0,0,388000,278000,110000,110000
4916,事欣科          ,146000,37000,109000,0,0,0,0,0,0,1000,1000,0,1000,0,0,0,110000
2420,新巨            ,88000,7000,81000,0,0,0,0,0,0,28000,28000,0,28000,0,0,0,109000
1339,昭輝            ,237000,154000,83000,0,0,0,0,0,0,26000,26000,0,26000,0,0,0,109000
1560,中砂            ,145000,28000,117000,0,0,0,0,10000,-10000,2000,2000,0,2000,0,0,0,109000
061597,南六永豐9A購04  ,0,0,0,0,0,0,0,0,0,109000,0,0,0,242000,133000,109000,109000
061125,億光永豐9A購01  ,0,0,0,0,0,0,0,0,0,109000,0,0,0,253000,144000,109000,109000
8463,潤泰材          ,121000,14000,107000,0,0,0,0,0,0,2000,2000,0,2000,0,0,0,109000
06926P,可成群益9A售04  ,0,0,0,0,0,0,0,0,0,108000,0,0,0,114000,6000,108000,108000
07255P,國巨凱基99售15  ,0,0,0,0,0,0,0,0,0,108000,0,0,0,125000,17000,108000,108000
063559,力山元大9B購04  ,0,20000,-20000,0,0,0,0,0,0,128000,0,0,0,397000,269000,128000,108000
060794,景碩永豐9A購02  ,0,0,0,0,0,0,0,0,0,108000,0,0,0,151000,43000,108000,108000
061309,鴻海統一9C購05  ,0,0,0,0,0,0,0,0,0,108000,0,0,0,188000,80000,108000,108000
061780,國巨群益9C購01  ,0,0,0,0,0,0,0,0,0,108000,0,0,0,111000,3000,108000,108000
062594,祥碩統一01購02  ,0,0,0,0,0,0,0,0,0,108000,0,0,0,247000,139000,108000,108000
062635,創意國票9B購01  ,0,0,0,0,0,0,0,0,0,108000,0,0,0,119000,11000,108000,108000
062922,南六元大9B購03  ,0,0,0,0,0,0,0,0,0,108000,0,0,0,285000,177000,108000,108000
062458,全新群益9B購03  ,0,0,0,0,0,0,0,0,0,108000,0,0,0,270000,162000,108000,108000
063516,香港反凱基03購01,0,0,0,0,0,0,0,0,0,107000,0,0,0,212000,105000,107000,107000
063340,英業達統一9B購01,0,0,0,0,0,0,0,0,0,107000,0,0,0,152000,45000,107000,107000
054166,日電貿凱基98購01,0,0,0,0,0,0,0,0,0,107000,0,0,0,164000,57000,107000,107000
055447,華新科統一97購04,0,0,0,0,0,0,0,0,0,107000,0,0,0,3140000,3033000,107000,107000
060467,神基元大9A購01  ,0,0,0,0,0,0,0,0,0,107000,0,0,0,278000,171000,107000,107000
062479,TPK國票9B購01   ,0,0,0,0,0,0,0,0,0,107000,0,0,0,160000,53000,107000,107000
4566,時碩工業        ,109000,4000,105000,0,0,0,0,0,0,2000,2000,0,2000,0,0,0,107000
055572,鴻海統一98購04  ,0,0,0,0,0,0,0,0,0,106000,0,0,0,114000,8000,106000,106000
05639P,欣興統一97售01  ,0,0,0,0,0,0,0,0,0,106000,0,0,0,106000,0,106000,106000
03650C,T50反1元大98牛05,0,0,0,0,0,0,0,0,0,106000,0,0,0,156000,50000,106000,106000
059205,元石油元大99購01,0,0,0,0,0,0,0,0,0,106000,0,0,0,106000,0,106000,106000
060381,元黃金凱基9A購01,0,0,0,0,0,0,0,0,0,106000,0,0,0,146000,40000,106000,106000
057376,新日興元大98購04,0,0,0,0,0,0,0,0,0,106000,0,0,0,206000,100000,106000,106000
058990,GIS凱基99購02   ,0,0,0,0,0,0,0,0,0,106000,0,0,0,109000,3000,106000,106000
062309,燿華凱基9B購01  ,0,0,0,0,0,0,0,0,0,106000,0,0,0,126000,20000,106000,106000
063154,南六元富9B購02  ,0,0,0,0,0,0,0,0,0,106000,0,0,0,523000,417000,106000,106000
5531,鄉林            ,255000,162000,93000,0,0,0,0,0,0,13000,13000,0,13000,0,0,0,106000
9944,新麗            ,260000,154000,106000,0,0,0,0,0,0,0,1000,1000,0,0,0,0,106000
07478P,南電康和9A售02  ,0,0,0,0,0,0,0,0,0,105000,0,0,0,119000,14000,105000,105000
055604,訊芯元大98購02  ,0,0,0,0,0,0,0,0,0,105000,0,0,0,173000,68000,105000,105000
04454P,大立光富邦98售02,0,0,0,0,0,0,0,0,0,105000,0,0,0,105000,0,105000,105000
055479,GIS凱基97購04   ,0,0,0,0,0,0,0,0,0,105000,0,0,0,105000,0,105000,105000
059862,全新群益99購04  ,0,0,0,0,0,0,0,0,0,105000,0,0,0,105000,0,105000,105000
06212P,華新科元大97售11,0,0,0,0,0,0,0,0,0,105000,0,0,0,105000,0,105000,105000
07748P,茂林凱基9A售04  ,0,0,0,0,0,0,0,0,0,104000,0,0,0,114000,10000,104000,104000
2731,雄獅            ,117000,13000,104000,0,0,0,0,0,0,0,0,0,0,0,0,0,104000
06582P,可成凱基98售06  ,0,0,0,0,0,0,0,0,0,104000,0,0,0,105000,1000,104000,104000
062368,聯詠元大9B購01  ,0,0,0,0,0,0,0,0,0,104000,0,0,0,111000,7000,104000,104000
062877,可成兆豐9C購01  ,0,0,0,0,0,0,0,0,0,104000,0,0,0,104000,0,104000,104000
062716,鴻海凱基9B購06  ,0,0,0,0,0,0,0,0,0,104000,0,0,0,137000,33000,104000,104000
061503,臻鼎國票9B購01  ,0,0,0,0,0,0,0,0,0,104000,0,0,0,110000,6000,104000,104000
2913,農林            ,146000,63000,83000,0,0,0,0,0,0,20000,20000,0,20000,0,0,0,103000
052622,貿聯兆豐97購01  ,0,0,0,0,0,0,0,0,0,103000,0,0,0,103000,0,103000,103000
051078,力山富邦97購01  ,0,0,0,0,0,0,0,0,0,103000,0,0,0,265000,162000,103000,103000
061908,台積電中信05購01,0,0,0,0,0,0,0,0,0,103000,0,0,0,124000,21000,103000,103000
062334,健策統一9B購02  ,0,0,0,0,0,0,0,0,0,103000,0,0,0,178000,75000,103000,103000
063849,奇鋐元大9C購01  ,0,0,0,0,0,0,0,0,0,102000,0,0,0,102000,0,102000,102000
047673,瑞昱元富96購01  ,0,0,0,0,0,0,0,0,0,102000,0,0,0,102000,0,102000,102000
055377,揚明光元大98購01,0,0,0,0,0,0,0,0,0,102000,0,0,0,202000,100000,102000,102000
059886,可成國票99購04  ,0,0,0,0,0,0,0,0,0,102000,0,0,0,203000,101000,102000,102000
059282,嘉聯益永豐99購01,0,0,0,0,0,0,0,0,0,102000,0,0,0,247000,145000,102000,102000
058901,美律元大99購07  ,0,0,0,0,0,0,0,0,0,102000,0,0,0,121000,19000,102000,102000
061996,矽格元大9B購01  ,0,0,0,0,0,0,0,0,0,102000,0,0,0,129000,27000,102000,102000
062872,華通兆豐9C購01  ,0,0,0,0,0,0,0,0,0,102000,0,0,0,422000,320000,102000,102000
060735,鴻海統一9C購03  ,0,0,0,0,0,0,0,0,0,102000,0,0,0,102000,0,102000,102000
3059,華晶科          ,118000,18000,100000,0,0,0,0,0,0,2000,2000,0,2000,0,0,0,102000
1473,台南            ,110000,10000,100000,0,0,0,0,0,0,1000,1000,0,1000,0,0,0,101000
1783,和康生          ,113000,13000,100000,0,0,0,0,0,0,1000,1000,0,1000,0,0,0,101000
1449,佳和            ,161000,60000,101000,0,0,0,0,0,0,0,0,0,0,0,0,0,101000
060785,國巨富邦9B購04  ,0,0,0,0,0,0,0,0,0,101000,0,0,0,259000,158000,101000,101000
060774,南亞科凱基9A購01,0,0,0,0,0,0,0,0,0,101000,0,0,0,121000,20000,101000,101000
062235,億光凱基9B購01  ,0,0,0,0,0,0,0,0,0,101000,0,0,0,179000,78000,101000,101000
07740P,臺股指永豐9A售01,0,0,0,0,0,0,0,0,0,100000,0,0,0,100000,0,100000,100000
07420P,可成元大99售07  ,0,0,0,0,0,0,0,0,0,100000,0,0,0,120000,20000,100000,100000
07791P,奇鋐元大9A售02  ,0,0,0,0,0,0,0,0,0,100000,0,0,0,100000,0,100000,100000
08047P,臺股指國票9B售12,0,0,0,0,0,0,0,0,0,100000,0,0,0,100000,0,100000,100000
06356P,啟碁永豐97售01  ,0,0,0,0,0,0,0,0,0,100000,0,0,0,125000,25000,100000,100000
06535P,可成群益99售02  ,0,0,0,0,0,0,0,0,0,100000,0,0,0,117000,17000,100000,100000
07241P,台灣50國票9A售05,0,0,0,0,0,0,0,0,0,100000,0,0,0,130000,30000,100000,100000
07080P,健策群益9A售01  ,0,0,0,0,0,0,0,0,0,100000,0,0,0,100000,0,100000,100000
07070P,晶相光元富99售01,0,0,0,0,0,0,0,0,0,100000,0,0,0,100000,0,100000,100000
06973P,臺股指元大9A售11,0,0,0,0,0,0,0,0,0,100000,0,0,0,100000,0,100000,100000
06900P,FBVIX國票12售01 ,0,0,0,0,0,0,0,0,0,100000,0,0,0,100000,0,100000,100000
056312,茂林元大98購01  ,0,0,0,0,0,0,0,0,0,100000,0,0,0,100000,0,100000,100000
052806,玉晶光元大98購04,0,0,0,0,0,0,0,0,0,100000,0,0,0,109000,9000,100000,100000
053486,T50反1兆豐96購01,0,0,0,0,0,0,0,0,0,100000,0,0,0,100000,0,100000,100000
048188,臺指反元大96購05,0,0,0,0,0,0,0,0,0,100000,0,0,0,100000,0,100000,100000
049437,可成國泰96購01  ,0,0,0,0,0,0,0,0,0,100000,0,0,0,100000,0,100000,100000
051902,T50反1元大97購01,0,0,0,0,0,0,0,0,0,100000,0,0,0,130000,30000,100000,100000
052006,康友富邦98購01  ,0,0,0,0,0,0,0,0,0,100000,0,0,0,100000,0,100000,100000
054012,廣達永豐96購01  ,0,0,0,0,0,0,0,0,0,100000,0,0,0,100000,0,100000,100000
054966,貿聯元大98購02  ,0,0,0,0,0,0,0,0,0,100000,0,0,0,100000,0,100000,100000
054683,川湖永豐97購01  ,0,0,0,0,0,0,0,0,0,100000,0,0,0,100000,0,100000,100000
055848,大立光元大97購11,0,0,0,0,0,0,0,0,0,100000,0,0,0,100000,0,100000,100000
055945,上証2X元大97購04,0,0,0,0,0,0,0,0,0,100000,0,0,0,100000,0,100000,100000
057943,可成國票99購03  ,0,0,0,0,0,0,0,0,0,100000,0,0,0,100000,0,100000,100000
059401,牧德元富99購01  ,0,0,0,0,0,0,0,0,0,100000,0,0,0,100000,0,100000,100000
058970,鴻海永豐99購02  ,0,0,0,0,0,0,0,0,0,100000,0,0,0,551000,451000,100000,100000
059814,SP黃豆凱基9A購02,0,0,0,0,0,0,0,0,0,100000,0,0,0,140000,40000,100000,100000
056803,群創台新99購02  ,0,0,0,0,0,0,0,0,0,100000,0,0,0,100000,0,100000,100000
05813P,臺股指國票96售06,0,0,0,0,0,0,0,0,0,100000,0,0,0,100000,0,100000,100000
062634,玉晶光國票9B購03,0,0,0,0,0,0,0,0,0,100000,0,0,0,139000,39000,100000,100000
063120,台光電元大9C購01,0,0,0,0,0,0,0,0,0,100000,0,0,0,126000,26000,100000,100000
063191,台表科凱基9B購03,0,0,0,0,0,0,0,0,0,100000,0,0,0,110000,10000,100000,100000
062928,富邦金台新9B購02,0,0,0,0,0,0,0,0,0,100000,0,0,0,124000,24000,100000,100000
061082,台光電兆豐9A購01,0,0,0,0,0,0,0,0,0,100000,0,0,0,100000,0,100000,100000
061654,旺宏國票9A購02  ,0,0,0,0,0,0,0,0,0,100000,0,0,0,100000,0,100000,100000
06167P,欣興國票97售05  ,0,0,0,0,0,0,0,0,0,100000,0,0,0,100000,0,100000,100000
061702,奇鋐國票9A購02  ,0,0,0,0,0,0,0,0,0,100000,0,0,0,130000,30000,100000,100000
061745,南電凱基9B購02  ,0,0,0,0,0,0,0,0,0,100000,0,0,0,100000,0,100000,100000
061372,世紀鋼國泰9C購01,0,0,0,0,0,0,0,0,0,100000,0,0,0,777000,677000,100000,100000
06140P,華新科群益97售06,0,0,0,0,0,0,0,0,0,100000,0,0,0,100000,0,100000,100000
07576P,可成元大9A售01  ,0,0,0,0,0,0,0,0,0,99000,0,0,0,100000,1000,99000,99000
08277P,嘉晶元富9C售02  ,0,0,0,0,0,0,0,0,0,99000,0,0,0,109000,10000,99000,99000
054673,京鼎國泰98購01  ,0,0,0,0,0,0,0,0,0,99000,0,0,0,99000,0,99000,99000
054751,GIS凱基98購01   ,0,0,0,0,0,0,0,0,0,99000,0,0,0,99000,0,99000,99000
048422,瑞昱元富96購02  ,0,0,0,0,0,0,0,0,0,99000,0,0,0,100000,1000,99000,99000
056353,鴻海元大99購02  ,0,0,0,0,0,0,0,0,0,99000,0,0,0,100000,1000,99000,99000
057284,新日興元大98購03,0,0,0,0,0,0,0,0,0,99000,0,0,0,128000,29000,99000,99000
061273,臺股指凱基9A購23,0,0,0,0,0,0,0,0,0,99000,0,0,0,101000,2000,99000,99000
063088,緯穎凱基9B購04  ,0,0,0,0,0,0,0,0,0,99000,0,0,0,124000,25000,99000,99000
9939,宏全            ,165000,134000,31000,0,0,0,0,0,0,68000,63000,0,63000,5000,0,5000,99000
1906,寶隆            ,141000,44000,97000,0,0,0,0,0,0,1000,1000,0,1000,0,0,0,98000
058774,台郡兆豐9A購01  ,0,0,0,0,0,0,0,0,0,98000,0,0,0,231000,133000,98000,98000
057100,國巨中信9A購02  ,0,0,0,0,0,0,0,0,0,98000,0,0,0,100000,2000,98000,98000
062238,臻鼎凱基9C購01  ,0,0,0,0,0,0,0,0,0,98000,0,0,0,100000,2000,98000,98000
062269,葡萄王群益9B購01,0,0,0,0,0,0,0,0,0,98000,0,0,0,98000,0,98000,98000
062281,奇鋐群益9B購01  ,0,0,0,0,0,0,0,0,0,98000,0,0,0,109000,11000,98000,98000
061733,聯發科中信01購01,0,0,0,0,0,0,0,0,0,98000,0,0,0,98000,0,98000,98000
061133,玉晶光第一9A購01,0,0,0,0,0,0,0,0,0,98000,0,0,0,354000,256000,98000,98000
061245,晶技群益9A購01  ,0,0,0,0,0,0,0,0,0,98000,0,0,0,98000,0,98000,98000
060659,鴻海凱基9B購03  ,0,0,0,0,0,0,0,0,0,98000,0,0,0,111000,13000,98000,98000
060489,世紀鋼群益9A購01,0,0,0,0,0,0,0,0,0,98000,0,0,0,98000,0,98000,98000
08003P,國巨國泰9B售07  ,0,0,0,0,0,0,0,0,0,97000,0,0,0,98000,1000,97000,97000
063614,美食群益9B購03  ,0,0,0,0,0,0,0,0,0,97000,0,0,0,115000,18000,97000,97000
060258,T50反1凱基9A購06,0,0,0,0,0,0,0,0,0,97000,0,0,0,217000,120000,97000,97000
057442,玉晶光統一98購03,0,0,0,0,0,0,0,0,0,97000,0,0,0,347000,250000,97000,97000
061289,玉晶光統一01購03,0,0,0,0,0,0,0,0,0,97000,0,0,0,440000,343000,97000,97000
3454,晶睿            ,90000,9000,81000,0,0,0,0,0,0,16000,16000,0,16000,0,0,0,97000
08852P,台灣50台新01售01,0,0,0,0,0,0,0,0,0,96000,0,0,0,452000,356000,96000,96000
052152,創意富邦98購01  ,0,0,0,0,0,0,0,0,0,96000,0,0,0,100000,4000,96000,96000
055324,TPK國票98購03   ,0,0,0,0,0,0,0,0,0,96000,0,0,0,96000,0,96000,96000
055748,GIS元富97購01   ,0,0,0,0,0,0,0,0,0,96000,0,0,0,96000,0,96000,96000
058387,國巨國票9A購03  ,0,0,0,0,0,0,0,0,0,96000,0,0,0,104000,8000,96000,96000
059949,啟碁永豐99購01  ,0,0,0,0,0,0,0,0,0,96000,0,0,0,102000,6000,96000,96000
058931,玉晶光統一9C購01,0,0,0,0,0,0,0,0,0,96000,0,0,0,372000,276000,96000,96000
057947,和碩國票99購01  ,0,0,0,0,0,0,0,0,0,96000,0,0,0,136000,40000,96000,96000
08178P,南亞科元大9B售01,0,0,0,0,0,0,0,0,0,95000,0,0,0,132000,37000,95000,95000
055331,國巨兆豐99購01  ,0,0,0,0,0,0,0,0,0,95000,0,0,0,333000,238000,95000,95000
00668,國泰美國道瓊    ,0,4000,-4000,0,0,0,0,0,0,99000,0,0,0,265000,166000,99000,95000
053355,超眾兆豐97購01  ,0,0,0,0,0,0,0,0,0,95000,0,0,0,95000,0,95000,95000
056939,康控元富98購01  ,0,0,0,0,0,0,0,0,0,95000,0,0,0,215000,120000,95000,95000
057511,健策統一98購02  ,0,0,0,0,0,0,0,0,0,95000,0,0,0,110000,15000,95000,95000
061348,聯鈞元大9A購05  ,0,0,0,0,0,0,0,0,0,95000,0,0,0,95000,0,95000,95000
060768,鴻海麥證9A購02  ,0,0,0,125000,30000,95000,0,0,0,95000,0,0,0,125000,30000,95000,95000
060868,致伸永豐9A購01  ,0,0,0,0,0,0,0,0,0,95000,0,0,0,292000,197000,95000,95000
062459,聯詠群益9B購01  ,0,0,0,0,0,0,0,0,0,95000,0,0,0,111000,16000,95000,95000
063094,玉晶光國票01購03,0,0,0,0,0,0,0,0,0,95000,0,0,0,136000,41000,95000,95000
062834,立積群益9B購02  ,0,0,0,0,0,0,0,0,0,95000,0,0,0,251000,156000,95000,95000
07317P,T50正2凱基9B售02,0,0,0,0,0,0,0,0,0,94000,0,0,0,94000,0,94000,94000
1786,科妍            ,99000,4000,95000,0,0,0,0,0,0,-1000,0,1000,-1000,0,0,0,94000
2851,中再保          ,108000,19000,89000,0,0,0,0,0,0,5000,5000,0,5000,0,0,0,94000
2545,皇翔            ,96000,6000,90000,0,0,0,0,0,0,4000,4000,0,4000,0,0,0,94000
063454,瑞儀統一9B購01  ,0,0,0,0,0,0,0,0,0,94000,0,0,0,308000,214000,94000,94000
056021,興富發群益97購01,0,0,0,0,0,0,0,0,0,94000,0,0,0,232000,138000,94000,94000
058192,訊芯永豐99購01  ,0,0,0,0,0,0,0,0,0,94000,0,0,0,94000,0,94000,94000
062389,台表科國泰01購01,0,0,0,0,0,0,0,0,0,94000,0,0,0,94000,0,94000,94000
4935,茂林-KY         ,502000,348000,154000,0,0,0,174000,307000,-133000,73000,14000,52000,-38000,114000,3000,111000,94000
063758,聯發科統一9B購14,0,0,0,0,0,0,0,0,0,93000,0,0,0,127000,34000,93000,93000
06891P,緯穎富邦99售03  ,0,0,0,0,0,0,0,0,0,93000,0,0,0,103000,10000,93000,93000
08232P,聯發科元富9B售06,0,0,0,0,0,0,0,0,0,93000,0,0,0,95000,2000,93000,93000
056480,京鼎元大98購02  ,0,0,0,0,0,0,0,0,0,93000,0,0,0,142000,49000,93000,93000
052561,矽創國票97購01  ,0,0,0,0,0,0,0,0,0,93000,0,0,0,93000,0,93000,93000
043442,大立光台新01購01,0,0,0,0,0,0,0,0,0,93000,0,0,0,176000,83000,93000,93000
057778,大立光群益98購02,0,0,0,0,0,0,0,0,0,93000,0,0,0,96000,3000,93000,93000
057189,康控元大98購02  ,0,0,0,0,0,0,0,0,0,93000,0,0,0,121000,28000,93000,93000
062987,祥碩中信01購01  ,0,0,0,0,0,0,0,0,0,93000,0,0,0,153000,60000,93000,93000
061491,嘉聯益兆豐9B購01,0,0,0,0,0,0,0,0,0,93000,0,0,0,607000,514000,93000,93000
061726,台積電麥證9A購05,0,0,0,93000,0,93000,0,0,0,93000,0,0,0,93000,0,93000,93000
1733,五鼎            ,104000,11000,93000,0,0,0,0,0,0,-1000,0,1000,-1000,0,0,0,92000
063500,嘉晶永豐9B購02  ,0,0,0,0,0,0,0,0,0,92000,0,0,0,144000,52000,92000,92000
063314,美律群益9B購01  ,0,0,0,0,0,0,0,0,0,92000,0,0,0,116000,24000,92000,92000
059771,台積電群益99購11,0,0,0,0,0,0,0,0,0,92000,0,0,0,114000,22000,92000,92000
06010P,國泰金元富96售01,0,0,0,0,0,0,0,0,0,92000,0,0,0,111000,19000,92000,92000
06046P,健策統一96售03  ,0,0,0,0,0,0,0,0,0,92000,0,0,0,152000,60000,92000,92000
061092,可成統一9C購02  ,0,0,0,0,0,0,0,0,0,92000,0,0,0,97000,5000,92000,92000
060798,旭富永豐9A購01  ,0,0,0,0,0,0,0,0,0,92000,0,0,0,100000,8000,92000,92000
3209,全科            ,118000,28000,90000,0,0,0,0,0,0,2000,2000,0,2000,0,0,0,92000
063507,奇鋐群益9B購02  ,0,0,0,0,0,0,0,0,0,91000,0,0,0,91000,0,91000,91000
06949P,台表科元大99售01,0,0,0,0,0,0,0,0,0,91000,0,0,0,91000,0,91000,91000
07777P,創意元大9A售03  ,0,0,0,0,0,0,0,0,0,91000,0,0,0,91000,0,91000,91000
048192,華通元大96購01  ,0,0,0,0,0,0,0,0,0,91000,0,0,0,92000,1000,91000,91000
047421,聯茂富邦97購01  ,0,0,0,0,0,0,0,0,0,91000,0,0,0,91000,0,91000,91000
059101,康控統一9A購01  ,0,0,0,0,0,0,0,0,0,91000,0,0,0,417000,326000,91000,91000
057805,華通元大98購06  ,0,0,0,0,0,0,0,0,0,91000,0,0,0,97000,6000,91000,91000
057589,超眾國票9A購01  ,0,0,0,0,0,0,0,0,0,91000,0,0,0,91000,0,91000,91000
058761,欣興群益99購02  ,0,0,0,0,0,0,0,0,0,91000,0,0,0,96000,5000,91000,91000
059647,超眾凱基99購04  ,0,0,0,0,0,0,0,0,0,91000,0,0,0,91000,0,91000,91000
057377,康控元大99購02  ,0,0,0,0,0,0,0,0,0,91000,0,0,0,272000,181000,91000,91000
062854,日電貿永豐9B購01,0,0,0,0,0,0,0,0,0,91000,0,0,0,264000,173000,91000,91000
062410,台積電第一9B購02,0,0,0,0,0,0,0,0,0,91000,0,0,0,145000,54000,91000,91000
07605P,台灣50元大9B售10,0,0,0,0,0,0,0,0,0,90000,0,0,0,90000,0,90000,90000
06887P,華新科元大98售04,0,0,0,0,0,0,0,0,0,90000,0,0,0,90000,0,90000,90000
07180P,臺股指凱基99售22,0,0,0,0,0,0,0,0,0,90000,0,0,0,90000,0,90000,90000
054854,台積電麥證97購01,0,0,0,90000,0,90000,0,0,0,90000,0,0,0,90000,0,90000,90000
045836,群創群益98購01  ,0,0,0,0,0,0,0,0,0,90000,0,0,0,90000,0,90000,90000
057278,可成元大98購06  ,0,0,0,0,0,0,0,0,0,90000,0,0,0,132000,42000,90000,90000
058790,楠梓電元大99購03,0,0,0,0,0,0,0,0,0,90000,0,0,0,148000,58000,90000,90000
058663,瑞儀兆豐9A購01  ,0,0,0,0,0,0,0,0,0,90000,0,0,0,90000,0,90000,90000
06042P,華新科永豐96售04,0,0,0,0,0,0,0,0,0,90000,0,0,0,150000,60000,90000,90000
060237,友達元大9A購06  ,0,0,0,0,0,0,0,0,0,90000,0,0,0,125000,35000,90000,90000
06023P,超眾國票96售03  ,0,0,0,0,0,0,0,0,0,90000,0,0,0,140000,50000,90000,90000
062145,億光國票9B購01  ,0,0,0,0,0,0,0,0,0,90000,0,0,0,103000,13000,90000,90000
06054P,臺股指中信9A售01,0,0,0,0,0,0,0,0,0,90000,0,0,0,90000,0,90000,90000
06123P,玉晶光元大97售04,0,0,0,0,0,0,0,0,0,90000,0,0,0,90000,0,90000,90000
5215,科嘉-KY         ,484000,322000,162000,0,0,0,0,73000,-73000,1000,1000,0,1000,0,0,0,90000
07184P,台灣50元富01售01,0,0,0,0,0,0,0,0,0,89000,0,0,0,89000,0,89000,89000
063422,奇鋐凱基9B購04  ,0,0,0,0,0,0,0,0,0,89000,0,0,0,141000,52000,89000,89000
08034P,台積電兆豐9B售02,0,0,0,0,0,0,0,0,0,89000,0,0,0,89000,0,89000,89000
08065P,瑞昱凱基9B售03  ,0,0,0,0,0,0,0,0,0,89000,0,0,0,111000,22000,89000,89000
052939,富邦金兆豐96購01,0,0,0,0,0,0,0,0,0,89000,0,0,0,89000,0,89000,89000
056545,TPK凱基98購02   ,0,0,0,0,0,0,0,0,0,89000,0,0,0,226000,137000,89000,89000
058834,GIS永豐99購01   ,0,0,0,0,0,0,0,0,0,89000,0,0,0,99000,10000,89000,89000
060585,玉晶光元富9A購02,0,0,0,0,0,0,0,0,0,89000,0,0,0,184000,95000,89000,89000
061626,超眾群益9A購02  ,0,0,0,0,0,0,0,0,0,89000,0,0,0,262000,173000,89000,89000
061906,統一中信9B購01  ,12000,0,12000,0,0,0,0,0,0,77000,0,0,0,100000,23000,77000,89000
061334,華通元大9A購09  ,0,0,0,0,0,0,0,0,0,89000,0,0,0,89000,0,89000,89000
4190,佐登-KY         ,70000,11000,59000,0,0,0,0,0,0,30000,27000,2000,25000,5000,0,5000,89000
063372,漢翔永豐9B購01  ,0,0,0,0,0,0,0,0,0,88000,0,0,0,88000,0,88000,88000
06371P,茂林國票98售04  ,0,0,0,0,0,0,0,0,0,88000,0,0,0,235000,147000,88000,88000
07234P,台灣50元大9B售04,0,0,0,0,0,0,0,0,0,88000,0,0,0,88000,0,88000,88000
06525P,上証2X國泰99售01,0,0,0,0,0,0,0,0,0,88000,0,0,0,140000,52000,88000,88000
06411P,晶相光永豐97售03,0,0,0,0,0,0,0,0,0,88000,0,0,0,105000,17000,88000,88000
054572,國巨元大98購03  ,0,0,0,0,0,0,0,0,0,88000,0,0,0,88000,0,88000,88000
059065,南電凱基9A購01  ,0,0,0,0,0,0,0,0,0,88000,0,0,0,109000,21000,88000,88000
059524,FBVIX凱基9A購02 ,0,0,0,0,0,0,0,0,0,88000,0,0,0,90000,2000,88000,88000
056269,新日興統一98購01,0,0,0,0,0,0,0,0,0,88000,0,0,0,248000,160000,88000,88000
052234,GIS凱基97購01   ,0,0,0,0,0,0,0,0,0,88000,0,0,0,88000,0,88000,88000
056401,國巨群益98購07  ,0,0,0,0,0,0,0,0,0,88000,0,0,0,88000,0,88000,88000
042752,台灣50元大96購03,0,0,0,0,0,0,0,0,0,88000,0,0,0,98000,10000,88000,88000
054130,漢唐元大97購02  ,0,0,0,0,0,0,0,0,0,88000,0,0,0,88000,0,88000,88000
057044,旺宏元大98購08  ,0,0,0,0,0,0,0,0,0,88000,0,0,0,88000,0,88000,88000
061375,華通永豐9A購02  ,0,0,0,0,0,0,0,0,0,88000,0,0,0,88000,0,88000,88000
062991,台光電群益9B購03,0,0,0,0,0,0,0,0,0,88000,0,0,0,321000,233000,88000,88000
3035,智原            ,477000,562000,-85000,0,0,0,0,0,0,173000,51000,6000,45000,158000,30000,128000,88000
07482P,南亞科元富9A售04,0,0,0,0,0,0,0,0,0,87000,0,0,0,310000,223000,87000,87000
1789,神隆            ,690000,623000,67000,0,0,0,0,0,0,20000,10000,0,10000,15000,5000,10000,87000
053947,義隆富邦97購01  ,0,0,0,0,0,0,0,0,0,87000,0,0,0,147000,60000,87000,87000
053341,聯發科國票97購03,0,0,0,0,0,0,0,0,0,87000,0,0,0,87000,0,87000,87000
058004,大立光群益98購03,0,0,0,0,0,0,0,0,0,87000,0,0,0,98000,11000,87000,87000
060341,國巨統一9C購02  ,0,0,0,0,0,0,0,0,0,87000,0,0,0,99000,12000,87000,87000
058353,國巨凱基99購09  ,0,0,0,0,0,0,0,0,0,87000,0,0,0,97000,10000,87000,87000
057658,玉晶光兆豐99購02,0,0,0,0,0,0,0,0,0,87000,0,0,0,450000,363000,87000,87000
056419,欣興元富98購02  ,0,0,0,0,0,0,0,0,0,86000,0,0,0,118000,32000,86000,86000
054421,臺股指元大99購03,0,0,0,0,0,0,0,0,0,86000,0,0,0,86000,0,86000,86000
057595,健鼎兆豐98購01  ,0,0,0,0,0,0,0,0,0,86000,0,0,0,714000,628000,86000,86000
062947,國巨富邦01購01  ,0,0,0,0,0,0,0,0,0,86000,0,0,0,91000,5000,86000,86000
062486,瑞昱富邦9B購01  ,0,0,0,0,0,0,0,0,0,86000,0,0,0,248000,162000,86000,86000
061287,大立光統一9B購06,0,0,0,0,0,0,0,0,0,86000,0,0,0,137000,51000,86000,86000
4155,訊映            ,104000,18000,86000,0,0,0,0,0,0,0,0,0,0,0,0,0,86000
2034,允強            ,145000,68000,77000,0,0,0,0,0,0,8000,8000,0,8000,0,0,0,85000
08197P,聯發科元大9B售24,0,0,0,0,0,0,0,0,0,85000,0,0,0,85000,0,85000,85000
2535,達欣工          ,108000,98000,10000,0,0,0,0,0,0,75000,75000,0,75000,0,0,0,85000
2850,新產            ,117000,33000,84000,0,0,0,0,0,0,1000,1000,0,1000,0,0,0,85000
08053P,臺股指國票9B售18,0,0,0,0,0,0,0,0,0,85000,0,0,0,165000,80000,85000,85000
06752P,訊芯凱基98售05  ,0,0,0,0,0,0,0,0,0,85000,0,0,0,85000,0,85000,85000
063765,上銀元富9B購09  ,0,0,0,0,0,0,0,0,0,85000,0,0,0,85000,0,85000,85000
056604,鴻海富邦9A購01  ,0,0,0,0,0,0,0,0,0,85000,0,0,0,85000,0,85000,85000
053438,玉晶光麥證97購02,0,0,0,85000,0,85000,0,0,0,85000,0,0,0,85000,0,85000,85000
04273P,上証反凱基99售01,0,0,0,0,0,0,0,0,0,85000,0,0,0,85000,0,85000,85000
057463,華邦電永豐98購01,0,0,0,0,0,0,0,0,0,85000,0,0,0,85000,0,85000,85000
057944,新日興國票99購02,0,0,0,0,0,0,0,0,0,85000,0,0,0,193000,108000,85000,85000
061361,世紀鋼兆豐9A購01,0,0,0,0,0,0,0,0,0,85000,0,0,0,85000,0,85000,85000
062465,臺指反凱基01購01,0,0,0,0,0,0,0,0,0,85000,0,0,0,85000,0,85000,85000
06230P,亞德客永豐97售03,0,0,0,0,0,0,0,0,0,85000,0,0,0,85000,0,85000,85000
062188,貿聯元大9B購02  ,0,0,0,0,0,0,0,0,0,85000,0,0,0,278000,193000,85000,85000
063014,技嘉元大9B購03  ,0,0,0,0,0,0,0,0,0,85000,0,0,0,121000,36000,85000,85000
062649,緯穎富邦9B購03  ,0,0,0,0,0,0,0,0,0,85000,0,0,0,163000,78000,85000,85000
3607,谷崧            ,84000,2000,82000,0,0,0,0,0,0,3000,3000,0,3000,0,0,0,85000
063384,巨大永豐9B購04  ,0,0,0,0,0,0,0,0,0,84000,0,0,0,217000,133000,84000,84000
07917P,可成永豐9B售01  ,0,0,0,0,0,0,0,0,0,84000,0,0,0,166000,82000,84000,84000
2538,基泰            ,83000,4000,79000,0,0,0,0,0,0,5000,5000,0,5000,0,0,0,84000
2617,台航            ,124000,46000,78000,0,0,0,0,0,0,6000,7000,1000,6000,0,0,0,84000
2451,創見            ,296000,146000,150000,0,0,0,70000,0,70000,-136000,80000,6000,74000,0,210000,-210000,84000
053630,奇鋐兆豐97購01  ,0,0,0,0,0,0,0,0,0,84000,0,0,0,84000,0,84000,84000
056255,華新科元富97購05,0,0,0,0,0,0,0,0,0,84000,0,0,0,86000,2000,84000,84000
059239,台積電凱基99購12,0,0,0,0,0,0,0,0,0,84000,0,0,0,385000,301000,84000,84000
058929,可成統一9C購01  ,0,0,0,0,0,0,0,0,0,84000,0,0,0,85000,1000,84000,84000
058942,南茂中信99購01  ,0,0,0,0,0,0,0,0,0,84000,0,0,0,160000,76000,84000,84000
058108,台郡台新99購01  ,0,0,0,0,0,0,0,0,0,84000,0,0,0,165000,81000,84000,84000
060306,台肥永豐9A購01  ,0,0,0,0,0,0,0,0,0,84000,0,0,0,89000,5000,84000,84000
057819,新日興元大99購01,0,0,0,0,0,0,0,0,0,84000,0,0,0,113000,29000,84000,84000
058390,樺漢國票9A購01  ,0,0,0,0,0,0,0,0,0,84000,0,0,0,123000,39000,84000,84000
061206,旺宏元大9A購12  ,0,0,0,0,0,0,0,0,0,84000,0,0,0,84000,0,84000,84000
061118,GIS富邦9A購01   ,0,0,0,0,0,0,0,0,0,84000,0,0,0,84000,0,84000,84000
1410,南染            ,84000,0,84000,0,0,0,0,0,0,-1000,0,1000,-1000,0,0,0,83000
08104P,晶技元大9B售06  ,0,0,0,0,0,0,0,0,0,83000,0,0,0,133000,50000,83000,83000
063618,智邦兆豐9C購01  ,0,0,0,0,0,0,0,0,0,83000,0,0,0,85000,2000,83000,83000
06847P,奇力新元大98售05,0,0,0,0,0,0,0,0,0,83000,0,0,0,88000,5000,83000,83000
06946P,T50正2元大9C售01,0,0,0,0,0,0,0,0,0,83000,0,0,0,103000,20000,83000,83000
059084,鴻海元大99購24  ,0,0,0,0,0,0,0,0,0,83000,0,0,0,222000,139000,83000,83000
053055,聯詠國票97購01  ,0,0,0,0,0,0,0,0,0,83000,0,0,0,103000,20000,83000,83000
06038P,國泰金台新96售01,0,0,0,0,0,0,0,0,0,83000,0,0,0,83000,0,83000,83000
05880P,創意康和96售01  ,0,0,0,0,0,0,0,0,0,83000,0,0,0,93000,10000,83000,83000
062152,國巨麥證9C購01  ,0,0,0,83000,0,83000,0,0,0,83000,0,0,0,83000,0,83000,83000
3321,同泰            ,83000,0,83000,0,0,0,0,0,0,0,0,0,0,0,0,0,83000
3024,憶聲            ,97000,14000,83000,0,0,0,0,0,0,0,0,0,0,0,0,0,83000
4540,全球傳動        ,132000,51000,81000,0,0,0,0,0,0,2000,2000,0,2000,0,0,0,83000
08158P,嘉澤元富9B售03  ,0,0,0,0,0,0,0,0,0,82000,0,0,0,97000,15000,82000,82000
07667P,亞德客元大9A售05,0,0,0,0,0,0,0,0,0,82000,0,0,0,124000,42000,82000,82000
08200P,祥碩元大9B售08  ,0,0,0,0,0,0,0,0,0,82000,0,0,0,82000,0,82000,82000
00690,兆豐藍籌30      ,1000,0,1000,0,0,0,0,0,0,81000,0,0,0,267000,186000,81000,82000
059210,鴻海元大99購26  ,0,0,0,0,0,0,0,0,0,82000,0,0,0,113000,31000,82000,82000
058079,鴻海群益98購08  ,0,0,0,0,0,0,0,0,0,82000,0,0,0,89000,7000,82000,82000
057388,奇鋐永豐98購02  ,0,0,0,0,0,0,0,0,0,82000,0,0,0,92000,10000,82000,82000
3583,辛耘            ,89000,7000,82000,0,0,0,0,0,0,0,0,0,0,0,0,0,82000
1476,儒鴻            ,522231,420515,101716,0,0,0,33000,123000,-90000,70000,95000,12000,83000,10000,23000,-13000,81716
07208P,台積電凱基99售14,0,0,0,0,0,0,0,0,0,81000,0,0,0,162000,81000,81000,81000
06386P,欣興永豐97售03  ,0,0,0,0,0,0,0,0,0,81000,0,0,0,91000,10000,81000,81000
00701,國泰股利精選30  ,1000,1000,0,0,0,0,0,0,0,81000,0,0,0,431000,350000,81000,81000
03678C,臺股指凱基01牛02,0,0,0,0,0,0,0,0,0,81000,0,0,0,93000,12000,81000,81000
055561,奇鋐凱基97購01  ,0,0,0,0,0,0,0,0,0,81000,0,0,0,133000,52000,81000,81000
057268,臻鼎兆豐99購01  ,0,0,0,0,0,0,0,0,0,81000,0,0,0,90000,9000,81000,81000
062396,華通永豐9B購01  ,0,0,0,0,0,0,0,0,0,81000,0,0,0,114000,33000,81000,81000
062767,GIS凱基9B購02   ,0,0,0,0,0,0,0,0,0,81000,0,0,0,83000,2000,81000,81000
061197,矽創永豐9A購02  ,0,0,0,0,0,0,0,0,0,81000,0,0,0,225000,144000,81000,81000
060614,T50反1元大9A購06,0,0,0,0,0,0,0,0,0,81000,0,0,0,81000,0,81000,81000
060722,矽格永豐9A購01  ,0,0,0,0,0,0,0,0,0,81000,0,0,0,149000,68000,81000,81000
061803,巨大永豐9B購01  ,0,0,0,0,0,0,0,0,0,81000,0,0,0,176000,95000,81000,81000
6108,競國            ,97000,46000,51000,0,0,0,0,0,0,30000,30000,0,30000,0,0,0,81000
06593P,欣興元大98售05  ,0,0,0,0,0,0,0,0,0,80000,0,0,0,105000,25000,80000,80000
07434P,臺股指國票9A售06,0,0,0,0,0,0,0,0,0,80000,0,0,0,92000,12000,80000,80000
055532,中工群益98購01  ,0,0,0,0,0,0,0,0,0,80000,0,0,0,100000,20000,80000,80000
054263,聯茂元大96購02  ,0,0,0,0,0,0,0,0,0,80000,0,0,0,80000,0,80000,80000
054178,中磊台新97購01  ,0,0,0,0,0,0,0,0,0,80000,0,0,0,80000,0,80000,80000
052624,微星亞東97購01  ,0,0,0,0,0,0,0,0,0,80000,0,0,0,80000,0,80000,80000
054112,台積電麥證96購02,0,0,0,320000,0,320000,0,0,0,80000,0,0,0,320000,240000,80000,80000
059476,道瓊指群益9C購01,0,0,0,0,0,0,0,0,0,80000,0,0,0,100000,20000,80000,80000
054511,香港反元大98購01,0,0,0,0,0,0,0,0,0,80000,0,0,0,80000,0,80000,80000
055735,宏達電元富98購01,0,0,0,0,0,0,0,0,0,80000,0,0,0,80000,0,80000,80000
055182,京鼎統一98購01  ,0,0,0,0,0,0,0,0,0,80000,0,0,0,80000,0,80000,80000
057328,京鼎群益99購02  ,0,0,0,0,0,0,0,0,0,80000,0,0,0,146000,66000,80000,80000
057685,台灣50凱基9C購01,0,0,0,0,0,0,0,0,0,80000,0,0,0,80000,0,80000,80000
060800,華新科第一9A購01,0,0,0,0,0,0,0,0,0,80000,0,0,0,80000,0,80000,80000
060641,聯鈞永豐9A購01  ,0,0,0,0,0,0,0,0,0,80000,0,0,0,80000,0,80000,80000
062869,帆宣中信9B購01  ,0,0,0,0,0,0,0,0,0,80000,0,0,0,80000,0,80000,80000
062636,聯鈞國票9B購01  ,0,0,0,0,0,0,0,0,0,80000,0,0,0,80000,0,80000,80000
062358,國巨元大9B購12  ,0,0,0,0,0,0,0,0,0,80000,0,0,0,80000,0,80000,80000
062307,華通凱基9C購01  ,0,0,0,0,0,0,0,0,0,80000,0,0,0,80000,0,80000,80000
062100,矽格永豐9B購01  ,0,0,0,0,0,0,0,0,0,80000,0,0,0,80000,0,80000,80000
3047,訊舟            ,84000,10000,74000,0,0,0,0,0,0,6000,6000,0,6000,0,0,0,80000
00866,新光Shiller CAPE,0,0,0,0,0,0,0,0,0,79000,0,0,0,79000,0,79000,79000
058170,國巨凱基9A購06  ,0,0,0,0,0,0,0,0,0,79000,0,0,0,100000,21000,79000,79000
057612,瑞昱元富02購01  ,0,0,0,0,0,0,0,0,0,79000,0,0,0,104000,25000,79000,79000
058795,可成元大99購03  ,0,0,0,0,0,0,0,0,0,79000,0,0,0,80000,1000,79000,79000
062399,神基永豐9B購01  ,0,0,0,0,0,0,0,0,0,79000,0,0,0,79000,0,79000,79000
060616,宏碁元大9A購02  ,0,0,0,0,0,0,0,0,0,79000,0,0,0,162000,83000,79000,79000
060545,台積電凱基9B購02,0,0,0,0,0,0,0,0,0,79000,0,0,0,80000,1000,79000,79000
061891,力山永豐9B購01  ,0,0,0,0,0,0,0,0,0,79000,0,0,0,122000,43000,79000,79000
3617,碩天            ,71000,6000,65000,0,0,0,0,0,0,14000,14000,0,14000,0,0,0,79000
07525P,臺股指中信9B售07,0,0,0,0,0,0,0,0,0,78000,0,0,0,80000,2000,78000,78000
07944P,華新科元大9B售08,0,0,0,0,0,0,0,0,0,78000,0,0,0,84000,6000,78000,78000
1439,中和            ,102000,25000,77000,0,0,0,0,0,0,1000,1000,0,1000,0,0,0,78000
063396,金像電群益9C購01,0,0,0,0,0,0,0,0,0,78000,0,0,0,78000,0,78000,78000
054675,美律台新98購01  ,0,0,0,0,0,0,0,0,0,78000,0,0,0,78000,0,78000,78000
059161,鴻海凱基9A購09  ,0,0,0,0,0,0,0,0,0,78000,0,0,0,85000,7000,78000,78000
059980,台積電元大99購50,0,0,0,0,0,0,0,0,0,78000,0,0,0,78000,0,78000,78000
056904,大立光元大99購05,0,0,0,0,0,0,0,0,0,78000,0,0,0,84000,6000,78000,78000
057872,旺宏元大99購06  ,0,0,0,0,0,0,0,0,0,78000,0,0,0,78000,0,78000,78000
060394,欣興麥證9A購01  ,0,0,0,90000,12000,78000,0,0,0,78000,0,0,0,90000,12000,78000,78000
06016P,京元電凱基96售03,0,0,0,0,0,0,0,0,0,78000,0,0,0,108000,30000,78000,78000
060089,台積電元大99購54,0,0,0,0,0,0,0,0,0,78000,0,0,0,78000,0,78000,78000
061114,南電元大9A購04  ,0,0,0,0,0,0,0,0,0,78000,0,0,0,89000,11000,78000,78000
061168,力成兆豐9A購01  ,0,0,0,0,0,0,0,0,0,78000,0,0,0,174000,96000,78000,78000
063019,聯發科元大9C購01,0,0,0,0,0,0,0,0,0,78000,0,0,0,106000,28000,78000,78000
063135,國巨統一9B購16  ,0,0,0,0,0,0,0,0,0,78000,0,0,0,228000,150000,78000,78000
063146,南六統一9B購02  ,0,0,0,0,0,0,0,0,0,78000,0,0,0,1035000,957000,78000,78000
8039,台虹            ,188000,155000,33000,0,0,0,0,0,0,45000,40000,0,40000,6000,1000,5000,78000
06583P,可成凱基98售07  ,0,0,0,0,0,0,0,0,0,77000,0,0,0,112000,35000,77000,77000
07014P,華通元大99售04  ,0,0,0,0,0,0,0,0,0,77000,0,0,0,86000,9000,77000,77000
1810,和成            ,71000,0,71000,0,0,0,0,0,0,6000,6000,0,6000,0,0,0,77000
07940P,國巨群益9B售06  ,0,0,0,0,0,0,0,0,0,77000,0,0,0,77000,0,77000,77000
006207,FH滬深          ,0,54000,-54000,0,0,0,0,0,0,131000,0,0,0,366000,235000,131000,77000
057249,華邦電統一9A購01,0,0,0,0,0,0,0,0,0,77000,0,0,0,139000,62000,77000,77000
062331,大立光統一9B購10,0,0,0,0,0,0,0,0,0,77000,0,0,0,82000,5000,77000,77000
061555,聯電國票9B購01  ,0,0,0,0,0,0,0,0,0,77000,0,0,0,77000,0,77000,77000
2450,神腦            ,74000,56891,17109,0,0,0,0,0,0,59000,59000,0,59000,0,0,0,76109
1809,中釉            ,73000,0,73000,0,0,0,0,0,0,3000,3000,0,3000,0,0,0,76000
07471P,南亞科元大9A售01,0,0,0,0,0,0,0,0,0,76000,0,0,0,91000,15000,76000,76000
07731P,臺股指凱基9A售28,0,0,0,0,0,0,0,0,0,76000,0,0,0,202000,126000,76000,76000
06836P,玉晶光國票99售06,0,0,0,0,0,0,0,0,0,76000,0,0,0,288000,212000,76000,76000
063764,上銀元富9B購08  ,0,0,0,0,0,0,0,0,0,76000,0,0,0,85000,9000,76000,76000
059426,鴻海元大99購31  ,0,0,0,0,0,0,0,0,0,76000,0,0,0,89000,13000,76000,76000
058123,亞光國票9A購01  ,0,0,0,0,0,0,0,0,0,76000,0,0,0,76000,0,76000,76000
060479,億豐元大9A購01  ,0,0,0,0,0,0,0,0,0,76000,0,0,0,76000,0,76000,76000
061679,健策元大9B購04  ,0,0,0,0,0,0,0,0,0,76000,0,0,0,94000,18000,76000,76000
061707,超眾國票9B購01  ,0,0,0,0,0,0,0,0,0,76000,0,0,0,82000,6000,76000,76000
061212,聯鈞元大9A購04  ,0,0,0,0,0,0,0,0,0,76000,0,0,0,162000,86000,76000,76000
063168,台表科永豐9B購01,0,0,0,0,0,0,0,0,0,76000,0,0,0,86000,10000,76000,76000
063221,京元電群益9B購02,0,0,0,0,0,0,0,0,0,76000,0,0,0,220000,144000,76000,76000
063628,華通元大9B購09  ,0,0,0,0,0,0,0,0,0,75000,0,0,0,85000,10000,75000,75000
063352,上銀元富9B購02  ,0,0,0,0,0,0,0,0,0,75000,0,0,0,100000,25000,75000,75000
06849P,欣興元大98售12  ,0,0,0,0,0,0,0,0,0,75000,0,0,0,95000,20000,75000,75000
07603P,台積電統一9B售08,0,0,0,0,0,0,0,0,0,75000,0,0,0,75000,0,75000,75000
07656P,國巨凱基9A售15  ,0,0,0,0,0,0,0,0,0,75000,0,0,0,75000,0,75000,75000
052069,聯茂兆豐96購01  ,0,0,0,0,0,0,0,0,0,75000,0,0,0,75000,0,75000,75000
053805,奇鋐凱基98購02  ,0,0,0,0,0,0,0,0,0,75000,0,0,0,78000,3000,75000,75000
053173,矽格群益97購01  ,0,0,0,0,0,0,0,0,0,75000,0,0,0,82000,7000,75000,75000
057574,中磊永豐98購01  ,0,0,0,0,0,0,0,0,0,75000,0,0,0,75000,0,75000,75000
058111,健鼎元富98購01  ,0,0,0,0,0,0,0,0,0,75000,0,0,0,110000,35000,75000,75000
057983,緯穎永豐98購03  ,0,0,0,0,0,0,0,0,0,75000,0,0,0,78000,3000,75000,75000
057955,技嘉元大98購07  ,0,0,0,0,0,0,0,0,0,75000,0,0,0,75000,0,75000,75000
063228,聯茂群益9B購01  ,0,0,0,0,0,0,0,0,0,75000,0,0,0,167000,92000,75000,75000
063013,技嘉元大9B購02  ,0,0,0,0,0,0,0,0,0,75000,0,0,0,85000,10000,75000,75000
062695,華通元大9C購01  ,0,0,0,0,0,0,0,0,0,75000,0,0,0,75000,0,75000,75000
062393,智邦富邦9B購01  ,0,0,0,0,0,0,0,0,0,75000,0,0,0,220000,145000,75000,75000
061160,瑞祺群益9A購01  ,0,0,0,0,0,0,0,0,0,75000,0,0,0,80000,5000,75000,75000
061152,微星群益9A購01  ,0,0,0,0,0,0,0,0,0,75000,0,0,0,84000,9000,75000,75000
061132,志超永豐9A購01  ,0,0,0,0,0,0,0,0,0,75000,0,0,0,100000,25000,75000,75000
060598,鴻海凱基9A購20  ,0,0,0,0,0,0,0,0,0,75000,0,0,0,77000,2000,75000,75000
060671,亞德客元大9A購03,0,0,0,0,0,0,0,0,0,75000,0,0,0,216000,141000,75000,75000
061418,世紀鋼群益9A購02,0,0,0,0,0,0,0,0,0,75000,0,0,0,422000,347000,75000,75000
8499,鼎炫-KY         ,70000,15000,55000,0,0,0,20000,0,20000,0,0,0,0,0,0,0,75000
08177P,金像電元大9B售02,0,0,0,0,0,0,0,0,0,74000,0,0,0,117000,43000,74000,74000
1723,中碳            ,220000,197000,23000,0,0,0,0,0,0,51000,51000,0,51000,0,0,0,74000
063643,臻鼎元大9B購03  ,0,0,0,0,0,0,0,0,0,74000,0,0,0,106000,32000,74000,74000
053524,聯電中信97購02  ,0,0,0,0,0,0,0,0,0,74000,0,0,0,94000,20000,74000,74000
045053,聯發科元富98購01,0,0,0,0,0,0,0,0,0,74000,0,0,0,74000,0,74000,74000
051911,大立光元大98購02,0,0,0,0,0,0,0,0,0,74000,0,0,0,74000,0,74000,74000
020008,元大特股高息N   ,0,0,0,0,0,0,0,0,0,74000,0,0,0,82000,8000,74000,74000
055893,大立光統一97購07,0,0,0,0,0,0,0,0,0,74000,0,0,0,74000,0,74000,74000
059755,宏達電國泰9A購01,0,0,0,0,0,0,0,0,0,74000,0,0,0,99000,25000,74000,74000
056872,旺宏凱基98購08  ,0,0,0,0,0,0,0,0,0,74000,0,0,0,74000,0,74000,74000
059830,台郡凱基99購05  ,0,0,0,0,0,0,0,0,0,74000,0,0,0,142000,68000,74000,74000
063026,南六元大9B購04  ,0,0,0,0,0,0,0,0,0,74000,0,0,0,246000,172000,74000,74000
3312,弘憶股          ,91000,19000,72000,0,0,0,0,0,0,2000,2000,0,2000,0,0,0,74000
063699,國巨群益9B購07  ,0,0,0,0,0,0,0,0,0,73000,0,0,0,74000,1000,73000,73000
063376,神達永豐9B購01  ,0,0,0,0,0,0,0,0,0,73000,0,0,0,90000,17000,73000,73000
063257,牧德國泰01購01  ,0,0,0,0,0,0,0,0,0,73000,0,0,0,93000,20000,73000,73000
1731,美吾華          ,80000,9000,71000,0,0,0,0,0,0,2000,2000,0,2000,0,0,0,73000
1340,勝悅-KY         ,70000,0,70000,0,0,0,0,0,0,3000,3000,0,3000,0,0,0,73000
2355,敬鵬            ,454000,580000,-126000,0,0,0,0,0,0,199000,107000,5000,102000,97000,0,97000,73000
2524,京城            ,80000,10000,70000,0,0,0,0,0,0,3000,3000,0,3000,0,0,0,73000
07842P,力成元大9A售01  ,0,0,0,0,0,0,0,0,0,73000,0,0,0,73000,0,73000,73000
059480,美律群益9A購01  ,0,0,0,0,0,0,0,0,0,73000,0,0,0,73000,0,73000,73000
056247,台郡群益97購01  ,0,0,0,0,0,0,0,0,0,73000,0,0,0,83000,10000,73000,73000
058136,景碩元大99購02  ,0,0,0,0,0,0,0,0,0,73000,0,0,0,83000,10000,73000,73000
059215,台積電元大99購28,0,0,0,0,0,0,0,0,0,73000,0,0,0,89000,16000,73000,73000
057149,京鼎國票99購02  ,0,0,0,0,0,0,0,0,0,73000,0,0,0,114000,41000,73000,73000
062889,可成群益9C購01  ,0,0,0,0,0,0,0,0,0,73000,0,0,0,74000,1000,73000,73000
061342,華新科元大9A購17,0,0,0,0,0,0,0,0,0,73000,0,0,0,73000,0,73000,73000
061547,禾伸堂群益9A購01,0,0,0,0,0,0,0,0,0,73000,0,0,0,103000,30000,73000,73000
061540,台積電群益9A購07,0,0,0,0,0,0,0,0,0,73000,0,0,0,94000,21000,73000,73000
061508,南六國泰9C購02  ,0,0,0,0,0,0,0,0,0,73000,0,0,0,174000,101000,73000,73000
4952,凌通            ,89000,15000,74000,0,0,0,0,0,0,-1000,1000,2000,-1000,0,0,0,73000
07989P,玉晶光凱基9B售07,0,0,0,0,0,0,0,0,0,72000,0,0,0,95000,23000,72000,72000
063368,遠東新永豐9B購01,0,0,0,0,0,0,0,0,0,72000,0,0,0,85000,13000,72000,72000
06550P,健策元大99售01  ,0,0,0,0,0,0,0,0,0,72000,0,0,0,72000,0,72000,72000
050797,聯發科中信99購01,0,0,0,0,0,0,0,0,0,72000,0,0,0,72000,0,72000,72000
057216,聯發科群益99購01,0,0,0,0,0,0,0,0,0,72000,0,0,0,72000,0,72000,72000
058846,鴻海群益99購03  ,0,0,0,0,0,0,0,0,0,72000,0,0,0,126000,54000,72000,72000
057354,聯鈞統一99購03  ,0,0,0,0,0,0,0,0,0,72000,0,0,0,102000,30000,72000,72000
057689,南亞科凱基99購02,0,0,0,0,0,0,0,0,0,72000,0,0,0,80000,8000,72000,72000
058701,鴻海元大99購16  ,0,0,0,0,0,0,0,0,0,72000,0,0,0,72000,0,72000,72000
060680,玉晶光元大9C購03,0,0,0,0,0,0,0,0,0,72000,0,0,0,93000,21000,72000,72000
061076,台達電兆豐9A購01,0,0,0,0,0,0,0,0,0,72000,0,0,0,350000,278000,72000,72000
061000,旺宏兆豐9A購02  ,0,0,0,0,0,0,0,0,0,72000,0,0,0,72000,0,72000,72000
063214,康控國票9C購01  ,0,0,0,0,0,0,0,0,0,72000,0,0,0,119000,47000,72000,72000
062006,瑞昱國泰9C購01  ,0,0,0,0,0,0,0,0,0,72000,0,0,0,82000,10000,72000,72000
062124,大立光統一9B購09,0,0,0,0,0,0,0,0,0,72000,0,0,0,128000,56000,72000,72000
4722,國精化          ,72000,2000,70000,0,0,0,0,0,0,2000,2000,0,2000,0,0,0,72000
4108,懷特            ,76000,4000,72000,0,0,0,0,0,0,0,0,0,0,0,0,0,72000
063291,緯穎元大01購01  ,0,0,0,0,0,0,0,0,0,71000,0,0,0,142000,71000,71000,71000
063382,南茂永豐9B購01  ,0,0,0,0,0,0,0,0,0,71000,0,0,0,132000,61000,71000,71000
054799,超眾群益98購01  ,0,0,0,0,0,0,0,0,0,71000,0,0,0,159000,88000,71000,71000
058142,瑞儀元大99購01  ,0,0,0,0,0,0,0,0,0,71000,0,0,0,118000,47000,71000,71000
056705,超眾國泰99購01  ,0,0,0,0,0,0,0,0,0,71000,0,0,0,71000,0,71000,71000
062333,嘉晶統一9C購01  ,0,0,0,0,0,0,0,0,0,71000,0,0,0,110000,39000,71000,71000
5288,豐祥-KY         ,89000,18000,71000,0,0,0,0,0,0,0,1000,1000,0,0,0,0,71000
08122P,晶技國票9C售01  ,0,0,0,0,0,0,0,0,0,70000,0,0,0,70000,0,70000,70000
08246P,亞德客群益01售01,0,0,0,0,0,0,0,0,0,70000,0,0,0,100000,30000,70000,70000
054943,群光元大97購01  ,0,0,0,0,0,0,0,0,0,70000,0,0,0,70000,0,70000,70000
059513,揚明光永豐99購01,0,0,0,0,0,0,0,0,0,70000,0,0,0,90000,20000,70000,70000
059053,鴻海凱基99購07  ,0,0,0,0,0,0,0,0,0,70000,0,0,0,76000,6000,70000,70000
050603,致新國泰96購01  ,0,0,0,0,0,0,0,0,0,70000,0,0,0,70000,0,70000,70000
051570,和碩富邦97購01  ,0,0,0,0,0,0,0,0,0,70000,0,0,0,70000,0,70000,70000
052047,建準凱基96購01  ,0,0,0,0,0,0,0,0,0,70000,0,0,0,70000,0,70000,70000
054147,GIS元大96購02   ,0,0,0,0,0,0,0,0,0,70000,0,0,0,70000,0,70000,70000
053893,京鼎群益97購02  ,0,0,0,0,0,0,0,0,0,70000,0,0,0,70000,0,70000,70000
054031,中鋼中信98購01  ,0,0,0,0,0,0,0,0,0,70000,0,0,0,70000,0,70000,70000
053494,南亞科兆豐96購02,0,0,0,0,0,0,0,0,0,70000,0,0,0,70000,0,70000,70000
052858,華通凱基97購02  ,0,0,0,0,0,0,0,0,0,70000,0,0,0,70000,0,70000,70000
054156,聯電亞東98購01  ,0,0,0,0,0,0,0,0,0,70000,0,0,0,70000,0,70000,70000
05538P,玉晶光國票97售02,0,0,0,0,0,0,0,0,0,70000,0,0,0,173000,103000,70000,70000
057918,旺宏凱基99購01  ,0,0,0,0,0,0,0,0,0,70000,0,0,0,70000,0,70000,70000
058545,義隆富邦9C購01  ,0,0,0,0,0,0,0,0,0,70000,0,0,0,130000,60000,70000,70000
062191,台郡元大9B購05  ,0,0,0,0,0,0,0,0,0,70000,0,0,0,84000,14000,70000,70000
06155P,智邦統一97售02  ,0,0,0,0,0,0,0,0,0,70000,0,0,0,70000,0,70000,70000
061345,玉晶光元大9A購14,0,0,0,0,0,0,0,0,0,70000,0,0,0,70000,0,70000,70000
061415,健策群益9A購04  ,0,0,0,0,0,0,0,0,0,70000,0,0,0,98000,28000,70000,70000
061395,健策統一9C購02  ,0,0,0,0,0,0,0,0,0,70000,0,0,0,91000,21000,70000,70000
06169P,華新科元富97售02,0,0,0,0,0,0,0,0,0,70000,0,0,0,70000,0,70000,70000
061622,臻鼎群益9A購01  ,0,0,0,0,0,0,0,0,0,70000,0,0,0,70000,0,70000,70000
2464,盟立            ,110000,38000,72000,0,0,0,0,0,0,-3000,3000,0,3000,0,6000,-6000,69000
063705,臻鼎群益9B購03  ,0,0,0,0,0,0,0,0,0,69000,0,0,0,254000,185000,69000,69000
051484,玉晶光凱基97購01,0,0,0,0,0,0,0,0,0,69000,0,0,0,201000,132000,69000,69000
058586,鴻海中信01購02  ,0,0,0,0,0,0,0,0,0,69000,0,0,0,79000,10000,69000,69000
060469,台勝科元大9A購02,1000,0,1000,0,0,0,0,0,0,68000,0,0,0,69000,1000,68000,69000
060156,光磊永豐9A購01  ,0,0,0,0,0,0,0,0,0,69000,0,0,0,180000,111000,69000,69000
059618,台積電日盛99購01,0,0,0,0,0,0,0,0,0,69000,0,0,0,69000,0,69000,69000
058896,中環元大99購03  ,0,0,0,0,0,0,0,0,0,69000,0,0,0,183000,114000,69000,69000
056851,瑞儀元富98購01  ,0,0,0,0,0,0,0,0,0,69000,0,0,0,162000,93000,69000,69000
061290,玉晶光統一01購04,0,0,0,0,0,0,0,0,0,69000,0,0,0,97000,28000,69000,69000
062148,奇鋐國票9B購01  ,0,0,0,0,0,0,0,0,0,69000,0,0,0,79000,10000,69000,69000
062904,台光電元大9B購06,0,0,0,0,0,0,0,0,0,69000,0,0,0,93000,24000,69000,69000
06706P,智原台新98售02  ,0,0,0,0,0,0,0,0,0,68000,0,0,0,73000,5000,68000,68000
06726P,欣興元富98售04  ,0,0,0,0,0,0,0,0,0,68000,0,0,0,126000,58000,68000,68000
051277,聯發科中信9A購01,0,0,0,0,0,0,0,0,0,68000,0,0,0,68000,0,68000,68000
056351,鴻海元大98購06  ,0,0,0,0,0,0,0,0,0,68000,0,0,0,68000,0,68000,68000
053457,旺宏國泰98購03  ,0,0,0,0,0,0,0,0,0,68000,0,0,0,68000,0,68000,68000
056617,美律永豐98購01  ,0,0,0,0,0,0,0,0,0,68000,0,0,0,68000,0,68000,68000
056655,旺宏元大99購02  ,0,0,0,0,0,0,0,0,0,68000,0,0,0,68000,0,68000,68000
057174,南亞科元大98購05,0,0,0,0,0,0,0,0,0,68000,0,0,0,68000,0,68000,68000
057178,可成元大98購03  ,0,0,0,0,0,0,0,0,0,68000,0,0,0,68000,0,68000,68000
058985,可成凱基99購03  ,0,0,0,0,0,0,0,0,0,68000,0,0,0,68000,0,68000,68000
057815,信邦元大98購01  ,0,0,0,0,0,0,0,0,0,68000,0,0,0,123000,55000,68000,68000
058160,奇鋐元富99購01  ,0,0,0,0,0,0,0,0,0,68000,0,0,0,127000,59000,68000,68000
058213,欣興群益99購01  ,0,0,0,0,0,0,0,0,0,68000,0,0,0,85000,17000,68000,68000
062776,鴻海元大9B購03  ,0,0,0,0,0,0,0,0,0,68000,0,0,0,68000,0,68000,68000
062815,聯發科兆豐9B購03,0,0,0,0,0,0,0,0,0,68000,0,0,0,73000,5000,68000,68000
062605,上銀凱基9B購03  ,0,0,0,0,0,0,0,0,0,68000,0,0,0,68000,0,68000,68000
062134,國巨群益9B購04  ,0,0,0,0,0,0,0,0,0,68000,0,0,0,78000,10000,68000,68000
061675,華新科元大9A購23,0,0,0,0,0,0,0,0,0,68000,0,0,0,68000,0,68000,68000
4977,眾達-KY         ,171000,150000,21000,0,0,0,80000,0,80000,-33000,1000,32000,-31000,0,2000,-2000,68000
4766,南寶            ,127000,63000,64000,0,0,0,0,0,0,4000,4000,0,4000,0,0,0,68000
3543,州巧            ,71000,3000,68000,0,0,0,0,0,0,0,0,0,0,0,0,0,68000
063366,台表科富邦9C購02,0,0,0,0,0,0,0,0,0,67000,0,0,0,67000,0,67000,67000
2537,聯上發          ,492000,444000,48000,0,0,0,0,0,0,19000,19000,0,19000,0,0,0,67000
08219P,上銀凱基9B售08  ,0,0,0,0,0,0,0,0,0,67000,0,0,0,67000,0,67000,67000
07459P,緯穎元大9A售01  ,0,0,0,0,0,0,0,0,0,67000,0,0,0,220000,153000,67000,67000
059315,鴻海元大99購30  ,0,0,0,0,0,0,0,0,0,67000,0,0,0,105000,38000,67000,67000
054863,億光群益97購01  ,0,0,0,0,0,0,0,0,0,67000,0,0,0,127000,60000,67000,67000
061678,玉晶光元大9B購04,0,0,0,0,0,0,0,0,0,67000,0,0,0,135000,68000,67000,67000
062040,玉晶光凱基01購01,0,0,0,0,0,0,0,0,0,67000,0,0,0,154000,87000,67000,67000
062336,茂林統一01購02  ,0,0,0,0,0,0,0,0,0,67000,0,0,0,77000,10000,67000,67000
062527,美律統一01購01  ,0,0,0,0,0,0,0,0,0,67000,0,0,0,440000,373000,67000,67000
063220,建準群益9B購01  ,0,0,0,0,0,0,0,0,0,67000,0,0,0,226000,159000,67000,67000
1514,亞力            ,126000,63000,63000,0,0,0,0,0,0,3000,3000,0,3000,0,0,0,66000
1589,永冠-KY         ,136000,36000,100000,0,0,0,0,0,0,-34000,15000,49000,-34000,0,0,0,66000
2849,安泰銀          ,70000,7000,63000,0,0,0,0,0,0,3000,3000,0,3000,0,0,0,66000
055896,南電統一97購02  ,0,0,0,0,0,0,0,0,0,66000,0,0,0,71000,5000,66000,66000
056624,景碩永豐98購01  ,0,0,0,0,0,0,0,0,0,66000,0,0,0,76000,10000,66000,66000
060420,神基永豐9A購01  ,0,0,0,0,0,0,0,0,0,66000,0,0,0,66000,0,66000,66000
057501,超眾群益98購04  ,0,0,0,0,0,0,0,0,0,66000,0,0,0,85000,19000,66000,66000
059689,南亞科永豐99購02,0,0,0,0,0,0,0,0,0,66000,0,0,0,114000,48000,66000,66000
05990P,台積電群益96售13,0,0,0,0,0,0,0,0,0,66000,0,0,0,68000,2000,66000,66000
057057,立積元大9A購01  ,0,0,0,0,0,0,0,0,0,66000,0,0,0,101000,35000,66000,66000
061403,滬深2X國票9A購06,0,0,0,0,0,0,0,0,0,66000,0,0,0,72000,6000,66000,66000
2329,華泰            ,498000,540000,-42000,0,0,0,0,0,0,107000,107000,0,107000,0,0,0,65000
06569P,可成永豐98售01  ,0,0,0,0,0,0,0,0,0,65000,0,0,0,65000,0,65000,65000
06457P,玉晶光統一98售02,0,0,0,0,0,0,0,0,0,65000,0,0,0,100000,35000,65000,65000
06958P,FBVIX凱基9C售02 ,0,0,0,0,0,0,0,0,0,65000,0,0,0,65000,0,65000,65000
056441,燿華凱基98購01  ,0,0,0,0,0,0,0,0,0,65000,0,0,0,70000,5000,65000,65000
053458,聯詠國泰97購01  ,0,0,0,0,0,0,0,0,0,65000,0,0,0,65000,0,65000,65000
053694,創意元大96購03  ,0,0,0,0,0,0,0,0,0,65000,0,0,0,165000,100000,65000,65000
00678,群益NBI生技     ,57000,0,57000,0,0,0,0,0,0,8000,0,0,0,335000,327000,8000,65000
058109,台灣50元富9B購01,0,0,0,0,0,0,0,0,0,65000,0,0,0,65000,0,65000,65000
056835,聯電元富99購01  ,0,0,0,0,0,0,0,0,0,65000,0,0,0,607000,542000,65000,65000
059673,玉山金元富99購01,0,0,0,0,0,0,0,0,0,65000,0,0,0,227000,162000,65000,65000
060967,鈺齊凱基9A購02  ,0,0,0,0,0,0,0,0,0,65000,0,0,0,115000,50000,65000,65000
060244,大立光元大9B購02,0,0,0,0,0,0,0,0,0,65000,0,0,0,126000,61000,65000,65000
058497,新日興群益9B購01,0,0,0,0,0,0,0,0,0,65000,0,0,0,101000,36000,65000,65000
060646,南電永豐9A購01  ,0,0,0,0,0,0,0,0,0,65000,0,0,0,65000,0,65000,65000
9941,裕融            ,63000,67000,-4000,0,0,0,0,0,0,69000,70000,1000,69000,0,0,0,65000
06936P,瑞儀元大98售01  ,0,0,0,0,0,0,0,0,0,64000,0,0,0,178000,114000,64000,64000
2471,資通            ,126000,63000,63000,0,0,0,0,0,0,1000,1000,0,1000,0,0,0,64000
07634P,金像電元大9A售01,0,0,0,0,0,0,0,0,0,64000,0,0,0,342000,278000,64000,64000
08140P,祥碩元大9B售07  ,0,0,0,0,0,0,0,0,0,64000,0,0,0,139000,75000,64000,64000
08077P,亞德客國票9B售02,0,0,0,0,0,0,0,0,0,64000,0,0,0,115000,51000,64000,64000
08087P,聯發科凱基9B售12,0,0,0,0,0,0,0,0,0,64000,0,0,0,66000,2000,64000,64000
07794P,智邦國票9A售03  ,0,0,0,0,0,0,0,0,0,64000,0,0,0,180000,116000,64000,64000
050100,台積電永昌96購02,0,0,0,0,0,0,0,0,0,64000,0,0,0,64000,0,64000,64000
052463,聯電統一96購01  ,0,0,0,0,0,0,0,0,0,64000,0,0,0,119000,55000,64000,64000
059143,國巨國票9A購04  ,0,0,0,0,0,0,0,0,0,64000,0,0,0,103000,39000,64000,64000
059170,康控凱基9B購01  ,0,0,0,0,0,0,0,0,0,64000,0,0,0,72000,8000,64000,64000
057700,新日興群益9A購01,0,0,0,0,0,0,0,0,0,64000,0,0,0,90000,26000,64000,64000
060320,元金2X群益02購01,0,0,0,0,0,0,0,0,0,64000,0,0,0,75000,11000,64000,64000
057458,TPK富邦9A購01   ,0,0,0,0,0,0,0,0,0,64000,0,0,0,64000,0,64000,64000
057996,臻鼎中信98購01  ,0,0,0,0,0,0,0,0,0,64000,0,0,0,92000,28000,64000,64000
060914,健策元大9A購03  ,0,0,0,0,0,0,0,0,0,64000,0,0,0,64000,0,64000,64000
061577,泰碩元大9A購03  ,0,0,0,0,0,0,0,0,0,64000,0,0,0,365000,301000,64000,64000
061617,微星群益9A購02  ,0,0,0,0,0,0,0,0,0,64000,0,0,0,117000,53000,64000,64000
063008,華通元大9B購06  ,0,0,0,0,0,0,0,0,0,64000,0,0,0,103000,39000,64000,64000
062549,中租永豐9B購01  ,0,0,0,0,0,0,0,0,0,64000,0,0,0,194000,130000,64000,64000
2062,橋椿            ,255000,194000,61000,0,0,0,0,0,0,2000,2000,0,2000,0,0,0,63000
06447P,上銀元大98售01  ,0,0,0,0,0,0,0,0,0,63000,0,0,0,63000,0,63000,63000
059100,元油2X統一9C購02,0,0,0,0,0,0,0,0,0,63000,0,0,0,198000,135000,63000,63000
051727,S&P反1國票97購01,0,0,0,0,0,0,0,0,0,63000,0,0,0,75000,12000,63000,63000
058050,台郡元大99購05  ,0,0,0,0,0,0,0,0,0,63000,0,0,0,256000,193000,63000,63000
057335,技嘉國票99購01  ,0,0,0,0,0,0,0,0,0,63000,0,0,0,124000,61000,63000,63000
060091,技嘉元大99購03  ,0,0,0,0,0,0,0,0,0,63000,0,0,0,63000,0,63000,63000
060932,南六永豐9A購02  ,0,0,0,0,0,0,0,0,0,63000,0,0,0,106000,43000,63000,63000
060405,中租國泰9C購01  ,0,0,0,0,0,0,0,0,0,63000,0,0,0,63000,0,63000,63000
057878,台郡元大99購04  ,0,0,0,0,0,0,0,0,0,63000,0,0,0,85000,22000,63000,63000
058481,玉晶光凱基9A購04,0,0,0,0,0,0,0,0,0,63000,0,0,0,143000,80000,63000,63000
062777,鴻海元大9C購03  ,0,0,0,0,0,0,0,0,0,63000,0,0,0,63000,0,63000,63000
061447,鴻海中信04購02  ,0,0,0,0,0,0,0,0,0,63000,0,0,0,95000,32000,63000,63000
1527,鑽全            ,80000,20000,60000,0,0,0,0,0,0,2000,2000,0,2000,0,0,0,62000
08192P,大毅國票9B售05  ,0,0,0,0,0,0,0,0,0,62000,0,0,0,62000,0,62000,62000
056020,義隆群益97購01  ,0,0,0,0,0,0,0,0,0,62000,0,0,0,62000,0,62000,62000
056468,鴻海元大98購07  ,0,0,0,0,0,0,0,0,0,62000,0,0,0,150000,88000,62000,62000
057894,華通元富02購02  ,0,0,0,0,0,0,0,0,0,62000,0,0,0,100000,38000,62000,62000
060388,世紀鋼凱基9B購01,0,0,0,0,0,0,0,0,0,62000,0,0,0,115000,53000,62000,62000
057325,可成群益9A購01  ,0,0,0,0,0,0,0,0,0,62000,0,0,0,62000,0,62000,62000
059841,國巨富邦9C購01  ,0,0,0,0,0,0,0,0,0,62000,0,0,0,201000,139000,62000,62000
060557,南電凱基9A購02  ,0,0,0,0,0,0,0,0,0,62000,0,0,0,110000,48000,62000,62000
9943,好樂迪          ,63000,4000,59000,0,0,0,0,0,0,3000,3000,0,3000,0,0,0,62000
08131P,立積元大9B售02  ,0,0,0,0,0,0,0,0,0,61000,0,0,0,141000,80000,61000,61000
07996P,亞德客凱基9B售03,0,0,0,0,0,0,0,0,0,61000,0,0,0,71000,10000,61000,61000
054072,台積電富邦98購02,0,0,0,0,0,0,0,0,0,61000,0,0,0,61000,0,61000,61000
055527,旺宏群益99購03  ,0,0,0,0,0,0,0,0,0,61000,0,0,0,61000,0,61000,61000
059695,聯鈞永豐99購02  ,0,0,0,0,0,0,0,0,0,61000,0,0,0,125000,64000,61000,61000
057508,康控國票99購03  ,0,0,0,0,0,0,0,0,0,61000,0,0,0,98000,37000,61000,61000
058499,滬深2X元大9C購01,0,0,0,0,0,0,0,0,0,61000,0,0,0,63000,2000,61000,61000
060658,台灣50凱基01購04,0,0,0,0,0,0,0,0,0,61000,0,0,0,61000,0,61000,61000
061579,京鼎元大9A購02  ,0,0,0,0,0,0,0,0,0,61000,0,0,0,186000,125000,61000,61000
07926P,上銀統一9B售02  ,0,0,0,0,0,0,0,0,0,60000,0,0,0,60000,0,60000,60000
07593P,臺股指凱基9A售08,0,0,0,0,0,0,0,0,0,60000,0,0,0,200000,140000,60000,60000
07691P,宏達電元大9A售05,0,0,0,0,0,0,0,0,0,60000,0,0,0,100000,40000,60000,60000
07714P,世紀鋼元大9A售03,0,10000,-10000,0,0,0,0,0,0,70000,0,0,0,275000,205000,70000,60000
06545P,致茂元大98售01  ,0,0,0,0,0,0,0,0,0,60000,0,0,0,73000,13000,60000,60000
063417,金像電凱基9B購03,0,0,0,0,0,0,0,0,0,60000,0,0,0,80000,20000,60000,60000
063767,義隆國泰02購01  ,0,0,0,0,0,0,0,0,0,60000,0,0,0,230000,170000,60000,60000
055458,燿華永豐98購01  ,0,0,0,0,0,0,0,0,0,60000,0,0,0,60000,0,60000,60000
052849,可成統一97購01  ,0,0,0,0,0,0,0,0,0,60000,0,0,0,70000,10000,60000,60000
050014,國巨富邦98購01  ,0,0,0,0,0,0,0,0,0,60000,0,0,0,79000,19000,60000,60000
051561,玉晶光國泰97購04,0,0,0,0,0,0,0,0,0,60000,0,0,0,60000,0,60000,60000
055623,貿聯國泰99購01  ,0,0,0,0,0,0,0,0,0,60000,0,0,0,65000,5000,60000,60000
055220,緯穎凱基98購02  ,0,0,0,0,0,0,0,0,0,60000,0,0,0,60000,0,60000,60000
056029,國巨麥證98購01  ,0,0,0,60000,0,60000,0,0,0,60000,0,0,0,60000,0,60000,60000
056169,鴻海元富97購08  ,0,0,0,0,0,0,0,0,0,60000,0,0,0,66000,6000,60000,60000
056283,鴻海永豐97購03  ,0,0,0,0,0,0,0,0,0,60000,0,0,0,60000,0,60000,60000
055796,南電國泰98購01  ,0,0,0,0,0,0,0,0,0,60000,0,0,0,71000,11000,60000,60000
058191,祥碩永豐99購01  ,0,0,0,0,0,0,0,0,0,60000,0,0,0,60000,0,60000,60000
057591,鴻海兆豐99購01  ,0,0,0,0,0,0,0,0,0,60000,0,0,0,60000,0,60000,60000
057660,訊芯兆豐98購02  ,0,0,0,0,0,0,0,0,0,60000,0,0,0,60000,0,60000,60000
058258,世芯國泰9A購01  ,0,0,0,0,0,0,0,0,0,60000,0,0,0,60000,0,60000,60000
058007,南電群益98購02  ,0,0,0,0,0,0,0,0,0,60000,0,0,0,60000,0,60000,60000
059459,訊芯永豐99購04  ,0,0,0,0,0,0,0,0,0,60000,0,0,0,60000,0,60000,60000
059252,聯詠凱基99購03  ,0,0,0,0,0,0,0,0,0,60000,0,0,0,100000,40000,60000,60000
059850,日電貿永豐99購01,0,0,0,0,0,0,0,0,0,60000,0,0,0,76000,16000,60000,60000
059834,友達國泰9B購01  ,0,0,0,0,0,0,0,0,0,60000,0,0,0,70000,10000,60000,60000
056674,華邦電元富98購01,0,0,0,0,0,0,0,0,0,60000,0,0,0,101000,41000,60000,60000
061378,南六永豐9A購03  ,0,0,0,0,0,0,0,0,0,60000,0,0,0,197000,137000,60000,60000
061095,台積電台新9B購03,0,0,0,0,0,0,0,0,0,60000,0,0,0,70000,10000,60000,60000
061194,聯鈞永豐9A購02  ,0,0,0,0,0,0,0,0,0,60000,0,0,0,60000,0,60000,60000
062604,東元凱基9B購01  ,0,0,0,0,0,0,0,0,0,60000,0,0,0,106000,46000,60000,60000
061997,台郡元大9B購03  ,0,0,0,0,0,0,0,0,0,60000,0,0,0,110000,50000,60000,60000
062192,南六元大9B購01  ,0,0,0,0,0,0,0,0,0,60000,0,0,0,75000,15000,60000,60000
6142,友勁            ,8000,0,8000,0,0,0,0,0,0,52000,52000,0,52000,0,0,0,60000
07049P,聯發科中信99售03,0,0,0,0,0,0,0,0,0,59000,0,0,0,100000,41000,59000,59000
047769,大立光元大96購01,0,0,0,0,0,0,0,0,0,59000,0,0,0,59000,0,59000,59000
00851,台新全球AI      ,0,0,0,0,0,0,0,0,0,59000,0,0,0,91000,32000,59000,59000
05305P,華新科國泰97售01,0,0,0,0,0,0,0,0,0,59000,0,0,0,139000,80000,59000,59000
053088,奇鋐元大98購01  ,0,0,0,0,0,0,0,0,0,59000,0,0,0,121000,62000,59000,59000
056777,矽力元大98購02  ,0,0,0,0,0,0,0,0,0,59000,0,0,0,61000,2000,59000,59000
062249,台積電元大9B購01,0,0,0,0,0,0,0,0,0,59000,0,0,0,90000,31000,59000,59000
062499,鴻海群益01購01  ,0,0,0,0,0,0,0,0,0,59000,0,0,0,80000,21000,59000,59000
063153,南六元富9B購01  ,0,0,0,0,0,0,0,0,0,59000,0,0,0,485000,426000,59000,59000
061354,瑞儀元大9A購01  ,0,0,0,0,0,0,0,0,0,59000,0,0,0,110000,51000,59000,59000
061722,健策永豐9B購03  ,0,0,0,0,0,0,0,0,0,59000,0,0,0,72000,13000,59000,59000
4306,炎洲            ,52000,0,52000,0,0,0,0,0,0,7000,7000,0,7000,0,0,0,59000
3022,威強電          ,72000,41000,31000,0,0,0,0,0,0,28000,28000,0,28000,0,0,0,59000
07127P,精元元大99售01  ,0,0,0,0,0,0,0,0,0,58000,0,0,0,89000,31000,58000,58000
06376P,上銀統一99售01  ,0,54000,-54000,0,0,0,0,0,0,112000,0,0,0,112000,0,112000,58000
07906P,中租群益9B售02  ,0,0,0,0,0,0,0,0,0,58000,0,0,0,70000,12000,58000,58000
07868P,健策元大9B售05  ,0,0,0,0,0,0,0,0,0,58000,0,0,0,78000,20000,58000,58000
2399,映泰            ,74000,17000,57000,0,0,0,0,0,0,1000,1000,0,1000,0,0,0,58000
2832,台產            ,58000,5000,53000,0,0,0,0,0,0,5000,5000,0,5000,0,0,0,58000
053609,華新中信9A購01  ,0,0,0,0,0,0,0,0,0,58000,0,0,0,78000,20000,58000,58000
056302,大立光元大97購17,0,0,0,0,0,0,0,0,0,58000,0,0,0,68000,10000,58000,58000
059086,國巨元大99購18  ,0,0,0,0,0,0,0,0,0,58000,0,0,0,107000,49000,58000,58000
055114,新日興凱基98購01,0,0,0,0,0,0,0,0,0,58000,0,0,0,103000,45000,58000,58000
055014,達興元富97購01  ,0,0,0,0,0,0,0,0,0,58000,0,0,0,58000,0,58000,58000
054717,亞德客永豐97購01,0,0,0,0,0,0,0,0,0,58000,0,0,0,58000,0,58000,58000
054455,楠梓電群益98購02,0,0,0,0,0,0,0,0,0,58000,0,0,0,156000,98000,58000,58000
057346,鴻海統一98購13  ,0,0,0,0,0,0,0,0,0,58000,0,0,0,86000,28000,58000,58000
058238,奇鋐元大99購02  ,0,0,0,0,0,0,0,0,0,58000,0,0,0,73000,15000,58000,58000
057484,南亞科元大98購06,0,0,0,0,0,0,0,0,0,58000,0,0,0,68000,10000,58000,58000
061575,華新科元大9A購20,0,0,0,0,0,0,0,0,0,58000,0,0,0,68000,10000,58000,58000
060609,玉晶光凱基9B購01,0,0,0,0,0,0,0,0,0,58000,0,0,0,104000,46000,58000,58000
060823,旺宏元大9A購05  ,0,0,0,0,0,0,0,0,0,58000,0,0,0,68000,10000,58000,58000
062921,GIS元大9B購01   ,0,0,0,0,0,0,0,0,0,58000,0,0,0,163000,105000,58000,58000
062462,GIS群益9B購01   ,0,0,0,0,0,0,0,0,0,58000,0,0,0,79000,21000,58000,58000
2415,錩新            ,92000,35078,56922,0,0,0,0,0,0,1000,1000,0,1000,0,0,0,57922
056583,昇陽半元大98購02,0,0,0,0,0,0,0,0,0,57000,0,0,0,105000,48000,57000,57000
055024,興勤國泰98購01  ,0,0,0,0,0,0,0,0,0,57000,0,0,0,93000,36000,57000,57000
056025,嘉晶群益97購01  ,0,0,0,0,0,0,0,0,0,57000,0,0,0,137000,80000,57000,57000
052893,聯電群益98購01  ,0,0,0,0,0,0,0,0,0,57000,0,0,0,57000,0,57000,57000
051536,玉晶光國票97購01,0,0,0,0,0,0,0,0,0,57000,0,0,0,245000,188000,57000,57000
052003,泰碩國泰97購02  ,0,0,0,0,0,0,0,0,0,57000,0,0,0,86000,29000,57000,57000
060338,鴻海統一9C購02  ,0,0,0,0,0,0,0,0,0,57000,0,0,0,57000,0,57000,57000
060316,福懋科永豐9A購01,0,0,0,0,0,0,0,0,0,57000,0,0,0,264000,207000,57000,57000
062477,聯詠國票9B購01  ,0,0,0,0,0,0,0,0,0,57000,0,0,0,57000,0,57000,57000
062567,祥碩中信9C購01  ,0,0,0,0,0,0,0,0,0,57000,0,0,0,183000,126000,57000,57000
061138,晶技統一9C購01  ,0,0,0,0,0,0,0,0,0,57000,0,0,0,117000,60000,57000,57000
061443,大立光統一9C購02,0,0,0,0,0,0,0,0,0,57000,0,0,0,110000,53000,57000,57000
06138P,台積電中信99售01,0,0,0,0,0,0,0,0,0,57000,0,0,0,60000,3000,57000,57000
8429,金麗-KY         ,67000,12000,55000,0,0,0,0,0,0,2000,2000,0,2000,0,0,0,57000
2106,建大            ,236000,328000,-92000,0,0,0,0,0,0,148000,168000,20000,148000,0,0,0,56000
07739P,緯穎永豐9A售01  ,0,0,0,0,0,0,0,0,0,56000,0,0,0,56000,0,56000,56000
07552P,技嘉元大9A售03  ,0,0,0,0,0,0,0,0,0,56000,0,0,0,80000,24000,56000,56000
07416P,台積電元大99售53,0,0,0,0,0,0,0,0,0,56000,0,0,0,94000,38000,56000,56000
07506P,中租元大9A售01  ,0,0,0,0,0,0,0,0,0,56000,0,0,0,100000,44000,56000,56000
07252P,台灣50凱基99售01,0,0,0,0,0,0,0,0,0,56000,0,0,0,56000,0,56000,56000
051259,鴻海永昌96購03  ,0,0,0,0,0,0,0,0,0,56000,0,0,0,56000,0,56000,56000
059539,緯穎凱基99購03  ,0,0,0,0,0,0,0,0,0,56000,0,0,0,70000,14000,56000,56000
060185,聯發科元富04購01,0,0,0,0,0,0,0,0,0,56000,0,0,0,56000,0,56000,56000
057817,景碩元大98購01  ,0,0,0,0,0,0,0,0,0,56000,0,0,0,77000,21000,56000,56000
057604,鴻海統一9C購01  ,0,0,0,0,0,0,0,0,0,56000,0,0,0,56000,0,56000,56000
057190,立積元大9A購02  ,0,0,0,0,0,0,0,0,0,56000,0,0,0,56000,0,56000,56000
061604,台光電凱基9B購01,0,0,0,0,0,0,0,0,0,56000,0,0,0,56000,0,56000,56000
060674,瑞昱元大9A購03  ,0,0,0,0,0,0,0,0,0,56000,0,0,0,76000,20000,56000,56000
063846,智邦元大9C購01  ,0,0,0,0,0,0,0,0,0,55000,0,0,0,67000,12000,55000,55000
063688,建準永豐9B購03  ,0,0,0,0,0,0,0,0,0,55000,0,0,0,55000,0,55000,55000
07465P,台灣50元大9C售24,0,0,0,0,0,0,0,0,0,55000,0,0,0,55000,0,55000,55000
07469P,台達電元大9A售01,0,0,0,0,0,0,0,0,0,55000,0,0,0,55000,0,55000,55000
07310P,大立光凱基99售12,0,0,0,0,0,0,0,0,0,55000,0,0,0,160000,105000,55000,55000
08129P,聯發科元大9B售23,0,0,0,0,0,0,0,0,0,55000,0,0,0,105000,50000,55000,55000
1532,勤美            ,198000,148000,50000,0,0,0,0,0,0,5000,5000,0,5000,0,0,0,55000
059564,鴻海凱基9A購15  ,0,0,0,0,0,0,0,0,0,55000,0,0,0,55000,0,55000,55000
059209,華通元大99購08  ,0,0,0,0,0,0,0,0,0,55000,0,0,0,55000,0,55000,55000
056286,奇鋐永豐97購01  ,0,0,0,0,0,0,0,0,0,55000,0,0,0,168000,113000,55000,55000
051722,玉晶光永豐97購01,0,0,0,0,0,0,0,0,0,55000,0,0,0,55000,0,55000,55000
049615,香港2X群益98購01,0,0,0,0,0,0,0,0,0,55000,0,0,0,55000,0,55000,55000
049667,大立光國泰96購01,0,0,0,0,0,0,0,0,0,55000,0,0,0,55000,0,55000,55000
052807,貿聯元大98購01  ,0,0,0,0,0,0,0,0,0,55000,0,0,0,55000,0,55000,55000
053506,南茂兆豐97購01  ,0,0,0,0,0,0,0,0,0,55000,0,0,0,55000,0,55000,55000
052669,群創群益98購06  ,0,0,0,0,0,0,0,0,0,55000,0,0,0,55000,0,55000,55000
057940,和大國票99購01  ,0,0,0,0,0,0,0,0,0,55000,0,0,0,297000,242000,55000,55000
057329,緯穎群益98購02  ,0,0,0,0,0,0,0,0,0,55000,0,0,0,115000,60000,55000,55000
059871,義隆凱基99購03  ,0,0,0,0,0,0,0,0,0,55000,0,0,0,70000,15000,55000,55000
058732,矽格永豐99購01  ,0,0,0,0,0,0,0,0,0,55000,0,0,0,197000,142000,55000,55000
060401,世紀鋼國票9B購01,0,0,0,0,0,0,0,0,0,55000,0,0,0,404000,349000,55000,55000
062346,智邦群益9B購02  ,0,0,0,0,0,0,0,0,0,55000,0,0,0,57000,2000,55000,55000
062709,帆宣元大9B購01  ,0,0,0,0,0,0,0,0,0,55000,0,0,0,60000,5000,55000,55000
4934,太極            ,121000,66000,55000,0,0,0,0,0,0,0,0,0,0,0,0,0,55000
1472,三洋紡          ,56000,2000,54000,0,0,0,0,0,0,0,0,0,0,0,0,0,54000
2612,中航            ,52000,1000,51000,0,0,0,0,0,0,3000,3000,0,3000,0,0,0,54000
052342,茂林凱基96購01  ,0,0,0,0,0,0,0,0,0,54000,0,0,0,66000,12000,54000,54000
053013,台積電統一97購01,0,0,0,0,0,0,0,0,0,54000,0,0,0,54000,0,54000,54000
050192,康控元大97購01  ,0,0,0,0,0,0,0,0,0,54000,0,0,0,54000,0,54000,54000
054075,GIS富邦97購02   ,0,0,0,0,0,0,0,0,0,54000,0,0,0,100000,46000,54000,54000
058261,大立光富邦03購01,0,0,0,0,0,0,0,0,0,54000,0,0,0,54000,0,54000,54000
057437,可成國票99購01  ,0,0,0,0,0,0,0,0,0,54000,0,0,0,54000,0,54000,54000
058372,欣興凱基99購03  ,0,0,0,0,0,0,0,0,0,54000,0,0,0,54000,0,54000,54000
058792,鴻海元大99購18  ,0,0,0,0,0,0,0,0,0,54000,0,0,0,57000,3000,54000,54000
063174,臺股指中信01購04,0,0,0,0,0,0,0,0,0,54000,0,0,0,55000,1000,54000,54000
061865,力山元大9B購01  ,0,0,0,0,0,0,0,0,0,54000,0,0,0,208000,154000,54000,54000
2539,櫻花建          ,99000,46000,53000,0,0,0,0,0,0,0,0,0,0,0,0,0,53000
08128P,聯發科元大9B售22,0,0,0,0,0,0,0,0,0,53000,0,0,0,80000,27000,53000,53000
063409,GIS國票9C購02   ,0,0,0,0,0,0,0,0,0,53000,0,0,0,111000,58000,53000,53000
063395,金像電群益9B購02,0,0,0,0,0,0,0,0,0,53000,0,0,0,63000,10000,53000,53000
063468,聯詠元大9B購04  ,0,0,0,0,0,0,0,0,0,53000,0,0,0,71000,18000,53000,53000
051047,深中小群益99購01,0,0,0,0,0,0,0,0,0,53000,0,0,0,109000,56000,53000,53000
054260,貿聯元大96購03  ,0,0,0,0,0,0,0,0,0,53000,0,0,0,353000,300000,53000,53000
055801,景碩永豐97購02  ,0,0,0,0,0,0,0,0,0,53000,0,0,0,153000,100000,53000,53000
056126,台郡國票98購02  ,0,0,0,0,0,0,0,0,0,53000,0,0,0,93000,40000,53000,53000
059864,亞德客凱基99購01,0,0,0,0,0,0,0,0,0,53000,0,0,0,103000,50000,53000,53000
059925,可成國泰9B購01  ,0,0,0,0,0,0,0,0,0,53000,0,0,0,56000,3000,53000,53000
059934,華通永豐99購02  ,0,0,0,0,0,0,0,0,0,53000,0,0,0,53000,0,53000,53000
061252,臺股指群益9A購03,0,0,0,0,0,0,0,0,0,53000,0,0,0,53000,0,53000,53000
061237,晶技元大9A購01  ,0,0,0,0,0,0,0,0,0,53000,0,0,0,131000,78000,53000,53000
062550,啟碁永豐9B購01  ,0,0,0,0,0,0,0,0,0,53000,0,0,0,53000,0,53000,53000
6024,群益期          ,141000,7000,134000,0,0,0,0,0,0,-81000,0,81000,-81000,0,0,0,53000
9927,泰銘            ,60000,9000,51000,0,0,0,0,0,0,2000,2000,0,2000,0,0,0,53000
07089P,臺指2X中信01售01,0,0,0,0,0,0,0,0,0,52000,0,0,0,226000,174000,52000,52000
06597P,國巨富邦9A售05  ,0,0,0,0,0,0,0,0,0,52000,0,0,0,68000,16000,52000,52000
08231P,上銀元富9B售10  ,0,0,0,0,0,0,0,0,0,52000,0,0,0,72000,20000,52000,52000
1457,宜進            ,57000,12000,45000,0,0,0,0,0,0,7000,7000,0,7000,0,0,0,52000
055934,景碩群益98購03  ,0,0,0,0,0,0,0,0,0,52000,0,0,0,56000,4000,52000,52000
055345,國巨凱基98購01  ,0,0,0,0,0,0,0,0,0,52000,0,0,0,52000,0,52000,52000
053889,致茂群益97購01  ,0,0,0,0,0,0,0,0,0,52000,0,0,0,52000,0,52000,52000
056911,緯穎元大99購01  ,0,0,0,0,0,0,0,0,0,52000,0,0,0,118000,66000,52000,52000
056740,大立光凱基98購13,0,0,0,0,0,0,0,0,0,52000,0,0,0,68000,16000,52000,52000
057619,玉晶光凱基98購02,0,0,0,0,0,0,0,0,0,52000,0,0,0,67000,15000,52000,52000
060470,台勝科元大9A購03,0,0,0,0,0,0,0,0,0,52000,0,0,0,52000,0,52000,52000
06232P,智易永豐97售01  ,0,0,0,0,0,0,0,0,0,52000,0,0,0,52000,0,52000,52000
061948,美食群益9B購01  ,0,0,0,0,0,0,0,0,0,52000,0,0,0,64000,12000,52000,52000
060769,國巨麥證9A購02  ,0,0,0,52000,0,52000,0,0,0,52000,0,0,0,52000,0,52000,52000
3694,海華            ,125000,75000,50000,0,0,0,0,0,0,2000,2000,0,2000,0,0,0,52000
1734,杏輝            ,86000,38000,48000,0,0,0,0,0,0,3000,3000,0,3000,0,0,0,51000
2444,兆勁            ,64000,13000,51000,0,0,0,0,0,0,0,0,0,0,0,0,0,51000
07830P,牧德凱基9A售03  ,0,0,0,0,0,0,0,0,0,51000,0,0,0,51000,0,51000,51000
07819P,旺宏國票9B售01  ,0,0,0,0,0,0,0,0,0,51000,0,0,0,117000,66000,51000,51000
06744P,嘉聯益永豐98售03,0,0,0,0,0,0,0,0,0,51000,0,0,0,81000,30000,51000,51000
06490P,鴻海富邦99售02  ,0,0,0,0,0,0,0,0,0,51000,0,0,0,51000,0,51000,51000
07085P,超眾元富9C售01  ,0,0,0,0,0,0,0,0,0,51000,0,0,0,65000,14000,51000,51000
03438P,群創群益98售03  ,0,0,0,0,0,0,0,0,0,51000,0,0,0,51000,0,51000,51000
056142,超眾元大97購06  ,0,0,0,0,0,0,0,0,0,51000,0,0,0,65000,14000,51000,51000
055860,啟碁元大97購04  ,0,0,0,0,0,0,0,0,0,51000,0,0,0,51000,0,51000,51000
055166,台積電統一97購05,0,0,0,0,0,0,0,0,0,51000,0,0,0,51000,0,51000,51000
056504,國巨永豐98購02  ,0,0,0,0,0,0,0,0,0,51000,0,0,0,51000,0,51000,51000
056526,力山凱基98購01  ,0,0,0,0,0,0,0,0,0,51000,0,0,0,84000,33000,51000,51000
058459,南電永豐99購01  ,0,0,0,0,0,0,0,0,0,51000,0,0,0,51000,0,51000,51000
057858,T50正2康和98購01,0,0,0,0,0,0,0,0,0,51000,0,0,0,51000,0,51000,51000
057859,神達康和98購01  ,0,0,0,0,0,0,0,0,0,51000,0,0,0,79000,28000,51000,51000
057706,臺股指群益98購06,0,0,0,0,0,0,0,0,0,51000,0,0,0,51000,0,51000,51000
058197,國巨中信99購02  ,0,0,0,0,0,0,0,0,0,51000,0,0,0,198000,147000,51000,51000
059870,全新凱基99購05  ,0,0,0,0,0,0,0,0,0,51000,0,0,0,103000,52000,51000,51000
057280,大立光元大98購15,0,0,0,0,0,0,0,0,0,51000,0,0,0,68000,17000,51000,51000
059723,美律元大9A購02  ,0,0,0,0,0,0,0,0,0,51000,0,0,0,56000,5000,51000,51000
061155,華新科群益9A購06,0,0,0,0,0,0,0,0,0,51000,0,0,0,89000,38000,51000,51000
061117,美律國泰9C購01  ,0,0,0,0,0,0,0,0,0,51000,0,0,0,51000,0,51000,51000
062109,聯詠國票9C購01  ,0,0,0,0,0,0,0,0,0,51000,0,0,0,51000,0,51000,51000
063114,南電兆豐9B購01  ,0,0,0,0,0,0,0,0,0,51000,0,0,0,51000,0,51000,51000
062701,漢唐元大9B購01  ,0,0,0,0,0,0,0,0,0,51000,0,0,0,119000,68000,51000,51000
07064P,臺股指元大9A售25,0,0,0,0,0,0,0,0,0,50000,0,0,0,50000,0,50000,50000
07243P,台灣50凱基9A售04,0,0,0,0,0,0,0,0,0,50000,0,0,0,50000,0,50000,50000
06948P,FBVIX元大01售02 ,0,0,0,0,0,0,0,0,0,50000,0,0,0,50000,0,50000,50000
06669P,緯穎凱基98售05  ,0,0,0,0,0,0,0,0,0,50000,0,0,0,50000,0,50000,50000
06599P,宏達電永豐98售02,0,0,0,0,0,0,0,0,0,50000,0,0,0,50000,0,50000,50000
06627P,華新科元富99售01,0,0,0,0,0,0,0,0,0,50000,0,0,0,50000,0,50000,50000
07865P,可成元大9B售02  ,0,0,0,0,0,0,0,0,0,50000,0,0,0,50000,0,50000,50000
07954P,台表科元大9B售02,0,0,0,0,0,0,0,0,0,50000,0,0,0,50000,0,50000,50000
07347P,上証2X凱基99售02,0,0,0,0,0,0,0,0,0,50000,0,0,0,50000,0,50000,50000
07417P,聯發科元大99售44,0,0,0,0,0,0,0,0,0,50000,0,0,0,50000,0,50000,50000
07409P,台積電台新99售07,0,0,0,0,0,0,0,0,0,50000,0,0,0,50000,0,50000,50000
07612P,國巨國泰9B售06  ,0,0,0,0,0,0,0,0,0,50000,0,0,0,160000,110000,50000,50000
056489,S&P反1國泰9A購01,0,0,0,0,0,0,0,0,0,50000,0,0,0,50000,0,50000,50000
054311,世芯凱基96購02  ,0,0,0,0,0,0,0,0,0,50000,0,0,0,90000,40000,50000,50000
055124,建準兆豐97購01  ,0,0,0,0,0,0,0,0,0,50000,0,0,0,50000,0,50000,50000
055737,開發金元富97購01,0,0,0,0,0,0,0,0,0,50000,0,0,0,50000,0,50000,50000
055884,臺股指元富97購01,0,0,0,0,0,0,0,0,0,50000,0,0,0,50000,0,50000,50000
05910P,力山永豐96售02  ,0,0,0,0,0,0,0,0,0,50000,0,0,0,50000,0,50000,50000
059123,訊芯永豐99購03  ,0,0,0,0,0,0,0,0,0,50000,0,0,0,163000,113000,50000,50000
059126,臺指反中信9B購01,0,0,0,0,0,0,0,0,0,50000,0,0,0,50000,0,50000,50000
056160,智易凱基97購03  ,0,0,0,0,0,0,0,0,0,50000,0,0,0,50000,0,50000,50000
056239,宏達電群益98購01,0,0,0,0,0,0,0,0,0,50000,0,0,0,50000,0,50000,50000
056259,T50反1統一9A購01,0,0,0,0,0,0,0,0,0,50000,0,0,0,50000,0,50000,50000
055831,台達電元大97購01,0,0,0,0,0,0,0,0,0,50000,0,0,0,50000,0,50000,50000
056296,旺宏元大97購07  ,0,0,0,0,0,0,0,0,0,50000,0,0,0,50000,0,50000,50000
055951,大成鋼元大97購02,0,0,0,0,0,0,0,0,0,50000,0,0,0,50000,0,50000,50000
056645,大立光凱基98購12,0,0,0,0,0,0,0,0,0,50000,0,0,0,98000,48000,50000,50000
055921,新唐凱基98購01  ,0,0,0,0,0,0,0,0,0,50000,0,0,0,50000,0,50000,50000
051813,GIS凱基96購02   ,0,0,0,0,0,0,0,0,0,50000,0,0,0,50000,0,50000,50000
052223,聯電凱基96購02  ,0,0,0,0,0,0,0,0,0,50000,0,0,0,60000,10000,50000,50000
051260,鴻海永昌96購04  ,0,0,0,0,0,0,0,0,0,50000,0,0,0,50000,0,50000,50000
050400,臻鼎中信97購01  ,0,0,0,0,0,0,0,0,0,50000,0,0,0,50000,0,50000,50000
055425,聚陽群益99購01  ,0,0,0,0,0,0,0,0,0,50000,0,0,0,50000,0,50000,50000
053679,緯創富邦96購01  ,0,0,0,0,0,0,0,0,0,50000,0,0,0,50000,0,50000,50000
056352,鴻海元大99購01  ,0,0,0,0,0,0,0,0,0,50000,0,0,0,152000,102000,50000,50000
052609,智易元大97購01  ,0,0,0,0,0,0,0,0,0,50000,0,0,0,50000,0,50000,50000
052704,TPK國票97購01   ,0,0,0,0,0,0,0,0,0,50000,0,0,0,50000,0,50000,50000
053523,T50反1中信9A購01,0,0,0,0,0,0,0,0,0,50000,0,0,0,50000,0,50000,50000
053459,康控國泰97購01  ,0,0,0,0,0,0,0,0,0,50000,0,0,0,50000,0,50000,50000
053473,聯發科元大96購15,0,0,0,0,0,0,0,0,0,50000,0,0,0,50000,0,50000,50000
059678,鴻海國泰9A購03  ,0,0,0,0,0,0,0,0,0,50000,0,0,0,75000,25000,50000,50000
059626,台積電凱基01購01,0,0,0,0,0,0,0,0,0,50000,0,0,0,50000,0,50000,50000
057990,美律統一99購02  ,0,0,0,0,0,0,0,0,0,50000,0,0,0,109000,59000,50000,50000
058037,台灣50元大9B購02,0,0,0,0,0,0,0,0,0,50000,0,0,0,50000,0,50000,50000
058977,SGBR2X凱基03購01,0,0,0,0,0,0,0,0,0,50000,0,0,0,60000,10000,50000,50000
057171,台光電元大9B購01,0,0,0,0,0,0,0,0,0,50000,0,0,0,55000,5000,50000,50000
057137,鈺齊凱基98購01  ,0,0,0,0,0,0,0,0,0,50000,0,0,0,50000,0,50000,50000
056924,亞光兆豐98購01  ,0,0,0,0,0,0,0,0,0,50000,0,0,0,50000,0,50000,50000
056848,泰鼎元富98購01  ,0,0,0,0,0,0,0,0,0,50000,0,0,0,50000,0,50000,50000
060048,元金2X凱基99購03,0,0,0,0,0,0,0,0,0,50000,0,0,0,50000,0,50000,50000
057040,國巨元大98購12  ,0,0,0,0,0,0,0,0,0,50000,0,0,0,50000,0,50000,50000
057702,同欣電群益99購01,0,0,0,0,0,0,0,0,0,50000,0,0,0,50000,0,50000,50000
058514,潤泰全元大99購01,0,0,0,0,0,0,0,0,0,50000,0,0,0,90000,40000,50000,50000
058672,可成群益9B購02  ,0,0,0,0,0,0,0,0,0,50000,0,0,0,55000,5000,50000,50000
060463,台積電元大9A購10,0,0,0,0,0,0,0,0,0,50000,0,0,0,50000,0,50000,50000
060402,神隆國泰9B購01  ,0,0,0,0,0,0,0,0,0,50000,0,0,0,60000,10000,50000,50000
060231,台積電元大9A購08,0,0,0,0,0,0,0,0,0,50000,0,0,0,50000,0,50000,50000
060131,GIS永豐99購03   ,0,0,0,0,0,0,0,0,0,50000,0,0,0,50000,0,50000,50000
058243,華擎元大99購01  ,0,0,0,0,0,0,0,0,0,50000,0,0,0,60000,10000,50000,50000
057524,旺宏元大99購04  ,0,0,0,0,0,0,0,0,0,50000,0,0,0,50000,0,50000,50000
062818,大立光兆豐9C購01,0,0,0,0,0,0,0,0,0,50000,0,0,0,60000,10000,50000,50000
063017,台光電元大9B購07,0,0,0,0,0,0,0,0,0,50000,0,0,0,51000,1000,50000,50000
063030,華通凱基9B購03  ,0,0,0,0,0,0,0,0,0,50000,0,0,0,70000,20000,50000,50000
061975,華通元大9B購01  ,0,0,0,0,0,0,0,0,0,50000,0,0,0,86000,36000,50000,50000
061102,台積電元大9A購22,0,0,0,0,0,0,0,0,0,50000,0,0,0,50000,0,50000,50000
060905,台積電元大9A購20,0,0,0,0,0,0,0,0,0,50000,0,0,0,50000,0,50000,50000
060857,旭富富邦9B購01  ,0,0,0,0,0,0,0,0,0,50000,0,0,0,110000,60000,50000,50000
060504,技嘉元大9A購02  ,0,0,0,0,0,0,0,0,0,50000,0,0,0,50000,0,50000,50000
3346,麗清            ,60000,11000,49000,0,0,0,0,0,0,1000,1000,0,1000,0,0,0,50000
2530,華建            ,44000,0,44000,0,0,0,0,0,0,5000,5000,0,5000,0,0,0,49000
1444,力麗            ,105000,72000,33000,0,0,0,0,0,0,16000,16000,0,16000,0,0,0,49000
063365,義隆富邦01購01  ,0,0,0,0,0,0,0,0,0,49000,0,0,0,104000,55000,49000,49000
063320,旭富群益9B購03  ,0,0,0,0,0,0,0,0,0,49000,0,0,0,123000,74000,49000,49000
053269,同欣電群益96購01,0,0,0,0,0,0,0,0,0,49000,0,0,0,49000,0,49000,49000
051431,群創元富99購02  ,0,0,0,0,0,0,0,0,0,49000,0,0,0,59000,10000,49000,49000
05790P,臺股指永昌96售07,0,0,0,0,0,0,0,0,0,49000,0,0,0,49000,0,49000,49000
060230,台積電元大9A購07,0,0,0,0,0,0,0,0,0,49000,0,0,0,49000,0,49000,49000
05851P,力山群益97售01  ,0,0,0,0,0,0,0,0,0,49000,0,0,0,109000,60000,49000,49000
058166,鴻海凱基9A購01  ,0,0,0,0,0,0,0,0,0,49000,0,0,0,51000,2000,49000,49000
05789P,臺股指永昌96售06,0,0,0,0,0,0,0,0,0,49000,0,0,0,49000,0,49000,49000
057980,聯詠永豐98購01  ,0,0,0,0,0,0,0,0,0,49000,0,0,0,49000,0,49000,49000
061190,力山永豐9A購02  ,0,0,0,0,0,0,0,0,0,49000,0,0,0,64000,15000,49000,49000
061613,南六統一9C購01  ,0,0,0,0,0,0,0,0,0,49000,0,0,0,403000,354000,49000,49000
061568,國巨元大9A購25  ,0,0,0,0,0,0,0,0,0,49000,0,0,0,74000,25000,49000,49000
061531,奇鋐台新9A購01  ,0,0,0,0,0,0,0,0,0,49000,0,0,0,49000,0,49000,49000
062617,京鼎元大9B購01  ,0,0,0,0,0,0,0,0,0,49000,0,0,0,215000,166000,49000,49000
8454,富邦媒          ,264000,195000,69000,0,0,0,0,43000,-43000,23000,36000,13000,23000,0,0,0,49000
6605,帝寶            ,62000,16000,46000,0,0,0,0,0,0,3000,3000,0,3000,0,0,0,49000
063319,神達群益9B購01  ,0,0,0,0,0,0,0,0,0,48000,0,0,0,165000,117000,48000,48000
08227P,T50反1元大9B售09,0,0,0,0,0,0,0,0,0,48000,0,0,0,50000,2000,48000,48000
1616,億泰            ,49000,1000,48000,0,0,0,0,0,0,0,0,0,0,0,0,0,48000
2852,第一保          ,46000,0,46000,0,0,0,0,0,0,2000,2000,0,2000,0,0,0,48000
2373,震旦行          ,30000,20000,10000,0,0,0,0,0,0,38000,38000,0,38000,0,0,0,48000
07368P,國巨凱基99售19  ,0,0,0,0,0,0,0,0,0,48000,0,0,0,60000,12000,48000,48000
08002P,大毅國票9B售03  ,0,0,0,0,0,0,0,0,0,48000,0,0,0,48000,0,48000,48000
056615,燿華永豐98購02  ,0,0,0,0,0,0,0,0,0,48000,0,0,0,48000,0,48000,48000
056299,友達元大9B購04  ,0,0,0,0,0,0,0,0,0,48000,0,0,0,48000,0,48000,48000
056459,茂林凱基99購01  ,0,0,0,0,0,0,0,0,0,48000,0,0,0,141000,93000,48000,48000
056451,可成凱基99購01  ,0,0,0,0,0,0,0,0,0,48000,0,0,0,48000,0,48000,48000
055358,臻鼎凱基97購01  ,0,0,0,0,0,0,0,0,0,48000,0,0,0,48000,0,48000,48000
060032,利勤永豐99購01  ,0,0,0,0,0,0,0,0,0,48000,0,0,0,124000,76000,48000,48000
059959,訊芯康和99購01  ,0,0,0,0,0,0,0,0,0,48000,0,0,0,61000,13000,48000,48000
060452,儒鴻元大9A購01  ,0,0,0,0,0,0,0,0,0,48000,0,0,0,132000,84000,48000,48000
058293,光寶科凱基9A購01,0,0,0,0,0,0,0,0,0,48000,0,0,0,101000,53000,48000,48000
057490,可成元大98購10  ,0,0,0,0,0,0,0,0,0,48000,0,0,0,78000,30000,48000,48000
060090,台積電元大99購55,0,0,0,0,0,0,0,0,0,48000,0,0,0,48000,0,48000,48000
060987,華新科元大9A購11,0,0,0,0,0,0,0,0,0,48000,0,0,0,56000,8000,48000,48000
062631,奇力新國票9B購01,0,0,0,0,0,0,0,0,0,48000,0,0,0,48000,0,48000,48000
061573,義隆元大9A購02  ,0,0,0,0,0,0,0,0,0,48000,0,0,0,83000,35000,48000,48000
061316,台積電凱基9A購24,0,0,0,0,0,0,0,0,0,48000,0,0,0,50000,2000,48000,48000
06187P,國巨統一97售05  ,0,0,0,0,0,0,0,0,0,48000,0,0,0,48000,0,48000,48000
061868,旺宏元大9B購03  ,0,0,0,0,0,0,0,0,0,48000,0,0,0,48000,0,48000,48000
061048,國巨中信9A購05  ,0,0,0,0,0,0,0,0,0,48000,0,0,0,67000,19000,48000,48000
060604,宏達電凱基9B購01,0,0,0,0,0,0,0,0,0,48000,0,0,0,68000,20000,48000,48000
07902P,玉晶光國票01售01,0,0,0,0,0,0,0,0,0,47000,0,0,0,59000,12000,47000,47000
07821P,臺股指國票9A售12,0,0,0,0,0,0,0,0,0,47000,0,0,0,480000,433000,47000,47000
07305P,T50正2群益99售02,0,0,0,0,0,0,0,0,0,47000,0,0,0,47000,0,47000,47000
2359,所羅門          ,71000,29000,42000,0,0,0,0,0,0,5000,5000,0,5000,0,0,0,47000
2030,彰源            ,43000,0,43000,0,0,0,0,0,0,4000,4000,0,4000,0,0,0,47000
056072,群創元大97購01  ,0,0,0,0,0,0,0,0,0,47000,0,0,0,47000,0,47000,47000
059507,鴻海永豐99購03  ,0,0,0,0,0,0,0,0,0,47000,0,0,0,49000,2000,47000,47000
060960,金像電凱基9B購01,0,0,0,0,0,0,0,0,0,47000,0,0,0,72000,25000,47000,47000
060097,華新科元大99購23,0,0,0,0,0,0,0,0,0,47000,0,0,0,63000,16000,47000,47000
057447,智邦元富02購01  ,0,0,0,0,0,0,0,0,0,47000,0,0,0,48000,1000,47000,47000
057691,健策凱基99購01  ,0,0,0,0,0,0,0,0,0,47000,0,0,0,53000,6000,47000,47000
057728,瑞昱國泰99購01  ,0,0,0,0,0,0,0,0,0,47000,0,0,0,47000,0,47000,47000
059909,鴻海元大99購36  ,0,0,0,0,0,0,0,0,0,47000,0,0,0,57000,10000,47000,47000
056983,大立光群益99購02,0,0,0,0,0,0,0,0,0,47000,0,0,0,88000,41000,47000,47000
056724,臻鼎中信9A購01  ,0,0,0,0,0,0,0,0,0,47000,0,0,0,395000,348000,47000,47000
057242,台郡凱基98購05  ,0,0,0,0,0,0,0,0,0,47000,0,0,0,180000,133000,47000,47000
060623,玉晶光元大9C購01,0,0,0,0,0,0,0,0,0,47000,0,0,0,68000,21000,47000,47000
060781,台郡國泰9B購01  ,0,0,0,0,0,0,0,0,0,47000,0,0,0,50000,3000,47000,47000
062779,台積電元大9B購03,0,0,0,0,0,0,0,0,0,47000,0,0,0,159000,112000,47000,47000
063021,大立光元大9C購05,0,0,0,0,0,0,0,0,0,47000,0,0,0,60000,13000,47000,47000
063173,矽格中信9B購01  ,0,0,0,0,0,0,0,0,0,47000,0,0,0,147000,100000,47000,47000
2233,宇隆            ,103000,63000,40000,0,0,0,0,0,0,6000,6000,0,6000,0,0,0,46000
08058P,華新科元大9B售10,0,0,0,0,0,0,0,0,0,46000,0,0,0,46000,0,46000,46000
063600,燿華凱基9B購04  ,0,0,0,0,0,0,0,0,0,46000,0,0,0,46000,0,46000,46000
056094,大立光元富97購03,0,0,0,0,0,0,0,0,0,46000,0,0,0,46000,0,46000,46000
056124,華通國票98購02  ,0,0,0,0,0,0,0,0,0,46000,0,0,0,54000,8000,46000,46000
056231,嘉聯益凱基97購02,0,0,0,0,0,0,0,0,0,46000,0,0,0,120000,74000,46000,46000
054357,可成兆豐97購02  ,0,0,0,0,0,0,0,0,0,46000,0,0,0,46000,0,46000,46000
056662,臺股指元大9A購09,0,0,0,0,0,0,0,0,0,46000,0,0,0,46000,0,46000,46000
053871,臻鼎元大96購03  ,0,0,0,0,0,0,0,0,0,46000,0,0,0,91000,45000,46000,46000
060040,康控國票99購04  ,0,0,0,0,0,0,0,0,0,46000,0,0,0,56000,10000,46000,46000
059911,國巨元大99購27  ,0,0,0,0,0,0,0,0,0,46000,0,0,0,96000,50000,46000,46000
059816,聯電凱基99購03  ,0,0,0,0,0,0,0,0,0,46000,0,0,0,56000,10000,46000,46000
058173,台積電凱基99購04,0,0,0,0,0,0,0,0,0,46000,0,0,0,46000,0,46000,46000
060253,昇陽半元大9C購01,0,0,0,0,0,0,0,0,0,46000,0,0,0,206000,160000,46000,46000
063230,緯穎群益9B購02  ,0,0,0,0,0,0,0,0,0,46000,0,0,0,76000,30000,46000,46000
062907,可成元大9C購03  ,0,0,0,0,0,0,0,0,0,46000,0,0,0,47000,1000,46000,46000
062851,建準永豐9B購02  ,0,0,0,0,0,0,0,0,0,46000,0,0,0,73000,27000,46000,46000
4426,利勤            ,98000,82000,16000,0,0,0,0,0,0,30000,33000,0,33000,0,3000,-3000,46000
063550,可成國票9C購01  ,0,0,0,0,0,0,0,0,0,45000,0,0,0,45000,0,45000,45000
063739,台勝科元大9B購03,0,0,0,0,0,0,0,0,0,45000,0,0,0,52000,7000,45000,45000
08084P,台表科元大9B售06,0,0,0,0,0,0,0,0,0,45000,0,0,0,50000,5000,45000,45000
07835P,台表科群益9A售02,0,0,0,0,0,0,0,0,0,45000,0,0,0,85000,40000,45000,45000
2114,鑫永銓          ,45000,1000,44000,0,0,0,0,0,0,1000,1000,0,1000,0,0,0,45000
2642,宅配通          ,196000,75000,121000,0,0,0,0,0,0,-76000,1000,77000,-76000,0,0,0,45000
1773,勝一            ,73000,28000,45000,0,0,0,0,0,0,0,1000,1000,0,0,0,0,45000
1506,正道            ,49000,4000,45000,0,0,0,0,0,0,0,0,0,0,0,0,0,45000
054065,樺漢國票97購01  ,0,0,0,0,0,0,0,0,0,45000,0,0,0,45000,0,45000,45000
051101,台表科元大96購02,0,0,0,0,0,0,0,0,0,45000,0,0,0,45000,0,45000,45000
055473,禾伸堂凱基97購01,0,0,0,0,0,0,0,0,0,45000,0,0,0,45000,0,45000,45000
052447,聯發科元大96購04,0,0,0,0,0,0,0,0,0,45000,0,0,0,50000,5000,45000,45000
055291,京鼎元大97購02  ,0,0,0,0,0,0,0,0,0,45000,0,0,0,117000,72000,45000,45000
055075,南電永豐97購01  ,0,0,0,0,0,0,0,0,0,45000,0,0,0,50000,5000,45000,45000
058150,中502X統一9B購01,0,0,0,0,0,0,0,0,0,45000,0,0,0,45000,0,45000,45000
057909,台光電兆豐98購01,0,0,0,0,0,0,0,0,0,45000,0,0,0,45000,0,45000,45000
057662,上銀元大9A購01  ,0,0,0,0,0,0,0,0,0,45000,0,0,0,45000,0,45000,45000
057311,玉晶光日盛9A購01,0,0,0,0,0,0,0,0,0,45000,0,0,0,45000,0,45000,45000
062679,技嘉統一01購01  ,0,0,0,0,0,0,0,0,0,45000,0,0,0,165000,120000,45000,45000
062160,南六凱基9B購01  ,0,0,0,0,0,0,0,0,0,45000,0,0,0,133000,88000,45000,45000
062446,聯詠元大9B購02  ,0,0,0,0,0,0,0,0,0,45000,0,0,0,118000,73000,45000,45000
061065,神基凱基9A購01  ,0,0,0,0,0,0,0,0,0,45000,0,0,0,50000,5000,45000,45000
060897,健策凱基9A購04  ,0,0,0,0,0,0,0,0,0,45000,0,0,0,46000,1000,45000,45000
4164,承業醫          ,57000,8000,49000,0,0,0,0,0,0,-4000,3000,7000,-4000,0,0,0,45000
3501,維熹            ,22000,0,22000,0,0,0,0,0,0,23000,23000,0,23000,0,0,0,45000
6277,宏正            ,62000,37000,25000,0,0,0,0,0,0,20000,20000,0,20000,0,0,0,45000
2477,美隆電          ,11000,1000,10000,0,0,0,0,0,0,34000,34000,0,34000,0,0,0,44000
08063P,立積國票9B售03  ,0,0,0,0,0,0,0,0,0,44000,0,0,0,89000,45000,44000,44000
08018P,牧德國票9B售04  ,0,0,0,0,0,0,0,0,0,44000,0,0,0,64000,20000,44000,44000
063654,上銀元富9B購05  ,0,0,0,0,0,0,0,0,0,44000,0,0,0,50000,6000,44000,44000
06801P,技嘉群益99售02  ,0,0,0,0,0,0,0,0,0,44000,0,0,0,52000,8000,44000,44000
07192P,聯發科元大99售23,0,0,0,0,0,0,0,0,0,44000,0,0,0,44000,0,44000,44000
054704,玉晶光第一97購01,0,0,0,0,0,0,0,0,0,44000,0,0,0,44000,0,44000,44000
055755,禾伸堂兆豐97購02,0,0,0,0,0,0,0,0,0,44000,0,0,0,94000,50000,44000,44000
056297,台光電元大97購04,0,0,0,0,0,0,0,0,0,44000,0,0,0,51000,7000,44000,44000
052468,超眾統一96購02  ,0,0,0,0,0,0,0,0,0,44000,0,0,0,272000,228000,44000,44000
054167,揚明光凱基98購01,0,0,0,0,0,0,0,0,0,44000,0,0,0,50000,6000,44000,44000
059443,嘉聯益元大9B購01,0,0,0,0,0,0,0,0,0,44000,0,0,0,55000,11000,44000,44000
058207,南茂凱基99購01  ,0,0,0,0,0,0,0,0,0,44000,0,0,0,172000,128000,44000,44000
057494,玉晶光元大99購09,0,0,0,0,0,0,0,0,0,44000,0,0,0,125000,81000,44000,44000
058342,鴻海群益9A購01  ,0,0,0,0,0,0,0,0,0,44000,0,0,0,48000,4000,44000,44000
060607,玉晶光凱基9A購06,0,0,0,0,0,0,0,0,0,44000,0,0,0,83000,39000,44000,44000
062349,新日興群益9B購02,0,0,0,0,0,0,0,0,0,44000,0,0,0,138000,94000,44000,44000
062911,聯詠元大9B購03  ,0,0,0,0,0,0,0,0,0,44000,0,0,0,227000,183000,44000,44000
6552,易華電          ,112000,71000,41000,0,0,0,0,0,0,3000,1000,0,1000,2000,0,2000,44000
8210,勤誠            ,245000,238000,7000,0,0,0,0,0,0,37000,24000,0,24000,16000,3000,13000,44000
4763,材料-KY         ,10000,10000,0,0,0,0,0,0,0,44000,44000,0,44000,0,0,0,44000
07276P,臺股指群益99售19,0,0,0,0,0,0,0,0,0,43000,0,0,0,100000,57000,43000,43000
07077P,緯穎凱基99售01  ,0,0,0,0,0,0,0,0,0,43000,0,0,0,43000,0,43000,43000
063755,上銀統一9C購03  ,0,0,0,0,0,0,0,0,0,43000,0,0,0,43000,0,43000,43000
063459,華通元大9B購08  ,0,0,0,0,0,0,0,0,0,43000,0,0,0,45000,2000,43000,43000
1540,喬福            ,41000,0,41000,0,0,0,0,0,0,2000,2000,0,2000,0,0,0,43000
045055,聯發科元富98購03,0,0,0,0,0,0,0,0,0,43000,0,0,0,43000,0,43000,43000
058320,華新科永豐99購02,0,0,0,0,0,0,0,0,0,43000,0,0,0,114000,71000,43000,43000
057548,微星凱基99購01  ,0,0,0,0,0,0,0,0,0,43000,0,0,0,55000,12000,43000,43000
057849,南茂永豐98購02  ,0,0,0,0,0,0,0,0,0,43000,0,0,0,55000,12000,43000,43000
057774,台光電群益99購02,0,0,0,0,0,0,0,0,0,43000,0,0,0,76000,33000,43000,43000
058533,玉晶光元富99購01,0,0,0,0,0,0,0,0,0,43000,0,0,0,108000,65000,43000,43000
062671,國泰金中信03購01,0,0,0,0,0,0,0,0,0,43000,0,0,0,68000,25000,43000,43000
062973,聯發科元富05購01,0,0,0,0,0,0,0,0,0,43000,0,0,0,53000,10000,43000,43000
062119,世紀鋼中信9B購01,0,0,0,0,0,0,0,0,0,43000,0,0,0,43000,0,43000,43000
060577,玉晶光中信9A購02,0,0,0,0,0,0,0,0,0,43000,0,0,0,68000,25000,43000,43000
060501,鴻海元大9A購13  ,0,0,0,0,0,0,0,0,0,43000,0,0,0,70000,27000,43000,43000
061934,台積電國票9B購06,0,0,0,0,0,0,0,0,0,43000,0,0,0,43000,0,43000,43000
061475,漢唐元大9A購01  ,0,0,0,0,0,0,0,0,0,43000,0,0,0,50000,7000,43000,43000
6115,鎰勝            ,18000,11000,7000,0,0,0,0,0,0,36000,36000,0,36000,0,0,0,43000
3266,昇陽            ,44000,1000,43000,0,0,0,0,0,0,0,0,0,0,0,0,0,43000
06803P,臺股指群益98售09,0,0,0,0,0,0,0,0,0,42000,0,0,0,42000,0,42000,42000
06850P,聯茂元大98售06  ,0,0,0,0,0,0,0,0,0,42000,0,0,0,60000,18000,42000,42000
06636P,可成凱基98售08  ,0,0,0,0,0,0,0,0,0,42000,0,0,0,43000,1000,42000,42000
050992,台積電元大97購01,0,0,0,0,0,0,0,0,0,42000,0,0,0,43000,1000,42000,42000
00665L,富邦恒生國企正2 ,251000,270000,-19000,0,0,0,0,0,0,61000,0,0,0,450000,389000,61000,42000
0061,元大寶滬深      ,117000,40000,77000,0,0,0,0,0,0,-35000,0,60000,-60000,83000,58000,25000,42000
056523,光寶科中信98購01,0,0,0,0,0,0,0,0,0,42000,0,0,0,91000,49000,42000,42000
057856,聯鈞國票99購03  ,0,0,0,0,0,0,0,0,0,42000,0,0,0,80000,38000,42000,42000
057727,華邦電國泰9A購01,0,0,0,0,0,0,0,0,0,42000,0,0,0,188000,146000,42000,42000
057506,聯鈞國票99購02  ,0,0,0,0,0,0,0,0,0,42000,0,0,0,80000,38000,42000,42000
058231,技嘉元大99購02  ,0,0,0,0,0,0,0,0,0,42000,0,0,0,44000,2000,42000,42000
060212,華航康和9A購01  ,0,0,0,0,0,0,0,0,0,42000,0,0,0,50000,8000,42000,42000
060400,南電國票9A購03  ,0,0,0,0,0,0,0,0,0,42000,0,0,0,42000,0,42000,42000
05971P,世紀鋼永豐96售04,0,0,0,0,0,0,0,0,0,42000,0,0,0,42000,0,42000,42000
060017,全新康和99購01  ,0,0,0,0,0,0,0,0,0,42000,0,0,0,80000,38000,42000,42000
06145P,華新科永豐97售02,0,0,0,0,0,0,0,0,0,42000,0,0,0,42000,0,42000,42000
062224,玉晶光統一9C購03,0,0,0,0,0,0,0,0,0,42000,0,0,0,219000,177000,42000,42000
061951,南電群益9B購01  ,0,0,0,0,0,0,0,0,0,42000,0,0,0,82000,40000,42000,42000
06487P,聯發科統一99售02,0,0,0,0,0,0,0,0,0,41000,0,0,0,108000,67000,41000,41000
063389,大立光兆豐9C購02,0,0,0,0,0,0,0,0,0,41000,0,0,0,102000,61000,41000,41000
1323,永裕            ,53000,14000,39000,0,0,0,0,0,0,2000,2000,0,2000,0,0,0,41000
2423,固緯            ,41000,4000,37000,0,0,0,0,0,0,4000,4000,0,4000,0,0,0,41000
054055,全新國票99購02  ,0,0,0,0,0,0,0,0,0,41000,0,0,0,41000,0,41000,41000
055439,台表科國票98購02,0,0,0,0,0,0,0,0,0,41000,0,0,0,52000,11000,41000,41000
056936,禾伸堂元富98購01,0,0,0,0,0,0,0,0,0,41000,0,0,0,47000,6000,41000,41000
059885,台積電國票99購12,0,0,0,0,0,0,0,0,0,41000,0,0,0,47000,6000,41000,41000
059987,大立光元大99購28,0,0,0,0,0,0,0,0,0,41000,0,0,0,47000,6000,41000,41000
056962,技嘉永豐98購01  ,0,0,0,0,0,0,0,0,0,41000,0,0,0,52000,11000,41000,41000
057941,聯電國票99購01  ,0,0,0,0,0,0,0,0,0,41000,0,0,0,41000,0,41000,41000
060065,大立光兆豐9B購01,0,0,0,0,0,0,0,0,0,41000,0,0,0,47000,6000,41000,41000
057530,奇鋐元大99購01  ,0,0,0,0,0,0,0,0,0,41000,0,0,0,90000,49000,41000,41000
058447,玉晶光富邦9A購02,0,0,0,0,0,0,0,0,0,41000,0,0,0,62000,21000,41000,41000
062068,滬深2X元大9B購02,0,0,0,0,0,0,0,0,0,41000,0,0,0,41000,0,41000,41000
062385,玉晶光國泰01購01,0,0,0,0,0,0,0,0,0,41000,0,0,0,543000,502000,41000,41000
062406,臻鼎永豐9B購01  ,0,0,0,0,0,0,0,0,0,41000,0,0,0,66000,25000,41000,41000
061515,泰碩永豐9A購03  ,0,0,0,0,0,0,0,0,0,41000,0,0,0,171000,130000,41000,41000
061925,禾伸堂凱基9C購01,0,0,0,0,0,0,0,0,0,41000,0,0,0,41000,0,41000,41000
061634,遠東新元大9A購01,0,0,0,0,0,0,0,0,0,41000,0,0,0,185000,144000,41000,41000
6215,和椿            ,40000,0,40000,0,0,0,0,0,0,1000,1000,0,1000,0,0,0,41000
8070,長華*           ,33000,2000,31000,0,0,0,0,0,0,10000,10000,0,10000,0,0,0,41000
08066P,南亞科凱基9B售04,0,0,0,0,0,0,0,0,0,40000,0,0,0,133000,93000,40000,40000
08083P,健策元大9C售05  ,0,0,0,0,0,0,0,0,0,40000,0,0,0,40000,0,40000,40000
07319P,台積電凱基01售02,0,0,0,0,0,0,0,0,0,40000,0,0,0,90000,50000,40000,40000
07560P,台積電國泰9B售01,0,0,0,0,0,0,0,0,0,40000,0,0,0,49000,9000,40000,40000
06382P,大毅元富97售02  ,0,0,0,0,0,0,0,0,0,40000,0,0,0,40000,0,40000,40000
06613P,華新科富邦9A售03,0,0,0,0,0,0,0,0,0,40000,0,0,0,40000,0,40000,40000
06681P,致茂元大98售02  ,0,0,0,0,0,0,0,0,0,40000,0,0,0,65000,25000,40000,40000
055422,康控永豐97購01  ,0,0,0,0,0,0,0,0,0,40000,0,0,0,40000,0,40000,40000
053632,新唐兆豐96購01  ,0,0,0,0,0,0,0,0,0,40000,0,0,0,40000,0,40000,40000
053018,旺宏元富96購02  ,0,0,0,0,0,0,0,0,0,40000,0,0,0,40000,0,40000,40000
053307,泰碩凱基97購01  ,0,0,0,0,0,0,0,0,0,40000,0,0,0,40000,0,40000,40000
053371,滬深2X元大99購01,0,0,0,0,0,0,0,0,0,40000,0,0,0,40000,0,40000,40000
053595,創意元大96購02  ,0,0,0,0,0,0,0,0,0,40000,0,0,0,40000,0,40000,40000
053995,奇力新群益97購02,0,0,0,0,0,0,0,0,0,40000,0,0,0,40000,0,40000,40000
051756,台積電元大97購04,0,0,0,0,0,0,0,0,0,40000,0,0,0,40000,0,40000,40000
0051,元大中型100     ,1000,0,1000,0,0,0,0,0,0,39000,0,0,0,39000,0,39000,40000
056540,聯詠凱基98購02  ,0,0,0,0,0,0,0,0,0,40000,0,0,0,40000,0,40000,40000
055647,義隆元富97購01  ,0,0,0,0,0,0,0,0,0,40000,0,0,0,40000,0,40000,40000
05642P,玉晶光兆豐97售02,0,0,0,0,0,0,0,0,0,40000,0,0,0,40000,0,40000,40000
054773,台郡國票98購01  ,0,0,0,0,0,0,0,0,0,40000,0,0,0,40000,0,40000,40000
054742,京鼎凱基99購01  ,0,0,0,0,0,0,0,0,0,40000,0,0,0,43000,3000,40000,40000
056157,聯詠凱基97購03  ,0,0,0,0,0,0,0,0,0,40000,0,0,0,40000,0,40000,40000
056041,禾伸堂凱基98購03,0,0,0,0,0,0,0,0,0,40000,0,0,0,40000,0,40000,40000
056044,同欣電凱基97購03,0,0,0,0,0,0,0,0,0,40000,0,0,0,60000,20000,40000,40000
059538,健策凱基99購03  ,0,0,0,0,0,0,0,0,0,40000,0,0,0,40000,0,40000,40000
058723,元石油國泰9A購01,0,0,0,0,0,0,0,0,0,40000,0,0,0,40000,0,40000,40000
058519,嘉澤元大99購01  ,0,0,0,0,0,0,0,0,0,40000,0,0,0,50000,10000,40000,40000
058674,宏達電群益99購01,0,0,0,0,0,0,0,0,0,40000,0,0,0,40000,0,40000,40000
058619,台灣50國票99購04,0,0,0,0,0,0,0,0,0,40000,0,0,0,40000,0,40000,40000
057726,華通國泰9A購01  ,0,0,0,0,0,0,0,0,0,40000,0,0,0,40000,0,40000,40000
057767,緯穎凱基98購06  ,0,0,0,0,0,0,0,0,0,40000,0,0,0,44000,4000,40000,40000
057438,禾伸堂國票99購01,0,0,0,0,0,0,0,0,0,40000,0,0,0,40000,0,40000,40000
057456,道瓊銀富邦9C購01,0,0,0,0,0,0,0,0,0,40000,0,0,0,40000,0,40000,40000
057472,T50正2元大9B購03,0,0,0,0,0,0,0,0,0,40000,0,0,0,40000,0,40000,40000
057164,國巨元大98購14  ,0,0,0,0,0,0,0,0,0,40000,0,0,0,50000,10000,40000,40000
057963,緯穎元大98購08  ,0,0,0,0,0,0,0,0,0,40000,0,0,0,50000,10000,40000,40000
058791,鴻海元大99購17  ,0,0,0,0,0,0,0,0,0,40000,0,0,0,42000,2000,40000,40000
058961,台灣50兆豐9C購01,0,0,0,0,0,0,0,0,0,40000,0,0,0,840000,800000,40000,40000
059676,台積電台新99購05,0,0,0,0,0,0,0,0,0,40000,0,0,0,40000,0,40000,40000
056968,揚明光永豐98購02,0,0,0,0,0,0,0,0,0,40000,0,0,0,40000,0,40000,40000
059910,鴻海元大99購37  ,0,0,0,0,0,0,0,0,0,40000,0,0,0,84000,44000,40000,40000
059928,道瓊銀富邦03購01,0,0,0,0,0,0,0,0,0,40000,0,0,0,58000,18000,40000,40000
056847,佐登元富98購01  ,0,0,0,0,0,0,0,0,0,40000,0,0,0,40000,0,40000,40000
056821,日電貿永豐98購01,0,0,0,0,0,0,0,0,0,40000,0,0,0,80000,40000,40000,40000
061933,光寶科國票9B購01,0,0,0,0,0,0,0,0,0,40000,0,0,0,42000,2000,40000,40000
060992,健策元大9A購05  ,0,0,0,0,0,0,0,0,0,40000,0,0,0,40000,0,40000,40000
060870,旭富群益9A購01  ,0,0,0,0,0,0,0,0,0,40000,0,0,0,199000,159000,40000,40000
062357,國巨元大9B購11  ,0,0,0,0,0,0,0,0,0,40000,0,0,0,40000,0,40000,40000
062944,茂林凱基9B購02  ,0,0,0,0,0,0,0,0,0,40000,0,0,0,40000,0,40000,40000
062655,漢唐永豐9B購01  ,0,0,0,0,0,0,0,0,0,40000,0,0,0,40000,0,40000,40000
062741,立積國票9B購02  ,0,0,0,0,0,0,0,0,0,40000,0,0,0,40000,0,40000,40000
06277P,臺股指凱基97售09,0,0,0,0,0,0,0,0,0,40000,0,0,0,41000,1000,40000,40000
06735P,奇力新凱基98售07,0,0,0,0,0,0,0,0,0,39000,0,0,0,39000,0,39000,39000
07145P,為升元大99售03  ,0,0,0,0,0,0,0,0,0,39000,0,0,0,39000,0,39000,39000
07710P,華擎元大9A售05  ,0,0,0,0,0,0,0,0,0,39000,0,0,0,69000,30000,39000,39000
07466P,亞德客元大9A售02,0,0,0,0,0,0,0,0,0,39000,0,0,0,65000,26000,39000,39000
08150P,立積國票9C售01  ,0,0,0,0,0,0,0,0,0,39000,0,0,0,52000,13000,39000,39000
2459,敦吉            ,81000,60000,21000,0,0,0,0,0,0,18000,18000,0,18000,0,0,0,39000
2701,萬企            ,34000,0,34000,0,0,0,0,0,0,5000,5000,0,5000,0,0,0,39000
1231,聯華食          ,50000,13000,37000,0,0,0,0,0,0,2000,2000,0,2000,0,0,0,39000
055707,聯鈞永豐98購01  ,0,0,0,0,0,0,0,0,0,39000,0,0,0,39000,0,39000,39000
055726,台表科元大98購03,0,0,0,0,0,0,0,0,0,39000,0,0,0,59000,20000,39000,39000
055618,麗豐國票98購01  ,0,0,0,0,0,0,0,0,0,39000,0,0,0,114000,75000,39000,39000
051382,玉晶光群益98購02,0,0,0,0,0,0,0,0,0,39000,0,0,0,114000,75000,39000,39000
051728,道瓊反國票97購01,0,0,0,0,0,0,0,0,0,39000,0,0,0,48000,9000,39000,39000
052733,台郡國泰97購01  ,0,0,0,0,0,0,0,0,0,39000,0,0,0,54000,15000,39000,39000
052847,漢唐統一99購01  ,0,0,0,0,0,0,0,0,0,39000,0,0,0,39000,0,39000,39000
054265,GIS元大96購03   ,0,0,0,0,0,0,0,0,0,39000,0,0,0,39000,0,39000,39000
058895,鴻海元大99購20  ,0,0,0,0,0,0,0,0,0,39000,0,0,0,41000,2000,39000,39000
060310,瑞昱永豐9A購01  ,0,0,0,0,0,0,0,0,0,39000,0,0,0,39000,0,39000,39000
058684,健策凱基99購02  ,0,0,0,0,0,0,0,0,0,39000,0,0,0,47000,8000,39000,39000
060744,鴻海國票9A購04  ,0,0,0,0,0,0,0,0,0,39000,0,0,0,158000,119000,39000,39000
061681,南電元大9A購08  ,0,0,0,0,0,0,0,0,0,39000,0,0,0,41000,2000,39000,39000
061492,超眾兆豐9B購01  ,0,0,0,0,0,0,0,0,0,39000,0,0,0,482000,443000,39000,39000
3679,新至陞          ,28000,0,28000,0,0,0,0,0,0,11000,11000,0,11000,0,0,0,39000
1316,上曜            ,34000,0,34000,0,0,0,0,0,0,4000,5000,1000,4000,0,0,0,38000
1708,東鹼            ,67000,31000,36000,0,0,0,0,0,0,2000,2000,0,2000,0,0,0,38000
2013,中鋼構          ,42000,8000,34000,0,0,0,0,0,0,4000,4000,0,4000,0,0,0,38000
2706,第一店          ,38000,0,38000,0,0,0,0,0,0,0,0,0,0,0,0,0,38000
07712P,茂林元大9A售03  ,0,0,0,0,0,0,0,0,0,38000,0,0,0,38000,0,38000,38000
07670P,茂林元大9A售02  ,0,0,0,0,0,0,0,0,0,38000,0,0,0,138000,100000,38000,38000
07267P,臺股指元大99售23,0,0,0,0,0,0,0,0,0,38000,0,0,0,40000,2000,38000,38000
07233P,台灣50元大99售04,0,0,0,0,0,0,0,0,0,38000,0,0,0,40000,2000,38000,38000
06626P,大立光統一9A售01,0,0,0,0,0,0,0,0,0,38000,0,0,0,38000,0,38000,38000
063489,新日興國泰01購01,0,0,0,0,0,0,0,0,0,38000,0,0,0,88000,50000,38000,38000
063499,金像電永豐9B購03,0,0,0,0,0,0,0,0,0,38000,0,0,0,71000,33000,38000,38000
063271,中磊兆豐9C購01  ,0,0,0,0,0,0,0,0,0,38000,0,0,0,72000,34000,38000,38000
056670,樺漢國票99購01  ,0,0,0,0,0,0,0,0,0,38000,0,0,0,153000,115000,38000,38000
053050,華通國票97購02  ,0,0,0,0,0,0,0,0,0,38000,0,0,0,38000,0,38000,38000
054211,奇鋐國票97購03  ,0,0,0,0,0,0,0,0,0,38000,0,0,0,79000,41000,38000,38000
052703,貿聯國票97購01  ,0,0,0,0,0,0,0,0,0,38000,0,0,0,38000,0,38000,38000
053522,臺股指群益99購01,0,0,0,0,0,0,0,0,0,38000,0,0,0,38000,0,38000,38000
054057,晶豪科國票97購01,0,0,0,0,0,0,0,0,0,38000,0,0,0,38000,0,38000,38000
053928,智易國票97購03  ,0,0,0,0,0,0,0,0,0,38000,0,0,0,38000,0,38000,38000
046385,群創凱基98購03  ,0,0,0,0,0,0,0,0,0,38000,0,0,0,38000,0,38000,38000
050416,高股息凱基96購02,0,0,0,0,0,0,0,0,0,38000,0,0,0,38000,0,38000,38000
055776,宏達電凱基98購02,0,0,0,0,0,0,0,0,0,38000,0,0,0,48000,10000,38000,38000
056054,亞德客元大97購05,0,0,0,0,0,0,0,0,0,38000,0,0,0,88000,50000,38000,38000
055949,亞德客元大97購04,0,0,0,0,0,0,0,0,0,38000,0,0,0,71000,33000,38000,38000
056251,聯發科兆豐97購02,0,0,0,0,0,0,0,0,0,38000,0,0,0,38000,0,38000,38000
058525,台虹元大99購02  ,0,0,0,0,0,0,0,0,0,38000,0,0,0,38000,0,38000,38000
058146,勤誠元大99購01  ,0,0,0,0,0,0,0,0,0,38000,0,0,0,163000,125000,38000,38000
060303,宏達電富邦9B購01,0,0,0,0,0,0,0,0,0,38000,0,0,0,321000,283000,38000,38000
056681,鴻海統一98購09  ,0,0,0,0,0,0,0,0,0,38000,0,0,0,46000,8000,38000,38000
057110,立積群益98購01  ,0,0,0,0,0,0,0,0,0,38000,0,0,0,98000,60000,38000,38000
061463,智邦群益9A購02  ,0,0,0,0,0,0,0,0,0,38000,0,0,0,151000,113000,38000,38000
061767,信邦元大9B購01  ,0,0,0,0,0,0,0,0,0,38000,0,0,0,169000,131000,38000,38000
060816,世紀鋼凱基9C購02,0,0,0,0,0,0,0,0,0,38000,0,0,0,40000,2000,38000,38000
060748,臻鼎國票9A購01  ,0,0,0,0,0,0,0,0,0,38000,0,0,0,38000,0,38000,38000
060597,華通凱基9A購04  ,0,0,0,0,0,0,0,0,0,38000,0,0,0,38000,0,38000,38000
063105,健策群益9C購01  ,0,0,0,0,0,0,0,0,0,38000,0,0,0,43000,5000,38000,38000
062318,台郡凱基9B購01  ,0,0,0,0,0,0,0,0,0,38000,0,0,0,84000,46000,38000,38000
062151,世紀鋼國票01購01,0,0,0,0,0,0,0,0,0,38000,0,0,0,38000,0,38000,38000
4989,榮科            ,35000,0,35000,0,0,0,0,0,0,3000,3000,0,3000,0,0,0,38000
063328,京元電國票9C購02,0,0,0,0,0,0,0,0,0,37000,0,0,0,97000,60000,37000,37000
07228P,台灣50群益9B售06,0,0,0,0,0,0,0,0,0,37000,0,0,0,64000,27000,37000,37000
07943P,瑞昱元大9B售02  ,0,0,0,0,0,0,0,0,0,37000,0,0,0,37000,0,37000,37000
2611,志信            ,35000,0,35000,0,0,0,0,0,0,2000,2000,0,2000,0,0,0,37000
2009,第一銅          ,33000,0,33000,0,0,0,0,0,0,4000,4000,0,4000,0,0,0,37000
1737,臺鹽            ,53000,8000,45000,0,0,0,0,0,0,-8000,0,8000,-8000,0,0,0,37000
08196P,上銀元大9B售07  ,0,0,0,0,0,0,0,0,0,37000,0,0,0,37000,0,37000,37000
055960,義隆元大97購01  ,0,0,0,0,0,0,0,0,0,37000,0,0,0,67000,30000,37000,37000
055097,福懋科群益97購01,0,0,0,0,0,0,0,0,0,37000,0,0,0,37000,0,37000,37000
054425,聯發科富邦99購03,0,0,0,0,0,0,0,0,0,37000,0,0,0,37000,0,37000,37000
054479,緯創中信98購01  ,0,0,0,0,0,0,0,0,0,37000,0,0,0,54000,17000,37000,37000
00681R,元大美債20反1   ,41000,0,41000,0,0,0,0,0,0,-4000,0,0,0,4000,8000,-4000,37000
051428,玉晶光統一96購01,0,0,0,0,0,0,0,0,0,37000,0,0,0,110000,73000,37000,37000
053643,漢唐國票97購02  ,0,0,0,0,0,0,0,0,0,37000,0,0,0,37000,0,37000,37000
055476,台郡凱基97購02  ,0,0,0,0,0,0,0,0,0,37000,0,0,0,47000,10000,37000,37000
056993,GIS兆豐99購01   ,0,0,0,0,0,0,0,0,0,37000,0,0,0,47000,10000,37000,37000
057302,福懋科中信98購01,0,0,0,0,0,0,0,0,0,37000,0,0,0,37000,0,37000,37000
059786,全新元大99購06  ,0,0,0,0,0,0,0,0,0,37000,0,0,0,179000,142000,37000,37000
059660,華新科元大9A購04,0,0,0,0,0,0,0,0,0,37000,0,0,0,52000,15000,37000,37000
057270,遠東新元大98購01,0,0,0,0,0,0,0,0,0,37000,0,0,0,37000,0,37000,37000
059250,大立光凱基99購06,0,0,0,0,0,0,0,0,0,37000,0,0,0,44000,7000,37000,37000
058751,南茂凱基9A購01  ,0,0,0,0,0,0,0,0,0,37000,0,0,0,106000,69000,37000,37000
062444,大立光元大9C購01,0,0,0,0,0,0,0,0,0,37000,0,0,0,37000,0,37000,37000
062449,臻鼎元大9B購01  ,0,0,0,0,0,0,0,0,0,37000,0,0,0,87000,50000,37000,37000
062593,健策統一9B購03  ,0,0,0,0,0,0,0,0,0,37000,0,0,0,54000,17000,37000,37000
1442,名軒            ,33000,3000,30000,0,0,0,0,0,0,6000,6000,0,6000,0,0,0,36000
07709P,創意元大9A售01  ,0,0,0,0,0,0,0,0,0,36000,0,0,0,36000,0,36000,36000
06882P,聯發科群益98售07,0,0,0,0,0,0,0,0,0,36000,0,0,0,36000,0,36000,36000
056347,GIS凱基9A購01   ,0,0,0,0,0,0,0,0,0,36000,0,0,0,36000,0,36000,36000
054565,玉晶光群益99購02,0,0,0,0,0,0,0,0,0,36000,0,0,0,52000,16000,36000,36000
05524P,瀚宇博國票97售02,0,0,0,0,0,0,0,0,0,36000,0,0,0,36000,0,36000,36000
056051,T50反1元大97購05,0,0,0,0,0,0,0,0,0,36000,0,0,0,36000,0,36000,36000
059340,鴻海凱基9A購12  ,0,0,0,0,0,0,0,0,0,36000,0,0,0,128000,92000,36000,36000
060221,大立光凱基9A購07,0,0,0,0,0,0,0,0,0,36000,0,0,0,36000,0,36000,36000
057919,技嘉凱基98購03  ,0,0,0,0,0,0,0,0,0,36000,0,0,0,40000,4000,36000,36000
059728,聯鈞元大99購01  ,0,0,0,0,0,0,0,0,0,36000,0,0,0,60000,24000,36000,36000
058086,鴻海元大98購14  ,0,0,0,0,0,0,0,0,0,36000,0,0,0,39000,3000,36000,36000
058129,國巨元大99購10  ,0,0,0,0,0,0,0,0,0,36000,0,0,0,116000,80000,36000,36000
062356,國巨元大9B購10  ,0,0,0,0,0,0,0,0,0,36000,0,0,0,36000,0,36000,36000
062009,聯發科國泰01購01,0,0,0,0,0,0,0,0,0,36000,0,0,0,73000,37000,36000,36000
060826,牧德元大9B購02  ,0,0,0,0,0,0,0,0,0,36000,0,0,0,36000,0,36000,36000
6192,巨路            ,38000,4000,34000,0,0,0,0,0,0,2000,2000,0,2000,0,0,0,36000
9905,大華            ,46000,16000,30000,0,0,0,0,0,0,6000,6000,0,6000,0,0,0,36000
06972P,聯發科元大99售04,0,0,0,0,0,0,0,0,0,35000,0,0,0,35000,0,35000,35000
07016P,聯發科元大99售10,0,0,0,0,0,0,0,0,0,35000,0,0,0,35000,0,35000,35000
063252,緯穎元大9B購07  ,0,0,0,0,0,0,0,0,0,35000,0,0,0,149000,114000,35000,35000
07844P,可成國票9A售01  ,0,0,0,0,0,0,0,0,0,35000,0,0,0,67000,32000,35000,35000
056014,上銀群益97購02  ,0,0,0,0,0,0,0,0,0,35000,0,0,0,50000,15000,35000,35000
055989,矽力元富9A購01  ,0,0,0,0,0,0,0,0,0,35000,0,0,0,100000,65000,35000,35000
055149,國巨元大97購06  ,0,0,0,0,0,0,0,0,0,35000,0,0,0,35000,0,35000,35000
054558,劍麟群益99購01  ,0,0,0,0,0,0,0,0,0,35000,0,0,0,145000,110000,35000,35000
054317,昇陽半凱基98購01,0,0,0,0,0,0,0,0,0,35000,0,0,0,90000,55000,35000,35000
056482,貿聯元大99購01  ,0,0,0,0,0,0,0,0,0,35000,0,0,0,35000,0,35000,35000
056669,貿聯國票99購01  ,0,0,0,0,0,0,0,0,0,35000,0,0,0,35000,0,35000,35000
055499,大立光元大98購05,0,0,0,0,0,0,0,0,0,35000,0,0,0,35000,0,35000,35000
055558,大立光凱基97購08,0,0,0,0,0,0,0,0,0,35000,0,0,0,35000,0,35000,35000
053647,臺股指國票96購10,0,0,0,0,0,0,0,0,0,35000,0,0,0,35000,0,35000,35000
053561,玉晶光國泰98購01,0,0,0,0,0,0,0,0,0,35000,0,0,0,40000,5000,35000,35000
052231,景碩凱基96購01  ,0,0,0,0,0,0,0,0,0,35000,0,0,0,45000,10000,35000,35000
01002T,土銀國泰R1      ,35000,0,35000,0,0,0,0,0,0,0,0,0,0,0,0,0,35000
053875,GIS元大97購01   ,0,0,0,0,0,0,0,0,0,35000,0,0,0,85000,50000,35000,35000
054094,創意群益96購02  ,0,0,0,0,0,0,0,0,0,35000,0,0,0,35000,0,35000,35000
057368,微星元大98購02  ,0,0,0,0,0,0,0,0,0,35000,0,0,0,90000,55000,35000,35000
057055,立積元大99購01  ,0,0,0,0,0,0,0,0,0,35000,0,0,0,103000,68000,35000,35000
056834,華新元富99購01  ,0,0,0,0,0,0,0,0,0,35000,0,0,0,35000,0,35000,35000
058043,鴻海元大98購13  ,0,0,0,0,0,0,0,0,0,35000,0,0,0,36000,1000,35000,35000
058053,上銀統一9B購01  ,0,0,0,0,0,0,0,0,0,35000,0,0,0,77000,42000,35000,35000
057561,大立光兆豐98購02,0,0,0,0,0,0,0,0,0,35000,0,0,0,35000,0,35000,35000
057699,可成群益9A購02  ,0,0,0,0,0,0,0,0,0,35000,0,0,0,105000,70000,35000,35000
060622,玉晶光元大9B購02,0,0,0,0,0,0,0,0,0,35000,0,0,0,37000,2000,35000,35000
060499,鴻海元大9A購11  ,0,0,0,0,0,0,0,0,0,35000,0,0,0,37000,2000,35000,35000
061519,T50反1中信03購01,0,0,0,0,0,0,0,0,0,35000,0,0,0,35000,0,35000,35000
061576,華新科元大9A購21,0,0,0,0,0,0,0,0,0,35000,0,0,0,53000,18000,35000,35000
062237,緯創凱基9B購01  ,0,0,0,0,0,0,0,0,0,35000,0,0,0,90000,55000,35000,35000
062273,國巨群益9C購02  ,0,0,0,0,0,0,0,0,0,35000,0,0,0,35000,0,35000,35000
062365,台光電元大9B購03,0,0,0,0,0,0,0,0,0,35000,0,0,0,65000,30000,35000,35000
06234P,亞德客元大97售02,0,0,0,0,0,0,0,0,0,35000,0,0,0,35000,0,35000,35000
063093,國產國票9B購01  ,0,0,0,0,0,0,0,0,0,35000,0,0,0,73000,38000,35000,35000
9911,櫻花            ,87000,55000,32000,0,0,0,0,0,0,3000,5000,2000,3000,0,0,0,35000
6672,騰輝電子-KY     ,79000,45000,34000,0,0,0,0,0,0,1000,1000,0,1000,0,0,0,35000
08060P,嘉澤元大9B售01  ,0,0,0,0,0,0,0,0,0,34000,0,0,0,50000,16000,34000,34000
1455,集盛            ,99000,75000,24000,0,0,0,0,0,0,10000,10000,0,10000,0,0,0,34000
08211P,台表科元富9B售03,0,0,0,0,0,0,0,0,0,34000,0,0,0,84000,50000,34000,34000
2453,凌群            ,75000,41000,34000,0,0,0,0,0,0,0,0,0,0,0,0,0,34000
2305,全友            ,46000,19000,27000,0,0,0,0,0,0,7000,8000,1000,7000,0,0,0,34000
03682C,臺股指凱基9C牛07,0,0,0,0,0,0,0,0,0,34000,0,0,0,115000,81000,34000,34000
049485,台積電元大96購03,0,0,0,0,0,0,0,0,0,34000,0,0,0,37000,3000,34000,34000
059296,大立光元富99購06,0,0,0,0,0,0,0,0,0,34000,0,0,0,201000,167000,34000,34000
059537,大立光凱基99購09,0,0,0,0,0,0,0,0,0,34000,0,0,0,34000,0,34000,34000
059165,南亞科凱基99購04,0,0,0,0,0,0,0,0,0,34000,0,0,0,78000,44000,34000,34000
058583,臻鼎群益99購01  ,0,0,0,0,0,0,0,0,0,34000,0,0,0,74000,40000,34000,34000
060229,楠梓電元大9C購01,0,0,0,0,0,0,0,0,0,34000,0,0,0,34000,0,34000,34000
060392,華擎群益9C購02  ,0,0,0,0,0,0,0,0,0,34000,0,0,0,114000,80000,34000,34000
058828,大毅永豐99購01  ,0,0,0,0,0,0,0,0,0,34000,0,0,0,68000,34000,34000,34000
057337,聯發科國票99購02,0,0,0,0,0,0,0,0,0,34000,0,0,0,34000,0,34000,34000
063075,祥碩永豐9B購04  ,0,0,0,0,0,0,0,0,0,34000,0,0,0,66000,32000,34000,34000
063149,聯發科元富05購02,0,0,0,0,0,0,0,0,0,34000,0,0,0,40000,6000,34000,34000
062332,大立光統一9B購11,0,0,0,0,0,0,0,0,0,34000,0,0,0,100000,66000,34000,34000
061831,智邦凱基9B購02  ,0,0,0,0,0,0,0,0,0,34000,0,0,0,50000,16000,34000,34000
060572,景碩永豐9A購01  ,0,0,0,0,0,0,0,0,0,34000,0,0,0,37000,3000,34000,34000
060582,玉晶光群益9C購01,0,0,0,0,0,0,0,0,0,34000,0,0,0,40000,6000,34000,34000
9930,中聯資源        ,30000,1000,29000,0,0,0,0,0,0,5000,5000,0,5000,0,0,0,34000
1903,士紙            ,32000,0,32000,0,0,0,0,0,0,1000,1000,0,1000,0,0,0,33000
056004,南電永豐97購02  ,0,0,0,0,0,0,0,0,0,33000,0,0,0,51000,18000,33000,33000
054066,緯穎國票97購03  ,0,0,0,0,0,0,0,0,0,33000,0,0,0,35000,2000,33000,33000
052581,訊芯元富98購01  ,0,0,0,0,0,0,0,0,0,33000,0,0,0,33000,0,33000,33000
056703,群創國泰9A購01  ,0,0,0,0,0,0,0,0,0,33000,0,0,0,33000,0,33000,33000
057958,禾伸堂元大99購05,0,0,0,0,0,0,0,0,0,33000,0,0,0,84000,51000,33000,33000
058988,大立光凱基9A購02,0,0,0,0,0,0,0,0,0,33000,0,0,0,33000,0,33000,33000
059290,全新元富99購01  ,0,0,0,0,0,0,0,0,0,33000,0,0,0,53000,20000,33000,33000
06035P,同欣電凱基96售03,0,0,0,0,0,0,0,0,0,33000,0,0,0,33000,0,33000,33000
06018P,康控凱基96售03  ,0,0,0,0,0,0,0,0,0,33000,0,0,0,33000,0,33000,33000
057462,光磊永豐98購02  ,0,0,0,0,0,0,0,0,0,33000,0,0,0,67000,34000,33000,33000
058520,智易元大99購03  ,0,0,0,0,0,0,0,0,0,33000,0,0,0,153000,120000,33000,33000
057906,福懋科中信99購01,0,0,0,0,0,0,0,0,0,33000,0,0,0,33000,0,33000,33000
060533,臺股指中信9B購05,0,0,0,0,0,0,0,0,0,33000,0,0,0,33000,0,33000,33000
061247,玉晶光群益9A購09,0,0,0,0,0,0,0,0,0,33000,0,0,0,110000,77000,33000,33000
061476,大毅元大9A購02  ,0,0,0,0,0,0,0,0,0,33000,0,0,0,126000,93000,33000,33000
062796,技嘉統一9C購01  ,0,0,0,0,0,0,0,0,0,33000,0,0,0,87000,54000,33000,33000
062886,中興電群益9B購01,0,0,0,0,0,0,0,0,0,33000,0,0,0,98000,65000,33000,33000
6155,鈞寶            ,52000,20000,32000,0,0,0,0,0,0,1000,1000,0,1000,0,0,0,33000
07892P,臺股指國票9B售02,0,0,0,0,0,0,0,0,0,32000,0,0,0,150000,118000,32000,32000
07365P,超眾元大99售07  ,0,0,0,0,0,0,0,0,0,32000,0,0,0,32000,0,32000,32000
06328P,台積電中信01售02,0,0,0,0,0,0,0,0,0,32000,0,0,0,52000,20000,32000,32000
063592,瑞祺永豐9B購02  ,0,0,0,0,0,0,0,0,0,32000,0,0,0,132000,100000,32000,32000
07188P,臺股指台新99售11,0,0,0,0,0,0,0,0,0,32000,0,0,0,32000,0,32000,32000
052942,聯發科中信97購04,0,0,0,0,0,0,0,0,0,32000,0,0,0,32000,0,32000,32000
056343,高鐵凱基98購02  ,0,0,0,0,0,0,0,0,0,32000,0,0,0,42000,10000,32000,32000
056295,國巨元大97購16  ,0,0,0,0,0,0,0,0,0,32000,0,0,0,50000,18000,32000,32000
054970,帆宣元大97購01  ,0,0,0,0,0,0,0,0,0,32000,0,0,0,165000,133000,32000,32000
058223,世芯統一9B購01  ,0,0,0,0,0,0,0,0,0,32000,0,0,0,32000,0,32000,32000
058354,台積電凱基9A購06,0,0,0,0,0,0,0,0,0,32000,0,0,0,51000,19000,32000,32000
057935,晶技群益98購02  ,0,0,0,0,0,0,0,0,0,32000,0,0,0,32000,0,32000,32000
059772,可成群益9A購05  ,0,0,0,0,0,0,0,0,0,32000,0,0,0,33000,1000,32000,32000
057317,技嘉凱基98購02  ,0,0,0,0,0,0,0,0,0,32000,0,0,0,202000,170000,32000,32000
062864,臺股指國票9B購21,0,0,0,0,0,0,0,0,0,32000,0,0,0,36000,4000,32000,32000
063227,祥碩群益9B購06  ,0,0,0,0,0,0,0,0,0,32000,0,0,0,107000,75000,32000,32000
062268,力山群益9B購01  ,0,0,0,0,0,0,0,0,0,32000,0,0,0,52000,20000,32000,32000
061231,聚陽元大9A購02  ,0,0,0,0,0,0,0,0,0,32000,0,0,0,258000,226000,32000,32000
060896,晶技凱基9A購02  ,0,0,0,0,0,0,0,0,0,32000,0,0,0,72000,40000,32000,32000
060493,美律元富01購01  ,0,0,0,0,0,0,0,0,0,32000,0,0,0,161000,129000,32000,32000
6152,百一            ,33000,1000,32000,0,0,0,0,0,0,0,0,0,0,0,0,0,32000
5269,祥碩            ,153188,145000,8188,0,0,0,85000,63000,22000,1000,0,11000,-11000,17000,5000,12000,31188
063667,全新統一01購02  ,0,0,0,0,0,0,0,0,0,31000,0,0,0,481000,450000,31000,31000
07595P,台灣50中信03售07,0,0,0,0,0,0,0,0,0,31000,0,0,0,143000,112000,31000,31000
08147P,聯發科群益9B售10,0,0,0,0,0,0,0,0,0,31000,0,0,0,117000,86000,31000,31000
2427,三商電          ,82000,53000,29000,0,0,0,0,0,0,2000,2000,0,2000,0,0,0,31000
056502,A50正2永豐98購01,0,0,0,0,0,0,0,0,0,31000,0,0,0,31000,0,31000,31000
056610,鴻海永豐98購01  ,0,0,0,0,0,0,0,0,0,31000,0,0,0,41000,10000,31000,31000
059021,台積電統一9B購07,0,0,0,0,0,0,0,0,0,31000,0,0,0,63000,32000,31000,31000
056349,道瓊銀元大9B購01,0,0,0,0,0,0,0,0,0,31000,0,0,0,31000,0,31000,31000
053292,美律中信98購01  ,0,0,0,0,0,0,0,0,0,31000,0,0,0,31000,0,31000,31000
051688,大立光凱基97購02,0,0,0,0,0,0,0,0,0,31000,0,0,0,31000,0,31000,31000
054100,致伸國票97購03  ,0,0,0,0,0,0,0,0,0,31000,0,0,0,43000,12000,31000,31000
04788P,台積電永昌96售05,0,0,0,0,0,0,0,0,0,31000,0,0,0,31000,0,31000,31000
049007,玉晶光中信96購01,0,0,0,0,0,0,0,0,0,31000,0,0,0,31000,0,31000,31000
047211,華新科富邦99購01,0,0,0,0,0,0,0,0,0,31000,0,0,0,37000,6000,31000,31000
056905,欣興元大98購03  ,0,0,0,0,0,0,0,0,0,31000,0,0,0,42000,11000,31000,31000
057901,大立光永豐98購04,0,0,0,0,0,0,0,0,0,31000,0,0,0,31000,0,31000,31000
058694,鈺齊國票9A購02  ,0,0,0,0,0,0,0,0,0,31000,0,0,0,38000,7000,31000,31000
060530,聯發科中信9C購03,0,0,0,0,0,0,0,0,0,31000,0,0,0,31000,0,31000,31000
060619,玉晶光元大9A購03,0,0,0,0,0,0,0,0,0,31000,0,0,0,168000,137000,31000,31000
060854,台積電富邦9C購08,0,0,0,0,0,0,0,0,0,31000,0,0,0,203000,172000,31000,31000
061931,力山國票9B購02  ,0,0,0,0,0,0,0,0,0,31000,0,0,0,33000,2000,31000,31000
062221,奇力新統一01購01,0,0,0,0,0,0,0,0,0,31000,0,0,0,35000,4000,31000,31000
8462,柏文            ,50000,23000,27000,0,0,0,0,0,0,4000,1000,0,1000,3000,0,3000,31000
6281,全國電          ,31000,16000,15000,0,0,0,0,0,0,16000,16000,0,16000,0,0,0,31000
2480,敦陽科          ,168000,148000,20000,0,0,0,0,0,0,10000,23000,13000,10000,0,0,0,30000
1526,日馳            ,71000,42000,29000,0,0,0,0,0,0,1000,2000,1000,1000,0,0,0,30000
08198P,聯發科元大9B售25,0,0,0,0,0,0,0,0,0,30000,0,0,0,65000,35000,30000,30000
1225,福懋油          ,32000,2000,30000,0,0,0,0,0,0,0,0,0,0,0,0,0,30000
07888P,大立光國票9B售01,0,0,0,0,0,0,0,0,0,30000,0,0,0,30000,0,30000,30000
07873P,華新科群益9B售03,0,0,0,0,0,0,0,0,0,30000,0,0,0,30000,0,30000,30000
07684P,大立光凱基9A售11,0,0,0,0,0,0,0,0,0,30000,0,0,0,30000,0,30000,30000
07722P,玉晶光凱基9A售10,0,0,0,0,0,0,0,0,0,30000,0,0,0,35000,5000,30000,30000
07387P,臺股指群益99售25,0,0,0,0,0,0,0,0,0,30000,0,0,0,50000,20000,30000,30000
07468P,聯電元大9A售02  ,0,0,0,0,0,0,0,0,0,30000,0,0,0,35000,5000,30000,30000
06995P,臺股指凱基99售16,0,0,0,0,0,0,0,0,0,30000,0,0,0,42000,12000,30000,30000
06921P,台光電凱基98售06,0,0,0,0,0,0,0,0,0,30000,0,0,0,30000,0,30000,30000
06515P,國巨凱基98售06  ,0,0,0,0,0,0,0,0,0,30000,0,0,0,40000,10000,30000,30000
06571P,欣興永豐98售03  ,0,0,0,0,0,0,0,0,0,30000,0,0,0,30000,0,30000,30000
06458P,玉晶光統一9A售02,0,0,0,0,0,0,0,0,0,30000,0,0,0,50000,20000,30000,30000
06418P,T50反1統一9A售02,0,0,0,0,0,0,0,0,0,30000,0,0,0,30000,0,30000,30000
06389P,聯發科兆豐97售01,0,0,0,0,0,0,0,0,0,30000,0,0,0,30000,0,30000,30000
047674,群創元富96購02  ,0,0,0,0,0,0,0,0,0,30000,0,0,0,30000,0,30000,30000
051600,新日興兆豐96購02,0,0,0,0,0,0,0,0,0,30000,0,0,0,30000,0,30000,30000
051466,玉晶光富邦97購01,0,0,0,0,0,0,0,0,0,30000,0,0,0,30000,0,30000,30000
050378,上証2X群益98購02,0,0,0,0,0,0,0,0,0,30000,0,0,0,30000,0,30000,30000
050333,鴻海國泰96購06  ,0,0,0,0,0,0,0,0,0,30000,0,0,0,30000,0,30000,30000
049272,世紀鋼元大96購02,0,0,0,0,0,0,0,0,0,30000,0,0,0,30000,0,30000,30000
053734,友達中信98購02  ,0,0,0,0,0,0,0,0,0,30000,0,0,0,30000,0,30000,30000
051741,可成國票97購01  ,0,0,0,0,0,0,0,0,0,30000,0,0,0,30000,0,30000,30000
051745,玉晶光國泰97購06,0,0,0,0,0,0,0,0,0,30000,0,0,0,30000,0,30000,30000
051694,A50正2中信96購03,0,0,0,0,0,0,0,0,0,30000,0,0,0,30000,0,30000,30000
053205,台光電麥證96購01,0,0,0,30000,0,30000,0,0,0,30000,0,0,0,30000,0,30000,30000
052839,上海銀國泰97購01,0,0,0,0,0,0,0,0,0,30000,0,0,0,30000,0,30000,30000
054160,華泰凱基98購01  ,0,0,0,0,0,0,0,0,0,30000,0,0,0,30000,0,30000,30000
053723,奇鋐凱基98購01  ,0,0,0,0,0,0,0,0,0,30000,0,0,0,40000,10000,30000,30000
053144,上証2X元大96購01,0,0,0,0,0,0,0,0,0,30000,0,0,0,30000,0,30000,30000
053110,大立光兆豐97購01,0,0,0,0,0,0,0,0,0,30000,0,0,0,30000,0,30000,30000
055394,健策統一97購01  ,0,0,0,0,0,0,0,0,0,30000,0,0,0,320000,290000,30000,30000
059014,SGBR2X元富03購01,0,0,0,0,0,0,0,0,0,30000,0,0,0,30000,0,30000,30000
059570,全新凱基99購04  ,0,0,0,0,0,0,0,0,0,30000,0,0,0,60000,30000,30000,30000
055867,臺股指元大97購05,0,0,0,0,0,0,0,0,0,30000,0,0,0,30000,0,30000,30000
059358,旺宏永豐99購02  ,0,0,0,0,0,0,0,0,0,30000,0,0,0,85000,55000,30000,30000
059078,FBVIX元大99購06 ,0,0,0,0,0,0,0,0,0,30000,0,0,0,110000,80000,30000,30000
059059,宏達電凱基99購03,0,0,0,0,0,0,0,0,0,30000,0,0,0,30000,0,30000,30000
056114,台達電群益97購02,0,0,0,0,0,0,0,0,0,30000,0,0,0,98000,68000,30000,30000
056478,晶技元大99購01  ,0,0,0,0,0,0,0,0,0,30000,0,0,0,40000,10000,30000,30000
055617,TPK國票98購04   ,0,0,0,0,0,0,0,0,0,30000,0,0,0,30000,0,30000,30000
054342,亞光元富99購01  ,0,0,0,0,0,0,0,0,0,30000,0,0,0,30000,0,30000,30000
054364,智伸科凱基96購01,0,0,0,0,0,0,0,0,0,30000,0,0,0,30000,0,30000,30000
056433,鴻海凱基98購09  ,0,0,0,0,0,0,0,0,0,30000,0,0,0,31000,1000,30000,30000
054613,大立光永豐97購02,0,0,0,0,0,0,0,0,0,30000,0,0,0,30000,0,30000,30000
054502,泰碩永豐96購01  ,0,0,0,0,0,0,0,0,0,30000,0,0,0,30000,0,30000,30000
054434,友達台新96購03  ,0,0,0,0,0,0,0,0,0,30000,0,0,0,30000,0,30000,30000
054437,欣興台新97購02  ,0,0,0,0,0,0,0,0,0,30000,0,0,0,30000,0,30000,30000
054757,南亞國票98購01  ,0,0,0,0,0,0,0,0,0,30000,0,0,0,30000,0,30000,30000
054630,聯鈞凱基98購01  ,0,0,0,0,0,0,0,0,0,30000,0,0,0,30000,0,30000,30000
055272,國巨元大98購04  ,0,0,0,0,0,0,0,0,0,30000,0,0,0,30000,0,30000,30000
057891,華新科統一9A購01,0,0,0,0,0,0,0,0,0,30000,0,0,0,30000,0,30000,30000
060086,鴻海元大99購42  ,0,0,0,0,0,0,0,0,0,30000,0,0,0,33000,3000,30000,30000
060113,祥碩元大9B購01  ,0,0,0,0,0,0,0,0,0,30000,0,0,0,30000,0,30000,30000
056831,元油2X元富98購11,0,0,0,0,0,0,0,0,0,30000,0,0,0,30000,0,30000,30000
059828,健策凱基99購05  ,0,0,0,0,0,0,0,0,0,30000,0,0,0,30000,0,30000,30000
059941,聯發科永豐99購04,0,0,0,0,0,0,0,0,0,30000,0,0,0,40000,10000,30000,30000
057338,群創國票99購01  ,0,0,0,0,0,0,0,0,0,30000,0,0,0,30000,0,30000,30000
059691,大立光永豐99購02,0,0,0,0,0,0,0,0,0,30000,0,0,0,30000,0,30000,30000
058919,SGBR2X元富99購05,0,0,0,0,0,0,0,0,0,30000,0,0,0,30000,0,30000,30000
059642,健策凱基99購04  ,0,0,0,0,0,0,0,0,0,30000,0,0,0,30000,0,30000,30000
057995,華新科中信98購02,0,0,0,0,0,0,0,0,0,30000,0,0,0,30000,0,30000,30000
057241,超眾凱基99購02  ,0,0,0,0,0,0,0,0,0,30000,0,0,0,34000,4000,30000,30000
057261,瑞昱兆豐98購01  ,0,0,0,0,0,0,0,0,0,30000,0,0,0,30000,0,30000,30000
057953,聚陽元大98購01  ,0,0,0,0,0,0,0,0,0,30000,0,0,0,30000,0,30000,30000
057128,台光電凱基98購03,0,0,0,0,0,0,0,0,0,30000,0,0,0,30000,0,30000,30000
059259,FBVIX中信03購06 ,0,0,0,0,0,0,0,0,0,30000,0,0,0,60000,30000,30000,30000
059256,臺股指凱基99購34,0,0,0,0,0,0,0,0,0,30000,0,0,0,30000,0,30000,30000
058981,國巨凱基99購10  ,0,0,0,0,0,0,0,0,0,30000,0,0,0,30000,0,30000,30000
062254,台光電元大9B購02,0,0,0,0,0,0,0,0,0,30000,0,0,0,32000,2000,30000,30000
062153,智邦麥證9B購01  ,0,0,0,140000,110000,30000,0,0,0,30000,0,0,0,160000,130000,30000,30000
062156,美律凱基9B購01  ,0,0,0,0,0,0,0,0,0,30000,0,0,0,30000,0,30000,30000
062159,聯詠凱基9B購01  ,0,0,0,0,0,0,0,0,0,30000,0,0,0,30000,0,30000,30000
061960,國巨統一01購05  ,0,0,0,0,0,0,0,0,0,30000,0,0,0,65000,35000,30000,30000
062094,台積電富邦9C購12,0,0,0,0,0,0,0,0,0,30000,0,0,0,30000,0,30000,30000
062355,華通元大9B購03  ,0,0,0,0,0,0,0,0,0,30000,0,0,0,75000,45000,30000,30000
062530,大立光統一01購03,0,0,0,0,0,0,0,0,0,30000,0,0,0,58000,28000,30000,30000
062760,漢唐凱基9B購01  ,0,0,0,0,0,0,0,0,0,30000,0,0,0,30000,0,30000,30000
062700,台光電元大9B購05,0,0,0,0,0,0,0,0,0,30000,0,0,0,32000,2000,30000,30000
061922,瑞昱凱基9B購01  ,0,0,0,0,0,0,0,0,0,30000,0,0,0,30000,0,30000,30000
061871,瑞昱元大9B購01  ,0,0,0,0,0,0,0,0,0,30000,0,0,0,30000,0,30000,30000
061801,祥碩永豐9B購01  ,0,0,0,0,0,0,0,0,0,30000,0,0,0,30000,0,30000,30000
061683,台灣50群益9B購09,0,0,0,0,0,0,0,0,0,30000,0,0,0,30000,0,30000,30000
061481,嘉澤元大9A購03  ,0,0,0,0,0,0,0,0,0,30000,0,0,0,38000,8000,30000,30000
061279,鴻海統一9C購04  ,0,0,0,0,0,0,0,0,0,30000,0,0,0,30000,0,30000,30000
061413,台勝科群益9A購01,0,0,0,0,0,0,0,0,0,30000,0,0,0,34000,4000,30000,30000
060893,台灣50凱基01購07,0,0,0,0,0,0,0,0,0,30000,0,0,0,30000,0,30000,30000
061039,台表科永豐9A購03,0,0,0,0,0,0,0,0,0,30000,0,0,0,30000,0,30000,30000
060523,鴻海中信9C購03  ,0,0,0,0,0,0,0,0,0,30000,0,0,0,30000,0,30000,30000
060485,華新科富邦9C購04,0,0,0,0,0,0,0,0,0,30000,0,0,0,30000,0,30000,30000
060814,健策凱基9B購01  ,0,0,0,0,0,0,0,0,0,30000,0,0,0,30000,0,30000,30000
060714,晶技永豐9A購02  ,0,0,0,0,0,0,0,0,0,30000,0,0,0,30000,0,30000,30000
3015,全漢            ,34000,6000,28000,0,0,0,0,0,0,2000,2000,0,2000,0,0,0,30000
063503,香港反中信9C購01,0,0,0,0,0,0,0,0,0,29000,0,0,0,30000,1000,29000,29000
063474,康控元大9B購04  ,0,0,0,0,0,0,0,0,0,29000,0,0,0,182000,153000,29000,29000
07957P,晶技群益9B售02  ,0,0,0,0,0,0,0,0,0,29000,0,0,0,53000,24000,29000,29000
1232,大統益          ,33000,6000,27000,0,0,0,0,0,0,2000,2000,0,2000,0,0,0,29000
08194P,同欣電國票9C售03,0,0,0,0,0,0,0,0,0,29000,0,0,0,41000,12000,29000,29000
055764,臺股指群益97購02,0,0,0,0,0,0,0,0,0,29000,20000,0,20000,9000,0,9000,29000
054961,玉晶光元大99購01,0,0,0,0,0,0,0,0,0,29000,0,0,0,34000,5000,29000,29000
059063,康控凱基99購04  ,0,0,0,0,0,0,0,0,0,29000,0,0,0,29000,0,29000,29000
053027,玉晶光富邦98購01,0,0,0,0,0,0,0,0,0,29000,0,0,0,29000,0,29000,29000
052775,滬深2X國票99購02,0,0,0,0,0,0,0,0,0,29000,0,0,0,41000,12000,29000,29000
053761,健策國泰98購01  ,0,0,0,0,0,0,0,0,0,29000,0,0,0,29000,0,29000,29000
058131,義隆元大99購02  ,0,0,0,0,0,0,0,0,0,29000,0,0,0,68000,39000,29000,29000
056718,GIS永豐98購01   ,0,0,0,0,0,0,0,0,0,29000,0,0,0,29000,0,29000,29000
057008,華新科中信99購02,0,0,0,0,0,0,0,0,0,29000,0,0,0,30000,1000,29000,29000
060150,華通富邦9B購01  ,0,0,0,0,0,0,0,0,0,29000,0,0,0,29000,0,29000,29000
060165,上緯控永豐9A購01,0,0,0,0,0,0,0,0,0,29000,0,0,0,92000,63000,29000,29000
057895,全新元富9B購01  ,0,0,0,0,0,0,0,0,0,29000,0,0,0,29000,0,29000,29000
057693,臺股指凱基98購11,0,0,0,0,0,0,0,0,0,29000,0,0,0,29000,0,29000,29000
061258,華通凱基9A購06  ,0,0,0,0,0,0,0,0,0,29000,0,0,0,29000,0,29000,29000
062615,亞德客元大9B購02,0,0,0,0,0,0,0,0,0,29000,0,0,0,65000,36000,29000,29000
062900,台積電元大9B購04,0,0,0,0,0,0,0,0,0,29000,0,0,0,41000,12000,29000,29000
062542,南電國泰9C購01  ,0,0,0,0,0,0,0,0,0,29000,0,0,0,120000,91000,29000,29000
062577,泰鼎群益9B購01  ,0,0,0,0,0,0,0,0,0,29000,0,0,0,119000,90000,29000,29000
062437,廣達元大9B購01  ,0,0,0,0,0,0,0,0,0,29000,0,0,0,59000,30000,29000,29000
062282,禾伸堂群益9B購01,0,0,0,0,0,0,0,0,0,29000,0,0,0,29000,0,29000,29000
06207P,聯發科凱基97售07,0,0,0,0,0,0,0,0,0,29000,0,0,0,29000,0,29000,29000
1108,幸福            ,31000,3000,28000,0,0,0,0,0,0,0,0,0,0,0,0,0,28000
2020,美亞            ,160000,133000,27000,0,0,0,0,0,0,1000,1000,0,1000,0,0,0,28000
2302,麗正            ,29000,1000,28000,0,0,0,0,0,0,0,0,0,0,0,0,0,28000
2528,皇普            ,27000,0,27000,0,0,0,0,0,0,1000,1000,0,1000,0,0,0,28000
08161P,台表科元富9B售02,0,0,0,0,0,0,0,0,0,28000,0,0,0,122000,94000,28000,28000
063259,廣達富邦9C購01  ,0,0,0,0,0,0,0,0,0,28000,0,0,0,174000,146000,28000,28000
063817,GIS群益9C購01   ,0,35000,-35000,0,0,0,0,0,0,63000,0,0,0,113000,50000,63000,28000
053849,聯發科元富96購04,0,0,0,0,0,0,0,0,0,28000,0,0,0,30000,2000,28000,28000
00709,富邦歐洲        ,0,0,0,0,0,0,0,0,0,28000,0,0,0,135000,107000,28000,28000
053573,臺股指統一99購01,0,0,0,0,0,0,0,0,0,28000,0,0,0,116000,88000,28000,28000
059095,訊芯元大99購01  ,0,0,0,0,0,0,0,0,0,28000,0,0,0,237000,209000,28000,28000
059194,元金2X永豐99購01,0,0,0,0,0,0,0,0,0,28000,0,0,0,28000,0,28000,28000
059043,聯電日盛99購01  ,0,0,0,0,0,0,0,0,0,28000,0,0,0,122000,94000,28000,28000
056084,漢唐統一97購03  ,0,0,0,0,0,0,0,0,0,28000,0,0,0,28000,0,28000,28000
056599,臻鼎元富98購01  ,0,0,0,0,0,0,0,0,0,28000,0,0,0,156000,128000,28000,28000
055919,景碩凱基98購02  ,0,0,0,0,0,0,0,0,0,28000,0,0,0,28000,0,28000,28000
055714,智邦元大97購03  ,0,0,0,0,0,0,0,0,0,28000,0,0,0,29000,1000,28000,28000
056492,全新國泰9A購01  ,0,0,0,0,0,0,0,0,0,28000,0,0,0,28000,0,28000,28000
057707,臺股指群益98購07,0,0,0,0,0,0,0,0,0,28000,0,0,0,120000,92000,28000,28000
060943,宏達電國票9B購02,0,0,0,0,0,0,0,0,0,28000,0,0,0,38000,10000,28000,28000
057407,超眾群益99購01  ,0,0,0,0,0,0,0,0,0,28000,0,0,0,28000,0,28000,28000
057493,聯詠元大98購02  ,0,0,0,0,0,0,0,0,0,28000,0,0,0,116000,88000,28000,28000
059889,華新科國票99購04,0,0,0,0,0,0,0,0,0,28000,0,0,0,28000,0,28000,28000
059944,欣興永豐99購03  ,0,0,0,0,0,0,0,0,0,28000,0,0,0,48000,20000,28000,28000
057279,國揚元大98購01  ,0,0,0,0,0,0,0,0,0,28000,0,0,0,193000,165000,28000,28000
062071,華通元大9B購02  ,0,0,0,0,0,0,0,0,0,28000,0,0,0,51000,23000,28000,28000
062167,燿華永豐9B購01  ,0,0,0,0,0,0,0,0,0,28000,0,0,0,28000,0,28000,28000
062797,瑞昱統一9B購01  ,0,0,0,0,0,0,0,0,0,28000,0,0,0,148000,120000,28000,28000
063001,巨大國票9B購01  ,0,0,0,0,0,0,0,0,0,28000,0,0,0,28000,0,28000,28000
061226,台積電中信9A購05,0,0,0,0,0,0,0,0,0,28000,0,0,0,28000,0,28000,28000
06378P,國巨統一97售08  ,0,0,0,0,0,0,0,0,0,27000,0,0,0,27000,0,27000,27000
063605,健策凱基9C購02  ,0,0,0,0,0,0,0,0,0,27000,0,0,0,34000,7000,27000,27000
063362,台表科國泰01購03,0,0,0,0,0,0,0,0,0,27000,0,0,0,27000,0,27000,27000
2109,華豐            ,28000,1000,27000,0,0,0,0,0,0,0,0,0,0,0,0,0,27000
054975,福懋科元大97購01,0,0,0,0,0,0,0,0,0,27000,0,0,0,117000,90000,27000,27000
05911P,南亞科永豐96售03,0,0,0,0,0,0,0,0,0,27000,0,0,0,27000,0,27000,27000
053172,瑞儀群益97購01  ,0,0,0,0,0,0,0,0,0,27000,0,0,0,27000,0,27000,27000
04462P,全新元富96售01  ,0,0,0,0,0,0,0,0,0,27000,0,0,0,27000,0,27000,27000
048179,臻鼎富邦97購01  ,0,0,0,0,0,0,0,0,0,27000,0,0,0,27000,0,27000,27000
058835,元油2X中信9C購02,0,0,0,0,0,0,0,0,0,27000,0,0,0,36000,9000,27000,27000
058836,FBVIX中信03購05 ,0,0,0,0,0,0,0,0,0,27000,0,0,0,55000,28000,27000,27000
060471,台勝科元大9B購01,0,0,0,0,0,0,0,0,0,27000,0,0,0,31000,4000,27000,27000
058427,大毅元富99購01  ,0,0,0,0,0,0,0,0,0,27000,0,0,0,27000,0,27000,27000
058654,鴻海中信03購01  ,0,0,0,0,0,0,0,0,0,27000,0,0,0,59000,32000,27000,27000
060861,漢唐永豐9A購01  ,0,0,0,0,0,0,0,0,0,27000,0,0,0,28000,1000,27000,27000
061300,臺股指富邦9A購02,0,0,0,0,0,0,0,0,0,27000,0,0,0,27000,0,27000,27000
061644,健策元大9C購02  ,0,0,0,0,0,0,0,0,0,27000,0,0,0,77000,50000,27000,27000
062800,奇力新統一01購02,0,0,0,0,0,0,0,0,0,27000,0,0,0,42000,15000,27000,27000
06282P,聯鈞永豐97售02  ,0,0,0,0,0,0,0,0,0,27000,0,0,0,27000,0,27000,27000
061959,鴻海統一9B購04  ,0,0,0,0,0,0,0,0,0,27000,0,0,0,42000,15000,27000,27000
062028,晶技群益9B購01  ,0,0,0,0,0,0,0,0,0,27000,0,0,0,27000,0,27000,27000
062545,嘉晶永豐9B購01  ,0,0,0,0,0,0,0,0,0,27000,0,0,0,27000,0,27000,27000
4141,龍燈-KY         ,30000,3000,27000,0,0,0,0,0,0,0,1000,1000,0,0,0,0,27000
1806,冠軍            ,27000,6000,21000,0,0,0,0,0,0,5000,5000,0,5000,0,0,0,26000
2506,太設            ,24000,2000,22000,0,0,0,0,0,0,4000,4000,0,4000,0,0,0,26000
07312P,台灣50元大99售10,0,0,0,0,0,0,0,0,0,26000,0,0,0,102000,76000,26000,26000
063727,鴻海元大9C購05  ,0,0,0,0,0,0,0,0,0,26000,0,0,0,85000,59000,26000,26000
050142,聯發科元富9A購01,0,0,0,0,0,0,0,0,0,26000,0,0,0,26000,0,26000,26000
035275,台積電台新97購01,0,0,0,0,0,0,0,0,0,26000,0,0,0,34000,8000,26000,26000
050570,聯發科中信97購02,0,0,0,0,0,0,0,0,0,26000,0,0,0,26000,0,26000,26000
046906,新光金凱基99購02,0,0,0,0,0,0,0,0,0,26000,0,0,0,40000,14000,26000,26000
056330,玉晶光國票99購03,0,0,0,0,0,0,0,0,0,26000,0,0,0,63000,37000,26000,26000
055468,智邦凱基97購04  ,0,0,0,0,0,0,0,0,0,26000,0,0,0,26000,0,26000,26000
056625,致伸永豐98購01  ,0,0,0,0,0,0,0,0,0,26000,0,0,0,111000,85000,26000,26000
056077,矽力元大97購07  ,0,0,0,0,0,0,0,0,0,26000,0,0,0,26000,0,26000,26000
055196,致新元富97購01  ,0,0,0,0,0,0,0,0,0,26000,0,0,0,129000,103000,26000,26000
054767,日電貿國票98購01,0,0,0,0,0,0,0,0,0,26000,0,0,0,36000,10000,26000,26000
055661,亞德客中信98購01,0,0,0,0,0,0,0,0,0,26000,0,0,0,66000,40000,26000,26000
060468,聯鈞元大9A購02  ,0,0,0,0,0,0,0,0,0,26000,0,0,0,27000,1000,26000,26000
058256,臺股指元大9A購20,0,0,0,0,0,0,0,0,0,26000,0,0,0,45000,19000,26000,26000
058783,臺股指國票99購02,0,0,0,0,0,0,0,0,0,26000,0,0,0,30000,4000,26000,26000
059254,台表科凱基9A購02,0,0,0,0,0,0,0,0,0,26000,0,0,0,26000,0,26000,26000
6164,華興            ,25000,0,25000,0,0,0,0,0,0,1000,1000,0,1000,0,0,0,26000
6189,豐藝            ,44000,20000,24000,0,0,0,0,0,0,2000,2000,0,2000,0,0,0,26000
6525,捷敏-KY         ,83000,52000,31000,0,0,0,0,0,0,-5000,1000,6000,-5000,0,0,0,26000
063644,祥碩元大9B購10  ,0,0,0,0,0,0,0,0,0,25000,0,0,0,25000,0,25000,25000
063885,南六元富9C購01  ,0,0,0,0,0,0,0,0,0,25000,0,0,0,84000,59000,25000,25000
06736P,新日興凱基98售03,0,0,0,0,0,0,0,0,0,25000,0,0,0,25000,0,25000,25000
06676P,華新科國票98售03,0,0,0,0,0,0,0,0,0,25000,0,0,0,25000,0,25000,25000
06692P,瑞昱凱基98售03  ,0,0,0,0,0,0,0,0,0,25000,0,0,0,40000,15000,25000,25000
06848P,聯詠元大98售04  ,0,0,0,0,0,0,0,0,0,25000,0,0,0,25000,0,25000,25000
07122P,欣興凱基99售05  ,0,0,0,0,0,0,0,0,0,25000,0,0,0,156000,131000,25000,25000
07405P,大立光凱基99售17,0,0,0,0,0,0,0,0,0,25000,0,0,0,25000,0,25000,25000
08139P,華新科元大9B售12,0,0,0,0,0,0,0,0,0,25000,0,0,0,75000,50000,25000,25000
07904P,聯發科群益9B售05,0,0,0,0,0,0,0,0,0,25000,0,0,0,112000,87000,25000,25000
2468,華經            ,52000,32000,20000,0,0,0,0,0,0,5000,6000,1000,5000,0,0,0,25000
1419,新紡            ,25000,2000,23000,0,0,0,0,0,0,2000,2000,0,2000,0,0,0,25000
055217,緯創凱基97購02  ,0,0,0,0,0,0,0,0,0,25000,0,0,0,45000,20000,25000,25000
05905P,晶技統一97售01  ,0,0,0,0,0,0,0,0,0,25000,0,0,0,31000,6000,25000,25000
059008,鈺齊元大99購03  ,0,0,0,0,0,0,0,0,0,25000,0,0,0,122000,97000,25000,25000
056365,欣興元大98購01  ,0,0,0,0,0,0,0,0,0,25000,0,0,0,80000,55000,25000,25000
055362,GIS凱基97購03   ,0,0,0,0,0,0,0,0,0,25000,0,0,0,25000,0,25000,25000
056318,鴻海群益98購02  ,0,0,0,0,0,0,0,0,0,25000,0,0,0,25000,0,25000,25000
03662C,FBVIX凱基03牛01 ,0,0,0,0,0,0,0,0,0,25000,0,0,0,74000,49000,25000,25000
045444,群創元富98購02  ,0,0,0,0,0,0,0,0,0,25000,0,0,0,25000,0,25000,25000
054046,義隆元大96購02  ,0,0,0,0,0,0,0,0,0,25000,0,0,0,25000,0,25000,25000
057925,貿聯凱基99購01  ,0,0,0,0,0,0,0,0,0,25000,0,0,0,35000,10000,25000,25000
057233,聯發科凱基98購14,0,0,0,0,0,0,0,0,0,25000,0,0,0,25000,0,25000,25000
057234,宏達電凱基98購05,0,0,0,0,0,0,0,0,0,25000,0,0,0,25000,0,25000,25000
059707,健策凱基9A購03  ,0,0,0,0,0,0,0,0,0,25000,0,0,0,30000,5000,25000,25000
056806,元油2X統一98購02,0,0,0,0,0,0,0,0,0,25000,0,0,0,25000,0,25000,25000
060981,旺宏元大9A購08  ,0,0,0,0,0,0,0,0,0,25000,0,0,0,27000,2000,25000,25000
060461,鴻海元大9A購09  ,0,0,0,0,0,0,0,0,0,25000,0,0,0,25000,0,25000,25000
060369,滬深2X元富01購01,0,0,0,0,0,0,0,0,0,25000,0,0,0,32000,7000,25000,25000
058693,旭富國票9A購01  ,0,0,0,0,0,0,0,0,0,25000,0,0,0,42000,17000,25000,25000
05875P,旺宏群益98售01  ,0,0,0,0,0,0,0,0,0,25000,0,0,0,25000,0,25000,25000
057808,旺宏元大99購05  ,0,0,0,0,0,0,0,0,0,25000,0,0,0,30000,5000,25000,25000
058167,鴻海凱基9A購03  ,0,0,0,0,0,0,0,0,0,25000,0,0,0,36000,11000,25000,25000
062510,台積電國票01購01,0,0,0,0,0,0,0,0,0,25000,0,0,0,30000,5000,25000,25000
062302,聯詠中信05購02  ,0,0,0,0,0,0,0,0,0,25000,0,0,0,25000,0,25000,25000
062366,義隆元大9B購04  ,0,0,0,0,0,0,0,0,0,25000,0,0,0,61000,36000,25000,25000
062144,華通國票9B購01  ,0,0,0,0,0,0,0,0,0,25000,0,0,0,25000,0,25000,25000
062236,信邦凱基9B購01  ,0,0,0,0,0,0,0,0,0,25000,0,0,0,40000,15000,25000,25000
062998,泰碩國票01購01  ,0,0,0,0,0,0,0,0,0,25000,0,0,0,63000,38000,25000,25000
063192,技嘉台新9B購01  ,0,0,0,0,0,0,0,0,0,25000,0,0,0,46000,21000,25000,25000
061892,亞德客永豐9B購01,0,0,0,0,0,0,0,0,0,25000,0,0,0,25000,0,25000,25000
060754,華通元大9A購04  ,0,0,0,0,0,0,0,0,0,25000,0,0,0,35000,10000,25000,25000
6409,旭隼            ,81000,70000,11000,0,0,0,0,0,0,14000,14000,0,14000,0,0,0,25000
8473,山林水          ,24000,1000,23000,0,0,0,0,0,0,2000,2000,0,2000,0,0,0,25000
5608,四維航          ,267000,246000,21000,0,0,0,0,0,0,4000,4000,0,4000,0,0,0,25000
4560,強信-KY         ,141000,116000,25000,0,0,0,0,0,0,0,0,0,0,0,0,0,25000
1608,華榮            ,278000,264000,14000,0,0,0,0,0,0,10000,10000,0,10000,0,0,0,24000
2495,普安            ,22000,0,22000,0,0,0,0,0,0,2000,2000,0,2000,0,0,0,24000
2527,宏璟            ,54000,38000,16000,0,0,0,0,0,0,8000,9000,1000,8000,0,0,0,24000
2616,山隆            ,30000,8000,22000,0,0,0,0,0,0,2000,2000,0,2000,0,0,0,24000
07316P,長榮航康和99售01,0,0,0,0,0,0,0,0,0,24000,0,0,0,24000,0,24000,24000
06863P,欣興凱基98售05  ,0,0,0,0,0,0,0,0,0,24000,0,0,0,44000,20000,24000,24000
06667P,鴻海凱基98售11  ,0,0,0,0,0,0,0,0,0,24000,0,0,0,38000,14000,24000,24000
06517P,國巨凱基98售09  ,0,0,0,0,0,0,0,0,0,24000,0,0,0,24000,0,24000,24000
06467P,旺宏統一98售01  ,0,0,0,0,0,0,0,0,0,24000,0,0,0,24000,0,24000,24000
063681,深中小永豐9B購01,0,0,0,0,0,0,0,0,0,24000,0,0,0,71000,47000,24000,24000
06377P,華通統一97售04  ,0,0,0,0,0,0,0,0,0,24000,0,0,0,72000,48000,24000,24000
054090,瑞昱群益97購01  ,0,0,0,0,0,0,0,0,0,24000,0,0,0,24000,0,24000,24000
051383,京鼎群益96購02  ,0,0,0,0,0,0,0,0,0,24000,0,0,0,24000,0,24000,24000
051268,創意富邦97購01  ,0,0,0,0,0,0,0,0,0,24000,0,0,0,24000,0,24000,24000
056663,臺股指元大9A購10,0,0,0,0,0,0,0,0,0,24000,0,0,0,24000,0,24000,24000
056132,台光電元大97購03,0,0,0,0,0,0,0,0,0,24000,0,0,0,32000,8000,24000,24000
054330,世芯永豐96購02  ,0,0,0,0,0,0,0,0,0,24000,0,0,0,52000,28000,24000,24000
058378,南電凱基99購01  ,0,0,0,0,0,0,0,0,0,24000,0,0,0,24000,0,24000,24000
058718,台灣50元富03購01,0,0,0,0,0,0,0,0,0,24000,0,0,0,24000,0,24000,24000
060095,聯發科元大99購42,0,0,0,0,0,0,0,0,0,24000,0,0,0,24000,0,24000,24000
058375,群創凱基9B購04  ,0,0,0,0,0,0,0,0,0,24000,0,0,0,110000,86000,24000,24000
056682,鴻海統一98購10  ,0,0,0,0,0,0,0,0,0,24000,0,0,0,29000,5000,24000,24000
058875,台表科國票9A購02,0,0,0,0,0,0,0,0,0,24000,0,0,0,37000,13000,24000,24000
058842,元油2X群益9C購01,0,0,0,0,0,0,0,0,0,24000,0,0,0,114000,90000,24000,24000
060678,聯詠元大9A購03  ,0,0,0,0,0,0,0,0,0,24000,0,0,0,61000,37000,24000,24000
060584,玉晶光元富9A購01,0,0,0,0,0,0,0,0,0,24000,0,0,0,34000,10000,24000,24000
061167,臻鼎兆豐9B購01  ,0,0,0,0,0,0,0,0,0,24000,0,0,0,24000,0,24000,24000
061874,義隆元大9B購02  ,0,0,0,0,0,0,0,0,0,24000,0,0,0,24000,0,24000,24000
061855,台郡國票9B購01  ,0,0,0,0,0,0,0,0,0,24000,0,0,0,75000,51000,24000,24000
063140,聯發科統一9B購08,0,0,0,0,0,0,0,0,0,24000,0,0,0,42000,18000,24000,24000
062250,台積電元大9B購02,0,0,0,0,0,0,0,0,0,24000,0,0,0,36000,12000,24000,24000
062053,華通統一9C購02  ,0,0,0,0,0,0,0,0,0,24000,0,0,0,86000,62000,24000,24000
4526,東台            ,30000,12000,18000,0,0,0,0,0,0,6000,6000,0,6000,0,0,0,24000
5519,隆大            ,71000,50000,21000,0,0,0,0,0,0,3000,3000,0,3000,0,0,0,24000
8103,瀚荃            ,13000,5000,8000,0,0,0,0,0,0,16000,16000,0,16000,0,0,0,24000
063781,健策永豐9B購08  ,0,0,0,0,0,0,0,0,0,23000,0,0,0,28000,5000,23000,23000
06621P,欣興元大98售06  ,0,0,0,0,0,0,0,0,0,23000,0,0,0,23000,0,23000,23000
06592P,欣興元大98售04  ,0,0,0,0,0,0,0,0,0,23000,0,0,0,23000,0,23000,23000
06728P,全新元大98售03  ,0,0,0,0,0,0,0,0,0,23000,0,0,0,35000,12000,23000,23000
054540,泰鼎國票99購01  ,0,0,0,0,0,0,0,0,0,23000,0,0,0,82000,59000,23000,23000
054908,群電康和97購01  ,0,0,0,0,0,0,0,0,0,23000,0,0,0,23000,0,23000,23000
055335,健策兆豐98購01  ,0,0,0,0,0,0,0,0,0,23000,0,0,0,23000,0,23000,23000
059298,大立光元富9C購02,0,0,0,0,0,0,0,0,0,23000,0,0,0,548000,525000,23000,23000
053588,聯發科元大97購07,0,0,0,0,0,0,0,0,0,23000,0,0,0,23000,0,23000,23000
05131P,聯詠統一97售01  ,0,0,0,0,0,0,0,0,0,23000,0,0,0,83000,60000,23000,23000
059637,大立光凱基01購01,0,0,0,0,0,0,0,0,0,23000,0,0,0,23000,0,23000,23000
057133,京鼎凱基98購02  ,0,0,0,0,0,0,0,0,0,23000,0,0,0,23000,0,23000,23000
059288,旺宏元富99購03  ,0,0,0,0,0,0,0,0,0,23000,0,0,0,23000,0,23000,23000
059951,台塑康和99購01  ,0,0,0,0,0,0,0,0,0,23000,0,0,0,23000,0,23000,23000
059876,智易凱基99購02  ,0,0,0,0,0,0,0,0,0,23000,0,0,0,32000,9000,23000,23000
058346,嘉晶群益99購01  ,0,0,0,0,0,0,0,0,0,23000,0,0,0,23000,0,23000,23000
062067,滬深2X元大9B購01,0,0,0,0,0,0,0,0,0,23000,0,0,0,23000,0,23000,23000
062264,南六元大9B購02  ,0,0,0,0,0,0,0,0,0,23000,0,0,0,152000,129000,23000,23000
062569,南電中信01購01  ,0,0,0,0,0,0,0,0,0,23000,0,0,0,38000,15000,23000,23000
062738,可成國票9B購02  ,0,0,0,0,0,0,0,0,0,23000,0,0,0,23000,0,23000,23000
062728,健策凱基9B購04  ,0,0,0,0,0,0,0,0,0,23000,0,0,0,43000,20000,23000,23000
061785,奇力新群益9B購01,0,0,0,0,0,0,0,0,0,23000,0,0,0,33000,10000,23000,23000
061672,臺指反元大01購05,0,0,0,0,0,0,0,0,0,23000,0,0,0,23000,0,23000,23000
061473,台積電元大9A購33,0,0,0,0,0,0,0,0,0,23000,0,0,0,45000,22000,23000,23000
060576,欣興中信9B購01  ,0,0,0,0,0,0,0,0,0,23000,0,0,0,24000,1000,23000,23000
060670,臺指反元大01購03,0,0,0,0,0,0,0,0,0,23000,0,0,0,23000,0,23000,23000
060776,世芯凱基9B購01  ,0,0,0,0,0,0,0,0,0,23000,0,0,0,235000,212000,23000,23000
6431,光麗-KY         ,23000,0,23000,0,0,0,0,0,0,0,0,0,0,0,0,0,23000
063261,康控富邦03購01  ,0,0,0,0,0,0,0,0,0,22000,0,0,0,325000,303000,22000,22000
07655P,台灣50凱基01售09,0,0,0,0,0,0,0,0,0,22000,0,0,0,25000,3000,22000,22000
2483,百容            ,3000,2000,1000,0,0,0,0,0,0,21000,21000,0,21000,0,0,0,22000
1234,黑松            ,32000,11000,21000,0,0,0,0,0,0,1000,1000,0,1000,0,0,0,22000
054061,晶技國票97購03  ,0,0,0,0,0,0,0,0,0,22000,0,0,0,22000,0,22000,22000
053593,晶技元大98購01  ,0,0,0,0,0,0,0,0,0,22000,0,0,0,186000,164000,22000,22000
054152,漢唐國泰98購02  ,0,0,0,0,0,0,0,0,0,22000,0,0,0,22000,0,22000,22000
059064,緯穎凱基99購02  ,0,0,0,0,0,0,0,0,0,22000,0,0,0,27000,5000,22000,22000
054556,世芯凱基99購01  ,0,0,0,0,0,0,0,0,0,22000,0,0,0,22000,0,22000,22000
054841,亞德客兆豐97購01,0,0,0,0,0,0,0,0,0,22000,0,0,0,51000,29000,22000,22000
057452,新日興元富98購01,0,0,0,0,0,0,0,0,0,22000,0,0,0,28000,6000,22000,22000
060363,美律元富9A購01  ,0,0,0,0,0,0,0,0,0,22000,0,0,0,161000,139000,22000,22000
058759,義隆群益99購01  ,0,0,0,0,0,0,0,0,0,22000,0,0,0,32000,10000,22000,22000
057892,上証2X元富02購01,0,0,0,0,0,0,0,0,0,22000,0,0,0,22000,0,22000,22000
058077,超眾凱基98購02  ,0,0,0,0,0,0,0,0,0,22000,0,0,0,94000,72000,22000,22000
057936,健策群益99購01  ,0,0,0,0,0,0,0,0,0,22000,0,0,0,30000,8000,22000,22000
059391,立積凱基9A購01  ,0,0,0,0,0,0,0,0,0,22000,0,0,0,22000,0,22000,22000
059685,T50正2永豐99購02,0,0,0,0,0,0,0,0,0,22000,0,0,0,22000,0,22000,22000
060811,亞德客凱基9A購02,0,0,0,0,0,0,0,0,0,22000,0,0,0,22000,0,22000,22000
060665,康控凱基9A購01  ,0,0,0,0,0,0,0,0,0,22000,0,0,0,65000,43000,22000,22000
061211,玉晶光元大9A購12,0,0,0,0,0,0,0,0,0,22000,0,0,0,80000,58000,22000,22000
061578,玉晶光元大9A購16,0,0,0,0,0,0,0,0,0,22000,0,0,0,22000,0,22000,22000
061566,華通元大9A購10  ,0,0,0,0,0,0,0,0,0,22000,0,0,0,65000,43000,22000,22000
061297,台積電富邦9C購09,0,0,0,0,0,0,0,0,0,22000,0,0,0,22000,0,22000,22000
061743,祥碩凱基9B購02  ,0,0,0,0,0,0,0,0,0,22000,0,0,0,52000,30000,22000,22000
061842,牧德凱基9C購01  ,0,0,0,0,0,0,0,0,0,22000,0,0,0,22000,0,22000,22000
062661,華通群益9B購05  ,0,0,0,0,0,0,0,0,0,22000,0,0,0,86000,64000,22000,22000
062915,嘉澤元大9B購03  ,0,0,0,0,0,0,0,0,0,22000,0,0,0,47000,25000,22000,22000
062558,義隆凱基9B購02  ,0,0,0,0,0,0,0,0,0,22000,0,0,0,44000,22000,22000,22000
062504,旭富群益9B購02  ,0,0,0,0,0,0,0,0,0,22000,0,0,0,186000,164000,22000,22000
062531,大立光統一9C購06,0,0,0,0,0,0,0,0,0,22000,0,0,0,42000,20000,22000,22000
062536,玉晶光麥證9B購01,0,0,0,90000,68000,22000,0,0,0,22000,0,0,0,91000,69000,22000,22000
6184,大豐電          ,25000,3000,22000,0,0,0,0,0,0,0,0,0,0,0,0,0,22000
3167,大量            ,13000,6000,7000,0,0,0,0,0,0,15000,15000,0,15000,0,0,0,22000
6415,矽力-KY         ,546402,524577,21825,0,0,0,5000,3000,2000,-2650,10000,15000,-5000,3350,1000,2350,21175
1817,凱撒衛          ,24000,2000,22000,0,0,0,0,0,0,-1000,0,1000,-1000,0,0,0,21000
2007,燁興            ,21000,0,21000,0,0,0,0,0,0,0,0,0,0,0,0,0,21000
06718P,聯詠元大98售01  ,0,0,0,0,0,0,0,0,0,21000,0,0,0,21000,0,21000,21000
06598P,奇力新永豐98售02,0,0,0,0,0,0,0,0,0,21000,0,0,0,31000,10000,21000,21000
059349,台郡凱基99購04  ,0,0,0,0,0,0,0,0,0,21000,0,0,0,42000,21000,21000,21000
053280,群創元大9C購01  ,0,0,0,0,0,0,0,0,0,21000,0,0,0,21000,0,21000,21000
055449,超眾統一9A購01  ,0,0,0,0,0,0,0,0,0,21000,0,0,0,21000,0,21000,21000
055507,樺漢元大98購02  ,0,0,0,0,0,0,0,0,0,21000,0,0,0,21000,0,21000,21000
055399,超眾統一99購01  ,0,0,0,0,0,0,0,0,0,21000,0,0,0,21000,0,21000,21000
052090,聯發科元大97購03,0,0,0,0,0,0,0,0,0,21000,0,0,0,30000,9000,21000,21000
059629,友達凱基99購06  ,0,0,0,0,0,0,0,0,0,21000,0,0,0,130000,109000,21000,21000
058890,元油2X元大9C購06,0,0,0,0,0,0,0,0,0,21000,0,0,0,21000,0,21000,21000
058768,南港兆豐99購01  ,0,0,0,0,0,0,0,0,0,21000,0,0,0,22000,1000,21000,21000
057571,泰碩永豐98購01  ,0,0,0,0,0,0,0,0,0,21000,0,0,0,31000,10000,21000,21000
057532,智原元大98購03  ,0,0,0,0,0,0,0,0,0,21000,0,0,0,459000,438000,21000,21000
057536,康控元大99購03  ,0,0,0,0,0,0,0,0,0,21000,0,0,0,96000,75000,21000,21000
058211,國巨群益9A購02  ,0,0,0,0,0,0,0,0,0,21000,0,0,0,21000,0,21000,21000
058700,鴻海元大99購15  ,0,0,0,0,0,0,0,0,0,21000,0,0,0,34000,13000,21000,21000
058512,宏達電元大99購04,0,0,0,0,0,0,0,0,0,21000,0,0,0,89000,68000,21000,21000
062564,矽創凱基9B購01  ,0,0,0,0,0,0,0,0,0,21000,0,0,0,96000,75000,21000,21000
062330,可成統一9B購03  ,0,0,0,0,0,0,0,0,0,21000,0,0,0,21000,0,21000,21000
063065,聯發科麥證9C購01,0,0,0,26000,5000,21000,0,0,0,21000,0,0,0,26000,5000,21000,21000
061446,鴻海中信04購01  ,0,0,0,0,0,0,0,0,0,21000,0,0,0,32000,11000,21000,21000
061498,大立光國票9A購10,0,0,0,0,0,0,0,0,0,21000,0,0,0,21000,0,21000,21000
061146,台表科中信9A購02,0,0,0,0,0,0,0,0,0,21000,0,0,0,38000,17000,21000,21000
060990,新光金元大9B購03,0,0,0,0,0,0,0,0,0,21000,0,0,0,261000,240000,21000,21000
060487,盛群富邦9B購01  ,0,0,0,0,0,0,0,0,0,21000,0,0,0,21000,0,21000,21000
060514,南電元大9A購02  ,0,0,0,0,0,0,0,0,0,21000,0,0,0,71000,50000,21000,21000
3004,豐達科          ,39000,19000,20000,0,0,0,0,0,0,1000,1000,0,1000,0,0,0,21000
4144,康聯-KY         ,28000,9000,19000,0,0,0,0,0,0,2000,2000,0,2000,0,0,0,21000
06644P,亞德客元大98售03,0,0,0,0,0,0,0,0,0,20000,0,0,0,20000,0,20000,20000
06702P,智邦元富98售01  ,0,0,0,0,0,0,0,0,0,20000,0,0,0,20000,0,20000,20000
06514P,國巨凱基98售05  ,0,0,0,0,0,0,0,0,0,20000,0,0,0,20000,0,20000,20000
06450P,聯發科元大98售03,0,0,0,0,0,0,0,0,0,20000,0,0,0,20000,0,20000,20000
06929P,鴻海元大99售11  ,0,0,0,0,0,0,0,0,0,20000,0,0,0,20000,0,20000,20000
06971P,台光電元大99售03,0,0,0,0,0,0,0,0,0,20000,0,0,0,30000,10000,20000,20000
063429,南電凱基01購01  ,0,0,0,0,0,0,0,0,0,20000,0,0,0,20000,0,20000,20000
063636,聯發科元大9B購26,0,0,0,0,0,0,0,0,0,20000,0,0,0,40000,20000,20000,20000
063576,台表科元大9B購08,0,0,0,0,0,0,0,0,0,20000,0,0,0,20000,0,20000,20000
2597,潤弘            ,19000,0,19000,0,0,0,0,0,0,1000,1000,0,1000,0,0,0,20000
07690P,華新科元大9A售15,0,0,0,0,0,0,0,0,0,20000,0,0,0,20000,0,20000,20000
07732P,台灣50台新9A售05,0,0,0,0,0,0,0,0,0,20000,0,0,0,20000,0,20000,20000
07553P,嘉晶元大9A售02  ,0,0,0,0,0,0,0,0,0,20000,0,0,0,35000,15000,20000,20000
07473P,祥碩元大9A售01  ,0,0,0,0,0,0,0,0,0,20000,0,0,0,159000,139000,20000,20000
07864P,可成元大9B售01  ,0,0,0,0,0,0,0,0,0,20000,0,0,0,50000,30000,20000,20000
08079P,宏達電國票9B售03,0,0,0,0,0,0,0,0,0,20000,0,0,0,20000,0,20000,20000
052101,滬深2X兆豐96購01,0,0,0,0,0,0,0,0,0,20000,0,0,0,20000,0,20000,20000
052137,台表科凱基96購02,0,0,0,0,0,0,0,0,0,20000,0,0,0,20000,0,20000,20000
052191,超眾群益96購01  ,0,0,0,0,0,0,0,0,0,20000,0,0,0,20000,0,20000,20000
052054,台表科凱基96購01,0,0,0,0,0,0,0,0,0,20000,0,0,0,20000,0,20000,20000
052045,瑞昱凱基96購01  ,0,0,0,0,0,0,0,0,0,20000,0,0,0,20000,0,20000,20000
054016,嘉晶永豐96購04  ,0,0,0,0,0,0,0,0,0,20000,0,0,0,20000,0,20000,20000
053846,友達元富99購02  ,0,0,0,0,0,0,0,0,0,20000,0,0,0,20000,0,20000,20000
053760,牧德國泰98購01  ,0,0,0,0,0,0,0,0,0,20000,0,0,0,20000,0,20000,20000
050220,台積電元富96購01,0,0,0,0,0,0,0,0,0,20000,0,0,0,20000,0,20000,20000
049763,美食國泰96購01  ,0,0,0,0,0,0,0,0,0,20000,0,0,0,20000,0,20000,20000
047773,超眾元大96購01  ,0,0,0,0,0,0,0,0,0,20000,0,0,0,20000,0,20000,20000
051582,聯發科元大97購02,0,0,0,0,0,0,0,0,0,20000,0,0,0,20000,0,20000,20000
00707R,元大S&P日圓反1  ,0,0,0,0,0,0,0,0,0,20000,0,0,0,21000,1000,20000,20000
056325,群創兆豐9A購01  ,0,0,0,0,0,0,0,0,0,20000,0,0,0,20000,0,20000,20000
055359,超眾凱基97購01  ,0,0,0,0,0,0,0,0,0,20000,0,0,0,40000,20000,20000,20000
053705,滬深2X凱基99購01,0,0,0,0,0,0,0,0,0,20000,0,0,0,20000,0,20000,20000
053666,臺股指凱基96購29,0,0,0,0,0,0,0,0,0,20000,0,0,0,20000,0,20000,20000
053150,聯發科元大96購11,0,0,0,0,0,0,0,0,0,20000,0,0,0,20000,0,20000,20000
053153,大立光元大99購02,0,0,0,0,0,0,0,0,0,20000,0,0,0,20000,0,20000,20000
053091,同欣電元大96購01,0,0,0,0,0,0,0,0,0,20000,0,0,0,20000,0,20000,20000
055515,聚陽中信9A購01  ,0,0,0,0,0,0,0,0,0,20000,0,0,0,20000,0,20000,20000
055475,臻鼎凱基97購02  ,0,0,0,0,0,0,0,0,0,20000,0,0,0,20000,0,20000,20000
055568,緯穎凱基97購02  ,0,0,0,0,0,0,0,0,0,20000,0,0,0,30000,10000,20000,20000
056418,台光電元富98購01,0,0,0,0,0,0,0,0,0,20000,0,0,0,66000,46000,20000,20000
054289,聯發科元大97購11,0,0,0,0,0,0,0,0,0,20000,0,0,0,20000,0,20000,20000
053349,台郡國票97購02  ,0,0,0,0,0,0,0,0,0,20000,0,0,0,80000,60000,20000,20000
053185,友達中信99購01  ,0,0,0,0,0,0,0,0,0,20000,0,0,0,20000,0,20000,20000
053501,明泰兆豐96購01  ,0,0,0,0,0,0,0,0,0,20000,0,0,0,20000,0,20000,20000
054159,T50正2凱基99購01,0,0,0,0,0,0,0,0,0,20000,0,0,0,20000,0,20000,20000
052317,台積電元大96購11,0,0,0,0,0,0,0,0,0,20000,0,0,0,25000,5000,20000,20000
052325,高股息中信99購01,0,0,0,0,0,0,0,0,0,20000,0,0,0,20000,0,20000,20000
052809,訊芯元大97購01  ,0,0,0,0,0,0,0,0,0,20000,0,0,0,20000,0,20000,20000
052765,新日興群益97購01,0,0,0,0,0,0,0,0,0,20000,0,0,0,20000,0,20000,20000
052962,台積電凱基97購03,0,0,0,0,0,0,0,0,0,20000,0,0,0,20000,0,20000,20000
05242P,群創國泰97售01  ,0,0,0,0,0,0,0,0,0,20000,0,0,0,20000,0,20000,20000
059347,京鼎凱基99購02  ,0,0,0,0,0,0,0,0,0,20000,0,0,0,21000,1000,20000,20000
059323,新日興元大99購02,0,0,0,0,0,0,0,0,0,20000,0,0,0,30000,10000,20000,20000
055876,美食元富9A購01  ,0,0,0,0,0,0,0,0,0,20000,0,0,0,20000,0,20000,20000
059006,樺漢元大99購01  ,0,0,0,0,0,0,0,0,0,20000,0,0,0,178000,158000,20000,20000
059573,健策凱基9A購02  ,0,0,0,0,0,0,0,0,0,20000,0,0,0,20000,0,20000,20000
059164,旺宏凱基99購06  ,0,0,0,0,0,0,0,0,0,20000,0,0,0,30000,10000,20000,20000
056156,禾伸堂凱基98購04,0,0,0,0,0,0,0,0,0,20000,0,0,0,20000,0,20000,20000
056161,康控凱基98購02  ,0,0,0,0,0,0,0,0,0,20000,0,0,0,20000,0,20000,20000
05621P,聯電中信96售01  ,0,0,0,0,0,0,0,0,0,20000,0,0,0,20000,0,20000,20000
056223,華邦電凱基97購04,0,0,0,0,0,0,0,0,0,20000,0,0,0,30000,10000,20000,20000
056305,群創元大9A購03  ,0,0,0,0,0,0,0,0,0,20000,0,0,0,20000,0,20000,20000
055806,致新永豐97購02  ,0,0,0,0,0,0,0,0,0,20000,0,0,0,30000,10000,20000,20000
055809,T50反1國票98購02,0,0,0,0,0,0,0,0,0,20000,0,0,0,45000,25000,20000,20000
056104,義隆永豐97購01  ,0,0,0,0,0,0,0,0,0,20000,0,0,0,20000,0,20000,20000
056099,上銀永豐97購02  ,0,0,0,0,0,0,0,0,0,20000,0,0,0,20000,0,20000,20000
055986,祥碩元富97購01  ,0,0,0,0,0,0,0,0,0,20000,0,0,0,20000,0,20000,20000
056034,華通凱基98購01  ,0,0,0,0,0,0,0,0,0,20000,0,0,0,20000,0,20000,20000
056623,禾伸堂永豐98購01,0,0,0,0,0,0,0,0,0,20000,0,0,0,20000,0,20000,20000
055939,GIS群益97購01   ,0,0,0,0,0,0,0,0,0,20000,0,0,0,20000,0,20000,20000
054439,健策台新96購03  ,0,0,0,0,0,0,0,0,0,20000,0,0,0,40000,20000,20000,20000
054468,台郡凱基98購01  ,0,0,0,0,0,0,0,0,0,20000,0,0,0,20000,0,20000,20000
055310,聯詠群益97購02  ,0,0,0,0,0,0,0,0,0,20000,0,0,0,20000,0,20000,20000
054777,昇陽半國票98購01,0,0,0,0,0,0,0,0,0,20000,0,0,0,20000,0,20000,20000
054917,聯發科凱基98購05,0,0,0,0,0,0,0,0,0,20000,0,0,0,20000,0,20000,20000
054948,聯發科元大97購14,0,0,0,0,0,0,0,0,0,20000,0,0,0,20000,0,20000,20000
055203,建準中信97購01  ,0,0,0,0,0,0,0,0,0,20000,0,0,0,20000,0,20000,20000
055147,鴻海元大97購11  ,0,0,0,0,0,0,0,0,0,20000,0,0,0,20000,0,20000,20000
05511P,T50反1台新06售01,0,0,0,0,0,0,0,0,0,20000,0,0,0,20000,0,20000,20000
058476,旺宏凱基9A購01  ,0,0,0,0,0,0,0,0,0,20000,0,0,0,30000,10000,20000,20000
058698,華通元大99購05  ,0,0,0,0,0,0,0,0,0,20000,0,0,0,109000,89000,20000,20000
058408,華通兆豐99購02  ,0,0,0,0,0,0,0,0,0,20000,0,0,0,108000,88000,20000,20000
057379,寶成元大98購02  ,0,0,0,0,0,0,0,0,0,20000,0,0,0,20000,0,20000,20000
057380,技嘉國泰9A購01  ,0,0,0,0,0,0,0,0,0,20000,0,0,0,20000,0,20000,20000
057549,台光電凱基98購05,0,0,0,0,0,0,0,0,0,20000,0,0,0,20000,0,20000,20000
057659,台表科兆豐98購01,0,0,0,0,0,0,0,0,0,20000,0,0,0,20000,0,20000,20000
060313,淘帝永豐9A購01  ,0,0,0,0,0,0,0,0,0,20000,0,0,0,20000,0,20000,20000
057486,美律元大98購04  ,0,0,0,0,0,0,0,0,0,20000,0,0,0,88000,68000,20000,20000
058994,道瓊指元大99購01,0,0,0,0,0,0,0,0,0,20000,0,0,0,30000,10000,20000,20000
057924,健策凱基98購02  ,0,0,0,0,0,0,0,0,0,20000,0,0,0,30000,10000,20000,20000
059266,緯創中信01購01  ,0,0,0,0,0,0,0,0,0,20000,0,0,0,20000,0,20000,20000
059719,台積電元大99購42,0,0,0,0,0,0,0,0,0,20000,0,0,0,40000,20000,20000,20000
057221,華通國票98購03  ,0,0,0,0,0,0,0,0,0,20000,0,0,0,22000,2000,20000,20000
057267,康控兆豐99購01  ,0,0,0,0,0,0,0,0,0,20000,0,0,0,20000,0,20000,20000
057243,樺漢凱基99購01  ,0,0,0,0,0,0,0,0,0,20000,0,0,0,52000,32000,20000,20000
057318,台光電凱基9A購01,0,0,0,0,0,0,0,0,0,20000,0,0,0,20000,0,20000,20000
057618,台光電凱基99購01,0,0,0,0,0,0,0,0,0,20000,0,0,0,20000,0,20000,20000
057650,力成元大98購04  ,0,0,0,0,0,0,0,0,0,20000,0,0,0,20000,0,20000,20000
056688,聯詠統一98購01  ,0,0,0,0,0,0,0,0,0,20000,0,0,0,20000,0,20000,20000
05710P,禾伸堂國票97售02,0,0,0,0,0,0,0,0,0,20000,0,0,0,120000,100000,20000,20000
05708P,奇力新國票97售04,0,0,0,0,0,0,0,0,0,20000,0,0,0,35000,15000,20000,20000
057012,康控中信98購01  ,0,0,0,0,0,0,0,0,0,20000,0,0,0,20000,0,20000,20000
059879,GIS凱基99購03   ,0,0,0,0,0,0,0,0,0,20000,0,0,0,30000,10000,20000,20000
059829,超眾凱基99購05  ,0,0,0,0,0,0,0,0,0,20000,0,0,0,40000,20000,20000,20000
060060,台積電兆豐99購05,0,0,0,0,0,0,0,0,0,20000,0,0,0,30000,10000,20000,20000
056938,泰碩元富98購01  ,0,0,0,0,0,0,0,0,0,20000,0,0,0,20000,0,20000,20000
056925,群創兆豐98購03  ,0,0,0,0,0,0,0,0,0,20000,0,0,0,20000,0,20000,20000
056917,國巨兆豐98購03  ,0,0,0,0,0,0,0,0,0,20000,0,0,0,50000,30000,20000,20000
060510,大立光元大9A購03,0,0,0,0,0,0,0,0,0,20000,0,0,0,40000,20000,20000,20000
060537,台灣50凱基9B購01,0,0,0,0,0,0,0,0,0,20000,0,0,0,20000,0,20000,20000
060645,台表科永豐9A購02,0,0,0,0,0,0,0,0,0,20000,0,0,0,30000,10000,20000,20000
060808,欣興群益9A購01  ,0,0,0,0,0,0,0,0,0,20000,0,0,0,20000,0,20000,20000
061126,京元電永豐9A購02,0,0,0,0,0,0,0,0,0,20000,0,0,0,45000,25000,20000,20000
061596,健策永豐9A購03  ,0,0,0,0,0,0,0,0,0,20000,0,0,0,33000,13000,20000,20000
06153P,健策元大97售04  ,0,0,0,0,0,0,0,0,0,20000,0,0,0,20000,0,20000,20000
061263,微星凱基9A購01  ,0,0,0,0,0,0,0,0,0,20000,0,0,0,30000,10000,20000,20000
061282,台積電統一9C購06,0,0,0,0,0,0,0,0,0,20000,0,0,0,20000,0,20000,20000
061438,牧德凱基9B購02  ,0,0,0,0,0,0,0,0,0,20000,0,0,0,20000,0,20000,20000
061827,台灣50凱基02購01,0,0,0,0,0,0,0,0,0,20000,0,0,0,20000,0,20000,20000
062616,玉晶光元大9C購06,0,0,0,0,0,0,0,0,0,20000,0,0,0,20000,0,20000,20000
062317,祥碩凱基9B購03  ,0,0,0,0,0,0,0,0,0,20000,0,0,0,20000,0,20000,20000
062299,台積電第一9B購01,0,0,0,0,0,0,0,0,0,20000,0,0,0,20000,0,20000,20000
06228P,亞德客凱基97售04,0,0,0,0,0,0,0,0,0,20000,0,0,0,30000,10000,20000,20000
062408,致新永豐9B購01  ,0,0,0,0,0,0,0,0,0,20000,0,0,0,88000,68000,20000,20000
4576,大銀微系統      ,50000,32000,18000,0,0,0,0,0,0,2000,2000,0,2000,0,0,0,20000
5243,乙盛-KY         ,293000,315000,-22000,0,0,0,0,0,0,42000,42000,0,42000,0,0,0,20000
8374,羅昇            ,18000,0,18000,0,0,0,0,0,0,2000,2000,0,2000,0,0,0,20000
8940,新天地          ,24000,4000,20000,0,0,0,0,0,0,0,0,0,0,0,0,0,20000
08056P,華通群益9B售06  ,0,0,0,0,0,0,0,0,0,19000,0,0,0,19000,0,19000,19000
07761P,智邦永豐9A售03  ,0,0,0,0,0,0,0,0,0,19000,0,0,0,19000,0,19000,19000
07668P,旺宏元大9A售10  ,0,0,0,0,0,0,0,0,0,19000,0,0,0,19000,0,19000,19000
2413,環科            ,22000,6000,16000,0,0,0,0,0,0,3000,3000,0,3000,0,0,0,19000
2017,官田鋼          ,16000,2000,14000,0,0,0,0,0,0,5000,5000,0,5000,0,0,0,19000
1626,艾美特-KY       ,22000,3000,19000,0,0,0,0,0,0,0,0,0,0,0,0,0,19000
1528,恩德            ,9000,0,9000,0,0,0,0,0,0,10000,10000,0,10000,0,0,0,19000
06889P,臺股指元大98售13,0,0,0,0,0,0,0,0,0,19000,0,0,0,29000,10000,19000,19000
055322,欣興國票97購06  ,0,0,0,0,0,0,0,0,0,19000,0,0,0,19000,0,19000,19000
054716,緯穎康和97購01  ,0,0,0,0,0,0,0,0,0,19000,0,0,0,20000,1000,19000,19000
059152,臺股指國票99購15,0,0,0,0,0,0,0,0,0,19000,0,0,0,20000,1000,19000,19000
059061,晶技凱基9A購01  ,0,0,0,0,0,0,0,0,0,19000,0,0,0,35000,16000,19000,19000
053540,健策永豐96購01  ,0,0,0,0,0,0,0,0,0,19000,0,0,0,20000,1000,19000,19000
00757,統一FANG+       ,0,0,0,0,0,0,0,0,0,19000,0,0,0,246000,227000,19000,19000
059954,華新科康和99購01,0,0,0,0,0,0,0,0,0,19000,0,0,0,50000,31000,19000,19000
057625,泰鼎國泰9A購01  ,0,0,0,0,0,0,0,0,0,19000,0,0,0,19000,0,19000,19000
057949,南電國票99購01  ,0,0,0,0,0,0,0,0,0,19000,0,0,0,19000,0,19000,19000
057957,嘉晶元大98購01  ,0,0,0,0,0,0,0,0,0,19000,0,0,0,58000,39000,19000,19000
058267,奇鋐永豐99購01  ,0,0,0,0,0,0,0,0,0,19000,0,0,0,39000,20000,19000,19000
060143,台積電國票9B購03,0,0,0,0,0,0,0,0,0,19000,0,0,0,23000,4000,19000,19000
057791,可成統一99購01  ,0,0,0,0,0,0,0,0,0,19000,0,0,0,20000,1000,19000,19000
058581,大立光群益99購05,0,0,0,0,0,0,0,0,0,19000,0,0,0,19000,0,19000,19000
062403,健策永豐9B購06  ,0,0,0,0,0,0,0,0,0,19000,0,0,0,34000,15000,19000,19000
062559,嘉晶凱基9B購02  ,0,0,0,0,0,0,0,0,0,19000,0,0,0,20000,1000,19000,19000
062439,聯發科元大9B購10,0,0,0,0,0,0,0,0,0,19000,0,0,0,30000,11000,19000,19000
062599,鴻海台新9B購01  ,0,0,0,0,0,0,0,0,0,19000,0,0,0,19000,0,19000,19000
061637,華新科元大9A購22,0,0,0,0,0,0,0,0,0,19000,0,0,0,19000,0,19000,19000
061516,力成永豐9A購02  ,0,0,0,0,0,0,0,0,0,19000,0,0,0,68000,49000,19000,19000
061111,台表科元大9A購02,0,0,0,0,0,0,0,0,0,19000,0,0,0,19000,0,19000,19000
060784,鴻海富邦9C購01  ,0,0,0,0,0,0,0,0,0,19000,0,0,0,128000,109000,19000,19000
060737,瑞儀統一9C購01  ,0,0,0,0,0,0,0,0,0,19000,0,0,0,21000,2000,19000,19000
060524,國巨中信9A購03  ,0,0,0,0,0,0,0,0,0,19000,0,0,0,19000,0,19000,19000
9908,大台北          ,25000,2000,23000,0,0,0,0,0,0,-4000,5000,9000,-4000,0,0,0,19000
3305,昇貿            ,19000,1000,18000,0,0,0,0,0,0,1000,1000,0,1000,0,0,0,19000
06369P,台積電凱基97售16,0,0,0,0,0,0,0,0,0,18000,0,0,0,25000,7000,18000,18000
063424,新日興凱基01購01,0,0,0,0,0,0,0,0,0,18000,0,0,0,54000,36000,18000,18000
063512,聯發科麥證9B購02,0,0,0,18000,0,18000,0,0,0,18000,0,0,0,18000,0,18000,18000
063298,統一凱基9B購01  ,0,0,0,0,0,0,0,0,0,18000,0,0,0,30000,12000,18000,18000
08127P,聯發科元大9B售21,0,0,0,0,0,0,0,0,0,18000,0,0,0,79000,61000,18000,18000
07838P,泰碩元大9A售04  ,0,0,0,0,0,0,0,0,0,18000,0,0,0,53000,35000,18000,18000
048892,台郡元富97購01  ,0,0,0,0,0,0,0,0,0,18000,0,0,0,36000,18000,18000,18000
053979,健策元大98購01  ,0,0,0,0,0,0,0,0,0,18000,0,0,0,19000,1000,18000,18000
054074,健策富邦98購01  ,0,0,0,0,0,0,0,0,0,18000,0,0,0,20000,2000,18000,18000
052855,群創日盛99購01  ,0,0,0,0,0,0,0,0,0,18000,0,0,0,18000,0,18000,18000
054278,晶技群益97購02  ,0,0,0,0,0,0,0,0,0,18000,0,0,0,18000,0,18000,18000
056366,玉晶光元大99購04,0,0,0,0,0,0,0,0,0,18000,0,0,0,35000,17000,18000,18000
056374,聯發科統一9B購01,0,0,0,0,0,0,0,0,0,18000,0,0,0,18000,0,18000,18000
056378,欣興元富98購01  ,0,0,0,0,0,0,0,0,0,18000,0,0,0,18000,0,18000,18000
056398,南茂永豐98購01  ,0,0,0,0,0,0,0,0,0,18000,0,0,0,105000,87000,18000,18000
05915P,聯發科元大96售19,0,0,0,0,0,0,0,0,0,18000,0,0,0,18000,0,18000,18000
054895,南電統一97購01  ,0,0,0,0,0,0,0,0,0,18000,0,0,0,40000,22000,18000,18000
058561,T50反1凱基9A購05,0,0,0,0,0,0,0,0,0,18000,0,0,0,18000,0,18000,18000
057403,亞光群益98購04  ,0,0,0,0,0,0,0,0,0,18000,0,0,0,28000,10000,18000,18000
058699,楠梓電元大99購02,0,0,0,0,0,0,0,0,0,18000,0,0,0,68000,50000,18000,18000
058234,華新科元大99購12,0,0,0,0,0,0,0,0,0,18000,0,0,0,68000,50000,18000,18000
060084,聯電元大99購02  ,0,0,0,0,0,0,0,0,0,18000,0,0,0,50000,32000,18000,18000
060949,祥碩中信9A購01  ,0,0,0,0,0,0,0,0,0,18000,0,0,0,20000,2000,18000,18000
058801,致伸元大99購01  ,0,0,0,0,0,0,0,0,0,18000,0,0,0,650000,632000,18000,18000
057269,鈺齊兆豐98購01  ,0,0,0,0,0,0,0,0,0,18000,0,0,0,18000,0,18000,18000
057222,鴻海國票99購04  ,0,0,0,0,0,0,0,0,0,18000,0,0,0,20000,2000,18000,18000
059435,大立光元大99購17,0,0,0,0,0,0,0,0,0,18000,0,0,0,18000,0,18000,18000
058855,台積電兆豐99購02,0,0,0,0,0,0,0,0,0,18000,0,0,0,349000,331000,18000,18000
059632,聯發科凱基01購01,0,0,0,0,0,0,0,0,0,18000,0,0,0,18000,0,18000,18000
058093,神達元大9A購01  ,0,0,0,0,0,0,0,0,0,18000,0,0,0,68000,50000,18000,18000
057027,祥碩凱基98購01  ,0,0,0,0,0,0,0,0,0,18000,0,0,0,18000,0,18000,18000
060525,台積電中信01購04,0,0,0,0,0,0,0,0,0,18000,0,0,0,20000,2000,18000,18000
060555,台表科凱基9A購03,0,0,0,0,0,0,0,0,0,18000,0,0,0,28000,10000,18000,18000
061421,台積電元大9A購29,0,0,0,0,0,0,0,0,0,18000,0,0,0,18000,0,18000,18000
061302,晶技永豐9A購04  ,0,0,0,0,0,0,0,0,0,18000,0,0,0,499000,481000,18000,18000
062666,和碩群益9B購01  ,0,0,0,0,0,0,0,0,0,18000,0,0,0,244000,226000,18000,18000
062852,聯發科永豐9B購02,0,0,0,0,0,0,0,0,0,18000,0,0,0,18000,0,18000,18000
063178,聯發科兆豐9B購04,0,0,0,0,0,0,0,0,0,18000,0,0,0,20000,2000,18000,18000
062483,致新國票9B購01  ,0,0,0,0,0,0,0,0,0,18000,0,0,0,24000,6000,18000,18000
062496,矽創中信9B購01  ,0,0,0,0,0,0,0,0,0,18000,0,0,0,167000,149000,18000,18000
062379,致新元大9B購01  ,0,0,0,0,0,0,0,0,0,18000,0,0,0,68000,50000,18000,18000
062277,廣達群益9B購01  ,0,0,0,0,0,0,0,0,0,18000,0,0,0,47000,29000,18000,18000
062251,旺宏元大9B購06  ,0,0,0,0,0,0,0,0,0,18000,0,0,0,68000,50000,18000,18000
062114,GIS國票9C購01   ,0,0,0,0,0,0,0,0,0,18000,0,0,0,22000,4000,18000,18000
3356,奇偶            ,34000,17000,17000,0,0,0,0,0,0,1000,2000,1000,1000,0,0,0,18000
2923,鼎固-KY         ,18000,0,18000,0,0,0,0,0,0,0,0,0,0,0,0,0,18000
6491,晶碩            ,9000,26000,-17000,0,0,0,25000,0,25000,10000,10000,0,10000,0,0,0,18000
6449,鈺邦            ,17000,0,17000,0,0,0,0,0,0,1000,2000,1000,1000,0,0,0,18000
07404P,華新科凱基99售10,0,0,0,0,0,0,0,0,0,17000,0,0,0,20000,3000,17000,17000
063740,矽格元大9B購03  ,0,0,0,0,0,0,0,0,0,17000,0,0,0,24000,7000,17000,17000
063751,祥碩國票9C購02  ,0,0,0,0,0,0,0,0,0,17000,0,0,0,17000,0,17000,17000
063782,致新永豐9B購02  ,0,0,0,0,0,0,0,0,0,17000,0,0,0,20000,3000,17000,17000
063619,聯發科兆豐01購01,0,0,0,0,0,0,0,0,0,17000,0,0,0,22000,5000,17000,17000
06483P,聯發科凱基98售10,0,0,0,0,0,0,0,0,0,17000,0,0,0,17000,0,17000,17000
06729P,聯詠元大98售03  ,0,0,0,0,0,0,0,0,0,17000,0,0,0,17000,0,17000,17000
054626,建準凱基98購01  ,0,0,0,0,0,0,0,0,0,17000,0,0,0,20000,3000,17000,17000
056464,臺股指凱基99購06,0,0,0,0,0,0,0,0,0,17000,0,0,0,17000,0,17000,17000
059121,瑞儀永豐99購01  ,0,0,0,0,0,0,0,0,0,17000,0,0,0,34000,17000,17000,17000
052795,健策兆豐97購01  ,0,0,0,0,0,0,0,0,0,17000,0,0,0,17000,0,17000,17000
049254,台積電元大96購02,0,0,0,0,0,0,0,0,0,17000,0,0,0,17000,0,17000,17000
056941,台郡元富9B購01  ,0,0,0,0,0,0,0,0,0,17000,0,0,0,17000,0,17000,17000
056721,台灣50永昌9A購01,0,0,0,0,0,0,0,0,0,17000,0,0,0,17000,0,17000,17000
058105,旺宏統一9A購02  ,0,0,0,0,0,0,0,0,0,17000,0,0,0,20000,3000,17000,17000
059946,健策永豐99購05  ,0,0,0,0,0,0,0,0,0,17000,0,0,0,18000,1000,17000,17000
059908,元金2X元大99購01,0,0,0,0,0,0,0,0,0,17000,0,0,0,20000,3000,17000,17000
059917,華新科元大99購19,0,0,0,0,0,0,0,0,0,17000,0,0,0,71000,54000,17000,17000
059783,旺宏元大99購17  ,0,0,0,0,0,0,0,0,0,17000,0,0,0,17000,0,17000,17000
060010,義隆群益99購02  ,0,0,0,0,0,0,0,0,0,17000,0,0,0,46000,29000,17000,17000
058874,聯鈞國票9A購01  ,0,0,0,0,0,0,0,0,0,17000,0,0,0,80000,63000,17000,17000
059212,鴻海元大99購28  ,0,0,0,0,0,0,0,0,0,17000,0,0,0,27000,10000,17000,17000
060063,可成兆豐9B購01  ,0,0,0,0,0,0,0,0,0,17000,0,0,0,20000,3000,17000,17000
057406,茂林群益98購03  ,0,0,0,0,0,0,0,0,0,17000,0,0,0,43000,26000,17000,17000
057492,大立光元大98購18,0,0,0,0,0,0,0,0,0,17000,0,0,0,25000,8000,17000,17000
062055,鴻海統一9C購07  ,0,0,0,0,0,0,0,0,0,17000,0,0,0,17000,0,17000,17000
062007,台光電國泰9C購01,0,0,0,0,0,0,0,0,0,17000,0,0,0,25000,8000,17000,17000
061994,瑞儀元大9B購01  ,0,0,0,0,0,0,0,0,0,17000,0,0,0,94000,77000,17000,17000
061969,大立光統一01購02,0,0,0,0,0,0,0,0,0,17000,0,0,0,35000,18000,17000,17000
062565,漢唐中信9C購01  ,0,0,0,0,0,0,0,0,0,17000,0,0,0,17000,0,17000,17000
062575,景碩群益9B購01  ,0,0,0,0,0,0,0,0,0,17000,0,0,0,118000,101000,17000,17000
062859,玉晶光國票01購02,0,0,0,0,0,0,0,0,0,17000,0,0,0,149000,132000,17000,17000
061335,國巨元大9A購19  ,0,0,0,0,0,0,0,0,0,17000,0,0,0,28000,11000,17000,17000
061426,玉晶光元大9A購15,0,0,0,0,0,0,0,0,0,17000,0,0,0,17000,0,17000,17000
061407,鴻海國票9A購07  ,0,0,0,0,0,0,0,0,0,17000,0,0,0,29000,12000,17000,17000
061465,聯詠群益9A購01  ,0,0,0,0,0,0,0,0,0,17000,0,0,0,20000,3000,17000,17000
061586,智邦富邦9A購02  ,0,0,0,0,0,0,0,0,0,17000,0,0,0,50000,33000,17000,17000
061706,旭富國票9A購02  ,30000,0,30000,0,0,0,0,0,0,-13000,0,0,0,33000,46000,-13000,17000
060618,玉晶光元大9A購02,0,0,0,0,0,0,0,0,0,17000,0,0,0,69000,52000,17000,17000
061047,大立光第一9A購01,0,0,0,0,0,0,0,0,0,17000,0,0,0,20000,3000,17000,17000
061084,京元電兆豐9A購02,0,0,0,0,0,0,0,0,0,17000,0,0,0,141000,124000,17000,17000
9917,中保科          ,174000,252000,-78000,0,0,0,0,1000,-1000,96000,100000,4000,96000,0,0,0,17000
063293,億豐元大9B購01  ,0,0,0,0,0,0,0,0,0,16000,0,0,0,130000,114000,16000,16000
063506,嘉晶群益9B購01  ,0,0,0,0,0,0,0,0,0,16000,0,0,0,162000,146000,16000,16000
07472P,和碩元大9A售03  ,0,0,0,0,0,0,0,0,0,16000,0,0,0,16000,0,16000,16000
08108P,聯發科元富9B售03,0,0,0,0,0,0,0,0,0,16000,0,0,0,16000,0,16000,16000
1533,車王電          ,17000,2000,15000,0,0,0,0,0,0,1000,1000,0,1000,0,0,0,16000
1614,三洋電          ,13000,0,13000,0,0,0,0,0,0,3000,3000,0,3000,0,0,0,16000
1603,華電            ,16000,2000,14000,0,0,0,0,0,0,2000,2000,0,2000,0,0,0,16000
2029,盛餘            ,14000,0,14000,0,0,0,0,0,0,2000,2000,0,2000,0,0,0,16000
2546,根基            ,29000,15000,14000,0,0,0,0,0,0,2000,2000,0,2000,0,0,0,16000
054064,台郡國票97購04  ,0,0,0,0,0,0,0,0,0,16000,0,0,0,82000,66000,16000,16000
006206,元大上證50      ,10000,16000,-6000,0,0,0,0,0,0,22000,0,0,0,635000,613000,22000,16000
03029X,元展26          ,0,0,0,0,0,0,0,0,0,16000,0,0,0,16000,0,16000,16000
050895,聯發科元大97購01,0,0,0,0,0,0,0,0,0,16000,0,0,0,28000,12000,16000,16000
052791,友達兆豐97購01  ,0,0,0,0,0,0,0,0,0,16000,0,0,0,71000,55000,16000,16000
056519,創意國票99購01  ,0,0,0,0,0,0,0,0,0,16000,0,0,0,84000,68000,16000,16000
055620,樺漢國票98購01  ,0,0,0,0,0,0,0,0,0,16000,0,0,0,16000,0,16000,16000
055732,全新元富9A購01  ,0,0,0,0,0,0,0,0,0,16000,0,0,0,16000,0,16000,16000
057948,嘉聯益國票99購02,0,0,0,0,0,0,0,0,0,16000,0,0,0,105000,89000,16000,16000
059683,康控富邦9C購01  ,0,0,0,0,0,0,0,0,0,16000,0,0,0,36000,20000,16000,16000
059659,旺宏元大9A購03  ,0,0,0,0,0,0,0,0,0,16000,0,0,0,16000,0,16000,16000
060014,中鋼康和99購01  ,0,0,0,0,0,0,0,0,0,16000,0,0,0,380000,364000,16000,16000
056914,臺股指元大99購09,0,0,0,0,0,0,0,0,0,16000,0,0,0,16000,0,16000,16000
059957,中信金康和99購01,0,0,0,0,0,0,0,0,0,16000,0,0,0,37000,21000,16000,16000
058135,景碩元大99購01  ,0,0,0,0,0,0,0,0,0,16000,0,0,0,90000,74000,16000,16000
061078,台積電兆豐9A購01,0,0,0,0,0,0,0,0,0,16000,0,0,0,30000,14000,16000,16000
060855,華新科富邦01購01,0,0,0,0,0,0,0,0,0,16000,0,0,0,66000,50000,16000,16000
060856,健策富邦9B購02  ,0,0,0,0,0,0,0,0,0,16000,0,0,0,18000,2000,16000,16000
061549,泰碩群益9A購01  ,0,0,0,0,0,0,0,0,0,16000,0,0,0,238000,222000,16000,16000
061524,華通凱基9A購07  ,0,0,0,0,0,0,0,0,0,16000,0,0,0,16000,0,16000,16000
062831,嘉澤群益9B購01  ,0,0,0,0,0,0,0,0,0,16000,0,0,0,39000,23000,16000,16000
063122,聯發科元大9B購15,0,0,0,0,0,0,0,0,0,16000,0,0,0,54000,38000,16000,16000
062278,聯發科群益9C購01,0,0,0,0,0,0,0,0,0,16000,0,0,0,16000,0,16000,16000
062398,建準永豐9B購01  ,0,0,0,0,0,0,0,0,0,16000,0,0,0,84000,68000,16000,16000
062196,聯發科中信01購02,0,0,0,0,0,0,0,0,0,16000,0,0,0,16000,0,16000,16000
6128,上福            ,15000,0,15000,0,0,0,0,0,0,1000,1000,0,1000,0,0,0,16000
2702,華園            ,69000,55000,14000,0,0,0,0,0,0,1000,1000,0,1000,0,0,0,15000
2906,高林            ,19000,6000,13000,0,0,0,0,0,0,2000,2000,0,2000,0,0,0,15000
08234P,華擎元富9B售03  ,0,0,0,0,0,0,0,0,0,15000,0,0,0,15000,0,15000,15000
08027P,嘉晶元大9B售03  ,0,0,0,0,0,0,0,0,0,15000,0,0,0,44000,29000,15000,15000
07840P,康控元大9A售02  ,0,0,0,0,0,0,0,0,0,15000,0,0,0,65000,50000,15000,15000
07759P,臺股指富邦9A售04,0,0,0,0,0,0,0,0,0,15000,0,0,0,15000,0,15000,15000
063447,聯發科統一9B購12,0,0,0,0,0,0,0,0,0,15000,0,0,0,86000,71000,15000,15000
063385,可成中信9C購01  ,0,0,0,0,0,0,0,0,0,15000,0,0,0,18000,3000,15000,15000
063300,華通凱基9B購05  ,0,0,0,0,0,0,0,0,0,15000,0,0,0,18000,3000,15000,15000
06370P,貿聯凱基97售03  ,0,0,0,0,0,0,0,0,0,15000,0,0,0,165000,150000,15000,15000
06751P,旺宏凱基98售10  ,0,0,0,0,0,0,0,0,0,15000,0,0,0,15000,0,15000,15000
06616P,國巨元大98售15  ,0,0,0,0,0,0,0,0,0,15000,0,0,0,15000,0,15000,15000
06477P,緯穎國票99售02  ,0,0,0,0,0,0,0,0,0,15000,0,0,0,155000,140000,15000,15000
06955P,臻鼎元富99售01  ,0,0,0,0,0,0,0,0,0,15000,0,0,0,20000,5000,15000,15000
055710,亞德客元大97購03,0,0,0,0,0,0,0,0,0,15000,0,0,0,50000,35000,15000,15000
055276,台積電元大97購20,0,0,0,0,0,0,0,0,0,15000,0,0,0,15000,0,15000,15000
054821,貿聯元大9A購01  ,0,0,0,0,0,0,0,0,0,15000,0,0,0,15000,0,15000,15000
054374,信邦中信96購01  ,0,0,0,0,0,0,0,0,0,15000,0,0,0,15000,0,15000,15000
059113,群光永豐99購01  ,0,0,0,0,0,0,0,0,0,15000,0,0,0,25000,10000,15000,15000
059070,道瓊指元大99購02,0,0,0,0,0,0,0,0,0,15000,0,0,0,15000,0,15000,15000
05901P,臺股指凱基9C售01,0,0,0,0,0,0,0,0,0,15000,0,0,0,15000,0,15000,15000
054180,亞泥康和96購01  ,0,0,0,0,0,0,0,0,0,15000,0,0,0,15000,0,15000,15000
056413,上証反中信9A購01,0,0,0,0,0,0,0,0,0,15000,0,0,0,15000,0,15000,15000
055353,華新科凱基98購03,0,0,0,0,0,0,0,0,0,15000,0,0,0,30000,15000,15000,15000
055427,技嘉群益98購01  ,0,0,0,0,0,0,0,0,0,15000,0,0,0,15000,0,15000,15000
050601,台表科國泰96購01,0,0,0,0,0,0,0,0,0,15000,0,0,0,15000,0,15000,15000
0054,元大台商50      ,0,0,0,0,0,0,0,0,0,15000,0,0,0,17000,2000,15000,15000
00735,國泰臺韓科技    ,80000,0,80000,0,0,0,0,0,0,-65000,0,0,0,197000,262000,-65000,15000
052113,漢唐中信98購01  ,0,0,0,0,0,0,0,0,0,15000,0,0,0,45000,30000,15000,15000
054142,致伸元大97購01  ,0,0,0,0,0,0,0,0,0,15000,0,0,0,20000,5000,15000,15000
049584,台積電元大96購04,0,0,0,0,0,0,0,0,0,15000,0,0,0,15000,0,15000,15000
059981,聯發科元大99購36,0,0,0,0,0,0,0,0,0,15000,0,0,0,33000,18000,15000,15000
059861,聯發科群益9A購01,0,0,0,0,0,0,0,0,0,15000,0,0,0,15000,0,15000,15000
056837,國巨元富98購02  ,0,0,0,0,0,0,0,0,0,15000,0,0,0,15000,0,15000,15000
060011,臺股指群益9C購06,0,0,0,0,0,0,0,0,0,15000,0,0,0,22000,7000,15000,15000
060050,鴻海凱基9B購01  ,0,0,0,0,0,0,0,0,0,15000,0,0,0,75000,60000,15000,15000
059675,大立光元富99購08,0,0,0,0,0,0,0,0,0,15000,0,0,0,15000,0,15000,15000
059630,美律凱基99購07  ,0,0,0,0,0,0,0,0,0,15000,0,0,0,15000,0,15000,15000
05943P,欣興凱基96售03  ,0,0,0,0,0,0,0,0,0,15000,0,0,0,15000,0,15000,15000
057205,元翎元富98購01  ,0,0,0,0,0,0,0,0,0,15000,0,0,0,15000,0,15000,15000
057153,祥碩國泰99購01  ,0,0,0,0,0,0,0,0,0,15000,0,0,0,15000,0,15000,15000
059211,鴻海元大99購27  ,0,0,0,0,0,0,0,0,0,15000,0,0,0,39000,24000,15000,15000
05922P,京元電兆豐96售01,0,0,0,0,0,0,0,0,0,15000,0,0,0,15000,0,15000,15000
059255,臺股指凱基99購33,0,0,0,0,0,0,0,0,0,15000,0,0,0,15000,0,15000,15000
057959,欣興元大98購14  ,0,0,0,0,0,0,0,0,0,15000,0,0,0,30000,15000,15000,15000
058956,健策國票9A購02  ,0,0,0,0,0,0,0,0,0,15000,0,0,0,34000,19000,15000,15000
058833,台表科永豐99購01,0,0,0,0,0,0,0,0,0,15000,0,0,0,30000,15000,15000,15000
058932,FBVIX台新99購01 ,0,0,0,0,0,0,0,0,0,15000,0,0,0,15000,0,15000,15000
057461,國巨永豐98購07  ,0,0,0,0,0,0,0,0,0,15000,0,0,0,15000,0,15000,15000
057431,京鼎兆豐98購02  ,0,0,0,0,0,0,0,0,0,15000,0,0,0,20000,5000,15000,15000
060277,道瓊反元大9A購02,0,0,0,0,0,0,0,0,0,15000,0,0,0,40000,25000,15000,15000
058691,友訊國票9A購01  ,0,0,0,0,0,0,0,0,0,15000,0,0,0,15000,0,15000,15000
058727,嘉晶富邦9A購01  ,0,0,0,0,0,0,0,0,0,15000,0,0,0,15000,0,15000,15000
058596,旺宏台新99購01  ,0,0,0,0,0,0,0,0,0,15000,0,0,0,45000,30000,15000,15000
057665,技嘉元大99購01  ,0,0,0,0,0,0,0,0,0,15000,0,0,0,83000,68000,15000,15000
057569,光磊永豐98購03  ,0,0,0,0,0,0,0,0,0,15000,0,0,0,136000,121000,15000,15000
062255,聯發科元大9B購07,0,0,0,0,0,0,0,0,0,15000,0,0,0,26000,11000,15000,15000
062275,燿華群益9B購01  ,0,0,0,0,0,0,0,0,0,15000,0,0,0,141000,126000,15000,15000
061981,聯發科元大9B購02,0,0,0,0,0,0,0,0,0,15000,0,0,0,74000,59000,15000,15000
062482,台表科國票9B購01,0,0,0,0,0,0,0,0,0,15000,0,0,0,15000,0,15000,15000
062440,聯發科元大9B購11,0,0,0,0,0,0,0,0,0,15000,0,0,0,19000,4000,15000,15000
061344,禾伸堂元大9A購02,0,0,0,0,0,0,0,0,0,15000,0,0,0,68000,53000,15000,15000
060993,健策元大9B購03  ,0,0,0,0,0,0,0,0,0,15000,0,0,0,44000,29000,15000,15000
061091,奇力新統一9C購02,0,0,0,0,0,0,0,0,0,15000,0,0,0,15000,0,15000,15000
5283,禾聯碩          ,17000,1000,16000,0,0,0,0,0,0,-1000,1000,2000,-1000,0,0,0,15000
4994,傳奇            ,34800,21000,13800,0,0,0,0,0,0,1000,1000,0,1000,0,0,0,14800
063587,漢唐永豐9B購02  ,0,0,0,0,0,0,0,0,0,14000,0,0,0,14000,0,14000,14000
063549,國巨國票9C購05  ,0,0,0,0,0,0,0,0,0,14000,0,0,0,20000,6000,14000,14000
063256,鴻海國泰01購02  ,0,0,0,0,0,0,0,0,0,14000,0,0,0,14000,0,14000,14000
063238,漢唐元大9B購02  ,0,0,0,0,0,0,0,0,0,14000,0,0,0,14000,0,14000,14000
07520P,臺股指元大9B售11,0,0,0,0,0,0,0,0,0,14000,0,0,0,14000,0,14000,14000
1437,勤益控          ,21000,7000,14000,0,0,0,0,0,0,0,0,0,0,0,0,0,14000
2010,春源            ,51000,38000,13000,0,0,0,0,0,0,1000,1000,0,1000,0,0,0,14000
1618,合機            ,10000,0,10000,0,0,0,0,0,0,4000,4000,0,4000,0,0,0,14000
2816,旺旺保          ,22000,9000,13000,0,0,0,0,0,0,1000,1000,0,1000,0,0,0,14000
053982,臻鼎元大96購05  ,0,0,0,0,0,0,0,0,0,14000,0,0,0,14000,0,14000,14000
053997,健策群益97購02  ,0,0,0,0,0,0,0,0,0,14000,0,0,0,14000,0,14000,14000
054050,創意元大96購06  ,0,0,0,0,0,0,0,0,0,14000,0,0,0,14000,0,14000,14000
054059,欣興國票97購03  ,0,0,0,0,0,0,0,0,0,14000,0,0,0,14000,0,14000,14000
04731P,臺股指中信96售03,0,0,0,0,0,0,0,0,0,14000,0,0,0,70000,56000,14000,14000
055525,國巨群益98購05  ,0,0,0,0,0,0,0,0,0,14000,0,0,0,28000,14000,14000,14000
052801,友達元大9A購01  ,0,0,0,0,0,0,0,0,0,14000,0,0,0,14000,0,14000,14000
055922,台郡凱基98購03  ,0,0,0,0,0,0,0,0,0,14000,0,0,0,14000,0,14000,14000
056026,智易群益97購01  ,0,0,0,0,0,0,0,0,0,14000,0,0,0,120000,106000,14000,14000
055973,亞德客統一97購01,0,0,0,0,0,0,0,0,0,14000,0,0,0,14000,0,14000,14000
055824,臺股指國票97購11,0,0,0,0,0,0,0,0,0,14000,0,0,0,14000,0,14000,14000
055327,致新國票98購01  ,0,0,0,0,0,0,0,0,0,14000,0,0,0,14000,0,14000,14000
056576,晶技元大99購02  ,0,0,0,0,0,0,0,0,0,14000,0,0,0,14000,0,14000,14000
057779,禾伸堂群益98購02,0,0,0,0,0,0,0,0,0,14000,0,0,0,14000,0,14000,14000
058470,台灣50日盛9B購02,0,0,0,0,0,0,0,0,0,14000,0,0,0,214000,200000,14000,14000
058474,鴻海凱基9A購06  ,0,0,0,0,0,0,0,0,0,14000,0,0,0,16000,2000,14000,14000
057962,超眾元大99購03  ,0,0,0,0,0,0,0,0,0,14000,0,0,0,65000,51000,14000,14000
05977P,旺宏永豐96售06  ,0,0,0,0,0,0,0,0,0,14000,0,0,0,29000,15000,14000,14000
056842,全新元富98購01  ,0,0,0,0,0,0,0,0,0,14000,0,0,0,14000,0,14000,14000
056883,美食康和98購01  ,0,0,0,0,0,0,0,0,0,14000,0,0,0,158000,144000,14000,14000
056746,超眾凱基99購01  ,0,0,0,0,0,0,0,0,0,14000,0,0,0,160000,146000,14000,14000
060999,國巨兆豐9A購01  ,0,0,0,0,0,0,0,0,0,14000,0,0,0,20000,6000,14000,14000
061156,玉晶光群益9A購07,0,0,0,0,0,0,0,0,0,14000,0,0,0,14000,0,14000,14000
060547,瑞昱凱基9A購01  ,0,0,0,0,0,0,0,0,0,14000,0,0,0,20000,6000,14000,14000
060672,鴻海元大9A購14  ,0,0,0,0,0,0,0,0,0,14000,0,0,0,14000,0,14000,14000
062514,玉晶光國票9C購02,0,0,0,0,0,0,0,0,0,14000,0,0,0,30000,16000,14000,14000
062029,牧德群益9B購03  ,0,0,0,0,0,0,0,0,0,14000,0,0,0,14000,0,14000,14000
062047,緯穎凱基9B購01  ,0,0,0,0,0,0,0,0,0,14000,0,0,0,44000,30000,14000,14000
062043,牧德凱基9B購04  ,0,0,0,0,0,0,0,0,0,14000,0,0,0,14000,0,14000,14000
6165,捷泰            ,49000,35000,14000,0,0,0,0,0,0,0,0,0,0,0,0,0,14000
3011,今皓            ,14000,0,14000,0,0,0,0,0,0,0,0,0,0,0,0,0,14000
3013,晟銘電          ,23000,11000,12000,0,0,0,0,0,0,2000,2000,0,2000,0,0,0,14000
2514,龍邦            ,50000,43000,7000,0,0,0,0,0,0,6000,6000,0,6000,0,0,0,13000
07508P,華新科國票9A售03,0,0,0,0,0,0,0,0,0,13000,0,0,0,40000,27000,13000,13000
07290P,台灣50凱基9A售08,0,0,0,0,0,0,0,0,0,13000,0,0,0,13000,0,13000,13000
07620P,國巨統一9B售07  ,0,0,0,0,0,0,0,0,0,13000,0,0,0,13000,0,13000,13000
063241,聯發科元大9B購18,0,0,0,0,0,0,0,0,0,13000,0,0,0,46000,33000,13000,13000
063316,聯發科群益9C購03,0,0,0,0,0,0,0,0,0,13000,0,0,0,99000,86000,13000,13000
063513,聯發科麥證9B購03,0,0,0,13000,0,13000,0,0,0,13000,0,0,0,13000,0,13000,13000
063588,華新科永豐9B購02,0,0,0,0,0,0,0,0,0,13000,0,0,0,13000,0,13000,13000
063637,聯發科元大9C購02,0,0,0,0,0,0,0,0,0,13000,0,0,0,20000,7000,13000,13000
063664,漢唐統一9C購01  ,0,0,0,0,0,0,0,0,0,13000,0,0,0,53000,40000,13000,13000
06478P,臺股指日盛9A售01,0,0,0,0,0,0,0,0,0,13000,0,0,0,13000,0,13000,13000
054925,神達凱基97購01  ,70000,0,70000,0,0,0,0,0,0,-57000,0,0,0,44000,101000,-57000,13000
054298,台表科元大97購03,0,0,0,0,0,0,0,0,0,13000,0,0,0,13000,0,13000,13000
055583,國巨元大97購10  ,0,0,0,0,0,0,0,0,0,13000,0,0,0,30000,17000,13000,13000
059317,台積電元大99購34,0,0,0,0,0,0,0,0,0,13000,0,0,0,21000,8000,13000,13000
059050,元油2X凱基9B購08,0,0,0,0,0,0,0,0,0,13000,0,0,0,13000,0,13000,13000
054188,欣興永豐96購03  ,0,0,0,0,0,0,0,0,0,13000,0,0,0,46000,33000,13000,13000
052885,高鐵兆豐98購01  ,0,0,0,0,0,0,0,0,0,13000,0,0,0,15000,2000,13000,13000
052928,美律元大98購01  ,0,0,0,0,0,0,0,0,0,13000,0,0,0,13000,0,13000,13000
056411,緯穎國票99購01  ,0,0,0,0,0,0,0,0,0,13000,0,0,0,199000,186000,13000,13000
03430B,臺股指元大9B熊01,0,0,0,0,0,0,0,0,0,13000,0,0,0,14000,1000,13000,13000
0055,元大MSCI金融    ,0,0,0,0,0,0,0,0,0,13000,0,0,0,27000,14000,13000,13000
03875P,滬深2X國票05售01,0,0,0,0,0,0,0,0,0,13000,0,0,0,23000,10000,13000,13000
057297,新日興永豐98購01,0,0,0,0,0,0,0,0,0,13000,0,0,0,74000,61000,13000,13000
056800,臺股指麥證98購01,0,0,0,13000,0,13000,0,0,0,13000,0,0,0,13000,0,13000,13000
059836,大立光國泰9B購02,0,0,0,0,0,0,0,0,0,13000,0,0,0,149000,136000,13000,13000
059918,華新科元大99購20,0,0,0,0,0,0,0,0,0,13000,0,0,0,134000,121000,13000,13000
059920,宏達電元大99購07,0,0,0,0,0,0,0,0,0,13000,0,0,0,84000,71000,13000,13000
057994,技嘉中信98購01  ,0,0,0,0,0,0,0,0,0,13000,0,0,0,24000,11000,13000,13000
059381,TPK亞東99購01   ,0,0,0,0,0,0,0,0,0,13000,0,0,0,13000,0,13000,13000
059237,鴻海凱基9A購10  ,0,0,0,0,0,0,0,0,0,13000,0,0,0,15000,2000,13000,13000
059265,美律中信01購01  ,0,0,0,0,0,0,0,0,0,13000,0,0,0,23000,10000,13000,13000
058518,玉晶光元大99購13,0,0,0,0,0,0,0,0,0,13000,0,0,0,235000,222000,13000,13000
058521,日月光元大99購01,0,0,0,0,0,0,0,0,0,13000,0,0,0,264000,251000,13000,13000
057747,致新永豐98購01  ,0,0,0,0,0,0,0,0,0,13000,0,0,0,13000,0,13000,13000
062742,技嘉國泰01購01  ,0,0,0,0,0,0,0,0,0,13000,0,0,0,123000,110000,13000,13000
062748,祥碩永豐9B購02  ,0,0,0,0,0,0,0,0,0,13000,0,0,0,13000,0,13000,13000
060840,可成國票9B購01  ,0,0,0,0,0,0,0,0,0,13000,0,0,0,13000,0,13000,13000
060521,鴻海中信01購03  ,0,0,0,0,0,0,0,0,0,13000,0,0,0,15000,2000,13000,13000
061783,友達群益9B購01  ,0,0,0,0,0,0,0,0,0,13000,0,0,0,33000,20000,13000,13000
06186P,鴻海統一97售02  ,0,0,0,0,0,0,0,0,0,13000,0,0,0,13000,0,13000,13000
3052,夆典            ,83000,71000,12000,0,0,0,0,0,0,1000,3000,2000,1000,0,0,0,13000
3416,融程電          ,27000,19000,8000,0,0,0,0,0,0,5000,0,0,0,5000,0,5000,13000
8114,振樺電          ,21000,8000,13000,0,0,0,0,0,0,0,1000,1000,0,0,0,0,13000
6579,研揚            ,15000,2000,13000,0,0,0,0,0,0,0,0,0,0,0,0,0,13000
9937,全國            ,18000,0,18000,0,0,0,0,0,0,-5000,0,5000,-5000,0,0,0,13000
06501P,臺股指元大9A售06,0,0,0,0,0,0,0,0,0,12000,0,0,0,15000,3000,12000,12000
063562,國巨元大9C購06  ,0,0,0,0,0,0,0,0,0,12000,0,0,0,18000,6000,12000,12000
063521,國巨凱基03購01  ,0,0,0,0,0,0,0,0,0,12000,0,0,0,12000,0,12000,12000
063397,廣達群益9B購02  ,0,0,0,0,0,0,0,0,0,12000,0,0,0,25000,13000,12000,12000
063345,嘉晶統一9C購02  ,0,0,0,0,0,0,0,0,0,12000,0,0,0,70000,58000,12000,12000
063240,聯發科元大9B購17,0,0,0,0,0,0,0,0,0,12000,0,0,0,36000,24000,12000,12000
063301,鴻海凱基9B購08  ,0,0,0,0,0,0,0,0,0,12000,0,0,0,14000,2000,12000,12000
07845P,南亞科元大9A售08,0,0,0,0,0,0,0,0,0,12000,0,0,0,36000,24000,12000,12000
08035P,國巨群益9C售04  ,0,0,0,0,0,0,0,0,0,12000,0,0,0,12000,0,12000,12000
08045P,健策國票9B售01  ,0,0,0,0,0,0,0,0,0,12000,0,0,0,22000,10000,12000,12000
08078P,聯發科國票9B售04,0,0,0,0,0,0,0,0,0,12000,0,0,0,12000,0,12000,12000
2028,威致            ,11000,0,11000,0,0,0,0,0,0,1000,1000,0,1000,0,0,0,12000
1325,恆大            ,19000,37000,-18000,0,0,0,0,0,0,30000,25000,1000,24000,6000,0,6000,12000
00865B,國泰US短期公債  ,0,0,0,0,0,0,0,0,0,12000,0,0,0,112000,100000,12000,12000
00685L,群益臺灣加權正2 ,0,0,0,0,0,0,0,0,0,12000,0,0,0,23000,11000,12000,12000
00673R,元大S&P原油反1  ,0,0,0,0,0,0,0,0,0,12000,0,0,0,249000,237000,12000,12000
050566,高股息中信97購02,0,0,0,0,0,0,0,0,0,12000,0,0,0,12000,0,12000,12000
055460,華擎永豐97購01  ,0,0,0,0,0,0,0,0,0,12000,0,0,0,12000,0,12000,12000
056396,祥碩永豐98購01  ,0,0,0,0,0,0,0,0,0,12000,0,0,0,12000,0,12000,12000
052573,智伸科凱基97購01,0,0,0,0,0,0,0,0,0,12000,0,0,0,12000,0,12000,12000
054154,智易國泰97購01  ,0,0,0,0,0,0,0,0,0,12000,0,0,0,12000,0,12000,12000
053628,微星兆豐96購01  ,0,0,0,0,0,0,0,0,0,12000,0,0,0,12000,0,12000,12000
053455,台光電元富96購02,0,0,0,0,0,0,0,0,0,12000,0,0,0,12000,0,12000,12000
059172,台郡凱基99購03  ,0,0,0,0,0,0,0,0,0,12000,0,0,0,22000,10000,12000,12000
054756,世紀鋼凱基99購01,0,0,0,0,0,0,0,0,0,12000,0,0,0,42000,30000,12000,12000
058526,鈺齊元大99購02  ,0,0,0,0,0,0,0,0,0,12000,0,0,0,88000,76000,12000,12000
058634,可成兆豐99購03  ,0,0,0,0,0,0,0,0,0,12000,0,0,0,12000,0,12000,12000
058741,欣興日盛99購01  ,0,0,0,0,0,0,0,0,0,12000,0,0,0,12000,0,12000,12000
060127,牧德永豐99購02  ,0,0,0,0,0,0,0,0,0,12000,0,0,0,32000,20000,12000,12000
058268,泰碩永豐9A購01  ,0,0,0,0,0,0,0,0,0,12000,0,0,0,32000,20000,12000,12000
059612,奇鋐永豐99購02  ,0,0,0,0,0,0,0,0,0,12000,0,0,0,37000,25000,12000,12000
059236,鴻海凱基99購09  ,0,0,0,0,0,0,0,0,0,12000,0,0,0,13000,1000,12000,12000
058069,美律凱基99購05  ,0,0,0,0,0,0,0,0,0,12000,0,0,0,12000,0,12000,12000
059635,華新科凱基9A購06,0,0,0,0,0,0,0,0,0,12000,0,0,0,22000,10000,12000,12000
059624,鴻海凱基01購01  ,0,0,0,0,0,0,0,0,0,12000,0,0,0,12000,0,12000,12000
059890,大立光國票99購03,0,0,0,0,0,0,0,0,0,12000,0,0,0,12000,0,12000,12000
057638,上銀元大99購01  ,0,0,0,0,0,0,0,0,0,12000,0,0,0,51000,39000,12000,12000
061946,鴻海群益9B購03  ,0,0,0,0,0,0,0,0,0,12000,0,0,0,21000,9000,12000,12000
061728,華新科麥證9A購02,0,0,0,13000,1000,12000,0,0,0,12000,0,0,0,13000,1000,12000,12000
061765,義隆元大9B購01  ,0,0,0,0,0,0,0,0,0,12000,0,0,0,12000,0,12000,12000
061479,泰碩元大9A購02  ,0,0,0,0,0,0,0,0,0,12000,0,0,0,180000,168000,12000,12000
060621,玉晶光元大9A購05,0,0,0,0,0,0,0,0,0,12000,0,0,0,74000,62000,12000,12000
060617,華新科元大9A購08,0,0,0,0,0,0,0,0,0,12000,0,0,0,22000,10000,12000,12000
061963,台積電統一01購04,0,0,0,0,0,0,0,0,0,12000,0,0,0,56000,44000,12000,12000
062181,義隆元大9B購03  ,0,0,0,0,0,0,0,0,0,12000,0,0,0,30000,18000,12000,12000
062562,瑞儀凱基9B購02  ,0,0,0,0,0,0,0,0,0,12000,0,0,0,91000,79000,12000,12000
062378,台表科元大9C購01,0,0,0,0,0,0,0,0,0,12000,0,0,0,75000,63000,12000,12000
3701,大眾控          ,12000,0,12000,0,0,0,0,0,0,0,0,0,0,0,0,0,12000
1541,錩泰            ,24000,16000,8000,0,0,0,0,0,0,3000,3000,0,3000,0,0,0,11000
2904,匯僑            ,10000,0,10000,0,0,0,0,0,0,1000,1000,0,1000,0,0,0,11000
07630P,臺股指凱基9A售11,0,0,0,0,0,0,0,0,0,11000,0,0,0,444000,433000,11000,11000
07503P,禾伸堂元大9A售01,0,0,0,0,0,0,0,0,0,11000,0,0,0,150000,139000,11000,11000
06890P,金融類元大98售02,0,0,0,0,0,0,0,0,0,11000,0,0,0,11000,0,11000,11000
07121P,華新科凱基99售03,0,0,0,0,0,0,0,0,0,11000,0,0,0,147000,136000,11000,11000
055311,健策群益98購02  ,0,0,0,0,0,0,0,0,0,11000,0,0,0,12000,1000,11000,11000
055791,臺股指凱基97購14,0,0,0,0,0,0,0,0,0,11000,0,0,0,11000,0,11000,11000
055738,玉山金元富97購01,0,0,0,0,0,0,0,0,0,11000,0,0,0,11000,0,11000,11000
059190,欣興富邦9A購01  ,0,0,0,0,0,0,0,0,0,11000,0,0,0,12000,1000,11000,11000
056281,深中小永豐97購01,0,0,0,0,0,0,0,0,0,11000,0,0,0,32000,21000,11000,11000
056213,建準國票98購02  ,0,0,0,0,0,0,0,0,0,11000,0,0,0,11000,0,11000,11000
055983,全新元富9A購02  ,0,0,0,0,0,0,0,0,0,11000,0,0,0,11000,0,11000,11000
052895,台積電群益96購04,0,0,0,0,0,0,0,0,0,11000,0,0,0,11000,0,11000,11000
056408,奇鋐國票99購01  ,0,0,0,0,0,0,0,0,0,11000,0,0,0,20000,9000,11000,11000
053074,嘉晶永豐96購02  ,0,0,0,0,0,0,0,0,0,11000,0,0,0,11000,0,11000,11000
051422,超眾國票96購01  ,0,0,0,0,0,0,0,0,0,11000,0,0,0,11000,0,11000,11000
05145P,道瓊反元大98售01,0,0,0,0,0,0,0,0,0,11000,0,0,0,11000,0,11000,11000
046476,鴻海統一96購01  ,0,0,0,0,0,0,0,0,0,11000,0,0,0,11000,0,11000,11000
02001L,富邦蘋果正二N   ,0,0,0,0,0,0,0,0,0,11000,0,0,0,11000,0,11000,11000
057054,立積元大98購03  ,0,0,0,0,0,0,0,0,0,11000,0,0,0,172000,161000,11000,11000
058910,泰鼎元大99購03  ,0,0,0,0,0,0,0,0,0,11000,0,0,0,11000,0,11000,11000
058026,上銀富邦9A購01  ,0,0,0,0,0,0,0,0,0,11000,0,0,0,72000,61000,11000,11000
059455,玉晶光永豐99購05,0,0,0,0,0,0,0,0,0,11000,0,0,0,11000,0,11000,11000
057152,緯穎國票99購03  ,0,0,0,0,0,0,0,0,0,11000,0,0,0,11000,0,11000,11000
057446,旺宏元富02購01  ,0,0,0,0,0,0,0,0,0,11000,0,0,0,11000,0,11000,11000
060961,台光電凱基9A購03,0,0,0,0,0,0,0,0,0,11000,0,0,0,11000,0,11000,11000
058358,技嘉凱基9A購01  ,0,0,0,0,0,0,0,0,0,11000,0,0,0,21000,10000,11000,11000
060182,旺宏元富9A購01  ,0,0,0,0,0,0,0,0,0,11000,0,0,0,11000,0,11000,11000
060267,上緯控國票9C購01,0,0,0,0,0,0,0,0,0,11000,0,0,0,11000,0,11000,11000
058429,欣興元富99購01  ,0,0,0,0,0,0,0,0,0,11000,0,0,0,11000,0,11000,11000
057722,臺股指元富98購01,0,0,0,0,0,0,0,0,0,11000,1000,0,1000,10000,0,10000,11000
057649,嘉聯益元大99購04,0,0,0,0,0,0,0,0,0,11000,0,0,0,220000,209000,11000,11000
062098,億光永豐9B購01  ,0,0,0,0,0,0,0,0,0,11000,0,0,0,90000,79000,11000,11000
062670,瑞昱中信03購01  ,0,0,0,0,0,0,0,0,0,11000,0,0,0,31000,20000,11000,11000
062786,立積元大9C購03  ,0,0,0,0,0,0,0,0,0,11000,0,0,0,230000,219000,11000,11000
062925,建準國票9B購01  ,0,0,0,0,0,0,0,0,0,11000,0,0,0,11000,0,11000,11000
062897,上銀元大9B購06  ,0,0,0,0,0,0,0,0,0,11000,0,0,0,11000,0,11000,11000
063104,大立光群益9C購02,0,0,0,0,0,0,0,0,0,11000,0,0,0,84000,73000,11000,11000
063189,臻鼎凱基9B購01  ,0,0,0,0,0,0,0,0,0,11000,0,0,0,40000,29000,11000,11000
063215,台表科國票9C購02,0,0,0,0,0,0,0,0,0,11000,0,0,0,19000,8000,11000,11000
063068,聯發科國泰01購03,0,0,0,0,0,0,0,0,0,11000,0,0,0,11000,0,11000,11000
060676,京元電元大9A購03,0,0,0,0,0,0,0,0,0,11000,0,0,0,161000,150000,11000,11000
061033,台光電永豐9A購01,0,0,0,0,0,0,0,0,0,11000,0,0,0,23000,12000,11000,11000
061502,嘉澤國票9A購02  ,0,0,0,0,0,0,0,0,0,11000,0,0,0,11000,0,11000,11000
061319,聯發科凱基9A購16,0,0,0,0,0,0,0,0,0,11000,0,0,0,11000,0,11000,11000
3518,柏騰            ,115000,104000,11000,0,0,0,0,0,0,0,0,0,0,0,0,0,11000
3055,蔚華科          ,10000,0,10000,0,0,0,0,0,0,1000,1000,0,1000,0,0,0,11000
4764,雙鍵            ,11000,1000,10000,0,0,0,0,0,0,1000,1000,0,1000,0,0,0,11000
4552,力達-KY         ,27000,16000,11000,0,0,0,0,0,0,0,0,0,0,0,0,0,11000
6581,鋼聯            ,11000,0,11000,0,0,0,0,0,0,0,0,0,0,0,0,0,11000
6226,光鼎            ,41000,31000,10000,0,0,0,0,0,0,1000,1000,0,1000,0,0,0,11000
07105P,大毅元富99售02  ,0,0,0,0,0,0,0,0,0,10000,0,0,0,10000,0,10000,10000
07148P,富邦金元大99售01,0,0,0,0,0,0,0,0,0,10000,0,0,0,60000,50000,10000,10000
07084P,S&P正2元富9B售02,0,0,0,0,0,0,0,0,0,10000,0,0,0,10000,0,10000,10000
07197P,臺股指元大99售13,0,0,0,0,0,0,0,0,0,10000,0,0,0,46000,36000,10000,10000
07230P,滬深2X群益01售02,0,0,0,0,0,0,0,0,0,10000,0,0,0,10000,0,10000,10000
07287P,全新群益9B售01  ,0,0,0,0,0,0,0,0,0,10000,0,0,0,10000,0,10000,10000
07288P,台灣50凱基99售06,0,0,0,0,0,0,0,0,0,10000,0,0,0,10000,0,10000,10000
07260P,台灣50元大9A售01,0,0,0,0,0,0,0,0,0,10000,0,0,0,10000,0,10000,10000
06857P,超眾永豐98售02  ,0,0,0,0,0,0,0,0,0,10000,0,0,0,60000,50000,10000,10000
06869P,金融類元大99售01,0,0,0,0,0,0,0,0,0,10000,0,0,0,10000,0,10000,10000
06923P,鴻海群益98售09  ,0,0,0,0,0,0,0,0,0,10000,0,0,0,10000,0,10000,10000
06997P,台灣50中信03售01,0,0,0,0,0,0,0,0,0,10000,0,0,0,10000,0,10000,10000
06994P,台光電凱基99售02,0,0,0,0,0,0,0,0,0,10000,0,0,0,10000,0,10000,10000
06707P,臺股指台新99售04,0,0,0,0,0,0,0,0,0,10000,0,0,0,10000,0,10000,10000
063237,微星元大9B購02  ,0,0,0,0,0,0,0,0,0,10000,0,0,0,134000,124000,10000,10000
063264,健策永豐9B購07  ,0,0,0,0,0,0,0,0,0,10000,0,0,0,10000,0,10000,10000
06330P,南亞科群益97售03,0,0,0,0,0,0,0,0,0,10000,0,0,0,10000,0,10000,10000
063452,創意統一01購01  ,0,0,0,0,0,0,0,0,0,10000,0,0,0,20000,10000,10000,10000
063498,金像電永豐9B購02,0,0,0,0,0,0,0,0,0,10000,0,0,0,10000,0,10000,10000
063627,上銀元大9B購09  ,0,0,0,0,0,0,0,0,0,10000,0,0,0,15000,5000,10000,10000
063726,鴻海元大9B購04  ,0,0,0,0,0,0,0,0,0,10000,0,0,0,55000,45000,10000,10000
07309P,聯發科凱基99售18,0,0,0,0,0,0,0,0,0,10000,0,0,0,10000,0,10000,10000
07401P,台積電凱基99售21,0,0,0,0,0,0,0,0,0,10000,0,0,0,10000,0,10000,10000
07373P,A50正2元大99售01,0,0,0,0,0,0,0,0,0,10000,0,0,0,60000,50000,10000,10000
07610P,大立光國票9A售04,0,0,0,0,0,0,0,0,0,10000,0,0,0,20000,10000,10000,10000
07585P,台灣50中信03售06,0,0,0,0,0,0,0,0,0,10000,0,0,0,10000,0,10000,10000
07734P,台積電富邦9C售10,0,0,0,0,0,0,0,0,0,10000,0,0,0,10000,0,10000,10000
07744P,奇力新凱基9A售05,0,0,0,0,0,0,0,0,0,10000,0,0,0,10000,0,10000,10000
08105P,景碩元大9B售01  ,0,0,0,0,0,0,0,0,0,10000,0,0,0,30000,20000,10000,10000
07853P,國巨凱基9A售19  ,0,0,0,0,0,0,0,0,0,10000,0,0,0,10000,0,10000,10000
07809P,國巨中信9A售06  ,0,0,0,0,0,0,0,0,0,10000,0,0,0,10000,0,10000,10000
07811P,華新科統一9A售02,0,0,0,0,0,0,0,0,0,10000,0,0,0,10000,0,10000,10000
07801P,上銀永豐9A售02  ,0,0,0,0,0,0,0,0,0,10000,0,0,0,10000,0,10000,10000
07946P,華通統一9B售02  ,0,0,0,0,0,0,0,0,0,10000,0,0,0,10000,0,10000,10000
2881A,富邦特          ,10000,0,10000,0,0,0,0,0,0,0,0,0,0,0,0,0,10000
2462,良得電          ,9000,0,9000,0,0,0,0,0,0,1000,1000,0,1000,0,0,0,10000
2358,廷鑫            ,10000,0,10000,0,0,0,0,0,0,0,1000,1000,0,0,0,0,10000
1454,台富            ,15000,5000,10000,0,0,0,0,0,0,0,0,0,0,0,0,0,10000
1452,宏益            ,9000,0,9000,0,0,0,0,0,0,1000,1000,0,1000,0,0,0,10000
1109,信大            ,15000,5000,10000,0,0,0,0,0,0,0,0,0,0,0,0,0,10000
1219,福壽            ,10000,0,10000,0,0,0,0,0,0,0,0,0,0,0,0,0,10000
050493,聯發科永昌96購01,0,0,0,0,0,0,0,0,0,10000,0,0,0,10000,0,10000,10000
046881,智原富邦99購01  ,0,0,0,0,0,0,0,0,0,10000,0,0,0,10000,0,10000,10000
051657,台郡元富98購01  ,0,0,0,0,0,0,0,0,0,10000,0,0,0,10000,0,10000,10000
051575,國巨元大96購03  ,0,0,0,0,0,0,0,0,0,10000,0,0,0,10000,0,10000,10000
051488,健策凱基96購04  ,0,0,0,0,0,0,0,0,0,10000,0,0,0,10000,0,10000,10000
051483,玉晶光凱基96購02,0,0,0,0,0,0,0,0,0,10000,0,0,0,10000,0,10000,10000
051257,光寶科國泰96購01,0,0,0,0,0,0,0,0,0,10000,0,0,0,10000,0,10000,10000
053774,台達電元大96購04,0,0,0,0,0,0,0,0,0,10000,0,0,0,10000,0,10000,10000
049795,華通元大96購02  ,0,0,0,0,0,0,0,0,0,10000,0,0,0,10000,0,10000,10000
049842,道瓊反中信98購01,0,0,0,0,0,0,0,0,0,10000,0,0,0,10000,0,10000,10000
049130,臺指反元大98購01,0,0,0,0,0,0,0,0,0,10000,0,0,0,10000,0,10000,10000
04935P,鴻海中信96售01  ,0,0,0,0,0,0,0,0,0,10000,0,0,0,10000,0,10000,10000
047548,友達凱基99購03  ,0,0,0,0,0,0,0,0,0,10000,0,0,0,10000,0,10000,10000
048334,A50正2元大96購01,0,0,0,0,0,0,0,0,0,10000,0,0,0,10000,0,10000,10000
048379,台郡元富96購01  ,0,0,0,0,0,0,0,0,0,10000,0,0,0,10000,0,10000,10000
054043,漢唐元大97購01  ,0,0,0,0,0,0,0,0,0,10000,0,0,0,60000,50000,10000,10000
053999,台表科群益96購06,0,0,0,0,0,0,0,0,0,10000,0,0,0,10000,0,10000,10000
054085,華新科統一96購04,0,0,0,0,0,0,0,0,0,10000,0,0,0,3098000,3088000,10000,10000
051701,華通群益97購01  ,0,0,0,0,0,0,0,0,0,10000,0,0,0,10000,0,10000,10000
051721,玉晶光永豐96購02,0,0,0,0,0,0,0,0,0,10000,0,0,0,17000,7000,10000,10000
053971,聯發科元大97購09,0,0,0,0,0,0,0,0,0,10000,0,0,0,10000,0,10000,10000
05212P,台積電國票96售04,0,0,0,0,0,0,0,0,0,10000,0,0,0,10000,0,10000,10000
052135,聯發科凱基9B購01,0,0,0,0,0,0,0,0,0,10000,0,0,0,10000,0,10000,10000
052104,英業達兆豐96購01,0,0,0,0,0,0,0,0,0,10000,0,0,0,10000,0,10000,10000
052220,T50反1凱基98購01,0,0,0,0,0,0,0,0,0,10000,0,0,0,10000,0,10000,10000
051910,大立光元大97購01,0,0,0,0,0,0,0,0,0,10000,0,0,0,10000,0,10000,10000
051930,國泰金兆豐97購01,0,0,0,0,0,0,0,0,0,10000,0,0,0,10000,0,10000,10000
053680,臺股指富邦96購01,0,0,0,0,0,0,0,0,0,10000,0,0,0,10000,0,10000,10000
053654,聯發科凱基98購01,0,0,0,0,0,0,0,0,0,10000,0,0,0,10000,0,10000,10000
05362P,可成富邦97售02  ,0,0,0,0,0,0,0,0,0,10000,0,0,0,10000,0,10000,10000
052992,冠德台新96購01  ,0,0,0,0,0,0,0,0,0,10000,0,0,0,10000,0,10000,10000
053721,國泰金凱基97購01,0,0,0,0,0,0,0,0,0,10000,0,0,0,10000,0,10000,10000
053005,微星永豐96購01  ,0,0,0,0,0,0,0,0,0,10000,0,0,0,10000,0,10000,10000
055426,旺宏群益99購02  ,0,0,0,0,0,0,0,0,0,10000,0,0,0,10000,0,10000,10000
056327,樺漢兆豐98購01  ,0,0,0,0,0,0,0,0,0,10000,0,0,0,10000,0,10000,10000
056414,國巨中信98購02  ,0,0,0,0,0,0,0,0,0,10000,0,0,0,10000,0,10000,10000
055566,台表科凱基97購03,0,0,0,0,0,0,0,0,0,10000,0,0,0,10000,0,10000,10000
055500,京鼎元大97購04  ,0,0,0,0,0,0,0,0,0,10000,0,0,0,10000,0,10000,10000
055481,聚陽元大97購01  ,0,0,0,0,0,0,0,0,0,10000,0,0,0,10000,0,10000,10000
055510,GIS元大97購03   ,0,0,0,0,0,0,0,0,0,10000,0,0,0,40000,30000,10000,10000
055444,致新台新97購01  ,0,0,0,0,0,0,0,0,0,10000,0,0,0,10000,0,10000,10000
054241,深中小元大98購01,0,0,0,0,0,0,0,0,0,10000,0,0,0,10000,0,10000,10000
056382,道瓊反國泰9A購01,0,0,0,0,0,0,0,0,0,10000,0,0,0,120000,110000,10000,10000
056339,聯發科凱基99購02,0,0,0,0,0,0,0,0,0,10000,0,0,0,10000,0,10000,10000
052884,台積電兆豐96購01,0,0,0,0,0,0,0,0,0,10000,0,0,0,10000,0,10000,10000
052856,滬深2X凱基98購01,0,0,0,0,0,0,0,0,0,10000,0,0,0,43000,33000,10000,10000
052908,大成鋼統一96購01,0,0,0,0,0,0,0,0,0,10000,0,0,0,10000,0,10000,10000
052952,矽創國票97購02  ,0,0,0,0,0,0,0,0,0,10000,0,0,0,10000,0,10000,10000
052437,聯發科富邦99購02,0,0,0,0,0,0,0,0,0,10000,0,0,0,10000,0,10000,10000
052476,台光電群益98購01,0,0,0,0,0,0,0,0,0,10000,0,0,0,10000,0,10000,10000
052322,力成元大96購01  ,0,0,0,0,0,0,0,0,0,10000,0,0,0,10000,0,10000,10000
052316,台積電元大96購10,0,0,0,0,0,0,0,0,0,10000,0,0,0,10000,0,10000,10000
052764,景碩群益98購01  ,0,0,0,0,0,0,0,0,0,10000,0,0,0,10000,0,10000,10000
054223,大立光統一98購04,0,0,0,0,0,0,0,0,0,10000,0,0,0,10000,0,10000,10000
053407,台積電兆豐96購02,0,0,0,0,0,0,0,0,0,10000,0,0,0,770000,760000,10000,10000
053387,緯創元大97購01  ,0,0,0,0,0,0,0,0,0,10000,0,0,0,10000,0,10000,10000
053548,旺宏凱基96購04  ,0,0,0,0,0,0,0,0,0,10000,0,0,0,10000,0,10000,10000
053550,聯發科凱基96購15,0,0,0,0,0,0,0,0,0,10000,0,0,0,10000,0,10000,10000
053530,聯發科康和96購01,0,0,0,0,0,0,0,0,0,10000,0,0,0,10000,0,10000,10000
053247,麗豐國票97購01  ,0,0,0,0,0,0,0,0,0,10000,0,0,0,10000,0,10000,10000
055920,智伸科凱基97購02,0,0,0,0,0,0,0,0,0,10000,0,0,0,10000,0,10000,10000
055904,貿聯亞東99購01  ,0,0,0,0,0,0,0,0,0,10000,0,0,0,10000,0,10000,10000
056614,智邦永豐98購01  ,0,0,0,0,0,0,0,0,0,10000,0,0,0,10000,0,10000,10000
056606,華新科富邦9A購02,0,0,0,0,0,0,0,0,0,10000,0,0,0,11000,1000,10000,10000
056591,S&P正2元富9A購01,0,0,0,0,0,0,0,0,0,10000,0,0,0,10000,0,10000,10000
056592,台積電元富98購01,0,0,0,0,0,0,0,0,0,10000,0,0,0,580000,570000,10000,10000
056193,聯發科富邦99購08,0,0,0,0,0,0,0,0,0,10000,0,0,0,10000,0,10000,10000
05625P,國巨國票97售01  ,0,0,0,0,0,0,0,0,0,10000,0,0,0,10000,0,10000,10000
056129,義隆麥證97購01  ,0,0,0,10000,0,10000,0,0,0,10000,0,0,0,10000,0,10000,10000
056280,上証2X永豐98購01,0,0,0,0,0,0,0,0,0,10000,0,0,0,10000,0,10000,10000
055798,聯茂富邦98購01  ,0,0,0,0,0,0,0,0,0,10000,0,0,0,10000,0,10000,10000
055828,上銀元大97購05  ,0,0,0,0,0,0,0,0,0,10000,0,0,0,10000,0,10000,10000
055837,致茂元大97購02  ,0,0,0,0,0,0,0,0,0,10000,0,0,0,10000,0,10000,10000
055841,南亞科元大97購04,0,0,0,0,0,0,0,0,0,10000,0,0,0,10000,0,10000,10000
055822,臺股指國票97購09,0,0,0,0,0,0,0,0,0,10000,0,0,0,10000,0,10000,10000
05920P,力成元大96售04  ,0,0,0,0,0,0,0,0,0,10000,0,0,0,10000,0,10000,10000
059177,臺股指凱基99購28,0,0,0,0,0,0,0,0,0,10000,0,0,0,10000,0,10000,10000
059199,欣興永豐99購02  ,0,0,0,0,0,0,0,0,0,10000,0,0,0,10000,0,10000,10000
059129,麗豐中信99購01  ,0,0,0,0,0,0,0,0,0,10000,0,0,0,35000,25000,10000,10000
059048,元油2X凱基9A購11,0,0,0,0,0,0,0,0,0,10000,0,0,0,10000,0,10000,10000
059039,致伸群益99購01  ,0,0,0,0,0,0,0,0,0,10000,0,0,0,70000,60000,10000,10000
059311,元石油元大99購04,0,0,0,0,0,0,0,0,0,10000,0,0,0,10000,0,10000,10000
055881,康控元富97購01  ,0,0,0,0,0,0,0,0,0,10000,0,0,0,10000,0,10000,10000
059327,南茂元大99購01  ,0,0,0,0,0,0,0,0,0,10000,0,0,0,18000,8000,10000,10000
059334,A50正2國票9A購02,0,0,0,0,0,0,0,0,0,10000,0,0,0,10000,0,10000,10000
059036,可成群益9B購03  ,0,0,0,0,0,0,0,0,0,10000,0,0,0,20000,10000,10000,10000
059493,國巨國票9B購01  ,0,0,0,0,0,0,0,0,0,10000,0,0,0,10000,0,10000,10000
055717,聯發科元大97購19,0,0,0,0,0,0,0,0,0,10000,0,0,0,10000,0,10000,10000
055728,緯穎元大97購03  ,0,0,0,0,0,0,0,0,0,10000,0,0,0,10000,0,10000,10000
056572,義隆元大99購01  ,0,0,0,0,0,0,0,0,0,10000,0,0,0,10000,0,10000,10000
055742,健策元富97購02  ,0,0,0,0,0,0,0,0,0,10000,0,0,0,10000,0,10000,10000
055285,華新科元大99購03,0,0,0,0,0,0,0,0,0,10000,0,0,0,10000,0,10000,10000
054725,國巨日盛97購01  ,0,0,0,0,0,0,0,0,0,10000,0,0,0,50000,40000,10000,10000
054674,台光電台新97購01,0,0,0,0,0,0,0,0,0,10000,0,0,0,10000,0,10000,10000
054680,華新科康和97購02,0,0,0,0,0,0,0,0,0,10000,0,0,0,60000,50000,10000,10000
054687,建準永豐97購02  ,0,0,0,0,0,0,0,0,0,10000,0,0,0,10000,0,10000,10000
054913,億光凱基97購01  ,0,0,0,0,0,0,0,0,0,10000,0,0,0,10000,0,10000,10000
054951,大毅元大97購01  ,0,0,0,0,0,0,0,0,0,10000,0,0,0,10000,0,10000,10000
054980,國巨元富97購01  ,0,0,0,0,0,0,0,0,0,10000,0,0,0,43000,33000,10000,10000
054981,國巨元富97購02  ,0,0,0,0,0,0,0,0,0,10000,0,0,0,10000,0,10000,10000
054999,玉晶光元富97購03,0,0,0,0,0,0,0,0,0,10000,0,0,0,10000,0,10000,10000
055142,健策永豐98購01  ,0,0,0,0,0,0,0,0,0,10000,0,0,0,14000,4000,10000,10000
055143,臻鼎永豐97購01  ,0,0,0,0,0,0,0,0,0,10000,0,0,0,10000,0,10000,10000
055161,貿聯元大98購03  ,0,0,0,0,0,0,0,0,0,10000,0,0,0,10000,0,10000,10000
055215,智邦凱基98購02  ,0,0,0,0,0,0,0,0,0,10000,0,0,0,10000,0,10000,10000
055209,勤誠康和97購01  ,0,0,0,0,0,0,0,0,0,10000,0,0,0,10000,0,10000,10000
055254,聯詠統一97購03  ,0,0,0,0,0,0,0,0,0,10000,0,0,0,10000,0,10000,10000
055626,力山永豐97購01  ,0,0,0,0,0,0,0,0,0,10000,0,0,0,30000,20000,10000,10000
055658,南電元富97購01  ,0,0,0,0,0,0,0,0,0,10000,0,0,0,20000,10000,10000,10000
054846,瑞昱兆豐97購01  ,0,0,0,0,0,0,0,0,0,10000,0,0,0,10000,0,10000,10000
054893,帆宣統一99購01  ,0,0,0,0,0,0,0,0,0,10000,0,0,0,20000,10000,10000,10000
056534,京元電凱基98購01,0,0,0,0,0,0,0,0,0,10000,0,0,0,52000,42000,10000,10000
054304,台積電凱基96購23,0,0,0,0,0,0,0,0,0,10000,0,0,0,10000,0,10000,10000
056453,禾伸堂凱基99購02,0,0,0,0,0,0,0,0,0,10000,0,0,0,10000,0,10000,10000
054400,健策永豐96購02  ,0,0,0,0,0,0,0,0,0,10000,0,0,0,10000,0,10000,10000
054447,國泰金兆豐96購01,0,0,0,0,0,0,0,0,0,10000,0,0,0,10000,0,10000,10000
054513,元金2X元大96購01,0,0,0,0,0,0,0,0,0,10000,0,0,0,10000,0,10000,10000
057677,臺股指元大98購07,0,0,0,0,0,0,0,0,0,10000,0,0,0,10000,0,10000,10000
057647,欣興元大98購10  ,0,0,0,0,0,0,0,0,0,10000,0,0,0,63000,53000,10000,10000
057682,台積電日盛9A購03,0,0,0,0,0,0,0,0,0,10000,0,0,0,550000,540000,10000,10000
057744,健策永豐98購02  ,0,0,0,0,0,0,0,0,0,10000,0,0,0,10000,0,10000,10000
057796,鴻海兆豐99購03  ,0,0,0,0,0,0,0,0,0,10000,0,0,0,10000,0,10000,10000
057803,上銀元大98購08  ,0,0,0,0,0,0,0,0,0,10000,0,0,0,10000,0,10000,10000
057845,晶相光永豐98購03,0,0,0,0,0,0,0,0,0,10000,0,0,0,10000,0,10000,10000
05752P,台積電中信96售06,0,0,0,0,0,0,0,0,0,10000,0,0,0,10000,0,10000,10000
057879,電子類元大99購02,0,0,0,0,0,0,0,0,0,10000,0,0,0,10000,0,10000,10000
057896,嘉晶元富98購01  ,0,0,0,0,0,0,0,0,0,10000,0,0,0,10000,0,10000,10000
058218,緯穎群益99購01  ,0,0,0,0,0,0,0,0,0,10000,0,0,0,10000,0,10000,10000
058462,台積電兆豐99購01,0,0,0,0,0,0,0,0,0,10000,0,0,0,150000,140000,10000,10000
058193,緯穎永豐99購01  ,0,0,0,0,0,0,0,0,0,10000,0,0,0,10000,0,10000,10000
058402,欣興元大99購04  ,0,0,0,0,0,0,0,0,0,10000,0,0,0,35000,25000,10000,10000
058746,華通凱基9A購02  ,0,0,0,0,0,0,0,0,0,10000,0,0,0,10000,0,10000,10000
059611,台積電永豐99購05,0,0,0,0,0,0,0,0,0,10000,0,0,0,30000,20000,10000,10000
05869P,旺宏凱基96售05  ,0,0,0,0,0,0,0,0,0,10000,0,0,0,10000,0,10000,10000
058665,台灣50群益9B購02,0,0,0,0,0,0,0,0,0,10000,0,0,0,81000,71000,10000,10000
058590,南電中信9A購02  ,0,0,0,0,0,0,0,0,0,10000,0,0,0,30000,20000,10000,10000
058593,大立光統一9B購02,0,0,0,0,0,0,0,0,0,10000,0,0,0,11000,1000,10000,10000
060139,T50反1國票9A購04,0,0,0,0,0,0,0,0,0,10000,0,0,0,10000,0,10000,10000
060129,祥碩永豐99購03  ,0,0,0,0,0,0,0,0,0,10000,0,0,0,16000,6000,10000,10000
060328,可成群益9A購06  ,0,0,0,0,0,0,0,0,0,10000,0,0,0,14000,4000,10000,10000
060340,國巨統一01購02  ,0,0,0,0,0,0,0,0,0,10000,0,0,0,10000,0,10000,10000
060397,群創國票9A購01  ,0,0,0,0,0,0,0,0,0,10000,0,0,0,10000,0,10000,10000
060941,台積電國票9B購04,0,0,0,0,0,0,0,0,0,10000,0,0,0,20000,10000,10000,10000
060925,華新科永豐9A購01,0,0,0,0,0,0,0,0,0,10000,0,0,0,10000,0,10000,10000
060928,明泰永豐9A購01  ,0,0,0,0,0,0,0,0,0,10000,0,0,0,10000,0,10000,10000
058356,華邦電凱基99購01,0,0,0,0,0,0,0,0,0,10000,0,0,0,10000,0,10000,10000
060072,國巨元富99購04  ,0,0,0,0,0,0,0,0,0,10000,0,0,0,45000,35000,10000,10000
058235,大立光元大99購08,0,0,0,0,0,0,0,0,0,10000,0,0,0,12000,2000,10000,10000
057471,昇陽半永豐98購02,0,0,0,0,0,0,0,0,0,10000,0,0,0,10000,0,10000,10000
057479,致茂元大98購03  ,0,0,0,0,0,0,0,0,0,10000,0,0,0,78000,68000,10000,10000
059249,大立光凱基99購05,0,0,0,0,0,0,0,0,0,10000,0,0,0,10000,0,10000,10000
058968,T50正2永豐99購01,0,0,0,0,0,0,0,0,0,10000,0,0,0,20000,10000,10000,10000
058838,國巨中信99購03  ,0,0,0,0,0,0,0,0,0,10000,0,0,0,191000,181000,10000,10000
059416,T50反1元大99購08,0,0,0,0,0,0,0,0,0,10000,0,0,0,10000,0,10000,10000
057236,聯詠凱基98購03  ,0,0,0,0,0,0,0,0,0,10000,0,0,0,30000,20000,10000,10000
057260,微星兆豐98購01  ,0,0,0,0,0,0,0,0,0,10000,0,0,0,35000,25000,10000,10000
058029,台灣50永豐9A購01,0,0,0,0,0,0,0,0,0,10000,0,0,0,10000,0,10000,10000
058014,上銀凱基99購02  ,0,0,0,0,0,0,0,0,0,10000,0,0,0,10000,0,10000,10000
058016,智邦凱基98購06  ,0,0,0,0,0,0,0,0,0,10000,0,0,0,20000,10000,10000,10000
058877,T50反1國泰9B購01,0,0,0,0,0,0,0,0,0,10000,0,0,0,200000,190000,10000,10000
05884P,旺宏統一96售01  ,0,0,0,0,0,0,0,0,0,10000,0,0,0,10000,0,10000,10000
059714,A50正2元大9C購01,0,0,0,0,0,0,0,0,0,10000,0,0,0,10000,0,10000,10000
059721,旺宏元大99購16  ,0,0,0,0,0,0,0,0,0,10000,0,0,0,10000,0,10000,10000
056951,牧德統一99購01  ,0,0,0,0,0,0,0,0,0,10000,0,0,0,10000,0,10000,10000
056964,聯發科永豐98購03,0,0,0,0,0,0,0,0,0,10000,0,0,0,10000,0,10000,10000
057106,美律群益98購03  ,0,0,0,0,0,0,0,0,0,10000,0,0,0,10000,0,10000,10000
057636,上銀元大98購06  ,0,0,0,0,0,0,0,0,0,10000,0,0,0,65000,55000,10000,10000
058084,大立光群益98購04,0,0,0,0,0,0,0,0,0,10000,0,0,0,10000,0,10000,10000
059825,嘉晶凱基99購02  ,0,0,0,0,0,0,0,0,0,10000,0,0,0,10000,0,10000,10000
06131P,京鼎元富97售02  ,0,0,0,0,0,0,0,0,0,10000,0,0,0,10000,0,10000,10000
061333,華通元大9A購08  ,0,0,0,0,0,0,0,0,0,10000,0,0,0,29000,19000,10000,10000
061338,台積電元大9A購28,0,0,0,0,0,0,0,0,0,10000,0,0,0,10000,0,10000,10000
061257,上銀凱基9A購06  ,0,0,0,0,0,0,0,0,0,10000,0,0,0,10000,0,10000,10000
061286,大立光統一9A購05,0,0,0,0,0,0,0,0,0,10000,0,0,0,10000,0,10000,10000
061420,國巨元大9A購22  ,0,0,0,0,0,0,0,0,0,10000,0,0,0,20000,10000,10000,10000
061386,道瓊銀群益9A購03,0,0,0,0,0,0,0,0,0,10000,0,0,0,10000,0,10000,10000
061377,聯發科永豐9A購04,0,0,0,0,0,0,0,0,0,10000,0,0,0,42000,32000,10000,10000
061464,瑞昱群益9A購01  ,0,0,0,0,0,0,0,0,0,10000,0,0,0,10000,0,10000,10000
061472,台積電元大9A購32,0,0,0,0,0,0,0,0,0,10000,0,0,0,50000,40000,10000,10000
061558,旺宏國票9B購02  ,0,0,0,0,0,0,0,0,0,10000,0,0,0,21000,11000,10000,10000
061598,南電永豐9A購04  ,0,0,0,0,0,0,0,0,0,10000,0,0,0,10000,0,10000,10000
061715,牧德凱基9B購03  ,0,0,0,0,0,0,0,0,0,10000,0,0,0,10000,0,10000,10000
061887,祥碩國泰9C購01  ,0,0,0,0,0,0,0,0,0,10000,0,0,0,10000,0,10000,10000
061829,T50反1凱基9C購02,0,0,0,0,0,0,0,0,0,10000,0,0,0,10000,0,10000,10000
061041,南電永豐9A購03  ,0,0,0,0,0,0,0,0,0,10000,0,0,0,10000,0,10000,10000
061064,可成凱基9B購02  ,0,0,0,0,0,0,0,0,0,10000,0,0,0,10000,0,10000,10000
060901,臺股指凱基9A購13,0,0,0,0,0,0,0,0,0,10000,0,0,0,16000,6000,10000,10000
060888,金像電統一9C購01,0,3000,-3000,0,0,0,0,0,0,13000,0,0,0,63000,50000,13000,10000
061107,世芯元大9A購05  ,0,0,0,0,0,0,0,0,0,10000,0,0,0,10000,0,10000,10000
06110P,國巨國泰98售02  ,0,0,0,0,0,0,0,0,0,10000,0,0,0,41000,31000,10000,10000
061104,華新科元大9A購13,0,0,0,0,0,0,0,0,0,10000,0,0,0,10000,0,10000,10000
061100,SP黃豆元大9A購04,0,0,0,0,0,0,0,0,0,10000,0,0,0,10000,0,10000,10000
061135,聯發科統一9C購03,0,0,0,0,0,0,0,0,0,10000,0,0,0,10000,0,10000,10000
061229,緯穎中信9B購01  ,0,0,0,0,0,0,0,0,0,10000,0,0,0,20000,10000,10000,10000
060679,聯詠元大9A購04  ,0,0,0,0,0,0,0,0,0,10000,0,0,0,150000,140000,10000,10000
060738,矽格統一9C購01  ,0,0,0,0,0,0,0,0,0,10000,0,0,0,15000,5000,10000,10000
060751,高股息元大9B購01,0,0,0,0,0,0,0,0,0,10000,0,0,0,10000,0,10000,10000
060705,台光電富邦9B購01,0,0,0,0,0,0,0,0,0,10000,0,0,0,10000,0,10000,10000
060486,中租富邦9A購01  ,0,0,0,0,0,0,0,0,0,10000,0,0,0,10000,0,10000,10000
060538,S&P反1凱基9A購01,0,0,0,0,0,0,0,0,0,10000,0,0,0,10000,0,10000,10000
060529,聯發科中信9A購04,0,0,0,0,0,0,0,0,0,10000,0,0,0,25000,15000,10000,10000
063095,健策國票9B購02  ,0,0,0,0,0,0,0,0,0,10000,0,0,0,10000,0,10000,10000
063037,聯發科凱基9C購02,0,0,0,0,0,0,0,0,0,10000,0,0,0,10000,0,10000,10000
063184,台光電凱基9B購03,0,0,0,0,0,0,0,0,0,10000,0,0,0,10000,0,10000,10000
062597,世紀鋼統一01購01,0,0,0,0,0,0,0,0,0,10000,0,0,0,20000,10000,10000,10000
062753,台積電麥證9B購01,0,0,0,10000,0,10000,0,0,0,10000,0,0,0,10000,0,10000,10000
061993,祥碩元大9C購01  ,0,0,0,0,0,0,0,0,0,10000,0,0,0,10000,0,10000,10000
062170,健策永豐9B購04  ,0,0,0,0,0,0,0,0,0,10000,0,0,0,11000,1000,10000,10000
062122,國巨統一02購01  ,0,0,0,0,0,0,0,0,0,10000,0,0,0,10000,0,10000,10000
062128,祥碩統一01購01  ,0,0,0,0,0,0,0,0,0,10000,0,0,0,32000,22000,10000,10000
062270,上銀群益9B購03  ,0,0,0,0,0,0,0,0,0,10000,0,0,0,10000,0,10000,10000
062320,南電凱基9B購03  ,0,0,0,0,0,0,0,0,0,10000,0,0,0,10000,0,10000,10000
062339,瑞昱麥證9C購01  ,0,0,0,43000,13000,30000,0,0,0,10000,0,0,0,43000,33000,10000,10000
062556,瑞昱凱基9B購02  ,0,0,0,0,0,0,0,0,0,10000,0,0,0,10000,0,10000,10000
062513,玉晶光國票9C購01,0,0,0,0,0,0,0,0,0,10000,0,0,0,74000,64000,10000,10000
6698,旭暉應材        ,13000,3000,10000,0,0,0,0,0,0,0,0,0,0,0,0,0,10000
8215,明基材          ,927000,920000,7000,0,0,0,0,0,0,3000,3000,0,3000,0,0,0,10000
1233,天仁            ,8000,0,8000,0,0,0,0,0,0,1000,1000,0,1000,0,0,0,9000
2038,海光            ,11000,3000,8000,0,0,0,0,0,0,1000,1000,0,1000,0,0,0,9000
1726,永記            ,8000,1000,7000,0,0,0,0,0,0,2000,2000,0,2000,0,0,0,9000
2482,連宇            ,8000,1000,7000,0,0,0,0,0,0,2000,2000,0,2000,0,0,0,9000
2543,皇昌            ,9000,0,9000,0,0,0,0,0,0,0,0,0,0,0,0,0,9000
07879P,瑞昱群益9C售01  ,0,0,0,0,0,0,0,0,0,9000,0,0,0,22000,13000,9000,9000
08152P,祥碩統一9B售02  ,0,0,0,0,0,0,0,0,0,9000,0,0,0,15000,6000,9000,9000
063685,鴻海永豐9B購03  ,0,0,0,0,0,0,0,0,0,9000,0,0,0,11000,2000,9000,9000
06709P,臺股指台新99售06,0,0,0,0,0,0,0,0,0,9000,9000,0,9000,0,0,0,9000
06625P,華新科統一98售03,0,0,0,0,0,0,0,0,0,9000,0,0,0,9000,0,9000,9000
06630P,國巨群益98售08  ,0,0,0,0,0,0,0,0,0,9000,0,0,0,9000,0,9000,9000
06549P,大立光元大98售11,0,0,0,0,0,0,0,0,0,9000,0,0,0,9000,0,9000,9000
06560P,台積電統一98售07,0,0,0,0,0,0,0,0,0,9000,0,0,0,18000,9000,9000,9000
06578P,華新科國票98售02,0,0,0,0,0,0,0,0,0,9000,0,0,0,9000,0,9000,9000
06468P,華新科統一98售02,0,0,0,0,0,0,0,0,0,9000,0,0,0,9000,0,9000,9000
06437P,玉晶光國票99售01,0,0,0,0,0,0,0,0,0,9000,0,0,0,13000,4000,9000,9000
063868,嘉晶永豐9C購01  ,0,0,0,0,0,0,0,0,0,9000,0,0,0,30000,21000,9000,9000
07195P,大立光元大99售12,0,0,0,0,0,0,0,0,0,9000,0,0,0,9000,0,9000,9000
07196P,大立光元大99售13,0,0,0,0,0,0,0,0,0,9000,0,0,0,9000,0,9000,9000
07187P,臺股指台新99售10,0,0,0,0,0,0,0,0,0,9000,0,0,0,9000,0,9000,9000
056430,鴻海凱基98購06  ,0,0,0,0,0,0,0,0,0,9000,0,0,0,20000,11000,9000,9000
055127,台虹兆豐97購01  ,0,0,0,0,0,0,0,0,0,9000,0,0,0,9000,0,9000,9000
055290,玉晶光元大98購08,0,0,0,0,0,0,0,0,0,9000,0,0,0,9000,0,9000,9000
059501,可成元富99購01  ,0,0,0,0,0,0,0,0,0,9000,0,0,0,9000,0,9000,9000
059087,台積電元大99購26,0,0,0,0,0,0,0,0,0,9000,0,0,0,14000,5000,9000,9000
059169,可成凱基99購04  ,0,0,0,0,0,0,0,0,0,9000,0,0,0,10000,1000,9000,9000
056608,力山永豐98購01  ,0,0,0,0,0,0,0,0,0,9000,0,0,0,10000,1000,9000,9000
056641,華通凱基98購03  ,0,0,0,0,0,0,0,0,0,9000,0,0,0,26000,17000,9000,9000
055929,聯發科群益97購05,0,0,0,0,0,0,0,0,0,9000,0,0,0,15000,6000,9000,9000
055967,臻鼎元大97購01  ,0,0,0,0,0,0,0,0,0,9000,0,0,0,9000,0,9000,9000
052456,滬深2X元富9B購03,0,0,0,0,0,0,0,0,0,9000,0,0,0,9000,0,9000,9000
053648,台積電凱基97購04,0,0,0,0,0,0,0,0,0,9000,0,0,0,9000,0,9000,9000
052089,聯發科元大96購02,0,0,0,0,0,0,0,0,0,9000,0,0,0,9000,0,9000,9000
050099,台積電永昌96購01,0,0,0,0,0,0,0,0,0,9000,0,0,0,10000,1000,9000,9000
035277,景碩台新97購01  ,0,0,0,0,0,0,0,0,0,9000,0,0,0,19000,10000,9000,9000
0052,富邦科技        ,4000,0,4000,0,0,0,0,0,0,5000,0,0,0,121000,116000,5000,9000
059782,A50正2元大9C購04,0,0,0,0,0,0,0,0,0,9000,0,0,0,10000,1000,9000,9000
060051,台積電凱基9B購01,0,0,0,0,0,0,0,0,0,9000,0,0,0,9000,0,9000,9000
060020,康控康和99購01  ,0,0,0,0,0,0,0,0,0,9000,0,0,0,14000,5000,9000,9000
058081,技嘉群益9A購03  ,0,0,0,0,0,0,0,0,0,9000,0,0,0,9000,0,9000,9000
059650,緯穎凱基99購04  ,0,0,0,0,0,0,0,0,0,9000,0,0,0,14000,5000,9000,9000
059377,台積電群益99購09,0,0,0,0,0,0,0,0,0,9000,0,0,0,14000,5000,9000,9000
060322,卜蜂群益9A購01  ,0,0,0,0,0,0,0,0,0,9000,0,0,0,11000,2000,9000,9000
05959P,聯發科國票98售01,0,0,0,0,0,0,0,0,0,9000,0,0,0,9000,0,9000,9000
062394,大立光富邦02購01,0,0,0,0,0,0,0,0,0,9000,0,0,0,12000,3000,9000,9000
062405,泰鼎永豐9B購02  ,0,0,0,0,0,0,0,0,0,9000,0,0,0,55000,46000,9000,9000
062218,燿華統一01購01  ,0,0,0,0,0,0,0,0,0,9000,0,0,0,39000,30000,9000,9000
061955,FANG+統一9B購01 ,0,0,0,0,0,0,0,0,0,9000,0,0,0,10000,1000,9000,9000
062642,帆宣國票9B購01  ,0,0,0,0,0,0,0,0,0,9000,0,0,0,9000,0,9000,9000
062887,台積電群益9C購05,0,0,0,0,0,0,0,0,0,9000,0,0,0,10000,1000,9000,9000
062875,瑞昱兆豐9C購01  ,0,0,0,0,0,0,0,0,0,9000,0,0,0,9000,0,9000,9000
063063,泰鼎元富9B購01  ,0,0,0,0,0,0,0,0,0,9000,0,0,0,89000,80000,9000,9000
062938,聯發科凱基9B購10,0,0,0,0,0,0,0,0,0,9000,0,0,0,29000,20000,9000,9000
061778,元金2X群益9B購02,0,0,0,0,0,0,0,0,0,9000,0,0,0,10000,1000,9000,9000
061587,美律富邦9A購02  ,0,0,0,0,0,0,0,0,0,9000,0,0,0,15000,6000,9000,9000
061269,嘉澤凱基9A購01  ,0,0,0,0,0,0,0,0,0,9000,0,0,0,34000,25000,9000,9000
061346,玉晶光元大9B購03,0,0,0,0,0,0,0,0,0,9000,0,0,0,95000,86000,9000,9000
9918,欣天然          ,9000,0,9000,0,0,0,0,0,0,0,0,0,0,0,0,0,9000
6216,居易            ,10000,3000,7000,0,0,0,0,0,0,2000,2000,0,2000,0,0,0,9000
3164,景岳            ,7000,0,7000,0,0,0,0,0,0,2000,2000,0,2000,0,0,0,9000
3311,閎暉            ,17000,9000,8000,0,0,0,0,0,0,1000,1000,0,1000,0,0,0,9000
063864,健策富邦01購01  ,0,0,0,0,0,0,0,0,0,8000,0,0,0,14000,6000,8000,8000
06395P,台積電元大97售29,0,0,0,0,0,0,0,0,0,8000,0,0,0,15000,7000,8000,8000
06633P,國巨國票99售01  ,0,0,0,0,0,0,0,0,0,8000,0,0,0,10000,2000,8000,8000
063630,智邦元大9B購09  ,0,0,0,0,0,0,0,0,0,8000,0,0,0,35000,27000,8000,8000
063502,南電永豐9B購02  ,0,0,0,0,0,0,0,0,0,8000,0,0,0,8000,0,8000,8000
063390,嘉晶兆豐9B購01  ,0,0,0,0,0,0,0,0,0,8000,0,0,0,220000,212000,8000,8000
2497,怡利電          ,7000,1000,6000,0,0,0,0,0,0,2000,2000,0,2000,0,0,0,8000
1445,大宇            ,6000,0,6000,0,0,0,0,0,0,2000,2000,0,2000,0,0,0,8000
00700,富邦恒生國企    ,0,0,0,0,0,0,0,0,0,8000,0,0,0,108000,100000,8000,8000
05065P,燿華元大96售03  ,0,0,0,0,0,0,0,0,0,8000,0,0,0,8000,0,8000,8000
046375,友達凱基98購01  ,0,0,0,0,0,0,0,0,0,8000,0,0,0,8000,0,8000,8000
053744,台郡國票97購03  ,0,0,0,0,0,0,0,0,0,8000,0,0,0,68000,60000,8000,8000
050170,臺指反元大97購02,0,0,0,0,0,0,0,0,0,8000,0,0,0,363000,355000,8000,8000
051907,台積電元大97購05,0,0,0,0,0,0,0,0,0,8000,0,0,0,8000,0,8000,8000
051899,欣興國泰97購01  ,0,0,0,0,0,0,0,0,0,8000,0,0,0,8000,0,8000,8000
054213,欣興國票97購04  ,0,0,0,0,0,0,0,0,0,8000,0,0,0,8000,0,8000,8000
053257,華通富邦97購01  ,0,0,0,0,0,0,0,0,0,8000,0,0,0,8000,0,8000,8000
056068,欣興元大97購05  ,0,0,0,0,0,0,0,0,0,8000,0,0,0,15000,7000,8000,8000
059085,鴻海元大99購25  ,0,0,0,0,0,0,0,0,0,8000,0,0,0,22000,14000,8000,8000
059519,台郡永豐99購01  ,0,0,0,0,0,0,0,0,0,8000,0,0,0,28000,20000,8000,8000
059033,元油2X群益9C購05,0,0,0,0,0,0,0,0,0,8000,0,0,0,8000,0,8000,8000
055192,世芯元富97購01  ,0,0,0,0,0,0,0,0,0,8000,0,0,0,8000,0,8000,8000
055029,帆宣國泰99購01  ,0,0,0,0,0,0,0,0,0,8000,0,0,0,29000,21000,8000,8000
054938,國巨元大97購04  ,0,0,0,0,0,0,0,0,0,8000,0,0,0,8000,0,8000,8000
054504,聯鈞永豐96購01  ,0,0,0,0,0,0,0,0,0,8000,0,0,0,8000,0,8000,8000
055689,台郡凱基99購01  ,0,0,0,0,0,0,0,0,0,8000,0,0,0,20000,12000,8000,8000
055597,禾伸堂元大98購02,0,0,0,0,0,0,0,0,0,8000,0,0,0,14000,6000,8000,8000
057392,福懋科永豐98購01,0,0,0,0,0,0,0,0,0,8000,0,0,0,76000,68000,8000,8000
058649,健策永豐99購01  ,0,0,0,0,0,0,0,0,0,8000,0,0,0,20000,12000,8000,8000
058206,祥碩凱基99購01  ,0,0,0,0,0,0,0,0,0,8000,0,0,0,8000,0,8000,8000
057563,旭富國泰9A購01  ,0,0,0,0,0,0,0,0,0,8000,0,0,0,11000,3000,8000,8000
060200,同欣電元富9A購01,0,0,0,0,0,0,0,0,0,8000,0,0,0,10000,2000,8000,8000
060216,鴻海凱基9A購17  ,0,0,0,0,0,0,0,0,0,8000,0,0,0,8000,0,8000,8000
057465,智易永豐98購02  ,0,0,0,0,0,0,0,0,0,8000,0,0,0,68000,60000,8000,8000
059219,旺宏元大99購12  ,0,0,0,0,0,0,0,0,0,8000,0,0,0,11000,3000,8000,8000
058892,元油2X元大9C購08,0,0,0,0,0,0,0,0,0,8000,0,0,0,18000,10000,8000,8000
059898,T50反1元大99購15,0,0,0,0,0,0,0,0,0,8000,0,0,0,8000,0,8000,8000
061894,台積電永豐9B購01,0,0,0,0,0,0,0,0,0,8000,0,0,0,8000,0,8000,8000
061139,玉晶光統一9C購02,0,0,0,0,0,0,0,0,0,8000,0,0,0,125000,117000,8000,8000
062948,台積電富邦01購02,0,0,0,0,0,0,0,0,0,8000,0,0,0,80000,72000,8000,8000
063199,台積電統一01購07,0,0,0,0,0,0,0,0,0,8000,0,0,0,10000,2000,8000,8000
062783,大立光元大9C購03,0,0,0,0,0,0,0,0,0,8000,0,0,0,13000,5000,8000,8000
062840,臺股指群益9B購07,0,0,0,0,0,0,0,0,0,8000,0,0,0,8000,0,8000,8000
061957,上銀統一01購01  ,0,0,0,0,0,0,0,0,0,8000,0,0,0,88000,80000,8000,8000
061978,旺宏元大9C購01  ,0,0,0,0,0,0,0,0,0,8000,0,0,0,66000,58000,8000,8000
062004,國巨國泰9C購03  ,0,0,0,0,0,0,0,0,0,8000,0,0,0,25000,17000,8000,8000
4438,廣越            ,18000,15000,3000,0,0,0,0,0,0,5000,5000,0,5000,0,0,0,8000
912000,晨訊科-DR       ,8000,0,8000,0,0,0,0,0,0,0,0,0,0,0,0,0,8000
8367,建新國際        ,7000,0,7000,0,0,0,0,0,0,1000,1000,0,1000,0,0,0,8000
8443,阿瘦            ,8000,0,8000,0,0,0,0,0,0,0,0,0,0,0,0,0,8000
8104,錸寶            ,61000,53000,8000,0,0,0,0,0,0,0,0,0,0,0,0,0,8000
1203,味王            ,7000,0,7000,0,0,0,0,0,0,0,0,0,0,0,0,0,7000
1713,國化            ,5000,0,5000,0,0,0,0,0,0,2000,2000,0,2000,0,0,0,7000
2008,高興昌          ,7000,0,7000,0,0,0,0,0,0,0,0,0,0,0,0,0,7000
1524,耿鼎            ,15000,11000,4000,0,0,0,0,0,0,3000,3000,0,3000,0,0,0,7000
1465,偉全            ,7000,0,7000,0,0,0,0,0,0,0,0,0,0,0,0,0,7000
1721,三晃            ,5000,3000,2000,0,0,0,0,0,0,5000,5000,0,5000,0,0,0,7000
2401,凌陽            ,795000,921000,-126000,0,0,0,0,0,0,133000,141000,8000,133000,0,0,0,7000
2115,六暉-KY         ,6000,0,6000,0,0,0,0,0,0,1000,1000,0,1000,0,0,0,7000
07741P,滬深2X凱基9B售04,0,0,0,0,0,0,0,0,0,7000,0,0,0,12000,5000,7000,7000
07392P,台積電國泰02售01,0,0,0,0,0,0,0,0,0,7000,0,0,0,10000,3000,7000,7000
07418P,聯發科元大99售45,0,0,0,0,0,0,0,0,0,7000,0,0,0,208000,201000,7000,7000
063407,泰鼎國票9C購01  ,0,0,0,0,0,0,0,0,0,7000,0,0,0,7000,0,7000,7000
063350,台表科統一02購02,0,0,0,0,0,0,0,0,0,7000,0,0,0,117000,110000,7000,7000
06424P,大成鋼永豐97售01,0,0,0,0,0,0,0,0,0,7000,0,0,0,30000,23000,7000,7000
06509P,鴻海群益98售03  ,0,0,0,0,0,0,0,0,0,7000,0,0,0,7000,0,7000,7000
07280P,FBVIX凱基99售01 ,0,0,0,0,0,0,0,0,0,7000,0,0,0,7000,0,7000,7000
06859P,元金2X中信9C售01,0,0,0,0,0,0,0,0,0,7000,0,0,0,7000,0,7000,7000
06903P,技嘉凱基98售04  ,0,0,0,0,0,0,0,0,0,7000,0,0,0,29000,22000,7000,7000
054610,聯發科永豐97購01,0,0,0,0,0,0,0,0,0,7000,0,0,0,7000,0,7000,7000
056449,義隆凱基98購03  ,0,0,0,0,0,0,0,0,0,7000,0,0,0,9000,2000,7000,7000
059510,華新科永豐99購07,0,0,0,0,0,0,0,0,0,7000,0,0,0,10000,3000,7000,7000
059302,大立光群益99購08,0,0,0,0,0,0,0,0,0,7000,0,0,0,7000,0,7000,7000
055942,臺股指群益9C購01,0,0,0,0,0,0,0,0,0,7000,0,0,0,7000,0,7000,7000
053461,台郡永昌99購01  ,0,0,0,0,0,0,0,0,0,7000,0,0,0,13000,6000,7000,7000
052417,聯發科兆豐9B購01,0,0,0,0,0,0,0,0,0,7000,0,0,0,7000,0,7000,7000
053637,強茂永豐96購01  ,0,0,0,0,0,0,0,0,0,7000,0,0,0,109000,102000,7000,7000
053029,國巨第一96購01  ,0,0,0,0,0,0,0,0,0,7000,0,0,0,7000,0,7000,7000
055349,京元電凱基97購02,0,0,0,0,0,0,0,0,0,7000,0,0,0,8000,1000,7000,7000
055524,鴻海群益98購01  ,0,0,0,0,0,0,0,0,0,7000,0,0,0,7000,0,7000,7000
053945,國巨富邦98購02  ,0,0,0,0,0,0,0,0,0,7000,0,0,0,10000,3000,7000,7000
054002,GIS群益96購03   ,0,0,0,0,0,0,0,0,0,7000,0,0,0,7000,0,7000,7000
058132,義隆元大99購03  ,0,0,0,0,0,0,0,0,0,7000,0,0,0,11000,4000,7000,7000
057093,臻鼎元富98購02  ,0,0,0,0,0,0,0,0,0,7000,0,0,0,7000,0,7000,7000
057043,台積電元大99購02,0,0,0,0,0,0,0,0,0,7000,0,0,0,7000,0,7000,7000
058905,京鼎元大99購01  ,0,0,0,0,0,0,0,0,0,7000,0,0,0,115000,108000,7000,7000
059273,臺指反元大9C購03,0,0,0,0,0,0,0,0,0,7000,0,0,0,7000,0,7000,7000
057464,大立光永豐98購02,0,0,0,0,0,0,0,0,0,7000,0,0,0,7000,0,7000,7000
058224,世芯統一9B購02  ,0,0,0,0,0,0,0,0,0,7000,0,0,0,7000,0,7000,7000
060085,華通元大99購10  ,0,0,0,0,0,0,0,0,0,7000,0,0,0,17000,10000,7000,7000
058217,新唐群益99購01  ,0,0,0,0,0,0,0,0,0,7000,0,0,0,7000,0,7000,7000
057735,台灣50富邦9C購02,0,0,0,0,0,0,0,0,0,7000,0,0,0,18000,11000,7000,7000
058579,聯發科群益99購04,0,0,0,0,0,0,0,0,0,7000,0,0,0,7000,0,7000,7000
057390,台表科永豐98購01,0,0,0,0,0,0,0,0,0,7000,0,0,0,35000,28000,7000,7000
058383,道瓊指中信9C購02,0,0,0,0,0,0,0,0,0,7000,0,0,0,7000,0,7000,7000
062083,健策元大9C購03  ,0,0,0,0,0,0,0,0,0,7000,0,0,0,55000,48000,7000,7000
062284,華擎群益9C購03  ,0,0,0,0,0,0,0,0,0,7000,0,0,0,7000,0,7000,7000
062511,台光電國票9B購02,0,0,0,0,0,0,0,0,0,7000,0,0,0,7000,0,7000,7000
062628,廣達國票9B購01  ,0,0,0,0,0,0,0,0,0,7000,0,0,0,54000,47000,7000,7000
063170,智邦第一9B購01  ,0,0,0,0,0,0,0,0,0,7000,0,0,0,53000,46000,7000,7000
060843,大立光國票9A購06,0,0,0,0,0,0,0,0,0,7000,0,0,0,52000,45000,7000,7000
061042,致新永豐9A購02  ,0,0,0,0,0,0,0,0,0,7000,0,0,0,43000,36000,7000,7000
061688,華通群益9A購07  ,0,0,0,0,0,0,0,0,0,7000,0,0,0,9000,2000,7000,7000
061340,義隆元大9A購01  ,0,0,0,0,0,0,0,0,0,7000,0,0,0,7000,0,7000,7000
061541,旺宏群益9A購03  ,0,0,0,0,0,0,0,0,0,7000,0,0,0,14000,7000,7000,7000
6197,佳必琪          ,100000,93000,7000,0,0,0,0,0,0,0,0,0,0,0,0,0,7000
5484,慧友            ,7000,0,7000,0,0,0,0,0,0,0,0,0,0,0,0,0,7000
06780P,義隆元大98售02  ,0,0,0,0,0,0,0,0,0,6000,0,0,0,169000,163000,6000,6000
07009P,臺股指中信9B售01,0,0,0,0,0,0,0,0,0,6000,0,0,0,20000,14000,6000,6000
06757P,台灣50元大9B售01,0,0,0,0,0,0,0,0,0,6000,0,0,0,50000,44000,6000,6000
07408P,台積電兆豐99售06,0,0,0,0,0,0,0,0,0,6000,0,0,0,6000,0,6000,6000
07383P,聯發科群益99售06,0,0,0,0,0,0,0,0,0,6000,0,0,0,6000,0,6000,6000
07901P,臺股指凱基9B售04,0,0,0,0,0,0,0,0,0,6000,0,0,0,276000,270000,6000,6000
2460,建通            ,5000,0,5000,0,0,0,0,0,0,1000,1000,0,1000,0,0,0,6000
2897A,王道銀甲特      ,0,0,0,0,0,0,0,0,0,6000,6000,0,6000,0,0,0,6000
1612,宏泰            ,1000,0,1000,0,0,0,0,0,0,5000,5000,0,5000,0,0,0,6000
1568,倉佑            ,4000,0,4000,0,0,0,0,0,0,2000,2000,0,2000,0,0,0,6000
2033,佳大            ,5000,0,5000,0,0,0,0,0,0,1000,1000,0,1000,0,0,0,6000
1446,宏和            ,5000,2000,3000,0,0,0,0,0,0,3000,3000,0,3000,0,0,0,6000
1463,強盛            ,2000,0,2000,0,0,0,0,0,0,4000,5000,1000,4000,0,0,0,6000
1416,廣豐            ,3000,0,3000,0,0,0,0,0,0,3000,3000,0,3000,0,0,0,6000
1436,華友聯          ,5000,0,5000,0,0,0,0,0,0,1000,1000,0,1000,0,0,0,6000
042168,台灣50凱基96購01,0,0,0,0,0,0,0,0,0,6000,0,0,0,6000,0,6000,6000
050984,大立光國泰97購01,0,0,0,0,0,0,0,0,0,6000,0,0,0,10000,4000,6000,6000
056426,上証2X凱基9A購01,0,0,0,0,0,0,0,0,0,6000,0,0,0,6000,0,6000,6000
053031,華新科第一96購01,0,0,0,0,0,0,0,0,0,6000,0,0,0,6000,0,6000,6000
053645,臺股指國票96購08,0,0,0,0,0,0,0,0,0,6000,0,0,0,6000,0,6000,6000
053629,玉山金兆豐96購01,0,0,0,0,0,0,0,0,0,6000,0,0,0,6000,0,6000,6000
055899,群創中信99購01  ,0,0,0,0,0,0,0,0,0,6000,0,0,0,6000,0,6000,6000
056070,新日興元大97購04,0,0,0,0,0,0,0,0,0,6000,0,0,0,20000,14000,6000,6000
059346,新日興凱基99購03,0,0,0,0,0,0,0,0,0,6000,0,0,0,6000,0,6000,6000
059341,台積電凱基99購15,0,0,0,0,0,0,0,0,0,6000,0,0,0,36000,30000,6000,6000
059160,華通凱基99購03  ,0,0,0,0,0,0,0,0,0,6000,0,0,0,6000,0,6000,6000
059171,祥碩凱基99購04  ,0,0,0,0,0,0,0,0,0,6000,0,0,0,6000,0,6000,6000
056434,國巨凱基98購03  ,0,0,0,0,0,0,0,0,0,6000,0,0,0,90000,84000,6000,6000
055654,景碩元富97購01  ,0,0,0,0,0,0,0,0,0,6000,0,0,0,6000,0,6000,6000
056490,台積電國泰99購01,0,0,0,0,0,0,0,0,0,6000,0,0,0,6000,0,6000,6000
055264,國巨永豐98購01  ,0,0,0,0,0,0,0,0,0,6000,0,0,0,6000,0,6000,6000
058439,玉晶光統一01購02,0,0,0,0,0,0,0,0,0,6000,0,0,0,6000,0,6000,6000
058569,健策凱基9A購01  ,0,0,0,0,0,0,0,0,0,6000,0,0,0,29000,23000,6000,6000
058507,美律元大9A購01  ,0,0,0,0,0,0,0,0,0,6000,0,0,0,64000,58000,6000,6000
058483,道瓊指國票9A購01,0,0,0,0,0,0,0,0,0,6000,0,0,0,106000,100000,6000,6000
057724,亞德客國泰99購01,0,0,0,0,0,0,0,0,0,6000,0,0,0,6000,0,6000,6000
059716,鴻海元大99購35  ,0,0,0,0,0,0,0,0,0,6000,0,0,0,13000,7000,6000,6000
058031,旺宏永豐98購04  ,0,0,0,0,0,0,0,0,0,6000,0,0,0,53000,47000,6000,6000
059907,道瓊指元大99購03,0,0,0,0,0,0,0,0,0,6000,0,0,0,16000,10000,6000,6000
059840,鴻海富邦9A購02  ,0,0,0,0,0,0,0,0,0,6000,0,0,0,6000,0,6000,6000
059824,大立光凱基99購13,0,0,0,0,0,0,0,0,0,6000,0,0,0,6000,0,6000,6000
061548,聯詠群益9A購02  ,0,0,0,0,0,0,0,0,0,6000,0,0,0,6000,0,6000,6000
061559,南亞科國票9A購02,0,0,0,0,0,0,0,0,0,6000,0,0,0,48000,42000,6000,6000
061408,華新科國票9A購06,0,0,0,0,0,0,0,0,0,6000,0,0,0,6000,0,6000,6000
061768,晶技元大9B購02  ,0,0,0,0,0,0,0,0,0,6000,0,0,0,11000,5000,6000,6000
061889,祥碩富邦9B購01  ,0,0,0,0,0,0,0,0,0,6000,0,0,0,6000,0,6000,6000
061869,智邦元大9B購01  ,0,0,0,0,0,0,0,0,0,6000,0,0,0,56000,50000,6000,6000
060661,台積電凱基9A購18,0,0,0,0,0,0,0,0,0,6000,0,0,0,26000,20000,6000,6000
060813,高鐵凱基9A購01  ,0,0,0,0,0,0,0,0,0,6000,0,0,0,16000,10000,6000,6000
063143,嘉澤統一9B購02  ,0,0,0,0,0,0,0,0,0,6000,0,0,0,26000,20000,6000,6000
062977,健策元富9B購01  ,0,0,0,0,0,0,0,0,0,6000,0,0,0,9000,3000,6000,6000
062799,聯發科統一9C購09,0,0,0,0,0,0,0,0,0,6000,0,0,0,6000,0,6000,6000
062917,旭富元大9C購03  ,0,0,0,0,0,0,0,0,0,6000,0,0,0,179000,173000,6000,6000
062316,康控凱基9B購03  ,0,0,0,0,0,0,0,0,0,6000,0,0,0,20000,14000,6000,6000
062039,聯發科凱基9B購07,0,0,0,0,0,0,0,0,0,6000,0,0,0,6000,0,6000,6000
3050,鈺德            ,12000,6000,6000,0,0,0,0,0,0,0,0,0,0,0,0,0,6000
8482,商億-KY         ,8000,2000,6000,0,0,0,0,0,0,0,0,0,0,0,0,0,6000
8411,福貞-KY         ,5000,2000,3000,0,0,0,0,0,0,3000,3000,0,3000,0,0,0,6000
1423,利華            ,3000,0,3000,0,0,0,0,0,0,2000,2000,0,2000,0,0,0,5000
1432,大魯閣          ,6000,1000,5000,0,0,0,0,0,0,0,0,0,0,0,0,0,5000
2069,運錩            ,3000,0,3000,0,0,0,0,0,0,2000,2000,0,2000,0,0,0,5000
1525,江申            ,4000,0,4000,0,0,0,0,0,0,1000,1000,0,1000,0,0,0,5000
1529,樂士            ,2000,2000,0,0,0,0,0,0,0,5000,5000,0,5000,0,0,0,5000
2440,太空梭          ,5000,0,5000,0,0,0,0,0,0,0,0,0,0,0,0,0,5000
07978P,茂林群益9B售02  ,0,0,0,0,0,0,0,0,0,5000,0,0,0,5000,0,5000,5000
08040P,臺股指群益9B售13,0,0,0,0,0,0,0,0,0,5000,0,0,0,10000,5000,5000,5000
063857,臺股指元大9C購10,0,0,0,0,0,0,0,0,0,5000,0,0,0,5000,0,5000,5000
06928P,鴻海元大99售10  ,0,0,0,0,0,0,0,0,0,5000,0,0,0,42000,37000,5000,5000
06810P,國巨統一99售03  ,0,0,0,0,0,0,0,0,0,5000,0,0,0,5000,0,5000,5000
07178P,臺股指凱基99售20,0,0,0,0,0,0,0,0,0,5000,0,0,0,5000,0,5000,5000
063511,南電群益9B購02  ,0,0,0,0,0,0,0,0,0,5000,0,0,0,10000,5000,5000,5000
063839,華通元大9C購02  ,0,0,0,0,0,0,0,0,0,5000,0,0,0,6000,1000,5000,5000
055202,神達群益97購01  ,0,0,0,0,0,0,0,0,0,5000,0,0,0,5000,0,5000,5000
055760,新日興群益98購02,0,0,0,0,0,0,0,0,0,5000,0,0,0,5000,0,5000,5000
056573,華新科元大99購06,0,0,0,0,0,0,0,0,0,5000,0,0,0,55000,50000,5000,5000
055733,奇力新元富97購01,0,0,0,0,0,0,0,0,0,5000,0,0,0,5000,0,5000,5000
055646,漢唐元富97購01  ,0,0,0,0,0,0,0,0,0,5000,0,0,0,5000,0,5000,5000
056474,華新科元大99購05,0,0,0,0,0,0,0,0,0,5000,0,0,0,5000,0,5000,5000
054375,貿聯中信99購01  ,0,0,0,0,0,0,0,0,0,5000,0,0,0,5000,0,5000,5000
05461P,台積電亞東97售01,0,0,0,0,0,0,0,0,0,5000,0,0,0,5000,0,5000,5000
054589,聯鈞國泰99購01  ,0,0,0,0,0,0,0,0,0,5000,0,0,0,146000,141000,5000,5000
054596,聯發科麥證97購01,0,0,0,5000,0,5000,0,0,0,5000,0,0,0,5000,0,5000,5000
054480,和碩中信98購01  ,0,0,0,0,0,0,0,0,0,5000,0,0,0,49000,44000,5000,5000
059182,台灣50台新9B購03,0,0,0,0,0,0,0,0,0,5000,0,0,0,5000,0,5000,5000
059168,奇力新凱基99購05,0,0,0,0,0,0,0,0,0,5000,0,0,0,6000,1000,5000,5000
059091,中信金元大99購01,0,0,0,0,0,0,0,0,0,5000,0,0,0,5000,0,5000,5000
059293,宏達電元富9B購01,0,0,0,0,0,0,0,0,0,5000,0,0,0,24000,19000,5000,5000
059526,鴻海凱基99購12  ,0,0,0,0,0,0,0,0,0,5000,0,0,0,7000,2000,5000,5000
059020,元油2X統一9B購02,0,0,0,0,0,0,0,0,0,5000,0,0,0,30000,25000,5000,5000
059001,聯發科元大99購17,0,0,0,0,0,0,0,0,0,5000,0,0,0,5000,0,5000,5000
056120,聯茂群益97購02  ,0,0,0,0,0,0,0,0,0,5000,0,0,0,5000,0,5000,5000
055911,可成凱基98購02  ,0,0,0,0,0,0,0,0,0,5000,0,0,0,50000,45000,5000,5000
055924,深中小群益9B購01,0,0,0,0,0,0,0,0,0,5000,0,0,0,5000,0,5000,5000
055932,玉山金群益99購01,0,0,0,0,0,0,0,0,0,5000,0,0,0,5000,0,5000,5000
05660P,玉晶光第一96售01,0,0,0,0,0,0,0,0,0,5000,0,0,0,5000,0,5000,5000
053569,漢唐統一98購01  ,0,0,0,0,0,0,0,0,0,5000,0,0,0,5000,0,5000,5000
053517,崇越群益97購01  ,0,0,0,0,0,0,0,0,0,5000,0,0,0,5000,0,5000,5000
053332,創意永豐96購03  ,0,0,0,0,0,0,0,0,0,5000,0,0,0,5000,0,5000,5000
053190,聯發科統一99購01,0,0,0,0,0,0,0,0,0,5000,0,0,0,5000,0,5000,5000
052308,大立光國泰97購02,0,0,0,0,0,0,0,0,0,5000,0,0,0,5000,0,5000,5000
052235,聯發科國票96購02,0,0,0,0,0,0,0,0,0,5000,0,0,0,80000,75000,5000,5000
05422P,大立光中信97售02,0,0,0,0,0,0,0,0,0,5000,0,0,0,5000,0,5000,5000
052748,群創元大9A購02  ,0,0,0,0,0,0,0,0,0,5000,0,0,0,5000,0,5000,5000
052608,欣興元大97購01  ,0,0,0,0,0,0,0,0,0,5000,0,0,0,5000,0,5000,5000
052871,群創凱基98購07  ,0,0,0,0,0,0,0,0,0,5000,0,0,0,5000,0,5000,5000
053708,道瓊反凱基98購01,0,0,0,0,0,0,0,0,0,5000,0,0,0,5000,0,5000,5000
05306P,泰碩國泰97售01  ,0,0,0,0,0,0,0,0,0,5000,0,0,0,25000,20000,5000,5000
055343,國巨凱基97購03  ,0,0,0,0,0,0,0,0,0,5000,0,0,0,5000,0,5000,5000
055361,樺漢凱基97購01  ,0,0,0,0,0,0,0,0,0,5000,0,0,0,5000,0,5000,5000
055376,群創元大01購01  ,0,0,0,0,0,0,0,0,0,5000,0,0,0,5000,0,5000,5000
051449,玉晶光元大96購01,0,0,0,0,0,0,0,0,0,5000,0,0,0,5000,0,5000,5000
051490,世芯凱基96購01  ,0,0,0,0,0,0,0,0,0,5000,0,0,0,25000,20000,5000,5000
051467,GIS富邦96購01   ,0,0,0,0,0,0,0,0,0,5000,0,0,0,5000,0,5000,5000
046928,奇鋐富邦97購01  ,0,0,0,0,0,0,0,0,0,5000,0,0,0,5000,0,5000,5000
0053,元大電子        ,0,0,0,0,0,0,0,0,0,5000,0,0,0,13000,8000,5000,5000
050344,鴻海元富96購01  ,0,0,0,0,0,0,0,0,0,5000,0,0,0,5000,0,5000,5000
050282,T50反1凱基97購01,0,0,0,0,0,0,0,0,0,5000,0,0,0,60000,55000,5000,5000
049892,國巨富邦96購01  ,0,0,0,0,0,0,0,0,0,5000,0,0,0,5000,0,5000,5000
049004,聯發科中信96購01,0,0,0,0,0,0,0,0,0,5000,0,0,0,5000,0,5000,5000
051799,台積電永豐96購01,0,0,0,0,0,0,0,0,0,5000,0,0,0,482000,477000,5000,5000
059874,大立光凱基99購15,0,0,0,0,0,0,0,0,0,5000,0,0,0,5000,0,5000,5000
059906,臺指反元大9C購04,0,0,0,0,0,0,0,0,0,5000,0,0,0,15000,10000,5000,5000
059921,大立光元大99購24,0,0,0,0,0,0,0,0,0,5000,0,0,0,15000,10000,5000,5000
056812,泰鼎統一98購01  ,0,0,0,0,0,0,0,0,0,5000,0,0,0,5000,0,5000,5000
056898,全新元大98購02  ,0,0,0,0,0,0,0,0,0,5000,0,0,0,5000,0,5000,5000
058091,欣興元大99購03  ,0,0,0,0,0,0,0,0,0,5000,0,0,0,15000,10000,5000,5000
057613,瑞昱元富02購02  ,0,0,0,0,0,0,0,0,0,5000,0,0,0,20000,15000,5000,5000
058078,景碩國票99購01  ,0,0,0,0,0,0,0,0,0,5000,0,0,0,5000,0,5000,5000
058839,瑞儀中信99購02  ,0,0,0,0,0,0,0,0,0,5000,0,0,0,26000,21000,5000,5000
058847,國巨群益99購05  ,0,0,0,0,0,0,0,0,0,5000,0,0,0,184000,179000,5000,5000
059734,T50正2元富99購05,0,0,0,0,0,0,0,0,0,5000,0,0,0,5000,0,5000,5000
059922,大立光元大99購25,0,0,0,0,0,0,0,0,0,5000,0,0,0,125000,120000,5000,5000
059404,鴻海台新99購03  ,0,0,0,0,0,0,0,0,0,5000,0,0,0,5000,0,5000,5000
058831,茂林永豐99購01  ,0,0,0,0,0,0,0,0,0,5000,0,0,0,5000,0,5000,5000
057718,旺宏元富02購02  ,0,0,0,0,0,0,0,0,0,5000,0,0,0,5000,0,5000,5000
057673,臻鼎元大98購01  ,0,0,0,0,0,0,0,0,0,5000,0,0,0,5000,0,5000,5000
057785,智邦國票99購02  ,0,0,0,0,0,0,0,0,0,5000,0,0,0,8000,3000,5000,5000
058469,臺股指中信9A購05,0,0,0,0,0,0,0,0,0,5000,0,0,0,5000,0,5000,5000
05814P,臺股指國票96售07,0,0,0,0,0,0,0,0,0,5000,0,0,0,5000,0,5000,5000
058617,南電元大99購01  ,0,0,0,0,0,0,0,0,0,5000,0,0,0,5000,0,5000,5000
058626,瑞昱國票9A購01  ,0,0,0,0,0,0,0,0,0,5000,0,0,0,5000,0,5000,5000
058633,台灣50兆豐99購01,0,0,0,0,0,0,0,0,0,5000,0,0,0,5000,0,5000,5000
058671,旺宏群益9A購01  ,0,0,0,0,0,0,0,0,0,5000,0,0,0,31000,26000,5000,5000
058704,台積電元大99購17,0,0,0,0,0,0,0,0,0,5000,0,0,0,46000,41000,5000,5000
060947,台積電統一9C購03,0,0,0,0,0,0,0,0,0,5000,0,0,0,5000,0,5000,5000
058366,元大金凱基99購01,0,0,0,0,0,0,0,0,0,5000,0,0,0,5000,0,5000,5000
058227,台灣50元大9C購01,0,0,0,0,0,0,0,0,0,5000,0,0,0,63000,58000,5000,5000
058253,臺股指元大9A購17,0,0,0,0,0,0,0,0,0,5000,0,0,0,7000,2000,5000,5000
057425,臺股指凱基9C購02,0,0,0,0,0,0,0,0,0,5000,0,0,0,5000,0,5000,5000
060344,聯發科統一01購01,0,0,0,0,0,0,0,0,0,5000,0,0,0,5000,0,5000,5000
062001,臺股指元大9B購25,0,0,0,0,0,0,0,0,0,5000,0,0,0,5000,0,5000,5000
062022,緯穎永豐9B購01  ,0,0,0,0,0,0,0,0,0,5000,0,0,0,50000,45000,5000,5000
062172,南六永豐9B購01  ,0,0,0,0,0,0,0,0,0,5000,0,0,0,183000,178000,5000,5000
062313,聯詠凱基9C購01  ,0,0,0,0,0,0,0,0,0,5000,0,0,0,20000,15000,5000,5000
062315,健策凱基9C購01  ,0,0,0,0,0,0,0,0,0,5000,0,0,0,22000,17000,5000,5000
062301,聯詠中信05購01  ,0,0,0,0,0,0,0,0,0,5000,0,0,0,15000,10000,5000,5000
062814,台光電兆豐9B購01,0,0,0,0,0,0,0,0,0,5000,0,0,0,5000,0,5000,5000
062646,聯發科國泰01購02,0,0,0,0,0,0,0,0,0,5000,0,0,0,30000,25000,5000,5000
060831,T50反1國票9B購03,0,0,0,0,0,0,0,0,0,5000,0,0,0,30000,25000,5000,5000
060756,鴻海元大9A購16  ,0,0,0,0,0,0,0,0,0,5000,0,0,0,75000,70000,5000,5000
060765,世芯元大9A購01  ,0,0,0,0,0,0,0,0,0,5000,0,0,0,5000,0,5000,5000
060594,國巨麥證9A購01  ,0,0,0,5000,0,5000,0,0,0,5000,0,0,0,5000,0,5000,5000
060635,義隆永豐9A購01  ,0,0,0,0,0,0,0,0,0,5000,0,0,0,5000,0,5000,5000
060642,華擎永豐9A購02  ,0,0,0,0,0,0,0,0,0,5000,0,0,0,192000,187000,5000,5000
061013,台積電麥證9A購03,0,0,0,5000,0,5000,0,0,0,5000,0,0,0,5000,0,5000,5000
061063,國巨凱基9A購14  ,0,0,0,0,0,0,0,0,0,5000,0,0,0,5000,0,5000,5000
061224,道瓊反中信01購01,0,0,0,0,0,0,0,0,0,5000,0,0,0,5000,0,5000,5000
061218,臺股指元大9A購55,0,0,0,0,0,0,0,0,0,5000,0,0,0,5000,0,5000,5000
061248,健策群益9A購03  ,0,0,0,0,0,0,0,0,0,5000,0,0,0,18000,13000,5000,5000
061201,FBVIX元大01購03 ,0,0,0,0,0,0,0,0,0,5000,0,0,0,5000,0,5000,5000
061852,大立光國票9B購02,0,0,0,0,0,0,0,0,0,5000,0,0,0,5000,0,5000,5000
061730,旺宏統一01購02  ,0,0,0,0,0,0,0,0,0,5000,0,0,0,5000,0,5000,5000
061320,奇力新凱基9A購04,0,0,0,0,0,0,0,0,0,5000,0,0,0,5000,0,5000,5000
061599,元金反中信9C購01,0,0,0,0,0,0,0,0,0,5000,0,0,0,7000,2000,5000,5000
061527,牧德凱基9A購02  ,0,0,0,0,0,0,0,0,0,5000,0,0,0,17000,12000,5000,5000
061528,超眾凱基9A購04  ,0,0,0,0,0,0,0,0,0,5000,0,0,0,28000,23000,5000,5000
8478,東哥遊艇        ,4000,0,4000,0,0,0,0,0,0,1000,1000,0,1000,0,0,0,5000
9925,新保            ,46000,47000,-1000,0,0,0,0,0,0,6000,6000,0,6000,0,0,0,5000
6671,三能-KY         ,5000,0,5000,0,0,0,0,0,0,0,0,0,0,0,0,0,5000
3002,歐格            ,4000,0,4000,0,0,0,0,0,0,1000,1000,0,1000,0,0,0,5000
3494,誠研            ,5000,0,5000,0,0,0,0,0,0,0,0,0,0,0,0,0,5000
3591,艾笛森          ,4000,0,4000,0,0,0,0,0,0,1000,1000,0,1000,0,0,0,5000
4545,銘鈺            ,13000,8000,5000,0,0,0,0,0,0,0,1000,1000,0,0,0,0,5000
4755,三福化          ,4000,0,4000,0,0,0,0,0,0,1000,1000,0,1000,0,0,0,5000
5258,虹堡            ,11000,7000,4000,0,0,0,0,0,0,1000,2000,1000,1000,0,0,0,5000
2613,中櫃            ,3000,85,2915,0,0,0,0,0,0,2000,2000,0,2000,0,0,0,4915
2424,隴華            ,4000,0,4000,0,0,0,0,0,0,0,0,0,0,0,0,0,4000
2438,翔耀            ,4000,0,4000,0,0,0,0,0,0,0,0,0,0,0,0,0,4000
1468,昶和            ,6000,2000,4000,0,0,0,0,0,0,0,0,0,0,0,0,0,4000
1474,弘裕            ,53000,49000,4000,0,0,0,0,0,0,0,1000,1000,0,0,0,0,4000
1587,吉茂            ,4000,0,4000,0,0,0,0,0,0,0,0,0,0,0,0,0,4000
2032,新鋼            ,3000,0,3000,0,0,0,0,0,0,1000,1000,0,1000,0,0,0,4000
1725,元禎            ,5000,1000,4000,0,0,0,0,0,0,0,0,0,0,0,0,0,4000
08213P,台光電統一9B售03,0,0,0,0,0,0,0,0,0,4000,0,0,0,9000,5000,4000,4000
07789P,緯穎群益9A售03  ,0,0,0,0,0,0,0,0,0,4000,0,0,0,4000,0,4000,4000
07776P,國巨群益9B售02  ,0,0,0,0,0,0,0,0,0,4000,0,0,0,4000,0,4000,4000
07872P,聯發科群益9B售03,0,0,0,0,0,0,0,0,0,4000,0,0,0,24000,20000,4000,4000
07344P,鴻海富邦9A售03  ,0,0,0,0,0,0,0,0,0,4000,0,0,0,4000,0,4000,4000
07300P,臺股指元大9A售33,0,0,0,0,0,0,0,0,0,4000,0,0,0,49000,45000,4000,4000
07411P,國巨元大99售31  ,0,0,0,0,0,0,0,0,0,4000,0,0,0,4000,0,4000,4000
07689P,旺宏元大9A售13  ,0,0,0,0,0,0,0,0,0,4000,0,0,0,9000,5000,4000,4000
07700P,臺股指元大9A售53,0,0,0,0,0,0,0,0,0,4000,0,0,0,4000,0,4000,4000
063748,台積電國票9C購05,0,0,0,0,0,0,0,0,0,4000,0,0,0,13000,9000,4000,4000
06375P,矽力元大97售06  ,0,0,0,0,0,0,0,0,0,4000,0,0,0,4000,0,4000,4000
063528,元大金凱基9B購01,0,0,0,0,0,0,0,0,0,4000,0,0,0,101000,97000,4000,4000
063353,上銀元富9B購03  ,0,0,0,0,0,0,0,0,0,4000,0,0,0,7000,3000,4000,4000
07067P,旺宏台新99售02  ,0,0,0,0,0,0,0,0,0,4000,0,0,0,9000,5000,4000,4000
07074P,FBVIX凱基9A售01 ,0,0,0,0,0,0,0,0,0,4000,0,0,0,4000,0,4000,4000
07076P,鴻海凱基9A售08  ,0,0,0,0,0,0,0,0,0,4000,0,0,0,45000,41000,4000,4000
07159P,台積電永豐99售04,0,0,0,0,0,0,0,0,0,4000,0,0,0,4000,0,4000,4000
06922P,元上證群益9C售01,0,0,0,0,0,0,0,0,0,4000,0,0,0,4000,0,4000,4000
07044P,台積電元大99售13,0,0,0,0,0,0,0,0,0,4000,0,0,0,4000,0,4000,4000
06421P,嘉澤統一97售02  ,0,0,0,0,0,0,0,0,0,4000,0,0,0,53000,49000,4000,4000
06417P,台積電兆豐97售03,0,0,0,0,0,0,0,0,0,4000,0,0,0,4000,0,4000,4000
052229,奇力新凱基96購01,0,0,0,0,0,0,0,0,0,4000,0,0,0,4000,0,4000,4000
053964,上銀元大96購05  ,0,0,0,0,0,0,0,0,0,4000,0,0,0,4000,0,4000,4000
00647L,元大S&P500正2   ,3000,5000,-2000,0,0,0,0,0,0,6000,0,0,0,331000,325000,6000,4000
006203,元大MSCI台灣    ,1000,1000,0,0,0,0,0,0,0,4000,0,0,0,9000,5000,4000,4000
00731,FH富時高息低波  ,0,0,0,0,0,0,0,0,0,4000,0,0,0,1336000,1332000,4000,4000
051562,玉晶光國泰97購05,0,0,0,0,0,0,0,0,0,4000,0,0,0,10000,6000,4000,4000
051463,世芯國泰97購02  ,0,0,0,0,0,0,0,0,0,4000,0,0,0,4000,0,4000,4000
055416,欣興富邦98購01  ,0,0,0,0,0,0,0,0,0,4000,0,0,0,10000,6000,4000,4000
053024,國巨富邦97購02  ,0,0,0,0,0,0,0,0,0,4000,0,0,0,4000,0,4000,4000
052907,嘉澤國票97購01  ,0,0,0,0,0,0,0,0,0,4000,0,0,0,40000,36000,4000,4000
052318,友達元大98購01  ,0,0,0,0,0,0,0,0,0,4000,0,0,0,4000,0,4000,4000
053559,台積電國泰98購01,0,0,0,0,0,0,0,0,0,4000,0,0,0,4000,0,4000,4000
053474,聯發科元大97購06,0,0,0,0,0,0,0,0,0,4000,0,0,0,4000,0,4000,4000
056597,宏碁元富98購01  ,0,0,0,0,0,0,0,0,0,4000,0,0,0,4000,0,4000,4000
056011,矽力中信99購01  ,0,0,0,0,0,0,0,0,0,4000,0,0,0,9000,5000,4000,4000
056272,嘉澤統一99購01  ,0,0,0,0,0,0,0,0,0,4000,0,0,0,15000,11000,4000,4000
056275,國巨國泰98購04  ,0,0,0,0,0,0,0,0,0,4000,0,0,0,6000,2000,4000,4000
059299,欣興元富99購03  ,0,0,0,0,0,0,0,0,0,4000,0,0,0,4000,0,4000,4000
059344,長榮航凱基99購01,0,0,0,0,0,0,0,0,0,4000,0,0,0,46000,42000,4000,4000
059073,元油2X元大9C購14,0,0,0,0,0,0,0,0,0,4000,0,0,0,7000,3000,4000,4000
059137,電子類群益99購01,0,0,0,0,0,0,0,0,0,4000,0,0,0,4000,0,4000,4000
054307,高鐵凱基98購01  ,0,0,0,0,0,0,0,0,0,4000,0,0,0,14000,10000,4000,4000
055164,矽創元大98購01  ,0,0,0,0,0,0,0,0,0,4000,0,0,0,4000,0,4000,4000
054967,神達元大97購01  ,0,0,0,0,0,0,0,0,0,4000,0,0,0,4000,0,4000,4000
060407,南六國泰9C購01  ,0,0,0,0,0,0,0,0,0,4000,0,0,0,4000,0,4000,4000
060222,貿聯凱基9A購02  ,0,0,0,0,0,0,0,0,0,4000,0,0,0,33000,29000,4000,4000
057434,國巨國票99購03  ,0,0,0,0,0,0,0,0,0,4000,0,0,0,4000,0,4000,4000
057497,祥碩元大98購06  ,0,0,0,0,0,0,0,0,0,4000,0,0,0,4000,0,4000,4000
058743,可成康和99購01  ,0,0,0,0,0,0,0,0,0,4000,0,0,0,7000,3000,4000,4000
058576,南亞科群益99購01,0,0,0,0,0,0,0,0,0,4000,0,0,0,90000,86000,4000,4000
058172,國巨凱基9B購02  ,0,0,0,0,0,0,0,0,0,4000,0,0,0,4000,0,4000,4000
057669,嘉晶元大99購03  ,0,0,0,0,0,0,0,0,0,4000,0,0,0,5000,1000,4000,4000
057757,鴻海凱基98購13  ,0,0,0,0,0,0,0,0,0,4000,0,0,0,12000,8000,4000,4000
057975,台積電永豐98購05,0,0,0,0,0,0,0,0,0,4000,0,0,0,4000,0,4000,4000
058999,台積電元大99購24,0,0,0,0,0,0,0,0,0,4000,0,0,0,65000,61000,4000,4000
059284,緯穎永豐99購03  ,0,0,0,0,0,0,0,0,0,4000,0,0,0,6000,2000,4000,4000
059276,可成元大99購06  ,0,0,0,0,0,0,0,0,0,4000,0,0,0,16000,12000,4000,4000
059639,大立光凱基9A購06,0,0,0,0,0,0,0,0,0,4000,0,0,0,14000,10000,4000,4000
058856,新光金兆豐99購01,0,0,0,0,0,0,0,0,0,4000,0,0,0,4000,0,4000,4000
059696,立積永豐99購03  ,0,0,0,0,0,0,0,0,0,4000,0,0,0,4000,0,4000,4000
058080,台積電群益98購06,0,0,0,0,0,0,0,0,0,4000,0,0,0,9000,5000,4000,4000
057614,華新科元富99購04,0,0,0,0,0,0,0,0,0,4000,0,0,0,4000,0,4000,4000
057061,華擎國泰9A購01  ,0,0,0,0,0,0,0,0,0,4000,0,0,0,4000,0,4000,4000
057086,立積統一9C購01  ,0,0,0,0,0,0,0,0,0,4000,0,0,0,4000,0,4000,4000
056684,旺宏統一98購02  ,0,0,0,0,0,0,0,0,0,4000,0,0,0,74000,70000,4000,4000
05685P,臺股指元大96售10,0,0,0,0,0,0,0,0,0,4000,0,0,0,4000,0,4000,4000
061494,聯發科國票9A購04,0,0,0,0,0,0,0,0,0,4000,0,0,0,4000,0,4000,4000
061650,南電元大9A購07  ,0,0,0,0,0,0,0,0,0,4000,0,0,0,10000,6000,4000,4000
061657,智原國票9A購01  ,0,0,0,0,0,0,0,0,0,4000,0,0,0,28000,24000,4000,4000
061938,大立光國票9B購03,0,0,0,0,0,0,0,0,0,4000,0,0,0,4000,0,4000,4000
061930,臺股指凱基9B購05,0,0,0,0,0,0,0,0,0,4000,0,0,0,15000,11000,4000,4000
061251,臺股指群益9A購02,0,0,0,0,0,0,0,0,0,4000,0,0,0,14000,10000,4000,4000
061072,南電凱基9B購01  ,0,0,0,0,0,0,0,0,0,4000,0,0,0,4000,0,4000,4000
061086,FBVIX統一01購01 ,0,0,0,0,0,0,0,0,0,4000,0,0,0,4000,0,4000,4000
060899,超眾凱基9A購01  ,0,0,0,0,0,0,0,0,0,4000,0,0,0,20000,16000,4000,4000
060910,聯發科元大9A購05,0,0,0,0,0,0,0,0,0,4000,0,0,0,9000,5000,4000,4000
060601,技嘉凱基9A購02  ,0,0,0,0,0,0,0,0,0,4000,0,0,0,4000,0,4000,4000
060693,台積電麥證9A購02,0,0,0,4000,0,4000,0,0,0,4000,0,0,0,4000,0,4000,4000
062640,訊連國票9C購01  ,0,0,0,0,0,0,0,0,0,4000,0,0,0,4000,0,4000,4000
062697,國巨元大9C購01  ,0,0,0,0,0,0,0,0,0,4000,0,0,0,7000,3000,4000,4000
062306,華通凱基9B購01  ,0,0,0,0,0,0,0,0,0,4000,0,0,0,4000,0,4000,4000
062424,聯發科統一9C購08,0,0,0,0,0,0,0,0,0,4000,0,0,0,4000,0,4000,4000
062359,旺宏元大9C購02  ,0,0,0,0,0,0,0,0,0,4000,0,0,0,22000,18000,4000,4000
062223,大立光統一9C購04,0,0,0,0,0,0,0,0,0,4000,0,0,0,59000,55000,4000,4000
5284,jpp-KY          ,2000,0,2000,0,0,0,0,0,0,2000,2000,0,2000,0,0,0,4000
6205,詮欣            ,3000,0,3000,0,0,0,0,0,0,1000,1000,0,1000,0,0,0,4000
3622,洋華            ,4000,1000,3000,0,0,0,0,0,0,1000,1000,0,1000,0,0,0,4000
4104,佳醫            ,50000,47000,3000,0,0,0,0,0,0,1000,1000,0,1000,0,0,0,4000
3308,聯德            ,4000,0,4000,0,0,0,0,0,0,0,0,0,0,0,0,0,4000
2936,客思達-KY       ,4000,0,4000,0,0,0,0,0,0,0,0,0,0,0,0,0,4000
3296,勝德            ,1000,0,1000,0,0,0,0,0,0,3000,3000,0,3000,0,0,0,4000
9926,新海            ,4000,0,4000,0,0,0,0,0,0,0,0,0,0,0,0,0,4000
8488,吉源-KY         ,3000,0,3000,0,0,0,0,0,0,1000,1000,0,1000,0,0,0,4000
8222,寶一            ,3000,0,3000,0,0,0,0,0,0,1000,1000,0,1000,0,0,0,4000
06558P,旺宏元富98售02  ,0,0,0,0,0,0,0,0,0,3000,0,0,0,3000,0,3000,3000
07250P,台灣50永豐99售07,0,0,0,0,0,0,0,0,0,3000,0,0,0,3000,0,3000,3000
063329,健策國票9C購01  ,0,0,0,0,0,0,0,0,0,3000,0,0,0,3000,0,3000,3000
063564,台積電元大9B購07,0,0,0,0,0,0,0,0,0,3000,0,0,0,3000,0,3000,3000
07455P,聯發科元大9A售01,0,0,0,0,0,0,0,0,0,3000,0,0,0,3000,0,3000,3000
07965P,玉晶光群益01售02,0,0,0,0,0,0,0,0,0,3000,0,0,0,3000,0,3000,3000
07884P,華新科凱基9B售08,0,0,0,0,0,0,0,0,0,3000,0,0,0,61000,58000,3000,3000
08070P,晶技國泰9C售02  ,0,0,0,0,0,0,0,0,0,3000,0,0,0,63000,60000,3000,3000
1441,大東            ,3000,1000,2000,0,0,0,0,0,0,1000,1000,0,1000,0,0,0,3000
1456,怡華            ,2000,0,2000,0,0,0,0,0,0,1000,1000,0,1000,0,0,0,3000
1724,台硝            ,1000,0,1000,0,0,0,0,0,0,2000,2000,0,2000,0,0,0,3000
1776,展宇            ,1000,0,1000,0,0,0,0,0,0,2000,2000,0,2000,0,0,0,3000
1735,日勝化          ,2000,0,2000,0,0,0,0,0,0,1000,1000,0,1000,0,0,0,3000
1583,程泰            ,9000,6000,3000,0,0,0,0,0,0,0,0,0,0,0,0,0,3000
2243,宏旭-KY         ,4000,1000,3000,0,0,0,0,0,0,0,0,0,0,0,0,0,3000
2838A,聯邦銀甲特      ,0,0,0,0,0,0,0,0,0,3000,4000,1000,3000,0,0,0,3000
055060,聯陽永豐97購01  ,0,0,0,0,0,0,0,0,0,3000,0,0,0,9000,6000,3000,3000
055034,建準富邦99購01  ,0,0,0,0,0,0,0,0,0,3000,0,0,0,3000,0,3000,3000
055700,緯穎國泰98購02  ,0,0,0,0,0,0,0,0,0,3000,0,0,0,6000,3000,3000,3000
055794,聯發科國泰99購01,0,0,0,0,0,0,0,0,0,3000,0,0,0,3000,0,3000,3000
054584,貿聯元富97購01  ,0,0,0,0,0,0,0,0,0,3000,0,0,0,3000,0,3000,3000
059056,技嘉凱基99購02  ,0,0,0,0,0,0,0,0,0,3000,0,0,0,11000,8000,3000,3000
059361,玉晶光永豐99購04,0,0,0,0,0,0,0,0,0,3000,0,0,0,3000,0,3000,3000
055865,臺股指元大97購02,0,0,0,0,0,0,0,0,0,3000,0,0,0,3000,0,3000,3000
059532,華新科凱基9B購03,0,0,0,0,0,0,0,0,0,3000,0,0,0,28000,25000,3000,3000
055810,T50反1國票99購01,0,0,0,0,0,0,0,0,0,3000,0,0,0,15000,12000,3000,3000
055955,微星元大97購01  ,0,0,0,0,0,0,0,0,0,3000,0,0,0,3000,0,3000,3000
053621,臺股指群益96購07,0,0,0,0,0,0,0,0,0,3000,0,0,0,3000,0,3000,3000
053176,矽力群益96購02  ,0,0,0,0,0,0,0,0,0,3000,0,0,0,3000,0,3000,3000
052658,友達元富9C購01  ,0,0,0,0,0,0,0,0,0,3000,0,0,0,13000,10000,3000,3000
054238,聯茂群益96購04  ,0,0,0,0,0,0,0,0,0,3000,0,0,0,3000,0,3000,3000
052941,康控兆豐97購01  ,0,0,0,0,0,0,0,0,0,3000,0,0,0,3000,0,3000,3000
052618,群創國泰98購01  ,0,0,0,0,0,0,0,0,0,3000,0,0,0,3000,0,3000,3000
055398,超眾統一97購03  ,0,0,0,0,0,0,0,0,0,3000,0,0,0,231000,228000,3000,3000
055384,緯穎元大98購02  ,0,0,0,0,0,0,0,0,0,3000,0,0,0,19000,16000,3000,3000
051375,道瓊反群益9A購01,0,0,0,0,0,0,0,0,0,3000,0,0,0,3000,0,3000,3000
051082,上証2X元大98購01,0,0,0,0,0,0,0,0,0,3000,0,0,0,3000,0,3000,3000
050719,世紀鋼群益96購01,0,0,0,0,0,0,0,0,0,3000,0,0,0,3000,0,3000,3000
00702,國泰標普低波高息,0,3000,-3000,0,0,0,0,0,0,6000,0,0,0,6000,0,6000,3000
00684R,元大美元指數反1 ,0,0,0,0,0,0,0,0,0,3000,0,0,0,3000,0,3000,3000
050306,聯發科中信97購01,0,0,0,0,0,0,0,0,0,3000,0,0,0,3000,0,3000,3000
051843,聯發科富邦99購01,0,0,0,0,0,0,0,0,0,3000,0,0,0,3000,0,3000,3000
03675C,臺股指元大04牛02,0,0,0,0,0,0,0,0,0,3000,0,0,0,5000,2000,3000,3000
043513,台灣50元大96購05,0,0,0,0,0,0,0,0,0,3000,0,0,0,202000,199000,3000,3000
053800,華通凱基97購03  ,0,0,0,0,0,0,0,0,0,3000,0,0,0,42000,39000,3000,3000
053842,聯發科統一96購08,0,0,0,0,0,0,0,0,0,3000,0,0,0,303000,300000,3000,3000
059818,鴻海凱基99購14  ,0,0,0,0,0,0,0,0,0,3000,0,0,0,3000,0,3000,3000
056695,景碩群益99購01  ,0,0,0,0,0,0,0,0,0,3000,0,0,0,3000,0,3000,3000
057073,康控永豐98購01  ,0,0,0,0,0,0,0,0,0,3000,0,0,0,3000,0,3000,3000
057049,新日興元大98購02,0,0,0,0,0,0,0,0,0,3000,0,0,0,3000,0,3000,3000
059767,矽力永豐99購01  ,0,0,0,0,0,0,0,0,0,3000,0,0,0,10000,7000,3000,3000
059247,可成凱基99購05  ,0,0,0,0,0,0,0,0,0,3000,0,0,0,3000,0,3000,3000
059257,臺股指凱基99購35,0,0,0,0,0,0,0,0,0,3000,0,0,0,4000,1000,3000,3000
057165,國巨元大99購05  ,0,0,0,0,0,0,0,0,0,3000,0,0,0,17000,14000,3000,3000
058796,可成元大99購04  ,0,0,0,0,0,0,0,0,0,3000,0,0,0,4000,1000,3000,3000
058784,臺股指國票99購03,0,0,0,0,0,0,0,0,0,3000,0,0,0,4000,1000,3000,3000
057678,臺股指元大98購08,0,0,0,0,0,0,0,0,0,3000,0,0,0,3000,0,3000,3000
057697,國巨群益98購09  ,0,0,0,0,0,0,0,0,0,3000,0,0,0,3000,0,3000,3000
058669,上銀群益99購01  ,0,0,0,0,0,0,0,0,0,3000,0,0,0,9000,6000,3000,3000
058486,大立光國票9A購01,0,0,0,0,0,0,0,0,0,3000,0,0,0,3000,0,3000,3000
058482,祥碩凱基99購02  ,0,0,0,0,0,0,0,0,0,3000,0,0,0,3000,0,3000,3000
058377,茂林凱基9A購03  ,0,0,0,0,0,0,0,0,0,3000,0,0,0,46000,43000,3000,3000
058710,臺股指元大9A購23,0,0,0,0,0,0,0,0,0,3000,0,0,0,3000,0,3000,3000
058347,玉晶光群益9B購01,0,0,0,0,0,0,0,0,0,3000,0,0,0,5000,2000,3000,3000
058329,S&P正2元富01購01,0,0,0,0,0,0,0,0,0,3000,0,0,0,3000,0,3000,3000
057510,泰碩統一98購02  ,0,0,0,0,0,0,0,0,0,3000,0,0,0,3000,0,3000,3000
060930,超眾永豐9A購03  ,0,0,0,0,0,0,0,0,0,3000,0,0,0,3000,0,3000,3000
060077,台積電台新9B購01,0,0,0,0,0,0,0,0,0,3000,0,0,0,3000,0,3000,3000
060154,堤維西永豐9A購01,0,0,0,0,0,0,0,0,0,3000,0,0,0,27000,24000,3000,3000
060272,台灣50元大9C購25,0,0,0,0,0,0,0,0,0,3000,0,0,0,3000,0,3000,3000
060315,易華電永豐9A購01,0,0,0,0,0,0,0,0,0,3000,0,0,0,67000,64000,3000,3000
060398,立積國票9B購01  ,0,0,0,0,0,0,0,0,0,3000,0,0,0,7000,4000,3000,3000
062276,瑞昱群益9B購01  ,0,0,0,0,0,0,0,0,0,3000,0,0,0,3000,0,3000,3000
06214P,國巨國票98售04  ,0,0,0,0,0,0,0,0,0,3000,0,0,0,3000,0,3000,3000
062123,台積電統一9B購13,0,0,0,0,0,0,0,0,0,3000,0,0,0,3000,0,3000,3000
062116,元金2X第一9B購01,0,0,0,0,0,0,0,0,0,3000,0,0,0,5000,2000,3000,3000
062088,緯穎元大9B購04  ,0,0,0,0,0,0,0,0,0,3000,0,0,0,25000,22000,3000,3000
062298,國巨第一9B購01  ,0,0,0,0,0,0,0,0,0,3000,0,0,0,3000,0,3000,3000
062736,漢唐國票9B購01  ,0,0,0,0,0,0,0,0,0,3000,0,0,0,3000,0,3000,3000
062618,祥碩元大9B購04  ,0,0,0,0,0,0,0,0,0,3000,0,0,0,3000,0,3000,3000
062905,聯發科元大9B購13,0,0,0,0,0,0,0,0,0,3000,0,0,0,42000,39000,3000,3000
063112,祥碩兆豐9B購01  ,0,0,0,0,0,0,0,0,0,3000,0,0,0,5000,2000,3000,3000
060656,國巨統一9C購03  ,0,0,0,0,0,0,0,0,0,3000,0,0,0,3000,0,3000,3000
060638,玉晶光永豐9A購04,0,0,0,0,0,0,0,0,0,3000,0,0,0,156000,153000,3000,3000
060532,欣興中信9A購01  ,0,0,0,0,0,0,0,0,0,3000,0,0,0,3000,0,3000,3000
06165P,臺股指凱基9A售03,0,0,0,0,0,0,0,0,0,3000,0,0,0,5000,2000,3000,3000
061368,南六國票9A購01  ,0,0,0,0,0,0,0,0,0,3000,0,0,0,121000,118000,3000,3000
8427,基勝-KY         ,3000,0,3000,0,0,0,0,0,0,0,0,0,0,0,0,0,3000
9902,台火            ,4000,2000,2000,0,0,0,0,0,0,1000,1000,0,1000,0,0,0,3000
8033,雷虎            ,6000,3000,3000,0,0,0,0,0,0,0,0,0,0,0,0,0,3000
8072,陞泰            ,2000,0,2000,0,0,0,0,0,0,1000,1000,0,1000,0,0,0,3000
6243,迅杰            ,6000,3000,3000,0,0,0,0,0,0,0,0,0,0,0,0,0,3000
3054,立萬利          ,3000,0,3000,0,0,0,0,0,0,0,0,0,0,0,0,0,3000
3025,星通            ,4000,3000,1000,0,0,0,0,0,0,2000,2000,0,2000,0,0,0,3000
3550,聯穎            ,1000,0,1000,0,0,0,0,0,0,2000,2000,0,2000,0,0,0,3000
3593,力銘            ,3000,0,3000,0,0,0,0,0,0,0,0,0,0,0,0,0,3000
6133,金橋            ,2000,0,2000,0,0,0,0,0,0,1000,1000,0,1000,0,0,0,3000
4439,冠星-KY         ,3000,0,3000,0,0,0,0,0,0,0,0,0,0,0,0,0,3000
2891B,中信金乙特      ,0,0,0,0,0,0,0,0,0,2000,2000,0,2000,0,0,0,2000
2630,亞航            ,2000,0,2000,0,0,0,0,0,0,0,0,0,0,0,0,0,2000
2540,愛山林          ,2000,2000,0,0,0,0,0,0,0,2000,2000,0,2000,0,0,0,2000
1470,大統新創        ,2000,0,2000,0,0,0,0,0,0,0,0,0,0,0,0,0,2000
1530,亞崴            ,1000,0,1000,0,0,0,0,0,0,1000,1000,0,1000,0,0,0,2000
1558,伸興            ,28000,28000,0,0,0,0,0,0,0,2000,2000,0,2000,0,0,0,2000
1535,中宇            ,3000,1000,2000,0,0,0,0,0,0,0,0,0,0,0,0,0,2000
1732,毛寶            ,224000,221000,3000,0,0,0,0,0,0,-1000,3000,4000,-1000,0,0,0,2000
1443,立益            ,2000,0,2000,0,0,0,0,0,0,0,0,0,0,0,0,0,2000
1235,興泰            ,1000,0,1000,0,0,0,0,0,0,1000,1000,0,1000,0,0,0,2000
1236,宏亞            ,3000,1000,2000,0,0,0,0,0,0,0,1000,1000,0,0,0,0,2000
1324,地球            ,1000,0,1000,0,0,0,0,0,0,1000,1000,0,1000,0,0,0,2000
1220,台榮            ,2000,0,2000,0,0,0,0,0,0,0,0,0,0,0,0,0,2000
1101B,台泥乙特        ,0,0,0,0,0,0,0,0,0,2000,2000,0,2000,0,0,0,2000
08081P,台灣50元大9B售20,0,0,0,0,0,0,0,0,0,2000,0,0,0,2000,0,2000,2000
08144P,臺股指凱基02售03,0,0,0,0,0,0,0,0,0,2000,0,0,0,2000,0,2000,2000
08173P,金像電凱基9B售02,0,0,0,0,0,0,0,0,0,2000,0,0,0,10000,8000,2000,2000
07855P,旺宏凱基9A售09  ,0,0,0,0,0,0,0,0,0,2000,0,0,0,11000,9000,2000,2000
07848P,旺宏群益9B售01  ,0,0,0,0,0,0,0,0,0,2000,0,0,0,2000,0,2000,2000
07487P,鴻海國票9A售01  ,0,0,0,0,0,0,0,0,0,2000,0,0,0,5000,3000,2000,2000
07349P,大立光凱基99售16,0,0,0,0,0,0,0,0,0,2000,0,0,0,2000,0,2000,2000
07394P,國巨群益99售12  ,0,0,0,0,0,0,0,0,0,2000,0,0,0,2000,0,2000,2000
07674P,金融類元大9A售01,0,0,0,0,0,0,0,0,0,2000,0,0,0,3000,1000,2000,2000
07665P,台灣50元大9C售31,0,0,0,0,0,0,0,0,0,2000,0,0,0,2000,0,2000,2000
06362P,臺股指麥證97售01,0,0,0,2000,0,2000,0,0,0,2000,0,0,0,2000,0,2000,2000
063361,台表科國泰01購02,0,0,0,0,0,0,0,0,0,2000,0,0,0,96000,94000,2000,2000
063509,超眾群益9B購03  ,0,0,0,0,0,0,0,0,0,2000,0,0,0,27000,25000,2000,2000
07244P,鴻海凱基9A售13  ,0,0,0,0,0,0,0,0,0,2000,0,0,0,2000,0,2000,2000
07245P,台積電凱基99售16,0,0,0,0,0,0,0,0,0,2000,0,0,0,3000,1000,2000,2000
07281P,鴻海凱基99售13  ,0,0,0,0,0,0,0,0,0,2000,0,0,0,2000,0,2000,2000
07217P,大立光凱基9A售05,0,0,0,0,0,0,0,0,0,2000,0,0,0,2000,0,2000,2000
07207P,台積電凱基99售13,0,0,0,0,0,0,0,0,0,2000,0,0,0,2000,0,2000,2000
07163P,臺股指群益99售14,0,0,0,0,0,0,0,0,0,2000,0,0,0,49000,47000,2000,2000
07068P,欣興台新99售01  ,0,0,0,0,0,0,0,0,0,2000,0,0,0,2000,0,2000,2000
07055P,景碩群益9A售02  ,0,0,0,0,0,0,0,0,0,2000,0,0,0,9000,7000,2000,2000
06985P,華新科富邦9C售02,0,0,0,0,0,0,0,0,0,2000,0,0,0,2000,0,2000,2000
06825P,臺股指國票98售01,0,0,0,0,0,0,0,0,0,2000,0,0,0,3000,1000,2000,2000
06865P,亞德客元大98售04,0,0,0,0,0,0,0,0,0,2000,0,0,0,2000,0,2000,2000
053783,聯發科元大96購17,0,0,0,0,0,0,0,0,0,2000,0,0,0,2000,0,2000,2000
053732,S&P反1中信9C購01,0,0,0,0,0,0,0,0,0,2000,0,0,0,2000,0,2000,2000
03676C,臺股指元大04牛03,0,0,0,0,0,0,0,0,0,2000,0,0,0,2000,0,2000,2000
044864,道瓊反國票96購01,0,0,0,0,0,0,0,0,0,2000,0,0,0,2000,0,2000,2000
047483,新光金凱基99購04,0,0,0,0,0,0,0,0,0,2000,0,0,0,2000,0,2000,2000
051919,台郡元大96購02  ,0,0,0,0,0,0,0,0,0,2000,0,0,0,2000,0,2000,2000
051749,矽力國泰97購01  ,0,0,0,0,0,0,0,0,0,2000,0,0,0,2000,0,2000,2000
053921,嘉晶國票97購03  ,0,0,0,0,0,0,0,0,0,2000,0,0,0,2000,0,2000,2000
053994,微星群益96購01  ,0,0,0,0,0,0,0,0,0,2000,0,0,0,2000,0,2000,2000
0057,富邦摩台        ,0,0,0,0,0,0,0,0,0,2000,0,0,0,24000,22000,2000,2000
00710B,FH彭博高收益債  ,0,0,0,0,0,0,0,0,0,2000,0,0,0,50000,48000,2000,2000
03013X,元展13          ,0,0,0,0,0,0,0,0,0,2000,0,0,0,3000,1000,2000,2000
03039X,元展36          ,0,0,0,0,0,0,0,0,0,2000,0,0,0,2000,0,2000,2000
053098,國巨元富96購04  ,0,0,0,0,0,0,0,0,0,2000,0,0,0,2000,0,2000,2000
053640,上緯控永豐96購01,0,0,0,0,0,0,0,0,0,2000,0,0,0,2000,0,2000,2000
056399,上証2X群益9C購01,0,0,0,0,0,0,0,0,0,2000,0,0,0,2000,0,2000,2000
05637P,聯電元大96售04  ,0,0,0,0,0,0,0,0,0,2000,0,0,0,22000,20000,2000,2000
054293,健策元大98購02  ,0,0,0,0,0,0,0,0,0,2000,0,0,0,2000,0,2000,2000
056660,臺股指元大9A購07,0,0,0,0,0,0,0,0,0,2000,0,0,0,2000,0,2000,2000
053382,友達元大9C購02  ,0,0,0,0,0,0,0,0,0,2000,0,0,0,2000,0,2000,2000
053562,玉晶光國泰98購02,0,0,0,0,0,0,0,0,0,2000,0,0,0,11000,9000,2000,2000
055804,祥碩永豐97購02  ,0,0,0,0,0,0,0,0,0,2000,0,0,0,21000,19000,2000,2000
055854,群創元大98購04  ,0,0,0,0,0,0,0,0,0,2000,0,0,0,2000,0,2000,2000
05930P,景碩康和96售01  ,0,0,0,0,0,0,0,0,0,2000,0,0,0,2000,0,2000,2000
059138,台積電兆豐99購04,0,0,0,0,0,0,0,0,0,2000,0,0,0,2000,0,2000,2000
059081,和大元大99購01  ,0,0,0,0,0,0,0,0,0,2000,0,0,0,2000,0,2000,2000
05912P,和大元大96售01  ,0,0,0,0,0,0,0,0,0,2000,0,0,0,2000,0,2000,2000
054516,國巨元大97購02  ,0,0,0,0,0,0,0,0,0,2000,0,0,0,2000,0,2000,2000
054495,滬深2X永豐97購02,0,0,0,0,0,0,0,0,0,2000,0,0,0,2000,0,2000,2000
056431,鴻海凱基98購07  ,0,0,0,0,0,0,0,0,0,2000,0,0,0,2000,0,2000,2000
054785,建準群益98購01  ,0,0,0,0,0,0,0,0,0,2000,0,0,0,124000,122000,2000,2000
056567,瀚宇博群益98購02,0,0,0,0,0,0,0,0,0,2000,0,0,0,203000,201000,2000,2000
055309,冠德群益97購01  ,0,0,0,0,0,0,0,0,0,2000,0,0,0,2000,0,2000,2000
054627,義隆凱基98購01  ,0,0,0,0,0,0,0,0,0,2000,0,0,0,43000,41000,2000,2000
054641,祥碩中信98購01  ,0,0,0,0,0,0,0,0,0,2000,0,0,0,2000,0,2000,2000
055157,晶豪科元大97購01,0,0,0,0,0,0,0,0,0,2000,0,0,0,2000,0,2000,2000
06094P,台達電中信97售01,0,0,0,0,0,0,0,0,0,2000,0,0,0,2000,0,2000,2000
058717,南電台新99購02  ,0,0,0,0,0,0,0,0,0,2000,0,0,0,2000,0,2000,2000
058414,大立光兆豐99購02,0,0,0,0,0,0,0,0,0,2000,0,0,0,2000,0,2000,2000
058557,健策第一01購01  ,0,0,0,0,0,0,0,0,0,2000,0,0,0,2000,0,2000,2000
058542,T50反1富邦9B購01,0,0,0,0,0,0,0,0,0,2000,0,0,0,2000,0,2000,2000
057694,臺股指凱基98購12,0,0,0,0,0,0,0,0,0,2000,0,0,0,2000,0,2000,2000
057844,新日興永豐99購01,0,0,0,0,0,0,0,0,0,2000,0,0,0,23000,21000,2000,2000
057832,聯發科元富02購05,0,0,0,0,0,0,0,0,0,2000,0,0,0,2000,0,2000,2000
057581,元大金中信9A購01,0,0,0,0,0,0,0,0,0,2000,0,0,0,216000,214000,2000,2000
057583,啟碁中信9A購01  ,0,0,0,0,0,0,0,0,0,2000,0,0,0,32000,30000,2000,2000
057566,欣興富邦99購01  ,0,0,0,0,0,0,0,0,0,2000,0,0,0,2000,0,2000,2000
057908,國泰金亞東99購01,0,0,0,0,0,0,0,0,0,2000,0,0,0,2000,0,2000,2000
059234,台灣50凱基9C購03,0,0,0,0,0,0,0,0,0,2000,0,0,0,2000,0,2000,2000
059274,國巨元大99購22  ,0,0,0,0,0,0,0,0,0,2000,0,0,0,2000,0,2000,2000
059780,滬深2X元大9C購06,0,0,0,0,0,0,0,0,0,2000,0,0,0,2000,0,2000,2000
059619,台積電日盛9A購04,0,0,0,0,0,0,0,0,0,2000,0,0,0,7000,5000,2000,2000
05890P,彩晶元大99售01  ,0,0,0,0,0,0,0,0,0,2000,0,0,0,2000,0,2000,2000
057214,瑞昱群益98購01  ,0,0,0,0,0,0,0,0,0,2000,0,0,0,2000,0,2000,2000
057001,華邦電國票99購02,0,0,0,0,0,0,0,0,0,2000,0,0,0,2000,0,2000,2000
059831,聯詠康和99購01  ,0,0,0,0,0,0,0,0,0,2000,0,0,0,4000,2000,2000,2000
059899,上証2X元大9C購04,0,0,0,0,0,0,0,0,0,2000,0,0,0,2000,0,2000,2000
059887,華新科國票99購02,0,0,0,0,0,0,0,0,0,2000,0,0,0,2000,0,2000,2000
05682P,大立光元大98售03,0,0,0,0,0,0,0,0,0,2000,0,0,0,2000,0,2000,2000
056907,群創元大9C購04  ,0,0,0,0,0,0,0,0,0,2000,0,0,0,2000,0,2000,2000
056929,華新科台新98購01,0,0,0,0,0,0,0,0,0,2000,0,0,0,2000,0,2000,2000
060029,嘉晶永豐99購03  ,0,0,0,0,0,0,0,0,0,2000,0,0,0,12000,10000,2000,2000
061392,泰鼎群益9A購02  ,0,0,0,0,0,0,0,0,0,2000,0,0,0,2000,0,2000,2000
061315,滬深2X凱基9C購06,0,0,0,0,0,0,0,0,0,2000,0,0,0,2000,0,2000,2000
060551,大立光凱基9B購02,0,0,0,0,0,0,0,0,0,2000,0,0,0,4000,2000,2000,2000
060558,億豐凱基9A購01  ,0,0,0,0,0,0,0,0,0,2000,0,0,0,2000,0,2000,2000
060663,聯發科凱基9A購13,0,0,0,0,0,0,0,0,0,2000,0,0,0,2000,0,2000,2000
060838,華通國票9A購05  ,0,0,0,0,0,0,0,0,0,2000,0,0,0,2000,0,2000,2000
060839,聯發科國票9A購02,0,0,0,0,0,0,0,0,0,2000,0,0,0,2000,0,2000,2000
060844,大立光國票9A購07,0,0,0,0,0,0,0,0,0,2000,0,0,0,2000,0,2000,2000
061235,台積電元大9A購23,0,0,0,0,0,0,0,0,0,2000,0,0,0,2000,0,2000,2000
061148,道瓊反群益9A購02,0,0,0,0,0,0,0,0,0,2000,0,0,0,2000,0,2000,2000
062932,滬深2X凱基01購01,0,0,0,0,0,0,0,0,0,2000,0,0,0,2000,0,2000,2000
062620,台表科元大9B購04,0,0,0,0,0,0,0,0,0,2000,0,0,0,52000,50000,2000,2000
062289,緯穎群益9B購01  ,0,0,0,0,0,0,0,0,0,2000,0,0,0,2000,0,2000,2000
062347,台光電群益9B購02,0,0,0,0,0,0,0,0,0,2000,0,0,0,2000,0,2000,2000
062059,聯發科統一9C購06,0,0,0,0,0,0,0,0,0,2000,0,0,0,2000,0,2000,2000
061982,聯發科元大9B購03,0,0,0,0,0,0,0,0,0,2000,0,0,0,2000,0,2000,2000
061952,臺股指群益9B購01,0,0,0,0,0,0,0,0,0,2000,0,0,0,2000,0,2000,2000
062169,禾伸堂永豐9B購01,0,0,0,0,0,0,0,0,0,2000,0,0,0,2000,0,2000,2000
062193,瑞昱第一9B購01  ,0,0,0,0,0,0,0,0,0,2000,0,0,0,9000,7000,2000,2000
4562,穎漢            ,1000,0,1000,0,0,0,0,0,0,1000,1000,0,1000,0,0,0,2000
4557,永新-KY         ,1000,0,1000,0,0,0,0,0,0,1000,1000,0,1000,0,0,0,2000
6136,富爾特          ,4000,2000,2000,0,0,0,0,0,0,0,0,0,0,0,0,0,2000
6117,迎廣            ,2000,0,2000,0,0,0,0,0,0,0,0,0,0,0,0,0,2000
6201,亞弘電          ,2000,0,2000,0,0,0,0,0,0,0,0,0,0,0,0,0,2000
9929,秋雨            ,2000,0,2000,0,0,0,0,0,0,0,0,0,0,0,0,0,2000
9924,福興            ,68000,69000,-1000,0,0,0,0,0,0,3000,3000,0,3000,0,0,0,2000
9931,欣高            ,2000,0,2000,0,0,0,0,0,0,0,0,0,0,0,0,0,2000
9935,慶豐富          ,137000,137000,0,0,0,0,0,0,0,2000,2000,0,2000,0,0,0,2000
06886P,旺宏元大99售07  ,0,0,0,0,0,0,0,0,0,1000,0,0,0,4000,3000,1000,1000
06827P,臺股指國票98售03,0,0,0,0,0,0,0,0,0,1000,0,0,0,1000,0,1000,1000
06813P,友訊元富98售03  ,0,0,0,0,0,0,0,0,0,1000,0,0,0,1000,0,1000,1000
07012P,智邦群益9A售01  ,0,0,0,0,0,0,0,0,0,1000,0,0,0,1000,0,1000,1000
06970P,旺宏元大99售08  ,0,0,0,0,0,0,0,0,0,1000,0,0,0,1000,0,1000,1000
06983P,台積電國泰9A售02,0,0,0,0,0,0,0,0,0,1000,0,0,0,1000,0,1000,1000
07219P,臺股指凱基99售32,0,0,0,0,0,0,0,0,0,1000,0,0,0,11000,10000,1000,1000
07264P,台積電元大99售38,0,0,0,0,0,0,0,0,0,1000,0,0,0,1000,0,1000,1000
06640P,國巨兆豐99售02  ,0,0,0,0,0,0,0,0,0,1000,0,0,0,1000,0,1000,1000
06436P,台光電國票98售04,0,0,0,0,0,0,0,0,0,1000,0,0,0,1000,0,1000,1000
063446,台光電統一01購02,0,0,0,0,0,0,0,0,0,1000,0,0,0,57000,56000,1000,1000
063440,上銀統一01購02  ,0,0,0,0,0,0,0,0,0,1000,0,0,0,25000,24000,1000,1000
063266,聯發科第一9B購01,0,0,0,0,0,0,0,0,0,1000,0,0,0,1000,0,1000,1000
063663,台光電統一9C購01,0,0,0,0,0,0,0,0,0,1000,0,0,0,87000,86000,1000,1000
07367P,鴻海凱基99售17  ,0,0,0,0,0,0,0,0,0,1000,0,0,0,1000,0,1000,1000
07343P,高鐵康和99售01  ,0,0,0,0,0,0,0,0,0,1000,0,0,0,1000,0,1000,1000
07335P,臺股指國票99售20,0,0,0,0,0,0,0,0,0,1000,0,0,0,1000,0,1000,1000
07430P,臺股指國票9A售02,0,0,0,0,0,0,0,0,0,1000,0,0,0,1000,0,1000,1000
07432P,臺股指國票9A售04,0,0,0,0,0,0,0,0,0,1000,0,0,0,1000,0,1000,1000
07889P,旭富國票9B售01  ,0,0,0,0,0,0,0,0,0,1000,0,0,0,116000,115000,1000,1000
07991P,鴻海群益9C售02  ,0,0,0,0,0,0,0,0,0,1000,0,0,0,1000,0,1000,1000
08261P,玉晶光元大9C售08,0,0,0,0,0,0,0,0,0,1000,0,0,0,4000,3000,1000,1000
08229P,祥碩國票9B售04  ,0,0,0,0,0,0,0,0,0,1000,0,0,0,31000,30000,1000,1000
1413,宏洲            ,1000,0,1000,0,0,0,0,0,0,0,0,0,0,0,0,0,1000
1516,川飛            ,4000,3000,1000,0,0,0,0,0,0,0,0,0,0,0,0,0,1000
1539,巨庭            ,0,0,0,0,0,0,0,0,0,1000,1000,0,1000,0,0,0,1000
2488,漢平            ,7000,8000,-1000,0,0,0,0,0,0,2000,2000,0,2000,0,0,0,1000
2901,欣欣            ,0,0,0,0,0,0,0,0,0,1000,1000,0,1000,0,0,0,1000
2236,百達-KY         ,0,0,0,0,0,0,0,0,0,1000,1000,0,1000,0,0,0,1000
2443,億麗            ,10000,9000,1000,0,0,0,0,0,0,0,0,0,0,0,0,0,1000
2465,麗臺            ,1000,0,1000,0,0,0,0,0,0,0,0,0,0,0,0,0,1000
054924,景碩凱基98購01  ,0,0,0,0,0,0,0,0,0,1000,0,0,0,1000,0,1000,1000
054643,上証2X群益9B購01,0,0,0,0,0,0,0,0,0,1000,0,0,0,1000,0,1000,1000
054656,深中小元大97購01,0,0,0,0,0,0,0,0,0,1000,0,0,0,181000,180000,1000,1000
054623,華新科第一97購01,0,0,0,0,0,0,0,0,0,1000,0,0,0,1000,0,1000,1000
055739,健鼎元富97購01  ,0,0,0,0,0,0,0,0,0,1000,0,0,0,1000,0,1000,1000
054345,世芯國票96購02  ,0,0,0,0,0,0,0,0,0,1000,0,0,0,1000,0,1000,1000
054532,強茂國泰98購01  ,0,0,0,0,0,0,0,0,0,1000,0,0,0,20000,19000,1000,1000
054580,樺漢元大98購01  ,0,0,0,0,0,0,0,0,0,1000,0,0,0,1000,0,1000,1000
059178,臺股指凱基99購30,0,0,0,0,0,0,0,0,0,1000,0,0,0,1000,0,1000,1000
059145,創意國票99購02  ,0,0,0,0,0,0,0,0,0,1000,0,0,0,1000,0,1000,1000
055861,矽力元大97購03  ,0,0,0,0,0,0,0,0,0,1000,0,0,0,1000,0,1000,1000
059319,台光電元大99購04,0,0,0,0,0,0,0,0,0,1000,0,0,0,1000,0,1000,1000
059531,華新科凱基9B購02,0,0,0,0,0,0,0,0,0,1000,0,0,0,2000,1000,1000,1000
059515,牧德永豐99購01  ,0,0,0,0,0,0,0,0,0,1000,0,0,0,1000,0,1000,1000
056659,泰碩元大99購01  ,0,0,0,0,0,0,0,0,0,1000,0,0,0,1000,0,1000,1000
056292,統一元大97購01  ,0,0,0,0,0,0,0,0,0,1000,0,0,0,1000,0,1000,1000
056176,創意元富97購01  ,0,0,0,0,0,0,0,0,0,1000,0,0,0,1000,0,1000,1000
056192,智邦富邦98購01  ,0,0,0,0,0,0,0,0,0,1000,0,0,0,1000,0,1000,1000
05593P,鴻海國票97售03  ,0,0,0,0,0,0,0,0,0,1000,0,0,0,1000,0,1000,1000
056048,同欣電兆豐97購01,0,0,0,0,0,0,0,0,0,1000,0,0,0,1000,0,1000,1000
056122,勤誠群益97購02  ,0,0,0,0,0,0,0,0,0,1000,0,0,0,1000,0,1000,1000
053509,華新群益98購01  ,0,0,0,0,0,0,0,0,0,1000,0,0,0,1000,0,1000,1000
053585,友達元大9C購03  ,0,0,0,0,0,0,0,0,0,1000,0,0,0,2000,1000,1000,1000
053466,華通元大98購01  ,0,0,0,0,0,0,0,0,0,1000,0,0,0,1000,0,1000,1000
053388,群創元大9C購02  ,0,0,0,0,0,0,0,0,0,1000,0,0,0,1000,0,1000,1000
053449,超眾凱基98購01  ,0,0,0,0,0,0,0,0,0,1000,0,0,0,174000,173000,1000,1000
052915,創意元富96購01  ,0,0,0,0,0,0,0,0,0,1000,0,0,0,1000,0,1000,1000
052328,台表科中信99購01,0,0,0,0,0,0,0,0,0,1000,0,0,0,1000,0,1000,1000
052385,滬深2X群益99購05,0,0,0,0,0,0,0,0,0,1000,0,0,0,1000,0,1000,1000
056360,智邦元大98購01  ,0,0,0,0,0,0,0,0,0,1000,0,0,0,1000,0,1000,1000
056341,宏達電凱基9A購01,0,0,0,0,0,0,0,0,0,1000,0,0,0,1000,0,1000,1000
055559,大立光凱基97購09,0,0,0,0,0,0,0,0,0,1000,0,0,0,1000,0,1000,1000
055357,欣興凱基97購04  ,0,0,0,0,0,0,0,0,0,1000,0,0,0,1000,0,1000,1000
055434,樺漢群益97購01  ,0,0,0,0,0,0,0,0,0,1000,0,0,0,1000,0,1000,1000
03047X,元展44          ,0,0,0,0,0,0,0,0,0,1000,0,0,0,1000,0,1000,1000
03014X,元展14          ,0,0,0,0,0,0,0,0,0,1000,0,0,0,1000,0,1000,1000
051578,智邦元大96購01  ,0,0,0,0,0,0,0,0,0,1000,0,0,0,2000,1000,1000,1000
051603,深中小群益99購03,0,0,0,0,0,0,0,0,0,1000,0,0,0,1000,0,1000,1000
020002,元富新中國N     ,0,0,0,0,0,0,0,0,0,1000,0,0,0,1000,0,1000,1000
03006X,元展06          ,0,0,0,0,0,0,0,0,0,1000,0,0,0,1000,0,1000,1000
051661,華新科永昌96購01,0,0,0,0,0,0,0,0,0,1000,0,0,0,31000,30000,1000,1000
054106,元油反凱基9C購01,0,0,0,0,0,0,0,0,0,1000,0,0,0,1000,0,1000,1000
051830,健策元大97購01  ,0,0,0,0,0,0,0,0,0,1000,0,0,0,2000,1000,1000,1000
051934,緯穎國票96購01  ,0,0,0,0,0,0,0,0,0,1000,0,0,0,1000,0,1000,1000
042692,台灣50凱基96購09,0,0,0,0,0,0,0,0,0,1000,0,0,0,1000,0,1000,1000
045054,聯發科元富98購02,0,0,0,0,0,0,0,0,0,1000,0,0,0,1000,0,1000,1000
056916,台達電兆豐98購02,0,0,0,0,0,0,0,0,0,1000,0,0,0,1000,0,1000,1000
056881,台灣50康和9A購01,0,0,0,0,0,0,0,0,0,1000,0,0,0,1000,0,1000,1000
056844,欣興元富98購03  ,0,0,0,0,0,0,0,0,0,1000,0,0,0,1000,0,1000,1000
05684P,臺股指元大96售09,0,0,0,0,0,0,0,0,0,1000,0,0,0,1000,0,1000,1000
059901,滬深2X元大9C購07,0,0,0,0,0,0,0,0,0,1000,0,0,0,2000,1000,1000,1000
059903,S&P正2元大99購02,0,0,0,0,0,0,0,0,0,1000,0,0,0,1000,0,1000,1000
059822,聯發科凱基99購19,0,0,0,0,0,0,0,0,0,1000,0,0,0,1000,0,1000,1000
059811,高股息凱基99購02,0,0,0,0,0,0,0,0,0,1000,0,0,0,1000,0,1000,1000
059856,昇陽半永豐99購03,0,0,0,0,0,0,0,0,0,1000,0,0,0,5000,4000,1000,1000
056694,欣興群益98購04  ,0,0,0,0,0,0,0,0,0,1000,0,0,0,60000,59000,1000,1000
05762P,昇陽半永豐96售04,0,0,0,0,0,0,0,0,0,1000,0,0,0,1000,0,1000,1000
058090,聯發科元大98購16,0,0,0,0,0,0,0,0,0,1000,0,0,0,1000,0,1000,1000
058133,華新科元大9A購02,0,0,0,0,0,0,0,0,0,1000,0,0,0,11000,10000,1000,1000
058120,台灣50國票99購03,0,0,0,0,0,0,0,0,0,1000,0,0,0,1000,0,1000,1000
05736P,臺股指統一96售06,0,0,0,0,0,0,0,0,0,1000,0,0,0,1000,0,1000,1000
05732P,臺股指統一96售02,0,0,0,0,0,0,0,0,0,1000,0,0,0,1000,0,1000,1000
059427,國巨元大99購24  ,0,0,0,0,0,0,0,0,0,1000,0,0,0,1000,0,1000,1000
058032,大立光永豐98購05,0,0,0,0,0,0,0,0,0,1000,0,0,0,11000,10000,1000,1000
058915,SGBR2X元富99購01,0,0,0,0,0,0,0,0,0,1000,0,0,0,1000,0,1000,1000
059787,奇力新元大9A購02,0,0,0,0,0,0,0,0,0,1000,0,0,0,1000,0,1000,1000
059748,聯發科台新99購03,0,0,0,0,0,0,0,0,0,1000,0,0,0,1000,0,1000,1000
059704,聯發科凱基9A購08,0,0,0,0,0,0,0,0,0,1000,0,0,0,1000,0,1000,1000
059617,A50正2群益01購02,0,0,0,0,0,0,0,0,0,1000,0,0,0,1000,0,1000,1000
058782,臺股指國票99購01,0,0,0,0,0,0,0,0,0,1000,0,0,0,51000,50000,1000,1000
058971,台積電永豐99購03,0,0,0,0,0,0,0,0,0,1000,0,0,0,1000,0,1000,1000
059591,台積電元大9A購04,0,0,0,0,0,0,0,0,0,1000,0,0,0,1000,0,1000,1000
057899,台積電永豐98購04,0,0,0,0,0,0,0,0,0,1000,0,0,0,1000,0,1000,1000
057876,隆達元大98購01  ,0,0,0,0,0,0,0,0,0,1000,0,0,0,6000,5000,1000,1000
058186,聯發科永豐99購01,0,0,0,0,0,0,0,0,0,1000,0,0,0,1000,0,1000,1000
057834,聯發科元富02購07,0,0,0,0,0,0,0,0,0,1000,0,0,0,1000,0,1000,1000
057831,聯發科元富02購04,0,0,0,0,0,0,0,0,0,1000,0,0,0,1000,0,1000,1000
057756,瑞昱日盛99購01  ,0,0,0,0,0,0,0,0,0,1000,0,0,0,1000,0,1000,1000
057709,電子類群益98購01,0,0,0,0,0,0,0,0,0,1000,0,0,0,1000,0,1000,1000
058558,鴻海日盛9A購02  ,0,0,0,0,0,0,0,0,0,1000,0,0,0,1000,0,1000,1000
058638,矽力兆豐99購01  ,0,0,0,0,0,0,0,0,0,1000,0,0,0,1000,0,1000,1000
058612,健策元大99購02  ,0,0,0,0,0,0,0,0,0,1000,0,0,0,1000,0,1000,1000
058609,玉山金元大99購01,0,0,0,0,0,0,0,0,0,1000,0,0,0,1000,0,1000,1000
058412,聯發科兆豐99購01,0,0,0,0,0,0,0,0,0,1000,0,0,0,1000,0,1000,1000
057382,聯發科國泰9A購01,0,0,0,0,0,0,0,0,0,1000,0,0,0,1000,0,1000,1000
058452,義隆永豐99購02  ,0,0,0,0,0,0,0,0,0,1000,0,0,0,1000,0,1000,1000
058386,A50正2國票9B購01,0,0,0,0,0,0,0,0,0,1000,0,0,0,1000,0,1000,1000
058737,鴻海第一01購01  ,0,0,0,0,0,0,0,0,0,1000,0,0,0,20000,19000,1000,1000
060088,國巨元大99購30  ,0,0,0,0,0,0,0,0,0,1000,0,0,0,1000,0,1000,1000
058340,高股息群益99購01,0,0,0,0,0,0,0,0,0,1000,0,0,0,1000,0,1000,1000
058359,瑞昱凱基99購01  ,0,0,0,0,0,0,0,0,0,1000,0,0,0,1000,0,1000,1000
057488,聯發科元大99購02,0,0,0,0,0,0,0,0,0,1000,0,0,0,1000,0,1000,1000
060408,和潤國泰9C購01  ,1000,0,1000,0,0,0,0,0,0,0,0,0,0,10000,10000,0,1000
060301,國巨富邦9C購02  ,0,0,0,0,0,0,0,0,0,1000,0,0,0,1000,0,1000,1000
060294,嘉澤元大9A購01  ,0,0,0,0,0,0,0,0,0,1000,0,0,0,1000,0,1000,1000
060264,華新科國票9A購02,0,0,0,0,0,0,0,0,0,1000,0,0,0,3000,2000,1000,1000
060233,宏碁元大9A購01  ,0,0,0,0,0,0,0,0,0,1000,0,0,0,130000,129000,1000,1000
060247,牧德元大9A購02  ,0,0,0,0,0,0,0,0,0,1000,0,0,0,1000,0,1000,1000
062166,致新國泰01購01  ,0,0,0,0,0,0,0,0,0,1000,0,0,0,5000,4000,1000,1000
061976,國巨元大9B購01  ,0,0,0,0,0,0,0,0,0,1000,0,0,0,1000,0,1000,1000
062000,臺股指元大9B購24,0,0,0,0,0,0,0,0,0,1000,0,0,0,1000,0,1000,1000
062054,鴻海統一9C購06  ,0,0,0,0,0,0,0,0,0,1000,0,0,0,1000,0,1000,1000
062076,美律元大9B購02  ,0,0,0,0,0,0,0,0,0,1000,0,0,0,1000,0,1000,1000
062077,聯發科元大9B購04,0,0,0,0,0,0,0,0,0,1000,0,0,0,1000,0,1000,1000
062324,上銀統一9B購04  ,0,0,0,0,0,0,0,0,0,1000,0,0,0,43000,42000,1000,1000
06239P,奇力新元大97售08,0,0,0,0,0,0,0,0,0,1000,0,0,0,31000,30000,1000,1000
062598,華通台新9B購02  ,0,0,0,0,0,0,0,0,0,1000,0,0,0,2000,1000,1000,1000
062659,台灣50群益9B購10,0,0,0,0,0,0,0,0,0,1000,0,0,0,1000,0,1000,1000
062812,國巨兆豐9B購03  ,0,0,0,0,0,0,0,0,0,1000,0,0,0,1000,0,1000,1000
062794,鴻海統一9C購15  ,0,0,0,0,0,0,0,0,0,1000,0,0,0,34000,33000,1000,1000
063000,緯穎國票9B購03  ,0,0,0,0,0,0,0,0,0,1000,0,0,0,1000,0,1000,1000
063132,台表科元大9C購02,0,0,0,0,0,0,0,0,0,1000,0,0,0,43000,42000,1000,1000
061169,GIS兆豐9A購01   ,0,0,0,0,0,0,0,0,0,1000,0,0,0,1000,0,1000,1000
061234,國巨元大9A購18  ,0,0,0,0,0,0,0,0,0,1000,0,0,0,1000,0,1000,1000
06117P,臺股指日盛97售02,0,0,0,0,0,0,0,0,0,1000,0,0,0,1000,0,1000,1000
060998,華通兆豐9A購01  ,0,0,0,0,0,0,0,0,0,1000,0,0,0,11000,10000,1000,1000
06090P,旺宏統一97售06  ,0,0,0,0,0,0,0,0,0,1000,0,0,0,1000,0,1000,1000
060898,世芯凱基9A購03  ,0,0,0,0,0,0,0,0,0,1000,0,0,0,47000,46000,1000,1000
060782,道瓊指富邦9C購01,0,0,0,0,0,0,0,0,0,1000,0,0,0,1000,0,1000,1000
061926,晶技凱基9B購02  ,0,0,0,0,0,0,0,0,0,1000,0,0,0,1000,0,1000,1000
061910,台積電中信05購03,0,0,0,0,0,0,0,0,0,1000,0,0,0,1000,0,1000,1000
061935,台積電國票9B購07,0,0,0,0,0,0,0,0,0,1000,0,0,0,1000,0,1000,1000
061884,臺股指元大9B購18,0,0,0,0,0,0,0,0,0,1000,0,0,0,1000,0,1000,1000
061823,勤誠群益9B購01  ,0,0,0,0,0,0,0,0,0,1000,0,0,0,11000,10000,1000,1000
9941A,裕融甲特        ,0,0,0,0,0,0,0,0,0,1000,1000,0,1000,0,0,0,1000
9906,欣巴巴          ,1000,0,1000,0,0,0,0,0,0,0,0,0,0,0,0,0,1000
8481,政伸            ,1000,0,1000,0,0,0,0,0,0,0,0,0,0,0,0,0,1000
6442,光聖            ,1000,0,1000,0,0,0,0,0,0,0,0,0,0,0,0,0,1000
6573,虹揚-KY         ,0,0,0,0,0,0,0,0,0,1000,1000,0,1000,0,0,0,1000
6674,鋐寶科技        ,1000,1000,0,0,0,0,0,0,0,1000,1000,0,1000,0,0,0,1000
6641,基士德-KY       ,1000,0,1000,0,0,0,0,0,0,0,0,0,0,0,0,0,1000
6655,科定            ,1000,0,1000,0,0,0,0,0,0,0,0,0,0,0,0,0,1000
4807,日成-KY         ,0,1000,-1000,0,0,0,0,0,0,2000,2000,0,2000,0,0,0,1000
3528,安馳            ,1000,0,1000,0,0,0,0,0,0,0,0,0,0,0,0,0,1000
3432,台端            ,0,0,0,0,0,0,0,0,0,1000,1000,0,1000,0,0,0,1000
3021,鴻名            ,1000,0,1000,0,0,0,0,0,0,0,1000,1000,0,0,0,0,1000
3046,建碁            ,2000,1000,1000,0,0,0,0,0,0,0,0,0,0,0,0,0,1000
6666,羅麗芬-KY       ,1000,979,21,0,0,0,0,0,0,0,0,0,0,0,0,0,21
1617,榮星            ,0,1000,-1000,0,0,0,0,0,0,1000,1000,0,1000,0,0,0,0
08235P,南電國泰9C售03  ,0,0,0,0,0,0,0,0,0,0,0,0,0,10000,10000,0,0
07910P,台積電統一9C售07,0,0,0,0,0,0,0,0,0,0,0,0,0,10000,10000,0,0
07796P,聯發科國票9A售03,0,0,0,0,0,0,0,0,0,0,0,0,0,20000,20000,0,0
07426P,上証2X國票9B售01,0,0,0,0,0,0,0,0,0,0,0,0,0,300000,300000,0,0
07489P,國巨國票9A售07  ,0,0,0,0,0,0,0,0,0,0,0,0,0,20000,20000,0,0
07479P,A50正2元富9A售03,0,0,0,0,0,0,0,0,0,0,0,0,0,10000,10000,0,0
07509P,牧德國票9A售03  ,0,0,0,0,0,0,0,0,0,0,0,0,0,68000,68000,0,0
07547P,緯穎凱基9A售05  ,0,0,0,0,0,0,0,0,0,0,0,0,0,25000,25000,0,0
07678P,大立光群益9A售03,0,0,0,0,0,0,0,0,0,0,0,0,0,20000,20000,0,0
07745P,華新科凱基9A售10,0,0,0,0,0,0,0,0,0,0,0,0,0,10000,10000,0,0
063546,國巨兆豐9C購03  ,0,0,0,0,0,0,0,0,0,0,0,0,0,10000,10000,0,0
063609,南電凱基9B購05  ,0,0,0,0,0,0,0,0,0,0,0,0,0,4000,4000,0,0
063756,鴻海統一9B購09  ,0,0,0,0,0,0,0,0,0,0,0,0,0,2000,2000,0,0
063706,台虹群益9B購01  ,0,0,0,0,0,0,0,0,0,0,0,0,0,7000,7000,0,0
063734,可成元大9B購04  ,0,0,0,0,0,0,0,0,0,0,0,0,0,4000,4000,0,0
063837,亞德客元大01購01,0,0,0,0,0,0,0,0,0,0,0,0,0,1000,1000,0,0
063851,健策元大01購01  ,0,0,0,0,0,0,0,0,0,0,0,0,0,27000,27000,0,0
063796,鴻海凱基9C購02  ,0,0,0,0,0,0,0,0,0,0,0,0,0,2000,2000,0,0
063801,GIS凱基01購01   ,0,0,0,0,0,0,0,0,0,0,0,0,0,309000,309000,0,0
063803,世紀鋼凱基01購01,0,0,0,0,0,0,0,0,0,0,0,0,0,6000,6000,0,0
063242,聯發科元大9B購19,0,0,0,0,0,0,0,0,0,0,0,0,0,35000,35000,0,0
063308,緯穎凱基9B購05  ,0,1000,-1000,0,0,0,0,0,0,1000,0,0,0,41000,40000,1000,0
063273,緯穎兆豐9C購01  ,0,0,0,0,0,0,0,0,0,0,0,0,0,135000,135000,0,0
06336P,鴻海元大98售05  ,0,0,0,0,0,0,0,0,0,0,0,0,0,30000,30000,0,0
063453,創意統一9C購01  ,0,0,0,0,0,0,0,0,0,0,0,0,0,61000,61000,0,0
063416,台積電凱基9B購10,0,0,0,0,0,0,0,0,0,0,0,0,0,6000,6000,0,0
063483,致新元大9B購03  ,0,0,0,0,0,0,0,0,0,0,0,0,0,21000,21000,0,0
063534,鴻海統一9B購07  ,0,0,0,0,0,0,0,0,0,0,0,0,0,2000,2000,0,0
06427P,鴻海元大97售13  ,0,0,0,0,0,0,0,0,0,0,0,0,0,115000,115000,0,0
06453P,群創元大9B售02  ,0,0,0,0,0,0,0,0,0,0,0,0,0,9000,9000,0,0
06448P,華通元大99售01  ,0,0,0,0,0,0,0,0,0,0,0,0,0,10000,10000,0,0
063990,世芯永豐01購01  ,0,0,0,0,0,0,0,0,0,0,0,0,0,29000,29000,0,0
063991,南六永豐9C購02  ,0,0,0,0,0,0,0,0,0,0,0,0,0,13000,13000,0,0
063962,台達電國票01購01,0,0,0,0,0,0,0,0,0,0,0,0,0,71000,71000,0,0
06504P,麗豐國票99售02  ,0,0,0,0,0,0,0,0,0,0,0,0,0,72000,72000,0,0
06488P,台積電元富98售05,0,0,0,0,0,0,0,0,0,0,0,0,0,201000,201000,0,0
06489P,台積電元富98售06,0,0,0,0,0,0,0,0,0,0,0,0,0,110000,110000,0,0
06469P,臺股指凱基99售09,0,0,0,0,0,0,0,0,0,0,0,0,0,5000,5000,0,0
06466P,台積電統一9B售01,0,0,0,0,0,0,0,0,0,0,0,0,0,2000,2000,0,0
06473P,鴻海元大99售03  ,0,0,0,0,0,0,0,0,0,0,0,0,0,41000,41000,0,0
06385P,聯發科永豐97售02,0,0,0,0,0,0,0,0,0,0,0,0,0,35000,35000,0,0
063869,玉晶光永豐9C購01,0,0,0,0,0,0,0,0,0,0,0,0,0,9000,9000,0,0
063891,國巨群益9C購07  ,0,0,0,0,0,0,0,0,0,0,0,0,0,2000,2000,0,0
063897,神達群益9C購01  ,0,0,0,0,0,0,0,0,0,0,0,0,0,16000,16000,0,0
063943,台光電元大9C購02,0,0,0,0,0,0,0,0,0,0,0,0,0,1000,1000,0,0
06617P,智邦元大98售03  ,0,0,0,0,0,0,0,0,0,0,0,0,0,100000,100000,0,0
06585P,鴻海元大99售04  ,0,0,0,0,0,0,0,0,0,0,0,0,0,60000,60000,0,0
06557P,台積電兆豐98售02,0,0,0,0,0,0,0,0,0,0,0,0,0,499000,499000,0,0
06543P,鴻海元大98售08  ,0,0,0,0,0,0,0,0,0,0,0,0,0,52000,52000,0,0
06544P,鴻海元大98售09  ,0,0,0,0,0,0,0,0,0,0,0,0,0,15000,15000,0,0
06528P,台積電富邦99售03,0,0,0,0,0,0,0,0,0,0,0,0,0,5000,5000,0,0
06534P,聯發科群益98售04,0,0,0,0,0,0,0,0,0,0,0,0,0,12000,12000,0,0
06698P,玉晶光國票99售05,0,0,0,0,0,0,0,0,0,0,0,0,0,11000,11000,0,0
06666P,台積電日盛9A售02,0,0,0,0,0,0,0,0,0,0,0,0,0,64000,64000,0,0
06655P,TPK元大98售02   ,0,0,0,0,0,0,0,0,0,0,0,0,0,40000,40000,0,0
07227P,聯發科元富99售05,0,0,0,0,0,0,0,0,0,0,0,0,0,400000,400000,0,0
07046P,大立光富邦9C售03,0,0,0,0,0,0,0,0,0,0,0,0,0,7000,7000,0,0
07103P,南電元大99售04  ,0,0,0,0,0,0,0,0,0,0,0,0,0,5000,5000,0,0
07090P,台灣50凱基01售01,0,0,0,0,0,0,0,0,0,0,0,0,0,2000,2000,0,0
06919P,臺股指日盛98售02,0,0,0,0,0,0,0,0,0,0,0,0,0,30000,30000,0,0
06927P,台灣50元大9B售03,0,0,0,0,0,0,0,0,0,0,0,0,0,20000,20000,0,0
07036P,台灣50台新9C售01,0,0,0,0,0,0,0,0,0,0,0,0,0,157000,157000,0,0
06806P,臺股指群益98售12,0,0,0,0,0,0,0,0,0,0,0,0,0,20000,20000,0,0
06789P,鴻海凱基98售12  ,0,0,0,0,0,0,0,0,0,0,0,0,0,72000,72000,0,0
06767P,台積電永昌99售03,0,0,0,0,0,0,0,0,0,0,0,0,0,10000,10000,0,0
06841P,臺股指統一9A售02,0,0,0,0,0,0,0,0,0,0,0,0,0,10000,10000,0,0
06843P,鴻海元大98售11  ,0,0,0,0,0,0,0,0,0,0,0,0,0,12000,12000,0,0
06911P,鴻海元大99售09  ,0,0,0,0,0,0,0,0,0,0,0,0,0,3000,3000,0,0
06893P,致新元富98售02  ,0,0,0,0,0,0,0,0,0,0,0,0,0,200000,200000,0,0
053737,華新科麥證96購01,0,0,0,0,40000,-40000,0,0,0,0,0,0,0,40000,40000,0,0
053818,富邦金群益98購01,0,5000,-5000,0,0,0,0,0,0,5000,0,0,0,5000,0,5000,0
03674C,臺股指元富9C牛02,0,0,0,0,0,0,0,0,0,0,0,0,0,9000,9000,0,0
051974,華新科凱基96購05,0,0,0,0,0,0,0,0,0,0,0,0,0,160000,160000,0,0
052038,國巨永昌96購01  ,0,0,0,0,0,0,0,0,0,0,0,0,0,10000,10000,0,0
051897,台光電國泰97購01,0,0,0,0,0,0,0,0,0,0,0,0,0,10000,10000,0,0
053972,華新科元大96購06,0,0,0,0,0,0,0,0,0,0,0,0,0,40000,40000,0,0
054080,微星中信98購01  ,0,0,0,0,0,0,0,0,0,0,0,0,0,20000,20000,0,0
054098,嘉晶國票97購04  ,0,0,0,0,0,0,0,0,0,0,0,0,0,58000,58000,0,0
03012X,元展12          ,0,0,0,0,0,0,0,0,0,0,0,0,0,1000,1000,0,0
00625K,富邦上証+R      ,0,0,0,0,0,0,0,0,0,0,0,0,0,52000,52000,0,0
00636K,國泰中國A50+U   ,0,0,0,0,0,0,0,0,0,0,0,0,0,100,100,0,0
00668K,國泰美國道瓊+U  ,0,0,0,0,0,0,0,0,0,0,0,0,0,100,100,0,0
00657K,國泰日經225+U   ,0,0,0,0,0,0,0,0,0,0,0,0,0,100,100,0,0
00775B,新光投等債15+   ,0,0,0,0,0,0,0,0,0,0,0,0,0,2000,2000,0,0
051659,力山國泰97購01  ,0,0,0,0,0,0,0,0,0,0,0,0,0,10000,10000,0,0
03094X,大立光元大68展08,0,0,0,0,0,0,0,0,0,0,0,0,0,1000,1000,0,0
050786,健策國泰96購01  ,0,0,0,0,0,0,0,0,0,0,0,0,0,2000,2000,0,0
05069P,鴻海統一96售03  ,0,0,0,0,0,0,0,0,0,0,0,0,0,1000,1000,0,0
051067,台積電國票96購03,0,0,0,0,0,0,0,0,0,0,0,0,0,1000,1000,0,0
053097,超眾統一96購03  ,0,0,0,0,0,0,0,0,0,0,0,0,0,6000,6000,0,0
053116,華新科中信96購01,0,0,0,0,0,0,0,0,0,0,0,0,0,100000,100000,0,0
055448,健策統一97購02  ,0,0,0,0,0,0,0,0,0,0,0,0,0,140000,140000,0,0
056333,台積電日盛9B購01,0,0,0,0,0,0,0,0,0,0,0,0,0,55000,55000,0,0
056380,麗豐元富98購01  ,0,0,0,0,0,0,0,0,0,0,0,0,0,10000,10000,0,0
05665P,台積電凱基96售08,0,0,0,0,0,0,0,0,0,0,0,0,0,30000,30000,0,0
052338,道瓊反凱基97購02,0,0,0,0,0,0,0,0,0,0,0,0,0,10000,10000,0,0
054157,國巨亞東96購01  ,0,0,0,0,0,0,0,0,0,0,0,0,0,70000,70000,0,0
054239,台郡群益96購02  ,0,0,0,0,0,0,0,0,0,0,0,0,0,10000,10000,0,0
054220,國巨統一97購02  ,0,0,0,0,0,0,0,0,0,0,0,0,0,43000,43000,0,0
054208,台積電國票97購07,0,0,0,0,0,0,0,0,0,0,0,0,0,1000,1000,0,0
052923,台積電永豐96購02,0,0,0,0,0,0,0,0,0,0,0,0,0,44000,44000,0,0
052958,T50反1凱基99購02,0,0,0,0,0,0,0,0,0,0,0,0,0,499000,499000,0,0
052551,台積電國票97購03,0,0,0,0,0,0,0,0,0,0,0,0,0,2000,2000,0,0
052532,台積電國泰96購07,0,0,0,0,0,0,0,0,0,0,0,0,0,157000,157000,0,0
053475,華新科元大96購05,0,0,0,0,0,0,0,0,0,0,0,0,0,217000,217000,0,0
053481,同欣電元大97購01,0,0,0,0,0,0,0,0,0,0,0,0,0,6000,6000,0,0
053376,鴻海元大96購19  ,0,0,0,0,0,0,0,0,0,0,0,0,0,1000,1000,0,0
053256,上銀富邦98購01  ,0,0,0,0,0,0,0,0,0,0,0,0,0,1000,1000,0,0
052662,華新科國票97購01,0,0,0,0,0,0,0,0,0,0,0,0,0,116000,116000,0,0
053162,緯穎元大97購01  ,0,0,0,0,0,0,0,0,0,0,0,0,0,55000,55000,0,0
056128,和大中信99購01  ,0,0,0,0,0,0,0,0,0,0,0,0,0,20000,20000,0,0
056093,大毅元富97購01  ,0,0,0,0,0,0,0,0,0,0,0,0,0,10000,10000,0,0
056091,百和統一97購01  ,0,0,0,0,0,0,0,0,0,0,0,0,0,48000,48000,0,0
055984,大立光元富97購02,0,0,0,0,0,0,0,0,0,0,0,0,0,10000,10000,0,0
056646,奇鋐凱基99購02  ,0,0,0,0,0,0,0,0,0,0,0,0,0,15000,15000,0,0
05590P,臺股指中信96售05,0,0,0,0,0,0,0,0,0,0,0,0,0,22000,22000,0,0
056230,可成凱基98購03  ,0,0,0,0,0,0,0,0,0,0,0,0,0,1000,1000,0,0
056300,聯發科元大97購23,0,0,0,0,0,0,0,0,0,0,0,0,0,56000,56000,0,0
059038,健策群益9A購02  ,0,0,0,0,0,0,0,0,0,0,0,0,0,1000,1000,0,0
059320,華新科元大99購15,0,0,0,0,0,0,0,0,0,0,0,0,0,4000,4000,0,0
059470,華新科元大99購16,0,0,0,0,0,0,0,0,0,0,0,0,0,4000,4000,0,0
059471,華新科元大99購17,0,0,0,0,0,0,0,0,0,0,0,0,0,3000,3000,0,0
055892,國巨統一99購01  ,0,0,0,0,0,0,0,0,0,0,0,0,0,20000,20000,0,0
059312,元石油元大99購05,0,0,0,0,0,0,0,0,0,0,0,0,0,3000,3000,0,0
059058,可成凱基9B購01  ,0,0,0,0,0,0,0,0,0,0,0,0,0,2000,2000,0,0
059088,台積電元大99購27,0,0,0,0,0,0,0,0,0,0,0,0,0,3000,3000,0,0
05917P,宏達電元大96售02,0,0,0,0,0,0,0,0,0,0,0,0,0,100000,100000,0,0
05919P,京鼎元大96售03  ,0,0,0,0,0,0,0,0,0,0,0,0,0,101000,101000,0,0
05916P,聯發科元大96售20,0,0,0,0,0,0,0,0,0,0,0,0,0,1000,1000,0,0
056463,台虹凱基98購02  ,0,0,0,0,0,0,0,0,0,0,0,0,0,6000,6000,0,0
056435,台積電凱基98購09,0,0,0,0,0,0,0,0,0,0,0,0,0,6000,6000,0,0
056471,台光電元大99購01,0,0,0,0,0,0,0,0,0,0,0,0,0,32000,32000,0,0
056535,全新凱基99購02  ,0,0,0,0,0,0,0,0,0,0,0,0,0,10000,10000,0,0
056532,技嘉凱基98購01  ,0,0,0,0,0,0,0,0,0,0,0,0,0,1000,1000,0,0
054862,群光群益97購01  ,0,0,0,0,0,0,0,0,0,0,0,0,0,98000,98000,0,0
054831,緯穎國泰98購01  ,0,0,0,0,0,0,0,0,0,0,0,0,0,1000,1000,0,0
055649,華新科元富97購03,0,0,0,0,0,0,0,0,0,0,0,0,0,99000,99000,0,0
055637,亞德客元富97購01,0,0,0,0,0,0,0,0,0,0,0,0,0,10000,10000,0,0
055672,國巨日盛97購02  ,0,0,0,0,0,0,0,0,0,0,0,0,0,10000,10000,0,0
054671,國巨國泰98購01  ,0,0,0,0,0,0,0,0,0,0,0,0,0,20000,20000,0,0
054753,復盛凱基98購01  ,0,0,0,0,0,0,0,0,0,0,0,0,0,20000,20000,0,0
054954,華新科元大97購06,0,0,0,0,0,0,0,0,0,0,0,0,0,175000,175000,0,0
055246,美律統一98購01  ,0,0,0,0,0,0,0,0,0,0,0,0,0,20000,20000,0,0
060160,聯陽永豐9A購01  ,1000,0,1000,0,0,0,0,0,0,-1000,0,0,0,3000,4000,-1000,0
060215,柏文康和9A購01  ,0,0,0,0,0,0,0,0,0,0,0,0,0,5000,5000,0,0
060351,滬深2X元富9A購01,0,0,0,0,0,0,0,0,0,0,0,0,0,11000,11000,0,0
058295,欣興凱基99購02  ,0,0,0,0,0,0,0,0,0,0,0,0,0,201000,201000,0,0
057468,台郡永豐98購01  ,0,0,0,0,0,0,0,0,0,0,0,0,0,10000,10000,0,0
05828P,台積電統一97售02,0,0,0,0,0,0,0,0,0,0,0,0,0,10000,10000,0,0
057429,華新科兆豐98購03,0,0,0,0,0,0,0,0,0,0,0,0,0,55000,55000,0,0
057421,智原凱基98購04  ,0,0,0,0,0,0,0,0,0,0,0,0,0,10000,10000,0,0
057454,上銀國泰99購02  ,0,0,0,0,0,0,0,0,0,0,0,0,0,26000,26000,0,0
058263,大成鋼永豐99購01,0,0,0,0,0,0,0,0,0,0,0,0,0,68000,68000,0,0
058244,神達元大99購02  ,0,0,0,0,0,0,0,0,0,0,0,0,0,68000,68000,0,0
060939,鴻海國票9A購06  ,0,0,0,0,0,0,0,0,0,0,0,0,0,15000,15000,0,0
058310,大立光元大99購10,0,0,0,0,0,0,0,0,0,0,0,0,0,1000,1000,0,0
058325,昇陽半永豐99購01,0,0,0,0,0,0,0,0,0,0,0,0,0,6000,6000,0,0
060106,旭富元大99購02  ,0,0,0,0,0,0,0,0,0,0,0,0,0,75000,75000,0,0
058742,鴻海康和99購01  ,0,0,0,0,0,0,0,0,0,0,0,0,0,1000,1000,0,0
058713,國巨統一9B購02  ,0,0,0,0,0,0,0,0,0,0,0,0,0,20000,20000,0,0
058683,可成凱基9A購01  ,0,0,0,0,0,0,0,0,0,0,0,0,0,1000,1000,0,0
058219,台灣50國票9A購02,0,0,0,0,0,0,0,0,0,0,0,0,0,35000,35000,0,0
058418,台積電麥證99購01,0,0,0,0,0,0,0,0,0,0,0,0,0,201000,201000,0,0
058594,台灣50元富9B購03,0,0,0,0,0,0,0,0,0,0,0,0,0,1000,1000,0,0
058673,華新科群益9A購02,0,0,0,0,0,0,0,0,0,0,0,0,0,4000,4000,0,0
058565,鴻海凱基9A購07  ,0,0,0,0,0,0,0,0,0,0,0,0,0,2000,2000,0,0
058544,FBVIX富邦9B購01 ,0,0,0,0,0,0,0,0,0,0,0,0,0,5000,5000,0,0
058538,智邦台新99購02  ,0,0,0,0,0,0,0,0,0,0,0,0,0,3000,3000,0,0
05850P,台積電兆豐96售06,0,0,0,0,0,0,0,0,0,0,0,0,0,216000,216000,0,0
058503,鴻海元大99購14  ,0,0,0,0,0,0,0,0,0,0,0,0,0,7000,7000,0,0
057704,台虹群益98購03  ,0,0,0,0,0,0,0,0,0,0,0,0,0,6000,6000,0,0
057758,鴻海凱基99購03  ,0,0,0,0,0,0,0,0,0,0,0,0,0,4000,4000,0,0
057736,鴻海富邦99購04  ,0,0,0,0,0,0,0,0,0,0,0,0,0,2000,2000,0,0
057690,美律凱基99購03  ,0,0,0,0,0,0,0,0,0,0,0,0,0,30000,30000,0,0
057667,可成元大99購01  ,0,0,0,0,0,0,0,0,0,0,0,0,0,69000,69000,0,0
057792,群創統一99購01  ,0,0,0,0,0,0,0,0,0,0,0,0,0,60000,60000,0,0
057802,卜蜂元大98購01  ,0,0,0,0,0,0,0,0,0,0,0,0,0,26000,26000,0,0
057789,上銀統一9A購01  ,0,0,0,0,0,0,0,0,0,0,0,0,0,30000,30000,0,0
057770,亞德客群益98購01,0,1000,-1000,0,0,0,0,0,0,1000,0,0,0,1000,0,1000,0
058187,泰碩永豐99購01  ,0,0,0,0,0,0,0,0,0,0,0,0,0,1000,1000,0,0
058185,國巨永豐99購01  ,0,0,0,0,0,0,0,0,0,0,0,0,0,20000,20000,0,0
05846P,大立光元大96售07,0,0,0,0,0,0,0,0,0,0,0,0,0,1000,1000,0,0
05845P,大立光元大96售06,0,0,0,0,0,0,0,0,0,0,0,0,0,1000,1000,0,0
058212,華新科群益9A購01,0,0,0,0,0,0,0,0,0,0,0,0,0,3000,3000,0,0
058158,台積電台新99購01,0,0,0,0,0,0,0,0,0,0,0,0,0,77000,77000,0,0
057861,台積電凱基98購16,0,0,0,0,0,0,0,0,0,0,0,0,0,5000,5000,0,0
057531,禾伸堂元大99購04,0,0,0,0,0,0,0,0,0,0,0,0,0,4000,4000,0,0
057529,嘉晶元大99購02  ,0,0,0,0,0,0,0,0,0,0,0,0,0,30000,30000,0,0
058980,鴻海凱基99購06  ,0,0,0,0,0,0,0,0,0,0,0,0,0,15000,15000,0,0
058952,南茂群益99購01  ,0,0,0,0,0,0,0,0,0,0,0,0,0,20000,20000,0,0
058983,旺宏凱基99購05  ,50000,0,50000,0,0,0,0,0,0,-50000,0,0,0,0,50000,-50000,0
058998,鴻海元大99購22  ,0,0,0,0,0,0,0,0,0,0,0,0,0,5000,5000,0,0
058824,晶技富邦9A購01  ,0,0,0,0,0,0,0,0,0,0,0,0,0,10000,10000,0,0
059275,可成元大99購05  ,0,0,0,0,0,0,0,0,0,0,0,0,0,4000,4000,0,0
059240,台積電凱基9A購09,0,0,0,0,0,0,0,0,0,0,0,0,0,3000,3000,0,0
059241,旺宏凱基99購07  ,0,0,0,0,0,0,0,0,0,0,0,0,0,17000,17000,0,0
059218,台積電元大99購31,0,0,0,0,0,0,0,0,0,0,0,0,0,10000,10000,0,0
057173,南亞科元大98購04,0,0,0,0,0,0,0,0,0,0,0,0,0,68000,68000,0,0
05717P,鴻海元大97售07  ,0,0,0,0,0,0,0,0,0,0,0,0,0,25000,25000,0,0
057910,華新科兆豐99購02,0,0,0,0,0,0,0,0,0,0,0,0,0,33000,33000,0,0
05719P,可成元大96售03  ,0,0,0,0,0,0,0,0,0,0,0,0,0,1000,1000,0,0
059669,台灣50元富9B購05,0,0,0,0,0,0,0,0,0,0,0,0,0,2449000,2449000,0,0
059663,旭富元大9C購02  ,0,0,0,0,0,0,0,0,0,0,0,0,0,70000,70000,0,0
059717,國巨元大99購21  ,0,0,0,0,0,0,0,0,0,0,0,0,0,2000,2000,0,0
059726,華新科元大99購18,0,0,0,0,0,0,0,0,0,0,0,0,0,4000,4000,0,0
058863,可成凱基99購02  ,0,0,0,0,0,0,0,0,0,0,0,0,0,1000,1000,0,0
058035,旭富永豐98購02  ,0,0,0,0,0,0,0,0,0,0,0,0,0,18000,18000,0,0
058024,台積電國泰9A購01,0,0,0,0,0,0,0,0,0,0,0,0,0,5000,5000,0,0
058044,鴻海元大99購07  ,0,0,0,0,0,0,0,0,0,0,0,0,0,5000,5000,0,0
058047,可成元大98購11  ,0,0,0,0,0,0,0,0,0,0,0,0,0,68000,68000,0,0
058018,南亞科凱基99購03,0,0,0,0,0,0,0,0,0,0,0,0,0,40000,40000,0,0
058009,智易國票99購01  ,0,0,0,0,0,0,0,0,0,0,0,0,0,2000,2000,0,0
05800P,台積電兆豐96售04,0,0,0,0,0,0,0,0,0,0,0,0,0,166000,166000,0,0
057988,鈺齊元富98購02  ,0,0,0,0,0,0,0,0,0,0,0,0,0,30000,30000,0,0
057276,全新元大99購03  ,0,0,0,0,0,0,0,0,0,0,0,0,0,10000,10000,0,0
059430,台積電元大99購36,0,0,0,0,0,0,0,0,0,0,0,0,0,3000,3000,0,0
057211,鴻海群益98購05  ,0,0,0,0,0,0,0,0,0,0,0,0,0,13000,13000,0,0
057212,台積電群益98購03,0,0,0,0,0,0,0,0,0,0,0,0,0,10000,10000,0,0
057370,可成元大98購07  ,0,0,0,0,0,0,0,0,0,0,0,0,0,69000,69000,0,0
057363,華通元大99購02  ,0,0,0,0,0,0,0,0,0,0,0,0,0,2000,2000,0,0
058122,美律國票9A購01  ,0,0,0,0,0,0,0,0,0,0,0,0,0,12000,12000,0,0
058118,瑞昱群益99購01  ,0,0,0,0,0,0,0,0,0,0,0,0,0,31000,31000,0,0
058096,南電元大98購04  ,0,0,0,0,0,0,0,0,0,0,0,0,0,50000,50000,0,0
058112,神達元富98購01  ,0,0,0,0,0,0,0,0,0,0,0,0,0,98000,98000,0,0
057611,技嘉元富98購02  ,0,0,0,0,0,0,0,0,0,0,0,0,0,10000,10000,0,0
058924,晶相光元富99購02,0,0,0,0,0,0,0,0,0,0,0,0,0,10000,10000,0,0
057064,華新科富邦9B購01,0,0,0,0,0,0,0,0,0,0,0,0,0,55000,55000,0,0
057023,美律凱基99購02  ,0,0,0,0,0,0,0,0,0,0,0,0,0,20000,20000,0,0
059855,緯穎永豐99購04  ,0,0,0,0,0,0,0,0,0,0,0,0,0,20000,20000,0,0
059877,康控凱基99購05  ,0,0,0,0,0,0,0,0,0,0,0,0,0,33000,33000,0,0
059867,華邦電凱基99購02,0,0,0,0,0,0,0,0,0,0,0,0,0,2000,2000,0,0
059803,S&P正2元富9B購03,0,0,0,0,0,0,0,0,0,0,0,0,0,1000,1000,0,0
059788,華新科元大9A購05,0,0,0,0,0,0,0,0,0,0,0,0,0,4000,4000,0,0
059785,美律元大9A購03  ,0,0,0,0,0,0,0,0,0,0,0,0,0,6000,6000,0,0
059884,鴻海國票99購09  ,0,0,0,0,0,0,0,0,0,0,0,0,0,2000,2000,0,0
05989P,健策元富96售01  ,0,0,0,0,0,0,0,0,0,0,0,0,0,200000,200000,0,0
059994,國巨元富99購01  ,0,0,0,0,0,0,0,0,0,0,0,0,0,5000,5000,0,0
056893,智邦元大98購02  ,0,0,0,0,0,0,0,0,0,0,0,0,0,1000,1000,0,0
056771,嘉晶元大99購01  ,0,0,0,0,0,0,0,0,0,0,0,0,0,10000,10000,0,0
060056,大立光凱基9B購01,0,0,0,0,0,0,0,0,0,0,0,0,0,10000,10000,0,0
061902,百和永豐9B購01  ,0,0,0,0,0,0,0,0,0,0,0,0,0,16000,16000,0,0
061669,崇越中信9A購01  ,0,0,0,0,0,0,0,0,0,0,0,0,0,48000,48000,0,0
061621,健策群益9A購05  ,0,0,0,0,0,0,0,0,0,0,0,0,0,109000,109000,0,0
061682,南電元大9B購01  ,0,0,0,0,0,0,0,0,0,0,0,0,0,10000,10000,0,0
061710,國巨凱基9A購18  ,0,0,0,0,0,0,0,0,0,0,0,0,0,1000,1000,0,0
061499,嘉晶國票9A購03  ,0,0,0,0,0,0,0,0,0,0,0,0,0,1000,1000,0,0
061450,嘉晶中信9A購01  ,0,0,0,0,0,0,0,0,0,0,0,0,0,21000,21000,0,0
060778,臺股指凱基9A購06,0,0,0,0,0,0,0,0,0,0,0,0,0,3000,3000,0,0
060797,世芯永豐9A購04  ,0,0,0,0,0,0,0,0,0,0,0,0,0,1000,1000,0,0
060698,旺宏國泰9C購01  ,0,0,0,0,0,0,0,0,0,0,0,0,0,111000,111000,0,0
06067P,華新科康和97售01,0,0,0,0,0,0,0,0,0,0,0,0,0,90000,90000,0,0
060710,上銀永豐9A購01  ,0,0,0,0,0,0,0,0,0,0,0,0,0,4000,4000,0,0
060550,可成凱基9A購02  ,0,0,0,0,0,0,0,0,0,0,0,0,0,2000,2000,0,0
060500,鴻海元大9A購12  ,0,0,0,0,0,0,0,0,0,0,0,0,0,50000,50000,0,0
06064P,台積電台新98售01,0,0,0,0,0,0,0,0,0,0,0,0,0,10000,10000,0,0
060581,玉晶光群益9B購02,0,0,0,0,0,0,0,0,0,0,0,0,0,3000,3000,0,0
060599,國巨凱基9C購01  ,0,0,0,0,0,0,0,0,0,0,0,0,0,106000,106000,0,0
060859,鴻海永豐9A購01  ,0,0,0,0,0,0,0,0,0,0,0,0,0,2000,2000,0,0
060866,世芯永豐9B購01  ,0,0,0,0,0,0,0,0,0,0,0,0,0,2000,2000,0,0
06100P,台積電日盛97售03,0,0,0,0,0,0,0,0,0,0,0,0,0,50000,50000,0,0
061018,台積電國票9B購05,0,0,0,0,0,0,0,0,0,0,0,0,0,5000,5000,0,0
061022,健策國泰9B購03  ,0,0,0,0,0,0,0,0,0,0,0,0,0,44000,44000,0,0
06119P,大立光凱基98售04,0,0,0,0,0,0,0,0,0,0,0,0,0,2000,2000,0,0
061207,美律元大9A購04  ,0,0,0,0,0,0,0,0,0,0,0,0,0,4000,4000,0,0
061233,國巨元大9A購17  ,0,0,0,0,0,0,0,0,0,0,0,0,0,10000,10000,0,0
061105,宏達電元大9A購04,0,0,0,0,0,0,0,0,0,0,0,0,0,68000,68000,0,0
061112,台表科元大9A購03,0,0,0,0,0,0,0,0,0,0,0,0,0,146000,146000,0,0
063172,廣達中信9C購01  ,0,0,0,0,0,0,0,0,0,0,0,0,0,48000,48000,0,0
062996,致茂國票9C購01  ,0,0,0,0,0,0,0,0,0,0,0,0,0,11000,11000,0,0
062946,祥碩國泰9C購02  ,0,0,0,0,0,0,0,0,0,0,0,0,0,68000,68000,0,0
063073,瑞昱永豐9B購01  ,0,0,0,0,0,0,0,0,0,0,0,0,0,15000,15000,0,0
063033,台積電凱基9B購09,0,0,0,0,0,0,0,0,0,0,0,0,0,5000,5000,0,0
062724,可成凱基9B購04  ,0,0,0,0,0,0,0,0,0,0,0,0,0,1000,1000,0,0
062290,聯發科富邦9C購04,0,0,0,0,0,0,0,0,0,0,0,0,0,17000,17000,0,0
062553,台積電凱基9B購07,0,0,0,0,0,0,0,0,0,0,0,0,0,5000,5000,0,0
062573,大毅群益9B購03  ,0,0,0,0,0,0,0,0,0,0,0,0,0,54000,54000,0,0
062434,華通元大9B購04  ,0,0,0,0,0,0,0,0,0,0,0,0,0,50000,50000,0,0
062468,台積電凱基9B購06,0,0,0,0,0,0,0,0,0,0,0,0,0,5000,5000,0,0
062107,台光電國票9B購01,0,0,0,0,0,0,0,0,0,0,0,0,0,18000,18000,0,0
062102,T50反1國票9B購07,0,0,0,0,0,0,0,0,0,0,0,0,0,200000,200000,0,0
062044,健策凱基9B購02  ,0,0,0,0,0,0,0,0,0,0,0,0,0,7000,7000,0,0
061992,祥碩元大9B購02  ,0,0,0,0,0,0,0,0,0,0,0,0,0,30000,30000,0,0
6477,安集            ,10000,27000,-17000,0,0,0,0,0,0,17000,17000,0,17000,0,0,0,0
9103,美德醫療-DR     ,55000,55000,0,0,0,0,0,0,0,0,0,0,0,0,0,0,0
9912,偉聯            ,8000,8000,0,0,0,0,0,0,0,0,0,0,0,0,0,0,0
8497,格威傳媒        ,1000,1000,0,0,0,0,0,0,0,0,0,0,0,0,0,0,0
8926,台汽電          ,162000,392000,-230000,0,0,0,0,0,0,230000,230000,0,230000,0,0,0,0
8480,泰昇-KY         ,1000,1000,0,0,0,0,0,0,0,0,0,0,0,0,0,0,0
4999,鑫禾            ,3000,17000,-14000,0,0,0,0,0,0,14000,14000,0,14000,0,0,0,0
5607,遠雄港          ,61000,65000,-4000,0,0,0,0,0,0,4000,4000,0,4000,0,0,0,0
07045P,上銀國票9A售01  ,0,0,0,0,0,0,0,0,0,-1000,0,0,0,14000,15000,-1000,-1000
07160P,台灣50中信03售04,0,0,0,0,0,0,0,0,0,-1000,0,0,0,0,1000,-1000,-1000
07161P,臺股指群益99售12,0,0,0,0,0,0,0,0,0,-1000,0,0,0,0,1000,-1000,-1000
06693P,臺股指凱基98售01,0,0,0,0,0,0,0,0,0,-1000,0,0,0,0,1000,-1000,-1000
06697P,台積電國票99售05,0,0,0,0,0,0,0,0,0,-1000,0,0,0,0,1000,-1000,-1000
06688P,鴻海中信02售01  ,0,0,0,0,0,0,0,0,0,-1000,0,0,0,0,1000,-1000,-1000
06711P,臺股指台新99售08,0,0,0,0,0,0,0,0,0,-1000,0,0,0,0,1000,-1000,-1000
06691P,臺股指群益9C售05,0,0,0,0,0,0,0,0,0,-1000,0,0,0,1000,2000,-1000,-1000
06527P,T50正2富邦9C售01,0,0,0,0,0,0,0,0,0,-1000,0,0,0,0,1000,-1000,-1000
06602P,國巨統一99售02  ,0,0,0,0,0,0,0,0,0,-1000,0,0,0,0,1000,-1000,-1000
06643P,大立光兆豐98售01,0,0,0,0,0,0,0,0,0,-1000,0,0,0,0,1000,-1000,-1000
063909,旺宏凱基02購01  ,0,0,0,0,0,0,0,0,0,-1000,0,0,0,0,1000,-1000,-1000
063927,奇力新統一02購01,0,0,0,0,0,0,0,0,0,-1000,0,0,0,0,1000,-1000,-1000
06470P,臺股指凱基99售10,0,0,0,0,0,0,0,0,0,-1000,0,0,0,0,1000,-1000,-1000
063979,健鼎兆豐9C購01  ,0,0,0,0,0,0,0,0,0,-1000,0,0,0,0,1000,-1000,-1000
06351P,臺股指台新99售03,0,0,0,0,0,0,0,0,0,-1000,0,0,0,0,1000,-1000,-1000
063494,金像電富邦9B購01,0,0,0,0,0,0,0,0,0,-1000,0,0,0,0,1000,-1000,-1000
063337,國巨統一02購02  ,0,0,0,0,0,0,0,0,0,-1000,0,0,0,0,1000,-1000,-1000
06329P,大立光兆豐97售04,0,0,0,0,0,0,0,0,0,-1000,0,0,0,0,1000,-1000,-1000
063724,亞德客元大9B購03,0,0,0,0,0,0,0,0,0,-1000,0,0,0,0,1000,-1000,-1000
063757,鴻海統一9C購16  ,0,0,0,0,0,0,0,0,0,-1000,0,0,0,7000,8000,-1000,-1000
063753,矽創國票9C購01  ,0,0,0,0,0,0,0,0,0,-1000,0,0,0,10000,11000,-1000,-1000
063762,緯穎統一9C購01  ,0,0,0,0,0,0,0,0,0,-1000,0,0,0,13000,14000,-1000,-1000
063545,華通兆豐9B購03  ,0,0,0,0,0,0,0,0,0,-1000,0,0,0,10000,11000,-1000,-1000
07758P,台積電國票9A售06,0,0,0,0,0,0,0,0,0,-1000,0,0,0,0,1000,-1000,-1000
07583P,台積電富邦9B售05,0,0,0,0,0,0,0,0,0,-1000,0,0,0,0,1000,-1000,-1000
07578P,高鐵元大9A售02  ,0,0,0,0,0,0,0,0,0,-1000,0,0,0,0,1000,-1000,-1000
07507P,國巨國票9B售02  ,0,0,0,0,0,0,0,0,0,-1000,0,0,0,0,1000,-1000,-1000
07775P,國巨群益9A售10  ,0,0,0,0,0,0,0,0,0,-1000,0,0,0,0,1000,-1000,-1000
07833P,大立光群益9B售02,0,0,0,0,0,0,0,0,0,-1000,0,0,0,0,1000,-1000,-1000
07949P,滬深2X元大9B售04,0,0,0,0,0,0,0,0,0,-1000,0,0,0,0,1000,-1000,-1000
08041P,臺股指群益9B售14,0,0,0,0,0,0,0,0,0,-1000,0,0,0,0,1000,-1000,-1000
08155P,聯發科元富9B售05,0,0,0,0,0,0,0,0,0,-1000,0,0,0,0,1000,-1000,-1000
08243P,祥碩凱基9C售02  ,0,0,0,0,0,0,0,0,0,-1000,0,0,0,0,1000,-1000,-1000
1453,大將            ,3000,5000,-2000,0,0,0,0,0,0,1000,1000,0,1000,0,0,0,-1000
2012,春雨            ,17000,21000,-4000,0,0,0,0,0,0,3000,3000,0,3000,0,0,0,-1000
2748,雲品            ,13000,14000,-1000,0,0,0,0,0,0,0,0,0,0,0,0,0,-1000
055261,帆宣統一98購01  ,0,0,0,0,0,0,0,0,0,-1000,0,0,0,0,1000,-1000,-1000
055026,健和興國泰98購01,0,0,0,0,0,0,0,0,0,-1000,0,0,0,0,1000,-1000,-1000
055718,可成元大97購02  ,0,0,0,0,0,0,0,0,0,-1000,0,0,0,0,1000,-1000,-1000
055787,聯茂凱基99購01  ,0,0,0,0,0,0,0,0,0,-1000,0,0,0,0,1000,-1000,-1000
055692,緯穎凱基97購03  ,0,0,0,0,0,0,0,0,0,-1000,0,0,0,0,1000,-1000,-1000
055598,欣興元大97購03  ,0,0,0,0,0,0,0,0,0,-1000,0,0,0,0,1000,-1000,-1000
055611,燿華國票98購02  ,0,0,0,0,0,0,0,0,0,-1000,0,0,0,0,1000,-1000,-1000
056457,嘉澤凱基98購01  ,0,0,0,0,0,0,0,0,0,-1000,0,0,0,0,1000,-1000,-1000
054368,鴻海中信9A購02  ,0,0,0,0,0,0,0,0,0,-1000,0,0,0,0,1000,-1000,-1000
055887,上銀統一97購03  ,0,0,0,0,0,0,0,0,0,-1000,0,0,0,0,1000,-1000,-1000
059351,台虹凱基99購01  ,0,0,0,0,0,0,0,0,0,-1000,0,0,0,8000,9000,-1000,-1000
059032,元石油群益9C購03,0,0,0,0,0,0,0,0,0,-1000,0,0,0,0,1000,-1000,-1000
059024,大立光統一9B購04,0,0,0,0,0,0,0,0,0,-1000,0,0,0,164000,165000,-1000,-1000
056217,A50正2中信99購02,0,0,0,0,0,0,0,0,0,-1000,0,0,0,0,1000,-1000,-1000
056214,義隆國票99購01  ,0,0,0,0,0,0,0,0,0,-1000,0,0,0,38000,39000,-1000,-1000
056205,貿聯永豐97購01  ,0,0,0,0,0,0,0,0,0,-1000,0,0,0,0,1000,-1000,-1000
056103,聯發科永豐97購03,0,0,0,0,0,0,0,0,0,-1000,0,0,0,75000,76000,-1000,-1000
052673,T50反1國泰97購01,0,0,0,0,0,0,0,0,0,-1000,0,0,0,0,1000,-1000,-1000
053287,臺股指元大96購15,0,0,0,0,0,0,0,0,0,-1000,0,0,0,0,1000,-1000,-1000
053339,友達國票97購02  ,0,0,0,0,0,0,0,0,0,-1000,0,0,0,0,1000,-1000,-1000
053317,友達群益9A購02  ,0,0,0,0,0,0,0,0,0,-1000,0,0,0,0,1000,-1000,-1000
053411,深中小國票9B購01,0,0,0,0,0,0,0,0,0,-1000,0,0,0,2000,3000,-1000,-1000
052610,貿聯元大97購01  ,0,0,0,0,0,0,0,0,0,-1000,0,0,0,0,1000,-1000,-1000
052617,景碩國泰98購01  ,0,0,0,0,0,0,0,0,0,-1000,0,0,0,0,1000,-1000,-1000
052890,FB上証群益9B購01,0,0,0,0,0,0,0,0,0,-1000,0,0,0,104000,105000,-1000,-1000
05241P,鴻海國泰97售04  ,0,0,0,0,0,0,0,0,0,-1000,0,0,0,231000,232000,-1000,-1000
056673,中石化元富9B購01,0,0,0,0,0,0,0,0,0,-1000,0,0,0,675000,676000,-1000,-1000
054268,健策第一96購01  ,0,0,0,0,0,0,0,0,0,-1000,0,0,0,0,1000,-1000,-1000
054270,寶滬深中信98購01,0,0,0,0,0,0,0,0,0,-1000,0,0,0,0,1000,-1000,-1000
055563,智易凱基97購02  ,0,0,0,0,0,0,0,0,0,-1000,0,0,0,0,1000,-1000,-1000
053040,全新凱基98購01  ,0,0,0,0,0,0,0,0,0,-1000,0,0,0,0,1000,-1000,-1000
053080,力山元大96購02  ,0,0,0,0,0,0,0,0,0,-1000,0,0,0,23000,24000,-1000,-1000
053137,旺宏富邦98購01  ,0,0,0,0,0,0,0,0,0,-1000,0,0,0,0,1000,-1000,-1000
055387,世紀鋼元大97購01,0,0,0,0,0,0,0,0,0,-1000,0,0,0,0,1000,-1000,-1000
051424,緯穎國票97購01  ,0,0,0,0,0,0,0,0,0,-1000,0,0,0,0,1000,-1000,-1000
051482,玉晶光凱基96購01,0,0,0,0,0,0,0,0,0,-1000,0,0,0,5000,6000,-1000,-1000
03026X,元展23          ,0,0,0,0,0,0,0,0,0,-1000,0,0,0,0,1000,-1000,-1000
03429B,臺股指元富97熊07,0,0,0,0,0,0,0,0,0,-1000,0,0,0,0,1000,-1000,-1000
03017X,元展17          ,0,0,0,0,0,0,0,0,0,-1000,0,0,0,0,1000,-1000,-1000
00732,國泰RMB短期報酬 ,0,1000,-1000,0,0,0,0,0,0,0,0,0,0,100000,100000,0,-1000
00742,新光內需收益    ,0,0,0,0,0,0,0,0,0,-1000,0,0,0,268000,269000,-1000,-1000
00689R,國泰20年美債反1 ,1000,0,1000,0,0,0,0,0,0,-2000,0,0,0,100000,102000,-2000,-1000
05218P,大立光永昌96售04,0,0,0,0,0,0,0,0,0,-1000,0,0,0,0,1000,-1000,-1000
053769,香港反元大99購01,0,0,0,0,0,0,0,0,0,-1000,0,0,0,19000,20000,-1000,-1000
048414,滬深2X統一98購01,0,0,0,0,0,0,0,0,0,-1000,0,0,0,0,1000,-1000,-1000
060057,欣興凱基9B購01  ,0,0,0,0,0,0,0,0,0,-1000,0,0,0,0,1000,-1000,-1000
060027,元金2X永豐99購02,0,0,0,0,0,0,0,0,0,-1000,0,0,0,0,1000,-1000,-1000
056897,南亞科元大98購02,0,0,0,0,0,0,0,0,0,-1000,0,0,0,68000,69000,-1000,-1000
059973,A50正2元大99購02,0,0,0,0,0,0,0,0,0,-1000,0,0,0,0,1000,-1000,-1000
059937,旺宏永豐99購03  ,0,0,0,0,0,0,0,0,0,-1000,0,0,0,0,1000,-1000,-1000
059820,南亞科凱基99購07,0,0,0,0,0,0,0,0,0,-1000,0,0,0,0,1000,-1000,-1000
059868,台光電凱基99購03,0,0,0,0,0,0,0,0,0,-1000,0,0,0,0,1000,-1000,-1000
059866,國巨凱基99購18  ,0,0,0,0,0,0,0,0,0,-1000,0,0,0,0,1000,-1000,-1000
057006,國巨中信98購03  ,0,0,0,0,0,0,0,0,0,-1000,0,0,0,0,1000,-1000,-1000
056987,南茂群益98購01  ,0,0,0,0,0,0,0,0,0,-1000,0,0,0,10000,11000,-1000,-1000
058070,華新科凱基98購07,0,0,0,0,0,0,0,0,0,-1000,0,0,0,0,1000,-1000,-1000
058097,台灣50國泰99購01,0,0,0,0,0,0,0,0,0,-1000,0,0,0,0,1000,-1000,-1000
057365,智邦元大98購07  ,0,0,0,0,0,0,0,0,0,-1000,0,0,0,1000,2000,-1000,-1000
05730P,臺股指凱基97售03,0,0,0,0,0,0,0,0,0,-1000,0,0,0,0,1000,-1000,-1000
059415,台灣50元大9A購03,0,0,0,0,0,0,0,0,0,-1000,0,0,0,5000,6000,-1000,-1000
057250,大立光統一98購08,0,0,0,0,0,0,0,0,0,-1000,0,0,0,0,1000,-1000,-1000
057283,欣興元大98購07  ,0,0,0,0,0,0,0,0,0,-1000,0,0,0,40000,41000,-1000,-1000
05804P,美律永豐96售01  ,0,0,0,0,0,0,0,0,0,-1000,0,0,0,0,1000,-1000,-1000
058897,國巨元大99購17  ,0,0,0,0,0,0,0,0,0,-1000,0,0,0,0,1000,-1000,-1000
058912,祥碩元大99購01  ,0,0,0,0,0,0,0,0,0,-1000,0,0,0,0,1000,-1000,-1000
059727,大立光元大9A購01,0,0,0,0,0,0,0,0,0,-1000,0,0,0,0,1000,-1000,-1000
059733,緯穎元大99購08  ,0,0,0,0,0,0,0,0,0,-1000,0,0,0,2000,3000,-1000,-1000
059613,泰鼎永豐99購02  ,0,0,0,0,0,0,0,0,0,-1000,0,0,0,15000,16000,-1000,-1000
057964,緯穎元大99購03  ,0,0,0,0,0,0,0,0,0,-1000,0,0,0,23000,24000,-1000,-1000
059378,台光電群益9B購01,0,0,0,0,0,0,0,0,0,-1000,0,0,0,0,1000,-1000,-1000
058960,臺股指國票99購05,0,0,0,0,0,0,0,0,0,-1000,0,0,0,0,1000,-1000,-1000
058946,SGBR2X群益9B購01,0,0,0,0,0,0,0,0,0,-1000,0,0,0,5000,6000,-1000,-1000
057573,京鼎永豐98購02  ,0,0,0,0,0,0,0,0,0,-1000,0,0,0,0,1000,-1000,-1000
057771,鴻海群益99購01  ,0,0,0,0,0,0,0,0,0,-1000,0,0,0,0,1000,-1000,-1000
058396,力山元大99購01  ,0,0,0,0,0,0,0,0,0,-1000,0,0,0,2000,3000,-1000,-1000
058430,滬深2X統一99購02,0,0,0,0,0,0,0,0,0,-1000,0,0,0,0,1000,-1000,-1000
058719,智邦元富99購01  ,0,0,0,0,0,0,0,0,0,-1000,0,0,0,0,1000,-1000,-1000
060111,臻鼎元大99購04  ,0,0,0,0,0,0,0,0,0,-1000,0,0,0,1000,2000,-1000,-1000
058360,台光電凱基9A購02,0,0,0,0,0,0,0,0,0,-1000,0,0,0,0,1000,-1000,-1000
058374,玉晶光凱基9A購03,0,0,0,0,0,0,0,0,0,-1000,0,0,0,118000,119000,-1000,-1000
057513,智邦台新98購01  ,0,0,0,0,0,0,0,0,0,-1000,0,0,0,0,1000,-1000,-1000
060379,T50反1凱基9A購07,0,0,0,0,0,0,0,0,0,-1000,0,0,0,0,1000,-1000,-1000
060174,T50反1元富04購01,0,0,0,0,0,0,0,0,0,-1000,0,0,0,6000,7000,-1000,-1000
060280,元金2X元大9A購01,0,0,0,0,0,0,0,0,0,-1000,0,0,0,0,1000,-1000,-1000
062027,國泰金群益9B購01,0,0,0,0,0,0,0,0,0,-1000,0,0,0,20000,21000,-1000,-1000
062066,元黃金元大9B購01,0,0,0,0,0,0,0,0,0,-1000,0,0,0,0,1000,-1000,-1000
062168,大毅永豐9B購01  ,0,0,0,0,0,0,0,0,0,-1000,0,0,0,0,1000,-1000,-1000
062154,國巨凱基9C購02  ,0,0,0,0,0,0,0,0,0,-1000,0,0,0,1000,2000,-1000,-1000
062176,元金2X元大9B購01,0,0,0,0,0,0,0,0,0,-1000,0,0,0,0,1000,-1000,-1000
062111,台勝科國票9B購01,0,0,0,0,0,0,0,0,0,-1000,0,0,0,8000,9000,-1000,-1000
062121,奇鋐台新9B購01  ,0,0,0,0,0,0,0,0,0,-1000,0,0,0,0,1000,-1000,-1000
06248P,國巨統一97售07  ,0,0,0,0,0,0,0,0,0,-1000,0,0,0,0,1000,-1000,-1000
06256P,臺股指群益97售09,0,0,0,0,0,0,0,0,0,-1000,0,0,0,0,1000,-1000,-1000
062554,台積電凱基9B購08,0,0,0,0,0,0,0,0,0,-1000,0,0,0,5000,6000,-1000,-1000
062300,T50反1中信03購02,0,0,0,0,0,0,0,0,0,-1000,0,0,0,0,1000,-1000,-1000
062381,上銀國泰9C購01  ,0,0,0,0,0,0,0,0,0,-1000,0,0,0,0,1000,-1000,-1000
06264P,友達凱基98售06  ,0,0,0,0,0,0,0,0,0,-1000,0,0,0,0,1000,-1000,-1000
062781,微星元大9C購01  ,0,0,0,0,0,0,0,0,0,-1000,0,0,0,129000,130000,-1000,-1000
063018,聯發科元大9B購14,0,0,0,0,0,0,0,0,0,-1000,0,0,0,26000,27000,-1000,-1000
062992,聯發科群益9B購09,0,0,0,0,0,0,0,0,0,-1000,0,0,0,4000,5000,-1000,-1000
061161,南六群益9A購01  ,0,0,0,0,0,0,0,0,0,-1000,0,0,0,0,1000,-1000,-1000
061189,可成富邦9B購02  ,0,0,0,0,0,0,0,0,0,-1000,0,0,0,0,1000,-1000,-1000
061044,世紀鋼永豐9A購02,0,0,0,0,0,0,0,0,0,-1000,0,0,0,0,1000,-1000,-1000
060627,國巨國泰9B購05  ,0,0,0,0,0,0,0,0,0,-1000,0,0,0,0,1000,-1000,-1000
060497,臺指反元大01購02,0,0,0,0,0,0,0,0,0,-1000,0,0,0,0,1000,-1000,-1000
060723,致新永豐9A購01  ,0,0,0,0,0,0,0,0,0,-1000,0,0,0,59000,60000,-1000,-1000
06066P,群創台新98售01  ,0,0,0,0,0,0,0,0,0,-1000,0,0,0,0,1000,-1000,-1000
060817,華邦電台新9A購01,0,0,0,0,0,0,0,0,0,-1000,0,0,0,198000,199000,-1000,-1000
060767,世紀鋼元大9A購02,0,0,0,0,0,0,0,0,0,-1000,0,0,0,25000,26000,-1000,-1000
061561,義隆國票9A購02  ,0,0,0,0,0,0,0,0,0,-1000,0,0,0,0,1000,-1000,-1000
061304,創意永豐9A購02  ,0,0,0,0,0,0,0,0,0,-1000,0,0,0,0,1000,-1000,-1000
061288,大立光統一9C購01,0,0,0,0,0,0,0,0,0,-1000,0,0,0,0,1000,-1000,-1000
061771,玉晶光元大9C購04,0,0,0,0,0,0,0,0,0,-1000,0,0,0,72000,73000,-1000,-1000
061943,上銀群益9B購02  ,0,0,0,0,0,0,0,0,0,-1000,0,0,0,0,1000,-1000,-1000
061860,臺股指國票9B購04,0,0,0,0,0,0,0,0,0,-1000,0,0,0,8000,9000,-1000,-1000
061799,奇鋐永豐9B購01  ,0,0,0,0,0,0,0,0,0,-1000,0,0,0,0,1000,-1000,-1000
6172,互億            ,5000,6000,-1000,0,0,0,0,0,0,0,0,0,0,0,0,0,-1000
4912,聯德控股-KY     ,20000,22000,-2000,0,0,0,0,0,0,1000,1000,0,1000,0,0,0,-1000
4572,駐龍            ,2000,3000,-1000,0,0,0,0,0,0,0,0,0,0,0,0,0,-1000
3058,立德            ,4000,5000,-1000,0,0,0,0,0,0,0,0,0,0,0,0,0,-1000
3383,新世紀          ,0,1000,-1000,0,0,0,0,0,0,0,0,0,0,0,0,0,-1000
8442,威宏-KY         ,0,0,0,0,0,0,0,0,0,-1000,1000,2000,-1000,0,0,0,-1000
6405,悅城            ,1000,3000,-2000,0,0,0,0,0,0,1000,1000,0,1000,0,0,0,-1000
6668,中揚光          ,47000,61000,-14000,0,0,0,0,0,0,13000,13000,0,13000,0,0,0,-1000
1727,中華化          ,3000,6000,-3000,0,0,0,0,0,0,1000,1000,0,1000,0,0,0,-2000
1615,大山            ,3000,6000,-3000,0,0,0,0,0,0,1000,1000,0,1000,0,0,0,-2000
1521,大億            ,6000,8000,-2000,0,0,0,0,0,0,0,0,0,0,0,0,0,-2000
08303P,聯發科富邦9C售05,0,0,0,0,0,0,0,0,0,-2000,0,0,0,0,2000,-2000,-2000
08162P,台灣50台新9C售06,0,0,0,0,0,0,0,0,0,-2000,0,0,0,0,2000,-2000,-2000
08000P,奇鋐凱基9B售03  ,0,0,0,0,0,0,0,0,0,-2000,0,0,0,0,2000,-2000,-2000
07974P,上証2X元大9B售02,0,0,0,0,0,0,0,0,0,-2000,0,0,0,0,2000,-2000,-2000
07474P,滬深2X群益9C售03,0,0,0,0,0,0,0,0,0,-2000,0,0,0,0,2000,-2000,-2000
07429P,臺股指國票9A售01,0,0,0,0,0,0,0,0,0,-2000,0,0,0,0,2000,-2000,-2000
07444P,聯發科凱基9A售10,0,0,0,0,0,0,0,0,0,-2000,0,0,0,0,2000,-2000,-2000
07295P,滬深2X元富9C售09,0,0,0,0,0,0,0,0,0,-2000,0,0,0,0,2000,-2000,-2000
07370P,南亞科凱基99售08,0,0,0,0,0,0,0,0,0,-2000,0,0,0,0,2000,-2000,-2000
07548P,台灣50元大9A售12,0,0,0,0,0,0,0,0,0,-2000,0,0,0,0,2000,-2000,-2000
07558P,玉晶光元大9A售10,0,0,0,0,0,0,0,0,0,-2000,0,0,0,10000,12000,-2000,-2000
063840,鴻海元大01購01  ,0,0,0,0,0,0,0,0,0,-2000,0,0,0,7000,9000,-2000,-2000
063822,聯發科麥證01購01,0,0,0,0,2000,-2000,0,0,0,-2000,0,0,0,0,2000,-2000,-2000
063279,國巨元大9C購05  ,0,0,0,0,0,0,0,0,0,-2000,0,0,0,2000,4000,-2000,-2000
06350P,臺股指台新99售02,0,0,0,0,0,0,0,0,0,-2000,0,0,0,0,2000,-2000,-2000
063973,緯穎國票9C購01  ,0,0,0,0,0,0,0,0,0,-2000,0,0,0,0,2000,-2000,-2000
063946,聯發科元大9C購04,0,0,0,0,0,0,0,0,0,-2000,0,0,0,0,2000,-2000,-2000
063957,臻鼎元大9C購01  ,0,0,0,0,0,0,0,0,0,-2000,0,0,0,0,2000,-2000,-2000
063873,南六永豐9C購01  ,0,0,0,0,0,0,0,0,0,-2000,0,0,0,137000,139000,-2000,-2000
063856,臺股指元大9C購09,0,0,0,0,0,0,0,0,0,-2000,0,0,0,0,2000,-2000,-2000
06722P,臺股指中信9A售04,0,0,0,0,0,0,0,0,0,-2000,0,0,0,0,2000,-2000,-2000
06646P,國巨元大98售16  ,0,0,0,0,0,0,0,0,0,-2000,0,0,0,0,2000,-2000,-2000
07166P,台灣50兆豐03售01,0,0,0,0,0,0,0,0,0,-2000,0,0,0,0,2000,-2000,-2000
07083P,台積電統一9A售06,0,0,0,0,0,0,0,0,0,-2000,0,0,0,0,2000,-2000,-2000
07242P,台灣50凱基9A售03,0,0,0,0,0,0,0,0,0,-2000,0,0,0,0,2000,-2000,-2000
06779P,智邦元大98售12  ,0,0,0,0,0,0,0,0,0,-2000,0,0,0,28000,30000,-2000,-2000
06782P,大立光元大99售07,0,0,0,0,0,0,0,0,0,-2000,0,0,0,0,2000,-2000,-2000
06784P,臺股指元大98售01,0,0,0,0,0,0,0,0,0,-2000,0,0,0,0,2000,-2000,-2000
049759,元黃金富邦9A購01,0,0,0,0,0,0,0,0,0,-2000,0,0,0,0,2000,-2000,-2000
049593,群創元大9A購01  ,0,0,0,0,0,0,0,0,0,-2000,0,0,0,0,2000,-2000,-2000
03677C,臺股指元大05牛02,0,0,0,0,0,0,0,0,0,-2000,0,0,0,3000,5000,-2000,-2000
03681C,台灣50凱基02牛02,0,0,0,0,0,0,0,0,0,-2000,0,0,0,18000,20000,-2000,-2000
051838,國巨國泰97購01  ,0,0,0,0,0,0,0,0,0,-2000,0,0,0,48000,50000,-2000,-2000
00774B,新光中國政金綠債,0,0,0,0,0,0,0,0,0,-2000,0,0,0,2000,4000,-2000,-2000
00663L,國泰臺灣加權正2 ,12000,21000,-9000,0,0,0,0,0,0,7000,0,0,0,55000,48000,7000,-2000
050402,緯穎中信96購01  ,0,0,0,0,0,0,0,0,0,-2000,0,0,0,10000,12000,-2000,-2000
053158,茂林元大96購01  ,0,0,0,0,0,0,0,0,0,-2000,0,0,0,51000,53000,-2000,-2000
055411,國巨富邦9A購02  ,0,0,0,0,0,0,0,0,0,-2000,0,0,0,0,2000,-2000,-2000
053022,欣興國泰98購01  ,0,0,0,0,0,0,0,0,0,-2000,0,0,0,0,2000,-2000,-2000
053057,聯電國泰97購02  ,0,0,0,0,0,0,0,0,0,-2000,0,0,0,1126000,1128000,-2000,-2000
053677,同欣電國泰97購01,0,0,0,0,0,0,0,0,0,-2000,0,0,0,4000,6000,-2000,-2000
056412,上証2X中信9A購02,0,0,0,0,0,0,0,0,0,-2000,0,0,0,0,2000,-2000,-2000
055521,S&P反1群益01購01,0,0,0,0,0,0,0,0,0,-2000,0,0,0,0,2000,-2000,-2000
054291,高鐵元大97購01  ,0,0,0,0,0,0,0,0,0,-2000,0,0,0,0,2000,-2000,-2000
055446,奇力新統一9A購01,0,0,0,0,0,0,0,0,0,-2000,0,0,0,0,2000,-2000,-2000
054231,國巨群益98購03  ,0,0,0,0,0,0,0,0,0,-2000,0,0,0,12000,14000,-2000,-2000
053443,智邦凱基97購01  ,0,0,0,0,0,0,0,0,0,-2000,0,0,0,16000,18000,-2000,-2000
056079,世紀鋼元大97購02,0,0,0,0,0,0,0,0,0,-2000,0,0,0,0,2000,-2000,-2000
056237,智邦群益97購02  ,0,0,0,0,0,0,0,0,0,-2000,0,0,0,0,2000,-2000,-2000
059360,全新永豐99購02  ,0,0,0,0,0,0,0,0,0,-2000,0,0,0,4000,6000,-2000,-2000
054588,玉晶光國泰99購02,0,0,0,0,0,0,0,0,0,-2000,0,0,0,0,2000,-2000,-2000
055671,世紀鋼群益97購01,0,0,0,0,0,0,0,0,0,-2000,0,0,0,0,2000,-2000,-2000
054840,T50反1兆豐98購01,0,0,0,0,0,0,0,0,0,-2000,0,0,0,0,2000,-2000,-2000
056554,GIS凱基99購01   ,0,0,0,0,0,0,0,0,0,-2000,0,0,0,0,2000,-2000,-2000
054772,康控國票98購02  ,0,0,0,0,0,0,0,0,0,-2000,0,0,0,0,2000,-2000,-2000
054933,南港元大97購01  ,0,0,0,0,0,0,0,0,0,-2000,0,0,0,0,2000,-2000,-2000
055108,智邦凱基98購01  ,0,0,0,0,0,0,0,0,0,-2000,0,0,0,0,2000,-2000,-2000
060311,盟立永豐9A購01  ,0,0,0,0,0,0,0,0,0,-2000,0,0,0,0,2000,-2000,-2000
060170,世紀鋼永豐9A購01,0,0,0,0,0,0,0,0,0,-2000,0,0,0,10000,12000,-2000,-2000
058284,滬深反群益01購01,0,0,0,0,0,0,0,0,0,-2000,0,0,0,0,2000,-2000,-2000
058220,世芯國票9A購01  ,0,0,0,0,0,0,0,0,0,-2000,0,0,0,0,2000,-2000,-2000
057433,上銀國票98購04  ,0,0,0,0,0,0,0,0,0,-2000,0,0,0,0,2000,-2000,-2000
058314,欣興富邦9B購01  ,0,0,0,0,0,0,0,0,0,-2000,0,0,0,2000,4000,-2000,-2000
058349,滬深2X日盛9A購01,0,0,0,0,0,0,0,0,0,-2000,0,0,0,0,2000,-2000,-2000
060105,牧德元大9B購01  ,0,0,0,0,0,0,0,0,0,-2000,0,0,0,8000,10000,-2000,-2000
060092,瑞昱元大99購03  ,0,0,0,0,0,0,0,0,0,-2000,0,0,0,1000,3000,-2000,-2000
060073,台積電元富99購03,0,0,0,0,0,0,0,0,0,-2000,0,0,0,0,2000,-2000,-2000
058651,FBVIX中信9C購01 ,0,0,0,0,0,0,0,0,0,-2000,0,0,0,2000,4000,-2000,-2000
058574,台積電群益99購03,0,0,0,0,0,0,0,0,0,-2000,0,0,0,5000,7000,-2000,-2000
057843,晶技永豐98購02  ,0,0,0,0,0,0,0,0,0,-2000,0,0,0,0,2000,-2000,-2000
057719,欣興元富02購01  ,0,0,0,0,0,0,0,0,0,-2000,0,0,0,48000,50000,-2000,-2000
057577,廣宇中信9A購01  ,0,0,0,0,0,0,0,0,0,-2000,0,0,0,0,2000,-2000,-2000
059383,台灣50凱基99購03,0,0,0,0,0,0,0,0,0,-2000,0,0,0,0,2000,-2000,-2000
058777,台光電國票9A購01,0,0,0,0,0,0,0,0,0,-2000,0,0,0,0,2000,-2000,-2000
058786,元黃金元大99購01,0,0,0,0,0,0,0,0,0,-2000,0,0,0,0,2000,-2000,-2000
05793P,臺股指中信99售08,0,0,0,0,0,0,0,0,0,-2000,0,0,0,0,2000,-2000,-2000
059770,A50正2群益9C購01,0,0,0,0,0,0,0,0,0,-2000,0,0,0,0,2000,-2000,-2000
057230,建準凱基98購02  ,0,0,0,0,0,0,0,0,0,-2000,0,0,0,0,2000,-2000,-2000
059466,國巨元大99購26  ,0,0,0,0,0,0,0,0,0,-2000,0,0,0,0,2000,-2000,-2000
057118,欣興日盛9A購01  ,0,0,0,0,0,0,0,0,0,-2000,0,0,0,5000,7000,-2000,-2000
056963,建準永豐98購01  ,0,0,0,0,0,0,0,0,0,-2000,0,0,0,0,2000,-2000,-2000
060058,牧德凱基9B購01  ,0,0,0,0,0,0,0,0,0,-2000,0,0,0,0,2000,-2000,-2000
061719,緯穎凱基9A購06  ,0,0,0,0,0,0,0,0,0,-2000,0,0,0,0,2000,-2000,-2000
061404,臺指反國票04購01,0,0,0,0,0,0,0,0,0,-2000,0,0,0,1000,3000,-2000,-2000
061504,祥碩國票9A購02  ,0,0,0,0,0,0,0,0,0,-2000,0,0,0,1000,3000,-2000,-2000
060812,智邦凱基9A購01  ,0,0,0,0,0,0,0,0,0,-2000,0,0,0,10000,12000,-2000,-2000
060520,臺指2X中信01購02,0,0,0,0,0,0,0,0,0,-2000,0,0,0,0,2000,-2000,-2000
060877,華邦電中信02購01,0,0,0,0,0,0,0,0,0,-2000,0,0,0,20000,22000,-2000,-2000
060903,臺指反元大9A購01,0,0,0,0,0,0,0,0,0,-2000,0,0,0,0,2000,-2000,-2000
060913,宏達電元大9A購03,0,0,0,0,0,0,0,0,0,-2000,0,0,0,68000,70000,-2000,-2000
061182,南六凱基9A購01  ,0,0,0,0,0,0,0,0,0,-2000,0,0,0,31000,33000,-2000,-2000
061108,臻鼎元大9A購02  ,0,0,0,0,0,0,0,0,0,-2000,0,0,0,10000,12000,-2000,-2000
061130,牧德永豐9A購04  ,0,0,0,0,0,0,0,0,0,-2000,0,0,0,0,2000,-2000,-2000
06294P,臺股指國票97售08,0,0,0,0,0,0,0,0,0,-2000,0,0,0,5000,7000,-2000,-2000
063045,國巨兆豐9C購02  ,0,0,0,0,0,0,0,0,0,-2000,0,0,0,15000,17000,-2000,-2000
062765,祥碩凱基9B購04  ,0,0,0,0,0,0,0,0,0,-2000,0,0,0,10000,12000,-2000,-2000
062770,臺股指凱基9B購14,0,0,0,0,0,0,0,0,0,-2000,0,0,0,1000,3000,-2000,-2000
062844,T50反1國泰9C購01,0,0,0,0,0,0,0,0,0,-2000,0,0,0,0,2000,-2000,-2000
062629,聯發科國票9C購01,0,0,0,0,0,0,0,0,0,-2000,0,0,0,0,2000,-2000,-2000
062551,緯穎永豐9B購02  ,0,0,0,0,0,0,0,0,0,-2000,0,0,0,0,2000,-2000,-2000
06245P,健策元富97售03  ,0,0,0,0,0,0,0,0,0,-2000,0,0,0,0,2000,-2000,-2000
062065,台灣50元大9B購14,0,0,0,0,0,0,0,0,0,-2000,0,0,0,0,2000,-2000,-2000
062032,崇越群益9B購01  ,0,0,0,0,0,0,0,0,0,-2000,0,0,0,0,2000,-2000,-2000
062014,牧德富邦9C購01  ,0,0,0,0,0,0,0,0,0,-2000,0,0,0,0,2000,-2000,-2000
061970,大立光統一9C購03,0,0,0,0,0,0,0,0,0,-2000,0,0,0,35000,37000,-2000,-2000
6451,訊芯-KY         ,160000,153000,7000,0,0,0,0,2000,-2000,-7000,2000,1000,1000,0,8000,-8000,-2000
911868,同方友友-DR     ,0,2000,-2000,0,0,0,0,0,0,0,0,0,0,0,0,0,-2000
4581,光隆精密-KY     ,0,2000,-2000,0,0,0,0,0,0,0,0,0,0,0,0,0,-2000
06861P,台積電國票99售08,0,0,0,0,0,0,0,0,0,-3000,0,0,0,0,3000,-3000,-3000
07222P,台灣50元大01售04,0,0,0,0,0,0,0,0,0,-3000,0,0,0,0,3000,-3000,-3000
06723P,台灣50麥證99售01,0,0,0,0,3000,-3000,0,0,0,-3000,0,0,0,0,3000,-3000,-3000
06631P,玉晶光群益9A售03,0,0,0,0,0,0,0,0,0,-3000,0,0,0,5000,8000,-3000,-3000
063896,世芯群益9C購01  ,0,0,0,0,0,0,0,0,0,-3000,0,0,0,25000,28000,-3000,-3000
063981,貿聯兆豐9C購01  ,0,0,0,0,0,0,0,0,0,-3000,0,0,0,0,3000,-3000,-3000
06513P,鴻海凱基98售10  ,0,0,0,0,0,0,0,0,0,-3000,0,0,0,0,3000,-3000,-3000
07388P,臺股指群益9C售07,0,0,0,0,0,0,0,0,0,-3000,0,0,0,0,3000,-3000,-3000
07913P,友達元大01售01  ,0,0,0,0,0,0,0,0,0,-3000,0,0,0,7000,10000,-3000,-3000
07890P,南電國票9B售01  ,0,0,0,0,0,0,0,0,0,-3000,0,0,0,7000,10000,-3000,-3000
07818P,台積電國票9C售01,0,0,0,0,0,0,0,0,0,-3000,0,0,0,0,3000,-3000,-3000
08043P,電子類群益9B售01,0,0,0,0,0,0,0,0,0,-3000,0,0,0,0,3000,-3000,-3000
08141P,鴻海凱基9B售09  ,0,0,0,0,0,0,0,0,0,-3000,0,0,0,0,3000,-3000,-3000
08269P,臺股指元大9C售07,0,0,0,0,0,0,0,0,0,-3000,0,0,0,0,3000,-3000,-3000
2024,志聯            ,1000,5000,-4000,0,0,0,0,0,0,1000,1000,0,1000,0,0,0,-3000
2397,友通            ,5000,9000,-4000,0,0,0,0,0,0,1000,1000,0,1000,0,0,0,-3000
2351,順德            ,1000,23000,-22000,0,0,0,20000,0,20000,-1000,0,1000,-1000,0,0,0,-3000
054319,世紀鋼凱基96購02,0,0,0,0,0,0,0,0,0,-3000,0,0,0,7000,10000,-3000,-3000
056362,聯發科元大99購01,0,0,0,0,0,0,0,0,0,-3000,0,0,0,11000,14000,-3000,-3000
056344,嘉晶凱基98購02  ,0,0,0,0,0,0,0,0,0,-3000,0,0,0,0,3000,-3000,-3000
055400,緯穎統一97購01  ,0,0,0,0,0,0,0,0,0,-3000,0,0,0,0,3000,-3000,-3000
03052X,元展49          ,0,0,0,0,0,0,0,0,0,-3000,0,0,0,0,3000,-3000,-3000
05124P,華新科富邦97售02,0,0,0,0,0,0,0,0,0,-3000,0,0,0,0,3000,-3000,-3000
042792,T50反1台新9C購01,0,0,0,0,0,0,0,0,0,-3000,0,0,0,1000,4000,-3000,-3000
053782,京元電元大98購02,0,0,0,0,0,0,0,0,0,-3000,0,0,0,32000,35000,-3000,-3000
04854P,鴻海國泰96售04  ,0,0,0,0,0,0,0,0,0,-3000,0,0,0,28000,31000,-3000,-3000
059872,華新科凱基01購01,0,0,0,0,0,0,0,0,0,-3000,0,0,0,43000,46000,-3000,-3000
059990,健策元大9A購01  ,0,0,0,0,0,0,0,0,0,-3000,0,0,0,2000,5000,-3000,-3000
05709P,大立光國票97售01,0,0,0,0,0,0,0,0,0,-3000,0,0,0,7000,10000,-3000,-3000
057303,喬山兆豐99購01  ,0,0,0,0,0,0,0,0,0,-3000,0,0,0,0,3000,-3000,-3000
058023,南電凱基98購02  ,0,0,0,0,0,0,0,0,0,-3000,0,0,0,3000,6000,-3000,-3000
059731,康控元大99購04  ,0,0,0,0,0,0,0,0,0,-3000,0,0,0,45000,48000,-3000,-3000
057970,國巨富邦99購03  ,0,0,0,0,0,0,0,0,0,-3000,0,0,0,0,3000,-3000,-3000
05899P,臺股指凱基96售30,0,0,0,0,0,0,0,0,0,-3000,0,0,0,2000,5000,-3000,-3000
05820P,臺股指凱基96售17,0,0,0,0,0,0,0,0,0,-3000,0,0,0,0,3000,-3000,-3000
057555,玉晶光凱基9A購02,0,0,0,0,0,0,0,0,0,-3000,0,0,0,2000,5000,-3000,-3000
057860,金寶凱基98購01  ,0,0,0,0,0,0,0,0,0,-3000,0,0,0,12000,15000,-3000,-3000
057833,聯發科元富02購06,0,0,0,0,0,0,0,0,0,-3000,0,0,0,5000,8000,-3000,-3000
058621,華通國票9A購01  ,0,0,0,0,0,0,0,0,0,-3000,0,0,0,0,3000,-3000,-3000
058473,上銀凱基9A購03  ,0,0,0,0,0,0,0,0,0,-3000,0,0,0,27000,30000,-3000,-3000
058750,緯穎凱基9A購03  ,0,0,0,0,0,0,0,0,0,-3000,0,0,0,33000,36000,-3000,-3000
05739P,臺股指統一97售02,0,0,0,0,0,0,0,0,0,-3000,0,0,0,2000,5000,-3000,-3000
058352,鴻海凱基9A購05  ,0,0,0,0,0,0,0,0,0,-3000,0,0,0,4000,7000,-3000,-3000
058332,鴻海元富99購03  ,0,0,0,0,0,0,0,0,0,-3000,0,0,0,0,3000,-3000,-3000
058311,緯穎元大99購05  ,0,0,0,0,0,0,0,0,0,-3000,0,0,0,97000,100000,-3000,-3000
057428,正崴兆豐98購01  ,0,0,0,0,0,0,0,0,0,-3000,0,0,0,124000,127000,-3000,-3000
057478,智邦元大99購01  ,0,0,0,0,0,0,0,0,0,-3000,0,0,0,7000,10000,-3000,-3000
057503,世紀鋼群益98購02,0,0,0,0,0,0,0,0,0,-3000,0,0,0,0,3000,-3000,-3000
060144,全新國票9B購01  ,0,0,0,0,0,0,0,0,0,-3000,0,0,0,3000,6000,-3000,-3000
060145,牧德國票9A購02  ,0,0,0,0,0,0,0,0,0,-3000,0,0,0,38000,41000,-3000,-3000
060317,台灣50群益02購01,0,0,0,0,0,0,0,0,0,-3000,0,0,0,5000,8000,-3000,-3000
060234,凱美元大9C購01  ,0,0,0,0,0,0,0,0,0,-3000,0,0,0,61000,64000,-3000,-3000
06024P,台郡國票97售05  ,0,0,0,0,0,0,0,0,0,-3000,0,0,0,0,3000,-3000,-3000
060464,台積電元大9A購11,0,0,0,0,0,0,0,0,0,-3000,0,0,0,0,3000,-3000,-3000
062112,祥碩國票9C購01  ,0,0,0,0,0,0,0,0,0,-3000,0,0,0,10000,13000,-3000,-3000
062163,大毅國泰01購01  ,0,0,0,0,0,0,0,0,0,-3000,0,0,0,344000,347000,-3000,-3000
062438,台光電元大9B購04,0,0,0,0,0,0,0,0,0,-3000,0,0,0,119000,122000,-3000,-3000
062576,華擎群益9B購02  ,0,0,0,0,0,0,0,0,0,-3000,0,0,0,138000,141000,-3000,-3000
062609,帆宣凱基9B購01  ,0,0,0,0,0,0,0,0,0,-3000,0,0,0,1000,4000,-3000,-3000
062654,技嘉永豐9B購01  ,0,0,0,0,0,0,0,0,0,-3000,0,0,0,0,3000,-3000,-3000
062873,國巨兆豐9C購01  ,0,0,0,0,0,0,0,0,0,-3000,0,0,0,0,3000,-3000,-3000
062789,臺股指元大9B購32,0,0,0,0,0,0,0,0,0,-3000,0,0,0,0,3000,-3000,-3000
062940,華新科凱基9C購02,0,0,0,0,0,0,0,0,0,-3000,0,0,0,3000,6000,-3000,-3000
061255,道瓊反凱基9C購01,0,0,0,0,0,0,0,0,0,-3000,0,0,0,0,3000,-3000,-3000
060517,臺股指元大9B購14,0,0,0,0,0,0,0,0,0,-3000,0,0,0,0,3000,-3000,-3000
060536,祥碩麥證9A購01  ,0,0,0,0,3000,-3000,0,0,0,-3000,0,0,0,0,3000,-3000,-3000
060578,臺股指中信9C購03,0,0,0,0,0,0,0,0,0,-3000,0,0,0,2000,5000,-3000,-3000
060819,國巨統一9C購04  ,0,0,0,0,0,0,0,0,0,-3000,0,0,0,0,3000,-3000,-3000
060779,臺股指凱基9A購07,0,0,0,0,0,0,0,0,0,-3000,0,0,0,7000,10000,-3000,-3000
060795,世芯永豐9A購02  ,0,0,0,0,0,0,0,0,0,-3000,0,0,0,101000,104000,-3000,-3000
060675,南亞科元大9A購02,0,0,0,0,0,0,0,0,0,-3000,0,0,0,68000,71000,-3000,-3000
061448,旺宏中信9A購02  ,0,0,0,0,0,0,0,0,0,-3000,0,0,0,0,3000,-3000,-3000
061588,聯發科富邦9B購07,0,0,0,0,0,0,0,0,0,-3000,0,0,0,0,3000,-3000,-3000
061689,國巨群益9A購12  ,0,0,0,0,0,0,0,0,0,-3000,0,0,0,3000,6000,-3000,-3000
06168P,台表科國票97售06,0,0,0,0,0,0,0,0,0,-3000,0,0,0,17000,20000,-3000,-3000
061909,台積電中信05購02,0,0,0,0,0,0,0,0,0,-3000,0,0,0,7000,10000,-3000,-3000
4555,氣立            ,47000,73000,-26000,0,0,0,0,0,0,23000,24000,1000,23000,0,0,0,-3000
5515,建國            ,57000,63000,-6000,0,0,0,0,0,0,3000,3000,0,3000,0,0,0,-3000
3130,一零四          ,0,3000,-3000,0,0,0,0,0,0,0,0,0,0,0,0,0,-3000
6715,嘉基            ,8000,11000,-3000,0,0,0,0,0,0,0,0,0,0,0,0,0,-3000
6278,台表科          ,551000,891669,-340669,0,0,0,103000,0,103000,234000,152000,20000,132000,165000,63000,102000,-3669
2430,燦坤            ,5000,14000,-9000,0,0,0,0,0,0,5000,5000,0,5000,0,0,0,-4000
08116P,臺股指凱基9B售17,0,0,0,0,0,0,0,0,0,-4000,0,0,0,0,4000,-4000,-4000
07923P,元金2X凱基02售02,0,0,0,0,0,0,0,0,0,-4000,0,0,0,0,4000,-4000,-4000
07912P,玉晶光統一9B售02,0,0,0,0,0,0,0,0,0,-4000,0,0,0,2000,6000,-4000,-4000
07958P,華擎群益9B售01  ,0,0,0,0,0,0,0,0,0,-4000,0,0,0,0,4000,-4000,-4000
07389P,臺股指群益9C售08,0,0,0,0,0,0,0,0,0,-4000,0,0,0,1000,5000,-4000,-4000
07359P,台積電元大99售45,0,0,0,0,0,0,0,0,0,-4000,0,0,0,10000,14000,-4000,-4000
07666P,台灣50元大9C售32,0,0,0,0,0,0,0,0,0,-4000,0,0,0,0,4000,-4000,-4000
07757P,國巨國票9B售04  ,0,0,0,0,0,0,0,0,0,-4000,0,0,0,0,4000,-4000,-4000
07673P,電子類元大9A售01,0,0,0,0,0,0,0,0,0,-4000,0,0,0,0,4000,-4000,-4000
063983,麗豐兆豐9C購01  ,0,0,0,0,0,0,0,0,0,-4000,0,0,0,0,4000,-4000,-4000
063870,健策永豐01購01  ,0,0,0,0,0,0,0,0,0,-4000,0,0,0,16000,20000,-4000,-4000
06394P,台積電元大97售28,0,0,0,0,0,0,0,0,0,-4000,0,0,0,1000,5000,-4000,-4000
07238P,台灣50國票99售07,0,0,0,0,0,0,0,0,0,-4000,0,0,0,0,4000,-4000,-4000
07283P,華新科凱基99售07,0,0,0,0,0,0,0,0,0,-4000,0,0,0,0,4000,-4000,-4000
07008P,台郡中信99售02  ,0,0,0,0,0,0,0,0,0,-4000,0,0,0,0,4000,-4000,-4000
06991P,矽創群益99售01  ,0,0,0,0,0,0,0,0,0,-4000,0,0,0,0,4000,-4000,-4000
06341P,大立光統一97售08,0,0,0,0,0,0,0,0,0,-4000,0,0,0,0,4000,-4000,-4000
063445,金像電統一9B購01,0,0,0,0,0,0,0,0,0,-4000,0,0,0,18000,22000,-4000,-4000
063324,道瓊反國票9B購03,0,0,0,0,0,0,0,0,0,-4000,0,0,0,0,4000,-4000,-4000
063561,上銀元大9B購08  ,0,0,0,0,0,0,0,0,0,-4000,0,0,0,0,4000,-4000,-4000
063642,茂林元大9B購08  ,0,0,0,0,0,0,0,0,0,-4000,0,0,0,55000,59000,-4000,-4000
03669C,滬深2X元富09牛01,0,0,0,0,0,0,0,0,0,-4000,0,0,0,2000,6000,-4000,-4000
054111,緯穎凱基97購01  ,0,0,0,0,0,0,0,0,0,-4000,0,0,0,38000,42000,-4000,-4000
03022X,富展01          ,0,0,0,0,0,0,0,0,0,-4000,0,0,0,0,4000,-4000,-4000
00657,國泰日經225     ,0,0,0,0,0,0,0,0,0,-4000,0,0,0,112000,116000,-4000,-4000
00641R,富邦日本反1     ,1000,18000,-17000,0,0,0,0,0,0,13000,0,0,0,409000,396000,13000,-4000
054250,漢唐元大96購04  ,0,0,0,0,0,0,0,0,0,-4000,0,0,0,46000,50000,-4000,-4000
054593,滬深2X永昌9A購01,0,0,0,0,0,0,0,0,0,-4000,0,0,0,0,4000,-4000,-4000
054923,晶技凱基98購01  ,0,0,0,0,0,0,0,0,0,-4000,0,0,0,8000,12000,-4000,-4000
055030,帆宣國泰99購02  ,0,0,0,0,0,0,0,0,0,-4000,0,0,0,45000,49000,-4000,-4000
059489,上証2X國票9A購01,0,0,0,0,0,0,0,0,0,-4000,0,0,0,6000,10000,-4000,-4000
059117,禾伸堂永豐99購01,0,0,0,0,0,0,0,0,0,-4000,0,0,0,0,4000,-4000,-4000
055820,矽力國票98購02  ,0,0,0,0,0,0,0,0,0,-4000,0,0,0,29000,33000,-4000,-4000
055923,矽力凱基98購01  ,0,0,0,0,0,0,0,0,0,-4000,0,0,0,18000,22000,-4000,-4000
056588,聯發科統一9A購02,0,0,0,0,0,0,0,0,0,-4000,0,0,0,1000,5000,-4000,-4000
060373,元金2X元富9A購01,0,0,0,0,0,0,0,0,0,-4000,0,0,0,2000,6000,-4000,-4000
060066,欣興兆豐9B購01  ,0,0,0,0,0,0,0,0,0,-4000,0,0,0,0,4000,-4000,-4000
058437,可成統一9B購01  ,0,0,0,0,0,0,0,0,0,-4000,0,0,0,6000,10000,-4000,-4000
058749,康控凱基99購03  ,0,0,0,0,0,0,0,0,0,-4000,0,0,0,60000,64000,-4000,-4000
058610,欣興元大99購05  ,0,0,0,0,0,0,0,0,0,-4000,0,0,0,56000,60000,-4000,-4000
057703,矽力群益98購01  ,0,0,0,0,0,0,0,0,0,-4000,0,0,0,6000,10000,-4000,-4000
059674,玉山金元富99購02,0,0,0,0,0,0,0,0,0,-4000,0,0,0,1000,5000,-4000,-4000
057640,台積電元大98購16,0,0,0,0,0,0,0,0,0,-4000,0,0,0,0,4000,-4000,-4000
057078,國巨統一9A購02  ,0,0,0,0,0,0,0,0,0,-4000,0,0,0,0,4000,-4000,-4000
056763,國巨元大99購02  ,0,0,0,0,0,0,0,0,0,-4000,0,0,0,0,4000,-4000,-4000
056856,華通群益9A購01  ,0,0,0,0,0,0,0,0,0,-4000,0,0,0,37000,41000,-4000,-4000
061940,世紀鋼國票9C購01,0,0,0,0,0,0,0,0,0,-4000,0,0,0,1000,5000,-4000,-4000
061781,台積電群益9C購01,0,0,0,0,0,0,0,0,0,-4000,0,0,0,27000,31000,-4000,-4000
06178P,大立光第一99售01,0,0,0,0,0,0,0,0,0,-4000,0,0,0,0,4000,-4000,-4000
06139P,台積電中信99售02,0,0,0,0,0,0,0,0,0,-4000,0,0,0,3000,7000,-4000,-4000
061264,全新凱基9B購01  ,0,0,0,0,0,0,0,0,0,-4000,0,0,0,27000,31000,-4000,-4000
061239,聯發科兆豐9A購01,0,0,0,0,0,0,0,0,0,-4000,0,0,0,0,4000,-4000,-4000
061175,台積電凱基9A購19,0,0,0,0,0,0,0,0,0,-4000,0,0,0,0,4000,-4000,-4000
061204,國巨元大9A購16  ,0,0,0,0,0,0,0,0,0,-4000,0,0,0,2000,6000,-4000,-4000
062759,旺宏凱基9B購07  ,0,0,0,0,0,0,0,0,0,-4000,0,0,0,15000,19000,-4000,-4000
062478,牧德國票9B購03  ,0,0,0,0,0,0,0,0,0,-4000,0,0,0,3000,7000,-4000,-4000
062344,力山群益9B購02  ,0,0,0,0,0,0,0,0,0,-4000,0,0,0,153000,157000,-4000,-4000
6209,今國光          ,96000,103000,-7000,0,0,0,0,0,0,3000,3000,0,3000,0,0,0,-4000
8201,無敵            ,1000,5000,-4000,0,0,0,0,0,0,0,0,0,0,0,0,0,-4000
3419,譁裕            ,14000,21000,-7000,0,0,0,0,0,0,3000,3000,0,3000,0,0,0,-4000
4930,燦星網          ,7000,12000,-5000,0,0,0,0,0,0,1000,2000,1000,1000,0,0,0,-4000
063635,漢唐元大9B購04  ,0,0,0,0,0,0,0,0,0,-5000,0,0,0,0,5000,-5000,-5000
063617,鴻海兆豐01購01  ,0,0,0,0,0,0,0,0,0,-5000,0,0,0,0,5000,-5000,-5000
063682,達新永豐9B購01  ,0,0,0,0,0,0,0,0,0,-5000,0,0,0,0,5000,-5000,-5000
063845,旺宏元大9C購03  ,0,0,0,0,0,0,0,0,0,-5000,0,0,0,8000,13000,-5000,-5000
063854,南電元大9C購01  ,0,0,0,0,0,0,0,0,0,-5000,0,0,0,2000,7000,-5000,-5000
063379,帆宣永豐9B購01  ,0,0,0,0,0,0,0,0,0,-5000,0,0,0,0,5000,-5000,-5000
06957P,FBVIX凱基01售01 ,0,0,0,0,0,0,0,0,0,-5000,0,0,0,0,5000,-5000,-5000
06908P,健策國泰99售02  ,0,0,0,0,0,0,0,0,0,-5000,0,0,0,0,5000,-5000,-5000
07059P,華通國票9A售02  ,0,0,0,0,0,0,0,0,0,-5000,0,0,0,60000,65000,-5000,-5000
063942,台積電元大01購03,0,0,0,0,0,0,0,0,0,-5000,0,0,0,0,5000,-5000,-5000
063956,神達元大9C購01  ,0,0,0,0,0,0,0,0,0,-5000,0,0,0,130000,135000,-5000,-5000
063877,鴻海元富9C購01  ,0,0,0,0,0,0,0,0,0,-5000,0,0,0,0,5000,-5000,-5000
063878,國巨元富9C購01  ,0,0,0,0,0,0,0,0,0,-5000,0,0,0,0,5000,-5000,-5000
063881,嘉晶元富9C購01  ,0,0,0,0,0,0,0,0,0,-5000,0,0,0,0,5000,-5000,-5000
06502P,A50中信98售01   ,0,0,0,0,0,0,0,0,0,-5000,0,0,0,0,5000,-5000,-5000
06717P,可成元大98售09  ,0,0,0,0,0,0,0,0,0,-5000,0,0,0,0,5000,-5000,-5000
07657P,技嘉凱基9A售03  ,0,0,0,0,0,0,0,0,0,-5000,0,0,0,0,5000,-5000,-5000
07590P,玉晶光國票9A售03,0,0,0,0,0,0,0,0,0,-5000,0,0,0,0,5000,-5000,-5000
07358P,鴻海元大99售39  ,0,0,0,0,0,0,0,0,0,-5000,0,0,0,0,5000,-5000,-5000
07314P,T50正2元大9C售03,0,0,0,0,0,0,0,0,0,-5000,0,0,0,0,5000,-5000,-5000
07423P,大立光元大99售33,0,0,0,0,0,0,0,0,0,-5000,0,0,0,0,5000,-5000,-5000
07517P,台積電元大9A售17,0,0,0,0,0,0,0,0,0,-5000,0,0,0,0,5000,-5000,-5000
07952P,富邦金元大9B售02,0,0,0,0,0,0,0,0,0,-5000,0,0,0,0,5000,-5000,-5000
07907P,台灣50台新9B售08,0,0,0,0,0,0,0,0,0,-5000,0,0,0,0,5000,-5000,-5000
07918P,玉晶光永豐9B售04,0,0,0,0,0,0,0,0,0,-5000,0,0,0,0,5000,-5000,-5000
07900P,臺股指凱基9B售03,0,0,0,0,0,0,0,0,0,-5000,0,0,0,1000,6000,-5000,-5000
08086P,燿華凱基9B售03  ,0,0,0,0,0,0,0,0,0,-5000,0,0,0,0,5000,-5000,-5000
08048P,臺股指國票9B售13,0,0,0,0,0,0,0,0,0,-5000,0,0,0,0,5000,-5000,-5000
08016P,臺股指凱基02售02,0,0,0,0,0,0,0,0,0,-5000,0,0,0,0,5000,-5000,-5000
1537,廣隆            ,48000,53000,-5000,0,0,0,0,0,0,0,0,0,0,0,0,0,-5000
1707,葡萄王          ,88000,151000,-63000,0,0,0,0,0,0,58000,59000,2000,57000,3000,2000,1000,-5000
08275P,南亞科元富9C售01,0,0,0,0,0,0,0,0,0,-5000,0,0,0,20000,25000,-5000,-5000
1110,東泥            ,21000,26000,-5000,0,0,0,0,0,0,0,0,0,0,0,0,0,-5000
056590,樺漢統一9A購01  ,0,0,0,0,0,0,0,0,0,-5000,0,0,0,0,5000,-5000,-5000
056069,新日興元大97購03,0,0,0,0,0,0,0,0,0,-5000,0,0,0,5000,10000,-5000,-5000
055853,群創元大98購03  ,0,0,0,0,0,0,0,0,0,-5000,0,0,0,0,5000,-5000,-5000
05629P,聯發科永昌99售02,0,0,0,0,0,0,0,0,0,-5000,0,0,0,0,5000,-5000,-5000
056656,華邦電元大98購02,0,0,0,0,0,0,0,0,0,-5000,0,0,0,0,5000,-5000,-5000
056136,京鼎元大98購01  ,0,0,0,0,0,0,0,0,0,-5000,0,0,0,74000,79000,-5000,-5000
059148,百和國票9A購01  ,0,0,0,0,0,0,0,0,0,-5000,0,0,0,0,5000,-5000,-5000
059473,T50反1群益99購03,0,0,0,0,0,0,0,0,0,-5000,0,0,0,0,5000,-5000,-5000
055090,國巨群益97購03  ,0,0,0,0,0,0,0,0,0,-5000,0,0,0,0,5000,-5000,-5000
054952,大毅元大97購02  ,0,0,0,0,0,0,0,0,0,-5000,0,0,0,0,5000,-5000,-5000
054974,台表科元大98購02,0,0,0,0,0,0,0,0,0,-5000,0,0,0,60000,65000,-5000,-5000
055154,聯發科元大98購01,0,0,0,0,0,0,0,0,0,-5000,0,0,0,1000,6000,-5000,-5000
05519P,上証2X凱基98售01,0,0,0,0,0,0,0,0,0,-5000,0,0,0,0,5000,-5000,-5000
055229,大毅國票97購02  ,0,0,0,0,0,0,0,0,0,-5000,0,0,0,8000,13000,-5000,-5000
054587,玉晶光國泰99購01,0,0,0,0,0,0,0,0,0,-5000,0,0,0,0,5000,-5000,-5000
056437,台積電凱基98購11,0,0,0,0,0,0,0,0,0,-5000,0,0,0,0,5000,-5000,-5000
056549,嘉聯益凱基98購04,0,0,0,0,0,0,0,0,0,-5000,0,0,0,26000,31000,-5000,-5000
056494,緯創國泰99購01  ,0,0,0,0,0,0,0,0,0,-5000,0,0,0,6000,11000,-5000,-5000
055645,技嘉元富97購01  ,0,0,0,0,0,0,0,0,0,-5000,0,0,0,1000,6000,-5000,-5000
055502,群創元大9C購03  ,0,0,0,0,0,0,0,0,0,-5000,0,0,0,0,5000,-5000,-5000
05546P,全新元大97售01  ,0,0,0,0,0,0,0,0,0,-5000,0,0,0,0,5000,-5000,-5000
055551,致茂凱基98購01  ,0,0,0,0,0,0,0,0,0,-5000,0,0,0,5000,10000,-5000,-5000
055442,矽創國票98購02  ,0,0,0,0,0,0,0,0,0,-5000,0,0,0,2000,7000,-5000,-5000
056311,泰鼎元大98購01  ,0,0,0,0,0,0,0,0,0,-5000,0,0,0,0,5000,-5000,-5000
055388,華通統一97購03  ,0,0,0,0,0,0,0,0,0,-5000,0,0,0,196000,201000,-5000,-5000
053025,燿華富邦98購02  ,0,0,0,0,0,0,0,0,0,-5000,0,0,0,0,5000,-5000,-5000
053093,緯穎元大96購06  ,0,0,0,0,0,0,0,0,0,-5000,0,0,0,0,5000,-5000,-5000
053412,台達電國票97購02,0,0,0,0,0,0,0,0,0,-5000,0,0,0,0,5000,-5000,-5000
053391,嘉聯益元大99購01,0,0,0,0,0,0,0,0,0,-5000,0,0,0,0,5000,-5000,-5000
052663,奇鋐國票97購01  ,0,0,0,0,0,0,0,0,0,-5000,0,0,0,0,5000,-5000,-5000
05414P,台表科國票96售02,0,0,0,0,0,0,0,0,0,-5000,0,0,0,0,5000,-5000,-5000
052299,T50反1台新05購03,0,0,0,0,0,0,0,0,0,-5000,0,0,0,0,5000,-5000,-5000
03427B,臺股指元大9A熊02,0,0,0,0,0,0,0,0,0,-5000,0,0,0,205000,210000,-5000,-5000
05102P,臺股指凱基96售09,0,0,0,0,0,0,0,0,0,-5000,0,0,0,0,5000,-5000,-5000
051850,臻鼎中信96購01  ,0,0,0,0,0,0,0,0,0,-5000,0,0,0,0,5000,-5000,-5000
053811,國巨群益98購02  ,0,0,0,0,0,0,0,0,0,-5000,0,0,0,30000,35000,-5000,-5000
047969,台達電富邦97購01,0,0,0,0,0,0,0,0,0,-5000,0,0,0,3000,8000,-5000,-5000
049463,華新科富邦97購01,0,0,0,0,0,0,0,0,0,-5000,0,0,0,0,5000,-5000,-5000
049894,嘉聯益富邦98購01,0,0,0,0,0,0,0,0,0,-5000,0,0,0,0,5000,-5000,-5000
056854,友達中信9A購01  ,0,10000,-10000,0,0,0,0,0,0,5000,0,0,0,5000,0,5000,-5000
05681P,大立光元大96售05,0,0,0,0,0,0,0,0,0,-5000,0,0,0,0,5000,-5000,-5000
056895,技嘉元大98購01  ,0,0,0,0,0,0,0,0,0,-5000,0,0,0,3000,8000,-5000,-5000
060008,華邦電群益9A購01,0,0,0,0,0,0,0,0,0,-5000,0,0,0,225000,230000,-5000,-5000
059996,美律元富99購01  ,0,0,0,0,0,0,0,0,0,-5000,0,0,0,114000,119000,-5000,-5000
056710,漢唐永豐98購01  ,0,0,0,0,0,0,0,0,0,-5000,0,0,0,70000,75000,-5000,-5000
056949,義隆統一98購01  ,0,0,0,0,0,0,0,0,0,-5000,0,0,0,0,5000,-5000,-5000
057032,A50反1元大9B購01,0,0,0,0,0,0,0,0,0,-5000,0,0,0,10000,15000,-5000,-5000
057341,技嘉台新98購01  ,0,0,0,0,0,0,0,0,0,-5000,0,0,0,0,5000,-5000,-5000
059692,聯詠永豐99購01  ,0,0,0,0,0,0,0,0,0,-5000,0,0,0,50000,55000,-5000,-5000
059760,楠梓電永豐99購01,0,0,0,0,0,0,0,0,0,-5000,0,0,0,0,5000,-5000,-5000
059636,宏達電凱基99購05,0,0,0,0,0,0,0,0,0,-5000,0,0,0,0,5000,-5000,-5000
058006,台郡群益98購04  ,0,0,0,0,0,0,0,0,0,-5000,0,0,0,0,5000,-5000,-5000
057231,美律凱基98購05  ,0,0,0,0,0,0,0,0,0,-5000,0,0,0,0,5000,-5000,-5000
05876P,聯發科群益96售03,0,0,0,0,0,0,0,0,0,-5000,0,0,0,0,5000,-5000,-5000
057915,台泥凱基98購01  ,0,0,0,0,0,0,0,0,0,-5000,0,0,0,31000,36000,-5000,-5000
057929,上銀群益98購02  ,0,0,0,0,0,0,0,0,0,-5000,0,0,0,0,5000,-5000,-5000
057672,茂林元大98購02  ,0,0,0,0,0,0,0,0,0,-5000,0,0,0,56000,61000,-5000,-5000
057855,晶技國票99購01  ,0,0,0,0,0,0,0,0,0,-5000,0,0,0,0,5000,-5000,-5000
05778P,台積電統一96售05,0,0,0,0,0,0,0,0,0,-5000,0,0,0,0,5000,-5000,-5000
057877,神達元大99購01  ,0,0,0,0,0,0,0,0,0,-5000,0,0,0,0,5000,-5000,-5000
058168,國巨凱基9A購04  ,0,0,0,0,0,0,0,0,0,-5000,0,0,0,0,5000,-5000,-5000
058625,旺宏國票9A購01  ,0,0,0,0,0,0,0,0,0,-5000,0,0,0,52000,57000,-5000,-5000
058487,晶技國票9A購01  ,0,0,0,0,0,0,0,0,0,-5000,0,0,0,9000,14000,-5000,-5000
058492,華通群益9B購01  ,0,0,0,0,0,0,0,0,0,-5000,0,0,0,0,5000,-5000,-5000
060934,台汽電永豐9A購02,0,0,0,0,0,0,0,0,0,-5000,0,0,0,0,5000,-5000,-5000
060159,健和興永豐9A購01,0,0,0,0,0,0,0,0,0,-5000,0,0,0,0,5000,-5000,-5000
062400,晶豪科永豐9B購02,0,0,0,0,0,0,0,0,0,-5000,0,0,0,14000,19000,-5000,-5000
062448,健策元大9C購04  ,0,0,0,0,0,0,0,0,0,-5000,0,0,0,95000,100000,-5000,-5000
061958,鴻海統一01購01  ,0,0,0,0,0,0,0,0,0,-5000,0,0,0,5000,10000,-5000,-5000
062643,緯穎國票9B購01  ,0,0,0,0,0,0,0,0,0,-5000,0,0,0,4000,9000,-5000,-5000
062843,臺股指群益9B購10,0,0,0,0,0,0,0,0,0,-5000,0,0,0,0,5000,-5000,-5000
062967,上銀元富9B購01  ,0,0,0,0,0,0,0,0,0,-5000,0,0,0,72000,77000,-5000,-5000
063009,國巨元大9B購18  ,0,0,0,0,0,0,0,0,0,-5000,0,0,0,0,5000,-5000,-5000
063034,致茂凱基9B購01  ,0,0,0,0,0,0,0,0,0,-5000,0,0,0,8000,13000,-5000,-5000
060900,超眾凱基9B購01  ,0,0,0,0,0,0,0,0,0,-5000,0,0,0,11000,16000,-5000,-5000
060664,聯詠凱基9A購01  ,0,0,0,0,0,0,0,0,0,-5000,0,0,0,134000,139000,-5000,-5000
06058P,玉晶光凱基97售04,0,0,0,0,0,0,0,0,0,-5000,0,0,0,15000,20000,-5000,-5000
060526,台積電中信9A購02,0,0,0,0,0,0,0,0,0,-5000,0,0,0,0,5000,-5000,-5000
060484,聯發科富邦9C購02,0,0,0,0,0,0,0,0,0,-5000,0,0,0,18000,23000,-5000,-5000
061362,台塑國票9B購01  ,0,0,0,0,0,0,0,0,0,-5000,0,0,0,75000,80000,-5000,-5000
061556,台積電國票9A購08,0,0,0,0,0,0,0,0,0,-5000,0,0,0,8000,13000,-5000,-5000
061530,智邦台新9A購02  ,0,0,0,0,0,0,0,0,0,-5000,0,0,0,20000,25000,-5000,-5000
061775,臺指反國票9B購04,0,0,0,0,0,0,0,0,0,-5000,0,0,0,0,5000,-5000,-5000
061766,華新科元大9B購02,0,0,0,0,0,0,0,0,0,-5000,0,0,0,0,5000,-5000,-5000
061757,T50反1元大9B購01,0,0,0,0,0,0,0,0,0,-5000,0,0,0,0,5000,-5000,-5000
061665,旺宏中信9C購01  ,0,0,0,0,0,0,0,0,0,-5000,0,0,0,0,5000,-5000,-5000
3669,圓展            ,147000,150000,-3000,0,0,0,0,0,0,-2000,0,2000,-2000,0,0,0,-5000
08221P,台表科凱基9B售05,0,0,0,0,0,0,0,0,0,-6000,0,0,0,10000,16000,-6000,-6000
08204P,台灣50中信01售04,0,0,0,0,0,0,0,0,0,-6000,0,0,0,0,6000,-6000,-6000
1517,利奇            ,7000,16000,-9000,0,0,0,0,0,0,3000,3000,0,3000,0,0,0,-6000
2486,一詮            ,30000,39000,-9000,0,0,0,0,0,0,3000,3000,0,3000,0,0,0,-6000
07971P,臺股指元大9B售29,0,0,0,0,0,0,0,0,0,-6000,0,0,0,0,6000,-6000,-6000
08093P,英業達元富9B售02,0,0,0,0,0,0,0,0,0,-6000,0,0,0,76000,82000,-6000,-6000
07526P,臺股指中信9B售08,0,0,0,0,0,0,0,0,0,-6000,0,0,0,0,6000,-6000,-6000
06690P,玉晶光群益9A售05,0,0,0,0,0,0,0,0,0,-6000,0,0,0,0,6000,-6000,-6000
06431P,新日興元大97售05,0,0,0,0,0,0,0,0,0,-6000,0,0,0,16000,22000,-6000,-6000
063907,華通凱基9C購03  ,0,0,0,0,0,0,0,0,0,-6000,0,0,0,0,6000,-6000,-6000
07098P,台積電元大99售18,0,0,0,0,0,0,0,0,0,-6000,0,0,0,0,6000,-6000,-6000
07251P,台灣50元富01售04,0,0,0,0,0,0,0,0,0,-6000,0,0,0,0,6000,-6000,-6000
063519,聚陽凱基9B購02  ,0,0,0,0,0,0,0,0,0,-6000,0,0,0,10000,16000,-6000,-6000
063819,致新群益9C購01  ,0,0,0,0,0,0,0,0,0,-6000,0,0,0,10000,16000,-6000,-6000
063747,國巨國票9C購06  ,0,0,0,0,0,0,0,0,0,-6000,0,0,0,0,6000,-6000,-6000
063749,聯發科國票9C購04,0,0,0,0,0,0,0,0,0,-6000,0,0,0,15000,21000,-6000,-6000
063696,T50反1群益9B購03,0,0,0,0,0,0,0,0,0,-6000,0,0,0,0,6000,-6000,-6000
063602,金像電凱基9B購04,0,0,0,0,0,0,0,0,0,-6000,0,0,0,0,6000,-6000,-6000
050758,聯發科元富9B購01,0,0,0,0,0,0,0,0,0,-6000,0,0,0,72000,78000,-6000,-6000
051560,玉晶光國泰97購03,0,0,0,0,0,0,0,0,0,-6000,0,0,0,0,6000,-6000,-6000
05263P,台積電元大96售09,0,0,0,0,0,0,0,0,0,-6000,0,0,0,0,6000,-6000,-6000
053062,緯穎富邦97購01  ,0,0,0,0,0,0,0,0,0,-6000,0,0,0,0,6000,-6000,-6000
055615,宏達電國票99購02,0,0,0,0,0,0,0,0,0,-6000,0,0,0,0,6000,-6000,-6000
056551,台郡凱基98購04  ,0,0,0,0,0,0,0,0,0,-6000,0,0,0,4000,10000,-6000,-6000
055577,晶技統一97購02  ,0,0,0,0,0,0,0,0,0,-6000,0,0,0,0,6000,-6000,-6000
059528,華新科凱基99購06,0,0,0,0,0,0,0,0,0,-6000,0,0,0,0,6000,-6000,-6000
059529,華新科凱基9A購04,0,0,0,0,0,0,0,0,0,-6000,0,0,0,0,6000,-6000,-6000
059568,台積電凱基9A購13,0,0,0,0,0,0,0,0,0,-6000,0,0,0,0,6000,-6000,-6000
059079,SGBR2X元大99購01,0,0,0,0,0,0,0,0,0,-6000,0,0,0,0,6000,-6000,-6000
060158,廣達永豐9A購01  ,0,0,0,0,0,0,0,0,0,-6000,0,0,0,68000,74000,-6000,-6000
060232,友訊元大9C購01  ,0,0,0,0,0,0,0,0,0,-6000,0,0,0,25000,31000,-6000,-6000
060378,台灣50凱基04購01,0,0,0,0,0,0,0,0,0,-6000,0,0,0,0,6000,-6000,-6000
060459,鴻海元大9A購07  ,0,0,0,0,0,0,0,0,0,-6000,0,0,0,49000,55000,-6000,-6000
058323,泰鼎永豐9A購01  ,0,0,0,0,0,0,0,0,0,-6000,0,0,0,37000,43000,-6000,-6000
060071,國巨元富99購03  ,0,0,0,0,0,0,0,0,0,-6000,0,0,0,0,6000,-6000,-6000
060107,旭富元大99購03  ,0,0,0,0,0,0,0,0,0,-6000,0,0,0,110000,116000,-6000,-6000
058289,奇鋐國票9A購01  ,0,0,0,0,0,0,0,0,0,-6000,0,0,0,37000,43000,-6000,-6000
058239,景碩元大99購03  ,0,0,0,0,0,0,0,0,0,-6000,0,0,0,75000,81000,-6000,-6000
058443,T50正2富邦01購01,0,0,0,0,0,0,0,0,0,-6000,0,0,0,0,6000,-6000,-6000
057557,聯茂凱基99購04  ,0,0,0,0,0,0,0,0,0,-6000,0,0,0,0,6000,-6000,-6000
058098,T50反1國泰9A購02,0,0,0,0,0,0,0,0,0,-6000,0,0,0,95000,101000,-6000,-6000
056722,滬深反中信9B購01,0,0,0,0,0,0,0,0,0,-6000,0,0,0,14000,20000,-6000,-6000
057088,上銀元富98購01  ,0,0,0,0,0,0,0,0,0,-6000,0,0,0,0,6000,-6000,-6000
056930,晶豪科台新98購01,0,0,0,0,0,0,0,0,0,-6000,0,0,0,0,6000,-6000,-6000
061603,瑞昱凱基9A購02  ,0,0,0,0,0,0,0,0,0,-6000,0,0,0,19000,25000,-6000,-6000
061834,華新科凱基02購02,0,0,0,0,0,0,0,0,0,-6000,0,0,0,0,6000,-6000,-6000
061486,國巨兆豐9B購02  ,0,0,0,0,0,0,0,0,0,-6000,0,0,0,0,6000,-6000,-6000
061266,國泰金凱基9B購01,0,0,0,0,0,0,0,0,0,-6000,0,0,0,66000,72000,-6000,-6000
060752,上銀元大9A購04  ,0,0,0,0,0,0,0,0,0,-6000,0,0,0,0,6000,-6000,-6000
060775,世芯凱基9A購02  ,0,0,0,0,0,0,0,0,0,-6000,0,0,0,28000,34000,-6000,-6000
060864,可成永豐9A購01  ,0,0,0,0,0,0,0,0,0,-6000,0,0,0,0,6000,-6000,-6000
062810,華通兆豐9B購02  ,0,0,0,0,0,0,0,0,0,-6000,0,0,0,110000,116000,-6000,-6000
062898,華通元大9B購05  ,0,0,0,0,0,0,0,0,0,-6000,0,0,0,72000,78000,-6000,-6000
06262P,國巨凱基97售07  ,0,0,0,0,0,0,0,0,0,-6000,0,0,0,4000,10000,-6000,-6000
061980,聯發科元大9B購01,0,0,0,0,0,0,0,0,0,-6000,0,0,0,34000,40000,-6000,-6000
062262,茂林元大9B購02  ,0,0,0,0,0,0,0,0,0,-6000,0,0,0,0,6000,-6000,-6000
06257P,臺股指群益97售10,0,0,0,0,0,0,0,0,0,-6000,0,0,0,0,6000,-6000,-6000
062367,禾伸堂元大9B購02,0,0,0,0,0,0,0,0,0,-6000,0,0,0,4000,10000,-6000,-6000
4148,全宇生技-KY     ,8000,14000,-6000,0,0,0,0,0,0,0,0,0,0,0,0,0,-6000
063608,力成凱基9B購03  ,0,0,0,0,0,0,0,0,0,-7000,0,0,0,50000,57000,-7000,-7000
063457,臺指反元大02購17,0,0,0,0,0,0,0,0,0,-7000,0,0,0,10000,17000,-7000,-7000
063413,台積電麥證01購01,0,0,0,0,7000,-7000,0,0,0,-7000,0,0,0,0,7000,-7000,-7000
063905,健策麥證02購01  ,0,0,0,0,7000,-7000,0,0,0,-7000,0,0,0,0,7000,-7000,-7000
07609P,台灣50國票9C售04,0,0,0,0,0,0,0,0,0,-7000,0,0,0,0,7000,-7000,-7000
07781P,高鐵凱基9A售02  ,0,0,0,0,0,0,0,0,0,-7000,0,0,0,0,7000,-7000,-7000
055830,上銀元大97購07  ,0,0,0,0,0,0,0,0,0,-7000,0,0,0,0,7000,-7000,-7000
054352,世芯國泰98購01  ,0,0,0,0,0,0,0,0,0,-7000,0,0,0,29000,36000,-7000,-7000
056566,臻鼎群益98購01  ,0,0,0,0,0,0,0,0,0,-7000,0,0,0,3000,10000,-7000,-7000
054872,瀚宇博群益98購01,0,0,0,0,0,0,0,0,0,-7000,0,0,0,98000,105000,-7000,-7000
055092,開發金群益9B購01,0,0,0,0,0,0,0,0,0,-7000,0,0,0,192000,199000,-7000,-7000
055701,亞德客富邦99購01,0,0,0,0,0,0,0,0,0,-7000,0,0,0,0,7000,-7000,-7000
050754,元金2X元富9B購01,0,0,0,0,0,0,0,0,0,-7000,0,0,0,3000,10000,-7000,-7000
03007X,元展07          ,0,0,0,0,0,0,0,0,0,-7000,0,0,0,0,7000,-7000,-7000
048651,美利達元大96購05,0,0,0,0,0,0,0,0,0,-7000,0,0,0,71000,78000,-7000,-7000
060023,T50反1國泰9A購03,0,0,0,0,0,0,0,0,0,-7000,0,0,0,10000,17000,-7000,-7000
060052,宏碁凱基99購01  ,0,0,0,0,0,0,0,0,0,-7000,0,0,0,83000,90000,-7000,-7000
059847,喬山永豐99購01  ,0,0,0,0,0,0,0,0,0,-7000,0,0,0,10000,17000,-7000,-7000
057019,台積電凱基98購14,0,0,0,0,0,0,0,0,0,-7000,0,0,0,0,7000,-7000,-7000
057000,亞德客國票99購01,0,0,0,0,0,0,0,0,0,-7000,0,0,0,15000,22000,-7000,-7000
058116,正崴中信99購02  ,0,0,0,0,0,0,0,0,0,-7000,0,0,0,48000,55000,-7000,-7000
057334,技嘉國票98購02  ,0,0,0,0,0,0,0,0,0,-7000,0,0,0,20000,27000,-7000,-7000
057716,神達統一98購01  ,0,0,0,0,0,0,0,0,0,-7000,0,0,0,0,7000,-7000,-7000
060314,元翎永豐9A購01  ,0,0,0,0,0,0,0,0,0,-7000,0,0,0,0,7000,-7000,-7000
060285,聯電元大9C購01  ,0,0,0,0,0,0,0,0,0,-7000,0,0,0,25000,32000,-7000,-7000
062189,康控元大9B購02  ,0,0,0,0,0,0,0,0,0,-7000,0,0,0,89000,96000,-7000,-7000
062091,世紀鋼元大9B購01,0,0,0,0,0,0,0,0,0,-7000,0,0,0,65000,72000,-7000,-7000
063024,祥碩元大9B購05  ,0,0,0,0,0,0,0,0,0,-7000,0,0,0,25000,32000,-7000,-7000
063059,A50正2元富9B購01,0,0,0,0,0,0,0,0,0,-7000,0,0,0,0,7000,-7000,-7000
06296P,燿華元大98售01  ,0,0,0,0,0,0,0,0,0,-7000,0,0,0,0,7000,-7000,-7000
06105P,國巨國票98售02  ,0,0,0,0,0,0,0,0,0,-7000,0,0,0,48000,55000,-7000,-7000
061327,台郡凱基9A購02  ,0,0,0,0,0,0,0,0,0,-7000,0,0,0,69000,76000,-7000,-7000
061843,億豐凱基9C購01  ,0,0,0,0,0,0,0,0,0,-7000,0,0,0,99000,106000,-7000,-7000
061776,晶技國票9B購01  ,0,0,0,0,0,0,0,0,0,-7000,0,0,0,0,7000,-7000,-7000
06161P,聯發科群益97售03,0,0,0,0,0,0,0,0,0,-7000,0,0,0,0,7000,-7000,-7000
5525,順天            ,7000,14000,-7000,0,0,0,0,0,0,0,0,0,0,0,0,0,-7000
07786P,南電中信9C售01  ,0,0,0,0,0,0,0,0,0,-8000,0,0,0,12000,20000,-8000,-8000
08059P,京鼎元大9B售02  ,0,0,0,0,0,0,0,0,0,-8000,0,0,0,57000,65000,-8000,-8000
07337P,台灣50凱基99售09,0,0,0,0,0,0,0,0,0,-8000,0,0,0,2000,10000,-8000,-8000
2882B,國泰金乙特      ,0,0,0,0,0,0,0,0,0,-8000,2000,10000,-8000,0,0,0,-8000
2431,聯昌            ,12000,20000,-8000,0,0,0,0,0,0,0,0,0,0,0,0,0,-8000
07216P,大立光凱基99售08,0,0,0,0,0,0,0,0,0,-8000,0,0,0,0,8000,-8000,-8000
07134P,臺股指元大9A售28,0,0,0,0,0,0,0,0,0,-8000,0,0,0,7000,15000,-8000,-8000
06368P,台積電凱基97售15,0,0,0,0,0,0,0,0,0,-8000,0,0,0,3000,11000,-8000,-8000
063744,儒鴻國票9C購01  ,0,0,0,0,0,0,0,0,0,-8000,0,0,0,13000,21000,-8000,-8000
063832,矽創國票01購01  ,0,0,0,0,0,0,0,0,0,-8000,0,0,0,0,8000,-8000,-8000
063833,致新國票01購01  ,0,0,0,0,0,0,0,0,0,-8000,0,0,0,0,8000,-8000,-8000
053754,英業達元富96購02,0,0,0,0,0,0,0,0,0,-8000,0,0,0,192000,200000,-8000,-8000
035276,南亞科台新97購01,0,0,0,0,0,0,0,0,0,-8000,0,0,0,2000,10000,-8000,-8000
03433B,臺股指元大9C熊01,0,0,0,0,0,0,0,0,0,-8000,0,0,0,30000,38000,-8000,-8000
053092,台表科元大97購02,0,0,0,0,0,0,0,0,0,-8000,0,0,0,0,8000,-8000,-8000
052681,T50反1元大98購02,0,0,0,0,0,0,0,0,0,-8000,0,0,0,44000,52000,-8000,-8000
053279,景碩元大97購01  ,0,0,0,0,0,0,0,0,0,-8000,0,0,0,0,8000,-8000,-8000
055713,國巨元大98購09  ,0,0,0,0,0,0,0,0,0,-8000,0,0,0,10000,18000,-8000,-8000
055265,玉晶光永豐98購03,0,0,0,0,0,0,0,0,0,-8000,0,0,0,122000,130000,-8000,-8000
055587,智邦元大97購02  ,0,0,0,0,0,0,0,0,0,-8000,0,0,0,0,8000,-8000,-8000
056165,矽力凱基98購02  ,0,1000,-1000,0,0,0,0,0,0,-7000,0,0,0,3000,10000,-7000,-8000
055953,上銀元大97購09  ,0,0,0,0,0,0,0,0,0,-8000,0,0,0,50000,58000,-8000,-8000
059107,南茂國泰9A購01  ,0,0,0,0,0,0,0,0,0,-8000,0,0,0,48000,56000,-8000,-8000
059018,滬深2X統一9A購01,0,0,0,0,0,0,0,0,0,-8000,0,0,0,0,8000,-8000,-8000
060336,南電康和9A購01  ,0,0,0,0,0,0,0,0,0,-8000,0,0,0,11000,19000,-8000,-8000
058287,國巨國票9A購02  ,0,0,0,0,0,0,0,0,0,-8000,0,0,0,0,8000,-8000,-8000
060966,台表科凱基9B購01,0,0,0,0,0,0,0,0,0,-8000,0,0,0,52000,60000,-8000,-8000
057386,聯發科永豐98購04,0,0,0,0,0,0,0,0,0,-8000,0,0,0,0,8000,-8000,-8000
057308,同欣電兆豐99購01,0,0,0,0,0,0,0,0,0,-8000,0,0,0,21000,29000,-8000,-8000
060059,鴻海兆豐99購06  ,0,0,0,0,0,0,0,0,0,-8000,0,0,0,0,8000,-8000,-8000
05797P,臺股指群益96售11,0,0,0,0,0,0,0,0,0,-8000,0,0,0,0,8000,-8000,-8000
059649,矽力凱基99購02  ,0,0,0,0,0,0,0,0,0,-8000,0,0,0,22000,30000,-8000,-8000
061427,旭富元大9A購02  ,0,0,0,0,0,0,0,0,0,-8000,0,0,0,353000,361000,-8000,-8000
061165,美律兆豐9A購01  ,0,0,0,0,0,0,0,0,0,-8000,0,0,0,27000,35000,-8000,-8000
062961,S&P反1元富9B購01,0,0,0,0,0,0,0,0,0,-8000,0,0,0,0,8000,-8000,-8000
062663,聯發科群益9B購07,0,0,0,0,0,0,0,0,0,-8000,0,0,0,30000,38000,-8000,-8000
062718,技嘉凱基9B購01  ,0,0,0,0,0,0,0,0,0,-8000,0,0,0,8000,16000,-8000,-8000
062847,臺股指富邦9B購01,0,0,0,0,0,0,0,0,0,-8000,0,0,0,0,8000,-8000,-8000
062827,神基群益9B購01  ,0,0,0,0,0,0,0,0,0,-8000,0,0,0,88000,96000,-8000,-8000
062413,台光電中信9B購02,0,0,0,0,0,0,0,0,0,-8000,0,0,0,2000,10000,-8000,-8000
062303,台表科中信01購01,0,0,0,0,0,0,0,0,0,-8000,0,0,0,5000,13000,-8000,-8000
3686,達能            ,18000,26000,-8000,0,0,0,0,0,0,0,0,0,0,0,0,0,-8000
2395,研華            ,613396,718679,-105283,0,0,0,0,2000,-2000,99000,100000,1000,99000,0,0,0,-8283
2466,冠西電          ,20000,30000,-10000,0,0,0,0,0,0,1000,1000,0,1000,0,0,0,-9000
2002A,中鋼特          ,0,0,0,0,0,0,0,0,0,-9000,1000,10000,-9000,0,0,0,-9000
08299P,玉晶光國票02售01,0,0,0,0,0,0,0,0,0,-9000,0,0,0,0,9000,-9000,-9000
1451,年興            ,6000,17000,-11000,0,0,0,0,0,0,2000,2000,0,2000,0,0,0,-9000
1459,聯發            ,11000,20000,-9000,0,0,0,0,0,0,0,0,0,0,0,0,0,-9000
07301P,臺股指元大9A售34,0,0,0,0,0,0,0,0,0,-9000,0,0,0,0,9000,-9000,-9000
07754P,日月光元大9A售02,0,0,0,0,0,0,0,0,0,-9000,0,0,0,0,9000,-9000,-9000
07877P,晶技永豐9B售01  ,0,0,0,0,0,0,0,0,0,-9000,0,0,0,1000,10000,-9000,-9000
063830,智伸科國票01購01,0,0,0,0,0,0,0,0,0,-9000,0,0,0,0,9000,-9000,-9000
063763,上銀元富9B購07  ,0,0,0,0,0,0,0,0,0,-9000,0,0,0,0,9000,-9000,-9000
06461P,玉晶光國泰9A售01,0,0,0,0,0,0,0,0,0,-9000,0,0,0,0,9000,-9000,-9000
06724P,台灣50國票98售01,0,0,0,0,0,0,0,0,0,-9000,0,0,0,1000,10000,-9000,-9000
06762P,智邦元大98售11  ,0,0,0,0,0,0,0,0,0,-9000,0,0,0,0,9000,-9000,-9000
059007,南電元大99購05  ,0,0,0,0,0,0,0,0,0,-9000,0,0,0,6000,15000,-9000,-9000
055665,亞德客群益97購01,0,0,0,0,0,0,0,0,0,-9000,0,0,0,0,9000,-9000,-9000
054378,楠梓電群益98購01,0,0,0,0,0,0,0,0,0,-9000,0,0,0,71000,80000,-9000,-9000
056467,上証2X元大98購02,0,0,0,0,0,0,0,0,0,-9000,0,0,0,2000,11000,-9000,-9000
055193,世芯元富97購02  ,0,0,0,0,0,0,0,0,0,-9000,0,0,0,1000,10000,-9000,-9000
053488,中石化兆豐97購01,0,0,0,0,0,0,0,0,0,-9000,0,0,0,60000,69000,-9000,-9000
053728,茂林凱基97購01  ,0,0,0,0,0,0,0,0,0,-9000,0,0,0,0,9000,-9000,-9000
055459,建準永豐97購03  ,0,0,0,0,0,0,0,0,0,-9000,0,0,0,37000,46000,-9000,-9000
006204,永豐臺灣加權    ,0,0,0,0,0,0,0,0,0,-9000,0,0,0,22000,31000,-9000,-9000
058819,華通國泰9B購01  ,0,0,0,0,0,0,0,0,0,-9000,0,0,0,176000,185000,-9000,-9000
056766,義隆元大98購01  ,0,0,0,0,0,0,0,0,0,-9000,0,0,0,0,9000,-9000,-9000
059992,S&P正2元富9B購04,0,0,0,0,0,0,0,0,0,-9000,0,0,0,1000,10000,-9000,-9000
057374,禾伸堂元大99購03,0,0,0,0,0,0,0,0,0,-9000,0,0,0,0,9000,-9000,-9000
058128,FBVIX元大9C購02 ,0,0,0,0,0,0,0,0,0,-9000,0,0,0,0,9000,-9000,-9000
057637,上銀元大98購07  ,0,0,0,0,0,0,0,0,0,-9000,0,0,0,1000,10000,-9000,-9000
057748,華通國票98購04  ,0,0,0,0,0,0,0,0,0,-9000,0,0,0,0,9000,-9000,-9000
057670,欣興元大99購02  ,0,0,0,0,0,0,0,0,0,-9000,0,0,0,45000,54000,-9000,-9000
057587,微星國票99購01  ,0,0,0,0,0,0,0,0,0,-9000,0,0,0,0,9000,-9000,-9000
060977,亞德客元大9A購04,0,0,0,0,0,0,0,0,0,-9000,0,0,0,80000,89000,-9000,-9000
060114,緯穎元大99購10  ,0,0,0,0,0,0,0,0,0,-9000,0,0,0,21000,30000,-9000,-9000
05830P,滬深2X元富99售03,0,0,0,0,0,0,0,0,0,-9000,0,0,0,9000,18000,-9000,-9000
058370,聯詠凱基99購01  ,0,0,0,0,0,0,0,0,0,-9000,0,0,0,10000,19000,-9000,-9000
057466,泰鼎永豐98購01  ,0,0,0,0,0,0,0,0,0,-9000,0,0,0,16000,25000,-9000,-9000
058228,為升元大99購01  ,0,0,0,0,0,0,0,0,0,-9000,0,0,0,0,9000,-9000,-9000
058221,上銀統一99購04  ,0,0,0,0,0,0,0,0,0,-9000,0,0,0,21000,30000,-9000,-9000
060146,健策國票9A購03  ,0,0,0,0,0,0,0,0,0,-9000,0,0,0,26000,35000,-9000,-9000
060128,健策永豐99購06  ,0,0,0,0,0,0,0,0,0,-9000,0,0,0,13000,22000,-9000,-9000
061965,台積電統一02購02,0,0,0,0,0,0,0,0,0,-9000,0,0,0,0,9000,-9000,-9000
062030,旭富群益9B購01  ,0,0,0,0,0,0,0,0,0,-9000,0,0,0,4000,13000,-9000,-9000
062200,臺指反國票03購01,0,0,0,0,0,0,0,0,0,-9000,0,0,0,20000,29000,-9000,-9000
062638,茂林國票9C購01  ,0,0,0,0,0,0,0,0,0,-9000,0,0,0,0,9000,-9000,-9000
061191,可成永豐9A購02  ,0,0,0,0,0,0,0,0,0,-9000,0,0,0,0,9000,-9000,-9000
061070,超眾凱基9C購01  ,0,0,0,0,0,0,0,0,0,-9000,0,0,0,61000,70000,-9000,-9000
060846,欣興國票9A購02  ,0,0,0,0,0,0,0,0,0,-9000,0,0,0,4000,13000,-9000,-9000
060643,牧德永豐9A購03  ,0,0,0,0,0,0,0,0,0,-9000,0,0,0,1000,10000,-9000,-9000
061497,大立光國票9A購09,0,0,0,0,0,0,0,0,0,-9000,0,0,0,0,9000,-9000,-9000
061454,國巨凱基9A購16  ,0,0,0,0,0,0,0,0,0,-9000,0,0,0,0,9000,-9000,-9000
061786,義隆群益9B購01  ,0,0,0,0,0,0,0,0,0,-9000,0,0,0,1000,10000,-9000,-9000
061793,上銀永豐9B購01  ,0,0,0,0,0,0,0,0,0,-9000,0,0,0,10000,19000,-9000,-9000
8466,美吉吉-KY       ,0,10000,-10000,0,0,0,0,0,0,1000,1000,0,1000,0,0,0,-9000
9946,三發地產        ,0,9000,-9000,0,0,0,0,0,0,0,0,0,0,0,0,0,-9000
00645,富邦日本        ,0,0,0,0,0,0,0,0,0,-9461,0,0,0,79539,89000,-9461,-9461
06671P,台積電群益98售04,0,0,0,0,0,0,0,0,0,-10000,0,0,0,0,10000,-10000,-10000
06482P,台積電凱基98售13,0,0,0,0,0,0,0,0,0,-10000,0,0,0,0,10000,-10000,-10000
06441P,台積電凱基98售08,0,0,0,0,0,0,0,0,0,-10000,0,0,0,0,10000,-10000,-10000
063958,瑞祺元大9C購01  ,0,0,0,0,0,0,0,0,0,-10000,0,0,0,0,10000,-10000,-10000
07118P,台積電凱基99售09,0,0,0,0,0,0,0,0,0,-10000,0,0,0,0,10000,-10000,-10000
07169P,臺股指國票99售06,0,0,0,0,0,0,0,0,0,-10000,0,0,0,0,10000,-10000,-10000
07165P,臺股指群益99售16,0,0,0,0,0,0,0,0,0,-10000,0,0,0,0,10000,-10000,-10000
07205P,鴻海凱基99售11  ,0,0,0,0,0,0,0,0,0,-10000,0,0,0,0,10000,-10000,-10000
07235P,T50正2元大9C售02,0,0,0,0,0,0,0,0,0,-10000,0,0,0,0,10000,-10000,-10000
06964P,臺股指凱基9B售01,0,0,0,0,0,0,0,0,0,-10000,0,0,0,0,10000,-10000,-10000
06924P,台積電群益98售07,0,0,0,0,0,0,0,0,0,-10000,0,0,0,0,10000,-10000,-10000
06925P,致茂群益9A售02  ,0,0,0,0,0,0,0,0,0,-10000,0,0,0,0,10000,-10000,-10000
06992P,玉晶光日盛9B售01,0,0,0,0,0,0,0,0,0,-10000,0,0,0,0,10000,-10000,-10000
06374P,台表科元大97售06,0,0,0,0,0,0,0,0,0,-10000,0,0,0,0,10000,-10000,-10000
063719,T50反1元大9B購11,0,0,0,0,0,0,0,0,0,-10000,0,0,0,0,10000,-10000,-10000
063847,聯發科元大9C購03,0,0,0,0,0,0,0,0,0,-10000,0,0,0,35000,45000,-10000,-10000
063826,中興電國票01購01,0,0,0,0,0,0,0,0,0,-10000,0,0,0,0,10000,-10000,-10000
063827,國巨國票02購01  ,0,0,0,0,0,0,0,0,0,-10000,0,0,0,0,10000,-10000,-10000
063828,台積電國票01購02,0,0,0,0,0,0,0,0,0,-10000,0,0,0,0,10000,-10000,-10000
063565,旺宏元大9B購08  ,0,0,0,0,0,0,0,0,0,-10000,0,0,0,25000,35000,-10000,-10000
063421,可成凱基9C購02  ,0,0,0,0,0,0,0,0,0,-10000,0,0,0,11000,21000,-10000,-10000
063425,台勝科凱基9B購02,0,0,0,0,0,0,0,0,0,-10000,0,0,0,0,10000,-10000,-10000
063531,台表科凱基9B購04,0,0,0,0,0,0,0,0,0,-10000,0,0,0,0,10000,-10000,-10000
07897P,臺股指元大9B售17,0,0,0,0,0,0,0,0,0,-10000,0,0,0,0,10000,-10000,-10000
07799P,南電國票9A售04  ,0,0,0,0,0,0,0,0,0,-10000,0,0,0,0,10000,-10000,-10000
08071P,臺股指富邦9B售04,0,0,0,0,0,0,0,0,0,-10000,0,0,0,0,10000,-10000,-10000
08091P,A50正2元富9B售02,0,0,0,0,0,0,0,0,0,-10000,0,0,0,0,10000,-10000,-10000
08098P,大立光凱基9B售09,0,0,0,0,0,0,0,0,0,-10000,0,0,0,0,10000,-10000,-10000
07752P,台灣50元大9C售33,0,0,0,0,0,0,0,0,0,-10000,0,0,0,0,10000,-10000,-10000
07763P,嘉澤永豐9A售02  ,0,0,0,0,0,0,0,0,0,-10000,0,0,0,0,10000,-10000,-10000
07682P,聯發科凱基9A售15,0,0,0,0,0,0,0,0,0,-10000,0,0,0,0,10000,-10000,-10000
07532P,台灣50中信01售02,0,0,0,0,0,0,0,0,0,-10000,0,0,0,0,10000,-10000,-10000
07651P,道瓊指中信01售01,0,0,0,0,0,0,0,0,0,-10000,0,0,0,40000,50000,-10000,-10000
07644P,南電凱基9A售03  ,0,0,0,0,0,0,0,0,0,-10000,0,0,0,110000,120000,-10000,-10000
07306P,台灣50凱基9A售09,0,0,0,0,0,0,0,0,0,-10000,0,0,0,0,10000,-10000,-10000
07353P,大立光國票99售02,0,0,0,0,0,0,0,0,0,-10000,0,0,0,0,10000,-10000,-10000
07402P,瑞昱凱基99售02  ,0,0,0,0,0,0,0,0,0,-10000,0,0,0,0,10000,-10000,-10000
07512P,國巨元大9A售08  ,0,0,0,0,0,0,0,0,0,-10000,0,0,0,0,10000,-10000,-10000
07467P,上銀元大9A售03  ,0,0,0,0,0,0,0,0,0,-10000,0,0,0,0,10000,-10000,-10000
07493P,台灣50元大9A售10,0,0,0,0,0,0,0,0,0,-10000,0,0,0,0,10000,-10000,-10000
07446P,台灣50元大9A售06,0,0,0,0,0,0,0,0,0,-10000,0,0,0,10000,20000,-10000,-10000
07439P,臺股指麥證9B售01,0,0,0,0,10000,-10000,0,0,0,-10000,0,0,0,0,10000,-10000,-10000
08239P,南六永豐9B售03  ,0,0,0,0,0,0,0,0,0,-10000,0,0,0,0,10000,-10000,-10000
050673,旺宏富邦96購02  ,0,0,0,0,0,0,0,0,0,-10000,0,0,0,0,10000,-10000,-10000
050561,上証2X元富97購01,0,0,0,0,0,0,0,0,0,-10000,0,0,0,0,10000,-10000,-10000
03857P,聯發科元富99售02,0,0,0,0,0,0,0,0,0,-10000,0,0,0,0,10000,-10000,-10000
049406,T50反1日盛97購01,0,0,0,0,0,0,0,0,0,-10000,0,0,0,0,10000,-10000,-10000
048010,嘉聯益富邦97購01,0,0,0,0,0,0,0,0,0,-10000,0,0,0,0,10000,-10000,-10000
048236,A50正2國票97購02,0,0,0,0,0,0,0,0,0,-10000,0,0,0,0,10000,-10000,-10000
050283,T50反1凱基9A購01,0,0,0,0,0,0,0,0,0,-10000,0,0,0,0,10000,-10000,-10000
054121,奇鋐永豐96購02  ,0,0,0,0,0,0,0,0,0,-10000,0,0,0,10000,20000,-10000,-10000
052201,超眾統一96購01  ,0,0,0,0,0,0,0,0,0,-10000,0,0,0,17000,27000,-10000,-10000
052228,聯發科凱基96購06,0,0,0,0,0,0,0,0,0,-10000,0,0,0,0,10000,-10000,-10000
054091,晶豪科群益96購01,0,0,0,0,0,0,0,0,0,-10000,0,0,0,0,10000,-10000,-10000
053864,義隆元大96購01  ,0,0,0,0,0,0,0,0,0,-10000,0,0,0,39000,49000,-10000,-10000
056345,嘉聯益凱基99購01,0,0,0,0,0,0,0,0,0,-10000,0,0,0,0,10000,-10000,-10000
056323,旺宏兆豐98購01  ,0,0,0,0,0,0,0,0,0,-10000,0,0,0,0,10000,-10000,-10000
055522,道瓊反群益01購01,0,0,0,0,0,0,0,0,0,-10000,0,0,0,0,10000,-10000,-10000
053001,力山永豐96購01  ,0,0,0,0,0,0,0,0,0,-10000,0,0,0,0,10000,-10000,-10000
053021,國巨國泰97購04  ,0,0,0,0,0,0,0,0,0,-10000,0,0,0,10000,20000,-10000,-10000
055373,聯詠元大97購03  ,0,0,0,0,0,0,0,0,0,-10000,0,0,0,0,10000,-10000,-10000
055363,緯穎凱基98購03  ,0,0,0,0,0,0,0,0,0,-10000,0,0,0,0,10000,-10000,-10000
055437,禾伸堂中信99購01,0,0,0,0,0,0,0,0,0,-10000,0,0,0,86000,96000,-10000,-10000
055402,正文元富97購02  ,0,0,0,0,0,0,0,0,0,-10000,0,0,0,10000,20000,-10000,-10000
053513,義隆群益96購05  ,0,0,0,0,0,0,0,0,0,-10000,0,0,0,0,10000,-10000,-10000
053281,茂林元大96購02  ,0,0,0,0,0,0,0,0,0,-10000,0,0,0,0,10000,-10000,-10000
052694,開發金中信98購01,0,0,0,0,0,0,0,0,0,-10000,0,0,0,30000,40000,-10000,-10000
052659,上証2X國票99購01,0,0,0,0,0,0,0,0,0,-10000,0,0,0,0,10000,-10000,-10000
052698,深中小國票99購01,0,0,0,0,0,0,0,0,0,-10000,0,0,0,0,10000,-10000,-10000
05271P,國巨富邦97售01  ,0,0,0,0,0,0,0,0,0,-10000,0,0,0,0,10000,-10000,-10000
052619,茂林國泰99購01  ,0,0,0,0,0,0,0,0,0,-10000,0,0,0,0,10000,-10000,-10000
052620,上証2X富邦97購02,0,0,0,0,0,0,0,0,0,-10000,0,0,0,0,10000,-10000,-10000
052521,友達元大9B購01  ,0,0,0,0,0,0,0,0,0,-10000,0,0,0,0,10000,-10000,-10000
052972,義隆群益96購04  ,0,0,0,0,0,0,0,0,0,-10000,0,0,0,0,10000,-10000,-10000
055119,力成凱基98購01  ,0,0,0,0,0,0,0,0,0,-10000,0,0,0,0,10000,-10000,-10000
055218,彩晶凱基99購01  ,0,0,0,0,0,0,0,0,0,-10000,0,0,0,0,10000,-10000,-10000
055005,晶相光元富97購01,0,0,0,0,0,0,0,0,0,-10000,0,0,0,5000,15000,-10000,-10000
054912,群光凱基97購01  ,0,0,0,0,0,0,0,0,0,-10000,0,0,0,47000,57000,-10000,-10000
055704,亞德客永豐97購04,0,0,0,0,0,0,0,0,0,-10000,0,0,0,0,10000,-10000,-10000
055740,智易元富97購01  ,0,0,0,0,0,0,0,0,0,-10000,0,0,0,0,10000,-10000,-10000
055745,臻鼎元富97購01  ,0,0,0,0,0,0,0,0,0,-10000,0,0,0,307000,317000,-10000,-10000
054735,漢唐凱基98購01  ,0,0,0,0,0,0,0,0,0,-10000,0,0,0,0,10000,-10000,-10000
054712,上証2X中信98購02,0,0,0,0,0,0,0,0,0,-10000,0,0,0,0,10000,-10000,-10000
055695,大毅國票98購03  ,0,0,0,0,0,0,0,0,0,-10000,0,0,0,0,10000,-10000,-10000
055316,上銀國票98購01  ,0,0,0,0,0,0,0,0,0,-10000,0,0,0,0,10000,-10000,-10000
054300,華通凱基96購07  ,0,0,0,0,0,0,0,0,0,-10000,0,0,0,10000,20000,-10000,-10000
056444,南亞科凱基99購01,0,0,0,0,0,0,0,0,0,-10000,0,0,0,0,10000,-10000,-10000
056448,全新凱基99購01  ,0,0,0,0,0,0,0,0,0,-10000,0,0,0,30000,40000,-10000,-10000
054335,緯穎永豐96購02  ,0,0,0,0,0,0,0,0,0,-10000,0,0,0,0,10000,-10000,-10000
054586,健鼎國泰99購01  ,0,0,0,0,0,0,0,0,0,-10000,0,0,0,0,10000,-10000,-10000
054583,玉晶光統一97購02,0,0,0,0,0,0,0,0,0,-10000,0,0,0,0,10000,-10000,-10000
055690,矽力凱基97購02  ,0,0,0,0,0,0,0,0,0,-10000,0,0,0,8000,18000,-10000,-10000
055687,瀚宇博凱基97購01,0,0,0,0,0,0,0,0,0,-10000,0,0,0,0,10000,-10000,-10000
056477,欣興元大98購02  ,0,0,0,0,0,0,0,0,0,-10000,0,0,0,60000,70000,-10000,-10000
054811,裕隆元大9A購01  ,0,0,0,0,0,0,0,0,0,-10000,0,0,0,0,10000,-10000,-10000
054806,台化元大9A購01  ,0,0,0,0,0,0,0,0,0,-10000,0,0,0,0,10000,-10000,-10000
056563,華新科群益98購04,0,0,0,0,0,0,0,0,0,-10000,0,0,0,4000,14000,-10000,-10000
054782,國巨群益97購01  ,0,0,0,0,0,0,0,0,0,-10000,0,0,0,0,10000,-10000,-10000
056543,京鼎凱基98購01  ,0,0,0,0,0,0,0,0,0,-10000,0,0,0,9000,19000,-10000,-10000
059029,旺宏兆豐99購01  ,0,0,0,0,0,0,0,0,0,-10000,0,0,0,0,10000,-10000,-10000
059569,旺宏凱基99購09  ,0,0,0,0,0,0,0,0,0,-10000,0,0,0,15000,25000,-10000,-10000
059544,創意亞東99購01  ,0,0,0,0,0,0,0,0,0,-10000,0,0,0,10000,20000,-10000,-10000
059474,元石油群益99購01,0,0,0,0,0,0,0,0,0,-10000,0,0,0,0,10000,-10000,-10000
059502,台灣50台新9B購04,0,0,0,0,0,0,0,0,0,-10000,0,0,0,0,10000,-10000,-10000
059202,禾聯碩永豐99購01,0,0,0,0,0,0,0,0,0,-10000,0,0,0,0,10000,-10000,-10000
056585,台積電統一9A購01,0,0,0,0,0,0,0,0,0,-10000,0,0,0,2000,12000,-10000,-10000
056092,亞德客元富97購02,0,0,0,0,0,0,0,0,0,-10000,0,0,0,0,10000,-10000,-10000
056147,鴻海日盛97購05  ,0,0,0,0,0,0,0,0,0,-10000,0,0,0,0,10000,-10000,-10000
056233,超眾凱基97購02  ,0,0,0,0,0,0,0,0,0,-10000,0,0,0,10000,20000,-10000,-10000
056277,上銀富邦99購02  ,0,0,0,0,0,0,0,0,0,-10000,0,0,0,30000,40000,-10000,-10000
060171,宏達電台新9A購01,0,0,0,0,0,0,0,0,0,-10000,0,0,0,0,10000,-10000,-10000
06037P,超眾國票98售02  ,0,0,0,0,0,0,0,0,0,-10000,0,0,0,0,10000,-10000,-10000
058278,FBVIX中信03購02 ,0,0,0,0,0,0,0,0,0,-10000,0,0,0,0,10000,-10000,-10000
058333,鴻海元富99購04  ,0,0,0,0,0,0,0,0,0,-10000,0,0,0,22000,32000,-10000,-10000
060108,泰鼎元大99購04  ,0,0,0,0,0,0,0,0,0,-10000,0,0,0,0,10000,-10000,-10000
060075,台積電元富99購05,0,0,0,0,0,0,0,0,0,-10000,0,0,0,0,10000,-10000,-10000
058155,牧德統一9A購01  ,0,0,0,0,0,0,0,0,0,-10000,0,0,0,0,10000,-10000,-10000
057547,技嘉凱基99購01  ,0,0,0,0,0,0,0,0,0,-10000,0,0,0,10000,20000,-10000,-10000
057526,智邦元大98購10  ,0,0,0,0,0,0,0,0,0,-10000,0,0,0,0,10000,-10000,-10000
057738,旺宏富邦9A購01  ,0,0,0,0,0,0,0,0,0,-10000,0,0,0,20000,30000,-10000,-10000
057795,鴻海兆豐99購02  ,0,0,0,0,0,0,0,0,0,-10000,0,0,0,2000,12000,-10000,-10000
057394,台積電中信9C購02,0,0,0,0,0,0,0,0,0,-10000,0,0,0,0,10000,-10000,-10000
058426,旺宏元富99購02  ,0,0,0,0,0,0,0,0,0,-10000,0,0,0,0,10000,-10000,-10000
05842P,台積電元大96售15,0,0,0,0,0,0,0,0,0,-10000,0,0,0,0,10000,-10000,-10000
058406,聯茂元大99購06  ,0,0,0,0,0,0,0,0,0,-10000,0,0,0,196000,206000,-10000,-10000
058567,華新科凱基9A購02,0,0,0,0,0,0,0,0,0,-10000,0,0,0,0,10000,-10000,-10000
058614,台郡元大9A購01  ,0,0,0,0,0,0,0,0,0,-10000,0,0,0,0,10000,-10000,-10000
058657,大立光中信99購01,0,0,0,0,0,0,0,0,0,-10000,0,0,0,0,10000,-10000,-10000
058600,國巨元大99購15  ,0,0,0,0,0,0,0,0,0,-10000,0,0,0,0,10000,-10000,-10000
05812P,臺股指國票96售05,0,0,0,0,0,0,0,0,0,-10000,0,0,0,0,10000,-10000,-10000
057035,元油2X元大9B購03,0,0,0,0,0,0,0,0,0,-10000,0,0,0,0,10000,-10000,-10000
057108,潤泰全群益98購01,0,0,0,0,0,0,0,0,0,-10000,0,0,0,0,10000,-10000,-10000
056805,元石油統一9B購01,0,0,0,0,0,0,0,0,0,-10000,0,0,0,0,10000,-10000,-10000
056902,大立光元大98購12,0,0,0,0,0,0,0,0,0,-10000,0,0,0,0,10000,-10000,-10000
056878,元油2X國票99購02,0,0,0,0,0,0,0,0,0,-10000,0,0,0,0,10000,-10000,-10000
059842,台積電富邦9C購05,0,0,0,0,0,0,0,0,0,-10000,0,0,0,0,10000,-10000,-10000
059789,貿聯元大9A購02  ,0,0,0,0,0,0,0,0,0,-10000,0,0,0,0,10000,-10000,-10000
059784,台光電元大9A購01,0,0,0,0,0,0,0,0,0,-10000,0,0,0,2000,12000,-10000,-10000
059817,華通凱基99購05  ,0,0,0,0,0,0,0,0,0,-10000,0,0,0,0,10000,-10000,-10000
059997,華航元富99購01  ,0,0,0,0,0,0,0,0,0,-10000,0,0,0,0,10000,-10000,-10000
059974,臺指反元大9C購05,0,0,0,0,0,0,0,0,0,-10000,0,0,0,0,10000,-10000,-10000
05994P,奇鋐元大96售02  ,0,0,0,0,0,0,0,0,0,-10000,0,0,0,0,10000,-10000,-10000
059891,臺股指國票99購25,0,0,0,0,0,0,0,0,0,-10000,0,0,0,0,10000,-10000,-10000
058982,台積電凱基99購08,0,0,0,0,0,0,0,0,0,-10000,0,0,0,0,10000,-10000,-10000
059387,華通凱基9A購03  ,0,0,0,0,0,0,0,0,0,-10000,0,0,0,0,10000,-10000,-10000
059405,台灣50國票01購01,0,0,0,0,0,0,0,0,0,-10000,0,0,0,0,10000,-10000,-10000
058939,台積電中信9B購01,0,0,0,0,0,0,0,0,0,-10000,0,0,0,0,10000,-10000,-10000
057934,華新科群益98購07,0,0,0,0,0,0,0,0,0,-10000,0,0,0,3000,13000,-10000,-10000
057154,易華電國泰99購01,0,0,0,0,0,0,0,0,0,-10000,0,0,0,0,10000,-10000,-10000
059262,致茂中信01購01  ,0,0,0,0,0,0,0,0,0,-10000,0,0,0,10000,20000,-10000,-10000
059214,國巨元大99購20  ,0,0,0,0,0,0,0,0,0,-10000,0,0,0,15000,25000,-10000,-10000
059648,台表科凱基99購03,0,0,0,0,0,0,0,0,0,-10000,0,0,0,0,10000,-10000,-10000
059645,祥碩凱基99購05  ,0,0,0,0,0,0,0,0,0,-10000,0,0,0,0,10000,-10000,-10000
059628,智邦凱基99購04  ,0,0,0,0,0,0,0,0,0,-10000,0,0,0,0,10000,-10000,-10000
058888,元油2X元大99購16,0,0,0,0,0,0,0,0,0,-10000,0,0,0,0,10000,-10000,-10000
058885,元石油元大9C購02,0,0,0,0,0,0,0,0,0,-10000,0,0,0,0,10000,-10000,-10000
058868,元油2X國票99購06,0,0,0,0,0,0,0,0,0,-10000,0,0,0,0,10000,-10000,-10000
058876,南電國票9A購02  ,0,0,0,0,0,0,0,0,0,-10000,0,0,0,0,10000,-10000,-10000
059708,立積凱基9A購02  ,0,0,0,0,0,0,0,0,0,-10000,0,0,0,0,10000,-10000,-10000
059682,可成富邦9A購01  ,0,0,0,0,0,0,0,0,0,-10000,0,0,0,0,10000,-10000,-10000
059699,華通凱基99購04  ,0,0,0,0,0,0,0,0,0,-10000,0,0,0,0,10000,-10000,-10000
057252,牧德元富98購01  ,0,0,0,0,0,0,0,0,0,-10000,0,0,0,0,10000,-10000,-10000
059467,旺宏元大99購15  ,0,0,0,0,0,0,0,0,0,-10000,0,0,0,1000,11000,-10000,-10000
057281,大立光元大98購16,0,0,0,0,0,0,0,0,0,-10000,0,0,0,0,10000,-10000,-10000
058041,FBVIX元大98購02 ,0,0,0,0,0,0,0,0,0,-10000,0,0,0,0,10000,-10000,-10000
058028,國巨富邦99購04  ,0,0,0,0,0,0,0,0,0,-10000,0,0,0,0,10000,-10000,-10000
058063,旺宏中信98購04  ,0,0,0,0,0,0,0,0,0,-10000,0,0,0,0,10000,-10000,-10000
061782,智邦群益9B購01  ,0,0,0,0,0,0,0,0,0,-10000,0,0,0,40000,50000,-10000,-10000
061674,聯發科元大9A購12,0,0,0,0,0,0,0,0,0,-10000,0,0,0,0,10000,-10000,-10000
061664,上銀中信9A購01  ,0,0,0,0,0,0,0,0,0,-10000,0,0,0,0,10000,-10000,-10000
061727,旺宏麥證9A購04  ,0,0,0,0,10000,-10000,0,0,0,-10000,0,0,0,0,10000,-10000,-10000
061501,嘉澤國票9A購01  ,0,0,0,0,0,0,0,0,0,-10000,0,0,0,0,10000,-10000,-10000
06129P,玉晶光元富97售06,0,0,0,0,0,0,0,0,0,-10000,0,0,0,0,10000,-10000,-10000
060649,國巨第一9A購01  ,0,0,0,0,0,0,0,0,0,-10000,0,0,0,5000,15000,-10000,-10000
060657,旺宏統一9B購05  ,0,0,0,0,0,0,0,0,0,-10000,0,0,0,0,10000,-10000,-10000
060589,台灣50台新9B購06,0,0,0,0,0,0,0,0,0,-10000,0,0,0,0,10000,-10000,-10000
06059P,泰碩元大97售02  ,0,0,0,0,0,0,0,0,0,-10000,0,0,0,0,10000,-10000,-10000
060546,旺宏凱基9A購02  ,0,0,0,0,0,0,0,0,0,-10000,0,0,0,0,10000,-10000,-10000
06076P,大立光凱基98售03,0,0,0,0,0,0,0,0,0,-10000,0,0,0,0,10000,-10000,-10000
060789,禾伸堂富邦9B購02,0,0,0,0,0,0,0,0,0,-10000,0,0,0,0,10000,-10000,-10000
060873,道瓊反中信9C購01,0,0,0,0,0,0,0,0,0,-10000,0,0,0,0,10000,-10000,-10000
061068,祥碩凱基9B購01  ,0,0,0,0,0,0,0,0,0,-10000,0,0,0,0,10000,-10000,-10000
061023,茂林國泰9B購02  ,0,0,0,0,0,0,0,0,0,-10000,0,0,0,10000,20000,-10000,-10000
06113P,台積電群益97售01,0,0,0,0,0,0,0,0,0,-10000,0,0,0,0,10000,-10000,-10000
061143,道瓊指中信9C購04,0,0,0,0,0,0,0,0,0,-10000,0,0,0,0,10000,-10000,-10000
062674,百和中信03購01  ,0,0,0,0,0,0,0,0,0,-10000,0,0,0,0,10000,-10000,-10000
062623,元金2X國票01購01,0,0,0,0,0,0,0,0,0,-10000,0,0,0,0,10000,-10000,-10000
062613,臺指反元大02購10,0,0,0,0,0,0,0,0,0,-10000,0,0,0,0,10000,-10000,-10000
062734,臺指反國票9C購03,0,0,0,0,0,0,0,0,0,-10000,0,0,0,70000,80000,-10000,-10000
062793,鴻海統一9B購06  ,0,0,0,0,0,0,0,0,0,-10000,0,0,0,0,10000,-10000,-10000
062853,大毅永豐9B購03  ,0,0,0,0,0,0,0,0,0,-10000,0,0,0,80000,90000,-10000,-10000
062942,嘉澤凱基9B購02  ,0,0,0,0,0,0,0,0,0,-10000,0,0,0,30000,40000,-10000,-10000
063193,聯發科台新9B購02,0,0,0,0,0,0,0,0,0,-10000,0,0,0,0,10000,-10000,-10000
062259,可成元大9B購03  ,0,0,0,0,0,0,0,0,0,-10000,0,0,0,1000,11000,-10000,-10000
062186,晶技元大9B購05  ,0,0,0,0,0,0,0,0,0,-10000,0,0,0,59000,69000,-10000,-10000
062177,上銀元大9B購02  ,0,0,0,0,0,0,0,0,0,-10000,0,0,0,0,10000,-10000,-10000
062173,世紀鋼永豐9B購01,0,0,0,0,0,0,0,0,0,-10000,0,0,0,0,10000,-10000,-10000
062137,華新科群益9B購04,0,0,0,0,0,0,0,0,0,-10000,0,0,0,0,10000,-10000,-10000
062146,大毅國票9B購01  ,0,0,0,0,0,0,0,0,0,-10000,0,0,0,2000,12000,-10000,-10000
061961,台積電統一01購02,0,0,0,0,0,0,0,0,0,-10000,0,0,0,0,10000,-10000,-10000
062082,嘉晶元大9B購01  ,0,0,0,0,0,0,0,0,0,-10000,0,0,0,0,10000,-10000,-10000
06204P,鴻海群益97售04  ,0,0,0,0,0,0,0,0,0,-10000,0,0,0,0,10000,-10000,-10000
062058,瑞昱統一01購01  ,0,0,0,0,0,0,0,0,0,-10000,0,0,0,0,10000,-10000,-10000
062375,祥碩元大9B購03  ,0,0,0,0,0,0,0,0,0,-10000,0,0,0,0,10000,-10000,-10000
062557,台光電凱基9B購02,0,0,0,0,0,0,0,0,0,-10000,0,0,0,0,10000,-10000,-10000
062563,緯穎凱基9B購03  ,0,0,0,0,0,0,0,0,0,-10000,0,0,0,0,10000,-10000,-10000
062544,信錦永豐9B購01  ,0,0,0,0,0,0,0,0,0,-10000,0,0,0,0,10000,-10000,-10000
062436,國巨元大9B購14  ,0,0,0,0,0,0,0,0,0,-10000,0,0,0,0,10000,-10000,-10000
062447,華擎元大9C購01  ,0,0,0,0,0,0,0,0,0,-10000,0,0,0,0,10000,-10000,-10000
4737,華廣            ,2000,12000,-10000,0,0,0,0,0,0,0,0,0,0,0,0,0,-10000
2022,聚亨            ,41000,5000,36000,0,0,0,0,0,0,-47000,7000,54000,-47000,0,0,0,-11000
07611P,大立光國票9A售05,0,0,0,0,0,0,0,0,0,-11000,0,0,0,0,11000,-11000,-11000
07631P,臺股指凱基9A售12,0,0,0,0,0,0,0,0,0,-11000,0,0,0,0,11000,-11000,-11000
07751P,世紀鋼凱基9A售02,0,0,0,0,0,0,0,0,0,-11000,0,0,0,25000,36000,-11000,-11000
08115P,聯發科凱基9B售13,0,0,0,0,0,0,0,0,0,-11000,0,0,0,43000,54000,-11000,-11000
063304,大立光凱基01購02,0,0,0,0,0,0,0,0,0,-11000,0,0,0,2000,13000,-11000,-11000
063646,帆宣元大9B購02  ,0,0,0,0,0,0,0,0,0,-11000,0,0,0,0,11000,-11000,-11000
063829,晶技國票01購01  ,0,0,0,0,0,0,0,0,0,-11000,0,0,0,0,11000,-11000,-11000
063731,台積電元大9B購10,0,0,0,0,0,0,0,0,0,-11000,0,0,0,50000,61000,-11000,-11000
07050P,宏達電中信9B售01,0,0,0,0,0,0,0,0,0,-11000,0,0,0,0,11000,-11000,-11000
059475,元石油群益99購02,0,0,0,0,0,0,0,0,0,-11000,0,0,0,0,11000,-11000,-11000
055610,光磊國票98購01  ,0,0,0,0,0,0,0,0,0,-11000,0,0,0,0,11000,-11000,-11000
056578,智易元大99購02  ,0,0,0,0,0,0,0,0,0,-11000,0,0,0,52000,63000,-11000,-11000
055716,致茂元大97購01  ,0,0,0,0,0,0,0,0,0,-11000,0,0,0,85000,96000,-11000,-11000
054916,聯發科凱基98購04,0,0,0,0,0,0,0,0,0,-11000,0,0,0,24000,35000,-11000,-11000
054297,台郡元大98購01  ,0,0,0,0,0,0,0,0,0,-11000,0,0,0,0,11000,-11000,-11000
049335,聯電統一97購01  ,0,0,0,0,0,0,0,0,0,-11000,0,0,0,22000,33000,-11000,-11000
00661,元大日經225     ,0,0,0,0,0,0,0,0,0,-11000,0,0,0,30000,41000,-11000,-11000
057135,立積凱基98購01  ,0,0,0,0,0,0,0,0,0,-11000,0,0,0,44000,55000,-11000,-11000
059853,超眾永豐99購03  ,0,0,0,0,0,0,0,0,0,-11000,0,0,0,92000,103000,-11000,-11000
057436,義隆國票99購02  ,0,0,0,0,0,0,0,0,0,-11000,0,0,0,41000,52000,-11000,-11000
058254,臺股指元大9A購18,0,0,0,0,0,0,0,0,0,-11000,0,0,0,0,11000,-11000,-11000
062178,上銀元大9B購03  ,0,0,0,0,0,0,0,0,0,-11000,0,0,0,0,11000,-11000,-11000
062267,滬深2X群益01購05,0,0,0,0,0,0,0,0,0,-11000,0,0,0,5000,16000,-11000,-11000
062984,致新元富9B購01  ,0,0,0,0,0,0,0,0,0,-11000,0,0,0,127000,138000,-11000,-11000
063046,聯發科兆豐9C購01,0,0,0,0,0,0,0,0,0,-11000,0,0,0,0,11000,-11000,-11000
062732,南六凱基9B購03  ,0,0,0,0,0,0,0,0,0,-11000,0,0,0,55000,66000,-11000,-11000
061341,華新科元大9A購16,0,0,0,0,0,0,0,0,0,-11000,0,0,0,0,11000,-11000,-11000
06148P,台積電元大97售17,0,0,0,0,0,0,0,0,0,-11000,0,0,0,0,11000,-11000,-11000
061510,嘉澤富邦9C購01  ,0,0,0,0,0,0,0,0,0,-11000,0,0,0,9000,20000,-11000,-11000
061759,上証反元大02購01,0,0,0,0,0,0,0,0,0,-11000,0,0,0,0,11000,-11000,-11000
061752,瑞昱台新9B購01  ,0,0,0,0,0,0,0,0,0,-11000,0,0,0,19000,30000,-11000,-11000
5706,鳳凰            ,38000,49000,-11000,0,0,0,0,0,0,0,0,0,0,0,0,0,-11000
5533,皇鼎            ,17000,32000,-15000,0,0,0,0,0,0,4000,4000,0,4000,0,0,0,-11000
3032,偉訓            ,13000,25000,-12000,0,0,0,0,0,0,1000,1000,0,1000,0,0,0,-11000
07056P,臺股指麥證99售02,0,0,0,0,12000,-12000,0,0,0,-12000,0,0,0,0,12000,-12000,-12000
07019P,鴻海台新99售01  ,0,0,0,0,0,0,0,0,0,-12000,0,0,0,0,12000,-12000,-12000
07039P,南電台新99售01  ,0,0,0,0,0,0,0,0,0,-12000,0,0,0,0,12000,-12000,-12000
06934P,聯鈞元大98售03  ,0,0,0,0,0,0,0,0,0,-12000,0,0,0,0,12000,-12000,-12000
063945,京元電元大9C購01,0,0,0,0,0,0,0,0,0,-12000,0,0,0,50000,62000,-12000,-12000
063916,瀚宇博凱基01購01,0,0,0,0,0,0,0,0,0,-12000,0,0,0,0,12000,-12000,-12000
06638P,鴻海統一99售02  ,0,0,0,0,0,0,0,0,0,-12000,0,0,0,57000,69000,-12000,-12000
063567,漢唐元大9B購03  ,0,0,0,0,0,0,0,0,0,-12000,0,0,0,13000,25000,-12000,-12000
07747P,晶技凱基9A售04  ,0,0,0,0,0,0,0,0,0,-12000,0,0,0,46000,58000,-12000,-12000
07545P,玉晶光凱基9A售07,0,0,0,0,0,0,0,0,0,-12000,0,0,0,118000,130000,-12000,-12000
07550P,國巨元大9A售09  ,0,0,0,0,0,0,0,0,0,-12000,0,0,0,0,12000,-12000,-12000
1256,鮮活果汁-KY     ,7000,19000,-12000,0,0,0,0,0,0,0,0,0,0,0,0,0,-12000
054060,晶技國票97購02  ,0,0,0,0,0,0,0,0,0,-12000,0,0,0,25000,37000,-12000,-12000
054161,友訊凱基98購01  ,0,0,0,0,0,0,0,0,0,-12000,0,0,0,0,12000,-12000,-12000
054919,興富發凱基97購01,0,0,0,0,0,0,0,0,0,-12000,0,0,0,0,12000,-12000,-12000
054376,聯茂中信97購01  ,0,0,0,0,0,0,0,0,0,-12000,0,0,0,0,12000,-12000,-12000
059368,T50正2元富99購02,0,0,0,0,0,0,0,0,0,-12000,0,0,0,0,12000,-12000,-12000
059521,南電永豐99購03  ,0,0,0,0,0,0,0,0,0,-12000,0,0,0,0,12000,-12000,-12000
059153,臺股指國票99購16,0,0,0,0,0,0,0,0,0,-12000,0,0,0,26000,38000,-12000,-12000
056164,聯茂凱基98購03  ,0,0,0,0,0,0,0,0,0,-12000,0,0,0,0,12000,-12000,-12000
058282,聯茂中信99購01  ,0,0,0,0,0,0,0,0,0,-12000,0,0,0,0,12000,-12000,-12000
057477,智邦元大98購09  ,0,0,0,0,0,0,0,0,0,-12000,0,0,0,0,12000,-12000,-12000
060957,SP黃豆凱基9A購04,0,0,0,0,0,0,0,0,0,-12000,0,0,0,0,12000,-12000,-12000
060109,茂林元大99購05  ,0,0,0,0,0,0,0,0,0,-12000,0,0,0,0,12000,-12000,-12000
060350,元黃金元富9B購01,0,0,0,0,0,0,0,0,0,-12000,0,0,0,0,12000,-12000,-12000
060416,神隆永豐9A購01  ,0,0,0,0,0,0,0,0,0,-12000,0,0,0,5000,17000,-12000,-12000
058644,元黃金富邦03購01,0,0,0,0,0,0,0,0,0,-12000,0,0,0,0,12000,-12000,-12000
058433,台積電統一9B購04,0,0,0,0,0,0,0,0,0,-12000,0,0,0,0,12000,-12000,-12000
058451,智邦永豐9A購01  ,0,0,0,0,0,0,0,0,0,-12000,0,0,0,0,12000,-12000,-12000
058385,創意中信99購01  ,0,0,0,0,0,0,0,0,0,-12000,0,0,0,8000,20000,-12000,-12000
057799,世紀鋼兆豐98購01,0,0,0,0,0,0,0,0,0,-12000,0,0,0,0,12000,-12000,-12000
058159,健策台新9A購01  ,0,0,0,0,0,0,0,0,0,-12000,0,0,0,3000,15000,-12000,-12000
059863,和大凱基99購01  ,0,0,0,0,0,0,0,0,0,-12000,0,0,0,68000,80000,-12000,-12000
059823,奇力新凱基99購07,0,0,0,0,0,0,0,0,0,-12000,0,0,0,0,12000,-12000,-12000
059827,晶技凱基99購03  ,0,0,0,0,0,0,0,0,0,-12000,0,0,0,0,12000,-12000,-12000
056696,茂林群益98購02  ,0,0,0,0,0,0,0,0,0,-12000,0,0,0,0,12000,-12000,-12000
057621,崇越凱基98購01  ,0,0,0,0,0,0,0,0,0,-12000,0,0,0,0,12000,-12000,-12000
059263,瑞昱中信01購01  ,0,0,0,0,0,0,0,0,0,-12000,0,0,0,0,12000,-12000,-12000
05714P,群創統一97售03  ,0,0,0,0,0,0,0,0,0,-12000,0,0,0,0,12000,-12000,-12000
058948,道瓊銀群益9C購01,0,0,0,0,0,0,0,0,0,-12000,0,0,0,0,12000,-12000,-12000
061643,嘉澤元大9A購05  ,0,0,0,0,0,0,0,0,0,-12000,0,0,0,0,12000,-12000,-12000
061620,禾伸堂群益9A購02,0,0,0,0,0,0,0,0,0,-12000,0,0,0,1000,13000,-12000,-12000
061563,群創國票9B購02  ,0,0,0,0,0,0,0,0,0,-12000,0,0,0,38000,50000,-12000,-12000
061399,喬山兆豐9B購01  ,0,0,0,0,0,0,0,0,0,-12000,0,0,0,0,12000,-12000,-12000
061154,可成群益9B購04  ,0,0,0,0,0,0,0,0,0,-12000,0,0,0,47000,59000,-12000,-12000
061195,健策永豐9B購02  ,0,0,0,0,0,0,0,0,0,-12000,0,0,0,18000,30000,-12000,-12000
061036,晶技永豐9A購03  ,0,0,0,0,0,0,0,0,0,-12000,0,0,0,1000,13000,-12000,-12000
060682,牧德元大9A購03  ,0,0,0,0,0,0,0,0,0,-12000,0,0,0,0,12000,-12000,-12000
060539,道瓊反凱基9A購01,0,0,0,0,0,0,0,0,0,-12000,0,0,0,8000,20000,-12000,-12000
06269P,群創凱基98售10  ,0,0,0,0,0,0,0,0,0,-12000,0,0,0,0,12000,-12000,-12000
062782,聯發科元大9B購12,0,0,0,0,0,0,0,0,0,-12000,0,0,0,38000,50000,-12000,-12000
062171,中磊永豐9B購01  ,0,0,0,0,0,0,0,0,0,-12000,0,0,0,10000,22000,-12000,-12000
06255P,臺股指群益97售08,0,0,0,0,0,0,0,0,0,-12000,0,0,0,3000,15000,-12000,-12000
062294,盛群永豐9B購01  ,0,0,0,0,0,0,0,0,0,-12000,0,0,0,0,12000,-12000,-12000
062322,元金2X統一01購01,0,0,0,0,0,0,0,0,0,-12000,0,0,0,0,12000,-12000,-12000
8341,日友            ,132000,155600,-23600,0,0,0,0,0,0,11000,11000,0,11000,0,0,0,-12600
2705,六福            ,28000,42000,-14000,0,0,0,0,0,0,1000,1000,0,1000,0,0,0,-13000
08193P,同欣電國票9C售02,0,0,0,0,0,0,0,0,0,-13000,0,0,0,36000,49000,-13000,-13000
07834P,聯詠群益9A售03  ,0,0,0,0,0,0,0,0,0,-13000,0,0,0,0,13000,-13000,-13000
07931P,國巨元大9B售03  ,0,0,0,0,0,0,0,0,0,-13000,0,0,0,0,13000,-13000,-13000
063496,儒鴻永豐9B購01  ,0,0,0,0,0,0,0,0,0,-13000,0,0,0,10000,23000,-13000,-13000
063426,茂林凱基9B購03  ,0,0,0,0,0,0,0,0,0,-13000,0,0,0,0,13000,-13000,-13000
063391,南電兆豐9C購01  ,0,0,0,0,0,0,0,0,0,-13000,0,0,0,86000,99000,-13000,-13000
06682P,玉晶光元大99售08,0,0,0,0,0,0,0,0,0,-13000,0,0,0,2000,15000,-13000,-13000
07060P,台表科國票9A售01,0,0,0,0,0,0,0,0,0,-13000,0,0,0,127000,140000,-13000,-13000
07209P,台積電凱基9A售10,0,0,0,0,0,0,0,0,0,-13000,0,0,0,0,13000,-13000,-13000
05617P,大立光統一97售02,0,0,0,0,0,0,0,0,0,-13000,0,0,0,20000,33000,-13000,-13000
054237,茂林群益97購01  ,0,0,0,0,0,0,0,0,0,-13000,0,0,0,0,13000,-13000,-13000
053431,志超永豐96購01  ,0,0,0,0,0,0,0,0,0,-13000,0,0,0,13000,26000,-13000,-13000
053662,矽力凱基97購01  ,0,0,0,0,0,0,0,0,0,-13000,0,0,0,1000,14000,-13000,-13000
051971,元金2X凱基97購02,0,0,0,0,0,0,0,0,0,-13000,0,0,0,0,13000,-13000,-13000
051577,台積電元大97購03,0,0,0,0,0,0,0,0,0,-13000,0,0,0,0,13000,-13000,-13000
058800,健策元大99購03  ,0,0,0,0,0,0,0,0,0,-13000,0,0,0,0,13000,-13000,-13000
058067,台積電第一9C購01,0,0,0,0,0,0,0,0,0,-13000,0,0,0,0,13000,-13000,-13000
058920,SGBR2X元富99購06,0,0,0,0,0,0,0,0,0,-13000,0,0,0,21000,34000,-13000,-13000
057003,立積國票98購01  ,0,0,0,0,0,0,0,0,0,-13000,0,0,0,39000,52000,-13000,-13000
058214,世芯群益9A購01  ,0,0,0,0,0,0,0,0,0,-13000,0,0,0,3000,16000,-13000,-13000
058272,超眾永豐9A購01  ,0,0,0,0,0,0,0,0,0,-13000,0,0,0,58000,71000,-13000,-13000
062474,台表科凱基9C購01,0,0,0,0,0,0,0,0,0,-13000,0,0,0,0,13000,-13000,-13000
063039,大立光凱基9C購02,0,0,0,0,0,0,0,0,0,-13000,0,0,0,14000,27000,-13000,-13000
062995,聚陽國票9C購01  ,0,0,0,0,0,0,0,0,0,-13000,0,0,0,23000,36000,-13000,-13000
061571,奇力新元大9A購03,0,0,0,0,0,0,0,0,0,-13000,0,0,0,90000,103000,-13000,-13000
061758,T50反1元大9B購02,0,0,0,0,0,0,0,0,0,-13000,0,0,0,0,13000,-13000,-13000
6670,復盛應用        ,252000,228000,24000,0,0,0,0,0,0,-37000,42000,96000,-54000,17000,0,17000,-13000
06425P,TPK永豐97售02   ,0,0,0,0,0,0,0,0,0,-14000,0,0,0,0,14000,-14000,-14000
06342P,世芯統一98售01  ,0,0,0,0,0,0,0,0,0,-14000,0,0,0,26000,40000,-14000,-14000
08149P,祥碩群益9B售07  ,0,0,0,0,0,0,0,0,0,-14000,0,0,0,0,14000,-14000,-14000
039212,台達電台新9A購01,0,0,0,0,0,0,0,0,0,-14000,0,0,0,23000,37000,-14000,-14000
059071,元油2X元大9C購12,0,0,0,0,0,0,0,0,0,-14000,0,0,0,0,14000,-14000,-14000
054343,世紀鋼元富96購02,0,0,0,0,0,0,0,0,0,-14000,0,0,0,124000,138000,-14000,-14000
056452,亞光凱基98購02  ,0,0,0,0,0,0,0,0,0,-14000,0,0,0,30000,44000,-14000,-14000
055032,億光富邦99購01  ,0,0,0,0,0,0,0,0,0,-14000,0,0,0,44000,58000,-14000,-14000
057875,京鼎元大98購03  ,0,0,0,0,0,0,0,0,0,-14000,0,0,0,103000,117000,-14000,-14000
058106,神達統一98購02  ,0,0,0,0,0,0,0,0,0,-14000,0,0,0,0,14000,-14000,-14000
059793,滬深2X國票99購03,0,0,0,0,0,0,0,0,0,-14000,0,0,0,0,14000,-14000,-14000
059852,康控永豐99購02  ,0,0,0,0,0,0,0,0,0,-14000,0,0,0,71000,85000,-14000,-14000
057121,立積康和98購01  ,0,0,0,0,0,0,0,0,0,-14000,0,0,0,0,14000,-14000,-14000
061839,華新科凱基05購04,0,0,0,0,0,0,0,0,0,-14000,0,0,0,0,14000,-14000,-14000
061370,晶技國泰9C購01  ,0,0,0,0,0,0,0,0,0,-14000,0,0,0,48000,62000,-14000,-14000
061425,華新科元大9A購19,0,0,0,0,0,0,0,0,0,-14000,0,0,0,3000,17000,-14000,-14000
061410,緯穎國票9A購03  ,0,0,0,0,0,0,0,0,0,-14000,0,0,0,8000,22000,-14000,-14000
060502,國巨元大9A購07  ,0,0,0,0,0,0,0,0,0,-14000,0,0,0,6000,20000,-14000,-14000
060620,玉晶光元大9A購04,0,0,0,0,0,0,0,0,0,-14000,0,0,0,81000,95000,-14000,-14000
060688,世紀鋼元大9C購01,0,0,0,0,0,0,0,0,0,-14000,0,0,0,50000,64000,-14000,-14000
060878,奇力新中信9C購01,0,0,0,0,0,0,0,0,0,-14000,0,0,0,20000,34000,-14000,-14000
063016,微星元大9C購02  ,0,0,0,0,0,0,0,0,0,-14000,0,0,0,138000,152000,-14000,-14000
06322P,超眾統一97售04  ,0,0,0,0,0,0,0,0,0,-14000,0,0,0,0,14000,-14000,-14000
062729,神達凱基9B購02  ,0,0,0,0,0,0,0,0,0,-14000,0,0,0,12000,26000,-14000,-14000
062476,神隆國票9B購01  ,0,0,0,0,0,0,0,0,0,-14000,0,0,0,2000,16000,-14000,-14000
062371,健策元大9B購08  ,0,0,0,0,0,0,0,0,0,-14000,0,0,0,51000,65000,-14000,-14000
9910,豐泰            ,750407,746612,3795,0,0,0,120000,237000,-117000,99000,116000,17000,99000,0,0,0,-14205
08051P,臺股指國票9B售16,0,0,0,0,0,0,0,0,0,-15000,0,0,0,4000,19000,-15000,-15000
08038P,臺股指群益9B售11,0,0,0,0,0,0,0,0,0,-15000,0,0,0,0,15000,-15000,-15000
08028P,臺股指元大9B售30,0,0,0,0,0,0,0,0,0,-15000,0,0,0,0,15000,-15000,-15000
07939P,台積電統一9B售14,0,0,0,0,0,0,0,0,0,-15000,0,0,0,0,15000,-15000,-15000
07798P,同欣電國票9A售01,0,0,0,0,0,0,0,0,0,-15000,0,0,0,20000,35000,-15000,-15000
07637P,國巨國票9A售08  ,0,0,0,0,0,0,0,0,0,-15000,0,0,0,0,15000,-15000,-15000
07772P,華新科國票9A售05,0,0,0,0,0,0,0,0,0,-15000,0,0,0,52000,67000,-15000,-15000
07463P,台積電國票9A售05,0,0,0,0,0,0,0,0,0,-15000,0,0,0,0,15000,-15000,-15000
07448P,台灣50元大9A售08,0,0,0,0,0,0,0,0,0,-15000,0,0,0,0,15000,-15000,-15000
2414,精技            ,5000,21000,-16000,0,0,0,0,0,0,1000,1000,0,1000,0,0,0,-15000
08208P,臺股指群益9B售16,0,0,0,0,0,0,0,0,0,-15000,0,0,0,0,15000,-15000,-15000
08224P,臺股指凱基9B售19,0,0,0,0,0,0,0,0,0,-15000,0,0,0,0,15000,-15000,-15000
063274,鈺齊兆豐9B購01  ,0,0,0,0,0,0,0,0,0,-15000,0,0,0,40000,55000,-15000,-15000
063249,祥碩元大9B購06  ,0,0,0,0,0,0,0,0,0,-15000,0,0,0,122000,137000,-15000,-15000
063790,南亞科台新9C購01,0,0,0,0,0,0,0,0,0,-15000,0,0,0,0,15000,-15000,-15000
06426P,T50正2元大9B售01,0,0,0,0,0,0,0,0,0,-15000,0,0,0,0,15000,-15000,-15000
06471P,臺股指凱基99售11,0,0,0,0,0,0,0,0,0,-15000,0,0,0,5000,20000,-15000,-15000
063949,大立光元大9C購10,0,0,0,0,0,0,0,0,0,-15000,0,0,0,0,15000,-15000,-15000
063888,TPK中信01購01   ,0,0,0,0,0,0,0,0,0,-15000,0,0,0,0,15000,-15000,-15000
07274P,上証2X群益01售01,0,0,0,0,0,0,0,0,0,-15000,0,0,0,10000,25000,-15000,-15000
06940P,旺宏永豐98售05  ,0,0,0,0,0,0,0,0,0,-15000,0,0,0,0,15000,-15000,-15000
06993P,鴻海凱基99售05  ,0,0,0,0,0,0,0,0,0,-15000,0,0,0,0,15000,-15000,-15000
054965,健策元大98購04  ,0,0,0,0,0,0,0,0,0,-15000,0,0,0,5000,20000,-15000,-15000
056462,訊芯凱基98購03  ,0,0,0,0,0,0,0,0,0,-15000,0,0,0,65000,80000,-15000,-15000
054354,技嘉富邦97購01  ,0,0,0,0,0,0,0,0,0,-15000,0,0,0,0,15000,-15000,-15000
059118,晶技永豐9A購01  ,0,0,0,0,0,0,0,0,0,-15000,0,0,0,12000,27000,-15000,-15000
056250,瑞昱兆豐97購02  ,0,0,0,0,0,0,0,0,0,-15000,0,0,0,0,15000,-15000,-15000
055996,矽力國泰99購01  ,0,0,0,0,0,0,0,0,0,-15000,0,0,0,5000,20000,-15000,-15000
056637,台光電日盛9A購01,0,0,0,0,0,0,0,0,0,-15000,0,0,0,0,15000,-15000,-15000
045443,群創元富98購01  ,0,0,0,0,0,0,0,0,0,-15000,0,0,0,0,15000,-15000,-15000
054235,欣興群益96購06  ,0,0,0,0,0,0,0,0,0,-15000,0,0,0,0,15000,-15000,-15000
054169,上緯控凱基98購01,0,0,0,0,0,0,0,0,0,-15000,0,0,0,85000,100000,-15000,-15000
057930,旺宏群益99購04  ,0,0,0,0,0,0,0,0,0,-15000,0,0,0,24000,39000,-15000,-15000
057916,國巨凱基98購13  ,0,0,0,0,0,0,0,0,0,-15000,0,0,0,40000,55000,-15000,-15000
059253,康控凱基9B購02  ,0,0,0,0,0,0,0,0,0,-15000,0,0,0,43000,58000,-15000,-15000
059390,華新科凱基99購05,0,0,0,0,0,0,0,0,0,-15000,0,0,0,0,15000,-15000,-15000
058989,茂林凱基99購02  ,0,0,0,0,0,0,0,0,0,-15000,0,0,0,11000,26000,-15000,-15000
058900,旺宏元大99購11  ,0,0,0,0,0,0,0,0,0,-15000,0,0,0,135000,150000,-15000,-15000
058042,鴻海元大98購12  ,0,0,0,0,0,0,0,0,0,-15000,0,0,0,5000,20000,-15000,-15000
057626,技嘉富邦9A購01  ,0,0,0,0,0,0,0,0,0,-15000,0,0,0,193000,208000,-15000,-15000
058074,欣興凱基99購01  ,0,0,0,0,0,0,0,0,0,-15000,0,0,0,0,15000,-15000,-15000
057794,T50反1兆豐99購02,0,0,0,0,0,0,0,0,0,-15000,0,0,0,0,15000,-15000,-15000
057828,緯穎元大99購02  ,0,0,0,0,0,0,0,0,0,-15000,0,0,0,10000,25000,-15000,-15000
058709,臺股指元大9A購22,0,0,0,0,0,0,0,0,0,-15000,0,0,0,0,15000,-15000,-15000
058697,亞德客元大99購01,0,0,0,0,0,0,0,0,0,-15000,0,0,0,0,15000,-15000,-15000
058623,國巨國票99購08  ,0,0,0,0,0,0,0,0,0,-15000,0,0,0,11000,26000,-15000,-15000
058517,景碩元大99購06  ,0,0,0,0,0,0,0,0,0,-15000,0,0,0,3000,18000,-15000,-15000
058290,南電國票9A購01  ,0,0,0,0,0,0,0,0,0,-15000,0,0,0,7000,22000,-15000,-15000
060978,國巨元大9A購13  ,0,0,0,0,0,0,0,0,0,-15000,0,0,0,5000,20000,-15000,-15000
060434,台汽電永豐9A購01,0,0,0,0,0,0,0,0,0,-15000,0,0,0,0,15000,-15000,-15000
060235,瑞昱元大9A購01  ,0,0,0,0,0,0,0,0,0,-15000,0,0,0,0,15000,-15000,-15000
062454,華通群益9C購03  ,0,0,0,0,0,0,0,0,0,-15000,0,0,0,15000,30000,-15000,-15000
062574,美食群益9B購02  ,0,0,0,0,0,0,0,0,0,-15000,0,0,0,197000,212000,-15000,-15000
062572,元金反群益9C購01,0,0,0,0,0,0,0,0,0,-15000,0,0,0,5000,20000,-15000,-15000
062060,奇鋐統一9C購01  ,0,0,0,0,0,0,0,0,0,-15000,0,0,0,10000,25000,-15000,-15000
062696,國巨元大9B購16  ,0,0,0,0,0,0,0,0,0,-15000,0,0,0,0,15000,-15000,-15000
062668,國巨中信9B購04  ,0,0,0,0,0,0,0,0,0,-15000,0,0,0,0,15000,-15000,-15000
062862,瑞儀國票9B購01  ,0,0,0,0,0,0,0,0,0,-15000,0,0,0,0,15000,-15000,-15000
063058,A50正2元富02購01,0,0,0,0,0,0,0,0,0,-15000,0,0,0,295000,310000,-15000,-15000
063070,奇力新富邦01購01,0,0,0,0,0,0,0,0,0,-15000,0,0,0,0,15000,-15000,-15000
063101,華通群益9B購07  ,0,0,0,0,0,0,0,0,0,-15000,0,0,0,17000,32000,-15000,-15000
061045,儒鴻第一9A購01  ,0,0,0,0,0,0,0,0,0,-15000,0,0,0,0,15000,-15000,-15000
061307,和潤永豐9A購02  ,0,0,0,0,0,0,0,0,0,-15000,0,0,0,14000,29000,-15000,-15000
061929,嘉澤凱基9B購01  ,0,0,0,0,0,0,0,0,0,-15000,0,0,0,0,15000,-15000,-15000
910322,康師傅-DR       ,0,15000,-15000,0,0,0,0,0,0,0,0,0,0,0,0,0,-15000
6005,群益證          ,1040000,1048000,-8000,0,0,0,0,7000,-7000,0,0,0,0,0,0,0,-15000
07236P,台灣50國票99售05,0,0,0,0,0,0,0,0,0,-16000,0,0,0,0,16000,-16000,-16000
063649,南六元大9C購02  ,1000,0,1000,0,0,0,0,0,0,-17000,0,0,0,186000,203000,-17000,-16000
06326P,鴻海中信01售01  ,0,0,0,0,0,0,0,0,0,-16000,0,0,0,0,16000,-16000,-16000
063481,緯穎元大9B購08  ,0,0,0,0,0,0,0,0,0,-16000,0,0,0,50000,66000,-16000,-16000
056358,友訊元大99購01  ,0,0,0,0,0,0,0,0,0,-16000,0,0,0,75000,91000,-16000,-16000
055490,台光電元大97購01,0,0,0,0,0,0,0,0,0,-16000,0,0,0,34000,50000,-16000,-16000
03033X,元展30          ,0,0,0,0,0,0,0,0,0,-16000,0,0,0,0,16000,-16000,-16000
059206,元石油元大99購02,0,0,0,0,0,0,0,0,0,-16000,0,0,0,14000,30000,-16000,-16000
059000,台積電元大99購25,0,0,0,0,0,0,0,0,0,-16000,0,0,0,52000,68000,-16000,-16000
054420,緯穎元大96購08  ,0,0,0,0,0,0,0,0,0,-16000,0,0,0,35000,51000,-16000,-16000
055589,台光電元大98購04,0,0,0,0,0,0,0,0,0,-16000,0,0,0,32000,48000,-16000,-16000
055727,矽力元大97購02  ,0,0,0,0,0,0,0,0,0,-16000,0,0,0,0,16000,-16000,-16000
058468,聯茂中信99購02  ,0,0,0,0,0,0,0,0,0,-16000,0,0,0,195000,211000,-16000,-16000
058570,臻鼎凱基9A購01  ,0,0,0,0,0,0,0,0,0,-16000,0,0,0,22000,38000,-16000,-16000
057882,華通群益9A購03  ,0,0,0,0,0,0,0,0,0,-16000,0,0,0,9000,25000,-16000,-16000
057907,台達電亞東99購01,0,0,0,0,0,0,0,0,0,-16000,0,0,0,0,16000,-16000,-16000
057060,緯穎元大98購05  ,0,0,0,0,0,0,0,0,0,-16000,0,0,0,12000,28000,-16000,-16000
056980,建準群益98購02  ,0,0,0,0,0,0,0,0,0,-16000,0,0,0,40000,56000,-16000,-16000
056947,國巨統一9A購01  ,0,0,0,0,0,0,0,0,0,-16000,0,0,0,0,16000,-16000,-16000
059984,華新科元大99購21,0,0,0,0,0,0,0,0,0,-16000,0,0,0,47000,63000,-16000,-16000
060044,大立光群益99購09,0,0,0,0,0,0,0,0,0,-16000,0,0,0,11000,27000,-16000,-16000
058843,元油2X群益9C購02,0,0,0,0,0,0,0,0,0,-16000,0,0,0,24000,40000,-16000,-16000
059713,滬深2X元大9C購04,0,0,0,0,0,0,0,0,0,-16000,0,0,0,1000,17000,-16000,-16000
059213,國巨元大99購19  ,0,0,0,0,0,0,0,0,0,-16000,0,0,0,20000,36000,-16000,-16000
059289,瑞昱元富99購01  ,0,0,0,0,0,0,0,0,0,-16000,0,0,0,23000,39000,-16000,-16000
061814,聯發科群益9B購04,0,0,0,0,0,0,0,0,0,-16000,0,0,0,28000,44000,-16000,-16000
061633,統一元大9A購01  ,0,0,0,0,0,0,0,0,0,-16000,0,0,0,65000,81000,-16000,-16000
061027,儒鴻永豐9A購02  ,0,0,0,0,0,0,0,0,0,-16000,0,0,0,1000,17000,-16000,-16000
061205,旺宏元大9A購11  ,0,0,0,0,0,0,0,0,0,-16000,0,0,0,0,16000,-16000,-16000
060718,中磊永豐9A購01  ,0,0,0,0,0,0,0,0,0,-16000,0,0,0,10000,26000,-16000,-16000
060761,南亞科元大9A購05,0,0,0,0,0,0,0,0,0,-16000,0,0,0,84000,100000,-16000,-16000
062855,嘉澤永豐9B購02  ,0,0,0,0,0,0,0,0,0,-16000,0,0,0,0,16000,-16000,-16000
062739,嘉晶國票9B購02  ,0,0,0,0,0,0,0,0,0,-16000,0,0,0,6000,22000,-16000,-16000
062045,崇越凱基9B購01  ,0,0,0,0,0,0,0,0,0,-16000,0,0,0,14000,30000,-16000,-16000
062500,國巨群益01購01  ,0,0,0,0,0,0,0,0,0,-16000,0,0,0,32000,48000,-16000,-16000
062423,聯發科統一9C購07,0,0,0,0,0,0,0,0,0,-16000,0,0,0,372000,388000,-16000,-16000
6533,晶心科          ,90000,113000,-23000,0,0,0,0,0,0,7000,9000,2000,7000,0,0,0,-16000
06505P,康控國票99售02  ,0,0,0,0,0,0,0,0,0,-17000,0,0,0,10000,27000,-17000,-17000
1435,中福            ,4000,21000,-17000,0,0,0,0,0,0,0,0,0,0,0,0,0,-17000
1466,聚隆            ,6000,23000,-17000,0,0,0,0,0,0,0,0,0,0,0,0,0,-17000
1531,高林股          ,8000,28000,-20000,0,0,0,0,0,0,3000,3000,0,3000,0,0,0,-17000
07728P,臺股指凱基9A售20,0,0,0,0,0,0,0,0,0,-17000,0,0,0,31000,48000,-17000,-17000
07886P,國巨國票9B售06  ,0,0,0,0,0,0,0,0,0,-17000,0,0,0,3000,20000,-17000,-17000
055775,友達凱基9A購01  ,0,0,0,0,0,0,0,0,0,-17000,0,0,0,35000,52000,-17000,-17000
055138,大毅永豐97購02  ,0,0,0,0,0,0,0,0,0,-17000,0,0,0,41000,58000,-17000,-17000
059060,大立光凱基9A購03,0,0,0,0,0,0,0,0,0,-17000,0,0,0,0,17000,-17000,-17000
059075,FBVIX元大99購01 ,0,0,0,0,0,0,0,0,0,-17000,0,0,0,10000,27000,-17000,-17000
047547,友達凱基99購02  ,0,0,0,0,0,0,0,0,0,-17000,0,0,0,0,17000,-17000,-17000
056416,華新科中信98購01,0,0,0,0,0,0,0,0,0,-17000,0,0,0,0,17000,-17000,-17000
057063,立積國泰9A購01  ,0,0,0,0,0,0,0,0,0,-17000,0,0,0,0,17000,-17000,-17000
058502,鴻海元大99購13  ,0,0,0,0,0,0,0,0,0,-17000,0,0,0,35000,52000,-17000,-17000
060265,宏達電國票9A購02,0,0,0,0,0,0,0,0,0,-17000,0,0,0,10000,27000,-17000,-17000
062135,國巨群益9B購05  ,0,0,0,0,0,0,0,0,0,-17000,0,0,0,54000,71000,-17000,-17000
063180,台塑凱基9B購01  ,0,0,0,0,0,0,0,0,0,-17000,0,0,0,0,17000,-17000,-17000
061181,牧德凱基9A購01  ,0,0,0,0,0,0,0,0,0,-17000,0,0,0,18000,35000,-17000,-17000
061754,晶技麥證9B購01  ,0,0,0,0,17000,-17000,0,0,0,-17000,0,0,0,0,17000,-17000,-17000
061366,台勝科國票9A購01,0,0,0,0,0,0,0,0,0,-17000,0,0,0,67000,84000,-17000,-17000
07782P,寶成凱基9A售02  ,0,0,0,0,0,0,0,0,0,-18000,0,0,0,4000,22000,-18000,-18000
08176P,國巨元大9B售20  ,0,0,0,0,0,0,0,0,0,-18000,0,0,0,0,18000,-18000,-18000
2429,銘旺科          ,17000,35000,-18000,0,0,0,0,0,0,0,0,0,0,0,0,0,-18000
063986,聯發科富邦02購01,0,0,0,0,0,0,0,0,0,-18000,0,0,0,0,18000,-18000,-18000
063388,台光電兆豐9C購01,0,0,0,0,0,0,0,0,0,-18000,0,0,0,5000,23000,-18000,-18000
063547,大立光兆豐9B購04,0,0,0,0,0,0,0,0,0,-18000,0,0,0,4000,22000,-18000,-18000
063759,義隆統一9C購01  ,0,0,0,0,0,0,0,0,0,-18000,0,0,0,60000,78000,-18000,-18000
055433,嘉聯益群益99購01,0,0,0,0,0,0,0,0,0,-18000,0,0,0,764000,782000,-18000,-18000
053378,台積電元大98購02,0,0,0,0,0,0,0,0,0,-18000,0,0,0,1000,19000,-18000,-18000
053904,漢唐凱基97購01  ,0,0,0,0,0,0,0,0,0,-18000,0,0,0,0,18000,-18000,-18000
020011,統一微波高息20N ,0,0,0,0,0,0,0,0,0,-18000,0,0,0,3000,21000,-18000,-18000
05588P,群創兆豐97售02  ,0,0,0,0,0,0,0,0,0,-18000,0,0,0,0,18000,-18000,-18000
056582,易華電元大98購01,0,0,0,0,0,0,0,0,0,-18000,0,0,0,50000,68000,-18000,-18000
056520,鴻海日盛99購01  ,0,0,0,0,0,0,0,0,0,-18000,0,0,0,0,18000,-18000,-18000
057498,台郡元大98購04  ,0,0,0,0,0,0,0,0,0,-18000,0,0,0,50000,68000,-18000,-18000
057483,微星元大98購04  ,0,0,0,0,0,0,0,0,0,-18000,0,0,0,11000,29000,-18000,-18000
058601,台積電元大99購10,0,0,0,0,0,0,0,0,0,-18000,0,0,0,29000,47000,-18000,-18000
056909,嘉聯益元大99購03,0,0,0,0,0,0,0,0,0,-18000,0,0,0,454000,472000,-18000,-18000
057151,易華電國票99購01,0,0,0,0,0,0,0,0,0,-18000,0,0,0,100000,118000,-18000,-18000
057191,祥碩元大98購05  ,0,0,0,0,0,0,0,0,0,-18000,0,0,0,14000,32000,-18000,-18000
059729,群創元大9C購05  ,0,0,0,0,0,0,0,0,0,-18000,0,0,0,137000,155000,-18000,-18000
061546,大立光群益9A購05,0,0,0,0,0,0,0,0,0,-18000,0,0,0,21000,39000,-18000,-18000
061732,智邦中信9B購01  ,0,0,0,0,0,0,0,0,0,-18000,0,0,0,0,18000,-18000,-18000
061738,聯發科凱基9B購04,0,0,0,0,0,0,0,0,0,-18000,0,0,0,2000,20000,-18000,-18000
061150,國巨群益9A購09  ,0,0,0,0,0,0,0,0,0,-18000,0,0,0,22000,40000,-18000,-18000
063145,台表科統一02購01,0,0,0,0,0,0,0,0,0,-18000,0,0,0,287000,305000,-18000,-18000
062717,華邦電凱基9C購01,0,0,0,0,0,0,0,0,0,-18000,0,0,0,30000,48000,-18000,-18000
062811,鴻海兆豐9B購01  ,0,0,0,0,0,0,0,0,0,-18000,0,0,0,11000,29000,-18000,-18000
062433,上銀元大9B購05  ,0,0,0,0,0,0,0,0,0,-18000,0,0,0,56000,74000,-18000,-18000
9942,茂順            ,41000,60000,-19000,0,0,0,0,0,0,1000,1000,0,1000,0,0,0,-18000
063777,儒鴻永豐9B購02  ,0,0,0,0,0,0,0,0,0,-19000,0,0,0,0,19000,-19000,-19000
063689,可成永豐9B購04  ,0,0,0,0,0,0,0,0,0,-19000,0,0,0,41000,60000,-19000,-19000
063414,鴻海凱基03購01  ,0,0,0,0,0,0,0,0,0,-19000,0,0,0,0,19000,-19000,-19000
063374,嘉澤永豐9B購04  ,0,0,0,0,0,0,0,0,0,-19000,0,0,0,0,19000,-19000,-19000
07048P,台積電中信03售01,0,0,0,0,0,0,0,0,0,-19000,0,0,0,13000,32000,-19000,-19000
07141P,台灣50國票9A售03,0,0,0,0,0,0,0,0,0,-19000,0,0,0,0,19000,-19000,-19000
06839P,玉晶光統一9A售05,0,0,0,0,0,0,0,0,0,-19000,0,0,0,58000,77000,-19000,-19000
2739,寒舍            ,47000,66000,-19000,0,0,0,0,0,0,0,0,0,0,0,0,0,-19000
08225P,臺股指凱基9B售20,0,0,0,0,0,0,0,0,0,-19000,0,0,0,0,19000,-19000,-19000
054531,聯發科國泰97購02,0,0,0,0,0,0,0,0,0,-19000,0,0,0,26000,45000,-19000,-19000
055221,矽創凱基97購02  ,0,0,0,0,0,0,0,0,0,-19000,0,0,0,1000,20000,-19000,-19000
03437B,臺股指元富9C熊01,0,0,0,0,0,0,0,0,0,-19000,0,0,0,9000,28000,-19000,-19000
053834,卜蜂永豐96購01  ,0,0,0,0,0,0,0,0,0,-19000,0,0,0,21000,40000,-19000,-19000
052937,國巨兆豐97購01  ,0,0,0,0,0,0,0,0,0,-19000,0,0,0,0,19000,-19000,-19000
053072,國巨台新97購01  ,0,0,0,0,0,0,0,0,0,-19000,0,0,0,1000,20000,-19000,-19000
053111,緯創兆豐97購01  ,0,0,0,0,0,0,0,0,0,-19000,0,0,0,1000,20000,-19000,-19000
056335,微星凱基98購01  ,0,0,0,0,0,0,0,0,0,-19000,0,0,0,11000,30000,-19000,-19000
057997,旺宏第一9C購01  ,0,0,0,0,0,0,0,0,0,-19000,0,0,0,0,19000,-19000,-19000
059264,台光電中信99購02,0,0,0,0,0,0,0,0,0,-19000,0,0,0,1000,20000,-19000,-19000
056796,國巨麥證98購02  ,0,0,0,14000,33000,-19000,0,0,0,-19000,0,0,0,14000,33000,-19000,-19000
057651,矽力元大98購03  ,0,0,0,0,0,0,0,0,0,-19000,0,0,0,39000,58000,-19000,-19000
057509,聯發科統一9A購03,0,0,0,0,0,0,0,0,0,-19000,0,0,0,2000,21000,-19000,-19000
060386,台勝科凱基9B購01,0,0,0,0,0,0,0,0,0,-19000,0,0,0,2000,21000,-19000,-19000
062323,上銀統一9B購03  ,0,0,0,0,0,0,0,0,0,-19000,0,0,0,67000,86000,-19000,-19000
062234,廣達凱基9B購01  ,0,0,0,0,0,0,0,0,0,-19000,0,0,0,16000,35000,-19000,-19000
062051,上銀統一9C購02  ,0,0,0,0,0,0,0,0,0,-19000,0,0,0,42000,61000,-19000,-19000
062681,全新統一01購01  ,0,0,0,0,0,0,0,0,0,-19000,0,0,0,1000,20000,-19000,-19000
062725,大立光凱基9B購06,0,0,0,0,0,0,0,0,0,-19000,0,0,0,8000,27000,-19000,-19000
062625,華通國票9B購02  ,0,0,0,0,0,0,0,0,0,-19000,0,0,0,54000,73000,-19000,-19000
063085,嘉澤凱基9C購01  ,0,0,0,0,0,0,0,0,0,-19000,0,0,0,20000,39000,-19000,-19000
062969,旺宏元富9B購01  ,0,0,0,0,0,0,0,0,0,-19000,0,0,0,13000,32000,-19000,-19000
060894,奇力新凱基9A購03,0,0,0,0,0,0,0,0,0,-19000,0,0,0,0,19000,-19000,-19000
061751,華通台新9B購01  ,0,0,0,0,0,0,0,0,0,-19000,0,0,0,14000,33000,-19000,-19000
061945,華通群益9B購04  ,0,0,0,0,0,0,0,0,0,-19000,0,0,0,7000,26000,-19000,-19000
061388,台積電群益9A購05,0,0,0,0,0,0,0,0,0,-19000,0,0,0,5000,24000,-19000,-19000
08230P,台表科國票9C售03,0,0,0,0,0,0,0,0,0,-20000,0,0,0,0,20000,-20000,-20000
08228P,華擎國票9C售01  ,0,0,0,0,0,0,0,0,0,-20000,0,0,0,0,20000,-20000,-20000
08236P,國巨富邦03售01  ,0,0,0,0,0,0,0,0,0,-20000,0,0,0,0,20000,-20000,-20000
2496,卓越            ,1000,21000,-20000,0,0,0,0,0,0,0,0,0,0,0,0,0,-20000
08165P,台表科永豐9B售02,0,0,0,0,0,0,0,0,0,-20000,0,0,0,0,20000,-20000,-20000
08123P,台表科國票9C售01,0,0,0,0,0,0,0,0,0,-20000,0,0,0,0,20000,-20000,-20000
07672P,南電元大9A售05  ,0,0,0,0,0,0,0,0,0,-20000,0,0,0,10000,30000,-20000,-20000
07698P,臺股指元大9A售51,0,0,0,0,0,0,0,0,0,-20000,0,0,0,0,20000,-20000,-20000
07632P,臺股指凱基9A售14,0,0,0,0,0,0,0,0,0,-20000,0,0,0,10000,30000,-20000,-20000
07419P,聯發科元大99售46,0,0,0,0,0,0,0,0,0,-20000,0,0,0,0,20000,-20000,-20000
07395P,台積電群益99售13,0,0,0,0,0,0,0,0,0,-20000,0,0,0,0,20000,-20000,-20000
07379P,大立光元大99售30,0,0,0,0,0,0,0,0,0,-20000,0,0,0,0,20000,-20000,-20000
07318P,鴻海凱基01售02  ,0,0,0,0,0,0,0,0,0,-20000,0,0,0,0,20000,-20000,-20000
06986P,台積電台新9A售01,0,0,0,0,0,0,0,0,0,-20000,0,0,0,100000,120000,-20000,-20000
07034P,大立光元富99售03,0,0,0,0,0,0,0,0,0,-20000,0,0,0,0,20000,-20000,-20000
06952P,大立光統一9A售03,0,0,0,0,0,0,0,0,0,-20000,0,0,0,0,20000,-20000,-20000
07051P,大立光中信99售02,0,0,0,0,0,0,0,0,0,-20000,0,0,0,0,20000,-20000,-20000
07203P,T50正2凱基9C售02,0,0,0,0,0,0,0,0,0,-20000,0,0,0,0,20000,-20000,-20000
06405P,億光元富97售02  ,0,0,0,0,0,0,0,0,0,-20000,0,0,0,0,20000,-20000,-20000
063930,高鐵統一02購02  ,0,0,0,0,0,0,0,0,0,-20000,0,0,0,0,20000,-20000,-20000
063934,寶成統一02購01  ,0,0,0,0,0,0,0,0,0,-20000,0,0,0,0,20000,-20000,-20000
06720P,智邦亞東99售01  ,0,0,0,0,0,0,0,0,0,-20000,0,0,0,0,20000,-20000,-20000
06564P,國巨富邦9A售04  ,0,0,0,0,0,0,0,0,0,-20000,0,0,0,0,20000,-20000,-20000
06327P,台積電中信01售01,0,0,0,0,0,0,0,0,0,-20000,0,0,0,10000,30000,-20000,-20000
063283,華新科元大9C購03,0,0,0,0,0,0,0,0,0,-20000,0,0,0,0,20000,-20000,-20000
063292,致新元大9B購02  ,0,0,0,0,0,0,0,0,0,-20000,0,0,0,53000,73000,-20000,-20000
063476,台表科元大9C購03,0,0,0,0,0,0,0,0,0,-20000,0,0,0,140000,160000,-20000,-20000
063623,祥碩兆豐9B購02  ,0,0,0,0,0,0,0,0,0,-20000,0,0,0,10000,30000,-20000,-20000
063794,亞德客凱基9C購01,0,0,0,0,0,0,0,0,0,-20000,0,0,0,1000,21000,-20000,-20000
056383,上銀國泰99購01  ,0,0,0,0,0,0,0,0,0,-20000,0,0,0,0,20000,-20000,-20000
056424,泰碩統一98購01  ,0,0,0,0,0,0,0,0,0,-20000,0,0,0,0,20000,-20000,-20000
055430,宏達電群益97購01,0,0,0,0,0,0,0,0,0,-20000,0,0,0,0,20000,-20000,-20000
055435,佳世達中信99購01,0,0,0,0,0,0,0,0,0,-20000,0,0,0,0,20000,-20000,-20000
05631P,國巨富邦9A售01  ,0,0,0,0,0,0,0,0,0,-20000,0,0,0,10000,30000,-20000,-20000
054212,聯詠國票97購03  ,0,0,0,0,0,0,0,0,0,-20000,0,0,0,0,20000,-20000,-20000
052788,開發金中信98購02,0,0,0,0,0,0,0,0,0,-20000,0,0,0,0,20000,-20000,-20000
053797,台積電中信98購01,0,0,0,0,0,0,0,0,0,-20000,0,0,0,0,20000,-20000,-20000
048070,聯發科元富99購03,0,0,0,0,0,0,0,0,0,-20000,0,0,0,0,20000,-20000,-20000
053883,大立光中信98購02,0,0,0,0,0,0,0,0,0,-20000,0,0,0,0,20000,-20000,-20000
052077,可成元富98購02  ,0,0,0,0,0,0,0,0,0,-20000,0,0,0,0,20000,-20000,-20000
046383,群創凱基98購01  ,0,0,0,0,0,0,0,0,0,-20000,0,0,0,60000,80000,-20000,-20000
050890,南電富邦99購01  ,0,0,0,0,0,0,0,0,0,-20000,0,0,0,12000,32000,-20000,-20000
00736,國泰新興市場    ,0,0,0,0,0,0,0,0,0,-20000,0,0,0,110000,130000,-20000,-20000
055080,正崴中信99購01  ,0,0,0,0,0,0,0,0,0,-20000,0,0,0,0,20000,-20000,-20000
055094,智易群益98購01  ,0,0,0,0,0,0,0,0,0,-20000,0,0,0,0,20000,-20000,-20000
055780,禾伸堂凱基99購01,0,0,0,0,0,0,0,0,0,-20000,0,0,0,0,20000,-20000,-20000
055730,建準元富97購02  ,0,0,0,0,0,0,0,0,0,-20000,0,0,0,0,20000,-20000,-20000
054763,宏達電國票99購01,0,0,0,0,0,0,0,0,0,-20000,0,0,0,0,20000,-20000,-20000
056524,欣興中信98購02  ,0,0,0,0,0,0,0,0,0,-20000,0,0,0,0,20000,-20000,-20000
056479,玉晶光元大99購05,0,0,0,0,0,0,0,0,0,-20000,0,0,0,34000,54000,-20000,-20000
05649P,矽創國票97售03  ,0,0,0,0,0,0,0,0,0,-20000,0,0,0,0,20000,-20000,-20000
059343,宏達電凱基99購04,0,0,0,0,0,0,0,0,0,-20000,0,0,0,0,20000,-20000,-20000
056182,台光電統一97購03,0,0,0,0,0,0,0,0,0,-20000,0,0,0,0,20000,-20000,-20000
056145,緯穎元大98購03  ,0,0,0,0,0,0,0,0,0,-20000,0,0,0,0,20000,-20000,-20000
056155,嘉晶凱基97購01  ,0,0,0,0,0,0,0,0,0,-20000,0,0,0,5000,25000,-20000,-20000
056276,同欣電國泰98購01,0,0,0,0,0,0,0,0,0,-20000,0,0,0,0,20000,-20000,-20000
055816,新日興國票98購01,0,0,0,0,0,0,0,0,0,-20000,0,0,0,0,20000,-20000,-20000
060435,鈺齊永豐9A購01  ,0,0,0,0,0,0,0,0,0,-20000,0,0,0,20000,40000,-20000,-20000
060446,A50正2元大9A購01,0,0,0,0,0,0,0,0,0,-20000,0,0,0,0,20000,-20000,-20000
060275,元黃金元大9A購01,0,0,0,0,0,0,0,0,0,-20000,0,0,0,0,20000,-20000,-20000
060161,牧德永豐9A購02  ,0,0,0,0,0,0,0,0,0,-20000,0,0,0,0,20000,-20000,-20000
058237,嘉晶元大99購04  ,0,0,0,0,0,0,0,0,0,-20000,0,0,0,2000,22000,-20000,-20000
057423,台郡凱基98購06  ,0,0,0,0,0,0,0,0,0,-20000,0,0,0,0,20000,-20000,-20000
057448,致茂元富98購01  ,0,0,0,0,0,0,0,0,0,-20000,0,0,0,0,20000,-20000,-20000
06096P,全新永豐97售02  ,0,0,0,0,0,0,0,0,0,-20000,0,0,0,32000,52000,-20000,-20000
058373,晶技凱基99購02  ,0,0,0,0,0,0,0,0,0,-20000,0,0,0,0,20000,-20000,-20000
058552,欣興永豐99購01  ,0,0,0,0,0,0,0,0,0,-20000,0,0,0,1000,21000,-20000,-20000
058747,友達凱基9A購03  ,0,0,0,0,0,0,0,0,0,-20000,0,0,0,40000,60000,-20000,-20000
057550,聯發科凱基02購01,0,0,0,0,0,0,0,0,0,-20000,0,0,0,0,20000,-20000,-20000
057540,緯穎日盛99購01  ,0,0,0,0,0,0,0,0,0,-20000,0,0,0,0,20000,-20000,-20000
057841,茂林富邦9A購02  ,0,0,0,0,0,0,0,0,0,-20000,0,0,0,0,20000,-20000,-20000
057729,華新科國泰99購04,0,0,0,0,0,0,0,0,0,-20000,0,0,0,30000,50000,-20000,-20000
057103,禾伸堂中信9A購01,0,0,0,0,0,0,0,0,0,-20000,0,0,0,10000,30000,-20000,-20000
057104,康友中信99購01  ,0,0,0,0,0,0,0,0,0,-20000,0,0,0,0,20000,-20000,-20000
056969,智易永豐98購01  ,0,0,0,0,0,0,0,0,0,-20000,0,0,0,50000,70000,-20000,-20000
06000P,GIS元大96售04   ,0,0,0,0,0,0,0,0,0,-20000,0,0,0,0,20000,-20000,-20000
056926,日月光兆豐98購01,0,0,0,0,0,0,0,0,0,-20000,0,0,0,0,20000,-20000,-20000
057136,立積凱基98購02  ,0,0,0,0,0,0,0,0,0,-20000,0,0,0,19000,39000,-20000,-20000
059260,國巨中信99購05  ,0,0,0,0,0,0,0,0,0,-20000,0,0,0,0,20000,-20000,-20000
057167,台積電元大99購03,0,0,0,0,0,0,0,0,0,-20000,0,0,0,0,20000,-20000,-20000
059403,T50反1台新03購03,0,0,0,0,0,0,0,0,0,-20000,0,0,0,244000,264000,-20000,-20000
059461,鈺齊永豐99購03  ,0,0,0,0,0,0,0,0,0,-20000,0,0,0,20000,40000,-20000,-20000
057263,可成兆豐99購01  ,0,0,0,0,0,0,0,0,0,-20000,0,0,0,0,20000,-20000,-20000
061391,晶技群益9A購02  ,0,0,0,0,0,0,0,0,0,-20000,0,0,0,5000,25000,-20000,-20000
061356,南電元大9A購06  ,0,0,0,0,0,0,0,0,0,-20000,0,0,0,103000,123000,-20000,-20000
061400,可成兆豐9B購02  ,0,0,0,0,0,0,0,0,0,-20000,0,0,0,0,20000,-20000,-20000
061488,奇力新兆豐9A購01,0,0,0,0,0,0,0,0,0,-20000,0,0,0,0,20000,-20000,-20000
061496,華新科國票9A購07,0,0,0,0,0,0,0,0,0,-20000,0,0,0,0,20000,-20000,-20000
061881,緯穎元大9B購02  ,0,0,0,0,0,0,0,0,0,-20000,0,0,0,10000,30000,-20000,-20000
061822,和潤群益9B購01  ,0,0,0,0,0,0,0,0,0,-20000,0,0,0,80000,100000,-20000,-20000
061867,旺宏元大9B購02  ,0,0,0,0,0,0,0,0,0,-20000,0,0,0,10000,30000,-20000,-20000
06185P,台表科元大97售05,0,0,0,0,0,0,0,0,0,-20000,0,0,0,0,20000,-20000,-20000
061735,上銀凱基9B購01  ,0,0,0,0,0,0,0,0,0,-20000,0,0,0,0,20000,-20000,-20000
061721,道瓊反富邦9B購01,0,0,0,0,0,0,0,0,0,-20000,0,0,0,10000,30000,-20000,-20000
061713,華邦電凱基9A購01,0,0,0,0,0,0,0,0,0,-20000,0,0,0,2000,22000,-20000,-20000
061083,京元電兆豐9A購01,0,0,0,0,0,0,0,0,0,-20000,0,0,0,0,20000,-20000,-20000
061173,T50反1凱基04購01,0,0,0,0,0,0,0,0,0,-20000,0,0,0,0,20000,-20000,-20000
061250,臺股指群益9A購01,0,0,0,0,0,0,0,0,0,-20000,0,0,0,0,20000,-20000,-20000
061223,T50反1中信01購01,0,0,0,0,0,0,0,0,0,-20000,0,0,0,0,20000,-20000,-20000
060806,華新科群益9A購03,0,0,0,0,0,0,0,0,0,-20000,0,0,0,3000,23000,-20000,-20000
060651,瑞儀中信9B購01  ,0,0,0,0,0,0,0,0,0,-20000,0,0,0,80000,100000,-20000,-20000
063061,華新科元富9B購04,0,0,0,0,0,0,0,0,0,-20000,0,0,0,0,20000,-20000,-20000
062703,可成元大9C購02  ,0,0,0,0,0,0,0,0,0,-20000,0,0,0,0,20000,-20000,-20000
062056,國巨統一9C購08  ,0,0,0,0,0,0,0,0,0,-20000,0,0,0,0,20000,-20000,-20000
062202,國巨國票9C購04  ,0,0,0,0,0,0,0,0,0,-20000,0,0,0,0,20000,-20000,-20000
062140,元金2X國票9B購03,0,0,0,0,0,0,0,0,0,-20000,0,0,0,0,20000,-20000,-20000
062179,旺宏元大9B購05  ,0,0,0,0,0,0,0,0,0,-20000,0,0,0,0,20000,-20000,-20000
062418,台積電統一01購06,0,0,0,0,0,0,0,0,0,-20000,0,0,0,80000,100000,-20000,-20000
062538,台積電國泰9C購02,0,0,0,0,0,0,0,0,0,-20000,0,0,0,16000,36000,-20000,-20000
9955,佳龍            ,14000,35000,-21000,0,0,0,0,0,0,1000,1000,0,1000,0,0,0,-20000
5203,訊連            ,29000,39000,-10000,0,0,0,0,30000,-30000,20000,19000,0,19000,1000,0,1000,-20000
2887F,台新戊特二      ,0,910,-910,0,0,0,0,0,0,-20000,0,20000,-20000,0,0,0,-20910
07988P,台積電台新9C售03,0,0,0,0,0,0,0,0,0,-21000,0,0,0,0,21000,-21000,-21000
063313,南亞科群益9B購02,0,0,0,0,0,0,0,0,0,-21000,0,0,0,52000,73000,-21000,-21000
06678P,大立光統一99售01,0,0,0,0,0,0,0,0,0,-21000,0,0,0,0,21000,-21000,-21000
06755P,大立光永豐98售03,0,0,0,0,0,0,0,0,0,-21000,0,0,0,14000,35000,-21000,-21000
06771P,台灣50中信02售01,0,0,0,0,0,0,0,0,0,-21000,0,0,0,0,21000,-21000,-21000
055844,大毅元大98購01  ,0,0,0,0,0,0,0,0,0,-21000,0,0,0,0,21000,-21000,-21000
059011,臺股指元大9A購30,0,0,0,0,0,0,0,0,0,-21000,0,0,0,0,21000,-21000,-21000
059049,元油2X凱基9A購12,0,0,0,0,0,0,0,0,0,-21000,0,0,0,0,21000,-21000,-21000
059149,臺股指國票99購12,0,0,0,0,0,0,0,0,0,-21000,0,0,0,0,21000,-21000,-21000
055207,致新中信99購01  ,0,0,0,0,0,0,0,0,0,-21000,0,0,0,44000,65000,-21000,-21000
050271,上緯控元大96購01,0,0,0,0,0,0,0,0,0,-21000,0,0,0,0,21000,-21000,-21000
052994,群創台新99購01  ,0,0,0,0,0,0,0,0,0,-21000,0,0,0,0,21000,-21000,-21000
056387,智伸科國泰99購01,0,0,0,0,0,0,0,0,0,-21000,0,0,0,10000,31000,-21000,-21000
058957,貿聯國票9A購01  ,0,0,0,0,0,0,0,0,0,-21000,0,0,0,59000,80000,-21000,-21000
059248,華新科凱基99購04,0,0,0,0,0,0,0,0,0,-21000,0,0,0,13000,34000,-21000,-21000
057028,台郡凱基99購02  ,0,0,0,0,0,0,0,0,0,-21000,0,0,0,10000,31000,-21000,-21000
057807,友訊元大98購02  ,0,0,0,0,0,0,0,0,0,-21000,0,0,0,0,21000,-21000,-21000
060948,可成第一9A購01  ,0,0,0,0,0,0,0,0,0,-21000,0,0,0,79000,100000,-21000,-21000
060186,義隆元富9A購01  ,0,0,0,0,0,0,0,0,0,-21000,0,0,0,19000,40000,-21000,-21000
060345,聯發科統一9B購05,0,0,0,0,0,0,0,0,0,-21000,0,0,0,0,21000,-21000,-21000
062548,智易永豐9B購01  ,0,0,0,0,0,0,0,0,0,-21000,0,0,0,0,21000,-21000,-21000
061964,台積電統一01購05,0,0,0,0,0,0,0,0,0,-21000,0,0,0,0,21000,-21000,-21000
061995,超眾元大01購01  ,0,0,0,0,0,0,0,0,0,-21000,0,0,0,0,21000,-21000,-21000
062952,台積電永豐9B購02,0,0,0,0,0,0,0,0,0,-21000,0,0,0,0,21000,-21000,-21000
063218,台塑群益9B購01  ,0,0,0,0,0,0,0,0,0,-21000,0,0,0,0,21000,-21000,-21000
061847,力山國票9B購01  ,0,0,0,0,0,0,0,0,0,-21000,0,0,0,16000,37000,-21000,-21000
061296,台積電國泰9C購01,0,0,0,0,0,0,0,0,0,-21000,0,0,0,97000,118000,-21000,-21000
6414,樺漢            ,161000,183000,-22000,0,0,0,20000,0,20000,-19000,6000,4000,2000,12000,33000,-21000,-21000
063783,儒鴻中信9C購01  ,0,0,0,0,0,0,0,0,0,-22000,0,0,0,0,22000,-22000,-22000
063768,華新科國泰9C購03,0,0,0,0,0,0,0,0,0,-22000,0,0,0,10000,32000,-22000,-22000
07995P,臺股指麥證9C售01,0,0,0,15000,37000,-22000,0,0,0,-22000,0,0,0,15000,37000,-22000,-22000
07413P,國巨元大99售33  ,0,0,0,0,0,0,0,0,0,-22000,0,0,0,9000,31000,-22000,-22000
05634P,玉晶光台新97售01,0,0,0,0,0,0,0,0,0,-22000,0,0,0,0,22000,-22000,-22000
03604P,群創凱基98售05  ,0,0,0,0,0,0,0,0,0,-22000,0,0,0,0,22000,-22000,-22000
054381,世芯群益98購01  ,0,0,0,0,0,0,0,0,0,-22000,0,0,0,44000,66000,-22000,-22000
059162,國巨凱基99購12  ,0,0,0,0,0,0,0,0,0,-22000,0,0,0,0,22000,-22000,-22000
059146,貿聯國票9A購02  ,0,0,0,0,0,0,0,0,0,-22000,0,0,0,0,22000,-22000,-22000
059313,元石油元大99購06,0,0,0,0,0,0,0,0,0,-22000,0,0,0,30000,52000,-22000,-22000
056168,鴻海元富97購07  ,0,0,0,0,0,0,0,0,0,-22000,0,0,0,0,22000,-22000,-22000
060399,康友國票9A購02  ,0,0,0,0,0,0,0,0,0,-22000,0,0,0,17000,39000,-22000,-22000
060100,新光金元大9C購01,0,0,0,0,0,0,0,0,0,-22000,0,0,0,300000,322000,-22000,-22000
060101,大立光元大99購31,0,0,0,0,0,0,0,0,0,-22000,0,0,0,0,22000,-22000,-22000
058344,旺宏群益99購05  ,0,0,0,0,0,0,0,0,0,-22000,0,0,0,0,22000,-22000,-22000
058240,景碩元大99購04  ,0,0,0,0,0,0,0,0,0,-22000,0,0,0,28000,50000,-22000,-22000
059434,全新元大99購05  ,0,0,0,0,0,0,0,0,0,-22000,0,0,0,54000,76000,-22000,-22000
059730,晶相光元大9C購02,0,0,0,0,0,0,0,0,0,-22000,0,0,0,100000,122000,-22000,-22000
061352,茂林元大9A購04  ,0,0,0,0,0,0,0,0,0,-22000,0,0,0,0,22000,-22000,-22000
061452,大成鋼凱基9A購01,0,0,0,0,0,0,0,0,0,-22000,0,0,0,160000,182000,-22000,-22000
061482,健策元大9C購01  ,0,0,0,0,0,0,0,0,0,-22000,0,0,0,48000,70000,-22000,-22000
061858,南電國票9B購02  ,0,0,0,0,0,0,0,0,0,-22000,0,0,0,1000,23000,-22000,-22000
061747,南亞科統一01購01,0,0,0,0,0,0,0,0,0,-22000,0,0,0,21000,43000,-22000,-22000
061635,台積電元大9A購34,0,0,0,0,0,0,0,0,0,-22000,0,0,0,5000,27000,-22000,-22000
061015,旺宏麥證9A購03  ,0,0,0,0,22000,-22000,0,0,0,-22000,0,0,0,0,22000,-22000,-22000
062026,華邦電群益9B購01,0,0,0,0,0,0,0,0,0,-22000,0,0,0,98000,120000,-22000,-22000
5007,三星            ,76000,102000,-26000,0,0,0,0,0,0,4000,4000,0,4000,0,0,0,-22000
3014,聯陽            ,514000,853000,-339000,0,0,0,0,0,0,317000,134000,6000,128000,189000,0,189000,-22000
3040,遠見            ,127000,150000,-23000,0,0,0,0,0,0,1000,1000,0,1000,0,0,0,-22000
07369P,台積電凱基99售20,0,0,0,0,0,0,0,0,0,-23000,0,0,0,7000,30000,-23000,-23000
08110P,臺股指中信01售05,0,0,0,0,0,0,0,0,0,-23000,0,0,0,0,23000,-23000,-23000
08214P,南六統一9B售03  ,0,0,0,0,0,0,0,0,0,-23000,0,0,0,383000,406000,-23000,-23000
063778,亞德客永豐9B購02,0,0,0,0,0,0,0,0,0,-23000,0,0,0,0,23000,-23000,-23000
063621,華新科兆豐9B購02,0,0,0,0,0,0,0,0,0,-23000,0,0,0,0,23000,-23000,-23000
063373,晶技永豐9B購02  ,0,0,0,0,0,0,0,0,0,-23000,0,0,0,0,23000,-23000,-23000
07063P,臺股指元大9A售24,0,0,0,0,0,0,0,0,0,-23000,0,0,0,0,23000,-23000,-23000
059163,台積電凱基99購10,0,0,0,0,0,0,0,0,0,-23000,0,0,0,25000,48000,-23000,-23000
05088P,大立光富邦99售01,0,0,0,0,0,0,0,0,0,-23000,0,0,0,4000,27000,-23000,-23000
053194,緯穎統一99購01  ,0,0,0,0,0,0,0,0,0,-23000,0,0,0,0,23000,-23000,-23000
059640,聯詠凱基99購04  ,0,0,0,0,0,0,0,0,0,-23000,0,0,0,2000,25000,-23000,-23000
059436,大立光元大99購18,0,0,0,0,0,0,0,0,0,-23000,0,0,0,7000,30000,-23000,-23000
060339,國巨統一01購01  ,0,0,0,0,0,0,0,0,0,-23000,0,0,0,27000,50000,-23000,-23000
057810,技嘉元大98購06  ,0,0,0,0,0,0,0,0,0,-23000,0,0,0,29000,52000,-23000,-23000
058927,勤誠元富99購02  ,0,0,0,0,0,0,0,0,0,-23000,0,0,0,0,23000,-23000,-23000
062712,晶技麥證9B購02  ,0,0,0,30000,53000,-23000,0,0,0,-23000,0,0,0,30000,53000,-23000,-23000
062645,國巨國泰9B購08  ,0,0,0,0,0,0,0,0,0,-23000,0,0,0,7000,30000,-23000,-23000
060634,矽創富邦9B購01  ,0,0,0,0,0,0,0,0,0,-23000,0,0,0,0,23000,-23000,-23000
4976,佳凌            ,175000,219000,-44000,0,0,0,0,0,0,21000,22000,1000,21000,0,0,0,-23000
07021P,台積電富邦9C售02,0,0,0,0,0,0,0,0,0,-24000,0,0,0,5000,29000,-24000,-24000
06730P,祥碩元大98售07  ,0,0,0,0,0,0,0,0,0,-24000,0,0,0,85000,109000,-24000,-24000
063418,京元電凱基9B購03,0,0,0,0,0,0,0,0,0,-24000,0,0,0,20000,44000,-24000,-24000
063648,台表科元大9C購05,0,0,0,0,0,0,0,0,0,-24000,0,0,0,29000,53000,-24000,-24000
056381,台虹元富98購01  ,0,0,0,0,0,0,0,0,0,-24000,0,0,0,26000,50000,-24000,-24000
055834,國巨元大97購13  ,0,0,0,0,0,0,0,0,0,-24000,0,0,0,8000,32000,-24000,-24000
054805,台苯元大9A購01  ,0,0,0,0,0,0,0,0,0,-24000,0,0,0,76000,100000,-24000,-24000
054886,大毅統一97購01  ,0,0,0,0,0,0,0,0,0,-24000,0,0,0,0,24000,-24000,-24000
054852,奇鋐國票98購01  ,0,0,0,0,0,0,0,0,0,-24000,0,0,0,0,24000,-24000,-24000
055085,大毅國票97購01  ,0,0,0,0,0,0,0,0,0,-24000,0,0,0,50000,74000,-24000,-24000
058613,茂林元大99購03  ,0,0,0,0,0,0,0,0,0,-24000,0,0,0,41000,65000,-24000,-24000
059456,智易永豐99購01  ,0,0,0,0,0,0,0,0,0,-24000,0,0,0,0,24000,-24000,-24000
059286,S&P正2元富01購03,0,0,0,0,0,0,0,0,0,-24000,0,0,0,1000,25000,-24000,-24000
057096,緯穎元富98購01  ,0,0,0,0,0,0,0,0,0,-24000,0,0,0,26000,50000,-24000,-24000
061020,超眾國票9A購02  ,0,0,0,0,0,0,0,0,0,-24000,0,0,0,51000,75000,-24000,-24000
061037,嘉澤永豐9A購01  ,0,0,0,0,0,0,0,0,0,-24000,0,0,0,10000,34000,-24000,-24000
061642,創意元大9A購04  ,0,0,0,0,0,0,0,0,0,-24000,0,0,0,772000,796000,-24000,-24000
06182P,群創兆豐97售03  ,0,0,0,0,0,0,0,0,0,-24000,0,0,0,0,24000,-24000,-24000
063022,嘉晶元大9B購04  ,0,0,0,0,0,0,0,0,0,-24000,0,0,0,236000,260000,-24000,-24000
063038,富邦金凱基9B購02,0,0,0,0,0,0,0,0,0,-24000,0,0,0,11000,35000,-24000,-24000
062046,矽格凱基9B購01  ,0,0,0,0,0,0,0,0,0,-24000,0,0,0,146000,170000,-24000,-24000
062185,禾伸堂元大9B購01,0,0,0,0,0,0,0,0,0,-24000,0,0,0,44000,68000,-24000,-24000
6591,動力-KY         ,35000,59000,-24000,0,0,0,0,0,0,0,0,0,0,0,0,0,-24000
063721,道瓊銀元大9B購03,0,0,0,0,0,0,0,0,0,-25000,0,0,0,0,25000,-25000,-25000
063460,智邦元大9B購08  ,0,0,0,0,0,0,0,0,0,-25000,0,0,0,46000,71000,-25000,-25000
063887,香港2X中信02購01,0,0,0,0,0,0,0,0,0,-25000,0,0,0,0,25000,-25000,-25000
07113P,台積電兆豐99售03,0,0,0,0,0,0,0,0,0,-25000,0,0,0,0,25000,-25000,-25000
08278P,玉晶光元富9C售02,0,0,0,0,0,0,0,0,0,-25000,0,0,0,0,25000,-25000,-25000
08284P,鴻海凱基01售03  ,0,0,0,0,0,0,0,0,0,-25000,0,0,0,0,25000,-25000,-25000
07428P,華新科國票9A售01,0,0,0,0,0,0,0,0,0,-25000,0,0,0,15000,40000,-25000,-25000
07504P,聯詠元大9A售02  ,0,0,0,0,0,0,0,0,0,-25000,0,0,0,0,25000,-25000,-25000
07647P,健策國票9A售04  ,0,0,0,0,0,0,0,0,0,-25000,0,0,0,115000,140000,-25000,-25000
07694P,超眾元大9A售05  ,0,0,0,0,0,0,0,0,0,-25000,0,0,0,30000,55000,-25000,-25000
055627,亞德客永豐97購02,0,0,0,0,0,0,0,0,0,-25000,0,0,0,43000,68000,-25000,-25000
055802,新日興永豐97購01,0,0,0,0,0,0,0,0,0,-25000,0,0,0,0,25000,-25000,-25000
055943,瑞昱麥證97購01  ,0,0,0,17000,42000,-25000,0,0,0,-25000,0,0,0,17000,42000,-25000,-25000
056057,華邦電元大97購05,0,0,0,0,0,0,0,0,0,-25000,0,0,0,0,25000,-25000,-25000
059174,訊芯凱基99購01  ,0,0,0,0,0,0,0,0,0,-25000,0,0,0,84000,109000,-25000,-25000
059324,智易元大99購04  ,0,0,0,0,0,0,0,0,0,-25000,0,0,0,0,25000,-25000,-25000
00688L,國泰20年美債正2 ,0,20000,-20000,0,0,0,0,0,0,-5000,0,0,0,101000,106000,-5000,-25000
052203,T50反1中信99購03,0,0,0,0,0,0,0,0,0,-25000,0,0,0,210000,235000,-25000,-25000
056742,玉晶光凱基9A購01,0,0,0,0,0,0,0,0,0,-25000,0,0,0,11000,36000,-25000,-25000
057927,勤誠凱基98購01  ,0,0,0,0,0,0,0,0,0,-25000,0,0,0,0,25000,-25000,-25000
058944,元石油群益9C購02,0,0,0,0,0,0,0,0,0,-25000,0,0,0,0,25000,-25000,-25000
057976,旺宏永豐98購03  ,0,0,0,0,0,0,0,0,0,-25000,0,0,0,0,25000,-25000,-25000
058505,台積電元大99購08,0,0,0,0,0,0,0,0,0,-25000,0,0,0,25000,50000,-25000,-25000
057725,台達電國泰9A購01,0,0,0,0,0,0,0,0,0,-25000,0,0,0,15000,40000,-25000,-25000
058196,台塑中信99購01  ,0,0,0,0,0,0,0,0,0,-25000,0,0,0,15000,40000,-25000,-25000
060325,旺宏群益9A購02  ,0,0,0,0,0,0,0,0,0,-25000,0,0,0,0,25000,-25000,-25000
060352,滬深2X元富9A購02,0,0,0,0,0,0,0,0,0,-25000,0,0,0,0,25000,-25000,-25000
060203,緯穎元富9A購01  ,0,0,0,0,0,0,0,0,0,-25000,0,0,0,0,25000,-25000,-25000
058335,鴻海元富99購06  ,0,0,0,0,0,0,0,0,0,-25000,0,0,0,0,25000,-25000,-25000
062036,致新群益9B購01  ,0,0,0,0,0,0,0,0,0,-25000,0,0,0,133000,158000,-25000,-25000
062080,奇力新元大9B購02,0,0,0,0,0,0,0,0,0,-25000,0,0,0,50000,75000,-25000,-25000
062011,上銀富邦9C購01  ,0,0,0,0,0,0,0,0,0,-25000,0,0,0,50000,75000,-25000,-25000
062937,旺宏凱基9B購08  ,0,0,0,0,0,0,0,0,0,-25000,0,0,0,16000,41000,-25000,-25000
063195,訊連元富9B購01  ,0,0,0,0,0,0,0,0,0,-25000,0,0,0,85000,110000,-25000,-25000
063150,聯發科元富05購03,10000,0,10000,0,0,0,0,0,0,-35000,0,0,0,9000,44000,-35000,-25000
062778,國巨元大9B購17  ,0,0,0,0,0,0,0,0,0,-25000,0,0,0,0,25000,-25000,-25000
061942,亞德客群益9B購01,0,0,0,0,0,0,0,0,0,-25000,0,0,0,9000,34000,-25000,-25000
061609,華新科統一9C購01,0,0,0,0,0,0,0,0,0,-25000,0,0,0,55000,80000,-25000,-25000
061704,景碩國票9A購01  ,0,0,0,0,0,0,0,0,0,-25000,0,0,0,0,25000,-25000,-25000
061684,T50反1群益9A購06,0,0,0,0,0,0,0,0,0,-25000,0,0,0,0,25000,-25000,-25000
06143P,鴻海永豐97售02  ,0,0,0,0,0,0,0,0,0,-25000,0,0,0,35000,60000,-25000,-25000
060885,世紀鋼中信9A購01,0,0,0,0,0,0,0,0,0,-25000,0,0,0,0,25000,-25000,-25000
061240,華新科兆豐9A購01,0,0,0,0,0,0,0,0,0,-25000,0,0,0,26000,51000,-25000,-25000
060801,滬深2X中信01購01,0,0,0,0,0,0,0,0,0,-25000,0,0,0,0,25000,-25000,-25000
060696,道瓊反國泰9C購01,0,0,0,0,0,0,0,0,0,-25000,0,0,0,5000,30000,-25000,-25000
07805P,義隆永豐9A售02  ,0,0,0,0,0,0,0,0,0,-26000,0,0,0,26000,52000,-26000,-26000
063710,光寶科凱基9C購01,0,0,0,0,0,0,0,0,0,-26000,0,0,0,14000,40000,-26000,-26000
055337,超眾兆豐98購01  ,0,0,0,0,0,0,0,0,0,-26000,0,0,0,100000,126000,-26000,-26000
052388,旺宏群益96購05  ,0,0,0,0,0,0,0,0,0,-26000,0,0,0,0,26000,-26000,-26000
059291,華新科元富9B購01,0,0,0,0,0,0,0,0,0,-26000,0,0,0,0,26000,-26000,-26000
056529,中環凱基98購01  ,0,0,0,0,0,0,0,0,0,-26000,0,0,0,16000,42000,-26000,-26000
054749,聯茂凱基98購01  ,0,0,0,0,0,0,0,0,0,-26000,0,0,0,0,26000,-26000,-26000
05749P,臺股指群益99售03,0,0,0,0,0,0,0,0,0,-26000,0,0,0,0,26000,-26000,-26000
058148,百和元大99購01  ,0,0,0,0,0,0,0,0,0,-26000,0,0,0,74000,100000,-26000,-26000
058532,禾伸堂元富99購01,0,0,0,0,0,0,0,0,0,-26000,0,0,0,1000,27000,-26000,-26000
057201,華擎元富98購01  ,0,0,0,0,0,0,0,0,0,-26000,0,0,0,4000,30000,-26000,-26000
057162,上銀元大98購03  ,0,0,0,0,0,0,0,0,0,-26000,0,0,0,0,26000,-26000,-26000
061409,力成國票9A購02  ,0,0,0,0,0,0,0,0,0,-26000,0,0,0,0,26000,-26000,-26000
061744,超眾凱基9B購02  ,0,0,0,0,0,0,0,0,0,-26000,0,0,0,20000,46000,-26000,-26000
061648,緯穎元大9A購04  ,0,0,0,0,0,0,0,0,0,-26000,0,0,0,2000,28000,-26000,-26000
061857,康友國票9B購01  ,0,0,0,0,0,0,0,0,0,-26000,0,0,0,16000,42000,-26000,-26000
061809,聯發科統一9C購05,0,0,0,0,0,0,0,0,0,-26000,0,0,0,0,26000,-26000,-26000
063187,全新凱基9B購02  ,0,0,0,0,0,0,0,0,0,-26000,0,0,0,17000,43000,-26000,-26000
062949,聯發科富邦01購01,0,0,0,0,0,0,0,0,0,-26000,0,0,0,16000,42000,-26000,-26000
062986,T50反1中信02購01,0,0,0,0,0,0,0,0,0,-26000,0,0,0,0,26000,-26000,-26000
061991,牧德元大9C購01  ,0,0,0,0,0,0,0,0,0,-26000,0,0,0,85000,111000,-26000,-26000
062360,華邦電元大9B購01,0,0,0,0,0,0,0,0,0,-26000,0,0,0,155000,181000,-26000,-26000
062348,聯發科群益9B購06,0,0,0,0,0,0,0,0,0,-26000,0,0,0,13000,39000,-26000,-26000
07706P,長榮航元大9A售03,0,0,0,0,0,0,0,0,0,-27000,0,0,0,23000,50000,-27000,-27000
07524P,臺股指中信9B售06,0,0,0,0,0,0,0,0,0,-27000,0,0,0,0,27000,-27000,-27000
056548,瀚宇博凱基98購02,0,0,0,0,0,0,0,0,0,-27000,0,0,0,17000,44000,-27000,-27000
059019,元石油統一9B購03,0,0,0,0,0,0,0,0,0,-27000,0,0,0,0,27000,-27000,-27000
056130,新日興麥證97購01,0,0,0,103000,130000,-27000,0,0,0,-27000,0,0,0,103000,130000,-27000,-27000
053427,鎧勝永豐96購02  ,0,0,0,0,0,0,0,0,0,-27000,0,0,0,0,27000,-27000,-27000
057273,智邦元大98購05  ,0,0,0,0,0,0,0,0,0,-27000,0,0,0,0,27000,-27000,-27000
058110,光寶科元富98購01,0,0,0,0,0,0,0,0,0,-27000,0,0,0,90000,117000,-27000,-27000
057731,華擎國泰9A購02  ,0,0,0,0,0,0,0,0,0,-27000,0,0,0,0,27000,-27000,-27000
057424,訊芯凱基98購04  ,0,0,0,0,0,0,0,0,0,-27000,0,0,0,21000,48000,-27000,-27000
062364,瑞昱元大9B購04  ,0,0,0,0,0,0,0,0,0,-27000,0,0,0,23000,50000,-27000,-27000
062722,京元電凱基9B購02,0,0,0,0,0,0,0,0,0,-27000,0,0,0,116000,143000,-27000,-27000
061414,牧德群益9B購02  ,0,0,0,0,0,0,0,0,0,-27000,0,0,0,98000,125000,-27000,-27000
061423,廣達元大9A購01  ,0,0,0,0,0,0,0,0,0,-27000,0,0,0,125000,152000,-27000,-27000
061592,義隆永豐9A購03  ,0,0,0,0,0,0,0,0,0,-27000,0,0,0,251000,278000,-27000,-27000
060554,中租凱基9A購01  ,0,0,0,0,0,0,0,0,0,-27000,0,0,0,0,27000,-27000,-27000
060560,欣興國泰9C購01  ,0,0,0,0,0,0,0,0,0,-27000,0,0,0,0,27000,-27000,-27000
060996,臻鼎元大9A購01  ,0,0,0,0,0,0,0,0,0,-27000,0,0,0,14000,41000,-27000,-27000
061066,嘉晶凱基9B購01  ,0,0,0,0,0,0,0,0,0,-27000,0,0,0,56000,83000,-27000,-27000
4725,信昌化          ,0,27000,-27000,0,0,0,0,0,0,0,0,0,0,0,0,0,-27000
063607,中租凱基9B購02  ,0,0,0,0,0,0,0,0,0,-28000,0,0,0,0,28000,-28000,-28000
063342,台光電統一9B購02,0,0,0,0,0,0,0,0,0,-28000,0,0,0,75000,103000,-28000,-28000
07181P,臺股指凱基99售23,0,0,0,0,0,0,0,0,0,-28000,0,0,0,0,28000,-28000,-28000
06888P,日月光元大98售02,0,0,0,0,0,0,0,0,0,-28000,0,0,0,0,28000,-28000,-28000
063858,鴻海國泰02購01  ,0,0,0,0,0,0,0,0,0,-28000,0,0,0,0,28000,-28000,-28000
06588P,台積電元大98售11,0,0,0,0,0,0,0,0,0,-28000,0,0,0,2000,30000,-28000,-28000
00682U,元大美元指數    ,0,0,0,0,0,0,0,0,0,-28000,0,0,0,0,28000,-28000,-28000
00706L,元大S&P日圓正2  ,0,2000,-2000,0,0,0,0,0,0,-26000,0,0,0,8000,34000,-26000,-28000
056141,聯茂元大97購05  ,0,0,0,0,0,0,0,0,0,-28000,0,0,0,21000,49000,-28000,-28000
056035,鴻海凱基97購06  ,0,0,0,0,0,0,0,0,0,-28000,0,0,0,2000,30000,-28000,-28000
056649,智易凱基98購01  ,0,0,0,0,0,0,0,0,0,-28000,0,0,0,30000,58000,-28000,-28000
056484,聯茂元大98購02  ,0,0,0,0,0,0,0,0,0,-28000,0,0,0,10000,38000,-28000,-28000
054554,大立光凱基98購02,0,0,0,0,0,0,0,0,0,-28000,0,0,0,39000,67000,-28000,-28000
058226,世芯元富99購01  ,0,0,0,0,0,0,0,0,0,-28000,0,0,0,0,28000,-28000,-28000
058758,台積電群益99購05,0,0,0,0,0,0,0,0,0,-28000,0,0,0,62000,90000,-28000,-28000
057352,大立光統一9A購02,0,0,0,0,0,0,0,0,0,-28000,0,0,0,6000,34000,-28000,-28000
057062,立積國泰99購01  ,0,0,0,0,0,0,0,0,0,-28000,0,0,0,2000,30000,-28000,-28000
058767,亞德客兆豐99購01,0,0,0,0,0,0,0,0,0,-28000,0,0,0,11000,39000,-28000,-28000
058950,國巨群益99購06  ,0,0,0,0,0,0,0,0,0,-28000,0,0,0,50000,78000,-28000,-28000
058986,華新科凱基9A購03,0,0,0,0,0,0,0,0,0,-28000,0,0,0,32000,60000,-28000,-28000
060871,台灣50中信01購03,0,0,0,0,0,0,0,0,0,-28000,0,0,0,22000,50000,-28000,-28000
06188P,大立光元富97售01,0,0,0,0,0,0,0,0,0,-28000,0,0,0,5000,33000,-28000,-28000
061649,緯穎元大9A購06  ,0,0,0,0,0,0,0,0,0,-28000,0,0,0,60000,88000,-28000,-28000
062362,致茂元大9B購01  ,0,0,0,0,0,0,0,0,0,-28000,0,0,0,50000,78000,-28000,-28000
062206,緯創國票9B購01  ,0,0,0,0,0,0,0,0,0,-28000,0,0,0,0,28000,-28000,-28000
062222,華新科統一9B購04,0,0,0,0,0,0,0,0,0,-28000,0,0,0,10000,38000,-28000,-28000
6206,飛捷            ,26000,79000,-53000,0,0,0,0,0,0,25000,25000,0,25000,0,0,0,-28000
8081,致新            ,147000,217000,-70000,0,0,0,90000,69000,21000,21000,36000,9000,27000,1000,7000,-6000,-28000
063922,大立光元富9C購04,0,0,0,0,0,0,0,0,0,-29000,0,0,0,0,29000,-29000,-29000
07206P,鴻海凱基9A售11  ,0,0,0,0,0,0,0,0,0,-29000,0,0,0,0,29000,-29000,-29000
063380,台表科永豐9B購03,0,0,0,0,0,0,0,0,0,-29000,0,0,0,87000,116000,-29000,-29000
1702,南僑            ,122000,155000,-33000,0,0,0,0,0,0,4000,4000,0,4000,0,0,0,-29000
2425,承啟            ,24000,54000,-30000,0,0,0,0,0,0,1000,1000,0,1000,0,0,0,-29000
054828,正崴國泰99購01  ,0,0,0,0,0,0,0,0,0,-29000,0,0,0,289000,318000,-29000,-29000
055974,上銀統一97購05  ,0,0,0,0,0,0,0,0,0,-29000,0,0,0,0,29000,-29000,-29000
056153,華新科凱基97購02,0,0,0,0,0,0,0,0,0,-29000,0,0,0,8000,37000,-29000,-29000
059109,台積電富邦9C購03,0,0,0,0,0,0,0,0,0,-29000,0,0,0,0,29000,-29000,-29000
058766,力山兆豐99購01  ,0,0,0,0,0,0,0,0,0,-29000,0,0,0,198000,227000,-29000,-29000
057912,美律日盛99購01  ,0,0,0,0,0,0,0,0,0,-29000,0,0,0,200000,229000,-29000,-29000
057048,新日興元大98購01,0,0,0,0,0,0,0,0,0,-29000,0,0,0,156000,185000,-29000,-29000
057119,微星康和98購01  ,0,0,0,0,0,0,0,0,0,-29000,0,0,0,50000,79000,-29000,-29000
060262,臺股指凱基9B購02,0,0,0,0,0,0,0,0,0,-29000,0,0,0,20000,49000,-29000,-29000
062097,台光電永豐9B購01,0,0,0,0,0,0,0,0,0,-29000,0,0,0,15000,44000,-29000,-29000
062285,台勝科群益9B購01,0,0,0,0,0,0,0,0,0,-29000,0,0,0,37000,66000,-29000,-29000
062835,瑞儀群益9B購01  ,0,0,0,0,0,0,0,0,0,-29000,0,0,0,128000,157000,-29000,-29000
062829,泰碩群益9B購01  ,0,0,0,0,0,0,0,0,0,-29000,0,0,0,171000,200000,-29000,-29000
061911,台積電中信05購04,0,0,0,0,0,0,0,0,0,-29000,0,0,0,270000,299000,-29000,-29000
061837,華新科凱基05購02,0,0,0,0,0,0,0,0,0,-29000,0,0,0,0,29000,-29000,-29000
061567,華通元大9A購11  ,0,0,0,0,0,0,0,0,0,-29000,0,0,0,70000,99000,-29000,-29000
061489,高鐵兆豐9A購01  ,0,0,0,0,0,0,0,0,0,-29000,0,0,0,5000,34000,-29000,-29000
061402,矽創兆豐9B購01  ,0,0,0,0,0,0,0,0,0,-29000,0,0,0,1000,30000,-29000,-29000
061365,國巨國票9B購05  ,0,0,0,0,0,0,0,0,0,-29000,0,0,0,21000,50000,-29000,-29000
08251P,臺股指群益9C售09,0,0,0,0,0,0,0,0,0,-30000,0,0,0,0,30000,-30000,-30000
07371P,滬深2X元大99售07,0,0,0,0,0,0,0,0,0,-30000,0,0,0,0,30000,-30000,-30000
07717P,臺股指群益9A售06,0,0,0,0,0,0,0,0,0,-30000,0,0,0,0,30000,-30000,-30000
07887P,台積電國票9C售03,0,0,0,0,0,0,0,0,0,-30000,0,0,0,0,30000,-30000,-30000
063325,SP黃豆國票9C購02,0,0,0,0,0,0,0,0,0,-30000,0,0,0,0,30000,-30000,-30000
063525,廣達凱基9B購02  ,0,0,0,0,0,0,0,0,0,-30000,0,0,0,0,30000,-30000,-30000
063448,聯發科統一9C購11,0,0,0,0,0,0,0,0,0,-30000,0,0,0,0,30000,-30000,-30000
063596,嘉澤中信9B購01  ,0,0,0,0,0,0,0,0,0,-30000,0,0,0,0,30000,-30000,-30000
063556,儒鴻元大9B購02  ,0,0,0,0,0,0,0,0,0,-30000,0,0,0,82000,112000,-30000,-30000
063687,金像電永豐9B購04,0,0,0,0,0,0,0,0,0,-30000,0,0,0,0,30000,-30000,-30000
063712,高鐵凱基9C購01  ,0,0,0,0,0,0,0,0,0,-30000,0,0,0,0,30000,-30000,-30000
07249P,T50正2富邦03售02,0,0,0,0,0,0,0,0,0,-30000,0,0,0,0,30000,-30000,-30000
06930P,台積電元大98售19,0,0,0,0,0,0,0,0,0,-30000,0,0,0,0,30000,-30000,-30000
063902,志超群益9C購01  ,0,0,0,0,0,0,0,0,0,-30000,0,0,0,0,30000,-30000,-30000
06419P,國巨統一97售09  ,0,0,0,0,0,0,0,0,0,-30000,0,0,0,0,30000,-30000,-30000
06449P,台積電元大98售09,0,0,0,0,0,0,0,0,0,-30000,0,0,0,0,30000,-30000,-30000
06510P,燿華永豐98售03  ,0,0,0,0,0,0,0,0,0,-30000,0,0,0,10000,40000,-30000,-30000
06587P,國巨元大98售13  ,0,0,0,0,0,0,0,0,0,-30000,0,0,0,0,30000,-30000,-30000
06572P,台積電永昌99售01,0,0,0,0,0,0,0,0,0,-30000,0,0,0,0,30000,-30000,-30000
06714P,台積電元大98售15,0,0,0,0,0,0,0,0,0,-30000,0,0,0,0,30000,-30000,-30000
06754P,台積電永豐98售03,0,0,0,0,0,0,0,0,0,-30000,0,0,0,0,30000,-30000,-30000
06647P,台積電元大98售13,0,0,0,0,0,0,0,0,0,-30000,0,0,0,0,30000,-30000,-30000
059098,元油2X統一9B購03,0,0,0,0,0,0,0,0,0,-30000,0,0,0,0,30000,-30000,-30000
059530,華新科凱基9A購05,0,0,0,0,0,0,0,0,0,-30000,0,0,0,0,30000,-30000,-30000
059566,台積電凱基9A購11,0,0,0,0,0,0,0,0,0,-30000,0,0,0,0,30000,-30000,-30000
059292,華新科元富9B購02,0,0,0,0,0,0,0,0,0,-30000,0,0,0,9000,39000,-30000,-30000
055849,聯詠元大97購05  ,0,0,0,0,0,0,0,0,0,-30000,0,0,0,68000,98000,-30000,-30000
055650,華新科元富98購01,0,0,0,0,0,0,0,0,0,-30000,0,0,0,69000,99000,-30000,-30000
055653,聯詠元富01購02  ,0,0,0,0,0,0,0,0,0,-30000,0,0,0,26000,56000,-30000,-30000
054316,矽創凱基97購01  ,0,0,0,0,0,0,0,0,0,-30000,0,0,0,0,30000,-30000,-30000
055320,建準國票98購01  ,0,0,0,0,0,0,0,0,0,-30000,0,0,0,0,30000,-30000,-30000
054929,群電凱基97購01  ,0,0,0,0,0,0,0,0,0,-30000,0,0,0,0,30000,-30000,-30000
054930,群電凱基98購01  ,0,0,0,0,0,0,0,0,0,-30000,0,0,0,0,30000,-30000,-30000
055262,台虹國泰98購01  ,0,0,0,0,0,0,0,0,0,-30000,0,0,0,0,30000,-30000,-30000
050485,國巨統一96購01  ,0,0,0,0,0,0,0,0,0,-30000,0,0,0,60000,90000,-30000,-30000
050842,旺宏國票97購01  ,0,0,0,0,0,0,0,0,0,-30000,0,0,0,0,30000,-30000,-30000
051510,新光金中信97購01,0,0,0,0,0,0,0,0,0,-30000,0,0,0,0,30000,-30000,-30000
051791,智伸科國票96購01,0,0,0,0,0,0,0,0,0,-30000,0,0,0,0,30000,-30000,-30000
052724,力成統一97購01  ,0,0,0,0,0,0,0,0,0,-30000,0,0,0,0,30000,-30000,-30000
053337,聯電國票97購01  ,0,0,0,0,0,0,0,0,0,-30000,0,0,0,156000,186000,-30000,-30000
052838,新唐國泰98購01  ,0,0,0,0,0,0,0,0,0,-30000,0,0,0,0,30000,-30000,-30000
053638,信邦永豐96購01  ,0,0,0,0,0,0,0,0,0,-30000,0,0,0,0,30000,-30000,-30000
055501,創意元大97購01  ,0,0,0,0,0,0,0,0,0,-30000,0,0,0,0,30000,-30000,-30000
060228,亞德客元大9A購01,0,0,0,0,0,0,0,0,0,-30000,0,0,0,80000,110000,-30000,-30000
060383,葡萄王凱基9A購01,0,0,0,0,0,0,0,0,0,-30000,0,0,0,0,30000,-30000,-30000
060404,台勝科國泰9B購01,0,0,0,0,0,0,0,0,0,-30000,0,0,0,30000,60000,-30000,-30000
058297,茂林凱基9A購02  ,0,0,0,0,0,0,0,0,0,-30000,0,0,0,0,30000,-30000,-30000
058305,華邦電元大99購02,0,0,0,0,0,0,0,0,0,-30000,0,0,0,0,30000,-30000,-30000
060936,T50反1國票9A購09,0,0,0,0,0,0,0,0,0,-30000,0,0,0,0,30000,-30000,-30000
058722,台郡元富99購01  ,0,0,0,0,0,0,0,0,0,-30000,0,0,0,313000,343000,-30000,-30000
058572,百和凱基9A購01  ,0,0,0,0,0,0,0,0,0,-30000,0,0,0,6000,36000,-30000,-30000
057105,致茂群益9A購01  ,0,0,0,0,0,0,0,0,0,-30000,0,0,0,50000,80000,-30000,-30000
058124,玉晶光國票9A購01,0,0,0,0,0,0,0,0,0,-30000,0,0,0,107000,137000,-30000,-30000
05712P,友達統一97售03  ,0,0,0,0,0,0,0,0,0,-30000,0,0,0,0,30000,-30000,-30000
058987,華新科凱基9B購01,0,0,0,0,0,0,0,0,0,-30000,0,0,0,0,30000,-30000,-30000
058978,SGBR2X凱基9A購03,0,0,0,0,0,0,0,0,0,-30000,0,0,0,0,30000,-30000,-30000
057235,亞光凱基98購04  ,0,0,0,0,0,0,0,0,0,-30000,0,0,0,0,30000,-30000,-30000
058062,上銀中信98購01  ,0,0,0,0,0,0,0,0,0,-30000,0,0,0,0,30000,-30000,-30000
059702,台積電凱基9A購14,0,0,0,0,0,0,0,0,0,-30000,0,0,0,0,30000,-30000,-30000
061272,超眾凱基9A購03  ,0,0,0,0,0,0,0,0,0,-30000,0,0,0,20000,50000,-30000,-30000
061311,元黃金凱基9A購03,0,0,0,0,0,0,0,0,0,-30000,0,0,0,0,30000,-30000,-30000
061569,旺宏元大9A購14  ,0,0,0,0,0,0,0,0,0,-30000,0,0,0,20000,50000,-30000,-30000
061557,台積電國票9C購02,0,0,0,0,0,0,0,0,0,-30000,0,0,0,0,30000,-30000,-30000
060830,T50反1國票9A購07,0,0,0,0,0,0,0,0,0,-30000,0,0,0,0,30000,-30000,-30000
062820,禾伸堂兆豐9B購01,0,0,0,0,0,0,0,0,0,-30000,0,0,0,128000,158000,-30000,-30000
063007,儒鴻元大9B購01  ,0,0,0,0,0,0,0,0,0,-30000,0,0,0,77000,107000,-30000,-30000
06236P,台積電元大97售25,0,0,0,0,0,0,0,0,0,-30000,0,0,0,0,30000,-30000,-30000
062432,上銀元大9B購04  ,0,0,0,0,0,0,0,0,0,-30000,0,0,0,0,30000,-30000,-30000
062493,元金反中信9B購01,0,0,0,0,0,0,0,0,0,-30000,0,0,0,0,30000,-30000,-30000
062075,智邦元大9B購03  ,0,0,0,0,0,0,0,0,0,-30000,0,0,0,58000,88000,-30000,-30000
062003,國巨國泰01購01  ,0,0,0,0,0,0,0,0,0,-30000,0,0,0,70000,100000,-30000,-30000
06902P,聯電凱基98售02  ,0,0,0,0,0,0,0,0,0,-31000,0,0,0,14000,45000,-31000,-31000
063800,玉晶光凱基9C購02,0,0,0,0,0,0,0,0,0,-31000,0,0,0,73000,104000,-31000,-31000
07814P,華通群益9A售06  ,0,0,0,0,0,0,0,0,0,-31000,0,0,0,28000,59000,-31000,-31000
052572,群創凱基99購01  ,0,0,0,0,0,0,0,0,0,-31000,0,0,0,50000,81000,-31000,-31000
053291,旺宏中信9A購01  ,0,0,0,0,0,0,0,0,0,-31000,0,0,0,0,31000,-31000,-31000
053405,台達電兆豐96購01,0,0,0,0,0,0,0,0,0,-31000,0,0,0,0,31000,-31000,-31000
056657,華邦電元大99購01,0,0,0,0,0,0,0,0,0,-31000,0,0,0,73000,104000,-31000,-31000
059120,致伸永豐99購01  ,0,0,0,0,0,0,0,0,0,-31000,0,0,0,91000,122000,-31000,-31000
057985,華通元富02購03  ,0,0,0,0,0,0,0,0,0,-31000,0,0,0,4000,35000,-31000,-31000
056709,華通永豐98購01  ,0,0,0,0,0,0,0,0,0,-31000,0,0,0,8000,39000,-31000,-31000
058605,華邦電元大99購04,0,0,0,0,0,0,0,0,0,-31000,0,0,0,113000,144000,-31000,-31000
057816,欣興元大98購13  ,0,0,0,0,0,0,0,0,0,-31000,0,0,0,68000,99000,-31000,-31000
057772,台積電群益99購01,0,0,0,0,0,0,0,0,0,-31000,0,0,0,0,31000,-31000,-31000
057768,華新科中信9A購01,0,0,0,0,0,0,0,0,0,-31000,0,0,0,0,31000,-31000,-31000
058363,全新凱基9A購02  ,0,0,0,0,0,0,0,0,0,-31000,0,0,0,85000,116000,-31000,-31000
058241,景碩元大99購05  ,0,0,0,0,0,0,0,0,0,-31000,0,0,0,54000,85000,-31000,-31000
060282,聚陽元大9A購01  ,0,0,0,0,0,0,0,0,0,-31000,0,0,0,1000,32000,-31000,-31000
06242P,大立光元富9A售02,0,0,0,0,0,0,0,0,0,-31000,0,0,0,0,31000,-31000,-31000
063171,光寶科中信9B購01,0,0,0,0,0,0,0,0,0,-31000,0,0,0,17000,48000,-31000,-31000
062837,復盛群益9B購01  ,0,0,0,0,0,0,0,0,0,-31000,0,0,0,160000,191000,-31000,-31000
062902,智邦元大9B購07  ,0,0,0,0,0,0,0,0,0,-31000,0,0,0,35000,66000,-31000,-31000
062744,超眾國泰9C購01  ,0,0,0,0,0,0,0,0,0,-31000,0,0,0,62000,93000,-31000,-31000
060591,富邦金台新9A購01,0,0,0,0,0,0,0,0,0,-31000,0,0,0,7000,38000,-31000,-31000
061509,SP黃豆富邦9C購01,0,0,0,0,0,0,0,0,0,-31000,0,0,0,0,31000,-31000,-31000
063611,儒鴻群益9B購03  ,0,0,0,0,0,0,0,0,0,-32000,0,0,0,0,32000,-32000,-32000
058765,緯穎群益99購03  ,0,0,0,0,0,0,0,0,0,-32000,0,0,0,12000,44000,-32000,-32000
055025,華新科國泰98購02,0,0,0,0,0,0,0,0,0,-32000,0,0,0,181000,213000,-32000,-32000
054351,華新科國泰97購03,0,0,0,0,0,0,0,0,0,-32000,0,0,0,15000,47000,-32000,-32000
054148,矽創元大96購03  ,0,0,0,0,0,0,0,0,0,-32000,0,0,0,68000,100000,-32000,-32000
057556,智易凱基99購01  ,0,0,0,0,0,0,0,0,0,-32000,0,0,0,86000,118000,-32000,-32000
057862,智邦凱基99購01  ,0,0,0,0,0,0,0,0,0,-32000,0,0,0,0,32000,-32000,-32000
059594,奇力新元大9B購01,0,0,0,0,0,0,0,0,0,-32000,0,0,0,1000,33000,-32000,-32000
056767,大毅元大99購01  ,0,0,0,0,0,0,0,0,0,-32000,0,0,0,170000,202000,-32000,-32000
061526,宏達電凱基9A購04,0,0,0,0,0,0,0,0,0,-32000,0,0,0,38000,70000,-32000,-32000
061453,台達電凱基9B購01,0,0,0,0,0,0,0,0,0,-32000,0,0,0,78000,110000,-32000,-32000
061605,華新科凱基9A購14,0,0,0,0,0,0,0,0,0,-32000,0,0,0,0,32000,-32000,-32000
062832,嘉澤群益9B購02  ,0,0,0,0,0,0,0,0,0,-32000,0,0,0,0,32000,-32000,-32000
062467,國巨凱基9B購08  ,0,0,0,0,0,0,0,0,0,-32000,0,0,0,0,32000,-32000,-32000
063563,國巨元大9C購07  ,0,0,0,0,0,0,0,0,0,-33000,0,0,0,284000,317000,-33000,-33000
063793,和大凱基9C購01  ,0,0,0,0,0,0,0,0,0,-33000,0,0,0,0,33000,-33000,-33000
063289,台表科元大9B購07,0,0,0,0,0,0,0,0,0,-33000,0,0,0,149000,182000,-33000,-33000
07183P,臺股指凱基99售25,0,0,0,0,0,0,0,0,0,-33000,0,0,0,10000,43000,-33000,-33000
06765P,欣興元大98售11  ,0,0,0,0,0,0,0,0,0,-33000,0,0,0,48000,81000,-33000,-33000
063898,旭富群益9C購01  ,0,0,0,0,0,0,0,0,0,-33000,0,0,0,0,33000,-33000,-33000
07730P,臺股指凱基9A售22,0,0,0,0,0,0,0,0,0,-33000,0,0,0,3000,36000,-33000,-33000
07470P,國巨元大9A售06  ,0,0,0,0,0,0,0,0,0,-33000,0,0,0,0,33000,-33000,-33000
052491,泰碩國票99購01  ,0,0,0,0,0,0,0,0,0,-33000,0,0,0,0,33000,-33000,-33000
054418,茂林元大97購01  ,0,0,0,0,0,0,0,0,0,-33000,0,0,0,38000,71000,-33000,-33000
056166,微星台新97購01  ,0,0,0,0,0,0,0,0,0,-33000,0,0,0,0,33000,-33000,-33000
056906,玉晶光元大9B購01,0,0,0,0,0,0,0,0,0,-33000,0,0,0,9000,42000,-33000,-33000
058812,台積電統一9B購06,0,0,0,0,0,0,0,0,0,-33000,0,0,0,6000,39000,-33000,-33000
058711,鴻海統一9A購02  ,0,0,0,0,0,0,0,0,0,-33000,0,0,0,0,33000,-33000,-33000
057523,大成鋼元大99購01,0,0,0,0,0,0,0,0,0,-33000,0,0,0,248000,281000,-33000,-33000
061998,緯穎元大9B購03  ,0,0,0,0,0,0,0,0,0,-33000,0,0,0,35000,68000,-33000,-33000
062775,大成鋼元大9B購02,0,0,0,0,0,0,0,0,0,-33000,0,0,0,285000,318000,-33000,-33000
062755,茂林麥證9B購01  ,0,0,0,0,33000,-33000,0,0,0,-33000,0,0,0,0,33000,-33000,-33000
061924,聯發科凱基9C購01,0,0,0,0,0,0,0,0,0,-33000,0,0,0,0,33000,-33000,-33000
061419,國巨元大9A購21  ,0,0,0,0,0,0,0,0,0,-33000,0,0,0,31000,64000,-33000,-33000
060704,台積電富邦01購01,0,0,0,0,0,0,0,0,0,-33000,0,0,0,0,33000,-33000,-33000
061184,大立光國泰9C購01,0,0,0,0,0,0,0,0,0,-33000,0,0,0,64000,97000,-33000,-33000
07539P,玉山金台新9A售01,0,0,0,0,0,0,0,0,0,-34000,0,0,0,0,34000,-34000,-34000
2441,超豐            ,213000,343000,-130000,0,0,0,0,0,0,96000,106000,10000,96000,0,0,0,-34000
063900,GIS群益9C購03   ,50000,0,50000,0,0,0,0,0,0,-84000,0,0,0,0,84000,-84000,-34000
07110P,台灣50群益9B售03,0,0,0,0,0,0,0,0,0,-34000,0,0,0,0,34000,-34000,-34000
063364,聯發科富邦01購02,0,0,0,0,0,0,0,0,0,-34000,0,0,0,42000,76000,-34000,-34000
063486,聚陽國泰9C購01  ,0,0,0,0,0,0,0,0,0,-34000,0,0,0,33000,67000,-34000,-34000
056558,台達電群益98購01,0,0,0,0,0,0,0,0,0,-34000,0,0,0,106000,140000,-34000,-34000
056544,貿聯凱基98購03  ,0,0,0,0,0,0,0,0,0,-34000,0,0,0,30000,64000,-34000,-34000
055576,嘉晶統一98購01  ,0,0,0,0,0,0,0,0,0,-34000,0,0,0,33000,67000,-34000,-34000
051614,元金2X凱基97購01,0,0,0,0,0,0,0,0,0,-34000,0,0,0,0,34000,-34000,-34000
060288,群光元大9C購01  ,0,10000,-10000,0,0,0,0,0,0,-24000,0,0,0,89000,113000,-24000,-34000
058208,百和凱基99購01  ,0,0,0,0,0,0,0,0,0,-34000,0,0,0,7000,41000,-34000,-34000
061339,京元電元大9A購05,0,0,0,0,0,0,0,0,0,-34000,0,0,0,129000,163000,-34000,-34000
061545,華新科群益9A購09,0,0,0,0,0,0,0,0,0,-34000,0,0,0,7000,41000,-34000,-34000
061973,上銀元大9B購01  ,0,0,0,0,0,0,0,0,0,-34000,0,0,0,0,34000,-34000,-34000
061983,華新科元大9B購04,0,0,0,0,0,0,0,0,0,-34000,0,0,0,0,34000,-34000,-34000
062506,巨大群益9C購01  ,0,0,0,0,0,0,0,0,0,-34000,0,0,0,0,34000,-34000,-34000
3149,正達            ,70000,104000,-34000,0,0,0,0,0,0,0,0,0,0,0,0,0,-34000
063472,茂林元大9B購04  ,0,0,0,0,0,0,0,0,0,-35000,0,0,0,20000,55000,-35000,-35000
063428,矽創凱基9B購02  ,0,0,0,0,0,0,0,0,0,-35000,0,0,0,5000,40000,-35000,-35000
063284,大立光元大9B購07,0,0,0,0,0,0,0,0,0,-35000,0,0,0,25000,60000,-35000,-35000
063278,國巨元大9C購04  ,0,0,0,0,0,0,0,0,0,-35000,0,0,0,0,35000,-35000,-35000
063711,高鐵凱基9B購01  ,0,0,0,0,0,0,0,0,0,-35000,0,0,0,0,35000,-35000,-35000
063728,國巨元大9B購21  ,0,0,0,0,0,0,0,0,0,-35000,0,0,0,0,35000,-35000,-35000
07557P,玉晶光元大9A售09,0,0,0,0,0,0,0,0,0,-35000,0,0,0,12000,47000,-35000,-35000
07760P,力山永豐9A售03  ,0,0,0,0,0,0,0,0,0,-35000,0,0,0,4000,39000,-35000,-35000
07293P,臺股指凱基99售45,0,0,0,0,0,0,0,0,0,-35000,0,0,0,0,35000,-35000,-35000
08019P,緯穎國票9B售02  ,0,0,0,0,0,0,0,0,0,-35000,0,0,0,85000,120000,-35000,-35000
053970,聯發科元大97購08,0,0,0,0,0,0,0,0,0,-35000,0,0,0,0,35000,-35000,-35000
053758,華新科國泰97購02,0,0,0,0,0,0,0,0,0,-35000,0,0,0,0,35000,-35000,-35000
05545P,台表科國泰98售01,0,0,0,0,0,0,0,0,0,-35000,0,0,0,335000,370000,-35000,-35000
053094,聯電統一97購02  ,0,0,0,0,0,0,0,0,0,-35000,0,0,0,0,35000,-35000,-35000
053582,英業達元大97購01,0,0,0,0,0,0,0,0,0,-35000,0,0,0,98000,133000,-35000,-35000
053627,宏碁兆豐97購01  ,0,0,0,0,0,0,0,0,0,-35000,0,0,0,0,35000,-35000,-35000
056151,建準凱基97購01  ,0,0,0,0,0,0,0,0,0,-35000,0,0,0,18000,53000,-35000,-35000
056271,嘉澤統一97購01  ,0,0,0,0,0,0,0,0,0,-35000,0,0,0,0,35000,-35000,-35000
059004,嘉晶元大99購05  ,0,0,0,0,0,0,0,0,0,-35000,0,0,0,182000,217000,-35000,-35000
058707,泰鼎元大99購02  ,0,0,0,0,0,0,0,0,0,-35000,0,0,0,3000,38000,-35000,-35000
058409,鴻海兆豐99購05  ,0,0,0,0,0,0,0,0,0,-35000,0,0,0,10000,45000,-35000,-35000
060162,碩天永豐9A購01  ,0,0,0,0,0,0,0,0,0,-35000,0,0,0,5000,40000,-35000,-35000
058275,S&P500中信9B購01,0,0,0,0,0,0,0,0,0,-35000,0,0,0,0,35000,-35000,-35000
058225,旺宏元富99購01  ,0,0,0,0,0,0,0,0,0,-35000,0,0,0,0,35000,-35000,-35000
057928,鈺齊凱基98購02  ,0,0,0,0,0,0,0,0,0,-35000,0,0,0,20000,55000,-35000,-35000
057148,玉晶光國票99購04,0,10000,-10000,0,0,0,0,0,0,-25000,0,0,0,148000,173000,-25000,-35000
060047,道瓊反凱基99購01,0,0,0,0,0,0,0,0,0,-35000,0,0,0,90000,125000,-35000,-35000
056715,瀚宇博永豐98購01,0,0,0,0,0,0,0,0,0,-35000,0,0,0,25000,60000,-35000,-35000
056744,麗豐凱基9A購01  ,0,0,0,0,0,0,0,0,0,-35000,0,0,0,5000,40000,-35000,-35000
062450,臻鼎元大9B購02  ,0,0,0,0,0,0,0,0,0,-35000,0,0,0,15000,50000,-35000,-35000
062383,大立光國泰01購01,0,0,0,0,0,0,0,0,0,-35000,0,0,0,273000,308000,-35000,-35000
061835,華新科凱基02購03,0,0,0,0,0,0,0,0,0,-35000,0,0,0,0,35000,-35000,-35000
061826,台郡麥證9B購01  ,0,0,0,44000,79000,-35000,0,0,0,-35000,0,0,0,44000,79000,-35000,-35000
061680,崇越元大9A購01  ,0,0,0,0,0,0,0,0,0,-35000,0,0,0,16000,51000,-35000,-35000
060734,華通統一9C購01  ,0,0,0,0,0,0,0,0,0,-35000,0,0,0,9000,44000,-35000,-35000
060559,世紀鋼凱基9C購01,0,0,0,0,0,0,0,0,0,-35000,0,0,0,15000,50000,-35000,-35000
07861P,台灣50中信03售08,0,0,0,0,0,0,0,0,0,-36000,0,0,0,0,36000,-36000,-36000
07891P,臺股指國票9B售01,0,0,0,0,0,0,0,0,0,-36000,0,0,0,26000,62000,-36000,-36000
07266P,大立光元大99售19,0,0,0,0,0,0,0,0,0,-36000,0,0,0,0,36000,-36000,-36000
063610,儒鴻群益9B購02  ,0,0,0,0,0,0,0,0,0,-36000,0,0,0,0,36000,-36000,-36000
06917P,聯電亞東99售01  ,0,0,0,0,0,0,0,0,0,-36000,0,0,0,0,36000,-36000,-36000
063862,世紀鋼國泰02購01,0,0,0,0,0,0,0,0,0,-36000,0,0,0,0,36000,-36000,-36000
06623P,立積元大98售04  ,0,0,0,0,0,0,0,0,0,-36000,0,0,0,0,36000,-36000,-36000
059363,超眾永豐99購02  ,0,0,0,0,0,0,0,0,0,-36000,0,0,0,66000,102000,-36000,-36000
055022,精元國泰99購01  ,0,0,0,0,0,0,0,0,0,-36000,0,0,0,0,36000,-36000,-36000
053485,矽創國票97購04  ,0,0,0,0,0,0,0,0,0,-36000,0,0,0,130000,166000,-36000,-36000
055381,茂林元大97購02  ,0,0,0,0,0,0,0,0,0,-36000,0,0,0,0,36000,-36000,-36000
055383,GIS元大97購02   ,0,0,0,0,0,0,0,0,0,-36000,0,0,0,17000,53000,-36000,-36000
056417,欣興中信98購01  ,0,0,0,0,0,0,0,0,0,-36000,0,0,0,146000,182000,-36000,-36000
057056,立積元大99購02  ,0,0,0,0,0,0,0,0,0,-36000,0,0,0,108000,144000,-36000,-36000
059952,旺宏康和99購01  ,0,0,0,0,0,0,0,0,0,-36000,0,0,0,5000,41000,-36000,-36000
060945,緯穎國票9A購02  ,0,0,0,0,0,0,0,0,0,-36000,0,0,0,3000,39000,-36000,-36000
061763,聯電元大9C購02  ,0,0,0,0,0,0,0,0,0,-36000,0,0,0,92000,128000,-36000,-36000
062426,大立光統一02購02,0,0,0,0,0,0,0,0,0,-36000,0,0,0,172000,208000,-36000,-36000
063158,瑞昱台新9B購02  ,0,0,0,0,0,0,0,0,0,-36000,0,0,0,4000,40000,-36000,-36000
06539P,聯發科凱基98售12,0,0,0,0,0,0,0,0,0,-37000,0,0,0,10000,47000,-37000,-37000
06503P,臺股指中信9A售02,0,0,0,0,0,0,0,0,0,-37000,0,0,0,188000,225000,-37000,-37000
06885P,國巨國票99售06  ,0,0,0,0,0,0,0,0,0,-37000,0,0,0,36000,73000,-37000,-37000
2882A,國泰特          ,2000,0,2000,0,0,0,0,0,0,-39000,0,39000,-39000,0,0,0,-37000
08276P,可成元富9C售02  ,0,0,0,0,0,0,0,0,0,-37000,0,0,0,0,37000,-37000,-37000
056392,玉晶光富邦9C購01,0,0,0,0,0,0,0,0,0,-37000,0,0,0,323000,360000,-37000,-37000
060061,旺宏兆豐99購02  ,0,0,0,0,0,0,0,0,0,-37000,0,0,0,20000,57000,-37000,-37000
060300,佐登國泰9B購01  ,0,0,0,0,0,0,0,0,0,-37000,0,0,0,16000,53000,-37000,-37000
060423,智易永豐9A購01  ,0,0,0,0,0,0,0,0,0,-37000,0,0,0,120000,157000,-37000,-37000
058668,元油2X群益9B購04,0,0,0,0,0,0,0,0,0,-37000,0,0,0,0,37000,-37000,-37000
059986,宏達電元大99購08,0,0,0,0,0,0,0,0,0,-37000,0,0,0,0,37000,-37000,-37000
057973,神達富邦9A購01  ,0,0,0,0,0,0,0,0,0,-37000,0,0,0,0,37000,-37000,-37000
063181,聚陽凱基9B購01  ,0,0,0,0,0,0,0,0,0,-37000,0,0,0,57000,94000,-37000,-37000
063006,道瓊反元大9C購01,0,0,0,0,0,0,0,0,0,-37000,0,0,0,65000,102000,-37000,-37000
062256,聯發科元大9B購08,0,0,0,0,0,0,0,0,0,-37000,0,0,0,0,37000,-37000,-37000
061913,宏碁中信9B購01  ,0,0,0,0,0,0,0,0,0,-37000,0,0,0,48000,85000,-37000,-37000
08254P,國巨元大9C售09  ,0,0,0,0,0,0,0,0,0,-38000,0,0,0,0,38000,-38000,-38000
07762P,聯發科永豐9A售03,0,0,0,0,0,0,0,0,0,-38000,0,0,0,0,38000,-38000,-38000
08054P,臺股指國票9B售19,0,0,0,0,0,0,0,0,0,-38000,0,0,0,68000,106000,-38000,-38000
063713,麗豐凱基9B購01  ,0,0,0,0,0,0,0,0,0,-38000,0,0,0,0,38000,-38000,-38000
063406,麗豐國票9C購01  ,0,0,0,0,0,0,0,0,0,-38000,0,0,0,37000,75000,-38000,-38000
063469,牧德元大9C購02  ,0,0,0,0,0,0,0,0,0,-38000,0,0,0,32000,70000,-38000,-38000
063463,瑞昱元大9B購05  ,0,0,0,0,0,0,0,0,0,-38000,0,0,0,0,38000,-38000,-38000
00711B,FH彭博新興債    ,0,0,0,0,0,0,0,0,0,-38000,0,0,0,41000,79000,-38000,-38000
055249,大毅統一99購01  ,0,0,0,0,0,0,0,0,0,-38000,0,0,0,108000,146000,-38000,-38000
054789,高鐵群益98購01  ,0,0,0,0,0,0,0,0,0,-38000,0,0,0,58000,96000,-38000,-38000
055619,同欣電國票98購02,0,0,0,0,0,0,0,0,0,-38000,0,0,0,214000,252000,-38000,-38000
056113,新日興兆豐98購01,0,0,0,0,0,0,0,0,0,-38000,0,0,0,128000,166000,-38000,-38000
059848,智邦永豐99購01  ,0,0,0,0,0,0,0,0,0,-38000,0,0,0,2000,40000,-38000,-38000
059791,超眾元大99購06  ,0,0,0,0,0,0,0,0,0,-38000,0,0,0,53000,91000,-38000,-38000
057010,景碩中信98購01  ,0,0,0,0,0,0,0,0,0,-38000,0,0,0,12000,50000,-38000,-38000
058926,勤誠元富99購01  ,0,0,0,0,0,0,0,0,0,-38000,0,0,0,30000,68000,-38000,-38000
058702,國巨元大99購16  ,0,0,0,0,0,0,0,0,0,-38000,0,0,0,80000,118000,-38000,-38000
060296,和碩元大9A購01  ,0,0,0,0,0,0,0,0,0,-38000,0,0,0,100000,138000,-38000,-38000
060923,全新永豐9A購01  ,0,0,0,0,0,0,0,0,0,-38000,0,0,0,0,38000,-38000,-38000
061916,元金2X凱基02購01,0,0,0,0,0,0,0,0,0,-38000,0,0,0,0,38000,-38000,-38000
061795,智邦永豐9B購01  ,0,0,0,0,0,0,0,0,0,-38000,0,0,0,4000,42000,-38000,-38000
061690,旺宏群益9A購05  ,0,0,0,0,0,0,0,0,0,-38000,0,0,0,0,38000,-38000,-38000
061390,大立光群益9A購04,0,0,0,0,0,0,0,0,0,-38000,0,0,0,0,38000,-38000,-38000
060755,鴻海元大9A購15  ,0,0,0,0,0,0,0,0,0,-38000,0,0,0,30000,68000,-38000,-38000
061989,晶技元大9B購04  ,0,0,0,0,0,0,0,0,0,-38000,0,0,0,38000,76000,-38000,-38000
062976,嘉澤元富9B購01  ,0,0,0,0,0,0,0,0,0,-38000,0,0,0,0,38000,-38000,-38000
063082,瑞昱凱基9B購04  ,0,0,0,0,0,0,0,0,0,-38000,0,0,0,50000,88000,-38000,-38000
062641,瀚宇博國票9B購01,0,0,0,0,0,0,0,0,0,-38000,0,0,0,0,38000,-38000,-38000
063815,玉晶光群益02購01,0,0,0,0,0,0,0,0,0,-39000,0,0,0,82000,121000,-39000,-39000
06864P,健策凱基98售01  ,0,0,0,0,0,0,0,0,0,-39000,0,0,0,29000,68000,-39000,-39000
056076,超眾元大97購05  ,0,0,0,0,0,0,0,0,0,-39000,0,0,0,41000,80000,-39000,-39000
059355,國巨富邦9B購03  ,0,0,0,0,0,0,0,0,0,-39000,0,0,0,1000,40000,-39000,-39000
056552,台表科凱基99購01,0,0,0,0,0,0,0,0,0,-39000,0,0,0,95000,134000,-39000,-39000
055773,瑞昱凱基97購03  ,0,0,0,0,0,0,0,0,0,-39000,0,0,0,10000,49000,-39000,-39000
051159,力山元大96購01  ,0,0,0,0,0,0,0,0,0,-39000,0,0,0,0,39000,-39000,-39000
053503,臻鼎兆豐97購01  ,0,0,0,0,0,0,0,0,0,-39000,0,0,0,1000,40000,-39000,-39000
053320,華新科群益97購01,0,0,0,0,0,0,0,0,0,-39000,0,0,0,5000,44000,-39000,-39000
060226,道瓊反元大9A購01,0,0,0,0,0,0,0,0,0,-39000,0,0,0,39000,78000,-39000,-39000
060189,宏達電元富9B購03,0,0,0,0,0,0,0,0,0,-39000,0,0,0,9000,48000,-39000,-39000
057873,義隆元大98購03  ,0,0,0,0,0,0,0,0,0,-39000,0,0,0,26000,65000,-39000,-39000
062187,台勝科元大9B購02,0,0,0,0,0,0,0,0,0,-39000,0,0,0,12000,51000,-39000,-39000
062464,T50反1凱基9C購03,0,0,0,0,0,0,0,0,0,-39000,0,0,0,0,39000,-39000,-39000
062521,玉晶光元大9C購05,0,0,0,0,0,0,0,0,0,-39000,0,0,0,236000,275000,-39000,-39000
060841,宏達電國票9B購01,0,0,0,0,0,0,0,0,0,-39000,0,0,0,0,39000,-39000,-39000
060849,力成國票9A購01  ,0,0,0,0,0,0,0,0,0,-39000,0,0,0,19000,58000,-39000,-39000
061458,臻鼎凱基9A購02  ,0,0,0,0,0,0,0,0,0,-39000,0,0,0,43000,82000,-39000,-39000
061912,台積電中信05購05,0,0,0,0,0,0,0,0,0,-39000,0,0,0,13000,52000,-39000,-39000
06824P,台灣50國票99售02,0,0,0,0,0,0,0,0,0,-40000,0,0,0,0,40000,-40000,-40000
063904,大立光麥證01購01,0,0,0,0,40000,-40000,0,0,0,-40000,0,0,0,0,40000,-40000,-40000
06538P,國巨凱基98售11  ,0,0,0,0,0,0,0,0,0,-40000,0,0,0,0,40000,-40000,-40000
06750P,聯發科元富02售03,0,0,0,0,0,0,0,0,0,-40000,0,0,0,10000,50000,-40000,-40000
063813,瑞昱群益9C購02  ,0,0,0,0,0,0,0,0,0,-40000,0,0,0,0,40000,-40000,-40000
063538,神達統一9C購01  ,0,0,0,0,0,0,0,0,0,-40000,0,0,0,0,40000,-40000,-40000
08005P,台積電群益9C售04,0,0,0,0,0,0,0,0,0,-40000,0,0,0,10000,50000,-40000,-40000
07708P,玉晶光元大9A售13,0,0,0,0,0,0,0,0,0,-40000,0,0,0,30000,70000,-40000,-40000
07636P,鴻海國票9A售05  ,0,0,0,0,0,0,0,0,0,-40000,0,0,0,0,40000,-40000,-40000
08250P,GIS群益9C售02   ,0,0,0,0,0,0,0,0,0,-40000,0,0,0,60000,100000,-40000,-40000
08201P,祥碩元大9B售09  ,0,0,0,0,0,0,0,0,0,-40000,0,0,0,91000,131000,-40000,-40000
053253,友達國泰97購02  ,0,0,0,0,0,0,0,0,0,-40000,0,0,0,0,40000,-40000,-40000
053134,南亞科國票97購01,0,0,0,0,0,0,0,0,0,-40000,0,0,0,0,40000,-40000,-40000
053033,智易兆豐97購01  ,0,0,0,0,0,0,0,0,0,-40000,0,0,0,0,40000,-40000,-40000
03425B,臺股指元大9A熊01,0,0,0,0,0,0,0,0,0,-40000,0,0,0,0,40000,-40000,-40000
00743,國泰中國A150    ,36000,3000,33000,0,0,0,0,0,0,-73000,0,0,0,20000,93000,-73000,-40000
050515,聯電元大96購01  ,0,0,0,0,0,0,0,0,0,-40000,0,0,0,100000,140000,-40000,-40000
041990,A50正2國票97購01,0,0,0,0,0,0,0,0,0,-40000,0,0,0,0,40000,-40000,-40000
053901,T50反1凱基99購03,0,0,0,0,0,0,0,0,0,-40000,0,0,0,0,40000,-40000,-40000
055762,智伸科群益97購01,0,0,0,0,0,0,0,0,0,-40000,0,0,0,0,40000,-40000,-40000
054621,華新科兆豐98購01,0,0,0,0,0,0,0,0,0,-40000,0,0,0,102000,142000,-40000,-40000
05502P,台表科國票97售01,0,0,0,0,0,0,0,0,0,-40000,0,0,0,0,40000,-40000,-40000
054928,帆宣凱基98購01  ,0,0,0,0,0,0,0,0,0,-40000,0,0,0,0,40000,-40000,-40000
054788,華新科群益98購02,0,0,0,0,0,0,0,0,0,-40000,0,0,0,0,40000,-40000,-40000
056450,可成凱基98購05  ,0,0,0,0,0,0,0,0,0,-40000,0,0,0,50000,90000,-40000,-40000
059472,T50正2群益99購01,0,0,0,0,0,0,0,0,0,-40000,0,0,0,0,40000,-40000,-40000
056098,矽創元富97購02  ,0,0,0,0,0,0,0,0,0,-40000,0,0,0,10000,50000,-40000,-40000
057602,聯茂群益98購02  ,0,0,0,0,0,0,0,0,0,-40000,0,0,0,0,40000,-40000,-40000
057579,長榮航中信9A購01,0,0,0,0,0,0,0,0,0,-40000,0,0,0,5000,45000,-40000,-40000
060326,群光群益9A購01  ,0,0,0,0,0,0,0,0,0,-40000,0,0,0,0,40000,-40000,-40000
058259,訊連國泰9B購01  ,0,0,0,0,0,0,0,0,0,-40000,0,0,0,0,40000,-40000,-40000
057495,牧德元大99購04  ,0,0,0,0,0,0,0,0,0,-40000,0,0,0,28000,68000,-40000,-40000
057058,祥碩元大98購04  ,0,0,0,0,0,0,0,0,0,-40000,0,0,0,0,40000,-40000,-40000
058099,鴻海國泰9A購02  ,0,0,0,0,0,0,0,0,0,-40000,0,0,0,0,40000,-40000,-40000
059821,美律凱基99購08  ,0,0,0,0,0,0,0,0,0,-40000,0,0,0,0,40000,-40000,-40000
059919,宏達電元大99購06,0,0,0,0,0,0,0,0,0,-40000,0,0,0,0,40000,-40000,-40000
060015,國巨康和99購03  ,0,0,0,0,0,0,0,0,0,-40000,0,0,0,2000,42000,-40000,-40000
056772,欣興元大99購01  ,0,0,0,0,0,0,0,0,0,-40000,0,0,0,67000,107000,-40000,-40000
058951,南電群益99購01  ,0,0,0,0,0,0,0,0,0,-40000,0,0,0,43000,83000,-40000,-40000
058937,仁寶中信99購01  ,0,0,0,0,0,0,0,0,0,-40000,0,0,0,0,40000,-40000,-40000
059223,大立光元大99購14,0,0,0,0,0,0,0,0,0,-40000,0,0,0,8000,48000,-40000,-40000
059452,全新永豐99購03  ,0,0,0,0,0,0,0,0,0,-40000,0,0,0,19000,59000,-40000,-40000
057232,京元電凱基98購02,0,0,0,0,0,0,0,0,0,-40000,0,0,0,0,40000,-40000,-40000
058849,奇力新群益99購02,0,0,0,0,0,0,0,0,0,-40000,0,0,0,0,40000,-40000,-40000
058055,華擎統一9A購01  ,0,0,0,0,0,0,0,0,0,-40000,0,0,0,27000,67000,-40000,-40000
059722,南亞科元大99購02,0,0,0,0,0,0,0,0,0,-40000,0,0,0,10000,50000,-40000,-40000
058904,晶技元大99購05  ,0,0,0,0,0,0,0,0,0,-40000,0,0,0,0,40000,-40000,-40000
05887P,友達元富99售03  ,0,0,0,0,0,0,0,0,0,-40000,0,0,0,0,40000,-40000,-40000
061846,元金2X國票9C購01,0,0,0,0,0,0,0,0,0,-40000,0,0,0,0,40000,-40000,-40000
061717,力成凱基9B購01  ,0,0,0,0,0,0,0,0,0,-40000,0,0,0,30000,70000,-40000,-40000
06166P,大立光國票98售01,0,0,0,0,0,0,0,0,0,-40000,0,0,0,0,40000,-40000,-40000
061384,T50反1群益9A購04,0,0,0,0,0,0,0,0,0,-40000,0,0,0,20000,60000,-40000,-40000
061253,臺股指群益9A購04,0,0,0,0,0,0,0,0,0,-40000,0,0,0,30000,70000,-40000,-40000
060833,道瓊反國票9A購01,0,0,0,0,0,0,0,0,0,-40000,0,0,0,0,40000,-40000,-40000
060541,正隆凱基9A購01  ,0,0,0,0,0,0,0,0,0,-40000,0,0,0,1000,41000,-40000,-40000
06254P,臺股指群益97售07,0,0,0,0,0,0,0,0,0,-40000,0,0,0,10000,50000,-40000,-40000
062485,華通國泰01購01  ,0,0,0,0,0,0,0,0,0,-40000,0,0,0,77000,117000,-40000,-40000
062441,華新科元大9C購01,0,0,0,0,0,0,0,0,0,-40000,0,0,0,10000,50000,-40000,-40000
062305,遠東新凱基9B購01,0,0,0,0,0,0,0,0,0,-40000,0,0,0,42000,82000,-40000,-40000
062142,喬山國票9B購01  ,0,0,0,0,0,0,0,0,0,-40000,0,0,0,2000,42000,-40000,-40000
062247,國巨元大9B購07  ,0,0,0,0,0,0,0,0,0,-40000,0,0,0,10000,50000,-40000,-40000
062774,儒鴻元大9C購01  ,0,0,0,0,0,0,0,0,0,-40000,0,0,0,114000,154000,-40000,-40000
062899,鴻海元大9C購04  ,0,0,0,0,0,0,0,0,0,-40000,0,0,0,10000,50000,-40000,-40000
062909,大立光元大9C購04,0,0,0,0,0,0,0,0,0,-40000,0,0,0,14000,54000,-40000,-40000
063010,國巨元大9C購02  ,0,0,0,0,0,0,0,0,0,-40000,0,0,0,0,40000,-40000,-40000
063124,奇力新元大9B購05,0,0,0,0,0,0,0,0,0,-40000,0,0,0,23000,63000,-40000,-40000
9105,泰金寶-DR       ,0,40000,-40000,0,0,0,0,0,0,0,0,0,0,0,0,0,-40000
07638P,長榮航國票9A售01,0,0,0,0,0,0,0,0,0,-41000,0,0,0,0,41000,-41000,-41000
08014P,微星凱基9B售02  ,0,0,0,0,0,0,0,0,0,-41000,0,0,0,10000,51000,-41000,-41000
08120P,南亞科國票9C售01,0,0,0,0,0,0,0,0,0,-41000,0,0,0,0,41000,-41000,-41000
06338P,亞德客統一97售02,0,0,0,0,0,0,0,0,0,-41000,0,0,0,10000,51000,-41000,-41000
063232,裕隆元大9B購01  ,0,0,0,0,0,0,0,0,0,-41000,0,0,0,20000,61000,-41000,-41000
059173,矽力凱基99購01  ,0,0,0,0,0,0,0,0,0,-41000,0,0,0,10000,51000,-41000,-41000
00660,元大歐洲50      ,0,0,0,0,0,0,0,0,0,-41000,0,0,0,1000,42000,-41000,-41000
055382,台郡元大99購01  ,0,0,0,0,0,0,0,0,0,-41000,0,0,0,29000,70000,-41000,-41000
053564,台積電富邦99購01,0,0,0,0,0,0,0,0,0,-41000,0,0,0,0,41000,-41000,-41000
053400,緯穎中信9A購01  ,0,0,0,0,0,0,0,0,0,-41000,0,0,0,0,41000,-41000,-41000
057172,南亞科元大98購03,0,0,0,0,0,0,0,0,0,-41000,0,0,0,47000,88000,-41000,-41000
058793,鴻海元大99購19  ,0,0,0,0,0,0,0,0,0,-41000,0,0,0,11000,52000,-41000,-41000
056843,冠德元富98購01  ,0,0,0,0,0,0,0,0,0,-41000,0,0,0,2000,43000,-41000,-41000
057628,旺宏永豐98購02  ,0,0,0,0,0,0,0,0,0,-41000,0,0,0,0,41000,-41000,-41000
063201,廣達統一01購01  ,0,0,0,0,0,0,0,0,0,-41000,0,0,0,14000,55000,-41000,-41000
062149,牧德國票9B購01  ,0,0,0,0,0,0,0,0,0,-41000,0,0,0,1000,42000,-41000,-41000
060745,京元電國票9A購01,0,0,0,0,0,0,0,0,0,-41000,0,0,0,0,41000,-41000,-41000
060699,華新科國泰9B購03,0,0,0,0,0,0,0,0,0,-41000,0,0,0,10000,51000,-41000,-41000
060876,國巨中信9A購04  ,0,0,0,0,0,0,0,0,0,-41000,0,0,0,0,41000,-41000,-41000
06177P,玉晶光元大98售07,0,0,0,0,0,0,0,0,0,-41000,0,0,0,0,41000,-41000,-41000
063955,TPK元大9C購01   ,0,0,0,0,0,0,0,0,0,-42000,0,0,0,0,42000,-42000,-42000
07531P,大立光國泰9B售03,0,0,0,0,0,0,0,0,0,-42000,0,0,0,0,42000,-42000,-42000
2476,鉅祥            ,109000,151000,-42000,0,0,0,0,0,0,0,0,0,0,0,0,0,-42000
055519,茂林中信99購01  ,0,0,0,0,0,0,0,0,0,-42000,0,0,0,19000,61000,-42000,-42000
054569,GIS群益98購01   ,0,0,0,0,0,0,0,0,0,-42000,0,0,0,69000,111000,-42000,-42000
056511,超眾永豐98購01  ,0,0,0,0,0,0,0,0,0,-42000,0,0,0,28000,70000,-42000,-42000
059694,創意永豐99購03  ,0,0,0,0,0,0,0,0,0,-42000,0,0,0,6000,48000,-42000,-42000
059469,智邦元大99購03  ,0,0,0,0,0,0,0,0,0,-42000,0,0,0,0,42000,-42000,-42000
058249,緯穎元大99購04  ,0,0,0,0,0,0,0,0,0,-42000,0,0,0,65000,107000,-42000,-42000
05958P,聯發科國票97售04,0,0,0,0,0,0,0,0,0,-42000,0,0,0,34000,76000,-42000,-42000
061542,旺宏群益9A購04  ,0,0,0,0,0,0,0,0,0,-42000,0,0,0,0,42000,-42000,-42000
060717,康控永豐9A購01  ,0,0,0,0,0,0,0,0,0,-42000,0,0,0,103000,145000,-42000,-42000
060544,國巨凱基9B購03  ,0,0,0,0,0,0,0,0,0,-42000,0,0,0,0,42000,-42000,-42000
063130,聯茂元大9B購02  ,0,0,0,0,0,0,0,0,0,-42000,0,0,0,21000,63000,-42000,-42000
1905,華紙            ,325000,386000,-61000,0,0,0,0,0,0,18000,19000,1000,18000,0,0,0,-43000
07462P,臺股指元大9B售05,0,0,0,0,0,0,0,0,0,-43000,0,0,0,7000,50000,-43000,-43000
08069P,大立光國泰01售02,0,0,0,0,0,0,0,0,0,-43000,0,0,0,0,43000,-43000,-43000
07033P,大立光統一9B售03,0,0,0,0,0,0,0,0,0,-43000,0,0,0,0,43000,-43000,-43000
063243,聯發科元大9B購20,0,0,0,0,0,0,0,0,0,-43000,0,0,0,63000,106000,-43000,-43000
063410,南六國票9C購01  ,0,0,0,0,0,0,0,0,0,-43000,0,0,0,120000,163000,-43000,-43000
063686,國巨永豐9B購04  ,0,0,0,0,0,0,0,0,0,-43000,0,0,0,0,43000,-43000,-43000
054758,南亞國票9A購01  ,0,0,0,0,0,0,0,0,0,-43000,0,0,0,5000,48000,-43000,-43000
059037,宏達電群益99購02,0,0,0,0,0,0,0,0,0,-43000,0,0,0,0,43000,-43000,-43000
059567,台積電凱基9A購12,0,0,0,0,0,0,0,0,0,-43000,0,0,0,0,43000,-43000,-43000
055972,GIS元大97購04   ,0,0,0,0,0,0,0,0,0,-43000,0,0,0,182000,225000,-43000,-43000
055847,大立光元大97購10,0,0,0,0,0,0,0,0,0,-43000,0,0,0,10000,53000,-43000,-43000
055428,友達群益9C購01  ,0,43000,-43000,0,0,0,0,0,0,0,0,0,0,0,0,0,-43000
057554,新日興凱基99購02,0,0,0,0,0,0,0,0,0,-43000,0,0,0,155000,198000,-43000,-43000
057596,聯茂兆豐99購01  ,0,0,0,0,0,0,0,0,0,-43000,0,0,0,0,43000,-43000,-43000
059634,可成凱基99購07  ,0,0,0,0,0,0,0,0,0,-43000,0,0,0,0,43000,-43000,-43000
058780,牧德國票9A購01  ,0,0,0,0,0,0,0,0,0,-43000,0,0,0,38000,81000,-43000,-43000
056749,滬深2X兆豐99購01,0,0,0,0,0,0,0,0,0,-43000,0,0,0,0,43000,-43000,-43000
063159,嘉澤國泰01購01  ,0,0,0,0,0,0,0,0,0,-43000,0,0,0,0,43000,-43000,-43000
062341,台表科麥證9C購01,0,0,0,1000,44000,-43000,0,0,0,-43000,0,0,0,1000,44000,-43000,-43000
060556,緯穎凱基9A購04  ,0,0,0,0,0,0,0,0,0,-43000,0,0,0,25000,68000,-43000,-43000
061552,南六群益9A購02  ,0,0,0,0,0,0,0,0,0,-43000,0,0,0,52000,95000,-43000,-43000
061343,大立光元大9A購04,0,0,0,0,0,0,0,0,0,-43000,0,0,0,0,43000,-43000,-43000
063594,上銀中信9C購01  ,0,0,0,0,0,0,0,0,0,-44000,0,0,0,0,44000,-44000,-44000
07265P,大立光元大99售16,0,0,0,0,0,0,0,0,0,-44000,0,0,0,259000,303000,-44000,-44000
063867,全新永豐9C購01  ,0,0,0,0,0,0,0,0,0,-44000,0,0,0,0,44000,-44000,-44000
06716P,台積電元大9A售02,0,0,0,0,0,0,0,0,0,-44000,0,0,0,0,44000,-44000,-44000
06654P,欣興元大98售08  ,0,0,0,0,0,0,0,0,0,-44000,0,0,0,167000,211000,-44000,-44000
07875P,祥碩群益9B售01  ,0,0,0,0,0,0,0,0,0,-44000,0,0,0,81000,125000,-44000,-44000
07500P,微星元大9A售01  ,0,0,0,0,0,0,0,0,0,-44000,0,0,0,4000,48000,-44000,-44000
056405,聯茂群益98購01  ,0,0,0,0,0,0,0,0,0,-44000,0,0,0,0,44000,-44000,-44000
051979,群創凱基97購01  ,0,0,0,0,0,0,0,0,0,-44000,0,0,0,50000,94000,-44000,-44000
053784,奇力新元大97購02,0,0,0,0,0,0,0,0,0,-44000,0,0,0,6000,50000,-44000,-44000
05606P,TPK國票97售02   ,0,0,0,0,0,0,0,0,0,-44000,0,0,0,0,44000,-44000,-44000
059534,國泰金凱基99購01,0,0,0,0,0,0,0,0,0,-44000,0,0,0,35000,79000,-44000,-44000
054819,裕民元大9A購01  ,0,0,0,0,0,0,0,0,0,-44000,0,0,0,587000,631000,-44000,-44000
059623,聯電凱基99購02  ,16000,0,16000,0,0,0,0,0,0,-60000,0,0,0,26000,86000,-60000,-44000
058189,嘉澤永豐99購01  ,0,0,0,0,0,0,0,0,0,-44000,0,0,0,10000,54000,-44000,-44000
057451,大立光元富9B購01,0,0,0,0,0,0,0,0,0,-44000,0,0,0,172000,216000,-44000,-44000
060252,緯穎元大9A購02  ,0,0,0,0,0,0,0,0,0,-44000,0,0,0,10000,54000,-44000,-44000
061584,勤誠元大9A購01  ,0,0,0,0,0,0,0,0,0,-44000,0,0,0,16000,60000,-44000,-44000
061474,瑞昱元大9A購04  ,0,0,0,0,0,0,0,0,0,-44000,0,0,0,3000,47000,-44000,-44000
060719,瀚宇博永豐9A購01,0,0,0,0,0,0,0,0,0,-44000,0,0,0,3000,47000,-44000,-44000
060912,華新科元大9A購10,0,0,0,0,0,0,0,0,0,-44000,0,0,0,6000,50000,-44000,-44000
061101,道瓊銀元大9A購02,0,0,0,0,0,0,0,0,0,-44000,0,0,0,175000,219000,-44000,-44000
062361,智邦元大9B購06  ,0,0,0,0,0,0,0,0,0,-44000,0,0,0,56000,100000,-44000,-44000
062452,A50正2群益01購04,0,0,0,0,0,0,0,0,0,-44000,0,0,0,0,44000,-44000,-44000
062132,神隆群益9B購01  ,0,0,0,0,0,0,0,0,0,-44000,0,0,0,173000,217000,-44000,-44000
062231,台光電麥證9C購01,0,0,0,50000,94000,-44000,0,0,0,-44000,0,0,0,50000,94000,-44000,-44000
3027,盛達            ,15000,62000,-47000,0,0,0,0,0,0,3000,3000,0,3000,0,0,0,-44000
07639P,緯穎國票9A售01  ,0,0,0,0,0,0,0,0,0,-45000,0,0,0,169000,214000,-45000,-45000
07987P,大立光統一9B售13,0,0,0,0,0,0,0,0,0,-45000,0,0,0,0,45000,-45000,-45000
07259P,滬深2X國票01售01,0,0,0,0,0,0,0,0,0,-45000,0,0,0,0,45000,-45000,-45000
07058P,台積電凱基9A售07,0,0,0,0,0,0,0,0,0,-45000,0,0,0,117000,162000,-45000,-45000
063411,和潤國票9C購01  ,0,0,0,0,0,0,0,0,0,-45000,0,0,0,33000,78000,-45000,-45000
063530,同欣電凱基9C購02,0,0,0,0,0,0,0,0,0,-45000,0,0,0,2000,47000,-45000,-45000
063514,南電麥證9C購01  ,0,0,0,70000,115000,-45000,0,0,0,-45000,0,0,0,70000,115000,-45000,-45000
063515,香港2X凱基01購01,0,0,0,0,0,0,0,0,0,-45000,0,0,0,49000,94000,-45000,-45000
055781,聯詠凱基98購01  ,0,0,0,0,0,0,0,0,0,-45000,0,0,0,0,45000,-45000,-45000
056298,億光元大97購02  ,0,0,0,0,0,0,0,0,0,-45000,0,0,0,52000,97000,-45000,-45000
053900,T50反1日盛99購01,0,0,0,0,0,0,0,0,0,-45000,0,0,0,0,45000,-45000,-45000
047410,上銀元富96購01  ,0,0,0,0,0,0,0,0,0,-45000,0,0,0,5000,50000,-45000,-45000
052837,友達國泰97購01  ,0,0,0,0,0,0,0,0,0,-45000,0,0,0,70000,115000,-45000,-45000
060099,宏達電元大99購09,0,0,0,0,0,0,0,0,0,-45000,0,0,0,20000,65000,-45000,-45000
057902,嘉晶永豐98購02  ,0,0,0,0,0,0,0,0,0,-45000,0,0,0,60000,105000,-45000,-45000
057708,臺股指群益98購08,0,0,0,0,0,0,0,0,0,-45000,0,0,0,0,45000,-45000,-45000
058484,元金2X國票04購01,0,0,0,0,0,0,0,0,0,-45000,0,0,0,0,45000,-45000,-45000
059687,卜蜂永豐99購01  ,0,0,0,0,0,0,0,0,0,-45000,0,0,0,0,45000,-45000,-45000
057239,貿聯凱基98購05  ,0,0,0,0,0,0,0,0,0,-45000,0,0,0,10000,55000,-45000,-45000
062161,南六凱基9C購01  ,0,0,0,0,0,0,0,0,0,-45000,0,0,0,108000,153000,-45000,-45000
062096,神隆永豐9B購01  ,0,0,0,0,0,0,0,0,0,-45000,0,0,0,4000,49000,-45000,-45000
062443,大立光元大9B購05,0,0,0,0,0,0,0,0,0,-45000,0,0,0,0,45000,-45000,-45000
063166,超眾永豐9B購01  ,0,0,0,0,0,0,0,0,0,-45000,0,0,0,42000,87000,-45000,-45000
062924,世紀鋼元大9C購04,0,0,0,0,0,0,0,0,0,-45000,0,0,0,61000,106000,-45000,-45000
061067,貿聯凱基9A購03  ,0,0,0,0,0,0,0,0,0,-45000,0,0,0,10000,55000,-45000,-45000
060824,旺宏元大9A購06  ,0,0,0,0,0,0,0,0,0,-45000,0,0,0,5000,50000,-45000,-45000
063544,華新科台新9B購02,0,0,0,0,0,0,0,0,0,-46000,0,0,0,20000,66000,-46000,-46000
07069P,欣興元富99售02  ,0,0,0,0,0,0,0,0,0,-46000,0,0,0,102000,148000,-46000,-46000
08006P,長榮航中信03售01,0,0,0,0,0,0,0,0,0,-46000,0,0,0,94000,140000,-46000,-46000
07535P,上銀元富9A售03  ,0,0,0,0,0,0,0,0,0,-46000,0,0,0,350000,396000,-46000,-46000
07756P,台灣50國票04售01,0,0,0,0,0,0,0,0,0,-46000,0,0,0,0,46000,-46000,-46000
1310,台苯            ,684000,1016000,-332000,0,0,0,0,0,0,286000,269000,0,269000,17000,0,17000,-46000
055545,國巨凱基97購06  ,0,0,0,0,0,0,0,0,0,-46000,0,0,0,2000,48000,-46000,-46000
053865,欣興元大97購02  ,0,0,0,0,0,0,0,0,0,-46000,0,0,0,1000,47000,-46000,-46000
055197,致新元富97購02  ,0,0,0,0,0,0,0,0,0,-46000,0,0,0,0,46000,-46000,-46000
058022,樺漢凱基99購02  ,0,0,0,0,0,0,0,0,0,-46000,0,0,0,20000,66000,-46000,-46000
058973,麗豐永豐99購01  ,0,0,0,0,0,0,0,0,0,-46000,0,0,0,84000,130000,-46000,-46000
058397,大成鋼元大99購02,0,0,0,0,0,0,0,0,0,-46000,0,0,0,198000,244000,-46000,-46000
057857,牧德國票99購01  ,0,0,0,0,0,0,0,0,0,-46000,0,0,0,0,46000,-46000,-46000
058334,鴻海元富99購05  ,0,0,0,0,0,0,0,0,0,-46000,0,0,0,35000,81000,-46000,-46000
060455,葡萄王元大9A購02,0,0,0,0,0,0,0,0,0,-46000,0,0,0,68000,114000,-46000,-46000
061188,大成鋼富邦9B購01,0,0,0,0,0,0,0,0,0,-46000,0,0,0,715000,761000,-46000,-46000
061716,瑞儀凱基9B購01  ,0,0,0,0,0,0,0,0,0,-46000,0,0,0,114000,160000,-46000,-46000
063125,華擎元大9C購02  ,0,0,0,0,0,0,0,0,0,-46000,0,0,0,152000,198000,-46000,-46000
062453,聚陽群益9C購01  ,0,0,0,0,0,0,0,0,0,-46000,0,0,0,27000,73000,-46000,-46000
061990,台勝科元大9C購01,0,0,0,0,0,0,0,0,0,-46000,0,0,0,4000,50000,-46000,-46000
06745P,台積電群益98售05,0,0,0,0,0,0,0,0,0,-47000,0,0,0,0,47000,-47000,-47000
063860,旺宏國泰02購01  ,0,0,0,0,0,0,0,0,0,-47000,0,0,0,0,47000,-47000,-47000
063591,麗豐永豐9B購02  ,0,0,0,0,0,0,0,0,0,-47000,0,0,0,0,47000,-47000,-47000
063725,聯電元大9C購03  ,0,0,0,0,0,0,0,0,0,-47000,0,0,0,3000,50000,-47000,-47000
063487,國巨國泰01購02  ,0,0,0,0,0,0,0,0,0,-47000,0,0,0,22000,69000,-47000,-47000
056550,瑞儀凱基99購01  ,0,0,0,0,0,0,0,0,0,-47000,0,0,0,56000,103000,-47000,-47000
051266,國巨富邦99購01  ,0,0,0,0,0,0,0,0,0,-47000,0,0,0,33000,80000,-47000,-47000
053095,台光電統一98購01,0,0,0,0,0,0,0,0,0,-47000,0,0,0,36000,83000,-47000,-47000
060430,和潤永豐9A購01  ,0,0,0,0,0,0,0,0,0,-47000,0,0,0,10000,57000,-47000,-47000
060169,群電永豐9A購01  ,0,0,0,0,0,0,0,0,0,-47000,0,0,0,14000,61000,-47000,-47000
060133,牧德群益9B購01  ,0,0,0,0,0,0,0,0,0,-47000,0,0,0,19000,66000,-47000,-47000
057132,華新科凱基98購05,0,0,0,0,0,0,0,0,0,-47000,0,0,0,0,47000,-47000,-47000
058072,大立光凱基98購20,0,0,0,0,0,0,0,0,0,-47000,0,0,0,0,47000,-47000,-47000
062445,大立光元大9C購02,0,0,0,0,0,0,0,0,0,-47000,0,0,0,0,47000,-47000,-47000
062488,台光電永豐9B購02,0,0,0,0,0,0,0,0,0,-47000,0,0,0,3000,50000,-47000,-47000
063098,台灣50群益01購02,0,0,0,0,0,0,0,0,0,-47000,0,0,0,0,47000,-47000,-47000
062798,台光電統一9B購01,0,0,0,0,0,0,0,0,0,-47000,0,0,0,38000,85000,-47000,-47000
061539,國巨群益9B購03  ,0,0,0,0,0,0,0,0,0,-47000,0,0,0,0,47000,-47000,-47000
063378,茂林永豐9B購02  ,0,0,0,0,0,0,0,0,0,-48000,0,0,0,0,48000,-48000,-48000
063435,儒鴻統一01購02  ,0,0,0,0,0,0,0,0,0,-48000,0,0,0,40000,88000,-48000,-48000
063785,華通中信06購02  ,0,0,0,0,0,0,0,0,0,-48000,0,0,0,7000,55000,-48000,-48000
063959,GIS元大9C購02   ,0,0,0,0,0,0,0,0,0,-48000,0,0,0,0,48000,-48000,-48000
06778P,台積電元大99售06,0,0,0,0,0,0,0,0,0,-48000,0,0,0,2000,50000,-48000,-48000
056508,揚明光永豐98購01,0,0,0,0,0,0,0,0,0,-48000,0,0,0,52000,100000,-48000,-48000
054472,道瓊反中信9A購01,0,0,0,0,0,0,0,0,0,-48000,0,0,0,75000,123000,-48000,-48000
055172,凱美統一97購02  ,0,0,0,0,0,0,0,0,0,-48000,0,0,0,0,48000,-48000,-48000
056002,嘉晶永豐97購01  ,0,0,0,0,0,0,0,0,0,-48000,0,0,0,20000,68000,-48000,-48000
057163,上銀元大98購04  ,0,0,0,0,0,0,0,0,0,-48000,0,0,0,2000,50000,-48000,-48000
059431,旺宏元大99購14  ,0,0,0,0,0,0,0,0,0,-48000,0,0,0,1000,49000,-48000,-48000
060477,和潤元大9A購01  ,0,0,0,0,0,0,0,0,0,-48000,0,0,0,0,48000,-48000,-48000
058328,世紀鋼統一9B購01,0,0,0,0,0,0,0,0,0,-48000,0,0,0,3000,51000,-48000,-48000
058156,超眾統一9A購02  ,0,0,0,0,0,0,0,0,0,-48000,0,0,0,546000,594000,-48000,-48000
061401,華擎兆豐9B購01  ,0,0,0,0,0,0,0,0,0,-48000,0,0,0,0,48000,-48000,-48000
061422,台積電元大9A購30,0,0,0,0,0,0,0,0,0,-48000,0,0,0,2000,50000,-48000,-48000
061764,旺宏元大9B購01  ,0,0,0,0,0,0,0,0,0,-48000,0,0,0,2000,50000,-48000,-48000
061032,金像電永豐9A購03,0,0,0,0,0,0,0,0,0,-48000,0,0,0,215000,263000,-48000,-48000
062606,聯電凱基9C購02  ,0,0,0,0,0,0,0,0,0,-48000,0,0,0,30000,78000,-48000,-48000
063225,茂林群益9B購04  ,0,0,0,0,0,0,0,0,0,-48000,0,0,0,0,48000,-48000,-48000
063231,台泥元大9B購01  ,0,0,0,0,0,0,0,0,0,-48000,0,0,0,107000,155000,-48000,-48000
062487,中興電永豐9B購01,0,0,0,0,0,0,0,0,0,-48000,0,0,0,0,48000,-48000,-48000
063923,世芯元富9C購01  ,0,0,0,0,0,0,0,0,0,-49000,0,0,0,0,49000,-49000,-49000
06434P,超眾群益98售02  ,0,0,0,0,0,0,0,0,0,-49000,0,0,0,100000,149000,-49000,-49000
063784,華通中信06購01  ,0,0,0,0,0,0,0,0,0,-49000,0,0,0,30000,79000,-49000,-49000
051292,牧德統一97購01  ,0,0,0,0,0,0,0,0,0,-49000,0,0,0,20000,69000,-49000,-49000
057900,南亞科永豐98購01,0,0,0,0,0,0,0,0,0,-49000,0,0,0,0,49000,-49000,-49000
058413,義隆兆豐99購01  ,0,0,0,0,0,0,0,0,0,-49000,0,0,0,85000,134000,-49000,-49000
058802,矽創元大99購02  ,0,0,0,0,0,0,0,0,0,-49000,0,0,0,60000,109000,-49000,-49000
059940,微星永豐99購01  ,0,0,0,0,0,0,0,0,0,-49000,0,0,0,17000,66000,-49000,-49000
059985,華新科元大99購22,0,0,0,0,0,0,0,0,0,-49000,0,0,0,5000,54000,-49000,-49000
062117,燿華中信9B購01  ,0,0,0,0,0,0,0,0,0,-49000,0,0,0,36000,85000,-49000,-49000
062261,嘉晶元大9B購02  ,0,0,0,0,0,0,0,0,0,-49000,0,0,0,55000,104000,-49000,-49000
062678,華通統一9C購04  ,0,0,0,0,0,0,0,0,0,-49000,0,0,0,4000,53000,-49000,-49000
060760,南亞科元大9A購04,0,0,0,0,0,0,0,0,0,-49000,0,0,0,76000,125000,-49000,-49000
061585,台積電富邦9B購06,0,0,0,0,0,0,0,0,0,-49000,0,0,0,0,49000,-49000,-49000
2939,凱羿-KY         ,15000,69000,-54000,0,0,0,0,0,0,5000,5000,0,5000,0,0,0,-49000
063855,臺股指元大9C購08,0,0,0,0,0,0,0,0,0,-50000,0,0,0,0,50000,-50000,-50000
063574,茂林元大9B購07  ,0,0,0,0,0,0,0,0,0,-50000,0,0,0,0,50000,-50000,-50000
063444,金像電統一03購01,0,0,0,0,0,0,0,0,0,-50000,0,0,0,2000,52000,-50000,-50000
063419,聯發科凱基03購01,0,0,0,0,0,0,0,0,0,-50000,0,0,0,0,50000,-50000,-50000
063467,大立光元大9C購06,0,0,0,0,0,0,0,0,0,-50000,0,0,0,13000,63000,-50000,-50000
063517,遠東新凱基01購01,0,0,0,0,0,0,0,0,0,-50000,0,0,0,0,50000,-50000,-50000
063326,正隆國票9B購01  ,0,0,0,0,0,0,0,0,0,-50000,0,0,0,0,50000,-50000,-50000
06492P,上銀永豐98售01  ,0,0,0,0,0,0,0,0,0,-50000,0,0,0,20000,70000,-50000,-50000
06480P,上銀凱基98售04  ,0,0,0,0,0,0,0,0,0,-50000,0,0,0,0,50000,-50000,-50000
063918,復盛凱基9C購01  ,0,0,0,0,0,0,0,0,0,-50000,0,0,0,0,50000,-50000,-50000
06685P,鴻海國泰9A售01  ,0,0,0,0,0,0,0,0,0,-50000,0,0,0,0,50000,-50000,-50000
06566P,華通永豐98售03  ,0,0,0,0,0,0,0,0,0,-50000,0,0,0,0,50000,-50000,-50000
06589P,台積電元大98售12,0,0,0,0,0,0,0,0,0,-50000,0,0,0,0,50000,-50000,-50000
06620P,聯發科元大98售07,0,0,0,0,0,0,0,0,0,-50000,0,0,0,50000,100000,-50000,-50000
06876P,台灣50兆豐9B售01,0,0,0,0,0,0,0,0,0,-50000,0,0,0,0,50000,-50000,-50000
08291P,智邦台新9C售02  ,0,0,0,0,0,0,0,0,0,-50000,0,0,0,0,50000,-50000,-50000
07742P,台積電凱基9A售25,0,0,0,0,0,0,0,0,0,-50000,0,0,0,0,50000,-50000,-50000
07544P,大立光凱基9A售09,0,0,0,0,0,0,0,0,0,-50000,0,0,0,0,50000,-50000,-50000
07414P,台積電元大99售51,0,0,0,0,0,0,0,0,0,-50000,0,0,0,0,50000,-50000,-50000
07324P,台積電元大99售40,0,0,0,0,0,0,0,0,0,-50000,0,0,0,0,50000,-50000,-50000
07325P,台積電元大99售41,0,0,0,0,0,0,0,0,0,-50000,0,0,0,0,50000,-50000,-50000
07382P,台積電群益9B售01,0,0,0,0,0,0,0,0,0,-50000,0,0,0,0,50000,-50000,-50000
07361P,聯發科元大99售34,0,0,0,0,0,0,0,0,0,-50000,0,0,0,50000,100000,-50000,-50000
07998P,聯電凱基9C售01  ,0,0,0,0,0,0,0,0,0,-50000,0,0,0,5000,55000,-50000,-50000
07935P,臺股指國票9B售07,0,0,0,0,0,0,0,0,0,-50000,0,0,0,0,50000,-50000,-50000
07823P,國巨元大9A售23  ,0,0,0,0,0,0,0,0,0,-50000,0,0,0,0,50000,-50000,-50000
07824P,國巨元大9A售24  ,0,0,0,0,0,0,0,0,0,-50000,0,0,0,0,50000,-50000,-50000
03670C,元油2X元富99牛01,0,0,0,0,0,0,0,0,0,-50000,0,0,0,0,50000,-50000,-50000
03444B,臺股指元大9C熊02,0,0,0,0,0,0,0,0,0,-50000,0,0,0,1000,51000,-50000,-50000
055392,凱美統一97購03  ,0,0,0,0,0,0,0,0,0,-50000,0,0,0,0,50000,-50000,-50000
055518,華新科中信99購01,0,0,0,0,0,0,0,0,0,-50000,0,0,0,0,50000,-50000,-50000
053586,建準元大96購01  ,0,0,0,0,0,0,0,0,0,-50000,0,0,0,0,50000,-50000,-50000
053365,彩晶國泰98購01  ,0,0,0,0,0,0,0,0,0,-50000,0,0,0,0,50000,-50000,-50000
056009,奇力新中信98購03,0,0,0,0,0,0,0,0,0,-50000,0,0,0,0,50000,-50000,-50000
055818,晶相光國票97購02,0,0,0,0,0,0,0,0,0,-50000,0,0,0,0,50000,-50000,-50000
056167,力成台新97購01  ,0,0,0,0,0,0,0,0,0,-50000,0,0,0,0,50000,-50000,-50000
056263,友訊統一99購01  ,0,0,0,0,0,0,0,0,0,-50000,0,0,0,0,50000,-50000,-50000
059541,T50正2康和99購01,0,0,0,0,0,0,0,0,0,-50000,0,0,0,3000,53000,-50000,-50000
059310,元石油元大99購03,0,0,0,0,0,0,0,0,0,-50000,0,0,0,0,50000,-50000,-50000
055173,瑞昱統一97購01  ,0,0,0,0,0,0,0,0,0,-50000,0,0,0,0,50000,-50000,-50000
055268,和大元大97購01  ,0,0,0,0,0,0,0,0,0,-50000,0,0,0,0,50000,-50000,-50000
055206,台虹中信97購01  ,0,0,0,0,0,0,0,0,0,-50000,0,0,0,130000,180000,-50000,-50000
054944,精元元大97購01  ,0,0,0,0,0,0,0,0,0,-50000,0,0,0,0,50000,-50000,-50000
055019,福懋科元富97購01,0,0,0,0,0,0,0,0,0,-50000,0,0,0,100000,150000,-50000,-50000
055068,亞翔永豐97購01  ,0,0,0,0,0,0,0,0,0,-50000,0,0,0,0,50000,-50000,-50000
054690,新興永豐97購01  ,0,0,0,0,0,0,0,0,0,-50000,0,0,0,0,50000,-50000,-50000
054478,可成中信97購01  ,0,0,0,0,0,0,0,0,0,-50000,0,0,0,0,50000,-50000,-50000
054579,聯茂元大97購01  ,0,0,0,0,0,0,0,0,0,-50000,0,0,0,0,50000,-50000,-50000
054882,台光電統一97購02,0,0,0,0,0,0,0,0,0,-50000,0,0,0,0,50000,-50000,-50000
056498,A50正2富邦9B購01,0,0,0,0,0,0,0,0,0,-50000,0,0,0,0,50000,-50000,-50000
059979,台積電元大99購49,0,0,0,0,0,0,0,0,0,-50000,0,0,0,0,50000,-50000,-50000
059945,嘉澤永豐99購03  ,0,0,0,0,0,0,0,0,0,-50000,0,0,0,0,50000,-50000,-50000
056890,國巨元大98購11  ,0,0,0,0,0,0,0,0,0,-50000,0,0,0,0,50000,-50000,-50000
056903,大立光元大99購04,0,0,0,0,0,0,0,0,0,-50000,0,0,0,0,50000,-50000,-50000
056765,友達元大9B購05  ,0,0,0,0,0,0,0,0,0,-50000,0,0,0,0,50000,-50000,-50000
060002,T50反1群益9A購01,0,0,0,0,0,0,0,0,0,-50000,0,0,0,0,50000,-50000,-50000
057314,全新麥證98購01  ,0,0,0,10000,60000,-50000,0,0,0,-50000,0,0,0,10000,60000,-50000,-50000
057655,奇力新中信98購05,0,0,0,0,0,0,0,0,0,-50000,0,0,0,0,50000,-50000,-50000
057007,奇力新中信98購04,0,0,0,0,0,0,0,0,0,-50000,0,0,0,0,50000,-50000,-50000
057188,佐登元大98購01  ,0,0,0,0,0,0,0,0,0,-50000,0,0,0,0,50000,-50000,-50000
057917,台積電凱基98購17,0,0,0,0,0,0,0,0,0,-50000,0,0,0,1000,51000,-50000,-50000
057989,旺宏統一99購04  ,0,0,0,0,0,0,0,0,0,-50000,0,0,0,10000,60000,-50000,-50000
058068,旺宏凱基98購11  ,0,0,0,0,0,0,0,0,0,-50000,0,0,0,15000,65000,-50000,-50000
058852,貿聯群益99購04  ,0,0,0,0,0,0,0,0,0,-50000,0,0,0,0,50000,-50000,-50000
058889,元油2X元大9C購05,0,0,0,0,0,0,0,0,0,-50000,0,0,0,0,50000,-50000,-50000
057385,光罩永豐99購01  ,0,0,0,0,0,0,0,0,0,-50000,0,0,0,0,50000,-50000,-50000
060929,健策永豐9A購01  ,0,0,0,0,0,0,0,0,0,-50000,0,0,0,11000,61000,-50000,-50000
058230,國巨元大99購11  ,0,0,0,0,0,0,0,0,0,-50000,0,0,0,0,50000,-50000,-50000
057496,佐登元大98購02  ,0,0,0,0,0,0,0,0,0,-50000,0,0,0,0,50000,-50000,-50000
058286,道瓊指國票9B購01,0,0,0,0,0,0,0,0,0,-50000,0,0,0,0,50000,-50000,-50000
060245,聯陽元大9C購01  ,0,0,0,0,0,0,0,0,0,-50000,0,0,0,11000,61000,-50000,-50000
061570,瑞昱元大9A購05  ,0,0,0,0,0,0,0,0,0,-50000,0,0,0,0,50000,-50000,-50000
061836,華新科凱基05購01,0,0,0,0,0,0,0,0,0,-50000,0,0,0,0,50000,-50000,-50000
061833,華新科凱基02購01,0,0,0,0,0,0,0,0,0,-50000,0,0,0,0,50000,-50000,-50000
060757,台積電元大9A購18,0,0,0,0,0,0,0,0,0,-50000,0,0,0,0,50000,-50000,-50000
060759,南亞科元大9A購03,0,0,0,0,0,0,0,0,0,-50000,0,0,0,68000,118000,-50000,-50000
062619,台表科元大9B購03,0,0,0,0,0,0,0,0,0,-50000,0,0,0,60000,110000,-50000,-50000
063020,奇力新元大9B購04,0,0,0,0,0,0,0,0,0,-50000,0,0,0,0,50000,-50000,-50000
062207,牧德國票9B購02  ,0,0,0,0,0,0,0,0,0,-50000,0,0,0,0,50000,-50000,-50000
06208P,台郡凱基97售03  ,0,0,0,0,0,0,0,0,0,-50000,0,0,0,0,50000,-50000,-50000
062494,中石化中信9C購01,0,0,0,0,0,0,0,0,0,-50000,0,0,0,0,50000,-50000,-50000
062501,台積電群益9C購03,0,0,0,0,0,0,0,0,0,-50000,0,0,0,109000,159000,-50000,-50000
8422,可寧衛          ,48000,122000,-74000,0,0,0,0,0,0,24000,24000,0,24000,0,0,0,-50000
07342P,大立光凱基99售14,0,0,0,0,0,0,0,0,0,-51000,0,0,0,0,51000,-51000,-51000
07415P,台積電元大99售52,0,0,0,0,0,0,0,0,0,-51000,0,0,0,1000,52000,-51000,-51000
07494P,葡萄王元大9A售03,0,0,0,0,0,0,0,0,0,-51000,0,0,0,9000,60000,-51000,-51000
2417,圓剛            ,794000,942000,-148000,0,0,0,100000,0,100000,-3000,2000,5000,-3000,0,0,0,-51000
063539,世紀鋼統一9B購02,0,0,0,0,0,0,0,0,0,-51000,0,0,0,0,51000,-51000,-51000
063553,同欣電國票9B購03,0,0,0,0,0,0,0,0,0,-51000,0,0,0,40000,91000,-51000,-51000
055586,旺宏元大98購06  ,0,0,0,0,0,0,0,0,0,-51000,0,0,0,118000,169000,-51000,-51000
054528,台光電統一96購02,0,0,0,0,0,0,0,0,0,-51000,0,0,0,80000,131000,-51000,-51000
054258,牧德元大97購01  ,0,0,0,0,0,0,0,0,0,-51000,0,0,0,0,51000,-51000,-51000
059762,禾伸堂永豐99購02,0,0,0,0,0,0,0,0,0,-51000,0,0,0,0,51000,-51000,-51000
057198,智伸科統一9B購01,0,0,0,0,0,0,0,0,0,-51000,0,0,0,0,51000,-51000,-51000
058997,鴻海元大99購21  ,0,0,0,0,0,0,0,0,0,-51000,0,0,0,2000,53000,-51000,-51000
056996,矽力日盛99購01  ,0,0,0,0,0,0,0,0,0,-51000,0,0,0,112000,163000,-51000,-51000
057367,技嘉元大98購02  ,0,0,0,0,0,0,0,0,0,-51000,0,0,0,64000,115000,-51000,-51000
060045,嘉晶群益99購02  ,0,0,0,0,0,0,0,0,0,-51000,0,0,0,69000,120000,-51000,-51000
062150,南六國票9B購01  ,0,0,0,0,0,0,0,0,0,-51000,0,0,0,79000,130000,-51000,-51000
063123,聯發科元大9B購16,0,0,0,0,0,0,0,0,0,-51000,0,0,0,45000,96000,-51000,-51000
062878,宏達電兆豐9B購01,0,0,0,0,0,0,0,0,0,-51000,0,0,0,0,51000,-51000,-51000
060683,泰鼎元大9A購02  ,0,0,0,0,0,0,0,0,0,-51000,0,0,0,0,51000,-51000,-51000
061870,智邦元大9B購02  ,0,0,0,0,0,0,0,0,0,-51000,0,0,0,66000,117000,-51000,-51000
061430,致新元大9A購01  ,0,0,0,0,0,0,0,0,0,-51000,0,0,0,0,51000,-51000,-51000
4942,嘉彰            ,54000,130000,-76000,0,0,0,0,0,0,25000,25000,0,25000,0,0,0,-51000
063780,高鐵永豐9B購02  ,0,0,0,0,0,0,0,0,0,-52000,0,0,0,13000,65000,-52000,-52000
063871,瀚宇博永豐9C購01,0,0,0,0,0,0,0,0,0,-52000,0,0,0,0,52000,-52000,-52000
1414,東和            ,26000,80000,-54000,0,0,0,0,0,0,2000,2000,0,2000,0,0,0,-52000
059072,元油2X元大9C購13,0,0,0,0,0,0,0,0,0,-52000,0,0,0,20000,72000,-52000,-52000
056256,聯茂元富97購03  ,0,0,0,0,0,0,0,0,0,-52000,0,0,0,0,52000,-52000,-52000
060187,華新科元富9A購02,0,0,0,0,0,0,0,0,0,-52000,0,0,0,48000,100000,-52000,-52000
058403,玉晶光元大99購12,0,0,0,0,0,0,0,0,0,-52000,0,0,0,110000,162000,-52000,-52000
058639,南電兆豐99購01  ,0,0,0,0,0,0,0,0,0,-52000,0,0,0,58000,110000,-52000,-52000
061358,世紀鋼元大9A購04,0,0,0,0,0,0,0,0,0,-52000,0,0,0,23000,75000,-52000,-52000
061014,台積電麥證9A購04,0,0,0,0,52000,-52000,0,0,0,-52000,0,0,0,0,52000,-52000,-52000
062861,世芯國票9C購01  ,0,0,0,0,0,0,0,0,0,-52000,0,0,0,90000,142000,-52000,-52000
062914,嘉澤元大9B購02  ,0,0,0,0,0,0,0,0,0,-52000,0,0,0,17000,69000,-52000,-52000
062110,華擎國票9B購01  ,0,0,0,0,0,0,0,0,0,-52000,0,0,0,20000,72000,-52000,-52000
5546,永固-KY         ,51000,103000,-52000,0,0,0,0,0,0,0,0,0,0,0,0,0,-52000
063978,美食兆豐9C購01  ,0,0,0,0,0,0,0,0,0,-53000,0,0,0,0,53000,-53000,-53000
06677P,牧德國票98售02  ,0,0,0,0,0,0,0,0,0,-53000,0,0,0,84000,137000,-53000,-53000
063707,儒鴻凱基9C購01  ,0,0,0,0,0,0,0,0,0,-53000,0,0,0,0,53000,-53000,-53000
063645,瑞儀元大9B購02  ,0,0,0,0,0,0,0,0,0,-53000,0,0,0,67000,120000,-53000,-53000
063482,緯穎元大9B購09  ,0,0,0,0,0,0,0,0,0,-53000,0,0,0,25000,78000,-53000,-53000
059096,百和元大99購04  ,0,0,0,0,0,0,0,0,0,-53000,0,0,0,20000,73000,-53000,-53000
053293,聯發科中信9B購01,0,0,0,0,0,0,0,0,0,-53000,0,0,0,67000,120000,-53000,-53000
058652,SGBR2X中信01購01,0,0,0,0,0,0,0,0,0,-53000,0,0,0,0,53000,-53000,-53000
060188,華新科元富9A購03,0,0,0,0,0,0,0,0,0,-53000,0,0,0,71000,124000,-53000,-53000
059955,美食康和99購01  ,0,0,0,0,0,0,0,0,0,-53000,0,0,0,0,53000,-53000,-53000
058134,信邦元大99購01  ,1000,0,1000,0,0,0,0,0,0,-54000,0,0,0,103000,157000,-54000,-53000
056958,喬山永豐98購01  ,0,0,0,0,0,0,0,0,0,-53000,0,0,0,0,53000,-53000,-53000
062319,南六凱基9B購02  ,0,0,0,0,0,0,0,0,0,-53000,0,0,0,108000,161000,-53000,-53000
062849,中興電永豐9B購02,0,0,0,0,0,0,0,0,0,-53000,0,0,0,2000,55000,-53000,-53000
062867,東元中信9B購01  ,0,0,0,0,0,0,0,0,0,-53000,0,0,0,100000,153000,-53000,-53000
062644,中環國泰9C購01  ,0,0,0,0,0,0,0,0,0,-53000,0,0,0,7000,60000,-53000,-53000
061109,臻鼎元大9A購03  ,0,0,0,0,0,0,0,0,0,-53000,0,0,0,116000,169000,-53000,-53000
063381,和潤永豐9B購01  ,0,0,0,0,0,0,0,0,0,-54000,0,0,0,3000,57000,-54000,-54000
06705P,臻鼎元富98售03  ,0,0,0,0,0,0,0,0,0,-54000,0,0,0,5000,59000,-54000,-54000
07013P,玉晶光群益9A售06,0,0,0,0,0,0,0,0,0,-54000,0,0,0,0,54000,-54000,-54000
07764P,世紀鋼永豐9A售04,0,0,0,0,0,0,0,0,0,-54000,0,0,0,0,54000,-54000,-54000
08026P,臺股指凱基9B售12,0,0,0,0,0,0,0,0,0,-54000,0,0,0,214000,268000,-54000,-54000
08112P,臺股指中信01售07,0,0,0,0,0,0,0,0,0,-54000,0,0,0,0,54000,-54000,-54000
048383,元金2X國票99購01,0,0,0,0,0,0,0,0,0,-54000,0,0,0,184000,238000,-54000,-54000
053965,聯電元大98購04  ,0,0,0,0,0,0,0,0,0,-54000,0,0,0,68000,122000,-54000,-54000
059359,精元永豐99購01  ,0,0,0,0,0,0,0,0,0,-54000,0,0,0,10000,64000,-54000,-54000
056267,文曄統一97購02  ,0,0,0,0,0,0,0,0,0,-54000,0,0,0,66000,120000,-54000,-54000
060249,正文元大9C購01  ,0,0,0,0,0,0,0,0,0,-54000,0,0,0,10000,64000,-54000,-54000
058618,南電元大99購02  ,0,0,0,0,0,0,0,0,0,-54000,0,0,0,4000,58000,-54000,-54000
058577,南亞科群益99購02,0,0,0,0,0,0,0,0,0,-54000,0,0,0,85000,139000,-54000,-54000
062651,世紀鋼富邦9C購01,0,0,0,0,0,0,0,0,0,-54000,0,0,0,100000,154000,-54000,-54000
062733,巨大凱基9B購01  ,0,0,0,0,0,0,0,0,0,-54000,0,0,0,4000,58000,-54000,-54000
063041,貿聯凱基9B購01  ,0,0,0,0,0,0,0,0,0,-54000,0,0,0,5000,59000,-54000,-54000
062971,英業達元富9B購01,0,0,0,0,0,0,0,0,0,-54000,0,0,0,141000,195000,-54000,-54000
062106,華邦電國票9B購02,0,0,0,0,0,0,0,0,0,-54000,0,0,0,107000,161000,-54000,-54000
062005,旺宏國泰01購01  ,0,0,0,0,0,0,0,0,0,-54000,0,0,0,6000,60000,-54000,-54000
3588,通嘉            ,142000,196000,-54000,0,0,0,0,0,0,0,0,0,0,0,0,0,-54000
08159P,日月光元富9B售01,0,0,0,0,0,0,0,0,0,-55000,0,0,0,0,55000,-55000,-55000
07803P,南亞科永豐9A售02,0,0,0,0,0,0,0,0,0,-55000,0,0,0,5000,60000,-55000,-55000
07559P,祥碩元大9A售03  ,0,0,0,0,0,0,0,0,0,-55000,0,0,0,3000,58000,-55000,-55000
07518P,臺股指元大9B售09,0,0,0,0,0,0,0,0,0,-55000,0,0,0,0,55000,-55000,-55000
07333P,台灣50國票9B售03,0,0,0,0,0,0,0,0,0,-55000,0,0,0,0,55000,-55000,-55000
063331,瑞儀國票9C購01  ,0,0,0,0,0,0,0,0,0,-55000,0,0,0,9000,64000,-55000,-55000
063518,儒鴻凱基9B購02  ,0,0,0,0,0,0,0,0,0,-55000,0,0,0,4000,59000,-55000,-55000
056179,康友元富97購02  ,0,0,0,0,0,0,0,0,0,-55000,0,0,0,0,55000,-55000,-55000
056596,光磊元富98購01  ,0,0,0,0,0,0,0,0,0,-55000,0,0,0,60000,115000,-55000,-55000
059533,富邦金凱基99購01,0,0,0,0,0,0,0,0,0,-55000,0,0,0,0,55000,-55000,-55000
059195,國巨永豐99購04  ,0,0,0,0,0,0,0,0,0,-55000,0,0,0,10000,65000,-55000,-55000
056488,致新元大99購01  ,0,0,0,0,0,0,0,0,0,-55000,0,0,0,22000,77000,-55000,-55000
053826,光磊麥證97購01  ,0,0,0,0,55000,-55000,0,0,0,-55000,0,0,0,0,55000,-55000,-55000
057777,可成群益9A購03  ,0,0,0,0,0,0,0,0,0,-55000,0,0,0,5000,60000,-55000,-55000
060926,宏達電永豐9A購01,0,0,0,0,0,0,0,0,0,-55000,0,0,0,0,55000,-55000,-55000
060022,勤誠康和99購01  ,0,0,0,0,0,0,0,0,0,-55000,0,0,0,0,55000,-55000,-55000
058807,和大統一9B購01  ,0,0,0,0,0,0,0,0,0,-55000,0,0,0,50000,105000,-55000,-55000
062280,大立光群益9C購01,0,0,0,0,0,0,0,0,0,-55000,0,0,0,1000,56000,-55000,-55000
062580,華通統一9C購03  ,0,0,0,0,0,0,0,0,0,-55000,0,0,0,0,55000,-55000,-55000
062672,兆豐金中信03購01,0,0,0,0,0,0,0,0,0,-55000,0,0,0,112000,167000,-55000,-55000
062592,牧德統一01購01  ,0,0,0,0,0,0,0,0,0,-55000,0,0,0,2000,57000,-55000,-55000
062769,臺股指凱基9B購13,0,0,0,0,0,0,0,0,0,-55000,0,0,0,0,55000,-55000,-55000
06183P,大立光元大97售05,0,0,0,0,0,0,0,0,0,-55000,0,0,0,5000,60000,-55000,-55000
063394,金像電群益9B購01,0,0,0,0,0,0,0,0,0,-56000,0,0,0,0,56000,-56000,-56000
052654,友達統一97購01  ,0,0,0,0,0,0,0,0,0,-56000,0,0,0,347000,403000,-56000,-56000
055657,超眾元富97購02  ,0,0,0,0,0,0,0,0,0,-56000,0,0,0,373000,429000,-56000,-56000
059074,元油2X元大9C購15,0,0,0,0,0,0,0,0,0,-56000,0,0,0,52000,108000,-56000,-56000
057161,亞德客元大98購02,0,0,0,0,0,0,0,0,0,-56000,0,0,0,96000,152000,-56000,-56000
058887,元石油元大9C購04,0,0,0,0,0,0,0,0,0,-56000,0,0,0,0,56000,-56000,-56000
058012,鈺齊國票99購01  ,0,0,0,0,0,0,0,0,0,-56000,0,0,0,38000,94000,-56000,-56000
056816,華通永豐98購02  ,0,0,0,0,0,0,0,0,0,-56000,0,0,0,0,56000,-56000,-56000
057512,華邦電台新98購01,0,0,0,0,0,0,0,0,0,-56000,0,0,0,145000,201000,-56000,-56000
060166,佐登永豐9A購01  ,0,0,0,0,0,0,0,0,0,-56000,0,0,0,32000,88000,-56000,-56000
057575,世紀鋼永豐98購02,0,0,0,0,0,0,0,0,0,-56000,0,0,0,138000,194000,-56000,-56000
058389,聯茂國票9A購01  ,0,0,0,0,0,0,0,0,0,-56000,0,0,0,17000,73000,-56000,-56000
05873P,華通群益97售02  ,0,0,0,0,0,0,0,0,0,-56000,0,0,0,24000,80000,-56000,-56000
061471,台積電元大9A購31,0,0,0,0,0,0,0,0,0,-56000,0,0,0,35000,91000,-56000,-56000
063129,祥碩元大9C購03  ,0,0,0,0,0,0,0,0,0,-56000,0,0,0,0,56000,-56000,-56000
063224,泰鼎群益9B購02  ,0,0,0,0,0,0,0,0,0,-56000,0,0,0,7000,63000,-56000,-56000
062340,力成麥證9B購01  ,0,0,0,95000,151000,-56000,0,0,0,-56000,0,0,0,95000,151000,-56000,-56000
07035P,大立光元富99售04,0,0,0,0,0,0,0,0,0,-57000,0,0,0,12000,69000,-57000,-57000
07999P,台達電凱基9B售02,0,0,0,0,0,0,0,0,0,-57000,0,0,0,63000,120000,-57000,-57000
2380,虹光            ,43000,100000,-57000,0,0,0,0,0,0,0,0,0,0,0,0,0,-57000
059047,元油2X凱基9A購10,0,0,0,0,0,0,0,0,0,-57000,0,0,0,260000,317000,-57000,-57000
056119,欣興群益97購02  ,0,0,0,0,0,0,0,0,0,-57000,0,0,0,18000,75000,-57000,-57000
054170,泰鼎凱基98購01  ,0,0,0,0,0,0,0,0,0,-57000,0,0,0,10000,67000,-57000,-57000
03686P,大立光統一98售02,0,0,0,0,0,0,0,0,0,-57000,0,0,0,0,57000,-57000,-57000
060422,台勝科永豐9A購01,0,0,0,0,0,0,0,0,0,-57000,0,0,0,167000,224000,-57000,-57000
059999,緯穎元富99購01  ,0,0,0,0,0,0,0,0,0,-57000,0,0,0,34000,91000,-57000,-57000
062372,旭富元大9B購01  ,0,0,0,0,0,0,0,0,0,-57000,0,0,0,87000,144000,-57000,-57000
062533,嘉澤統一9C購01  ,0,0,0,0,0,0,0,0,0,-57000,0,0,0,0,57000,-57000,-57000
063169,台汽電永豐9B購01,0,0,0,0,0,0,0,0,0,-57000,0,0,0,0,57000,-57000,-57000
062706,大立光元大9B購06,0,0,0,0,0,0,0,0,0,-57000,0,0,0,0,57000,-57000,-57000
061145,臻鼎中信9A購02  ,0,0,0,0,0,0,0,0,0,-57000,0,0,0,201000,258000,-57000,-57000
060562,旺宏富邦9C購02  ,0,0,0,0,0,0,0,0,0,-57000,0,0,0,80000,137000,-57000,-57000
00654R,富邦印度反1     ,70000,132000,-62000,0,0,0,0,0,0,4955,0,0,0,88000,83045,4955,-57045
063488,金像電國泰01購01,0,0,0,0,0,0,0,0,0,-58000,0,0,0,37000,95000,-58000,-58000
054134,強茂元大96購01  ,0,0,0,0,0,0,0,0,0,-58000,0,0,0,420000,478000,-58000,-58000
056191,世紀鋼統一97購01,0,0,0,0,0,0,0,0,0,-58000,0,0,0,0,58000,-58000,-58000
059883,T50反1國票99購02,0,0,0,0,0,0,0,0,0,-58000,0,0,0,0,58000,-58000,-58000
059732,超眾元大9A購01  ,0,0,0,0,0,0,0,0,0,-58000,0,0,0,29000,87000,-58000,-58000
057134,茂林凱基98購02  ,0,0,0,0,0,0,0,0,0,-58000,0,0,0,0,58000,-58000,-58000
060157,致茂永豐9A購02  ,0,0,0,0,0,0,0,0,0,-58000,0,0,0,68000,126000,-58000,-58000
058637,晶技兆豐99購01  ,0,0,0,0,0,0,0,0,0,-58000,0,0,0,12000,70000,-58000,-58000
05773P,臺股指凱基99售03,0,0,0,0,0,0,0,0,0,-58000,100000,0,100000,998000,1156000,-158000,-58000
060792,信錦永豐9A購01  ,0,0,0,0,0,0,0,0,0,-58000,0,0,0,0,58000,-58000,-58000
060916,金像電國泰9C購01,0,0,0,0,0,0,0,0,0,-58000,0,0,0,215000,273000,-58000,-58000
061898,茂林永豐9B購01  ,0,0,0,0,0,0,0,0,0,-58000,0,0,0,0,58000,-58000,-58000
062286,台郡群益9B購01  ,0,0,0,0,0,0,0,0,0,-58000,0,0,0,72000,130000,-58000,-58000
3702A,大聯大甲特      ,0,4000,-4000,0,0,0,0,0,0,-54000,12000,66000,-54000,0,0,0,-58000
063294,美律麥證9B購01  ,0,0,0,26000,85000,-59000,0,0,0,-59000,0,0,0,26000,85000,-59000,-59000
2509,全坤建          ,4000,66000,-62000,0,0,0,0,0,0,3000,3000,0,3000,0,0,0,-59000
07292P,臺股指凱基99售44,0,0,0,0,0,0,0,0,0,-59000,0,0,0,45000,104000,-59000,-59000
056174,億光元富97購01  ,0,0,0,0,0,0,0,0,0,-59000,0,0,0,55000,114000,-59000,-59000
056642,旺宏凱基98購07  ,0,0,0,0,0,0,0,0,0,-59000,0,0,0,2000,61000,-59000,-59000
055902,同欣電中信99購01,0,0,0,0,0,0,0,0,0,-59000,0,0,0,177000,236000,-59000,-59000
056486,樺漢元大98購04  ,0,0,0,0,0,0,0,0,0,-59000,0,0,0,123000,182000,-59000,-59000
058656,燿華中信99購01  ,0,0,0,0,0,0,0,0,0,-59000,0,0,0,109000,168000,-59000,-59000
062105,國巨國票9C購03  ,0,0,0,0,0,0,0,0,0,-59000,0,0,0,56000,115000,-59000,-59000
063043,台灣50兆豐9B購02,0,0,0,0,0,0,0,0,0,-59000,0,0,0,2064000,2123000,-59000,-59000
061903,宏全永豐9B購01  ,0,0,0,0,0,0,0,0,0,-59000,0,0,0,0,59000,-59000,-59000
061595,智易永豐9A購02  ,0,0,0,0,0,0,0,0,0,-59000,0,0,0,68000,127000,-59000,-59000
060667,力成凱基9A購01  ,0,0,0,0,0,0,0,0,0,-59000,0,0,0,33000,92000,-59000,-59000
07490P,大立光國票9A售03,0,0,0,0,0,0,0,0,0,-60000,0,0,0,0,60000,-60000,-60000
07410P,鴻海元大99售44  ,0,0,0,0,0,0,0,0,0,-60000,0,0,0,10000,70000,-60000,-60000
07451P,鴻海元大9B售01  ,0,0,0,0,0,0,0,0,0,-60000,0,0,0,0,60000,-60000,-60000
07705P,台積電元大9A售26,0,0,0,0,0,0,0,0,0,-60000,0,0,0,0,60000,-60000,-60000
07707P,玉山金元大9A售03,0,0,0,0,0,0,0,0,0,-60000,0,0,0,0,60000,-60000,-60000
07702P,台積電中信9A售06,0,0,0,0,0,0,0,0,0,-60000,0,0,0,0,60000,-60000,-60000
08004P,大毅永豐9B售02  ,0,0,0,0,0,0,0,0,0,-60000,0,0,0,10000,70000,-60000,-60000
07856P,力成凱基9A售02  ,0,0,0,0,0,0,0,0,0,-60000,0,0,0,10000,70000,-60000,-60000
07841P,臻鼎元大9A售04  ,0,0,0,0,0,0,0,0,0,-60000,0,0,0,15000,75000,-60000,-60000
063491,國巨富邦02購02  ,0,0,0,0,0,0,0,0,0,-60000,0,0,0,0,60000,-60000,-60000
063652,國泰金台新9B購01,0,0,0,0,0,0,0,0,0,-60000,0,0,0,0,60000,-60000,-60000
06937P,GIS元大98售03   ,0,0,0,0,0,0,0,0,0,-60000,0,0,0,40000,100000,-60000,-60000
06967P,台郡台新99售02  ,0,0,0,0,0,0,0,0,0,-60000,0,0,0,0,60000,-60000,-60000
055584,國巨元大97購11  ,0,0,0,0,0,0,0,0,0,-60000,0,0,0,0,60000,-60000,-60000
054842,台達電兆豐98購01,0,0,0,0,0,0,0,0,0,-60000,0,0,0,0,60000,-60000,-60000
054750,聯茂凱基98購02  ,0,0,0,0,0,0,0,0,0,-60000,0,0,0,0,60000,-60000,-60000
055205,京鼎中信99購01  ,0,0,0,0,0,0,0,0,0,-60000,0,0,0,0,60000,-60000,-60000
056215,華新科國票97購03,0,0,0,0,0,0,0,0,0,-60000,0,0,0,0,60000,-60000,-60000
056304,創意元大97購03  ,0,0,0,0,0,0,0,0,0,-60000,0,0,0,0,60000,-60000,-60000
059571,奇力新凱基99購06,0,0,0,0,0,0,0,0,0,-60000,0,0,0,0,60000,-60000,-60000
055885,大成鋼統一97購02,0,0,0,0,0,0,0,0,0,-60000,0,0,0,0,60000,-60000,-60000
059114,華新科永豐99購05,0,0,0,0,0,0,0,0,0,-60000,0,0,0,0,60000,-60000,-60000
05052P,友達群益97售01  ,0,0,0,0,0,0,0,0,0,-60000,0,0,0,0,60000,-60000,-60000
046191,新光金凱基98購01,0,0,0,0,0,0,0,0,0,-60000,0,0,0,0,60000,-60000,-60000
052911,友達統一97購02  ,0,0,0,0,0,0,0,0,0,-60000,0,0,0,0,60000,-60000,-60000
055531,華新科群益98購03,0,0,0,0,0,0,0,0,0,-60000,0,0,0,20000,80000,-60000,-60000
056314,力成元大97購01  ,0,0,0,0,0,0,0,0,0,-60000,0,0,0,10000,70000,-60000,-60000
057793,群創統一99購02  ,0,0,0,0,0,0,0,0,0,-60000,0,0,0,0,60000,-60000,-60000
057482,微星元大98購03  ,0,0,0,0,0,0,0,0,0,-60000,0,0,0,0,60000,-60000,-60000
060098,華新科元大99購24,0,0,0,0,0,0,0,0,0,-60000,0,0,0,3000,63000,-60000,-60000
058963,華新科兆豐99購05,0,0,0,0,0,0,0,0,0,-60000,0,0,0,0,60000,-60000,-60000
057258,中環兆豐98購01  ,0,0,0,0,0,0,0,0,0,-60000,0,0,0,0,60000,-60000,-60000
056921,京元電兆豐98購01,0,0,0,0,0,0,0,0,0,-60000,0,0,0,16000,76000,-60000,-60000
057623,友訊國泰99購01  ,0,0,0,0,0,0,0,0,0,-60000,0,0,0,0,60000,-60000,-60000
057355,彩晶統一98購03  ,0,0,0,0,0,0,0,0,0,-60000,0,0,0,5000,65000,-60000,-60000
061624,中租群益9A購01  ,0,1000,-1000,0,0,0,0,0,0,-59000,0,0,0,1000,60000,-59000,-60000
063047,大立光兆豐9B購03,0,0,0,0,0,0,0,0,0,-60000,0,0,0,21000,81000,-60000,-60000
062939,奇力新凱基9B購02,0,0,0,0,0,0,0,0,0,-60000,0,0,0,0,60000,-60000,-60000
062735,和大國票9B購01  ,0,0,0,0,0,0,0,0,0,-60000,0,0,0,0,60000,-60000,-60000
062624,大成鋼國票9B購02,0,0,0,0,0,0,0,0,0,-60000,0,0,0,0,60000,-60000,-60000
062041,華擎凱基9C購01  ,0,0,0,0,0,0,0,0,0,-60000,0,0,0,23000,83000,-60000,-60000
061977,國巨元大9B購02  ,0,0,0,0,0,0,0,0,0,-60000,0,0,0,0,60000,-60000,-60000
4943,康控-KY         ,223000,282000,-59000,0,0,0,0,0,0,-1000,26000,0,26000,31000,58000,-27000,-60000
06737P,台郡凱基98售07  ,0,0,0,0,0,0,0,0,0,-61000,0,0,0,0,61000,-61000,-61000
063779,華邦電永豐9B購01,0,0,0,0,0,0,0,0,0,-61000,0,0,0,14000,75000,-61000,-61000
063233,國巨元大9B購19  ,0,0,0,0,0,0,0,0,0,-61000,0,0,0,25000,86000,-61000,-61000
063236,旺宏元大9B購07  ,0,0,0,0,0,0,0,0,0,-61000,0,0,0,3000,64000,-61000,-61000
07975P,國巨元大9B售15  ,0,0,0,0,0,0,0,0,0,-61000,0,0,0,7000,68000,-61000,-61000
1712,興農            ,180000,244000,-64000,0,0,0,0,0,0,3000,3000,0,3000,0,0,0,-61000
056354,國巨元大98購10  ,0,0,0,0,0,0,0,0,0,-61000,0,0,0,0,61000,-61000,-61000
03432B,臺股指凱基98熊13,0,0,0,0,0,0,0,0,0,-61000,0,0,0,0,61000,-61000,-61000
055805,矽力永豐97購01  ,0,0,0,0,0,0,0,0,0,-61000,0,0,0,49000,110000,-61000,-61000
056622,高鐵永豐98購01  ,0,0,0,0,0,0,0,0,0,-61000,0,0,0,7000,68000,-61000,-61000
055301,台虹元大97購01  ,0,0,0,0,0,0,0,0,0,-61000,0,0,0,50000,111000,-61000,-61000
057369,奇力新元大99購05,0,0,0,0,0,0,0,0,0,-61000,0,0,0,39000,100000,-61000,-61000
056743,貿聯凱基98購04  ,0,0,0,0,0,0,0,0,0,-61000,0,0,0,0,61000,-61000,-61000
060115,南電元大99購06  ,0,0,0,0,0,0,0,0,0,-61000,0,0,0,0,61000,-61000,-61000
060964,日月光凱基9A購01,0,0,0,0,0,0,0,0,0,-61000,0,0,0,255000,316000,-61000,-61000
062141,遠東新國票9B購01,0,0,0,0,0,0,0,0,0,-61000,0,0,0,0,61000,-61000,-61000
062473,同欣電凱基9B購01,0,0,0,0,0,0,0,0,0,-61000,0,0,0,20000,81000,-61000,-61000
06190P,玉晶光永豐97售05,0,0,0,0,0,0,0,0,0,-61000,0,0,0,0,61000,-61000,-61000
060721,瑞儀永豐9A購01  ,0,0,0,0,0,0,0,0,0,-61000,0,0,0,143000,204000,-61000,-61000
07895P,美律元大9B售01  ,0,0,0,0,0,0,0,0,0,-62000,0,0,0,0,62000,-62000,-62000
07424P,大立光元大9B售01,0,0,0,0,0,0,0,0,0,-62000,0,0,0,0,62000,-62000,-62000
056289,合勤控永豐97購01,0,0,0,0,0,0,0,0,0,-62000,0,0,0,0,62000,-62000,-62000
056163,嘉聯益凱基98購03,0,0,0,0,0,0,0,0,0,-62000,0,0,0,0,62000,-62000,-62000
00680L,元大美債20正2   ,24000,0,24000,0,0,0,0,0,0,-86000,0,0,0,0,86000,-86000,-62000
03840P,台積電統一99售02,0,0,0,0,0,0,0,0,0,-62000,0,0,0,0,62000,-62000,-62000
055432,臻鼎群益97購02  ,0,0,0,0,0,0,0,0,0,-62000,0,0,0,38000,100000,-62000,-62000
060208,卜蜂康和9A購01  ,0,0,0,0,0,0,0,0,0,-62000,0,0,0,89000,151000,-62000,-62000
060453,儒鴻元大9A購02  ,0,0,0,0,0,0,0,0,0,-62000,0,0,0,198000,260000,-62000,-62000
059938,凱美永豐99購01  ,0,0,0,0,0,0,0,0,0,-62000,0,0,0,23000,85000,-62000,-62000
057150,貿聯國票99購02  ,0,0,0,0,0,0,0,0,0,-62000,0,0,0,0,62000,-62000,-62000
060815,茂林凱基9B購01  ,0,0,0,0,0,0,0,0,0,-62000,0,0,0,0,62000,-62000,-62000
061350,牧德元大9B購03  ,0,0,0,0,0,0,0,0,0,-62000,0,0,0,22000,84000,-62000,-62000
062291,力成富邦9B購01  ,0,0,0,0,0,0,0,0,0,-62000,0,0,0,0,62000,-62000,-62000
08202P,台表科國泰01售04,0,0,0,0,0,0,0,0,0,-63000,0,0,0,0,63000,-63000,-63000
063408,茂林國票9C購02  ,0,0,0,0,0,0,0,0,0,-63000,0,0,0,8000,71000,-63000,-63000
063969,晶豪科國票01購01,0,0,0,0,0,0,0,0,0,-63000,0,0,0,0,63000,-63000,-63000
06878P,台灣50日盛9B售01,0,0,0,0,0,0,0,0,0,-63000,0,0,0,25000,88000,-63000,-63000
055380,智易元大98購02  ,0,0,0,0,0,0,0,0,0,-63000,0,0,0,0,63000,-63000,-63000
055533,大立光群益97購03,0,0,0,0,0,0,0,0,0,-63000,0,0,0,16000,79000,-63000,-63000
056058,建準元大97購02  ,0,0,0,0,0,0,0,0,0,-63000,0,0,0,0,63000,-63000,-63000
055136,聯發科富邦99購06,0,0,0,0,0,0,0,0,0,-63000,0,0,0,0,63000,-63000,-63000
057084,立積統一9B購01  ,0,0,0,0,0,0,0,0,0,-63000,0,0,0,62000,125000,-63000,-63000
061800,泰鼎永豐9B購01  ,0,0,0,0,0,0,0,0,0,-63000,0,0,0,0,63000,-63000,-63000
061646,力成元大9A購02  ,0,0,0,0,0,0,0,0,0,-63000,0,0,0,165000,228000,-63000,-63000
4720,德淵            ,42000,105000,-63000,0,0,0,0,0,0,0,0,0,0,0,0,0,-63000
055323,貿聯國票98購01  ,0,0,0,0,0,0,0,0,0,-64000,0,0,0,38000,102000,-64000,-64000
054523,GIS元大96購05   ,0,0,0,0,0,0,0,0,0,-64000,0,0,0,51000,115000,-64000,-64000
056232,瑞儀凱基98購01  ,0,0,0,0,0,0,0,0,0,-64000,0,0,0,51000,115000,-64000,-64000
05579P,友達凱基98售03  ,0,0,0,0,0,0,0,0,0,-64000,0,0,0,0,64000,-64000,-64000
00656R,國泰中國A50反1  ,0,0,0,0,0,0,0,0,0,-64000,0,0,0,180000,244000,-64000,-64000
046937,聯電元大99購01  ,0,0,0,0,0,0,0,0,0,-64000,0,0,0,0,64000,-64000,-64000
056940,嘉聯益元富98購01,0,0,0,0,0,0,0,0,0,-64000,0,0,0,41000,105000,-64000,-64000
059743,開發金元富99購01,0,0,0,0,0,0,0,0,0,-64000,0,0,0,30000,94000,-64000,-64000
060209,喬山康和9A購01  ,0,0,0,0,0,0,0,0,0,-64000,0,0,0,0,64000,-64000,-64000
061817,高鐵群益9B購01  ,0,0,0,0,0,0,0,0,0,-64000,0,0,0,9000,73000,-64000,-64000
06083P,華通統一98售02  ,0,0,0,0,0,0,0,0,0,-64000,0,0,0,0,64000,-64000,-64000
061987,大立光元大9B購03,0,0,0,0,0,0,0,0,0,-64000,0,0,0,10000,74000,-64000,-64000
07106P,國巨統一9B售05  ,0,0,0,0,0,0,0,0,0,-65000,0,0,0,39000,104000,-65000,-65000
06481P,台積電凱基98售12,0,0,0,0,0,0,0,0,0,-65000,0,0,0,0,65000,-65000,-65000
06594P,立積元大98售01  ,0,0,0,0,0,0,0,0,0,-65000,0,0,0,32000,97000,-65000,-65000
07933P,大立光富邦9C售06,0,0,0,0,0,0,0,0,0,-65000,0,0,0,50000,115000,-65000,-65000
08153P,台表科統一9B售01,0,0,0,0,0,0,0,0,0,-65000,0,0,0,0,65000,-65000,-65000
053364,友達國泰98購01  ,0,0,0,0,0,0,0,0,0,-65000,0,0,0,0,65000,-65000,-65000
055858,聯茂元大97購03  ,0,0,0,0,0,0,0,0,0,-65000,0,0,0,56000,121000,-65000,-65000
056512,易華電永豐98購01,0,0,0,0,0,0,0,0,0,-65000,0,0,0,0,65000,-65000,-65000
054740,強茂凱基99購01  ,0,0,0,0,0,0,0,0,0,-65000,0,0,0,6000,71000,-65000,-65000
057445,華通元富02購01  ,0,0,0,0,0,0,0,0,0,-65000,0,0,0,46000,111000,-65000,-65000
057865,富邦金凱基98購01,0,0,0,0,0,0,0,0,0,-65000,0,0,0,0,65000,-65000,-65000
059757,上証2X永豐99購03,0,0,0,0,0,0,0,0,0,-65000,0,0,0,0,65000,-65000,-65000
062182,華新科元大9B購07,0,0,0,0,0,0,0,0,0,-65000,0,0,0,3000,68000,-65000,-65000
060793,微星永豐9A購01  ,0,0,0,0,0,0,0,0,0,-65000,0,0,0,37000,102000,-65000,-65000
060709,緯穎富邦9B購01  ,0,0,0,0,0,0,0,0,0,-65000,0,0,0,178000,243000,-65000,-65000
4739,康普            ,65000,130000,-65000,0,0,0,0,0,0,0,0,0,0,0,0,0,-65000
08145P,台灣50群益9B售11,0,0,0,0,0,0,0,0,0,-66000,0,0,0,90000,156000,-66000,-66000
08017P,華新科國票9B售01,0,0,0,0,0,0,0,0,0,-66000,0,0,0,31000,97000,-66000,-66000
06766P,玉晶光元大99售10,0,0,0,0,0,0,0,0,0,-66000,0,0,0,57000,123000,-66000,-66000
054408,義隆國票98購01  ,0,0,0,0,0,0,0,0,0,-66000,0,0,0,0,66000,-66000,-66000
056290,正文永豐98購01  ,0,0,0,0,0,0,0,0,0,-66000,0,0,0,0,66000,-66000,-66000
05620P,大立光富邦9B售01,0,0,0,0,0,0,0,0,0,-66000,0,0,0,0,66000,-66000,-66000
059116,晶豪科永豐99購01,0,0,0,0,0,0,0,0,0,-66000,0,0,0,0,66000,-66000,-66000
046061,中石化凱基98購01,0,0,0,0,0,0,0,0,0,-66000,0,0,0,29000,95000,-66000,-66000
056732,國巨凱基98購07  ,0,0,0,0,0,0,0,0,0,-66000,0,0,0,0,66000,-66000,-66000
057321,台泥群益98購01  ,0,0,0,0,0,0,0,0,0,-66000,0,0,0,34000,100000,-66000,-66000
058298,聯茂凱基99購05  ,0,0,0,0,0,0,0,0,0,-66000,0,0,0,0,66000,-66000,-66000
060450,南亞元大9A購02  ,0,0,0,0,0,0,0,0,0,-66000,0,0,0,65000,131000,-66000,-66000
061700,瑞昱國票9A購02  ,0,0,0,0,0,0,0,0,0,-66000,0,0,0,0,66000,-66000,-66000
062374,茂林元大9B購03  ,0,0,0,0,0,0,0,0,0,-66000,0,0,0,28000,94000,-66000,-66000
4967,十銓            ,688000,753000,-65000,0,0,0,0,0,0,-1000,1000,2000,-1000,0,0,0,-66000
06396P,新日興康和97售01,0,0,0,0,0,0,0,0,0,-67000,0,0,0,0,67000,-67000,-67000
063263,高鐵永豐9B購01  ,0,0,0,0,0,0,0,0,0,-67000,0,0,0,10000,77000,-67000,-67000
063818,矽創群益9C購01  ,0,0,0,0,0,0,0,0,0,-67000,0,0,0,22000,89000,-67000,-67000
053396,漢唐中信9A購01  ,0,0,0,0,0,0,0,0,0,-67000,0,0,0,0,67000,-67000,-67000
055365,華通元大97購03  ,0,0,0,0,0,0,0,0,0,-67000,0,0,0,23000,90000,-67000,-67000
060218,台積電凱基9A購15,0,0,0,0,0,0,0,0,0,-67000,0,0,0,34000,101000,-67000,-67000
058242,玉晶光元大9A購01,0,0,0,0,0,0,0,0,0,-67000,0,0,0,0,67000,-67000,-67000
058851,大立光群益99購07,0,0,0,0,0,0,0,0,0,-67000,0,0,0,47000,114000,-67000,-67000
057175,美律元大98購03  ,0,0,0,0,0,0,0,0,0,-67000,0,0,0,0,67000,-67000,-67000
058814,南亞科台新99購01,0,0,0,0,0,0,0,0,0,-67000,0,0,0,0,67000,-67000,-67000
062591,新日興統一9C購01,0,0,0,0,0,0,0,0,0,-67000,0,0,0,1076000,1143000,-67000,-67000
061985,富邦金元大9B購01,0,0,0,0,0,0,0,0,0,-67000,0,0,0,37000,104000,-67000,-67000
062822,力成兆豐9B購01  ,0,0,0,0,0,0,0,0,0,-67000,0,0,0,3000,70000,-67000,-67000
061583,矽創元大9A購01  ,0,0,0,0,0,0,0,0,0,-67000,0,0,0,140000,207000,-67000,-67000
061215,健策元大9A購06  ,0,0,0,0,0,0,0,0,0,-67000,0,0,0,63000,130000,-67000,-67000
063723,儒鴻元大9B購04  ,0,0,0,0,0,0,0,0,0,-68000,0,0,0,57000,125000,-68000,-68000
063286,嘉澤元大9B購04  ,0,0,0,0,0,0,0,0,0,-68000,0,0,0,10000,78000,-68000,-68000
063508,緯創群益9B購01  ,0,0,0,0,0,0,0,0,0,-68000,0,0,0,10000,78000,-68000,-68000
06868P,電子類元大99售01,0,0,0,0,0,0,0,0,0,-68000,0,0,0,0,68000,-68000,-68000
06862P,大立光凱基98售16,0,0,0,0,0,0,0,0,0,-68000,0,0,0,0,68000,-68000,-68000
053063,力山群益98購01  ,0,0,0,0,0,0,0,0,0,-68000,0,0,0,98000,166000,-68000,-68000
054411,光磊元大97購02  ,0,0,0,0,0,0,0,0,0,-68000,0,0,0,0,68000,-68000,-68000
054332,世芯永豐97購01  ,0,0,0,0,0,0,0,0,0,-68000,0,0,0,145000,213000,-68000,-68000
056472,美律元大99購03  ,0,0,0,0,0,0,0,0,0,-68000,0,0,0,0,68000,-68000,-68000
055302,達方元大97購01  ,0,0,0,0,0,0,0,0,0,-68000,0,0,0,0,68000,-68000,-68000
055230,大毅國票98購01  ,0,0,0,0,0,0,0,0,0,-68000,0,0,0,13000,81000,-68000,-68000
058826,台積電永豐99購02,0,0,0,0,0,0,0,0,0,-68000,0,0,0,0,68000,-68000,-68000
057147,新日興國票99購01,0,0,0,0,0,0,0,0,0,-68000,0,0,0,0,68000,-68000,-68000
059754,訊芯群益9A購01  ,0,0,0,0,0,0,0,0,0,-68000,0,0,0,43000,111000,-68000,-68000
058049,帆宣元大98購01  ,0,0,0,0,0,0,0,0,0,-68000,0,0,0,0,68000,-68000,-68000
056745,聯茂凱基99購03  ,0,0,0,0,0,0,0,0,0,-68000,0,0,0,10000,78000,-68000,-68000
057371,可成元大98購08  ,0,0,0,0,0,0,0,0,0,-68000,0,0,0,0,68000,-68000,-68000
057641,旺宏元大98購10  ,0,0,0,0,0,0,0,0,0,-68000,0,0,0,0,68000,-68000,-68000
057045,美律元大99購04  ,0,0,0,0,0,0,0,0,0,-68000,0,0,0,0,68000,-68000,-68000
056900,可成元大98購02  ,0,0,0,0,0,0,0,0,0,-68000,0,0,0,0,68000,-68000,-68000
056768,宏達電元大99購03,0,0,0,0,0,0,0,0,0,-68000,0,0,0,0,68000,-68000,-68000
057460,楠梓電永豐98購03,0,0,0,0,0,0,0,0,0,-68000,0,0,0,0,68000,-68000,-68000
060959,金像電凱基9A購01,0,0,0,0,0,0,0,0,0,-68000,0,0,0,14000,82000,-68000,-68000
060454,葡萄王元大9A購01,0,0,0,0,0,0,0,0,0,-68000,0,0,0,2000,70000,-68000,-68000
060462,鴻海元大9A購10  ,0,0,0,0,0,0,0,0,0,-68000,0,0,0,2000,70000,-68000,-68000
060347,大立光統一02購01,0,0,0,0,0,0,0,0,0,-68000,0,0,0,38000,106000,-68000,-68000
057874,可成元大99購02  ,0,0,0,0,0,0,0,0,0,-68000,0,0,0,0,68000,-68000,-68000
058555,矽創永豐9A購01  ,0,0,0,0,0,0,0,0,0,-68000,0,0,0,40000,108000,-68000,-68000
061876,明泰元大9B購01  ,0,0,0,0,0,0,0,0,0,-68000,0,0,0,0,68000,-68000,-68000
061878,茂林元大9B購01  ,0,0,0,0,0,0,0,0,0,-68000,0,0,0,14000,82000,-68000,-68000
062923,緯穎元大9B購06  ,0,0,0,0,0,0,0,0,0,-68000,0,0,0,0,68000,-68000,-68000
062621,緯穎元大9B購05  ,0,0,0,0,0,0,0,0,0,-68000,0,0,0,0,68000,-68000,-68000
062749,元金2X中信9B購01,0,0,0,0,0,0,0,0,0,-68000,0,0,0,0,68000,-68000,-68000
063091,聯電中信9B購01  ,0,0,0,0,0,0,0,0,0,-68000,0,0,0,114000,182000,-68000,-68000
063208,鈺齊統一9C購01  ,0,0,0,0,0,0,0,0,0,-68000,0,0,0,102000,170000,-68000,-68000
06701P,臺股指統一99售06,0,0,0,0,0,0,0,0,0,-69000,0,0,0,197000,266000,-69000,-69000
063442,金像電統一01購01,0,0,0,0,0,0,0,0,0,-69000,0,0,0,0,69000,-69000,-69000
063769,玉晶光國泰02購01,0,0,0,0,0,0,0,0,0,-69000,0,0,0,213000,282000,-69000,-69000
063577,台表科元大9C購04,0,0,0,0,0,0,0,0,0,-69000,0,0,0,3000,72000,-69000,-69000
08011P,玉晶光元大9B售05,0,0,0,0,0,0,0,0,0,-69000,0,0,0,275000,344000,-69000,-69000
055271,鴻海元大98購03  ,0,0,0,0,0,0,0,0,0,-69000,0,0,0,24000,93000,-69000,-69000
054467,隆達凱基97購01  ,0,0,0,0,0,0,0,0,0,-69000,0,0,0,91000,160000,-69000,-69000
057813,京元電元大98購03,0,0,0,0,0,0,0,0,0,-69000,0,0,0,461000,530000,-69000,-69000
060417,正隆永豐9A購01  ,0,0,0,0,0,0,0,0,0,-69000,0,0,0,26000,95000,-69000,-69000
060254,世紀鋼元大9A購01,0,0,0,0,0,0,0,0,0,-69000,0,0,0,0,69000,-69000,-69000
059956,玉山金康和99購01,0,0,0,0,0,0,0,0,0,-69000,0,0,0,146000,215000,-69000,-69000
056700,華新科國泰99購03,0,0,0,0,0,0,0,0,0,-69000,0,0,0,18000,87000,-69000,-69000
061611,南六統一01購01  ,0,0,0,0,0,0,0,0,0,-69000,0,0,0,167000,236000,-69000,-69000
060994,世芯元大9A購03  ,0,0,0,0,0,0,0,0,0,-69000,0,0,0,4000,73000,-69000,-69000
060906,旺宏元大9A購07  ,0,0,0,0,0,0,0,0,0,-69000,0,0,0,11000,80000,-69000,-69000
3031,佰鴻            ,72000,141000,-69000,0,0,0,0,0,0,0,2000,2000,0,0,0,0,-69000
07749P,台郡凱基9A售01  ,0,0,0,0,0,0,0,0,0,-70000,0,0,0,0,70000,-70000,-70000
08233P,國泰金元富9B售01,0,0,0,0,0,0,0,0,0,-70000,0,0,0,0,70000,-70000,-70000
08259P,華新科元大9C售04,0,0,0,0,0,0,0,0,0,-70000,0,0,0,0,70000,-70000,-70000
063580,立積國泰9C購01  ,0,0,0,0,0,0,0,0,0,-70000,0,0,0,0,70000,-70000,-70000
063542,泰鼎元富9B購02  ,0,0,0,0,0,0,0,0,0,-70000,0,0,0,3000,73000,-70000,-70000
063403,鈺齊群益9B購01  ,0,0,0,0,0,0,0,0,0,-70000,0,0,0,0,70000,-70000,-70000
06611P,祥碩國票98售01  ,0,0,0,0,0,0,0,0,0,-70000,0,0,0,0,70000,-70000,-70000
07031P,台灣50中信03售02,0,0,0,0,0,0,0,0,0,-70000,0,0,0,0,70000,-70000,-70000
07150P,和碩元大99售01  ,0,0,0,0,0,0,0,0,0,-70000,0,0,0,0,70000,-70000,-70000
054457,強茂群益96購01  ,0,0,0,0,0,0,0,0,0,-70000,0,0,0,0,70000,-70000,-70000
054458,復盛群益96購01  ,0,0,0,0,0,0,0,0,0,-70000,0,0,0,10000,80000,-70000,-70000
055216,友達凱基98購05  ,0,0,0,0,0,0,0,0,0,-70000,0,0,0,0,70000,-70000,-70000
055505,新唐元大97購02  ,0,0,0,0,0,0,0,0,0,-70000,0,0,0,10000,80000,-70000,-70000
053398,和鑫中信99購01  ,0,0,0,0,0,0,0,0,0,-70000,0,0,0,10000,80000,-70000,-70000
052458,T50反1統一97購01,0,0,0,0,0,0,0,0,0,-70000,0,0,0,0,70000,-70000,-70000
054205,華新國票97購02  ,0,0,0,0,0,0,0,0,0,-70000,0,0,0,70000,140000,-70000,-70000
051729,華新國票96購01  ,0,0,0,0,0,0,0,0,0,-70000,0,0,0,0,70000,-70000,-70000
056984,嘉晶群益98購01  ,0,0,0,0,0,0,0,0,0,-70000,0,0,0,12000,82000,-70000,-70000
058125,元油2X元大9C購01,0,0,0,0,0,0,0,0,0,-70000,0,0,0,0,70000,-70000,-70000
056819,奇力新永豐98購01,0,0,0,0,0,0,0,0,0,-70000,0,0,0,0,70000,-70000,-70000
059664,立積元大9C購01  ,0,0,0,0,0,0,0,0,0,-70000,0,0,0,0,70000,-70000,-70000
058947,SGBR2X群益9B購02,0,0,0,0,0,0,0,0,0,-70000,0,0,0,0,70000,-70000,-70000
060944,國泰金國票9A購01,0,0,0,0,0,0,0,0,0,-70000,0,0,0,78000,148000,-70000,-70000
057746,同欣電永豐98購02,0,0,0,0,0,0,0,0,0,-70000,0,0,0,0,70000,-70000,-70000
058645,康控富邦01購01  ,0,0,0,0,0,0,0,0,0,-70000,0,0,0,121000,191000,-70000,-70000
061025,創意富邦9B購01  ,0,0,0,0,0,0,0,0,0,-70000,0,0,0,200000,270000,-70000,-70000
061238,晶技元大9A購02  ,0,0,0,0,0,0,0,0,0,-70000,0,0,0,0,70000,-70000,-70000
06060P,玉晶光元大97售03,0,0,0,0,0,0,0,0,0,-70000,0,0,0,27000,97000,-70000,-70000
063163,京元電永豐9B購01,0,0,0,0,0,0,0,0,0,-70000,0,0,0,49000,119000,-70000,-70000
06307P,聚陽元富97售02  ,0,0,0,0,0,0,0,0,0,-70000,0,0,0,0,70000,-70000,-70000
063090,道瓊反中信9C購02,0,0,0,0,0,0,0,0,0,-70000,0,0,0,0,70000,-70000,-70000
062927,同欣電國票9B購02,0,0,0,0,0,0,0,0,0,-70000,0,0,0,170000,240000,-70000,-70000
062804,玉晶光統一9C購04,0,0,0,0,0,0,0,0,0,-70000,0,0,0,129000,199000,-70000,-70000
062780,旺宏元大01購01  ,0,0,0,0,0,0,0,0,0,-70000,0,0,0,12000,82000,-70000,-70000
062008,南亞科國泰9C購01,0,0,0,0,0,0,0,0,0,-70000,0,0,0,397000,467000,-70000,-70000
062402,台勝科永豐9B購02,0,0,0,0,0,0,0,0,0,-70000,0,0,0,0,70000,-70000,-70000
063932,世芯統一01購01  ,0,0,0,0,0,0,0,0,0,-71000,0,0,0,0,71000,-71000,-71000
063717,宏達電兆豐9B購02,0,0,0,0,0,0,0,0,0,-71000,0,0,0,0,71000,-71000,-71000
055188,亞翔統一97購01  ,0,0,0,0,0,0,0,0,0,-71000,0,0,0,0,71000,-71000,-71000
056506,晶豪科永豐98購02,0,0,0,0,0,0,0,0,0,-71000,0,0,0,30000,101000,-71000,-71000
057742,喬山永豐98購02  ,0,0,0,0,0,0,0,0,0,-71000,0,0,0,0,71000,-71000,-71000
05779P,台積電統一96售06,0,0,0,0,0,0,0,0,0,-71000,0,0,0,69000,140000,-71000,-71000
057111,立積群益98購02  ,0,0,0,0,0,0,0,0,0,-71000,0,0,0,10000,81000,-71000,-71000
062081,華新科元大9B購06,0,0,0,0,0,0,0,0,0,-71000,0,0,0,7000,78000,-71000,-71000
062702,可成元大9C購01  ,0,0,0,0,0,0,0,0,0,-71000,0,0,0,5000,76000,-71000,-71000
061043,百和永豐9A購01  ,0,0,0,0,0,0,0,0,0,-71000,0,0,0,16000,87000,-71000,-71000
061001,智邦兆豐9B購01  ,0,0,0,0,0,0,0,0,0,-71000,0,0,0,8000,79000,-71000,-71000
061505,力成國票9A購03  ,0,0,0,0,0,0,0,0,0,-71000,0,0,0,37000,108000,-71000,-71000
063387,台積電兆豐9B購03,0,0,0,0,0,0,0,0,0,-72000,0,0,0,68000,140000,-72000,-72000
063461,金像電元大9B購03,0,0,0,0,0,0,0,0,0,-72000,0,0,0,3000,75000,-72000,-72000
08096P,大立光元富9B售04,0,0,0,0,0,0,0,0,0,-72000,0,0,0,0,72000,-72000,-72000
055049,智邦永豐97購01  ,0,0,0,0,0,0,0,0,0,-72000,0,0,0,10000,82000,-72000,-72000
059103,旭富元富99購03  ,0,0,0,0,0,0,0,0,0,-72000,0,0,0,123000,195000,-72000,-72000
054017,茂林永豐96購02  ,0,0,0,0,0,0,0,0,0,-72000,0,0,0,4000,76000,-72000,-72000
053255,貿聯國泰97購01  ,0,0,0,0,0,0,0,0,0,-72000,0,0,0,40000,112000,-72000,-72000
053083,中環元大99購01  ,0,0,0,0,0,0,0,0,0,-72000,0,0,0,0,72000,-72000,-72000
058779,大立光國票9A購02,0,0,0,0,0,0,0,0,0,-72000,0,0,0,0,72000,-72000,-72000
057158,義隆永豐99購01  ,0,0,0,0,0,0,0,0,0,-72000,0,0,0,64000,136000,-72000,-72000
057826,祥碩元大98購08  ,0,0,0,0,0,0,0,0,0,-72000,0,0,0,0,72000,-72000,-72000
058171,國巨凱基9A購07  ,0,0,0,0,0,0,0,0,0,-72000,0,0,0,0,72000,-72000,-72000
061381,台灣50群益9B購07,0,0,0,0,0,0,0,0,0,-72000,0,0,0,120000,192000,-72000,-72000
061668,信邦中信9B購01  ,0,0,0,0,0,0,0,0,0,-72000,0,0,0,97000,169000,-72000,-72000
061740,華新科凱基03購01,0,0,0,0,0,0,0,0,0,-72000,0,0,0,1000,73000,-72000,-72000
063056,嘉澤統一9C購02  ,0,0,0,0,0,0,0,0,0,-72000,0,0,0,5000,77000,-72000,-72000
061974,光寶科元大9B購01,0,0,0,0,0,0,0,0,0,-72000,0,0,0,118000,190000,-72000,-72000
08090P,嘉澤統一9B售01  ,0,0,0,0,0,0,0,0,0,-73000,0,0,0,3000,76000,-73000,-73000
07932P,國巨元大9B售04  ,0,0,0,0,0,0,0,0,0,-73000,0,0,0,0,73000,-73000,-73000
1218,泰山            ,199000,272000,-73000,0,0,0,0,0,0,0,0,0,0,0,0,0,-73000
06845P,億光元大98售02  ,0,0,0,0,0,0,0,0,0,-73000,0,0,0,20000,93000,-73000,-73000
056133,可成元大97購05  ,0,0,0,0,0,0,0,0,0,-73000,0,0,0,0,73000,-73000,-73000
054971,帆宣元大97購02  ,0,0,0,0,0,0,0,0,0,-73000,0,0,0,0,73000,-73000,-73000
060472,中租元大9A購02  ,0,0,0,0,0,0,0,0,0,-73000,0,0,0,10000,83000,-73000,-73000
058820,致茂國泰9B購01  ,0,0,0,0,0,0,0,0,0,-73000,0,0,0,45000,118000,-73000,-73000
058911,茂林元大99購04  ,0,0,0,0,0,0,0,0,0,-73000,0,0,0,10000,83000,-73000,-73000
059924,世紀鋼元大99購06,0,0,0,0,0,0,0,0,0,-73000,0,0,0,65000,138000,-73000,-73000
061988,大立光元大9B購04,0,0,0,0,0,0,0,0,0,-73000,0,0,0,0,73000,-73000,-73000
063119,華通元大9B購07  ,0,0,0,0,0,0,0,0,0,-73000,0,0,0,20000,93000,-73000,-73000
062677,儒鴻統一01購01  ,0,0,0,0,0,0,0,0,0,-73000,0,0,0,11000,84000,-73000,-73000
062673,台新金中信03購01,0,0,0,0,0,0,0,0,0,-73000,0,0,0,20000,93000,-73000,-73000
061305,帆宣永豐9A購01  ,0,0,0,0,0,0,0,0,0,-73000,0,0,0,12000,85000,-73000,-73000
061087,國巨統一01購04  ,0,0,0,0,0,0,0,0,0,-73000,0,0,0,15000,88000,-73000,-73000
07129P,華新科元大99售14,0,0,0,0,0,0,0,0,0,-74000,0,0,0,64000,138000,-74000,-74000
063761,嘉澤統一02購01  ,0,0,0,0,0,0,0,0,0,-74000,0,0,0,0,74000,-74000,-74000
063625,儒鴻元大9B購03  ,0,0,0,0,0,0,0,0,0,-74000,0,0,0,61000,135000,-74000,-74000
055603,超眾元大97購04  ,0,0,0,0,0,0,0,0,0,-74000,0,0,0,68000,142000,-74000,-74000
055845,大立光元大97購08,0,0,0,0,0,0,0,0,0,-74000,0,0,0,69000,143000,-74000,-74000
056635,亞德客日盛99購01,0,0,0,0,0,0,0,0,0,-74000,0,0,0,11000,85000,-74000,-74000
059198,華新科永豐99購06,0,0,0,0,0,0,0,0,0,-74000,0,0,0,4000,78000,-74000,-74000
057053,立積元大98購02  ,0,0,0,0,0,0,0,0,0,-74000,0,0,0,180000,254000,-74000,-74000
058850,華新科群益99購03,0,0,0,0,0,0,0,0,0,-74000,0,0,0,3000,77000,-74000,-74000
060239,國揚元大9C購01  ,0,0,0,0,0,0,0,0,0,-74000,0,0,0,70000,144000,-74000,-74000
057745,泰鼎永豐99購01  ,0,0,0,0,0,0,0,0,0,-74000,0,0,0,49000,123000,-74000,-74000
060799,茂林永豐9A購01  ,0,0,0,0,0,0,0,0,0,-74000,0,0,0,32000,106000,-74000,-74000
061651,世紀鋼元大9C購02,0,0,0,0,0,0,0,0,0,-74000,0,0,0,1000,75000,-74000,-74000
062918,祥碩元大9C購02  ,0,0,0,0,0,0,0,0,0,-74000,0,0,0,0,74000,-74000,-74000
063196,力成元富9B購01  ,0,0,0,0,0,0,0,0,0,-74000,0,0,0,175000,249000,-74000,-74000
062260,華新科元大9B購09,0,0,0,0,0,0,0,0,0,-74000,0,0,0,0,74000,-74000,-74000
062373,泰鼎元大9B購01  ,0,0,0,0,0,0,0,0,0,-74000,0,0,0,47000,121000,-74000,-74000
063590,華擎永豐9B購01  ,0,0,0,0,0,0,0,0,0,-75000,0,0,0,0,75000,-75000,-75000
063791,玉晶光台新9C購01,0,0,0,0,0,0,0,0,0,-75000,0,0,0,0,75000,-75000,-75000
063464,廣達元大9B購02  ,0,0,0,0,0,0,0,0,0,-75000,0,0,0,50000,125000,-75000,-75000
06846P,美律元大98售05  ,0,0,0,0,0,0,0,0,0,-75000,0,0,0,0,75000,-75000,-75000
059147,矽創國票99購01  ,0,0,0,0,0,0,0,0,0,-75000,0,0,0,0,75000,-75000,-75000
055569,聚陽統一98購01  ,0,0,0,0,0,0,0,0,0,-75000,0,0,0,30000,105000,-75000,-75000
056340,可成凱基98購04  ,0,0,0,0,0,0,0,0,0,-75000,0,0,0,5000,80000,-75000,-75000
035274,華新台新97購01  ,0,0,0,0,0,0,0,0,0,-75000,0,0,0,5000,80000,-75000,-75000
058670,鴻海群益9A購03  ,0,0,0,0,0,0,0,0,0,-75000,0,0,0,16000,91000,-75000,-75000
058739,喬山中信99購01  ,0,0,0,0,0,0,0,0,0,-75000,0,0,0,35000,110000,-75000,-75000
062876,全新兆豐9B購01  ,0,0,0,0,0,0,0,0,0,-75000,0,0,0,10000,85000,-75000,-75000
061907,裕隆中信9B購01  ,0,0,0,0,0,0,0,0,0,-75000,0,0,0,76000,151000,-75000,-75000
060882,大立光中信9A購05,0,0,0,0,0,0,0,0,0,-75000,0,0,0,0,75000,-75000,-75000
061151,友訊群益9A購01  ,0,0,0,0,0,0,0,0,0,-75000,0,0,0,70000,145000,-75000,-75000
063317,大立光群益9B購06,0,0,0,0,0,0,0,0,0,-76000,0,0,0,0,76000,-76000,-76000
03446B,臺股指元大9B熊26,0,35000,-35000,0,0,0,0,0,0,-41000,0,0,0,47000,88000,-41000,-76000
054296,世芯元大97購01  ,0,0,0,0,0,0,0,0,0,-76000,0,0,0,97000,173000,-76000,-76000
053487,台泥兆豐97購01  ,0,0,0,0,0,0,0,0,0,-76000,0,0,0,5000,81000,-76000,-76000
057570,技嘉永豐98購02  ,0,0,0,0,0,0,0,0,0,-76000,0,0,0,4000,80000,-76000,-76000
060293,緯創元大9A購01  ,0,0,0,0,0,0,0,0,0,-76000,0,0,0,69000,145000,-76000,-76000
057366,智邦元大98購08  ,0,0,0,0,0,0,0,0,0,-76000,0,0,0,38000,114000,-76000,-76000
059875,信邦凱基99購02  ,0,0,0,0,0,0,0,0,0,-76000,0,0,0,33000,109000,-76000,-76000
061177,大立光凱基9A購10,0,0,0,0,0,0,0,0,0,-76000,0,0,0,0,76000,-76000,-76000
061614,亞德客群益9A購01,0,0,0,0,0,0,0,0,0,-76000,0,0,0,2000,78000,-76000,-76000
062726,華擎凱基9B購02  ,0,0,0,0,0,0,0,0,0,-76000,0,0,0,0,76000,-76000,-76000
063223,牧德群益9B購04  ,0,0,0,0,0,0,0,0,0,-76000,0,0,0,64000,140000,-76000,-76000
062143,大成鋼國票9B購01,0,0,0,0,0,0,0,0,0,-76000,0,0,0,0,76000,-76000,-76000
062052,華通統一01購01  ,0,0,0,0,0,0,0,0,0,-76000,0,0,0,25000,101000,-76000,-76000
07675P,全新永豐9A售02  ,0,0,0,0,0,0,0,0,0,-77000,0,0,0,0,77000,-77000,-77000
056783,國巨群益99購01  ,0,0,0,0,0,0,0,0,0,-77000,0,0,0,35000,112000,-77000,-77000
058137,玉晶光元大99購11,0,0,0,0,0,0,0,0,0,-77000,0,0,0,320000,397000,-77000,-77000
056713,華擎永豐98購01  ,0,0,0,0,0,0,0,0,0,-77000,0,0,0,0,77000,-77000,-77000
060958,儒鴻凱基9A購02  ,0,0,0,0,0,0,0,0,0,-77000,0,0,0,50000,127000,-77000,-77000
05775P,台積電國泰98售02,0,0,0,0,0,0,0,0,0,-77000,0,0,0,203000,280000,-77000,-77000
057820,華擎元大98購02  ,0,0,0,0,0,0,0,0,0,-77000,0,0,0,224000,301000,-77000,-77000
062252,華邦電元大9C購01,0,0,0,0,0,0,0,0,0,-77000,0,0,0,38000,115000,-77000,-77000
062204,京元電國票9C購01,0,0,0,0,0,0,0,0,0,-77000,0,0,0,114000,191000,-77000,-77000
07685P,玉晶光凱基9B售03,0,0,0,0,0,0,0,0,0,-78000,0,0,0,40000,118000,-78000,-78000
08042P,臺股指群益9B售15,0,0,0,0,0,0,0,0,0,-78000,0,0,0,0,78000,-78000,-78000
063788,矽創統一02購01  ,0,0,0,0,0,0,0,0,0,-78000,0,0,0,0,78000,-78000,-78000
056428,台達電凱基99購01,0,0,0,0,0,0,0,0,0,-78000,0,0,0,11000,89000,-78000,-78000
055496,高鐵元大97購02  ,0,0,0,0,0,0,0,0,0,-78000,0,0,0,0,78000,-78000,-78000
006208,富邦台50        ,3000,7000,-4000,0,0,0,0,0,0,-74000,0,0,0,683000,757000,-74000,-78000
059318,旺宏元大99購13  ,0,0,0,0,0,0,0,0,0,-78000,0,0,0,0,78000,-78000,-78000
055963,欣興元大97購04  ,0,0,0,0,0,0,0,0,0,-78000,0,0,0,10000,88000,-78000,-78000
055736,宏達電元富99購01,0,0,0,0,0,0,0,0,0,-78000,0,0,0,142000,220000,-78000,-78000
060355,元金2X元富9C購01,0,0,0,0,0,0,0,0,0,-78000,0,0,0,5000,83000,-78000,-78000
056899,可成元大98購01  ,0,0,0,0,0,0,0,0,0,-78000,0,0,0,0,78000,-78000,-78000
059766,同欣電永豐99購03,0,0,0,0,0,0,0,0,0,-78000,0,0,0,112000,190000,-78000,-78000
057170,瑞昱元大98購01  ,0,0,0,0,0,0,0,0,0,-78000,0,0,0,12000,90000,-78000,-78000
063042,同欣電凱基9C購01,0,0,0,0,0,0,0,0,0,-78000,0,0,0,28000,106000,-78000,-78000
061349,嘉澤元大9A購02  ,0,0,0,0,0,0,0,0,0,-78000,0,0,0,50000,128000,-78000,-78000
061077,國巨兆豐9B購01  ,0,0,0,0,0,0,0,0,0,-78000,0,0,0,232000,310000,-78000,-78000
8249,菱光            ,22000,101000,-79000,0,0,0,0,0,0,1000,1000,0,1000,0,0,0,-78000
063729,國巨元大9C購08  ,0,0,0,0,0,0,0,0,0,-79000,0,0,0,4000,83000,-79000,-79000
063434,和潤元富9B購01  ,0,0,0,0,0,0,0,0,0,-79000,0,0,0,0,79000,-79000,-79000
08258P,旺宏元大9C售04  ,0,0,0,0,0,0,0,0,0,-79000,0,0,0,39000,118000,-79000,-79000
056619,強茂永豐98購01  ,0,0,0,0,0,0,0,0,0,-79000,0,0,0,103000,182000,-79000,-79000
059488,大立光兆豐99購03,0,0,0,0,0,0,0,0,0,-79000,0,0,0,56000,135000,-79000,-79000
059009,世紀鋼元大99購04,0,0,0,0,0,0,0,0,0,-79000,0,0,0,79000,158000,-79000,-79000
058798,大立光元大99購11,0,0,0,0,0,0,0,0,0,-79000,0,0,0,0,79000,-79000,-79000
059662,旭富元大9C購01  ,0,0,0,0,0,0,0,0,0,-79000,0,0,0,74000,153000,-79000,-79000
057240,茂林凱基9A購01  ,0,0,0,0,0,0,0,0,0,-79000,0,0,0,15000,94000,-79000,-79000
060302,台積電富邦02購01,0,0,0,0,0,0,0,0,0,-79000,0,0,0,218000,297000,-79000,-79000
060214,茂林康和9A購01  ,0,0,0,0,0,0,0,0,0,-79000,0,0,0,14000,93000,-79000,-79000
058153,景碩統一9B購01  ,0,0,0,0,0,0,0,0,0,-79000,0,0,0,262000,341000,-79000,-79000
058650,台虹永豐9A購01  ,0,0,0,0,0,0,0,0,0,-79000,0,0,0,38000,117000,-79000,-79000
061127,美食永豐9A購01  ,0,0,0,0,0,0,0,0,0,-79000,0,0,0,123000,202000,-79000,-79000
061773,和潤元大9B購01  ,0,0,0,0,0,0,0,0,0,-79000,0,0,0,90000,169000,-79000,-79000
07623P,大立光統一9B售05,0,0,0,0,0,0,0,0,0,-80000,0,0,0,0,80000,-80000,-80000
07386P,臺股指群益99售24,0,0,0,0,0,0,0,0,0,-80000,0,0,0,0,80000,-80000,-80000
063842,國巨元大9C購10  ,0,0,0,0,0,0,0,0,0,-80000,0,0,0,0,80000,-80000,-80000
07214P,聯發科凱基9A售04,0,0,0,0,0,0,0,0,0,-80000,0,0,0,185000,265000,-80000,-80000
059094,臻鼎元大99購03  ,0,0,0,0,0,0,0,0,0,-80000,0,0,0,10000,90000,-80000,-80000
056626,同欣電永豐98購01,0,0,0,0,0,0,0,0,0,-80000,0,0,0,0,80000,-80000,-80000
053259,卜蜂群益97購01  ,0,0,0,0,0,0,0,0,0,-80000,0,0,0,0,80000,-80000,-80000
057773,技嘉群益9A購02  ,0,0,0,0,0,0,0,0,0,-80000,0,0,0,63000,143000,-80000,-80000
060122,亞德客永豐99購02,0,0,0,0,0,0,0,0,0,-80000,0,0,0,34000,114000,-80000,-80000
059819,台積電凱基99購17,0,0,0,0,0,0,0,0,0,-80000,0,0,0,20000,100000,-80000,-80000
061656,華新科國票9A購08,0,0,0,0,0,0,0,0,0,-80000,0,0,0,20000,100000,-80000,-80000
061244,和碩兆豐9A購01  ,0,0,0,0,0,0,0,0,0,-80000,0,0,0,120000,200000,-80000,-80000
061054,台積電群益9A購04,0,0,0,0,0,0,0,0,0,-80000,0,0,0,20000,100000,-80000,-80000
060908,金像電元大9A購03,0,0,0,0,0,0,0,0,0,-80000,0,0,0,77000,157000,-80000,-80000
060786,聯發科富邦9B購06,0,0,0,0,0,0,0,0,0,-80000,0,0,0,0,80000,-80000,-80000
063025,超眾元大9B購01  ,0,0,0,0,0,0,0,0,0,-80000,0,0,0,83000,163000,-80000,-80000
062698,台積電元大01購01,0,0,0,0,0,0,0,0,0,-80000,0,0,0,0,80000,-80000,-80000
062070,金寶元大9B購01  ,0,0,0,0,0,0,0,0,0,-80000,0,0,0,20000,100000,-80000,-80000
063735,華新科元大9B購15,0,0,0,0,0,0,0,0,0,-81000,0,0,0,5000,86000,-81000,-81000
054216,聯茂國票97購03  ,0,0,0,0,0,0,0,0,0,-81000,0,0,0,0,81000,-81000,-81000
056971,麗豐永豐98購01  ,0,0,0,0,0,0,0,0,0,-81000,0,0,0,1000,82000,-81000,-81000
6235,華孚            ,15000,102000,-87000,0,0,0,0,0,0,6000,6000,0,6000,0,0,0,-81000
07304P,臺股指元大9A售37,0,0,0,0,0,0,0,0,0,-82000,0,0,0,258000,340000,-82000,-82000
054760,台化國票9A購01  ,0,0,0,0,0,0,0,0,0,-82000,0,0,0,0,82000,-82000,-82000
060955,大立光群益9A購02,0,0,0,0,0,0,0,0,0,-82000,0,0,0,0,82000,-82000,-82000
057904,矽力永豐98購01  ,0,0,0,0,0,0,0,0,0,-82000,0,0,0,16000,98000,-82000,-82000
058524,超眾元大99購04  ,0,0,0,0,0,0,0,0,0,-82000,0,0,0,101000,183000,-82000,-82000
062534,力成統一01購01  ,0,0,0,0,0,0,0,0,0,-82000,0,0,0,159000,241000,-82000,-82000
062537,聯電國泰9C購01  ,0,0,0,0,0,0,0,0,0,-82000,0,0,0,49000,131000,-82000,-82000
063087,南六凱基9C購02  ,0,0,0,0,0,0,0,0,0,-82000,0,0,0,70000,152000,-82000,-82000
060666,聯茂凱基9A購02  ,0,0,0,0,0,0,0,0,0,-82000,0,0,0,13000,95000,-82000,-82000
060636,大毅永豐9A購02  ,0,0,0,0,0,0,0,0,0,-82000,0,0,0,0,82000,-82000,-82000
07645P,華通元大9A售06  ,0,0,0,0,0,0,0,0,0,-83000,0,0,0,47000,130000,-83000,-83000
08106P,聯發科統一9B售09,0,0,0,0,0,0,0,0,0,-83000,0,0,0,0,83000,-83000,-83000
057776,京元電群益98購02,0,0,0,0,0,0,0,0,0,-83000,0,0,0,21000,104000,-83000,-83000
057075,嘉聯益永豐98購01,0,0,0,0,0,0,0,0,0,-83000,0,0,0,121000,204000,-83000,-83000
057207,立積元富98購02  ,0,0,0,0,0,0,0,0,0,-83000,0,0,0,137000,220000,-83000,-83000
057993,中環中信98購01  ,0,0,0,0,0,0,0,0,0,-83000,0,0,0,0,83000,-83000,-83000
058881,全新永豐99購01  ,0,0,0,0,0,0,0,0,0,-83000,0,0,0,0,83000,-83000,-83000
058975,台灣50凱基01購02,0,0,0,0,0,0,0,0,0,-83000,0,0,0,0,83000,-83000,-83000
060596,元黃金凱基9A購02,0,0,0,0,0,0,0,0,0,-83000,0,0,0,0,83000,-83000,-83000
062919,聯茂元大9B購01  ,15000,0,15000,0,0,0,0,0,0,-98000,0,0,0,27000,125000,-98000,-83000
062073,國巨元大9B購06  ,0,0,0,0,0,0,0,0,0,-83000,0,0,0,0,83000,-83000,-83000
062063,世紀鋼統一9C購01,0,0,0,0,0,0,0,0,0,-83000,0,0,0,0,83000,-83000,-83000
061953,台積電台新9B購04,0,0,0,0,0,0,0,0,0,-83000,0,0,0,17000,100000,-83000,-83000
6582,申豐            ,248000,322000,-74000,0,0,0,0,0,0,-9000,11000,20000,-9000,0,0,0,-83000
063797,台積電凱基02購02,0,0,0,0,0,0,0,0,0,-84000,0,0,0,0,84000,-84000,-84000
063253,巨大元大9B購03  ,0,0,0,0,0,0,0,0,0,-84000,0,0,0,311000,395000,-84000,-84000
054957,興富發元大97購01,0,0,0,0,0,0,0,0,0,-84000,0,0,0,60000,144000,-84000,-84000
047885,元金2X富邦99購01,0,0,0,0,0,0,0,0,0,-84000,0,0,0,0,84000,-84000,-84000
056776,聯茂元大99購01  ,0,0,0,0,0,0,0,0,0,-84000,0,0,0,7000,91000,-84000,-84000
057671,群創元大9B購06  ,0,0,0,0,0,0,0,0,0,-84000,0,0,0,0,84000,-84000,-84000
062239,台汽電凱基9B購01,0,0,0,0,0,0,0,0,0,-84000,0,0,0,0,84000,-84000,-84000
062354,台達電元大9B購01,0,0,0,0,0,0,0,0,0,-84000,0,0,0,37000,121000,-84000,-84000
061028,聚陽永豐9A購01  ,0,0,0,0,0,0,0,0,0,-84000,0,0,0,231000,315000,-84000,-84000
061734,全新中信9B購02  ,0,0,0,0,0,0,0,0,0,-84000,0,0,0,1000,85000,-84000,-84000
061720,智邦國泰9C購01  ,0,0,0,0,0,0,0,0,0,-84000,0,0,0,31000,115000,-84000,-84000
063792,香港反凱基9C購01,0,0,0,0,0,0,0,0,0,-85000,0,0,0,0,85000,-85000,-85000
07027P,台積電群益99售04,0,0,0,0,0,0,0,0,0,-85000,0,0,0,0,85000,-85000,-85000
06438P,玉晶光國票99售02,0,0,0,0,0,0,0,0,0,-85000,0,0,0,0,85000,-85000,-85000
056135,緯創元大98購01  ,0,0,0,0,0,0,0,0,0,-85000,0,0,0,20000,105000,-85000,-85000
057838,台郡國泰99購01  ,0,20000,-20000,0,0,0,0,0,0,-65000,0,0,0,20000,85000,-65000,-85000
057559,可成兆豐99購02  ,0,0,0,0,0,0,0,0,0,-85000,0,0,0,0,85000,-85000,-85000
058554,瀚宇博永豐99購01,0,0,0,0,0,0,0,0,0,-85000,0,0,0,0,85000,-85000,-85000
058588,致茂中信9B購01  ,0,0,0,0,0,0,0,0,0,-85000,0,0,0,55000,140000,-85000,-85000
058265,奇力新永豐9A購01,0,0,0,0,0,0,0,0,0,-85000,0,0,0,0,85000,-85000,-85000
058104,國巨統一9A購04  ,0,0,0,0,0,0,0,0,0,-85000,0,0,0,35000,120000,-85000,-85000
061059,世芯國票9B購01  ,0,0,0,0,0,0,0,0,0,-85000,0,0,0,85000,170000,-85000,-85000
062958,長榮航麥證9B購01,0,0,0,0,85000,-85000,0,0,0,-85000,0,0,0,0,85000,-85000,-85000
063647,超眾元大9B購02  ,0,0,0,0,0,0,0,0,0,-86000,0,0,0,74000,160000,-86000,-86000
07363P,大立光元大99售26,0,0,0,0,0,0,0,0,0,-86000,0,0,0,20000,106000,-86000,-86000
054640,健策中信9B購01  ,0,0,0,0,0,0,0,0,0,-86000,0,0,0,115000,201000,-86000,-86000
055341,台達電凱基97購02,0,0,0,0,0,0,0,0,0,-86000,0,0,0,0,86000,-86000,-86000
058848,台積電群益99購07,0,0,0,0,0,0,0,0,0,-86000,0,0,0,1000,87000,-86000,-86000
062941,大立光凱基9B購07,0,0,0,0,0,0,0,0,0,-86000,0,0,0,34000,120000,-86000,-86000
061017,國泰金麥證9A購01,0,0,0,0,86000,-86000,0,0,0,-86000,0,0,0,0,86000,-86000,-86000
060845,欣興國票9A購01  ,0,0,0,0,0,0,0,0,0,-86000,0,0,0,1000,87000,-86000,-86000
060540,南亞凱基9A購01  ,0,0,0,0,0,0,0,0,0,-86000,0,0,0,4000,90000,-86000,-86000
052434,茂林國泰97購01  ,0,0,0,0,0,0,0,0,0,-87000,0,0,0,10000,97000,-87000,-87000
055137,GIS富邦98購01   ,0,0,0,0,0,0,0,0,0,-87000,0,0,0,208000,295000,-87000,-87000
060172,智原台新9A購01  ,0,0,0,0,0,0,0,0,0,-87000,0,0,0,110000,197000,-87000,-87000
06050P,玉晶光國票98售01,0,0,0,0,0,0,0,0,0,-87000,0,0,0,66000,153000,-87000,-87000
061186,牧德國泰9C購01  ,0,0,0,0,0,0,0,0,0,-87000,0,0,0,64000,151000,-87000,-87000
061468,神達群益9A購01  ,0,0,0,0,0,0,0,0,0,-87000,0,0,0,0,87000,-87000,-87000
062983,緯穎元富9B購01  ,0,0,0,0,0,0,0,0,0,-87000,0,0,0,0,87000,-87000,-87000
062891,台汽電群益9B購01,0,0,0,0,0,0,0,0,0,-87000,0,0,0,0,87000,-87000,-87000
062019,嘉澤永豐9B購01  ,0,0,0,0,0,0,0,0,0,-87000,0,0,0,0,87000,-87000,-87000
063307,同欣電凱基9B購02,0,0,0,0,0,0,0,0,0,-88000,0,0,0,61000,149000,-88000,-88000
063490,儒鴻富邦9C購01  ,0,0,0,0,0,0,0,0,0,-88000,0,0,0,1000,89000,-88000,-88000
063954,世芯元大01購02  ,0,0,0,0,0,0,0,0,0,-88000,0,0,0,15000,103000,-88000,-88000
06721P,臺股指中信9A售03,0,0,0,0,0,0,0,0,0,-88000,0,0,0,50000,138000,-88000,-88000
046384,群創凱基98購02  ,0,0,0,0,0,0,0,0,0,-88000,0,0,0,70000,158000,-88000,-88000
053973,晶豪科元大96購01,0,0,0,0,0,0,0,0,0,-88000,0,0,0,75000,163000,-88000,-88000
060329,鎧勝群益9B購01  ,0,0,0,0,0,0,0,0,0,-88000,0,0,0,264000,352000,-88000,-88000
059421,滬深2X元大99購05,0,0,0,0,0,0,0,0,0,-88000,0,0,0,0,88000,-88000,-88000
059742,富邦金元富99購01,0,0,0,0,0,0,0,0,0,-88000,0,0,0,10000,98000,-88000,-88000
059224,大立光元大99購15,0,0,0,0,0,0,0,0,0,-88000,0,0,0,0,88000,-88000,-88000
062481,同欣電國票9B購01,0,15000,-15000,0,0,0,0,0,0,-73000,0,0,0,15000,88000,-73000,-88000
062754,台勝科麥證9B購01,0,0,0,9000,97000,-88000,0,0,0,-88000,0,0,0,9000,97000,-88000,-88000
061336,國巨元大9A購20  ,0,0,0,0,0,0,0,0,0,-88000,0,0,0,22000,110000,-88000,-88000
061439,寶成凱基9A購01  ,0,0,0,0,0,0,0,0,0,-88000,0,0,0,200000,288000,-88000,-88000
061701,友達國票9B購02  ,0,0,0,0,0,0,0,0,0,-88000,0,0,0,0,88000,-88000,-88000
6214,精誠            ,117000,263000,-146000,0,0,0,0,0,0,58000,60000,2000,58000,0,0,0,-88000
063244,華新科元大9B購11,0,0,0,0,0,0,0,0,0,-89000,0,0,0,0,89000,-89000,-89000
07617P,聯發科中信9C售04,0,0,0,0,0,0,0,0,0,-89000,0,0,0,180000,269000,-89000,-89000
054567,拓凱群益98購01  ,0,0,0,0,0,0,0,0,0,-89000,0,0,0,85000,174000,-89000,-89000
054346,世芯國票97購01  ,0,0,0,0,0,0,0,0,0,-89000,0,0,0,22000,111000,-89000,-89000
056738,國巨凱基9A購02  ,0,0,0,0,0,0,0,0,0,-89000,0,0,0,1000,90000,-89000,-89000
060028,國揚永豐99購01  ,0,0,0,0,0,0,0,0,0,-89000,0,0,0,0,89000,-89000,-89000
060982,旺宏元大9A購09  ,0,0,0,0,0,0,0,0,0,-89000,0,0,0,0,89000,-89000,-89000
060602,京元電凱基9A購01,0,0,0,0,0,0,0,0,0,-89000,0,0,0,100000,189000,-89000,-89000
062727,華擎凱基9B購03  ,0,0,0,0,0,0,0,0,0,-89000,0,0,0,6000,95000,-89000,-89000
062763,華擎凱基9C購02  ,0,0,0,0,0,0,0,0,0,-89000,0,0,0,15000,104000,-89000,-89000
5434,崇越            ,177000,292000,-115000,0,0,0,0,0,0,26000,31000,5000,26000,0,0,0,-89000
063638,華新科元大9B購14,0,0,0,0,0,0,0,0,0,-90000,0,0,0,3000,93000,-90000,-90000
063823,T50反1國票01購02,0,0,0,0,0,0,0,0,0,-90000,0,0,0,0,90000,-90000,-90000
063722,遠東新元大9B購02,0,0,0,0,0,0,0,0,0,-90000,0,0,0,4000,94000,-90000,-90000
06387P,緯穎永豐97售02  ,0,0,0,0,0,0,0,0,0,-90000,0,0,0,25000,115000,-90000,-90000
07164P,臺股指群益99售15,0,0,0,0,0,0,0,0,0,-90000,0,0,0,30000,120000,-90000,-90000
055684,京鼎凱基97購01  ,0,0,0,0,0,0,0,0,0,-90000,0,0,0,70000,160000,-90000,-90000
056581,超眾元大99購01  ,0,0,0,0,0,0,0,0,0,-90000,0,0,0,67000,157000,-90000,-90000
059112,上銀永豐99購01  ,0,0,0,0,0,0,0,0,0,-90000,0,0,0,20000,110000,-90000,-90000
059127,國巨中信99購04  ,0,0,0,0,0,0,0,0,0,-90000,0,0,0,0,90000,-90000,-90000
054053,聯茂元大96購01  ,0,0,0,0,0,0,0,0,0,-90000,0,0,0,10000,100000,-90000,-90000
05272P,臻鼎中信97售03  ,0,0,0,0,0,0,0,0,0,-90000,0,0,0,60000,150000,-90000,-90000
056403,茂林群益98購01  ,0,0,0,0,0,0,0,0,0,-90000,0,0,0,0,90000,-90000,-90000
058274,世紀鋼永豐99購01,0,0,0,0,0,0,0,0,0,-90000,0,0,0,29000,119000,-90000,-90000
058608,華新科元大99購13,0,0,0,0,0,0,0,0,0,-90000,0,0,0,3000,93000,-90000,-90000
058658,瑞儀中信99購01  ,0,0,0,0,0,0,0,0,0,-90000,0,0,0,275000,365000,-90000,-90000
056726,友達日盛9A購01  ,0,0,0,0,0,0,0,0,0,-90000,0,0,0,0,90000,-90000,-90000
058073,大立光凱基99購04,0,0,0,0,0,0,0,0,0,-90000,0,0,0,0,90000,-90000,-90000
061790,中租群益9B購01  ,0,0,0,0,0,0,0,0,0,-90000,0,0,0,18000,108000,-90000,-90000
061830,元金2X凱基01購01,0,0,0,0,0,0,0,0,0,-90000,0,0,0,0,90000,-90000,-90000
061360,智邦兆豐9B購02  ,0,0,0,0,0,0,0,0,0,-90000,0,0,0,86000,176000,-90000,-90000
063882,玉晶光元富9C購01,0,0,0,0,0,0,0,0,0,-91000,0,0,0,2000,93000,-91000,-91000
056177,嘉澤元富97購01  ,0,0,0,0,0,0,0,0,0,-91000,0,0,0,0,91000,-91000,-91000
058909,神達元大99購03  ,0,0,0,0,0,0,0,0,0,-91000,0,0,0,134000,225000,-91000,-91000
057552,禾伸堂凱基98購05,0,0,0,0,0,0,0,0,0,-91000,0,0,0,31000,122000,-91000,-91000
061840,長榮航凱基9C購01,0,0,0,0,0,0,0,0,0,-91000,0,0,0,0,91000,-91000,-91000
061693,華新科群益9B購02,0,0,0,0,0,0,0,0,0,-91000,0,0,0,4000,95000,-91000,-91000
060513,緯穎元大9B購01  ,0,0,0,0,0,0,0,0,0,-91000,0,0,0,110000,201000,-91000,-91000
062711,台表科元大9B購05,0,0,0,0,0,0,0,0,0,-91000,0,0,0,43000,134000,-91000,-91000
063211,道瓊銀國票9B購01,0,0,0,0,0,0,0,0,0,-91000,0,0,0,10000,101000,-91000,-91000
062491,矽創永豐9B購01  ,0,0,0,0,0,0,0,0,0,-91000,0,0,0,145000,236000,-91000,-91000
06570P,大立光永豐98售01,0,0,0,0,0,0,0,0,0,-92000,0,0,0,25000,117000,-92000,-92000
057842,緯穎富邦99購02  ,0,0,0,0,0,0,0,0,0,-92000,0,0,0,0,92000,-92000,-92000
058585,S&P正2中信9B購02,0,0,0,0,0,0,0,0,0,-92000,0,0,0,0,92000,-92000,-92000
060202,康友元富9A購01  ,0,0,0,0,0,0,0,0,0,-92000,0,0,0,10000,102000,-92000,-92000
059641,群創凱基99購06  ,0,0,0,0,0,0,0,0,0,-92000,0,0,0,30000,122000,-92000,-92000
062136,南亞科群益9B購01,0,0,0,0,0,0,0,0,0,-92000,0,0,0,47000,139000,-92000,-92000
061480,泰碩元大9B購01  ,0,0,0,0,0,0,0,0,0,-92000,0,0,0,162000,254000,-92000,-92000
063493,金像電富邦01購01,0,0,0,0,0,0,0,0,0,-93000,0,0,0,0,93000,-93000,-93000
063470,泰鼎元大9B購03  ,0,0,0,0,0,0,0,0,0,-93000,0,0,0,18000,111000,-93000,-93000
08134P,臺股指元大9B售40,0,0,0,0,0,0,0,0,0,-93000,0,0,0,3000,96000,-93000,-93000
08148P,長榮航群益9B售03,0,0,0,0,0,0,0,0,0,-93000,0,0,0,7000,100000,-93000,-93000
059540,新光金日盛99購01,0,0,0,0,0,0,0,0,0,-93000,0,0,0,3000,96000,-93000,-93000
053056,同欣電國票97購01,0,0,0,0,0,0,0,0,0,-93000,0,0,0,7000,100000,-93000,-93000
053403,彩晶群益98購01  ,0,0,0,0,0,0,0,0,0,-93000,0,0,0,0,93000,-93000,-93000
061882,矽創元大9B購01  ,0,0,0,0,0,0,0,0,0,-93000,0,0,0,98000,191000,-93000,-93000
060650,奇力新中信9A購01,0,0,0,0,0,0,0,0,0,-93000,0,0,0,0,93000,-93000,-93000
3038,全台            ,741000,910000,-169000,0,0,0,0,0,0,76000,142000,66000,76000,0,0,0,-93000
063677,台光電國泰9C購02,0,0,0,0,0,0,0,0,0,-94000,0,0,0,44000,138000,-94000,-94000
063573,茂林元大9B購06  ,0,0,0,0,0,0,0,0,0,-94000,0,0,0,0,94000,-94000,-94000
059278,群創元大9A購04  ,0,0,0,0,0,0,0,0,0,-94000,0,0,0,59000,153000,-94000,-94000
056946,國巨統一98購05  ,0,0,0,0,0,0,0,0,0,-94000,0,0,0,15000,109000,-94000,-94000
060009,南亞科群益99購03,0,0,0,0,0,0,0,0,0,-94000,0,0,0,52000,146000,-94000,-94000
057480,技嘉元大98購03  ,0,0,0,0,0,0,0,0,0,-94000,0,0,0,2000,96000,-94000,-94000
058721,立積元富9C購01  ,0,0,0,0,0,0,0,0,0,-94000,0,0,0,372000,466000,-94000,-94000
061737,南亞科凱基9B購01,0,0,0,0,0,0,0,0,0,-94000,0,0,0,30000,124000,-94000,-94000
061600,聯電凱基9B購01  ,0,0,0,0,0,0,0,0,0,-94000,0,0,0,30000,124000,-94000,-94000
061301,華新科永豐9A購03,0,0,0,0,0,0,0,0,0,-94000,0,0,0,0,94000,-94000,-94000
062608,智易凱基9B購01  ,0,0,0,0,0,0,0,0,0,-94000,0,0,0,46000,140000,-94000,-94000
063714,超眾凱基9B購03  ,0,0,0,0,0,0,0,0,0,-95000,0,0,0,30000,125000,-95000,-95000
08085P,華通凱基9B售04  ,0,0,0,0,0,0,0,0,0,-95000,0,0,0,0,95000,-95000,-95000
054261,智伸科元大96購03,0,0,0,0,0,0,0,0,0,-95000,0,0,0,2000,97000,-95000,-95000
056184,南亞科統一97購03,0,0,0,0,0,0,0,0,0,-95000,0,0,0,55000,150000,-95000,-95000
055731,美律元富97購01  ,0,0,0,0,0,0,0,0,0,-95000,0,0,0,3000,98000,-95000,-95000
057681,T50反1日盛9C購01,0,0,0,0,0,0,0,0,0,-95000,0,0,0,0,95000,-95000,-95000
058181,華新科國泰9B購01,0,0,0,0,0,0,0,0,0,-95000,0,0,0,77000,172000,-95000,-95000
058051,同欣電元大98購03,0,0,0,0,0,0,0,0,0,-95000,0,0,0,59000,154000,-95000,-95000
062596,緯穎統一01購02  ,0,0,0,0,0,0,0,0,0,-95000,0,0,0,26000,121000,-95000,-95000
060480,億豐元大9A購02  ,0,0,0,0,0,0,0,0,0,-95000,0,0,0,10000,105000,-95000,-95000
060884,超眾中信9B購01  ,0,0,0,0,0,0,0,0,0,-95000,0,0,0,60000,155000,-95000,-95000
07130P,台郡元大9B售01  ,0,0,0,0,0,0,0,0,0,-96000,0,0,0,14000,110000,-96000,-96000
055779,國泰金凱基97購02,0,0,0,0,0,0,0,0,0,-96000,0,0,0,10000,106000,-96000,-96000
055178,晶豪科統一97購01,0,0,0,0,0,0,0,0,0,-96000,0,0,0,0,96000,-96000,-96000
059139,全新兆豐9A購01  ,0,0,0,0,0,0,0,0,0,-96000,0,0,0,239000,335000,-96000,-96000
058832,立積永豐99購01  ,0,0,0,0,0,0,0,0,0,-96000,0,0,0,385000,481000,-96000,-96000
060922,金像電永豐9A購01,0,0,0,0,0,0,0,0,0,-96000,0,0,0,19000,115000,-96000,-96000
061050,康友中信9A購01  ,0,0,0,0,0,0,0,0,0,-96000,0,0,0,0,96000,-96000,-96000
3557,嘉威            ,229000,330000,-101000,0,0,0,0,0,0,5000,5000,0,5000,0,0,0,-96000
063321,泰鼎群益9B購03  ,0,0,0,0,0,0,0,0,0,-97000,0,0,0,101000,198000,-97000,-97000
08055P,臺股指國票9B售20,0,0,0,0,0,0,0,0,0,-97000,0,0,0,10000,107000,-97000,-97000
2547,日勝生          ,230000,342000,-112000,0,0,0,0,0,0,15000,15000,0,15000,0,0,0,-97000
060266,潤泰全國票9A購01,0,0,0,0,0,0,0,0,0,-97000,0,0,0,46000,143000,-97000,-97000
059277,群創元大99購05  ,0,0,0,0,0,0,0,0,0,-97000,0,0,0,108000,205000,-97000,-97000
059693,智原永豐99購01  ,0,0,0,0,0,0,0,0,0,-97000,0,0,0,0,97000,-97000,-97000
060037,鴻海國票99購10  ,0,0,0,0,0,0,0,0,0,-97000,0,0,0,10000,107000,-97000,-97000
05995P,T50正2中信9C售01,0,0,0,0,0,0,0,0,0,-97000,0,0,0,156000,253000,-97000,-97000
059580,大立光元富99購07,0,0,0,0,0,0,0,0,0,-97000,0,0,0,63000,160000,-97000,-97000
062704,大毅元大9C購01  ,0,0,0,0,0,0,0,0,0,-97000,0,0,0,113000,210000,-97000,-97000
4119,旭富            ,230000,201000,29000,0,0,0,0,110000,-110000,-16000,36000,1000,35000,11000,62000,-51000,-97000
07147P,高鐵元大99售01  ,0,0,0,0,0,0,0,0,0,-98000,0,0,0,2000,100000,-98000,-98000
055305,旺宏群益99購01  ,0,0,0,0,0,0,0,0,0,-98000,0,0,0,0,98000,-98000,-98000
056356,台積電元大99購01,0,0,0,0,0,0,0,0,0,-98000,0,0,0,117000,215000,-98000,-98000
059805,台積電元富99購02,0,0,0,0,0,0,0,0,0,-98000,0,0,0,2000,100000,-98000,-98000
058775,台積電國票9A購02,0,0,0,0,0,0,0,0,0,-98000,0,0,0,7000,105000,-98000,-98000
058180,華新科國泰9A購01,0,0,0,0,0,0,0,0,0,-98000,0,0,0,125000,223000,-98000,-98000
062669,微星中信03購01  ,0,0,0,0,0,0,0,0,0,-98000,0,0,0,30000,128000,-98000,-98000
063080,裕隆凱基9B購01  ,0,0,0,0,0,0,0,0,0,-98000,0,0,0,10000,108000,-98000,-98000
3094,聯傑            ,32000,130000,-98000,0,0,0,0,0,0,0,0,0,0,0,0,0,-98000
063436,儒鴻統一01購03  ,0,0,0,0,0,0,0,0,0,-99000,0,0,0,21000,120000,-99000,-99000
07360P,台積電元大99售46,0,0,0,0,0,0,0,0,0,-99000,0,0,0,1000,100000,-99000,-99000
056227,奇力新凱基98購04,0,0,0,0,0,0,0,0,0,-99000,0,0,0,0,99000,-99000,-99000
056611,國巨永豐98購03  ,0,0,0,0,0,0,0,0,0,-99000,0,0,0,0,99000,-99000,-99000
057537,聯茂元大98購04  ,0,0,0,0,0,0,0,0,0,-99000,0,0,0,69000,168000,-99000,-99000
057788,嘉聯益國票99購01,0,0,0,0,0,0,0,0,0,-99000,0,0,0,57000,156000,-99000,-99000
060240,富邦金元大9A購01,0,0,0,0,0,0,0,0,0,-99000,0,0,0,124000,223000,-99000,-99000
059410,滬深2X國票9A購04,0,0,0,0,0,0,0,0,0,-99000,0,0,0,0,99000,-99000,-99000
059795,鴻海國票99購07  ,0,0,0,0,0,0,0,0,0,-99000,0,0,0,5000,104000,-99000,-99000
062842,臺股指群益9B購09,0,0,0,0,0,0,0,0,0,-99000,0,0,0,1000,100000,-99000,-99000
061147,上証2X群益9C購06,0,0,0,0,0,0,0,0,0,-99000,0,0,0,0,99000,-99000,-99000
060685,康友元大9A購01  ,0,0,0,0,0,0,0,0,0,-99000,0,0,0,50000,149000,-99000,-99000
07390P,華新科康和99售02,0,0,0,0,0,0,0,0,0,-100000,0,0,0,0,100000,-100000,-100000
08075P,聯電群益9C售01  ,0,0,0,0,0,0,0,0,0,-100000,0,0,0,0,100000,-100000,-100000
07874P,長榮航群益9B售01,0,0,0,0,0,0,0,0,0,-100000,0,0,0,0,100000,-100000,-100000
063730,台積電元大9B購09,0,0,0,0,0,0,0,0,0,-100000,0,0,0,0,100000,-100000,-100000
07093P,台積電凱基99售07,0,0,0,0,0,0,0,0,0,-100000,0,0,0,0,100000,-100000,-100000
07189P,聯發科富邦9B售03,0,0,0,0,0,0,0,0,0,-100000,0,0,0,0,100000,-100000,-100000
06961P,台積電凱基99售05,0,0,0,0,0,0,0,0,0,-100000,0,0,0,0,100000,-100000,-100000
063961,世紀鋼元大9C購05,0,0,0,0,0,0,0,0,0,-100000,0,0,0,0,100000,-100000,-100000
056643,奇力新凱基99購01,0,0,0,0,0,0,0,0,0,-100000,0,0,0,0,100000,-100000,-100000
056012,勤誠中信99購01  ,0,0,0,0,0,0,0,0,0,-100000,0,0,0,0,100000,-100000,-100000
059203,勤誠永豐99購02  ,0,0,0,0,0,0,0,0,0,-100000,0,0,0,10000,110000,-100000,-100000
059042,世紀鋼群益99購02,0,0,0,0,0,0,0,0,0,-100000,0,0,0,0,100000,-100000,-100000
055006,晶相光元富9A購01,0,0,0,0,0,0,0,0,0,-100000,0,0,0,0,100000,-100000,-100000
054876,群電群益97購02  ,0,0,0,0,0,0,0,0,0,-100000,0,0,0,0,100000,-100000,-100000
054308,嘉晶凱基98購01  ,0,0,0,0,0,0,0,0,0,-100000,0,0,0,0,100000,-100000,-100000
054427,潤泰全富邦97購01,0,0,0,0,0,0,0,0,0,-100000,0,0,0,0,100000,-100000,-100000
054526,道瓊反統一98購01,0,0,0,0,0,0,0,0,0,-100000,0,0,0,0,100000,-100000,-100000
053221,彩晶凱基98購01  ,0,0,0,0,0,0,0,0,0,-100000,0,0,0,0,100000,-100000,-100000
052931,麗豐元大97購01  ,0,0,0,0,0,0,0,0,0,-100000,0,0,0,0,100000,-100000,-100000
054005,旺宏統一97購04  ,0,0,0,0,0,0,0,0,0,-100000,0,0,0,0,100000,-100000,-100000
060054,華新科凱基9B購04,0,0,0,0,0,0,0,0,0,-100000,0,0,0,0,100000,-100000,-100000
060299,友訊國泰9B購01  ,0,0,0,0,0,0,0,0,0,-100000,0,0,0,0,100000,-100000,-100000
060349,上証2X元富9A購04,0,0,0,0,0,0,0,0,0,-100000,0,0,0,0,100000,-100000,-100000
060368,緯穎元富9A購03  ,0,0,0,0,0,0,0,0,0,-100000,0,0,0,0,100000,-100000,-100000
060410,台苯永豐9A購01  ,0,0,0,0,0,0,0,0,0,-100000,0,0,0,0,100000,-100000,-100000
058246,帆宣元大99購01  ,0,0,0,0,0,0,0,0,0,-100000,0,0,0,1000,101000,-100000,-100000
057601,中磊群益98購01  ,0,0,0,0,0,0,0,0,0,-100000,0,0,0,0,100000,-100000,-100000
058729,國巨永豐99購03  ,0,0,0,0,0,0,0,0,0,-100000,0,0,0,0,100000,-100000,-100000
05841P,華通元大96售04  ,0,0,0,0,0,0,0,0,0,-100000,0,0,0,0,100000,-100000,-100000
058493,台積電群益9A購01,0,0,0,0,0,0,0,0,0,-100000,0,0,0,0,100000,-100000,-100000
06082P,華通統一98售01  ,0,0,0,0,0,0,0,0,0,-100000,0,0,0,0,100000,-100000,-100000
061026,南電富邦9B購01  ,0,0,0,0,0,0,0,0,0,-100000,0,0,0,0,100000,-100000,-100000
061572,奇力新元大9A購04,0,0,0,0,0,0,0,0,0,-100000,0,0,0,0,100000,-100000,-100000
061739,奇力新凱基9C購01,0,0,0,0,0,0,0,0,0,-100000,0,0,0,0,100000,-100000,-100000
063015,微星元大9B購01  ,0,0,0,0,0,0,0,0,0,-100000,0,0,0,0,100000,-100000,-100000
063213,智伸科國票9C購01,0,0,0,0,0,0,0,0,0,-100000,0,0,0,77000,177000,-100000,-100000
063108,世紀鋼群益9C購01,0,0,0,0,0,0,0,0,0,-100000,0,0,0,0,100000,-100000,-100000
06206P,台積電凱基97售11,0,0,0,0,0,0,0,0,0,-100000,0,0,0,0,100000,-100000,-100000
062492,牧德第一9B購01  ,0,0,0,0,0,0,0,0,0,-100000,0,0,0,0,100000,-100000,-100000
062484,臺股指國票9B購10,0,0,0,0,0,0,0,0,0,-100000,0,0,0,0,100000,-100000,-100000
062311,奇力新凱基9B購01,0,0,0,0,0,0,0,0,0,-100000,0,0,0,0,100000,-100000,-100000
3338,泰碩            ,253000,235000,18000,0,0,0,0,0,0,-118000,1000,10000,-9000,22000,131000,-109000,-100000
6176,瑞儀            ,777100,1627000,-849900,0,0,0,296000,2000,294000,455000,657000,24000,633000,9000,187000,-178000,-100900
063570,嘉晶元大9C購02  ,0,0,0,0,0,0,0,0,0,-101000,0,0,0,236000,337000,-101000,-101000
063662,上銀統一01購03  ,0,0,0,0,0,0,0,0,0,-101000,0,0,0,0,101000,-101000,-101000
063239,建準元大9B購01  ,0,0,0,0,0,0,0,0,0,-101000,0,0,0,91000,192000,-101000,-101000
07992P,玉晶光群益01售04,0,0,0,0,0,0,0,0,0,-101000,0,0,0,0,101000,-101000,-101000
08273P,國巨元富9C售02  ,0,0,0,0,0,0,0,0,0,-101000,0,0,0,0,101000,-101000,-101000
060437,宏全永豐9A購01  ,0,0,0,0,0,0,0,0,0,-101000,0,0,0,0,101000,-101000,-101000
057937,神達群益98購02  ,0,0,0,0,0,0,0,0,0,-101000,0,0,0,97000,198000,-101000,-101000
059400,滬深2X元富9C購04,0,0,0,0,0,0,0,0,0,-101000,0,0,0,0,101000,-101000,-101000
057225,華新凱基98購01  ,0,0,0,0,0,0,0,0,0,-101000,0,0,0,40000,141000,-101000,-101000
062882,新日興兆豐9C購01,0,0,0,0,0,0,0,0,0,-101000,0,0,0,70000,171000,-101000,-101000
061580,華擎元大9A購06  ,0,0,0,0,0,0,0,0,0,-101000,0,0,0,84000,185000,-101000,-101000
061075,亞德客兆豐9A購01,0,0,0,0,0,0,0,0,0,-101000,0,0,0,4000,105000,-101000,-101000
060700,華新科國泰9C購01,0,0,0,0,0,0,0,0,0,-101000,0,0,0,69000,170000,-101000,-101000
060503,技嘉元大9A購01  ,0,0,0,0,0,0,0,0,0,-101000,0,0,0,15000,116000,-101000,-101000
063427,南六凱基9B購04  ,0,0,0,0,0,0,0,0,0,-102000,0,0,0,63000,165000,-102000,-102000
06996P,臺股指凱基99售17,0,0,0,0,0,0,0,0,0,-102000,0,0,0,10000,112000,-102000,-102000
02001R,富邦蘋果反一N   ,0,0,0,0,0,0,0,0,0,-102000,0,0,0,10000,112000,-102000,-102000
055594,華新科元大98購02,0,0,0,0,0,0,0,0,0,-102000,0,0,0,14000,116000,-102000,-102000
055777,冠德凱基97購01  ,0,0,0,0,0,0,0,0,0,-102000,0,0,0,40000,142000,-102000,-102000
058061,貿聯元富9B購01  ,0,0,0,0,0,0,0,0,0,-102000,0,0,0,18000,120000,-102000,-102000
058048,群創元大9B購07  ,0,0,0,0,0,0,0,0,0,-102000,0,0,0,20000,122000,-102000,-102000
057416,T50反1凱基9C購01,0,0,0,0,0,0,0,0,0,-102000,0,0,0,0,102000,-102000,-102000
058190,貿聯永豐99購01  ,0,0,0,0,0,0,0,0,0,-102000,0,0,0,0,102000,-102000,-102000
061914,台光電中信9B購01,0,0,0,0,0,0,0,0,0,-102000,0,0,0,8000,110000,-102000,-102000
063952,玉晶光元大01購01,0,0,0,0,0,0,0,0,0,-103000,0,0,0,5000,108000,-103000,-103000
063270,喬山兆豐9C購01  ,0,0,0,0,0,0,0,0,0,-103000,0,0,0,38000,141000,-103000,-103000
063359,泰鼎國泰01購01  ,0,0,0,0,0,0,0,0,0,-103000,0,0,0,29000,132000,-103000,-103000
063595,燿華中信9B購02  ,0,0,0,0,0,0,0,0,0,-103000,0,0,0,8000,111000,-103000,-103000
1315,達新            ,153000,265000,-112000,0,0,0,0,0,0,9000,3000,0,3000,6000,0,6000,-103000
058203,信邦凱基99購01  ,0,0,0,0,0,0,0,0,0,-103000,0,0,0,80000,183000,-103000,-103000
058422,百和麥證99購01  ,0,0,0,5000,108000,-103000,0,0,0,-103000,0,0,0,5000,108000,-103000,-103000
060246,晶相光元大9C購03,0,0,0,0,0,0,0,0,0,-103000,0,0,0,73000,176000,-103000,-103000
061677,泰碩元大9A購05  ,0,0,0,0,0,0,0,0,0,-103000,0,0,0,187000,290000,-103000,-103000
061318,智邦凱基9B購01  ,0,0,0,0,0,0,0,0,0,-103000,0,0,0,61000,164000,-103000,-103000
060509,宏達電元大9A購02,0,0,0,0,0,0,0,0,0,-103000,0,0,0,0,103000,-103000,-103000
060644,泰鼎永豐9A購02  ,0,0,0,0,0,0,0,0,0,-103000,0,0,0,35000,138000,-103000,-103000
060681,華擎元大9A購02  ,0,0,0,0,0,0,0,0,0,-103000,0,0,0,23000,126000,-103000,-103000
062409,巨大永豐9B購02  ,0,0,0,0,0,0,0,0,0,-103000,0,0,0,141000,244000,-103000,-103000
063848,大立光元大9C購09,0,0,0,0,0,0,0,0,0,-104000,0,0,0,8000,112000,-104000,-104000
00714,群益道瓊美國地產,0,0,0,0,0,0,0,0,0,-104000,0,0,0,0,104000,-104000,-104000
058955,台積電國票9A購04,0,0,0,0,0,0,0,0,0,-104000,0,0,0,19000,123000,-104000,-104000
057364,國巨元大98購18  ,0,0,0,0,0,0,0,0,0,-104000,0,0,0,1000,105000,-104000,-104000
057609,友訊元富98購01  ,0,0,0,0,0,0,0,0,0,-104000,0,0,0,113000,217000,-104000,-104000
062226,臻鼎統一9B購01  ,0,0,0,0,0,0,0,0,0,-104000,0,0,0,80000,184000,-104000,-104000
062988,儒鴻群益9B購01  ,0,0,0,0,0,0,0,0,0,-104000,0,0,0,0,104000,-104000,-104000
3532,台勝科          ,167000,72000,95000,0,0,0,0,0,0,-199000,6000,0,6000,7000,212000,-205000,-104000
063651,金像電台新9B購01,0,0,0,0,0,0,0,0,0,-105000,0,0,0,0,105000,-105000,-105000
063412,寶成國票9C購01  ,0,0,0,0,0,0,0,0,0,-105000,0,0,0,34000,139000,-105000,-105000
063951,新日興元大9C購01,0,0,0,0,0,0,0,0,0,-105000,0,0,0,0,105000,-105000,-105000
00683L,元大美元指數正2 ,0,0,0,0,0,0,0,0,0,-105000,0,0,0,0,105000,-105000,-105000
053510,聯電群益97購01  ,0,0,0,0,0,0,0,0,0,-105000,0,0,0,95000,200000,-105000,-105000
053036,聯電凱基98購01  ,0,0,0,0,0,0,0,0,0,-105000,0,0,0,0,105000,-105000,-105000
058140,臻鼎元大99購02  ,0,0,0,0,0,0,0,0,0,-105000,0,0,0,26000,131000,-105000,-105000
057453,矽創元富98購01  ,0,0,0,0,0,0,0,0,0,-105000,0,0,0,20000,125000,-105000,-105000
057401,晶豪科群益99購01,0,0,0,0,0,0,0,0,0,-105000,0,0,0,0,105000,-105000,-105000
6558,興能高          ,179600,286000,-106400,0,0,0,0,0,0,1000,1000,0,1000,0,0,0,-105400
2929,淘帝-KY         ,106000,211552,-105552,0,0,0,0,0,0,0,0,0,0,0,0,0,-105552
063953,世芯元大01購01  ,1000,0,1000,0,0,0,0,0,0,-107000,0,0,0,2000,109000,-107000,-106000
2348,海悅            ,175000,280000,-105000,0,0,0,0,0,0,-1000,0,1000,-1000,0,0,0,-106000
057393,台積電中信02購01,0,0,0,0,0,0,0,0,0,-106000,0,0,0,0,106000,-106000,-106000
058431,國巨統一9B購01  ,0,0,0,0,0,0,0,0,0,-106000,0,0,0,40000,146000,-106000,-106000
058540,嘉聯益國泰9A購02,0,0,0,0,0,0,0,0,0,-106000,0,0,0,99000,205000,-106000,-106000
057112,立積群益99購01  ,0,0,0,0,0,0,0,0,0,-106000,0,0,0,22000,128000,-106000,-106000
057971,華新科富邦9B購02,0,0,0,0,0,0,0,0,0,-106000,0,0,0,30000,136000,-106000,-106000
059453,奇力新永豐99購01,0,0,0,0,0,0,0,0,0,-106000,0,0,0,0,106000,-106000,-106000
062719,微星凱基9B購01  ,0,0,0,0,0,0,0,0,0,-106000,0,0,0,0,106000,-106000,-106000
062416,和大統一01購02  ,0,0,0,0,0,0,0,0,0,-106000,0,0,0,10000,116000,-106000,-106000
062495,友達中信01購02  ,0,0,0,0,0,0,0,0,0,-106000,0,0,0,10000,116000,-106000,-106000
060736,旺宏統一01購01  ,0,0,0,0,0,0,0,0,0,-106000,0,0,0,21000,127000,-106000,-106000
061708,同欣電國票9A購02,0,0,0,0,0,0,0,0,0,-106000,0,0,0,65000,171000,-106000,-106000
08057P,京鼎群益9B售01  ,0,0,0,0,0,0,0,0,0,-107000,0,0,0,0,107000,-107000,-107000
07648P,祥碩國票9B售01  ,0,0,0,0,0,0,0,0,0,-107000,0,0,0,571000,678000,-107000,-107000
07082P,美律元大99售06  ,0,0,0,0,0,0,0,0,0,-107000,0,0,0,0,107000,-107000,-107000
063736,大立光元大9B購08,0,0,0,0,0,0,0,0,0,-107000,0,0,0,6000,113000,-107000,-107000
057630,茂林永豐98購01  ,0,0,0,0,0,0,0,0,0,-107000,0,0,0,0,107000,-107000,-107000
058309,大毅元大99購02  ,0,0,0,0,0,0,0,0,0,-107000,0,0,0,13000,120000,-107000,-107000
061741,新光金凱基9B購01,0,0,0,0,0,0,0,0,0,-107000,0,0,0,10000,117000,-107000,-107000
061564,華擎國票9A購02  ,0,0,0,0,0,0,0,0,0,-107000,0,0,0,10000,117000,-107000,-107000
061121,智邦永豐9A購02  ,0,0,0,0,0,0,0,0,0,-107000,0,0,0,27000,134000,-107000,-107000
061256,亞德客凱基9B購01,0,0,0,0,0,0,0,0,0,-107000,0,0,0,0,107000,-107000,-107000
062353,亞德客元大9B購01,0,0,0,0,0,0,0,0,0,-107000,0,0,0,79000,186000,-107000,-107000
062894,道瓊銀元大9B購02,0,0,0,0,0,0,0,0,0,-107000,0,0,0,40000,147000,-107000,-107000
063245,富邦金元大9B購03,0,0,0,0,0,0,0,0,0,-108000,0,0,0,35000,143000,-108000,-108000
063861,南亞科國泰02購01,0,0,0,0,0,0,0,0,0,-108000,0,0,0,25000,133000,-108000,-108000
07945P,上銀國票9B售02  ,0,0,0,0,0,0,0,0,0,-108000,0,0,0,53000,161000,-108000,-108000
1447,力鵬            ,150000,269000,-119000,0,0,0,0,0,0,11000,11000,0,11000,0,0,0,-108000
054063,聯茂國票97購02  ,0,0,0,0,0,0,0,0,0,-108000,0,0,0,0,108000,-108000,-108000
051739,奇力新國票97購01,0,0,0,0,0,0,0,0,0,-108000,0,0,0,0,108000,-108000,-108000
055705,微星永豐97購01  ,0,0,0,0,0,0,0,0,0,-108000,0,0,0,0,108000,-108000,-108000
054527,國巨統一97購03  ,0,0,0,0,0,0,0,0,0,-108000,0,0,0,250000,358000,-108000,-108000
05711P,茂林國票97售03  ,0,0,0,0,0,0,0,0,0,-108000,0,0,0,30000,138000,-108000,-108000
058371,智原凱基9A購01  ,0,0,0,0,0,0,0,0,0,-108000,0,0,0,57000,165000,-108000,-108000
058604,華邦電元大99購03,0,0,0,0,0,0,0,0,0,-108000,0,0,0,7000,115000,-108000,-108000
057812,友達元大9A購05  ,0,0,0,0,0,0,0,0,0,-108000,0,0,0,165000,273000,-108000,-108000
061183,友達國泰9B購02  ,0,0,0,0,0,0,0,0,0,-108000,0,0,0,72000,180000,-108000,-108000
061120,台積電永豐9A購03,0,0,0,0,0,0,0,0,0,-108000,0,0,0,0,108000,-108000,-108000
063282,奇力新元大9B購06,0,0,0,0,0,0,0,0,0,-109000,0,0,0,10000,119000,-109000,-109000
056107,智易永豐97購02  ,0,0,0,0,0,0,0,0,0,-109000,0,0,0,10000,119000,-109000,-109000
060093,友達元大03購01  ,0,0,0,0,0,0,0,0,0,-109000,0,0,0,102000,211000,-109000,-109000
060204,矽創元富9A購01  ,0,0,0,0,0,0,0,0,0,-109000,0,0,0,12000,121000,-109000,-109000
060413,東元永豐9A購01  ,0,0,0,0,0,0,0,0,0,-109000,0,0,0,0,109000,-109000,-109000
063458,正隆元大9B購01  ,0,0,0,0,0,0,0,0,0,-110000,0,0,0,10000,120000,-110000,-110000
063683,大成鋼永豐9B購01,0,0,0,0,0,0,0,0,0,-110000,0,0,0,12000,122000,-110000,-110000
07703P,玉晶光中信9B售03,0,0,0,0,0,0,0,0,0,-110000,0,0,0,0,110000,-110000,-110000
054778,世紀鋼國票99購01,0,0,0,0,0,0,0,0,0,-110000,0,0,0,0,110000,-110000,-110000
055039,神達富邦99購01  ,0,0,0,0,0,0,0,0,0,-110000,0,0,0,200000,310000,-110000,-110000
060414,中興電永豐9A購01,0,0,0,0,0,0,0,0,0,-110000,0,0,0,0,110000,-110000,-110000
060419,漢翔永豐9A購01  ,0,0,0,0,0,0,0,0,0,-110000,0,0,0,0,110000,-110000,-110000
057481,技嘉元大98購04  ,0,0,0,0,0,0,0,0,0,-110000,0,0,0,0,110000,-110000,-110000
056913,臺股指元大99購05,0,0,0,0,0,0,0,0,0,-110000,0,0,0,0,110000,-110000,-110000
058884,世紀鋼永豐99購02,0,0,0,0,0,0,0,0,0,-110000,0,0,0,20000,130000,-110000,-110000
060835,亞德客國票9A購01,0,0,0,0,0,0,0,0,0,-110000,0,0,0,26000,136000,-110000,-110000
061308,元金2X中信9A購01,0,0,0,0,0,0,0,0,0,-110000,0,0,0,0,110000,-110000,-110000
063281,京元電元大9B購01,0,0,0,0,0,0,0,0,0,-111000,0,0,0,56000,167000,-111000,-111000
06615P,鴻海元大9C售02  ,0,0,0,0,0,0,0,0,0,-111000,0,0,0,0,111000,-111000,-111000
053770,元金2X元大98購01,0,0,0,0,0,0,0,0,0,-111000,0,0,0,4000,115000,-111000,-111000
060569,台積電永豐9A購01,0,0,0,0,0,0,0,0,0,-111000,0,0,0,0,111000,-111000,-111000
061180,華擎凱基9B購01  ,0,0,0,0,0,0,0,0,0,-111000,0,0,0,5000,116000,-111000,-111000
062682,全新統一9B購01  ,0,0,0,0,0,0,0,0,0,-111000,0,0,0,14000,125000,-111000,-111000
062427,嘉澤統一01購01  ,0,0,0,0,0,0,0,0,0,-111000,0,0,0,31000,142000,-111000,-111000
3450,聯鈞            ,256000,284000,-28000,0,0,0,26000,0,26000,-109000,25000,3000,22000,4000,135000,-131000,-111000
8261,富鼎            ,45000,158000,-113000,0,0,0,0,0,0,2000,3000,1000,2000,0,0,0,-111000
063315,京元電群益9B購03,0,0,0,0,0,0,0,0,0,-112000,0,0,0,98000,210000,-112000,-112000
063420,奇力新凱基9B購03,0,0,0,0,0,0,0,0,0,-112000,0,0,0,0,112000,-112000,-112000
063733,聯發科元大9B購27,0,0,0,0,0,0,0,0,0,-112000,0,0,0,51000,163000,-112000,-112000
053631,欣興兆豐97購01  ,0,0,0,0,0,0,0,0,0,-112000,0,0,0,74000,186000,-112000,-112000
055536,嘉聯益群益99購02,0,0,0,0,0,0,0,0,0,-112000,0,0,0,96000,208000,-112000,-112000
059097,世紀鋼元大99購05,0,0,0,0,0,0,0,0,0,-112000,0,0,0,41000,153000,-112000,-112000
059425,SGBR2X元大9A購02,0,0,0,0,0,0,0,0,0,-112000,0,0,0,270000,382000,-112000,-112000
058781,康友國票9A購01  ,0,0,0,0,0,0,0,0,0,-112000,0,0,0,47000,159000,-112000,-112000
058797,大毅元大99購03  ,0,0,0,0,0,0,0,0,0,-112000,0,0,0,61000,173000,-112000,-112000
059832,超眾康和99購01  ,0,0,0,0,0,0,0,0,0,-112000,0,0,0,50000,162000,-112000,-112000
060375,葡萄王元富9A購01,0,0,0,0,0,0,0,0,0,-112000,0,0,0,98000,210000,-112000,-112000
060367,緯穎元富9A購02  ,0,0,0,0,0,0,0,0,0,-112000,0,0,0,70000,182000,-112000,-112000
063147,東元元富9B購01  ,0,0,0,0,0,0,0,0,0,-112000,0,0,0,174000,286000,-112000,-112000
060573,力成永豐9A購01  ,0,0,0,0,0,0,0,0,0,-112000,0,0,0,36000,148000,-112000,-112000
061432,世紀鋼元大9A購05,0,0,0,0,0,0,0,0,0,-112000,0,0,0,0,112000,-112000,-112000
061581,貿聯元大9A購05  ,0,0,0,0,0,0,0,0,0,-112000,0,0,0,131000,243000,-112000,-112000
061462,國巨群益9A購11  ,0,0,0,0,0,0,0,0,0,-112000,0,0,0,68000,180000,-112000,-112000
063653,儒鴻元富9B購01  ,0,0,0,0,0,0,0,0,0,-113000,0,0,0,0,113000,-113000,-113000
2911,麗嬰房          ,33000,148000,-115000,0,0,0,0,0,0,2000,2000,0,2000,0,0,0,-113000
054383,傳奇群益97購01  ,0,0,0,0,0,0,0,0,0,-113000,0,0,0,0,113000,-113000,-113000
053107,旺宏兆豐97購01  ,0,0,0,0,0,0,0,0,0,-113000,0,0,0,10000,123000,-113000,-113000
058925,旭富元富99購02  ,0,0,0,0,0,0,0,0,0,-113000,0,0,0,160000,273000,-113000,-113000
3533,嘉澤            ,567000,597000,-30000,0,0,0,152000,304000,-152000,69000,93000,24000,69000,10000,10000,0,-113000
08095P,大立光元富9B售03,0,0,0,0,0,0,0,0,0,-114000,0,0,0,0,114000,-114000,-114000
06603P,立積統一99售01  ,0,0,0,0,0,0,0,0,0,-114000,0,0,0,63000,177000,-114000,-114000
053249,致伸國票97購02  ,0,0,0,0,0,0,0,0,0,-114000,0,0,0,0,114000,-114000,-114000
058589,群創中信01購01  ,0,0,0,0,0,0,0,0,0,-114000,0,0,0,48000,162000,-114000,-114000
058204,世芯凱基9A購01  ,0,0,0,0,0,0,0,0,0,-114000,0,0,0,55000,169000,-114000,-114000
060251,易華電元大9C購01,0,0,0,0,0,0,0,0,0,-114000,0,0,0,34000,148000,-114000,-114000
061435,元金2X凱基9C購03,0,0,0,0,0,0,0,0,0,-114000,0,0,0,20000,134000,-114000,-114000
060570,南亞科永豐9A購01,0,0,0,0,0,0,0,0,0,-114000,0,0,0,0,114000,-114000,-114000
8271,宇瞻            ,160000,291000,-131000,0,0,0,0,0,0,17000,19000,2000,17000,0,0,0,-114000
06877P,台積電兆豐98售04,0,0,0,0,0,0,0,0,0,-115000,0,0,0,1110000,1225000,-115000,-115000
07713P,台郡元大9A售03  ,0,0,0,0,0,0,0,0,0,-115000,0,0,0,0,115000,-115000,-115000
052578,大立光統一97購01,0,0,0,0,0,0,0,0,0,-115000,0,0,0,10000,125000,-115000,-115000
057298,旭富永豐98購01  ,0,0,0,0,0,0,0,0,0,-115000,0,0,0,217000,332000,-115000,-115000
057120,茂林康和98購01  ,0,0,0,0,0,0,0,0,0,-115000,0,0,0,0,115000,-115000,-115000
060762,長榮航元大9A購02,0,0,0,0,0,0,0,0,0,-115000,0,0,0,60000,175000,-115000,-115000
06173P,華通元大97售02  ,0,0,0,0,0,0,0,0,0,-115000,0,0,0,0,115000,-115000,-115000
063202,南亞科統一9C購02,0,0,0,0,0,0,0,0,0,-115000,0,0,0,275000,390000,-115000,-115000
063568,高鐵元大9B購01  ,0,0,0,0,0,0,0,0,0,-116000,0,0,0,134000,250000,-116000,-116000
055112,晶豪科凱基98購01,0,0,0,0,0,0,0,0,0,-116000,0,0,0,0,116000,-116000,-116000
056712,京鼎永豐98購01  ,0,0,0,0,0,0,0,0,0,-116000,0,0,0,62000,178000,-116000,-116000
060962,義隆凱基9B購01  ,1000,0,1000,0,0,0,0,0,0,-117000,0,0,0,415000,532000,-117000,-116000
058188,華擎永豐99購01  ,0,0,0,0,0,0,0,0,0,-116000,0,0,0,266000,382000,-116000,-116000
058531,華通元富99購01  ,0,0,0,0,0,0,0,0,0,-116000,0,0,0,12000,128000,-116000,-116000
062312,大立光凱基9B購03,0,0,0,0,0,0,0,0,0,-116000,0,0,0,4000,120000,-116000,-116000
06763P,技嘉元大98售05  ,0,0,0,0,0,0,0,0,0,-117000,0,0,0,3000,120000,-117000,-117000
055803,鎧勝永豐97購01  ,0,0,0,0,0,0,0,0,0,-117000,0,0,0,37000,154000,-117000,-117000
055344,國巨凱基97購04  ,0,0,0,0,0,0,0,0,0,-117000,0,0,0,3000,120000,-117000,-117000
05755P,臺股指中信99售04,0,0,0,0,0,0,0,0,0,-117000,0,0,0,49000,166000,-117000,-117000
057011,日月光中信99購01,0,0,0,0,0,0,0,0,0,-117000,0,0,0,3000,120000,-117000,-117000
057138,亞德客兆豐98購01,0,0,0,0,0,0,0,0,0,-117000,0,0,0,0,117000,-117000,-117000
057197,立積台新98購01  ,0,0,0,0,0,0,0,0,0,-117000,0,0,0,166000,283000,-117000,-117000
060505,友達元大9C購05  ,0,0,0,0,0,0,0,0,0,-117000,0,0,0,136000,253000,-117000,-117000
061149,華通群益9A購05  ,0,0,0,0,0,0,0,0,0,-117000,0,0,0,50000,167000,-117000,-117000
063288,泰鼎元大9B購02  ,0,0,0,0,0,0,0,0,0,-118000,0,0,0,41000,159000,-118000,-118000
053887,聯茂兆豐97購02  ,0,0,0,0,0,0,0,0,0,-118000,0,0,0,64000,182000,-118000,-118000
059189,國泰金富邦9B購01,0,0,0,0,0,0,0,0,0,-118000,0,0,0,172000,290000,-118000,-118000
060016,廣達康和99購01  ,0,0,0,0,0,0,0,0,0,-118000,0,0,0,26000,144000,-118000,-118000
058748,景碩凱基9A購01  ,0,0,0,0,0,0,0,0,0,-118000,0,0,0,37000,155000,-118000,-118000
063566,台光電元大9B購08,0,0,0,0,0,0,0,0,0,-119000,0,0,0,51000,170000,-119000,-119000
059115,美食永豐99購01  ,0,0,0,0,0,0,0,0,0,-119000,0,0,0,43000,162000,-119000,-119000
056584,鴻海統一9B購01  ,0,0,0,0,0,0,0,0,0,-119000,0,0,0,986000,1105000,-119000,-119000
057397,茂林中信9A購01  ,0,0,0,0,0,0,0,0,0,-119000,0,0,0,0,119000,-119000,-119000
05729P,臺股指凱基97售02,0,0,0,0,0,0,0,0,0,-119000,0,0,0,2000,121000,-119000,-119000
060995,泰鼎元大9A購03  ,0,0,0,0,0,0,0,0,0,-119000,0,0,0,0,119000,-119000,-119000
06608P,立積群益99售02  ,0,0,0,0,0,0,0,0,0,-120000,0,0,0,45000,165000,-120000,-120000
07020P,玉晶光台新99售02,0,0,0,0,0,0,0,0,0,-120000,0,0,0,0,120000,-120000,-120000
07795P,美律國票9A售03  ,0,0,0,0,0,0,0,0,0,-120000,0,0,0,0,120000,-120000,-120000
057312,美律麥證98購01  ,0,0,0,0,120000,-120000,0,0,0,-120000,0,0,0,0,120000,-120000,-120000
059763,華擎永豐99購03  ,0,0,0,0,0,0,0,0,0,-120000,0,0,0,0,120000,-120000,-120000
057395,旺宏中信98購03  ,0,0,0,0,0,0,0,0,0,-120000,0,0,0,0,120000,-120000,-120000
058559,華新科日盛99購02,0,0,0,0,0,0,0,0,0,-120000,0,0,0,0,120000,-120000,-120000
057890,滬深反統一98購01,0,0,0,0,0,0,0,0,0,-120000,0,0,0,0,120000,-120000,-120000
058338,康友元富99購01  ,0,0,0,0,0,0,0,0,0,-120000,0,0,0,10000,130000,-120000,-120000
061228,聯茂中信9A購01  ,0,0,0,0,0,0,0,0,0,-120000,0,0,0,0,120000,-120000,-120000
061772,健策元大9B購06  ,0,0,0,0,0,0,0,0,0,-120000,0,0,0,9000,129000,-120000,-120000
061265,富邦金凱基9B購01,0,0,0,0,0,0,0,0,0,-120000,0,0,0,3000,123000,-120000,-120000
062120,國巨台新9B購01  ,0,0,0,0,0,0,0,0,0,-120000,0,0,0,1000,121000,-120000,-120000
063116,大立光麥證9C購01,0,0,0,0,120000,-120000,0,0,0,-120000,0,0,0,0,120000,-120000,-120000
1507,永大            ,93000,281000,-188000,0,0,0,0,0,0,67000,71000,4000,67000,0,0,0,-121000
063883,超眾元富9C購02  ,0,0,0,0,0,0,0,0,0,-121000,0,0,0,20000,141000,-121000,-121000
055104,台達電凱基98購01,0,0,0,0,0,0,0,0,0,-121000,0,0,0,46000,167000,-121000,-121000
056116,義隆群益97購02  ,0,0,0,0,0,0,0,0,0,-121000,0,0,0,0,121000,-121000,-121000
053867,創意元大96購04  ,0,0,0,0,0,0,0,0,0,-121000,0,0,0,25000,146000,-121000,-121000
056397,彩晶永豐99購01  ,0,0,0,0,0,0,0,0,0,-121000,0,0,0,0,121000,-121000,-121000
058771,神達兆豐99購01  ,0,0,0,0,0,0,0,0,0,-121000,0,0,0,66000,187000,-121000,-121000
056991,牧德兆豐98購01  ,0,0,0,0,0,0,0,0,0,-121000,0,0,0,388000,509000,-121000,-121000
062990,台積電群益9B購06,0,0,0,0,0,0,0,0,0,-121000,0,0,0,34000,155000,-121000,-121000
3406,玉晶光          ,1245000,2148000,-903000,0,0,0,647000,0,647000,135000,244000,102000,142000,131000,138000,-7000,-121000
063529,聯茂凱基9B購02  ,0,0,0,0,0,0,0,0,0,-122000,0,0,0,0,122000,-122000,-122000
07994P,臺股指群益9B售04,0,0,0,0,0,0,0,0,0,-122000,0,0,0,3000,125000,-122000,-122000
00875,國泰網路資安    ,129000,3000,126000,0,0,0,0,0,0,-248000,0,0,0,497000,745000,-248000,-122000
059947,貿聯永豐99購03  ,0,0,0,0,0,0,0,0,0,-122000,0,0,0,16000,138000,-122000,-122000
059283,康友永豐99購02  ,0,0,0,0,0,0,0,0,0,-122000,0,0,0,4000,126000,-122000,-122000
062934,大成鋼凱基9B購02,0,0,0,0,0,0,0,0,0,-122000,0,0,0,81000,203000,-122000,-122000
062676,南六台新9B購01  ,0,0,0,0,0,0,0,0,0,-122000,0,0,0,74000,196000,-122000,-122000
061275,臺股指凱基9A購25,0,0,0,0,0,0,0,0,0,-122000,0,0,0,35000,157000,-122000,-122000
063258,緯穎國泰9C購01  ,0,0,0,0,0,0,0,0,0,-123000,0,0,0,17000,140000,-123000,-123000
05624P,同欣電中信98售01,0,0,0,0,0,0,0,0,0,-123000,0,0,0,38000,161000,-123000,-123000
059942,全新永豐99購04  ,0,0,0,0,0,0,0,0,0,-123000,0,0,0,0,123000,-123000,-123000
061140,華擎統一9C購01  ,0,0,0,0,0,0,0,0,0,-123000,0,0,0,31000,154000,-123000,-123000
062648,聯茂富邦9B購01  ,0,0,0,0,0,0,0,0,0,-123000,0,0,0,0,123000,-123000,-123000
062920,康友元大9B購01  ,0,0,0,0,0,0,0,0,0,-123000,0,0,0,76000,199000,-123000,-123000
062380,巨大元大9B購01  ,0,0,0,0,0,0,0,0,0,-123000,0,0,0,50000,173000,-123000,-123000
08092P,仁寶元富9B售02  ,0,0,0,0,0,0,0,0,0,-124000,0,0,0,0,124000,-124000,-124000
07695P,台郡元大9A售02  ,0,0,0,0,0,0,0,0,0,-124000,0,0,0,0,124000,-124000,-124000
054795,合勤控群益98購01,0,0,0,0,0,0,0,0,0,-124000,0,0,0,0,124000,-124000,-124000
056994,緯穎兆豐98購02  ,0,0,0,0,0,0,0,0,0,-124000,0,0,0,21000,145000,-124000,-124000
057071,華擎永豐98購02  ,0,0,0,0,0,0,0,0,0,-124000,0,0,0,22000,146000,-124000,-124000
062720,南亞科凱基9B購03,0,0,0,0,0,0,0,0,0,-124000,0,0,0,0,124000,-124000,-124000
060611,同欣電凱基9A購02,0,0,0,0,0,0,0,0,0,-124000,0,0,0,54000,178000,-124000,-124000
061667,友達中信9A購02  ,0,0,0,0,0,0,0,0,0,-124000,0,0,0,53000,177000,-124000,-124000
07925P,台積電凱基9B售05,0,0,0,0,0,0,0,0,0,-125000,0,0,0,0,125000,-125000,-125000
063295,京元電麥證9B購01,0,0,0,98000,223000,-125000,0,0,0,-125000,0,0,0,98000,223000,-125000,-125000
07146P,瑞昱元大99售02  ,0,0,0,0,0,0,0,0,0,-125000,0,0,0,0,125000,-125000,-125000
055795,茂林國泰98購01  ,0,0,0,0,0,0,0,0,0,-125000,0,0,0,2000,127000,-125000,-125000
060241,國泰金元大9A購01,0,0,0,0,0,0,0,0,0,-125000,0,0,0,80000,205000,-125000,-125000
062752,世芯中信9B購01  ,0,0,0,0,0,0,0,0,0,-125000,0,0,0,392000,517000,-125000,-125000
062764,世芯凱基9B購02  ,0,0,0,0,0,0,0,0,0,-125000,0,0,0,222000,347000,-125000,-125000
06999P,玉晶光國票9B售01,0,0,0,0,0,0,0,0,0,-126000,0,0,0,62000,188000,-126000,-126000
07924P,台積電凱基9B售04,0,0,0,0,0,0,0,0,0,-126000,0,0,0,0,126000,-126000,-126000
058270,上緯控永豐99購01,0,0,0,0,0,0,0,0,0,-126000,0,0,0,24000,150000,-126000,-126000
058692,華邦電國票9B購01,0,0,0,0,0,0,0,0,0,-126000,0,0,0,10000,136000,-126000,-126000
057228,友達凱基9B購01  ,0,0,0,0,0,0,0,0,0,-126000,0,0,0,0,126000,-126000,-126000
061295,台積電國泰9B購02,0,0,0,0,0,0,0,0,0,-126000,0,0,0,72000,198000,-126000,-126000
07729P,臺股指凱基9A售21,0,0,0,0,0,0,0,0,0,-127000,0,0,0,40000,167000,-127000,-127000
055421,玉晶光永豐98購04,0,0,0,0,0,0,0,0,0,-127000,0,0,0,174000,301000,-127000,-127000
062972,京元電元富9B購01,0,0,0,0,0,0,0,0,0,-127000,0,0,0,190000,317000,-127000,-127000
062490,聯茂永豐9B購01  ,0,0,0,0,0,0,0,0,0,-127000,0,0,0,2000,129000,-127000,-127000
063462,金像電元大9C購01,0,0,0,0,0,0,0,0,0,-128000,0,0,0,55000,183000,-128000,-128000
054318,台虹凱基98購01  ,0,0,0,0,0,0,0,0,0,-128000,0,0,0,17000,145000,-128000,-128000
056651,聯茂凱基98購04  ,0,0,0,0,0,0,0,0,0,-128000,0,0,0,0,128000,-128000,-128000
058435,旺宏統一9B購02  ,0,0,0,0,0,0,0,0,0,-128000,0,0,0,0,128000,-128000,-128000
06265P,美律凱基97售01  ,0,0,0,0,0,0,0,0,0,-128000,0,0,0,0,128000,-128000,-128000
063656,台光電元富03購01,0,0,0,0,0,0,0,0,0,-129000,0,0,0,132000,261000,-129000,-129000
07653P,華新科群益9A售05,0,0,0,0,0,0,0,0,0,-129000,0,0,0,110000,239000,-129000,-129000
059016,晶相光元富99購03,0,0,0,0,0,0,0,0,0,-129000,0,0,0,0,129000,-129000,-129000
058421,國泰金麥證01購01,0,0,0,0,129000,-129000,0,0,0,-129000,0,0,0,0,129000,-129000,-129000
060374,儒鴻元富9A購01  ,0,0,0,0,0,0,0,0,0,-129000,0,0,0,212000,341000,-129000,-129000
058995,台達電元大99購01,0,0,0,0,0,0,0,0,0,-129000,0,0,0,105000,234000,-129000,-129000
2436,偉詮電          ,147000,311000,-164000,0,0,0,0,0,0,34000,34000,0,34000,0,0,0,-130000
063834,滬深2X元大01購03,0,0,0,0,0,0,0,0,0,-130000,0,0,0,0,130000,-130000,-130000
056455,群創凱基9A購01  ,0,0,0,0,0,0,0,0,0,-130000,0,0,0,99000,229000,-130000,-130000
054471,T50反1中信9C購01,0,0,0,0,0,0,0,0,0,-130000,0,0,0,0,130000,-130000,-130000
058934,台灣50中信03購03,0,0,0,0,0,0,0,0,0,-130000,0,0,0,0,130000,-130000,-130000
057176,全新元大99購02  ,0,0,0,0,0,0,0,0,0,-130000,0,0,0,100000,230000,-130000,-130000
056943,華通統一99購01  ,0,0,0,0,0,0,0,0,0,-130000,0,0,0,141000,271000,-130000,-130000
057396,健鼎中信99購01  ,0,0,0,0,0,0,0,0,0,-130000,0,0,0,160000,290000,-130000,-130000
062404,新唐永豐9B購01  ,0,0,0,0,0,0,0,0,0,-130000,0,0,0,10000,140000,-130000,-130000
061607,台表科凱基9B購02,0,0,0,0,0,0,0,0,0,-130000,0,0,0,86000,216000,-130000,-130000
063694,貿聯永豐9B購01  ,0,0,0,0,0,0,0,0,0,-131000,0,0,0,10000,141000,-131000,-131000
063473,茂林元大9B購05  ,0,0,0,0,0,0,0,0,0,-131000,0,0,0,38000,169000,-131000,-131000
06456P,聯發科統一98售03,0,0,0,0,0,0,0,0,0,-131000,0,0,0,513000,644000,-131000,-131000
056198,台光電永豐97購02,0,0,0,0,0,0,0,0,0,-131000,0,0,0,34000,165000,-131000,-131000
058556,百和永豐99購01  ,0,0,0,0,0,0,0,0,0,-131000,0,0,0,14000,145000,-131000,-131000
061110,超眾元大9A購03  ,0,0,0,0,0,0,0,0,0,-131000,0,0,0,85000,216000,-131000,-131000
060848,聯茂國票9A購02  ,0,0,0,0,0,0,0,0,0,-131000,0,0,0,44000,175000,-131000,-131000
059939,技嘉永豐99購01  ,0,0,0,0,0,0,0,0,0,-132000,0,0,0,11000,143000,-132000,-132000
062860,華擎國票9B購02  ,0,0,0,0,0,0,0,0,0,-132000,0,0,0,13000,145000,-132000,-132000
07719P,臺股指群益9A售08,0,0,0,0,0,0,0,0,0,-133000,0,0,0,46000,179000,-133000,-133000
056279,新日興富邦99購01,0,0,0,0,0,0,0,0,0,-133000,0,0,0,224000,357000,-133000,-133000
055578,群創統一98購03  ,0,0,0,0,0,0,0,0,0,-133000,0,0,0,0,133000,-133000,-133000
055408,力成國泰98購01  ,0,0,0,0,0,0,0,0,0,-133000,0,0,0,3000,136000,-133000,-133000
060869,超眾永豐9A購02  ,0,0,0,0,0,0,0,0,0,-133000,0,0,0,0,133000,-133000,-133000
060654,大毅群益9B購01  ,0,0,0,0,0,0,0,0,0,-133000,0,0,0,1000,134000,-133000,-133000
063809,矽創兆豐01購01  ,0,0,0,0,0,0,0,0,0,-134000,0,0,0,20000,154000,-134000,-134000
060342,台積電統一02購01,0,0,0,0,0,0,0,0,0,-134000,0,0,0,34000,168000,-134000,-134000
061879,超眾元大9C購01  ,0,0,0,0,0,0,0,0,0,-134000,0,0,0,111000,245000,-134000,-134000
061872,友達元大9C購06  ,0,0,0,0,0,0,0,0,0,-134000,0,0,0,67000,201000,-134000,-134000
062747,立積永豐9B購01  ,0,0,0,0,0,0,0,0,0,-134000,0,0,0,0,134000,-134000,-134000
06595P,祥碩元大98售03  ,0,0,0,0,0,0,0,0,0,-135000,0,0,0,95000,230000,-135000,-135000
052700,奇鋐國票97購02  ,0,0,0,0,0,0,0,0,0,-135000,0,0,0,223000,358000,-135000,-135000
060346,華新科統一01購01,0,0,0,0,0,0,0,0,0,-135000,0,0,0,58000,193000,-135000,-135000
057449,華新科元富99購02,0,0,0,0,0,0,0,0,0,-135000,0,0,0,0,135000,-135000,-135000
057017,和大凱基98購01  ,0,0,0,0,0,0,0,0,0,-135000,0,0,0,5000,140000,-135000,-135000
07279P,台灣50台新99售02,0,0,0,0,0,0,0,0,0,-136000,0,0,0,0,136000,-136000,-136000
08119P,南亞科統一9C售03,0,0,0,0,0,0,0,0,0,-136000,0,0,0,0,136000,-136000,-136000
020016,統一MSCI美科技N ,0,0,0,0,0,0,0,0,0,-136000,0,0,0,215000,351000,-136000,-136000
059950,百和永豐99購02  ,0,0,0,0,0,0,0,0,0,-136000,0,0,0,0,136000,-136000,-136000
058969,亞德客永豐99購01,0,0,0,0,0,0,0,0,0,-136000,0,0,0,33000,169000,-136000,-136000
058865,群創凱基01購01  ,0,0,0,0,0,0,0,0,0,-136000,0,0,0,0,136000,-136000,-136000
061844,T50反1國票9C購02,0,0,0,0,0,0,0,0,0,-136000,0,0,0,120000,256000,-136000,-136000
061080,華邦電兆豐9B購01,0,0,0,0,0,0,0,0,0,-136000,0,0,0,445000,581000,-136000,-136000
00763U,街口道瓊銅      ,0,0,0,0,0,0,0,0,0,-137000,0,0,0,14000,151000,-137000,-137000
055071,群電永豐97購01  ,0,0,0,0,0,0,0,0,0,-137000,0,0,0,0,137000,-137000,-137000
056658,美食元大98購01  ,0,0,0,0,0,0,0,0,0,-137000,0,0,0,17000,154000,-137000,-137000
060043,全新群益9B購02  ,0,0,0,0,0,0,0,0,0,-137000,0,0,0,21000,158000,-137000,-137000
056910,超眾元大99購02  ,0,0,0,0,0,0,0,0,0,-137000,0,0,0,29000,166000,-137000,-137000
058464,矽創兆豐9A購01  ,0,0,0,0,0,0,0,0,0,-137000,0,0,0,15000,152000,-137000,-137000
061518,達方永豐9A購02  ,0,0,0,0,0,0,0,0,0,-137000,0,0,0,140000,277000,-137000,-137000
062415,聯茂中信9C購01  ,0,0,0,0,0,0,0,0,0,-137000,0,0,0,10000,147000,-137000,-137000
062049,亞德客統一01購01,0,0,0,0,0,0,0,0,0,-137000,0,0,0,169000,306000,-137000,-137000
6141,柏承            ,619000,758000,-139000,0,0,0,0,0,0,2000,2000,0,2000,0,0,0,-137000
056469,國巨元大99購01  ,0,0,0,0,0,0,0,0,0,-138000,0,0,0,0,138000,-138000,-138000
058380,臺股指凱基99購15,0,0,0,0,0,0,0,0,0,-138000,0,0,0,782000,920000,-138000,-138000
057969,緯穎國泰99購01  ,0,0,0,0,0,0,0,0,0,-138000,0,0,0,30000,168000,-138000,-138000
06954P,大立光元富99售01,0,0,0,0,0,0,0,0,0,-139000,0,0,0,34000,173000,-139000,-139000
063247,信邦元大9B購02  ,0,0,0,0,0,0,0,0,0,-139000,0,0,0,168000,307000,-139000,-139000
059991,超眾元大9A購02  ,0,0,0,0,0,0,0,0,0,-139000,0,0,0,47000,186000,-139000,-139000
057712,南亞科統一9A購01,0,0,0,0,0,0,0,0,0,-139000,0,0,0,136000,275000,-139000,-139000
061901,柏文永豐9B購01  ,0,0,0,0,0,0,0,0,0,-139000,0,0,0,0,139000,-139000,-139000
063377,泰鼎永豐9B購03  ,0,0,0,0,0,0,0,0,0,-140000,0,0,0,0,140000,-140000,-140000
07780P,美律凱基9A售02  ,0,0,0,0,0,0,0,0,0,-140000,0,0,0,0,140000,-140000,-140000
055036,中工富邦9B購01  ,0,0,0,0,0,0,0,0,0,-140000,0,0,0,20000,160000,-140000,-140000
059062,群創凱基99購05  ,0,0,0,0,0,0,0,0,0,-140000,0,0,0,30000,170000,-140000,-140000
058498,世紀鋼群益99購01,0,0,0,0,0,0,0,0,0,-140000,0,0,0,85000,225000,-140000,-140000
056823,智伸科永豐98購01,0,0,0,0,0,0,0,0,0,-140000,0,0,0,33000,173000,-140000,-140000
061153,奇力新群益9A購02,0,0,0,0,0,0,0,0,0,-140000,0,0,0,0,140000,-140000,-140000
062391,台達電富邦9C購01,0,0,0,0,0,0,0,0,0,-140000,0,0,0,51000,191000,-140000,-140000
1590,亞德客-KY       ,562154,619000,-56846,0,0,0,0,139000,-139000,55000,42000,2000,40000,15000,0,15000,-140846
054517,高鐵元大96購01  ,0,0,0,0,0,0,0,0,0,-141000,0,0,0,0,141000,-141000,-141000
03050X,元展47          ,0,0,0,0,0,0,0,0,0,-141000,0,0,0,52000,193000,-141000,-141000
057196,茂林台新98購01  ,0,0,0,0,0,0,0,0,0,-141000,0,0,0,0,141000,-141000,-141000
058321,大立光永豐99購01,0,0,0,0,0,0,0,0,0,-141000,0,0,0,9000,150000,-141000,-141000
060236,精元元大9C購01  ,0,0,0,0,0,0,0,0,0,-141000,0,0,0,0,141000,-141000,-141000
062227,南六統一01購02  ,0,0,0,0,0,0,0,0,0,-141000,0,0,0,167000,308000,-141000,-141000
063029,喬山凱基9B購01  ,0,0,0,0,0,0,0,0,0,-141000,0,0,0,3000,144000,-141000,-141000
055814,晶豪科國票97購02,0,0,0,0,0,0,0,0,0,-142000,0,0,0,1000,143000,-142000,-142000
059458,鎧勝永豐99購01  ,0,0,0,0,0,0,0,0,0,-142000,0,0,0,0,142000,-142000,-142000
057288,聯茂元大98購03  ,0,0,0,0,0,0,0,0,0,-142000,0,0,0,34000,176000,-142000,-142000
063107,矽創群益9B購01  ,0,0,0,0,0,0,0,0,0,-142000,0,0,0,58000,200000,-142000,-142000
2516,新建            ,61000,207000,-146000,0,0,0,0,0,0,3000,3000,0,3000,0,0,0,-143000
07162P,臺股指群益99售13,0,0,0,0,0,0,0,0,0,-143000,0,0,0,117000,260000,-143000,-143000
056307,貿聯元大97購05  ,0,0,0,0,0,0,0,0,0,-143000,0,0,0,2000,145000,-143000,-143000
056375,玉晶光統一01購01,0,0,0,0,0,0,0,0,0,-143000,0,0,0,35000,178000,-143000,-143000
058687,聯茂凱基9A購01  ,0,0,0,0,0,0,0,0,0,-143000,0,0,0,30000,173000,-143000,-143000
057809,英業達元大98購01,0,0,0,0,0,0,0,0,0,-143000,0,0,0,70000,213000,-143000,-143000
063028,巨大元大9B購02  ,0,0,0,0,0,0,0,0,0,-143000,0,0,0,327000,470000,-143000,-143000
060742,臺指反國票9B購02,0,0,0,0,0,0,0,0,0,-143000,0,0,0,5000,148000,-143000,-143000
06904P,TPK凱基98售03   ,0,0,0,0,0,0,0,0,0,-144000,0,0,0,0,144000,-144000,-144000
063527,美食凱基01購01  ,0,0,0,0,0,0,0,0,0,-144000,0,0,0,0,144000,-144000,-144000
059155,台表科日盛99購01,0,0,0,0,0,0,0,0,0,-144000,0,0,0,35000,179000,-144000,-144000
054755,世紀鋼凱基98購01,0,0,0,0,0,0,0,0,0,-144000,0,0,0,15000,159000,-144000,-144000
061062,和大凱基9A購02  ,0,0,0,0,0,0,0,0,0,-144000,0,0,0,95000,239000,-144000,-144000
2406,國碩            ,140000,285000,-145000,0,0,0,0,0,0,0,0,0,0,0,0,0,-145000
060600,台積電凱基9C購01,0,0,0,0,0,0,0,0,0,-145000,0,0,0,5000,150000,-145000,-145000
061866,力山元大9C購01  ,0,0,0,0,0,0,0,0,0,-145000,0,0,0,134000,279000,-145000,-145000
063660,儒鴻統一9C購01  ,0,0,0,0,0,0,0,0,0,-146000,0,0,0,45000,191000,-146000,-146000
056517,茂林兆豐99購01  ,0,0,0,0,0,0,0,0,0,-146000,0,0,0,0,146000,-146000,-146000
061019,大毅國票9A購01  ,0,0,0,0,0,0,0,0,0,-146000,0,0,0,55000,201000,-146000,-146000
063053,聯發科統一01購04,0,0,0,0,0,0,0,0,0,-146000,0,0,0,0,146000,-146000,-146000
062190,瀚宇博元大9B購01,0,0,0,0,0,0,0,0,0,-146000,0,0,0,90000,236000,-146000,-146000
062376,中租元大9B購02  ,0,0,0,0,0,0,0,0,0,-146000,0,0,0,100000,246000,-146000,-146000
063449,全新統一9B購02  ,0,0,0,0,0,0,0,0,0,-147000,0,0,0,488000,635000,-147000,-147000
054481,鎧勝中信96購01  ,0,0,0,0,0,0,0,0,0,-147000,0,0,0,16000,163000,-147000,-147000
05348P,美律元富98售01  ,0,0,0,0,0,0,0,0,0,-147000,0,0,0,3000,150000,-147000,-147000
058318,致茂永豐9A購01  ,0,0,0,0,0,0,0,0,0,-147000,0,0,0,2000,149000,-147000,-147000
058248,聯茂元大99購05  ,0,0,0,0,0,0,0,0,0,-147000,0,0,0,73000,220000,-147000,-147000
057296,智原永豐98購01  ,0,0,0,0,0,0,0,0,0,-147000,0,0,0,10000,157000,-147000,-147000
061543,南亞科群益9A購01,0,0,0,0,0,0,0,0,0,-147000,0,0,0,15000,162000,-147000,-147000
063360,茂林國泰9C購02  ,0,0,0,0,0,0,0,0,0,-148000,0,0,0,7000,155000,-148000,-148000
059242,南亞科凱基99購06,0,0,0,0,0,0,0,0,0,-148000,0,0,0,4000,152000,-148000,-148000
058630,日月光國票9A購01,0,0,0,0,0,0,0,0,0,-148000,0,0,0,24000,172000,-148000,-148000
062512,美食國票9B購01  ,0,0,0,0,0,0,0,0,0,-148000,0,0,0,58000,206000,-148000,-148000
6196,帆宣            ,300000,449000,-149000,0,0,0,0,0,0,1000,2000,0,2000,2000,3000,-1000,-148000
6202,盛群            ,163000,357198,-194198,0,0,0,0,0,0,46000,43000,0,43000,4000,1000,3000,-148198
06853P,華擎元富98售03  ,0,0,0,0,0,0,0,0,0,-149000,0,0,0,99000,248000,-149000,-149000
07101P,台郡元大99售06  ,0,0,0,0,0,0,0,0,0,-149000,0,0,0,66000,215000,-149000,-149000
063884,台表科元富03購01,0,0,0,0,0,0,0,0,0,-149000,0,0,0,36000,185000,-149000,-149000
053082,聯電元大98購03  ,0,0,0,0,0,0,0,0,0,-149000,0,0,0,0,149000,-149000,-149000
058216,TPK群益99購01   ,0,0,0,0,0,0,0,0,0,-149000,0,0,0,139000,288000,-149000,-149000
058813,旺宏統一9B購04  ,0,0,0,0,0,0,0,0,0,-149000,0,0,0,16000,165000,-149000,-149000
056733,國巨凱基98購10  ,0,0,0,0,0,0,0,0,0,-149000,0,0,0,0,149000,-149000,-149000
062228,南六統一02購01  ,0,0,0,0,0,0,0,0,0,-149000,0,0,0,138000,287000,-149000,-149000
062089,矽創元大9B購02  ,0,0,0,0,0,0,0,0,0,-149000,0,0,0,77000,226000,-149000,-149000
062018,台勝科永豐9B購01,0,0,0,0,0,0,0,0,0,-149000,0,0,0,0,149000,-149000,-149000
063155,緯穎元富9B購03  ,0,0,0,0,0,0,0,0,0,-149000,0,0,0,20000,169000,-149000,-149000
061917,亞德客凱基9B購02,0,0,0,0,0,0,0,0,0,-149000,0,0,0,1000,150000,-149000,-149000
063913,貿聯凱基02購01  ,0,0,0,0,0,0,0,0,0,-150000,0,0,0,0,150000,-150000,-150000
063306,聯茂凱基9C購01  ,0,0,0,0,0,0,0,0,0,-150000,0,0,0,47000,197000,-150000,-150000
2704,國賓            ,315000,615000,-300000,0,0,0,0,0,0,150000,150000,0,150000,0,0,0,-150000
055340,華新科日盛97購01,0,0,0,0,0,0,0,0,0,-150000,0,0,0,51000,201000,-150000,-150000
056309,合勤控元大97購01,0,0,0,0,0,0,0,0,0,-150000,0,0,0,215000,365000,-150000,-150000
054666,強茂元富97購01  ,0,0,0,0,0,0,0,0,0,-150000,0,0,0,0,150000,-150000,-150000
05691P,聯發科中信98售01,0,0,0,0,0,0,0,0,0,-150000,0,0,0,50000,200000,-150000,-150000
058770,貿聯兆豐9A購01  ,0,0,0,0,0,0,0,0,0,-150000,0,0,0,21000,171000,-150000,-150000
057578,可成中信99購01  ,0,0,0,0,0,0,0,0,0,-150000,0,0,0,122000,272000,-150000,-150000
057533,晶相光元大98購02,0,0,0,0,0,0,0,0,0,-150000,0,0,0,0,150000,-150000,-150000
060305,得力永豐9A購01  ,0,0,0,0,0,0,0,0,0,-150000,0,0,0,0,150000,-150000,-150000
061828,T50反1凱基02購01,0,0,0,0,0,0,0,0,0,-150000,0,0,0,100000,250000,-150000,-150000
062957,鴻海麥證9C購01  ,0,0,0,0,150000,-150000,0,0,0,-150000,0,0,0,0,150000,-150000,-150000
062999,聯茂國票9C購01  ,0,0,0,0,0,0,0,0,0,-150000,0,0,0,22000,172000,-150000,-150000
062740,致伸國票9B購01  ,30000,0,30000,0,0,0,0,0,0,-180000,0,0,0,4000,184000,-180000,-150000
062428,超眾統一9B購01  ,0,0,0,0,0,0,0,0,0,-150000,0,0,0,179000,329000,-150000,-150000
2467,志聖            ,335000,514000,-179000,0,0,0,0,0,0,28000,28000,0,28000,0,0,0,-151000
07407P,欣興凱基99售07  ,0,0,0,0,0,0,0,0,0,-151000,0,0,0,160000,311000,-151000,-151000
052536,聯茂國泰97購01  ,0,0,0,0,0,0,0,0,0,-151000,0,0,0,57000,208000,-151000,-151000
061666,友達中信01購01  ,0,0,0,0,0,0,0,0,0,-151000,0,0,0,18000,169000,-151000,-151000
061560,友達國票9B購01  ,0,0,0,0,0,0,0,0,0,-151000,0,0,0,5000,156000,-151000,-151000
07149P,健鼎元大99售03  ,0,0,0,0,0,0,0,0,0,-152000,0,0,0,25000,177000,-152000,-152000
055244,國巨統一98購01  ,0,0,0,0,0,0,0,0,0,-152000,0,0,0,91000,243000,-152000,-152000
061271,聯茂凱基9A購04  ,0,0,0,0,0,0,0,0,0,-152000,0,0,0,0,152000,-152000,-152000
6706,惠特            ,71000,160000,-89000,0,0,0,0,0,0,-63000,3000,66000,-63000,0,0,0,-152000
063433,臻鼎元富9B購01  ,0,0,0,0,0,0,0,0,0,-153000,0,0,0,454000,607000,-153000,-153000
061774,T50反1國票9B購06,0,0,0,0,0,0,0,0,0,-153000,0,0,0,0,153000,-153000,-153000
063190,聯茂凱基9B購01  ,0,0,0,0,0,0,0,0,0,-153000,0,0,0,10000,163000,-153000,-153000
058269,世芯永豐9A購01  ,0,0,0,0,0,0,0,0,0,-154000,0,0,0,42000,196000,-154000,-154000
060567,華擎富邦9C購01  ,0,0,0,0,0,0,0,0,0,-154000,0,0,0,0,154000,-154000,-154000
060716,新唐永豐9A購01  ,0,0,0,0,0,0,0,0,0,-154000,0,0,0,1000,155000,-154000,-154000
063269,儒鴻兆豐9C購01  ,0,0,0,0,0,0,0,0,0,-155000,0,0,0,0,155000,-155000,-155000
063267,台表科中信01購02,0,0,0,0,0,0,0,0,0,-155000,0,0,0,206000,361000,-155000,-155000
058428,大立光元富99購02,0,0,0,0,0,0,0,0,0,-155000,0,0,0,94000,249000,-155000,-155000
056828,國巨富邦9A購03  ,0,0,0,0,0,0,0,0,0,-155000,0,0,0,0,155000,-155000,-155000
060660,國巨凱基9B購04  ,0,0,0,0,0,0,0,0,0,-155000,0,0,0,0,155000,-155000,-155000
03647C,T50反1元富99牛02,0,0,0,0,0,0,0,0,0,-156000,0,0,0,60000,216000,-156000,-156000
03442B,臺股指元大9A熊48,0,0,0,0,0,0,0,0,0,-156000,0,0,0,318000,474000,-156000,-156000
058803,世紀鋼元大99購03,0,0,0,0,0,0,0,0,0,-156000,0,0,0,55000,211000,-156000,-156000
062310,南亞科凱基9B購02,0,0,0,0,0,0,0,0,0,-156000,0,0,0,0,156000,-156000,-156000
062471,國泰金凱基9B購02,0,0,0,0,0,0,0,0,0,-156000,0,0,0,3000,159000,-156000,-156000
2314,台揚            ,140000,299000,-159000,0,0,0,0,0,0,2000,2000,0,2000,0,0,0,-157000
1582,信錦            ,138000,320000,-182000,0,0,0,0,0,0,25000,25000,0,25000,0,0,0,-157000
00712,FH富時不動產    ,16000,52000,-36000,0,0,0,0,0,0,-121000,0,0,0,52000,173000,-121000,-157000
057701,嘉聯益群益98購02,0,0,0,0,0,0,0,0,0,-157000,0,0,0,104000,261000,-157000,-157000
063027,台汽電元大9B購01,0,0,0,0,0,0,0,0,0,-157000,0,0,0,0,157000,-157000,-157000
062684,華新科統一01購02,0,0,0,0,0,0,0,0,0,-157000,0,0,0,140000,297000,-157000,-157000
060796,世芯永豐9A購03  ,0,0,0,0,0,0,0,0,0,-157000,0,0,0,220000,377000,-157000,-157000
059031,元石油中信03購01,0,0,0,0,0,0,0,0,0,-158000,0,0,0,5000,163000,-158000,-158000
060083,和大元大99購02  ,0,0,0,0,0,0,0,0,0,-158000,0,0,0,190000,348000,-158000,-158000
060915,旭富元大9A購01  ,0,0,0,0,0,0,0,0,0,-158000,0,0,0,170000,328000,-158000,-158000
062802,宏達電統一9B購01,0,0,0,0,0,0,0,0,0,-158000,0,0,0,0,158000,-158000,-158000
3057,喬鼎            ,9000,167000,-158000,0,0,0,0,0,0,0,0,0,0,0,0,0,-158000
2421,建準            ,1303000,1025000,278000,0,0,0,0,380000,-380000,-57000,48000,75000,-27000,5000,35000,-30000,-159000
059348,日月光凱基99購01,0,0,0,0,0,0,0,0,0,-159000,0,0,0,83000,242000,-159000,-159000
058731,貿聯永豐99購02  ,0,0,0,0,0,0,0,0,0,-159000,0,0,0,35000,194000,-159000,-159000
059851,晶相光永豐99購02,0,0,0,0,0,0,0,0,0,-159000,0,0,0,0,159000,-159000,-159000
2536,宏普            ,205000,368000,-163000,0,0,0,0,0,0,3000,4000,1000,3000,0,0,0,-160000
063772,智邦富邦9B購02  ,0,0,0,0,0,0,0,0,0,-160000,0,0,0,0,160000,-160000,-160000
055181,日電貿統一97購01,0,0,0,0,0,0,0,0,0,-160000,0,0,0,10000,170000,-160000,-160000
054135,大立光元大97購04,0,0,0,0,0,0,0,0,0,-160000,0,0,0,0,160000,-160000,-160000
056920,友達兆豐98購02  ,0,0,0,0,0,0,0,0,0,-160000,0,0,0,290000,450000,-160000,-160000
059272,台灣50元大99購01,0,0,0,0,0,0,0,0,0,-160000,0,0,0,0,160000,-160000,-160000
058516,健鼎元大99購02  ,0,0,0,0,0,0,0,0,0,-160000,0,0,0,60000,220000,-160000,-160000
061947,旺宏群益9B購02  ,0,0,0,0,0,0,0,0,0,-160000,0,0,0,50000,210000,-160000,-160000
08088P,義隆凱基9B售03  ,0,0,0,0,0,0,0,0,0,-161000,0,0,0,20000,181000,-161000,-161000
054803,味全元大9A購01  ,0,0,0,0,0,0,0,0,0,-161000,0,0,0,12000,173000,-161000,-161000
060426,盛群永豐9A購01  ,0,0,0,0,0,0,0,0,0,-161000,0,0,0,20000,181000,-161000,-161000
063669,宏達電統一9C購01,0,0,0,0,0,0,0,0,0,-162000,0,0,0,19000,181000,-162000,-162000
056537,冠德凱基98購01  ,0,0,0,0,0,0,0,0,0,-162000,0,0,0,23000,185000,-162000,-162000
054058,晶豪科國票98購01,0,0,0,0,0,0,0,0,0,-162000,0,0,0,55000,217000,-162000,-162000
058434,旺宏統一9B購01  ,0,0,0,0,0,0,0,0,0,-162000,0,0,0,0,162000,-162000,-162000
060790,日月光富邦9A購01,0,0,0,0,0,0,0,0,0,-162000,0,0,0,373000,535000,-162000,-162000
062658,聯茂第一9B購01  ,0,0,0,0,0,0,0,0,0,-162000,0,0,0,120000,282000,-162000,-162000
063852,瀚宇博元大9C購01,0,0,0,0,0,0,0,0,0,-163000,0,0,0,0,163000,-163000,-163000
058773,和碩兆豐99購01  ,0,0,0,0,0,0,0,0,0,-163000,0,0,0,67000,230000,-163000,-163000
056762,亞德客元大98購01,0,0,0,0,0,0,0,0,0,-163000,0,0,0,73000,236000,-163000,-163000
062667,立積群益9B購01  ,0,0,0,0,0,0,0,0,0,-163000,0,0,0,242000,405000,-163000,-163000
063405,聯發科國票9C購03,0,0,0,0,0,0,0,0,0,-164000,0,0,0,6000,170000,-164000,-164000
056600,聯茂元富98購01  ,0,0,0,0,0,0,0,0,0,-164000,0,0,0,0,164000,-164000,-164000
062451,瀚宇博元大9B購02,0,0,0,0,0,0,0,0,0,-164000,0,0,0,40000,204000,-164000,-164000
062266,世紀鋼元大9B購02,0,0,0,0,0,0,0,0,0,-164000,0,0,0,56000,220000,-164000,-164000
056818,正崴永豐98購01  ,0,0,0,0,0,0,0,0,0,-165000,0,0,0,0,165000,-165000,-165000
056714,晶相光永豐98購02,0,0,0,0,0,0,0,0,0,-165000,0,0,0,0,165000,-165000,-165000
058788,喬山元大99購01  ,0,0,0,0,0,0,0,0,0,-165000,0,0,0,10000,175000,-165000,-165000
060984,南亞科元大9A購07,0,0,0,0,0,0,0,0,0,-165000,0,0,0,14000,179000,-165000,-165000
062607,美食凱基9B購01  ,0,0,0,0,0,0,0,0,0,-165000,0,0,0,27000,192000,-165000,-165000
062787,超眾元大9C購02  ,0,0,0,0,0,0,0,0,0,-165000,0,0,0,23000,188000,-165000,-165000
061071,復盛凱基9A購01  ,0,0,0,0,0,0,0,0,0,-166000,0,0,0,197000,363000,-166000,-166000
061294,奇力新麥證9A購01,0,0,0,0,166000,-166000,0,0,0,-166000,0,0,0,0,166000,-166000,-166000
063814,嘉晶群益9C購01  ,0,0,0,0,0,0,0,0,0,-167000,0,0,0,12000,179000,-167000,-167000
060361,南亞科元富9A購03,0,0,0,0,0,0,0,0,0,-167000,0,0,0,131000,298000,-167000,-167000
062916,智易元大9B購01  ,0,0,0,0,0,0,0,0,0,-167000,0,0,0,27000,194000,-167000,-167000
3704,合勤控          ,117000,305000,-188000,0,0,0,0,0,0,21000,24000,0,24000,35000,38000,-3000,-167000
063355,超眾元富9B購01  ,0,0,0,0,0,0,0,0,0,-168000,0,0,0,393000,561000,-168000,-168000
054088,華新群益98購02  ,0,0,0,0,0,0,0,0,0,-168000,0,0,0,388000,556000,-168000,-168000
053316,友達群益9A購01  ,0,0,0,0,0,0,0,0,0,-168000,0,0,0,42000,210000,-168000,-168000
058496,文曄群益99購01  ,0,0,0,0,0,0,0,0,0,-168000,0,0,0,32000,200000,-168000,-168000
3708,上緯投控        ,178000,371000,-193000,0,0,0,0,0,0,25000,20000,0,20000,5000,0,5000,-168000
059747,台達電台新99購01,0,0,0,0,0,0,0,0,0,-169000,0,0,0,13000,182000,-169000,-169000
062603,台化凱基9B購01  ,0,0,0,0,0,0,0,0,0,-169000,0,0,0,30000,199000,-169000,-169000
063136,智邦統一9B購02  ,0,0,0,0,0,0,0,0,0,-169000,0,0,0,293000,462000,-169000,-169000
062211,玉晶光台新9B購01,0,0,0,0,0,0,0,0,0,-169000,0,0,0,39000,208000,-169000,-169000
062023,寶成永豐9B購01  ,0,0,0,0,0,0,0,0,0,-169000,0,0,0,40000,209000,-169000,-169000
053854,聯茂國泰97購02  ,0,0,0,0,0,0,0,0,0,-170000,0,0,0,18000,188000,-170000,-170000
059246,奇力新凱基9A購02,0,0,0,0,0,0,0,0,0,-170000,0,0,0,0,170000,-170000,-170000
057016,中石化凱基9B購01,0,0,0,0,0,0,0,0,0,-170000,0,0,0,81000,251000,-170000,-170000
058703,台積電元大99購16,0,0,0,0,0,0,0,0,0,-170000,0,0,0,56000,226000,-170000,-170000
062664,群創群益9B購02  ,0,0,0,0,0,0,0,0,0,-170000,0,0,0,63000,233000,-170000,-170000
059646,聯茂凱基99購06  ,0,0,0,0,0,0,0,0,0,-171000,0,0,0,70000,241000,-171000,-171000
061477,晶豪科元大9A購01,0,0,0,0,0,0,0,0,0,-171000,0,0,0,152000,323000,-171000,-171000
07263P,台積電元大99售37,0,0,0,0,0,0,0,0,0,-172000,0,0,0,10000,182000,-172000,-172000
055466,台達電凱基97購03,0,0,0,0,0,0,0,0,0,-172000,0,0,0,0,172000,-172000,-172000
061405,亞德客國票9B購01,0,0,0,0,0,0,0,0,0,-172000,0,0,0,12000,184000,-172000,-172000
060809,康友群益9A購01  ,0,0,0,0,0,0,0,0,0,-172000,0,0,0,239000,411000,-172000,-172000
063703,晶豪科群益9B購02,0,0,0,0,0,0,0,0,0,-173000,0,0,0,118000,291000,-173000,-173000
060411,達新永豐9A購01  ,0,0,0,0,0,0,0,0,0,-173000,0,0,0,29000,202000,-173000,-173000
060259,潤泰全凱基9C購01,0,0,0,0,0,0,0,0,0,-173000,0,0,0,132000,305000,-173000,-173000
057420,美食凱基98購01  ,0,0,0,0,0,0,0,0,0,-173000,0,0,0,10000,183000,-173000,-173000
061939,中租國票9B購01  ,0,0,0,0,0,0,0,0,0,-173000,0,0,0,31000,204000,-173000,-173000
063820,華邦電麥證01購01,0,0,0,0,174000,-174000,0,0,0,-174000,0,0,0,0,174000,-174000,-174000
054221,華新科統一96購05,0,0,0,0,0,0,0,0,0,-174000,0,0,0,0,174000,-174000,-174000
056023,晶豪科群益97購01,0,0,0,0,0,0,0,0,0,-174000,0,0,0,0,174000,-174000,-174000
056291,聯茂永豐97購03  ,0,0,0,0,0,0,0,0,0,-174000,0,0,0,0,174000,-174000,-174000
060415,葡萄王永豐9A購01,0,0,0,0,0,0,0,0,0,-174000,0,0,0,0,174000,-174000,-174000
061616,鴻海群益9A購07  ,0,0,0,0,0,0,0,0,0,-174000,0,0,0,131000,305000,-174000,-174000
060626,貿聯元大9A購04  ,0,0,0,0,0,0,0,0,0,-174000,0,0,0,107000,281000,-174000,-174000
063210,百和統一9C購01  ,0,0,0,0,0,0,0,0,0,-174000,0,0,0,0,174000,-174000,-174000
063841,國巨元大01購01  ,0,0,0,0,0,0,0,0,0,-175000,0,0,0,0,175000,-175000,-175000
07854P,台積電凱基9A售28,0,0,0,0,0,0,0,0,0,-175000,0,0,0,14000,189000,-175000,-175000
1210,大成            ,329000,962000,-633000,0,0,0,0,0,0,458000,458000,0,458000,0,0,0,-175000
055599,TPK元大97購01   ,0,0,0,0,0,0,0,0,0,-175000,0,0,0,0,175000,-175000,-175000
060289,京元電元大9A購01,0,0,0,0,0,0,0,0,0,-175000,0,0,0,316000,491000,-175000,-175000
058445,旺宏富邦9C購01  ,0,0,0,0,0,0,0,0,0,-175000,0,0,0,0,175000,-175000,-175000
056922,全新兆豐99購01  ,0,0,0,0,0,0,0,0,0,-175000,0,0,0,10000,185000,-175000,-175000
062743,微星國泰01購01  ,0,0,0,0,0,0,0,0,0,-175000,0,0,0,424000,599000,-175000,-175000
063737,大立光元大9C購07,0,0,0,0,0,0,0,0,0,-176000,0,0,0,14000,190000,-176000,-176000
06725P,聯電元富98售01  ,0,0,0,0,0,0,0,0,0,-176000,0,0,0,124000,300000,-176000,-176000
053913,華新國票97購01  ,0,0,0,0,0,0,0,0,0,-176000,0,0,0,96000,272000,-176000,-176000
060030,晶相光永豐99購03,0,0,0,0,0,0,0,0,0,-176000,0,0,0,9000,185000,-176000,-176000
058720,旭富元富99購01  ,0,0,0,0,0,0,0,0,0,-176000,0,0,0,141000,317000,-176000,-176000
059536,新光金凱基99購05,0,0,0,0,0,0,0,0,0,-177000,0,0,0,100000,277000,-177000,-177000
060295,貿聯元大9A購03  ,0,0,0,0,0,0,0,0,0,-177000,0,0,0,10000,187000,-177000,-177000
057059,易華電元大99購01,0,0,0,0,0,0,0,0,0,-177000,0,0,0,25000,202000,-177000,-177000
062665,智易群益9B購01  ,0,0,0,0,0,0,0,0,0,-177000,0,0,0,0,177000,-177000,-177000
061673,仁寶元大9B購01  ,0,0,0,0,0,0,0,0,0,-177000,0,0,0,192000,369000,-177000,-177000
3029,零壹            ,149000,327000,-178000,0,0,0,0,0,0,1000,1000,0,1000,0,0,0,-177000
059054,國巨凱基99購11  ,0,0,0,0,0,0,0,0,0,-179000,0,0,0,74000,253000,-179000,-179000
054883,億光統一97購01  ,0,0,0,0,0,0,0,0,0,-179000,0,0,0,20000,199000,-179000,-179000
054771,茂林國票98購02  ,0,0,0,0,0,0,0,0,0,-179000,0,0,0,22000,201000,-179000,-179000
055336,茂林兆豐98購01  ,0,0,0,0,0,0,0,0,0,-179000,0,0,0,0,179000,-179000,-179000
061441,大毅永豐9A購04  ,0,0,0,0,0,0,0,0,0,-179000,0,0,0,88000,267000,-179000,-179000
060907,金像電元大9A購02,0,0,0,0,0,0,0,0,0,-179000,0,0,0,41000,220000,-179000,-179000
062685,華新科統一9C購03,0,0,0,0,0,0,0,0,0,-179000,0,0,0,25000,204000,-179000,-179000
062050,亞德客統一9C購01,0,0,0,0,0,0,0,0,0,-179000,0,0,0,22000,201000,-179000,-179000
063693,智易永豐9B購02  ,0,0,0,0,0,0,0,0,0,-180000,0,0,0,0,180000,-180000,-180000
063804,華邦電兆豐01購01,0,0,0,0,0,0,0,0,0,-180000,0,0,0,0,180000,-180000,-180000
062037,華新凱基9B購01  ,0,0,0,0,0,0,0,0,0,-180000,0,0,0,3000,183000,-180000,-180000
063069,道瓊銀富邦05購01,0,0,0,0,0,0,0,0,0,-180000,0,0,0,10000,190000,-180000,-180000
061937,聯發科國票9B購02,0,0,0,0,0,0,0,0,0,-180000,0,0,0,8000,188000,-180000,-180000
3563,牧德            ,142000,179000,-37000,0,0,0,0,150000,-150000,7000,10000,12000,-2000,12000,3000,9000,-180000
063859,國巨國泰01購03  ,0,0,0,0,0,0,0,0,0,-181000,0,0,0,0,181000,-181000,-181000
058139,臻鼎元大99購01  ,0,0,0,0,0,0,0,0,0,-181000,0,0,0,30000,211000,-181000,-181000
060451,中石化元大9C購02,0,0,0,0,0,0,0,0,0,-181000,0,0,0,189000,370000,-181000,-181000
062874,微星兆豐9B購01  ,0,0,0,0,0,0,0,0,0,-181000,0,0,0,10000,191000,-181000,-181000
063808,台表科兆豐9C購01,0,0,0,0,0,0,0,0,0,-182000,0,0,0,0,182000,-182000,-182000
052546,友達中信98購01  ,0,0,0,0,0,0,0,0,0,-182000,0,0,0,113000,295000,-182000,-182000
054830,世芯國泰99購01  ,0,0,0,0,0,0,0,0,0,-182000,0,0,0,64000,246000,-182000,-182000
060924,大毅永豐9A購03  ,0,0,0,0,0,0,0,0,0,-182000,0,0,0,0,182000,-182000,-182000
057072,日月光永豐98購01,0,0,0,0,0,0,0,0,0,-182000,0,0,0,84000,266000,-182000,-182000
061753,南亞科台新9B購01,0,0,0,0,0,0,0,0,0,-182000,0,0,0,16000,198000,-182000,-182000
063640,貿聯元大9B購03  ,0,0,0,0,0,0,0,0,0,-183000,0,0,0,0,183000,-183000,-183000
056481,創意元大98購01  ,0,0,0,0,0,0,0,0,0,-183000,0,0,0,10000,193000,-183000,-183000
054947,興勤元大97購01  ,0,0,0,0,0,0,0,0,0,-183000,0,0,0,50000,233000,-183000,-183000
060788,嘉晶富邦9B購01  ,0,0,0,0,0,0,0,0,0,-183000,0,0,0,157000,340000,-183000,-183000
062480,茂林國票9B購01  ,0,0,0,0,0,0,0,0,0,-183000,0,0,0,9000,192000,-183000,-183000
063704,麗豐群益9B購01  ,0,0,0,0,0,0,0,0,0,-184000,0,0,0,0,184000,-184000,-184000
058348,台表科群益99購01,0,0,0,0,0,0,0,0,0,-184000,0,0,0,20000,204000,-184000,-184000
062138,力成群益9B購01  ,0,0,0,0,0,0,0,0,0,-184000,0,0,0,0,184000,-184000,-184000
063023,華擎元大9B購02  ,0,0,0,0,0,0,0,0,0,-184000,0,0,0,54000,238000,-184000,-184000
063333,同欣電國票9C購01,0,0,0,0,0,0,0,0,0,-185000,0,0,0,48000,233000,-185000,-185000
057847,聯茂永豐98購01  ,0,0,0,0,0,0,0,0,0,-185000,0,0,0,0,185000,-185000,-185000
062751,華擎中信9C購01  ,0,0,0,0,0,0,0,0,0,-185000,0,0,0,38000,223000,-185000,-185000
060886,國巨統一01購03  ,0,0,0,0,0,0,0,0,0,-185000,0,0,0,13000,198000,-185000,-185000
061640,智原元大9A購01  ,0,0,0,0,0,0,0,0,0,-185000,0,0,0,330000,515000,-185000,-185000
053584,友達元大9B購02  ,0,0,0,0,0,0,0,0,0,-186000,0,0,0,64000,250000,-186000,-186000
056846,晶相光元富98購01,0,0,0,0,0,0,0,0,0,-186000,0,0,0,0,186000,-186000,-186000
063505,奇力新群益9B購03,0,0,0,0,0,0,0,0,0,-187000,0,0,0,100000,287000,-187000,-187000
2636,台驊投控        ,140000,327000,-187000,0,0,0,0,0,0,0,0,0,0,0,0,0,-187000
061593,智原永豐9A購01  ,0,0,0,0,0,0,0,0,0,-187000,0,0,0,0,187000,-187000,-187000
060807,新光金群益9A購01,0,0,0,0,0,0,0,0,0,-187000,0,0,0,1081000,1268000,-187000,-187000
063106,台表科群益9B購03,0,0,0,0,0,0,0,0,0,-187000,0,0,0,62000,249000,-187000,-187000
062164,禾伸堂國泰01購01,0,0,0,0,0,0,0,0,0,-187000,0,0,0,0,187000,-187000,-187000
062195,聚陽中信9C購01  ,0,0,0,0,0,0,0,0,0,-188000,0,0,0,7000,195000,-188000,-188000
061749,群創統一9C購02  ,0,0,0,0,0,0,0,0,0,-188000,0,0,0,0,188000,-188000,-188000
048270,T50反1富邦99購01,0,0,0,0,0,0,0,0,0,-189000,0,0,0,0,189000,-189000,-189000
054363,世芯凱基97購01  ,0,0,0,0,0,0,0,0,0,-189000,0,0,0,22000,211000,-189000,-189000
061053,國巨群益9A購08  ,0,0,0,0,0,0,0,0,0,-189000,0,0,0,10000,199000,-189000,-189000
062407,同欣電永豐9B購01,0,0,0,0,0,0,0,0,0,-189000,0,0,0,1000,190000,-189000,-189000
063816,TPK群益9C購01   ,0,0,0,0,0,0,0,0,0,-190000,0,0,0,22000,212000,-190000,-190000
063650,矽創元大9B購03  ,0,0,0,0,0,0,0,0,0,-190000,0,0,0,27000,217000,-190000,-190000
055962,晶豪科元大97購02,0,0,0,0,0,0,0,0,0,-190000,0,0,0,0,190000,-190000,-190000
060911,大毅元大9A購01  ,0,0,0,0,0,0,0,0,0,-190000,0,0,0,55000,245000,-190000,-190000
061128,大立光永豐9A購02,0,0,0,0,0,0,0,0,0,-190000,0,0,0,0,190000,-190000,-190000
07171P,臺股指國票99售08,0,0,0,0,0,0,0,0,0,-191000,0,0,0,490000,681000,-191000,-191000
063177,友達兆豐9B購01  ,0,0,0,0,0,0,0,0,0,-191000,0,0,0,85000,276000,-191000,-191000
3653,健策            ,223000,284000,-61000,0,0,0,30000,187000,-157000,27000,49000,11000,38000,55000,66000,-11000,-191000
063584,南六國泰01購01  ,0,0,0,0,0,0,0,0,0,-192000,0,0,0,71000,263000,-192000,-192000
056755,聯茂兆豐98購01  ,0,0,0,0,0,0,0,0,0,-192000,0,0,0,20000,212000,-192000,-192000
058611,欣興元大99購06  ,0,0,0,0,0,0,0,0,0,-192000,0,0,0,26000,218000,-192000,-192000
057507,貿聯國票98購02  ,0,0,0,0,0,0,0,0,0,-192000,0,0,0,5000,197000,-192000,-192000
062694,遠東新元大9B購01,0,0,0,0,0,0,0,0,0,-192000,0,0,0,71000,263000,-192000,-192000
056422,全新統一98購02  ,0,0,0,0,0,0,0,0,0,-193000,0,0,0,35000,228000,-193000,-193000
057085,立積統一9B購02  ,0,0,0,0,0,0,0,0,0,-193000,0,0,0,242000,435000,-193000,-193000
062795,國巨統一9B購15  ,0,0,0,0,0,0,0,0,0,-193000,0,0,0,10000,203000,-193000,-193000
063110,牧德兆豐9B購01  ,0,0,0,0,0,0,0,0,0,-193000,0,0,0,130000,323000,-193000,-193000
062993,華新科群益9B購05,0,0,0,0,0,0,0,0,0,-193000,0,0,0,13000,206000,-193000,-193000
056139,貿聯元大97購04  ,0,0,0,0,0,0,0,0,0,-194000,0,0,0,0,194000,-194000,-194000
063299,金寶凱基9B購01  ,0,0,0,0,0,0,0,0,0,-195000,0,0,0,6000,201000,-195000,-195000
053246,聯詠國票97購02  ,0,0,0,0,0,0,0,0,0,-195000,0,0,0,5000,200000,-195000,-195000
060424,中租永豐9A購01  ,0,0,0,0,0,0,0,0,0,-195000,0,0,0,60000,255000,-195000,-195000
062147,大毅國票9B購02  ,0,0,0,0,0,0,0,0,0,-195000,0,0,0,5000,200000,-195000,-195000
062908,晶豪科元大9B購03,0,0,0,0,0,0,0,0,0,-196000,0,0,0,212000,408000,-196000,-196000
063401,中租群益9B購03  ,0,0,0,0,0,0,0,0,0,-197000,0,0,0,74000,271000,-197000,-197000
063806,瀚宇博兆豐01購01,0,0,0,0,0,0,0,0,0,-197000,0,0,0,0,197000,-197000,-197000
063787,玉晶光統一01購07,0,0,0,0,0,0,0,0,0,-197000,0,0,0,39000,236000,-197000,-197000
08080P,祥碩國票9B售03  ,0,0,0,0,0,0,0,0,0,-197000,0,0,0,20000,217000,-197000,-197000
063100,聚陽群益9C購02  ,0,0,0,0,0,0,0,0,0,-197000,0,0,0,224000,421000,-197000,-197000
063162,國喬永豐9B購01  ,0,0,0,0,0,0,0,0,0,-197000,0,0,0,60000,257000,-197000,-197000
060625,華擎元大9A購01  ,0,0,0,0,0,0,0,0,0,-197000,0,0,0,207000,404000,-197000,-197000
061351,智伸科元大9A購01,0,0,0,0,0,0,0,0,0,-197000,0,0,0,162000,359000,-197000,-197000
07505P,台勝科元大9A售01,0,0,0,0,0,0,0,0,0,-198000,0,0,0,5000,203000,-198000,-198000
063692,華擎永豐9B購02  ,0,0,0,0,0,0,0,0,0,-198000,0,0,0,0,198000,-198000,-198000
060989,國泰金元大9A購02,0,0,0,0,0,0,0,0,0,-198000,0,0,0,45000,243000,-198000,-198000
061532,和大統一9C購02  ,0,0,0,0,0,0,0,0,0,-198000,0,0,0,113000,311000,-198000,-198000
062421,台積電統一9C購09,0,0,0,0,0,0,0,0,0,-198000,0,0,0,0,198000,-198000,-198000
063593,GIS永豐9B購01   ,0,0,0,0,0,0,0,0,0,-199000,0,0,0,163000,362000,-199000,-199000
063262,南六富邦9C購01  ,0,0,0,0,0,0,0,0,0,-199000,0,0,0,402000,601000,-199000,-199000
059166,友達凱基99購05  ,0,0,0,0,0,0,0,0,0,-199000,0,0,0,1000,200000,-199000,-199000
054339,聯詠統一96購02  ,0,0,0,0,0,0,0,0,0,-199000,0,0,0,0,199000,-199000,-199000
06337P,祥碩元大97售05  ,0,0,0,0,0,0,0,0,0,-200000,0,0,0,0,200000,-200000,-200000
07062P,台積電元大99售15,0,0,0,0,0,0,0,0,0,-200000,0,0,0,0,200000,-200000,-200000
06832P,玉晶光凱基98售03,0,0,0,0,0,0,0,0,0,-200000,0,0,0,0,200000,-200000,-200000
07677P,祥碩永豐9A售01  ,0,0,0,0,0,0,0,0,0,-200000,0,0,0,0,200000,-200000,-200000
055827,中石化元大98購01,0,0,0,0,0,0,0,0,0,-200000,0,0,0,0,200000,-200000,-200000
053583,漢唐元大96購03  ,0,0,0,0,0,0,0,0,0,-200000,0,0,0,0,200000,-200000,-200000
054101,茂林國票97購04  ,0,0,0,0,0,0,0,0,0,-200000,0,0,0,0,200000,-200000,-200000
057514,華新科元富99購03,0,0,0,0,0,0,0,0,0,-200000,0,0,0,0,200000,-200000,-200000
058251,百和元大99購03  ,0,0,0,0,0,0,0,0,0,-200000,0,0,0,0,200000,-200000,-200000
058113,百和元富98購01  ,0,0,0,0,0,0,0,0,0,-200000,0,0,0,0,200000,-200000,-200000
056770,國產元大98購02  ,0,0,0,0,0,0,0,0,0,-200000,0,0,0,0,200000,-200000,-200000
062287,康友群益9B購02  ,0,0,0,0,0,0,0,0,0,-200000,0,0,0,2000,202000,-200000,-200000
062509,SP黃豆國票9B購03,0,0,0,0,0,0,0,0,0,-200000,0,0,0,0,200000,-200000,-200000
062258,奇力新元大9B購03,0,0,0,0,0,0,0,0,0,-200000,0,0,0,0,200000,-200000,-200000
062693,中石化元大02購01,0,0,0,0,0,0,0,0,0,-200000,0,0,0,33000,233000,-200000,-200000
061431,鈺齊元大9A購01  ,0,0,0,0,0,0,0,0,0,-200000,0,0,0,0,200000,-200000,-200000
061695,群創群益9A購01  ,0,0,0,0,0,0,0,0,0,-200000,0,0,0,0,200000,-200000,-200000
061791,康友群益9B購01  ,0,0,0,0,0,0,0,0,0,-200000,0,0,0,0,200000,-200000,-200000
061052,和大群益9A購01  ,0,0,0,0,0,0,0,0,0,-200000,0,0,0,42000,242000,-200000,-200000
062953,大立光永豐9B購01,0,0,0,0,0,0,0,0,0,-201000,0,0,0,0,201000,-201000,-201000
06884P,台郡群益98售03  ,0,0,0,0,0,0,0,0,0,-202000,0,0,0,0,202000,-202000,-202000
056075,瀚宇博元大97購03,0,0,0,0,0,0,0,0,0,-202000,0,0,0,218000,420000,-202000,-202000
063060,華新科元富9B購03,0,0,0,0,0,0,0,0,0,-202000,0,0,0,0,202000,-202000,-202000
058209,臺股指凱基01購01,0,0,0,0,0,0,0,0,0,-203000,0,0,0,331000,534000,-203000,-203000
061179,華擎凱基9A購01  ,0,0,0,0,0,0,0,0,0,-203000,0,0,0,0,203000,-203000,-203000
060881,玉山金中信02購01,0,0,0,0,0,0,0,0,0,-204000,0,0,0,211000,415000,-204000,-204000
061816,長榮航群益9B購02,0,0,0,0,0,0,0,0,0,-204000,0,0,0,128000,332000,-204000,-204000
063497,東元永豐9B購01  ,0,0,0,0,0,0,0,0,0,-205000,0,0,0,0,205000,-205000,-205000
063641,泰鼎元大9B購04  ,0,0,0,0,0,0,0,0,0,-205000,0,0,0,155000,360000,-205000,-205000
057169,微星元大98購01  ,0,0,0,0,0,0,0,0,0,-205000,0,0,0,95000,300000,-205000,-205000
058941,華新科中信99購03,0,0,0,0,0,0,0,0,0,-205000,0,0,0,0,205000,-205000,-205000
061653,上証2X國票9A購02,0,0,0,0,0,0,0,0,0,-205000,0,0,0,0,205000,-205000,-205000
056507,創意永豐98購02  ,0,0,0,0,0,0,0,0,0,-206000,0,0,0,79000,285000,-206000,-206000
057938,台表科群益98購02,0,0,0,0,0,0,0,0,0,-206000,0,0,0,24000,230000,-206000,-206000
057743,華擎永豐98購03  ,0,0,0,0,0,0,0,0,0,-206000,0,0,0,0,206000,-206000,-206000
062979,茂林元富9B購01  ,0,0,0,0,0,0,0,0,0,-206000,0,0,0,61000,267000,-206000,-206000
063582,瑞祺國泰9C購01  ,0,0,0,0,0,0,0,0,0,-207000,0,0,0,0,207000,-207000,-207000
063176,南亞科兆豐9B購01,0,0,0,0,0,0,0,0,0,-207000,0,0,0,28000,235000,-207000,-207000
062352,南六群益9B購02  ,0,0,0,0,0,0,0,0,0,-207000,0,0,0,70000,277000,-207000,-207000
062194,遠東新中信9C購01,0,0,0,0,0,0,0,0,0,-208000,0,0,0,20000,228000,-208000,-208000
062863,聯茂國票9B購01  ,0,0,0,0,0,0,0,0,0,-208000,0,0,0,64000,272000,-208000,-208000
061574,大毅元大9B購01  ,0,0,0,0,0,0,0,0,0,-208000,0,0,0,3000,211000,-208000,-208000
057775,南亞科群益98購02,0,0,0,0,0,0,0,0,0,-209000,0,0,0,1000,210000,-209000,-209000
061638,國泰金元大9A購03,0,0,0,0,0,0,0,0,0,-209000,0,0,0,52000,261000,-209000,-209000
062205,奇力新國票9C購01,0,0,0,0,0,0,0,0,0,-209000,0,0,0,0,209000,-209000,-209000
07871P,台積電群益9C售02,0,0,0,0,0,0,0,0,0,-210000,0,0,0,0,210000,-210000,-210000
052167,亞泥元大96購01  ,0,0,0,0,0,0,0,0,0,-210000,0,0,0,29000,239000,-210000,-210000
059217,台積電元大99購30,0,0,0,0,0,0,0,0,0,-210000,0,0,0,0,210000,-210000,-210000
063807,超眾兆豐01購01  ,0,0,0,0,0,0,0,0,0,-211000,0,0,0,0,211000,-211000,-211000
060396,友達國票9A購01  ,0,0,0,0,0,0,0,0,0,-211000,0,0,0,7000,218000,-211000,-211000
061645,超眾元大9A購06  ,0,0,0,0,0,0,0,0,0,-211000,0,0,0,95000,306000,-211000,-211000
060821,SP黃豆元大9A購02,0,0,0,0,0,0,0,0,0,-211000,0,0,0,100000,311000,-211000,-211000
06634P,欣興國票98售02  ,0,0,0,0,0,0,0,0,0,-212000,0,0,0,41000,253000,-212000,-212000
056241,緯創群益97購01  ,0,0,0,0,0,0,0,0,0,-212000,0,0,0,68000,280000,-212000,-212000
059181,世紀鋼元富9C購01,0,0,0,0,0,0,0,0,0,-212000,0,0,0,13000,225000,-212000,-212000
061950,日月光群益9B購01,0,0,0,0,0,0,0,0,0,-212000,0,0,0,157000,369000,-212000,-212000
08132P,南六元大9B售05  ,0,0,0,0,0,0,0,0,0,-213000,0,0,0,145000,358000,-213000,-213000
057616,聯電凱基99購01  ,0,0,0,0,0,0,0,0,0,-213000,0,0,0,69000,282000,-213000,-213000
053502,智伸科兆豐97購01,0,0,0,0,0,0,0,0,0,-214000,0,0,0,7000,221000,-214000,-214000
059281,創意永豐99購02  ,0,0,0,0,0,0,0,0,0,-214000,0,0,0,115000,329000,-214000,-214000
060766,世芯元大9A購02  ,0,0,0,0,0,0,0,0,0,-214000,0,0,0,20000,234000,-214000,-214000
060733,和大統一9C購01  ,0,0,0,0,0,0,0,0,0,-214000,0,0,0,174000,388000,-214000,-214000
060653,全新群益9A購02  ,0,0,0,0,0,0,0,0,0,-214000,0,0,0,98000,312000,-214000,-214000
063219,友達群益9B購03  ,0,0,0,0,0,0,0,0,0,-214000,0,0,0,91000,305000,-214000,-214000
08222P,南六凱基9B售05  ,0,0,0,0,0,0,0,0,0,-215000,0,0,0,15000,230000,-215000,-215000
063603,友達凱基9B購05  ,0,0,0,0,0,0,0,0,0,-215000,0,0,0,28000,243000,-215000,-215000
057974,上銀永豐98購02  ,0,0,0,0,0,0,0,0,0,-215000,0,0,0,0,215000,-215000,-215000
062321,力成台新9B購01  ,0,0,0,0,0,0,0,0,0,-215000,0,0,0,10000,225000,-215000,-215000
063557,聚陽元大9B購01  ,0,0,0,0,0,0,0,0,0,-216000,0,0,0,53000,269000,-216000,-216000
063450,華新科統一02購01,0,0,0,0,0,0,0,0,0,-216000,0,0,0,30000,246000,-216000,-216000
07815P,美律群益9A售04  ,0,0,0,0,0,0,0,0,0,-216000,0,0,0,0,216000,-216000,-216000
07773P,台灣50群益9A售15,0,0,0,0,0,0,0,0,0,-216000,0,0,0,0,216000,-216000,-216000
053178,南亞科統一98購01,0,0,0,0,0,0,0,0,0,-216000,0,0,0,0,216000,-216000,-216000
053882,聯發科中信98購02,0,0,0,0,0,0,0,0,0,-216000,0,0,0,6000,222000,-216000,-216000
054807,台化元大9A購02  ,7000,0,7000,0,0,0,0,0,0,-223000,0,0,0,200000,423000,-223000,-216000
060474,中租元大9B購01  ,0,0,0,0,0,0,0,0,0,-216000,0,0,0,24000,240000,-216000,-216000
060946,世紀鋼國票9A購02,0,0,0,0,0,0,0,0,0,-216000,0,0,0,107000,323000,-216000,-216000
056101,光磊永豐98購01  ,0,0,0,0,0,0,0,0,0,-217000,0,0,0,77000,294000,-217000,-217000
00703,台新MSCI中國    ,6000,0,6000,0,0,0,0,0,0,-223000,0,0,0,151000,374000,-223000,-217000
058222,玉晶光統一9B購01,0,0,0,0,0,0,0,0,0,-217000,0,0,0,51000,268000,-217000,-217000
059765,嘉聯益永豐99購02,0,0,0,0,0,0,0,0,0,-217000,0,0,0,192000,409000,-217000,-217000
059680,台積電國泰9A購03,0,0,0,0,0,0,0,0,0,-217000,0,0,0,795000,1012000,-217000,-217000
059671,滬深2X元富99購05,0,0,0,0,0,0,0,0,0,-217000,0,0,0,51000,268000,-217000,-217000
060684,同欣電元大9A購01,0,50000,-50000,0,0,0,0,0,0,-167000,0,0,0,136000,303000,-167000,-217000
063551,美食國票9B購02  ,0,0,0,0,0,0,0,0,0,-218000,0,0,0,0,218000,-218000,-218000
055931,冠德群益97購02  ,0,0,0,0,0,0,0,0,0,-218000,0,0,0,76000,294000,-218000,-218000
062705,美食元大9B購01  ,0,0,0,0,0,0,0,0,0,-218000,0,0,0,69000,287000,-218000,-218000
058664,百和兆豐99購01  ,0,0,0,0,0,0,0,0,0,-219000,0,0,0,19000,238000,-219000,-219000
060571,京元電永豐9A購01,0,0,0,0,0,0,0,0,0,-219000,0,0,0,17000,236000,-219000,-219000
061214,華擎元大9A購04  ,0,0,0,0,0,0,0,0,0,-219000,0,0,0,139000,358000,-219000,-219000
063675,亞德客國泰01購01,0,0,0,0,0,0,0,0,0,-220000,0,0,0,131000,351000,-220000,-220000
07170P,臺股指國票99售07,0,0,0,0,0,0,0,0,0,-220000,0,0,0,175000,395000,-220000,-220000
07766P,美律群益9A售03  ,0,0,0,0,0,0,0,0,0,-220000,0,0,0,0,220000,-220000,-220000
07315P,台積電台新99售06,0,0,0,0,0,0,0,0,0,-220000,0,0,0,0,220000,-220000,-220000
061216,世芯元大9A購06  ,0,0,0,0,0,0,0,0,0,-220000,0,0,0,96000,316000,-220000,-220000
061941,道瓊指群益9B購01,0,0,0,0,0,0,0,0,0,-220000,0,0,0,0,220000,-220000,-220000
061466,創意群益9A購01  ,0,0,0,0,0,0,0,0,0,-220000,0,0,0,148000,368000,-220000,-220000
08245P,台灣50群益9C售05,0,0,0,0,0,0,0,0,0,-221000,0,0,0,0,221000,-221000,-221000
07202P,台灣50凱基9C售04,0,0,0,0,0,0,0,0,0,-221000,0,0,0,10000,231000,-221000,-221000
056001,美食永豐97購01  ,0,0,0,0,0,0,0,0,0,-221000,0,0,0,95000,316000,-221000,-221000
059880,世紀鋼凱基99購02,0,0,0,0,0,0,0,0,0,-222000,0,0,0,0,222000,-222000,-222000
056639,國產康和98購01  ,0,0,0,0,0,0,0,0,0,-223000,0,0,0,0,223000,-223000,-223000
059003,中壽元大99購01  ,0,0,0,0,0,0,0,0,0,-223000,0,0,0,226000,449000,-223000,-223000
03445B,臺股指元大02熊01,0,0,0,0,0,0,0,0,0,-223000,0,0,0,31000,254000,-223000,-223000
062662,友達群益9B購02  ,0,0,0,0,0,0,0,0,0,-223000,0,0,0,0,223000,-223000,-223000
063895,新光金群益01購01,0,0,0,0,0,0,0,0,0,-224000,0,0,0,0,224000,-224000,-224000
063354,茂林元富9B購02  ,0,0,0,0,0,0,0,0,0,-224000,0,0,0,0,224000,-224000,-224000
058996,台達電元大99購02,0,0,0,0,0,0,0,0,0,-224000,0,0,0,149000,373000,-224000,-224000
058312,大毅國泰9B購01  ,0,0,0,0,0,0,0,0,0,-224000,0,0,0,70000,294000,-224000,-224000
060456,正隆元大9A購01  ,0,0,0,0,0,0,0,0,0,-224000,0,0,0,67000,291000,-224000,-224000
061815,奇力新群益9B購02,0,0,0,0,0,0,0,0,0,-224000,0,0,0,23000,247000,-224000,-224000
061639,晶豪科元大9A購02,0,0,0,0,0,0,0,0,0,-224000,0,0,0,85000,309000,-224000,-224000
07920P,大立光中信01售01,0,0,0,0,0,0,0,0,0,-225000,0,0,0,68000,293000,-225000,-225000
059093,旭富元大99購01  ,0,0,0,0,0,0,0,0,0,-225000,0,0,0,201000,426000,-225000,-225000
058705,長榮航元大99購01,0,0,0,0,0,0,0,0,0,-225000,0,0,0,68000,293000,-225000,-225000
061899,復盛永豐9B購01  ,0,0,0,0,0,0,0,0,0,-225000,0,0,0,20000,245000,-225000,-225000
062523,世紀鋼元大9C購03,0,0,0,0,0,0,0,0,0,-225000,0,0,0,20000,245000,-225000,-225000
054369,鴻海中信9C購01  ,0,0,0,0,0,0,0,0,0,-226000,0,0,0,0,226000,-226000,-226000
061243,麗豐兆豐9A購01  ,0,0,0,0,0,0,0,0,0,-226000,0,0,0,0,226000,-226000,-226000
063400,華擎群益9B購03  ,0,0,0,0,0,0,0,0,0,-227000,0,0,0,0,227000,-227000,-227000
2457,飛宏            ,66000,301000,-235000,0,0,0,0,0,0,6000,6000,0,6000,0,0,0,-229000
059873,華新科凱基99購09,0,0,0,0,0,0,0,0,0,-229000,0,0,0,0,229000,-229000,-229000
054969,亞翔元大97購01  ,0,0,0,0,0,0,0,0,0,-230000,0,0,0,0,230000,-230000,-230000
062377,力成元大9B購01  ,0,0,0,0,0,0,0,0,0,-230000,0,0,0,108000,338000,-230000,-230000
062288,南六群益9B購01  ,0,0,0,0,0,0,0,0,0,-231000,0,0,0,199000,430000,-231000,-231000
063076,柏文永豐9B購02  ,0,0,0,0,0,0,0,0,0,-231000,0,0,0,0,231000,-231000,-231000
059869,友達凱基99購07  ,0,0,0,0,0,0,0,0,0,-233000,0,0,0,42000,275000,-233000,-233000
061676,新光金元大9A購03,0,0,0,0,0,0,0,0,0,-233000,0,0,0,11000,244000,-233000,-233000
2385,群光            ,1349748,1521860,-172112,0,0,0,0,3000,-3000,-58000,143000,12000,131000,5000,194000,-189000,-233112
059030,奇力新兆豐99購03,0,0,0,0,0,0,0,0,0,-234000,0,0,0,20000,254000,-234000,-234000
059267,群創中信01購02  ,0,0,0,0,0,0,0,0,0,-234000,0,0,0,0,234000,-234000,-234000
063334,復盛國票9B購01  ,0,0,0,0,0,0,0,0,0,-235000,0,0,0,42000,277000,-235000,-235000
03658C,T50反1元大9A牛02,0,0,0,0,0,0,0,0,0,-235000,0,0,0,0,235000,-235000,-235000
062913,創意元大9B購02  ,0,0,0,0,0,0,0,0,0,-235000,0,0,0,154000,389000,-235000,-235000
062271,華通群益9C購02  ,0,0,0,0,0,0,0,0,0,-235000,0,0,0,292000,527000,-235000,-235000
055058,大毅永豐97購01  ,0,0,0,0,0,0,0,0,0,-236000,0,0,0,39000,275000,-236000,-236000
062826,奇力新群益9C購01,0,0,0,0,0,0,0,0,0,-236000,0,0,0,0,236000,-236000,-236000
061818,富邦金群益9C購01,0,0,0,0,0,0,0,0,0,-236000,0,0,0,25000,261000,-236000,-236000
063465,友達元大9C購10  ,0,0,0,0,0,0,0,0,0,-237000,0,0,0,20000,257000,-237000,-237000
058808,大成鋼統一9B購01,0,0,0,0,0,0,0,0,0,-237000,0,0,0,11000,248000,-237000,-237000
07173P,臺股指國票99售10,0,0,0,0,0,0,0,0,0,-238000,0,0,0,363000,601000,-238000,-238000
057289,力成元大98購03  ,0,0,0,0,0,0,0,0,0,-238000,0,0,0,116000,354000,-238000,-238000
061389,華新科群益9B購01,0,0,0,0,0,0,0,0,0,-238000,0,0,0,4000,242000,-238000,-238000
058769,友達兆豐99購01  ,0,0,0,0,0,0,0,0,0,-239000,0,0,0,0,239000,-239000,-239000
060281,卜蜂元大9C購01  ,0,0,0,0,0,0,0,0,0,-239000,0,0,0,0,239000,-239000,-239000
061762,台塑元大9B購01  ,0,0,0,0,0,0,0,0,0,-239000,0,0,0,0,239000,-239000,-239000
062968,仁寶元富9B購01  ,0,0,0,0,0,0,0,0,0,-239000,0,0,0,89000,328000,-239000,-239000
07257P,臺股指凱基99售37,0,0,0,0,0,0,0,0,0,-240000,0,0,0,60000,300000,-240000,-240000
054875,群電群益97購01  ,0,0,0,0,0,0,0,0,0,-240000,0,0,0,0,240000,-240000,-240000
058273,同欣電永豐99購01,0,0,0,0,0,0,0,0,0,-240000,0,0,0,0,240000,-240000,-240000
059397,T50反1元富99購05,0,0,0,0,0,0,0,0,0,-240000,0,0,0,0,240000,-240000,-240000
052853,友達日盛99購01  ,0,0,0,0,0,0,0,0,0,-241000,0,0,0,0,241000,-241000,-241000
060227,和大元大9A購01  ,0,0,0,0,0,0,0,0,0,-241000,0,0,0,119000,360000,-241000,-241000
060385,台勝科凱基9A購01,0,0,0,0,0,0,0,0,0,-241000,0,0,0,5000,246000,-241000,-241000
07903P,台積電群益9B售03,0,0,0,0,0,0,0,0,0,-242000,0,0,0,0,242000,-242000,-242000
053919,可成國票97購02  ,0,0,0,0,0,0,0,0,0,-242000,0,0,0,28000,270000,-242000,-242000
061357,寶成元大9A購01  ,0,0,0,0,0,0,0,0,0,-242000,0,0,0,83000,325000,-242000,-242000
07982P,全新群益9B售04  ,0,0,0,0,0,0,0,0,0,-243000,0,0,0,0,243000,-243000,-243000
062213,和大統一9B購02  ,0,0,0,0,0,0,0,0,0,-243000,0,0,0,106000,349000,-243000,-243000
063485,巨大元大9B購04  ,0,0,0,0,0,0,0,0,0,-244000,0,0,0,347000,591000,-244000,-244000
063276,和大元大9B購01  ,0,0,0,0,0,0,0,0,0,-244000,0,0,0,0,244000,-244000,-244000
056618,京元電永豐98購01,0,0,0,0,0,0,0,0,0,-244000,0,0,0,20000,264000,-244000,-244000
057674,台郡元大99購03  ,0,0,0,0,0,0,0,0,0,-244000,0,0,0,215000,459000,-244000,-244000
061687,大成鋼群益9A購01,0,0,0,0,0,0,0,0,0,-244000,0,0,0,0,244000,-244000,-244000
063558,聚陽元大9B購02  ,0,0,0,0,0,0,0,0,0,-245000,0,0,0,207000,452000,-245000,-245000
063836,台塑元大9C購01  ,0,0,0,0,0,0,0,0,0,-245000,0,0,0,0,245000,-245000,-245000
057299,立積永豐98購02  ,0,0,0,0,0,0,0,0,0,-245000,0,0,0,12000,257000,-245000,-245000
061034,晶豪科永豐9A購01,0,0,0,0,0,0,0,0,0,-245000,0,0,0,0,245000,-245000,-245000
060708,康友富邦9B購01  ,0,0,0,0,0,0,0,0,0,-245000,0,0,0,20000,265000,-245000,-245000
3376,新日興          ,410000,1149000,-739000,0,0,0,441000,0,441000,53000,152000,49000,103000,71000,121000,-50000,-245000
07652P,臺股指中信9A售07,0,0,0,0,0,0,0,0,0,-246000,0,0,0,20000,266000,-246000,-246000
00771,元大US高息特別股,0,0,0,0,0,0,0,0,0,-246000,215000,42000,173000,95000,514000,-419000,-246000
057961,茂林元大9A購01  ,0,0,0,0,0,0,0,0,0,-246000,0,0,0,80000,326000,-246000,-246000
061232,和大元大9A購03  ,0,0,0,0,0,0,0,0,0,-246000,0,0,0,75000,321000,-246000,-246000
062369,創意元大9B購01  ,0,0,0,0,0,0,0,0,0,-246000,0,0,0,6000,252000,-246000,-246000
060360,南亞科元富9A購02,0,0,0,0,0,0,0,0,0,-247000,0,0,0,237000,484000,-247000,-247000
058587,台積電中信9C購03,0,0,0,0,0,0,0,0,0,-248000,0,0,0,10000,258000,-248000,-248000
057074,立積永豐98購01  ,0,0,0,0,0,0,0,0,0,-248000,0,0,0,82000,330000,-248000,-248000
056265,國泰金統一97購01,0,0,0,0,0,0,0,0,0,-249000,0,0,0,0,249000,-249000,-249000
062233,神隆凱基9B購01  ,0,0,0,0,0,0,0,0,0,-249000,0,0,0,0,249000,-249000,-249000
9945,潤泰新          ,1615748,2106645,-490897,0,0,0,0,0,0,241000,257000,16000,241000,0,0,0,-249897
054638,國泰金中信99購01,0,0,0,0,0,0,0,0,0,-250000,0,0,0,0,250000,-250000,-250000
053154,聯詠元大96購01  ,0,0,0,0,0,0,0,0,0,-250000,0,0,0,0,250000,-250000,-250000
058021,牧德凱基98購02  ,0,0,0,0,0,0,0,0,0,-250000,0,0,0,0,250000,-250000,-250000
060918,康友國泰9C購01  ,0,0,0,0,0,0,0,0,0,-250000,0,0,0,116000,366000,-250000,-250000
6191,精成科          ,156000,410000,-254000,0,0,0,0,0,0,4000,4000,0,4000,0,0,0,-250000
054578,世芯元大99購01  ,0,0,0,0,0,0,0,0,0,-251000,0,0,0,171000,422000,-251000,-251000
056200,大毅永豐98購01  ,0,0,0,0,0,0,0,0,0,-251000,0,0,0,21000,272000,-251000,-251000
062069,喬山元大9B購01  ,0,0,0,0,0,0,0,0,0,-251000,0,0,0,60000,311000,-251000,-251000
063050,葡萄王統一01購01,0,0,0,0,0,0,0,0,0,-253000,0,0,0,22000,275000,-253000,-253000
3380,明泰            ,378000,645000,-267000,0,0,0,0,0,0,14000,4000,0,4000,31000,21000,10000,-253000
057444,台泥元富98購01  ,0,0,0,0,0,0,0,0,0,-254000,0,0,0,86000,340000,-254000,-254000
063131,聯茂元大9B購03  ,0,0,0,0,0,0,0,0,0,-254000,0,0,0,46000,300000,-254000,-254000
062707,致伸元大9B購01  ,0,0,0,0,0,0,0,0,0,-254000,0,0,0,376000,630000,-254000,-254000
062568,緯穎中信9C購01  ,0,0,0,0,0,0,0,0,0,-255000,0,0,0,30000,285000,-255000,-255000
062295,康友永豐9B購01  ,0,0,0,0,0,0,0,0,0,-256000,0,0,0,0,256000,-256000,-256000
063246,嘉晶元大9C購01  ,0,0,0,0,0,0,0,0,0,-257000,0,0,0,168000,425000,-257000,-257000
063371,南亞科永豐9B購01,0,0,0,0,0,0,0,0,0,-257000,0,0,0,0,257000,-257000,-257000
056559,華通群益98購02  ,0,0,0,0,0,0,0,0,0,-257000,0,0,0,739000,996000,-257000,-257000
060421,華擎永豐9A購01  ,0,0,0,0,0,0,0,0,0,-257000,0,0,0,84000,341000,-257000,-257000
058215,貿聯群益99購02  ,0,0,0,0,0,0,0,0,0,-257000,0,0,0,100000,357000,-257000,-257000
057183,玉晶光元大99購07,0,0,0,0,0,0,0,0,0,-257000,0,0,0,13000,270000,-257000,-257000
061511,緯穎富邦9B購02  ,0,0,0,0,0,0,0,0,0,-257000,0,0,0,347000,604000,-257000,-257000
060535,群創麥證9A購01  ,0,0,0,0,258000,-258000,0,0,0,-258000,0,0,0,0,258000,-258000,-258000
07967P,力山元大9B售03  ,0,0,0,0,0,0,0,0,0,-260000,0,0,0,109000,369000,-260000,-260000
056850,彩晶元富99購01  ,0,0,0,0,0,0,0,0,0,-260000,0,0,0,0,260000,-260000,-260000
060867,智伸科永豐9A購01,0,0,0,0,0,0,0,0,0,-260000,0,0,0,144000,404000,-260000,-260000
061040,康友永豐9A購01  ,0,0,0,0,0,0,0,0,0,-260000,0,0,0,0,260000,-260000,-260000
07618P,大立光中信9A售06,0,0,0,0,0,0,0,0,0,-261000,0,0,0,20000,281000,-261000,-261000
07086P,力成元富9C售01  ,0,0,0,0,0,0,0,0,0,-261000,0,0,0,194000,455000,-261000,-261000
063947,大毅元大9C購02  ,0,0,0,0,0,0,0,0,0,-261000,0,0,0,0,261000,-261000,-261000
055333,晶豪科兆豐97購01,0,0,0,0,0,0,0,0,0,-261000,0,0,0,0,261000,-261000,-261000
058457,創意永豐99購01  ,0,0,0,0,0,0,0,0,0,-261000,0,0,0,47000,308000,-261000,-261000
061383,高股息群益9A購01,0,0,0,0,0,0,0,0,0,-261000,0,0,0,0,261000,-261000,-261000
060130,瀚宇博永豐99購02,0,0,0,0,0,0,0,0,0,-262000,0,0,0,1000,263000,-262000,-262000
061618,友達群益9A購04  ,0,0,0,0,0,0,0,0,0,-262000,0,0,0,37000,299000,-262000,-262000
9919,康那香          ,4000,291000,-287000,0,0,0,0,20000,-20000,45000,0,0,0,45000,0,45000,-262000
060988,華新科元大9A購12,0,0,0,0,0,0,0,0,0,-263000,0,0,0,106000,369000,-263000,-263000
061003,南亞科兆豐9A購01,0,0,0,0,0,0,0,0,0,-263000,0,0,0,12000,275000,-263000,-263000
057491,美食元大98購03  ,0,0,0,0,0,0,0,0,0,-264000,0,0,0,30000,294000,-264000,-264000
059995,南亞科元富99購01,0,0,0,0,0,0,0,0,0,-264000,0,0,0,106000,370000,-264000,-264000
6183,關貿            ,42000,67000,-25000,0,0,0,0,0,0,-239000,2000,241000,-239000,0,0,0,-264000
063853,同欣電元大9C購02,0,0,0,0,0,0,0,0,0,-265000,0,0,0,17000,282000,-265000,-265000
056849,瀚宇博元富98購01,0,0,0,0,0,0,0,0,0,-265000,0,0,0,31000,296000,-265000,-265000
063349,台郡統一9C購01  ,0,0,0,0,0,0,0,0,0,-266000,0,0,0,237000,503000,-266000,-266000
06982P,義隆凱基99售02  ,0,0,0,0,0,0,0,0,0,-266000,0,0,0,371000,637000,-266000,-266000
059509,奇力新永豐99購02,0,0,0,0,0,0,0,0,0,-266000,0,0,0,0,266000,-266000,-266000
060534,友達麥證9A購01  ,0,0,0,8000,274000,-266000,0,0,0,-266000,0,0,0,8000,274000,-266000,-266000
063339,智邦統一01購01  ,0,0,0,0,0,0,0,0,0,-267000,0,0,0,373000,640000,-267000,-267000
07765P,台積電群益9A售06,0,0,0,0,0,0,0,0,0,-268000,0,0,0,2000,270000,-268000,-268000
060432,達方永豐9A購01  ,0,0,0,0,0,0,0,0,0,-268000,0,0,0,186000,454000,-268000,-268000
062801,宏達電統一01購01,0,0,0,0,0,0,0,0,0,-268000,0,0,0,182000,450000,-268000,-268000
062883,智易兆豐9C購01  ,0,0,0,0,0,0,0,0,0,-268000,0,0,0,0,268000,-268000,-268000
07458P,長榮航元大9A售01,0,0,0,0,0,0,0,0,0,-269000,0,0,0,0,269000,-269000,-269000
055703,緯穎富邦98購01  ,0,0,0,0,0,0,0,0,0,-269000,0,0,0,0,269000,-269000,-269000
060548,友達凱基9B購03  ,0,0,0,0,0,0,0,0,0,-269000,0,0,0,22000,291000,-269000,-269000
061398,力成中信9A購01  ,0,0,0,0,0,0,0,0,0,-269000,0,0,0,45000,314000,-269000,-269000
07247P,聯發科凱基9A售06,0,0,0,0,0,0,0,0,0,-270000,0,0,0,0,270000,-270000,-270000
08146P,台積電群益9B售08,0,0,0,0,0,0,0,0,0,-271000,0,0,0,0,271000,-271000,-271000
059090,台新金元大99購01,0,0,0,0,0,0,0,0,0,-272000,0,0,0,9000,281000,-272000,-272000
060983,南亞科元大9A購06,0,0,0,0,0,0,0,0,0,-272000,0,0,0,12000,284000,-272000,-272000
060583,南亞科元富9A購05,0,0,0,0,0,0,0,0,0,-272000,0,0,0,8000,280000,-272000,-272000
057450,國泰金元富98購01,0,0,0,0,0,0,0,0,0,-273000,0,0,0,223000,496000,-273000,-273000
057798,貿聯兆豐99購01  ,0,0,0,0,0,0,0,0,0,-273000,0,0,0,70000,343000,-273000,-273000
061873,友達元大9C購07  ,0,0,0,0,0,0,0,0,0,-273000,0,0,0,0,273000,-273000,-273000
06833P,矽力群益99售01  ,0,0,0,0,0,0,0,0,0,-274000,0,0,0,0,274000,-274000,-274000
063802,南茂凱基9C購01  ,0,0,0,0,0,0,0,0,0,-274000,0,0,0,29000,303000,-274000,-274000
056769,國產元大98購01  ,0,0,0,0,0,0,0,0,0,-274000,0,0,0,0,274000,-274000,-274000
058914,元油2X元富01購02,0,0,0,0,0,0,0,0,0,-274000,0,0,0,0,274000,-274000,-274000
063142,奇力新統一9C購04,0,0,0,0,0,0,0,0,0,-274000,0,0,0,11000,285000,-274000,-274000
052095,彩晶元大97購01  ,0,0,0,0,0,0,0,0,0,-275000,0,0,0,100000,375000,-275000,-275000
056788,日月光群益98購01,0,0,0,0,0,0,0,0,0,-275000,0,0,0,0,275000,-275000,-275000
060155,友訊永豐9A購01  ,0,0,0,0,0,0,0,0,0,-275000,0,0,0,0,275000,-275000,-275000
061129,文曄永豐9A購01  ,0,0,0,0,0,0,0,0,0,-275000,0,0,0,0,275000,-275000,-275000
054710,東元元富97購01  ,0,0,0,0,0,0,0,0,0,-276000,0,0,0,129000,405000,-276000,-276000
057883,中環群益98購01  ,0,0,0,0,0,0,0,0,0,-276000,0,0,0,0,276000,-276000,-276000
059878,聯茂凱基99購07  ,0,0,0,0,0,0,0,0,0,-280000,0,0,0,57000,337000,-280000,-280000
057141,嘉聯益兆豐99購01,0,0,0,0,0,0,0,0,0,-280000,0,0,0,628000,908000,-280000,-280000
056385,創意國泰99購01  ,0,0,0,0,0,0,0,0,0,-281000,0,0,0,66000,347000,-281000,-281000
062879,美食兆豐9B購01  ,0,0,0,0,0,0,0,0,0,-281000,0,0,0,2000,283000,-281000,-281000
054347,上緯控國票96購02,0,0,0,0,0,0,0,0,0,-282000,0,0,0,55000,337000,-282000,-282000
059860,台積電群益9A購02,0,0,0,0,0,0,0,0,0,-282000,0,0,0,22000,304000,-282000,-282000
058144,聯茂元大99購02  ,0,0,0,0,0,0,0,0,0,-282000,0,0,0,68000,350000,-282000,-282000
057780,台郡群益98購02  ,0,0,0,0,0,0,0,0,0,-282000,0,0,0,84000,366000,-282000,-282000
062653,正隆永豐9B購01  ,0,0,0,0,0,0,0,0,0,-282000,0,0,0,0,282000,-282000,-282000
07032P,聯發科統一9C售02,0,0,0,0,0,0,0,0,0,-285000,0,0,0,2000,287000,-285000,-285000
03414B,臺股指凱基99熊01,0,70000,-70000,0,0,0,0,0,0,-215000,0,0,0,485000,700000,-215000,-285000
07832P,台積電群益9A售08,0,0,0,0,0,0,0,0,0,-286000,0,0,0,15000,301000,-286000,-286000
057888,貿聯群益98購02  ,0,0,0,0,0,0,0,0,0,-287000,0,0,0,2000,289000,-287000,-287000
061417,力成群益9A購01  ,0,0,0,0,0,0,0,0,0,-287000,0,0,0,239000,526000,-287000,-287000
063581,同欣電國泰9C購01,0,0,0,0,0,0,0,0,0,-288000,0,0,0,0,288000,-288000,-288000
063358,華擎國泰01購01  ,0,0,0,0,0,0,0,0,0,-288000,0,0,0,20000,308000,-288000,-288000
059943,信邦永豐99購01  ,0,0,0,0,0,0,0,0,0,-289000,0,0,0,311000,600000,-289000,-289000
062345,和大群益9B購01  ,0,0,0,0,0,0,0,0,0,-289000,0,0,0,258000,547000,-289000,-289000
061877,貿聯元大9B購01  ,0,0,0,0,0,0,0,0,0,-290000,0,0,0,17000,307000,-290000,-290000
061124,微星永豐9A購02  ,0,0,0,0,0,0,0,0,0,-291000,0,0,0,33000,324000,-291000,-291000
061030,喬山永豐9A購01  ,0,0,0,0,0,0,0,0,0,-291000,0,0,0,58000,349000,-291000,-291000
055631,創意永豐98購01  ,0,0,0,0,0,0,0,0,0,-292000,0,0,0,21000,313000,-292000,-292000
05563P,台積電元大97售07,0,0,0,0,0,0,0,0,0,-292000,0,0,0,0,292000,-292000,-292000
060483,友達富邦9A購01  ,0,0,0,0,0,0,0,0,0,-292000,0,0,0,0,292000,-292000,-292000
056538,國泰金凱基98購01,0,0,0,0,0,0,0,0,0,-293000,0,0,0,123000,416000,-293000,-293000
054695,世芯永豐98購01  ,0,0,0,0,0,0,0,0,0,-293000,0,0,0,27000,320000,-293000,-293000
061373,華通富邦9A購02  ,0,0,0,0,0,0,0,0,0,-293000,0,0,0,259000,552000,-293000,-293000
062540,茂林國泰9C購01  ,0,0,0,0,0,0,0,0,0,-293000,0,0,0,170000,463000,-293000,-293000
06668P,祥碩凱基98售02  ,0,0,0,0,0,0,0,0,0,-294000,0,0,0,80000,374000,-294000,-294000
062561,瀚宇博凱基9B購01,0,0,0,0,0,0,0,0,0,-294000,0,0,0,77000,371000,-294000,-294000
063296,可成麥證9B購01  ,0,0,0,5000,300000,-295000,0,0,0,-295000,0,0,0,5000,300000,-295000,-295000
063604,群創凱基01購02  ,0,0,0,0,0,0,0,0,0,-295000,0,0,0,61000,356000,-295000,-295000
063613,全新群益9C購01  ,0,0,0,0,0,0,0,0,0,-295000,0,0,0,151000,446000,-295000,-295000
062522,同欣電元大9B購02,0,0,0,0,0,0,0,0,0,-295000,0,0,0,60000,355000,-295000,-295000
059080,亞泥元大99購01  ,0,0,0,0,0,0,0,0,0,-296000,0,0,0,57000,353000,-296000,-296000
056665,上証2X國票99購02,0,0,0,0,0,0,0,0,0,-296000,0,0,0,6000,302000,-296000,-296000
060506,京元電元大9A購02,0,0,0,0,0,0,0,0,0,-296000,0,0,0,35000,331000,-296000,-296000
058762,貿聯群益99購03  ,0,0,0,0,0,0,0,0,0,-297000,0,0,0,235000,532000,-297000,-297000
058584,百和群益9A購01  ,0,0,0,0,0,0,0,0,0,-297000,0,0,0,71000,368000,-297000,-297000
057525,光磊元大99購01  ,0,0,0,0,0,0,0,0,0,-298000,0,0,0,15000,313000,-298000,-298000
058247,聯茂元大99購04  ,0,0,0,0,0,0,0,0,0,-298000,0,0,0,68000,366000,-298000,-298000
063077,巨大永豐9B購03  ,0,0,0,0,0,0,0,0,0,-298000,0,0,0,104000,402000,-298000,-298000
062279,晶豪科群益9B購01,0,0,0,0,0,0,0,0,0,-299000,0,0,0,30000,329000,-299000,-299000
07588P,滬深2X國票9C售01,0,0,0,0,0,0,0,0,0,-300000,0,0,0,0,300000,-300000,-300000
054585,禾伸堂國泰99購01,0,0,0,0,0,0,0,0,0,-300000,0,0,0,0,300000,-300000,-300000
059581,日月光元富99購02,0,0,0,0,0,0,0,0,0,-300000,0,0,0,715000,1015000,-300000,-300000
2548,華固            ,364000,781000,-417000,0,0,0,0,0,0,116000,149000,33000,116000,0,0,0,-301000
055746,同欣電元富97購01,0,0,0,0,0,0,0,0,0,-302000,0,0,0,2000,304000,-302000,-302000
056894,佳世達元大99購01,0,0,0,0,0,0,0,0,0,-302000,0,0,0,0,302000,-302000,-302000
057083,立積統一98購01  ,0,0,0,0,0,0,0,0,0,-303000,0,0,0,12000,315000,-303000,-303000
056676,國產元富98購01  ,0,0,0,0,0,0,0,0,0,-303000,0,0,0,283000,586000,-303000,-303000
061979,友達元大9C購08  ,0,0,0,0,0,0,0,0,0,-303000,0,0,0,68000,371000,-303000,-303000
058444,國巨富邦9B購01  ,0,0,0,0,0,0,0,0,0,-304000,0,0,0,1000,305000,-304000,-304000
060791,聯茂富邦9A購02  ,0,0,0,0,0,0,0,0,0,-304000,0,0,0,0,304000,-304000,-304000
061582,麗豐元大9A購01  ,0,0,0,0,0,0,0,0,0,-304000,0,0,0,245000,549000,-304000,-304000
063431,神隆元富9B購01  ,0,0,0,0,0,0,0,0,0,-305000,0,0,0,40000,345000,-305000,-305000
07022P,嘉晶永豐99售02  ,0,0,0,0,0,0,0,0,0,-306000,0,0,0,60000,366000,-306000,-306000
059450,和大永豐99購01  ,0,0,0,0,0,0,0,0,0,-306000,0,0,0,7000,313000,-306000,-306000
054709,宏達電統一97購01,0,0,0,0,0,0,0,0,0,-308000,0,0,0,616000,924000,-308000,-308000
058424,滬深2X元富99購04,0,0,0,0,0,0,0,0,0,-308000,0,0,0,26000,334000,-308000,-308000
060953,富邦金群益9A購01,0,0,0,0,0,0,0,0,0,-308000,0,0,0,165000,473000,-308000,-308000
063113,聯茂兆豐9B購01  ,0,0,0,0,0,0,0,0,0,-309000,0,0,0,46000,355000,-309000,-309000
063872,嘉聯益永豐9C購01,0,0,0,0,0,0,0,0,0,-310000,0,0,0,9000,319000,-310000,-310000
00633L,富邦上証正2     ,2947000,978000,1969000,0,0,0,0,0,0,-2279000,0,0,0,3613000,5892000,-2279000,-310000
058410,國巨兆豐99購03  ,0,0,0,0,0,0,0,0,0,-310000,0,0,0,33000,343000,-310000,-310000
058810,國巨統一9B購04  ,0,0,0,0,0,0,0,0,0,-310000,0,0,0,422000,732000,-310000,-310000
062497,遠東新群益9B購01,0,0,0,0,0,0,0,0,0,-310000,0,0,0,110000,420000,-310000,-310000
063495,台光電富邦9C購01,0,0,0,0,0,0,0,0,0,-311000,0,0,0,0,311000,-311000,-311000
053361,友達元富99購01  ,0,0,0,0,0,0,0,0,0,-311000,0,0,0,20000,331000,-311000,-311000
058923,華新科元富99購06,0,0,0,0,0,0,0,0,0,-312000,0,0,0,41000,353000,-312000,-312000
063560,力山元大9B購05  ,0,0,0,0,0,0,0,0,0,-313000,0,0,0,86000,399000,-313000,-313000
060552,群創凱基9B購05  ,0,0,0,0,0,0,0,0,0,-315000,0,0,0,35000,350000,-315000,-315000
063432,金寶元富9B購01  ,0,0,0,0,0,0,0,0,0,-317000,0,0,0,236000,553000,-317000,-317000
059297,大立光元富9C購01,0,0,0,0,0,0,0,0,0,-317000,0,0,0,297000,614000,-317000,-317000
058054,台積電統一9C購01,0,0,0,0,0,0,0,0,0,-317000,0,0,0,1499000,1816000,-317000,-317000
063133,喬山統一01購01  ,0,0,0,0,0,0,0,0,0,-317000,0,0,0,23000,340000,-317000,-317000
063071,華新科富邦02購01,0,0,0,0,0,0,0,0,0,-317000,0,0,0,0,317000,-317000,-317000
1611,中電            ,16000,335000,-319000,0,0,0,0,0,0,0,0,0,0,0,0,0,-319000
00717,富邦美國特別股  ,0,0,0,0,0,0,0,0,0,-319000,0,0,0,396000,715000,-319000,-319000
062950,貿聯富邦01購01  ,0,0,0,0,0,0,0,0,0,-319000,0,0,0,179000,498000,-319000,-319000
060686,康友元大9A購02  ,0,0,0,0,0,0,0,0,0,-319000,0,0,0,2000,321000,-319000,-319000
061562,群創國票9B購01  ,0,0,0,0,0,0,0,0,0,-319000,0,0,0,57000,376000,-319000,-319000
063277,大成鋼元大9B購03,0,0,0,0,0,0,0,0,0,-320000,0,0,0,362000,682000,-320000,-320000
06618P,智邦元大98售04  ,0,0,0,0,0,0,0,0,0,-320000,0,0,0,0,320000,-320000,-320000
056458,日月光凱基98購02,0,0,0,0,0,0,0,0,0,-321000,0,0,0,60000,381000,-321000,-321000
059643,日月光凱基99購02,0,0,0,0,0,0,0,0,0,-321000,0,0,0,140000,461000,-321000,-321000
058936,國喬中信99購01  ,0,0,0,0,0,0,0,0,0,-321000,0,0,0,180000,501000,-321000,-321000
060891,世芯統一9A購01  ,0,0,0,0,0,0,0,0,0,-322000,0,0,0,0,322000,-322000,-322000
062085,同欣電元大9B購01,0,0,0,0,0,0,0,0,0,-322000,0,0,0,82000,404000,-322000,-322000
062761,嘉晶凱基9C購01  ,0,0,0,0,0,0,0,0,0,-323000,0,0,0,157000,480000,-323000,-323000
06479P,聯發科中信99售02,0,0,0,0,0,0,0,0,0,-325000,0,0,0,100000,425000,-325000,-325000
054577,世芯元大98購01  ,0,0,0,0,0,0,0,0,0,-325000,0,0,0,129000,454000,-325000,-325000
056321,創意群益98購02  ,0,0,0,0,0,0,0,0,0,-325000,0,0,0,98000,423000,-325000,-325000
063203,華新科統一9C購04,0,0,0,0,0,0,0,0,0,-325000,0,0,0,1000,326000,-325000,-325000
059140,大立光兆豐9A購02,0,0,0,0,0,0,0,0,0,-327000,0,0,0,159000,486000,-327000,-327000
058025,聯茂國泰99購01  ,0,0,0,0,0,0,0,0,0,-327000,0,0,0,177000,504000,-327000,-327000
061283,智邦統一9A購01  ,0,0,0,0,0,0,0,0,0,-327000,0,0,0,81000,408000,-327000,-327000
060364,奇力新元富9A購01,0,0,0,0,0,0,0,0,0,-329000,0,0,0,129000,458000,-329000,-329000
057656,大成鋼兆豐98購01,0,0,0,0,0,0,0,0,0,-330000,0,0,0,91000,421000,-330000,-330000
1215,卜蜂            ,400000,771000,-371000,0,0,0,0,0,0,38000,0,0,0,48000,10000,38000,-333000
057887,智原群益98購04  ,0,0,0,0,0,0,0,0,0,-333000,0,0,0,164000,497000,-333000,-333000
063121,友達元大9C購09  ,0,0,0,0,0,0,0,0,0,-333000,0,0,0,51000,384000,-333000,-333000
062807,和碩統一9B購01  ,0,0,0,0,0,0,0,0,0,-333000,0,0,0,138000,471000,-333000,-333000
062846,國泰金富邦9C購01,0,0,0,0,0,0,0,0,0,-333000,0,0,0,402000,735000,-333000,-333000
052863,友達凱基98購02  ,0,0,0,0,0,0,0,0,0,-334000,0,0,0,0,334000,-334000,-334000
061106,群創元大9B購09  ,0,0,0,0,0,0,0,0,0,-334000,0,0,0,56000,390000,-334000,-334000
4956,光鋐            ,497000,832000,-335000,0,0,0,0,0,0,1000,1000,0,1000,0,0,0,-334000
063229,台表科群益9B購04,0,0,0,0,0,0,0,0,0,-335000,0,0,0,60000,395000,-335000,-335000
063569,美食元大9B購03  ,0,0,0,0,0,0,0,0,0,-336000,0,0,0,59000,395000,-336000,-336000
052367,聯茂國票96購02  ,0,0,0,0,0,0,0,0,0,-336000,0,0,0,15000,351000,-336000,-336000
053118,大立光中信9C購01,0,0,0,0,0,0,0,0,0,-336000,0,0,0,515000,851000,-336000,-336000
059051,和大凱基9A購01  ,0,0,0,0,0,0,0,0,0,-336000,0,0,0,40000,376000,-336000,-336000
055698,茂林國票98購03  ,0,0,0,0,0,0,0,0,0,-336000,0,0,0,0,336000,-336000,-336000
05677P,玉晶光群益98售03,0,0,0,0,0,0,0,0,0,-336000,0,0,0,0,336000,-336000,-336000
062785,世芯元大9C購01  ,0,0,0,0,0,0,0,0,0,-336000,0,0,0,321000,657000,-336000,-336000
058646,聯茂富邦9A購01  ,0,0,0,0,0,0,0,0,0,-338000,0,0,0,250000,588000,-338000,-338000
06656P,GIS元大98售02   ,0,0,0,0,0,0,0,0,0,-340000,0,0,0,212000,552000,-340000,-340000
053568,智伸科富邦98購01,0,0,0,0,0,0,0,0,0,-341000,0,0,0,10000,351000,-341000,-341000
060124,奇力新永豐99購03,0,0,0,0,0,0,0,0,0,-341000,0,0,0,0,341000,-341000,-341000
062225,華擎統一01購01  ,0,0,0,0,0,0,0,0,0,-341000,0,0,0,74000,415000,-341000,-341000
061928,群創凱基9B購06  ,0,0,0,0,0,0,0,0,0,-341000,0,0,0,98000,439000,-341000,-341000
062974,奇力新元富9B購01,0,0,0,0,0,0,0,0,0,-342000,0,0,0,129000,471000,-342000,-342000
07711P,世芯元大9A售07  ,0,0,0,0,0,0,0,0,0,-343000,0,0,0,110000,453000,-343000,-343000
08111P,臺股指中信01售06,0,0,0,0,0,0,0,0,0,-343000,0,0,0,23000,366000,-343000,-343000
03447B,臺股指凱基9B熊16,0,0,0,0,0,0,0,0,0,-343000,0,0,0,0,343000,-343000,-343000
057675,同欣電元大98購02,0,0,0,0,0,0,0,0,0,-343000,0,0,0,258000,601000,-343000,-343000
062033,瀚宇博群益9B購01,0,0,0,0,0,0,0,0,0,-345000,0,0,0,113000,458000,-345000,-345000
063399,智原群益9B購01  ,0,0,0,0,0,0,0,0,0,-346000,0,0,0,91000,437000,-346000,-346000
061986,晶豪科元大9B購01,0,0,0,0,0,0,0,0,0,-346000,0,0,0,78000,424000,-346000,-346000
2379,瑞昱            ,1031728,1386000,-354272,0,0,0,0,50000,-50000,58000,134000,78000,56000,11000,9000,2000,-346272
058764,康友群益99購01  ,0,0,0,0,0,0,0,0,0,-350000,0,0,0,0,350000,-350000,-350000
061493,T50反1國票9B購04,0,0,0,0,0,0,0,0,0,-350000,0,0,0,0,350000,-350000,-350000
058547,世紀鋼富邦9A購01,0,0,0,0,0,0,0,0,0,-352000,0,0,0,0,352000,-352000,-352000
060942,智邦國票9A購02  ,0,0,0,0,0,0,0,0,0,-354000,0,0,0,0,354000,-354000,-354000
060126,創意永豐99購04  ,0,0,0,0,0,0,0,0,0,-356000,0,0,0,26000,382000,-356000,-356000
07491P,臺股指國票9A售09,0,0,0,0,0,0,0,0,0,-357000,0,0,0,200000,557000,-357000,-357000
07115P,T50反1日盛9C售02,0,0,0,0,0,0,0,0,0,-357000,0,0,0,0,357000,-357000,-357000
057733,嘉聯益國泰99購01,0,0,0,0,0,0,0,0,0,-357000,0,0,0,86000,443000,-357000,-357000
061769,晶技元大9B購03  ,0,0,0,0,0,0,0,0,0,-358000,0,0,0,31000,389000,-358000,-358000
063222,群創群益9B購03  ,0,0,0,0,0,0,0,0,0,-358000,0,0,0,69000,427000,-358000,-358000
00670L,富邦NASDAQ正2   ,5000,1000,4000,0,0,0,0,0,0,-364000,48000,0,48000,180000,592000,-412000,-360000
057717,友訊元富98購02  ,0,0,0,0,0,0,0,0,0,-360000,0,0,0,107000,467000,-360000,-360000
3017,奇鋐            ,1400000,1421000,-21000,0,0,0,0,0,0,-340000,53000,35000,18000,46000,404000,-358000,-361000
061610,力成統一9C購01  ,0,0,0,0,0,0,0,0,0,-362000,0,0,0,446000,808000,-362000,-362000
060183,南亞科元富9A購01,0,0,0,0,0,0,0,0,0,-363000,0,0,0,59000,422000,-363000,-363000
060528,友達中信9C購01  ,0,0,0,0,0,0,0,0,0,-363000,0,0,0,30000,393000,-363000,-363000
062871,大成鋼兆豐9B購01,0,0,0,0,0,0,0,0,0,-363000,0,0,0,30000,393000,-363000,-363000
063466,美食元大9B購02  ,0,0,0,0,0,0,0,0,0,-365000,0,0,0,68000,433000,-365000,-365000
057356,彩晶統一98購04  ,0,0,0,0,0,0,0,0,0,-365000,0,0,0,0,365000,-365000,-365000
055744,茂林元富97購02  ,0,0,0,0,0,0,0,0,0,-366000,0,0,0,681000,1047000,-366000,-366000
061196,世芯永豐9A購06  ,0,0,0,0,0,0,0,0,0,-366000,0,0,0,168000,534000,-366000,-366000
060511,群創元大9B購08  ,0,0,0,0,0,0,0,0,0,-368000,0,0,0,52000,420000,-368000,-368000
062823,台表科兆豐9B購01,0,0,0,0,0,0,0,0,0,-368000,0,0,0,313000,681000,-368000,-368000
062337,台表科統一01購01,0,0,0,0,0,0,0,0,0,-368000,0,0,0,156000,524000,-368000,-368000
063950,信邦元大9C購01  ,0,0,0,0,0,0,0,0,0,-369000,0,0,0,0,369000,-369000,-369000
056995,華新科日盛99購01,0,0,0,0,0,0,0,0,0,-370000,0,0,0,170000,540000,-370000,-370000
058280,SGBR2X中信99購01,0,0,0,0,0,0,0,0,0,-370000,0,0,0,0,370000,-370000,-370000
063811,亞德客群益9C購01,0,0,0,0,0,0,0,0,0,-371000,0,0,0,0,371000,-371000,-371000
057009,信邦中信99購01  ,0,0,0,0,0,0,0,0,0,-371000,0,0,0,48000,419000,-371000,-371000
062771,臺股指凱基9B購15,0,0,0,0,0,0,0,0,0,-371000,0,0,0,10000,381000,-371000,-371000
062690,華擎統一9B購01  ,0,0,0,0,0,0,0,0,0,-373000,0,0,0,36000,409000,-373000,-373000
06152P,玉晶光元大98售06,0,0,0,0,0,0,0,0,0,-373000,0,0,0,2000,375000,-373000,-373000
062982,同欣電元富9B購01,0,0,0,0,0,0,0,0,0,-375000,0,0,0,27000,402000,-375000,-375000
062293,麗豐永豐9B購01  ,0,0,0,0,0,0,0,0,0,-375000,0,0,0,34000,409000,-375000,-375000
061789,群創群益9B購01  ,0,0,0,0,0,0,0,0,0,-376000,0,0,0,0,376000,-376000,-376000
063049,上海銀兆豐9B購01,0,0,0,0,0,0,0,0,0,-378000,0,0,0,510000,888000,-378000,-378000
07354P,臺股指國票99售22,0,0,0,0,0,0,0,0,0,-379000,0,0,0,120000,499000,-379000,-379000
055235,金寶台新98購01  ,0,0,0,0,0,0,0,0,0,-379000,0,0,0,0,379000,-379000,-379000
057002,友達國票98購01  ,0,0,0,0,0,0,0,0,0,-380000,0,0,0,80000,460000,-380000,-380000
062456,台積電群益9B購05,0,0,0,0,0,0,0,0,0,-380000,0,0,0,119000,499000,-380000,-380000
05644P,大立光中信9A售03,0,0,0,0,0,0,0,0,0,-383000,0,0,0,615000,998000,-383000,-383000
061006,新光金兆豐9A購01,0,0,0,0,0,0,0,0,0,-383000,0,0,0,89000,472000,-383000,-383000
06323P,台郡統一97售01  ,0,0,0,0,0,0,0,0,0,-384000,0,0,0,0,384000,-384000,-384000
4106,雃博            ,504000,889000,-385000,0,0,0,0,0,0,1000,1000,0,1000,0,0,0,-384000
055295,瀚宇博元大97購02,0,0,0,0,0,0,0,0,0,-385000,0,0,0,100000,485000,-385000,-385000
062945,世芯國泰01購01  ,0,0,0,0,0,0,0,0,0,-385000,0,0,0,217000,602000,-385000,-385000
061085,聯茂兆豐9A購01  ,0,0,0,0,0,0,0,0,0,-386000,0,0,0,26000,412000,-386000,-386000
060298,鎧勝元大9C購01  ,0,0,0,0,0,0,0,0,0,-387000,0,0,0,132000,519000,-387000,-387000
060307,南港永豐9A購01  ,0,0,0,0,0,0,0,0,0,-387000,0,0,0,70000,457000,-387000,-387000
8016,矽創            ,443000,876000,-433000,0,0,0,1000,0,1000,45000,22000,1000,21000,32000,8000,24000,-387000
060248,日月光元大9A購01,0,0,0,0,0,0,0,0,0,-391000,0,0,0,107000,498000,-391000,-391000
062784,世芯元大9B購01  ,0,0,0,0,0,0,0,0,0,-391000,0,0,0,79000,470000,-391000,-391000
00662,富邦NASDAQ      ,0,23000,-23000,0,0,0,0,0,0,-370000,0,0,0,82000,452000,-370000,-393000
00686R,群益臺灣加權反1 ,0,0,0,0,0,0,0,0,0,-394000,0,0,0,237000,631000,-394000,-394000
07366P,國巨康和99售02  ,0,0,0,0,0,0,0,0,0,-395000,0,0,0,35000,430000,-395000,-395000
058145,聯茂元大99購03  ,0,0,0,0,0,0,0,0,0,-395000,0,0,0,23000,418000,-395000,-395000
058262,大立光富邦9C購02,0,0,0,0,0,0,0,0,0,-396000,0,0,0,7000,403000,-396000,-396000
063074,創意永豐9B購02  ,0,0,0,0,0,0,0,0,0,-396000,0,0,0,72000,468000,-396000,-396000
061241,晶技兆豐9A購01  ,0,0,0,0,0,0,0,0,0,-396000,0,0,0,48000,444000,-396000,-396000
06286P,世芯國票97售02  ,0,0,0,0,0,0,0,0,0,-397000,0,0,0,226000,623000,-397000,-397000
061971,力山元大9C購02  ,0,0,0,0,0,0,0,0,0,-397000,0,0,0,165000,562000,-397000,-397000
056860,正崴群益98購01  ,0,0,0,0,0,0,0,0,0,-398000,0,0,0,14000,412000,-398000,-398000
063510,台表科群益9C購01,0,0,0,0,0,0,0,0,0,-400000,0,0,0,85000,485000,-400000,-400000
062833,世芯群益9B購01  ,0,0,0,0,0,0,0,0,0,-401000,0,0,0,144000,545000,-401000,-401000
063310,和大群益9B購02  ,0,0,0,0,0,0,0,0,0,-403000,0,0,0,128000,531000,-403000,-403000
057307,瀚宇博兆豐99購01,0,0,0,0,0,0,0,0,0,-403000,0,0,0,181000,584000,-403000,-403000
07804P,美律永豐9A售02  ,0,0,0,0,0,0,0,0,0,-404000,0,0,0,0,404000,-404000,-404000
057931,正崴群益98購02  ,0,0,0,0,0,0,0,0,0,-404000,0,0,0,10000,414000,-404000,-404000
060286,佳世達元大9C購01,0,0,0,0,0,0,0,0,0,-404000,0,0,0,51000,455000,-404000,-404000
060194,旭富元富9A購01  ,0,0,0,0,0,0,0,0,0,-408000,0,0,0,270000,678000,-408000,-408000
063198,仁寶統一01購02  ,0,0,0,0,0,0,0,0,0,-408000,0,0,0,104000,512000,-408000,-408000
061202,和大元大9A購02  ,0,0,0,0,0,0,0,0,0,-408000,0,0,0,45000,453000,-408000,-408000
063475,同欣電元大9C購01,0,0,0,0,0,0,0,0,0,-409000,0,0,0,15000,424000,-409000,-409000
053114,聯茂兆豐97購01  ,0,0,0,0,0,0,0,0,0,-410000,0,0,0,30000,440000,-410000,-410000
061703,信邦國票9A購01  ,0,0,0,0,0,0,0,0,0,-410000,0,0,0,85000,495000,-410000,-410000
063657,茂林元富9B購04  ,0,0,0,0,0,0,0,0,0,-411000,0,0,0,0,411000,-411000,-411000
058908,貿聯元大99購03  ,0,0,0,0,0,0,0,0,0,-412000,0,0,0,56000,468000,-412000,-412000
061227,日月光中信9B購01,0,0,0,0,0,0,0,0,0,-413000,0,0,0,14000,427000,-413000,-413000
07218P,臺股指凱基99售31,0,0,0,0,0,0,0,0,0,-414000,0,0,0,51000,465000,-414000,-414000
054426,國泰金富邦97購02,0,0,0,0,0,0,0,0,0,-414000,0,0,0,90000,504000,-414000,-414000
060243,潤泰全元大9C購02,0,0,0,0,0,0,0,0,0,-414000,0,0,0,115000,529000,-414000,-414000
6669,緯穎            ,753190,999206,-246016,0,0,0,95000,360000,-265000,97000,103000,15000,88000,10000,1000,9000,-414016
08156P,大立光元富9B售05,0,0,0,0,0,0,0,0,0,-415000,0,0,0,4000,419000,-415000,-415000
060121,新光金富邦99購01,0,0,0,0,0,0,0,0,0,-415000,0,0,0,190000,605000,-415000,-415000
2342,茂矽            ,240501,658000,-417499,0,0,0,0,0,0,2000,2000,0,2000,0,0,0,-415499
056680,華通統一98購04  ,0,0,0,0,0,0,0,0,0,-417000,0,0,0,13000,430000,-417000,-417000
062520,晶豪科元大9B購02,0,0,0,0,0,0,0,0,0,-417000,0,0,0,69000,486000,-417000,-417000
063876,華新元富9C購01  ,0,0,0,0,0,0,0,0,0,-418000,0,0,0,0,418000,-418000,-418000
056693,國產群益98購01  ,0,0,0,0,0,0,0,0,0,-418000,0,0,0,98000,516000,-418000,-418000
061355,康友元大9A購03  ,0,0,0,0,0,0,0,0,0,-418000,0,0,0,12000,430000,-418000,-418000
03648C,T50反1元大96牛07,0,0,0,0,0,0,0,0,0,-419000,0,0,0,11000,430000,-419000,-419000
061134,大成鋼統一9C購01,0,0,0,0,0,0,0,0,0,-419000,0,0,0,26000,445000,-419000,-419000
062660,神隆群益9B購02  ,0,0,0,0,0,0,0,0,0,-419000,0,0,0,75000,494000,-419000,-419000
049700,瀚宇博元大97購01,0,0,0,0,0,0,0,0,0,-421000,0,0,0,24000,445000,-421000,-421000
062133,大成鋼群益9B購01,0,0,0,0,0,0,0,0,0,-423000,0,0,0,0,423000,-423000,-423000
063322,台郡群益9B購02  ,0,0,0,0,0,0,0,0,0,-424000,0,0,0,291000,715000,-424000,-424000
056579,麗豐元大99購01  ,0,0,0,0,0,0,0,0,0,-425000,0,0,0,142000,567000,-425000,-425000
060242,潤泰全元大9C購01,0,0,0,0,0,0,0,0,0,-426000,0,0,0,44000,470000,-426000,-426000
063072,裕隆永豐9B購01  ,0,0,0,0,0,0,0,0,0,-427000,0,0,0,68000,495000,-427000,-427000
055909,大成鋼凱基98購02,0,0,0,0,0,0,0,0,0,-428000,0,0,0,0,428000,-428000,-428000
3036,文曄            ,247000,467000,-220000,0,0,0,48000,0,48000,-257000,90000,370000,-280000,23000,0,23000,-429000
058515,健鼎元大99購01  ,0,0,0,0,0,0,0,0,0,-430000,0,0,0,108000,538000,-430000,-430000
062850,友訊永豐9B購01  ,0,0,0,0,0,0,0,0,0,-430000,0,0,0,36000,466000,-430000,-430000
9914,美利達          ,334000,476000,-142000,0,0,0,12000,360000,-348000,59000,74000,15000,59000,0,0,0,-431000
063344,臺企銀統一9C購01,0,0,0,0,0,0,0,0,0,-432000,0,0,0,20000,452000,-432000,-432000
063589,美食永豐9B購02  ,0,0,0,0,0,0,0,0,0,-432000,0,0,0,260000,692000,-432000,-432000
00715L,街口布蘭特油正2 ,340000,0,340000,0,0,0,0,0,0,-772000,0,0,0,150000,922000,-772000,-432000
058829,華新科永豐99購04,0,0,0,0,0,0,0,0,0,-436000,0,0,0,81000,517000,-436000,-436000
054826,復盛元大9A購01  ,0,0,0,0,0,0,0,0,0,-437000,0,0,0,96000,533000,-437000,-437000
057836,南亞科國泰9A購01,0,0,0,0,0,0,0,0,0,-437000,0,0,0,75000,512000,-437000,-437000
063639,華擎元大9C購03  ,0,0,0,0,0,0,0,0,0,-440000,0,0,0,23000,463000,-440000,-440000
063441,台達電統一9C購01,0,0,0,0,0,0,0,0,0,-440000,0,0,0,423000,863000,-440000,-440000
063893,微星群益9C購01  ,0,0,0,0,0,0,0,0,0,-440000,0,0,0,0,440000,-440000,-440000
07091P,SGBR2X凱基9A售02,0,0,0,0,0,0,0,0,0,-440000,0,0,0,0,440000,-440000,-440000
060695,同欣電麥證9A購01,0,0,0,0,527000,-527000,0,0,0,-440000,0,0,0,87000,527000,-440000,-440000
062126,創意統一9B購01  ,0,0,0,0,0,0,0,0,0,-441000,0,0,0,176000,617000,-441000,-441000
054349,同欣電國票97購02,0,0,0,0,0,0,0,0,0,-443000,0,0,0,115000,558000,-443000,-443000
051849,旺宏中信98購01  ,0,0,0,0,0,0,0,0,0,-443000,0,0,0,157000,600000,-443000,-443000
061535,群創統一9C購01  ,0,0,0,0,0,0,0,0,0,-444000,0,0,0,134000,578000,-444000,-444000
063879,台積電元富9C購01,0,0,0,0,0,0,0,0,0,-445000,0,0,0,0,445000,-445000,-445000
2387,精元            ,658000,1277000,-619000,0,0,0,0,0,0,174000,33000,0,33000,145000,4000,141000,-445000
062201,臺指反國票9B購05,0,0,0,0,0,0,0,0,0,-445000,0,0,0,0,445000,-445000,-445000
058319,大毅永豐9A購01  ,0,0,0,0,0,0,0,0,0,-446000,0,0,0,13000,459000,-446000,-446000
057257,台泥兆豐99購01  ,0,0,0,0,0,0,0,0,0,-447000,0,0,0,10000,457000,-447000,-447000
062528,全新統一9C購01  ,0,0,0,0,0,0,0,0,0,-447000,0,0,0,0,447000,-447000,-447000
062943,世芯凱基9B購03  ,0,0,0,0,0,0,0,0,0,-447000,0,0,0,56000,503000,-447000,-447000
063260,信邦富邦9B購01  ,0,0,0,0,0,0,0,0,0,-448000,0,0,0,220000,668000,-448000,-448000
053276,友達元大9C購01  ,0,0,0,0,0,0,0,0,0,-450000,0,0,0,0,450000,-450000,-450000
061787,華新科群益9C購01,0,0,0,0,0,0,0,0,0,-450000,0,0,0,9000,459000,-450000,-450000
2915,潤泰全          ,2316000,2736095,-420095,0,0,0,0,0,0,-30000,167000,10000,157000,64000,251000,-187000,-450095
058327,大毅統一9B購01  ,0,0,0,0,0,0,0,0,0,-451000,0,0,0,873000,1324000,-451000,-451000
1229,聯華            ,436000,1151150,-715150,0,0,0,0,0,0,264000,264000,0,264000,0,0,0,-451150
060677,京元電元大9A購04,0,0,0,0,0,0,0,0,0,-452000,0,0,0,261000,713000,-452000,-452000
06674P,祥碩群益98售02  ,0,0,0,0,0,0,0,0,0,-453000,0,0,0,102000,555000,-453000,-453000
061347,創意元大9A購02  ,0,0,0,0,0,0,0,0,0,-454000,0,0,0,140000,594000,-454000,-454000
063117,聯茂麥證9B購01  ,0,0,0,0,457000,-457000,0,0,0,-457000,0,0,0,0,457000,-457000,-457000
062746,致伸永豐9B購01  ,0,0,0,0,0,0,0,0,0,-457000,0,0,0,147000,604000,-457000,-457000
052277,台達電凱基97購01,0,0,0,0,0,0,0,0,0,-459000,0,0,0,0,459000,-459000,-459000
059183,T50反1台新03購02,0,0,0,0,0,0,0,0,0,-460000,0,0,0,0,460000,-460000,-460000
062016,美食永豐9B購01  ,0,0,0,0,0,0,0,0,0,-460000,0,0,0,181000,641000,-460000,-460000
062689,華擎統一02購01  ,0,0,0,0,0,0,0,0,0,-467000,0,0,0,35000,502000,-467000,-467000
6271,同欣電          ,715000,1927000,-1212000,0,0,0,490000,112000,378000,366000,113000,86000,27000,342000,3000,339000,-468000
057835,華擎元富9B購01  ,0,0,0,0,0,0,0,0,0,-469000,0,0,0,80000,549000,-469000,-469000
059438,群創元大99購06  ,0,0,0,0,0,0,0,0,0,-472000,0,0,0,317000,789000,-472000,-472000
062230,緯穎統一01購01  ,0,0,0,0,0,0,0,0,0,-472000,0,0,0,45000,517000,-472000,-472000
054808,東元元大9A購01  ,0,0,0,0,0,0,0,0,0,-476000,0,0,0,35000,511000,-476000,-476000
063311,喬山群益9B購01  ,0,0,0,0,0,0,0,0,0,-480000,0,0,0,0,480000,-480000,-480000
061364,國巨國票9A購09  ,0,0,0,0,0,0,0,0,0,-480000,0,0,0,4000,484000,-480000,-480000
6416,瑞祺電通        ,308000,417130,-109130,0,0,0,0,313000,-313000,-59000,131000,43000,88000,11000,158000,-147000,-481130
061792,和大永豐9B購01  ,0,0,0,0,0,0,0,0,0,-482000,0,0,0,0,482000,-482000,-482000
060940,國巨國票9B購03  ,0,0,0,0,0,0,0,0,0,-488000,0,0,0,3000,491000,-488000,-488000
058676,聯茂群益99購01  ,0,0,0,0,0,0,0,0,0,-489000,0,0,0,10000,499000,-489000,-489000
063439,正隆統一01購01  ,0,0,0,0,0,0,0,0,0,-490000,0,0,0,0,490000,-490000,-490000
06507P,台表科國票99售01,0,0,0,0,0,0,0,0,0,-490000,0,0,0,0,490000,-490000,-490000
060668,上証2X元大9A購02,0,0,0,0,0,0,0,0,0,-490000,0,0,0,0,490000,-490000,-490000
060865,創意永豐9A購01  ,0,0,0,0,0,0,0,0,0,-492000,0,0,0,60000,552000,-492000,-492000
049024,玉晶光群益97購01,0,0,0,0,0,0,0,0,0,-493000,0,0,0,705000,1198000,-493000,-493000
061658,聯茂富邦9A購03  ,0,0,0,0,0,0,0,0,0,-493000,0,0,0,0,493000,-493000,-493000
057824,日月光元大98購01,0,0,0,0,0,0,0,0,0,-494000,0,0,0,417000,911000,-494000,-494000
060190,國泰金元富9A購01,0,0,0,0,0,0,0,0,0,-495000,0,0,0,138000,633000,-495000,-495000
056243,創意群益97購03  ,0,0,0,0,0,0,0,0,0,-497000,0,0,0,0,497000,-497000,-497000
060457,中橡元大9A購02  ,0,0,0,0,0,0,0,0,0,-497000,0,0,0,379000,876000,-497000,-497000
07000P,T50反1元大99售03,0,0,0,0,0,0,0,0,0,-498000,0,0,0,0,498000,-498000,-498000
063398,信邦群益9B購02  ,0,0,0,0,0,0,0,0,0,-498000,0,0,0,265000,763000,-498000,-498000
062131,臺指反群益9B購03,0,0,0,0,0,0,0,0,0,-499000,0,0,0,0,499000,-499000,-499000
063141,聯發科統一9C購10,0,0,0,0,0,0,0,0,0,-499000,0,0,0,0,499000,-499000,-499000
063537,華擎統一9C購03  ,0,0,0,0,0,0,0,0,0,-500000,0,0,0,49000,549000,-500000,-500000
055245,凱美統一99購01  ,0,0,0,0,0,0,0,0,0,-500000,0,0,0,8000,508000,-500000,-500000
057203,麗豐元富98購02  ,0,0,0,0,0,0,0,0,0,-501000,0,0,0,10000,511000,-501000,-501000
062650,南電富邦01購01  ,0,0,0,0,0,0,0,0,0,-505000,0,0,0,15000,520000,-505000,-505000
062836,同欣電群益9B購02,0,0,0,0,0,0,0,0,0,-507000,0,0,0,45000,552000,-507000,-507000
063451,漢翔統一9C購01  ,0,0,0,0,0,0,0,0,0,-509000,0,0,0,15000,524000,-509000,-509000
060019,彰銀康和99購01  ,0,0,0,0,0,0,0,0,0,-511000,0,0,0,20000,531000,-511000,-511000
057684,聯茂日盛99購01  ,0,0,0,0,0,0,0,0,0,-511000,0,0,0,0,511000,-511000,-511000
062688,華擎統一01購03  ,0,0,0,0,0,0,0,0,0,-512000,0,0,0,53000,565000,-512000,-512000
063066,同欣電麥證9B購01,0,0,0,10000,525000,-515000,0,0,0,-515000,0,0,0,10000,525000,-515000,-515000
4968,立積            ,414000,1156000,-742000,0,0,0,5000,0,5000,222000,208000,15000,193000,55000,26000,29000,-515000
063285,華擎元大9B購03  ,0,0,0,0,0,0,0,0,0,-518000,0,0,0,50000,568000,-518000,-518000
061972,華新元大9B購01  ,0,0,0,0,0,0,0,0,0,-518000,0,0,0,65000,583000,-518000,-518000
063805,技嘉兆豐9C購01  ,0,0,0,0,0,0,0,0,0,-524000,0,0,0,0,524000,-524000,-524000
07334P,臺股指國票99售19,0,0,0,0,0,0,0,0,0,-529000,0,0,0,152000,681000,-529000,-529000
059326,康友元大99購01  ,0,0,0,0,0,0,0,0,0,-530000,0,0,0,52000,582000,-530000,-530000
061213,群創元大9A購05  ,0,0,0,0,0,0,0,0,0,-530000,0,0,0,20000,550000,-530000,-530000
061625,聯茂群益9A購02  ,0,0,0,0,0,0,0,0,0,-533000,0,0,0,3000,536000,-533000,-533000
063484,達方元大9B購01  ,0,0,0,0,0,0,0,0,0,-536000,0,0,0,67000,603000,-536000,-536000
055325,佐登國票98購01  ,0,0,0,0,0,0,0,0,0,-537000,0,0,0,12000,549000,-537000,-537000
062821,華擎兆豐9C購01  ,0,0,0,0,0,0,0,0,0,-543000,0,0,0,112000,655000,-543000,-543000
2369,菱生            ,329000,945000,-616000,0,0,0,0,0,0,72000,72000,0,72000,0,0,0,-544000
061659,信邦永豐9A購01  ,0,0,0,0,0,0,0,0,0,-544000,0,0,0,141000,685000,-544000,-544000
00642U,元大S&P石油     ,7000,40000,-33000,0,0,0,0,0,0,-512000,0,0,0,59000,571000,-512000,-545000
060123,光罩永豐99購02  ,0,0,0,0,0,0,0,0,0,-547000,0,0,0,0,547000,-547000,-547000
053932,華新科統一96購03,0,0,0,0,0,0,0,0,0,-549000,0,0,0,0,549000,-549000,-549000
063167,同欣電永豐9B購03,0,0,0,0,0,0,0,0,0,-549000,0,0,0,20000,569000,-549000,-549000
061956,和大統一01購01  ,0,0,0,0,0,0,0,0,0,-549000,0,0,0,525000,1074000,-549000,-549000
063248,創意元大9C購01  ,0,0,0,0,0,0,0,0,0,-550000,0,0,0,0,550000,-550000,-550000
062817,富邦金兆豐9B購01,0,0,0,0,0,0,0,0,0,-550000,0,0,0,28000,578000,-550000,-550000
062108,晶豪科國票9B購01,0,0,0,0,0,0,0,0,0,-551000,0,0,0,97000,648000,-551000,-551000
08135P,玉晶光國泰01售02,0,0,0,0,0,0,0,0,0,-554000,0,0,0,4000,558000,-554000,-554000
2404,漢唐            ,136000,628000,-492000,0,0,0,0,0,0,-63000,41000,5000,36000,1000,100000,-99000,-555000
056937,智原元富98購01  ,0,0,0,0,0,0,0,0,0,-555000,0,0,0,28000,583000,-555000,-555000
063572,麗豐元大9B購01  ,0,0,0,0,0,0,0,0,0,-556000,0,0,0,132000,688000,-556000,-556000
062806,世芯統一02購01  ,0,0,0,0,0,0,0,0,0,-556000,0,0,0,529000,1085000,-556000,-556000
062954,世芯永豐9B購03  ,0,0,0,0,0,0,0,0,0,-556000,0,0,0,54000,610000,-556000,-556000
058100,聯茂國泰99購02  ,0,0,0,0,0,0,0,0,0,-557000,0,0,0,133000,690000,-557000,-557000
063204,高鐵統一9C購01  ,0,0,0,0,0,0,0,0,0,-559000,0,0,0,621000,1180000,-559000,-559000
061619,大立光群益9B購01,0,0,0,0,0,0,0,0,0,-559000,0,0,0,2000,561000,-559000,-559000
2376,技嘉            ,1985000,2185000,-200000,0,0,0,125000,285000,-160000,-200000,130000,55000,75000,50000,325000,-275000,-560000
052269,T50反1日盛9B購01,0,0,0,0,0,0,0,0,0,-562000,0,0,0,0,562000,-562000,-562000
062328,南亞科統一9C購01,0,0,0,0,0,0,0,0,0,-562000,0,0,0,83000,645000,-562000,-562000
063626,聚陽元大9B購03  ,0,0,0,0,0,0,0,0,0,-566000,0,0,0,88000,654000,-566000,-566000
058536,群創統一9B購01  ,0,0,0,0,0,0,0,0,0,-568000,0,0,0,0,568000,-568000,-568000
054866,宏盛群益98購01  ,0,0,0,0,0,0,0,0,0,-570000,0,0,0,0,570000,-570000,-570000
061278,和大統一9A購01  ,0,0,0,0,0,0,0,0,0,-570000,0,0,0,622000,1192000,-570000,-570000
057721,華擎元富98購02  ,0,0,0,0,0,0,0,0,0,-571000,0,0,0,150000,721000,-571000,-571000
00652,富邦印度        ,80000,7000,73000,0,0,0,0,0,0,-645000,0,0,0,6000,651000,-645000,-572000
058149,百和元大99購02  ,0,0,0,0,0,0,0,0,0,-577000,0,0,0,179000,756000,-577000,-577000
063251,同欣電元大9B購04,0,0,0,0,0,0,0,0,0,-581000,0,0,0,78000,659000,-581000,-581000
3545,敦泰            ,1115000,1698000,-583000,0,0,0,0,0,0,1000,3000,2000,1000,0,0,0,-582000
063351,億豐統一9B購01  ,0,0,0,0,0,0,0,0,0,-583000,0,0,0,25000,608000,-583000,-583000
058522,聯茂元大99購07  ,0,0,0,0,0,0,0,0,0,-583000,0,0,0,370000,953000,-583000,-583000
06491P,台積電富邦99售02,0,0,0,0,0,0,0,0,0,-587000,0,0,0,244000,831000,-587000,-587000
059849,興勤永豐99購01  ,0,0,0,0,0,0,0,0,0,-588000,0,0,0,28000,616000,-588000,-588000
063369,聚陽永豐9B購01  ,0,0,0,0,0,0,0,0,0,-592000,0,0,0,8000,600000,-592000,-592000
062343,中石化群益9B購01,0,0,0,0,0,0,0,0,0,-597000,0,0,0,137000,734000,-597000,-597000
053898,康友群益97購01  ,0,0,0,0,0,0,0,0,0,-598000,0,0,0,0,598000,-598000,-598000
063541,華擎元富9B購02  ,0,0,0,0,0,0,0,0,0,-599000,0,0,0,85000,684000,-599000,-599000
055306,燿華群益97購01  ,0,0,0,0,0,0,0,0,0,-599000,0,0,0,0,599000,-599000,-599000
057405,麗豐群益98購01  ,0,0,0,0,0,0,0,0,0,-599000,0,0,0,15000,614000,-599000,-599000
063064,台表科元富9B購01,0,0,0,0,0,0,0,0,0,-599000,0,0,0,149000,748000,-599000,-599000
05722P,玉晶光國票97售03,0,0,0,0,0,0,0,0,0,-602000,0,0,0,195000,797000,-602000,-602000
07025P,玉晶光凱基99售01,0,0,0,0,0,0,0,0,0,-603000,0,0,0,539000,1142000,-603000,-603000
1722,台肥            ,570000,890000,-320000,0,0,0,0,503000,-503000,219000,215000,0,215000,4000,0,4000,-604000
00638R,元大滬深300反1  ,0,476000,-476000,0,0,0,0,0,0,-133000,120000,0,120000,480000,733000,-253000,-609000
059958,鎧勝康和99購01  ,0,0,0,0,0,0,0,0,0,-612000,0,0,0,376000,988000,-612000,-612000
063128,智伸科元大9B購01,0,0,0,0,0,0,0,0,0,-613000,0,0,0,165000,778000,-613000,-613000
062870,亞德客兆豐9C購01,0,0,0,0,0,0,0,0,0,-617000,0,0,0,149000,766000,-617000,-617000
063055,創意統一9B購02  ,0,0,0,0,0,0,0,0,0,-622000,0,0,0,125000,747000,-622000,-622000
053381,友達元大9A購02  ,0,0,0,0,0,0,0,0,0,-623000,0,0,0,0,623000,-623000,-623000
057404,貿聯群益99購01  ,0,0,0,0,0,0,0,0,0,-625000,0,0,0,10000,635000,-625000,-625000
07966P,瑞祺群益9B售02  ,0,0,0,0,0,0,0,0,0,-629000,0,0,0,0,629000,-629000,-629000
049973,T50反1日盛9A購01,0,0,0,0,0,0,0,0,0,-629000,0,0,0,3000,632000,-629000,-629000
063548,同欣電兆豐9B購01,0,0,0,0,0,0,0,0,0,-632000,0,0,0,0,632000,-632000,-632000
059188,京元電富邦9B購01,0,0,0,0,0,0,0,0,0,-633000,0,0,0,603000,1236000,-633000,-633000
2363,矽統            ,827000,1468000,-641000,0,0,0,0,0,0,5000,5000,0,5000,0,0,0,-636000
057378,康友元大98購02  ,0,0,0,0,0,0,0,0,0,-638000,0,0,0,0,638000,-638000,-638000
062680,微星統一01購01  ,0,0,0,0,0,0,0,0,0,-642000,0,0,0,130000,772000,-642000,-642000
061416,聯茂群益9A購01  ,0,0,0,0,0,0,0,0,0,-643000,0,0,0,215000,858000,-643000,-643000
056774,和鑫元大98購01  ,0,0,0,0,0,0,0,0,0,-646000,0,0,0,53000,699000,-646000,-646000
062686,群創統一9C購03  ,0,0,0,0,0,0,0,0,0,-648000,0,0,0,45000,693000,-648000,-648000
063209,巨大統一01購01  ,0,0,0,0,0,0,0,0,0,-648000,0,0,0,234000,882000,-648000,-648000
060783,亞德客富邦9B購01,0,0,0,0,0,0,0,0,0,-656000,0,0,0,56000,712000,-656000,-656000
060427,聯茂永豐9A購01  ,0,0,0,0,0,0,0,0,0,-662000,0,0,0,0,662000,-662000,-662000
2458,義隆            ,722000,2122000,-1400000,0,0,0,865000,206000,659000,76000,205000,132000,73000,32000,29000,3000,-665000
056301,開發金元大9A購01,0,0,0,0,0,0,0,0,0,-666000,0,0,0,5000,671000,-666000,-666000
063899,同欣電群益9C購01,0,0,0,0,0,0,0,0,0,-667000,0,0,0,26000,693000,-667000,-667000
05692P,聯發科中信9A售02,0,0,0,0,0,0,0,0,0,-668000,0,0,0,475000,1143000,-668000,-668000
062824,國巨群益9C購03  ,0,0,0,0,0,0,0,0,0,-674000,0,0,0,0,674000,-674000,-674000
062856,世芯永豐9B購02  ,0,0,0,0,0,0,0,0,0,-683000,0,0,0,14000,697000,-683000,-683000
060309,佳世達永豐9A購01,0,0,0,0,0,0,0,0,0,-684000,0,0,0,0,684000,-684000,-684000
057516,和鑫元富98購01  ,0,0,0,0,0,0,0,0,0,-685000,0,0,0,302000,987000,-685000,-685000
3706,神達            ,606000,1164000,-558000,0,0,0,0,300000,-300000,172000,179000,12000,167000,31000,26000,5000,-686000
063750,和鑫國票9B購01  ,0,0,0,0,0,0,0,0,0,-688000,0,0,0,19000,707000,-688000,-688000
063250,同欣電元大9B購03,0,0,0,0,0,0,0,0,0,-688000,0,0,0,86000,774000,-688000,-688000
3413,京鼎            ,176581,822000,-645419,0,0,0,0,0,0,-44000,16000,0,16000,9000,69000,-60000,-689419
061750,台達電台新9B購01,0,0,0,0,0,0,0,0,0,-690000,0,0,0,78000,768000,-690000,-690000
4133,亞諾法          ,1701000,2396000,-695000,0,0,0,0,0,0,4000,5000,1000,4000,0,0,0,-691000
2912,統一超          ,4703638,5515332,-811694,0,0,0,0,19000,-19000,139000,141000,2000,139000,0,0,0,-691694
3576,聯合再生        ,432000,1124000,-692000,0,0,0,0,0,0,0,0,0,0,0,0,0,-692000
058733,同欣電永豐99購02,0,0,0,0,0,0,0,0,0,-700000,0,0,0,17000,717000,-700000,-700000
3048,益登            ,186000,891000,-705000,0,0,0,0,0,0,-2000,10000,12000,-2000,0,0,0,-707000
063206,貿聯統一9C購02  ,0,0,0,0,0,0,0,0,0,-709000,0,0,0,68000,777000,-709000,-709000
061284,友達統一9C購01  ,0,0,0,0,0,0,0,0,0,-710000,0,0,0,5000,715000,-710000,-710000
3437,榮創            ,145000,859000,-714000,0,0,0,0,0,0,1000,1000,0,1000,0,0,0,-713000
063917,南六凱基02購01  ,0,0,0,0,0,0,0,0,0,-716000,0,0,0,28000,744000,-716000,-716000
061293,聯茂統一9A購01  ,0,0,0,0,0,0,0,0,0,-718000,0,0,0,49000,767000,-718000,-718000
061094,彩晶統一9B購02  ,0,0,0,0,0,0,0,0,0,-720000,0,0,0,0,720000,-720000,-720000
054713,國巨中信9B購01  ,0,0,0,0,0,0,0,0,0,-723000,0,0,0,0,723000,-723000,-723000
058229,為升元大99購02  ,0,0,0,0,0,0,0,0,0,-723000,0,0,0,20000,743000,-723000,-723000
061796,興勤永豐9B購01  ,0,0,0,0,0,0,0,0,0,-725000,0,0,0,0,725000,-725000,-725000
062350,台表科群益9B購01,0,0,0,0,0,0,0,0,0,-728000,0,0,0,138000,866000,-728000,-728000
059948,正文永豐99購01  ,0,0,0,0,0,0,0,0,0,-731000,0,0,0,27000,758000,-731000,-731000
8213,志超            ,477000,1184000,-707000,0,0,0,0,0,0,-24000,4000,0,4000,0,28000,-28000,-731000
063679,群創國泰01購01  ,0,0,0,0,0,0,0,0,0,-733000,0,0,0,51000,784000,-733000,-733000
2393,億光            ,498000,1204000,-706000,0,0,0,0,0,0,-27000,79000,98000,-19000,47000,55000,-8000,-733000
1515,力山            ,805000,1700000,-895000,0,0,0,119000,0,119000,42000,103000,79000,24000,91000,73000,18000,-734000
2439,美律            ,278498,943000,-664502,0,0,0,0,0,0,-76000,57000,10000,47000,6000,129000,-123000,-740502
056677,智伸科元富98購01,0,0,0,0,0,0,0,0,0,-741000,0,0,0,239000,980000,-741000,-741000
062956,同欣電永豐9B購02,0,0,0,0,0,0,0,0,0,-744000,0,0,0,0,744000,-744000,-744000
060431,復盛永豐9A購01  ,0,0,0,0,0,0,0,0,0,-750000,0,0,0,0,750000,-750000,-750000
063205,貿聯統一9C購01  ,0,0,0,0,0,0,0,0,0,-754000,0,0,0,25000,779000,-754000,-754000
057568,友訊永豐99購01  ,0,0,0,0,0,0,0,0,0,-755000,0,0,0,37000,792000,-755000,-755000
062062,貿聯統一01購01  ,0,0,0,0,0,0,0,0,0,-758000,0,0,0,330000,1088000,-758000,-758000
060628,和大富邦9B購01  ,0,0,0,0,0,0,0,0,0,-762000,0,0,0,147000,909000,-762000,-762000
062034,同欣電群益9B購01,0,0,0,0,0,0,0,0,0,-773000,0,0,0,2000,775000,-773000,-773000
058534,友達統一9B購01  ,0,0,0,0,0,0,0,0,0,-774000,0,0,0,0,774000,-774000,-774000
061270,彩晶凱基9A購02  ,0,0,0,0,0,0,0,0,0,-774000,0,0,0,60000,834000,-774000,-774000
056813,聯茂統一99購01  ,0,0,0,0,0,0,0,0,0,-776000,0,0,0,96000,872000,-776000,-776000
061122,敬鵬永豐9A購01  ,0,0,0,0,0,0,0,0,0,-780000,0,0,0,30000,810000,-780000,-780000
046629,群創統一98購01  ,0,0,0,0,0,0,0,0,0,-787000,0,0,0,0,787000,-787000,-787000
046942,友達元大99購01  ,0,0,0,0,0,0,0,0,0,-791000,0,0,0,126000,917000,-791000,-791000
060851,國巨國泰9C購01  ,0,0,0,0,0,0,0,0,0,-793000,0,0,0,204000,997000,-793000,-793000
060284,南港元大01購01  ,0,0,0,0,0,0,0,0,0,-794000,0,0,0,0,794000,-794000,-794000
063665,南亞科統一01購02,0,0,0,0,0,0,0,0,0,-798000,0,0,0,254000,1052000,-798000,-798000
056266,開發金統一9A購01,0,0,0,0,0,0,0,0,0,-809000,0,0,0,411000,1220000,-809000,-809000
061004,友達兆豐9A購01  ,0,0,0,0,0,0,0,0,0,-811000,0,0,0,0,811000,-811000,-811000
059607,台積電富邦9C購04,0,0,0,0,0,0,0,0,0,-815000,0,0,0,276000,1091000,-815000,-815000
059975,元金2X元大99購02,0,0,0,0,0,0,0,0,0,-819000,0,0,0,20000,839000,-819000,-819000
3005,神基            ,556000,919000,-363000,0,0,0,0,184000,-184000,-279000,113000,0,113000,0,392000,-392000,-826000
063680,寶成富邦9C購01  ,0,0,0,0,0,0,0,0,0,-830000,0,0,0,155000,985000,-830000,-830000
060706,群創富邦9A購01  ,0,0,0,0,0,0,0,0,0,-835000,0,0,0,80000,915000,-835000,-835000
060312,潤泰全永豐9A購01,0,0,0,0,0,0,0,0,0,-838000,0,0,0,62000,900000,-838000,-838000
3019,亞光            ,381000,1072000,-691000,0,0,0,0,0,0,-147000,123000,122000,1000,5000,153000,-148000,-838000
063051,仁寶統一01購01  ,0,0,0,0,0,0,0,0,0,-840000,0,0,0,158000,998000,-840000,-840000
061455,京元電凱基9B購01,0,0,0,0,0,0,0,0,0,-848000,0,0,0,23000,871000,-848000,-848000
6443,元晶            ,245000,1093000,-848000,0,0,0,0,0,0,0,0,0,0,0,0,0,-848000
058928,國巨統一9C購01  ,0,0,0,0,0,0,0,0,0,-849000,0,0,0,316000,1165000,-849000,-849000
062526,友達統一01購01  ,0,0,0,0,0,0,0,0,0,-858000,0,0,0,13000,871000,-858000,-858000
3010,華立            ,199000,1048000,-849000,0,0,0,0,0,0,-9000,3000,12000,-9000,0,0,0,-858000
057972,群創富邦9C購01  ,0,0,0,0,0,0,0,0,0,-859000,0,0,0,106000,965000,-859000,-859000
061533,友達統一9C購02  ,0,0,0,0,0,0,0,0,0,-864000,0,0,0,56000,920000,-864000,-864000
9958,世紀鋼          ,328000,770000,-442000,0,0,0,0,400000,-400000,-22000,62000,45000,17000,47000,86000,-39000,-864000
063134,裕隆統一01購01  ,0,0,0,0,0,0,0,0,0,-867000,0,0,0,806000,1673000,-867000,-867000
063179,群創兆豐9B購01  ,0,0,0,0,0,0,0,0,0,-870000,0,0,0,23000,893000,-870000,-870000
062020,智伸科永豐9B購01,0,0,0,0,0,0,0,0,0,-872000,0,0,0,3000,875000,-872000,-872000
07646P,世芯元大9A售04  ,0,0,0,0,0,0,0,0,0,-878000,0,0,0,97000,975000,-878000,-878000
054801,康友群益97購02  ,0,0,0,0,0,0,0,0,0,-897000,0,0,0,0,897000,-897000,-897000
00635U,元大S&P黃金     ,4000,0,4000,0,0,0,0,0,0,-902000,0,0,0,114000,1016000,-902000,-898000
055259,玉晶光統一9A購01,0,0,0,0,0,0,0,0,0,-900000,0,0,0,471000,1371000,-900000,-900000
060889,國泰金統一9C購01,0,0,0,0,0,0,0,0,0,-900000,0,0,0,291000,1191000,-900000,-900000
058337,日月光元富99購01,0,0,0,0,0,0,0,0,0,-901000,0,0,0,175000,1076000,-901000,-901000
057804,為升元大98購01  ,0,0,0,0,0,0,0,0,0,-901000,0,0,0,326000,1227000,-901000,-901000
6239,力成            ,934814,2026000,-1091186,0,0,0,222000,343000,-121000,304000,294000,20000,274000,39000,9000,30000,-908186
062589,友達統一9C購03  ,0,0,0,0,0,0,0,0,0,-918000,0,0,0,0,918000,-918000,-918000
00676R,富邦臺灣加權反1 ,0,0,0,0,0,0,0,0,0,-924000,0,0,0,537000,1461000,-924000,-924000
062978,世芯元富9B購01  ,0,0,0,0,0,0,0,0,0,-926000,0,0,0,353000,1279000,-926000,-926000
062730,致伸凱基9B購01  ,0,0,0,0,0,0,0,0,0,-927000,0,0,0,286000,1213000,-927000,-927000
063144,超眾統一9C購02  ,0,0,0,0,0,0,0,0,0,-930000,0,0,0,305000,1235000,-930000,-930000
054370,台積電中信9A購01,0,0,0,0,0,0,0,0,0,-934000,0,0,0,193000,1127000,-934000,-934000
063678,友達國泰9C購01  ,0,0,0,0,0,0,0,0,0,-937000,0,0,0,0,937000,-937000,-937000
060418,中橡永豐9A購01  ,0,0,0,0,0,0,0,0,0,-938000,0,0,0,114000,1052000,-938000,-938000
00693U,街口S&P黃豆     ,26000,26000,0,0,0,0,0,0,0,-943000,0,0,0,280000,1223000,-943000,-943000
063197,遠東新統一9C購01,0,0,0,0,0,0,0,0,0,-945000,0,0,0,30000,975000,-945000,-945000
3044,健鼎            ,811500,2165000,-1353500,0,0,0,0,0,0,404000,352000,2000,350000,88000,34000,54000,-949500
061159,同欣電群益9A購01,0,0,0,0,0,0,0,0,0,-958000,0,0,0,255000,1213000,-958000,-958000
062461,智伸科群益9B購01,0,0,0,0,0,0,0,0,0,-959000,0,0,0,0,959000,-959000,-959000
058537,彩晶統一9B購01  ,0,0,0,0,0,0,0,0,0,-986000,0,0,0,107000,1093000,-986000,-986000
057199,台達電元富02購01,0,87000,-87000,0,0,0,0,0,0,-901000,0,0,0,300000,1201000,-901000,-988000
062626,台積電國票9C購04,0,0,0,0,0,0,0,0,0,-993000,0,0,0,8000,1001000,-993000,-993000
056261,台積電統一97購07,0,0,0,0,0,0,0,0,0,-996000,0,0,0,0,996000,-996000,-996000
062687,華擎統一01購02  ,0,0,0,0,0,0,0,0,0,-1001000,0,0,0,456000,1457000,-1001000,-1001000
063438,聚陽統一9C購01  ,0,0,0,0,0,0,0,0,0,-1002000,0,0,0,120000,1122000,-1002000,-1002000
063323,同欣電群益9B購03,0,0,0,0,0,0,0,0,0,-1005000,0,0,0,23000,1028000,-1005000,-1005000
060193,群創元富9A購01  ,0,0,0,0,0,0,0,0,0,-1013000,0,0,0,250000,1263000,-1013000,-1013000
061520,健策中信9A購01  ,0,0,0,0,0,0,0,0,0,-1036000,0,0,0,62000,1098000,-1036000,-1036000
060937,T50反1國票9A購10,0,0,0,0,0,0,0,0,0,-1043000,0,0,0,224000,1267000,-1043000,-1043000
061187,瀚宇博國泰9C購01,0,0,0,0,0,0,0,0,0,-1052000,0,0,0,65000,1117000,-1052000,-1052000
1717,長興            ,1179000,1788000,-609000,0,0,0,0,3000,-3000,-463000,337000,800000,-463000,0,0,0,-1075000
055174,精元統一97購01  ,0,0,0,0,0,0,0,0,0,-1080000,0,0,0,15000,1095000,-1080000,-1080000
3090,日電貿          ,205000,1154000,-949000,0,0,0,0,0,0,-137000,33000,0,33000,32000,202000,-170000,-1086000
6257,矽格            ,843000,1951785,-1108785,0,0,0,0,51000,-51000,18000,476000,278000,198000,56000,236000,-180000,-1141785
062809,同欣電統一9C購01,0,0,0,0,0,0,0,0,0,-1146000,0,0,0,51000,1197000,-1146000,-1146000
058648,聯陽永豐99購01  ,0,0,0,0,0,0,0,0,0,-1148000,0,0,0,1000,1149000,-1148000,-1148000
055497,開發金元大97購01,0,0,0,0,0,0,0,0,0,-1154000,0,0,0,1000,1155000,-1154000,-1154000
00640L,富邦日本正2     ,1000,0,1000,0,0,0,0,0,0,-1168998,0,0,0,664002,1833000,-1168998,-1167998
054446,美食兆豐97購01  ,0,0,0,0,0,0,0,0,0,-1170000,0,0,0,65000,1235000,-1170000,-1170000
063207,聯茂統一01購01  ,0,0,0,0,0,0,0,0,0,-1180000,0,0,0,30000,1210000,-1180000,-1180000
060764,華擎元大9A購03  ,0,0,0,0,0,0,0,0,0,-1221000,0,0,0,76000,1297000,-1221000,-1221000
062543,華通富邦9C購01  ,0,0,0,0,0,0,0,0,0,-1224000,0,0,0,108000,1332000,-1224000,-1224000
2885,元大金          ,11656252,12397000,-740748,0,0,0,0,35000,-35000,-449000,17000,424000,-407000,0,42000,-42000,-1224748
056196,聯茂富邦98購02  ,0,0,0,0,0,0,0,0,0,-1228000,0,0,0,22000,1250000,-1228000,-1228000
1760,寶齡富錦        ,899000,2210000,-1311000,0,0,0,0,15000,-15000,56000,56000,0,56000,0,0,0,-1270000
058488,華擎國票9A購01  ,0,0,0,0,0,0,0,0,0,-1272000,0,0,0,18000,1290000,-1272000,-1272000
057287,彩晶元大9C購03  ,0,0,0,0,0,0,0,0,0,-1280000,0,0,0,0,1280000,-1280000,-1280000
063054,健鼎統一01購01  ,0,0,0,0,0,0,0,0,0,-1308000,0,0,0,667000,1975000,-1308000,-1308000
3030,德律            ,207000,1560000,-1353000,0,0,0,0,0,0,42000,61000,19000,42000,0,0,0,-1311000
056248,康友群益97購04  ,0,0,0,0,0,0,0,0,0,-1319000,0,0,0,0,1319000,-1319000,-1319000
060308,劍麟永豐9A購01  ,0,0,0,0,0,0,0,0,0,-1326000,0,0,0,125000,1451000,-1326000,-1326000
3189,景碩            ,913000,3003000,-2090000,0,0,0,900000,85000,815000,-53000,118000,30000,88000,20000,161000,-141000,-1328000
057082,玉晶光統一9A購04,0,0,0,0,0,0,0,0,0,-1346000,0,0,0,386000,1732000,-1346000,-1346000
053799,矽創中信9A購01  ,0,0,0,0,0,0,0,0,0,-1364000,0,0,0,0,1364000,-1364000,-1364000
00650L,FH香港正2       ,0,0,0,0,0,0,0,0,0,-1375000,0,0,0,748000,2123000,-1375000,-1375000
3673,TPK-KY          ,721241,1630000,-908759,0,0,0,0,1000,-1000,-522000,186000,28000,158000,63000,743000,-680000,-1431759
1504,東元            ,1626000,3604000,-1978000,0,0,0,0,6000,-6000,548000,374000,0,374000,174000,0,174000,-1436000
06662P,玉晶光中信9A售01,0,0,0,0,0,0,0,0,0,-1473000,0,0,0,144000,1617000,-1473000,-1473000
055537,康友群益97購03  ,0,0,0,0,0,0,0,0,0,-1545000,0,0,0,0,1545000,-1545000,-1545000
047995,台達電元大96購01,0,0,0,0,0,0,0,0,0,-1546000,0,0,0,0,1546000,-1546000,-1546000
060921,中橡永豐9A購02  ,0,0,0,0,0,0,0,0,0,-1571000,0,0,0,0,1571000,-1571000,-1571000
061923,友達凱基9B購04  ,0,0,0,0,0,0,0,0,0,-1659000,0,0,0,0,1659000,-1659000,-1659000
00738U,元大道瓊白銀    ,4000,0,4000,0,0,0,0,0,0,-1701000,0,0,0,495000,2196000,-1701000,-1697000
2455,全新            ,1238000,3105884,-1867884,0,0,0,30000,0,30000,97000,81000,24000,57000,93000,53000,40000,-1740884
2614,東森            ,372000,2130000,-1758000,0,0,0,0,0,0,6000,6000,0,6000,0,0,0,-1752000
061008,群創兆豐9A購02  ,0,0,0,0,0,0,0,0,0,-1758000,0,0,0,95000,1853000,-1758000,-1758000
052542,友達元富98購01  ,0,0,0,0,0,0,0,0,0,-1826000,0,0,0,0,1826000,-1826000,-1826000
063437,聚陽統一01購01  ,0,0,0,0,0,0,0,0,0,-1856000,0,0,0,9000,1865000,-1856000,-1856000
063670,美食統一9C購01  ,0,0,0,0,0,0,0,0,0,-1871000,0,0,0,25000,1896000,-1871000,-1871000
063661,聚陽統一9C購02  ,0,0,0,0,0,0,0,0,0,-1940000,0,0,0,45000,1985000,-1940000,-1940000
00708L,元大S&P黃金正2  ,0,0,0,0,0,0,0,0,0,-1988000,0,0,0,1543000,3531000,-1988000,-1988000
2345,智邦            ,3891526,6164627,-2273101,0,0,0,4000,178000,-174000,401000,251000,64000,187000,238000,24000,214000,-2046101
063062,群創元富9B購01  ,0,0,0,0,0,0,0,0,0,-2083000,0,0,0,136000,2219000,-2083000,-2083000
061536,華擎統一9C購02  ,0,0,0,0,0,0,0,0,0,-2092000,0,0,0,75000,2167000,-2092000,-2092000
063536,美食統一01購01  ,0,0,0,0,0,0,0,0,0,-2115000,0,0,0,177000,2292000,-2115000,-2115000
063336,大成鋼統一9C購02,0,0,0,0,0,0,0,0,0,-2339000,0,0,0,30000,2369000,-2339000,-2339000
8112,至上            ,186000,2603000,-2417000,0,0,0,0,1000,-1000,63000,63000,0,63000,0,0,0,-2355000
00664R,國泰臺灣加權反1 ,0,0,0,0,0,0,0,0,0,-2473000,0,0,0,1786000,4259000,-2473000,-2473000
2890,永豐金          ,15405638,19766640,-4361002,0,0,0,0,32000,-32000,1668000,1674000,6000,1668000,0,0,0,-2725002
062165,聯茂國泰01購01  ,0,0,0,0,0,0,0,0,0,-2733000,0,0,0,287000,3020000,-2733000,-2733000
00852L,國泰美國道瓊正2 ,12000,26000,-14000,0,0,0,0,0,0,-2723000,0,0,0,3205000,5928000,-2723000,-2737000
8046,南電            ,1116000,3131000,-2015000,0,0,0,20000,722000,-702000,-26000,55000,19000,36000,56000,118000,-62000,-2743000
2367,燿華            ,915000,2990000,-2075000,0,0,0,0,0,0,-692000,118000,0,118000,69000,879000,-810000,-2767000
00653L,富邦印度正2     ,604000,4637000,-4033000,0,0,0,0,0,0,1203000,0,0,0,3646000,2443000,1203000,-2830000
062731,力成凱基9B購02  ,0,0,0,0,0,0,0,0,0,-3308000,0,0,0,120000,3428000,-3308000,-3308000
07597P,臺股指中信01售02,0,0,0,0,0,0,0,0,0,-3400000,0,0,0,464000,3864000,-3400000,-3400000
3037,欣興            ,3833110,7511000,-3677890,0,0,0,123000,928000,-805000,-14000,1063000,1211000,-148000,258000,124000,134000,-4496890
8150,南茂            ,923000,4718337,-3795337,0,0,0,1079000,1738000,-659000,-143000,237000,18000,219000,65000,427000,-362000,-4597337
2449,京元電子        ,2029000,6731000,-4702000,0,0,0,0,0,0,-332000,242000,480000,-238000,272000,366000,-94000,-5034000
2337,旺宏            ,3316000,10846000,-7530000,0,0,0,0,100000,-100000,388000,412000,144000,268000,156000,36000,120000,-7242000
2344,華邦電          ,6275399,13809000,-7533601,0,0,0,0,1000,-1000,276000,245000,112000,133000,243000,100000,143000,-7258601
2368,金像電          ,4378000,4083000,295000,0,0,0,0,9436000,-9436000,1534000,1773000,300000,1473000,123000,62000,61000,-7607000
00632R,元大台灣50反1   ,504000,2213000,-1709000,0,0,0,0,3388000,-3388000,-46457000,551000,2950000,-2399000,30559000,74617000,-44058000,-51554000
00677U,富邦VIX         ,1692000,70769000,-69077000,0,0,0,0,0,0,-87242000,600000,5000,595000,2223000,90060000,-87837000,-156319000
