證券代號,證券名稱,外陸資買進股數(不含外資自營商),外陸資賣出股數(不含外資自營商),外陸資買賣超股數(不含外資自營商),外資自營商買進股數,外資自營商賣出股數,外資自營商買賣超股數,投信買進股數,投信賣出股數,投信買賣超股數,自營商買賣超股數,自營商買進股數(自行買賣),自營商賣出股數(自行買賣),自營商買賣超股數(自行買賣),自營商買進股數(避險),自營商賣出股數(避險),自營商買賣超股數(避險),三大法人買賣超股數
00632R,元大台灣50反1   ,16524000,4695000,11829000,0,0,0,0,0,0,85898000,1590000,650000,940000,94599000,9641000,84958000,97727000
00637L,元大滬深300正2  ,24966000,13354000,11612000,0,0,0,0,0,0,16980000,651000,0,651000,34362000,18033000,16329000,28592000
2883,開發金          ,20342686,12575992,7766694,0,0,0,1569000,0,1569000,81000,0,0,0,289000,208000,81000,9416694
2610,華航            ,14612000,5988000,8624000,0,0,0,250000,0,250000,503000,0,4000,-4000,507000,0,507000,9377000
00633L,富邦上証正2     ,7157000,1477000,5680000,0,0,0,371000,0,371000,1621000,252000,0,252000,4659000,3290000,1369000,7672000
2618,長榮航          ,8848000,8784067,63933,0,0,0,6200000,0,6200000,856000,202000,124000,78000,803000,25000,778000,7119933
2408,南亞科          ,12039250,6271220,5768030,0,0,0,1329000,0,1329000,-520000,226000,325000,-99000,195000,616000,-421000,6577030
2345,智邦            ,10913504,3924690,6988814,0,0,0,170000,756000,-586000,90000,213000,201000,12000,270000,192000,78000,6492814
8112,至上            ,6244300,779000,5465300,0,0,0,1000,0,1000,24000,30000,6000,24000,0,0,0,5490300
0056,元大高股息      ,19000,65000,-46000,0,0,0,512000,0,512000,4801000,30000,0,30000,5030000,259000,4771000,5267000
2448,晶電            ,13886000,4724000,9162000,0,0,0,524000,4421000,-3897000,-26000,110000,138000,-28000,2000,0,2000,5239000
3017,奇鋐            ,2468000,3188000,-720000,0,0,0,4732000,0,4732000,1078000,1512000,438000,1074000,232000,228000,4000,5090000
00852L,國泰美國道瓊正2 ,383000,497000,-114000,0,0,0,0,0,0,4731000,0,0,0,7228000,2497000,4731000,4617000
2382,廣達            ,5652696,1485260,4167436,0,0,0,358000,0,358000,-187000,4000,152000,-148000,28000,67000,-39000,4338436
3545,敦泰            ,5968000,2276000,3692000,0,0,0,0,0,0,135000,135000,0,135000,0,0,0,3827000
3338,泰碩            ,3475000,1079000,2396000,0,0,0,370000,329000,41000,696000,686000,126000,560000,285000,149000,136000,3133000
3037,欣興            ,7575000,8528986,-953986,0,0,0,2783000,0,2783000,966000,1109000,276000,833000,298000,165000,133000,2795014
3026,禾伸堂          ,2587000,552000,2035000,0,0,0,679000,0,679000,9000,8000,0,8000,142000,141000,1000,2723000
2301,光寶科          ,3816115,1712100,2104015,0,0,0,503000,0,503000,102000,79000,2000,77000,107000,82000,25000,2709015
4927,泰鼎-KY         ,1598000,1329000,269000,0,0,0,1146000,0,1146000,1165000,722000,36000,686000,525000,46000,479000,2580000
00655L,國泰中國A50正2  ,2237000,48000,2189000,0,0,0,0,0,0,312000,0,0,0,3073000,2761000,312000,2501000
2324,仁寶            ,9158850,6587553,2571297,0,0,0,0,0,0,-251000,8000,22000,-14000,0,237000,-237000,2320297
2371,大同            ,3883000,1607000,2276000,0,0,0,0,0,0,0,0,0,0,0,0,0,2276000
053363,旺宏國泰98購02  ,0,0,0,0,0,0,0,0,0,2200000,0,0,0,2200000,0,2200000,2200000
2603,長榮            ,6371000,4886000,1485000,0,0,0,154000,0,154000,466000,466000,0,466000,0,0,0,2105000
2385,群光            ,2627000,524350,2102650,0,0,0,2000,0,2000,-22000,0,1000,-1000,26000,47000,-21000,2082650
2504,國產            ,2645000,2139000,506000,0,0,0,917000,0,917000,476000,250000,0,250000,399000,173000,226000,1899000
056138,群創元大9B購01  ,0,0,0,0,0,0,0,0,0,1879000,0,0,0,1889000,10000,1879000,1879000
2886,兆豐金          ,9119878,5211830,3908048,0,0,0,15000,2000000,-1985000,-126000,12000,6000,6000,0,132000,-132000,1797048
6213,聯茂            ,683000,586000,97000,0,0,0,1179000,151000,1028000,594000,528000,6000,522000,96000,24000,72000,1719000
052542,友達元富98購01  ,0,0,0,0,0,0,0,0,0,1713000,0,0,0,1765000,52000,1713000,1713000
2353,宏碁            ,3458000,1608334,1849666,0,0,0,0,0,0,-201000,53000,192000,-139000,63000,125000,-62000,1648666
1210,大成            ,1407000,260000,1147000,0,0,0,327000,0,327000,100000,92000,0,92000,8000,0,8000,1574000
9919,康那香          ,3508000,2212000,1296000,0,0,0,300000,0,300000,-50000,0,50000,-50000,0,0,0,1546000
058005,茂林群益98購04  ,0,0,0,0,0,0,0,0,0,1467000,0,0,0,1487000,20000,1467000,1467000
060226,道瓊反元大9A購01,0,0,0,0,0,0,0,0,0,1449000,0,0,0,1470000,21000,1449000,1449000
058838,國巨中信99購03  ,0,0,0,0,0,0,0,0,0,1431000,0,0,0,1431000,0,1431000,1431000
2105,正新            ,3973003,2602000,1371003,0,0,0,2000,0,2000,22000,27000,17000,10000,20000,8000,12000,1395003
1301,台塑            ,2522468,1249782,1272686,0,0,0,72000,0,72000,0,16000,4000,12000,0,12000,-12000,1344686
056403,茂林群益98購01  ,0,0,0,0,0,0,0,0,0,1248000,0,0,0,1317000,69000,1248000,1248000
060784,鴻海富邦9C購01  ,0,0,0,0,0,0,0,0,0,1229000,0,0,0,1348000,119000,1229000,1229000
020012,富邦行動通訊N   ,0,0,0,0,0,0,0,0,0,1220000,0,0,0,1233000,13000,1220000,1220000
059560,T50反1凱基99購08,0,0,0,0,0,0,0,0,0,1167000,0,0,0,1242000,75000,1167000,1167000
046942,友達元大99購01  ,0,0,0,0,0,0,0,0,0,1142000,0,0,0,1142000,0,1142000,1142000
4938,和碩            ,4142953,3247870,895083,0,0,0,341000,0,341000,-97000,40000,60000,-20000,11000,88000,-77000,1139083
2633,台灣高鐵        ,1817044,859000,958044,0,0,0,3000,0,3000,170000,38000,18000,20000,160000,10000,150000,1131044
059395,T50反1元富99購03,0,0,0,0,0,0,0,0,0,1131000,0,0,0,1721000,590000,1131000,1131000
054980,國巨元富97購01  ,0,0,0,0,0,0,0,0,0,1109000,0,0,0,1109000,0,1109000,1109000
3029,零壹            ,1162000,64000,1098000,0,0,0,0,0,0,-2000,0,2000,-2000,0,0,0,1096000
054685,國巨永豐97購02  ,0,0,0,0,0,0,0,0,0,1086000,0,0,0,1086000,0,1086000,1086000
1907,永豐餘          ,1334000,261000,1073000,0,0,0,0,0,0,0,0,0,0,0,0,0,1073000
044201,群創國票95購01  ,0,0,0,0,0,0,0,0,0,1055000,0,0,0,1055000,0,1055000,1055000
9938,百和            ,603000,808000,-205000,0,0,0,1131000,0,1131000,123000,93000,16000,77000,125000,79000,46000,1049000
054332,世芯永豐97購01  ,0,0,0,0,0,0,0,0,0,1045000,0,0,0,1045000,0,1045000,1045000
3006,晶豪科          ,2895000,2157000,738000,0,0,0,0,250000,-250000,538000,348000,57000,291000,315000,68000,247000,1026000
052414,聯電麥證95購01  ,0,0,0,1006000,0,1006000,0,0,0,1006000,0,0,0,1006000,0,1006000,1006000
058131,義隆元大99購02  ,0,0,0,0,0,0,0,0,0,991000,0,0,0,1180000,189000,991000,991000
061183,友達國泰9B購02  ,0,0,0,0,0,0,0,0,0,990000,0,0,0,1005000,15000,990000,990000
054905,國揚康和97購01  ,0,0,0,0,0,0,0,0,0,982000,0,0,0,986000,4000,982000,982000
6504,南六            ,705000,842098,-137098,0,0,0,1103000,0,1103000,13000,100000,75000,25000,5000,17000,-12000,978902
00875,國泰網路資安    ,2121000,0,2121000,0,0,0,0,0,0,-1155000,0,0,0,1055000,2210000,-1155000,966000
049367,全新元大96購01  ,0,0,0,0,0,0,0,0,0,960000,0,0,0,960000,0,960000,960000
053486,T50反1兆豐96購01,0,0,0,0,0,0,0,0,0,953000,0,0,0,1010000,57000,953000,953000
060119,上銀富邦9B購03  ,0,0,0,0,0,0,0,0,0,948000,0,0,0,980000,32000,948000,948000
058214,世芯群益9A購01  ,0,0,0,0,0,0,0,0,0,921000,0,0,0,978000,57000,921000,921000
053524,聯電中信97購02  ,0,0,0,0,0,0,0,0,0,917000,0,0,0,1651000,734000,917000,917000
061031,神隆永豐9A購02  ,0,0,0,0,0,0,0,0,0,915000,0,0,0,1011000,96000,915000,915000
2855,統一證          ,1001000,91000,910000,0,0,0,0,0,0,0,0,0,0,0,0,0,910000
052852,國巨元富96購02  ,0,0,0,0,0,0,0,0,0,904000,0,0,0,904000,0,904000,904000
4906,正文            ,1088000,206000,882000,0,0,0,0,0,0,20000,0,0,0,20000,0,20000,902000
059656,T50反1元大99購11,0,0,0,0,0,0,0,0,0,898000,0,0,0,1035000,137000,898000,898000
057523,大成鋼元大99購01,0,0,0,0,0,0,0,0,0,884000,0,0,0,1110000,226000,884000,884000
061284,友達統一9C購01  ,0,0,0,0,0,0,0,0,0,877000,0,0,0,897000,20000,877000,877000
052132,旺宏凱基9B購01  ,0,0,0,0,0,0,0,0,0,871000,0,0,0,871000,0,871000,871000
060807,新光金群益9A購01,0,0,0,0,0,0,0,0,0,866000,0,0,0,982000,116000,866000,866000
3042,晶技            ,3218000,3901000,-683000,0,0,0,552000,0,552000,996000,873000,69000,804000,269000,77000,192000,865000
6269,台郡            ,1063000,1825000,-762000,0,0,0,1431000,0,1431000,190000,150000,53000,97000,160000,67000,93000,859000
060387,盛群凱基9A購01  ,0,10000,-10000,0,0,0,0,0,0,856000,0,0,0,941000,85000,856000,846000
060709,緯穎富邦9B購01  ,0,0,0,0,0,0,0,0,0,835000,0,0,0,926000,91000,835000,835000
00664R,國泰臺灣加權反1 ,0,0,0,0,0,0,0,0,0,827000,0,0,0,1603000,776000,827000,827000
057972,群創富邦9C購01  ,0,0,0,0,0,0,0,0,0,815000,0,0,0,870000,55000,815000,815000
2379,瑞昱            ,1192982,801235,391747,0,0,0,532000,182000,350000,71000,106000,22000,84000,12000,25000,-13000,812747
2347,聯強            ,1687000,1266150,420850,0,0,0,500000,0,500000,-113000,6000,2000,4000,0,117000,-117000,807850
053630,奇鋐兆豐97購01  ,0,0,0,0,0,0,0,0,0,804000,0,0,0,1018000,214000,804000,804000
058026,上銀富邦9A購01  ,0,0,0,0,0,0,0,0,0,804000,0,0,0,862000,58000,804000,804000
059438,群創元大99購06  ,0,0,0,0,0,0,0,0,0,775000,0,0,0,892000,117000,775000,775000
6288,聯嘉            ,1040000,269000,771000,0,0,0,0,0,0,0,6000,6000,0,0,0,0,771000
2606,裕民            ,1489000,907000,582000,0,0,0,0,0,0,188000,188000,0,188000,0,0,0,770000
3023,信邦            ,831000,566000,265000,0,0,0,451000,0,451000,30000,49000,41000,8000,30000,8000,22000,746000
058228,為升元大99購01  ,0,0,0,0,0,0,0,0,0,741000,0,0,0,741000,0,741000,741000
2481,強茂            ,1214000,638000,576000,0,0,0,117000,0,117000,36000,40000,0,40000,12000,16000,-4000,729000
060340,國巨統一01購02  ,0,0,0,0,0,0,0,0,0,722000,0,0,0,819000,97000,722000,722000
3231,緯創            ,5069925,4409230,660695,0,0,0,0,75000,-75000,136000,95000,2000,93000,179000,136000,43000,721695
057973,神達富邦9A購01  ,0,0,0,0,0,0,0,0,0,721000,0,0,0,721000,0,721000,721000
03678C,臺股指凱基01牛02,0,0,0,0,0,0,0,0,0,718000,0,0,0,1451000,733000,718000,718000
055419,國巨永豐97購03  ,0,0,0,0,0,0,0,0,0,711000,0,0,0,806000,95000,711000,711000
07366P,國巨康和99售02  ,0,0,0,0,0,0,0,0,0,710000,0,0,0,2308000,1598000,710000,710000
1229,聯華            ,1212000,517000,695000,0,0,0,0,0,0,10000,10000,0,10000,0,0,0,705000
6416,瑞祺電通        ,333000,315000,18000,0,0,0,466000,0,466000,217000,123000,53000,70000,169000,22000,147000,701000
3189,景碩            ,1090000,231000,859000,0,0,0,66000,275000,-209000,42000,120000,70000,50000,14000,22000,-8000,692000
057009,信邦中信99購01  ,0,0,0,0,0,0,0,0,0,688000,0,0,0,1039000,351000,688000,688000
2360,致茂            ,747000,174000,573000,0,0,0,50000,0,50000,62000,81000,0,81000,25000,44000,-19000,685000
052426,國巨台新96購01  ,0,0,0,0,0,0,0,0,0,668000,0,0,0,1208000,540000,668000,668000
4935,茂林-KY         ,651000,428000,223000,0,0,0,252000,0,252000,192000,211000,6000,205000,64000,77000,-13000,667000
060193,群創元富9A購01  ,0,0,0,0,0,0,0,0,0,665000,0,0,0,788000,123000,665000,665000
3704,合勤控          ,742000,78000,664000,0,0,0,0,0,0,1000,0,0,0,17000,16000,1000,665000
053458,聯詠國泰97購01  ,0,0,0,0,0,0,0,0,0,660000,0,0,0,660000,0,660000,660000
047962,T50反1中信96購02,0,0,0,0,0,0,0,0,0,657000,0,0,0,1108000,451000,657000,657000
2458,義隆            ,2373000,975000,1398000,0,0,0,0,651000,-651000,-95000,139000,245000,-106000,111000,100000,11000,652000
055198,奇力新第一97購01,0,0,0,0,0,0,0,0,0,650000,0,0,0,650000,0,650000,650000
058032,大立光永豐98購05,0,0,0,0,0,0,0,0,0,650000,0,0,0,650000,0,650000,650000
2912,統一超          ,1442570,799400,643170,0,0,0,3000,0,3000,0,0,0,0,0,0,0,646170
061182,南六凱基9A購01  ,0,0,0,0,0,0,0,0,0,642000,0,0,0,712000,70000,642000,642000
060632,可成富邦9B購01  ,0,0,0,0,0,0,0,0,0,640000,0,0,0,856000,216000,640000,640000
1305,華夏            ,805000,166000,639000,0,0,0,0,0,0,0,0,0,0,0,0,0,639000
6669,緯穎            ,894000,384850,509150,0,0,0,70000,0,70000,56000,30000,1000,29000,36000,9000,27000,635150
035276,南亞科台新97購01,0,0,0,0,0,0,0,0,0,635000,0,0,0,650000,15000,635000,635000
047202,欣興元富96購01  ,0,0,0,0,0,0,0,0,0,635000,0,0,0,635000,0,635000,635000
048748,國巨元富96購01  ,0,0,0,0,0,0,0,0,0,630000,0,0,0,630000,0,630000,630000
060706,群創富邦9A購01  ,0,0,0,0,0,0,0,0,0,624000,0,0,0,733000,109000,624000,624000
060121,新光金富邦99購01,0,0,0,0,0,0,0,0,0,619000,0,0,0,665000,46000,619000,619000
060790,日月光富邦9A購01,0,0,0,0,0,0,0,0,0,619000,0,0,0,621000,2000,619000,619000
060303,宏達電富邦9B購01,0,0,0,0,0,0,0,0,0,617000,0,0,0,622000,5000,617000,617000
055330,上銀兆豐98購02  ,0,0,0,0,0,0,0,0,0,614000,0,0,0,614000,0,614000,614000
3450,聯鈞            ,826000,290000,536000,0,0,0,30000,0,30000,42000,56000,31000,25000,63000,46000,17000,608000
060701,玉晶光國泰9C購01,0,0,0,0,0,0,0,0,0,607000,0,0,0,782000,175000,607000,607000
055123,億光兆豐97購01  ,0,0,0,0,0,0,0,0,0,601000,0,0,0,601000,0,601000,601000
2014,中鴻            ,955000,354000,601000,0,0,0,0,0,0,0,0,0,0,0,0,0,601000
8210,勤誠            ,641000,262000,379000,0,0,0,0,3000,-3000,224000,30000,3000,27000,212000,15000,197000,600000
057775,南亞科群益98購02,0,0,0,0,0,0,0,0,0,597000,0,0,0,752000,155000,597000,597000
059128,友達中信99購02  ,0,0,0,0,0,0,0,0,0,596000,0,0,0,730000,134000,596000,596000
060260,京鼎凱基9C購01  ,0,0,0,0,0,0,0,0,0,587000,0,0,0,772000,185000,587000,587000
057995,華新科中信98購02,0,0,0,0,0,0,0,0,0,573000,0,0,0,1016000,443000,573000,573000
061117,美律國泰9C購01  ,0,0,0,0,0,0,0,0,0,567000,0,0,0,579000,12000,567000,567000
054805,台苯元大9A購01  ,0,0,0,0,0,0,0,0,0,562000,0,0,0,798000,236000,562000,562000
3661,世芯-KY         ,1018000,675000,343000,0,0,0,25000,0,25000,192000,315000,15000,300000,72000,180000,-108000,560000
061094,彩晶統一9B購02  ,0,0,0,0,0,0,0,0,0,555000,0,0,0,555000,0,555000,555000
053361,友達元富99購01  ,0,0,0,0,0,0,0,0,0,555000,0,0,0,752000,197000,555000,555000
00651R,FH香港反1       ,21000,0,21000,0,0,0,0,0,0,532000,0,0,0,641000,109000,532000,553000
060414,中興電永豐9A購01,0,0,0,0,0,0,0,0,0,552000,0,0,0,630000,78000,552000,552000
058397,大成鋼元大99購02,0,0,0,0,0,0,0,0,0,551000,0,0,0,672000,121000,551000,551000
058732,矽格永豐99購01  ,0,0,0,0,0,0,0,0,0,551000,0,0,0,606000,55000,551000,551000
055505,新唐元大97購02  ,0,0,0,0,0,0,0,0,0,550000,0,0,0,550000,0,550000,550000
3014,聯陽            ,575000,93000,482000,0,0,0,0,0,0,66000,40000,0,40000,29000,3000,26000,548000
060819,國巨統一9C購04  ,0,0,0,0,0,0,0,0,0,547000,0,0,0,953000,406000,547000,547000
3702,大聯大          ,1208000,532000,676000,0,0,0,0,0,0,-132000,2000,0,2000,0,134000,-134000,544000
060199,台郡元富9A購01  ,0,0,0,0,0,0,0,0,0,543000,0,0,0,588000,45000,543000,543000
056083,億光統一97購03  ,0,0,0,0,0,0,0,0,0,542000,0,0,0,636000,94000,542000,542000
058820,致茂國泰9B購01  ,0,0,0,0,0,0,0,0,0,536000,0,0,0,702000,166000,536000,536000
061030,喬山永豐9A購01  ,0,0,0,0,0,0,0,0,0,532000,0,0,0,615000,83000,532000,532000
059196,聯發科永豐99購02,0,0,0,0,0,0,0,0,0,531000,0,0,0,1104000,573000,531000,531000
057626,技嘉富邦9A購01  ,0,0,0,0,0,0,0,0,0,530000,0,0,0,690000,160000,530000,530000
059862,全新群益99購04  ,0,0,0,0,0,0,0,0,0,528000,0,0,0,565000,37000,528000,528000
057883,中環群益98購01  ,0,0,0,0,0,0,0,0,0,527000,0,0,0,537000,10000,527000,527000
058714,美律統一9B購01  ,0,0,0,0,0,0,0,0,0,520000,0,0,0,592000,72000,520000,520000
050142,聯發科元富9A購01,0,0,0,0,0,0,0,0,0,519000,0,0,0,519000,0,519000,519000
060715,日電貿永豐9A購01,0,0,0,0,0,0,0,0,0,517000,0,0,0,521000,4000,517000,517000
057351,奇力新統一98購02,0,0,0,0,0,0,0,0,0,516000,0,0,0,770000,254000,516000,516000
059825,嘉晶凱基99購02  ,0,0,0,0,0,0,0,0,0,503000,0,0,0,609000,106000,503000,503000
056677,智伸科元富98購01,0,0,0,0,0,0,0,0,0,501000,0,0,0,551000,50000,501000,501000
058154,泰碩統一9A購01  ,0,0,0,0,0,0,0,0,0,501000,0,0,0,519000,18000,501000,501000
048655,A50正2元富96購01,0,0,0,0,0,0,0,0,0,500000,0,0,0,500000,0,500000,500000
054096,佳世達國票97購01,0,0,0,0,0,0,0,0,0,500000,0,0,0,500000,0,500000,500000
060142,臺指反國票9B購01,0,0,0,0,0,0,0,0,0,499000,0,0,0,499000,0,499000,499000
051832,復盛元大95購01  ,0,0,0,0,0,0,0,0,0,499000,0,0,0,499000,0,499000,499000
051414,新光金國票95購04,0,0,0,0,0,0,0,0,0,499000,0,0,0,499000,0,499000,499000
056850,彩晶元富99購01  ,0,0,0,0,0,0,0,0,0,499000,0,0,0,499000,0,499000,499000
07448P,台灣50元大9A售08,0,0,0,0,0,0,0,0,0,499000,0,0,0,499000,0,499000,499000
058849,奇力新群益99購02,0,0,0,0,0,0,0,0,0,497000,0,0,0,733000,236000,497000,497000
054863,億光群益97購01  ,0,0,0,0,0,0,0,0,0,496000,0,0,0,496000,0,496000,496000
9945,潤泰新          ,1181000,687350,493650,0,0,0,0,0,0,-3000,12000,15000,-3000,0,0,0,490650
060552,群創凱基9B購05  ,0,0,0,0,0,0,0,0,0,489000,0,0,0,567000,78000,489000,489000
051818,國巨統一95購02  ,0,0,0,0,0,0,0,0,0,484000,0,0,0,1188000,704000,484000,484000
058093,神達元大9A購01  ,0,0,0,0,0,0,0,0,0,483000,0,0,0,533000,50000,483000,483000
058244,神達元大99購02  ,0,0,0,0,0,0,0,0,0,482000,0,0,0,532000,50000,482000,482000
05306P,泰碩國泰97售01  ,0,0,0,0,0,0,0,0,0,481000,0,0,0,817000,336000,481000,481000
6271,同欣電          ,829000,373000,456000,0,0,0,0,0,0,23000,32000,0,32000,9000,18000,-9000,479000
03440B,臺股指元大9B熊02,0,0,0,0,0,0,0,0,0,478000,0,0,0,1417000,939000,478000,478000
056167,力成台新97購01  ,0,0,0,0,0,0,0,0,0,477000,0,0,0,477000,0,477000,477000
055974,上銀統一97購05  ,0,0,0,0,0,0,0,0,0,473000,0,0,0,475000,2000,473000,473000
2515,中工            ,783000,310000,473000,0,0,0,0,0,0,-1000,0,10000,-10000,9000,0,9000,472000
07433P,臺股指國票9A售05,0,0,0,0,0,0,0,0,0,470000,0,0,0,470000,0,470000,470000
055639,上銀元富97購02  ,0,0,0,0,0,0,0,0,0,462000,0,0,0,519000,57000,462000,462000
1717,長興            ,419000,286641,132359,0,0,0,328000,0,328000,0,0,0,0,0,0,0,460359
059155,台表科日盛99購01,0,0,0,0,0,0,0,0,0,460000,0,0,0,600000,140000,460000,460000
059062,群創凱基99購05  ,0,0,0,0,0,0,0,0,0,459000,0,0,0,571000,112000,459000,459000
051729,華新國票96購01  ,0,0,0,0,0,0,0,0,0,458000,0,0,0,458000,0,458000,458000
2059,川湖            ,499000,85000,414000,0,0,0,35000,0,35000,7000,9000,2000,7000,0,0,0,456000
060642,華擎永豐9A購02  ,0,0,0,0,0,0,0,0,0,455000,0,0,0,461000,6000,455000,455000
053403,彩晶群益98購01  ,0,0,0,0,0,0,0,0,0,455000,0,0,0,455000,0,455000,455000
056788,日月光群益98購01,0,0,0,0,0,0,0,0,0,455000,0,0,0,455000,0,455000,455000
060548,友達凱基9B購03  ,0,0,0,0,0,0,0,0,0,453000,0,0,0,453000,0,453000,453000
056851,瑞儀元富98購01  ,0,0,0,0,0,0,0,0,0,453000,0,0,0,466000,13000,453000,453000
055318,華通國票98購01  ,0,0,0,0,0,0,0,0,0,452000,0,0,0,640000,188000,452000,452000
3376,新日興          ,597000,235000,362000,0,0,0,41000,0,41000,48000,32000,30000,2000,55000,9000,46000,451000
052152,創意富邦98購01  ,0,0,0,0,0,0,0,0,0,450000,0,0,0,450000,0,450000,450000
057971,華新科富邦9B購02,0,0,0,0,0,0,0,0,0,443000,0,0,0,550000,107000,443000,443000
07545P,玉晶光凱基9A售07,0,0,0,0,0,0,0,0,0,442000,0,0,0,672000,230000,442000,442000
056589,康控統一98購01  ,0,0,0,0,0,0,0,0,0,439000,0,0,0,459000,20000,439000,439000
058996,台達電元大99購02,0,0,0,0,0,0,0,0,0,439000,0,0,0,492000,53000,439000,439000
00640L,富邦日本正2     ,0,3000,-3000,0,0,0,0,0,0,440000,0,0,0,808000,368000,440000,437000
051468,智邦日盛95購01  ,0,0,0,0,0,0,0,0,0,437000,0,0,0,1187000,750000,437000,437000
2838,聯邦銀          ,546000,109000,437000,0,0,0,0,0,0,0,0,0,0,0,0,0,437000
057158,義隆永豐99購01  ,0,0,0,0,0,0,0,0,0,436000,0,0,0,662000,226000,436000,436000
057112,立積群益99購01  ,0,10000,-10000,0,0,0,0,0,0,446000,0,0,0,538000,92000,446000,436000
060284,南港元大01購01  ,0,0,0,0,0,0,0,0,0,435000,0,0,0,715000,280000,435000,435000
053844,GIS統一96購01   ,0,0,0,0,0,0,0,0,0,432000,0,0,0,432000,0,432000,432000
060700,華新科國泰9C購01,0,0,0,0,0,0,0,0,0,431000,0,0,0,516000,85000,431000,431000
07292P,臺股指凱基99售44,0,0,0,0,0,0,0,0,0,431000,0,0,0,511000,80000,431000,431000
059975,元金2X元大99購02,0,0,0,0,0,0,0,0,0,428000,0,0,0,671000,243000,428000,428000
052463,聯電統一96購01  ,0,0,0,0,0,0,0,0,0,427000,0,0,0,432000,5000,427000,427000
060779,臺股指凱基9A購07,0,0,0,0,0,0,0,0,0,426000,0,0,0,464000,38000,426000,426000
058896,中環元大99購03  ,0,0,0,0,0,0,0,0,0,426000,0,0,0,461000,35000,426000,426000
052908,大成鋼統一96購01,0,0,0,0,0,0,0,0,0,425000,0,0,0,474000,49000,425000,425000
059355,國巨富邦9B購03  ,0,0,0,0,0,0,0,0,0,422000,0,0,0,955000,533000,422000,422000
057207,立積元富98購02  ,0,0,0,0,0,0,0,0,0,422000,0,0,0,804000,382000,422000,422000
058766,力山兆豐99購01  ,0,0,0,0,0,0,0,0,0,422000,0,0,0,979000,557000,422000,422000
054076,義隆第一96購01  ,0,0,0,0,0,0,0,0,0,420000,0,0,0,621000,201000,420000,420000
058337,日月光元富99購01,0,0,0,0,0,0,0,0,0,420000,0,0,0,470000,50000,420000,420000
059243,聯發科凱基99購12,0,0,0,0,0,0,0,0,0,420000,0,0,0,420000,0,420000,420000
057572,明泰永豐98購01  ,0,0,0,0,0,0,0,0,0,419000,0,0,0,500000,81000,419000,419000
052067,中磊兆豐96購01  ,0,0,0,0,0,0,0,0,0,417000,0,0,0,688000,271000,417000,417000
057228,友達凱基9B購01  ,0,0,0,0,0,0,0,0,0,417000,0,0,0,417000,0,417000,417000
059682,可成富邦9A購01  ,0,0,0,0,0,0,0,0,0,415000,0,0,0,417000,2000,415000,415000
058258,世芯國泰9A購01  ,0,0,0,0,0,0,0,0,0,415000,0,0,0,471000,56000,415000,415000
059982,聯發科元大99購37,0,0,0,0,0,0,0,0,0,414000,0,0,0,512000,98000,414000,414000
060630,國巨富邦9C購03  ,0,0,0,0,0,0,0,0,0,413000,0,0,0,743000,330000,413000,413000
061153,奇力新群益9A購02,0,0,0,0,0,0,0,0,0,412000,0,0,0,579000,167000,412000,412000
059536,新光金凱基99購05,0,0,0,0,0,0,0,0,0,411000,0,0,0,431000,20000,411000,411000
056397,彩晶永豐99購01  ,0,0,0,0,0,0,0,0,0,407000,0,0,0,407000,0,407000,407000
061213,群創元大9A購05  ,0,0,0,0,0,0,0,0,0,406000,0,0,0,508000,102000,406000,406000
057249,華邦電統一9A購01,0,0,0,0,0,0,0,0,0,406000,0,0,0,406000,0,406000,406000
052776,力山國票97購01  ,0,0,0,0,0,0,0,0,0,405000,0,0,0,405000,0,405000,405000
04479P,同欣電中信96售02,0,0,0,0,0,0,0,0,0,404000,0,0,0,404000,0,404000,404000
059257,臺股指凱基99購35,0,0,0,0,0,0,0,0,0,404000,0,0,0,404000,0,404000,404000
060360,南亞科元富9A購02,0,0,0,0,0,0,0,0,0,403000,0,0,0,784000,381000,403000,403000
1304,台聚            ,557000,169000,388000,0,0,0,0,0,0,15000,15000,0,15000,0,0,0,403000
060511,群創元大9B購08  ,0,0,0,0,0,0,0,0,0,402000,0,0,0,538000,136000,402000,402000
059874,大立光凱基99購15,0,0,0,0,0,0,0,0,0,400000,0,0,0,400000,0,400000,400000
048793,超眾元大95購02  ,0,0,0,0,0,0,0,0,0,400000,0,0,0,400000,0,400000,400000
049889,欣興國泰96購01  ,0,0,0,0,0,0,0,0,0,400000,0,0,0,400000,0,400000,400000
051116,可成麥證95購01  ,0,0,0,400000,0,400000,0,0,0,400000,0,0,0,400000,0,400000,400000
053295,奇力新中信96購01,0,0,0,0,0,0,0,0,0,400000,0,0,0,400000,0,400000,400000
059834,友達國泰9B購01  ,0,0,0,0,0,0,0,0,0,399000,0,0,0,523000,124000,399000,399000
056303,亞光元大97購04  ,0,0,0,0,0,0,0,0,0,399000,0,0,0,399000,0,399000,399000
052945,嘉晶國票97購01  ,0,0,0,0,0,0,0,0,0,398000,0,0,0,400000,2000,398000,398000
9958,世紀鋼          ,395000,236000,159000,0,0,0,0,0,0,235000,54000,20000,34000,289000,88000,201000,394000
1227,佳格            ,1117000,627891,489109,0,0,0,0,120000,-120000,23000,24000,1000,23000,0,0,0,392109
059581,日月光元富99購02,0,0,0,0,0,0,0,0,0,392000,0,0,0,442000,50000,392000,392000
056533,友達凱基9A購02  ,0,0,0,0,0,0,0,0,0,392000,0,0,0,392000,0,392000,392000
060891,世芯統一9A購01  ,0,0,0,0,0,0,0,0,0,390000,0,0,0,498000,108000,390000,390000
061188,大成鋼富邦9B購01,0,0,0,0,0,0,0,0,0,389000,0,0,0,978000,589000,389000,389000
060627,國巨國泰9B購05  ,0,0,0,0,0,0,0,0,0,389000,0,0,0,594000,205000,389000,389000
061204,國巨元大9A購16  ,0,0,0,0,0,0,0,0,0,388000,0,0,0,545000,157000,388000,388000
058577,南亞科群益99購02,0,0,0,0,0,0,0,0,0,388000,0,0,0,491000,103000,388000,388000
07264P,台積電元大99售38,0,0,0,0,0,0,0,0,0,386000,0,0,0,436000,50000,386000,386000
059729,群創元大9C購05  ,0,0,0,0,0,0,0,0,0,385000,0,0,0,605000,220000,385000,385000
6285,啟碁            ,520000,137000,383000,0,0,0,0,0,0,2000,0,8000,-8000,27000,17000,10000,385000
059166,友達凱基99購05  ,0,0,0,0,0,0,0,0,0,384000,0,0,0,387000,3000,384000,384000
07242P,台灣50凱基9A售03,0,0,0,0,0,0,0,0,0,384000,0,0,0,405000,21000,384000,384000
054567,拓凱群益98購01  ,0,0,0,0,0,0,0,0,0,383000,0,0,0,922000,539000,383000,383000
2454,聯發科          ,4528883,4392311,136572,0,0,0,149000,95000,54000,192000,313000,159000,154000,212000,174000,38000,382572
059953,聯發科康和99購01,0,0,0,0,0,0,0,0,0,381000,0,0,0,1025000,644000,381000,381000
051158,嘉晶富邦96購01  ,0,0,0,0,0,0,0,0,0,381000,0,0,0,381000,0,381000,381000
056136,京鼎元大98購01  ,0,0,0,0,0,0,0,0,0,381000,0,0,0,381000,0,381000,381000
059503,大立光富邦9B購04,0,0,0,0,0,0,0,0,0,380000,0,0,0,451000,71000,380000,380000
061298,華新科富邦01購02,0,0,0,0,0,0,0,0,0,380000,0,0,0,382000,2000,380000,380000
057912,美律日盛99購01  ,0,0,0,0,0,0,0,0,0,380000,0,0,0,411000,31000,380000,380000
2377,微星            ,633681,177000,456681,0,0,0,3000,57000,-54000,-23000,14000,44000,-30000,72000,65000,7000,379681
060505,友達元大9C購05  ,0,0,0,0,0,0,0,0,0,377000,0,0,0,384000,7000,377000,377000
056574,亞光元大99購03  ,0,0,0,0,0,0,0,0,0,376000,0,0,0,433000,57000,376000,376000
061357,寶成元大9A購01  ,0,0,0,0,0,0,0,0,0,373000,0,0,0,379000,6000,373000,373000
061169,GIS兆豐9A購01   ,0,0,0,0,0,0,0,0,0,373000,0,0,0,378000,5000,373000,373000
055497,開發金元大97購01,0,0,0,0,0,0,0,0,0,372000,0,0,0,677000,305000,372000,372000
2439,美律            ,682000,224000,458000,0,0,0,0,0,0,-86000,4000,11000,-7000,19000,98000,-79000,372000
060684,同欣電元大9A購01,0,0,0,0,0,0,0,0,0,371000,0,0,0,527000,156000,371000,371000
052851,滬深2X元富96購02,0,0,0,0,0,0,0,0,0,371000,0,0,0,381000,10000,371000,371000
061227,日月光中信9B購01,0,0,0,0,0,0,0,0,0,370000,0,0,0,475000,105000,370000,370000
058663,瑞儀兆豐9A購01  ,0,0,0,0,0,0,0,0,0,369000,0,0,0,371000,2000,369000,369000
060901,臺股指凱基9A購13,0,0,0,0,0,0,0,0,0,367000,0,0,0,467000,100000,367000,367000
058685,TPK凱基99購01   ,0,0,0,0,0,0,0,0,0,367000,0,0,0,432000,65000,367000,367000
055940,致新群益98購01  ,0,0,0,0,0,0,0,0,0,367000,0,0,0,385000,18000,367000,367000
8271,宇瞻            ,769000,404000,365000,0,0,0,0,0,0,0,0,0,0,0,0,0,365000
055733,奇力新元富97購01,0,0,0,0,0,0,0,0,0,364000,0,0,0,531000,167000,364000,364000
060914,健策元大9A購03  ,0,0,0,0,0,0,0,0,0,363000,0,0,0,572000,209000,363000,363000
1319,東陽            ,472339,104000,368339,0,0,0,0,0,0,-6000,0,6000,-6000,0,0,0,362339
059678,鴻海國泰9A購03  ,0,0,0,0,0,0,0,0,0,362000,0,0,0,403000,41000,362000,362000
5269,祥碩            ,582000,271000,311000,0,0,0,81000,60000,21000,29000,33000,42000,-9000,52000,14000,38000,361000
4943,康控-KY         ,1031000,699000,332000,0,0,0,0,0,0,26000,0,14000,-14000,72000,32000,40000,358000
060307,南港永豐9A購01  ,0,0,0,0,0,0,0,0,0,355000,0,0,0,420000,65000,355000,355000
050892,聯電元大96購02  ,0,0,0,0,0,0,0,0,0,355000,0,0,0,580000,225000,355000,355000
3437,榮創            ,447000,92000,355000,0,0,0,0,0,0,0,0,0,0,0,0,0,355000
056364,亞光元大99購02  ,0,0,0,0,0,0,0,0,0,352000,0,0,0,357000,5000,352000,352000
047571,滬深2X群益99購01,0,0,0,0,0,0,0,0,0,351000,0,0,0,351000,0,351000,351000
060616,宏碁元大9A購02  ,0,0,0,0,0,0,0,0,0,350000,0,0,0,460000,110000,350000,350000
056855,祥碩中信98購02  ,0,0,0,0,0,0,0,0,0,350000,0,0,0,1128000,778000,350000,350000
056749,滬深2X兆豐99購01,0,0,0,0,0,0,0,0,0,350000,0,0,0,350000,0,350000,350000
060005,上銀群益99購03  ,0,0,0,0,0,0,0,0,0,349000,0,0,0,349000,0,349000,349000
058725,美律富邦9A購01  ,0,0,0,0,0,0,0,0,0,349000,0,0,0,477000,128000,349000,349000
00686R,群益臺灣加權反1 ,0,0,0,0,0,0,0,0,0,348000,0,0,0,424000,76000,348000,348000
054374,信邦中信96購01  ,0,0,0,0,0,0,0,0,0,348000,0,0,0,738000,390000,348000,348000
060126,創意永豐99購04  ,0,0,0,0,0,0,0,0,0,347000,0,0,0,368000,21000,347000,347000
058702,國巨元大99購16  ,0,0,0,0,0,0,0,0,0,347000,0,0,0,488000,141000,347000,347000
061270,彩晶凱基9A購02  ,0,0,0,0,0,0,0,0,0,346000,0,0,0,346000,0,346000,346000
061185,嘉晶國泰9B購01  ,0,0,0,0,0,0,0,0,0,346000,0,0,0,366000,20000,346000,346000
060990,新光金元大9B購03,0,0,0,0,0,0,0,0,0,344000,0,0,0,344000,0,344000,344000
3036,文曄            ,592000,40000,552000,0,0,0,0,0,0,-211000,0,172000,-172000,0,39000,-39000,341000
055030,帆宣國泰99購02  ,0,0,0,0,0,0,0,0,0,337000,0,0,0,391000,54000,337000,337000
055874,中環元富9A購01  ,0,0,0,0,0,0,0,0,0,337000,0,0,0,856000,519000,337000,337000
1536,和大            ,751000,453000,298000,0,0,0,0,0,0,39000,25000,12000,13000,31000,5000,26000,337000
059958,鎧勝康和99購01  ,0,0,0,0,0,0,0,0,0,334000,0,0,0,340000,6000,334000,334000
057762,全新凱基99購03  ,0,0,0,0,0,0,0,0,0,334000,0,0,0,334000,0,334000,334000
07039P,南電台新99售01  ,0,0,0,0,0,0,0,0,0,333000,0,0,0,388000,55000,333000,333000
052462,上銀統一95購03  ,0,0,0,0,0,0,0,0,0,333000,0,0,0,333000,0,333000,333000
058721,立積元富9C購01  ,0,0,0,0,0,0,0,0,0,333000,0,0,0,632000,299000,333000,333000
060896,晶技凱基9A購02  ,0,0,0,0,0,0,0,0,0,332000,0,0,0,519000,187000,332000,332000
03253P,台灣50國泰03售02,0,0,0,0,0,0,0,0,0,332000,0,0,0,332000,0,332000,332000
057639,國巨元大99購07  ,0,0,0,0,0,0,0,0,0,331000,0,0,0,450000,119000,331000,331000
052785,滬深2X中信99購03,0,0,0,0,0,0,0,0,0,330000,0,0,0,380000,50000,330000,330000
061158,世芯群益9A購02  ,0,0,0,0,0,0,0,0,0,328000,0,0,0,465000,137000,328000,328000
060544,國巨凱基9B購03  ,0,0,0,0,0,0,0,0,0,328000,0,0,0,502000,174000,328000,328000
057713,美律統一99購01  ,0,0,0,0,0,0,0,0,0,327000,0,0,0,586000,259000,327000,327000
058832,立積永豐99購01  ,0,0,0,0,0,0,0,0,0,327000,0,0,0,480000,153000,327000,327000
060717,康控永豐9A購01  ,0,0,0,0,0,0,0,0,0,326000,0,0,0,431000,105000,326000,326000
060953,富邦金群益9A購01,0,0,0,0,0,0,0,0,0,326000,0,0,0,361000,35000,326000,326000
061029,力山永豐9A購01  ,0,0,0,0,0,0,0,0,0,326000,0,0,0,364000,38000,326000,326000
058768,南港兆豐99購01  ,0,0,0,0,0,0,0,0,0,326000,0,0,0,326000,0,326000,326000
058245,訊連元大99購01  ,0,0,0,0,0,0,0,0,0,324000,0,0,0,701000,377000,324000,324000
060718,中磊永豐9A購01  ,0,0,0,0,0,0,0,0,0,323000,0,0,0,414000,91000,323000,323000
059096,百和元大99購04  ,0,0,0,0,0,0,0,0,0,323000,0,0,0,531000,208000,323000,323000
060651,瑞儀中信9B購01  ,0,0,0,0,0,0,0,0,0,322000,0,0,0,323000,1000,322000,322000
053949,康控富邦9A購01  ,0,0,0,0,0,0,0,0,0,322000,0,0,0,322000,0,322000,322000
059307,T50反1元大99購06,0,0,0,0,0,0,0,0,0,322000,0,0,0,421000,99000,322000,322000
058200,世芯康和99購01  ,0,0,0,0,0,0,0,0,0,322000,0,0,0,928000,606000,322000,322000
060619,玉晶光元大9A購03,0,0,0,0,0,0,0,0,0,320000,0,0,0,340000,20000,320000,320000
059945,嘉澤永豐99購03  ,0,0,0,0,0,0,0,0,0,320000,0,0,0,488000,168000,320000,320000
060752,上銀元大9A購04  ,0,0,0,0,0,0,0,0,0,320000,0,0,0,409000,89000,320000,320000
055851,智原元大98購01  ,0,0,0,0,0,0,0,0,0,320000,0,0,0,320000,0,320000,320000
059903,S&P正2元大99購02,0,0,0,0,0,0,0,0,0,319000,0,0,0,321000,2000,319000,319000
058750,緯穎凱基9A購03  ,0,0,0,0,0,0,0,0,0,319000,0,0,0,379000,60000,319000,319000
059187,國巨富邦9B購02  ,0,0,0,0,0,0,0,0,0,318000,0,0,0,478000,160000,318000,318000
1326,台化            ,1436515,1386374,50141,0,0,0,321000,0,321000,-54000,10000,20000,-10000,0,44000,-44000,317141
060187,華新科元富9A購02,0,0,0,0,0,0,0,0,0,317000,0,0,0,325000,8000,317000,317000
057356,彩晶統一98購04  ,0,0,0,0,0,0,0,0,0,317000,0,0,0,317000,0,317000,317000
060183,南亞科元富9A購01,0,0,0,0,0,0,0,0,0,316000,0,0,0,395000,79000,316000,316000
2317,鴻海            ,9735529,9283144,452385,0,0,0,16000,55000,-39000,-98000,256000,236000,20000,157000,275000,-118000,315385
060481,巨大元大9A購01  ,0,0,0,0,0,0,0,0,0,315000,0,0,0,483000,168000,315000,315000
05169P,玉晶光元大95售03,0,0,0,0,0,0,0,0,0,315000,0,0,0,315000,0,315000,315000
057737,國巨富邦99購02  ,0,0,0,0,0,0,0,0,0,315000,0,0,0,315000,0,315000,315000
061004,友達兆豐9A購01  ,0,0,0,0,0,0,0,0,0,314000,0,0,0,314000,0,314000,314000
054695,世芯永豐98購01  ,0,0,0,0,0,0,0,0,0,314000,0,0,0,341000,27000,314000,314000
054855,得力群益98購01  ,0,0,0,0,0,0,0,0,0,312000,0,0,0,410000,98000,312000,312000
053337,聯電國票97購01  ,0,0,0,0,0,0,0,0,0,311000,0,0,0,626000,315000,311000,311000
060558,億豐凱基9A購01  ,0,0,0,0,0,0,0,0,0,310000,0,0,0,397000,87000,310000,310000
054958,亞光元大97購03  ,0,0,0,0,0,0,0,0,0,310000,0,0,0,310000,0,310000,310000
050773,京鼎元大94購02  ,0,0,0,0,0,0,0,0,0,310000,0,0,0,310000,0,310000,310000
057287,彩晶元大9C購03  ,0,0,0,0,0,0,0,0,0,309000,0,0,0,309000,0,309000,309000
061155,華新科群益9A購06,0,0,0,0,0,0,0,0,0,308000,0,0,0,532000,224000,308000,308000
055471,聯發科凱基97購04,0,0,0,0,0,0,0,0,0,306000,0,0,0,315000,9000,306000,306000
059213,國巨元大99購19  ,0,0,0,0,0,0,0,0,0,306000,0,0,0,453000,147000,306000,306000
056995,華新科日盛99購01,0,0,0,0,0,0,0,0,0,306000,0,0,0,431000,125000,306000,306000
053505,瑞儀兆豐97購01  ,0,0,0,0,0,0,0,0,0,305000,0,0,0,305000,0,305000,305000
058526,鈺齊元大99購02  ,0,0,0,0,0,0,0,0,0,305000,0,0,0,349000,44000,305000,305000
060897,健策凱基9A購04  ,0,0,0,0,0,0,0,0,0,304000,0,0,0,334000,30000,304000,304000
060493,美律元富01購01  ,0,0,0,0,0,0,0,0,0,304000,0,0,0,436000,132000,304000,304000
053063,力山群益98購01  ,300000,280000,20000,0,0,0,0,0,0,284000,0,0,0,605000,321000,284000,304000
060362,建準元富9A購02  ,0,0,0,0,0,0,0,0,0,303000,0,0,0,608000,305000,303000,303000
046791,台郡統一96購01  ,0,0,0,0,0,0,0,0,0,303000,0,0,0,353000,50000,303000,303000
07131P,緯穎元大99售06  ,0,0,0,0,0,0,0,0,0,303000,0,0,0,360000,57000,303000,303000
060765,世芯元大9A購01  ,0,0,0,0,0,0,0,0,0,302000,0,0,0,530000,228000,302000,302000
055885,大成鋼統一97購02,0,0,0,0,0,0,0,0,0,302000,0,0,0,335000,33000,302000,302000
059051,和大凱基9A購01  ,0,0,0,0,0,0,0,0,0,302000,0,0,0,427000,125000,302000,302000
061347,創意元大9A購02  ,0,0,0,0,0,0,0,0,0,301000,0,0,0,700000,399000,301000,301000
058398,中環元大99購02  ,0,0,0,0,0,0,0,0,0,301000,0,0,0,301000,0,301000,301000
03019X,元展19          ,0,0,0,0,0,0,0,0,0,300000,0,0,0,300000,0,300000,300000
057827,康友元大98購03  ,0,0,0,0,0,0,0,0,0,300000,0,0,0,300000,0,300000,300000
054698,同欣電永豐97購01,0,0,0,0,0,0,0,0,0,300000,0,0,0,300000,0,300000,300000
055725,嘉聯益元大98購03,0,0,0,0,0,0,0,0,0,300000,0,0,0,300000,0,300000,300000
07258P,台灣50台新9A售01,0,0,0,0,0,0,0,0,0,300000,0,0,0,370000,70000,300000,300000
07290P,台灣50凱基9A售08,0,0,0,0,0,0,0,0,0,300000,0,0,0,300000,0,300000,300000
07619P,鴻海統一9A售03  ,0,0,0,0,0,0,0,0,0,300000,0,0,0,300000,0,300000,300000
07787P,國巨凱基9A售17  ,0,0,0,0,0,0,0,0,0,300000,0,0,0,300000,0,300000,300000
060093,友達元大03購01  ,0,0,0,0,0,0,0,0,0,298000,0,0,0,314000,16000,298000,298000
03012X,元展12          ,0,0,0,0,0,0,0,0,0,298000,0,0,0,300000,2000,298000,298000
060862,美律永豐9A購01  ,0,0,0,0,0,0,0,0,0,297000,0,0,0,329000,32000,297000,297000
057258,中環兆豐98購01  ,0,0,0,0,0,0,0,0,0,297000,0,0,0,297000,0,297000,297000
061127,美食永豐9A購01  ,0,0,0,0,0,0,0,0,0,296000,0,0,0,296000,0,296000,296000
04938P,亞德客國票95售01,0,0,0,0,0,0,0,0,0,296000,0,0,0,296000,0,296000,296000
056674,華邦電元富98購01,0,0,0,0,0,0,0,0,0,296000,0,0,0,296000,0,296000,296000
060379,T50反1凱基9A購07,0,0,0,0,0,0,0,0,0,295000,0,0,0,305000,10000,295000,295000
060663,聯發科凱基9A購13,0,0,0,0,0,0,0,0,0,295000,0,0,0,305000,10000,295000,295000
057729,華新科國泰99購04,0,0,0,0,0,0,0,0,0,295000,0,0,0,300000,5000,295000,295000
060261,臺股指凱基9A購04,0,0,0,0,0,0,0,0,0,294000,0,0,0,294000,0,294000,294000
057967,聯發科國泰9A購02,0,0,0,0,0,0,0,0,0,294000,0,0,0,294000,0,294000,294000
05407P,超眾凱基95售04  ,0,0,0,0,0,0,0,0,0,294000,0,0,0,294000,0,294000,294000
061264,全新凱基9B購01  ,0,0,0,0,0,0,0,0,0,293000,0,0,0,293000,0,293000,293000
054883,億光統一97購01  ,0,0,0,0,0,0,0,0,0,292000,0,0,0,332000,40000,292000,292000
060789,禾伸堂富邦9B購02,0,0,0,0,0,0,0,0,0,291000,0,0,0,1139000,848000,291000,291000
054298,台表科元大97購03,0,0,0,0,0,0,0,0,0,291000,0,0,0,292000,1000,291000,291000
052130,國巨凱基9B購01  ,0,0,0,0,0,0,0,0,0,290000,0,0,0,607000,317000,290000,290000
051514,智邦凱基95購05  ,0,0,0,0,0,0,0,0,0,290000,0,0,0,290000,0,290000,290000
05930P,景碩康和96售01  ,0,0,0,0,0,0,0,0,0,290000,0,0,0,325000,35000,290000,290000
5215,科嘉-KY         ,223000,101000,122000,0,0,0,127000,0,127000,41000,41000,0,41000,0,0,0,290000
059692,聯詠永豐99購01  ,0,0,0,0,0,0,0,0,0,289000,0,0,0,300000,11000,289000,289000
059527,聯發科凱基99購16,0,0,0,0,0,0,0,0,0,289000,0,0,0,304000,15000,289000,289000
05476P,聯發科群益95售06,0,0,0,0,0,0,0,0,0,289000,0,0,0,290000,1000,289000,289000
058396,力山元大99購01  ,0,0,0,0,0,0,0,0,0,289000,0,0,0,411000,122000,289000,289000
049463,華新科富邦97購01,0,0,0,0,0,0,0,0,0,288000,0,0,0,288000,0,288000,288000
059290,全新元富99購01  ,0,0,0,0,0,0,0,0,0,286000,0,0,0,291000,5000,286000,286000
058831,茂林永豐99購01  ,0,0,0,0,0,0,0,0,0,286000,0,0,0,417000,131000,286000,286000
060799,茂林永豐9A購01  ,0,0,0,0,0,0,0,0,0,285000,0,0,0,380000,95000,285000,285000
049007,玉晶光中信96購01,0,0,0,0,0,0,0,0,0,285000,0,0,0,498000,213000,285000,285000
057743,華擎永豐98購03  ,0,0,0,0,0,0,0,0,0,285000,0,0,0,393000,108000,285000,285000
055343,國巨凱基97購03  ,0,0,0,0,0,0,0,0,0,285000,0,0,0,411000,126000,285000,285000
060731,奇力新群益9A購01,0,0,0,0,0,0,0,0,0,284000,0,0,0,289000,5000,284000,284000
059869,友達凱基99購07  ,0,0,0,0,0,0,0,0,0,283000,0,0,0,298000,15000,283000,283000
058105,旺宏統一9A購02  ,0,0,0,0,0,0,0,0,0,283000,0,0,0,303000,20000,283000,283000
2023,燁輝            ,373000,90000,283000,0,0,0,0,0,0,0,0,0,0,0,0,0,283000
06046P,健策統一96售03  ,0,0,0,0,0,0,0,0,0,281000,0,0,0,293000,12000,281000,281000
060908,金像電元大9A購03,35000,40000,-5000,0,0,0,0,0,0,286000,0,0,0,660000,374000,286000,281000
061231,聚陽元大9A購02  ,0,0,0,0,0,0,0,0,0,281000,0,0,0,518000,237000,281000,281000
054970,帆宣元大97購01  ,0,0,0,0,0,0,0,0,0,281000,0,0,0,281000,0,281000,281000
058049,帆宣元大98購01  ,0,0,0,0,0,0,0,0,0,281000,0,0,0,312000,31000,281000,281000
061123,燿華永豐9A購01  ,0,0,0,0,0,0,0,0,0,280000,0,0,0,280000,0,280000,280000
054623,華新科第一97購01,0,0,0,0,0,0,0,0,0,280000,0,0,0,280000,0,280000,280000
053205,台光電麥證96購01,0,0,0,280000,0,280000,0,0,0,280000,0,0,0,280000,0,280000,280000
058385,創意中信99購01  ,0,0,0,0,0,0,0,0,0,280000,0,0,0,365000,85000,280000,280000
056074,茂林元大97購04  ,0,0,0,0,0,0,0,0,0,280000,0,0,0,280000,0,280000,280000
057834,聯發科元富02購07,0,0,0,0,0,0,0,0,0,279000,0,0,0,279000,0,279000,279000
060485,華新科富邦9C購04,0,0,0,0,0,0,0,0,0,278000,0,0,0,509000,231000,278000,278000
059629,友達凱基99購06  ,0,0,0,0,0,0,0,0,0,277000,0,0,0,280000,3000,277000,277000
1720,生達            ,394000,118000,276000,0,0,0,0,0,0,0,0,0,0,0,0,0,276000
061333,華通元大9A購08  ,0,0,0,0,0,0,0,0,0,275000,0,0,0,275000,0,275000,275000
049775,旺宏統一95購02  ,0,0,0,0,0,0,0,0,0,275000,0,0,0,333000,58000,275000,275000
058147,鈺齊元大99購01  ,0,0,0,0,0,0,0,0,0,275000,0,0,0,446000,171000,275000,275000
06780P,義隆元大98售02  ,0,0,0,0,0,0,0,0,0,274000,0,0,0,369000,95000,274000,274000
060100,新光金元大9C購01,0,0,0,0,0,0,0,0,0,274000,0,0,0,274000,0,274000,274000
053864,義隆元大96購01  ,0,0,0,0,0,0,0,0,0,273000,0,0,0,579000,306000,273000,273000
2867,三商壽          ,1099000,826000,273000,0,0,0,0,0,0,0,0,0,0,0,0,0,273000
00647L,元大S&P500正2   ,18000,18000,0,0,0,0,0,0,0,272000,0,0,0,541000,269000,272000,272000
052925,日電貿永豐96購01,0,0,0,0,0,0,0,0,0,272000,0,0,0,272000,0,272000,272000
057270,遠東新元大98購01,0,0,0,0,0,0,0,0,0,272000,0,0,0,292000,20000,272000,272000
058268,泰碩永豐9A購01  ,0,0,0,0,0,0,0,0,0,271000,0,0,0,343000,72000,271000,271000
060818,上銀統一9C購01  ,0,0,0,0,0,0,0,0,0,270000,0,0,0,413000,143000,270000,270000
054941,凱美元大97購01  ,0,0,0,0,0,0,0,0,0,270000,0,0,0,270000,0,270000,270000
055518,華新科中信99購01,0,0,0,0,0,0,0,0,0,270000,0,0,0,270000,0,270000,270000
2338,光罩            ,676000,484000,192000,0,0,0,0,0,0,78000,0,0,0,159000,81000,78000,270000
054439,健策台新96購03  ,0,0,0,0,0,0,0,0,0,269000,0,0,0,332000,63000,269000,269000
05905P,晶技統一97售01  ,0,0,0,0,0,0,0,0,0,269000,0,0,0,312000,43000,269000,269000
056169,鴻海元富97購08  ,0,0,0,0,0,0,0,0,0,269000,0,0,0,335000,66000,269000,269000
07342P,大立光凱基99售14,0,0,0,0,0,0,0,0,0,269000,0,0,0,340000,71000,269000,269000
055288,日電貿元大97購02,0,0,0,0,0,0,0,0,0,268000,0,0,0,278000,10000,268000,268000
2417,圓剛            ,674000,407000,267000,0,0,0,0,0,0,0,0,0,0,0,0,0,267000
057793,群創統一99購02  ,0,0,0,0,0,0,0,0,0,266000,0,0,0,394000,128000,266000,266000
2845,遠東銀          ,814000,548293,265707,0,0,0,0,0,0,0,0,0,0,0,0,0,265707
06746P,聯發科群益99售02,0,0,0,0,0,0,0,0,0,265000,0,0,0,265000,0,265000,265000
060549,聯發科凱基9B購03,0,0,0,0,0,0,0,0,0,265000,0,0,0,302000,37000,265000,265000
050774,健策元大96購02  ,0,0,0,0,0,0,0,0,0,265000,0,0,0,321000,56000,265000,265000
056298,億光元大97購02  ,0,0,0,0,0,0,0,0,0,265000,0,0,0,315000,50000,265000,265000
059057,聯發科凱基99購10,0,0,0,0,0,0,0,0,0,265000,0,0,0,280000,15000,265000,265000
057396,健鼎中信99購01  ,0,0,0,0,0,0,0,0,0,265000,0,0,0,265000,0,265000,265000
059872,華新科凱基01購01,0,0,0,0,0,0,0,0,0,264000,0,0,0,445000,181000,264000,264000
053253,友達國泰97購02  ,0,0,0,0,0,0,0,0,0,264000,0,0,0,264000,0,264000,264000
058444,國巨富邦9B購01  ,0,0,0,0,0,0,0,0,0,264000,0,0,0,295000,31000,264000,264000
060361,南亞科元富9A購03,0,0,0,0,0,0,0,0,0,263000,0,0,0,363000,100000,263000,263000
8081,致新            ,470000,188000,282000,0,0,0,0,0,0,-19000,10000,0,10000,6000,35000,-29000,263000
057997,旺宏第一9C購01  ,0,0,0,0,0,0,0,0,0,262000,0,0,0,313000,51000,262000,262000
056245,嘉澤群益97購01  ,0,0,0,0,0,0,0,0,0,262000,0,0,0,432000,170000,262000,262000
057824,日月光元大98購01,0,0,0,0,0,0,0,0,0,261000,0,0,0,261000,0,261000,261000
061046,上銀第一9A購01  ,0,0,0,0,0,0,0,0,0,260000,0,0,0,341000,81000,260000,260000
054028,臻鼎凱基96購03  ,0,0,0,0,0,0,0,0,0,260000,0,0,0,260000,0,260000,260000
4956,光鋐            ,283000,23000,260000,0,0,0,0,0,0,0,0,0,0,0,0,0,260000
060240,富邦金元大9A購01,0,0,0,0,0,0,0,0,0,259000,0,0,0,299000,40000,259000,259000
060018,國產康和99購01  ,0,0,0,0,0,0,0,0,0,259000,0,0,0,306000,47000,259000,259000
058181,華新科國泰9B購01,0,0,0,0,0,0,0,0,0,259000,0,0,0,293000,34000,259000,259000
6282,康舒            ,358000,124000,234000,0,0,0,0,0,0,25000,4000,2000,2000,23000,0,23000,259000
07634P,金像電元大9A售01,0,0,0,0,0,0,0,0,0,258000,0,0,0,472000,214000,258000,258000
060416,神隆永豐9A購01  ,0,0,0,0,0,0,0,0,0,256000,0,0,0,301000,45000,256000,256000
4960,誠美材          ,382000,126000,256000,0,0,0,0,0,0,0,0,0,0,0,0,0,256000
055216,友達凱基98購05  ,0,0,0,0,0,0,0,0,0,255000,0,0,0,355000,100000,255000,255000
051561,玉晶光國泰97購04,0,0,0,0,0,0,0,0,0,255000,0,0,0,318000,63000,255000,255000
061035,亞光永豐9A購01  ,0,0,0,0,0,0,0,0,0,254000,0,0,0,254000,0,254000,254000
055887,上銀統一97購03  ,0,0,0,0,0,0,0,0,0,253000,0,0,0,266000,13000,253000,253000
1303,南亞            ,1804155,2529760,-725605,0,0,0,1008000,0,1008000,-30000,0,30000,-30000,0,0,0,252395
060426,盛群永豐9A購01  ,0,0,0,0,0,0,0,0,0,252000,0,0,0,256000,4000,252000,252000
059107,南茂國泰9A購01  ,0,0,0,0,0,0,0,0,0,252000,0,0,0,278000,26000,252000,252000
061129,文曄永豐9A購01  ,0,0,0,0,0,0,0,0,0,251000,0,0,0,251000,0,251000,251000
051259,鴻海永昌96購03  ,0,0,0,0,0,0,0,0,0,250000,0,0,0,250000,0,250000,250000
054874,帆宣群益99購02  ,0,0,0,0,0,0,0,0,0,250000,0,0,0,250000,0,250000,250000
052837,友達國泰97購01  ,0,0,0,0,0,0,0,0,0,250000,0,0,0,331000,81000,250000,250000
6592,和潤企業        ,326000,365000,-39000,0,0,0,160000,0,160000,129000,0,0,0,166000,37000,129000,250000
061140,華擎統一9C購01  ,0,0,0,0,0,0,0,0,0,248000,0,0,0,255000,7000,248000,248000
053056,同欣電國票97購01,0,0,0,0,0,0,0,0,0,248000,0,0,0,293000,45000,248000,248000
055142,健策永豐98購01  ,0,0,0,0,0,0,0,0,0,248000,0,0,0,287000,39000,248000,248000
1762,中化生          ,585000,834000,-249000,0,0,0,474000,0,474000,23000,23000,0,23000,0,0,0,248000
061351,智伸科元大9A購01,0,0,0,0,0,0,0,0,0,247000,0,0,0,257000,10000,247000,247000
060308,劍麟永豐9A購01  ,0,0,0,0,0,0,0,0,0,247000,0,0,0,323000,76000,247000,247000
057929,上銀群益98購02  ,0,0,0,0,0,0,0,0,0,246000,0,0,0,321000,75000,246000,246000
054928,帆宣凱基98購01  ,0,0,0,0,0,0,0,0,0,246000,0,0,0,246000,0,246000,246000
058677,矽格群益99購01  ,0,0,0,0,0,0,0,0,0,246000,0,0,0,246000,0,246000,246000
058182,日電貿國泰9A購01,0,0,0,0,0,0,0,0,0,246000,0,0,0,246000,0,246000,246000
057096,緯穎元富98購01  ,0,0,0,0,0,0,0,0,0,246000,0,0,0,345000,99000,246000,246000
060014,中鋼康和99購01  ,0,0,0,0,0,0,0,0,0,245000,0,0,0,290000,45000,245000,245000
057656,大成鋼兆豐98購01,0,0,0,0,0,0,0,0,0,245000,0,0,0,305000,60000,245000,245000
057206,立積元富98購01  ,0,0,0,0,0,0,0,0,0,245000,0,0,0,538000,293000,245000,245000
00737,國泰AI+Robo     ,560000,0,560000,0,0,0,0,0,0,-316000,0,0,0,538000,854000,-316000,244000
056281,深中小永豐97購01,0,0,0,0,0,0,0,0,0,243000,0,0,0,484000,241000,243000,243000
046906,新光金凱基99購02,0,0,0,0,0,0,0,0,0,242000,0,0,0,259000,17000,242000,242000
055252,新光金統一98購02,0,0,0,0,0,0,0,0,0,242000,0,0,0,242000,0,242000,242000
057109,信邦群益98購01  ,0,0,0,0,0,0,0,0,0,242000,0,0,0,669000,427000,242000,242000
056488,致新元大99購01  ,0,0,0,0,0,0,0,0,0,242000,0,0,0,294000,52000,242000,242000
054919,興富發凱基97購01,0,0,0,0,0,0,0,0,0,241000,0,0,0,241000,0,241000,241000
054673,京鼎國泰98購01  ,0,0,0,0,0,0,0,0,0,240000,0,0,0,307000,67000,240000,240000
057649,嘉聯益元大99購04,0,0,0,0,0,0,0,0,0,240000,0,0,0,271000,31000,240000,240000
056255,華新科元富97購05,0,0,0,0,0,0,0,0,0,240000,0,0,0,290000,50000,240000,240000
2049,上銀            ,1406000,1176090,229910,0,0,0,114000,0,114000,-104000,36000,56000,-20000,5000,89000,-84000,239910
059920,宏達電元大99購07,0,0,0,0,0,0,0,0,0,239000,0,0,0,300000,61000,239000,239000
060886,國巨統一01購03  ,0,0,0,0,0,0,0,0,0,239000,0,0,0,279000,40000,239000,239000
07074P,FBVIX凱基9A售01 ,0,0,0,0,0,0,0,0,0,238000,0,0,0,238000,0,238000,238000
060712,建準永豐9A購01  ,0,0,0,0,0,0,0,0,0,238000,0,0,0,322000,84000,238000,238000
053754,英業達元富96購02,0,0,0,0,0,0,0,0,0,238000,0,0,0,338000,100000,238000,238000
058369,亞光凱基99購02  ,0,0,0,0,0,0,0,0,0,238000,0,0,0,238000,0,238000,238000
058682,聯發科凱基99購07,0,0,0,0,0,0,0,0,0,237000,0,0,0,237000,0,237000,237000
058819,華通國泰9B購01  ,0,0,0,0,0,0,0,0,0,237000,0,0,0,237000,0,237000,237000
058547,世紀鋼富邦9A購01,0,0,0,0,0,0,0,0,0,236000,0,0,0,563000,327000,236000,236000
060722,矽格永豐9A購01  ,0,0,0,0,0,0,0,0,0,235000,0,0,0,235000,0,235000,235000
052588,玉晶光永豐98購01,0,0,0,0,0,0,0,0,0,235000,0,0,0,262000,27000,235000,235000
047418,智邦富邦97購01  ,0,0,0,0,0,0,0,0,0,235000,0,0,0,250000,15000,235000,235000
057836,南亞科國泰9A購01,0,0,0,0,0,0,0,0,0,235000,0,0,0,342000,107000,235000,235000
2501,國建            ,315000,81000,234000,0,0,0,0,0,0,1000,1000,0,1000,0,0,0,235000
058132,義隆元大99購03  ,0,0,0,0,0,0,0,0,0,234000,0,0,0,486000,252000,234000,234000
1905,華紙            ,255000,21000,234000,0,0,0,0,0,0,0,0,0,0,0,0,0,234000
057698,奇力新群益98購02,0,0,0,0,0,0,0,0,0,233000,0,0,0,320000,87000,233000,233000
057730,聯鈞國泰9A購01  ,0,0,0,0,0,0,0,0,0,233000,0,0,0,436000,203000,233000,233000
052927,友達元大98購02  ,0,0,0,0,0,0,0,0,0,233000,0,0,0,233000,0,233000,233000
059100,元油2X統一9C購02,0,0,0,0,0,0,0,0,0,233000,0,0,0,717000,484000,233000,233000
057671,群創元大9B購06  ,0,0,0,0,0,0,0,0,0,232000,0,0,0,232000,0,232000,232000
048651,美利達元大96購05,0,0,0,0,0,0,0,0,0,232000,0,0,0,257000,25000,232000,232000
061025,創意富邦9B購01  ,0,0,0,0,0,0,0,0,0,231000,0,0,0,236000,5000,231000,231000
060365,京鼎元富9A購01  ,0,0,0,0,0,0,0,0,0,231000,0,0,0,612000,381000,231000,231000
054640,健策中信9B購01  ,10000,0,10000,0,0,0,0,0,0,221000,0,0,0,240000,19000,221000,231000
056903,大立光元大99購04,0,0,0,0,0,0,0,0,0,231000,0,0,0,256000,25000,231000,231000
06067P,華新科康和97售01,0,0,0,0,0,0,0,0,0,230000,0,0,0,304000,74000,230000,230000
057865,富邦金凱基98購01,0,0,0,0,0,0,0,0,0,230000,0,0,0,240000,10000,230000,230000
058204,世芯凱基9A購01  ,0,0,0,0,0,0,0,0,0,230000,0,0,0,445000,215000,230000,230000
057624,新日興國泰99購01,0,0,0,0,0,0,0,0,0,229000,0,0,0,229000,0,229000,229000
07761P,智邦永豐9A售03  ,0,0,0,0,0,0,0,0,0,229000,0,0,0,320000,91000,229000,229000
060163,健策永豐9B購01  ,0,0,0,0,0,0,0,0,0,228000,0,0,0,243000,15000,228000,228000
058413,義隆兆豐99購01  ,0,0,0,0,0,0,0,0,0,228000,0,0,0,391000,163000,228000,228000
058507,美律元大9A購01  ,0,0,0,0,0,0,0,0,0,228000,0,0,0,284000,56000,228000,228000
2006,東和鋼鐵        ,406000,238000,168000,0,0,0,0,0,0,60000,90000,30000,60000,0,0,0,228000
9914,美利達          ,468000,1051100,-583100,0,0,0,724000,0,724000,87000,91000,4000,87000,0,0,0,227900
060940,國巨國票9B購03  ,0,0,0,0,0,0,0,0,0,227000,0,0,0,464000,237000,227000,227000
061170,南茂兆豐9B購01  ,0,0,0,0,0,0,0,0,0,227000,0,0,0,227000,0,227000,227000
053364,友達國泰98購01  ,0,0,0,0,0,0,0,0,0,227000,0,0,0,227000,0,227000,227000
058664,百和兆豐99購01  ,0,0,0,0,0,0,0,0,0,227000,0,0,0,411000,184000,227000,227000
060746,玉晶光國票9B購02,0,0,0,0,0,0,0,0,0,226000,0,0,0,262000,36000,226000,226000
057691,健策凱基99購01  ,0,0,0,0,0,0,0,0,0,226000,0,0,0,227000,1000,226000,226000
049438,嘉晶國泰96購01  ,0,0,0,0,0,0,0,0,0,226000,0,0,0,226000,0,226000,226000
055575,華新科統一98購01,0,0,0,0,0,0,0,0,0,226000,0,0,0,226000,0,226000,226000
07590P,玉晶光國票9A售03,0,0,0,0,0,0,0,0,0,226000,0,0,0,265000,39000,226000,226000
052319,可成元大95購12  ,0,0,0,0,0,0,0,0,0,225000,0,0,0,225000,0,225000,225000
056572,義隆元大99購01  ,0,0,0,0,0,0,0,0,0,225000,0,0,0,522000,297000,225000,225000
058929,可成統一9C購01  ,0,0,0,0,0,0,0,0,0,225000,0,0,0,226000,1000,225000,225000
07647P,健策國票9A售04  ,0,0,0,0,0,0,0,0,0,225000,0,0,0,225000,0,225000,225000
060292,聯詠元大9A購01  ,0,0,0,0,0,0,0,0,0,224000,0,0,0,281000,57000,224000,224000
060470,台勝科元大9A購03,0,0,0,0,0,0,0,0,0,224000,0,0,0,339000,115000,224000,224000
053536,明泰永豐96購01  ,0,0,0,0,0,0,0,0,0,224000,0,0,0,391000,167000,224000,224000
058559,華新科日盛99購02,0,0,0,0,0,0,0,0,0,224000,0,0,0,232000,8000,224000,224000
054331,世芯永豐96購03  ,0,0,0,0,0,0,0,0,0,223000,0,0,0,242000,19000,223000,223000
053750,致伸永豐96購02  ,0,0,0,0,0,0,0,0,0,223000,0,0,0,223000,0,223000,223000
055025,華新科國泰98購02,0,0,0,0,0,0,0,0,0,223000,0,0,0,226000,3000,223000,223000
048591,台郡兆豐94購01  ,0,0,0,0,0,0,0,0,0,223000,0,0,0,223000,0,223000,223000
056308,TPK元大97購02   ,0,0,0,0,0,0,0,0,0,223000,0,0,0,247000,24000,223000,223000
060237,友達元大9A購06  ,0,0,0,0,0,0,0,0,0,222000,0,0,0,381000,159000,222000,222000
057733,嘉聯益國泰99購01,0,0,0,0,0,0,0,0,0,222000,0,0,0,222000,0,222000,222000
054801,康友群益97購02  ,0,0,0,0,0,0,0,0,0,222000,0,0,0,222000,0,222000,222000
059741,聯發科元富99購07,0,0,0,0,0,0,0,0,0,221000,0,0,0,262000,41000,221000,221000
060909,金像電元大9B購01,0,0,0,0,0,0,0,0,0,221000,0,0,0,261000,40000,221000,221000
046384,群創凱基98購02  ,0,0,0,0,0,0,0,0,0,221000,0,0,0,230000,9000,221000,221000
05564P,玉晶光元大97售02,0,0,0,0,0,0,0,0,0,221000,0,0,0,221000,0,221000,221000
057714,聯發科統一98購05,0,0,0,0,0,0,0,0,0,220000,0,0,0,220000,0,220000,220000
056529,中環凱基98購01  ,0,0,0,0,0,0,0,0,0,220000,0,0,0,273000,53000,220000,220000
07685P,玉晶光凱基9B售03,0,0,0,0,0,0,0,0,0,220000,0,0,0,230000,10000,220000,220000
055041,致新富邦97購01  ,0,0,0,0,0,0,0,0,0,219000,0,0,0,219000,0,219000,219000
059993,上銀元富99購01  ,0,0,0,0,0,0,0,0,0,218000,0,0,0,286000,68000,218000,218000
2328,廣宇            ,595000,403000,192000,0,0,0,0,0,0,26000,34000,8000,26000,0,0,0,218000
061049,奇力新中信9A購02,0,0,0,0,0,0,0,0,0,217000,0,0,0,303000,86000,217000,217000
059789,貿聯元大9A購02  ,0,0,0,0,0,0,0,0,0,216000,0,0,0,216000,0,216000,216000
055388,華通統一97購03  ,0,0,0,0,0,0,0,0,0,216000,0,0,0,216000,0,216000,216000
2369,菱生            ,700000,484000,216000,0,0,0,0,0,0,0,0,0,0,0,0,0,216000
059641,群創凱基99購06  ,0,0,0,0,0,0,0,0,0,215000,0,0,0,361000,146000,215000,215000
06822P,上銀富邦99售03  ,0,0,0,0,0,0,0,0,0,215000,0,0,0,221000,6000,215000,215000
057701,嘉聯益群益98購02,0,0,0,0,0,0,0,0,0,215000,0,0,0,215000,0,215000,215000
052987,華新科元大99購01,0,0,0,0,0,0,0,0,0,215000,0,0,0,215000,0,215000,215000
057307,瀚宇博兆豐99購01,0,0,0,0,0,0,0,0,0,215000,0,0,0,250000,35000,215000,215000
3041,揚智            ,333000,118000,215000,0,0,0,0,0,0,0,0,0,0,0,0,0,215000
3035,智原            ,561000,327000,234000,0,0,0,0,0,0,-20000,18000,30000,-12000,21000,29000,-8000,214000
051888,國巨元富95購05  ,0,0,0,0,0,0,0,0,0,213000,0,0,0,213000,0,213000,213000
052003,泰碩國泰97購02  ,0,0,0,0,0,0,0,0,0,212000,0,0,0,906000,694000,212000,212000
046629,群創統一98購01  ,0,0,0,0,0,0,0,0,0,212000,0,0,0,257000,45000,212000,212000
054531,聯發科國泰97購02,0,0,0,0,0,0,0,0,0,212000,0,0,0,259000,47000,212000,212000
056562,奇力新群益98購01,0,0,0,0,0,0,0,0,0,212000,0,0,0,351000,139000,212000,212000
056085,聯發科統一97購01,0,0,0,0,0,0,0,0,0,212000,0,0,0,212000,0,212000,212000
058984,全新凱基9A購03  ,0,0,0,0,0,0,0,0,0,212000,0,0,0,259000,47000,212000,212000
2905,三商            ,384000,172000,212000,0,0,0,0,0,0,0,0,0,0,0,0,0,212000
4414,如興            ,457000,245000,212000,0,0,0,0,0,0,0,0,0,0,0,0,0,212000
059480,美律群益9A購01  ,0,0,0,0,0,0,0,0,0,211000,0,0,0,309000,98000,211000,211000
051745,玉晶光國泰97購06,0,0,0,0,0,0,0,0,0,211000,0,0,0,225000,14000,211000,211000
050686,欣興兆豐96購01  ,0,0,0,0,0,0,0,0,0,210000,0,0,0,210000,0,210000,210000
057502,訊芯群益98購02  ,0,0,0,0,0,0,0,0,0,210000,0,0,0,573000,363000,210000,210000
057279,國揚元大98購01  ,0,0,0,0,0,0,0,0,0,210000,0,0,0,271000,61000,210000,210000
056909,嘉聯益元大99購03,0,0,0,0,0,0,0,0,0,210000,0,0,0,244000,34000,210000,210000
1440,南紡            ,333000,123000,210000,0,0,0,0,0,0,0,0,0,0,0,0,0,210000
059623,聯電凱基99購02  ,0,0,0,0,0,0,0,0,0,209000,0,0,0,508000,299000,209000,209000
060601,技嘉凱基9A購02  ,0,0,0,0,0,0,0,0,0,209000,0,0,0,209000,0,209000,209000
07319P,台積電凱基01售02,0,0,0,0,0,0,0,0,0,209000,0,0,0,209000,0,209000,209000
060566,聯詠富邦9C購01  ,0,0,0,0,0,0,0,0,0,208000,0,0,0,419000,211000,208000,208000
060262,臺股指凱基9B購02,0,0,0,0,0,0,0,0,0,208000,0,0,0,494000,286000,208000,208000
053898,康友群益97購01  ,0,0,0,0,0,0,0,0,0,208000,0,0,0,209000,1000,208000,208000
056398,南茂永豐98購01  ,0,0,0,0,0,0,0,0,0,208000,0,0,0,420000,212000,208000,208000
4915,致伸            ,392000,166000,226000,0,0,0,1000,0,1000,-19000,0,8000,-8000,10000,21000,-11000,208000
060048,元金2X凱基99購03,0,0,0,0,0,0,0,0,0,207000,0,0,0,207000,0,207000,207000
061040,康友永豐9A購01  ,0,0,0,0,0,0,0,0,0,207000,0,0,0,217000,10000,207000,207000
05467P,聯電元大95售02  ,0,0,0,0,0,0,0,0,0,207000,0,0,0,392000,185000,207000,207000
055005,晶相光元富97購01,0,100000,-100000,0,0,0,0,0,0,307000,0,0,0,605000,298000,307000,207000
058762,貿聯群益99購03  ,0,0,0,0,0,0,0,0,0,207000,0,0,0,237000,30000,207000,207000
058142,瑞儀元大99購01  ,0,0,0,0,0,0,0,0,0,207000,0,0,0,277000,70000,207000,207000
054279,揚明光群益98購01,0,0,0,0,0,0,0,0,0,206000,0,0,0,206000,0,206000,206000
060894,奇力新凱基9A購03,0,0,0,0,0,0,0,0,0,205000,0,0,0,225000,20000,205000,205000
061118,GIS富邦9A購01   ,0,0,0,0,0,0,0,0,0,205000,0,0,0,246000,41000,205000,205000
061215,健策元大9A購06  ,0,0,0,0,0,0,0,0,0,205000,0,0,0,445000,240000,205000,205000
00830,國泰費城半導體  ,0,6000,-6000,0,0,0,0,0,0,211000,311000,0,311000,225000,325000,-100000,205000
057324,億光群益98購01  ,0,0,0,0,0,0,0,0,0,205000,0,0,0,217000,12000,205000,205000
056786,亞光群益98購03  ,0,0,0,0,0,0,0,0,0,205000,0,0,0,303000,98000,205000,205000
056603,嘉聯益國泰9A購01,0,0,0,0,0,0,0,0,0,205000,0,0,0,285000,80000,205000,205000
061267,玉山金凱基9B購01,0,0,0,0,0,0,0,0,0,204000,0,0,0,204000,0,204000,204000
061368,南六國票9A購01  ,0,0,0,0,0,0,0,0,0,204000,0,0,0,364000,160000,204000,204000
061081,宏碁兆豐9A購01  ,0,0,0,0,0,0,0,0,0,204000,0,0,0,323000,119000,204000,204000
060726,聯發科第一9A購01,0,0,0,0,0,0,0,0,0,203000,0,0,0,227000,24000,203000,203000
052943,奇力新國票96購02,0,0,0,0,0,0,0,0,0,203000,0,0,0,265000,62000,203000,203000
057417,國巨凱基9A購03  ,0,0,0,0,0,0,0,0,0,202000,0,0,0,202000,0,202000,202000
07303P,臺股指元大9A售36,0,0,0,0,0,0,0,0,0,202000,0,0,0,262000,60000,202000,202000
07589P,玉晶光國票9A售02,0,0,0,0,0,0,0,0,0,202000,0,0,0,204000,2000,202000,202000
059460,GIS永豐99購02   ,0,0,0,0,0,0,0,0,0,201000,0,0,0,224000,23000,201000,201000
00641R,富邦日本反1     ,0,0,0,0,0,0,0,0,0,201000,0,0,0,356000,155000,201000,201000
07617P,聯發科中信9C售04,0,0,0,0,0,0,0,0,0,201000,0,0,0,222000,21000,201000,201000
1611,中電            ,224000,24000,200000,0,0,0,0,0,0,1000,1000,0,1000,0,0,0,201000
2505,國揚            ,1259000,604000,655000,0,0,0,0,0,0,-454000,0,0,0,152000,606000,-454000,201000
059897,T50反1元大99購14,0,0,0,0,0,0,0,0,0,200000,0,0,0,200000,0,200000,200000
06546P,聯發科元大98售05,0,0,0,0,0,0,0,0,0,200000,0,0,0,200000,0,200000,200000
03006X,元展06          ,0,0,0,0,0,0,0,0,0,200000,0,0,0,200000,0,200000,200000
03007X,元展07          ,0,0,0,0,0,0,0,0,0,200000,0,0,0,200000,0,200000,200000
03015X,元展15          ,0,0,0,0,0,0,0,0,0,200000,0,0,0,200000,0,200000,200000
051740,可成國票96購04  ,0,0,0,0,0,0,0,0,0,200000,0,0,0,200000,0,200000,200000
051828,微星元大95購03  ,0,0,0,0,0,0,0,0,0,200000,0,0,0,200000,0,200000,200000
052030,GIS群益95購04   ,0,0,0,0,0,0,0,0,0,200000,0,0,0,200000,0,200000,200000
058977,SGBR2X凱基03購01,0,0,0,0,0,0,0,0,0,200000,0,0,0,353000,153000,200000,200000
059272,台灣50元大99購01,0,0,0,0,0,0,0,0,0,200000,0,0,0,200000,0,200000,200000
057202,TPK元富98購02   ,0,0,0,0,0,0,0,0,0,200000,0,0,0,477000,277000,200000,200000
056003,智伸科永豐97購02,0,0,0,0,0,0,0,0,0,200000,0,0,0,200000,0,200000,200000
060948,可成第一9A購01  ,0,0,0,0,0,0,0,0,0,199000,0,0,0,199000,0,199000,199000
060418,中橡永豐9A購01  ,0,0,0,0,0,0,0,0,0,199000,0,0,0,262000,63000,199000,199000
059312,元石油元大99購05,0,0,0,0,0,0,0,0,0,199000,0,0,0,669000,470000,199000,199000
00766L,台新MSCI中國正2 ,0,0,0,0,0,0,0,0,0,198000,0,0,0,266000,68000,198000,198000
050715,台積電群益96購01,0,0,0,0,0,0,0,0,0,198000,0,0,0,198000,0,198000,198000
054351,華新科國泰97購03,0,0,0,0,0,0,0,0,0,198000,0,0,0,253000,55000,198000,198000
057616,聯電凱基99購01  ,0,0,0,0,0,0,0,0,0,198000,0,0,0,285000,87000,198000,198000
056711,亞光永豐98購01  ,0,0,0,0,0,0,0,0,0,197000,0,0,0,197000,0,197000,197000
058537,彩晶統一9B購01  ,0,0,0,0,0,0,0,0,0,197000,0,0,0,330000,133000,197000,197000
05212P,台積電國票96售04,0,0,0,0,0,0,0,0,0,196000,0,0,0,398000,202000,196000,196000
058658,瑞儀中信99購01  ,0,0,0,0,0,0,0,0,0,196000,0,0,0,213000,17000,196000,196000
055232,泰碩國票98購01  ,0,6000,-6000,0,0,0,0,0,0,202000,0,0,0,217000,15000,202000,196000
07543P,台積電凱基9A售17,0,0,0,0,0,0,0,0,0,196000,0,0,0,241000,45000,196000,196000
054582,致新元大97購01  ,0,0,0,0,0,0,0,0,0,195000,0,0,0,208000,13000,195000,195000
058672,可成群益9B購02  ,0,0,0,0,0,0,0,0,0,195000,0,0,0,205000,10000,195000,195000
057090,奇力新元富98購02,0,0,0,0,0,0,0,0,0,195000,0,0,0,315000,120000,195000,195000
057106,美律群益98購03  ,0,0,0,0,0,0,0,0,0,195000,0,0,0,195000,0,195000,195000
058852,貿聯群益99購04  ,0,0,0,0,0,0,0,0,0,195000,0,0,0,217000,22000,195000,195000
059867,華邦電凱基99購02,0,0,0,0,0,0,0,0,0,194000,0,0,0,194000,0,194000,194000
052937,國巨兆豐97購01  ,0,0,0,0,0,0,0,0,0,194000,0,0,0,204000,10000,194000,194000
058614,台郡元大9A購01  ,0,0,0,0,0,0,0,0,0,194000,0,0,0,194000,0,194000,194000
4739,康普            ,160000,168000,-8000,0,0,0,190000,0,190000,12000,0,1000,-1000,13000,0,13000,194000
060434,台汽電永豐9A購01,0,0,0,0,0,0,0,0,0,193000,0,0,0,226000,33000,193000,193000
061190,力山永豐9A購02  ,0,0,0,0,0,0,0,0,0,193000,0,0,0,276000,83000,193000,193000
057838,台郡國泰99購01  ,0,0,0,0,0,0,0,0,0,193000,0,0,0,193000,0,193000,193000
055174,精元統一97購01  ,0,0,0,0,0,0,0,0,0,193000,0,0,0,613000,420000,193000,193000
055698,茂林國票98購03  ,0,0,0,0,0,0,0,0,0,192000,0,0,0,287000,95000,192000,192000
07546P,玉晶光凱基9A售09,0,0,0,0,0,0,0,0,0,192000,0,0,0,757000,565000,192000,192000
1218,泰山            ,272000,90000,182000,0,0,0,0,0,0,10000,10000,0,10000,0,0,0,192000
060596,元黃金凱基9A購02,0,0,0,0,0,0,0,0,0,191000,0,0,0,278000,87000,191000,191000
052094,瀚宇博元大96購02,0,0,0,0,0,0,0,0,0,191000,0,0,0,211000,20000,191000,191000
056571,燿華元大98購02  ,0,0,0,0,0,0,0,0,0,191000,0,0,0,191000,0,191000,191000
060052,宏碁凱基99購01  ,0,0,0,0,0,0,0,0,0,190000,0,0,0,208000,18000,190000,190000
059507,鴻海永豐99購03  ,0,0,0,0,0,0,0,0,0,190000,0,0,0,300000,110000,190000,190000
060915,旭富元大9A購01  ,0,0,0,0,0,0,0,0,0,190000,0,0,0,357000,167000,190000,190000
050688,大立光日盛94購03,0,0,0,0,0,0,0,0,0,190000,0,0,0,190000,0,190000,190000
053516,茂林群益96購05  ,0,0,0,0,0,0,0,0,0,190000,0,0,0,396000,206000,190000,190000
053383,京元電元大97購01,0,0,0,0,0,0,0,0,0,190000,0,0,0,190000,0,190000,190000
056385,創意國泰99購01  ,0,0,0,0,0,0,0,0,0,190000,0,0,0,190000,0,190000,190000
056526,力山凱基98購01  ,0,0,0,0,0,0,0,0,0,190000,0,0,0,360000,170000,190000,190000
058995,台達電元大99購01,0,0,0,0,0,0,0,0,0,190000,0,0,0,204000,14000,190000,190000
058363,全新凱基9A購02  ,0,0,0,0,0,0,0,0,0,190000,0,0,0,190000,0,190000,190000
058229,為升元大99購02  ,0,0,0,0,0,0,0,0,0,190000,0,0,0,210000,20000,190000,190000
2365,昆盈            ,222000,32000,190000,0,0,0,0,0,0,0,0,0,0,0,0,0,190000
060366,健策元富9A購01  ,0,0,0,0,0,0,0,0,0,189000,0,0,0,189000,0,189000,189000
054352,世芯國泰98購01  ,0,0,0,0,0,0,0,0,0,189000,0,0,0,232000,43000,189000,189000
058771,神達兆豐99購01  ,0,0,0,0,0,0,0,0,0,189000,0,0,0,215000,26000,189000,189000
2034,允強            ,254000,65000,189000,0,0,0,0,0,0,0,0,0,0,0,0,0,189000
1904,正隆            ,1182000,576000,606000,0,0,0,0,433000,-433000,16000,0,0,0,38000,22000,16000,189000
3413,京鼎            ,407000,281000,126000,0,0,0,10000,0,10000,53000,76000,27000,49000,68000,64000,4000,189000
07531P,大立光國泰9B售03,0,0,0,0,0,0,0,0,0,189000,0,0,0,238000,49000,189000,189000
060197,臻鼎元富9A購02  ,0,0,0,0,0,0,0,0,0,188000,0,0,0,650000,462000,188000,188000
059570,全新凱基99購04  ,0,0,0,0,0,0,0,0,0,188000,0,0,0,188000,0,188000,188000
05977P,旺宏永豐96售06  ,0,0,0,0,0,0,0,0,0,188000,0,0,0,267000,79000,188000,188000
054311,世芯凱基96購02  ,0,0,0,0,0,0,0,0,0,188000,0,0,0,286000,98000,188000,188000
057092,健策元富98購01  ,0,0,0,0,0,0,0,0,0,188000,0,0,0,283000,95000,188000,188000
056406,建準國票99購01  ,0,0,0,0,0,0,0,0,0,188000,0,0,0,188000,0,188000,188000
1464,得力            ,279000,91000,188000,0,0,0,0,0,0,0,0,0,0,0,0,0,188000
059459,訊芯永豐99購04  ,0,0,0,0,0,0,0,0,0,187000,0,0,0,294000,107000,187000,187000
060320,元金2X群益02購01,0,0,0,0,0,0,0,0,0,187000,0,0,0,370000,183000,187000,187000
060720,嘉聯益永豐9A購02,0,0,0,0,0,0,0,0,0,187000,0,0,0,187000,0,187000,187000
061249,億豐群益9A購01  ,0,0,0,0,0,0,0,0,0,187000,0,0,0,260000,73000,187000,187000
057129,聯發科凱基99購03,0,0,0,0,0,0,0,0,0,187000,0,0,0,188000,1000,187000,187000
07640P,國巨群益9A售07  ,0,0,0,0,0,0,0,0,0,187000,0,0,0,220000,33000,187000,187000
060778,臺股指凱基9A購06,0,0,0,0,0,0,0,0,0,186000,0,0,0,187000,1000,186000,186000
059847,喬山永豐99購01  ,0,0,0,0,0,0,0,0,0,186000,0,0,0,275000,89000,186000,186000
053694,創意元大96購03  ,0,0,0,0,0,0,0,0,0,186000,0,0,0,286000,100000,186000,186000
049491,聯發科元大95購01,0,0,0,0,0,0,0,0,0,186000,0,0,0,446000,260000,186000,186000
057982,帆宣永豐98購01  ,0,0,0,0,0,0,0,0,0,186000,0,0,0,186000,0,186000,186000
060412,儒鴻永豐9A購01  ,0,0,0,0,0,0,0,0,0,185000,0,0,0,280000,95000,185000,185000
061189,可成富邦9B購02  ,0,0,0,0,0,0,0,0,0,185000,0,0,0,205000,20000,185000,185000
051659,力山國泰97購01  ,0,0,0,0,0,0,0,0,0,185000,0,0,0,280000,95000,185000,185000
052699,友達國票97購01  ,0,0,0,0,0,0,0,0,0,185000,0,0,0,200000,15000,185000,185000
054807,台化元大9A購02  ,0,0,0,0,0,0,0,0,0,185000,0,0,0,185000,0,185000,185000
057629,泰碩永豐98購02  ,0,0,0,0,0,0,0,0,0,185000,0,0,0,235000,50000,185000,185000
1308,亞聚            ,220000,55000,165000,0,0,0,0,0,0,20000,20000,0,20000,0,0,0,185000
060329,鎧勝群益9B購01  ,0,0,0,0,0,0,0,0,0,184000,0,0,0,244000,60000,184000,184000
056211,南港國票98購01  ,0,0,0,0,0,0,0,0,0,184000,0,0,0,338000,154000,184000,184000
056823,智伸科永豐98購01,0,0,0,0,0,0,0,0,0,183000,0,0,0,251000,68000,183000,183000
060396,友達國票9A購01  ,0,0,0,0,0,0,0,0,0,182000,0,0,0,225000,43000,182000,182000
060878,奇力新中信9C購01,0,0,0,0,0,0,0,0,0,182000,0,0,0,282000,100000,182000,182000
04049P,大立光元大95售02,0,0,0,0,0,0,0,0,0,182000,0,0,0,182000,0,182000,182000
047564,滬深2X國票99購01,0,0,0,0,0,0,0,0,0,182000,0,0,0,932000,750000,182000,182000
057987,大立光元富98購02,0,0,0,0,0,0,0,0,0,182000,0,0,0,540000,358000,182000,182000
08637P,台灣50中信96售03,0,0,0,0,0,0,0,0,0,182000,0,0,0,238000,56000,182000,182000
3535,晶彩科          ,395000,213000,182000,0,0,0,0,0,0,0,0,0,0,0,0,0,182000
6197,佳必琪          ,227000,45000,182000,0,0,0,0,0,0,0,0,0,0,0,0,0,182000
05528P,臺股指群益96售01,4000,0,4000,0,0,0,0,0,0,177000,0,0,0,242000,65000,177000,181000
055334,禾伸堂兆豐97購01,0,0,0,0,0,0,0,0,0,181000,0,0,0,315000,134000,181000,181000
07368P,國巨凱基99售19  ,0,0,0,0,0,0,0,0,0,181000,0,0,0,365000,184000,181000,181000
07100P,華航元大99售01  ,0,0,0,0,0,0,0,0,0,180000,0,0,0,180000,0,180000,180000
060692,鴻海麥證9A購01  ,0,0,0,208000,28000,180000,0,0,0,180000,0,0,0,208000,28000,180000,180000
048859,玉晶光群益96購02,0,0,0,0,0,0,0,0,0,180000,0,0,0,200000,20000,180000,180000
00706L,元大S&P日圓正2  ,0,0,0,0,0,0,0,0,0,180000,0,0,0,180000,0,180000,180000
057970,國巨富邦99購03  ,0,0,0,0,0,0,0,0,0,180000,0,0,0,180000,0,180000,180000
052934,中磊元大96購01  ,0,0,0,0,0,0,0,0,0,180000,0,0,0,206000,26000,180000,180000
057089,奇力新元富98購01,0,0,0,0,0,0,0,0,0,180000,0,0,0,200000,20000,180000,180000
057176,全新元大99購02  ,0,0,0,0,0,0,0,0,0,180000,0,0,0,180000,0,180000,180000
060032,利勤永豐99購01  ,0,0,0,0,0,0,0,0,0,179000,0,0,0,179000,0,179000,179000
055433,嘉聯益群益99購01,0,0,0,0,0,0,0,0,0,179000,0,0,0,328000,149000,179000,179000
059151,臺股指國票99購14,0,0,0,0,0,0,0,0,0,179000,0,0,0,192000,13000,179000,179000
057606,健策統一98購03  ,0,0,0,0,0,0,0,0,0,178000,0,0,0,216000,38000,178000,178000
060049,華通凱基99購06  ,0,0,0,0,0,0,0,0,0,177000,0,0,0,177000,0,177000,177000
060710,上銀永豐9A購01  ,0,0,0,0,0,0,0,0,0,177000,0,0,0,189000,12000,177000,177000
061273,臺股指凱基9A購23,0,0,0,0,0,0,0,0,0,177000,0,0,0,177000,0,177000,177000
055393,華新科統一97購03,0,0,0,0,0,0,0,0,0,177000,0,0,0,177000,0,177000,177000
07413P,國巨元大99售33  ,0,0,0,0,0,0,0,0,0,177000,0,0,0,211000,34000,177000,177000
07415P,台積電元大99售52,0,0,0,0,0,0,0,0,0,177000,0,0,0,227000,50000,177000,177000
055746,同欣電元富97購01,0,0,0,0,0,0,0,0,0,176000,0,0,0,246000,70000,176000,176000
057078,國巨統一9A購02  ,0,0,0,0,0,0,0,0,0,176000,0,0,0,176000,0,176000,176000
059080,亞泥元大99購01  ,0,0,0,0,0,0,0,0,0,176000,0,0,0,191000,15000,176000,176000
057181,亞光元大98購02  ,0,0,0,0,0,0,0,0,0,176000,0,0,0,276000,100000,176000,176000
061083,京元電兆豐9A購01,0,0,0,0,0,0,0,0,0,175000,0,0,0,175000,0,175000,175000
060729,國巨群益9A購05  ,0,0,0,0,0,0,0,0,0,175000,0,0,0,376000,201000,175000,175000
052849,可成統一97購01  ,0,0,0,0,0,0,0,0,0,175000,0,0,0,210000,35000,175000,175000
059139,全新兆豐9A購01  ,0,0,0,0,0,0,0,0,0,175000,0,0,0,178000,3000,175000,175000
061265,富邦金凱基9B購01,0,0,0,0,0,0,0,0,0,174000,0,0,0,174000,0,174000,174000
060639,玉晶光永豐9A購05,0,0,0,0,0,0,0,0,0,174000,0,0,0,175000,1000,174000,174000
05910P,力山永豐96售02  ,0,0,0,0,0,0,0,0,0,174000,0,0,0,276000,102000,174000,174000
059343,宏達電凱基99購04,0,0,0,0,0,0,0,0,0,174000,0,0,0,231000,57000,174000,174000
060405,中租國泰9C購01  ,0,0,0,0,0,0,0,0,0,173000,0,0,0,174000,1000,173000,173000
060043,全新群益9B購02  ,0,0,0,0,0,0,0,0,0,173000,0,0,0,188000,15000,173000,173000
3530,晶相光          ,391000,240000,151000,0,0,0,0,0,0,22000,0,0,0,77000,55000,22000,173000
061068,祥碩凱基9B購01  ,0,0,0,0,0,0,0,0,0,172000,0,0,0,311000,139000,172000,172000
058731,貿聯永豐99購02  ,0,0,0,0,0,0,0,0,0,172000,0,0,0,172000,0,172000,172000
060294,嘉澤元大9A購01  ,0,0,0,0,0,0,0,0,0,171000,0,0,0,296000,125000,171000,171000
057877,神達元大99購01  ,0,0,0,0,0,0,0,0,0,171000,0,0,0,196000,25000,171000,171000
055804,祥碩永豐97購02  ,0,0,0,0,0,0,0,0,0,171000,0,0,0,794000,623000,171000,171000
059076,FBVIX元大99購04 ,0,0,0,0,0,0,0,0,0,171000,0,0,0,181000,10000,171000,171000
060553,祥碩凱基9A購01  ,0,0,0,0,0,0,0,0,0,170000,0,0,0,412000,242000,170000,170000
059926,世紀鋼國泰9B購01,0,0,0,0,0,0,0,0,0,170000,0,0,0,432000,262000,170000,170000
053671,可成統一96購03  ,0,0,0,0,0,0,0,0,0,170000,0,0,0,170000,0,170000,170000
060457,中橡元大9A購02  ,0,0,0,0,0,0,0,0,0,169000,0,0,0,261000,92000,169000,169000
060403,上銀國泰9B購01  ,0,0,0,0,0,0,0,0,0,169000,0,0,0,226000,57000,169000,169000
061125,億光永豐9A購01  ,0,0,0,0,0,0,0,0,0,169000,0,0,0,193000,24000,169000,169000
052104,英業達兆豐96購01,0,0,0,0,0,0,0,0,0,169000,0,0,0,230000,61000,169000,169000
052328,台表科中信99購01,0,0,0,0,0,0,0,0,0,169000,0,0,0,219000,50000,169000,169000
056383,上銀國泰99購01  ,0,0,0,0,0,0,0,0,0,169000,0,0,0,169000,0,169000,169000
058590,南電中信9A購02  ,0,0,0,0,0,0,0,0,0,169000,0,0,0,183000,14000,169000,169000
057832,聯發科元富02購05,0,0,0,0,0,0,0,0,0,168000,0,0,0,189000,21000,168000,168000
06534P,聯發科群益98售04,0,0,0,0,0,0,0,0,0,167000,0,0,0,200000,33000,167000,167000
060570,南亞科永豐9A購01,0,0,0,0,0,0,0,0,0,167000,0,0,0,197000,30000,167000,167000
057926,帆宣凱基98購02  ,0,0,0,0,0,0,0,0,0,167000,0,0,0,167000,0,167000,167000
053259,卜蜂群益97購01  ,0,0,0,0,0,0,0,0,0,167000,0,0,0,175000,8000,167000,167000
055196,致新元富97購01  ,0,0,0,0,0,0,0,0,0,167000,0,0,0,269000,102000,167000,167000
058604,華邦電元大99購03,0,0,0,0,0,0,0,0,0,167000,0,0,0,168000,1000,167000,167000
057727,華邦電國泰9A購01,0,0,0,0,0,0,0,0,0,166000,0,0,0,166000,0,166000,166000
047421,聯茂富邦97購01  ,0,0,0,0,0,0,0,0,0,166000,0,0,0,290000,124000,166000,166000
056535,全新凱基99購02  ,0,0,0,0,0,0,0,0,0,166000,0,0,0,166000,0,166000,166000
060623,玉晶光元大9C購01,0,0,0,0,0,0,0,0,0,165000,0,0,0,197000,32000,165000,165000
059763,華擎永豐99購03  ,0,0,0,0,0,0,0,0,0,165000,0,0,0,185000,20000,165000,165000
061134,大成鋼統一9C購01,0,0,0,0,0,0,0,0,0,165000,0,0,0,303000,138000,165000,165000
061122,敬鵬永豐9A購01  ,0,0,0,0,0,0,0,0,0,165000,0,0,0,165000,0,165000,165000
057059,易華電元大99購01,0,0,0,0,0,0,0,0,0,165000,0,0,0,165000,0,165000,165000
07629P,臺股指凱基9A售10,0,0,0,0,0,0,0,0,0,165000,0,0,0,165000,0,165000,165000
1514,亞力            ,288000,123000,165000,0,0,0,0,0,0,0,0,0,0,0,0,0,165000
060344,聯發科統一01購01,0,0,0,0,0,0,0,0,0,164000,0,0,0,210000,46000,164000,164000
056762,亞德客元大98購01,0,0,0,0,0,0,0,0,0,164000,0,0,0,204000,40000,164000,164000
060290,興富發元大9C購01,0,0,0,0,0,0,0,0,0,163000,0,0,0,163000,0,163000,163000
060194,旭富元富9A購01  ,0,0,0,0,0,0,0,0,0,163000,0,0,0,188000,25000,163000,163000
060583,南亞科元富9A購05,0,0,0,0,0,0,0,0,0,163000,0,0,0,177000,14000,163000,163000
057717,友訊元富98購02  ,0,0,0,0,0,0,0,0,0,163000,0,0,0,294000,131000,163000,163000
060753,上銀元大9A購05  ,0,0,0,0,0,0,0,0,0,162000,0,0,0,289000,127000,162000,162000
054527,國巨統一97購03  ,0,0,0,0,0,0,0,0,0,162000,0,0,0,549000,387000,162000,162000
03441B,臺股指凱基9A熊05,0,0,0,0,0,0,0,0,0,162000,0,0,0,942000,780000,162000,162000
6531,愛普            ,1779000,1570000,209000,0,0,0,0,0,0,-47000,9000,56000,-47000,0,0,0,162000
05261P,鴻海元大95售20  ,0,0,0,0,0,0,0,0,0,161000,0,0,0,161000,0,161000,161000
054744,晶相光凱基99購01,0,0,0,0,0,0,0,0,0,161000,0,0,0,161000,0,161000,161000
2362,藍天            ,278000,117000,161000,0,0,0,0,0,0,0,0,0,0,0,0,0,161000
060745,京元電國票9A購01,0,0,0,0,0,0,0,0,0,160000,0,0,0,160000,0,160000,160000
060880,中壽中信9C購01  ,0,0,0,0,0,0,0,0,0,160000,0,0,0,189000,29000,160000,160000
061041,南電永豐9A購03  ,0,0,0,0,0,0,0,0,0,160000,0,0,0,202000,42000,160000,160000
060479,億豐元大9A購01  ,0,0,0,0,0,0,0,0,0,160000,0,0,0,236000,76000,160000,160000
052918,智易富邦97購02  ,0,0,0,0,0,0,0,0,0,160000,0,0,0,160000,0,160000,160000
058478,聯發科凱基9A購01,0,0,0,0,0,0,0,0,0,160000,0,0,0,161000,1000,160000,160000
8028,昇陽半導體      ,468000,319000,149000,0,0,0,0,0,0,11000,0,0,0,14000,3000,11000,160000
060084,聯電元大99購02  ,0,0,0,0,0,0,0,0,0,159000,0,0,0,262000,103000,159000,159000
05213P,台積電國票96售05,0,0,0,0,0,0,0,0,0,159000,0,0,0,159000,0,159000,159000
059296,大立光元富99購06,0,0,0,0,0,0,0,0,0,159000,0,0,0,195000,36000,159000,159000
060355,元金2X元富9C購01,0,0,0,0,0,0,0,0,0,158000,0,0,0,196000,38000,158000,158000
051928,大立光中信96購03,0,0,0,0,0,0,0,0,0,158000,0,0,0,178000,20000,158000,158000
050955,達方群益97購01  ,0,0,0,0,0,0,0,0,0,158000,0,0,0,158000,0,158000,158000
056981,全新群益99購03  ,0,0,0,0,0,0,0,0,0,158000,0,0,0,158000,0,158000,158000
056031,勤誠康和97購02  ,0,0,0,0,0,0,0,0,0,158000,0,0,0,158000,0,158000,158000
060057,欣興凱基9B購01  ,0,0,0,0,0,0,0,0,0,157000,0,0,0,188000,31000,157000,157000
059742,富邦金元富99購01,0,0,0,0,0,0,0,0,0,157000,0,0,0,167000,10000,157000,157000
055192,世芯元富97購01  ,0,0,0,0,0,0,0,0,0,157000,0,0,0,157000,0,157000,157000
056028,GIS群益97購02   ,0,0,0,0,0,0,0,0,0,157000,0,0,0,157000,0,157000,157000
059154,可成日盛99購02  ,0,0,0,0,0,0,0,0,0,157000,0,0,0,164000,7000,157000,157000
059175,臺股指凱基99購26,0,0,0,0,0,0,0,0,0,157000,0,0,0,177000,20000,157000,157000
058267,奇鋐永豐99購01  ,0,0,0,0,0,0,0,0,0,157000,0,0,0,177000,20000,157000,157000
07731P,臺股指凱基9A售28,0,0,0,0,0,0,0,0,0,157000,0,0,0,231000,74000,157000,157000
060431,復盛永豐9A購01  ,0,0,0,0,0,0,0,0,0,156000,0,0,0,224000,68000,156000,156000
058532,禾伸堂元富99購01,0,0,0,0,0,0,0,0,0,156000,0,0,0,397000,241000,156000,156000
057993,中環中信98購01  ,0,0,0,0,0,0,0,0,0,156000,0,0,0,156000,0,156000,156000
057509,聯發科統一9A購03,0,0,0,0,0,0,0,0,0,156000,0,0,0,166000,10000,156000,156000
060814,健策凱基9B購01  ,0,0,0,0,0,0,0,0,0,155000,0,0,0,155000,0,155000,155000
054158,國巨日盛99購01  ,0,0,0,0,0,0,0,0,0,155000,0,0,0,307000,152000,155000,155000
00739,元大MSCI A股    ,108000,0,108000,0,0,0,0,0,0,47000,0,0,0,431000,384000,47000,155000
061159,同欣電群益9A購01,0,0,0,0,0,0,0,0,0,154000,0,0,0,789000,635000,154000,154000
054426,國泰金富邦97購02,0,0,0,0,0,0,0,0,0,154000,0,0,0,154000,0,154000,154000
057941,聯電國票99購01  ,0,0,0,0,0,0,0,0,0,154000,0,0,0,236000,82000,154000,154000
060809,康友群益9A購01  ,0,0,0,0,0,0,0,0,0,153000,0,0,0,253000,100000,153000,153000
060298,鎧勝元大9C購01  ,0,0,0,0,0,0,0,0,0,153000,0,0,0,203000,50000,153000,153000
054938,國巨元大97購04  ,0,0,0,0,0,0,0,0,0,153000,0,0,0,153000,0,153000,153000
056492,全新國泰9A購01  ,0,0,0,0,0,0,0,0,0,153000,0,0,0,168000,15000,153000,153000
059919,宏達電元大99購06,0,0,0,0,0,0,0,0,0,152000,0,0,0,215000,63000,152000,152000
061028,聚陽永豐9A購01  ,0,0,0,0,0,0,0,0,0,152000,0,0,0,263000,111000,152000,152000
060926,宏達電永豐9A購01,0,0,0,0,0,0,0,0,0,152000,0,0,0,152000,0,152000,152000
053094,聯電統一97購02  ,0,0,0,0,0,0,0,0,0,152000,0,0,0,156000,4000,152000,152000
054240,訊芯群益96購03  ,0,0,0,0,0,0,0,0,0,152000,0,0,0,228000,76000,152000,152000
056058,建準元大97購02  ,0,0,0,0,0,0,0,0,0,152000,0,0,0,152000,0,152000,152000
055301,台虹元大97購01  ,0,0,0,0,0,0,0,0,0,152000,0,0,0,197000,45000,152000,152000
056287,亞光永豐97購02  ,0,0,0,0,0,0,0,0,0,152000,0,0,0,152000,0,152000,152000
05626P,景碩國票97售03  ,0,0,0,0,0,0,0,0,0,152000,0,0,0,253000,101000,152000,152000
060473,中租元大9A購03  ,0,0,0,0,0,0,0,0,0,151000,0,0,0,229000,78000,151000,151000
053488,中石化兆豐97購01,0,0,0,0,0,0,0,0,0,151000,0,0,0,153000,2000,151000,151000
053773,上銀元大96購04  ,0,0,0,0,0,0,0,0,0,151000,0,0,0,151000,0,151000,151000
057062,立積國泰99購01  ,0,0,0,0,0,0,0,0,0,151000,0,0,0,161000,10000,151000,151000
060364,奇力新元富9A購01,0,0,0,0,0,0,0,0,0,150000,0,0,0,300000,150000,150000,150000
060986,聯發科元大9A購07,0,0,0,0,0,0,0,0,0,150000,0,0,0,749000,599000,150000,150000
061279,鴻海統一9C購04  ,0,0,0,0,0,0,0,0,0,150000,0,0,0,189000,39000,150000,150000
054011,旺宏永豐96購05  ,0,0,0,0,0,0,0,0,0,150000,0,0,0,150000,0,150000,150000
053984,康友元大96購05  ,0,0,0,0,0,0,0,0,0,150000,0,0,0,150000,0,150000,150000
048847,A50群益98購01   ,0,0,0,0,0,0,0,0,0,150000,0,0,0,150000,0,150000,150000
05419P,矽力永豐95售02  ,0,0,0,0,0,0,0,0,0,150000,0,0,0,150000,0,150000,150000
057956,全新元大99購04  ,0,0,0,0,0,0,0,0,0,150000,0,0,0,154000,4000,150000,150000
057638,上銀元大99購01  ,0,0,0,0,0,0,0,0,0,150000,0,0,0,150000,0,150000,150000
056232,瑞儀凱基98購01  ,0,0,0,0,0,0,0,0,0,150000,0,0,0,150000,0,150000,150000
056280,上証2X永豐98購01,0,0,0,0,0,0,0,0,0,150000,0,0,0,150000,0,150000,150000
057187,群創元大9B購04  ,0,0,0,0,0,0,0,0,0,150000,0,0,0,150000,0,150000,150000
057276,全新元大99購03  ,0,0,0,0,0,0,0,0,0,150000,0,0,0,170000,20000,150000,150000
057445,華通元富02購01  ,0,0,0,0,0,0,0,0,0,150000,0,0,0,150000,0,150000,150000
059185,臺股指台新99購12,0,0,0,0,0,0,0,0,0,150000,0,0,0,150000,0,150000,150000
061106,群創元大9B購09  ,0,0,0,0,0,0,0,0,0,149000,0,0,0,302000,153000,149000,149000
060201,台表科元富9A購01,0,0,0,0,0,0,0,0,0,149000,0,0,0,244000,95000,149000,149000
056622,高鐵永豐98購01  ,0,0,0,0,0,0,0,0,0,149000,0,0,0,149000,0,149000,149000
056319,智原群益98購02  ,0,0,0,0,0,0,0,0,0,149000,0,0,0,154000,5000,149000,149000
2002,中鋼            ,4928943,4713097,215846,0,0,0,16000,0,16000,-83000,0,5000,-5000,12000,90000,-78000,148846
060547,瑞昱凱基9A購01  ,0,0,0,0,0,0,0,0,0,148000,0,0,0,376000,228000,148000,148000
056088,台郡統一97購02  ,0,0,0,0,0,0,0,0,0,148000,0,0,0,246000,98000,148000,148000
056894,佳世達元大99購01,0,0,0,0,0,0,0,0,0,148000,0,0,0,420000,272000,148000,148000
2897,王道銀行        ,149000,1000,148000,0,0,0,0,0,0,0,0,0,0,0,0,0,148000
00636,國泰中國A50     ,899000,2000,897000,0,0,0,0,0,0,-749149,0,0,0,1331000,2080149,-749149,147851
061090,奇力新統一9C購01,0,0,0,0,0,0,0,0,0,147000,0,0,0,209000,62000,147000,147000
051463,世芯國泰97購02  ,0,0,0,0,0,0,0,0,0,147000,0,0,0,195000,48000,147000,147000
054050,創意元大96購06  ,0,0,0,0,0,0,0,0,0,147000,0,0,0,147000,0,147000,147000
056984,嘉晶群益98購01  ,0,0,0,0,0,0,0,0,0,147000,0,0,0,203000,56000,147000,147000
056673,中石化元富9B購01,0,0,0,0,0,0,0,0,0,147000,0,0,0,308000,161000,147000,147000
058055,華擎統一9A購01  ,0,0,0,0,0,0,0,0,0,147000,0,0,0,208000,61000,147000,147000
058375,群創凱基9B購04  ,0,0,0,0,0,0,0,0,0,147000,0,0,0,175000,28000,147000,147000
060111,臻鼎元大99購04  ,0,0,0,0,0,0,0,0,0,146000,0,0,0,150000,4000,146000,146000
057789,上銀統一9A購01  ,0,0,0,0,0,0,0,0,0,146000,0,0,0,146000,0,146000,146000
1417,嘉裕            ,155000,9000,146000,0,0,0,0,0,0,0,0,0,0,0,0,0,146000
07394P,國巨群益99售12  ,0,0,0,0,0,0,0,0,0,146000,0,0,0,162000,16000,146000,146000
060297,和碩元大9A購02  ,0,0,0,0,0,0,0,0,0,145000,0,0,0,145000,0,145000,145000
060413,東元永豐9A購01  ,0,0,0,0,0,0,0,0,0,145000,0,0,0,145000,0,145000,145000
059519,台郡永豐99購01  ,0,0,0,0,0,0,0,0,0,145000,0,0,0,175000,30000,145000,145000
054556,世芯凱基99購01  ,0,0,0,0,0,0,0,0,0,145000,0,0,0,145000,0,145000,145000
058148,百和元大99購01  ,0,0,0,0,0,0,0,0,0,145000,0,0,0,499000,354000,145000,145000
057017,和大凱基98購01  ,0,0,0,0,0,0,0,0,0,145000,0,0,0,165000,20000,145000,145000
057285,群創元大98購07  ,0,0,0,0,0,0,0,0,0,145000,0,0,0,150000,5000,145000,145000
059278,群創元大9A購04  ,0,0,0,0,0,0,0,0,0,145000,0,0,0,162000,17000,145000,145000
07468P,聯電元大9A售02  ,0,0,0,0,0,0,0,0,0,145000,0,0,0,327000,182000,145000,145000
2313,華通            ,3419000,4105000,-686000,0,0,0,3000,0,3000,828000,1246000,466000,780000,181000,133000,48000,145000
059806,聯發科元富99購08,0,0,0,0,0,0,0,0,0,144000,0,0,0,144000,0,144000,144000
05994P,奇鋐元大96售02  ,0,0,0,0,0,0,0,0,0,144000,0,0,0,241000,97000,144000,144000
060419,漢翔永豐9A購01  ,0,0,0,0,0,0,0,0,0,144000,0,0,0,144000,0,144000,144000
06859P,元金2X中信9C售01,0,0,0,0,0,0,0,0,0,144000,0,0,0,211000,67000,144000,144000
052084,台泥元大95購01  ,0,0,0,0,0,0,0,0,0,144000,0,0,0,144000,0,144000,144000
059283,康友永豐99購02  ,0,0,0,0,0,0,0,0,0,144000,0,0,0,233000,89000,144000,144000
061008,群創兆豐9A購02  ,0,0,0,0,0,0,0,0,0,143000,0,0,0,322000,179000,143000,143000
056791,嘉聯益群益98購01,0,0,0,0,0,0,0,0,0,143000,0,0,0,162000,19000,143000,143000
060916,金像電國泰9C購01,0,0,0,0,0,0,0,0,0,142000,0,0,0,298000,156000,142000,142000
06595P,祥碩元大98售03  ,0,0,0,0,0,0,0,0,0,142000,0,0,0,150000,8000,142000,142000
060502,國巨元大9A購07  ,0,0,0,0,0,0,0,0,0,142000,0,0,0,168000,26000,142000,142000
053057,聯電國泰97購02  ,0,0,0,0,0,0,0,0,0,142000,0,0,0,404000,262000,142000,142000
056971,麗豐永豐98購01  ,0,0,0,0,0,0,0,0,0,142000,0,0,0,162000,20000,142000,142000
059938,凱美永豐99購01  ,0,0,0,0,0,0,0,0,0,141000,0,0,0,141000,0,141000,141000
057875,京鼎元大98購03  ,0,0,0,0,0,0,0,0,0,141000,0,0,0,224000,83000,141000,141000
054710,東元元富97購01  ,0,0,0,0,0,0,0,0,0,141000,0,0,0,397000,256000,141000,141000
053584,友達元大9B購02  ,0,0,0,0,0,0,0,0,0,141000,0,0,0,176000,35000,141000,141000
053595,創意元大96購02  ,0,0,0,0,0,0,0,0,0,141000,0,0,0,151000,10000,141000,141000
059075,FBVIX元大99購01 ,0,0,0,0,0,0,0,0,0,141000,0,0,0,160000,19000,141000,141000
058282,聯茂中信99購01  ,0,0,0,0,0,0,0,0,0,141000,0,0,0,306000,165000,141000,141000
060629,鴻海富邦9B購01  ,0,0,0,0,0,0,0,0,0,140000,0,0,0,157000,17000,140000,140000
060391,華擎群益9C購01  ,0,0,0,0,0,0,0,0,0,140000,0,0,0,140000,0,140000,140000
060992,健策元大9A購05  ,0,0,0,0,0,0,0,0,0,140000,0,0,0,202000,62000,140000,140000
06072P,牧德永豐97售01  ,0,0,0,0,0,0,0,0,0,140000,0,0,0,275000,135000,140000,140000
061320,奇力新凱基9A購04,0,0,0,0,0,0,0,0,0,140000,0,0,0,165000,25000,140000,140000
052853,友達日盛99購01  ,0,0,0,0,0,0,0,0,0,140000,0,0,0,144000,4000,140000,140000
052085,聯電元大95購01  ,0,0,0,0,0,0,0,0,0,140000,0,0,0,370000,230000,140000,140000
2441,超豐            ,255000,115000,140000,0,0,0,0,0,0,0,0,0,0,0,0,0,140000
07489P,國巨國票9A售07  ,0,0,0,0,0,0,0,0,0,140000,0,0,0,180000,40000,140000,140000
1712,興農            ,196000,56000,140000,0,0,0,0,0,0,0,0,0,0,0,0,0,140000
060937,T50反1國票9A購10,125000,0,125000,0,0,0,0,0,0,14000,0,0,0,210000,196000,14000,139000
055173,瑞昱統一97購01  ,0,0,0,0,0,0,0,0,0,139000,0,0,0,139000,0,139000,139000
056657,華邦電元大99購01,0,0,0,0,0,0,0,0,0,139000,0,0,0,272000,133000,139000,139000
1201,味全            ,303000,158000,145000,0,0,0,0,0,0,-6000,0,0,0,0,6000,-6000,139000
2467,志聖            ,230000,91000,139000,0,0,0,0,0,0,0,0,0,0,0,0,0,139000
060960,金像電凱基9B購01,0,0,0,0,0,0,0,0,0,138000,0,0,0,270000,132000,138000,138000
061070,超眾凱基9C購01  ,0,0,0,0,0,0,0,0,0,138000,0,0,0,140000,2000,138000,138000
06641P,智邦兆豐99售01  ,0,0,0,0,0,0,0,0,0,138000,0,0,0,140000,2000,138000,138000
060133,牧德群益9B購01  ,0,0,0,0,0,0,0,0,0,138000,0,0,0,151000,13000,138000,138000
056021,興富發群益97購01,0,0,0,0,0,0,0,0,0,138000,0,0,0,158000,20000,138000,138000
058324,嘉聯益永豐9A購01,0,0,0,0,0,0,0,0,0,138000,0,0,0,138000,0,138000,138000
058720,旭富元富99購01  ,0,0,0,0,0,0,0,0,0,138000,0,0,0,175000,37000,138000,138000
055806,致新永豐97購02  ,0,0,0,0,0,0,0,0,0,138000,0,0,0,138000,0,138000,138000
06172P,台虹永豐97售02  ,0,0,0,0,0,0,0,0,0,137000,0,0,0,137000,0,137000,137000
061052,和大群益9A購01  ,0,0,0,0,0,0,0,0,0,137000,0,0,0,237000,100000,137000,137000
042929,台積電中信95購02,0,0,0,0,0,0,0,0,0,137000,0,0,0,140000,3000,137000,137000
058118,瑞昱群益99購01  ,0,0,0,0,0,0,0,0,0,137000,0,0,0,186000,49000,137000,137000
4536,拓凱            ,223000,44000,179000,0,0,0,100000,200000,-100000,58000,60000,0,60000,0,2000,-2000,137000
060283,台肥元大9C購01  ,0,0,0,0,0,0,0,0,0,136000,0,0,0,136000,0,136000,136000
054384,瀚宇博群益96購02,0,0,0,0,0,0,0,0,0,136000,0,0,0,146000,10000,136000,136000
058180,華新科國泰9A購01,0,0,0,0,0,0,0,0,0,136000,0,0,0,386000,250000,136000,136000
059114,華新科永豐99購05,0,0,0,0,0,0,0,0,0,136000,0,0,0,136000,0,136000,136000
5471,松翰            ,450000,314000,136000,0,0,0,0,0,0,0,25000,25000,0,0,0,0,136000
060134,鈺齊群益9A購01  ,0,0,0,0,0,0,0,0,0,135000,0,0,0,414000,279000,135000,135000
059928,道瓊銀富邦03購01,0,0,0,0,0,0,0,0,0,135000,0,0,0,170000,35000,135000,135000
061334,華通元大9A購09  ,0,0,0,0,0,0,0,0,0,135000,0,0,0,151000,16000,135000,135000
05624P,同欣電中信98售01,0,0,0,0,0,0,0,0,0,135000,0,0,0,135000,0,135000,135000
055980,祥碩統一98購01  ,0,0,0,0,0,0,0,0,0,135000,0,0,0,140000,5000,135000,135000
07256P,臺股指凱基99售36,0,0,0,0,0,0,0,0,0,135000,0,0,0,160000,25000,135000,135000
059755,宏達電國泰9A購01,0,0,0,0,0,0,0,0,0,134000,0,0,0,292000,158000,134000,134000
058312,大毅國泰9B購01  ,0,0,0,0,0,0,0,0,0,134000,0,0,0,244000,110000,134000,134000
058965,祥碩兆豐99購02  ,0,0,0,0,0,0,0,0,0,134000,0,0,0,202000,68000,134000,134000
059461,鈺齊永豐99購03  ,0,0,0,0,0,0,0,0,0,133000,0,0,0,260000,127000,133000,133000
060781,台郡國泰9B購01  ,0,0,0,0,0,0,0,0,0,133000,0,0,0,186000,53000,133000,133000
3596,智易            ,449000,321000,128000,0,0,0,0,3000,-3000,8000,2000,2000,0,20000,12000,8000,133000
059396,T50反1元富99購04,130000,0,130000,0,0,0,0,0,0,2000,0,0,0,139000,137000,2000,132000
060241,國泰金元大9A購01,0,0,0,0,0,0,0,0,0,132000,0,0,0,156000,24000,132000,132000
055844,大毅元大98購01  ,0,0,0,0,0,0,0,0,0,132000,0,0,0,135000,3000,132000,132000
060301,國巨富邦9C購02  ,0,0,0,0,0,0,0,0,0,131000,0,0,0,143000,12000,131000,131000
060540,南亞凱基9A購01  ,0,0,0,0,0,0,0,0,0,131000,0,0,0,244000,113000,131000,131000
053973,晶豪科元大96購01,0,0,0,0,0,0,0,0,0,131000,0,0,0,230000,99000,131000,131000
055421,玉晶光永豐98購04,0,0,0,0,0,0,0,0,0,131000,0,0,0,131000,0,131000,131000
056304,創意元大97購03  ,0,0,0,0,0,0,0,0,0,131000,0,0,0,131000,0,131000,131000
058215,貿聯群益99購02  ,0,0,0,0,0,0,0,0,0,131000,0,0,0,131000,0,131000,131000
057325,可成群益9A購01  ,0,0,0,0,0,0,0,0,0,131000,0,0,0,139000,8000,131000,131000
3588,通嘉            ,150000,19000,131000,0,0,0,0,0,0,0,0,0,0,0,0,0,131000
060085,華通元大99購10  ,0,0,0,0,0,0,0,0,0,130000,0,0,0,130000,0,130000,130000
052611,力成元大96購02  ,0,0,0,0,0,0,0,0,0,130000,0,0,0,188000,58000,130000,130000
051609,貿聯群益95購03  ,0,0,0,0,0,0,0,0,0,130000,0,0,0,130000,0,130000,130000
052006,康友富邦98購01  ,0,0,0,0,0,0,0,0,0,130000,0,0,0,130000,0,130000,130000
054070,創意國泰96購02  ,0,0,0,0,0,0,0,0,0,130000,0,0,0,130000,0,130000,130000
054506,矽格永豐96購01  ,0,0,0,0,0,0,0,0,0,130000,0,0,0,130000,0,130000,130000
057781,國巨國票99購04  ,0,0,0,0,0,0,0,0,0,130000,0,0,0,130000,0,130000,130000
053660,群創凱基98購08  ,0,0,0,0,0,0,0,0,0,130000,0,0,0,130000,0,130000,130000
053465,聯電元大96購05  ,0,0,0,0,0,0,0,0,0,130000,0,0,0,130000,0,130000,130000
057316,國巨凱基99購04  ,0,0,0,0,0,0,0,0,0,130000,0,0,0,140000,10000,130000,130000
058570,臻鼎凱基9A購01  ,0,0,0,0,0,0,0,0,0,130000,0,0,0,130000,0,130000,130000
07557P,玉晶光元大9A售09,0,0,0,0,0,0,0,0,0,130000,0,0,0,160000,30000,130000,130000
07703P,玉晶光中信9B售03,0,0,0,0,0,0,0,0,0,130000,0,0,0,130000,0,130000,130000
060333,金寶康和9A購01  ,0,0,0,0,0,0,0,0,0,129000,0,0,0,159000,30000,129000,129000
060856,健策富邦9B購02  ,0,0,0,0,0,0,0,0,0,129000,0,0,0,361000,232000,129000,129000
056203,興富發永豐97購01,0,0,0,0,0,0,0,0,0,129000,0,0,0,129000,0,129000,129000
056435,台積電凱基98購09,0,0,0,0,0,0,0,0,0,129000,0,0,0,144000,15000,129000,129000
059023,可成統一9B購02  ,0,0,0,0,0,0,0,0,0,129000,0,0,0,311000,182000,129000,129000
07252P,台灣50凱基99售01,0,0,0,0,0,0,0,0,0,129000,0,0,0,132000,3000,129000,129000
061006,新光金兆豐9A購01,0,0,0,0,0,0,0,0,0,128000,0,0,0,154000,26000,128000,128000
060323,華通群益9C購01  ,0,0,0,0,0,0,0,0,0,128000,0,0,0,471000,343000,128000,128000
059848,智邦永豐99購01  ,0,0,0,0,0,0,0,0,0,128000,0,0,0,294000,166000,128000,128000
057662,上銀元大9A購01  ,0,0,0,0,0,0,0,0,0,128000,0,0,0,178000,50000,128000,128000
057613,瑞昱元富02購02  ,0,0,0,0,0,0,0,0,0,128000,0,0,0,223000,95000,128000,128000
057831,聯發科元富02購04,0,0,0,0,0,0,0,0,0,128000,0,0,0,129000,1000,128000,128000
055527,旺宏群益99購03  ,0,0,0,0,0,0,0,0,0,128000,0,0,0,130000,2000,128000,128000
056953,智邦富邦98購02  ,0,0,0,0,0,0,0,0,0,128000,0,0,0,128000,0,128000,128000
1598,岱宇            ,257000,129000,128000,0,0,0,0,0,0,0,0,0,0,0,0,0,128000
060407,南六國泰9C購01  ,0,0,0,0,0,0,0,0,0,127000,0,0,0,127000,0,127000,127000
050047,奇鋐國票95購01  ,0,0,0,0,0,0,0,0,0,127000,0,0,0,127000,0,127000,127000
058129,國巨元大99購10  ,0,0,0,0,0,0,0,0,0,127000,0,0,0,327000,200000,127000,127000
057833,聯發科元富02購06,0,0,0,0,0,0,0,0,0,126000,0,0,0,132000,6000,126000,126000
055983,全新元富9A購02  ,0,0,0,0,0,0,0,0,0,126000,0,0,0,126000,0,126000,126000
07341P,台積電凱基99售18,0,0,0,0,0,0,0,0,0,126000,0,0,0,126000,0,126000,126000
054523,GIS元大96購05   ,0,0,0,0,0,0,0,0,0,125000,0,0,0,125000,0,125000,125000
053165,大立光群益96購03,0,0,0,0,0,0,0,0,0,125000,0,0,0,425000,300000,125000,125000
9921,巨大            ,1290000,1943000,-653000,0,0,0,764000,0,764000,14000,18000,1000,17000,25000,28000,-3000,125000
052796,和碩兆豐96購01  ,0,0,0,0,0,0,0,0,0,124000,0,0,0,134000,10000,124000,124000
058445,旺宏富邦9C購01  ,0,0,0,0,0,0,0,0,0,124000,0,0,0,124000,0,124000,124000
3533,嘉澤            ,342000,202968,139032,0,0,0,40000,87000,-47000,31000,48000,17000,31000,9000,9000,0,123032
05971P,世紀鋼永豐96售04,0,0,0,0,0,0,0,0,0,123000,0,0,0,148000,25000,123000,123000
053127,貿聯凱基97購01  ,0,0,0,0,0,0,0,0,0,123000,0,0,0,123000,0,123000,123000
054255,亞光元大96購05  ,0,0,0,0,0,0,0,0,0,123000,0,0,0,123000,0,123000,123000
00656R,國泰中國A50反1  ,87000,70000,17000,0,0,0,0,0,0,106000,0,0,0,139000,33000,106000,123000
01003T,兆豐新光R1      ,156000,33000,123000,0,0,0,0,0,0,0,0,0,0,0,0,0,123000
056583,昇陽半元大98購02,0,0,0,0,0,0,0,0,0,123000,0,0,0,225000,102000,123000,123000
059015,華通元富99購02  ,0,0,0,0,0,0,0,0,0,123000,0,0,0,128000,5000,123000,123000
057567,嘉聯益富邦9A購01,0,0,0,0,0,0,0,0,0,123000,0,0,0,287000,164000,123000,123000
057511,健策統一98購02  ,0,0,0,0,0,0,0,0,0,123000,0,0,0,157000,34000,123000,123000
059996,美律元富99購01  ,0,0,0,0,0,0,0,0,0,122000,0,0,0,252000,130000,122000,122000
060879,華新科中信9A購02,0,0,0,0,0,0,0,0,0,122000,0,0,0,122000,0,122000,122000
052374,瑞昱元大95購02  ,0,0,0,0,0,0,0,0,0,122000,0,0,0,122000,0,122000,122000
05289P,鴻海永豐95售05  ,0,0,0,0,0,0,0,0,0,122000,0,0,0,122000,0,122000,122000
054349,同欣電國票97購02,0,0,0,0,0,0,0,0,0,122000,0,0,0,168000,46000,122000,122000
055193,世芯元富97購02  ,0,0,0,0,0,0,0,0,0,122000,0,0,0,133000,11000,122000,122000
054662,同欣電元大97購02,0,0,0,0,0,0,0,0,0,122000,0,0,0,194000,72000,122000,122000
056129,義隆麥證97購01  ,0,0,0,304000,182000,122000,0,0,0,122000,0,0,0,304000,182000,122000,122000
060737,瑞儀統一9C購01  ,0,0,0,0,0,0,0,0,0,121000,0,0,0,156000,35000,121000,121000
052946,智原國票97購02  ,0,0,0,0,0,0,0,0,0,121000,0,0,0,122000,1000,121000,121000
057738,旺宏富邦9A購01  ,0,0,0,0,0,0,0,0,0,121000,0,0,0,131000,10000,121000,121000
057286,群創元大9B購05  ,0,0,0,0,0,0,0,0,0,121000,0,0,0,122000,1000,121000,121000
056898,全新元大98購02  ,0,0,0,0,0,0,0,0,0,121000,0,0,0,121000,0,121000,121000
060899,超眾凱基9A購01  ,0,0,0,0,0,0,0,0,0,120000,0,0,0,120000,0,120000,120000
060117,國巨國泰9B購04  ,0,0,0,0,0,0,0,0,0,120000,0,0,0,120000,0,120000,120000
054690,新興永豐97購01  ,0,0,0,0,0,0,0,0,0,120000,0,0,0,120000,0,120000,120000
052694,開發金中信98購01,0,0,0,0,0,0,0,0,0,120000,0,0,0,120000,0,120000,120000
053431,志超永豐96購01  ,0,0,0,0,0,0,0,0,0,120000,0,0,0,120000,0,120000,120000
050584,瑞儀國票95購01  ,0,0,0,0,0,0,0,0,0,120000,0,0,0,120000,0,120000,120000
054015,晶豪科永豐96購03,0,0,0,0,0,0,0,0,0,120000,0,0,0,130000,10000,120000,120000
04346P,大立光兆豐95售02,0,0,0,0,0,0,0,0,0,120000,0,0,0,120000,0,120000,120000
056933,國巨元富98購03  ,0,0,0,0,0,0,0,0,0,120000,0,0,0,270000,150000,120000,120000
058467,日月光中信9A購01,0,0,0,0,0,0,0,0,0,120000,0,0,0,120000,0,120000,120000
058175,旺宏凱基99購03  ,0,0,0,0,0,0,0,0,0,120000,0,0,0,120000,0,120000,120000
061209,聯發科元大9A購10,0,0,0,0,0,0,0,0,0,119000,0,0,0,149000,30000,119000,119000
06652P,長榮航元大98售01,0,0,0,0,0,0,0,0,0,119000,0,0,0,159000,40000,119000,119000
054747,麗豐凱基98購01  ,0,0,0,0,0,0,0,0,0,119000,0,0,0,119000,0,119000,119000
055197,致新元富97購02  ,0,0,0,0,0,0,0,0,0,119000,0,0,0,127000,8000,119000,119000
2359,所羅門          ,155000,36000,119000,0,0,0,0,0,0,0,0,0,0,0,0,0,119000
060756,鴻海元大9A購16  ,0,0,0,0,0,0,0,0,0,118000,0,0,0,118000,0,118000,118000
060458,華通元大9A購02  ,0,0,0,0,0,0,0,0,0,118000,0,0,0,172000,54000,118000,118000
050998,訊連元大95購01  ,0,0,0,0,0,0,0,0,0,118000,0,0,0,118000,0,118000,118000
055592,奇力新元大97購07,0,0,0,0,0,0,0,0,0,118000,0,0,0,118000,0,118000,118000
056818,正崴永豐98購01  ,0,0,0,0,0,0,0,0,0,118000,0,0,0,144000,26000,118000,118000
056621,宏達電永豐98購01,0,0,0,0,0,0,0,0,0,118000,0,0,0,118000,0,118000,118000
060350,元黃金元富9B購01,0,0,0,0,0,0,0,0,0,117000,0,0,0,117000,0,117000,117000
060874,中鋼中信02購01  ,0,0,0,0,0,0,0,0,0,117000,0,0,0,123000,6000,117000,117000
057174,南亞科元大98購05,0,0,0,0,0,0,0,0,0,117000,0,0,0,150000,33000,117000,117000
057328,京鼎群益99購02  ,0,0,0,0,0,0,0,0,0,117000,0,0,0,298000,181000,117000,117000
056267,文曄統一97購02  ,0,0,0,0,0,0,0,0,0,117000,0,0,0,160000,43000,117000,117000
055295,瀚宇博元大97購02,0,0,0,0,0,0,0,0,0,117000,0,0,0,117000,0,117000,117000
07539P,玉山金台新9A售01,0,0,0,0,0,0,0,0,0,117000,0,0,0,146000,29000,117000,117000
1338,廣華-KY         ,170000,53000,117000,0,0,0,0,0,0,0,0,0,0,0,0,0,117000
051845,世紀鋼富邦96購01,0,0,0,0,0,0,0,0,0,116000,0,0,0,116000,0,116000,116000
055565,祥碩凱基97購01  ,0,0,0,0,0,0,0,0,0,116000,0,0,0,136000,20000,116000,116000
055814,晶豪科國票97購02,0,0,0,0,0,0,0,0,0,116000,0,0,0,257000,141000,116000,116000
060306,台肥永豐9A購01  ,0,0,0,0,0,0,0,0,0,115000,0,0,0,115000,0,115000,115000
060061,旺宏兆豐99購02  ,0,0,0,0,0,0,0,0,0,115000,0,0,0,115000,0,115000,115000
00678,群益NBI生技     ,21000,0,21000,0,0,0,0,0,0,94000,20000,0,20000,376000,302000,74000,115000
053392,致新元大96購01  ,0,0,0,0,0,0,0,0,0,115000,0,0,0,135000,20000,115000,115000
058569,健策凱基9A購01  ,0,0,0,0,0,0,0,0,0,115000,0,0,0,163000,48000,115000,115000
058250,台虹元大99購01  ,0,0,0,0,0,0,0,0,0,115000,0,0,0,224000,109000,115000,115000
056684,旺宏統一98購02  ,0,0,0,0,0,0,0,0,0,115000,0,0,0,115000,0,115000,115000
07189P,聯發科富邦9B售03,0,0,0,0,0,0,0,0,0,115000,0,0,0,153000,38000,115000,115000
6415,矽力-KY         ,427000,332000,95000,0,0,0,40000,29000,11000,9000,0,0,0,9000,0,9000,115000
059951,台塑康和99購01  ,0,0,0,0,0,0,0,0,0,114000,0,0,0,187000,73000,114000,114000
060189,宏達電元富9B購03,0,0,0,0,0,0,0,0,0,114000,0,0,0,135000,21000,114000,114000
054709,宏達電統一97購01,0,0,0,0,0,0,0,0,0,114000,0,0,0,114000,0,114000,114000
053029,國巨第一96購01  ,0,0,0,0,0,0,0,0,0,114000,0,0,0,114000,0,114000,114000
053889,致茂群益97購01  ,0,0,0,0,0,0,0,0,0,114000,0,0,0,271000,157000,114000,114000
059160,華通凱基99購03  ,0,0,0,0,0,0,0,0,0,114000,0,0,0,125000,11000,114000,114000
058008,禾伸堂國票99購02,0,0,0,0,0,0,0,0,0,114000,0,0,0,123000,9000,114000,114000
058795,可成元大99購03  ,0,0,0,0,0,0,0,0,0,114000,0,0,0,114000,0,114000,114000
060929,健策永豐9A購01  ,0,0,0,0,0,0,0,0,0,113000,0,0,0,113000,0,113000,113000
052859,國巨凱基96購07  ,0,0,0,0,0,0,0,0,0,113000,0,0,0,333000,220000,113000,113000
057601,中磊群益98購01  ,0,0,0,0,0,0,0,0,0,113000,0,0,0,113000,0,113000,113000
056326,TPK兆豐98購01   ,0,0,0,0,0,0,0,0,0,113000,0,0,0,173000,60000,113000,113000
057111,立積群益98購02  ,0,0,0,0,0,0,0,0,0,113000,0,0,0,145000,32000,113000,113000
056580,泰鼎元大9A購01  ,0,0,0,0,0,0,0,0,0,113000,0,0,0,113000,0,113000,113000
6582,申豐            ,184000,62000,122000,0,0,0,0,0,0,-9000,5000,14000,-9000,0,0,0,113000
9907,統一實          ,434000,321000,113000,0,0,0,0,0,0,0,0,0,0,0,0,0,113000
2537,聯上發          ,268000,155000,113000,0,0,0,0,0,0,0,0,0,0,0,0,0,113000
061319,聯發科凱基9A購16,0,0,0,0,0,0,0,0,0,112000,0,0,0,129000,17000,112000,112000
060451,中石化元大9C購02,0,0,0,0,0,0,0,0,0,112000,0,0,0,122000,10000,112000,112000
060708,康友富邦9B購01  ,0,0,0,0,0,0,0,0,0,112000,0,0,0,122000,10000,112000,112000
056000,佳世達永豐97購01,0,0,0,0,0,0,0,0,0,112000,0,0,0,123000,11000,112000,112000
6277,宏正            ,141000,29000,112000,0,0,0,0,0,0,0,0,0,0,0,0,0,112000
060159,健和興永豐9A購01,0,0,0,0,0,0,0,0,0,111000,0,0,0,121000,10000,111000,111000
057257,台泥兆豐99購01  ,0,0,0,0,0,0,0,0,0,111000,0,0,0,120000,9000,111000,111000
055762,智伸科群益97購01,0,0,0,0,0,0,0,0,0,111000,0,0,0,201000,90000,111000,111000
2031,新光鋼          ,162000,51000,111000,0,0,0,0,0,0,0,0,0,0,0,0,0,111000
060356,上銀元富9A購01  ,0,0,0,0,0,0,0,0,0,110000,0,0,0,128000,18000,110000,110000
060682,牧德元大9A購03  ,0,0,0,0,0,0,0,0,0,110000,0,0,0,169000,59000,110000,110000
060008,華邦電群益9A購01,0,0,0,0,0,0,0,0,0,110000,0,0,0,443000,333000,110000,110000
059624,鴻海凱基01購01  ,0,0,0,0,0,0,0,0,0,110000,0,0,0,110000,0,110000,110000
061103,聯發科元大9A購08,0,0,0,0,0,0,0,0,0,110000,0,0,0,413000,303000,110000,110000
058123,亞光國票9A購01  ,0,0,0,0,0,0,0,0,0,110000,0,0,0,110000,0,110000,110000
054221,華新科統一96購05,0,0,0,0,0,0,0,0,0,110000,0,0,0,240000,130000,110000,110000
054873,帆宣群益99購01  ,0,0,0,0,0,0,0,0,0,110000,0,0,0,120000,10000,110000,110000
053527,創意中信97購01  ,0,0,0,0,0,0,0,0,0,110000,0,0,0,110000,0,110000,110000
055065,神達永豐97購01  ,0,0,0,0,0,0,0,0,0,110000,0,0,0,110000,0,110000,110000
052665,緯穎國票96購03  ,0,0,0,0,0,0,0,0,0,110000,0,0,0,110000,0,110000,110000
046020,滬深2X元大95購02,0,0,0,0,0,0,0,0,0,110000,0,0,0,110000,0,110000,110000
057066,緯穎富邦99購01  ,0,0,0,0,0,0,0,0,0,110000,0,0,0,110000,0,110000,110000
057074,立積永豐98購01  ,0,0,0,0,0,0,0,0,0,110000,0,0,0,342000,232000,110000,110000
058892,元油2X元大9C購08,0,0,0,0,0,0,0,0,0,110000,0,0,0,130000,20000,110000,110000
058882,晶相光永豐99購01,0,80000,-80000,0,0,0,0,0,0,190000,0,0,0,190000,0,190000,110000
060911,大毅元大9A購01  ,0,0,0,0,0,0,0,0,0,109000,0,0,0,161000,52000,109000,109000
060815,茂林凱基9B購01  ,0,0,0,0,0,0,0,0,0,109000,0,0,0,141000,32000,109000,109000
06852P,臺股指元大98售11,0,0,0,0,0,0,0,0,0,109000,0,0,0,795000,686000,109000,109000
059525,上銀凱基99購08  ,0,0,0,0,0,0,0,0,0,109000,0,0,0,109000,0,109000,109000
060649,國巨第一9A購01  ,0,0,0,0,0,0,0,0,0,109000,0,0,0,471000,362000,109000,109000
053453,新光金統一98購01,0,0,0,0,0,0,0,0,0,109000,0,0,0,109000,0,109000,109000
057953,聚陽元大98購01  ,0,0,0,0,0,0,0,0,0,109000,0,0,0,109000,0,109000,109000
056958,喬山永豐98購01  ,0,0,0,0,0,0,0,0,0,109000,0,0,0,109000,0,109000,109000
07711P,世芯元大9A售07  ,0,0,0,0,0,0,0,0,0,109000,0,0,0,152000,43000,109000,109000
2357,華碩            ,783755,673980,109775,0,0,0,1000,0,1000,-2000,15000,0,15000,0,17000,-17000,108775
053531,國泰金康和96購01,0,0,0,0,0,0,0,0,0,108000,0,0,0,160000,52000,108000,108000
054683,川湖永豐97購01  ,0,0,0,0,0,0,0,0,0,108000,0,0,0,298000,190000,108000,108000
052424,泰碩國票97購01  ,0,0,0,0,0,0,0,0,0,108000,0,0,0,304000,196000,108000,108000
056842,全新元富98購01  ,0,0,0,0,0,0,0,0,0,108000,0,0,0,108000,0,108000,108000
056422,全新統一98購02  ,0,0,0,0,0,0,0,0,0,108000,0,0,0,108000,0,108000,108000
057491,美食元大98購03  ,0,0,0,0,0,0,0,0,0,108000,0,0,0,108000,0,108000,108000
057060,緯穎元大98購05  ,0,0,0,0,0,0,0,0,0,108000,0,0,0,108000,0,108000,108000
058297,茂林凱基9A購02  ,0,0,0,0,0,0,0,0,0,108000,0,0,0,108000,0,108000,108000
058521,日月光元大99購01,0,0,0,0,0,0,0,0,0,108000,0,0,0,108000,0,108000,108000
058646,聯茂富邦9A購01  ,0,0,0,0,0,0,0,0,0,108000,0,0,0,198000,90000,108000,108000
2436,偉詮電          ,196000,88000,108000,0,0,0,0,0,0,0,0,0,0,0,0,0,108000
2472,立隆電          ,322500,213000,109500,0,0,0,0,0,0,-2000,0,2000,-2000,0,0,0,107500
059579,聯發科元富99購06,0,0,0,0,0,0,0,0,0,107000,0,0,0,107000,0,107000,107000
059766,同欣電永豐99購03,0,0,0,0,0,0,0,0,0,107000,0,0,0,172000,65000,107000,107000
052558,新唐國票97購01  ,0,0,0,0,0,0,0,0,0,107000,0,0,0,107000,0,107000,107000
03647C,T50反1元富99牛02,0,0,0,0,0,0,0,0,0,107000,0,0,0,107000,0,107000,107000
058772,茂林兆豐9A購01  ,0,0,0,0,0,0,0,0,0,107000,0,0,0,245000,138000,107000,107000
05920P,力成元大96售04  ,0,0,0,0,0,0,0,0,0,107000,0,0,0,472000,365000,107000,107000
055444,致新台新97購01  ,0,0,0,0,0,0,0,0,0,107000,0,0,0,107000,0,107000,107000
060287,燿華元大9A購01  ,0,0,0,0,0,0,0,0,0,106000,0,0,0,110000,4000,106000,106000
060157,致茂永豐9A購02  ,0,0,0,0,0,0,0,0,0,106000,0,0,0,555000,449000,106000,106000
060095,聯發科元大99購42,0,0,0,0,0,0,0,0,0,106000,0,0,0,116000,10000,106000,106000
00663L,國泰臺灣加權正2 ,0,0,0,0,0,0,0,0,0,106000,0,0,0,250000,144000,106000,106000
058909,神達元大99購03  ,0,0,0,0,0,0,0,0,0,106000,0,0,0,158000,52000,106000,106000
058588,致茂中信9B購01  ,0,0,0,0,0,0,0,0,0,106000,0,0,0,190000,84000,106000,106000
055380,智易元大98購02  ,0,0,0,0,0,0,0,0,0,106000,0,0,0,140000,34000,106000,106000
057008,華新科中信99購02,0,0,0,0,0,0,0,0,0,106000,0,0,0,116000,10000,106000,106000
1708,東鹼            ,146000,18000,128000,0,0,0,0,0,0,-22000,3000,25000,-22000,0,0,0,106000
1434,福懋            ,562000,455608,106392,0,0,0,0,0,0,-1000,0,1000,-1000,0,0,0,105392
060190,國泰金元富9A購01,0,0,0,0,0,0,0,0,0,105000,0,0,0,224000,119000,105000,105000
059878,聯茂凱基99購07  ,0,0,0,0,0,0,0,0,0,105000,0,0,0,268000,163000,105000,105000
054802,高股息元大97購01,0,0,0,0,0,0,0,0,0,105000,0,0,0,105000,0,105000,105000
053082,聯電元大98購03  ,0,0,0,0,0,0,0,0,0,105000,0,0,0,105000,0,105000,105000
053189,聯發科統一96購05,0,0,0,0,0,0,0,0,0,105000,0,0,0,105000,0,105000,105000
057044,旺宏元大98購08  ,0,0,0,0,0,0,0,0,0,105000,0,0,0,155000,50000,105000,105000
058339,康友元富99購02  ,0,0,0,0,0,0,0,0,0,105000,0,0,0,120000,15000,105000,105000
058190,貿聯永豐99購01  ,0,0,0,0,0,0,0,0,0,105000,0,0,0,115000,10000,105000,105000
056323,旺宏兆豐98購01  ,0,0,0,0,0,0,0,0,0,105000,0,0,0,155000,50000,105000,105000
057479,致茂元大98購03  ,0,0,0,0,0,0,0,0,0,105000,0,0,0,234000,129000,105000,105000
059224,大立光元大99購15,0,0,0,0,0,0,0,0,0,105000,0,0,0,152000,47000,105000,105000
059870,全新凱基99購05  ,0,0,0,0,0,0,0,0,0,104000,0,0,0,137000,33000,104000,104000
060265,宏達電國票9A購02,0,0,0,0,0,0,0,0,0,104000,0,0,0,104000,0,104000,104000
060483,友達富邦9A購01  ,0,0,0,0,0,0,0,0,0,104000,0,0,0,104000,0,104000,104000
052095,彩晶元大97購01  ,0,0,0,0,0,0,0,0,0,104000,0,0,0,104000,0,104000,104000
059089,聯發科元大99購19,0,0,0,0,0,0,0,0,0,104000,0,0,0,105000,1000,104000,104000
058100,聯茂國泰99購02  ,0,0,0,0,0,0,0,0,0,104000,0,0,0,134000,30000,104000,104000
057010,景碩中信98購01  ,0,0,0,0,0,0,0,0,0,104000,0,0,0,184000,80000,104000,104000
059871,義隆凱基99購03  ,0,0,0,0,0,0,0,0,0,103000,0,0,0,437000,334000,103000,103000
059930,健策富邦9B購01  ,0,0,0,0,0,0,0,0,0,103000,0,0,0,109000,6000,103000,103000
061149,華通群益9A購05  ,0,0,0,0,0,0,0,0,0,103000,0,0,0,133000,30000,103000,103000
061304,創意永豐9A購02  ,0,0,0,0,0,0,0,0,0,103000,0,0,0,104000,1000,103000,103000
054128,台積電元大97購10,0,0,0,0,0,0,0,0,0,103000,0,0,0,103000,0,103000,103000
055951,大成鋼元大97購02,0,0,0,0,0,0,0,0,0,103000,0,0,0,103000,0,103000,103000
057529,嘉晶元大99購02  ,0,0,0,0,0,0,0,0,0,103000,0,0,0,115000,12000,103000,103000
056455,群創凱基9A購01  ,0,0,0,0,0,0,0,0,0,103000,0,0,0,159000,56000,103000,103000
061355,康友元大9A購03  ,0,0,0,0,0,0,0,0,0,102000,0,0,0,119000,17000,102000,102000
060993,健策元大9B購03  ,0,0,0,0,0,0,0,0,0,102000,0,0,0,304000,202000,102000,102000
059516,TPK永豐99購01   ,0,0,0,0,0,0,0,0,0,102000,0,0,0,142000,40000,102000,102000
060397,群創國票9A購01  ,0,0,0,0,0,0,0,0,0,102000,0,0,0,267000,165000,102000,102000
057720,日電貿元富98購01,0,0,0,0,0,0,0,0,0,102000,0,0,0,203000,101000,102000,102000
055069,帆宣永豐97購01  ,0,0,0,0,0,0,0,0,0,102000,0,0,0,102000,0,102000,102000
056634,為升兆豐99購01  ,0,0,0,0,0,0,0,0,0,102000,0,0,0,112000,10000,102000,102000
058951,南電群益99購01  ,0,0,0,0,0,0,0,0,0,102000,0,0,0,112000,10000,102000,102000
058797,大毅元大99購03  ,0,0,0,0,0,0,0,0,0,102000,0,0,0,139000,37000,102000,102000
059127,國巨中信99購04  ,0,0,0,0,0,0,0,0,0,102000,0,0,0,178000,76000,102000,102000
058573,鴻海群益9A購02  ,0,0,0,0,0,0,0,0,0,102000,0,0,0,159000,57000,102000,102000
056144,GIS元大98購01   ,0,0,0,0,0,0,0,0,0,102000,0,0,0,102000,0,102000,102000
060251,易華電元大9C購01,0,0,0,0,0,0,0,0,0,101000,0,0,0,102000,1000,101000,101000
060508,聯發科元大9A購04,0,0,0,0,0,0,0,0,0,101000,0,0,0,130000,29000,101000,101000
060699,華新科國泰9B購03,0,0,0,0,0,0,0,0,0,101000,0,0,0,141000,40000,101000,101000
060015,國巨康和99購03  ,0,0,0,0,0,0,0,0,0,101000,0,0,0,450000,349000,101000,101000
060070,國巨元富99購02  ,0,0,0,0,0,0,0,0,0,101000,0,0,0,131000,30000,101000,101000
055049,智邦永豐97購01  ,0,0,0,0,0,0,0,0,0,101000,0,0,0,226000,125000,101000,101000
053777,台積電元大96購20,0,0,0,0,0,0,0,0,0,101000,0,0,0,101000,0,101000,101000
00639,富邦深100       ,569000,736000,-167000,0,0,0,0,0,0,268000,0,0,0,1514000,1246000,268000,101000
054235,欣興群益96購06  ,0,0,0,0,0,0,0,0,0,101000,0,0,0,179000,78000,101000,101000
053167,欣興群益96購03  ,0,0,0,0,0,0,0,0,0,101000,0,0,0,101000,0,101000,101000
055909,大成鋼凱基98購02,0,0,0,0,0,0,0,0,0,101000,0,0,0,131000,30000,101000,101000
07369P,台積電凱基99售20,0,0,0,0,0,0,0,0,0,101000,0,0,0,120000,19000,101000,101000
1808,潤隆            ,151566,51000,100566,0,0,0,0,0,0,0,0,0,0,0,0,0,100566
060035,臺股指永豐99購04,0,0,0,0,0,0,0,0,0,100000,0,0,0,100000,0,100000,100000
059636,宏達電凱基99購05,0,0,0,0,0,0,0,0,0,100000,0,0,0,100000,0,100000,100000
060565,大立光富邦01購01,0,0,0,0,0,0,0,0,0,100000,0,0,0,150000,50000,100000,100000
060542,上銀凱基9A購04  ,0,0,0,0,0,0,0,0,0,100000,0,0,0,104000,4000,100000,100000
060865,創意永豐9A購01  ,0,0,0,0,0,0,0,0,0,100000,0,0,0,101000,1000,100000,100000
060787,奇力新富邦9A購01,0,0,0,0,0,0,0,0,0,100000,0,0,0,100000,0,100000,100000
053399,創意中信96購01  ,0,0,0,0,0,0,0,0,0,100000,0,0,0,100000,0,100000,100000
053540,健策永豐96購01  ,0,0,0,0,0,0,0,0,0,100000,0,0,0,100000,0,100000,100000
054366,和大中信98購01  ,0,0,0,0,0,0,0,0,0,100000,0,0,0,100000,0,100000,100000
057623,友訊國泰99購01  ,0,0,0,0,0,0,0,0,0,100000,0,0,0,100000,0,100000,100000
057636,上銀元大98購06  ,0,0,0,0,0,0,0,0,0,100000,0,0,0,100000,0,100000,100000
047047,旺宏國票95購01  ,0,0,0,0,0,0,0,0,0,100000,0,0,0,100000,0,100000,100000
048754,瀚宇博元富97購01,0,0,0,0,0,0,0,0,0,100000,0,0,0,100000,0,100000,100000
052070,GIS兆豐95購03   ,0,0,0,0,0,0,0,0,0,100000,0,0,0,100000,0,100000,100000
051630,力山國票96購01  ,0,0,0,0,0,0,0,0,0,100000,0,0,0,100000,0,100000,100000
053727,麗豐凱基97購01  ,0,0,0,0,0,0,0,0,0,100000,0,0,0,100000,0,100000,100000
051418,智易國票97購01  ,0,0,0,0,0,0,0,0,0,100000,0,0,0,100000,0,100000,100000
055125,智原兆豐97購01  ,0,0,0,0,0,0,0,0,0,100000,0,0,0,200000,100000,100000,100000
051251,信邦元大95購01  ,0,0,0,0,0,0,0,0,0,100000,0,0,0,100000,0,100000,100000
050460,GIS元大95購03   ,0,0,0,0,0,0,0,0,0,100000,0,0,0,100000,0,100000,100000
058141,嘉聯益元大99購05,0,0,0,0,0,0,0,0,0,100000,0,0,0,100000,0,100000,100000
058512,宏達電元大99購04,0,0,0,0,0,0,0,0,0,100000,0,0,0,100000,0,100000,100000
058494,可成群益9B購01  ,0,0,0,0,0,0,0,0,0,100000,0,0,0,108000,8000,100000,100000
059090,台新金元大99購01,0,0,0,0,0,0,0,0,0,100000,0,0,0,149000,49000,100000,100000
057540,緯穎日盛99購01  ,0,0,0,0,0,0,0,0,0,100000,0,0,0,140000,40000,100000,100000
056607,貿聯富邦99購02  ,0,0,0,0,0,0,0,0,0,100000,0,0,0,100000,0,100000,100000
056584,鴻海統一9B購01  ,0,0,0,0,0,0,0,0,0,100000,0,0,0,120000,20000,100000,100000
055532,中工群益98購01  ,0,0,0,0,0,0,0,0,0,100000,0,0,0,100000,0,100000,100000
07361P,聯發科元大99售34,0,0,0,0,0,0,0,0,0,100000,0,0,0,150000,50000,100000,100000
07363P,大立光元大99售26,0,0,0,0,0,0,0,0,0,100000,0,0,0,100000,0,100000,100000
1473,台南            ,105000,5000,100000,0,0,0,0,0,0,0,0,0,0,0,0,0,100000
060721,瑞儀永豐9A購01  ,0,0,0,0,0,0,0,0,0,99000,0,0,0,107000,8000,99000,99000
060979,國巨元大9A購14  ,0,0,0,0,0,0,0,0,0,99000,0,0,0,304000,205000,99000,99000
061003,南亞科兆豐9A購01,0,0,0,0,0,0,0,0,0,99000,0,0,0,217000,118000,99000,99000
060449,元金2X元大9A購02,0,0,0,0,0,0,0,0,0,99000,0,0,0,101000,2000,99000,99000
060624,玉晶光元大9C購02,0,0,0,0,0,0,0,0,0,99000,0,0,0,116000,17000,99000,99000
060676,京元電元大9A購03,0,0,0,0,0,0,0,0,0,99000,0,0,0,142000,43000,99000,99000
060128,健策永豐99購06  ,0,0,0,0,0,0,0,0,0,99000,0,0,0,116000,17000,99000,99000
060150,華通富邦9B購01  ,0,0,0,0,0,0,0,0,0,99000,0,0,0,100000,1000,99000,99000
060006,華通群益9A購04  ,0,0,0,0,0,0,0,0,0,99000,0,0,0,104000,5000,99000,99000
051390,京元電兆豐95購01,0,0,0,0,0,0,0,0,0,99000,0,0,0,249000,150000,99000,99000
03677C,臺股指元大05牛02,0,0,0,0,0,0,0,0,0,99000,0,0,0,99000,0,99000,99000
053632,新唐兆豐96購01  ,0,0,0,0,0,0,0,0,0,99000,0,0,0,99000,0,99000,99000
057319,奇力新凱基99購02,0,0,0,0,0,0,0,0,0,99000,0,0,0,107000,8000,99000,99000
058424,滬深2X元富99購04,0,0,0,0,0,0,0,0,0,99000,0,0,0,279000,180000,99000,99000
056114,台達電群益97購02,0,0,0,0,0,0,0,0,0,99000,0,0,0,119000,20000,99000,99000
2913,農林            ,192000,95000,97000,0,0,0,0,0,0,2000,2000,0,2000,0,0,0,99000
060144,全新國票9B購01  ,0,0,0,0,0,0,0,0,0,98000,0,0,0,112000,14000,98000,98000
060244,大立光元大9B購02,0,0,0,0,0,0,0,0,0,98000,0,0,0,101000,3000,98000,98000
060293,緯創元大9A購01  ,0,0,0,0,0,0,0,0,0,98000,0,0,0,197000,99000,98000,98000
060921,中橡永豐9A購02  ,0,0,0,0,0,0,0,0,0,98000,0,0,0,154000,56000,98000,98000
053642,瀚宇博永豐96購01,0,0,0,0,0,0,0,0,0,98000,0,0,0,98000,0,98000,98000
052814,上証2X永豐96購02,0,0,0,0,0,0,0,0,0,98000,0,0,0,110000,12000,98000,98000
054458,復盛群益96購01  ,0,0,0,0,0,0,0,0,0,98000,0,0,0,98000,0,98000,98000
00681R,元大美債20反1   ,0,0,0,0,0,0,0,0,0,98000,0,0,0,103000,5000,98000,98000
051607,緯創群益96購02  ,0,0,0,0,0,0,0,0,0,98000,0,0,0,98000,0,98000,98000
056098,矽創元富97購02  ,0,0,0,0,0,0,0,0,0,98000,0,0,0,98000,0,98000,98000
055815,亞光國票99購01  ,0,0,0,0,0,0,0,0,0,98000,0,0,0,136000,38000,98000,98000
055684,京鼎凱基97購01  ,0,0,0,0,0,0,0,0,0,98000,0,0,0,226000,128000,98000,98000
055387,世紀鋼元大97購01,0,0,0,0,0,0,0,0,0,98000,0,0,0,108000,10000,98000,98000
058751,南茂凱基9A購01  ,0,0,0,0,0,0,0,0,0,98000,0,0,0,98000,0,98000,98000
057298,旭富永豐98購01  ,0,0,0,0,0,0,0,0,0,98000,0,0,0,129000,31000,98000,98000
059153,臺股指國票99購16,0,0,0,0,0,0,0,0,0,98000,0,0,0,220000,122000,98000,98000
06408P,聯茂元富97售02  ,0,0,0,0,0,0,0,0,0,97000,0,0,0,97000,0,97000,97000
053198,亞德客日盛96購01,0,0,0,0,0,0,0,0,0,97000,0,0,0,101000,4000,97000,97000
057820,華擎元大98購02  ,0,0,0,0,0,0,0,0,0,97000,0,0,0,232000,135000,97000,97000
056163,嘉聯益凱基98購03,0,0,0,0,0,0,0,0,0,97000,0,0,0,97000,0,97000,97000
06680P,智邦元大98售06  ,0,0,0,0,0,0,0,0,0,96000,0,0,0,444000,348000,96000,96000
060928,明泰永豐9A購01  ,0,0,0,0,0,0,0,0,0,96000,0,0,0,270000,174000,96000,96000
057716,神達統一98購01  ,0,0,0,0,0,0,0,0,0,96000,0,0,0,101000,5000,96000,96000
055556,奇力新凱基98購03,0,0,0,0,0,0,0,0,0,96000,0,0,0,96000,0,96000,96000
056419,欣興元富98購02  ,0,0,0,0,0,0,0,0,0,96000,0,0,0,190000,94000,96000,96000
055533,大立光群益97購03,0,0,0,0,0,0,0,0,0,96000,0,0,0,96000,0,96000,96000
056784,南亞科群益98購01,0,0,0,0,0,0,0,0,0,96000,0,0,0,177000,81000,96000,96000
059041,南茂群益99購02  ,0,0,0,0,0,0,0,0,0,96000,0,0,0,165000,69000,96000,96000
058944,元石油群益9C購02,0,0,0,0,0,0,0,0,0,96000,0,0,0,99000,3000,96000,96000
07507P,國巨國票9B售02  ,0,0,0,0,0,0,0,0,0,96000,0,0,0,98000,2000,96000,96000
060214,茂林康和9A購01  ,0,0,0,0,0,0,0,0,0,95000,0,0,0,205000,110000,95000,95000
060099,宏達電元大99購09,0,0,0,0,0,0,0,0,0,95000,0,0,0,121000,26000,95000,95000
060499,鴻海元大9A購11  ,0,0,0,0,0,0,0,0,0,95000,0,0,0,135000,40000,95000,95000
055032,億光富邦99購01  ,0,0,0,0,0,0,0,0,0,95000,0,0,0,95000,0,95000,95000
056702,欣興國泰9A購01  ,0,0,0,0,0,0,0,0,0,95000,0,0,0,95000,0,95000,95000
060686,康友元大9A購02  ,0,0,0,0,0,0,0,0,0,94000,0,0,0,110000,16000,94000,94000
060575,大立光中信9B購02,0,0,0,0,0,0,0,0,0,94000,0,0,0,94000,0,94000,94000
060107,旭富元大99購03  ,0,0,0,0,0,0,0,0,0,94000,0,0,0,127000,33000,94000,94000
06938P,南電元大98售03  ,0,0,0,0,0,0,0,0,0,94000,0,0,0,178000,84000,94000,94000
06154P,超眾元大98售01  ,0,0,0,0,0,0,0,0,0,94000,0,0,0,94000,0,94000,94000
053867,創意元大96購04  ,0,0,0,0,0,0,0,0,0,94000,0,0,0,270000,176000,94000,94000
054002,GIS群益96購03   ,0,0,0,0,0,0,0,0,0,94000,0,0,0,94000,0,94000,94000
048745,儒鴻元富97購02  ,0,0,0,0,0,0,0,0,0,94000,0,0,0,94000,0,94000,94000
054909,福懋科康和97購01,0,0,0,0,0,0,0,0,0,94000,0,0,0,102000,8000,94000,94000
054689,華新科永豐97購01,0,0,0,0,0,0,0,0,0,94000,0,0,0,94000,0,94000,94000
058782,臺股指國票99購01,0,0,0,0,0,0,0,0,0,94000,0,0,0,109000,15000,94000,94000
058530,為升元富99購01  ,0,0,0,0,0,0,0,0,0,94000,0,0,0,94000,0,94000,94000
061338,台積電元大9A購28,0,0,0,0,0,0,0,0,0,93000,0,0,0,96000,3000,93000,93000
060437,宏全永豐9A購01  ,0,0,0,0,0,0,0,0,0,93000,0,0,0,113000,20000,93000,93000
060465,聯發科元大9A購02,0,0,0,0,0,0,0,0,0,93000,0,0,0,104000,11000,93000,93000
059531,華新科凱基9B購02,0,0,0,0,0,0,0,0,0,93000,0,0,0,111000,18000,93000,93000
054830,世芯國泰99購01  ,0,0,0,0,0,0,0,0,0,93000,0,0,0,107000,14000,93000,93000
053092,台表科元大97購02,0,0,0,0,0,0,0,0,0,93000,0,0,0,169000,76000,93000,93000
053401,臺股指中信99購01,0,0,0,0,0,0,0,0,0,93000,0,0,0,93000,0,93000,93000
053428,中磊永豐96購02  ,0,0,0,0,0,0,0,0,0,93000,0,0,0,105000,12000,93000,93000
057849,南茂永豐98購02  ,0,0,0,0,0,0,0,0,0,93000,0,0,0,93000,0,93000,93000
052295,揚明光國票96購03,0,0,0,0,0,0,0,0,0,93000,0,0,0,93000,0,93000,93000
058090,聯發科元大98購16,0,0,0,0,0,0,0,0,0,93000,0,0,0,188000,95000,93000,93000
056644,宏達電凱基98購04,0,0,0,0,0,0,0,0,0,93000,0,0,0,93000,0,93000,93000
056582,易華電元大98購01,0,0,0,0,0,0,0,0,0,93000,0,0,0,97000,4000,93000,93000
057470,易華電永豐98購02,0,0,0,0,0,0,0,0,0,93000,0,0,0,132000,39000,93000,93000
9802,鈺齊-KY         ,576000,1111000,-535000,0,0,0,608000,0,608000,20000,1000,0,1000,43000,24000,19000,93000
8462,柏文            ,131000,62000,69000,0,0,0,0,0,0,24000,15000,0,15000,10000,1000,9000,93000
061105,宏達電元大9A購04,0,0,0,0,0,0,0,0,0,92000,0,0,0,92000,0,92000,92000
061438,牧德凱基9B購02  ,0,0,0,0,0,0,0,0,0,92000,0,0,0,111000,19000,92000,92000
020000,富邦特選蘋果N   ,0,0,0,0,0,0,0,0,0,92000,0,0,0,92000,0,92000,92000
053248,智伸科國票97購01,0,0,0,0,0,0,0,0,0,92000,0,0,0,130000,38000,92000,92000
054898,台肥康和97購01  ,0,0,0,0,0,0,0,0,0,92000,0,0,0,139000,47000,92000,92000
054937,國巨元大97購03  ,0,0,0,0,0,0,0,0,0,92000,0,0,0,92000,0,92000,92000
059267,群創中信01購02  ,0,0,0,0,0,0,0,0,0,92000,0,0,0,92000,0,92000,92000
05925P,晶技永豐96售03  ,0,0,0,0,0,0,0,0,0,92000,0,0,0,93000,1000,92000,92000
056626,同欣電永豐98購01,0,0,0,0,0,0,0,0,0,92000,0,0,0,92000,0,92000,92000
058556,百和永豐99購01  ,0,0,0,0,0,0,0,0,0,92000,0,0,0,148000,56000,92000,92000
059786,全新元大99購06  ,0,0,0,0,0,0,0,0,0,91000,0,0,0,102000,11000,91000,91000
059840,鴻海富邦9A購02  ,0,0,0,0,0,0,0,0,0,91000,0,0,0,91000,0,91000,91000
060248,日月光元大9A購01,0,0,0,0,0,0,0,0,0,91000,0,0,0,107000,16000,91000,91000
052989,麗豐元大98購01  ,0,0,0,0,0,0,0,0,0,91000,0,0,0,101000,10000,91000,91000
052309,健策國泰97購01  ,0,0,0,0,0,0,0,0,0,91000,0,0,0,103000,12000,91000,91000
052434,茂林國泰97購01  ,0,0,0,0,0,0,0,0,0,91000,0,0,0,188000,97000,91000,91000
058531,華通元富99購01  ,0,0,0,0,0,0,0,0,0,91000,0,0,0,91000,0,91000,91000
058513,宏達電元大99購05,0,0,0,0,0,0,0,0,0,91000,0,0,0,91000,0,91000,91000
056709,華通永豐98購01  ,0,0,0,0,0,0,0,0,0,91000,0,0,0,91000,0,91000,91000
056579,麗豐元大99購01  ,0,0,0,0,0,0,0,0,0,91000,0,0,0,248000,157000,91000,91000
056014,上銀群益97購02  ,0,0,0,0,0,0,0,0,0,91000,0,0,0,91000,0,91000,91000
1608,華榮            ,106000,15000,91000,0,0,0,0,0,0,0,0,0,0,0,0,0,91000
07708P,玉晶光元大9A售13,0,0,0,0,0,0,0,0,0,91000,0,0,0,127000,36000,91000,91000
060573,力成永豐9A購01  ,0,0,0,0,0,0,0,0,0,90000,0,0,0,139000,49000,90000,90000
06200P,聯發科元大97售18,0,0,0,0,0,0,0,0,0,90000,0,0,0,100000,10000,90000,90000
06867P,訊芯元大98售08  ,0,0,0,0,0,0,0,0,0,90000,0,0,0,90000,0,90000,90000
06734P,智邦凱基98售05  ,0,0,0,0,0,0,0,0,0,90000,0,0,0,149000,59000,90000,90000
052446,聯發科元大96購03,0,0,0,0,0,0,0,0,0,90000,0,0,0,90000,0,90000,90000
050644,國巨凱基96購01  ,0,0,0,0,0,0,0,0,0,90000,0,0,0,156000,66000,90000,90000
051000,台郡元大96購01  ,0,0,0,0,0,0,0,0,0,90000,0,0,0,90000,0,90000,90000
054258,牧德元大97購01  ,0,0,0,0,0,0,0,0,0,90000,0,0,0,149000,59000,90000,90000
05440P,緯穎國票96售02  ,0,0,0,0,0,0,0,0,0,90000,0,0,0,320000,230000,90000,90000
054932,台肥元大97購01  ,0,0,0,0,0,0,0,0,0,90000,0,0,0,164000,74000,90000,90000
053113,瀚宇博兆豐97購01,0,0,0,0,0,0,0,0,0,90000,0,0,0,90000,0,90000,90000
053103,瀚宇博元富96購01,0,0,0,0,0,0,0,0,0,90000,0,0,0,190000,100000,90000,90000
053427,鎧勝永豐96購02  ,0,0,0,0,0,0,0,0,0,90000,0,0,0,90000,0,90000,90000
057217,奇力新群益99購01,0,0,0,0,0,0,0,0,0,90000,0,0,0,120000,30000,90000,90000
059305,台灣50元大99購02,0,0,0,0,0,0,0,0,0,90000,0,0,0,110000,20000,90000,90000
057495,牧德元大99購04  ,0,0,0,0,0,0,0,0,0,90000,0,0,0,138000,48000,90000,90000
057419,奇力新凱基98購06,0,0,0,0,0,0,0,0,0,90000,0,0,0,90000,0,90000,90000
058674,宏達電群益99購01,0,0,0,0,0,0,0,0,0,90000,0,0,0,93000,3000,90000,90000
055302,達方元大97購01  ,0,0,0,0,0,0,0,0,0,90000,0,0,0,278000,188000,90000,90000
060842,新光金國票9B購01,0,0,0,0,0,0,0,0,0,89000,0,0,0,89000,0,89000,89000
060285,聯電元大9C購01  ,0,0,0,0,0,0,0,0,0,89000,0,0,0,304000,215000,89000,89000
060045,嘉晶群益99購02  ,0,0,0,0,0,0,0,0,0,89000,0,0,0,182000,93000,89000,89000
054428,禾伸堂富邦98購01,0,0,0,0,0,0,0,0,0,89000,0,0,0,89000,0,89000,89000
057788,嘉聯益國票99購01,0,0,0,0,0,0,0,0,0,89000,0,0,0,89000,0,89000,89000
057625,泰鼎國泰9A購01  ,0,0,0,0,0,0,0,0,0,89000,0,0,0,89000,0,89000,89000
057667,可成元大99購01  ,0,0,0,0,0,0,0,0,0,89000,0,0,0,89000,0,89000,89000
053894,創意群益96購01  ,0,0,0,0,0,0,0,0,0,89000,0,0,0,89000,0,89000,89000
053945,國巨富邦98購02  ,0,0,0,0,0,0,0,0,0,89000,0,0,0,89000,0,89000,89000
057058,祥碩元大98購04  ,0,0,0,0,0,0,0,0,0,89000,0,0,0,89000,0,89000,89000
058010,帆宣國票98購01  ,0,0,0,0,0,0,0,0,0,89000,0,0,0,99000,10000,89000,89000
057440,台積電統一98購10,0,0,0,0,0,0,0,0,0,89000,0,0,0,89000,0,89000,89000
060357,上銀元富9A購02  ,0,0,0,0,0,0,0,0,0,88000,0,0,0,88000,0,88000,88000
060436,巨大永豐9A購01  ,0,0,0,0,0,0,0,0,0,88000,0,0,0,939000,851000,88000,88000
060774,南亞科凱基9A購01,0,0,0,0,0,0,0,0,0,88000,0,0,0,321000,233000,88000,88000
061168,力成兆豐9A購01  ,0,0,0,0,0,0,0,0,0,88000,0,0,0,145000,57000,88000,88000
06933P,禾伸堂元大98售03,0,0,0,0,0,0,0,0,0,88000,0,0,0,124000,36000,88000,88000
057614,華新科元富99購04,0,0,0,0,0,0,0,0,0,88000,0,0,0,179000,91000,88000,88000
057915,台泥凱基98購01  ,0,0,0,0,0,0,0,0,0,88000,0,0,0,88000,0,88000,88000
053617,宏達電群益96購02,0,0,0,0,0,0,0,0,0,88000,0,0,0,88000,0,88000,88000
056404,嘉聯益群益9A購01,0,0,0,0,0,0,0,0,0,88000,0,0,0,130000,42000,88000,88000
057240,茂林凱基9A購01  ,0,0,0,0,0,0,0,0,0,88000,0,0,0,90000,2000,88000,88000
056183,南亞科統一97購02,0,0,0,0,0,0,0,0,0,88000,0,0,0,181000,93000,88000,88000
058342,鴻海群益9A購01  ,0,0,0,0,0,0,0,0,0,88000,0,0,0,88000,0,88000,88000
058082,美律群益98購05  ,0,0,0,0,0,0,0,0,0,88000,0,0,0,118000,30000,88000,88000
058783,臺股指國票99購02,0,0,0,0,0,0,0,0,0,88000,0,0,0,141000,53000,88000,88000
1455,集盛            ,319000,231000,88000,0,0,0,0,0,0,0,0,0,0,0,0,0,88000
2617,台航            ,214000,126000,88000,0,0,0,0,0,0,0,0,0,0,0,0,0,88000
061352,茂林元大9A購04  ,0,0,0,0,0,0,0,0,0,87000,0,0,0,106000,19000,87000,87000
060738,矽格統一9C購01  ,0,0,0,0,0,0,0,0,0,87000,0,0,0,88000,1000,87000,87000
060001,台灣50群益9A購10,0,0,0,0,0,0,0,0,0,87000,0,0,0,89000,2000,87000,87000
059580,大立光元富99購07,0,0,0,0,0,0,0,0,0,87000,0,0,0,108000,21000,87000,87000
050685,緯穎元富94購02  ,0,0,0,0,0,0,0,0,0,87000,0,0,0,87000,0,87000,87000
050725,光磊國票96購01  ,0,0,0,0,0,0,0,0,0,87000,0,0,0,87000,0,87000,87000
055261,帆宣統一98購01  ,0,0,0,0,0,0,0,0,0,87000,0,0,0,87000,0,87000,87000
058259,訊連國泰9B購01  ,0,0,0,0,0,0,0,0,0,87000,0,0,0,110000,23000,87000,87000
057136,立積凱基98購02  ,0,0,0,0,0,0,0,0,0,87000,0,0,0,173000,86000,87000,87000
2406,國碩            ,371000,284000,87000,0,0,0,0,0,0,0,0,0,0,0,0,0,87000
059526,鴻海凱基99購12  ,0,0,0,0,0,0,0,0,0,86000,0,0,0,86000,0,86000,86000
060634,矽創富邦9B購01  ,0,0,0,0,0,0,0,0,0,86000,0,0,0,91000,5000,86000,86000
061296,台積電國泰9C購01,0,0,0,0,0,0,0,0,0,86000,0,0,0,86000,0,86000,86000
0055,元大MSCI金融    ,0,0,0,0,0,0,0,0,0,86000,0,0,0,90000,4000,86000,86000
054533,泰碩國泰98購01  ,0,0,0,0,0,0,0,0,0,86000,0,0,0,891000,805000,86000,86000
057798,貿聯兆豐99購01  ,0,0,0,0,0,0,0,0,0,86000,0,0,0,231000,145000,86000,86000
058111,健鼎元富98購01  ,0,0,0,0,0,0,0,0,0,86000,0,0,0,130000,44000,86000,86000
058656,燿華中信99購01  ,0,0,0,0,0,0,0,0,0,86000,0,0,0,96000,10000,86000,86000
056343,高鐵凱基98購02  ,0,0,0,0,0,0,0,0,0,86000,0,0,0,86000,0,86000,86000
057990,美律統一99購02  ,0,0,0,0,0,0,0,0,0,86000,0,0,0,105000,19000,86000,86000
056480,京鼎元大98購02  ,0,0,0,0,0,0,0,0,0,86000,0,0,0,230000,144000,86000,86000
059295,大立光元富99購05,0,0,0,0,0,0,0,0,0,86000,0,0,0,194000,108000,86000,86000
059249,大立光凱基99購05,0,0,0,0,0,0,0,0,0,86000,0,0,0,92000,6000,86000,86000
059040,訊芯群益99購03  ,0,0,0,0,0,0,0,0,0,86000,0,0,0,439000,353000,86000,86000
2889,國票金          ,609000,523000,86000,0,0,0,0,0,0,0,0,0,0,0,0,0,86000
07672P,南電元大9A售05  ,0,0,0,0,0,0,0,0,0,86000,0,0,0,91000,5000,86000,86000
07172P,臺股指國票99售09,0,0,0,0,0,0,0,0,0,86000,0,0,0,232000,146000,86000,86000
061222,台灣50中信9A購02,0,0,0,0,0,0,0,0,0,85000,0,0,0,85000,0,85000,85000
061223,T50反1中信01購01,0,0,0,0,0,0,0,0,0,85000,0,0,0,85000,0,85000,85000
061073,T50反1兆豐9A購01,0,0,0,0,0,0,0,0,0,85000,0,0,0,85000,0,85000,85000
060910,聯發科元大9A購05,0,0,0,0,0,0,0,0,0,85000,0,0,0,175000,90000,85000,85000
060028,國揚永豐99購01  ,0,0,0,0,0,0,0,0,0,85000,0,0,0,134000,49000,85000,85000
052733,台郡國泰97購01  ,0,0,0,0,0,0,0,0,0,85000,0,0,0,100000,15000,85000,85000
051423,GIS國票97購01   ,0,0,0,0,0,0,0,0,0,85000,0,0,0,85000,0,85000,85000
056481,創意元大98購01  ,0,0,0,0,0,0,0,0,0,85000,0,0,0,85000,0,85000,85000
056723,國巨中信9A購01  ,0,0,0,0,0,0,0,0,0,85000,0,0,0,85000,0,85000,85000
056139,貿聯元大97購04  ,0,0,0,0,0,0,0,0,0,85000,0,0,0,85000,0,85000,85000
1307,三芳            ,143000,58000,85000,0,0,0,0,0,0,0,10000,10000,0,0,0,0,85000
4942,嘉彰            ,163000,78705,84295,0,0,0,0,0,0,0,0,0,0,0,0,0,84295
060677,京元電元大9A購04,0,0,0,0,0,0,0,0,0,84000,0,0,0,116000,32000,84000,84000
061112,台表科元大9A購03,0,0,0,0,0,0,0,0,0,84000,0,0,0,87000,3000,84000,84000
061126,京元電永豐9A購02,0,0,0,0,0,0,0,0,0,84000,0,0,0,85000,1000,84000,84000
05160P,國巨國票96售03  ,0,0,0,0,0,0,0,0,0,84000,0,0,0,89000,5000,84000,84000
051847,香港反中信99購01,0,0,0,0,0,0,0,0,0,84000,0,0,0,85000,1000,84000,84000
051979,群創凱基97購01  ,0,0,0,0,0,0,0,0,0,84000,0,0,0,97000,13000,84000,84000
052764,景碩群益98購01  ,0,0,0,0,0,0,0,0,0,84000,0,0,0,89000,5000,84000,84000
057748,華通國票98購04  ,0,0,0,0,0,0,0,0,0,84000,0,0,0,84000,0,84000,84000
054074,健策富邦98購01  ,0,0,0,0,0,0,0,0,0,84000,0,0,0,94000,10000,84000,84000
058262,大立光富邦9C購02,0,0,0,0,0,0,0,0,0,84000,0,0,0,101000,17000,84000,84000
055525,國巨群益98購05  ,0,0,0,0,0,0,0,0,0,84000,0,0,0,306000,222000,84000,84000
057211,鴻海群益98購05  ,0,0,0,0,0,0,0,0,0,84000,0,0,0,217000,133000,84000,84000
057484,南亞科元大98購06,0,0,0,0,0,0,0,0,0,84000,0,0,0,92000,8000,84000,84000
4532,瑞智            ,210000,126000,84000,0,0,0,0,0,0,0,0,0,0,0,0,0,84000
061050,康友中信9A購01  ,0,0,0,0,0,0,0,0,0,83000,0,0,0,124000,41000,83000,83000
060611,同欣電凱基9A購02,0,0,0,0,0,0,0,0,0,83000,0,0,0,275000,192000,83000,83000
059954,華新科康和99購01,0,0,0,0,0,0,0,0,0,83000,0,0,0,83000,0,83000,83000
052864,奇力新凱基96購02,0,0,0,0,0,0,0,0,0,83000,0,0,0,83000,0,83000,83000
053332,創意永豐96購03  ,0,0,0,0,0,0,0,0,0,83000,0,0,0,150000,67000,83000,83000
057170,瑞昱元大98購01  ,25000,0,25000,0,0,0,0,0,0,58000,0,0,0,92000,34000,58000,83000
057804,為升元大98購01  ,0,0,0,0,0,0,0,0,0,83000,0,0,0,83000,0,83000,83000
057072,日月光永豐98購01,0,0,0,0,0,0,0,0,0,83000,0,0,0,125000,42000,83000,83000
057151,易華電國票99購01,0,0,0,0,0,0,0,0,0,83000,0,0,0,93000,10000,83000,83000
059722,南亞科元大99購02,0,0,0,0,0,0,0,0,0,82000,0,0,0,98000,16000,82000,82000
06025P,臺股指元大99售02,0,0,0,0,0,0,0,0,0,82000,0,0,0,107000,25000,82000,82000
060278,道瓊反元大9A購03,0,0,0,0,0,0,0,0,0,82000,0,0,0,100000,18000,82000,82000
060154,堤維西永豐9A購01,0,0,0,0,0,0,0,0,0,82000,0,0,0,82000,0,82000,82000
061065,神基凱基9A購01  ,0,0,0,0,0,0,0,0,0,82000,0,0,0,82000,0,82000,82000
060977,亞德客元大9A購04,0,0,0,0,0,0,0,0,0,82000,0,0,0,101000,19000,82000,82000
054481,鎧勝中信96購01  ,0,0,0,0,0,0,0,0,0,82000,0,0,0,89000,7000,82000,82000
05296P,牧德凱基96售01  ,0,0,0,0,0,0,0,0,0,82000,0,0,0,82000,0,82000,82000
047410,上銀元富96購01  ,0,0,0,0,0,0,0,0,0,82000,0,0,0,82000,0,82000,82000
055071,群電永豐97購01  ,0,0,0,0,0,0,0,0,0,82000,0,0,0,82000,0,82000,82000
058191,祥碩永豐99購01  ,0,0,0,0,0,0,0,0,0,82000,0,0,0,355000,273000,82000,82000
058122,美律國票9A購01  ,0,0,0,0,0,0,0,0,0,82000,0,0,0,82000,0,82000,82000
057370,可成元大98購07  ,0,0,0,0,0,0,0,0,0,82000,0,0,0,82000,0,82000,82000
058931,玉晶光統一9C購01,0,0,0,0,0,0,0,0,0,82000,0,0,0,122000,40000,82000,82000
060912,華新科元大9A購10,0,0,0,0,0,0,0,0,0,81000,0,0,0,84000,3000,81000,81000
061193,玉晶光永豐9B購02,0,0,0,0,0,0,0,0,0,81000,0,0,0,82000,1000,81000,81000
061430,致新元大9A購01  ,0,0,0,0,0,0,0,0,0,81000,0,0,0,222000,141000,81000,81000
054205,華新國票97購02  ,0,0,0,0,0,0,0,0,0,81000,0,0,0,81000,0,81000,81000
057355,彩晶統一98購03  ,0,0,0,0,0,0,0,0,0,81000,0,0,0,81000,0,81000,81000
057075,嘉聯益永豐98購01,0,0,0,0,0,0,0,0,0,81000,0,0,0,83000,2000,81000,81000
3705,永信            ,105000,24000,81000,0,0,0,0,0,0,0,0,0,0,0,0,0,81000
6672,騰輝電子-KY     ,125000,46000,79000,0,0,0,0,0,0,2000,2000,0,2000,0,0,0,81000
061436,上銀凱基9A購07  ,0,0,0,0,0,0,0,0,0,80000,0,0,0,273000,193000,80000,80000
07010P,T50正2凱基9C售01,0,0,0,0,0,0,0,0,0,80000,0,0,0,80000,0,80000,80000
061162,南電群益9A購02  ,0,0,0,0,0,0,0,0,0,80000,0,0,0,140000,60000,80000,80000
061076,台達電兆豐9A購01,0,0,0,0,0,0,0,0,0,80000,0,0,0,178000,98000,80000,80000
061045,儒鴻第一9A購01  ,0,0,0,0,0,0,0,0,0,80000,0,0,0,139000,59000,80000,80000
061039,台表科永豐9A購03,0,0,0,0,0,0,0,0,0,80000,0,0,0,80000,0,80000,80000
060239,國揚元大9C購01  ,0,0,0,0,0,0,0,0,0,80000,0,0,0,384000,304000,80000,80000
06035P,同欣電凱基96售03,0,0,0,0,0,0,0,0,0,80000,0,0,0,80000,0,80000,80000
060698,旺宏國泰9C購01  ,0,0,0,0,0,0,0,0,0,80000,0,0,0,260000,180000,80000,80000
057747,致新永豐98購01  ,0,0,0,0,0,0,0,0,0,80000,0,0,0,120000,40000,80000,80000
057763,康控凱基99購02  ,0,0,0,0,0,0,0,0,0,80000,0,0,0,140000,60000,80000,80000
057924,健策凱基98購02  ,0,0,0,0,0,0,0,0,0,80000,0,0,0,116000,36000,80000,80000
054892,彩晶統一99購01  ,0,0,0,0,0,0,0,0,0,80000,0,0,0,80000,0,80000,80000
055156,華新科元大99購02,0,0,0,0,0,0,0,0,0,80000,0,0,0,80000,0,80000,80000
050895,聯發科元大97購01,0,0,0,0,0,0,0,0,0,80000,0,0,0,80000,0,80000,80000
048805,瀚宇博富邦95購01,0,0,0,0,0,0,0,0,0,80000,0,0,0,80000,0,80000,80000
057154,易華電國泰99購01,0,0,0,0,0,0,0,0,0,80000,0,0,0,80000,0,80000,80000
058014,上銀凱基99購02  ,0,0,0,0,0,0,0,0,0,80000,0,0,0,83000,3000,80000,80000
055578,群創統一98購03  ,0,0,0,0,0,0,0,0,0,80000,0,0,0,80000,0,80000,80000
055287,日電貿元大97購01,0,0,0,0,0,0,0,0,0,80000,0,0,0,95000,15000,80000,80000
056276,同欣電國泰98購01,0,0,0,0,0,0,0,0,0,80000,0,0,0,80000,0,80000,80000
056283,鴻海永豐97購03  ,0,0,0,0,0,0,0,0,0,80000,0,0,0,80000,0,80000,80000
057383,玉晶光富邦9A購01,0,0,0,0,0,0,0,0,0,80000,0,0,0,100000,20000,80000,80000
2727,王品            ,148000,68000,80000,0,0,0,0,0,0,0,0,0,0,0,0,0,80000
060504,技嘉元大9A購02  ,0,0,0,0,0,0,0,0,0,79000,0,0,0,83000,4000,79000,79000
059760,楠梓電永豐99購01,0,0,0,0,0,0,0,0,0,79000,0,0,0,107000,28000,79000,79000
060932,南六永豐9A購02  ,0,0,0,0,0,0,0,0,0,79000,0,0,0,359000,280000,79000,79000
060850,康友國票9A購03  ,0,0,0,0,0,0,0,0,0,79000,0,0,0,107000,28000,79000,79000
049024,玉晶光群益97購01,0,0,0,0,0,0,0,0,0,79000,0,0,0,85000,6000,79000,79000
050096,國巨國泰95購05  ,0,0,0,0,0,0,0,0,0,79000,0,0,0,79000,0,79000,79000
054950,奇力新元大98購02,0,0,0,0,0,0,0,0,0,79000,0,0,0,170000,91000,79000,79000
057697,國巨群益98購09  ,0,0,0,0,0,0,0,0,0,79000,0,0,0,79000,0,79000,79000
059144,嘉晶國票9A購02  ,0,0,0,0,0,0,0,0,0,79000,0,0,0,228000,149000,79000,79000
058746,華通凱基9A購02  ,0,0,0,0,0,0,0,0,0,79000,0,0,0,79000,0,79000,79000
058735,南茂永豐99購01  ,8000,0,8000,0,0,0,0,0,0,71000,0,0,0,72000,1000,71000,79000
058596,旺宏台新99購01  ,0,0,0,0,0,0,0,0,0,79000,0,0,0,159000,80000,79000,79000
058201,華通凱基9A購01  ,0,0,0,0,0,0,0,0,0,79000,0,0,0,85000,6000,79000,79000
2489,瑞軒            ,156000,99000,57000,0,0,0,0,0,0,22000,22000,0,22000,0,0,0,79000
061294,奇力新麥證9A購01,0,0,0,84000,6000,78000,0,0,0,78000,0,0,0,84000,6000,78000,78000
059822,聯發科凱基99購19,0,0,0,0,0,0,0,0,0,78000,0,0,0,212000,134000,78000,78000
059912,國巨元大99購28  ,0,0,0,0,0,0,0,0,0,78000,0,0,0,101000,23000,78000,78000
060533,臺股指中信9B購05,0,0,0,0,0,0,0,0,0,78000,0,0,0,111000,33000,78000,78000
060625,華擎元大9A購01  ,0,0,0,0,0,0,0,0,0,78000,0,0,0,78000,0,78000,78000
060184,建準元富9A購01  ,0,0,0,0,0,0,0,0,0,78000,0,0,0,157000,79000,78000,78000
054192,國巨中信98購01  ,0,0,0,0,0,0,0,0,0,78000,0,0,0,78000,0,78000,78000
051266,國巨富邦99購01  ,0,0,0,0,0,0,0,0,0,78000,0,0,0,199000,121000,78000,78000
053804,富邦金凱基96購01,0,0,0,0,0,0,0,0,0,78000,0,0,0,108000,30000,78000,78000
048571,美利達元大96購03,0,0,0,0,0,0,0,0,0,78000,0,0,0,78000,0,78000,78000
048572,美利達元大96購04,0,0,0,0,0,0,0,0,0,78000,0,0,0,78000,0,78000,78000
057149,京鼎國票99購02  ,0,0,0,0,0,0,0,0,0,78000,0,0,0,148000,70000,78000,78000
056143,訊芯元大97購04  ,0,0,0,0,0,0,0,0,0,78000,0,0,0,178000,100000,78000,78000
060299,友訊國泰9B購01  ,0,0,0,0,0,0,0,0,0,77000,0,0,0,137000,60000,77000,77000
060604,宏達電凱基9B購01,0,0,0,0,0,0,0,0,0,77000,0,0,0,81000,4000,77000,77000
07067P,旺宏台新99售02  ,0,0,0,0,0,0,0,0,0,77000,0,0,0,160000,83000,77000,77000
048422,瑞昱元富96購02  ,0,0,0,0,0,0,0,0,0,77000,0,0,0,93000,16000,77000,77000
055019,福懋科元富97購01,0,0,0,0,0,0,0,0,0,77000,0,0,0,77000,0,77000,77000
052581,訊芯元富98購01  ,0,0,0,0,0,0,0,0,0,77000,0,0,0,77000,0,77000,77000
058208,百和凱基99購01  ,0,0,0,0,0,0,0,0,0,77000,0,0,0,166000,89000,77000,77000
058565,鴻海凱基9A購07  ,0,0,0,0,0,0,0,0,0,77000,0,0,0,77000,0,77000,77000
058578,聯發科群益99購03,0,0,0,0,0,0,0,0,0,77000,0,0,0,147000,70000,77000,77000
057255,聯發科麥證98購02,0,0,0,150000,63000,87000,0,0,0,77000,0,0,0,150000,73000,77000,77000
056516,晶豪科兆豐98購01,0,0,0,0,0,0,0,0,0,77000,0,0,0,81000,4000,77000,77000
056963,建準永豐98購01  ,0,0,0,0,0,0,0,0,0,77000,0,0,0,77000,0,77000,77000
1909,榮成            ,479000,404000,75000,0,0,0,2000,0,2000,0,0,0,0,0,0,0,77000
4766,南寶            ,33000,15000,18000,0,0,0,59000,0,59000,0,0,0,0,0,0,0,77000
5288,豐祥-KY         ,83000,6000,77000,0,0,0,0,0,0,0,0,0,0,0,0,0,77000
061372,世紀鋼國泰9C購01,0,0,0,0,0,0,0,0,0,76000,0,0,0,76000,0,76000,76000
060645,台表科永豐9A購02,0,0,0,0,0,0,0,0,0,76000,0,0,0,76000,0,76000,76000
059673,玉山金元富99購01,0,0,0,0,0,0,0,0,0,76000,0,0,0,91000,15000,76000,76000
054252,奇力新元大96購04,0,0,0,0,0,0,0,0,0,76000,0,0,0,76000,0,76000,76000
054558,劍麟群益99購01  ,0,0,0,0,0,0,0,0,0,76000,0,0,0,130000,54000,76000,76000
054717,亞德客永豐97購01,0,0,0,0,0,0,0,0,0,76000,0,0,0,77000,1000,76000,76000
056988,聚陽兆豐98購01  ,0,0,0,0,0,0,0,0,0,76000,0,0,0,76000,0,76000,76000
056765,友達元大9B購05  ,0,0,0,0,0,0,0,0,0,76000,0,0,0,76000,0,76000,76000
058989,茂林凱基99購02  ,0,0,0,0,0,0,0,0,0,76000,0,0,0,153000,77000,76000,76000
058246,帆宣元大99購01  ,0,0,0,0,0,0,0,0,0,76000,0,0,0,150000,74000,76000,76000
3645,達邁            ,131000,55000,76000,0,0,0,0,0,0,0,0,0,0,0,0,0,76000
3059,華晶科          ,121000,45000,76000,0,0,0,0,0,0,0,0,0,0,0,0,0,76000
1215,卜蜂            ,131000,121000,10000,0,0,0,0,0,0,66000,46000,0,46000,27000,7000,20000,76000
059790,立積元大9C購02  ,0,0,0,0,0,0,0,0,0,75000,0,0,0,75000,0,75000,75000
060900,超眾凱基9B購01  ,0,0,0,0,0,0,0,0,0,75000,0,0,0,100000,25000,75000,75000
060989,國泰金元大9A購02,0,0,0,0,0,0,0,0,0,75000,0,0,0,177000,102000,75000,75000
055175,建準統一97購01  ,0,0,0,0,0,0,0,0,0,75000,0,0,0,208000,133000,75000,75000
054934,金寶元大97購01  ,0,0,0,0,0,0,0,0,0,75000,0,0,0,100000,25000,75000,75000
057654,A50正2中信98購01,0,0,0,0,0,0,0,0,0,75000,0,0,0,85000,10000,75000,75000
050788,台郡國泰96購01  ,0,0,0,0,0,0,0,0,0,75000,0,0,0,75000,0,75000,75000
052572,群創凱基99購01  ,0,0,0,0,0,0,0,0,0,75000,0,0,0,97000,22000,75000,75000
052513,大立光凱基95購13,0,0,0,0,0,0,0,0,0,75000,0,0,0,75000,0,75000,75000
049264,奇鋐元大95購01  ,0,0,0,0,0,0,0,0,0,75000,0,0,0,75000,0,75000,75000
056133,可成元大97購05  ,0,0,0,0,0,0,0,0,0,75000,0,0,0,75000,0,75000,75000
058810,國巨統一9B購04  ,0,0,0,0,0,0,0,0,0,75000,0,0,0,190000,115000,75000,75000
059282,嘉聯益永豐99購01,0,0,0,0,0,0,0,0,0,75000,0,0,0,75000,0,75000,75000
056386,TPK國泰99購01   ,0,0,0,0,0,0,0,0,0,75000,0,0,0,85000,10000,75000,75000
061130,牧德永豐9A購04  ,0,0,0,0,0,0,0,0,0,74000,0,0,0,79000,5000,74000,74000
059910,鴻海元大99購37  ,0,0,0,0,0,0,0,0,0,74000,0,0,0,74000,0,74000,74000
059916,聯發科元大99購33,0,0,0,0,0,0,0,0,0,74000,0,0,0,120000,46000,74000,74000
059851,晶相光永豐99購02,0,0,0,0,0,0,0,0,0,74000,0,0,0,445000,371000,74000,74000
059530,華新科凱基9A購05,0,0,0,0,0,0,0,0,0,74000,0,0,0,81000,7000,74000,74000
060337,FBVIX統一9A購01 ,0,0,0,0,0,0,0,0,0,74000,0,0,0,101000,27000,74000,74000
057574,中磊永豐98購01  ,0,0,0,0,0,0,0,0,0,74000,0,0,0,88000,14000,74000,74000
057882,華通群益9A購03  ,0,0,0,0,0,0,0,0,0,74000,0,0,0,75000,1000,74000,74000
054231,國巨群益98購03  ,0,0,0,0,0,0,0,0,0,74000,0,0,0,288000,214000,74000,74000
054075,GIS富邦97購02   ,0,0,0,0,0,0,0,0,0,74000,0,0,0,74000,0,74000,74000
056919,英業達兆豐98購01,0,0,0,0,0,0,0,0,0,74000,0,0,0,185000,111000,74000,74000
056899,可成元大98購01  ,0,0,0,0,0,0,0,0,0,74000,0,0,0,78000,4000,74000,74000
056686,可成統一98購01  ,0,0,0,0,0,0,0,0,0,74000,0,0,0,136000,62000,74000,74000
059250,大立光凱基99購06,0,0,0,0,0,0,0,0,0,74000,0,0,0,74000,0,74000,74000
057162,上銀元大98購03  ,0,0,0,0,0,0,0,0,0,74000,0,0,0,95000,21000,74000,74000
3004,豐達科          ,125000,51000,74000,0,0,0,0,0,0,0,0,0,0,0,0,0,74000
5305,敦南            ,161000,87000,74000,0,0,0,0,0,0,0,0,0,0,0,0,0,74000
059717,國巨元大99購21  ,0,0,0,0,0,0,0,0,0,73000,0,0,0,166000,93000,73000,73000
059618,台積電日盛99購01,0,0,0,0,0,0,0,0,0,73000,0,0,0,458000,385000,73000,73000
061257,上銀凱基9A購06  ,0,0,0,0,0,0,0,0,0,73000,0,0,0,73000,0,73000,73000
057592,美律兆豐99購01  ,0,0,0,0,0,0,0,0,0,73000,0,0,0,205000,132000,73000,73000
057612,瑞昱元富02購01  ,0,0,0,0,0,0,0,0,0,73000,0,0,0,198000,125000,73000,73000
057779,禾伸堂群益98購02,0,0,0,0,0,0,0,0,0,73000,0,0,0,249000,176000,73000,73000
046628,大立光統一98購01,0,0,0,0,0,0,0,0,0,73000,0,0,0,100000,27000,73000,73000
050601,台表科國泰96購01,0,0,0,0,0,0,0,0,0,73000,0,0,0,93000,20000,73000,73000
056980,建準群益98購02  ,0,0,0,0,0,0,0,0,0,73000,0,0,0,188000,115000,73000,73000
07671P,超眾元大9A售04  ,0,0,0,0,0,0,0,0,0,73000,0,0,0,73000,0,73000,73000
2605,新興            ,517960,445000,72960,0,0,0,0,0,0,0,8000,0,8000,0,8000,-8000,72960
1590,亞德客-KY       ,321122,282000,39122,0,0,0,45000,0,45000,-12000,0,0,0,4000,16000,-12000,72122
059614,致新永豐99購01  ,0,0,0,0,0,0,0,0,0,72000,0,0,0,107000,35000,72000,72000
059633,聯發科凱基9A購07,0,0,0,0,0,0,0,0,0,72000,0,0,0,72000,0,72000,72000
050170,臺指反元大97購02,0,0,0,0,0,0,0,0,0,72000,0,0,0,314000,242000,72000,72000
053999,台表科群益96購06,0,0,0,0,0,0,0,0,0,72000,0,0,0,82000,10000,72000,72000
053249,致伸國票97購02  ,0,0,0,0,0,0,0,0,0,72000,0,0,0,72000,0,72000,72000
057449,華新科元富99購02,0,0,0,0,0,0,0,0,0,72000,0,0,0,80000,8000,72000,72000
058315,TPK富邦9C購01   ,0,0,0,0,0,0,0,0,0,72000,0,0,0,75000,3000,72000,72000
058496,文曄群益99購01  ,0,0,0,0,0,0,0,0,0,72000,0,0,0,90000,18000,72000,72000
3056,總太            ,249000,177000,72000,0,0,0,0,0,0,0,0,0,0,0,0,0,72000
06034P,世芯凱基96售03  ,0,0,0,0,0,0,0,0,0,71000,0,0,0,121000,50000,71000,71000
060185,聯發科元富04購01,0,0,0,0,0,0,0,0,0,71000,0,0,0,94000,23000,71000,71000
060222,貿聯凱基9A購02  ,0,0,0,0,0,0,0,0,0,71000,0,0,0,176000,105000,71000,71000
060695,同欣電麥證9A購01,0,150000,-150000,223000,2000,221000,0,0,0,221000,0,0,0,223000,2000,221000,71000
060422,台勝科永豐9A購01,0,0,0,0,0,0,0,0,0,71000,0,0,0,81000,10000,71000,71000
054921,文曄凱基97購01  ,0,0,0,0,0,0,0,0,0,71000,0,0,0,71000,0,71000,71000
054786,全新群益99購02  ,0,0,0,0,0,0,0,0,0,71000,0,0,0,71000,0,71000,71000
054363,世芯凱基97購01  ,0,0,0,0,0,0,0,0,0,71000,0,0,0,88000,17000,71000,71000
052691,GIS元大96購01   ,0,0,0,0,0,0,0,0,0,71000,0,0,0,71000,0,71000,71000
052423,宏達電國票96購02,0,0,0,0,0,0,0,0,0,71000,0,0,0,110000,39000,71000,71000
056224,聯發科凱基97購08,0,0,0,0,0,0,0,0,0,71000,0,0,0,71000,0,71000,71000
056141,聯茂元大97購05  ,0,0,0,0,0,0,0,0,0,71000,0,0,0,87000,16000,71000,71000
058605,華邦電元大99購04,0,0,0,0,0,0,0,0,0,71000,0,0,0,221000,150000,71000,71000
058650,台虹永豐9A購01  ,0,0,0,0,0,0,0,0,0,71000,0,0,0,73000,2000,71000,71000
056314,力成元大97購01  ,0,0,0,0,0,0,0,0,0,71000,0,0,0,136000,65000,71000,71000
058808,大成鋼統一9B購01,0,0,0,0,0,0,0,0,0,71000,0,0,0,117000,46000,71000,71000
059004,嘉晶元大99購05  ,0,0,0,0,0,0,0,0,0,71000,0,0,0,220000,149000,71000,71000
2892,第一金          ,6934939,6845151,89788,0,0,0,13000,0,13000,-32000,0,26000,-26000,0,6000,-6000,70788
059817,華通凱基99購05  ,0,0,0,0,0,0,0,0,0,70000,0,0,0,74000,4000,70000,70000
061349,嘉澤元大9A購02  ,0,0,0,0,0,0,0,0,0,70000,0,0,0,221000,151000,70000,70000
060824,旺宏元大9A購06  ,0,0,0,0,0,0,0,0,0,70000,0,0,0,253000,183000,70000,70000
061398,力成中信9A購01  ,0,0,0,0,0,0,0,0,0,70000,0,0,0,80000,10000,70000,70000
050674,瑞昱富邦94購02  ,0,0,0,0,0,0,0,0,0,70000,0,0,0,70000,0,70000,70000
051314,嘉聯益麥證96購01,0,0,0,70000,0,70000,0,0,0,70000,0,0,0,70000,0,70000,70000
051318,上銀國票96購01  ,0,0,0,0,0,0,0,0,0,70000,0,0,0,70000,0,70000,70000
053710,華通凱基96購05  ,0,0,0,0,0,0,0,0,0,70000,0,0,0,70000,0,70000,70000
053761,健策國泰98購01  ,0,0,0,0,0,0,0,0,0,70000,0,0,0,164000,94000,70000,70000
03675C,臺股指元大04牛02,0,0,0,0,0,0,0,0,0,70000,0,0,0,77000,7000,70000,70000
054303,國巨凱基96購15  ,0,0,0,0,0,0,0,0,0,70000,0,0,0,70000,0,70000,70000
057675,同欣電元大98購02,0,0,0,0,0,0,0,0,0,70000,0,0,0,171000,101000,70000,70000
054480,和碩中信98購01  ,0,0,0,0,0,0,0,0,0,70000,0,0,0,94000,24000,70000,70000
053460,緯穎國泰97購01  ,0,0,0,0,0,0,0,0,0,70000,0,0,0,195000,125000,70000,70000
052798,滬深2X元大96購07,0,0,0,0,0,0,0,0,0,70000,0,0,0,100000,30000,70000,70000
058959,南茂國票9A購01  ,0,0,0,0,0,0,0,0,0,70000,0,0,0,70000,0,70000,70000
055461,TPK永豐97購01   ,0,0,0,0,0,0,0,0,0,70000,0,0,0,80000,10000,70000,70000
055263,華新科富邦9A購01,0,0,0,0,0,0,0,0,0,70000,0,0,0,70000,0,70000,70000
055233,康友國票98購01  ,0,0,0,0,0,0,0,0,0,70000,0,0,0,70000,0,70000,70000
058309,大毅元大99購02  ,0,0,0,0,0,0,0,0,0,70000,0,0,0,102000,32000,70000,70000
4977,眾達-KY         ,286000,806000,-520000,0,0,0,608000,0,608000,-18000,0,15000,-15000,0,3000,-3000,70000
07771P,義隆國票9A售01  ,0,0,0,0,0,0,0,0,0,70000,0,0,0,73000,3000,70000,70000
07202P,台灣50凱基9C售04,0,0,0,0,0,0,0,0,0,70000,0,0,0,72000,2000,70000,70000
06201P,可成元大97售01  ,0,0,0,0,0,0,0,0,0,69000,0,0,0,69000,0,69000,69000
06431P,新日興元大97售05,0,0,0,0,0,0,0,0,0,69000,0,0,0,69000,0,69000,69000
06506P,台郡國票99售02  ,0,0,0,0,0,0,0,0,0,69000,0,0,0,87000,18000,69000,69000
06900P,FBVIX國票12售01 ,0,0,0,0,0,0,0,0,0,69000,0,0,0,74000,5000,69000,69000
061295,台積電國泰9B購02,0,0,0,0,0,0,0,0,0,69000,0,0,0,95000,26000,69000,69000
059984,華新科元大99購21,0,0,0,0,0,0,0,0,0,69000,0,0,0,74000,5000,69000,69000
059647,超眾凱基99購04  ,0,0,0,0,0,0,0,0,0,69000,0,0,0,232000,163000,69000,69000
060202,康友元富9A購01  ,0,0,0,0,0,0,0,0,0,69000,0,0,0,79000,10000,69000,69000
058227,台灣50元大9C購01,0,0,0,0,0,0,0,0,0,69000,0,0,0,69000,0,69000,69000
055659,百和元富97購01  ,0,0,0,0,0,0,0,0,0,69000,0,0,0,75000,6000,69000,69000
1231,聯華食          ,28000,21000,7000,0,0,0,0,0,0,62000,63000,1000,62000,0,0,0,69000
060363,美律元富9A購01  ,0,0,0,0,0,0,0,0,0,68000,0,0,0,170000,102000,68000,68000
060328,可成群益9A購06  ,0,0,0,0,0,0,0,0,0,68000,0,0,0,94000,26000,68000,68000
060409,味全永豐9A購01  ,0,0,0,0,0,0,0,0,0,68000,0,0,0,68000,0,68000,68000
06051P,嘉聯益國票97售04,0,0,0,0,0,0,0,0,0,68000,0,0,0,73000,5000,68000,68000
059348,日月光凱基99購01,0,0,0,0,0,0,0,0,0,68000,0,0,0,98000,30000,68000,68000
060847,康控國票9A購01  ,0,0,0,0,0,0,0,0,0,68000,0,0,0,278000,210000,68000,68000
060868,致伸永豐9A購01  ,0,0,0,0,0,0,0,0,0,68000,0,0,0,113000,45000,68000,68000
053473,聯發科元大96購15,0,0,0,0,0,0,0,0,0,68000,0,0,0,132000,64000,68000,68000
054936,鴻海元大97購10  ,0,0,0,0,0,0,0,0,0,68000,0,0,0,68000,0,68000,68000
054974,台表科元大98購02,0,0,0,0,0,0,0,0,0,68000,0,0,0,73000,5000,68000,68000
054135,大立光元大97購04,0,0,0,0,0,0,0,0,0,68000,0,0,0,68000,0,68000,68000
055490,台光電元大97購01,0,0,0,0,0,0,0,0,0,68000,0,0,0,68000,0,68000,68000
056441,燿華凱基98購01  ,0,0,0,0,0,0,0,0,0,68000,0,0,0,112000,44000,68000,68000
056057,華邦電元大97購05,0,0,0,0,0,0,0,0,0,68000,0,0,0,68000,0,68000,68000
057486,美律元大98購04  ,0,0,0,0,0,0,0,0,0,68000,0,0,0,68000,0,68000,68000
060857,旭富富邦9B購01  ,0,0,0,0,0,0,0,0,0,67000,0,0,0,67000,0,67000,67000
060898,世芯凱基9A購03  ,0,0,0,0,0,0,0,0,0,67000,0,0,0,176000,109000,67000,67000
060907,金像電元大9A購02,0,0,0,0,0,0,0,0,0,67000,0,0,0,447000,380000,67000,67000
07082P,美律元大99售06  ,0,0,0,0,0,0,0,0,0,67000,0,0,0,805000,738000,67000,67000
060459,鴻海元大9A購07  ,0,0,0,0,0,0,0,0,0,67000,0,0,0,67000,0,67000,67000
060643,牧德永豐9A購03  ,0,0,0,0,0,0,0,0,0,67000,0,0,0,111000,44000,67000,67000
054935,華通元大98購03  ,0,0,0,0,0,0,0,0,0,67000,0,0,0,68000,1000,67000,67000
048682,奇力新富邦96購01,0,0,0,0,0,0,0,0,0,67000,0,0,0,67000,0,67000,67000
058865,群創凱基01購01  ,0,0,0,0,0,0,0,0,0,67000,0,0,0,150000,83000,67000,67000
056458,日月光凱基98購02,0,0,0,0,0,0,0,0,0,67000,0,0,0,67000,0,67000,67000
056563,華新科群益98購04,0,0,0,0,0,0,0,0,0,67000,0,0,0,67000,0,67000,67000
056351,鴻海元大98購06  ,0,0,0,0,0,0,0,0,0,67000,0,0,0,68000,1000,67000,67000
055736,宏達電元富99購01,0,0,0,0,0,0,0,0,0,67000,0,0,0,115000,48000,67000,67000
056190,昇陽半統一97購01,0,0,0,0,0,0,0,0,0,67000,0,0,0,67000,0,67000,67000
060230,台積電元大9A購07,0,0,0,0,0,0,0,0,0,66000,0,0,0,69000,3000,66000,66000
059986,宏達電元大99購08,0,0,0,0,0,0,0,0,0,66000,0,0,0,88000,22000,66000,66000
059813,滬深2X凱基9B購01,0,0,0,0,0,0,0,0,0,66000,0,0,0,66000,0,66000,66000
06844P,智邦元大98售13  ,0,0,0,0,0,0,0,0,0,66000,0,0,0,104000,38000,66000,66000
051405,世芯永豐95購01  ,0,0,0,0,0,0,0,0,0,66000,0,0,0,66000,0,66000,66000
050481,泰鼎國票96購01  ,0,0,0,0,0,0,0,0,0,66000,0,0,0,66000,0,66000,66000
055936,彩晶群益98購02  ,0,0,0,0,0,0,0,0,0,66000,0,0,0,66000,0,66000,66000
055667,致茂群益98購01  ,0,0,0,0,0,0,0,0,0,66000,0,0,0,163000,97000,66000,66000
059174,訊芯凱基99購01  ,0,0,0,0,0,0,0,0,0,66000,0,0,0,170000,104000,66000,66000
059319,台光電元大99購04,0,0,0,0,0,0,0,0,0,66000,0,0,0,97000,31000,66000,66000
07208P,台積電凱基99售14,0,0,0,0,0,0,0,0,0,66000,0,0,0,66000,0,66000,66000
061419,國巨元大9A購21  ,0,0,0,0,0,0,0,0,0,65000,0,0,0,276000,211000,65000,65000
059454,亞光永豐99購01  ,0,0,0,0,0,0,0,0,0,65000,0,0,0,88000,23000,65000,65000
059665,嘉聯益元大99購06,0,0,0,0,0,0,0,0,0,65000,0,0,0,65000,0,65000,65000
060719,瀚宇博永豐9A購01,0,0,0,0,0,0,0,0,0,65000,0,0,0,75000,10000,65000,65000
053892,景碩群益96購02  ,0,0,0,0,0,0,0,0,0,65000,0,0,0,65000,0,65000,65000
048379,台郡元富96購01  ,0,0,0,0,0,0,0,0,0,65000,0,0,0,65000,0,65000,65000
053325,GIS群益96購02   ,0,0,0,0,0,0,0,0,0,65000,0,0,0,65000,0,65000,65000
053281,茂林元大96購02  ,0,0,0,0,0,0,0,0,0,65000,0,0,0,237000,172000,65000,65000
059286,S&P正2元富01購03,0,0,0,0,0,0,0,0,0,65000,0,0,0,70000,5000,65000,65000
059103,旭富元富99購03  ,0,0,0,0,0,0,0,0,0,65000,0,0,0,81000,16000,65000,65000
059082,華通元大99購06  ,0,0,0,0,0,0,0,0,0,65000,0,0,0,65000,0,65000,65000
057539,南茂元大98購02  ,0,0,0,0,0,0,0,0,0,65000,0,0,0,262000,197000,65000,65000
057541,台灣50康和9A購04,0,0,0,0,0,0,0,0,0,65000,0,0,0,65000,0,65000,65000
056734,國巨凱基99購01  ,0,0,0,0,0,0,0,0,0,65000,0,0,0,65000,0,65000,65000
056619,強茂永豐98購01  ,0,0,0,0,0,0,0,0,0,65000,0,0,0,79000,14000,65000,65000
055528,華邦電群益97購01,0,0,0,0,0,0,0,0,0,65000,0,0,0,65000,0,65000,65000
055764,臺股指群益97購02,0,0,0,0,0,0,0,0,0,65000,0,0,0,65000,0,65000,65000
055726,台表科元大98購03,0,0,0,0,0,0,0,0,0,65000,0,0,0,86000,21000,65000,65000
058438,大立光統一9B購01,0,0,0,0,0,0,0,0,0,65000,0,0,0,80000,15000,65000,65000
2535,達欣工          ,85000,76000,9000,0,0,0,0,0,0,56000,56000,0,56000,0,0,0,65000
060466,玉山金元大9A購01,0,0,0,0,0,0,0,0,0,64000,0,0,0,191000,127000,64000,64000
059537,大立光凱基99購09,0,0,0,0,0,0,0,0,0,64000,0,0,0,64000,0,64000,64000
059956,玉山金康和99購01,0,0,0,0,0,0,0,0,0,64000,0,0,0,182000,118000,64000,64000
053502,智伸科兆豐97購01,0,0,0,0,0,0,0,0,0,64000,0,0,0,74000,10000,64000,64000
053072,國巨台新97購01  ,0,0,0,0,0,0,0,0,0,64000,0,0,0,357000,293000,64000,64000
058247,聯茂元大99購04  ,0,0,0,0,0,0,0,0,0,64000,0,0,0,102000,38000,64000,64000
058238,奇鋐元大99購02  ,0,0,0,0,0,0,0,0,0,64000,0,0,0,64000,0,64000,64000
059314,上銀元大99購03  ,0,0,0,0,0,0,0,0,0,64000,0,0,0,64000,0,64000,64000
3712,永崴投控        ,102000,38000,64000,0,0,0,0,0,0,0,0,0,0,0,0,0,64000
07310P,大立光凱基99售12,0,0,0,0,0,0,0,0,0,64000,0,0,0,120000,56000,64000,64000
060033,臻鼎永豐99購01  ,0,0,0,0,0,0,0,0,0,63000,0,0,0,89000,26000,63000,63000
059440,康控元大9B購01  ,0,0,0,0,0,0,0,0,0,63000,0,0,0,98000,35000,63000,63000
060656,國巨統一9C購03  ,0,0,0,0,0,0,0,0,0,63000,0,0,0,66000,3000,63000,63000
060621,玉晶光元大9A購05,0,0,0,0,0,0,0,0,0,63000,0,0,0,91000,28000,63000,63000
060805,國巨群益9A購06  ,0,0,0,0,0,0,0,0,0,63000,0,0,0,372000,309000,63000,63000
054771,茂林國票98購02  ,0,0,0,0,0,0,0,0,0,63000,0,0,0,80000,17000,63000,63000
057935,晶技群益98購02  ,0,0,0,0,0,0,0,0,0,63000,0,0,0,93000,30000,63000,63000
057684,聯茂日盛99購01  ,0,0,0,0,0,0,0,0,0,63000,0,0,0,145000,82000,63000,63000
00665L,富邦恒生國企正2 ,0,7000,-7000,0,0,0,0,0,0,70000,0,0,0,70000,0,70000,63000
059298,大立光元富9C購02,0,0,0,0,0,0,0,0,0,63000,0,0,0,117000,54000,63000,63000
056881,台灣50康和9A購01,0,0,0,0,0,0,0,0,0,63000,0,0,0,63000,0,63000,63000
055657,超眾元富97購02  ,20000,0,20000,0,0,0,0,0,0,43000,0,0,0,346000,303000,43000,63000
2739,寒舍            ,63000,0,63000,0,0,0,0,0,0,0,0,0,0,0,0,0,63000
061246,玉晶光群益9A購08,0,0,0,0,0,0,0,0,0,62000,0,0,0,76000,14000,62000,62000
061337,台積電元大9A購27,0,0,0,0,0,0,0,0,0,62000,0,0,0,62000,0,62000,62000
061417,力成群益9A購01  ,0,0,0,0,0,0,0,0,0,62000,0,0,0,62000,0,62000,62000
061441,大毅永豐9A購04  ,0,0,0,0,0,0,0,0,0,62000,0,0,0,62000,0,62000,62000
059534,國泰金凱基99購01,0,0,0,0,0,0,0,0,0,62000,0,0,0,62000,0,62000,62000
059807,大立光元富99購09,0,0,0,0,0,0,0,0,0,62000,0,0,0,92000,30000,62000,62000
052159,瑞昱永豐95購01  ,0,0,0,0,0,0,0,0,0,62000,0,0,0,67000,5000,62000,62000
053970,聯發科元大97購08,0,0,0,0,0,0,0,0,0,62000,0,0,0,73000,11000,62000,62000
053018,旺宏元富96購02  ,0,0,0,0,0,0,0,0,0,62000,0,0,0,67000,5000,62000,62000
055949,亞德客元大97購04,0,0,0,0,0,0,0,0,0,62000,0,0,0,69000,7000,62000,62000
056856,華通群益9A購01  ,0,0,0,0,0,0,0,0,0,62000,0,0,0,62000,0,62000,62000
055519,茂林中信99購01  ,0,0,0,0,0,0,0,0,0,62000,0,0,0,160000,98000,62000,62000
059070,道瓊指元大99購02,0,0,0,0,0,0,0,0,0,62000,0,0,0,62000,0,62000,62000
059957,中信金康和99購01,0,0,0,0,0,0,0,0,0,61000,0,0,0,131000,70000,61000,61000
059610,上銀永豐99購02  ,0,0,0,0,0,0,0,0,0,61000,0,0,0,83000,22000,61000,61000
057672,茂林元大98購02  ,0,0,0,0,0,0,0,0,0,61000,0,0,0,74000,13000,61000,61000
057943,可成國票99購03  ,0,0,0,0,0,0,0,0,0,61000,0,0,0,86000,25000,61000,61000
055132,台虹康和97購01  ,0,0,0,0,0,0,0,0,0,61000,0,0,0,61000,0,61000,61000
051594,和碩元大96購01  ,0,0,0,0,0,0,0,0,0,61000,0,0,0,123000,62000,61000,61000
050451,嘉晶元大95購01  ,0,0,0,0,0,0,0,0,0,61000,0,0,0,61000,0,61000,61000
058907,健策元大99購04  ,0,0,0,0,0,0,0,0,0,61000,0,0,0,81000,20000,61000,61000
055432,臻鼎群益97購02  ,0,0,0,0,0,0,0,0,0,61000,0,0,0,61000,0,61000,61000
056710,漢唐永豐98購01  ,0,0,0,0,0,0,0,0,0,61000,0,0,0,61000,0,61000,61000
055710,亞德客元大97購03,0,0,0,0,0,0,0,0,0,61000,0,0,0,64000,3000,61000,61000
055414,奇力新富邦9B購01,0,0,0,0,0,0,0,0,0,61000,0,0,0,61000,0,61000,61000
058220,世芯國票9A購01  ,0,0,0,0,0,0,0,0,0,61000,0,0,0,217000,156000,61000,61000
058152,聯發科統一9B購02,0,0,0,0,0,0,0,0,0,61000,0,0,0,90000,29000,61000,61000
057809,英業達元大98購01,0,0,0,0,0,0,0,0,0,61000,0,0,0,181000,120000,61000,61000
060498,華通元大9A購03  ,0,0,0,0,0,0,0,0,0,60000,0,0,0,60000,0,60000,60000
061022,健策國泰9B購03  ,0,0,0,0,0,0,0,0,0,60000,0,0,0,67000,7000,60000,60000
05059P,大立光國票96售02,0,0,0,0,0,0,0,0,0,60000,0,0,0,60000,0,60000,60000
051281,健策兆豐96購01  ,0,0,0,0,0,0,0,0,0,60000,0,0,0,77000,17000,60000,60000
051113,聯電元富95購01  ,0,0,0,0,0,0,0,0,0,60000,0,0,0,60000,0,60000,60000
052560,康舒國票97購01  ,0,0,0,0,0,0,0,0,0,60000,0,0,0,60000,0,60000,60000
051531,國巨國票96購04  ,0,0,0,0,0,0,0,0,0,60000,0,0,0,139000,79000,60000,60000
053721,國泰金凱基97購01,0,0,0,0,0,0,0,0,0,60000,0,0,0,60000,0,60000,60000
053919,可成國票97購02  ,0,0,0,0,0,0,0,0,0,60000,0,0,0,61000,1000,60000,60000
052227,瑞昱凱基95購05  ,0,0,0,0,0,0,0,0,0,60000,0,0,0,80000,20000,60000,60000
04953P,台積電群益94售13,0,0,0,0,0,0,0,0,0,60000,0,0,0,60000,0,60000,60000
048010,嘉聯益富邦97購01,0,0,0,0,0,0,0,0,0,60000,0,0,0,60000,0,60000,60000
054334,超眾永豐96購04  ,0,0,0,0,0,0,0,0,0,60000,0,0,0,70000,10000,60000,60000
052897,緯創群益96購03  ,0,0,0,0,0,0,0,0,0,60000,0,0,0,60000,0,60000,60000
054785,建準群益98購01  ,0,0,0,0,0,0,0,0,0,60000,0,0,0,60000,0,60000,60000
054716,緯穎康和97購01  ,0,0,0,0,0,0,0,0,0,60000,0,0,0,149000,89000,60000,60000
053492,華邦電兆豐97購01,0,0,0,0,0,0,0,0,0,60000,0,0,0,60000,0,60000,60000
053387,緯創元大97購01  ,0,0,0,0,0,0,0,0,0,60000,0,0,0,60000,0,60000,60000
057061,華擎國泰9A購01  ,0,0,0,0,0,0,0,0,0,60000,0,0,0,60000,0,60000,60000
057029,緯穎凱基98購04  ,0,0,0,0,0,0,0,0,0,60000,0,0,0,60000,0,60000,60000
055672,國巨日盛97購02  ,0,0,0,0,0,0,0,0,0,60000,0,0,0,60000,0,60000,60000
058643,T50正2富邦03購01,0,0,0,0,0,0,0,0,0,60000,0,0,0,60000,0,60000,60000
059234,台灣50凱基9C購03,0,0,0,0,0,0,0,0,0,60000,0,0,0,60000,0,60000,60000
2101,南港            ,441000,293000,148000,0,0,0,0,0,0,-88000,30000,0,30000,41000,159000,-118000,60000
07260P,台灣50元大9A售01,0,0,0,0,0,0,0,0,0,60000,0,0,0,65000,5000,60000,60000
1526,日馳            ,90000,30000,60000,0,0,0,0,0,0,0,0,0,0,0,0,0,60000
060723,致新永豐9A購01  ,0,0,0,0,0,0,0,0,0,59000,0,0,0,126000,67000,59000,59000
060777,茂林凱基9C購01  ,0,0,0,0,0,0,0,0,0,59000,0,0,0,95000,36000,59000,59000
060507,聯發科元大9A購03,0,0,0,0,0,0,0,0,0,59000,0,0,0,272000,213000,59000,59000
060200,同欣電元富9A購01,0,0,0,0,0,0,0,0,0,59000,0,0,0,313000,254000,59000,59000
053658,亞光凱基96購01  ,0,0,0,0,0,0,0,0,0,59000,0,0,0,59000,0,59000,59000
053134,南亞科國票97購01,0,0,0,0,0,0,0,0,0,59000,0,0,0,91000,32000,59000,59000
054532,強茂國泰98購01  ,0,0,0,0,0,0,0,0,0,59000,0,0,0,59000,0,59000,59000
057707,臺股指群益98購07,0,0,0,0,0,0,0,0,0,59000,0,0,0,409000,350000,59000,59000
051449,玉晶光元大96購01,0,0,0,0,0,0,0,0,0,59000,0,0,0,59000,0,59000,59000
058957,貿聯國票9A購01  ,0,0,0,0,0,0,0,0,0,59000,0,0,0,60000,1000,59000,59000
056946,國巨統一98購05  ,0,0,0,0,0,0,0,0,0,59000,0,0,0,851000,792000,59000,59000
057199,台達電元富02購01,0,0,0,0,0,0,0,0,0,59000,0,0,0,483000,424000,59000,59000
055954,南港元大97購02  ,0,0,0,0,0,0,0,0,0,59000,0,0,0,59000,0,59000,59000
057102,亞光中信9A購01  ,0,0,0,0,0,0,0,0,0,59000,0,0,0,85000,26000,59000,59000
058327,大毅統一9B購01  ,0,0,0,0,0,0,0,0,0,59000,0,0,0,301000,242000,59000,59000
07352P,台積電國票99售11,0,0,0,0,0,0,0,0,0,59000,0,0,0,83000,24000,59000,59000
3669,圓展            ,172000,113000,59000,0,0,0,0,0,0,0,0,0,0,0,0,0,59000
4994,傳奇            ,75800,17000,58800,0,0,0,0,0,0,0,0,0,0,0,0,0,58800
060480,億豐元大9A購02  ,0,0,0,0,0,0,0,0,0,58000,0,0,0,218000,160000,58000,58000
060050,鴻海凱基9B購01  ,0,0,0,0,0,0,0,0,0,58000,0,0,0,88000,30000,58000,58000
059850,日電貿永豐99購01,0,0,0,0,0,0,0,0,0,58000,0,0,0,61000,3000,58000,58000
059909,鴻海元大99購36  ,0,0,0,0,0,0,0,0,0,58000,0,0,0,105000,47000,58000,58000
060999,國巨兆豐9A購01  ,0,0,0,0,0,0,0,0,0,58000,0,0,0,199000,141000,58000,58000
061196,世芯永豐9A購06  ,0,0,0,0,0,0,0,0,0,58000,0,0,0,345000,287000,58000,58000
057689,南亞科凱基99購02,0,0,0,0,0,0,0,0,0,58000,0,0,0,58000,0,58000,58000
05807P,泰鼎永豐96售03  ,0,0,0,0,0,0,0,0,0,58000,0,0,0,118000,60000,58000,58000
058047,可成元大98購11  ,0,0,0,0,0,0,0,0,0,58000,0,0,0,58000,0,58000,58000
055665,亞德客群益97購01,0,0,0,0,0,0,0,0,0,58000,0,0,0,61000,3000,58000,58000
056359,旺宏元大9A購01  ,0,0,0,0,0,0,0,0,0,58000,0,0,0,58000,0,58000,58000
056967,奇鋐永豐98購01  ,0,0,0,0,0,0,0,0,0,58000,0,0,0,100000,42000,58000,58000
058846,鴻海群益99購03  ,0,0,0,0,0,0,0,0,0,58000,0,0,0,85000,27000,58000,58000
059281,創意永豐99購02  ,0,0,0,0,0,0,0,0,0,58000,0,0,0,90000,32000,58000,58000
059327,南茂元大99購01  ,0,0,0,0,0,0,0,0,0,58000,0,0,0,59000,1000,58000,58000
07311P,台灣50元大99售09,0,0,0,0,0,0,0,0,0,58000,0,0,0,130000,72000,58000,58000
07170P,臺股指國票99售07,0,0,0,0,0,0,0,0,0,58000,0,0,0,108000,50000,58000,58000
07506P,中租元大9A售01  ,0,0,0,0,0,0,0,0,0,58000,0,0,0,78000,20000,58000,58000
6451,訊芯-KY         ,339000,300000,39000,0,0,0,0,0,0,19000,2000,2000,0,34000,15000,19000,58000
061001,智邦兆豐9B購01  ,0,0,0,0,0,0,0,0,0,57000,0,0,0,449000,392000,57000,57000
060955,大立光群益9A購02,0,0,0,0,0,0,0,0,0,57000,0,0,0,57000,0,57000,57000
060759,南亞科元大9A購03,0,0,0,0,0,0,0,0,0,57000,0,0,0,203000,146000,57000,57000
060861,漢唐永豐9A購01  ,0,0,0,0,0,0,0,0,0,57000,0,0,0,57000,0,57000,57000
059914,台積電元大99購47,0,0,0,0,0,0,0,0,0,57000,0,0,0,118000,61000,57000,57000
059773,康控群益99購01  ,0,0,0,0,0,0,0,0,0,57000,0,0,0,102000,45000,57000,57000
060210,上銀康和9A購01  ,0,0,0,0,0,0,0,0,0,57000,0,0,0,64000,7000,57000,57000
057937,神達群益98購02  ,0,0,0,0,0,0,0,0,0,57000,0,0,0,57000,0,57000,57000
055131,茂林康和97購01  ,0,0,0,0,0,0,0,0,0,57000,0,0,0,211000,154000,57000,57000
050014,國巨富邦98購01  ,0,0,0,0,0,0,0,0,0,57000,0,0,0,171000,114000,57000,57000
052173,廣達元大95購02  ,0,0,0,0,0,0,0,0,0,57000,0,0,0,68000,11000,57000,57000
057457,華邦電富邦98購01,0,0,0,0,0,0,0,0,0,57000,0,0,0,57000,0,57000,57000
056828,國巨富邦9A購03  ,0,0,0,0,0,0,0,0,0,57000,0,0,0,57000,0,57000,57000
055240,京元電元富97購01,0,0,0,0,0,0,0,0,0,57000,0,0,0,58000,1000,57000,57000
058743,可成康和99購01  ,0,0,0,0,0,0,0,0,0,57000,0,0,0,58000,1000,57000,57000
055280,智邦元大97購01  ,0,0,0,0,0,0,0,0,0,57000,0,0,0,90000,33000,57000,57000
05625P,國巨國票97售01  ,0,0,0,0,0,0,0,0,0,57000,0,0,0,91000,34000,57000,57000
060110,茂林元大99購06  ,0,0,0,0,0,0,0,0,0,56000,0,0,0,230000,174000,56000,56000
060528,友達中信9C購01  ,0,0,0,0,0,0,0,0,0,56000,0,0,0,290000,234000,56000,56000
060554,中租凱基9A購01  ,0,0,0,0,0,0,0,0,0,56000,0,0,0,111000,55000,56000,56000
060702,玉晶光國泰9C購02,0,0,0,0,0,0,0,0,0,56000,0,0,0,121000,65000,56000,56000
059765,嘉聯益永豐99購02,0,0,0,0,0,0,0,0,0,56000,0,0,0,99000,43000,56000,56000
060829,T50反1國票9A購06,0,0,0,0,0,0,0,0,0,56000,0,0,0,56000,0,56000,56000
060748,臻鼎國票9A購01  ,0,0,0,0,0,0,0,0,0,56000,0,0,0,63000,7000,56000,56000
061390,大立光群益9A購04,0,0,0,0,0,0,0,0,0,56000,0,0,0,56000,0,56000,56000
048383,元金2X國票99購01,0,0,0,0,0,0,0,0,0,56000,0,0,0,67000,11000,56000,56000
053955,華通永豐96購04  ,0,0,0,0,0,0,0,0,0,56000,0,0,0,56000,0,56000,56000
053997,健策群益97購02  ,0,0,0,0,0,0,0,0,0,56000,0,0,0,119000,63000,56000,56000
054773,台郡國票98購01  ,0,0,0,0,0,0,0,0,0,56000,0,0,0,74000,18000,56000,56000
058479,亞光凱基9A購01  ,0,0,0,0,0,0,0,0,0,56000,0,0,0,56000,0,56000,56000
056970,TPK永豐98購01   ,0,0,0,0,0,0,0,0,0,56000,0,0,0,182000,126000,56000,56000
057466,泰鼎永豐98購01  ,0,0,0,0,0,0,0,0,0,56000,0,0,0,56000,0,56000,56000
057363,華通元大99購02  ,0,0,0,0,0,0,0,0,0,56000,0,0,0,59000,3000,56000,56000
1467,南緯            ,90000,34000,56000,0,0,0,0,0,0,0,0,0,0,0,0,0,56000
2524,京城            ,76000,20000,56000,0,0,0,0,0,0,0,0,0,0,0,0,0,56000
060835,亞德客國票9A購01,0,0,0,0,0,0,0,0,0,55000,0,0,0,55000,0,55000,55000
061510,嘉澤富邦9C購01  ,0,0,0,0,0,0,0,0,0,55000,0,0,0,55000,0,55000,55000
06668P,祥碩凱基98售02  ,0,0,0,0,0,0,0,0,0,55000,0,0,0,97000,42000,55000,55000
059683,康控富邦9C購01  ,0,0,0,0,0,0,0,0,0,55000,0,0,0,160000,105000,55000,55000
059691,大立光永豐99購02,0,0,0,0,0,0,0,0,0,55000,0,0,0,55000,0,55000,55000
060420,神基永豐9A購01  ,0,0,0,0,0,0,0,0,0,55000,0,0,0,55000,0,55000,55000
054803,味全元大9A購01  ,0,0,0,0,0,0,0,0,0,55000,0,0,0,55000,0,55000,55000
054609,正崴永豐97購01  ,0,0,0,0,0,0,0,0,0,55000,0,0,0,55000,0,55000,55000
05485P,旺宏凱基95售08  ,0,0,0,0,0,0,0,0,0,55000,0,0,0,55000,0,55000,55000
050519,旺宏元大95購03  ,0,0,0,0,0,0,0,0,0,55000,0,0,0,55000,0,55000,55000
052062,臺股指國票95購09,0,0,0,0,0,0,0,0,0,55000,0,0,0,55000,0,55000,55000
051898,富邦金國泰97購01,0,0,0,0,0,0,0,0,0,55000,0,0,0,92000,37000,55000,55000
051675,瑞儀元大96購02  ,0,0,0,0,0,0,0,0,0,55000,0,0,0,55000,0,55000,55000
045685,康控元大95購01  ,0,0,0,0,0,0,0,0,0,55000,0,0,0,55000,0,55000,55000
059117,禾伸堂永豐99購01,0,0,0,0,0,0,0,0,0,55000,0,0,0,163000,108000,55000,55000
058197,國巨中信99購02  ,0,0,0,0,0,0,0,0,0,55000,0,0,0,55000,0,55000,55000
058264,瑞昱永豐99購01  ,0,0,0,0,0,0,0,0,0,55000,0,0,0,71000,16000,55000,55000
058555,矽創永豐9A購01  ,0,0,0,0,0,0,0,0,0,55000,0,0,0,73000,18000,55000,55000
060124,奇力新永豐99購03,0,0,0,0,0,0,0,0,0,54000,0,0,0,86000,32000,54000,54000
060164,合勤控永豐9A購01,0,0,0,0,0,0,0,0,0,54000,0,0,0,54000,0,54000,54000
059370,玉晶光元富99購02,0,0,0,0,0,0,0,0,0,54000,0,0,0,129000,75000,54000,54000
059898,T50反1元大99購15,0,0,0,0,0,0,0,0,0,54000,0,0,0,54000,0,54000,54000
060964,日月光凱基9A購01,0,0,0,0,0,0,0,0,0,54000,0,0,0,65000,11000,54000,54000
061012,國巨麥證9A購03  ,0,0,0,154000,0,154000,0,0,0,54000,0,0,0,154000,100000,54000,54000
061343,大立光元大9A購04,0,0,0,0,0,0,0,0,0,54000,0,0,0,54000,0,54000,54000
050634,華新科群益96購01,0,0,0,0,0,0,0,0,0,54000,0,0,0,54000,0,54000,54000
051503,玉晶光統一97購01,0,0,0,0,0,0,0,0,0,54000,0,0,0,179000,125000,54000,54000
053698,中磊元大96購02  ,0,0,0,0,0,0,0,0,0,54000,0,0,0,154000,100000,54000,54000
053389,彩晶元大98購01  ,0,0,0,0,0,0,0,0,0,54000,0,0,0,54000,0,54000,54000
053186,健策中信9C購01  ,0,0,0,0,0,0,0,0,0,54000,0,0,0,89000,35000,54000,54000
057650,力成元大98購04  ,0,0,0,0,0,0,0,0,0,54000,0,0,0,75000,21000,54000,54000
057000,亞德客國票99購01,0,0,0,0,0,0,0,0,0,54000,0,0,0,56000,2000,54000,54000
059172,台郡凱基99購03  ,0,0,0,0,0,0,0,0,0,54000,0,0,0,54000,0,54000,54000
057468,台郡永豐98購01  ,0,0,0,0,0,0,0,0,0,54000,0,0,0,132000,78000,54000,54000
056038,可成凱基97購01  ,0,0,0,0,0,0,0,0,0,54000,0,0,0,76000,22000,54000,54000
2355,敬鵬            ,266000,183000,83000,0,0,0,0,0,0,-29000,0,6000,-6000,0,23000,-23000,54000
07309P,聯發科凱基99售18,0,0,0,0,0,0,0,0,0,54000,0,0,0,64000,10000,54000,54000
059875,信邦凱基99購02  ,1000,0,1000,0,0,0,0,0,0,52000,0,0,0,335000,283000,52000,53000
059990,健策元大9A購01  ,0,0,0,0,0,0,0,0,0,53000,0,0,0,60000,7000,53000,53000
059690,建準永豐99購01  ,0,0,0,0,0,0,0,0,0,53000,0,0,0,65000,12000,53000,53000
053292,美律中信98購01  ,0,0,0,0,0,0,0,0,0,53000,0,0,0,63000,10000,53000,53000
050651,大立光凱基96購02,0,0,0,0,0,0,0,0,0,53000,0,0,0,53000,0,53000,53000
056904,大立光元大99購05,0,0,0,0,0,0,0,0,0,53000,0,0,0,53000,0,53000,53000
057805,華通元大98購06  ,0,0,0,0,0,0,0,0,0,53000,0,0,0,143000,90000,53000,53000
058659,力成中信99購01  ,0,0,0,0,0,0,0,0,0,53000,0,0,0,512000,459000,53000,53000
058791,鴻海元大99購17  ,0,0,0,0,0,0,0,0,0,53000,0,0,0,71000,18000,53000,53000
055916,奇鋐凱基99購01  ,0,0,0,0,0,0,0,0,0,53000,0,0,0,232000,179000,53000,53000
1310,台苯            ,248000,225000,23000,0,0,0,0,0,0,30000,0,0,0,38000,8000,30000,53000
2816,旺旺保          ,55000,2000,53000,0,0,0,0,0,0,0,0,0,0,0,0,0,53000
060595,台灣50凱基04購04,0,0,0,0,0,0,0,0,0,52000,0,0,0,62000,10000,52000,52000
06721P,臺股指中信9A售03,0,0,0,0,0,0,0,0,0,52000,0,0,0,52000,0,52000,52000
061427,旭富元大9A購02  ,0,0,0,0,0,0,0,0,0,52000,0,0,0,165000,113000,52000,52000
051483,玉晶光凱基96購02,0,0,0,0,0,0,0,0,0,52000,0,0,0,72000,20000,52000,52000
055112,晶豪科凱基98購01,0,0,0,0,0,0,0,0,0,52000,0,0,0,68000,16000,52000,52000
048696,台達電國票96購01,0,0,0,0,0,0,0,0,0,52000,0,0,0,52000,0,52000,52000
054045,奇力新元大97購03,0,0,0,0,0,0,0,0,0,52000,0,0,0,103000,51000,52000,52000
057724,亞德客國泰99購01,0,0,0,0,0,0,0,0,0,52000,0,0,0,374000,322000,52000,52000
052997,國巨康和96購01  ,0,0,0,0,0,0,0,0,0,52000,0,0,0,105000,53000,52000,52000
055359,超眾凱基97購01  ,0,0,0,0,0,0,0,0,0,52000,0,0,0,159000,107000,52000,52000
056954,聯詠富邦9A購01  ,0,0,0,0,0,0,0,0,0,52000,0,0,0,62000,10000,52000,52000
056801,國巨台新98購01  ,0,0,0,0,0,0,0,0,0,52000,0,0,0,98000,46000,52000,52000
058987,華新科凱基9B購01,0,10000,-10000,0,0,0,0,0,0,62000,0,0,0,65000,3000,62000,52000
1906,寶隆            ,56000,4000,52000,0,0,0,0,0,0,0,0,0,0,0,0,0,52000
5534,長虹            ,115000,74000,41000,0,0,0,1000,0,1000,10000,2000,0,2000,8000,0,8000,52000
06684P,緯穎元大98售06  ,0,0,0,0,0,0,0,0,0,51000,0,0,0,51000,0,51000,51000
060749,祥碩國票9A購01  ,0,0,0,0,0,0,0,0,0,51000,0,0,0,113000,62000,51000,51000
060476,瑞祺元大9A購02  ,0,0,0,0,0,0,0,0,0,51000,0,0,0,468000,417000,51000,51000
060560,欣興國泰9C購01  ,0,0,0,0,0,0,0,0,0,51000,0,0,0,87000,36000,51000,51000
059688,燿華永豐99購01  ,0,0,0,0,0,0,0,0,0,51000,0,0,0,71000,20000,51000,51000
059619,台積電日盛9A購04,0,0,0,0,0,0,0,0,0,51000,0,0,0,624000,573000,51000,51000
059453,奇力新永豐99購01,0,0,0,0,0,0,0,0,0,51000,0,0,0,61000,10000,51000,51000
051451,世芯元大95購03  ,0,0,0,0,0,0,0,0,0,51000,0,0,0,51000,0,51000,51000
050658,台郡麥證96購01  ,0,0,0,51000,0,51000,0,0,0,51000,0,0,0,51000,0,51000,51000
052544,牧德元富95購01  ,0,0,0,0,0,0,0,0,0,51000,0,0,0,52000,1000,51000,51000
058918,SGBR2X元富99購04,0,0,0,0,0,0,0,0,0,51000,0,0,0,51000,0,51000,51000
058930,華新科統一9B購01,0,0,0,0,0,0,0,0,0,51000,0,0,0,61000,10000,51000,51000
058800,健策元大99購03  ,0,0,0,0,0,0,0,0,0,51000,0,0,0,93000,42000,51000,51000
056075,瀚宇博元大97購03,0,0,0,0,0,0,0,0,0,51000,0,0,0,128000,77000,51000,51000
05551P,電子類元大96售01,0,0,0,0,0,0,0,0,0,51000,0,0,0,51000,0,51000,51000
055335,健策兆豐98購01  ,0,0,0,0,0,0,0,0,0,51000,0,0,0,60000,9000,51000,51000
058764,康友群益99購01  ,0,0,0,0,0,0,0,0,0,51000,0,0,0,149000,98000,51000,51000
055289,泰碩元大98購01  ,0,0,0,0,0,0,0,0,0,51000,0,0,0,51000,0,51000,51000
058580,華新科群益99購02,0,0,0,0,0,0,0,0,0,51000,0,0,0,55000,4000,51000,51000
056165,矽力凱基98購02  ,0,0,0,0,0,0,0,0,0,51000,0,0,0,51000,0,51000,51000
056243,創意群益97購03  ,0,0,0,0,0,0,0,0,0,51000,0,0,0,52000,1000,51000,51000
057147,新日興國票99購01,0,0,0,0,0,0,0,0,0,51000,0,0,0,51000,0,51000,51000
3686,達能            ,65000,14000,51000,0,0,0,0,0,0,0,0,0,0,0,0,0,51000
07178P,臺股指凱基99售20,0,0,0,0,0,0,0,0,0,51000,0,0,0,51000,0,51000,51000
07143P,FBVIX元大99售02 ,0,0,0,0,0,0,0,0,0,51000,0,0,0,51000,0,51000,51000
2354,鴻準            ,1113000,1062532,50468,0,0,0,0,0,0,0,0,0,0,0,0,0,50468
059543,可成亞東99購02  ,0,0,0,0,0,0,0,0,0,50000,0,0,0,50000,0,50000,50000
060055,宏達電凱基99購06,0,0,0,0,0,0,0,0,0,50000,0,0,0,50000,0,50000,50000
060091,技嘉元大99購03  ,0,0,0,0,0,0,0,0,0,50000,0,0,0,51000,1000,50000,50000
059769,滬深2X群益9C購01,0,0,0,0,0,0,0,0,0,50000,0,0,0,60000,10000,50000,50000
060653,全新群益9A購02  ,0,0,0,0,0,0,0,0,0,50000,0,0,0,126000,76000,50000,50000
060833,道瓊反國票9A購01,0,0,0,0,0,0,0,0,0,50000,0,0,0,50000,0,50000,50000
060869,超眾永豐9A購02  ,0,0,0,0,0,0,0,0,0,50000,0,0,0,50000,0,50000,50000
061322,華新科凱基9A購12,0,0,0,0,0,0,0,0,0,50000,0,0,0,70000,20000,50000,50000
061120,台積電永豐9A購03,0,0,0,0,0,0,0,0,0,50000,0,0,0,81000,31000,50000,50000
06897P,FBVIX群益01售01 ,0,0,0,0,0,0,0,0,0,50000,0,0,0,50000,0,50000,50000
07026P,超眾凱基99售03  ,0,0,0,0,0,0,0,0,0,50000,0,0,0,50000,0,50000,50000
06222P,致茂元富97售02  ,0,0,0,0,0,0,0,0,0,50000,0,0,0,50000,0,50000,50000
06332P,世紀鋼群益98售01,0,0,0,0,0,0,0,0,0,50000,0,0,0,55000,5000,50000,50000
050227,大立光中信96購01,0,0,0,0,0,0,0,0,0,50000,0,0,0,50000,0,50000,50000
052331,漢唐亞東97購01  ,0,0,0,0,0,0,0,0,0,50000,0,0,0,50000,0,50000,50000
050615,奇力新元大95購03,0,0,0,0,0,0,0,0,0,50000,0,0,0,50000,0,50000,50000
050793,大立光富邦96購03,0,0,0,0,0,0,0,0,0,50000,0,0,0,50000,0,50000,50000
051236,鴻海元大96購05  ,0,0,0,0,0,0,0,0,0,50000,0,0,0,50000,0,50000,50000
051267,美律富邦96購01  ,0,0,0,0,0,0,0,0,0,50000,0,0,0,50000,0,50000,50000
052579,亞泥元富96購01  ,0,0,0,0,0,0,0,0,0,50000,0,0,0,50000,0,50000,50000
053865,欣興元大97購02  ,0,0,0,0,0,0,0,0,0,50000,0,0,0,50000,0,50000,50000
048534,貿聯國票94購01  ,0,0,0,0,0,0,0,0,0,50000,0,0,0,50000,0,50000,50000
048601,智易國票94購03  ,0,0,0,0,0,0,0,0,0,50000,0,0,0,50000,0,50000,50000
03896P,長榮航凱基95售01,0,0,0,0,0,0,0,0,0,50000,0,0,0,50000,0,50000,50000
03737P,臺股指中信95售01,0,0,0,0,0,0,0,0,0,50000,0,0,0,50000,0,50000,50000
052971,京元電群益98購01,0,0,0,0,0,0,0,0,0,50000,0,0,0,50000,0,50000,50000
052974,瀚宇博群益96購01,0,0,0,0,0,0,0,0,0,50000,0,0,0,50000,0,50000,50000
052968,燿華群益98購01  ,0,0,0,0,0,0,0,0,0,50000,0,0,0,50000,0,50000,50000
054276,國巨群益96購07  ,0,0,0,0,0,0,0,0,0,50000,0,0,0,50000,0,50000,50000
054464,奇力新凱基98購02,0,0,0,0,0,0,0,0,0,50000,0,0,0,50000,0,50000,50000
054466,欣興凱基97購03  ,0,0,0,0,0,0,0,0,0,50000,0,0,0,69000,19000,50000,50000
054429,中石化台新97購01,0,0,0,0,0,0,0,0,0,50000,0,0,0,50000,0,50000,50000
052862,正崴凱基96購01  ,0,0,0,0,0,0,0,0,0,50000,0,0,0,50000,0,50000,50000
054197,台積電永昌96購07,0,0,0,0,0,0,0,0,0,50000,0,0,0,50000,0,50000,50000
057665,技嘉元大99購01  ,0,0,0,0,0,0,0,0,0,50000,0,0,0,50000,0,50000,50000
057632,傳奇永豐98購01  ,0,0,0,0,0,0,0,0,0,50000,0,0,0,50000,0,50000,50000
057945,京鼎國票99購03  ,0,0,0,0,0,0,0,0,0,50000,0,0,0,53000,3000,50000,50000
057823,神達元大98購01  ,0,0,0,0,0,0,0,0,0,50000,0,0,0,50000,0,50000,50000
057837,康控國泰99購02  ,0,0,0,0,0,0,0,0,0,50000,0,0,0,120000,70000,50000,50000
057870,大立光凱基99購02,0,0,0,0,0,0,0,0,0,50000,0,0,0,50000,0,50000,50000
052807,貿聯元大98購01  ,0,0,0,0,0,0,0,0,0,50000,0,0,0,50000,0,50000,50000
052726,鴻海元富96購03  ,0,0,0,0,0,0,0,0,0,50000,0,0,0,50000,0,50000,50000
053693,欣興元大96購05  ,0,0,0,0,0,0,0,0,0,50000,0,0,0,50000,0,50000,50000
053457,旺宏國泰98購03  ,0,0,0,0,0,0,0,0,0,50000,0,0,0,50000,0,50000,50000
054944,精元元大97購01  ,0,0,0,0,0,0,0,0,0,50000,0,0,0,50000,0,50000,50000
055182,京鼎統一98購01  ,0,0,0,0,0,0,0,0,0,50000,0,0,0,50000,0,50000,50000
054767,日電貿國票98購01,0,0,0,0,0,0,0,0,0,50000,0,0,0,50000,0,50000,50000
056112,勤誠永豐97購02  ,0,0,0,0,0,0,0,0,0,50000,0,0,0,50000,0,50000,50000
057803,上銀元大98購08  ,0,0,0,0,0,0,0,0,0,50000,0,0,0,50000,0,50000,50000
058401,華航元大9A購01  ,0,0,0,0,0,0,0,0,0,50000,0,0,0,50000,0,50000,50000
058616,台虹元大9A購01  ,0,0,0,0,0,0,0,0,0,50000,0,0,0,50000,0,50000,50000
056294,上銀元大97購11  ,0,0,0,0,0,0,0,0,0,50000,0,0,0,50000,0,50000,50000
055686,致伸凱基97購02  ,0,0,0,0,0,0,0,0,0,50000,0,0,0,50000,0,50000,50000
055846,大立光元大97購09,0,0,0,0,0,0,0,0,0,50000,0,0,0,50000,0,50000,50000
055841,南亞科元大97購04,0,0,0,0,0,0,0,0,0,50000,0,0,0,50000,0,50000,50000
055747,康舒元富97購01  ,0,0,0,0,0,0,0,0,0,50000,0,0,0,60000,10000,50000,50000
055793,臺股指凱基97購16,0,0,0,0,0,0,0,0,0,50000,0,0,0,50000,0,50000,50000
057976,旺宏永豐98購03  ,0,0,0,0,0,0,0,0,0,50000,0,0,0,50000,0,50000,50000
056362,聯發科元大99購01,0,0,0,0,0,0,0,0,0,50000,0,0,0,50000,0,50000,50000
056849,瀚宇博元富98購01,0,0,0,0,0,0,0,0,0,50000,0,0,0,50000,0,50000,50000
056726,友達日盛9A購01  ,0,0,0,0,0,0,0,0,0,50000,0,0,0,50000,0,50000,50000
056596,光磊元富98購01  ,0,0,0,0,0,0,0,0,0,50000,0,0,0,60000,10000,50000,50000
057305,南亞科兆豐98購02,0,0,0,0,0,0,0,0,0,50000,0,0,0,50000,0,50000,50000
058952,南茂群益99購01  ,0,0,0,0,0,0,0,0,0,50000,0,0,0,68000,18000,50000,50000
057378,康友元大98購02  ,0,0,0,0,0,0,0,0,0,50000,0,0,0,50000,0,50000,50000
05741P,聯發科元大96售14,0,0,0,0,0,0,0,0,0,50000,0,0,0,50000,0,50000,50000
05917P,宏達電元大96售02,0,0,0,0,0,0,0,0,0,50000,0,0,0,50000,0,50000,50000
059230,滬深2X國票9B購02,0,0,0,0,0,0,0,0,0,50000,0,0,0,50000,0,50000,50000
2374,佳能            ,51000,1000,50000,0,0,0,0,0,0,0,0,0,0,0,0,0,50000
07147P,高鐵元大99售01  ,0,0,0,0,0,0,0,0,0,50000,0,0,0,55000,5000,50000,50000
07287P,全新群益9B售01  ,0,0,0,0,0,0,0,0,0,50000,0,0,0,50000,0,50000,50000
07561P,玉晶光永豐9A售02,0,0,0,0,0,0,0,0,0,50000,0,0,0,80000,30000,50000,50000
07490P,大立光國票9A售03,0,0,0,0,0,0,0,0,0,50000,0,0,0,50000,0,50000,50000
060390,聯鈞群益9A購01  ,0,0,0,0,0,0,0,0,0,49000,0,0,0,133000,84000,49000,49000
06000P,GIS元大96售04   ,0,0,0,0,0,0,0,0,0,49000,0,0,0,56000,7000,49000,49000
059458,鎧勝永豐99購01  ,0,0,0,0,0,0,0,0,0,49000,0,0,0,49000,0,49000,49000
055136,聯發科富邦99購06,0,0,0,0,0,0,0,0,0,49000,0,0,0,49000,0,49000,49000
051157,華新科富邦98購01,0,0,0,0,0,0,0,0,0,49000,0,0,0,49000,0,49000,49000
05252P,華通凱基95售01  ,0,0,0,0,0,0,0,0,0,49000,0,0,0,49000,0,49000,49000
059142,道瓊指國票9B購02,0,0,0,0,0,0,0,0,0,49000,0,0,0,50000,1000,49000,49000
057353,玉晶光統一99購01,0,0,0,0,0,0,0,0,0,49000,0,0,0,60000,11000,49000,49000
056558,台達電群益98購01,0,0,0,0,0,0,0,0,0,49000,0,0,0,183000,134000,49000,49000
055333,晶豪科兆豐97購01,0,0,0,0,0,0,0,0,0,49000,0,0,0,131000,82000,49000,49000
058468,聯茂中信99購02  ,0,0,0,0,0,0,0,0,0,49000,0,0,0,190000,141000,49000,49000
058509,聯發科元大99購12,0,0,0,0,0,0,0,0,0,49000,0,0,0,522000,473000,49000,49000
058058,大立光元富9B購02,0,0,0,0,0,0,0,0,0,49000,0,0,0,61000,12000,49000,49000
08674P,嘉晶元富07售02  ,0,0,0,0,0,0,0,0,0,49000,0,0,0,49000,0,49000,49000
2399,映泰            ,136000,87000,49000,0,0,0,0,0,0,0,0,0,0,0,0,0,49000
060636,大毅永豐9A購02  ,0,0,0,0,0,0,0,0,0,48000,0,0,0,51000,3000,48000,48000
060561,台積電富邦04購01,0,0,0,0,0,0,0,0,0,48000,0,0,0,466000,418000,48000,48000
060456,正隆元大9A購01  ,0,0,0,0,0,0,0,0,0,48000,0,0,0,253000,205000,48000,48000
061176,聯發科凱基9A購14,0,0,0,0,0,0,0,0,0,48000,0,0,0,60000,12000,48000,48000
060822,華通元大9A購05  ,0,0,0,0,0,0,0,0,0,48000,0,0,0,122000,74000,48000,48000
053374,台達電元大96購03,0,0,0,0,0,0,0,0,0,48000,0,0,0,48000,0,48000,48000
053170,茂林群益96購04  ,0,0,0,0,0,0,0,0,0,48000,0,0,0,49000,1000,48000,48000
052759,京元電群益96購01,0,0,0,0,0,0,0,0,0,48000,0,0,0,98000,50000,48000,48000
057595,健鼎兆豐98購01  ,0,0,0,0,0,0,0,0,0,48000,0,0,0,120000,72000,48000,48000
054339,聯詠統一96購02  ,0,0,0,0,0,0,0,0,0,48000,0,0,0,48000,0,48000,48000
057110,立積群益98購01  ,0,0,0,0,0,0,0,0,0,48000,0,0,0,135000,87000,48000,48000
058421,國泰金麥證01購01,0,0,0,50000,2000,48000,0,0,0,48000,0,0,0,50000,2000,48000,48000
058534,友達統一9B購01  ,0,0,0,0,0,0,0,0,0,48000,0,0,0,48000,0,48000,48000
058510,全新元大9B購02  ,0,0,0,0,0,0,0,0,0,48000,0,0,0,58000,10000,48000,48000
056462,訊芯凱基98購03  ,0,0,0,0,0,0,0,0,0,48000,0,0,0,86000,38000,48000,48000
057424,訊芯凱基98購04  ,0,0,0,0,0,0,0,0,0,48000,0,0,0,136000,88000,48000,48000
057499,奇鋐群益98購01  ,0,0,0,0,0,0,0,0,0,48000,0,0,0,70000,22000,48000,48000
061036,晶技永豐9A購03  ,0,0,0,0,0,0,0,0,0,47000,0,0,0,131000,84000,47000,47000
061156,玉晶光群益9A購07,0,0,0,0,0,0,0,0,0,47000,0,0,0,48000,1000,47000,47000
06214P,國巨國票98售04  ,20000,0,20000,0,0,0,0,0,0,27000,0,0,0,99000,72000,27000,47000
07109P,聯發科中信9B售02,0,0,0,0,0,0,0,0,0,47000,0,0,0,152000,105000,47000,47000
06682P,玉晶光元大99售08,0,0,0,0,0,0,0,0,0,47000,0,0,0,47000,0,47000,47000
060617,華新科元大9A購08,0,0,0,0,0,0,0,0,0,47000,0,0,0,49000,2000,47000,47000
060094,聯發科元大99購41,0,0,0,0,0,0,0,0,0,47000,0,0,0,100000,53000,47000,47000
059704,聯發科凱基9A購08,0,0,0,0,0,0,0,0,0,47000,0,0,0,107000,60000,47000,47000
059751,華通群益9B購03  ,0,0,0,0,0,0,0,0,0,47000,0,0,0,49000,2000,47000,47000
059820,南亞科凱基99購07,0,0,0,0,0,0,0,0,0,47000,0,0,0,83000,36000,47000,47000
059915,聯發科元大99購32,0,0,0,0,0,0,0,0,0,47000,0,0,0,406000,359000,47000,47000
054881,光罩統一97購01  ,0,0,0,0,0,0,0,0,0,47000,0,0,0,107000,60000,47000,47000
059339,上銀凱基99購06  ,0,0,0,0,0,0,0,0,0,47000,0,0,0,77000,30000,47000,47000
056705,超眾國泰99購01  ,0,0,0,0,0,0,0,0,0,47000,0,0,0,83000,36000,47000,47000
056846,晶相光元富98購01,0,0,0,0,0,0,0,0,0,47000,0,0,0,232000,185000,47000,47000
055776,宏達電凱基98購02,0,0,0,0,0,0,0,0,0,47000,0,0,0,67000,20000,47000,47000
6112,聚碩            ,59000,12000,47000,0,0,0,0,0,0,0,0,0,0,0,0,0,47000
060088,國巨元大99購30  ,0,0,0,0,0,0,0,0,0,46000,0,0,0,202000,156000,46000,46000
060591,富邦金台新9A購01,0,0,0,0,0,0,0,0,0,46000,0,0,0,46000,0,46000,46000
061017,國泰金麥證9A購01,0,0,0,58000,12000,46000,0,0,0,46000,0,0,0,58000,12000,46000,46000
060817,華邦電台新9A購01,0,0,0,0,0,0,0,0,0,46000,0,0,0,144000,98000,46000,46000
054868,國泰金群益9A購01,0,0,0,0,0,0,0,0,0,46000,0,0,0,46000,0,46000,46000
054720,禾伸堂永豐97購01,0,0,0,0,0,0,0,0,0,46000,0,0,0,50000,4000,46000,46000
05412P,泰碩國票95售02  ,0,0,0,0,0,0,0,0,0,46000,0,0,0,66000,20000,46000,46000
047768,大立光元大95購01,0,0,0,0,0,0,0,0,0,46000,0,0,0,46000,0,46000,46000
00666R,富邦恒生國企反1 ,0,4000,-4000,0,0,0,0,0,0,50000,0,0,0,130000,80000,50000,46000
00650L,FH香港正2       ,0,0,0,0,0,0,0,0,0,46000,0,0,0,417000,371000,46000,46000
058463,宏達電兆豐99購02,0,0,0,0,0,0,0,0,0,46000,0,0,0,46000,0,46000,46000
056496,康控國泰99購01  ,0,0,0,0,0,0,0,0,0,46000,0,0,0,152000,106000,46000,46000
056366,玉晶光元大99購04,0,0,0,0,0,0,0,0,0,46000,0,0,0,51000,5000,46000,46000
059300,國巨群益99購08  ,0,0,0,0,0,0,0,0,0,46000,0,0,0,47000,1000,46000,46000
059214,國巨元大99購20  ,0,0,0,0,0,0,0,0,0,46000,0,0,0,65000,19000,46000,46000
1902,台紙            ,128000,82000,46000,0,0,0,0,0,0,0,0,0,0,0,0,0,46000
1626,艾美特-KY       ,71000,25000,46000,0,0,0,0,0,0,0,0,0,0,0,0,0,46000
060867,智伸科永豐9A購01,0,30000,-30000,0,0,0,0,0,0,75000,0,0,0,75000,0,75000,45000
060776,世芯凱基9B購01  ,0,0,0,0,0,0,0,0,0,45000,0,0,0,398000,353000,45000,45000
07022P,嘉晶永豐99售02  ,0,0,0,0,0,0,0,0,0,45000,0,0,0,45000,0,45000,45000
06424P,大成鋼永豐97售01,0,0,0,0,0,0,0,0,0,45000,0,0,0,55000,10000,45000,45000
060562,旺宏富邦9C購02  ,0,0,0,0,0,0,0,0,0,45000,0,0,0,61000,16000,45000,45000
060555,台表科凱基9A購03,0,0,0,0,0,0,0,0,0,45000,0,0,0,45000,0,45000,45000
060503,技嘉元大9A購01  ,0,0,0,0,0,0,0,0,0,45000,0,0,0,68000,23000,45000,45000
059791,超眾元大99購06  ,0,0,0,0,0,0,0,0,0,45000,0,0,0,88000,43000,45000,45000
055023,億光國泰98購01  ,0,0,0,0,0,0,0,0,0,45000,0,0,0,45000,0,45000,45000
054918,華新科凱基98購02,0,0,0,0,0,0,0,0,0,45000,0,0,0,45000,0,45000,45000
056087,世芯統一97購01  ,0,0,0,0,0,0,0,0,0,45000,0,0,0,45000,0,45000,45000
056863,義隆群益98購01  ,0,0,0,0,0,0,0,0,0,45000,0,0,0,60000,15000,45000,45000
056897,南亞科元大98購02,0,0,0,0,0,0,0,0,0,45000,0,0,0,62000,17000,45000,45000
056890,國巨元大98購11  ,0,0,0,0,0,0,0,0,0,45000,0,0,0,47000,2000,45000,45000
056703,群創國泰9A購01  ,0,0,0,0,0,0,0,0,0,45000,0,0,0,65000,20000,45000,45000
058061,貿聯元富9B購01  ,0,0,0,0,0,0,0,0,0,45000,0,0,0,100000,55000,45000,45000
055842,建準元大98購01  ,0,0,0,0,0,0,0,0,0,45000,0,0,0,45000,0,45000,45000
055935,創意群益97購02  ,0,0,0,0,0,0,0,0,0,45000,0,0,0,99000,54000,45000,45000
058760,嘉晶群益9A購01  ,0,0,0,0,0,0,0,0,0,45000,0,0,0,287000,242000,45000,45000
07786P,南電中信9C售01  ,0,0,0,0,0,0,0,0,0,45000,0,0,0,51000,6000,45000,45000
07243P,台灣50凱基9A售04,0,0,0,0,0,0,0,0,0,45000,0,0,0,63000,18000,45000,45000
060044,大立光群益99購09,0,0,0,0,0,0,0,0,0,44000,0,0,0,44000,0,44000,44000
060131,GIS永豐99購03   ,0,0,0,0,0,0,0,0,0,44000,0,0,0,64000,20000,44000,44000
07014P,華通元大99售04  ,0,0,0,0,0,0,0,0,0,44000,0,0,0,67000,23000,44000,44000
061033,台光電永豐9A購01,0,0,0,0,0,0,0,0,0,44000,0,0,0,44000,0,44000,44000
057719,欣興元富02購01  ,0,0,0,0,0,0,0,0,0,44000,0,0,0,44000,0,44000,44000
051428,玉晶光統一96購01,0,0,0,0,0,0,0,0,0,44000,0,0,0,140000,96000,44000,44000
052610,貿聯元大97購01  ,0,0,0,0,0,0,0,0,0,44000,0,0,0,44000,0,44000,44000
049675,台光電國票95購01,0,0,0,0,0,0,0,0,0,44000,0,0,0,44000,0,44000,44000
05194P,玉晶光康和95售01,0,0,0,0,0,0,0,0,0,44000,0,0,0,244000,200000,44000,44000
055962,晶豪科元大97購02,0,0,0,0,0,0,0,0,0,44000,0,0,0,106000,62000,44000,44000
055838,致茂元大97購03  ,0,0,0,0,0,0,0,0,0,44000,0,0,0,54000,10000,44000,44000
057148,玉晶光國票99購04,0,0,0,0,0,0,0,0,0,44000,0,0,0,61000,17000,44000,44000
058801,致伸元大99購01  ,0,0,0,0,0,0,0,0,0,44000,0,0,0,274000,230000,44000,44000
2471,資通            ,316000,285000,31000,0,0,0,0,0,0,13000,13000,0,13000,0,0,0,44000
4141,龍燈-KY         ,54000,10000,44000,0,0,0,0,0,0,0,0,0,0,0,0,0,44000
061339,京元電元大9A購05,0,0,0,0,0,0,0,0,0,43000,0,0,0,93000,50000,43000,43000
060295,貿聯元大9A購03  ,0,0,0,0,0,0,0,0,0,43000,0,0,0,45000,2000,43000,43000
060429,南六永豐9A購01  ,0,0,0,0,0,0,0,0,0,43000,0,0,0,151000,108000,43000,43000
059988,大立光元大9A購02,0,0,0,0,0,0,0,0,0,43000,0,0,0,53000,10000,43000,43000
059764,健策永豐99購04  ,0,0,0,0,0,0,0,0,0,43000,0,0,0,43000,0,43000,43000
059889,華新科國票99購04,0,0,0,0,0,0,0,0,0,43000,0,0,0,50000,7000,43000,43000
059434,全新元大99購05  ,0,0,0,0,0,0,0,0,0,43000,0,0,0,48000,5000,43000,43000
03680C,臺股指凱基9A牛26,0,0,0,0,0,0,0,0,0,43000,0,0,0,342000,299000,43000,43000
052682,上銀元大97購01  ,0,0,0,0,0,0,0,0,0,43000,0,0,0,53000,10000,43000,43000
053719,可成凱基96購08  ,0,0,0,0,0,0,0,0,0,43000,0,0,0,63000,20000,43000,43000
056764,友達元大9A購03  ,0,0,0,0,0,0,0,0,0,43000,0,0,0,45000,2000,43000,43000
057182,禾伸堂元大99購02,0,0,0,0,0,0,0,0,0,43000,0,0,0,53000,10000,43000,43000
057812,友達元大9A購05  ,0,0,0,0,0,0,0,0,0,43000,0,0,0,263000,220000,43000,43000
055300,緯穎元大98購01  ,0,0,0,0,0,0,0,0,0,43000,0,0,0,43000,0,43000,43000
058693,旭富國票9A購01  ,0,0,0,0,0,0,0,0,0,43000,0,0,0,58000,15000,43000,43000
07194P,聯發科元大99售25,0,0,0,0,0,0,0,0,0,43000,0,0,0,47000,4000,43000,43000
07129P,華新科元大99售14,0,0,0,0,0,0,0,0,0,43000,0,0,0,120000,77000,43000,43000
07408P,台積電兆豐99售06,0,0,0,0,0,0,0,0,0,43000,0,0,0,53000,10000,43000,43000
059666,台表科元大9B購01,0,0,0,0,0,0,0,0,0,42000,0,0,0,46000,4000,42000,42000
060678,聯詠元大9A購03  ,0,0,0,0,0,0,0,0,0,42000,0,0,0,73000,31000,42000,42000
060250,台表科元大9A購01,0,0,0,0,0,0,0,0,0,42000,0,0,0,57000,15000,42000,42000
060162,碩天永豐9A購01  ,0,0,0,0,0,0,0,0,0,42000,0,0,0,42000,0,42000,42000
061038,TPK永豐9A購01   ,0,0,0,0,0,0,0,0,0,42000,0,0,0,100000,58000,42000,42000
060770,宏達電麥證9A購01,0,0,0,42000,0,42000,0,0,0,42000,0,0,0,42000,0,42000,42000
060806,華新科群益9A購03,0,0,0,0,0,0,0,0,0,42000,0,0,0,73000,31000,42000,42000
06954P,大立光元富99售01,0,0,0,0,0,0,0,0,0,42000,0,0,0,117000,75000,42000,42000
06479P,聯發科中信99售02,0,0,0,0,0,0,0,0,0,42000,0,0,0,52000,10000,42000,42000
061424,華新科元大9A購18,0,0,0,0,0,0,0,0,0,42000,0,0,0,57000,15000,42000,42000
052447,聯發科元大96購04,0,0,0,0,0,0,0,0,0,42000,0,0,0,98000,56000,42000,42000
057934,華新科群益98購07,0,0,0,0,0,0,0,0,0,42000,0,0,0,42000,0,42000,42000
057888,貿聯群益98購02  ,0,0,0,0,0,0,0,0,0,42000,0,0,0,54000,12000,42000,42000
054333,茂林永豐96購03  ,0,0,0,0,0,0,0,0,0,42000,0,0,0,42000,0,42000,42000
053506,南茂兆豐97購01  ,0,0,0,0,0,0,0,0,0,42000,0,0,0,42000,0,42000,42000
058687,聯茂凱基9A購01  ,0,0,0,0,0,0,0,0,0,42000,0,0,0,48000,6000,42000,42000
058248,聯茂元大99購05  ,0,0,0,0,0,0,0,0,0,42000,0,0,0,50000,8000,42000,42000
056928,旺宏台新98購01  ,0,0,0,0,0,0,0,0,0,42000,0,0,0,42000,0,42000,42000
059287,華通元富99購03  ,0,0,0,0,0,0,0,0,0,42000,0,0,0,42000,0,42000,42000
059334,A50正2國票9A購02,0,0,0,0,0,0,0,0,0,42000,0,0,0,63000,21000,42000,42000
059022,聯發科統一9B購04,0,0,0,0,0,0,0,0,0,42000,0,0,0,44000,2000,42000,42000
07163P,臺股指群益99售14,0,0,0,0,0,0,0,0,0,42000,0,0,0,66000,24000,42000,42000
07729P,臺股指凱基9A售21,0,0,0,0,0,0,0,0,0,42000,0,0,0,96000,54000,42000,42000
1524,耿鼎            ,43000,1000,42000,0,0,0,0,0,0,0,0,0,0,0,0,0,42000
060791,聯茂富邦9A購02  ,0,0,0,0,0,0,0,0,0,41000,0,0,0,157000,116000,41000,41000
060734,華通統一9C購01  ,0,0,0,0,0,0,0,0,0,41000,0,0,0,53000,12000,41000,41000
060944,國泰金國票9A購01,0,0,0,0,0,0,0,0,0,41000,0,0,0,74000,33000,41000,41000
060947,台積電統一9C購03,0,0,0,0,0,0,0,0,0,41000,0,0,0,46000,5000,41000,41000
060213,牧德康和9A購01  ,0,0,0,0,0,0,0,0,0,41000,0,0,0,53000,12000,41000,41000
059360,全新永豐99購02  ,0,0,0,0,0,0,0,0,0,41000,0,0,0,41000,0,41000,41000
059917,華新科元大99購19,0,0,0,0,0,0,0,0,0,41000,0,0,0,41000,0,41000,41000
054872,瀚宇博群益98購01,0,0,0,0,0,0,0,0,0,41000,0,0,0,44000,3000,41000,41000
054738,聯發科凱基97購01,0,0,0,0,0,0,0,0,0,41000,0,0,0,47000,6000,41000,41000
051026,健策統一96購01  ,0,0,0,0,0,0,0,0,0,41000,0,0,0,97000,56000,41000,41000
058975,台灣50凱基01購02,0,0,0,0,0,0,0,0,0,41000,0,0,0,41000,0,41000,41000
057498,台郡元大98購04  ,0,0,0,0,0,0,0,0,0,41000,0,0,0,153000,112000,41000,41000
056743,貿聯凱基98購04  ,0,0,0,0,0,0,0,0,0,41000,0,0,0,41000,0,41000,41000
057301,嘉聯益永豐98購02,0,0,0,0,0,0,0,0,0,41000,0,0,0,41000,0,41000,41000
056998,麗豐康和98購01  ,0,0,0,0,0,0,0,0,0,41000,0,0,0,41000,0,41000,41000
05710P,禾伸堂國票97售02,0,0,0,0,0,0,0,0,0,41000,0,0,0,46000,5000,41000,41000
058727,嘉晶富邦9A購01  ,0,0,0,0,0,0,0,0,0,41000,0,0,0,100000,59000,41000,41000
1612,宏泰            ,41000,0,41000,0,0,0,0,0,0,0,0,0,0,0,0,0,41000
3504,揚明光          ,92000,51000,41000,0,0,0,0,0,0,0,0,0,0,0,0,0,41000
2457,飛宏            ,158000,117000,41000,0,0,0,0,0,0,0,0,0,0,0,0,0,41000
2423,固緯            ,44000,3000,41000,0,0,0,0,0,0,0,0,0,0,0,0,0,41000
059821,美律凱基99購08  ,0,0,0,0,0,0,0,0,0,40000,0,0,0,40000,0,40000,40000
060024,T50反1國泰9B購02,0,0,0,0,0,0,0,0,0,40000,0,0,0,40000,0,40000,40000
059552,台灣50凱基99購04,0,0,0,0,0,0,0,0,0,40000,0,0,0,40000,0,40000,40000
059654,T50反1元大99購09,0,0,0,0,0,0,0,0,0,40000,0,0,0,50000,10000,40000,40000
059711,滬深2X元大9C購02,0,0,0,0,0,0,0,0,0,40000,0,0,0,40000,0,40000,40000
059743,開發金元富99購01,0,0,0,0,0,0,0,0,0,40000,0,0,0,60000,20000,40000,40000
059630,美律凱基99購07  ,0,0,0,0,0,0,0,0,0,40000,0,0,0,50000,10000,40000,40000
060267,上緯控國票9C購01,0,0,0,0,0,0,0,0,0,40000,0,0,0,82000,42000,40000,40000
060383,葡萄王凱基9A購01,0,0,0,0,0,0,0,0,0,40000,0,0,0,80000,40000,40000,40000
060501,鴻海元大9A購13  ,0,0,0,0,0,0,0,0,0,40000,0,0,0,40000,0,40000,40000
060967,鈺齊凱基9A購02  ,0,0,0,0,0,0,0,0,0,40000,0,0,0,344000,304000,40000,40000
061362,台塑國票9B購01  ,0,0,0,0,0,0,0,0,0,40000,0,0,0,40000,0,40000,40000
06618P,智邦元大98售04  ,0,0,0,0,0,0,0,0,0,40000,0,0,0,40000,0,40000,40000
050850,訊連國票96購01  ,0,0,0,0,0,0,0,0,0,40000,0,0,0,40000,0,40000,40000
052511,聯發科凱基95購14,0,0,0,0,0,0,0,0,0,40000,0,0,0,60000,20000,40000,40000
049697,群創元大98購01  ,0,0,0,0,0,0,0,0,0,40000,0,0,0,40000,0,40000,40000
049926,智易元大95購02  ,0,0,0,0,0,0,0,0,0,40000,0,0,0,40000,0,40000,40000
052575,茂林凱基96購04  ,0,0,0,0,0,0,0,0,0,40000,0,0,0,40000,0,40000,40000
050138,台表科國票95購02,0,0,0,0,0,0,0,0,0,40000,0,0,0,40000,0,40000,40000
055133,致新康和97購01  ,0,0,0,0,0,0,0,0,0,40000,0,0,0,40000,0,40000,40000
053965,聯電元大98購04  ,0,0,0,0,0,0,0,0,0,40000,0,0,0,40000,0,40000,40000
052076,可成元富98購01  ,0,0,0,0,0,0,0,0,0,40000,0,0,0,60000,20000,40000,40000
052167,亞泥元大96購01  ,0,0,0,0,0,0,0,0,0,40000,0,0,0,40000,0,40000,40000
054590,嘉聯益國泰98購01,0,0,0,0,0,0,0,0,0,40000,0,0,0,126000,86000,40000,40000
053495,聯發科兆豐96購02,0,0,0,0,0,0,0,0,0,40000,0,0,0,40000,0,40000,40000
052809,訊芯元大97購01  ,0,0,0,0,0,0,0,0,0,40000,0,0,0,40000,0,40000,40000
058684,健策凱基99購02  ,0,0,0,0,0,0,0,0,0,40000,0,0,0,60000,20000,40000,40000
058781,康友國票9A購01  ,0,0,0,0,0,0,0,0,0,40000,0,0,0,44000,4000,40000,40000
055843,美律元大97購02  ,0,0,0,0,0,0,0,0,0,40000,0,0,0,40000,0,40000,40000
055791,臺股指凱基97購14,0,0,0,0,0,0,0,0,0,40000,0,0,0,40000,0,40000,40000
056197,友訊永豐97購01  ,0,0,0,0,0,0,0,0,0,40000,0,0,0,539000,499000,40000,40000
056181,百和元富97購02  ,0,0,0,0,0,0,0,0,0,40000,0,0,0,40000,0,40000,40000
05813P,臺股指國票96售06,0,0,0,0,0,0,0,0,0,40000,0,0,0,50000,10000,40000,40000
058237,嘉晶元大99購04  ,0,0,0,0,0,0,0,0,0,40000,0,0,0,158000,118000,40000,40000
058080,台積電群益98購06,0,0,0,0,0,0,0,0,0,40000,0,0,0,63000,23000,40000,40000
058464,矽創兆豐9A購01  ,0,0,0,0,0,0,0,0,0,40000,0,0,0,40000,0,40000,40000
056549,嘉聯益凱基98購04,0,0,0,0,0,0,0,0,0,40000,0,0,0,40000,0,40000,40000
056560,旺宏群益98購03  ,0,0,0,0,0,0,0,0,0,40000,0,0,0,40000,0,40000,40000
056701,國產國泰9A購01  ,0,0,0,0,0,0,0,0,0,40000,0,0,0,40000,0,40000,40000
056625,致伸永豐98購01  ,0,0,0,0,0,0,0,0,0,40000,0,0,0,40000,0,40000,40000
057172,南亞科元大98購03,0,0,0,0,0,0,0,0,0,40000,0,0,0,140000,100000,40000,40000
056464,臺股指凱基99購06,0,0,0,0,0,0,0,0,0,40000,0,0,0,40000,0,40000,40000
058936,國喬中信99購01  ,0,0,0,0,0,0,0,0,0,40000,0,0,0,50000,10000,40000,40000
058911,茂林元大99購04  ,0,0,0,0,0,0,0,0,0,40000,0,0,0,205000,165000,40000,40000
058829,華新科永豐99購04,0,0,0,0,0,0,0,0,0,40000,0,0,0,60000,20000,40000,40000
059268,鎧勝中信01購01  ,0,0,0,0,0,0,0,0,0,40000,0,0,0,40000,0,40000,40000
2239,英利-KY         ,47000,7000,40000,0,0,0,0,0,0,0,0,0,0,0,0,0,40000
1522,堤維西          ,102000,52000,50000,0,0,0,0,0,0,-10000,0,0,0,0,10000,-10000,40000
07135P,臺股指元大9A售29,0,0,0,0,0,0,0,0,0,40000,0,0,0,40000,0,40000,40000
07409P,台積電台新99售07,0,0,0,0,0,0,0,0,0,40000,0,0,0,40000,0,40000,40000
07442P,華航康和9A售02  ,0,0,0,0,0,0,0,0,0,40000,0,0,0,205000,165000,40000,40000
06653P,美食元大98售02  ,0,0,0,0,0,0,0,0,0,39000,0,0,0,141000,102000,39000,39000
07126P,台積電元大99售23,0,0,0,0,0,0,0,0,0,39000,0,0,0,39000,0,39000,39000
061100,SP黃豆元大9A購04,0,0,0,0,0,0,0,0,0,39000,0,0,0,45000,6000,39000,39000
060716,新唐永豐9A購01  ,0,0,0,0,0,0,0,0,0,39000,0,0,0,146000,107000,39000,39000
060224,台灣50元大9A購09,0,0,0,0,0,0,0,0,0,39000,0,0,0,39000,0,39000,39000
059992,S&P正2元富9B購04,0,0,0,0,0,0,0,0,0,39000,0,0,0,40000,1000,39000,39000
052858,華通凱基97購02  ,0,0,0,0,0,0,0,0,0,39000,0,0,0,99000,60000,39000,39000
057859,神達康和98購01  ,0,0,0,0,0,0,0,0,0,39000,0,0,0,57000,18000,39000,39000
053800,華通凱基97購03  ,0,0,0,0,0,0,0,0,0,39000,0,0,0,39000,0,39000,39000
050884,聯茂國泰96購01  ,0,0,0,0,0,0,0,0,0,39000,0,0,0,62000,23000,39000,39000
051321,建準國票96購01  ,0,0,0,0,0,0,0,0,0,39000,0,0,0,39000,0,39000,39000
059115,美食永豐99購01  ,0,0,0,0,0,0,0,0,0,39000,0,0,0,65000,26000,39000,39000
057404,貿聯群益99購01  ,0,0,0,0,0,0,0,0,0,39000,0,0,0,137000,98000,39000,39000
057306,玉晶光兆豐99購01,0,0,0,0,0,0,0,0,0,39000,0,0,0,39000,0,39000,39000
056755,聯茂兆豐98購01  ,0,0,0,0,0,0,0,0,0,39000,0,0,0,39000,0,39000,39000
058271,訊連永豐99購01  ,0,0,0,0,0,0,0,0,0,39000,0,0,0,93000,54000,39000,39000
055689,台郡凱基99購01  ,0,0,0,0,0,0,0,0,0,39000,0,0,0,44000,5000,39000,39000
058550,南亞科永豐99購01,0,0,0,0,0,0,0,0,0,39000,0,0,0,39000,0,39000,39000
07710P,華擎元大9A售05  ,0,0,0,0,0,0,0,0,0,39000,0,0,0,39000,0,39000,39000
059835,聯發科國泰9B購01,0,0,0,0,0,0,0,0,0,38000,0,0,0,767000,729000,38000,38000
061376,瑞昱永豐9A購02  ,0,0,0,0,0,0,0,0,0,38000,0,0,0,39000,1000,38000,38000
060730,台積電群益9A購03,0,0,0,0,0,0,0,0,0,38000,0,0,0,39000,1000,38000,38000
060786,聯發科富邦9B購06,0,0,0,0,0,0,0,0,0,38000,0,0,0,38000,0,38000,38000
052016,神基永豐95購01  ,0,0,0,0,0,0,0,0,0,38000,0,0,0,38000,0,38000,38000
047024,奇力新元大95購01,0,0,0,0,0,0,0,0,0,38000,0,0,0,38000,0,38000,38000
053320,華新科群益97購01,0,0,0,0,0,0,0,0,0,38000,0,0,0,55000,17000,38000,38000
055415,禾伸堂富邦9B購01,0,0,0,0,0,0,0,0,0,38000,0,0,0,44000,6000,38000,38000
055615,宏達電國票99購02,0,0,0,0,0,0,0,0,0,38000,0,0,0,38000,0,38000,38000
055830,上銀元大97購07  ,0,0,0,0,0,0,0,0,0,38000,0,0,0,50000,12000,38000,38000
058107,全新台新99購01  ,0,0,0,0,0,0,0,0,0,38000,0,0,0,38000,0,38000,38000
056739,美律凱基98購04  ,0,0,0,0,0,0,0,0,0,38000,0,0,0,38000,0,38000,38000
056616,台光電永豐98購01,0,0,0,0,0,0,0,0,0,38000,0,0,0,97000,59000,38000,38000
056699,光罩國泰99購01  ,0,0,0,0,0,0,0,0,0,38000,0,0,0,38000,0,38000,38000
056518,美律國票99購01  ,0,0,0,0,0,0,0,0,0,38000,0,0,0,38000,0,38000,38000
057277,可成元大98購05  ,0,0,0,0,0,0,0,0,0,38000,0,0,0,49000,11000,38000,38000
057216,聯發科群益99購01,0,0,0,0,0,0,0,0,0,38000,0,0,0,38000,0,38000,38000
058839,瑞儀中信99購02  ,0,0,0,0,0,0,0,0,0,38000,0,0,0,64000,26000,38000,38000
058902,聯發科元大99購15,0,0,0,0,0,0,0,0,0,38000,0,0,0,104000,66000,38000,38000
059037,宏達電群益99購02,0,0,0,0,0,0,0,0,0,38000,0,0,0,45000,7000,38000,38000
07721P,台積電凱基9A售22,0,0,0,0,0,0,0,0,0,38000,0,0,0,38000,0,38000,38000
07775P,國巨群益9A售10  ,0,0,0,0,0,0,0,0,0,38000,0,0,0,48000,10000,38000,38000
2939,凱羿-KY         ,65000,27000,38000,0,0,0,0,0,0,0,0,0,0,0,0,0,38000
061109,臻鼎元大9A購03  ,0,0,0,0,0,0,0,0,0,37000,0,0,0,37000,0,37000,37000
060168,台表科永豐9A購01,0,0,0,0,0,0,0,0,0,37000,0,0,0,39000,2000,37000,37000
060341,國巨統一9C購02  ,0,0,0,0,0,0,0,0,0,37000,0,0,0,59000,22000,37000,37000
060509,宏達電元大9A購02,0,0,0,0,0,0,0,0,0,37000,0,0,0,105000,68000,37000,37000
053635,技嘉永豐96購01  ,0,0,0,0,0,0,0,0,0,37000,0,0,0,41000,4000,37000,37000
051774,聯茂中信96購01  ,0,0,0,0,0,0,0,0,0,37000,0,0,0,110000,73000,37000,37000
051028,台光電元富95購02,0,0,0,0,0,0,0,0,0,37000,0,0,0,37000,0,37000,37000
059024,大立光統一9B購04,0,0,0,0,0,0,0,0,0,37000,0,0,0,37000,0,37000,37000
056623,禾伸堂永豐98購01,0,0,0,0,0,0,0,0,0,37000,0,0,0,117000,80000,37000,37000
055829,上銀元大97購06  ,0,0,0,0,0,0,0,0,0,37000,0,0,0,37000,0,37000,37000
055619,同欣電國票98購02,0,0,0,0,0,0,0,0,0,37000,0,0,0,37000,0,37000,37000
056264,聯發科統一98購02,0,0,0,0,0,0,0,0,0,37000,0,0,0,37000,0,37000,37000
2801,彰銀            ,2680477,1843988,836489,0,0,0,8000,780000,-772000,-28000,2000,30000,-28000,0,0,0,36489
060514,南電元大9A購02  ,0,0,0,0,0,0,0,0,0,36000,0,0,0,36000,0,36000,36000
060571,京元電永豐9A購01,0,0,0,0,0,0,0,0,0,36000,0,0,0,50000,14000,36000,36000
060582,玉晶光群益9C購01,0,0,0,0,0,0,0,0,0,36000,0,0,0,36000,0,36000,36000
060208,卜蜂康和9A購01  ,0,0,0,0,0,0,0,0,0,36000,0,0,0,136000,100000,36000,36000
060026,聯發科富邦9B購05,0,0,0,0,0,0,0,0,0,36000,0,0,0,186000,150000,36000,36000
059363,超眾永豐99購02  ,0,0,0,0,0,0,0,0,0,36000,0,0,0,49000,13000,36000,36000
061374,力山永豐9A購04  ,0,0,0,0,0,0,0,0,0,36000,0,0,0,164000,128000,36000,36000
061016,可成麥證9A購01  ,0,0,0,50000,14000,36000,0,0,0,36000,0,0,0,50000,14000,36000,36000
048732,台勝科麥證95購01,0,0,0,36000,0,36000,0,0,0,36000,0,0,0,36000,0,36000,36000
052768,泰鼎群益96購01  ,0,0,0,0,0,0,0,0,0,36000,0,0,0,50000,14000,36000,36000
052885,高鐵兆豐98購01  ,0,0,0,0,0,0,0,0,0,36000,0,0,0,36000,0,36000,36000
058536,群創統一9B購01  ,0,0,0,0,0,0,0,0,0,36000,0,0,0,36000,0,36000,36000
058629,嘉晶國票9A購01  ,0,0,0,0,0,0,0,0,0,36000,0,0,0,70000,34000,36000,36000
05577P,上銀凱基96售02  ,0,0,0,0,0,0,0,0,0,36000,0,0,0,37000,1000,36000,36000
058233,聯發科元大99購06,0,0,0,0,0,0,0,0,0,36000,0,0,0,172000,136000,36000,36000
058216,TPK群益99購01   ,0,0,0,0,0,0,0,0,0,36000,0,0,0,172000,136000,36000,36000
056608,力山永豐98購01  ,0,0,0,0,0,0,0,0,0,36000,0,0,0,36000,0,36000,36000
056911,緯穎元大99購01  ,0,0,0,0,0,0,0,0,0,36000,0,0,0,124000,88000,36000,36000
057536,康控元大99購03  ,0,0,0,0,0,0,0,0,0,36000,0,0,0,162000,126000,36000,36000
4137,麗豐-KY         ,78000,78000,0,0,0,0,27000,0,27000,9000,0,0,0,11000,2000,9000,36000
6165,捷泰            ,70000,34000,36000,0,0,0,0,0,0,0,0,0,0,0,0,0,36000
07714P,世紀鋼元大9A售03,0,0,0,0,0,0,0,0,0,36000,0,0,0,49000,13000,36000,36000
07579P,聯茂元大9A售01  ,0,0,0,0,0,0,0,0,0,36000,0,0,0,273000,237000,36000,36000
8499,鼎炫-KY         ,49000,13000,36000,0,0,0,0,0,0,0,0,0,0,0,0,0,36000
060863,聯發科永豐9A購02,0,0,0,0,0,0,0,0,0,35000,0,0,0,57000,22000,35000,35000
07015P,國巨元大99售13  ,0,0,0,0,0,0,0,0,0,35000,0,0,0,35000,0,35000,35000
06568P,國巨永豐98售05  ,0,0,0,0,0,0,0,0,0,35000,0,0,0,59000,24000,35000,35000
061482,健策元大9C購01  ,0,0,0,0,0,0,0,0,0,35000,0,0,0,65000,30000,35000,35000
06454P,緯穎元大98售04  ,0,0,0,0,0,0,0,0,0,35000,0,0,0,40000,5000,35000,35000
059740,瑞昱元富99購02  ,0,0,0,0,0,0,0,0,0,35000,0,0,0,43000,8000,35000,35000
059946,健策永豐99購05  ,0,0,0,0,0,0,0,0,0,35000,0,0,0,45000,10000,35000,35000
060671,亞德客元大9A購03,0,0,0,0,0,0,0,0,0,35000,0,0,0,96000,61000,35000,35000
060460,鴻海元大9A購08  ,0,0,0,0,0,0,0,0,0,35000,0,0,0,116000,81000,35000,35000
052239,泰鼎國票97購01  ,0,0,0,0,0,0,0,0,0,35000,0,0,0,74000,39000,35000,35000
052102,台泥兆豐96購01  ,0,0,0,0,0,0,0,0,0,35000,0,0,0,50000,15000,35000,35000
05118P,超眾元大96售04  ,0,0,0,0,0,0,0,0,0,35000,0,0,0,55000,20000,35000,35000
049892,國巨富邦96購01  ,0,0,0,0,0,0,0,0,0,35000,0,0,0,80000,45000,35000,35000
053924,京鼎國票97購01  ,0,0,0,0,0,0,0,0,0,35000,0,0,0,35000,0,35000,35000
051378,奇力新群益95購01,0,0,0,0,0,0,0,0,0,35000,0,0,0,35000,0,35000,35000
059299,欣興元富99購03  ,0,0,0,0,0,0,0,0,0,35000,0,0,0,70000,35000,35000,35000
056905,欣興元大98購03  ,0,0,0,0,0,0,0,0,0,35000,0,0,0,106000,71000,35000,35000
056567,瀚宇博群益98購02,0,0,0,0,0,0,0,0,0,35000,0,0,0,51000,16000,35000,35000
056054,亞德客元大97購05,0,0,0,0,0,0,0,0,0,35000,0,0,0,52000,17000,35000,35000
057140,宏達電兆豐98購01,0,0,0,0,0,0,0,0,0,35000,0,0,0,35000,0,35000,35000
057991,健策統一9C購01  ,0,0,0,0,0,0,0,0,0,35000,0,0,0,183000,148000,35000,35000
07555P,玉晶光元大9A售07,0,0,0,0,0,0,0,0,0,35000,0,0,0,35000,0,35000,35000
07233P,台灣50元大99售04,0,0,0,0,0,0,0,0,0,35000,0,0,0,40000,5000,35000,35000
059994,國巨元富99購01  ,0,0,0,0,0,0,0,0,0,34000,0,0,0,34000,0,34000,34000
059615,台灣50群益99購05,0,0,0,0,0,0,0,0,0,34000,0,0,0,34000,0,34000,34000
059501,可成元富99購01  ,0,0,0,0,0,0,0,0,0,34000,0,0,0,60000,26000,34000,34000
060849,力成國票9A購01  ,0,0,0,0,0,0,0,0,0,34000,0,0,0,52000,18000,34000,34000
060923,全新永豐9A購01  ,0,0,0,0,0,0,0,0,0,34000,0,0,0,37000,3000,34000,34000
051749,矽力國泰97購01  ,0,0,0,0,0,0,0,0,0,34000,0,0,0,37000,3000,34000,34000
006206,元大上證50      ,7000,96000,-89000,0,0,0,0,0,0,123000,0,0,0,213000,90000,123000,34000
052777,燿華國票98購01  ,0,0,0,0,0,0,0,0,0,34000,0,0,0,44000,10000,34000,34000
057141,嘉聯益兆豐99購01,0,0,0,0,0,0,0,0,0,34000,0,0,0,88000,54000,34000,34000
058176,聯發科凱基99購05,0,0,0,0,0,0,0,0,0,34000,0,0,0,34000,0,34000,34000
056033,T50正2凱基99購02,0,0,0,0,0,0,0,0,0,34000,0,0,0,34000,0,34000,34000
056509,晶相光永豐98購01,0,58000,-58000,0,0,0,0,0,0,92000,0,0,0,128000,36000,92000,34000
057292,國巨國泰9B購01  ,0,0,0,0,0,0,0,0,0,34000,0,0,0,34000,0,34000,34000
056668,光磊國票99購01  ,0,0,0,0,0,0,0,0,0,34000,0,0,0,72000,38000,34000,34000
058924,晶相光元富99購02,0,0,0,0,0,0,0,0,0,34000,0,0,0,160000,126000,34000,34000
057461,國巨永豐98購07  ,0,0,0,0,0,0,0,0,0,34000,0,0,0,50000,16000,34000,34000
07612P,國巨國泰9B售06  ,0,0,0,0,0,0,0,0,0,34000,0,0,0,223000,189000,34000,34000
061214,華擎元大9A購04  ,0,0,0,0,0,0,0,0,0,33000,0,0,0,40000,7000,33000,33000
060581,玉晶光群益9B購02,0,0,0,0,0,0,0,0,0,33000,0,0,0,53000,20000,33000,33000
060335,明泰康和9A購01  ,0,0,0,0,0,0,0,0,0,33000,0,0,0,104000,71000,33000,33000
054180,亞泥康和96購01  ,0,0,0,0,0,0,0,0,0,33000,0,0,0,33000,0,33000,33000
057642,南亞科元大98購07,0,0,0,0,0,0,0,0,0,33000,0,0,0,73000,40000,33000,33000
051696,新日興中信96購01,0,0,0,0,0,0,0,0,0,33000,0,0,0,33000,0,33000,33000
053836,亞光永豐96購02  ,0,0,0,0,0,0,0,0,0,33000,0,0,0,33000,0,33000,33000
055510,GIS元大97購03   ,0,0,0,0,0,0,0,0,0,33000,0,0,0,33000,0,33000,33000
056127,致新國票98購02  ,0,0,0,0,0,0,0,0,0,33000,0,0,0,258000,225000,33000,33000
058647,華新科永豐99購03,0,0,0,0,0,0,0,0,0,33000,0,0,0,33000,0,33000,33000
058669,上銀群益99購01  ,0,0,0,0,0,0,0,0,0,33000,0,0,0,33000,0,33000,33000
5234,達興材料        ,49000,15000,34000,0,0,0,0,0,0,-1000,0,1000,-1000,0,0,0,33000
5434,崇越            ,221000,192000,29000,0,0,0,0,0,0,4000,0,0,0,4000,0,4000,33000
2348,海悅            ,48000,13000,35000,0,0,0,0,0,0,-2000,0,2000,-2000,0,0,0,33000
060188,華新科元富9A購03,0,0,0,0,0,0,0,0,0,32000,0,0,0,52000,20000,32000,32000
059634,可成凱基99購07  ,0,0,0,0,0,0,0,0,0,32000,0,0,0,34000,2000,32000,32000
051722,玉晶光永豐97購01,0,0,0,0,0,0,0,0,0,32000,0,0,0,74000,42000,32000,32000
052229,奇力新凱基96購01,0,0,0,0,0,0,0,0,0,32000,0,0,0,32000,0,32000,32000
054577,世芯元大98購01  ,0,0,0,0,0,0,0,0,0,32000,0,0,0,32000,0,32000,32000
055157,晶豪科元大97購01,0,0,0,0,0,0,0,0,0,32000,0,0,0,32000,0,32000,32000
054842,台達電兆豐98購01,0,0,0,0,0,0,0,0,0,32000,0,0,0,40000,8000,32000,32000
058572,百和凱基9A購01  ,0,0,0,0,0,0,0,0,0,32000,0,0,0,98000,66000,32000,32000
055631,創意永豐98購01  ,0,0,0,0,0,0,0,0,0,32000,0,0,0,73000,41000,32000,32000
056192,智邦富邦98購01  ,0,0,0,0,0,0,0,0,0,32000,0,0,0,37000,5000,32000,32000
058185,國巨永豐99購01  ,0,0,0,0,0,0,0,0,0,32000,0,0,0,121000,89000,32000,32000
058348,台表科群益99購01,0,0,0,0,0,0,0,0,0,32000,0,0,0,55000,23000,32000,32000
058353,國巨凱基99購09  ,0,0,0,0,0,0,0,0,0,32000,0,0,0,393000,361000,32000,32000
056487,康友元大98購01  ,0,0,0,0,0,0,0,0,0,32000,0,0,0,33000,1000,32000,32000
056641,華通凱基98購03  ,0,0,0,0,0,0,0,0,0,32000,0,0,0,32000,0,32000,32000
056847,佐登元富98購01  ,0,0,0,0,0,0,0,0,0,32000,0,0,0,480000,448000,32000,32000
058955,台積電國票9A購04,0,0,0,0,0,0,0,0,0,32000,0,0,0,235000,203000,32000,32000
059302,大立光群益99購08,0,0,0,0,0,0,0,0,0,32000,0,0,0,32000,0,32000,32000
059275,可成元大99購05  ,0,0,0,0,0,0,0,0,0,32000,0,0,0,54000,22000,32000,32000
059029,旺宏兆豐99購01  ,0,0,0,0,0,0,0,0,0,32000,0,0,0,68000,36000,32000,32000
059039,致伸群益99購01  ,0,0,0,0,0,0,0,0,0,32000,0,0,0,82000,50000,32000,32000
2107,厚生            ,96000,64000,32000,0,0,0,0,0,0,0,0,0,0,0,0,0,32000
5608,四維航          ,43000,11000,32000,0,0,0,0,0,0,0,0,0,0,0,0,0,32000
07620P,國巨統一9B售07  ,0,0,0,0,0,0,0,0,0,32000,0,0,0,70000,38000,32000,32000
059727,大立光元大9A購01,0,0,0,0,0,0,0,0,0,31000,0,0,0,31000,0,31000,31000
060080,台灣50元大02購01,0,0,0,0,0,0,0,0,0,31000,0,0,0,31000,0,31000,31000
060235,瑞昱元大9A購01  ,0,0,0,0,0,0,0,0,0,31000,0,0,0,103000,72000,31000,31000
05483P,國巨凱基95售07  ,0,0,0,0,0,0,0,0,0,31000,0,0,0,31000,0,31000,31000
05465P,台表科永豐95售03,0,0,0,0,0,0,0,0,0,31000,0,0,0,31000,0,31000,31000
053568,智伸科富邦98購01,0,0,0,0,0,0,0,0,0,31000,0,0,0,31000,0,31000,31000
053405,台達電兆豐96購01,0,0,0,0,0,0,0,0,0,31000,0,0,0,39000,8000,31000,31000
054306,聯發科凱基96購23,0,0,0,0,0,0,0,0,0,31000,0,0,0,31000,0,31000,31000
049335,聯電統一97購01  ,0,0,0,0,0,0,0,0,0,31000,0,0,0,31000,0,31000,31000
0061,元大寶滬深      ,96000,6000,90000,0,0,0,0,0,0,-59000,25000,65000,-40000,40000,59000,-19000,31000
05751P,台積電中信96售05,0,0,0,0,0,0,0,0,0,31000,0,0,0,61000,30000,31000,31000
057215,友達群益98購03  ,0,0,0,0,0,0,0,0,0,31000,0,0,0,31000,0,31000,31000
056142,超眾元大97購06  ,0,0,0,0,0,0,0,0,0,31000,0,0,0,246000,215000,31000,31000
058140,臻鼎元大99購02  ,0,0,0,0,0,0,0,0,0,31000,0,0,0,66000,35000,31000,31000
057034,道瓊反元大9B購01,0,0,0,0,0,0,0,0,0,31000,0,0,0,31000,0,31000,31000
055847,大立光元大97購10,0,0,0,0,0,0,0,0,0,31000,0,0,0,50000,19000,31000,31000
058630,日月光國票9A購01,0,0,0,0,0,0,0,0,0,31000,0,0,0,31000,0,31000,31000
07422P,大立光元大99售32,0,0,0,0,0,0,0,0,0,31000,0,0,0,31000,0,31000,31000
3622,洋華            ,49000,18000,31000,0,0,0,0,0,0,0,0,0,0,0,0,0,31000
060233,宏碁元大9A購01  ,0,0,0,0,0,0,0,0,0,30000,0,0,0,143000,113000,30000,30000
060380,T50反1凱基9A購08,0,0,0,0,0,0,0,0,0,30000,0,0,0,70000,40000,30000,30000
060608,玉晶光凱基9A購08,0,0,0,0,0,0,0,0,0,30000,0,0,0,30000,0,30000,30000
060464,台積電元大9A購11,0,0,0,0,0,0,0,0,0,30000,0,0,0,30000,0,30000,30000
060462,鴻海元大9A購10  ,0,0,0,0,0,0,0,0,0,30000,0,0,0,30000,0,30000,30000
060537,台灣50凱基9B購01,0,0,0,0,0,0,0,0,0,30000,0,0,0,30000,0,30000,30000
059977,鴻海元大99購40  ,0,0,0,0,0,0,0,0,0,30000,0,0,0,60000,30000,30000,30000
059368,T50正2元富99購02,0,0,0,0,0,0,0,0,0,30000,0,0,0,45000,15000,30000,30000
059393,臺股指凱基99購39,0,0,0,0,0,0,0,0,0,30000,0,0,0,30000,0,30000,30000
059416,T50反1元大99購08,0,0,0,0,0,0,0,0,0,30000,0,0,0,30000,0,30000,30000
060736,旺宏統一01購01  ,0,0,0,0,0,0,0,0,0,30000,0,0,0,72000,42000,30000,30000
06418P,T50反1統一9A售02,0,0,0,0,0,0,0,0,0,30000,0,0,0,40000,10000,30000,30000
06386P,欣興永豐97售03  ,0,0,0,0,0,0,0,0,0,30000,0,0,0,30000,0,30000,30000
06955P,臻鼎元富99售01  ,0,0,0,0,0,0,0,0,0,30000,0,0,0,30000,0,30000,30000
049153,大立光元大96購02,0,0,0,0,0,0,0,0,0,30000,0,0,0,30000,0,30000,30000
03033P,微星國票03售01  ,50000,0,50000,0,0,0,0,0,0,-20000,0,0,0,0,20000,-20000,30000
049434,茂林國票95購01  ,0,0,0,0,0,0,0,0,0,30000,0,0,0,80000,50000,30000,30000
044105,聯詠中信95購01  ,0,0,0,0,0,0,0,0,0,30000,0,0,0,30000,0,30000,30000
045882,滬深2X元大95購01,0,0,0,0,0,0,0,0,0,30000,0,0,0,30000,0,30000,30000
04628P,欣興元大95售01  ,0,0,0,0,0,0,0,0,0,30000,0,0,0,215000,185000,30000,30000
052208,力成麥證95購01  ,0,0,0,31000,1000,30000,0,0,0,30000,0,0,0,31000,1000,30000,30000
051988,台光電元大95購01,0,0,0,0,0,0,0,0,0,30000,0,0,0,30000,0,30000,30000
053966,旺宏元大96購08  ,0,0,0,0,0,0,0,0,0,30000,0,0,0,30000,0,30000,30000
055149,國巨元大97購06  ,0,0,0,0,0,0,0,0,0,30000,0,0,0,38000,8000,30000,30000
052606,聯發科元大97購04,0,0,0,0,0,0,0,0,0,30000,0,0,0,80000,50000,30000,30000
052323,矽力元大95購04  ,0,0,0,0,0,0,0,0,0,30000,0,0,0,50000,20000,30000,30000
052353,高鐵群益97購01  ,0,0,0,0,0,0,0,0,0,30000,0,0,0,30000,0,30000,30000
051154,國巨國泰96購03  ,0,0,0,0,0,0,0,0,0,30000,0,0,0,42000,12000,30000,30000
050926,禾伸堂凱基95購01,0,0,0,0,0,0,0,0,0,30000,0,0,0,30000,0,30000,30000
050690,台達電凱基96購01,0,0,0,0,0,0,0,0,0,30000,0,0,0,30000,0,30000,30000
050600,瑞儀國泰95購01  ,0,0,0,0,0,0,0,0,0,30000,0,0,0,30000,0,30000,30000
050493,聯發科永昌96購01,0,0,0,0,0,0,0,0,0,30000,0,0,0,30000,0,30000,30000
050402,緯穎中信96購01  ,0,0,0,0,0,0,0,0,0,30000,0,0,0,30000,0,30000,30000
054378,楠梓電群益98購01,0,0,0,0,0,0,0,0,0,30000,0,0,0,30000,0,30000,30000
054405,樺漢康和96購01  ,0,0,0,0,0,0,0,0,0,30000,0,0,0,30000,0,30000,30000
054293,健策元大98購02  ,0,0,0,0,0,0,0,0,0,30000,0,0,0,158000,128000,30000,30000
057894,華通元富02購02  ,0,0,0,0,0,0,0,0,0,30000,0,0,0,32000,2000,30000,30000
053426,創意永豐96購04  ,0,0,0,0,0,0,0,0,0,30000,0,0,0,30000,0,30000,30000
053303,建準凱基96購03  ,0,0,0,0,0,0,0,0,0,30000,0,0,0,30000,0,30000,30000
054772,康控國票98購02  ,0,0,0,0,0,0,0,0,0,30000,0,0,0,30000,0,30000,30000
055204,宏達電中信99購01,0,0,0,0,0,0,0,0,0,30000,0,0,0,30000,0,30000,30000
054925,神達凱基97購01  ,0,0,0,0,0,0,0,0,0,30000,0,0,0,44000,14000,30000,30000
053124,聯發科凱基96購12,0,0,0,0,0,0,0,0,0,30000,0,0,0,50000,20000,30000,30000
053132,國巨國票97購02  ,0,0,0,0,0,0,0,0,0,30000,0,0,0,30000,0,30000,30000
053101,創意元富96購03  ,0,0,0,0,0,0,0,0,0,30000,0,0,0,40000,10000,30000,30000
055004,群創元富99購06  ,0,0,0,0,0,0,0,0,0,30000,0,0,0,30000,0,30000,30000
058595,T50正2元富99購01,0,0,0,0,0,0,0,0,0,30000,0,0,0,30000,0,30000,30000
058549,藍天永豐99購01  ,0,0,0,0,0,0,0,0,0,30000,0,0,0,50000,20000,30000,30000
058683,可成凱基9A購01  ,0,0,0,0,0,0,0,0,0,30000,0,0,0,40000,10000,30000,30000
055248,可成統一97購02  ,0,0,0,0,0,0,0,0,0,30000,0,0,0,40000,10000,30000,30000
055268,和大元大97購01  ,0,0,0,0,0,0,0,0,0,30000,0,0,0,30000,0,30000,30000
055713,國巨元大98購09  ,0,0,0,0,0,0,0,0,0,30000,0,0,0,71000,41000,30000,30000
055377,揚明光元大98購01,0,0,0,0,0,0,0,0,0,30000,0,0,0,30000,0,30000,30000
055386,致新元大97購02  ,0,0,0,0,0,0,0,0,0,30000,0,0,0,30000,0,30000,30000
056126,台郡國票98購02  ,0,0,0,0,0,0,0,0,0,30000,0,0,0,30000,0,30000,30000
056200,大毅永豐98購01  ,0,0,0,0,0,0,0,0,0,30000,0,0,0,30000,0,30000,30000
058106,神達統一98購02  ,0,0,0,0,0,0,0,0,0,30000,0,0,0,30000,0,30000,30000
058078,景碩國票99購01  ,0,0,0,0,0,0,0,0,0,30000,0,0,0,34000,4000,30000,30000
057221,華通國票98購03  ,0,0,0,0,0,0,0,0,0,30000,0,0,0,34000,4000,30000,30000
057195,南茂元大98購01  ,0,0,0,0,0,0,0,0,0,30000,0,0,0,236000,206000,30000,30000
057236,聯詠凱基98購03  ,0,0,0,0,0,0,0,0,0,30000,0,0,0,40000,10000,30000,30000
056940,嘉聯益元富98購01,0,0,0,0,0,0,0,0,0,30000,0,0,0,30000,0,30000,30000
056586,光罩統一98購02  ,0,0,0,0,0,0,0,0,0,30000,0,0,0,180000,150000,30000,30000
057371,可成元大98購08  ,0,0,0,0,0,0,0,0,0,30000,0,0,0,73000,43000,30000,30000
057558,致新凱基98購01  ,0,0,0,0,0,0,0,0,0,30000,0,0,0,36000,6000,30000,30000
059217,台積電元大99購30,0,0,0,0,0,0,0,0,0,30000,0,0,0,30000,0,30000,30000
3321,同泰            ,37000,7000,30000,0,0,0,0,0,0,0,0,0,0,0,0,0,30000
07473P,祥碩元大9A售01  ,0,0,0,0,0,0,0,0,0,30000,0,0,0,95000,65000,30000,30000
07569P,國巨凱基9A售13  ,0,0,0,0,0,0,0,0,0,30000,0,0,0,30000,0,30000,30000
07542P,台積電凱基9A售16,0,0,0,0,0,0,0,0,0,30000,0,0,0,30000,0,30000,30000
07535P,上銀元富9A售03  ,0,0,0,0,0,0,0,0,0,30000,0,0,0,56000,26000,30000,30000
07130P,台郡元大9B售01  ,0,0,0,0,0,0,0,0,0,30000,0,0,0,80000,50000,30000,30000
07171P,臺股指國票99售08,0,0,0,0,0,0,0,0,0,30000,0,0,0,40000,10000,30000,30000
07632P,臺股指凱基9A售14,0,0,0,0,0,0,0,0,0,30000,0,0,0,30000,0,30000,30000
9925,新保            ,38000,8000,30000,0,0,0,0,0,0,0,0,0,0,0,0,0,30000
8341,日友            ,85000,55900,29100,0,0,0,0,0,0,0,0,0,0,0,0,0,29100
060963,禾伸堂凱基9A購01,0,0,0,0,0,0,0,0,0,29000,0,0,0,203000,174000,29000,29000
060889,國泰金統一9C購01,0,0,0,0,0,0,0,0,0,29000,0,0,0,197000,168000,29000,29000
059723,美律元大9A購02  ,0,0,0,0,0,0,0,0,0,29000,0,0,0,85000,56000,29000,29000
059635,華新科凱基9A購06,0,0,0,0,0,0,0,0,0,29000,0,0,0,29000,0,29000,29000
059947,貿聯永豐99購03  ,0,0,0,0,0,0,0,0,0,29000,0,0,0,69000,40000,29000,29000
059748,聯發科台新99購03,0,0,0,0,0,0,0,0,0,29000,0,0,0,163000,134000,29000,29000
059772,可成群益9A購05  ,0,0,0,0,0,0,0,0,0,29000,0,0,0,46000,17000,29000,29000
060296,和碩元大9A購01  ,0,0,0,0,0,0,0,0,0,29000,0,0,0,69000,40000,29000,29000
054890,聯鈞統一99購01  ,0,0,0,0,0,0,0,0,0,29000,0,0,0,98000,69000,29000,29000
053734,友達中信98購02  ,0,0,0,0,0,0,0,0,0,29000,0,0,0,29000,0,29000,29000
051902,T50反1元大97購01,0,0,0,0,0,0,0,0,0,29000,0,0,0,60000,31000,29000,29000
00865B,國泰US短期公債  ,0,0,0,0,0,0,0,0,0,29000,0,0,0,129000,100000,29000,29000
00703,台新MSCI中國    ,0,0,0,0,0,0,0,0,0,29000,0,0,0,109000,80000,29000,29000
00733,富邦臺灣中小    ,0,0,0,0,0,0,0,0,0,29000,0,0,0,234000,205000,29000,29000
059254,台表科凱基9A購02,0,0,0,0,0,0,0,0,0,29000,0,0,0,54000,25000,29000,29000
059027,神達台新99購02  ,0,0,0,0,0,0,0,0,0,29000,0,0,0,29000,0,29000,29000
057230,建準凱基98購02  ,0,0,0,0,0,0,0,0,0,29000,0,0,0,264000,235000,29000,29000
056412,上証2X中信9A購02,0,0,0,0,0,0,0,0,0,29000,0,0,0,40000,11000,29000,29000
055755,禾伸堂兆豐97購02,0,0,0,0,0,0,0,0,0,29000,0,0,0,162000,133000,29000,29000
07494P,葡萄王元大9A售03,0,5000,-5000,0,0,0,0,0,0,34000,0,0,0,121000,87000,34000,29000
3094,聯傑            ,39000,10000,29000,0,0,0,0,0,0,0,0,0,0,0,0,0,29000
6177,達麗            ,108000,79000,29000,0,0,0,0,0,0,0,0,0,0,0,0,0,29000
2431,聯昌            ,37000,8000,29000,0,0,0,0,0,0,0,0,0,0,0,0,0,29000
2488,漢平            ,60000,31000,29000,0,0,0,0,0,0,0,0,0,0,0,0,0,29000
059709,上証2X元大9C購01,0,0,0,0,0,0,0,0,0,28000,0,0,0,30000,2000,28000,28000
059424,SGBR2X元大9A購01,0,0,0,0,0,0,0,0,0,28000,0,0,0,213000,185000,28000,28000
059443,嘉聯益元大9B購01,0,0,0,0,0,0,0,0,0,28000,0,0,0,28000,0,28000,28000
061037,嘉澤永豐9A購01  ,0,0,0,0,0,0,0,0,0,28000,0,0,0,30000,2000,28000,28000
060788,嘉晶富邦9B購01  ,0,0,0,0,0,0,0,0,0,28000,0,0,0,291000,263000,28000,28000
061184,大立光國泰9C購01,0,0,0,0,0,0,0,0,0,28000,0,0,0,78000,50000,28000,28000
06655P,TPK元大98售02   ,0,0,0,0,0,0,0,0,0,28000,0,0,0,50000,22000,28000,28000
061425,華新科元大9A購19,0,0,0,0,0,0,0,0,0,28000,0,0,0,28000,0,28000,28000
053489,上銀兆豐97購01  ,0,0,0,0,0,0,0,0,0,28000,0,0,0,44000,16000,28000,28000
055837,致茂元大97購02  ,0,0,0,0,0,0,0,0,0,28000,0,0,0,273000,245000,28000,28000
058770,貿聯兆豐9A購01  ,0,0,0,0,0,0,0,0,0,28000,0,0,0,28000,0,28000,28000
057101,新光金中信9A購01,0,0,0,0,0,0,0,0,0,28000,0,0,0,38000,10000,28000,28000
057448,致茂元富98購01  ,0,0,0,0,0,0,0,0,0,28000,0,0,0,28000,0,28000,28000
1810,和成            ,31000,3000,28000,0,0,0,0,0,0,0,0,0,0,0,0,0,28000
2020,美亞            ,55000,27000,28000,0,0,0,0,0,0,0,0,0,0,0,0,0,28000
061195,健策永豐9B購02  ,0,0,0,0,0,0,0,0,0,27000,0,0,0,29000,2000,27000,27000
060934,台汽電永豐9A購02,0,0,0,0,0,0,0,0,0,27000,0,0,0,99000,72000,27000,27000
059674,玉山金元富99購02,0,0,0,0,0,0,0,0,0,27000,0,0,0,39000,12000,27000,27000
060087,鴻海元大99購43  ,0,0,0,0,0,0,0,0,0,27000,0,0,0,37000,10000,27000,27000
060315,易華電永豐9A購01,0,0,0,0,0,0,0,0,0,27000,0,0,0,75000,48000,27000,27000
060289,京元電元大9A購01,0,0,0,0,0,0,0,0,0,27000,0,0,0,27000,0,27000,27000
060536,祥碩麥證9A購01  ,0,0,0,102000,75000,27000,0,0,0,27000,0,0,0,102000,75000,27000,27000
00685L,群益臺灣加權正2 ,0,0,0,0,0,0,0,0,0,27000,0,0,0,35000,8000,27000,27000
051660,緯穎國泰96購02  ,0,0,0,0,0,0,0,0,0,27000,0,0,0,27000,0,27000,27000
058958,台表科國票9A購03,0,0,0,0,0,0,0,0,0,27000,0,0,0,127000,100000,27000,27000
056065,奇鋐元大97購01  ,0,0,0,0,0,0,0,0,0,27000,0,0,0,164000,137000,27000,27000
05729P,臺股指凱基97售02,0,0,0,0,0,0,0,0,0,27000,0,0,0,76000,49000,27000,27000
05669P,嘉晶永豐96售03  ,0,0,0,0,0,0,0,0,0,27000,0,0,0,27000,0,27000,27000
056176,創意元富97購01  ,0,0,0,0,0,0,0,0,0,27000,0,0,0,30000,3000,27000,27000
058362,聯發科凱基99購06,0,0,0,0,0,0,0,0,0,27000,0,0,0,37000,10000,27000,27000
058780,牧德國票9A購01  ,0,0,0,0,0,0,0,0,0,27000,0,0,0,37000,10000,27000,27000
058567,華新科凱基9A購02,0,0,0,0,0,0,0,0,0,27000,0,0,0,61000,34000,27000,27000
055863,緯穎元大97購05  ,0,0,0,0,0,0,0,0,0,27000,0,0,0,27000,0,27000,27000
056330,玉晶光國票99購03,0,0,0,0,0,0,0,0,0,27000,0,0,0,31000,4000,27000,27000
07502P,美食元大9A售01  ,0,2000,-2000,0,0,0,0,0,0,29000,0,0,0,179000,150000,29000,27000
07288P,台灣50凱基99售06,0,0,0,0,0,0,0,0,0,27000,0,0,0,48000,21000,27000,27000
060680,玉晶光元大9C購03,0,0,0,0,0,0,0,0,0,26000,0,0,0,69000,43000,26000,26000
059452,全新永豐99購03  ,0,0,0,0,0,0,0,0,0,26000,0,0,0,36000,10000,26000,26000
061393,緯穎群益9A購01  ,0,0,0,0,0,0,0,0,0,26000,0,0,0,230000,204000,26000,26000
06553P,訊芯元大98售05  ,0,0,0,0,0,0,0,0,0,26000,0,0,0,26000,0,26000,26000
06896P,信邦中信98售01  ,0,0,0,0,0,0,0,0,0,26000,0,0,0,86000,60000,26000,26000
049199,茂林永豐95購01  ,0,0,0,0,0,0,0,0,0,26000,0,0,0,26000,0,26000,26000
050547,華新科凱基95購01,0,0,0,0,0,0,0,0,0,26000,0,0,0,36000,10000,26000,26000
054760,台化國票9A購01  ,0,0,0,0,0,0,0,0,0,26000,0,0,0,26000,0,26000,26000
057835,華擎元富9B購01  ,0,0,0,0,0,0,0,0,0,26000,0,0,0,100000,74000,26000,26000
057605,旺宏統一99購03  ,0,0,0,0,0,0,0,0,0,26000,0,0,0,26000,0,26000,26000
055648,可成元富97購01  ,0,0,0,0,0,0,0,0,0,26000,0,0,0,26000,0,26000,26000
055594,華新科元大98購02,0,0,0,0,0,0,0,0,0,26000,0,0,0,44000,18000,26000,26000
055996,矽力國泰99購01  ,0,0,0,0,0,0,0,0,0,26000,0,0,0,31000,5000,26000,26000
056736,國巨凱基99購03  ,0,0,0,0,0,0,0,0,0,26000,0,0,0,79000,53000,26000,26000
056910,超眾元大99購02  ,0,0,0,0,0,0,0,0,0,26000,0,0,0,158000,132000,26000,26000
059276,可成元大99購06  ,0,0,0,0,0,0,0,0,0,26000,0,0,0,75000,49000,26000,26000
5484,慧友            ,26000,0,26000,0,0,0,0,0,0,0,0,0,0,0,0,0,26000
3003,健和興          ,217000,205000,12000,0,0,0,0,0,0,14000,24000,0,24000,4000,14000,-10000,26000
06853P,華擎元富98售03  ,0,0,0,0,0,0,0,0,0,25000,0,0,0,25000,0,25000,25000
060982,旺宏元大9A購09  ,0,0,0,0,0,0,0,0,0,25000,0,0,0,131000,106000,25000,25000
061080,華邦電兆豐9B購01,0,0,0,0,0,0,0,0,0,25000,0,0,0,60000,35000,25000,25000
061377,聯發科永豐9A購04,0,0,0,0,0,0,0,0,0,25000,0,0,0,25000,0,25000,25000
059703,旺宏凱基99購11  ,0,0,0,0,0,0,0,0,0,25000,0,0,0,25000,0,25000,25000
060034,立積永豐99購04  ,0,0,0,0,0,0,0,0,0,25000,0,0,0,97000,72000,25000,25000
05996P,華新科群益96售03,0,0,0,0,0,0,0,0,0,25000,0,0,0,34000,9000,25000,25000
059989,嘉晶元大9A購01  ,0,0,0,0,0,0,0,0,0,25000,0,0,0,112000,87000,25000,25000
060463,台積電元大9A購10,0,0,0,0,0,0,0,0,0,25000,0,0,0,76000,51000,25000,25000
060256,臺股指元大9B購07,0,0,0,0,0,0,0,0,0,25000,0,0,0,25000,0,25000,25000
060264,華新科國票9A購02,0,0,0,0,0,0,0,0,0,25000,0,0,0,25000,0,25000,25000
054195,亞泥國泰98購01  ,0,0,0,0,0,0,0,0,0,25000,0,0,0,25000,0,25000,25000
054632,緯穎凱基9A購01  ,0,0,0,0,0,0,0,0,0,25000,0,0,0,25000,0,25000,25000
05471P,聯電統一95售01  ,0,0,0,0,0,0,0,0,0,25000,0,0,0,25000,0,25000,25000
053355,超眾兆豐97購01  ,0,0,0,0,0,0,0,0,0,25000,0,0,0,94000,69000,25000,25000
052659,上証2X國票99購01,0,0,0,0,0,0,0,0,0,25000,0,0,0,45000,20000,25000,25000
051347,國巨元大95購06  ,0,0,0,0,0,0,0,0,0,25000,0,0,0,25000,0,25000,25000
054003,鴻海統一96購13  ,0,0,0,0,0,0,0,0,0,25000,0,0,0,25000,0,25000,25000
059118,晶技永豐9A購01  ,0,0,0,0,0,0,0,0,0,25000,0,0,0,41000,16000,25000,25000
059135,臺股指群益99購10,0,0,0,0,0,0,0,0,0,25000,0,0,0,25000,0,25000,25000
059162,國巨凱基99購12  ,0,0,0,0,0,0,0,0,0,25000,0,0,0,99000,74000,25000,25000
057178,可成元大98購03  ,0,0,0,0,0,0,0,0,0,25000,0,0,0,28000,3000,25000,25000
055835,華邦電元大97購03,0,0,0,0,0,0,0,0,0,25000,0,0,0,93000,68000,25000,25000
055382,台郡元大99購01  ,0,0,0,0,0,0,0,0,0,25000,0,0,0,45000,20000,25000,25000
058545,義隆富邦9C購01  ,0,0,0,0,0,0,0,0,0,25000,0,0,0,26000,1000,25000,25000
057083,立積統一98購01  ,0,0,0,0,0,0,0,0,0,25000,0,0,0,25000,0,25000,25000
3653,健策            ,411000,393000,18000,0,0,0,60000,47000,13000,-6000,18000,8000,10000,52000,68000,-16000,25000
07358P,鴻海元大99售39  ,0,0,0,0,0,0,0,0,0,25000,0,0,0,80000,55000,25000,25000
07365P,超眾元大99售07  ,0,0,0,0,0,0,0,0,0,25000,0,0,0,25000,0,25000,25000
07627P,超眾凱基9A售02  ,0,0,0,0,0,0,0,0,0,25000,0,0,0,35000,10000,25000,25000
07751P,世紀鋼凱基9A售02,0,0,0,0,0,0,0,0,0,25000,0,0,0,50000,25000,25000,25000
059747,台達電台新99購01,0,0,0,0,0,0,0,0,0,24000,0,0,0,47000,23000,24000,24000
059836,大立光國泰9B購02,1000,0,1000,0,0,0,0,0,0,23000,0,0,0,46000,23000,23000,24000
059891,臺股指國票99購25,0,0,0,0,0,0,0,0,0,24000,0,0,0,24000,0,24000,24000
059371,聯鈞元富99購02  ,0,0,0,0,0,0,0,0,0,24000,0,0,0,24000,0,24000,24000
061095,台積電台新9B購03,0,0,0,0,0,0,0,0,0,24000,0,0,0,324000,300000,24000,24000
061015,旺宏麥證9A購03  ,0,0,0,24000,0,24000,0,0,0,24000,0,0,0,24000,0,24000,24000
07124P,台積電元大99售21,0,0,0,0,0,0,0,0,0,24000,0,0,0,24000,0,24000,24000
061405,亞德客國票9B購01,0,0,0,0,0,0,0,0,0,24000,0,0,0,37000,13000,24000,24000
055073,易華電永豐97購01,0,0,0,0,0,0,0,0,0,24000,0,0,0,24000,0,24000,24000
052590,祥碩永豐96購01  ,0,0,0,0,0,0,0,0,0,24000,0,0,0,326000,302000,24000,24000
050675,奇鋐富邦96購01  ,0,0,0,0,0,0,0,0,0,24000,0,0,0,24000,0,24000,24000
051087,國巨元大97購01  ,0,0,0,0,0,0,0,0,0,24000,0,0,0,80000,56000,24000,24000
051103,緯穎元大96購03  ,0,0,0,0,0,0,0,0,0,24000,0,0,0,24000,0,24000,24000
051192,緯創兆豐96購01  ,0,0,0,0,0,0,0,0,0,24000,0,0,0,69000,45000,24000,24000
052505,友達日盛9B購02  ,0,0,0,0,0,0,0,0,0,24000,0,0,0,24000,0,24000,24000
048898,晶相光國泰96購01,0,0,0,0,0,0,0,0,0,24000,0,0,0,25000,1000,24000,24000
051748,超眾國泰96購01  ,0,0,0,0,0,0,0,0,0,24000,0,0,0,27000,3000,24000,24000
052103,台積電兆豐95購06,0,0,0,0,0,0,0,0,0,24000,0,0,0,24000,0,24000,24000
054913,億光凱基97購01  ,0,0,0,0,0,0,0,0,0,24000,0,0,0,24000,0,24000,24000
054160,華泰凱基98購01  ,0,0,0,0,0,0,0,0,0,24000,0,0,0,36000,12000,24000,24000
052990,超眾元大97購01  ,0,0,0,0,0,0,0,0,0,24000,0,0,0,33000,9000,24000,24000
054525,奇鋐元富96購01  ,0,0,0,0,0,0,0,0,0,24000,0,0,0,91000,67000,24000,24000
057916,國巨凱基98購13  ,0,0,0,0,0,0,0,0,0,24000,0,0,0,71000,47000,24000,24000
058359,瑞昱凱基99購01  ,0,0,0,0,0,0,0,0,0,24000,0,0,0,30000,6000,24000,24000
058476,旺宏凱基9A購01  ,0,0,0,0,0,0,0,0,0,24000,0,0,0,24000,0,24000,24000
058487,晶技國票9A購01  ,0,0,0,0,0,0,0,0,0,24000,0,0,0,65000,41000,24000,24000
058713,國巨統一9B購02  ,0,0,0,0,0,0,0,0,0,24000,0,0,0,24000,0,24000,24000
055324,TPK國票98購03   ,0,0,0,0,0,0,0,0,0,24000,0,0,0,24000,0,24000,24000
056418,台光電元富98購01,0,0,0,0,0,0,0,0,0,24000,0,0,0,93000,69000,24000,24000
056365,欣興元大98購01  ,0,0,0,0,0,0,0,0,0,24000,0,0,0,144000,120000,24000,24000
055536,嘉聯益群益99購02,0,0,0,0,0,0,0,0,0,24000,0,0,0,26000,2000,24000,24000
056915,上銀兆豐99購01  ,0,0,0,0,0,0,0,0,0,24000,0,0,0,24000,0,24000,24000
057327,玉晶光群益9A購04,0,0,0,0,0,0,0,0,0,24000,0,0,0,89000,65000,24000,24000
056639,國產康和98購01  ,0,0,0,0,0,0,0,0,0,24000,0,0,0,24000,0,24000,24000
059138,台積電兆豐99購04,0,0,0,0,0,0,0,0,0,24000,0,0,0,39000,15000,24000,24000
059264,台光電中信99購02,0,0,0,0,0,0,0,0,0,24000,0,0,0,194000,170000,24000,24000
1447,力鵬            ,42000,18000,24000,0,0,0,0,0,0,0,0,0,0,0,0,0,24000
07434P,臺股指國票9A售06,0,0,0,0,0,0,0,0,0,24000,0,0,0,30000,6000,24000,24000
07255P,國巨凱基99售15  ,0,0,0,0,0,0,0,0,0,24000,0,0,0,263000,239000,24000,24000
3030,德律            ,60000,36000,24000,0,0,0,0,0,0,0,0,0,0,0,0,0,24000
2114,鑫永銓          ,26000,2000,24000,0,0,0,0,0,0,0,0,0,0,0,0,0,24000
2480,敦陽科          ,118000,94000,24000,0,0,0,0,0,0,0,0,0,0,0,0,0,24000
06347P,祥碩元富97售02  ,0,0,0,0,0,0,0,0,0,23000,0,0,0,25000,2000,23000,23000
060983,南亞科元大9A購06,0,0,0,0,0,0,0,0,0,23000,0,0,0,299000,276000,23000,23000
060987,華新科元大9A購11,0,0,0,0,0,0,0,0,0,23000,0,0,0,39000,16000,23000,23000
059639,大立光凱基9A購06,0,0,0,0,0,0,0,0,0,23000,0,0,0,44000,21000,23000,23000
059995,南亞科元富99購01,0,0,0,0,0,0,0,0,0,23000,0,0,0,113000,90000,23000,23000
060103,聯詠元大99購01  ,0,0,0,0,0,0,0,0,0,23000,0,0,0,72000,49000,23000,23000
060586,玉晶光元富9A購03,0,0,0,0,0,0,0,0,0,23000,0,0,0,23000,0,23000,23000
057858,T50正2康和98購01,0,0,0,0,0,0,0,0,0,23000,0,0,0,23000,0,23000,23000
057637,上銀元大98購07  ,0,0,0,0,0,0,0,0,0,23000,0,0,0,23000,0,23000,23000
053032,國巨兆豐97購02  ,0,0,0,0,0,0,0,0,0,23000,0,0,0,23000,0,23000,23000
053158,茂林元大96購01  ,0,0,0,0,0,0,0,0,0,23000,0,0,0,106000,83000,23000,23000
053558,訊芯凱基96購02  ,0,0,0,0,0,0,0,0,0,23000,0,0,0,58000,35000,23000,23000
051717,祥碩康和95購01  ,0,0,0,0,0,0,0,0,0,23000,0,0,0,23000,0,23000,23000
048059,欣興國泰95購01  ,0,0,0,0,0,0,0,0,0,23000,0,0,0,23000,0,23000,23000
058949,上銀群益99購02  ,0,0,0,0,0,0,0,0,0,23000,0,0,0,46000,23000,23000,23000
058950,國巨群益99購06  ,0,0,0,0,0,0,0,0,0,23000,0,0,0,265000,242000,23000,23000
056643,奇力新凱基99購01,0,0,0,0,0,0,0,0,0,23000,0,0,0,43000,20000,23000,23000
056962,技嘉永豐98購01  ,0,0,0,0,0,0,0,0,0,23000,0,0,0,56000,33000,23000,23000
058606,聯發科元大99購13,0,0,0,0,0,0,0,0,0,23000,0,0,0,75000,52000,23000,23000
055357,欣興凱基97購04  ,0,0,0,0,0,0,0,0,0,23000,0,0,0,40000,17000,23000,23000
055732,全新元富9A購01  ,0,0,0,0,0,0,0,0,0,23000,0,0,0,23000,0,23000,23000
058455,玉晶光永豐99購03,0,0,0,0,0,0,0,0,0,23000,0,0,0,24000,1000,23000,23000
058151,台積電統一9A購04,0,0,0,0,0,0,0,0,0,23000,0,0,0,23000,0,23000,23000
057086,立積統一9C購01  ,0,0,0,0,0,0,0,0,0,23000,0,0,0,24000,1000,23000,23000
057022,智邦凱基98購04  ,0,0,0,0,0,0,0,0,0,23000,0,0,0,23000,0,23000,23000
6142,友勁            ,14000,0,14000,0,0,0,0,0,0,9000,9000,0,9000,0,0,0,23000
07403P,聯發科凱基99售21,0,0,0,0,0,0,0,0,0,23000,0,0,0,23000,0,23000,23000
1615,大山            ,24000,33000,-9000,0,0,0,0,0,0,32000,0,4000,-4000,36000,0,36000,23000
6533,晶心科          ,61000,38000,23000,0,0,0,0,0,0,0,0,0,0,0,0,0,23000
2608,嘉里大榮        ,82000,59894,22106,0,0,0,0,0,0,0,0,0,0,0,0,0,22106
060584,玉晶光元富9A購01,0,0,0,0,0,0,0,0,0,22000,0,0,0,39000,17000,22000,22000
060694,旺宏麥證9A購02  ,0,0,0,22000,0,22000,0,0,0,22000,0,0,0,22000,0,22000,22000
059886,可成國票99購04  ,0,0,0,0,0,0,0,0,0,22000,0,0,0,22000,0,22000,22000
059720,台積電元大99購43,0,0,0,0,0,0,0,0,0,22000,0,0,0,211000,189000,22000,22000
061378,南六永豐9A購03  ,0,0,0,0,0,0,0,0,0,22000,0,0,0,334000,312000,22000,22000
06246P,茂林元富97售03  ,0,0,0,0,0,0,0,0,0,22000,0,0,0,103000,81000,22000,22000
061439,寶成凱基9A購01  ,0,0,0,0,0,0,0,0,0,22000,0,0,0,52000,30000,22000,22000
048187,臺指反元大96購04,0,0,0,0,0,0,0,0,0,22000,0,0,0,22000,0,22000,22000
020015,統一MSCI美低波N ,0,0,0,0,0,0,0,0,0,22000,0,0,0,59000,37000,22000,22000
00668,國泰美國道瓊    ,0,2000,-2000,0,0,0,0,0,0,24000,0,0,0,57000,33000,24000,22000
052251,台光電永豐95購03,0,0,0,0,0,0,0,0,0,22000,0,0,0,22000,0,22000,22000
053718,全新凱基97購02  ,0,0,0,0,0,0,0,0,0,22000,0,0,0,22000,0,22000,22000
053181,滬深2X元富99購02,0,0,0,0,0,0,0,0,0,22000,0,0,0,22000,0,22000,22000
054886,大毅統一97購01  ,0,0,0,0,0,0,0,0,0,22000,0,0,0,22000,0,22000,22000
054792,揚明光群益97購01,0,0,0,0,0,0,0,0,0,22000,0,0,0,120000,98000,22000,22000
054345,世芯國票96購02  ,0,0,0,0,0,0,0,0,0,22000,0,0,0,22000,0,22000,22000
052860,旺宏凱基96購03  ,0,0,0,0,0,0,0,0,0,22000,0,0,0,22000,0,22000,22000
056228,可成凱基97購03  ,0,0,0,0,0,0,0,0,0,22000,0,0,0,22000,0,22000,22000
058012,鈺齊國票99購01  ,0,0,0,0,0,0,0,0,0,22000,0,0,0,40000,18000,22000,22000
058295,欣興凱基99購02  ,0,0,0,0,0,0,0,0,0,22000,0,0,0,286000,264000,22000,22000
058437,可成統一9B購01  ,0,0,0,0,0,0,0,0,0,22000,0,0,0,22000,0,22000,22000
058371,智原凱基9A購01  ,0,0,0,0,0,0,0,0,0,22000,0,0,0,22000,0,22000,22000
058355,旺宏凱基99購04  ,0,0,0,0,0,0,0,0,0,22000,0,0,0,22000,0,22000,22000
05538P,玉晶光國票97售02,0,0,0,0,0,0,0,0,0,22000,0,0,0,43000,21000,22000,22000
05875P,旺宏群益98售01  ,0,0,0,0,0,0,0,0,0,22000,0,0,0,30000,8000,22000,22000
058793,鴻海元大99購19  ,0,0,0,0,0,0,0,0,0,22000,0,0,0,39000,17000,22000,22000
055479,GIS凱基97購04   ,0,0,0,0,0,0,0,0,0,22000,0,0,0,22000,0,22000,22000
056523,光寶科中信98購01,0,0,0,0,0,0,0,0,0,22000,0,0,0,76000,54000,22000,22000
056368,祥碩元大98購02  ,0,0,0,0,0,0,0,0,0,22000,0,0,0,22000,0,22000,22000
057507,貿聯國票98購02  ,0,0,0,0,0,0,0,0,0,22000,0,0,0,39000,17000,22000,22000
059140,大立光兆豐9A購02,0,0,0,0,0,0,0,0,0,22000,0,0,0,24000,2000,22000,22000
1451,年興            ,29000,7000,22000,0,0,0,0,0,0,0,0,0,0,0,0,0,22000
6409,旭隼            ,79700,56250,23450,0,0,0,0,0,0,-2000,0,2000,-2000,0,0,0,21450
06984P,上銀富邦9B售01  ,0,0,0,0,0,0,0,0,0,21000,0,0,0,21000,0,21000,21000
06836P,玉晶光國票99售06,0,0,0,0,0,0,0,0,0,21000,0,0,0,1825000,1804000,21000,21000
061075,亞德客兆豐9A購01,0,0,0,0,0,0,0,0,0,21000,0,0,0,21000,0,21000,21000
060800,華新科第一9A購01,0,0,0,0,0,0,0,0,0,21000,0,0,0,43000,22000,21000,21000
060827,健策元大9A購02  ,0,0,0,0,0,0,0,0,0,21000,0,0,0,69000,48000,21000,21000
059586,上銀元大9A購02  ,0,0,0,0,0,0,0,0,0,21000,0,0,0,21000,0,21000,21000
059853,超眾永豐99購03  ,0,0,0,0,0,0,0,0,0,21000,0,0,0,44000,23000,21000,21000
060089,台積電元大99購54,0,0,0,0,0,0,0,0,0,21000,0,0,0,50000,29000,21000,21000
060056,大立光凱基9B購01,0,0,0,0,0,0,0,0,0,21000,0,0,0,21000,0,21000,21000
060229,楠梓電元大9C購01,0,0,0,0,0,0,0,0,0,21000,0,0,0,66000,45000,21000,21000
052969,建準群益97購01  ,0,0,0,0,0,0,0,0,0,21000,0,0,0,91000,70000,21000,21000
057954,宏碁元大99購01  ,0,0,0,0,0,0,0,0,0,21000,0,0,0,21000,0,21000,21000
054585,禾伸堂國泰99購01,0,0,0,0,0,0,0,0,0,21000,0,0,0,21000,0,21000,21000
05265P,正崴元大95售03  ,0,0,0,0,0,0,0,0,0,21000,0,0,0,21000,0,21000,21000
049922,禾伸堂元大95購01,0,0,0,0,0,0,0,0,0,21000,0,0,0,21000,0,21000,21000
052157,東元永豐95購01  ,0,0,0,0,0,0,0,0,0,21000,0,0,0,21000,0,21000,21000
048551,鴻海元大94購02  ,0,0,0,0,0,0,0,0,0,21000,0,0,0,21000,0,21000,21000
059001,聯發科元大99購17,0,0,0,0,0,0,0,0,0,21000,0,0,0,36000,15000,21000,21000
059265,美律中信01購01  ,0,0,0,0,0,0,0,0,0,21000,0,0,0,35000,14000,21000,21000
057533,晶相光元大98購02,0,0,0,0,0,0,0,0,0,21000,0,0,0,222000,201000,21000,21000
058942,南茂中信99購01  ,0,0,0,0,0,0,0,0,0,21000,0,0,0,21000,0,21000,21000
058940,聯發科中信9A購03,0,0,0,0,0,0,0,0,0,21000,0,0,0,26000,5000,21000,21000
058847,國巨群益99購05  ,0,0,0,0,0,0,0,0,0,21000,0,0,0,198000,177000,21000,21000
056860,正崴群益98購01  ,0,0,0,0,0,0,0,0,0,21000,0,0,0,128000,107000,21000,21000
056882,華邦電康和98購01,0,0,0,0,0,0,0,0,0,21000,0,0,0,21000,0,21000,21000
056627,訊芯永豐98購01  ,0,0,0,0,0,0,0,0,0,21000,0,0,0,77000,56000,21000,21000
056274,彩晶統一98購02  ,0,0,0,0,0,0,0,0,0,21000,0,0,0,21000,0,21000,21000
058579,聯發科群益99購04,0,0,0,0,0,0,0,0,0,21000,0,0,0,21000,0,21000,21000
058662,禾伸堂兆豐99購01,0,0,0,0,0,0,0,0,0,21000,0,0,0,39000,18000,21000,21000
056354,國巨元大98購10  ,0,0,0,0,0,0,0,0,0,21000,0,0,0,125000,104000,21000,21000
058232,聯發科元大99購05,0,0,0,0,0,0,0,0,0,21000,0,0,0,31000,10000,21000,21000
057094,祥碩元富98購01  ,0,0,0,0,0,0,0,0,0,21000,0,0,0,21000,0,21000,21000
1540,喬福            ,22000,1000,21000,0,0,0,0,0,0,0,0,0,0,0,0,0,21000
07370P,南亞科凱基99售08,0,0,0,0,0,0,0,0,0,21000,0,0,0,21000,0,21000,21000
6605,帝寶            ,35000,14000,21000,0,0,0,0,0,0,0,0,0,0,0,0,0,21000
060122,亞德客永豐99購02,0,0,0,0,0,0,0,0,0,20000,0,0,0,20000,0,20000,20000
06058P,玉晶光凱基97售04,0,0,0,0,0,0,0,0,0,20000,0,0,0,232000,212000,20000,20000
060500,鴻海元大9A購12  ,0,0,0,0,0,0,0,0,0,20000,0,0,0,20000,0,20000,20000
060063,可成兆豐9B購01  ,0,0,0,0,0,0,0,0,0,20000,0,0,0,55000,35000,20000,20000
060090,台積電元大99購55,0,0,0,0,0,0,0,0,0,20000,0,0,0,51000,31000,20000,20000
060021,立積康和99購01  ,0,0,0,0,0,0,0,0,0,20000,0,0,0,20000,0,20000,20000
059974,臺指反元大9C購05,0,0,0,0,0,0,0,0,0,20000,0,0,0,20000,0,20000,20000
05999P,世芯元大96售01  ,0,0,0,0,0,0,0,0,0,20000,0,0,0,20000,0,20000,20000
059935,國巨永豐99購07  ,0,0,0,0,0,0,0,0,0,20000,0,0,0,36000,16000,20000,20000
059881,臺股指凱基99購46,0,0,0,0,0,0,0,0,0,20000,0,0,0,30000,10000,20000,20000
059826,欣興凱基99購06  ,0,0,0,0,0,0,0,0,0,20000,0,0,0,20000,0,20000,20000
059572,華新科凱基99購08,0,0,0,0,0,0,0,0,0,20000,0,0,0,20000,0,20000,20000
059564,鴻海凱基9A購15  ,0,0,0,0,0,0,0,0,0,20000,0,0,0,20000,0,20000,20000
059622,上銀凱基99購10  ,0,0,0,0,0,0,0,0,0,20000,0,0,0,20000,0,20000,20000
059386,上銀凱基99購07  ,0,0,0,0,0,0,0,0,0,20000,0,0,0,23000,3000,20000,20000
059432,聯發科元大99購26,0,0,0,0,0,0,0,0,0,20000,0,0,0,50000,30000,20000,20000
059545,台灣50群益99購04,0,0,0,0,0,0,0,0,0,20000,0,0,0,20000,0,20000,20000
060951,元黃金群益9A購01,0,0,0,0,0,0,0,0,0,20000,0,0,0,20000,0,20000,20000
060887,台積電統一01購01,0,0,0,0,0,0,0,0,0,20000,0,0,0,20000,0,20000,20000
061047,大立光第一9A購01,0,0,0,0,0,0,0,0,0,20000,0,0,0,20000,0,20000,20000
06134P,緯穎元富97售03  ,0,0,0,0,0,0,0,0,0,20000,0,0,0,20000,0,20000,20000
061342,華新科元大9A購17,0,0,0,0,0,0,0,0,0,20000,0,0,0,20000,0,20000,20000
061288,大立光統一9C購01,0,0,0,0,0,0,0,0,0,20000,0,0,0,20000,0,20000,20000
06650P,聯發科元大98售09,0,0,0,0,0,0,0,0,0,20000,0,0,0,20000,0,20000,20000
06953P,景碩統一9A售01  ,0,0,0,0,0,0,0,0,0,20000,0,0,0,21000,1000,20000,20000
048527,鴻海國票94購02  ,0,0,0,0,0,0,0,0,0,20000,0,0,0,20000,0,20000,20000
03618C,高股息凱基95牛01,0,0,0,0,0,0,0,0,0,20000,0,0,0,20000,0,20000,20000
04696P,亞德客國泰95售02,0,0,0,0,0,0,0,0,0,20000,0,0,0,20000,0,20000,20000
052171,台積電元大95購21,0,0,0,0,0,0,0,0,0,20000,0,0,0,20000,0,20000,20000
052263,聯電亞東95購01  ,0,0,0,0,0,0,0,0,0,20000,0,0,0,20000,0,20000,20000
051904,深100元大95購01 ,0,0,0,0,0,0,0,0,0,20000,0,0,0,30000,10000,20000,20000
046881,智原富邦99購01  ,0,0,0,0,0,0,0,0,0,20000,0,0,0,30000,10000,20000,20000
044988,玉晶光統一95購01,0,0,0,0,0,0,0,0,0,20000,0,0,0,20000,0,20000,20000
050163,群創國泰95購01  ,0,0,0,0,0,0,0,0,0,20000,0,0,0,20000,0,20000,20000
052498,台積電永豐95購06,0,0,0,0,0,0,0,0,0,20000,0,0,0,20000,0,20000,20000
052430,泰碩永豐95購02  ,0,0,0,0,0,0,0,0,0,20000,0,0,0,20000,0,20000,20000
050867,聯鈞永豐95購01  ,0,0,0,0,0,0,0,0,0,20000,0,0,0,20000,0,20000,20000
050464,華通國泰95購01  ,0,0,0,0,0,0,0,0,0,20000,0,0,0,20000,0,20000,20000
050545,奇力新凱基95購01,0,0,0,0,0,0,0,0,0,20000,0,0,0,20000,0,20000,20000
052585,友達永豐97購01  ,0,0,0,0,0,0,0,0,0,20000,0,0,0,20000,0,20000,20000
053774,台達電元大96購04,0,0,0,0,0,0,0,0,0,20000,0,0,0,20000,0,20000,20000
05138P,嘉聯益凱基96售02,0,0,0,0,0,0,0,0,0,20000,0,0,0,20000,0,20000,20000
055104,台達電凱基98購01,0,0,0,0,0,0,0,0,0,20000,0,0,0,20000,0,20000,20000
055015,帆宣元富97購01  ,0,0,0,0,0,0,0,0,0,20000,0,0,0,20000,0,20000,20000
053890,華新科群益98購01,0,0,0,0,0,0,0,0,0,20000,0,0,0,20000,0,20000,20000
053895,智易群益96購02  ,0,0,0,0,0,0,0,0,0,20000,0,0,0,20000,0,20000,20000
054614,玉晶光永豐97購03,0,0,0,0,0,0,0,0,0,20000,0,0,0,20000,0,20000,20000
055217,緯創凱基97購02  ,0,0,0,0,0,0,0,0,0,20000,0,0,0,133000,113000,20000,20000
054751,GIS凱基98購01   ,0,0,0,0,0,0,0,0,0,20000,0,0,0,20000,0,20000,20000
054877,百和群益98購01  ,0,0,0,0,0,0,0,0,0,20000,0,0,0,20000,0,20000,20000
054867,華航群益99購01  ,0,0,0,0,0,0,0,0,0,20000,0,0,0,20000,0,20000,20000
053136,彩晶國票97購01  ,0,0,0,0,0,0,0,0,0,20000,0,0,0,20000,0,20000,20000
053141,景碩永豐96購02  ,0,0,0,0,0,0,0,0,0,20000,0,0,0,20000,0,20000,20000
053123,京元電凱基96購01,0,0,0,0,0,0,0,0,0,20000,0,0,0,20000,0,20000,20000
053079,世紀鋼永豐96購01,0,0,0,0,0,0,0,0,0,20000,0,0,0,20000,0,20000,20000
053569,漢唐統一98購01  ,0,0,0,0,0,0,0,0,0,20000,0,0,0,131000,111000,20000,20000
053585,友達元大9C購03  ,0,0,0,0,0,0,0,0,0,20000,0,0,0,20000,0,20000,20000
053610,矽力中信98購01  ,0,0,0,0,0,0,0,0,0,20000,0,0,0,20000,0,20000,20000
053689,台光電元大96購01,0,0,0,0,0,0,0,0,0,20000,0,0,0,20000,0,20000,20000
052719,致新凱基96購01  ,0,0,0,0,0,0,0,0,0,20000,0,0,0,20000,0,20000,20000
052815,滬深2X永豐97購01,0,0,0,0,0,0,0,0,0,20000,0,0,0,20000,0,20000,20000
057869,大立光凱基99購01,0,0,0,0,0,0,0,0,0,20000,0,0,0,20000,0,20000,20000
052995,上銀康和96購01  ,0,0,0,0,0,0,0,0,0,20000,0,0,0,20000,0,20000,20000
053019,禾伸堂元富96購01,0,0,0,0,0,0,0,0,0,20000,0,0,0,20000,0,20000,20000
05300P,健策元大95售02  ,0,0,0,0,0,0,0,0,0,20000,0,0,0,20000,0,20000,20000
05423P,聯電亞東95售02  ,0,0,0,0,0,0,0,0,0,20000,0,0,0,20000,0,20000,20000
052870,玉晶光凱基96購03,0,0,0,0,0,0,0,0,0,20000,0,0,0,20000,0,20000,20000
054215,創意國票97購02  ,0,0,0,0,0,0,0,0,0,20000,0,0,0,20000,0,20000,20000
056252,聯發科兆豐97購03,0,0,0,0,0,0,0,0,0,20000,0,0,0,20000,0,20000,20000
057163,上銀元大98購04  ,0,0,0,0,0,0,0,0,0,20000,0,0,0,20000,0,20000,20000
056166,微星台新97購01  ,0,0,0,0,0,0,0,0,0,20000,0,0,0,20000,0,20000,20000
058195,鈺齊永豐99購01  ,0,0,0,0,0,0,0,0,0,20000,0,0,0,20000,0,20000,20000
056350,上銀元大98購02  ,0,0,0,0,0,0,0,0,0,20000,0,0,0,20000,0,20000,20000
055700,緯穎國泰98購02  ,0,0,0,0,0,0,0,0,0,20000,0,0,0,30000,10000,20000,20000
055372,宏達電元大97購04,0,0,0,0,0,0,0,0,0,20000,0,0,0,20000,0,20000,20000
055919,景碩凱基98購02  ,0,0,0,0,0,0,0,0,0,20000,0,0,0,20000,0,20000,20000
055925,上銀群益97購01  ,0,0,0,0,0,0,0,0,0,20000,0,0,0,20000,0,20000,20000
055866,臺股指元大97購03,0,0,0,0,0,0,0,0,0,20000,0,0,0,20000,0,20000,20000
058790,楠梓電元大99購03,0,0,0,0,0,0,0,0,0,20000,0,0,0,100000,80000,20000,20000
055246,美律統一98購01  ,0,0,0,0,0,0,0,0,0,20000,0,0,0,20000,0,20000,20000
057304,為升兆豐99購02  ,0,0,0,0,0,0,0,0,0,20000,0,0,0,20000,0,20000,20000
056845,揚明光元富98購01,0,0,0,0,0,0,0,0,0,20000,0,0,0,20000,0,20000,20000
056922,全新兆豐99購01  ,0,0,0,0,0,0,0,0,0,20000,0,0,0,20000,0,20000,20000
056379,玉晶光元富98購01,0,0,0,0,0,0,0,0,0,20000,0,0,0,20000,0,20000,20000
056399,上証2X群益9C購01,0,0,0,0,0,0,0,0,0,20000,0,0,0,30000,10000,20000,20000
057268,臻鼎兆豐99購01  ,0,0,0,0,0,0,0,0,0,20000,0,0,0,30000,10000,20000,20000
057232,京元電凱基98購02,0,0,0,0,0,0,0,0,0,20000,0,0,0,30000,10000,20000,20000
057225,華新凱基98購01  ,0,0,0,0,0,0,0,0,0,20000,0,0,0,20000,0,20000,20000
055456,上銀富邦99購01  ,0,0,0,0,0,0,0,0,0,20000,0,0,0,20000,0,20000,20000
058856,新光金兆豐99購01,0,0,0,0,0,0,0,0,0,20000,0,0,0,20000,0,20000,20000
058860,SGBR2X凱基9A購01,0,0,0,0,0,0,0,0,0,20000,0,0,0,20000,0,20000,20000
058863,可成凱基99購02  ,0,0,0,0,0,0,0,0,0,20000,0,0,0,30000,10000,20000,20000
058883,旭富永豐99購01  ,0,0,0,0,0,0,0,0,0,20000,0,0,0,20000,0,20000,20000
058937,仁寶中信99購01  ,0,0,0,0,0,0,0,0,0,20000,0,0,0,31000,11000,20000,20000
058994,道瓊指元大99購01,0,0,0,0,0,0,0,0,0,20000,0,0,0,20000,0,20000,20000
057528,南亞科元大99購01,0,0,0,0,0,0,0,0,0,20000,0,0,0,20000,0,20000,20000
057472,T50正2元大9B購03,0,0,0,0,0,0,0,0,0,20000,0,0,0,20000,0,20000,20000
057478,智邦元大99購01  ,0,0,0,0,0,0,0,0,0,20000,0,0,0,20000,0,20000,20000
057337,聯發科國票99購02,0,0,0,0,0,0,0,0,0,20000,0,0,0,20000,0,20000,20000
05926P,智易永豐96售02  ,0,0,0,0,0,0,0,0,0,20000,0,0,0,20000,0,20000,20000
059209,華通元大99購08  ,0,0,0,0,0,0,0,0,0,20000,0,0,0,20000,0,20000,20000
059078,FBVIX元大99購06 ,0,0,0,0,0,0,0,0,0,20000,0,0,0,23000,3000,20000,20000
6698,旭暉應材        ,37000,17000,20000,0,0,0,0,0,0,0,0,0,0,0,0,0,20000
07294P,滬深2X元富9C售08,0,0,0,0,0,0,0,0,0,20000,0,0,0,30000,10000,20000,20000
07251P,台灣50元富01售04,0,0,0,0,0,0,0,0,0,20000,0,0,0,20000,0,20000,20000
07230P,滬深2X群益01售02,0,0,0,0,0,0,0,0,0,20000,0,0,0,30000,10000,20000,20000
07238P,台灣50國票99售07,0,0,0,0,0,0,0,0,0,20000,0,0,0,20000,0,20000,20000
07405P,大立光凱基99售17,0,0,0,0,0,0,0,0,0,20000,0,0,0,20000,0,20000,20000
07505P,台勝科元大9A售01,0,0,0,0,0,0,0,0,0,20000,0,0,0,26000,6000,20000,20000
07621P,台積電統一9B售09,0,0,0,0,0,0,0,0,0,20000,0,0,0,20000,0,20000,20000
07601P,國巨統一9A售05  ,0,0,0,0,0,0,0,0,0,20000,0,0,0,30000,10000,20000,20000
07578P,高鐵元大9A售02  ,0,0,0,0,0,0,0,0,0,20000,0,0,0,20000,0,20000,20000
07728P,臺股指凱基9A售20,0,0,0,0,0,0,0,0,0,20000,0,0,0,20000,0,20000,20000
07694P,超眾元大9A售05  ,0,0,0,0,0,0,0,0,0,20000,0,0,0,45000,25000,20000,20000
6152,百一            ,20000,0,20000,0,0,0,0,0,0,0,0,0,0,0,0,0,20000
3028,增你強          ,24000,4000,20000,0,0,0,0,0,0,0,0,0,0,0,0,0,20000
2331,精英            ,70000,50000,20000,0,0,0,0,0,0,0,0,0,0,0,0,0,20000
07021P,台積電富邦9C售02,0,0,0,0,0,0,0,0,0,19000,0,0,0,19000,0,19000,19000
06572P,台積電永昌99售01,0,0,0,0,0,0,0,0,0,19000,0,0,0,39000,20000,19000,19000
06421P,嘉澤統一97售02  ,0,0,0,0,0,0,0,0,0,19000,0,0,0,30000,11000,19000,19000
061289,玉晶光統一01購03,0,0,0,0,0,0,0,0,0,19000,0,0,0,69000,50000,19000,19000
061280,國巨統一9C購06  ,0,0,0,0,0,0,0,0,0,19000,0,0,0,239000,220000,19000,19000
061305,帆宣永豐9A購01  ,0,0,0,0,0,0,0,0,0,19000,0,0,0,59000,40000,19000,19000
060996,臻鼎元大9A購01  ,0,0,0,0,0,0,0,0,0,19000,0,0,0,23000,4000,19000,19000
059855,緯穎永豐99購04  ,0,0,0,0,0,0,0,0,0,19000,0,0,0,28000,9000,19000,19000
060594,國巨麥證9A購01  ,0,0,0,24000,5000,19000,0,0,0,19000,0,0,0,24000,5000,19000,19000
060610,玉晶光凱基9B購02,0,0,0,0,0,0,0,0,0,19000,0,0,0,69000,50000,19000,19000
060130,瀚宇博永豐99購02,0,0,0,0,0,0,0,0,0,19000,0,0,0,19000,0,19000,19000
060203,緯穎元富9A購01  ,0,0,0,0,0,0,0,0,0,19000,0,0,0,177000,158000,19000,19000
054069,亞光國泰98購01  ,0,0,0,0,0,0,0,0,0,19000,0,0,0,19000,0,19000,19000
054093,智原群益97購01  ,0,0,0,0,0,0,0,0,0,19000,0,0,0,31000,12000,19000,19000
052938,華新科兆豐96購01,0,0,0,0,0,0,0,0,0,19000,0,0,0,19000,0,19000,19000
054770,健策國票98購01  ,0,0,0,0,0,0,0,0,0,19000,0,0,0,19000,0,19000,19000
055147,鴻海元大97購11  ,0,0,0,0,0,0,0,0,0,19000,0,0,0,99000,80000,19000,19000
050902,南電元大96購01  ,0,0,0,0,0,0,0,0,0,19000,0,0,0,87000,68000,19000,19000
059130,台灣50群益9B購05,0,0,0,0,0,0,0,0,0,19000,0,0,0,19000,0,19000,19000
05919P,京鼎元大96售03  ,0,0,0,0,0,0,0,0,0,19000,0,0,0,225000,206000,19000,19000
057341,技嘉台新98購01  ,0,0,0,0,0,0,0,0,0,19000,0,0,0,19000,0,19000,19000
057524,旺宏元大99購04  ,0,0,0,0,0,0,0,0,0,19000,0,0,0,19000,0,19000,19000
056820,欣興永豐98購02  ,0,0,0,0,0,0,0,0,0,19000,0,0,0,20000,1000,19000,19000
058564,元金2X凱基9C購01,0,0,0,0,0,0,0,0,0,19000,0,0,0,19000,0,19000,19000
055695,大毅國票98購03  ,0,0,0,0,0,0,0,0,0,19000,0,0,0,19000,0,19000,19000
05851P,力山群益97售01  ,0,0,0,0,0,0,0,0,0,19000,0,0,0,20000,1000,19000,19000
058027,鴻海富邦98購04  ,0,0,0,0,0,0,0,0,0,19000,0,0,0,19000,0,19000,19000
05621P,聯電中信96售01  ,0,0,0,0,0,0,0,0,0,19000,0,0,0,27000,8000,19000,19000
3047,訊舟            ,102000,83000,19000,0,0,0,0,0,0,0,0,0,0,0,0,0,19000
6166,凌華            ,49000,30000,19000,0,0,0,0,0,0,0,0,0,0,0,0,0,19000
07747P,晶技凱基9A售04  ,0,0,0,0,0,0,0,0,0,19000,0,0,0,46000,27000,19000,19000
1711,永光            ,81000,62000,19000,0,0,0,0,0,0,0,0,0,0,0,0,0,19000
07146P,瑞昱元大99售02  ,0,0,0,0,0,0,0,0,0,19000,0,0,0,21000,2000,19000,19000
8367,建新國際        ,21000,2000,19000,0,0,0,0,0,0,0,0,0,0,0,0,0,19000
060217,國巨凱基9A購10  ,0,0,0,0,0,0,0,0,0,18000,0,0,0,43000,25000,18000,18000
060145,牧德國票9A購02  ,0,0,0,0,0,0,0,0,0,18000,0,0,0,45000,27000,18000,18000
060345,聯發科統一9B購05,0,0,0,0,0,0,0,0,0,18000,0,0,0,21000,3000,18000,18000
060339,國巨統一01購01  ,0,0,0,0,0,0,0,0,0,18000,0,0,0,87000,69000,18000,18000
060593,華通麥證9A購01  ,0,0,0,18000,0,18000,0,0,0,18000,0,0,0,18000,0,18000,18000
060662,旺宏凱基9A購03  ,0,0,0,0,0,0,0,0,0,18000,0,0,0,31000,13000,18000,18000
060487,盛群富邦9B購01  ,0,0,0,0,0,0,0,0,0,18000,0,0,0,37000,19000,18000,18000
060415,葡萄王永豐9A購01,0,0,0,0,0,0,0,0,0,18000,0,0,0,18000,0,18000,18000
059802,上証2X元富99購02,0,0,0,0,0,0,0,0,0,18000,0,0,0,18000,0,18000,18000
059987,大立光元大99購28,0,0,0,0,0,0,0,0,0,18000,0,0,0,29000,11000,18000,18000
059390,華新科凱基99購05,0,0,0,0,0,0,0,0,0,18000,0,0,0,25000,7000,18000,18000
059565,國巨凱基99購16  ,0,0,0,0,0,0,0,0,0,18000,0,0,0,43000,25000,18000,18000
059705,華新科凱基9A購07,0,0,0,0,0,0,0,0,0,18000,0,0,0,18000,0,18000,18000
060959,金像電凱基9A購01,0,0,0,0,0,0,0,0,0,18000,0,0,0,241000,223000,18000,18000
061208,聯發科元大9A購09,0,0,0,0,0,0,0,0,0,18000,0,0,0,93000,75000,18000,18000
049602,南電元大95購01  ,0,0,0,0,0,0,0,0,0,18000,0,0,0,28000,10000,18000,18000
04250P,嘉晶統一95售02  ,0,0,0,0,0,0,0,0,0,18000,0,0,0,18000,0,18000,18000
049554,禾伸堂富邦96購01,0,0,0,0,0,0,0,0,0,18000,0,0,0,18000,0,18000,18000
051926,聯電中信97購01  ,0,0,0,0,0,0,0,0,0,18000,0,0,0,38000,20000,18000,18000
00648R,元大S&P500反1   ,5000,0,5000,0,0,0,0,0,0,13000,0,0,0,244000,231000,13000,18000
054254,晶豪科元大96購02,0,0,0,0,0,0,0,0,0,18000,0,0,0,26000,8000,18000,18000
05446P,緯穎元大95售04  ,0,0,0,0,0,0,0,0,0,18000,0,0,0,18000,0,18000,18000
057957,嘉晶元大98購01  ,0,0,0,0,0,0,0,0,0,18000,0,0,0,119000,101000,18000,18000
057725,台達電國泰9A購01,0,0,0,0,0,0,0,0,0,18000,0,0,0,18000,0,18000,18000
057087,台郡統一99購01  ,0,0,0,0,0,0,0,0,0,18000,0,0,0,19000,1000,18000,18000
058135,景碩元大99購01  ,0,0,0,0,0,0,0,0,0,18000,0,0,0,68000,50000,18000,18000
058485,智邦國票9A購01  ,0,0,0,0,0,0,0,0,0,18000,0,0,0,18000,0,18000,18000
058409,鴻海兆豐99購05  ,0,0,0,0,0,0,0,0,0,18000,0,0,0,18000,0,18000,18000
058192,訊芯永豐99購01  ,0,0,0,0,0,0,0,0,0,18000,0,0,0,89000,71000,18000,18000
058240,景碩元大99購04  ,0,0,0,0,0,0,0,0,0,18000,0,0,0,68000,50000,18000,18000
058700,鴻海元大99購15  ,0,0,0,0,0,0,0,0,0,18000,0,0,0,33000,15000,18000,18000
056295,國巨元大97購16  ,0,0,0,0,0,0,0,0,0,18000,0,0,0,77000,59000,18000,18000
057295,可成永豐98購02  ,0,0,0,0,0,0,0,0,0,18000,0,0,0,28000,10000,18000,18000
056694,欣興群益98購04  ,0,0,0,0,0,0,0,0,0,18000,0,0,0,117000,99000,18000,18000
056470,旺宏元大99購01  ,0,0,0,0,0,0,0,0,0,18000,0,0,0,18000,0,18000,18000
057527,億光元大98購01  ,0,0,0,0,0,0,0,0,0,18000,0,0,0,245000,227000,18000,18000
059289,瑞昱元富99購01  ,0,0,0,0,0,0,0,0,0,18000,0,0,0,46000,28000,18000,18000
9941,裕融            ,76000,58000,18000,0,0,0,0,0,0,0,0,0,0,0,0,0,18000
07583P,台積電富邦9B售05,0,0,0,0,0,0,0,0,0,18000,0,0,0,18000,0,18000,18000
4572,駐龍            ,19000,1000,18000,0,0,0,0,0,0,0,0,0,0,0,0,0,18000
2010,春源            ,28000,10000,18000,0,0,0,0,0,0,0,0,0,0,0,0,0,18000
2465,麗臺            ,20000,2000,18000,0,0,0,0,0,0,0,0,0,0,0,0,0,18000
060924,大毅永豐9A購03  ,0,0,0,0,0,0,0,0,0,17000,0,0,0,17000,0,17000,17000
061406,華通國票9A購06  ,0,0,0,0,0,0,0,0,0,17000,0,0,0,17000,0,17000,17000
06602P,國巨統一99售02  ,0,0,0,0,0,0,0,0,0,17000,0,0,0,43000,26000,17000,17000
059351,台虹凱基99購01  ,0,0,0,0,0,0,0,0,0,17000,0,0,0,114000,97000,17000,17000
060007,鴻海群益99購04  ,0,0,0,0,0,0,0,0,0,17000,0,0,0,38000,21000,17000,17000
060020,康控康和99購01  ,0,0,0,0,0,0,0,0,0,17000,0,0,0,113000,96000,17000,17000
059809,貿聯元富99購01  ,0,0,0,0,0,0,0,0,0,17000,0,0,0,17000,0,17000,17000
060109,茂林元大99購05  ,0,0,0,0,0,0,0,0,0,17000,0,0,0,35000,18000,17000,17000
057955,技嘉元大98購07  ,0,0,0,0,0,0,0,0,0,17000,0,0,0,57000,40000,17000,17000
053024,國巨富邦97購02  ,0,0,0,0,0,0,0,0,0,17000,0,0,0,17000,0,17000,17000
053464,喬山元大96購01  ,0,0,0,0,0,0,0,0,0,17000,0,0,0,17000,0,17000,17000
048902,昇陽半國泰96購01,0,0,0,0,0,0,0,0,0,17000,0,0,0,17000,0,17000,17000
051781,緯穎群益96購01  ,0,0,0,0,0,0,0,0,0,17000,0,0,0,17000,0,17000,17000
051728,道瓊反國票97購01,0,0,0,0,0,0,0,0,0,17000,0,0,0,20000,3000,17000,17000
050936,國巨國票95購04  ,0,0,0,0,0,0,0,0,0,17000,0,0,0,17000,0,17000,17000
059121,瑞儀永豐99購01  ,0,0,0,0,0,0,0,0,0,17000,0,0,0,53000,36000,17000,17000
058796,可成元大99購04  ,0,0,0,0,0,0,0,0,0,17000,0,0,0,120000,103000,17000,17000
056479,玉晶光元大99購05,0,0,0,0,0,0,0,0,0,17000,0,0,0,53000,36000,17000,17000
056507,創意永豐98購02  ,0,0,0,0,0,0,0,0,0,17000,0,0,0,17000,0,17000,17000
056590,樺漢統一9A購01  ,0,0,0,0,0,0,0,0,0,17000,0,0,0,17000,0,17000,17000
056767,大毅元大99購01  ,0,0,0,0,0,0,0,0,0,17000,0,0,0,40000,23000,17000,17000
055272,國巨元大98購04  ,0,0,0,0,0,0,0,0,0,17000,0,0,0,32000,15000,17000,17000
058673,華新科群益9A購02,0,0,0,0,0,0,0,0,0,17000,0,0,0,17000,0,17000,17000
055720,宏達電元大97購05,0,0,0,0,0,0,0,0,0,17000,0,0,0,67000,50000,17000,17000
055675,亞德客凱基97購02,0,0,0,0,0,0,0,0,0,17000,0,0,0,49000,32000,17000,17000
055583,國巨元大97購10  ,0,0,0,0,0,0,0,0,0,17000,0,0,0,237000,220000,17000,17000
058206,祥碩凱基99購01  ,0,0,0,0,0,0,0,0,0,17000,0,0,0,584000,567000,17000,17000
058042,鴻海元大98購12  ,0,0,0,0,0,0,0,0,0,17000,0,0,0,33000,16000,17000,17000
4552,力達-KY         ,35000,18000,17000,0,0,0,0,0,0,0,0,0,0,0,0,0,17000
3050,鈺德            ,26000,9000,17000,0,0,0,0,0,0,0,0,0,0,0,0,0,17000
3022,威強電          ,68000,51000,17000,0,0,0,0,0,0,0,0,0,0,0,0,0,17000
07411P,國巨元大99售31  ,0,0,0,0,0,0,0,0,0,17000,0,0,0,17000,0,17000,17000
6715,嘉基            ,22000,5000,17000,0,0,0,0,0,0,0,0,0,0,0,0,0,17000
6581,鋼聯            ,21000,4000,17000,0,0,0,0,0,0,0,0,0,0,0,0,0,17000
00752,中信中國50      ,0,0,0,0,0,0,0,0,0,16143,0,0,0,266000,249857,16143,16143
060280,元金2X元大9A購01,0,0,0,0,0,0,0,0,0,16000,0,0,0,100000,84000,16000,16000
060066,欣興兆豐9B購01  ,0,0,0,0,0,0,0,0,0,16000,0,0,0,31000,15000,16000,16000
060016,廣達康和99購01  ,0,0,0,0,0,0,0,0,0,16000,0,0,0,18000,2000,16000,16000
059409,台灣50國票9C購01,0,0,0,0,0,0,0,0,0,16000,0,0,0,16000,0,16000,16000
061335,國巨元大9A購19  ,0,0,0,0,0,0,0,0,0,16000,0,0,0,86000,70000,16000,16000
061064,可成凱基9B購02  ,0,0,0,0,0,0,0,0,0,16000,0,0,0,16000,0,16000,16000
061161,南六群益9A購01  ,0,0,0,0,0,0,0,0,0,16000,0,0,0,17000,1000,16000,16000
00683L,元大美元指數正2 ,0,0,0,0,0,0,0,0,0,16000,0,0,0,17000,1000,16000,16000
03619C,臺股指元大95牛02,0,0,0,0,0,0,0,0,0,16000,0,0,0,16000,0,16000,16000
051769,矽力元大95購01  ,0,0,0,0,0,0,0,0,0,16000,0,0,0,40000,24000,16000,16000
049795,華通元大96購02  ,0,0,0,0,0,0,0,0,0,16000,0,0,0,16000,0,16000,16000
049972,南電國票95購02  ,0,0,0,0,0,0,0,0,0,16000,0,0,0,40000,24000,16000,16000
053625,國巨兆豐96購03  ,0,0,0,0,0,0,0,0,0,16000,0,0,0,26000,10000,16000,16000
053151,華新科元大96購04,0,0,0,0,0,0,0,0,0,16000,0,0,0,16000,0,16000,16000
057118,欣興日盛9A購01  ,0,0,0,0,0,0,0,0,0,16000,0,0,0,16000,0,16000,16000
05609P,國泰金凱基96售01,0,0,0,0,0,0,0,0,0,16000,0,0,0,126000,110000,16000,16000
056783,國巨群益99購01  ,0,0,0,0,0,0,0,0,0,16000,0,0,0,282000,266000,16000,16000
05683P,矽創元大96售01  ,0,0,0,0,0,0,0,0,0,16000,0,0,0,50000,34000,16000,16000
056921,京元電兆豐98購01,0,0,0,0,0,0,0,0,0,16000,0,0,0,113000,97000,16000,16000
055473,禾伸堂凱基97購01,0,0,0,0,0,0,0,0,0,16000,0,0,0,16000,0,16000,16000
056388,勤誠國泰99購01  ,0,0,0,0,0,0,0,0,0,16000,0,0,0,16000,0,16000,16000
059188,京元電富邦9B購01,0,0,0,0,0,0,0,0,0,16000,0,0,0,118000,102000,16000,16000
059173,矽力凱基99購01  ,0,0,0,0,0,0,0,0,0,16000,0,0,0,16000,0,16000,16000
059330,台灣50國票99購10,0,0,0,0,0,0,0,0,0,16000,0,0,0,16000,0,16000,16000
5706,鳳凰            ,23000,7000,16000,0,0,0,0,0,0,0,0,0,0,0,0,0,16000
2419,仲琦            ,80000,64000,16000,0,0,0,0,0,0,0,0,0,0,0,0,0,16000
2404,漢唐            ,183000,120000,63000,0,0,0,0,24000,-24000,-23000,10000,10000,0,7000,30000,-23000,16000
061364,國巨國票9A購09  ,0,0,0,0,0,0,0,0,0,15000,0,0,0,248000,233000,15000,15000
061375,華通永豐9A購02  ,0,0,0,0,0,0,0,0,0,15000,0,0,0,17000,2000,15000,15000
060839,聯發科國票9A購02,0,0,0,0,0,0,0,0,0,15000,0,0,0,20000,5000,15000,15000
06581P,南亞科凱基98售04,0,0,0,0,0,0,0,0,0,15000,0,0,0,31000,16000,15000,15000
06868P,電子類元大99售01,0,0,0,0,0,0,0,0,0,15000,0,0,0,16000,1000,15000,15000
07049P,聯發科中信99售03,0,0,0,0,0,0,0,0,0,15000,0,0,0,50000,35000,15000,15000
061434,國巨麥證9A購04  ,0,0,0,15000,0,15000,0,0,0,15000,0,0,0,15000,0,15000,15000
06448P,華通元大99售01  ,0,0,0,0,0,0,0,0,0,15000,0,0,0,22000,7000,15000,15000
059725,聯發科元大99購31,0,0,0,0,0,0,0,0,0,15000,0,0,0,15000,0,15000,15000
059571,奇力新凱基99購06,0,0,0,0,0,0,0,0,0,15000,0,0,0,15000,0,15000,15000
060009,南亞科群益99購03,0,0,0,0,0,0,0,0,0,15000,0,0,0,145000,130000,15000,15000
059815,SP黃豆凱基9A購03,0,0,0,0,0,0,0,0,0,15000,0,0,0,15000,0,15000,15000
060351,滬深2X元富9A購01,0,0,0,0,0,0,0,0,0,15000,0,0,0,52000,37000,15000,15000
060139,T50反1國票9A購04,0,0,0,0,0,0,0,0,0,15000,0,0,0,15000,0,15000,15000
060151,旺宏富邦9A購02  ,0,0,0,0,0,0,0,0,0,15000,0,0,0,36000,21000,15000,15000
054952,大毅元大97購02  ,0,0,0,0,0,0,0,0,0,15000,0,0,0,15000,0,15000,15000
053629,玉山金兆豐96購01,0,0,0,0,0,0,0,0,0,15000,0,0,0,15000,0,15000,15000
052747,京鼎元大97購01  ,0,0,0,0,0,0,0,0,0,15000,0,0,0,15000,0,15000,15000
053400,緯穎中信9A購01  ,0,0,0,0,0,0,0,0,0,15000,0,0,0,163000,148000,15000,15000
053191,奇鋐統一96購01  ,0,0,0,0,0,0,0,0,0,15000,0,0,0,15000,0,15000,15000
053231,奇力新康和96購01,0,0,0,0,0,0,0,0,0,15000,0,0,0,80000,65000,15000,15000
052967,智邦群益96購01  ,0,0,0,0,0,0,0,0,0,15000,0,0,0,15000,0,15000,15000
052922,國巨永豐96購01  ,0,0,0,0,0,0,0,0,0,15000,0,0,0,15000,0,15000,15000
052928,美律元大98購01  ,0,0,0,0,0,0,0,0,0,15000,0,0,0,15000,0,15000,15000
057760,聯發科凱基98購18,0,0,0,0,0,0,0,0,0,15000,0,0,0,15000,0,15000,15000
057604,鴻海統一9C購01  ,0,0,0,0,0,0,0,0,0,15000,0,0,0,15000,0,15000,15000
052429,禾伸堂永豐95購02,0,0,0,0,0,0,0,0,0,15000,0,0,0,85000,70000,15000,15000
053932,華新科統一96購03,0,0,0,0,0,0,0,0,0,15000,0,0,0,16000,1000,15000,15000
055079,台光電中信97購01,0,0,0,0,0,0,0,0,0,15000,0,0,0,15000,0,15000,15000
051582,聯發科元大97購02,0,0,0,0,0,0,0,0,0,15000,0,0,0,15000,0,15000,15000
051590,玉晶光元大96購02,0,0,0,0,0,0,0,0,0,15000,0,0,0,15000,0,15000,15000
053735,矽力中信97購01  ,0,0,0,0,0,0,0,0,0,15000,0,0,0,30000,15000,15000,15000
051801,牧德永豐95購04  ,0,0,0,0,0,0,0,0,0,15000,0,0,0,376000,361000,15000,15000
05161P,華新科國票96售01,0,0,0,0,0,0,0,0,0,15000,0,0,0,65000,50000,15000,15000
049442,滬深2X統一99購01,0,0,0,0,0,0,0,0,0,15000,0,0,0,15000,0,15000,15000
048483,可成國泰95購01  ,0,0,0,0,0,0,0,0,0,15000,0,0,0,15000,0,15000,15000
047904,臺指反元大96購01,0,0,0,0,0,0,0,0,0,15000,0,0,0,15000,0,15000,15000
047196,上銀統一97購01  ,0,0,0,0,0,0,0,0,0,15000,0,0,0,15000,0,15000,15000
059304,華新科兆豐99購06,0,0,0,0,0,0,0,0,0,15000,0,0,0,15000,0,15000,15000
05922P,京元電兆豐96售01,0,0,0,0,0,0,0,0,0,15000,0,0,0,15000,0,15000,15000
059020,元油2X統一9B購02,0,0,0,0,0,0,0,0,0,15000,0,0,0,53000,38000,15000,15000
057538,緯穎元大98購07  ,0,0,0,0,0,0,0,0,0,15000,0,0,0,20000,5000,15000,15000
058919,SGBR2X元富99購05,0,0,0,0,0,0,0,0,0,15000,0,0,0,40000,25000,15000,15000
056414,國巨中信98購02  ,0,0,0,0,0,0,0,0,0,15000,0,0,0,15000,0,15000,15000
056885,元油2X元大99購03,0,0,0,0,0,0,0,0,0,15000,0,0,0,30000,15000,15000,15000
057309,南茂兆豐99購01  ,0,0,0,0,0,0,0,0,0,15000,0,0,0,15000,0,15000,15000
058516,健鼎元大99購02  ,0,0,0,0,0,0,0,0,0,15000,0,0,0,90000,75000,15000,15000
058503,鴻海元大99購14  ,0,0,0,0,0,0,0,0,0,15000,0,0,0,134000,119000,15000,15000
058457,創意永豐99購01  ,0,0,0,0,0,0,0,0,0,15000,0,0,0,32000,17000,15000,15000
055623,貿聯國泰99購01  ,0,0,0,0,0,0,0,0,0,15000,0,0,0,50000,35000,15000,15000
055375,京鼎元大97購03  ,0,0,0,0,0,0,0,0,0,15000,0,0,0,15000,0,15000,15000
058628,宏達電國票9A購01,0,0,0,0,0,0,0,0,0,15000,0,0,0,15000,0,15000,15000
2426,鼎元            ,158000,134000,24000,0,0,0,0,0,0,-9000,0,9000,-9000,0,0,0,15000
2705,六福            ,16000,1000,15000,0,0,0,0,0,0,0,0,0,0,0,0,0,15000
4108,懷特            ,66000,51000,15000,0,0,0,0,0,0,0,0,0,0,0,0,0,15000
07406P,大立光凱基99售18,0,0,0,0,0,0,0,0,0,15000,0,0,0,15000,0,15000,15000
07441P,臺股指麥證9B售03,0,0,0,15000,0,15000,0,0,0,15000,0,0,0,15000,0,15000,15000
07566P,台積電台新9B售02,0,0,0,0,0,0,0,0,0,15000,0,0,0,15000,0,15000,15000
07764P,世紀鋼永豐9A售04,0,0,0,0,0,0,0,0,0,15000,0,0,0,15000,0,15000,15000
07688P,華通元大9A售07  ,0,0,0,0,0,0,0,0,0,15000,0,0,0,15000,0,15000,15000
06038P,國泰金台新96售01,0,0,0,0,0,0,0,0,0,14000,0,0,0,14000,0,14000,14000
060282,聚陽元大9A購01  ,0,0,0,0,0,0,0,0,0,14000,0,0,0,67000,53000,14000,14000
060428,瑞祺永豐9A購01  ,0,0,0,0,0,0,0,0,0,14000,0,0,0,699000,685000,14000,14000
060685,康友元大9A購01  ,0,0,0,0,0,0,0,0,0,14000,0,0,0,91000,77000,14000,14000
06396P,新日興康和97售01,0,0,0,0,0,0,0,0,0,14000,0,0,0,17000,3000,14000,14000
07025P,玉晶光凱基99售01,0,0,0,0,0,0,0,0,0,14000,0,0,0,14000,0,14000,14000
060943,宏達電國票9B購02,0,0,0,0,0,0,0,0,0,14000,0,0,0,14000,0,14000,14000
060913,宏達電元大9A購03,0,0,0,0,0,0,0,0,0,14000,0,0,0,114000,100000,14000,14000
061044,世紀鋼永豐9A購02,0,0,0,0,0,0,0,0,0,14000,0,0,0,44000,30000,14000,14000
048189,臺指反元大96購06,0,0,0,0,0,0,0,0,0,14000,0,0,0,21000,7000,14000,14000
04794P,友達元大96售03  ,0,0,0,0,0,0,0,0,0,14000,0,0,0,14000,0,14000,14000
045054,聯發科元富98購02,0,0,0,0,0,0,0,0,0,14000,0,0,0,50000,36000,14000,14000
050261,國巨元大95購04  ,0,0,0,0,0,0,0,0,0,14000,0,0,0,15000,1000,14000,14000
050854,世紀鋼國票97購01,0,0,0,0,0,0,0,0,0,14000,0,0,0,43000,29000,14000,14000
057948,嘉聯益國票99購02,0,0,0,0,0,0,0,0,0,14000,0,0,0,16000,2000,14000,14000
057895,全新元富9B購01  ,0,0,0,0,0,0,0,0,0,14000,0,0,0,21000,7000,14000,14000
05431P,台光電統一97售01,0,0,0,0,0,0,0,0,0,14000,0,0,0,14000,0,14000,14000
058508,聯發科元大99購11,0,0,0,0,0,0,0,0,0,14000,0,0,0,14000,0,14000,14000
058387,國巨國票9A購03  ,0,0,0,0,0,0,0,0,0,14000,0,0,0,230000,216000,14000,14000
058403,玉晶光元大99購12,0,0,0,0,0,0,0,0,0,14000,0,0,0,147000,133000,14000,14000
056438,旺宏凱基98購05  ,0,0,0,0,0,0,0,0,0,14000,0,0,0,14000,0,14000,14000
057566,欣興富邦99購01  ,0,0,0,0,0,0,0,0,0,14000,0,0,0,14000,0,14000,14000
057481,技嘉元大98購04  ,0,0,0,0,0,0,0,0,0,14000,0,0,0,14000,0,14000,14000
057431,京鼎兆豐98購02  ,0,0,0,0,0,0,0,0,0,14000,0,0,0,50000,36000,14000,14000
059246,奇力新凱基9A購02,0,0,0,0,0,0,0,0,0,14000,0,0,0,14000,0,14000,14000
059240,台積電凱基9A購09,0,0,0,0,0,0,0,0,0,14000,0,0,0,32000,18000,14000,14000
07719P,臺股指群益9A售08,0,0,0,0,0,0,0,0,0,14000,0,0,0,77000,63000,14000,14000
07524P,臺股指中信9B售06,0,0,0,0,0,0,0,0,0,14000,0,0,0,19000,5000,14000,14000
07226P,貿聯富邦9B售01  ,0,0,0,0,0,0,0,0,0,14000,0,0,0,16000,2000,14000,14000
3018,同開            ,100000,86000,14000,0,0,0,0,0,0,0,0,0,0,0,0,0,14000
3040,遠見            ,2506900,2492900,14000,0,0,0,0,0,0,0,0,0,0,0,0,0,14000
5283,禾聯碩          ,15000,1000,14000,0,0,0,0,0,0,0,0,0,0,0,0,0,14000
4999,鑫禾            ,26000,12000,14000,0,0,0,0,0,0,0,0,0,0,0,0,0,14000
9934,成霖            ,51000,37000,14000,0,0,0,0,0,0,0,0,0,0,0,0,0,14000
060954,國泰金群益9A購02,0,0,0,0,0,0,0,0,0,13000,0,0,0,13000,0,13000,13000
061141,臻鼎統一9A購01  ,0,0,0,0,0,0,0,0,0,13000,0,0,0,86000,73000,13000,13000
061058,健策國票9A購05  ,0,0,0,0,0,0,0,0,0,13000,0,0,0,24000,11000,13000,13000
06752P,訊芯凱基98售05  ,0,0,0,0,0,0,0,0,0,13000,0,0,0,23000,10000,13000,13000
06487P,聯發科統一99售02,0,0,0,0,0,0,0,0,0,13000,0,0,0,16000,3000,13000,13000
060578,臺股指中信9C購03,0,0,0,0,0,0,0,0,0,13000,0,0,0,20000,7000,13000,13000
060169,群電永豐9A購01  ,0,0,0,0,0,0,0,0,0,13000,0,0,0,40000,27000,13000,13000
060071,國巨元富99購03  ,0,0,0,0,0,0,0,0,0,13000,0,0,0,513000,500000,13000,13000
059511,宏達電永豐99購02,0,0,0,0,0,0,0,0,0,13000,0,0,0,13000,0,13000,13000
052895,台積電群益96購04,0,0,0,0,0,0,0,0,0,13000,0,0,0,79000,66000,13000,13000
054501,強茂永豐96購02  ,0,0,0,0,0,0,0,0,0,13000,0,0,0,13000,0,13000,13000
057969,緯穎國泰99購01  ,0,0,0,0,0,0,0,0,0,13000,0,0,0,271000,258000,13000,13000
051466,玉晶光富邦97購01,0,0,0,0,0,0,0,0,0,13000,0,0,0,13000,0,13000,13000
05174P,元金2X富邦9B售01,0,0,0,0,0,0,0,0,0,13000,0,0,0,13000,0,13000,13000
03603P,群創凱基98售04  ,0,0,0,0,0,0,0,0,0,13000,0,0,0,113000,100000,13000,13000
00771,元大US高息特別股,0,0,0,0,0,0,0,0,0,13000,0,0,0,28000,15000,13000,13000
00689R,國泰20年美債反1 ,0,0,0,0,0,0,0,0,0,13000,0,0,0,155000,142000,13000,13000
059253,康控凱基9B購02  ,0,0,0,0,0,0,0,0,0,13000,0,0,0,182000,169000,13000,13000
059168,奇力新凱基99購05,0,0,0,0,0,0,0,0,0,13000,0,0,0,338000,325000,13000,13000
057985,華通元富02購03  ,0,0,0,0,0,0,0,0,0,13000,0,0,0,15000,2000,13000,13000
058483,道瓊指國票9A購01,0,0,0,0,0,0,0,0,0,13000,0,0,0,13000,0,13000,13000
058210,臺股指凱基9C購04,0,0,0,0,0,0,0,0,0,13000,0,0,0,13000,0,13000,13000
058540,嘉聯益國泰9A購02,0,0,0,0,0,0,0,0,0,13000,0,0,0,13000,0,13000,13000
058610,欣興元大99購05  ,0,0,0,0,0,0,0,0,0,13000,0,0,0,100000,87000,13000,13000
055627,亞德客永豐97購02,0,0,0,0,0,0,0,0,0,13000,0,0,0,14000,1000,13000,13000
055682,智原凱基98購02  ,0,0,0,0,0,0,0,0,0,13000,0,0,0,13000,0,13000,13000
07660P,聯茂凱基9A售03  ,0,0,0,0,0,0,0,0,0,13000,0,0,0,13000,0,13000,13000
1773,勝一            ,36000,23000,13000,0,0,0,0,0,0,0,0,0,0,0,0,0,13000
05982P,漢唐國票96售03  ,0,0,0,0,0,0,0,0,0,12000,0,0,0,12000,0,12000,12000
059846,力山永豐99購01  ,0,0,0,0,0,0,0,0,0,12000,0,0,0,12000,0,12000,12000
059880,世紀鋼凱基99購02,0,0,0,0,0,0,0,0,0,12000,0,0,0,12000,0,12000,12000
060114,緯穎元大99購10  ,0,0,0,0,0,0,0,0,0,12000,0,0,0,168000,156000,12000,12000
060687,GIS元大9A購01   ,0,0,0,0,0,0,0,0,0,12000,0,0,0,224000,212000,12000,12000
060665,康控凱基9A購01  ,0,0,0,0,0,0,0,0,0,12000,0,0,0,100000,88000,12000,12000
07127P,精元元大99售01  ,0,0,0,0,0,0,0,0,0,12000,0,0,0,12000,0,12000,12000
06908P,健策國泰99售02  ,0,0,0,0,0,0,0,0,0,12000,0,0,0,12000,0,12000,12000
061147,上証2X群益9C購06,0,0,0,0,0,0,0,0,0,12000,0,0,0,12000,0,12000,12000
06124P,超眾元大97售03  ,0,0,0,0,0,0,0,0,0,12000,0,0,0,12000,0,12000,12000
060769,國巨麥證9A購02  ,0,0,0,12000,0,12000,0,0,0,12000,0,0,0,12000,0,12000,12000
048273,南電富邦97購01  ,0,0,0,0,0,0,0,0,0,12000,0,0,0,16000,4000,12000,12000
049272,世紀鋼元大96購02,0,0,0,0,0,0,0,0,0,12000,0,0,0,112000,100000,12000,12000
051381,玉晶光群益98購01,0,0,0,0,0,0,0,0,0,12000,0,0,0,61000,49000,12000,12000
057857,牧德國票99購01  ,0,0,0,0,0,0,0,0,0,12000,0,0,0,207000,195000,12000,12000
053398,和鑫中信99購01  ,0,0,0,0,0,0,0,0,0,12000,0,0,0,12000,0,12000,12000
05590P,臺股指中信96售05,0,0,0,0,0,0,0,0,0,12000,0,0,0,20000,8000,12000,12000
055953,上銀元大97購09  ,0,0,0,0,0,0,0,0,0,12000,0,0,0,25000,13000,12000,12000
058626,瑞昱國票9A購01  ,0,0,0,0,0,0,0,0,0,12000,0,0,0,12000,0,12000,12000
058374,玉晶光凱基9A購03,0,0,0,0,0,0,0,0,0,12000,0,0,0,12000,0,12000,12000
058043,鴻海元大98購13  ,0,0,0,0,0,0,0,0,0,12000,0,0,0,23000,11000,12000,12000
05620P,大立光富邦9B售01,0,0,0,0,0,0,0,0,0,12000,0,0,0,12000,0,12000,12000
056193,聯發科富邦99購08,0,0,0,0,0,0,0,0,0,12000,0,0,0,12000,0,12000,12000
057494,玉晶光元大99購09,0,0,0,0,0,0,0,0,0,12000,0,0,0,13000,1000,12000,12000
058903,聯發科元大99購16,0,0,0,0,0,0,0,0,0,12000,0,0,0,328000,316000,12000,12000
059068,台虹國票9A購01  ,0,0,0,0,0,0,0,0,0,12000,0,0,0,50000,38000,12000,12000
059191,茂林富邦9B購01  ,0,0,0,0,0,0,0,0,0,12000,0,0,0,16000,4000,12000,12000
056713,華擎永豐98購01  ,0,0,0,0,0,0,0,0,0,12000,0,0,0,12000,0,12000,12000
07283P,華新科凱基99售07,0,0,0,0,0,0,0,0,0,12000,0,0,0,22000,10000,12000,12000
07304P,臺股指元大9A售37,0,0,0,0,0,0,0,0,0,12000,0,0,0,112000,100000,12000,12000
07382P,台積電群益9B售01,0,0,0,0,0,0,0,0,0,12000,0,0,0,12000,0,12000,12000
4555,氣立            ,91000,142000,-51000,0,0,0,30000,0,30000,33000,54000,21000,33000,0,0,0,12000
6412,群電            ,326000,307000,19000,0,0,0,0,0,0,-7000,0,0,0,1000,8000,-7000,12000
6224,聚鼎            ,34000,23000,11000,0,0,0,0,0,0,1000,1000,0,1000,0,0,0,12000
2723,美食-KY         ,298000,281000,17000,0,0,0,0,0,0,-5000,0,0,0,2000,7000,-5000,12000
2836,高雄銀          ,38000,26000,12000,0,0,0,0,0,0,0,0,0,0,0,0,0,12000
2514,龍邦            ,29000,17000,12000,0,0,0,0,0,0,0,0,0,0,0,0,0,12000
060768,鴻海麥證9A購02  ,0,0,0,11000,0,11000,0,0,0,11000,0,0,0,11000,0,11000,11000
061146,台表科中信9A購02,0,0,0,0,0,0,0,0,0,11000,0,0,0,11000,0,11000,11000
07001P,國巨元大99售12  ,0,0,0,0,0,0,0,0,0,11000,0,0,0,11000,0,11000,11000
061395,健策統一9C購02  ,0,0,0,0,0,0,0,0,0,11000,0,0,0,309000,298000,11000,11000
060635,義隆永豐9A購01  ,0,0,0,0,0,0,0,0,0,11000,0,0,0,26000,15000,11000,11000
060551,大立光凱基9B購02,0,0,0,0,0,0,0,0,0,11000,0,0,0,11000,0,11000,11000
06016P,京元電凱基96售03,0,0,0,0,0,0,0,0,0,11000,0,0,0,11000,0,11000,11000
060195,旭富元富9A購02  ,0,0,0,0,0,0,0,0,0,11000,0,0,0,35000,24000,11000,11000
060316,福懋科永豐9A購01,0,0,0,0,0,0,0,0,0,11000,0,0,0,28000,17000,11000,11000
060349,上証2X元富9A購04,0,0,0,0,0,0,0,0,0,11000,0,0,0,11000,0,11000,11000
059873,華新科凱基99購09,0,0,0,0,0,0,0,0,0,11000,0,0,0,13000,2000,11000,11000
059864,亞德客凱基99購01,0,0,0,0,0,0,0,0,0,11000,0,0,0,13000,2000,11000,11000
059887,華新科國票99購02,0,0,0,0,0,0,0,0,0,11000,0,0,0,11000,0,11000,11000
059574,台表科凱基99購02,0,0,0,0,0,0,0,0,0,11000,0,0,0,11000,0,11000,11000
059578,智邦元富99購02  ,0,0,0,0,0,0,0,0,0,11000,0,0,0,13000,2000,11000,11000
059693,智原永豐99購01  ,0,0,0,0,0,0,0,0,0,11000,0,0,0,11000,0,11000,11000
054836,勤誠中信97購01  ,0,0,0,0,0,0,0,0,0,11000,0,0,0,11000,0,11000,11000
057900,南亞科永豐98購01,0,0,0,0,0,0,0,0,0,11000,0,0,0,34000,23000,11000,11000
053045,國巨中信97購01  ,0,0,0,0,0,0,0,0,0,11000,0,0,0,11000,0,11000,11000
051476,聯發科凱基95購09,0,0,0,0,0,0,0,0,0,11000,0,0,0,11000,0,11000,11000
051539,瀚宇博國票97購01,0,0,0,0,0,0,0,0,0,11000,0,0,0,11000,0,11000,11000
056569,T50正2元大9B購02,0,0,0,0,0,0,0,0,0,11000,0,0,0,11000,0,11000,11000
059328,台灣50國票99購08,0,0,0,0,0,0,0,0,0,11000,0,0,0,11000,0,11000,11000
056199,美律永豐97購01  ,0,0,0,0,0,0,0,0,0,11000,0,0,0,11000,0,11000,11000
057806,國巨元大98購20  ,0,0,0,0,0,0,0,0,0,11000,0,0,0,11000,0,11000,11000
058525,台虹元大99購02  ,0,0,0,0,0,0,0,0,0,11000,0,0,0,115000,104000,11000,11000
058452,義隆永豐99購02  ,0,0,0,0,0,0,0,0,0,11000,0,0,0,11000,0,11000,11000
058187,泰碩永豐99購01  ,0,0,0,0,0,0,0,0,0,11000,0,0,0,58000,47000,11000,11000
056275,國巨國泰98購04  ,0,0,0,0,0,0,0,0,0,11000,0,0,0,11000,0,11000,11000
055780,禾伸堂凱基99購01,0,0,0,0,0,0,0,0,0,11000,0,0,0,11000,0,11000,11000
055614,華新科國票97購02,0,0,0,0,0,0,0,0,0,11000,0,0,0,11000,0,11000,11000
05634P,玉晶光台新97售01,0,0,0,0,0,0,0,0,0,11000,0,0,0,101000,90000,11000,11000
055351,聯發科凱基97購03,0,0,0,0,0,0,0,0,0,11000,0,0,0,14000,3000,11000,11000
055429,華新科群益99購01,0,0,0,0,0,0,0,0,0,11000,0,0,0,11000,0,11000,11000
2832,台產            ,13000,2000,11000,0,0,0,0,0,0,0,0,0,0,0,0,0,11000
2881B,富邦金乙特      ,10000,0,10000,0,0,0,0,0,0,1000,1000,0,1000,0,0,0,11000
4912,聯德控股-KY     ,18000,7000,11000,0,0,0,0,0,0,0,0,0,0,0,0,0,11000
5258,虹堡            ,33000,22000,11000,0,0,0,0,0,0,0,0,0,0,0,0,0,11000
07306P,台灣50凱基9A售09,0,0,0,0,0,0,0,0,0,11000,0,0,0,15000,4000,11000,11000
1519,華城            ,72000,60000,12000,0,0,0,0,0,0,-1000,0,1000,-1000,0,0,0,11000
07656P,國巨凱基9A售15  ,0,0,0,0,0,0,0,0,0,11000,0,0,0,11000,0,11000,11000
07732P,台灣50台新9A售05,0,0,0,0,0,0,0,0,0,11000,0,0,0,11000,0,11000,11000
2108,南帝            ,97000,86072,10928,0,0,0,0,0,0,0,0,0,0,0,0,0,10928
059685,T50正2永豐99購02,0,0,0,0,0,0,0,0,0,10000,0,0,0,14000,4000,10000,10000
059616,滬深2X群益01購04,0,0,0,0,0,0,0,0,0,10000,0,0,0,10000,0,10000,10000
059505,上証2X永豐99購02,0,0,0,0,0,0,0,0,0,10000,0,0,0,10000,0,10000,10000
059492,國巨國票9A購06  ,0,0,0,0,0,0,0,0,0,10000,0,0,0,10000,0,10000,10000
059362,健策永豐99購03  ,0,0,0,0,0,0,0,0,0,10000,0,0,0,10000,0,10000,10000
05990P,台積電群益96售13,0,0,0,0,0,0,0,0,0,10000,0,0,0,462000,452000,10000,10000
059828,健策凱基99購05  ,0,0,0,0,0,0,0,0,0,10000,0,0,0,10000,0,10000,10000
060074,台積電元富99購04,0,0,0,0,0,0,0,0,0,10000,0,0,0,30000,20000,10000,10000
059934,華通永豐99購02  ,0,0,0,0,0,0,0,0,0,10000,0,0,0,12000,2000,10000,10000
060358,國巨元富9A購01  ,0,0,0,0,0,0,0,0,0,10000,0,0,0,10000,0,10000,10000
060198,祥碩元富9A購02  ,0,0,0,0,0,0,0,0,0,10000,0,0,0,41000,31000,10000,10000
060102,禾伸堂元大99購06,0,0,0,0,0,0,0,0,0,10000,0,0,0,10000,0,10000,10000
060516,臺股指元大9B購13,0,0,0,0,0,0,0,0,0,10000,0,0,0,10000,0,10000,10000
060605,大立光凱基9C購01,0,0,0,0,0,0,0,0,0,10000,0,0,0,10000,0,10000,10000
060589,台灣50台新9B購06,0,0,0,0,0,0,0,0,0,10000,0,0,0,10000,0,10000,10000
06059P,泰碩元大97售02  ,0,0,0,0,0,0,0,0,0,10000,0,0,0,90000,80000,10000,10000
06387P,緯穎永豐97售02  ,0,0,0,0,0,0,0,0,0,10000,0,0,0,43000,33000,10000,10000
06458P,玉晶光統一9A售02,0,0,0,0,0,0,0,0,0,10000,0,0,0,77000,67000,10000,10000
06441P,台積電凱基98售08,0,0,0,0,0,0,0,0,0,10000,0,0,0,20000,10000,10000,10000
06284P,台積電國票98售03,0,0,0,0,0,0,0,0,0,10000,0,0,0,10000,0,10000,10000
06353P,電子類富邦99售02,0,0,0,0,0,0,0,0,0,10000,0,0,0,10000,0,10000,10000
06320P,上銀統一97售04  ,0,0,0,0,0,0,0,0,0,10000,0,0,0,40000,30000,10000,10000
06228P,亞德客凱基97售04,0,0,0,0,0,0,0,0,0,10000,0,0,0,10000,0,10000,10000
06995P,臺股指凱基99售16,0,0,0,0,0,0,0,0,0,10000,0,0,0,10000,0,10000,10000
06992P,玉晶光日盛9B售01,0,0,0,0,0,0,0,0,0,10000,0,0,0,10000,0,10000,10000
07041P,T50反1元大9C售01,0,0,0,0,0,0,0,0,0,10000,0,0,0,10000,0,10000,10000
07034P,大立光元富99售03,0,0,0,0,0,0,0,0,0,10000,0,0,0,10000,0,10000,10000
06952P,大立光統一9A售03,0,0,0,0,0,0,0,0,0,10000,0,0,0,72000,62000,10000,10000
06869P,金融類元大99售01,0,0,0,0,0,0,0,0,0,10000,0,0,0,10000,0,10000,10000
06873P,嘉晶元富98售02  ,0,0,0,0,0,0,0,0,0,10000,0,0,0,10000,0,10000,10000
06854P,鴻海富邦99售05  ,0,0,0,0,0,0,0,0,0,10000,0,0,0,10000,0,10000,10000
06599P,宏達電永豐98售02,0,0,0,0,0,0,0,0,0,10000,0,0,0,10000,0,10000,10000
06600P,貿聯永豐98售01  ,0,0,0,0,0,0,0,0,0,10000,0,0,0,10000,0,10000,10000
061069,嘉聯益凱基9A購01,0,0,0,0,0,0,0,0,0,10000,0,0,0,83000,73000,10000,10000
061286,大立光統一9A購05,0,0,0,0,0,0,0,0,0,10000,0,0,0,10000,0,10000,10000
061255,道瓊反凱基9C購01,0,0,0,0,0,0,0,0,0,10000,0,0,0,10000,0,10000,10000
06077P,GIS凱基97售02   ,0,0,0,0,0,0,0,0,0,10000,0,0,0,10000,0,10000,10000
060760,南亞科元大9A購04,0,0,0,0,0,0,0,0,0,10000,0,0,0,177000,167000,10000,10000
060841,宏達電國票9B購01,0,0,0,0,0,0,0,0,0,10000,0,0,0,10000,0,10000,10000
051541,GIS國票96購02   ,0,0,0,0,0,0,0,0,0,10000,0,0,0,110000,100000,10000,10000
051562,玉晶光國泰97購05,0,0,0,0,0,0,0,0,0,10000,0,0,0,10000,0,10000,10000
051570,和碩富邦97購01  ,0,0,0,0,0,0,0,0,0,10000,0,0,0,40000,30000,10000,10000
051462,世芯國泰97購01  ,0,0,0,0,0,0,0,0,0,10000,0,0,0,20000,10000,10000,10000
052676,聯發科永昌98購01,0,0,0,0,0,0,0,0,0,10000,0,0,0,10000,0,10000,10000
055035,興勤富邦98購01  ,0,0,0,0,0,0,0,0,0,10000,0,0,0,10000,0,10000,10000
055044,信錦永豐97購01  ,0,0,0,0,0,0,0,0,0,10000,0,0,0,20000,10000,10000,10000
055067,禾聯碩永豐97購01,0,0,0,0,0,0,0,0,0,10000,0,0,0,10000,0,10000,10000
053877,奇力新亞東96購01,0,0,0,0,0,0,0,0,0,10000,0,0,0,10000,0,10000,10000
053799,矽創中信9A購01  ,0,0,0,0,0,0,0,0,0,10000,0,0,0,10000,0,10000,10000
055143,臻鼎永豐97購01  ,0,0,0,0,0,0,0,0,0,10000,0,0,0,10000,0,10000,10000
055137,GIS富邦98購01   ,0,0,0,0,0,0,0,0,0,10000,0,0,0,10000,0,10000,10000
051081,聯茂富邦96購01  ,0,0,0,0,0,0,0,0,0,10000,0,0,0,10000,0,10000,10000
05052P,友達群益97售01  ,0,0,0,0,0,0,0,0,0,10000,0,0,0,10000,0,10000,10000
050480,健策國票95購04  ,0,0,0,0,0,0,0,0,0,10000,0,0,0,10000,0,10000,10000
050724,國巨國票96購01  ,0,0,0,0,0,0,0,0,0,10000,0,0,0,10000,0,10000,10000
052514,嘉澤凱基96購01  ,0,0,0,0,0,0,0,0,0,10000,0,0,0,10000,0,10000,10000
052518,道瓊反元大95購02,0,0,0,0,0,0,0,0,0,10000,0,0,0,10000,0,10000,10000
052354,健策群益96購02  ,0,0,0,0,0,0,0,0,0,10000,0,0,0,10000,0,10000,10000
052274,大立光群益95購03,0,0,0,0,0,0,0,0,0,10000,0,0,0,10000,0,10000,10000
049269,超眾元大96購02  ,0,0,0,0,0,0,0,0,0,10000,0,0,0,10000,0,10000,10000
046961,大立光中信95購02,0,0,0,0,0,0,0,0,0,10000,0,0,0,10000,0,10000,10000
049490,京元電元大95購02,0,0,0,0,0,0,0,0,0,10000,0,0,0,10000,0,10000,10000
049437,可成國泰96購01  ,0,0,0,0,0,0,0,0,0,10000,0,0,0,10000,0,10000,10000
049518,宏達電國票95購02,0,0,0,0,0,0,0,0,0,10000,0,0,0,10000,0,10000,10000
051694,A50正2中信96購03,0,0,0,0,0,0,0,0,0,10000,0,0,0,10000,0,10000,10000
044088,國巨元富95購01  ,0,0,0,0,0,0,0,0,0,10000,0,0,0,10000,0,10000,10000
045444,群創元富98購02  ,0,0,0,0,0,0,0,0,0,10000,0,0,0,10000,0,10000,10000
042317,台灣50永豐96購01,0,0,0,0,0,0,0,0,0,10000,0,0,0,10000,0,10000,10000
043442,大立光台新01購01,0,0,0,0,0,0,0,0,0,10000,0,0,0,18000,8000,10000,10000
03821P,上海銀統一95售01,0,0,0,0,0,0,0,0,0,10000,0,0,0,10000,0,10000,10000
040215,上証反凱基95購01,0,0,0,0,0,0,0,0,0,10000,0,0,0,10000,0,10000,10000
051788,奇力新國票97購02,0,0,0,0,0,0,0,0,0,10000,0,0,0,10000,0,10000,10000
051927,國巨中信96購01  ,0,0,0,0,0,0,0,0,0,10000,0,0,0,10000,0,10000,10000
051947,矽力統一95購01  ,0,0,0,0,0,0,0,0,0,10000,0,0,0,10000,0,10000,10000
052017,奇鋐永豐95購01  ,0,0,0,0,0,0,0,0,0,10000,0,0,0,20000,10000,10000,10000
052231,景碩凱基96購01  ,0,0,0,0,0,0,0,0,0,10000,0,0,0,10000,0,10000,10000
052113,漢唐中信98購01  ,0,0,0,0,0,0,0,0,0,10000,0,0,0,10000,0,10000,10000
052121,全新國票96購03  ,0,0,0,0,0,0,0,0,0,10000,0,0,0,10000,0,10000,10000
052125,群創國票95購02  ,0,0,0,0,0,0,0,0,0,10000,0,0,0,10000,0,10000,10000
048414,滬深2X統一98購01,0,0,0,0,0,0,0,0,0,10000,0,0,0,10000,0,10000,10000
047993,鑽全元大96購01  ,0,0,0,0,0,0,0,0,0,10000,0,0,0,10000,0,10000,10000
048659,國巨統一94購02  ,0,0,0,0,0,0,0,0,0,10000,0,0,0,10000,0,10000,10000
035277,景碩台新97購01  ,0,0,0,0,0,0,0,0,0,10000,0,0,0,10000,0,10000,10000
036628,統一台新99購01  ,0,0,0,0,0,0,0,0,0,10000,0,0,0,20000,10000,10000,10000
04914P,國巨國泰95售06  ,0,0,0,0,0,0,0,0,0,10000,0,0,0,10000,0,10000,10000
03039X,元展36          ,0,0,0,0,0,0,0,0,0,10000,0,0,0,10000,0,10000,10000
00753L,中信中國50正2   ,352000,232000,120000,0,0,0,0,0,0,-110000,0,0,0,324000,434000,-110000,10000
047145,鴻海群益95購01  ,0,0,0,0,0,0,0,0,0,10000,0,0,0,10000,0,10000,10000
052979,上銀元大96購02  ,0,0,0,0,0,0,0,0,0,10000,0,0,0,10000,0,10000,10000
054380,世芯群益97購02  ,0,0,0,0,0,0,0,0,0,10000,0,0,0,15000,5000,10000,10000
054350,美律國泰98購01  ,0,0,0,0,0,0,0,0,0,10000,0,0,0,10000,0,10000,10000
052916,華新科富邦96購01,0,0,0,0,0,0,0,0,0,10000,0,0,0,10000,0,10000,10000
054246,國巨元大96購12  ,0,0,0,0,0,0,0,0,0,10000,0,0,0,10000,0,10000,10000
054250,漢唐元大96購04  ,0,0,0,0,0,0,0,0,0,10000,0,0,0,10000,0,10000,10000
054118,國巨永豐96購04  ,0,0,0,0,0,0,0,0,0,10000,0,0,0,10000,0,10000,10000
054217,台表科國票97購05,0,0,0,0,0,0,0,0,0,10000,0,0,0,10000,0,10000,10000
054203,滬深2X國票96購03,0,0,0,0,0,0,0,0,0,10000,0,0,0,10000,0,10000,10000
054162,光罩凱基98購01  ,0,0,0,0,0,0,0,0,0,10000,0,0,0,10000,0,10000,10000
054178,中磊台新97購01  ,0,0,0,0,0,0,0,0,0,10000,0,0,0,36000,26000,10000,10000
057902,嘉晶永豐98購02  ,0,0,0,0,0,0,0,0,0,10000,0,0,0,10000,0,10000,10000
057584,國巨亞東99購01  ,0,0,0,0,0,0,0,0,0,10000,0,0,0,10000,0,10000,10000
057569,光磊永豐98購03  ,0,0,0,0,0,0,0,0,0,10000,0,0,0,73000,63000,10000,10000
057850,上銀兆豐99購02  ,0,0,0,0,0,0,0,0,0,10000,0,0,0,10000,0,10000,10000
054497,國巨永豐96購05  ,0,0,0,0,0,0,0,0,0,10000,0,0,0,10000,0,10000,10000
054516,國巨元大97購02  ,0,0,0,0,0,0,0,0,0,10000,0,0,0,10000,0,10000,10000
057619,玉晶光凱基98購02,0,0,0,0,0,0,0,0,0,10000,0,0,0,10000,0,10000,10000
057790,台積電統一99購04,0,0,0,0,0,0,0,0,0,10000,0,0,0,11000,1000,10000,10000
057758,鴻海凱基99購03  ,0,0,0,0,0,0,0,0,0,10000,0,0,0,10000,0,10000,10000
054822,祥碩元大97購01  ,0,0,0,0,0,0,0,0,0,10000,0,0,0,16000,6000,10000,10000
054843,中環兆豐97購01  ,0,0,0,0,0,0,0,0,0,10000,0,0,0,40000,30000,10000,10000
054900,金寶康和97購01  ,0,0,0,0,0,0,0,0,0,10000,0,0,0,10000,0,10000,10000
053099,正崴元富96購01  ,0,0,0,0,0,0,0,0,0,10000,0,0,0,10000,0,10000,10000
054981,國巨元富97購02  ,0,0,0,0,0,0,0,0,0,10000,0,0,0,10000,0,10000,10000
054725,國巨日盛97購01  ,0,0,0,0,0,0,0,0,0,10000,0,0,0,20000,10000,10000,10000
054697,凌華永豐97購01  ,0,0,0,0,0,0,0,0,0,10000,0,0,0,10000,0,10000,10000
055176,大毅統一98購02  ,0,0,0,0,0,0,0,0,0,10000,0,0,0,10000,0,10000,10000
054618,訊芯永豐97購01  ,0,0,0,0,0,0,0,0,0,10000,0,0,0,10000,0,10000,10000
054559,台光電群益99購01,0,0,0,0,0,0,0,0,0,10000,0,0,0,12000,2000,10000,10000
053370,上証2X元大97購03,0,0,0,0,0,0,0,0,0,10000,0,0,0,10000,0,10000,10000
053408,友達兆豐98購01  ,0,0,0,0,0,0,0,0,0,10000,0,0,0,10000,0,10000,10000
053447,京鼎凱基96購03  ,0,0,0,0,0,0,0,0,0,10000,0,0,0,10000,0,10000,10000
053500,新日興兆豐97購01,0,0,0,0,0,0,0,0,0,10000,0,0,0,115000,105000,10000,10000
053215,禾伸堂凱基96購01,0,0,0,0,0,0,0,0,0,10000,0,0,0,10000,0,10000,10000
053226,國巨台新97購02  ,0,0,0,0,0,0,0,0,0,10000,0,0,0,20000,10000,10000,10000
053282,彩晶元大9C購01  ,0,0,0,0,0,0,0,0,0,10000,0,0,0,10000,0,10000,10000
052750,臺股指元大96購04,0,0,0,0,0,0,0,0,0,10000,0,0,0,10000,0,10000,10000
053677,同欣電國泰97購01,0,0,0,0,0,0,0,0,0,10000,0,0,0,190000,180000,10000,10000
053598,日月光元大96購04,0,0,0,0,0,0,0,0,0,10000,0,0,0,10000,0,10000,10000
053583,漢唐元大96購03  ,0,0,0,0,0,0,0,0,0,10000,0,0,0,10000,0,10000,10000
055345,國巨凱基98購01  ,0,0,0,0,0,0,0,0,0,10000,0,0,0,10000,0,10000,10000
055586,旺宏元大98購06  ,0,0,0,0,0,0,0,0,0,10000,0,0,0,12000,2000,10000,10000
055579,健策統一9A購01  ,0,0,0,0,0,0,0,0,0,10000,0,0,0,24000,14000,10000,10000
055788,緯穎凱基97購04  ,0,0,0,0,0,0,0,0,0,10000,0,0,0,10000,0,10000,10000
055716,致茂元大97購01  ,0,0,0,0,0,0,0,0,0,10000,0,0,0,215000,205000,10000,10000
055752,臺股指永昌97購01,0,0,0,0,0,0,0,0,0,10000,0,0,0,10000,0,10000,10000
055947,元油反元大98購03,0,0,0,0,0,0,0,0,0,10000,0,0,0,10000,0,10000,10000
055872,亞泥元富97購01  ,0,0,0,0,0,0,0,0,0,10000,0,0,0,10000,0,10000,10000
056312,茂林元大98購01  ,0,0,0,0,0,0,0,0,0,10000,0,0,0,10000,0,10000,10000
055305,旺宏群益99購01  ,0,0,0,0,0,0,0,0,0,10000,0,0,0,10000,0,10000,10000
055231,大毅國票98購02  ,0,0,0,0,0,0,0,0,0,10000,0,0,0,10000,0,10000,10000
058794,旺宏元大99購09  ,0,0,0,0,0,0,0,0,0,10000,0,0,0,10000,0,10000,10000
055234,昇陽半國票98購02,0,0,0,0,0,0,0,0,0,10000,0,0,0,10000,0,10000,10000
058773,和碩兆豐99購01  ,0,0,0,0,0,0,0,0,0,10000,0,0,0,10000,0,10000,10000
058608,華新科元大99購13,0,0,0,0,0,0,0,0,0,10000,0,0,0,10000,0,10000,10000
058212,華新科群益9A購01,0,0,0,0,0,0,0,0,0,10000,0,0,0,50000,40000,10000,10000
058451,智邦永豐9A購01  ,0,0,0,0,0,0,0,0,0,10000,0,0,0,10000,0,10000,10000
058533,玉晶光元富99購01,0,0,0,0,0,0,0,0,0,10000,0,0,0,10000,0,10000,10000
058133,華新科元大9A購02,0,0,0,0,0,0,0,0,0,10000,0,0,0,30000,20000,10000,10000
056097,訊芯元富97購02  ,0,0,0,0,0,0,0,0,0,10000,0,0,0,60000,50000,10000,10000
056156,禾伸堂凱基98購04,0,0,0,0,0,0,0,0,0,10000,0,0,0,10000,0,10000,10000
05699P,茂林凱基96售05  ,0,0,0,0,0,0,0,0,0,10000,0,0,0,10000,0,10000,10000
056188,晶相光統一99購01,0,0,0,0,0,0,0,0,0,10000,0,0,0,10000,0,10000,10000
056223,華邦電凱基97購04,0,0,0,0,0,0,0,0,0,10000,0,0,0,30000,20000,10000,10000
057123,上銀凱基98購05  ,0,0,0,0,0,0,0,0,0,10000,0,0,0,10000,0,10000,10000
059197,可成永豐99購02  ,0,0,0,0,0,0,0,0,0,10000,0,0,0,15000,5000,10000,10000
059219,旺宏元大99購12  ,0,0,0,0,0,0,0,0,0,10000,0,0,0,29000,19000,10000,10000
059222,聯發科元大99購22,0,0,0,0,0,0,0,0,0,10000,0,0,0,379000,369000,10000,10000
059223,大立光元大99購14,0,0,0,0,0,0,0,0,0,10000,0,0,0,53000,43000,10000,10000
059260,國巨中信99購05  ,0,0,0,0,0,0,0,0,0,10000,0,0,0,30000,20000,10000,10000
059011,臺股指元大9A購30,0,0,0,0,0,0,0,0,0,10000,0,0,0,10000,0,10000,10000
058916,SGBR2X元富99購02,0,0,0,0,0,0,0,0,0,10000,0,0,0,30000,20000,10000,10000
058990,GIS凱基99購02   ,0,0,0,0,0,0,0,0,0,10000,0,0,0,119000,109000,10000,10000
057557,聯茂凱基99購04  ,0,0,0,0,0,0,0,0,0,10000,0,0,0,10000,0,10000,10000
057560,華新科兆豐99購01,0,0,0,0,0,0,0,0,0,10000,0,0,0,10000,0,10000,10000
057561,大立光兆豐98購02,0,0,0,0,0,0,0,0,0,10000,0,0,0,10000,0,10000,10000
057462,光磊永豐98購02  ,0,0,0,0,0,0,0,0,0,10000,0,0,0,50000,40000,10000,10000
057518,世紀鋼元富98購01,0,0,0,0,0,0,0,0,0,10000,0,0,0,10000,0,10000,10000
057333,智邦國票99購01  ,0,0,0,0,0,0,0,0,0,10000,0,0,0,10000,0,10000,10000
057398,台郡中信99購01  ,0,0,0,0,0,0,0,0,0,10000,0,0,0,10000,0,10000,10000
057294,台灣50永豐99購01,0,0,0,0,0,0,0,0,0,10000,0,0,0,10000,0,10000,10000
056548,瀚宇博凱基98購02,0,0,0,0,0,0,0,0,0,10000,0,0,0,10000,0,10000,10000
057320,玉晶光凱基98購01,0,0,0,0,0,0,0,0,0,10000,0,0,0,10000,0,10000,10000
056695,景碩群益99購01  ,0,0,0,0,0,0,0,0,0,10000,0,0,0,20000,10000,10000,10000
056926,日月光兆豐98購01,0,0,0,0,0,0,0,0,0,10000,0,0,0,20000,10000,10000,10000
056892,旺宏元大9A購02  ,0,0,0,0,0,0,0,0,0,10000,0,0,0,10000,0,10000,10000
057171,台光電元大9B購01,0,0,0,0,0,0,0,0,0,10000,0,0,0,37000,27000,10000,10000
056402,智易群益98購02  ,0,0,0,0,0,0,0,0,0,10000,0,0,0,10000,0,10000,10000
057194,南電元大98購01  ,0,0,0,0,0,0,0,0,0,10000,0,0,0,10000,0,10000,10000
056392,玉晶光富邦9C購01,0,0,0,0,0,0,0,0,0,10000,0,0,0,10000,0,10000,10000
056029,國巨麥證98購01  ,0,0,0,110000,0,110000,0,0,0,10000,0,0,0,110000,100000,10000,10000
05553P,智原群益96售01  ,0,0,0,0,0,0,0,0,0,10000,0,0,0,10000,0,10000,10000
055470,南亞科凱基97購01,0,0,0,0,0,0,0,0,0,10000,0,0,0,10000,0,10000,10000
056440,智邦凱基98購03  ,0,0,0,0,0,0,0,0,0,10000,0,0,0,10000,0,10000,10000
057271,國巨元大98購17  ,0,0,0,0,0,0,0,0,0,10000,0,0,0,10000,0,10000,10000
056517,茂林兆豐99購01  ,0,0,0,0,0,0,0,0,0,10000,0,0,0,10000,0,10000,10000
2731,雄獅            ,58000,48000,10000,0,0,0,0,0,0,0,0,0,0,0,0,0,10000
2415,錩新            ,11000,1000,10000,0,0,0,0,0,0,0,0,0,0,0,0,0,10000
4545,銘鈺            ,11000,1000,10000,0,0,0,0,0,0,0,0,0,0,0,0,0,10000
6243,迅杰            ,10000,0,10000,0,0,0,0,0,0,0,0,0,0,0,0,0,10000
1592,英瑞-KY         ,94000,84000,10000,0,0,0,0,0,0,0,0,0,0,0,0,0,10000
1713,國化            ,10000,0,10000,0,0,0,0,0,0,0,0,0,0,0,0,0,10000
07330P,台灣50群益9A售08,0,0,0,0,0,0,0,0,0,10000,0,0,0,10000,0,10000,10000
07221P,臺股指中信9B售04,0,0,0,0,0,0,0,0,0,10000,0,0,0,10000,0,10000,10000
07386P,臺股指群益99售24,0,0,0,0,0,0,0,0,0,10000,0,0,0,25000,15000,10000,10000
07598P,臺股指中信01售03,0,0,0,0,0,0,0,0,0,10000,0,0,0,10000,0,10000,10000
060826,牧德元大9B購02  ,0,0,0,0,0,0,0,0,0,9000,0,0,0,120000,111000,9000,9000
060859,鴻海永豐9A購01  ,0,0,0,0,0,0,0,0,0,9000,0,0,0,9000,0,9000,9000
060754,華通元大9A購04  ,0,0,0,0,0,0,0,0,0,9000,0,0,0,9000,0,9000,9000
061247,玉晶光群益9A購09,0,0,0,0,0,0,0,0,0,9000,0,0,0,127000,118000,9000,9000
06617P,智邦元大98售03  ,0,0,0,0,0,0,0,0,0,9000,0,0,0,312000,303000,9000,9000
06656P,GIS元大98售02   ,0,0,0,0,0,0,0,0,0,9000,0,0,0,79000,70000,9000,9000
060342,台積電統一02購01,0,0,0,0,0,0,0,0,0,9000,0,0,0,29000,20000,9000,9000
060394,欣興麥證9A購01  ,0,0,0,55000,46000,9000,0,0,0,9000,0,0,0,55000,46000,9000,9000
060370,滬深2X元富04購01,0,0,0,0,0,0,0,0,0,9000,0,0,0,9000,0,9000,9000
059681,華新科國泰9B購02,0,0,0,0,0,0,0,0,0,9000,0,0,0,9000,0,9000,9000
059746,聯鈞元富99購03  ,0,0,0,0,0,0,0,0,0,9000,0,0,0,9000,0,9000,9000
054768,泰碩國票99購02  ,0,0,0,0,0,0,0,0,0,9000,0,0,0,148000,139000,9000,9000
057863,美律凱基9A購01  ,0,0,0,0,0,0,0,0,0,9000,0,0,0,10000,1000,9000,9000
054445,技嘉兆豐96購01  ,0,0,0,0,0,0,0,0,0,9000,0,0,0,10000,1000,9000,9000
054278,晶技群益97購02  ,0,0,0,0,0,0,0,0,0,9000,0,0,0,9000,0,9000,9000
00730,富邦臺灣優質高息,0,0,0,0,0,0,0,0,0,9000,0,0,0,303000,294000,9000,9000
03064X,元展59          ,0,0,0,0,0,0,0,0,0,9000,0,0,0,9000,0,9000,9000
051798,國巨永豐95購03  ,0,0,0,0,0,0,0,0,0,9000,0,0,0,10000,1000,9000,9000
051889,智邦元富95購02  ,0,0,0,0,0,0,0,0,0,9000,0,0,0,9000,0,9000,9000
03980P,群創凱基95售02  ,0,0,0,0,0,0,0,0,0,9000,0,0,0,9000,0,9000,9000
052488,旺宏國票96購03  ,0,0,0,0,0,0,0,0,0,9000,0,0,0,30000,21000,9000,9000
053809,上銀群益96購02  ,0,0,0,0,0,0,0,0,0,9000,0,0,0,9000,0,9000,9000
053728,茂林凱基97購01  ,0,0,0,0,0,0,0,0,0,9000,0,0,0,25000,16000,9000,9000
055449,超眾統一9A購01  ,0,0,0,0,0,0,0,0,0,9000,0,0,0,73000,64000,9000,9000
05549P,臺股指元大96售03,0,0,0,0,0,0,0,0,0,9000,0,0,0,9000,0,9000,9000
056036,鴻海凱基97購07  ,0,0,0,0,0,0,0,0,0,9000,0,0,0,11000,2000,9000,9000
057460,楠梓電永豐98購03,0,0,0,0,0,0,0,0,0,9000,0,0,0,9000,0,9000,9000
058983,旺宏凱基99購05  ,0,0,0,0,0,0,0,0,0,9000,0,0,0,15000,6000,9000,9000
059124,台積電第一03購01,0,0,0,0,0,0,0,0,0,9000,0,0,0,9000,0,9000,9000
058023,南電凱基98購02  ,0,0,0,0,0,0,0,0,0,9000,0,0,0,10000,1000,9000,9000
056145,緯穎元大98購03  ,0,0,0,0,0,0,0,0,0,9000,0,0,0,9000,0,9000,9000
058410,國巨兆豐99購03  ,0,0,0,0,0,0,0,0,0,9000,0,0,0,9000,0,9000,9000
055331,國巨兆豐99購01  ,0,0,0,0,0,0,0,0,0,9000,0,0,0,9000,0,9000,9000
055896,南電統一97購02  ,0,0,0,0,0,0,0,0,0,9000,0,0,0,30000,21000,9000,9000
055779,國泰金凱基97購02,0,0,0,0,0,0,0,0,0,9000,0,0,0,48000,39000,9000,9000
055785,祥碩凱基97購02  ,0,0,0,0,0,0,0,0,0,9000,0,0,0,82000,73000,9000,9000
055572,鴻海統一98購04  ,0,0,0,0,0,0,0,0,0,9000,0,0,0,9000,0,9000,9000
055669,緯穎群益97購02  ,0,0,0,0,0,0,0,0,0,9000,0,0,0,9000,0,9000,9000
07526P,臺股指中信9B售08,0,0,0,0,0,0,0,0,0,9000,0,0,0,12000,3000,9000,9000
07537P,玉晶光元富9A售04,0,0,0,0,0,0,0,0,0,9000,0,0,0,10000,1000,9000,9000
07559P,祥碩元大9A售03  ,0,0,0,0,0,0,0,0,0,9000,0,0,0,75000,66000,9000,9000
07239P,台灣50國票9A售04,0,0,0,0,0,0,0,0,0,9000,0,0,0,9000,0,9000,9000
1449,佳和            ,40000,31000,9000,0,0,0,0,0,0,0,0,0,0,0,0,0,9000
1444,力麗            ,185000,176000,9000,0,0,0,0,0,0,0,0,0,0,0,0,0,9000
07654P,台灣50凱基01售08,0,0,0,0,0,0,0,0,0,9000,0,0,0,10000,1000,9000,9000
07712P,茂林元大9A售03  ,0,0,0,0,0,0,0,0,0,9000,0,0,0,15000,6000,9000,9000
5607,遠雄港          ,117000,108000,9000,0,0,0,0,0,0,0,0,0,0,0,0,0,9000
6155,鈞寶            ,213000,204000,9000,0,0,0,0,0,0,0,0,0,0,0,0,0,9000
9940,信義            ,57000,48000,9000,0,0,0,0,0,0,0,0,0,0,0,0,0,9000
8103,瀚荃            ,11000,1000,10000,0,0,0,0,0,0,-1000,0,1000,-1000,0,0,0,9000
059728,聯鈞元大99購01  ,0,0,0,0,0,0,0,0,0,8000,0,0,0,8000,0,8000,8000
059631,京元電凱基99購02,0,0,0,0,0,0,0,0,0,8000,0,0,0,86000,78000,8000,8000
059387,華通凱基9A購03  ,0,0,0,0,0,0,0,0,0,8000,0,0,0,12000,4000,8000,8000
059357,華通永豐99購01  ,0,0,0,0,0,0,0,0,0,8000,0,0,0,28000,20000,8000,8000
059562,上銀凱基99購09  ,0,0,0,0,0,0,0,0,0,8000,0,0,0,8000,0,8000,8000
059529,華新科凱基9A購04,0,0,0,0,0,0,0,0,0,8000,0,0,0,8000,0,8000,8000
059959,訊芯康和99購01  ,0,0,0,0,0,0,0,0,0,8000,0,0,0,8000,0,8000,8000
059754,訊芯群益9A購01  ,0,0,0,0,0,0,0,0,0,8000,0,0,0,28000,20000,8000,8000
06593P,欣興元大98售05  ,0,0,0,0,0,0,0,0,0,8000,0,0,0,199000,191000,8000,8000
06949P,台表科元大99售01,0,0,0,0,0,0,0,0,0,8000,0,0,0,27000,19000,8000,8000
060838,華通國票9A購05  ,0,0,0,0,0,0,0,0,0,8000,0,0,0,8000,0,8000,8000
060871,台灣50中信01購03,0,0,0,0,0,0,0,0,0,8000,0,0,0,46000,38000,8000,8000
052657,友達元富96購01  ,0,0,0,0,0,0,0,0,0,8000,0,0,0,8000,0,8000,8000
05123P,鴻海永昌96售07  ,0,0,0,0,0,0,0,0,0,8000,0,0,0,8000,0,8000,8000
05149P,緯穎國泰96售01  ,0,0,0,0,0,0,0,0,0,8000,0,0,0,8000,0,8000,8000
050786,健策國泰96購01  ,0,0,0,0,0,0,0,0,0,8000,0,0,0,8000,0,8000,8000
049260,華新科元大96購01,0,0,0,0,0,0,0,0,0,8000,0,0,0,407000,399000,8000,8000
047673,瑞昱元富96購01  ,0,0,0,0,0,0,0,0,0,8000,0,0,0,18000,10000,8000,8000
0051,元大中型100     ,0,0,0,0,0,0,0,0,0,8000,0,0,0,10000,2000,8000,8000
054259,健策元大97購03  ,0,0,0,0,0,0,0,0,0,8000,0,0,0,8000,0,8000,8000
054335,緯穎永豐96購02  ,0,0,0,0,0,0,0,0,0,8000,0,0,0,40000,32000,8000,8000
054189,貿聯永豐96購03  ,0,0,0,0,0,0,0,0,0,8000,0,0,0,18000,10000,8000,8000
054253,宏達電元大97購03,0,0,0,0,0,0,0,0,0,8000,0,0,0,33000,25000,8000,8000
057961,茂林元大9A購01  ,0,0,0,0,0,0,0,0,0,8000,0,0,0,38000,30000,8000,8000
057712,南亞科統一9A購01,0,0,0,0,0,0,0,0,0,8000,0,0,0,156000,148000,8000,8000
053593,晶技元大98購01  ,0,0,0,0,0,0,0,0,0,8000,0,0,0,137000,129000,8000,8000
053302,國巨凱基96購10  ,0,0,0,0,0,0,0,0,0,8000,0,0,0,18000,10000,8000,8000
053267,華新科群益96購02,0,0,0,0,0,0,0,0,0,8000,0,0,0,8000,0,8000,8000
058524,超眾元大99購04  ,0,0,0,0,0,0,0,0,0,8000,0,0,0,9000,1000,8000,8000
058050,台郡元大99購05  ,0,0,0,0,0,0,0,0,0,8000,0,0,0,156000,148000,8000,8000
057103,禾伸堂中信9A購01,0,0,0,0,0,0,0,0,0,8000,0,0,0,226000,218000,8000,8000
059131,國巨群益99購07  ,0,0,0,0,0,0,0,0,0,8000,0,0,0,306000,298000,8000,8000
059145,創意國票99購02  ,0,0,0,0,0,0,0,0,0,8000,0,0,0,13000,5000,8000,8000
059161,鴻海凱基9A購09  ,0,0,0,0,0,0,0,0,0,8000,0,0,0,8000,0,8000,8000
059231,華通國票9A購04  ,0,0,0,0,0,0,0,0,0,8000,0,0,0,9000,1000,8000,8000
059195,國巨永豐99購04  ,0,0,0,0,0,0,0,0,0,8000,0,0,0,24000,16000,8000,8000
059303,國巨兆豐99購04  ,0,0,0,0,0,0,0,0,0,8000,0,0,0,8000,0,8000,8000
058956,健策國票9A購02  ,0,0,0,0,0,0,0,0,0,8000,0,0,0,8000,0,8000,8000
058923,華新科元富99購06,0,0,0,0,0,0,0,0,0,8000,0,0,0,40000,32000,8000,8000
057450,國泰金元富98購01,0,0,0,0,0,0,0,0,0,8000,0,0,0,135000,127000,8000,8000
057530,奇鋐元大99購01  ,0,0,0,0,0,0,0,0,0,8000,0,0,0,17000,9000,8000,8000
056434,國巨凱基98購03  ,25000,0,25000,0,0,0,0,0,0,-17000,0,0,0,130000,147000,-17000,8000
057165,國巨元大99購05  ,0,0,0,0,0,0,0,0,0,8000,0,0,0,40000,32000,8000,8000
056426,上証2X凱基9A購01,0,0,0,0,0,0,0,0,0,8000,0,0,0,23000,15000,8000,8000
055516,上銀中信97購01  ,0,0,0,0,0,0,0,0,0,8000,0,0,0,8000,0,8000,8000
056936,禾伸堂元富98購01,0,0,0,0,0,0,0,0,0,8000,0,0,0,267000,259000,8000,8000
056930,晶豪科台新98購01,0,0,0,0,0,0,0,0,0,8000,0,0,0,8000,0,8000,8000
8033,雷虎            ,12000,4000,8000,0,0,0,0,0,0,0,0,0,0,0,0,0,8000
8940,新天地          ,8000,0,8000,0,0,0,0,0,0,0,0,0,0,0,0,0,8000
2482,連宇            ,9000,1000,8000,0,0,0,0,0,0,0,0,0,0,0,0,0,8000
2597,潤弘            ,8000,0,8000,0,0,0,0,0,0,0,0,0,0,0,0,0,8000
2351,順德            ,68000,57000,11000,0,0,0,0,0,0,-3000,0,3000,-3000,0,0,0,8000
07652P,臺股指中信9A售07,0,0,0,0,0,0,0,0,0,8000,0,0,0,25000,17000,8000,8000
07628P,臺股指凱基9A售09,0,0,0,0,0,0,0,0,0,8000,0,0,0,10000,2000,8000,8000
1321,大洋            ,22000,14000,8000,0,0,0,0,0,0,0,0,0,0,0,0,0,8000
1529,樂士            ,2000,0,2000,0,0,0,0,0,0,6000,6000,0,6000,0,0,0,8000
07246P,旺宏凱基99售08  ,0,0,0,0,0,0,0,0,0,8000,0,0,0,10000,2000,8000,8000
07314P,T50正2元大9C售03,0,0,0,0,0,0,0,0,0,8000,0,0,0,8000,0,8000,8000
07281P,鴻海凱基99售13  ,0,0,0,0,0,0,0,0,0,8000,0,0,0,10000,2000,8000,8000
07508P,華新科國票9A售03,0,0,0,0,0,0,0,0,0,8000,0,0,0,9000,1000,8000,8000
061154,可成群益9B購04  ,0,0,0,0,0,0,0,0,0,7000,0,0,0,59000,52000,7000,7000
06980P,緯穎永豐99售02  ,0,0,0,0,0,0,0,0,0,7000,0,0,0,15000,8000,7000,7000
07076P,鴻海凱基9A售08  ,0,0,0,0,0,0,0,0,0,7000,0,0,0,7000,0,7000,7000
061476,大毅元大9A購02  ,0,0,0,0,0,0,0,0,0,7000,0,0,0,30000,23000,7000,7000
059842,台積電富邦9C購05,0,0,0,0,0,0,0,0,0,7000,0,0,0,10000,3000,7000,7000
059844,大立光富邦9C購04,0,0,0,0,0,0,0,0,0,7000,0,0,0,27000,20000,7000,7000
059955,美食康和99購01  ,0,0,0,0,0,0,0,0,0,7000,0,0,0,73000,66000,7000,7000
059962,S&P正2凱基99購02,0,0,0,0,0,0,0,0,0,7000,0,0,0,7000,0,7000,7000
060062,聯發科兆豐99購04,0,0,0,0,0,0,0,0,0,7000,0,0,0,16000,9000,7000,7000
059520,台表科永豐99購02,0,0,0,0,0,0,0,0,0,7000,0,0,0,13000,6000,7000,7000
059535,玉山金凱基99購01,0,0,0,0,0,0,0,0,0,7000,0,0,0,47000,40000,7000,7000
059442,祥碩元大99購03  ,0,0,0,0,0,0,0,0,0,7000,0,0,0,11000,4000,7000,7000
059698,滬深2X凱基9A購02,0,0,0,0,0,0,0,0,0,7000,0,0,0,7000,0,7000,7000
060585,玉晶光元富9A購02,0,0,0,0,0,0,0,0,0,7000,0,0,0,7000,0,7000,7000
060659,鴻海凱基9B購03  ,0,0,0,0,0,0,0,0,0,7000,0,0,0,34000,27000,7000,7000
053255,貿聯國泰97購01  ,0,0,0,0,0,0,0,0,0,7000,0,0,0,12000,5000,7000,7000
053480,祥碩元大96購02  ,0,0,0,0,0,0,0,0,0,7000,0,0,0,68000,61000,7000,7000
054067,百和國票97購03  ,0,0,0,0,0,0,0,0,0,7000,0,0,0,7000,0,7000,7000
052893,聯電群益98購01  ,0,0,0,0,0,0,0,0,0,7000,0,0,0,57000,50000,7000,7000
054479,緯創中信98購01  ,0,0,0,0,0,0,0,0,0,7000,0,0,0,15000,8000,7000,7000
0054,元大台商50      ,0,0,0,0,0,0,0,0,0,7000,0,0,0,8000,1000,7000,7000
03050X,元展47          ,0,0,0,0,0,0,0,0,0,7000,0,0,0,63000,56000,7000,7000
03658C,T50反1元大9A牛02,0,0,0,0,0,0,0,0,0,7000,0,0,0,10000,3000,7000,7000
046011,欣興元富95購01  ,0,0,0,0,0,0,0,0,0,7000,0,0,0,7000,0,7000,7000
04616P,臺股指群益95售02,0,0,0,0,0,0,0,0,0,7000,0,0,0,62000,55000,7000,7000
05196P,台積電永豐95售03,0,0,0,0,0,0,0,0,0,7000,0,0,0,7000,0,7000,7000
049600,緯穎元大95購02  ,0,0,0,0,0,0,0,0,0,7000,0,0,0,7000,0,7000,7000
052670,茂林群益96購02  ,0,0,0,0,0,0,0,0,0,7000,0,0,0,7000,0,7000,7000
056900,可成元大98購02  ,0,0,0,0,0,0,0,0,0,7000,0,0,0,82000,75000,7000,7000
056809,旺宏統一98購03  ,0,0,0,0,0,0,0,0,0,7000,0,0,0,107000,100000,7000,7000
056642,旺宏凱基98購07  ,0,0,0,0,0,0,0,0,0,7000,0,0,0,35000,28000,7000,7000
057243,樺漢凱基99購01  ,0,0,0,0,0,0,0,0,0,7000,0,0,0,30000,23000,7000,7000
056420,台表科元富98購01,0,0,0,0,0,0,0,0,0,7000,0,0,0,8000,1000,7000,7000
057451,大立光元富9B購01,0,0,0,0,0,0,0,0,0,7000,0,0,0,55000,48000,7000,7000
057407,超眾群益99購01  ,0,0,0,0,0,0,0,0,0,7000,0,0,0,60000,53000,7000,7000
058901,美律元大99購07  ,0,0,0,0,0,0,0,0,0,7000,0,0,0,67000,60000,7000,7000
059169,可成凱基99購04  ,0,0,0,0,0,0,0,0,0,7000,0,0,0,7000,0,7000,7000
059085,鴻海元大99購25  ,0,0,0,0,0,0,0,0,0,7000,0,0,0,50000,43000,7000,7000
059091,中信金元大99購01,0,0,0,0,0,0,0,0,0,7000,0,0,0,7000,0,7000,7000
058048,群創元大9B購07  ,0,0,0,0,0,0,0,0,0,7000,0,0,0,28000,21000,7000,7000
058019,美律凱基99購04  ,0,0,0,0,0,0,0,0,0,7000,0,0,0,7000,0,7000,7000
058469,臺股指中信9A購05,0,0,0,0,0,0,0,0,0,7000,0,0,0,7000,0,7000,7000
058230,國巨元大99購11  ,0,0,0,0,0,0,0,0,0,7000,0,0,0,57000,50000,7000,7000
058289,奇鋐國票9A購01  ,0,0,0,0,0,0,0,0,0,7000,0,0,0,15000,8000,7000,7000
058079,鴻海群益98購08  ,0,0,0,0,0,0,0,0,0,7000,0,0,0,66000,59000,7000,7000
058085,景碩群益9A購01  ,0,0,0,0,0,0,0,0,0,7000,0,0,0,7000,0,7000,7000
058631,鈺齊國票9A購01  ,0,0,0,0,0,0,0,0,0,7000,0,0,0,12000,5000,7000,7000
058551,義隆永豐99購03  ,0,0,0,0,0,0,0,0,0,7000,0,0,0,8000,1000,7000,7000
07161P,臺股指群益99售12,0,0,0,0,0,0,0,0,0,7000,0,0,0,7000,0,7000,7000
07636P,鴻海國票9A售05  ,0,0,0,0,0,0,0,0,0,7000,0,0,0,7000,0,7000,7000
07738P,玉晶光永豐9A售06,0,0,0,0,0,0,0,0,0,7000,0,0,0,10000,3000,7000,7000
1817,凱撒衛          ,8000,1000,7000,0,0,0,0,0,0,0,0,0,0,0,0,0,7000
2702,華園            ,10000,3000,7000,0,0,0,0,0,0,0,0,0,0,0,0,0,7000
2838A,聯邦銀甲特      ,11000,0,11000,0,0,0,0,0,0,-4000,0,4000,-4000,0,0,0,7000
6184,大豐電          ,11000,4000,7000,0,0,0,0,0,0,0,0,0,0,0,0,0,7000
3702A,大聯大甲特      ,11000,4000,7000,0,0,0,0,0,0,0,0,0,0,0,0,0,7000
9908,大台北          ,15000,8000,7000,0,0,0,0,0,0,0,0,0,0,0,0,0,7000
060672,鴻海元大9A購14  ,0,0,0,0,0,0,0,0,0,6000,0,0,0,6000,0,6000,6000
059716,鴻海元大99購35  ,0,0,0,0,0,0,0,0,0,6000,0,0,0,6000,0,6000,6000
059408,台灣50國票9B購02,0,0,0,0,0,0,0,0,0,6000,0,0,0,6000,0,6000,6000
059473,T50反1群益99購03,0,0,0,0,0,0,0,0,0,6000,0,0,0,15000,9000,6000,6000
059796,台積電國票99購10,0,0,0,0,0,0,0,0,0,6000,0,0,0,16000,10000,6000,6000
05987P,健策統一96售02  ,0,0,0,0,0,0,0,0,0,6000,0,0,0,13000,7000,6000,6000
059854,台表科永豐99購03,0,0,0,0,0,0,0,0,0,6000,0,0,0,45000,39000,6000,6000
07094P,華通國票9A售03  ,0,0,0,0,0,0,0,0,0,6000,0,0,0,67000,61000,6000,6000
06936P,瑞儀元大98售01  ,0,0,0,0,0,0,0,0,0,6000,0,0,0,20000,14000,6000,6000
06937P,GIS元大98售03   ,0,0,0,0,0,0,0,0,0,6000,0,0,0,6000,0,6000,6000
06843P,鴻海元大98售11  ,0,0,0,0,0,0,0,0,0,6000,0,0,0,12000,6000,6000,6000
061164,燿華兆豐9B購01  ,0,0,0,0,0,0,0,0,0,6000,0,0,0,69000,63000,6000,6000
06109P,華新科群益97售05,0,0,0,0,0,0,0,0,0,6000,0,0,0,6000,0,6000,6000
060895,華新科凱基9B購05,0,0,0,0,0,0,0,0,0,6000,0,0,0,32000,26000,6000,6000
06100P,台積電日盛97售03,0,0,0,0,0,0,0,0,0,6000,0,0,0,26000,20000,6000,6000
060876,國巨中信9A購04  ,0,0,0,0,0,0,0,0,0,6000,0,0,0,102000,96000,6000,6000
052674,智邦國泰98購01  ,0,0,0,0,0,0,0,0,0,6000,0,0,0,6000,0,6000,6000
052612,康舒元大97購01  ,0,0,0,0,0,0,0,0,0,6000,0,0,0,6000,0,6000,6000
053729,聯茂凱基96購05  ,0,0,0,0,0,0,0,0,0,6000,0,0,0,6000,0,6000,6000
053744,台郡國票97購03  ,0,0,0,0,0,0,0,0,0,6000,0,0,0,250000,244000,6000,6000
054017,茂林永豐96購02  ,0,0,0,0,0,0,0,0,0,6000,0,0,0,13000,7000,6000,6000
053989,奇力新兆豐97購01,0,0,0,0,0,0,0,0,0,6000,0,0,0,6000,0,6000,6000
052566,國巨凱基96購04  ,0,0,0,0,0,0,0,0,0,6000,0,0,0,41000,35000,6000,6000
050522,聯發科元大95購03,0,0,0,0,0,0,0,0,0,6000,0,0,0,66000,60000,6000,6000
051945,智邦統一95購03  ,0,0,0,0,0,0,0,0,0,6000,0,0,0,16000,10000,6000,6000
051743,揚明光國票96購02,0,0,0,0,0,0,0,0,0,6000,0,0,0,80000,74000,6000,6000
05217P,鴻海統一95售08  ,0,0,0,0,0,0,0,0,0,6000,0,0,0,6000,0,6000,6000
049298,矽格群益95購01  ,0,0,0,0,0,0,0,0,0,6000,0,0,0,6000,0,6000,6000
049288,聯茂兆豐95購02  ,0,0,0,0,0,0,0,0,0,6000,0,0,0,6000,0,6000,6000
03052X,元展49          ,0,0,0,0,0,0,0,0,0,6000,0,0,0,6000,0,6000,6000
01007T,兆豐國泰R2      ,6000,0,6000,0,0,0,0,0,0,0,0,0,0,0,0,0,6000
054412,智邦元大96購03  ,0,0,0,0,0,0,0,0,0,6000,0,0,0,6000,0,6000,6000
054376,聯茂中信97購01  ,0,0,0,0,0,0,0,0,0,6000,0,0,0,93000,87000,6000,6000
054294,世芯元大96購02  ,0,0,0,0,0,0,0,0,0,6000,0,0,0,6000,0,6000,6000
05761P,嘉澤永豐96售01  ,0,0,0,0,0,0,0,0,0,6000,0,0,0,26000,20000,6000,6000
057644,奇力新元大98購04,0,0,0,0,0,0,0,0,0,6000,0,0,0,50000,44000,6000,6000
05449P,臺股指元大95售26,0,0,0,0,0,0,0,0,0,6000,0,0,0,6000,0,6000,6000
053551,可成凱基96購05  ,0,0,0,0,0,0,0,0,0,6000,0,0,0,16000,10000,6000,6000
053474,聯發科元大97購06,0,0,0,0,0,0,0,0,0,6000,0,0,0,6000,0,6000,6000
053388,群創元大9C購02  ,0,0,0,0,0,0,0,0,0,6000,0,0,0,6000,0,6000,6000
054594,國巨麥證97購01  ,0,0,0,6000,0,6000,0,0,0,6000,0,0,0,6000,0,6000,6000
054572,國巨元大98購03  ,0,0,0,0,0,0,0,0,0,6000,0,0,0,8000,2000,6000,6000
054895,南電統一97購01  ,0,0,0,0,0,0,0,0,0,6000,0,0,0,6000,0,6000,6000
058777,台光電國票9A購01,0,0,0,0,0,0,0,0,0,6000,0,0,0,12000,6000,6000,6000
055417,健策富邦98購02  ,0,0,0,0,0,0,0,0,0,6000,0,0,0,6000,0,6000,6000
058223,世芯統一9B購01  ,0,0,0,0,0,0,0,0,0,6000,0,0,0,6000,0,6000,6000
058415,祥碩兆豐99購01  ,0,0,0,0,0,0,0,0,0,6000,0,0,0,10000,4000,6000,6000
058373,晶技凱基99購02  ,0,0,0,0,0,0,0,0,0,6000,0,0,0,6000,0,6000,6000
057134,茂林凱基98購02  ,0,0,0,0,0,0,0,0,0,6000,0,0,0,81000,75000,6000,6000
057135,立積凱基98購01  ,0,0,0,0,0,0,0,0,0,6000,0,0,0,6000,0,6000,6000
056110,嘉聯益永豐97購02,0,0,0,0,0,0,0,0,0,6000,0,0,0,46000,40000,6000,6000
057023,美律凱基99購02  ,0,0,0,0,0,0,0,0,0,6000,0,0,0,6000,0,6000,6000
059067,上銀國票9A購02  ,0,0,0,0,0,0,0,0,0,6000,0,0,0,6000,0,6000,6000
059192,臺股指富邦9C購01,0,0,0,0,0,0,0,0,0,6000,0,0,0,10000,4000,6000,6000
059205,元石油元大99購01,0,0,0,0,0,0,0,0,0,6000,0,0,0,10000,4000,6000,6000
058897,國巨元大99購17  ,0,0,0,0,0,0,0,0,0,6000,0,0,0,6000,0,6000,6000
057505,健策麥證98購01  ,0,0,0,16000,0,16000,0,0,0,6000,0,0,0,16000,10000,6000,6000
057222,鴻海國票99購04  ,0,0,0,0,0,0,0,0,0,6000,0,0,0,6000,0,6000,6000
057190,立積元大9A購02  ,0,0,0,0,0,0,0,0,0,6000,0,0,0,6000,0,6000,6000
056041,禾伸堂凱基98購03,0,0,0,0,0,0,0,0,0,6000,0,0,0,6000,0,6000,6000
056491,南亞科國泰99購01,0,0,0,0,0,0,0,0,0,6000,0,0,0,6000,0,6000,6000
056537,冠德凱基98購01  ,0,0,0,0,0,0,0,0,0,6000,0,0,0,6000,0,6000,6000
056960,光罩永豐98購01  ,0,0,0,0,0,0,0,0,0,6000,0,0,0,125000,119000,6000,6000
8046,南電            ,2386000,4424000,-2038000,0,0,0,1815000,0,1815000,229000,419000,245000,174000,96000,41000,55000,6000
6128,上福            ,6000,0,6000,0,0,0,0,0,0,0,0,0,0,0,0,0,6000
2546,根基            ,18000,12000,6000,0,0,0,0,0,0,0,0,0,0,0,0,0,6000
2358,廷鑫            ,16000,10000,6000,0,0,0,0,0,0,0,0,0,0,0,0,0,6000
07770P,台積電國票9A售07,0,0,0,0,0,0,0,0,0,6000,0,0,0,10000,4000,6000,6000
1410,南染            ,6000,0,6000,0,0,0,0,0,0,0,0,0,0,0,0,0,6000
07300P,臺股指元大9A售33,0,0,0,0,0,0,0,0,0,6000,0,0,0,31000,25000,6000,6000
060792,信錦永豐9A購01  ,0,0,0,0,0,0,0,0,0,5000,0,0,0,5000,0,5000,5000
060882,大立光中信9A購05,0,0,0,0,0,0,0,0,0,5000,0,0,0,55000,50000,5000,5000
061210,玉山金元大9A購02,0,0,0,0,0,0,0,0,0,5000,0,0,0,84000,79000,5000,5000
061363,儒鴻國票9B購01  ,0,0,0,0,0,0,0,0,0,5000,0,0,0,33000,28000,5000,5000
06133P,帆宣元富97售02  ,0,0,0,0,0,0,0,0,0,5000,0,0,0,5000,0,5000,5000
06890P,金融類元大98售02,0,0,0,0,0,0,0,0,0,5000,0,0,0,5000,0,5000,5000
06921P,台光電凱基98售06,0,0,0,0,0,0,0,0,0,5000,0,0,0,5000,0,5000,5000
06634P,欣興國票98售02  ,0,0,0,0,0,0,0,0,0,5000,0,0,0,6000,1000,5000,5000
06838P,台積電統一99售05,0,0,0,0,0,0,0,0,0,5000,0,0,0,5000,0,5000,5000
06813P,友訊元富98售03  ,0,0,0,0,0,0,0,0,0,5000,0,0,0,5000,0,5000,5000
061402,矽創兆豐9B購01  ,0,0,0,0,0,0,0,0,0,5000,0,0,0,40000,35000,5000,5000
06328P,台積電中信01售02,0,0,0,0,0,0,0,0,0,5000,0,0,0,5000,0,5000,5000
06475P,牧德永豐98售03  ,0,0,0,0,0,0,0,0,0,5000,0,0,0,35000,30000,5000,5000
059818,鴻海凱基99購14  ,0,0,0,0,0,0,0,0,0,5000,0,0,0,10000,5000,5000,5000
060072,國巨元富99購04  ,0,0,0,0,0,0,0,0,0,5000,0,0,0,1208000,1203000,5000,5000
059404,鴻海台新99購03  ,0,0,0,0,0,0,0,0,0,5000,0,0,0,5000,0,5000,5000
059354,臺指反富邦9B購01,0,0,0,0,0,0,0,0,0,5000,0,0,0,5000,0,5000,5000
059697,上証2X凱基9A購03,0,0,0,0,0,0,0,0,0,5000,0,0,0,5000,0,5000,5000
059699,華通凱基99購04  ,0,0,0,0,0,0,0,0,0,5000,0,0,0,5000,0,5000,5000
059671,滬深2X元富99購05,0,0,0,0,0,0,0,0,0,5000,0,0,0,5000,0,5000,5000
059620,聯發科日盛99購02,0,0,0,0,0,0,0,0,0,5000,0,0,0,5000,0,5000,5000
060609,玉晶光凱基9B購01,0,0,0,0,0,0,0,0,0,5000,0,0,0,5000,0,5000,5000
060607,玉晶光凱基9A購06,0,0,0,0,0,0,0,0,0,5000,0,0,0,5000,0,5000,5000
060626,貿聯元大9A購04  ,0,0,0,0,0,0,0,0,0,5000,0,0,0,33000,28000,5000,5000
060440,台灣50元大9C購27,0,0,0,0,0,0,0,0,0,5000,0,0,0,5000,0,5000,5000
054857,信錦群益97購01  ,0,0,0,0,0,0,0,0,0,5000,0,0,0,5000,0,5000,5000
054965,健策元大98購04  ,0,0,0,0,0,0,0,0,0,5000,0,0,0,5000,0,5000,5000
055209,勤誠康和97購01  ,0,0,0,0,0,0,0,0,0,5000,0,0,0,5000,0,5000,5000
054743,聯鈞凱基99購01  ,0,0,0,0,0,0,0,0,0,5000,0,0,0,5000,0,5000,5000
054634,FB上証中信99購01,0,0,0,0,0,0,0,0,0,5000,0,0,0,10000,5000,5000,5000
054625,旺宏凱基98購03  ,0,0,0,0,0,0,0,0,0,5000,0,0,0,5000,0,5000,5000
053423,亞光永豐96購01  ,0,0,0,0,0,0,0,0,0,5000,0,0,0,107000,102000,5000,5000
053483,嘉澤第一96購01  ,0,0,0,0,0,0,0,0,0,5000,0,0,0,5000,0,5000,5000
053293,聯發科中信9B購01,0,0,0,0,0,0,0,0,0,5000,0,0,0,5000,0,5000,5000
053294,聯發科中信9C購01,0,0,0,0,0,0,0,0,0,5000,0,0,0,5000,0,5000,5000
053353,玉晶光兆豐97購03,0,0,0,0,0,0,0,0,0,5000,0,0,0,5000,0,5000,5000
053347,茂林國票98購01  ,0,0,0,0,0,0,0,0,0,5000,0,0,0,10000,5000,5000,5000
053278,禾伸堂元大96購01,0,0,0,0,0,0,0,0,0,5000,0,0,0,36000,31000,5000,5000
053683,上証2X元大96購03,0,0,0,0,0,0,0,0,0,5000,0,0,0,5000,0,5000,5000
057947,和碩國票99購01  ,0,0,0,0,0,0,0,0,0,5000,0,0,0,5000,0,5000,5000
05793P,臺股指中信99售08,0,0,0,0,0,0,0,0,0,5000,0,0,0,10000,5000,5000,5000
057646,玉山金元大98購01,0,0,0,0,0,0,0,0,0,5000,0,0,0,54000,49000,5000,5000
05763P,致新永豐96售01  ,0,0,0,0,0,0,0,0,0,5000,0,0,0,5000,0,5000,5000
052955,國巨日盛96購01  ,0,0,0,0,0,0,0,0,0,5000,0,0,0,15000,10000,5000,5000
054383,傳奇群益97購01  ,0,0,0,0,0,0,0,0,0,5000,0,0,0,5000,0,5000,5000
054400,健策永豐96購02  ,0,0,0,0,0,0,0,0,0,5000,0,0,0,15000,10000,5000,5000
054207,國巨國票98購01  ,0,0,0,0,0,0,0,0,0,5000,0,0,0,5000,0,5000,5000
054214,京鼎國票97購02  ,0,0,0,0,0,0,0,0,0,5000,0,0,0,5000,0,5000,5000
00700,富邦恒生國企    ,0,0,0,0,0,0,0,0,0,5000,0,0,0,125000,120000,5000,5000
049004,聯發科中信96購01,0,0,0,0,0,0,0,0,0,5000,0,0,0,5000,0,5000,5000
048504,A50正2中信95購01,0,0,0,0,0,0,0,0,0,5000,0,0,0,5000,0,5000,5000
04606P,高股息中信96售01,0,0,0,0,0,0,0,0,0,5000,0,0,0,5000,0,5000,5000
046793,聯發科元富99購01,0,0,0,0,0,0,0,0,0,5000,0,0,0,5000,0,5000,5000
04289P,臺股指中信95售07,0,0,0,0,0,0,0,0,0,5000,0,0,0,5000,0,5000,5000
042692,台灣50凱基96購09,0,0,0,0,0,0,0,0,0,5000,0,0,0,5000,0,5000,5000
052137,台表科凱基96購02,0,0,0,0,0,0,0,0,0,5000,0,0,0,5000,0,5000,5000
051784,國巨兆豐95購01  ,0,0,0,0,0,0,0,0,0,5000,0,0,0,5000,0,5000,5000
051826,智邦元大95購03  ,0,0,0,0,0,0,0,0,0,5000,0,0,0,5000,0,5000,5000
05066P,康控元大95售03  ,0,0,0,0,0,0,0,0,0,5000,0,0,0,5000,0,5000,5000
050650,大立光凱基96購01,0,0,0,0,0,0,0,0,0,5000,0,0,0,5000,0,5000,5000
050779,超眾元大96購03  ,0,0,0,0,0,0,0,0,0,5000,0,0,0,5000,0,5000,5000
051094,健策元大96購03  ,0,0,0,0,0,0,0,0,0,5000,0,0,0,5000,0,5000,5000
052563,京元電日盛96購01,0,0,0,0,0,0,0,0,0,5000,0,0,0,5000,0,5000,5000
049591,開發金元大98購01,0,0,0,0,0,0,0,0,0,5000,0,0,0,5000,0,5000,5000
050228,中磊中信96購01  ,0,0,0,0,0,0,0,0,0,5000,0,0,0,15000,10000,5000,5000
050169,臺指反元大97購01,0,0,0,0,0,0,0,0,0,5000,0,0,0,5000,0,5000,5000
052502,瀚宇博永豐95購02,0,0,0,0,0,0,0,0,0,5000,0,0,0,5000,0,5000,5000
052279,旺宏凱基95購07  ,0,0,0,0,0,0,0,0,0,5000,0,0,0,5000,0,5000,5000
052297,旭富國票96購01  ,0,0,0,0,0,0,0,0,0,5000,0,0,0,5000,0,5000,5000
052298,易華電國票96購01,0,0,0,0,0,0,0,0,0,5000,0,0,0,5000,0,5000,5000
052317,台積電元大96購11,0,0,0,0,0,0,0,0,0,5000,0,0,0,5000,0,5000,5000
053990,晶技兆豐96購01  ,0,0,0,0,0,0,0,0,0,5000,0,0,0,5000,0,5000,5000
053996,晶相光群益97購01,0,299000,-299000,0,0,0,0,0,0,304000,0,0,0,382000,78000,304000,5000
05509P,智邦元富96售02  ,0,0,0,0,0,0,0,0,0,5000,0,0,0,5000,0,5000,5000
055102,上銀凱基98購01  ,0,0,0,0,0,0,0,0,0,5000,0,0,0,5000,0,5000,5000
052599,S&P反1元大96購01,0,0,0,0,0,0,0,0,0,5000,0,0,0,14000,9000,5000,5000
052663,奇鋐國票97購01  ,0,0,0,0,0,0,0,0,0,5000,0,0,0,5000,0,5000,5000
051488,健策凱基96購04  ,0,0,0,0,0,0,0,0,0,5000,0,0,0,5000,0,5000,5000
051461,聯詠國泰96購01  ,0,0,0,0,0,0,0,0,0,5000,0,0,0,10000,5000,5000,5000
056917,國巨兆豐98購03  ,0,0,0,0,0,0,0,0,0,5000,0,0,0,5000,0,5000,5000
056757,T50反1元大98購07,0,0,0,0,0,0,0,0,0,5000,0,0,0,5000,0,5000,5000
05649P,矽創國票97售03  ,0,0,0,0,0,0,0,0,0,5000,0,0,0,11000,6000,5000,5000
055466,台達電凱基97購03,0,0,0,0,0,0,0,0,0,5000,0,0,0,5000,0,5000,5000
05722P,玉晶光國票97售03,0,0,0,0,0,0,0,0,0,5000,0,0,0,5000,0,5000,5000
055500,京鼎元大97購04  ,0,0,0,0,0,0,0,0,0,5000,0,0,0,5000,0,5000,5000
056050,晶技國票98購01  ,0,0,0,0,0,0,0,0,0,5000,0,0,0,5000,0,5000,5000
056377,智伸科統一9A購01,0,0,0,0,0,0,0,0,0,5000,0,0,0,5000,0,5000,5000
056371,樺漢元大98購03  ,0,0,0,0,0,0,0,0,0,5000,0,0,0,5000,0,5000,5000
056428,台達電凱基99購01,0,0,0,0,0,0,0,0,0,5000,0,0,0,5000,0,5000,5000
056401,國巨群益98購07  ,0,0,0,0,0,0,0,0,0,5000,0,0,0,5000,0,5000,5000
057545,國巨凱基99購05  ,0,0,0,0,0,0,0,0,0,5000,0,0,0,5000,0,5000,5000
057563,旭富國泰9A購01  ,0,0,0,0,0,0,0,0,0,5000,0,0,0,10000,5000,5000,5000
058823,聯發科富邦9C購01,0,0,0,0,0,0,0,0,0,5000,0,0,0,5000,0,5000,5000
058941,華新科中信99購03,0,0,0,0,0,0,0,0,0,5000,0,0,0,15000,10000,5000,5000
059134,臺股指群益99購09,0,0,0,0,0,0,0,0,0,5000,0,0,0,5000,0,5000,5000
057040,國巨元大98購12  ,0,0,0,0,0,0,0,0,0,5000,0,0,0,94000,89000,5000,5000
058052,南電元大98購02  ,0,0,0,0,0,0,0,0,0,5000,0,0,0,5000,0,5000,5000
058287,國巨國票9A購02  ,0,0,0,0,0,0,0,0,0,5000,0,0,0,10000,5000,5000,5000
058473,上銀凱基9A購03  ,0,0,0,0,0,0,0,0,0,5000,0,0,0,5000,0,5000,5000
058434,旺宏統一9B購01  ,0,0,0,0,0,0,0,0,0,5000,0,0,0,15000,10000,5000,5000
058257,聯陽國泰9B購01  ,0,0,0,0,0,0,0,0,0,5000,0,0,0,5000,0,5000,5000
058072,大立光凱基98購20,0,0,0,0,0,0,0,0,0,5000,0,0,0,5000,0,5000,5000
055564,茂林凱基98購01  ,0,0,0,0,0,0,0,0,0,5000,0,0,0,5000,0,5000,5000
056331,聯鈞國票99購01  ,0,0,0,0,0,0,0,0,0,5000,0,0,0,5000,0,5000,5000
056338,聯發科凱基99購01,0,0,0,0,0,0,0,0,0,5000,0,0,0,5000,0,5000,5000
055813,聯發科國票98購04,0,0,0,0,0,0,0,0,0,5000,0,0,0,20000,15000,5000,5000
055860,啟碁元大97購04  ,0,0,0,0,0,0,0,0,0,5000,0,0,0,5000,0,5000,5000
058739,喬山中信99購01  ,0,0,0,0,0,0,0,0,0,5000,0,0,0,322000,317000,5000,5000
056310,神達元大97購02  ,0,0,0,0,0,0,0,0,0,5000,0,0,0,5000,0,5000,5000
058535,玉晶光統一9A購06,0,0,0,0,0,0,0,0,0,5000,0,0,0,5000,0,5000,5000
058653,光寶科中信9A購01,0,0,0,0,0,0,0,0,0,5000,0,0,0,80000,75000,5000,5000
07285P,上証2X群益01售02,0,0,0,0,0,0,0,0,0,5000,0,0,0,5000,0,5000,5000
07338P,滬深2X凱基99售02,0,0,0,0,0,0,0,0,0,5000,0,0,0,5000,0,5000,5000
07481P,大立光台新9A售01,0,0,0,0,0,0,0,0,0,5000,0,0,0,5000,0,5000,5000
1702,南僑            ,43000,42000,1000,0,0,0,0,0,0,4000,0,0,0,4000,0,4000,5000
07745P,華新科凱基9A售10,0,0,0,0,0,0,0,0,0,5000,0,0,0,5000,0,5000,5000
07699P,臺股指元大9A售52,0,0,0,0,0,0,0,0,0,5000,0,0,0,20000,15000,5000,5000
2375,凱美            ,385000,374000,11000,0,0,0,0,0,0,-6000,0,0,0,0,6000,-6000,5000
2849,安泰銀          ,22000,17000,5000,0,0,0,0,0,0,0,0,0,0,0,0,0,5000
2466,冠西電          ,6000,1000,5000,0,0,0,0,0,0,0,0,0,0,0,0,0,5000
4725,信昌化          ,121000,116000,5000,0,0,0,0,0,0,0,0,0,0,0,0,0,5000
3167,大量            ,5000,0,5000,0,0,0,0,0,0,0,0,0,0,0,0,0,5000
6666,羅麗芬-KY       ,13000,8000,5000,0,0,0,0,0,0,0,0,0,0,0,0,0,5000
8429,金麗-KY         ,35000,30000,5000,0,0,0,0,0,0,0,0,0,0,0,0,0,5000
059596,大立光元大99購20,0,0,0,0,0,0,0,0,0,4000,0,0,0,4000,0,4000,4000
059389,國巨凱基99購14  ,0,0,0,0,0,0,0,0,0,4000,0,0,0,14000,10000,4000,4000
059467,旺宏元大99購15  ,0,0,0,0,0,0,0,0,0,4000,0,0,0,4000,0,4000,4000
059494,國巨國票9C購01  ,0,0,0,0,0,0,0,0,0,4000,0,0,0,4000,0,4000,4000
059885,台積電國票99購12,0,0,0,0,0,0,0,0,0,4000,0,0,0,25000,21000,4000,4000
06447P,上銀元大98售01  ,0,0,0,0,0,0,0,0,0,4000,0,0,0,13000,9000,4000,4000
061420,國巨元大9A購22  ,0,0,0,0,0,0,0,0,0,4000,0,0,0,128000,124000,4000,4000
06849P,欣興元大98售12  ,0,0,0,0,0,0,0,0,0,4000,0,0,0,23000,19000,4000,4000
06606P,訊芯元富98售02  ,0,0,0,0,0,0,0,0,0,4000,0,0,0,4000,0,4000,4000
06902P,聯電凱基98售02  ,0,0,0,0,0,0,0,0,0,4000,0,0,0,4000,0,4000,4000
061167,臻鼎兆豐9B購01  ,0,0,0,0,0,0,0,0,0,4000,0,0,0,34000,30000,4000,4000
060985,聯發科元大9A購06,0,0,0,0,0,0,0,0,0,4000,0,0,0,89000,85000,4000,4000
060802,道瓊指中信9C購03,0,0,0,0,0,0,0,0,0,4000,0,0,0,4000,0,4000,4000
051487,健策凱基96購03  ,0,0,0,0,0,0,0,0,0,4000,0,0,0,4000,0,4000,4000
051404,牧德永豐96購01  ,0,0,0,0,0,0,0,0,0,4000,0,0,0,4000,0,4000,4000
05136P,台積電凱基95售08,0,0,0,0,0,0,0,0,0,4000,0,0,0,5000,1000,4000,4000
052647,晶技永豐97購01  ,0,0,0,0,0,0,0,0,0,4000,0,0,0,12000,8000,4000,4000
053769,香港反元大99購01,0,0,0,0,0,0,0,0,0,4000,0,0,0,5000,1000,4000,4000
051827,智邦元大95購04  ,0,0,0,0,0,0,0,0,0,4000,0,0,0,4000,0,4000,4000
049430,國巨國票95購02  ,0,0,0,0,0,0,0,0,0,4000,0,0,0,4000,0,4000,4000
049064,T50反1凱基96購03,0,0,0,0,0,0,0,0,0,4000,0,0,0,4000,0,4000,4000
03049X,元展46          ,0,0,0,0,0,0,0,0,0,4000,0,0,0,6000,2000,4000,4000
00728,第一金工業30    ,0,0,0,0,0,0,0,0,0,4000,0,0,0,437000,433000,4000,4000
054410,國巨元大96購14  ,0,0,0,0,0,0,0,0,0,4000,0,0,0,4000,0,4000,4000
057617,國巨凱基99購06  ,0,0,0,0,0,0,0,0,0,4000,0,0,0,4000,0,4000,4000
054061,晶技國票97購03  ,0,0,0,0,0,0,0,0,0,4000,0,0,0,39000,35000,4000,4000
053321,智原群益96購02  ,0,0,0,0,0,0,0,0,0,4000,0,0,0,10000,6000,4000,4000
055264,國巨永豐98購01  ,0,0,0,0,0,0,0,0,0,4000,0,0,0,206000,202000,4000,4000
058068,旺宏凱基98購11  ,0,25000,-25000,0,0,0,0,0,0,29000,0,0,0,118000,89000,29000,4000
058459,南電永豐99購01  ,0,0,0,0,0,0,0,0,0,4000,0,0,0,4000,0,4000,4000
056094,大立光元富97購03,0,0,0,0,0,0,0,0,0,4000,0,0,0,108000,104000,4000,4000
059035,旺宏群益99購06  ,0,0,0,0,0,0,0,0,0,4000,0,0,0,4000,0,4000,4000
057500,神達群益98購01  ,0,0,0,0,0,0,0,0,0,4000,0,0,0,4000,0,4000,4000
057198,智伸科統一9B購01,0,0,0,0,0,0,0,0,0,4000,0,0,0,4000,0,4000,4000
056794,上銀麥證98購01  ,0,0,0,4000,0,4000,0,0,0,4000,0,0,0,4000,0,4000,4000
056906,玉晶光元大9B購01,0,0,0,0,0,0,0,0,0,4000,0,0,0,4000,0,4000,4000
056689,玉晶光統一9A購03,0,0,0,0,0,0,0,0,0,4000,0,0,0,117000,113000,4000,4000
6625,必應            ,4000,0,4000,0,0,0,0,0,0,0,0,0,0,0,0,0,4000
3528,安馳            ,4000,0,4000,0,0,0,0,0,0,0,0,0,0,0,0,0,4000
6216,居易            ,4000,0,4000,0,0,0,0,0,0,0,0,0,0,0,0,0,4000
2462,良得電          ,4000,0,4000,0,0,0,0,0,0,0,0,0,0,0,0,0,4000
2430,燦坤            ,5000,1000,4000,0,0,0,0,0,0,0,0,0,0,0,0,0,4000
2483,百容            ,6000,2000,4000,0,0,0,0,0,0,0,0,0,0,0,0,0,4000
2881A,富邦特          ,0,3000,-3000,0,0,0,0,0,0,7000,7000,0,7000,0,0,0,4000
1220,台榮            ,4000,0,4000,0,0,0,0,0,0,0,0,0,0,0,0,0,4000
1521,大億            ,4000,0,4000,0,0,0,0,0,0,0,0,0,0,0,0,0,4000
1233,天仁            ,4000,0,4000,0,0,0,0,0,0,0,0,0,0,0,0,0,4000
1436,華友聯          ,7000,3000,4000,0,0,0,0,0,0,0,0,0,0,0,0,0,4000
07384P,大立光群益9A售01,0,0,0,0,0,0,0,0,0,4000,0,0,0,4000,0,4000,4000
07614P,華新科群益9A售04,0,0,0,0,0,0,0,0,0,4000,0,0,0,6000,2000,4000,4000
07142P,台灣50元大01售01,0,0,0,0,0,0,0,0,0,4000,0,0,0,4000,0,4000,4000
060798,旭富永豐9A購01  ,0,0,0,0,0,0,0,0,0,3000,0,0,0,3000,0,3000,3000
060811,亞德客凱基9A購02,0,0,0,0,0,0,0,0,0,3000,0,0,0,25000,22000,3000,3000
061206,旺宏元大9A購12  ,0,0,0,0,0,0,0,0,0,3000,0,0,0,154000,151000,3000,3000
061321,華新科凱基9A購09,0,0,0,0,0,0,0,0,0,3000,0,0,0,3000,0,3000,3000
061303,玉晶光永豐9B購03,0,0,0,0,0,0,0,0,0,3000,0,0,0,7000,4000,3000,3000
061314,滬深2X凱基9B購06,0,0,0,0,0,0,0,0,0,3000,0,0,0,3000,0,3000,3000
07098P,台積電元大99售18,0,0,0,0,0,0,0,0,0,3000,0,0,0,3000,0,3000,3000
06578P,華新科國票98售02,0,0,0,0,0,0,0,0,0,3000,0,0,0,3000,0,3000,3000
06648P,華邦電元大98售03,0,0,0,0,0,0,0,0,0,3000,0,0,0,3000,0,3000,3000
06461P,玉晶光國泰9A售01,0,0,0,0,0,0,0,0,0,3000,0,0,0,4000,1000,3000,3000
06311P,嘉聯益元富97售02,0,0,0,0,0,0,0,0,0,3000,0,0,0,3000,0,3000,3000
06160P,台達電群益97售01,0,0,0,0,0,0,0,0,0,3000,0,0,0,13000,10000,3000,3000
059941,聯發科永豐99購04,0,0,0,0,0,0,0,0,0,3000,0,0,0,3000,0,3000,3000
059532,華新科凱基9B購03,0,0,0,0,0,0,0,0,0,3000,0,0,0,3000,0,3000,3000
059542,聯發科亞東99購01,0,0,0,0,0,0,0,0,0,3000,0,0,0,4000,1000,3000,3000
059587,華通元大9A購01  ,0,0,0,0,0,0,0,0,0,3000,0,0,0,4000,1000,3000,3000
059588,鴻海元大99購32  ,0,0,0,0,0,0,0,0,0,3000,0,0,0,32000,29000,3000,3000
059696,立積永豐99購03  ,0,0,0,0,0,0,0,0,0,3000,0,0,0,16000,13000,3000,3000
059726,華新科元大99購18,0,0,0,0,0,0,0,0,0,3000,0,0,0,3000,0,3000,3000
059744,禾伸堂元富99購02,0,0,0,0,0,0,0,0,0,3000,0,0,0,3000,0,3000,3000
060520,臺指2X中信01購02,0,0,0,0,0,0,0,0,0,3000,0,0,0,3000,0,3000,3000
06048P,大立光富邦96售05,0,0,0,0,0,0,0,0,0,3000,0,0,0,3000,0,3000,3000
060603,聯發科凱基9A購12,0,0,0,0,0,0,0,0,0,3000,0,0,0,382000,379000,3000,3000
060332,聯發科麥證9A購01,0,0,0,7000,4000,3000,0,0,0,3000,0,0,0,7000,4000,3000,3000
060115,南電元大99購06  ,0,0,0,0,0,0,0,0,0,3000,0,0,0,3000,0,3000,3000
060148,臺股指國票9A購08,0,0,0,0,0,0,0,0,0,3000,0,0,0,18000,15000,3000,3000
06021P,世紀鋼元富96售03,0,0,0,0,0,0,0,0,0,3000,0,0,0,12000,9000,3000,3000
05331P,上証2X國票96售01,0,0,0,0,0,0,0,0,0,3000,0,0,0,7000,4000,3000,3000
053243,楠梓電國票97購02,0,0,0,0,0,0,0,0,0,3000,0,0,0,3000,0,3000,3000
053195,玉晶光元富96購02,0,0,0,0,0,0,0,0,0,3000,0,0,0,13000,10000,3000,3000
053155,晶技元大97購02  ,0,0,0,0,0,0,0,0,0,3000,0,0,0,3000,0,3000,3000
054063,聯茂國票97購02  ,0,0,0,0,0,0,0,0,0,3000,0,0,0,3000,0,3000,3000
052790,智邦兆豐97購01  ,0,0,0,0,0,0,0,0,0,3000,0,0,0,3000,0,3000,3000
052775,滬深2X國票99購02,0,0,0,0,0,0,0,0,0,3000,0,0,0,11000,8000,3000,3000
053675,臺股指元富96購02,0,0,0,0,0,0,0,0,0,3000,0,0,0,3000,0,3000,3000
054968,佐登元大97購01  ,0,0,0,0,0,0,0,0,0,3000,0,0,0,3000,0,3000,3000
057923,晶豪科凱基98購02,0,0,0,0,0,0,0,0,0,3000,0,0,0,3000,0,3000,3000
057901,大立光永豐98購04,0,0,0,0,0,0,0,0,0,3000,0,0,0,3000,0,3000,3000
057852,國巨國票99購05  ,0,0,0,0,0,0,0,0,0,3000,0,0,0,3000,0,3000,3000
057856,聯鈞國票99購03  ,0,0,0,0,0,0,0,0,0,3000,0,0,0,18000,15000,3000,3000
052972,義隆群益96購04  ,0,0,0,0,0,0,0,0,0,3000,0,0,0,15000,12000,3000,3000
053054,禾伸堂國票97購01,0,0,0,0,0,0,0,0,0,3000,0,0,0,3000,0,3000,3000
048901,矽格國泰95購01  ,0,0,0,0,0,0,0,0,0,3000,0,0,0,3000,0,3000,3000
051619,智邦凱基95購07  ,0,0,0,0,0,0,0,0,0,3000,0,0,0,3000,0,3000,3000
044247,道瓊反元富97購01,0,0,0,0,0,0,0,0,0,3000,0,0,0,3000,0,3000,3000
046630,京元電元富95購03,0,0,0,0,0,0,0,0,0,3000,0,0,0,6000,3000,3000,3000
052038,國巨永昌96購01  ,0,0,0,0,0,0,0,0,0,3000,0,0,0,3000,0,3000,3000
053737,華新科麥證96購01,0,0,0,3000,0,3000,0,0,0,3000,0,0,0,3000,0,3000,3000
051424,緯穎國票97購01  ,0,0,0,0,0,0,0,0,0,3000,0,0,0,3000,0,3000,3000
051450,世芯元大95購02  ,0,0,0,0,0,0,0,0,0,3000,0,0,0,3000,0,3000,3000
052325,高股息中信99購01,0,0,0,0,0,0,0,0,0,3000,0,0,0,3000,0,3000,3000
051092,禾伸堂元大95購02,0,0,0,0,0,0,0,0,0,3000,0,0,0,3000,0,3000,3000
051319,光磊國票96購02  ,0,0,0,0,0,0,0,0,0,3000,0,0,0,3000,0,3000,3000
050899,旭富元大95購01  ,0,0,0,0,0,0,0,0,0,3000,0,0,0,3000,0,3000,3000
050385,貿聯國票95購02  ,0,0,0,0,0,0,0,0,0,3000,0,0,0,38000,35000,3000,3000
056715,瀚宇博永豐98購01,0,0,0,0,0,0,0,0,0,3000,0,0,0,119000,116000,3000,3000
056561,台光電群益98購02,0,0,0,0,0,0,0,0,0,3000,0,0,0,52000,49000,3000,3000
056822,佐登永豐98購01  ,0,0,0,0,0,0,0,0,0,3000,0,0,0,3000,0,3000,3000
056367,祥碩元大98購01  ,0,0,0,0,0,0,0,0,0,3000,0,0,0,5000,2000,3000,3000
057413,臺股指群益9C購04,0,0,0,0,0,0,0,0,0,3000,0,0,0,7000,4000,3000,3000
058997,鴻海元大99購21  ,0,0,0,0,0,0,0,0,0,3000,0,0,0,33000,30000,3000,3000
056250,瑞昱兆豐97購02  ,0,0,0,0,0,0,0,0,0,3000,0,0,0,125000,122000,3000,3000
058481,玉晶光凱基9A購04,0,0,0,0,0,0,0,0,0,3000,0,0,0,4000,1000,3000,3000
058360,台光電凱基9A購02,0,0,0,0,0,0,0,0,0,3000,0,0,0,3000,0,3000,3000
058121,國巨國票9A購01  ,0,0,0,0,0,0,0,0,0,3000,0,0,0,33000,30000,3000,3000
058103,台積電永豐98購06,0,0,0,0,0,0,0,0,0,3000,0,0,0,3000,0,3000,3000
058636,亞光兆豐9A購01  ,0,0,0,0,0,0,0,0,0,3000,0,0,0,3000,0,3000,3000
05536P,奇力新元大96售03,0,0,0,0,0,0,0,0,0,3000,0,0,0,3000,0,3000,3000
055363,緯穎凱基98購03  ,0,0,0,0,0,0,0,0,0,3000,0,0,0,3000,0,3000,3000
07158P,FBVIX國泰9C售01 ,0,0,0,0,0,0,0,0,0,3000,0,0,0,3000,0,3000,3000
07323P,鴻海元大99售34  ,0,0,0,0,0,0,0,0,0,3000,0,0,0,3000,0,3000,3000
07571P,台灣50元大9A售14,0,0,0,0,0,0,0,0,0,3000,0,0,0,3000,0,3000,3000
07496P,鴻海元大9A售05  ,0,0,0,0,0,0,0,0,0,3000,0,0,0,4000,1000,3000,3000
1445,大宇            ,8000,5000,3000,0,0,0,0,0,0,0,0,0,0,0,0,0,3000
1312A,國喬特          ,0,0,0,0,0,0,0,0,0,3000,3000,0,3000,0,0,0,3000
1535,中宇            ,3000,0,3000,0,0,0,0,0,0,0,0,0,0,0,0,0,3000
08864P,欣興元大01售01  ,0,0,0,0,0,0,0,0,0,3000,0,0,0,3000,0,3000,3000
07677P,祥碩永豐9A售01  ,0,0,0,0,0,0,0,0,0,3000,0,0,0,6000,3000,3000,3000
07717P,臺股指群益9A售06,0,0,0,0,0,0,0,0,0,3000,0,0,0,7000,4000,3000,3000
4438,廣越            ,11000,8000,3000,0,0,0,0,0,0,0,0,0,0,0,0,0,3000
3550,聯穎            ,3000,0,3000,0,0,0,0,0,0,0,0,0,0,0,0,0,3000
4190,佐登-KY         ,68000,41000,27000,0,0,0,0,30000,-30000,6000,0,0,0,6000,0,6000,3000
3025,星通            ,8000,5000,3000,0,0,0,0,0,0,0,0,0,0,0,0,0,3000
6671,三能-KY         ,3000,0,3000,0,0,0,0,0,0,0,0,0,0,0,0,0,3000
8454,富邦媒          ,70000,58000,12000,0,0,0,0,7000,-7000,-2000,0,2000,-2000,0,0,0,3000
8411,福貞-KY         ,0,0,0,0,0,0,0,0,0,3000,3000,0,3000,0,0,0,3000
06018P,康控凱基96售03  ,0,0,0,0,0,0,0,0,0,2000,0,0,0,2000,0,2000,2000
060143,台積電國票9B購03,0,0,0,0,0,0,0,0,0,2000,0,0,0,16000,14000,2000,2000
060146,健策國票9A購03  ,0,0,0,0,0,0,0,0,0,2000,0,0,0,11000,9000,2000,2000
060136,T50反1國票9A購01,0,0,0,0,0,0,0,0,0,2000,0,0,0,2000,0,2000,2000
060324,台積電群益9B購02,0,0,0,0,0,0,0,0,0,2000,0,0,0,5000,3000,2000,2000
060317,台灣50群益02購01,0,0,0,0,0,0,0,0,0,2000,0,0,0,4000,2000,2000,2000
060398,立積國票9B購01  ,0,0,0,0,0,0,0,0,0,2000,0,0,0,65000,63000,2000,2000
060606,玉晶光凱基9A購05,0,0,0,0,0,0,0,0,0,2000,0,0,0,7000,5000,2000,2000
060613,T50反1元大9A購05,0,0,0,0,0,0,0,0,0,2000,0,0,0,2000,0,2000,2000
060546,旺宏凱基9A購02  ,0,0,0,0,0,0,0,0,0,2000,0,0,0,2000,0,2000,2000
059659,旺宏元大9A購03  ,0,0,0,0,0,0,0,0,0,2000,0,0,0,2000,0,2000,2000
059694,創意永豐99購03  ,0,0,0,0,0,0,0,0,0,2000,0,0,0,34000,32000,2000,2000
059597,大立光元大99購21,0,0,0,0,0,0,0,0,0,2000,0,0,0,3000,1000,2000,2000
059598,欣興元大99購08  ,0,0,0,0,0,0,0,0,0,2000,0,0,0,3000,1000,2000,2000
059592,聯發科元大99購28,0,0,0,0,0,0,0,0,0,2000,0,0,0,2000,0,2000,2000
059648,台表科凱基99購03,0,0,0,0,0,0,0,0,0,2000,0,0,0,2000,0,2000,2000
059553,台灣50凱基99購05,0,0,0,0,0,0,0,0,0,2000,0,0,0,2000,0,2000,2000
059383,台灣50凱基99購03,0,0,0,0,0,0,0,0,0,2000,0,0,0,10000,8000,2000,2000
059398,滬深2X元富9C購02,0,0,0,0,0,0,0,0,0,2000,0,0,0,2000,0,2000,2000
059429,台積電元大99購35,0,0,0,0,0,0,0,0,0,2000,0,0,0,3000,1000,2000,2000
059937,旺宏永豐99購03  ,0,0,0,0,0,0,0,0,0,2000,0,0,0,2000,0,2000,2000
060073,台積電元富99購03,0,0,0,0,0,0,0,0,0,2000,0,0,0,18000,16000,2000,2000
060025,台積電富邦9C購06,0,0,0,0,0,0,0,0,0,2000,0,0,0,25000,23000,2000,2000
059901,滬深2X元大9C購07,0,0,0,0,0,0,0,0,0,2000,0,0,0,4000,2000,2000,2000
06274P,臺股指凱基97售06,0,0,0,0,0,0,0,0,0,2000,0,0,0,2000,0,2000,2000
06300P,緯穎元大97售04  ,0,0,0,0,0,0,0,0,0,2000,0,0,0,2000,0,2000,2000
06644P,亞德客元大98售03,0,0,0,0,0,0,0,0,0,2000,0,0,0,2000,0,2000,2000
06645P,上銀元大98售05  ,0,0,0,0,0,0,0,0,0,2000,0,0,0,2000,0,2000,2000
06582P,可成凱基98售06  ,0,0,0,0,0,0,0,0,0,2000,0,0,0,2000,0,2000,2000
06711P,臺股指台新99售08,0,0,0,0,0,0,0,0,0,2000,0,0,0,2000,0,2000,2000
07050P,宏達電中信9B售01,0,0,0,0,0,0,0,0,0,2000,0,0,0,2000,0,2000,2000
06888P,日月光元大98售02,0,0,0,0,0,0,0,0,0,2000,0,0,0,2000,0,2000,2000
06959P,鴻海凱基9A售02  ,0,0,0,0,0,0,0,0,0,2000,0,0,0,24000,22000,2000,2000
07032P,聯發科統一9C售02,0,0,0,0,0,0,0,0,0,2000,0,0,0,2000,0,2000,2000
061139,玉晶光統一9C購02,0,0,0,0,0,0,0,0,0,2000,0,0,0,2000,0,2000,2000
060978,國巨元大9A購13  ,0,0,0,0,0,0,0,0,0,2000,0,0,0,140000,138000,2000,2000
050760,矽力元富94購03  ,0,0,0,0,0,0,0,0,0,2000,0,0,0,2000,0,2000,2000
051286,國巨統一97購01  ,0,0,0,0,0,0,0,0,0,2000,0,0,0,330000,328000,2000,2000
052334,大成鋼日盛95購01,0,0,0,0,0,0,0,0,0,2000,0,0,0,2000,0,2000,2000
052417,聯發科兆豐9B購01,0,0,0,0,0,0,0,0,0,2000,0,0,0,12000,10000,2000,2000
052520,南亞科元大95購06,0,0,0,0,0,0,0,0,0,2000,0,0,0,2000,0,2000,2000
050150,國巨群益95購01  ,0,0,0,0,0,0,0,0,0,2000,0,0,0,2000,0,2000,2000
052570,華新科凱基96購06,0,0,0,0,0,0,0,0,0,2000,0,0,0,2000,0,2000,2000
049820,世紀鋼元大96購03,0,0,0,0,0,0,0,0,0,2000,0,0,0,31000,29000,2000,2000
051508,元黃金中信97購01,0,0,0,0,0,0,0,0,0,2000,0,0,0,2000,0,2000,2000
055018,緯穎元富97購02  ,0,0,0,0,0,0,0,0,0,2000,0,0,0,6000,4000,2000,2000
051899,欣興國泰97購01  ,0,0,0,0,0,0,0,0,0,2000,0,0,0,2000,0,2000,2000
051954,矽力元富95購04  ,0,0,0,0,0,0,0,0,0,2000,0,0,0,2000,0,2000,2000
051950,旺宏元富95購02  ,0,0,0,0,0,0,0,0,0,2000,0,0,0,2000,0,2000,2000
04230P,臺股指中信95售06,0,0,0,0,0,0,0,0,0,2000,0,0,0,2000,0,2000,2000
051623,和碩凱基96購02  ,0,0,0,0,0,0,0,0,0,2000,0,0,0,2000,0,2000,2000
051653,南電永豐95購02  ,0,0,0,0,0,0,0,0,0,2000,0,0,0,2000,0,2000,2000
049156,緯穎元大96購01  ,0,0,0,0,0,0,0,0,0,2000,0,0,0,2000,0,2000,2000
03425B,臺股指元大9A熊01,0,0,0,0,0,0,0,0,0,2000,0,0,0,2000,0,2000,2000
048788,華新科元大95購02,0,0,0,0,0,0,0,0,0,2000,0,0,0,32000,30000,2000,2000
047905,元油反元大96購04,0,0,0,0,0,0,0,0,0,2000,0,0,0,2000,0,2000,2000
048058,大立光國泰95購01,0,0,0,0,0,0,0,0,0,2000,0,0,0,2000,0,2000,2000
05304P,國巨國泰97售02  ,0,0,0,0,0,0,0,0,0,2000,0,0,0,12000,10000,2000,2000
054159,T50正2凱基99購01,0,0,0,0,0,0,0,0,0,2000,0,0,0,2000,0,2000,2000
054117,宏全康和96購01  ,0,0,0,0,0,0,0,0,0,2000,0,0,0,2000,0,2000,2000
052867,晶技凱基96購01  ,0,0,0,0,0,0,0,0,0,2000,0,0,0,20000,18000,2000,2000
057876,隆達元大98購01  ,0,0,0,0,0,0,0,0,0,2000,0,0,0,32000,30000,2000,2000
054519,禾伸堂元大97購02,0,0,0,0,0,0,0,0,0,2000,0,0,0,2000,0,2000,2000
057589,超眾國票9A購01  ,0,0,0,0,0,0,0,0,0,2000,0,0,0,15000,13000,2000,2000
053687,智邦元大96購02  ,0,0,0,0,0,0,0,0,0,2000,0,0,0,6000,4000,2000,2000
053631,欣興兆豐97購01  ,0,0,0,0,0,0,0,0,0,2000,0,0,0,38000,36000,2000,2000
05279P,上銀元大95售02  ,0,0,0,0,0,0,0,0,0,2000,0,0,0,2000,0,2000,2000
052753,電子類元大96購02,0,0,0,0,0,0,0,0,0,2000,0,0,0,2000,0,2000,2000
05273P,國巨群益95售02  ,0,0,0,0,0,0,0,0,0,2000,0,0,0,2000,0,2000,2000
053174,同欣電群益98購02,0,0,0,0,0,0,0,0,0,2000,0,0,0,2000,0,2000,2000
053251,世紀鋼國票97購02,0,0,0,0,0,0,0,0,0,2000,0,0,0,2000,0,2000,2000
053487,台泥兆豐97購01  ,0,0,0,0,0,0,0,0,0,2000,0,0,0,7000,5000,2000,2000
053417,上銀永豐96購02  ,0,0,0,0,0,0,0,0,0,2000,0,0,0,2000,0,2000,2000
055362,GIS凱基97購03   ,0,0,0,0,0,0,0,0,0,2000,0,0,0,2000,0,2000,2000
05539P,鎧勝永豐96售01  ,0,0,0,0,0,0,0,0,0,2000,0,0,0,2000,0,2000,2000
055320,建準國票98購01  ,0,0,0,0,0,0,0,0,0,2000,0,0,0,40000,38000,2000,2000
058089,聯發科元大98購15,0,0,0,0,0,0,0,0,0,2000,0,0,0,2000,0,2000,2000
058290,南電國票9A購01  ,0,0,0,0,0,0,0,0,0,2000,0,0,0,21000,19000,2000,2000
058304,鴻海元大99購12  ,0,0,0,0,0,0,0,0,0,2000,0,0,0,2000,0,2000,2000
058358,技嘉凱基9A購01  ,0,0,0,0,0,0,0,0,0,2000,0,0,0,2000,0,2000,2000
056213,建準國票98購02  ,0,0,0,0,0,0,0,0,0,2000,0,0,0,21000,19000,2000,2000
056206,泰鼎永豐97購01  ,0,0,0,0,0,0,0,0,0,2000,0,0,0,2000,0,2000,2000
05803P,臺股指兆豐96售03,0,0,0,0,0,0,0,0,0,2000,0,0,0,2000,0,2000,2000
057994,技嘉中信98購01  ,0,0,0,0,0,0,0,0,0,2000,0,0,0,2000,0,2000,2000
059069,臺指反元大9C購01,0,0,0,0,0,0,0,0,0,2000,0,0,0,5000,3000,2000,2000
059136,臺股指群益99購11,0,0,0,0,0,0,0,0,0,2000,0,0,0,2000,0,2000,2000
059241,旺宏凱基99購07  ,0,0,0,0,0,0,0,0,0,2000,0,0,0,2000,0,2000,2000
059310,元石油元大99購03,0,0,0,0,0,0,0,0,0,2000,0,0,0,2000,0,2000,2000
057434,國巨國票99購03  ,0,0,0,0,0,0,0,0,0,2000,0,0,0,2000,0,2000,2000
057386,聯發科永豐98購04,0,0,0,0,0,0,0,0,0,2000,0,0,0,34000,32000,2000,2000
057525,光磊元大99購01  ,0,0,0,0,0,0,0,0,0,2000,0,0,0,2000,0,2000,2000
058878,旭富國泰9B購01  ,0,0,0,0,0,0,0,0,0,2000,0,0,0,67000,65000,2000,2000
056378,欣興元富98購01  ,0,0,0,0,0,0,0,0,0,2000,0,0,0,2000,0,2000,2000
057173,南亞科元大98購04,0,0,0,0,0,0,0,0,0,2000,0,0,0,52000,50000,2000,2000
057224,和碩日盛9A購01  ,0,0,0,0,0,0,0,0,0,2000,0,0,0,2000,0,2000,2000
056787,健鼎群益98購01  ,0,0,0,0,0,0,0,0,0,2000,0,0,0,2000,0,2000,2000
056989,鴻海兆豐98購02  ,0,0,0,0,0,0,0,0,0,2000,0,0,0,2000,0,2000,2000
056576,晶技元大99購02  ,0,0,0,0,0,0,0,0,0,2000,0,0,0,2000,0,2000,2000
8480,泰昇-KY         ,5000,2000,3000,0,0,0,0,0,0,-1000,0,1000,-1000,0,0,0,2000
8482,商億-KY         ,3000,1000,2000,0,0,0,0,0,0,0,0,0,0,0,0,0,2000
910322,康師傅-DR       ,2000,0,2000,0,0,0,0,0,0,0,0,0,0,0,0,0,2000
8374,羅昇            ,2000,0,2000,0,0,0,0,0,0,0,0,0,0,0,0,0,2000
6491,晶碩            ,27000,25000,2000,0,0,0,0,0,0,0,0,0,0,0,0,0,2000
2936,客思達-KY       ,2000,0,2000,0,0,0,0,0,0,0,0,0,0,0,0,0,2000
4571,鈞興-KY         ,5000,0,5000,0,0,0,0,0,0,-3000,0,3000,-3000,0,0,0,2000
4720,德淵            ,65000,63000,2000,0,0,0,0,0,0,0,0,0,0,0,0,0,2000
4916,事欣科          ,34000,32000,2000,0,0,0,0,0,0,0,0,0,0,0,0,0,2000
5525,順天            ,5000,3000,2000,0,0,0,0,0,0,0,0,0,0,0,0,0,2000
2528,皇普            ,2000,1000,1000,0,0,0,0,0,0,1000,1000,0,1000,0,0,0,2000
2002A,中鋼特          ,0,0,0,0,0,0,0,0,0,2000,2000,0,2000,0,0,0,2000
07723P,臺股指凱基9A售15,0,0,0,0,0,0,0,0,0,2000,0,0,0,2000,0,2000,2000
07693P,群創元大9B售10  ,0,0,0,0,0,0,0,0,0,2000,0,0,0,12000,10000,2000,2000
1568,倉佑            ,3000,1000,2000,0,0,0,0,0,0,0,0,0,0,0,0,0,2000
1452,宏益            ,14000,12000,2000,0,0,0,0,0,0,0,0,0,0,0,0,0,2000
1432,大魯閣          ,2000,0,2000,0,0,0,0,0,0,0,0,0,0,0,0,0,2000
1454,台富            ,6000,4000,2000,0,0,0,0,0,0,0,0,0,0,0,0,0,2000
07437P,臺股指麥證9A售04,0,0,0,5000,3000,2000,0,0,0,2000,0,0,0,5000,3000,2000,2000
07420P,可成元大99售07  ,0,0,0,0,0,0,0,0,0,2000,0,0,0,60000,58000,2000,2000
07271P,台灣50元大9C售04,0,0,0,0,0,0,0,0,0,2000,0,0,0,2000,0,2000,2000
07150P,和碩元大99售01  ,0,0,0,0,0,0,0,0,0,2000,0,0,0,2000,0,2000,2000
07248P,可成凱基99售06  ,0,0,0,0,0,0,0,0,0,2000,0,0,0,2000,0,2000,2000
07223P,鴻海元大99售29  ,0,0,0,0,0,0,0,0,0,2000,0,0,0,103000,101000,2000,2000
061000,旺宏兆豐9A購02  ,0,0,0,0,0,0,0,0,0,1000,0,0,0,1000,0,1000,1000
060831,T50反1國票9B購03,0,0,0,0,0,0,0,0,0,1000,0,0,0,1000,0,1000,1000
060783,亞德客富邦9B購01,0,0,0,0,0,0,0,0,0,1000,0,0,0,117000,116000,1000,1000
061072,南電凱基9B購01  ,0,0,0,0,0,0,0,0,0,1000,0,0,0,1000,0,1000,1000
061366,台勝科國票9A購01,0,0,0,0,0,0,0,0,0,1000,0,0,0,13000,12000,1000,1000
06964P,臺股指凱基9B售01,0,0,0,0,0,0,0,0,0,1000,0,0,0,1000,0,1000,1000
06901P,亞德客凱基98售02,0,0,0,0,0,0,0,0,0,1000,0,0,0,1000,0,1000,1000
07085P,超眾元富9C售01  ,0,0,0,0,0,0,0,0,0,1000,0,0,0,30000,29000,1000,1000
07088P,訊芯永豐99售02  ,0,0,0,0,0,0,0,0,0,1000,0,0,0,1000,0,1000,1000
06697P,台積電國票99售05,0,0,0,0,0,0,0,0,0,1000,0,0,0,1000,0,1000,1000
06701P,臺股指統一99售06,0,0,0,0,0,0,0,0,0,1000,0,0,0,41000,40000,1000,1000
06760P,台積電元大98售18,0,0,0,0,0,0,0,0,0,1000,0,0,0,17000,16000,1000,1000
06825P,臺股指國票98售01,0,0,0,0,0,0,0,0,0,1000,0,0,0,1000,0,1000,1000
06833P,矽力群益99售01  ,0,0,0,0,0,0,0,0,0,1000,0,0,0,11000,10000,1000,1000
06840P,臺股指統一98售04,0,0,0,0,0,0,0,0,0,1000,0,0,0,51000,50000,1000,1000
06787P,臺股指元大98售04,0,0,0,0,0,0,0,0,0,1000,0,0,0,3000,2000,1000,1000
06584P,欣興凱基98售03  ,0,0,0,0,0,0,0,0,0,1000,0,0,0,5000,4000,1000,1000
06604P,聯發科元富02售02,0,0,0,0,0,0,0,0,0,1000,0,0,0,1000,0,1000,1000
06286P,世芯國票97售02  ,0,0,0,0,0,0,0,0,0,1000,0,0,0,1000,0,1000,1000
06181P,國巨中信97售02  ,0,0,0,0,0,0,0,0,0,1000,0,0,0,1000,0,1000,1000
06235P,國巨元大97售12  ,0,0,0,0,0,0,0,0,0,1000,0,0,0,1000,0,1000,1000
06399P,台表科凱基97售05,0,0,0,0,0,0,0,0,0,1000,0,0,0,1000,0,1000,1000
06485P,玉晶光群益9A售02,0,0,0,0,0,0,0,0,0,1000,0,0,0,1201000,1200000,1000,1000
059859,國巨群益9A購03  ,0,0,0,0,0,0,0,0,0,1000,0,0,0,1000,0,1000,1000
059860,台積電群益9A購02,0,0,0,0,0,0,0,0,0,1000,0,0,0,51000,50000,1000,1000
059811,高股息凱基99購02,0,0,0,0,0,0,0,0,0,1000,0,0,0,2000,1000,1000,1000
060017,全新康和99購01  ,0,0,0,0,0,0,0,0,0,1000,0,0,0,11000,10000,1000,1000
060003,上証2X群益9B購02,0,0,0,0,0,0,0,0,0,1000,0,0,0,1000,0,1000,1000
059451,國巨永豐99購05  ,0,0,0,0,0,0,0,0,0,1000,0,0,0,11000,10000,1000,1000
05954P,旺宏國票97售03  ,0,0,0,0,0,0,0,0,0,1000,0,0,0,10000,9000,1000,1000
05959P,聯發科國票98售01,0,0,0,0,0,0,0,0,0,1000,0,0,0,1000,0,1000,1000
059608,聯發科富邦9B購04,0,0,0,0,0,0,0,0,0,1000,0,0,0,1000,0,1000,1000
059605,臺股指元大9A購42,0,0,0,0,0,0,0,0,0,1000,0,0,0,1000,0,1000,1000
059657,華通元大99購09  ,0,0,0,0,0,0,0,0,0,1000,0,0,0,1000,0,1000,1000
060661,台積電凱基9A購18,0,0,0,0,0,0,0,0,0,1000,0,0,0,42000,41000,1000,1000
060689,臺股指元大9A購43,0,0,0,0,0,0,0,0,0,1000,0,0,0,4000,3000,1000,1000
060170,世紀鋼永豐9A購01,0,0,0,0,0,0,0,0,0,1000,0,0,0,35000,34000,1000,1000
053451,致新凱基96購02  ,0,0,0,0,0,0,0,0,0,1000,0,0,0,10000,9000,1000,1000
05347P,滬深2X元富9B售02,0,0,0,0,0,0,0,0,0,1000,0,0,0,1000,0,1000,1000
053504,祥碩兆豐96購01  ,0,0,0,0,0,0,0,0,0,1000,0,0,0,1000,0,1000,1000
052740,聯發科元大96購07,0,0,0,0,0,0,0,0,0,1000,0,0,0,1000,0,1000,1000
052755,滬深2X群益9A購01,0,0,0,0,0,0,0,0,0,1000,0,0,0,1000,0,1000,1000
052729,國巨國泰97購03  ,0,0,0,0,0,0,0,0,0,1000,0,0,0,1000,0,1000,1000
052806,玉晶光元大98購04,0,0,0,0,0,0,0,0,0,1000,0,0,0,1000,0,1000,1000
054046,義隆元大96購02  ,0,0,0,0,0,0,0,0,0,1000,0,0,0,1000,0,1000,1000
054032,上銀中信96購01  ,0,0,0,0,0,0,0,0,0,1000,0,0,0,1000,0,1000,1000
053652,友達凱基98購04  ,0,0,0,0,0,0,0,0,0,1000,0,0,0,1000,0,1000,1000
053597,牧德元大99購01  ,0,0,0,0,0,0,0,0,0,1000,0,0,0,1000,0,1000,1000
053102,祥碩元富96購01  ,0,0,0,0,0,0,0,0,0,1000,0,0,0,1000,0,1000,1000
053112,中磊兆豐97購01  ,0,0,0,0,0,0,0,0,0,1000,0,0,0,102000,101000,1000,1000
054904,興勤康和97購01  ,0,0,0,0,0,0,0,0,0,1000,0,0,0,46000,45000,1000,1000
054914,億光凱基98購01  ,0,0,0,0,0,0,0,0,0,1000,0,0,0,1000,0,1000,1000
054951,大毅元大97購01  ,0,0,0,0,0,0,0,0,0,1000,0,0,0,1000,0,1000,1000
055177,宏達電統一99購01,0,0,0,0,0,0,0,0,0,1000,0,0,0,6000,5000,1000,1000
054578,世芯元大99購01  ,0,0,0,0,0,0,0,0,0,1000,0,0,0,1000,0,1000,1000
055215,智邦凱基98購02  ,0,0,0,0,0,0,0,0,0,1000,0,0,0,1000,0,1000,1000
057909,台光電兆豐98購01,0,0,0,0,0,0,0,0,0,1000,0,0,0,1000,0,1000,1000
057674,台郡元大99購03  ,0,0,0,0,0,0,0,0,0,1000,0,0,0,259000,258000,1000,1000
057776,京元電群益98購02,0,0,0,0,0,0,0,0,0,1000,0,0,0,1000,0,1000,1000
057785,智邦國票99購02  ,0,0,0,0,0,0,0,0,0,1000,0,0,0,1000,0,1000,1000
054157,國巨亞東96購01  ,0,0,0,0,0,0,0,0,0,1000,0,0,0,1000,0,1000,1000
054104,T50反1凱基9A購02,0,0,0,0,0,0,0,0,0,1000,0,0,0,1000,0,1000,1000
054210,台光電國票97購03,0,0,0,0,0,0,0,0,0,1000,0,0,0,1000,0,1000,1000
05298P,上銀元大95售03  ,0,0,0,0,0,0,0,0,0,1000,0,0,0,1000,0,1000,1000
054423,華新富邦96購01  ,0,0,0,0,0,0,0,0,0,1000,0,0,0,1000,0,1000,1000
047780,友達中信96購01  ,0,0,0,0,0,0,0,0,0,1000,0,0,0,1000,0,1000,1000
048505,滬深2X群益99購03,0,0,0,0,0,0,0,0,0,1000,0,0,0,1000,0,1000,1000
048575,旺宏國泰94購04  ,0,0,0,0,0,0,0,0,0,1000,0,0,0,1000,0,1000,1000
03428B,臺股指凱基97熊18,0,0,0,0,0,0,0,0,0,1000,0,0,0,1000,0,1000,1000
03422B,臺股指凱基96熊28,0,0,0,0,0,0,0,0,0,1000,0,0,0,1000,0,1000,1000
03111P,元油2X富邦97售01,0,0,0,0,0,0,0,0,0,1000,0,0,0,1000,0,1000,1000
049217,智邦國票95購01  ,0,0,0,0,0,0,0,0,0,1000,0,0,0,1000,0,1000,1000
00731,FH富時高息低波  ,0,0,0,0,0,0,0,0,0,1000,0,0,0,6000,5000,1000,1000
00707R,元大S&P日圓反1  ,0,0,0,0,0,0,0,0,0,1000,0,0,0,2000,1000,1000,1000
020007,凱基臺灣500N    ,0,0,0,0,0,0,0,0,0,1000,0,0,0,1000,0,1000,1000
00661,元大日經225     ,0,0,0,0,0,0,0,0,0,1000,0,0,0,1000,0,1000,1000
00657,國泰日經225     ,0,0,0,0,0,0,0,0,0,1000,0,0,0,185000,184000,1000,1000
051736,旺宏國票96購01  ,0,0,0,0,0,0,0,0,0,1000,0,0,0,2000,1000,1000,1000
046934,智邦元富96購01  ,0,0,0,0,0,0,0,0,0,1000,0,0,0,1000,0,1000,1000
042928,台積電中信95購01,0,0,0,0,0,0,0,0,0,1000,0,0,0,1000,0,1000,1000
04427P,滬深2X元大97售02,0,0,0,0,0,0,0,0,0,1000,0,0,0,1000,0,1000,1000
04518P,高鐵群益95售01  ,0,0,0,0,0,0,0,0,0,1000,0,0,0,1000,0,1000,1000
051953,矽力元富95購03  ,0,0,0,0,0,0,0,0,0,1000,0,0,0,1000,0,1000,1000
051948,滬深2X元富9B購01,0,0,0,0,0,0,0,0,0,1000,0,0,0,1000,0,1000,1000
052032,臺股指群益95購05,0,0,0,0,0,0,0,0,0,1000,0,0,0,1000,0,1000,1000
052191,超眾群益96購01  ,0,0,0,0,0,0,0,0,0,1000,0,0,0,6000,5000,1000,1000
052202,矽力統一96購01  ,0,0,0,0,0,0,0,0,0,1000,0,0,0,1000,0,1000,1000
053805,奇鋐凱基98購02  ,0,0,0,0,0,0,0,0,0,1000,0,0,0,6000,5000,1000,1000
053817,華新科群益97購02,0,0,0,0,0,0,0,0,0,1000,0,0,0,1000,0,1000,1000
055085,大毅國票97購01  ,0,0,0,0,0,0,0,0,0,1000,0,0,0,3000,2000,1000,1000
055089,金寶群益98購01  ,0,0,0,0,0,0,0,0,0,1000,0,0,0,1000,0,1000,1000
055039,神達富邦99購01  ,0,0,0,0,0,0,0,0,0,1000,0,0,0,1000,0,1000,1000
053968,華邦電元大97購01,0,0,0,0,0,0,0,0,0,1000,0,0,0,1000,0,1000,1000
053976,亞光元大96購02  ,0,0,0,0,0,0,0,0,0,1000,0,0,0,1000,0,1000,1000
053941,國巨國泰96購05  ,0,0,0,0,0,0,0,0,0,1000,0,0,0,1000,0,1000,1000
051534,景碩國票97購01  ,0,0,0,0,0,0,0,0,0,1000,0,0,0,1000,0,1000,1000
051577,台積電元大97購03,0,0,0,0,0,0,0,0,0,1000,0,0,0,1000,0,1000,1000
05159P,聯發科永豐95售04,0,0,0,0,0,0,0,0,0,1000,0,0,0,1000,0,1000,1000
05373P,臺股指中信95售11,0,0,0,0,0,0,0,0,0,1000,0,0,0,1000,0,1000,1000
049803,華新科元大95購07,0,0,0,0,0,0,0,0,0,1000,0,0,0,1000,0,1000,1000
05014P,臺股指元大95售05,0,0,0,0,0,0,0,0,0,1000,0,0,0,1000,0,1000,1000
050102,鴻海富邦95購04  ,0,0,0,0,0,0,0,0,0,1000,0,0,0,1000,0,1000,1000
050344,鴻海元富96購01  ,0,0,0,0,0,0,0,0,0,1000,0,0,0,1000,0,1000,1000
052456,滬深2X元富9B購03,0,0,0,0,0,0,0,0,0,1000,0,0,0,1000,0,1000,1000
051254,健策元大96購04  ,0,0,0,0,0,0,0,0,0,1000,0,0,0,2000,1000,1000,1000
050905,臺股指元大95購12,0,0,0,0,0,0,0,0,0,1000,0,0,0,1000,0,1000,1000
05091P,台積電元大95售11,0,0,0,0,0,0,0,0,0,1000,0,0,0,1000,0,1000,1000
050687,上銀日盛94購01  ,0,0,0,0,0,0,0,0,0,1000,0,0,0,1000,0,1000,1000
050714,深中小群益98購01,0,0,0,0,0,0,0,0,0,1000,0,0,0,1000,0,1000,1000
056565,欣興群益98購03  ,0,0,0,0,0,0,0,0,0,1000,0,0,0,1000,0,1000,1000
056721,台灣50永昌9A購01,0,0,0,0,0,0,0,0,0,1000,0,0,0,1000,0,1000,1000
056678,力成元富98購01  ,0,0,0,0,0,0,0,0,0,1000,0,0,0,1000,0,1000,1000
056825,深中小富邦9B購01,0,0,0,0,0,0,0,0,0,1000,0,0,0,1000,0,1000,1000
05718P,國巨元大96售09  ,0,0,0,0,0,0,0,0,0,1000,0,0,0,21000,20000,1000,1000
056363,華新科元大99購04,0,0,0,0,0,0,0,0,0,1000,0,0,0,1000,0,1000,1000
056011,矽力中信99購01  ,0,0,0,0,0,0,0,0,0,1000,0,0,0,1000,0,1000,1000
057241,超眾凱基99購02  ,0,0,0,0,0,0,0,0,0,1000,0,0,0,1000,0,1000,1000
056506,晶豪科永豐98購02,0,0,0,0,0,0,0,0,0,1000,0,0,0,83000,82000,1000,1000
055551,致茂凱基98購01  ,0,0,0,0,0,0,0,0,0,1000,0,0,0,2000,1000,1000,1000
056519,創意國票99購01  ,0,0,0,0,0,0,0,0,0,1000,0,0,0,16000,15000,1000,1000
058875,台表科國票9A購02,0,0,0,0,0,0,0,0,0,1000,0,0,0,17000,16000,1000,1000
058876,南電國票9A購02  ,0,0,0,0,0,0,0,0,0,1000,0,0,0,1000,0,1000,1000
05928P,華邦電康和96售01,0,0,0,0,0,0,0,0,0,1000,0,0,0,1000,0,1000,1000
059229,臺股指元大99購22,0,0,0,0,0,0,0,0,0,1000,0,0,0,1000,0,1000,1000
059221,聯發科元大99購21,0,0,0,0,0,0,0,0,0,1000,0,0,0,93000,92000,1000,1000
057088,上銀元富98購01  ,0,0,0,0,0,0,0,0,0,1000,0,0,0,1000,0,1000,1000
057121,立積康和98購01  ,0,0,0,0,0,0,0,0,0,1000,0,0,0,1000,0,1000,1000
057003,立積國票98購01  ,0,0,0,0,0,0,0,0,0,1000,0,0,0,47000,46000,1000,1000
058323,泰鼎永豐9A購01  ,0,0,0,0,0,0,0,0,0,1000,0,0,0,1000,0,1000,1000
058419,聯發科麥證99購02,0,0,0,1000,40000,-39000,0,0,0,1000,0,0,0,41000,40000,1000,1000
058427,大毅元富99購01  ,0,0,0,0,0,0,0,0,0,1000,0,0,0,1000,0,1000,1000
058408,華通兆豐99購02  ,0,0,0,0,0,0,0,0,0,1000,0,0,0,1000,0,1000,1000
058440,玉晶光統一99購02,0,0,0,0,0,0,0,0,0,1000,0,0,0,49000,48000,1000,1000
058286,道瓊指國票9B購01,0,0,0,0,0,0,0,0,0,1000,0,0,0,1000,0,1000,1000
058235,大立光元大99購08,0,0,0,0,0,0,0,0,0,1000,0,0,0,1000,0,1000,1000
058097,台灣50國泰99購01,0,0,0,0,0,0,0,0,0,1000,0,0,0,1000,0,1000,1000
055322,欣興國票97購06  ,0,0,0,0,0,0,0,0,0,1000,0,0,0,1000,0,1000,1000
055319,國巨國票98購03  ,0,0,0,0,0,0,0,0,0,1000,0,0,0,1000,0,1000,1000
055285,華新科元大99購03,0,0,0,0,0,0,0,0,0,1000,0,0,0,1000,0,1000,1000
055243,國巨統一97購04  ,0,0,0,0,0,0,0,0,0,1000,0,0,0,1000,0,1000,1000
05859P,台表科國票97售04,0,0,0,0,0,0,0,0,0,1000,0,0,0,1000,0,1000,1000
058649,健策永豐99購01  ,0,0,0,0,0,0,0,0,0,1000,0,0,0,1000,0,1000,1000
058654,鴻海中信03購01  ,0,0,0,0,0,0,0,0,0,1000,0,0,0,7000,6000,1000,1000
058670,鴻海群益9A購03  ,0,0,0,0,0,0,0,0,0,1000,0,0,0,1000,0,1000,1000
058706,聯鈞元大9C購01  ,0,0,0,0,0,0,0,0,0,1000,0,0,0,1000,0,1000,1000
057992,大立光日盛98購01,0,0,0,0,0,0,0,0,0,1000,0,0,0,1000,0,1000,1000
055557,華新科凱基97購01,0,0,0,0,0,0,0,0,0,1000,0,0,0,1000,0,1000,1000
055852,聯鈞元大98購01  ,0,0,0,0,0,0,0,0,0,1000,0,0,0,1000,0,1000,1000
055878,泰碩元富97購02  ,0,0,0,0,0,0,0,0,0,1000,0,0,0,1000,0,1000,1000
055986,祥碩元富97購01  ,0,0,0,0,0,0,0,0,0,1000,0,0,0,1000,0,1000,1000
05580P,美律凱基96售03  ,0,0,0,0,0,0,0,0,0,1000,0,0,0,1000,0,1000,1000
055738,玉山金元富97購01,0,0,0,0,0,0,0,0,0,1000,0,0,0,5000,4000,1000,1000
07227P,聯發科元富99售05,0,0,0,0,0,0,0,0,0,1000,0,0,0,1000,0,1000,1000
07216P,大立光凱基99售08,0,0,0,0,0,0,0,0,0,1000,0,0,0,1000,0,1000,1000
07176P,臺股指凱基99售18,0,0,0,0,0,0,0,0,0,1000,0,0,0,1000,0,1000,1000
07282P,聯發科凱基99售17,0,0,0,0,0,0,0,0,0,1000,0,0,0,1000,0,1000,1000
07270P,台灣50元大01售09,0,0,0,0,0,0,0,0,0,1000,0,0,0,14000,13000,1000,1000
07325P,台積電元大99售41,0,0,0,0,0,0,0,0,0,1000,0,0,0,1000,0,1000,1000
07429P,臺股指國票9A售01,0,0,0,0,0,0,0,0,0,1000,0,0,0,1000,0,1000,1000
1441,大東            ,1000,0,1000,0,0,0,0,0,0,0,0,0,0,0,0,0,1000
1537,廣隆            ,27000,26000,1000,0,0,0,0,0,0,0,0,0,0,0,0,0,1000
1516,川飛            ,1000,0,1000,0,0,0,0,0,0,0,0,0,0,0,0,0,1000
1618,合機            ,2000,1000,1000,0,0,0,0,0,0,0,0,0,0,0,0,0,1000
07670P,茂林元大9A售02  ,0,0,0,0,0,0,0,0,0,1000,0,0,0,121000,120000,1000,1000
08525P,台灣50凱基96售02,0,0,0,0,0,0,0,0,0,1000,0,0,0,1000,0,1000,1000
2038,海光            ,1000,0,1000,0,0,0,0,0,0,0,0,0,0,0,0,0,1000
2748,雲品            ,3000,2000,1000,0,0,0,0,0,0,0,0,0,0,0,0,0,1000
2548,華固            ,338000,374000,-36000,0,0,0,0,0,0,37000,37000,0,37000,0,0,0,1000
2712,遠雄來          ,1000,0,1000,0,0,0,0,0,0,0,0,0,0,0,0,0,1000
5906,台南-KY         ,2000,1000,1000,0,0,0,0,0,0,0,0,0,0,0,0,0,1000
6201,亞弘電          ,1000,0,1000,0,0,0,0,0,0,0,0,0,0,0,0,0,1000
4722,國精化          ,25000,24000,1000,0,0,0,0,0,0,0,0,0,0,0,0,0,1000
4557,永新-KY         ,1000,0,1000,0,0,0,0,0,0,0,0,0,0,0,0,0,1000
4764,雙鍵            ,2000,1000,1000,0,0,0,0,0,0,0,0,0,0,0,0,0,1000
2908,特力            ,28000,27000,1000,0,0,0,0,0,0,0,0,0,0,0,0,0,1000
2911,麗嬰房          ,1000,0,1000,0,0,0,0,0,0,0,0,0,0,0,0,0,1000
3593,力銘            ,1000,0,1000,0,0,0,0,0,0,0,0,0,0,0,0,0,1000
6573,虹揚-KY         ,1000,0,1000,0,0,0,0,0,0,0,0,0,0,0,0,0,1000
9905,大華            ,5000,4000,1000,0,0,0,0,0,0,0,0,0,0,0,0,0,1000
9906,欣巴巴          ,1000,0,1000,0,0,0,0,0,0,0,0,0,0,0,0,0,1000
9937,全國            ,5000,4000,1000,0,0,0,0,0,0,0,0,0,0,0,0,0,1000
060221,大立光凱基9A購07,0,0,0,0,0,0,0,0,0,0,0,0,0,12000,12000,0,0
06014P,聯發科富邦97售02,0,0,0,0,0,0,0,0,0,0,0,0,0,10000,10000,0,0
060161,牧德永豐9A購02  ,0,0,0,0,0,0,0,0,0,0,0,0,0,11000,11000,0,0
060101,大立光元大99購31,0,0,0,0,0,0,0,0,0,0,0,0,0,1000,1000,0,0
060400,南電國票9A購03  ,0,0,0,0,0,0,0,0,0,0,0,0,0,20000,20000,0,0
060369,滬深2X元富01購01,0,0,0,0,0,0,0,0,0,0,0,0,0,12000,12000,0,0
060352,滬深2X元富9A購02,0,0,0,0,0,0,0,0,0,0,0,0,0,12000,12000,0,0
060338,鴻海統一9C購02  ,0,0,0,0,0,0,0,0,0,0,0,0,0,10000,10000,0,0
060367,緯穎元富9A購02  ,0,0,0,0,0,0,0,0,0,0,0,0,0,10000,10000,0,0
060646,南電永豐9A購01  ,0,0,0,0,0,0,0,0,0,0,0,0,0,35000,35000,0,0
060600,台積電凱基9C購01,0,0,0,0,0,0,0,0,0,0,0,0,0,3000,3000,0,0
060590,台積電台新9C購02,0,0,0,0,0,0,0,0,0,0,0,0,0,1000,1000,0,0
060526,台積電中信9A購02,0,0,0,0,0,0,0,0,0,0,0,0,0,1000,1000,0,0
06050P,玉晶光國票98售01,0,0,0,0,0,0,0,0,0,0,0,0,0,406000,406000,0,0
060461,鴻海元大9A購09  ,0,0,0,0,0,0,0,0,0,0,0,0,0,64000,64000,0,0
059745,欣興元富99購04  ,0,0,0,0,0,0,0,0,0,0,0,0,0,2000,2000,0,0
059707,健策凱基9A購03  ,0,0,0,0,0,0,0,0,0,0,0,0,0,2000,2000,0,0
059599,健策元大9B購02  ,0,0,0,0,0,0,0,0,0,0,0,0,0,3000,3000,0,0
059590,台積電元大99購39,0,0,0,0,0,0,0,0,0,0,0,0,0,1000,1000,0,0
059573,健策凱基9A購02  ,0,0,0,0,0,0,0,0,0,0,0,0,0,2000,2000,0,0
059642,健策凱基99購04  ,0,0,0,0,0,0,0,0,0,0,0,0,0,2000,2000,0,0
059551,T50正2康和99購02,0,0,0,0,0,0,0,0,0,0,0,0,0,2000,2000,0,0
059538,健策凱基99購03  ,0,0,0,0,0,0,0,0,0,0,0,0,0,4000,4000,0,0
059500,鴻海元富99購11  ,0,0,0,0,0,0,0,0,0,0,0,0,0,13000,13000,0,0
059456,智易永豐99購01  ,0,0,0,0,0,0,0,0,0,0,0,0,0,21000,21000,0,0
059487,聯發科兆豐99購03,0,0,0,0,0,0,0,0,0,0,0,0,0,4000,4000,0,0
059437,京鼎元大99購02  ,0,0,0,0,0,0,0,0,0,0,0,0,0,11000,11000,0,0
059427,國巨元大99購24  ,0,0,0,0,0,0,0,0,0,0,0,0,0,4000,4000,0,0
059428,國巨元大99購25  ,0,0,0,0,0,0,0,0,0,0,0,0,0,1000,1000,0,0
05937P,台積電凱基96售21,0,0,0,0,0,0,0,0,0,0,0,0,0,150000,150000,0,0
05936P,台積電凱基96售20,0,0,0,0,0,0,0,0,0,0,0,0,0,236000,236000,0,0
059376,國巨群益99購09  ,0,0,0,0,0,0,0,0,0,0,0,0,0,600000,600000,0,0
059361,玉晶光永豐99購04,0,0,0,0,0,0,0,0,0,0,0,0,0,3000,3000,0,0
060004,臺指反群益9A購01,0,0,0,0,0,0,0,0,0,0,0,0,0,10000,10000,0,0
060037,鴻海國票99購10  ,0,0,0,0,0,0,0,0,0,0,0,0,0,1000,1000,0,0
059784,台光電元大9A購01,0,0,0,0,0,0,0,0,0,0,0,0,0,9000,9000,0,0
05984P,台積電統一98售01,0,0,0,0,0,0,0,0,0,0,0,0,0,150000,150000,0,0
059883,T50反1國票99購02,0,0,0,0,0,0,0,0,0,0,0,0,0,100000,100000,0,0
06481P,台積電凱基98售12,0,0,0,0,0,0,0,0,0,0,0,0,0,84000,84000,0,0
06468P,華新科統一98售02,0,0,0,0,0,0,0,0,0,0,0,0,0,15000,15000,0,0
06513P,鴻海凱基98售10  ,0,0,0,0,0,0,0,0,0,0,0,0,0,7000,7000,0,0
06545P,致茂元大98售01  ,0,0,0,0,0,0,0,0,0,0,0,0,0,10000,10000,0,0
06443P,台積電凱基99售01,0,0,0,0,0,0,0,0,0,0,0,0,0,130000,130000,0,0
06434P,超眾群益98售02  ,0,0,0,0,0,0,0,0,0,0,0,0,0,25000,25000,0,0
06453P,群創元大9B售02  ,0,0,0,0,0,0,0,0,0,0,0,0,0,10000,10000,0,0
06395P,台積電元大97售29,0,0,0,0,0,0,0,0,0,0,0,0,0,160000,160000,0,0
06373P,聯發科元大97售22,0,0,0,0,0,0,0,0,0,0,0,0,0,190000,190000,0,0
06427P,鴻海元大97售13  ,0,0,0,0,0,0,0,0,0,0,0,0,0,30000,30000,0,0
06236P,台積電元大97售25,0,0,0,0,0,0,0,0,0,0,0,0,0,300000,300000,0,0
06216P,上銀元富97售03  ,0,0,0,0,0,0,0,0,0,0,0,0,0,5000,5000,0,0
06202P,大立光元大98售06,0,0,0,0,0,0,0,0,0,0,0,0,0,40000,40000,0,0
06176P,台積電元大97售22,0,0,0,0,0,0,0,0,0,0,0,0,0,470000,470000,0,0
061583,矽創元大9A購01  ,0,0,0,0,0,0,0,0,0,0,0,0,0,19000,19000,0,0
06296P,燿華元大98售01  ,0,0,0,0,0,0,0,0,0,0,0,0,0,49000,49000,0,0
06298P,聯發科元大97售20,0,0,0,0,0,0,0,0,0,0,0,0,0,20000,20000,0,0
06213P,大立光元大98售07,0,0,0,0,0,0,0,0,0,0,0,0,0,20000,20000,0,0
06369P,台積電凱基97售16,0,0,0,0,0,0,0,0,0,0,0,0,0,170000,170000,0,0
06338P,亞德客統一97售02,0,0,0,0,0,0,0,0,0,0,0,0,0,10000,10000,0,0
06339P,上銀統一97售06  ,0,0,0,0,0,0,0,0,0,0,0,0,0,20000,20000,0,0
06142P,台虹康和97售02  ,0,0,0,0,0,0,0,0,0,0,0,0,0,10000,10000,0,0
061407,鴻海國票9A購07  ,0,0,0,0,0,0,0,0,0,0,0,0,0,12000,12000,0,0
06145P,華新科永豐97售02,0,0,0,0,0,0,0,0,0,0,0,0,0,330000,330000,0,0
061455,京元電凱基9B購01,0,0,0,0,0,0,0,0,0,0,0,0,0,23000,23000,0,0
061484,華通兆豐9B購01  ,0,0,0,0,0,0,0,0,0,0,0,0,0,5000,5000,0,0
06148P,台積電元大97售17,0,0,0,0,0,0,0,0,0,0,0,0,0,220000,220000,0,0
061578,玉晶光元大9A購16,0,0,0,0,0,0,0,0,0,0,0,0,0,4000,4000,0,0
061579,京鼎元大9A購02  ,0,0,0,0,0,0,0,0,0,0,0,0,0,18000,18000,0,0
061526,宏達電凱基9A購04,0,0,0,0,0,0,0,0,0,0,0,0,0,13000,13000,0,0
06588P,台積電元大98售11,0,0,0,0,0,0,0,0,0,0,0,0,0,130000,130000,0,0
06589P,台積電元大98售12,0,0,0,0,0,0,0,0,0,0,0,0,0,90000,90000,0,0
06647P,台積電元大98售13,0,0,0,0,0,0,0,0,0,0,0,0,0,130000,130000,0,0
06643P,大立光兆豐98售01,0,0,0,0,0,0,0,0,0,0,0,0,0,10000,10000,0,0
06658P,台灣50富邦9C售01,0,0,0,0,0,0,0,0,0,0,0,0,0,10000,10000,0,0
06681P,致茂元大98售02  ,0,0,0,0,0,0,0,0,0,0,0,0,0,10000,10000,0,0
06690P,玉晶光群益9A售05,0,0,0,0,0,0,0,0,0,0,0,0,0,100000,100000,0,0
06669P,緯穎凱基98售05  ,0,0,0,0,0,0,0,0,0,0,0,0,0,85000,85000,0,0
06663P,鴻海兆豐98售03  ,0,0,0,0,0,0,0,0,0,0,0,0,0,85000,85000,0,0
06812P,台灣50元富9C售01,0,0,0,0,0,0,0,0,0,0,0,0,0,10000,10000,0,0
06875P,台灣50永昌9A售02,0,0,0,0,0,0,0,0,0,0,0,0,0,130000,130000,0,0
06759P,台積電元大98售17,0,0,0,0,0,0,0,0,0,0,0,0,0,53000,53000,0,0
06767P,台積電永昌99售03,0,0,0,0,0,0,0,0,0,0,0,0,0,50000,50000,0,0
06741P,台積電富邦98售04,0,0,0,0,0,0,0,0,0,0,0,0,0,40000,40000,0,0
06698P,玉晶光國票99售05,0,0,0,0,0,0,0,0,0,0,0,0,0,300000,300000,0,0
06712P,臺股指台新99售09,0,0,0,0,0,0,0,0,0,0,0,0,0,407000,407000,0,0
06714P,台積電元大98售15,0,0,0,0,0,0,0,0,0,0,0,0,0,140000,140000,0,0
06716P,台積電元大9A售02,0,0,0,0,0,0,0,0,0,0,0,0,0,140000,140000,0,0
06723P,台灣50麥證99售01,0,0,0,0,30000,-30000,0,0,0,0,0,0,0,30000,30000,0,0
07077P,緯穎凱基99售01  ,0,0,0,0,0,0,0,0,0,0,0,0,0,200000,200000,0,0
07080P,健策群益9A售01  ,0,0,0,0,0,0,0,0,0,0,0,0,0,79000,79000,0,0
07064P,臺股指元大9A售25,0,0,0,0,0,0,0,0,0,0,0,0,0,381000,381000,0,0
07065P,臺股指元大9A售26,0,0,0,0,0,0,0,0,0,0,0,0,0,1265000,1265000,0,0
06925P,致茂群益9A售02  ,0,0,0,0,0,0,0,0,0,0,0,0,0,10000,10000,0,0
06919P,臺股指日盛98售02,0,0,0,0,0,0,0,0,0,0,0,0,0,9000,9000,0,0
06930P,台積電元大98售19,0,0,0,0,0,0,0,0,0,0,0,0,0,60000,60000,0,0
07002P,鴻海兆豐99售04  ,0,0,0,0,0,0,0,0,0,0,0,0,0,41000,41000,0,0
07024P,臺股指永豐99售02,0,0,0,0,0,0,0,0,0,0,0,0,0,20000,20000,0,0
07016P,聯發科元大99售10,0,0,0,0,0,0,0,0,0,0,0,0,0,2000,2000,0,0
061281,台積電統一9C購05,0,0,0,0,0,0,0,0,0,0,0,0,0,1000,1000,0,0
061291,玉晶光統一01購05,0,0,0,0,0,0,0,0,0,0,0,0,0,5000,5000,0,0
061200,道瓊反元大9A購06,0,0,0,0,0,0,0,0,0,0,0,0,0,20000,20000,0,0
06117P,臺股指日盛97售02,0,0,0,0,0,0,0,0,0,0,0,0,0,100000,100000,0,0
060732,玉晶光群益9C購02,0,0,0,0,0,0,0,0,0,0,0,0,0,147000,147000,0,0
061018,台積電國票9B購05,0,0,0,0,0,0,0,0,0,0,0,0,0,6000,6000,0,0
061019,大毅國票9A購01  ,0,0,0,0,0,0,0,0,0,0,0,0,0,2000,2000,0,0
061023,茂林國泰9B購02  ,0,0,0,0,0,0,0,0,0,0,0,0,0,10000,10000,0,0
050684,台郡元富94購02  ,0,0,0,0,0,0,0,0,0,0,0,0,0,20000,20000,0,0
050630,大立光亞東96購01,0,0,0,0,0,0,0,0,0,0,0,0,0,50000,50000,0,0
050551,大立光凱基95購05,0,0,0,0,0,0,0,0,0,0,0,0,0,49000,49000,0,0
050920,旺宏凱基95購01  ,0,0,0,0,0,0,0,0,0,0,0,0,0,120000,120000,0,0
050893,鴻海元大96購03  ,0,0,0,0,0,0,0,0,0,0,0,0,0,10000,10000,0,0
050880,大立光元富95購03,0,0,0,0,0,0,0,0,0,0,0,0,0,5000,5000,0,0
05088P,大立光富邦99售01,0,0,0,0,0,0,0,0,0,0,0,0,0,10000,10000,0,0
050990,T50反1元大95購01,0,0,0,0,0,0,0,0,0,0,0,0,0,150000,150000,0,0
051283,亞德客統一95購01,0,0,0,0,0,0,0,0,0,0,0,0,0,1000,1000,0,0
051317,亞德客國票96購01,0,0,0,0,0,0,0,0,0,0,0,0,0,4000,4000,0,0
05122P,鴻海永昌96售06  ,0,0,0,0,0,0,0,0,0,0,0,0,0,78000,78000,0,0
052431,茂林永豐95購03  ,0,0,0,0,0,0,0,0,0,0,0,0,0,30000,30000,0,0
05244P,台積電元大95售17,0,0,0,0,0,0,0,0,0,0,0,0,0,190000,190000,0,0
052519,旺宏元大95購05  ,0,0,0,0,0,0,0,0,0,0,0,0,0,10000,10000,0,0
052312,美律富邦96購02  ,0,0,0,0,0,0,0,0,0,0,0,0,0,10000,10000,0,0
052342,茂林凱基96購01  ,0,0,0,0,0,0,0,0,0,0,0,0,0,20000,20000,0,0
050155,華新科群益95購01,0,0,0,0,0,0,0,0,0,0,0,0,0,10000,10000,0,0
052574,茂林凱基96購02  ,0,0,0,0,0,0,0,0,0,0,0,0,0,30000,30000,0,0
052529,力成元大95購03  ,0,0,0,0,0,0,0,0,0,0,0,0,0,100000,100000,0,0
052625,南電亞東97購01  ,0,0,0,0,0,0,0,0,0,0,0,0,0,20000,20000,0,0
052633,國巨凱基96購05  ,0,0,0,0,0,0,0,0,0,0,0,0,0,240000,240000,0,0
05150P,玉晶光第一95售01,0,0,0,0,0,0,0,0,0,0,0,0,0,30000,30000,0,0
051399,玉晶光台新96購01,0,0,0,0,0,0,0,0,0,0,0,0,0,98000,98000,0,0
051400,國巨永豐95購01  ,0,0,0,0,0,0,0,0,0,0,0,0,0,30000,30000,0,0
053922,亞光國票96購01  ,0,0,0,0,0,0,0,0,0,0,0,0,0,5000,5000,0,0
053930,S&P反1統一98購01,0,0,0,0,0,0,0,0,0,0,0,0,0,20000,20000,0,0
05399P,GIS國票95售03   ,0,0,0,0,0,0,0,0,0,0,0,0,0,80000,80000,0,0
055122,國巨兆豐98購01  ,0,0,0,0,0,0,0,0,0,0,0,0,0,10000,10000,0,0
053886,亞光兆豐96購01  ,0,0,0,0,0,0,0,0,0,0,0,0,0,55000,55000,0,0
052234,GIS凱基97購01   ,0,0,0,0,0,0,0,0,0,0,0,0,0,8000,8000,0,0
052041,鴻海日盛95購02  ,0,0,0,0,0,0,0,0,0,0,0,0,0,499000,499000,0,0
052045,瑞昱凱基96購01  ,0,0,0,0,0,0,0,0,0,0,0,0,0,10000,10000,0,0
052052,嘉澤凱基95購02  ,0,0,0,0,0,0,0,0,0,0,0,0,0,10000,10000,0,0
051957,旺宏台新95購02  ,0,0,0,0,0,0,0,0,0,0,0,0,0,90000,90000,0,0
051838,國巨國泰97購01  ,0,0,0,0,0,0,0,0,0,0,0,0,0,65000,65000,0,0
04322P,可成元大94售01  ,0,0,0,0,0,0,0,0,0,0,0,0,0,22000,22000,0,0
04935P,鴻海中信96售01  ,0,0,0,0,0,0,0,0,0,0,0,0,0,80000,80000,0,0
05171P,臺股指元大95售15,0,0,0,0,0,0,0,0,0,0,0,0,0,2000,2000,0,0
051721,玉晶光永豐96購02,0,0,0,0,0,0,0,0,0,0,0,0,0,21000,21000,0,0
051624,智邦麥證95購02  ,0,0,0,1000,0,1000,0,0,0,0,0,0,0,1000,1000,0,0
00657K,國泰日經225+U   ,0,0,0,0,0,0,0,0,0,0,0,0,0,100,100,0,0
00668K,國泰美國道瓊+U  ,0,0,0,0,0,0,0,0,0,0,0,0,0,100,100,0,0
00675L,富邦臺灣加權正2 ,0,0,0,0,0,0,0,0,0,0,0,0,0,328000,328000,0,0
006204,永豐臺灣加權    ,0,0,0,0,0,0,0,0,0,0,0,0,0,1000,1000,0,0
00625K,富邦上証+R      ,0,0,0,0,0,0,0,0,0,0,0,0,0,70000,70000,0,0
00636K,國泰中國A50+U   ,0,0,0,0,0,0,0,0,0,0,0,0,0,100,100,0,0
047211,華新科富邦99購01,0,0,0,0,0,0,0,0,0,0,0,0,0,2000,2000,0,0
00711B,FH彭博新興債    ,0,0,0,0,0,0,0,0,0,0,0,0,0,101000,101000,0,0
00732,國泰RMB短期報酬 ,0,0,0,0,0,0,0,0,0,0,0,0,0,100000,100000,0,0
00742,新光內需收益    ,0,0,0,0,0,0,0,0,0,0,0,0,0,100000,100000,0,0
00774B,新光中國政金綠債,0,0,0,0,0,0,0,0,0,0,0,0,0,2000,2000,0,0
00775B,新光投等債15+   ,0,0,0,0,0,0,0,0,0,0,0,0,0,2000,2000,0,0
00776,新光ICE美國權值 ,0,0,0,0,0,0,0,0,0,0,0,0,0,100000,100000,0,0
03035X,元展32          ,0,0,0,0,0,0,0,0,0,0,0,0,0,2000,2000,0,0
03604P,群創凱基98售05  ,0,0,0,0,0,0,0,0,0,0,0,0,0,39000,39000,0,0
036084,台灣50台新98購01,0,0,0,0,0,0,0,0,0,0,0,0,0,410000,410000,0,0
048785,台積電元大96購01,0,0,0,0,0,0,0,0,0,0,0,0,0,15000,15000,0,0
047854,滬深2X國票96購02,0,0,0,0,0,0,0,0,0,0,0,0,0,50000,50000,0,0
047630,元油反元大96購02,0,0,0,0,0,0,0,0,0,0,0,0,0,3000,3000,0,0
048001,中工元大96購01  ,0,0,0,0,0,0,0,0,0,0,0,0,0,99000,99000,0,0
054444,緯穎台新97購01  ,0,0,0,0,0,0,0,0,0,0,0,0,0,28000,28000,0,0
054482,大成鋼台新96購01,0,0,0,0,0,0,0,0,0,0,0,0,0,500000,500000,0,0
054346,世芯國票97購01  ,0,0,0,0,0,0,0,0,0,0,0,0,0,10000,10000,0,0
053022,欣興國泰98購01  ,0,0,0,0,0,0,0,0,0,0,0,0,0,36000,36000,0,0
053012,國巨統一96購03  ,0,0,0,0,0,0,0,0,0,0,0,0,0,10000,10000,0,0
053005,微星永豐96購01  ,0,0,0,0,0,0,0,0,0,0,0,0,0,168000,168000,0,0
053037,國巨凱基96購08  ,0,0,0,0,0,0,0,0,0,0,0,0,0,300000,300000,0,0
054295,世芯元大96購03  ,0,0,0,0,0,0,0,0,0,0,0,0,0,10000,10000,0,0
05427P,聯發科凱基96售07,0,0,0,0,0,0,0,0,0,0,0,0,0,6000,6000,0,0
054273,宏達電中信98購01,0,0,0,0,0,0,0,0,0,0,0,0,0,30000,30000,0,0
054081,聯電元富96購01  ,0,0,0,0,0,0,0,0,0,0,0,0,0,2000,2000,0,0
054152,漢唐國泰98購02  ,0,0,0,0,0,0,0,0,0,0,0,0,0,10000,10000,0,0
054147,GIS元大96購02   ,0,0,0,0,0,0,0,0,0,0,0,0,0,68000,68000,0,0
052879,滬深2X凱基97購02,0,0,0,0,0,0,0,0,0,0,0,0,0,20000,20000,0,0
05291P,鴻海凱基95售16  ,0,0,0,0,0,0,0,0,0,0,0,0,0,40000,40000,0,0
052940,玉晶光兆豐97購01,0,0,0,0,0,0,0,0,0,0,0,0,0,10000,10000,0,0
052835,滬深2X國泰98購01,0,0,0,0,0,0,0,0,0,0,0,0,0,30000,30000,0,0
052830,台光電群益96購01,0,0,0,0,0,0,0,0,0,0,0,0,0,340000,340000,0,0
057767,緯穎凱基98購06  ,0,0,0,0,0,0,0,0,0,0,0,0,0,10000,10000,0,0
057757,鴻海凱基98購13  ,0,0,0,0,0,0,0,0,0,0,0,0,0,15000,15000,0,0
05768P,台積電凱基96售15,0,0,0,0,0,0,0,0,0,0,0,0,0,10000,10000,0,0
057910,華新科兆豐99購02,0,0,0,0,0,0,0,0,0,0,0,0,0,10000,10000,0,0
057913,健策日盛98購01  ,0,0,0,0,0,0,0,0,0,0,0,0,0,10000,10000,0,0
057914,日月光日盛9A購01,0,0,0,0,0,0,0,0,0,0,0,0,0,100000,100000,0,0
057873,義隆元大98購03  ,0,0,0,0,0,0,0,0,0,0,0,0,0,260000,260000,0,0
057842,緯穎富邦99購02  ,0,0,0,0,0,0,0,0,0,0,0,0,0,10000,10000,0,0
054587,玉晶光國泰99購01,0,0,0,0,0,0,0,0,0,0,0,0,0,10000,10000,0,0
054555,欣興凱基98購01  ,0,0,0,0,0,0,0,0,0,0,0,0,0,90000,90000,0,0
054576,健策元大98購03  ,0,0,0,0,0,0,0,0,0,0,0,0,0,5000,5000,0,0
054593,滬深2X永昌9A購01,0,0,0,0,0,0,0,0,0,0,0,0,0,1000,1000,0,0
054621,華新科兆豐98購01,0,0,0,0,0,0,0,0,0,0,0,0,0,10000,10000,0,0
055160,玉晶光元大99購03,0,0,0,0,0,0,0,0,0,0,0,0,0,5000,5000,0,0
055185,晶相光統一97購01,0,10000,-10000,0,0,0,0,0,0,10000,0,0,0,10000,0,10000,0
05518P,T50反1凱基98售03,0,0,0,0,0,0,0,0,0,0,0,0,0,10000,10000,0,0
055179,大立光統一97購04,0,0,0,0,0,0,0,0,0,0,0,0,0,35000,35000,0,0
055214,聯電凱基97購02  ,0,0,0,0,0,0,0,0,0,0,0,0,0,5000,5000,0,0
054643,上証2X群益9B購01,0,0,0,0,0,0,0,0,0,0,0,0,0,10000,10000,0,0
05468P,鴻海元大96售14  ,0,0,0,0,0,0,0,0,0,0,0,0,0,300000,300000,0,0
05469P,台積電元大95售24,0,0,0,0,0,0,0,0,0,0,0,0,0,100000,100000,0,0
054783,國巨群益98購04  ,0,0,0,0,0,0,0,0,0,0,0,0,0,10000,10000,0,0
05481P,鴻海凱基95售21  ,0,0,0,0,0,0,0,0,0,0,0,0,0,1000,1000,0,0
054840,T50反1兆豐98購01,0,0,0,0,0,0,0,0,0,0,0,0,0,10000,10000,0,0
054835,致新中信97購01  ,0,0,0,0,0,0,0,0,0,0,0,0,0,10000,10000,0,0
053090,新唐元大96購01  ,0,0,0,0,0,0,0,0,0,0,0,0,0,10000,10000,0,0
053152,大立光元大99購01,0,0,0,0,0,0,0,0,0,0,0,0,0,6000,6000,0,0
053153,大立光元大99購02,0,0,0,0,0,0,0,0,0,0,0,0,0,10000,10000,0,0
05315P,鴻海永昌96售08  ,0,0,0,0,0,0,0,0,0,0,0,0,0,650000,650000,0,0
053163,上証2X群益9A購02,0,0,0,0,0,0,0,0,0,0,0,0,0,10000,10000,0,0
053129,緯穎凱基96購01  ,0,0,0,0,0,0,0,0,0,0,0,0,0,19000,19000,0,0
053130,聯發科麥證96購01,0,0,0,0,100000,-100000,0,0,0,0,0,0,0,100000,100000,0,0
054959,禾伸堂元大98購01,0,0,0,0,0,0,0,0,0,0,0,0,0,10000,10000,0,0
05358P,大立光元大95售09,0,0,0,0,0,0,0,0,0,0,0,0,0,1000,1000,0,0
053561,玉晶光國泰98購01,0,0,0,0,0,0,0,0,0,0,0,0,0,292000,292000,0,0
053562,玉晶光國泰98購02,0,0,0,0,0,0,0,0,0,0,0,0,0,15000,15000,0,0
053566,大立光富邦99購03,0,0,0,0,0,0,0,0,0,0,0,0,0,62000,62000,0,0
053517,崇越群益97購01  ,0,0,0,0,0,0,0,0,0,0,0,0,0,150000,150000,0,0
053498,大立光兆豐96購03,0,0,0,0,0,0,0,0,0,0,0,0,0,117000,117000,0,0
05402P,台郡永豐95售02  ,0,0,0,0,0,0,0,0,0,0,0,0,0,100000,100000,0,0
052696,玉晶光麥證97購01,0,0,0,35000,0,35000,0,0,0,0,0,0,0,35000,35000,0,0
052756,國巨群益96購02  ,0,0,0,0,0,0,0,0,0,0,0,0,0,500000,500000,0,0
052742,可成元大96購01  ,0,0,0,0,0,0,0,0,0,0,0,0,0,11000,11000,0,0
052780,玉晶光國票96購04,0,0,0,0,0,0,0,0,0,0,0,0,0,15000,15000,0,0
053528,南電中信9A購01  ,0,0,0,0,0,0,0,0,0,0,0,0,0,20000,20000,0,0
053484,國巨國票97購03  ,0,0,0,0,0,0,0,0,0,0,0,0,0,2000,2000,0,0
053357,可成統一96購02  ,0,0,0,0,0,0,0,0,0,0,0,0,0,5000,5000,0,0
053188,旺宏統一97購03  ,0,0,0,0,0,0,0,0,0,0,0,0,0,2000000,2000000,0,0
05327P,臺股指凱基95售11,0,0,0,0,0,0,0,0,0,0,0,0,0,166000,166000,0,0
053234,奇鋐永豐96購01  ,0,0,0,0,0,0,0,0,0,0,0,0,0,10000,10000,0,0
055740,智易元富97購01  ,0,0,0,0,0,0,0,0,0,0,0,0,0,20000,20000,0,0
055790,南電凱基97購01  ,0,0,0,0,0,0,0,0,0,0,0,0,0,20000,20000,0,0
055795,茂林國泰98購01  ,0,0,0,0,0,0,0,0,0,0,0,0,0,400000,400000,0,0
055997,矽創國泰99購01  ,0,0,0,0,0,0,0,0,0,0,0,0,0,28000,28000,0,0
055972,GIS元大97購04   ,0,0,0,0,0,0,0,0,0,0,0,0,0,17000,17000,0,0
055926,國巨群益98購06  ,0,0,0,0,0,0,0,0,0,0,0,0,0,200000,200000,0,0
055892,國巨統一99購01  ,0,0,0,0,0,0,0,0,0,0,0,0,0,10000,10000,0,0
055911,可成凱基98購02  ,0,0,0,0,0,0,0,0,0,0,0,0,0,2000,2000,0,0
055915,大立光凱基98購07,0,0,0,0,0,0,0,0,0,0,0,0,0,68000,68000,0,0
055346,國巨凱基98購02  ,0,0,0,0,0,0,0,0,0,0,0,0,0,200000,200000,0,0
055339,緯穎兆豐98購01  ,0,0,0,0,0,0,0,0,0,0,0,0,0,6000,6000,0,0
055378,晶相光元大97購02,0,6000,-6000,0,0,0,0,0,0,6000,0,0,0,6000,0,6000,0
055402,正文元富97購02  ,0,0,0,0,0,0,0,0,0,0,0,0,0,50000,50000,0,0
055687,瀚宇博凱基97購01,0,0,0,0,0,0,0,0,0,0,0,0,0,10000,10000,0,0
058711,鴻海統一9A購02  ,0,0,0,0,0,0,0,0,0,0,0,0,0,29000,29000,0,0
058681,大立光康和9B購01,0,0,0,0,0,0,0,0,0,0,0,0,0,10000,10000,0,0
058607,聯發科元大99購14,0,0,0,0,0,0,0,0,0,0,0,0,0,1000,1000,0,0
058618,南電元大99購02  ,0,0,0,0,0,0,0,0,0,0,0,0,0,10000,10000,0,0
058539,聯發科台新99購01,0,0,0,0,0,0,0,0,0,0,0,0,0,390000,390000,0,0
055244,國巨統一98購01  ,0,0,0,0,0,0,0,0,0,0,0,0,0,20000,20000,0,0
055247,聯發科統一98購01,0,0,0,0,0,0,0,0,0,0,0,0,0,140000,140000,0,0
055253,大立光統一97購06,0,0,0,0,0,0,0,0,0,0,0,0,0,68000,68000,0,0
058792,鴻海元大99購18  ,0,0,0,0,0,0,0,0,0,0,0,0,0,43000,43000,0,0
058738,FBVIX中信03購04 ,0,0,0,0,0,0,0,0,0,0,0,0,0,2000,2000,0,0
055271,鴻海元大98購03  ,0,0,0,0,0,0,0,0,0,0,0,0,0,28000,28000,0,0
055293,晶相光元大97購01,0,10000,-10000,0,0,0,0,0,0,10000,0,0,0,10000,0,10000,0
055311,健策群益98購02  ,0,0,0,0,0,0,0,0,0,0,0,0,0,12000,12000,0,0
056306,晶相光元大98購01,0,10000,-10000,0,0,0,0,0,0,10000,0,0,0,10000,0,10000,0
058091,欣興元大99購03  ,0,0,0,0,0,0,0,0,0,0,0,0,0,3000,3000,0,0
058155,牧德統一9A購01  ,0,0,0,0,0,0,0,0,0,0,0,0,0,30000,30000,0,0
058196,台塑中信99購01  ,0,0,0,0,0,0,0,0,0,0,0,0,0,20000,20000,0,0
05818P,大立光凱基96售14,0,0,0,0,0,0,0,0,0,0,0,0,0,10000,10000,0,0
058199,國巨康和99購01  ,0,0,0,0,0,0,0,0,0,0,0,0,0,100000,100000,0,0
05827P,台積電統一96售10,0,0,0,0,0,0,0,0,0,0,0,0,0,20000,20000,0,0
058265,奇力新永豐9A購01,0,0,0,0,0,0,0,0,0,0,0,0,0,25000,25000,0,0
058436,聯發科統一9B購03,0,0,0,0,0,0,0,0,0,0,0,0,0,80000,80000,0,0
05842P,台積電元大96售15,0,0,0,0,0,0,0,0,0,0,0,0,0,20000,20000,0,0
05850P,台積電兆豐96售06,0,0,0,0,0,0,0,0,0,0,0,0,0,10000,10000,0,0
058502,鴻海元大99購13  ,0,0,0,0,0,0,0,0,0,0,0,0,0,16000,16000,0,0
058428,大立光元富99購02,0,0,0,0,0,0,0,0,0,0,0,0,0,23000,23000,0,0
058414,大立光兆豐99購02,0,0,0,0,0,0,0,0,0,0,0,0,0,226000,226000,0,0
058376,貿聯凱基9A購01  ,0,0,0,0,0,0,0,0,0,0,0,0,0,90000,90000,0,0
058389,聯茂國票9A購01  ,0,0,0,0,0,0,0,0,0,0,0,0,0,4000,4000,0,0
058333,鴻海元富99購04  ,0,0,0,0,0,0,0,0,0,0,0,0,0,15000,15000,0,0
058347,玉晶光群益9B購01,0,0,0,0,0,0,0,0,0,0,0,0,0,18000,18000,0,0
056175,可成元富97購03  ,0,0,0,0,0,0,0,0,0,0,0,0,0,10000,10000,0,0
057045,美律元大99購04  ,0,0,0,0,0,0,0,0,0,0,0,0,0,68000,68000,0,0
05617P,大立光統一97售02,0,0,0,0,0,0,0,0,0,0,0,0,0,60000,60000,0,0
05614P,臺股指康和96售03,0,0,0,0,0,0,0,0,0,0,0,0,0,200000,200000,0,0
056155,嘉晶凱基97購01  ,0,0,0,0,0,0,0,0,0,0,0,0,0,200000,200000,0,0
056251,聯發科兆豐97購02,0,0,0,0,0,0,0,0,0,0,0,0,0,10000,10000,0,0
056256,聯茂元富97購03  ,0,0,0,0,0,0,0,0,0,0,0,0,0,26000,26000,0,0
057996,臻鼎中信98購01  ,0,0,0,0,0,0,0,0,0,0,0,0,0,20000,20000,0,0
057146,技嘉國票98購01  ,0,0,0,0,0,0,0,0,0,0,0,0,0,5000,5000,0,0
058044,鴻海元大99購07  ,0,0,0,0,0,0,0,0,0,0,0,0,0,45000,45000,0,0
058009,智易國票99購01  ,0,0,0,0,0,0,0,0,0,0,0,0,0,2000,2000,0,0
059237,鴻海凱基9A購10  ,0,0,0,0,0,0,0,0,0,0,0,0,0,1000,1000,0,0
059211,鴻海元大99購27  ,0,0,0,0,0,0,0,0,0,0,0,0,0,82000,82000,0,0
059331,台灣50國票9A購06,0,0,0,0,0,0,0,0,0,0,0,0,0,20000,20000,0,0
059321,欣興元大99購07  ,0,0,0,0,0,0,0,0,0,0,0,0,0,1000,1000,0,0
059315,鴻海元大99購30  ,0,0,0,0,0,0,0,0,0,0,0,0,0,88000,88000,0,0
059129,麗豐中信99購01  ,0,0,0,0,0,0,0,0,0,0,0,0,0,31000,31000,0,0
059122,超眾永豐99購01  ,0,0,0,0,0,0,0,0,0,0,0,0,0,1000,1000,0,0
059102,聯鈞元富99購01  ,0,0,0,0,0,0,0,0,0,0,0,0,0,6000,6000,0,0
059149,臺股指國票99購12,0,0,0,0,0,0,0,0,0,0,0,0,0,1000,1000,0,0
059058,可成凱基9B購01  ,0,0,0,0,0,0,0,0,0,0,0,0,0,8000,8000,0,0
059059,宏達電凱基99購03,0,0,0,0,0,0,0,0,0,0,0,0,0,1000,1000,0,0
059053,鴻海凱基99購07  ,0,0,0,0,0,0,0,0,0,0,0,0,0,1000,1000,0,0
058855,台積電兆豐99購02,0,0,0,0,0,0,0,0,0,0,0,0,0,1000,1000,0,0
058895,鴻海元大99購20  ,0,0,0,0,0,0,0,0,0,0,0,0,0,29000,29000,0,0
058840,T50反1群益99購02,0,0,0,0,0,0,0,0,0,0,0,0,0,20000,20000,0,0
058830,健策永豐99購02  ,0,0,0,0,0,0,0,0,0,0,0,0,0,4000,4000,0,0
058817,嘉聯益台新99購01,0,0,0,0,0,0,0,0,0,0,0,0,0,53000,53000,0,0
05889P,群創元大98售02  ,0,0,0,0,0,0,0,0,0,0,0,0,0,37000,37000,0,0
05898P,旺宏凱基96售06  ,0,0,0,0,0,0,0,0,0,0,0,0,0,10000,10000,0,0
058980,鴻海凱基99購06  ,0,0,0,0,0,0,0,0,0,0,0,0,0,40000,40000,0,0
058969,亞德客永豐99購01,0,0,0,0,0,0,0,0,0,0,0,0,0,1000,1000,0,0
057514,華新科元富99購03,0,0,0,0,0,0,0,0,0,0,0,0,0,64000,64000,0,0
057489,奇力新元大99購06,0,0,0,0,0,0,0,0,0,0,0,0,0,25000,25000,0,0
057487,聯發科元大98購10,0,0,0,0,0,0,0,0,0,0,0,0,0,250000,250000,0,0
057392,福懋科永豐98購01,0,0,0,0,0,0,0,0,0,0,0,0,0,10000,10000,0,0
057336,聯發科國票99購01,0,0,0,0,0,0,0,0,0,0,0,0,0,20000,20000,0,0
057442,玉晶光統一98購03,0,0,0,0,0,0,0,0,0,0,0,0,0,20000,20000,0,0
057444,台泥元富98購01  ,0,0,0,0,0,0,0,0,0,0,0,0,0,11000,11000,0,0
057429,華新科兆豐98購03,0,0,0,0,0,0,0,0,0,0,0,0,0,10000,10000,0,0
057263,可成兆豐99購01  ,0,0,0,0,0,0,0,0,0,0,0,0,0,5000,5000,0,0
056445,聯發科凱基98購07,0,0,0,0,0,0,0,0,0,0,0,0,0,10000,10000,0,0
056467,上証2X元大98購02,0,0,0,0,0,0,0,0,0,0,0,0,0,16000,16000,0,0
055511,大立光兆豐97購02,0,0,0,0,0,0,0,0,0,0,0,0,0,20000,20000,0,0
055492,華新科元大97購08,0,0,0,0,0,0,0,0,0,0,0,0,0,41000,41000,0,0
05601P,鴻海元大97售04  ,0,0,0,0,0,0,0,0,0,0,0,0,0,170000,170000,0,0
05602P,國巨元大96售06  ,0,0,0,0,0,0,0,0,0,0,0,0,0,53000,53000,0,0
056062,大立光元大97購12,0,0,0,0,0,0,0,0,0,0,0,0,0,10000,10000,0,0
05781P,臺股指統一99售02,0,0,0,0,0,0,0,0,0,0,0,0,0,20000,20000,0,0
056376,玉晶光統一98購01,0,0,0,0,0,0,0,0,0,0,0,0,0,30000,30000,0,0
056384,玉晶光國泰9A購02,0,0,0,0,0,0,0,0,0,0,0,0,0,2000,2000,0,0
05716P,T50反1元大98售03,0,0,0,0,0,0,0,0,0,0,0,0,0,580000,580000,0,0
056400,道瓊反群益9C購01,0,0,0,0,0,0,0,0,0,0,0,0,0,70000,70000,0,0
056430,鴻海凱基98購06  ,0,0,0,0,0,0,0,0,0,0,0,0,0,21000,21000,0,0
057168,旺宏元大99購03  ,0,0,0,0,0,0,0,0,0,0,0,0,0,17000,17000,0,0
05681P,大立光元大96售05,0,0,0,0,0,0,0,0,0,0,0,0,0,10000,10000,0,0
05682P,大立光元大98售03,0,0,0,0,0,0,0,0,0,0,0,0,0,25000,25000,0,0
056837,國巨元富98購02  ,0,0,0,0,0,0,0,0,0,0,0,0,0,150000,150000,0,0
056771,嘉晶元大99購01  ,0,0,0,0,0,0,0,0,0,0,0,0,0,3000,3000,0,0
056732,國巨凱基98購07  ,0,0,0,0,0,0,0,0,0,0,0,0,0,200000,200000,0,0
056976,喬山群益98購01  ,0,0,0,0,0,0,0,0,0,0,0,0,0,1000,1000,0,0
056973,T50反1永昌9C購01,30000,0,30000,0,0,0,0,0,0,-30000,0,0,0,0,30000,-30000,0
056920,友達兆豐98購02  ,0,0,0,0,0,0,0,0,0,0,0,0,0,100000,100000,0,0
056707,鴻海富邦99購03  ,0,0,0,0,0,0,0,0,0,0,0,0,0,220000,220000,0,0
056720,世紀鋼永豐98購01,0,0,0,0,0,0,0,0,0,0,0,0,0,100000,100000,0,0
056737,國巨凱基9A購01  ,0,0,0,0,0,0,0,0,0,0,0,0,0,151000,151000,0,0
056651,聯茂凱基98購04  ,0,0,0,0,0,0,0,0,0,0,0,0,0,10000,10000,0,0
056664,上証反中信9B購01,0,0,0,0,0,0,0,0,0,0,0,0,0,100000,100000,0,0
057313,聯發科麥證99購01,0,0,0,7000,7000,0,0,0,0,0,0,0,0,7000,7000,0,0
057303,喬山兆豐99購01  ,0,0,0,0,0,0,0,0,0,0,0,0,0,7000,7000,0,0
8478,東哥遊艇        ,1000,1000,0,0,0,0,0,0,0,0,0,0,0,0,0,0,0
3057,喬鼎            ,3000,3000,0,0,0,0,0,0,0,0,0,0,0,0,0,0,0
3058,立德            ,1000,1000,0,0,0,0,0,0,0,0,0,0,0,0,0,0,0
3257,虹冠電          ,2000,2000,0,0,0,0,0,0,0,0,0,0,0,0,0,0,0
2527,宏璟            ,63000,63000,0,0,0,0,0,0,0,0,0,0,0,0,0,0,0
2429,銘旺科          ,18000,18000,0,0,0,0,0,0,0,0,0,0,0,0,0,0,0
2227,裕日車          ,12000,12000,0,0,0,0,0,0,0,0,0,0,0,0,0,0,0
07778P,台灣50凱基9C售08,0,0,0,0,0,0,0,0,0,0,0,0,0,10000,10000,0,0
07692P,玉晶光元大9A售11,0,0,0,0,0,0,0,0,0,0,0,0,0,1000,1000,0,0
07698P,臺股指元大9A售51,0,0,0,0,0,0,0,0,0,0,0,0,0,5000,5000,0,0
07713P,台郡元大9A售03  ,0,0,0,0,0,0,0,0,0,0,0,0,0,25000,25000,0,0
1725,元禎            ,1000,1000,0,0,0,0,0,0,0,0,0,0,0,0,0,0,0
1423,利華            ,1000,1000,0,0,0,0,0,0,0,0,0,0,0,0,0,0,0
07463P,台積電國票9A售05,0,0,0,0,0,0,0,0,0,0,0,0,0,30000,30000,0,0
07472P,和碩元大9A售03  ,0,0,0,0,0,0,0,0,0,0,0,0,0,50000,50000,0,0
07410P,鴻海元大99售44  ,0,0,0,0,0,0,0,0,0,0,0,0,0,87000,87000,0,0
07529P,國巨凱基9A售11  ,0,0,0,0,0,0,0,0,0,0,0,0,0,20000,20000,0,0
07540P,鴻海凱基9A售21  ,0,0,0,0,0,0,0,0,0,0,0,0,0,55000,55000,0,0
07333P,台灣50國票9B售03,0,0,0,0,0,0,0,0,0,0,0,0,0,11000,11000,0,0
07272P,台灣50元大9C售05,0,0,0,0,0,0,0,0,0,0,0,0,0,5000,5000,0,0
07169P,臺股指國票99售06,0,0,0,0,0,0,0,0,0,0,0,0,0,499000,499000,0,0
3543,州巧            ,0,0,0,0,0,0,0,0,0,-562,0,562,-562,0,0,0,-562
061011,華通麥證9A購02  ,0,0,0,12000,13000,-1000,0,0,0,-1000,0,0,0,12000,13000,-1000,-1000
06088P,建準永豐97售01  ,0,0,0,0,0,0,0,0,0,-1000,0,0,0,0,1000,-1000,-1000
060890,大立光統一01購01,0,0,0,0,0,0,0,0,0,-1000,0,0,0,16000,17000,-1000,-1000
06080P,景碩群益98售02  ,0,0,0,0,0,0,0,0,0,-1000,0,0,0,0,1000,-1000,-1000
06104P,大立光凱基97售04,0,0,0,0,0,0,0,0,0,-1000,0,0,0,0,1000,-1000,-1000
061292,玉晶光統一01購06,0,0,0,0,0,0,0,0,0,-1000,0,0,0,4000,5000,-1000,-1000
061277,智邦台新9A購01  ,0,0,0,0,0,0,0,0,0,-1000,0,0,0,15000,16000,-1000,-1000
061229,緯穎中信9B購01  ,0,0,0,0,0,0,0,0,0,-1000,0,0,0,3000,4000,-1000,-1000
07013P,玉晶光群益9A售06,0,0,0,0,0,0,0,0,0,-1000,0,0,0,0,1000,-1000,-1000
07058P,台積電凱基9A售07,0,0,0,0,0,0,0,0,0,-1000,0,0,0,0,1000,-1000,-1000
06683P,訊芯元大98售07  ,0,0,0,0,0,0,0,0,0,-1000,0,0,0,34000,35000,-1000,-1000
06566P,華通永豐98售03  ,0,0,0,0,0,0,0,0,0,-1000,0,0,0,9000,10000,-1000,-1000
061529,國巨台新9A購02  ,0,0,0,0,0,0,0,0,0,-1000,0,0,0,0,1000,-1000,-1000
061525,華新科凱基9A購13,0,0,0,0,0,0,0,0,0,-1000,0,0,0,0,1000,-1000,-1000
061496,華新科國票9A購07,0,0,0,0,0,0,0,0,0,-1000,0,0,0,0,1000,-1000,-1000
061447,鴻海中信04購02  ,0,0,0,0,0,0,0,0,0,-1000,0,0,0,0,1000,-1000,-1000
06247P,同欣電元富97售02,0,0,0,0,0,0,0,0,0,-1000,0,0,0,0,1000,-1000,-1000
06203P,奇力新中信98售02,0,0,0,0,0,0,0,0,0,-1000,0,0,0,0,1000,-1000,-1000
06195P,台積電元富97售06,0,0,0,0,0,0,0,0,0,-1000,0,0,0,250000,251000,-1000,-1000
06548P,大立光元大98售10,0,0,0,0,0,0,0,0,0,-1000,0,0,0,0,1000,-1000,-1000
059884,鴻海國票99購09  ,0,0,0,0,0,0,0,0,0,-1000,0,0,0,0,1000,-1000,-1000
059798,臺股指國票99購21,0,0,0,0,0,0,0,0,0,-1000,0,0,0,0,1000,-1000,-1000
059827,晶技凱基99購03  ,0,0,0,0,0,0,0,0,0,-1000,0,0,0,0,1000,-1000,-1000
060000,國巨台新99購01  ,0,0,0,0,0,0,0,0,0,-1000,0,0,0,10000,11000,-1000,-1000
05995P,T50正2中信9C售01,0,0,0,0,0,0,0,0,0,-1000,0,0,0,0,1000,-1000,-1000
059388,國巨凱基99購13  ,0,0,0,0,0,0,0,0,0,-1000,0,0,0,1000,2000,-1000,-1000
059436,大立光元大99購18,0,0,0,0,0,0,0,0,0,-1000,0,0,0,0,1000,-1000,-1000
059466,國巨元大99購26  ,0,0,0,0,0,0,0,0,0,-1000,0,0,0,13000,14000,-1000,-1000
059490,國巨國票99購09  ,0,0,0,0,0,0,0,0,0,-1000,0,0,0,0,1000,-1000,-1000
059491,國巨國票9A購05  ,0,0,0,0,0,0,0,0,0,-1000,0,0,0,0,1000,-1000,-1000
059515,牧德永豐99購01  ,0,0,0,0,0,0,0,0,0,-1000,0,0,0,29000,30000,-1000,-1000
059724,聯發科元大99購30,0,0,0,0,0,0,0,0,0,-1000,0,0,0,0,1000,-1000,-1000
06043P,創意永豐96售06  ,0,0,0,0,0,0,0,0,0,-1000,0,0,0,48000,49000,-1000,-1000
060444,滬深2X元大9A購04,0,0,0,0,0,0,0,0,0,-1000,0,0,0,0,1000,-1000,-1000
060492,元黃金元富9A購01,0,0,0,0,0,0,0,0,0,-1000,0,0,0,5000,6000,-1000,-1000
06060P,玉晶光元大97售03,0,0,0,0,0,0,0,0,0,-1000,0,0,0,0,1000,-1000,-1000
060637,玉晶光永豐9A購03,0,0,0,0,0,0,0,0,0,-1000,0,0,0,5000,6000,-1000,-1000
060247,牧德元大9A購02  ,0,0,0,0,0,0,0,0,0,-1000,0,0,0,21000,22000,-1000,-1000
060216,鴻海凱基9A購17  ,0,0,0,0,0,0,0,0,0,-1000,0,0,0,31000,32000,-1000,-1000
060219,聯發科凱基9A購09,0,0,0,0,0,0,0,0,0,-1000,0,0,0,0,1000,-1000,-1000
053304,可成凱基96購03  ,0,0,0,0,0,0,0,0,0,-1000,0,0,0,0,1000,-1000,-1000
053459,康控國泰97購01  ,0,0,0,0,0,0,0,0,0,-1000,0,0,0,0,1000,-1000,-1000
053407,台積電兆豐96購02,0,0,0,0,0,0,0,0,0,-1000,0,0,0,0,1000,-1000,-1000
05272P,臻鼎中信97售03  ,0,0,0,0,0,0,0,0,0,-1000,0,0,0,21000,22000,-1000,-1000
052787,國巨中信96購02  ,0,0,0,0,0,0,0,0,0,-1000,0,0,0,10000,11000,-1000,-1000
055012,茂林元富97購01  ,0,0,0,0,0,0,0,0,0,-1000,0,0,0,0,1000,-1000,-1000
053081,上銀元大97購02  ,0,0,0,0,0,0,0,0,0,-1000,0,0,0,0,1000,-1000,-1000
054739,義隆凱基98購02  ,0,0,0,0,0,0,0,0,0,-1000,0,0,0,40000,41000,-1000,-1000
054637,智邦中信98購01  ,0,0,0,0,0,0,0,0,0,-1000,0,0,0,20000,21000,-1000,-1000
05515P,台積電群益96售03,0,0,0,0,0,0,0,0,0,-1000,0,0,0,150000,151000,-1000,-1000
054563,泰碩群益99購01  ,0,0,0,0,0,0,0,0,0,-1000,0,0,0,282000,283000,-1000,-1000
054547,鴻海凱基98購02  ,0,0,0,0,0,0,0,0,0,-1000,0,0,0,1000,2000,-1000,-1000
057847,聯茂永豐98購01  ,0,0,0,0,0,0,0,0,0,-1000,0,0,0,3000,4000,-1000,-1000
057814,聯發科元大98購12,0,0,0,0,0,0,0,0,0,-1000,0,0,0,0,1000,-1000,-1000
057938,台表科群益98購02,0,0,0,0,0,0,0,0,0,-1000,0,0,0,1000,2000,-1000,-1000
05770P,聯發科凱基96售16,0,0,0,0,0,0,0,0,0,-1000,0,0,0,3000,4000,-1000,-1000
057752,臺股指國票98購08,0,0,0,0,0,0,0,0,0,-1000,0,0,0,5000,6000,-1000,-1000
052825,TPK永豐96購01   ,0,0,0,0,0,0,0,0,0,-1000,0,0,0,0,1000,-1000,-1000
052844,台積電統一96購02,0,0,0,0,0,0,0,0,0,-1000,0,0,0,0,1000,-1000,-1000
054154,智易國泰97購01  ,0,0,0,0,0,0,0,0,0,-1000,0,0,0,0,1000,-1000,-1000
054277,亞光群益97購01  ,0,0,0,0,0,0,0,0,0,-1000,0,0,0,0,1000,-1000,-1000
054290,奇力新元大96購05,0,0,0,0,0,0,0,0,0,-1000,0,0,0,0,1000,-1000,-1000
053064,國巨群益96購04  ,0,0,0,0,0,0,0,0,0,-1000,0,0,0,81000,82000,-1000,-1000
053027,玉晶光富邦98購01,0,0,0,0,0,0,0,0,0,-1000,0,0,0,60000,61000,-1000,-1000
053003,國巨永豐96購02  ,0,0,0,0,0,0,0,0,0,-1000,0,0,0,4000,5000,-1000,-1000
05437P,聯詠永豐95售02  ,0,0,0,0,0,0,0,0,0,-1000,0,0,0,0,1000,-1000,-1000
04731P,臺股指中信96售03,0,0,0,0,0,0,0,0,0,-1000,0,0,0,0,1000,-1000,-1000
03420B,臺股指元大95熊31,0,0,0,0,0,0,0,0,0,-1000,0,0,0,0,1000,-1000,-1000
03432B,臺股指凱基98熊13,0,0,0,0,0,0,0,0,0,-1000,0,0,0,0,1000,-1000,-1000
03434B,臺股指元大99熊10,0,0,0,0,0,0,0,0,0,-1000,0,0,0,0,1000,-1000,-1000
03026X,元展23          ,0,0,0,0,0,0,0,0,0,-1000,0,0,0,0,1000,-1000,-1000
03009X,元展09          ,0,0,0,0,0,0,0,0,0,-1000,0,0,0,0,1000,-1000,-1000
00770,國泰北美科技    ,0,0,0,0,0,0,0,0,0,-1000,0,0,0,14000,15000,-1000,-1000
047004,台積電統一99購01,0,0,0,0,0,0,0,0,0,-1000,0,0,0,0,1000,-1000,-1000
020011,統一微波高息20N ,0,0,0,0,0,0,0,0,0,-1000,0,0,0,1000,2000,-1000,-1000
00682U,元大美元指數    ,0,0,0,0,0,0,0,0,0,-1000,0,0,0,0,1000,-1000,-1000
00688L,國泰20年美債正2 ,0,0,0,0,0,0,0,0,0,-1000,0,0,0,100000,101000,-1000,-1000
051647,華新科永豐95購02,0,0,0,0,0,0,0,0,0,-1000,0,0,0,0,1000,-1000,-1000
049425,喬山兆豐95購01  ,0,0,0,0,0,0,0,0,0,-1000,0,0,0,0,1000,-1000,-1000
046944,奇力新元大96購01,0,0,0,0,0,0,0,0,0,-1000,0,0,0,0,1000,-1000,-1000
045189,大立光元富98購01,0,0,0,0,0,0,0,0,0,-1000,0,0,0,0,1000,-1000,-1000
051840,康友國泰97購02  ,0,0,0,0,0,0,0,0,0,-1000,0,0,0,0,1000,-1000,-1000
05189P,新光金凱基97售02,0,0,0,0,0,0,0,0,0,-1000,0,0,0,0,1000,-1000,-1000
052106,明泰兆豐95購01  ,0,0,0,0,0,0,0,0,0,-1000,0,0,0,3000,4000,-1000,-1000
055022,精元國泰99購01  ,0,0,0,0,0,0,0,0,0,-1000,0,0,0,3000,4000,-1000,-1000
055096,緯穎群益97購01  ,0,0,0,0,0,0,0,0,0,-1000,0,0,0,0,1000,-1000,-1000
055129,鈺齊兆豐97購01  ,0,0,0,0,0,0,0,0,0,-1000,0,0,0,0,1000,-1000,-1000
051375,道瓊反群益9A購01,0,0,0,0,0,0,0,0,0,-1000,0,0,0,0,1000,-1000,-1000
051497,中磊亞東96購01  ,0,0,0,0,0,0,0,0,0,-1000,0,0,0,0,1000,-1000,-1000
051544,T50反1康和98購01,0,0,0,0,0,0,0,0,0,-1000,0,0,0,0,1000,-1000,-1000
052622,貿聯兆豐97購01  ,0,0,0,0,0,0,0,0,0,-1000,0,0,0,0,1000,-1000,-1000
053732,S&P反1中信9C購01,0,0,0,0,0,0,0,0,0,-1000,0,0,0,0,1000,-1000,-1000
053703,緯穎兆豐96購01  ,0,0,0,0,0,0,0,0,0,-1000,0,0,0,10000,11000,-1000,-1000
05016P,臺股指元大95售07,0,0,0,0,0,0,0,0,0,-1000,0,0,0,0,1000,-1000,-1000
05033P,T50反1元大98售01,0,0,0,0,0,0,0,0,0,-1000,0,0,0,0,1000,-1000,-1000
050378,上証2X群益98購02,0,0,0,0,0,0,0,0,0,-1000,0,0,0,0,1000,-1000,-1000
052459,道瓊反統一95購04,0,0,0,0,0,0,0,0,0,-1000,0,0,0,0,1000,-1000,-1000
050984,大立光國泰97購01,0,0,0,0,0,0,0,0,0,-1000,0,0,0,0,1000,-1000,-1000
05092P,全新元大95售03  ,0,0,0,0,0,0,0,0,0,-1000,0,0,0,0,1000,-1000,-1000
050653,聯鈞凱基96購01  ,0,0,0,0,0,0,0,0,0,-1000,0,0,0,0,1000,-1000,-1000
050420,鴻海凱基95購03  ,0,0,0,0,0,0,0,0,0,-1000,0,0,0,0,1000,-1000,-1000
050497,臺指反凱基96購02,0,0,0,0,0,0,0,0,0,-1000,0,0,0,0,1000,-1000,-1000
050491,旺宏國泰96購01  ,0,0,0,0,0,0,0,0,0,-1000,0,0,0,2000,3000,-1000,-1000
050853,南電國票96購01  ,0,0,0,0,0,0,0,0,0,-1000,0,0,0,1000,2000,-1000,-1000
05727P,新光金日盛96售02,0,0,0,0,0,0,0,0,0,-1000,0,0,0,0,1000,-1000,-1000
057289,力成元大98購03  ,0,0,0,0,0,0,0,0,0,-1000,0,0,0,284000,285000,-1000,-1000
056568,台表科群益98購01,0,0,0,0,0,0,0,0,0,-1000,0,0,0,67000,68000,-1000,-1000
055467,國巨凱基97購05  ,0,0,0,0,0,0,0,0,0,-1000,0,0,0,310000,311000,-1000,-1000
057260,微星兆豐98購01  ,0,0,0,0,0,0,0,0,0,-1000,0,0,0,0,1000,-1000,-1000
059012,臺股指元大9A購31,0,0,0,0,0,0,0,0,0,-1000,0,0,0,0,1000,-1000,-1000
059109,台積電富邦9C購03,0,0,0,0,0,0,0,0,0,-1000,0,0,0,0,1000,-1000,-1000
059120,致伸永豐99購01  ,0,0,0,0,0,0,0,0,0,-1000,0,0,0,55000,56000,-1000,-1000
059320,華新科元大99購15,0,0,0,0,0,0,0,0,0,-1000,0,0,0,5000,6000,-1000,-1000
059341,台積電凱基99購15,0,0,0,0,0,0,0,0,0,-1000,0,0,0,0,1000,-1000,-1000
059274,國巨元大99購22  ,0,0,0,0,0,0,0,0,0,-1000,0,0,0,398000,399000,-1000,-1000
05713P,大立光統一96售05,0,0,0,0,0,0,0,0,0,-1000,0,0,0,0,1000,-1000,-1000
058004,大立光群益98購03,0,0,0,0,0,0,0,0,0,-1000,0,0,0,0,1000,-1000,-1000
056214,義隆國票99購01  ,0,0,0,0,0,0,0,0,0,-1000,0,0,0,10000,11000,-1000,-1000
05611P,康控群益96售02  ,0,0,0,0,0,0,0,0,0,-1000,0,0,0,0,1000,-1000,-1000
05608P,聯發科凱基96售10,0,0,0,0,0,0,0,0,0,-1000,0,0,0,0,1000,-1000,-1000
058391,T50反1元大99購02,0,0,0,0,0,0,0,0,0,-1000,0,0,0,0,1000,-1000,-1000
05849P,臺股指元大96售25,0,0,0,0,0,0,0,0,0,-1000,0,0,0,1000,2000,-1000,-1000
058189,嘉澤永豐99購01  ,0,0,0,0,0,0,0,0,0,-1000,0,0,0,0,1000,-1000,-1000
058054,台積電統一9C購01,0,0,0,0,0,0,0,0,0,-1000,0,0,0,0,1000,-1000,-1000
058617,南電元大99購01  ,0,0,0,0,0,0,0,0,0,-1000,0,0,0,0,1000,-1000,-1000
055374,明泰元大97購01  ,0,0,0,0,0,0,0,0,0,-1000,0,0,0,25000,26000,-1000,-1000
055354,宏達電凱基98購01,0,0,0,0,0,0,0,0,0,-1000,0,0,0,49000,50000,-1000,-1000
05559P,臺股指麥證96售01,0,0,0,0,1000,-1000,0,0,0,-1000,0,0,0,0,1000,-1000,-1000
055904,貿聯亞東99購01  ,0,0,0,0,0,0,0,0,0,-1000,0,0,0,0,1000,-1000,-1000
055978,大立光統一98購05,0,0,0,0,0,0,0,0,0,-1000,0,0,0,0,1000,-1000,-1000
055796,南電國泰98購01  ,0,0,0,0,0,0,0,0,0,-1000,0,0,0,0,1000,-1000,-1000
055691,訊芯凱基97購02  ,0,0,0,0,0,0,0,0,0,-1000,0,0,0,39000,40000,-1000,-1000
3557,嘉威            ,230000,231000,-1000,0,0,0,0,0,0,0,0,0,0,0,0,0,-1000
3416,融程電          ,0,1000,-1000,0,0,0,0,0,0,0,0,0,0,0,0,0,-1000
3419,譁裕            ,83000,84000,-1000,0,0,0,0,0,0,0,0,0,0,0,0,0,-1000
3356,奇偶            ,63000,64000,-1000,0,0,0,0,0,0,0,0,0,0,0,0,0,-1000
2910,統領            ,0,1000,-1000,0,0,0,0,0,0,0,0,0,0,0,0,0,-1000
2891B,中信金乙特      ,0,0,0,0,0,0,0,0,0,-1000,0,1000,-1000,0,0,0,-1000
4930,燦星網          ,0,1000,-1000,0,0,0,0,0,0,0,0,0,0,0,0,0,-1000
4755,三福化          ,1000,2000,-1000,0,0,0,0,0,0,0,0,0,0,0,0,0,-1000
6115,鎰勝            ,11000,12000,-1000,0,0,0,0,0,0,0,0,0,0,0,0,0,-1000
6117,迎廣            ,0,1000,-1000,0,0,0,0,0,0,0,0,0,0,0,0,0,-1000
2243,宏旭-KY         ,0,1000,-1000,0,0,0,0,0,0,0,0,0,0,0,0,0,-1000
2236,百達-KY         ,0,1000,-1000,0,0,0,0,0,0,0,0,0,0,0,0,0,-1000
2373,震旦行          ,0,1000,-1000,0,0,0,0,0,0,0,0,0,0,0,0,0,-1000
2460,建通            ,0,1000,-1000,0,0,0,0,0,0,0,0,0,0,0,0,0,-1000
2509,全坤建          ,0,1000,-1000,0,0,0,0,0,0,0,0,0,0,0,0,0,-1000
07160P,台灣50中信03售04,0,0,0,0,0,0,0,0,0,-1000,0,0,0,0,1000,-1000,-1000
07200P,臺股指元大99售16,0,0,0,0,0,0,0,0,0,-1000,0,0,0,0,1000,-1000,-1000
07220P,台灣50中信03售05,0,0,0,0,0,0,0,0,0,-1000,0,0,0,0,1000,-1000,-1000
07346P,FBVIX群益99售04 ,0,0,0,0,0,0,0,0,0,-1000,0,0,0,0,1000,-1000,-1000
07622P,華新科統一9B售02,0,0,0,0,0,0,0,0,0,-1000,0,0,0,13000,14000,-1000,-1000
1453,大將            ,1000,2000,-1000,0,0,0,0,0,0,0,0,0,0,0,0,0,-1000
1466,聚隆            ,0,1000,-1000,0,0,0,0,0,0,0,0,0,0,0,0,0,-1000
1256,鮮活果汁-KY     ,9000,10000,-1000,0,0,0,0,0,0,0,0,0,0,0,0,0,-1000
1339,昭輝            ,37000,38000,-1000,0,0,0,0,0,0,0,0,0,0,0,0,0,-1000
1583,程泰            ,0,1000,-1000,0,0,0,0,0,0,0,0,0,0,0,0,0,-1000
1558,伸興            ,4000,5000,-1000,0,0,0,0,0,0,0,0,0,0,0,0,0,-1000
07697P,臺股指元大9A售50,0,0,0,0,0,0,0,0,0,-1000,0,0,0,0,1000,-1000,-1000
1203,味王            ,0,1000,-1000,0,0,0,0,0,0,0,0,0,0,0,0,0,-1000
1108,幸福            ,0,1000,-1000,0,0,0,0,0,0,0,0,0,0,0,0,0,-1000
9927,泰銘            ,2000,3000,-1000,0,0,0,0,0,0,0,0,0,0,0,0,0,-1000
6641,基士德-KY       ,0,1000,-1000,0,0,0,0,0,0,0,0,0,0,0,0,0,-1000
8201,無敵            ,0,1000,-1000,0,0,0,0,0,0,0,0,0,0,0,0,0,-1000
8222,寶一            ,0,1000,-1000,0,0,0,0,0,0,0,0,0,0,0,0,0,-1000
8070,長華*           ,8000,9000,-1000,0,0,0,0,0,0,0,0,0,0,0,0,0,-1000
3008,大立光          ,331589,345510,-13921,0,0,0,16000,0,16000,-4000,1000,4000,-3000,0,1000,-1000,-1921
060212,華航康和9A購01  ,0,0,0,0,0,0,0,0,0,-2000,0,0,0,38000,40000,-2000,-2000
060106,旭富元大99購02  ,0,0,0,0,0,0,0,0,0,-2000,0,0,0,98000,100000,-2000,-2000
060147,臺股指國票9A購07,0,0,0,0,0,0,0,0,0,-2000,0,0,0,30000,32000,-2000,-2000
060266,潤泰全國票9A購01,0,0,0,0,0,0,0,0,0,-2000,0,0,0,9000,11000,-2000,-2000
060597,華通凱基9A購04  ,0,0,0,0,0,0,0,0,0,-2000,0,0,0,0,2000,-2000,-2000
060569,台積電永豐9A購01,0,0,0,0,0,0,0,0,0,-2000,0,0,0,9000,11000,-2000,-2000
060541,正隆凱基9A購01  ,0,0,0,0,0,0,0,0,0,-2000,0,0,0,40000,42000,-2000,-2000
060425,凌華永豐9A購01  ,0,0,0,0,0,0,0,0,0,-2000,0,0,0,0,2000,-2000,-2000
059968,世紀鋼凱基99購03,0,0,0,0,0,0,0,0,0,-2000,0,0,0,0,2000,-2000,-2000
060053,聯發科凱基9B購02,0,0,0,0,0,0,0,0,0,-2000,0,0,0,95000,97000,-2000,-2000
059824,大立光凱基99購13,0,0,0,0,0,0,0,0,0,-2000,0,0,0,5000,7000,-2000,-2000
06378P,國巨統一97售08  ,0,0,0,0,0,0,0,0,0,-2000,0,0,0,0,2000,-2000,-2000
06437P,玉晶光國票99售01,0,0,0,0,0,0,0,0,0,-2000,0,0,0,351000,353000,-2000,-2000
06337P,祥碩元大97售05  ,0,0,0,0,0,0,0,0,0,-2000,0,0,0,605000,607000,-2000,-2000
06303P,臺股指元大97售09,0,0,0,0,0,0,0,0,0,-2000,0,0,0,0,2000,-2000,-2000
06271P,彩晶凱基97售01  ,0,0,0,0,0,0,0,0,0,-2000,0,0,0,0,2000,-2000,-2000
06139P,台積電中信99售02,0,0,0,0,0,0,0,0,0,-2000,0,0,0,0,2000,-2000,-2000
06552P,茂林元大99售02  ,0,0,0,0,0,0,0,0,0,-2000,0,0,0,18000,20000,-2000,-2000
06560P,台積電統一98售07,0,0,0,0,0,0,0,0,0,-2000,0,0,0,0,2000,-2000,-2000
06691P,臺股指群益9C售05,0,0,0,0,0,0,0,0,0,-2000,0,0,0,0,2000,-2000,-2000
06730P,祥碩元大98售07  ,0,0,0,0,0,0,0,0,0,-2000,0,0,0,0,2000,-2000,-2000
06753P,智邦富邦98售03  ,0,0,0,0,0,0,0,0,0,-2000,0,0,0,0,2000,-2000,-2000
06750P,聯發科元富02售03,0,0,0,0,0,0,0,0,0,-2000,0,0,0,10000,12000,-2000,-2000
06880P,鈺齊凱基98售03  ,0,0,0,0,0,0,0,0,0,-2000,0,0,0,3000,5000,-2000,-2000
06828P,臺股指國票98售04,0,0,0,0,0,0,0,0,0,-2000,0,0,0,0,2000,-2000,-2000
06803P,臺股指群益98售09,0,0,0,0,0,0,0,0,0,-2000,0,0,0,0,2000,-2000,-2000
06810P,國巨統一99售03  ,0,0,0,0,0,0,0,0,0,-2000,0,0,0,0,2000,-2000,-2000
061250,臺股指群益9A購01,0,0,0,0,0,0,0,0,0,-2000,0,0,0,1000,3000,-2000,-2000
061060,台灣50麥證9B購01,0,0,0,0,2000,-2000,0,0,0,-2000,0,0,0,0,2000,-2000,-2000
06112P,台積電兆豐97售01,0,0,0,0,0,0,0,0,0,-2000,0,0,0,0,2000,-2000,-2000
061013,台積電麥證9A購03,0,0,0,0,2000,-2000,0,0,0,-2000,0,0,0,0,2000,-2000,-2000
061014,台積電麥證9A購04,0,0,0,0,2000,-2000,0,0,0,-2000,0,0,0,0,2000,-2000,-2000
05388P,南亞科元大95售04,0,0,0,0,0,0,0,0,0,-2000,0,0,0,0,2000,-2000,-2000
053979,健策元大98購01  ,0,0,0,0,0,0,0,0,0,-2000,0,0,0,0,2000,-2000,-2000
04617P,臺股指群益95售03,0,0,0,0,0,0,0,0,0,-2000,0,0,0,0,2000,-2000,-2000
049252,國巨元大96購01  ,0,0,0,0,0,0,0,0,0,-2000,0,0,0,107000,109000,-2000,-2000
03022X,富展01          ,0,0,0,0,0,0,0,0,0,-2000,0,0,0,0,2000,-2000,-2000
03430B,臺股指元大9B熊01,0,0,0,0,0,0,0,0,0,-2000,0,0,0,0,2000,-2000,-2000
047303,寶滬深元大96購01,0,0,0,0,0,0,0,0,0,-2000,0,0,0,0,2000,-2000,-2000
054315,訊芯凱基98購01  ,0,0,0,0,0,0,0,0,0,-2000,0,0,0,0,2000,-2000,-2000
052975,嘉聯益群益96購01,0,0,0,0,0,0,0,0,0,-2000,0,0,0,0,2000,-2000,-2000
054265,GIS元大96購03   ,0,0,0,0,0,0,0,0,0,-2000,0,0,0,117000,119000,-2000,-2000
052882,南電凱基96購02  ,0,0,0,0,0,0,0,0,0,-2000,0,0,0,1000,3000,-2000,-2000
054758,南亞國票9A購01  ,0,0,0,0,0,0,0,0,0,-2000,0,0,0,0,2000,-2000,-2000
053111,緯創兆豐97購01  ,0,0,0,0,0,0,0,0,0,-2000,0,0,0,12000,14000,-2000,-2000
055230,大毅國票98購01  ,0,0,0,0,0,0,0,0,0,-2000,0,0,0,29000,31000,-2000,-2000
053069,同欣電群益98購01,0,0,0,0,0,0,0,0,0,-2000,0,0,0,0,2000,-2000,-2000
053176,矽力群益96購02  ,0,0,0,0,0,0,0,0,0,-2000,0,0,0,17000,19000,-2000,-2000
055728,緯穎元大97購03  ,0,0,0,0,0,0,0,0,0,-2000,0,0,0,0,2000,-2000,-2000
055753,貿聯第一98購01  ,0,0,0,0,0,0,0,0,0,-2000,0,0,0,0,2000,-2000,-2000
05589P,大立光中信9A售01,0,0,0,0,0,0,0,0,0,-2000,0,0,0,0,2000,-2000,-2000
055598,欣興元大97購03  ,0,0,0,0,0,0,0,0,0,-2000,0,0,0,0,2000,-2000,-2000
056337,聯發科凱基98購06,0,0,0,0,0,0,0,0,0,-2000,0,0,0,0,2000,-2000,-2000
055701,亞德客富邦99購01,0,0,0,0,0,0,0,0,0,-2000,0,0,0,0,2000,-2000,-2000
055408,力成國泰98購01  ,0,0,0,0,0,0,0,0,0,-2000,0,0,0,76000,78000,-2000,-2000
058586,鴻海中信01購02  ,0,0,0,0,0,0,0,0,0,-2000,0,0,0,0,2000,-2000,-2000
058099,鴻海國泰9A購02  ,0,0,0,0,0,0,0,0,0,-2000,0,0,0,0,2000,-2000,-2000
058108,台郡台新99購01  ,0,0,0,0,0,0,0,0,0,-2000,0,0,0,30000,32000,-2000,-2000
058164,FBVIX凱基03購02 ,0,0,0,0,0,0,0,0,0,-2000,0,0,0,0,2000,-2000,-2000
058441,T50反1台新03購01,0,0,0,0,0,0,0,0,0,-2000,0,0,0,0,2000,-2000,-2000
057795,鴻海兆豐99購02  ,0,0,0,0,0,0,0,0,0,-2000,0,0,0,2000,4000,-2000,-2000
057085,立積統一9B購02  ,0,0,0,0,0,0,0,0,0,-2000,0,0,0,0,2000,-2000,-2000
056241,緯創群益97購01  ,0,0,0,0,0,0,0,0,0,-2000,0,0,0,27000,29000,-2000,-2000
056259,T50反1統一9A購01,0,0,0,0,0,0,0,0,0,-2000,0,0,0,0,2000,-2000,-2000
058020,大立光凱基99購03,0,0,0,0,0,0,0,0,0,-2000,0,0,0,0,2000,-2000,-2000
059236,鴻海凱基99購09  ,0,0,0,0,0,0,0,0,0,-2000,0,0,0,0,2000,-2000,-2000
059317,台積電元大99購34,0,0,0,0,0,0,0,0,0,-2000,0,0,0,553000,555000,-2000,-2000
05911P,南亞科永豐96售03,0,0,0,0,0,0,0,0,0,-2000,0,0,0,4000,6000,-2000,-2000
059159,上銀凱基99購05  ,0,0,0,0,0,0,0,0,0,-2000,0,0,0,30000,32000,-2000,-2000
059031,元石油中信03購01,0,0,0,0,0,0,0,0,0,-2000,0,0,0,0,2000,-2000,-2000
059077,FBVIX元大99購05 ,0,0,0,0,0,0,0,0,0,-2000,0,0,0,0,2000,-2000,-2000
059084,鴻海元大99購24  ,0,0,0,0,0,0,0,0,0,-2000,0,0,0,0,2000,-2000,-2000
05755P,臺股指中信99售04,0,0,0,0,0,0,0,0,0,-2000,0,0,0,10000,12000,-2000,-2000
058843,元油2X群益9C購02,0,0,0,0,0,0,0,0,0,-2000,0,0,0,0,2000,-2000,-2000
057253,高股息中信99購02,0,0,0,0,0,0,0,0,0,-2000,0,0,0,0,2000,-2000,-2000
056489,S&P反1國泰9A購01,0,0,0,0,0,0,0,0,0,-2000,0,0,0,0,2000,-2000,-2000
055521,S&P反1群益01購01,0,0,0,0,0,0,0,0,0,-2000,0,0,0,0,2000,-2000,-2000
05697P,友達凱基96售01  ,0,40000,-40000,0,0,0,0,0,0,38000,0,0,0,40000,2000,38000,-2000
3024,憶聲            ,15000,17000,-2000,0,0,0,0,0,0,0,0,0,0,0,0,0,-2000
3002,歐格            ,0,2000,-2000,0,0,0,0,0,0,0,0,0,0,0,0,0,-2000
3591,艾笛森          ,0,2000,-2000,0,0,0,0,0,0,0,0,0,0,0,0,0,-2000
6164,華興            ,0,2000,-2000,0,0,0,0,0,0,0,0,0,0,0,0,0,-2000
2496,卓越            ,2000,4000,-2000,0,0,0,0,0,0,0,0,0,0,0,0,0,-2000
2433,互盛電          ,2000,4000,-2000,0,0,0,0,0,0,0,0,0,0,0,0,0,-2000
2630,亞航            ,0,2000,-2000,0,0,0,0,0,0,0,0,0,0,0,0,0,-2000
07825P,健策國泰9B售04  ,0,0,0,0,0,0,0,0,0,-2000,0,0,0,0,2000,-2000,-2000
1541,錩泰            ,0,0,0,0,0,0,0,0,0,-2000,0,2000,-2000,0,0,0,-2000
1533,車王電          ,1000,3000,-2000,0,0,0,0,0,0,0,0,0,0,0,0,0,-2000
1232,大統益          ,0,2000,-2000,0,0,0,0,0,0,0,0,0,0,0,0,0,-2000
07551P,國巨元大9A售10  ,0,0,0,0,0,0,0,0,0,-2000,0,0,0,0,2000,-2000,-2000
07564P,臺股指中信01售01,0,0,0,0,0,0,0,0,0,-2000,0,0,0,0,2000,-2000,-2000
07519P,臺股指元大9B售10,0,0,0,0,0,0,0,0,0,-2000,0,0,0,8000,10000,-2000,-2000
07340P,鴻海凱基99售15  ,0,0,0,0,0,0,0,0,0,-2000,0,0,0,0,2000,-2000,-2000
07274P,上証2X群益01售01,0,0,0,0,0,0,0,0,0,-2000,0,0,0,0,2000,-2000,-2000
07137P,大立光中信9B售01,0,0,0,0,0,0,0,0,0,-2000,0,0,0,0,2000,-2000,-2000
07139P,元油2X群益9C售06,0,0,0,0,0,0,0,0,0,-2000,0,0,0,0,2000,-2000,-2000
6464,台數科          ,0,2000,-2000,0,0,0,0,0,0,0,0,0,0,0,0,0,-2000
9918,欣天然          ,0,2000,-2000,0,0,0,0,0,0,0,0,0,0,0,0,0,-2000
911616,杜康-DR         ,0,2000,-2000,0,0,0,0,0,0,0,0,0,0,0,0,0,-2000
060816,世紀鋼凱基9C購02,0,0,0,0,0,0,0,0,0,-3000,0,0,0,15000,18000,-3000,-3000
060830,T50反1國票9A購07,0,0,0,0,0,0,0,0,0,-3000,0,0,0,11000,14000,-3000,-3000
061192,奇鋐永豐9A購01  ,0,0,0,0,0,0,0,0,0,-3000,0,0,0,65000,68000,-3000,-3000
06800P,台灣50群益9A售02,0,0,0,0,0,0,0,0,0,-3000,0,0,0,0,3000,-3000,-3000
06583P,可成凱基98售07  ,0,0,0,0,0,0,0,0,0,-3000,0,0,0,0,3000,-3000,-3000
07120P,聯發科凱基99售09,0,0,0,0,0,0,0,0,0,-3000,0,0,0,0,3000,-3000,-3000
061403,滬深2X國票9A購06,0,0,0,0,0,0,0,0,0,-3000,0,0,0,0,3000,-3000,-3000
061435,元金2X凱基9C購03,0,0,0,0,0,0,0,0,0,-3000,0,0,0,2000,5000,-3000,-3000
06398P,禾伸堂凱基97售02,0,0,0,0,0,0,0,0,0,-3000,0,0,0,0,3000,-3000,-3000
059899,上証2X元大9C購04,0,0,0,0,0,0,0,0,0,-3000,0,0,0,0,3000,-3000,-3000
059831,聯詠康和99購01  ,0,0,0,0,0,0,0,0,0,-3000,0,0,0,20000,23000,-3000,-3000
059942,全新永豐99購04  ,0,0,0,0,0,0,0,0,0,-3000,0,0,0,3000,6000,-3000,-3000
059695,聯鈞永豐99購02  ,0,0,0,0,0,0,0,0,0,-3000,0,0,0,72000,75000,-3000,-3000
059643,日月光凱基99購02,0,0,0,0,0,0,0,0,0,-3000,0,0,0,91000,94000,-3000,-3000
059509,奇力新永豐99購02,0,0,0,0,0,0,0,0,0,-3000,0,0,0,0,3000,-3000,-3000
060346,華新科統一01購01,0,0,0,0,0,0,0,0,0,-3000,0,0,0,2000,5000,-3000,-3000
057699,可成群益9A購02  ,0,0,0,0,0,0,0,0,0,-3000,0,0,0,7000,10000,-3000,-3000
035275,台積電台新97購01,0,0,0,0,0,0,0,0,0,-3000,0,0,0,0,3000,-3000,-3000
039212,台達電台新9A購01,0,0,0,0,0,0,0,0,0,-3000,0,0,0,0,3000,-3000,-3000
052020,聯茂永豐95購02  ,0,0,0,0,0,0,0,0,0,-3000,0,0,0,0,3000,-3000,-3000
052025,國巨群益96購01  ,0,0,0,0,0,0,0,0,0,-3000,0,0,0,108000,111000,-3000,-3000
053885,全新兆豐96購01  ,0,0,0,0,0,0,0,0,0,-3000,0,0,0,0,3000,-3000,-3000
05267P,欣興元大95售08  ,0,0,0,0,0,0,0,0,0,-3000,0,0,0,0,3000,-3000,-3000
050671,超眾永豐94購04  ,0,0,0,0,0,0,0,0,0,-3000,0,0,0,0,3000,-3000,-3000
056895,技嘉元大98購01  ,0,0,0,0,0,0,0,0,0,-3000,0,0,0,2000,5000,-3000,-3000
057278,可成元大98購06  ,0,0,0,0,0,0,0,0,0,-3000,0,0,0,39000,42000,-3000,-3000
057180,華新科元大99購08,0,0,0,0,0,0,0,0,0,-3000,0,0,0,0,3000,-3000,-3000
058898,台積電元大99購20,0,0,0,0,0,0,0,0,0,-3000,0,0,0,0,3000,-3000,-3000
059324,智易元大99購04  ,0,0,0,0,0,0,0,0,0,-3000,0,0,0,0,3000,-3000,-3000
059345,禾伸堂凱基99購03,0,0,0,0,0,0,0,0,0,-3000,0,0,0,13000,16000,-3000,-3000
059216,台積電元大99購29,0,0,0,0,0,0,0,0,0,-3000,0,0,0,0,3000,-3000,-3000
059288,旺宏元富99購03  ,0,0,0,0,0,0,0,0,0,-3000,0,0,0,0,3000,-3000,-3000
057794,T50反1兆豐99購02,0,0,0,0,0,0,0,0,0,-3000,0,0,0,50000,53000,-3000,-3000
056103,聯發科永豐97購03,0,0,0,0,0,0,0,0,0,-3000,0,0,0,3000,6000,-3000,-3000
058400,聯發科元大99購09,0,0,0,0,0,0,0,0,0,-3000,0,0,0,64000,67000,-3000,-3000
058098,T50反1國泰9A購02,0,0,0,0,0,0,0,0,0,-3000,0,0,0,0,3000,-3000,-3000
058272,超眾永豐9A購01  ,0,0,0,0,0,0,0,0,0,-3000,0,0,0,0,3000,-3000,-3000
058583,臻鼎群益99購01  ,0,0,0,0,0,0,0,0,0,-3000,0,0,0,107000,110000,-3000,-3000
055291,京鼎元大97購02  ,0,0,0,0,0,0,0,0,0,-3000,0,0,0,368000,371000,-3000,-3000
055681,奇鋐凱基98購03  ,0,0,0,0,0,0,0,0,0,-3000,0,0,0,0,3000,-3000,-3000
8466,美吉吉-KY       ,0,3000,-3000,0,0,0,0,0,0,0,0,0,0,0,0,0,-3000
07339P,滬深2X凱基9A售03,0,0,0,0,0,0,0,0,0,-3000,0,0,0,0,3000,-3000,-3000
07371P,滬深2X元大99售07,0,0,0,0,0,0,0,0,0,-3000,0,0,0,0,3000,-3000,-3000
07362P,聯發科元大99售35,0,0,0,0,0,0,0,0,0,-3000,0,0,0,57000,60000,-3000,-3000
07360P,台積電元大99售46,0,0,0,0,0,0,0,0,0,-3000,0,0,0,0,3000,-3000,-3000
07584P,台積電永豐9A售02,0,0,0,0,0,0,0,0,0,-3000,0,0,0,0,3000,-3000,-3000
07491P,臺股指國票9A售09,0,0,0,0,0,0,0,0,0,-3000,0,0,0,0,3000,-3000,-3000
07445P,大立光凱基9A售08,0,0,0,0,0,0,0,0,0,-3000,0,0,0,15000,18000,-3000,-3000
1604,聲寶            ,22000,25000,-3000,0,0,0,0,0,0,0,0,0,0,0,0,0,-3000
1726,永記            ,0,3000,-3000,0,0,0,0,0,0,0,0,0,0,0,0,0,-3000
1614,三洋電          ,29000,32000,-3000,0,0,0,0,0,0,0,0,0,0,0,0,0,-3000
2516,新建            ,0,3000,-3000,0,0,0,0,0,0,0,0,0,0,0,0,0,-3000
2380,虹光            ,0,3000,-3000,0,0,0,0,0,0,0,0,0,0,0,0,0,-3000
2302,麗正            ,0,3000,-3000,0,0,0,0,0,0,0,0,0,0,0,0,0,-3000
2007,燁興            ,0,3000,-3000,0,0,0,0,0,0,0,0,0,0,0,0,0,-3000
2009,第一銅          ,4000,7000,-3000,0,0,0,0,0,0,0,0,0,0,0,0,0,-3000
1806,冠軍            ,2000,5000,-3000,0,0,0,0,0,0,0,0,0,0,0,0,0,-3000
6172,互億            ,0,3000,-3000,0,0,0,0,0,0,0,0,0,0,0,0,0,-3000
2904,匯僑            ,0,3000,-3000,0,0,0,0,0,0,0,0,0,0,0,0,0,-3000
059475,元石油群益99購02,0,0,0,0,0,0,0,0,0,-4000,0,0,0,0,4000,-4000,-4000
059405,台灣50國票01購01,0,0,0,0,0,0,0,0,0,-4000,0,0,0,2000,6000,-4000,-4000
059617,A50正2群益01購02,0,0,0,0,0,0,0,0,0,-4000,0,0,0,6000,10000,-4000,-4000
059700,鴻海凱基9A購16  ,0,0,0,0,0,0,0,0,0,-4000,0,0,0,0,4000,-4000,-4000
059768,上証2X群益9C購02,0,0,0,0,0,0,0,0,0,-4000,0,0,0,1000,5000,-4000,-4000
06306P,臺股指元大97售12,0,0,0,0,0,0,0,0,0,-4000,0,0,0,0,4000,-4000,-4000
06167P,欣興國票97售05  ,0,0,0,0,0,0,0,0,0,-4000,0,0,0,239000,243000,-4000,-4000
061581,貿聯元大9A購05  ,0,0,0,0,0,0,0,0,0,-4000,0,0,0,0,4000,-4000,-4000
07059P,華通國票9A售02  ,0,0,0,0,0,0,0,0,0,-4000,0,0,0,208000,212000,-4000,-4000
07057P,大立光康和9B售02,0,0,0,0,0,0,0,0,0,-4000,0,0,0,50000,54000,-4000,-4000
07112P,聯發科群益99售05,0,0,0,0,0,0,0,0,0,-4000,0,0,0,0,4000,-4000,-4000
06696P,台灣50國票99售01,0,0,0,0,0,0,0,0,0,-4000,0,0,0,0,4000,-4000,-4000
060961,台光電凱基9A購03,0,0,0,0,0,0,0,0,0,-4000,0,0,0,16000,20000,-4000,-4000
052454,力成元大95購02  ,0,0,0,0,0,0,0,0,0,-4000,0,0,0,0,4000,-4000,-4000
052536,聯茂國泰97購01  ,0,0,0,0,0,0,0,0,0,-4000,0,0,0,40000,44000,-4000,-4000
052648,茂林永豐96購01  ,0,0,0,0,0,0,0,0,0,-4000,0,0,0,0,4000,-4000,-4000
049498,茂林元大95購01  ,0,0,0,0,0,0,0,0,0,-4000,0,0,0,60000,64000,-4000,-4000
006203,元大MSCI台灣    ,0,0,0,0,0,0,0,0,0,-4000,0,0,0,0,4000,-4000,-4000
00743,國泰中國A150    ,1000,22000,-21000,0,0,0,0,0,0,17000,0,0,0,21000,4000,17000,-4000
057582,亞光中信9A購02  ,0,0,0,0,0,0,0,0,0,-4000,0,0,0,0,4000,-4000,-4000
052907,嘉澤國票97購01  ,0,0,0,0,0,0,0,0,0,-4000,0,0,0,0,4000,-4000,-4000
054271,中石化中信99購01,0,0,0,0,0,0,0,0,0,-4000,0,0,0,6000,10000,-4000,-4000
054360,智邦凱基96購03  ,0,0,0,0,0,0,0,0,0,-4000,0,0,0,0,4000,-4000,-4000
054408,義隆國票98購01  ,0,0,0,0,0,0,0,0,0,-4000,0,0,0,43000,47000,-4000,-4000
053376,鴻海元大96購19  ,0,0,0,0,0,0,0,0,0,-4000,0,0,0,700000,704000,-4000,-4000
053409,和碩兆豐96購02  ,0,0,0,0,0,0,0,0,0,-4000,0,0,0,0,4000,-4000,-4000
054038,T50反1元大98購04,0,0,0,0,0,0,0,0,0,-4000,0,0,0,0,4000,-4000,-4000
054702,智邦第一97購01  ,0,0,0,0,0,0,0,0,0,-4000,0,0,0,0,4000,-4000,-4000
05568P,台積電統一96售03,0,0,0,0,0,0,0,0,0,-4000,0,0,0,0,4000,-4000,-4000
055724,祥碩元大97購03  ,0,0,0,0,0,0,0,0,0,-4000,0,0,0,3000,7000,-4000,-4000
05877P,大立光群益96售06,0,0,0,0,0,0,0,0,0,-4000,0,0,0,0,4000,-4000,-4000
058765,緯穎群益99購03  ,0,0,0,0,0,0,0,0,0,-4000,0,0,0,61000,65000,-4000,-4000
058729,國巨永豐99購03  ,0,0,0,0,0,0,0,0,0,-4000,0,0,0,9000,13000,-4000,-4000
058161,T50反1日盛03購01,0,0,0,0,0,0,0,0,0,-4000,0,0,0,0,4000,-4000,-4000
058334,鴻海元富99購05  ,0,0,0,0,0,0,0,0,0,-4000,0,0,0,0,4000,-4000,-4000
056164,聯茂凱基98購03  ,0,0,0,0,0,0,0,0,0,-4000,0,0,0,6000,10000,-4000,-4000
056184,南亞科統一97購03,0,0,0,0,0,0,0,0,0,-4000,0,0,0,6000,10000,-4000,-4000
059225,臺股指元大99購18,0,0,0,0,0,0,0,0,0,-4000,0,0,0,0,4000,-4000,-4000
05921P,同欣電元大96售06,0,0,0,0,0,0,0,0,0,-4000,0,0,0,15000,19000,-4000,-4000
059150,臺股指國票99購13,0,0,0,0,0,0,0,0,0,-4000,0,0,0,0,4000,-4000,-4000
059137,電子類群益99購01,0,0,0,0,0,0,0,0,0,-4000,0,0,0,0,4000,-4000,-4000
057510,泰碩統一98購02  ,0,0,0,0,0,0,0,0,0,-4000,0,0,0,0,4000,-4000,-4000
05646P,聯發科國票96售05,0,0,0,0,0,0,0,0,0,-4000,0,0,0,0,4000,-4000,-4000
055480,元上證元大97購02,0,0,0,0,0,0,0,0,0,-4000,0,0,0,0,4000,-4000,-4000
3055,蔚華科          ,0,4000,-4000,0,0,0,0,0,0,0,0,0,0,0,0,0,-4000
4144,康聯-KY         ,3000,7000,-4000,0,0,0,0,0,0,0,0,0,0,0,0,0,-4000
4439,冠星-KY         ,0,4000,-4000,0,0,0,0,0,0,0,0,0,0,0,0,0,-4000
5007,三星            ,9000,13000,-4000,0,0,0,0,0,0,0,0,0,0,0,0,0,-4000
1903,士紙            ,1000,5000,-4000,0,0,0,0,0,0,0,0,0,0,0,0,0,-4000
2013,中鋼構          ,3000,7000,-4000,0,0,0,0,0,0,0,0,0,0,0,0,0,-4000
2611,志信            ,0,4000,-4000,0,0,0,0,0,0,0,0,0,0,0,0,0,-4000
1517,利奇            ,0,4000,-4000,0,0,0,0,0,0,0,0,0,0,0,0,0,-4000
1414,東和            ,0,4000,-4000,0,0,0,0,0,0,0,0,0,0,0,0,0,-4000
07257P,臺股指凱基99售37,0,0,0,0,0,0,0,0,0,-4000,0,0,0,180000,184000,-4000,-4000
9931,欣高            ,0,0,0,0,0,0,0,0,0,-4000,0,4000,-4000,0,0,0,-4000
9942,茂順            ,9000,13000,-4000,0,0,0,0,0,0,0,0,0,0,0,0,0,-4000
6579,研揚            ,0,4000,-4000,0,0,0,0,0,0,0,0,0,0,0,0,0,-4000
9930,中聯資源        ,6000,10521,-4521,0,0,0,0,0,0,0,0,0,0,0,0,0,-4521
060945,緯穎國票9A購02  ,0,0,0,0,0,0,0,0,0,-5000,0,0,0,0,5000,-5000,-5000
060823,旺宏元大9A購05  ,0,0,0,0,0,0,0,0,0,-5000,0,0,0,301000,306000,-5000,-5000
060864,可成永豐9A購01  ,0,0,0,0,0,0,0,0,0,-5000,0,0,0,2000,7000,-5000,-5000
06075P,智邦凱基97售02  ,0,0,0,0,0,0,0,0,0,-5000,0,0,0,0,5000,-5000,-5000
06783P,亞光元大98售03  ,0,0,0,0,0,0,0,0,0,-5000,0,0,0,0,5000,-5000,-5000
06972P,聯發科元大99售04,0,0,0,0,0,0,0,0,0,-5000,0,0,0,0,5000,-5000,-5000
06929P,鴻海元大99售11  ,0,0,0,0,0,0,0,0,0,-5000,0,0,0,0,5000,-5000,-5000
06926P,可成群益9A售04  ,0,0,0,0,0,0,0,0,0,-5000,0,0,0,0,5000,-5000,-5000
061521,亞光兆豐9A購02  ,0,0,0,0,0,0,0,0,0,-5000,0,0,0,0,5000,-5000,-5000
061533,友達統一9C購02  ,0,0,0,0,0,0,0,0,0,-5000,0,0,0,0,5000,-5000,-5000
061585,台積電富邦9B購06,0,0,0,0,0,0,0,0,0,-5000,0,0,0,0,5000,-5000,-5000
06234P,亞德客元大97售02,0,0,0,0,0,0,0,0,0,-5000,0,0,0,0,5000,-5000,-5000
06380P,臺股指統一98售02,0,0,0,0,0,0,0,0,0,-5000,0,0,0,0,5000,-5000,-5000
06486P,麗豐元大98售02  ,0,0,0,0,0,0,0,0,0,-5000,0,0,0,150000,155000,-5000,-5000
06494P,鴻海永昌98售03  ,0,0,0,0,0,0,0,0,0,-5000,0,0,0,0,5000,-5000,-5000
059783,旺宏元大99購17  ,0,0,0,0,0,0,0,0,0,-5000,0,0,0,10000,15000,-5000,-5000
059788,華新科元大9A購05,0,0,0,0,0,0,0,0,0,-5000,0,0,0,28000,33000,-5000,-5000
06008P,燿華統一96售04  ,0,0,0,0,0,0,0,0,0,-5000,0,0,0,0,5000,-5000,-5000
060031,旭富永豐99購02  ,0,0,0,0,0,0,0,0,0,-5000,0,0,0,30000,35000,-5000,-5000
059607,台積電富邦9C購04,0,0,0,0,0,0,0,0,0,-5000,0,0,0,520000,525000,-5000,-5000
059431,旺宏元大99購14  ,0,0,0,0,0,0,0,0,0,-5000,0,0,0,0,5000,-5000,-5000
059554,台灣50凱基99購08,0,0,0,0,0,0,0,0,0,-5000,0,0,0,0,5000,-5000,-5000
059548,台積電群益99購10,0,0,0,0,0,0,0,0,0,-5000,0,0,0,0,5000,-5000,-5000
060354,A50正2元富9A購02,0,0,0,0,0,0,0,0,0,-5000,0,0,0,5000,10000,-5000,-5000
060371,A50正2元富01購01,0,0,0,0,0,0,0,0,0,-5000,0,0,0,0,5000,-5000,-5000
060564,南亞科富邦9C購01,0,0,0,0,0,0,0,0,0,-5000,0,0,0,0,5000,-5000,-5000
060525,台積電中信01購04,0,0,0,0,0,0,0,0,0,-5000,0,0,0,1000,6000,-5000,-5000
060648,鴻海第一9A購01  ,0,0,0,0,0,0,0,0,0,-5000,0,0,0,0,5000,-5000,-5000
06068P,玉晶光康和97售01,0,0,0,0,0,0,0,0,0,-5000,0,0,0,60000,65000,-5000,-5000
05456P,鴻海凱基95售19  ,0,0,0,0,0,0,0,0,0,-5000,0,0,0,35000,40000,-5000,-5000
05487P,台表科凱基95售02,0,0,0,0,0,0,0,0,0,-5000,0,0,0,0,5000,-5000,-5000
054042,華泰元大96購01  ,0,0,0,0,0,0,0,0,0,-5000,0,0,0,73000,78000,-5000,-5000
05271P,國巨富邦97售01  ,0,0,0,0,0,0,0,0,0,-5000,0,0,0,0,5000,-5000,-5000
053219,祥碩凱基96購01  ,0,0,0,0,0,0,0,0,0,-5000,0,0,0,44000,49000,-5000,-5000
054282,泰鼎群益98購02  ,0,0,0,0,0,0,0,0,0,-5000,0,0,0,5000,10000,-5000,-5000
053033,智易兆豐97購01  ,0,0,0,0,0,0,0,0,0,-5000,0,0,0,0,5000,-5000,-5000
052980,上銀元大96購03  ,0,0,0,0,0,0,0,0,0,-5000,0,0,0,0,5000,-5000,-5000
052986,聯發科元大97購05,0,0,0,0,0,0,0,0,0,-5000,0,0,0,0,5000,-5000,-5000
057892,上証2X元富02購01,0,0,0,0,0,0,0,0,0,-5000,0,0,0,0,5000,-5000,-5000
057862,智邦凱基99購01  ,0,0,0,0,0,0,0,0,0,-5000,0,0,0,8000,13000,-5000,-5000
057657,國巨兆豐98購04  ,0,0,0,0,0,0,0,0,0,-5000,0,0,0,5000,10000,-5000,-5000
00736,國泰新興市場    ,40000,0,40000,0,0,0,0,0,0,-45000,0,0,0,101000,146000,-45000,-5000
00713,元大台灣高息低波,10000,2000,8000,0,0,0,0,0,0,-13000,0,0,0,0,13000,-13000,-5000
0057,富邦摩台        ,0,0,0,0,0,0,0,0,0,-5000,0,0,0,20000,25000,-5000,-5000
03662C,FBVIX凱基03牛01 ,0,0,0,0,0,0,0,0,0,-5000,0,0,0,10000,15000,-5000,-5000
03033X,元展30          ,0,0,0,0,0,0,0,0,0,-5000,0,0,0,3000,8000,-5000,-5000
049200,元黃金群益98購01,0,0,0,0,0,0,0,0,0,-5000,0,0,0,0,5000,-5000,-5000
04906P,欣興國票95售01  ,0,0,0,0,0,0,0,0,0,-5000,0,0,0,0,5000,-5000,-5000
049539,元油2X群益9A購01,0,0,0,0,0,0,0,0,0,-5000,0,0,0,0,5000,-5000,-5000
05173P,臺股指元大95售17,0,0,0,0,0,0,0,0,0,-5000,0,0,0,0,5000,-5000,-5000
04454P,大立光富邦98售02,0,0,0,0,0,0,0,0,0,-5000,0,0,0,0,5000,-5000,-5000
04544P,欣興富邦96售02  ,0,0,0,0,0,0,0,0,0,-5000,0,0,0,0,5000,-5000,-5000
051789,嘉澤國票96購01  ,0,0,0,0,0,0,0,0,0,-5000,0,0,0,0,5000,-5000,-5000
052133,華邦電凱基9B購01,0,0,0,0,0,0,0,0,0,-5000,0,0,0,0,5000,-5000,-5000
052083,S&P反1元大97購02,0,0,0,0,0,0,0,0,0,-5000,0,0,0,0,5000,-5000,-5000
052073,矽力統一95購03  ,0,0,0,0,0,0,0,0,0,-5000,0,0,0,0,5000,-5000,-5000
052220,T50反1凱基98購01,0,0,0,0,0,0,0,0,0,-5000,0,0,0,0,5000,-5000,-5000
052672,世紀鋼群益96購02,0,0,0,0,0,0,0,0,0,-5000,0,0,0,0,5000,-5000,-5000
052693,微星中信96購01  ,0,0,0,0,0,0,0,0,0,-5000,0,0,0,0,5000,-5000,-5000
053742,創意國票97購01  ,0,0,0,0,0,0,0,0,0,-5000,0,0,0,21000,26000,-5000,-5000
051600,新日興兆豐96購02,0,0,0,0,0,0,0,0,0,-5000,0,0,0,0,5000,-5000,-5000
051490,世芯凱基96購01  ,0,0,0,0,0,0,0,0,0,-5000,0,0,0,5000,10000,-5000,-5000
055017,緯穎元富97購01  ,0,0,0,0,0,0,0,0,0,-5000,0,0,0,0,5000,-5000,-5000
049759,元黃金富邦9A購01,0,0,0,0,0,0,0,0,0,-5000,0,0,0,0,5000,-5000,-5000
050171,臺指反元大97購03,0,0,0,0,0,0,0,0,0,-5000,0,0,0,0,5000,-5000,-5000
050705,南電凱基96購01  ,0,0,0,0,0,0,0,0,0,-5000,0,0,0,2000,7000,-5000,-5000
057264,新光金兆豐98購01,0,0,0,0,0,0,0,0,0,-5000,0,0,0,0,5000,-5000,-5000
057252,牧德元富98購01  ,0,0,0,0,0,0,0,0,0,-5000,0,0,0,10000,15000,-5000,-5000
056081,T50反1統一99購02,0,0,0,0,0,0,0,0,0,-5000,0,0,0,0,5000,-5000,-5000
057818,泰碩元大9A購01  ,0,0,0,0,0,0,0,0,0,-5000,0,0,0,5000,10000,-5000,-5000
056888,元油2X元大99購06,0,0,0,0,0,0,0,0,0,-5000,0,0,0,0,5000,-5000,-5000
056570,旺宏元大98購07  ,0,0,0,0,0,0,0,0,0,-5000,0,0,0,0,5000,-5000,-5000
056600,聯茂元富98購01  ,0,0,0,0,0,0,0,0,0,-5000,0,0,0,0,5000,-5000,-5000
05748P,臺股指群益99售02,0,0,0,0,0,0,0,0,0,-5000,0,0,0,0,5000,-5000,-5000
057368,微星元大98購02  ,0,0,0,0,0,0,0,0,0,-5000,0,0,0,130000,135000,-5000,-5000
058799,晶技元大99購04  ,0,0,0,0,0,0,0,0,0,-5000,0,0,0,1000,6000,-5000,-5000
059167,聯發科凱基99購11,0,0,0,0,0,0,0,0,0,-5000,0,0,0,0,5000,-5000,-5000
059098,元油2X統一9B購03,0,0,0,0,0,0,0,0,0,-5000,0,0,0,0,5000,-5000,-5000
059266,緯創中信01購01  ,0,0,0,0,0,0,0,0,0,-5000,0,0,0,5000,10000,-5000,-5000
059342,聯發科凱基9A購05,0,0,0,0,0,0,0,0,0,-5000,0,0,0,5000,10000,-5000,-5000
059311,元石油元大99購04,0,0,0,0,0,0,0,0,0,-5000,0,0,0,231000,236000,-5000,-5000
057063,立積國泰9A購01  ,0,0,0,0,0,0,0,0,0,-5000,0,0,0,40000,45000,-5000,-5000
057033,A50反1元大9B購02,0,0,0,0,0,0,0,0,0,-5000,0,0,0,10000,15000,-5000,-5000
056135,緯創元大98購01  ,0,0,0,0,0,0,0,0,0,-5000,0,0,0,38000,43000,-5000,-5000
057132,華新科凱基98購05,0,0,0,0,0,0,0,0,0,-5000,0,0,0,0,5000,-5000,-5000
058411,技嘉兆豐99購01  ,0,0,0,0,0,0,0,0,0,-5000,0,0,0,5000,10000,-5000,-5000
058412,聯發科兆豐99購01,0,0,0,0,0,0,0,0,0,-5000,0,0,0,54000,59000,-5000,-5000
058193,緯穎永豐99購01  ,0,0,0,0,0,0,0,0,0,-5000,0,0,0,10000,15000,-5000,-5000
058070,華新科凱基98購07,0,0,0,0,0,0,0,0,0,-5000,0,0,0,0,5000,-5000,-5000
058671,旺宏群益9A購01  ,0,0,0,0,0,0,0,0,0,-5000,0,0,0,0,5000,-5000,-5000
058611,欣興元大99購06  ,0,0,0,0,0,0,0,0,0,-5000,0,0,0,66000,71000,-5000,-5000
055715,智邦元大97購04  ,0,0,0,0,0,0,0,0,0,-5000,0,0,0,5000,10000,-5000,-5000
055987,台表科元富97購01,0,0,0,0,0,0,0,0,0,-5000,0,0,0,0,5000,-5000,-5000
055405,華泰國泰98購01  ,0,0,0,0,0,0,0,0,0,-5000,0,0,0,0,5000,-5000,-5000
055566,台表科凱基97購03,0,0,0,0,0,0,0,0,0,-5000,0,0,0,5000,10000,-5000,-5000
8422,可寧衛          ,50000,55000,-5000,0,0,0,0,0,0,0,0,0,0,0,0,0,-5000
07141P,台灣50國票9A售03,0,0,0,0,0,0,0,0,0,-5000,0,0,0,0,5000,-5000,-5000
07301P,臺股指元大9A售34,0,0,0,0,0,0,0,0,0,-5000,0,0,0,15000,20000,-5000,-5000
07465P,台灣50元大9C售24,0,0,0,0,0,0,0,0,0,-5000,0,0,0,0,5000,-5000,-5000
07378P,大立光元大99售29,0,0,0,0,0,0,0,0,0,-5000,0,0,0,0,5000,-5000,-5000
1234,黑松            ,9000,14000,-5000,0,0,0,0,0,0,0,0,0,0,0,0,0,-5000
07817P,同欣電群益9A售02,0,0,0,0,0,0,0,0,0,-5000,0,0,0,0,5000,-5000,-5000
07819P,旺宏國票9B售01  ,0,0,0,0,0,0,0,0,0,-5000,0,0,0,0,5000,-5000,-5000
07784P,華新科富邦9B售04,0,0,0,0,0,0,0,0,0,-5000,0,0,0,0,5000,-5000,-5000
07720P,臺股指群益9A售09,0,0,0,0,0,0,0,0,0,-5000,0,0,0,20000,25000,-5000,-5000
2852,第一保          ,2000,7000,-5000,0,0,0,0,0,0,0,0,0,0,0,0,0,-5000
2545,皇翔            ,6000,11000,-5000,0,0,0,0,0,0,0,0,0,0,0,0,0,-5000
2109,華豐            ,8000,13000,-5000,0,0,0,0,0,0,0,0,0,0,0,0,0,-5000
2069,運錩            ,0,5000,-5000,0,0,0,0,0,0,0,0,0,0,0,0,0,-5000
2420,新巨            ,31000,36000,-5000,0,0,0,0,0,0,0,0,0,0,0,0,0,-5000
3209,全科            ,17000,22000,-5000,0,0,0,0,0,0,0,0,0,0,0,0,0,-5000
3016,嘉晶            ,332000,332000,0,0,0,0,0,0,0,-5000,0,0,0,62000,67000,-5000,-5000
060696,道瓊反國泰9C購01,0,0,0,0,0,0,0,0,0,-6000,0,0,0,20000,26000,-6000,-6000
060579,上証2X群益9C購04,0,0,0,0,0,0,0,0,0,-6000,0,0,0,1000,7000,-6000,-6000
060602,京元電凱基9A購01,0,0,0,0,0,0,0,0,0,-6000,0,0,0,0,6000,-6000,-6000
06055P,華通凱基97售04  ,0,0,0,0,0,0,0,0,0,-6000,0,0,0,0,6000,-6000,-6000
060334,群光康和9A購01  ,0,0,0,0,0,0,0,0,0,-6000,0,0,0,0,6000,-6000,-6000
060228,亞德客元大9A購01,0,0,0,0,0,0,0,0,0,-6000,0,0,0,80000,86000,-6000,-6000
05943P,欣興凱基96售03  ,0,0,0,0,0,0,0,0,0,-6000,0,0,0,46000,52000,-6000,-6000
059600,緯穎元大99購07  ,0,0,0,0,0,0,0,0,0,-6000,0,0,0,0,6000,-6000,-6000
059823,奇力新凱基99購07,0,0,0,0,0,0,0,0,0,-6000,0,0,0,0,6000,-6000,-6000
059861,聯發科群益9A購01,0,0,0,0,0,0,0,0,0,-6000,0,0,0,57000,63000,-6000,-6000
06416P,大立光群益97售06,0,0,0,0,0,0,0,0,0,-6000,0,0,0,0,6000,-6000,-6000
06342P,世芯統一98售01  ,0,0,0,0,0,0,0,0,0,-6000,0,0,0,0,6000,-6000,-6000
061499,嘉晶國票9A購03  ,0,0,0,0,0,0,0,0,0,-6000,0,0,0,3000,9000,-6000,-6000
061495,聯發科國票9B購01,15000,0,15000,0,0,0,0,0,0,-21000,0,0,0,10000,31000,-21000,-6000
06726P,欣興元富98售04  ,0,0,0,0,0,0,0,0,0,-6000,0,0,0,0,6000,-6000,-6000
06686P,麗豐永豐98售02  ,0,0,0,0,0,0,0,0,0,-6000,0,0,0,24000,30000,-6000,-6000
061205,旺宏元大9A購11  ,0,0,0,0,0,0,0,0,0,-6000,0,0,0,230000,236000,-6000,-6000
061272,超眾凱基9A購03  ,0,0,0,0,0,0,0,0,0,-6000,0,0,0,7000,13000,-6000,-6000
052515,矽力凱基95購02  ,0,0,0,0,0,0,0,0,0,-6000,0,0,0,0,6000,-6000,-6000
051605,奇力新群益95購02,0,0,0,0,0,0,0,0,0,-6000,0,0,0,0,6000,-6000,-6000
052060,旺宏國票96購02  ,0,0,0,0,0,0,0,0,0,-6000,0,0,0,0,6000,-6000,-6000
051666,旺宏元大96購05  ,0,0,0,0,0,0,0,0,0,-6000,0,0,0,0,6000,-6000,-6000
04928P,大立光凱基95售07,0,0,0,0,0,0,0,0,0,-6000,0,0,0,0,6000,-6000,-6000
0052,富邦科技        ,0,1000,-1000,0,0,0,0,0,0,-5000,0,0,0,117000,122000,-5000,-6000
00645,富邦日本        ,0,0,0,0,0,0,0,0,0,-6000,0,0,0,67000,73000,-6000,-6000
00866,新光Shiller CAPE,0,0,0,0,0,0,0,0,0,-6000,0,0,0,26000,32000,-6000,-6000
054216,聯茂國票97購03  ,0,0,0,0,0,0,0,0,0,-6000,0,0,0,11000,17000,-6000,-6000
052772,台虹群益96購01  ,0,0,0,0,0,0,0,0,0,-6000,0,0,0,54000,60000,-6000,-6000
053135,信邦國票96購01  ,0,0,0,0,0,0,0,0,0,-6000,0,0,0,0,6000,-6000,-6000
054766,智原國票98購01  ,0,0,0,0,0,0,0,0,0,-6000,0,0,0,24000,30000,-6000,-6000
054788,華新科群益98購02,0,0,0,0,0,0,0,0,0,-6000,0,0,0,0,6000,-6000,-6000
055727,矽力元大97購02  ,0,0,0,0,0,0,0,0,0,-6000,0,0,0,2000,8000,-6000,-6000
058589,群創中信01購01  ,0,0,0,0,0,0,0,0,0,-6000,0,0,0,32000,38000,-6000,-6000
058744,FBVIX凱基9C購03 ,0,0,0,0,0,0,0,0,0,-6000,0,0,0,0,6000,-6000,-6000
055267,百和永豐97購01  ,0,0,0,0,0,0,0,0,0,-6000,0,0,0,0,6000,-6000,-6000
056092,亞德客元富97購02,0,0,0,0,0,0,0,0,0,-6000,0,0,0,33000,39000,-6000,-6000
059326,康友元大99購01  ,0,0,0,0,0,0,0,0,0,-6000,0,0,0,202000,208000,-6000,-6000
059262,致茂中信01購01  ,0,0,0,0,0,0,0,0,0,-6000,0,0,0,25000,31000,-6000,-6000
059212,鴻海元大99購28  ,0,0,0,0,0,0,0,0,0,-6000,0,0,0,147000,153000,-6000,-6000
059065,南電凱基9A購01  ,0,0,0,0,0,0,0,0,0,-6000,0,0,0,118000,124000,-6000,-6000
059165,南亞科凱基99購04,0,0,0,0,0,0,0,0,0,-6000,0,0,0,25000,31000,-6000,-6000
058961,台灣50兆豐9C購01,0,0,0,0,0,0,0,0,0,-6000,0,0,0,0,6000,-6000,-6000
056742,玉晶光凱基9A購01,0,0,0,0,0,0,0,0,0,-6000,0,0,0,47000,53000,-6000,-6000
057179,可成元大98購04  ,0,0,0,0,0,0,0,0,0,-6000,0,0,0,66000,72000,-6000,-6000
057269,鈺齊兆豐98購01  ,0,0,0,0,0,0,0,0,0,-6000,0,0,0,3000,9000,-6000,-6000
056504,國巨永豐98購02  ,0,0,0,0,0,0,0,0,0,-6000,0,0,0,19000,25000,-6000,-6000
05723P,華通永豐96售03  ,0,0,0,0,0,0,0,0,0,-6000,0,0,0,9000,15000,-6000,-6000
3694,海華            ,2000,8000,-6000,0,0,0,0,0,0,0,0,0,0,0,0,0,-6000
4763,材料-KY         ,27000,35000,-8000,0,0,0,0,0,0,2000,5000,3000,2000,0,0,0,-6000
6215,和椿            ,5000,0,5000,0,0,0,0,0,0,-11000,0,11000,-11000,0,0,0,-6000
2022,聚亨            ,0,6000,-6000,0,0,0,0,0,0,0,0,0,0,0,0,0,-6000
2030,彰源            ,33000,39000,-6000,0,0,0,0,0,0,0,0,0,0,0,0,0,-6000
2497,怡利電          ,2000,8000,-6000,0,0,0,0,0,0,0,0,0,0,0,0,0,-6000
2616,山隆            ,0,6000,-6000,0,0,0,0,0,0,0,0,0,0,0,0,0,-6000
07769P,國巨國票9A售10  ,0,0,0,0,0,0,0,0,0,-6000,0,0,0,0,6000,-6000,-6000
1235,興泰            ,0,6000,-6000,0,0,0,0,0,0,0,0,0,0,0,0,0,-6000
1456,怡華            ,0,6000,-6000,0,0,0,0,0,0,0,0,0,0,0,0,0,-6000
1506,正道            ,5000,11000,-6000,0,0,0,0,0,0,0,0,0,0,0,0,0,-6000
07280P,FBVIX凱基99售01 ,0,0,0,0,0,0,0,0,0,-6000,0,0,0,0,6000,-6000,-6000
9943,好樂迪          ,42000,48000,-6000,0,0,0,0,0,0,0,0,0,0,0,0,0,-6000
8039,台虹            ,415000,420000,-5000,0,0,0,0,0,0,-1000,14000,4000,10000,33000,44000,-11000,-6000
060906,旺宏元大9A購07  ,0,0,0,0,0,0,0,0,0,-7000,0,0,0,22000,29000,-7000,-7000
06090P,旺宏統一97售06  ,0,0,0,0,0,0,0,0,0,-7000,0,0,0,0,7000,-7000,-7000
06688P,鴻海中信02售01  ,0,0,0,0,0,0,0,0,0,-7000,0,0,0,0,7000,-7000,-7000
06558P,旺宏元富98售02  ,0,0,0,0,0,0,0,0,0,-7000,0,0,0,0,7000,-7000,-7000
06633P,國巨國票99售01  ,0,0,0,0,0,0,0,0,0,-7000,0,0,0,0,7000,-7000,-7000
06736P,新日興凱基98售03,0,0,0,0,0,0,0,0,0,-7000,0,0,0,4000,11000,-7000,-7000
06882P,聯發科群益98售07,0,0,0,0,0,0,0,0,0,-7000,0,0,0,0,7000,-7000,-7000
07011P,宏達電凱基99售02,0,0,0,0,0,0,0,0,0,-7000,0,0,0,3000,10000,-7000,-7000
06249P,億光統一97售02  ,0,0,0,0,0,0,0,0,0,-7000,0,0,0,5000,12000,-7000,-7000
059863,和大凱基99購01  ,0,0,0,0,0,0,0,0,0,-7000,0,0,0,42000,49000,-7000,-7000
059931,緯穎富邦9A購01  ,0,0,0,0,0,0,0,0,0,-7000,0,0,0,53000,60000,-7000,-7000
060060,台積電兆豐99購05,0,0,0,0,0,0,0,0,0,-7000,0,0,0,38000,45000,-7000,-7000
059541,T50正2康和99購01,0,0,0,0,0,0,0,0,0,-7000,0,0,0,7000,14000,-7000,-7000
060633,玉晶光富邦02購01,0,0,0,0,0,0,0,0,0,-7000,0,0,0,5000,12000,-7000,-7000
055227,聯發科國票98購02,0,0,0,0,0,0,0,0,0,-7000,0,0,0,3000,10000,-7000,-7000
054538,台光電國票98購01,0,0,0,0,0,0,0,0,0,-7000,0,0,0,38000,45000,-7000,-7000
054923,晶技凱基98購01  ,0,0,0,0,0,0,0,0,0,-7000,0,0,0,12000,19000,-7000,-7000
057596,聯茂兆豐99購01  ,0,0,0,0,0,0,0,0,0,-7000,0,0,0,15000,22000,-7000,-7000
020008,元大特股高息N   ,0,0,0,0,0,0,0,0,0,-7000,0,0,0,8000,15000,-7000,-7000
00763U,街口道瓊銅      ,0,0,0,0,0,0,0,0,0,-7000,0,0,0,26000,33000,-7000,-7000
03010X,元展10          ,0,0,0,0,0,0,0,0,0,-7000,0,0,0,0,7000,-7000,-7000
04293P,滬深2X元大96售02,0,0,0,0,0,0,0,0,0,-7000,0,0,0,0,7000,-7000,-7000
052203,T50反1中信99購03,0,0,0,0,0,0,0,0,0,-7000,0,0,0,3000,10000,-7000,-7000
051537,牧德國票96購01  ,0,0,0,0,0,0,0,0,0,-7000,0,0,0,3000,10000,-7000,-7000
053784,奇力新元大97購02,0,0,0,0,0,0,0,0,0,-7000,0,0,0,84000,91000,-7000,-7000
050694,國巨凱基96購03  ,0,0,0,0,0,0,0,0,0,-7000,0,0,0,20000,27000,-7000,-7000
055545,國巨凱基97購06  ,0,0,0,0,0,0,0,0,0,-7000,0,0,0,3000,10000,-7000,-7000
056080,世紀鋼元大97購03,0,0,0,0,0,0,0,0,0,-7000,0,0,0,0,7000,-7000,-7000
056581,超眾元大99購01  ,0,0,0,0,0,0,0,0,0,-7000,0,0,0,0,7000,-7000,-7000
057143,台郡兆豐98購01  ,0,0,0,0,0,0,0,0,0,-7000,0,0,0,53000,60000,-7000,-7000
058127,FBVIX元大9C購01 ,0,0,0,0,0,0,0,0,0,-7000,0,0,0,0,7000,-7000,-7000
056209,超眾永豐97購02  ,0,0,0,0,0,0,0,0,0,-7000,0,0,0,1000,8000,-7000,-7000
058273,同欣電永豐99購01,0,0,0,0,0,0,0,0,0,-7000,0,0,0,0,7000,-7000,-7000
058495,元大金群益9B購01,0,0,0,0,0,0,0,0,0,-7000,0,0,0,79000,86000,-7000,-7000
058786,元黃金元大99購01,0,0,0,0,0,0,0,0,0,-7000,0,0,0,0,7000,-7000,-7000
058698,華通元大99購05  ,0,0,0,0,0,0,0,0,0,-7000,0,0,0,0,7000,-7000,-7000
055875,光罩元富97購02  ,0,0,0,0,0,0,0,0,0,-7000,0,0,0,61000,68000,-7000,-7000
055407,祥碩國泰98購01  ,0,0,0,0,0,0,0,0,0,-7000,0,0,0,57000,64000,-7000,-7000
8473,山林水          ,0,7000,-7000,0,0,0,0,0,0,0,0,0,0,0,0,0,-7000
07267P,臺股指元大99售23,0,0,0,0,0,0,0,0,0,-7000,0,0,0,0,7000,-7000,-7000
1474,弘裕            ,4000,11000,-7000,0,0,0,0,0,0,0,0,0,0,0,0,0,-7000
1603,華電            ,6000,13000,-7000,0,0,0,0,0,0,0,0,0,0,0,0,0,-7000
2543,皇昌            ,0,7000,-7000,0,0,0,0,0,0,0,0,0,0,0,0,0,-7000
2459,敦吉            ,10000,16000,-6000,0,0,0,0,0,0,-1000,0,1000,-1000,0,0,0,-7000
3605,宏致            ,109000,116000,-7000,0,0,0,0,0,0,0,0,0,0,0,0,0,-7000
060386,台勝科凱基9B購01,0,0,0,0,0,0,0,0,0,-8000,0,0,0,30000,38000,-8000,-8000
059544,創意亞東99購01  ,0,0,0,0,0,0,0,0,0,-8000,0,0,0,0,8000,-8000,-8000
059667,矽力元大99購01  ,0,0,0,0,0,0,0,0,0,-8000,0,0,0,1000,9000,-8000,-8000
060012,電子類群益99購02,0,0,0,0,0,0,0,0,0,-8000,0,0,0,0,8000,-8000,-8000
059925,可成國泰9B購01  ,0,0,0,0,0,0,0,0,0,-8000,0,0,0,27000,35000,-8000,-8000
06265P,美律凱基97售01  ,0,0,0,0,0,0,0,0,0,-8000,0,0,0,0,8000,-8000,-8000
061488,奇力新兆豐9A購01,0,0,0,0,0,0,0,0,0,-8000,0,0,0,0,8000,-8000,-8000
06886P,旺宏元大99售07  ,0,0,0,0,0,0,0,0,0,-8000,0,0,0,0,8000,-8000,-8000
06102P,智邦凱基97售03  ,0,0,0,0,0,0,0,0,0,-8000,0,0,0,32000,40000,-8000,-8000
060969,台灣50元大9C購29,0,0,0,0,0,0,0,0,0,-8000,0,0,0,0,8000,-8000,-8000
060766,世芯元大9A購02  ,0,0,0,0,0,0,0,0,0,-8000,0,0,0,409000,417000,-8000,-8000
060808,欣興群益9A購01  ,0,0,0,0,0,0,0,0,0,-8000,0,0,0,63000,71000,-8000,-8000
061254,道瓊反凱基9A購02,0,0,0,0,0,0,0,0,0,-8000,0,0,0,2000,10000,-8000,-8000
053983,樺漢元大97購02  ,0,0,0,0,0,0,0,0,0,-8000,0,0,0,0,8000,-8000,-8000
055152,旺宏元大98購04  ,0,0,0,0,0,0,0,0,0,-8000,0,0,0,0,8000,-8000,-8000
03810P,大立光富邦98售01,0,0,0,0,0,0,0,0,0,-8000,0,0,0,0,8000,-8000,-8000
04908P,南電國票95售03  ,0,0,0,0,0,0,0,0,0,-8000,0,0,0,52000,60000,-8000,-8000
057843,晶技永豐98購02  ,0,0,0,0,0,0,0,0,0,-8000,0,0,0,22000,30000,-8000,-8000
057659,台表科兆豐98購01,0,0,0,0,0,0,0,0,0,-8000,0,0,0,10000,18000,-8000,-8000
057744,健策永豐98購02  ,0,0,0,0,0,0,0,0,0,-8000,0,0,0,27000,35000,-8000,-8000
054169,上緯控凱基98購01,0,0,0,0,0,0,0,0,0,-8000,0,0,0,3000,11000,-8000,-8000
055207,致新中信99購01  ,0,0,0,0,0,0,0,0,0,-8000,0,0,0,7000,15000,-8000,-8000
055587,智邦元大97購02  ,0,0,0,0,0,0,0,0,0,-8000,0,0,0,3000,11000,-8000,-8000
055798,聯茂富邦98購01  ,0,0,0,0,0,0,0,0,0,-8000,0,0,0,32000,40000,-8000,-8000
05865P,大立光元大96售09,0,0,0,0,0,0,0,0,0,-8000,0,0,0,0,8000,-8000,-8000
058022,樺漢凱基99購02  ,0,0,0,0,0,0,0,0,0,-8000,0,0,0,10000,18000,-8000,-8000
058932,FBVIX台新99購01 ,0,0,0,0,0,0,0,0,0,-8000,0,0,0,1000,9000,-8000,-8000
058933,FBVIX台新9B購01 ,0,0,0,0,0,0,0,0,0,-8000,0,0,0,0,8000,-8000,-8000
057381,微星國泰9A購01  ,0,0,0,0,0,0,0,0,0,-8000,0,0,0,0,8000,-8000,-8000
057360,元油2X元大98購10,0,0,0,0,0,0,0,0,0,-8000,0,0,0,0,8000,-8000,-8000
057422,欣興凱基98購04  ,0,0,0,0,0,0,0,0,0,-8000,0,0,0,0,8000,-8000,-8000
059180,祥碩元富9A購01  ,0,0,0,0,0,0,0,0,0,-8000,0,0,0,531000,539000,-8000,-8000
059292,華新科元富9B購02,0,0,0,0,0,0,0,0,0,-8000,0,0,0,5000,13000,-8000,-8000
3305,昇貿            ,0,8000,-8000,0,0,0,0,0,0,0,0,0,0,0,0,0,-8000
3311,閎暉            ,13000,21000,-8000,0,0,0,0,0,0,0,0,0,0,0,0,0,-8000
2444,兆勁            ,106000,114000,-8000,0,0,0,0,0,0,0,0,0,0,0,0,0,-8000
2305,全友            ,1000,9000,-8000,0,0,0,0,0,0,0,0,0,0,0,0,0,-8000
07758P,台積電國票9A售06,0,0,0,0,0,0,0,0,0,-8000,0,0,0,0,8000,-8000,-8000
1104,環泥            ,2000,10000,-8000,0,0,0,0,0,0,0,0,0,0,0,0,0,-8000
061388,台積電群益9A購05,0,0,0,0,0,0,0,0,0,-9000,0,0,0,0,9000,-9000,-9000
061172,大立光麥證9A購02,0,0,0,0,9000,-9000,0,0,0,-9000,0,0,0,0,9000,-9000,-9000
061086,FBVIX統一01購01 ,0,0,0,0,0,0,0,0,0,-9000,0,0,0,0,9000,-9000,-9000
060881,玉山金中信02購01,0,0,0,0,0,0,0,0,0,-9000,0,0,0,40000,49000,-9000,-9000
060843,大立光國票9A購06,0,0,0,0,0,0,0,0,0,-9000,0,0,0,0,9000,-9000,-9000
060844,大立光國票9A購07,0,0,0,0,0,0,0,0,0,-9000,0,0,0,0,9000,-9000,-9000
07036P,台灣50台新9C售01,0,0,0,0,0,0,0,0,0,-9000,0,0,0,341000,350000,-9000,-9000
061498,大立光國票9A購10,0,0,0,0,0,0,0,0,0,-9000,0,0,0,0,9000,-9000,-9000
059829,超眾凱基99購05  ,0,0,0,0,0,0,0,0,0,-9000,0,0,0,107000,116000,-9000,-9000
059488,大立光兆豐99購03,0,0,0,0,0,0,0,0,0,-9000,0,0,0,0,9000,-9000,-9000
060275,元黃金元大9A購01,0,0,0,0,0,0,0,0,0,-9000,0,0,0,31000,40000,-9000,-9000
060557,南電凱基9A購02  ,0,0,0,0,0,0,0,0,0,-9000,0,0,0,27000,36000,-9000,-9000
05454P,奇鋐群益95售04  ,0,0,0,0,0,0,0,0,0,-9000,0,0,0,19000,28000,-9000,-9000
054649,聯茂群益97購01  ,0,0,0,0,0,0,0,0,0,-9000,0,0,0,0,9000,-9000,-9000
054641,祥碩中信98購01  ,0,0,0,0,0,0,0,0,0,-9000,0,0,0,11000,20000,-9000,-9000
054845,智邦兆豐98購01  ,0,0,0,0,0,0,0,0,0,-9000,0,0,0,19000,28000,-9000,-9000
053340,建準國票97購01  ,0,0,0,0,0,0,0,0,0,-9000,0,0,0,0,9000,-9000,-9000
052933,祥碩元大96購01  ,0,0,0,0,0,0,0,0,0,-9000,0,0,0,5000,14000,-9000,-9000
057773,技嘉群益9A購02  ,0,0,0,0,0,0,0,0,0,-9000,0,0,0,0,9000,-9000,-9000
056991,牧德兆豐98購01  ,0,0,0,0,0,0,0,0,0,-9000,0,0,0,222000,231000,-9000,-9000
00851,台新全球AI      ,0,0,0,0,0,0,0,0,0,-9000,0,0,0,12000,21000,-9000,-9000
045055,聯發科元富98購03,0,0,0,0,0,0,0,0,0,-9000,0,0,0,3000,12000,-9000,-9000
053896,麗豐群益97購01  ,0,0,0,0,0,0,0,0,0,-9000,0,0,0,0,9000,-9000,-9000
051603,深中小群益99購03,0,0,0,0,0,0,0,0,0,-9000,0,0,0,0,9000,-9000,-9000
059199,欣興永豐99購02  ,0,0,0,0,0,0,0,0,0,-9000,0,0,0,3000,12000,-9000,-9000
059148,百和國票9A購01  ,0,0,0,0,0,0,0,0,0,-9000,0,0,0,6000,15000,-9000,-9000
059116,晶豪科永豐99購01,0,0,0,0,0,0,0,0,0,-9000,0,0,0,38000,47000,-9000,-9000
05901P,臺股指凱基9C售01,0,0,0,0,0,0,0,0,0,-9000,0,0,0,0,9000,-9000,-9000
05744P,台表科元大96售04,0,0,0,0,0,0,0,0,0,-9000,0,0,0,10000,19000,-9000,-9000
05752P,台積電中信96售06,0,0,0,0,0,0,0,0,0,-9000,0,0,0,10000,19000,-9000,-9000
058967,可成麥證99購01  ,0,0,0,4000,13000,-9000,0,0,0,-9000,0,0,0,4000,13000,-9000,-9000
058835,元油2X中信9C購02,0,0,0,0,0,0,0,0,0,-9000,0,0,0,0,9000,-9000,-9000
056010,力成中信97購01  ,0,0,0,0,0,0,0,0,0,-9000,0,0,0,40000,49000,-9000,-9000
05873P,華通群益97售02  ,0,0,0,0,0,0,0,0,0,-9000,0,0,0,0,9000,-9000,-9000
055257,景碩統一97購01  ,0,0,0,0,0,0,0,0,0,-9000,0,0,0,0,9000,-9000,-9000
05529P,臺股指群益96售02,2000,0,2000,0,0,0,0,0,0,-11000,0,0,0,1000,12000,-11000,-9000
07668P,旺宏元大9A售10  ,0,0,0,0,0,0,0,0,0,-9000,0,0,0,0,9000,-9000,-9000
1340,勝悅-KY         ,4000,13000,-9000,0,0,0,0,0,0,0,0,0,0,0,0,0,-9000
07164P,臺股指群益99售15,0,0,0,0,0,0,0,0,0,-9000,0,0,0,153000,162000,-9000,-9000
07259P,滬深2X國票01售01,0,0,0,0,0,0,0,0,0,-9000,0,0,0,20000,29000,-9000,-9000
07391P,台灣50國泰02售01,0,0,0,0,0,0,0,0,0,-9000,0,0,0,0,9000,-9000,-9000
07503P,禾伸堂元大9A售01,0,0,0,0,0,0,0,0,0,-9000,0,0,0,20000,29000,-9000,-9000
2388,威盛            ,46000,55000,-9000,0,0,0,0,0,0,0,0,0,0,0,0,0,-9000
6206,飛捷            ,22000,31000,-9000,0,0,0,0,0,0,0,0,0,0,0,0,0,-9000
6136,富爾特          ,0,9000,-9000,0,0,0,0,0,0,0,0,0,0,0,0,0,-9000
8261,富鼎            ,27000,36000,-9000,0,0,0,0,0,0,0,0,0,0,0,0,0,-9000
06044P,同欣電永豐96售03,0,0,0,0,0,0,0,0,0,-10000,0,0,0,40000,50000,-10000,-10000
060469,台勝科元大9A購02,0,0,0,0,0,0,0,0,0,-10000,0,0,0,58000,68000,-10000,-10000
06057P,大立光凱基98售01,0,0,0,0,0,0,0,0,0,-10000,0,0,0,0,10000,-10000,-10000
060598,鴻海凱基9A購20  ,0,0,0,0,0,0,0,0,0,-10000,0,0,0,0,10000,-10000,-10000
060330,台灣50麥證9A購03,0,0,0,0,10000,-10000,0,0,0,-10000,0,0,0,0,10000,-10000,-10000
060304,大立光富邦9C購05,0,0,0,0,0,0,0,0,0,-10000,0,0,0,0,10000,-10000,-10000
060389,世紀鋼凱基9B購02,0,0,0,0,0,0,0,0,0,-10000,0,0,0,0,10000,-10000,-10000
06017P,亞光凱基96售04  ,0,0,0,0,0,0,0,0,0,-10000,0,0,0,0,10000,-10000,-10000
060097,華新科元大99購23,0,0,0,0,0,0,0,0,0,-10000,0,0,0,0,10000,-10000,-10000
059514,嘉澤永豐99購02  ,0,0,0,0,0,0,0,0,0,-10000,0,0,0,4000,14000,-10000,-10000
05951P,台積電國票97售05,0,0,0,0,0,0,0,0,0,-10000,0,0,0,0,10000,-10000,-10000
059632,聯發科凱基01購01,0,0,0,0,0,0,0,0,0,-10000,0,0,0,0,10000,-10000,-10000
059832,超眾康和99購01  ,0,0,0,0,0,0,0,0,0,-10000,0,0,0,0,10000,-10000,-10000
059838,茂林國泰9B購01  ,0,0,0,0,0,0,0,0,0,-10000,0,0,0,0,10000,-10000,-10000
05974P,國巨富邦97售03  ,0,0,0,0,0,0,0,0,0,-10000,0,0,0,0,10000,-10000,-10000
059893,台積電台新9A購02,0,0,0,0,0,0,0,0,0,-10000,0,0,0,1000,11000,-10000,-10000
059936,台積電永豐99購06,0,0,0,0,0,0,0,0,0,-10000,0,0,0,0,10000,-10000,-10000
059978,國巨元大99購29  ,0,0,0,0,0,0,0,0,0,-10000,0,0,0,0,10000,-10000,-10000
060019,彰銀康和99購01  ,0,0,0,0,0,0,0,0,0,-10000,0,0,0,58000,68000,-10000,-10000
060039,大立光國票99購04,0,0,0,0,0,0,0,0,0,-10000,0,0,0,0,10000,-10000,-10000
06004P,奇力新永豐96售02,0,0,0,0,0,0,0,0,0,-10000,0,0,0,0,10000,-10000,-10000
06007P,世芯永豐96售01  ,0,0,0,0,0,0,0,0,0,-10000,0,0,0,0,10000,-10000,-10000
06006P,欣興永豐96售04  ,0,0,0,0,0,0,0,0,0,-10000,0,0,0,0,10000,-10000,-10000
061531,奇鋐台新9A購01  ,0,0,0,0,0,0,0,0,0,-10000,0,0,0,0,10000,-10000,-10000
061527,牧德凱基9A購02  ,0,0,0,0,0,0,0,0,0,-10000,0,0,0,28000,38000,-10000,-10000
061516,力成永豐9A購02  ,0,0,0,0,0,0,0,0,0,-10000,0,0,0,0,10000,-10000,-10000
061582,麗豐元大9A購01  ,0,0,0,0,0,0,0,0,0,-10000,0,0,0,26000,36000,-10000,-10000
061561,義隆國票9A購02  ,0,0,0,0,0,0,0,0,0,-10000,0,0,0,0,10000,-10000,-10000
061544,大毅群益9B購02  ,0,0,0,0,0,0,0,0,0,-10000,0,0,0,0,10000,-10000,-10000
061546,大立光群益9A購05,0,0,0,0,0,0,0,0,0,-10000,0,0,0,0,10000,-10000,-10000
061446,鴻海中信04購01  ,0,0,0,0,0,0,0,0,0,-10000,0,0,0,0,10000,-10000,-10000
061458,臻鼎凱基9A購02  ,0,0,0,0,0,0,0,0,0,-10000,0,0,0,0,10000,-10000,-10000
061465,聯詠群益9A購01  ,0,0,0,0,0,0,0,0,0,-10000,0,0,0,0,10000,-10000,-10000
061467,嘉澤群益9A購01  ,0,0,0,0,0,0,0,0,0,-10000,0,0,0,42000,52000,-10000,-10000
06248P,國巨統一97售07  ,0,0,0,0,0,0,0,0,0,-10000,0,0,0,130000,140000,-10000,-10000
06163P,聯詠群益97售01  ,0,0,0,0,0,0,0,0,0,-10000,0,0,0,30000,40000,-10000,-10000
06208P,台郡凱基97售03  ,0,0,0,0,0,0,0,0,0,-10000,0,0,0,0,10000,-10000,-10000
06445P,大立光凱基98售09,0,0,0,0,0,0,0,0,0,-10000,0,0,0,0,10000,-10000,-10000
06451P,聯發科元大98售04,0,0,0,0,0,0,0,0,0,-10000,0,0,0,0,10000,-10000,-10000
06496P,台灣50日盛98售01,0,0,0,0,0,0,0,0,0,-10000,0,0,0,0,10000,-10000,-10000
06503P,臺股指中信9A售02,0,0,0,0,0,0,0,0,0,-10000,0,0,0,0,10000,-10000,-10000
06527P,T50正2富邦9C售01,0,0,0,0,0,0,0,0,0,-10000,0,0,0,0,10000,-10000,-10000
06505P,康控國票99售02  ,0,0,0,0,0,0,0,0,0,-10000,0,0,0,0,10000,-10000,-10000
07012P,智邦群益9A售01  ,0,0,0,0,0,0,0,0,0,-10000,0,0,0,0,10000,-10000,-10000
06973P,臺股指元大9A售11,0,0,0,0,0,0,0,0,0,-10000,0,0,0,0,10000,-10000,-10000
06928P,鴻海元大99售10  ,0,0,0,0,0,0,0,0,0,-10000,0,0,0,27000,37000,-10000,-10000
07114P,旺宏兆豐9A售01  ,0,0,0,0,0,0,0,0,0,-10000,0,0,0,0,10000,-10000,-10000
07105P,大毅元富99售02  ,0,0,0,0,0,0,0,0,0,-10000,0,0,0,0,10000,-10000,-10000
07084P,S&P正2元富9B售02,0,0,0,0,0,0,0,0,0,-10000,0,0,0,0,10000,-10000,-10000
07122P,欣興凱基99售05  ,0,0,0,0,0,0,0,0,0,-10000,0,0,0,0,10000,-10000,-10000
06879P,長榮航凱基98售02,0,0,0,0,0,0,0,0,0,-10000,0,0,0,0,10000,-10000,-10000
06751P,旺宏凱基98售10  ,0,0,0,0,0,0,0,0,0,-10000,0,0,0,1000,11000,-10000,-10000
06762P,智邦元大98售11  ,0,0,0,0,0,0,0,0,0,-10000,0,0,0,0,10000,-10000,-10000
06621P,欣興元大98售06  ,0,0,0,0,0,0,0,0,0,-10000,0,0,0,0,10000,-10000,-10000
06576P,台光電群益98售03,0,0,0,0,0,0,0,0,0,-10000,0,0,0,0,10000,-10000,-10000
06675P,國巨國票99售02  ,0,0,0,0,0,0,0,0,0,-10000,0,0,0,0,10000,-10000,-10000
06673P,大立光群益98售01,0,0,0,0,0,0,0,0,0,-10000,0,0,0,19000,29000,-10000,-10000
06660P,大立光富邦9B售03,0,0,0,0,0,0,0,0,0,-10000,0,0,0,0,10000,-10000,-10000
06661P,玉晶光永豐98售05,0,0,0,0,0,0,0,0,0,-10000,0,0,0,20000,30000,-10000,-10000
06638P,鴻海統一99售02  ,0,0,0,0,0,0,0,0,0,-10000,0,0,0,0,10000,-10000,-10000
060866,世芯永豐9B購01  ,0,0,0,0,0,0,0,0,0,-10000,0,0,0,229000,239000,-10000,-10000
060772,FBVIX凱基9A購03 ,0,0,0,0,0,0,0,0,0,-10000,0,0,0,0,10000,-10000,-10000
061124,微星永豐9A購02  ,0,0,0,0,0,0,0,0,0,-10000,0,0,0,0,10000,-10000,-10000
061062,和大凱基9A購02  ,0,0,0,0,0,0,0,0,0,-10000,0,0,0,20000,30000,-10000,-10000
061350,牧德元大9B購03  ,0,0,0,0,0,0,0,0,0,-10000,0,0,0,12000,22000,-10000,-10000
061297,台積電富邦9C購09,0,0,0,0,0,0,0,0,0,-10000,0,0,0,50000,60000,-10000,-10000
061300,臺股指富邦9A購02,0,0,0,0,0,0,0,0,0,-10000,0,0,0,0,10000,-10000,-10000
05154P,台積電兆豐95售05,0,0,0,0,0,0,0,0,0,-10000,0,0,0,0,10000,-10000,-10000
051393,新光金兆豐96購01,0,0,0,0,0,0,0,0,0,-10000,0,0,0,0,10000,-10000,-10000
051471,國巨凱基97購01  ,0,0,0,0,0,0,0,0,0,-10000,0,0,0,40000,50000,-10000,-10000
05260P,和碩元富95售02  ,0,0,0,0,0,0,0,0,0,-10000,0,0,0,0,10000,-10000,-10000
053977,新日興元大96購03,0,0,0,0,0,0,0,0,0,-10000,0,0,0,0,10000,-10000,-10000
055114,新日興凱基98購01,0,0,0,0,0,0,0,0,0,-10000,0,0,0,0,10000,-10000,-10000
055056,億光永豐97購01  ,0,0,0,0,0,0,0,0,0,-10000,0,0,0,0,10000,-10000,-10000
050698,明泰凱基96購01  ,0,0,0,0,0,0,0,0,0,-10000,0,0,0,0,10000,-10000,-10000
050808,台達電凱基96購02,0,0,0,0,0,0,0,0,0,-10000,0,0,0,40000,50000,-10000,-10000
050823,信邦凱基95購01  ,0,0,0,0,0,0,0,0,0,-10000,0,0,0,0,10000,-10000,-10000
051001,緯穎元大96購02  ,0,0,0,0,0,0,0,0,0,-10000,0,0,0,0,10000,-10000,-10000
051003,中環中信97購01  ,0,0,0,0,0,0,0,0,0,-10000,0,0,0,0,10000,-10000,-10000
051153,鴻海國泰97購02  ,0,0,0,0,0,0,0,0,0,-10000,0,0,0,0,10000,-10000,-10000
052304,可成永豐95購03  ,0,0,0,0,0,0,0,0,0,-10000,0,0,0,0,10000,-10000,-10000
052305,GIS永豐95購03   ,0,0,0,0,0,0,0,0,0,-10000,0,0,0,50000,60000,-10000,-10000
052276,力成群益96購01  ,0,0,0,0,0,0,0,0,0,-10000,0,0,0,0,10000,-10000,-10000
049859,味全兆豐95購01  ,0,0,0,0,0,0,0,0,0,-10000,0,0,0,0,10000,-10000,-10000
04960P,大立光凱基96售04,0,0,0,0,0,0,0,0,0,-10000,0,0,0,0,10000,-10000,-10000
049593,群創元大9A購01  ,0,0,0,0,0,0,0,0,0,-10000,0,0,0,0,10000,-10000,-10000
03857P,聯發科元富99售02,0,0,0,0,0,0,0,0,0,-10000,0,0,0,0,10000,-10000,-10000
04693P,超眾群益95售01  ,0,0,0,0,0,0,0,0,0,-10000,0,0,0,0,10000,-10000,-10000
049251,國巨元大95購02  ,0,0,0,0,0,0,0,0,0,-10000,0,0,0,18000,28000,-10000,-10000
049458,SP黃豆元富96購01,0,0,0,0,0,0,0,0,0,-10000,0,0,0,0,10000,-10000,-10000
052192,SP黃豆元富95購04,0,0,0,0,0,0,0,0,0,-10000,0,0,0,0,10000,-10000,-10000
052066,華邦電兆豐96購01,0,0,0,0,0,0,0,0,0,-10000,0,0,0,0,10000,-10000,-10000
052112,滬深2X中信99購01,0,0,0,0,0,0,0,0,0,-10000,0,0,0,0,10000,-10000,-10000
052101,滬深2X兆豐96購01,0,0,0,0,0,0,0,0,0,-10000,0,0,0,0,10000,-10000,-10000
051766,泰鼎元大95購02  ,0,0,0,0,0,0,0,0,0,-10000,0,0,0,0,10000,-10000,-10000
051987,廣達元大95購01  ,0,0,0,0,0,0,0,0,0,-10000,0,0,0,0,10000,-10000,-10000
051977,泰碩凱基95購01  ,0,0,0,0,0,0,0,0,0,-10000,0,0,0,0,10000,-10000,-10000
051903,T50反1元大97購02,0,0,0,0,0,0,0,0,0,-10000,0,0,0,0,10000,-10000,-10000
047298,聯茂元富96購01  ,0,0,0,0,0,0,0,0,0,-10000,0,0,0,0,10000,-10000,-10000
049017,旺宏群益96購03  ,0,0,0,0,0,0,0,0,0,-10000,0,0,0,0,10000,-10000,-10000
03670C,元油2X元富99牛01,0,0,0,0,0,0,0,0,0,-10000,0,0,0,0,10000,-10000,-10000
03412P,滬深2X群益98售01,0,0,0,0,0,0,0,0,0,-10000,0,0,0,0,10000,-10000,-10000
03438P,群創群益98售03  ,0,0,0,0,0,0,0,0,0,-10000,0,0,0,0,10000,-10000,-10000
047675,群創元富96購03  ,0,0,0,0,0,0,0,0,0,-10000,0,0,0,0,10000,-10000,-10000
047689,瑞昱富邦97購01  ,0,0,0,0,0,0,0,0,0,-10000,0,0,0,0,10000,-10000,-10000
048382,T50反1國票96購01,0,0,0,0,0,0,0,0,0,-10000,0,0,0,0,10000,-10000,-10000
057887,智原群益98購04  ,0,0,0,0,0,0,0,0,0,-10000,0,0,0,0,10000,-10000,-10000
057919,技嘉凱基98購03  ,0,0,0,0,0,0,0,0,0,-10000,0,0,0,0,10000,-10000,-10000
052839,上海銀國泰97購01,0,0,0,0,0,0,0,0,0,-10000,0,0,0,0,10000,-10000,-10000
054196,台光電國泰97購02,0,0,0,0,0,0,0,0,0,-10000,0,0,0,0,10000,-10000,-10000
054201,聯詠富邦97購02  ,0,0,0,0,0,0,0,0,0,-10000,0,0,0,0,10000,-10000,-10000
052998,拓凱康和96購01  ,0,0,0,0,0,0,0,0,0,-10000,0,0,0,0,10000,-10000,-10000
054263,聯茂元大96購02  ,0,0,0,0,0,0,0,0,0,-10000,0,0,0,0,10000,-10000,-10000
054297,台郡元大98購01  ,0,0,0,0,0,0,0,0,0,-10000,0,0,0,0,10000,-10000,-10000
054344,景碩國票97購04  ,0,0,0,0,0,0,0,0,0,-10000,0,0,0,0,10000,-10000,-10000
053305,聯詠凱基96購02  ,0,0,0,0,0,0,0,0,0,-10000,0,0,0,0,10000,-10000,-10000
053291,旺宏中信9A購01  ,0,0,0,0,0,0,0,0,0,-10000,0,0,0,360000,370000,-10000,-10000
053238,麗豐永豐96購01  ,0,0,0,0,0,0,0,0,0,-10000,0,0,0,0,10000,-10000,-10000
053183,大立光元富96購03,0,0,0,0,0,0,0,0,0,-10000,0,0,0,0,10000,-10000,-10000
053438,玉晶光麥證97購02,0,0,0,0,10000,-10000,0,0,0,-10000,0,0,0,0,10000,-10000,-10000
053380,南亞科元大97購01,0,0,0,0,0,0,0,0,0,-10000,0,0,0,0,10000,-10000,-10000
053530,聯發科康和96購01,0,0,0,0,0,0,0,0,0,-10000,0,0,0,0,10000,-10000,-10000
052705,超眾國票97購01  ,0,0,0,0,0,0,0,0,0,-10000,0,0,0,0,10000,-10000,-10000
052791,友達兆豐97購01  ,0,0,0,0,0,0,0,0,0,-10000,0,0,0,0,10000,-10000,-10000
053557,聯茂凱基96購04  ,0,0,0,0,0,0,0,0,0,-10000,0,0,0,0,10000,-10000,-10000
053640,上緯控永豐96購01,0,0,0,0,0,0,0,0,0,-10000,0,0,0,0,10000,-10000,-10000
053673,超眾元富96購03  ,0,0,0,0,0,0,0,0,0,-10000,0,0,0,0,10000,-10000,-10000
054848,群創兆豐98購01  ,0,0,0,0,0,0,0,0,0,-10000,0,0,0,0,10000,-10000,-10000
054858,台肥群益97購01  ,0,0,0,0,0,0,0,0,0,-10000,0,0,0,0,10000,-10000,-10000
054834,帆宣中信97購01  ,0,0,0,0,0,0,0,0,0,-10000,0,0,0,0,10000,-10000,-10000
053088,奇鋐元大98購01  ,0,0,0,0,0,0,0,0,0,-10000,0,0,0,0,10000,-10000,-10000
054994,建準元富97購01  ,0,0,0,0,0,0,0,0,0,-10000,0,0,0,0,10000,-10000,-10000
054688,兆赫永豐97購01  ,0,0,0,0,0,0,0,0,0,-10000,0,0,0,0,10000,-10000,-10000
054728,聯發科日盛97購01,0,0,0,0,0,0,0,0,0,-10000,0,0,0,0,10000,-10000,-10000
054565,玉晶光群益99購02,0,0,0,0,0,0,0,0,0,-10000,0,0,0,0,10000,-10000,-10000
05459P,聯詠凱基95售03  ,0,0,0,0,0,0,0,0,0,-10000,0,0,0,0,10000,-10000,-10000
055211,A50反1凱基9A購01,0,0,0,0,0,0,0,0,0,-10000,0,0,0,0,10000,-10000,-10000
055269,和大元大97購02  ,0,0,0,0,0,0,0,0,0,-10000,0,0,0,0,10000,-10000,-10000
05872P,大立光凱基96售15,0,0,0,0,0,0,0,0,0,-10000,0,0,0,0,10000,-10000,-10000
058723,元石油國泰9A購01,0,0,0,0,0,0,0,0,0,-10000,0,0,0,0,10000,-10000,-10000
058734,康友永豐99購01  ,0,0,0,0,0,0,0,0,0,-10000,0,0,0,0,10000,-10000,-10000
058591,台灣50統一9B購02,0,0,0,0,0,0,0,0,0,-10000,0,0,0,3000,13000,-10000,-10000
055723,康控元大97購04  ,0,0,0,0,0,0,0,0,0,-10000,0,0,0,0,10000,-10000,-10000
055754,和大兆豐97購01  ,0,0,0,0,0,0,0,0,0,-10000,0,0,0,0,10000,-10000,-10000
056325,群創兆豐9A購01  ,0,0,0,0,0,0,0,0,0,-10000,0,0,0,0,10000,-10000,-10000
055599,TPK元大97購01   ,0,0,0,0,0,0,0,0,0,-10000,0,0,0,0,10000,-10000,-10000
05535P,台積電元大97售06,0,0,0,0,0,0,0,0,0,-10000,0,0,0,260000,270000,-10000,-10000
055383,GIS元大97購02   ,0,0,0,0,0,0,0,0,0,-10000,0,0,0,0,10000,-10000,-10000
058007,南電群益98購02  ,0,0,0,0,0,0,0,0,0,-10000,0,0,0,7000,17000,-10000,-10000
057999,智邦亞東99購02  ,0,0,0,0,0,0,0,0,0,-10000,0,0,0,0,10000,-10000,-10000
056168,鴻海元富97購07  ,0,0,0,0,0,0,0,0,0,-10000,0,0,0,0,10000,-10000,-10000
057049,新日興元大98購02,0,0,0,0,0,0,0,0,0,-10000,0,0,0,40000,50000,-10000,-10000
057070,美律永豐98購02  ,0,0,0,0,0,0,0,0,0,-10000,0,0,0,0,10000,-10000,-10000
05848P,臺股指元大96售24,0,0,0,0,0,0,0,0,0,-10000,0,0,0,10000,20000,-10000,-10000
058515,健鼎元大99購01  ,0,0,0,0,0,0,0,0,0,-10000,0,0,0,0,10000,-10000,-10000
05845P,大立光元大96售06,0,0,0,0,0,0,0,0,0,-10000,0,0,0,0,10000,-10000,-10000
05846P,大立光元大96售07,0,0,0,0,0,0,0,0,0,-10000,0,0,0,0,10000,-10000,-10000
058361,美律凱基99購06  ,0,0,0,0,0,0,0,0,0,-10000,0,0,0,21000,31000,-10000,-10000
058296,明泰凱基99購01  ,0,0,0,0,0,0,0,0,0,-10000,0,0,0,0,10000,-10000,-10000
056066,奇鋐元大98購02  ,0,0,0,0,0,0,0,0,0,-10000,0,0,0,0,10000,-10000,-10000
056076,超眾元大97購05  ,0,0,0,0,0,0,0,0,0,-10000,0,0,0,50000,60000,-10000,-10000
056056,旺宏元大97購06  ,0,0,0,0,0,0,0,0,0,-10000,0,0,0,310000,320000,-10000,-10000
057184,群創元大98購05  ,0,0,0,0,0,0,0,0,0,-10000,0,0,0,0,10000,-10000,-10000
056407,嘉晶國票99購01  ,0,0,0,0,0,0,0,0,0,-10000,0,0,0,70000,80000,-10000,-10000
055502,群創元大9C購03  ,0,0,0,0,0,0,0,0,0,-10000,0,0,0,0,10000,-10000,-10000
055435,佳世達中信99購01,0,0,0,0,0,0,0,0,0,-10000,0,0,0,10000,20000,-10000,-10000
057275,友達元大9A購04  ,0,0,0,0,0,0,0,0,0,-10000,0,0,0,0,10000,-10000,-10000
057262,友達兆豐98購03  ,0,0,0,0,0,0,0,0,0,-10000,0,0,0,0,10000,-10000,-10000
057293,力成國泰99購01  ,0,0,0,0,0,0,0,0,0,-10000,0,0,0,0,10000,-10000,-10000
056665,上証2X國票99購02,0,0,0,0,0,0,0,0,0,-10000,0,0,0,0,10000,-10000,-10000
056658,美食元大98購01  ,10000,0,10000,0,0,0,0,0,0,-20000,0,0,0,0,20000,-20000,-10000
056683,台積電統一98購05,0,0,0,0,0,0,0,0,0,-10000,0,0,0,20000,30000,-10000,-10000
056685,光罩統一98購03  ,0,0,0,0,0,0,0,0,0,-10000,0,0,0,0,10000,-10000,-10000
056745,聯茂凱基99購03  ,0,0,0,0,0,0,0,0,0,-10000,0,0,0,1000,11000,-10000,-10000
056751,和大兆豐98購01  ,0,0,0,0,0,0,0,0,0,-10000,0,0,0,0,10000,-10000,-10000
056753,群創兆豐98購02  ,0,0,0,0,0,0,0,0,0,-10000,0,0,0,0,10000,-10000,-10000
056804,T50反1統一9A購03,0,0,0,0,0,0,0,0,0,-10000,0,0,0,30000,40000,-10000,-10000
056876,群創凱基98購11  ,0,0,0,0,0,0,0,0,0,-10000,0,0,0,0,10000,-10000,-10000
056925,群創兆豐98購03  ,0,0,0,0,0,0,0,0,0,-10000,0,0,0,0,10000,-10000,-10000
056934,國巨元富98購04  ,0,0,0,0,0,0,0,0,0,-10000,0,0,0,160000,170000,-10000,-10000
058807,和大統一9B購01  ,0,0,0,0,0,0,0,0,0,-10000,0,0,0,0,10000,-10000,-10000
058802,矽創元大99購02  ,0,0,0,0,0,0,0,0,0,-10000,0,0,0,0,10000,-10000,-10000
057399,滬深反群益9C購01,0,0,0,0,0,0,0,0,0,-10000,0,0,0,0,10000,-10000,-10000
057357,超眾統一98購01  ,0,0,0,0,0,0,0,0,0,-10000,0,0,0,15000,25000,-10000,-10000
057349,聯發科統一98購04,0,0,0,0,0,0,0,0,0,-10000,0,0,0,0,10000,-10000,-10000
059033,元油2X群益9C購05,0,0,0,0,0,0,0,0,0,-10000,0,0,0,0,10000,-10000,-10000
059081,和大元大99購01  ,0,0,0,0,0,0,0,0,0,-10000,0,0,0,0,10000,-10000,-10000
059189,國泰金富邦9B購01,0,0,0,0,0,0,0,0,0,-10000,0,0,0,236000,246000,-10000,-10000
059256,臺股指凱基99購34,0,0,0,0,0,0,0,0,0,-10000,0,0,0,54000,64000,-10000,-10000
059252,聯詠凱基99購03  ,0,0,0,0,0,0,0,0,0,-10000,0,0,0,0,10000,-10000,-10000
059273,臺指反元大9C購03,0,0,0,0,0,0,0,0,0,-10000,0,0,0,0,10000,-10000,-10000
6183,關貿            ,2000,12000,-10000,0,0,0,0,0,0,0,0,0,0,0,0,0,-10000
3164,景岳            ,2000,12000,-10000,0,0,0,0,0,0,0,0,0,0,0,0,0,-10000
2468,華經            ,0,10000,-10000,0,0,0,0,0,0,0,0,0,0,0,0,0,-10000
2637,慧洋-KY         ,358000,368000,-10000,0,0,0,0,0,0,0,0,0,0,0,0,0,-10000
2887F,台新戊特二      ,0,0,0,0,0,0,0,0,0,-10000,0,10000,-10000,0,0,0,-10000
07388P,臺股指群益9C售07,0,0,0,0,0,0,0,0,0,-10000,0,0,0,0,10000,-10000,-10000
07377P,聯發科元大99售40,0,0,0,0,0,0,0,0,0,-10000,0,0,0,0,10000,-10000,-10000
07439P,臺股指麥證9B售01,0,0,0,0,10000,-10000,0,0,0,-10000,0,0,0,0,10000,-10000,-10000
07512P,國巨元大9A售08  ,0,0,0,0,0,0,0,0,0,-10000,0,0,0,0,10000,-10000,-10000
07514P,台積電元大9A售14,0,0,0,0,0,0,0,0,0,-10000,0,0,0,0,10000,-10000,-10000
07538P,玉晶光元富9A售05,0,0,0,0,0,0,0,0,0,-10000,0,0,0,0,10000,-10000,-10000
07140P,台灣50日盛99售01,0,0,0,0,0,0,0,0,0,-10000,0,0,0,0,10000,-10000,-10000
07291P,臺股指凱基99售43,0,0,0,0,0,0,0,0,0,-10000,0,0,0,32000,42000,-10000,-10000
07295P,滬深2X元富9C售09,0,0,0,0,0,0,0,0,0,-10000,0,0,0,0,10000,-10000,-10000
07355P,臺股指國票99售23,0,0,0,0,0,0,0,0,0,-10000,0,0,0,40000,50000,-10000,-10000
07327P,台灣50群益9A售06,0,0,0,0,0,0,0,0,0,-10000,0,0,0,0,10000,-10000,-10000
1315,達新            ,38000,48000,-10000,0,0,0,0,0,0,0,0,0,0,0,0,0,-10000
1446,宏和            ,9000,19000,-10000,0,0,0,0,0,0,0,0,0,0,0,0,0,-10000
1442,名軒            ,7000,17000,-10000,0,0,0,0,0,0,0,0,0,0,0,0,0,-10000
07673P,電子類元大9A售01,0,0,0,0,0,0,0,0,0,-10000,0,0,0,0,10000,-10000,-10000
07684P,大立光凱基9A售11,0,0,0,0,0,0,0,0,0,-10000,0,0,0,0,10000,-10000,-10000
07812P,大立光統一9A售06,0,0,0,0,0,0,0,0,0,-10000,0,0,0,0,10000,-10000,-10000
07749P,台郡凱基9A售01  ,0,0,0,0,0,0,0,0,0,-10000,0,0,0,14000,24000,-10000,-10000
07779P,鴻海凱基9B售04  ,0,0,0,0,0,0,0,0,0,-10000,0,0,0,0,10000,-10000,-10000
061174,鴻海凱基9A購23  ,0,0,0,0,0,0,0,0,0,-11000,0,0,0,45000,56000,-11000,-11000
060751,高股息元大9B購01,0,0,0,0,0,0,0,0,0,-11000,0,0,0,0,11000,-11000,-11000
07055P,景碩群益9A售02  ,0,0,0,0,0,0,0,0,0,-11000,0,0,0,0,11000,-11000,-11000
06940P,旺宏永豐98售05  ,0,0,0,0,0,0,0,0,0,-11000,0,0,0,0,11000,-11000,-11000
06917P,聯電亞東99售01  ,0,0,0,0,0,0,0,0,0,-11000,0,0,0,0,11000,-11000,-11000
06239P,奇力新元大97售08,0,0,0,0,0,0,0,0,0,-11000,0,0,0,0,11000,-11000,-11000
061505,力成國票9A購03  ,0,0,0,0,0,0,0,0,0,-11000,0,0,0,0,11000,-11000,-11000
061485,鴻海兆豐9A購01  ,0,0,0,0,0,0,0,0,0,-11000,0,0,0,0,11000,-11000,-11000
060047,道瓊反凱基99購01,0,0,0,0,0,0,0,0,0,-11000,0,0,0,25000,36000,-11000,-11000
059594,奇力新元大9B購01,0,0,0,0,0,0,0,0,0,-11000,0,0,0,10000,21000,-11000,-11000
054996,聯陽元富97購01  ,0,0,0,0,0,0,0,0,0,-11000,0,0,0,0,11000,-11000,-11000
054535,旺宏富邦97購02  ,0,0,0,0,0,0,0,0,0,-11000,0,0,0,410000,421000,-11000,-11000
048852,旺宏群益96購02  ,0,0,0,0,0,0,0,0,0,-11000,0,0,0,99000,110000,-11000,-11000
048848,滬深2X群益98購02,0,0,0,0,0,0,0,0,0,-11000,0,0,0,0,11000,-11000,-11000
03091X,元展85          ,0,0,0,0,0,0,0,0,0,-11000,0,0,0,5000,16000,-11000,-11000
00709,富邦歐洲        ,0,0,0,0,0,0,0,0,0,-11000,0,0,0,100000,111000,-11000,-11000
052151,義隆富邦96購01  ,0,0,0,0,0,0,0,0,0,-11000,0,0,0,0,11000,-11000,-11000
052619,茂林國泰99購01  ,0,0,0,0,0,0,0,0,0,-11000,0,0,0,310000,321000,-11000,-11000
059000,台積電元大99購25,0,0,0,0,0,0,0,0,0,-11000,0,0,0,0,11000,-11000,-11000
05895P,奇力新群益96售03,0,0,0,0,0,0,0,0,0,-11000,0,0,0,0,11000,-11000,-11000
056969,智易永豐98購01  ,0,0,0,0,0,0,0,0,0,-11000,0,0,0,15000,26000,-11000,-11000
057296,智原永豐98購01  ,0,0,0,0,0,0,0,0,0,-11000,0,0,0,1000,12000,-11000,-11000
056453,禾伸堂凱基99購02,0,0,0,0,0,0,0,0,0,-11000,0,0,0,0,11000,-11000,-11000
057142,力成兆豐98購01  ,0,0,0,0,0,0,0,0,0,-11000,0,0,0,0,11000,-11000,-11000
058582,禾伸堂群益99購02,0,0,0,0,0,0,0,0,0,-11000,0,0,0,49000,60000,-11000,-11000
07373P,A50正2元大99售01,0,0,0,0,0,0,0,0,0,-11000,0,0,0,0,11000,-11000,-11000
2461,光群雷          ,52000,63000,-11000,0,0,0,0,0,0,0,0,0,0,0,0,0,-11000
2450,神腦            ,28000,39000,-11000,0,0,0,0,0,0,0,0,0,0,0,0,0,-11000
2495,普安            ,4000,15000,-11000,0,0,0,0,0,0,0,0,0,0,0,0,0,-11000
4737,華廣            ,0,11000,-11000,0,0,0,0,0,0,0,0,0,0,0,0,0,-11000
9902,台火            ,2000,13000,-11000,0,0,0,0,0,0,0,0,0,0,0,0,0,-11000
8101,華冠            ,0,11000,-11000,0,0,0,0,0,0,0,0,0,0,0,0,0,-11000
8249,菱光            ,12000,23000,-11000,0,0,0,0,0,0,0,0,0,0,0,0,0,-11000
059702,台積電凱基9A購14,0,0,0,0,0,0,0,0,0,-12000,0,0,0,6000,18000,-12000,-12000
059991,超眾元大9A購02  ,0,0,0,0,0,0,0,0,0,-12000,0,0,0,15000,27000,-12000,-12000
059970,台灣50元大9B購07,0,0,0,0,0,0,0,0,0,-12000,0,0,0,0,12000,-12000,-12000
060373,元金2X元富9A購01,0,0,0,0,0,0,0,0,0,-12000,0,0,0,26000,38000,-12000,-12000
060253,昇陽半元大9C購01,0,0,0,0,0,0,0,0,0,-12000,0,0,0,128000,140000,-12000,-12000
06192P,高股息中信98售01,0,0,0,0,0,0,0,0,0,-12000,0,0,0,0,12000,-12000,-12000
06262P,國巨凱基97售07  ,0,0,0,0,0,0,0,0,0,-12000,0,0,0,5000,17000,-12000,-12000
06466P,台積電統一9B售01,0,0,0,0,0,0,0,0,0,-12000,0,0,0,0,12000,-12000,-12000
06891P,緯穎富邦99售03  ,0,0,0,0,0,0,0,0,0,-12000,0,0,0,0,12000,-12000,-12000
07102P,南電元大99售03  ,0,0,0,0,0,0,0,0,0,-12000,0,0,0,0,12000,-12000,-12000
060755,鴻海元大9A購15  ,0,0,0,0,0,0,0,0,0,-12000,0,0,0,50000,62000,-12000,-12000
060794,景碩永豐9A購02  ,0,0,0,0,0,0,0,0,0,-12000,0,0,0,43000,55000,-12000,-12000
060852,京鼎國泰9B購01  ,0,0,0,0,0,0,0,0,0,-12000,0,0,0,562000,574000,-12000,-12000
060966,台表科凱基9B購01,0,0,0,0,0,0,0,0,0,-12000,0,0,0,74000,86000,-12000,-12000
060941,台積電國票9B購04,0,0,0,0,0,0,0,0,0,-12000,0,0,0,1000,13000,-12000,-12000
061325,晶技凱基9A購03  ,0,0,0,0,0,0,0,0,0,-12000,0,0,0,54000,66000,-12000,-12000
053958,京元電永豐96購01,0,0,0,0,0,0,0,0,0,-12000,0,0,0,0,12000,-12000,-12000
052056,緯穎凱基95購04  ,0,0,0,0,0,0,0,0,0,-12000,0,0,0,21000,33000,-12000,-12000
00762,元大全球AI      ,0,0,0,0,0,0,0,0,0,-12000,0,0,0,30000,42000,-12000,-12000
0053,元大電子        ,0,0,0,0,0,0,0,0,0,-12000,0,0,0,8000,20000,-12000,-12000
057690,美律凱基99購03  ,0,0,0,0,0,0,0,0,0,-12000,0,0,0,18000,30000,-12000,-12000
054354,技嘉富邦97購01  ,0,0,0,0,0,0,0,0,0,-12000,0,0,0,10000,22000,-12000,-12000
054323,旺宏台新96購02  ,0,0,0,0,0,0,0,0,0,-12000,0,0,0,1000,13000,-12000,-12000
052963,智邦凱基96購02  ,0,0,0,0,0,0,0,0,0,-12000,0,0,0,2000,14000,-12000,-12000
053142,緯穎永豐96購01  ,0,0,0,0,0,0,0,0,0,-12000,0,0,0,1000,13000,-12000,-12000
053300,大成鋼凱基96購02,0,0,0,0,0,0,0,0,0,-12000,0,0,0,54000,66000,-12000,-12000
058701,鴻海元大99購16  ,0,0,0,0,0,0,0,0,0,-12000,0,0,0,29000,41000,-12000,-12000
058775,台積電國票9A購02,0,0,0,0,0,0,0,0,0,-12000,0,0,0,162000,174000,-12000,-12000
055647,義隆元富97購01  ,0,0,0,0,0,0,0,0,0,-12000,0,0,0,4000,16000,-12000,-12000
058453,可成永豐99購01  ,0,0,0,0,0,0,0,0,0,-12000,0,0,0,0,12000,-12000,-12000
058488,華擎國票9A購01  ,0,0,0,0,0,0,0,0,0,-12000,0,0,0,0,12000,-12000,-12000
056477,欣興元大98購02  ,0,0,0,0,0,0,0,0,0,-12000,0,0,0,84000,96000,-12000,-12000
058874,聯鈞國票9A購01  ,0,0,0,0,0,0,0,0,0,-12000,0,0,0,2000,14000,-12000,-12000
2383,台光電          ,804000,664000,140000,0,0,0,1000,180000,-179000,27000,37000,22000,15000,18000,6000,12000,-12000
2029,盛餘            ,0,12000,-12000,0,0,0,0,0,0,0,0,0,0,0,0,0,-12000
1809,中釉            ,43000,55000,-12000,0,0,0,0,0,0,0,0,0,0,0,0,0,-12000
07279P,台灣50台新99售02,0,0,0,0,0,0,0,0,0,-12000,0,0,0,25000,37000,-12000,-12000
07536P,華新科元富9A售04,0,0,0,0,0,0,0,0,0,-12000,0,0,0,3000,15000,-12000,-12000
07788P,華新科群益9A售08,0,0,0,0,0,0,0,0,0,-12000,0,0,0,0,12000,-12000,-12000
07689P,旺宏元大9A售13  ,0,0,0,0,0,0,0,0,0,-12000,0,0,0,0,12000,-12000,-12000
1309,台達化          ,209000,221000,-12000,0,0,0,0,0,0,0,0,0,0,0,0,0,-12000
061381,台灣50群益9B購07,0,0,0,0,0,0,0,0,0,-13000,0,0,0,132000,145000,-13000,-13000
061261,台積電凱基9B購03,0,0,0,0,0,0,0,0,0,-13000,0,0,0,0,13000,-13000,-13000
061243,麗豐兆豐9A購01  ,0,0,0,0,0,0,0,0,0,-13000,0,0,0,5000,18000,-13000,-13000
06096P,全新永豐97售02  ,0,0,0,0,0,0,0,0,0,-13000,0,0,0,0,13000,-13000,-13000
060773,FBVIX凱基9A購04 ,0,0,0,0,0,0,0,0,0,-13000,0,0,0,0,13000,-13000,-13000
07071P,立積元富99售01  ,0,0,0,0,0,0,0,0,0,-13000,0,0,0,8000,21000,-13000,-13000
06677P,牧德國票98售02  ,0,0,0,0,0,0,0,0,0,-13000,0,0,0,0,13000,-13000,-13000
06439P,上銀凱基98售02  ,0,0,0,0,0,0,0,0,0,-13000,0,0,0,3000,16000,-13000,-13000
06140P,華新科群益97售06,0,0,0,0,0,0,0,0,0,-13000,0,0,0,2000,15000,-13000,-13000
060191,亞光元富9A購02  ,0,0,0,0,0,0,0,0,0,-13000,0,0,0,210000,223000,-13000,-13000
059999,緯穎元富99購01  ,0,0,0,0,0,0,0,0,0,-13000,0,0,0,28000,41000,-13000,-13000
059911,國巨元大99購27  ,0,0,0,0,0,0,0,0,0,-13000,0,0,0,965000,978000,-13000,-13000
059782,A50正2元大9C購04,0,0,0,0,0,0,0,0,0,-13000,0,0,0,7000,20000,-13000,-13000
059663,旭富元大9C購02  ,0,0,0,0,0,0,0,0,0,-13000,0,0,0,74000,87000,-13000,-13000
053307,泰碩凱基97購01  ,0,0,0,0,0,0,0,0,0,-13000,0,0,0,0,13000,-13000,-13000
05310P,智原永豐95售04  ,0,0,0,0,0,0,0,0,0,-13000,0,0,0,11000,24000,-13000,-13000
05472P,國巨統一96售02  ,0,0,0,0,0,0,0,0,0,-13000,0,0,0,0,13000,-13000,-13000
054151,瑞昱國泰97購01  ,0,0,0,0,0,0,0,0,0,-13000,0,0,0,18000,31000,-13000,-13000
05764P,世紀鋼永豐96售03,0,0,0,0,0,0,0,0,0,-13000,0,0,0,12000,25000,-13000,-13000
054526,道瓊反統一98購01,0,0,0,0,0,0,0,0,0,-13000,0,0,0,0,13000,-13000,-13000
00671R,富邦NASDAQ反1   ,0,1000,-1000,0,0,0,0,0,0,-12000,0,0,0,513000,525000,-12000,-13000
00735,國泰臺韓科技    ,0,0,0,0,0,0,0,0,0,-13000,0,0,0,282000,295000,-13000,-13000
049236,元油2X元富96購06,0,0,0,0,0,0,0,0,0,-13000,0,0,0,16000,29000,-13000,-13000
052483,超眾群益95購03  ,0,0,0,0,0,0,0,0,0,-13000,0,0,0,0,13000,-13000,-13000
058934,台灣50中信03購03,0,0,0,0,0,0,0,0,0,-13000,0,0,0,1000,14000,-13000,-13000
058928,國巨統一9C購01  ,0,0,0,0,0,0,0,0,0,-13000,0,0,0,0,13000,-13000,-13000
058960,臺股指國票99購05,0,0,0,0,0,0,0,0,0,-13000,0,0,0,3000,16000,-13000,-13000
057501,超眾群益98購04  ,0,0,0,0,0,0,0,0,0,-13000,0,0,0,1000,14000,-13000,-13000
058040,FBVIX元大98購01 ,0,0,0,0,0,0,0,0,0,-13000,0,0,0,2000,15000,-13000,-13000
056233,超眾凱基97購02  ,0,0,0,0,0,0,0,0,0,-13000,0,0,0,0,13000,-13000,-13000
055600,致伸元大97購02  ,0,0,0,0,0,0,0,0,0,-13000,0,0,0,0,13000,-13000,-13000
055409,元黃金富邦01購01,0,0,0,0,0,0,0,0,0,-13000,0,0,0,0,13000,-13000,-13000
058763,和碩群益99購01  ,0,0,0,0,0,0,0,0,0,-13000,0,0,0,0,13000,-13000,-13000
058632,世紀鋼國票9A購01,0,0,0,0,0,0,0,0,0,-13000,0,0,0,26000,39000,-13000,-13000
1459,聯發            ,0,13000,-13000,0,0,0,0,0,0,0,0,0,0,0,0,0,-13000
1721,三晃            ,9000,22000,-13000,0,0,0,0,0,0,0,0,0,0,0,0,0,-13000
4968,立積            ,611000,719000,-108000,0,0,0,34000,0,34000,61000,132000,10000,122000,10000,71000,-61000,-13000
9911,櫻花            ,72000,72000,0,0,0,0,0,0,0,-13000,0,13000,-13000,0,0,0,-13000
05963P,貿聯國票97售02  ,0,0,0,0,0,0,0,0,0,-14000,0,0,0,12000,26000,-14000,-14000
059804,台積電元富99購01,0,0,0,0,0,0,0,0,0,-14000,0,0,0,0,14000,-14000,-14000
060314,元翎永豐9A購01  ,0,0,0,0,0,0,0,0,0,-14000,0,0,0,42000,56000,-14000,-14000
060395,儒鴻國票9A購01  ,0,0,0,0,0,0,0,0,0,-14000,0,0,0,58000,72000,-14000,-14000
060592,上銀麥證9A購01  ,0,0,0,9000,23000,-14000,0,0,0,-14000,0,0,0,9000,23000,-14000,-14000
061282,台積電統一9C購06,0,0,0,0,0,0,0,0,0,-14000,0,0,0,0,14000,-14000,-14000
061365,國巨國票9B購05  ,0,0,0,0,0,0,0,0,0,-14000,0,0,0,203000,217000,-14000,-14000
061310,華新科麥證9A購01,0,0,0,0,14000,-14000,0,0,0,-14000,0,0,0,0,14000,-14000,-14000
052576,聯茂凱基96購01  ,0,0,0,0,0,0,0,0,0,-14000,0,0,0,10000,24000,-14000,-14000
050673,旺宏富邦96購02  ,0,0,0,0,0,0,0,0,0,-14000,0,0,0,0,14000,-14000,-14000
05226P,智邦統一95售01  ,0,0,0,0,0,0,0,0,0,-14000,0,0,0,171000,185000,-14000,-14000
051780,矽力群益95購01  ,0,0,0,0,0,0,0,0,0,-14000,0,0,0,0,14000,-14000,-14000
051849,旺宏中信98購01  ,0,0,0,0,0,0,0,0,0,-14000,0,0,0,0,14000,-14000,-14000
00702,國泰標普低波高息,0,1000,-1000,0,0,0,0,0,0,-13000,0,0,0,17000,30000,-13000,-14000
048870,義隆國票96購01  ,0,0,0,0,0,0,0,0,0,-14000,0,0,0,45000,59000,-14000,-14000
04817P,創意國票95售02  ,0,0,0,0,0,0,0,0,0,-14000,0,0,0,0,14000,-14000,-14000
054390,智邦元富96購03  ,0,0,0,0,0,0,0,0,0,-14000,0,0,0,0,14000,-14000,-14000
054431,鴻海台新96購03  ,0,0,0,0,0,0,0,0,0,-14000,0,0,0,0,14000,-14000,-14000
054791,泰碩群益99購02  ,0,0,0,0,0,0,0,0,0,-14000,0,0,0,162000,176000,-14000,-14000
054064,台郡國票97購04  ,0,0,0,0,0,0,0,0,0,-14000,0,0,0,0,14000,-14000,-14000
05860P,旺宏康和96售01  ,0,0,0,0,0,0,0,0,0,-14000,0,0,0,6000,20000,-14000,-14000
058102,楠梓電永豐98購04,0,0,0,0,0,0,0,0,0,-14000,0,0,0,10000,24000,-14000,-14000
059008,鈺齊元大99購03  ,0,0,0,0,0,0,0,0,0,-14000,0,0,0,111000,125000,-14000,-14000
059133,臺股指群益99購08,0,0,0,0,0,0,0,0,0,-14000,0,0,0,0,14000,-14000,-14000
059194,元金2X永豐99購01,0,0,0,0,0,0,0,0,0,-14000,0,0,0,0,14000,-14000,-14000
059323,新日興元大99購02,0,0,0,0,0,0,0,0,0,-14000,0,0,0,1000,15000,-14000,-14000
056471,台光電元大99購01,0,0,0,0,0,0,0,0,0,-14000,0,0,0,13000,27000,-14000,-14000
056405,聯茂群益98購01  ,0,0,0,0,0,0,0,0,0,-14000,0,0,0,8000,22000,-14000,-14000
8404,百和興業-KY     ,103000,117000,-14000,0,0,0,0,0,0,0,0,0,0,0,0,0,-14000
2413,環科            ,10000,24000,-14000,0,0,0,0,0,0,0,0,0,0,0,0,0,-14000
07593P,臺股指凱基9A售08,0,0,0,0,0,0,0,0,0,-14000,0,0,0,50000,64000,-14000,-14000
07588P,滬深2X國票9C售01,0,0,0,0,0,0,0,0,0,-14000,0,0,0,0,14000,-14000,-14000
07134P,臺股指元大9A售28,0,0,0,0,0,0,0,0,0,-14000,0,0,0,4000,18000,-14000,-14000
061179,華擎凱基9A購01  ,0,0,0,0,0,0,0,0,0,-15000,0,0,0,30000,45000,-15000,-15000
061173,T50反1凱基04購01,0,0,0,0,0,0,0,0,0,-15000,0,0,0,0,15000,-15000,-15000
061054,台積電群益9A購04,0,0,0,0,0,0,0,0,0,-15000,0,0,0,67000,82000,-15000,-15000
061048,國巨中信9A購05  ,0,0,0,0,0,0,0,0,0,-15000,0,0,0,10000,25000,-15000,-15000
061401,華擎兆豐9B購01  ,0,0,0,0,0,0,0,0,0,-15000,0,0,0,60000,75000,-15000,-15000
061426,玉晶光元大9A購15,0,0,0,0,0,0,0,0,0,-15000,0,0,0,0,15000,-15000,-15000
061473,台積電元大9A購33,0,0,0,0,0,0,0,0,0,-15000,0,0,0,0,15000,-15000,-15000
061443,大立光統一9C購02,0,0,0,0,0,0,0,0,0,-15000,0,0,0,11000,26000,-15000,-15000
061559,南亞科國票9A購02,0,0,0,0,0,0,0,0,0,-15000,0,0,0,0,15000,-15000,-15000
06385P,聯發科永豐97售02,0,0,0,0,0,0,0,0,0,-15000,0,0,0,80000,95000,-15000,-15000
06492P,上銀永豐98售01  ,0,0,0,0,0,0,0,0,0,-15000,0,0,0,5000,20000,-15000,-15000
06631P,玉晶光群益9A售03,0,0,0,0,0,0,0,0,0,-15000,0,0,0,1399000,1414000,-15000,-15000
06847P,奇力新元大98售05,0,0,0,0,0,0,0,0,0,-15000,0,0,0,11000,26000,-15000,-15000
07103P,南電元大99售04  ,0,0,0,0,0,0,0,0,0,-15000,0,0,0,6000,21000,-15000,-15000
060077,台積電台新9B購01,0,0,0,0,0,0,0,0,0,-15000,0,0,0,36000,51000,-15000,-15000
059637,大立光凱基01購01,0,0,0,0,0,0,0,0,0,-15000,0,0,0,35000,50000,-15000,-15000
059567,台積電凱基9A購12,0,0,0,0,0,0,0,0,0,-15000,0,0,0,0,15000,-15000,-15000
059676,台積電台新99購05,0,0,0,0,0,0,0,0,0,-15000,0,0,0,0,15000,-15000,-15000
05948P,茂林元大96售03  ,0,0,0,0,0,0,0,0,0,-15000,0,0,0,0,15000,-15000,-15000
059369,滬深2X元富9C購01,0,0,0,0,0,0,0,0,0,-15000,0,0,0,35000,50000,-15000,-15000
054062,TPK國票96購02   ,0,0,0,0,0,0,0,0,0,-15000,0,0,0,30000,45000,-15000,-15000
053356,聯發科統一96購07,0,0,0,0,0,0,0,0,0,-15000,0,0,0,250000,265000,-15000,-15000
053250,百和國票97購02  ,0,0,0,0,0,0,0,0,0,-15000,0,0,0,0,15000,-15000,-15000
053424,欣興永豐96購02  ,0,0,0,0,0,0,0,0,0,-15000,0,0,0,40000,55000,-15000,-15000
052834,彩晶群益96購01  ,0,0,0,0,0,0,0,0,0,-15000,0,0,0,0,15000,-15000,-15000
05771P,大立光凱基96售13,0,0,0,0,0,0,0,0,0,-15000,0,0,0,0,15000,-15000,-15000
00690,兆豐藍籌30      ,0,0,0,0,0,0,0,0,0,-15000,0,0,0,160000,175000,-15000,-15000
052005,矽力國泰97購02  ,0,0,0,0,0,0,0,0,0,-15000,0,0,0,22000,37000,-15000,-15000
03875P,滬深2X國票05售01,0,0,0,0,0,0,0,0,0,-15000,0,0,0,0,15000,-15000,-15000
049894,嘉聯益富邦98購01,0,0,0,0,0,0,0,0,0,-15000,0,0,0,0,15000,-15000,-15000
053942,超眾國泰96購02  ,0,0,0,0,0,0,0,0,0,-15000,0,0,0,0,15000,-15000,-15000
056051,T50反1元大97購05,0,0,0,0,0,0,0,0,0,-15000,0,0,0,0,15000,-15000,-15000
057238,群創凱基9B購03  ,0,0,0,0,0,0,0,0,0,-15000,0,0,0,0,15000,-15000,-15000
059308,T50反1元大99購07,30000,0,30000,0,0,0,0,0,0,-45000,0,0,0,0,45000,-45000,-15000
059239,台積電凱基99購12,0,0,0,0,0,0,0,0,0,-15000,0,0,0,0,15000,-15000,-15000
059123,訊芯永豐99購03  ,0,0,0,0,0,0,0,0,0,-15000,0,0,0,545000,560000,-15000,-15000
057488,聯發科元大99購02,0,0,0,0,0,0,0,0,0,-15000,0,0,0,0,15000,-15000,-15000
058165,FBVIX凱基9C購01 ,0,0,0,0,0,0,0,0,0,-15000,0,0,0,0,15000,-15000,-15000
058277,FBVIX中信03購01 ,0,0,0,0,0,0,0,0,0,-15000,0,0,0,0,15000,-15000,-15000
058520,智易元大99購03  ,0,0,0,0,0,0,0,0,0,-15000,0,0,0,23000,38000,-15000,-15000
058399,美律元大99購05  ,0,0,0,0,0,0,0,0,0,-15000,0,0,0,9000,24000,-15000,-15000
058003,FBVIX群益9C購02 ,0,0,0,0,0,0,0,0,0,-15000,0,0,0,0,15000,-15000,-15000
057004,滬深反中信9A購01,0,0,0,0,0,0,0,0,0,-15000,0,0,0,0,15000,-15000,-15000
058128,FBVIX元大9C購02 ,0,0,0,0,0,0,0,0,0,-15000,0,0,0,0,15000,-15000,-15000
058730,玉晶光永豐9A購01,0,0,0,0,0,0,0,0,0,-15000,0,0,0,5000,20000,-15000,-15000
058767,亞德客兆豐99購01,0,0,0,0,0,0,0,0,0,-15000,0,0,0,3000,18000,-15000,-15000
055360,台表科凱基97購02,0,0,0,0,0,0,0,0,0,-15000,0,0,0,0,15000,-15000,-15000
055368,台積電元大97購24,0,0,0,0,0,0,0,0,0,-15000,0,0,0,2000,17000,-15000,-15000
05570P,聯發科統一96售04,0,0,0,0,0,0,0,0,0,-15000,0,0,0,5000,20000,-15000,-15000
07190P,臺股指富邦9C售02,0,0,0,0,0,0,0,0,0,-15000,0,0,0,5000,20000,-15000,-15000
07326P,大立光元大99售23,0,0,0,0,0,0,0,0,0,-15000,0,0,0,15000,30000,-15000,-15000
07686P,祥碩凱基9A售02  ,0,0,0,0,0,0,0,0,0,-15000,0,0,0,0,15000,-15000,-15000
07702P,台積電中信9A售06,0,0,0,0,0,0,0,0,0,-15000,0,0,0,0,15000,-15000,-15000
2486,一詮            ,19000,34000,-15000,0,0,0,0,0,0,0,0,0,0,0,0,0,-15000
4566,時碩工業        ,11000,26000,-15000,0,0,0,0,0,0,0,0,0,0,0,0,0,-15000
5531,鄉林            ,41000,56000,-15000,0,0,0,0,0,0,0,0,0,0,0,0,0,-15000
3501,維熹            ,4000,19000,-15000,0,0,0,0,0,0,0,0,0,0,0,0,0,-15000
3617,碩天            ,5000,20000,-15000,0,0,0,0,0,0,0,0,0,0,0,0,0,-15000
2395,研華            ,461530,476290,-14760,0,0,0,1000,0,1000,-2000,0,2000,-2000,0,0,0,-15760
059568,台積電凱基9A購13,0,0,0,0,0,0,0,0,0,-16000,0,0,0,31000,47000,-16000,-16000
060083,和大元大99購02  ,0,0,0,0,0,0,0,0,0,-16000,0,0,0,78000,94000,-16000,-16000
059877,康控凱基99購05  ,0,0,0,0,0,0,0,0,0,-16000,0,0,0,53000,69000,-16000,-16000
06037P,超眾國票98售02  ,0,0,0,0,0,0,0,0,0,-16000,0,0,0,0,16000,-16000,-16000
06758P,鴻海元大98售10  ,0,0,0,0,0,0,0,0,0,-16000,0,0,0,0,16000,-16000,-16000
06417P,台積電兆豐97售03,0,0,0,0,0,0,0,0,0,-16000,0,0,0,0,16000,-16000,-16000
06185P,台表科元大97售05,0,0,0,0,0,0,0,0,0,-16000,0,0,0,0,16000,-16000,-16000
061464,瑞昱群益9A購01  ,0,0,0,0,0,0,0,0,0,-16000,0,0,0,69000,85000,-16000,-16000
060997,上銀兆豐9B購01  ,0,0,0,0,0,0,0,0,0,-16000,0,0,0,65000,81000,-16000,-16000
060998,華通兆豐9A購01  ,0,0,0,0,0,0,0,0,0,-16000,0,0,0,15000,31000,-16000,-16000
060957,SP黃豆凱基9A購04,0,0,0,0,0,0,0,0,0,-16000,0,0,0,14000,30000,-16000,-16000
01002T,土銀國泰R1      ,0,16000,-16000,0,0,0,0,0,0,0,0,0,0,0,0,0,-16000
05757P,旺宏永豐96售03  ,0,0,0,0,0,0,0,0,0,-16000,0,0,0,0,16000,-16000,-16000
05758P,光罩永豐96售02  ,0,0,0,0,0,0,0,0,0,-16000,0,0,0,190000,206000,-16000,-16000
054260,貿聯元大96購03  ,0,0,0,0,0,0,0,0,0,-16000,0,0,0,52000,68000,-16000,-16000
053542,超眾永豐96購01  ,0,0,0,0,0,0,0,0,0,-16000,0,0,0,1000,17000,-16000,-16000
054930,群電凱基98購01  ,0,0,0,0,0,0,0,0,0,-16000,0,0,0,0,16000,-16000,-16000
055802,新日興永豐97購01,0,0,0,0,0,0,0,0,0,-16000,0,0,0,34000,50000,-16000,-16000
058603,台積電元大99購12,0,0,0,0,0,0,0,0,0,-16000,0,0,0,4000,20000,-16000,-16000
058592,聯發科統一9C購01,0,0,0,0,0,0,0,0,0,-16000,0,0,0,36000,52000,-16000,-16000
056105,智原永豐97購01  ,0,0,0,0,0,0,0,0,0,-16000,0,0,0,8000,24000,-16000,-16000
056124,華通國票98購02  ,0,0,0,0,0,0,0,0,0,-16000,0,0,0,19000,35000,-16000,-16000
057048,新日興元大98購01,0,0,0,0,0,0,0,0,0,-16000,0,0,0,90000,106000,-16000,-16000
057057,立積元大9A購01  ,0,0,0,0,0,0,0,0,0,-16000,0,0,0,13000,29000,-16000,-16000
058317,國巨永豐99購02  ,0,0,0,0,0,0,0,0,0,-16000,0,0,0,203000,219000,-16000,-16000
057506,聯鈞國票99購02  ,0,0,0,0,0,0,0,0,0,-16000,0,0,0,46000,62000,-16000,-16000
057388,奇鋐永豐98購02  ,0,0,0,0,0,0,0,0,0,-16000,0,0,0,1000,17000,-16000,-16000
058947,SGBR2X群益9B購02,0,0,0,0,0,0,0,0,0,-16000,0,0,0,39000,55000,-16000,-16000
059146,貿聯國票9A購02  ,0,0,0,0,0,0,0,0,0,-16000,0,0,0,27000,43000,-16000,-16000
056484,聯茂元大98購02  ,0,0,0,0,0,0,0,0,0,-16000,0,0,0,0,16000,-16000,-16000
057299,立積永豐98購02  ,0,0,0,0,0,0,0,0,0,-16000,0,0,0,104000,120000,-16000,-16000
056972,祥碩永豐98購02  ,0,0,0,0,0,0,0,0,0,-16000,0,0,0,5000,21000,-16000,-16000
2414,精技            ,30000,46000,-16000,0,0,0,0,0,0,0,0,0,0,0,0,0,-16000
07637P,國巨國票9A售08  ,0,0,0,0,0,0,0,0,0,-16000,0,0,0,19000,35000,-16000,-16000
6477,安集            ,1000,17000,-16000,0,0,0,0,0,0,0,0,0,0,0,0,0,-16000
061066,嘉晶凱基9B購01  ,0,0,0,0,0,0,0,0,0,-17000,0,0,0,43000,60000,-17000,-17000
061119,國巨永豐9A購03  ,0,0,0,0,0,0,0,0,0,-17000,0,0,0,11000,28000,-17000,-17000
061379,鈺齊永豐9A購02  ,0,0,0,0,0,0,0,0,0,-17000,0,0,0,103000,120000,-17000,-17000
07053P,台灣50兆豐01售01,0,0,0,0,0,0,0,0,0,-17000,0,0,0,55000,72000,-17000,-17000
060368,緯穎元富9A購03  ,0,0,0,0,0,0,0,0,0,-17000,0,0,0,82000,99000,-17000,-17000
05976P,國巨凱基96售14  ,0,0,0,0,0,0,0,0,0,-17000,0,0,0,15000,32000,-17000,-17000
060075,台積電元富99購05,0,0,0,0,0,0,0,0,0,-17000,0,0,0,0,17000,-17000,-17000
059512,晶豪科永豐99購02,0,0,0,0,0,0,0,0,0,-17000,0,0,0,3000,20000,-17000,-17000
054831,緯穎國泰98購01  ,0,0,0,0,0,0,0,0,0,-17000,0,0,0,26000,43000,-17000,-17000
053149,京元電元大96購02,0,0,0,0,0,0,0,0,0,-17000,0,0,0,103000,120000,-17000,-17000
053316,友達群益9A購01  ,0,0,0,0,0,0,0,0,0,-17000,0,0,0,0,17000,-17000,-17000
05759P,智邦永豐96售02  ,0,0,0,0,0,0,0,0,0,-17000,0,0,0,219000,236000,-17000,-17000
057670,欣興元大99購02  ,0,0,0,0,0,0,0,0,0,-17000,0,0,0,103000,120000,-17000,-17000
048192,華通元大96購01  ,0,0,0,0,0,0,0,0,0,-17000,0,0,0,0,17000,-17000,-17000
052022,南電永豐95購03  ,0,0,0,0,0,0,0,0,0,-17000,0,0,0,0,17000,-17000,-17000
049888,智邦國泰96購01  ,0,0,0,0,0,0,0,0,0,-17000,0,0,0,12000,29000,-17000,-17000
04974P,聯發科凱基96售02,0,0,0,0,0,0,0,0,0,-17000,0,0,0,10000,27000,-17000,-17000
050232,奇鋐麥證95購01  ,0,0,0,0,17000,-17000,0,0,0,-17000,0,0,0,0,17000,-17000,-17000
052508,矽力日盛95購02  ,0,0,0,0,0,0,0,0,0,-17000,0,0,0,0,17000,-17000,-17000
05063P,聯電元大96售03  ,0,0,0,0,0,0,0,0,0,-17000,0,0,0,28000,45000,-17000,-17000
051239,國巨元大96購02  ,0,0,0,0,0,0,0,0,0,-17000,0,0,0,0,17000,-17000,-17000
051089,旺宏元大96購04  ,0,0,0,0,0,0,0,0,0,-17000,0,0,0,0,17000,-17000,-17000
056655,旺宏元大99購02  ,0,0,0,0,0,0,0,0,0,-17000,0,0,0,29000,46000,-17000,-17000
057465,智易永豐98購02  ,0,0,0,0,0,0,0,0,0,-17000,0,0,0,7000,24000,-17000,-17000
058160,奇鋐元富99購01  ,0,0,0,0,0,0,0,0,0,-17000,0,0,0,98000,115000,-17000,-17000
057811,南亞科元大98購08,0,0,0,0,0,0,0,0,0,-17000,0,0,0,0,17000,-17000,-17000
058036,南電永豐98購01  ,0,0,0,0,0,0,0,0,0,-17000,0,0,0,0,17000,-17000,-17000
055707,聯鈞永豐98購01  ,0,0,0,0,0,0,0,0,0,-17000,0,0,0,0,17000,-17000,-17000
055620,樺漢國票98購01  ,0,0,0,0,0,0,0,0,0,-17000,0,0,0,17000,34000,-17000,-17000
07804P,美律永豐9A售02  ,0,0,0,0,0,0,0,0,0,-17000,0,0,0,0,17000,-17000,-17000
1110,東泥            ,1000,18000,-17000,0,0,0,0,0,0,0,0,0,0,0,0,0,-17000
2536,宏普            ,16000,33000,-17000,0,0,0,0,0,0,0,0,0,0,0,0,0,-17000
2612,中航            ,30000,47000,-17000,0,0,0,0,0,0,0,0,0,0,0,0,0,-17000
3515,華擎            ,408000,267000,141000,0,0,0,0,178000,-178000,20000,25000,10000,15000,31000,26000,5000,-17000
5285,界霖            ,11000,28000,-17000,0,0,0,0,0,0,0,0,0,0,0,0,0,-17000
059513,揚明光永豐99購01,0,0,0,0,0,0,0,0,0,-18000,0,0,0,12000,30000,-18000,-18000
060622,玉晶光元大9B購02,0,0,0,0,0,0,0,0,0,-18000,0,0,0,32000,50000,-18000,-18000
06999P,玉晶光國票9B售01,0,0,0,0,0,0,0,0,0,-18000,0,0,0,0,18000,-18000,-18000
06619P,聯發科元大98售06,0,0,0,0,0,0,0,0,0,-18000,0,0,0,0,18000,-18000,-18000
061404,臺指反國票04購01,0,0,0,0,0,0,0,0,0,-18000,0,0,0,0,18000,-18000,-18000
061481,嘉澤元大9A購03  ,0,0,0,0,0,0,0,0,0,-18000,0,0,0,29000,47000,-18000,-18000
061503,臻鼎國票9B購01  ,0,0,0,0,0,0,0,0,0,-18000,0,0,0,0,18000,-18000,-18000
06490P,鴻海富邦99售02  ,0,0,0,0,0,0,0,0,0,-18000,0,0,0,2000,20000,-18000,-18000
060836,上銀國票9A購03  ,0,0,0,0,0,0,0,0,0,-18000,0,0,0,38000,56000,-18000,-18000
051394,奇鋐兆豐95購01  ,0,0,0,0,0,0,0,0,0,-18000,0,0,0,20000,38000,-18000,-18000
046680,上証反群益95購01,0,0,0,0,0,0,0,0,0,-18000,0,0,0,0,18000,-18000,-18000
048759,巨大元富96購01  ,0,0,0,0,0,0,0,0,0,-18000,0,0,0,0,18000,-18000,-18000
054356,可成兆豐97購01  ,0,0,0,0,0,0,0,0,0,-18000,0,0,0,0,18000,-18000,-18000
054161,友訊凱基98購01  ,0,0,0,0,0,0,0,0,0,-18000,0,0,0,40000,58000,-18000,-18000
053331,玉晶光永豐97購02,0,0,0,0,0,0,0,0,0,-18000,0,0,0,0,18000,-18000,-18000
054866,宏盛群益98購01  ,0,0,0,0,0,0,0,0,0,-18000,0,0,0,2000,20000,-18000,-18000
054778,世紀鋼國票99購01,0,0,0,0,0,0,0,0,0,-18000,0,0,0,91000,109000,-18000,-18000
055568,緯穎凱基97購02  ,0,0,0,0,0,0,0,0,0,-18000,0,0,0,2000,20000,-18000,-18000
05594P,旺宏國票96售04  ,0,0,0,0,0,0,0,0,0,-18000,0,0,0,35000,53000,-18000,-18000
058144,聯茂元大99購02  ,0,0,0,0,0,0,0,0,0,-18000,0,0,0,20000,38000,-18000,-18000
057068,國巨永豐98購06  ,0,0,0,0,0,0,0,0,0,-18000,0,0,0,30000,48000,-18000,-18000
058074,欣興凱基99購01  ,0,0,0,0,0,0,0,0,0,-18000,0,0,0,16000,34000,-18000,-18000
057562,奇鋐兆豐98購01  ,0,0,0,0,0,0,0,0,0,-18000,0,0,0,0,18000,-18000,-18000
058833,台表科永豐99購01,0,0,0,0,0,0,0,0,0,-18000,0,0,0,37000,55000,-18000,-18000
059063,康控凱基99購04  ,0,0,0,0,0,0,0,0,0,-18000,0,0,0,49000,67000,-18000,-18000
059215,台積電元大99購28,0,0,0,0,0,0,0,0,0,-18000,0,0,0,10000,28000,-18000,-18000
059220,聯發科元大99購20,0,0,0,0,0,0,0,0,0,-18000,0,0,0,176000,194000,-18000,-18000
059313,元石油元大99購06,0,0,0,0,0,0,0,0,0,-18000,0,0,0,6000,24000,-18000,-18000
057288,聯茂元大98購03  ,0,0,0,0,0,0,0,0,0,-18000,0,0,0,10000,28000,-18000,-18000
056573,華新科元大99購06,0,0,0,0,0,0,0,0,0,-18000,0,0,0,65000,83000,-18000,-18000
056776,聯茂元大99購01  ,0,0,0,0,0,0,0,0,0,-18000,0,0,0,0,18000,-18000,-18000
056521,群創日盛98購01  ,0,0,0,0,0,0,0,0,0,-18000,0,0,0,0,18000,-18000,-18000
6214,精誠            ,84000,117000,-33000,0,0,0,0,0,0,15000,2000,0,2000,13000,0,13000,-18000
2850,新產            ,11000,29000,-18000,0,0,0,0,0,0,0,0,0,0,0,0,0,-18000
2390,云辰            ,36000,54000,-18000,0,0,0,0,0,0,0,0,0,0,0,0,0,-18000
07776P,國巨群益9B售02  ,0,0,0,0,0,0,0,0,0,-18000,0,0,0,0,18000,-18000,-18000
07662P,台積電兆豐9A售03,0,0,0,0,0,0,0,0,0,-18000,0,0,0,0,18000,-18000,-18000
1525,江申            ,1000,4000,-3000,0,0,0,0,15000,-15000,0,0,0,0,0,0,0,-18000
1463,強盛            ,0,18000,-18000,0,0,0,0,0,0,0,0,0,0,0,0,0,-18000
1323,永裕            ,2000,20000,-18000,0,0,0,0,0,0,0,0,0,0,0,0,0,-18000
07587P,台灣50國票9A售11,0,0,0,0,0,0,0,0,0,-18000,0,0,0,0,18000,-18000,-18000
07470P,國巨元大9A售06  ,0,0,0,0,0,0,0,0,0,-18000,0,0,0,102000,120000,-18000,-18000
06533P,上証2X中信9B售01,0,0,0,0,0,0,0,0,0,-19000,0,0,0,1000,20000,-19000,-19000
06535P,可成群益99售02  ,0,0,0,0,0,0,0,0,0,-19000,0,0,0,0,19000,-19000,-19000
06254P,臺股指群益97售07,0,0,0,0,0,0,0,0,0,-19000,0,0,0,59000,78000,-19000,-19000
06232P,智易永豐97售01  ,0,0,0,0,0,0,0,0,0,-19000,0,0,0,36000,55000,-19000,-19000
061545,華新科群益9A購09,0,0,0,0,0,0,0,0,0,-19000,0,0,0,0,19000,-19000,-19000
060392,華擎群益9C購02  ,0,0,0,0,0,0,0,0,0,-19000,0,0,0,1000,20000,-19000,-19000
059558,T50正2凱基9C購03,0,0,0,0,0,0,0,0,0,-19000,0,0,0,0,19000,-19000,-19000
054908,群電康和97購01  ,0,0,0,0,0,0,0,0,0,-19000,0,0,0,0,19000,-19000,-19000
035274,華新台新97購01  ,0,0,0,0,0,0,0,0,0,-19000,0,0,0,1000,20000,-19000,-19000
052068,瑞儀兆豐96購01  ,0,0,0,0,0,0,0,0,0,-19000,0,0,0,1000,20000,-19000,-19000
055040,台虹富邦99購01  ,0,0,0,0,0,0,0,0,0,-19000,0,0,0,0,19000,-19000,-19000
055441,緯穎國票98購01  ,0,0,0,0,0,0,0,0,0,-19000,0,0,0,0,19000,-19000,-19000
058390,樺漢國票9A購01  ,0,0,0,0,0,0,0,0,0,-19000,0,0,0,0,19000,-19000,-19000
058037,台灣50元大9B購02,0,0,0,0,0,0,0,0,0,-19000,0,0,0,0,19000,-19000,-19000
057150,貿聯國票99購02  ,0,0,0,0,0,0,0,0,0,-19000,0,0,0,0,19000,-19000,-19000
058785,臺股指國票99購04,0,0,0,0,0,0,0,0,0,-19000,0,0,0,6000,25000,-19000,-19000
058699,楠梓電元大99購02,0,0,0,0,0,0,0,0,0,-19000,0,0,0,68000,87000,-19000,-19000
056352,鴻海元大99購01  ,0,0,0,0,0,0,0,0,0,-19000,0,0,0,49000,68000,-19000,-19000
07467P,上銀元大9A售03  ,0,0,0,0,0,0,0,0,0,-19000,0,0,0,15000,34000,-19000,-19000
07477P,國巨群益9A售04  ,0,0,0,0,0,0,0,0,0,-19000,0,0,0,0,19000,-19000,-19000
1435,中福            ,0,19000,-19000,0,0,0,0,0,0,0,0,0,0,0,0,0,-19000
059621,T50正2凱基9C購04,0,0,0,0,0,0,0,0,0,-20000,0,0,0,0,20000,-20000,-20000
059713,滬深2X元大9C購04,0,0,0,0,0,0,0,0,0,-20000,0,0,0,0,20000,-20000,-20000
060038,台積電國票99購13,0,0,0,0,0,0,0,0,0,-20000,0,0,0,4000,24000,-20000,-20000
059762,禾伸堂永豐99購02,0,0,0,0,0,0,0,0,0,-20000,0,0,0,262000,282000,-20000,-20000
060343,台積電統一9C購02,0,0,0,0,0,0,0,0,0,-20000,0,0,0,0,20000,-20000,-20000
060220,華新科凱基9A購08,0,0,0,0,0,0,0,0,0,-20000,0,0,0,0,20000,-20000,-20000
060587,牧德元富9A購01  ,0,0,0,0,0,0,0,0,0,-20000,0,0,0,0,20000,-20000,-20000
060532,欣興中信9A購01  ,0,0,0,0,0,0,0,0,0,-20000,0,0,0,12000,32000,-20000,-20000
060524,國巨中信9A購03  ,0,0,0,0,0,0,0,0,0,-20000,0,0,0,21000,41000,-20000,-20000
060494,台灣50元大01購12,0,0,0,0,0,0,0,0,0,-20000,0,0,0,0,20000,-20000,-20000
061432,世紀鋼元大9A購05,0,0,0,0,0,0,0,0,0,-20000,0,0,0,0,20000,-20000,-20000
061474,瑞昱元大9A購04  ,0,0,0,0,0,0,0,0,0,-20000,0,0,0,8000,28000,-20000,-20000
061471,台積電元大9A購31,0,0,0,0,0,0,0,0,0,-20000,0,0,0,0,20000,-20000,-20000
061472,台積電元大9A購32,0,0,0,0,0,0,0,0,0,-20000,0,0,0,0,20000,-20000,-20000
061456,玉晶光凱基9B購05,0,0,0,0,0,0,0,0,0,-20000,0,0,0,1000,21000,-20000,-20000
06263P,燿華凱基97售04  ,0,0,0,0,0,0,0,0,0,-20000,0,0,0,20000,40000,-20000,-20000
06219P,國巨元富97售05  ,0,0,0,0,0,0,0,0,0,-20000,0,0,0,0,20000,-20000,-20000
06550P,健策元大99售01  ,0,0,0,0,0,0,0,0,0,-20000,0,0,0,15000,35000,-20000,-20000
06504P,麗豐國票99售02  ,0,0,0,0,0,0,0,0,0,-20000,0,0,0,0,20000,-20000,-20000
06848P,聯詠元大98售04  ,0,0,0,0,0,0,0,0,0,-20000,0,0,0,14000,34000,-20000,-20000
06915P,晶技元富98售02  ,0,0,0,0,0,0,0,0,0,-20000,0,0,0,0,20000,-20000,-20000
06904P,TPK凱基98售03   ,0,0,0,0,0,0,0,0,0,-20000,0,0,0,0,20000,-20000,-20000
06934P,聯鈞元大98售03  ,0,0,0,0,0,0,0,0,0,-20000,0,0,0,10000,30000,-20000,-20000
06935P,神達元大98售02  ,0,0,0,0,0,0,0,0,0,-20000,0,0,0,0,20000,-20000,-20000
07051P,大立光中信99售02,0,0,0,0,0,0,0,0,0,-20000,0,0,0,0,20000,-20000,-20000
07052P,臺股指中信9C售02,0,0,0,0,0,0,0,0,0,-20000,0,0,0,0,20000,-20000,-20000
060744,鴻海國票9A購04  ,0,0,0,0,0,0,0,0,0,-20000,0,0,0,8000,28000,-20000,-20000
060980,台積電元大9A購21,0,0,0,0,0,0,0,0,0,-20000,0,0,0,30000,50000,-20000,-20000
061387,鴻海群益9A購05  ,0,0,0,0,0,0,0,0,0,-20000,0,0,0,10000,30000,-20000,-20000
061389,華新科群益9B購01,0,0,0,0,0,0,0,0,0,-20000,0,0,0,88000,108000,-20000,-20000
061235,台積電元大9A購23,0,0,0,0,0,0,0,0,0,-20000,0,0,0,0,20000,-20000,-20000
05506P,茂林凱基96售03  ,0,0,0,0,0,0,0,0,0,-20000,0,0,0,0,20000,-20000,-20000
055144,T50反1元大97購03,0,0,0,0,0,0,0,0,0,-20000,0,0,0,0,20000,-20000,-20000
051361,泰鼎元大95購01  ,0,0,0,0,0,0,0,0,0,-20000,0,0,0,0,20000,-20000,-20000
051510,新光金中信97購01,0,0,0,0,0,0,0,0,0,-20000,0,0,0,0,20000,-20000,-20000
053713,漢唐凱基96購04  ,0,0,0,0,0,0,0,0,0,-20000,0,0,0,0,20000,-20000,-20000
053749,揚明光永豐97購01,0,0,0,0,0,0,0,0,0,-20000,0,0,0,0,20000,-20000,-20000
051049,亞德客群益95購01,0,0,0,0,0,0,0,0,0,-20000,0,0,0,0,20000,-20000,-20000
050948,華固群益95購01  ,0,0,0,0,0,0,0,0,0,-20000,0,0,0,0,20000,-20000,-20000
051170,南電元大95購03  ,0,0,0,0,0,0,0,0,0,-20000,0,0,0,0,20000,-20000,-20000
051211,道瓊反統一95購01,0,0,0,0,0,0,0,0,0,-20000,0,0,0,0,20000,-20000,-20000
051339,智易永豐95購02  ,0,0,0,0,0,0,0,0,0,-20000,0,0,0,0,20000,-20000,-20000
050783,旺宏國泰96購02  ,0,0,0,0,0,0,0,0,0,-20000,0,0,0,0,20000,-20000,-20000
050699,京鼎凱基96購01  ,0,0,0,0,0,0,0,0,0,-20000,0,0,0,0,20000,-20000,-20000
050135,禾伸堂兆豐95購01,0,0,0,0,0,0,0,0,0,-20000,0,0,0,2000,22000,-20000,-20000
052568,漢唐凱基96購02  ,0,0,0,0,0,0,0,0,0,-20000,0,0,0,0,20000,-20000,-20000
052134,智邦凱基95購09  ,0,0,0,0,0,0,0,0,0,-20000,0,0,0,10000,30000,-20000,-20000
05222P,致伸凱基95售02  ,0,0,0,0,0,0,0,0,0,-20000,0,0,0,0,20000,-20000,-20000
05195P,南茂康和95售01  ,0,0,0,0,0,0,0,0,0,-20000,0,0,0,0,20000,-20000,-20000
04713P,創意元大95售01  ,0,0,0,0,0,0,0,0,0,-20000,0,0,0,0,20000,-20000,-20000
00654R,富邦印度反1     ,67000,0,67000,0,0,0,0,0,0,-87000,0,0,0,29000,116000,-87000,-20000
054896,聯茂日盛97購01  ,0,0,0,0,0,0,0,0,0,-20000,0,0,0,0,20000,-20000,-20000
053107,旺宏兆豐97購01  ,0,0,0,0,0,0,0,0,0,-20000,0,0,0,100000,120000,-20000,-20000
055013,訊連元富97購01  ,0,0,0,0,0,0,0,0,0,-20000,0,0,0,0,20000,-20000,-20000
054544,統一中信97購01  ,0,0,0,0,0,0,0,0,0,-20000,0,0,0,0,20000,-20000,-20000
053609,華新中信9A購01  ,0,0,0,0,0,0,0,0,0,-20000,0,0,0,0,20000,-20000,-20000
053697,臻鼎元大96購02  ,0,0,0,0,0,0,0,0,0,-20000,0,0,0,0,20000,-20000,-20000
052695,台表科中信98購01,0,0,0,0,0,0,0,0,0,-20000,0,0,0,0,20000,-20000,-20000
052748,群創元大9A購02  ,0,0,0,0,0,0,0,0,0,-20000,0,0,0,0,20000,-20000,-20000
052827,昇陽半永豐97購01,0,0,0,0,0,0,0,0,0,-20000,0,0,0,0,20000,-20000,-20000
052836,旺宏國泰98購01  ,0,0,0,0,0,0,0,0,0,-20000,0,0,0,12000,32000,-20000,-20000
05424P,台達電亞東96售02,0,0,0,0,0,0,0,0,0,-20000,0,0,0,0,20000,-20000,-20000
054245,鴻海元大96購23  ,0,0,0,0,0,0,0,0,0,-20000,0,0,0,0,20000,-20000,-20000
052888,台表科中信9A購01,0,0,0,0,0,0,0,0,0,-20000,0,0,0,0,20000,-20000,-20000
05288P,寶成元富95售02  ,0,0,0,0,0,0,0,0,0,-20000,0,0,0,0,20000,-20000,-20000
053036,聯電凱基98購01  ,0,0,0,0,0,0,0,0,0,-20000,0,0,0,0,20000,-20000,-20000
052961,國巨凱基97購02  ,0,0,0,0,0,0,0,0,0,-20000,0,0,0,0,20000,-20000,-20000
057660,訊芯兆豐98購02  ,0,0,0,0,0,0,0,0,0,-20000,0,0,0,0,20000,-20000,-20000
057607,旺宏台新98購02  ,0,0,0,0,0,0,0,0,0,-20000,0,0,0,0,20000,-20000,-20000
057628,旺宏永豐98購02  ,0,0,0,0,0,0,0,0,0,-20000,0,0,0,10000,30000,-20000,-20000
057925,貿聯凱基99購01  ,0,0,0,0,0,0,0,0,0,-20000,0,0,0,27000,47000,-20000,-20000
057903,聯鈞永豐99購01  ,0,0,0,0,0,0,0,0,0,-20000,0,0,0,0,20000,-20000,-20000
055576,嘉晶統一98購01  ,0,0,0,0,0,0,0,0,0,-20000,0,0,0,0,20000,-20000,-20000
055628,旺宏永豐97購01  ,0,0,0,0,0,0,0,0,0,-20000,0,0,0,0,20000,-20000,-20000
055366,國巨元大98購05  ,0,0,0,0,0,0,0,0,0,-20000,0,0,0,0,20000,-20000,-20000
05567P,致伸群益96售01  ,0,0,0,0,0,0,0,0,0,-20000,0,0,0,0,20000,-20000,-20000
056004,南電永豐97購02  ,0,0,0,0,0,0,0,0,0,-20000,0,0,0,19000,39000,-20000,-20000
055905,可成兆豐97購03  ,0,0,0,0,0,0,0,0,0,-20000,0,0,0,10000,30000,-20000,-20000
055906,大立光兆豐97購03,0,0,0,0,0,0,0,0,0,-20000,0,0,0,0,20000,-20000,-20000
055708,茂林永豐97購02  ,0,0,0,0,0,0,0,0,0,-20000,0,0,0,0,20000,-20000,-20000
05574P,英業達元富96售01,0,0,0,0,0,0,0,0,0,-20000,0,0,0,0,20000,-20000,-20000
055822,臺股指國票97購09,0,0,0,0,0,0,0,0,0,-20000,0,0,0,0,20000,-20000,-20000
055824,臺股指國票97購11,0,0,0,0,0,0,0,0,0,-20000,0,0,0,17000,37000,-20000,-20000
05866P,致伸元大96售01  ,0,0,0,0,0,0,0,0,0,-20000,0,0,0,0,20000,-20000,-20000
058676,聯茂群益99購01  ,0,0,0,0,0,0,0,0,0,-20000,0,0,0,0,20000,-20000,-20000
058678,南亞科日盛99購01,0,0,0,0,0,0,0,0,0,-20000,0,0,0,0,20000,-20000,-20000
055265,玉晶光永豐98購03,0,0,0,0,0,0,0,0,0,-20000,0,0,0,0,20000,-20000,-20000
056324,南亞科兆豐98購01,0,0,0,0,0,0,0,0,0,-20000,0,0,0,15000,35000,-20000,-20000
057153,祥碩國泰99購01  ,0,0,0,0,0,0,0,0,0,-20000,0,0,0,0,20000,-20000,-20000
057128,台光電凱基98購03,0,0,0,0,0,0,0,0,0,-20000,0,0,0,0,20000,-20000,-20000
058384,大成鋼中信99購01,0,0,0,0,0,0,0,0,0,-20000,0,0,0,0,20000,-20000,-20000
058431,國巨統一9B購01  ,0,0,0,0,0,0,0,0,0,-20000,0,0,0,0,20000,-20000,-20000
058213,欣興群益99購01  ,0,0,0,0,0,0,0,0,0,-20000,0,0,0,43000,63000,-20000,-20000
055457,聚陽永豐97購01  ,0,0,0,0,0,0,0,0,0,-20000,0,0,0,0,20000,-20000,-20000
055481,聚陽元大97購01  ,0,0,0,0,0,0,0,0,0,-20000,0,0,0,0,20000,-20000,-20000
056055,國巨元大97購15  ,0,0,0,0,0,0,0,0,0,-20000,0,0,0,0,20000,-20000,-20000
056415,聯發科中信98購04,0,0,0,0,0,0,0,0,0,-20000,0,0,0,10000,30000,-20000,-20000
056396,祥碩永豐98購01  ,0,0,0,0,0,0,0,0,0,-20000,0,0,0,0,20000,-20000,-20000
05720P,可成中信98售01  ,0,0,0,0,0,0,0,0,0,-20000,0,0,0,0,20000,-20000,-20000
057988,鈺齊元富98購02  ,0,0,0,0,0,0,0,0,0,-20000,0,0,0,0,20000,-20000,-20000
05658P,日月光元富96售02,0,0,0,0,0,0,0,0,0,-20000,0,0,0,1000,21000,-20000,-20000
059056,技嘉凱基99購02  ,0,0,0,0,0,0,0,0,0,-20000,0,0,0,0,20000,-20000,-20000
059073,元油2X元大9C購14,0,0,0,0,0,0,0,0,0,-20000,0,0,0,0,20000,-20000,-20000
05881P,彩晶康和96售01  ,0,0,0,0,0,0,0,0,0,-20000,0,0,0,0,20000,-20000,-20000
057469,康友永豐98購02  ,0,0,0,0,0,0,0,0,0,-20000,0,0,0,0,20000,-20000,-20000
057452,新日興元富98購01,0,0,0,0,0,0,0,0,0,-20000,0,0,0,30000,50000,-20000,-20000
07754P,日月光元大9A售02,0,0,0,0,0,0,0,0,0,-20000,0,0,0,1000,21000,-20000,-20000
07821P,臺股指國票9A售12,0,0,0,0,0,0,0,0,0,-20000,0,0,0,0,20000,-20000,-20000
07487P,鴻海國票9A售01  ,0,0,0,0,0,0,0,0,0,-20000,0,0,0,0,20000,-20000,-20000
07457P,宏達電元大9A售01,0,0,0,0,0,0,0,0,0,-20000,0,0,0,42000,62000,-20000,-20000
07395P,台積電群益99售13,0,0,0,0,0,0,0,0,0,-20000,0,0,0,0,20000,-20000,-20000
07553P,嘉晶元大9A售02  ,0,0,0,0,0,0,0,0,0,-20000,0,0,0,0,20000,-20000,-20000
2397,友通            ,12000,32000,-20000,0,0,0,0,0,0,0,0,0,0,0,0,0,-20000
2530,華建            ,0,20000,-20000,0,0,0,0,0,0,0,0,0,0,0,0,0,-20000
3032,偉訓            ,26000,46000,-20000,0,0,0,0,0,0,0,0,0,0,0,0,0,-20000
910861,神州-DR         ,0,20000,-20000,0,0,0,0,0,0,0,0,0,0,0,0,0,-20000
9917,中保科          ,12100,33000,-20900,0,0,0,0,0,0,0,0,0,0,0,0,0,-20900
060812,智邦凱基9A購01  ,0,0,0,0,0,0,0,0,0,-21000,0,0,0,62000,83000,-21000,-21000
061577,泰碩元大9A購03  ,0,0,0,0,0,0,0,0,0,-21000,0,0,0,0,21000,-21000,-21000
060534,友達麥證9A購01  ,0,0,0,0,21000,-21000,0,0,0,-21000,0,0,0,0,21000,-21000,-21000
059611,台積電永豐99購05,0,0,0,0,0,0,0,0,0,-21000,0,0,0,2000,23000,-21000,-21000
057949,南電國票99購01  ,0,0,0,0,0,0,0,0,0,-21000,0,0,0,10000,31000,-21000,-21000
057600,大立光群益99購03,0,0,0,0,0,0,0,0,0,-21000,0,0,0,0,21000,-21000,-21000
054170,泰鼎凱基98購01  ,0,0,0,0,0,0,0,0,0,-21000,0,0,0,0,21000,-21000,-21000
053184,世紀鋼元富96購01,0,0,0,0,0,0,0,0,0,-21000,0,0,0,11000,32000,-21000,-21000
00757,統一FANG+       ,0,0,0,0,0,0,0,0,0,-21000,0,0,0,207000,228000,-21000,-21000
050754,元金2X元富9B購01,0,0,0,0,0,0,0,0,0,-21000,0,0,0,0,21000,-21000,-21000
050580,強茂國票95購01  ,0,0,0,0,0,0,0,0,0,-21000,0,0,0,25000,46000,-21000,-21000
053780,南亞科元大96購03,0,0,0,0,0,0,0,0,0,-21000,0,0,0,102000,123000,-21000,-21000
057436,義隆國票99購02  ,5000,0,5000,0,0,0,0,0,0,-26000,0,0,0,3000,29000,-26000,-21000
059007,南電元大99購05  ,0,0,0,0,0,0,0,0,0,-21000,0,0,0,1000,22000,-21000,-21000
05606P,TPK國票97售02   ,0,0,0,0,0,0,0,0,0,-21000,0,0,0,0,21000,-21000,-21000
057980,聯詠永豐98購01  ,0,0,0,0,0,0,0,0,0,-21000,0,0,0,49000,70000,-21000,-21000
05817P,可成凱基96售07  ,0,0,0,0,0,0,0,0,0,-21000,0,0,0,0,21000,-21000,-21000
055968,祥碩元大97購04  ,0,0,0,0,0,0,0,0,0,-21000,0,0,0,82000,103000,-21000,-21000
055563,智易凱基97購02  ,0,0,0,0,0,0,0,0,0,-21000,0,0,0,3000,24000,-21000,-21000
2851,中再保          ,12000,33000,-21000,0,0,0,0,0,0,0,0,0,0,0,0,0,-21000
2704,國賓            ,24000,45000,-21000,0,0,0,0,0,0,0,0,0,0,0,0,0,-21000
07570P,旺宏凱基9A售04  ,0,0,0,0,0,0,0,0,0,-21000,0,0,0,10000,31000,-21000,-21000
07418P,聯發科元大99售45,0,0,0,0,0,0,0,0,0,-21000,0,0,0,8000,29000,-21000,-21000
07317P,T50正2凱基9B售02,0,0,0,0,0,0,0,0,0,-21000,0,0,0,40000,61000,-21000,-21000
07218P,臺股指凱基99售31,0,0,0,0,0,0,0,0,0,-21000,0,0,0,12000,33000,-21000,-21000
1219,福壽            ,0,21000,-21000,0,0,0,0,0,0,0,0,0,0,0,0,0,-21000
07767P,華新科群益9A售07,0,0,0,0,0,0,0,0,0,-21000,0,0,0,3000,24000,-21000,-21000
059524,FBVIX凱基9A購02 ,0,0,0,0,0,0,0,0,0,-22000,0,0,0,40000,62000,-22000,-22000
060478,南電元大9A購01  ,0,0,0,0,0,0,0,0,0,-22000,0,0,0,0,22000,-22000,-22000
06614P,祥碩永豐98售03  ,0,0,0,0,0,0,0,0,0,-22000,0,0,0,221000,243000,-22000,-22000
06672P,聯發科群益98售05,0,0,0,0,0,0,0,0,0,-22000,0,0,0,0,22000,-22000,-22000
061032,金像電永豐9A購03,0,0,0,0,0,0,0,0,0,-22000,0,0,0,244000,266000,-22000,-22000
061356,南電元大9A購06  ,0,0,0,0,0,0,0,0,0,-22000,0,0,0,32000,54000,-22000,-22000
055090,國巨群益97購03  ,0,0,0,0,0,0,0,0,0,-22000,0,0,0,202000,224000,-22000,-22000
05076P,深中小群益99售02,0,0,0,0,0,0,0,0,0,-22000,0,0,0,0,22000,-22000,-22000
051055,友達群益98購01  ,0,0,0,0,0,0,0,0,0,-22000,0,0,0,5000,27000,-22000,-22000
05242P,群創國泰97售01  ,0,0,0,0,0,0,0,0,0,-22000,0,0,0,0,22000,-22000,-22000
051792,泰鼎國票96購02  ,0,0,0,0,0,0,0,0,0,-22000,0,0,0,0,22000,-22000,-22000
051731,聯電國票96購02  ,0,0,0,0,0,0,0,0,0,-22000,0,0,0,18000,40000,-22000,-22000
053114,聯茂兆豐97購01  ,0,0,0,0,0,0,0,0,0,-22000,0,0,0,0,22000,-22000,-22000
054897,信錦康和97購01  ,0,0,0,0,0,0,0,0,0,-22000,0,0,0,18000,40000,-22000,-22000
052846,智邦統一97購01  ,0,0,0,0,0,0,0,0,0,-22000,0,0,0,1000,23000,-22000,-22000
053017,世紀鋼統一96購02,0,0,0,0,0,0,0,0,0,-22000,0,0,0,0,22000,-22000,-22000
057920,奇力新凱基98購08,0,0,0,0,0,0,0,0,0,-22000,0,0,0,18000,40000,-22000,-22000
057886,聯詠群益98購01  ,0,0,0,0,0,0,0,0,0,-22000,0,0,0,76000,98000,-22000,-22000
055933,欣興群益98購02  ,0,0,0,0,0,0,0,0,0,-22000,0,0,0,73000,95000,-22000,-22000
058575,智邦群益99購01  ,0,0,0,0,0,0,0,0,0,-22000,0,0,0,18000,40000,-22000,-22000
058454,嘉晶永豐99購01  ,0,0,0,0,0,0,0,0,0,-22000,0,0,0,3000,25000,-22000,-22000
058318,致茂永豐9A購01  ,0,0,0,0,0,0,0,0,0,-22000,0,0,0,163000,185000,-22000,-22000
058357,智邦凱基99購02  ,0,0,0,0,0,0,0,0,0,-22000,0,0,0,0,22000,-22000,-22000
056239,宏達電群益98購01,0,0,0,0,0,0,0,0,0,-22000,0,0,0,9000,31000,-22000,-22000
058136,景碩元大99購02  ,0,0,0,0,0,0,0,0,0,-22000,0,0,0,4000,26000,-22000,-22000
057028,台郡凱基99購02  ,0,0,0,0,0,0,0,0,0,-22000,0,0,0,3000,25000,-22000,-22000
055486,國巨元大98購06  ,0,0,0,0,0,0,0,0,0,-22000,0,0,0,0,22000,-22000,-22000
056511,超眾永豐98購01  ,0,0,0,0,0,0,0,0,0,-22000,0,0,0,0,22000,-22000,-22000
056478,晶技元大99購01  ,0,0,0,0,0,0,0,0,0,-22000,0,0,0,8000,30000,-22000,-22000
056551,台郡凱基98購04  ,0,0,0,0,0,0,0,0,0,-22000,0,0,0,4000,26000,-22000,-22000
056839,台光電元富98購02,0,0,0,0,0,0,0,0,0,-22000,0,0,0,10000,32000,-22000,-22000
059014,SGBR2X元富03購01,0,0,0,0,0,0,0,0,0,-22000,0,0,0,2000,24000,-22000,-22000
05745P,富邦金兆豐96售02,0,0,0,0,0,0,0,0,0,-22000,0,0,0,0,22000,-22000,-22000
07794P,智邦國票9A售03  ,0,0,0,0,0,0,0,0,0,-22000,0,0,0,5000,27000,-22000,-22000
1709,和益            ,65000,87000,-22000,0,0,0,0,0,0,0,0,0,0,0,0,0,-22000
07219P,臺股指凱基99售32,0,0,0,0,0,0,0,0,0,-22000,0,0,0,16000,38000,-22000,-22000
07387P,臺股指群益99售25,0,0,0,0,0,0,0,0,0,-22000,0,0,0,20000,42000,-22000,-22000
3679,新至陞          ,4000,24000,-20000,0,0,0,0,0,0,-2000,0,2000,-2000,0,0,0,-22000
6139,亞翔            ,56000,78000,-22000,0,0,0,0,0,0,0,0,0,0,0,0,0,-22000
8463,潤泰材          ,9000,31000,-22000,0,0,0,0,0,0,0,0,0,0,0,0,0,-22000
6591,動力-KY         ,55000,78000,-23000,0,0,0,0,0,0,1000,1000,0,1000,0,0,0,-22000
06091P,華新科統一97售01,0,0,0,0,0,0,0,0,0,-23000,0,0,0,22000,45000,-23000,-23000
06676P,華新科國票98售03,0,0,0,0,0,0,0,0,0,-23000,0,0,0,0,23000,-23000,-23000
07006P,旺宏統一9B售03  ,0,0,0,0,0,0,0,0,0,-23000,0,0,0,0,23000,-23000,-23000
06467P,旺宏統一98售01  ,0,0,0,0,0,0,0,0,0,-23000,0,0,0,0,23000,-23000,-23000
060450,南亞元大9A購02  ,0,0,0,0,0,0,0,0,0,-23000,0,0,0,50000,73000,-23000,-23000
06054P,臺股指中信9A售01,0,0,0,0,0,0,0,0,0,-23000,0,0,0,0,23000,-23000,-23000
059612,奇鋐永豐99購02  ,0,0,0,0,0,0,0,0,0,-23000,0,0,0,20000,43000,-23000,-23000
059733,緯穎元大99購08  ,0,0,0,0,0,0,0,0,0,-23000,0,0,0,43000,66000,-23000,-23000
059913,台積電元大99購44,0,0,0,0,0,0,0,0,0,-23000,0,0,0,62000,85000,-23000,-23000
060010,義隆群益99購02  ,0,0,0,0,0,0,0,0,0,-23000,0,0,0,56000,79000,-23000,-23000
057918,旺宏凱基99購01  ,0,0,0,0,0,0,0,0,0,-23000,0,0,0,12000,35000,-23000,-23000
054861,智邦群益97購01  ,0,0,0,0,0,0,0,0,0,-23000,0,0,0,4000,27000,-23000,-23000
052784,緯穎國票97購02  ,0,0,0,0,0,0,0,0,0,-23000,0,0,0,9000,32000,-23000,-23000
03669C,滬深2X元富09牛01,0,0,0,0,0,0,0,0,0,-23000,0,0,0,0,23000,-23000,-23000
053956,旺宏永豐96購04  ,0,0,0,0,0,0,0,0,0,-23000,0,0,0,62000,85000,-23000,-23000
059340,鴻海凱基9A購12  ,0,0,0,0,0,0,0,0,0,-23000,0,0,0,21000,44000,-23000,-23000
056557,世紀鋼凱基98購02,0,0,0,0,0,0,0,0,0,-23000,0,0,0,46000,69000,-23000,-23000
057119,微星康和98購01  ,0,0,0,0,0,0,0,0,0,-23000,0,0,0,0,23000,-23000,-23000
058115,台光電中信99購01,0,0,0,0,0,0,0,0,0,-23000,0,0,0,106000,129000,-23000,-23000
058692,華邦電國票9B購01,0,0,0,0,0,0,0,0,0,-23000,0,0,0,80000,103000,-23000,-23000
8114,振樺電          ,4000,27000,-23000,0,0,0,0,0,0,0,0,0,0,0,0,0,-23000
2425,承啟            ,175000,198000,-23000,0,0,0,0,0,0,0,0,0,0,0,0,0,-23000
07265P,大立光元大99售16,0,0,0,0,0,0,0,0,0,-23000,0,0,0,7000,30000,-23000,-23000
2492,華新科          ,2386314,2544000,-157686,0,0,0,600000,10000,590000,-456000,332000,373000,-41000,75000,490000,-415000,-23686
059626,台積電凱基01購01,0,0,0,0,0,0,0,0,0,-24000,0,0,0,1000,25000,-24000,-24000
059364,昇陽半永豐99購02,0,0,0,0,0,0,0,0,0,-24000,0,0,0,18000,42000,-24000,-24000
06173P,華通元大97售02  ,0,0,0,0,0,0,0,0,0,-24000,0,0,0,17000,41000,-24000,-24000
07046P,大立光富邦9C售03,0,0,0,0,0,0,0,0,0,-24000,0,0,0,0,24000,-24000,-24000
061043,百和永豐9A購01  ,0,0,0,0,0,0,0,0,0,-24000,0,0,0,219000,243000,-24000,-24000
061194,聯鈞永豐9A購02  ,0,0,0,0,0,0,0,0,0,-24000,0,0,0,2000,26000,-24000,-24000
03433B,臺股指元大9C熊01,0,0,0,0,0,0,0,0,0,-24000,0,0,0,31000,55000,-24000,-24000
046813,聯電凱基96購01  ,0,0,0,0,0,0,0,0,0,-24000,0,0,0,10000,34000,-24000,-24000
03686P,大立光統一98售02,0,0,0,0,0,0,0,0,0,-24000,0,0,0,0,24000,-24000,-24000
058224,世芯統一9B購02  ,0,0,0,0,0,0,0,0,0,-24000,0,0,0,779000,803000,-24000,-24000
056774,和鑫元大98購01  ,0,0,0,0,0,0,0,0,0,-24000,0,0,0,150000,174000,-24000,-24000
057446,旺宏元富02購01  ,0,0,0,0,0,0,0,0,0,-24000,0,0,0,48000,72000,-24000,-24000
2642,宅配通          ,33000,57000,-24000,0,0,0,0,0,0,0,0,0,0,0,0,0,-24000
6226,光鼎            ,49000,73000,-24000,0,0,0,0,0,0,0,0,0,0,0,0,0,-24000
4560,強信-KY         ,105000,129000,-24000,0,0,0,0,0,0,0,0,0,0,0,0,0,-24000
3583,辛耘            ,46000,70000,-24000,0,0,0,0,0,0,0,0,0,0,0,0,0,-24000
1795,美時            ,256000,280000,-24000,0,0,0,0,0,0,0,0,0,0,0,0,0,-24000
1802,台玻            ,108000,131000,-23000,0,0,0,0,0,0,-1000,0,1000,-1000,0,0,0,-24000
6449,鈺邦            ,6000,41000,-35000,0,0,0,0,0,0,11000,12000,1000,11000,0,0,0,-24000
061089,台積電統一9C購04,0,0,0,0,0,0,0,0,0,-25000,0,0,0,11000,36000,-25000,-25000
06125P,楠梓電元富99售01,0,0,0,0,0,0,0,0,0,-25000,0,0,0,0,25000,-25000,-25000
060775,世芯凱基9A購02  ,0,0,0,0,0,0,0,0,0,-25000,0,0,0,347000,372000,-25000,-25000
06983P,台積電國泰9A售02,0,0,0,0,0,0,0,0,0,-25000,0,0,0,3000,28000,-25000,-25000
06971P,台光電元大99售03,0,0,0,0,0,0,0,0,0,-25000,0,0,0,0,25000,-25000,-25000
06240P,奇力新元富97售03,0,0,0,0,0,0,0,0,0,-25000,0,0,0,25000,50000,-25000,-25000
061508,南六國泰9C購02  ,0,0,0,0,0,0,0,0,0,-25000,0,0,0,5000,30000,-25000,-25000
061483,TPK元大9A購01   ,0,0,0,0,0,0,0,0,0,-25000,0,0,0,22000,47000,-25000,-25000
05964P,華通凱基96售06  ,0,0,0,0,0,0,0,0,0,-25000,0,0,0,0,25000,-25000,-25000
060471,台勝科元大9B購01,0,0,0,0,0,0,0,0,0,-25000,0,0,0,42000,67000,-25000,-25000
053948,大立光富邦99購04,0,0,0,0,0,0,0,0,0,-25000,0,0,0,0,25000,-25000,-25000
051460,S&P反1國泰97購01,0,0,0,0,0,0,0,0,0,-25000,0,0,0,0,25000,-25000,-25000
052389,聯發科群益95購05,0,0,0,0,0,0,0,0,0,-25000,0,0,0,0,25000,-25000,-25000
053648,台積電凱基97購04,0,0,0,0,0,0,0,0,0,-25000,0,0,0,0,25000,-25000,-25000
053637,強茂永豐96購01  ,0,0,0,0,0,0,0,0,0,-25000,0,0,0,43000,68000,-25000,-25000
053496,義隆兆豐96購02  ,0,0,0,0,0,0,0,0,0,-25000,0,0,0,9000,34000,-25000,-25000
054167,揚明光凱基98購01,0,0,0,0,0,0,0,0,0,-25000,0,0,0,0,25000,-25000,-25000
057556,智易凱基99購01  ,0,0,0,0,0,0,0,0,0,-25000,0,0,0,0,25000,-25000,-25000
058877,T50反1國泰9B購01,0,0,0,0,0,0,0,0,0,-25000,0,0,0,20000,45000,-25000,-25000
059126,臺指反中信9B購01,0,0,0,0,0,0,0,0,0,-25000,0,0,0,0,25000,-25000,-25000
059177,臺股指凱基99購28,0,0,0,0,0,0,0,0,0,-25000,0,0,0,30000,55000,-25000,-25000
05656P,台表科統一96售01,0,0,0,0,0,0,0,0,0,-25000,0,0,0,0,25000,-25000,-25000
055515,聚陽中信9A購01  ,0,0,0,0,0,0,0,0,0,-25000,0,0,0,0,25000,-25000,-25000
055239,帆宣台新97購01  ,0,0,0,0,0,0,0,0,0,-25000,0,0,0,0,25000,-25000,-25000
055943,瑞昱麥證97購01  ,0,0,0,0,25000,-25000,0,0,0,-25000,0,0,0,0,25000,-25000,-25000
07404P,華新科凱基99售10,0,0,0,0,0,0,0,0,0,-25000,0,0,0,10000,35000,-25000,-25000
2233,宇隆            ,23000,48000,-25000,0,0,0,0,0,0,0,0,0,0,0,0,0,-25000
060563,智邦富邦9A購01  ,0,0,0,0,0,0,0,0,0,-26000,0,0,0,133000,159000,-26000,-26000
059980,台積電元大99購50,0,0,0,0,0,0,0,0,0,-26000,0,0,0,0,26000,-26000,-26000
05979P,華新科中信96售02,0,0,0,0,0,0,0,0,0,-26000,0,0,0,0,26000,-26000,-26000
06150P,奇力新元大97售06,0,0,0,0,0,0,0,0,0,-26000,0,0,0,15000,41000,-26000,-26000
060767,世紀鋼元大9A購02,0,0,0,0,0,0,0,0,0,-26000,0,0,0,24000,50000,-26000,-26000
060848,聯茂國票9A購02  ,0,0,0,0,0,0,0,0,0,-26000,0,0,0,11000,37000,-26000,-26000
061010,上銀麥證9A購02  ,0,0,0,9000,35000,-26000,0,0,0,-26000,0,0,0,9000,35000,-26000,-26000
060922,金像電永豐9A購01,0,0,0,0,0,0,0,0,0,-26000,0,0,0,345000,371000,-26000,-26000
061326,新日興凱基9B購01,0,0,0,0,0,0,0,0,0,-26000,0,0,0,0,26000,-26000,-26000
054302,鴻海凱基96購18  ,0,0,0,0,0,0,0,0,0,-26000,0,0,0,18000,44000,-26000,-26000
057575,世紀鋼永豐98購02,0,0,0,0,0,0,0,0,0,-26000,0,0,0,80000,106000,-26000,-26000
05762P,昇陽半永豐96售04,0,0,0,0,0,0,0,0,0,-26000,0,0,0,0,26000,-26000,-26000
053539,智易永豐96購01  ,0,0,0,0,0,0,0,0,0,-26000,0,0,0,14000,40000,-26000,-26000
053159,同欣電元大96購02,0,0,0,0,0,0,0,0,0,-26000,0,0,0,0,26000,-26000,-26000
054989,精元元富97購01  ,0,0,0,0,0,0,0,0,0,-26000,0,0,0,74000,100000,-26000,-26000
052294,創意國票96購03  ,0,0,0,0,0,0,0,0,0,-26000,0,0,0,12000,38000,-26000,-26000
055092,開發金群益9B購01,0,0,0,0,0,0,0,0,0,-26000,0,0,0,80000,106000,-26000,-26000
055054,群光永豐97購01  ,0,0,0,0,0,0,0,0,0,-26000,0,0,0,4000,30000,-26000,-26000
053854,聯茂國泰97購02  ,0,0,0,0,0,0,0,0,0,-26000,0,0,0,20000,46000,-26000,-26000
058274,世紀鋼永豐99購01,0,0,0,0,0,0,0,0,0,-26000,0,0,0,63000,89000,-26000,-26000
058172,國巨凱基9B購02  ,0,0,0,0,0,0,0,0,0,-26000,0,0,0,10000,36000,-26000,-26000
058153,景碩統一9B購01  ,0,0,0,0,0,0,0,0,0,-26000,0,0,0,0,26000,-26000,-26000
05719P,可成元大96售03  ,0,0,0,0,0,0,0,0,0,-26000,0,0,0,0,26000,-26000,-26000
056843,冠德元富98購01  ,0,0,0,0,0,0,0,0,0,-26000,0,0,0,0,26000,-26000,-26000
059170,康控凱基9B購01  ,0,0,0,0,0,0,0,0,0,-26000,0,0,0,182000,208000,-26000,-26000
6283,淳安            ,27000,53000,-26000,0,0,0,0,0,0,0,0,0,0,0,0,0,-26000
07613P,國巨永豐9A售01  ,0,0,0,0,0,0,0,0,0,-26000,0,0,0,0,26000,-26000,-26000
07192P,聯發科元大99售23,0,0,0,0,0,0,0,0,0,-26000,0,0,0,0,26000,-26000,-26000
9924,福興            ,2000,28000,-26000,0,0,0,0,0,0,0,0,0,0,0,0,0,-26000
060933,南電永豐9A購02  ,0,0,0,0,0,0,0,0,0,-27000,0,0,0,16000,43000,-27000,-27000
060747,聯鈞國票9A購02  ,0,0,0,0,0,0,0,0,0,-27000,0,0,0,32000,59000,-27000,-27000
06144P,台光電永豐97售01,0,0,0,0,0,0,0,0,0,-27000,0,0,0,0,27000,-27000,-27000
059785,美律元大9A購03  ,0,0,0,0,0,0,0,0,0,-27000,0,0,0,14000,41000,-27000,-27000
059845,欣興富邦9A購02  ,0,0,0,0,0,0,0,0,0,-27000,0,0,0,364000,391000,-27000,-27000
060030,晶相光永豐99購03,0,0,0,0,0,0,0,0,0,-27000,0,0,0,237000,264000,-27000,-27000
060027,元金2X永豐99購02,0,0,0,0,0,0,0,0,0,-27000,0,0,0,0,27000,-27000,-27000
059613,泰鼎永豐99購02  ,0,0,0,0,0,0,0,0,0,-27000,0,0,0,264000,291000,-27000,-27000
059397,T50反1元富99購05,30000,0,30000,0,0,0,0,0,0,-57000,0,0,0,68000,125000,-57000,-27000
055108,智邦凱基98購01  ,0,0,0,0,0,0,0,0,0,-27000,0,0,0,0,27000,-27000,-27000
052410,智邦亞東96購01  ,0,0,0,0,0,0,0,0,0,-27000,0,0,0,10000,37000,-27000,-27000
03418B,臺股指元大95熊20,0,0,0,0,0,0,0,0,0,-27000,0,0,0,6000,33000,-27000,-27000
054888,泰碩統一97購01  ,0,0,0,0,0,0,0,0,0,-27000,0,0,0,0,27000,-27000,-27000
058379,臺股指凱基99購14,0,0,0,0,0,0,0,0,0,-27000,0,0,0,96000,123000,-27000,-27000
058011,台虹國票99購01  ,0,0,0,0,0,0,0,0,0,-27000,0,0,0,74000,101000,-27000,-27000
07791P,奇鋐元大9A售02  ,0,0,0,0,0,0,0,0,0,-27000,0,0,0,0,27000,-27000,-27000
2538,基泰            ,5000,32000,-27000,0,0,0,0,0,0,0,0,0,0,0,0,0,-27000
059566,台積電凱基9A購11,0,0,0,0,0,0,0,0,0,-28000,0,0,0,0,28000,-28000,-28000
06015P,大立光富邦98售04,0,0,0,0,0,0,0,0,0,-28000,0,0,0,0,28000,-28000,-28000
060388,世紀鋼凱基9B購01,0,0,0,0,0,0,0,0,0,-28000,0,0,0,0,28000,-28000,-28000
06355P,聯茂永豐97售02  ,0,0,0,0,0,0,0,0,0,-28000,0,0,0,2000,30000,-28000,-28000
06702P,智邦元富98售01  ,0,0,0,0,0,0,0,0,0,-28000,0,0,0,64000,92000,-28000,-28000
054573,漢唐元大98購01  ,0,0,0,0,0,0,0,0,0,-28000,0,0,0,2000,30000,-28000,-28000
053485,矽創國票97購04  ,0,0,0,0,0,0,0,0,0,-28000,0,0,0,0,28000,-28000,-28000
057740,茂林富邦9A購01  ,0,0,0,0,0,0,0,0,0,-28000,0,0,0,80000,108000,-28000,-28000
057931,正崴群益98購02  ,0,0,0,0,0,0,0,0,0,-28000,0,0,0,60000,88000,-28000,-28000
03439B,臺股指元大99熊29,0,0,0,0,0,0,0,0,0,-28000,0,0,0,0,28000,-28000,-28000
051677,達方元大95購01  ,0,0,0,0,0,0,0,0,0,-28000,0,0,0,5000,33000,-28000,-28000
050121,南電元大95購02  ,0,0,0,0,0,0,0,0,0,-28000,0,0,0,0,28000,-28000,-28000
050183,奇鋐元大96購01  ,0,0,0,0,0,0,0,0,0,-28000,0,0,0,2000,30000,-28000,-28000
050890,南電富邦99購01  ,0,0,0,0,0,0,0,0,0,-28000,0,0,0,2000,30000,-28000,-28000
058266,宏達電永豐99購01,0,0,0,0,0,0,0,0,0,-28000,0,0,0,30000,58000,-28000,-28000
058159,健策台新9A購01  ,0,0,0,0,0,0,0,0,0,-28000,0,0,0,63000,91000,-28000,-28000
058086,鴻海元大98購14  ,0,0,0,0,0,0,0,0,0,-28000,0,0,0,19000,47000,-28000,-28000
058256,臺股指元大9A購20,0,0,0,0,0,0,0,0,0,-28000,0,0,0,2000,30000,-28000,-28000
056302,大立光元大97購17,0,0,0,0,0,0,0,0,0,-28000,0,0,0,40000,68000,-28000,-28000
056772,欣興元大99購01  ,0,0,0,0,0,0,0,0,0,-28000,0,0,0,76000,104000,-28000,-28000
056766,義隆元大98購01  ,0,0,0,0,0,0,0,0,0,-28000,0,0,0,28000,56000,-28000,-28000
055540,京鼎台新97購01  ,0,0,0,0,0,0,0,0,0,-28000,0,0,0,0,28000,-28000,-28000
07766P,美律群益9A售03  ,0,0,0,0,0,0,0,0,0,-28000,0,0,0,0,28000,-28000,-28000
07658P,國泰金凱基9A售01,0,0,0,0,0,0,0,0,0,-28000,0,0,0,245000,273000,-28000,-28000
9188,精熙-DR         ,0,28000,-28000,0,0,0,0,0,0,0,0,0,0,0,0,0,-28000
8105,凌巨            ,87000,115000,-28000,0,0,0,0,0,0,0,0,0,0,0,0,0,-28000
061415,健策群益9A購04  ,0,0,0,0,0,0,0,0,0,-29000,0,0,0,4000,33000,-29000,-29000
061518,達方永豐9A購02  ,0,0,0,0,0,0,0,0,0,-29000,0,0,0,0,29000,-29000,-29000
060714,晶技永豐9A購02  ,0,0,0,0,0,0,0,0,0,-29000,0,0,0,97000,126000,-29000,-29000
060655,國巨統一9B購06  ,0,0,0,0,0,0,0,0,0,-29000,0,0,0,239000,268000,-29000,-29000
060666,聯茂凱基9A購02  ,0,0,0,0,0,0,0,0,0,-29000,0,0,0,35000,64000,-29000,-29000
05268P,玉晶光元大98售01,0,0,0,0,0,0,0,0,0,-29000,0,0,0,0,29000,-29000,-29000
04927P,大立光凱基95售06,0,0,0,0,0,0,0,0,0,-29000,0,0,0,0,29000,-29000,-29000
053518,聯茂群益96購03  ,0,0,0,0,0,0,0,0,0,-29000,0,0,0,0,29000,-29000,-29000
053628,微星兆豐96購01  ,0,0,0,0,0,0,0,0,0,-29000,0,0,0,0,29000,-29000,-29000
056469,國巨元大99購01  ,0,0,0,0,0,0,0,0,0,-29000,0,0,0,5000,34000,-29000,-29000
056986,超眾群益98購03  ,0,0,0,0,0,0,0,0,0,-29000,0,0,0,6000,35000,-29000,-29000
056902,大立光元大98購12,0,0,0,0,0,0,0,0,0,-29000,0,0,0,0,29000,-29000,-29000
059119,華擎永豐99購02  ,0,0,0,0,0,0,0,0,0,-29000,0,0,0,1000,30000,-29000,-29000
058964,群創兆豐99購01  ,0,0,0,0,0,0,0,0,0,-29000,0,0,0,0,29000,-29000,-29000
058251,百和元大99購03  ,0,0,0,0,0,0,0,0,0,-29000,0,0,0,234000,263000,-29000,-29000
058006,台郡群益98購04  ,0,0,0,0,0,0,0,0,0,-29000,0,0,0,32000,61000,-29000,-29000
056191,世紀鋼統一97購01,0,0,0,0,0,0,0,0,0,-29000,0,0,0,100000,129000,-29000,-29000
056120,聯茂群益97購02  ,0,0,0,0,0,0,0,0,0,-29000,0,0,0,0,29000,-29000,-29000
07642P,華通凱基9A售05  ,0,0,0,0,0,0,0,0,0,-29000,0,0,0,0,29000,-29000,-29000
07772P,華新科國票9A售05,0,0,0,0,0,0,0,0,0,-29000,0,0,0,0,29000,-29000,-29000
1707,葡萄王          ,377000,276000,101000,0,0,0,0,130000,-130000,0,0,0,0,0,0,0,-29000
07397P,大立光群益99售10,0,0,0,0,0,0,0,0,0,-29000,0,0,0,18000,47000,-29000,-29000
2493,揚博            ,11000,40000,-29000,0,0,0,0,0,0,0,0,0,0,0,0,0,-29000
5225,東科-KY         ,144000,173000,-29000,0,0,0,0,0,0,0,0,0,0,0,0,0,-29000
059628,智邦凱基99購04  ,0,25000,-25000,0,0,0,0,0,0,-5000,0,0,0,155000,160000,-5000,-30000
059441,祥碩元大99購02  ,0,0,0,0,0,0,0,0,0,-30000,0,0,0,0,30000,-30000,-30000
061490,茂林兆豐9B購01  ,0,0,0,0,0,0,0,0,0,-30000,0,0,0,0,30000,-30000,-30000
061453,台達電凱基9B購01,0,0,0,0,0,0,0,0,0,-30000,0,0,0,0,30000,-30000,-30000
06270P,致伸凱基97售03  ,0,0,0,0,0,0,0,0,0,-30000,0,0,0,0,30000,-30000,-30000
06577P,聯發科日盛9A售02,0,0,0,0,0,0,0,0,0,-30000,0,0,0,0,30000,-30000,-30000
06993P,鴻海凱基99售05  ,0,0,0,0,0,0,0,0,0,-30000,0,0,0,18000,48000,-30000,-30000
06903P,技嘉凱基98售04  ,0,0,0,0,0,0,0,0,0,-30000,0,0,0,0,30000,-30000,-30000
061063,國巨凱基9A購14  ,0,0,0,0,0,0,0,0,0,-30000,0,0,0,205000,235000,-30000,-30000
053446,欣興凱基96購02  ,0,0,0,0,0,0,0,0,0,-30000,0,0,0,0,30000,-30000,-30000
053287,臺股指元大96購15,0,0,0,0,0,0,0,0,0,-30000,0,0,0,0,30000,-30000,-30000
05520P,聯詠凱基96售01  ,0,0,0,0,0,0,0,0,0,-30000,0,0,0,0,30000,-30000,-30000
055170,光磊統一97購01  ,0,0,0,0,0,0,0,0,0,-30000,0,0,0,18000,48000,-30000,-30000
055191,牧德元富97購01  ,0,0,0,0,0,0,0,0,0,-30000,0,0,0,0,30000,-30000,-30000
054992,南亞科元富97購02,0,0,0,0,0,0,0,0,0,-30000,0,0,0,0,30000,-30000,-30000
055008,隆達元富97購01  ,0,0,0,0,0,0,0,0,0,-30000,0,0,0,0,30000,-30000,-30000
057890,滬深反統一98購01,0,0,0,0,0,0,0,0,0,-30000,0,0,0,0,30000,-30000,-30000
054149,達方元大96購01  ,0,0,0,0,0,0,0,0,0,-30000,0,0,0,60000,90000,-30000,-30000
054111,緯穎凱基97購01  ,0,0,0,0,0,0,0,0,0,-30000,0,0,0,44000,74000,-30000,-30000
051808,美律凱基96購02  ,0,0,0,0,0,0,0,0,0,-30000,0,0,0,0,30000,-30000,-30000
051873,緯穎凱基95購02  ,0,0,0,0,0,0,0,0,0,-30000,0,0,0,10000,40000,-30000,-30000
052238,智易國票96購01  ,0,0,0,0,0,0,0,0,0,-30000,0,0,0,0,30000,-30000,-30000
052146,泰碩群益95購01  ,0,0,0,0,0,0,0,0,0,-30000,0,0,0,0,30000,-30000,-30000
04866P,台積電統一95售02,0,0,0,0,0,0,0,0,0,-30000,0,0,0,300000,330000,-30000,-30000
048652,巨大元大96購01  ,0,0,0,0,0,0,0,0,0,-30000,0,0,0,0,30000,-30000,-30000
051601,群創兆豐95購02  ,0,0,0,0,0,0,0,0,0,-30000,0,0,0,0,30000,-30000,-30000
053893,京鼎群益97購02  ,0,0,0,0,0,0,0,0,0,-30000,0,0,0,0,30000,-30000,-30000
051057,信邦群益95購01  ,0,0,0,0,0,0,0,0,0,-30000,0,0,0,0,30000,-30000,-30000
050351,華新科群益95購02,0,0,0,0,0,0,0,0,0,-30000,0,0,0,11000,41000,-30000,-30000
05238P,禾伸堂永豐95售01,0,0,0,0,0,0,0,0,0,-30000,0,0,0,0,30000,-30000,-30000
05237P,為升永豐95售01  ,0,0,0,0,0,0,0,0,0,-30000,0,0,0,0,30000,-30000,-30000
052530,台郡元大96購04  ,0,0,0,0,0,0,0,0,0,-30000,0,0,0,0,30000,-30000,-30000
056119,欣興群益97購02  ,0,0,0,0,0,0,0,0,0,-30000,0,0,0,0,30000,-30000,-30000
056140,康控元大98購01  ,0,0,0,0,0,0,0,0,0,-30000,0,0,0,0,30000,-30000,-30000
056157,聯詠凱基97購03  ,0,0,0,0,0,0,0,0,0,-30000,0,0,0,0,30000,-30000,-30000
057012,康控中信98購01  ,0,0,0,0,0,0,0,0,0,-30000,0,0,0,0,30000,-30000,-30000
056235,鴻海群益97購07  ,0,0,0,0,0,0,0,0,0,-30000,0,0,0,0,30000,-30000,-30000
057131,奇力新凱基98購05,0,0,0,0,0,0,0,0,0,-30000,0,0,0,0,30000,-30000,-30000
05830P,滬深2X元富99售03,0,0,0,0,0,0,0,0,0,-30000,0,0,0,0,30000,-30000,-30000
055856,新唐元大97購03  ,0,0,0,0,0,0,0,0,0,-30000,0,0,0,0,30000,-30000,-30000
055772,致茂凱基97購01  ,0,0,0,0,0,0,0,0,0,-30000,0,0,0,0,30000,-30000,-30000
05555P,健策群益98售01  ,0,0,0,0,0,0,0,0,0,-30000,0,0,0,6000,36000,-30000,-30000
055353,華新科凱基98購03,0,0,0,0,0,0,0,0,0,-30000,0,0,0,80000,110000,-30000,-30000
055349,京元電凱基97購02,0,0,0,0,0,0,0,0,0,-30000,0,0,0,0,30000,-30000,-30000
058938,台積電中信01購03,0,0,0,0,0,0,0,0,0,-30000,0,0,0,0,30000,-30000,-30000
057471,昇陽半永豐98購02,0,0,0,0,0,0,0,0,0,-30000,0,0,0,0,30000,-30000,-30000
057490,可成元大98購10  ,0,0,0,0,0,0,0,0,0,-30000,0,0,0,35000,65000,-30000,-30000
057438,禾伸堂國票99購01,0,0,0,0,0,0,0,0,0,-30000,0,0,0,139000,169000,-30000,-30000
05908P,大立光元富96售05,0,0,0,0,0,0,0,0,0,-30000,0,0,0,0,30000,-30000,-30000
059248,華新科凱基99購04,0,0,0,0,0,0,0,0,0,-30000,0,0,0,0,30000,-30000,-30000
056931,智原台新98購01  ,0,0,0,0,0,0,0,0,0,-30000,0,0,0,0,30000,-30000,-30000
056941,台郡元富9B購01  ,0,0,0,0,0,0,0,0,0,-30000,0,0,0,1000,31000,-30000,-30000
056588,聯發科統一9A購02,0,0,0,0,0,0,0,0,0,-30000,0,0,0,234000,264000,-30000,-30000
056500,大立光富邦9B購02,0,0,0,0,0,0,0,0,0,-30000,0,0,0,0,30000,-30000,-30000
2923,鼎固-KY         ,0,30000,-30000,0,0,0,0,0,0,0,0,0,0,0,0,0,-30000
07266P,大立光元大99售19,0,0,0,0,0,0,0,0,0,-30000,0,0,0,50000,80000,-30000,-30000
07305P,T50正2群益99售02,0,0,0,0,0,0,0,0,0,-30000,0,0,0,0,30000,-30000,-30000
07785P,鴻海中信04售03  ,0,0,0,0,0,0,0,0,0,-30000,0,0,0,0,30000,-30000,-30000
07826P,台積電富邦9B售07,0,0,0,0,0,0,0,0,0,-30000,0,0,0,0,30000,-30000,-30000
1225,福懋油          ,23000,53000,-30000,0,0,0,0,0,0,0,0,0,0,0,0,0,-30000
08218P,滬深2X凱基96售01,0,0,0,0,0,0,0,0,0,-30000,0,0,0,0,30000,-30000,-30000
07678P,大立光群益9A售03,0,0,0,0,0,0,0,0,0,-30000,0,0,0,0,30000,-30000,-30000
061233,國巨元大9A購17  ,0,0,0,0,0,0,0,0,0,-31000,0,0,0,107000,138000,-31000,-31000
061450,嘉晶中信9A購01  ,0,0,0,0,0,0,0,0,0,-31000,0,0,0,0,31000,-31000,-31000
052367,聯茂國票96購02  ,0,0,0,0,0,0,0,0,0,-31000,0,0,0,0,31000,-31000,-31000
051382,玉晶光群益98購02,0,0,0,0,0,0,0,0,0,-31000,0,0,0,156000,187000,-31000,-31000
052055,緯穎凱基95購03  ,0,0,0,0,0,0,0,0,0,-31000,0,0,0,20000,51000,-31000,-31000
05650P,台積電富邦96售01,0,0,0,0,0,0,0,0,0,-31000,0,0,0,0,31000,-31000,-31000
056321,創意群益98購02  ,0,0,0,0,0,0,0,0,0,-31000,0,0,0,90000,121000,-31000,-31000
055327,致新國票98購01  ,0,0,0,0,0,0,0,0,0,-31000,0,0,0,0,31000,-31000,-31000
058279,FBVIX中信03購03 ,0,0,0,0,0,0,0,0,0,-31000,0,0,0,0,31000,-31000,-31000
058149,百和元大99購02  ,0,0,0,0,0,0,0,0,0,-31000,0,0,0,308000,339000,-31000,-31000
1337,再生-KY         ,41000,72000,-31000,0,0,0,0,0,0,0,0,0,0,0,0,0,-31000
07181P,臺股指凱基99售23,0,0,0,0,0,0,0,0,0,-31000,0,0,0,7000,38000,-31000,-31000
07392P,台積電國泰02售01,0,0,0,0,0,0,0,0,0,-31000,0,0,0,53000,84000,-31000,-31000
07501P,華新科元大9A售07,0,0,0,0,0,0,0,0,0,-31000,0,0,0,0,31000,-31000,-31000
07527P,台灣50凱基9B售02,0,0,0,0,0,0,0,0,0,-31000,0,0,0,50000,81000,-31000,-31000
6024,群益期          ,6000,37000,-31000,0,0,0,0,0,0,0,0,0,0,0,0,0,-31000
6168,宏齊            ,8000,39000,-31000,0,0,0,0,0,0,0,0,0,0,0,0,0,-31000
5907,大洋-KY         ,21000,87000,-66000,0,0,0,0,0,0,35000,0,0,0,35000,0,35000,-31000
2207,和泰車          ,114390,147000,-32610,0,0,0,1000,0,1000,0,0,0,0,0,0,0,-31610
061457,TPK凱基9A購01   ,0,0,0,0,0,0,0,0,0,-32000,0,0,0,48000,80000,-32000,-32000
06374P,台表科元大97售06,0,0,0,0,0,0,0,0,0,-32000,0,0,0,0,32000,-32000,-32000
07023P,南電永豐99售02  ,0,0,0,0,0,0,0,0,0,-32000,0,0,0,0,32000,-32000,-32000
061228,聯茂中信9A購01  ,0,0,0,0,0,0,0,0,0,-32000,0,0,0,0,32000,-32000,-32000
060058,牧德凱基9B購01  ,0,0,0,0,0,0,0,0,0,-32000,0,0,0,117000,149000,-32000,-32000
060424,中租永豐9A購01  ,0,0,0,0,0,0,0,0,0,-32000,0,0,0,54000,86000,-32000,-32000
00783,富邦中証500     ,0,0,0,0,0,0,167000,0,167000,-199000,0,0,0,1085000,1284000,-199000,-32000
051292,牧德統一97購01  ,0,0,0,0,0,0,0,0,0,-32000,0,0,0,56000,88000,-32000,-32000
053104,台表科元富96購02,0,0,0,0,0,0,0,0,0,-32000,0,0,0,0,32000,-32000,-32000
058368,奇鋐凱基9A購01  ,0,0,0,0,0,0,0,0,0,-32000,0,0,0,0,32000,-32000,-32000
055562,欣興凱基97購06  ,0,0,0,0,0,0,0,0,0,-32000,0,0,0,0,32000,-32000,-32000
057203,麗豐元富98購02  ,0,0,0,0,0,0,0,0,0,-32000,0,0,0,149000,181000,-32000,-32000
07389P,臺股指群益9C售08,0,0,0,0,0,0,0,0,0,-32000,0,0,0,3000,35000,-32000,-32000
1503,士電            ,2000,34000,-32000,0,0,0,0,0,0,0,0,0,0,0,0,0,-32000
1507,永大            ,9000,41000,-32000,0,0,0,0,0,0,0,0,0,0,0,0,0,-32000
060559,世紀鋼凱基9C購01,0,0,0,0,0,0,0,0,0,-33000,0,0,0,94000,127000,-33000,-33000
059908,元金2X元大99購01,0,0,0,0,0,0,0,0,0,-33000,0,0,0,0,33000,-33000,-33000
061082,台光電兆豐9A購01,0,0,0,0,0,0,0,0,0,-33000,0,0,0,0,33000,-33000,-33000
060884,超眾中信9B購01  ,0,0,0,0,0,0,0,0,0,-33000,0,0,0,47000,80000,-33000,-33000
057963,緯穎元大98購08  ,0,0,0,0,0,0,0,0,0,-33000,0,0,0,0,33000,-33000,-33000
020016,統一MSCI美科技N ,0,0,0,0,0,0,0,0,0,-33000,0,0,0,35000,68000,-33000,-33000
052201,超眾統一96購01  ,0,0,0,0,0,0,0,0,0,-33000,0,0,0,0,33000,-33000,-33000
056020,義隆群益97購01  ,0,0,0,0,0,0,0,0,0,-33000,0,0,0,5000,38000,-33000,-33000
058344,旺宏群益99購05  ,0,0,0,0,0,0,0,0,0,-33000,0,0,0,0,33000,-33000,-33000
058435,旺宏統一9B購02  ,0,0,0,0,0,0,0,0,0,-33000,0,0,0,74000,107000,-33000,-33000
1560,中砂            ,26000,54000,-28000,0,0,0,0,0,0,-5000,0,5000,-5000,0,0,0,-33000
07630P,臺股指凱基9A售11,0,0,0,0,0,0,0,0,0,-33000,0,0,0,11000,44000,-33000,-33000
07774P,台灣50群益9A售16,0,0,0,0,0,0,0,0,0,-33000,0,0,0,0,33000,-33000,-33000
07322P,鴻海元大99售33  ,0,0,0,0,0,0,0,0,0,-33000,0,0,0,10000,43000,-33000,-33000
2012,春雨            ,0,33000,-33000,0,0,0,0,0,0,0,0,0,0,0,0,0,-33000
5243,乙盛-KY         ,67000,100000,-33000,0,0,0,0,0,0,0,0,0,0,0,0,0,-33000
2929,淘帝-KY         ,77000,114000,-37000,0,0,0,0,0,0,4000,0,0,0,4000,0,4000,-33000
6525,捷敏-KY         ,20000,53000,-33000,0,0,0,0,0,0,0,0,0,0,0,0,0,-33000
060782,道瓊指富邦9C購01,0,0,0,0,0,0,0,0,0,-34000,0,0,0,5000,39000,-34000,-34000
060435,鈺齊永豐9A購01  ,0,0,0,0,0,0,0,0,0,-34000,0,0,0,203000,237000,-34000,-34000
060218,台積電凱基9A購15,0,0,0,0,0,0,0,0,0,-34000,0,0,0,30000,64000,-34000,-34000
055130,京鼎康和97購01  ,0,0,0,0,0,0,0,0,0,-34000,0,0,0,0,34000,-34000,-34000
053430,樺漢永豐96購01  ,0,0,0,0,0,0,0,0,0,-34000,0,0,0,0,34000,-34000,-34000
058053,上銀統一9B購01  ,0,0,0,0,0,0,0,0,0,-34000,0,0,0,0,34000,-34000,-34000
055955,微星元大97購01  ,0,0,0,0,0,0,0,0,0,-34000,0,0,0,109000,143000,-34000,-34000
055476,台郡凱基97購02  ,0,0,0,0,0,0,0,0,0,-34000,0,0,0,6000,40000,-34000,-34000
057375,欣興元大98購09  ,0,0,0,0,0,0,0,0,0,-34000,0,0,0,147000,181000,-34000,-34000
057376,新日興元大98購04,0,0,0,0,0,0,0,0,0,-34000,0,0,0,68000,102000,-34000,-34000
3010,華立            ,134000,168000,-34000,0,0,0,0,0,0,0,0,0,0,0,0,0,-34000
4976,佳凌            ,29000,63000,-34000,0,0,0,0,0,0,0,0,0,0,0,0,0,-34000
2636,台驊投控        ,4000,38000,-34000,0,0,0,0,0,0,0,0,0,0,0,0,0,-34000
1527,鑽全            ,133000,167300,-34300,0,0,0,0,0,0,0,0,0,0,0,0,0,-34300
060506,京元電元大9A購02,0,0,0,0,0,0,0,0,0,-35000,0,0,0,45000,80000,-35000,-35000
059706,嘉晶凱基99購01  ,0,0,0,0,0,0,0,0,0,-35000,0,0,0,40000,75000,-35000,-35000
061308,元金2X中信9A購01,0,0,0,0,0,0,0,0,0,-35000,0,0,0,0,35000,-35000,-35000
07106P,國巨統一9B售05  ,0,0,0,0,0,0,0,0,0,-35000,0,0,0,95000,130000,-35000,-35000
06594P,立積元大98售01  ,0,0,0,0,0,0,0,0,0,-35000,0,0,0,144000,179000,-35000,-35000
06744P,嘉聯益永豐98售03,0,0,0,0,0,0,0,0,0,-35000,0,0,0,55000,90000,-35000,-35000
053662,矽力凱基97購01  ,0,0,0,0,0,0,0,0,0,-35000,0,0,0,1000,36000,-35000,-35000
054059,欣興國票97購03  ,0,0,0,0,0,0,0,0,0,-35000,0,0,0,178000,213000,-35000,-35000
053073,技嘉康和96購01  ,0,0,0,0,0,0,0,0,0,-35000,0,0,0,73000,108000,-35000,-35000
054742,京鼎凱基99購01  ,0,0,0,0,0,0,0,0,0,-35000,0,0,0,19000,54000,-35000,-35000
055029,帆宣國泰99購01  ,0,0,0,0,0,0,0,0,0,-35000,0,0,0,4000,39000,-35000,-35000
049973,T50反1日盛9A購01,0,0,0,0,0,0,0,0,0,-35000,0,0,0,0,35000,-35000,-35000
055459,建準永豐97購03  ,0,0,0,0,0,0,0,0,0,-35000,0,0,0,63000,98000,-35000,-35000
056417,欣興中信98購01  ,0,0,0,0,0,0,0,0,0,-35000,0,0,0,35000,70000,-35000,-35000
05675P,美律群益97售01  ,0,0,0,0,0,0,0,0,0,-35000,0,0,0,0,35000,-35000,-35000
056777,矽力元大98購02  ,0,0,0,0,0,0,0,0,0,-35000,0,0,0,2000,37000,-35000,-35000
055777,冠德凱基97購01  ,0,0,0,0,0,0,0,0,0,-35000,0,0,0,0,35000,-35000,-35000
056286,奇鋐永豐97購01  ,0,0,0,0,0,0,0,0,0,-35000,0,0,0,45000,80000,-35000,-35000
07757P,國巨國票9B售04  ,0,0,0,0,0,0,0,0,0,-35000,0,0,0,0,35000,-35000,-35000
07517P,台積電元大9A售17,0,0,0,0,0,0,0,0,0,-35000,0,0,0,5000,40000,-35000,-35000
3518,柏騰            ,32000,67000,-35000,0,0,0,0,0,0,0,0,0,0,0,0,0,-35000
4104,佳醫            ,3000,40000,-37000,0,0,0,0,0,0,2000,2000,0,2000,0,0,0,-35000
06456P,聯發科統一98售03,0,0,0,0,0,0,0,0,0,-36000,0,0,0,30000,66000,-36000,-36000
060837,上銀國票9A購04  ,0,0,0,0,0,0,0,0,0,-36000,0,0,0,7000,43000,-36000,-36000
059430,台積電元大99購36,0,0,0,0,0,0,0,0,0,-36000,0,0,0,340000,376000,-36000,-36000
060411,達新永豐9A購01  ,0,0,0,0,0,0,0,0,0,-36000,0,0,0,23000,59000,-36000,-36000
060156,光磊永豐9A購01  ,0,0,0,0,0,0,0,0,0,-36000,0,0,0,6000,42000,-36000,-36000
050485,國巨統一96購01  ,0,0,0,0,0,0,0,0,0,-36000,0,0,0,255000,291000,-36000,-36000
052713,智邦凱基96購01  ,0,0,0,0,0,0,0,0,0,-36000,0,0,0,0,36000,-36000,-36000
054212,聯詠國票97購03  ,0,0,0,0,0,0,0,0,0,-36000,0,0,0,0,36000,-36000,-36000
055907,台虹兆豐98購01  ,0,0,0,0,0,0,0,0,0,-36000,0,0,0,8000,44000,-36000,-36000
056358,友訊元大99購01  ,0,0,0,0,0,0,0,0,0,-36000,0,0,0,0,36000,-36000,-36000
056044,同欣電凱基97購03,0,0,0,0,0,0,0,0,0,-36000,0,0,0,10000,46000,-36000,-36000
058981,國巨凱基99購10  ,0,0,0,0,0,0,0,0,0,-36000,0,0,0,212000,248000,-36000,-36000
3033,威健            ,7000,43000,-36000,0,0,0,0,0,0,0,0,0,0,0,0,0,-36000
6235,華孚            ,0,36000,-36000,0,0,0,0,0,0,0,0,0,0,0,0,0,-36000
2393,億光            ,670000,647000,23000,0,0,0,0,0,0,-59000,223000,6000,217000,7000,283000,-276000,-36000
060576,欣興中信9B購01  ,0,0,0,0,0,0,0,0,0,-37000,0,0,0,43000,80000,-37000,-37000
059347,京鼎凱基99購02  ,0,0,0,0,0,0,0,0,0,-37000,0,0,0,38000,75000,-37000,-37000
060029,嘉晶永豐99購03  ,0,0,0,0,0,0,0,0,0,-37000,0,0,0,14000,51000,-37000,-37000
061252,臺股指群益9A購03,0,0,0,0,0,0,0,0,0,-37000,0,0,0,0,37000,-37000,-37000
06188P,大立光元富97售01,0,0,0,0,0,0,0,0,0,-37000,0,0,0,4000,41000,-37000,-37000
06982P,義隆凱基99售02  ,0,0,0,0,0,0,0,0,0,-37000,0,0,0,0,37000,-37000,-37000
057944,新日興國票99購02,0,0,0,0,0,0,0,0,0,-37000,0,0,0,11000,48000,-37000,-37000
3266,昇陽            ,2000,39000,-37000,0,0,0,0,0,0,0,0,0,0,0,0,0,-37000
3312,弘憶股          ,2000,36000,-34000,0,0,0,0,0,0,-3000,0,3000,-3000,0,0,0,-37000
07276P,臺股指群益99售19,0,0,0,0,0,0,0,0,0,-37000,0,0,0,3000,40000,-37000,-37000
061059,世芯國票9B購01  ,0,5000,-5000,0,0,0,0,0,0,-33000,0,0,0,42000,75000,-33000,-38000
060828,高股息國票9A購01,0,0,0,0,0,0,0,0,0,-38000,0,0,0,10000,48000,-38000,-38000
057766,矽力凱基98購03  ,0,0,0,0,0,0,0,0,0,-38000,0,0,0,4000,42000,-38000,-38000
054416,禾伸堂元大97購01,0,0,0,0,0,0,0,0,0,-38000,0,0,0,52000,90000,-38000,-38000
053395,致茂中信96購01  ,0,0,0,0,0,0,0,0,0,-38000,0,0,0,0,38000,-38000,-38000
054882,台光電統一97購02,0,0,0,0,0,0,0,0,0,-38000,0,0,0,10000,48000,-38000,-38000
057365,智邦元大98購07  ,0,0,0,0,0,0,0,0,0,-38000,0,0,0,12000,50000,-38000,-38000
057403,亞光群益98購04  ,0,0,0,0,0,0,0,0,0,-38000,0,0,0,87000,125000,-38000,-38000
057405,麗豐群益98購01  ,0,0,0,0,0,0,0,0,0,-38000,0,0,0,47000,85000,-38000,-38000
055437,禾伸堂中信99購01,0,0,0,0,0,0,0,0,0,-38000,0,0,0,129000,167000,-38000,-38000
055626,力山永豐97購01  ,0,0,0,0,0,0,0,0,0,-38000,0,0,0,39000,77000,-38000,-38000
055816,新日興國票98購01,0,0,0,0,0,0,0,0,0,-38000,0,0,0,0,38000,-38000,-38000
056162,祥碩凱基97購03  ,0,0,0,0,0,0,0,0,0,-38000,0,0,0,4000,42000,-38000,-38000
058480,新日興凱基9A購01,0,0,0,0,0,0,0,0,0,-38000,0,0,0,0,38000,-38000,-38000
07217P,大立光凱基9A售05,0,0,0,0,0,0,0,0,0,-38000,0,0,0,6000,44000,-38000,-38000
07626P,台灣50凱基04售07,0,0,0,0,0,0,0,0,0,-38000,0,0,0,0,38000,-38000,-38000
1786,科妍            ,24000,62000,-38000,0,0,0,0,0,0,0,0,0,0,0,0,0,-38000
3015,全漢            ,82000,120000,-38000,0,0,0,0,0,0,0,0,0,0,0,0,0,-38000
6120,達運            ,472000,510000,-38000,0,0,0,0,0,0,0,0,0,0,0,0,0,-38000
2539,櫻花建          ,1000,39000,-38000,0,0,0,0,0,0,0,0,0,0,0,0,0,-38000
059876,智易凱基99購02  ,0,0,0,0,0,0,0,0,0,-39000,0,0,0,11000,50000,-39000,-39000
059508,聯發科永豐99購03,0,0,0,0,0,0,0,0,0,-39000,0,0,0,82000,121000,-39000,-39000
053406,國巨兆豐96購02  ,0,0,0,0,0,0,0,0,0,-39000,0,0,0,0,39000,-39000,-39000
05359P,嘉澤元大95售02  ,0,0,0,0,0,0,0,0,0,-39000,0,0,0,210000,249000,-39000,-39000
057433,上銀國票98購04  ,0,0,0,0,0,0,0,0,0,-39000,0,0,0,29000,68000,-39000,-39000
4164,承業醫          ,9000,49000,-40000,0,0,0,0,0,0,1000,1000,0,1000,0,0,0,-39000
0050,元大台灣50      ,15006,748000,-732994,0,0,0,160000,0,160000,533000,251000,0,251000,1687000,1405000,282000,-39994
059378,台光電群益9B購01,0,0,0,0,0,0,0,0,0,-40000,0,0,0,25000,65000,-40000,-40000
059401,牧德元富99購01  ,0,0,0,0,0,0,0,0,0,-40000,0,0,0,30000,70000,-40000,-40000
059719,台積電元大99購42,0,0,0,0,0,0,0,0,0,-40000,0,0,0,18000,58000,-40000,-40000
059739,華通元富99購04  ,0,0,0,0,0,0,0,0,0,-40000,0,0,0,0,40000,-40000,-40000
059662,旭富元大9C購01  ,0,0,0,0,0,0,0,0,0,-40000,0,0,0,30000,70000,-40000,-40000
059805,台積電元富99購02,0,0,0,0,0,0,0,0,0,-40000,0,0,0,80000,120000,-40000,-40000
060946,世紀鋼國票9A購02,0,0,0,0,0,0,0,0,0,-40000,0,0,0,0,40000,-40000,-40000
060949,祥碩中信9A購01  ,0,0,0,0,0,0,0,0,0,-40000,0,0,0,238000,278000,-40000,-40000
061056,臺指反國票02購01,0,0,0,0,0,0,0,0,0,-40000,0,0,0,0,40000,-40000,-40000
061143,道瓊指中信9C購04,0,0,0,0,0,0,0,0,0,-40000,0,0,0,0,40000,-40000,-40000
06960P,國巨凱基99售08  ,0,0,0,0,0,0,0,0,0,-40000,0,0,0,0,40000,-40000,-40000
06845P,億光元大98售02  ,0,0,0,0,0,0,0,0,0,-40000,0,0,0,10000,50000,-40000,-40000
06179P,國巨群益97售04  ,0,0,0,0,0,0,0,0,0,-40000,0,0,0,0,40000,-40000,-40000
061448,旺宏中信9A購02  ,0,0,0,0,0,0,0,0,0,-40000,0,0,0,0,40000,-40000,-40000
061410,緯穎國票9A購03  ,0,0,0,0,0,0,0,0,0,-40000,0,0,0,0,40000,-40000,-40000
061570,瑞昱元大9A購05  ,0,0,0,0,0,0,0,0,0,-40000,0,0,0,0,40000,-40000,-40000
049436,義隆國泰96購02  ,0,0,0,0,0,0,0,0,0,-40000,0,0,0,0,40000,-40000,-40000
051077,台郡國泰96購02  ,0,0,0,0,0,0,0,0,0,-40000,0,0,0,0,40000,-40000,-40000
049706,世紀鋼元大95購02,0,0,0,0,0,0,0,0,0,-40000,0,0,0,0,40000,-40000,-40000
052326,滬深反中信99購01,0,0,0,0,0,0,0,0,0,-40000,0,0,0,0,40000,-40000,-40000
053806,鎧勝凱基96購02  ,0,0,0,0,0,0,0,0,0,-40000,0,0,0,40000,80000,-40000,-40000
053947,義隆富邦97購01  ,0,0,0,0,0,0,0,0,0,-40000,0,0,0,86000,126000,-40000,-40000
055146,華通元大98購04  ,0,0,0,0,0,0,0,0,0,-40000,0,0,0,0,40000,-40000,-40000
051540,力成國票95購01  ,0,0,0,0,0,0,0,0,0,-40000,0,0,0,0,40000,-40000,-40000
052602,聯電元大97購01  ,0,0,0,0,0,0,0,0,0,-40000,0,0,0,0,40000,-40000,-40000
053469,光磊元大97購01  ,0,0,0,0,0,0,0,0,0,-40000,0,0,0,0,40000,-40000,-40000
054679,台積電康和99購01,0,0,0,0,0,0,0,0,0,-40000,0,0,0,0,40000,-40000,-40000
05297P,臻鼎凱基95售04  ,0,0,0,0,0,0,0,0,0,-40000,0,0,0,0,40000,-40000,-40000
054109,南亞科凱基96購05,0,0,0,0,0,0,0,0,0,-40000,0,0,0,56000,96000,-40000,-40000
052887,華通中信96購01  ,0,0,0,0,0,0,0,0,0,-40000,0,0,0,0,40000,-40000,-40000
057774,台光電群益99購02,0,0,0,0,0,0,0,0,0,-40000,0,0,0,2000,42000,-40000,-40000
057741,超眾富邦98購01  ,0,0,0,0,0,0,0,0,0,-40000,0,0,0,0,40000,-40000,-40000
057896,嘉晶元富98購01  ,0,0,0,0,0,0,0,0,0,-40000,0,0,0,0,40000,-40000,-40000
057423,台郡凱基98購06  ,0,0,0,0,0,0,0,0,0,-40000,0,0,0,0,40000,-40000,-40000
059143,國巨國票9A購04  ,0,0,0,0,0,0,0,0,0,-40000,0,0,0,283000,323000,-40000,-40000
056486,樺漢元大98購04  ,0,0,0,0,0,0,0,0,0,-40000,0,0,0,142000,182000,-40000,-40000
056748,T50反1兆豐99購01,0,0,0,0,0,0,0,0,0,-40000,0,0,0,0,40000,-40000,-40000
056937,智原元富98購01  ,0,0,0,0,0,0,0,0,0,-40000,0,0,0,0,40000,-40000,-40000
056598,京元電元富98購01,0,0,0,0,0,0,0,0,0,-40000,0,0,0,0,40000,-40000,-40000
056719,台虹永豐98購01  ,0,0,0,0,0,0,0,0,0,-40000,0,0,0,204000,244000,-40000,-40000
056118,聯詠群益97購03  ,0,0,0,0,0,0,0,0,0,-40000,0,0,0,0,40000,-40000,-40000
058660,樺漢中信9A購01  ,0,0,0,0,0,0,0,0,0,-40000,0,0,0,369000,409000,-40000,-40000
1109,信大            ,18000,58000,-40000,0,0,0,0,0,0,0,0,0,0,0,0,0,-40000
6668,中揚光          ,84000,124000,-40000,0,0,0,0,0,0,0,0,0,0,0,0,0,-40000
06411P,晶相光永豐97售03,0,0,0,0,0,0,0,0,0,-41000,0,0,0,0,41000,-41000,-41000
061132,志超永豐9A購01  ,0,0,0,0,0,0,0,0,0,-41000,0,0,0,7000,48000,-41000,-41000
061042,致新永豐9A購02  ,0,0,0,0,0,0,0,0,0,-41000,0,0,0,272000,313000,-41000,-41000
054188,欣興永豐96購03  ,0,0,0,0,0,0,0,0,0,-41000,0,0,0,37000,78000,-41000,-41000
052739,國巨元大96購04  ,0,0,0,0,0,0,0,0,0,-41000,0,0,0,1000,42000,-41000,-41000
051891,智邦元富95購04  ,0,0,0,0,0,0,0,0,0,-41000,0,0,0,110000,151000,-41000,-41000
047212,宏達電富邦97購01,0,0,0,0,0,0,0,0,0,-41000,0,0,0,119000,160000,-41000,-41000
058184,鴻海永豐99購01  ,0,0,0,0,0,0,0,0,0,-41000,0,0,0,0,41000,-41000,-41000
058116,正崴中信99購02  ,0,0,0,0,0,0,0,0,0,-41000,0,0,0,39000,80000,-41000,-41000
058973,麗豐永豐99購01  ,50000,0,50000,0,0,0,0,0,0,-91000,0,0,0,108000,199000,-91000,-41000
061002,瑞昱兆豐9B購01  ,20000,0,20000,0,0,0,0,0,0,-62000,0,0,0,344000,406000,-62000,-42000
061136,可成統一9A購01  ,0,0,0,0,0,0,0,0,0,-42000,0,0,0,154000,196000,-42000,-42000
061340,義隆元大9A購01  ,0,0,0,0,0,0,0,0,0,-42000,0,0,0,154000,196000,-42000,-42000
06323P,台郡統一97售01  ,0,0,0,0,0,0,0,0,0,-42000,0,0,0,1000,43000,-42000,-42000
061491,嘉聯益兆豐9B購01,0,0,0,0,0,0,0,0,0,-42000,0,0,0,0,42000,-42000,-42000
06739P,聯詠兆豐98售02  ,0,0,0,0,0,0,0,0,0,-42000,0,0,0,0,42000,-42000,-42000
06962P,華新科永豐99售01,0,0,0,0,0,0,0,0,0,-42000,0,0,0,420000,462000,-42000,-42000
059731,康控元大99購04  ,0,0,0,0,0,0,0,0,0,-42000,0,0,0,93000,135000,-42000,-42000
060234,凱美元大9C購01  ,0,0,0,0,0,0,0,0,0,-42000,0,0,0,181000,223000,-42000,-42000
059036,可成群益9B購03  ,0,0,0,0,0,0,0,0,0,-42000,0,0,0,141000,183000,-42000,-42000
057989,旺宏統一99購04  ,0,0,0,0,0,0,0,0,0,-42000,0,0,0,141000,183000,-42000,-42000
055336,茂林兆豐98購01  ,0,0,0,0,0,0,0,0,0,-42000,0,0,0,42000,84000,-42000,-42000
07657P,技嘉凱基9A售03  ,0,0,0,0,0,0,0,0,0,-42000,0,0,0,0,42000,-42000,-42000
07241P,台灣50國票9A售05,0,0,0,0,0,0,0,0,0,-42000,0,0,0,2000,44000,-42000,-42000
3454,晶睿            ,71000,113000,-42000,0,0,0,0,0,0,0,0,0,0,0,0,0,-42000
2476,鉅祥            ,15000,57000,-42000,0,0,0,0,0,0,0,0,0,0,0,0,0,-42000
2412,中華電          ,2143814,2197520,-53706,0,0,0,5000,0,5000,6000,10000,0,10000,0,4000,-4000,-42706
060640,京鼎永豐9A購01  ,0,0,0,0,0,0,0,0,0,-43000,0,0,0,178000,221000,-43000,-43000
060660,國巨凱基9B購04  ,0,0,0,0,0,0,0,0,0,-43000,0,0,0,200000,243000,-43000,-43000
059882,臺股指凱基9C購06,0,0,0,0,0,0,0,0,0,-43000,0,0,0,248000,291000,-43000,-43000
059961,T50反1凱基99購09,0,0,0,0,0,0,0,0,0,-43000,0,0,0,172000,215000,-43000,-43000
06766P,玉晶光元大99售10,0,0,0,0,0,0,0,0,0,-43000,0,0,0,63000,106000,-43000,-43000
061111,台表科元大9A購02,0,0,0,0,0,0,0,0,0,-43000,0,0,0,44000,87000,-43000,-43000
060793,微星永豐9A購01  ,0,0,0,0,0,0,0,0,0,-43000,0,0,0,0,43000,-43000,-43000
00680L,元大美債20正2   ,0,0,0,0,0,0,0,0,0,-43000,0,0,0,14000,57000,-43000,-43000
053921,嘉晶國票97購03  ,0,0,0,0,0,0,0,0,0,-43000,0,0,0,25000,68000,-43000,-43000
052378,矽力元大96購01  ,0,0,0,0,0,0,0,0,0,-43000,0,0,0,0,43000,-43000,-43000
055172,凱美統一97購02  ,0,0,0,0,0,0,0,0,0,-43000,0,0,0,105000,148000,-43000,-43000
055229,大毅國票97購02  ,0,0,0,0,0,0,0,0,0,-43000,0,0,0,5000,48000,-43000,-43000
054852,奇鋐國票98購01  ,0,0,0,0,0,0,0,0,0,-43000,0,0,0,93000,136000,-43000,-43000
057787,TPK國票99購01   ,0,0,0,0,0,0,0,0,0,-43000,0,0,0,8000,51000,-43000,-43000
057819,新日興元大99購01,0,0,0,0,0,0,0,0,0,-43000,0,0,0,50000,93000,-43000,-43000
056416,華新科中信98購01,0,0,0,0,0,0,0,0,0,-43000,0,0,0,24000,67000,-43000,-43000
05880P,創意康和96售01  ,0,0,0,0,0,0,0,0,0,-43000,0,0,0,0,43000,-43000,-43000
3013,晟銘電          ,3000,46000,-43000,0,0,0,0,0,0,0,0,0,0,0,0,0,-43000
6414,樺漢            ,141000,203000,-62000,0,0,0,0,0,0,19000,10000,21000,-11000,36000,6000,30000,-43000
061336,國巨元大9A購20  ,0,0,0,0,0,0,0,0,0,-44000,0,0,0,144000,188000,-44000,-44000
061245,晶技群益9A購01  ,0,0,0,0,0,0,0,0,0,-44000,0,0,0,51000,95000,-44000,-44000
06728P,全新元大98售03  ,0,0,0,0,0,0,0,0,0,-44000,0,0,0,6000,50000,-44000,-44000
060527,台積電中信9C購04,0,0,0,0,0,0,0,0,0,-44000,0,0,0,0,44000,-44000,-44000
057599,技嘉群益9A購01  ,0,0,0,0,0,0,0,0,0,-44000,0,0,0,6000,50000,-44000,-44000
054915,興勤凱基97購01  ,0,0,0,0,0,0,0,0,0,-44000,0,0,0,20000,64000,-44000,-44000
049700,瀚宇博元大97購01,0,0,0,0,0,0,0,0,0,-44000,0,0,0,116000,160000,-44000,-44000
055094,智易群益98購01  ,0,0,0,0,0,0,0,0,0,-44000,0,0,0,0,44000,-44000,-44000
00660,元大歐洲50      ,0,0,0,0,0,0,0,0,0,-44000,0,0,0,61000,105000,-44000,-44000
02001L,富邦蘋果正二N   ,0,0,0,0,0,0,0,0,0,-44000,0,0,0,11000,55000,-44000,-44000
052216,康友元大96購01  ,0,0,0,0,0,0,0,0,0,-44000,0,0,0,5000,49000,-44000,-44000
057816,欣興元大98購13  ,0,0,0,0,0,0,0,0,0,-44000,0,0,0,7000,51000,-44000,-44000
058046,國巨元大9A購01  ,0,0,0,0,0,0,0,0,0,-44000,0,0,0,23000,67000,-44000,-44000
4576,大銀微系統      ,5000,49000,-44000,0,0,0,0,0,0,0,0,0,0,0,0,0,-44000
07560P,台積電國泰9B售01,0,0,0,0,0,0,0,0,0,-44000,0,0,0,1400000,1444000,-44000,-44000
07616P,瑞昱中信02售01  ,0,0,0,0,0,0,0,0,0,-44000,0,0,0,0,44000,-44000,-44000
060384,葡萄王凱基9B購01,0,0,0,0,0,0,0,0,0,-45000,0,0,0,5000,50000,-45000,-45000
059879,GIS凱基99購03   ,0,0,0,0,0,0,0,0,0,-45000,0,0,0,16000,61000,-45000,-45000
06515P,國巨凱基98售06  ,0,0,0,0,0,0,0,0,0,-45000,0,0,0,29000,74000,-45000,-45000
061107,世芯元大9A購05  ,0,0,0,0,0,0,0,0,0,-45000,0,0,0,208000,253000,-45000,-45000
061102,台積電元大9A購22,0,0,0,0,0,0,0,0,0,-45000,0,0,0,58000,103000,-45000,-45000
061104,華新科元大9A購13,0,0,0,0,0,0,0,0,0,-45000,0,0,0,20000,65000,-45000,-45000
060956,超眾群益9A購01  ,0,0,0,0,0,0,0,0,0,-45000,0,0,0,84000,129000,-45000,-45000
055058,大毅永豐97購01  ,0,0,0,0,0,0,0,0,0,-45000,0,0,0,15000,60000,-45000,-45000
053875,GIS元大97購01   ,0,0,0,0,0,0,0,0,0,-45000,0,0,0,48000,93000,-45000,-45000
055014,達興元富97購01  ,0,0,0,0,0,0,0,0,0,-45000,0,0,0,5000,50000,-45000,-45000
053118,大立光中信9C購01,0,0,0,0,0,0,0,0,0,-45000,0,0,0,5000,50000,-45000,-45000
053611,聯茂麥證96購01  ,0,0,0,50000,95000,-45000,0,0,0,-45000,0,0,0,50000,95000,-45000,-45000
054121,奇鋐永豐96購02  ,0,0,0,0,0,0,0,0,0,-45000,0,0,0,42000,87000,-45000,-45000
057073,康控永豐98購01  ,0,0,0,0,0,0,0,0,0,-45000,0,0,0,0,45000,-45000,-45000
055344,國巨凱基97購04  ,0,0,0,0,0,0,0,0,0,-45000,0,0,0,53000,98000,-45000,-45000
055818,晶相光國票97購02,0,99000,-99000,0,0,0,0,0,0,54000,0,0,0,274000,220000,54000,-45000
055924,深中小群益9B購01,0,0,0,0,0,0,0,0,0,-45000,0,0,0,30000,75000,-45000,-45000
058637,晶技兆豐99購01  ,0,0,0,0,0,0,0,0,0,-45000,0,0,0,5000,50000,-45000,-45000
056459,茂林凱基99購01  ,0,0,0,0,0,0,0,0,0,-45000,0,0,0,80000,125000,-45000,-45000
056597,宏碁元富98購01  ,0,0,0,0,0,0,0,0,0,-45000,0,0,0,0,45000,-45000,-45000
05730P,臺股指凱基97售03,0,0,0,0,0,0,0,0,0,-45000,0,0,0,0,45000,-45000,-45000
058873,美律國票9A購02  ,0,0,0,0,0,0,0,0,0,-45000,0,0,0,17000,62000,-45000,-45000
058841,深中小群益01購01,0,0,0,0,0,0,0,0,0,-45000,0,0,0,598000,643000,-45000,-45000
057414,華新科日盛9A購01,0,0,0,0,0,0,0,0,0,-45000,0,0,0,0,45000,-45000,-45000
6192,巨路            ,2000,47000,-45000,0,0,0,0,0,0,0,0,0,0,0,0,0,-45000
2882B,國泰金乙特      ,0,0,0,0,0,0,0,0,0,-45000,0,45000,-45000,0,0,0,-45000
060785,國巨富邦9B購04  ,0,0,0,0,0,0,0,0,0,-46000,0,0,0,37000,83000,-46000,-46000
061110,超眾元大9A購03  ,0,0,0,0,0,0,0,0,0,-46000,0,0,0,73000,119000,-46000,-46000
061309,鴻海統一9C購05  ,0,0,0,0,0,0,0,0,0,-46000,0,0,0,28000,74000,-46000,-46000
06230P,亞德客永豐97售03,0,0,0,0,0,0,0,0,0,-46000,0,0,0,10000,56000,-46000,-46000
061408,華新科國票9A購06,0,0,0,0,0,0,0,0,0,-46000,0,0,0,0,46000,-46000,-46000
059379,聯電亞東99購02  ,0,0,0,0,0,0,0,0,0,-46000,0,0,0,0,46000,-46000,-46000
057651,矽力元大98購03  ,0,0,0,0,0,0,0,0,0,-46000,0,0,0,55000,101000,-46000,-46000
053639,禾伸堂永豐96購01,0,0,0,0,0,0,0,0,0,-46000,0,0,0,40000,86000,-46000,-46000
055060,聯陽永豐97購01  ,0,0,0,0,0,0,0,0,0,-46000,0,0,0,42000,88000,-46000,-46000
05087P,GIS國泰96售01   ,0,0,0,0,0,0,0,0,0,-46000,0,0,0,6000,52000,-46000,-46000
056599,臻鼎元富98購01  ,0,0,0,0,0,0,0,0,0,-46000,0,0,0,172000,218000,-46000,-46000
056332,台郡國票99購01  ,0,0,0,0,0,0,0,0,0,-46000,0,0,0,0,46000,-46000,-46000
056107,智易永豐97購02  ,0,0,0,0,0,0,0,0,0,-46000,0,0,0,10000,56000,-46000,-46000
058077,超眾凱基98購02  ,0,0,0,0,0,0,0,0,0,-46000,0,0,0,5000,51000,-46000,-46000
059661,大立光元大99購22,0,0,0,0,0,0,0,0,0,-47000,0,0,0,0,47000,-47000,-47000
060065,大立光兆豐9B購01,0,0,0,0,0,0,0,0,0,-47000,0,0,0,18000,65000,-47000,-47000
060204,矽創元富9A購01  ,0,0,0,0,0,0,0,0,0,-47000,0,0,0,13000,60000,-47000,-47000
061085,聯茂兆豐9A購01  ,0,0,0,0,0,0,0,0,0,-47000,0,0,0,97000,144000,-47000,-47000
051277,聯發科中信9A購01,0,0,0,0,0,0,0,0,0,-47000,0,0,0,0,47000,-47000,-47000
054021,義隆台新96購01  ,0,0,0,0,0,0,0,0,0,-47000,0,0,0,175000,222000,-47000,-47000
052727,仁寶元富96購01  ,0,0,0,0,0,0,0,0,0,-47000,0,0,0,253000,300000,-47000,-47000
054098,嘉晶國票97購04  ,0,0,0,0,0,0,0,0,0,-47000,0,0,0,50000,97000,-47000,-47000
054442,啟碁台新96購01  ,0,0,0,0,0,0,0,0,0,-47000,0,0,0,0,47000,-47000,-47000
058170,國巨凱基9A購06  ,0,0,0,0,0,0,0,0,0,-47000,0,0,0,542000,589000,-47000,-47000
058761,欣興群益99購02  ,0,0,0,0,0,0,0,0,0,-47000,0,0,0,37000,84000,-47000,-47000
057390,台表科永豐98購01,0,0,0,0,0,0,0,0,0,-47000,0,0,0,42000,89000,-47000,-47000
07349P,大立光凱基99售16,0,0,0,0,0,0,0,0,0,-47000,0,0,0,38000,85000,-47000,-47000
07705P,台積電元大9A售26,0,0,0,0,0,0,0,0,0,-47000,0,0,0,0,47000,-47000,-47000
060096,聯發科元大99購43,0,0,0,0,0,0,0,0,0,-48000,0,0,0,0,48000,-48000,-48000
060326,群光群益9A購01  ,0,0,0,0,0,0,0,0,0,-48000,0,0,0,19000,67000,-48000,-48000
060402,神隆國泰9B購01  ,0,0,0,0,0,0,0,0,0,-48000,0,0,0,208000,256000,-48000,-48000
060406,瑞祺國泰9B購01  ,0,0,0,0,0,0,0,0,0,-48000,0,0,0,341000,389000,-48000,-48000
059563,鴻海凱基9A購14  ,0,0,0,0,0,0,0,0,0,-48000,0,0,0,20000,68000,-48000,-48000
054220,國巨統一97購02  ,0,0,0,0,0,0,0,0,0,-48000,0,0,0,392000,440000,-48000,-48000
054880,華泰統一97購01  ,0,0,0,0,0,0,0,0,0,-48000,0,0,0,0,48000,-48000,-48000
049255,旺宏元大97購02  ,0,0,0,0,0,0,0,0,0,-48000,0,0,0,62000,110000,-48000,-48000
056978,技嘉群益99購01  ,0,0,0,0,0,0,0,0,0,-48000,0,0,0,0,48000,-48000,-48000
056949,義隆統一98購01  ,0,0,0,0,0,0,0,0,0,-48000,0,0,0,0,48000,-48000,-48000
056803,群創台新99購02  ,0,0,0,0,0,0,0,0,0,-48000,0,0,0,150000,198000,-48000,-48000
055440,矽力國票98購01  ,0,0,0,0,0,0,0,0,0,-48000,0,0,0,0,48000,-48000,-48000
055653,聯詠元富01購02  ,0,0,0,0,0,0,0,0,0,-48000,0,0,0,0,48000,-48000,-48000
055820,矽力國票98購02  ,0,0,0,0,0,0,0,0,0,-48000,0,0,0,0,48000,-48000,-48000
058283,世紀鋼中信99購01,0,0,0,0,0,0,0,0,0,-48000,0,0,0,85000,133000,-48000,-48000
057071,華擎永豐98購02  ,0,0,0,0,0,0,0,0,0,-48000,0,0,0,200000,248000,-48000,-48000
059868,台光電凱基99購03,0,0,0,0,0,0,0,0,0,-49000,0,0,0,7000,56000,-49000,-49000
061238,晶技元大9A購02  ,0,0,0,0,0,0,0,0,0,-49000,0,0,0,44000,93000,-49000,-49000
06123P,玉晶光元大97售04,0,0,0,0,0,0,0,0,0,-49000,0,0,0,74000,123000,-49000,-49000
060764,華擎元大9A購03  ,0,0,0,0,0,0,0,0,0,-49000,0,0,0,60000,109000,-49000,-49000
050172,臺指反元大98購02,0,0,0,0,0,0,0,0,0,-49000,0,0,0,0,49000,-49000,-49000
052818,智邦永豐96購01  ,0,0,0,0,0,0,0,0,0,-49000,0,0,0,80000,129000,-49000,-49000
058828,大毅永豐99購01  ,0,0,0,0,0,0,0,0,0,-49000,0,0,0,0,49000,-49000,-49000
059316,國巨元大99購23  ,0,0,0,0,0,0,0,0,0,-49000,0,0,0,11000,60000,-49000,-49000
6189,豐藝            ,12000,61000,-49000,0,0,0,0,0,0,0,0,0,0,0,0,0,-49000
060727,高股息中信9C購02,0,0,0,0,0,0,0,0,0,-50000,0,0,0,0,50000,-50000,-50000
060905,台積電元大9A購20,0,0,0,0,0,0,0,0,0,-50000,0,0,0,50000,100000,-50000,-50000
06122P,亞光元大98售01  ,0,0,0,0,0,0,0,0,0,-50000,0,0,0,0,50000,-50000,-50000
061061,聯發科麥證9A購02,0,0,0,0,50000,-50000,0,0,0,-50000,0,0,0,0,50000,-50000,-50000
061203,國巨元大9A購15  ,0,0,0,0,0,0,0,0,0,-50000,0,0,0,54000,104000,-50000,-50000
061540,台積電群益9A購07,0,0,0,0,0,0,0,0,0,-50000,0,0,0,1000,51000,-50000,-50000
06199P,聯發科元大97售17,0,0,0,0,0,0,0,0,0,-50000,0,0,0,10000,60000,-50000,-50000
06180P,禾伸堂群益97售01,0,0,0,0,0,0,0,0,0,-50000,0,0,0,10000,60000,-50000,-50000
06444P,大立光凱基98售08,0,0,0,0,0,0,0,0,0,-50000,0,0,0,0,50000,-50000,-50000
06974P,臺股指元大9A售12,0,0,0,0,0,0,0,0,0,-50000,0,0,0,0,50000,-50000,-50000
059979,台積電元大99購49,0,0,0,0,0,0,0,0,0,-50000,0,0,0,1000,51000,-50000,-50000
060673,旺宏元大9A購04  ,0,0,0,0,0,0,0,0,0,-50000,0,0,0,0,50000,-50000,-50000
060620,玉晶光元大9A購04,0,0,0,0,0,0,0,0,0,-50000,0,0,0,20000,70000,-50000,-50000
060138,T50反1國票9A購03,0,0,0,0,0,0,0,0,0,-50000,0,0,0,0,50000,-50000,-50000
052819,義隆永豐96購01  ,0,0,0,0,0,0,0,0,0,-50000,0,0,0,4000,54000,-50000,-50000
052917,大立光富邦99購02,0,0,0,0,0,0,0,0,0,-50000,0,0,0,0,50000,-50000,-50000
053067,牧德群益96購01  ,0,0,0,0,0,0,0,0,0,-50000,0,0,0,66000,116000,-50000,-50000
057621,崇越凱基98購01  ,0,0,0,0,0,0,0,0,0,-50000,0,0,0,0,50000,-50000,-50000
057792,群創統一99購01  ,0,0,0,0,0,0,0,0,0,-50000,0,0,0,50000,100000,-50000,-50000
057734,訊芯國泰9A購01  ,0,0,0,0,0,0,0,0,0,-50000,0,0,0,0,50000,-50000,-50000
055205,京鼎中信99購01  ,0,0,0,0,0,0,0,0,0,-50000,0,0,0,0,50000,-50000,-50000
054041,鴻海元大96購22  ,0,0,0,0,0,0,0,0,0,-50000,0,0,0,0,50000,-50000,-50000
053315,漢唐群益96購02  ,0,0,0,0,0,0,0,0,0,-50000,0,0,0,0,50000,-50000,-50000
053211,漢唐凱基96購03  ,0,0,0,0,0,0,0,0,0,-50000,0,0,0,0,50000,-50000,-50000
051278,臻鼎中信97購02  ,0,0,0,0,0,0,0,0,0,-50000,0,0,0,0,50000,-50000,-50000
054025,鴻海凱基96購17  ,0,0,0,0,0,0,0,0,0,-50000,0,0,0,0,50000,-50000,-50000
055037,宏盛富邦99購01  ,0,0,0,0,0,0,0,0,0,-50000,0,0,0,0,50000,-50000,-50000
055024,興勤國泰98購01  ,0,0,0,0,0,0,0,0,0,-50000,0,0,0,0,50000,-50000,-50000
051650,矽力永豐95購01  ,0,0,0,0,0,0,0,0,0,-50000,0,0,0,0,50000,-50000,-50000
042752,台灣50元大96購03,0,0,0,0,0,0,0,0,0,-50000,0,0,0,5000,55000,-50000,-50000
049117,矽格統一96購01  ,0,0,0,0,0,0,0,0,0,-50000,0,0,0,0,50000,-50000,-50000
057385,光罩永豐99購01  ,0,0,0,0,0,0,0,0,0,-50000,0,0,0,10000,60000,-50000,-50000
056637,台光電日盛9A購01,0,0,0,0,0,0,0,0,0,-50000,0,0,0,0,50000,-50000,-50000
057127,旺宏凱基98購09  ,0,0,0,0,0,0,0,0,0,-50000,0,0,0,0,50000,-50000,-50000
056231,嘉聯益凱基97購02,0,0,0,0,0,0,0,0,0,-50000,0,0,0,2000,52000,-50000,-50000
056207,茂林永豐97購03  ,0,0,0,0,0,0,0,0,0,-50000,0,0,0,0,50000,-50000,-50000
058239,景碩元大99購03  ,0,0,0,0,0,0,0,0,0,-50000,0,0,0,0,50000,-50000,-50000
055705,微星永豐97購01  ,0,0,0,0,0,0,0,0,0,-50000,0,0,0,0,50000,-50000,-50000
055902,同欣電中信99購01,0,0,0,0,0,0,0,0,0,-50000,0,0,0,20000,70000,-50000,-50000
055859,啟碁元大97購03  ,0,0,0,0,0,0,0,0,0,-50000,0,0,0,68000,118000,-50000,-50000
055688,力成凱基98購02  ,0,0,0,0,0,0,0,0,0,-50000,0,0,0,0,50000,-50000,-50000
058703,台積電元大99購16,0,0,0,0,0,0,0,0,0,-50000,0,0,0,263000,313000,-50000,-50000
058704,台積電元大99購17,0,0,0,0,0,0,0,0,0,-50000,0,0,0,0,50000,-50000,-50000
3052,夆典            ,20000,70000,-50000,0,0,0,0,0,0,0,0,0,0,0,0,0,-50000
07302P,臺股指元大9A售35,0,0,0,0,0,0,0,0,0,-50000,0,0,0,0,50000,-50000,-50000
07197P,臺股指元大99售13,0,0,0,0,0,0,0,0,0,-50000,0,0,0,0,50000,-50000,-50000
07520P,臺股指元大9B售11,0,0,0,0,0,0,0,0,0,-50000,0,0,0,0,50000,-50000,-50000
060535,群創麥證9A購01  ,0,0,0,18000,69000,-51000,0,0,0,-51000,0,0,0,18000,69000,-51000,-51000
060022,勤誠康和99購01  ,0,0,0,0,0,0,0,0,0,-51000,0,0,0,18000,69000,-51000,-51000
06608P,立積群益99售02  ,0,0,0,0,0,0,0,0,0,-51000,0,0,0,35000,86000,-51000,-51000
061494,聯發科國票9A購04,0,0,0,0,0,0,0,0,0,-51000,0,0,0,10000,61000,-51000,-51000
061197,矽創永豐9A購02  ,0,0,0,0,0,0,0,0,0,-51000,0,0,0,17000,68000,-51000,-51000
050424,鴻海凱基96購03  ,0,0,0,0,0,0,0,0,0,-51000,0,0,0,2000,53000,-51000,-51000
056951,牧德統一99購01  ,0,0,0,0,0,0,0,0,0,-51000,0,0,0,0,51000,-51000,-51000
056966,嘉晶永豐98購01  ,0,0,0,0,0,0,0,0,0,-51000,0,0,0,26000,77000,-51000,-51000
1316,上曜            ,42000,93000,-51000,0,0,0,0,0,0,0,0,0,0,0,0,0,-51000
4564,元翎            ,97000,147000,-50000,0,0,0,0,0,0,-1000,0,0,0,4000,5000,-1000,-51000
061150,國巨群益9A購09  ,0,0,0,0,0,0,0,0,0,-52000,0,0,0,351000,403000,-52000,-52000
060286,佳世達元大9C購01,0,0,0,0,0,0,0,0,0,-52000,0,0,0,173000,225000,-52000,-52000
048892,台郡元富97購01  ,0,0,0,0,0,0,0,0,0,-52000,0,0,0,0,52000,-52000,-52000
054828,正崴國泰99購01  ,0,0,0,0,0,0,0,0,0,-52000,0,0,0,15000,67000,-52000,-52000
057959,欣興元大98購14  ,0,0,0,0,0,0,0,0,0,-52000,0,0,0,30000,82000,-52000,-52000
054211,奇鋐國票97購03  ,0,0,0,0,0,0,0,0,0,-52000,0,0,0,0,52000,-52000,-52000
054130,漢唐元大97購02  ,0,0,0,0,0,0,0,0,0,-52000,0,0,0,0,52000,-52000,-52000
055531,華新科群益98購03,0,0,0,0,0,0,0,0,0,-52000,0,0,0,80000,132000,-52000,-52000
059097,世紀鋼元大99購05,0,0,0,0,0,0,0,0,0,-52000,0,0,0,42000,94000,-52000,-52000
058623,國巨國票99購08  ,0,0,0,0,0,0,0,0,0,-52000,0,0,0,0,52000,-52000,-52000
055668,欣興群益97購01  ,0,0,0,0,0,0,0,0,0,-52000,0,0,0,88000,140000,-52000,-52000
2882A,國泰特          ,28000,0,28000,0,0,0,0,0,0,-80000,0,80000,-80000,0,0,0,-52000
060455,葡萄王元大9A購02,0,0,0,0,0,0,0,0,0,-53000,0,0,0,0,53000,-53000,-53000
061071,復盛凱基9A購01  ,0,0,0,0,0,0,0,0,0,-53000,0,0,0,111000,164000,-53000,-53000
061597,南六永豐9A購04  ,0,0,0,0,0,0,0,0,0,-53000,0,0,0,0,53000,-53000,-53000
057704,台虹群益98購03  ,0,0,0,0,0,0,0,0,0,-53000,0,0,0,174000,227000,-53000,-53000
049439,牧德國泰96購01  ,0,0,0,0,0,0,0,0,0,-53000,0,0,0,0,53000,-53000,-53000
053810,台達電群益96購01,0,0,0,0,0,0,0,0,0,-53000,0,0,0,95000,148000,-53000,-53000
051575,國巨元大96購03  ,0,0,0,0,0,0,0,0,0,-53000,0,0,0,0,53000,-53000,-53000
055992,智原台新97購02  ,0,0,0,0,0,0,0,0,0,-53000,0,0,0,0,53000,-53000,-53000
055834,國巨元大97購13  ,0,0,0,0,0,0,0,0,0,-53000,0,0,0,142000,195000,-53000,-53000
055782,新日興凱基99購01,0,0,0,0,0,0,0,0,0,-53000,0,0,0,0,53000,-53000,-53000
055279,華邦電元大97購02,0,0,0,0,0,0,0,0,0,-53000,0,0,0,0,53000,-53000,-53000
057056,立積元大99購02  ,0,0,0,0,0,0,0,0,0,-53000,0,0,0,6000,59000,-53000,-53000
05546P,全新元大97售01  ,0,0,0,0,0,0,0,0,0,-53000,0,0,0,1000,54000,-53000,-53000
2601,益航            ,674000,787000,-113000,0,0,0,0,0,0,60000,60000,0,60000,0,0,0,-53000
2231,為升            ,65000,118000,-53000,0,0,0,0,0,0,0,0,0,0,3000,3000,0,-53000
07416P,台積電元大99售53,0,0,0,0,0,0,0,0,0,-53000,0,0,0,37000,90000,-53000,-53000
061092,可成統一9C購02  ,0,0,0,0,0,0,0,0,0,-54000,0,0,0,161000,215000,-54000,-54000
059965,鴻海凱基99購16  ,0,0,0,0,0,0,0,0,0,-54000,0,0,0,0,54000,-54000,-54000
059687,卜蜂永豐99購01  ,0,0,0,0,0,0,0,0,0,-54000,0,0,0,0,54000,-54000,-54000
050842,旺宏國票97購01  ,0,0,0,0,0,0,0,0,0,-54000,0,0,0,56000,110000,-54000,-54000
049597,泰鼎元大96購01  ,0,0,0,0,0,0,0,0,0,-54000,0,0,0,0,54000,-54000,-54000
053534,微星永豐96購02  ,0,0,0,0,0,0,0,0,0,-54000,0,0,0,131000,185000,-54000,-54000
057265,聯詠兆豐98購01  ,0,0,0,0,0,0,0,0,0,-54000,0,0,0,0,54000,-54000,-54000
057815,信邦元大98購01  ,0,0,0,0,0,0,0,0,0,-54000,0,0,0,162000,216000,-54000,-54000
058041,FBVIX元大98購02 ,0,0,0,0,0,0,0,0,0,-54000,0,0,0,2000,56000,-54000,-54000
058096,南電元大98購04  ,0,0,0,0,0,0,0,0,0,-54000,0,0,0,0,54000,-54000,-54000
055938,矽力群益97購01  ,0,0,0,0,0,0,0,0,0,-54000,0,0,0,0,54000,-54000,-54000
2477,美隆電          ,0,54000,-54000,0,0,0,0,0,0,0,0,0,0,0,0,0,-54000
4989,榮科            ,5000,59000,-54000,0,0,0,0,0,0,0,0,0,0,0,0,0,-54000
06012P,世芯國票96售01  ,0,0,0,0,0,0,0,0,0,-55000,0,0,0,76000,131000,-55000,-55000
060238,強茂元大9C購01  ,0,0,0,0,0,0,0,0,0,-55000,0,0,0,53000,108000,-55000,-55000
061157,聯鈞群益9A購02  ,0,0,0,0,0,0,0,0,0,-55000,0,0,0,0,55000,-55000,-55000
054418,茂林元大97購01  ,0,0,0,0,0,0,0,0,0,-55000,0,0,0,35000,90000,-55000,-55000
051075,智邦國泰97購01  ,0,0,0,0,0,0,0,0,0,-55000,0,0,0,13000,68000,-55000,-55000
052681,T50反1元大98購02,0,0,0,0,0,0,0,0,0,-55000,0,0,0,3000,58000,-55000,-55000
058081,技嘉群益9A購03  ,0,0,0,0,0,0,0,0,0,-55000,0,0,0,30000,85000,-55000,-55000
058519,嘉澤元大99購01  ,0,0,0,0,0,0,0,0,0,-55000,0,0,0,6000,61000,-55000,-55000
056993,GIS兆豐99購01   ,0,0,0,0,0,0,0,0,0,-55000,0,0,0,0,55000,-55000,-55000
056410,康控國票99購01  ,0,0,0,0,0,0,0,0,0,-55000,0,0,0,147000,202000,-55000,-55000
057984,聯發科台新98購01,0,0,0,0,0,0,0,0,0,-55000,0,0,0,346000,401000,-55000,-55000
059181,世紀鋼元富9C購01,0,0,0,0,0,0,0,0,0,-55000,0,0,0,50000,105000,-55000,-55000
059297,大立光元富9C購01,0,0,0,0,0,0,0,0,0,-55000,0,0,0,15000,70000,-55000,-55000
057369,奇力新元大99購05,0,0,0,0,0,0,0,0,0,-55000,0,0,0,0,55000,-55000,-55000
058914,元油2X元富01購02,0,0,0,0,0,0,0,0,0,-55000,0,0,0,0,55000,-55000,-55000
4526,東台            ,11000,66000,-55000,0,0,0,0,0,0,0,0,0,0,0,0,0,-55000
2402,毅嘉            ,93000,148000,-55000,0,0,0,0,0,0,0,0,0,0,0,0,0,-55000
07225P,台積電元大99售33,0,0,0,0,0,0,0,0,0,-55000,0,0,0,0,55000,-55000,-55000
1531,高林股          ,77000,132000,-55000,0,0,0,0,0,0,0,0,0,0,0,0,0,-55000
9955,佳龍            ,7000,62000,-55000,0,0,0,0,0,0,0,0,0,0,0,0,0,-55000
061088,國巨統一9C購05  ,0,0,0,0,0,0,0,0,0,-56000,0,0,0,207000,263000,-56000,-56000
060797,世芯永豐9A購04  ,0,0,0,0,0,0,0,0,0,-56000,0,0,0,246000,302000,-56000,-56000
060276,S&P反1元大9A購03,0,0,0,0,0,0,0,0,0,-56000,0,0,0,0,56000,-56000,-56000
060433,億豐永豐9A購01  ,0,0,0,0,0,0,0,0,0,-56000,0,0,0,0,56000,-56000,-56000
060713,聯詠永豐9A購01  ,0,0,0,0,0,0,0,0,0,-56000,0,0,0,23000,79000,-56000,-56000
059689,南亞科永豐99購02,0,0,0,0,0,0,0,0,0,-56000,0,0,0,47000,103000,-56000,-56000
053209,台積電凱基96購07,0,0,0,0,0,0,0,0,0,-56000,0,0,0,4000,60000,-56000,-56000
057266,TPK兆豐98購02   ,0,0,0,0,0,0,0,0,0,-56000,0,0,0,21000,77000,-56000,-56000
055425,聚陽群益99購01  ,0,0,0,0,0,0,0,0,0,-56000,0,0,0,0,56000,-56000,-56000
07187P,臺股指台新99售10,0,0,0,0,0,0,0,0,0,-56000,0,0,0,5000,61000,-56000,-56000
4961,天鈺            ,53000,109000,-56000,0,0,0,0,0,0,0,0,0,0,0,0,0,-56000
061500,京鼎國票9B購01  ,0,0,0,0,0,0,0,0,0,-57000,0,0,0,29000,86000,-57000,-57000
054912,群光凱基97購01  ,0,0,0,0,0,0,0,0,0,-57000,0,0,0,133000,190000,-57000,-57000
05760P,京鼎永豐96售02  ,0,0,0,0,0,0,0,0,0,-57000,0,0,0,0,57000,-57000,-57000
057930,旺宏群益99購04  ,0,0,0,0,0,0,0,0,0,-57000,0,0,0,86000,143000,-57000,-57000
057878,台郡元大99購04  ,0,0,0,0,0,0,0,0,0,-57000,0,0,0,23000,80000,-57000,-57000
053745,康友國票97購01  ,0,0,0,0,0,0,0,0,0,-57000,0,0,0,100000,157000,-57000,-57000
02001R,富邦蘋果反一N   ,0,0,0,0,0,0,0,0,0,-57000,0,0,0,0,57000,-57000,-57000
055963,欣興元大97購04  ,0,0,0,0,0,0,0,0,0,-57000,0,0,0,118000,175000,-57000,-57000
058694,鈺齊國票9A購02  ,0,0,0,0,0,0,0,0,0,-57000,0,0,0,25000,82000,-57000,-57000
058293,光寶科凱基9A購01,0,0,0,0,0,0,0,0,0,-57000,0,0,0,295000,352000,-57000,-57000
058241,景碩元大99購05  ,0,0,0,0,0,0,0,0,0,-57000,0,0,0,89000,146000,-57000,-57000
056408,奇鋐國票99購01  ,0,0,0,0,0,0,0,0,0,-57000,0,0,0,37000,94000,-57000,-57000
07452P,國巨元大9A售05  ,0,0,0,0,0,0,0,0,0,-57000,0,0,0,75000,132000,-57000,-57000
9136,巨騰-DR         ,0,57000,-57000,0,0,0,0,0,0,0,0,0,0,0,0,0,-57000
8011,台通            ,135000,192000,-57000,0,0,0,0,0,0,0,0,0,0,0,0,0,-57000
2428,興勤            ,128000,213681,-85681,0,0,0,0,0,0,28000,0,1000,-1000,29000,0,29000,-57681
06598P,奇力新永豐98售02,0,0,0,0,0,0,0,0,0,-58000,0,0,0,0,58000,-58000,-58000
05947P,大成鋼元大96售03,0,0,0,0,0,0,0,0,0,-58000,0,0,0,5000,63000,-58000,-58000
057975,台積電永豐98購05,0,0,0,0,0,0,0,0,0,-58000,0,0,0,0,58000,-58000,-58000
055208,京鼎康和97購02  ,0,0,0,0,0,0,0,0,0,-58000,0,0,0,0,58000,-58000,-58000
056670,樺漢國票99購01  ,0,0,0,0,0,0,0,0,0,-58000,0,0,0,0,58000,-58000,-58000
059083,華通元大99購07  ,0,0,0,0,0,0,0,0,0,-58000,0,0,0,73000,131000,-58000,-58000
058284,滬深反群益01購01,0,0,0,0,0,0,0,0,0,-58000,0,0,0,0,58000,-58000,-58000
058553,合勤控永豐99購01,0,0,0,0,0,0,0,0,0,-58000,0,0,0,68000,126000,-58000,-58000
058554,瀚宇博永豐99購01,0,0,0,0,0,0,0,0,0,-58000,0,0,0,10000,68000,-58000,-58000
055730,建準元富97購02  ,0,0,0,0,0,0,0,0,0,-58000,0,0,0,100000,158000,-58000,-58000
2062,橋椿            ,8000,66000,-58000,0,0,0,0,0,0,0,0,0,0,0,0,0,-58000
07400P,國巨凱基99售20  ,0,0,0,0,0,0,0,0,0,-58000,0,0,0,23000,81000,-58000,-58000
1783,和康生          ,18000,76000,-58000,0,0,0,0,0,0,0,0,0,0,0,0,0,-58000
059493,國巨國票9B購01  ,0,0,0,0,0,0,0,0,0,-59000,0,0,0,207000,266000,-59000,-59000
060657,旺宏統一9B購05  ,0,0,0,0,0,0,0,0,0,-59000,0,0,0,1000,60000,-59000,-59000
06013P,世芯國泰97售03  ,0,0,0,0,0,0,0,0,0,-59000,0,0,0,0,59000,-59000,-59000
054943,群光元大97購01  ,0,0,0,0,0,0,0,0,0,-59000,0,0,0,115000,174000,-59000,-59000
054972,聯茂元大97購02  ,0,0,0,0,0,0,0,0,0,-59000,0,0,0,0,59000,-59000,-59000
052874,超眾凱基96購01  ,0,0,0,0,0,0,0,0,0,-59000,0,0,0,1000,60000,-59000,-59000
055138,大毅永豐97購02  ,0,0,0,0,0,0,0,0,0,-59000,0,0,0,15000,74000,-59000,-59000
055127,台虹兆豐97購01  ,0,0,0,0,0,0,0,0,0,-59000,0,0,0,2000,61000,-59000,-59000
058749,康控凱基99購03  ,0,0,0,0,0,0,0,0,0,-59000,0,0,0,43000,102000,-59000,-59000
056212,台光電國票98購03,0,0,0,0,0,0,0,0,0,-59000,0,0,0,0,59000,-59000,-59000
057201,華擎元富98購01  ,0,0,0,0,0,0,0,0,0,-59000,0,0,0,9000,68000,-59000,-59000
07722P,玉晶光凱基9A售10,0,0,0,0,0,0,0,0,0,-59000,0,0,0,0,59000,-59000,-59000
07653P,華新科群益9A售05,0,0,0,0,0,0,0,0,0,-59000,0,0,0,2000,61000,-59000,-59000
07145P,為升元大99售03  ,0,0,0,0,0,0,0,0,0,-59000,0,0,0,0,59000,-59000,-59000
6108,競國            ,1000,60000,-59000,0,0,0,0,0,0,0,0,0,0,0,0,0,-59000
060165,上緯控永豐9A購01,0,0,0,0,0,0,0,0,0,-60000,0,0,0,256000,316000,-60000,-60000
060166,佐登永豐9A購01  ,0,0,0,0,0,0,0,0,0,-60000,0,0,0,0,60000,-60000,-60000
05978P,麗豐永豐96售02  ,0,0,0,0,0,0,0,0,0,-60000,0,0,0,0,60000,-60000,-60000
06773P,台灣50兆豐9A售01,0,0,0,0,0,0,0,0,0,-60000,0,0,0,0,60000,-60000,-60000
06268P,聯詠凱基97售02  ,0,0,0,0,0,0,0,0,0,-60000,0,0,0,10000,70000,-60000,-60000
060846,欣興國票9A購02  ,0,0,0,0,0,0,0,0,0,-60000,0,0,0,82000,142000,-60000,-60000
061344,禾伸堂元大9A購02,0,0,0,0,0,0,0,0,0,-60000,0,0,0,207000,267000,-60000,-60000
052667,漢唐群益96購01  ,0,0,0,0,0,0,0,0,0,-60000,0,0,0,0,60000,-60000,-60000
052620,上証2X富邦97購02,0,0,0,0,0,0,0,0,0,-60000,0,0,0,0,60000,-60000,-60000
052428,嘉晶永豐95購01  ,0,0,0,0,0,0,0,0,0,-60000,0,0,0,30000,90000,-60000,-60000
05439P,聯發科國票95售06,0,0,0,0,0,0,0,0,0,-60000,0,0,0,6000,66000,-60000,-60000
057826,祥碩元大98購08  ,0,0,0,0,0,0,0,0,0,-60000,0,0,0,20000,80000,-60000,-60000
054975,福懋科元大97購01,0,0,0,0,0,0,0,0,0,-60000,0,0,0,0,60000,-60000,-60000
053077,同欣電永豐96購01,0,0,0,0,0,0,0,0,0,-60000,0,0,0,0,60000,-60000,-60000
057817,景碩元大98購01  ,0,0,0,0,0,0,0,0,0,-60000,0,0,0,38000,98000,-60000,-60000
059113,群光永豐99購01  ,0,0,0,0,0,0,0,0,0,-60000,0,0,0,1000,61000,-60000,-60000
056130,新日興麥證97購01,0,0,0,0,60000,-60000,0,0,0,-60000,0,0,0,0,60000,-60000,-60000
056268,新日興統一97購01,0,0,0,0,0,0,0,0,0,-60000,0,0,0,0,60000,-60000,-60000
07576P,可成元大9A售01  ,0,0,0,0,0,0,0,0,0,-60000,0,0,0,10000,70000,-60000,-60000
07866P,上証2X國票97售01,0,0,0,0,0,0,0,0,0,-60000,0,0,0,0,60000,-60000,-60000
060877,華邦電中信02購01,0,0,0,0,0,0,0,0,0,-61000,0,0,0,5000,66000,-61000,-61000
060761,南亞科元大9A購05,0,0,0,0,0,0,0,0,0,-61000,0,0,0,482000,543000,-61000,-61000
061462,國巨群益9A購11  ,0,0,0,0,0,0,0,0,0,-61000,0,0,0,246000,307000,-61000,-61000
059732,超眾元大9A購01  ,0,0,0,0,0,0,0,0,0,-61000,0,0,0,15000,76000,-61000,-61000
05973P,聯詠元大96售06  ,0,0,0,0,0,0,0,0,0,-61000,0,0,0,18000,79000,-61000,-61000
060104,新日興元大99購03,0,0,0,0,0,0,0,0,0,-61000,0,0,0,49000,110000,-61000,-61000
060658,台灣50凱基01購04,0,0,0,0,0,0,0,0,0,-61000,0,0,0,53000,114000,-61000,-61000
056132,台光電元大97購03,0,0,0,0,0,0,0,0,0,-61000,0,0,0,0,61000,-61000,-61000
059338,滬深2X凱基9C購02,0,0,0,0,0,0,0,0,0,-61000,0,0,0,84000,145000,-61000,-61000
057374,禾伸堂元大99購03,0,0,0,0,0,0,0,0,0,-61000,0,0,0,180000,241000,-61000,-61000
057284,新日興元大98購03,0,0,0,0,0,0,0,0,0,-61000,0,0,0,30000,91000,-61000,-61000
3443,創意            ,231000,250000,-19000,0,0,0,0,0,0,-42000,5000,0,5000,8000,55000,-47000,-61000
060310,瑞昱永豐9A購01  ,0,0,0,0,0,0,0,0,0,-62000,0,0,0,60000,122000,-62000,-62000
060381,元黃金凱基9A購01,0,0,0,0,0,0,0,0,0,-62000,0,0,0,278000,340000,-62000,-62000
059350,樺漢凱基9A購01  ,0,0,0,0,0,0,0,0,0,-62000,0,0,0,157000,219000,-62000,-62000
06864P,健策凱基98售01  ,0,0,0,0,0,0,0,0,0,-62000,0,0,0,40000,102000,-62000,-62000
060942,智邦國票9A購02  ,0,0,0,0,0,0,0,0,0,-62000,0,0,0,360000,422000,-62000,-62000
060984,南亞科元大9A購07,0,0,0,0,0,0,0,0,0,-62000,0,0,0,201000,263000,-62000,-62000
061317,旺宏凱基9A購05  ,0,0,0,0,0,0,0,0,0,-62000,0,0,0,27000,89000,-62000,-62000
2511,太子            ,108000,170000,-62000,0,0,0,0,0,0,0,0,0,0,0,0,0,-62000
1733,五鼎            ,30000,92000,-62000,0,0,0,0,0,0,0,1000,1000,0,0,0,0,-62000
07573P,國巨元大9A售11  ,0,0,0,0,0,0,0,0,0,-62000,0,0,0,33000,95000,-62000,-62000
061391,晶技群益9A購02  ,0,0,0,0,0,0,0,0,0,-63000,0,0,0,84000,147000,-63000,-63000
06763P,技嘉元大98售05  ,0,0,0,0,0,0,0,0,0,-63000,0,0,0,3000,66000,-63000,-63000
059675,大立光元富99購08,0,0,0,0,0,0,0,0,0,-63000,0,0,0,42000,105000,-63000,-63000
060112,祥碩元大99購04  ,0,0,0,0,0,0,0,0,0,-63000,0,0,0,377000,440000,-63000,-63000
054694,聯鈞永豐97購01  ,0,0,0,0,0,0,0,0,0,-63000,0,0,0,0,63000,-63000,-63000
056671,台灣50元富9A購01,0,0,0,0,0,0,0,0,0,-63000,0,0,0,0,63000,-63000,-63000
057007,奇力新中信98購04,0,0,0,0,0,0,0,0,0,-63000,0,0,0,60000,123000,-63000,-63000
058372,欣興凱基99購03  ,0,0,0,0,0,0,0,0,0,-63000,0,0,0,68000,131000,-63000,-63000
3346,麗清            ,6000,69000,-63000,0,0,0,0,0,0,0,0,0,0,0,0,0,-63000
059559,T50反1凱基99購07,0,0,0,0,0,0,0,0,0,-64000,0,0,0,1000,65000,-64000,-64000
061091,奇力新統一9C購02,0,0,0,0,0,0,0,0,0,-64000,0,0,0,211000,275000,-64000,-64000
052821,晶技永豐96購01  ,0,0,0,0,0,0,0,0,0,-64000,0,0,0,10000,74000,-64000,-64000
055026,健和興國泰98購01,0,0,0,0,0,0,0,0,0,-64000,0,0,0,0,64000,-64000,-64000
044963,台積電中信96購01,0,2000,-2000,0,0,0,0,0,0,-62000,0,0,0,0,62000,-62000,-64000
07459P,緯穎元大9A售01  ,0,0,0,0,0,0,0,0,0,-64000,0,0,0,99000,163000,-64000,-64000
1737,臺鹽            ,5000,69000,-64000,0,0,0,0,0,0,0,0,0,0,0,0,0,-64000
6456,GIS-KY          ,299000,318000,-19000,0,0,0,0,0,0,-45000,0,0,0,3000,48000,-45000,-64000
061207,美律元大9A購04  ,0,0,0,0,0,0,0,0,0,-65000,0,0,0,48000,113000,-65000,-65000
06155P,智邦統一97售02  ,0,0,0,0,0,0,0,0,0,-65000,0,0,0,30000,95000,-65000,-65000
06187P,國巨統一97售05  ,0,0,0,0,0,0,0,0,0,-65000,0,0,0,0,65000,-65000,-65000
059787,奇力新元大9A購02,0,0,0,0,0,0,0,0,0,-65000,0,0,0,17000,82000,-65000,-65000
051422,超眾國票96購01  ,0,0,0,0,0,0,0,0,0,-65000,0,0,0,1000,66000,-65000,-65000
053627,宏碁兆豐97購01  ,0,0,0,0,0,0,0,0,0,-65000,0,0,0,0,65000,-65000,-65000
052704,TPK國票97購01   ,0,0,0,0,0,0,0,0,0,-65000,0,0,0,0,65000,-65000,-65000
056146,台虹元大98購01  ,0,0,0,0,0,0,0,0,0,-65000,0,0,0,150000,215000,-65000,-65000
055901,超眾中信97購01  ,0,0,0,0,0,0,0,0,0,-65000,0,0,0,62000,127000,-65000,-65000
057504,技嘉麥證98購01  ,0,0,0,0,65000,-65000,0,0,0,-65000,0,0,0,0,65000,-65000,-65000
059856,昇陽半永豐99購03,0,0,0,0,0,0,0,0,0,-66000,0,0,0,53000,119000,-66000,-66000
061371,嘉澤國泰9C購01  ,0,0,0,0,0,0,0,0,0,-66000,0,0,0,14000,80000,-66000,-66000
061428,南六元大9A購01  ,0,0,0,0,0,0,0,0,0,-66000,0,0,0,23000,89000,-66000,-66000
07070P,晶相光元富99售01,0,0,0,0,0,0,0,0,0,-66000,0,0,0,0,66000,-66000,-66000
054053,聯茂元大96購01  ,0,0,0,0,0,0,0,0,0,-66000,0,0,0,75000,141000,-66000,-66000
00714,群益道瓊美國地產,0,0,0,0,0,0,0,0,0,-66000,0,0,0,3000,69000,-66000,-66000
056578,智易元大99購02  ,0,0,0,0,0,0,0,0,0,-66000,0,0,0,55000,121000,-66000,-66000
056023,晶豪科群益97購01,0,0,0,0,0,0,0,0,0,-66000,0,0,0,199000,265000,-66000,-66000
056307,貿聯元大97購05  ,0,0,0,0,0,0,0,0,0,-66000,0,0,0,52000,118000,-66000,-66000
9946,三發地產        ,0,66000,-66000,0,0,0,0,0,0,0,0,0,0,0,0,0,-66000
2453,凌群            ,76000,143000,-67000,0,0,0,0,0,0,1000,1000,0,1000,0,0,0,-66000
06005P,晶豪科永豐96售04,0,0,0,0,0,0,0,0,0,-67000,0,0,0,1000,68000,-67000,-67000
054090,瑞昱群益97購01  ,0,0,0,0,0,0,0,0,0,-67000,0,0,0,188000,255000,-67000,-67000
057777,可成群益9A購03  ,0,0,0,0,0,0,0,0,0,-67000,0,0,0,30000,97000,-67000,-67000
055848,大立光元大97購11,0,0,0,0,0,0,0,0,0,-67000,0,0,0,1000,68000,-67000,-67000
05805P,義隆永豐96售02  ,0,0,0,0,0,0,0,0,0,-67000,0,0,0,30000,97000,-67000,-67000
056618,京元電永豐98購01,0,0,0,0,0,0,0,0,0,-67000,0,0,0,138000,205000,-67000,-67000
07760P,力山永豐9A售03  ,0,0,0,0,0,0,0,0,0,-67000,0,0,0,28000,95000,-67000,-67000
07245P,台積電凱基99售16,0,0,0,0,0,0,0,0,0,-67000,0,0,0,8000,75000,-67000,-67000
059924,世紀鋼元大99購06,0,0,0,0,0,0,0,0,0,-68000,0,0,0,94000,162000,-68000,-68000
060243,潤泰全元大9C購02,0,0,0,0,0,0,0,0,0,-68000,0,0,0,111000,179000,-68000,-68000
060513,緯穎元大9B購01  ,0,0,0,0,0,0,0,0,0,-68000,0,0,0,19000,87000,-68000,-68000
06729P,聯詠元大98售03  ,0,0,0,0,0,0,0,0,0,-68000,0,0,0,0,68000,-68000,-68000
06851P,鈺齊元大98售01  ,0,0,0,0,0,0,0,0,0,-68000,0,0,0,0,68000,-68000,-68000
06177P,玉晶光元大98售07,0,0,0,0,0,0,0,0,0,-68000,0,0,0,2000,70000,-68000,-68000
057583,啟碁中信9A購01  ,0,0,0,0,0,0,0,0,0,-68000,0,0,0,30000,98000,-68000,-68000
052372,台泥元大95購02  ,0,0,0,0,0,0,0,0,0,-68000,0,0,0,0,68000,-68000,-68000
056812,泰鼎統一98購01  ,0,0,0,0,0,0,0,0,0,-68000,0,0,0,25000,93000,-68000,-68000
057367,技嘉元大98購02  ,0,0,0,0,0,0,0,0,0,-68000,0,0,0,0,68000,-68000,-68000
058035,旭富永豐98購02  ,0,0,0,0,0,0,0,0,0,-68000,0,0,0,47000,115000,-68000,-68000
055714,智邦元大97購03  ,0,0,0,0,0,0,0,0,0,-68000,0,0,0,19000,87000,-68000,-68000
056297,台光電元大97購04,0,0,0,0,0,0,0,0,0,-68000,0,0,0,2000,70000,-68000,-68000
07350P,台灣50國票99售11,0,0,0,0,0,0,0,0,0,-68000,0,0,0,0,68000,-68000,-68000
2392,正崴            ,456000,474000,-18000,0,0,0,0,0,0,-50000,6000,52000,-46000,28000,32000,-4000,-68000
8926,台汽電          ,80000,134333,-54333,0,0,0,0,0,0,-14000,20000,0,20000,0,34000,-34000,-68333
06662P,玉晶光中信9A售01,0,0,0,0,0,0,0,0,0,-69000,0,0,0,265000,334000,-69000,-69000
07121P,華新科凱基99售03,0,0,0,0,0,0,0,0,0,-69000,0,0,0,0,69000,-69000,-69000
03414B,臺股指凱基99熊01,70000,60000,10000,0,0,0,0,0,0,-79000,0,0,0,114000,193000,-79000,-69000
057742,喬山永豐98購02  ,0,0,0,0,0,0,0,0,0,-69000,0,0,0,29000,98000,-69000,-69000
058821,泰鼎國泰9B購01  ,0,0,0,0,0,0,0,0,0,-69000,0,0,0,85000,154000,-69000,-69000
056049,奇力新國票98購01,0,0,0,0,0,0,0,0,0,-69000,0,0,0,97000,166000,-69000,-69000
07235P,T50正2元大9C售02,0,0,0,0,0,0,0,0,0,-69000,0,0,0,5000,74000,-69000,-69000
07210P,智邦凱基99售03  ,0,0,0,0,0,0,0,0,0,-69000,0,0,0,30000,99000,-69000,-69000
07763P,嘉澤永豐9A售02  ,0,0,0,0,0,0,0,0,0,-69000,0,0,0,60000,129000,-69000,-69000
07649P,金像電永豐9A售02,0,0,0,0,0,0,0,0,0,-69000,0,0,0,151000,220000,-69000,-69000
06737P,台郡凱基98售07  ,0,0,0,0,0,0,0,0,0,-70000,0,0,0,0,70000,-70000,-70000
061067,貿聯凱基9A購03  ,0,0,0,0,0,0,0,0,0,-70000,0,0,0,20000,90000,-70000,-70000
06042P,華新科永豐96售04,0,0,0,0,0,0,0,0,0,-70000,0,0,0,131000,201000,-70000,-70000
060125,強茂永豐99購01  ,0,0,0,0,0,0,0,0,0,-70000,0,0,0,0,70000,-70000,-70000
060288,群光元大9C購01  ,0,0,0,0,0,0,0,0,0,-70000,0,0,0,25000,95000,-70000,-70000
059377,台積電群益99購09,0,0,0,0,0,0,0,0,0,-70000,0,0,0,5000,75000,-70000,-70000
057573,京鼎永豐98購02  ,0,0,0,0,0,0,0,0,0,-70000,0,0,0,5000,75000,-70000,-70000
053166,聯詠群益96購02  ,0,0,0,0,0,0,0,0,0,-70000,0,0,0,0,70000,-70000,-70000
051999,勤誠元大95購01  ,0,0,0,0,0,0,0,0,0,-70000,0,0,0,30000,100000,-70000,-70000
050306,聯發科中信97購01,0,0,0,0,0,0,0,0,0,-70000,0,0,0,455000,525000,-70000,-70000
053760,牧德國泰98購01  ,0,0,0,0,0,0,0,0,0,-70000,0,0,0,0,70000,-70000,-70000
053929,正文國票97購01  ,0,0,0,0,0,0,0,0,0,-70000,0,0,0,25000,95000,-70000,-70000
058314,欣興富邦9B購01  ,0,0,0,0,0,0,0,0,0,-70000,0,0,0,0,70000,-70000,-70000
07359P,台積電元大99售45,0,0,0,0,0,0,0,0,0,-70000,0,0,0,18000,88000,-70000,-70000
2707,晶華            ,23000,93000,-70000,0,0,0,0,0,0,0,0,0,0,0,0,0,-70000
061234,國巨元大9A購18  ,0,0,0,0,0,0,0,0,0,-71000,0,0,0,89000,160000,-71000,-71000
060870,旭富群益9A購01  ,0,0,0,0,0,0,0,0,0,-71000,0,0,0,17000,88000,-71000,-71000
06718P,聯詠元大98售01  ,0,0,0,0,0,0,0,0,0,-71000,0,0,0,0,71000,-71000,-71000
053915,光罩國票96購02  ,0,0,0,0,0,0,0,0,0,-71000,0,0,0,111000,182000,-71000,-71000
051990,泰碩元大95購01  ,0,0,0,0,0,0,0,0,0,-71000,0,0,0,3000,74000,-71000,-71000
054693,神基永豐97購01  ,0,0,0,0,0,0,0,0,0,-71000,0,0,0,30000,101000,-71000,-71000
057928,鈺齊凱基98購02  ,0,0,0,0,0,0,0,0,0,-71000,0,0,0,146000,217000,-71000,-71000
057603,樺漢群益98購02  ,0,0,0,0,0,0,0,0,0,-71000,0,0,0,337000,408000,-71000,-71000
4540,全球傳動        ,172000,243000,-71000,0,0,0,0,0,0,0,0,0,0,0,0,0,-71000
07530P,聯發科凱基9A售11,0,0,0,0,0,0,0,0,0,-71000,0,0,0,10000,81000,-71000,-71000
6670,復盛應用        ,307000,375000,-68000,0,0,0,0,0,0,-3000,0,0,0,0,3000,-3000,-71000
6706,惠特            ,124000,241131,-117131,0,0,0,0,0,0,46000,46000,0,46000,0,0,0,-71131
060892,超眾統一9C購01  ,0,0,0,0,0,0,0,0,0,-72000,0,0,0,0,72000,-72000,-72000
059646,聯茂凱基99購06  ,0,0,0,0,0,0,0,0,0,-72000,0,0,0,65000,137000,-72000,-72000
060650,奇力新中信9A購01,0,0,0,0,0,0,0,0,0,-72000,0,0,0,310000,382000,-72000,-72000
057874,可成元大99購02  ,0,0,0,0,0,0,0,0,0,-72000,0,0,0,1000,73000,-72000,-72000
058345,台光電群益99購03,0,0,0,0,0,0,0,0,0,-72000,0,0,0,52000,124000,-72000,-72000
055603,超眾元大97購04  ,0,0,0,0,0,0,0,0,0,-72000,0,0,0,1000,73000,-72000,-72000
060277,道瓊反元大9A購02,0,0,0,0,0,0,0,0,0,-73000,0,0,0,7000,80000,-73000,-73000
060336,南電康和9A購01  ,0,0,0,0,0,0,0,0,0,-73000,0,0,0,232000,305000,-73000,-73000
060232,友訊元大9C購01  ,0,0,0,0,0,0,0,0,0,-73000,0,0,0,68000,141000,-73000,-73000
06243P,亞光元富97售01  ,0,0,0,0,0,0,0,0,0,-73000,0,0,0,0,73000,-73000,-73000
061454,國巨凱基9A購16  ,0,0,0,0,0,0,0,0,0,-73000,0,0,0,190000,263000,-73000,-73000
053066,欣興群益96購02  ,0,0,0,0,0,0,0,0,0,-73000,0,0,0,0,73000,-73000,-73000
053501,明泰兆豐96購01  ,0,0,0,0,0,0,0,0,0,-73000,0,0,0,94000,167000,-73000,-73000
051906,國巨元大95購09  ,0,0,0,0,0,0,0,0,0,-73000,0,0,0,129000,202000,-73000,-73000
056289,合勤控永豐97購01,0,0,0,0,0,0,0,0,0,-73000,0,0,0,0,73000,-73000,-73000
059284,緯穎永豐99購03  ,0,0,0,0,0,0,0,0,0,-73000,0,0,0,92000,165000,-73000,-73000
07574P,國巨元大9A售12  ,0,0,0,0,0,0,0,0,0,-73000,0,0,0,1000,74000,-73000,-73000
07648P,祥碩國票9B售01  ,0,0,0,0,0,0,0,0,0,-73000,0,0,0,34000,107000,-73000,-73000
1701,中化            ,329000,402000,-73000,0,0,0,0,0,0,0,0,0,0,0,0,0,-73000
061442,玉晶光永豐9A購07,0,0,0,0,0,0,0,0,0,-74000,0,0,0,0,74000,-74000,-74000
06135P,志超元富97售01  ,0,0,0,0,0,0,0,0,0,-74000,0,0,0,0,74000,-74000,-74000
053880,智邦中信96購01  ,0,0,0,0,0,0,0,0,0,-74000,0,0,0,21000,95000,-74000,-74000
054274,智易中信96購02  ,0,0,0,0,0,0,0,0,0,-74000,0,0,0,0,74000,-74000,-74000
057517,矽創元富98購02  ,0,0,0,0,0,0,0,0,0,-74000,0,0,0,24000,98000,-74000,-74000
056536,義隆凱基98購04  ,0,0,0,0,0,0,0,0,0,-74000,0,0,0,11000,85000,-74000,-74000
056534,京元電凱基98購01,0,0,0,0,0,0,0,0,0,-74000,0,0,0,6000,80000,-74000,-74000
058171,國巨凱基9A購07  ,0,0,0,0,0,0,0,0,0,-74000,0,0,0,206000,280000,-74000,-74000
060931,GIS永豐9A購01   ,0,0,0,0,0,0,0,0,0,-75000,0,0,0,5000,80000,-75000,-75000
060854,台積電富邦9C購08,0,0,0,0,0,0,0,0,0,-75000,0,0,0,2000,77000,-75000,-75000
059730,晶相光元大9C購02,0,0,0,0,0,0,0,0,0,-75000,0,0,0,156000,231000,-75000,-75000
059349,台郡凱基99購04  ,0,0,0,0,0,0,0,0,0,-75000,0,0,0,44000,119000,-75000,-75000
059540,新光金日盛99購01,0,0,0,0,0,0,0,0,0,-75000,0,0,0,0,75000,-75000,-75000
059950,百和永豐99購02  ,0,0,0,0,0,0,0,0,0,-75000,0,0,0,107000,182000,-75000,-75000
1730,花仙子          ,39000,114000,-75000,0,0,0,0,0,0,0,0,0,0,0,0,0,-75000
07284P,大立光凱基99售10,0,0,0,0,0,0,0,0,0,-75000,0,0,0,3000,78000,-75000,-75000
060252,緯穎元大9A購02  ,0,0,0,0,0,0,0,0,0,-76000,0,0,0,135000,211000,-76000,-76000
060489,世紀鋼群益9A購01,0,0,0,0,0,0,0,0,0,-76000,0,0,0,225000,301000,-76000,-76000
054420,緯穎元大96購08  ,0,0,0,0,0,0,0,0,0,-76000,0,0,0,73000,149000,-76000,-76000
058110,光寶科元富98購01,0,0,0,0,0,0,0,0,0,-76000,0,0,0,32000,108000,-76000,-76000
058402,欣興元大99購04  ,0,0,0,0,0,0,0,0,0,-76000,0,0,0,166000,242000,-76000,-76000
056187,京鼎統一97購01  ,0,0,0,0,0,0,0,0,0,-76000,0,0,0,46000,122000,-76000,-76000
05855P,滬深2X中信9C售01,0,0,0,0,0,0,0,0,0,-76000,0,0,0,15000,91000,-76000,-76000
058625,旺宏國票9A購01  ,0,0,0,0,0,0,0,0,0,-76000,0,0,0,54000,130000,-76000,-76000
057169,微星元大98購01  ,0,0,0,0,0,0,0,0,0,-76000,0,0,0,20000,96000,-76000,-76000
060375,葡萄王元富9A購01,0,0,0,0,0,0,0,0,0,-77000,0,0,0,23000,100000,-77000,-77000
061353,康控元大9A購01  ,0,0,0,0,0,0,0,0,0,-77000,0,0,0,227000,304000,-77000,-77000
06493P,聯發科永豐98售02,0,0,0,0,0,0,0,0,0,-77000,0,0,0,150000,227000,-77000,-77000
054579,聯茂元大97購01  ,0,0,0,0,0,0,0,0,0,-77000,0,0,0,22000,99000,-77000,-77000
056697,緯穎群益98購01  ,0,0,0,0,0,0,0,0,0,-77000,0,0,0,62000,139000,-77000,-77000
055381,茂林元大97購02  ,0,0,0,0,0,0,0,0,0,-77000,0,0,0,15000,92000,-77000,-77000
07780P,美律凱基9A售02  ,0,0,0,0,0,0,0,0,0,-77000,0,0,0,0,77000,-77000,-77000
061367,瑞祺國票9A購01  ,0,0,0,0,0,0,0,0,0,-78000,0,0,0,437000,515000,-78000,-78000
060927,嘉晶永豐9A購01  ,0,0,0,0,0,0,0,0,0,-78000,0,0,0,32000,110000,-78000,-78000
060468,聯鈞元大9A購02  ,0,0,0,0,0,0,0,0,0,-78000,0,0,0,65000,143000,-78000,-78000
052586,晶豪科永豐96購01,0,0,0,0,0,0,0,0,0,-78000,0,0,0,96000,174000,-78000,-78000
055763,鎧勝群益97購01  ,0,0,0,0,0,0,0,0,0,-78000,0,0,0,57000,135000,-78000,-78000
056291,聯茂永豐97購03  ,0,0,0,0,0,0,0,0,0,-78000,0,0,0,51000,129000,-78000,-78000
058748,景碩凱基9A購01  ,0,0,0,0,0,0,0,0,0,-78000,0,0,0,22000,100000,-78000,-78000
07743P,智邦凱基9A售03  ,0,0,0,0,0,0,0,0,0,-78000,0,0,0,10000,88000,-78000,-78000
07184P,台灣50元富01售01,0,0,0,0,0,0,0,0,0,-78000,0,0,0,0,78000,-78000,-78000
8016,矽創            ,276000,208000,68000,0,0,0,1000,150000,-149000,3000,0,2000,-2000,5000,0,5000,-78000
05565P,鎧勝元大96售01  ,0,0,0,0,0,0,0,0,0,-79000,0,0,0,10000,89000,-79000,-79000
060321,元金2X群益9B購01,0,0,0,0,0,0,0,0,0,-80000,0,0,0,0,80000,-80000,-80000
059403,T50反1台新03購03,100000,0,100000,0,0,0,0,0,0,-180000,0,0,0,0,180000,-180000,-80000
06720P,智邦亞東99售01  ,0,0,0,0,0,0,0,0,0,-80000,0,0,0,0,80000,-80000,-80000
050322,世紀鋼國票95購01,0,0,0,0,0,0,0,0,0,-80000,0,0,0,0,80000,-80000,-80000
05206P,南茂元大95售01  ,0,0,0,0,0,0,0,0,0,-80000,0,0,0,0,80000,-80000,-80000
054550,旺宏凱基98購02  ,0,0,0,0,0,0,0,0,0,-80000,0,0,0,30000,110000,-80000,-80000
055206,台虹中信97購01  ,0,0,0,0,0,0,0,0,0,-80000,0,0,0,20000,100000,-80000,-80000
054922,文曄凱基98購01  ,0,0,0,0,0,0,0,0,0,-80000,0,0,0,0,80000,-80000,-80000
058145,聯茂元大99購03  ,0,0,0,0,0,0,0,0,0,-80000,0,0,0,88000,168000,-80000,-80000
056205,貿聯永豐97購01  ,0,0,0,0,0,0,0,0,0,-80000,0,0,0,0,80000,-80000,-80000
058226,世芯元富99購01  ,0,0,0,0,0,0,0,0,0,-80000,0,0,0,40000,120000,-80000,-80000
056614,智邦永豐98購01  ,0,0,0,0,0,0,0,0,0,-80000,0,0,0,50000,130000,-80000,-80000
056617,美律永豐98購01  ,0,0,0,0,0,0,0,0,0,-80000,0,0,0,40000,120000,-80000,-80000
057428,正崴兆豐98購01  ,0,0,0,0,0,0,0,0,0,-80000,0,0,0,216000,296000,-80000,-80000
058963,華新科兆豐99購05,0,0,0,0,0,0,0,0,0,-80000,0,0,0,90000,170000,-80000,-80000
07466P,亞德客元大9A售02,0,0,0,0,0,0,0,0,0,-80000,0,0,0,35000,115000,-80000,-80000
05464P,華通康和95售02  ,0,0,0,0,0,0,0,0,0,-81000,0,0,0,0,81000,-81000,-81000
05731P,創意統一96售03  ,0,0,0,0,0,0,0,0,0,-81000,0,0,0,0,81000,-81000,-81000
07709P,創意元大9A售01  ,0,0,0,0,0,0,0,0,0,-81000,0,0,0,50000,131000,-81000,-81000
2614,東森            ,376000,457000,-81000,0,0,0,0,0,0,0,0,0,0,0,0,0,-81000
5871,中租-KY         ,1278000,1306818,-28818,0,0,0,1000,0,1000,-54000,2000,37000,-35000,9000,28000,-19000,-81818
061504,祥碩國票9A購02  ,0,0,0,0,0,0,0,0,0,-82000,0,0,0,160000,242000,-82000,-82000
060327,美律群益9A購02  ,0,0,0,0,0,0,0,0,0,-82000,0,0,0,55000,137000,-82000,-82000
060697,鴻海國泰9C購01  ,0,0,0,0,0,0,0,0,0,-82000,0,0,0,153000,235000,-82000,-82000
054244,華新元大96購01  ,0,0,0,0,0,0,0,0,0,-82000,0,0,0,118000,200000,-82000,-82000
057568,友訊永豐99購01  ,0,0,0,0,0,0,0,0,0,-82000,0,0,0,0,82000,-82000,-82000
057609,友訊元富98購01  ,0,0,0,0,0,0,0,0,0,-82000,0,0,0,133000,215000,-82000,-82000
058188,華擎永豐99購01  ,0,0,0,0,0,0,0,0,0,-82000,0,0,0,18000,100000,-82000,-82000
5515,建國            ,0,82000,-82000,0,0,0,0,0,0,0,0,0,0,0,0,0,-82000
2015,豐興            ,105000,205000,-100000,0,0,0,0,0,0,18000,18000,0,18000,0,0,0,-82000
060105,牧德元大9B購01  ,0,0,0,0,0,0,0,0,0,-83000,0,0,0,21000,104000,-83000,-83000
059940,微星永豐99購01  ,0,0,0,0,0,0,0,0,0,-83000,0,0,0,2000,85000,-83000,-83000
061429,南六元大9A購02  ,0,0,0,0,0,0,0,0,0,-83000,0,0,0,93000,176000,-83000,-83000
06779P,智邦元大98售12  ,0,0,0,0,0,0,0,0,0,-83000,0,0,0,240000,323000,-83000,-83000
057841,茂林富邦9A購02  ,0,0,0,0,0,0,0,0,0,-83000,0,0,0,40000,123000,-83000,-83000
048576,義隆國泰95購01  ,0,0,0,0,0,0,0,0,0,-83000,0,0,0,76000,159000,-83000,-83000
052654,友達統一97購01  ,0,0,0,0,0,0,0,0,0,-83000,0,0,0,16000,99000,-83000,-83000
052685,技嘉元大96購01  ,0,0,0,0,0,0,0,0,0,-83000,0,0,0,17000,100000,-83000,-83000
055703,緯穎富邦98購01  ,0,0,0,0,0,0,0,0,0,-83000,0,0,0,90000,173000,-83000,-83000
061152,微星群益9A購01  ,0,0,0,0,0,0,0,0,0,-84000,0,0,0,0,84000,-84000,-84000
060382,儒鴻凱基9A購01  ,0,0,0,0,0,0,0,0,0,-84000,0,0,0,110000,194000,-84000,-84000
053887,聯茂兆豐97購02  ,0,0,0,0,0,0,0,0,0,-84000,0,0,0,40000,124000,-84000,-84000
058648,聯陽永豐99購01  ,0,0,0,0,0,0,0,0,0,-84000,0,0,0,0,84000,-84000,-84000
056178,嘉澤元富97購02  ,0,0,0,0,0,0,0,0,0,-84000,0,0,0,10000,94000,-84000,-84000
07777P,創意元大9A售03  ,0,0,0,0,0,0,0,0,0,-84000,0,0,0,50000,134000,-84000,-84000
8215,明基材          ,269000,353000,-84000,0,0,0,0,0,0,0,0,0,0,0,0,0,-84000
1582,信錦            ,29000,113784,-84784,0,0,0,0,0,0,0,0,0,0,0,0,0,-84784
060568,SP黃豆永豐9A購01,0,0,0,0,0,0,0,0,0,-85000,0,0,0,0,85000,-85000,-85000
061263,微星凱基9A購01  ,0,0,0,0,0,0,0,0,0,-85000,0,0,0,24000,109000,-85000,-85000
061232,和大元大9A購03  ,0,0,0,0,0,0,0,0,0,-85000,0,0,0,27000,112000,-85000,-85000
061486,國巨兆豐9B購02  ,0,0,0,0,0,0,0,0,0,-85000,0,0,0,200000,285000,-85000,-85000
051985,智邦元大95購05  ,0,0,0,0,0,0,0,0,0,-85000,0,0,0,0,85000,-85000,-85000
054071,泰鼎國泰97購02  ,0,0,0,0,0,0,0,0,0,-85000,0,0,0,8000,93000,-85000,-85000
054826,復盛元大9A購01  ,0,0,0,0,0,0,0,0,0,-85000,0,0,0,168000,253000,-85000,-85000
058788,喬山元大99購01  ,0,0,0,0,0,0,0,0,0,-85000,0,0,0,450000,535000,-85000,-85000
057189,康控元大98購02  ,0,0,0,0,0,0,0,0,0,-85000,0,0,0,98000,183000,-85000,-85000
061512,國巨永豐9A購04  ,0,0,0,0,0,0,0,0,0,-86000,0,0,0,12000,98000,-86000,-86000
053510,聯電群益97購01  ,0,0,0,0,0,0,0,0,0,-86000,0,0,0,0,86000,-86000,-86000
052096,力成元大95購01  ,0,0,0,0,0,0,0,0,0,-86000,0,0,0,15000,101000,-86000,-86000
051406,泰鼎永豐96購01  ,0,0,0,0,0,0,0,0,0,-86000,0,0,0,12000,98000,-86000,-86000
057421,智原凱基98購04  ,0,0,0,0,0,0,0,0,0,-86000,0,0,0,20000,106000,-86000,-86000
058243,華擎元大99購01  ,0,0,0,0,0,0,0,0,0,-86000,0,0,0,98000,184000,-86000,-86000
07458P,長榮航元大9A售01,0,0,0,0,0,0,0,0,0,-86000,0,0,0,67000,153000,-86000,-86000
061108,臻鼎元大9A購02  ,0,0,0,0,0,0,0,0,0,-87000,0,0,0,28000,115000,-87000,-87000
060995,泰鼎元大9A購03  ,0,0,0,0,0,0,0,0,0,-87000,0,0,0,102000,189000,-87000,-87000
060002,T50反1群益9A購01,0,0,0,0,0,0,0,0,0,-87000,0,0,0,0,87000,-87000,-87000
057571,泰碩永豐98購01  ,0,0,0,0,0,0,0,0,0,-87000,0,0,0,49000,136000,-87000,-87000
057053,立積元大98購02  ,0,0,0,0,0,0,0,0,0,-87000,0,0,0,33000,120000,-87000,-87000
058051,同欣電元大98購03,0,0,0,0,0,0,0,0,0,-87000,0,0,0,19000,106000,-87000,-87000
057214,瑞昱群益98購01  ,0,0,0,0,0,0,0,0,0,-87000,0,0,0,42000,129000,-87000,-87000
07334P,臺股指國票99售19,0,0,0,0,0,0,0,0,0,-87000,0,0,0,348000,435000,-87000,-87000
056391,大立光富邦9C購01,0,0,0,0,0,0,0,0,0,-88000,0,0,0,0,88000,-88000,-88000
056473,奇力新元大99購02,0,0,0,0,0,0,0,0,0,-88000,0,0,0,12000,100000,-88000,-88000
059263,瑞昱中信01購01  ,0,0,0,0,0,0,0,0,0,-88000,0,0,0,41000,129000,-88000,-88000
059054,國巨凱基99購11  ,0,0,0,0,0,0,0,0,0,-88000,0,0,0,83000,171000,-88000,-88000
07509P,牧德國票9A售03  ,0,0,0,0,0,0,0,0,0,-88000,0,0,0,0,88000,-88000,-88000
060452,儒鴻元大9A購01  ,0,0,0,0,0,0,0,0,0,-89000,0,0,0,85000,174000,-89000,-89000
06507P,台表科國票99售01,0,0,0,0,0,0,0,0,0,-89000,0,0,0,10000,99000,-89000,-89000
049871,T50反1台新9A購02,0,0,0,0,0,0,0,0,0,-89000,0,0,0,21000,110000,-89000,-89000
056423,奇鋐統一98購01  ,0,0,0,0,0,0,0,0,0,-89000,0,0,0,0,89000,-89000,-89000
056735,國巨凱基99購02  ,0,0,0,0,0,0,0,0,0,-89000,0,0,0,201000,290000,-89000,-89000
061451,南電中信9A購03  ,0,0,0,0,0,0,0,0,0,-90000,0,0,0,0,90000,-90000,-90000
061084,京元電兆豐9A購02,0,0,0,0,0,0,0,0,0,-90000,0,0,0,20000,110000,-90000,-90000
060675,南亞科元大9A購02,0,0,0,0,0,0,0,0,0,-90000,0,0,0,29000,119000,-90000,-90000
060258,T50反1凱基9A購06,0,0,0,0,0,0,0,0,0,-90000,0,0,0,20000,110000,-90000,-90000
059976,道瓊銀元大99購01,0,0,0,0,0,0,0,0,0,-90000,0,0,0,10000,100000,-90000,-90000
059852,康控永豐99購02  ,0,0,0,0,0,0,0,0,0,-90000,0,0,0,308000,398000,-90000,-90000
055036,中工富邦9B購01  ,0,0,0,0,0,0,0,0,0,-90000,0,0,0,0,90000,-90000,-90000
055153,台光電元大98購02,0,0,0,0,0,0,0,0,0,-90000,0,0,0,0,90000,-90000,-90000
041534,T50反1凱基96購01,0,0,0,0,0,0,0,0,0,-90000,0,0,0,0,90000,-90000,-90000
056841,友達元富98購03  ,0,0,0,0,0,0,0,0,0,-90000,0,0,0,0,90000,-90000,-90000
058879,智邦富邦99購01  ,0,0,0,0,0,0,0,0,0,-90000,0,0,0,15000,105000,-90000,-90000
055255,欣興統一97購02  ,0,0,0,0,0,0,0,0,0,-90000,0,0,0,5000,95000,-90000,-90000
1731,美吾華          ,12000,102000,-90000,0,0,0,0,0,0,0,0,0,0,0,0,0,-90000
4952,凌通            ,9000,99000,-90000,0,0,0,0,0,0,0,0,0,0,0,0,0,-90000
3149,正達            ,12000,102000,-90000,0,0,0,0,0,0,0,0,0,0,0,0,0,-90000
060040,康控國票99購04  ,0,0,0,0,0,0,0,0,0,-91000,0,0,0,4000,95000,-91000,-91000
061005,可成兆豐9A購01  ,0,0,0,0,0,0,0,0,0,-91000,0,0,0,79000,170000,-91000,-91000
06846P,美律元大98售05  ,0,0,0,0,0,0,0,0,0,-91000,0,0,0,0,91000,-91000,-91000
055618,麗豐國票98購01  ,0,0,0,0,0,0,0,0,0,-91000,0,0,0,40000,131000,-91000,-91000
058328,世紀鋼統一9B購01,0,0,0,0,0,0,0,0,0,-91000,0,0,0,79000,170000,-91000,-91000
058816,祥碩台新99購02  ,0,0,0,0,0,0,0,0,0,-91000,0,0,0,70000,161000,-91000,-91000
3048,益登            ,36000,116000,-80000,0,0,0,0,0,0,-11000,0,11000,-11000,0,0,0,-91000
07293P,臺股指凱基99售45,0,0,0,0,0,0,0,0,0,-91000,0,0,0,105000,196000,-91000,-91000
06654P,欣興元大98售08  ,0,0,0,0,0,0,0,0,0,-92000,0,0,0,81000,173000,-92000,-92000
061463,智邦群益9A購02  ,0,0,0,0,0,0,0,0,0,-92000,0,0,0,4000,96000,-92000,-92000
061515,泰碩永豐9A購03  ,0,0,0,0,0,0,0,0,0,-92000,0,0,0,0,92000,-92000,-92000
061302,晶技永豐9A購04  ,0,0,0,0,0,0,0,0,0,-92000,0,0,0,90000,182000,-92000,-92000
060011,臺股指群益9C購06,0,0,0,0,0,0,0,0,0,-92000,0,0,0,3000,95000,-92000,-92000
057024,義隆凱基99購01  ,0,0,0,0,0,0,0,0,0,-92000,0,0,0,9000,101000,-92000,-92000
05861P,瀚宇博永豐96售02,0,0,0,0,0,0,0,0,0,-92000,0,0,0,66000,158000,-92000,-92000
07462P,臺股指元大9B售05,0,0,0,0,0,0,0,0,0,-92000,0,0,0,22000,114000,-92000,-92000
3380,明泰            ,579000,235000,344000,0,0,0,0,0,0,-436000,0,210000,-210000,127000,353000,-226000,-92000
060254,世紀鋼元大9A購01,0,0,0,0,0,0,0,0,0,-93000,0,0,0,10000,103000,-93000,-93000
060249,正文元大9C購01  ,0,0,0,0,0,0,0,0,0,-93000,0,0,0,0,93000,-93000,-93000
060313,淘帝永豐9A購01  ,0,0,0,0,0,0,0,0,0,-93000,0,0,0,0,93000,-93000,-93000
06477P,緯穎國票99售02  ,0,0,0,0,0,0,0,0,0,-93000,0,0,0,27000,120000,-93000,-93000
055178,晶豪科統一97購01,0,0,0,0,0,0,0,0,0,-93000,0,0,0,36000,129000,-93000,-93000
055589,台光電元大98購04,0,0,0,0,0,0,0,0,0,-93000,0,0,0,0,93000,-93000,-93000
055400,緯穎統一97購01  ,0,0,0,0,0,0,0,0,0,-93000,0,0,0,0,93000,-93000,-93000
056763,國巨元大99購02  ,0,0,0,0,0,0,0,0,0,-93000,0,0,0,337000,430000,-93000,-93000
07715P,台灣50群益9A售14,0,0,0,0,0,0,0,0,0,-93000,0,0,0,129000,222000,-93000,-93000
06551P,貿聯元大98售05  ,0,0,0,0,0,0,0,0,0,-94000,0,0,0,0,94000,-94000,-94000
060803,台灣50群益9A購13,0,0,0,0,0,0,0,0,0,-94000,0,0,0,0,94000,-94000,-94000
060654,大毅群益9B購01  ,0,0,0,0,0,0,0,0,0,-94000,0,0,0,122000,216000,-94000,-94000
05605P,嘉聯益元大97售02,0,0,0,0,0,0,0,0,0,-94000,0,0,0,0,94000,-94000,-94000
06151P,華新科元大97售07,0,0,0,0,0,0,0,0,0,-95000,0,0,0,55000,150000,-95000,-95000
055007,晶相光元富9A購02,0,0,0,0,0,0,0,0,0,-95000,0,0,0,0,95000,-95000,-95000
053672,嘉澤元富96購02  ,0,0,0,0,0,0,0,0,0,-95000,0,0,0,107000,202000,-95000,-95000
052816,上銀永豐96購01  ,0,0,0,0,0,0,0,0,0,-95000,0,0,0,50000,145000,-95000,-95000
05024P,華通國票96售01  ,0,0,0,0,0,0,0,0,0,-95000,0,0,0,32000,127000,-95000,-95000
056360,智邦元大98購01  ,0,0,0,0,0,0,0,0,0,-95000,0,0,0,13000,108000,-95000,-95000
055937,康舒群益97購01  ,0,0,0,0,0,0,0,0,0,-95000,0,0,0,0,95000,-95000,-95000
057120,茂林康和98購01  ,0,0,0,0,0,0,0,0,0,-95000,0,0,0,5000,100000,-95000,-95000
058377,茂林凱基9A購03  ,0,0,0,0,0,0,0,0,0,-95000,0,0,0,100000,195000,-95000,-95000
058456,京鼎永豐99購01  ,0,0,0,0,0,0,0,0,0,-95000,0,0,0,88000,183000,-95000,-95000
8131,福懋科          ,28000,122000,-94000,0,0,0,0,0,0,-1000,0,0,0,0,1000,-1000,-95000
057273,智邦元大98購05  ,0,0,0,0,0,0,0,0,0,-96000,0,0,0,177000,273000,-96000,-96000
3406,玉晶光          ,446000,742072,-296072,0,0,0,16000,0,16000,184000,259000,198000,61000,245000,122000,123000,-96072
059761,國巨永豐99購06  ,0,0,0,0,0,0,0,0,0,-97000,0,0,0,89000,186000,-97000,-97000
054058,晶豪科國票98購01,0,0,0,0,0,0,0,0,0,-97000,0,0,0,62000,159000,-97000,-97000
058642,旺宏麥證9A購01  ,0,0,0,212000,309000,-97000,0,0,0,-97000,0,0,0,212000,309000,-97000,-97000
6141,柏承            ,97000,194000,-97000,0,0,0,0,0,0,0,0,0,0,0,0,0,-97000
060472,中租元大9A購02  ,0,0,0,0,0,0,0,0,0,-98000,0,0,0,60000,158000,-98000,-98000
060417,正隆永豐9A購01  ,0,0,0,0,0,0,0,0,0,-98000,0,0,0,131000,229000,-98000,-98000
054862,群光群益97購01  ,0,0,0,0,0,0,0,0,0,-98000,0,0,0,0,98000,-98000,-98000
052903,致茂國票97購01  ,0,0,0,0,0,0,0,0,0,-98000,0,0,0,1000,99000,-98000,-98000
051991,泰碩元大95購02  ,0,0,0,0,0,0,0,0,0,-98000,0,0,0,9000,107000,-98000,-98000
055537,康友群益97購03  ,0,0,0,0,0,0,0,0,0,-98000,0,0,0,0,98000,-98000,-98000
056975,元油2X群益98購03,0,0,0,0,0,0,0,0,0,-98000,0,0,0,0,98000,-98000,-98000
2455,全新            ,378000,423000,-45000,0,0,0,0,0,0,-53000,68000,54000,14000,13000,80000,-67000,-98000
07667P,亞德客元大9A售05,0,0,0,0,0,0,0,0,0,-98000,0,0,0,0,98000,-98000,-98000
07421P,國泰金元大99售01,0,0,0,0,0,0,0,0,0,-98000,0,0,0,21000,119000,-98000,-98000
060443,滬深2X元大9A購03,0,0,0,0,0,0,0,0,0,-99000,0,0,0,0,99000,-99000,-99000
060860,國巨永豐9A購02  ,0,0,0,0,0,0,0,0,0,-99000,0,0,0,200000,299000,-99000,-99000
055225,華邦電國票99購01,0,0,0,0,0,0,0,0,0,-99000,0,0,0,0,99000,-99000,-99000
058263,大成鋼永豐99購01,0,0,0,0,0,0,0,0,0,-99000,0,0,0,0,99000,-99000,-99000
1103,嘉泥            ,34000,133000,-99000,0,0,0,0,0,0,0,0,0,0,0,0,0,-99000
060925,華新科永豐9A購01,0,0,0,0,0,0,0,0,0,-100000,0,0,0,8000,108000,-100000,-100000
061514,泰碩永豐9A購02  ,0,0,0,0,0,0,0,0,0,-100000,0,0,0,0,100000,-100000,-100000
06802P,緯穎群益98售03  ,0,0,0,0,0,0,0,0,0,-100000,0,0,0,0,100000,-100000,-100000
060614,T50反1元大9A購06,0,0,0,0,0,0,0,0,0,-100000,0,0,0,0,100000,-100000,-100000
052941,康控兆豐97購01  ,0,0,0,0,0,0,0,0,0,-100000,0,0,0,0,100000,-100000,-100000
054082,楠梓電元富96購01,0,0,0,0,0,0,0,0,0,-100000,0,0,0,0,100000,-100000,-100000
054223,大立光統一98購04,0,0,0,0,0,0,0,0,0,-100000,0,0,0,0,100000,-100000,-100000
054446,美食兆豐97購01  ,0,0,0,0,0,0,0,0,0,-100000,0,0,0,0,100000,-100000,-100000
057598,鴻海群益98購07  ,0,0,0,0,0,0,0,0,0,-100000,0,0,0,0,100000,-100000,-100000
057906,福懋科中信99購01,0,0,0,0,0,0,0,0,0,-100000,0,0,0,0,100000,-100000,-100000
042792,T50反1台新9C購01,0,0,0,0,0,0,0,0,0,-100000,0,0,0,0,100000,-100000,-100000
051738,全新國票96購02  ,0,0,0,0,0,0,0,0,0,-100000,0,0,0,0,100000,-100000,-100000
050254,大立光富邦96購02,0,0,0,0,0,0,0,0,0,-100000,0,0,0,0,100000,-100000,-100000
053819,大立光群益96購04,0,1000,-1000,0,0,0,0,0,0,-99000,0,0,0,1000,100000,-99000,-100000
058234,華新科元大99購12,0,0,0,0,0,0,0,0,0,-100000,0,0,0,20000,120000,-100000,-100000
058249,緯穎元大99購04  ,0,0,0,0,0,0,0,0,0,-100000,0,0,0,61000,161000,-100000,-100000
056248,康友群益97購04  ,0,0,0,0,0,0,0,0,0,-100000,0,0,0,0,100000,-100000,-100000
058021,牧德凱基98購02  ,0,0,0,0,0,0,0,0,0,-100000,0,0,0,0,100000,-100000,-100000
057323,智邦群益98購01  ,0,0,0,0,0,0,0,0,0,-100000,0,0,0,15000,115000,-100000,-100000
056977,國巨群益9A購01  ,0,0,0,0,0,0,0,0,0,-100000,0,0,0,50000,150000,-100000,-100000
056760,元油2X元大98購06,0,0,0,0,0,0,0,0,0,-100000,0,0,0,0,100000,-100000,-100000
056716,康舒永豐98購01  ,0,0,0,0,0,0,0,0,0,-100000,0,0,0,0,100000,-100000,-100000
056067,智原元大97購01  ,0,0,0,0,0,0,0,0,0,-100000,0,0,0,0,100000,-100000,-100000
058966,元油2X日盛99購03,0,0,0,0,0,0,0,0,0,-100000,0,0,0,0,100000,-100000,-100000
057387,奇力新永豐98購03,0,0,0,0,0,0,0,0,0,-100000,0,0,0,0,100000,-100000,-100000
07753P,台灣50元大9C售34,0,0,0,0,0,0,0,0,0,-100000,0,0,0,0,100000,-100000,-100000
1723,中碳            ,28000,128000,-100000,0,0,0,0,0,0,0,0,0,0,0,0,0,-100000
07379P,大立光元大99售30,0,0,0,0,0,0,0,0,0,-100000,0,0,0,0,100000,-100000,-100000
07456P,華新科元大9A售06,0,0,0,0,0,0,0,0,0,-100000,0,0,0,50000,150000,-100000,-100000
07516P,台積電元大9A售16,0,0,0,0,0,0,0,0,0,-100000,0,0,0,97000,197000,-100000,-100000
07541P,國巨凱基9A售12  ,0,0,0,0,0,0,0,0,0,-100000,0,0,0,0,100000,-100000,-100000
07605P,台灣50元大9B售10,0,0,0,0,0,0,0,0,0,-100000,0,0,0,100000,200000,-100000,-100000
07175P,聯詠凱基99售02  ,0,0,0,0,0,0,0,0,0,-100000,0,0,0,0,100000,-100000,-100000
060322,卜蜂群益9A購01  ,0,0,0,0,0,0,0,0,0,-101000,0,0,0,0,101000,-101000,-101000
06023P,超眾國票96售03  ,0,0,0,0,0,0,0,0,0,-101000,0,0,0,22000,123000,-101000,-101000
060042,台積電群益99購12,0,0,0,0,0,0,0,0,0,-101000,0,0,0,6000,107000,-101000,-101000
059400,滬深2X元富9C購04,0,0,0,0,0,0,0,0,0,-101000,0,0,0,0,101000,-101000,-101000
061411,T50反1群益9A購05,0,0,0,0,0,0,0,0,0,-101000,0,0,0,10000,111000,-101000,-101000
060994,世芯元大9A購03  ,0,0,0,0,0,0,0,0,0,-101000,0,0,0,249000,350000,-101000,-101000
061142,南電統一9A購01  ,45000,0,45000,0,0,0,0,0,0,-146000,0,0,0,138000,284000,-146000,-101000
048983,牧德元大95購01  ,0,0,0,0,0,0,0,0,0,-101000,0,0,0,0,101000,-101000,-101000
054343,世紀鋼元富96購02,0,0,0,0,0,0,0,0,0,-101000,0,0,0,60000,161000,-101000,-101000
058908,貿聯元大99購03  ,0,0,0,0,0,0,0,0,0,-101000,0,0,0,199000,300000,-101000,-101000
056629,昇陽半永豐98購01,0,0,0,0,0,0,0,0,0,-101000,0,0,0,25000,126000,-101000,-101000
056116,義隆群益97購02  ,0,0,0,0,0,0,0,0,0,-101000,0,0,0,16000,117000,-101000,-101000
055731,美律元富97購01  ,0,0,0,0,0,0,0,0,0,-101000,0,0,0,0,101000,-101000,-101000
1437,勤益控          ,6000,107000,-101000,0,0,0,0,0,0,0,0,0,0,0,0,0,-101000
059410,滬深2X國票9A購04,0,0,0,0,0,0,0,0,0,-102000,0,0,0,0,102000,-102000,-102000
059640,聯詠凱基99購04  ,0,0,0,0,0,0,0,0,0,-102000,0,0,0,100000,202000,-102000,-102000
060432,達方永豐9A購01  ,0,0,0,0,0,0,0,0,0,-102000,0,0,0,74000,176000,-102000,-102000
057647,欣興元大98購10  ,0,0,0,0,0,0,0,0,0,-102000,0,0,0,60000,162000,-102000,-102000
053507,百和兆豐96購01  ,0,0,0,0,0,0,0,0,0,-102000,0,0,0,0,102000,-102000,-102000
006205,富邦上証        ,64000,73000,-9000,0,0,0,0,0,0,-93000,0,100000,-100000,1368000,1361000,7000,-102000
057054,立積元大98購03  ,0,0,0,0,0,0,0,0,0,-102000,0,0,0,77000,179000,-102000,-102000
057482,微星元大98購03  ,0,0,0,0,0,0,0,0,0,-102000,0,0,0,11000,113000,-102000,-102000
059179,祥碩元富99購01  ,0,0,0,0,0,0,0,0,0,-102000,0,0,0,357000,459000,-102000,-102000
1532,勤美            ,10000,112000,-102000,0,0,0,0,0,0,0,0,0,0,0,0,0,-102000
07802P,瑞昱永豐9A售03  ,0,0,0,0,0,0,0,0,0,-102000,0,0,0,0,102000,-102000,-102000
056394,晶豪科永豐98購01,0,0,0,0,0,0,0,0,0,-103000,0,0,0,88000,191000,-103000,-103000
056177,嘉澤元富97購01  ,0,0,0,0,0,0,0,0,0,-103000,0,0,0,0,103000,-103000,-103000
053443,智邦凱基97購01  ,0,0,0,0,0,0,0,0,0,-104000,0,0,0,21000,125000,-104000,-104000
058218,緯穎群益99購01  ,0,0,0,0,0,0,0,0,0,-104000,0,0,0,0,104000,-104000,-104000
057401,晶豪科群益99購01,0,0,0,0,0,0,0,0,0,-104000,0,0,0,225000,329000,-104000,-104000
07618P,大立光中信9A售06,0,0,0,0,0,0,0,0,0,-104000,0,0,0,0,104000,-104000,-104000
060474,中租元大9B購01  ,0,0,0,0,0,0,0,0,0,-105000,0,0,0,0,105000,-105000,-105000
053513,義隆群益96購05  ,0,0,0,0,0,0,0,0,0,-105000,0,0,0,4000,109000,-105000,-105000
054027,欣興凱基96購04  ,0,0,0,0,0,0,0,0,0,-105000,0,0,0,0,105000,-105000,-105000
054457,強茂群益96購01  ,0,0,0,0,0,0,0,0,0,-105000,0,0,0,46000,151000,-105000,-105000
03763P,聯發科元富96售01,0,0,0,0,0,0,0,0,0,-105000,0,0,0,0,105000,-105000,-105000
053994,微星群益96購01  ,0,0,0,0,0,0,0,0,0,-105000,0,0,0,52000,157000,-105000,-105000
057366,智邦元大98購08  ,0,0,0,0,0,0,0,0,0,-105000,0,0,0,103000,208000,-105000,-105000
057477,智邦元大98購09  ,0,0,0,0,0,0,0,0,0,-105000,0,0,0,24000,129000,-105000,-105000
057454,上銀國泰99購02  ,0,0,0,0,0,0,0,0,0,-105000,0,0,0,95000,200000,-105000,-105000
059038,健策群益9A購02  ,0,0,0,0,0,0,0,0,0,-105000,0,0,0,0,105000,-105000,-105000
05711P,茂林國票97售03  ,0,0,0,0,0,0,0,0,0,-105000,0,0,0,66000,171000,-105000,-105000
07474P,滬深2X群益9C售03,0,0,0,0,0,0,0,0,0,-105000,0,0,0,0,105000,-105000,-105000
2903,遠百            ,238000,394000,-156000,0,0,0,0,0,0,51000,51000,0,51000,0,0,0,-105000
057960,聯鈞元大98購02  ,0,0,0,0,0,0,0,0,0,-106000,0,0,0,78000,184000,-106000,-106000
4919,新唐            ,132000,223000,-91000,0,0,0,0,0,0,-15000,0,0,0,2000,17000,-15000,-106000
06087P,國巨永豐97售01  ,0,0,0,0,0,0,0,0,0,-107000,0,0,0,0,107000,-107000,-107000
061547,禾伸堂群益9A購01,0,0,0,0,0,0,0,0,0,-107000,0,0,0,13000,120000,-107000,-107000
06611P,祥碩國票98售01  ,0,0,0,0,0,0,0,0,0,-107000,0,0,0,82000,189000,-107000,-107000
058861,國巨凱基9A購08  ,0,0,0,0,0,0,0,0,0,-107000,0,0,0,200000,307000,-107000,-107000
06529P,貿聯富邦99售03  ,0,0,0,0,0,0,0,0,0,-108000,0,0,0,62000,170000,-108000,-108000
060160,聯陽永豐9A購01  ,0,0,0,0,0,0,0,0,0,-108000,0,0,0,16000,124000,-108000,-108000
060259,潤泰全凱基9C購01,0,0,0,0,0,0,0,0,0,-108000,0,0,0,100000,208000,-108000,-108000
059625,國巨凱基99購17  ,0,0,0,0,0,0,0,0,0,-108000,0,0,0,0,108000,-108000,-108000
052847,漢唐統一99購01  ,0,0,0,0,0,0,0,0,0,-108000,0,0,0,0,108000,-108000,-108000
054745,智易凱基97購01  ,0,0,0,0,0,0,0,0,0,-108000,0,0,0,0,108000,-108000,-108000
00710B,FH彭博高收益債  ,0,0,0,0,0,0,0,0,0,-108000,0,0,0,7000,115000,-108000,-108000
057802,卜蜂元大98購01  ,0,0,0,0,0,0,0,0,0,-108000,0,0,0,35000,143000,-108000,-108000
058613,茂林元大99購03  ,0,0,0,0,0,0,0,0,0,-108000,0,0,0,96000,204000,-108000,-108000
2228,劍麟            ,111000,209000,-98000,0,0,0,0,0,0,-10000,0,2000,-2000,0,8000,-8000,-108000
07687P,上銀元大9A售06  ,0,0,0,0,0,0,0,0,0,-108000,0,0,0,0,108000,-108000,-108000
060641,聯鈞永豐9A購01  ,0,0,0,0,0,0,0,0,0,-109000,0,0,0,1000,110000,-109000,-109000
06657P,寶成元大98售01  ,0,0,0,0,0,0,0,0,0,-109000,0,0,0,161000,270000,-109000,-109000
060976,SP黃豆元大9A購03,0,0,0,0,0,0,0,0,0,-109000,0,0,0,0,109000,-109000,-109000
058522,聯茂元大99購07  ,0,0,0,0,0,0,0,0,0,-109000,0,0,0,87000,196000,-109000,-109000
058311,緯穎元大99購05  ,0,0,0,0,0,0,0,0,0,-109000,0,0,0,29000,138000,-109000,-109000
3607,谷崧            ,3000,112000,-109000,0,0,0,0,0,0,0,0,0,0,0,0,0,-109000
06212P,華新科元大97售11,0,0,0,0,0,0,0,0,0,-110000,0,0,0,4000,114000,-110000,-110000
061571,奇力新元大9A購03,0,0,0,0,0,0,0,0,0,-110000,0,0,0,0,110000,-110000,-110000
061497,大立光國票9A購09,0,0,0,0,0,0,0,0,0,-110000,0,0,0,0,110000,-110000,-110000
060231,台積電元大9A購08,0,0,0,0,0,0,0,0,0,-110000,0,0,0,24000,134000,-110000,-110000
060023,T50反1國泰9A購03,75000,0,75000,0,0,0,0,0,0,-185000,0,0,0,0,185000,-185000,-110000
058326,祥碩台新99購01  ,0,0,0,0,0,0,0,0,0,-110000,0,0,0,26000,136000,-110000,-110000
07643P,禾伸堂凱基9A售02,0,0,0,0,0,0,0,0,0,-110000,0,0,0,0,110000,-110000,-110000
07133P,臺股指元大9A售27,0,0,0,0,0,0,0,0,0,-110000,0,0,0,0,110000,-110000,-110000
07312P,台灣50元大99售10,0,0,0,0,0,0,0,0,0,-110000,0,0,0,40000,150000,-110000,-110000
060484,聯發科富邦9C購02,0,0,0,0,0,0,0,0,0,-111000,0,0,0,139000,250000,-111000,-111000
060757,台積電元大9A購18,0,0,0,0,0,0,0,0,0,-111000,0,0,0,0,111000,-111000,-111000
2484,希華            ,155000,266000,-111000,0,0,0,0,0,0,0,0,0,0,0,0,0,-111000
052235,聯發科國票96購02,0,0,0,0,0,0,0,0,0,-112000,0,0,0,110000,222000,-112000,-112000
05708P,奇力新國票97售04,0,0,0,0,0,0,0,0,0,-112000,0,0,0,20000,132000,-112000,-112000
055489,瑞昱元大97購02  ,0,0,0,0,0,0,0,0,0,-112000,0,0,0,0,112000,-112000,-112000
056844,欣興元富98購03  ,0,0,0,0,0,0,0,0,0,-112000,0,0,0,2000,114000,-112000,-112000
4155,訊映            ,56000,168000,-112000,0,0,0,0,0,0,0,0,0,0,0,0,0,-112000
1477,聚陽            ,620000,725198,-105198,0,0,0,0,0,0,-7000,4000,4000,0,11000,18000,-7000,-112198
060796,世芯永豐9A購03  ,0,0,0,0,0,0,0,0,0,-113000,0,0,0,209000,322000,-113000,-113000
060116,世紀鋼元大99購07,0,0,0,0,0,0,0,0,0,-113000,0,0,0,50000,163000,-113000,-113000
052614,聯電國泰97購01  ,0,0,0,0,0,0,0,0,0,-113000,0,0,0,102000,215000,-113000,-113000
059005,嘉晶元大99購06  ,0,0,0,0,0,0,0,0,0,-113000,0,0,0,65000,178000,-113000,-113000
057164,國巨元大98購14  ,0,0,0,0,0,0,0,0,0,-113000,0,0,0,31000,144000,-113000,-113000
07471P,南亞科元大9A售01,0,0,0,0,0,0,0,0,0,-113000,0,0,0,0,113000,-113000,-113000
056961,凱美永豐98購01  ,0,0,0,0,0,0,0,0,0,-114000,0,0,0,46000,160000,-114000,-114000
059944,欣興永豐99購03  ,0,0,0,0,0,0,0,0,0,-115000,0,0,0,169000,284000,-115000,-115000
061241,晶技兆豐9A購01  ,0,0,0,0,0,0,0,0,0,-115000,0,0,0,113000,228000,-115000,-115000
053173,矽格群益97購01  ,0,0,0,0,0,0,0,0,0,-115000,0,0,0,34000,149000,-115000,-115000
056186,智原統一97購01  ,0,0,0,0,0,0,0,0,0,-115000,0,0,0,2000,117000,-115000,-115000
07228P,台灣50群益9B售06,0,0,0,0,0,0,0,0,0,-115000,0,0,0,0,115000,-115000,-115000
07641P,上銀凱基9A售05  ,0,0,0,0,0,0,0,0,0,-115000,0,0,0,30000,145000,-115000,-115000
3005,神基            ,150000,162000,-12000,0,0,0,1000,0,1000,-104000,0,0,0,0,104000,-104000,-115000
061248,健策群益9A購03  ,0,0,0,0,0,0,0,0,0,-116000,0,0,0,23000,139000,-116000,-116000
061293,聯茂統一9A購01  ,0,0,0,0,0,0,0,0,0,-116000,0,0,0,72000,188000,-116000,-116000
06765P,欣興元大98售11  ,0,0,0,0,0,0,0,0,0,-116000,0,0,0,8000,124000,-116000,-116000
04706P,力山元大95售01  ,0,0,0,0,0,0,0,0,0,-116000,0,0,0,57000,173000,-116000,-116000
058261,大立光富邦03購01,0,0,0,0,0,0,0,0,0,-116000,0,0,0,0,116000,-116000,-116000
6209,今國光          ,125000,241000,-116000,0,0,0,0,0,0,0,0,0,0,0,0,0,-116000
07646P,世芯元大9A售04  ,0,0,0,0,0,0,0,0,0,-116000,0,0,0,11000,127000,-116000,-116000
059450,和大永豐99購01  ,0,0,0,0,0,0,0,0,0,-117000,0,0,0,50000,167000,-117000,-117000
052452,茂林元大95購03  ,0,0,0,0,0,0,0,0,0,-117000,0,0,0,0,117000,-117000,-117000
9935,慶豐富          ,167000,284000,-117000,0,0,0,0,0,0,0,0,0,0,0,0,0,-117000
060309,佳世達永豐9A購01,0,0,0,0,0,0,0,0,0,-118000,0,0,0,26000,144000,-118000,-118000
06914P,南茂元大98售03  ,0,0,0,0,0,0,0,0,0,-118000,0,0,0,0,118000,-118000,-118000
053216,京鼎凱基96購02  ,0,0,0,0,0,0,0,0,0,-118000,0,0,0,53000,171000,-118000,-118000
053006,玉晶光永豐96購03,0,0,0,0,0,0,0,0,0,-118000,0,0,0,34000,152000,-118000,-118000
057700,新日興群益9A購01,0,0,0,0,0,0,0,0,0,-118000,0,0,0,226000,344000,-118000,-118000
054540,泰鼎國票99購01  ,0,0,0,0,0,0,0,0,0,-119000,0,0,0,2000,121000,-119000,-119000
058905,京鼎元大99購01  ,0,0,0,0,0,0,0,0,0,-119000,0,0,0,20000,139000,-119000,-119000
1736,喬山            ,394000,589000,-195000,0,0,0,0,0,0,76000,0,5000,-5000,142000,61000,81000,-119000
061536,華擎統一9C購02  ,0,0,0,0,0,0,0,0,0,-120000,0,0,0,0,120000,-120000,-120000
06371P,茂林國票98售04  ,0,0,0,0,0,0,0,0,0,-120000,0,0,0,6000,126000,-120000,-120000
061026,南電富邦9B購01  ,0,0,0,0,0,0,0,0,0,-120000,0,0,0,351000,471000,-120000,-120000
054682,東元永豐97購01  ,0,0,0,0,0,0,0,0,0,-120000,0,0,0,0,120000,-120000,-120000
03435B,臺股指凱基99熊29,0,0,0,0,0,0,0,0,0,-120000,0,0,0,121000,241000,-120000,-120000
044784,華邦電中信96購01,0,0,0,0,0,0,0,0,0,-120000,0,0,0,0,120000,-120000,-120000
1589,永冠-KY         ,83000,206000,-123000,0,0,0,0,0,0,3000,24000,21000,3000,0,0,0,-120000
06674P,祥碩群益98售02  ,0,0,0,0,0,0,0,0,0,-121000,0,0,0,28000,149000,-121000,-121000
06010P,國泰金元富96售01,0,0,0,0,0,0,0,0,0,-121000,0,0,0,0,121000,-121000,-121000
060572,景碩永豐9A購01  ,0,0,0,0,0,0,0,0,0,-121000,0,0,0,0,121000,-121000,-121000
059997,華航元富99購01  ,0,0,0,0,0,0,0,0,0,-121000,0,0,0,5000,126000,-121000,-121000
054947,興勤元大97購01  ,0,0,0,0,0,0,0,0,0,-121000,0,0,0,600000,721000,-121000,-121000
058972,新日興永豐9A購01,0,0,0,0,0,0,0,0,0,-121000,0,0,0,55000,176000,-121000,-121000
057329,緯穎群益98購02  ,0,0,0,0,0,0,0,0,0,-121000,0,0,0,5000,126000,-121000,-121000
055958,台光電元大97購02,0,0,0,0,0,0,0,0,0,-121000,0,0,0,0,121000,-121000,-121000
055348,旺宏凱基97購01  ,0,0,0,0,0,0,0,0,0,-121000,0,0,0,4000,125000,-121000,-121000
07558P,玉晶光元大9A售10,0,0,0,0,0,0,0,0,0,-121000,0,0,0,5000,126000,-121000,-121000
060393,泰鼎群益9A購01  ,0,0,0,0,0,0,0,0,0,-122000,0,0,0,1000,123000,-122000,-122000
052491,泰碩國票99購01  ,0,0,0,0,0,0,0,0,0,-122000,0,0,0,150000,272000,-122000,-122000
060227,和大元大9A購01  ,0,0,0,0,0,0,0,0,0,-123000,0,0,0,82000,205000,-123000,-123000
061509,SP黃豆富邦9C購01,0,0,0,0,0,0,0,0,0,-123000,0,0,0,0,123000,-123000,-123000
07800P,華新科國泰9B售04,0,0,0,0,0,0,0,0,0,-123000,0,0,0,2000,125000,-123000,-123000
060917,台表科國泰9B購01,0,0,0,0,0,0,0,0,0,-124000,0,0,0,89000,213000,-124000,-124000
060804,T50反1群益9A購02,0,0,0,0,0,0,0,0,0,-124000,0,0,0,6000,130000,-124000,-124000
058137,玉晶光元大99購11,0,0,0,0,0,0,0,0,0,-124000,0,0,0,6000,130000,-124000,-124000
056996,矽力日盛99購01  ,0,0,0,0,0,0,0,0,0,-124000,0,0,0,21000,145000,-124000,-124000
07162P,臺股指群益99售13,0,0,0,0,0,0,0,0,0,-124000,0,0,0,162000,286000,-124000,-124000
2547,日勝生          ,187480,312000,-124520,0,0,0,0,0,0,0,0,0,0,0,0,0,-124520
060851,國巨國泰9C購01  ,0,0,0,0,0,0,0,0,0,-125000,0,0,0,1630000,1755000,-125000,-125000
058439,玉晶光統一01購02,0,0,0,0,0,0,0,0,0,-125000,0,0,0,5000,130000,-125000,-125000
06081P,深中小元大97售02,0,0,0,0,0,0,0,0,0,-126000,0,0,0,0,126000,-126000,-126000
060965,中租凱基9B購01  ,0,0,0,0,0,0,0,0,0,-126000,0,0,0,154000,280000,-126000,-126000
059771,台積電群益99購11,0,0,0,0,0,0,0,0,0,-126000,0,0,0,43000,169000,-126000,-126000
059650,緯穎凱基99購04  ,0,0,0,0,0,0,0,0,0,-126000,0,0,0,214000,340000,-126000,-126000
057483,微星元大98購04  ,0,0,0,0,0,0,0,0,0,-126000,0,0,0,143000,269000,-126000,-126000
061412,儒鴻群益9A購01  ,0,0,0,0,0,0,0,0,0,-127000,0,0,0,89000,216000,-127000,-127000
07081P,南電群益9A售01  ,0,0,0,0,0,0,0,0,0,-127000,0,0,0,28000,155000,-127000,-127000
051078,力山富邦97購01  ,0,0,0,0,0,0,0,0,0,-127000,0,0,0,46000,173000,-127000,-127000
057885,台光電群益98購04,0,0,0,0,0,0,0,0,0,-127000,0,0,0,93000,220000,-127000,-127000
05545P,台表科國泰98售01,0,0,0,0,0,0,0,0,0,-127000,0,0,0,40000,167000,-127000,-127000
057251,泰鼎統一98購02  ,0,0,0,0,0,0,0,0,0,-127000,0,0,0,37000,164000,-127000,-127000
058774,台郡兆豐9A購01  ,0,0,0,0,0,0,0,0,0,-127000,0,0,0,3000,130000,-127000,-127000
07407P,欣興凱基99售07  ,0,0,0,0,0,0,0,0,0,-127000,0,0,0,12000,139000,-127000,-127000
061181,牧德凱基9A購01  ,0,0,0,0,0,0,0,0,0,-128000,0,0,0,103000,231000,-128000,-128000
060092,瑞昱元大99購03  ,0,0,0,0,0,0,0,0,0,-128000,0,0,0,99000,227000,-128000,-128000
058025,聯茂國泰99購01  ,0,0,0,0,0,0,0,0,0,-128000,0,0,0,143000,271000,-128000,-128000
059016,晶相光元富99購03,0,0,0,0,0,0,0,0,0,-128000,0,0,0,27000,155000,-128000,-128000
5522,遠雄            ,137000,265000,-128000,0,0,0,0,0,0,0,0,0,0,0,0,0,-128000
060127,牧德永豐99購02  ,0,0,0,0,0,0,0,0,0,-129000,0,0,0,82000,211000,-129000,-129000
060707,台郡富邦9A購01  ,0,0,0,0,0,0,0,0,0,-129000,0,0,0,542000,671000,-129000,-129000
057532,智原元大98購03  ,0,0,0,0,0,0,0,0,0,-129000,0,0,0,91000,220000,-129000,-129000
07683P,宏達電凱基9A售03,0,0,0,0,0,0,0,0,0,-129000,0,0,0,10000,139000,-129000,-129000
00672L,元大S&P原油正2  ,0,0,0,0,0,0,0,0,0,-130000,0,0,0,300000,430000,-130000,-130000
056838,旺宏元富98購01  ,0,0,0,0,0,0,0,0,0,-130000,0,0,0,0,130000,-130000,-130000
058422,百和麥證99購01  ,0,0,0,20000,150000,-130000,0,0,0,-130000,0,0,0,20000,150000,-130000,-130000
058722,台郡元富99購01  ,0,0,0,0,0,0,0,0,0,-130000,0,0,0,255000,385000,-130000,-130000
04006P,滬深2X國票9B售01,0,0,0,0,0,0,0,0,0,-131000,0,0,0,0,131000,-131000,-131000
052822,泰碩永豐97購01  ,0,0,0,0,0,0,0,0,0,-131000,0,0,0,40000,171000,-131000,-131000
05500P,臺股指中信96售04,0,0,0,0,0,0,0,0,0,-131000,0,0,0,70000,201000,-131000,-131000
054065,樺漢國票97購01  ,0,0,0,0,0,0,0,0,0,-131000,0,0,0,12000,143000,-131000,-131000
060291,高鐵元大9A購01  ,0,0,0,0,0,0,0,0,0,-132000,0,0,0,96000,228000,-132000,-132000
061216,世芯元大9A購06  ,0,0,0,0,0,0,0,0,0,-132000,0,0,0,281000,413000,-132000,-132000
053171,中磊群益96購01  ,0,0,0,0,0,0,0,0,0,-132000,0,0,0,118000,250000,-132000,-132000
055183,聯鈞統一97購01  ,0,0,0,0,0,0,0,0,0,-132000,0,0,0,168000,300000,-132000,-132000
5388,中磊            ,125000,208000,-83000,0,0,0,1000,0,1000,-50000,6000,0,6000,22000,78000,-56000,-132000
07635P,世芯永豐9A售05  ,0,0,0,0,0,0,0,0,0,-133000,0,0,0,10000,143000,-133000,-133000
059922,大立光元大99購25,0,0,0,0,0,0,0,0,0,-134000,0,0,0,146000,280000,-134000,-134000
05521P,創意永豐96售01  ,0,0,0,0,0,0,0,0,0,-135000,0,0,0,0,135000,-135000,-135000
056271,嘉澤統一97購01  ,0,0,0,0,0,0,0,0,0,-135000,0,0,0,0,135000,-135000,-135000
058168,國巨凱基9A購04  ,0,0,0,0,0,0,0,0,0,-135000,0,0,0,200000,335000,-135000,-135000
058970,鴻海永豐99購02  ,0,0,0,0,0,0,0,0,0,-135000,0,0,0,385000,520000,-135000,-135000
07552P,技嘉元大9A售03  ,0,0,0,0,0,0,0,0,0,-135000,0,0,0,6000,141000,-135000,-135000
051907,台積電元大97購05,0,0,0,0,0,0,0,0,0,-136000,0,0,0,10000,146000,-136000,-136000
053752,超眾永豐96購02  ,0,0,0,0,0,0,0,0,0,-136000,0,0,0,35000,171000,-136000,-136000
059064,緯穎凱基99購02  ,0,0,0,0,0,0,0,0,0,-136000,0,0,0,10000,146000,-136000,-136000
059061,晶技凱基9A購01  ,0,0,0,0,0,0,0,0,0,-136000,0,0,0,184000,320000,-136000,-136000
056077,矽力元大97購07  ,0,0,0,0,0,0,0,0,0,-136000,0,0,0,0,136000,-136000,-136000
055597,禾伸堂元大98購02,0,0,0,0,0,0,0,0,0,-136000,0,0,0,32000,168000,-136000,-136000
1734,杏輝            ,42000,178000,-136000,0,0,0,0,0,0,0,0,0,0,0,0,0,-136000
060612,世紀鋼凱基9A購01,0,0,0,0,0,0,0,0,0,-137000,0,0,0,12000,149000,-137000,-137000
058920,SGBR2X元富99購06,0,0,0,0,0,0,0,0,0,-137000,0,0,0,15000,152000,-137000,-137000
061414,牧德群益9B購02  ,0,0,0,0,0,0,0,0,0,-138000,0,0,0,2000,140000,-138000,-138000
050337,南電國泰95購01  ,0,0,0,0,0,0,0,0,0,-138000,0,0,0,3000,141000,-138000,-138000
04462P,全新元富96售01  ,0,0,0,0,0,0,0,0,0,-138000,0,0,0,31000,169000,-138000,-138000
052700,奇鋐國票97購02  ,0,0,0,0,0,0,0,0,0,-138000,0,0,0,339000,477000,-138000,-138000
05644P,大立光中信9A售03,0,0,0,0,0,0,0,0,0,-138000,0,0,0,43000,181000,-138000,-138000
055670,矽創群益98購02  ,0,0,0,0,0,0,0,0,0,-138000,0,0,0,65000,203000,-138000,-138000
060246,晶相光元大9C購03,0,0,0,0,0,0,0,0,0,-139000,0,0,0,176000,315000,-139000,-139000
052246,超眾康和95購01  ,0,0,0,0,0,0,0,0,0,-139000,0,0,0,1000,140000,-139000,-139000
006207,FH滬深          ,0,403000,-403000,0,0,0,0,0,0,264000,1000,31000,-30000,595000,301000,294000,-139000
060211,智邦康和9A購01  ,0,0,0,0,0,0,0,0,0,-140000,0,0,0,11000,151000,-140000,-140000
061346,玉晶光元大9B購03,0,0,0,0,0,0,0,0,0,-140000,0,0,0,70000,210000,-140000,-140000
052697,滬深2X國票98購01,0,0,0,0,0,0,0,0,0,-140000,0,0,0,0,140000,-140000,-140000
056714,晶相光永豐98購02,0,27000,-27000,0,0,0,0,0,0,-113000,0,0,0,93000,206000,-113000,-140000
4306,炎洲            ,49000,185000,-136000,0,0,0,0,0,0,-4000,4000,8000,-4000,0,0,0,-140000
060674,瑞昱元大9A購03  ,0,0,0,0,0,0,0,0,0,-141000,0,0,0,135000,276000,-141000,-141000
054229,超眾元富96購05  ,0,0,0,0,0,0,0,0,0,-141000,0,0,0,22000,163000,-141000,-141000
059072,元油2X元大9C購13,0,0,0,0,0,0,0,0,0,-141000,0,0,0,290000,431000,-141000,-141000
1457,宜進            ,8000,149000,-141000,0,0,0,0,0,0,0,0,0,0,0,0,0,-141000
059539,緯穎凱基99購03  ,0,0,0,0,0,0,0,0,0,-142000,0,0,0,100000,242000,-142000,-142000
061278,和大統一9A購01  ,0,0,0,0,0,0,0,0,0,-142000,0,0,0,75000,217000,-142000,-142000
047194,世紀鋼元大96購01,0,0,0,0,0,0,0,0,0,-142000,0,0,0,13000,155000,-142000,-142000
057161,亞德客元大98購02,0,0,0,0,0,0,0,0,0,-142000,0,0,0,74000,216000,-142000,-142000
060763,聯鈞元大9A購03  ,0,0,0,0,0,0,0,0,0,-143000,0,0,0,37000,180000,-143000,-143000
053187,國巨統一96購05  ,0,0,0,0,0,0,0,0,0,-143000,0,0,0,1286000,1429000,-143000,-143000
058178,國巨國泰9A購02  ,0,0,0,0,0,0,0,0,0,-143000,0,0,0,214000,357000,-143000,-143000
060991,京鼎元大9A購01  ,0,0,0,0,0,0,0,0,0,-144000,0,0,0,276000,420000,-144000,-144000
061360,智邦兆豐9B購02  ,0,0,0,0,0,0,0,0,0,-144000,0,0,0,78000,222000,-144000,-144000
061187,瀚宇博國泰9C購01,0,0,0,0,0,0,0,0,0,-144000,0,0,0,31000,175000,-144000,-144000
06801P,技嘉群益99售02  ,0,0,0,0,0,0,0,0,0,-144000,0,0,0,0,144000,-144000,-144000
051809,義隆凱基96購01  ,0,0,0,0,0,0,0,0,0,-144000,0,0,0,8000,152000,-144000,-144000
056559,華通群益98購02  ,0,0,0,0,0,0,0,0,0,-144000,0,0,0,103000,247000,-144000,-144000
061262,智邦凱基9A購02  ,0,0,0,0,0,0,0,0,0,-145000,0,0,0,24000,169000,-145000,-145000
060196,泰鼎元富9A購01  ,0,0,0,0,0,0,0,0,0,-145000,0,0,0,31000,176000,-145000,-145000
058322,玉晶光永豐99購02,0,0,0,0,0,0,0,0,0,-146000,0,0,0,47000,193000,-146000,-146000
6230,超眾            ,271046,506000,-234954,0,0,0,60000,100000,-40000,128000,86000,0,86000,58000,16000,42000,-146954
060113,祥碩元大9B購01  ,0,0,0,0,0,0,0,0,0,-147000,0,0,0,395000,542000,-147000,-147000
056237,智邦群益97購02  ,0,0,0,0,0,0,0,0,0,-147000,0,0,0,71000,218000,-147000,-147000
056380,麗豐元富98購01  ,0,0,0,0,0,0,0,0,0,-147000,0,0,0,56000,203000,-147000,-147000
06893P,致新元富98售02  ,0,0,0,0,0,0,0,0,0,-148000,0,0,0,19000,167000,-148000,-148000
052795,健策兆豐97購01  ,0,0,0,0,0,0,0,0,0,-148000,0,0,0,295000,443000,-148000,-148000
059455,玉晶光永豐99購05,0,0,0,0,0,0,0,0,0,-149000,0,0,0,84000,233000,-149000,-149000
057084,立積統一9B購01  ,0,0,0,0,0,0,0,0,0,-149000,0,0,0,30000,179000,-149000,-149000
058691,友訊國票9A購01  ,0,0,0,0,0,0,0,0,0,-149000,0,0,0,0,149000,-149000,-149000
2206,三陽工業        ,86000,235000,-149000,0,0,0,0,0,0,0,0,0,0,0,0,0,-149000
061569,旺宏元大9A購14  ,0,0,0,0,0,0,0,0,0,-150000,0,0,0,0,150000,-150000,-150000
061301,華新科永豐9A購03,0,0,0,0,0,0,0,0,0,-150000,0,0,0,16000,166000,-150000,-150000
061242,玉晶光兆豐9B購02,0,0,0,0,0,0,0,0,0,-150000,0,0,0,0,150000,-150000,-150000
047690,美律富邦97購01  ,0,0,0,0,0,0,0,0,0,-150000,0,0,0,300000,450000,-150000,-150000
050719,世紀鋼群益96購01,0,0,0,0,0,0,0,0,0,-150000,0,0,0,0,150000,-150000,-150000
053759,晶相光國泰98購01,0,50000,-50000,0,0,0,0,0,0,-100000,0,0,0,50000,150000,-100000,-150000
052604,建準元大97購01  ,0,0,0,0,0,0,0,0,0,-150000,0,0,0,130000,280000,-150000,-150000
055397,超眾統一97購02  ,0,0,0,0,0,0,0,0,0,-150000,0,0,0,100000,250000,-150000,-150000
4934,太極            ,617000,767000,-150000,0,0,0,0,0,0,0,0,0,0,0,0,0,-150000
061431,鈺齊元大9A購01  ,0,0,0,0,0,0,0,0,0,-151000,0,0,0,169000,320000,-151000,-151000
06622P,牧德元大98售01  ,0,0,0,0,0,0,0,0,0,-151000,0,0,0,67000,218000,-151000,-151000
057508,康控國票99購03  ,0,0,0,0,0,0,0,0,0,-151000,0,0,0,0,151000,-151000,-151000
06839P,玉晶光統一9A售05,0,0,0,0,0,0,0,0,0,-152000,0,0,0,26000,178000,-152000,-152000
046937,聯電元大99購01  ,0,0,0,0,0,0,0,0,0,-152000,0,0,0,253000,405000,-152000,-152000
057964,緯穎元大99購03  ,0,0,0,0,0,0,0,0,0,-152000,0,0,0,20000,172000,-152000,-152000
058759,義隆群益99購01  ,0,0,0,0,0,0,0,0,0,-152000,0,0,0,18000,170000,-152000,-152000
050894,旺宏元大96購03  ,0,0,0,0,0,0,0,0,0,-153000,0,0,0,5000,158000,-153000,-153000
056091,百和統一97購01  ,0,0,0,0,0,0,0,0,0,-153000,0,0,0,191000,344000,-153000,-153000
056327,樺漢兆豐98購01  ,0,0,0,0,0,0,0,0,0,-154000,0,0,0,0,154000,-154000,-154000
057191,祥碩元大98購05  ,0,0,0,0,0,0,0,0,0,-154000,0,0,0,96000,250000,-154000,-154000
07482P,南亞科元富9A售04,0,0,0,0,0,0,0,0,0,-154000,0,0,0,0,154000,-154000,-154000
057705,臺股指群益98購05,0,0,0,0,0,0,0,0,0,-155000,0,0,0,0,155000,-155000,-155000
056883,美食康和98購01  ,0,0,0,0,0,0,0,0,0,-155000,0,0,0,0,155000,-155000,-155000
2915,潤泰全          ,1019256,1178000,-158744,0,0,0,0,0,0,3000,36000,2000,34000,47000,78000,-31000,-155744
061479,泰碩元大9A購02  ,0,0,0,0,0,0,0,0,0,-156000,0,0,0,2000,158000,-156000,-156000
052200,台光電統一95購02,0,0,0,0,0,0,0,0,0,-156000,0,0,0,0,156000,-156000,-156000
058836,FBVIX中信03購05 ,0,0,0,0,0,0,0,0,0,-156000,0,0,0,27000,183000,-156000,-156000
06137P,玉晶光永豐97售04,0,0,0,0,0,0,0,0,0,-157000,0,0,0,147000,304000,-157000,-157000
061027,儒鴻永豐9A購02  ,0,0,0,0,0,0,0,0,0,-157000,0,0,0,404000,561000,-157000,-157000
058686,祥碩凱基99購03  ,0,0,0,0,0,0,0,0,0,-157000,0,0,0,409000,566000,-157000,-157000
3703,欣陸            ,74000,231000,-157000,0,0,0,0,0,0,0,0,0,0,0,0,0,-157000
5203,訊連            ,181000,316179,-135179,0,0,0,0,0,0,-22000,10000,20000,-10000,15000,27000,-12000,-157179
060599,國巨凱基9C購01  ,0,0,0,0,0,0,0,0,0,-158000,0,0,0,228000,386000,-158000,-158000
060556,緯穎凱基9A購04  ,0,0,0,0,0,0,0,0,0,-158000,0,0,0,110000,268000,-158000,-158000
05011P,南電國泰96售01  ,0,0,0,0,0,0,0,0,0,-158000,0,0,0,107000,265000,-158000,-158000
053950,緯穎富邦97購02  ,0,0,0,0,0,0,0,0,0,-158000,0,0,0,22000,180000,-158000,-158000
057739,新日興富邦9B購01,0,0,0,0,0,0,0,0,0,-158000,0,0,0,171000,329000,-158000,-158000
053619,和碩群益96購01  ,0,0,0,0,0,0,0,0,0,-158000,0,0,0,0,158000,-158000,-158000
058308,全新元大9B購01  ,0,0,0,0,0,0,0,0,0,-158000,0,0,0,45000,203000,-158000,-158000
059200,京鼎永豐99購02  ,0,0,0,0,0,0,0,0,0,-158000,0,0,0,284000,442000,-158000,-158000
059346,新日興凱基99購03,0,0,0,0,0,0,0,0,0,-159000,0,0,0,0,159000,-159000,-159000
061480,泰碩元大9B購01  ,0,0,0,0,0,0,0,0,0,-159000,0,0,0,19000,178000,-159000,-159000
054545,奇力新中信98購01,0,0,0,0,0,0,0,0,0,-160000,0,0,0,0,160000,-160000,-160000
056999,元油2X國票98購02,0,0,0,0,0,0,0,0,0,-160000,0,0,0,0,160000,-160000,-160000
07595P,台灣50中信03售07,0,0,0,0,0,0,0,0,0,-160000,0,0,0,0,160000,-160000,-160000
058203,信邦凱基99購01  ,0,0,0,0,0,0,0,0,0,-161000,0,0,0,62000,223000,-161000,-161000
058194,勤誠永豐99購01  ,0,0,0,0,0,0,0,0,0,-161000,0,0,0,194000,355000,-161000,-161000
6541,泰福-KY         ,35000,196000,-161000,0,0,0,0,0,0,0,0,0,0,0,0,0,-161000
061489,高鐵兆豐9A購01  ,0,0,0,0,0,0,0,0,0,-162000,0,0,0,0,162000,-162000,-162000
060688,世紀鋼元大9C購01,0,0,0,0,0,0,0,0,0,-162000,0,0,0,3000,165000,-162000,-162000
056265,國泰金統一97購01,0,0,0,0,0,0,0,0,0,-162000,0,0,0,7000,169000,-162000,-162000
3563,牧德            ,58000,290000,-232000,0,0,0,20000,0,20000,50000,45000,3000,42000,19000,11000,8000,-162000
060855,華新科富邦01購01,0,0,0,0,0,0,0,0,0,-163000,0,0,0,87000,250000,-163000,-163000
054467,隆達凱基97購01  ,0,0,0,0,0,0,0,0,0,-163000,0,0,0,84000,247000,-163000,-163000
055862,矽力元大97購04  ,0,0,0,0,0,0,0,0,0,-164000,0,0,0,0,164000,-164000,-164000
3044,健鼎            ,585000,447490,137510,0,0,0,0,326000,-326000,24000,37000,4000,33000,0,9000,-9000,-164490
059359,精元永豐99購01  ,0,0,0,0,0,0,0,0,0,-165000,0,0,0,106000,271000,-165000,-165000
058850,華新科群益99購03,0,0,0,0,0,0,0,0,0,-165000,0,0,0,5000,170000,-165000,-165000
061178,晶技凱基9B購01  ,0,0,0,0,0,0,0,0,0,-166000,0,0,0,36000,202000,-166000,-166000
061549,泰碩群益9A購01  ,0,0,0,0,0,0,0,0,0,-166000,0,0,0,0,166000,-166000,-166000
060918,康友國泰9C購01  ,0,0,0,0,0,0,0,0,0,-167000,0,0,0,399000,566000,-167000,-167000
059918,華新科元大99購20,0,0,0,0,0,0,0,0,0,-167000,0,0,0,17000,184000,-167000,-167000
059819,台積電凱基99購17,0,0,0,0,0,0,0,0,0,-167000,0,0,0,30000,197000,-167000,-167000
060410,台苯永豐9A購01  ,0,0,0,0,0,0,0,0,0,-167000,0,0,0,63000,230000,-167000,-167000
059030,奇力新兆豐99購03,0,0,0,0,0,0,0,0,0,-167000,0,0,0,431000,598000,-167000,-167000
4551,智伸科          ,78000,183000,-105000,0,0,0,28000,0,28000,-90000,22000,101000,-79000,0,11000,-11000,-167000
8464,億豐            ,820000,980052,-160052,0,0,0,0,0,0,-7000,4000,5000,-1000,2000,8000,-6000,-167052
060539,道瓊反凱基9A購01,0,0,0,0,0,0,0,0,0,-168000,0,0,0,424000,592000,-168000,-168000
057828,緯穎元大99購02  ,0,0,0,0,0,0,0,0,0,-168000,0,0,0,25000,193000,-168000,-168000
05375P,健策國票96售02  ,0,0,0,0,0,0,0,0,0,-168000,0,0,0,0,168000,-168000,-168000
058156,超眾統一9A購02  ,0,0,0,0,0,0,0,0,0,-168000,0,0,0,78000,246000,-168000,-168000
07354P,臺股指國票99售22,0,0,0,0,0,0,0,0,0,-168000,0,0,0,32000,200000,-168000,-168000
060242,潤泰全元大9C購01,0,0,0,0,0,0,0,0,0,-169000,0,0,0,68000,237000,-169000,-169000
059183,T50反1台新03購02,0,0,0,0,0,0,0,0,0,-169000,0,0,0,0,169000,-169000,-169000
059923,緯穎元大99購09  ,0,0,0,0,0,0,0,0,0,-170000,0,0,0,40000,210000,-170000,-170000
056494,緯創國泰99購01  ,0,0,0,0,0,0,0,0,0,-170000,0,0,0,0,170000,-170000,-170000
057055,立積元大99購01  ,0,0,0,0,0,0,0,0,0,-170000,0,0,0,71000,241000,-170000,-170000
055611,燿華國票98購02  ,0,0,0,0,0,0,0,0,0,-170000,0,0,0,0,170000,-170000,-170000
061113,南電元大9A購03  ,0,0,0,0,0,0,0,0,0,-171000,0,0,0,40000,211000,-171000,-171000
057904,矽力永豐98購01  ,0,0,0,0,0,0,0,0,0,-171000,0,0,0,112000,283000,-171000,-171000
3031,佰鴻            ,5000,176000,-171000,0,0,0,0,0,0,0,0,0,0,0,0,0,-171000
060385,台勝科凱基9A購01,0,0,0,0,0,0,0,0,0,-172000,0,0,0,131000,303000,-172000,-172000
060423,智易永豐9A購01  ,0,0,0,0,0,0,0,0,0,-172000,0,0,0,0,172000,-172000,-172000
057721,華擎元富98購02  ,0,0,0,0,0,0,0,0,0,-172000,0,0,0,159000,331000,-172000,-172000
053410,啟碁兆豐96購01  ,0,0,0,0,0,0,0,0,0,-172000,0,0,0,53000,225000,-172000,-172000
056979,微星群益98購01  ,0,0,0,0,0,0,0,0,0,-172000,0,0,0,70000,242000,-172000,-172000
07148P,富邦金元大99售01,0,0,0,0,0,0,0,0,0,-172000,0,0,0,45000,217000,-172000,-172000
5876,上海商銀        ,1891958,1870676,21282,0,0,0,4000,0,4000,-198000,0,200000,-200000,2000,0,2000,-172718
1718,中纖            ,260121,433000,-172879,0,0,0,0,0,0,0,0,0,0,0,0,0,-172879
060704,台積電富邦01購01,0,0,0,0,0,0,0,0,0,-173000,0,0,0,72000,245000,-173000,-173000
053638,信邦永豐96購01  ,0,0,0,0,0,0,0,0,0,-173000,0,0,0,233000,406000,-173000,-173000
057958,禾伸堂元大99購05,0,0,0,0,0,0,0,0,0,-173000,0,0,0,131000,304000,-173000,-173000
052004,泰碩國泰97購03  ,0,0,0,0,0,0,0,0,0,-173000,0,0,0,458000,631000,-173000,-173000
056731,國巨凱基98購04  ,0,0,0,0,0,0,0,0,0,-173000,0,0,0,200000,373000,-173000,-173000
058270,上緯控永豐99購01,0,0,0,0,0,0,0,0,0,-173000,0,0,0,0,173000,-173000,-173000
059816,聯電凱基99購03  ,0,0,0,0,0,0,0,0,0,-174000,0,0,0,234000,408000,-174000,-174000
055091,微星群益97購01  ,0,0,0,0,0,0,0,0,0,-174000,0,0,0,98000,272000,-174000,-174000
056495,泰鼎國泰99購01  ,0,0,0,0,0,0,0,0,0,-175000,0,0,0,11000,186000,-175000,-175000
054134,強茂元大96購01  ,0,0,0,0,0,0,0,0,0,-176000,0,0,0,123000,299000,-176000,-176000
056672,元油2X元富98購10,0,0,0,0,0,0,0,0,0,-176000,0,0,0,0,176000,-176000,-176000
4426,利勤            ,58000,220000,-162000,0,0,0,0,0,0,-14000,0,0,0,0,14000,-14000,-176000
060421,華擎永豐9A購01  ,0,0,0,0,0,0,0,0,0,-177000,0,0,0,0,177000,-177000,-177000
051346,仁寶元大95購01  ,0,0,0,0,0,0,0,0,0,-177000,0,0,0,100000,277000,-177000,-177000
2478,大毅            ,1341000,1376000,-35000,0,0,0,0,50000,-50000,-92000,57000,112000,-55000,23000,60000,-37000,-177000
056449,義隆凱基98購03  ,0,0,0,0,0,0,0,0,0,-179000,0,0,0,22000,201000,-179000,-179000
057808,旺宏元大99購05  ,0,0,0,0,0,0,0,0,0,-179000,0,0,0,10000,189000,-179000,-179000
058568,宏達電凱基9A購02,0,0,0,0,0,0,0,0,0,-179000,0,0,0,31000,210000,-179000,-179000
2405,浩鑫            ,65000,244000,-179000,0,0,0,0,0,0,0,0,0,0,0,0,0,-179000
060245,聯陽元大9C購01  ,0,0,0,0,0,0,0,0,0,-180000,0,0,0,20000,200000,-180000,-180000
059866,國巨凱基99購18  ,0,0,0,0,0,0,0,0,0,-180000,0,0,0,100000,280000,-180000,-180000
061145,臻鼎中信9A購02  ,0,0,0,0,0,0,0,0,0,-180000,0,0,0,20000,200000,-180000,-180000
061392,泰鼎群益9A購02  ,0,0,0,0,0,0,0,0,0,-180000,0,0,0,102000,282000,-180000,-180000
060733,和大統一9C購01  ,0,0,0,0,0,0,0,0,0,-180000,0,0,0,54000,234000,-180000,-180000
050400,臻鼎中信97購01  ,0,0,0,0,0,0,0,0,0,-180000,0,0,0,0,180000,-180000,-180000
058095,昇陽半元大98購03,0,0,0,0,0,0,0,0,0,-180000,0,0,0,170000,350000,-180000,-180000
060795,世芯永豐9A購02  ,0,0,0,0,0,0,0,0,0,-181000,0,0,0,224000,405000,-181000,-181000
053080,力山元大96購02  ,0,0,0,0,0,0,0,0,0,-181000,0,0,0,10000,191000,-181000,-181000
2485,兆赫            ,342000,499000,-157000,0,0,0,0,0,0,-24000,16000,40000,-24000,4000,4000,0,-181000
07669P,華新科元大9A售14,0,0,0,0,0,0,0,0,0,-181000,0,0,0,0,181000,-181000,-181000
07644P,南電凱基9A售03  ,0,0,0,0,0,0,0,0,0,-182000,0,0,0,17000,199000,-182000,-182000
060158,廣達永豐9A購01  ,0,0,0,0,0,0,0,0,0,-183000,0,0,0,24000,207000,-183000,-183000
054164,強茂凱基98購01  ,0,0,0,0,0,0,0,0,0,-183000,0,0,0,130000,313000,-183000,-183000
056939,康控元富98購01  ,0,0,0,0,0,0,0,0,0,-183000,0,0,0,477000,660000,-183000,-183000
060567,華擎富邦9C購01  ,0,0,0,0,0,0,0,0,0,-185000,0,0,0,0,185000,-185000,-185000
061418,世紀鋼群益9A購02,0,0,0,0,0,0,0,0,0,-185000,0,0,0,0,185000,-185000,-185000
054799,超眾群益98購01  ,0,0,0,0,0,0,0,0,0,-185000,0,0,0,6000,191000,-185000,-185000
056266,開發金統一9A購01,0,0,0,0,0,0,0,0,0,-185000,0,0,0,422000,607000,-185000,-185000
061470,鈺齊群益9A購02  ,0,0,0,0,0,0,0,0,0,-186000,0,0,0,0,186000,-186000,-186000
055805,矽力永豐97購01  ,0,0,0,0,0,0,0,0,0,-186000,0,0,0,14000,200000,-186000,-186000
4133,亞諾法          ,174000,360000,-186000,0,0,0,0,0,0,0,0,0,0,0,0,0,-186000
061218,臺股指元大9A購55,0,0,0,0,0,0,0,0,0,-187000,0,0,0,0,187000,-187000,-187000
056819,奇力新永豐98購01,0,0,0,0,0,0,0,0,0,-187000,0,0,0,30000,217000,-187000,-187000
061358,世紀鋼元大9A購04,0,0,0,0,0,0,0,0,0,-188000,0,0,0,98000,286000,-188000,-188000
060705,台光電富邦9B購01,0,0,0,0,0,0,0,0,0,-188000,0,0,0,27000,215000,-188000,-188000
052180,緯穎元大96購05  ,0,0,0,0,0,0,0,0,0,-188000,0,0,0,68000,256000,-188000,-188000
1460,宏遠            ,30000,218000,-188000,0,0,0,0,0,0,0,0,0,0,0,0,0,-188000
060644,泰鼎永豐9A購02  ,0,0,0,0,0,0,0,0,0,-189000,0,0,0,54000,243000,-189000,-189000
058497,新日興群益9B購01,0,0,0,0,0,0,0,0,0,-189000,0,0,0,203000,392000,-189000,-189000
045087,玉晶光元大95購01,0,0,0,0,0,0,0,0,0,-190000,0,0,0,10000,200000,-190000,-190000
052702,群創國票97購03  ,0,0,0,0,0,0,0,0,0,-190000,0,0,0,10000,200000,-190000,-190000
058222,玉晶光統一9B購01,0,0,0,0,0,0,0,0,0,-190000,0,0,0,0,190000,-190000,-190000
060821,SP黃豆元大9A購02,0,0,0,0,0,0,0,0,0,-191000,0,0,0,482000,673000,-191000,-191000
058719,智邦元富99購01  ,0,0,0,0,0,0,0,0,0,-191000,0,0,0,3000,194000,-191000,-191000
057731,華擎國泰9A購02  ,0,0,0,0,0,0,0,0,0,-192000,0,0,0,18000,210000,-192000,-192000
04831P,聯詠富邦96售01  ,0,0,0,0,0,0,0,0,0,-192000,0,0,0,95000,287000,-192000,-192000
048350,世紀鋼元大95購01,0,0,0,0,0,0,0,0,0,-192000,0,0,0,0,192000,-192000,-192000
058429,欣興元富99購01  ,0,0,0,0,0,0,0,0,0,-192000,0,0,0,128000,320000,-192000,-192000
057531,禾伸堂元大99購04,0,0,0,0,0,0,0,0,0,-192000,0,0,0,171000,363000,-192000,-192000
4746,台耀            ,379000,574000,-195000,0,0,0,0,0,0,3000,9000,6000,3000,0,0,0,-192000
9939,宏全            ,148000,350000,-202000,0,0,0,0,0,0,10000,10000,0,10000,7000,7000,0,-192000
060120,聯電富邦9B購01  ,0,0,0,0,0,0,0,0,0,-193000,0,0,0,120000,313000,-193000,-193000
2316,楠梓電          ,451000,854000,-403000,0,0,0,0,0,0,210000,222000,0,222000,9000,21000,-12000,-193000
056045,勤誠凱基97購01  ,0,0,0,0,0,0,0,0,0,-194000,0,0,0,0,194000,-194000,-194000
058645,康控富邦01購01  ,0,0,0,0,0,0,0,0,0,-195000,0,0,0,231000,426000,-195000,-195000
060215,柏文康和9A購01  ,0,0,0,0,0,0,0,0,0,-196000,0,0,0,92000,288000,-196000,-196000
055817,京鼎國票99購01  ,0,0,0,0,0,0,0,0,0,-196000,0,0,0,24000,220000,-196000,-196000
052714,義隆凱基96購02  ,0,0,0,0,0,0,0,0,0,-197000,0,0,0,7000,204000,-197000,-197000
057283,欣興元大98購07  ,0,0,0,0,0,0,0,0,0,-197000,0,0,0,304000,501000,-197000,-197000
060988,華新科元大9A購12,0,0,0,0,0,0,0,0,0,-198000,0,0,0,23000,221000,-198000,-198000
055297,啟碁元大97購01  ,0,0,0,0,0,0,0,0,0,-198000,0,0,0,80000,278000,-198000,-198000
058741,欣興日盛99購01  ,0,0,0,0,0,0,0,0,0,-198000,0,0,0,2000,200000,-198000,-198000
1439,中和            ,178000,377900,-199900,0,0,0,0,0,0,0,0,0,0,0,0,0,-199900
06885P,國巨國票99售06  ,0,0,0,0,0,0,0,0,0,-200000,0,0,0,0,200000,-200000,-200000
07068P,欣興台新99售01  ,0,0,0,0,0,0,0,0,0,-200000,0,0,0,0,200000,-200000,-200000
07128P,大毅元大99售04  ,0,0,0,0,0,0,0,0,0,-200000,0,0,0,36000,236000,-200000,-200000
060683,泰鼎元大9A購02  ,0,0,0,0,0,0,0,0,0,-200000,0,0,0,10000,210000,-200000,-200000
060427,聯茂永豐9A購01  ,0,0,0,0,0,0,0,0,0,-200000,0,0,0,19000,219000,-200000,-200000
053586,建準元大96購01  ,0,0,0,0,0,0,0,0,0,-200000,0,0,0,0,200000,-200000,-200000
8021,尖點            ,132000,327600,-195600,0,0,0,0,0,0,-5000,0,5000,-5000,0,0,0,-200600
061413,台勝科群益9A購01,0,0,0,0,0,0,0,0,0,-202000,0,0,0,87000,289000,-202000,-202000
03443B,臺股指凱基9A熊27,0,0,0,0,0,0,0,0,0,-202000,0,0,0,0,202000,-202000,-202000
057032,A50反1元大9B購01,0,0,0,0,0,0,0,0,0,-202000,0,0,0,0,202000,-202000,-202000
2340,光磊            ,108000,296000,-188000,0,0,0,0,0,0,-14000,4000,14000,-10000,8000,12000,-4000,-202000
058498,世紀鋼群益99購01,0,0,0,0,0,0,0,0,0,-203000,0,0,0,89000,292000,-203000,-203000
057397,茂林中信9A購01  ,0,0,0,0,0,0,0,0,0,-203000,0,0,0,77000,280000,-203000,-203000
058584,百和群益9A購01  ,0,0,0,0,0,0,0,0,0,-204000,0,0,0,130000,334000,-204000,-204000
2208,台船            ,57000,261000,-204000,0,0,0,0,0,0,0,0,0,0,0,0,0,-204000
059468,智邦元大99購02  ,0,0,0,0,0,0,0,0,0,-205000,0,0,0,13000,218000,-205000,-205000
055403,泰鼎元富97購01  ,0,0,0,0,0,0,0,0,0,-205000,0,0,0,10000,215000,-205000,-205000
2809,京城銀          ,76000,277000,-201000,0,0,0,0,0,0,-4000,0,4000,-4000,0,0,0,-205000
060186,義隆元富9A購01  ,0,0,0,0,0,0,0,0,0,-206000,0,0,0,209000,415000,-206000,-206000
061212,聯鈞元大9A購04  ,0,0,0,0,0,0,0,0,0,-207000,0,0,0,20000,227000,-207000,-207000
060853,健策國泰9B購02  ,0,0,0,0,0,0,0,0,0,-209000,0,0,0,0,209000,-209000,-209000
2520,冠德            ,157000,428000,-271000,0,0,0,0,0,0,62000,62000,0,62000,0,0,0,-209000
054546,玉晶光中信9B購01,0,0,0,0,0,0,0,0,0,-210000,0,0,0,256000,466000,-210000,-210000
5264,鎧勝-KY         ,254000,389000,-135000,0,0,0,0,0,0,-75000,0,0,0,0,75000,-75000,-210000
060962,義隆凱基9B購01  ,0,0,0,0,0,0,0,0,0,-211000,0,0,0,364000,575000,-211000,-211000
055093,京鼎群益98購01  ,0,0,0,0,0,0,0,0,0,-211000,0,0,0,210000,421000,-211000,-211000
056202,國揚永豐97購01  ,0,0,0,0,0,0,0,0,0,-211000,0,0,0,108000,319000,-211000,-211000
059171,祥碩凱基99購04  ,0,0,0,0,0,0,0,0,0,-211000,0,0,0,94000,305000,-211000,-211000
06457P,玉晶光統一98售02,0,0,0,0,0,0,0,0,0,-212000,0,0,0,11000,223000,-212000,-212000
059948,正文永豐99購01  ,0,0,0,0,0,0,0,0,0,-212000,0,0,0,91000,303000,-212000,-212000
060958,儒鴻凱基9A購02  ,0,0,0,0,0,0,0,0,0,-213000,0,0,0,156000,369000,-213000,-213000
060825,聯詠元大9A購05  ,10000,0,10000,0,0,0,0,0,0,-224000,0,0,0,68000,292000,-224000,-214000
061478,奇鋐元大9A購01  ,0,0,0,0,0,0,0,0,0,-214000,0,0,0,92000,306000,-214000,-214000
061361,世紀鋼兆豐9A購01,0,0,0,0,0,0,0,0,0,-215000,0,0,0,0,215000,-215000,-215000
053998,泰鼎群益98購01  ,0,0,0,0,0,0,0,0,0,-215000,0,0,0,211000,426000,-215000,-215000
057267,康控兆豐99購01  ,0,0,0,0,0,0,0,0,0,-215000,0,0,0,0,215000,-215000,-215000
6552,易華電          ,124000,329000,-205000,0,0,0,0,0,0,-10000,0,0,0,1000,11000,-10000,-215000
057821,晶相光元大98購03,0,0,0,0,0,0,0,0,0,-216000,0,0,0,148000,364000,-216000,-216000
056605,台積電富邦9B購02,0,0,0,0,0,0,0,0,0,-216000,0,0,0,0,216000,-216000,-216000
057377,康控元大99購02  ,0,0,0,0,0,0,0,0,0,-216000,0,0,0,567000,783000,-216000,-216000
2607,榮運            ,57000,273000,-216000,0,0,0,0,0,0,0,0,0,0,0,0,0,-216000
2421,建準            ,404000,629000,-225000,0,0,0,0,0,0,9000,8000,0,8000,55000,54000,1000,-216000
058134,信邦元大99購01  ,0,0,0,0,0,0,0,0,0,-217000,0,0,0,336000,553000,-217000,-217000
2442,新美齊          ,18000,235000,-217000,0,0,0,0,0,0,0,0,0,0,0,0,0,-217000
059645,祥碩凱基99購05  ,0,0,0,0,0,0,0,0,0,-219000,0,0,0,56000,275000,-219000,-219000
1732,毛寶            ,503000,720000,-217000,0,0,0,0,0,0,-2000,0,2000,-2000,0,0,0,-219000
059469,智邦元大99購03  ,0,0,0,0,0,0,0,0,0,-220000,0,0,0,53000,273000,-220000,-220000
054617,超眾永豐97購01  ,0,0,0,0,0,0,0,0,0,-220000,0,0,0,5000,225000,-220000,-220000
055745,臻鼎元富97購01  ,0,0,0,0,0,0,0,0,0,-220000,0,0,0,20000,240000,-220000,-220000
00646,元大S&P500      ,6000,39000,-33000,0,0,0,0,0,0,-188000,2000,0,2000,33000,223000,-190000,-221000
00662,富邦NASDAQ      ,2000,2000,0,0,0,0,0,0,0,-221000,0,0,0,100000,321000,-221000,-221000
07173P,臺股指國票99售10,0,0,0,0,0,0,0,0,0,-221000,0,0,0,20000,241000,-221000,-221000
061307,和潤永豐9A購02  ,0,0,0,0,0,0,0,0,0,-222000,0,0,0,48000,270000,-222000,-222000
061573,義隆元大9A購02  ,0,0,0,0,0,0,0,0,0,-223000,0,0,0,8000,231000,-223000,-223000
060236,精元元大9C購01  ,0,0,0,0,0,0,0,0,0,-223000,0,0,0,339000,562000,-223000,-223000
060670,臺指反元大01購03,0,0,0,0,0,0,0,0,0,-224000,0,0,0,0,224000,-224000,-224000
052069,聯茂兆豐96購01  ,0,0,0,0,0,0,0,0,0,-224000,0,0,0,0,224000,-224000,-224000
055877,奇鋐元富97購01  ,0,0,0,0,0,0,0,0,0,-225000,0,0,0,123000,348000,-225000,-225000
07623P,大立光統一9B售05,0,0,0,0,0,0,0,0,0,-225000,0,0,0,0,225000,-225000,-225000
055584,國巨元大97購11  ,0,0,0,0,0,0,0,0,0,-226000,0,0,0,1000,227000,-226000,-226000
059009,世紀鋼元大99購04,0,0,0,0,0,0,0,0,0,-226000,0,0,0,179000,405000,-226000,-226000
3038,全台            ,627000,884000,-257000,0,0,0,0,0,0,30000,30000,0,30000,0,0,0,-227000
060279,SP黃豆元大9A購01,0,0,0,0,0,0,0,0,0,-228000,0,0,0,122000,350000,-228000,-228000
058927,勤誠元富99購02  ,0,0,0,0,0,0,0,0,0,-228000,0,0,0,134000,362000,-228000,-228000
2451,創見            ,78000,249220,-171220,0,0,0,0,0,0,-57000,0,0,0,0,57000,-57000,-228220
060374,儒鴻元富9A購01  ,0,0,0,0,0,0,0,0,0,-229000,0,0,0,192000,421000,-229000,-229000
060762,長榮航元大9A購02,0,0,0,0,0,0,0,0,0,-229000,0,0,0,57000,286000,-229000,-229000
056540,聯詠凱基98購02  ,0,0,0,0,0,0,0,0,0,-229000,0,0,0,1000,230000,-229000,-229000
3060,銘異            ,440000,669000,-229000,0,0,0,0,0,0,0,0,0,0,0,0,0,-229000
059474,元石油群益99購01,0,0,0,0,0,0,0,0,0,-230000,0,0,0,0,230000,-230000,-230000
048653,巨大元大96購02  ,0,0,0,0,0,0,0,0,0,-230000,0,0,0,0,230000,-230000,-230000
053959,晶豪科永豐96購02,0,0,0,0,0,0,0,0,0,-230000,0,0,0,0,230000,-230000,-230000
058726,宏達電富邦9A購01,0,0,0,0,0,0,0,0,0,-230000,0,0,0,0,230000,-230000,-230000
6005,群益證          ,314450,546000,-231550,0,0,0,0,0,0,0,0,0,0,0,0,0,-231550
061244,和碩兆豐9A購01  ,0,0,0,0,0,0,0,0,0,-232000,0,0,0,14000,246000,-232000,-232000
07805P,義隆永豐9A售02  ,0,0,0,0,0,0,0,0,0,-232000,0,0,0,0,232000,-232000,-232000
059255,臺股指凱基99購33,0,0,0,0,0,0,0,0,0,-233000,0,0,0,33000,266000,-233000,-233000
061511,緯穎富邦9B購02  ,0,0,0,0,0,0,0,0,0,-234000,0,0,0,0,234000,-234000,-234000
059358,旺宏永豐99購02  ,0,0,0,0,0,0,0,0,0,-234000,0,0,0,71000,305000,-234000,-234000
05240P,玉晶光永豐96售01,0,0,0,0,0,0,0,0,0,-234000,0,0,0,15000,249000,-234000,-234000
060281,卜蜂元大9C購01  ,0,0,0,0,0,0,0,0,0,-237000,0,0,0,0,237000,-237000,-237000
060129,祥碩永豐99購03  ,0,0,0,0,0,0,0,0,0,-238000,0,0,0,87000,325000,-238000,-238000
061348,聯鈞元大9A購05  ,0,0,0,0,0,0,0,0,0,-238000,0,0,0,0,238000,-238000,-238000
058514,潤泰全元大99購01,0,0,0,0,0,0,0,0,0,-238000,0,0,0,33000,271000,-238000,-238000
6443,元晶            ,14000,252000,-238000,0,0,0,0,0,0,0,0,0,0,0,0,0,-238000
061135,聯發科統一9C購03,0,0,0,0,0,0,0,0,0,-239000,0,0,0,1000,240000,-239000,-239000
059814,SP黃豆凱基9A購02,0,0,0,0,0,0,0,0,0,-239000,0,0,0,20000,259000,-239000,-239000
054057,晶豪科國票97購01,0,0,0,0,0,0,0,0,0,-240000,0,0,0,150000,390000,-240000,-240000
054091,晶豪科群益96購01,0,0,0,0,0,0,0,0,0,-240000,0,0,0,60000,300000,-240000,-240000
057526,智邦元大98購10  ,0,0,0,0,0,0,0,0,0,-240000,0,0,0,77000,317000,-240000,-240000
05524P,瀚宇博國票97售02,0,0,0,0,0,0,0,0,0,-241000,0,0,0,47000,288000,-241000,-241000
061240,華新科兆豐9A購01,0,0,0,0,0,0,0,0,0,-242000,0,0,0,9000,251000,-242000,-242000
048850,聯電群益96購01  ,0,0,0,0,0,0,0,0,0,-242000,0,0,0,132000,374000,-242000,-242000
059949,啟碁永豐99購01  ,0,0,0,0,0,0,0,0,0,-243000,0,0,0,137000,380000,-243000,-243000
052207,台郡中信95購02  ,0,0,0,0,0,0,0,0,0,-244000,0,0,0,156000,400000,-244000,-244000
1714,和桐            ,564000,808000,-244000,0,0,0,0,0,0,0,0,0,0,0,0,0,-244000
00670L,富邦NASDAQ正2   ,29000,28000,1000,0,0,0,0,0,0,-246000,0,0,0,341000,587000,-246000,-245000
056198,台光電永豐97購02,0,0,0,0,0,0,0,0,0,-245000,0,0,0,23000,268000,-245000,-245000
055509,訊芯元大97購03  ,0,0,0,0,0,0,0,0,0,-245000,0,0,0,171000,416000,-245000,-245000
07060P,台表科國票9A售01,0,0,0,0,0,0,0,0,0,-247000,0,0,0,15000,262000,-247000,-247000
057395,旺宏中信98購03  ,0,0,0,0,0,0,0,0,0,-247000,0,0,0,228000,475000,-247000,-247000
9910,豐泰            ,318000,1248275,-930275,0,0,0,532000,0,532000,151000,151000,0,151000,0,0,0,-247275
058910,泰鼎元大99購03  ,0,0,0,0,0,0,0,0,0,-248000,0,0,0,545000,793000,-248000,-248000
060448,道瓊反元大9A購04,0,0,0,0,0,0,0,0,0,-249000,0,0,0,100000,349000,-249000,-249000
054394,奇力新永豐96購03,0,0,0,0,0,0,0,0,0,-249000,0,0,0,0,249000,-249000,-249000
057447,智邦元富02購01  ,0,0,0,0,0,0,0,0,0,-249000,0,0,0,42000,291000,-249000,-249000
052163,康舒永豐95購02  ,0,0,0,0,0,0,0,0,0,-250000,0,0,0,0,250000,-250000,-250000
051944,智邦統一95購02  ,0,0,0,0,0,0,0,0,0,-250000,0,0,0,46000,296000,-250000,-250000
061186,牧德國泰9C購01  ,0,0,0,0,0,0,0,0,0,-252000,0,0,0,186000,438000,-252000,-252000
058752,鈺齊凱基9A購01  ,0,0,0,0,0,0,0,0,0,-252000,0,0,0,134000,386000,-252000,-252000
059042,世紀鋼群益99購02,0,0,0,0,0,0,0,0,0,-253000,0,0,0,0,253000,-253000,-253000
03657C,T50反1元大99牛01,0,0,0,0,0,0,0,0,0,-254000,0,0,0,60000,314000,-254000,-254000
2201,裕隆            ,1160000,1495251,-335251,0,0,0,0,0,0,81000,83000,18000,65000,16000,0,16000,-254251
060813,高鐵凱基9A購01  ,0,0,0,0,0,0,0,0,0,-256000,0,0,0,309000,565000,-256000,-256000
060475,瑞祺元大9A購01  ,0,0,0,0,0,0,0,0,0,-257000,0,0,0,156000,413000,-257000,-257000
060408,和潤國泰9C購01  ,0,0,0,0,0,0,0,0,0,-257000,0,0,0,10000,267000,-257000,-257000
058912,祥碩元大99購01  ,0,0,0,0,0,0,0,0,0,-258000,0,0,0,339000,597000,-258000,-258000
07633P,台灣50元大9A售18,0,0,0,0,0,0,0,0,0,-259000,0,0,0,1000,260000,-259000,-259000
060155,友訊永豐9A購01  ,0,0,0,0,0,0,0,0,0,-260000,0,0,0,0,260000,-260000,-260000
054684,裕隆永豐97購01  ,0,0,0,0,0,0,0,0,0,-260000,0,0,0,1000,261000,-260000,-260000
07597P,臺股指中信01售02,0,0,0,0,0,0,0,0,0,-260000,0,0,0,70000,330000,-260000,-260000
07174P,臺股指國票99售11,0,0,0,0,0,0,0,0,0,-260000,0,0,0,189000,449000,-260000,-260000
2534,宏盛            ,184000,383600,-199600,0,0,0,0,0,0,-61000,0,61000,-61000,0,0,0,-260600
060453,儒鴻元大9A購02  ,0,0,0,0,0,0,0,0,0,-261000,0,0,0,73000,334000,-261000,-261000
3576,聯合再生        ,205000,466000,-261000,0,0,0,0,0,0,0,0,0,0,0,0,0,-261000
1476,儒鴻            ,286000,676011,-390011,0,0,0,139000,0,139000,-10000,5000,26000,-21000,15000,4000,11000,-261011
061269,嘉澤凱基9A購01  ,0,0,0,0,0,0,0,0,0,-262000,0,0,0,1000,263000,-262000,-262000
4106,雃博            ,54000,316000,-262000,0,0,0,0,0,0,0,0,0,0,0,0,0,-262000
061202,和大元大9A購02  ,0,0,0,0,0,0,0,0,0,-263000,0,0,0,0,263000,-263000,-263000
054304,台積電凱基96購23,0,0,0,0,0,0,0,0,0,-263000,0,0,0,0,263000,-263000,-263000
058854,樺漢群益9B購01  ,0,0,0,0,0,0,0,0,0,-263000,0,0,0,114000,377000,-263000,-263000
059259,FBVIX中信03購06 ,0,0,0,0,0,0,0,0,0,-263000,0,0,0,30000,293000,-263000,-263000
6278,台表科          ,908000,1561000,-653000,0,0,0,633000,257000,376000,13000,73000,10000,63000,19000,69000,-50000,-264000
06743P,創意永豐98售03  ,0,0,0,0,0,0,0,0,0,-265000,0,0,0,92000,357000,-265000,-265000
057577,廣宇中信9A購01  ,0,0,0,0,0,0,0,0,0,-265000,0,0,0,0,265000,-265000,-265000
058523,聯茂元大99購08  ,0,0,0,0,0,0,0,0,0,-266000,0,0,0,0,266000,-266000,-266000
8163,達方            ,340000,636000,-296000,0,0,0,0,0,0,30000,36000,40000,-4000,39000,5000,34000,-266000
061053,國巨群益9A購08  ,0,0,0,0,0,0,0,0,0,-268000,0,0,0,247000,515000,-268000,-268000
056738,國巨凱基9A購02  ,0,0,0,0,0,0,0,0,0,-269000,0,0,0,312000,581000,-269000,-269000
2314,台揚            ,268000,537000,-269000,0,0,0,0,0,0,0,0,0,0,0,0,0,-269000
061138,晶技統一9C購01  ,0,0,0,0,0,0,0,0,0,-270000,0,0,0,178000,448000,-270000,-270000
053062,緯穎富邦97購01  ,0,0,0,0,0,0,0,0,0,-270000,0,0,0,9000,279000,-270000,-270000
061534,聯發科統一9C購04,0,0,0,0,0,0,0,0,0,-271000,0,0,0,0,271000,-271000,-271000
059485,台灣50兆豐99購02,0,0,0,0,0,0,0,0,0,-272000,0,0,0,32000,304000,-272000,-272000
057927,勤誠凱基98購01  ,0,0,0,0,0,0,0,0,0,-272000,0,0,0,20000,292000,-272000,-272000
051918,聯茂元大95購01  ,0,0,0,0,0,0,0,0,0,-272000,0,0,0,33000,305000,-272000,-272000
059047,元油2X凱基9A購10,0,0,0,0,0,0,0,0,0,-272000,0,0,0,253000,525000,-272000,-272000
2204,中華            ,42000,315000,-273000,0,0,0,0,0,0,0,0,0,0,0,0,0,-273000
1722,台肥            ,171000,435000,-264000,0,0,0,0,0,0,-9000,0,0,0,0,9000,-9000,-273000
2329,華泰            ,275000,545000,-270000,0,0,0,0,0,0,-4000,0,0,0,0,4000,-4000,-274000
060079,台郡台新99購03  ,0,0,0,0,0,0,0,0,0,-275000,0,0,0,240000,515000,-275000,-275000
05637P,聯電元大96售04  ,0,0,0,0,0,0,0,0,0,-278000,0,0,0,152000,430000,-278000,-278000
057872,旺宏元大99購06  ,0,0,0,0,0,0,0,0,0,-280000,0,0,0,233000,513000,-280000,-280000
07402P,瑞昱凱基99售02  ,0,0,0,0,0,0,0,0,0,-280000,0,0,0,20000,300000,-280000,-280000
056817,國巨永豐98購04  ,0,0,0,0,0,0,0,0,0,-281000,0,0,0,24000,305000,-281000,-281000
055604,訊芯元大98購02  ,0,0,0,0,0,0,0,0,0,-282000,0,0,0,96000,378000,-282000,-282000
059967,聯發科凱基99購20,0,0,0,0,0,0,0,0,0,-284000,0,0,0,35000,319000,-284000,-284000
07638P,長榮航國票9A售01,0,0,0,0,0,0,0,0,0,-284000,0,0,0,34000,318000,-284000,-284000
061237,晶技元大9A購01  ,0,0,0,0,0,0,0,0,0,-285000,0,0,0,130000,415000,-285000,-285000
054977,SP黃豆元富9B購01,0,0,0,0,0,0,0,0,0,-286000,0,0,0,0,286000,-286000,-286000
059006,樺漢元大99購01  ,0,0,0,0,0,0,0,0,0,-286000,0,0,0,217000,503000,-286000,-286000
2104,國際中橡        ,997000,1262000,-265000,0,0,0,0,0,0,-21000,0,0,0,11000,32000,-21000,-286000
061137,晶技統一9B購01  ,0,0,0,0,0,0,0,0,0,-287000,0,0,0,260000,547000,-287000,-287000
061034,晶豪科永豐9A購01,0,0,0,0,0,0,0,0,0,-288000,0,0,0,79000,367000,-288000,-288000
061327,台郡凱基9A購02  ,0,0,0,0,0,0,0,0,0,-290000,0,0,0,138000,428000,-290000,-290000
057393,台積電中信02購01,0,0,0,0,0,0,0,0,0,-290000,0,0,0,0,290000,-290000,-290000
061380,巨大永豐9A購02  ,0,0,0,0,0,0,0,0,0,-291000,0,0,0,164000,455000,-291000,-291000
07316P,長榮航康和99售01,0,0,0,0,0,0,0,0,0,-291000,0,0,0,20000,311000,-291000,-291000
060401,世紀鋼國票9B購01,0,0,0,0,0,0,0,0,0,-294000,0,0,0,148000,442000,-294000,-294000
1402,遠東新          ,2532781,2813000,-280219,0,0,0,5000,0,5000,-19000,18000,28000,-10000,0,9000,-9000,-294219
057125,國巨凱基98購12  ,0,0,0,0,0,0,0,0,0,-295000,0,0,0,206000,501000,-295000,-295000
060036,上証2X國票99購03,0,0,0,0,0,0,0,0,0,-300000,0,0,0,0,300000,-300000,-300000
059533,富邦金凱基99購01,0,0,0,0,0,0,0,0,0,-300000,0,0,0,299000,599000,-300000,-300000
053537,玉晶光永豐98購02,0,0,0,0,0,0,0,0,0,-300000,0,0,0,0,300000,-300000,-300000
052088,漢唐元大95購02  ,0,0,0,0,0,0,0,0,0,-300000,0,0,0,0,300000,-300000,-300000
05152P,玉晶光群益96售05,0,0,0,0,0,0,0,0,0,-301000,0,0,0,26000,327000,-301000,-301000
6558,興能高          ,86000,388000,-302000,0,0,0,0,0,0,0,0,0,0,0,0,0,-302000
058143,瑞儀元大99購02  ,0,0,0,0,0,0,0,0,0,-303000,0,0,0,137000,440000,-303000,-303000
055858,聯茂元大97購03  ,0,0,0,0,0,0,0,0,0,-307000,0,0,0,148000,455000,-307000,-307000
2820,華票            ,171000,478000,-307000,0,0,0,0,0,0,0,0,0,0,0,0,0,-307000
060312,潤泰全永豐9A購01,0,0,0,0,0,0,0,0,0,-308000,0,0,0,20000,328000,-308000,-308000
6452,康友-KY         ,47000,380000,-333000,0,0,0,0,0,0,25000,1000,0,1000,40000,16000,24000,-308000
055404,超眾元富97購01  ,0,0,0,0,0,0,0,0,0,-309000,0,0,0,122000,431000,-309000,-309000
2464,盟立            ,30000,339000,-309000,0,0,0,0,0,0,0,0,0,0,0,0,0,-309000
054406,旺宏國票98購01  ,0,0,0,0,0,0,0,0,0,-310000,0,0,0,5000,315000,-310000,-310000
061274,臺股指凱基9A購24,0,0,0,0,0,0,0,0,0,-312000,0,0,0,0,312000,-312000,-312000
061020,超眾國票9A購02  ,0,0,0,0,0,0,0,0,0,-312000,0,0,0,1000,313000,-312000,-312000
053768,S&P反1元大99購01,0,0,0,0,0,0,0,0,0,-312000,0,0,0,0,312000,-312000,-312000
058803,世紀鋼元大99購03,0,0,0,0,0,0,0,0,0,-315000,0,0,0,150000,465000,-315000,-315000
3665,貿聯-KY         ,205000,208000,-3000,0,0,0,0,304000,-304000,-8000,0,0,0,4000,12000,-8000,-315000
059203,勤誠永豐99購02  ,0,0,0,0,0,0,0,0,0,-316000,0,0,0,99000,415000,-316000,-316000
056893,智邦元大98購02  ,0,0,0,0,0,0,0,0,0,-316000,0,0,0,59000,375000,-316000,-316000
050915,健策中信98購01  ,0,0,0,0,0,0,0,0,0,-317000,0,0,0,126000,443000,-317000,-317000
061318,智邦凱基9B購01  ,0,0,0,0,0,0,0,0,0,-320000,0,0,0,10000,330000,-320000,-320000
3532,台勝科          ,124000,213000,-89000,0,0,0,0,189000,-189000,-42000,2000,0,2000,16000,60000,-44000,-320000
053494,南亞科兆豐96購02,0,0,0,0,0,0,0,0,0,-321000,0,0,0,41000,362000,-321000,-321000
1609,大亞            ,153040,475000,-321960,0,0,0,0,0,0,0,0,0,0,0,0,0,-321960
060530,聯發科中信9C購03,0,0,0,0,0,0,0,0,0,-322000,0,0,0,0,322000,-322000,-322000
060628,和大富邦9B購01  ,0,0,0,0,0,0,0,0,0,-322000,0,0,0,123000,445000,-322000,-322000
061275,臺股指凱基9A購25,0,0,0,0,0,0,0,0,0,-324000,0,0,0,288000,612000,-324000,-324000
07580P,緯穎元大9A售03  ,0,0,0,0,0,0,0,0,0,-324000,0,0,0,3000,327000,-324000,-324000
058576,南亞科群益99購01,0,0,0,0,0,0,0,0,0,-325000,0,0,0,246000,571000,-325000,-325000
061487,聯發科兆豐9B購02,0,0,0,0,0,0,0,0,0,-326000,0,0,0,0,326000,-326000,-326000
061592,義隆永豐9A購03  ,0,0,0,0,0,0,0,0,0,-326000,0,0,0,4000,330000,-326000,-326000
056515,燿華兆豐99購01  ,0,0,0,0,0,0,0,0,0,-326000,0,0,0,0,326000,-326000,-326000
058999,台積電元大99購24,0,0,0,0,0,0,0,0,0,-327000,0,0,0,57000,384000,-327000,-327000
056189,樺漢統一97購02  ,0,0,0,0,0,0,0,0,0,-327000,0,0,0,211000,538000,-327000,-327000
052313,聯電元大98購01  ,0,0,0,0,0,0,0,0,0,-328000,0,0,0,18000,346000,-328000,-328000
058707,泰鼎元大99購02  ,0,0,0,0,0,0,0,0,0,-329000,0,0,0,58000,387000,-329000,-329000
055809,T50反1國票98購02,0,0,0,0,0,0,0,0,0,-330000,0,0,0,0,330000,-330000,-330000
056717,康友永豐98購01  ,0,0,0,0,0,0,0,0,0,-330000,0,0,0,0,330000,-330000,-330000
054120,奇力新永豐96購01,0,0,0,0,0,0,0,0,0,-331000,0,0,0,0,331000,-331000,-331000
056769,國產元大98購01  ,0,0,0,0,0,0,0,0,0,-334000,0,0,0,702000,1036000,-334000,-334000
061166,玉晶光兆豐9B購01,0,0,0,0,0,0,0,0,0,-341000,0,0,0,1000,342000,-341000,-341000
060404,台勝科國泰9B購01,0,0,0,0,0,0,0,0,0,-342000,0,0,0,87000,429000,-342000,-342000
6196,帆宣            ,156000,478000,-322000,0,0,0,0,0,0,-22000,0,0,0,3000,25000,-22000,-344000
5521,工信            ,107000,501000,-394000,0,0,0,0,0,0,50000,50000,0,50000,0,0,0,-344000
056104,義隆永豐97購01  ,0,0,0,0,0,0,0,0,0,-347000,0,0,0,20000,367000,-347000,-347000
8104,錸寶            ,16000,363000,-347000,0,0,0,0,0,0,0,0,0,0,0,0,0,-347000
051159,力山元大96購01  ,0,0,0,0,0,0,0,0,0,-349000,0,0,0,1000,350000,-349000,-349000
061007,聯詠兆豐9A購01  ,0,0,0,0,0,0,0,0,0,-350000,0,0,0,310000,660000,-350000,-350000
053297,鎧勝中信98購01  ,0,0,0,0,0,0,0,0,0,-350000,0,0,0,20000,370000,-350000,-350000
054033,欣興中信96購02  ,0,0,0,0,0,0,0,0,0,-350000,0,0,0,0,350000,-350000,-350000
07390P,華新科康和99售02,0,0,0,0,0,0,0,0,0,-350000,0,0,0,250000,600000,-350000,-350000
07504P,聯詠元大9A售02  ,0,0,0,0,0,0,0,0,0,-350000,0,0,0,0,350000,-350000,-350000
00674R,元大S&P黃金反1  ,15000,0,15000,0,0,0,0,0,0,-368000,0,0,0,180000,548000,-368000,-353000
00643,群益深証中小    ,219000,284000,-65000,0,0,0,0,0,0,-290000,0,0,0,316000,606000,-290000,-355000
060051,台積電凱基9B購01,0,0,0,0,0,0,0,0,0,-356000,0,0,0,40000,396000,-356000,-356000
2474,可成            ,1622653,1960052,-337399,0,0,0,4000,0,4000,-23000,66000,45000,21000,16000,60000,-44000,-356399
00669R,國泰美國道瓊反1 ,83000,41000,42000,0,0,0,0,0,0,-400000,0,0,0,2307000,2707000,-400000,-358000
056944,鴻海統一98購11  ,0,0,0,0,0,0,0,0,0,-358000,0,0,0,29000,387000,-358000,-358000
9105,泰金寶-DR       ,31000,389000,-358000,0,0,0,0,0,0,0,0,0,0,0,0,0,-358000
061513,華新科永豐9A購04,0,0,0,0,0,0,0,0,0,-359000,0,0,0,5000,364000,-359000,-359000
048270,T50反1富邦99購01,0,0,0,0,0,0,0,0,0,-359000,0,0,0,1000,360000,-359000,-359000
06085P,義隆台新97售01  ,0,0,0,0,0,0,0,0,0,-360000,0,0,0,7000,367000,-360000,-360000
00652,富邦印度        ,0,256000,-256000,0,0,0,0,0,0,-104000,0,0,0,44000,148000,-104000,-360000
055168,光罩統一98購01  ,0,0,0,0,0,0,0,0,0,-360000,0,0,0,10000,370000,-360000,-360000
057105,致茂群益9A購01  ,0,0,0,0,0,0,0,0,0,-362000,0,0,0,278000,640000,-362000,-362000
2890,永豐金          ,5986678,6387634,-400956,0,0,0,14000,0,14000,24000,0,0,0,26000,2000,24000,-362956
061121,智邦永豐9A購02  ,0,0,0,0,0,0,0,0,0,-364000,0,0,0,31000,395000,-364000,-364000
053352,義隆兆豐96購01  ,0,0,0,0,0,0,0,0,0,-368000,0,0,0,4000,372000,-368000,-368000
5519,隆大            ,27000,395000,-368000,0,0,0,0,0,0,0,0,0,0,0,0,0,-368000
4119,旭富            ,284000,602000,-318000,0,0,0,0,33000,-33000,-17000,0,0,0,3000,20000,-17000,-368000
061087,國巨統一01購04  ,0,0,0,0,0,0,0,0,0,-369000,0,0,0,254000,623000,-369000,-369000
060981,旺宏元大9A購08  ,0,0,0,0,0,0,0,0,0,-369000,0,0,0,201000,570000,-369000,-369000
059998,華航元富99購02  ,0,0,0,0,0,0,0,0,0,-374000,0,0,0,42000,416000,-374000,-374000
061024,南電國泰9B購01  ,0,0,0,0,0,0,0,0,0,-376000,0,0,0,131000,507000,-376000,-376000
061077,國巨兆豐9B購01  ,0,0,0,0,0,0,0,0,0,-376000,0,0,0,200000,576000,-376000,-376000
061151,友訊群益9A購01  ,0,0,0,0,0,0,0,0,0,-377000,0,0,0,85000,462000,-377000,-377000
054459,鈺齊群益96購01  ,0,0,0,0,0,0,0,0,0,-378000,0,0,0,0,378000,-378000,-378000
058622,國巨國票99購07  ,0,0,0,0,0,0,0,0,0,-378000,0,0,0,409000,787000,-378000,-378000
057300,訊連永豐98購01  ,0,0,0,0,0,0,0,0,0,-378000,0,0,0,231000,609000,-378000,-378000
3708,上緯投控        ,126000,513000,-387000,0,0,0,0,0,0,9000,0,0,0,16000,7000,9000,-378000
052712,旺宏凱基96購02  ,0,0,0,0,0,0,0,0,0,-379000,0,0,0,30000,409000,-379000,-379000
07807P,聯茂永豐9A售02  ,0,0,0,0,0,0,0,0,0,-379000,0,0,0,0,379000,-379000,-379000
041991,元油2X國票98購01,0,0,0,0,0,0,0,0,0,-380000,0,0,0,0,380000,-380000,-380000
07700P,臺股指元大9A售53,0,0,0,0,0,0,0,0,0,-381000,0,0,0,47000,428000,-381000,-381000
060108,泰鼎元大99購04  ,0,0,0,0,0,0,0,0,0,-383000,0,0,0,18000,401000,-383000,-383000
060538,S&P反1凱基9A購01,0,0,0,0,0,0,0,0,0,-385000,0,0,0,70000,455000,-385000,-385000
00717,富邦美國特別股  ,0,52000,-52000,0,0,0,0,0,0,-333000,0,0,0,450000,783000,-333000,-385000
053571,奇鋐統一96購02  ,0,0,0,0,0,0,0,0,0,-385000,0,0,0,0,385000,-385000,-385000
060512,祥碩元大9A購02  ,0,0,0,0,0,0,0,0,0,-386000,0,0,0,200000,586000,-386000,-386000
00701,國泰股利精選30  ,0,0,0,0,0,0,0,0,0,-386256,0,0,0,275000,661256,-386256,-386256
059201,祥碩永豐99購02  ,0,0,0,0,0,0,0,0,0,-388000,0,0,0,130000,518000,-388000,-388000
057107,華新科群益98購06,0,0,0,0,0,0,0,0,0,-389000,0,0,0,208000,597000,-389000,-389000
058405,訊連元大99購02  ,0,0,0,0,0,0,0,0,0,-389000,0,0,0,238000,627000,-389000,-389000
060758,台積電元大9A購19,0,0,0,0,0,0,0,0,0,-391000,0,0,0,20000,411000,-391000,-391000
056309,合勤控元大97購01,0,0,0,0,0,0,0,0,0,-392000,0,0,0,70000,462000,-392000,-392000
045873,元油2X元富98購04,0,0,0,0,0,0,0,0,0,-400000,0,0,0,0,400000,-400000,-400000
060430,和潤永豐9A購01  ,0,0,0,0,0,0,0,0,0,-401000,0,0,0,168000,569000,-401000,-401000
059680,台積電國泰9A購03,0,0,0,0,0,0,0,0,0,-402000,0,0,0,136000,538000,-402000,-402000
050515,聯電元大96購01  ,0,0,0,0,0,0,0,0,0,-404000,0,0,0,3000,407000,-404000,-404000
057780,台郡群益98購02  ,0,0,0,0,0,0,0,0,0,-405000,0,0,0,227000,632000,-405000,-405000
1710,東聯            ,420000,440000,-20000,0,0,0,0,0,0,-385000,0,385000,-385000,0,0,0,-405000
060477,和潤元大9A購01  ,0,0,0,0,0,0,0,0,0,-406000,0,0,0,421000,827000,-406000,-406000
054502,泰碩永豐96購01  ,0,10000,-10000,0,0,0,0,0,0,-396000,0,0,0,108000,504000,-396000,-406000
061074,儒鴻兆豐9B購01  ,0,0,0,0,0,0,0,0,0,-409000,0,0,0,183000,592000,-409000,-409000
058406,聯茂元大99購06  ,0,0,0,0,0,0,0,0,0,-409000,0,0,0,45000,454000,-409000,-409000
2634,漢翔            ,114000,517000,-403000,0,0,0,0,0,0,-6000,0,0,0,0,6000,-6000,-409000
060888,金像電統一9C購01,0,0,0,0,0,0,0,0,0,-410000,0,0,0,415000,825000,-410000,-410000
06748P,智邦台新98售02  ,0,0,0,0,0,0,0,0,0,-411000,0,0,0,38000,449000,-411000,-411000
059176,臺股指凱基99購27,0,0,0,0,0,0,0,0,0,-411000,0,0,0,2000,413000,-411000,-411000
07782P,寶成凱基9A售02  ,0,0,0,0,0,0,0,0,0,-411000,0,0,0,50000,461000,-411000,-411000
059019,元石油統一9B購03,0,0,0,0,0,0,0,0,0,-413000,0,0,0,100000,513000,-413000,-413000
050618,緯創元大95購01  ,0,0,0,0,0,0,0,0,0,-415000,0,0,0,0,415000,-415000,-415000
051536,玉晶光國票97購01,0,0,0,0,0,0,0,0,0,-416000,0,0,0,66000,482000,-416000,-416000
3090,日電貿          ,283000,644000,-361000,0,0,0,0,0,0,-56000,0,0,0,5000,61000,-56000,-417000
6191,精成科          ,165000,586000,-421000,0,0,0,0,0,0,0,0,0,0,0,0,0,-421000
057408,台郡群益98購01  ,0,0,0,0,0,0,0,0,0,-423000,0,0,0,16000,439000,-423000,-423000
8213,志超            ,309000,730000,-421000,0,0,0,0,0,0,-2000,0,1000,-1000,0,1000,-1000,-423000
060046,S&P反1凱基99購02,0,0,0,0,0,0,0,0,0,-425000,0,0,0,25000,450000,-425000,-425000
058712,鴻海統一9B購03  ,0,0,0,0,0,0,0,0,0,-426000,0,0,0,30000,456000,-426000,-426000
00638R,元大滬深300反1  ,3000,398000,-395000,0,0,0,0,0,0,-32000,0,0,0,190000,222000,-32000,-427000
2387,精元            ,637000,1152000,-515000,0,0,0,0,0,0,88000,15000,1000,14000,150000,76000,74000,-427000
060631,微星富邦9B購01  ,0,0,0,0,0,0,0,0,0,-428000,0,0,0,0,428000,-428000,-428000
060123,光罩永豐99購02  ,0,0,0,0,0,0,0,0,0,-431000,0,0,0,121000,552000,-431000,-431000
2841,台開            ,309000,741000,-432000,0,0,0,0,0,0,0,0,0,0,0,0,0,-432000
058736,鈺齊永豐99購02  ,0,0,0,0,0,0,0,0,0,-433000,0,0,0,50000,483000,-433000,-433000
4967,十銓            ,293100,728000,-434900,0,0,0,0,0,0,0,0,0,0,0,0,0,-434900
059932,世紀鋼富邦9A購02,0,0,0,0,0,0,0,0,0,-436000,0,0,0,58000,494000,-436000,-436000
061477,晶豪科元大9A購01,0,0,0,0,0,0,0,0,0,-436000,0,0,0,155000,591000,-436000,-436000
057347,國巨統一9A購03  ,0,0,0,0,0,0,0,0,0,-436000,0,0,0,0,436000,-436000,-436000
056012,勤誠中信99購01  ,0,0,0,0,0,0,0,0,0,-444000,0,0,0,0,444000,-444000,-444000
056611,國巨永豐98購03  ,0,0,0,0,0,0,0,0,0,-450000,0,0,0,20000,470000,-450000,-450000
049946,智邦兆豐95購01  ,0,0,0,0,0,0,0,0,0,-451000,0,0,0,101000,552000,-451000,-451000
2881,富邦金          ,4037648,4245941,-208293,0,0,0,10000,0,10000,-253000,0,2000,-2000,0,251000,-251000,-451293
00712,FH富時不動產    ,0,457000,-457000,0,0,0,0,0,0,2000,0,0,0,68000,66000,2000,-455000
059983,聯發科元大99購38,0,0,0,0,0,0,0,0,0,-456000,0,0,0,40000,496000,-456000,-456000
8996,高力            ,163000,631000,-468000,0,0,0,0,0,0,10000,10000,0,10000,0,0,0,-458000
051727,S&P反1國票97購01,0,0,0,0,0,0,0,0,0,-459000,0,0,0,0,459000,-459000,-459000
059849,興勤永豐99購01  ,0,0,0,0,0,0,0,0,0,-468000,0,0,0,174000,642000,-468000,-468000
060920,超眾富邦9B購01  ,0,0,0,0,0,0,0,0,0,-469000,0,0,0,634000,1103000,-469000,-469000
061423,廣達元大9A購01  ,0,0,0,0,0,0,0,0,0,-471000,0,0,0,26000,497000,-471000,-471000
057467,祥碩永豐98購04  ,0,0,0,0,0,0,0,0,0,-471000,0,0,0,170000,641000,-471000,-471000
049501,台郡元大95購01  ,0,0,0,0,0,0,0,0,0,-473000,0,0,0,71000,544000,-473000,-473000
1314,中石化          ,2288000,2695023,-407023,0,0,0,0,0,0,-67000,60000,44000,16000,21000,104000,-83000,-474023
006208,富邦台50        ,0,0,0,0,0,0,0,0,0,-475000,0,0,0,308000,783000,-475000,-475000
055861,矽力元大97購03  ,0,0,0,0,0,0,0,0,0,-477000,0,0,0,11000,488000,-477000,-477000
058733,同欣電永豐99購02,0,0,0,0,0,0,0,0,0,-479000,0,0,0,65000,544000,-479000,-479000
061416,聯茂群益9A購01  ,0,0,0,0,0,0,0,0,0,-482000,0,0,0,95000,577000,-482000,-482000
9933,中鼎            ,296000,779000,-483000,0,0,0,0,0,0,0,0,0,0,0,0,0,-483000
055006,晶相光元富9A購01,0,450000,-450000,0,0,0,0,0,0,-35000,0,0,0,485000,520000,-35000,-485000
060376,瑞祺元富9A購01  ,0,0,0,0,0,0,0,0,0,-486000,0,0,0,375000,861000,-486000,-486000
9944,新麗            ,278000,764000,-486000,0,0,0,0,0,0,0,0,0,0,0,0,0,-486000
059767,矽力永豐99購01  ,0,0,0,0,0,0,0,0,0,-487000,0,0,0,42000,529000,-487000,-487000
052223,聯電凱基96購02  ,0,0,0,0,0,0,0,0,0,-488000,0,0,0,0,488000,-488000,-488000
058822,樺漢國泰9B購01  ,0,0,0,0,0,0,0,0,0,-488000,0,0,0,45000,533000,-488000,-488000
059425,SGBR2X元大9A購02,0,0,0,0,0,0,0,0,0,-490000,0,0,0,0,490000,-490000,-490000
059943,信邦永豐99購01  ,0,0,0,0,0,0,0,0,0,-497000,0,0,0,223000,720000,-497000,-497000
6153,嘉聯益          ,744000,842000,-98000,0,0,0,0,0,0,-400000,0,100000,-100000,9000,309000,-300000,-498000
052623,台郡兆豐96購01  ,0,0,0,0,0,0,0,0,0,-499000,0,0,0,0,499000,-499000,-499000
047680,上証反中信96購01,0,0,0,0,0,0,0,0,0,-500000,0,0,0,0,500000,-500000,-500000
1313,聯成            ,181000,681000,-500000,0,0,0,0,0,0,0,0,0,0,0,0,0,-500000
6257,矽格            ,506000,677645,-171645,0,0,0,0,0,0,-330000,39000,282000,-243000,9000,96000,-87000,-501645
056693,國產群益98購01  ,0,0,0,0,0,0,0,0,0,-506000,0,0,0,98000,604000,-506000,-506000
2542,興富發          ,740000,1247000,-507000,0,0,0,0,0,0,1000,15000,4000,11000,0,10000,-10000,-506000
2337,旺宏            ,5982000,6034436,-52436,0,0,0,0,208000,-208000,-249000,956000,1554000,-598000,949000,600000,349000,-509436
00850,元大臺灣ESG永續 ,1000,0,1000,0,0,0,0,0,0,-518000,0,0,0,163000,681000,-518000,-517000
060225,S&P反1元大9A購02,0,0,0,0,0,0,0,0,0,-520000,0,0,0,0,520000,-520000,-520000
056196,聯茂富邦98購02  ,0,0,0,0,0,0,0,0,0,-522000,0,0,0,224000,746000,-522000,-522000
060780,祥碩國泰9B購01  ,0,0,0,0,0,0,0,0,0,-523000,0,0,0,779000,1302000,-523000,-523000
061354,瑞儀元大9A購01  ,0,0,0,0,0,0,0,0,0,-524000,0,0,0,233000,757000,-524000,-524000
07263P,台積電元大99售37,0,0,0,0,0,0,0,0,0,-526000,0,0,0,186000,712000,-526000,-526000
061584,勤誠元大9A購01  ,0,0,0,0,0,0,0,0,0,-529000,0,0,0,70000,599000,-529000,-529000
3019,亞光            ,368000,760000,-392000,0,0,0,0,0,0,-137000,18000,118000,-100000,3000,40000,-37000,-529000
057077,國巨統一98購06  ,0,0,0,0,0,0,0,0,0,-532000,0,0,0,126000,658000,-532000,-532000
061370,晶技國泰9C購01  ,0,0,0,0,0,0,0,0,0,-534000,0,0,0,230000,764000,-534000,-534000
00635U,元大S&P黃金     ,12000,2000,10000,0,0,0,0,0,0,-546000,100000,0,100000,74000,720000,-646000,-536000
060209,喬山康和9A購01  ,0,0,0,0,0,0,0,0,0,-539000,0,0,0,42000,581000,-539000,-539000
054239,台郡群益96購02  ,0,0,0,0,0,0,0,0,0,-540000,0,0,0,178000,718000,-540000,-540000
061114,南電元大9A購04  ,0,0,0,0,0,0,0,0,0,-543000,0,0,0,141000,684000,-543000,-543000
07575P,瑞昱元大9A售02  ,0,0,0,0,0,0,0,0,0,-554000,0,0,0,11000,565000,-554000,-554000
3049,和鑫            ,1156000,1713000,-557000,0,0,0,0,0,0,0,0,0,0,0,0,0,-557000
03840P,台積電統一99售02,0,0,0,0,0,0,0,0,0,-560000,0,0,0,0,560000,-560000,-560000
3706,神達            ,522000,699000,-177000,0,0,0,0,223000,-223000,-163000,0,0,0,19000,182000,-163000,-563000
060930,超眾永豐9A購03  ,0,0,0,0,0,0,0,0,0,-565000,0,0,0,30000,595000,-565000,-565000
061283,智邦統一9A購01  ,0,0,0,0,0,0,0,0,0,-566000,0,0,0,412000,978000,-566000,-566000
2349,錸德            ,363000,733000,-370000,0,0,0,0,200000,-200000,0,0,0,0,0,0,0,-570000
058926,勤誠元富99購01  ,0,0,0,0,0,0,0,0,0,-577000,0,0,0,812000,1389000,-577000,-577000
4142,國光生          ,733000,1310000,-577000,0,0,0,0,0,0,0,0,0,0,0,0,0,-577000
060529,聯發科中信9A購04,0,0,0,0,0,0,0,0,0,-581000,0,0,0,274000,855000,-581000,-581000
00676R,富邦臺灣加權反1 ,0,0,0,0,0,0,0,0,0,-582000,0,0,0,877000,1459000,-582000,-582000
055235,金寶台新98購01  ,0,0,0,0,0,0,0,0,0,-584000,0,0,0,100000,684000,-584000,-584000
061538,SP黃豆群益9A購03,0,0,0,0,0,0,0,0,0,-597000,0,0,0,0,597000,-597000,-597000
054148,矽創元大96購03  ,0,0,0,0,0,0,0,0,0,-598000,0,0,0,0,598000,-598000,-598000
056320,京鼎群益99購01  ,0,0,0,0,0,0,0,0,0,-605000,0,0,0,383000,988000,-605000,-605000
2498,宏達電          ,723000,1205000,-482000,0,0,0,0,0,0,-125000,8000,28000,-20000,10000,115000,-105000,-607000
3043,科風            ,0,610810,-610810,0,0,0,0,0,0,0,0,0,0,0,0,0,-610810
061021,聯電國泰9B購01  ,0,10000,-10000,0,0,0,0,0,0,-605000,0,0,0,891000,1496000,-605000,-615000
00738U,元大道瓊白銀    ,8000,221000,-213000,0,0,0,0,0,0,-406189,0,0,0,178000,584189,-406189,-619189
061469,瑞祺群益9A購02  ,0,0,0,0,0,0,0,0,0,-622000,0,0,0,68000,690000,-622000,-622000
056296,旺宏元大97購07  ,0,0,0,0,0,0,0,0,0,-625000,0,0,0,0,625000,-625000,-625000
058146,勤誠元大99購01  ,0,0,0,0,0,0,0,0,0,-630000,0,0,0,201000,831000,-630000,-630000
061492,超眾兆豐9B購01  ,0,0,0,0,0,0,0,0,0,-633000,0,0,0,0,633000,-633000,-633000
038489,T50反1台新9A購01,1000,0,1000,0,0,0,0,0,0,-640000,0,0,0,0,640000,-640000,-639000
3698,隆達            ,350000,910000,-560000,0,0,0,0,0,0,-80000,64000,144000,-80000,0,0,0,-640000
061306,瑞祺永豐9A購02  ,0,0,0,0,0,0,0,0,0,-647000,0,0,0,59000,706000,-647000,-647000
00861,元大全球未來通訊,12000,0,12000,0,0,0,0,0,0,-671000,0,0,0,909000,1580000,-671000,-659000
052527,泰鼎元大96購02  ,0,0,0,0,0,0,0,0,0,-661000,0,0,0,92000,753000,-661000,-661000
3682,亞太電          ,295000,956000,-661000,0,0,0,0,0,0,0,0,0,0,0,0,0,-661000
061506,瑞祺國票9A購02  ,0,0,0,0,0,0,0,0,0,-662000,0,0,0,66000,728000,-662000,-662000
059841,國巨富邦9C購01  ,0,0,0,0,0,0,0,0,0,-665000,0,0,0,3213000,3878000,-665000,-665000
00692,富邦公司治理    ,0,0,0,0,0,0,0,0,0,-672000,0,0,0,853000,1525000,-672000,-672000
2401,凌陽            ,119000,786000,-667000,0,0,0,0,0,0,-6000,12000,18000,-6000,0,0,0,-673000
054819,裕民元大9A購01  ,0,0,0,0,0,0,0,0,0,-677000,0,0,0,350000,1027000,-677000,-677000
2615,萬海            ,238000,915000,-677000,0,0,0,0,0,0,0,0,0,0,0,0,0,-677000
059095,訊芯元大99購01  ,0,0,0,0,0,0,0,0,0,-685000,0,0,0,700000,1385000,-685000,-685000
056872,旺宏凱基98購08  ,0,0,0,0,0,0,0,0,0,-700000,0,0,0,10000,710000,-700000,-700000
052010,兆豐金中信95購01,0,0,0,0,0,0,0,0,0,-706000,0,0,0,10000,716000,-706000,-706000
054471,T50反1中信9C購01,0,0,0,0,0,0,0,0,0,-708000,0,0,0,65000,773000,-708000,-708000
3034,聯詠            ,1967627,2807617,-839990,0,0,0,230000,127000,103000,22000,88000,26000,62000,17000,57000,-40000,-714990
057770,亞德客群益98購01,0,0,0,0,0,0,0,0,0,-722000,0,0,0,63000,785000,-722000,-722000
056121,勤誠群益97購01  ,0,0,0,0,0,0,0,0,0,-723000,0,0,0,322000,1045000,-723000,-723000
060399,康友國票9A購02  ,0,0,0,0,0,0,0,0,0,-724000,0,0,0,29000,753000,-724000,-724000
3062,建漢            ,321000,1054000,-733000,0,0,0,0,0,0,-9000,0,9000,-9000,0,0,0,-742000
3045,台灣大          ,689255,1441010,-751755,0,0,0,8000,0,8000,-2000,0,2000,-2000,0,0,0,-745755
4904,遠傳            ,1870592,2634056,-763464,0,0,0,3000,0,3000,12000,22000,1000,21000,0,9000,-9000,-748464
056122,勤誠群益97購02  ,0,0,0,0,0,0,0,0,0,-749000,0,0,0,133000,882000,-749000,-749000
058113,百和元富98購01  ,0,0,0,0,0,0,0,0,0,-753000,0,0,0,305000,1058000,-753000,-753000
052194,旺宏元富95購04  ,0,0,0,0,0,0,0,0,0,-757000,0,0,0,100000,857000,-757000,-757000
6202,盛群            ,316000,740000,-424000,0,0,0,0,301000,-301000,-44000,0,0,0,3000,47000,-44000,-769000
061055,康控群益9A購01  ,0,0,0,0,0,0,0,0,0,-772000,0,0,0,161000,933000,-772000,-772000
00715L,街口布蘭特油正2 ,0,29000,-29000,0,0,0,0,0,0,-755000,0,0,0,0,755000,-755000,-784000
046928,奇鋐富邦97購01  ,0,0,0,0,0,0,0,0,0,-789000,0,0,0,223000,1012000,-789000,-789000
060936,T50反1國票9A購09,0,0,0,0,0,0,0,0,0,-815000,0,0,0,15000,830000,-815000,-815000
061399,喬山兆豐9B購01  ,0,0,0,0,0,0,0,0,0,-820000,0,0,0,99000,919000,-820000,-820000
056770,國產元大98購02  ,0,0,0,0,0,0,0,0,0,-821000,0,0,0,162000,983000,-821000,-821000
057940,和大國票99購01  ,0,0,0,0,0,0,0,0,0,-822000,0,0,0,917000,1739000,-822000,-822000
2812,台中銀          ,1551000,2374000,-823000,0,0,0,0,0,0,0,0,0,0,0,0,0,-823000
3673,TPK-KY          ,433000,1172000,-739000,0,0,0,0,0,0,-89000,12000,92000,-80000,50000,59000,-9000,-828000
1513,中興電          ,19000,758000,-739000,0,0,0,0,0,0,-91000,0,0,0,0,91000,-91000,-830000
061517,瑞祺永豐9A購03  ,0,0,0,0,0,0,0,0,0,-836000,0,0,0,13000,849000,-836000,-836000
00631L,元大台灣50正2   ,287000,799000,-512000,0,0,0,0,0,0,-325000,8000,0,8000,2368000,2701000,-333000,-837000
057696,聯電群益9A購01  ,0,0,0,0,0,0,0,0,0,-838000,0,0,0,0,838000,-838000,-838000
00673R,元大S&P原油反1  ,0,0,0,0,0,0,0,0,0,-848000,0,0,0,1385000,2233000,-848000,-848000
052153,GIS富邦96購02   ,0,0,0,0,0,0,0,0,0,-858000,0,0,0,170000,1028000,-858000,-858000
07478P,南電康和9A售02  ,0,0,0,0,0,0,0,0,0,-864000,0,0,0,760000,1624000,-864000,-864000
00634R,富邦上証反1     ,105000,114000,-9000,0,0,0,0,0,0,-873000,0,50000,-50000,128000,951000,-823000,-882000
1217,愛之味          ,289000,1185000,-896000,0,0,0,0,0,0,0,0,0,0,0,0,0,-896000
2882,國泰金          ,4882795,5631238,-748443,0,0,0,11000,0,11000,-161000,0,0,0,41000,202000,-161000,-898443
060667,力成凱基9A購01  ,0,0,0,0,0,0,0,0,0,-906000,0,0,0,62000,968000,-906000,-906000
052738,聯電元大98購02  ,0,0,0,0,0,0,0,0,0,-910000,0,0,0,143000,1053000,-910000,-910000
057475,聯電元大9A購01  ,0,0,0,0,0,0,0,0,0,-914000,0,0,0,32000,946000,-914000,-914000
2332,友訊            ,464000,1420000,-956000,0,0,0,0,0,0,31000,58000,70000,-12000,93000,50000,43000,-925000
057113,祥碩群益98購01  ,0,0,0,0,0,0,0,0,0,-937000,0,0,0,232000,1169000,-937000,-937000
2823,中壽            ,3116000,4284276,-1168276,0,0,0,4000,0,4000,218000,0,0,0,280000,62000,218000,-946276
061160,瑞祺群益9A購01  ,0,0,0,0,0,0,0,0,0,-951000,0,0,0,784000,1735000,-951000,-951000
8150,南茂            ,795000,1498000,-703000,0,0,0,0,0,0,-253000,0,0,0,16000,269000,-253000,-956000
2102,泰豐            ,754000,1719000,-965000,0,0,0,0,0,0,0,0,0,0,0,0,0,-965000
00693U,街口S&P黃豆     ,37000,23000,14000,0,0,0,0,0,0,-982000,0,0,0,531000,1513000,-982000,-968000
2106,建大            ,214000,1204000,-990000,0,0,0,0,0,0,0,0,0,0,0,0,0,-990000
057406,茂林群益98購03  ,0,0,0,0,0,0,0,0,0,-997000,0,0,0,0,997000,-997000,-997000
1325,恆大            ,127000,68000,59000,0,0,0,0,1000000,-1000000,-57000,0,57000,-57000,0,0,0,-998000
2456,奇力新          ,344000,1507000,-1163000,0,0,0,302000,0,302000,-142000,94000,141000,-47000,44000,139000,-95000,-1003000
6505,台塑化          ,1022238,2054587,-1032349,0,0,0,9000,0,9000,15000,15000,0,15000,0,0,0,-1008349
059375,道瓊反群益9C購02,0,0,0,0,0,0,0,0,0,-1009000,0,0,0,53000,1062000,-1009000,-1009000
1504,東元            ,307000,1354000,-1047000,0,0,0,0,0,0,-3000,14000,12000,2000,0,5000,-5000,-1050000
2352,佳世達          ,1521000,2241000,-720000,0,0,0,0,333000,-333000,-15000,9000,20000,-11000,3000,7000,-4000,-1068000
00708L,元大S&P黃金正2  ,4000,119000,-115000,0,0,0,0,0,0,-961000,0,0,0,2306000,3267000,-961000,-1076000
2609,陽明            ,241000,1326000,-1085000,0,0,0,0,0,0,0,0,0,0,0,0,0,-1085000
5469,瀚宇博          ,725000,1726000,-1001000,0,0,0,0,0,0,-93000,0,9000,-9000,47000,131000,-84000,-1094000
2834,臺企銀          ,5663000,6787976,-1124976,0,0,0,0,0,0,2000,2000,0,2000,0,0,0,-1122976
2342,茂矽            ,557000,1737000,-1180000,0,0,0,0,0,0,0,0,0,0,0,0,0,-1180000
2027,大成鋼          ,632000,1223000,-591000,0,0,0,0,0,0,-615000,12000,58000,-46000,104000,673000,-569000,-1206000
2376,技嘉            ,1367000,2424000,-1057000,0,0,0,0,77000,-77000,-80000,38000,2000,36000,21000,137000,-116000,-1214000
1312,國喬            ,304000,1540000,-1236000,0,0,0,0,0,0,6000,6000,0,6000,0,0,0,-1230000
2308,台達電          ,1456947,2125683,-668736,0,0,0,8000,516000,-508000,-54000,10000,50000,-40000,9000,23000,-14000,-1230736
2323,中環            ,1059000,2033000,-974000,0,0,0,0,0,0,-260000,20000,0,20000,0,280000,-280000,-1234000
8110,華東            ,185000,1470000,-1285000,0,0,0,0,0,0,0,14000,14000,0,0,0,0,-1285000
2103,台橡            ,791000,2110000,-1319000,0,0,0,0,0,0,0,0,0,0,0,0,0,-1319000
2363,矽統            ,1457000,2793000,-1336000,0,0,0,0,0,0,0,0,0,0,0,0,0,-1336000
059830,台郡凱基99購05  ,0,0,0,0,0,0,0,0,0,-1345000,0,0,0,243000,1588000,-1345000,-1345000
059086,國巨元大99購18  ,0,0,0,0,0,0,0,0,0,-1347000,0,0,0,30000,1377000,-1347000,-1347000
059865,國巨凱基01購01  ,0,0,0,0,0,0,0,0,0,-1355000,0,0,0,1435000,2790000,-1355000,-1355000
1101,台泥            ,4418906,4569179,-150273,0,0,0,532000,1477000,-945000,-273000,0,127000,-127000,5000,151000,-146000,-1368273
2356,英業達          ,2188000,3408530,-1220530,0,0,0,0,0,0,-210000,94000,38000,56000,37000,303000,-266000,-1430530
056696,茂林群益98購02  ,0,0,0,0,0,0,0,0,0,-1471000,0,0,0,0,1471000,-1471000,-1471000
060302,台積電富邦02購01,0,0,0,0,0,0,0,0,0,-1593000,0,0,0,523000,2116000,-1593000,-1593000
1409,新纖            ,176000,1770000,-1594000,0,0,0,0,0,0,0,0,0,0,0,0,0,-1594000
056829,台積電富邦9A購01,0,0,0,0,0,0,0,0,0,-1641000,0,0,0,149000,1790000,-1641000,-1641000
058450,旺宏永豐99購01  ,0,0,0,0,0,0,0,0,0,-1660000,0,0,0,0,1660000,-1660000,-1660000
2327,國巨            ,3957258,7448080,-3490822,0,0,0,1031000,0,1031000,685000,298000,119000,179000,1162000,656000,506000,-1774822
5880,合庫金          ,3587037,5339035,-1751998,0,0,0,12000,0,12000,-85000,0,2000,-2000,0,83000,-83000,-1824998
2449,京元電子        ,1090000,3138000,-2048000,0,0,0,284000,0,284000,-65000,127000,65000,62000,89000,216000,-127000,-1829000
4958,臻鼎-KY         ,1319000,2850400,-1531400,0,0,0,0,274000,-274000,-58000,10000,60000,-50000,15000,23000,-8000,-1863400
1789,神隆            ,200000,2036000,-1836000,0,0,0,0,0,0,-85000,0,0,0,25000,110000,-85000,-1921000
2312,金寶            ,1248000,3244000,-1996000,0,0,0,0,0,0,64000,4000,1000,3000,206000,145000,61000,-1932000
1515,力山            ,1051000,3040000,-1989000,0,0,0,60000,0,60000,-7000,68000,5000,63000,89000,159000,-70000,-1936000
057332,旺宏國票99購03  ,0,0,0,0,0,0,0,0,0,-1941000,0,0,0,5000,1946000,-1941000,-1941000
1216,統一            ,3721829,5728748,-2006919,0,0,0,19000,0,19000,9000,17000,10000,7000,4000,2000,2000,-1978919
1760,寶齡富錦        ,1195000,3109000,-1914000,0,0,0,0,120000,-120000,5000,5000,0,5000,0,0,0,-2029000
2368,金像電          ,9757000,13417000,-3660000,0,0,0,1308000,118000,1190000,342000,2057000,1601000,456000,169000,283000,-114000,-2128000
2330,台積電          ,16333183,17832192,-1499009,0,0,0,34000,1002000,-968000,335000,266000,130000,136000,445000,246000,199000,-2132009
00653L,富邦印度正2     ,470000,1188000,-718000,0,0,0,0,0,0,-1415000,0,0,0,557000,1972000,-1415000,-2133000
2367,燿華            ,1342000,3745000,-2403000,0,0,0,0,0,0,-46000,0,0,0,22000,68000,-46000,-2449000
6176,瑞儀            ,793000,2798160,-2005160,0,0,0,0,355000,-355000,-89000,1000,21000,-20000,25000,94000,-69000,-2449160
6251,定穎            ,3189000,2956000,233000,0,0,0,366000,2890000,-2524000,-203000,251000,454000,-203000,0,0,0,-2494000
2884,玉山金          ,5682451,8935133,-3252682,0,0,0,15000,0,15000,596000,1006000,193000,813000,33000,250000,-217000,-2641682
2880,華南金          ,3250891,5931194,-2680303,0,0,0,12000,0,12000,-102000,0,102000,-102000,0,0,0,-2770303
2891,中信金          ,13079581,15514462,-2434881,0,0,0,66000,0,66000,-402000,0,130000,-130000,0,272000,-272000,-2770881
9904,寶成            ,2546276,5453005,-2906729,0,0,0,3000,0,3000,-14000,70000,78000,-8000,2000,8000,-6000,-2917729
6239,力成            ,1829762,4944391,-3114629,0,0,0,149000,30000,119000,-12000,48000,39000,9000,13000,34000,-21000,-3007629
1605,華新            ,1193000,3726000,-2533000,0,0,0,0,0,0,-566000,0,140000,-140000,0,426000,-426000,-3099000
1102,亞泥            ,1781184,5341030,-3559846,0,0,0,526000,0,526000,-143000,0,20000,-20000,0,123000,-123000,-3176846
3711,日月光投控      ,1761455,4949283,-3187828,0,0,0,55000,0,55000,-157000,29000,92000,-63000,4000,98000,-94000,-3289828
6116,彩晶            ,2253000,4881000,-2628000,0,0,0,0,0,0,-903000,10000,130000,-120000,50000,833000,-783000,-3531000
2887,台新金          ,5742564,9354914,-3612350,0,0,0,14000,0,14000,2000,0,0,0,2000,0,2000,-3596350
2888,新光金          ,10773790,14746613,-3972823,0,0,0,16000,0,16000,-280000,48000,110000,-62000,382000,600000,-218000,-4236823
2344,華邦電          ,4053000,8896000,-4843000,0,0,0,0,0,0,-246000,434000,646000,-212000,71000,105000,-34000,-5089000
00642U,元大S&P石油     ,18000,2410,15590,0,0,0,0,0,0,-8069000,0,0,0,1501000,9570000,-8069000,-8053410
2409,友達            ,22153478,35531000,-13377522,0,0,0,0,0,0,-3842000,121000,988000,-867000,154000,3129000,-2975000,-17219522
2885,元大金          ,12921905,32154182,-19232277,0,0,0,15000,0,15000,562000,602000,40000,562000,0,0,0,-18655277
3481,群創            ,18286000,42539344,-24253344,0,0,0,30000,0,30000,-2876000,64000,300000,-236000,603000,3243000,-2640000,-27099344
00677U,富邦VIX         ,10223000,40461000,-30238000,0,0,0,0,0,0,-29756000,200000,200000,0,3111000,32867000,-29756000,-59994000
2303,聯電            ,39259108,105608959,-66349851,0,0,0,14000,535000,-521000,-2839000,1910000,2142000,-232000,493000,3100000,-2607000,-69709851
